matchId,queueId,Diff_LV,Diff_CS,Diff_jglCS,Diff-K,Diff-K-top,K-WIN-top,K-LOSE-top,Diff-K-jug,K-WIN-jug,K-LOSE-jug,Diff-K-mid,K-WIN-mid,K-LOSE-mid,Diff-K-ad,K-WIN-ad,K-LOSE-ad,Diff-K-sup,K-WIN-sup,K-LOSE-sup,invadeKill,Diff-A,Diff_WARDplaced,Diff-ControlWARDplaced,LOSE_controlWARDPlaced,WIN_controlWARDPlaced,Diff_WARDkill,Diff_Inhibitor,Diff_TOWERkill,Diff_FirstDRAGON,Diff_FirstHERALD,Diff_Firsttower,Diff_FirstBLOOD,dragonType,result
KR_6768755968,420,1,70,12,1,2,3,1,0,2,2,2,2,0,-4,0,4,1,3,2,0,-6,42,-8,9,1,-34,0,1,1,1,1,1,6,1
KR_6741544201,420,4,108,-12,8,3,4,1,-1,1,2,4,5,1,1,2,1,1,1,0,0,9,32,4,3,7,7,0,2,1,1,1,1,3,1
KR_6729016155,420,7,121,68,16,-2,3,5,8,9,1,4,5,1,2,2,0,4,6,2,1,17,149,1,3,4,-1,0,4,1,1,1,1,4,1
KR_6737134668,440,4,28,29,13,0,2,2,3,5,2,3,5,2,6,6,0,1,1,0,0,17,-9,6,2,8,-3,0,1,1,0,1,1,2,1
KR_6744536775,420,2,18,2,9,2,2,0,3,3,0,2,2,0,1,2,1,1,2,1,0,9,13,11,3,14,-3,0,1,1,1,1,1,3,1
KR_6742374938,420,3,25,-12,7,2,3,1,-2,0,2,1,4,3,6,7,1,0,0,0,0,9,-62,2,6,8,0,0,2,1,1,1,-1,3,1
KR_6773578802,420,0,4,29,0,-1,0,1,-2,1,3,2,3,1,3,6,3,-2,1,3,0,4,-155,4,3,7,-4,0,0,1,-1,0,1,3,1
KR_6777655621,420,2,7,9,6,2,6,4,2,5,3,0,2,2,-2,1,3,4,4,0,1,2,-5,0,7,7,5,0,3,-1,1,1,1,1,1
KR_6776869157,420,0,36,7,-6,-6,0,6,-5,1,6,2,3,1,0,1,1,3,3,0,0,0,-15,0,5,5,1,0,0,-1,1,1,-1,2,1
KR_6742365758,420,2,-29,-7,1,-1,2,3,-1,2,3,3,3,0,1,6,5,-1,1,2,0,9,5,-2,8,6,0,0,1,1,-1,1,-1,6,1
KR_6775856731,420,2,-17,-4,11,1,3,2,4,7,3,1,2,1,3,3,0,2,2,0,0,7,41,2,7,9,3,0,1,-1,1,1,1,2,1
KR_6774790690,420,3,1,12,10,2,2,0,7,8,1,1,1,0,2,3,1,-2,0,2,0,11,-27,1,6,7,5,0,0,-1,1,0,-1,6,1
KR_6777374658,420,3,39,2,7,3,3,0,1,4,3,3,3,0,0,1,1,0,0,0,0,0,-9,-4,8,4,1,0,1,1,1,1,-1,6,1
KR_6741465295,420,6,63,24,11,-1,1,2,10,12,2,1,3,2,2,2,0,-1,1,2,1,15,1,2,8,10,-6,0,2,1,1,1,1,4,1
KR_6754594689,420,-1,-47,-8,6,-2,1,3,4,6,2,1,2,1,2,4,2,1,3,2,2,15,-4,2,6,8,1,0,-1,1,-1,-1,1,6,1
KR_6777722583,440,3,47,-25,16,0,4,4,6,7,1,5,5,0,1,4,3,4,4,0,2,26,39,-1,7,6,-18,0,5,-1,1,1,1,6,1
KR_6776052741,440,4,4,11,11,0,0,0,0,2,2,6,6,0,4,5,1,1,1,0,0,10,1,-1,5,4,2,0,2,1,1,1,1,6,1
KR_6745336046,420,-1,-32,14,-2,0,1,1,-3,0,3,1,4,3,-2,2,4,2,3,1,0,9,7,-5,8,3,1,0,0,-1,1,-1,-1,6,1
KR_6737317879,420,2,-11,41,4,-3,1,4,0,4,4,2,3,1,4,6,2,1,1,0,2,13,14,2,6,8,1,0,1,1,-1,1,1,4,1
KR_6776721711,420,4,99,-4,8,1,2,1,2,4,2,4,5,1,1,1,0,0,1,1,0,11,-11,5,4,9,5,0,0,1,1,1,1,6,1
KR_6776510717,420,1,-9,13,3,2,2,0,2,3,1,0,0,0,-1,1,2,0,0,0,0,2,0,-1,4,3,2,0,0,1,-1,0,-1,3,1
KR_6773188934,420,2,38,0,7,2,3,1,1,2,1,2,4,2,1,4,3,1,1,0,0,4,405,0,2,2,-1,0,2,-1,1,1,1,4,1
KR_6777868121,420,-1,-57,1,2,3,4,1,-1,2,3,-2,3,5,2,3,1,0,0,0,0,4,39,3,4,7,-2,0,-2,1,-1,-1,-1,3,1
KR_6777167109,420,2,-59,-9,0,6,7,1,-2,1,3,0,4,4,-3,3,6,-1,0,1,1,-3,-3,0,6,6,3,0,0,1,1,1,1,5,1
KR_6776757276,420,4,42,-29,16,4,6,2,5,7,2,4,6,2,3,10,7,0,0,0,3,28,1,1,8,9,2,0,0,0,1,1,1,0,1
KR_6752725318,420,-1,-7,1,-15,-4,2,6,2,2,0,-4,2,6,-8,4,12,-1,1,2,-3,-7,-4,3,7,10,-2,0,-2,-1,-1,-1,-1,2,1
KR_6716044786,420,4,65,-5,9,-2,0,2,3,4,1,6,8,2,3,3,0,-1,0,1,0,7,13,5,2,7,0,0,4,1,1,1,1,3,1
KR_6727344228,420,3,45,42,5,1,1,0,2,5,3,2,4,2,-1,3,4,1,1,0,0,2,21,3,5,8,7,0,2,1,1,1,1,6,1
KR_6767751413,420,-1,19,-4,1,0,0,0,0,3,3,-2,1,3,2,4,2,1,2,1,0,17,-3,-2,5,3,0,0,0,1,-1,0,-1,3,1
KR_6770549059,440,2,-29,39,2,-1,2,3,4,6,2,-4,0,4,4,7,3,-1,1,2,1,8,-4,0,7,7,2,0,0,1,-1,0,1,3,1
KR_6767992210,420,7,65,32,13,4,6,2,2,7,5,1,5,4,-1,0,1,7,8,1,0,13,0,1,4,5,5,0,3,1,1,1,1,3,1
KR_6772943233,420,1,-7,-17,7,-2,0,2,0,5,5,0,5,5,6,7,1,3,3,0,0,8,4,-2,5,3,-5,0,0,1,1,1,1,2,1
KR_6749647797,420,3,36,10,8,-1,1,2,1,3,2,9,11,2,-1,0,1,0,0,0,0,3,-9,0,6,6,2,0,3,1,1,1,1,1,1
KR_6775178620,420,1,-35,4,3,0,2,2,-1,2,3,2,2,0,1,1,0,1,2,1,0,6,42,3,3,6,0,0,1,1,1,1,-1,6,1
KR_6777438179,420,2,69,0,8,-2,0,2,3,4,1,1,1,0,6,7,1,0,2,2,0,9,-2,4,4,8,0,0,0,1,1,1,1,4,1
KR_6766240935,420,3,22,-4,7,2,3,1,1,2,1,-3,1,4,3,3,0,4,4,0,0,5,-4,3,3,6,1,0,0,1,1,0,1,2,1
KR_6735422996,420,2,36,0,12,1,1,0,9,9,0,4,4,0,-2,2,4,0,1,1,1,23,3,4,4,8,0,0,2,1,1,1,1,1,1
KR_6777101081,420,-2,-8,13,0,-2,3,5,4,4,0,-1,2,3,-2,2,4,1,1,0,0,7,-45,-2,6,4,9,0,-2,1,-1,-1,-1,6,1
KR_6773843622,420,-1,-34,20,-1,0,1,1,-3,2,5,1,6,5,1,2,1,0,1,1,-2,0,-15,1,5,6,-2,0,-1,-1,-1,-1,-1,3,1
KR_6747242842,420,-2,-30,-15,2,-3,0,3,-5,3,8,1,4,3,8,10,2,1,2,1,0,9,3,1,4,5,5,0,-1,1,-1,-1,-1,4,1
KR_6755696986,420,2,31,23,-2,3,3,0,-1,3,4,1,1,0,-2,2,4,-3,1,4,0,-5,47,6,4,10,0,0,0,1,1,1,-1,6,1
KR_6776990199,420,2,37,2,13,2,3,1,1,3,2,3,5,2,7,8,1,0,1,1,0,17,6,-2,9,7,-1,0,1,1,1,1,1,4,1
KR_6742491521,420,5,23,47,4,3,3,0,0,3,3,-1,1,2,2,6,4,0,1,1,-1,4,11,2,7,9,-2,0,-1,1,-1,-1,-1,2,1
KR_6762302605,420,5,44,36,11,-3,1,4,1,6,5,5,6,1,7,7,0,1,2,1,1,11,-4,-1,7,6,6,0,2,1,1,1,1,6,1
KR_6776855781,420,1,25,9,10,2,5,3,-2,2,4,9,10,1,-2,3,5,3,5,2,0,11,6,3,4,7,0,0,2,1,1,1,1,5,1
KR_6710392606,420,1,22,14,9,-2,3,5,6,8,2,-2,1,3,3,4,1,4,4,0,2,5,-29,-5,11,6,6,0,2,1,1,1,1,5,1
KR_6776113785,420,5,79,0,8,0,0,0,8,11,3,-1,0,1,2,3,1,-1,0,1,0,12,-4,-7,12,5,4,0,1,-1,1,1,-1,3,1
KR_6772467382,420,7,64,47,16,7,7,0,6,8,2,0,0,0,3,4,1,0,0,0,0,13,42,3,3,6,-4,0,3,1,1,1,1,1,1
KR_6776571144,420,4,81,36,14,4,6,2,3,5,2,3,5,2,4,5,1,0,0,0,1,22,6,2,4,6,-1,0,1,1,1,1,1,2,1
KR_6774561984,420,0,-68,20,0,-3,2,5,1,3,2,3,4,1,-2,7,9,1,1,0,0,-12,10,-10,15,5,3,0,-1,-1,1,-1,1,1,1
KR_6736398331,420,2,29,-16,1,6,9,3,3,6,3,-4,2,6,-5,0,5,1,5,4,-2,3,24,0,6,6,-1,0,1,1,-1,-1,1,2,1
KR_6766091805,420,3,40,-10,10,1,2,1,3,3,0,3,3,0,2,4,2,1,1,0,0,15,-1,3,2,5,5,0,4,-1,1,1,1,6,1
KR_6767201609,420,1,-9,-20,11,4,4,0,2,4,2,0,1,1,4,4,0,1,1,0,0,13,5,2,4,6,-3,0,1,-1,1,1,1,4,1
KR_6753017986,420,1,-73,43,0,-2,1,3,-1,3,4,-2,2,4,0,5,5,5,5,0,-2,10,-18,1,6,7,-3,0,-1,-1,1,-1,-1,5,1
KR_6770841974,420,-4,-41,-35,-8,0,3,3,3,5,2,-5,1,6,-4,2,6,-2,1,3,1,-4,-32,2,4,6,2,0,-2,-1,-1,-1,1,2,1
KR_6760586657,420,3,60,-11,4,2,3,1,4,5,1,-1,1,2,1,4,3,-2,0,2,0,6,0,3,5,8,6,0,2,1,-1,1,-1,1,1
KR_6764590054,420,-1,16,0,0,0,1,1,4,4,0,0,2,2,-3,1,4,-1,0,1,0,-1,2,0,4,4,0,0,0,-1,1,0,-1,4,1
KR_6775153617,420,0,33,-28,9,0,0,0,0,1,1,-2,2,4,10,14,4,1,1,0,0,15,-17,-6,9,3,2,0,0,1,-1,0,1,5,1
KR_6729510917,420,5,53,6,11,2,2,0,2,2,0,3,5,2,4,7,3,0,0,0,0,8,23,-5,7,2,-2,0,1,-1,1,1,1,5,1
KR_6746483272,420,3,73,0,8,3,5,2,2,4,2,1,3,2,3,4,1,-1,3,4,0,5,-6,6,5,11,2,0,0,1,1,0,-1,2,1
KR_6733379917,420,1,39,-19,8,1,1,0,5,6,1,-1,1,2,1,3,2,2,2,0,0,12,1,2,7,9,9,0,1,1,-1,1,1,4,1
KR_6772862704,440,0,7,-20,0,1,1,0,-2,1,3,0,1,1,1,1,0,0,1,1,0,1,-26,3,3,6,-6,0,0,1,1,0,-1,1,1
KR_6777087018,420,2,37,-6,2,-2,4,6,1,4,3,1,2,1,3,4,1,-1,1,2,0,2,9,3,4,7,-2,0,-1,1,-1,-1,-1,5,1
KR_6776147316,420,-1,-30,39,-5,-6,0,6,3,4,1,-3,1,4,0,2,2,1,1,0,-1,2,-7,-5,10,5,-5,0,-1,1,-1,-1,-1,5,1
KR_6764821903,420,0,-15,0,-2,-1,2,3,2,3,1,-2,2,4,-1,0,1,0,1,1,0,1,-9,0,7,7,1,0,0,-1,-1,-1,1,4,1
KR_6697932711,420,-1,0,18,6,2,4,2,7,8,1,-6,1,7,4,6,2,-1,0,1,3,7,-2,2,4,6,0,0,0,1,1,1,1,5,1
KR_6760263566,420,2,45,12,6,3,7,4,-1,2,3,2,2,0,2,4,2,0,1,1,0,-1,4,0,8,8,2,0,1,-1,1,1,1,6,1
KR_6770498086,420,2,21,-9,12,0,2,2,3,4,1,4,5,1,3,5,2,2,3,1,-1,9,-232,0,8,8,0,0,1,1,1,1,-1,5,1
KR_6749985174,420,4,43,24,10,0,2,2,-2,3,5,3,3,0,11,12,1,-2,0,2,0,14,-2,-1,9,8,-1,0,2,0,1,1,1,0,1
KR_6746607819,420,3,52,19,5,3,3,0,4,5,1,-1,1,2,0,5,5,-1,1,2,1,9,22,2,7,9,6,0,1,1,1,1,-1,1,1
KR_6763811870,420,-1,22,-23,-5,-2,1,3,-6,3,9,1,1,0,1,2,1,1,1,0,-1,-14,12,-3,7,4,2,0,-1,-1,-1,1,-1,1,1
KR_6775247768,420,4,24,28,13,4,5,1,1,4,3,2,4,2,5,6,1,1,1,0,0,14,33,1,7,8,-1,0,2,1,1,1,1,4,1
KR_6775342208,420,1,-27,13,4,9,9,0,1,4,3,-2,3,5,-3,2,5,-1,0,1,-1,-3,0,-5,10,5,7,0,0,-1,1,1,-1,4,1
KR_6770105868,440,4,43,7,6,2,3,1,1,1,0,1,2,1,1,3,2,1,2,1,0,2,-3,-2,6,4,4,0,0,0,-1,0,1,0,1
KR_6720437215,420,9,111,20,19,8,8,0,7,10,3,4,5,1,0,3,3,0,0,0,0,24,5,7,4,11,5,0,4,-1,-1,1,1,1,1
KR_6777656287,420,3,21,4,4,2,3,1,0,2,2,0,2,2,2,4,2,0,0,0,0,3,0,-2,7,5,0,0,-1,1,-1,-1,-1,6,1
KR_6727924591,420,2,59,-5,11,1,1,0,2,6,4,0,2,2,7,7,0,1,1,0,1,11,-7,-1,8,7,4,0,2,-1,1,1,1,2,1
KR_6728993654,420,3,-13,32,2,-2,1,3,0,3,3,0,2,2,3,8,5,1,1,0,0,9,1,3,8,11,0,0,-1,-1,-1,-1,-1,5,1
KR_6774759232,420,2,-33,1,-2,4,6,2,-2,4,6,-3,3,6,-2,1,3,1,1,0,1,5,-19,6,6,12,-5,0,1,-1,-1,1,1,4,1
KR_6769100462,420,0,62,-9,3,1,2,1,-3,1,4,1,1,0,5,5,0,-1,0,1,0,3,-21,2,5,7,-2,0,0,-1,0,1,1,2,1
KR_6689845689,420,1,8,-24,0,-5,0,5,-1,4,5,2,2,0,5,8,3,-1,0,1,0,8,-13,-5,6,1,7,0,-1,-1,-1,1,-1,6,1
KR_6768609344,440,0,95,-3,0,0,1,1,6,7,1,1,3,2,-1,0,1,-6,0,6,0,0,20,-5,9,4,4,0,1,-1,1,1,-1,1,1
KR_6775872186,420,4,26,7,7,4,5,1,1,5,4,-1,1,2,2,2,0,1,1,0,0,0,44,-1,5,4,5,0,0,-1,1,1,1,3,1
KR_6769789604,420,0,29,-33,-4,2,3,1,-4,1,5,0,3,3,1,3,2,-3,0,3,0,0,-113,-3,7,4,8,0,-2,-1,1,-1,-1,6,1
KR_6775933589,420,3,47,0,3,3,3,0,-1,2,3,0,1,1,2,3,1,-1,0,1,0,-3,-6,0,6,6,6,0,1,-1,1,1,1,5,1
KR_6756976275,420,3,94,8,15,0,1,1,9,9,0,1,4,3,5,6,1,0,1,1,1,29,45,4,3,7,-25,0,4,1,1,1,1,3,1
KR_6776295984,440,-1,4,8,-5,0,1,1,-4,1,5,-4,1,5,2,5,3,1,1,0,0,-1,-6,-4,9,5,2,0,0,1,-1,0,-1,3,1
KR_6772616587,420,5,24,1,15,1,2,1,7,9,2,2,2,0,4,5,1,1,1,0,0,14,30,5,4,9,1,0,0,1,1,1,1,2,1
KR_6765718397,420,1,-7,-14,-3,1,2,1,-5,1,6,0,2,2,2,3,1,-1,1,2,0,-1,-143,-3,8,5,0,0,0,1,-1,1,-1,4,1
KR_6698021010,420,0,40,0,-1,0,1,1,-1,1,2,-1,0,1,1,1,0,0,0,0,0,-1,6,3,8,11,-1,0,0,1,-1,0,-1,4,1
KR_6736900980,420,-2,-61,20,1,-3,1,4,7,8,1,-2,3,5,1,7,6,-2,1,3,2,6,21,-3,9,6,6,0,-1,1,0,-1,1,3,1
KR_6775582903,420,0,-34,-5,5,-2,0,2,2,3,1,3,4,1,2,2,0,0,0,0,0,11,0,8,4,12,0,0,0,1,-1,0,1,1,1
KR_6749825640,420,5,87,44,9,4,5,1,-1,3,4,2,3,1,2,3,1,2,2,0,0,-4,-2,0,5,5,1,0,2,1,1,1,-1,4,1
KR_6754355442,420,4,44,14,8,3,4,1,-1,4,5,-1,1,2,5,6,1,2,2,0,0,10,-266,4,5,9,1,0,1,1,1,1,1,2,1
KR_6711915155,420,-2,-11,3,-2,-1,2,3,2,6,4,1,4,3,-2,4,6,-2,1,3,1,2,-10,1,10,11,-7,0,0,-1,-1,-1,-1,3,1
KR_6775327479,420,5,68,27,5,3,3,0,1,2,1,2,2,0,1,3,2,-2,1,3,0,-1,19,3,3,6,-5,0,1,-1,1,1,-1,5,1
KR_6753225747,420,4,32,23,9,2,3,1,2,6,4,5,7,2,-3,3,6,3,5,2,2,10,33,-4,8,4,4,0,3,1,1,1,1,1,1
KR_6763032625,440,-1,36,16,3,-1,2,3,2,6,4,-1,0,1,3,6,3,0,2,2,0,6,-7,1,4,5,4,0,-1,0,0,-1,1,0,1
KR_6776734072,420,2,-2,-8,5,2,2,0,-1,2,3,1,5,4,4,4,0,-1,2,3,0,9,-4,8,1,9,1,0,0,-1,-1,0,1,3,1
KR_6775386738,420,2,103,-12,6,0,1,1,0,3,3,-1,2,3,5,7,2,2,3,1,1,1,20,6,0,6,0,0,2,1,1,1,1,6,1
KR_6775074771,420,4,-7,20,17,0,1,1,8,10,2,4,4,0,4,4,0,1,2,1,0,16,-36,3,3,6,24,0,0,1,1,1,1,1,1
KR_6739623419,420,3,-5,4,15,3,3,0,7,8,1,4,7,3,0,7,7,1,1,0,0,26,8,2,5,7,1,0,2,-1,1,1,1,3,1
KR_6722120002,420,0,-48,-9,0,0,3,3,0,5,5,-1,2,3,-2,3,5,3,3,0,-1,0,10,-10,15,5,0,0,-2,1,-1,-1,-1,5,1
KR_6739015620,420,-2,-24,-36,1,0,3,3,-3,2,5,1,3,2,4,7,3,-1,0,1,0,5,-38,4,4,8,4,0,-2,-1,1,-1,1,5,1
KR_6748558144,420,2,-2,-5,1,0,1,1,4,5,1,-2,2,4,0,2,2,-1,0,1,0,-4,-18,-3,6,3,-2,0,0,-1,1,1,-1,6,1
KR_6742124432,440,3,-7,16,10,1,3,2,-1,0,1,-4,1,5,3,3,0,11,11,0,0,16,-26,-1,8,7,16,0,0,1,1,1,1,3,1
KR_6710613497,420,2,31,-6,6,0,1,1,2,3,1,-1,2,3,6,8,2,-1,2,3,0,8,16,1,7,8,-4,0,0,1,-1,-1,1,6,1
KR_6761992732,420,0,-6,15,-1,-2,1,3,3,4,1,-5,0,5,4,4,0,-1,0,1,0,1,-9,-5,9,4,4,0,0,-1,1,0,1,6,1
KR_6743564405,420,4,-38,7,12,2,2,0,3,3,0,6,8,2,-2,0,2,3,3,0,0,10,-43,2,4,6,15,0,1,1,-1,1,1,5,1
KR_6772082191,420,-3,-45,9,-1,-4,0,4,2,5,3,0,1,1,0,2,2,1,1,0,0,9,-239,3,6,9,2,0,-1,-1,1,-1,1,4,1
KR_6724715518,420,4,22,-4,5,-1,3,4,3,7,4,-1,1,2,2,3,1,2,2,0,0,4,39,-10,12,2,-8,0,1,-1,1,1,1,6,1
KR_6757564304,420,2,72,20,4,-2,1,3,3,4,1,4,7,3,-3,3,6,2,3,1,0,-1,-9,4,5,9,1,0,1,-1,1,1,1,6,1
KR_6764533373,420,4,42,32,11,4,5,1,3,5,2,0,4,4,4,7,3,0,1,1,0,9,13,3,5,8,-3,0,3,1,-1,1,1,4,1
KR_6771154675,420,5,57,1,6,3,3,0,-1,2,3,1,3,2,2,3,1,1,1,0,0,6,11,0,5,5,-12,0,0,1,-1,1,1,3,1
KR_6773867039,420,1,56,12,0,-1,0,1,1,2,1,2,2,0,-2,0,2,0,0,0,0,-3,-5,-1,6,5,2,0,0,1,-1,0,1,5,1
KR_6760512459,420,1,-5,43,9,4,4,0,2,4,2,0,0,0,3,4,1,0,0,0,0,12,20,1,9,10,-2,0,1,1,1,1,1,1,1
KR_6705530738,420,-2,61,-16,-6,3,5,2,-5,1,6,-3,2,5,-1,1,2,0,0,0,-1,-12,49,-1,6,5,-11,0,3,-1,1,1,-1,4,1
KR_6771586170,420,2,41,-5,9,-1,3,4,5,6,1,3,3,0,1,4,3,1,3,2,1,20,95,8,7,15,-7,0,1,1,1,1,1,3,1
KR_6777445070,420,2,11,24,-2,1,3,2,-3,2,5,0,1,1,-2,1,3,2,2,0,-1,-8,17,-10,11,1,0,0,1,-1,1,1,-1,4,1
KR_6726614610,420,3,51,5,9,-1,1,2,2,3,1,0,3,3,6,7,1,2,2,0,0,16,1,-2,7,5,4,0,1,-1,1,1,-1,6,1
KR_6742830532,420,2,45,36,8,-3,1,4,9,14,5,-2,2,4,5,5,0,-1,0,1,0,11,22,4,4,8,-25,0,1,1,1,1,1,5,1
KR_6734941421,420,7,13,37,10,5,5,0,1,2,1,3,4,1,-1,1,2,2,2,0,0,7,-4,3,5,8,1,0,1,0,1,1,-1,0,1
KR_6766871849,420,3,-11,-7,8,7,8,1,1,3,2,1,2,1,-1,0,1,0,0,0,0,2,2,0,6,6,0,0,2,1,1,1,1,4,1
KR_6774074719,440,0,-19,-4,3,-4,0,4,3,4,1,0,3,3,4,4,0,0,0,0,0,14,30,-1,4,3,-9,0,0,1,-1,0,-1,5,1
KR_6704560087,420,2,-20,10,9,-1,2,3,6,9,3,6,8,2,-2,0,2,0,1,1,0,5,80,2,3,5,3,0,1,1,1,1,1,1,1
KR_6776049288,420,-1,6,-6,-4,4,4,0,-4,0,4,1,1,0,-6,1,7,1,1,0,0,-14,-16,-6,8,2,-2,0,1,-1,1,1,-1,1,1
KR_6764893520,420,1,40,4,3,-1,1,2,-2,2,4,-2,1,3,7,9,2,1,4,3,-1,-9,2,2,5,7,-1,0,1,1,-1,1,-1,5,1
KR_6763595080,420,1,25,12,7,2,4,2,0,1,1,3,5,2,-1,0,1,3,3,0,0,9,0,-3,5,2,3,0,2,-1,1,1,1,6,1
KR_6771653714,440,1,18,18,1,0,1,1,4,5,1,-1,1,2,-3,0,3,1,3,2,-1,-2,-23,2,3,5,3,0,1,-1,-1,1,-1,3,1
KR_6753762474,420,3,5,3,7,2,3,1,4,6,2,-1,1,2,1,4,3,1,1,0,1,6,13,0,7,7,1,0,0,1,-1,-1,1,5,1
KR_6710256545,420,5,55,-10,10,3,3,0,2,3,1,6,7,1,0,1,1,-1,0,1,0,13,6,4,7,11,5,0,2,-1,1,1,-1,2,1
KR_6763208960,420,1,-25,23,6,3,4,1,1,2,1,0,1,1,2,3,1,0,0,0,0,7,9,5,6,11,-3,0,1,1,1,1,1,1,1
KR_6751496304,420,-2,-31,9,1,4,5,1,-7,4,11,-2,2,4,5,9,4,1,1,0,1,-13,-5,3,6,9,-2,0,1,-1,1,1,1,1,1
KR_6710720561,420,2,22,-8,5,-5,1,6,2,3,1,2,2,0,6,7,1,0,0,0,-2,18,11,3,4,7,-4,0,-1,1,-1,-1,1,3,1
KR_6774202861,420,2,45,20,9,0,3,3,1,6,5,4,5,1,4,7,3,0,0,0,1,11,7,3,5,8,0,0,-1,0,-1,1,1,0,1
KR_6746678779,420,4,40,20,10,0,0,0,5,7,2,8,8,0,-1,1,2,-2,0,2,0,13,3,6,2,8,-1,0,-1,-1,-1,-1,1,3,1
KR_6736076943,420,2,58,12,-2,-5,0,5,2,8,6,2,3,1,0,1,1,-1,0,1,0,1,-32,0,6,6,-3,0,-1,1,-1,-1,-1,5,1
KR_6764336947,420,4,51,-11,9,2,3,1,0,3,3,-1,1,2,6,8,2,2,2,0,0,14,-65,4,3,7,-2,0,3,1,-1,1,1,1,1
KR_6756635945,420,3,16,-20,16,0,1,1,5,8,3,4,5,1,4,6,2,3,3,0,0,24,14,-1,6,5,5,0,1,1,1,1,1,2,1
KR_6764552076,420,1,18,-3,8,0,1,1,3,4,1,5,8,3,1,2,1,-1,0,1,1,11,-19,4,5,9,0,0,2,1,1,1,1,3,1
KR_6768063060,420,-1,-5,11,-3,-1,3,4,1,5,4,0,1,1,1,1,0,-4,1,5,-1,-3,5,5,3,8,0,0,0,1,1,0,-1,6,1
KR_6739012065,420,3,19,-3,1,-5,3,8,2,2,0,3,3,0,0,4,4,1,1,0,0,-2,4,7,4,11,-6,0,2,-1,1,1,1,1,1
KR_6775811739,420,3,41,15,8,6,7,1,1,2,1,0,1,1,0,2,2,1,2,1,2,-2,6,-4,8,4,4,0,1,-1,1,1,1,1,1
KR_6763569944,440,3,3,28,3,0,1,1,-1,2,3,-1,1,2,4,5,1,1,1,0,0,0,2,-6,10,4,3,0,-1,-1,-1,-1,-1,5,1
KR_6770180393,420,0,-43,-3,2,-2,3,5,-2,2,4,3,5,2,2,6,4,1,1,0,1,4,-31,0,9,9,1,0,-1,1,-1,-1,1,3,1
KR_6733662872,420,-4,-21,-26,0,2,2,0,-3,0,3,1,1,0,0,0,0,0,1,1,0,-3,30,-3,7,4,-31,0,0,-1,-1,1,1,5,1
KR_6772129894,420,0,-50,8,0,-3,1,4,3,4,1,-1,0,1,1,2,1,0,0,0,0,5,-3,-4,10,6,0,0,0,1,1,-1,1,3,1
KR_6776546746,420,-3,-11,13,-5,3,7,4,0,5,5,-6,0,6,0,0,0,-2,0,2,0,-4,-10,-1,6,5,2,0,0,1,-1,0,-1,5,1
KR_6777278340,420,2,-10,4,7,-1,1,2,6,7,1,-2,2,4,4,6,2,0,2,2,0,14,-1,-3,9,6,2,0,0,1,-1,-1,1,4,1
KR_6701938946,420,4,38,24,11,-3,1,4,6,10,4,3,6,3,2,2,0,3,3,0,0,16,-39,1,8,9,-5,0,1,0,-1,1,-1,0,1
KR_6693622995,420,-2,24,-15,2,2,3,1,-5,5,10,1,3,2,2,3,1,2,3,1,1,-9,-54,2,8,10,26,0,0,-1,1,0,1,4,1
KR_6729771602,440,2,27,-4,6,2,3,1,4,4,0,1,2,1,-2,1,3,1,1,0,0,4,0,2,5,7,-1,0,0,-1,1,0,1,3,1
KR_6756531239,420,0,29,4,-1,4,5,1,-1,2,3,-2,0,2,-3,2,5,1,1,0,1,-15,6,-3,7,4,-1,0,1,1,1,1,1,5,1
KR_6760766849,440,1,23,4,-2,0,2,2,1,3,2,-4,1,5,-1,1,2,2,2,0,0,0,-15,-4,7,3,3,0,-1,-1,1,-1,-1,2,1
KR_6725953983,420,9,118,52,17,2,3,1,4,5,1,5,6,1,4,4,0,2,3,1,1,20,33,2,3,5,2,0,4,0,1,1,1,0,1
KR_6724201855,420,1,44,24,7,-1,2,3,2,6,4,3,4,1,2,2,0,1,1,0,0,6,5,-3,6,3,5,0,2,1,1,1,1,2,1
KR_6735794088,440,0,-55,23,7,-1,1,2,10,11,1,-1,2,3,-2,0,2,1,1,0,1,16,-11,3,4,7,-5,0,2,-1,1,1,1,1,1
KR_6771939466,420,0,27,-14,0,-3,1,4,2,7,5,-1,3,4,4,4,0,-2,0,2,0,0,-17,-2,4,2,5,0,0,1,-1,-1,-1,6,1
KR_6737408592,420,1,26,-27,3,2,2,0,2,4,2,-4,3,7,1,4,3,2,2,0,0,7,-6,3,6,9,-2,0,1,-1,-1,1,1,6,1
KR_6772368221,420,2,-32,-37,8,2,3,1,4,6,2,0,3,3,2,3,1,0,0,0,3,12,15,3,4,7,-7,0,0,-1,1,0,1,6,1
KR_6714684724,420,-1,36,18,-1,-3,1,4,6,7,1,-3,1,4,1,2,1,-2,0,2,-2,-2,-6,-1,6,5,0,0,2,-1,-1,1,-1,5,1
KR_6777404643,420,1,28,35,-2,0,3,3,3,4,1,-3,2,5,-1,2,3,-1,0,1,-1,-6,18,1,6,7,-4,0,-1,-1,-1,-1,-1,3,1
KR_6726858852,420,4,42,29,4,1,2,1,-1,3,4,6,7,1,0,3,3,-2,0,2,0,-2,3,1,5,6,-2,0,1,1,1,1,-1,6,1
KR_6775991948,420,3,29,12,6,1,1,0,2,4,2,0,3,3,2,3,1,1,3,2,0,5,-18,1,4,5,-6,0,2,1,1,1,1,3,1
KR_6743317864,440,6,75,24,11,3,3,0,6,6,0,1,2,1,1,3,2,0,1,1,0,17,-7,-4,10,6,1,0,1,1,1,1,1,3,1
KR_6766509755,420,0,25,-22,1,4,4,0,-1,0,1,-1,2,3,0,1,1,-1,1,2,-1,-6,-10,3,6,9,4,0,-1,-1,-1,-1,-1,3,1
KR_6755571987,420,-1,20,-7,2,-5,0,5,4,5,1,2,2,0,0,2,2,1,1,0,1,6,-106,3,3,6,-4,0,0,1,-1,-1,1,5,1
KR_6777829058,420,7,49,65,14,2,3,1,3,5,2,5,5,0,3,5,2,1,4,3,0,14,3,-8,12,4,2,0,2,0,1,1,1,0,1
KR_6777675642,420,1,16,19,1,-1,1,2,-2,1,3,2,4,2,-1,0,1,3,3,0,0,-2,-11,-3,9,6,4,0,2,1,1,1,1,6,1
KR_6776557704,420,2,46,-9,12,4,6,2,0,2,2,-2,2,4,10,10,0,0,0,0,0,10,9,3,1,4,-2,0,2,1,1,1,1,2,1
KR_6774069139,420,0,-2,-4,-4,-4,1,5,1,2,1,-3,3,6,2,4,2,0,2,2,-1,-8,5,0,5,5,-3,0,-1,1,1,-1,-1,3,1
KR_6774226628,420,4,31,-9,16,4,4,0,0,2,2,1,1,0,8,9,1,3,3,0,0,20,1,1,7,8,7,0,1,0,-1,1,1,0,1
KR_6723684480,420,0,72,36,2,2,4,2,3,5,2,3,6,3,-2,2,4,-4,1,5,2,5,-9,1,4,5,11,0,2,1,1,1,1,6,1
KR_6756229190,420,3,48,-7,7,1,2,1,7,9,2,2,3,1,-3,1,4,0,0,0,0,4,-5,-1,6,5,4,0,0,1,-1,0,1,1,1
KR_6746275387,420,3,66,36,7,-1,0,1,2,4,2,-2,2,4,2,5,3,6,6,0,0,3,-18,2,6,8,4,0,2,1,1,1,1,5,1
KR_6774867871,420,2,-18,11,6,3,3,0,2,5,3,0,0,0,0,0,0,1,1,0,0,7,8,-1,7,6,-7,0,0,-1,1,0,1,2,1
KR_6723607507,420,-1,-70,-8,6,1,3,2,8,8,0,2,3,1,-6,0,6,1,2,1,0,3,-5,1,5,6,3,0,0,1,-1,1,-1,3,1
KR_6775832304,420,1,-42,2,0,-1,0,1,0,2,2,1,4,3,0,1,1,0,0,0,-1,-1,-15,0,6,6,-3,0,-2,1,-1,-1,-1,3,1
KR_6776437018,420,0,-22,13,3,-2,1,3,3,5,2,1,2,1,0,1,1,1,1,0,0,2,-5,-1,5,4,-4,0,-1,1,-1,-1,1,6,1
KR_6723741410,420,4,68,16,11,0,1,1,4,6,2,6,9,3,0,3,3,1,2,1,0,22,1,-3,9,6,6,0,0,1,1,1,-1,1,1
KR_6749414599,440,-2,13,-25,-6,3,4,1,-1,3,4,0,1,1,2,3,1,-10,0,10,-3,-14,-8,-2,6,4,-4,0,-2,0,-1,-1,-1,0,1
KR_6768796356,420,2,27,19,8,5,8,3,0,3,3,0,2,2,2,3,1,1,2,1,0,3,-19,1,7,8,5,0,3,-1,1,1,-1,3,1
KR_6770240634,440,5,60,20,6,4,6,2,2,6,4,4,4,0,-1,1,2,-3,3,6,3,12,22,0,6,6,-2,0,2,0,0,1,1,0,1
KR_6751070176,440,-1,-32,-26,1,5,6,1,-3,1,4,4,9,5,-2,2,4,-3,2,5,0,5,-5,4,5,9,-5,0,0,-1,1,0,-1,3,1
KR_6774502155,420,-3,-37,-22,-4,1,3,2,-2,1,3,-1,1,2,-1,1,2,-1,0,1,0,-6,265,6,7,13,-2,0,-2,1,1,-1,1,4,1
KR_6776968368,420,5,20,-1,5,2,2,0,-1,3,4,-1,0,1,-1,4,5,6,6,0,0,3,1,2,3,5,0,0,2,-1,1,1,1,3,1
KR_6770162302,420,4,53,-4,10,-4,1,5,7,8,1,4,7,3,2,9,7,1,2,1,1,11,-17,0,6,6,1,0,2,1,1,1,1,6,1
KR_6733654761,420,0,24,8,-1,-4,3,7,-1,4,5,1,3,2,5,5,0,-2,0,2,0,-6,1,-1,7,6,-1,0,1,1,1,1,-1,6,1
KR_6768180463,420,-2,0,3,-5,-2,0,2,-1,1,2,-3,1,4,0,3,3,1,1,0,0,-10,1,1,6,7,-1,0,-1,-1,1,-1,1,4,1
KR_6765254801,420,3,-14,7,7,-3,2,5,1,2,1,7,7,0,1,4,3,1,1,0,0,17,181,-1,5,4,10,0,1,-1,1,1,1,6,1
KR_6736345632,420,1,20,1,10,1,1,0,-4,1,5,6,9,3,3,5,2,4,4,0,0,2,3,2,4,6,2,0,2,1,1,1,1,2,1
KR_6770641901,420,-1,6,5,-2,-4,3,7,-5,3,8,1,2,1,6,6,0,0,0,0,0,-1,39,2,8,10,7,0,1,1,1,1,-1,1,1
KR_6719034555,420,3,48,31,7,5,6,1,2,3,1,1,4,3,0,3,3,-1,1,2,0,10,-66,-5,8,3,-5,0,3,-1,1,1,1,4,1
KR_6776148326,420,0,11,-1,0,0,1,1,-1,3,4,-7,1,8,6,6,0,2,3,1,1,7,42,5,4,9,-1,0,2,-1,1,1,1,4,1
KR_6752475333,420,2,26,8,6,5,6,1,1,2,1,4,7,3,-3,3,6,-1,2,3,1,-5,-9,1,5,6,-6,0,1,-1,1,1,1,4,1
KR_6736951850,420,0,8,17,2,1,1,0,-2,3,5,-1,4,5,4,7,3,0,1,1,0,9,62,6,4,10,-25,0,1,1,1,1,1,5,1
KR_6737118713,420,3,57,32,6,0,0,0,-1,1,2,1,5,4,2,2,0,4,6,2,0,14,-47,-3,6,3,26,0,1,-1,1,1,1,2,1
KR_6772364192,420,3,4,5,7,-5,1,6,7,12,5,-2,3,5,8,12,4,-1,0,1,0,12,10,5,4,9,-3,0,0,-1,1,1,1,4,1
KR_6775975430,420,0,0,-4,6,1,2,1,3,4,1,0,1,1,1,4,3,1,1,0,0,7,256,3,7,10,-4,0,0,1,0,0,-1,6,1
KR_6740667388,420,4,66,35,5,6,6,0,0,2,2,-4,1,5,3,4,1,0,0,0,0,5,-13,0,6,6,0,0,2,-1,1,1,1,1,1
KR_6776816749,420,3,74,11,11,2,3,1,3,4,1,1,3,2,5,5,0,0,1,1,0,13,-34,-4,9,5,-3,0,2,1,-1,1,1,4,1
KR_6757015901,420,-2,3,46,-12,-7,0,7,-1,1,2,-3,3,6,1,3,2,-2,0,2,0,-10,-6,-8,12,4,2,0,-3,-1,-1,-1,1,1,1
KR_6776325322,420,2,-20,35,4,-3,1,4,3,3,0,1,3,2,3,3,0,0,0,0,0,-1,37,0,5,5,-5,0,2,1,1,1,1,6,1
KR_6699287751,420,3,62,4,4,2,3,1,2,6,4,2,3,1,-2,3,5,0,1,1,0,2,-140,0,7,7,2,0,2,-1,1,1,-1,3,1
KR_6768644492,420,6,30,16,12,2,3,1,1,2,1,3,3,0,1,3,2,5,5,0,0,15,26,7,3,10,-5,0,2,-1,1,1,1,2,1
KR_6758396127,420,3,2,23,10,0,2,2,2,3,1,2,2,0,4,4,0,2,2,0,0,11,27,0,5,5,-4,0,0,0,1,-1,1,0,1
KR_6777829514,420,-3,-15,1,-7,-2,0,2,-1,3,4,-3,2,5,0,4,4,-1,0,1,0,-9,-9,-3,9,6,3,0,0,-1,-1,0,-1,6,1
KR_6750626655,420,0,-52,26,-8,2,3,1,-4,2,6,-4,2,6,-5,1,6,3,4,1,-1,-12,-10,0,7,7,-1,0,-1,1,1,-1,-1,1,1
KR_6775723072,420,2,24,7,-3,-3,2,5,-5,0,5,4,5,1,1,3,2,0,1,1,0,1,-3,1,8,9,2,0,2,1,1,1,-1,6,1
KR_6758456807,440,5,81,27,14,2,3,1,3,5,2,0,3,3,8,11,3,1,4,3,-1,13,-2,-1,4,3,5,0,1,1,1,1,-1,2,1
KR_6742748701,420,2,40,4,5,7,7,0,-1,3,4,-1,1,2,1,5,4,-1,1,2,-1,4,-38,-5,8,3,1,0,3,1,1,1,-1,4,1
KR_6769009808,420,-1,48,-48,-2,-1,0,1,-2,2,4,3,4,1,-1,2,3,-1,0,1,0,5,-207,-3,8,5,1,0,0,-1,-1,0,1,1,1
KR_6775809111,420,1,31,0,4,1,1,0,4,5,1,-1,1,2,-1,5,6,1,2,1,0,1,-6,-1,7,6,-1,0,1,-1,1,1,1,6,1
KR_6746163667,420,3,14,15,0,0,1,1,4,7,3,-2,1,3,3,8,5,-5,0,5,-1,-1,-8,-3,9,6,6,0,0,-1,-1,-1,-1,3,1
KR_6739528540,420,0,17,14,0,1,3,2,2,3,1,3,4,1,-4,1,5,-2,0,2,-1,-4,39,0,5,5,-3,0,0,-1,1,0,-1,6,1
KR_6748314713,420,4,73,24,5,4,5,1,2,5,3,-4,2,6,3,5,2,0,0,0,-1,7,3,-1,9,8,-3,0,0,-1,1,0,-1,6,1
KR_6769693749,420,3,20,-8,8,5,6,1,-3,2,5,7,8,1,-1,0,1,0,0,0,0,6,4,1,6,7,2,0,0,-1,1,1,1,6,1
KR_6775839045,420,5,43,3,7,2,3,1,-4,0,4,7,8,1,1,3,2,1,1,0,1,7,12,-2,7,5,5,0,1,1,-1,1,1,4,1
KR_6756138342,420,3,40,-1,10,2,2,0,5,7,2,2,2,0,0,2,2,1,3,2,0,10,0,-2,7,5,0,0,1,1,1,1,1,5,1
KR_6766860189,420,-2,-16,-14,-1,-5,1,6,-4,2,6,-2,2,4,8,10,2,2,4,2,0,8,-11,-3,5,2,-3,0,2,-1,1,1,1,4,1
KR_6776556877,420,1,-24,18,7,0,2,2,3,5,2,2,3,1,3,6,3,-1,1,2,0,8,349,3,4,7,-2,0,1,1,1,1,-1,3,1
KR_6764932813,420,2,44,16,3,0,0,0,-1,1,2,1,1,0,5,6,1,-2,1,3,0,4,6,2,5,7,-2,0,2,1,1,1,1,5,1
KR_6773495356,440,4,63,29,12,1,4,3,11,12,1,4,4,0,-3,0,3,-1,3,4,2,12,-359,2,1,3,-3,0,-1,1,-1,1,1,2,1
KR_6745600706,420,1,-3,0,5,-1,0,1,0,2,2,2,2,0,1,4,3,3,3,0,0,6,6,3,4,7,-6,0,1,0,-1,-1,-1,0,1
KR_6770099509,420,3,5,28,7,-2,1,3,5,7,2,3,5,2,1,2,1,0,2,2,0,8,-13,4,2,6,3,0,1,1,1,1,-1,2,1
KR_6754326653,420,2,42,4,3,-2,1,3,-5,0,5,0,0,0,11,12,1,-1,0,1,0,6,9,6,5,11,-3,0,0,1,-1,0,-1,6,1
KR_6777053708,420,2,7,28,7,2,5,3,0,0,0,4,5,1,1,4,3,0,0,0,0,6,11,-2,8,6,-7,0,1,1,1,1,-1,5,1
KR_6752353065,420,-4,-30,-8,-5,-3,0,3,2,2,0,-3,2,5,1,8,7,-2,1,3,-2,-9,-7,1,7,8,-6,0,-1,1,-1,-1,-1,6,1
KR_6766824114,420,0,-2,39,1,1,2,1,0,1,1,3,5,2,-4,2,6,1,2,1,0,-4,-2,-4,8,4,5,0,0,1,1,-1,-1,3,1
KR_6725025997,420,-3,57,-15,-7,-3,1,4,-2,2,4,-1,1,2,1,5,4,-2,1,3,-1,-11,-1,0,4,4,-5,0,0,1,-1,-1,-1,5,1
KR_6756208631,420,2,83,-4,6,-2,2,4,3,4,1,-1,1,2,6,8,2,0,3,3,2,9,10,2,2,4,-3,0,0,-1,-1,0,1,2,1
KR_6764317378,420,3,4,3,6,2,3,1,-2,6,8,3,5,2,2,4,2,1,1,0,0,12,101,-5,9,4,1,0,1,1,1,1,-1,2,1
KR_6774391970,420,-1,-82,8,2,-5,1,6,4,4,0,5,6,1,-1,4,5,-1,0,1,-1,1,123,-2,5,3,2,0,1,1,-1,1,1,2,1
KR_6774707688,420,0,35,32,6,-3,0,3,4,4,0,2,4,2,1,5,4,2,2,0,0,8,288,-1,6,5,0,0,2,-1,-1,1,1,6,1
KR_6761684770,420,1,-19,-5,0,2,3,1,-1,3,4,0,2,2,-3,1,4,2,2,0,1,-4,-24,4,4,8,2,0,1,1,1,1,1,1,1
KR_6770668940,420,4,7,-5,6,5,6,1,-1,2,3,2,3,1,-1,0,1,1,2,1,0,8,-29,3,3,6,-3,0,1,-1,1,1,-1,1,1
KR_6775359320,420,4,59,12,15,3,4,1,0,3,3,3,5,2,7,7,0,2,3,1,0,14,17,3,5,8,0,0,2,1,1,1,1,5,1
KR_6766723536,440,2,10,8,-1,0,1,1,0,3,3,0,1,1,-1,0,1,0,0,0,0,1,26,-1,8,7,0,0,0,-1,-1,0,-1,4,1
KR_6777134088,420,0,-4,9,3,1,4,3,1,2,1,0,2,2,1,2,1,0,1,1,0,4,-2,0,5,5,1,0,2,1,-1,1,-1,2,1
KR_6736586265,420,5,62,9,10,6,6,0,2,4,2,2,2,0,0,1,1,0,0,0,0,10,-38,2,3,5,15,0,1,-1,1,1,1,2,1
KR_6776503958,420,1,32,12,3,0,2,2,2,5,3,3,4,1,-1,1,2,-1,0,1,0,3,-4,-2,7,5,0,0,-1,1,-1,-1,1,3,1
KR_6728519960,420,4,36,-16,13,-3,0,3,4,6,2,5,6,1,8,9,1,-1,0,1,1,19,1,12,0,12,-2,0,2,0,1,1,1,0,1
KR_6715005277,440,1,-47,0,-4,3,4,1,-7,4,11,2,2,0,-2,2,4,0,0,0,0,0,-17,1,3,4,-6,0,-1,-1,1,-1,-1,6,1
KR_6774447839,420,-1,26,-6,-3,0,2,2,-3,3,6,-3,1,4,0,4,4,3,4,1,0,-7,2,2,8,10,-7,0,2,-1,-1,1,-1,4,1
KR_6777258487,420,0,29,8,-5,-2,1,3,-3,0,3,-1,2,3,2,3,1,-1,1,2,0,-9,-3,1,5,6,-3,0,0,1,1,0,1,3,1
KR_6709670040,420,6,87,6,11,0,4,4,5,6,1,2,2,0,3,5,2,1,2,1,0,20,-7,-4,10,6,6,0,2,-1,1,1,1,1,1
KR_6773261653,420,-5,-77,-18,-5,-3,2,5,1,4,3,-3,1,4,1,4,3,-1,0,1,-3,-2,-17,-4,5,1,-2,0,-1,1,-1,-1,-1,4,1
KR_6774800661,420,4,-7,20,6,0,3,3,5,8,3,0,3,3,-1,3,4,2,4,2,1,5,-5,-3,8,5,4,0,1,1,1,1,1,1,1
KR_6712122355,420,2,-49,18,4,0,2,2,0,4,4,-4,0,4,5,5,0,3,4,1,0,2,3,3,4,7,-2,0,1,1,1,1,1,3,1
KR_6776279059,420,1,20,14,-8,1,2,1,-3,5,8,-5,1,6,-1,1,2,0,1,1,1,-11,0,-6,12,6,1,0,-1,1,-1,-1,1,4,1
KR_6759528513,440,1,47,25,3,2,4,2,0,2,2,1,1,0,-1,1,2,1,1,0,0,8,-4,-6,7,1,3,0,0,0,0,0,1,0,1
KR_6777580072,420,6,45,11,10,-1,1,2,1,2,1,4,6,2,5,5,0,1,1,0,0,17,0,-1,6,5,6,0,3,1,1,1,-1,4,1
KR_6774111023,420,0,-24,-7,-4,-1,1,2,-5,0,5,-2,1,3,0,1,1,4,4,0,0,-8,27,-2,7,5,-5,0,0,1,1,1,-1,2,1
KR_6777362873,420,6,33,3,13,-2,3,5,4,6,2,3,4,1,6,6,0,2,2,0,1,27,6,-1,9,8,-4,0,1,1,-1,1,1,2,1
KR_6775710895,420,2,-11,-7,2,1,1,0,-1,0,1,-1,4,5,1,2,1,2,2,0,0,3,-6,1,2,3,-2,0,0,1,1,0,1,4,1
KR_6776317558,440,1,50,1,2,-3,1,4,-3,0,3,2,2,0,6,8,2,0,1,1,-1,7,-8,-2,6,4,-3,0,-1,1,-1,-1,-1,5,1
KR_6731127902,440,1,20,-8,6,4,4,0,-1,2,3,-5,1,6,6,8,2,2,4,2,0,9,103,-2,6,4,3,0,0,-1,1,0,1,4,1
KR_6763278482,440,-1,14,-8,-7,-4,1,5,1,2,1,-1,3,4,0,4,4,-3,0,3,0,-9,4,-1,5,4,3,0,1,1,-1,1,-1,4,1
KR_6709020621,420,-1,8,14,0,2,4,2,-2,0,2,-3,1,4,3,4,1,0,1,1,0,-7,2,-2,10,8,-2,0,1,1,1,1,1,1,1
KR_6742292092,440,1,106,3,1,-3,3,6,0,1,1,1,3,2,2,3,1,1,1,0,0,-6,-23,0,5,5,1,0,1,-1,1,1,-1,1,1
KR_6777878645,440,5,75,27,-3,-2,4,6,-2,0,2,5,6,1,-1,4,5,-3,2,5,-1,-7,14,1,6,7,2,0,1,1,1,1,-1,3,1
KR_6747918810,420,0,27,0,4,0,1,1,-2,0,2,4,5,1,3,4,1,-1,0,1,2,15,6,3,1,4,-2,0,0,1,-1,0,1,2,1
KR_6727218886,420,12,127,20,20,8,8,0,2,2,0,3,6,3,7,9,2,0,2,2,1,12,3,2,5,7,1,0,0,1,1,1,1,1,1
KR_6745411142,420,1,23,21,-1,-3,1,4,2,4,2,0,3,3,0,1,1,0,1,1,0,-11,-6,-3,9,6,5,0,2,1,1,1,1,5,1
KR_6716783272,420,3,75,5,8,-1,1,2,9,11,2,-1,2,3,0,4,4,1,1,0,0,10,-18,1,7,8,5,0,0,1,-1,1,-1,6,1
KR_6777800789,420,-2,19,-25,-3,2,4,2,-1,0,1,-2,6,8,-2,2,4,0,1,1,0,-5,12,1,8,9,-3,0,0,-1,-1,1,-1,5,1
KR_6776390328,420,1,-16,4,7,1,3,2,4,4,0,2,3,1,-1,5,6,1,1,0,0,9,14,7,1,8,-6,0,0,1,-1,-1,1,4,1
KR_6695022370,420,1,37,18,-2,-1,1,2,-6,0,6,-4,0,4,7,10,3,2,2,0,-1,-10,28,3,4,7,-7,0,2,-1,-1,1,1,6,1
KR_6775217598,420,6,47,40,4,1,1,0,-1,3,4,1,1,0,-4,1,5,7,8,1,0,-3,-82,9,4,13,1,0,-1,-1,1,-1,-1,5,1
KR_6777539863,420,2,34,-32,9,-2,0,2,0,2,2,5,5,0,3,5,2,3,4,1,0,13,49,3,5,8,-16,0,0,1,-1,0,1,3,1
KR_6719223252,420,-1,24,-8,-1,0,1,1,-3,0,3,-1,3,4,2,4,2,1,3,2,0,-6,-8,5,5,10,1,0,1,1,-1,1,-1,5,1
KR_6776052510,420,0,25,28,-3,0,2,2,2,3,1,2,2,0,-5,0,5,-2,0,2,0,-2,-2,2,6,8,0,0,1,-1,1,1,-1,6,1
KR_6774422566,420,1,-6,15,12,2,4,2,0,6,6,-1,3,4,9,10,1,2,3,1,0,20,-7,-3,9,6,4,0,0,1,-1,1,1,3,1
KR_6747314925,420,2,-75,25,10,1,3,2,5,6,1,1,1,0,-1,2,3,4,5,1,0,11,8,1,8,9,3,0,0,1,1,0,-1,2,1
KR_6746659598,420,6,66,18,18,2,2,0,5,5,0,4,5,1,5,7,2,2,2,0,0,20,7,7,2,9,6,0,2,1,1,1,1,6,1
KR_6777302061,420,4,5,9,12,0,0,0,-3,3,6,4,5,1,10,12,2,1,1,0,2,18,42,-5,11,6,7,0,1,1,1,1,1,5,1
KR_6761882169,420,2,17,8,1,-1,0,1,5,6,1,2,2,0,-1,3,4,-4,1,5,1,14,186,1,8,9,2,0,1,-1,1,1,1,5,1
KR_6774183256,420,9,113,9,13,2,3,1,1,1,0,0,2,2,10,12,2,0,0,0,-1,11,2,2,6,8,6,0,3,1,1,1,-1,4,1
KR_6723183635,420,1,22,0,10,2,2,0,4,6,2,2,2,0,1,2,1,1,2,1,0,12,-2,2,4,6,2,0,0,1,-1,1,1,2,1
KR_6738993219,420,0,-7,12,1,5,6,1,-2,1,3,1,2,1,-3,1,4,0,0,0,0,1,-12,4,4,8,-5,0,1,1,1,1,-1,1,1
KR_6776052718,420,0,-27,12,-3,1,3,2,-1,3,4,-3,3,6,-2,1,3,2,4,2,0,0,-3,3,4,7,0,0,0,1,-1,0,-1,1,1
KR_6756518567,420,2,39,0,0,0,0,0,-2,1,3,2,4,2,-1,3,4,1,1,0,0,-4,-342,-3,8,5,2,0,0,-1,-1,0,1,6,1
KR_6777769467,420,0,9,-15,-1,-1,1,2,4,6,2,-1,1,2,-4,0,4,1,1,0,0,-1,-13,-5,11,6,5,0,0,1,1,1,-1,2,1
KR_6763663446,420,5,3,9,17,2,6,4,7,7,0,1,1,0,6,8,2,1,2,1,1,18,6,0,7,7,2,0,1,1,1,1,1,4,1
KR_6777390088,420,0,4,0,11,1,1,0,6,6,0,3,5,2,3,5,2,-2,1,3,0,19,9,7,3,10,1,0,0,1,1,1,1,6,1
KR_6770889291,420,5,59,19,13,-1,1,2,7,7,0,0,2,2,7,7,0,0,0,0,0,16,9,9,5,14,3,0,3,1,-1,1,1,2,1
KR_6776673261,420,2,13,22,1,0,1,1,1,1,0,-2,1,3,0,1,1,2,2,0,0,1,-10,-3,11,8,6,0,0,1,-1,0,1,6,1
KR_6754663081,420,5,34,4,12,3,3,0,1,4,3,3,4,1,3,4,1,2,2,0,0,5,39,4,0,4,2,0,2,-1,1,1,-1,2,1
KR_6758827719,420,0,-58,18,2,2,3,1,0,1,1,5,7,2,-5,0,5,0,1,1,0,2,-10,2,4,6,-8,0,0,1,1,-1,-1,3,1
KR_6735474607,420,2,-32,21,8,-1,1,2,2,5,3,3,5,2,3,4,1,1,1,0,3,14,11,2,6,8,1,0,0,1,1,0,1,5,1
KR_6772335145,420,3,44,28,5,0,3,3,0,3,3,1,4,3,5,5,0,-1,0,1,0,9,36,3,4,7,-6,0,1,-1,1,1,1,5,1
KR_6777623199,420,-3,-15,-28,-10,2,4,2,-4,2,6,-2,1,3,-5,0,5,-1,1,2,0,-10,-13,1,6,7,1,0,0,-1,-1,0,-1,4,1
KR_6774504509,420,1,39,-28,-4,-4,2,6,-1,3,4,4,4,0,0,6,6,-3,0,3,0,-4,-3,0,4,4,0,0,-1,1,-1,-1,-1,6,1
KR_6772438441,420,3,41,28,5,-1,1,2,0,3,3,2,3,1,2,4,2,2,2,0,0,6,5,4,3,7,-2,0,0,1,1,0,-1,4,1
KR_6774025434,420,-3,5,0,-4,1,1,0,-3,1,4,0,0,0,-2,2,4,0,0,0,0,-6,-15,1,4,5,5,0,0,-1,1,-1,-1,1,1
KR_6707445752,420,3,45,-11,5,0,0,0,1,3,2,2,4,2,1,3,2,1,2,1,0,-3,4,1,7,8,-1,0,0,1,-1,1,1,6,1
KR_6770117291,420,0,-38,-11,0,1,2,1,0,3,3,0,0,0,0,2,2,-1,1,2,0,1,-2,0,8,8,-2,0,-1,-1,-1,-1,-1,1,1
KR_6772679753,440,-1,84,21,0,0,2,2,-4,1,5,3,5,2,1,3,2,0,0,0,-1,-3,1,-4,8,4,2,0,0,0,-1,1,-1,0,1
KR_6770254630,420,0,-39,1,5,4,4,0,2,3,1,2,2,0,-2,0,2,-1,0,1,0,3,-6,2,7,9,1,0,1,1,1,1,1,4,1
KR_6775550495,420,2,37,9,2,3,4,1,-1,2,3,2,3,1,0,2,2,-2,0,2,0,5,0,5,4,9,0,0,1,1,1,1,-1,6,1
KR_6773978372,420,2,86,-17,9,4,4,0,3,7,4,2,5,3,3,6,3,-3,0,3,0,12,-2,-1,6,5,5,0,1,-1,-1,1,1,3,1
KR_6713543903,420,-1,-35,-8,5,3,5,2,-7,3,10,3,4,1,3,4,1,3,3,0,0,7,11,0,5,5,-4,0,-2,1,-1,-1,-1,1,1
KR_6724098761,420,6,58,19,11,0,2,2,6,10,4,1,3,2,5,5,0,-1,2,3,1,22,-2,-1,6,5,4,0,2,-1,1,1,1,2,1
KR_6715939407,420,1,-54,-1,6,1,2,1,4,7,3,1,4,3,0,6,6,0,0,0,-1,6,-68,-3,5,2,11,0,0,1,-1,-1,-1,5,1
KR_6769409246,420,2,45,21,5,-5,1,6,4,8,4,3,6,3,0,3,3,3,4,1,-1,4,1,-3,8,5,-3,0,1,-1,1,1,-1,5,1
KR_6708063137,420,2,-1,18,-2,1,1,0,-4,1,5,-2,3,5,4,5,1,-1,1,2,0,5,-17,-1,7,6,2,0,0,-1,1,1,1,4,1
KR_6687671903,420,7,152,34,16,1,2,1,6,6,0,5,6,1,5,5,0,-1,0,1,0,27,43,4,4,8,1,0,5,1,1,1,1,1,1
KR_6774236920,420,4,57,39,15,4,5,1,6,9,3,3,5,2,3,5,2,-1,0,1,0,14,8,-3,5,2,-2,0,0,1,-1,1,1,6,1
KR_6766604169,420,3,82,4,14,0,1,1,9,12,3,6,7,1,0,0,0,-1,0,1,0,9,18,6,2,8,3,0,2,1,1,1,1,6,1
KR_6776778658,420,4,45,1,11,3,6,3,3,4,1,4,4,0,2,3,1,-1,0,1,0,7,6,1,3,4,-3,0,0,1,1,1,1,1,1
KR_6771386702,420,1,14,-4,4,3,3,0,0,2,2,1,2,1,1,4,3,-1,1,2,0,1,-1,3,7,10,5,0,1,-1,1,1,1,6,1
KR_6764118303,420,1,-44,-19,8,2,3,1,6,7,1,0,4,4,2,2,0,-2,0,2,0,18,-5,-4,10,6,2,0,0,1,1,0,-1,5,1
KR_6776100707,420,0,29,-21,1,-3,0,3,-1,0,1,2,5,3,0,1,1,3,3,0,0,3,-16,-2,6,4,1,0,1,-1,-1,1,-1,3,1
KR_6750626291,420,0,30,19,-1,0,0,0,-2,1,3,1,3,2,0,2,2,0,0,0,0,-4,-36,-3,7,4,-3,0,1,-1,1,1,1,1,1
KR_6754289341,420,-1,14,-11,0,1,2,1,-2,1,3,0,1,1,2,3,1,-1,0,1,0,-4,7,-1,7,6,-3,0,1,-1,1,1,-1,1,1
KR_6734202386,420,6,-9,6,12,-1,2,3,0,3,3,6,8,2,1,4,3,6,8,2,2,15,-4,1,8,9,1,0,-2,1,1,1,1,4,1
KR_6776910715,420,3,38,-14,14,4,5,1,3,3,0,2,2,0,6,7,1,-1,2,3,1,19,-5,-8,13,5,6,0,2,-1,1,1,1,1,1
KR_6766045640,420,4,-5,18,12,1,2,1,2,2,0,-2,1,3,6,7,1,5,5,0,1,11,49,1,7,8,7,0,1,1,1,1,1,1,1
KR_6776139756,420,3,65,14,13,2,3,1,5,6,1,1,3,2,4,5,1,1,1,0,0,9,-3,1,7,8,5,0,1,1,-1,1,1,6,1
KR_6733898712,420,1,15,-33,5,-2,0,2,1,3,2,-1,1,2,7,7,0,0,0,0,0,12,1,-4,8,4,2,0,-1,1,-1,-1,1,2,1
KR_6765503708,420,2,56,-3,4,3,4,1,-1,2,3,5,7,2,-2,1,3,-1,0,1,0,-6,5,3,5,8,-2,0,0,1,1,1,1,1,1
KR_6775457415,420,3,34,-5,6,3,5,2,4,6,2,2,2,0,-3,2,5,0,1,1,-1,12,4,4,3,7,0,0,0,-1,1,1,1,5,1
KR_6769730526,420,1,-26,-11,4,-2,0,2,5,6,1,-1,1,2,1,5,4,1,1,0,-2,1,336,2,3,5,-3,0,0,-1,-1,0,-1,2,1
KR_6765430896,420,4,37,34,7,0,1,1,6,6,0,2,3,1,-2,3,5,1,2,1,0,10,33,0,6,6,0,0,1,1,-1,1,-1,1,1
KR_6746727979,440,10,107,40,23,5,7,2,4,4,0,2,2,0,7,10,3,5,6,1,0,20,-399,3,1,4,-2,0,2,-1,1,1,1,6,1
KR_6710409448,420,-3,78,-30,-3,-2,4,6,1,5,4,1,1,0,-2,2,4,-1,1,2,0,-6,-14,1,6,7,1,0,-1,1,-1,-1,1,5,1
KR_6739630986,420,-3,-68,12,1,-3,1,4,0,3,3,2,3,1,0,1,1,2,2,0,1,9,2,2,7,9,-3,0,-2,-1,-1,-1,1,5,1
KR_6739912663,420,6,110,34,10,3,3,0,1,5,4,2,2,0,5,5,0,-1,2,3,0,22,-88,-7,11,4,6,0,3,1,1,1,1,4,1
KR_6766830369,420,-2,-9,-27,6,0,1,1,0,4,4,3,4,1,3,4,1,0,1,1,0,6,17,4,4,8,-4,0,0,1,1,0,1,6,1
KR_6767271150,420,1,3,-33,5,3,3,0,-5,1,6,1,4,3,6,8,2,0,1,1,-3,0,-59,4,7,11,0,0,0,1,1,1,-1,4,1
KR_6743716711,420,-1,15,-21,-3,0,0,0,-1,1,2,1,2,1,-2,2,4,-1,0,1,0,-2,15,3,5,8,-6,0,0,-1,-1,0,-1,2,1
KR_6743064810,420,0,-44,16,5,-2,1,3,1,2,1,5,5,0,0,1,1,1,2,1,0,18,-11,-2,8,6,9,0,-1,1,-1,-1,-1,2,1
KR_6746906116,420,-1,-8,3,0,3,3,0,-4,2,6,-5,2,7,5,5,0,1,1,0,0,2,5,0,7,7,2,0,-1,-1,-1,-1,1,6,1
KR_6709225392,420,2,17,-8,6,1,2,1,1,5,4,0,2,2,1,2,1,3,4,1,1,5,-101,0,10,10,5,0,-1,-1,-1,-1,1,6,1
KR_6777763836,440,2,72,12,13,2,2,0,1,4,3,5,7,2,-2,3,5,7,7,0,0,11,-13,4,2,6,-1,0,0,-1,-1,1,1,1,1
KR_6727394191,420,-1,-30,21,-16,-1,2,3,-11,1,12,-1,5,6,-3,2,5,0,1,1,-1,-17,-9,-5,6,1,1,0,-4,-1,1,-1,-1,4,1
KR_6726997358,420,3,56,-12,7,3,4,1,0,2,2,-4,2,6,7,7,0,1,1,0,0,9,41,-1,8,7,1,0,2,1,-1,1,1,2,1
KR_6777072168,420,1,-36,9,5,3,3,0,-1,1,2,5,5,0,0,1,1,-2,0,2,0,5,106,-4,8,4,1,0,0,1,1,0,1,4,1
KR_6773353573,420,5,67,-5,18,4,5,1,3,4,1,4,6,2,6,6,0,1,1,0,-1,12,-28,1,5,6,0,0,2,1,1,1,-1,6,1
KR_6757312609,420,1,-25,-9,3,-4,0,4,2,8,6,1,1,0,4,4,0,0,1,1,0,9,-13,3,2,5,0,0,0,1,1,0,-1,2,1
KR_6775246933,420,4,-33,22,5,-1,0,1,3,4,1,0,1,1,1,4,3,2,3,1,0,7,10,7,3,10,-7,0,1,1,1,1,1,6,1
KR_6746565932,420,2,54,-13,14,5,8,3,5,8,3,2,3,1,1,4,3,1,1,0,0,9,-25,1,9,10,3,0,0,1,1,1,1,4,1
KR_6756573036,420,3,36,20,9,1,2,1,2,3,1,1,4,3,2,4,2,3,3,0,0,16,11,3,5,8,2,0,0,1,1,1,1,4,1
KR_6740698580,420,0,67,-36,7,2,3,1,-3,1,4,5,7,2,0,1,1,3,3,0,5,15,115,6,4,10,-6,0,1,-1,-1,1,1,2,1
KR_6711933488,420,5,27,0,10,5,5,0,-3,1,4,3,5,2,4,6,2,1,2,1,0,12,-4,-3,9,6,3,0,2,1,1,1,1,4,1
KR_6747015685,420,1,38,12,-1,-2,1,3,1,4,3,3,4,1,-3,1,4,0,1,1,0,-1,-59,3,5,8,0,0,-1,-1,-1,-1,-1,3,1
KR_6711446510,420,3,36,-23,11,2,2,0,3,4,1,3,4,1,3,5,2,0,0,0,0,12,-71,0,7,7,0,0,1,0,1,1,1,0,1
KR_6745538448,440,0,61,-2,-10,0,3,3,-5,4,9,4,4,0,-8,0,8,-1,0,1,0,-14,-29,1,4,5,-2,0,0,-1,-1,-1,-1,5,1
KR_6777835085,420,2,51,-4,3,2,3,1,3,4,1,0,4,4,0,3,3,-2,1,3,0,-2,12,1,5,6,5,0,0,1,-1,0,1,2,1
KR_6774417401,420,-4,-31,11,0,1,4,3,7,7,0,-3,1,4,-5,0,5,0,2,2,0,0,-7,2,6,8,6,0,0,1,1,0,-1,1,1
KR_6748627297,420,1,-36,-3,2,1,1,0,-1,3,4,2,3,1,-1,2,3,1,1,0,-1,-1,-8,1,9,10,6,0,-1,-1,-1,-1,-1,5,1
KR_6699371474,420,-1,-4,19,0,-2,0,2,2,3,1,-2,1,3,3,6,3,-1,0,1,3,-4,-2,3,2,5,3,0,0,1,1,-1,1,4,1
KR_6750486595,420,7,143,7,17,0,2,2,8,8,0,4,5,1,5,5,0,0,1,1,0,15,3,7,2,9,2,0,4,1,1,1,1,6,1
KR_6760169209,420,-1,-64,-24,2,-1,3,4,-2,3,5,3,7,4,-1,1,2,3,5,2,-2,1,48,2,4,6,-2,0,-1,0,1,-1,-1,0,1
KR_6767180752,420,-1,-45,5,1,-1,1,2,0,3,3,1,2,1,1,5,4,0,0,0,0,3,-1,-3,7,4,2,0,0,1,1,1,-1,4,1
KR_6773201093,420,-1,-30,26,3,3,5,2,6,9,3,0,8,8,-8,2,10,2,2,0,1,-3,-9,0,7,7,-2,0,2,0,1,1,-1,0,1
KR_6747840451,420,0,-63,43,-5,0,2,2,2,2,0,-3,1,4,-1,4,5,-3,0,3,0,4,27,8,3,11,-4,0,0,-1,1,-1,-1,6,1
KR_6771365872,440,-2,-8,15,-6,0,0,0,-6,3,9,1,7,6,-2,5,7,1,1,0,0,-4,-4,-3,6,3,5,0,0,1,-1,0,1,5,1
KR_6713015501,420,4,61,1,4,1,1,0,1,2,1,-2,2,4,4,5,1,0,1,1,0,4,-27,3,9,12,0,0,0,1,-1,1,-1,2,1
KR_6736181465,420,2,70,63,10,3,3,0,9,10,1,1,1,0,-3,2,5,0,0,0,2,8,5,2,6,8,-6,0,3,1,1,1,1,6,1
KR_6775604798,420,3,49,1,4,3,4,1,-3,2,5,1,2,1,3,4,1,0,0,0,0,2,-4,1,5,6,4,0,2,1,1,1,1,6,1
KR_6777611822,420,0,-8,-12,-1,1,2,1,5,7,2,1,2,1,-7,0,7,-1,1,2,0,3,266,2,2,4,-2,0,1,-1,1,-1,1,5,1
KR_6727761835,420,2,46,-4,5,-2,0,2,3,5,2,-2,0,2,6,6,0,0,1,1,0,17,-93,-8,13,5,2,0,0,1,-1,1,1,5,1
KR_6758959245,420,5,47,12,6,7,8,1,1,2,1,0,1,1,-1,1,2,-1,1,2,0,7,-4,1,4,5,5,0,1,1,1,1,1,5,1
KR_6741612501,420,3,38,12,6,-2,1,3,3,5,2,2,3,1,3,5,2,0,1,1,0,11,-12,0,5,5,-1,0,2,-1,1,1,-1,4,1
KR_6754640192,420,0,-11,16,-3,-4,0,4,-3,0,3,-1,1,2,1,4,3,4,4,0,0,1,0,2,5,7,1,0,-2,1,-1,-1,-1,3,1
KR_6754357722,420,4,1,20,4,3,4,1,-2,2,4,3,4,1,0,2,2,0,2,2,0,-6,-1,-4,8,4,2,0,2,-1,-1,1,-1,6,1
KR_6775335817,420,1,11,32,8,0,1,1,7,9,2,-1,1,2,1,2,1,1,1,0,0,6,0,1,4,5,1,0,0,1,-1,1,1,2,1
KR_6776900328,420,0,67,-11,0,-2,2,4,-4,2,6,3,3,0,0,3,3,3,4,1,0,6,54,-5,7,2,-13,0,3,1,1,1,1,6,1
KR_6699172354,420,-2,-12,-20,-9,8,8,0,-7,1,8,-2,3,5,-5,2,7,-3,0,3,2,-10,7,-2,9,7,2,0,0,1,-1,-1,1,4,1
KR_6764061029,420,2,-22,13,5,3,4,1,3,4,1,3,3,0,-5,1,6,1,2,1,0,-3,-350,-1,8,7,8,0,1,1,1,1,1,4,1
KR_6690315630,420,4,26,35,5,1,1,0,2,5,3,1,2,1,-2,2,4,3,3,0,0,2,-58,3,4,7,-1,0,1,1,1,1,-1,4,1
KR_6768169484,420,2,37,12,8,4,4,0,-1,3,4,3,3,0,1,2,1,1,1,0,0,5,-3,-4,7,3,0,0,0,-1,1,1,1,5,1
KR_6770932718,420,-1,-38,-20,-6,-4,1,5,-7,1,8,-1,1,2,5,9,4,1,2,1,-1,8,5,3,7,10,3,0,-1,1,-1,-1,1,3,1
KR_6736374381,420,3,29,40,8,-1,1,2,3,4,1,1,4,3,3,5,2,2,2,0,1,5,128,5,1,6,3,0,3,-1,-1,1,1,6,1
KR_6726371222,420,2,-14,10,1,2,3,1,0,3,3,-1,3,4,-3,0,3,3,5,2,0,7,-15,-3,8,5,6,0,0,-1,1,-1,1,2,1
KR_6773634956,420,1,53,0,-1,3,3,0,-2,1,3,1,1,0,0,1,1,-3,0,3,0,-1,-8,-3,12,9,5,0,1,-1,1,1,1,6,1
KR_6766131397,420,3,42,-18,3,-1,1,2,6,6,0,0,1,1,-2,2,4,0,0,0,0,4,-3,0,7,7,4,0,0,1,-1,-1,-1,2,1
KR_6761847876,420,4,101,-4,13,5,8,3,1,2,1,2,4,2,3,5,2,2,3,1,2,9,-10,-5,7,2,5,0,2,-1,-1,1,1,5,1
KR_6686586662,420,5,71,52,8,0,1,1,0,3,3,-1,4,5,7,8,1,2,2,0,0,21,42,-3,8,5,1,0,2,1,1,1,1,5,1
KR_6735925340,420,4,23,7,18,9,9,0,3,4,1,0,6,6,4,6,2,2,4,2,1,23,43,1,7,8,-1,0,1,1,1,1,1,5,1
KR_6759738023,420,7,69,5,18,6,7,1,1,2,1,5,5,0,4,5,1,2,3,1,0,23,-30,0,6,6,-2,0,2,-1,1,1,1,1,1
KR_6766142988,420,3,74,-12,6,4,4,0,-2,2,4,5,5,0,-2,1,3,1,2,1,0,0,137,1,7,8,2,0,2,1,1,1,1,3,1
KR_6733460249,420,2,21,-17,2,-1,0,1,1,2,1,2,2,0,-1,0,1,1,1,0,0,-1,-7,-1,7,6,6,0,2,1,1,1,1,2,1
KR_6776154289,440,2,-8,9,6,-7,2,9,5,7,2,0,2,2,4,6,2,4,5,1,0,10,11,1,3,4,0,0,0,-1,1,1,1,1,1
KR_6719298748,420,2,10,24,9,-4,0,4,8,8,0,4,4,0,1,3,2,0,4,4,0,13,35,3,9,12,6,0,0,1,1,-1,-1,1,1
KR_6751730714,420,1,68,25,4,-1,0,1,1,1,0,0,3,3,5,5,0,-1,0,1,0,9,25,-2,10,8,3,0,0,1,-1,0,1,5,1
KR_6777608972,420,1,9,20,1,5,5,0,-2,2,4,0,1,1,-2,1,3,0,0,0,0,6,5,4,2,6,-5,0,1,-1,1,1,1,3,1
KR_6755220512,420,-2,45,-10,-7,0,2,2,-2,3,5,-1,0,1,-2,6,8,-2,0,2,0,-16,10,3,3,6,-4,0,-1,1,-1,-1,-1,3,1
KR_6770964297,420,1,11,45,3,7,7,0,0,4,4,-1,3,4,-3,0,3,0,0,0,0,-2,-2,-2,6,4,2,0,1,1,1,1,1,5,1
KR_6777139223,420,2,46,20,4,-1,1,2,8,9,1,-2,1,3,0,2,2,-1,1,2,0,4,51,5,4,9,-27,0,2,1,1,1,-1,6,1
KR_6716808476,420,1,-27,7,0,0,1,1,0,3,3,1,3,2,-1,3,4,0,0,0,0,0,3,1,7,8,-3,0,-1,-1,1,1,1,4,1
KR_6773001233,420,3,-5,-12,1,2,2,0,-1,2,3,2,5,3,0,4,4,-2,0,2,0,-2,-1,3,5,8,9,0,0,-1,1,-1,1,2,1
KR_6775248780,420,2,32,4,4,2,2,0,2,3,1,4,5,1,-2,2,4,-2,0,2,0,-3,13,5,6,11,-4,0,1,1,1,1,1,2,1
KR_6702486551,420,6,82,15,14,5,6,1,2,3,1,-2,1,3,7,7,0,2,3,1,0,18,0,2,8,10,-2,0,2,1,1,1,1,4,1
KR_6768339810,420,0,-29,14,-6,-3,2,5,0,7,7,0,3,3,-4,1,5,1,3,2,0,-2,-1,-9,11,2,-2,0,0,-1,-1,1,1,1,1
KR_6732420489,420,3,71,-8,7,-2,0,2,3,5,2,0,2,2,6,6,0,0,0,0,-1,6,-33,-1,8,7,0,0,0,1,-1,1,-1,2,1
KR_6775942517,420,1,-37,19,2,1,3,2,8,9,1,1,2,1,-3,3,6,-5,0,5,0,3,-7,3,3,6,1,0,1,1,1,1,1,5,1
KR_6763732132,420,4,40,8,2,0,3,3,-1,0,1,-3,0,3,6,6,0,0,0,0,0,6,-28,0,7,7,2,0,0,1,1,1,1,2,1
KR_6719760944,420,0,90,-3,4,0,3,3,8,9,1,1,4,3,-3,1,4,-2,3,5,0,-3,-25,-3,7,4,0,0,0,-1,1,-1,1,3,1
KR_6770314724,420,1,-2,52,2,2,3,1,2,4,2,-1,2,3,-1,1,2,0,1,1,0,2,-5,-2,8,6,1,0,1,1,-1,1,-1,3,1
KR_6731839497,420,2,15,23,2,2,2,0,1,2,1,-2,1,3,1,4,3,0,2,2,0,7,30,1,7,8,5,0,1,-1,1,1,-1,5,1
KR_6774695513,420,-3,-4,-42,0,-3,1,4,1,2,1,0,5,5,2,3,1,0,1,1,0,8,-6,2,2,4,1,0,0,1,-1,0,1,2,1
KR_6776253595,420,-2,22,-7,-1,5,6,1,-2,0,2,-3,1,4,-1,0,1,0,0,0,0,1,12,-3,8,5,8,0,-1,0,1,1,1,0,1
KR_6777456785,420,-2,-21,24,-6,-2,2,4,2,4,2,-7,1,8,1,4,3,0,1,1,0,-8,11,3,8,11,-3,0,0,1,1,0,1,4,1
KR_6768122928,420,1,19,-24,10,2,5,3,4,5,1,5,6,1,4,6,2,-5,0,5,1,13,20,2,6,8,2,0,0,1,-1,1,1,3,1
KR_6777312979,420,1,52,10,7,-1,0,1,-1,1,2,4,6,2,6,7,1,-1,0,1,0,0,11,2,7,9,1,0,2,1,-1,1,1,2,1
KR_6709268335,420,4,32,28,-1,0,1,1,1,5,4,-3,1,4,0,4,4,1,1,0,0,3,3,2,5,7,2,0,1,1,-1,-1,1,5,1
KR_6709219837,420,-1,13,17,8,2,3,1,-3,1,4,7,9,2,2,3,1,0,0,0,0,5,13,4,5,9,-2,0,1,1,1,1,1,3,1
KR_6776810701,420,6,83,-2,20,2,2,0,2,4,2,6,7,1,6,7,1,4,5,1,2,26,12,7,0,7,-1,0,0,1,-1,1,-1,6,1
KR_6777213099,420,2,7,3,7,-5,2,7,7,8,1,0,2,2,5,7,2,0,1,1,1,18,-6,0,7,7,-1,0,0,-1,1,0,1,3,1
KR_6739827905,420,-1,5,13,1,1,4,3,2,4,2,-1,3,4,-3,1,4,2,2,0,-1,-3,15,0,7,7,4,0,0,1,-1,0,-1,2,1
KR_6774791958,420,1,51,43,4,2,2,0,0,5,5,-3,0,3,4,4,0,1,1,0,0,-3,3,1,3,4,-4,0,0,1,1,0,1,4,1
KR_6764946929,420,2,5,2,3,0,4,4,-3,1,4,-3,2,5,6,6,0,3,3,0,0,1,6,0,3,3,-7,0,0,1,-1,1,-1,1,1
KR_6701770189,420,5,61,8,16,5,5,0,6,11,5,-1,1,2,1,2,1,5,6,1,1,14,4,-8,10,2,-2,0,2,1,1,1,1,6,1
KR_6777763228,420,2,-13,-1,1,2,2,0,-2,3,5,1,4,3,0,0,0,0,1,1,0,2,4,-3,7,4,1,0,0,0,-1,-1,-1,0,1
KR_6757540261,420,6,75,-9,14,-2,0,2,8,9,1,6,6,0,2,3,1,0,1,1,0,18,26,5,3,8,-2,0,4,1,1,1,1,2,1
KR_6754416833,420,-1,-10,6,3,0,2,2,0,2,2,5,5,0,-2,0,2,0,1,1,0,-1,50,-4,7,3,4,0,0,-1,1,1,1,4,1
KR_6738102203,420,1,40,-16,1,2,3,1,1,4,3,-1,1,2,-1,1,2,0,2,2,0,-2,11,-8,11,3,1,0,-1,1,-1,-1,-1,2,1
KR_6772985584,420,-1,34,51,-7,1,1,0,0,3,3,-9,6,15,1,1,0,0,0,0,0,-10,9,4,3,7,-3,0,0,-1,1,0,1,6,1
KR_6776232135,420,-5,-55,-16,-1,1,1,0,-3,2,5,0,3,3,3,8,5,-2,0,2,0,4,-19,2,7,9,-8,0,-1,1,-1,-1,1,3,1
KR_6733081078,420,4,59,37,9,3,5,2,11,11,0,-1,0,1,-2,2,4,-2,1,3,0,15,8,1,5,6,-2,0,1,-1,1,1,-1,2,1
KR_6752985558,440,3,35,-3,2,-1,3,4,-2,1,3,7,9,2,-2,1,3,0,2,2,1,5,1,1,4,5,1,0,1,-1,1,-1,1,5,1
KR_6702703671,420,-1,23,5,2,-1,2,3,-2,3,5,0,2,2,6,7,1,-1,0,1,0,4,-69,5,4,9,4,0,1,1,-1,1,1,4,1
KR_6764285386,420,3,-28,37,3,-2,0,2,1,5,4,4,4,0,-3,3,6,3,6,3,-1,12,3,-1,8,7,1,0,-1,1,-1,-1,-1,6,1
KR_6746710189,420,3,-18,4,8,-3,0,3,5,5,0,4,6,2,2,3,1,0,0,0,0,21,8,-4,8,4,-2,0,2,1,-1,1,-1,4,1
KR_6774105620,420,3,65,26,12,4,5,1,5,6,1,-1,4,5,4,5,1,0,1,1,1,16,-35,2,7,9,-1,0,1,1,1,1,1,5,1
KR_6768957999,420,1,6,14,-4,3,4,1,0,2,2,-2,0,2,-3,1,4,-2,0,2,0,-8,-23,2,8,10,2,0,-1,1,-1,-1,-1,6,1
KR_6768731033,420,3,-28,-4,8,2,3,1,-1,3,4,3,4,1,2,3,1,2,2,0,0,12,46,4,4,8,0,0,1,1,-1,1,-1,1,1
KR_6775885753,420,1,83,4,3,1,3,2,-4,2,6,4,4,0,1,3,2,1,1,0,1,2,1,0,6,6,5,0,1,1,-1,1,1,1,1
KR_6758899895,420,2,43,16,-2,-1,2,3,-2,0,2,-2,0,2,-4,0,4,7,11,4,0,-1,2,-4,12,8,2,0,0,1,1,1,-1,4,1
KR_6775306930,420,-2,-23,-14,0,-4,1,5,0,3,3,2,3,1,-1,2,3,3,4,1,3,10,-197,-3,8,5,3,0,0,-1,-1,0,1,3,1
KR_6775959626,420,5,29,32,5,3,4,1,0,1,1,2,4,2,4,4,0,-4,0,4,1,7,1,4,6,10,-3,0,0,-1,-1,1,1,2,1
KR_6776571488,420,4,0,1,15,-1,3,4,9,10,1,0,2,2,7,8,1,0,0,0,0,22,6,2,1,3,5,0,0,1,-1,-1,-1,4,1
KR_6740919335,420,4,-5,10,-4,-1,2,3,1,2,1,-2,1,3,-2,1,3,0,0,0,-1,1,-5,3,5,8,-1,0,-1,-1,-1,-1,-1,6,1
KR_6749232091,440,0,43,-8,6,-3,1,4,-1,0,1,2,4,2,5,8,3,3,3,0,0,-2,180,3,2,5,-2,0,2,-1,1,1,1,3,1
KR_6734899121,420,6,36,32,6,2,3,1,0,4,4,3,6,3,5,7,2,-4,0,4,0,7,0,2,8,10,-1,0,1,1,1,1,-1,2,1
KR_6771260013,440,8,115,-3,15,1,3,2,3,6,3,3,4,1,8,11,3,0,3,3,1,15,-10,0,9,9,2,0,1,1,-1,1,1,2,1
KR_6736724744,420,5,14,18,3,-2,1,3,-3,2,5,2,2,0,4,6,2,2,2,0,0,5,3,1,7,8,4,0,0,1,1,0,-1,1,1
KR_6769534732,420,-1,-17,-4,-1,0,1,1,-1,2,3,-5,0,5,4,7,3,1,1,0,0,-5,-10,-2,3,1,-8,0,2,-1,1,1,-1,2,1
KR_6764008218,420,0,15,15,1,-3,0,3,3,4,1,-1,0,1,2,3,1,0,0,0,0,8,10,4,5,9,-3,0,-1,1,-1,-1,1,6,1
KR_6684761945,420,1,12,8,9,-2,0,2,3,3,0,6,7,1,3,3,0,-1,0,1,0,17,-8,5,3,8,3,1,3,1,1,1,1,2,1
KR_6724051636,420,3,64,-4,11,7,7,0,0,2,2,5,5,0,0,3,3,-1,1,2,0,16,-104,1,5,6,3,0,1,1,-1,1,1,4,1
KR_6770400488,420,3,67,4,4,-2,0,2,2,5,3,2,4,2,3,4,1,-1,0,1,0,10,1,2,5,7,1,0,0,1,1,1,-1,4,1
KR_6747183383,420,-4,-54,-5,-8,-2,0,2,-3,1,4,2,3,1,-3,3,6,-2,0,2,0,-7,-1,6,3,9,-4,0,-1,-1,1,1,-1,1,1
KR_6776608410,420,5,78,18,11,0,2,2,3,6,3,5,5,0,2,3,1,1,3,2,0,14,0,-2,5,3,3,0,2,1,1,1,1,6,1
KR_6770711791,420,-5,-37,-8,-11,-8,1,9,0,5,5,0,4,4,-2,5,7,-1,0,1,-1,-13,3,1,5,6,-2,0,0,1,-1,0,-1,2,1
KR_6769164349,420,4,97,-8,15,3,3,0,-1,6,7,6,6,0,6,7,1,1,1,0,1,21,10,7,2,9,0,0,1,1,1,1,1,4,1
KR_6775845545,420,1,2,1,4,4,4,0,0,1,1,-1,0,1,-2,1,3,3,3,0,0,2,-11,-2,7,5,4,0,1,-1,1,1,1,2,1
KR_6745131716,420,2,36,19,-1,5,6,1,-3,2,5,0,1,1,0,3,3,-3,1,4,0,-2,-16,-1,8,7,-3,0,0,-1,1,1,-1,4,1
KR_6777529998,420,1,58,-6,-2,1,1,0,-2,1,3,2,3,1,-3,0,3,0,1,1,0,-8,-167,-4,8,4,4,0,0,1,-1,0,-1,2,1
KR_6746104094,420,2,-35,-11,9,5,6,1,-4,0,4,3,4,1,5,9,4,0,1,1,0,12,1,-3,7,4,0,0,1,1,-1,-1,1,3,1
KR_6776252110,420,1,-34,4,5,0,1,1,3,6,3,4,4,0,-3,1,4,1,3,2,1,2,2,-1,7,6,5,0,0,-1,-1,0,1,1,1
KR_6766100893,420,1,19,13,-2,4,4,0,1,2,1,-8,2,10,3,4,1,-2,0,2,-1,-1,-10,-2,9,7,-4,0,0,-1,-1,-1,-1,2,1
KR_6774928222,420,0,-2,-8,1,-1,2,3,2,3,1,0,1,1,0,1,1,0,0,0,0,2,13,4,5,9,1,0,1,1,-1,1,1,6,1
KR_6743799300,420,0,39,13,1,-1,1,2,1,3,2,1,3,2,0,2,2,0,1,1,0,0,0,1,6,7,2,0,0,-1,1,0,1,4,1
KR_6755133852,420,6,100,-32,15,5,7,2,3,3,0,1,2,1,6,7,1,0,1,1,0,18,5,7,4,11,2,1,6,1,1,1,-1,4,1
KR_6776898296,420,0,-6,-31,3,-2,1,3,0,2,2,1,4,3,2,3,1,2,3,1,1,4,-7,-2,7,5,0,0,-1,1,-1,-1,1,5,1
KR_6777739065,420,-1,-6,19,11,-3,3,6,0,2,2,9,9,0,4,6,2,1,2,1,3,3,22,3,3,6,1,0,-1,1,-1,-1,1,6,1
KR_6757323777,420,-1,14,8,2,1,1,0,2,6,4,0,0,0,0,6,6,-1,0,1,0,-1,31,0,6,6,5,0,0,1,-1,0,1,5,1
KR_6749882428,420,0,28,-6,7,-5,1,6,1,2,1,2,5,3,9,11,2,0,0,0,4,25,-14,2,4,6,0,0,0,1,-1,1,-1,6,1
KR_6737461592,420,2,48,7,1,3,4,1,1,4,3,1,5,4,-4,2,6,0,2,2,0,-14,-13,-2,6,4,3,0,0,-1,1,-1,1,5,1
KR_6745812265,420,2,8,16,8,6,6,0,7,8,1,-3,4,7,0,3,3,-2,1,3,0,9,10,8,3,11,-3,0,2,1,1,1,-1,6,1
KR_6736619772,420,1,26,-5,1,2,3,1,1,4,3,-3,1,4,0,3,3,1,1,0,-1,1,-43,-8,14,6,14,0,1,-1,-1,1,-1,6,1
KR_6744501259,420,2,29,-12,1,1,1,0,0,4,4,-2,1,3,3,3,0,-1,0,1,1,10,-13,-1,10,9,-7,0,0,-1,-1,-1,1,2,1
KR_6760074345,420,4,92,14,13,4,4,0,2,3,1,5,5,0,-1,1,2,3,5,2,0,12,-11,7,0,7,4,0,2,1,1,1,1,6,1
KR_6709613833,420,2,21,52,6,4,4,0,0,2,2,3,3,0,-1,1,2,0,1,1,1,4,19,6,4,10,-7,0,1,1,1,1,1,3,1
KR_6684568836,420,-1,38,-26,-7,-3,1,4,0,4,4,0,3,3,-3,0,3,-1,0,1,0,-6,-7,0,7,7,1,0,-1,-1,-1,1,-1,1,1
KR_6776387288,440,1,-31,-1,9,3,5,2,2,3,1,3,4,1,3,6,3,-2,0,2,0,15,25,-1,6,5,5,0,0,1,1,1,1,4,1
KR_6737329859,420,8,132,39,17,0,1,1,1,2,1,4,6,2,9,12,3,3,4,1,1,18,1,-1,7,6,-1,0,5,1,1,1,1,1,1
KR_6776419898,420,2,3,8,5,3,4,1,1,2,1,2,6,4,0,1,1,-1,0,1,0,0,11,0,5,5,-2,0,2,-1,1,1,1,4,1
KR_6763080543,440,-1,17,-6,-3,3,3,0,-1,1,2,1,2,1,-5,4,9,-1,1,2,0,-1,38,-3,9,6,3,0,2,0,-1,1,-1,0,1
KR_6772978045,420,-3,-88,-27,-6,-4,1,5,-5,1,6,-1,4,5,4,6,2,0,3,3,0,-9,-5,-1,9,8,-5,0,-1,-1,1,1,-1,2,1
KR_6727362971,420,-1,77,0,2,-4,1,5,1,3,2,0,1,1,7,7,0,-2,0,2,0,6,-5,1,5,6,1,0,1,1,1,1,1,2,1
KR_6753361420,420,-1,46,-17,2,4,5,1,-5,1,6,5,6,1,-2,3,5,0,1,1,1,-6,4,2,5,7,5,0,0,1,-1,-1,1,1,1
KR_6741645787,420,5,63,19,10,0,1,1,1,4,3,3,5,2,4,4,0,2,2,0,0,16,6,0,8,8,2,0,1,1,-1,1,1,1,1
KR_6728191341,420,0,-39,8,2,2,3,1,0,3,3,4,4,0,-5,2,7,1,1,0,0,3,17,3,4,7,-3,0,0,1,1,1,1,5,1
KR_6723157721,420,3,27,-15,11,2,3,1,2,3,1,3,3,0,5,5,0,-1,1,2,0,22,-5,3,4,7,2,0,2,1,-1,-1,1,1,1
KR_6763707581,420,2,-7,3,0,-2,0,2,-5,2,7,1,1,0,5,6,1,1,3,2,0,0,-45,0,6,6,2,0,2,1,1,1,1,6,1
KR_6772198269,440,1,96,40,-7,0,1,1,-3,3,6,0,2,2,1,6,5,-5,0,5,0,-18,-1,0,2,2,-3,0,2,-1,1,1,-1,6,1
KR_6774537274,420,3,73,29,2,3,3,0,1,2,1,1,3,2,-2,1,3,-1,0,1,2,4,-14,6,4,10,2,0,3,-1,1,1,1,5,1
KR_6733681773,420,5,60,12,10,2,7,5,5,8,3,3,3,0,-1,4,5,1,1,0,1,18,19,0,10,10,2,0,1,1,1,1,1,1,1
KR_6733102841,420,-2,44,-24,-3,-2,0,2,-2,1,3,2,4,2,-1,1,2,0,0,0,0,-7,9,1,6,7,-5,0,0,-1,1,1,1,2,1
KR_6777466190,420,-1,-12,3,-6,1,1,0,-4,4,8,1,2,1,-3,0,3,-1,1,2,0,-8,-1,2,4,6,-1,0,0,1,-1,1,1,4,1
KR_6743329699,420,1,26,-23,8,4,6,2,0,5,5,-3,0,3,6,9,3,1,1,0,0,15,-2,0,5,5,1,0,2,-1,1,1,1,5,1
KR_6763343616,420,5,64,3,20,0,1,1,5,6,1,2,5,3,8,10,2,5,5,0,0,26,23,0,4,4,-1,0,2,1,1,1,1,5,1
KR_6776374043,420,5,66,2,4,3,3,0,1,1,0,3,4,1,-2,0,2,-1,0,1,0,1,-10,4,5,9,5,0,1,1,-1,1,1,1,1
KR_6776405788,420,0,20,-16,5,-1,2,3,1,5,4,4,4,0,0,1,1,1,1,0,0,6,-1,-1,9,8,0,0,1,1,1,1,1,6,1
KR_6774808083,420,0,-21,-37,0,-3,1,4,-2,4,6,1,3,2,4,5,1,0,0,0,0,1,-38,-3,7,4,-1,0,0,1,-1,-1,1,1,1
KR_6777269769,420,6,62,11,16,2,2,0,6,9,3,0,1,1,5,7,2,3,3,0,0,23,-4,7,6,13,7,0,1,-1,1,1,1,4,1
KR_6765513134,420,3,14,20,7,2,3,1,3,5,2,0,2,2,3,4,1,-1,2,3,0,10,-4,-3,9,6,5,0,-1,1,-1,-1,1,4,1
KR_6774971715,440,3,47,33,8,3,4,1,3,4,1,0,2,2,0,0,0,2,3,1,0,10,7,0,7,7,0,0,0,1,1,0,-1,3,1
KR_6712471707,420,4,56,-22,10,1,1,0,1,3,2,6,6,0,2,5,3,0,1,1,0,8,20,1,9,10,-3,0,1,-1,1,1,1,3,1
KR_6724999402,420,5,42,1,9,-1,0,1,7,8,1,-1,1,2,3,3,0,1,1,0,0,16,4,3,4,7,-1,0,1,1,-1,1,1,2,1
KR_6776817628,420,2,10,-19,3,1,1,0,-2,2,4,0,1,1,1,3,2,3,4,1,0,0,-19,-3,8,5,2,0,1,-1,-1,1,1,1,1
KR_6775470712,420,-3,18,3,-5,-1,1,2,-2,2,4,0,3,3,-3,2,5,1,2,1,0,-11,-9,3,5,8,-2,0,0,-1,1,0,1,5,1
KR_6741524287,420,-1,-53,-7,2,-1,1,2,3,6,3,-1,3,4,1,3,2,0,1,1,2,3,-43,4,5,9,16,0,1,1,1,1,1,5,1
KR_6710465976,420,0,23,0,4,-2,1,3,1,10,9,4,7,3,1,2,1,0,2,2,-1,12,5,2,3,5,-5,0,0,1,-1,0,1,6,1
KR_6777871411,420,4,73,-2,8,2,2,0,2,4,2,4,5,1,0,5,5,0,1,1,2,8,5,3,5,8,-1,0,1,1,-1,1,1,5,1
KR_6728246906,420,2,32,7,4,2,2,0,-1,4,5,1,2,1,1,2,1,1,2,1,0,7,-20,-2,9,7,1,0,1,1,1,1,1,2,1
KR_6698188025,420,7,11,20,15,4,4,0,9,9,0,0,1,1,-1,2,3,3,3,0,1,23,7,5,5,10,1,0,2,1,1,1,1,3,1
KR_6764126098,420,0,-1,13,3,-3,0,3,0,3,3,1,2,1,4,5,1,1,2,1,0,5,2,6,3,9,3,0,1,1,-1,1,1,2,1
KR_6773779273,420,0,43,-12,-1,-2,1,3,-3,1,4,2,4,2,4,6,2,-2,0,2,0,-7,-9,-3,8,5,-2,0,1,-1,-1,1,-1,1,1
KR_6713223687,420,4,-18,23,12,0,2,2,4,6,2,5,6,1,1,1,0,2,2,0,1,12,7,12,2,14,-4,0,1,1,1,1,1,6,1
KR_6769927010,420,0,15,9,-3,3,3,0,-1,4,5,-3,2,5,1,2,1,-3,1,4,0,-6,-23,1,7,8,-3,0,1,1,-1,-1,-1,1,1
KR_6765572187,420,7,60,44,13,1,2,1,7,7,0,3,3,0,2,3,1,0,2,2,1,16,-9,2,5,7,7,0,3,1,1,1,1,2,1
KR_6773150998,420,4,45,38,9,-1,2,3,2,2,0,4,5,1,6,8,2,-2,0,2,0,6,7,6,2,8,-3,0,1,1,1,1,-1,5,1
KR_6777835103,420,2,40,24,3,-1,0,1,3,5,2,2,4,2,1,4,3,-2,0,2,0,6,-11,0,5,5,0,0,0,1,-1,1,1,6,1
KR_6742327456,420,2,-29,14,5,-1,0,1,4,5,1,-4,3,7,3,4,1,3,4,1,0,7,9,4,5,9,-3,0,0,1,-1,0,1,2,1
KR_6743360884,420,4,49,28,7,5,8,3,-1,2,3,-2,3,5,6,6,0,-1,1,2,0,1,-9,-2,8,6,0,0,2,1,1,1,1,4,1
KR_6766241807,420,4,50,-13,7,1,4,3,1,2,1,-1,1,2,7,8,1,-1,0,1,0,6,26,-2,8,6,2,0,3,1,1,1,1,2,1
KR_6774119506,420,1,-60,-24,3,1,2,1,5,5,0,-2,3,5,0,0,0,-1,0,1,0,5,2,1,6,7,-2,0,1,1,1,1,-1,1,1
KR_6777189962,420,2,55,-25,4,2,2,0,1,5,4,1,2,1,-1,2,3,1,1,0,0,3,27,2,3,5,1,0,0,1,-1,1,1,6,1
KR_6736375798,420,4,42,-4,9,-1,0,1,3,4,1,4,5,1,1,1,0,2,2,0,0,16,-27,5,6,11,-1,0,3,1,1,1,1,2,1
KR_6742758170,420,0,12,-9,4,2,2,0,2,2,0,0,3,3,1,3,2,-1,0,1,-1,-2,-4,2,6,8,2,0,0,1,1,1,-1,4,1
KR_6749192196,420,2,28,5,3,-2,0,2,1,2,1,-1,5,6,3,6,3,2,2,0,0,-3,-9,-2,8,6,1,0,1,1,-1,1,-1,3,1
KR_6698354882,420,-1,11,-23,0,1,2,1,2,3,1,-2,3,5,0,2,2,-1,1,2,1,5,4,-4,9,5,3,0,0,-1,1,-1,1,2,1
KR_6776663354,420,0,-10,-5,13,2,4,2,2,3,1,3,3,0,8,8,0,-2,3,5,1,15,5,-6,11,5,0,0,1,1,1,1,1,1,1
KR_6771406708,420,4,54,18,12,2,4,2,9,9,0,1,2,1,-1,0,1,1,1,0,0,10,-17,0,7,7,5,0,1,1,-1,1,1,2,1
KR_6775039656,420,5,-17,17,9,-1,3,4,0,2,2,4,5,1,6,7,1,0,2,2,0,13,10,0,6,6,-1,0,-1,1,-1,-1,-1,6,1
KR_6760791393,420,2,58,-15,8,4,4,0,2,3,1,3,4,1,1,2,1,-2,0,2,0,5,6,2,6,8,2,0,1,-1,1,1,1,6,1
KR_6776320135,420,1,-12,-16,6,0,1,1,3,7,4,-1,0,1,6,8,2,-2,0,2,0,6,4,3,6,9,1,0,0,-1,1,0,1,3,1
KR_6742965735,420,4,45,16,12,4,4,0,4,4,0,-1,2,3,5,9,4,0,1,1,0,17,-25,4,5,9,-1,0,1,0,1,1,1,0,1
KR_6776184300,420,8,106,-6,25,1,2,1,7,7,0,2,4,2,16,18,2,-1,1,2,-1,23,32,-2,6,4,3,0,2,1,1,1,1,5,1
KR_6750010550,420,5,21,25,10,-5,2,7,5,5,0,6,6,0,2,4,2,2,4,2,0,14,9,-1,6,5,6,0,2,1,1,1,1,2,1
KR_6742454264,420,-2,-37,-49,-1,-3,1,4,-1,1,2,-2,3,5,6,8,2,-1,1,2,1,8,-13,-5,11,6,7,0,0,-1,1,-1,1,1,1
KR_6735756201,420,1,7,-24,2,3,3,0,0,4,4,2,6,4,-2,0,2,-1,0,1,0,-8,-27,1,5,6,3,0,-1,1,-1,-1,-1,5,1
KR_6776865353,420,4,8,-7,-1,-1,3,4,-1,4,5,-2,1,3,1,4,3,2,3,1,0,2,6,1,7,8,-10,0,-1,1,-1,-1,1,4,1
KR_6745920201,420,3,21,27,12,1,2,1,3,3,0,2,6,4,3,6,3,3,4,1,0,23,22,1,6,7,4,0,1,1,-1,1,1,6,1
KR_6701283027,420,-1,-1,8,2,5,5,0,0,1,1,0,1,1,-3,1,4,0,0,0,0,0,-26,1,6,7,-1,0,1,1,1,1,-1,3,1
KR_6719122232,420,5,84,24,11,0,0,0,3,3,0,3,5,2,3,7,4,2,2,0,0,9,122,3,4,7,1,0,1,1,1,1,1,2,1
KR_6763260186,440,2,21,12,3,1,1,0,2,3,1,4,4,0,-1,3,4,-3,4,7,0,-2,-325,1,3,4,13,0,0,0,1,1,-1,0,1
KR_6741734365,420,2,36,-7,13,-2,1,3,2,4,2,4,5,1,8,9,1,1,1,0,0,19,6,10,5,15,-5,0,3,-1,1,1,1,3,1
KR_6776248916,420,-4,-22,4,-12,-6,0,6,-1,7,8,-3,3,6,-3,0,3,1,1,0,0,-11,-7,-6,11,5,0,0,-1,1,-1,-1,-1,6,1
KR_6763718275,420,2,-22,15,4,7,7,0,-4,1,5,-1,2,3,1,2,1,1,1,0,0,2,-36,-3,8,5,1,0,-1,1,-1,-1,1,5,1
KR_6776657599,420,2,35,9,5,3,3,0,-1,3,4,2,5,3,1,4,3,0,2,2,0,3,-10,-4,9,5,4,0,2,1,1,1,1,4,1
KR_6777274988,420,1,14,-22,3,0,1,1,-1,2,3,1,4,3,2,3,1,1,1,0,0,8,-7,-4,6,2,1,0,0,-1,-1,1,-1,3,1
KR_6700812687,420,6,85,0,16,3,3,0,5,8,3,1,2,1,5,5,0,2,3,1,0,21,7,4,4,8,-2,0,1,-1,1,1,1,6,1
KR_6758526762,420,6,80,-2,15,3,4,1,1,4,3,5,5,0,4,4,0,2,2,0,0,16,9,6,2,8,1,0,2,1,1,1,1,1,1
KR_6744467893,420,0,-24,-2,-2,1,1,0,-1,2,3,-3,0,3,-2,6,8,3,3,0,-1,4,-32,-3,5,2,2,0,0,-1,-1,-1,-1,4,1
KR_6752024914,440,-3,-95,4,1,-3,1,4,-3,2,5,3,3,0,2,5,3,2,7,5,-1,-2,37,-1,8,7,-14,0,-3,-1,-1,-1,-1,1,1
KR_6750393794,420,2,29,30,-2,2,4,2,2,5,3,-1,0,1,-2,0,2,-3,1,4,0,1,-13,-6,9,3,10,0,0,-1,1,1,1,5,1
KR_6775607079,420,-2,-9,-11,-5,-6,0,6,-2,1,3,1,2,1,1,3,2,1,1,0,0,0,-20,-1,9,8,4,0,-1,-1,-1,-1,-1,2,1
KR_6764377457,420,4,59,23,8,-2,1,3,10,11,1,-1,8,9,1,5,4,0,1,1,1,6,-18,-1,8,7,1,0,1,1,-1,1,1,2,1
KR_6776333891,420,6,18,3,5,5,8,3,3,4,1,2,3,1,-4,1,5,-1,0,1,0,15,-1,2,6,8,3,0,2,1,1,1,-1,3,1
KR_6723064927,420,3,39,4,8,2,3,1,4,5,1,-1,1,2,3,5,2,0,0,0,0,15,7,2,5,7,2,0,4,-1,1,1,1,2,1
KR_6735314561,420,6,119,23,19,0,2,2,9,11,2,3,4,1,6,6,0,1,3,2,0,14,-10,-3,11,8,7,0,3,0,1,1,1,0,1
KR_6776398465,420,3,29,-16,9,0,3,3,1,3,2,1,2,1,7,7,0,0,1,1,0,16,10,7,5,12,-1,0,0,-1,-1,1,-1,2,1
KR_6776872149,420,2,30,2,6,4,4,0,4,7,3,2,4,2,-2,2,4,-2,2,4,0,8,23,3,6,9,5,0,0,-1,1,1,-1,4,1
KR_6743420063,440,2,38,-32,3,3,3,0,-1,0,1,-1,0,1,2,3,1,0,0,0,0,6,-15,2,6,8,9,0,-1,-1,-1,-1,1,3,1
KR_6768017275,420,2,-40,7,5,1,3,2,2,4,2,-1,1,2,3,3,0,0,0,0,0,6,8,0,6,6,-2,0,0,-1,1,0,-1,5,1
KR_6777362846,420,2,28,-23,8,4,5,1,1,3,2,3,3,0,0,2,2,0,1,1,0,0,-8,-4,9,5,4,0,0,-1,-1,0,1,1,1
KR_6739443563,420,4,31,52,2,1,4,3,2,3,1,-2,1,3,2,7,5,-1,0,1,0,-1,32,2,3,5,4,0,1,-1,1,1,1,6,1
KR_6766919688,420,5,0,20,15,-3,0,3,10,10,0,3,3,0,1,3,2,4,4,0,0,25,19,0,5,5,0,0,1,1,-1,1,1,6,1
KR_6740559975,420,1,70,-48,5,3,3,0,2,3,1,-2,2,4,1,2,1,1,2,1,0,5,12,-1,5,4,5,0,1,-1,1,1,1,3,1
KR_6762280276,420,-1,-18,-1,-2,-3,1,4,-6,0,6,1,6,5,5,5,0,1,1,0,1,0,-51,-3,9,6,0,0,-2,1,-1,-1,1,6,1
KR_6776242019,420,3,44,-17,1,-5,0,5,0,2,2,4,4,0,2,5,3,0,2,2,0,5,4,-3,7,4,4,0,1,1,-1,1,1,5,1
KR_6752325974,420,3,5,27,1,4,4,0,0,3,3,1,1,0,0,2,2,-4,0,4,0,-1,-10,2,4,6,2,0,0,1,1,-1,1,1,1
KR_6738971761,420,5,97,20,5,1,4,3,5,5,0,0,1,1,-1,1,2,0,2,2,0,4,-4,-1,8,7,-2,0,3,1,1,1,-1,4,1
KR_6776139822,420,1,-3,2,-2,-2,0,2,-2,1,3,1,3,2,0,1,1,1,1,0,0,-1,36,0,7,7,-22,0,0,1,1,0,1,3,1
KR_6737383472,420,3,50,-13,4,-2,2,4,3,7,4,-1,1,2,3,5,2,1,1,0,0,10,11,1,6,7,-7,0,0,1,-1,-1,-1,3,1
KR_6770313667,440,0,-95,8,9,-2,0,2,4,6,2,0,0,0,5,5,0,2,2,0,0,15,6,2,4,6,-4,0,1,1,-1,1,1,5,1
KR_6760395076,420,5,24,-4,7,0,1,1,1,2,1,0,1,1,7,9,2,-1,0,1,0,10,-9,-7,11,4,7,0,1,1,-1,1,1,1,1
KR_6776942876,420,1,-8,18,7,-3,1,4,2,5,3,6,8,2,2,3,1,0,1,1,0,17,48,2,3,5,-10,0,-1,1,1,1,1,3,1
KR_6742938727,420,0,-5,-20,2,2,5,3,1,5,4,-2,1,3,2,4,2,-1,2,3,0,1,20,1,6,7,-3,0,1,-1,-1,1,-1,1,1
KR_6771873806,420,1,-11,4,-5,1,3,2,-3,1,4,2,3,1,-3,1,4,-2,0,2,0,-10,-5,-6,10,4,-3,0,0,1,1,0,-1,5,1
KR_6775840142,440,2,35,-16,11,1,2,1,6,6,0,7,7,0,3,3,0,-6,1,7,3,22,-4,5,6,11,-3,0,2,1,1,1,1,5,1
KR_6773692046,420,-2,-30,-42,-6,-1,3,4,-3,1,4,3,5,2,0,2,2,-5,0,5,0,-3,-8,-3,7,4,-4,0,-2,-1,-1,-1,-1,6,1
KR_6752685125,420,1,40,13,3,4,7,3,-5,0,5,1,3,2,3,5,2,0,1,1,-1,-2,116,-2,8,6,4,0,1,1,1,1,-1,3,1
KR_6698248215,420,3,27,24,2,3,4,1,0,1,1,1,1,0,-2,1,3,0,0,0,0,1,21,0,3,3,1,0,1,1,1,1,-1,2,1
KR_6776859066,420,-1,-13,4,10,0,3,3,2,7,5,4,5,1,5,6,1,-1,0,1,2,20,24,-4,10,6,4,0,0,1,1,1,1,3,1
KR_6766483320,420,2,18,0,8,3,4,1,-1,3,4,2,3,1,1,5,4,3,4,1,-1,6,-7,-1,7,6,2,0,1,-1,1,1,-1,5,1
KR_6731993661,420,-1,17,-36,1,4,4,0,-5,3,8,2,5,3,-1,2,3,1,2,1,0,-5,5,3,4,7,2,0,0,-1,0,0,1,6,1
KR_6707744509,420,6,96,-16,8,2,2,0,1,3,2,4,4,0,1,4,3,0,1,1,0,6,-37,1,6,7,2,0,1,1,1,1,1,5,1
KR_6743388331,420,1,18,-12,7,-1,1,2,2,4,2,1,3,2,2,4,2,3,3,0,0,12,-29,-1,7,6,4,0,0,0,-1,1,1,0,1
KR_6772721854,420,3,16,-16,3,2,3,1,-1,1,2,2,4,2,3,3,0,-3,0,3,-1,12,-135,3,5,8,9,0,0,1,-1,0,-1,2,1
KR_6777805973,420,4,73,26,3,2,3,1,-4,0,4,4,5,1,3,4,1,-2,0,2,0,0,-9,-5,15,10,7,0,1,1,-1,1,-1,4,1
KR_6705389154,420,-2,-27,-16,-7,-2,0,2,-4,3,7,-3,1,4,1,3,2,1,3,2,0,-12,-138,-1,6,5,-2,0,0,1,1,0,-1,1,1
KR_6770013698,440,4,19,25,8,4,6,2,0,1,1,4,4,0,-2,4,6,2,2,0,0,7,29,2,9,11,0,0,-1,1,-1,-1,1,6,1
KR_6698056675,420,2,45,-14,3,0,3,3,1,4,3,0,2,2,0,3,3,2,3,1,-1,13,-18,1,5,6,1,0,2,1,-1,1,-1,1,1
KR_6776133624,420,4,17,32,9,0,1,1,-2,1,3,3,3,0,4,5,1,4,5,1,0,9,9,1,4,5,1,0,1,1,1,1,1,3,1
KR_6724398073,420,5,49,33,11,0,2,2,8,10,2,-1,0,1,1,5,4,3,3,0,0,12,-26,1,3,4,3,0,1,1,-1,1,-1,3,1
KR_6765698160,420,1,17,-38,5,-1,2,3,0,1,1,5,7,2,1,3,2,0,0,0,0,12,-2,-7,11,4,0,0,0,1,1,1,1,1,1
KR_6752768088,420,2,29,25,4,4,4,0,-1,1,2,-1,1,2,4,4,0,-2,0,2,0,5,-17,0,7,7,-2,0,0,-1,1,0,-1,3,1
KR_6755247932,420,-1,21,-16,6,-4,1,5,4,5,1,3,5,2,2,4,2,1,2,1,0,16,48,2,5,7,1,0,0,1,1,-1,1,1,1
KR_6708909772,420,4,103,9,13,0,0,0,3,6,3,6,7,1,6,6,0,-2,0,2,0,21,16,10,4,14,1,0,1,1,-1,1,1,1,1
KR_6720146566,420,-3,-37,21,0,4,4,0,-1,4,5,-2,2,4,-3,4,7,2,3,1,0,-8,-12,-3,12,9,3,0,0,-1,1,1,-1,2,1
KR_6752890321,440,-1,-41,20,-9,-2,2,4,1,3,2,-2,1,3,-4,0,4,-2,0,2,0,-5,9,-3,6,3,-1,0,-1,1,-1,-1,-1,5,1
KR_6752878484,440,3,-26,9,6,4,4,0,2,2,0,0,0,0,0,2,2,0,1,1,1,13,-40,-4,7,3,27,0,-1,-1,1,-1,1,3,1
KR_6775718566,420,0,0,31,-8,1,2,1,-3,0,3,-2,1,3,-3,0,3,-1,0,1,1,-11,4,1,7,8,4,0,1,1,1,1,1,4,1
KR_6776265102,420,4,51,15,7,2,3,1,2,3,1,6,6,0,-2,0,2,-1,2,3,0,4,7,3,3,6,0,0,2,1,1,1,-1,5,1
KR_6739000071,420,5,63,7,12,-2,2,4,6,7,1,2,3,1,3,5,2,3,3,0,1,14,4,2,5,7,3,0,1,-1,1,1,1,5,1
KR_6738034874,420,1,-16,-7,8,2,4,2,-1,1,2,4,4,0,2,3,1,1,1,0,0,15,-8,-6,8,2,2,0,-1,1,-1,-1,-1,5,1
KR_6762015971,420,0,-30,6,0,2,4,2,0,1,1,-2,3,5,3,4,1,-3,0,3,-1,-3,6,3,4,7,-2,0,1,1,-1,1,-1,6,1
KR_6768518820,420,3,-9,32,6,-1,0,1,3,5,2,1,1,0,0,2,2,3,3,0,0,7,-10,-5,9,4,3,0,1,1,1,1,1,3,1
KR_6753330515,420,0,0,12,8,0,2,2,6,6,0,3,3,0,-3,2,5,2,2,0,1,12,-1,4,2,6,-5,0,1,1,1,1,1,4,1
KR_6774648964,420,1,22,-4,9,3,3,0,1,5,4,4,5,1,2,3,1,-1,1,2,0,18,4,5,2,7,-1,0,1,1,1,1,-1,4,1
KR_6777233275,420,-2,-14,-23,-5,0,2,2,-3,1,4,0,3,3,-1,2,3,-1,0,1,0,-2,4,3,5,8,-2,0,-1,-1,-1,-1,1,3,1
KR_6775919144,420,0,-14,25,0,-1,3,4,3,3,0,1,3,2,-3,0,3,0,0,0,0,6,-4,-2,6,4,-2,0,0,1,-1,0,-1,3,1
KR_6739395481,420,2,72,20,10,6,7,1,3,8,5,1,2,1,0,2,2,0,4,4,0,5,3,2,6,8,2,0,0,1,-1,1,-1,1,1
KR_6777145032,420,2,21,11,5,5,6,1,3,4,1,0,0,0,-2,0,2,-1,0,1,0,4,-37,-3,6,3,1,0,0,-1,1,-1,1,6,1
KR_6775753605,420,3,38,12,4,-1,1,2,2,2,0,4,4,0,-2,3,5,1,1,0,0,3,-9,1,6,7,-1,0,0,-1,-1,1,-1,4,1
KR_6772889319,420,3,71,13,0,-2,2,4,1,3,2,1,4,3,0,3,3,0,0,0,0,3,33,0,6,6,1,0,1,1,-1,1,-1,1,1
KR_6727511161,420,-1,26,-15,5,0,3,3,4,5,1,-2,4,6,1,3,2,2,3,1,0,11,6,0,7,7,3,0,0,-1,-1,1,1,3,1
KR_6736167694,420,3,-7,35,10,5,5,0,-5,4,9,4,5,1,5,5,0,1,1,0,0,13,32,1,8,9,-1,0,1,1,1,1,-1,6,1
KR_6769265191,420,5,46,18,11,4,4,0,-3,1,4,4,6,2,6,10,4,0,3,3,1,3,0,4,5,9,0,0,0,1,1,1,1,2,1
KR_6724626902,420,0,2,-5,2,1,4,3,-5,0,5,8,8,0,1,4,3,-3,0,3,0,5,-25,-5,12,7,0,0,-1,-1,-1,-1,1,1,1
KR_6736123111,420,1,28,11,4,0,1,1,-1,1,2,2,2,0,3,3,0,0,0,0,0,9,9,3,3,6,3,0,0,1,1,0,1,5,1
KR_6748512999,420,-2,30,-14,-6,-2,0,2,-3,1,4,0,1,1,-2,0,2,1,1,0,0,-8,-5,0,7,7,-7,0,0,1,-1,0,-1,2,1
KR_6749671811,420,3,77,44,3,-1,3,4,5,7,2,1,2,1,-1,1,2,-1,0,1,0,3,-1,-6,11,5,0,0,1,1,-1,1,-1,4,1
KR_6775572925,420,0,-3,-12,2,0,2,2,0,1,1,-1,1,2,3,5,2,0,0,0,0,3,-71,-1,8,7,28,0,1,1,1,1,-1,2,1
KR_6766830375,420,2,7,6,5,-1,1,2,6,8,2,2,3,1,-1,2,3,-1,1,2,1,8,41,3,4,7,0,0,1,1,1,1,1,1,1
KR_6710325881,420,5,60,18,12,2,3,1,-1,4,5,12,12,0,0,2,2,-1,0,1,0,1,15,5,2,7,1,0,2,1,1,1,1,6,1
KR_6749184759,440,4,75,-27,3,5,6,1,1,3,2,-4,0,4,1,3,2,0,1,1,0,-1,-2,0,4,4,3,0,0,-1,-1,1,1,2,1
KR_6742252573,440,0,-44,19,-7,-4,1,5,4,4,0,-1,1,2,0,4,4,-6,0,6,0,-14,-12,-1,7,6,0,0,0,-1,0,0,-1,1,1
KR_6771447663,420,2,6,-25,-5,0,2,2,1,2,1,-5,0,5,0,0,0,-1,1,2,0,-13,-50,-1,6,5,1,0,0,-1,1,0,-1,6,1
KR_6777304071,420,-2,12,-25,4,-1,0,1,0,1,1,-1,1,2,4,5,1,2,3,1,0,6,5,2,4,6,-4,0,1,1,-1,1,1,4,1
KR_6721280497,420,6,108,13,6,2,2,0,2,4,2,0,2,2,1,3,2,1,1,0,0,6,-115,4,4,8,-3,0,2,0,-1,1,1,0,1
KR_6767627708,420,4,36,25,16,0,3,3,6,7,1,7,7,0,4,6,2,-1,1,2,0,23,9,-7,11,4,6,0,3,1,-1,1,1,4,1
KR_6744681224,420,-1,-24,5,-8,0,1,1,4,4,0,2,4,2,-13,0,13,-1,2,3,-1,-10,-18,-4,7,3,2,0,-1,-1,1,-1,-1,5,1
KR_6730627234,420,2,-8,18,7,3,3,0,5,5,0,-1,2,3,2,3,1,-2,1,3,0,6,39,0,7,7,-6,0,0,-1,-1,1,1,2,1
KR_6753276117,420,1,86,-10,5,1,5,4,2,4,2,3,4,1,0,2,2,-1,0,1,0,-2,-11,0,4,4,-1,0,1,1,1,1,1,6,1
KR_6748590600,420,1,12,-12,12,2,3,1,1,3,2,-1,0,1,6,6,0,4,4,0,1,16,-32,2,5,7,1,0,1,1,1,1,1,3,1
KR_6753884266,420,2,24,21,4,4,4,0,-2,1,3,2,2,0,1,3,2,-1,1,2,1,3,-19,-1,4,3,-3,0,2,1,1,1,1,2,1
KR_6751436673,420,2,35,-2,1,-2,2,4,6,7,1,1,3,2,-1,1,2,-3,0,3,1,13,-8,-3,11,8,1,0,0,1,1,1,1,1,1
KR_6700513851,420,5,45,45,15,2,3,1,-2,1,3,5,7,2,11,12,1,-1,0,1,0,20,6,4,4,8,3,0,2,1,1,1,1,3,1
KR_6773782805,420,2,45,-19,8,-2,2,4,0,4,4,1,4,3,9,10,1,0,2,2,0,7,8,1,5,6,-2,0,0,1,-1,0,-1,6,1
KR_6756166240,440,6,65,22,8,-1,4,5,3,4,1,1,4,3,0,4,4,5,5,0,-1,-2,16,-1,4,3,-2,0,0,1,1,1,-1,5,1
KR_6738550423,420,0,-55,1,1,2,2,0,-1,1,2,3,5,2,-1,1,2,-2,1,3,0,-6,117,-4,8,4,0,0,0,-1,-1,-1,-1,6,1
KR_6776874564,420,0,-41,-1,1,2,3,1,-2,1,3,0,1,1,3,4,1,-2,3,5,0,-10,1,6,5,11,-7,0,0,1,-1,1,-1,2,1
KR_6706139856,420,3,12,-5,7,4,4,0,-1,1,2,2,2,0,2,3,1,0,0,0,0,12,-7,-1,5,4,4,0,1,-1,1,1,1,1,1
KR_6757201633,420,3,15,37,6,-2,0,2,0,4,4,1,2,1,4,6,2,3,3,0,1,8,0,0,7,7,1,0,1,-1,1,1,1,5,1
KR_6753231575,420,-3,4,-5,-9,-1,0,1,-5,2,7,-1,5,6,-1,6,7,-1,1,2,0,-9,-8,-2,8,6,2,0,0,-1,1,0,1,1,1
KR_6740770764,420,4,72,16,12,4,4,0,-2,3,5,3,5,2,7,9,2,0,2,2,0,14,-42,-2,6,4,3,0,2,1,1,1,1,2,1
KR_6777815553,420,3,-6,50,7,-1,0,1,4,5,1,2,2,0,4,5,1,-2,0,2,1,6,4,3,4,7,-2,0,1,1,1,1,-1,3,1
KR_6771581557,420,3,60,1,3,1,2,1,3,3,0,1,1,0,-1,2,3,-1,3,4,1,-1,2,-2,8,6,0,0,0,1,1,-1,1,3,1
KR_6776731486,420,6,25,48,5,1,3,2,1,2,1,1,4,3,2,3,1,0,0,0,0,9,2,4,2,6,3,0,3,1,1,1,-1,2,1
KR_6751950177,420,5,47,0,6,-1,0,1,3,7,4,-4,2,6,6,7,1,2,2,0,-1,16,-18,-1,7,6,0,0,1,1,1,1,-1,6,1
KR_6745355267,420,7,91,13,12,4,5,1,6,6,0,4,5,1,-2,0,2,0,1,1,0,14,0,3,3,6,3,0,2,1,1,1,1,6,1
KR_6775932645,420,2,19,29,10,-1,1,2,4,7,3,3,7,4,4,7,3,0,1,1,2,8,83,-4,9,5,-7,0,0,1,1,-1,1,6,1
KR_6767781443,420,-2,20,-2,-3,-2,3,5,-3,2,5,-5,0,5,7,8,1,0,2,2,1,8,-1,0,8,8,2,0,-1,1,-1,-1,1,3,1
KR_6765602983,420,-1,-51,-16,-6,-4,1,5,1,9,8,-2,2,4,2,5,3,-3,0,3,0,-2,15,-6,7,1,-3,0,0,0,-1,-1,-1,0,1
KR_6776486856,420,3,50,8,10,2,5,3,2,5,3,1,4,3,3,8,5,2,2,0,1,13,6,5,5,10,1,0,1,1,1,1,1,1,1
KR_6774129905,420,2,67,-3,-3,1,1,0,1,3,2,0,2,2,-3,3,6,-2,0,2,0,-6,-201,4,7,11,-3,0,2,1,1,1,-1,4,1
KR_6776844430,420,1,1,18,-3,-3,2,5,3,4,1,0,1,1,-3,2,5,0,1,1,0,-4,0,0,9,9,0,0,2,1,1,1,-1,4,1
KR_6718790142,420,1,-18,-2,-2,-4,0,4,0,8,8,1,2,1,1,2,1,0,1,1,0,-5,-24,1,6,7,2,0,1,-1,-1,1,1,3,1
KR_6775521514,420,1,8,8,-7,-2,1,3,5,6,1,2,2,0,-9,4,13,-3,0,3,-2,-4,-9,1,6,7,-3,0,-2,-1,-1,-1,-1,2,1
KR_6774395940,420,3,79,40,7,-1,3,4,4,6,2,0,3,3,4,5,1,0,2,2,1,13,29,0,6,6,3,0,3,1,1,1,1,2,1
KR_6775914532,420,0,-31,36,-3,3,3,0,3,5,2,-1,1,2,-9,2,11,1,4,3,0,-1,8,-1,7,6,-7,0,-1,-1,-1,-1,-1,1,1
KR_6772116896,420,1,-9,32,5,0,1,1,0,3,3,1,3,2,3,5,2,1,1,0,0,5,25,0,5,5,1,0,1,1,1,1,1,4,1
KR_6776983745,420,7,134,11,14,5,6,1,2,7,5,8,9,1,-1,5,6,0,1,1,0,12,2,0,6,6,1,0,4,1,1,1,1,6,1
KR_6774944289,420,1,28,8,8,-2,2,4,0,3,3,4,4,0,2,5,3,4,4,0,0,11,8,0,7,7,5,0,0,1,1,1,1,3,1
KR_6764635667,420,4,20,18,3,-3,1,4,5,5,0,1,2,1,1,2,1,-1,1,2,-1,-3,-12,-8,12,4,9,0,1,-1,1,1,-1,1,1
KR_6764938480,420,4,100,21,8,1,2,1,3,4,1,-1,2,3,5,5,0,0,0,0,1,9,7,-1,6,5,-2,0,1,1,-1,1,1,5,1
KR_6735520914,420,4,53,5,7,2,4,2,2,3,1,7,7,0,-1,2,3,-3,0,3,-1,14,10,-1,7,6,-3,0,0,1,-1,1,-1,4,1
KR_6665887241,420,2,-7,-2,3,-1,3,4,-2,3,5,3,4,1,2,2,0,1,1,0,1,2,-7,-2,9,7,6,0,-1,-1,1,1,1,3,1
KR_6775507270,420,2,27,-4,5,3,4,1,2,2,0,-1,0,1,-1,2,3,2,2,0,0,5,-9,-3,7,4,0,0,1,-1,-1,1,1,5,1
KR_6733711005,420,4,17,-20,16,2,3,1,2,3,1,9,10,1,1,3,2,2,2,0,1,18,-8,-2,5,3,8,0,3,1,1,1,1,5,1
KR_6726895060,420,1,-37,38,9,3,5,2,3,8,5,2,3,1,-3,2,5,4,4,0,0,10,8,5,2,7,-4,0,0,1,1,1,-1,1,1
KR_6769216911,420,1,66,8,-4,1,2,1,0,3,3,-1,1,2,-4,1,5,0,1,1,0,-4,0,2,9,11,-2,0,-1,1,-1,-1,1,5,1
KR_6741241602,440,4,-27,22,9,5,5,0,4,4,0,0,0,0,-1,2,3,1,1,0,0,11,-7,-6,11,5,3,0,-1,-1,1,1,1,6,1
KR_6752319339,440,4,60,0,13,6,7,1,1,3,2,-1,2,3,7,7,0,0,3,3,0,14,3,5,0,5,-1,0,2,1,1,1,1,6,1
KR_6761561174,440,7,46,10,11,2,5,3,-4,0,4,6,9,3,7,8,1,0,0,0,0,9,7,2,3,5,6,0,0,0,0,1,-1,0,1
KR_6756917140,420,1,-3,23,2,5,5,0,-2,3,5,-3,0,3,1,2,1,1,1,0,0,-11,-2,2,5,7,-2,0,1,-1,1,1,1,4,1
KR_6776843008,420,3,48,19,9,3,4,1,0,2,2,3,3,0,3,3,0,0,3,3,0,6,-33,2,2,4,30,0,1,1,1,1,1,6,1
KR_6756081129,420,4,38,1,8,1,4,3,0,1,1,4,7,3,2,3,1,1,2,1,0,7,12,2,6,8,-4,0,-1,0,-1,1,-1,0,1
KR_6775933077,420,5,31,10,11,1,2,1,4,4,0,3,5,2,3,5,2,0,0,0,0,16,6,7,3,10,4,0,2,1,1,1,1,5,1
KR_6775449859,440,-2,12,-8,-8,-3,2,5,5,6,1,-1,3,4,-4,1,5,-5,3,8,3,-4,5,1,4,5,1,0,1,1,1,1,1,5,1
KR_6767079370,420,3,39,14,3,3,3,0,2,4,2,2,3,1,-5,5,10,1,1,0,0,1,3,0,6,6,-1,0,-1,1,-1,-1,1,3,1
KR_6721074786,420,0,5,36,2,0,1,1,2,4,2,1,3,2,0,0,0,-1,0,1,0,1,-32,4,5,9,-6,0,1,-1,1,1,1,4,1
KR_6736409260,420,1,48,3,7,3,4,1,8,9,1,0,1,1,-3,0,3,-1,0,1,0,8,53,2,4,6,-21,0,0,1,-1,1,1,5,1
KR_6776460080,420,3,57,63,0,-2,2,4,5,8,3,0,1,1,0,2,2,-3,0,3,0,-4,8,4,4,8,2,0,0,1,1,1,-1,2,1
KR_6733146429,420,0,29,1,-3,-5,1,6,1,5,4,1,3,2,0,0,0,0,1,1,0,-1,31,-5,10,5,3,0,0,-1,1,1,-1,3,1
KR_6776836327,420,6,44,12,7,3,3,0,5,6,1,2,2,0,-3,1,4,0,2,2,0,13,16,-1,4,3,2,0,2,-1,-1,1,-1,5,1
KR_6776002929,420,4,35,20,8,2,4,2,-2,1,3,5,6,1,7,9,2,-4,1,5,0,-2,-7,-2,7,5,0,0,0,1,1,-1,-1,4,1
KR_6749048016,420,-3,-9,-2,-7,-2,2,4,-4,2,6,3,8,5,-3,1,4,-1,0,1,0,-17,0,0,8,8,0,0,0,-1,-1,1,-1,2,1
KR_6733728281,420,6,126,34,11,3,3,0,0,0,0,1,1,0,8,11,3,-1,1,2,1,12,4,0,4,4,0,0,3,1,1,1,1,6,1
KR_6719972381,420,2,32,5,1,-6,0,6,0,4,4,1,4,3,6,6,0,0,2,2,-1,7,-3,-3,6,3,5,0,1,0,1,1,-1,0,1
KR_6766572529,440,4,26,32,4,-3,0,3,0,6,6,1,1,0,2,3,1,4,6,2,0,2,6,-4,7,3,4,0,1,1,-1,1,-1,3,1
KR_6776346987,420,-2,-51,-19,-4,0,2,2,-2,2,4,-1,3,4,-1,3,4,0,1,1,0,-5,1,2,5,7,-1,0,2,-1,1,1,1,2,1
KR_6776645810,420,0,-8,8,-4,0,1,1,-2,0,2,-1,0,1,0,3,3,-1,0,1,0,-3,-2,-2,5,3,-1,0,0,1,-1,0,-1,4,1
KR_6770414498,420,2,-16,8,5,-1,2,3,2,2,0,2,3,1,0,2,2,2,2,0,0,10,-1,-1,8,7,10,0,-1,1,-1,-1,1,6,1
KR_6735098631,420,-1,8,9,1,0,3,3,5,5,0,-2,3,5,-3,4,7,1,1,0,0,11,12,1,8,9,-3,0,0,1,1,0,1,3,1
KR_6699385089,420,8,83,29,12,3,5,2,2,3,1,0,1,1,5,7,2,2,4,2,0,9,32,1,2,3,1,0,1,-1,1,1,-1,6,1
KR_6774225490,420,5,130,16,12,4,5,1,3,7,4,2,5,3,0,2,2,3,3,0,0,9,-10,-4,7,3,5,0,1,-1,1,1,1,3,1
KR_6761683536,440,3,-15,28,3,3,3,0,2,3,1,1,2,1,-4,2,6,1,2,1,0,-6,-5,-5,5,0,3,0,0,1,1,0,1,4,1
KR_6775302046,420,3,-6,21,-1,-5,0,5,0,1,1,4,7,3,-1,2,3,1,2,1,0,-2,-3,-3,8,5,4,0,0,1,-1,0,1,1,1
KR_6716134200,420,1,-4,-12,5,3,6,3,2,6,4,2,5,3,-2,2,4,0,0,0,0,5,2,-4,5,1,3,0,-2,1,-1,1,-1,6,1
KR_6715285139,420,5,92,17,13,1,1,0,6,6,0,-1,0,1,6,8,2,1,1,0,1,14,8,2,5,7,6,0,1,1,1,1,1,5,1
KR_6776366557,440,-1,-21,19,1,0,1,1,-1,4,5,-1,0,1,0,0,0,3,3,0,0,5,5,-1,5,4,5,0,0,-1,1,1,-1,2,1
KR_6767640484,420,3,6,7,8,0,0,0,-1,3,4,6,6,0,5,8,3,-2,1,3,0,6,-19,4,5,9,2,0,0,1,1,0,-1,5,1
KR_6763460307,440,-1,-58,4,6,4,4,0,-1,1,2,1,4,3,2,2,0,0,2,2,0,7,-6,-2,4,2,5,0,-1,0,-1,-1,1,0,1
KR_6744987453,420,4,-5,-44,16,2,4,2,3,4,1,2,2,0,9,10,1,0,0,0,0,22,5,2,6,8,8,0,0,1,1,-1,-1,1,1
KR_6736497623,420,1,-9,0,3,2,2,0,-1,3,4,6,6,0,-5,1,6,1,1,0,0,2,-9,2,7,9,0,0,0,1,0,1,-1,4,1
KR_6777751757,420,0,30,-14,9,4,4,0,4,5,1,5,5,0,-4,1,5,0,0,0,1,15,-1,1,4,5,3,0,1,-1,1,1,1,1,1
KR_6755911153,420,0,-33,-10,0,-2,0,2,3,4,1,3,6,3,-4,4,8,0,0,0,0,2,-17,-5,11,6,5,0,-1,1,1,-1,-1,6,1
KR_6775423399,420,3,2,12,7,0,2,2,-1,2,3,6,7,1,0,2,2,2,2,0,0,9,-7,-5,9,4,-4,0,2,0,1,1,-1,0,1
KR_6756305443,420,1,-80,8,8,-1,1,2,4,8,4,4,4,0,1,5,4,0,0,0,-1,9,-4,-1,5,4,-2,0,0,1,-1,-1,-1,1,1
KR_6743671881,420,1,10,12,2,-1,1,2,2,3,1,5,7,2,-5,1,6,1,1,0,0,5,45,1,4,5,0,0,1,-1,1,1,-1,3,1
KR_6770671911,420,1,8,35,-3,1,2,1,4,4,0,-3,2,5,-3,1,4,-2,0,2,-1,0,-2,-4,5,1,1,0,0,-1,-1,-1,-1,6,1
KR_6773398863,420,2,-2,-22,4,1,2,1,0,4,4,1,2,1,2,3,1,0,0,0,0,4,1,3,4,7,4,0,0,1,-1,-1,1,1,1
KR_6759331681,420,4,7,30,4,3,4,1,1,4,3,4,4,0,-4,2,6,0,0,0,0,9,-4,3,4,7,1,0,1,1,1,1,-1,6,1
KR_6722090052,420,3,-1,-25,7,3,6,3,-3,0,3,5,5,0,3,6,3,-1,0,1,-1,10,-4,-3,7,4,2,0,2,-1,1,1,-1,5,1
KR_6765954277,440,2,-8,12,5,0,1,1,0,0,0,1,2,1,2,2,0,2,2,0,0,6,0,3,4,7,-4,0,1,1,1,1,1,2,1
KR_6736891024,420,1,24,35,1,-2,3,5,1,4,3,2,2,0,1,4,3,-1,0,1,0,9,46,-5,10,5,-19,0,1,1,-1,1,-1,6,1
KR_6712526536,420,0,65,2,-2,2,4,2,-2,2,4,3,6,3,-2,0,2,-3,1,4,1,-7,-37,1,6,7,-2,0,0,-1,1,1,1,3,1
KR_6733818433,420,-5,-19,-8,-13,0,0,0,-4,0,4,-5,1,6,-2,1,3,-2,0,2,0,-23,0,5,5,10,-8,0,-1,-1,-1,-1,1,4,1
KR_6767677090,420,2,-1,37,1,0,3,3,-1,2,3,2,4,2,0,2,2,0,1,1,-1,2,12,-5,14,9,2,0,-1,1,-1,-1,-1,3,1
KR_6742712595,420,-1,-10,25,-6,-1,1,2,1,4,3,-2,0,2,-2,1,3,-2,1,3,-1,-17,-15,2,6,8,3,0,1,1,-1,1,-1,4,1
KR_6769085776,420,0,64,0,-1,1,2,1,-1,1,2,1,4,3,0,4,4,-2,0,2,0,-9,11,2,5,7,2,0,1,1,1,1,-1,2,1
KR_6711812458,420,3,30,-10,8,3,4,1,2,3,1,1,2,1,2,4,2,0,0,0,0,8,32,-1,7,6,4,0,-1,1,1,-1,1,2,1
KR_6775478490,420,0,-36,-11,-4,-1,3,4,-1,2,3,1,4,3,-3,0,3,0,1,1,0,-14,3,4,6,10,-2,0,1,-1,-1,1,-1,4,1
KR_6771513211,440,1,61,-20,0,-3,2,5,1,3,2,-3,1,4,5,5,0,0,0,0,0,4,3,3,5,8,6,0,0,1,-1,0,1,5,1
KR_6776896565,420,4,46,36,1,0,3,3,-1,5,6,1,4,3,2,5,3,-1,1,2,-2,-5,-41,3,5,8,-3,0,0,1,-1,1,1,4,1
KR_6757734274,420,5,63,21,11,-1,3,4,0,1,1,9,11,2,1,4,3,2,3,1,0,10,8,5,2,7,-5,0,-1,1,-1,1,1,3,1
KR_6774404177,420,-2,-43,-12,4,-1,2,3,3,5,2,1,1,0,1,2,1,0,2,2,1,4,1,1,5,6,2,0,-1,-1,-1,-1,1,1,1
KR_6770856014,420,-1,-56,12,3,2,5,3,1,2,1,3,3,0,-2,2,4,-1,1,2,1,-1,7,2,8,10,-6,0,1,1,1,1,1,2,1
KR_6773034824,420,-1,6,9,2,0,1,1,-1,0,1,4,5,1,-1,2,3,0,1,1,0,-7,32,-4,7,3,-29,0,0,-1,1,1,1,6,1
KR_6768520801,420,0,-29,9,3,4,4,0,3,4,1,-3,2,5,-1,1,2,0,1,1,0,8,2,1,7,8,7,0,-2,1,-1,-1,-1,5,1
KR_6762033973,420,-1,-36,19,1,-1,0,1,-3,3,6,1,3,2,3,3,0,1,4,3,0,12,17,1,8,9,0,0,-1,1,1,-1,-1,1,1
KR_6730385512,420,-2,-10,22,-14,-3,3,6,-6,0,6,-5,1,6,1,3,2,-1,1,2,0,-15,-10,-4,7,3,5,0,0,-1,-1,-1,-1,3,1
KR_6777767096,420,6,33,32,9,4,5,1,7,7,0,1,4,3,-2,1,3,-1,2,3,0,5,42,2,6,8,-1,0,1,-1,1,1,1,4,1
KR_6770042995,420,5,102,7,10,3,4,1,3,4,1,2,4,2,-1,3,4,3,4,1,0,13,-2,1,5,6,4,0,1,1,1,1,-1,4,1
KR_6743266309,420,0,52,28,-6,2,2,0,-1,1,2,-4,2,6,-2,1,3,-1,0,1,0,-9,-82,-2,7,5,9,0,0,-1,-1,0,-1,2,1
KR_6761059340,420,2,17,-4,-1,1,4,3,0,3,3,-1,1,2,-1,3,4,0,0,0,0,2,-25,2,7,9,-6,0,0,1,-1,-1,-1,2,1
KR_6733622752,420,1,19,0,-1,-1,1,2,2,7,5,0,1,1,-1,3,4,-1,0,1,0,-3,5,2,7,9,0,0,0,-1,1,1,1,5,1
KR_6776133444,420,1,30,14,3,3,4,1,-1,1,2,5,5,0,-5,0,5,1,1,0,0,2,-4,0,6,6,1,0,1,1,1,1,1,5,1
KR_6768379474,420,2,-45,9,5,2,2,0,3,3,0,2,5,3,-3,0,3,1,2,1,0,4,-2,4,5,9,5,0,0,-1,-1,0,-1,5,1
KR_6777016762,420,5,45,-13,6,-1,1,2,3,4,1,1,1,0,1,1,0,2,2,0,0,10,2,3,6,9,3,0,3,-1,1,1,1,3,1
KR_6765315925,420,5,77,45,11,3,4,1,5,5,0,3,4,1,2,3,1,-2,0,2,0,11,-6,4,2,6,6,0,3,1,1,1,1,1,1
KR_6741803134,420,4,71,41,11,-1,0,1,8,8,0,1,3,2,3,5,2,0,0,0,0,10,0,0,10,10,5,0,2,-1,1,1,1,6,1
KR_6738802678,420,0,-11,22,0,-3,0,3,-2,0,2,3,5,2,2,3,1,0,3,3,1,5,42,2,5,7,2,0,1,1,-1,1,1,2,1
KR_6771640210,440,0,-42,-9,2,-4,0,4,-1,3,4,5,6,1,-1,0,1,3,3,0,0,6,32,0,5,5,-1,0,-1,-1,-1,-1,-1,5,1
KR_6765427433,420,0,3,22,5,5,6,1,4,5,1,2,3,1,-5,2,7,-1,0,1,0,3,7,2,5,7,0,0,1,-1,1,1,1,3,1
KR_6777848530,440,2,-75,26,-2,5,6,1,-3,2,5,4,5,1,-11,0,11,3,4,1,0,-5,5,-4,5,1,4,0,0,-1,0,-1,-1,4,1
KR_6746738152,420,-4,-83,-15,-6,-3,3,6,3,8,5,-5,0,5,0,2,2,-1,0,1,0,1,-1,1,7,8,2,0,-2,1,-1,-1,-1,2,1
KR_6776458320,440,-2,-56,-5,-4,-4,1,5,2,4,2,-2,1,3,0,4,4,0,0,0,0,-2,30,3,3,6,-2,0,1,-1,1,1,1,6,1
KR_6755311198,420,4,37,18,6,2,5,3,-2,3,5,0,2,2,3,4,1,3,4,1,-1,3,3,-1,5,4,-4,0,2,-1,1,1,-1,5,1
KR_6735053603,420,-3,-5,-12,-2,4,5,1,-2,6,8,-2,1,3,-2,1,3,0,3,3,2,-6,-18,1,8,9,0,0,1,-1,1,1,1,4,1
KR_6708329881,420,0,54,-24,-4,0,1,1,-3,3,6,-1,1,2,-1,3,4,1,1,0,0,-2,-22,-1,7,6,-2,0,0,1,-1,0,-1,3,1
KR_6764244255,420,1,32,-5,3,-1,0,1,3,7,4,-1,2,3,4,5,1,-2,0,2,1,4,-37,3,8,11,9,0,1,-1,-1,1,1,6,1
KR_6764401770,420,1,26,23,4,-2,1,3,-1,3,4,4,9,5,2,6,4,1,2,1,1,6,-5,-13,16,3,6,0,1,-1,1,1,-1,2,1
KR_6735236671,420,4,-2,39,10,3,3,0,6,9,3,-5,1,6,5,7,2,1,2,1,0,2,44,1,7,8,2,0,2,1,1,1,1,4,1
KR_6760766688,420,0,15,-21,-3,1,2,1,0,3,3,-2,3,5,-2,1,3,0,0,0,0,2,20,-2,9,7,3,0,1,-1,-1,1,-1,3,1
KR_6667935886,420,-2,6,8,1,-3,3,6,4,4,0,2,7,5,-2,2,4,0,0,0,0,-1,-4,0,5,5,0,0,-1,1,1,-1,1,1,1
KR_6771750607,420,4,56,28,8,-3,2,5,5,6,1,2,4,2,3,5,2,1,1,0,0,13,2,2,5,7,0,0,1,1,-1,1,1,1,1
KR_6768338763,440,-2,7,-16,-1,1,1,0,-3,1,4,2,2,0,1,1,0,-2,1,3,0,-4,4,1,5,6,1,0,0,-1,-1,0,-1,5,1
KR_6698324798,420,2,-9,31,-1,-2,1,3,0,3,3,4,6,2,-4,1,5,1,2,1,0,-1,3,-1,8,7,-1,0,0,-1,1,1,-1,1,1
KR_6745455354,420,4,65,35,12,-3,0,3,1,2,1,4,5,1,8,9,1,2,2,0,0,8,3,-3,9,6,4,0,3,1,1,1,1,1,1
KR_6770965550,420,2,-52,-5,10,1,3,2,3,3,0,-1,2,3,3,5,2,4,4,0,0,18,-12,-3,6,3,-1,0,1,1,-1,-1,1,2,1
KR_6742832208,420,3,41,12,4,4,5,1,-1,1,2,-2,1,3,3,4,1,0,0,0,0,5,9,-2,7,5,4,0,2,1,1,1,-1,5,1
KR_6711283126,440,0,52,-30,-2,2,3,1,-5,1,6,-6,0,6,5,8,3,2,3,1,0,3,0,2,7,9,-3,0,1,-1,1,1,1,5,1
KR_6700183973,420,-2,83,-14,6,0,1,1,6,10,4,0,3,3,0,0,0,0,1,1,0,6,6,2,7,9,-6,0,1,-1,1,1,1,2,1
KR_6776959788,420,-1,-8,-12,6,0,3,3,1,2,1,2,4,2,2,5,3,1,1,0,0,3,28,1,3,4,4,0,1,1,1,1,1,3,1
KR_6767108072,420,4,74,24,8,6,8,2,-3,1,4,-4,2,6,8,8,0,1,1,0,-1,11,-284,-5,9,4,8,0,2,1,0,1,-1,2,1
KR_6776378961,420,-3,-6,-22,-4,-3,0,3,0,3,3,2,2,0,-1,1,2,-2,3,5,1,-7,-6,0,5,5,5,0,-1,-1,1,-1,1,6,1
KR_6775121024,420,4,53,8,12,3,4,1,1,2,1,7,8,1,1,3,2,0,1,1,0,11,12,1,3,4,-2,0,2,1,1,1,1,5,1
KR_6768004614,420,0,0,3,2,0,2,2,2,4,2,0,0,0,0,2,2,0,3,3,0,-3,7,2,6,8,-1,0,0,1,1,1,1,5,1
KR_6748508360,420,3,29,29,10,1,2,1,5,7,2,0,2,2,3,5,2,1,2,1,0,12,37,2,7,9,0,0,1,1,-1,-1,1,3,1
KR_6773632389,420,5,95,-4,9,4,4,0,4,7,3,1,1,0,0,2,2,0,0,0,0,4,4,3,7,10,-8,0,0,1,1,0,1,2,1
KR_6768885532,440,7,102,17,22,6,7,1,6,7,1,4,7,3,2,4,2,4,5,1,2,21,46,3,2,5,2,0,3,0,0,1,1,0,1
KR_6738893251,420,7,78,15,8,1,3,2,-1,2,3,5,5,0,2,5,3,1,2,1,0,6,-1,-2,10,8,4,0,2,1,-1,1,1,1,1
KR_6760899753,420,3,-24,60,9,1,2,1,5,7,2,7,10,3,-1,1,2,-3,0,3,2,5,12,-3,6,3,0,0,0,1,1,1,1,3,1
KR_6719977856,420,-1,-3,-17,-8,-2,1,3,-4,0,4,1,3,2,-3,1,4,0,1,1,0,-10,-9,-5,10,5,3,0,0,-1,-1,-1,-1,2,1
KR_6725997653,420,5,96,20,11,1,3,2,3,4,1,-3,2,5,8,10,2,2,2,0,0,5,4,3,5,8,-3,0,2,1,1,1,1,3,1
KR_6777169113,420,0,-14,-2,10,2,3,1,6,7,1,-1,5,6,-1,1,2,4,4,0,1,13,-7,-2,9,7,9,0,1,-1,1,1,1,4,1
KR_6768838732,420,0,15,20,-5,-3,0,3,-1,2,3,3,5,2,-3,1,4,-1,1,2,0,-8,-10,-4,10,6,4,0,1,1,1,1,1,2,1
KR_6775445676,420,3,54,-10,13,3,4,1,1,2,1,0,3,3,3,4,1,6,6,0,-1,15,12,0,5,5,-2,0,1,1,-1,-1,-1,1,1
KR_6739075975,420,2,9,23,4,-3,0,3,4,4,0,4,4,0,-1,0,1,0,1,1,0,11,30,-2,9,7,5,0,-2,1,-1,-1,-1,4,1
KR_6734082131,420,6,70,20,7,3,3,0,1,3,2,2,3,1,-1,2,3,2,3,1,0,5,3,3,8,11,0,0,1,1,1,1,1,6,1
KR_6776413853,420,3,30,13,8,-1,0,1,6,7,1,1,3,2,0,3,3,2,2,0,0,6,-56,-6,11,5,7,0,1,1,1,1,1,6,1
KR_6739500371,420,3,0,64,-2,-4,1,5,-4,1,5,4,6,2,0,1,1,2,4,2,0,7,12,-3,7,4,7,0,1,1,-1,-1,1,6,1
KR_6770980558,420,3,32,42,7,0,3,3,5,7,2,5,7,2,0,5,5,-3,0,3,-2,9,30,-3,6,3,5,0,1,1,1,1,-1,5,1
KR_6731707979,440,0,-29,19,4,-5,2,7,4,9,5,-6,1,7,1,3,2,10,11,1,1,16,0,-4,7,3,6,0,-1,1,1,-1,-1,4,1
KR_6705486546,420,0,-4,23,5,0,2,2,9,10,1,-1,1,2,-1,2,3,-2,0,2,1,11,28,0,6,6,-6,0,0,1,1,1,1,5,1
KR_6772387072,420,7,18,45,20,0,3,3,5,5,0,8,8,0,5,7,2,2,3,1,2,27,2,2,4,6,4,0,5,1,1,1,1,2,1
KR_6771846559,420,-1,-7,11,-2,1,4,3,-2,2,4,2,3,1,-3,1,4,0,0,0,0,-4,-9,-2,6,4,6,0,1,-1,1,1,1,4,1
KR_6695056369,420,6,68,19,11,5,6,1,-2,1,3,7,7,0,3,4,1,-2,0,2,0,9,36,3,3,6,0,0,2,-1,1,1,1,6,1
KR_6774747613,420,0,-49,-8,6,7,8,1,-1,2,3,-1,0,1,1,4,3,0,1,1,1,3,281,4,3,7,-3,0,1,1,1,1,1,5,1
KR_6775686331,420,-1,28,-11,2,0,7,7,5,6,1,-1,1,2,-1,2,3,-1,2,3,2,3,-2,3,6,9,-5,0,0,1,1,0,1,1,1
KR_6750800277,420,0,39,0,0,-2,0,2,6,9,3,0,2,2,0,0,0,-4,1,5,0,0,134,3,6,9,-6,0,2,1,1,1,1,1,1
KR_6740040667,420,2,-1,9,4,2,2,0,1,3,2,2,4,2,-1,1,2,0,0,0,0,4,4,1,5,6,0,0,0,-1,-1,1,1,4,1
KR_6776736010,420,0,24,1,7,-1,1,2,2,4,2,6,6,0,1,1,0,-1,1,2,0,12,-1,0,5,5,-1,0,0,-1,-1,1,-1,4,1
KR_6765730401,440,3,74,24,2,0,2,2,-4,3,7,3,4,1,3,5,2,0,1,1,-1,-1,6,0,4,4,1,0,0,1,0,-1,-1,3,1
KR_6729438512,420,4,85,5,8,0,3,3,3,10,7,5,8,3,2,3,1,-2,1,3,1,11,2,4,5,9,-2,0,1,1,-1,1,1,1,1
KR_6744162167,420,1,-12,16,5,1,1,0,-2,2,4,3,5,2,1,3,2,2,3,1,0,6,38,4,5,9,6,0,0,1,1,0,1,5,1
KR_6723513595,420,3,-17,-5,6,-1,1,2,7,8,1,-2,3,5,2,2,0,0,2,2,0,5,-7,-6,11,5,-1,0,0,1,-1,-1,-1,3,1
KR_6711842347,420,6,-11,21,9,2,3,1,2,5,3,1,2,1,3,6,3,1,3,2,0,20,-10,-7,11,4,-5,0,0,1,-1,1,-1,6,1
KR_6775452936,420,-1,-60,4,6,0,2,2,2,4,2,0,2,2,5,5,0,-1,0,1,0,5,0,1,9,10,0,0,0,-1,-1,-1,1,1,1
KR_6758043351,420,1,-15,35,2,1,1,0,0,4,4,-3,4,7,1,2,1,3,3,0,-1,-2,-7,-3,7,4,2,0,0,1,1,1,-1,2,1
KR_6754649143,420,2,-48,17,4,0,2,2,2,4,2,0,0,0,2,3,1,0,2,2,0,1,2,1,5,6,-2,0,-1,-1,-1,-1,1,2,1
KR_6746237339,420,0,-26,0,5,1,1,0,1,6,5,3,5,2,0,4,4,0,2,2,0,10,1,4,8,12,0,0,1,-1,1,1,1,4,1
KR_6775053259,420,-2,-52,-20,-2,0,1,1,1,1,0,-1,1,2,-3,3,6,1,1,0,0,1,38,3,4,7,3,0,1,-1,1,-1,-1,2,1
KR_6766659798,420,0,-27,6,1,2,2,0,1,1,0,2,2,0,-3,1,4,-1,1,2,0,0,-2,-6,11,5,-6,0,1,1,1,1,-1,2,1
KR_6773566440,440,0,-16,17,5,-4,0,4,8,8,0,-2,0,2,4,4,0,-1,0,1,1,4,1,1,5,6,-1,0,-2,1,1,-1,1,6,1
KR_6776776063,420,4,99,-4,6,1,4,3,0,3,3,6,6,0,2,7,5,-3,2,5,0,13,-4,2,3,5,-1,0,-1,1,1,-1,1,4,1
KR_6772951245,420,-1,-21,12,1,-3,2,5,3,4,1,3,4,1,0,4,4,-2,1,3,0,0,-11,-5,8,3,2,0,-1,-1,1,-1,1,4,1
KR_6742522031,420,0,-18,-13,-3,3,4,1,-3,3,6,1,1,0,-2,3,5,-2,1,3,-1,-2,0,-1,6,5,-3,0,2,-1,1,1,-1,2,1
KR_6770625255,420,-3,-45,10,2,0,3,3,1,5,4,0,2,2,0,3,3,1,2,1,0,8,17,4,3,7,2,0,1,1,1,1,1,2,1
KR_6737898291,420,5,83,-24,9,2,4,2,2,6,4,2,2,0,1,4,3,2,2,0,0,4,3,0,5,5,-1,0,0,-1,1,1,-1,4,1
KR_6770415072,420,3,75,-3,10,0,1,1,3,4,1,0,2,2,7,8,1,0,1,1,0,13,-5,0,7,7,4,0,0,1,-1,1,1,6,1
KR_6749719716,420,3,-25,8,3,6,7,1,-1,2,3,-1,1,2,-1,2,3,0,0,0,-2,-9,3,-5,7,2,3,0,0,1,1,0,-1,1,1
KR_6736486245,420,-1,32,-18,2,-1,1,2,3,4,1,5,7,2,-3,3,6,-2,2,4,0,0,-16,-5,9,4,2,0,1,1,1,1,-1,6,1
KR_6737172101,440,3,20,17,10,0,0,0,1,1,0,7,8,1,1,3,2,1,1,0,0,12,-69,1,5,6,22,0,-1,1,-1,-1,1,5,1
KR_6703580982,420,2,1,32,4,-1,1,2,-2,2,4,3,4,1,1,2,1,3,3,0,-1,8,-7,3,3,6,5,0,0,1,1,1,-1,4,1
KR_6728433992,420,4,89,-2,5,6,8,2,0,5,5,3,4,1,-5,2,7,1,2,1,-1,6,38,-1,7,6,2,0,4,-1,1,1,1,3,1
KR_6743606851,440,2,-19,-8,0,0,2,2,-1,3,4,6,6,0,-5,0,5,0,2,2,0,13,-3,-2,8,6,7,0,1,-1,1,1,1,4,1
KR_6744110562,420,3,-22,10,4,1,1,0,1,1,0,1,7,6,-3,1,4,4,5,1,1,4,-1,-3,5,2,1,0,0,1,1,-1,1,5,1
KR_6777732932,420,7,73,38,9,3,3,0,3,3,0,0,3,3,2,2,0,1,1,0,0,11,-29,2,3,5,10,0,4,1,1,1,1,5,1
KR_6768776786,440,3,38,-33,11,7,7,0,4,4,0,1,4,3,2,2,0,-3,1,4,1,23,-4,-1,8,7,3,0,0,1,-1,1,1,4,1
KR_6773641105,420,0,22,4,5,0,1,1,2,4,2,1,2,1,2,3,1,0,3,3,1,14,-128,4,7,11,-3,0,0,-1,1,0,1,2,1
KR_6770475877,420,-3,-82,-27,-1,1,2,1,1,4,3,3,5,2,-5,4,9,-1,2,3,0,3,-26,-5,8,3,2,0,-1,-1,-1,-1,-1,1,1
KR_6775836805,420,1,12,39,9,1,1,0,1,3,2,5,7,2,3,8,5,-1,1,2,3,7,5,1,8,9,-1,0,1,1,-1,1,1,1,1
KR_6755637621,420,1,21,-11,8,4,4,0,0,3,3,5,6,1,0,2,2,-1,1,2,1,7,-20,2,6,8,0,0,1,-1,1,1,1,4,1
KR_6776923734,420,0,-45,8,-3,0,1,1,-2,2,4,0,1,1,-1,2,3,0,0,0,0,-8,-52,2,5,7,20,0,-1,1,-1,-1,1,2,1
KR_6708238295,420,10,114,28,19,3,4,1,5,6,1,7,7,0,5,7,2,-1,0,1,0,20,2,4,6,10,3,0,2,1,-1,1,1,4,1
KR_6696898524,420,3,22,78,5,2,3,1,-5,0,5,6,9,3,4,5,1,-2,1,3,0,-6,2,-11,14,3,4,0,1,1,1,1,1,4,1
KR_6776232735,420,3,43,12,8,-1,1,2,1,2,1,1,4,3,5,5,0,2,2,0,1,11,19,3,3,6,1,0,3,1,1,1,1,5,1
KR_6768733394,420,-1,-17,7,-3,1,3,2,-1,3,4,3,4,1,-4,1,5,-2,0,2,0,-6,-35,-3,7,4,3,0,0,1,-1,0,-1,1,1
KR_6764767624,420,4,49,8,10,0,2,2,3,3,0,-1,1,2,6,7,1,2,2,0,0,15,7,4,2,6,0,0,2,1,1,1,-1,2,1
KR_6769245075,420,5,43,8,15,-2,0,2,-3,3,6,6,8,2,6,6,0,8,9,1,0,26,1,-3,6,3,3,0,1,1,-1,1,1,5,1
KR_6766733152,420,5,15,-5,7,3,4,1,0,1,1,-3,0,3,6,7,1,1,2,1,0,10,1,-3,9,6,-7,0,1,1,-1,-1,1,6,1
KR_6777804256,420,2,13,5,4,1,2,1,-1,3,4,4,7,3,-1,1,2,1,1,0,0,6,-6,-8,11,3,0,0,0,-1,-1,-1,1,2,1
KR_6747967136,420,0,13,-28,6,3,3,0,1,4,3,-3,0,3,4,4,0,1,1,0,1,3,13,3,5,8,-2,0,1,1,-1,1,1,2,1
KR_6753320621,420,4,127,12,7,2,2,0,2,2,0,1,4,3,4,5,1,-2,1,3,0,3,-3,0,5,5,9,0,1,1,1,1,1,2,1
KR_6776105709,420,-5,-48,8,1,4,4,0,1,2,1,4,6,2,-8,2,10,0,2,2,0,-1,-341,-1,9,8,5,0,1,1,1,1,1,1,1
KR_6770475247,420,0,-53,5,5,-1,1,2,6,8,2,1,3,2,0,3,3,-1,0,1,0,14,89,-1,6,5,-5,0,-1,-1,-1,-1,-1,3,1
KR_6762919096,420,1,42,-8,3,0,3,3,-2,2,4,1,2,1,4,9,5,0,1,1,0,2,-4,1,5,6,3,0,1,-1,1,1,1,3,1
KR_6777067939,420,-1,-32,16,-1,-1,0,1,0,1,1,3,3,0,-4,1,5,1,1,0,0,-1,-1,1,5,6,-4,0,-1,1,-1,-1,1,3,1
KR_6768527482,420,-1,-8,-32,5,-2,3,5,-2,3,5,3,4,1,7,7,0,-1,2,3,0,9,-14,-6,13,7,9,0,1,1,-1,-1,1,2,1
KR_6776755597,420,0,-59,-7,8,3,4,1,0,6,6,4,7,3,2,3,1,-1,3,4,0,7,8,2,6,8,-4,0,-1,-1,-1,-1,1,6,1
KR_6769394179,420,3,60,0,-5,0,2,2,0,3,3,-5,0,5,0,3,3,0,0,0,0,-2,14,2,6,8,-1,0,0,1,-1,0,-1,1,1
KR_6773817600,420,2,1,35,6,-2,1,3,5,5,0,-1,2,3,4,5,1,0,0,0,0,9,-1,2,7,9,2,0,-1,1,-1,-1,-1,5,1
KR_6777046126,420,2,13,18,10,0,2,2,3,5,2,0,3,3,1,2,1,6,7,1,1,15,-27,6,4,10,2,0,0,1,1,1,1,2,1
KR_6774692183,420,3,-30,8,10,4,4,0,0,0,0,4,4,0,7,10,3,-5,0,5,-1,4,-4,-1,7,6,1,0,-1,1,-1,-1,1,5,1
KR_6776407018,420,1,-22,3,3,3,4,1,-6,0,6,4,6,2,2,2,0,0,1,1,0,-3,5,5,1,6,-2,0,0,-1,1,0,1,2,1
KR_6774604037,420,4,22,29,3,0,3,3,3,4,1,-1,0,1,1,2,1,0,0,0,0,3,36,-4,6,2,-2,0,0,1,-1,0,1,4,1
KR_6775536834,420,-1,-14,-4,-3,-2,0,2,-2,2,4,0,2,2,2,4,2,-1,2,3,0,-4,-8,-7,9,2,6,0,-1,1,-1,1,-1,3,1
KR_6775453312,420,4,48,8,0,5,5,0,1,5,4,-2,2,4,-4,1,5,0,0,0,-1,-1,6,3,3,6,-1,0,1,-1,1,1,-1,4,1
KR_6770838678,420,3,99,2,6,2,3,1,2,4,2,-1,0,1,0,3,3,3,3,0,0,5,-41,0,8,8,6,0,1,0,1,1,1,0,1
KR_6776561766,440,3,46,0,9,-2,1,3,1,1,0,3,4,1,1,2,1,6,7,1,1,11,-39,0,7,7,-3,0,0,1,1,0,1,4,1
KR_6764666201,420,-2,29,-24,-2,4,6,2,-4,1,5,-4,2,6,2,3,1,0,0,0,-1,1,10,-1,9,8,0,0,0,-1,-1,-1,-1,1,1
KR_6774315109,420,1,-7,-8,4,0,1,1,2,2,0,1,2,1,2,2,0,-1,0,1,0,11,40,3,4,7,0,0,0,-1,-1,0,1,6,1
KR_6756519460,420,0,12,20,1,1,3,2,0,5,5,1,3,2,-1,5,6,0,1,1,0,-8,10,7,2,9,-5,0,-1,0,1,-1,-1,0,1
KR_6745434682,420,3,33,29,5,3,3,0,2,2,0,2,3,1,0,1,1,-2,0,2,0,2,8,-4,9,5,-4,0,2,-1,1,1,-1,2,1
KR_6773373174,420,1,8,4,-1,4,6,2,-2,0,2,2,5,3,-3,4,7,-2,1,3,1,6,-2,-1,5,4,4,0,0,1,1,1,1,2,1
KR_6774245342,420,3,29,0,1,4,6,2,-2,1,3,-2,0,2,1,5,4,0,1,1,0,-4,-28,-1,7,6,-4,0,1,-1,-1,1,-1,6,1
KR_6757050584,420,1,45,-12,-1,0,2,2,-4,0,4,2,3,1,1,2,1,0,1,1,0,-9,-1,0,7,7,1,0,1,0,1,1,1,0,1
KR_6715181962,420,2,38,13,1,2,3,1,1,4,3,-3,1,4,0,1,1,1,1,0,0,3,-27,-2,8,6,4,0,0,1,-1,0,1,2,1
KR_6777551342,420,3,27,17,7,3,5,2,-2,1,3,0,0,0,6,6,0,0,1,1,0,5,12,3,7,10,4,0,2,-1,1,1,1,6,1
KR_6732492784,420,1,2,4,-2,0,0,0,2,2,0,-1,1,2,-3,0,3,0,1,1,0,-11,42,3,6,9,2,0,1,-1,1,1,1,1,1
KR_6742889675,420,-1,-35,-9,-2,-1,0,1,0,4,4,0,2,2,0,2,2,-1,1,2,0,-3,39,-5,10,5,6,0,0,-1,1,-1,-1,5,1
KR_6772095438,420,0,6,-18,5,10,10,0,-4,0,4,-2,2,4,1,3,2,0,3,3,2,6,7,2,4,6,2,0,-1,0,1,-1,1,0,1
KR_6772567918,420,6,84,29,15,2,4,2,3,6,3,3,3,0,4,5,1,3,3,0,0,16,0,0,7,7,4,0,2,1,1,1,1,1,1
KR_6775590039,420,3,94,-11,7,-1,3,4,-1,2,3,6,7,1,4,7,3,-1,0,1,0,-1,-38,-3,8,5,9,0,1,1,-1,1,1,5,1
KR_6758874837,420,4,26,6,6,-1,1,2,3,4,1,-3,1,4,9,11,2,-2,0,2,0,9,-3,-9,16,7,1,0,0,1,-1,1,1,2,1
KR_6748651239,420,0,-49,-11,-5,-4,2,6,3,4,1,0,2,2,-4,0,4,0,2,2,-1,-7,188,-8,12,4,3,0,-2,-1,1,-1,-1,1,1
KR_6732081753,420,2,24,28,4,1,3,2,3,3,0,-3,1,4,2,3,1,1,1,0,0,3,0,2,7,9,-2,0,1,1,1,1,1,2,1
KR_6777706029,420,3,16,1,2,2,3,1,2,5,3,2,2,0,-2,0,2,-2,0,2,0,1,3,0,6,6,3,0,0,-1,1,1,1,5,1
KR_6758479368,420,2,6,14,4,3,3,0,-5,1,6,1,2,1,6,7,1,-1,2,3,0,-1,99,1,8,9,2,0,0,-1,1,0,1,5,1
KR_6770112277,420,-5,7,-28,0,-3,1,4,0,1,1,-3,3,6,5,6,1,1,2,1,0,12,-30,4,4,8,-2,0,0,1,-1,-1,1,3,1
KR_6760901735,420,-3,78,18,2,3,3,0,0,2,2,-1,6,7,1,4,3,-1,0,1,0,1,-8,-1,8,7,3,0,1,1,1,1,1,2,1
KR_6777867633,420,4,38,41,7,3,3,0,3,4,1,2,2,0,1,1,0,-2,1,3,0,8,6,-3,8,5,2,0,1,1,-1,1,1,6,1
KR_6777550349,440,7,38,5,17,2,3,1,0,1,1,10,10,0,2,5,3,3,4,1,0,20,4,-1,10,9,4,0,0,1,1,1,1,6,1
KR_6771322859,420,4,-22,17,4,-1,1,2,0,3,3,1,4,3,2,2,0,2,2,0,0,8,-3,1,4,5,5,0,0,1,1,0,1,1,1
KR_6776310176,420,6,24,27,19,4,4,0,4,7,3,0,1,1,-3,5,8,14,16,2,0,24,63,-3,7,4,0,0,1,-1,-1,1,-1,2,1
KR_6720842205,420,3,42,9,4,-1,1,2,5,6,1,1,3,2,-1,2,3,0,3,3,0,10,-16,1,6,7,1,0,0,-1,1,-1,1,6,1
KR_6772523687,440,2,-3,-8,2,0,1,1,1,1,0,4,7,3,-2,0,2,-1,1,2,0,8,-65,-3,9,6,-2,0,0,-1,1,0,-1,2,1
KR_6773731420,420,-2,9,-17,-1,1,3,2,-4,4,8,2,2,0,1,2,1,-1,0,1,0,0,176,6,4,10,-6,0,2,-1,1,1,-1,2,1
KR_6699889898,420,5,70,14,13,1,3,2,3,4,1,3,7,4,6,7,1,0,2,2,0,10,-86,0,5,5,2,0,3,-1,1,1,1,6,1
KR_6777028908,440,3,31,16,7,4,4,0,3,4,1,-6,0,6,2,3,1,4,4,0,0,-1,-36,1,4,5,2,0,1,1,-1,1,-1,2,1
KR_6760186322,420,2,41,14,-3,2,3,1,-6,1,7,-1,0,1,2,5,3,0,1,1,0,3,-43,1,7,8,2,0,1,1,-1,1,1,5,1
KR_6744780441,420,3,97,8,2,-1,0,1,1,3,2,-1,1,2,2,5,3,1,2,1,0,-5,2,-1,6,5,3,0,0,0,-1,1,1,0,1
KR_6777840000,420,5,57,24,13,3,3,0,2,4,2,4,5,1,3,3,0,1,3,2,-1,9,-11,0,8,8,12,0,1,1,1,1,-1,4,1
KR_6753328590,420,2,26,-30,10,0,2,2,5,5,0,2,4,2,2,6,4,1,1,0,0,14,17,5,7,12,8,0,1,-1,1,1,1,5,1
KR_6775580563,420,4,57,46,16,6,6,0,-1,1,2,-2,1,3,14,15,1,-1,1,2,0,10,7,2,3,5,-3,0,4,1,1,1,1,4,1
KR_6714938368,420,3,-8,0,2,-2,0,2,4,9,5,2,4,2,-2,3,5,0,0,0,2,7,-21,0,6,6,-4,0,1,1,1,1,1,2,1
KR_6776326205,420,0,14,-38,0,0,1,1,-2,3,5,-2,1,3,4,4,0,0,1,1,0,7,-1,6,3,9,3,0,1,-1,1,1,1,1,1
KR_6765873142,420,4,33,12,7,2,2,0,1,4,3,2,4,2,2,3,1,0,0,0,0,10,-45,3,6,9,-2,0,1,1,-1,1,1,4,1
KR_6753770851,420,4,24,33,3,0,2,2,3,4,1,0,5,5,0,1,1,0,0,0,0,-1,15,8,0,8,-5,0,0,1,1,1,-1,4,1
KR_6776100851,420,2,25,22,3,-2,1,3,2,3,1,7,8,1,-2,4,6,-2,0,2,0,14,4,0,8,8,0,0,-1,1,-1,-1,-1,4,1
KR_6775737547,420,2,6,20,4,2,4,2,2,3,1,2,3,1,-2,2,4,0,1,1,0,0,5,4,2,6,1,0,2,1,1,1,1,1,1
KR_6771087818,420,2,-58,29,6,-1,1,2,8,11,3,-3,1,4,2,2,0,0,3,3,0,14,-14,1,6,7,1,0,0,1,1,1,-1,3,1
KR_6739459176,420,4,20,43,8,0,3,3,4,6,2,0,1,1,5,7,2,-1,1,2,0,13,4,5,4,9,2,0,0,1,1,1,-1,1,1
KR_6776183203,420,2,39,14,8,-2,1,3,-1,4,5,11,12,1,0,2,2,0,2,2,0,0,12,0,7,7,-10,0,1,-1,1,1,-1,5,1
KR_6753136930,420,1,7,-41,12,0,2,2,4,5,1,3,6,3,3,3,0,2,3,1,0,28,-14,0,5,5,3,0,1,1,1,1,-1,3,1
KR_6754555896,420,-1,-14,5,6,1,1,0,7,9,2,0,2,2,-2,1,3,0,2,2,1,14,10,1,8,9,-3,0,-1,-1,1,-1,1,6,1
KR_6736787036,420,4,36,-8,11,5,5,0,2,4,2,5,6,1,1,4,3,-2,1,3,0,9,10,-1,5,4,0,0,2,1,-1,1,-1,3,1
KR_6742881269,420,-4,1,9,-2,0,2,2,4,9,5,-1,0,1,-3,0,3,-2,1,3,0,1,6,7,3,10,-4,0,-1,1,1,-1,-1,3,1
KR_6767032298,420,-1,-25,-17,-4,-1,1,2,-3,1,4,-2,2,4,2,3,1,0,1,1,-1,2,-5,3,3,6,3,0,-1,-1,1,-1,-1,3,1
KR_6777286265,420,1,97,-12,4,4,6,2,-2,0,2,-1,4,5,2,2,0,1,1,0,0,-3,-81,2,6,8,5,0,0,1,1,-1,1,6,1
KR_6696864756,420,4,-32,1,4,3,3,0,5,6,1,1,4,3,-6,2,8,1,2,1,-4,3,57,2,5,7,-1,0,1,-1,1,-1,-1,6,1
KR_6776954811,420,4,41,-15,16,4,4,0,5,5,0,0,1,1,3,4,1,4,5,1,0,15,6,-1,3,2,1,0,4,1,1,1,1,3,1
KR_6777767674,420,2,45,40,14,4,5,1,2,4,2,3,5,2,1,8,7,4,6,2,0,13,-2,-1,3,2,4,0,2,1,1,1,1,3,1
KR_6772840341,420,0,40,-10,1,6,7,1,-2,1,3,-4,0,4,1,2,1,0,0,0,0,0,46,4,3,7,-19,0,2,-1,1,1,1,5,1
KR_6736100364,420,1,-27,-28,4,1,1,0,2,3,1,-2,1,3,3,4,1,0,0,0,0,3,-12,0,8,8,-2,0,0,-1,1,0,1,3,1
KR_6705705599,420,5,43,20,12,3,4,1,3,5,2,-1,2,3,8,8,0,-1,0,1,0,14,-15,3,4,7,-2,0,0,1,1,1,1,2,1
KR_6745180599,420,3,55,0,10,0,3,3,0,2,2,5,5,0,2,6,4,3,3,0,1,15,7,4,2,6,1,0,-1,1,-1,-1,1,2,1
KR_6752732358,420,0,57,-3,2,1,3,2,3,4,1,0,4,4,-2,3,5,0,3,3,1,2,30,2,4,6,1,0,1,1,1,1,1,6,1
KR_6727816247,420,2,10,0,4,-1,1,2,3,5,2,-1,2,3,2,2,0,1,1,0,0,11,-34,-2,10,8,28,0,0,-1,-1,1,-1,5,1
KR_6739290025,420,5,38,32,13,6,7,1,3,5,2,-2,1,3,5,5,0,1,2,1,1,9,5,-1,6,5,1,0,1,1,-1,1,1,5,1
KR_6740990862,420,1,14,-9,4,1,3,2,3,6,3,0,1,1,-1,0,1,1,1,0,0,2,6,-3,8,5,-4,0,-1,-1,1,-1,-1,1,1
KR_6757796364,440,-2,0,-44,-6,-4,1,5,-4,1,5,-5,1,6,6,6,0,1,1,0,0,1,-30,1,7,8,1,0,-1,-1,0,-1,1,4,1
KR_6761887355,420,2,25,31,6,2,3,1,1,3,2,2,3,1,1,2,1,0,0,0,0,4,56,-1,4,3,-26,0,0,1,-1,0,-1,2,1
KR_6702589099,420,1,-14,-8,5,5,5,0,-1,1,2,-1,3,4,3,5,2,-1,0,1,0,8,-3,1,5,6,-8,0,-1,-1,-1,-1,-1,5,1
KR_6687570291,420,2,32,0,10,0,1,1,4,6,2,5,6,1,2,3,1,-1,0,1,0,9,6,8,4,12,-2,0,1,1,-1,1,1,4,1
KR_6753411432,420,9,134,40,4,-1,0,1,2,4,2,1,3,2,2,2,0,0,0,0,0,5,23,1,3,4,0,0,4,0,1,1,1,0,1
KR_6753728419,420,2,24,-4,4,1,2,1,0,4,4,1,3,2,2,3,1,0,0,0,0,5,17,6,4,10,-7,0,1,-1,1,1,1,2,1
KR_6777885187,420,2,-3,30,2,-1,0,1,4,5,1,2,4,2,-3,0,3,0,1,1,0,4,-11,-1,6,5,4,0,0,1,-1,-1,-1,3,1
KR_6777199375,420,2,6,27,1,5,6,1,-1,2,3,-1,2,3,-2,3,5,0,1,1,-1,-3,2,5,7,12,6,0,1,-1,1,1,-1,1,1
KR_6733755808,420,1,-21,36,8,1,2,1,4,9,5,4,4,0,-1,0,1,0,1,1,1,6,16,8,6,14,-5,0,-1,1,-1,-1,1,1,1
KR_6734600462,420,-3,-15,-16,-2,2,2,0,1,2,1,-1,2,3,0,2,2,-4,0,4,0,-2,-6,0,9,9,4,0,1,1,1,1,-1,3,1
KR_6768876463,420,1,-47,-29,21,3,6,3,1,2,1,4,6,2,12,15,3,1,1,0,-1,28,7,-1,7,6,7,0,-1,1,1,-1,1,4,1
KR_6762431314,420,1,0,-2,-6,1,3,2,-2,3,5,1,2,1,-6,3,9,0,2,2,0,-2,7,2,6,8,-4,0,0,-1,-1,-1,-1,3,1
KR_6776603109,420,2,65,-28,3,1,3,2,-1,1,2,1,1,0,-4,1,5,6,7,1,0,-4,18,2,1,3,1,0,1,1,1,1,-1,6,1
KR_6777320347,420,2,0,29,-1,1,3,2,-5,0,5,0,2,2,2,4,2,1,3,2,0,4,6,0,4,4,-2,0,0,-1,1,0,-1,1,1
KR_6713872428,420,2,19,-9,-1,2,3,1,0,2,2,2,3,1,-4,4,8,-1,0,1,0,-5,-31,-3,7,4,4,0,1,-1,-1,1,-1,6,1
KR_6777160270,420,3,-45,15,7,1,2,1,0,2,2,4,4,0,1,1,0,1,1,0,0,11,16,2,3,5,2,0,1,1,1,1,1,1,1
KR_6712368066,420,2,19,19,8,6,7,1,0,5,5,2,2,0,0,2,2,0,0,0,0,6,8,5,5,10,-8,0,2,-1,1,1,1,4,1
KR_6761787871,420,0,-41,-10,-2,-1,0,1,-3,1,4,0,0,0,3,5,2,-1,0,1,0,1,-2,-4,7,3,-2,0,1,1,-1,1,-1,2,1
KR_6746177655,420,0,-11,-11,4,0,0,0,3,4,1,0,5,5,2,5,3,-1,0,1,1,12,0,1,5,6,3,0,-1,-1,-1,-1,1,2,1
KR_6774921931,420,3,83,8,6,1,2,1,0,1,1,0,3,3,4,5,1,1,1,0,1,8,13,5,5,10,0,0,1,1,-1,1,1,3,1
KR_6774116334,420,1,22,-15,6,5,5,0,-4,0,4,3,6,3,2,4,2,0,0,0,0,6,-46,-1,6,5,22,0,0,-1,-1,1,1,6,1
KR_6740222422,420,0,55,15,2,-4,1,5,0,5,5,-1,2,3,6,8,2,1,2,1,0,-1,14,-3,8,5,2,0,0,1,-1,1,1,2,1
KR_6734916953,420,-3,2,-56,-2,-1,1,2,1,4,3,0,5,5,-1,2,3,-1,1,2,0,-1,-6,-1,6,5,-1,0,1,-1,-1,-1,-1,6,1
KR_6751542615,420,1,-15,0,-1,3,4,1,-1,1,2,-2,0,2,-2,3,5,1,2,1,0,3,7,-2,6,4,1,0,1,-1,-1,1,-1,1,1
KR_6770500487,420,2,-30,37,0,4,4,0,-1,2,3,-2,0,2,-1,3,4,0,0,0,0,-6,-10,-1,5,4,0,0,-2,-1,-1,-1,-1,2,1
KR_6762279188,420,1,24,8,5,4,4,0,-1,1,2,1,2,1,-1,0,1,2,2,0,0,0,-4,-2,6,4,3,0,1,0,1,1,1,0,1
KR_6776381378,420,2,-22,13,5,2,3,1,-3,3,6,0,2,2,3,4,1,3,5,2,0,-2,2,-3,12,9,0,0,2,1,1,1,1,2,1
KR_6698433992,420,2,46,-3,7,0,3,3,-1,3,4,0,0,0,8,9,1,0,1,1,1,14,20,-5,9,4,9,0,0,1,-1,1,1,2,1
KR_6738294655,440,-3,-76,-22,2,-3,0,3,0,4,4,-1,0,1,4,5,1,2,2,0,2,5,8,1,8,9,0,0,1,1,-1,1,1,6,1
KR_6745945814,420,4,30,23,9,1,3,2,8,9,1,1,1,0,0,4,4,-1,3,4,0,3,33,-1,6,5,0,0,2,0,1,1,1,0,1
KR_6712437668,420,5,34,19,9,0,1,1,7,9,2,2,3,1,0,1,1,0,1,1,0,9,-28,1,5,6,-1,0,0,1,1,1,1,6,1
KR_6755798614,440,2,56,32,2,0,3,3,-1,0,1,0,1,1,5,8,3,-2,2,4,1,-4,15,-1,6,5,2,0,0,1,1,0,1,3,1
KR_6754441188,420,2,25,16,9,2,2,0,5,5,0,1,2,1,-2,2,4,3,4,1,0,9,14,7,4,11,-4,0,1,1,-1,1,1,2,1
KR_6733855504,420,4,33,15,6,-1,1,2,2,5,3,-1,2,3,9,9,0,-3,1,4,0,4,1,1,3,4,-1,0,0,1,1,0,-1,5,1
KR_6733775707,420,1,51,-17,-1,0,0,0,-5,0,5,-1,1,2,3,6,3,2,2,0,-1,-6,-6,-5,11,6,0,0,-1,1,-1,-1,-1,2,1
KR_6777855439,420,4,43,16,4,3,4,1,5,6,1,-5,0,5,0,3,3,1,2,1,0,7,40,4,7,11,-3,0,0,-1,1,1,-1,6,1
KR_6754477214,420,2,71,-25,-1,1,4,3,-1,2,3,3,5,2,-1,3,4,-3,0,3,1,6,5,-3,10,7,-3,0,1,1,-1,1,1,6,1
KR_6776128339,420,0,-28,-16,7,0,2,2,3,6,3,1,4,3,1,3,2,2,3,1,0,12,-9,0,9,9,-1,0,0,1,-1,0,1,3,1
KR_6776169523,420,2,4,-10,2,3,4,1,0,2,2,-1,4,5,0,1,1,0,1,1,0,4,45,-6,12,6,-33,0,1,-1,-1,1,-1,6,1
KR_6723653798,420,0,-68,0,-5,-3,2,5,-3,4,7,4,6,2,-2,2,4,-1,1,2,0,-1,4,1,8,9,-2,0,-1,1,-1,-1,-1,2,1
KR_6756623573,420,2,-43,32,-2,-1,1,2,-2,1,3,-3,0,3,3,5,2,1,1,0,0,6,2,-2,8,6,-1,0,0,-1,1,0,-1,6,1
KR_6776223630,420,2,17,-23,3,-3,0,3,4,5,1,-1,1,2,3,5,2,0,0,0,0,5,1,-2,10,8,-2,0,0,1,-1,-1,1,3,1
KR_6763538972,420,1,38,-18,7,3,4,1,3,5,2,0,3,3,2,3,1,-1,0,1,0,10,4,2,4,6,-3,0,1,-1,1,1,1,5,1
KR_6754587502,420,1,72,-5,4,2,2,0,3,5,2,-5,0,5,3,8,5,1,2,1,0,7,2,1,4,5,-4,0,1,1,1,1,-1,1,1
KR_6774643808,420,4,50,21,12,2,2,0,4,4,0,-1,3,4,4,5,1,3,3,0,0,5,3,0,8,8,3,0,0,1,1,0,1,5,1
KR_6709131042,420,7,40,10,18,5,5,0,3,3,0,1,2,1,5,7,2,4,4,0,0,18,4,3,1,4,0,0,0,-1,1,1,1,1,1
KR_6737312798,420,3,65,18,13,6,7,1,1,3,2,3,8,5,5,6,1,-2,0,2,0,19,9,3,2,5,-1,0,0,1,1,1,-1,5,1
KR_6777783470,420,-1,15,-10,-2,-1,3,4,2,3,1,-4,0,4,2,5,3,-1,0,1,0,-9,-6,-3,10,7,-2,0,2,1,1,1,-1,4,1
KR_6768127160,420,2,43,-12,3,-1,1,2,1,4,3,-2,1,3,3,7,4,2,2,0,0,10,2,-3,9,6,1,0,0,-1,-1,1,-1,4,1
KR_6718935023,420,1,-11,4,2,2,2,0,5,6,1,0,4,4,-4,1,5,-1,0,1,0,2,8,1,6,7,-3,0,1,-1,1,1,1,6,1
KR_6718820436,420,3,29,-16,8,3,3,0,2,2,0,-1,1,2,2,8,6,2,5,3,1,6,0,5,4,9,7,0,3,1,1,1,-1,2,1
KR_6735070521,420,2,-11,18,5,-3,0,3,6,8,2,1,4,3,1,4,3,0,1,1,0,7,-4,3,4,7,1,0,-1,1,1,-1,1,2,1
KR_6762059719,420,3,66,12,6,0,1,1,1,1,0,7,7,0,-2,0,2,0,0,0,0,2,-1,0,6,6,3,0,0,1,1,0,-1,2,1
KR_6776077032,420,-1,-54,15,1,-1,1,2,3,4,1,2,4,2,-3,3,6,0,2,2,1,-2,18,-7,13,6,-8,0,0,-1,1,1,1,1,1
KR_6766698473,420,-1,-70,18,3,3,3,0,2,3,1,-1,1,2,-1,1,2,0,1,1,0,2,2,-2,8,6,-7,0,0,1,-1,0,1,2,1
KR_6754622294,420,3,30,21,4,-1,2,3,3,7,4,0,4,4,1,1,0,1,1,0,0,11,-9,-6,9,3,-1,0,0,1,-1,0,-1,4,1
KR_6777390153,420,0,-32,3,5,-1,0,1,-3,4,7,4,5,1,4,7,3,1,1,0,0,6,0,-1,6,5,0,0,0,1,1,0,1,2,1
KR_6776519457,420,-5,-41,12,-12,-5,0,5,-5,3,8,1,1,0,-1,3,4,-2,0,2,-1,-19,-9,-5,9,4,-3,0,-1,1,1,-1,-1,5,1
KR_6699569946,420,-3,-46,10,-2,1,1,0,2,4,2,0,1,1,0,5,5,-5,3,8,1,6,25,8,1,9,0,0,-3,-1,1,-1,1,3,1
KR_6776779626,420,2,49,-7,6,4,5,1,2,4,2,1,3,2,1,2,1,-2,0,2,0,-4,9,0,5,5,-2,0,3,1,1,1,1,1,1
KR_6774117893,420,0,-21,35,1,3,5,2,-5,1,6,-1,3,4,0,1,1,4,5,1,0,4,0,-2,9,7,0,0,0,1,-1,-1,1,2,1
KR_6742420434,440,3,-16,-2,9,-1,1,2,0,0,0,0,1,1,-1,2,3,11,11,0,0,14,22,7,5,12,-21,0,2,1,1,1,-1,3,1
KR_6777256288,420,3,70,-15,6,-2,0,2,6,7,1,0,2,2,-2,0,2,4,5,1,0,3,4,0,9,9,2,0,0,1,-1,1,-1,3,1
KR_6777802354,420,0,17,0,-2,-2,0,2,3,6,3,1,3,2,-3,1,4,-1,1,2,0,-2,11,-2,6,4,-3,0,1,1,1,1,-1,3,1
KR_6767658158,420,-2,-80,3,4,-1,2,3,1,2,1,8,10,2,-1,3,4,-3,0,3,0,-2,22,-1,6,5,-1,0,0,-1,1,1,1,1,1
KR_6760137455,420,0,-53,-12,-6,0,0,0,-3,2,5,-1,2,3,0,2,2,-2,1,3,0,0,-35,-7,9,2,2,0,0,-1,-1,0,-1,1,1
KR_6764281239,420,5,-18,-13,5,0,2,2,1,3,2,2,2,0,-1,2,3,3,3,0,-1,6,0,-2,8,6,1,0,1,-1,-1,1,-1,1,1
KR_6777767903,420,-1,-31,-4,-3,1,4,3,-2,4,6,-1,5,6,-1,1,2,0,1,1,0,-6,-12,-2,10,8,10,0,0,1,0,0,-1,4,1
KR_6768333720,440,3,63,-13,6,5,6,1,-4,1,5,0,4,4,2,5,3,3,3,0,0,4,50,-1,4,3,-10,0,1,-1,-1,1,-1,1,1
KR_6754895777,420,2,10,7,5,8,9,1,1,2,1,2,4,2,-4,2,6,-2,1,3,1,-1,3,4,2,6,-3,0,2,-1,1,1,1,1,1
KR_6776340307,420,2,79,-11,5,4,6,2,-2,1,3,3,6,3,2,4,2,-2,1,3,0,3,13,1,3,4,-3,0,2,-1,1,1,1,2,1
KR_6775408149,420,1,-22,4,6,-1,0,1,3,6,3,0,2,2,4,7,3,0,0,0,0,13,36,-1,7,6,0,0,0,1,-1,1,1,1,1
KR_6775866626,420,3,50,16,-2,1,1,0,0,1,1,6,7,1,-5,0,5,-4,0,4,0,-6,-28,3,5,8,11,0,1,-1,1,1,-1,6,1
KR_6777544288,420,2,-10,6,10,4,5,1,3,9,6,-1,1,2,3,6,3,1,1,0,0,19,12,3,7,10,-6,0,1,1,1,1,1,3,1
KR_6774229304,420,5,39,6,3,0,2,2,4,6,2,0,2,2,-1,0,1,0,1,1,0,4,-1,-2,5,3,4,0,0,-1,-1,1,1,1,1
KR_6776744037,420,-1,-7,16,-1,-6,0,6,2,3,1,2,2,0,2,2,0,-1,0,1,1,-1,2,-6,10,4,0,0,0,1,-1,0,1,4,1
KR_6718380678,420,1,14,16,4,-1,1,2,4,6,2,-3,2,5,3,5,2,1,2,1,0,1,-7,-13,16,3,1,0,1,-1,1,1,1,6,1
KR_6741317542,440,5,5,0,8,1,1,0,-2,1,3,3,5,2,2,3,1,4,5,1,0,13,1,3,4,7,1,0,1,-1,1,1,1,1,1
KR_6736674033,420,3,27,-8,8,0,3,3,0,5,5,0,1,1,8,8,0,0,0,0,0,15,-11,3,4,7,22,0,-1,-1,-1,-1,-1,5,1
KR_6776852666,420,6,61,9,15,2,3,1,4,5,1,5,5,0,1,3,2,3,5,2,1,15,25,1,6,7,4,0,2,1,-1,1,1,2,1
KR_6775912775,420,7,46,54,16,-1,0,1,3,8,5,3,4,1,12,16,4,-1,0,1,0,26,3,6,4,10,1,0,3,-1,1,1,-1,6,1
KR_6709125134,420,-1,-47,-16,-6,5,5,0,-2,2,4,0,0,0,-11,0,11,2,3,1,0,-13,-6,2,5,7,-1,0,-1,-1,-1,-1,-1,5,1
KR_6755570471,420,5,71,15,14,2,2,0,5,6,1,4,6,2,2,3,1,1,3,2,0,15,1,7,1,8,9,0,3,1,1,1,-1,4,1
KR_6772574027,420,2,23,1,4,-3,2,5,6,7,1,3,5,2,1,2,1,-3,0,3,0,7,-5,-4,7,3,1,0,1,1,1,1,-1,5,1
KR_6770381979,440,1,37,-30,5,2,2,0,0,0,0,5,5,0,-1,1,2,-1,0,1,1,2,-1,-8,10,2,3,0,2,-1,1,1,1,3,1
KR_6768357665,420,3,34,-4,9,0,1,1,2,2,0,3,4,1,5,5,0,-1,0,1,0,12,-1,1,8,9,4,0,1,1,-1,1,1,2,1
KR_6715483637,420,1,63,12,1,1,1,0,0,2,2,3,4,1,-2,3,5,-1,0,1,0,-9,-6,2,8,10,9,0,0,-1,1,1,-1,5,1
KR_6775801190,420,-2,-33,32,-11,-5,1,6,-1,0,1,-1,4,5,-1,3,4,-3,0,3,-1,-12,6,-4,11,7,-3,0,1,1,1,1,-1,1,1
KR_6777366508,420,2,58,15,-3,0,2,2,-1,1,2,-1,4,5,0,3,3,-1,1,2,0,2,25,-3,6,3,1,0,1,1,0,1,-1,6,1
KR_6746395957,420,0,7,-24,-1,-2,0,2,3,7,4,-4,0,4,0,8,8,2,3,1,-1,3,14,-2,8,6,3,0,1,1,-1,1,-1,6,1
KR_6732131652,420,5,70,4,9,-3,1,4,3,5,2,6,7,1,3,3,0,0,1,1,-1,15,42,3,4,7,5,0,0,1,1,0,-1,2,1
KR_6745762807,420,5,83,20,17,4,5,1,1,7,6,0,3,3,7,10,3,5,5,0,0,17,6,3,3,6,-4,0,4,-1,1,1,-1,1,1
KR_6737480780,420,3,14,24,1,1,1,0,-2,1,3,1,1,0,1,3,2,0,0,0,0,5,4,2,7,9,1,0,0,-1,1,0,-1,3,1
KR_6757122200,440,-1,12,36,4,2,3,1,0,5,5,0,4,4,-1,1,2,3,3,0,0,-1,9,2,3,5,-2,0,0,1,-1,-1,-1,2,1
KR_6731073812,440,0,87,-19,6,-2,0,2,-3,0,3,2,4,2,6,7,1,3,3,0,0,13,5,-1,2,1,3,0,2,-1,1,1,1,6,1
KR_6777715838,420,5,54,0,8,3,4,1,2,4,2,0,2,2,0,1,1,3,5,2,0,8,3,-3,5,2,0,0,1,1,-1,1,-1,6,1
KR_6767346994,420,8,124,32,12,4,5,1,-2,0,2,3,4,1,6,7,1,1,2,1,0,13,6,4,3,7,4,0,2,1,1,1,1,6,1
KR_6769151034,420,1,0,20,3,-1,2,3,2,3,1,4,6,2,-1,2,3,-1,1,2,0,4,7,4,4,8,1,0,2,-1,1,1,1,1,1
KR_6706510453,420,-3,-48,13,5,3,7,4,2,4,2,1,1,0,-1,2,3,0,0,0,0,4,15,5,3,8,-4,0,-1,1,1,-1,1,5,1
KR_6754053180,420,3,41,7,7,2,4,2,-1,0,1,3,7,4,3,4,1,0,0,0,0,12,42,1,4,5,-1,0,0,-1,-1,0,-1,3,1
KR_6765976668,420,3,-6,17,10,1,3,2,6,7,1,1,1,0,0,1,1,2,3,1,1,14,6,0,3,3,3,0,0,-1,-1,0,1,3,1
KR_6776109356,420,-4,38,33,-14,-2,0,2,2,3,1,-2,2,4,-6,0,6,-6,0,6,0,-17,-17,-3,6,3,2,0,0,-1,1,0,-1,4,1
KR_6776256125,420,3,14,28,8,6,6,0,2,4,2,4,5,1,-3,2,5,-1,0,1,1,6,6,5,4,9,3,0,4,1,1,1,1,4,1
KR_6765700080,420,4,44,5,3,1,1,0,0,2,2,0,0,0,0,0,0,2,2,0,0,3,-30,-1,5,4,6,0,1,1,1,1,1,1,1
KR_6771260291,420,2,33,24,8,-3,1,4,-2,3,5,2,2,0,11,13,2,0,1,1,0,12,10,2,5,7,-1,0,0,1,-1,1,1,1,1
KR_6757570052,420,0,-21,7,1,2,2,0,-1,4,5,-2,2,4,2,4,2,0,0,0,-1,-2,0,-3,8,5,-5,0,-1,-1,1,-1,-1,3,1
KR_6760911532,440,-1,-6,-21,-4,-1,2,3,-4,1,5,-3,0,3,0,2,2,4,5,1,0,-1,-6,-3,13,10,-6,0,-1,-1,-1,-1,-1,1,1
KR_6735315504,420,-1,-11,-10,-3,1,2,1,-2,2,4,3,4,1,-1,2,3,-4,1,5,0,-3,-17,0,8,8,5,0,0,-1,1,0,1,5,1
KR_6777021527,420,2,24,12,4,5,5,0,2,3,1,3,6,3,-3,0,3,-3,0,3,0,5,1,3,2,5,-2,0,0,-1,-1,1,1,5,1
KR_6774600819,420,0,-2,0,5,-3,0,3,2,4,2,4,6,2,1,4,3,1,1,0,0,12,1,3,6,9,2,0,0,1,-1,0,1,1,1
KR_6702906997,420,2,-64,27,9,-2,1,3,6,6,0,5,8,3,-3,4,7,3,3,0,1,22,7,-4,8,4,4,0,1,0,1,1,1,0,1
KR_6764203444,420,-1,23,11,-4,-3,1,4,1,5,4,-2,3,5,-1,3,4,1,1,0,0,-1,-43,-4,8,4,6,0,0,0,0,1,-1,0,1
KR_6777633794,420,8,60,6,18,2,3,1,1,5,4,10,10,0,1,4,3,4,4,0,0,10,-11,-1,5,4,-4,0,3,1,1,1,1,2,1
KR_6697515319,420,-1,-22,-32,-2,2,3,1,0,3,3,-2,3,5,-1,3,4,-1,0,1,0,-7,-22,1,7,8,-1,0,1,-1,1,1,1,3,1
KR_6752815573,420,0,39,-9,5,-1,1,2,1,1,0,-1,1,2,7,8,1,-1,0,1,0,6,-1,3,3,6,8,0,1,1,1,1,1,4,1
KR_6744359055,420,-1,52,3,1,2,5,3,-1,1,2,-5,0,5,3,4,1,2,3,1,-1,2,255,-4,9,5,-2,0,0,-1,-1,-1,-1,1,1
KR_6709255986,420,1,-20,-13,1,-1,1,2,-4,3,7,2,3,1,8,9,1,-4,2,6,0,10,12,-1,9,8,-8,0,0,1,-1,-1,-1,5,1
KR_6777748535,420,0,-10,-10,7,4,4,0,0,2,2,1,3,2,1,2,1,1,1,0,0,9,-9,-2,8,6,3,0,0,-1,1,0,1,4,1
KR_6754021588,420,-3,-49,-16,-8,-4,0,4,-1,3,4,0,2,2,-2,1,3,-1,0,1,0,-8,22,-3,7,4,0,0,-1,-1,1,-1,-1,5,1
KR_6702656785,420,9,86,51,20,13,13,0,3,6,3,-1,1,2,7,7,0,-2,0,2,0,14,10,3,6,9,-1,0,4,1,1,1,1,1,1
KR_6771913931,440,2,48,5,5,-2,0,2,0,1,1,3,3,0,3,5,2,1,3,2,0,4,120,-2,8,6,0,0,1,-1,-1,1,-1,1,1
KR_6776201973,420,8,101,3,26,5,6,1,1,4,3,10,10,0,8,9,1,2,2,0,0,27,-17,9,1,10,7,0,2,-1,-1,1,1,6,1
KR_6776201889,420,4,101,-1,17,3,4,1,5,7,2,0,2,2,8,9,1,1,1,0,-1,14,8,5,6,11,-1,0,1,-1,1,1,-1,2,1
KR_6744817931,420,1,38,52,-5,-1,1,2,4,5,1,-1,2,3,-5,2,7,-2,1,3,0,-8,27,0,4,4,-6,0,1,-1,-1,1,-1,2,1
KR_6767433608,420,-1,0,-8,-3,-3,0,3,0,4,4,0,2,2,-1,0,1,1,1,0,0,-3,5,-1,7,6,3,0,-1,1,1,-1,-1,2,1
KR_6743735702,420,3,25,13,13,0,4,4,1,3,2,8,11,3,3,6,3,1,2,1,0,17,1,3,10,13,2,0,1,1,1,1,-1,1,1
KR_6708999418,420,0,34,-35,0,0,2,2,0,2,2,-1,3,4,1,4,3,0,4,4,0,9,-104,2,5,7,0,0,-1,1,-1,-1,-1,3,1
KR_6753331976,420,-1,-20,-16,-4,0,1,1,-6,0,6,5,5,0,-3,1,4,0,0,0,1,-9,-47,-5,9,4,1,0,-1,1,-1,-1,1,4,1
KR_6760647259,420,4,43,3,9,8,8,0,0,3,3,2,4,2,-3,3,6,2,2,0,1,6,2,1,4,5,-3,0,2,1,1,1,1,3,1
KR_6775660309,420,2,72,-8,2,0,3,3,-2,2,4,-3,2,5,4,4,0,3,3,0,0,-3,-3,0,9,9,0,0,1,1,1,1,-1,5,1
KR_6715102279,440,5,30,29,12,0,2,2,5,5,0,-3,1,4,4,5,1,6,7,1,0,18,5,-3,8,5,0,0,1,1,1,1,-1,3,1
KR_6777888873,420,3,-24,-18,7,-1,1,2,7,8,1,-1,0,1,2,2,0,0,1,1,0,16,42,-2,10,8,0,0,0,1,1,1,1,6,1
KR_6736820006,420,-1,25,18,-1,1,1,0,0,5,5,0,1,1,-2,0,2,0,1,1,0,0,37,-5,9,4,-1,0,0,1,1,1,-1,2,1
KR_6732753047,420,1,64,5,2,2,5,3,1,4,3,0,4,4,2,4,2,-3,0,3,0,-1,12,9,1,10,-3,0,2,1,-1,1,-1,2,1
KR_6711144872,440,1,-98,18,2,0,3,3,-2,1,3,2,2,0,0,3,3,2,2,0,0,-2,10,0,6,6,1,0,0,1,1,1,-1,3,1
KR_6749427922,420,-3,-28,-48,-5,0,3,3,-6,0,6,5,5,0,-2,0,2,-2,0,2,0,-9,-55,-4,9,5,18,0,-1,-1,1,1,-1,5,1
KR_6710525382,420,1,-2,0,14,3,4,1,0,2,2,8,8,0,3,3,0,0,1,1,0,21,-6,-2,8,6,6,0,1,1,-1,1,1,1,1
KR_6756709656,420,2,-9,-36,14,0,1,1,-2,1,3,0,3,3,5,5,0,11,12,1,0,20,11,3,5,8,4,0,0,1,-1,0,1,6,1
KR_6724068063,420,5,73,3,15,1,2,1,3,6,3,4,4,0,5,5,0,2,2,0,0,16,-7,2,3,5,4,0,1,1,-1,1,1,5,1
KR_6766210115,420,0,10,-44,7,0,1,1,5,7,2,4,4,0,-4,3,7,2,2,0,0,5,-12,-2,11,9,0,0,1,-1,1,1,1,1,1
KR_6776267635,420,3,-50,-36,11,0,2,2,7,9,2,0,1,1,4,5,1,0,0,0,0,15,12,-1,9,8,7,0,0,1,1,-1,1,4,1
KR_6772926299,420,0,-9,26,0,-3,0,3,1,2,1,5,5,0,-3,1,4,0,0,0,0,4,9,5,3,8,-6,0,0,1,1,0,-1,6,1
KR_6719997080,420,1,91,15,4,0,5,5,4,7,3,2,2,0,-1,1,2,-1,0,1,0,6,-6,0,6,6,2,0,2,-1,1,1,-1,6,1
KR_6733088951,420,1,38,10,3,0,2,2,1,2,1,-2,2,4,3,3,0,1,1,0,0,9,-11,-6,11,5,11,0,0,1,-1,1,-1,4,1
KR_6769600591,420,0,-70,-7,0,0,1,1,-2,0,2,-2,0,2,6,7,1,-2,0,2,0,0,41,-5,10,5,-4,0,0,-1,-1,0,-1,3,1
KR_6756741717,440,2,26,19,10,7,7,0,1,2,1,5,5,0,1,1,0,-4,0,4,0,9,-3,2,5,7,0,0,1,-1,1,1,1,2,1
KR_6756110993,420,3,37,4,10,2,4,2,-1,3,4,7,9,2,0,1,1,2,3,1,1,18,16,9,5,14,-6,0,1,1,-1,1,1,5,1
KR_6720445090,420,-3,67,-12,-6,1,3,2,-3,2,5,-2,2,4,1,2,1,-3,1,4,0,-9,9,3,3,6,-4,0,1,-1,1,1,-1,4,1
KR_6727081186,420,5,42,-7,12,3,3,0,2,4,2,0,3,3,7,8,1,0,0,0,0,13,4,-1,3,2,0,0,3,1,1,1,1,5,1
KR_6777076637,420,3,65,7,14,3,4,1,2,5,3,7,10,3,6,8,2,-4,0,4,0,16,-121,-4,8,4,5,0,1,1,1,1,1,4,1
KR_6708921916,420,1,-35,44,3,-3,3,6,3,5,2,0,4,4,2,5,3,1,2,1,-1,2,15,2,4,6,2,0,0,1,1,0,-1,4,1
KR_6768465382,420,1,65,29,-3,1,1,0,-3,4,7,1,2,1,-3,2,5,1,2,1,0,0,-3,-3,7,4,2,0,0,1,-1,0,1,6,1
KR_6775958913,420,0,72,-4,-1,0,3,3,-3,0,3,0,1,1,0,5,5,2,2,0,1,-5,2,-1,6,5,-4,0,0,-1,1,1,1,2,1
KR_6777677534,420,1,-19,16,4,-3,2,5,-2,1,3,0,3,3,8,9,1,1,1,0,0,9,-24,-4,10,6,0,0,-1,1,-1,-1,1,1,1
KR_6764548340,420,-1,-24,-2,-1,-5,1,6,-1,1,2,6,6,0,-1,2,3,0,2,2,0,0,-10,2,4,6,4,0,-2,-1,-1,-1,-1,3,1
KR_6774078852,440,4,-13,-18,6,0,3,3,8,8,0,0,6,6,0,1,1,-2,1,3,0,13,-3,1,4,5,0,0,1,-1,0,1,-1,6,1
KR_6769818302,420,2,52,-9,5,0,1,1,6,8,2,2,3,1,-2,2,4,-1,2,3,0,8,92,-1,7,6,3,0,0,-1,1,0,-1,6,1
KR_6691566175,420,1,48,11,6,-1,2,3,0,6,6,6,6,0,-1,1,2,2,2,0,1,7,9,5,6,11,-1,0,1,-1,0,1,1,6,1
KR_6775116409,420,3,-17,13,3,2,3,1,2,5,3,2,2,0,1,1,0,-4,0,4,0,3,36,-1,7,6,8,0,-1,1,1,-1,1,1,1
KR_6775573874,420,5,78,28,12,4,6,2,1,1,0,4,4,0,4,6,2,-1,0,1,2,9,12,-2,7,5,-1,0,4,1,1,1,1,5,1
KR_6764458484,420,-1,14,9,1,0,1,1,0,1,1,-6,0,6,5,8,3,2,2,0,0,12,13,5,2,7,0,0,1,1,1,1,-1,1,1
KR_6748369366,420,2,16,18,6,3,5,2,1,3,2,-2,1,3,4,6,2,0,2,2,0,11,3,1,4,5,-2,0,1,1,1,1,-1,4,1
KR_6728323622,440,4,109,-4,8,-1,1,2,-2,1,3,10,11,1,4,6,2,-3,4,7,0,13,0,-1,4,3,2,0,2,-1,1,1,-1,4,1
KR_6775901243,420,0,-6,20,0,0,1,1,0,1,1,1,7,6,-2,1,3,1,1,0,0,3,-14,0,4,4,3,0,-1,1,-1,1,1,6,1
KR_6742459603,440,-2,6,4,-4,0,1,1,-1,0,1,0,2,2,-4,2,6,1,1,0,0,-7,51,-3,8,5,0,0,0,-1,0,-1,-1,6,1
KR_6725366044,420,-4,-68,-12,-3,2,3,1,-1,5,6,-3,0,3,-2,1,3,1,4,3,1,-8,5,3,6,9,2,0,0,1,1,1,1,3,1
KR_6742274235,420,2,47,-12,2,3,5,2,2,6,4,-1,4,5,-1,1,2,-1,0,1,0,-8,-1,-2,6,4,-3,0,2,-1,1,1,1,5,1
KR_6772263035,420,-3,-43,1,-2,2,3,1,6,7,1,-2,3,5,-1,0,1,-7,1,8,0,3,9,10,2,12,-3,0,-2,1,1,-1,-1,5,1
KR_6764191580,420,0,-13,33,7,1,1,0,2,5,3,7,8,1,-4,1,5,1,3,2,1,10,19,1,5,6,-3,0,2,1,1,1,-1,6,1
KR_6766785559,420,2,-5,-8,7,2,2,0,1,5,4,-1,2,3,0,2,2,5,5,0,0,9,15,5,5,10,-3,0,2,1,-1,1,1,4,1
KR_6770314904,420,1,10,17,-5,-3,0,3,0,2,2,-2,1,3,1,5,4,-1,1,2,0,-5,-39,-3,9,6,-2,0,-1,1,1,-1,1,3,1
KR_6745238299,420,-2,41,-1,-2,5,6,1,-5,1,6,0,0,0,-3,1,4,1,2,1,0,-5,5,3,9,12,-1,0,1,-1,1,1,-1,4,1
KR_6741336152,420,3,49,14,1,1,1,0,-1,0,1,2,2,0,0,0,0,-1,0,1,0,0,2,1,7,8,3,0,2,1,1,1,1,4,1
KR_6754754409,420,6,16,16,9,3,3,0,1,5,4,4,4,0,-2,1,3,3,4,1,0,16,-39,-4,10,6,4,0,1,1,-1,-1,-1,2,1
KR_6777869583,420,5,24,68,10,-2,0,2,5,5,0,5,7,2,3,4,1,-1,0,1,1,13,12,5,3,8,-4,0,2,1,-1,1,1,4,1
KR_6773172121,420,2,26,6,5,4,4,0,-2,3,5,0,2,2,3,9,6,0,1,1,0,-1,0,6,2,8,-4,0,2,1,1,1,1,2,1
KR_6686616200,420,1,125,-15,4,5,5,0,-1,1,2,5,5,0,-5,1,6,0,0,0,0,-4,-3,0,8,8,7,0,2,1,1,1,-1,4,1
KR_6758662687,420,0,11,5,2,2,2,0,-1,3,4,-2,1,3,3,4,1,0,2,2,1,14,-1,-2,7,5,11,0,0,1,-1,0,1,4,1
KR_6723917407,420,4,75,15,5,5,5,0,-2,3,5,0,2,2,1,3,2,1,1,0,0,3,1,4,5,9,5,0,0,1,1,0,1,4,1
KR_6761169732,420,3,24,30,4,0,0,0,4,5,1,1,5,4,-2,2,4,1,3,2,0,5,2,0,4,4,3,0,1,1,1,1,-1,1,1
KR_6718761126,420,1,55,-27,6,-2,0,2,5,7,2,-3,0,3,8,10,2,-2,1,3,1,3,11,4,4,8,-8,0,2,1,1,1,1,2,1
KR_6773129381,420,-2,9,0,1,-2,2,4,-2,3,5,4,6,2,1,2,1,0,1,1,0,-1,3,-3,10,7,0,0,0,-1,-1,0,1,2,1
KR_6772654533,420,-3,-78,-24,-8,-3,0,3,-2,4,6,-1,3,4,-3,2,5,1,2,1,-1,-7,-44,-1,5,4,-2,0,-1,-1,-1,-1,-1,3,1
KR_6772017698,420,5,55,29,11,-2,2,4,0,3,3,4,4,0,10,10,0,-1,2,3,0,11,10,0,9,9,-6,0,1,1,1,1,-1,2,1
KR_6766530254,440,10,71,40,24,4,4,0,4,4,0,1,2,1,6,6,0,9,10,1,0,19,-5,-2,2,0,2,0,2,1,1,1,1,2,1
KR_6752097829,440,3,-29,44,7,0,0,0,3,3,0,0,3,3,3,4,1,1,2,1,0,9,-4,1,7,8,5,0,0,1,1,0,-1,5,1
KR_6766759929,420,3,16,17,5,3,5,2,0,2,2,3,4,1,0,3,3,-1,0,1,0,-3,5,-1,6,5,-2,0,1,1,1,1,1,6,1
KR_6772385685,420,3,4,12,3,2,4,2,-1,3,4,0,5,5,4,5,1,-2,0,2,0,14,-1,-1,8,7,2,0,0,-1,1,-1,1,6,1
KR_6761646301,420,-1,-63,-36,4,-2,1,3,-1,4,5,5,9,4,0,6,6,2,3,1,-2,12,63,6,3,9,1,0,-1,1,-1,-1,1,6,1
KR_6699132771,420,8,86,19,20,0,1,1,5,7,2,2,3,1,13,14,1,0,0,0,0,20,-220,2,5,7,-1,0,4,1,1,1,1,1,1
KR_6777499580,420,3,23,0,10,4,4,0,0,3,3,1,2,1,4,4,0,1,3,2,0,6,-5,0,4,4,-3,0,1,1,-1,1,1,5,1
KR_6736084971,420,4,88,48,1,4,4,0,0,3,3,-6,1,7,1,1,0,2,2,0,0,-7,-4,-1,7,6,4,0,2,1,1,1,1,4,1
KR_6756861792,440,1,-12,-7,7,0,3,3,2,2,0,1,1,0,4,6,2,0,1,1,1,15,71,-3,6,3,2,0,0,-1,1,1,1,1,1
KR_6739278830,420,0,-14,-29,-7,-7,0,7,1,2,1,-6,1,7,3,6,3,2,2,0,0,-3,-149,5,2,7,0,0,-1,1,-1,-1,-1,5,1
KR_6735562722,420,-1,-18,-3,4,-2,0,2,1,3,2,3,4,1,2,4,2,0,0,0,0,7,-26,0,6,6,1,0,-1,1,1,-1,1,1,1
KR_6755087980,420,3,-4,8,4,0,1,1,5,7,2,-3,0,3,1,1,0,1,1,0,0,9,-15,1,6,7,-1,0,0,1,-1,0,-1,6,1
KR_6715300482,440,4,31,28,3,4,4,0,-1,0,1,0,0,0,-2,3,5,2,5,3,0,2,7,-2,6,4,-2,0,1,1,-1,1,-1,1,1
KR_6713438037,420,-1,56,-44,8,0,0,0,2,3,1,3,4,1,1,2,1,2,2,0,0,18,-32,1,6,7,28,0,0,-1,-1,-1,1,1,1
KR_6771903885,440,1,-34,9,5,-1,3,4,0,2,2,3,5,2,1,4,3,2,3,1,0,7,-5,1,4,5,1,0,-1,1,1,-1,1,1,1
KR_6770301422,440,2,-45,9,3,1,3,2,0,3,3,4,6,2,-3,0,3,1,2,1,1,8,-3,-1,6,5,-3,0,-1,1,-1,-1,1,5,1
KR_6736219626,420,3,72,31,4,4,4,0,0,3,3,-1,1,2,3,3,0,-2,0,2,1,0,-77,4,7,11,-4,0,1,1,1,1,1,2,1
KR_6766479135,420,2,74,-17,9,0,1,1,0,5,5,4,4,0,5,5,0,0,1,1,-1,12,-14,2,3,5,-2,0,2,1,1,1,-1,4,1
KR_6752184079,440,3,28,4,9,-3,1,4,4,4,0,3,4,1,0,0,0,5,6,1,0,14,3,-2,7,5,1,0,0,0,1,1,1,0,1
KR_6716013169,420,-4,-15,-2,-6,-5,0,5,2,4,2,-4,3,7,1,2,1,0,0,0,1,-3,-43,-6,8,2,4,0,1,1,1,1,1,5,1
KR_6777835006,420,-1,-15,0,5,-1,2,3,-4,2,6,5,6,1,6,7,1,-1,0,1,0,11,237,-2,8,6,-9,0,0,-1,-1,-1,-1,5,1
KR_6748172890,420,1,-15,34,2,-3,1,4,3,4,1,2,4,2,0,3,3,0,2,2,0,5,1,1,4,5,4,0,-1,-1,-1,-1,1,1,1
KR_6775278487,420,6,46,-1,12,0,0,0,7,9,2,-2,0,2,6,7,1,1,1,0,-1,11,5,0,2,2,3,0,0,-1,1,1,-1,4,1
KR_6734708110,420,0,24,11,5,0,1,1,-1,2,3,0,1,1,6,6,0,0,0,0,0,8,1,-3,10,7,3,0,-2,1,-1,-1,1,3,1
KR_6760360484,420,-5,-20,-16,-2,-6,1,7,-2,1,3,1,1,0,3,7,4,2,2,0,-1,-3,-49,-6,11,5,2,0,-1,-1,-1,-1,-1,1,1
KR_6701099990,420,4,-13,-14,8,3,6,3,-1,3,4,2,3,1,2,2,0,2,2,0,0,17,7,4,3,7,3,0,1,1,-1,1,1,1,1
KR_6763240277,420,-4,21,-5,-7,-2,0,2,-3,2,5,1,3,2,-2,2,4,-1,0,1,0,-6,-5,-2,8,6,8,0,0,1,1,1,1,6,1
KR_6756152308,420,0,-4,29,4,2,2,0,0,1,1,-1,1,2,3,6,3,0,1,1,0,1,10,2,5,7,-5,0,1,1,-1,1,1,5,1
KR_6736285391,420,0,40,12,3,2,5,3,-1,2,3,1,4,3,0,3,3,1,1,0,-1,-5,221,3,8,11,-3,0,0,1,1,1,-1,6,1
KR_6746747315,420,3,54,16,8,4,4,0,1,2,1,-1,5,6,2,10,8,2,3,1,1,-6,-9,2,5,7,3,0,1,1,1,1,-1,2,1
KR_6759446604,440,0,6,9,1,-1,1,2,1,3,2,-1,0,1,1,1,0,1,1,0,0,2,2,1,5,6,0,0,0,-1,1,0,1,4,1
KR_6775877513,420,-2,20,20,-4,3,4,1,-3,5,8,-2,1,3,2,3,1,-4,0,4,0,-9,8,4,4,8,-3,0,0,1,1,1,-1,4,1
KR_6769838685,420,4,3,4,6,4,6,2,0,2,2,4,4,0,0,2,2,-2,1,3,0,2,-281,0,5,5,1,0,1,-1,1,1,-1,3,1
KR_6699367811,420,0,4,24,3,-1,2,3,-3,4,7,-1,1,2,8,8,0,0,0,0,1,2,4,4,5,9,8,0,-1,-1,-1,-1,1,4,1
KR_6776957247,420,2,8,6,4,4,4,0,2,4,2,-5,1,6,-2,2,4,5,5,0,0,8,2,-8,11,3,3,0,0,-1,1,1,-1,6,1
KR_6764446609,420,3,-17,0,8,-2,0,2,1,3,2,11,12,1,-3,3,6,1,2,1,0,3,98,-4,7,3,0,0,3,-1,1,1,1,1,1
KR_6699294996,420,5,99,-19,6,0,1,1,-1,1,2,4,5,1,3,3,0,0,0,0,0,6,12,1,7,8,1,0,1,-1,-1,1,-1,2,1
KR_6752627708,420,2,0,32,4,0,2,2,-1,0,1,5,8,3,-1,2,3,1,1,0,0,3,-11,-3,8,5,7,0,-1,1,-1,-1,-1,1,1
KR_6767132783,420,-3,4,-30,-8,-3,1,4,-1,2,3,-1,2,3,1,2,1,-4,0,4,0,-7,-5,-3,7,4,1,0,0,-1,1,-1,1,1,1
KR_6772648954,420,1,84,29,3,-1,3,4,2,7,5,1,2,1,-3,2,5,4,4,0,0,7,1,-2,7,5,0,0,2,-1,1,1,1,3,1
KR_6765854130,420,2,67,5,5,2,3,1,2,2,0,-2,1,3,4,5,1,-1,0,1,-1,7,-2,-2,7,5,3,0,-1,1,-1,1,-1,3,1
KR_6771162714,440,1,78,18,-1,1,1,0,-2,4,6,0,4,4,0,0,0,0,0,0,-1,-5,5,3,6,9,-5,0,0,-1,-1,0,-1,4,1
KR_6763527941,440,2,-21,-14,10,-5,1,6,2,3,1,1,1,0,2,4,2,10,11,1,0,12,0,-1,7,6,2,0,0,1,-1,1,1,4,1
KR_6763556805,420,4,64,-1,12,2,6,4,6,6,0,2,5,3,3,3,0,-1,0,1,0,13,0,-2,7,5,8,0,1,1,1,1,1,3,1
KR_6774285667,420,0,-21,-15,-2,1,1,0,-1,1,2,3,3,0,-4,0,4,-1,1,2,0,-9,-4,-1,6,5,-3,0,1,-1,1,1,-1,2,1
KR_6699697170,420,2,7,20,0,-5,0,5,-1,3,4,1,7,6,2,4,2,3,4,1,0,6,-1,-4,9,5,0,0,-1,-1,-1,-1,1,2,1
KR_6767576979,420,-2,11,4,-8,0,3,3,1,4,3,1,3,2,-10,1,11,0,1,1,2,-12,11,-2,8,6,-3,0,2,-1,1,1,1,4,1
KR_6746647861,420,4,35,-36,12,-1,4,5,0,1,1,-1,1,2,12,13,1,2,5,3,0,21,10,3,2,5,-7,0,1,1,-1,-1,1,5,1
KR_6749283145,420,3,65,0,13,0,2,2,8,9,1,4,8,4,2,3,1,-1,1,2,0,18,-5,-3,10,7,7,0,0,1,1,1,-1,2,1
KR_6774070442,420,4,30,26,7,2,3,1,-2,0,2,-2,1,3,5,5,0,4,4,0,0,5,5,-1,7,6,5,0,0,-1,1,1,1,5,1
KR_6750240901,420,2,-10,20,16,1,1,0,1,6,5,2,4,2,11,13,2,1,2,1,0,23,14,-4,13,9,-3,0,0,-1,1,-1,1,6,1
KR_6748331496,420,2,69,24,0,0,0,0,0,3,3,-2,1,3,1,3,2,1,1,0,0,-6,-31,0,8,8,10,0,2,1,-1,1,1,3,1
KR_6759998461,440,2,28,4,6,0,1,1,7,7,0,-3,1,4,-1,1,2,3,4,1,0,3,-3,-5,10,5,0,0,0,1,0,1,1,4,1
KR_6774052567,420,2,14,24,4,2,4,2,0,5,5,2,3,1,1,3,2,-1,2,3,1,15,15,2,4,6,1,0,1,1,1,1,1,3,1
KR_6774383761,420,4,37,12,9,6,6,0,1,5,4,3,4,1,2,4,2,-3,0,3,0,3,22,-3,6,3,4,0,0,1,-1,1,1,2,1
KR_6743204136,420,2,37,-24,6,0,2,2,-1,2,3,0,1,1,6,7,1,1,2,1,0,10,-13,-3,10,7,1,0,1,-1,-1,1,1,3,1
KR_6760078793,420,6,5,16,17,3,4,1,4,7,3,6,7,1,4,7,3,0,0,0,0,19,0,-1,8,7,-1,0,2,1,1,1,1,2,1
KR_6766654292,440,5,122,49,15,7,9,2,1,4,3,-5,1,6,7,10,3,5,6,1,3,8,-6,-3,5,2,0,0,3,-1,0,1,1,2,1
KR_6711651315,420,4,13,-7,5,3,5,2,-1,2,3,-1,3,4,2,3,1,2,2,0,0,12,-9,5,7,12,5,0,0,-1,1,0,-1,4,1
KR_6731593126,440,3,2,7,7,-1,1,2,3,5,2,4,4,0,0,3,3,1,2,1,1,13,28,-2,7,5,7,0,0,0,-1,1,1,0,1
KR_6774844142,420,1,88,-5,3,1,3,2,0,1,1,-2,2,4,4,4,0,0,0,0,0,-1,1,-1,7,6,-1,0,2,-1,1,1,-1,6,1
KR_6766727030,420,-1,-10,-24,5,1,3,2,4,6,2,4,6,2,-6,2,8,2,3,1,0,6,22,5,5,10,3,0,-1,-1,-1,-1,1,1,1
KR_6754537002,420,-1,14,-1,-1,-1,3,4,-3,0,3,-1,2,3,6,8,2,-2,0,2,1,-5,9,2,6,8,7,0,0,-1,-1,-1,1,5,1
KR_6776449488,420,0,5,46,-4,0,1,1,-10,1,11,3,6,3,2,8,6,1,2,1,-2,-15,-1,-6,11,5,2,0,0,-1,1,0,-1,1,1
KR_6738220774,420,3,26,-10,3,0,2,2,-5,1,6,5,7,2,2,4,2,1,2,1,0,-2,0,-5,9,4,3,0,0,0,-1,0,1,0,1
KR_6716581815,420,7,155,26,14,0,1,1,7,10,3,3,3,0,3,4,1,1,1,0,0,17,-16,0,5,5,5,0,1,1,-1,1,1,3,1
KR_6703613689,420,2,29,20,3,3,7,4,1,4,3,-1,2,3,-1,4,5,1,1,0,-2,0,-2,-2,6,4,7,0,0,1,-1,1,-1,6,1
KR_6734501528,420,2,-40,44,1,-1,2,3,-1,1,2,4,7,3,0,4,4,-1,0,1,0,5,-9,-8,14,6,2,0,2,1,1,1,1,4,1
KR_6750553108,420,-2,17,-35,1,-2,2,4,0,1,1,4,6,2,2,4,2,-3,0,3,1,9,-115,5,2,7,2,0,-1,0,-1,-1,1,0,1
KR_6777069952,420,-3,-49,-2,-2,-1,0,1,1,3,2,1,1,0,-3,1,4,0,0,0,0,-3,0,-6,8,2,-1,0,0,1,-1,0,-1,6,1
KR_6733515370,420,2,6,17,5,-4,1,5,7,8,1,-2,2,4,2,2,0,2,2,0,-1,10,10,6,6,12,2,0,0,1,-1,1,-1,6,1
KR_6744302736,420,3,10,-3,5,4,5,1,2,9,7,3,7,4,-5,5,10,1,5,4,4,7,5,2,3,5,5,0,0,1,-1,-1,1,1,1
KR_6768092838,420,-3,16,-8,-12,-1,1,2,-7,4,11,-1,1,2,-2,4,6,-1,0,1,0,-13,0,-4,8,4,3,0,0,-1,-1,0,1,1,1
KR_6743787651,420,-1,54,-46,8,0,2,2,0,2,2,0,3,3,7,10,3,1,1,0,-1,11,37,7,2,9,4,0,0,-1,1,1,1,1,1
KR_6773339532,440,0,-6,1,5,1,1,0,-5,0,5,2,4,2,6,6,0,1,3,2,0,2,4,1,5,6,2,0,1,1,0,1,1,1,1
KR_6777542534,420,3,54,-12,1,2,2,0,3,6,3,-3,1,4,-4,0,4,3,3,0,0,-3,2,-1,8,7,0,0,1,-1,-1,1,1,3,1
KR_6737312957,420,2,18,14,1,0,1,1,-5,1,6,2,2,0,2,5,3,2,2,0,0,-1,-9,-2,9,7,8,0,0,-1,1,0,-1,2,1
KR_6769374547,420,5,34,7,14,2,4,2,10,10,0,-3,3,6,7,7,0,-2,1,3,3,22,11,3,4,7,-2,0,3,1,1,1,1,3,1
KR_6743577125,440,6,10,12,14,3,3,0,0,1,1,-1,2,3,0,1,1,12,12,0,0,19,25,-1,4,3,-3,0,1,1,-1,1,1,4,1
KR_6742334216,420,0,-26,12,5,-2,1,3,4,4,0,0,1,1,4,4,0,-1,0,1,1,10,11,0,7,7,5,0,0,1,-1,0,1,1,1
KR_6736986853,420,8,67,69,6,6,6,0,3,4,1,-1,1,2,-1,0,1,-1,0,1,0,5,-5,-1,5,4,-4,0,3,1,1,1,1,6,1
KR_6769523359,420,2,27,-36,1,-2,2,4,0,5,5,3,5,2,4,7,3,-4,1,5,1,-7,-3,-3,8,5,1,0,1,-1,-1,-1,1,5,1
KR_6773077010,420,4,49,24,8,3,5,2,0,3,3,1,2,1,3,3,0,1,2,1,1,13,5,0,4,4,3,0,0,1,1,1,1,5,1
KR_6771177148,420,-1,38,13,-6,0,2,2,-1,2,3,-5,1,6,0,3,3,0,1,1,-1,-11,-72,-1,9,8,4,0,0,-1,-1,0,-1,4,1
KR_6702852021,420,1,38,27,4,-2,2,4,1,2,1,-3,0,3,3,7,4,5,5,0,0,0,-12,1,3,4,5,0,1,1,1,1,1,6,1
KR_6720893020,420,1,-23,-25,3,1,4,3,2,3,1,0,1,1,0,2,2,0,1,1,1,6,7,2,8,10,0,0,1,0,1,1,1,0,1
KR_6776835609,420,7,46,37,24,2,4,2,8,8,0,4,4,0,4,4,0,6,7,1,2,30,69,4,5,9,1,0,1,1,1,1,1,4,1
KR_6768886210,420,-2,-71,10,-6,-4,1,5,3,5,2,-5,0,5,-2,5,7,2,2,0,-3,5,-18,-1,9,8,2,0,-1,-1,1,-1,1,2,1
KR_6771350094,420,3,32,5,13,2,2,0,0,3,3,7,7,0,1,3,2,3,4,1,0,21,30,-1,4,3,0,0,0,1,-1,1,1,4,1
KR_6767985422,420,1,11,6,6,1,4,3,1,2,1,2,2,0,2,2,0,0,0,0,0,10,-6,0,3,3,1,0,0,1,1,0,-1,5,1
KR_6726807757,420,0,50,0,5,1,1,0,0,2,2,-1,3,4,6,8,2,-1,1,2,0,3,-12,1,7,8,1,0,0,-1,-1,-1,1,4,1
KR_6766550689,420,4,77,20,10,1,2,1,0,5,5,1,3,2,7,8,1,1,1,0,1,22,-17,-8,14,6,7,0,2,1,-1,1,1,5,1
KR_6765870489,420,-1,-13,5,3,0,3,3,4,5,1,-1,0,1,-1,4,5,1,1,0,0,0,14,4,2,6,4,0,0,-1,1,0,1,5,1
KR_6713290886,440,6,47,7,14,3,4,1,2,2,0,0,1,1,6,7,1,3,4,1,0,11,45,-3,5,2,5,0,2,1,1,1,1,6,1
KR_6712142019,420,-4,-55,-7,-6,2,4,2,-3,4,7,-2,1,3,-5,2,7,2,2,0,0,-3,3,-1,9,8,-1,0,-1,1,1,-1,1,6,1
KR_6690546157,420,2,55,10,10,5,5,0,7,8,1,1,2,1,-4,2,6,1,2,1,-1,6,5,4,3,7,-1,0,1,-1,1,1,-1,2,1
KR_6711108914,440,0,25,13,6,-3,1,4,2,5,3,6,7,1,0,2,2,1,2,1,0,10,3,3,6,9,-3,0,1,1,1,1,1,3,1
KR_6776625564,420,1,12,12,5,1,2,1,3,5,2,-1,2,3,4,6,2,-2,0,2,0,7,4,-2,11,9,-3,0,0,-1,1,1,1,5,1
KR_6776089367,420,1,38,15,-4,1,2,1,0,2,2,1,2,1,-7,0,7,1,2,1,0,-9,25,3,4,7,-10,0,0,-1,1,1,-1,2,1
KR_6775763259,420,0,40,-12,7,0,2,2,2,3,1,4,6,2,1,1,0,0,2,2,0,5,-11,-4,10,6,8,0,0,-1,-1,0,1,3,1
KR_6687928726,420,0,68,-24,-1,1,2,1,-3,1,4,3,4,1,-1,1,2,-1,0,1,0,5,0,-3,8,5,3,0,-1,-1,-1,-1,1,4,1
KR_6736669235,420,5,22,16,9,2,2,0,3,6,3,5,6,1,-1,1,2,0,1,1,0,11,-4,4,5,9,3,0,0,1,-1,1,-1,1,1
KR_6762394484,420,8,103,56,12,3,3,0,6,8,2,7,9,2,-4,0,4,0,1,1,0,5,8,6,2,8,-1,0,3,1,1,1,1,3,1
KR_6766737829,420,-1,58,-19,-3,2,3,1,-5,0,5,-3,3,6,3,3,0,0,1,1,0,-1,-8,0,7,7,-4,0,0,1,-1,0,1,6,1
KR_6775936906,420,0,-36,-10,2,-2,0,2,0,3,3,6,8,2,0,1,1,-2,0,2,0,7,-27,3,4,7,6,0,0,1,-1,-1,-1,2,1
KR_6766531098,420,-2,-31,-10,-5,1,2,1,0,2,2,-2,3,5,-3,0,3,-1,0,1,0,-3,-1,-2,6,4,-3,0,0,-1,-1,0,-1,4,1
KR_6775755026,420,5,40,16,9,2,3,1,4,7,3,1,6,5,0,0,0,2,2,0,0,12,-7,-1,5,4,8,0,1,1,1,1,-1,1,1
KR_6739868805,420,2,40,28,2,-3,0,3,4,8,4,0,3,3,0,1,1,1,2,1,0,2,-2,-2,9,7,2,0,0,1,-1,-1,-1,2,1
KR_6776978211,420,1,1,56,2,1,3,2,-2,2,4,3,5,2,-3,1,4,3,3,0,1,3,34,-5,7,2,-1,0,1,0,1,1,-1,0,1
KR_6710201010,420,9,38,45,12,-1,1,2,0,6,6,7,7,0,6,6,0,0,1,1,0,8,30,3,5,8,3,0,3,1,1,1,1,4,1
KR_6727697866,420,2,57,16,2,1,1,0,-3,0,3,0,2,2,4,4,0,0,2,2,0,0,-34,-1,10,9,1,0,-1,1,-1,-1,1,6,1
KR_6679261129,420,3,2,-8,9,3,5,2,3,4,1,-1,0,1,2,2,0,2,2,0,0,13,9,5,3,8,3,0,1,1,1,1,1,6,1
KR_6766777762,420,4,-33,16,13,2,3,1,1,3,2,2,2,0,10,10,0,-2,2,4,1,21,8,6,6,12,-5,0,-2,1,-1,-1,1,1,1
KR_6775403456,420,4,29,38,16,2,3,1,7,8,1,1,2,1,4,4,0,2,2,0,0,25,30,0,6,6,5,0,0,1,1,1,1,6,1
KR_6775384748,420,1,20,-4,2,4,6,2,0,3,3,-2,1,3,1,3,2,-1,3,4,0,-1,-6,2,4,6,2,0,-1,-1,-1,-1,1,4,1
KR_6777807700,420,2,41,24,10,-1,0,1,2,5,3,8,9,1,0,2,2,1,2,1,0,9,5,4,6,10,3,0,2,1,1,1,1,6,1
KR_6775393588,420,-1,-34,28,-3,-2,1,3,0,1,1,-1,3,4,1,1,0,-1,0,1,0,-16,32,3,5,8,-9,0,2,-1,1,1,1,6,1
KR_6769673104,420,-1,109,19,-1,2,2,0,0,1,1,3,3,0,-6,0,6,0,0,0,0,-10,-2,-2,6,4,1,0,1,1,1,1,-1,3,1
KR_6765999438,420,0,33,-36,13,2,3,1,0,3,3,8,10,2,3,4,1,0,0,0,0,12,-2,1,4,5,5,0,0,1,-1,-1,1,5,1
KR_6715297481,420,-3,-103,17,-6,-5,0,5,-1,6,7,1,3,2,-1,3,4,0,2,2,-3,-8,38,1,3,4,-1,0,-3,1,-1,-1,-1,1,1
KR_6716356366,420,1,1,1,-4,-6,0,6,0,1,1,2,4,2,0,1,1,0,0,0,-1,-2,-7,-5,11,6,4,0,0,1,-1,1,-1,1,1
KR_6772349225,420,3,-10,-8,12,3,3,0,-2,4,6,3,4,1,7,7,0,1,1,0,0,11,13,-3,6,3,1,0,0,1,1,1,1,5,1
KR_6776209591,420,8,84,49,8,-1,0,1,-1,2,3,5,6,1,3,6,3,2,2,0,-1,13,-5,-1,5,4,4,0,2,1,-1,1,-1,6,1
KR_6777596582,420,1,52,-30,4,1,1,0,2,6,4,-5,1,6,1,2,1,5,5,0,0,0,-17,2,4,6,-2,0,2,-1,0,1,1,4,1
KR_6764918948,420,2,52,0,9,4,4,0,2,4,2,2,5,3,0,1,1,1,1,0,0,9,6,3,3,6,1,0,-1,1,1,-1,-1,5,1
KR_6775857421,420,-2,23,5,-8,3,3,0,-3,1,4,-3,4,7,2,5,3,-7,1,8,0,-16,-53,-5,11,6,33,0,1,-1,1,1,-1,4,1
KR_6722341045,420,1,41,-20,4,5,5,0,-4,1,5,-1,1,2,4,5,1,0,0,0,0,-5,204,1,7,8,-7,0,0,-1,-1,1,1,6,1
KR_6777054055,420,11,160,27,15,3,3,0,1,3,2,3,4,1,5,5,0,3,3,0,4,28,56,2,2,4,-2,1,5,0,1,1,1,0,1
KR_6744101022,440,5,35,20,0,3,3,0,1,9,8,-1,1,2,-2,3,5,-1,1,2,0,-3,10,-1,5,4,0,0,0,1,1,1,-1,5,1
KR_6777899158,420,4,73,11,9,-3,2,5,4,5,1,1,2,1,6,7,1,1,6,5,-1,2,2,4,3,7,-3,0,0,-1,-1,1,-1,5,1
KR_6760619557,420,6,53,16,16,2,3,1,7,8,1,3,5,2,2,6,4,2,3,1,0,28,-43,4,6,10,17,0,0,1,1,1,1,4,1
KR_6710566587,420,-2,-3,-41,8,-3,2,5,6,8,2,-3,1,4,7,7,0,1,2,1,1,7,36,6,1,7,-8,0,0,-1,1,1,-1,6,1
KR_6767668425,420,-2,14,-15,3,2,2,0,0,4,4,0,2,2,1,3,2,0,1,1,0,-1,-32,-2,7,5,1,0,1,-1,1,1,1,4,1
KR_6715107934,420,5,111,30,18,12,12,0,2,4,2,5,6,1,-1,3,4,0,2,2,0,11,-33,4,2,6,0,0,2,1,1,1,1,4,1
KR_6768458735,420,-2,-59,12,-1,-2,2,4,5,7,2,-1,2,3,-2,0,2,-1,0,1,0,-7,-1,3,5,8,4,0,-1,-1,1,-1,-1,6,1
KR_6776428127,420,-1,-5,-15,-7,-4,1,5,-1,2,3,2,4,2,1,7,6,-5,1,6,0,-5,-8,-4,7,3,2,0,-2,1,-1,-1,-1,3,1
KR_6744712129,420,2,28,27,-1,-1,1,2,-2,1,3,-1,2,3,3,5,2,0,0,0,0,-3,-1,-2,8,6,-2,0,0,-1,-1,0,-1,1,1
KR_6736558422,420,4,73,25,7,2,3,1,1,5,4,1,1,0,2,4,2,1,3,2,0,3,-343,2,6,8,-3,0,1,1,-1,1,1,1,1
KR_6754500699,420,3,40,56,10,-4,0,4,4,6,2,4,4,0,6,7,1,0,2,2,0,7,6,7,3,10,-2,0,0,1,-1,-1,1,6,1
KR_6667907576,420,0,-17,14,-2,-1,2,3,6,6,0,-4,0,4,-1,0,1,-2,0,2,0,-4,3,2,5,7,-6,0,-1,-1,1,1,1,3,1
KR_6743608726,420,3,50,21,9,0,1,1,1,2,1,0,2,2,8,8,0,0,1,1,0,15,-29,0,5,5,-2,0,3,1,1,1,-1,5,1
KR_6769187531,420,0,40,-20,5,2,4,2,2,4,2,-1,1,2,3,3,0,-1,0,1,0,7,-31,-1,6,5,3,0,0,1,-1,1,1,6,1
KR_6763735159,420,2,18,-8,3,2,2,0,-1,3,4,2,3,1,-1,4,5,1,2,1,0,13,8,2,3,5,-3,0,1,1,-1,1,-1,4,1
KR_6777850134,420,2,22,11,9,0,0,0,0,2,2,4,4,0,3,4,1,2,2,0,0,13,1,0,5,5,0,0,2,-1,1,1,1,5,1
KR_6770420845,420,2,21,-4,2,-3,0,3,5,8,3,1,1,0,0,2,2,-1,2,3,1,-3,79,7,5,12,-28,0,1,0,1,1,1,0,1
KR_6770640758,420,5,52,-14,11,1,2,1,0,4,4,3,3,0,3,4,1,4,4,0,0,5,46,-2,6,4,-1,0,1,1,-1,1,-1,5,1
KR_6776445661,420,3,85,-16,11,8,9,1,1,5,4,1,1,0,0,7,7,1,1,0,3,15,-4,-6,11,5,4,0,1,1,-1,1,1,1,1
KR_6711178435,420,3,25,-1,11,1,4,3,-1,2,3,3,3,0,6,6,0,2,3,1,0,17,28,5,5,10,-2,0,2,-1,-1,1,1,6,1
KR_6731780366,420,2,41,-13,10,5,6,1,2,5,3,1,1,0,2,6,4,0,1,1,1,16,-45,4,4,8,18,0,0,1,1,-1,1,4,1
KR_6776854440,420,2,-5,8,12,0,3,3,5,6,1,2,2,0,6,6,0,-1,1,2,0,17,-49,7,1,8,27,0,0,1,1,-1,1,1,1
KR_6772650462,420,3,61,-23,6,5,5,0,1,5,4,2,4,2,0,2,2,-2,0,2,0,5,1,3,5,8,6,0,1,-1,1,1,1,5,1
KR_6775231632,420,2,63,13,4,1,2,1,-1,5,6,0,1,1,5,9,4,-1,0,1,0,6,45,4,8,12,-4,0,1,1,1,1,-1,5,1
KR_6766451774,420,0,-24,25,1,-2,2,4,0,4,4,2,3,1,3,4,1,-2,0,2,0,-1,5,5,6,11,-2,0,0,1,1,-1,1,1,1
KR_6716557595,420,5,24,4,10,2,2,0,9,9,0,-2,0,2,2,2,0,-1,0,1,0,9,-16,4,5,9,3,0,2,-1,1,1,1,4,1
KR_6740694468,420,-2,5,11,-3,-2,1,3,-1,4,5,1,3,2,1,2,1,-2,0,2,0,-9,-39,2,3,5,5,0,1,1,1,1,-1,2,1
KR_6775898284,420,4,75,-13,15,4,4,0,0,4,4,-1,3,4,5,9,4,7,8,1,0,1,-192,2,4,6,4,0,0,1,1,1,-1,6,1
KR_6746319476,420,-1,8,5,-7,-3,0,3,-8,2,10,1,3,2,4,8,4,-1,0,1,0,-7,3,0,6,6,-3,0,1,1,-1,1,-1,3,1
KR_6725582015,420,-2,-32,-49,3,1,2,1,-1,2,3,2,4,2,-1,0,1,2,4,2,-1,7,0,-1,5,4,1,0,-2,1,1,-1,-1,3,1
KR_6776081672,420,5,95,48,11,0,3,3,1,3,2,2,6,4,5,7,2,3,4,1,1,14,2,-2,9,7,5,0,0,1,-1,1,1,6,1
KR_6749797728,420,2,-19,3,0,0,2,2,-2,3,5,2,6,4,0,1,1,0,0,0,1,2,-21,3,6,9,1,0,0,-1,1,1,1,4,1
KR_6772563986,420,-1,20,-6,5,0,0,0,0,3,3,1,5,4,8,8,0,-4,0,4,0,5,-3,-1,7,6,5,0,2,-1,1,1,1,1,1
KR_6774186076,420,7,45,25,18,2,4,2,7,7,0,6,7,1,4,4,0,-1,0,1,0,21,-6,1,2,3,5,0,1,1,1,1,1,6,1
KR_6742565802,420,3,73,-17,6,3,4,1,2,5,3,2,3,1,-1,2,3,0,0,0,0,2,20,7,4,11,-4,0,3,1,1,1,1,3,1
KR_6775291326,420,2,15,-33,11,-3,0,3,3,3,0,2,4,2,8,9,1,1,2,1,0,11,7,2,7,9,-2,0,2,1,1,1,-1,6,1
KR_6762161190,420,1,-33,7,0,-4,3,7,0,2,2,-1,1,2,2,3,1,3,3,0,0,0,21,4,5,9,-3,0,0,1,-1,0,-1,4,1
KR_6776431868,420,1,30,-12,5,4,4,0,0,3,3,1,3,2,1,3,2,-1,0,1,0,7,5,1,6,7,-3,0,0,-1,1,0,1,3,1
KR_6777849955,420,2,53,8,6,1,2,1,2,2,0,-1,0,1,4,5,1,0,0,0,0,4,-4,4,7,11,0,0,0,1,1,1,1,3,1
KR_6774639517,420,9,158,76,17,0,1,1,3,3,0,6,8,2,7,8,1,1,2,1,0,16,8,1,7,8,5,0,1,1,-1,1,1,1,1
KR_6776238005,420,-2,-22,1,-2,-8,1,9,0,3,3,4,5,1,4,4,0,-2,0,2,0,8,3,1,7,8,-5,0,-2,1,-1,-1,-1,3,1
KR_6750783707,420,4,62,21,6,1,1,0,-3,3,6,2,2,0,5,6,1,1,2,1,1,8,-10,-5,10,5,2,0,1,1,-1,1,1,6,1
KR_6765776440,420,-1,-62,-9,0,0,3,3,-4,1,5,1,2,1,0,2,2,3,3,0,-1,1,4,1,6,7,1,0,0,1,1,1,-1,3,1
KR_6775721139,420,4,92,16,8,3,3,0,5,8,3,-2,0,2,2,4,2,0,2,2,0,15,2,2,4,6,7,0,2,-1,1,1,1,6,1
KR_6737292976,420,-1,80,-25,0,1,2,1,-3,1,4,1,1,0,2,2,0,-1,2,3,0,1,-10,1,5,6,4,0,-2,-1,-1,-1,-1,1,1
KR_6762182264,420,0,17,12,-1,0,0,0,0,2,2,-1,3,4,0,5,5,0,1,1,0,-5,2,2,5,7,-1,0,0,-1,1,0,-1,2,1
KR_6699446782,420,-1,-1,-24,3,2,2,0,0,2,2,-3,0,3,3,4,1,1,2,1,0,7,-25,2,4,6,-1,0,1,1,-1,1,1,1,1
KR_6763747101,420,5,20,8,15,-2,0,2,3,7,4,6,8,2,8,8,0,0,0,0,0,28,-36,1,6,7,15,0,1,1,-1,1,-1,2,1
KR_6770462007,420,2,29,-7,0,0,0,0,-3,1,4,1,3,2,1,3,2,1,2,1,0,-4,-12,2,4,6,2,0,2,0,-1,1,1,0,1
KR_6760227131,420,0,13,4,9,0,3,3,2,7,5,-2,3,5,7,7,0,2,2,0,0,17,5,4,1,5,2,0,2,1,1,1,-1,5,1
KR_6777860936,420,5,117,3,15,9,10,1,0,3,3,1,5,4,4,7,3,1,2,1,1,16,8,3,5,8,0,0,3,1,1,1,1,1,1
KR_6740650716,420,1,-22,14,5,5,6,1,1,4,3,0,0,0,-1,2,3,0,1,1,0,-3,5,4,3,7,-4,0,-1,1,-1,-1,1,1,1
KR_6701595207,420,2,3,-12,9,4,4,0,0,1,1,-2,1,3,3,6,3,4,5,1,0,14,4,1,9,10,3,0,1,-1,1,1,1,4,1
KR_6685723204,420,2,-16,8,13,0,0,0,4,5,1,3,4,1,5,7,2,1,2,1,0,20,6,0,8,8,-1,0,2,1,-1,1,-1,4,1
KR_6757550831,420,3,10,7,10,4,6,2,1,3,2,4,5,1,1,5,4,0,1,1,0,0,-4,2,5,7,7,0,2,-1,1,1,1,4,1
KR_6777110292,420,0,51,-32,1,2,3,1,6,10,4,2,3,1,-6,5,11,-3,0,3,2,-5,14,-4,10,6,5,0,1,-1,1,1,1,1,1
KR_6739942610,440,4,44,29,5,1,2,1,-1,3,4,2,2,0,1,4,3,2,5,3,0,1,1,1,6,7,4,0,1,1,1,1,1,1,1
KR_6777884851,420,2,48,12,3,1,2,1,0,1,1,0,3,3,0,3,3,2,2,0,0,3,6,4,6,10,0,0,0,1,1,1,1,5,1
KR_6756403305,420,0,5,-24,7,3,4,1,-3,2,5,4,5,1,2,6,4,1,1,0,0,5,-3,1,6,7,-2,0,0,0,-1,0,1,0,1
KR_6770669492,420,-3,-64,24,0,-2,0,2,-1,3,4,6,6,0,-3,2,5,0,1,1,0,-1,0,1,5,6,1,0,-1,1,1,-1,1,6,1
KR_6744131822,440,4,90,13,7,-6,0,6,-1,3,4,0,3,3,7,9,2,7,7,0,0,9,7,0,5,5,1,0,2,-1,1,1,1,4,1
KR_6743474681,440,7,143,23,15,2,5,3,4,5,1,4,5,1,5,5,0,0,2,2,0,9,10,3,3,6,2,0,2,1,1,1,1,1,1
KR_6765463587,420,1,64,8,2,1,1,0,3,5,2,0,1,1,-1,1,2,-1,0,1,0,-1,75,1,7,8,-37,0,2,1,1,1,-1,1,1
KR_6701216273,420,1,-25,6,-3,-3,3,6,-6,0,6,5,6,1,1,2,1,0,2,2,0,-6,-9,0,8,8,-1,0,-1,-1,-1,-1,-1,4,1
KR_6776491672,420,-2,-26,-2,-1,1,2,1,-1,2,3,2,3,1,0,6,6,-3,0,3,0,1,-8,-7,10,3,6,0,1,-1,-1,1,1,3,1
KR_6715940501,420,1,0,-14,13,3,4,1,4,4,0,1,3,2,5,6,1,0,0,0,0,21,-3,0,4,4,6,0,2,1,1,1,1,1,1
KR_6749081588,420,1,-6,41,1,-3,1,4,-5,4,9,8,9,1,0,2,2,1,2,1,0,-3,-6,-3,7,4,-2,0,-1,1,-1,-1,-1,4,1
KR_6765757382,420,1,-3,38,5,2,2,0,0,1,1,3,3,0,0,0,0,0,0,0,0,2,107,1,2,3,0,0,0,1,1,0,1,3,1
KR_6746700927,420,-1,-69,23,1,0,3,3,1,1,0,2,4,2,-1,0,1,-1,2,3,-1,3,40,4,5,9,0,0,0,-1,1,0,-1,1,1
KR_6736242097,420,4,46,12,7,1,2,1,0,2,2,5,6,1,3,5,2,-2,0,2,0,11,17,-1,6,5,-2,0,0,1,1,1,1,2,1
KR_6715032000,420,4,68,57,11,1,1,0,0,2,2,4,5,1,5,8,3,1,1,0,0,13,1,1,5,6,2,0,-1,1,-1,1,1,2,1
KR_6777588175,420,-2,45,-32,-5,4,4,0,-1,2,3,1,1,0,-9,3,12,0,0,0,0,-15,-22,0,7,7,8,0,1,1,1,1,1,1,1
KR_6763229906,420,8,45,-4,23,-1,1,2,8,8,0,4,5,1,8,9,1,4,4,0,0,26,129,-1,7,6,-1,0,1,1,-1,1,1,5,1
KR_6733160670,420,0,-55,7,5,-4,1,5,2,3,1,5,5,0,-1,7,8,3,3,0,0,10,-24,2,3,5,2,0,1,1,1,1,1,6,1
KR_6700989662,420,1,-10,8,2,-3,0,3,0,3,3,-1,2,3,1,3,2,5,5,0,0,12,17,-1,8,7,-2,0,2,-1,-1,1,-1,1,1
KR_6758102083,440,2,58,13,6,4,4,0,0,1,1,-1,1,2,0,5,5,3,3,0,0,10,18,1,8,9,0,0,1,-1,1,1,1,2,1
KR_6775079451,420,5,30,37,10,4,4,0,0,1,1,-2,2,4,9,11,2,-1,1,2,1,5,12,0,7,7,3,0,1,-1,1,1,1,6,1
KR_6750320320,420,-2,26,-1,-6,-2,1,3,0,3,3,-1,3,4,-4,2,6,1,1,0,0,-3,23,-4,9,5,4,0,-1,-1,-1,1,1,2,1
KR_6742825395,420,3,48,-12,1,2,4,2,-1,1,2,-2,1,3,-1,2,3,3,3,0,1,0,-5,3,6,9,1,0,1,1,1,1,1,6,1
KR_6774454967,420,2,62,-27,7,1,2,1,1,5,4,-2,3,5,6,9,3,1,2,1,0,18,11,-1,9,8,0,0,3,-1,1,1,-1,3,1
KR_6770421489,420,-1,-1,0,0,1,2,1,2,3,1,2,2,0,-6,0,6,1,1,0,0,-5,18,1,5,6,1,0,1,-1,1,1,-1,3,1
KR_6700868884,420,0,25,0,3,-1,0,1,1,3,2,0,3,3,2,3,1,1,2,1,0,6,-1,2,8,10,5,0,0,1,-1,0,1,2,1
KR_6763224965,420,1,23,-8,4,1,3,2,-3,2,5,6,7,1,0,4,4,0,1,1,0,4,-5,0,7,7,1,0,-1,-1,1,1,-1,2,1
KR_6762876919,440,0,-49,-5,-7,-3,0,3,1,2,1,-3,0,3,-1,1,2,-1,2,3,0,-3,9,0,6,6,1,0,1,-1,1,1,-1,2,1
KR_6775539836,420,1,-5,19,7,-1,0,1,4,6,2,2,2,0,2,2,0,0,0,0,0,10,-4,-1,7,6,-1,0,-2,-1,-1,-1,1,2,1
KR_6710759668,420,3,11,16,10,0,1,1,9,10,1,-2,1,3,3,3,0,0,1,1,0,16,9,1,8,9,-9,0,2,1,-1,1,-1,2,1
KR_6776816496,420,1,-3,16,7,4,7,3,2,2,0,1,1,0,0,4,4,0,0,0,0,0,-7,-3,5,2,0,0,0,1,1,0,1,4,1
KR_6773877183,420,2,80,-15,2,1,2,1,0,3,3,-6,0,6,6,7,1,1,1,0,1,3,2,3,6,9,4,0,-1,1,-1,-1,1,5,1
KR_6752446407,440,5,49,5,15,2,5,3,9,10,1,-1,2,3,4,7,3,1,4,3,2,22,13,5,3,8,-2,0,2,-1,1,1,-1,3,1
KR_6765750724,420,4,28,8,12,1,2,1,8,10,2,-3,2,5,7,7,0,-1,0,1,0,6,404,-4,6,2,-2,0,3,-1,1,1,1,3,1
KR_6774129269,420,0,7,2,-1,-1,2,3,0,3,3,0,3,3,-1,4,5,1,1,0,2,1,155,-1,8,7,6,0,0,-1,-1,-1,1,5,1
KR_6756182306,420,0,-32,18,2,-4,1,5,2,2,0,1,1,0,2,3,1,1,1,0,0,16,55,-3,7,4,-1,0,0,-1,1,-1,1,1,1
KR_6689572242,420,2,-4,-2,2,-2,1,3,3,4,1,1,3,2,1,4,3,-1,0,1,-2,3,-2,1,7,8,-3,0,1,1,-1,1,-1,1,1
KR_6777009445,420,5,64,-7,8,1,2,1,-1,2,3,1,2,1,2,3,1,5,6,1,0,8,3,3,5,8,1,0,4,1,-1,1,1,6,1
KR_6709158225,420,-1,-3,24,4,0,1,1,2,5,3,1,2,1,2,6,4,-1,1,2,0,7,-3,3,5,8,3,0,1,1,1,1,1,1,1
KR_6766242213,440,3,-55,35,12,-1,3,4,4,4,0,4,6,2,3,3,0,2,2,0,0,24,70,-3,5,2,-24,0,0,-1,1,-1,1,1,1
KR_6774717596,420,4,12,-18,13,0,1,1,4,5,1,8,9,1,1,2,1,0,1,1,0,12,4,-3,7,4,2,0,1,1,1,1,1,2,1
KR_6775960849,420,5,46,60,5,-1,1,2,6,7,1,4,4,0,-1,1,2,-3,0,3,0,4,-8,5,2,7,-3,0,1,1,0,1,1,1,1
KR_6771837171,420,2,-31,20,5,-1,0,1,3,9,6,1,2,1,3,5,2,-1,0,1,1,5,33,-1,6,5,-3,0,0,1,-1,0,1,6,1
KR_6725004901,420,2,-24,13,7,1,2,1,5,6,1,3,5,2,-2,5,7,0,0,0,0,11,6,0,5,5,-2,0,0,1,1,1,1,1,1
KR_6774619047,420,3,14,22,6,2,3,1,1,6,5,0,4,4,1,3,2,2,2,0,-2,11,41,-2,9,7,1,0,3,1,1,1,-1,3,1
KR_6767971493,420,1,17,13,-1,0,1,1,1,5,4,-4,0,4,4,5,1,-2,0,2,0,-2,5,4,4,8,-1,0,0,1,-1,0,-1,2,1
KR_6775823099,420,0,68,-33,11,4,5,1,2,4,2,3,5,2,2,5,3,0,0,0,0,11,199,-2,6,4,3,0,1,-1,1,1,-1,1,1
KR_6765229669,420,2,22,17,0,6,7,1,-2,2,4,3,3,0,-5,0,5,-2,1,3,-2,-3,3,-2,10,8,6,0,2,1,1,1,-1,6,1
KR_6743698379,420,9,106,32,17,4,4,0,2,3,1,7,8,1,5,5,0,-1,0,1,1,18,31,2,3,5,5,0,4,0,1,1,1,0,1
KR_6772716097,420,1,47,-26,4,1,1,0,2,5,3,1,2,1,-4,0,4,4,5,1,0,5,-42,6,6,12,27,0,2,1,1,1,-1,2,1
KR_6744167747,420,9,160,11,12,4,5,1,5,6,1,1,2,1,2,2,0,0,1,1,0,10,55,1,5,6,5,0,4,1,1,1,1,5,1
KR_6776964691,420,0,-27,8,4,0,3,3,4,5,1,-1,2,3,-1,3,4,2,2,0,0,5,-1,0,7,7,-4,0,-1,0,1,-1,-1,0,1
KR_6775731245,420,3,30,14,11,1,1,0,5,6,1,3,4,1,3,3,0,-1,0,1,0,15,19,2,2,4,-2,0,1,-1,1,1,1,6,1
KR_6758969722,420,3,80,25,13,6,6,0,0,1,1,3,4,1,2,4,2,2,2,0,0,13,2,6,1,7,3,0,2,1,-1,1,1,4,1
KR_6771012427,420,1,15,34,9,2,3,1,4,6,2,3,4,1,0,3,3,0,4,4,0,7,-35,-4,7,3,6,0,0,1,-1,-1,1,3,1
KR_6723676816,420,-1,-7,-11,5,-2,0,2,0,4,4,1,4,3,5,7,2,1,1,0,0,6,-24,-3,6,3,-3,0,-2,1,-1,-1,-1,6,1
KR_6776314152,420,0,36,-32,-2,-4,0,4,-4,4,8,-1,2,3,7,9,2,0,0,0,-1,12,13,7,0,7,-2,0,0,1,-1,-1,1,1,1
KR_6758349728,420,-1,-12,-15,-3,4,5,1,-2,1,3,-5,2,7,0,1,1,0,2,2,0,-4,-103,-1,4,3,-2,0,0,1,1,0,-1,2,1
KR_6769841794,420,9,163,5,14,6,6,0,4,5,1,0,1,1,3,3,0,1,1,0,1,21,12,1,4,5,2,1,6,1,1,1,1,4,1
KR_6762948839,440,-2,49,-16,-6,-3,2,5,0,2,2,3,3,0,-5,1,6,-1,2,3,0,-13,2,3,6,9,3,0,0,1,-1,0,-1,1,1
KR_6723413750,420,1,-17,16,12,1,3,2,2,4,2,0,1,1,2,3,1,7,8,1,0,19,20,-2,7,5,6,0,1,-1,1,1,1,1,1
KR_6766186357,420,1,79,12,-2,2,2,0,-1,1,2,-1,0,1,0,7,7,-2,1,3,0,-14,0,2,4,6,-2,0,0,1,-1,-1,1,3,1
KR_6738550427,440,3,9,-15,10,2,3,1,-1,1,2,0,1,1,6,7,1,3,3,0,0,6,343,0,4,4,-1,0,1,1,-1,1,1,1,1
KR_6775475894,420,-3,-9,-22,-2,-3,0,3,-5,1,6,-3,1,4,5,6,1,4,5,1,0,0,2,2,4,6,-7,0,0,-1,-1,0,-1,4,1
KR_6736311692,420,4,31,12,4,-1,0,1,1,4,3,5,5,0,-2,5,7,1,1,0,0,2,313,-2,9,7,-2,0,1,-1,1,1,1,6,1
KR_6776289400,420,4,42,-4,11,0,0,0,2,3,1,6,7,1,4,7,3,-1,0,1,0,14,-8,6,5,11,4,0,2,1,1,1,1,6,1
KR_6739960538,420,3,49,52,-1,1,1,0,-2,1,3,0,1,1,-1,0,1,1,1,0,0,-5,29,2,5,7,-10,0,0,-1,-1,0,1,4,1
KR_6712504610,420,6,35,7,19,5,5,0,7,9,2,5,5,0,2,3,1,0,0,0,0,13,-32,5,5,10,3,0,1,1,1,1,1,5,1
KR_6773019672,420,2,23,8,3,-4,0,4,2,4,2,0,1,1,5,6,1,0,1,1,0,4,0,2,6,8,-1,0,1,1,-1,1,1,1,1
KR_6767875404,440,1,10,4,4,-1,0,1,3,5,2,2,5,3,-4,2,6,4,4,0,0,3,-11,-3,6,3,6,0,0,1,1,0,1,3,1
KR_6777110207,420,-1,33,-20,1,1,3,2,0,2,2,0,1,1,2,5,3,-2,0,2,2,-2,-196,-1,7,6,-5,0,1,1,1,1,1,1,1
KR_6687344603,420,-5,-63,-26,-4,2,4,2,-2,2,4,-3,0,3,-1,2,3,0,4,4,0,-6,46,4,6,10,-4,0,-1,-1,-1,-1,-1,5,1
KR_6731062380,420,0,-47,24,0,1,1,0,-2,4,6,1,3,2,2,4,2,-2,0,2,0,-2,4,-2,6,4,-2,0,0,-1,1,0,-1,4,1
KR_6710377002,420,2,-12,3,8,-4,0,4,1,6,5,6,6,0,2,3,1,3,3,0,-2,8,-118,4,3,7,4,0,1,1,1,1,-1,6,1
KR_6748399326,420,0,23,32,-2,2,2,0,-6,1,7,4,5,1,0,0,0,-2,1,3,0,-4,3,-3,10,7,-3,0,0,-1,-1,1,-1,4,1
KR_6721724435,420,-1,54,-13,-2,-4,1,5,0,3,3,2,3,1,1,1,0,-1,1,2,0,2,0,1,5,6,1,0,0,1,-1,0,1,4,1
KR_6771207397,420,3,33,16,5,-1,0,1,1,1,0,2,3,1,2,3,1,1,2,1,0,8,12,-2,6,4,5,0,0,0,-1,0,-1,0,1
KR_6775528832,420,2,-13,23,6,1,2,1,4,4,0,2,2,0,0,0,0,-1,0,1,0,13,39,2,9,11,3,0,0,-1,1,0,-1,2,1
KR_6772612766,420,3,36,-6,9,-4,0,4,4,4,0,2,3,1,4,5,1,3,3,0,0,17,3,-1,8,7,1,0,-1,1,-1,-1,1,1,1
KR_6706570062,420,4,38,-17,11,2,3,1,-1,2,3,3,4,1,5,6,1,2,2,0,0,10,8,-4,6,2,-6,0,2,1,-1,1,-1,5,1
KR_6735530112,420,4,-13,12,12,5,5,0,5,7,2,-3,1,4,1,4,3,4,5,1,4,13,-5,-2,7,5,-1,0,2,0,1,1,1,0,1
KR_6775153758,420,0,-5,6,5,0,1,1,-1,1,2,6,6,0,4,4,0,-4,4,8,0,14,11,1,8,9,4,0,-1,1,-1,-1,1,5,1
KR_6770015508,420,0,1,-2,2,2,3,1,1,1,0,0,4,4,2,2,0,-3,0,3,0,9,3,0,6,6,-1,0,-1,1,-1,-1,1,6,1
KR_6774092340,420,1,37,8,3,-2,1,3,1,5,4,1,3,2,4,4,0,-1,0,1,0,8,7,4,6,10,-3,0,0,1,-1,0,1,2,1
KR_6777734460,420,-1,-9,-21,0,-2,2,4,5,5,0,1,3,2,-5,0,5,1,1,0,0,-9,6,-1,8,7,-10,0,0,1,-1,1,1,2,1
KR_6705688693,420,5,5,-3,3,7,7,0,0,2,2,0,3,3,-3,2,5,-1,1,2,1,3,-8,-4,7,3,4,0,2,1,1,1,1,3,1
KR_6773749962,420,-1,38,-28,-1,0,2,2,-2,4,6,4,5,1,-1,0,1,-2,0,2,-1,-1,-6,4,5,9,2,0,1,1,1,1,-1,5,1
KR_6752819181,420,1,55,-8,0,1,4,3,1,3,2,-2,1,3,0,4,4,0,1,1,1,4,-5,1,5,6,-1,0,1,1,-1,1,1,6,1
KR_6740628035,420,5,57,-5,14,2,3,1,2,2,0,5,5,0,0,0,0,5,5,0,0,12,-16,-1,8,7,-3,0,1,1,1,1,1,1,1
KR_6765281096,420,-1,-12,-12,-4,-4,1,5,0,3,3,1,5,4,-1,1,2,0,1,1,0,9,-30,5,2,7,4,0,0,1,1,1,-1,5,1
KR_6752876663,420,1,11,-7,-4,-4,2,6,5,8,3,-2,0,2,-5,1,6,2,3,1,-1,-7,5,-2,5,3,-5,0,-1,-1,-1,-1,-1,1,1
KR_6722804922,420,0,-23,28,-4,0,1,1,1,2,1,0,2,2,-4,2,6,-1,1,2,-1,-7,-23,0,7,7,-3,0,-1,-1,-1,-1,-1,1,1
KR_6732077542,420,1,-22,37,1,1,1,0,0,3,3,3,4,1,-4,0,4,1,1,0,0,-6,1,-3,7,4,0,0,0,-1,1,0,-1,4,1
KR_6721306496,420,1,23,31,-8,0,2,2,-1,1,2,2,3,1,-8,0,8,-1,0,1,0,-16,-14,-4,7,3,7,0,2,-1,1,1,-1,5,1
KR_6771632979,420,4,65,19,12,4,4,0,2,6,4,-2,3,5,8,12,4,0,2,2,1,5,31,1,8,9,2,0,2,1,1,1,1,4,1
KR_6752779232,420,3,43,3,9,-1,3,4,1,5,4,1,1,0,5,7,2,3,4,1,1,9,-14,-1,7,6,1,0,0,-1,1,0,1,1,1
KR_6740643272,420,-1,-21,4,5,1,2,1,4,8,4,4,4,0,-2,2,4,-2,2,4,3,15,-24,6,6,12,2,0,0,1,-1,1,1,6,1
KR_6731528915,420,0,-38,-14,3,0,1,1,3,6,3,0,1,1,0,1,1,0,0,0,0,9,2,-1,8,7,-5,0,0,-1,-1,0,1,1,1
KR_6665650505,420,3,60,4,7,2,2,0,1,4,3,2,2,0,3,7,4,-1,1,2,-2,10,-4,0,7,7,3,0,0,1,-1,1,-1,4,1
KR_6770048324,420,2,7,28,7,0,2,2,4,6,2,2,2,0,1,3,2,0,2,2,0,4,-6,-2,5,3,3,0,1,1,-1,1,1,4,1
KR_6684897892,420,5,25,19,9,0,2,2,2,2,0,1,3,2,5,6,1,1,2,1,-1,8,-31,-1,6,5,1,0,1,-1,1,1,1,2,1
KR_6776530124,420,3,73,13,4,4,4,0,-2,1,3,2,2,0,0,1,1,0,0,0,0,3,5,2,5,7,8,0,2,1,1,1,1,2,1
KR_6775890601,420,0,-64,-8,3,-3,2,5,-1,5,6,-2,0,2,6,8,2,3,3,0,0,13,17,0,9,9,-7,0,0,-1,1,1,1,1,1
KR_6775790040,420,0,39,1,-8,1,2,1,-6,0,6,-2,3,5,-1,0,1,0,0,0,0,-16,-40,-3,8,5,2,0,1,-1,1,1,-1,4,1
KR_6777770295,440,1,89,-30,7,0,2,2,2,2,0,1,5,4,4,5,1,0,0,0,0,12,-4,0,5,5,2,0,1,-1,1,1,-1,6,1
KR_6758494643,420,-1,-41,4,2,2,3,1,0,1,1,3,3,0,0,1,1,-3,0,3,0,0,-11,-2,8,6,3,0,-2,1,-1,-1,1,5,1
KR_6749859487,420,-1,-23,-9,1,-3,2,5,0,4,4,2,2,0,2,4,2,0,0,0,0,7,-41,3,3,6,3,0,-1,-1,-1,-1,-1,1,1
KR_6759461563,440,-3,-25,-12,0,0,3,3,3,3,0,-2,1,3,-1,1,2,0,0,0,0,2,1,6,4,10,-1,0,-1,-1,-1,-1,1,2,1
KR_6777118174,420,4,93,27,7,2,2,0,1,1,0,0,3,3,4,4,0,0,0,0,0,8,35,-1,11,10,0,0,2,1,1,1,1,1,1
KR_6744143240,420,1,45,-1,3,2,4,2,0,3,3,-4,3,7,4,6,2,1,2,1,0,7,0,5,8,13,-4,0,-1,1,-1,-1,1,4,1
KR_6715469634,420,-2,-22,-2,2,-3,2,5,1,2,1,0,0,0,2,2,0,2,2,0,0,7,-96,4,3,7,2,0,1,1,1,1,-1,5,1
KR_6765461622,420,3,14,2,9,2,2,0,1,5,4,0,1,1,6,11,5,0,0,0,0,9,12,-4,11,7,1,0,3,1,1,1,-1,3,1
KR_6727187408,420,3,27,31,13,5,6,1,-1,3,4,4,5,1,5,7,2,0,2,2,0,13,4,0,6,6,-2,0,1,1,1,1,1,1,1
KR_6765478060,420,0,49,-3,7,0,2,2,-3,0,3,9,11,2,-1,1,2,2,2,0,1,18,0,1,6,7,6,0,1,1,1,1,1,2,1
KR_6760617025,420,-1,-49,6,-5,-8,1,9,7,9,2,0,2,2,-2,1,3,-2,1,3,0,-1,10,-5,12,7,-7,0,0,1,-1,-1,-1,1,1
KR_6767905272,420,2,35,32,0,0,3,3,-2,6,8,-2,0,2,7,8,1,-3,1,4,0,2,5,3,8,11,4,0,3,0,1,1,-1,0,1
KR_6771038272,420,2,12,-26,6,-3,1,4,3,5,2,2,5,3,3,5,2,1,1,0,0,9,2,-4,7,3,-4,0,0,-1,-1,-1,1,4,1
KR_6744135490,420,4,94,28,3,-3,1,4,4,5,1,-2,0,2,2,5,3,2,3,1,-1,1,9,1,6,7,0,0,2,1,-1,1,-1,4,1
KR_6775527868,420,0,-11,-22,-1,2,5,3,2,4,2,-3,1,4,2,5,3,-4,0,4,0,-1,-5,0,7,7,-3,0,-2,1,-1,-1,1,4,1
KR_6775515270,420,0,59,16,4,1,2,1,2,3,1,6,6,0,-3,2,5,-2,0,2,0,5,29,2,5,7,8,0,0,1,1,0,1,5,1
KR_6760354148,440,5,18,15,12,4,5,1,-1,0,1,3,3,0,6,8,2,0,1,1,0,10,-5,-3,10,7,-4,0,1,0,0,1,1,0,1
KR_6770244644,440,6,99,13,9,1,4,3,0,1,1,1,1,0,7,7,0,0,1,1,0,7,70,5,4,9,-7,0,0,-1,1,1,1,5,1
KR_6771335681,420,2,-3,0,10,5,7,2,0,4,4,3,5,2,2,4,2,0,0,0,0,3,-5,-5,7,2,3,0,0,-1,1,0,1,4,1
KR_6758945258,420,6,32,3,14,1,2,1,1,3,2,8,8,0,4,4,0,0,2,2,0,16,-22,-6,11,5,4,0,0,1,1,0,-1,3,1
KR_6775865368,420,1,-7,-2,1,-4,0,4,0,2,2,-2,0,2,5,6,1,2,2,0,0,11,-6,5,5,10,-5,0,1,1,-1,-1,-1,4,1
KR_6764844849,420,-3,5,-29,-3,-3,0,3,-2,3,5,1,2,1,1,4,3,0,1,1,1,-8,-2,0,5,5,-1,0,0,1,-1,0,1,3,1
KR_6774734719,420,5,35,28,-2,-2,2,4,4,9,5,0,1,1,-3,2,5,-1,0,1,0,-15,49,-1,10,9,-6,0,0,1,-1,0,1,3,1
KR_6767308724,420,3,50,1,4,3,5,2,1,1,0,3,3,0,-1,3,4,-2,1,3,0,4,4,2,5,7,0,0,1,-1,-1,1,-1,1,1
KR_6727448512,420,1,-4,-7,0,2,5,3,-3,1,4,0,1,1,0,1,1,1,1,0,-1,0,-48,0,9,9,4,0,2,-1,1,1,-1,1,1
KR_6765658800,440,1,59,24,4,-1,1,2,-1,2,3,-1,3,4,5,6,1,2,3,1,0,2,-10,-2,6,4,0,0,2,1,-1,1,1,4,1
KR_6776674065,420,3,75,-11,10,0,1,1,-2,2,4,9,9,0,-1,0,1,4,5,1,0,12,-45,2,4,6,5,0,-1,-1,-1,-1,1,5,1
KR_6754321868,420,7,90,33,17,2,3,1,0,1,1,-1,3,4,14,17,3,2,3,1,0,16,28,2,5,7,2,0,4,-1,1,1,-1,1,1
KR_6766880523,420,2,41,25,3,-1,1,2,1,3,2,-1,1,2,4,4,0,0,0,0,0,6,-143,0,5,5,-5,0,-1,1,1,1,1,3,1
KR_6643777587,420,1,61,-16,9,0,2,2,2,3,1,1,2,1,4,6,2,2,3,1,0,13,3,6,3,9,0,0,1,1,-1,1,1,4,1
KR_6776783025,420,0,-1,18,-5,-1,1,2,-1,2,3,-5,5,10,0,4,4,2,4,2,0,-12,-13,2,5,7,-3,0,0,1,1,1,-1,1,1
KR_6776505952,420,2,53,-11,2,1,2,1,3,3,0,-2,1,3,-1,2,3,1,2,1,0,4,41,1,4,5,-32,0,1,1,1,1,1,6,1
KR_6775817660,420,2,13,10,7,0,2,2,1,5,4,0,2,2,6,7,1,0,0,0,0,10,7,2,4,6,4,0,0,1,1,0,-1,2,1
KR_6764795956,420,1,7,20,1,2,4,2,-1,3,4,2,3,1,-1,3,4,-1,1,2,0,-2,-130,-2,8,6,4,0,0,1,1,1,-1,5,1
KR_6764624257,440,2,84,3,4,-1,1,2,1,2,1,0,2,2,3,5,2,1,1,0,0,4,-229,-4,9,5,4,0,-1,-1,-1,-1,1,4,1
KR_6717512427,420,3,74,13,9,6,7,1,7,10,3,-2,1,3,-1,2,3,-1,1,2,1,11,-5,3,6,9,-2,0,3,1,1,1,1,6,1
KR_6705638525,420,1,12,20,-2,2,4,2,0,1,1,0,2,2,-5,2,7,1,1,0,0,-4,-32,2,5,7,9,0,0,-1,1,1,1,1,1
KR_6712334606,420,-2,-24,8,-6,0,2,2,0,1,1,-3,3,6,-3,2,5,0,1,1,0,-5,-76,-3,5,2,7,0,-2,-1,1,-1,-1,3,1
KR_6748164364,420,0,-70,7,0,-4,1,5,2,4,2,-2,2,4,-2,2,4,6,6,0,0,3,-16,-9,11,2,10,0,-2,-1,-1,-1,-1,5,1
KR_6769070641,420,2,15,-13,4,2,3,1,3,4,1,-1,1,2,0,1,1,0,0,0,0,8,5,3,4,7,1,0,3,-1,1,1,1,3,1
KR_6749474635,420,5,143,-6,0,-4,4,8,3,4,1,-1,0,1,3,4,1,-1,0,1,0,0,-2,-1,6,5,1,0,-1,-1,-1,-1,-1,2,1
KR_6743545788,420,-1,-79,8,-3,-5,0,5,1,4,3,4,4,0,-3,2,5,0,1,1,0,2,-34,-3,10,7,0,0,-1,1,1,-1,-1,6,1
KR_6731876903,420,4,37,-4,13,3,4,1,6,8,2,3,4,1,3,5,2,-2,1,3,2,10,-49,2,7,9,26,0,2,1,1,1,1,4,1
KR_6772029675,420,2,44,-39,10,0,3,3,7,7,0,0,0,0,3,4,1,0,2,2,0,10,-4,3,1,4,7,0,1,1,-1,1,-1,1,1
KR_6771601870,420,-1,22,-3,3,1,1,0,-2,3,5,0,3,3,2,2,0,2,2,0,0,-2,-11,-6,10,4,9,0,0,-1,1,0,1,4,1
KR_6710347967,420,6,131,0,14,6,6,0,6,7,1,2,3,1,2,3,1,-2,1,3,2,18,-3,9,2,11,2,0,2,-1,1,1,1,3,1
KR_6773485984,420,4,36,16,10,-3,5,8,6,7,1,4,6,2,4,6,2,-1,1,2,0,10,2,3,4,7,2,0,2,1,1,1,-1,4,1
KR_6777885222,420,-2,37,-18,4,1,3,2,4,4,0,0,2,2,4,4,0,-5,0,5,1,6,-1,-2,6,4,-4,0,0,1,1,0,1,4,1
KR_6758421250,420,0,-15,28,1,0,2,2,5,5,0,-3,2,5,-4,5,9,3,4,1,0,-1,31,2,8,10,-2,0,-1,1,1,-1,1,2,1
KR_6774043624,420,-2,-32,8,-3,-5,0,5,3,3,0,-2,1,3,0,0,0,1,2,1,0,-2,-27,-2,7,5,9,0,1,-1,1,1,1,2,1
KR_6776249018,420,1,3,4,7,0,2,2,6,9,3,-1,5,6,2,3,1,0,1,1,1,7,3,4,1,5,3,0,0,1,1,1,1,3,1
KR_6763173790,440,-2,-65,30,-2,3,3,0,4,6,2,-4,0,4,-3,3,6,-2,1,3,0,4,59,4,3,7,-2,0,-1,0,1,-1,1,0,1
KR_6766915651,420,-2,1,-5,-2,-4,0,4,3,4,1,0,3,3,0,2,2,-1,0,1,0,10,12,3,9,12,-8,0,-1,-1,1,-1,-1,5,1
KR_6734868595,420,-1,36,7,-4,0,4,4,1,3,2,-4,2,6,-2,5,7,1,1,0,1,-8,-3,1,5,6,7,0,1,1,1,1,1,4,1
KR_6759410221,420,4,-5,27,5,2,2,0,2,3,1,-1,2,3,3,4,1,-1,2,3,0,3,6,3,9,12,0,0,3,1,1,1,-1,4,1
KR_6695106714,420,6,46,71,18,3,4,1,9,10,1,5,5,0,0,1,1,1,1,0,1,19,80,3,8,11,-22,0,2,1,1,1,1,1,1
KR_6751629242,440,3,13,16,1,1,1,0,3,4,1,-6,1,7,0,5,5,3,3,0,0,-6,-3,1,6,7,2,0,1,1,1,1,-1,3,1
KR_6770188081,440,1,0,-16,4,1,3,2,0,0,0,0,2,2,-2,1,3,5,6,1,0,10,56,1,5,6,3,0,-1,-1,1,-1,1,2,1
KR_6768457137,420,6,-1,27,10,0,1,1,3,5,2,1,2,1,6,7,1,0,0,0,0,17,63,2,4,6,-7,0,2,1,1,1,1,3,1
KR_6760444652,420,6,100,41,15,2,3,1,7,9,2,5,6,1,1,6,5,0,1,1,1,26,6,5,1,6,0,0,1,1,1,1,1,2,1
KR_6751219476,420,-1,18,47,-5,2,2,0,-1,2,3,-3,3,6,0,1,1,-3,0,3,0,-10,-18,-3,6,3,3,0,0,1,-1,1,1,3,1
KR_6777692419,420,4,17,9,-1,2,3,1,-2,1,3,-3,2,5,2,4,2,0,0,0,0,-9,-24,2,5,7,4,0,1,-1,1,1,-1,4,1
KR_6777148124,420,0,-35,-1,9,3,5,2,0,4,4,-1,2,3,6,7,1,1,2,1,0,18,6,1,5,6,-4,0,1,1,1,1,1,2,1
KR_6744285351,420,1,-29,6,5,-2,2,4,0,2,2,2,2,0,0,4,4,5,5,0,0,7,-2,-2,8,6,-2,0,-1,1,-1,-1,1,1,1
KR_6776135893,420,1,10,-36,9,5,6,1,-2,1,3,7,9,2,-1,2,3,0,1,1,-1,8,7,0,3,3,3,0,1,-1,-1,1,-1,6,1
KR_6766673549,420,4,-64,51,6,3,3,0,5,7,2,2,3,1,0,3,3,-4,0,4,0,2,-51,0,6,6,21,0,0,-1,1,-1,-1,4,1
KR_6719861588,420,5,44,3,14,2,3,1,2,2,0,1,1,0,4,7,3,5,6,1,0,18,7,3,3,6,-1,0,2,1,1,1,1,2,1
KR_6777422018,420,3,0,-1,3,-1,0,1,-3,2,5,2,2,0,4,5,1,1,1,0,-1,4,-3,-5,11,6,3,0,1,1,-1,1,-1,6,1
KR_6755348790,420,4,96,-2,7,3,7,4,1,2,1,1,1,0,3,4,1,-1,3,4,1,12,10,1,5,6,12,0,3,1,-1,1,1,2,1
KR_6774342702,420,1,74,15,0,4,4,0,2,3,1,0,0,0,-5,1,6,-1,0,1,0,-5,140,-1,7,6,-2,0,1,-1,1,1,1,6,1
KR_6742863079,420,-1,-19,-4,-7,-4,0,4,-1,5,6,0,2,2,1,2,1,-3,3,6,-1,-12,2,-4,8,4,-1,0,0,-1,-1,-1,-1,2,1
KR_6732892745,420,3,31,8,-2,3,4,1,-2,3,5,-4,1,5,3,3,0,-2,1,3,0,-10,-51,-5,9,4,-1,0,3,-1,1,1,1,5,1
KR_6646148064,420,-4,-16,-20,-9,-1,1,2,-2,3,5,-3,0,3,-2,5,7,-1,1,2,0,-16,4,5,5,10,-3,0,0,-1,-1,0,-1,4,1
KR_6770335218,420,0,54,-27,-3,2,4,2,0,4,4,1,2,1,-3,2,5,-3,0,3,0,-2,-2,1,5,6,-2,0,1,-1,1,1,1,4,1
KR_6777701483,420,5,89,-5,15,0,2,2,4,4,0,5,5,0,6,7,1,0,0,0,0,22,-1,3,6,9,5,0,1,1,1,1,1,2,1
KR_6776274986,440,2,5,27,7,0,2,2,2,2,0,-2,1,3,6,6,0,1,1,0,0,9,5,2,7,9,0,0,0,1,1,0,1,2,1
KR_6742032834,420,4,41,-14,6,4,5,1,1,3,2,-1,0,1,0,7,7,2,2,0,0,4,32,9,6,15,-1,0,1,-1,1,1,1,5,1
KR_6724492670,420,6,94,3,17,3,5,2,5,6,1,1,4,3,5,6,1,3,5,2,-1,15,-2,-1,8,7,3,0,2,-1,1,1,-1,5,1
KR_6746191758,420,-1,56,-7,4,0,0,0,0,0,0,0,0,0,4,4,0,0,0,0,0,8,0,0,5,5,7,0,2,-1,1,1,1,4,1
KR_6775686262,420,-1,-1,-1,1,-2,4,6,1,3,2,3,5,2,-1,2,3,0,1,1,0,6,-10,-3,7,4,0,0,0,-1,1,0,1,3,1
KR_6762351680,420,0,-18,-13,4,-1,1,2,1,3,2,-4,0,4,5,6,1,3,3,0,0,6,80,0,3,3,1,0,1,1,-1,1,1,2,1
KR_6773150172,420,1,57,20,-3,2,3,1,-5,1,6,1,5,4,-1,1,2,0,1,1,0,-5,-5,0,3,3,1,0,3,-1,1,1,1,5,1
KR_6775495892,420,-1,27,36,-5,-1,0,1,-2,1,3,-3,0,3,0,4,4,1,1,0,0,-11,-10,-1,8,7,1,0,1,1,-1,1,1,6,1
KR_6760728528,420,4,30,14,15,4,4,0,5,6,1,2,5,3,4,6,2,0,1,1,0,16,-2,6,4,10,3,0,0,1,1,1,1,1,1
KR_6743506923,420,4,26,33,5,4,5,1,1,3,2,1,6,5,0,2,2,-1,0,1,0,-4,13,4,4,8,4,0,1,1,1,1,1,4,1
KR_6776065633,420,2,-13,19,9,2,2,0,5,7,2,2,2,0,2,3,1,-2,0,2,0,12,2,-2,7,5,0,0,2,1,1,1,-1,6,1
KR_6725888160,440,4,13,21,13,2,2,0,0,4,4,-1,3,4,7,9,2,5,6,1,0,14,279,0,4,4,-1,0,2,1,1,1,1,6,1
KR_6734898552,420,-1,-5,-31,-2,-2,2,4,-2,1,3,0,2,2,3,5,2,-1,0,1,0,3,5,0,6,6,-4,0,-1,-1,-1,-1,-1,1,1
KR_6771555020,420,-2,-34,16,-4,-4,0,4,-3,2,5,0,2,2,2,4,2,1,4,3,-1,-3,1,1,7,8,-1,0,-1,1,-1,-1,-1,2,1
KR_6776951670,420,5,47,-16,14,2,3,1,2,3,1,4,6,2,5,6,1,1,1,0,0,14,9,4,5,9,3,0,1,1,-1,1,1,3,1
KR_6739282874,440,2,-16,24,1,-1,2,3,-2,0,2,3,3,0,0,4,4,1,2,1,0,2,-2,-1,6,5,-3,0,-1,1,-1,-1,-1,5,1
KR_6721355410,420,1,12,-17,4,5,5,0,0,1,1,-2,3,5,0,2,2,1,1,0,0,4,-38,-5,9,4,37,0,0,1,-1,1,-1,2,1
KR_6734146861,420,3,70,-4,7,0,1,1,-5,2,7,5,6,1,6,7,1,1,2,1,0,7,-3,0,5,5,4,0,1,1,-1,1,-1,6,1
KR_6775567056,420,-3,-49,4,-1,4,6,2,-5,5,10,-3,2,5,1,3,2,2,2,0,0,-2,-11,1,6,7,-2,0,0,1,1,0,-1,3,1
KR_6766944078,420,0,11,4,4,2,2,0,2,4,2,1,3,2,0,1,1,-1,1,2,0,1,10,-1,6,5,2,0,1,1,1,-1,1,4,1
KR_6742562076,420,0,-54,16,3,5,6,1,4,7,3,-3,1,4,-4,1,5,1,1,0,1,5,-7,-6,12,6,2,0,1,-1,1,1,1,2,1
KR_6735749320,420,4,63,-3,15,6,6,0,5,7,2,3,5,2,0,3,3,1,2,1,0,13,13,4,3,7,-4,0,1,1,-1,1,1,6,1
KR_6772905101,420,1,44,48,0,0,0,0,0,1,1,1,2,1,0,5,5,-1,1,2,0,-5,10,2,5,7,1,0,2,1,1,1,-1,4,1
KR_6702633287,420,0,-7,10,3,2,3,1,0,2,2,2,4,2,-2,2,4,1,1,0,0,9,20,-4,8,4,3,0,-1,1,0,-1,1,1,1
KR_6777809509,440,1,24,17,6,-1,1,2,0,3,3,2,4,2,4,5,1,1,1,0,0,4,-13,-4,8,4,3,0,1,1,1,1,1,1,1
KR_6763734478,420,2,32,-14,8,6,7,1,5,5,0,0,1,1,-2,2,4,-1,0,1,0,8,-39,5,6,11,16,0,-1,1,-1,-1,1,3,1
KR_6740570162,420,2,-37,6,7,-4,1,5,6,6,0,4,6,2,1,4,3,0,1,1,0,15,7,3,5,8,8,0,0,1,1,-1,-1,2,1
KR_6700608072,420,2,-14,9,1,3,3,0,-2,3,5,3,3,0,-3,0,3,0,1,1,0,8,0,1,5,6,0,0,-1,1,-1,-1,1,1,1
KR_6742903232,440,2,41,-5,2,2,4,2,2,2,0,1,2,1,0,1,1,-3,1,4,0,-1,3,4,5,9,-6,0,0,1,1,1,-1,3,1
KR_6738079917,420,1,22,48,3,-2,0,2,1,2,1,4,4,0,2,3,1,-2,0,2,0,5,2,1,6,7,-6,0,0,1,1,0,-1,3,1
KR_6762463050,420,5,46,1,13,7,7,0,4,7,3,1,5,4,3,3,0,-2,0,2,0,11,-1,-3,9,6,6,0,0,1,1,1,-1,1,1
KR_6775288785,420,3,62,-1,3,-1,1,2,-3,1,4,0,4,4,5,5,0,2,3,1,-1,3,10,1,8,9,0,0,3,1,1,1,-1,4,1
KR_6736428643,420,3,33,13,5,4,6,2,0,3,3,1,3,2,1,3,2,-1,1,2,1,4,5,3,6,9,-2,0,1,1,-1,1,1,2,1
KR_6707703306,420,0,-33,-15,4,0,3,3,1,2,1,-2,0,2,5,6,1,0,0,0,0,10,-41,0,6,6,22,0,0,1,1,1,-1,2,1
KR_6771574335,420,4,68,24,8,0,2,2,5,7,2,4,7,3,0,0,0,-1,0,1,0,11,141,-6,11,5,7,0,0,1,1,0,-1,2,1
KR_6763605728,440,8,103,60,13,8,8,0,-2,6,8,-1,0,1,2,3,1,6,8,2,1,0,3,2,4,6,6,0,2,1,1,1,1,3,1
KR_6738005425,420,0,32,-10,1,0,6,6,-1,3,4,3,7,4,-3,5,8,2,2,0,-4,-3,65,-2,9,7,4,0,1,-1,1,1,-1,1,1
KR_6703478492,420,0,23,27,3,0,2,2,-7,1,8,3,4,1,6,9,3,1,3,2,0,2,5,3,3,6,1,0,1,1,-1,1,-1,1,1
KR_6734957357,420,9,108,2,14,-1,1,2,2,4,2,8,11,3,4,5,1,1,3,2,2,14,5,6,3,9,1,0,4,1,1,1,1,1,1
KR_6763330141,420,-2,6,-21,-1,2,2,0,-4,0,4,-1,0,1,2,3,1,0,0,0,0,-6,3,-3,8,5,7,0,0,-1,1,1,1,3,1
KR_6721322984,420,-1,-5,3,-1,-1,1,2,-1,1,2,0,1,1,3,5,2,-2,0,2,0,0,-4,-5,10,5,-1,0,0,1,1,-1,1,2,1
KR_6775978818,420,-1,-54,-2,0,-1,0,1,-1,3,4,1,1,0,-1,3,4,2,2,0,-1,2,215,-4,6,2,-2,0,-1,0,-1,-1,-1,0,1
KR_6708476655,420,0,-44,-2,4,-2,2,4,4,7,3,-3,1,4,5,5,0,0,1,1,0,11,5,-1,6,5,6,0,1,1,1,1,1,6,1
KR_6748220239,420,-2,-83,-4,-4,-2,0,2,-2,1,3,0,1,1,3,4,1,-3,1,4,0,-2,-110,3,8,11,0,0,-1,-1,1,-1,-1,6,1
KR_6709065488,420,0,-61,-5,3,-1,1,2,4,6,2,0,1,1,-2,4,6,2,4,2,-1,3,1,2,7,9,-2,0,-1,-1,-1,-1,-1,4,1
KR_6769568483,420,2,-31,12,7,1,3,2,1,3,2,5,7,2,0,2,2,0,0,0,0,0,20,-3,8,5,4,0,1,1,1,1,1,5,1
KR_6751325631,440,3,98,9,12,0,3,3,0,1,1,-2,4,6,17,18,1,-3,2,5,2,13,-45,2,6,8,17,0,-1,1,-1,1,1,3,1
KR_6723350172,420,4,26,17,7,2,3,1,5,6,1,0,4,4,-1,3,4,1,1,0,0,10,-3,-3,10,7,4,0,2,1,1,1,1,3,1
KR_6773473682,440,-1,41,4,-6,-3,0,3,-1,6,7,1,2,1,-2,0,2,-1,0,1,0,-9,1,-5,6,1,2,0,1,-1,1,1,1,2,1
KR_6765800010,420,4,34,36,9,0,4,4,4,5,1,-1,1,2,5,11,6,1,3,2,1,6,-13,-3,10,7,4,0,-1,0,-1,1,1,0,1
KR_6771827443,440,2,-14,-13,9,4,4,0,2,4,2,0,0,0,2,2,0,1,1,0,0,15,-9,-1,7,6,3,0,0,-1,-1,0,1,3,1
KR_6762911397,440,3,84,-27,5,1,4,3,2,5,3,6,6,0,-1,0,1,-3,2,5,0,3,9,1,5,6,4,0,2,1,1,1,-1,3,1
KR_6765357197,420,1,29,11,1,2,3,1,-1,0,1,2,4,2,-1,3,4,-1,0,1,0,4,3,0,3,3,-1,0,1,-1,-1,1,-1,5,1
KR_6729280176,420,2,55,14,4,0,2,2,-1,0,1,4,5,1,0,1,1,1,1,0,0,8,1,2,7,9,7,0,1,1,1,1,-1,6,1
KR_6707795539,420,3,-8,1,8,3,4,1,1,7,6,3,5,2,0,4,4,1,1,0,-3,14,-4,-2,10,8,7,0,1,1,1,1,-1,3,1
KR_6771198884,420,5,62,14,9,-1,0,1,8,10,2,3,5,2,1,1,0,-2,2,4,0,11,-5,-4,6,2,5,0,2,-1,1,1,1,6,1
KR_6727672952,420,1,47,16,2,3,4,1,2,7,5,0,5,5,-2,5,7,-1,2,3,1,6,74,0,9,9,-10,0,3,1,-1,1,1,6,1
KR_6768394021,420,2,-8,-7,7,-1,0,1,5,5,0,2,3,1,1,2,1,0,0,0,0,4,-8,2,2,4,5,0,0,-1,-1,0,-1,6,1
KR_6777016185,420,0,19,-13,-5,-3,0,3,2,2,0,0,1,1,-2,2,4,-2,3,5,-1,-8,-156,0,5,5,-1,0,1,1,-1,1,-1,2,1
KR_6708300361,420,1,58,-15,2,0,3,3,2,3,1,0,2,2,1,3,2,-1,0,1,0,-3,-24,1,9,10,3,0,1,-1,1,1,1,6,1
KR_6740623290,420,3,43,5,10,4,5,1,4,4,0,-2,1,3,5,5,0,-1,3,4,0,2,-24,6,5,11,-4,0,1,1,1,1,1,1,1
KR_6718996187,420,-1,-5,17,-3,-3,0,3,-2,1,3,3,3,0,-2,2,4,1,1,0,0,3,0,-1,7,6,-1,0,-1,-1,-1,-1,-1,3,1
KR_6777279471,420,5,40,27,16,1,4,3,5,6,1,1,2,1,6,6,0,3,3,0,1,23,34,-4,9,5,5,0,1,1,1,1,1,4,1
KR_6760161951,420,3,26,0,6,0,2,2,-2,2,4,4,6,2,2,3,1,2,2,0,0,14,8,8,5,13,-5,0,1,1,-1,1,1,2,1
KR_6772796975,420,5,52,45,9,-2,1,3,0,4,4,2,2,0,7,7,0,2,4,2,0,9,40,-2,7,5,-19,0,3,-1,1,1,1,3,1
KR_6777472441,420,0,-18,16,8,-3,0,3,10,11,1,5,6,1,-4,0,4,0,1,1,0,12,3,6,1,7,-3,0,1,1,1,1,1,1,1
KR_6764977012,420,1,4,14,2,3,4,1,4,4,0,0,3,3,-5,1,6,0,0,0,0,-4,8,6,6,12,-5,0,1,1,1,1,1,3,1
KR_6774256769,420,2,-4,28,7,3,4,1,2,5,3,4,6,2,0,1,1,-2,0,2,1,3,1,-4,10,6,7,0,0,-1,1,1,1,4,1
KR_6723798521,420,-1,-32,-92,2,0,1,1,-1,1,2,4,4,0,-1,1,2,0,0,0,0,4,2,2,5,7,-4,0,0,-1,-1,0,1,3,1
KR_6712279310,420,3,4,9,3,-1,0,1,0,2,2,0,2,2,4,4,0,0,0,0,0,7,8,4,5,9,0,0,0,1,-1,0,-1,1,1
KR_6771241308,420,3,43,36,4,-1,0,1,0,2,2,3,4,1,1,4,3,1,1,0,0,3,-10,-3,12,9,4,0,1,1,-1,1,1,4,1
KR_6757417460,420,3,29,30,9,1,2,1,1,5,4,6,7,1,0,0,0,1,1,0,0,11,-13,2,3,5,1,0,2,-1,1,1,1,2,1
KR_6727712578,420,2,31,10,10,3,4,1,-1,1,2,0,5,5,2,2,0,6,6,0,0,8,9,-3,7,4,2,0,1,1,-1,1,1,3,1
KR_6767477520,420,0,18,34,0,0,2,2,3,6,3,1,2,1,-3,0,3,-1,0,1,0,-10,4,-4,10,6,-2,0,-1,1,-1,-1,1,5,1
KR_6776982661,420,3,62,-10,8,4,4,0,2,4,2,-4,1,5,2,4,2,4,5,1,0,10,-5,-1,5,4,1,0,1,-1,1,1,1,6,1
KR_6756578998,440,4,74,7,16,9,9,0,6,7,1,5,5,0,-2,1,3,-2,5,7,2,22,-19,4,2,6,3,0,1,1,1,1,1,3,1
KR_6739341163,420,2,-22,21,7,0,0,0,1,6,5,6,6,0,-1,4,5,1,1,0,0,7,-14,-1,9,8,-1,0,2,-1,1,1,-1,3,1
KR_6775078074,420,6,61,16,14,10,10,0,-1,3,4,4,4,0,1,2,1,0,0,0,0,7,-8,-2,7,5,4,0,1,1,1,1,1,2,1
KR_6702968384,420,-1,36,-23,-3,1,2,1,1,6,5,-3,1,4,0,2,2,-2,1,3,0,-12,-9,-2,9,7,0,0,1,-1,1,-1,-1,6,1
KR_6777133576,420,-1,36,10,-3,-1,0,1,2,2,0,0,1,1,-6,0,6,2,2,0,0,-2,-33,2,9,11,-1,0,0,1,-1,-1,-1,4,1
KR_6759961058,440,0,-32,6,6,3,3,0,2,4,2,0,1,1,4,6,2,-3,0,3,0,16,33,1,9,10,-7,0,1,1,1,1,-1,1,1
KR_6713299838,420,0,-11,-44,4,0,3,3,1,3,2,0,2,2,1,2,1,2,2,0,0,5,9,4,3,7,-3,0,0,1,1,0,-1,5,1
KR_6764916466,420,1,42,4,1,2,4,2,-2,0,2,0,1,1,2,2,0,-1,0,1,2,3,15,-1,7,6,2,0,0,-1,-1,1,1,6,1
KR_6699169731,420,3,68,8,3,1,2,1,-1,4,5,0,3,3,0,4,4,3,3,0,-1,4,139,-1,6,5,5,0,0,1,-1,1,-1,1,1
KR_6760835199,420,-3,-35,10,-6,-1,1,2,-4,3,7,1,3,2,-2,1,3,0,0,0,0,-1,-9,-4,6,2,6,0,-1,1,-1,-1,-1,1,1
KR_6773072987,420,0,17,0,-3,-3,0,3,-1,1,2,-1,2,3,2,4,2,0,1,1,-1,-2,69,-1,7,6,-4,0,0,-1,-1,0,-1,1,1
KR_6776142922,420,1,-1,17,4,-1,1,2,5,8,3,-2,1,3,0,3,3,2,3,1,0,5,22,1,4,5,5,0,0,1,1,1,1,1,1
KR_6767849209,420,3,7,-8,7,0,1,1,3,4,1,3,4,1,2,2,0,-1,0,1,0,4,16,-2,6,4,1,0,1,1,1,1,1,4,1
KR_6767321078,420,-1,-21,6,1,1,4,3,3,4,1,-3,1,4,-2,1,3,2,2,0,-1,11,-11,0,9,9,1,0,-1,-1,-1,-1,-1,6,1
KR_6764500082,420,1,-72,37,2,-4,0,4,-1,2,3,7,9,2,1,6,5,-1,0,1,0,15,5,-3,7,4,-3,0,-1,1,1,-1,1,6,1
KR_6776646194,420,3,58,5,0,3,4,1,-1,3,4,-3,3,6,0,3,3,1,1,0,0,-6,-8,-3,10,7,5,0,2,-1,-1,1,1,4,1
KR_6700534508,420,2,33,22,8,1,1,0,3,5,2,2,2,0,2,3,1,0,0,0,0,15,3,6,4,10,3,0,0,1,-1,1,-1,4,1
KR_6721291563,420,3,7,51,5,4,5,1,1,3,2,2,2,0,-2,4,6,0,0,0,0,1,77,4,5,9,-23,0,0,-1,1,-1,-1,4,1
KR_6749700811,420,2,60,13,11,-1,1,2,1,7,6,3,4,1,4,4,0,4,6,2,1,15,50,-7,15,8,-21,0,1,1,1,1,1,6,1
KR_6775887300,420,1,40,17,11,1,2,1,2,5,3,3,3,0,4,5,1,1,1,0,0,16,21,6,3,9,4,0,2,1,1,1,1,3,1
KR_6775117500,420,4,42,4,12,2,2,0,-1,2,3,-1,3,4,1,3,2,11,12,1,0,13,-20,6,4,10,-1,0,3,1,1,1,1,1,1
KR_6764791846,420,2,76,-2,11,7,7,0,1,3,2,1,2,1,0,2,2,2,4,2,2,0,11,4,4,8,-3,0,1,1,1,1,1,5,1
KR_6776888401,420,2,-11,15,5,0,0,0,5,8,3,1,4,3,-1,1,2,0,0,0,0,4,-175,2,5,7,-2,0,0,-1,1,0,1,3,1
KR_6727884421,420,2,81,27,9,4,7,3,6,6,0,1,2,1,1,3,2,-3,1,4,0,5,7,0,5,5,7,0,0,1,1,0,1,1,1
KR_6775360020,420,1,-42,12,2,2,7,5,-3,1,4,1,2,1,2,3,1,0,1,1,-2,3,37,-5,9,4,-5,0,-2,1,-1,-1,-1,4,1
KR_6711856531,420,2,-23,0,4,1,3,2,1,5,4,-3,3,6,3,4,1,2,3,1,0,-2,-6,2,3,5,2,0,0,-1,1,1,1,4,1
KR_6776221178,420,0,24,25,0,0,1,1,3,6,3,-1,0,1,-1,2,3,-1,0,1,-1,-8,-4,-3,8,5,4,0,0,1,1,0,-1,3,1
KR_6777051964,420,-1,13,13,1,-1,2,3,1,4,3,1,2,1,0,2,2,0,0,0,-1,6,-5,-3,9,6,2,0,0,1,1,0,-1,2,1
KR_6772969651,420,2,67,-16,-2,0,3,3,-1,2,3,0,2,2,-1,2,3,0,1,1,1,-1,7,0,5,5,-25,0,1,-1,1,1,1,2,1
KR_6755197043,420,6,59,46,12,1,2,1,5,6,1,3,4,1,2,3,1,1,1,0,0,7,7,3,5,8,-1,0,2,1,1,1,-1,4,1
KR_6710629786,420,5,23,-21,23,6,7,1,10,10,0,-1,2,3,6,6,0,2,2,0,0,39,33,4,4,8,-2,0,3,1,1,1,1,5,1
KR_6734916526,420,0,-24,0,5,-3,0,3,3,6,3,0,1,1,5,5,0,0,0,0,1,1,-152,5,4,9,4,0,0,-1,1,0,1,4,1
KR_6761752807,420,2,36,-20,8,-3,3,6,2,4,2,2,4,2,5,5,0,2,8,6,-1,6,9,1,7,8,0,0,2,-1,1,1,-1,3,1
KR_6777132073,420,7,4,16,13,0,2,2,1,2,1,4,6,2,10,10,0,-2,1,3,0,19,38,1,5,6,2,0,1,1,1,1,1,4,1
KR_6754421913,420,5,7,13,14,1,3,2,7,8,1,3,6,3,2,5,3,1,2,1,1,16,11,-1,5,4,1,0,0,1,1,0,1,1,1
KR_6729089547,420,0,30,-10,3,2,4,2,-5,4,9,6,7,1,0,2,2,0,1,1,2,5,4,3,4,7,-4,0,0,1,-1,-1,1,1,1
KR_6775616020,420,-1,20,6,-2,-3,1,4,3,4,1,0,2,2,-2,2,4,0,0,0,0,4,-6,-2,7,5,0,0,1,1,1,1,1,6,1
KR_6732956050,440,3,27,9,5,2,2,0,-1,4,5,2,2,0,-1,2,3,3,3,0,2,-1,6,1,8,9,-3,0,1,-1,1,1,1,5,1
KR_6705077012,420,1,42,-17,4,1,2,1,0,4,4,2,6,4,-1,2,3,2,2,0,0,-5,28,0,6,6,-2,0,2,-1,1,1,-1,6,1
KR_6699410288,420,1,41,-2,5,0,3,3,-1,1,2,1,2,1,2,5,3,3,3,0,0,5,-8,-4,10,6,4,0,0,-1,1,0,-1,3,1
KR_6770501278,420,-1,44,12,0,0,2,2,-2,1,3,1,4,3,3,5,2,-2,0,2,0,-6,3,2,4,6,2,0,4,1,1,1,1,6,1
KR_6777455903,420,0,0,9,-6,-1,1,2,-2,1,3,-1,3,4,-1,0,1,-1,2,3,0,-6,-7,-4,9,5,-1,0,-1,-1,-1,-1,1,5,1
KR_6742672387,420,-2,-12,-23,-7,-4,0,4,4,4,0,0,0,0,-5,1,6,-2,0,2,0,-4,123,0,7,7,5,0,-1,1,-1,-1,-1,4,1
KR_6767554204,420,1,37,-7,3,3,4,1,-1,1,2,2,3,1,0,2,2,-1,0,1,0,5,8,3,5,8,-2,0,0,-1,-1,1,1,6,1
KR_6764357060,420,4,84,40,4,8,11,3,0,4,4,1,1,0,-3,0,3,-2,2,4,1,0,31,0,8,8,-3,0,1,1,-1,1,1,3,1
KR_6751534125,420,6,118,9,17,6,6,0,8,12,4,3,4,1,0,3,3,0,1,1,0,11,400,1,4,5,0,0,3,1,-1,1,1,1,1
KR_6726439375,420,5,81,-16,11,2,2,0,2,2,0,3,3,0,3,4,1,1,1,0,0,12,11,2,5,7,4,0,2,-1,1,1,-1,6,1
KR_6746213436,420,3,102,12,6,5,6,1,1,2,1,2,2,0,-2,1,3,0,0,0,0,2,-3,-1,4,3,5,0,1,1,1,1,-1,1,1
KR_6768683478,420,0,74,-18,2,0,1,1,0,3,3,-2,0,2,4,6,2,0,0,0,1,2,34,0,4,4,0,0,1,1,-1,1,1,6,1
KR_6771039756,440,6,161,20,9,4,4,0,-3,0,3,3,4,1,5,6,1,0,1,1,0,5,7,1,2,3,0,0,2,1,1,1,1,4,1
KR_6774979381,420,1,7,8,1,0,2,2,-3,1,4,7,8,1,-3,1,4,0,0,0,0,0,0,0,8,8,4,0,0,1,1,0,-1,4,1
KR_6728365155,440,2,-29,19,7,4,5,1,3,4,1,0,1,1,2,4,2,-2,0,2,0,10,0,0,6,6,-5,0,0,1,1,1,-1,2,1
KR_6772276103,420,-1,-46,9,-4,0,0,0,-5,1,6,-2,0,2,3,5,2,0,0,0,0,-10,-27,1,5,6,-4,0,1,1,-1,1,-1,6,1
KR_6773081152,420,-2,7,18,-6,0,0,0,1,1,0,-3,1,4,-3,3,6,-1,0,1,0,-9,-25,-3,7,4,-1,0,-1,-1,1,-1,1,6,1
KR_6760521838,420,0,31,2,6,-3,1,4,-1,0,1,3,4,1,7,8,1,0,2,2,0,10,6,-1,6,5,-1,0,1,1,1,1,1,1,1
KR_6774250600,420,2,17,20,4,0,2,2,-2,3,5,5,9,4,1,2,1,0,0,0,0,-2,3,-1,4,3,-1,0,1,-1,1,-1,1,4,1
KR_6645623252,420,3,23,-8,13,3,4,1,3,3,0,5,6,1,4,5,1,-2,1,3,0,11,-32,3,7,10,23,0,1,1,1,1,-1,5,1
KR_6770036048,420,0,58,16,4,0,1,1,-2,1,3,0,1,1,6,6,0,0,1,1,0,14,3,1,7,8,-2,0,0,-1,1,0,1,1,1
KR_6766619666,420,-2,-19,-9,1,3,6,3,1,1,0,-2,2,4,0,1,1,-1,1,2,0,1,-36,-1,5,4,-3,0,0,1,1,0,-1,2,1
KR_6722012509,420,-1,9,-16,1,-4,1,5,-2,1,3,1,2,1,4,5,1,2,3,1,0,9,-5,8,3,11,-5,0,1,-1,1,1,-1,2,1
KR_6746070010,420,5,10,24,13,2,2,0,3,4,1,5,6,1,1,2,1,2,2,0,0,17,12,0,5,5,3,0,0,1,1,0,1,6,1
KR_6777808767,420,1,14,8,2,0,1,1,3,3,0,-2,2,4,5,8,3,-4,0,4,0,6,5,-2,7,5,-4,0,-1,-1,-1,-1,-1,6,1
KR_6728622312,420,1,10,6,2,0,1,1,-3,2,5,1,2,1,6,7,1,-2,0,2,-1,-4,-1,1,7,8,4,0,0,1,-1,0,-1,4,1
KR_6774195401,420,0,33,1,-4,-1,4,5,0,8,8,0,1,1,1,4,3,-4,1,5,1,-15,-14,1,5,6,-3,0,-1,-1,-1,-1,1,5,1
KR_6750190342,420,5,44,9,13,1,2,1,7,10,3,5,6,1,2,8,6,-2,4,6,-1,15,-13,0,9,9,0,0,1,1,-1,1,-1,2,1
KR_6714107824,420,-1,4,20,0,0,1,1,0,5,5,-2,0,2,3,4,1,-1,1,2,-2,7,-3,0,8,8,-4,0,0,-1,-1,1,-1,1,1
KR_6698366393,420,2,-53,33,12,-3,0,3,5,6,1,2,3,1,7,10,3,1,2,1,0,21,-5,-2,6,4,-2,0,0,1,1,1,-1,2,1
KR_6771696746,420,4,55,17,12,-1,2,3,1,3,2,1,3,2,9,14,5,2,2,0,0,18,1,-1,5,4,-8,0,1,1,1,1,1,5,1
KR_6772577867,420,5,44,7,18,7,7,0,2,4,2,5,8,3,4,7,3,0,0,0,0,29,-5,8,4,12,-5,0,1,1,1,1,1,2,1
KR_6705559267,420,1,-1,-3,6,-3,1,4,7,8,1,2,2,0,-1,3,4,1,1,0,0,13,3,0,10,10,2,0,1,1,-1,1,-1,2,1
KR_6745912770,420,-2,-58,-7,-2,-6,0,6,0,2,2,-2,3,5,-2,2,4,8,8,0,0,3,22,-1,6,5,-1,0,-1,-1,-1,-1,1,3,1
KR_6776198531,420,5,38,2,8,1,1,0,-2,2,4,0,2,2,8,8,0,1,1,0,0,4,4,3,3,6,-2,0,2,1,1,1,1,4,1
KR_6772709906,420,6,55,28,15,0,2,2,6,6,0,4,5,1,2,3,1,3,3,0,0,18,-8,-3,8,5,5,0,1,1,-1,1,1,4,1
KR_6711257462,420,5,138,5,10,-1,1,2,3,6,3,6,7,1,2,4,2,0,1,1,0,10,-34,-2,7,5,5,0,2,1,-1,1,1,2,1
KR_6704402400,420,0,29,-12,-4,-1,0,1,-2,1,3,3,3,0,-4,0,4,0,0,0,0,-4,40,0,6,6,-28,0,0,1,-1,1,1,4,1
KR_6777198126,420,4,36,19,11,3,5,2,-1,4,5,2,3,1,6,6,0,1,3,2,0,21,5,0,6,6,5,0,2,1,1,1,1,4,1
KR_6743550553,420,4,13,32,10,3,3,0,3,5,2,-2,2,4,3,4,1,3,4,1,0,11,0,-2,5,3,6,0,2,1,1,1,-1,6,1
KR_6776317971,420,4,3,7,15,0,3,3,7,7,0,3,4,1,2,3,1,3,6,3,0,20,51,2,8,10,3,0,3,-1,1,1,1,1,1
KR_6776520688,440,0,18,41,-1,-3,0,3,2,4,2,1,2,1,-2,1,3,1,2,1,0,-6,0,2,6,8,-2,0,0,1,-1,0,-1,5,1
KR_6732422489,420,3,1,-8,8,4,4,0,3,4,1,1,1,0,1,2,1,-1,0,1,0,9,-40,0,8,8,-3,0,0,1,-1,0,1,1,1
KR_6750729681,420,1,13,15,-1,-2,0,2,-2,3,5,0,4,4,3,3,0,0,1,1,0,1,-4,-1,7,6,-2,0,0,0,1,0,1,0,1
KR_6777846644,420,3,87,7,11,6,8,2,2,2,0,2,2,0,1,6,5,0,1,1,0,13,4,3,3,6,3,0,3,1,1,1,-1,6,1
KR_6763149511,420,0,27,0,-3,1,1,0,3,6,3,-5,0,5,-1,3,4,-1,0,1,1,4,-1,-3,7,4,9,0,-1,1,-1,-1,1,3,1
KR_6774832833,420,2,34,21,1,2,3,1,0,4,4,0,2,2,-2,1,3,1,1,0,0,-2,1,1,3,4,-1,0,1,1,1,1,-1,4,1
KR_6732179105,420,1,42,9,8,-3,1,4,1,1,0,3,3,0,6,6,0,1,1,0,0,11,-47,-1,7,6,30,0,1,1,-1,1,1,3,1
KR_6758136747,440,4,98,38,13,7,8,1,2,3,1,1,5,4,7,7,0,-4,0,4,1,-2,1,7,5,12,-2,0,2,-1,1,1,1,1,1
KR_6776643778,420,4,38,12,15,1,4,3,6,7,1,0,2,2,6,6,0,2,2,0,0,22,-3,1,4,5,7,0,1,1,-1,1,1,2,1
KR_6765918949,420,0,24,-33,7,2,2,0,2,4,2,3,4,1,4,6,2,-4,1,5,-1,8,-47,6,6,12,5,0,0,-1,1,1,1,2,1
KR_6776649769,420,3,30,28,2,-2,0,2,1,3,2,-2,1,3,5,6,1,0,2,2,0,5,7,-1,7,6,0,0,2,1,-1,-1,1,1,1
KR_6733135231,420,5,6,23,7,2,2,0,-2,3,5,1,2,1,6,7,1,0,1,1,0,13,-3,2,5,7,-2,0,0,1,-1,-1,-1,4,1
KR_6756218117,420,2,-9,41,3,1,4,3,1,4,3,4,4,0,-3,2,5,0,0,0,0,6,73,-4,8,4,-19,0,1,-1,1,1,1,5,1
KR_6775691358,420,4,59,10,11,0,1,1,1,3,2,1,2,1,9,10,1,0,2,2,1,18,29,5,4,9,4,0,4,1,1,1,1,3,1
KR_6770326574,440,-3,-34,-20,-1,-6,0,6,-2,1,3,4,4,0,3,3,0,0,0,0,1,3,74,4,3,7,1,0,-1,1,-1,1,1,4,1
KR_6776145953,420,-1,16,-43,9,6,7,1,-1,3,4,3,4,1,4,6,2,-3,0,3,0,11,-2,4,7,11,1,0,1,-1,-1,1,1,6,1
KR_6755771420,420,4,-10,20,16,2,2,0,10,11,1,0,0,0,4,10,6,0,0,0,-2,15,-7,1,5,6,6,0,2,1,1,1,1,5,1
KR_6711899549,420,10,153,44,19,5,5,0,5,9,4,3,4,1,5,5,0,1,1,0,0,30,-3,1,2,3,1,0,3,1,1,1,1,3,1
KR_6777667988,420,1,25,-12,5,6,7,1,1,4,3,0,1,1,-2,0,2,0,0,0,0,0,44,-4,8,4,-2,0,1,1,-1,-1,1,5,1
KR_6721637844,420,1,-17,1,2,-1,1,2,1,2,1,3,3,0,-1,1,2,0,1,1,0,3,-31,4,5,9,-5,0,-1,1,-1,-1,1,5,1
KR_6769349059,420,-3,-34,32,-3,2,2,0,-1,2,3,-3,1,4,-1,2,3,0,0,0,1,-4,1,2,3,5,-1,0,-1,1,1,-1,1,3,1
KR_6744226242,420,2,17,-29,7,8,8,0,2,4,2,-1,1,2,-2,2,4,0,1,1,1,-2,2,-4,7,3,2,0,2,1,1,1,1,5,1
KR_6773589878,420,-1,29,-9,3,-1,1,2,2,4,2,4,4,0,-1,1,2,-1,0,1,0,-1,-10,0,8,8,9,0,0,1,1,1,1,2,1
KR_6776492897,440,2,43,-1,-1,0,2,2,1,4,3,2,2,0,-2,1,3,-2,1,3,-1,-10,24,0,5,5,-1,0,1,1,1,1,-1,5,1
KR_6771866489,420,-2,4,-17,-6,-2,0,2,0,2,2,-2,1,3,3,7,4,-5,0,5,0,-1,11,4,5,9,-5,0,-1,-1,1,-1,-1,2,1
KR_6774699343,420,6,12,28,8,5,6,1,-5,4,9,1,2,1,7,7,0,0,2,2,0,-3,-1,5,2,7,0,0,2,1,1,1,1,2,1
KR_6754316577,420,-2,-3,-2,0,-2,1,3,-3,0,3,2,4,2,5,6,1,-2,0,2,0,9,15,-1,9,8,-3,0,0,-1,-1,0,-1,2,1
KR_6775910738,420,5,58,1,8,3,5,2,0,4,4,2,4,2,6,6,0,-3,1,4,0,15,-3,-1,7,6,0,0,2,1,-1,1,-1,4,1
KR_6776401777,420,4,25,-6,9,2,2,0,3,3,0,2,5,3,2,2,0,0,0,0,0,11,-4,2,4,6,1,0,0,1,1,0,1,3,1
KR_6698159133,420,-2,-88,-20,2,0,1,1,7,9,2,-2,2,4,-6,1,7,3,3,0,1,15,12,4,6,10,-4,0,0,1,1,0,1,4,1
KR_6771394364,420,3,11,1,5,-1,1,2,1,4,3,-2,2,4,6,6,0,1,1,0,0,11,-7,0,5,5,-2,0,2,-1,1,1,1,6,1
KR_6689486555,420,1,38,-4,2,-2,2,4,2,2,0,0,4,4,2,3,1,0,1,1,0,7,5,4,2,6,0,0,0,1,-1,1,-1,6,1
KR_6763625293,420,4,74,20,10,4,4,0,-1,3,4,2,6,4,4,5,1,1,3,2,-1,12,-1,-2,8,6,3,0,1,1,1,1,-1,1,1
KR_6755326738,420,2,61,-5,6,2,2,0,0,1,1,3,3,0,2,4,2,-1,1,2,0,6,23,-1,7,6,1,0,1,1,1,1,1,4,1
KR_6774010030,420,1,64,-1,1,1,2,1,-1,3,4,1,3,2,1,2,1,-1,2,3,0,-7,7,0,5,5,-3,0,1,0,-1,1,-1,0,1
KR_6776907625,420,-1,-38,-12,-2,0,2,2,1,5,4,1,2,1,-4,1,5,0,1,1,0,-1,7,-1,6,5,0,0,0,1,1,1,-1,3,1
KR_6667953977,420,5,71,-2,12,5,5,0,1,2,1,2,6,4,6,6,0,-2,0,2,1,15,25,7,2,9,-1,0,1,1,-1,1,1,2,1
KR_6738407805,420,3,17,41,8,0,1,1,4,4,0,0,2,2,5,6,1,-1,0,1,0,12,13,5,5,10,2,0,1,1,1,1,1,4,1
KR_6772398930,420,1,35,-1,5,5,6,1,2,5,3,-1,2,3,3,4,1,-4,0,4,1,-2,9,-3,6,3,-3,0,1,1,-1,1,1,3,1
KR_6777754966,420,0,-53,-17,0,4,5,1,-1,6,7,-4,0,4,-1,2,3,2,2,0,-1,-3,0,-1,8,7,-3,0,-1,-1,-1,-1,-1,6,1
KR_6777797300,420,2,-25,41,-5,0,1,1,-1,3,4,-2,0,2,-2,2,4,0,1,1,0,-5,-7,-1,7,6,3,0,-2,-1,-1,-1,1,5,1
KR_6732330903,420,4,-1,28,13,3,4,1,3,5,2,5,5,0,1,3,2,1,4,3,0,11,40,0,7,7,3,0,0,1,1,0,-1,3,1
KR_6741223297,420,4,19,48,-4,1,2,1,-4,3,7,0,2,2,-4,0,4,3,3,0,0,-5,8,2,6,8,-8,0,-1,1,0,-1,-1,2,1
KR_6776766134,420,0,48,-5,1,-1,1,2,-1,3,4,4,6,2,-1,1,2,0,1,1,0,-2,0,0,4,4,1,0,-1,-1,1,-1,1,6,1
KR_6735770866,440,-1,-10,3,4,3,5,2,1,2,1,-2,1,3,1,1,0,1,1,0,0,1,-3,-8,11,3,9,0,1,-1,1,1,1,5,1
KR_6736892574,420,4,51,-5,10,0,2,2,0,6,6,9,10,1,3,3,0,-2,0,2,0,13,-2,-2,7,5,6,0,3,1,1,1,1,1,1
KR_6769754528,420,3,42,-16,5,5,6,1,-1,2,3,4,5,1,-2,1,3,-1,2,3,-1,-7,-124,-1,9,8,0,0,1,-1,1,1,-1,1,1
KR_6751797285,420,3,66,20,3,0,1,1,-4,4,8,2,2,0,4,6,2,1,1,0,0,2,-26,-3,6,3,6,0,1,1,1,1,-1,5,1
KR_6773595181,440,4,42,-3,11,2,3,1,1,2,1,5,5,0,3,5,2,0,1,1,0,11,9,1,7,8,2,0,1,1,1,1,1,6,1
KR_6775603627,420,1,11,-29,3,0,2,2,-4,2,6,2,4,2,5,7,2,0,1,1,0,2,8,5,1,6,-1,0,1,-1,1,1,1,5,1
KR_6712506400,420,5,47,-2,12,-3,3,6,2,3,1,4,5,1,8,9,1,1,1,0,0,25,7,0,5,5,-1,0,1,1,-1,1,1,4,1
KR_6777001256,440,2,63,-25,9,2,2,0,3,4,1,5,5,0,-2,3,5,1,2,1,0,3,-5,1,4,5,-1,0,0,1,1,0,-1,2,1
KR_6760630407,420,-2,26,16,0,0,2,2,-4,0,4,4,5,1,4,4,0,-4,1,5,0,5,-6,-8,12,4,8,0,-1,1,1,-1,1,3,1
KR_6768999107,420,0,33,22,-4,0,3,3,1,4,3,0,0,0,-3,2,5,-2,3,5,0,-10,-3,-2,5,3,2,0,0,1,-1,0,1,6,1
KR_6767626614,420,5,34,12,2,2,3,1,-1,6,7,0,6,6,0,3,3,1,3,2,-1,-5,-18,2,7,9,3,0,1,-1,1,1,-1,1,1
KR_6770154901,420,3,27,53,2,-1,2,3,2,5,3,-1,1,2,2,4,2,0,1,1,-2,-4,-42,2,6,8,6,0,0,1,-1,0,-1,1,1
KR_6742250108,420,-1,13,7,-2,2,3,1,-1,3,4,-5,1,6,1,2,1,1,2,1,0,-7,0,2,6,8,2,0,0,-1,-1,-1,1,3,1
KR_6773844347,440,0,29,-25,2,1,1,0,1,3,2,0,0,0,-4,0,4,4,5,1,0,5,34,3,7,10,-3,0,0,-1,-1,0,1,4,1
KR_6745602293,420,3,74,-18,7,3,3,0,8,9,1,-4,0,4,0,4,4,0,0,0,0,14,7,-4,8,4,1,0,1,1,-1,1,1,5,1
KR_6771117156,420,1,28,12,3,1,3,2,-1,1,2,2,3,1,0,1,1,1,1,0,0,5,-7,-4,8,4,1,0,0,-1,1,0,1,5,1
KR_6775992847,420,0,52,12,-5,0,1,1,-5,1,6,-1,5,6,1,4,3,0,0,0,-1,-16,0,-1,8,7,4,0,-1,1,-1,-1,1,1,1
KR_6717227352,420,1,63,-1,5,3,4,1,-2,3,5,4,4,0,-1,1,2,1,1,0,0,-4,-36,4,5,9,5,0,0,-1,-1,-1,1,1,1
KR_6709519305,420,2,45,0,2,-2,1,3,1,3,2,0,1,1,2,2,0,1,1,0,0,7,7,1,6,7,1,0,-1,1,-1,-1,1,6,1
KR_6773382800,440,2,-2,24,3,0,1,1,-1,1,2,2,3,1,0,2,2,2,2,0,0,8,4,0,5,5,-4,0,0,1,0,1,-1,4,1
KR_6776458771,420,2,11,-3,3,1,2,1,-4,1,5,3,4,1,2,5,3,1,2,1,0,4,-36,0,6,6,1,0,2,1,-1,1,-1,1,1
KR_6744889802,420,3,6,-23,15,2,2,0,3,4,1,2,2,0,8,10,2,0,0,0,0,17,-2,6,3,9,2,0,0,1,0,1,1,4,1
KR_6774256494,420,1,26,12,2,0,1,1,5,5,0,-4,1,5,2,2,0,-1,1,2,0,-3,-8,4,3,7,1,0,2,1,1,1,-1,1,1
KR_6769544897,420,-2,16,-13,2,6,7,1,-8,2,10,0,2,2,3,4,1,1,1,0,0,-3,4,-1,5,4,1,0,1,-1,1,1,1,4,1
KR_6749920308,420,-1,-9,-24,3,2,5,3,-1,3,4,1,4,3,-1,1,2,2,2,0,-1,-2,28,0,6,6,-7,0,2,1,1,1,-1,4,1
KR_6691573615,420,1,46,-22,6,4,4,0,2,4,2,1,3,2,0,6,6,-1,1,2,2,10,-24,4,4,8,-3,0,1,1,-1,-1,1,6,1
KR_6774665190,420,2,-4,36,2,2,2,0,0,3,3,0,0,0,0,3,3,0,0,0,0,-5,-40,-5,9,4,6,0,0,1,1,1,-1,2,1
KR_6711807721,420,8,95,32,11,0,1,1,1,5,4,7,9,2,3,5,2,0,0,0,0,20,8,3,6,9,6,0,3,1,-1,1,1,4,1
KR_6764426944,420,2,6,5,2,-3,0,3,0,4,4,6,6,0,-2,1,3,1,2,1,0,8,8,0,9,9,9,0,0,-1,1,0,1,1,1
KR_6754796064,420,4,35,-12,7,4,7,3,3,3,0,0,1,1,2,4,2,-2,1,3,0,6,-2,-3,7,4,2,0,0,1,-1,1,1,4,1
KR_6765411432,420,2,3,37,1,-2,2,4,3,4,1,1,3,2,3,3,0,-4,0,4,0,7,-1,2,5,7,-3,0,0,1,-1,1,-1,5,1
KR_6773902228,420,2,77,1,8,1,2,1,3,3,0,-1,1,2,4,6,2,1,1,0,0,23,-54,1,3,4,1,0,1,1,1,1,1,5,1
KR_6746683567,420,5,41,-8,16,4,4,0,3,4,1,2,6,4,5,6,1,2,2,0,1,13,33,7,3,10,-1,0,1,1,1,1,1,5,1
KR_6731016752,420,1,9,-12,6,-1,2,3,1,2,1,7,7,0,-1,0,1,0,1,1,0,9,8,6,6,12,-2,0,2,1,1,1,-1,5,1
KR_6742706121,420,6,38,42,10,2,4,2,4,4,0,3,7,4,2,2,0,-1,2,3,0,13,47,-7,11,4,5,0,2,1,1,1,1,3,1
KR_6768403808,420,2,10,-18,6,2,3,1,-1,3,4,5,5,0,0,0,0,0,0,0,0,-1,-1,2,5,7,5,0,0,-1,1,0,1,1,1
KR_6713279719,440,2,39,31,1,1,2,1,0,3,3,1,1,0,0,4,4,-1,1,2,0,-3,-3,-4,12,8,-1,0,-1,-1,-1,-1,1,6,1
KR_6740515477,420,6,63,4,11,5,5,0,3,5,2,1,2,1,2,2,0,0,0,0,0,12,2,-1,5,4,3,1,6,1,1,1,1,5,1
KR_6722802881,420,2,-12,13,-1,-3,0,3,0,4,4,-3,2,5,3,6,3,2,3,1,-1,14,8,1,10,11,0,0,-1,1,-1,-1,1,4,1
KR_6744323506,420,3,72,16,4,0,2,2,2,4,2,0,1,1,2,2,0,0,0,0,0,2,-30,5,4,9,0,0,2,1,1,1,1,4,1
KR_6765610182,420,0,28,2,4,-1,2,3,-2,1,3,0,2,2,7,8,1,0,0,0,0,7,3,0,6,6,2,0,-1,1,-1,-1,1,2,1
KR_6762479112,420,3,27,20,3,0,1,1,-3,1,4,0,4,4,6,8,2,0,0,0,0,5,4,0,8,8,-4,0,1,1,1,1,1,1,1
KR_6775842490,420,0,74,29,2,-2,2,4,2,3,1,1,2,1,2,3,1,-1,0,1,0,7,154,-3,7,4,4,0,2,-1,-1,1,-1,6,1
KR_6777841421,420,-1,7,16,1,-1,1,2,0,3,3,1,1,0,1,2,1,0,0,0,0,0,-8,-1,9,8,2,0,1,-1,-1,1,-1,3,1
KR_6773696471,420,3,90,61,5,0,1,1,4,4,0,3,3,0,-3,1,4,1,1,0,0,5,-2,2,5,7,4,0,1,1,1,1,1,5,1
KR_6767572699,420,1,-31,-11,-1,0,1,1,-2,2,4,1,4,3,-1,2,3,1,1,0,0,4,37,7,4,11,2,0,0,-1,-1,1,-1,6,1
KR_6774399996,420,3,30,12,1,4,5,1,1,3,2,-6,0,6,0,5,5,2,3,1,0,-3,1,-4,7,3,-2,0,1,1,-1,1,-1,3,1
KR_6773992740,420,3,45,16,3,2,4,2,-1,1,2,0,2,2,0,2,2,2,4,2,2,7,-1,-1,7,6,0,0,1,1,1,1,1,3,1
KR_6775819187,420,-1,-27,2,-3,2,2,0,0,3,3,0,1,1,-2,1,3,-3,0,3,0,-5,-9,-1,10,9,-4,0,-1,-1,1,-1,-1,1,1
KR_6760477794,420,7,94,-8,17,1,2,1,2,3,1,-1,3,4,10,10,0,5,6,1,4,28,31,2,3,5,-2,0,1,1,1,1,1,2,1
KR_6776003512,440,2,96,43,6,-1,1,2,8,9,1,-6,0,6,5,7,2,0,1,1,-1,-1,-6,0,2,2,1,0,1,1,1,1,-1,1,1
KR_6739975128,420,1,-40,-28,5,-1,4,5,2,5,3,1,4,3,3,6,3,0,1,1,0,1,-46,-2,9,7,0,0,0,1,1,1,1,5,1
KR_6740135498,420,0,-19,24,3,-2,1,3,3,4,1,2,7,5,0,1,1,0,3,3,-1,-2,11,2,4,6,-7,0,0,1,1,1,-1,1,1
KR_6741397309,420,1,-21,-30,-3,-5,2,7,3,5,2,0,4,4,1,4,3,-2,0,2,0,4,3,-3,6,3,2,0,-1,1,-1,-1,-1,4,1
KR_6776589887,420,3,45,28,9,-3,1,4,5,7,2,0,0,0,7,9,2,0,1,1,0,11,-1,5,3,8,-1,0,0,-1,1,0,1,2,1
KR_6763144747,420,2,32,43,4,0,2,2,5,6,1,-1,2,3,1,2,1,-1,0,1,0,8,56,2,3,5,-6,0,0,1,1,1,-1,4,1
KR_6777043227,420,4,-7,8,11,4,4,0,0,1,1,4,6,2,3,3,0,0,3,3,-1,5,1,3,5,8,2,0,2,1,-1,1,-1,2,1
KR_6746199368,420,3,56,33,6,0,2,2,7,7,0,-2,1,3,1,2,1,0,0,0,0,8,9,0,8,8,1,0,2,1,1,1,1,5,1
KR_6731060242,440,1,32,-24,7,1,2,1,1,4,3,2,2,0,3,3,0,0,1,1,0,5,-51,4,1,5,27,0,0,-1,-1,1,1,5,1
KR_6756266361,420,5,71,16,15,3,6,3,5,7,2,4,6,2,0,3,3,3,4,1,0,11,-3,3,4,7,6,0,2,-1,1,1,1,2,1
KR_6710375755,420,6,44,36,12,8,9,1,0,4,4,2,4,2,1,2,1,1,1,0,0,9,-3,2,6,8,3,0,1,1,-1,1,1,1,1
KR_6710036688,420,3,-35,3,6,3,5,2,1,2,1,2,2,0,1,3,2,-1,1,2,0,7,-11,-4,9,5,-1,0,0,-1,0,-1,1,4,1
KR_6774121685,420,4,20,-8,5,2,4,2,2,3,1,0,1,1,0,7,7,1,2,1,0,12,-34,-2,7,5,25,0,0,1,1,0,1,4,1
KR_6777047336,420,2,-27,20,-1,1,2,1,4,8,4,1,3,2,-5,1,6,-2,0,2,0,0,-1,-4,9,5,-4,0,0,1,1,1,-1,4,1
KR_6761885225,420,0,20,-12,-4,0,1,1,1,2,1,-2,1,3,-2,0,2,-1,1,2,-1,-8,-22,-6,12,6,6,0,0,1,1,1,-1,3,1
KR_6768177299,420,1,47,9,2,-1,1,2,-2,7,9,4,7,3,2,2,0,-1,0,1,3,0,23,-2,7,5,2,0,1,1,1,1,1,6,1
KR_6760766302,420,-1,21,-8,2,2,2,0,-5,2,7,6,7,1,-1,0,1,0,0,0,0,0,7,0,6,6,-3,0,0,1,1,1,1,5,1
KR_6776040749,420,4,10,26,12,4,5,1,0,4,4,1,2,1,5,6,1,2,2,0,2,0,49,-3,9,6,3,0,1,1,1,1,1,5,1
KR_6689656231,420,-1,-27,-31,3,1,1,0,3,5,2,0,4,4,-2,0,2,1,1,0,0,0,182,5,3,8,-2,0,-1,1,1,-1,1,1,1
KR_6765205097,420,0,8,2,3,3,3,0,3,5,2,-4,1,5,2,3,1,-1,1,2,0,2,-7,2,5,7,-4,0,0,-1,1,0,-1,1,1
KR_6766707603,420,4,48,33,1,-2,2,4,0,3,3,5,6,1,-1,0,1,-1,0,1,0,1,-37,-1,7,6,0,0,2,-1,1,1,-1,2,1
KR_6742137297,420,8,4,38,13,-1,2,3,4,6,2,7,7,0,2,2,0,1,1,0,0,8,9,4,5,9,2,0,1,1,1,1,1,4,1
KR_6721363631,420,-1,12,-30,1,1,2,1,-1,2,3,0,2,2,2,3,1,-1,0,1,0,6,17,-5,7,2,4,0,1,-1,1,1,1,4,1
KR_6777431424,420,-1,-12,-4,4,3,4,1,1,3,2,-1,0,1,1,4,3,0,0,0,0,3,5,3,2,5,-6,0,1,0,1,1,-1,0,1
KR_6771991907,420,4,-19,20,9,4,4,0,0,1,1,4,7,3,0,4,4,1,1,0,0,2,15,1,7,8,-4,0,0,1,1,1,-1,5,1
KR_6753291360,420,3,2,21,4,-4,0,4,5,7,2,0,2,2,2,5,3,1,2,1,0,6,3,-2,5,3,2,0,1,1,-1,1,1,3,1
KR_6742490935,420,1,68,-13,5,1,2,1,2,5,3,-1,1,2,-1,1,2,4,4,0,0,4,-32,1,7,8,10,0,0,1,1,1,1,1,1
KR_6743791849,420,2,18,-1,5,2,4,2,2,3,1,-2,2,4,1,5,4,2,3,1,2,7,5,-3,12,9,-5,0,1,-1,-1,1,1,4,1
KR_6739405343,420,2,29,17,6,-4,1,5,5,7,2,1,6,5,3,10,7,1,2,1,0,5,-6,-1,7,6,-1,0,0,1,1,1,1,3,1
KR_6734549010,420,4,21,11,13,-2,0,2,4,5,1,4,5,1,6,6,0,1,1,0,0,14,9,0,6,6,0,0,1,1,1,1,1,5,1
KR_6737506997,420,-1,2,19,-7,0,2,2,-2,0,2,-3,0,3,-1,1,2,-1,4,5,0,-15,-27,1,4,5,-2,0,0,1,1,1,1,5,1
KR_6762421355,420,0,17,2,3,0,2,2,-3,1,4,1,1,0,3,4,1,2,2,0,0,0,-16,5,4,9,-9,0,1,-1,1,1,-1,2,1
KR_6737099618,420,2,2,-15,8,1,1,0,2,9,7,3,6,3,2,4,2,0,3,3,0,12,10,0,4,4,-1,0,0,-1,-1,0,-1,6,1
KR_6776644187,420,4,51,-6,13,1,1,0,4,7,3,8,9,1,-1,3,4,1,1,0,-1,15,-11,-5,10,5,5,0,1,1,1,1,-1,4,1
KR_6729477149,420,7,156,63,12,11,11,0,0,1,1,3,4,1,1,2,1,-3,0,3,1,14,12,-5,10,5,5,1,6,1,1,1,1,2,1
KR_6764446654,420,2,-61,19,8,2,3,1,2,3,1,1,3,2,3,3,0,0,3,3,-1,19,-14,1,8,9,-2,0,2,1,1,1,-1,2,1
KR_6741732997,420,-1,-34,-6,-2,-1,3,4,2,4,2,2,4,2,-4,1,5,-1,0,1,1,2,-2,0,4,4,1,0,-1,1,-1,-1,1,2,1
KR_6733638020,420,5,4,38,1,-1,1,2,0,6,6,0,1,1,1,3,2,1,1,0,0,-1,1,-3,7,4,3,0,0,1,1,1,1,6,1
KR_6738516935,420,0,-27,3,4,-4,0,4,3,4,1,5,6,1,0,5,5,0,1,1,0,3,6,4,6,10,-3,0,0,-1,1,0,-1,2,1
KR_6745846085,420,0,17,9,6,1,3,2,2,3,1,1,5,4,-1,2,3,3,3,0,0,5,17,3,3,6,0,0,2,1,1,1,1,1,1
KR_6745731886,420,4,112,5,6,-1,1,2,5,7,2,0,2,2,2,2,0,0,0,0,0,0,-1,6,4,10,4,0,3,0,1,1,1,0,1
KR_6768266038,420,3,-2,0,8,3,4,1,6,7,1,2,4,2,-2,1,3,-1,0,1,1,9,29,1,4,5,1,0,0,1,-1,1,1,1,1
KR_6769479474,420,1,45,-15,2,0,2,2,1,3,2,-2,2,4,1,1,0,2,3,1,0,5,7,-3,10,7,-9,0,2,-1,1,1,1,3,1
KR_6691202591,420,1,38,-19,5,-4,2,6,1,4,3,1,4,3,5,8,3,2,3,1,2,7,7,0,7,7,-2,0,1,1,-1,1,-1,6,1
KR_6756864653,420,5,105,15,9,5,5,0,3,6,3,0,3,3,0,2,2,1,1,0,0,4,6,-5,7,2,0,0,2,1,-1,1,1,3,1
KR_6766011167,420,-1,-7,-18,2,-1,3,4,-3,1,4,0,3,3,4,4,0,2,3,1,0,4,-10,4,6,10,-8,0,-1,1,-1,1,-1,4,1
KR_6752307170,420,1,-15,-16,8,-1,0,1,5,6,1,2,2,0,-2,2,4,4,4,0,0,6,43,3,5,8,-8,0,1,1,1,1,-1,5,1
KR_6724633423,420,0,28,31,6,2,4,2,3,3,0,0,2,2,0,1,1,1,1,0,0,5,1,-1,6,5,8,0,1,1,1,-1,1,6,1
KR_6769339331,420,2,18,3,0,1,3,2,2,5,3,5,8,3,-5,0,5,-3,0,3,0,1,-17,-2,7,5,3,0,1,-1,1,-1,-1,3,1
KR_6777198531,420,2,13,16,17,0,2,2,1,3,2,11,13,2,5,5,0,0,2,2,1,12,-110,2,5,7,-2,0,1,1,0,1,1,4,1
KR_6752369385,440,-1,-13,28,-1,1,3,2,-1,4,5,1,2,1,1,3,2,-3,2,5,0,-4,-22,0,9,9,10,0,0,0,1,0,-1,0,1
KR_6761582150,420,4,68,36,3,-2,2,4,2,5,3,0,2,2,-1,0,1,4,5,1,1,8,-24,-2,7,5,-8,0,3,1,1,1,1,3,1
KR_6740702130,420,4,56,26,3,4,5,1,-4,2,6,5,5,0,-1,1,2,-1,0,1,0,-1,116,2,4,6,4,0,0,1,-1,1,1,3,1
KR_6754342842,420,1,9,30,-2,5,6,1,0,3,3,-2,0,2,-5,4,9,0,1,1,0,-14,53,3,8,11,-26,0,2,1,-1,1,-1,2,1
KR_6772672323,420,4,57,-9,9,3,4,1,2,7,5,5,7,2,-1,1,2,0,2,2,1,4,-148,-2,7,5,2,0,2,1,1,-1,1,5,1
KR_6773088311,420,6,49,-1,-3,-6,2,8,0,4,4,-3,1,4,4,4,0,2,2,0,-3,3,12,4,3,7,-5,0,1,1,1,1,-1,5,1
KR_6774104165,440,-2,-38,19,-5,-6,1,7,-3,1,4,4,4,0,0,1,1,0,0,0,0,1,-38,0,6,6,1,0,0,0,1,0,-1,0,1
KR_6776414550,420,3,35,-16,14,5,5,0,3,4,1,0,2,2,4,4,0,2,3,1,2,19,0,0,3,3,1,0,0,1,-1,1,1,1,1
KR_6767689470,420,1,72,37,2,1,4,3,0,0,0,0,0,0,2,3,1,-1,2,3,-1,2,-12,0,8,8,2,0,1,1,-1,1,-1,5,1
KR_6757600331,420,0,48,-8,8,2,4,2,0,3,3,8,8,0,-2,1,3,0,0,0,-1,5,3,3,6,9,2,0,2,1,1,1,-1,2,1
KR_6728258668,440,1,-1,31,6,-1,0,1,-4,1,5,2,5,3,8,8,0,1,1,0,-2,10,21,-4,6,2,1,0,3,0,1,1,-1,0,1
KR_6743599330,420,1,67,-3,2,-5,0,5,2,4,2,2,3,1,4,5,1,-1,0,1,0,8,6,7,2,9,-4,0,1,1,-1,1,-1,5,1
KR_6776819134,420,0,-19,-17,4,3,3,0,2,4,2,3,5,2,-3,4,7,-1,2,3,0,4,6,3,4,7,-5,0,0,-1,1,-1,-1,3,1
KR_6758911200,420,7,90,59,11,1,2,1,7,10,3,-1,1,2,3,3,0,1,2,1,0,11,12,4,3,7,1,0,4,1,1,1,1,4,1
KR_6747786941,420,4,-5,8,13,2,2,0,7,8,1,3,3,0,2,6,4,-1,0,1,0,8,7,1,5,6,-1,0,-1,1,1,1,1,5,1
KR_6716744596,420,4,35,16,12,3,4,1,2,6,4,3,5,2,3,3,0,1,1,0,1,6,5,2,3,5,0,0,2,-1,1,1,1,2,1
KR_6777525730,420,-1,-12,4,0,2,2,0,3,5,2,-2,0,2,-1,0,1,-2,2,4,0,3,53,-1,8,7,5,0,1,-1,1,-1,-1,6,1
KR_6776798596,420,2,55,10,2,-1,2,3,-3,0,3,-1,2,3,8,10,2,-1,0,1,0,2,-4,1,7,8,3,0,2,1,-1,1,-1,4,1
KR_6775474654,440,3,21,19,7,4,4,0,2,2,0,2,3,1,1,5,4,-2,1,3,0,8,9,-2,6,4,5,0,0,1,-1,1,1,3,1
KR_6746537884,420,4,50,18,6,-1,0,1,5,5,0,4,4,0,-5,3,8,3,4,1,0,8,-2,3,4,7,-3,0,2,1,1,1,1,3,1
KR_6735874665,440,0,-33,3,-2,0,1,1,-2,0,2,2,2,0,-3,0,3,1,1,0,0,-6,-9,-7,10,3,-3,0,-1,-1,1,-1,-1,6,1
KR_6760159086,420,7,13,9,8,0,1,1,1,3,2,4,4,0,2,3,1,1,1,0,0,10,4,7,1,8,-3,0,2,1,1,1,1,2,1
KR_6770294718,440,2,73,-32,5,0,1,1,1,3,2,5,7,2,-1,2,3,0,5,5,0,7,-37,-3,7,4,-1,0,2,-1,1,1,1,1,1
KR_6741836146,420,2,-13,-18,4,5,6,1,-3,0,3,4,5,1,-1,1,2,-1,0,1,0,-2,-4,2,4,6,-3,0,0,1,1,0,1,6,1
KR_6772659434,420,1,48,9,7,3,5,2,1,3,2,5,6,1,1,2,1,-3,1,4,1,8,43,0,5,5,-1,0,2,1,1,1,1,6,1
KR_6753019764,420,-2,-68,12,-5,-1,2,3,-1,2,3,-2,2,4,-1,2,3,0,0,0,0,-2,-3,-1,7,6,-4,0,0,1,-1,-1,-1,5,1
KR_6774444679,420,3,41,4,8,0,1,1,4,5,1,0,1,1,4,10,6,0,0,0,1,17,4,0,5,5,5,0,2,1,1,1,1,3,1
KR_6716940137,420,4,110,1,7,1,3,2,3,3,0,0,8,8,5,6,1,-2,0,2,0,0,-17,1,2,3,4,0,1,1,1,1,1,4,1
KR_6699467496,420,-1,22,-13,-3,4,5,1,-8,1,9,1,4,3,3,4,1,-3,0,3,0,-9,-39,-1,5,4,0,0,1,-1,1,-1,-1,4,1
KR_6776275193,420,0,-34,-29,0,-3,1,4,-5,1,6,0,1,1,8,9,1,0,0,0,0,2,5,1,6,7,-7,0,0,-1,1,1,-1,2,1
KR_6771075230,420,4,2,38,5,-2,0,2,6,11,5,0,4,4,3,3,0,-2,1,3,-1,7,-2,-7,12,5,-5,0,1,-1,0,1,-1,6,1
KR_6734956244,420,3,20,4,8,3,4,1,3,3,0,0,2,2,1,3,2,1,2,1,0,8,-16,0,6,6,2,0,2,1,1,1,-1,3,1
KR_6774171207,420,1,-33,8,5,-2,0,2,2,2,0,7,7,0,-1,2,3,-1,0,1,0,7,-4,0,7,7,8,0,-1,1,-1,-1,-1,3,1
KR_6774403997,420,-1,4,4,1,-1,1,2,5,6,1,1,2,1,-3,1,4,-1,1,2,1,5,10,3,6,9,-11,0,0,1,1,0,1,5,1
KR_6755936549,420,3,60,61,1,-2,1,3,4,6,2,-3,1,4,0,5,5,2,2,0,1,4,-204,7,5,12,5,0,3,-1,1,1,1,2,1
KR_6766470272,420,2,4,13,4,3,4,1,-1,4,5,-1,0,1,2,2,0,1,1,0,-1,12,29,-3,9,6,-1,0,0,-1,1,1,-1,5,1
KR_6755946508,420,4,37,24,15,5,9,4,2,4,2,7,8,1,-4,1,5,5,5,0,1,13,-385,1,5,6,3,0,2,1,1,1,1,6,1
KR_6777047658,420,-5,-39,-28,-6,0,0,0,1,5,4,-2,1,3,-4,0,4,-1,0,1,0,-9,-15,2,7,9,-1,0,0,-1,1,0,-1,4,1
KR_6709221960,420,-1,-20,5,0,2,4,2,-4,3,7,2,4,2,-2,3,5,2,3,1,0,-14,-2,-3,10,7,-3,0,0,-1,-1,-1,1,5,1
KR_6763818810,420,-1,-18,-25,4,-3,1,4,3,4,1,3,3,0,0,1,1,1,2,1,1,2,8,1,7,8,-2,0,1,1,1,-1,1,4,1
KR_6730864932,440,2,-27,33,2,-3,2,5,6,6,0,4,4,0,-2,5,7,-3,0,3,0,10,-23,3,3,6,6,0,0,1,1,-1,-1,3,1
KR_6773732269,440,0,16,16,-2,2,2,0,0,1,1,-2,0,2,-3,2,5,1,3,2,0,-2,6,4,5,9,2,0,0,-1,1,0,-1,1,1
KR_6736428666,420,2,-36,19,4,1,2,1,1,2,1,2,4,2,-2,1,3,2,2,0,2,4,0,-1,7,6,5,0,0,-1,1,0,1,5,1
KR_6750377312,440,3,11,35,5,-1,1,2,3,3,0,1,2,1,2,4,2,0,2,2,0,4,9,4,4,8,0,0,1,1,1,1,1,4,1
KR_6775433220,420,-1,35,3,0,0,0,0,2,5,3,-1,0,1,2,4,2,-3,1,4,0,4,2,0,8,8,0,0,0,1,1,0,-1,3,1
KR_6777417704,420,-2,-41,19,-5,-1,0,1,-3,2,5,0,2,2,-2,1,3,1,1,0,0,-10,-2,-6,10,4,2,0,-1,1,1,-1,1,3,1
KR_6720459430,420,6,53,41,13,-3,0,3,5,7,2,2,3,1,8,9,1,1,1,0,0,24,17,7,2,9,-1,0,0,1,1,1,1,5,1
KR_6760650882,420,-1,-37,1,-5,-1,0,1,0,5,5,-2,2,4,0,4,4,-2,1,3,0,-6,33,-8,15,7,-3,0,-1,0,-1,-1,1,0,1
KR_6727890954,420,0,-11,-1,3,0,0,0,-2,4,6,0,2,2,4,5,1,1,3,2,0,8,9,3,5,8,-5,0,-1,1,-1,-1,1,4,1
KR_6753280015,420,4,4,20,8,2,3,1,-1,1,2,5,5,0,2,3,1,0,1,1,0,9,-3,2,5,7,-3,0,0,1,-1,0,-1,4,1
KR_6712159362,420,5,113,-29,21,3,3,0,-1,4,5,7,8,1,10,11,1,2,3,1,0,20,2,1,6,7,8,0,3,1,1,1,-1,3,1
KR_6746910574,420,-1,51,1,-1,0,1,1,-3,0,3,-5,0,5,6,6,0,1,2,1,0,-3,-37,0,5,5,4,0,0,1,-1,0,1,3,1
KR_6759911124,420,1,17,-1,8,0,1,1,3,5,2,4,5,1,0,0,0,1,1,0,1,16,30,8,2,10,1,0,1,1,1,1,1,4,1
KR_6740345093,420,0,17,6,-2,-7,0,7,0,2,2,3,5,2,2,5,3,0,0,0,0,-4,-7,0,9,9,9,0,0,1,-1,0,1,6,1
KR_6734882544,420,-2,-14,-5,7,1,4,3,4,9,5,0,6,6,2,2,0,0,1,1,1,11,0,0,11,11,-6,0,0,1,0,1,1,5,1
KR_6752422758,420,3,-7,-6,2,-2,2,4,0,2,2,3,4,1,-1,0,1,2,2,0,0,10,-5,-10,13,3,7,0,-1,-1,-1,-1,-1,5,1
KR_6776471760,420,1,33,-16,3,2,3,1,1,2,1,-1,1,2,1,2,1,0,0,0,0,4,-5,-6,9,3,4,0,0,-1,-1,0,1,4,1
KR_6706105988,420,0,51,36,-1,0,1,1,-5,2,7,0,1,1,2,3,1,2,2,0,0,-1,2,-2,7,5,3,0,0,0,-1,0,-1,0,1
KR_6770784325,420,-1,-61,-35,5,5,6,1,4,6,2,0,2,2,-3,2,5,-1,2,3,0,7,3,4,5,9,1,0,0,1,1,-1,1,1,1
KR_6720675730,420,2,22,16,3,1,2,1,2,5,3,-1,2,3,2,3,1,-1,1,2,0,0,-1,3,8,11,0,0,2,0,1,1,1,0,1
KR_6758441002,440,0,-44,-24,-3,2,2,0,1,2,1,3,4,1,-2,1,3,-7,0,7,0,-5,-24,0,5,5,-5,0,0,0,1,0,-1,0,1
KR_6777483595,420,1,-37,45,7,0,3,3,6,7,1,1,1,0,-1,1,2,1,1,0,0,10,49,1,5,6,-2,0,-1,-1,1,-1,1,3,1
KR_6773088795,440,-2,25,30,-4,-1,3,4,0,5,5,-2,3,5,0,1,1,-1,0,1,1,-8,-9,-6,10,4,0,0,1,1,1,1,1,3,1
KR_6758681727,420,0,70,16,4,2,3,1,1,1,0,6,7,1,-5,0,5,0,2,2,0,-6,17,8,2,10,-1,0,1,1,1,1,1,5,1
KR_6777404086,420,3,16,3,2,1,1,0,3,3,0,3,3,0,-3,2,5,-2,0,2,0,7,-2,4,7,11,-4,0,0,-1,1,1,-1,2,1
KR_6710641366,420,3,60,-5,7,-2,0,2,0,3,3,-1,3,4,8,9,1,2,2,0,1,18,6,0,3,3,3,0,0,-1,-1,1,1,5,1
KR_6761068316,420,2,21,30,3,0,3,3,-1,4,5,5,5,0,-1,3,4,0,2,2,-1,-2,41,2,5,7,0,0,1,-1,1,1,-1,5,1
KR_6763612110,420,6,87,22,11,4,4,0,2,4,2,2,3,1,4,4,0,-1,0,1,0,15,51,2,4,6,-1,0,3,1,1,1,1,1,1
KR_6773146443,420,3,53,-11,6,6,6,0,2,6,4,-3,1,4,0,1,1,1,1,0,0,-3,4,0,4,4,-1,0,0,1,-1,1,1,3,1
KR_6745868212,420,3,18,-12,5,2,3,1,1,5,4,1,3,2,0,3,3,1,2,1,0,-5,12,5,6,11,-7,0,2,1,1,1,1,3,1
KR_6698080611,420,5,82,3,12,-3,0,3,2,4,2,4,5,1,8,10,2,1,1,0,0,7,-14,2,5,7,-5,0,3,1,1,-1,-1,5,1
KR_6757515573,420,0,13,-35,8,1,3,2,-2,5,7,5,5,0,4,7,3,0,1,1,1,6,-13,4,4,8,-3,0,1,0,1,1,1,0,1
KR_6772788092,440,-1,25,-54,2,1,2,1,1,4,3,-4,0,4,4,5,1,0,0,0,0,4,-3,1,6,7,1,0,-1,-1,1,-1,1,5,1
KR_6763742728,420,-1,-53,-4,-2,2,3,1,-5,1,6,5,7,2,-5,1,6,1,2,1,0,-6,7,-2,8,6,-1,0,-1,1,0,-1,1,2,1
KR_6761759073,420,0,-18,4,5,-2,0,2,2,2,0,4,6,2,2,2,0,-1,0,1,0,9,-29,7,4,11,-1,0,1,-1,1,1,1,4,1
KR_6760411007,420,-2,1,-10,-6,-2,1,3,4,5,1,-1,0,1,-9,4,13,2,2,0,-1,-11,27,-1,8,7,1,0,-1,1,-1,-1,-1,1,1
KR_6774314960,420,0,18,5,-2,-2,3,5,0,6,6,-2,1,3,3,4,1,-1,0,1,0,-1,50,-1,6,5,-24,0,-2,1,-1,-1,1,4,1
KR_6773933963,420,-1,-23,-21,1,-1,0,1,3,3,0,-2,0,2,0,4,4,1,1,0,0,4,6,1,5,6,2,0,1,1,1,1,1,4,1
KR_6729375237,420,0,12,-5,3,4,5,1,0,1,1,-2,1,3,1,2,1,0,0,0,0,-3,-30,-3,5,2,2,0,0,1,-1,-1,1,6,1
KR_6736392435,420,3,34,-2,13,1,1,0,3,5,2,3,3,0,3,6,3,3,4,1,0,11,213,8,3,11,-1,0,0,1,1,0,1,2,1
KR_6768276665,420,5,26,41,9,3,3,0,4,5,1,-1,2,3,6,7,1,-3,0,3,0,13,4,-3,10,7,-2,0,0,1,-1,1,-1,6,1
KR_6770494835,440,-1,-30,10,-4,-1,1,2,-3,4,7,2,3,1,-2,2,4,0,0,0,-2,-2,-7,-4,9,5,1,0,0,1,1,-1,-1,3,1
KR_6704995613,420,3,46,-11,8,3,4,1,-2,3,5,0,1,1,6,6,0,1,1,0,1,4,25,6,2,8,6,0,0,1,1,1,1,2,1
KR_6731909501,420,2,-15,8,7,0,1,1,0,3,3,-1,0,1,5,6,1,3,4,1,0,8,145,2,4,6,0,0,1,-1,1,1,1,4,1
KR_6769884983,420,2,25,-14,8,1,4,3,1,7,6,3,3,0,2,6,4,1,1,0,0,11,1,-2,8,6,0,0,2,-1,1,1,-1,2,1
KR_6743523146,440,2,34,8,-1,4,4,0,0,0,0,0,1,1,-3,1,4,-2,1,3,0,-1,-19,2,7,9,-3,0,1,1,1,1,-1,4,1
KR_6774200581,420,1,64,-10,0,3,3,0,-3,1,4,2,2,0,-4,3,7,2,4,2,1,-7,29,1,4,5,1,0,-1,1,-1,-1,-1,2,1
KR_6709825274,420,2,-1,34,4,1,2,1,-2,3,5,7,8,1,-2,2,4,0,0,0,0,6,-2,2,7,9,-3,0,1,1,1,1,-1,2,1
KR_6777258016,420,3,8,0,7,4,5,1,10,11,1,0,1,1,-1,4,5,-6,1,7,0,9,-40,0,6,6,16,0,1,0,-1,-1,-1,0,1
KR_6770435982,420,1,30,-13,2,-4,1,5,2,2,0,2,5,3,2,4,2,0,0,0,0,10,7,3,5,8,-3,0,0,1,-1,0,-1,6,1
KR_6772221035,440,1,-36,5,2,3,3,0,-2,4,6,-2,2,4,0,6,6,3,4,1,1,0,-5,2,4,6,-1,0,0,1,1,-1,1,4,1
KR_6730650667,420,2,19,17,10,2,3,1,1,3,2,1,3,2,2,5,3,4,5,1,1,15,56,6,3,9,2,0,2,1,1,1,1,1,1
KR_6735624828,420,3,18,11,8,3,3,0,2,2,0,4,4,0,-2,0,2,1,1,0,2,10,6,0,6,6,3,0,3,1,1,1,1,5,1
KR_6770616724,420,3,45,19,5,1,3,2,5,6,1,1,3,2,-1,2,3,-1,1,2,0,4,-4,-6,8,2,0,0,1,-1,1,-1,1,2,1
KR_6741861816,420,-2,-29,-10,-6,0,3,3,-4,6,10,-5,0,5,2,3,1,1,1,0,0,-10,1,-1,8,7,-6,0,1,-1,-1,1,1,1,1
KR_6777176958,420,5,38,12,11,4,5,1,0,4,4,2,3,1,4,5,1,1,2,1,0,8,-34,-1,7,6,9,0,4,-1,1,1,-1,1,1
KR_6760722971,420,4,63,12,3,0,2,2,1,5,4,1,1,0,0,2,2,1,2,1,0,3,-10,-2,8,6,4,0,2,1,1,1,1,5,1
KR_6777040836,420,2,27,24,6,2,2,0,2,2,0,1,3,2,2,4,2,-1,1,2,0,6,1,0,6,6,3,0,0,1,-1,1,1,5,1
KR_6771364895,420,4,14,-15,14,11,11,0,2,5,3,0,1,1,1,1,0,0,0,0,0,20,-8,0,4,4,6,0,1,1,1,1,-1,5,1
KR_6766364754,420,-2,13,-19,-3,0,2,2,0,1,1,0,2,2,-3,1,4,0,1,1,0,2,0,-3,7,4,-2,0,-1,-1,-1,-1,1,1,1
KR_6769528549,420,2,12,0,6,3,4,1,4,4,0,2,5,3,-4,2,6,1,2,1,0,-7,-4,1,7,8,1,0,1,1,1,1,1,4,1
KR_6733368540,440,4,156,24,6,7,8,1,1,6,5,3,4,1,-5,1,6,0,1,1,0,4,-7,-4,8,4,8,0,3,1,1,1,1,6,1
KR_6770311292,420,3,-25,22,7,0,1,1,3,7,4,-2,1,3,1,1,0,5,5,0,0,3,8,8,2,10,-11,0,1,-1,-1,1,-1,4,1
KR_6729677994,420,3,45,7,6,5,5,0,4,5,1,3,6,3,-5,0,5,-1,1,2,2,1,-1,-2,7,5,0,0,1,-1,-1,1,1,6,1
KR_6777799377,420,5,48,28,9,1,7,6,6,7,1,1,2,1,1,3,2,0,1,1,0,9,13,6,3,9,-1,0,1,1,1,1,1,2,1
KR_6775822521,420,8,45,59,17,2,3,1,8,8,0,1,3,2,5,7,2,1,2,1,-1,17,-15,1,3,4,5,0,1,1,1,1,-1,2,1
KR_6742309604,420,-6,-48,-4,-2,-2,3,5,0,1,1,-1,3,4,0,1,1,1,2,1,1,4,7,-3,6,3,-2,0,0,1,-1,-1,1,3,1
KR_6754207306,420,0,-9,4,3,0,2,2,-1,3,4,1,2,1,3,7,4,0,1,1,0,0,10,3,8,11,-1,0,1,1,-1,1,1,3,1
KR_6777898251,420,5,103,-1,20,7,9,2,6,6,0,1,2,1,3,4,1,3,3,0,3,13,170,8,2,10,-1,0,2,1,1,1,1,5,1
KR_6771958631,420,2,8,4,1,2,2,0,0,2,2,0,2,2,-1,2,3,0,1,1,-1,-3,-2,-2,4,2,0,0,1,-1,1,1,-1,1,1
KR_6777047267,420,5,62,33,5,4,5,1,1,2,1,1,2,1,-1,0,1,0,0,0,0,1,-43,-5,7,2,6,0,2,1,1,1,1,2,1
KR_6777167994,420,0,6,12,5,1,3,2,3,5,2,-1,2,3,2,4,2,0,1,1,1,10,10,8,7,15,-1,0,0,1,1,0,1,4,1
KR_6744035763,440,4,-19,-5,13,-4,1,5,2,3,1,4,7,3,6,6,0,5,7,2,0,14,1,-5,6,1,0,0,0,-1,1,-1,1,6,1
KR_6734009513,420,-1,15,-21,-1,1,2,1,-1,2,3,-3,1,4,5,5,0,-3,0,3,0,5,8,-3,7,4,2,0,-2,1,-1,-1,1,4,1
KR_6685071115,420,1,78,-22,6,0,1,1,2,5,3,3,6,3,1,4,3,0,1,1,1,8,-1,-2,8,6,3,0,1,-1,1,1,1,4,1
KR_6742011563,420,1,47,16,3,1,2,1,2,5,3,1,1,0,-1,2,3,0,1,1,0,-2,-22,1,5,6,-4,0,0,1,-1,0,1,1,1
KR_6774110383,420,1,56,-21,4,0,1,1,-4,0,4,3,4,1,6,7,1,-1,0,1,0,7,15,6,6,12,1,0,0,1,-1,1,1,5,1
KR_6775370653,420,4,-8,12,9,2,2,0,5,8,3,1,3,2,2,4,2,-1,0,1,0,12,10,2,9,11,-4,0,1,1,1,1,-1,2,1
KR_6777707237,420,0,-16,20,8,-2,0,2,3,6,3,4,6,2,4,6,2,-1,0,1,0,8,4,1,5,6,-4,0,1,1,1,-1,-1,6,1
KR_6759057574,420,-2,-44,0,4,-1,2,3,0,1,1,2,3,1,3,3,0,0,1,1,1,17,-1,4,4,8,3,0,0,-1,1,-1,1,2,1
KR_6736721579,420,-1,-30,26,0,-2,0,2,-2,4,6,5,5,0,1,3,2,-2,1,3,1,3,-3,-2,8,6,28,0,-1,1,1,-1,1,3,1
KR_6742868291,420,2,28,-10,5,-1,1,2,6,7,1,-2,3,5,4,6,2,-2,1,3,0,9,0,2,9,11,-1,0,0,1,-1,1,1,5,1
KR_6734246585,420,0,25,-13,9,-3,0,3,-2,2,4,4,7,3,4,4,0,6,6,0,1,13,14,3,4,7,4,0,1,1,0,1,1,4,1
KR_6699168143,420,3,4,3,14,2,6,4,2,3,1,5,5,0,2,3,1,3,3,0,1,10,12,8,2,10,-3,0,3,1,1,1,1,2,1
KR_6741836176,440,0,-8,32,2,2,4,2,-4,1,5,-5,0,5,5,7,2,4,5,1,2,1,8,1,9,10,-1,0,2,1,1,1,1,6,1
KR_6776419120,420,1,16,27,5,-1,2,3,2,4,2,2,3,1,2,7,5,0,0,0,-1,4,-28,2,6,8,-1,0,0,1,-1,1,-1,3,1
KR_6727733941,420,2,25,-7,2,-3,1,4,1,1,0,0,4,4,2,3,1,2,2,0,0,9,-62,1,7,8,33,0,0,1,-1,-1,-1,5,1
KR_6766224015,440,1,18,-30,-2,-1,1,2,-1,5,6,3,4,1,-1,7,8,-2,0,2,1,-8,-14,5,3,8,-5,0,1,1,1,1,1,2,1
KR_6764881648,420,2,74,8,-2,2,5,3,-1,1,2,-1,3,4,-3,1,4,1,1,0,0,-8,10,-2,6,4,0,0,1,-1,1,-1,-1,5,1
KR_6731010479,420,1,-14,-30,-1,-1,0,1,-4,0,4,6,6,0,-1,0,1,-1,0,1,1,-3,3,-2,8,6,-4,0,0,-1,1,0,1,4,1
KR_6741530152,420,0,23,13,-4,1,1,0,-1,1,2,0,1,1,-3,3,6,-1,0,1,0,-5,0,-1,12,11,4,0,-1,1,-1,-1,1,5,1
KR_6775726027,420,2,3,-3,2,1,3,2,2,3,1,3,3,0,-3,4,7,-1,0,1,-1,9,13,5,2,7,2,0,0,-1,1,0,-1,6,1
KR_6769860553,420,2,-2,8,7,3,3,0,-1,5,6,2,3,1,1,5,4,2,2,0,0,4,6,0,7,7,-1,0,1,1,-1,1,1,4,1
KR_6737415643,420,4,13,-5,11,1,1,0,1,5,4,3,5,2,2,4,2,4,4,0,-1,14,0,2,3,5,-3,0,0,1,-1,-1,-1,4,1
KR_6735278020,420,3,-32,31,3,-4,0,4,2,3,1,0,1,1,5,7,2,0,0,0,0,3,-5,-6,10,4,4,0,0,1,-1,-1,-1,2,1
KR_6758442660,420,1,5,9,4,2,2,0,-2,2,4,7,8,1,1,3,2,-4,0,4,0,1,19,-4,8,4,3,0,1,-1,1,1,1,1,1
KR_6756980139,420,1,0,49,-4,4,4,0,0,2,2,-5,1,6,-3,1,4,0,0,0,1,-11,158,-4,8,4,-1,0,0,1,1,0,1,2,1
KR_6777849107,420,5,36,48,12,1,2,1,4,6,2,5,6,1,2,5,3,0,0,0,0,20,18,2,6,8,-10,0,1,1,-1,1,-1,3,1
KR_6773776988,420,5,49,26,3,0,2,2,3,7,4,-2,3,5,1,3,2,1,1,0,0,10,-5,-3,10,7,1,0,1,-1,1,1,1,1,1
KR_6775329559,420,2,56,12,1,-1,1,2,2,3,1,3,5,2,-3,0,3,0,1,1,0,4,4,-5,8,3,0,0,0,1,1,-1,1,3,1
KR_6777240637,420,11,98,53,26,3,4,1,3,4,1,12,13,1,7,9,2,1,2,1,1,19,17,1,5,6,-4,1,6,1,1,1,1,3,1
KR_6777219431,440,3,73,38,2,5,5,0,0,2,2,2,3,1,-5,0,5,0,0,0,2,-10,2,-1,7,6,0,0,2,1,1,1,1,3,1
KR_6756006653,420,0,-10,-20,1,-2,0,2,1,2,1,3,4,1,-1,0,1,0,0,0,0,3,-102,1,2,3,0,0,-2,-1,-1,-1,1,1,1
KR_6753661453,420,1,-1,15,5,2,3,1,2,2,0,4,5,1,0,2,2,-3,0,3,0,14,2,-1,5,4,-1,0,0,1,1,0,-1,2,1
KR_6746045100,420,5,75,4,8,2,3,1,-3,2,5,0,4,4,10,12,2,-1,2,3,0,4,4,-3,6,3,-1,0,2,0,-1,1,-1,0,1
KR_6712405856,420,3,24,40,4,2,4,2,0,2,2,2,2,0,0,1,1,0,0,0,-1,11,18,2,7,9,3,0,2,1,1,1,-1,1,1
KR_6760016600,440,4,20,14,8,0,1,1,4,7,3,3,4,1,1,2,1,0,0,0,0,11,1,2,5,7,-2,0,0,1,1,0,-1,4,1
KR_6766512019,420,-1,14,28,0,-2,1,3,0,3,3,-1,2,3,1,4,3,2,3,1,1,2,-26,8,3,11,7,0,1,1,-1,1,1,2,1
KR_6775094382,420,2,34,-22,7,0,1,1,2,4,2,4,5,1,4,6,2,-3,0,3,-1,3,8,2,5,7,2,0,0,1,-1,-1,-1,3,1
KR_6720977666,420,3,11,23,11,2,3,1,9,10,1,-3,2,5,1,8,7,2,2,0,-1,2,-20,4,3,7,-9,0,0,0,1,1,-1,0,1
KR_6769842715,420,2,-32,24,2,1,2,1,2,2,0,1,3,2,-2,2,4,0,1,1,-1,-4,-17,3,3,6,0,0,0,1,1,1,-1,1,1
KR_6769439298,420,8,79,49,12,3,3,0,0,8,8,5,6,1,5,7,2,-1,0,1,1,11,-8,2,7,9,4,0,1,1,-1,1,1,2,1
KR_6774459029,420,2,15,4,6,0,0,0,0,2,2,2,5,3,2,3,1,2,2,0,0,9,-3,0,4,4,-1,0,1,1,1,1,-1,4,1
KR_6772068904,420,4,-25,-15,9,0,4,4,3,4,1,1,2,1,6,6,0,-1,0,1,1,29,38,-2,7,5,-2,0,0,-1,-1,1,1,1,1
KR_6766704875,420,-1,2,5,-1,-4,1,5,-1,6,7,1,2,1,1,2,1,2,3,1,0,1,1,0,7,7,-3,0,1,1,-1,1,-1,4,1
KR_6742542601,420,3,-33,-26,10,2,3,1,2,4,2,4,7,3,1,3,2,1,1,0,-2,9,9,2,7,9,-2,0,1,1,-1,1,-1,6,1
KR_6774138615,420,0,-10,8,0,-2,0,2,-4,0,4,1,3,2,3,5,2,2,2,0,0,9,-17,3,6,9,2,0,0,1,1,1,-1,5,1
KR_6774748217,420,4,12,-12,15,-2,0,2,9,10,1,5,8,3,2,6,4,1,3,2,-1,19,2,3,6,9,3,0,3,1,1,1,-1,1,1
KR_6767610786,420,0,-38,-12,7,-2,2,4,3,3,0,5,5,0,-1,1,2,2,3,1,0,14,-2,-1,6,5,0,0,1,1,1,1,1,2,1
KR_6775983693,420,-4,-87,-13,-2,0,2,2,-1,3,4,-2,1,3,-2,2,4,3,3,0,-1,2,23,4,2,6,-4,0,0,-1,1,0,-1,4,1
KR_6764426119,420,-1,-25,8,0,4,4,0,0,5,5,-1,2,3,-5,2,7,2,2,0,0,-8,-2,4,5,9,2,0,0,-1,1,-1,1,3,1
KR_6771345172,420,5,31,-3,8,2,2,0,3,4,1,3,4,1,0,3,3,0,0,0,0,14,5,3,3,6,-5,0,0,-1,1,1,-1,3,1
KR_6714018655,420,2,7,3,10,-3,0,3,3,5,2,5,6,1,4,4,0,1,3,2,0,13,6,-1,9,8,4,0,2,1,-1,1,-1,2,1
KR_6772593570,440,3,43,20,4,2,4,2,0,1,1,3,6,3,2,3,1,-3,1,4,1,4,-5,-1,5,4,4,0,2,0,1,1,1,0,1
KR_6769724660,420,-3,0,16,-2,-1,3,4,0,3,3,-3,1,4,0,1,1,2,2,0,0,4,11,-1,7,6,5,0,1,1,-1,1,-1,1,1
KR_6772623271,420,0,14,19,2,0,1,1,1,3,2,4,4,0,-2,1,3,-1,1,2,0,-6,3,1,7,8,2,0,-1,1,-1,-1,1,6,1
KR_6709630806,420,6,71,-28,12,2,5,3,5,8,3,5,7,2,0,0,0,0,1,1,0,20,6,0,6,6,0,0,3,0,1,1,1,0,1
KR_6747853643,420,5,56,23,10,3,4,1,-1,1,2,2,2,0,8,8,0,-2,0,2,0,16,0,2,2,4,3,0,2,1,-1,1,1,2,1
KR_6775574407,420,-1,14,-51,1,0,3,3,-1,4,5,-2,1,3,2,2,0,2,2,0,0,-4,-6,0,5,5,2,0,0,1,-1,-1,-1,2,1
KR_6775447848,420,-1,-55,14,1,0,0,0,-2,0,2,1,2,1,1,1,0,1,1,0,0,1,8,-1,8,7,-6,0,1,1,1,1,1,1,1
KR_6710644678,420,0,-7,16,4,0,2,2,-4,2,6,8,9,1,3,3,0,-3,0,3,0,-7,9,-3,8,5,-3,0,-1,1,-1,-1,-1,2,1
KR_6743631599,420,2,27,-2,3,1,2,1,2,2,0,-2,3,5,2,5,3,0,2,2,0,11,-3,-3,6,3,5,0,0,1,0,0,-1,3,1
KR_6748213246,420,0,12,0,-3,-1,2,3,0,4,4,0,3,3,-2,6,8,0,3,3,-1,1,-10,-3,7,4,2,0,-1,1,-1,-1,-1,2,1
KR_6769622261,420,3,22,8,3,5,6,1,-3,1,4,-1,0,1,-1,0,1,3,3,0,0,1,-10,4,3,7,1,0,0,1,1,1,-1,6,1
KR_6768826266,420,3,37,16,3,1,2,1,1,5,4,-2,1,3,4,9,5,-1,0,1,0,-4,4,2,7,9,-2,0,0,-1,1,0,-1,6,1
KR_6776281435,420,1,67,1,4,3,7,4,0,3,3,-4,2,6,5,9,4,0,0,0,0,-7,-10,-4,8,4,4,0,3,1,1,1,1,3,1
KR_6775094883,420,5,84,20,6,-1,1,2,0,2,2,5,6,1,2,3,1,0,0,0,1,6,2,1,4,5,-1,0,1,1,1,1,1,1,1
KR_6769048626,420,5,111,11,13,3,3,0,5,6,1,2,3,1,2,2,0,1,2,1,0,13,-194,1,5,6,0,0,1,1,1,1,1,5,1
KR_6776626903,420,7,84,13,12,5,5,0,3,6,3,3,4,1,2,4,2,-1,1,2,0,7,2,4,7,11,-2,0,3,-1,1,1,1,4,1
KR_6766552264,420,1,15,-17,2,-1,0,1,0,2,2,3,3,0,0,0,0,0,0,0,0,4,30,0,3,3,-4,0,-2,-1,1,-1,-1,6,1
KR_6763282190,420,6,103,17,11,4,4,0,2,5,3,6,6,0,-1,0,1,0,1,1,0,7,7,4,2,6,2,0,3,1,-1,1,-1,3,1
KR_6774091420,440,4,41,4,9,1,2,1,-1,5,6,3,3,0,1,2,1,5,5,0,0,7,-6,-1,3,2,7,0,0,1,-1,1,1,3,1
KR_6775909506,420,2,35,18,10,3,3,0,3,4,1,4,5,1,1,1,0,-1,0,1,0,12,14,8,2,10,-1,0,1,-1,1,1,1,6,1
KR_6746339806,420,0,21,35,-1,-4,0,4,0,3,3,2,4,2,0,2,2,1,1,0,0,-1,0,-3,10,7,7,0,-1,1,-1,-1,1,5,1
KR_6768229371,420,-3,-61,-21,-5,3,3,0,1,2,1,0,0,0,-11,1,12,2,2,0,-1,-10,3,-5,12,7,-5,0,0,-1,1,-1,-1,1,1
KR_6730037523,420,5,21,36,12,6,6,0,5,6,1,-4,1,5,4,5,1,1,1,0,-1,14,-13,2,5,7,11,0,1,1,-1,1,-1,6,1
KR_6777863088,420,0,-1,4,3,1,2,1,-1,5,6,-2,1,3,1,2,1,4,4,0,0,3,17,-6,8,2,4,0,0,1,-1,-1,-1,6,1
KR_6710204166,420,4,73,-20,9,2,3,1,2,4,2,-3,0,3,6,7,1,2,2,0,0,14,9,7,3,10,-5,0,2,1,-1,1,-1,1,1
KR_6768430461,420,1,-19,44,-4,-3,1,4,3,9,6,-3,2,5,0,5,5,-1,0,1,-6,-14,20,-2,8,6,-5,0,-2,-1,-1,-1,-1,4,1
KR_6771283391,420,1,-18,13,8,3,3,0,5,6,1,0,0,0,0,1,1,0,0,0,1,7,-3,0,4,4,5,0,0,1,1,-1,1,6,1
KR_6773818941,420,-2,-35,11,-4,1,2,1,0,3,3,-3,1,4,-2,2,4,0,0,0,0,-4,-3,-2,10,8,-3,0,-1,-1,1,-1,1,4,1
KR_6731571058,440,1,45,12,5,0,1,1,-1,5,6,2,2,0,-2,2,4,6,7,1,0,8,-36,-3,6,3,26,0,2,-1,1,1,-1,1,1
KR_6740290920,420,-2,-42,5,1,1,4,3,0,0,0,4,6,2,-1,4,5,-3,0,3,0,-5,1,3,5,8,1,0,0,1,-1,-1,-1,6,1
KR_6734067914,420,0,-16,-32,2,0,0,0,2,4,2,-1,1,2,2,7,5,-1,0,1,0,-1,-3,-3,8,5,4,0,1,-1,1,1,-1,1,1
KR_6774928504,420,4,54,14,7,0,0,0,1,4,3,2,2,0,1,5,4,3,3,0,0,6,44,2,5,7,-2,0,1,1,1,1,1,4,1
KR_6777114304,420,5,36,36,17,2,2,0,11,12,1,3,3,0,2,2,0,-1,1,2,0,15,18,9,4,13,-8,0,2,1,1,1,1,5,1
KR_6776504348,420,-2,57,3,0,6,6,0,-2,0,2,-2,2,4,-2,1,3,0,2,2,0,0,-42,-1,6,5,4,0,0,1,1,-1,1,1,1
KR_6775500329,420,2,75,31,4,4,7,3,2,3,1,-1,5,6,0,4,4,-1,0,1,0,-8,23,-2,7,5,2,0,0,1,-1,1,1,6,1
KR_6724190943,420,0,24,-14,0,-1,0,1,0,3,3,0,2,2,2,3,1,-1,0,1,0,1,121,5,4,9,1,0,0,-1,-1,-1,-1,4,1
KR_6736517961,420,4,8,21,5,4,4,0,1,4,3,1,2,1,1,3,2,-2,0,2,-1,3,81,4,6,10,4,0,2,1,-1,1,-1,3,1
KR_6771906185,440,1,-23,23,4,-4,1,5,3,5,2,2,3,1,9,10,1,-6,0,6,0,11,26,4,2,6,-3,0,-2,-1,-1,-1,-1,2,1
KR_6772482455,420,2,21,-24,8,3,4,1,3,5,2,-2,1,3,3,4,1,1,1,0,0,15,13,6,6,12,0,0,0,1,1,0,1,3,1
KR_6773628053,420,4,11,20,13,2,3,1,7,7,0,2,2,0,1,1,0,1,3,2,0,16,48,6,3,9,0,0,1,1,1,1,1,4,1
KR_6735382228,420,2,-9,0,10,3,4,1,1,2,1,4,7,3,2,3,1,0,2,2,1,14,-25,3,9,12,2,0,1,1,1,1,-1,4,1
KR_6770871751,420,6,55,55,8,1,1,0,3,8,5,2,3,1,1,2,1,1,1,0,0,4,-10,2,4,6,-2,0,2,1,1,1,-1,1,1
KR_6736440967,420,6,113,34,15,5,5,0,3,4,1,5,6,1,-1,3,4,3,5,2,0,11,-4,-1,7,6,10,0,3,-1,1,1,-1,1,1
KR_6777772728,420,3,25,20,8,-1,3,4,1,4,3,5,5,0,1,4,3,2,2,0,3,8,301,9,0,9,-5,0,1,1,-1,-1,1,3,1
KR_6753882433,440,0,18,-5,-2,2,4,2,-1,1,2,2,2,0,-1,1,2,-4,0,4,0,-5,-34,-1,6,5,1,0,0,1,-1,1,1,1,1
KR_6733325584,420,2,8,-1,4,0,1,1,-2,1,3,2,2,0,1,2,1,3,4,1,0,7,-1,-5,9,4,6,0,0,1,-1,0,1,6,1
KR_6776403878,420,0,-71,-6,1,5,5,0,0,3,3,0,1,1,-4,0,4,0,0,0,0,-5,14,-1,8,7,-5,0,-3,-1,1,-1,1,5,1
KR_6737141215,420,3,3,46,0,4,4,0,3,4,1,-2,2,4,-5,1,6,0,0,0,0,-7,33,2,6,8,-1,0,3,-1,1,1,-1,5,1
KR_6768518892,420,2,53,27,6,8,10,2,-4,3,7,0,2,2,3,4,1,-1,1,2,0,-1,323,0,8,8,3,0,1,1,1,1,-1,4,1
KR_6766087517,440,-1,-45,42,-7,-8,2,10,2,6,4,0,2,2,-2,0,2,1,1,0,0,-16,-15,-3,6,3,4,0,-1,1,1,-1,-1,5,1
KR_6775527251,420,8,51,34,18,4,4,0,3,5,2,10,12,2,1,3,2,0,1,1,0,28,2,-1,7,6,2,0,0,1,-1,0,1,1,1
KR_6769444241,420,2,69,24,5,-4,0,4,5,7,2,1,2,1,3,5,2,0,0,0,0,9,9,4,7,11,4,0,2,1,1,1,1,1,1
KR_6756521845,420,4,26,57,-2,-3,1,4,5,5,0,1,2,1,-5,3,8,0,1,1,0,-3,-4,-4,8,4,5,0,1,-1,1,1,1,4,1
KR_6771840477,420,2,72,-3,-1,0,1,1,0,0,0,0,2,2,0,3,3,-1,1,2,0,-6,-14,-3,8,5,-7,0,0,1,-1,-1,1,2,1
KR_6776849455,420,-1,76,-8,-5,2,2,0,-8,0,8,-1,2,3,2,4,2,0,3,3,1,-5,-8,-6,12,6,11,0,1,-1,-1,1,1,1,1
KR_6729134717,420,1,17,-5,2,4,4,0,0,5,5,3,4,1,-3,0,3,-2,0,2,0,-2,35,0,6,6,-6,0,0,-1,1,1,1,5,1
KR_6708055673,420,-4,-65,-12,-5,1,2,1,0,2,2,-4,0,4,-1,3,4,-1,0,1,0,-8,-7,-2,5,3,1,0,-2,1,1,-1,1,6,1
KR_6770633887,420,1,17,31,-7,4,6,2,-4,1,5,-5,0,5,-2,4,6,0,2,2,-2,-12,-5,2,4,6,-3,0,1,-1,1,1,-1,5,1
KR_6766029380,420,3,48,20,8,-1,1,2,6,7,1,1,3,2,-1,0,1,3,3,0,0,9,149,1,5,6,8,0,3,1,1,1,1,4,1
KR_6766008572,420,-2,26,7,-4,-1,1,2,-7,0,7,1,2,1,3,4,1,0,1,1,0,-5,-1,-4,6,2,2,0,0,1,-1,1,1,4,1
KR_6777870401,420,2,40,-4,1,1,1,0,0,1,1,-2,2,4,0,4,4,2,2,0,0,0,-8,1,9,10,8,0,1,1,-1,1,1,1,1
KR_6724511329,420,-1,-7,-1,2,0,1,1,1,3,2,-1,2,3,1,4,3,1,2,1,0,10,-5,-3,9,6,2,0,0,-1,-1,-1,1,1,1
KR_6773065126,420,4,62,-10,17,2,4,2,6,6,0,1,3,2,6,6,0,2,3,1,0,25,14,10,0,10,-1,0,2,1,1,1,1,1,1
KR_6735822230,420,2,-12,12,11,4,4,0,5,5,0,1,1,0,1,3,2,0,1,1,0,13,-2,-2,9,7,6,0,0,1,-1,1,1,3,1
KR_6751508879,420,3,22,-23,11,-1,3,4,2,6,4,3,6,3,6,7,1,1,1,0,2,22,12,7,4,11,-4,0,0,1,-1,-1,1,4,1
KR_6711704742,420,4,29,27,14,2,5,3,4,9,5,3,5,2,5,7,2,0,1,1,0,13,36,5,2,7,-7,0,2,1,1,1,1,6,1
KR_6746183860,420,-1,38,23,7,-1,4,5,3,6,3,1,2,1,6,11,5,-2,3,5,3,9,-3,-4,10,6,8,0,0,1,1,1,1,6,1
KR_6766847755,420,-1,49,10,4,1,1,0,-2,1,3,5,8,3,0,1,1,0,1,1,0,-5,16,9,1,10,-1,0,0,-1,1,0,1,5,1
KR_6739480272,440,-1,-9,8,-6,0,3,3,-8,0,8,7,7,0,-4,1,5,-1,0,1,0,-11,3,-5,7,2,-3,0,-1,-1,0,-1,1,3,1
KR_6754733816,420,4,64,8,2,-1,0,1,1,2,1,1,3,2,1,1,0,0,0,0,0,4,-1,8,3,11,0,0,1,1,1,1,-1,4,1
KR_6749104686,420,0,52,8,0,3,4,1,-5,2,7,-3,0,3,3,7,4,2,2,0,1,-6,8,2,4,6,-1,0,1,1,1,1,1,3,1
KR_6773565913,420,-2,15,-10,-7,-5,2,7,0,6,6,3,4,1,-1,1,2,-4,0,4,-3,-6,-34,-3,7,4,-3,0,-1,-1,-1,-1,-1,2,1
KR_6762382056,420,3,16,-12,3,4,4,0,-2,3,5,0,3,3,-2,0,2,3,4,1,0,9,-1,0,6,6,1,0,-1,-1,-1,-1,-1,1,1
KR_6744451845,420,2,30,18,0,-1,0,1,0,4,4,-3,1,4,1,2,1,3,5,2,0,-6,-27,-3,11,8,-2,0,0,-1,-1,1,-1,5,1
KR_6776123367,440,1,8,20,4,3,4,1,2,2,0,2,2,0,-3,0,3,0,0,0,0,9,34,-1,7,6,5,0,0,1,-1,0,-1,6,1
KR_6751016176,440,4,47,36,9,3,3,0,1,5,4,1,1,0,0,1,1,4,5,1,0,4,-51,3,8,11,33,0,1,1,1,1,1,4,1
KR_6776959926,420,2,37,20,-3,3,3,0,2,2,0,-1,2,3,-6,1,7,-1,0,1,0,-7,3,0,6,6,-1,0,0,-1,1,1,-1,1,1
KR_6776314791,420,5,91,37,12,1,2,1,7,7,0,2,3,1,-1,2,3,3,4,1,1,9,19,5,3,8,1,0,1,1,-1,1,1,1,1
KR_6750117710,420,4,27,0,10,4,4,0,4,5,1,0,0,0,1,4,3,1,2,1,0,11,14,5,5,10,-3,0,1,-1,1,1,-1,1,1
KR_6771825596,420,-1,-1,-41,0,-2,1,3,6,7,1,-2,1,3,-1,1,2,-1,1,2,0,1,-2,-5,8,3,-3,0,1,-1,1,1,1,4,1
KR_6774947121,420,2,22,19,13,3,5,2,-1,2,3,0,2,2,11,12,1,0,1,1,1,16,9,-1,7,6,1,0,2,1,0,1,1,3,1
KR_6743294318,420,6,43,32,13,9,10,1,8,9,1,-1,3,4,-3,0,3,0,0,0,1,5,35,-4,10,6,8,0,4,1,1,1,1,6,1
KR_6777731849,440,0,-13,41,-2,-2,0,2,-5,0,5,3,4,1,1,2,1,1,3,2,0,-2,0,-1,8,7,-3,0,0,1,1,0,1,3,1
KR_6735923718,420,2,77,12,3,3,6,3,0,2,2,1,1,0,-1,3,4,0,0,0,0,1,-15,1,6,7,8,0,0,1,-1,-1,1,5,1
KR_6722298236,420,8,103,14,17,4,4,0,3,4,1,2,2,0,8,9,1,0,0,0,0,11,49,3,4,7,-22,0,3,1,1,1,1,3,1
KR_6741593352,420,4,14,-4,10,7,7,0,0,1,1,0,3,3,1,2,1,2,2,0,0,12,2,1,2,3,8,0,1,1,1,1,1,5,1
KR_6762848010,440,4,61,11,7,5,7,2,1,1,0,0,1,1,-1,1,2,2,2,0,0,6,22,0,3,3,-4,0,1,1,1,1,1,3,1
KR_6755756511,440,6,-25,24,11,1,3,2,4,5,1,-2,1,3,8,11,3,0,2,2,2,16,15,3,4,7,-3,0,-1,1,1,-1,1,4,1
KR_6774204618,420,-1,0,32,0,-2,0,2,-2,1,3,4,5,1,0,0,0,0,0,0,0,2,-31,2,3,5,13,0,-1,1,0,-1,1,2,1
KR_6737928045,420,3,-10,0,7,6,6,0,1,6,5,1,1,0,-1,2,3,0,0,0,0,5,-5,1,7,8,11,0,0,1,1,0,1,2,1
KR_6729797775,420,1,49,-28,0,2,4,2,-1,2,3,-4,2,6,1,2,1,2,6,4,0,-3,5,-3,11,8,2,0,0,-1,1,0,-1,3,1
KR_6734910257,420,4,91,-35,7,3,4,1,0,2,2,1,3,2,3,5,2,0,2,2,0,10,-2,0,4,4,-2,0,1,1,-1,1,1,5,1
KR_6770312212,420,3,32,9,8,0,0,0,1,2,1,3,5,2,2,4,2,2,2,0,1,17,-6,-4,10,6,4,0,0,1,-1,0,1,2,1
KR_6740636948,420,0,31,17,-2,0,3,3,5,8,3,0,2,2,-8,1,9,1,2,1,-3,-8,8,3,4,7,-1,0,0,-1,1,0,-1,2,1
KR_6776277317,420,3,20,26,7,-2,0,2,4,4,0,1,4,3,4,6,2,0,0,0,1,14,-4,0,6,6,2,0,0,-1,1,1,1,6,1
KR_6773495156,420,2,6,40,6,1,2,1,3,4,1,1,2,1,-1,1,2,2,2,0,0,5,40,0,7,7,-6,0,0,1,-1,0,1,6,1
KR_6746723454,420,4,75,15,6,3,3,0,3,4,1,4,6,2,-2,2,4,-2,1,3,0,-3,60,-2,8,6,-17,0,3,1,1,1,1,2,1
KR_6772206056,440,2,-37,20,1,-7,1,8,-2,1,3,5,6,1,3,5,2,2,3,1,0,9,8,3,1,4,1,0,-1,0,0,-1,1,0,1
KR_6724607920,420,2,39,7,1,4,5,1,1,2,1,-1,1,2,-3,2,5,0,1,1,0,2,23,0,8,8,6,0,1,-1,1,1,-1,5,1
KR_6776800215,420,3,54,13,18,8,9,1,3,4,1,1,1,0,3,5,2,3,3,0,1,16,15,6,2,8,-4,0,2,-1,1,1,1,2,1
KR_6706883879,420,-1,-6,-36,0,0,1,1,3,3,0,-2,1,3,0,4,4,-1,0,1,0,6,-6,-1,6,5,7,0,2,-1,1,1,1,5,1
KR_6772381576,420,2,-33,-49,8,-1,0,1,1,5,4,9,10,1,-1,2,3,0,0,0,0,8,-17,3,6,9,1,0,1,-1,1,1,1,6,1
KR_6766995606,420,-3,14,-15,-4,-2,1,3,0,2,2,-4,0,4,1,3,2,1,2,1,1,0,-7,-2,8,6,2,0,1,1,-1,1,1,1,1
KR_6714078410,440,3,23,29,10,4,7,3,-2,1,3,7,9,2,0,1,1,1,4,3,1,13,3,2,5,7,-2,0,1,1,-1,1,1,2,1
KR_6777244272,420,4,-4,32,2,2,3,1,2,5,3,0,2,2,-3,1,4,1,1,0,0,8,-221,-3,7,4,-2,0,0,-1,-1,0,1,3,1
KR_6764167495,420,5,-17,33,10,-3,2,5,7,7,0,3,3,0,2,2,0,1,2,1,0,12,7,-3,9,6,-3,0,2,-1,1,1,1,1,1
KR_6773864874,420,0,-19,-23,2,3,4,1,-1,1,2,0,3,3,2,6,4,-2,0,2,0,1,-102,7,3,10,-4,0,-1,-1,-1,1,1,3,1
KR_6769624301,420,4,27,46,13,-1,0,1,-1,6,7,9,9,0,4,4,0,2,2,0,0,16,173,3,6,9,2,0,2,1,1,1,1,2,1
KR_6774215250,420,1,-8,20,2,0,2,2,0,3,3,-2,0,2,3,3,0,1,2,1,0,4,5,0,4,4,6,0,1,1,1,1,1,1,1
KR_6775940945,420,-3,10,39,-9,1,1,0,-6,2,8,-3,2,5,-1,5,6,0,0,0,0,-17,1,7,7,14,-3,0,0,1,1,0,-1,6,1
KR_6774831801,420,3,70,13,0,-3,2,5,0,2,2,3,5,2,1,3,2,-1,2,3,-1,-8,3,0,9,9,-1,0,0,1,1,1,-1,2,1
KR_6772175745,420,3,71,-1,8,0,1,1,2,3,1,2,2,0,4,4,0,0,0,0,0,9,-4,-2,7,5,5,0,1,1,-1,1,-1,3,1
KR_6709889111,420,1,2,-11,1,-1,1,2,5,8,3,-1,1,2,-1,4,5,-1,0,1,0,0,13,4,5,9,-5,0,0,0,1,0,-1,0,1
KR_6733964954,420,5,56,51,3,-1,2,3,2,4,2,2,6,4,0,1,1,0,1,1,0,3,-11,-5,5,0,9,0,2,1,-1,1,1,3,1
KR_6765513380,420,7,81,63,16,5,6,1,6,6,0,4,6,2,0,2,2,1,1,0,0,8,5,2,3,5,3,0,1,1,1,1,1,2,1
KR_6729104788,420,-2,-96,-12,-2,0,2,2,3,5,2,-1,2,3,0,1,1,-4,0,4,0,-1,68,-2,9,7,-3,0,-1,1,-1,-1,-1,2,1
KR_6735987575,420,-1,-86,-23,2,-3,1,4,0,0,0,0,3,3,6,7,1,-1,2,3,0,6,-5,0,5,5,0,0,-2,1,-1,-1,-1,1,1
KR_6757871224,420,3,-20,28,7,1,4,3,7,8,1,-2,0,2,1,5,4,0,0,0,-1,10,0,0,7,7,8,0,0,1,1,0,-1,2,1
KR_6735942722,420,0,-37,30,-3,-7,0,7,-3,1,4,3,5,2,2,4,2,2,2,0,0,1,8,6,2,8,-2,0,0,1,1,1,-1,6,1
KR_6745310463,420,0,-7,-27,6,-2,2,4,4,6,2,2,2,0,1,1,0,1,1,0,0,8,-7,1,6,7,0,0,1,-1,1,-1,1,2,1
KR_6724789562,420,9,115,43,22,1,1,0,5,7,2,5,5,0,4,6,2,7,9,2,1,33,32,4,3,7,2,0,1,1,-1,1,1,5,1
KR_6777125057,420,4,41,26,6,-2,1,3,-1,2,3,3,7,4,6,6,0,0,1,1,1,8,-4,0,8,8,0,0,0,1,-1,0,1,6,1
KR_6771745110,420,6,107,11,15,2,5,3,4,6,2,6,6,0,4,5,1,-1,1,2,0,7,-14,2,4,6,2,0,2,1,1,1,1,2,1
KR_6774996326,440,1,34,14,2,2,5,3,4,8,4,-3,0,3,3,6,3,-4,1,5,0,-6,2,3,4,7,1,0,1,0,1,1,1,0,1
KR_6769524110,420,3,34,16,3,-1,1,2,3,7,4,0,2,2,-1,2,3,2,2,0,1,8,-14,-3,10,7,0,0,0,1,-1,0,1,3,1
KR_6765986068,420,4,12,37,8,2,2,0,1,2,1,5,8,3,0,1,1,0,1,1,0,8,23,-3,8,5,1,0,1,-1,1,1,1,5,1
KR_6763384065,420,0,-46,8,1,1,3,2,-4,0,4,4,4,0,4,5,1,-4,2,6,0,11,8,8,1,9,-3,0,-1,-1,1,-1,-1,4,1
KR_6776658180,420,5,61,-3,6,-1,3,4,3,5,2,0,0,0,5,8,3,-1,0,1,1,9,-2,1,6,7,0,0,1,1,-1,1,1,4,1
KR_6777222572,420,5,72,30,8,-4,1,5,4,4,0,5,5,0,3,3,0,0,1,1,0,15,14,2,6,8,-4,0,3,1,1,1,-1,4,1
KR_6682423236,420,5,91,3,5,-1,1,2,-4,1,5,6,6,0,2,4,2,2,3,1,-1,7,-3,3,6,9,1,0,2,1,-1,1,-1,2,1
KR_6776050194,420,-2,32,7,-3,-1,1,2,-1,1,2,-1,2,3,-1,2,3,1,1,0,0,-5,2,-3,8,5,-1,0,0,1,1,0,-1,1,1
KR_6751563743,420,0,24,12,-2,4,5,1,-3,1,4,1,3,2,-5,2,7,1,1,0,4,-8,-12,-9,12,3,7,0,2,1,1,1,1,1,1
KR_6681499837,420,3,25,1,6,1,2,1,2,4,2,-1,4,5,4,5,1,0,1,1,0,20,7,3,4,7,2,0,2,1,-1,1,1,2,1
KR_6737926264,420,2,39,-6,4,-3,1,4,6,6,0,-3,0,3,3,4,1,1,2,1,0,6,-29,4,3,7,0,0,2,1,1,1,1,1,1
KR_6765757494,420,1,32,4,1,0,1,1,2,5,3,1,1,0,0,1,1,-2,0,2,0,-3,13,3,5,8,-4,0,-1,1,-1,-1,-1,2,1
KR_6771140621,440,1,-16,10,1,3,6,3,1,2,1,-1,2,3,-2,1,3,0,2,2,0,4,-7,4,3,7,-3,0,0,0,-1,0,-1,0,1
KR_6774990140,420,1,29,0,2,3,4,1,1,4,3,0,5,5,-3,2,5,1,1,0,0,-3,2,1,5,6,-1,0,-1,-1,1,1,-1,2,1
KR_6776646598,420,2,-18,0,0,-4,2,6,4,5,1,-1,0,1,2,3,1,-1,1,2,0,4,13,5,3,8,-6,0,1,-1,-1,1,-1,3,1
KR_6766508103,420,2,11,-35,1,1,3,2,2,4,2,0,2,2,-2,0,2,0,1,1,0,0,-30,-2,9,7,20,0,1,-1,1,1,-1,3,1
KR_6775595819,420,1,23,-30,9,6,7,1,-1,6,7,-2,1,3,5,7,2,1,1,0,0,3,1,6,3,9,-5,0,1,-1,1,1,1,6,1
KR_6745954337,420,-1,82,-8,0,-1,2,3,-8,0,8,0,1,1,7,10,3,2,3,1,0,-8,-44,-3,12,9,5,0,0,-1,1,1,1,6,1
KR_6728560805,420,2,9,-2,8,0,1,1,4,5,1,0,2,2,3,4,1,1,1,0,0,14,22,0,6,6,-1,0,1,1,1,1,1,3,1
KR_6766416378,420,-1,-4,-1,-1,-1,1,2,-1,1,2,-2,0,2,2,5,3,1,2,1,0,0,121,3,7,10,-3,0,0,1,-1,1,1,3,1
KR_6764460211,420,2,53,4,8,2,3,1,-1,3,4,1,3,2,0,1,1,6,6,0,3,11,-1,-2,5,3,4,0,0,1,-1,1,1,6,1
KR_6751830631,420,3,-33,28,5,-2,2,4,5,6,1,-1,2,3,5,5,0,-2,0,2,-2,2,23,0,7,7,-3,0,0,1,-1,-1,-1,6,1
KR_6766685322,420,1,11,8,-4,2,2,0,-1,3,4,1,1,0,-5,1,6,-1,0,1,0,-10,15,-2,10,8,-4,0,0,-1,1,1,-1,6,1
KR_6772226342,420,-2,-22,-13,1,-1,2,3,8,8,0,-4,0,4,-3,2,5,1,1,0,0,4,-9,0,6,6,0,0,-1,1,-1,-1,1,3,1
KR_6748909783,420,0,43,-7,3,0,1,1,0,3,3,1,3,2,0,5,5,2,2,0,0,7,17,-1,8,7,-6,0,0,-1,1,0,-1,6,1
KR_6702543353,420,7,95,22,20,2,2,0,1,5,4,6,6,0,12,13,1,-1,1,2,1,25,39,1,5,6,0,0,3,1,1,1,1,5,1
KR_6775895101,420,2,37,-22,7,9,9,0,-5,1,6,3,3,0,1,4,3,-1,0,1,1,3,4,0,5,5,-5,0,0,-1,1,-1,1,2,1
KR_6748310531,420,5,121,47,9,-2,2,4,3,3,0,4,4,0,4,4,0,0,0,0,0,6,-63,1,5,6,2,0,3,1,1,1,-1,2,1
KR_6774626860,420,0,-10,-3,-1,0,2,2,4,5,1,-5,1,6,0,2,2,0,0,0,0,2,1,1,7,8,-2,0,-1,1,1,-1,1,4,1
KR_6766190991,440,2,9,9,9,-7,0,7,-3,1,4,3,3,0,10,13,3,6,7,1,1,15,46,-1,4,3,0,0,2,0,-1,1,1,0,1
KR_6744305860,420,0,40,7,-4,1,3,2,-3,2,5,-1,1,2,-1,3,4,0,0,0,0,-5,-6,-1,9,8,5,0,1,-1,1,1,-1,2,1
KR_6771475481,440,-1,88,6,8,-3,1,4,8,9,1,0,2,2,3,8,5,0,1,1,1,6,3,-1,4,3,-2,0,2,0,0,1,1,0,1
KR_6766208663,420,0,64,11,5,-1,4,5,8,11,3,-4,2,6,4,6,2,-2,1,3,0,2,-32,4,4,8,3,0,2,-1,-1,1,-1,1,1
KR_6755820283,420,-2,-23,1,-1,2,2,0,-1,2,3,-3,0,3,2,3,1,-1,0,1,0,-2,-54,2,5,7,21,0,0,-1,1,0,1,3,1
KR_6777279888,420,1,13,-26,12,0,1,1,10,11,1,3,4,1,2,3,1,-3,1,4,0,12,-26,-2,8,6,-3,0,3,1,-1,1,1,5,1
KR_6770408657,420,-4,-65,9,-3,-1,1,2,-2,2,4,2,2,0,-6,1,7,4,5,1,0,-3,35,5,1,6,-5,0,-1,1,-1,-1,1,3,1
KR_6754226821,420,5,-8,14,14,4,4,0,6,8,2,4,5,1,1,2,1,-1,1,2,1,20,10,6,0,6,3,0,2,1,1,1,1,3,1
KR_6755180165,420,8,87,2,14,-3,1,4,7,9,2,3,3,0,7,8,1,0,1,1,0,23,42,-3,8,5,-1,0,5,1,1,1,-1,6,1
KR_6777743315,420,3,65,-17,1,-3,1,4,0,2,2,0,0,0,3,3,0,1,1,0,0,1,-5,-2,9,7,-2,0,1,1,-1,1,1,2,1
KR_6744220165,420,3,30,1,8,3,4,1,-1,2,3,0,3,3,5,7,2,1,2,1,0,9,6,3,7,10,-2,0,1,1,-1,1,-1,6,1
KR_6757481537,420,5,78,26,5,-3,1,4,4,5,1,1,3,2,3,6,3,0,2,2,0,9,30,-3,7,4,5,0,1,-1,1,1,1,4,1
KR_6736252852,420,-1,18,16,0,0,2,2,-3,2,5,1,2,1,-1,1,2,3,4,1,0,3,30,4,4,8,-4,0,0,1,-1,-1,1,1,1
KR_6750286482,420,8,26,30,10,-1,0,1,8,8,0,0,3,3,4,6,2,-1,1,2,0,20,12,-2,6,4,0,0,0,-1,1,1,1,2,1
KR_6736757325,420,3,74,40,9,4,5,1,2,4,2,-3,1,4,5,7,2,1,3,2,-1,2,-19,2,6,8,-9,0,2,-1,1,1,-1,3,1
KR_6774526011,420,1,26,-28,6,-3,2,5,2,3,1,3,3,0,4,4,0,0,0,0,0,11,-1,-1,5,4,1,0,1,1,-1,1,1,3,1
KR_6745306165,420,1,2,-22,10,5,6,1,1,3,2,6,10,4,-3,0,3,1,2,1,0,7,24,3,4,7,0,0,1,-1,1,1,1,1,1
KR_6770948847,420,5,-4,42,7,2,2,0,1,2,1,2,4,2,1,2,1,1,1,0,0,1,-10,-3,9,6,4,0,1,1,1,1,1,6,1
KR_6774561801,420,4,18,-10,4,-1,2,3,3,6,3,2,6,4,-2,3,5,2,2,0,0,7,3,4,7,11,-3,0,1,1,1,1,-1,5,1
KR_6776733330,420,4,78,21,12,1,3,2,3,3,0,0,3,3,8,8,0,0,1,1,0,12,0,2,2,4,1,0,2,1,-1,1,1,3,1
KR_6764724688,420,4,32,-32,17,5,8,3,-3,2,5,10,11,1,5,5,0,0,1,1,0,19,-16,11,1,12,1,0,0,-1,1,0,-1,2,1
KR_6766882780,420,6,81,19,11,9,9,0,-3,1,4,3,4,1,0,4,4,2,3,1,1,7,-31,4,6,10,-1,1,7,1,1,1,1,3,1
KR_6679278492,440,7,28,31,15,4,5,1,0,1,1,11,11,0,0,1,1,0,0,0,0,3,-4,0,5,5,0,0,3,1,1,1,1,5,1
KR_6759380155,440,1,5,4,5,1,4,3,1,4,3,-2,1,3,5,6,1,0,0,0,0,13,-8,3,4,7,4,0,0,1,1,0,-1,6,1
KR_6765604127,440,0,-14,-14,3,2,2,0,-2,0,2,-1,0,1,3,4,1,1,2,1,0,2,14,-1,6,5,-1,0,0,1,0,0,1,3,1
KR_6773303411,440,4,12,19,8,-1,0,1,4,4,0,4,4,0,1,2,1,0,0,0,0,5,13,3,3,6,4,0,2,1,1,1,1,3,1
KR_6772044812,420,5,63,20,10,0,1,1,5,6,1,4,4,0,0,1,1,1,1,0,0,11,4,0,5,5,0,0,0,1,1,0,-1,4,1
KR_6776561421,420,1,7,9,-1,1,1,0,1,2,1,1,2,1,-4,2,6,0,0,0,0,-4,-15,-1,8,7,10,0,0,-1,1,1,-1,4,1
KR_6708316917,420,2,4,15,8,-3,0,3,6,7,1,4,4,0,0,2,2,1,1,0,0,17,1,3,3,6,-1,0,0,1,1,1,-1,4,1
KR_6772758054,440,0,21,-22,3,1,3,2,-1,1,2,2,2,0,0,1,1,1,1,0,1,7,-8,0,6,6,3,0,0,-1,1,0,1,4,1
KR_6769658950,420,0,17,13,-4,-4,0,4,-1,2,3,1,2,1,-3,2,5,3,5,2,-1,3,6,-1,4,3,0,0,0,-1,1,0,-1,5,1
KR_6727558298,420,3,-16,57,-1,1,2,1,-3,1,4,-1,3,4,2,3,1,0,1,1,0,0,35,-2,12,10,-5,0,0,-1,-1,0,-1,1,1
KR_6764489893,420,5,55,19,5,0,3,3,2,4,2,3,6,3,0,1,1,0,0,0,0,6,13,6,6,12,1,0,0,1,1,1,-1,2,1
KR_6742267059,420,7,119,49,14,5,6,1,3,5,2,0,2,2,5,6,1,1,2,1,2,14,-29,-6,11,5,6,0,1,1,1,1,1,2,1
KR_6760711336,420,3,-40,13,6,1,4,3,4,4,0,2,5,3,-4,2,6,3,5,2,0,11,11,0,6,6,5,0,0,1,1,0,1,2,1
KR_6755568693,420,0,-18,19,6,1,4,3,0,3,3,3,5,2,2,3,1,0,0,0,-1,3,1,7,4,11,3,0,0,1,1,1,-1,5,1
KR_6771639037,420,4,106,19,14,2,3,1,3,3,0,8,8,0,-1,4,5,2,3,1,0,24,3,-4,9,5,5,0,4,-1,1,1,1,4,1
KR_6753867254,420,-1,6,-20,-10,0,2,2,-5,3,8,-3,1,4,-2,1,3,0,0,0,-4,-27,-24,-2,8,6,1,0,0,-1,1,0,-1,4,1
KR_6766588263,420,0,26,11,3,0,2,2,2,6,4,1,2,1,0,1,1,0,1,1,0,-1,6,3,6,9,6,0,2,1,1,1,1,3,1
KR_6776537126,420,7,27,14,7,0,2,2,1,2,1,0,3,3,6,7,1,0,2,2,0,4,0,-1,5,4,1,0,1,1,-1,1,1,3,1
KR_6769739270,420,3,-13,23,0,6,8,2,-2,4,6,1,4,3,-2,4,6,-3,0,3,0,-3,3,-1,6,5,-1,0,0,1,-1,0,-1,6,1
KR_6776981489,420,-2,-17,-20,2,-1,1,2,1,3,2,1,6,5,-2,1,3,3,3,0,-2,3,-9,3,8,11,0,0,0,-1,1,0,-1,1,1
KR_6726733841,420,0,20,-24,3,-1,0,1,2,2,0,2,4,2,0,3,3,0,1,1,0,8,5,2,9,11,4,0,1,-1,1,1,1,1,1
KR_6771790833,420,-1,75,-20,4,3,3,0,2,2,0,-2,1,3,3,7,4,-2,0,2,0,3,-9,1,2,3,0,0,0,-1,1,0,1,1,1
KR_6758311175,420,-1,12,-4,1,2,3,1,0,1,1,-1,1,2,0,1,1,0,0,0,-1,4,-29,-3,8,5,9,0,0,-1,1,0,-1,2,1
KR_6764858517,420,-1,-3,17,-5,-1,1,2,1,5,4,-2,1,3,-1,2,3,-2,3,5,0,-5,-10,-4,7,3,5,0,0,1,-1,-1,1,6,1
KR_6709250197,420,2,30,9,2,8,8,0,1,2,1,1,2,1,-10,1,11,2,2,0,0,-7,25,2,4,6,4,0,0,0,1,1,1,0,1
KR_6762751991,440,7,82,15,15,4,5,1,2,3,1,5,7,2,3,4,1,1,2,1,-1,11,9,-2,8,6,-1,0,0,-1,1,0,-1,5,1
KR_6706648136,420,-3,-43,-22,-5,-2,1,3,0,3,3,-2,1,3,1,6,5,-2,0,2,0,-9,-3,-5,9,4,0,0,1,-1,-1,1,1,6,1
KR_6752784210,420,4,66,25,13,2,3,1,9,9,0,2,2,0,0,3,3,0,1,1,0,18,14,1,7,8,-2,0,2,-1,1,1,1,4,1
KR_6766554315,420,1,-4,15,6,2,2,0,2,2,0,4,4,0,-2,3,5,0,2,2,0,1,-3,1,4,5,3,0,1,-1,1,1,-1,3,1
KR_6774707647,420,0,-6,0,3,-2,0,2,0,3,3,0,1,1,2,8,6,3,4,1,2,2,20,-2,9,7,-3,0,0,1,1,0,1,6,1
KR_6766851353,420,1,-13,-8,6,0,1,1,0,1,1,1,1,0,5,6,1,0,0,0,0,10,3,3,6,9,-4,0,1,1,-1,1,1,3,1
KR_6756412882,420,0,58,4,8,-1,3,4,6,8,2,0,1,1,2,3,1,1,3,2,0,9,53,3,2,5,-22,0,-1,1,-1,-1,1,3,1
KR_6720899869,420,5,60,-14,13,1,3,2,1,3,2,0,0,0,8,9,1,3,5,2,0,14,9,-7,10,3,1,0,1,-1,1,1,1,4,1
KR_6738396158,440,-1,-5,3,-6,-3,0,3,-4,3,7,-1,2,3,1,3,2,1,1,0,-2,-10,15,1,6,7,3,0,0,0,1,-1,-1,0,1
KR_6753337473,420,1,-2,1,7,0,2,2,0,8,8,2,2,0,3,5,2,2,3,1,0,7,-7,0,4,4,1,0,-1,-1,-1,-1,-1,3,1
KR_6753835307,420,2,-24,23,8,7,8,1,-5,5,10,7,9,2,-1,2,3,0,2,2,0,0,0,7,4,11,1,0,-1,1,1,-1,1,2,1
KR_6774234854,420,2,-32,-5,8,2,3,1,2,6,4,4,6,2,2,4,2,-2,0,2,0,7,11,0,3,3,-1,0,0,1,-1,1,1,6,1
KR_6776481147,420,5,91,21,11,2,2,0,1,6,5,4,6,2,6,9,3,-2,1,3,0,17,5,0,6,6,-1,0,1,-1,-1,1,-1,6,1
KR_6776116805,420,5,49,38,1,-1,2,3,3,5,2,2,2,0,-4,3,7,1,2,1,0,4,0,-1,8,7,-2,0,0,-1,-1,-1,-1,5,1
KR_6692849436,420,-1,4,5,1,2,3,1,3,5,2,1,4,3,-5,3,8,0,1,1,-1,4,-6,-2,12,10,0,0,-2,-1,1,-1,-1,2,1
KR_6771293663,440,-1,-7,1,-3,1,2,1,0,5,5,-4,0,4,-1,1,2,1,2,1,0,-1,-4,-2,5,3,0,0,-1,1,-1,-1,-1,6,1
KR_6770346734,420,1,-14,35,-2,2,4,2,0,4,4,-3,3,6,0,3,3,-1,0,1,-1,16,-47,-1,8,7,22,0,-3,1,-1,-1,-1,1,1
KR_6771058268,420,3,38,33,9,0,0,0,2,4,2,6,8,2,1,1,0,0,3,3,0,10,-47,1,8,9,-3,0,0,1,1,0,1,5,1
KR_6770395323,420,1,10,-1,4,2,3,1,-1,6,7,5,7,2,-1,3,4,-1,1,2,0,4,-1,-1,4,3,2,0,0,1,1,-1,1,2,1
KR_6776982678,420,2,37,23,4,0,1,1,3,5,2,-1,1,2,2,5,3,0,0,0,0,3,-5,5,5,10,7,0,2,1,1,1,1,5,1
KR_6744364029,420,1,8,21,9,0,0,0,-2,0,2,-1,2,3,5,5,0,7,7,0,0,10,-1,5,4,9,10,0,2,1,1,1,1,1,1
KR_6777735600,420,-4,-25,-24,-1,0,3,3,-4,2,6,4,4,0,-2,4,6,1,1,0,-1,-5,8,0,6,6,-4,0,0,-1,-1,-1,-1,4,1
KR_6777791373,440,1,71,-12,-1,-2,2,4,1,1,0,4,5,1,0,2,2,-4,0,4,0,-7,-7,-4,8,4,1,0,-1,-1,-1,-1,1,6,1
KR_6774252689,420,5,-30,18,1,0,1,1,2,4,2,0,2,2,0,3,3,-1,0,1,-1,-1,54,2,5,7,1,0,-1,-1,-1,-1,-1,2,1
KR_6774982508,420,3,16,-11,7,3,4,1,4,6,2,-1,4,5,1,2,1,0,0,0,0,7,13,1,7,8,3,0,1,1,1,1,1,3,1
KR_6743934832,420,0,48,-22,8,2,2,0,4,6,2,1,2,1,0,1,1,1,2,1,1,14,-1,5,2,7,4,0,1,1,-1,1,1,4,1
KR_6751206452,440,2,39,8,1,2,2,0,0,4,4,1,1,0,-1,1,2,-1,0,1,0,-1,-38,1,3,4,23,0,0,-1,1,0,1,5,1
KR_6752225184,420,0,26,13,4,2,3,1,0,4,4,-2,0,2,4,4,0,0,0,0,0,9,-5,-3,11,8,-8,0,2,1,1,1,-1,4,1
KR_6777887505,420,0,16,-9,-7,-4,2,6,5,5,0,-5,0,5,-4,2,6,1,3,2,-2,-9,-8,-4,9,5,1,0,0,1,-1,0,-1,1,1
KR_6775143731,420,-1,-10,-5,0,-2,2,4,1,2,1,-4,3,7,2,3,1,3,3,0,0,5,111,3,6,9,0,0,-2,1,-1,-1,1,3,1
KR_6777125423,420,3,40,3,13,1,3,2,0,2,2,6,9,3,2,2,0,4,5,1,1,10,1,2,3,5,2,0,0,-1,1,1,1,3,1
KR_6697083641,420,1,-46,5,1,1,1,0,2,2,0,-2,3,5,0,0,0,0,1,1,0,-3,-7,3,6,9,-2,0,0,-1,1,0,1,4,1
KR_6773207258,420,2,40,16,4,1,1,0,0,3,3,0,1,1,1,3,2,2,2,0,0,0,-66,2,6,8,0,0,0,-1,1,0,1,6,1
KR_6766168899,440,2,90,-29,10,2,3,1,-1,2,3,-1,4,5,7,9,2,3,3,0,0,10,5,6,2,8,-5,0,1,0,-1,1,1,0,1
KR_6679191857,420,6,134,23,8,-1,1,2,0,2,2,8,9,1,0,2,2,1,2,1,0,3,-119,-1,6,5,3,0,1,-1,1,1,1,4,1
KR_6756803818,440,3,69,11,5,3,3,0,5,6,1,-2,3,5,-2,6,8,1,1,0,-1,3,-57,-2,4,2,-2,0,1,0,1,1,-1,0,1
KR_6775335459,420,3,14,8,8,0,0,0,5,6,1,4,5,1,0,1,1,-1,0,1,0,14,-1,-2,8,6,3,0,0,1,1,1,-1,5,1
KR_6736015573,420,4,13,37,9,3,4,1,4,5,1,0,1,1,1,1,0,1,3,2,0,7,-90,1,4,5,2,0,-1,1,1,-1,-1,1,1
KR_6751643414,440,2,-56,12,-1,0,4,4,1,2,1,-1,2,3,-1,1,2,0,0,0,0,1,-11,4,6,10,-7,0,-1,-1,1,-1,-1,4,1
KR_6768148677,440,0,-7,12,10,-2,0,2,6,6,0,7,8,1,2,6,4,-3,1,4,0,8,-10,2,4,6,1,0,0,1,-1,1,1,6,1
KR_6776018134,420,-2,0,-7,-6,-2,0,2,-2,0,2,-3,2,5,1,4,3,0,0,0,0,-7,5,0,6,6,-1,0,0,-1,-1,0,1,1,1
KR_6720487829,420,1,16,6,6,-1,1,2,-1,4,5,5,7,2,3,4,1,0,1,1,-1,10,-8,1,6,7,3,0,3,1,1,1,-1,2,1
KR_6710595048,420,7,-15,29,19,0,1,1,4,7,3,5,6,1,5,6,1,5,5,0,0,16,10,6,5,11,-2,0,3,1,1,1,-1,5,1
KR_6731654895,440,6,33,11,9,-1,3,4,1,2,1,1,2,1,2,5,3,6,8,2,2,16,23,-4,7,3,-14,0,3,0,1,1,1,0,1
KR_6764838570,420,-1,-27,-4,-1,-2,1,3,1,3,2,-2,3,5,0,1,1,2,3,1,0,1,9,1,4,5,-2,0,0,1,-1,1,-1,4,1
KR_6765773112,420,-1,29,-31,1,-1,2,3,1,4,3,1,4,3,0,1,1,0,2,2,0,4,-22,-1,8,7,4,0,0,-1,-1,-1,1,1,1
KR_6771227294,420,3,-18,-16,11,-2,1,3,8,8,0,1,2,1,4,4,0,0,2,2,0,9,-53,4,2,6,25,0,-2,1,-1,-1,1,6,1
KR_6776129294,420,-2,41,7,-2,-2,1,3,1,4,3,0,2,2,0,2,2,-1,1,2,1,-6,16,-4,13,9,-1,0,0,-1,1,1,1,2,1
KR_6770515017,420,2,9,20,7,0,0,0,4,5,1,-1,2,3,3,3,0,1,1,0,0,9,-9,-3,8,5,8,0,2,1,1,1,-1,3,1
KR_6710626373,420,-2,-40,16,-7,-7,0,7,2,4,2,-1,2,3,-1,2,3,0,1,1,0,-11,-8,-2,7,5,5,0,-2,1,-1,-1,-1,3,1
KR_6768193656,420,-3,-7,-26,1,2,3,1,0,0,0,0,3,3,2,3,1,-3,0,3,0,1,-9,-1,5,4,1,0,0,1,-1,1,1,4,1
KR_6770747248,420,-1,26,0,-4,2,2,0,2,3,1,0,2,2,-7,0,7,-1,0,1,0,-2,5,2,6,8,-2,0,0,-1,-1,0,1,5,1
KR_6736929154,420,1,7,17,11,-1,2,3,-1,2,3,3,4,1,7,7,0,3,3,0,0,10,0,1,4,5,3,0,2,1,1,1,-1,5,1
KR_6776586965,420,0,4,0,-4,-1,1,2,-1,0,1,4,5,1,-4,4,8,-2,0,2,-2,-3,-27,3,5,8,0,0,-2,1,1,-1,-1,5,1
KR_6777296265,420,1,7,-24,-2,2,3,1,-3,3,6,0,3,3,-3,1,4,2,2,0,0,-8,1,2,4,6,-5,0,1,1,1,1,-1,6,1
KR_6727608886,420,-2,62,-1,-7,-2,0,2,-2,4,6,-6,1,7,1,2,1,2,2,0,0,-7,-13,0,8,8,3,0,-1,1,-1,-1,1,5,1
KR_6765754552,440,1,13,18,0,3,3,0,1,1,0,0,3,3,-4,0,4,0,1,1,0,-3,-15,1,5,6,1,0,0,0,-1,0,-1,0,1
KR_6742077026,420,1,-29,-12,6,-1,0,1,4,6,2,3,3,0,-1,4,5,1,1,0,0,4,-17,2,8,10,5,0,0,1,1,1,-1,4,1
KR_6777795603,420,-1,-69,6,3,-1,1,2,3,4,1,2,4,2,-4,1,5,3,3,0,-1,10,4,4,4,8,-2,0,-1,1,-1,-1,-1,5,1
KR_6712524849,420,-2,13,-6,-7,2,3,1,-9,1,10,0,4,4,2,6,4,-2,1,3,-1,-1,-12,2,4,6,-3,0,2,1,1,1,-1,6,1
KR_6772361748,420,0,-13,12,12,1,1,0,1,5,4,7,9,2,6,8,2,-3,0,3,0,18,27,3,7,10,6,0,0,-1,-1,1,-1,5,1
KR_6744336827,420,-1,58,-27,4,2,7,5,1,2,1,-3,3,6,6,7,1,-2,0,2,0,12,42,4,6,10,-8,0,1,-1,1,1,-1,6,1
KR_6772035458,420,1,-24,-12,6,1,5,4,2,3,1,2,6,4,1,7,6,0,1,1,0,16,16,-4,6,2,1,0,2,1,-1,-1,-1,5,1
KR_6773708737,420,3,53,5,10,0,2,2,7,9,2,5,6,1,-2,1,3,0,1,1,0,10,7,-2,5,3,-1,0,3,1,-1,1,-1,3,1
KR_6772365360,420,1,-9,0,5,1,1,0,3,4,1,1,3,2,0,1,1,0,0,0,0,8,23,2,5,7,1,0,2,1,1,1,-1,4,1
KR_6737192895,420,-1,-9,-12,3,7,7,0,-2,5,7,-4,0,4,1,5,4,1,4,3,3,5,120,4,6,10,-1,0,2,-1,1,1,1,4,1
KR_6734920623,420,5,9,20,4,-2,0,2,0,4,4,3,4,1,2,8,6,1,1,0,-1,1,-28,-3,11,8,10,0,0,-1,-1,1,-1,3,1
KR_6766024110,420,3,5,4,8,1,3,2,-2,0,2,7,7,0,1,3,2,1,5,4,0,19,12,0,5,5,2,0,-1,1,-1,-1,1,2,1
KR_6772224299,420,2,71,4,-1,2,2,0,-1,0,1,-1,0,1,-1,0,1,0,0,0,-1,-6,-8,-3,9,6,-1,0,1,1,-1,1,-1,2,1
KR_6698448168,420,2,-37,9,4,-3,0,3,1,3,2,2,3,1,1,4,3,3,4,1,0,9,7,5,4,9,-5,0,0,1,-1,0,1,4,1
KR_6775278899,420,8,87,23,20,1,2,1,1,5,4,5,5,0,11,13,2,2,3,1,0,15,7,4,3,7,0,0,1,1,-1,1,1,2,1
KR_6770839907,420,5,29,24,12,1,2,1,10,10,0,3,3,0,-2,3,5,0,0,0,0,18,36,9,2,11,1,0,0,1,1,1,1,6,1
KR_6749569732,440,0,48,19,4,-2,1,3,2,2,0,-1,3,4,3,4,1,2,2,0,0,5,-24,1,7,8,4,0,0,1,0,0,1,5,1
KR_6774537730,420,2,71,20,-1,-1,1,2,0,3,3,-4,1,5,3,4,1,1,1,0,0,-6,-2,1,8,9,-4,0,2,-1,1,1,1,3,1
KR_6687654251,420,2,14,-10,8,-2,1,3,4,7,3,3,3,0,5,6,1,-2,0,2,0,10,-11,-3,12,9,7,0,0,1,-1,0,1,3,1
KR_6753303007,420,2,-9,24,0,0,3,3,-1,1,2,1,2,1,-3,0,3,3,3,0,-1,2,16,0,5,5,0,0,0,1,1,0,-1,6,1
KR_6775435603,420,3,8,-16,5,2,2,0,1,4,3,3,3,0,-2,0,2,1,2,1,0,1,1,-1,10,9,1,0,0,1,-1,0,1,2,1
KR_6762970942,440,1,-22,0,7,7,9,2,-2,4,6,-1,1,2,-2,3,5,5,5,0,0,9,12,1,5,6,0,0,2,1,1,1,-1,6,1
KR_6765898931,420,2,77,-38,5,2,2,0,1,4,3,6,6,0,-3,0,3,-1,0,1,0,0,-7,1,8,9,3,0,3,-1,1,1,1,3,1
KR_6742549951,420,3,0,16,17,4,5,1,8,10,2,2,3,1,1,3,2,2,2,0,1,21,19,2,5,7,-3,0,1,1,1,1,1,5,1
KR_6733018502,420,3,41,-2,6,-5,0,5,8,10,2,3,5,2,1,3,2,-1,0,1,2,17,1,1,4,5,3,0,3,1,1,1,1,2,1
KR_6776773440,420,3,8,19,10,-2,1,3,2,3,1,-1,0,1,4,6,2,7,9,2,0,10,13,2,7,9,-6,0,0,-1,-1,0,1,2,1
KR_6723194474,440,-1,-62,-29,4,0,4,4,6,6,0,0,2,2,-2,2,4,0,0,0,0,5,-15,-5,10,5,0,0,-1,1,-1,-1,1,1,1
KR_6772330457,420,3,-1,40,5,3,3,0,-1,1,2,-2,3,5,1,2,1,4,4,0,0,5,6,0,10,10,2,0,0,1,1,0,-1,1,1
KR_6776966373,420,11,149,52,20,11,11,0,5,6,1,1,1,0,1,1,0,2,3,1,0,15,6,7,1,8,1,0,4,1,1,1,1,6,1
KR_6771291653,440,2,93,5,13,0,3,3,4,5,1,3,4,1,3,8,5,3,4,1,0,15,6,4,3,7,-3,0,1,1,-1,1,1,3,1
KR_6746576555,420,5,11,10,12,0,1,1,0,3,3,5,5,0,5,5,0,2,2,0,0,11,6,5,3,8,4,0,1,1,1,1,-1,4,1
KR_6776669286,420,1,56,12,4,-1,0,1,2,5,3,0,1,1,3,4,1,0,0,0,0,12,-59,1,3,4,4,0,2,-1,1,1,1,5,1
KR_6717392163,420,-1,11,-18,-4,3,4,1,-6,3,9,2,3,1,-1,2,3,-2,0,2,0,-11,-5,2,4,6,-1,0,-1,1,1,-1,1,2,1
KR_6754057949,420,0,107,6,-1,1,4,3,-2,4,6,-2,2,4,1,4,3,1,2,1,0,6,2,2,5,7,3,0,3,1,1,1,1,1,1
KR_6760058701,420,3,-1,7,7,2,9,7,2,6,4,3,3,0,0,0,0,0,0,0,0,21,-11,-2,7,5,4,0,1,-1,1,-1,-1,3,1
KR_6721093077,420,1,23,3,5,2,2,0,3,4,1,-2,2,4,1,2,1,1,3,2,0,8,-41,-1,6,5,1,0,0,1,-1,0,1,1,1
KR_6763527363,440,2,62,-1,-2,1,5,4,-2,1,3,0,1,1,0,1,1,-1,0,1,-3,-11,-4,-6,12,6,5,0,0,-1,1,1,-1,4,1
KR_6746355204,420,0,-16,12,0,-1,0,1,6,7,1,-4,2,6,-3,2,5,2,2,0,0,-6,-8,0,8,8,1,0,0,1,-1,-1,-1,6,1
KR_6768466684,420,-3,18,12,-7,-3,1,4,0,2,2,1,4,3,-6,1,7,1,3,2,0,-4,8,-5,8,3,12,0,2,-1,1,1,1,2,1
KR_6772381377,420,4,54,8,7,-2,1,3,8,10,2,2,5,3,-3,2,5,2,3,1,0,-1,13,-2,5,3,2,0,2,1,1,1,-1,4,1
KR_6740571538,420,-2,-16,-27,0,0,0,0,3,4,1,0,2,2,-3,0,3,0,0,0,0,-5,-37,-8,11,3,6,0,0,1,1,1,-1,3,1
KR_6776649605,420,3,39,29,7,3,4,1,5,8,3,3,5,2,-2,3,5,-2,0,2,2,14,0,4,9,13,-4,0,0,1,1,1,1,6,1
KR_6742971896,420,3,23,13,7,7,7,0,-3,2,5,2,5,3,0,2,2,1,2,1,1,1,5,6,1,7,1,0,2,1,1,1,1,6,1
KR_6750292030,420,5,22,22,17,5,6,1,5,7,2,1,1,0,5,7,2,1,2,1,3,20,-3,2,5,7,8,0,0,1,-1,0,1,5,1
KR_6751448782,420,2,-1,9,3,-1,0,1,1,4,3,-2,6,8,4,6,2,1,2,1,0,9,5,2,7,9,-1,0,1,-1,-1,1,-1,6,1
KR_6760089871,420,1,4,2,10,-3,0,3,-2,4,6,12,14,2,3,4,1,0,3,3,0,21,-16,-1,5,4,2,0,1,1,1,1,1,6,1
KR_6705521594,420,2,46,-28,-1,-2,2,4,3,9,6,2,4,2,-3,4,7,-1,0,1,0,-1,-7,-6,11,5,2,0,-1,0,-1,-1,-1,0,1
KR_6748536891,420,-2,-31,-10,-3,-3,0,3,-2,0,2,-3,5,8,3,5,2,2,2,0,0,6,8,-2,12,10,-1,0,1,-1,1,1,-1,2,1
KR_6723383026,420,2,8,-34,12,2,4,2,3,8,5,0,2,2,5,7,2,2,2,0,0,5,-11,8,6,14,0,0,0,-1,-1,1,1,1,1
KR_6764906324,420,-2,-17,-12,2,2,2,0,3,3,0,-1,1,2,-3,1,4,1,1,0,0,-2,-3,3,5,8,-39,0,0,1,1,1,-1,4,1
KR_6777346705,420,-1,-38,-7,-1,-2,2,4,-8,2,10,4,7,3,7,7,0,-2,1,3,-1,-4,-13,8,4,12,1,0,1,-1,1,1,-1,6,1
KR_6739742817,420,4,15,10,10,-1,2,3,5,7,2,-1,1,2,5,7,2,2,2,0,0,13,125,6,2,8,-3,0,2,1,-1,1,-1,6,1
KR_6742999247,420,1,35,15,-1,-2,0,2,0,2,2,1,5,4,0,2,2,0,0,0,0,0,-14,-2,5,3,5,0,-1,-1,-1,-1,1,2,1
KR_6730124190,420,1,3,-23,5,3,4,1,4,5,1,2,2,0,-2,1,3,-2,0,2,1,5,-119,-3,8,5,1,0,1,1,1,1,1,2,1
KR_6774829456,420,1,7,-13,11,1,1,0,3,7,4,6,7,1,-2,3,5,3,5,2,-1,10,-7,-2,6,4,4,0,1,1,-1,1,-1,6,1
KR_6774680133,420,4,100,43,16,6,8,2,1,2,1,1,3,2,8,8,0,0,1,1,3,21,-28,5,0,5,18,0,2,1,1,1,1,5,1
KR_6739676430,420,2,5,1,4,1,3,2,1,2,1,0,0,0,3,3,0,-1,0,1,1,3,5,8,5,13,3,0,1,1,-1,1,1,2,1
KR_6732934490,440,4,59,24,1,0,2,2,-3,2,5,-1,3,4,6,7,1,-1,0,1,0,-4,-3,-1,5,4,3,0,0,-1,0,1,1,4,1
KR_6777676411,420,-2,-36,9,-5,-1,0,1,-1,1,2,1,3,2,-4,1,5,0,2,2,0,-6,7,5,4,9,-7,0,-1,-1,1,-1,-1,2,1
KR_6701170008,420,5,12,17,13,-2,0,2,9,9,0,1,3,2,2,2,0,3,4,1,0,21,15,4,6,10,-3,0,1,1,-1,1,-1,2,1
KR_6721952905,420,2,4,32,-1,3,4,1,-3,2,5,-1,4,5,0,2,2,0,3,3,1,-12,-1,1,6,7,-2,0,-1,1,-1,-1,1,3,1
KR_6770246982,420,3,2,9,6,5,6,1,0,3,3,-1,1,2,3,5,2,-1,0,1,0,6,0,7,3,10,4,0,1,1,1,1,1,1,1
KR_6776213542,420,1,31,17,0,-2,1,3,6,7,1,-2,0,2,-3,2,5,1,1,0,0,-6,14,1,6,7,-2,0,2,-1,1,1,1,6,1
KR_6757440685,420,1,4,3,-5,-2,2,4,1,3,2,-3,1,4,-1,4,5,0,1,1,0,-1,-8,-3,6,3,-5,0,-1,1,-1,-1,-1,5,1
KR_6766855689,420,6,6,55,14,-1,1,2,6,8,2,5,5,0,4,5,1,0,1,1,0,24,29,-4,9,5,3,0,0,-1,1,0,-1,6,1
KR_6736573641,420,2,111,-23,6,-1,3,4,-1,4,5,2,4,2,7,9,2,-1,0,1,0,3,10,-4,8,4,-4,0,3,-1,-1,1,1,2,1
KR_6733968094,420,-5,-9,-1,-6,0,1,1,2,6,4,-1,1,2,0,1,1,-7,0,7,0,-3,9,-2,9,7,2,0,-2,-1,-1,-1,1,2,1
KR_6746877736,420,4,86,9,6,8,10,2,-3,3,6,0,1,1,1,2,1,0,1,1,1,-2,10,-2,6,4,0,0,2,1,-1,1,1,2,1
KR_6773150895,420,3,41,20,2,3,3,0,0,4,4,-1,2,3,-1,0,1,1,1,0,1,1,44,2,8,10,-7,0,3,1,1,1,-1,1,1
KR_6741634911,420,3,43,20,5,2,3,1,-1,1,2,0,1,1,1,2,1,3,3,0,0,12,-22,1,8,9,-5,0,1,1,-1,-1,-1,1,1
KR_6769230036,420,2,25,4,4,1,2,1,3,5,2,-1,2,3,1,2,1,0,0,0,1,4,3,-1,6,5,0,0,0,1,0,0,1,5,1
KR_6709361074,420,1,-30,-20,7,1,2,1,5,6,1,2,2,0,-1,2,3,0,1,1,0,7,27,4,5,9,1,0,0,-1,1,0,1,5,1
KR_6777479945,420,5,76,-9,13,3,4,1,1,4,3,5,5,0,4,6,2,0,1,1,0,8,-2,1,5,6,-2,0,2,1,1,1,1,1,1
KR_6764886972,420,2,-3,20,2,2,2,0,-3,4,7,2,4,2,1,3,2,0,1,1,0,-5,2,-1,9,8,-2,0,0,-1,1,0,1,2,1
KR_6744741748,420,1,26,-2,7,0,1,1,1,1,0,0,3,3,6,8,2,0,0,0,0,17,-9,2,7,9,-2,0,-2,1,-1,-1,-1,6,1
KR_6773893527,420,-1,-61,-17,0,0,2,2,-3,2,5,1,4,3,3,4,1,-1,2,3,0,-1,-18,-6,10,4,-3,0,0,1,1,1,-1,5,1
KR_6771538172,420,1,2,5,3,1,2,1,2,3,1,3,8,5,-3,1,4,0,1,1,-1,1,42,3,6,9,1,0,1,1,1,1,1,5,1
KR_6774676931,420,5,72,11,14,1,3,2,5,7,2,3,5,2,7,8,1,-2,0,2,0,20,9,8,6,14,-1,0,2,1,1,1,1,2,1
KR_6733190128,420,-3,-13,-27,-6,-5,0,5,-3,0,3,-3,4,7,4,4,0,1,2,1,0,-4,-40,4,2,6,-4,0,0,1,-1,-1,1,5,1
KR_6708043144,420,3,55,27,4,3,4,1,2,5,3,2,2,0,-3,1,4,0,0,0,-1,2,18,-1,9,8,4,0,2,-1,1,1,-1,4,1
KR_6777780150,420,1,37,0,5,-1,2,3,3,4,1,5,8,3,-1,3,4,-1,1,2,0,3,7,3,6,9,1,0,1,-1,1,1,1,4,1
KR_6772657406,420,2,57,8,0,1,2,1,-6,1,7,-2,2,4,6,7,1,1,1,0,1,3,10,0,5,5,0,0,2,-1,-1,1,1,3,1
KR_6773434736,420,1,9,0,-3,0,0,0,-1,3,4,1,4,3,-3,0,3,0,1,1,0,-2,-15,2,4,6,-1,0,0,1,1,0,-1,1,1
KR_6776495458,420,0,-48,31,2,2,5,3,2,4,2,5,5,0,-5,1,6,-2,2,4,0,2,1,3,1,4,-1,0,0,1,1,-1,-1,6,1
KR_6723138005,440,3,-54,44,6,4,4,0,4,4,0,2,5,3,-1,0,1,-3,0,3,0,-7,-115,6,6,12,-10,0,1,-1,1,1,1,1,1
KR_6754042992,420,1,21,13,7,-1,1,2,4,7,3,-2,0,2,8,10,2,-2,0,2,0,10,2,3,4,7,2,0,-1,1,-1,-1,-1,4,1
KR_6744529680,420,3,101,-23,1,4,6,2,-2,4,6,0,2,2,1,3,2,-2,0,2,0,-5,197,0,5,5,4,0,0,1,1,1,-1,5,1
KR_6745583910,420,1,15,7,2,0,1,1,-2,1,3,0,2,2,1,4,3,3,3,0,2,5,2,-2,6,4,-2,0,0,-1,1,0,1,1,1
KR_6768438826,420,0,52,39,-3,2,2,0,-3,2,5,1,3,2,-2,2,4,-1,0,1,0,-11,2,-3,8,5,0,0,0,1,1,0,-1,5,1
KR_6656410379,420,1,-7,3,3,1,1,0,5,5,0,-5,0,5,2,4,2,0,0,0,0,3,3,5,4,9,-2,0,0,-1,-1,0,-1,5,1
KR_6750219375,420,2,-2,-9,10,2,3,1,2,5,3,0,3,3,4,4,0,2,2,0,0,11,-8,2,5,7,2,0,1,1,1,1,1,5,1
KR_6775213675,420,2,37,36,1,1,2,1,-2,4,6,1,3,2,0,1,1,1,1,0,0,4,2,1,8,9,-5,0,0,1,1,1,-1,1,1
KR_6770426037,420,2,32,-13,6,-3,1,4,6,8,2,0,1,1,3,5,2,0,1,1,0,9,-31,1,5,6,1,0,0,-1,-1,0,-1,5,1
KR_6775784496,420,5,54,31,6,2,3,1,1,4,3,0,1,1,0,2,2,3,3,0,-1,0,-3,-3,11,8,12,0,2,1,1,1,-1,5,1
KR_6721768072,420,-2,-43,-28,-6,-2,3,5,0,4,4,-4,0,4,-3,1,4,3,3,0,0,-6,8,2,4,6,-7,0,0,0,-1,-1,-1,0,1
KR_6771751199,440,2,72,-16,3,0,1,1,-2,0,2,1,1,0,4,4,0,0,0,0,1,3,-25,3,2,5,3,0,2,1,1,1,1,3,1
KR_6766894212,420,1,28,19,2,1,2,1,0,3,3,1,2,1,2,3,1,-2,1,3,1,0,-4,0,4,4,2,0,1,-1,1,1,1,3,1
KR_6711144153,440,0,-12,4,6,0,2,2,1,6,5,1,4,3,4,10,6,0,3,3,1,0,2,1,3,4,2,0,-1,1,1,-1,-1,6,1
KR_6761881597,440,0,46,-25,8,4,5,1,1,4,3,4,5,1,1,6,5,-2,0,2,2,13,-4,1,5,6,1,0,2,1,1,1,1,1,1
KR_6771354940,420,3,-15,2,13,-1,0,1,4,6,2,1,2,1,1,3,2,8,9,1,0,4,-5,-4,8,4,-5,0,0,-1,-1,0,1,6,1
KR_6775656765,420,-2,-12,-12,-1,-1,1,2,-2,3,5,1,3,2,0,3,3,1,3,2,-1,-1,36,-1,3,2,-19,0,1,-1,1,1,-1,4,1
KR_6725980155,440,6,47,36,13,5,7,2,2,4,2,-1,1,2,3,5,2,4,5,1,0,13,-1,1,1,2,0,0,1,-1,1,1,1,1,1
KR_6756028418,420,4,31,7,0,2,3,1,-1,3,4,-2,1,3,-1,2,3,2,2,0,0,-9,320,1,4,5,3,0,0,1,1,1,1,1,1
KR_6773405732,420,-3,40,-12,-7,0,5,5,3,3,0,-6,0,6,-2,2,4,-2,1,3,1,-7,5,0,6,6,-2,0,1,-1,1,1,1,6,1
KR_6745982955,420,-1,59,-28,-3,4,5,1,0,3,3,-9,3,12,1,1,0,1,1,0,1,-3,221,-1,5,4,-3,0,1,1,-1,1,1,2,1
KR_6735166799,420,2,-7,32,2,-5,0,5,7,8,1,1,1,0,0,1,1,-1,0,1,0,8,33,-1,4,3,-21,0,-1,1,-1,-1,-1,6,1
KR_6776647403,440,0,-12,33,-6,2,2,0,-2,1,3,-2,1,3,-1,1,2,-3,0,3,0,-4,10,-1,3,2,-7,0,0,1,-1,0,-1,5,1
KR_6759929897,420,3,3,-16,10,-2,0,2,-3,2,5,2,2,0,12,12,0,1,1,0,0,17,4,-1,6,5,4,0,1,0,-1,1,1,0,1
KR_6766455490,420,2,-22,20,2,3,7,4,-1,3,4,-2,0,2,2,3,1,0,1,1,0,6,-2,1,4,5,-4,0,-1,-1,-1,-1,1,1,1
KR_6774401293,420,0,12,-6,5,0,3,3,1,3,2,0,3,3,4,5,1,0,0,0,0,8,29,5,2,7,3,0,0,1,1,0,1,2,1
KR_6776969844,420,1,-47,37,10,6,6,0,-1,1,2,4,4,0,0,3,3,1,1,0,0,16,-39,0,6,6,17,0,-2,1,-1,-1,-1,2,1
KR_6765850261,440,-2,-44,-4,-5,-5,1,6,-3,4,7,6,7,1,-2,2,4,-1,1,2,-1,-13,-17,-1,11,10,1,0,1,-1,1,1,-1,3,1
KR_6776521473,420,3,-1,12,2,0,1,1,1,3,2,0,3,3,1,3,2,0,0,0,0,-1,7,-1,8,7,5,0,0,1,-1,0,1,1,1
KR_6771281979,420,-2,14,-19,-7,0,0,0,-1,2,3,-2,4,6,0,4,4,-4,0,4,0,-15,44,-2,6,4,-3,0,-2,1,-1,-1,1,6,1
KR_6739745315,420,1,44,8,14,2,3,1,-5,4,9,6,6,0,10,10,0,1,2,1,0,16,-35,1,7,8,1,0,0,1,-1,-1,1,6,1
KR_6761980901,420,1,-20,18,7,-1,0,1,1,3,2,5,9,4,3,6,3,-1,0,1,0,9,-20,-1,8,7,4,0,-1,1,1,-1,-1,1,1
KR_6770051770,420,2,-36,1,-5,-3,0,3,-2,4,6,0,1,1,4,4,0,-4,0,4,0,-2,-11,0,8,8,1,0,0,1,-1,0,-1,2,1
KR_6765577702,420,-1,-58,0,2,-3,1,4,-1,2,3,3,3,0,2,5,3,1,2,1,0,-1,-2,-3,7,4,-3,0,-1,1,-1,-1,-1,6,1
KR_6764463558,420,2,0,4,7,-1,1,2,0,5,5,3,8,5,5,6,1,0,1,1,0,21,-8,1,5,6,-2,0,0,0,0,1,-1,0,1
KR_6776343641,440,4,55,1,5,5,6,1,1,3,2,-1,1,2,-1,3,4,1,1,0,0,-2,67,5,3,8,3,0,2,1,1,1,-1,3,1
KR_6753046690,420,4,54,18,5,0,2,2,-2,0,2,-1,1,2,8,10,2,0,1,1,1,3,-126,-2,8,6,-1,0,2,1,1,1,1,2,1
KR_6753240978,420,4,21,-14,9,4,4,0,7,7,0,-1,5,6,1,4,3,-2,0,2,0,2,-7,2,3,5,-1,0,2,-1,1,1,1,1,1
KR_6760565758,420,1,-34,2,1,0,1,1,0,2,2,2,4,2,0,2,2,-1,0,1,0,-1,-8,-3,9,6,-1,0,1,-1,1,1,-1,4,1
KR_6775815307,420,3,37,31,9,-2,0,2,2,4,2,2,3,1,5,6,1,2,2,0,3,22,8,1,4,5,2,0,-2,1,-1,1,1,3,1
KR_6757742728,440,0,-48,-7,0,-1,3,4,1,2,1,-2,2,4,1,2,1,1,5,4,0,11,-7,-2,6,4,0,0,-1,-1,-1,-1,-1,5,1
KR_6764439417,420,3,-6,18,9,2,3,1,0,3,3,2,3,1,2,4,2,3,3,0,2,8,-1,6,4,10,1,0,1,1,1,1,1,6,1
KR_6774983089,420,-1,-52,14,2,0,3,3,1,1,0,-2,1,3,4,6,2,-1,0,1,0,1,-226,-1,10,9,-4,0,0,1,1,0,1,4,1
KR_6777636060,420,5,91,11,9,-1,2,3,7,8,1,1,3,2,1,2,1,1,1,0,0,12,-6,-3,6,3,4,0,1,1,1,1,1,6,1
KR_6775344288,420,-1,-11,3,-4,4,5,1,-1,5,6,0,2,2,-6,0,6,-1,0,1,1,-6,-25,-12,13,1,3,0,2,-1,1,1,1,1,1
KR_6742912596,420,5,64,18,4,3,4,1,-1,2,3,0,2,2,2,5,3,0,1,1,-1,4,39,1,6,7,-3,0,2,-1,1,1,-1,2,1
KR_6740325746,420,-1,-2,-27,0,0,3,3,0,3,3,-1,3,4,1,3,2,0,0,0,0,-2,-243,3,6,9,0,0,0,0,0,0,1,0,1
KR_6708519821,420,1,55,31,4,-2,0,2,6,7,1,0,0,0,2,5,3,-2,0,2,0,12,62,-2,9,7,5,0,2,1,1,1,-1,5,1
KR_6728345178,420,0,-22,-17,8,2,2,0,1,7,6,1,2,1,2,5,3,2,2,0,0,7,8,4,8,12,1,0,0,-1,1,-1,1,3,1
KR_6745854532,420,0,35,26,0,-2,1,3,2,4,2,0,5,5,-1,3,4,1,4,3,0,8,-38,-3,9,6,2,0,0,-1,1,1,-1,2,1
KR_6774783069,420,2,-25,3,7,0,0,0,1,6,5,6,6,0,1,1,0,-1,0,1,0,8,-12,1,10,11,5,0,-1,1,1,-1,-1,3,1
KR_6753245561,420,2,39,17,0,3,3,0,-1,1,2,-1,1,2,3,3,0,-4,0,4,0,-8,5,0,4,4,-1,0,2,-1,1,1,1,4,1
KR_6774179042,420,-1,-14,-13,-1,0,1,1,-1,1,2,-2,1,3,3,4,1,-1,1,2,0,-1,0,-2,8,6,4,0,-1,-1,-1,-1,1,3,1
KR_6738917462,420,3,70,-4,10,3,4,1,4,5,1,4,7,3,0,3,3,-1,1,2,0,10,27,5,6,11,5,0,1,1,1,1,1,3,1
KR_6744886677,420,6,71,26,5,3,5,2,-1,0,1,3,3,0,0,2,2,0,0,0,0,2,9,2,3,5,0,0,2,1,1,1,1,6,1
KR_6713040236,420,1,21,-8,2,6,6,0,0,3,3,0,2,2,-3,1,4,-1,0,1,0,0,-1,2,6,8,1,0,-1,-1,-1,-1,1,5,1
KR_6773218000,420,-1,-64,0,2,3,3,0,3,5,2,-1,2,3,-2,0,2,-1,0,1,-1,-1,-1,2,5,7,1,0,0,1,1,-1,-1,2,1
KR_6769359668,420,1,-13,-4,4,2,3,1,4,5,1,-1,1,2,-3,2,5,2,2,0,0,5,30,4,7,11,6,0,3,-1,1,1,-1,6,1
KR_6711341240,440,4,-1,32,10,-1,2,3,2,2,0,4,5,1,4,6,2,1,1,0,0,15,46,3,3,6,-14,0,1,1,1,1,1,1,1
KR_6777777472,420,0,-13,0,-1,-1,1,2,-2,2,4,2,4,2,0,4,4,0,2,2,-1,6,0,-2,5,3,1,0,0,1,-1,0,-1,4,1
KR_6775255481,420,1,-4,1,6,1,3,2,6,7,1,-1,1,2,0,1,1,0,1,1,0,7,69,7,6,13,2,0,0,1,1,1,1,5,1
KR_6770125797,420,3,58,70,1,1,3,2,1,3,2,-1,2,3,6,6,0,-6,0,6,1,-5,-1,2,3,5,11,0,1,1,1,1,-1,6,1
KR_6766101899,420,-3,-24,8,-5,-1,3,4,2,5,3,2,3,1,-6,3,9,-2,0,2,0,-13,2,1,7,8,-2,0,0,-1,-1,1,1,6,1
KR_6743160154,420,2,-36,55,6,-1,0,1,1,1,0,2,3,1,0,3,3,4,4,0,1,5,-6,7,1,8,4,0,0,1,1,0,1,3,1
KR_6744434589,420,5,79,47,9,8,8,0,1,2,1,-2,1,3,3,4,1,-1,1,2,0,3,5,2,8,10,-3,0,0,1,1,1,1,3,1
KR_6766375263,420,0,-44,15,0,-3,4,7,2,5,3,2,5,3,-2,2,4,1,3,2,0,-5,23,5,3,8,-13,0,-2,-1,1,-1,1,4,1
KR_6752250611,420,1,29,-11,0,2,2,0,-3,1,4,3,5,2,-1,2,3,-1,0,1,0,3,-343,2,6,8,3,0,1,-1,1,1,-1,3,1
KR_6774169806,420,2,25,-13,7,1,2,1,3,6,3,0,4,4,1,5,4,2,2,0,2,12,17,0,7,7,4,0,-1,1,-1,-1,1,4,1
KR_6758755568,420,1,1,-1,-1,1,1,0,-1,4,5,0,3,3,1,5,4,-2,1,3,-2,-6,-34,-4,9,5,-1,0,0,-1,-1,-1,-1,6,1
KR_6737697983,420,-5,-38,8,-15,-1,1,2,0,4,4,-3,1,4,-6,0,6,-5,0,5,-2,-18,-288,-6,8,2,5,0,-2,-1,1,1,-1,2,1
KR_6777850141,420,0,-23,-32,8,0,0,0,1,3,2,5,5,0,2,6,4,0,0,0,-2,15,130,0,8,8,2,0,2,1,1,1,-1,2,1
KR_6764936947,420,2,42,0,7,-4,1,5,9,9,0,1,4,3,-1,0,1,2,2,0,1,5,-1,4,5,9,5,0,1,1,1,1,1,5,1
KR_6732472410,420,-1,-11,-11,-3,-4,1,5,-1,1,2,3,4,1,-1,1,2,0,1,1,0,-2,-19,3,6,9,-6,0,0,-1,-1,0,1,1,1
KR_6772974851,420,2,-27,16,4,1,1,0,3,3,0,1,2,1,-4,1,5,3,5,2,1,5,-2,-3,11,8,3,0,1,-1,1,1,1,4,1
KR_6736417187,420,4,37,8,11,2,2,0,1,3,2,0,1,1,4,6,2,4,6,2,0,15,-20,2,7,9,8,0,1,1,1,1,1,5,1
KR_6760491827,420,0,-7,9,-2,0,1,1,-1,3,4,-1,1,2,-1,1,2,1,1,0,0,-5,6,0,4,4,-1,0,0,1,-1,0,-1,4,1
KR_6762349433,420,4,13,31,4,0,2,2,2,3,1,-3,1,4,3,3,0,2,2,0,0,13,5,2,2,4,6,0,2,1,-1,1,-1,2,1
KR_6767535783,420,10,91,22,23,5,6,1,4,5,1,15,18,3,-1,0,1,0,0,0,0,19,6,0,2,2,-1,0,3,1,-1,1,-1,1,1
KR_6767257794,420,3,-14,20,10,0,1,1,4,6,2,1,1,0,3,4,1,2,2,0,-1,2,31,0,5,5,0,0,0,0,1,0,-1,0,1
KR_6770361014,420,6,144,16,12,2,2,0,6,8,2,2,3,1,3,4,1,-1,0,1,1,9,7,2,3,5,5,0,4,1,1,1,1,5,1
KR_6771760464,420,0,18,6,3,-1,1,2,3,4,1,0,1,1,1,1,0,0,0,0,2,4,-2,1,6,7,1,0,1,1,1,1,1,2,1
KR_6699147777,420,3,69,14,5,-1,0,1,0,7,7,1,2,1,6,7,1,-1,0,1,0,7,-41,-1,7,6,11,0,1,1,-1,1,1,3,1
KR_6734935006,420,3,-4,-13,13,5,6,1,3,5,2,-1,2,3,6,7,1,0,1,1,1,23,55,2,8,10,-1,0,1,-1,1,1,1,6,1
KR_6776422162,420,3,2,1,5,-2,2,4,4,7,3,3,3,0,-1,1,2,1,1,0,0,-1,-206,-1,6,5,0,0,0,1,1,0,1,4,1
KR_6765501409,420,3,1,35,8,2,2,0,2,2,0,7,7,0,-4,1,5,1,2,1,0,11,23,5,2,7,-3,0,1,1,1,1,-1,3,1
KR_6777684628,440,-2,-54,8,2,-4,1,5,-2,4,6,5,5,0,-1,2,3,4,5,1,0,6,-3,-1,5,4,-3,0,0,1,1,1,-1,4,1
KR_6767886893,420,1,15,32,-3,1,1,0,-6,2,8,6,8,2,-1,2,3,-3,2,5,0,-3,0,2,5,7,-3,0,0,-1,1,-1,-1,1,1
KR_6739312678,420,3,-7,7,2,-1,1,2,0,9,9,3,3,0,1,4,3,-1,3,4,0,2,-8,-3,9,6,10,0,0,-1,1,1,1,5,1
KR_6749664937,420,1,44,-24,-1,-2,3,5,1,3,2,1,4,3,0,3,3,-1,1,2,0,-9,-37,-5,14,9,5,0,0,1,-1,1,1,2,1
KR_6753685936,420,-1,24,-11,-3,2,2,0,-1,2,3,-3,0,3,-4,0,4,3,3,0,0,1,3,-2,5,3,-3,0,0,-1,1,1,-1,2,1
KR_6777887049,420,7,95,59,16,2,3,1,7,9,2,3,5,2,6,6,0,-2,0,2,1,15,33,-2,7,5,1,0,2,1,-1,1,1,4,1
KR_6764978425,420,0,-39,18,-2,1,3,2,-2,1,3,-3,1,4,3,5,2,-1,1,2,0,-11,24,3,5,8,-4,0,0,1,1,0,1,1,1
KR_6771275336,420,4,-8,32,3,1,3,2,3,4,1,-1,5,6,-1,4,5,1,3,2,-1,4,-2,0,8,8,4,0,1,1,-1,-1,-1,6,1
KR_6749034871,420,1,24,10,7,1,4,3,0,2,2,2,3,1,3,3,0,1,2,1,1,14,19,7,3,10,1,0,2,1,1,1,1,2,1
KR_6776278443,420,0,71,-3,6,1,2,1,1,4,3,9,12,3,-2,3,5,-3,0,3,1,5,23,3,5,8,1,0,0,1,1,1,1,2,1
KR_6740599165,420,1,0,27,4,-2,1,3,-2,3,5,0,1,1,8,9,1,0,1,1,0,-2,-23,-3,9,6,1,0,1,1,-1,1,-1,2,1
KR_6715258468,420,6,53,31,9,4,4,0,4,6,2,0,2,2,0,3,3,1,2,1,0,8,19,2,4,6,1,0,0,1,1,1,-1,6,1
KR_6766163251,420,-2,-4,-4,-4,0,2,2,-2,1,3,-2,1,3,-2,2,4,2,2,0,0,-1,12,-2,4,2,-6,0,0,-1,1,0,1,4,1
KR_6755503844,420,0,-31,-12,0,-1,2,3,4,4,0,2,4,2,-5,1,6,0,0,0,0,4,-13,1,4,5,4,0,-1,0,-1,-1,-1,0,1
KR_6761571693,420,-2,-37,-44,-5,-4,1,5,2,6,4,-3,0,3,0,2,2,0,1,1,0,-3,-164,-3,7,4,0,0,-1,-1,1,-1,1,3,1
KR_6777356075,420,-1,34,-6,-3,-1,1,2,-2,1,3,-2,2,4,2,4,2,0,0,0,0,0,-17,3,7,10,0,0,0,-1,1,-1,1,4,1
KR_6740116233,440,-1,-19,-12,4,3,5,2,4,5,1,1,1,0,-3,2,5,-1,1,2,0,12,-7,0,7,7,10,0,-1,-1,-1,-1,1,4,1
KR_6732052196,420,2,-5,21,3,-3,1,4,0,4,4,4,7,3,3,3,0,-1,1,2,0,7,-64,0,7,7,-4,0,0,1,-1,0,1,5,1
KR_6699613858,420,1,8,-19,7,0,1,1,3,5,2,0,0,0,4,5,1,0,1,1,1,13,4,3,7,10,-1,0,2,1,1,1,1,4,1
KR_6769258444,440,4,50,-2,4,0,1,1,-1,5,6,4,5,1,-5,2,7,6,6,0,0,-1,3,1,5,6,1,0,1,1,-1,1,1,4,1
KR_6776461628,420,4,-41,-2,2,-1,3,4,5,7,2,0,3,3,-2,0,2,0,0,0,0,9,-39,-7,11,4,29,0,0,-1,-1,-1,-1,4,1
KR_6747265624,420,-3,40,-24,-5,0,1,1,-3,2,5,-1,3,4,-1,6,7,0,1,1,0,-3,-45,-3,7,4,1,0,0,1,-1,-1,-1,5,1
KR_6773399465,420,3,26,12,3,3,4,1,6,7,1,-4,0,4,0,2,2,-2,1,3,0,4,4,-2,9,7,-7,0,1,-1,0,1,1,5,1
KR_6777056082,420,3,56,19,0,4,5,1,-4,2,6,2,4,2,-1,2,3,-1,1,2,1,-2,28,3,6,9,-4,0,-1,1,1,-1,1,5,1
KR_6777156292,420,-1,-34,5,-4,-7,1,8,1,2,1,0,1,1,0,1,1,2,2,0,-1,-2,-1,-4,9,5,2,0,0,1,-1,0,-1,5,1
KR_6749182693,420,1,-6,8,0,-2,0,2,-1,0,1,2,3,1,1,1,0,0,0,0,0,0,-13,-4,7,3,2,0,0,1,-1,0,-1,6,1
KR_6728630511,420,4,85,17,7,-1,1,2,4,4,0,0,1,1,4,7,3,0,0,0,0,3,3,2,4,6,4,0,0,1,1,1,1,2,1
KR_6769247521,420,-3,4,25,-1,3,3,0,-1,0,1,4,5,1,-6,0,6,-1,0,1,1,-5,1,8,3,11,-1,0,0,-1,1,0,1,3,1
KR_6740478702,420,3,51,27,5,3,3,0,0,3,3,0,1,1,1,5,4,1,2,1,0,5,16,-8,16,8,2,0,2,1,1,1,1,3,1
KR_6744408028,440,2,3,4,6,3,3,0,0,1,1,3,4,1,5,7,2,-5,1,6,1,5,-1,3,4,7,-1,0,0,1,-1,-1,1,5,1
KR_6776625071,420,2,60,-18,2,-1,0,1,2,5,3,3,3,0,-2,0,2,0,1,1,-2,-4,289,2,6,8,0,0,1,1,1,1,-1,1,1
KR_6729526659,420,1,28,14,-2,-1,1,2,-3,1,4,-2,3,5,4,5,1,0,1,1,0,3,-25,3,8,11,-4,0,-1,1,-1,-1,-1,6,1
KR_6764619378,420,2,-41,4,6,1,3,2,5,7,2,1,3,2,1,3,2,-2,0,2,0,11,16,2,7,9,-3,0,1,1,-1,1,1,6,1
KR_6775271797,420,5,90,-2,9,2,3,1,1,2,1,1,3,2,4,7,3,1,1,0,0,13,3,5,4,9,2,0,2,1,1,1,1,5,1
KR_6772343658,420,6,80,10,16,5,6,1,5,6,1,4,4,0,2,3,1,0,0,0,0,9,0,0,5,5,4,0,4,1,1,1,1,3,1
KR_6774557244,420,1,27,8,4,1,1,0,-5,2,7,4,6,2,2,4,2,2,2,0,0,1,0,-2,8,6,3,0,0,-1,1,0,1,1,1
KR_6770120011,420,5,28,51,15,1,2,1,5,5,0,5,5,0,2,4,2,2,2,0,0,11,21,2,3,5,-2,0,1,1,1,1,1,3,1
KR_6774420730,420,4,61,-11,10,3,4,1,3,3,0,0,2,2,4,5,1,0,1,1,0,13,-2,5,7,12,3,0,-1,1,-1,1,1,6,1
KR_6709167613,420,10,126,37,13,2,3,1,6,7,1,4,4,0,0,1,1,1,1,0,0,11,6,4,5,9,4,0,4,1,1,1,1,5,1
KR_6772838853,420,2,-15,4,10,2,3,1,-1,2,3,2,3,1,6,6,0,1,2,1,0,21,10,3,6,9,0,0,3,-1,1,1,1,6,1
KR_6736518566,420,-1,12,12,4,2,3,1,1,5,4,-3,1,4,4,5,1,0,0,0,0,4,11,4,4,8,-5,0,0,-1,1,0,1,1,1
KR_6775463794,420,2,10,16,4,1,2,1,5,6,1,1,4,3,-3,1,4,0,0,0,0,7,42,3,3,6,-22,0,0,-1,-1,1,-1,6,1
KR_6733174924,420,1,-8,25,3,3,3,0,1,1,0,-1,1,2,1,1,0,-1,0,1,0,4,-2,0,7,7,3,0,1,-1,1,1,-1,1,1
KR_6774981497,420,1,-45,-13,5,-2,0,2,-2,2,4,5,6,1,3,4,1,1,2,1,0,5,235,2,8,10,0,0,0,1,1,-1,-1,2,1
KR_6760205504,420,3,70,-19,4,3,4,1,0,8,8,0,1,1,1,4,3,0,1,1,0,-6,1,2,3,5,3,0,1,1,-1,1,1,4,1
KR_6773474590,440,0,-15,-23,1,-1,3,4,-5,0,5,0,0,0,2,4,2,5,6,1,0,3,31,0,5,5,5,0,-1,1,-1,1,1,6,1
KR_6773294794,420,4,27,38,14,4,4,0,3,5,2,5,6,1,0,3,3,2,3,1,0,19,36,2,5,7,6,0,1,-1,1,1,1,4,1
KR_6751261745,420,-3,-36,-34,0,-3,0,3,0,3,3,0,1,1,1,3,2,2,2,0,1,2,21,-2,7,5,-1,0,0,1,-1,0,1,5,1
KR_6772768991,420,5,40,7,12,1,2,1,1,2,1,1,3,2,7,8,1,2,2,0,1,8,0,-2,5,3,3,0,1,1,1,1,1,4,1
KR_6726063317,420,9,117,40,17,4,5,1,5,8,3,1,2,1,7,8,1,0,1,1,1,9,2,2,5,7,4,0,3,1,1,1,1,6,1
KR_6772493587,440,1,-19,2,6,-1,0,1,6,8,2,-1,2,3,-4,3,7,6,7,1,0,-2,-30,4,2,6,-2,0,0,1,1,1,1,2,1
KR_6776487960,420,3,70,-1,7,3,3,0,-1,2,3,3,7,4,3,4,1,-1,1,2,0,9,32,3,4,7,-4,0,2,1,1,1,-1,2,1
KR_6770621993,420,7,101,14,19,4,5,1,6,7,1,1,2,1,8,8,0,0,0,0,0,20,20,7,2,9,-1,0,2,1,1,1,1,5,1
KR_6777615817,420,5,50,45,0,1,5,4,2,5,3,3,3,0,-5,3,8,-1,0,1,-3,-7,4,-2,6,4,-1,0,1,-1,1,1,-1,1,1
KR_6684583565,420,3,39,8,9,3,3,0,2,4,2,-3,1,4,11,13,2,-4,0,4,-3,4,6,6,5,11,-1,0,1,1,1,1,-1,6,1
KR_6734124669,420,0,-25,0,-3,4,7,3,-2,0,2,-2,2,4,-3,0,3,0,1,1,0,-15,-7,-8,13,5,6,0,0,1,-1,-1,1,3,1
KR_6750119992,420,-2,25,26,-5,-4,0,4,-1,4,5,1,2,1,1,1,0,-2,0,2,0,0,13,1,6,7,-3,0,-1,1,-1,-1,1,6,1
KR_6710749334,420,3,9,19,6,0,1,1,5,7,2,-2,1,3,1,6,5,2,2,0,0,19,8,-3,11,8,-2,0,1,-1,1,1,1,2,1
KR_6775249314,420,1,-33,12,4,-1,1,2,3,7,4,2,8,6,-1,3,4,1,2,1,-2,7,30,-2,9,7,-2,0,-1,-1,-1,-1,1,1,1
KR_6756393671,420,2,40,26,11,4,8,4,0,4,4,1,3,2,1,3,2,5,5,0,2,15,8,0,7,7,-4,0,2,1,1,1,1,4,1
KR_6751668976,420,2,-7,-40,15,3,6,3,8,8,0,2,2,0,0,4,4,2,4,2,0,26,-2,7,1,8,-2,0,-1,1,-1,-1,1,4,1
KR_6771266229,420,3,19,-12,4,4,5,1,-3,0,3,-1,3,4,2,5,3,2,3,1,0,-2,5,3,5,8,-4,0,2,0,1,1,1,0,1
KR_6717760793,420,5,57,32,11,-1,0,1,3,4,1,1,3,2,8,8,0,0,1,1,0,15,-31,-3,6,3,-5,0,0,-1,-1,1,1,5,1
KR_6775649377,420,2,20,5,11,-2,2,4,5,6,1,-1,2,3,7,9,2,2,2,0,-1,20,-17,2,6,8,2,0,2,-1,1,1,-1,4,1
KR_6775787576,420,0,7,32,7,0,1,1,5,6,1,3,7,4,0,2,2,-1,1,2,-1,11,-18,3,3,6,-4,0,0,1,-1,1,-1,6,1
KR_6775444384,420,0,5,20,-2,2,2,0,-3,3,6,1,1,0,2,6,4,-4,0,4,0,-2,9,-3,7,4,8,0,0,-1,1,1,-1,6,1
KR_6774014654,440,-2,31,-16,-3,2,4,2,1,3,2,-1,1,2,-5,2,7,0,1,1,0,-9,-2,1,3,4,0,0,-1,-1,1,1,-1,1,1
KR_6774260712,420,-3,-1,-10,-5,1,3,2,1,1,0,-2,1,3,-1,0,1,-4,0,4,0,-7,-27,-6,8,2,2,0,0,0,-1,0,-1,0,1
KR_6752975673,420,6,65,13,16,7,7,0,3,5,2,7,8,1,1,4,3,-2,3,5,0,6,-9,-6,9,3,7,0,2,-1,1,1,1,5,1
KR_6777819834,420,2,44,15,5,1,1,0,3,4,1,1,2,1,1,4,3,-1,0,1,0,9,1,-3,10,7,7,0,1,-1,1,1,1,5,1
KR_6697430983,420,-2,-18,10,-1,-1,1,2,8,8,0,-4,1,5,-3,2,5,-1,1,2,1,-5,-5,0,8,8,-4,0,1,-1,1,1,1,3,1
KR_6768830624,440,4,14,17,10,0,2,2,2,4,2,2,4,2,1,2,1,5,6,1,0,15,9,-1,5,4,-1,0,-1,1,1,-1,1,3,1
KR_6769603643,420,1,14,20,3,3,5,2,4,4,0,-3,1,4,-2,0,2,1,1,0,0,-2,-90,2,5,7,6,0,0,-1,1,0,-1,2,1
KR_6760583726,420,2,6,-9,4,2,3,1,0,4,4,-1,2,3,4,4,0,-1,0,1,0,5,1,4,6,10,-4,0,2,1,1,1,1,5,1
KR_6755963601,420,0,-12,2,1,3,3,0,2,2,0,0,1,1,-4,0,4,0,0,0,0,-1,109,0,6,6,2,0,0,1,1,-1,-1,4,1
KR_6768710894,420,3,93,9,12,3,4,1,6,12,6,-1,0,1,3,6,3,1,2,1,2,11,-111,0,5,5,4,0,3,1,1,1,1,6,1
KR_6761555971,420,5,14,16,7,5,5,0,1,3,2,3,6,3,-4,0,4,2,2,0,0,1,30,0,5,5,1,0,0,1,1,-1,1,2,1
KR_6733605945,420,1,-9,-1,-4,0,1,1,-3,2,5,-4,1,5,3,4,1,0,1,1,0,1,134,-2,6,4,2,0,-1,1,-1,-1,-1,6,1
KR_6764492750,420,1,-4,16,5,2,2,0,0,2,2,3,4,1,1,3,2,-1,0,1,0,15,5,-2,7,5,1,0,-1,1,-1,-1,1,5,1
KR_6744794552,420,0,-23,4,2,1,4,3,0,3,3,1,1,0,-1,1,2,1,1,0,0,-6,0,-1,8,7,-2,0,0,1,1,1,-1,6,1
KR_6772509827,420,5,6,36,13,0,2,2,-1,3,4,8,8,0,4,4,0,2,2,0,1,16,28,3,5,8,0,0,1,1,1,1,1,4,1
KR_6750200364,420,1,25,4,3,2,4,2,0,2,2,2,5,3,-2,0,2,1,1,0,0,0,-8,-3,9,6,9,0,2,-1,-1,1,1,4,1
KR_6740042505,440,1,-60,-13,-2,-2,3,5,1,5,4,0,1,1,3,8,5,-4,1,5,1,1,1,7,3,10,-3,0,-1,-1,1,-1,-1,1,1
KR_6772589696,420,0,9,-8,2,1,3,2,0,1,1,3,4,1,-1,0,1,-1,1,2,0,5,1,-2,6,4,4,0,0,-1,-1,-1,-1,1,1
KR_6775602558,420,-1,-6,20,0,-2,1,3,2,5,3,-2,1,3,1,5,4,1,3,2,-1,-1,-9,2,6,8,3,0,0,1,-1,0,-1,5,1
KR_6638305783,420,2,46,-6,2,0,2,2,4,5,1,-1,1,2,1,1,0,-2,0,2,0,3,39,-1,9,8,4,0,1,1,1,1,1,6,1
KR_6757440996,420,2,41,15,10,-2,0,2,1,3,2,9,10,1,0,0,0,2,2,0,0,9,17,4,2,6,-1,0,-1,1,-1,1,1,2,1
KR_6744700905,420,4,7,8,12,-5,0,5,10,10,0,2,5,3,2,3,1,3,3,0,0,20,-4,-5,8,3,7,0,1,1,-1,1,1,1,1
KR_6758601313,420,0,33,5,4,-2,1,3,2,5,3,4,5,1,1,3,2,-1,0,1,-1,1,-44,2,7,9,-1,0,1,1,1,1,-1,3,1
KR_6664048646,420,3,47,20,9,3,3,0,3,4,1,0,1,1,0,4,4,3,4,1,0,6,8,3,5,8,4,0,2,-1,1,1,1,4,1
KR_6770022096,420,2,87,1,16,0,3,3,5,9,4,5,6,1,9,11,2,-3,0,3,1,15,9,5,1,6,0,0,4,1,-1,1,1,6,1
KR_6775468390,440,1,7,-8,8,0,1,1,1,5,4,0,2,2,3,3,0,4,4,0,1,5,-4,1,4,5,3,0,2,-1,1,1,1,6,1
KR_6776088986,420,2,-37,0,7,-3,0,3,0,1,1,4,5,1,5,5,0,1,1,0,0,15,-11,1,7,8,9,0,0,1,1,-1,-1,3,1
KR_6777123280,420,3,-15,8,7,-2,0,2,1,1,0,5,6,1,2,3,1,1,3,2,0,16,-35,1,6,7,2,0,0,-1,1,0,1,1,1
KR_6765589549,420,3,-15,1,10,3,3,0,-3,0,3,4,5,1,2,2,0,4,5,1,0,19,-2,-1,8,7,0,0,0,-1,1,0,1,1,1
KR_6718304620,420,4,24,32,7,-1,1,2,1,3,2,6,7,1,2,3,1,-1,1,2,0,13,3,-6,10,4,-2,0,1,1,-1,1,1,6,1
KR_6768565915,420,2,-17,36,0,1,1,0,1,6,5,1,3,2,0,5,5,-3,0,3,0,1,1,0,7,7,3,0,-2,1,-1,-1,-1,5,1
KR_6758203781,420,0,13,-11,1,0,1,1,0,5,5,3,3,0,-1,2,3,-1,1,2,0,1,-5,3,4,7,-8,0,0,-1,-1,-1,1,4,1
KR_6776507811,420,4,-8,25,16,-3,0,3,4,5,1,2,5,3,4,7,3,9,11,2,1,15,12,3,8,11,1,0,2,1,1,1,1,2,1
KR_6777112472,420,-4,-24,-15,-2,-5,1,6,4,5,1,1,3,2,-1,3,4,-1,1,2,0,2,23,-3,9,6,7,0,-1,-1,-1,-1,1,6,1
KR_6777053072,420,2,66,-19,6,-3,0,3,1,4,3,1,1,0,6,6,0,1,1,0,0,9,10,0,6,6,-1,0,0,1,-1,-1,1,4,1
KR_6710270830,440,5,76,36,-5,2,2,0,0,3,3,-2,1,3,-4,1,5,-1,2,3,0,-10,13,2,2,4,-2,0,2,-1,1,1,-1,1,1
KR_6772865259,420,3,22,75,4,1,1,0,3,3,0,4,5,1,-2,5,7,-2,0,2,0,-2,-13,-4,9,5,4,0,0,1,1,-1,-1,2,1
KR_6744152501,420,1,44,19,2,0,1,1,2,3,1,1,3,2,1,4,3,-2,0,2,0,7,14,1,5,6,-2,0,1,1,1,1,-1,2,1
KR_6770212036,420,2,25,-27,12,8,8,0,2,4,2,-2,1,3,5,6,1,-1,0,1,0,12,4,-1,6,5,2,0,1,-1,1,1,1,2,1
KR_6742907832,420,2,0,0,-1,2,2,0,-6,3,9,2,3,1,0,2,2,1,1,0,0,-7,-4,1,4,5,-3,0,1,-1,1,1,-1,5,1
KR_6777073303,420,-1,-13,-15,-3,2,4,2,3,5,2,-1,1,2,-3,0,3,-4,1,5,0,-6,42,3,5,8,-26,0,1,-1,1,1,-1,3,1
KR_6760441324,420,1,44,-14,-5,3,4,1,-3,2,5,-1,2,3,-5,0,5,1,1,0,0,-4,-6,-5,13,8,3,0,0,-1,1,1,-1,1,1
KR_6736971972,420,4,34,36,2,2,4,2,2,4,2,1,2,1,-3,0,3,0,0,0,0,-6,-18,-3,5,2,1,0,0,1,1,1,1,5,1
KR_6769716717,440,3,12,4,5,3,4,1,2,3,1,-2,0,2,2,3,1,0,0,0,0,5,-48,-1,8,7,1,0,0,-1,-1,0,-1,1,1
KR_6768818469,420,4,66,34,10,3,3,0,3,4,1,6,6,0,-2,4,6,0,0,0,0,16,11,-1,7,6,4,0,0,1,1,1,1,1,1
KR_6721397594,420,0,36,-16,1,-2,2,4,2,3,1,-1,1,2,1,2,1,1,1,0,0,8,8,0,6,6,-5,0,0,-1,1,0,-1,1,1
KR_6765239934,420,1,7,17,4,-2,1,3,3,4,1,1,3,2,2,4,2,0,2,2,0,5,2,2,5,7,-2,0,1,1,-1,1,-1,2,1
KR_6776934010,420,5,-4,37,6,-1,3,4,0,4,4,2,2,0,2,4,2,3,3,0,0,12,-12,-1,8,7,-2,0,0,-1,-1,-1,-1,3,1
KR_6768818754,420,3,21,-2,8,1,3,2,-1,0,1,3,4,1,7,9,2,-2,1,3,0,19,0,0,5,5,-2,0,2,1,1,1,1,6,1
KR_6766806527,420,5,88,1,12,2,2,0,3,6,3,6,6,0,5,5,0,-4,0,4,2,9,31,7,2,9,-3,0,1,1,1,1,1,6,1
KR_6742407383,420,1,-19,0,5,7,10,3,-2,2,4,2,2,0,-3,3,6,1,2,1,1,4,2,-1,5,4,1,0,0,1,-1,0,1,4,1
KR_6736663423,420,1,26,-1,6,2,2,0,-3,0,3,2,3,1,4,6,2,1,1,0,0,13,13,7,6,13,24,0,1,-1,1,1,1,3,1
KR_6775428187,420,2,35,-16,2,-2,0,2,-2,2,4,6,7,1,1,3,2,-1,0,1,0,3,-20,-3,8,5,6,0,1,-1,1,1,1,4,1
KR_6765993096,420,3,7,22,8,-1,2,3,0,3,3,6,8,2,4,5,1,-1,0,1,0,5,160,-1,6,5,-5,0,1,1,1,1,1,1,1
KR_6772499269,420,1,19,-12,4,-2,2,4,0,3,3,2,3,1,2,5,3,2,3,1,1,8,2,-4,10,6,-2,0,1,1,1,1,1,1,1
KR_6776899171,420,2,3,20,8,2,2,0,4,4,0,1,2,1,1,3,2,0,2,2,0,17,13,5,6,11,2,0,0,-1,1,0,1,4,1
KR_6727900129,420,-1,27,20,-5,-3,1,4,0,3,3,0,1,1,-3,0,3,1,2,1,0,-8,-12,-4,9,5,4,0,0,-1,-1,0,-1,4,1
KR_6772746940,420,1,6,-4,6,3,4,1,-2,3,5,0,7,7,6,7,1,-1,0,1,0,6,2,1,5,6,-2,0,0,1,-1,0,-1,3,1
KR_6744904529,420,2,82,1,4,0,2,2,-2,7,9,1,2,1,6,7,1,-1,1,2,0,2,-8,-2,10,8,6,0,3,-1,-1,1,1,5,1
KR_6736454465,420,1,34,3,2,3,4,1,1,4,3,-4,1,5,2,2,0,0,0,0,1,-1,1,-5,11,6,-3,0,2,1,1,1,1,3,1
KR_6736994035,420,0,27,-15,2,-1,2,3,4,7,3,1,2,1,3,3,0,-5,0,5,0,1,7,6,2,8,-2,0,1,1,-1,1,1,4,1
KR_6729487190,420,3,74,19,5,3,3,0,3,3,0,-4,0,4,3,4,1,0,1,1,1,11,38,0,7,7,7,0,1,-1,-1,1,1,6,1
KR_6775723325,420,1,36,-6,1,3,4,1,1,3,2,-2,2,4,1,1,0,-2,0,2,0,-2,-2,1,7,8,2,0,1,1,1,1,1,3,1
KR_6776601266,420,0,43,23,2,-2,0,2,0,2,2,-1,1,2,5,8,3,0,0,0,0,6,-5,-1,7,6,2,0,0,1,1,1,1,4,1
KR_6777442757,420,2,5,2,5,-1,2,3,3,6,3,1,2,1,1,2,1,1,1,0,0,2,8,3,8,11,-3,0,0,1,1,0,1,5,1
KR_6775895583,420,1,-15,2,-1,2,3,1,0,2,2,-1,5,6,-3,3,6,1,1,0,0,-3,-26,1,6,7,-1,0,0,-1,1,-1,1,2,1
KR_6775439929,420,2,61,19,4,-2,1,3,5,6,1,3,3,0,0,2,2,-2,0,2,1,10,3,0,6,6,0,0,0,1,-1,0,1,2,1
KR_6758250657,420,-1,-9,-16,-2,1,6,5,-3,1,4,3,4,1,-2,2,4,-1,0,1,-1,-3,6,6,5,11,-4,0,1,1,1,1,1,3,1
KR_6775817504,420,3,-34,0,11,3,3,0,1,4,3,3,7,4,3,5,2,1,2,1,0,10,3,-5,11,6,2,0,0,-1,1,0,1,3,1
KR_6775504995,420,2,16,22,11,2,2,0,-5,0,5,1,1,0,14,16,2,-1,2,3,2,12,-48,0,5,5,33,0,0,1,1,-1,1,4,1
KR_6776653089,420,0,-34,-9,1,-1,1,2,-2,1,3,2,4,2,0,2,2,2,4,2,-1,-5,7,0,8,8,-2,0,0,-1,1,1,-1,3,1
KR_6751168930,420,3,-33,25,4,3,3,0,1,2,1,-3,2,5,3,8,5,0,0,0,0,10,-15,-1,9,8,-1,0,0,-1,-1,-1,-1,5,1
KR_6733195709,440,2,49,7,6,2,3,1,-1,1,2,3,3,0,2,3,1,0,2,2,0,2,-12,-1,5,4,7,0,0,-1,-1,1,1,1,1
KR_6771881188,420,-1,45,-23,-2,1,3,2,-2,3,5,-1,1,2,0,2,2,0,0,0,1,-2,-4,2,9,11,4,0,-1,1,-1,-1,1,5,1
KR_6767936576,420,1,60,25,0,3,4,1,3,5,2,1,2,1,-5,2,7,-2,0,2,0,-4,-6,-3,9,6,5,0,1,1,1,1,-1,2,1
KR_6772614233,420,7,122,38,10,3,3,0,4,6,2,-4,0,4,4,7,3,3,4,1,0,15,-17,-4,8,4,1,0,3,1,-1,1,-1,3,1
KR_6776904967,420,2,-14,15,6,0,0,0,-1,0,1,-2,0,2,7,7,0,2,3,1,-1,2,1,4,6,10,2,0,0,-1,1,0,-1,2,1
KR_6769164304,420,2,8,-31,12,4,4,0,7,9,2,0,4,4,1,2,1,0,2,2,0,19,-8,6,3,9,1,0,1,1,0,1,1,4,1
KR_6775209208,420,0,3,0,-5,-3,1,4,-5,0,5,-2,3,5,3,6,3,2,2,0,0,-5,2,0,8,8,2,0,-2,1,-1,-1,-1,1,1
KR_6739437447,420,-1,-70,2,5,0,3,3,3,4,1,0,2,2,1,3,2,1,3,2,0,14,118,-3,8,5,3,0,-1,-1,1,-1,1,5,1
KR_6752559363,420,-1,0,17,-2,-5,2,7,0,1,1,0,1,1,0,1,1,3,3,0,0,5,74,2,5,7,-1,0,-2,1,-1,-1,-1,6,1
KR_6774723547,420,0,23,16,0,-2,1,3,0,2,2,1,3,2,1,3,2,0,0,0,0,7,4,0,11,11,0,0,-1,-1,-1,-1,-1,6,1
KR_6777693284,420,3,7,-4,9,3,3,0,6,7,1,1,1,0,-2,1,3,1,1,0,0,11,-9,0,10,10,1,0,0,1,1,1,1,5,1
KR_6742575141,420,-1,61,6,2,2,5,3,-3,4,7,0,3,3,3,9,6,0,2,2,3,4,11,6,7,13,-2,0,2,1,1,1,1,3,1
KR_6741258076,420,-1,-51,-7,4,-1,2,3,2,3,1,3,5,2,0,3,3,0,1,1,0,7,40,-1,10,9,-4,0,-1,1,-1,-1,-1,6,1
KR_6740277783,420,4,36,18,6,0,2,2,6,10,4,0,3,3,1,6,5,-1,3,4,-1,9,3,-10,13,3,2,0,3,-1,1,1,-1,4,1
KR_6777508414,420,3,15,-12,12,1,2,1,3,6,3,6,7,1,0,2,2,2,2,0,0,11,-214,-2,8,6,0,0,0,-1,1,1,1,6,1
KR_6735796383,420,-4,-45,-13,-5,-3,0,3,3,8,5,-9,0,9,2,3,1,2,2,0,-1,3,-1,-1,6,5,-6,0,0,1,1,0,-1,4,1
KR_6767923909,420,5,63,4,8,2,4,2,1,4,3,3,5,2,1,3,2,1,1,0,0,13,-33,-5,8,3,13,0,2,1,1,1,1,5,1
KR_6772282876,420,0,64,-19,8,7,7,0,0,2,2,0,2,2,-1,2,3,2,2,0,0,2,6,1,5,6,5,0,1,1,1,1,1,5,1
KR_6731167110,420,0,-61,9,10,0,1,1,0,3,3,2,3,1,5,7,2,3,3,0,0,12,8,0,5,5,-5,0,1,1,-1,1,1,1,1
KR_6776131563,420,1,34,32,3,4,5,1,-1,0,1,2,4,2,-3,3,6,1,3,2,0,0,-23,1,6,7,1,0,0,1,1,-1,-1,5,1
KR_6776753584,420,0,50,-4,7,0,1,1,-2,2,4,3,5,2,6,6,0,0,0,0,-1,12,163,2,6,8,-2,0,1,1,1,1,-1,1,1
KR_6720868222,420,1,86,15,-4,-2,0,2,-7,1,8,3,5,2,1,2,1,1,2,1,0,-16,-8,1,6,7,2,0,3,1,1,1,1,4,1
KR_6775270906,420,6,0,52,15,3,4,1,7,7,0,1,2,1,5,5,0,-1,0,1,1,12,24,2,7,9,-1,0,2,1,1,1,1,3,1
KR_6762792080,420,4,5,6,15,2,5,3,1,7,6,9,9,0,2,4,2,1,1,0,1,15,-1,-3,6,3,1,0,2,1,1,1,1,3,1
KR_6763223836,420,-3,-25,-13,-6,4,5,1,-4,1,5,1,3,2,-2,0,2,-5,0,5,0,-14,-40,0,6,6,-1,0,1,-1,1,1,-1,4,1
KR_6777562578,420,3,113,1,-1,-3,2,5,-2,2,4,4,4,0,-2,2,4,2,2,0,0,-2,-5,4,3,7,5,0,1,1,1,1,-1,4,1
KR_6709239804,420,2,40,-8,2,2,2,0,3,6,3,0,3,3,-2,1,3,-1,0,1,0,3,-10,2,6,8,9,0,0,1,-1,-1,1,5,1
KR_6776613679,420,5,64,24,10,2,3,1,7,12,5,-1,0,1,2,3,1,0,1,1,0,13,-3,1,9,10,1,0,2,1,-1,1,1,3,1
KR_6754610551,420,1,68,-4,-3,2,3,1,-4,1,5,-2,3,5,2,3,1,-1,1,2,0,-8,-12,-3,12,9,-6,0,1,-1,-1,1,-1,6,1
KR_6755383542,420,-1,-10,-29,6,0,2,2,-1,0,1,1,3,2,4,5,1,2,2,0,0,16,4,5,2,7,4,0,1,0,1,-1,1,0,1
KR_6764579696,420,0,-47,11,9,-4,1,5,3,5,2,2,5,3,8,9,1,0,1,1,2,22,28,-3,8,5,2,0,0,-1,1,1,1,5,1
KR_6746371791,420,6,115,57,11,4,5,1,-1,2,3,4,4,0,3,5,2,1,3,2,3,10,223,4,4,8,6,0,2,1,1,1,1,5,1
KR_6733695631,420,0,-26,-11,4,0,2,2,2,3,1,0,3,3,3,6,3,-1,0,1,0,2,-8,4,7,11,-3,0,0,-1,1,1,1,4,1
KR_6772831042,420,0,56,31,-6,-2,3,5,-3,2,5,-1,0,1,0,5,5,0,3,3,-1,-17,9,-1,8,7,3,0,1,0,1,1,-1,0,1
KR_6773918813,420,-3,12,-12,-3,1,2,1,-1,2,3,-4,2,6,0,3,3,1,2,1,0,-5,2,-1,4,3,-2,0,-1,1,-1,-1,1,4,1
KR_6745122649,420,0,39,0,2,2,5,3,-2,1,3,1,5,4,1,2,1,0,1,1,0,-2,3,1,7,8,-4,0,1,1,1,1,1,5,1
KR_6777791680,420,1,18,20,3,-6,0,6,1,2,1,2,3,1,5,6,1,1,1,0,-1,10,-10,2,6,8,2,0,0,1,1,1,-1,1,1
KR_6768317820,420,3,44,12,12,0,1,1,3,3,0,1,1,0,5,5,0,3,3,0,0,18,3,0,6,6,8,0,1,1,1,1,1,2,1
KR_6774990065,420,-2,-24,-35,-2,-1,0,1,-8,2,10,2,4,2,4,6,2,1,2,1,1,3,1,1,6,7,-4,0,-1,-1,1,-1,1,1,1
KR_6777173337,420,0,53,-9,1,1,3,2,-3,1,4,2,2,0,2,4,2,-1,1,2,0,1,2,0,6,6,-5,0,0,-1,-1,0,-1,3,1
KR_6774947987,420,0,-10,1,8,-1,1,2,-3,0,3,5,5,0,6,10,4,1,2,1,2,13,6,3,5,8,-5,0,1,1,-1,1,1,3,1
KR_6700577444,420,2,-4,15,6,2,3,1,2,5,3,0,2,2,0,1,1,2,2,0,0,17,9,4,2,6,-1,0,1,1,1,1,1,5,1
KR_6742404408,420,0,-19,16,-2,3,3,0,-2,5,7,-7,0,7,4,5,1,0,2,2,0,6,-8,4,9,13,4,0,-1,1,1,-1,-1,5,1
KR_6777294421,420,1,-24,3,3,0,1,1,-1,4,5,0,1,1,4,4,0,0,1,1,-1,8,-12,-1,8,7,8,0,2,1,1,1,-1,2,1
KR_6736807896,420,2,15,4,5,-1,2,3,0,1,1,4,4,0,2,4,2,0,0,0,0,13,228,-3,6,3,3,0,0,-1,1,1,1,5,1
KR_6747265988,420,-3,47,-32,-5,1,3,2,1,3,2,-7,2,9,0,2,2,0,0,0,0,-5,12,3,7,10,-9,0,0,-1,-1,0,-1,5,1
KR_6769065663,420,0,6,13,4,1,2,1,2,5,3,-2,1,3,2,4,2,1,1,0,0,8,-1,1,6,7,-1,0,1,-1,1,1,-1,5,1
KR_6744800780,420,5,90,28,13,2,3,1,8,9,1,2,2,0,3,3,0,-2,1,3,0,21,-34,2,7,9,3,0,4,1,1,1,1,3,1
KR_6753796802,420,0,-40,-23,9,-3,0,3,-1,4,5,10,11,1,4,7,3,-1,0,1,0,19,31,5,5,10,0,0,0,1,-1,-1,-1,3,1
KR_6715328048,420,0,-12,14,11,-2,0,2,0,1,1,5,5,0,3,5,2,5,7,2,0,16,-130,7,1,8,-5,0,0,-1,1,0,1,6,1
KR_6734973576,420,5,77,21,14,4,4,0,2,5,3,2,4,2,5,7,2,1,2,1,1,21,-4,0,8,8,7,0,3,1,1,1,1,5,1
KR_6740196968,420,-2,-11,-7,-4,-3,0,3,0,1,1,0,3,3,-4,0,4,3,3,0,0,0,-10,0,7,7,3,0,-1,1,1,-1,-1,1,1
KR_6762792149,420,-1,37,-33,-3,1,1,0,-3,0,3,-4,0,4,2,7,5,1,1,0,0,-6,1,1,7,8,-1,0,0,-1,1,0,-1,6,1
KR_6719869296,420,2,76,-6,6,6,6,0,-2,3,5,2,5,3,0,3,3,0,1,1,0,2,75,-2,7,5,0,0,2,1,-1,1,-1,1,1
KR_6734016291,420,0,-19,-14,0,-1,1,2,-4,2,6,-2,2,4,8,8,0,-1,1,2,0,1,-22,0,6,6,1,0,0,1,-1,0,1,1,1
KR_6736428315,420,2,81,13,7,3,3,0,3,7,4,0,3,3,1,2,1,0,0,0,1,11,7,-1,5,4,-1,0,1,1,-1,1,1,1,1
KR_6740536026,420,8,79,52,10,3,6,3,0,4,4,2,3,1,4,5,1,1,1,0,1,10,0,0,5,5,4,0,2,1,1,1,1,5,1
KR_6767560147,420,2,8,-11,5,-2,0,2,2,4,2,0,2,2,5,5,0,0,1,1,0,4,3,2,6,8,-3,0,1,-1,1,1,-1,6,1
KR_6727099072,420,-1,55,-28,-5,-2,2,4,0,2,2,2,2,0,-4,2,6,-1,0,1,0,-5,-7,-4,11,7,-4,0,-1,-1,-1,-1,1,4,1
KR_6771923383,420,0,21,8,5,2,3,1,0,6,6,3,4,1,-1,4,5,1,4,3,0,2,-7,-1,7,6,2,0,-1,1,1,-1,1,4,1
KR_6762830903,420,6,51,4,9,-1,1,2,4,4,0,1,3,2,6,9,3,-1,2,3,0,17,8,5,4,9,4,0,2,0,-1,1,1,0,1
KR_6777812083,420,0,11,-8,6,1,2,1,-1,1,2,0,1,1,6,7,1,0,2,2,0,11,-35,0,5,5,0,0,1,1,-1,1,-1,6,1
KR_6775649106,420,-1,-12,-18,1,0,3,3,4,6,2,2,4,2,-1,2,3,-4,0,4,0,5,-6,1,7,8,2,0,0,1,-1,-1,-1,5,1
KR_6743282969,420,0,-39,24,0,4,4,0,1,3,2,2,2,0,-5,0,5,-2,1,3,-1,-5,-13,0,8,8,-6,0,-1,1,-1,-1,-1,3,1
KR_6775550203,420,0,-11,5,5,2,3,1,1,4,3,8,9,1,-4,0,4,-2,0,2,1,-9,203,-4,9,5,2,0,-1,1,1,-1,1,3,1
KR_6763411354,420,8,89,45,11,4,5,1,7,7,0,2,3,1,-2,1,3,0,1,1,0,10,12,2,2,4,-4,0,2,1,1,1,1,2,1
KR_6759395927,420,4,-26,4,15,3,3,0,3,6,3,6,7,1,1,3,2,2,2,0,0,17,24,5,3,8,-2,0,0,-1,1,1,1,2,1
KR_6749011365,420,4,-10,13,11,-1,2,3,3,5,2,7,8,1,1,3,2,1,1,0,-1,6,-9,-2,6,4,7,0,0,1,1,0,-1,2,1
KR_6765155953,420,2,30,16,2,-2,3,5,8,8,0,-1,4,5,1,3,2,-4,1,5,1,6,28,-1,8,7,5,0,1,-1,1,1,1,2,1
KR_6773204757,420,-2,-43,6,1,0,2,2,1,1,0,2,4,2,-1,2,3,-1,1,2,0,6,-1,1,6,7,0,0,0,1,1,0,1,3,1
KR_6769587132,420,2,28,22,7,-2,2,4,6,6,0,1,7,6,3,4,1,-1,0,1,0,10,6,3,6,9,-2,0,2,1,1,1,-1,6,1
KR_6727786061,420,0,-19,-20,-1,2,2,0,0,1,1,-6,1,7,2,3,1,1,2,1,0,6,-21,-7,10,3,-2,0,0,-1,1,1,1,2,1
KR_6776944306,420,-2,-9,-13,-3,-2,2,4,-1,5,6,0,2,2,-1,2,3,1,1,0,0,-3,-3,-2,9,7,2,0,1,-1,1,1,1,5,1
KR_6766486558,420,6,74,12,16,3,3,0,1,2,1,2,3,1,8,9,1,2,2,0,0,17,6,3,4,7,3,1,5,1,1,1,1,6,1
KR_6766110950,420,0,-70,-3,11,0,0,0,3,3,0,7,7,0,0,2,2,1,1,0,0,15,23,3,4,7,4,0,0,-1,1,-1,1,4,1
KR_6776822832,420,3,14,8,13,1,3,2,7,7,0,0,2,2,5,7,2,0,2,2,4,18,2,9,7,16,-2,0,0,1,1,0,1,5,1
KR_6707759463,420,2,58,36,10,8,9,1,6,8,2,0,2,2,-2,4,6,-2,1,3,0,1,2,6,2,8,-5,0,1,-1,1,1,1,4,1
KR_6777197795,420,6,85,26,7,-2,1,3,1,3,2,1,2,1,4,7,3,3,3,0,0,8,13,0,4,4,0,0,4,-1,1,1,-1,6,1
KR_6762314320,420,3,47,0,14,1,4,3,3,5,2,4,5,1,4,6,2,2,2,0,0,22,2,-7,10,3,2,0,2,-1,1,1,1,3,1
KR_6776595753,420,3,28,26,-5,2,3,1,-4,2,6,-4,1,5,0,1,1,1,2,1,0,-10,-60,0,3,3,-4,0,1,-1,-1,1,-1,4,1
KR_6775689694,420,4,34,-19,6,3,3,0,0,2,2,2,3,1,0,1,1,1,2,1,0,1,98,1,5,6,9,0,1,1,-1,1,1,6,1
KR_6731437440,440,4,46,32,3,-1,2,3,5,6,1,1,5,4,-1,3,4,-1,3,4,0,4,-11,-4,6,2,3,0,-2,1,-1,-1,-1,1,1
KR_6767558949,420,2,54,1,4,0,1,1,2,4,2,2,5,3,0,5,5,0,0,0,1,-5,-2,-4,10,6,3,0,3,1,1,1,1,2,1
KR_6770883505,420,0,42,-18,2,0,1,1,1,3,2,0,4,4,-1,3,4,2,2,0,0,-2,-28,-1,5,4,1,0,0,1,-1,0,1,3,1
KR_6774945174,420,3,20,9,4,-1,2,3,-3,7,10,4,5,1,1,4,3,3,4,1,0,6,41,6,6,12,-4,0,0,1,-1,1,-1,4,1
KR_6748276994,420,-3,25,18,2,0,1,1,-1,5,6,-1,0,1,3,3,0,1,3,2,0,5,-11,-2,6,4,-1,0,-2,1,-1,-1,1,6,1
KR_6776301622,420,0,46,-17,-4,0,2,2,-6,1,7,5,7,2,-1,0,1,-2,2,4,0,3,2,2,2,4,0,0,2,1,-1,1,-1,2,1
KR_6721835770,420,0,-11,12,0,1,3,2,1,5,4,-3,0,3,1,2,1,0,0,0,0,-1,25,-2,9,7,3,0,1,-1,1,-1,1,3,1
KR_6752012860,440,2,-67,32,10,0,3,3,6,8,2,-1,1,2,3,5,2,2,3,1,-1,9,22,2,4,6,-4,0,1,1,1,1,-1,6,1
KR_6723978432,420,-1,35,16,-5,-2,3,5,-1,3,4,0,4,4,-2,1,3,0,1,1,1,-3,6,0,6,6,8,0,0,1,1,1,1,2,1
KR_6769744016,420,0,-64,37,0,1,3,2,-1,6,7,-2,0,2,4,5,1,-2,0,2,0,-1,-6,-4,11,7,-2,0,-1,1,-1,-1,-1,4,1
KR_6729202151,420,3,-10,29,7,-3,1,4,2,3,1,-1,1,2,5,6,1,4,5,1,0,7,3,4,4,8,-5,0,0,1,1,0,1,2,1
KR_6771383815,420,3,93,11,5,-2,1,3,-1,2,3,7,8,1,2,4,2,-1,0,1,0,0,-119,4,4,8,3,0,0,1,-1,1,1,1,1
KR_6776486511,420,3,25,-14,6,0,3,3,0,2,2,1,1,0,5,7,2,0,0,0,0,14,4,0,6,6,-4,0,1,1,-1,-1,-1,2,1
KR_6772639233,420,-2,-21,0,-4,-3,2,5,-3,0,3,4,6,2,-2,0,2,0,0,0,0,-3,12,-3,8,5,0,0,0,-1,1,-1,-1,2,1
KR_6775501695,420,-1,47,4,-3,2,4,2,-2,2,4,-3,1,4,1,3,2,-1,2,3,0,-6,-13,-4,9,5,-6,0,0,-1,1,0,-1,4,1
KR_6776252310,420,0,64,-3,-1,4,4,0,-2,0,2,-1,0,1,-1,5,6,-1,0,1,2,-6,20,-5,10,5,-10,0,1,-1,1,1,1,1,1
KR_6732395488,420,4,45,-3,11,2,4,2,-1,2,3,3,3,0,6,6,0,1,1,0,0,13,-14,0,5,5,1,0,2,1,1,1,1,3,1
KR_6776553187,420,1,43,33,3,2,3,1,-5,3,8,3,3,0,3,4,1,0,0,0,1,-8,9,-2,10,8,-3,0,3,1,1,1,-1,6,1
KR_6764389577,420,-1,51,-21,-4,-2,0,2,-5,0,5,1,3,2,1,2,1,1,3,2,0,-1,-5,-6,9,3,2,0,0,1,-1,0,1,6,1
KR_6764986420,420,4,20,21,8,2,2,0,3,4,1,-3,1,4,3,6,3,3,4,1,1,20,-16,5,4,9,0,0,0,-1,1,-1,1,3,1
KR_6734906142,420,5,57,27,8,2,3,1,3,4,1,-1,1,2,2,4,2,2,3,1,0,15,100,-7,12,5,9,0,2,1,1,1,1,2,1
KR_6773085750,420,2,30,40,3,1,2,1,5,5,0,-3,2,5,2,2,0,-2,0,2,0,8,3,-1,9,8,1,0,1,1,1,1,1,6,1
KR_6744339074,420,0,26,-35,0,-3,2,5,1,4,3,-5,0,5,3,5,2,4,4,0,-1,1,-7,-2,8,6,-2,0,1,-1,1,1,-1,3,1
KR_6761853719,420,3,59,12,9,5,5,0,5,5,0,0,0,0,-3,2,5,2,2,0,0,13,-14,-5,11,6,3,0,2,1,1,1,-1,2,1
KR_6753904244,420,7,124,24,12,4,4,0,6,8,2,6,6,0,-1,1,2,-3,1,4,0,7,-4,4,1,5,0,0,3,1,1,1,-1,4,1
KR_6777009379,420,1,-23,-17,3,1,2,1,2,3,1,-1,3,4,0,2,2,1,1,0,0,2,33,-2,6,4,-10,0,2,-1,1,1,1,4,1
KR_6748424141,420,-2,-9,-20,-4,-1,1,2,-3,2,5,-2,0,2,2,5,3,0,0,0,0,-1,1,0,6,6,-2,0,-3,1,-1,-1,-1,4,1
KR_6755039771,420,2,12,4,10,0,2,2,1,3,2,8,8,0,2,4,2,-1,2,3,0,23,-32,-1,7,6,23,0,2,1,1,1,1,5,1
KR_6732962581,420,7,136,19,21,7,8,1,5,7,2,0,2,2,7,9,2,2,3,1,1,15,2,-1,5,4,3,0,3,1,1,1,1,4,1
KR_6757275433,420,-1,-30,-11,2,0,1,1,2,3,1,-2,0,2,-2,2,4,4,4,0,0,1,0,2,6,8,2,0,-1,-1,-1,-1,1,5,1
KR_6775120894,420,4,33,20,6,0,0,0,-1,0,1,12,13,1,-5,0,5,0,0,0,0,2,-11,-2,6,4,3,0,3,1,1,1,1,4,1
KR_6774912694,420,0,45,-8,2,1,2,1,0,4,4,2,4,2,0,2,2,-1,1,2,0,11,-3,0,8,8,-1,0,1,-1,1,1,-1,6,1
KR_6746659488,420,3,-17,52,9,0,0,0,4,7,3,0,2,2,3,4,1,2,3,1,0,17,-19,1,5,6,0,0,1,1,-1,1,-1,5,1
KR_6763791393,420,0,42,17,6,-2,2,4,2,3,1,2,5,3,4,7,3,0,0,0,0,-1,5,0,6,6,-4,0,1,1,1,1,1,4,1
KR_6774855488,420,2,72,4,5,5,5,0,-3,1,4,-1,0,1,3,3,0,1,2,1,0,3,1,1,4,5,3,0,2,1,1,1,-1,3,1
KR_6768487525,420,2,35,16,5,1,3,2,4,4,0,1,2,1,2,3,1,-3,0,3,-2,8,-10,1,5,6,3,0,2,1,1,1,-1,1,1
KR_6776622842,420,2,28,30,8,4,5,1,8,8,0,-2,1,3,-3,1,4,1,3,2,0,-3,1,4,3,7,-3,0,-1,1,-1,-1,1,3,1
KR_6757007829,420,4,31,28,7,1,4,3,0,3,3,3,3,0,3,3,0,0,0,0,0,8,117,0,7,7,3,0,0,1,-1,0,-1,2,1
KR_6773270180,420,3,97,3,7,3,4,1,-2,4,6,4,5,1,1,3,2,1,2,1,0,4,-9,-3,8,5,8,0,-1,-1,-1,-1,1,6,1
KR_6755129353,420,0,-16,-10,-2,0,2,2,1,1,0,-4,2,6,0,2,2,1,1,0,1,-9,3,-3,7,4,2,0,1,1,1,1,1,6,1
KR_6731126562,420,5,-53,-41,8,3,4,1,-3,0,3,-3,2,5,11,11,0,0,2,2,-1,11,6,2,7,9,-5,0,0,0,-1,-1,-1,0,1
KR_6755241276,420,3,-17,48,10,0,3,3,10,10,0,1,3,2,0,2,2,-1,0,1,0,9,30,2,4,6,6,0,1,0,1,1,1,0,1
KR_6686344596,420,4,12,-11,15,3,4,1,4,5,1,3,4,1,5,10,5,0,1,1,0,3,-17,1,6,7,2,0,2,1,1,1,1,4,1
KR_6776336925,420,0,23,1,-4,-1,1,2,2,2,0,-1,3,4,0,5,5,-4,0,4,0,-9,6,5,5,10,0,0,0,1,-1,0,1,2,1
KR_6777792025,420,4,31,17,4,-2,2,4,3,7,4,4,4,0,-1,3,4,0,2,2,-1,9,-15,3,5,8,-5,0,0,0,1,1,-1,0,1
KR_6747300129,420,3,19,-5,4,-1,2,3,-2,0,2,5,7,2,-1,1,2,3,5,2,0,12,3,1,6,7,-2,0,0,1,1,0,-1,4,1
KR_6766536689,420,-1,-14,-22,7,2,4,2,-1,1,2,-2,2,4,7,8,1,1,2,1,0,5,-1,-1,4,3,1,0,1,1,1,1,1,6,1
KR_6738065283,440,5,2,34,12,2,4,2,2,6,4,3,4,1,1,2,1,4,6,2,1,18,43,3,3,6,-14,0,1,1,0,1,1,4,1
KR_6760308541,420,3,4,-13,6,-1,0,1,6,6,0,1,6,5,0,1,1,0,1,1,0,9,-10,-6,8,2,3,0,1,-1,1,1,1,2,1
KR_6748331539,420,2,53,-4,0,-1,0,1,2,4,2,-3,0,3,0,1,1,2,2,0,0,-3,8,3,5,8,3,0,2,-1,1,1,1,1,1
KR_6756689086,420,3,63,-4,0,0,2,2,0,3,3,0,4,4,1,4,3,-1,0,1,0,2,-6,-2,7,5,-1,0,-1,-1,-1,-1,-1,5,1
KR_6748078680,420,4,62,-28,7,1,1,0,1,1,0,-2,1,3,6,6,0,1,1,0,0,9,2,-3,10,7,5,0,1,1,1,1,1,6,1
KR_6744571396,420,5,30,67,6,1,2,1,3,3,0,2,3,1,0,2,2,0,1,1,0,5,22,2,4,6,-5,0,1,1,1,1,1,6,1
KR_6769856496,440,-2,94,24,-8,-1,2,3,0,3,3,-3,0,3,-4,1,5,0,0,0,0,-15,-2,-1,5,4,1,0,0,-1,1,0,1,4,1
KR_6729346500,420,1,-4,29,4,4,4,0,4,4,0,1,1,0,-5,5,10,0,3,3,1,-1,6,2,5,7,-4,0,1,1,-1,-1,1,2,1
KR_6776151424,420,-2,-2,-32,-2,7,7,0,-3,0,3,-6,1,7,-2,6,8,2,2,0,0,2,9,5,3,8,-4,0,-2,-1,-1,-1,1,2,1
KR_6743880637,420,-3,-14,-11,-7,-6,1,7,2,2,0,3,8,5,-4,2,6,-2,0,2,0,-1,-19,-5,8,3,3,0,0,1,-1,1,-1,3,1
KR_6774716187,420,9,143,37,19,6,7,1,0,2,2,0,1,1,10,10,0,3,7,4,1,11,5,3,1,4,5,0,4,1,1,1,1,6,1
KR_6759167967,420,0,97,-11,6,-1,1,2,-4,0,4,2,4,2,10,11,1,-1,0,1,0,8,43,-1,6,5,-18,0,2,1,-1,1,1,6,1
KR_6734935681,420,8,77,34,8,3,4,1,0,2,2,1,1,0,5,7,2,-1,1,2,0,19,8,1,7,8,1,0,2,1,1,1,1,5,1
KR_6764674747,420,3,0,12,5,-3,3,6,2,7,5,2,4,2,2,5,3,2,2,0,0,16,-9,-2,7,5,0,0,-1,-1,0,-1,-1,1,1
KR_6743013053,440,3,103,32,3,0,1,1,1,4,3,5,6,1,1,3,2,-4,0,4,0,-2,-13,-3,12,9,-2,0,2,1,1,1,1,5,1
KR_6732485626,440,1,-47,24,1,1,1,0,1,2,1,0,3,3,-1,3,4,0,2,2,0,1,5,1,5,6,-2,0,0,1,1,0,-1,1,1
KR_6744562632,420,-1,3,-7,-1,1,2,1,-1,1,2,-2,0,2,-2,2,4,3,4,1,0,-4,224,-4,10,6,4,0,-1,-1,1,-1,1,5,1
KR_6762917013,420,-1,15,20,-7,0,2,2,-7,0,7,3,5,2,-3,1,4,0,0,0,0,-8,-5,-5,8,3,-2,0,0,1,0,1,1,2,1
KR_6719841724,420,9,99,35,24,4,4,0,-2,2,4,16,18,2,6,11,5,0,1,1,1,18,4,5,4,9,0,0,3,1,1,1,1,6,1
KR_6767945968,440,0,-8,35,2,0,3,3,4,6,2,0,0,0,-4,1,5,2,2,0,0,1,-17,-2,5,3,2,0,0,1,0,0,1,3,1
KR_6735970629,420,8,73,15,20,-1,0,1,14,15,1,1,5,4,6,8,2,0,3,3,0,19,-3,3,5,8,-2,0,3,-1,1,1,1,6,1
KR_6775298358,420,5,9,4,12,0,1,1,3,3,0,8,10,2,1,2,1,0,0,0,0,18,2,2,3,5,6,0,3,1,1,1,1,2,1
KR_6754266899,420,6,48,-1,15,4,4,0,1,2,1,6,8,2,4,6,2,0,0,0,2,15,4,6,5,11,0,0,0,1,-1,1,1,4,1
KR_6671134661,420,6,6,28,14,2,2,0,6,7,1,4,8,4,0,1,1,2,2,0,3,22,-7,-3,9,6,4,0,1,-1,1,1,1,2,1
KR_6732993581,420,7,79,20,21,4,5,1,4,7,3,5,5,0,7,10,3,1,4,3,0,17,27,7,3,10,-1,0,3,0,1,1,1,0,1
KR_6773018604,440,-2,-16,-30,-3,0,1,1,0,3,3,-1,1,2,0,1,1,-2,0,2,1,-2,12,6,3,9,-1,0,0,-1,1,0,1,4,1
KR_6771180771,420,2,26,-4,7,4,4,0,1,4,3,4,5,1,-2,0,2,0,0,0,0,10,36,-4,8,4,-9,0,1,-1,1,1,1,3,1
KR_6754614411,420,-1,17,-4,-3,-1,2,3,-2,1,3,-2,2,4,2,2,0,0,0,0,0,-5,12,1,9,10,3,0,2,-1,1,1,1,6,1
KR_6772652033,420,2,51,-6,5,8,8,0,4,4,0,-7,1,8,1,3,2,-1,0,1,0,5,-10,4,3,7,-4,0,2,1,1,1,1,6,1
KR_6740529737,420,7,74,-4,10,1,2,1,2,3,1,-4,0,4,9,9,0,2,2,0,2,15,9,5,3,8,4,0,3,1,1,1,1,1,1
KR_6656444512,420,3,-4,-3,-1,0,2,2,-1,4,5,-4,2,6,5,6,1,-1,2,3,-2,3,0,-8,10,2,2,0,0,1,-1,0,-1,5,1
KR_6777852215,420,-1,-47,15,3,2,6,4,7,8,1,-3,5,8,-3,1,4,0,3,3,-1,20,-1,-2,8,6,4,0,0,1,1,-1,-1,4,1
KR_6775328339,420,1,-32,-25,2,3,6,3,5,7,2,0,0,0,-4,3,7,-2,0,2,0,5,-4,1,5,6,7,0,0,1,1,0,-1,2,1
KR_6728699780,420,0,3,23,-4,0,2,2,-3,3,6,2,3,1,-2,0,2,-1,2,3,0,-6,-9,-5,8,3,2,0,2,-1,1,1,-1,4,1
KR_6711953582,420,10,151,8,17,5,5,0,3,3,0,3,3,0,5,5,0,1,2,1,1,14,57,8,4,12,-2,0,4,0,1,1,-1,0,1
KR_6776343167,420,3,89,20,8,0,4,4,0,7,7,7,7,0,2,3,1,-1,0,1,1,6,3,3,3,6,-5,0,2,-1,-1,1,1,1,1
KR_6774855001,420,1,-3,25,6,2,2,0,4,6,2,1,1,0,-1,2,3,0,0,0,0,4,-151,5,3,8,-11,0,1,1,1,1,1,6,1
KR_6773571926,440,2,48,-20,5,0,2,2,0,6,6,1,6,5,2,2,0,2,2,0,0,10,19,2,4,6,3,0,-1,-1,-1,-1,1,6,1
KR_6734851817,420,2,-53,19,5,1,2,1,2,3,1,-1,3,4,2,5,3,1,1,0,0,5,-5,-5,10,5,5,0,0,1,1,1,-1,3,1
KR_6776659679,420,1,21,-28,11,5,5,0,2,5,3,0,1,1,3,5,2,1,2,1,0,15,-3,-1,9,8,6,0,0,1,1,0,1,6,1
KR_6769899960,420,-3,3,-36,4,-2,1,3,1,5,4,-1,2,3,5,7,2,1,3,2,1,15,7,6,3,9,-3,0,1,1,1,1,1,3,1
KR_6746700154,420,2,11,8,8,-2,1,3,4,6,2,5,7,2,2,4,2,-1,0,1,0,6,5,-5,9,4,-1,0,2,1,0,1,-1,4,1
KR_6774365883,420,-1,-30,-14,4,6,6,0,-2,0,2,1,4,3,-1,0,1,0,1,1,0,-2,14,2,4,6,-3,0,1,1,1,1,1,5,1
KR_6768528844,420,0,-32,5,5,1,2,1,6,6,0,3,5,2,-3,0,3,-2,0,2,1,2,2,3,6,9,-5,0,-1,-1,1,-1,1,1,1
KR_6776411060,440,-1,36,-4,-3,1,2,1,-1,1,2,1,2,1,-4,0,4,0,0,0,0,-11,63,2,4,6,-2,0,0,-1,1,0,1,4,1
KR_6773479666,420,0,-4,0,2,-2,3,5,2,4,2,1,4,3,0,2,2,1,2,1,0,1,5,2,3,5,-5,0,1,1,-1,1,1,5,1
KR_6735828619,420,1,-43,8,3,1,3,2,3,4,1,-2,1,3,0,4,4,1,1,0,0,10,2,-1,6,5,4,0,-1,1,1,-1,-1,3,1
KR_6770725726,420,3,71,19,12,3,4,1,6,8,2,5,5,0,-1,4,5,-1,0,1,0,8,4,3,3,6,2,0,2,1,1,1,1,4,1
KR_6740713539,420,1,14,-9,3,-1,3,4,-1,3,4,5,6,1,-1,2,3,1,2,1,0,0,-7,2,3,5,4,0,0,1,1,0,1,5,1
KR_6772428980,420,4,31,41,6,-1,0,1,3,6,3,3,5,2,2,3,1,-1,0,1,0,7,2,0,6,6,2,0,2,1,-1,1,-1,6,1
KR_6770737376,420,2,-57,4,9,0,2,2,3,5,2,6,6,0,0,1,1,0,0,0,0,12,8,4,3,7,-3,0,0,1,1,-1,1,6,1
KR_6776487725,420,5,17,17,6,-2,4,6,3,4,1,3,5,2,2,2,0,0,0,0,0,13,4,-3,8,5,-4,0,1,1,1,1,-1,4,1
KR_6677044779,420,-2,-47,-13,-5,-4,1,5,-2,5,7,-3,1,4,2,6,4,2,4,2,0,-13,-8,0,6,6,-1,0,0,-1,1,1,-1,5,1
KR_6774033616,440,-1,-16,27,0,-2,1,3,1,1,0,3,3,0,-2,0,2,0,0,0,0,-2,180,1,4,5,0,0,0,1,1,0,-1,5,1
KR_6752183863,420,0,7,22,1,-2,0,2,-1,1,2,-2,1,3,6,6,0,0,1,1,0,16,-4,0,5,5,3,0,-1,1,-1,-1,-1,4,1
KR_6772049808,420,2,41,-7,2,0,1,1,1,4,3,4,7,3,-3,0,3,0,1,1,0,-4,3,2,5,7,-1,0,1,-1,1,1,1,5,1
KR_6770125675,420,-1,-37,33,0,-2,2,4,-2,1,3,3,4,1,2,3,1,-1,2,3,0,6,28,3,4,7,5,0,-1,1,1,-1,1,1,1
KR_6716914900,420,5,32,44,6,1,3,2,-1,1,2,3,3,0,3,3,0,0,1,1,-1,3,-209,1,4,5,0,0,1,-1,1,1,-1,2,1
KR_6760904970,420,1,54,15,3,-2,0,2,0,3,3,0,3,3,0,1,1,5,6,1,0,6,17,1,4,5,-1,0,0,1,-1,1,1,4,1
KR_6772878726,420,2,44,8,8,3,4,1,-1,1,2,-1,0,1,2,4,2,5,5,0,0,10,-317,6,2,8,1,0,1,-1,1,1,1,2,1
KR_6766770819,420,2,59,-20,6,3,5,2,1,6,5,3,4,1,-1,3,4,0,1,1,0,7,34,3,5,8,1,0,2,1,1,1,1,3,1
KR_6755582696,420,0,8,-24,3,-2,0,2,6,7,1,1,5,4,-2,5,7,0,2,2,0,3,5,4,6,10,-8,0,-1,1,-1,-1,-1,5,1
KR_6771650016,420,4,13,28,5,2,3,1,-1,1,2,3,7,4,2,5,3,-1,1,2,0,5,0,-1,7,6,5,0,1,1,-1,1,-1,3,1
KR_6775464622,420,1,12,-13,2,-3,0,3,-2,2,4,-2,1,3,10,10,0,-1,2,3,1,8,-77,9,6,15,0,0,-1,1,-1,-1,1,4,1
KR_6776005921,420,0,-6,9,5,2,3,1,-1,2,3,-1,1,2,5,7,2,0,0,0,0,-2,2,0,9,9,-6,0,2,-1,1,1,1,6,1
KR_6706631207,420,1,31,-11,6,4,5,1,2,6,4,-1,0,1,0,1,1,1,2,1,0,7,37,5,2,7,2,0,1,1,1,1,1,1,1
KR_6754242878,420,0,16,33,-2,-2,2,4,3,4,1,3,5,2,-3,0,3,-3,0,3,0,4,5,0,6,6,2,0,-1,1,-1,-1,1,3,1
KR_6745484439,420,1,17,-18,3,0,2,2,2,3,1,1,4,3,0,2,2,0,1,1,0,1,-24,2,4,6,-1,0,1,1,1,1,1,5,1
KR_6768427044,440,2,-37,-8,11,4,4,0,-1,0,1,2,4,2,1,3,2,5,5,0,2,19,-3,-4,8,4,2,0,0,1,-1,0,1,4,1
KR_6777406741,420,4,35,57,7,5,6,1,-1,1,2,5,6,1,-1,2,3,-1,0,1,0,8,0,1,4,5,-2,0,1,1,1,1,1,2,1
KR_6729497687,420,5,12,24,6,4,4,0,-1,1,2,1,4,3,1,6,5,1,1,0,-2,-1,2,-1,8,7,4,0,0,-1,1,0,-1,2,1
KR_6777794439,420,4,11,18,7,2,2,0,0,1,1,0,5,5,4,6,2,1,2,1,-1,8,6,5,4,9,-2,0,0,-1,1,0,-1,2,1
KR_6764617638,420,-1,-12,16,-1,-4,0,4,4,5,1,0,2,2,0,0,0,-1,0,1,-1,1,-23,-1,5,4,1,0,1,1,1,1,-1,5,1
KR_6742645538,420,2,-16,4,1,5,7,2,0,4,4,-1,2,3,-2,4,6,-1,0,1,0,-1,-8,-2,6,4,-9,0,0,-1,-1,0,-1,5,1
KR_6712385238,420,0,-39,-12,1,-3,1,4,0,3,3,4,4,0,0,1,1,0,1,1,0,6,-24,-2,4,2,1,0,0,1,-1,0,-1,1,1
KR_6757101490,420,2,6,20,0,2,2,0,1,4,3,-4,0,4,1,3,2,0,0,0,0,-9,-7,-4,10,6,2,0,1,1,1,1,1,4,1
KR_6754400449,420,4,35,8,10,2,3,1,-1,1,2,2,2,0,7,7,0,0,0,0,0,15,43,6,2,8,0,0,1,1,-1,1,1,2,1
KR_6750885015,420,-2,-49,-6,3,-1,0,1,1,3,2,2,3,1,-1,1,2,2,2,0,1,12,14,1,5,6,-5,0,0,1,-1,-1,1,3,1
KR_6759011185,420,4,44,5,9,2,2,0,-5,1,6,5,5,0,6,6,0,1,2,1,0,7,-2,1,8,9,3,0,1,1,-1,1,1,2,1
KR_6757100593,420,3,-2,-30,8,2,3,1,3,3,0,0,0,0,1,1,0,2,2,0,0,7,-27,8,3,11,21,0,0,1,-1,1,1,2,1
KR_6638445372,420,-1,-55,-31,-3,1,3,2,0,6,6,-1,0,1,-5,1,6,2,3,1,-2,-4,0,6,1,7,-3,0,0,1,1,-1,-1,4,1
KR_6749560202,420,-1,-20,-25,7,-3,1,4,2,10,8,2,4,2,4,7,3,2,3,1,4,27,4,3,9,12,2,0,-1,1,1,-1,1,4,1
KR_6706402492,420,5,40,-28,13,0,2,2,3,8,5,2,3,1,8,8,0,0,0,0,0,17,13,8,3,11,0,0,2,0,-1,1,1,0,1
KR_6755689745,420,0,-2,-22,1,1,1,0,-1,4,5,2,2,0,1,3,2,-2,0,2,0,6,-6,-2,8,6,5,0,1,-1,1,1,-1,4,1
KR_6772277443,420,0,15,-3,-4,1,2,1,0,7,7,-4,0,4,-2,2,4,1,1,0,0,-10,97,-3,7,4,-4,0,0,-1,-1,1,-1,2,1
KR_6773038143,420,-1,-13,0,-4,-2,4,6,1,1,0,-3,1,4,1,1,0,-1,0,1,1,-6,6,5,3,8,-5,0,-1,1,-1,-1,1,2,1
KR_6774974270,420,-7,-72,-55,-11,-1,1,2,-2,3,5,1,1,0,-7,2,9,-2,1,3,0,-4,-15,3,3,6,-5,0,-1,-1,1,1,1,6,1
KR_6777675769,420,-1,34,7,-7,-2,3,5,-3,2,5,-1,0,1,-1,0,1,0,0,0,0,-7,21,0,5,5,-1,0,1,-1,1,1,1,2,1
KR_6729641286,420,5,32,27,11,1,3,2,1,4,3,1,2,1,-5,3,8,13,13,0,0,10,-4,0,8,8,-3,0,1,1,1,1,1,2,1
KR_6775930571,420,-3,-38,-9,-3,-3,1,4,1,3,2,-6,1,7,4,6,2,1,3,2,0,-2,-20,0,5,5,1,0,1,1,-1,1,-1,3,1
KR_6750337957,420,3,21,-11,10,1,1,0,1,4,3,1,4,3,6,6,0,1,1,0,0,10,-22,0,8,8,26,0,1,-1,1,1,1,4,1
KR_6777716257,420,4,37,34,1,3,3,0,-1,2,3,-1,3,4,-1,2,3,1,2,1,0,-3,-5,-6,11,5,-3,0,0,1,0,1,-1,5,1
KR_6773587636,420,-1,51,4,-6,1,2,1,0,2,2,-1,4,5,-5,0,5,-1,0,1,0,-13,-39,0,6,6,-23,0,2,1,1,1,1,4,1
KR_6776233258,420,-2,-38,-20,-5,-3,3,6,0,1,1,-4,1,5,5,6,1,-3,2,5,1,-2,-2,5,0,5,5,0,-2,1,-1,-1,1,6,1
KR_6742787636,420,-1,-23,11,-4,-1,0,1,-3,1,4,-1,1,2,1,1,0,0,0,0,0,-4,10,8,3,11,-2,0,1,1,1,1,-1,6,1
KR_6758456933,420,-1,-22,-6,4,-4,0,4,4,7,3,-1,5,6,4,5,1,1,1,0,0,11,-8,-1,8,7,1,0,0,-1,1,1,1,5,1
KR_6714540018,420,8,121,26,7,0,4,4,0,3,3,6,6,0,1,3,2,0,1,1,0,9,13,4,7,11,-2,0,3,-1,1,1,-1,2,1
KR_6758601888,420,5,29,58,9,-4,0,4,4,7,3,0,1,1,7,7,0,2,2,0,0,18,44,6,4,10,-7,0,2,1,-1,1,1,4,1
KR_6728923475,420,0,-16,12,2,-1,2,3,6,7,1,0,3,3,-3,2,5,0,0,0,2,23,-14,-4,9,5,3,0,2,1,1,1,1,2,1
KR_6770194080,440,1,90,-14,7,5,7,2,4,5,1,1,2,1,0,0,0,-3,2,5,0,0,1,2,1,3,-3,0,1,-1,1,1,1,6,1
KR_6723440974,420,6,62,36,13,1,3,2,9,10,1,1,5,4,2,3,1,0,2,2,1,18,50,4,6,10,-4,0,4,0,1,1,1,0,1
KR_6773126176,440,3,68,-24,9,-1,2,3,0,0,0,0,2,2,7,7,0,3,3,0,1,16,-13,3,2,5,3,0,1,-1,1,1,1,6,1
KR_6765854477,440,2,32,16,11,4,6,2,-1,2,3,1,2,1,8,8,0,-1,1,2,1,21,70,1,7,8,-4,0,0,1,1,1,1,3,1
KR_6720336393,420,2,32,-3,5,-1,1,2,6,10,4,0,2,2,2,3,1,-2,2,4,-1,0,3,-2,11,9,2,0,2,1,1,1,-1,1,1
KR_6777880725,420,3,58,8,4,3,3,0,-4,2,6,1,2,1,2,3,1,2,4,2,0,1,-2,-2,6,4,-9,0,1,1,1,1,-1,2,1
KR_6746185892,440,2,-9,-15,3,-1,0,1,0,2,2,5,5,0,-4,1,5,3,3,0,1,7,0,-4,5,1,1,0,1,-1,-1,1,1,5,1
KR_6775576327,420,1,14,12,-5,-3,2,5,1,5,4,-1,4,5,0,5,5,-2,0,2,-2,-4,12,-2,7,5,6,0,1,1,1,1,-1,3,1
KR_6777745309,420,-2,22,-15,4,-2,2,4,2,3,1,6,6,0,-2,1,3,0,2,2,0,6,12,2,6,8,3,0,0,1,-1,0,1,6,1
KR_6777344886,420,4,-4,16,12,3,3,0,4,5,1,0,5,5,4,8,4,1,1,0,0,13,1,-2,6,4,0,0,0,1,1,0,1,3,1
KR_6776804011,420,3,-4,-12,5,1,2,1,2,2,0,3,4,1,1,3,2,-2,0,2,0,2,9,-1,8,7,1,0,0,-1,1,0,1,3,1
KR_6771507130,420,0,66,21,6,0,5,5,0,4,4,4,4,0,2,3,1,0,2,2,1,2,-6,0,8,8,7,0,1,1,1,1,1,1,1
KR_6777468614,420,6,150,4,9,5,6,1,-3,2,5,2,3,1,5,6,1,0,0,0,0,2,6,-3,8,5,2,0,4,-1,1,1,-1,2,1
KR_6749664114,420,3,81,23,0,0,3,3,4,6,2,-1,2,3,0,3,3,-3,0,3,0,0,10,0,12,12,2,0,2,1,1,1,-1,3,1
KR_6739223248,420,1,6,16,2,0,2,2,3,6,3,0,3,3,-1,3,4,0,0,0,0,13,-3,-1,8,7,3,0,-1,-1,-1,-1,-1,4,1
KR_6750697625,420,3,17,20,6,-1,0,1,0,1,1,6,9,3,3,5,2,-2,0,2,0,9,12,2,3,5,-5,0,-1,1,-1,-1,1,4,1
KR_6775320208,420,3,93,28,4,0,4,4,3,5,2,5,6,1,-3,0,3,-1,0,1,1,7,-11,-5,9,4,6,0,0,1,1,0,1,4,1
KR_6769626728,420,3,22,20,-2,2,2,0,0,4,4,1,5,4,-4,0,4,-1,0,1,0,-3,-6,-3,9,6,-3,0,2,1,1,1,-1,2,1
KR_6767098265,420,-2,-21,25,-3,2,2,0,-5,0,5,-1,3,4,2,6,4,-1,0,1,-1,1,5,3,4,7,-1,0,-1,-1,1,-1,-1,3,1
KR_6777680070,420,1,12,-24,-1,0,2,2,-1,0,1,0,3,3,-2,1,3,2,2,0,0,-2,5,2,7,9,1,0,-1,1,-1,-1,1,4,1
KR_6774846191,420,-1,-9,-9,-2,1,2,1,-4,2,6,0,0,0,1,1,0,0,0,0,0,-4,-38,0,9,9,6,0,-1,1,-1,-1,-1,3,1
KR_6774711343,420,0,-16,28,7,1,1,0,2,4,2,0,0,0,2,6,4,2,3,1,0,1,-26,2,6,8,0,0,0,-1,1,0,1,2,1
KR_6742356840,420,1,-2,-3,4,2,4,2,1,2,1,3,3,0,-2,2,4,0,3,3,0,4,24,1,9,10,4,0,1,1,0,1,-1,5,1
KR_6747337555,420,4,-5,-26,11,2,2,0,1,2,1,-1,1,2,7,10,3,2,2,0,1,17,0,-2,8,6,6,0,2,1,-1,1,1,3,1
KR_6733400834,420,2,39,-6,3,0,1,1,0,2,2,5,6,1,-1,1,2,-1,0,1,0,7,0,-5,8,3,5,0,0,-1,1,-1,-1,3,1
KR_6696882647,420,0,35,-34,5,4,5,1,-1,0,1,0,3,3,3,3,0,-1,1,2,2,14,33,6,5,11,-1,0,1,1,-1,1,1,6,1
KR_6776339391,420,2,11,27,2,2,5,3,4,4,0,-3,1,4,-1,2,3,0,1,1,0,-4,-13,-7,9,2,6,0,1,-1,-1,1,1,5,1
KR_6760892513,420,2,-2,-7,11,0,2,2,2,3,1,10,11,1,0,3,3,-1,0,1,0,16,10,10,4,14,-3,0,0,1,1,1,-1,4,1
KR_6773063646,440,-3,5,-24,-5,-2,1,3,0,3,3,-3,0,3,-1,4,5,1,1,0,-1,1,-30,-1,8,7,0,0,0,-1,-1,0,-1,5,1
KR_6728989104,420,6,35,31,9,-1,3,4,3,3,0,-1,4,5,4,6,2,4,4,0,0,1,7,7,4,11,2,0,3,1,1,1,-1,5,1
KR_6771522145,420,2,-24,-1,4,2,3,1,4,7,3,-1,2,3,-2,1,3,1,1,0,0,-3,4,3,2,5,1,0,1,1,1,1,-1,4,1
KR_6708391208,420,1,111,-2,-3,-1,0,1,-4,0,4,4,5,1,-2,1,3,0,1,1,0,-7,0,0,9,9,5,0,1,-1,1,1,-1,1,1
KR_6712469477,420,2,-2,17,5,5,5,0,-2,1,3,2,4,2,-1,2,3,1,2,1,0,12,7,-2,8,6,4,0,1,1,1,1,-1,2,1
KR_6776377778,420,2,43,4,-2,0,2,2,1,2,1,-1,2,3,-3,0,3,1,1,0,0,-7,-1,0,5,5,-1,0,0,-1,-1,-1,-1,6,1
KR_6745288378,420,8,27,48,13,2,2,0,5,7,2,0,6,6,2,4,2,4,4,0,1,10,-13,-1,7,6,2,0,2,1,1,1,1,2,1
KR_6763821613,420,1,-10,-20,4,-1,0,1,1,2,1,5,5,0,0,2,2,-1,0,1,0,-4,-3,0,4,4,-3,0,1,-1,1,1,1,1,1
KR_6774510375,420,2,69,11,0,-2,0,2,3,5,2,-4,0,4,3,5,2,0,2,2,0,-3,16,10,3,13,-4,0,1,1,1,1,-1,5,1
KR_6738822032,420,0,-31,-4,-4,-1,1,2,1,5,4,-1,5,6,0,1,1,-3,1,4,-2,5,-3,-5,9,4,3,0,-1,-1,1,-1,-1,2,1
KR_6743281674,420,3,60,-7,5,0,2,2,4,6,2,1,2,1,-1,3,4,1,3,2,0,8,-30,0,6,6,3,0,0,1,-1,-1,1,3,1
KR_6772035881,420,4,-8,8,2,2,4,2,4,4,0,2,4,2,-4,2,6,-2,1,3,0,5,-91,-5,8,3,1,0,-1,1,1,-1,1,4,1
KR_6710603311,420,0,77,-51,3,1,4,3,-2,1,3,2,4,2,4,6,2,-2,1,3,0,5,-23,0,4,4,3,0,2,-1,1,1,1,5,1
KR_6768334958,420,0,-48,10,1,2,2,0,-4,3,7,2,4,2,0,3,3,1,1,0,-1,2,-4,-2,9,7,-2,0,0,1,-1,0,-1,5,1
KR_6774920669,420,4,27,24,-1,2,2,0,-1,0,1,1,2,1,-2,0,2,-1,0,1,0,-1,45,6,4,10,-3,0,1,-1,1,1,1,4,1
KR_6773569930,420,7,67,23,20,-1,1,2,7,7,0,5,7,2,10,11,1,-1,1,2,1,36,10,-1,5,4,3,0,6,1,1,1,1,4,1
KR_6738065997,420,4,57,47,5,1,2,1,2,5,3,-1,1,2,4,4,0,-1,0,1,1,3,2,-2,8,6,0,0,1,1,-1,1,1,2,1
KR_6777265539,420,3,29,16,7,3,5,2,-1,1,2,-2,1,3,6,9,3,1,1,0,0,-6,3,0,7,7,2,0,0,1,-1,0,1,2,1
KR_6765480458,420,3,58,13,12,7,8,1,4,6,2,-1,0,1,3,8,5,-1,1,2,1,11,-3,6,3,9,-2,0,2,1,1,1,1,6,1
KR_6775502812,420,4,5,27,5,0,2,2,0,1,1,0,4,4,4,5,1,1,3,2,0,8,24,1,4,5,-2,0,0,1,1,1,1,4,1
KR_6706636797,420,4,26,34,7,1,2,1,0,5,5,4,10,6,3,3,0,-1,0,1,0,6,-11,-5,9,4,7,0,0,1,1,0,-1,5,1
KR_6722063180,420,1,-2,13,3,-3,0,3,4,5,1,-2,0,2,5,8,3,-1,0,1,0,14,6,3,7,10,-3,0,2,1,-1,1,-1,4,1
KR_6710530420,420,2,65,-9,0,2,2,0,-2,2,4,0,2,2,-1,2,3,1,1,0,-1,-2,-10,-3,13,10,7,0,1,-1,1,1,-1,2,1
KR_6775119157,420,3,-31,30,-2,-1,2,3,-4,1,5,1,2,1,1,2,1,1,1,0,0,-2,-3,0,6,6,-2,0,0,0,1,0,-1,0,1
KR_6774996540,420,0,7,3,3,-2,1,3,-1,0,1,3,7,4,1,3,2,2,2,0,0,0,21,5,5,10,-1,0,-1,-1,-1,-1,1,6,1
KR_6770455017,440,2,4,12,3,4,6,2,-4,2,6,-2,2,4,4,4,0,1,1,0,0,2,-4,-1,5,4,5,0,0,1,1,1,-1,4,1
KR_6775487456,440,1,32,-36,1,2,2,0,-5,1,6,-2,4,6,9,10,1,-3,1,4,2,8,0,-3,7,4,5,0,2,-1,1,1,1,6,1
KR_6774673154,420,-1,-40,0,-2,0,4,4,-1,0,1,-4,0,4,5,6,1,-2,1,3,0,-3,-12,6,6,12,-25,0,-1,1,-1,-1,-1,1,1
KR_6721671424,420,2,50,-4,10,-2,2,4,-2,1,3,0,2,2,13,13,0,1,1,0,0,21,0,-2,6,4,2,0,0,-1,1,1,-1,5,1
KR_6752896411,420,0,29,-5,1,-1,3,4,4,4,0,-1,1,2,4,4,0,-5,2,7,-1,13,4,2,9,11,2,0,1,-1,1,1,-1,6,1
KR_6766510090,420,5,37,36,13,9,10,1,2,6,4,1,2,1,1,2,1,0,0,0,0,16,18,9,2,11,0,0,2,1,1,1,-1,6,1
KR_6772832296,420,5,47,54,12,-1,1,2,5,7,2,3,5,2,6,6,0,-1,0,1,0,11,-5,3,4,7,8,0,1,1,1,1,1,5,1
KR_6746496774,420,2,-11,0,4,3,5,2,1,2,1,2,2,0,5,7,2,-7,1,8,0,11,-12,0,4,4,2,0,-1,1,-1,-1,-1,1,1
KR_6772228108,420,0,-26,37,-5,-1,1,2,0,1,1,-2,0,2,1,4,3,-3,0,3,0,-7,8,1,5,6,4,0,0,1,-1,0,-1,1,1
KR_6750933973,420,1,58,-17,0,3,3,0,1,5,4,-5,0,5,1,3,2,0,0,0,0,-5,-52,2,4,6,-4,0,2,-1,1,1,1,4,1
KR_6701475660,420,2,15,34,9,0,3,3,2,4,2,1,1,0,3,5,2,3,3,0,0,2,-2,2,4,6,6,0,1,1,1,1,1,4,1
KR_6772304366,420,0,-11,-16,5,-3,0,3,3,3,0,2,5,3,2,4,2,1,3,2,-1,11,14,3,4,7,-1,0,-1,-1,-1,-1,-1,6,1
KR_6749752533,420,0,81,2,5,3,3,0,-1,3,4,6,8,2,-1,3,4,-2,0,2,0,1,10,0,4,4,-2,0,1,-1,1,1,1,5,1
KR_6738462488,420,0,-38,-16,2,1,3,2,1,2,1,1,2,1,0,3,3,-1,0,1,0,3,-4,-4,8,4,5,0,0,1,1,0,1,3,1
KR_6739849074,440,0,-65,23,-1,2,4,2,-4,0,4,0,2,2,-1,4,5,2,2,0,1,6,-7,0,6,6,-1,0,-1,-1,1,-1,1,3,1
KR_6777841759,420,6,109,19,8,0,4,4,1,3,2,3,5,2,5,7,2,-1,1,2,0,14,28,4,3,7,1,0,3,-1,1,1,1,4,1
KR_6775481715,420,-2,-41,-8,2,-1,2,3,3,4,1,0,3,3,-2,1,3,2,2,0,0,-2,-17,-2,7,5,-1,0,0,-1,1,0,-1,4,1
KR_6772048069,420,3,34,0,5,3,3,0,0,2,2,0,1,1,-1,2,3,3,3,0,0,1,-38,-3,6,3,8,0,0,1,-1,0,1,4,1
KR_6761781363,420,0,26,-5,1,-3,0,3,3,6,3,1,3,2,3,3,0,-3,1,4,0,9,-2,0,5,5,-1,0,-1,1,-1,-1,-1,5,1
KR_6776455604,440,-3,-107,19,-8,-2,2,4,-1,3,4,-4,0,4,1,2,1,-2,1,3,-1,-3,-22,-3,4,1,0,0,0,0,-1,-1,-1,0,1
KR_6744319211,420,5,80,8,7,2,4,2,2,3,1,0,2,2,3,3,0,0,0,0,1,0,4,0,7,7,3,0,1,-1,1,1,1,1,1
KR_6771816927,420,5,13,-8,13,4,5,1,1,5,4,6,6,0,1,1,0,1,1,0,0,11,6,3,2,5,-1,0,1,-1,1,1,1,4,1
KR_6707877612,420,-2,-55,-20,0,-3,0,3,0,0,0,3,3,0,0,2,2,0,0,0,0,1,2,-1,6,5,-1,0,0,-1,1,1,1,2,1
KR_6700541418,420,0,42,19,-5,2,3,1,-1,3,4,-1,1,2,-5,2,7,0,0,0,-1,-13,2,-10,15,5,3,0,-1,1,-1,1,-1,5,1
KR_6755366637,420,2,33,28,7,1,2,1,0,2,2,1,4,3,5,5,0,0,2,2,1,10,-4,3,3,6,6,0,1,1,1,1,1,5,1
KR_6716608915,420,-1,-33,4,0,-1,5,6,0,2,2,1,2,1,0,3,3,0,1,1,-1,0,-24,-5,10,5,-3,0,2,-1,1,1,-1,4,1
KR_6764405310,420,1,23,-25,10,0,3,3,0,1,1,3,3,0,5,6,1,2,2,0,1,15,17,-2,6,4,3,0,0,1,-1,-1,1,6,1
KR_6762787687,420,5,60,-9,15,2,2,0,4,5,1,5,6,1,3,4,1,1,1,0,1,19,24,5,3,8,4,0,3,1,1,1,1,6,1
KR_6776038144,420,-1,-21,-36,-1,-3,0,3,-1,2,3,-4,2,6,6,7,1,1,2,1,1,5,3,-3,8,5,0,0,0,-1,-1,-1,1,2,1
KR_6759672077,420,3,41,4,6,1,2,1,2,2,0,0,2,2,3,6,3,0,1,1,0,12,47,2,4,6,-7,0,0,1,-1,0,-1,5,1
KR_6720001535,420,2,66,-9,4,4,4,0,-1,3,4,-2,1,3,1,4,3,2,2,0,0,0,-26,-3,7,4,-1,0,0,1,-1,1,1,3,1
KR_6765745039,420,0,8,-5,0,2,2,0,2,3,1,-3,0,3,0,6,6,-1,3,4,0,1,-10,3,5,8,3,0,1,-1,1,1,-1,4,1
KR_6774091938,420,0,39,-5,3,0,3,3,1,3,2,0,4,4,0,3,3,2,3,1,0,-5,12,1,6,7,-3,0,1,1,1,1,-1,6,1
KR_6745266317,420,3,33,-4,2,2,4,2,-3,1,4,-2,1,3,5,7,2,0,0,0,0,4,27,7,4,11,7,0,1,1,1,1,1,5,1
KR_6773277763,420,0,19,-36,5,-2,0,2,1,2,1,1,3,2,5,5,0,0,0,0,-1,11,8,1,8,9,7,0,0,-1,-1,-1,-1,2,1
KR_6757163996,420,1,-36,18,-2,3,3,0,0,2,2,1,1,0,-6,1,7,0,0,0,-2,-8,-35,2,3,5,-1,0,1,-1,1,1,-1,5,1
KR_6722960693,420,0,-10,33,0,-1,0,1,0,3,3,4,5,1,-4,0,4,1,1,0,0,-3,6,3,3,6,-6,0,-1,-1,-1,-1,-1,2,1
KR_6700555208,420,3,14,32,3,-1,2,3,5,6,1,-2,2,4,1,3,2,0,0,0,0,11,11,4,8,12,-1,0,3,1,1,1,-1,3,1
KR_6777267565,420,1,13,4,3,3,4,1,2,3,1,-1,2,3,-1,3,4,0,0,0,0,2,-8,-1,6,5,5,0,2,1,1,1,1,5,1
KR_6771683652,420,1,21,2,3,4,4,0,0,1,1,3,3,0,-4,1,5,0,0,0,0,-8,-36,5,4,9,17,0,0,-1,1,1,-1,2,1
KR_6759656695,420,3,28,21,14,3,3,0,0,2,2,2,3,1,6,8,2,3,3,0,1,20,-5,0,8,8,5,0,0,1,1,1,1,1,1
KR_6774136389,420,1,23,25,-2,0,0,0,0,1,1,-1,2,3,0,2,2,-1,0,1,0,0,-8,4,5,9,-8,0,-1,-1,-1,-1,-1,2,1
KR_6775923812,420,5,25,2,13,2,3,1,1,3,2,4,4,0,5,5,0,1,2,1,1,7,-7,3,4,7,3,0,0,-1,1,1,1,5,1
KR_6753250757,420,4,7,45,8,5,6,1,2,4,2,1,5,4,1,4,3,-1,1,2,3,9,-9,-2,5,3,6,0,1,1,1,1,1,3,1
KR_6741060217,420,0,-5,-6,-4,-2,0,2,-6,4,10,-1,2,3,4,5,1,1,2,1,0,1,13,3,4,7,-1,0,-2,1,-1,1,1,2,1
KR_6770166609,420,2,26,10,-2,3,4,1,-3,1,4,0,1,1,-1,3,4,-1,1,2,0,-5,-52,-1,5,4,-2,0,3,-1,1,1,-1,6,1
KR_6746778578,420,3,75,16,6,1,2,1,1,7,6,0,1,1,2,3,1,2,2,0,0,12,35,3,6,9,3,0,1,1,1,1,1,5,1
KR_6777166953,420,2,58,-5,7,1,3,2,2,3,1,1,2,1,4,4,0,-1,1,2,0,12,15,5,2,7,4,0,2,1,-1,1,-1,1,1
KR_6768717586,420,3,27,12,9,2,2,0,8,9,1,-2,1,3,0,1,1,1,1,0,1,13,11,2,6,8,8,0,0,1,1,0,1,2,1
KR_6751664372,440,-3,-76,17,-7,-1,1,2,2,5,3,0,4,4,-1,0,1,-7,0,7,0,-5,-22,2,4,6,-2,0,-1,1,-1,-1,1,3,1
KR_6769962576,440,2,-3,-6,15,7,10,3,2,3,1,2,4,2,6,7,1,-2,1,3,1,20,21,2,4,6,-6,0,1,1,0,1,1,6,1
KR_6774516824,420,2,91,-14,8,0,0,0,2,4,2,1,2,1,4,6,2,1,2,1,-1,15,-2,-1,9,8,-1,0,0,-1,-1,1,-1,3,1
KR_6775591541,420,3,22,40,10,0,1,1,9,9,0,2,3,1,1,4,3,-2,2,4,-1,8,-15,0,8,8,0,0,0,1,1,1,-1,3,1
KR_6776006036,420,-2,-10,-13,4,-1,2,3,3,5,2,5,6,1,-1,4,5,-2,1,3,0,13,18,6,4,10,-2,0,0,1,-1,0,-1,4,1
KR_6765471514,420,4,85,47,12,1,3,2,4,5,1,2,7,5,6,7,1,-1,2,3,0,12,8,2,6,8,3,0,0,1,-1,1,1,3,1
KR_6760079102,420,1,-22,-10,2,5,6,1,-3,3,6,3,7,4,-3,2,5,0,0,0,0,-7,-14,-2,7,5,0,0,1,-1,1,1,1,2,1
KR_6705495797,420,2,-2,1,7,3,3,0,1,3,2,0,4,4,0,3,3,3,4,1,1,7,2,-1,9,8,3,0,-1,1,1,1,1,2,1
KR_6769695472,440,-2,-11,-7,2,2,3,1,2,5,3,-3,3,6,1,3,2,0,3,3,1,-1,2,4,3,7,-1,0,-1,0,0,-1,1,0,1
KR_6723490520,420,0,13,-13,18,2,3,1,5,7,2,3,6,3,6,8,2,2,3,1,0,23,4,2,3,5,-1,0,2,1,-1,1,-1,1,1
KR_6708899103,420,2,14,1,8,1,1,0,2,5,3,1,3,2,3,6,3,1,1,0,0,10,1,4,7,11,-3,0,0,1,-1,-1,-1,4,1
KR_6774861103,420,0,-21,-16,0,-3,2,5,3,7,4,1,2,1,1,4,3,-2,0,2,0,-5,-31,-1,8,7,4,0,1,1,-1,-1,-1,1,1
KR_6760846060,420,5,53,17,13,-1,0,1,2,4,2,6,6,0,5,7,2,1,2,1,0,14,2,2,5,7,0,0,4,1,1,1,-1,5,1
KR_6767614406,420,2,24,0,-1,0,0,0,2,2,0,0,2,2,-3,3,6,0,2,2,0,0,7,1,6,7,-8,0,1,-1,1,1,1,2,1
KR_6745434585,420,3,11,34,0,-1,0,1,2,3,1,1,2,1,-3,2,5,1,2,1,0,-8,-9,-2,10,8,-1,0,-1,1,-1,-1,1,1,1
KR_6739755492,420,3,13,3,-1,1,1,0,2,7,5,-5,0,5,2,3,1,-1,1,2,1,1,-14,-1,5,4,5,0,0,-1,1,-1,1,3,1
KR_6724201808,420,3,-10,-24,11,1,3,2,3,4,1,-1,0,1,7,7,0,1,1,0,0,14,33,0,8,8,1,0,2,1,-1,1,1,1,1
KR_6759550857,420,1,-58,5,6,1,3,2,1,3,2,2,4,2,2,6,4,0,3,3,1,9,-11,1,7,8,-8,0,-1,-1,1,-1,1,6,1
KR_6777842565,420,1,-27,-6,6,-7,2,9,5,5,0,4,5,1,4,7,3,0,0,0,0,10,-1,-4,8,4,0,0,0,1,-1,-1,-1,1,1
KR_6740633570,420,6,77,1,12,3,4,1,5,7,2,4,5,1,-1,1,2,1,1,0,0,11,-66,3,4,7,2,0,1,1,1,1,1,3,1
KR_6775669853,420,3,67,-3,9,3,3,0,-1,2,3,3,3,0,3,3,0,1,1,0,0,10,-2,-1,8,7,10,0,1,-1,-1,-1,1,1,1
KR_6710726560,420,1,-45,-12,1,1,3,2,-1,2,3,1,2,1,0,3,3,0,1,1,0,0,9,1,9,10,-2,0,0,1,1,1,1,2,1
KR_6733145386,420,3,0,13,9,1,1,0,4,4,0,1,4,3,3,4,1,0,0,0,0,12,-49,2,8,10,25,0,0,-1,1,1,1,2,1
KR_6697926208,420,2,102,26,5,-3,1,4,5,6,1,3,5,2,-1,2,3,1,2,1,1,6,11,4,6,10,3,0,1,-1,-1,1,1,4,1
KR_6777718674,420,3,56,11,3,1,3,2,1,2,1,-3,1,4,2,3,1,2,2,0,1,0,32,-5,8,3,-15,0,1,1,-1,1,1,5,1
KR_6736544732,420,6,5,29,10,1,2,1,-1,2,3,8,10,2,3,5,2,-1,0,1,0,7,-11,-6,8,2,9,0,0,1,1,1,1,5,1
KR_6771065901,420,3,3,28,-2,2,4,2,-2,2,4,0,2,2,-1,0,1,-1,0,1,0,0,-10,-1,8,7,-6,0,0,-1,1,1,-1,2,1
KR_6724305419,420,6,54,11,7,0,1,1,2,3,1,3,3,0,4,4,0,-2,1,3,0,10,-2,5,3,8,5,0,0,1,-1,0,1,1,1
KR_6772870785,420,3,-14,0,1,-1,0,1,-1,2,3,-1,1,2,4,8,4,0,2,2,-2,-4,8,-2,4,2,1,0,1,-1,1,1,-1,5,1
KR_6756594272,440,2,38,-16,8,7,7,0,-1,1,2,1,3,2,0,2,2,1,1,0,0,3,0,4,3,7,1,0,1,0,0,1,-1,0,1
KR_6747513760,420,4,82,-12,7,2,3,1,3,3,0,-1,1,2,2,2,0,1,1,0,0,7,-2,4,3,7,2,0,0,1,-1,0,-1,1,1
KR_6766041608,420,4,-31,27,7,0,2,2,2,4,2,-2,2,4,4,5,1,3,5,2,0,5,-35,-3,9,6,2,0,1,1,1,1,-1,1,1
KR_6740670049,420,2,17,-26,7,2,4,2,-2,1,3,-2,1,3,8,8,0,1,1,0,0,12,9,-3,6,3,-4,0,2,-1,1,1,1,3,1
KR_6776457635,420,5,6,11,14,6,6,0,3,5,2,2,5,3,3,5,2,0,0,0,0,23,13,5,4,9,-4,0,1,0,1,1,1,0,1
KR_6729795586,440,1,18,36,-6,-4,0,4,2,4,2,1,2,1,-2,6,8,-3,1,4,1,-13,2,-2,6,4,-2,0,3,-1,1,1,1,3,1
KR_6773066568,420,2,71,3,9,-2,0,2,6,6,0,-1,0,1,7,7,0,-1,0,1,0,20,6,-3,6,3,5,0,1,1,1,1,1,3,1
KR_6774598097,420,-1,-8,8,-3,-2,2,4,1,3,2,0,1,1,0,2,2,-2,0,2,0,1,2,2,3,5,-1,0,1,-1,-1,1,-1,1,1
KR_6729028532,420,-1,-34,29,1,1,3,2,-2,8,10,1,4,3,3,6,3,-2,0,2,-1,-1,-6,7,2,9,-4,0,0,1,-1,-1,-1,1,1
KR_6707894656,420,-1,-23,8,-10,-2,0,2,-1,2,3,-2,1,3,-6,0,6,1,1,0,0,-19,4,4,3,7,-10,0,0,-1,1,0,-1,6,1
KR_6771059385,440,0,3,6,5,0,1,1,-4,0,4,7,7,0,2,3,1,0,6,6,1,1,-13,0,6,6,-3,0,0,1,1,1,1,2,1
KR_6751291941,440,7,50,24,11,7,7,0,3,3,0,0,1,1,-1,1,2,2,2,0,0,6,0,0,6,6,-2,0,2,1,-1,1,1,5,1
KR_6774827579,420,-3,-13,15,2,0,1,1,8,9,1,-5,2,7,-3,0,3,2,2,0,1,11,-26,-4,10,6,-2,0,-1,1,1,-1,1,6,1
KR_6775660403,420,-1,42,-30,-1,-1,0,1,0,3,3,2,6,4,0,3,3,-2,0,2,0,0,-1,-2,7,5,5,0,2,1,1,1,1,2,1
KR_6732284071,420,1,-42,18,3,-3,0,3,4,4,0,1,4,3,2,2,0,-1,1,2,0,7,20,-1,7,6,1,0,0,1,1,0,1,2,1
KR_6776021759,420,2,16,-9,-5,3,4,1,2,3,1,-1,3,4,-7,1,8,-2,1,3,-4,-19,2,-5,12,7,7,0,1,-1,1,1,-1,6,1
KR_6726614010,420,4,15,-16,6,7,7,0,-2,3,5,4,4,0,0,2,2,-3,2,5,0,13,-9,2,5,7,3,0,1,1,1,1,1,6,1
KR_6739501046,420,5,18,16,12,3,3,0,0,4,4,1,1,0,5,6,1,3,3,0,2,16,69,1,8,9,5,0,3,1,1,1,1,2,1
KR_6702751626,420,2,59,31,8,1,2,1,-1,4,5,3,4,1,4,5,1,1,1,0,0,7,-29,-1,9,8,1,0,2,1,-1,1,1,4,1
KR_6776598711,420,4,46,2,4,-4,1,5,1,4,3,3,6,3,3,5,2,1,5,4,0,5,3,5,7,12,-8,0,1,-1,-1,1,1,5,1
KR_6762021571,420,-4,-37,7,-9,0,4,4,-4,6,10,-7,0,7,1,2,1,1,1,0,1,-10,-50,-1,10,9,3,0,-1,-1,-1,-1,1,1,1
KR_6776993560,420,2,22,9,8,0,1,1,4,4,0,2,3,1,1,2,1,1,1,0,0,8,1,2,3,5,5,0,2,1,1,1,1,5,1
KR_6768406335,420,5,26,22,13,-1,1,2,14,14,0,0,1,1,1,3,2,-1,1,2,0,9,16,3,6,9,-5,0,0,1,-1,1,1,3,1
KR_6766682286,420,0,-59,0,2,2,6,4,1,5,4,-6,1,7,3,6,3,2,4,2,0,-3,20,0,5,5,1,0,0,1,1,0,-1,2,1
KR_6767391418,420,3,46,-14,1,0,2,2,1,4,3,-1,0,1,0,2,2,1,1,0,0,-2,-5,-5,11,6,-6,0,0,-1,1,0,1,2,1
KR_6770004422,420,4,37,38,10,2,3,1,2,3,1,1,3,2,3,3,0,2,3,1,0,4,29,2,7,9,-7,0,1,1,-1,1,-1,2,1
KR_6743046446,420,-2,-44,-20,2,1,3,2,2,4,2,-1,1,2,1,2,1,-1,0,1,0,11,10,1,7,8,-5,0,1,-1,1,1,1,1,1
KR_6752720971,420,0,31,25,3,-1,3,4,-2,3,5,0,3,3,5,7,2,1,1,0,0,6,49,-2,12,10,3,0,-1,1,-1,1,-1,6,1
KR_6740919362,420,3,57,-12,8,4,4,0,1,5,4,-2,2,4,7,7,0,-2,0,2,0,0,18,-1,8,7,-3,0,0,1,-1,0,1,6,1
KR_6766028902,440,0,-32,9,-3,2,4,2,1,4,3,-1,1,2,-2,2,4,-3,2,5,0,-5,-14,-5,8,3,1,0,0,1,1,0,1,6,1
KR_6713637583,420,3,91,-36,4,3,3,0,0,0,0,-3,1,4,2,4,2,2,3,1,0,6,-25,0,8,8,6,0,1,1,-1,1,-1,5,1
KR_6773323021,420,1,57,0,0,1,2,1,5,5,0,-1,7,8,-4,1,5,-1,2,3,-1,-7,0,3,4,7,4,0,1,1,-1,1,-1,2,1
KR_6743373747,420,-1,19,19,-1,-1,2,3,-3,3,6,5,6,1,-4,1,5,2,4,2,0,-6,-13,-6,8,2,3,0,-1,1,-1,-1,1,1,1
KR_6724423297,420,-2,-9,23,1,0,1,1,0,5,5,3,4,1,-1,1,2,-1,0,1,0,8,-41,0,5,5,20,0,-1,1,1,-1,1,3,1
KR_6733412298,440,2,-7,12,6,-1,0,1,9,9,0,1,2,1,-3,3,6,0,2,2,1,7,-2,5,3,8,-2,0,0,1,1,-1,1,5,1
KR_6767984822,420,-3,-51,-62,-8,-5,1,6,0,4,4,-1,1,2,-3,1,4,1,1,0,0,-1,84,4,4,8,-2,0,-2,-1,-1,-1,-1,6,1
KR_6776401926,420,1,-27,20,6,-1,2,3,0,3,3,4,4,0,0,2,2,3,4,1,2,11,27,-5,10,5,3,0,0,1,-1,0,1,3,1
KR_6710248072,420,0,44,-12,3,-4,3,7,-1,4,5,4,5,1,7,7,0,-3,1,4,1,9,26,4,8,12,-3,0,0,1,-1,1,1,4,1
KR_6693661827,420,3,48,2,8,0,3,3,5,6,1,1,3,2,3,3,0,-1,1,2,-1,8,-23,3,7,10,-1,0,0,1,0,0,-1,2,1
KR_6762402048,420,3,21,11,2,0,1,1,3,3,0,-1,2,3,-2,3,5,2,2,0,1,2,1,1,5,6,-1,0,-1,-1,-1,-1,1,2,1
KR_6774515535,420,5,44,34,13,3,6,3,1,3,2,1,3,2,5,5,0,3,3,0,0,18,-28,0,8,8,-5,0,2,1,-1,1,-1,4,1
KR_6776036858,420,7,67,-23,26,4,4,0,2,4,2,7,8,1,13,14,1,0,2,2,0,20,-5,0,6,6,1,0,3,0,1,1,-1,0,1
KR_6714117750,420,0,57,-56,2,0,1,1,-2,4,6,0,1,1,2,4,2,2,2,0,1,5,-5,-2,6,4,1,0,1,1,-1,1,1,1,1
KR_6754627290,420,1,-26,25,5,-5,0,5,6,7,1,0,1,1,4,5,1,0,1,1,1,10,-27,0,5,5,5,0,0,1,-1,1,1,3,1
KR_6776517062,420,0,-10,21,-2,-4,2,6,3,4,1,2,3,1,-3,2,5,0,0,0,0,3,39,-1,10,9,6,0,1,1,-1,1,1,6,1
KR_6743501732,420,7,123,21,11,4,4,0,2,4,2,1,1,0,3,3,0,1,1,0,0,12,3,3,5,8,5,0,3,1,1,1,1,5,1
KR_6769568806,420,1,49,6,1,1,2,1,1,4,3,2,3,1,-2,0,2,-1,1,2,0,-7,0,4,5,9,2,0,0,1,-1,1,1,1,1
KR_6775778319,420,0,-3,-35,6,4,5,1,1,1,0,-3,2,5,2,4,2,2,4,2,0,25,-4,3,6,9,1,0,-1,-1,-1,-1,1,5,1
KR_6693696654,420,-1,-40,-21,-3,-3,0,3,-1,1,2,2,6,4,-1,2,3,0,1,1,2,-7,27,2,6,8,-1,0,-2,-1,1,-1,1,2,1
KR_6777349522,420,1,20,31,-3,1,2,1,-2,4,6,0,2,2,-1,3,4,-1,0,1,0,-12,-76,-1,6,5,4,0,0,1,1,0,-1,2,1
KR_6770598005,420,-1,16,-22,-3,0,1,1,3,6,3,2,4,2,-9,2,11,1,2,1,0,-2,413,6,3,9,1,0,0,1,1,-1,-1,5,1
KR_6731700308,420,3,52,7,-1,1,3,2,-2,2,4,-2,1,3,3,5,2,-1,1,2,2,-3,-5,-3,7,4,-2,0,0,-1,1,1,1,5,1
KR_6740902549,420,3,-29,42,0,1,3,2,1,5,4,3,6,3,-2,2,4,-3,1,4,-5,-1,4,0,6,6,-2,0,0,-1,1,1,-1,4,1
KR_6751036583,420,3,21,23,10,6,6,0,2,3,1,2,3,1,-1,3,4,1,3,2,0,10,32,-4,9,5,2,0,1,-1,1,1,1,3,1
KR_6766439333,420,6,50,36,9,2,3,1,1,2,1,6,6,0,0,1,1,0,0,0,0,6,36,1,4,5,-1,0,1,1,1,1,1,6,1
KR_6743980731,420,2,43,12,4,-2,0,2,-1,1,2,-1,1,2,8,10,2,0,2,2,1,14,1,6,3,9,-4,0,1,1,1,1,1,5,1
KR_6765391875,420,4,66,12,9,1,2,1,1,3,2,1,2,1,5,6,1,1,1,0,0,15,2,-2,5,3,6,0,0,1,1,1,-1,5,1
KR_6763807521,420,2,40,-31,6,2,3,1,4,5,1,5,8,3,-4,1,5,-1,2,3,-1,3,6,2,4,6,-3,0,2,-1,1,1,-1,1,1
KR_6714580346,420,2,19,4,8,0,2,2,1,3,2,1,3,2,7,12,5,-1,0,1,0,11,1,6,4,10,3,0,2,1,1,1,-1,4,1
KR_6773761286,420,0,-17,-13,3,1,2,1,1,2,1,0,3,3,2,3,1,-1,0,1,0,6,-106,6,1,7,-9,0,0,-1,1,0,-1,2,1
KR_6712288583,420,2,-15,16,6,-1,0,1,5,7,2,1,4,3,0,3,3,1,1,0,1,15,-87,1,9,10,-5,0,1,1,1,1,1,6,1
KR_6757368078,420,1,10,6,10,3,4,1,0,3,3,-2,0,2,8,9,1,1,1,0,0,5,15,-1,8,7,-2,0,2,1,1,1,-1,5,1
KR_6766227104,420,9,85,89,18,3,4,1,5,6,1,2,3,1,11,11,0,-3,0,3,2,24,6,2,3,5,4,0,3,1,1,1,1,5,1
KR_6773997052,420,5,3,0,8,4,4,0,0,0,0,1,3,2,3,7,4,0,1,1,0,9,-17,-3,5,2,0,0,1,-1,1,1,-1,6,1
KR_6766571687,420,-1,89,35,12,1,4,3,8,9,1,1,4,3,-1,4,5,3,6,3,1,10,18,0,6,6,5,0,3,-1,1,1,1,3,1
KR_6773040834,420,3,51,11,9,3,4,1,1,4,3,1,2,1,5,6,1,-1,1,2,0,8,-9,-1,8,7,6,0,1,1,1,1,1,3,1
KR_6775536250,420,0,-19,-8,-1,-4,0,4,1,2,1,2,5,3,0,5,5,0,1,1,0,1,4,0,7,7,3,0,0,-1,1,1,1,2,1
KR_6775519611,420,2,28,-4,8,2,3,1,3,6,3,1,3,2,1,3,2,1,2,1,1,11,11,-1,8,7,0,0,2,1,1,1,1,4,1
KR_6746076520,420,1,23,15,3,3,4,1,0,2,2,-4,2,6,1,7,6,3,3,0,-2,-3,-59,1,7,8,-1,0,2,-1,1,1,-1,5,1
KR_6768083502,420,6,51,12,14,-1,1,2,4,5,1,1,2,1,2,4,2,8,8,0,0,19,22,-5,11,6,3,0,0,0,1,-1,1,0,1
KR_6734945188,420,-1,38,24,0,0,1,1,2,3,1,0,2,2,-2,0,2,0,1,1,0,0,27,-6,11,5,6,0,0,-1,1,0,1,2,1
KR_6748540792,420,4,4,24,4,0,0,0,0,5,5,2,4,2,1,3,2,1,1,0,0,6,-24,1,5,6,2,0,-1,1,-1,-1,1,1,1
KR_6761235066,420,0,52,-25,-2,0,2,2,-1,2,3,-2,2,4,2,4,2,-1,3,4,2,4,-43,-3,8,5,-3,0,2,-1,1,1,1,2,1
KR_6713180395,420,0,24,-1,0,2,2,0,1,3,2,-2,1,3,-2,1,3,1,2,1,0,3,7,-3,7,4,1,0,0,-1,1,1,1,2,1
KR_6777701522,420,7,23,52,14,8,8,0,8,8,0,-2,0,2,0,3,3,0,1,1,0,7,9,0,5,5,3,0,3,1,1,1,1,4,1
KR_6764550066,420,0,1,-12,3,2,4,2,-3,3,6,3,4,1,-3,4,7,4,5,1,-1,-7,9,2,6,8,-6,0,1,0,1,1,-1,0,1
KR_6727287530,440,0,-19,16,4,-6,0,6,-3,0,3,7,8,1,5,5,0,1,2,1,2,12,47,4,3,7,1,0,0,1,1,-1,1,1,1
KR_6679458941,420,4,126,28,7,5,5,0,-3,0,3,0,1,1,4,5,1,1,1,0,0,3,-3,-1,10,9,2,0,1,1,1,1,1,1,1
KR_6715613214,420,5,34,19,13,2,2,0,1,7,6,5,5,0,4,4,0,1,1,0,0,20,5,2,4,6,-6,0,2,1,1,1,1,1,1
KR_6764413196,420,1,0,-5,-2,-3,1,4,-3,2,5,2,6,4,-3,2,5,5,5,0,0,1,-11,-4,11,7,10,0,0,1,-1,-1,1,2,1
KR_6754450026,420,4,33,12,12,3,3,0,8,12,4,0,0,0,2,5,3,-1,0,1,0,11,7,5,3,8,0,0,1,1,1,1,-1,4,1
KR_6769313482,420,4,41,-2,8,3,3,0,2,3,1,3,5,2,0,3,3,0,0,0,0,1,11,2,5,7,1,0,0,1,1,1,1,5,1
KR_6732977875,420,10,184,63,20,2,3,1,8,9,1,-3,1,4,6,8,2,7,7,0,2,32,40,0,5,5,4,0,2,1,1,1,1,4,1
KR_6774370005,420,0,31,55,0,0,1,1,2,2,0,1,1,0,1,1,0,-4,0,4,0,3,5,4,3,7,3,0,1,-1,1,1,-1,3,1
KR_6744837957,420,1,-6,20,8,2,2,0,-1,1,2,-2,4,6,10,12,2,-1,1,2,1,22,5,1,7,8,1,0,2,1,1,1,1,5,1
KR_6769917503,420,-2,-21,-9,-8,-2,0,2,-3,0,3,0,1,1,-4,0,4,1,1,0,0,-9,-1,-4,9,5,-2,0,0,1,-1,0,-1,3,1
KR_6774282140,420,5,75,8,7,4,5,1,4,7,3,0,2,2,-1,0,1,0,2,2,0,3,12,4,6,10,-4,0,4,1,1,1,1,6,1
KR_6773221575,420,2,47,16,5,2,3,1,-1,1,2,2,3,1,1,1,0,1,1,0,-1,2,6,-1,8,7,6,0,1,1,1,1,-1,6,1
KR_6767269162,420,5,45,24,4,2,2,0,3,4,1,0,2,2,-1,0,1,0,0,0,0,2,7,3,5,8,0,0,1,1,1,1,-1,6,1
KR_6777810495,420,1,-15,31,0,-2,1,3,2,4,2,-1,3,4,1,2,1,0,1,1,0,3,12,7,4,11,-1,0,1,1,1,1,1,4,1
KR_6775959221,420,-2,-3,-16,-7,4,4,0,-15,0,15,-1,2,3,1,3,2,4,6,2,0,-14,4,9,2,11,-3,0,0,-1,-1,-1,-1,2,1
KR_6776478138,440,1,0,-11,1,-4,0,4,0,0,0,3,3,0,3,5,2,-1,1,2,0,18,-67,2,7,9,1,0,1,1,-1,1,-1,5,1
KR_6776454320,420,2,70,-1,11,-1,1,2,3,6,3,2,4,2,1,3,2,6,7,1,0,13,-2,5,3,8,-3,0,2,1,1,1,1,3,1
KR_6776614996,420,0,-44,-16,1,-3,1,4,2,5,3,-1,3,4,4,5,1,-1,0,1,-1,3,77,0,7,7,-21,0,-1,1,1,-1,-1,3,1
KR_6775410609,420,3,-24,-3,6,0,6,6,4,6,2,-1,3,4,3,6,3,0,4,4,1,6,-2,2,5,7,3,0,2,-1,1,1,-1,2,1
KR_6774589467,420,-2,-14,4,-7,0,1,1,-3,2,5,-5,0,5,2,2,0,-1,0,1,-1,-10,25,4,3,7,0,0,-1,-1,-1,-1,-1,2,1
KR_6774113662,420,3,74,23,3,4,5,1,-6,2,8,4,4,0,1,4,3,0,1,1,0,1,-18,3,4,7,1,0,0,1,1,-1,-1,3,1
KR_6697056466,420,-2,-60,8,-1,-4,1,5,0,4,4,0,0,0,3,3,0,0,0,0,0,2,11,4,5,9,-6,0,-3,1,-1,-1,-1,2,1
KR_6767623953,420,3,50,-29,9,1,4,3,-1,4,5,2,2,0,7,7,0,0,1,1,0,11,-3,3,2,5,5,0,2,1,1,1,-1,6,1
KR_6772211562,420,2,48,8,-3,-3,1,4,0,3,3,-2,0,2,1,3,2,1,2,1,0,7,38,3,6,9,-12,0,0,1,-1,1,-1,1,1
KR_6756547836,420,5,96,0,14,3,3,0,2,6,4,2,7,5,6,10,4,1,1,0,2,17,34,-3,8,5,3,0,3,1,1,1,1,3,1
KR_6771363500,440,1,-1,-7,-2,4,4,0,1,2,1,-4,3,7,-4,0,4,1,2,1,0,-9,-3,4,4,8,-1,0,0,-1,1,0,1,1,1
KR_6742252137,420,6,79,6,12,5,7,2,2,4,2,3,4,1,2,5,3,0,1,1,0,10,6,0,8,8,2,0,3,1,1,1,-1,6,1
KR_6773240065,420,3,2,13,2,4,4,0,-5,2,7,0,2,2,4,5,1,-1,0,1,0,7,-13,2,7,9,-2,0,1,1,-1,1,-1,4,1
KR_6776860256,420,4,43,18,18,8,8,0,2,5,3,2,2,0,3,4,1,3,3,0,0,17,7,3,5,8,0,0,5,1,1,1,1,1,1
KR_6769673211,420,5,90,0,8,-1,2,3,2,3,1,4,6,2,2,4,2,1,1,0,1,19,7,0,10,10,2,0,0,1,-1,-1,1,6,1
KR_6774177055,420,6,139,-11,14,1,2,1,5,5,0,-1,1,2,3,5,2,6,10,4,0,17,4,2,5,7,-3,0,2,1,1,1,1,2,1
KR_6769507513,420,4,48,17,5,-1,1,2,-2,0,2,9,9,0,-1,3,4,0,1,1,0,7,-28,-2,7,5,26,0,2,1,1,1,1,4,1
KR_6776226929,420,1,51,-2,2,2,4,2,4,5,1,0,2,2,-5,1,6,1,1,0,0,5,-8,4,3,7,1,0,2,-1,-1,1,-1,4,1
KR_6750834814,420,0,-14,-6,9,0,3,3,3,4,1,0,1,1,5,5,0,1,1,0,0,12,7,2,5,7,-1,0,1,-1,1,1,1,4,1
KR_6771534242,420,-1,-34,24,0,1,1,0,1,1,0,0,0,0,-2,1,3,0,0,0,0,-5,24,-3,10,7,-5,0,0,-1,1,0,1,4,1
KR_6742779498,420,0,44,-30,0,0,2,2,-1,4,5,-2,1,3,1,3,2,2,3,1,1,-2,-4,7,3,10,-2,0,2,1,1,1,1,2,1
KR_6775920323,420,1,52,11,3,3,4,1,0,1,1,-2,2,4,4,5,1,-2,0,2,0,-3,-28,6,2,8,6,0,0,1,1,1,1,2,1
KR_6754372139,420,4,43,0,11,1,1,0,4,4,0,1,3,2,5,6,1,0,1,1,0,12,6,5,4,9,1,0,2,1,-1,1,1,2,1
KR_6775276668,420,2,1,-16,6,-3,1,4,-1,1,2,7,7,0,2,2,0,1,2,1,0,7,2,1,6,7,-1,0,0,1,1,0,1,1,1
KR_6755838175,420,1,19,9,8,1,2,1,3,4,1,1,3,2,5,6,1,-2,1,3,0,18,35,4,5,9,0,0,3,1,1,1,1,4,1
KR_6742818507,420,0,-3,-18,1,-1,0,1,-1,2,3,1,2,1,2,2,0,0,1,1,0,1,14,1,7,8,4,0,0,1,-1,0,-1,6,1
KR_6709485806,420,2,-64,17,5,-4,0,4,7,10,3,1,1,0,2,3,1,-1,0,1,0,11,-35,-2,5,3,14,0,-1,1,1,1,1,5,1
KR_6737051989,420,0,25,7,-2,1,3,2,-1,2,3,1,3,2,-1,4,5,-2,0,2,0,-4,-33,-1,7,6,6,0,1,-1,1,1,1,1,1
KR_6777628463,420,1,19,-15,10,3,3,0,9,11,2,2,4,2,-4,1,5,0,1,1,0,10,111,1,5,6,6,0,3,1,1,1,-1,1,1
KR_6753806863,420,2,30,-5,2,-5,0,5,3,3,0,-1,1,2,5,6,1,0,3,3,0,1,1,5,3,8,1,0,2,1,1,1,-1,4,1
KR_6754744065,420,2,-9,16,7,2,2,0,1,4,3,1,2,1,4,6,2,-1,1,2,-1,5,21,0,6,6,5,0,1,1,1,1,-1,3,1
KR_6776463882,420,1,56,16,-4,-2,0,2,-5,1,6,1,2,1,1,2,1,1,1,0,0,-4,1,3,5,8,5,0,0,1,1,0,-1,6,1
KR_6771911354,420,2,-11,12,4,2,2,0,-3,2,5,4,10,6,0,1,1,1,1,0,0,-6,13,3,5,8,-4,0,0,-1,1,1,1,6,1
KR_6755953167,420,1,25,6,3,0,3,3,6,9,3,-4,2,6,2,3,1,-1,1,2,0,-3,1,3,5,8,-2,0,1,-1,1,1,-1,2,1
KR_6752999374,420,2,32,-7,1,1,3,2,4,4,0,-6,0,6,0,5,5,2,3,1,0,4,342,1,6,7,-1,0,-1,0,0,-1,-1,0,1
KR_6764361300,420,-3,22,-19,0,2,3,1,1,2,1,-2,1,3,0,2,2,-1,0,1,0,-3,107,2,3,5,1,0,0,1,1,0,-1,2,1
KR_6735273390,420,-1,52,46,-3,-5,2,7,2,5,3,1,3,2,-1,2,3,0,0,0,0,-4,0,0,7,7,4,0,0,1,-1,1,-1,5,1
KR_6773630590,420,1,32,-8,4,0,1,1,1,2,1,3,3,0,0,2,2,0,2,2,0,4,5,-2,7,5,-3,0,1,-1,-1,1,1,6,1
KR_6709522230,420,3,-36,31,5,-2,0,2,1,3,2,1,1,0,5,5,0,0,0,0,0,10,-3,0,4,4,0,0,0,1,-1,0,1,1,1
KR_6776437806,420,3,-5,6,2,-2,1,3,2,4,2,3,4,1,0,2,2,-1,1,2,0,7,-4,-2,8,6,0,0,0,1,-1,1,-1,2,1
KR_6774176904,420,3,21,-4,11,2,5,3,2,4,2,6,8,2,1,4,3,0,1,1,0,14,-421,5,5,10,2,0,2,-1,1,1,-1,6,1
KR_6771554875,420,3,46,51,4,-1,0,1,3,5,2,3,4,1,0,3,3,-1,0,1,0,5,6,2,3,5,2,0,1,-1,1,1,-1,6,1
KR_6724513468,420,-1,-3,-16,1,0,1,1,0,4,4,-1,3,4,1,2,1,1,1,0,0,7,-6,1,8,9,1,0,0,-1,-1,1,1,1,1
KR_6777456690,420,3,80,5,4,2,3,1,2,2,0,1,2,1,-1,2,3,0,0,0,1,0,11,2,6,8,1,0,2,-1,1,1,1,5,1
KR_6748528597,420,0,-33,23,-2,-7,0,7,0,4,4,0,5,5,2,3,1,3,3,0,0,8,-34,-2,4,2,-2,0,-1,1,1,-1,-1,6,1
KR_6766604023,420,7,102,47,15,3,4,1,4,5,1,5,5,0,2,4,2,1,2,1,0,19,2,3,1,4,2,0,1,1,1,1,1,4,1
KR_6736399222,420,2,40,6,5,4,5,1,4,5,1,1,2,1,-3,3,6,-1,0,1,0,6,36,1,6,7,9,0,3,-1,1,1,1,4,1
KR_6750695848,420,3,18,13,9,2,2,0,4,5,1,2,2,0,0,3,3,1,1,0,0,9,2,6,6,12,6,0,0,1,-1,-1,1,5,1
KR_6777684058,420,-1,-5,11,-1,2,2,0,-2,3,5,1,3,2,-2,0,2,0,0,0,0,-1,-1,-2,5,3,-4,0,-1,-1,-1,-1,1,4,1
KR_6728621488,420,-1,-21,39,-9,0,1,1,-4,0,4,-1,1,2,-3,2,5,-1,0,1,0,-9,-6,-1,6,5,-1,0,0,-1,1,0,1,2,1
KR_6765989116,420,2,-6,21,2,-3,0,3,0,3,3,0,3,3,5,6,1,0,0,0,0,7,46,3,3,6,-1,0,1,1,-1,1,1,6,1
KR_6738327282,420,1,-14,-2,0,0,3,3,0,2,2,2,2,0,-1,0,1,-1,0,1,0,-3,-4,0,6,6,6,0,0,-1,1,0,-1,1,1
KR_6749787400,420,2,-14,16,4,0,1,1,1,6,5,4,5,1,-1,1,2,0,0,0,0,4,38,6,3,9,-5,0,-1,1,1,-1,-1,1,1
KR_6777019349,420,4,27,-7,8,-1,1,2,3,4,1,6,7,1,0,1,1,0,1,1,0,8,-4,2,5,7,3,0,0,-1,1,0,1,2,1
KR_6763477843,440,0,12,-5,-1,0,1,1,2,3,1,0,4,4,-3,0,3,0,1,1,0,0,-19,-1,4,3,-1,0,0,-1,1,0,-1,1,1
KR_6767666563,440,5,-1,18,14,2,3,1,0,2,2,8,11,3,1,3,2,3,3,0,1,17,21,5,3,8,3,0,1,1,-1,1,1,4,1
KR_6771231237,440,2,-41,22,6,-1,4,5,3,5,2,5,5,0,0,4,4,-1,2,3,0,3,-5,-6,11,5,-2,0,0,-1,-1,-1,1,6,1
KR_6764518975,420,2,64,20,3,-1,1,2,-3,3,6,3,4,1,4,9,5,0,0,0,1,9,-2,0,5,5,4,0,3,-1,1,1,1,5,1
KR_6776597008,440,0,1,16,1,4,5,1,-3,0,3,1,3,2,-3,1,4,2,3,1,0,1,10,-4,6,2,3,0,-1,1,-1,-1,1,4,1
KR_6775454362,420,2,-17,8,7,1,3,2,0,1,1,1,3,2,3,4,1,2,2,0,0,9,-4,1,6,7,2,0,0,-1,1,0,-1,5,1
KR_6707824330,420,-2,2,-30,-2,2,3,1,-1,1,2,-1,1,2,-1,3,4,-1,0,1,0,-1,-6,-1,6,5,5,0,-1,-1,-1,-1,-1,1,1
KR_6708958642,420,3,0,-2,15,2,4,2,2,5,3,4,9,5,5,6,1,2,2,0,0,16,-32,0,6,6,5,0,0,1,1,1,-1,4,1
KR_6713694031,420,1,-16,20,-3,0,1,1,0,3,3,0,4,4,-4,4,8,1,1,0,-1,-4,-18,-2,7,5,0,0,0,-1,1,0,-1,3,1
KR_6771396738,420,1,22,-8,6,1,2,1,2,4,2,-1,1,2,3,3,0,1,1,0,0,12,21,-6,12,6,1,0,1,-1,1,1,1,6,1
KR_6755986083,420,3,59,32,3,2,2,0,-1,0,1,3,4,1,-1,5,6,0,0,0,0,3,0,-4,8,4,-4,0,1,-1,1,-1,-1,5,1
KR_6766840483,420,3,24,24,15,4,5,1,9,10,1,7,8,1,-5,0,5,0,1,1,0,6,0,3,4,7,-4,0,1,1,1,1,1,6,1
KR_6772935600,440,1,35,12,5,2,2,0,1,1,0,-1,6,7,0,4,4,3,4,1,0,-7,-39,0,3,3,23,0,0,-1,1,1,-1,5,1
KR_6760718771,420,7,65,31,16,8,8,0,1,4,3,0,2,2,4,8,4,3,4,1,0,10,2,5,1,6,-1,0,3,1,1,1,1,2,1
KR_6767594893,420,0,62,-12,1,-2,2,4,3,3,0,2,4,2,0,1,1,-2,0,2,0,1,-1,-1,5,4,3,0,-1,-1,-1,-1,-1,1,1
KR_6706066926,420,1,17,6,-2,-4,0,4,-2,1,3,6,6,0,-2,0,2,0,0,0,0,-5,-2,3,8,11,2,0,0,1,-1,-1,-1,2,1
KR_6751547593,420,2,-3,10,8,0,4,4,-2,0,2,5,8,3,2,9,7,3,3,0,1,13,46,4,3,7,2,0,2,1,1,1,1,2,1
KR_6774352385,420,-3,-83,26,-5,-4,0,4,1,5,4,3,4,1,-3,3,6,-2,1,3,0,-8,-6,0,4,4,2,0,-1,1,-1,-1,1,6,1
KR_6742866231,420,5,26,35,9,1,1,0,0,0,0,3,3,0,3,4,1,2,3,1,0,13,1,4,6,10,0,0,1,1,-1,1,1,5,1
KR_6776810559,420,-1,-63,-3,2,-1,1,2,3,5,2,-1,3,4,3,3,0,-2,0,2,1,13,57,0,4,4,0,0,1,-1,1,-1,1,4,1
KR_6755175309,420,2,-14,-12,3,-5,0,5,3,5,2,1,4,3,3,4,1,1,1,0,0,14,-1,4,5,9,-3,0,1,1,-1,1,-1,3,1
KR_6736803093,420,-1,-44,2,5,0,2,2,4,5,1,0,0,0,2,3,1,-1,0,1,0,10,44,1,7,8,-13,0,0,-1,1,1,1,4,1
KR_6769026604,420,2,-10,23,10,0,2,2,1,3,2,3,4,1,4,5,1,2,2,0,0,15,0,2,3,5,6,0,0,1,1,0,1,3,1
KR_6762832427,420,-2,17,4,2,1,3,2,2,3,1,-1,7,8,5,5,0,-5,0,5,0,10,13,2,2,4,-2,0,-1,-1,-1,1,1,4,1
KR_6734672845,420,3,68,12,1,-2,1,3,-2,3,5,0,3,3,2,2,0,3,3,0,-1,-9,0,4,6,10,6,0,2,1,1,1,-1,1,1
KR_6773680257,420,-3,-1,-56,3,-1,2,3,1,3,2,4,5,1,-2,1,3,1,1,0,0,3,5,0,7,7,-4,0,1,1,1,1,1,5,1
KR_6696954583,420,-3,-24,4,-2,-6,0,6,4,6,2,-1,4,5,2,6,4,-1,2,3,1,7,-12,-3,10,7,3,0,-1,-1,-1,-1,1,1,1
KR_6774456323,420,1,9,-18,4,-3,1,4,4,7,3,-3,2,5,4,7,3,2,2,0,2,6,-5,0,6,6,4,0,0,1,1,1,1,3,1
KR_6754404767,420,3,54,3,7,3,6,3,1,3,2,3,3,0,3,5,2,-3,2,5,-1,7,-205,5,6,11,-1,0,2,-1,1,1,-1,6,1
KR_6747880967,420,0,3,8,0,1,4,3,2,3,1,-1,3,4,-1,1,2,-1,0,1,0,0,-9,-5,7,2,5,0,3,-1,1,1,-1,1,1
KR_6746242939,440,-3,-108,-65,-2,-2,1,3,2,4,2,1,1,0,-2,1,3,-1,1,2,0,1,-1,0,5,5,-1,0,-2,-1,-1,-1,1,1,1
KR_6734492640,420,2,20,21,0,2,2,0,2,7,5,-5,2,7,1,4,3,0,0,0,0,1,-7,-5,9,4,6,0,1,-1,-1,1,-1,6,1
KR_6740960403,420,4,22,20,10,2,3,1,4,7,3,2,2,0,2,5,3,0,1,1,-1,11,-53,-6,13,7,3,0,0,1,-1,1,1,3,1
KR_6765251783,420,6,25,19,11,5,5,0,3,3,0,3,4,1,0,3,3,0,0,0,0,9,-1,1,6,7,-1,0,2,-1,1,1,1,2,1
KR_6776757643,420,0,-13,-8,9,-1,0,1,1,1,0,2,3,1,2,3,1,5,6,1,-1,14,-22,7,3,10,-4,0,0,1,1,-1,-1,4,1
KR_6726012597,420,9,103,68,19,3,3,0,3,7,4,6,8,2,3,4,1,4,4,0,0,22,-20,0,7,7,4,0,3,-1,1,1,-1,4,1
KR_6769662230,440,4,94,44,0,0,1,1,-1,2,3,1,2,1,0,3,3,0,0,0,0,-7,25,2,4,6,1,0,0,1,1,1,-1,6,1
KR_6775428555,420,1,-7,0,10,-1,1,2,7,7,0,1,1,0,-1,1,2,4,5,1,0,16,1,0,7,7,9,0,-1,1,-1,-1,1,5,1
KR_6770321786,420,3,58,11,5,0,1,1,-2,3,5,1,2,1,7,10,3,-1,1,2,-1,14,4,3,4,7,3,0,2,1,-1,1,-1,2,1
KR_6741872175,420,3,58,-35,9,5,5,0,1,2,1,0,0,0,1,4,3,2,2,0,1,8,3,5,0,5,7,0,2,1,1,1,1,5,1
KR_6733904248,420,5,68,6,7,9,10,1,0,4,4,4,5,1,-2,2,4,-4,0,4,0,0,-17,5,3,8,3,0,1,-1,-1,1,1,5,1
KR_6771950859,420,3,74,-5,6,4,4,0,0,6,6,-1,1,2,1,4,3,2,2,0,0,7,-13,3,5,8,-6,0,2,1,-1,1,-1,2,1
KR_6775558502,420,6,113,66,15,0,2,2,8,8,0,4,9,5,2,2,0,1,4,3,0,21,-49,1,5,6,4,0,2,1,1,1,1,6,1
KR_6762574223,420,2,52,8,-3,5,5,0,-1,2,3,2,3,1,-9,1,10,0,0,0,-1,-7,-10,-8,11,3,6,0,-1,-1,1,-1,1,4,1
KR_6710108562,420,1,56,-20,7,-1,3,4,7,9,2,1,3,2,-1,1,2,1,1,0,-1,13,-9,-3,10,7,0,0,2,-1,1,1,-1,5,1
KR_6777772391,420,6,92,4,10,5,5,0,-1,1,2,2,5,3,5,6,1,-1,0,1,3,19,34,3,2,5,-7,0,3,1,1,1,1,3,1
KR_6769679259,420,3,45,-14,10,6,6,0,4,4,0,2,3,1,-1,2,3,-1,1,2,0,6,-5,-1,6,5,2,0,2,0,1,1,1,0,1
KR_6698275807,420,3,31,8,6,3,3,0,4,6,2,1,2,1,-2,2,4,0,0,0,0,5,3,1,4,5,-2,0,3,0,1,1,1,0,1
KR_6743008574,420,4,72,27,15,-1,2,3,9,10,1,-2,2,4,7,8,1,2,3,1,1,20,15,1,5,6,4,0,4,1,1,1,1,2,1
KR_6771648796,420,0,6,5,-4,-3,0,3,3,4,1,-5,0,5,2,2,0,-1,0,1,0,2,12,-1,5,4,2,0,-2,-1,-1,-1,-1,6,1
KR_6741167978,420,-1,-8,16,-3,-10,0,10,-2,1,3,-1,5,6,10,12,2,0,0,0,0,-4,-3,3,9,12,-2,0,0,-1,1,1,1,4,1
KR_6775778356,420,1,28,-4,2,-1,1,2,1,2,1,3,3,0,1,4,3,-2,2,4,0,0,1,7,4,11,0,0,0,1,1,0,-1,1,1
KR_6755557173,420,-1,63,1,-3,2,3,1,2,3,1,-5,3,8,-1,1,2,-1,0,1,0,-9,34,-2,7,5,2,0,1,1,1,1,-1,5,1
KR_6744330221,420,6,51,40,10,3,3,0,3,5,2,3,6,3,0,1,1,1,1,0,0,16,-5,-5,10,5,-2,0,0,1,-1,0,1,6,1
KR_6773852638,420,1,13,7,0,3,3,0,-1,3,4,0,2,2,-2,3,5,0,0,0,0,0,-11,-4,8,4,-2,0,-1,-1,-1,-1,-1,5,1
KR_6771501330,420,3,50,12,3,1,2,1,2,3,1,2,4,2,-1,2,3,-1,1,2,0,0,27,4,7,11,5,0,0,1,1,0,-1,3,1
KR_6735676351,420,2,-30,16,7,2,5,3,1,8,7,-2,0,2,6,7,1,0,1,1,0,1,0,8,4,12,-2,0,-1,1,1,-1,1,4,1
KR_6745954421,420,5,21,25,7,-2,1,3,6,6,0,0,6,6,1,3,2,2,2,0,0,4,34,-4,8,4,2,0,0,1,-1,-1,-1,6,1
KR_6738649125,420,4,14,23,6,1,2,1,3,6,3,0,3,3,0,2,2,2,2,0,1,9,138,-2,6,4,-3,0,1,1,-1,-1,1,2,1
KR_6748615019,420,2,-31,6,11,0,2,2,0,2,2,2,2,0,9,11,2,0,3,3,0,19,-29,5,4,9,4,0,1,1,-1,1,-1,6,1
KR_6771026771,420,2,33,3,7,4,5,1,-1,3,4,4,7,3,1,2,1,-1,1,2,0,4,18,0,8,8,-6,0,0,1,1,1,-1,6,1
KR_6740964767,420,0,-32,35,10,1,1,0,-1,4,5,1,5,4,10,12,2,-1,1,2,1,25,2,3,7,10,0,0,1,1,1,1,1,5,1
KR_6757075825,420,4,-33,48,17,1,2,1,9,10,1,0,3,3,8,8,0,-1,1,2,0,14,3,0,6,6,0,0,1,1,1,1,1,4,1
KR_6752798987,440,-1,22,12,4,-3,0,3,7,7,0,-3,1,4,-2,0,2,5,6,1,0,6,167,0,4,4,2,0,0,-1,1,1,1,3,1
KR_6773988014,440,-3,-51,-17,2,-1,1,2,1,3,2,0,1,1,3,5,2,-1,1,2,0,4,-10,-1,9,8,0,0,0,0,-1,0,-1,0,1
KR_6709377043,420,1,18,-19,3,-3,0,3,1,3,2,2,4,2,4,4,0,-1,0,1,0,4,-11,-2,8,6,9,0,0,1,-1,0,1,1,1
KR_6776980988,420,0,22,4,-6,-4,1,5,-4,1,5,0,2,2,2,3,1,0,1,1,0,-2,9,5,7,12,7,0,0,1,-1,1,1,3,1
KR_6765000765,420,3,-13,7,5,3,5,2,-1,4,5,-1,1,2,7,8,1,-3,0,3,0,3,-2,3,8,11,-4,0,0,1,-1,0,1,3,1
KR_6774360358,420,2,114,10,3,0,3,3,1,5,4,-4,0,4,4,6,2,2,2,0,0,-6,-39,-1,7,6,-1,0,2,1,-1,1,1,5,1
KR_6775881878,420,3,-6,1,5,1,2,1,-2,2,4,4,4,0,1,3,2,1,2,1,1,12,-6,0,7,7,7,0,1,1,1,1,1,4,1
KR_6720535092,420,5,-7,54,13,-1,1,2,6,9,3,7,7,0,0,4,4,1,4,3,0,13,8,3,3,6,5,0,1,1,1,1,1,1,1
KR_6758694602,420,0,73,-10,9,2,3,1,1,2,1,4,4,0,2,2,0,0,2,2,0,9,1,2,4,6,3,0,3,-1,1,1,1,6,1
KR_6771453013,420,8,87,12,18,11,14,3,3,4,1,3,3,0,0,2,2,1,1,0,0,14,5,5,4,9,1,0,5,1,1,1,1,2,1
KR_6702154702,420,5,37,21,6,6,8,2,1,3,2,-2,1,3,-2,2,4,3,5,2,1,-5,-16,1,8,9,3,0,2,1,1,1,1,3,1
KR_6776446208,440,-1,53,-19,-6,-3,0,3,-6,0,6,2,2,0,2,7,5,-1,1,2,2,0,-41,-3,7,4,-1,0,0,1,-1,-1,1,2,1
KR_6773257096,420,4,30,27,11,3,3,0,1,5,4,0,2,2,3,4,1,4,4,0,0,17,4,1,6,7,2,0,2,1,1,1,1,3,1
KR_6770065683,420,3,-13,-4,4,-3,0,3,4,5,1,3,4,1,2,3,1,-2,1,3,0,6,-4,6,4,10,11,0,0,1,1,0,1,4,1
KR_6764071364,420,-1,33,-27,3,-2,0,2,0,2,2,1,3,2,3,4,1,1,1,0,1,5,-38,4,6,10,-2,0,1,1,1,1,1,1,1
KR_6771234977,420,4,9,15,11,5,5,0,2,4,2,6,7,1,-4,0,4,2,2,0,0,15,-16,7,1,8,5,0,-1,1,-1,-1,1,3,1
KR_6776370589,420,2,12,11,1,-2,2,4,2,3,1,1,4,3,-1,2,3,1,3,2,-1,-2,7,4,4,8,-1,0,0,1,1,-1,-1,4,1
KR_6775177260,420,8,98,43,16,2,4,2,7,7,0,3,4,1,5,6,1,-1,0,1,0,20,11,7,0,7,-3,0,3,1,1,1,-1,3,1
KR_6758724532,420,3,45,-1,8,-1,1,2,7,8,1,3,5,2,0,3,3,-1,0,1,0,16,-20,-1,9,8,2,0,1,-1,1,1,1,5,1
KR_6777339649,420,1,-5,17,-2,-2,0,2,-2,0,2,2,2,0,-2,1,3,2,4,2,0,-4,5,-2,7,5,-2,0,1,-1,1,1,-1,1,1
KR_6777456275,420,3,52,-3,9,0,3,3,4,4,0,2,2,0,3,3,0,0,0,0,0,15,-4,3,4,7,1,0,1,1,1,1,1,6,1
KR_6771265379,420,2,-18,7,7,-3,0,3,1,5,4,1,2,1,8,8,0,0,1,1,0,10,2,3,2,5,-1,0,-1,1,-1,-1,1,2,1
KR_6777870440,420,4,44,8,0,2,2,0,3,7,4,-2,1,3,-4,1,5,1,1,0,0,2,0,-2,7,5,2,0,2,1,1,1,-1,2,1
KR_6771742614,420,-2,-64,-4,1,2,3,1,1,2,1,4,4,0,-6,3,9,0,2,2,-1,-10,15,5,6,11,-7,0,-1,-1,1,1,-1,5,1
KR_6760171651,420,-1,-67,-10,-3,5,5,0,3,5,2,-2,2,4,-5,0,5,-4,0,4,0,2,-3,0,4,4,-6,0,-2,-1,1,-1,-1,5,1
KR_6742748434,420,2,19,-16,9,1,1,0,0,3,3,1,2,1,5,6,1,2,2,0,0,15,-5,5,2,7,1,0,1,1,-1,1,1,6,1
KR_6772423118,420,0,15,7,0,-1,2,3,-2,1,3,-2,2,4,5,7,2,0,0,0,0,5,9,2,6,8,0,0,0,1,-1,-1,-1,4,1
KR_6770841917,420,0,-53,7,4,-1,3,4,1,2,1,5,5,0,-4,0,4,3,4,1,0,11,44,4,5,9,-26,0,-1,1,1,-1,1,5,1
KR_6753840869,420,2,-1,11,-2,1,2,1,0,2,2,-3,0,3,-4,5,9,4,4,0,0,-6,9,3,6,9,-2,0,1,-1,1,1,-1,1,1
KR_6772000397,440,1,-47,-3,1,-2,2,4,2,6,4,2,3,1,1,2,1,-2,1,3,0,-4,0,0,4,4,-2,0,0,1,1,1,-1,4,1
KR_6743455033,420,1,31,27,2,-2,1,3,5,8,3,1,2,1,0,3,3,-2,0,2,1,4,-13,-3,8,5,7,0,0,1,1,0,1,5,1
KR_6709277464,420,0,14,-12,3,3,3,0,1,2,1,-2,1,3,1,3,2,0,2,2,-1,3,10,2,3,5,-7,0,1,1,1,1,-1,4,1
KR_6777829698,420,4,-42,21,6,1,3,2,4,7,3,-1,2,3,5,5,0,-3,1,4,0,11,60,-3,7,4,-1,0,-1,1,-1,-1,-1,3,1
KR_6742663429,420,0,10,-5,-2,-2,0,2,1,2,1,-1,1,2,1,4,3,-1,0,1,0,-5,19,-3,6,3,-1,0,-1,1,-1,-1,1,4,1
KR_6769592465,420,0,99,-10,2,1,2,1,2,3,1,3,3,0,0,3,3,-4,0,4,0,4,3,4,3,7,0,0,0,1,-1,0,1,5,1
KR_6732595904,420,2,60,-29,8,0,3,3,1,4,3,1,4,3,6,6,0,0,0,0,2,10,25,-2,12,10,6,0,2,1,-1,1,1,6,1
KR_6762046790,420,3,-26,-7,12,-1,0,1,3,4,1,3,4,1,7,8,1,0,2,2,0,18,13,0,7,7,2,0,1,1,1,1,-1,2,1
KR_6777757967,420,-2,49,-18,-1,-3,1,4,0,2,2,0,1,1,2,3,1,0,0,0,0,6,-3,-4,9,5,5,0,0,1,-1,-1,-1,6,1
KR_6740460240,420,9,87,32,11,-2,0,2,7,10,3,2,4,2,0,2,2,4,4,0,-1,20,0,2,3,5,0,0,2,1,-1,1,-1,5,1
KR_6712439295,420,1,60,37,6,-1,1,2,0,0,0,7,8,1,1,3,2,-1,0,1,0,9,-14,-2,8,6,3,0,2,-1,-1,1,1,6,1
KR_6773001565,420,0,-75,12,-5,4,6,2,3,4,1,-2,2,4,-5,0,5,-5,1,6,0,5,1,-2,7,5,-1,0,-4,-1,-1,-1,-1,6,1
KR_6751789136,420,-2,-3,-3,-6,0,3,3,3,6,3,-3,1,4,-5,1,6,-1,1,2,0,-6,-2,-1,6,5,2,0,1,-1,-1,1,-1,4,1
KR_6727546373,420,6,96,42,21,2,3,1,5,7,2,-1,5,6,11,13,2,4,4,0,2,24,33,2,1,3,-2,0,3,1,1,1,1,4,1
KR_6766035652,420,-1,-18,11,-10,-3,1,4,-4,5,9,0,4,4,1,5,4,-4,0,4,1,-6,-10,-4,9,5,6,0,0,1,-1,-1,1,5,1
KR_6742635134,440,0,-54,9,4,-3,4,7,0,0,0,3,6,3,-3,0,3,7,7,0,0,7,2,2,6,8,0,0,0,1,1,-1,-1,5,1
KR_6764857577,420,2,-1,-20,1,3,4,1,-2,1,3,1,3,2,1,4,3,-2,3,5,0,5,2,-2,6,4,1,0,2,1,-1,1,-1,3,1
KR_6767911186,440,3,9,6,6,-2,3,5,4,4,0,1,2,1,4,6,2,-1,0,1,-1,4,10,0,2,2,-4,0,0,1,-1,1,-1,5,1
KR_6776837111,420,2,-1,12,5,1,2,1,2,2,0,0,3,3,3,4,1,-1,0,1,1,8,-7,2,8,10,10,0,-2,-1,-1,-1,1,5,1
KR_6764538735,420,2,66,-16,14,4,4,0,3,4,1,-1,1,2,6,9,3,2,2,0,0,7,-8,8,3,11,-2,0,2,1,1,1,1,3,1
KR_6740975770,420,7,112,46,4,0,1,1,0,5,5,3,5,2,-2,2,4,3,3,0,0,4,14,-3,7,4,1,0,0,-1,-1,1,-1,5,1
KR_6776364984,420,1,22,-3,1,-2,0,2,-4,1,5,6,6,0,-2,2,4,3,4,1,-1,-1,-15,-2,8,6,-2,0,0,-1,1,0,-1,4,1
KR_6776035551,420,0,62,53,1,1,1,0,-2,3,5,1,2,1,1,3,2,0,0,0,1,1,-5,2,5,7,6,0,1,1,1,1,1,4,1
KR_6736332710,420,3,31,-28,9,0,2,2,1,2,1,1,3,2,3,6,3,4,5,1,1,13,1,-2,8,6,1,0,1,1,1,1,-1,5,1
KR_6753804009,420,1,19,19,1,0,1,1,1,2,1,-1,2,3,1,3,2,0,2,2,0,-2,0,-4,8,4,2,0,0,1,-1,1,-1,1,1
KR_6771996674,420,3,52,16,2,-2,0,2,4,5,1,2,3,1,-2,0,2,0,1,1,0,12,-23,1,6,7,1,0,1,0,1,1,-1,0,1
KR_6777272929,420,-2,-66,0,2,1,2,1,-3,1,4,0,1,1,0,3,3,4,4,0,0,3,3,2,6,8,-4,0,1,1,1,1,1,3,1
KR_6756441722,420,4,7,15,6,-4,0,4,4,4,0,3,3,0,2,5,3,1,1,0,0,8,-18,0,6,6,5,0,0,1,-1,-1,-1,2,1
KR_6771122427,440,2,35,12,3,2,2,0,-5,0,5,5,6,1,1,1,0,0,0,0,0,-3,7,1,2,3,0,0,0,-1,1,0,-1,6,1
KR_6755403419,420,4,33,40,2,3,6,3,-1,1,2,2,3,1,-2,0,2,0,2,2,1,-4,-1,-5,10,5,-1,0,-1,1,-1,-1,1,2,1
KR_6766537216,420,-3,-10,7,-5,0,2,2,-1,1,2,-4,0,4,0,0,0,0,0,0,-1,-5,2,5,5,10,7,0,0,-1,-1,0,-1,4,1
KR_6763632133,420,1,-15,11,-1,-1,0,1,-1,1,2,2,3,1,-1,1,2,0,0,0,0,-4,0,-4,9,5,1,0,0,1,1,0,1,4,1
KR_6751487254,420,-1,21,6,-1,0,1,1,-4,2,6,4,4,0,-1,2,3,0,0,0,0,2,-17,1,5,6,4,0,1,-1,-1,1,-1,5,1
KR_6777551169,420,2,6,3,2,-1,0,1,0,1,1,2,4,2,-1,1,2,2,3,1,0,4,7,-3,9,6,-6,0,0,1,-1,0,1,5,1
KR_6742952493,440,-2,-45,28,0,-5,2,7,-1,0,1,-2,0,2,8,10,2,0,1,1,-1,6,3,6,4,10,-6,0,0,1,1,0,-1,3,1
KR_6775195829,420,0,19,-13,3,-2,0,2,0,4,4,1,4,3,4,8,4,0,1,1,-1,10,41,3,5,8,-2,0,1,1,-1,1,-1,6,1
KR_6755209465,420,3,38,-5,9,-2,0,2,1,1,0,7,7,0,1,4,3,2,3,1,0,9,7,2,3,5,1,0,1,1,-1,1,1,4,1
KR_6739163006,420,5,-27,14,5,1,1,0,4,4,0,4,5,1,-4,1,5,0,1,1,0,5,-25,2,5,7,0,0,0,-1,-1,0,1,4,1
KR_6723048671,440,0,70,8,-1,-2,0,2,1,4,3,2,4,2,-2,1,3,0,0,0,0,-12,8,6,3,9,3,0,0,1,-1,1,-1,2,1
KR_6764592643,420,6,68,24,10,5,5,0,2,2,0,-1,2,3,2,2,0,2,2,0,0,9,-14,6,2,8,-4,0,2,1,-1,1,1,1,1
KR_6741274807,420,2,48,-12,5,2,2,0,-3,0,3,-3,2,5,5,8,3,4,5,1,-1,5,-13,0,6,6,-3,0,2,-1,1,1,1,6,1
KR_6776132990,420,0,4,-14,0,2,2,0,3,4,1,-1,3,4,4,5,1,-8,1,9,1,5,7,4,8,12,-5,0,1,-1,1,-1,1,2,1
KR_6766835719,420,8,74,35,15,4,4,0,11,11,0,1,3,2,-1,2,3,0,0,0,0,9,3,1,4,5,1,0,2,1,1,1,1,3,1
KR_6744776241,420,1,49,9,6,1,2,1,2,2,0,-1,0,1,4,6,2,0,0,0,0,10,1,2,7,9,10,0,0,1,1,0,1,4,1
KR_6718822326,420,1,31,-12,6,-3,1,4,1,3,2,1,2,1,7,7,0,0,0,0,0,11,-61,-1,8,7,1,0,1,1,1,1,-1,4,1
KR_6773305056,420,2,87,-21,8,5,5,0,0,4,4,-2,1,3,3,3,0,2,4,2,0,6,3,4,5,9,0,0,1,1,1,1,1,3,1
KR_6777419123,420,4,60,0,4,3,4,1,-3,3,6,-1,3,4,4,5,1,1,3,2,0,6,-2,4,3,7,0,0,0,1,0,0,1,4,1
KR_6777707302,420,-2,-25,-16,1,1,1,0,0,1,1,0,3,3,-1,1,2,1,1,0,0,-1,-124,-3,8,5,-1,0,-1,-1,-1,-1,1,4,1
KR_6698254496,420,-1,-1,-8,0,3,4,1,1,2,1,-3,1,4,0,1,1,-1,0,1,0,2,3,2,4,6,0,0,1,-1,1,1,-1,1,1
KR_6760203508,420,3,64,1,5,6,7,1,-2,1,3,1,4,3,1,6,5,-1,0,1,0,2,-2,-2,8,6,-2,0,1,-1,-1,1,-1,4,1
KR_6764331541,420,0,21,25,3,-4,3,7,1,3,2,1,2,1,4,4,0,1,2,1,0,14,4,0,6,6,4,0,0,1,-1,1,-1,1,1
KR_6777764447,420,4,61,-11,9,4,4,0,3,5,2,1,3,2,1,3,2,0,2,2,0,10,3,-5,8,3,8,0,1,1,1,1,1,4,1
KR_6768991518,420,3,39,-23,12,1,2,1,5,8,3,-2,3,5,4,5,1,4,5,1,1,21,27,-2,7,5,0,0,2,1,1,1,1,5,1
KR_6720074578,420,7,63,34,16,-1,2,3,2,4,2,5,6,1,9,9,0,1,1,0,-1,6,46,1,5,6,-2,0,3,1,1,1,-1,2,1
KR_6752614392,420,0,8,2,0,0,1,1,1,3,2,-6,1,7,7,7,0,-2,1,3,1,7,-26,-2,10,8,4,0,1,1,-1,1,1,2,1
KR_6776210616,440,0,-45,11,0,1,3,2,1,2,1,-1,1,2,-1,0,1,0,0,0,0,-1,6,-1,5,4,-4,0,0,1,-1,0,-1,4,1
KR_6755070587,420,3,13,5,10,2,2,0,6,9,3,1,2,1,1,4,3,0,2,2,0,11,9,4,5,9,-2,0,2,1,-1,1,1,3,1
KR_6773228280,420,2,37,-10,7,-1,0,1,3,6,3,2,4,2,2,3,1,1,1,0,0,12,6,3,6,9,2,0,0,-1,-1,1,-1,5,1
KR_6740612669,420,0,-8,-10,-2,1,2,1,5,8,3,-6,0,6,-5,1,6,3,3,0,-1,7,5,-2,4,2,1,0,-2,-1,-1,-1,-1,2,1
KR_6777164670,420,4,27,2,3,1,3,2,3,5,2,-1,4,5,0,2,2,0,0,0,0,1,14,0,8,8,0,0,1,1,1,1,-1,5,1
KR_6764586182,420,1,-31,-16,5,4,6,2,0,1,1,2,3,1,0,3,3,-1,1,2,1,4,-5,-4,7,3,5,0,2,-1,1,1,1,2,1
KR_6775901311,420,4,26,31,10,-2,1,3,2,2,0,11,12,1,1,3,2,-2,0,2,0,15,9,6,5,11,3,0,2,1,-1,1,1,2,1
KR_6769662502,420,2,11,4,5,0,2,2,3,4,1,3,4,1,-2,1,3,1,1,0,0,16,-87,0,8,8,7,0,0,1,-1,-1,-1,1,1
KR_6764950082,420,-1,27,-16,2,-2,2,4,6,7,1,1,2,1,-1,3,4,-2,0,2,3,13,8,-2,8,6,-4,0,0,-1,1,0,1,5,1
KR_6760476945,420,3,60,23,3,0,2,2,2,5,3,-2,0,2,3,5,2,0,1,1,0,0,38,3,5,8,-6,0,-1,1,-1,-1,1,5,1
KR_6698390940,420,5,4,-4,7,3,5,2,4,6,2,0,0,0,0,4,4,0,0,0,0,11,4,3,2,5,-1,0,1,-1,1,1,1,2,1
KR_6772432646,420,2,67,28,3,-4,0,4,3,4,1,0,4,4,1,3,2,3,6,3,-4,-5,-28,0,6,6,7,0,0,1,-1,0,-1,5,1
KR_6777036142,420,1,60,-15,4,5,6,1,0,1,1,0,3,3,0,5,5,-1,1,2,0,-3,-9,-2,9,7,4,0,2,1,1,1,1,3,1
KR_6746701543,420,0,21,40,6,0,3,3,2,3,1,2,3,1,4,6,2,-2,1,3,0,4,-12,1,8,9,11,0,1,1,1,1,1,4,1
KR_6777084238,420,3,26,3,8,1,4,3,-1,0,1,8,9,1,0,3,3,0,1,1,0,9,-295,3,4,7,-2,0,1,1,1,1,-1,6,1
KR_6740396538,420,0,79,12,-4,4,4,0,-2,1,3,-3,0,3,0,2,2,-3,0,3,1,-6,-10,3,6,9,-1,0,1,-1,1,-1,1,5,1
KR_6751103784,420,2,12,-4,9,-4,1,5,4,5,1,6,7,1,2,4,2,1,2,1,0,12,0,4,4,8,-1,0,2,1,1,1,1,5,1
KR_6773970562,420,1,-15,12,2,1,5,4,0,3,3,-3,2,5,1,1,0,3,3,0,0,6,-5,0,4,4,2,0,0,-1,1,0,1,2,1
KR_6743172729,420,5,19,-16,16,4,7,3,1,2,1,1,2,1,8,9,1,2,3,1,1,19,-58,5,6,11,-2,0,2,1,1,1,1,1,1
KR_6769751831,420,2,15,11,-2,1,5,4,-5,1,6,-1,2,3,0,2,2,3,3,0,0,7,0,-2,9,7,1,0,0,-1,-1,0,-1,2,1
KR_6773400670,420,0,33,11,2,-4,0,4,6,7,1,-1,1,2,-2,2,4,3,4,1,0,8,1,5,4,9,-1,0,0,1,1,0,1,6,1
KR_6756671089,440,6,98,-1,7,2,3,1,5,6,1,1,4,3,1,2,1,-2,0,2,0,11,-18,1,2,3,-3,0,3,-1,1,1,-1,5,1
KR_6772967032,420,3,-4,-12,17,3,4,1,3,6,3,4,7,3,5,6,1,2,2,0,1,25,12,-2,11,9,1,0,2,1,1,1,1,5,1
KR_6729166696,420,1,-35,3,-3,1,3,2,1,4,3,-1,0,1,-1,0,1,-3,0,3,-2,-8,-11,0,6,6,2,0,1,-1,1,1,-1,2,1
KR_6741945729,420,3,6,16,6,4,5,1,1,4,3,3,3,0,-1,3,4,-1,0,1,0,5,-23,2,6,8,-1,0,1,1,1,1,1,2,1
KR_6681568525,420,-2,54,1,-4,-3,1,4,0,2,2,-3,1,4,1,3,2,1,1,0,0,-2,42,3,2,5,-28,0,0,1,1,1,-1,3,1
KR_6772949270,440,0,30,-25,-8,-1,1,2,-8,0,8,1,3,2,-1,1,2,1,2,1,0,-14,13,2,4,6,-1,0,0,1,-1,-1,-1,3,1
KR_6755183058,420,-1,27,-1,1,2,3,1,3,3,0,-4,1,5,0,1,1,0,0,0,0,-4,-9,1,6,7,0,0,1,1,1,1,-1,2,1
KR_6763295258,440,3,-9,27,0,1,1,0,-2,1,3,-1,3,4,3,4,1,-1,0,1,0,3,-1,-1,3,2,4,0,0,1,-1,0,-1,4,1
KR_6773326699,420,5,46,20,8,0,2,2,-1,2,3,0,2,2,4,4,0,5,5,0,0,10,-32,0,5,5,9,0,0,1,-1,-1,-1,5,1
KR_6757398722,420,0,5,3,0,-2,0,2,1,5,4,2,2,0,-1,0,1,0,0,0,0,-4,-1,-2,6,4,5,0,0,1,1,0,1,6,1
KR_6777726632,420,1,-14,6,6,1,5,4,-1,4,5,6,7,1,0,2,2,0,1,1,0,15,-203,6,2,8,-3,0,0,1,-1,0,-1,2,1
KR_6749689607,420,4,83,16,5,-1,2,3,4,6,2,-2,1,3,3,5,2,1,2,1,0,12,-61,-7,10,3,7,0,1,1,-1,1,-1,4,1
KR_6772235849,420,2,31,13,13,3,4,1,0,3,3,2,6,4,4,4,0,4,5,1,0,14,-8,-1,8,7,2,0,3,-1,1,1,1,2,1
KR_6777275822,420,-1,-67,0,-4,3,4,1,-1,2,3,-2,0,2,-3,1,4,-1,0,1,1,-3,-24,0,6,6,4,0,0,-1,-1,-1,1,6,1
KR_6708922044,420,5,39,7,7,2,3,1,4,5,1,1,3,2,0,2,2,0,0,0,0,14,4,0,7,7,-2,0,1,-1,1,1,1,2,1
KR_6769265928,420,1,83,12,15,10,10,0,4,4,0,2,3,1,-2,1,3,1,2,1,0,17,-1,2,4,6,4,0,0,1,1,0,1,6,1
KR_6766934262,420,4,-17,38,-1,-2,1,3,1,5,4,0,1,1,-3,3,6,3,4,1,0,6,-3,-1,5,4,0,0,-2,-1,1,-1,-1,4,1
KR_6777679542,420,1,-21,9,4,-1,1,2,3,6,3,-2,0,2,0,3,3,4,4,0,2,9,22,4,7,11,-2,0,-1,1,-1,-1,1,5,1
KR_6765268928,420,-1,45,9,-5,0,0,0,5,5,0,1,1,0,-10,0,10,-1,0,1,0,-7,-4,2,3,5,2,0,0,-1,1,1,1,6,1
KR_6771740498,420,-3,-25,-14,-4,-3,2,5,4,5,1,-1,1,2,-2,1,3,-2,0,2,0,4,-4,5,4,9,-1,0,-1,-1,-1,-1,-1,4,1
KR_6741299699,420,1,-37,-2,-1,4,5,1,-1,3,4,0,3,3,-3,1,4,-1,1,2,-1,-11,3,-5,8,3,-4,0,-1,1,-1,1,-1,3,1
KR_6764335692,420,0,-6,-7,5,-2,1,3,2,2,0,1,1,0,2,2,0,2,2,0,0,15,-1,4,5,9,2,0,-1,-1,1,1,1,5,1
KR_6737201549,420,0,43,11,2,0,3,3,2,5,3,0,4,4,0,1,1,0,0,0,0,2,0,6,2,8,1,0,0,1,1,1,1,6,1
KR_6757509732,420,6,86,11,10,5,6,1,7,8,1,0,2,2,-1,1,2,-1,0,1,0,2,4,1,6,7,2,0,1,-1,1,1,1,3,1
KR_6665467385,420,-3,-79,-23,2,-2,0,2,-1,3,4,0,3,3,5,7,2,0,2,2,0,3,-14,2,5,7,10,0,0,1,1,0,1,5,1
KR_6736523801,420,-1,31,-23,6,3,3,0,-1,3,4,5,8,3,-1,1,2,0,1,1,0,9,5,4,3,7,-4,0,0,1,-1,1,1,5,1
KR_6775839948,440,3,-28,29,3,1,1,0,-1,2,3,0,6,6,2,2,0,1,1,0,0,3,8,2,4,6,-4,0,0,1,1,0,-1,4,1
KR_6754774905,420,-4,-67,-7,-12,-1,1,2,-5,0,5,0,1,1,-6,1,7,0,2,2,0,-12,-48,2,6,8,24,0,-2,-1,-1,-1,-1,6,1
KR_6775930214,440,2,-28,20,7,0,0,0,5,6,1,2,3,1,-1,2,3,1,2,1,0,14,2,2,7,9,3,0,1,-1,1,1,-1,4,1
KR_6719659758,420,8,151,12,15,3,4,1,7,9,2,3,5,2,1,3,2,1,1,0,0,5,-3,4,3,7,7,0,3,1,1,1,1,4,1
KR_6746675909,420,0,7,-29,1,-4,1,5,-1,2,3,1,2,1,4,5,1,1,2,1,0,4,-2,-3,10,7,0,0,1,1,-1,1,1,1,1
KR_6706214629,420,1,-42,-7,0,4,4,0,-4,2,6,2,4,2,-2,1,3,0,1,1,-2,-12,-8,-3,8,5,1,0,-1,1,1,-1,-1,6,1
KR_6776063853,420,3,56,-3,1,1,2,1,0,6,6,3,5,2,-3,5,8,0,1,1,1,-5,0,0,4,4,-3,0,2,1,-1,1,1,5,1
KR_6775608501,420,0,7,-8,1,-1,2,3,1,2,1,4,4,0,-1,4,5,-2,0,2,0,4,-7,-2,8,6,0,0,-1,-1,1,-1,1,3,1
KR_6665964088,420,0,-55,5,8,2,2,0,0,5,5,5,7,2,1,2,1,0,0,0,1,5,0,-4,5,1,-1,0,1,1,-1,1,1,3,1
KR_6757079630,420,1,-10,-13,8,3,3,0,1,5,4,3,4,1,1,4,3,0,0,0,0,6,-5,1,5,6,0,0,1,1,1,1,1,5,1
KR_6724694109,420,4,65,6,3,3,3,0,3,3,0,1,4,3,-3,3,6,-1,2,3,0,0,18,6,6,12,-2,0,2,-1,1,1,1,3,1
KR_6774994136,420,0,17,15,5,-1,3,4,4,6,2,-3,0,3,4,5,1,1,1,0,2,10,9,-2,7,5,2,0,1,-1,-1,1,-1,3,1
KR_6702191698,420,1,8,9,3,0,2,2,-2,3,5,-2,1,3,4,8,4,3,3,0,0,10,-3,0,5,5,4,0,0,1,-1,1,-1,3,1
KR_6733853901,420,3,86,-11,2,0,1,1,0,5,5,0,1,1,0,4,4,2,3,1,0,1,-10,-5,12,7,6,0,0,1,-1,1,1,5,1
KR_6777060235,420,-4,-54,-3,-7,-4,0,4,-4,3,7,3,6,3,-1,2,3,-1,1,2,2,-14,-6,-1,11,10,1,0,-1,-1,1,-1,1,1,1
KR_6769318568,420,-1,-7,14,-2,1,5,4,-2,2,4,-3,1,4,2,3,1,0,0,0,0,-4,1,1,5,6,-4,0,0,1,1,-1,-1,1,1
KR_6775683514,420,0,58,-32,7,0,1,1,3,6,3,3,5,2,1,1,0,0,0,0,0,6,4,0,5,5,5,0,2,0,1,1,-1,0,1
KR_6769743939,420,-3,-52,17,-6,4,4,0,-3,1,4,-1,2,3,-5,2,7,-1,0,1,0,-5,-51,-5,8,3,14,0,-1,-1,1,-1,-1,4,1
KR_6740546159,420,2,-16,-3,1,-2,1,3,2,6,4,-2,2,4,1,5,4,2,2,0,1,1,30,-3,9,6,-6,0,0,1,-1,-1,1,6,1
KR_6709196303,420,-4,-39,7,-6,-4,1,5,-2,5,7,-1,0,1,2,3,1,-1,0,1,1,5,-17,-3,10,7,4,0,-1,1,1,1,1,2,1
KR_6777885670,420,5,34,12,9,5,6,1,3,3,0,3,4,1,-1,4,5,-1,1,2,-1,8,13,-4,7,3,1,0,1,1,1,1,-1,3,1
KR_6741889674,420,3,-7,21,3,-2,0,2,4,4,0,2,3,1,-1,5,6,0,2,2,-1,5,2,-3,11,8,-1,0,1,1,1,-1,1,4,1
KR_6766398464,420,5,23,8,8,4,6,2,2,3,1,4,6,2,1,4,3,-3,1,4,0,9,-10,-9,12,3,5,0,0,1,1,-1,1,3,1
KR_6775505875,420,2,-5,-6,2,-1,1,2,1,7,6,0,1,1,1,4,3,1,1,0,0,-2,45,1,7,8,-1,0,0,1,-1,-1,1,1,1
KR_6777340492,420,4,-13,16,10,1,1,0,2,2,0,2,3,1,5,6,1,0,0,0,0,9,-7,-1,4,3,3,0,1,-1,1,1,-1,4,1
KR_6777822715,420,4,74,-28,14,4,4,0,10,11,1,-1,0,1,0,1,1,1,2,1,0,17,7,7,3,10,-5,0,2,0,1,1,1,0,1
KR_6746683594,440,4,65,24,13,-1,2,3,1,3,2,2,2,0,5,9,4,6,7,1,1,5,-66,-2,5,3,16,0,2,1,-1,1,1,3,1
KR_6742198615,440,4,18,19,9,-2,0,2,5,6,1,2,3,1,-1,2,3,5,10,5,1,17,-2,-3,6,3,2,0,2,1,1,1,1,3,1
KR_6732045180,420,2,20,0,10,-1,0,1,7,9,2,2,4,2,4,4,0,-2,1,3,0,18,1,5,4,9,3,0,0,-1,-1,1,1,1,1
KR_6754640010,420,1,59,1,0,-1,0,1,2,3,1,-4,0,4,4,5,1,-1,0,1,0,2,-1,1,4,5,7,0,1,1,1,1,1,6,1
KR_6753352431,420,6,49,17,10,5,6,1,-1,0,1,2,6,4,4,6,2,0,0,0,0,11,-11,-1,8,7,4,0,2,1,1,1,1,5,1
KR_6728519391,420,-2,-52,-9,-2,2,2,0,1,3,2,-1,2,3,-4,1,5,0,0,0,0,-8,-1,5,5,10,-3,0,-1,-1,1,-1,1,1,1
KR_6699514999,420,-1,-5,-5,8,-1,1,2,3,6,3,-1,3,4,5,8,3,2,2,0,0,6,24,-1,10,9,-3,0,2,1,1,1,1,1,1
KR_6743610322,420,0,6,-17,1,4,5,1,-2,2,4,-1,1,2,-2,3,5,2,3,1,-1,-2,-8,-5,7,2,0,0,-2,-1,-1,-1,-1,2,1
KR_6775208944,420,4,40,4,11,-3,1,4,4,5,1,1,1,0,4,4,0,5,5,0,-1,12,-46,2,5,7,22,0,2,1,1,1,-1,4,1
KR_6731552099,440,3,35,21,11,5,6,1,-3,4,7,2,5,3,8,9,1,-1,1,2,2,21,-40,0,6,6,2,0,1,1,1,1,1,5,1
KR_6776567167,420,4,48,4,4,0,2,2,5,6,1,4,5,1,-5,3,8,0,1,1,0,2,-12,0,4,4,-1,0,3,-1,1,1,-1,1,1
KR_6772813336,420,0,26,-8,1,4,6,2,-2,0,2,0,2,2,0,0,0,-1,0,1,0,4,-7,0,4,4,3,0,1,-1,-1,1,1,3,1
KR_6710115249,420,-1,46,-32,4,1,3,2,1,2,1,2,3,1,-2,3,5,2,2,0,0,4,3,6,2,8,1,0,1,1,1,1,1,6,1
KR_6767838496,440,1,36,-25,1,-1,1,2,0,3,3,-3,3,6,5,5,0,0,1,1,0,1,-3,-3,5,2,0,0,1,-1,-1,1,1,1,1
KR_6764676243,420,2,53,-40,3,3,3,0,0,1,1,0,1,1,0,5,5,0,0,0,0,1,6,2,5,7,-8,0,0,-1,-1,0,-1,2,1
KR_6776312545,420,0,62,-19,2,-2,1,3,-2,0,2,3,6,3,2,3,1,1,1,0,0,3,38,-1,7,6,-19,0,0,-1,-1,1,1,4,1
KR_6722165212,420,2,37,4,5,1,3,2,1,4,3,-3,0,3,7,7,0,-1,1,2,0,1,27,11,6,17,-11,0,0,1,1,1,1,3,1
KR_6776621828,420,4,60,33,10,0,1,1,4,5,1,2,2,0,1,1,0,3,3,0,0,17,-70,4,3,7,-1,0,2,1,-1,1,1,6,1
KR_6736134442,420,4,11,57,9,7,9,2,-3,0,3,6,8,2,-2,0,2,1,2,1,0,13,1,2,9,11,11,0,2,1,1,1,-1,6,1
KR_6777148031,420,3,113,25,7,1,3,2,3,6,3,-2,2,4,2,3,1,3,6,3,0,16,-9,-3,7,4,1,0,2,1,1,1,1,5,1
KR_6743008708,420,3,57,-10,8,5,7,2,4,7,3,-4,3,7,3,6,3,0,0,0,0,9,13,7,7,14,1,0,2,1,-1,1,1,4,1
KR_6744830508,420,3,81,2,0,2,4,2,-2,5,7,1,3,2,-1,1,2,0,2,2,0,1,26,-3,7,4,4,0,3,-1,1,1,1,1,1
KR_6776062836,420,4,84,8,7,2,3,1,1,3,2,-1,1,2,4,4,0,1,2,1,0,7,22,2,5,7,7,0,3,1,1,1,1,5,1
KR_6697265697,420,0,-40,11,-3,-1,0,1,-2,3,5,1,2,1,0,5,5,-1,0,1,-1,-2,14,-3,7,4,8,0,1,-1,1,1,-1,4,1
KR_6774362077,420,3,16,36,3,4,4,0,2,3,1,-5,1,6,3,4,1,-1,0,1,0,4,-30,4,4,8,1,0,0,-1,1,0,-1,4,1
KR_6774729594,440,4,104,31,14,1,2,1,1,4,3,1,3,2,9,10,1,2,3,1,0,18,-5,0,6,6,2,0,1,1,1,1,1,4,1
KR_6753368119,420,1,11,-8,4,3,3,0,-3,0,3,-1,0,1,4,5,1,1,1,0,1,-2,-3,4,2,6,-6,0,0,1,1,1,1,1,1
KR_6776571699,420,3,-24,27,10,-1,1,2,4,5,1,4,4,0,0,2,2,3,4,1,1,10,10,2,6,8,0,0,2,1,1,1,1,1,1
KR_6772727310,420,1,-17,-1,9,5,6,1,1,1,0,0,1,1,3,4,1,0,0,0,0,12,-64,4,6,10,-1,0,0,1,-1,0,1,3,1
KR_6768132000,420,2,48,-13,3,-3,0,3,-4,0,4,5,5,0,3,6,3,2,2,0,1,8,27,-1,4,3,2,0,0,1,1,1,1,2,1
KR_6773562854,420,0,21,-9,6,1,2,1,2,2,0,3,4,1,0,2,2,0,0,0,0,7,0,3,4,7,7,0,0,-1,1,0,1,5,1
KR_6775778633,420,0,15,7,0,1,1,0,-4,3,7,-1,3,4,1,4,3,3,4,1,-1,-8,-2,-1,8,7,-4,0,0,1,-1,1,-1,4,1
KR_6775876628,420,-2,46,-25,1,-4,0,4,2,4,2,3,4,1,1,2,1,-1,0,1,0,3,10,3,4,7,6,0,-1,1,-1,-1,1,3,1
KR_6771701628,420,1,2,14,1,2,3,1,-3,3,6,-1,0,1,3,4,1,0,1,1,0,-4,5,-1,11,10,-2,0,0,1,1,0,1,4,1
KR_6745012687,420,-3,-85,0,-4,1,2,1,-1,3,4,-2,1,3,-1,1,2,-1,2,3,0,0,113,9,5,14,-3,0,-1,-1,1,-1,-1,2,1
KR_6741775836,420,4,30,25,2,-4,0,4,4,4,0,-4,2,6,7,8,1,-1,0,1,0,1,0,-5,12,7,11,0,1,1,-1,1,1,4,1
KR_6776331010,420,1,22,56,-5,0,1,1,-2,2,4,2,3,1,-4,2,6,-1,0,1,0,-11,-25,-4,8,4,2,0,1,1,1,1,-1,6,1
KR_6777707277,420,8,91,0,22,-1,1,2,8,11,3,3,3,0,10,10,0,2,3,1,0,25,11,4,5,9,2,1,4,0,-1,1,1,0,1
KR_6776810757,420,1,55,0,0,3,3,0,1,9,8,-2,0,2,-1,1,2,-1,0,1,-1,-11,-43,-4,11,7,12,0,-1,-1,1,-1,-1,5,1
KR_6742235405,420,3,42,13,10,-2,1,3,1,6,5,3,3,0,3,6,3,5,6,1,1,7,-7,1,9,10,3,0,1,1,1,1,1,2,1
KR_6774625319,420,1,-42,-2,8,4,4,0,0,3,3,0,3,3,4,5,1,0,0,0,0,8,-55,-4,7,3,11,0,1,-1,1,1,1,3,1
KR_6776167482,420,-2,-4,-75,3,6,6,0,-3,2,5,1,3,2,0,1,1,-1,2,3,0,5,3,5,3,8,-2,0,1,-1,-1,1,1,3,1
KR_6708142353,420,5,57,41,13,3,4,1,1,3,2,8,8,0,0,1,1,1,1,0,0,15,29,4,7,11,3,0,3,1,1,1,1,2,1
KR_6726389864,420,1,52,-5,3,1,2,1,2,4,2,-4,5,9,2,5,3,2,3,1,0,0,6,-3,5,2,-4,0,2,1,1,1,1,1,1
KR_6771949093,420,0,11,-19,11,-1,1,2,7,7,0,3,4,1,0,0,0,2,3,1,0,9,-5,3,3,6,4,0,0,1,-1,0,1,2,1
KR_6739013892,420,6,77,-2,16,7,7,0,-1,1,2,3,4,1,8,9,1,-1,1,2,1,18,-17,-1,5,4,3,0,3,1,-1,1,1,4,1
KR_6740631668,420,3,15,-7,12,-3,1,4,-1,1,2,5,5,0,4,4,0,7,7,0,1,14,32,3,3,6,2,0,0,1,1,1,1,2,1
KR_6714242148,420,2,58,8,10,9,9,0,0,3,3,0,2,2,2,2,0,-1,1,2,0,8,-10,-1,5,4,5,0,1,1,1,1,-1,1,1
KR_6777495081,420,1,36,-2,-5,3,3,0,-2,1,3,-2,1,3,-2,0,2,-2,1,3,0,-6,6,4,6,10,1,0,2,0,1,1,1,0,1
KR_6749739846,420,1,3,40,1,-3,0,3,1,4,3,2,2,0,1,2,1,0,0,0,0,6,1,0,6,6,-6,0,0,1,1,0,1,6,1
KR_6763774908,420,1,99,16,1,0,3,3,-5,1,6,0,2,2,5,5,0,1,1,0,0,-5,8,-3,9,6,-4,0,0,-1,1,1,1,1,1
KR_6775251875,420,1,41,-5,3,4,5,1,-2,1,3,5,9,4,-1,6,7,-3,1,4,0,4,-9,0,5,5,-1,0,2,1,1,1,1,3,1
KR_6753386712,420,4,22,-4,18,-1,0,1,7,7,0,3,4,1,10,10,0,-1,0,1,0,25,10,2,5,7,3,0,1,1,1,1,1,5,1
KR_6763740354,420,7,29,-13,16,0,1,1,7,8,1,4,5,1,5,7,2,0,0,0,0,25,-24,-2,6,4,3,0,1,1,1,1,1,6,1
KR_6754626727,420,4,17,8,9,1,2,1,6,7,1,0,2,2,0,2,2,2,2,0,0,17,14,2,4,6,2,0,1,1,1,1,1,6,1
KR_6746437141,420,3,-38,-36,4,3,3,0,0,2,2,-3,1,4,1,1,0,3,4,1,0,9,-21,-1,4,3,4,0,1,-1,-1,1,-1,5,1
KR_6749590146,420,-2,-5,-11,7,0,3,3,-1,2,3,2,4,2,4,8,4,2,4,2,0,-1,-9,-2,14,12,6,0,0,1,1,1,1,5,1
KR_6756921109,440,0,61,3,2,-1,2,3,-1,2,3,3,4,1,1,4,3,0,1,1,-1,3,-40,-1,3,2,1,0,0,1,0,1,-1,5,1
KR_6757027211,440,6,61,18,19,3,4,1,1,4,3,3,6,3,11,14,3,1,1,0,0,12,125,1,2,3,0,0,4,1,1,1,1,3,1
KR_6720996178,420,0,42,1,-2,-2,1,3,0,1,1,0,3,3,0,2,2,0,0,0,0,3,1,0,7,7,4,0,-1,1,-1,-1,-1,4,1
KR_6742310867,420,1,24,31,4,-4,1,5,4,5,1,0,2,2,1,4,3,3,4,1,0,4,-10,-4,7,3,6,0,1,-1,1,1,-1,2,1
KR_6776281704,440,3,34,-5,5,1,2,1,4,4,0,-2,0,2,0,0,0,2,2,0,0,6,52,2,5,7,-1,0,0,1,-1,0,1,2,1
KR_6744329600,420,2,22,15,-1,-2,0,2,3,6,3,2,3,1,-1,3,4,-3,2,5,-1,-1,15,0,4,4,-5,0,0,1,-1,1,-1,5,1
KR_6742883023,420,3,-21,24,6,0,3,3,1,3,2,1,5,4,2,5,3,2,3,1,1,18,26,-6,10,4,4,0,-1,1,-1,-1,1,2,1
KR_6759871214,440,0,-4,3,4,1,2,1,-3,0,3,-2,0,2,3,4,1,5,7,2,0,6,8,2,7,9,-2,0,0,1,-1,1,-1,2,1
KR_6768787001,420,-3,-86,-2,-4,-3,1,4,1,2,1,-1,1,2,-2,2,4,1,2,1,0,-1,67,1,3,4,-4,0,-1,1,-1,-1,1,1,1
KR_6713822153,420,2,29,12,-1,-2,0,2,-2,5,7,2,4,2,2,3,1,-1,2,3,-1,-9,2,2,5,7,1,0,1,1,1,1,-1,3,1
KR_6712272048,420,-2,14,-16,4,2,2,0,1,1,0,1,1,0,2,2,0,-2,0,2,0,5,5,-2,8,6,-2,0,1,1,1,1,1,5,1
KR_6764214247,420,-1,84,-8,-6,1,2,1,-6,2,8,-4,2,6,-2,1,3,5,5,0,0,-12,-4,-3,11,8,6,0,1,1,-1,1,1,1,1
KR_6770124641,440,0,53,24,-3,-1,0,1,0,5,5,3,3,0,-7,0,7,2,5,3,0,-5,-3,-1,6,5,-2,0,1,1,0,1,1,1,1
KR_6729004954,420,3,62,6,15,1,3,2,0,0,0,-2,3,5,12,18,6,4,4,0,1,-4,-3,1,4,5,0,0,2,1,1,1,1,3,1
KR_6766827160,420,2,-12,8,0,1,3,2,2,3,1,-4,2,6,1,2,1,0,1,1,0,7,-142,2,4,6,5,0,1,-1,0,1,-1,4,1
KR_6775840937,420,0,43,16,5,-2,1,3,1,5,4,2,3,1,1,6,5,3,5,2,-1,0,-12,0,6,6,-3,0,1,-1,1,-1,-1,5,1
KR_6777016577,420,1,37,9,4,1,2,1,2,4,2,0,3,3,1,2,1,0,1,1,0,-2,-5,0,5,5,-5,0,0,-1,1,1,1,6,1
KR_6777589243,420,1,53,12,4,1,2,1,-1,1,2,2,5,3,0,1,1,2,2,0,0,0,-4,-3,7,4,7,0,0,-1,-1,0,1,4,1
KR_6776051069,420,2,29,-20,7,1,1,0,1,3,2,5,5,0,1,4,3,-1,0,1,0,9,42,1,4,5,-17,0,2,-1,1,1,1,6,1
KR_6764755404,420,2,-3,30,11,2,5,3,0,3,3,8,10,2,1,4,3,0,1,1,0,10,4,9,6,15,-6,0,2,-1,1,1,1,1,1
KR_6776341314,420,0,19,-1,0,0,2,2,3,5,2,2,4,2,-5,1,6,0,2,2,-1,7,25,1,5,6,8,0,0,1,-1,0,-1,3,1
KR_6766110202,420,1,-11,3,-2,1,2,1,-4,1,5,1,2,1,2,2,0,-2,0,2,0,-5,4,7,5,12,1,0,0,1,1,0,-1,1,1
KR_6701166444,420,-1,33,-16,-4,-5,0,5,-1,5,6,-2,2,4,-1,0,1,5,5,0,0,-8,-14,0,3,3,-6,0,4,1,-1,-1,1,5,1
KR_6697217514,420,1,26,6,4,3,4,1,-2,3,5,-1,0,1,4,6,2,0,0,0,0,0,-11,-4,9,5,7,0,2,-1,1,1,1,1,1
KR_6768101740,420,4,55,27,11,3,3,0,4,4,0,0,0,0,-3,0,3,7,7,0,0,9,38,0,7,7,-3,0,2,1,-1,1,1,5,1
KR_6746510121,420,2,16,11,-6,1,1,0,-2,1,3,-1,4,5,-1,1,2,-3,0,3,-1,-13,1,3,2,5,-6,0,0,-1,1,1,-1,5,1
KR_6764267679,420,2,29,17,2,5,5,0,3,6,3,0,1,1,-5,1,6,-1,2,3,1,0,42,0,8,8,-21,0,1,1,-1,-1,1,3,1
KR_6770383644,420,6,89,12,14,5,5,0,5,7,2,2,3,1,3,3,0,-1,1,2,0,7,49,-3,6,3,0,0,2,-1,1,1,1,1,1
KR_6772019754,440,-3,-6,-35,-4,2,7,5,-4,1,5,0,1,1,-2,2,4,0,1,1,0,-1,-30,2,4,6,2,0,0,-1,-1,-1,-1,3,1
KR_6769160279,420,4,11,17,13,0,1,1,4,4,0,5,7,2,0,3,3,4,4,0,0,17,-8,-1,6,5,1,0,0,1,-1,0,-1,4,1
KR_6774608691,420,1,-14,5,8,-2,2,4,5,6,1,1,4,3,4,5,1,0,1,1,1,13,4,7,4,11,0,0,-1,0,-1,-1,1,0,1
KR_6776922607,420,3,89,-5,6,2,2,0,-1,1,2,1,2,1,3,3,0,1,1,0,0,8,110,-2,8,6,5,0,3,1,-1,1,-1,3,1
KR_6764868971,420,3,10,2,14,7,8,1,1,6,5,1,2,1,4,5,1,1,1,0,-1,23,-12,-3,8,5,2,0,1,1,1,1,-1,5,1
KR_6777002611,420,1,13,-9,4,8,9,1,-4,1,5,-2,1,3,2,3,1,0,0,0,0,9,-5,1,4,5,-2,0,0,-1,1,1,1,1,1
KR_6774778174,420,1,7,-21,14,1,2,1,2,4,2,1,4,3,4,7,3,6,6,0,1,16,-4,2,4,6,0,0,0,1,1,0,1,1,1
KR_6747284972,420,3,24,20,7,1,1,0,7,9,2,1,4,3,-2,0,2,0,0,0,0,4,27,3,5,8,-9,0,0,-1,1,1,1,3,1
KR_6765972352,420,2,-11,14,3,-3,1,4,2,3,1,3,3,0,1,2,1,0,0,0,0,5,2,-1,5,4,-2,0,2,1,1,1,-1,1,1
KR_6756034675,440,-1,27,23,-4,-1,1,2,-1,4,5,-1,4,5,-3,2,5,2,3,1,0,-1,-4,-8,9,1,7,0,1,-1,-1,1,-1,3,1
KR_6776463832,420,4,43,-8,8,-3,1,4,8,8,0,-3,1,4,7,9,2,-1,0,1,0,8,11,-2,9,7,-5,0,0,-1,-1,0,-1,5,1
KR_6775597024,420,4,25,18,9,1,1,0,3,4,1,1,1,0,4,5,1,0,0,0,2,17,40,1,6,7,3,0,3,1,1,1,1,4,1
KR_6776534725,420,0,15,-12,6,4,7,3,1,4,3,6,6,0,-4,0,4,-1,0,1,1,7,20,0,6,6,-2,0,0,-1,1,1,1,1,1
KR_6771690841,420,-2,-37,19,-1,1,2,1,-1,3,4,2,3,1,-3,0,3,0,0,0,0,-3,5,-3,7,4,-3,0,0,-1,1,0,1,2,1
KR_6735225365,420,0,1,16,-4,-6,1,7,0,4,4,-2,0,2,1,3,2,3,3,0,0,-6,5,-2,6,4,-1,0,-1,1,-1,-1,-1,1,1
KR_6769558131,420,2,39,1,3,0,1,1,2,5,3,0,2,2,2,5,3,-1,0,1,0,-1,-2,-1,7,6,1,0,2,0,-1,1,1,0,1
KR_6733462724,440,-5,-27,-4,-14,1,3,2,-7,3,10,-1,3,4,-5,0,5,-2,1,3,0,-18,12,0,6,6,-4,0,-1,1,-1,-1,1,4,1
KR_6763153105,420,3,21,20,-1,0,1,1,-1,2,3,3,3,0,-2,1,3,-1,1,2,0,-4,8,-5,9,4,-3,0,0,1,1,1,-1,5,1
KR_6766674784,420,-1,1,-17,-1,-2,0,2,1,2,1,0,2,2,0,0,0,0,0,0,0,-4,-98,-2,5,3,-1,0,2,0,1,1,-1,0,1
KR_6763108459,420,2,-32,2,8,2,2,0,2,3,1,2,4,2,0,2,2,2,3,1,0,16,-4,-3,9,6,6,0,0,-1,1,0,1,4,1
KR_6763018720,420,-2,-22,15,-9,-2,1,3,-4,2,6,-3,2,5,3,4,1,-3,0,3,0,-7,119,-5,10,5,2,0,-2,-1,-1,-1,1,4,1
KR_6777612803,420,-1,-12,-8,-3,-6,1,7,0,3,3,1,2,1,1,7,6,1,2,1,0,-1,-7,-2,7,5,4,0,-1,-1,-1,-1,-1,2,1
KR_6697577700,420,1,52,11,-1,-1,1,2,0,3,3,1,4,3,1,4,3,-2,0,2,0,-8,1,-1,6,5,-3,0,0,1,1,1,-1,1,1
KR_6753940471,420,1,7,9,9,1,3,2,1,1,0,1,4,3,7,9,2,-1,1,2,4,23,33,1,6,7,4,0,0,-1,-1,1,1,5,1
KR_6666055580,420,3,8,-4,5,-1,1,2,1,3,2,4,5,1,2,4,2,-1,0,1,0,14,1,3,8,11,-3,0,0,1,-1,-1,1,1,1
KR_6772294517,440,-5,-58,-32,-5,-3,2,5,-1,1,2,1,4,3,1,3,2,-3,0,3,-1,0,-4,2,5,7,0,0,-2,-1,-1,-1,-1,6,1
KR_6754917747,420,4,52,0,4,2,5,3,7,8,1,-2,3,5,-1,4,5,-2,0,2,0,3,28,0,6,6,-2,0,1,-1,-1,1,1,1,1
KR_6743721941,420,2,18,11,6,-1,0,1,0,6,6,0,1,1,3,4,1,4,4,0,0,4,-40,1,7,8,3,0,-1,-1,-1,-1,1,3,1
KR_6775068574,420,1,16,17,3,3,3,0,-3,0,3,0,0,0,3,4,1,0,0,0,1,-1,4,1,8,9,8,0,3,-1,1,1,1,6,1
KR_6777881840,420,0,15,-4,-1,1,2,1,1,1,0,-3,2,5,2,6,4,-2,1,3,-1,-2,-11,-3,10,7,1,0,2,-1,-1,1,-1,6,1
KR_6776719542,420,2,40,28,3,0,1,1,-2,1,3,1,5,4,3,3,0,1,2,1,0,5,36,5,2,7,0,0,0,-1,1,0,-1,2,1
KR_6774573263,420,1,13,33,5,-2,3,5,4,5,1,4,5,1,2,3,1,-3,0,3,-1,1,-27,1,6,7,2,0,1,1,1,1,-1,1,1
KR_6753264824,420,0,7,-11,0,5,5,0,-1,4,5,-9,0,9,-2,1,3,7,7,0,1,-10,5,-1,6,5,4,0,0,-1,-1,-1,1,5,1
KR_6775887712,420,4,18,36,7,5,6,1,1,3,2,1,2,1,-1,0,1,1,4,3,3,-4,294,0,3,3,1,0,1,-1,1,1,1,6,1
KR_6738601818,420,4,42,-12,14,2,2,0,5,10,5,0,1,1,6,9,3,1,3,2,0,13,7,-2,7,5,-2,0,3,1,-1,1,1,3,1
KR_6776589096,420,7,49,1,18,10,11,1,0,2,2,2,6,4,6,7,1,0,0,0,0,20,-21,-4,7,3,-6,0,3,1,1,1,-1,4,1
KR_6766829926,420,1,3,38,-11,-3,0,3,-4,0,4,-1,1,2,-3,2,5,0,2,2,0,-14,10,-3,8,5,-3,0,0,-1,-1,0,-1,2,1
KR_6726011658,440,0,48,32,0,2,3,1,0,1,1,-2,1,3,-1,5,6,1,2,1,0,-7,-99,1,6,7,-3,0,1,-1,1,1,-1,4,1
KR_6750626961,440,6,55,0,16,3,3,0,8,8,0,-1,0,1,0,0,0,6,7,1,0,17,56,5,1,6,-21,0,2,1,0,1,1,5,1
KR_6744641433,420,1,42,-21,4,4,5,1,0,2,2,-1,1,2,0,1,1,1,1,0,0,0,-11,1,4,5,-3,0,0,-1,-1,0,1,2,1
KR_6766660027,420,5,61,-8,14,4,5,1,-4,2,6,1,6,5,9,12,3,4,4,0,1,18,2,2,8,10,1,0,1,1,1,1,1,5,1
KR_6773249522,440,-1,-2,30,-6,2,3,1,4,5,1,-6,0,6,-4,0,4,-2,0,2,0,-5,1,-2,5,3,1,0,0,-1,1,0,-1,5,1
KR_6761340708,420,3,48,-3,-5,-1,2,3,0,0,0,-7,1,8,3,4,1,0,0,0,-1,-5,-3,-3,10,7,4,0,0,1,-1,0,-1,3,1
KR_6763158493,420,3,67,39,11,2,4,2,2,5,3,-2,3,5,11,12,1,-2,0,2,-1,10,0,1,5,6,2,0,2,-1,1,1,1,2,1
KR_6769124061,420,4,86,11,7,0,0,0,3,6,3,2,3,1,3,3,0,-1,0,1,0,11,13,7,1,8,1,0,1,1,1,1,1,3,1
KR_6723589116,420,2,38,24,6,-2,1,3,5,6,1,-1,3,4,4,4,0,0,0,0,0,-6,3,-1,7,6,7,0,1,1,1,1,1,6,1
KR_6776217121,440,2,9,17,8,2,3,1,2,3,1,3,3,0,2,2,0,-1,0,1,0,5,-44,5,5,10,30,0,1,-1,1,1,1,5,1
KR_6718829103,440,1,9,0,6,2,4,2,5,7,2,-1,1,2,-1,4,5,1,2,1,1,12,5,1,5,6,-3,0,1,1,1,1,1,5,1
KR_6774031078,420,2,39,9,5,6,7,1,-3,0,3,1,3,2,0,1,1,1,2,1,1,-10,-1,-1,5,4,0,0,0,-1,1,1,1,5,1
KR_6750807364,420,2,2,21,0,-5,0,5,0,4,4,2,3,1,3,4,1,0,0,0,0,2,-13,4,6,10,0,0,0,1,-1,-1,-1,5,1
KR_6756770050,440,9,81,16,25,2,2,0,4,5,1,6,6,0,6,6,0,7,7,0,1,42,54,1,4,5,2,0,3,1,1,1,1,4,1
KR_6754219884,420,5,70,-43,10,2,2,0,3,4,1,2,3,1,2,5,3,1,2,1,-1,9,323,1,3,4,4,0,4,1,1,1,-1,3,1
KR_6775596545,420,-2,-57,30,-1,-1,2,3,2,4,2,0,3,3,-2,3,5,0,0,0,0,-1,48,3,4,7,-3,0,-1,1,1,1,1,3,1
KR_6777329294,420,1,-35,23,-2,0,1,1,-2,1,3,-1,1,2,3,4,1,-2,0,2,-1,-5,-3,-1,10,9,2,0,0,1,1,1,-1,5,1
KR_6754283826,420,7,74,12,11,3,4,1,1,3,2,3,6,3,5,6,1,-1,1,2,0,10,-5,4,2,6,4,0,2,1,1,1,1,6,1
KR_6777219408,420,0,42,1,2,-2,0,2,2,3,1,2,3,1,-1,0,1,1,1,0,0,14,-14,-2,6,4,-1,0,-1,-1,1,1,1,4,1
KR_6776836058,420,5,34,6,11,-3,1,4,4,4,0,5,5,0,4,6,2,1,1,0,0,17,-3,-3,5,2,1,0,2,1,1,1,-1,5,1
KR_6678512304,420,1,2,31,1,4,4,0,4,4,0,-3,0,3,-4,0,4,0,1,1,0,-9,-5,-8,10,2,3,0,1,1,1,1,-1,1,1
KR_6766134257,420,3,41,15,5,3,6,3,5,6,1,4,6,2,-5,1,6,-2,1,3,0,3,-11,2,4,6,6,0,0,0,1,1,-1,0,1
KR_6764992063,420,2,57,-11,8,2,2,0,4,5,1,0,3,3,2,3,1,0,1,1,0,11,4,1,7,8,-1,0,1,-1,1,1,1,3,1
KR_6771183317,420,-2,-3,-13,0,2,3,1,0,3,3,-5,2,7,-1,3,4,4,4,0,0,-1,0,-2,6,4,1,0,-2,1,-1,-1,-1,3,1
KR_6776853559,420,0,20,-11,6,0,1,1,2,3,1,4,4,0,-1,2,3,1,1,0,0,3,-3,1,5,6,0,0,0,1,-1,0,1,2,1
KR_6773926727,440,5,97,0,13,1,3,2,5,5,0,3,5,2,4,6,2,0,0,0,0,8,2,1,5,6,4,0,1,1,-1,-1,1,2,1
KR_6777248175,420,1,-25,20,11,-2,0,2,5,5,0,3,3,0,2,4,2,3,4,1,0,22,19,3,5,8,0,0,0,1,-1,1,-1,2,1
KR_6752184243,420,0,-17,15,1,1,2,1,-2,3,5,-2,1,3,4,6,2,0,0,0,0,3,-2,5,7,12,-5,0,-1,1,-1,-1,-1,5,1
KR_6726907582,420,2,83,-35,2,0,5,5,-3,2,5,4,5,1,2,3,1,-1,1,2,0,4,16,-3,8,5,5,0,0,-1,-1,0,-1,5,1
KR_6762005656,420,-1,-33,9,-5,0,2,2,-7,2,9,-3,0,3,3,4,1,2,2,0,0,-3,2,5,2,7,-3,0,0,1,-1,-1,1,6,1
KR_6760396123,440,-1,-37,2,-5,0,5,5,-6,1,7,1,1,0,-1,1,2,1,1,0,1,-14,-2,-3,5,2,2,0,1,-1,-1,-1,1,5,1
KR_6769902465,420,-1,-13,-8,3,3,3,0,-1,3,4,3,5,2,-2,1,3,0,0,0,0,-2,-4,0,4,4,0,0,0,-1,1,0,1,1,1
KR_6776526413,420,4,17,-7,15,3,3,0,9,10,1,5,7,2,-1,4,5,-1,0,1,0,18,8,4,4,8,1,0,3,1,1,1,1,1,1
KR_6774647844,420,0,45,-12,5,-3,2,5,0,1,1,2,3,1,7,7,0,-1,0,1,0,8,26,0,4,4,-3,0,2,-1,1,1,1,4,1
KR_6767213281,420,2,78,16,6,0,1,1,0,1,1,4,5,1,2,3,1,0,0,0,0,10,35,-2,9,7,5,0,0,1,-1,0,1,1,1
KR_6740938907,420,1,-39,14,3,-1,2,3,1,2,1,6,6,0,-3,0,3,0,0,0,0,-1,12,-4,7,3,9,0,1,1,-1,1,1,1,1
KR_6754231933,420,-2,27,-3,-9,-1,1,2,-2,0,2,-3,1,4,-2,1,3,-1,2,3,0,-8,8,7,5,12,-2,0,1,-1,1,1,1,6,1
KR_6777477778,420,-1,-46,-13,-8,-5,1,6,-1,5,6,-3,1,4,4,8,4,-3,1,4,-1,-2,-240,3,7,10,-1,0,-2,-1,-1,-1,-1,6,1
KR_6776599077,420,2,27,-9,0,0,1,1,1,2,1,1,1,0,-2,0,2,0,0,0,0,2,34,4,8,12,1,0,1,1,1,1,-1,1,1
KR_6775282139,420,0,-34,-28,3,2,4,2,4,6,2,-1,1,2,0,4,4,-2,3,5,0,6,-2,-1,3,2,2,0,0,1,1,0,-1,6,1
KR_6737052453,420,5,13,53,8,-3,0,3,5,7,2,0,0,0,2,4,2,4,4,0,0,17,-6,-5,9,4,6,0,1,1,1,1,1,3,1
KR_6732594261,420,0,-15,4,7,-1,3,4,1,4,3,3,4,1,3,6,3,1,1,0,0,10,-23,-2,10,8,9,0,2,1,1,1,-1,3,1
KR_6744184986,420,4,94,15,7,3,4,1,7,8,1,-3,0,3,-2,2,4,2,2,0,0,4,-4,3,5,8,0,0,1,1,1,1,1,1,1
KR_6764716731,420,1,10,-11,6,2,3,1,2,2,0,1,1,0,0,0,0,1,1,0,0,8,36,1,4,5,0,0,0,1,1,1,1,4,1
KR_6776608078,420,4,97,-4,8,4,5,1,8,9,1,0,1,1,-4,1,5,0,1,1,0,4,201,2,3,5,2,0,1,1,1,1,-1,4,1
KR_6766772927,420,-2,67,-16,5,-2,1,3,5,6,1,-1,2,3,3,3,0,0,0,0,0,5,3,5,3,8,2,0,0,1,1,1,1,6,1
KR_6776920922,420,1,39,-4,-1,0,0,0,-2,3,5,2,4,2,-2,1,3,1,1,0,0,0,0,3,4,7,0,0,1,-1,1,-1,-1,4,1
KR_6722788423,420,4,7,36,11,2,4,2,5,6,1,0,2,2,4,7,3,0,1,1,-2,6,7,-3,10,7,1,0,1,1,-1,1,-1,3,1
KR_6752985291,420,2,24,-15,3,-1,1,2,5,6,1,-1,2,3,-1,4,5,1,1,0,1,4,11,2,4,6,-2,0,1,-1,1,1,1,2,1
KR_6771998436,420,3,-25,31,7,-1,2,3,6,6,0,3,5,2,-2,0,2,1,2,1,0,9,5,0,4,4,1,0,0,-1,1,0,1,5,1
KR_6776997953,420,0,-6,7,3,-2,1,3,-2,1,3,8,8,0,1,2,1,-2,0,2,-1,6,5,-1,7,6,1,0,0,1,1,1,-1,5,1
KR_6719900509,440,-1,-21,-25,4,1,3,2,3,6,3,3,4,1,-3,0,3,0,1,1,0,-2,-11,-2,4,2,-3,0,0,-1,0,0,-1,4,1
KR_6776346223,420,3,40,2,6,3,6,3,4,4,0,0,3,3,0,3,3,-1,1,2,1,5,8,-3,7,4,3,0,4,1,1,1,1,6,1
KR_6756140332,440,2,23,20,-1,-2,3,5,0,3,3,-1,3,4,1,3,2,1,1,0,0,1,-75,-2,4,2,10,0,-1,1,-1,-1,-1,3,1
KR_6709747640,420,1,-2,24,5,2,3,1,4,5,1,-1,0,1,-1,1,2,1,1,0,0,1,4,-2,7,5,-3,0,0,1,-1,0,1,4,1
KR_6772596662,420,-1,16,15,-9,0,3,3,-3,3,6,0,3,3,-5,3,8,-1,0,1,0,-20,-3,-4,8,4,-1,0,0,-1,1,0,-1,5,1
KR_6774910248,420,-1,21,-5,-2,-1,0,1,-5,2,7,-1,1,2,2,4,2,3,4,1,0,1,-6,4,1,5,0,0,0,-1,-1,-1,-1,1,1
KR_6767091024,420,2,48,30,7,1,1,0,-1,2,3,6,9,3,1,2,1,0,1,1,0,14,6,-5,10,5,3,0,0,1,-1,0,1,3,1
KR_6753855137,420,2,46,-14,11,-1,0,1,5,8,3,2,5,3,3,4,1,2,2,0,0,14,11,3,4,7,-9,0,2,-1,1,1,-1,5,1
KR_6705633822,420,5,63,14,9,3,5,2,4,5,1,0,2,2,3,5,2,-1,1,2,0,11,-4,1,7,8,7,0,2,1,1,1,1,4,1
KR_6766060515,420,0,8,32,0,-2,0,2,0,1,1,-2,0,2,4,5,1,0,0,0,0,1,-13,-2,11,9,1,0,0,1,1,1,-1,4,1
KR_6776278118,420,3,4,6,9,1,1,0,0,1,1,5,7,2,3,7,4,0,1,1,0,16,-6,-8,9,1,3,0,1,1,1,-1,-1,6,1
KR_6753500405,420,0,-9,7,4,3,3,0,0,4,4,3,5,2,-4,2,6,2,3,1,0,6,-62,0,5,5,28,0,-1,1,-1,-1,-1,4,1
KR_6764699534,420,4,-4,-15,9,1,3,2,3,6,3,-1,2,3,4,5,1,2,2,0,0,13,-8,-5,7,2,7,0,-1,1,-1,-1,1,4,1
KR_6772956661,420,0,-30,22,6,-2,1,3,2,5,3,1,3,2,1,1,0,4,5,1,0,8,1,-3,6,3,3,0,-1,-1,-1,-1,1,5,1
KR_6769565357,420,0,-27,4,9,0,2,2,1,2,1,5,5,0,3,4,1,0,0,0,0,11,-8,1,7,8,6,0,0,0,1,1,1,0,1
KR_6773689322,420,3,36,12,8,1,3,2,0,1,1,5,5,0,1,1,0,1,1,0,0,5,-7,0,8,8,3,0,0,1,1,1,1,5,1
KR_6735617616,420,-2,-34,7,3,-4,2,6,3,5,2,0,1,1,2,5,3,2,2,0,0,3,3,1,7,8,2,0,0,1,1,1,-1,5,1
KR_6772055004,420,2,55,25,3,3,3,0,0,2,2,5,6,1,-4,2,6,-1,1,2,0,-3,-13,-8,9,1,0,0,-1,1,1,1,1,1,1
KR_6776740172,420,3,39,-1,11,1,4,3,1,2,1,2,4,2,6,9,3,1,2,1,0,18,3,2,3,5,1,0,1,-1,1,1,1,4,1
KR_6772942542,420,4,10,9,8,-1,1,2,5,6,1,3,3,0,1,2,1,0,2,2,0,20,13,8,2,10,5,0,1,-1,-1,1,-1,2,1
KR_6744074077,420,-1,17,7,0,2,4,2,0,4,4,-4,0,4,1,2,1,1,1,0,0,4,-7,-1,7,6,6,0,-1,1,1,-1,-1,2,1
KR_6764803642,420,-2,-32,11,-2,-1,0,1,1,5,4,1,2,1,-3,2,5,0,0,0,0,-3,6,3,4,7,-7,0,0,1,1,1,-1,1,1
KR_6776774373,420,4,48,-11,13,2,2,0,-1,1,2,7,8,1,4,4,0,1,1,0,0,14,5,1,6,7,2,0,1,1,-1,1,1,3,1
KR_6776388439,420,2,66,-13,10,2,3,1,0,1,1,1,1,0,7,8,1,0,2,2,0,7,-3,8,1,9,3,0,1,1,-1,1,-1,4,1
KR_6742335160,420,2,29,28,11,-5,3,8,7,8,1,4,6,2,4,8,4,1,2,1,1,8,-4,1,9,10,3,0,2,1,-1,1,1,5,1
KR_6776463835,420,-1,26,4,-2,1,3,2,-1,1,2,-3,2,5,3,4,1,-2,0,2,0,-9,2,4,5,9,0,0,0,-1,-1,1,-1,5,1
KR_6740520477,420,0,12,8,-4,-1,1,2,-2,4,6,-1,1,2,2,3,1,-2,0,2,0,-7,56,2,4,6,-26,0,0,1,1,1,-1,3,1
KR_6766856514,420,4,-7,42,5,-1,1,2,1,4,3,1,3,2,5,6,1,-1,0,1,0,11,13,1,5,6,-2,0,2,0,1,1,-1,0,1
KR_6758845020,420,0,-16,-28,3,-3,2,5,0,3,3,2,3,1,6,7,1,-2,1,3,1,8,4,-3,11,8,-6,0,-1,1,-1,-1,1,6,1
KR_6776484158,420,5,65,0,4,2,4,2,0,1,1,1,1,0,-1,2,3,2,2,0,0,2,0,0,6,6,1,0,1,1,1,1,-1,6,1
KR_6749804589,420,5,58,2,11,1,1,0,3,3,0,1,3,2,5,7,2,1,1,0,0,6,1,7,3,10,2,0,1,1,1,1,1,6,1
KR_6776331311,420,4,3,-12,16,2,3,1,9,9,0,2,4,2,1,6,5,2,2,0,0,19,1,4,3,7,-7,0,1,1,-1,1,1,2,1
KR_6774388493,420,0,16,-3,3,-1,2,3,3,6,3,1,4,3,-2,2,4,2,4,2,0,3,-37,-2,5,3,3,0,0,-1,1,1,1,5,1
KR_6713147059,420,4,9,33,5,-3,0,3,4,6,2,2,3,1,2,5,3,0,1,1,0,9,14,2,9,11,0,0,0,1,-1,0,-1,4,1
KR_6757056774,420,1,36,-8,11,2,2,0,1,8,7,5,6,1,6,7,1,-3,0,3,0,8,40,-4,11,7,-28,0,2,1,-1,-1,-1,1,1
KR_6701226421,420,2,34,1,-1,-4,1,5,-1,1,2,2,5,3,2,6,4,0,1,1,0,3,-33,-1,7,6,6,0,0,-1,-1,1,1,5,1
KR_6764641648,420,3,22,21,5,2,5,3,4,5,1,2,3,1,-1,3,4,-2,0,2,0,5,-47,0,6,6,14,0,1,1,1,1,1,5,1
KR_6750431114,420,4,68,35,11,2,4,2,0,3,3,6,7,1,-1,0,1,4,5,1,0,11,13,0,7,7,-5,0,3,1,1,1,-1,5,1
KR_6770178252,440,3,-50,13,7,-2,0,2,1,2,1,3,4,1,4,4,0,1,2,1,-1,10,5,0,6,6,0,0,0,1,-1,0,-1,4,1
KR_6753088964,420,-3,18,-2,4,-7,1,8,17,19,2,-2,2,4,0,4,4,-4,1,5,4,-13,6,4,4,8,1,0,0,-1,1,1,1,2,1
KR_6753073491,420,6,138,23,12,3,4,1,6,9,3,2,6,4,1,7,6,0,0,0,-1,8,-5,-4,12,8,4,0,3,1,1,1,-1,4,1
KR_6741024529,420,3,59,20,9,1,3,2,4,6,2,-5,3,8,7,8,1,2,2,0,1,7,-5,3,8,11,-3,0,0,1,1,1,1,2,1
KR_6759613141,420,7,89,5,13,1,2,1,5,7,2,2,4,2,4,6,2,1,1,0,0,15,1,-2,9,7,8,0,3,1,1,1,1,6,1
KR_6742180002,420,3,67,12,10,-3,0,3,4,4,0,1,3,2,7,7,0,1,1,0,0,16,4,2,4,6,-1,1,2,1,-1,1,-1,4,1
KR_6752237552,420,5,12,49,11,-2,1,3,1,4,3,4,5,1,0,3,3,8,8,0,0,19,24,0,7,7,1,0,1,1,-1,1,-1,6,1
KR_6774742409,420,6,79,14,7,0,2,2,0,3,3,4,6,2,0,1,1,3,3,0,0,11,10,4,4,8,5,0,2,1,1,1,-1,4,1
KR_6766480621,420,0,29,8,7,4,4,0,1,4,3,1,2,1,0,0,0,1,1,0,0,3,18,2,5,7,-2,0,1,1,1,1,-1,5,1
KR_6773936420,420,2,24,27,3,0,2,2,3,3,0,3,5,2,-1,1,2,-2,0,2,0,2,-1,1,6,7,0,0,1,1,1,1,1,3,1
KR_6776123470,420,5,15,2,10,1,2,1,4,5,1,1,4,3,2,4,2,2,4,2,1,10,-1,-2,7,5,3,0,2,1,1,1,1,4,1
KR_6772614064,420,7,139,25,15,10,10,0,1,7,6,-1,3,4,-1,2,3,6,8,2,3,13,12,11,2,13,-3,0,4,1,1,1,1,3,1
KR_6774920427,420,3,36,-17,4,-3,1,4,0,1,1,2,3,1,3,5,2,2,3,1,0,4,34,-2,9,7,7,0,1,1,-1,1,1,3,1
KR_6724434356,420,1,14,8,7,5,5,0,3,5,2,-2,2,4,1,2,1,0,2,2,1,5,-161,2,6,8,-5,0,0,-1,1,1,1,4,1
KR_6740689322,420,3,40,-7,6,0,1,1,0,5,5,5,6,1,3,3,0,-2,2,4,1,7,-13,-2,6,4,-1,0,1,1,1,1,1,6,1
KR_6710048703,420,0,-32,17,-5,1,5,4,3,5,2,1,2,1,-6,2,8,-4,0,4,0,-9,211,2,8,10,0,0,-1,1,1,-1,-1,5,1
KR_6741921429,440,-2,-38,-5,-6,-4,4,8,0,1,1,1,2,1,1,3,2,-4,2,6,0,-4,-2,1,5,6,2,0,0,-1,1,-1,1,1,1
KR_6765851194,420,2,32,32,4,-2,1,3,0,3,3,4,4,0,1,3,2,1,2,1,0,9,36,-3,8,5,0,0,0,1,1,1,1,5,1
KR_6760545348,420,-3,-36,5,-1,0,1,1,-1,0,1,0,2,2,0,3,3,0,3,3,0,-4,-53,2,5,7,28,0,-1,-1,-1,-1,1,4,1
KR_6744422061,440,0,35,-20,-3,2,2,0,-4,0,4,4,4,0,-1,0,1,-4,1,5,0,-12,-66,3,3,6,0,0,1,-1,1,1,-1,1,1
KR_6769752285,420,-4,-6,5,-3,1,3,2,2,2,0,-2,1,3,-4,0,4,0,1,1,1,-3,25,-4,8,4,0,0,1,-1,1,1,1,4,1
KR_6768246403,440,0,-23,24,-5,3,5,2,-4,1,5,-1,1,2,-3,1,4,0,0,0,0,-12,-3,1,4,5,0,0,-1,-1,1,1,-1,2,1
KR_6752835134,420,-1,-27,8,9,2,3,1,4,5,1,1,1,0,1,2,1,1,1,0,1,9,-1,6,2,8,4,0,0,1,-1,0,1,6,1
KR_6762193045,420,-2,-51,16,-7,-3,0,3,-5,2,7,-2,0,2,1,1,0,2,2,0,0,-6,1,-3,6,3,1,0,0,1,1,1,-1,1,1
KR_6740030722,420,-1,33,-35,-6,0,0,0,1,7,6,-6,1,7,-1,2,3,0,1,1,0,-7,-37,-1,8,7,-4,0,0,-1,-1,1,1,4,1
KR_6730196531,420,5,49,25,10,0,2,2,6,6,0,0,2,2,5,8,3,-1,1,2,0,4,7,3,4,7,1,0,1,1,-1,1,-1,2,1
KR_6774781516,420,-3,-37,21,-5,-3,0,3,-2,1,3,5,6,1,-4,1,5,-1,2,3,0,-6,-19,-3,7,4,6,0,-1,1,-1,-1,-1,4,1
KR_6702700300,420,4,57,-2,16,0,2,2,4,5,1,6,6,0,5,5,0,1,2,1,-1,20,9,6,2,8,3,0,1,1,1,1,-1,3,1
KR_6776552761,420,-2,1,-17,-2,0,1,1,1,2,1,0,1,1,-2,0,2,-1,1,2,1,2,-3,1,6,7,5,0,0,1,1,0,1,1,1
KR_6709695801,420,3,-4,11,9,6,6,0,-1,2,3,2,3,1,2,7,5,0,1,1,0,5,25,1,6,7,-3,0,1,1,1,1,1,2,1
KR_6748085355,420,2,120,-22,6,2,3,1,0,6,6,3,4,1,0,1,1,1,3,2,0,2,-45,-3,10,7,12,0,1,-1,1,1,1,1,1
KR_6753328187,420,5,42,0,9,0,1,1,1,4,3,0,3,3,8,10,2,0,0,0,0,9,-4,-3,5,2,-1,0,2,-1,1,1,-1,4,1
KR_6733174620,420,0,45,12,-4,-4,3,7,-3,5,8,3,6,3,-2,3,5,2,3,1,2,-2,27,0,9,9,4,0,0,1,-1,-1,1,2,1
KR_6766020104,420,4,-13,-1,8,4,4,0,2,2,0,2,5,3,-2,2,4,2,4,2,2,18,-4,3,5,8,2,0,1,1,1,1,1,1,1
KR_6769275230,420,0,-19,5,2,0,1,1,-2,2,4,3,3,0,0,0,0,1,2,1,0,0,-192,3,1,4,-8,0,0,-1,1,1,-1,2,1
KR_6777221054,420,-1,-28,-26,2,1,4,3,-6,1,7,3,4,1,5,6,1,-1,1,2,-1,-4,-6,-3,7,4,4,0,2,-1,1,1,-1,6,1
KR_6774444791,420,-1,-43,20,-6,-1,3,4,-4,2,6,4,5,1,-2,3,5,-3,1,4,0,-10,-4,-4,8,4,-6,0,1,-1,-1,1,1,3,1
KR_6743189933,420,0,-6,-13,-9,0,3,3,-7,1,8,-3,1,4,2,4,2,-1,1,2,1,-5,3,1,7,8,1,0,0,1,-1,1,1,3,1
KR_6743791258,420,5,22,19,8,3,5,2,4,5,1,2,4,2,-2,2,4,1,1,0,0,0,-33,1,5,6,16,0,2,-1,1,1,-1,3,1
KR_6774427645,420,2,11,-4,12,1,3,2,2,5,3,2,2,0,5,7,2,2,2,0,0,9,0,-2,8,6,5,0,-1,1,-1,-1,1,4,1
KR_6777609379,420,2,46,23,-3,-1,1,2,1,3,2,-4,1,5,0,2,2,1,1,0,0,-5,-3,1,4,5,7,0,0,-1,1,0,-1,6,1
KR_6753367493,420,2,63,-9,3,2,3,1,-3,1,4,-2,1,3,4,5,1,2,3,1,1,5,6,5,3,8,2,0,0,1,-1,1,1,5,1
KR_6768256812,420,4,51,9,5,3,4,1,-1,3,4,1,1,0,1,4,3,1,1,0,0,5,8,5,4,9,-1,0,2,1,-1,1,1,5,1
KR_6714450679,420,4,74,3,16,4,5,1,3,4,1,1,4,3,4,5,1,4,4,0,0,15,9,3,5,8,3,0,2,1,1,1,1,2,1
KR_6699151592,420,-2,79,-31,-9,-3,1,4,-3,1,4,-4,0,4,0,4,4,1,2,1,0,-3,6,-4,10,6,-1,0,-1,-1,-1,-1,-1,1,1
KR_6742369657,420,4,64,-4,16,4,5,1,2,2,0,8,10,2,4,7,3,-2,0,2,0,27,3,4,4,8,6,0,1,0,1,1,-1,0,1
KR_6751050164,420,3,49,19,8,6,7,1,-2,3,5,1,2,1,4,5,1,-1,0,1,0,6,125,1,3,4,2,0,1,1,-1,1,1,3,1
KR_6771171765,420,5,40,5,12,4,4,0,-4,1,5,2,6,4,11,12,1,-1,0,1,2,14,6,-2,10,8,6,0,4,1,1,1,1,4,1
KR_6754635434,420,1,20,-12,5,5,6,1,-2,3,5,2,6,4,-3,0,3,3,3,0,0,-3,3,2,7,9,-3,0,0,-1,-1,1,1,4,1
KR_6717135612,420,-5,-76,-48,-3,2,2,0,-2,1,3,-2,4,6,-1,3,4,0,0,0,0,-6,-7,4,6,10,-1,0,0,-1,-1,-1,1,3,1
KR_6776559542,420,5,58,49,11,1,2,1,3,3,0,4,5,1,4,9,5,-1,0,1,0,16,5,-7,9,2,3,0,1,1,1,1,-1,5,1
KR_6745847278,420,6,27,8,14,1,1,0,6,8,2,3,7,4,5,5,0,-1,0,1,0,26,2,6,3,9,2,0,1,-1,1,1,1,1,1
KR_6775361713,420,7,139,65,13,4,4,0,0,1,1,2,4,2,4,6,2,3,3,0,1,12,-5,-3,12,9,1,0,2,1,1,1,1,1,1
KR_6743150344,440,7,20,9,16,3,3,0,-2,1,3,7,8,1,3,3,0,5,5,0,0,24,75,5,3,8,0,0,0,-1,1,1,1,6,1
KR_6771629085,420,-1,39,-63,1,1,2,1,-2,3,5,2,4,2,-1,5,6,1,1,0,0,-1,2,5,2,7,0,0,0,-1,1,-1,1,4,1
KR_6723097360,440,1,14,-31,8,3,3,0,-1,1,2,3,5,2,4,5,1,-1,2,3,0,6,-6,-4,13,9,7,0,0,1,1,0,1,2,1
KR_6764071302,420,1,-43,-8,5,2,2,0,3,3,0,2,5,3,3,5,2,-5,0,5,0,3,5,5,3,8,-4,0,-1,0,1,-1,-1,0,1
KR_6764981286,420,2,13,41,0,-3,0,3,10,10,0,-1,2,3,-5,0,5,-1,2,3,-1,-3,-14,-3,6,3,2,0,1,1,1,1,-1,1,1
KR_6742950733,420,3,33,40,5,6,6,0,-3,1,4,1,2,1,1,7,6,0,0,0,-1,-4,-11,-4,8,4,9,0,1,-1,1,1,-1,1,1
KR_6750386891,420,1,-37,20,-1,1,4,3,0,2,2,-1,1,2,0,3,3,-1,1,2,0,-5,-22,-4,8,4,-2,0,0,1,1,1,1,2,1
KR_6762487656,420,1,-2,-30,3,2,2,0,-2,3,5,1,2,1,0,2,2,2,2,0,0,5,4,-1,7,6,-1,0,1,-1,-1,1,-1,2,1
KR_6761609476,440,6,62,21,9,2,5,3,0,4,4,0,3,3,7,8,1,0,0,0,0,13,10,-2,6,4,-4,0,2,1,1,1,1,3,1
KR_6688263680,420,2,4,39,5,3,3,0,-3,0,3,0,2,2,0,3,3,5,6,1,2,6,15,-6,9,3,8,0,2,1,1,1,1,4,1
KR_6775021506,420,2,2,-26,8,4,5,1,-1,2,3,1,2,1,4,5,1,0,1,1,0,19,30,3,6,9,4,0,1,1,1,1,1,5,1
KR_6764384493,420,3,112,27,7,0,1,1,-1,1,2,4,5,1,4,6,2,0,1,1,0,3,7,1,3,4,3,0,1,1,1,1,1,1,1
KR_6705356959,420,-3,-20,-16,-5,4,4,0,-6,0,6,-3,0,3,0,0,0,0,1,1,0,-4,-32,0,9,9,-2,0,1,1,1,1,-1,6,1
KR_6699950800,420,8,127,-5,24,2,4,2,3,6,3,5,7,2,12,12,0,2,2,0,0,18,-189,4,4,8,4,0,2,1,1,1,1,3,1
KR_6770963496,420,4,-2,-5,4,-1,1,2,0,3,3,0,5,5,5,6,1,0,1,1,0,11,24,-3,7,4,1,0,1,-1,-1,1,1,2,1
KR_6776836215,420,-1,-20,4,-9,-3,2,5,0,3,3,-5,1,6,-1,2,3,0,3,3,-1,-4,-9,-6,7,1,1,0,-1,-1,1,-1,-1,4,1
KR_6767090274,420,3,17,-13,9,1,3,2,1,3,2,2,3,1,7,9,2,-2,1,3,1,12,-41,0,8,8,8,0,1,-1,1,1,1,4,1
KR_6752214191,420,4,4,0,7,2,3,1,0,3,3,-1,0,1,4,5,1,2,3,1,2,13,-12,7,4,11,0,0,0,1,1,-1,1,5,1
KR_6758972565,420,5,48,3,16,0,2,2,5,5,0,3,4,1,9,9,0,-1,0,1,0,22,38,-3,7,4,1,0,2,1,1,1,1,1,1
KR_6748269021,420,5,53,24,6,4,4,0,1,3,2,1,3,2,-3,3,6,3,3,0,1,9,28,2,4,6,2,0,0,1,1,1,1,5,1
KR_6764913490,420,-3,-44,-21,-1,-2,0,2,-1,5,6,3,5,2,-1,3,4,0,1,1,0,6,15,0,8,8,2,0,0,-1,1,-1,1,4,1
KR_6735808967,420,1,14,28,-4,-1,0,1,3,4,1,-4,3,7,-1,3,4,-1,0,1,0,-7,9,2,4,6,-5,0,-1,1,-1,-1,1,6,1
KR_6709317141,420,2,55,-26,9,-1,2,3,7,7,0,-1,2,3,5,8,3,-1,1,2,0,10,-9,3,8,11,5,0,-1,-1,1,-1,1,2,1
KR_6732675475,420,0,-8,-12,10,1,2,1,5,6,1,7,8,1,-5,0,5,2,2,0,0,14,6,2,5,7,-2,0,2,1,1,1,1,5,1
KR_6749851211,420,-1,-47,7,2,1,2,1,3,5,2,2,4,2,-3,3,6,-1,2,3,0,0,13,0,5,5,-5,0,0,-1,1,0,1,2,1
KR_6777550044,420,-1,-23,40,-4,1,2,1,-2,3,5,-3,2,5,0,1,1,0,0,0,0,-5,131,-5,8,3,-10,0,0,1,1,0,-1,1,1
KR_6765861286,420,2,65,-9,8,-3,1,4,2,5,3,0,0,0,2,5,3,7,7,0,1,11,42,2,5,7,-9,0,1,-1,-1,1,-1,6,1
KR_6770442001,440,4,42,16,8,0,1,1,3,4,1,2,4,2,2,4,2,1,1,0,1,11,5,1,7,8,1,0,0,1,-1,0,1,6,1
KR_6776419504,420,-1,13,-16,-1,1,2,1,-4,1,5,0,1,1,1,1,0,1,1,0,0,1,4,-2,6,4,2,0,-1,1,-1,-1,-1,4,1
KR_6743498916,420,1,30,-19,2,1,3,2,-4,0,4,4,4,0,-1,0,1,2,2,0,0,7,12,-3,8,5,-6,0,0,-1,1,-1,1,4,1
KR_6753930781,420,-3,16,9,-10,0,2,2,-7,0,7,-3,2,5,-1,2,3,1,1,0,0,-20,-44,-3,7,4,-1,0,-1,1,-1,-1,1,2,1
KR_6751445129,420,-1,11,-20,-1,1,3,2,-2,3,5,-3,5,8,3,5,2,0,0,0,0,1,-8,-4,7,3,4,0,-2,-1,-1,-1,-1,2,1
KR_6769981581,420,7,45,16,18,0,1,1,12,12,0,1,1,0,5,10,5,0,1,1,2,20,-7,0,5,5,7,0,1,1,1,1,1,6,1
KR_6775861242,420,3,-30,68,5,0,1,1,7,9,2,0,1,1,-3,3,6,1,2,1,0,9,39,-1,7,6,-1,0,-1,1,-1,-1,-1,3,1
KR_6772541204,420,1,40,6,2,0,2,2,-3,1,4,2,2,0,4,4,0,-1,1,2,0,-1,31,2,5,7,4,0,1,-1,1,1,-1,6,1
KR_6767546582,420,2,-27,8,0,2,2,0,-1,3,4,-2,1,3,0,2,2,1,1,0,0,-4,-6,0,6,6,-1,0,-1,1,1,-1,-1,6,1
KR_6771774996,420,1,19,-6,4,-1,2,3,0,2,2,-2,1,3,6,6,0,1,1,0,0,8,6,0,9,9,-6,0,-1,-1,-1,-1,1,5,1
KR_6728196765,420,1,13,20,1,4,4,0,-1,3,4,-5,5,10,3,7,4,0,1,1,0,3,14,2,10,12,0,0,-1,1,-1,-1,-1,4,1
KR_6741650818,440,4,71,21,2,0,2,2,-1,0,1,-1,0,1,4,5,1,0,1,1,0,-1,1,0,7,7,2,0,1,1,1,1,1,1,1
KR_6776648469,440,-1,37,-21,-5,-1,2,3,-4,0,4,1,1,0,-4,0,4,3,3,0,0,-8,5,2,5,7,-2,0,1,-1,1,1,-1,5,1
KR_6777683722,420,1,13,0,11,2,3,1,1,3,2,3,3,0,4,4,0,1,1,0,0,15,17,5,2,7,0,0,1,1,1,1,1,2,1
KR_6769302160,420,0,-18,24,2,-3,1,4,0,3,3,2,5,3,2,3,1,1,1,0,0,6,-2,-1,4,3,3,0,0,1,1,1,1,4,1
KR_6733628579,440,2,103,15,7,2,3,1,1,3,2,3,4,1,2,2,0,-1,1,2,0,7,48,2,6,8,-1,0,0,0,-1,1,1,0,1
KR_6769517215,420,2,21,9,5,-1,2,3,4,4,0,6,6,0,0,3,3,-4,1,5,0,14,-11,0,6,6,1,0,0,1,1,0,1,6,1
KR_6752901094,420,5,71,9,12,0,4,4,5,6,1,3,5,2,3,4,1,1,1,0,0,18,3,-1,6,5,2,0,3,-1,-1,1,1,2,1
KR_6699545257,420,0,11,-20,-2,-1,2,3,0,0,0,-5,0,5,3,4,1,1,2,1,0,-1,34,-1,7,6,-4,0,1,1,-1,1,1,5,1
KR_6774119795,420,6,52,17,15,2,2,0,5,6,1,4,4,0,2,4,2,2,2,0,0,18,4,-1,9,8,3,0,2,1,1,1,-1,4,1
KR_6742802203,420,1,21,6,6,3,4,1,1,3,2,-2,1,3,1,4,3,3,4,1,-1,13,-14,1,9,10,-3,0,1,-1,-1,1,-1,2,1
KR_6758727865,420,4,98,21,6,1,4,3,0,1,1,1,3,2,3,3,0,1,1,0,0,5,20,-3,6,3,-1,0,1,1,1,1,1,3,1
KR_6770683368,420,3,66,16,4,3,3,0,1,2,1,1,3,2,0,1,1,-1,1,2,1,4,-2,-4,8,4,-1,0,0,1,-1,0,1,3,1
KR_6710595312,420,3,39,-13,15,1,2,1,-1,3,4,8,11,3,5,5,0,2,4,2,0,17,-2,2,6,8,0,0,3,1,1,1,1,5,1
KR_6739371047,440,0,14,19,-1,-4,3,7,-2,0,2,0,1,1,4,4,0,1,3,2,0,5,1,0,7,7,3,0,0,-1,1,0,1,1,1
KR_6742431076,420,3,-70,20,7,-1,1,2,3,4,1,4,4,0,0,3,3,1,1,0,0,13,22,-2,8,6,0,0,-1,1,1,-1,1,4,1
KR_6777175323,420,5,53,20,7,2,3,1,0,4,4,3,7,4,2,6,4,0,2,2,0,-4,-3,-8,11,3,4,0,2,1,1,1,-1,4,1
KR_6764284274,420,-2,12,-6,-6,0,1,1,-1,4,5,0,1,1,-2,1,3,-3,0,3,0,-4,6,2,5,7,-5,0,0,-1,-1,1,-1,3,1
KR_6749961828,420,6,101,-1,11,1,1,0,1,1,0,7,7,0,1,3,2,1,1,0,0,6,11,5,4,9,-3,0,1,1,1,1,1,3,1
KR_6777321576,420,3,-2,52,2,0,4,4,4,6,2,2,2,0,-1,3,4,-3,0,3,0,-2,8,0,5,5,-4,0,1,-1,1,1,1,3,1
KR_6776945318,440,-1,-21,4,-5,0,5,5,0,2,2,-2,5,7,-3,2,5,0,1,1,0,-4,10,-3,3,0,1,0,0,-1,1,1,1,1,1
KR_6756493486,420,3,67,29,4,2,4,2,0,4,4,3,4,1,-2,2,4,1,1,0,0,3,16,2,5,7,-2,0,0,0,1,0,-1,0,1
KR_6737294552,420,-3,-16,4,-6,-2,2,4,-3,2,5,2,5,3,-2,0,2,-1,0,1,0,-11,-7,-4,8,4,2,0,0,-1,1,0,1,3,1
KR_6746002013,420,4,47,5,23,0,1,1,10,11,1,5,8,3,8,9,1,0,1,1,0,26,42,-5,8,3,2,0,0,1,1,-1,1,1,1
KR_6770014472,440,2,47,-3,5,1,2,1,2,4,2,0,3,3,1,2,1,1,1,0,0,8,-1,1,6,7,2,0,1,-1,1,1,-1,2,1
KR_6763553646,420,4,86,-30,12,4,4,0,0,4,4,3,4,1,5,7,2,0,1,1,0,12,-9,-1,4,3,5,0,1,1,1,1,1,5,1
KR_6738596545,420,3,-24,50,3,1,3,2,2,7,5,1,1,0,-1,1,2,0,0,0,-1,-4,-188,2,5,7,-4,0,0,-1,1,0,-1,2,1
KR_6772155915,420,-1,-26,-7,-1,2,3,1,7,8,1,-2,1,3,-1,3,4,-7,0,7,0,4,22,0,6,6,-6,0,-3,1,-1,-1,1,5,1
KR_6773164949,420,1,43,29,4,1,2,1,-1,4,5,2,4,2,4,4,0,-2,2,4,0,-3,33,4,7,11,-1,0,0,1,-1,0,1,2,1
KR_6776096379,420,2,64,-3,4,6,6,0,-2,2,4,2,4,2,-1,1,2,-1,0,1,0,-6,2,5,6,11,1,0,0,-1,1,1,-1,1,1
KR_6776734108,420,3,-2,-7,9,0,1,1,1,2,1,2,2,0,4,6,2,2,2,0,0,12,11,6,5,11,0,0,1,1,1,1,1,2,1
KR_6769917616,440,0,-36,-10,2,0,2,2,2,2,0,-1,0,1,1,1,0,0,0,0,0,5,-41,0,6,6,26,0,0,1,-1,0,1,2,1
KR_6776837791,420,0,-33,-21,2,5,5,0,-2,3,5,-2,3,5,0,6,6,1,3,2,0,-5,7,1,3,4,-4,0,0,-1,1,-1,-1,5,1
KR_6776853757,420,0,-6,-13,4,-1,2,3,2,3,1,0,1,1,1,1,0,2,3,1,2,10,244,5,6,11,6,0,1,-1,1,-1,1,5,1
KR_6763720565,420,2,4,39,3,-2,1,3,-1,4,5,2,4,2,6,7,1,-2,1,3,0,-1,31,-1,9,8,1,0,2,1,1,1,1,6,1
KR_6774629537,420,1,32,-4,2,0,1,1,4,6,2,-1,0,1,-1,2,3,0,1,1,0,7,-3,-1,7,6,5,0,0,-1,-1,1,-1,3,1
KR_6773929912,420,6,103,0,11,1,1,0,5,5,0,3,3,0,2,2,0,0,1,1,0,17,5,2,3,5,3,0,4,1,1,1,1,5,1
KR_6772032884,420,-2,57,-16,2,-3,2,5,0,1,1,2,2,0,3,7,4,0,0,0,0,2,-38,-2,7,5,4,0,-1,-1,1,-1,-1,6,1
KR_6734818619,420,5,-11,-23,16,2,4,2,6,8,2,3,4,1,4,8,4,1,3,2,1,19,120,0,6,6,1,0,1,1,1,1,1,2,1
KR_6745931621,420,0,20,-6,6,-2,0,2,0,4,4,-2,3,5,5,7,2,5,5,0,1,15,-26,0,8,8,-1,0,1,1,1,1,1,5,1
KR_6764886738,420,1,21,-14,5,2,2,0,2,2,0,0,1,1,-1,1,2,2,2,0,0,6,-36,4,3,7,-1,0,1,1,1,1,1,2,1
KR_6737968168,420,1,-23,28,2,1,4,3,-4,0,4,1,1,0,6,6,0,-2,0,2,1,-9,-33,-3,10,7,2,0,1,1,1,1,1,6,1
KR_6742723307,420,6,70,35,11,2,2,0,5,6,1,3,3,0,-2,0,2,3,4,1,0,14,17,-1,4,3,3,0,1,1,-1,1,-1,4,1
KR_6754640218,420,1,25,28,5,-7,1,8,6,9,3,7,8,1,-2,0,2,1,3,2,0,4,40,-1,5,4,0,0,1,0,1,1,1,0,1
KR_6776357059,420,2,47,4,5,-3,0,3,4,6,2,2,3,1,4,5,1,-2,0,2,0,8,21,-2,6,4,2,0,1,1,-1,1,1,4,1
KR_6753415184,420,1,18,11,-3,-3,0,3,0,2,2,2,3,1,-2,3,5,0,2,2,0,-6,-4,-3,8,5,0,0,1,-1,1,1,-1,2,1
KR_6765538376,420,-1,-60,-1,-5,0,1,1,1,4,3,-5,3,8,-2,2,4,1,1,0,0,0,-2,-3,7,4,-9,0,-1,-1,-1,-1,-1,1,1
KR_6727883094,420,1,-7,9,3,1,1,0,5,5,0,-1,1,2,-3,0,3,1,1,0,0,9,-10,-7,15,8,2,0,0,0,1,1,-1,0,1
KR_6755410962,420,4,82,-15,6,4,5,1,-6,1,7,0,2,2,4,6,2,4,6,2,-1,0,3,0,5,5,6,0,1,1,-1,1,1,5,1
KR_6772300795,420,2,-20,13,12,2,3,1,5,6,1,3,4,1,-5,0,5,7,8,1,-1,16,8,7,3,10,-6,0,0,-1,1,1,-1,2,1
KR_6766126742,420,-2,-29,-16,-1,-5,0,5,1,7,6,1,4,3,2,4,2,0,1,1,0,-2,7,0,3,3,-2,0,-1,1,1,-1,1,6,1
KR_6775371305,420,4,48,18,10,4,4,0,2,3,1,3,3,0,1,1,0,0,0,0,0,13,8,-1,8,7,-7,0,0,1,1,1,1,5,1
KR_6752149950,420,4,2,12,1,5,5,0,1,2,1,0,3,3,-2,0,2,-3,0,3,0,-2,8,-2,5,3,3,0,1,-1,1,1,1,1,1
KR_6759319009,420,2,39,-23,9,1,1,0,-1,2,3,4,6,2,2,2,0,3,3,0,0,5,6,5,3,8,-2,0,1,1,1,1,1,2,1
KR_6751259899,440,4,35,-4,8,1,1,0,3,3,0,1,3,2,-5,0,5,8,9,1,0,2,-14,-3,8,5,2,0,-1,1,-1,-1,1,4,1
KR_6697506568,420,2,10,18,0,2,2,0,-5,1,6,6,6,0,0,4,4,-3,1,4,-2,-3,2,0,5,5,-1,0,1,1,1,1,-1,6,1
KR_6736330203,420,2,106,16,8,4,8,4,1,6,5,3,5,2,-1,3,4,1,2,1,0,-3,23,-3,7,4,1,0,4,-1,1,1,1,3,1
KR_6737287667,420,5,55,21,17,9,10,1,6,6,0,2,4,2,-1,2,3,1,1,0,0,16,8,4,5,9,-3,0,0,0,1,1,1,0,1
KR_6766915270,420,2,50,32,7,5,5,0,-4,1,5,7,7,0,-1,1,2,0,1,1,0,1,2,0,4,4,0,0,2,-1,1,1,-1,1,1
KR_6777739163,420,3,51,21,3,-2,3,5,4,7,3,3,6,3,-2,0,2,0,0,0,0,2,55,-1,6,5,4,0,-1,1,-1,-1,1,4,1
KR_6757440509,420,-1,-22,-7,5,0,0,0,4,6,2,-2,4,6,1,2,1,2,3,1,0,0,18,-1,9,8,1,0,1,-1,1,1,1,3,1
KR_6723216007,440,1,18,16,1,3,3,0,1,5,4,-1,1,2,-3,1,4,1,3,2,0,6,-2,0,6,6,-1,0,1,0,0,1,-1,0,1
KR_6774262852,420,0,-43,-2,-4,-3,1,4,1,3,2,-1,2,3,1,3,2,-2,1,3,0,4,53,-1,6,5,-8,0,-1,-1,-1,-1,-1,5,1
KR_6761913843,440,-4,32,12,-11,-4,4,8,-5,3,8,-2,1,3,0,0,0,0,3,3,0,-5,10,0,2,2,-5,0,1,1,1,1,1,3,1
KR_6745626082,440,0,-13,12,-3,-1,1,2,-3,2,5,-2,1,3,4,8,4,-1,0,1,0,-6,38,-3,6,3,2,0,0,-1,1,1,1,1,1
KR_6737012296,440,2,-12,22,1,-2,1,3,2,3,1,0,1,1,1,2,1,0,2,2,0,0,6,2,6,8,-5,0,0,1,-1,0,1,3,1
KR_6775815721,420,0,-19,15,-7,-1,3,4,-4,1,5,5,5,0,-9,2,11,2,2,0,0,-9,-2,-3,8,5,-1,0,-1,-1,1,-1,1,6,1
KR_6758389733,440,4,-46,59,5,-3,2,5,2,2,0,3,4,1,3,4,1,0,0,0,0,11,1,-3,5,2,0,0,0,-1,1,-1,-1,4,1
KR_6776217761,420,2,12,6,10,-6,0,6,4,4,0,-1,1,2,11,14,3,2,2,0,2,19,-25,1,8,9,3,0,3,1,1,1,-1,5,1
KR_6736298486,420,0,-8,-4,-1,-1,2,3,2,6,4,2,3,1,-1,3,4,-3,0,3,0,0,-3,-1,5,4,0,0,-1,1,-1,-1,-1,3,1
KR_6754453452,420,0,49,-7,3,0,1,1,-1,1,2,1,2,1,3,3,0,0,0,0,0,3,9,6,4,10,-3,0,2,1,-1,1,-1,4,1
KR_6733476979,420,2,-9,18,2,1,2,1,5,6,1,-1,1,2,-1,1,2,-2,0,2,0,1,3,2,4,6,-3,0,1,1,1,1,-1,5,1
KR_6722727516,420,4,77,7,4,2,2,0,-1,1,2,2,2,0,1,4,3,0,1,1,0,-2,29,5,5,10,2,0,1,1,-1,-1,1,2,1
KR_6774626559,420,-1,-7,8,-2,-1,2,3,0,2,2,-1,2,3,0,1,1,0,1,1,0,1,-11,-2,6,4,3,0,1,-1,1,1,-1,5,1
KR_6776631262,440,2,-31,28,0,3,6,3,-7,1,8,0,4,4,-1,0,1,5,8,3,1,4,-10,-1,5,4,-3,0,-1,1,1,-1,-1,1,1
KR_6777886798,420,0,28,16,-3,3,8,5,-2,4,6,-1,1,2,-6,0,6,3,4,1,-1,0,-1,-1,6,5,-4,0,2,-1,1,1,-1,2,1
KR_6771435946,420,0,-17,31,0,-3,0,3,4,8,4,-2,3,5,-1,4,5,2,3,1,0,9,129,-3,8,5,0,0,-1,1,1,1,1,5,1
KR_6734955524,420,3,63,19,5,9,9,0,0,4,4,-5,0,5,0,1,1,1,2,1,1,3,-11,-1,5,4,1,0,1,1,1,1,1,4,1
KR_6763286781,420,-1,-16,-8,3,-2,0,2,2,2,0,-1,2,3,2,6,4,2,3,1,0,8,35,3,4,7,0,0,-1,1,-1,1,-1,4,1
KR_6769717820,420,0,41,9,2,0,1,1,2,6,4,1,2,1,1,3,2,-2,0,2,-1,-3,-48,6,6,12,1,0,2,1,-1,1,-1,1,1
KR_6777807481,420,12,104,80,19,3,3,0,4,4,0,5,5,0,7,7,0,0,0,0,0,20,56,8,1,9,-5,0,4,1,1,1,1,5,1
KR_6733562178,420,3,25,9,3,2,7,5,0,3,3,2,2,0,0,0,0,-1,0,1,0,2,1,-2,8,6,-3,0,2,1,1,1,-1,5,1
KR_6747918933,420,4,16,-11,11,2,4,2,5,7,2,2,2,0,3,3,0,-1,0,1,0,19,-1,1,5,6,3,0,0,1,-1,0,-1,2,1
KR_6713462063,420,0,19,-27,-1,1,1,0,2,4,2,-6,0,6,2,3,1,0,1,1,0,1,-1,3,6,9,0,0,0,-1,-1,0,-1,1,1
KR_6775882816,420,-4,98,-7,-2,1,3,2,-5,2,7,-3,4,7,5,7,2,0,1,1,0,-9,0,8,1,9,0,0,-1,1,-1,-1,-1,1,1
KR_6739884884,420,-2,-38,-30,0,-4,1,5,0,2,2,3,5,2,3,4,1,-2,0,2,0,7,-5,2,5,7,0,0,0,1,-1,-1,-1,2,1
KR_6775307915,420,3,63,-21,0,5,5,0,-1,1,2,-6,0,6,2,10,8,0,0,0,-1,-10,-40,2,5,7,-2,0,2,-1,-1,1,-1,5,1
KR_6722907484,420,1,-15,-9,-1,0,0,0,5,9,4,0,2,2,-1,3,4,-5,0,5,-1,-2,-34,-1,7,6,-5,0,0,1,1,0,-1,5,1
KR_6761775023,440,1,-98,-24,3,-1,1,2,-1,2,3,-3,3,6,7,7,0,1,1,0,1,17,-6,-2,5,3,4,0,-2,1,-1,-1,1,5,1
KR_6702653731,420,0,2,15,1,-1,1,2,1,2,1,-1,1,2,4,5,1,-2,1,3,0,9,-19,2,8,10,-2,0,1,1,1,1,1,4,1
KR_6773331139,440,2,69,-11,5,0,4,4,-2,2,4,0,1,1,7,8,1,0,0,0,0,8,9,1,6,7,5,0,1,1,1,1,-1,5,1
KR_6719940891,420,5,97,2,17,1,2,1,13,14,1,5,7,2,1,4,3,-3,0,3,0,16,-10,3,7,10,7,0,2,-1,1,1,1,5,1
KR_6724141219,420,0,-20,5,1,0,2,2,7,8,1,-5,3,8,-2,3,5,1,1,0,0,7,-30,1,7,8,-4,0,0,-1,1,-1,1,5,1
KR_6768945970,420,4,32,13,9,1,4,3,4,5,1,4,4,0,-1,0,1,1,2,1,0,9,7,3,6,9,0,0,1,1,1,1,-1,3,1
KR_6764879074,420,0,6,0,2,2,3,1,0,2,2,-1,1,2,2,2,0,-1,1,2,0,-1,2,1,9,10,-2,0,0,1,1,0,1,1,1
KR_6759106042,420,-1,26,16,3,0,1,1,3,4,1,1,2,1,4,4,0,-5,0,5,0,5,-5,4,3,7,1,0,0,-1,1,0,1,1,1
KR_6776298963,420,2,-17,20,-1,-4,1,5,0,2,2,0,0,0,4,7,3,-1,1,2,0,0,4,1,4,5,-1,0,0,-1,1,0,1,1,1
KR_6758351929,420,0,3,-16,-2,0,0,0,0,3,3,0,3,3,-3,1,4,1,1,0,0,2,-40,-1,5,4,-2,0,0,-1,1,-1,1,6,1
KR_6774480393,420,-2,-26,-12,-3,1,5,4,-2,0,2,-2,0,2,2,3,1,-2,1,3,0,0,1,1,6,7,0,0,1,-1,1,1,-1,3,1
KR_6699405753,420,0,-22,1,2,1,1,0,1,3,2,1,4,3,-2,2,4,1,1,0,0,8,-4,-1,9,8,-1,0,0,1,1,-1,-1,1,1
KR_6732585840,420,-2,-76,15,3,2,2,0,4,6,2,1,4,3,-4,3,7,0,0,0,0,5,21,2,7,9,-2,0,-1,1,1,-1,-1,6,1
KR_6774163262,420,1,-4,4,0,2,5,3,-3,1,4,1,3,2,2,2,0,-2,0,2,0,-1,-25,-2,6,4,7,0,0,1,1,1,-1,2,1
KR_6716655183,420,-3,-23,-33,0,2,3,1,-3,3,6,0,3,3,3,4,1,-2,0,2,0,3,2,2,4,6,-6,0,-1,1,-1,-1,1,5,1
KR_6773449440,420,4,58,26,13,0,2,2,3,3,0,5,5,0,6,6,0,-1,0,1,0,10,1,2,4,6,-1,0,2,1,-1,1,1,1,1
KR_6777169309,420,1,1,6,6,-6,0,6,0,1,1,8,8,0,1,3,2,3,4,1,0,15,37,-3,8,5,-1,0,1,1,1,1,1,1,1
KR_6773185187,440,2,-6,-2,1,-1,1,2,0,3,3,0,6,6,5,5,0,-3,0,3,0,4,-4,3,4,7,-2,0,0,1,-1,0,-1,1,1
KR_6771683505,420,2,69,-27,8,6,7,1,-2,4,6,2,7,5,0,1,1,2,3,1,0,6,13,6,3,9,-1,0,2,-1,-1,1,1,1,1
KR_6776587211,420,6,20,33,4,-1,1,2,-3,3,6,7,7,0,-1,4,5,2,2,0,0,2,9,-11,16,5,0,0,0,0,-1,-1,1,0,1
KR_6743211420,420,1,24,1,4,-1,0,1,5,7,2,1,3,2,-2,0,2,1,1,0,0,13,-28,1,8,9,5,0,0,1,-1,-1,1,5,1
KR_6757147054,420,6,28,1,4,2,2,0,2,4,2,2,3,1,-3,0,3,1,2,1,1,4,-64,-4,6,2,3,0,1,0,1,-1,1,0,1
KR_6695142495,420,3,21,-25,-2,2,3,1,-1,1,2,-2,1,3,-1,4,5,0,1,1,-1,-3,8,0,5,5,3,0,1,-1,1,1,-1,6,1
KR_6744928205,420,1,8,1,-7,0,3,3,2,2,0,-4,1,5,-4,0,4,-1,1,2,-2,-15,-15,-8,12,4,7,0,1,-1,1,1,-1,4,1
KR_6726176154,420,4,13,-7,7,4,4,0,0,2,2,-1,2,3,2,3,1,2,3,1,0,1,-31,-2,8,6,9,0,1,-1,-1,1,-1,5,1
KR_6775618950,420,4,-30,12,7,1,3,2,2,3,1,-1,2,3,4,5,1,1,1,0,1,9,33,3,6,9,3,0,2,1,1,1,1,4,1
KR_6770368152,440,2,-18,-28,6,1,3,2,7,9,2,4,5,1,-5,3,8,-1,0,1,0,5,3,5,3,8,-1,0,1,1,1,1,-1,4,1
KR_6745082349,420,2,42,29,0,2,3,1,-2,2,4,0,2,2,1,3,2,-1,0,1,0,2,-2,-4,8,4,4,0,1,-1,-1,1,1,4,1
KR_6775505349,420,5,63,12,17,1,3,2,6,7,1,1,1,0,10,11,1,-1,1,2,0,22,0,0,6,6,-1,0,1,1,1,1,1,6,1
KR_6701921094,420,4,37,16,7,0,4,4,1,3,2,0,2,2,4,4,0,2,2,0,0,7,239,4,2,6,-2,0,0,1,-1,0,-1,1,1
KR_6776637497,420,3,19,-12,1,-1,2,3,0,2,2,2,4,2,-1,2,3,1,1,0,0,-1,27,-1,5,4,1,0,0,-1,1,1,-1,1,1
KR_6777318724,420,2,23,-19,8,2,3,1,5,6,1,1,2,1,0,3,3,0,1,1,0,5,6,-7,9,2,4,0,1,1,1,1,1,2,1
KR_6771952123,420,4,74,3,12,1,4,3,0,3,3,7,10,3,4,7,3,0,1,1,0,17,-1,4,3,7,1,0,1,-1,-1,1,-1,1,1
KR_6773803060,440,-2,-91,8,-8,0,3,3,-2,0,2,-3,0,3,-5,0,5,2,4,2,-1,-11,1,0,7,7,-4,0,0,-1,-1,-1,-1,4,1
KR_6765199768,420,3,5,-29,12,4,5,1,0,0,0,0,5,5,9,11,2,-1,1,2,2,25,4,5,6,11,4,0,0,1,-1,-1,1,5,1
KR_6775861410,420,5,54,61,14,0,1,1,7,8,1,1,2,1,3,4,1,3,3,0,0,15,-1,3,3,6,3,0,2,1,-1,1,-1,4,1
KR_6748650188,420,1,-8,-9,4,1,3,2,2,4,2,2,3,1,4,6,2,-5,1,6,1,13,-12,-1,10,9,4,0,-1,1,-1,-1,1,4,1
KR_6759966823,420,1,32,24,4,2,2,0,0,4,4,-3,0,3,7,7,0,-2,1,3,0,6,4,0,6,6,-1,0,3,1,1,1,-1,2,1
KR_6756651629,440,-2,-66,12,1,-1,3,4,1,2,1,4,5,1,-2,0,2,-1,1,2,0,3,-10,1,2,3,2,0,-1,-1,1,-1,-1,1,1
KR_6766518278,420,1,2,34,-3,0,2,2,0,0,0,-2,1,3,0,2,2,-1,0,1,0,-2,-187,-1,6,5,-6,0,0,1,-1,0,1,6,1
KR_6777819374,420,3,55,-12,11,-1,0,1,5,6,1,2,3,1,7,7,0,-2,0,2,0,11,1,-1,7,6,1,0,2,1,-1,1,1,4,1
KR_6775821471,420,0,-26,-47,-1,3,4,1,-4,3,7,2,2,0,-1,0,1,-1,0,1,0,-5,-36,-1,9,8,-3,0,-1,-1,1,1,1,2,1
KR_6746023864,420,0,37,1,11,0,1,1,-2,2,4,9,10,1,0,2,2,4,7,3,0,3,7,3,8,11,-1,0,0,1,-1,1,1,3,1
KR_6777180414,420,3,-27,12,11,0,3,3,2,3,1,7,7,0,2,2,0,0,0,0,0,18,8,1,9,10,-1,0,1,1,1,1,-1,3,1
KR_6774544281,420,4,20,27,9,-1,1,2,4,5,1,2,6,4,3,3,0,1,1,0,0,9,2,0,6,6,5,0,2,-1,1,1,1,4,1
KR_6776815604,420,1,-20,-4,2,5,6,1,3,4,1,-1,2,3,-3,2,5,-2,1,3,-2,2,-13,-5,9,4,3,0,0,1,1,-1,-1,1,1
KR_6776398168,420,0,-42,-17,-3,0,2,2,-1,0,1,-2,1,3,0,2,2,0,1,1,0,-6,2,3,4,7,-3,0,0,1,-1,0,-1,4,1
KR_6756896029,420,4,26,25,8,2,3,1,5,5,0,3,4,1,-2,0,2,0,0,0,0,-1,5,0,4,4,4,0,0,1,1,1,1,6,1
KR_6766231806,420,5,84,19,11,4,5,1,0,7,7,2,4,2,0,2,2,5,5,0,0,9,29,4,5,9,3,0,1,1,1,1,1,2,1
KR_6740263823,420,6,25,36,19,5,7,2,2,3,1,5,7,2,5,6,1,2,2,0,0,24,33,1,6,7,3,0,0,1,-1,-1,1,6,1
KR_6711370168,420,1,57,-20,-2,-7,0,7,0,1,1,0,1,1,5,6,1,0,1,1,0,5,2,0,6,6,-5,0,2,-1,1,1,1,2,1
KR_6753290913,420,7,63,15,17,2,4,2,2,3,1,4,6,2,8,9,1,1,6,5,1,22,-1,-1,4,3,0,0,3,1,1,1,1,2,1
KR_6776104428,440,1,98,5,4,1,2,1,1,1,0,4,4,0,-1,1,2,-1,0,1,0,0,16,3,4,7,-5,0,0,-1,1,0,1,1,1
KR_6770105407,440,-1,-41,-6,2,5,5,0,2,2,0,-4,1,5,-1,0,1,0,0,0,0,4,29,0,3,3,1,0,0,-1,1,1,1,5,1
KR_6744760100,440,2,39,1,0,4,5,1,0,2,2,-9,0,9,3,3,0,2,2,0,1,6,-110,2,6,8,3,0,1,1,-1,1,1,5,1
KR_6760262222,420,0,-10,-8,-6,0,1,1,3,4,1,-5,0,5,-3,3,6,-1,0,1,-1,-6,7,0,7,7,1,0,0,1,-1,1,-1,2,1
KR_6774142803,420,4,41,75,5,1,2,1,5,5,0,2,5,3,-3,0,3,0,0,0,1,1,10,7,5,12,-3,0,0,1,1,1,1,4,1
KR_6770990626,440,-1,15,12,-3,1,2,1,-1,3,4,3,6,3,-1,2,3,-5,2,7,0,-1,-2,6,5,11,-7,0,0,0,-1,0,-1,0,1
KR_6775650795,420,-1,36,0,0,-1,0,1,1,2,1,1,3,2,1,1,0,-2,0,2,0,-2,108,2,8,10,-1,0,0,-1,1,0,-1,3,1
KR_6774848617,420,-1,-20,-11,1,1,3,2,-2,3,5,-1,1,2,2,6,4,1,3,2,0,-2,199,-1,8,7,7,0,1,-1,-1,1,1,3,1
KR_6742040105,420,4,83,35,7,8,8,0,0,4,4,3,4,1,-4,0,4,0,2,2,1,-6,3,4,4,8,-3,0,4,1,1,1,1,5,1
KR_6729451521,420,2,-27,0,9,3,4,1,2,7,5,6,6,0,1,2,1,-3,0,3,0,8,-37,3,3,6,25,0,0,1,1,1,-1,3,1
KR_6760305804,420,-1,-31,5,-4,1,2,1,-2,4,6,-1,2,3,-1,3,4,-1,0,1,0,-3,-1,3,5,8,-1,0,-1,1,-1,-1,-1,2,1
KR_6775190944,420,0,2,-12,5,-4,1,5,6,6,0,3,5,2,1,2,1,-1,0,1,0,17,-5,-2,8,6,3,0,1,1,-1,1,1,1,1
KR_6753276046,420,3,77,14,15,4,5,1,4,6,2,3,4,1,4,8,4,0,0,0,0,18,1,1,7,8,3,0,0,1,-1,1,1,4,1
KR_6774053294,420,2,67,20,-2,-1,0,1,-1,2,3,-1,3,4,2,7,5,-1,1,2,1,2,-128,3,5,8,1,0,0,1,1,-1,1,5,1
KR_6776934370,420,1,9,5,1,-3,0,3,4,5,1,1,1,0,0,2,2,-1,0,1,0,-1,-7,1,5,6,7,0,1,-1,1,1,-1,2,1
KR_6776012900,420,3,7,22,7,-1,0,1,3,4,1,5,6,1,-1,2,3,1,1,0,0,9,45,1,3,4,0,0,2,1,1,1,1,3,1
KR_6728507845,420,8,78,16,16,1,1,0,2,3,1,7,9,2,4,6,2,2,3,1,-1,15,0,-2,6,4,1,0,2,1,1,1,-1,4,1
KR_6769010277,420,5,71,20,12,4,5,1,0,3,3,2,3,1,4,5,1,2,3,1,1,18,18,4,4,8,5,0,2,-1,1,1,1,2,1
KR_6776798913,420,0,-10,4,4,2,6,4,1,5,4,-3,1,4,3,6,3,1,1,0,0,10,-62,4,7,11,-4,0,1,1,1,1,-1,3,1
KR_6750442764,420,6,68,25,13,5,5,0,2,4,2,-1,2,3,4,6,2,3,4,1,0,8,9,1,7,8,7,0,1,1,-1,1,1,3,1
KR_6729973424,420,9,125,42,21,4,4,0,3,5,2,1,3,2,8,9,1,5,5,0,2,15,106,0,10,10,6,2,7,1,1,1,1,2,1
KR_6757041868,420,1,104,27,-2,-1,0,1,-2,4,6,-1,1,2,0,1,1,2,3,1,0,-3,-34,-4,8,4,6,0,0,1,-1,0,1,6,1
KR_6678626837,440,6,42,52,13,5,7,2,4,5,1,2,2,0,1,1,0,1,1,0,0,13,0,1,5,6,1,0,3,1,1,1,1,2,1
KR_6735424485,420,-1,-4,24,-4,-3,0,3,2,2,0,-1,0,1,-2,0,2,0,2,2,0,-4,43,-1,5,4,-30,0,0,1,1,1,-1,4,1
KR_6737600105,420,5,82,-6,13,5,5,0,3,6,3,2,2,0,4,4,0,-1,1,2,0,18,4,2,5,7,-1,0,1,-1,1,1,1,3,1
KR_6749061467,420,-3,5,-18,-3,-2,0,2,-3,0,3,-3,0,3,5,5,0,0,0,0,0,3,-2,3,4,7,-3,0,1,-1,1,1,1,5,1
KR_6737122247,420,0,-1,-7,2,0,2,2,-1,7,8,-1,2,3,4,5,1,0,1,1,0,1,1,-3,11,8,-3,0,-1,-1,1,1,1,2,1
KR_6755290594,420,2,15,24,-4,9,9,0,-3,2,5,-4,3,7,-5,2,7,-1,1,2,0,-13,-1,-1,7,6,2,0,1,-1,1,1,1,4,1
KR_6742689211,420,0,46,-30,-1,-2,2,4,1,2,1,1,5,4,-3,2,5,2,3,1,1,-3,31,-3,7,4,2,0,1,-1,-1,-1,1,2,1
KR_6760675608,420,0,-21,13,4,-5,1,6,2,3,1,7,8,1,0,2,2,0,1,1,0,14,-1,2,4,6,2,0,1,1,1,1,1,4,1
KR_6769145225,420,5,51,-12,11,-1,2,3,3,4,1,3,5,2,4,4,0,2,2,0,0,13,10,4,3,7,-2,0,2,1,1,1,1,4,1
KR_6769269287,440,1,-13,-12,10,1,2,1,3,7,4,5,13,8,2,4,2,-1,0,1,4,21,-4,1,5,6,-1,0,1,1,1,1,1,1,1
KR_6777825549,420,0,3,-10,2,3,4,1,-1,0,1,0,0,0,0,1,1,0,2,2,1,-3,-32,2,5,7,-4,0,1,1,1,1,1,5,1
KR_6750645369,420,0,5,36,-2,-1,0,1,3,5,2,-7,0,7,3,5,2,0,0,0,0,-1,1,0,6,6,-5,0,1,1,1,1,-1,2,1
KR_6769592637,420,-2,-66,-12,1,-7,1,8,3,8,5,0,1,1,3,6,3,2,3,1,0,-3,22,4,8,12,-2,0,-1,-1,-1,1,1,3,1
KR_6729168276,420,2,-66,24,2,3,4,1,-2,3,5,-1,4,5,3,5,2,-1,0,1,-1,-2,-19,-3,7,4,3,0,1,1,1,1,-1,5,1
KR_6775557946,420,3,13,51,3,2,2,0,0,2,2,-2,4,6,0,3,3,3,5,2,1,-8,-2,1,8,9,2,0,0,1,-1,-1,1,5,1
KR_6776994649,420,1,-3,-20,5,-1,0,1,1,4,3,5,5,0,2,4,2,-2,1,3,0,3,-7,-3,9,6,6,0,-1,1,-1,-1,1,3,1
KR_6762918509,420,6,98,-5,10,1,3,2,2,3,1,5,7,2,2,8,6,0,2,2,2,9,-11,7,0,7,4,0,2,1,1,1,1,1,1
KR_6708636659,420,3,110,-4,5,2,2,0,1,4,3,-1,3,4,3,3,0,0,0,0,1,11,-9,0,7,7,-2,0,2,-1,1,1,1,1,1
KR_6774100375,420,0,-32,8,1,-3,1,4,3,5,2,2,3,1,2,4,2,-3,0,3,0,-3,-7,-1,6,5,-1,0,-1,1,1,-1,1,2,1
KR_6764938152,420,0,-7,-37,8,0,1,1,4,7,3,5,5,0,-1,1,2,0,0,0,0,12,-1,2,6,8,-1,0,1,1,1,1,1,2,1
KR_6766397276,420,1,101,-41,5,-2,1,3,0,2,2,-3,0,3,9,10,1,1,1,0,0,8,-33,3,5,8,8,0,1,-1,1,1,1,3,1
KR_6699434699,420,3,21,15,7,-1,0,1,0,4,4,1,2,1,5,6,1,2,2,0,0,7,6,0,6,6,2,0,1,1,1,1,1,3,1
KR_6750344587,440,3,87,-12,5,1,2,1,6,6,0,-3,0,3,6,7,1,-5,0,5,0,6,-43,2,6,8,3,0,1,1,-1,1,1,1,1
KR_6759258068,440,4,37,29,6,5,5,0,0,3,3,-2,2,4,4,4,0,-1,2,3,0,-1,10,4,3,7,-4,0,1,1,-1,1,1,3,1
KR_6734042559,420,-1,-31,-28,4,2,3,1,4,5,1,1,5,4,-1,1,2,-2,1,3,0,9,-46,2,7,9,25,0,-1,-1,1,-1,-1,5,1
KR_6768862308,420,1,63,9,6,5,5,0,4,5,1,-2,1,3,-1,4,5,0,1,1,-1,2,3,-3,11,8,0,0,1,-1,-1,1,-1,1,1
KR_6773989990,420,0,34,13,-3,-2,2,4,-1,4,5,-3,1,4,1,5,4,2,2,0,1,1,37,-7,11,4,-1,0,0,-1,1,1,1,5,1
KR_6774580476,420,-1,27,8,2,5,5,0,-2,2,4,0,2,2,-2,2,4,1,2,1,0,1,-10,1,6,7,8,0,1,-1,1,1,1,1,1
KR_6759504658,420,1,40,-20,7,-1,1,2,7,9,2,5,6,1,-2,4,6,-2,1,3,1,6,-16,-1,4,3,1,0,0,-1,-1,-1,1,2,1
KR_6773087197,420,1,-3,3,9,3,4,1,2,3,1,3,4,1,0,2,2,1,2,1,1,10,-33,2,5,7,2,0,1,1,1,1,1,1,1
KR_6777520101,420,3,1,-3,2,-1,1,2,0,6,6,2,3,1,-3,0,3,4,4,0,0,-2,1,-7,12,5,1,0,1,1,-1,1,-1,6,1
KR_6776630147,420,1,-4,17,-2,-3,0,3,2,5,3,-5,1,6,3,6,3,1,1,0,0,-1,2,-3,7,4,-1,0,-1,-1,1,-1,-1,4,1
KR_6776564917,440,4,53,24,9,9,9,0,0,1,1,-2,1,3,1,2,1,1,1,0,0,24,-6,-2,8,6,8,0,1,1,-1,1,1,6,1
KR_6713296187,420,2,36,15,10,-1,1,2,1,2,1,6,7,1,1,3,2,3,4,1,0,13,12,4,5,9,0,0,3,1,1,1,1,2,1
KR_6712316687,420,2,8,31,4,-2,2,4,-1,3,4,1,2,1,1,7,6,5,6,1,0,1,7,-2,5,3,1,0,1,1,-1,1,-1,1,1
KR_6754444091,420,6,55,36,19,3,3,0,0,2,2,8,9,1,8,8,0,0,0,0,3,25,3,-1,7,6,1,0,1,1,1,1,1,4,1
KR_6742676487,420,1,28,-47,4,1,4,3,3,6,3,2,3,1,-2,2,4,0,1,1,0,6,24,-8,9,1,8,0,1,1,1,-1,1,2,1
KR_6772192765,420,0,-1,-1,-5,-1,3,4,-1,2,3,0,0,0,-3,1,4,0,1,1,-2,-6,-6,1,5,6,5,0,1,-1,1,1,-1,1,1
KR_6765787534,420,3,16,15,8,0,5,5,3,6,3,4,4,0,1,3,2,0,1,1,0,11,-5,0,7,7,0,0,-2,-1,-1,-1,-1,4,1
KR_6771315228,420,0,-12,-4,6,-4,0,4,3,4,1,-3,0,3,8,9,1,2,2,0,0,7,9,3,2,5,0,0,3,1,1,1,1,3,1
KR_6772884529,420,5,69,22,1,4,4,0,-3,4,7,4,6,2,-5,1,6,1,1,0,0,5,-43,-3,7,4,4,0,2,1,1,1,-1,2,1
KR_6705458662,420,4,59,5,12,0,1,1,-1,3,4,5,5,0,6,6,0,2,4,2,0,18,11,1,7,8,0,0,1,-1,-1,1,1,5,1
KR_6777150246,420,-3,-10,9,-4,-4,0,4,-1,0,1,2,2,0,0,4,4,-1,1,2,0,-2,1,1,7,8,-1,0,0,1,1,0,-1,4,1
KR_6700839869,420,6,45,39,10,5,5,0,2,5,3,7,7,0,-5,1,6,1,1,0,0,11,45,2,6,8,3,0,0,1,1,1,1,3,1
KR_6711358989,420,-1,-23,-3,-3,0,0,0,-1,3,4,-3,1,4,1,4,3,0,0,0,0,-6,10,1,5,6,-5,0,0,-1,-1,0,1,5,1
KR_6772545892,420,1,-4,-4,-1,-2,0,2,0,0,0,-1,0,1,1,3,2,1,1,0,0,-1,7,-4,8,4,-6,0,0,1,-1,0,-1,2,1
KR_6765394334,420,2,56,-9,0,-2,0,2,2,2,0,-2,1,3,1,5,4,1,2,1,0,0,-24,-8,13,5,1,0,0,1,-1,1,1,5,1
KR_6768756261,420,1,41,5,5,0,1,1,3,6,3,5,6,1,0,4,4,-3,0,3,0,13,2,-1,8,7,4,0,0,1,1,1,1,3,1
KR_6743550326,420,-1,32,23,-5,0,3,3,0,3,3,-5,0,5,-1,2,3,1,1,0,2,3,34,-1,9,8,2,0,1,1,1,1,1,4,1
KR_6769309741,420,-2,45,15,-1,1,2,1,-3,1,4,1,1,0,-1,3,4,1,1,0,0,-4,-9,-2,5,3,-4,0,1,1,1,1,1,4,1
KR_6763303875,420,0,-9,-19,-3,1,1,0,-3,2,5,-2,1,3,1,4,3,0,1,1,-1,-12,-19,-2,11,9,5,0,3,-1,1,1,-1,6,1
KR_6766881674,420,2,3,-18,1,1,3,2,-5,0,5,4,5,1,2,2,0,-1,0,1,0,2,-140,-2,6,4,-3,0,-1,1,-1,-1,1,3,1
KR_6765801868,420,7,87,20,12,-1,0,1,0,1,1,4,6,2,10,12,2,-1,0,1,0,9,1,-8,13,5,0,0,3,1,1,1,1,2,1
KR_6742936768,420,-1,34,-9,-3,-1,1,2,0,5,5,-1,1,2,-2,0,2,1,1,0,0,-1,2,1,7,8,0,0,0,1,-1,0,-1,1,1
KR_6721047425,420,4,32,25,12,0,2,2,4,5,1,6,7,1,0,0,0,2,2,0,0,8,8,4,3,7,1,0,1,-1,1,1,1,4,1
KR_6776365214,420,2,-16,-11,12,1,3,2,6,7,1,1,1,0,3,4,1,1,1,0,0,19,14,3,3,6,2,0,0,1,1,1,1,3,1
KR_6764965496,420,-3,-13,-16,-1,-4,1,5,3,5,2,0,4,4,-2,1,3,2,2,0,0,-15,-25,2,10,12,3,0,0,1,-1,-1,-1,6,1
KR_6727589108,420,5,13,36,7,1,1,0,0,7,7,-1,1,2,8,8,0,-1,1,2,0,0,31,1,6,7,3,0,3,1,1,1,1,4,1
KR_6777083862,420,4,81,4,11,2,3,1,7,7,0,-1,3,4,3,4,1,0,0,0,1,16,4,-1,6,5,-3,0,2,1,1,1,1,1,1
KR_6777536408,420,-4,-14,-5,-2,0,4,4,-2,1,3,-1,1,2,2,2,0,-1,1,2,0,-5,67,0,5,5,4,0,-1,1,1,-1,1,6,1
KR_6731836412,420,2,1,16,2,1,2,1,2,7,5,-7,3,10,3,7,4,3,4,1,-1,0,11,-3,10,7,-6,0,-1,1,1,1,-1,5,1
KR_6756451663,420,-2,-38,-3,3,1,3,2,-1,3,4,4,8,4,-1,3,4,0,0,0,0,9,13,-1,7,6,-3,0,0,1,1,1,1,3,1
KR_6760395604,420,3,59,3,8,0,2,2,-2,1,3,2,3,1,8,9,1,0,0,0,0,16,8,1,6,7,2,0,1,1,-1,1,1,3,1
KR_6776570899,420,0,25,-10,2,1,2,1,0,3,3,-1,3,4,2,3,1,0,0,0,0,5,-11,-4,7,3,9,0,1,1,1,1,-1,6,1
KR_6775011084,440,1,26,23,4,-2,2,4,0,2,2,2,4,2,2,2,0,2,2,0,0,11,0,-1,8,7,-4,0,0,-1,-1,0,-1,5,1
KR_6716184441,420,-4,-27,-24,-8,-1,1,2,-1,0,1,-2,3,5,-2,0,2,-2,0,2,0,-4,0,-2,6,4,-5,0,-3,-1,1,-1,-1,1,1
KR_6770285731,420,3,89,2,12,1,4,3,1,3,2,2,3,1,8,9,1,0,2,2,2,16,9,3,4,7,0,0,2,1,-1,1,1,5,1
KR_6736790111,420,0,-39,32,-2,-4,0,4,1,3,2,3,3,0,-2,2,4,0,0,0,0,3,6,2,5,7,-6,0,1,1,1,1,1,1,1
KR_6754554116,420,2,13,-8,15,-1,2,3,4,5,1,6,6,0,4,4,0,2,2,0,-1,19,-35,4,3,7,17,0,-2,1,-1,-1,-1,3,1
KR_6710415971,420,4,10,13,8,2,2,0,2,5,3,2,4,2,2,3,1,0,1,1,0,7,-21,0,6,6,0,0,1,1,1,1,1,5,1
KR_6722656154,420,0,-78,-4,-3,-5,0,5,4,6,2,-2,2,4,-1,1,2,1,1,0,-1,-3,12,0,10,10,-4,0,0,1,1,0,-1,4,1
KR_6709268945,420,3,14,1,13,0,2,2,2,6,4,2,6,4,6,7,1,3,3,0,1,29,-16,6,1,7,0,0,0,1,1,1,1,6,1
KR_6715883008,420,-3,22,4,0,3,3,0,-2,3,5,-3,1,4,4,4,0,-2,0,2,1,3,2,-1,6,5,0,0,1,1,0,1,1,5,1
KR_6773946525,420,4,62,57,14,8,8,0,5,7,2,3,4,1,-1,4,5,-1,0,1,2,-1,0,-5,8,3,0,0,1,1,1,1,1,5,1
KR_6744102283,420,2,4,-12,5,5,5,0,-3,0,3,4,5,1,-2,1,3,1,5,4,0,9,1,0,7,7,2,0,0,-1,1,0,-1,2,1
KR_6776958300,420,1,-21,-12,5,-2,1,3,4,6,2,1,2,1,1,1,0,1,1,0,0,11,-21,-3,9,6,3,0,-1,-1,-1,-1,1,3,1
KR_6776489597,420,4,35,-7,1,-1,0,1,3,3,0,0,3,3,1,4,3,-2,0,2,-1,5,-14,-1,9,8,4,0,1,-1,-1,1,-1,6,1
KR_6705467261,420,5,125,17,11,-1,2,3,2,6,4,5,6,1,4,6,2,1,2,1,0,14,11,6,1,7,6,0,2,1,1,1,1,6,1
KR_6767861842,420,0,51,-8,5,0,2,2,4,4,0,1,4,3,1,2,1,-1,2,3,0,4,-1,5,4,9,1,0,1,1,-1,1,1,4,1
KR_6774594347,420,1,31,-12,5,3,3,0,1,3,2,1,3,2,0,5,5,0,2,2,0,5,-18,3,6,9,-2,0,1,1,1,1,1,3,1
KR_6727914911,420,0,18,-11,-3,4,4,0,-2,2,4,-5,3,8,-1,1,2,1,1,0,0,-7,-29,1,5,6,0,0,0,-1,1,1,1,1,1
KR_6742347394,440,-2,15,13,-2,-4,0,4,-1,1,2,1,1,0,2,2,0,0,1,1,0,1,0,3,2,5,3,0,0,1,-1,-1,1,1,1
KR_6732895790,440,8,82,20,4,-2,0,2,5,7,2,-1,1,2,2,4,2,0,0,0,-2,-2,2,-3,5,2,3,0,0,-1,-1,0,-1,2,1
KR_6762552966,420,-1,23,-10,0,1,2,1,1,3,2,3,5,2,-3,3,6,-2,0,2,0,1,5,5,7,12,0,0,1,1,1,1,1,2,1
KR_6737327115,440,4,41,11,10,-3,0,3,6,11,5,3,5,2,2,3,1,2,2,0,0,17,3,-1,9,8,1,0,2,1,1,1,1,2,1
KR_6766123601,420,1,13,20,-3,-1,0,1,-1,3,4,-6,1,7,3,5,2,2,2,0,0,-7,-6,-1,5,4,0,0,1,1,1,1,-1,6,1
KR_6774668400,420,6,71,40,18,0,3,3,5,7,2,6,6,0,6,8,2,1,1,0,0,9,-169,2,3,5,1,0,3,-1,1,1,1,5,1
KR_6770998337,420,0,31,17,2,0,2,2,-2,4,6,3,4,1,1,3,2,0,3,3,0,7,44,4,3,7,-5,0,0,-1,1,1,1,5,1
KR_6748088606,420,1,2,-17,6,0,2,2,3,4,1,5,5,0,1,2,1,-3,0,3,0,6,-17,-4,12,8,0,0,1,1,1,1,1,6,1
KR_6776120452,440,-1,-63,6,-4,-1,1,2,0,1,1,3,4,1,-3,1,4,-3,0,3,0,-3,-55,-1,9,8,30,0,-1,1,-1,-1,-1,1,1
KR_6760185604,420,6,90,9,17,1,3,2,7,7,0,6,6,0,3,5,2,0,1,1,1,21,-1,5,2,7,1,0,1,1,-1,1,1,4,1
KR_6704453967,420,-2,4,8,-2,3,3,0,5,6,1,-1,2,3,-6,4,10,-3,1,4,1,-3,-9,-4,9,5,-4,0,0,1,-1,-1,1,6,1
KR_6720895076,420,4,104,-5,4,2,3,1,-2,3,5,0,1,1,4,7,3,0,0,0,1,6,0,2,6,8,0,0,2,-1,1,1,1,4,1
KR_6767511671,420,0,-27,13,5,-5,0,5,4,7,3,2,2,0,3,4,1,1,2,1,0,7,-27,2,4,6,-1,0,1,-1,1,-1,-1,6,1
KR_6736447463,420,2,15,24,6,2,2,0,1,3,2,0,3,3,-1,0,1,4,4,0,0,9,-6,-1,7,6,2,0,2,-1,1,1,1,4,1
KR_6750670279,420,4,24,32,4,0,0,0,-1,3,4,3,4,1,1,2,1,1,2,1,0,5,-10,-3,13,10,5,0,0,-1,1,0,1,4,1
KR_6769676762,420,-4,31,11,-8,-4,0,4,1,4,3,-4,1,5,-1,3,4,0,0,0,0,-9,-5,-2,5,3,-4,0,-1,1,1,1,-1,5,1
KR_6764719294,420,-4,-55,-32,-8,1,1,0,-5,1,6,-5,3,8,2,4,2,-1,1,2,0,-9,-8,3,4,7,2,0,-2,-1,-1,-1,1,4,1
KR_6761481966,420,-1,10,-16,4,-2,0,2,-2,2,4,1,1,0,5,6,1,2,2,0,0,9,-5,-3,10,7,-5,0,0,1,-1,0,-1,1,1
KR_6766084237,420,3,70,13,3,-2,1,3,4,5,1,1,1,0,1,4,3,-1,0,1,1,0,4,1,5,6,-2,0,1,1,-1,1,-1,6,1
KR_6740544864,420,2,33,1,6,3,5,2,0,3,3,1,2,1,3,5,2,-1,0,1,0,10,4,1,5,6,-2,0,1,1,1,1,1,5,1
KR_6747493492,420,2,19,13,2,-3,1,4,2,5,3,1,5,4,4,5,1,-2,0,2,0,3,1,2,5,7,0,0,0,-1,1,-1,1,3,1
KR_6749532492,420,0,67,-2,-1,3,4,1,1,6,5,0,1,1,-5,2,7,0,1,1,0,-5,-4,-4,9,5,3,0,0,-1,1,0,-1,2,1
KR_6753403015,420,3,42,29,2,4,4,0,0,1,1,5,5,0,-4,2,6,-3,0,3,0,-1,-9,-2,8,6,2,0,1,1,1,1,-1,2,1
KR_6772698231,420,4,21,-9,6,-1,2,3,0,2,2,2,7,5,6,8,2,-1,0,1,0,0,-15,-1,6,5,1,0,1,1,-1,1,1,3,1
KR_6701364055,420,0,-23,22,5,-3,0,3,-1,2,3,4,4,0,3,7,4,2,2,0,0,9,-6,1,11,12,0,0,0,1,1,0,-1,5,1
KR_6771969853,420,2,54,8,2,1,3,2,-1,4,5,0,7,7,-1,1,2,3,3,0,2,11,-6,-2,6,4,2,0,0,-1,1,1,1,4,1
KR_6750239884,420,4,-1,28,8,1,3,2,0,3,3,6,11,5,0,0,0,1,2,1,-3,10,-8,-2,8,6,4,0,1,1,1,1,-1,4,1
KR_6722715511,420,5,61,27,9,4,5,1,3,5,2,0,1,1,1,3,2,1,1,0,0,9,26,2,4,6,4,0,3,1,1,1,1,2,1
KR_6773353305,420,1,60,-19,2,0,1,1,0,0,0,-2,1,3,5,5,0,-1,0,1,0,9,-108,2,4,6,2,0,0,1,-1,1,-1,1,1
KR_6775511248,420,1,8,-12,5,-3,1,4,2,4,2,1,3,2,5,6,1,0,1,1,0,7,-6,6,5,11,-3,0,1,-1,-1,-1,-1,5,1
KR_6755008870,420,2,2,4,5,1,1,0,3,3,0,3,4,1,0,2,2,-2,1,3,0,3,54,-1,6,5,-33,0,2,1,1,1,1,4,1
KR_6665585039,420,1,8,9,3,1,3,2,1,3,2,0,1,1,1,1,0,0,1,1,0,4,16,0,6,6,2,0,1,-1,1,1,-1,1,1
KR_6777742761,420,4,57,-1,5,1,3,2,-1,0,1,-2,5,7,7,7,0,0,0,0,0,7,-13,0,6,6,4,0,0,1,-1,1,1,1,1
KR_6745406121,420,3,18,31,8,3,3,0,2,3,1,3,3,0,-1,3,4,1,1,0,-2,19,2,-2,5,3,3,0,2,1,1,1,-1,1,1
KR_6746287430,420,2,-21,12,8,-2,1,3,7,8,1,3,3,0,0,4,4,0,0,0,0,13,-22,0,7,7,4,0,1,1,1,1,1,6,1
KR_6712757813,420,1,-25,15,0,0,2,2,-1,1,2,3,3,0,0,1,1,-2,0,2,0,-2,-27,1,7,8,-5,0,0,1,1,0,-1,1,1
KR_6729419637,420,3,-10,-12,11,0,2,2,1,2,1,7,7,0,1,4,3,2,2,0,0,12,-21,7,4,11,0,0,2,1,1,1,1,3,1
KR_6742168773,420,2,56,2,3,7,7,0,0,4,4,1,2,1,-3,1,4,-2,0,2,0,3,43,4,4,8,-2,0,2,1,1,1,1,2,1
KR_6705178507,420,2,-8,19,6,3,3,0,1,1,0,3,3,0,-3,2,5,2,3,1,0,6,-5,-1,6,5,0,0,0,-1,1,1,-1,1,1
KR_6733970732,420,2,36,-11,15,-2,0,2,3,6,3,0,2,2,14,14,0,0,2,2,0,25,13,1,8,9,3,0,0,1,1,1,-1,1,1
KR_6760829795,420,-1,19,-28,-3,2,3,1,1,4,3,-2,2,4,-5,0,5,1,1,0,0,-8,102,3,3,6,0,0,0,-1,1,1,1,1,1
KR_6776403356,420,2,7,4,1,1,3,2,3,3,0,-3,1,4,0,2,2,0,0,0,0,-2,9,-1,7,6,-2,0,1,1,-1,-1,1,1,1
KR_6760849942,440,-1,1,-30,10,4,5,1,-2,1,3,0,2,2,11,11,0,-3,0,3,0,8,-3,0,2,2,4,0,1,1,1,1,-1,4,1
KR_6765643433,420,2,70,-1,4,-2,1,3,0,2,2,1,1,0,3,4,1,2,2,0,0,11,43,1,5,6,-11,0,0,-1,-1,-1,1,3,1
KR_6753167948,420,2,18,-10,10,-1,0,1,10,11,1,1,2,1,2,6,4,-2,0,2,1,15,31,2,5,7,3,0,0,1,1,-1,1,6,1
KR_6727347375,440,2,86,-19,6,-1,1,2,0,5,5,1,2,1,0,2,2,6,7,1,0,5,5,-1,8,7,0,0,-1,1,-1,-1,1,4,1
KR_6773896620,440,1,-7,16,4,-1,2,3,-2,0,2,6,6,0,1,2,1,0,0,0,0,3,9,-2,6,4,2,0,1,1,1,1,-1,3,1
KR_6772870864,420,3,-16,21,1,0,1,1,-4,1,5,8,10,2,-3,3,6,0,0,0,0,-8,-31,-2,9,7,4,0,1,0,1,1,1,0,1
KR_6776660755,440,1,-36,-36,6,-1,1,2,6,8,2,0,4,4,1,1,0,0,0,0,0,15,2,1,6,7,0,0,1,-1,1,-1,-1,4,1
KR_6723859021,420,3,41,33,5,3,3,0,0,3,3,1,5,4,2,4,2,-1,1,2,0,-1,33,0,9,9,-7,0,0,0,1,1,1,0,1
KR_6764597675,440,3,57,35,7,-2,0,2,1,3,2,7,9,2,0,2,2,1,1,0,0,3,-2,-2,4,2,4,0,0,-1,1,1,-1,3,1
KR_6709845994,420,1,52,3,9,-1,1,2,5,8,3,5,5,0,0,1,1,0,0,0,0,12,-1,-2,6,4,4,0,1,1,-1,1,1,2,1
KR_6749264969,440,2,-2,-28,13,-1,0,1,4,4,0,3,7,4,7,9,2,0,0,0,0,20,14,5,3,8,-1,0,1,0,0,1,1,0,1
KR_6761197233,420,5,86,9,5,1,5,4,2,4,2,0,2,2,1,5,4,1,1,0,-1,-1,6,-5,11,6,-1,0,2,-1,1,1,-1,5,1
KR_6679489048,420,7,117,-15,20,9,9,0,2,3,1,4,4,0,5,6,1,0,0,0,0,24,1,2,4,6,6,0,0,1,-1,1,1,1,1
KR_6708022876,420,4,78,20,7,5,7,2,-4,3,7,1,1,0,4,4,0,1,1,0,0,2,3,-4,7,3,2,0,2,-1,-1,1,1,6,1
KR_6698018892,420,3,1,-14,6,3,3,0,6,7,1,0,3,3,0,5,5,-3,0,3,0,-2,56,1,4,5,0,0,2,-1,1,1,-1,3,1
KR_6773482391,420,1,-11,-9,-2,-3,1,4,5,6,1,-3,7,10,-2,4,6,1,3,2,0,2,-9,0,7,7,8,0,0,-1,-1,1,-1,1,1
KR_6776439328,420,5,36,23,16,0,1,1,5,5,0,4,5,1,7,7,0,0,1,1,0,22,0,3,5,8,5,0,3,1,1,1,1,6,1
KR_6741070963,420,1,-6,-24,7,5,6,1,2,3,1,-1,0,1,3,6,3,-2,0,2,0,6,7,5,5,10,1,0,1,-1,1,1,1,5,1
KR_6765828451,420,-2,-83,-9,-7,-2,2,4,1,3,2,-4,1,5,-5,2,7,3,3,0,0,-2,4,-3,7,4,0,0,-2,1,-1,-1,-1,4,1
KR_6761885578,420,1,-11,7,-2,-1,3,4,2,4,2,2,2,0,-5,1,6,0,2,2,0,-2,12,0,5,5,-7,0,0,-1,1,-1,1,3,1
KR_6743732361,420,1,18,-14,5,0,2,2,7,9,2,0,1,1,1,5,4,-3,3,6,0,7,3,4,3,7,2,0,-1,1,1,-1,1,6,1
KR_6745573417,420,1,-23,-12,5,1,1,0,2,5,3,2,3,1,-1,3,4,1,2,1,0,10,0,8,5,13,-4,0,0,1,1,1,1,3,1
KR_6754201300,420,1,32,4,4,0,1,1,2,4,2,3,7,4,-2,3,5,1,1,0,0,-1,0,-3,8,5,0,0,2,1,1,1,1,4,1
KR_6761908601,420,-2,-31,-13,-10,-2,1,3,-4,2,6,3,4,1,-5,1,6,-2,0,2,0,-12,-1,-2,6,4,-2,0,0,-1,1,-1,-1,1,1
KR_6743567246,420,2,43,8,3,5,6,1,-2,2,4,-2,3,5,-2,0,2,4,5,1,0,-3,1,0,6,6,7,0,0,-1,-1,-1,1,5,1
KR_6761532442,440,3,87,8,1,1,4,3,0,1,1,0,1,1,-1,2,3,1,4,3,0,6,3,-2,5,3,-1,0,1,1,1,1,1,4,1
KR_6776791279,420,-1,26,-11,3,1,3,2,-1,6,7,-5,1,6,6,6,0,2,4,2,0,7,4,10,4,14,-1,0,-1,1,-1,-1,1,6,1
KR_6776223565,420,6,111,43,12,2,4,2,-2,6,8,5,7,2,4,6,2,3,3,0,0,8,-42,2,4,6,0,0,2,1,-1,1,1,1,1
KR_6776062906,420,0,27,7,-1,-1,4,5,-1,2,3,-5,2,7,3,4,1,3,4,1,-1,-15,-21,2,9,11,-7,0,0,1,1,0,1,3,1
KR_6768766466,420,2,51,23,-1,2,2,0,2,3,1,-1,2,3,-1,2,3,-3,1,4,-1,-7,5,6,4,10,-2,0,1,1,-1,1,-1,3,1
KR_6769461959,420,1,35,-15,-1,1,1,0,1,2,1,-3,1,4,1,1,0,-1,0,1,0,2,1,0,5,5,0,0,0,1,-1,0,-1,1,1
KR_6769819585,440,2,-8,-16,1,-1,0,1,0,2,2,4,6,2,0,4,4,-2,0,2,1,-5,10,2,1,3,-25,0,1,0,-1,1,1,0,1
KR_6773829456,420,1,-10,-11,14,3,3,0,4,4,0,2,3,1,5,5,0,0,1,1,2,20,26,2,8,10,-3,0,0,1,-1,0,1,4,1
KR_6770092270,440,4,-15,25,7,-2,3,5,4,6,2,0,3,3,2,3,1,3,5,2,0,7,5,1,6,7,2,0,-2,1,1,1,-1,4,1
KR_6775048382,420,4,63,29,3,0,1,1,2,3,1,1,1,0,-1,1,2,1,1,0,1,8,4,5,4,9,2,0,1,1,-1,-1,1,4,1
KR_6689786088,420,1,10,-12,-1,-2,0,2,-2,2,4,1,1,0,3,3,0,-1,0,1,0,4,-27,-2,7,5,1,0,0,1,-1,-1,-1,4,1
KR_6740687047,420,3,66,22,3,1,3,2,1,2,1,-4,3,7,2,3,1,3,4,1,0,-2,-18,-1,6,5,-2,0,1,1,1,1,1,2,1
KR_6749441436,420,1,18,-3,5,-2,1,3,1,2,1,8,9,1,-1,0,1,-1,1,2,0,6,-18,6,3,9,1,0,1,1,1,1,1,3,1
KR_6773645462,420,4,42,19,9,-2,0,2,-3,0,3,8,8,0,4,5,1,2,2,0,0,27,-7,1,4,5,0,0,2,1,-1,1,1,1,1
KR_6775468974,420,2,-10,-16,4,-1,2,3,2,5,3,1,4,3,2,6,4,0,0,0,1,3,-8,-5,11,6,-1,0,1,-1,1,1,-1,1,1
KR_6744651005,420,2,-8,-28,6,-1,2,3,1,5,4,2,3,1,1,5,4,3,4,1,0,3,-1,1,6,7,-1,0,-1,1,-1,-1,1,1,1
KR_6774751809,420,-4,-110,1,0,-4,0,4,0,3,3,3,3,0,0,3,3,1,2,1,-1,0,15,3,6,9,2,0,-3,1,-1,-1,-1,3,1
KR_6764170421,420,2,-61,27,2,-2,0,2,1,2,1,-1,1,2,2,5,3,2,3,1,0,5,8,3,5,8,3,0,0,1,1,0,1,1,1
KR_6741375783,420,0,48,-33,-1,-1,1,2,-2,1,3,-1,3,4,2,2,0,1,1,0,1,0,14,1,6,7,2,0,1,-1,-1,1,1,6,1
KR_6769785258,420,-1,5,-7,-4,-4,1,5,-1,1,2,0,1,1,1,2,1,0,0,0,0,1,4,0,2,2,1,0,0,1,-1,0,-1,1,1
KR_6733046534,420,1,-3,1,-3,0,2,2,3,4,1,-3,1,4,-3,2,5,0,1,1,0,-10,6,-5,10,5,1,0,2,1,1,1,1,3,1
KR_6728140700,420,2,-2,-9,-1,3,4,1,1,2,1,1,4,3,-4,0,4,-2,0,2,0,-9,5,0,8,8,-5,0,0,-1,1,1,-1,4,1
KR_6762617183,420,3,55,2,2,5,5,0,0,1,1,0,3,3,-3,0,3,0,1,1,0,-7,-22,-4,8,4,3,0,1,-1,1,1,-1,4,1
KR_6744600701,420,3,99,22,15,3,3,0,3,5,2,6,6,0,3,3,0,0,1,1,0,15,125,4,6,10,-2,0,3,1,1,1,1,4,1
KR_6697217491,420,2,32,0,2,2,2,0,2,6,4,0,2,2,0,1,1,-2,2,4,0,2,-11,-4,7,3,3,0,0,-1,-1,-1,-1,1,1
KR_6776620452,420,3,82,21,2,3,3,0,1,2,1,-1,0,1,-1,2,3,0,2,2,0,-5,29,0,7,7,-4,0,1,-1,1,1,1,4,1
KR_6734869765,420,0,17,-18,8,2,2,0,-1,1,2,2,3,1,2,3,1,3,3,0,0,6,-32,4,4,8,4,0,0,1,-1,0,1,2,1
KR_6726262626,420,2,3,-16,5,2,3,1,1,5,4,0,0,0,0,1,1,2,3,1,0,-1,-23,4,4,8,5,0,1,-1,1,-1,-1,5,1
KR_6748015305,440,5,37,-17,9,4,4,0,0,2,2,-1,0,1,6,6,0,0,0,0,0,14,12,-1,4,3,-1,0,0,-1,0,1,-1,2,1
KR_6743238152,420,-1,-18,-11,2,1,1,0,2,4,2,2,3,1,-3,3,6,0,0,0,0,-3,-10,2,4,6,1,0,0,1,-1,0,-1,1,1
KR_6764613408,420,0,74,-3,-2,-5,0,5,3,3,0,-1,2,3,0,1,1,1,1,0,0,-1,107,0,6,6,5,0,-1,1,-1,-1,-1,1,1
KR_6747356982,420,1,67,-9,1,1,2,1,-2,4,6,0,3,3,-2,0,2,4,4,0,0,-1,-161,1,5,6,6,0,3,1,-1,1,1,4,1
KR_6766364164,420,3,71,4,9,6,6,0,4,5,1,0,0,0,0,1,1,-1,0,1,0,7,-1,3,6,9,5,0,4,-1,1,1,1,6,1
KR_6746171423,420,2,27,-19,7,-2,1,3,-1,0,1,-2,2,4,2,5,3,10,10,0,1,12,10,2,6,8,-3,0,0,-1,-1,1,1,6,1
KR_6739534436,440,1,-14,0,3,1,4,3,1,4,3,-1,2,3,0,3,3,2,3,1,0,1,7,3,3,6,3,0,1,-1,-1,1,1,6,1
KR_6774890019,420,-1,-17,-7,5,-3,1,4,1,4,3,-1,3,4,7,8,1,1,2,1,0,11,10,3,5,8,-7,0,1,-1,-1,1,1,4,1
KR_6745334001,420,-3,-64,-19,1,2,5,3,0,4,4,2,3,1,-3,0,3,0,0,0,0,-2,-27,7,5,12,7,0,1,1,1,1,-1,6,1
KR_6772932512,420,4,-24,10,13,2,3,1,6,6,0,-3,1,4,5,8,3,3,6,3,0,12,16,1,4,5,1,0,1,1,-1,1,-1,4,1
KR_6776478101,420,4,119,12,4,-1,1,2,-3,4,7,4,4,0,3,3,0,1,2,1,0,4,-19,-1,6,5,1,0,1,1,-1,1,1,4,1
KR_6729913284,440,0,14,32,-7,1,2,1,-1,0,1,-2,0,2,-4,5,9,-1,1,2,0,-9,55,-1,9,8,-31,0,-1,-1,-1,-1,-1,2,1
KR_6775818245,420,1,18,-21,6,3,3,0,2,4,2,-5,1,6,3,7,4,3,3,0,0,6,-42,-1,7,6,0,0,0,-1,-1,0,1,4,1
KR_6775775502,420,-1,8,-21,6,-2,0,2,1,3,2,2,3,1,2,2,0,3,3,0,1,9,5,3,7,10,5,0,2,1,1,1,1,2,1
KR_6775969531,420,1,42,29,-3,-1,1,2,-1,2,3,0,1,1,-1,1,2,0,1,1,0,-9,13,1,5,6,-7,0,0,-1,1,0,-1,2,1
KR_6776877708,420,-2,37,-13,-8,1,1,0,-4,1,5,-1,2,3,-4,1,5,0,0,0,0,-15,-20,-5,10,5,2,0,-2,-1,-1,-1,-1,1,1
KR_6776370601,420,1,45,27,0,1,3,2,-3,0,3,3,4,1,-2,0,2,1,1,0,0,-6,6,4,4,8,-3,0,0,1,1,1,1,5,1
KR_6753536343,420,-1,16,5,5,3,3,0,1,3,2,1,2,1,-2,2,4,2,2,0,0,8,10,0,9,9,-6,0,0,1,-1,-1,-1,4,1
KR_6745339606,420,-2,29,-14,-4,-1,0,1,-1,1,2,-3,0,3,2,2,0,-1,0,1,0,-6,-14,-1,6,5,2,0,0,-1,-1,0,1,3,1
KR_6770638019,420,2,-25,38,0,-2,1,3,1,5,4,-2,5,7,1,3,2,2,3,1,0,1,-1,-2,7,5,3,0,0,1,-1,0,1,3,1
KR_6777104171,420,-1,11,-9,-1,3,5,2,-3,1,4,-2,0,2,0,1,1,1,1,0,0,1,-4,-3,9,6,-1,0,0,-1,1,1,-1,4,1
KR_6755549133,420,2,60,7,9,1,1,0,1,4,3,5,6,1,2,2,0,0,1,1,1,10,-30,0,8,8,2,0,1,1,1,1,1,5,1
KR_6775684472,420,0,29,-12,4,0,1,1,0,2,2,1,2,1,3,4,1,0,0,0,0,7,-35,6,3,9,-2,0,1,1,-1,1,-1,1,1
KR_6754984645,420,1,-9,9,3,2,2,0,-1,3,4,-1,2,3,2,4,2,1,1,0,0,1,-8,-3,10,7,-2,0,0,1,-1,1,1,5,1
KR_6772317230,420,5,22,36,5,-3,0,3,5,6,1,0,4,4,2,3,1,1,1,0,-1,15,2,-3,6,3,5,0,1,1,1,1,-1,2,1
KR_6745873244,420,1,9,4,1,-2,1,3,-1,2,3,1,4,3,2,3,1,1,3,2,2,7,-11,-6,8,2,0,0,-1,-1,-1,-1,1,4,1
KR_6736079138,420,3,6,28,9,2,4,2,4,5,1,-3,0,3,8,11,3,-2,0,2,0,4,12,2,6,8,-1,0,3,1,1,1,1,2,1
KR_6773116757,420,1,33,3,8,11,12,1,-4,4,8,1,2,1,0,1,1,0,1,1,0,-1,3,3,4,7,3,0,0,-1,1,1,1,5,1
KR_6750734367,420,2,-13,-14,2,5,5,0,1,3,2,-3,1,4,0,2,2,-1,0,1,0,0,5,-3,9,6,-1,0,0,0,0,1,1,0,1
KR_6776197049,440,0,-5,3,1,4,5,1,-1,1,2,2,2,0,-5,0,5,1,1,0,0,-2,49,4,4,8,-4,0,0,-1,-1,0,-1,3,1
KR_6773901999,420,3,26,-2,3,4,5,1,2,5,3,1,2,1,-3,3,6,-1,0,1,0,-4,311,1,5,6,4,0,-1,-1,-1,-1,1,3,1
KR_6773402914,420,0,-49,-9,0,-1,1,2,1,3,2,0,2,2,-2,2,4,2,2,0,0,-4,-7,-3,8,5,-4,0,0,1,-1,-1,1,4,1
KR_6754619668,420,1,21,6,5,1,2,1,1,2,1,2,2,0,2,3,1,-1,0,1,1,4,-4,3,6,9,-1,0,1,1,-1,1,1,5,1
KR_6765572175,420,4,99,5,13,1,1,0,5,5,0,1,2,1,5,6,1,1,1,0,0,17,3,-6,13,7,4,0,1,1,1,1,1,1,1
KR_6698017200,420,5,33,-3,17,0,1,1,2,3,1,5,7,2,10,11,1,0,0,0,-1,20,22,1,5,6,3,0,1,1,0,1,-1,4,1
KR_6776116880,420,3,26,10,9,2,3,1,-1,0,1,3,5,2,3,3,0,2,2,0,0,11,-26,5,2,7,2,0,1,-1,1,1,-1,5,1
KR_6760450321,440,1,-14,-19,0,-2,4,6,1,3,2,3,4,1,-4,3,7,2,3,1,0,4,-20,-3,7,4,0,0,-1,1,-1,-1,-1,5,1
KR_6771734315,420,2,-6,0,7,2,2,0,0,1,1,2,6,4,3,4,1,0,0,0,0,7,131,-1,10,9,-6,0,1,-1,1,1,-1,5,1
KR_6765972432,420,-1,8,-14,-4,-2,0,2,-2,3,5,1,6,5,-2,2,4,1,1,0,0,-1,124,-2,6,4,-3,0,0,-1,0,0,-1,4,1
KR_6744759412,420,-1,-7,13,-2,-5,0,5,-3,3,6,3,3,0,3,4,1,0,2,2,0,10,-94,1,4,5,-2,0,0,1,-1,0,1,1,1
KR_6777565181,420,1,76,-21,8,-2,1,3,2,4,2,-3,1,4,5,6,1,6,6,0,2,9,15,4,2,6,8,0,3,-1,1,1,1,3,1
KR_6750561963,420,2,4,-19,2,2,3,1,2,3,1,-4,1,5,1,3,2,1,1,0,0,3,31,-5,8,3,-3,0,0,-1,1,1,-1,3,1
KR_6754630467,420,4,40,24,10,0,1,1,7,7,0,3,6,3,1,2,1,-1,1,2,0,14,19,3,7,10,0,0,1,1,1,1,1,4,1
KR_6776866452,420,5,37,23,12,1,3,2,3,5,2,0,2,2,8,8,0,0,2,2,0,20,27,9,5,14,-2,0,2,1,1,1,-1,4,1
KR_6743302327,420,-1,49,-24,0,0,3,3,3,4,1,-3,0,3,-1,2,3,1,2,1,0,-1,-9,4,5,9,-1,0,-1,1,-1,-1,1,4,1
KR_6737364677,420,3,56,-20,8,0,2,2,5,6,1,1,3,2,2,4,2,0,0,0,1,12,-174,1,4,5,30,0,0,1,-1,0,1,1,1
KR_6776294817,420,6,79,40,18,6,8,2,5,5,0,2,2,0,2,3,1,3,3,0,0,12,13,-2,9,7,2,0,3,1,1,1,1,4,1
KR_6775771368,420,4,63,5,2,1,2,1,-3,2,5,1,5,4,3,6,3,0,4,4,0,-3,-163,0,9,9,2,0,-1,-1,-1,-1,-1,6,1
KR_6741920666,420,-2,-40,-25,-12,1,2,1,-5,2,7,-1,3,4,-2,1,3,-5,0,5,-1,-15,-36,-1,9,8,0,0,-1,-1,1,-1,-1,6,1
KR_6751289921,420,4,49,21,8,-1,0,1,3,5,2,3,3,0,3,5,2,0,0,0,0,14,4,1,5,6,-1,0,1,1,1,1,1,5,1
KR_6733003422,420,2,-5,6,8,3,3,0,0,3,3,-1,4,5,4,6,2,2,2,0,0,8,-1,2,1,3,3,0,1,1,1,1,-1,2,1
KR_6772874836,440,1,41,10,-2,-1,1,2,0,2,2,-1,2,3,2,3,1,-2,0,2,0,-3,-2,-4,6,2,4,0,0,1,-1,-1,-1,3,1
KR_6774142160,420,4,25,-6,9,7,7,0,7,8,1,-3,0,3,0,1,1,-2,0,2,0,1,16,3,5,8,-4,0,2,-1,1,1,-1,4,1
KR_6760775928,420,0,22,56,2,1,4,3,4,8,4,1,2,1,2,4,2,-6,1,7,0,1,-1,3,3,6,-1,0,0,-1,1,1,1,2,1
KR_6742951138,420,5,6,0,6,-3,1,4,2,5,3,4,6,2,2,3,1,1,2,1,1,2,-27,0,11,11,-4,0,1,1,1,1,1,4,1
KR_6769660599,420,3,40,11,12,5,5,0,3,6,3,-1,0,1,4,5,1,1,2,1,3,12,-10,-2,8,6,9,0,1,1,-1,1,-1,4,1
KR_6702567903,420,1,25,-11,2,3,6,3,-2,3,5,4,4,0,-5,0,5,2,3,1,0,-4,-6,-3,11,8,-1,0,1,-1,1,1,1,6,1
KR_6773019228,420,2,23,19,5,-1,1,2,3,8,5,1,4,3,0,4,4,2,2,0,0,11,-6,-1,8,7,5,0,0,0,-1,0,-1,0,1
KR_6766739101,440,2,8,0,8,3,3,0,6,8,2,0,1,1,-1,2,3,0,3,3,-1,7,6,-3,5,2,-2,0,1,-1,-1,1,-1,4,1
KR_6772787741,420,-4,-70,4,-8,0,2,2,-7,1,8,-1,3,4,-2,1,3,2,2,0,0,-6,240,-4,6,2,-2,0,0,-1,1,0,1,3,1
KR_6701671298,420,0,-16,-23,3,1,2,1,1,3,2,1,3,2,-1,0,1,1,1,0,0,8,-29,-1,10,9,1,0,0,1,-1,-1,1,4,1
KR_6772806342,420,0,-53,-8,-3,-2,1,3,-1,2,3,-1,0,1,1,1,0,0,0,0,0,-2,31,-5,8,3,2,0,-1,1,-1,-1,1,6,1
KR_6775878572,420,1,13,5,8,-2,1,3,0,3,3,1,4,3,7,8,1,2,4,2,0,14,16,5,5,10,4,0,2,1,1,1,1,3,1
KR_6776877592,420,1,-7,-4,6,-3,1,4,2,5,3,0,1,1,6,6,0,1,3,2,1,12,-35,5,6,11,2,0,2,1,-1,1,-1,2,1
KR_6756058733,440,-1,0,18,-5,-1,3,4,-2,0,2,0,2,2,3,3,0,-5,1,6,-1,-3,-4,2,1,3,-1,0,-1,1,-1,-1,-1,3,1
KR_6706178403,420,3,15,-12,5,-4,0,4,7,9,2,2,3,1,-1,1,2,1,2,1,0,9,40,4,4,8,4,0,1,-1,1,1,-1,6,1
KR_6772519397,420,1,-9,-2,10,0,2,2,-2,3,5,5,5,0,5,6,1,2,2,0,1,13,-67,6,2,8,16,0,0,1,-1,1,1,5,1
KR_6771882701,420,3,2,25,6,3,5,2,4,6,2,-2,0,2,1,3,2,0,1,1,-1,-1,-3,3,3,6,3,0,1,1,1,1,-1,2,1
KR_6760489510,420,3,38,35,5,-1,1,2,-1,2,3,5,7,2,1,4,3,1,1,0,0,8,0,1,5,6,1,0,2,1,1,1,1,6,1
KR_6772311459,420,0,1,-9,-6,1,2,1,5,6,1,-4,2,6,-5,0,5,-3,0,3,0,-3,-12,0,6,6,2,0,1,-1,1,1,-1,6,1
KR_6764141121,420,2,-29,-12,9,4,5,1,3,7,4,0,2,2,2,2,0,0,1,1,0,14,1,-2,8,6,2,0,0,1,-1,1,1,6,1
KR_6730830512,440,4,34,48,7,-4,1,5,0,5,5,0,0,0,12,15,3,-1,2,3,-1,11,-18,2,3,5,-2,0,1,1,-1,1,-1,2,1
KR_6738377220,420,5,63,5,7,2,3,1,-1,3,4,6,6,0,-2,2,4,2,2,0,0,4,134,-1,9,8,4,0,0,-1,-1,1,1,5,1
KR_6736858123,420,0,16,0,-6,-4,0,4,0,6,6,-4,0,4,1,5,4,1,1,0,0,-7,-13,1,8,9,2,0,0,-1,-1,0,1,2,1
KR_6769254857,420,2,52,8,3,0,1,1,0,3,3,7,7,0,-4,1,5,0,0,0,0,8,-3,0,7,7,10,0,-1,-1,-1,-1,-1,6,1
KR_6776841693,420,2,-13,-8,13,3,3,0,0,1,1,4,4,0,3,5,2,3,3,0,4,18,-37,-1,9,8,30,0,0,1,-1,1,1,4,1
KR_6753990691,420,0,-44,17,0,1,2,1,2,3,1,3,3,0,-4,1,5,-2,1,3,0,7,29,-6,11,5,7,0,-1,1,1,-1,1,6,1
KR_6692148290,420,-2,35,-5,-5,0,4,4,-8,1,9,0,1,1,1,5,4,2,2,0,1,-2,-32,1,7,8,0,0,1,-1,-1,1,1,5,1
KR_6755850398,420,5,118,27,15,2,5,3,1,2,1,1,2,1,7,8,1,4,4,0,0,17,10,-1,5,4,7,0,3,1,1,1,1,2,1
KR_6774020114,440,2,80,1,6,-1,4,5,3,3,0,0,1,1,1,1,0,3,4,1,0,0,19,3,4,7,-1,0,2,-1,1,1,1,1,1
KR_6764165906,420,4,23,2,10,0,2,2,4,6,2,2,5,3,2,2,0,2,3,1,0,20,31,-8,13,5,4,0,1,1,1,1,1,2,1
KR_6732942371,440,1,9,14,0,3,5,2,-3,4,7,-1,2,3,0,2,2,1,3,2,0,-7,7,-2,8,6,4,0,0,1,-1,1,1,6,1
KR_6775296091,420,2,30,-3,4,4,5,1,0,1,1,1,6,5,2,4,2,-3,0,3,-1,6,0,0,9,9,0,0,0,1,-1,-1,-1,6,1
KR_6776561984,420,3,82,27,4,-3,0,3,3,4,1,2,4,2,1,1,0,1,1,0,0,8,2,2,2,4,4,0,2,1,1,1,1,1,1
KR_6737312273,420,-4,-24,-14,-4,-7,2,9,6,7,1,-1,2,3,-2,3,5,0,0,0,0,-7,-6,-1,8,7,1,0,1,-1,1,1,-1,2,1
KR_6771062875,420,3,40,-12,5,5,6,1,2,4,2,4,7,3,-1,1,2,-5,0,5,0,-4,17,7,1,8,-4,0,3,-1,1,1,1,2,1
KR_6773483749,440,2,86,8,13,6,6,0,3,3,0,0,3,3,6,8,2,-2,1,3,2,11,9,0,7,7,6,0,0,1,1,1,1,2,1
KR_6716578438,420,1,-8,-4,7,7,7,0,-5,0,5,1,5,4,1,4,3,3,3,0,0,-3,89,3,1,4,-2,0,2,-1,1,1,1,5,1
KR_6775643291,420,6,92,32,10,-1,1,2,-1,3,4,2,2,0,10,11,1,0,0,0,0,12,-31,6,2,8,0,0,3,1,1,1,1,1,1
KR_6775977115,420,-1,-31,18,1,7,8,1,1,5,4,-3,2,5,-2,2,4,-2,2,4,-1,-3,-1,3,3,6,1,0,0,-1,1,0,-1,6,1
KR_6746350702,420,3,61,10,3,-2,4,6,1,2,1,-2,0,2,6,7,1,0,1,1,1,7,8,-5,11,6,-3,0,2,1,-1,1,1,5,1
KR_6742305307,420,4,87,20,13,1,3,2,5,8,3,1,2,1,6,9,3,0,0,0,0,11,-5,-4,11,7,-2,0,0,1,-1,1,1,2,1
KR_6771114567,420,0,-34,-2,6,-1,1,2,1,4,3,-3,1,4,8,10,2,1,1,0,3,11,3,1,3,4,-5,0,-2,1,-1,-1,1,3,1
KR_6776744683,420,-2,-18,4,-2,-2,1,3,8,9,1,-1,0,1,-6,2,8,-1,0,1,0,-9,1,3,5,8,-2,0,-2,-1,1,-1,1,5,1
KR_6777859072,420,1,3,33,-2,2,3,1,-3,2,5,1,3,2,-2,3,5,0,0,0,0,-2,15,4,2,6,-10,0,1,1,1,1,-1,4,1
KR_6737317000,420,3,-50,-16,13,-3,0,3,-1,3,4,10,12,2,2,5,3,5,5,0,1,24,9,1,6,7,-5,0,1,-1,1,1,1,1,1
KR_6724832832,420,2,-18,-24,4,2,2,0,0,3,3,2,8,6,0,2,2,0,3,3,0,3,13,9,2,11,-7,0,1,1,1,1,1,2,1
KR_6762346394,420,3,44,-1,1,-1,1,2,3,3,0,2,3,1,-3,3,6,0,0,0,0,8,13,3,3,6,0,0,0,1,-1,-1,1,6,1
KR_6739091311,420,-4,-43,-35,-4,1,2,1,4,5,1,-2,2,4,-8,0,8,1,1,0,0,-9,-1,2,7,9,-4,0,0,-1,1,1,1,1,1
KR_6721143998,420,1,-4,13,2,-5,0,5,8,9,1,-1,3,4,-2,1,3,2,3,1,0,1,49,3,4,7,-35,0,0,1,1,0,1,6,1
KR_6763660021,420,-2,-34,12,0,-1,1,2,-4,1,5,-2,0,2,6,6,0,1,1,0,0,-4,3,-1,6,5,-2,0,1,1,1,1,-1,6,1
KR_6740496363,420,4,59,-12,10,0,1,1,0,1,1,4,6,2,3,4,1,3,4,1,1,28,13,1,3,4,1,0,2,1,-1,1,1,5,1
KR_6776294439,420,9,55,32,20,-1,1,2,2,2,0,11,14,3,7,8,1,1,1,0,1,26,13,8,4,12,0,0,4,1,1,1,1,5,1
KR_6773287903,420,0,-58,29,2,-3,4,7,1,3,2,-1,0,1,6,6,0,-1,0,1,0,0,7,5,3,8,-3,0,0,1,1,0,-1,2,1
KR_6734348646,420,7,65,3,13,2,2,0,6,7,1,4,6,2,-1,1,2,2,2,0,1,18,-32,0,8,8,20,0,3,1,-1,1,1,6,1
KR_6775761546,420,1,22,6,0,-2,0,2,1,4,3,1,2,1,-1,3,4,1,1,0,0,3,18,-1,7,6,4,0,0,-1,-1,1,1,6,1
KR_6777212984,420,2,11,23,3,2,5,3,-5,0,5,3,5,2,3,4,1,0,0,0,-1,8,0,-3,11,8,-1,0,1,1,1,1,-1,4,1
KR_6693585637,420,1,-6,-13,6,0,1,1,-4,2,6,4,5,1,7,7,0,-1,1,2,0,3,-44,1,5,6,4,0,0,1,1,-1,-1,3,1
KR_6766076019,440,3,111,-21,7,3,3,0,0,2,2,4,6,2,1,3,2,-1,2,3,2,4,4,0,5,5,4,0,2,-1,1,1,1,4,1
KR_6772054424,420,1,-6,5,-4,-4,1,5,2,4,2,-1,3,4,-1,3,4,0,2,2,1,1,1,-4,8,4,3,0,1,1,-1,1,1,5,1
KR_6762858536,420,3,-18,-4,6,-2,2,4,-1,2,3,4,4,0,3,4,1,2,2,0,0,13,3,-2,6,4,2,0,0,1,1,0,-1,2,1
KR_6706786049,420,6,53,4,11,1,2,1,5,6,1,2,3,1,2,2,0,1,2,1,0,13,7,4,5,9,0,0,2,1,1,1,-1,4,1
KR_6730009945,420,2,-2,32,6,2,2,0,0,5,5,2,6,4,5,5,0,-3,0,3,0,5,31,2,6,8,0,0,2,1,1,1,-1,4,1
KR_6736358120,420,3,36,53,8,4,5,1,-1,1,2,5,6,1,1,1,0,-1,1,2,-1,5,29,1,4,5,1,0,1,1,1,1,-1,1,1
KR_6745121392,420,1,75,24,-3,2,3,1,-2,1,3,-2,0,2,-1,0,1,0,2,2,0,-11,2,-2,6,4,-2,0,1,-1,1,1,1,2,1
KR_6714880957,420,2,34,27,-2,0,1,1,1,2,1,1,4,3,-2,2,4,-2,0,2,1,1,-4,-1,9,8,7,0,0,1,-1,-1,1,3,1
KR_6722984013,420,3,-5,-14,8,0,2,2,9,10,1,1,2,1,-1,7,8,-1,2,3,0,0,27,3,7,10,-21,0,1,1,1,1,-1,3,1
KR_6732968203,440,3,89,-16,7,3,3,0,-1,0,1,5,6,1,0,0,0,0,0,0,0,5,-3,-2,5,3,3,0,1,1,1,1,-1,6,1
KR_6774745516,420,-1,13,4,4,2,2,0,1,2,1,-1,0,1,2,3,1,0,0,0,0,5,-11,0,5,5,5,0,0,1,1,0,1,4,1
KR_6774282319,420,1,15,-9,-1,-1,0,1,-3,1,4,2,2,0,0,0,0,1,1,0,0,-3,2,3,5,8,2,0,2,1,1,1,1,3,1
KR_6742825626,420,3,91,15,7,-1,2,3,-1,2,3,3,3,0,1,2,1,5,9,4,0,5,-7,0,4,4,12,0,0,-1,1,1,-1,4,1
KR_6768797991,440,2,27,8,8,5,6,1,2,3,1,-3,2,5,2,2,0,2,5,3,0,13,4,-1,5,4,5,0,2,-1,-1,1,1,4,1
KR_6703505897,420,0,59,5,6,6,6,0,-3,4,7,1,4,3,2,2,0,0,0,0,0,7,-33,3,6,9,-1,0,1,1,1,1,1,5,1
KR_6741114364,420,0,-47,1,8,2,3,1,7,10,3,-1,3,4,-1,1,2,1,2,1,0,9,-2,-1,5,4,0,0,0,1,1,0,1,1,1
KR_6774421971,420,4,36,-24,8,2,3,1,5,6,1,0,2,2,0,6,6,1,1,0,0,16,-138,-2,6,4,2,0,0,0,1,0,1,0,1
KR_6776876645,420,4,65,28,3,-1,1,2,0,2,2,-3,0,3,6,8,2,1,2,1,-1,4,-1,1,7,8,2,0,2,1,0,1,-1,6,1
KR_6774650841,420,2,12,4,5,3,3,0,3,6,3,-1,2,3,3,4,1,-3,0,3,1,7,2,5,4,9,0,0,1,1,-1,-1,1,2,1
KR_6776376361,420,-3,-47,0,-7,1,3,2,2,3,1,-2,0,2,3,4,1,-11,0,11,0,-7,-9,-5,7,2,-2,0,0,1,-1,0,1,1,1
KR_6744471908,420,-1,27,-23,-1,4,5,1,0,4,4,-3,1,4,-3,0,3,1,1,0,1,-2,319,-1,6,5,-2,0,0,-1,1,1,1,1,1
KR_6775921883,420,3,2,45,2,1,1,0,5,8,3,0,1,1,-5,1,6,1,1,0,0,-7,9,-5,11,6,-1,0,-1,-1,-1,-1,-1,4,1
KR_6774307157,420,3,61,17,6,-2,3,5,5,8,3,0,1,1,3,3,0,0,2,2,0,12,-3,4,7,11,0,0,0,1,-1,-1,1,3,1
KR_6776767088,420,2,38,-20,4,1,1,0,4,5,1,-3,1,4,2,4,2,0,1,1,0,3,5,-4,9,5,0,0,1,1,-1,1,-1,3,1
KR_6773634712,420,0,-1,35,0,-1,3,4,3,6,3,-2,2,4,2,3,1,-2,0,2,0,6,12,0,5,5,-3,0,1,-1,1,1,-1,3,1
KR_6734025403,420,5,23,9,14,0,0,0,6,7,1,1,3,2,3,5,2,4,4,0,0,23,15,-1,8,7,-3,0,0,-1,-1,-1,1,2,1
KR_6771770329,420,2,30,5,5,0,1,1,6,7,1,-2,1,3,2,3,1,-1,0,1,0,8,2,2,4,6,2,0,0,1,1,1,1,2,1
KR_6753239970,420,1,11,50,8,1,4,3,5,7,2,1,1,0,2,4,2,-1,0,1,0,17,35,3,6,9,-2,0,1,1,1,1,-1,2,1
KR_6773762303,420,3,65,3,4,3,4,1,2,3,1,3,3,0,-4,1,5,0,0,0,0,1,35,2,4,6,4,0,0,-1,-1,0,1,5,1
KR_6709095604,420,8,80,88,14,-1,1,2,3,5,2,4,4,0,7,9,2,1,1,0,1,19,6,-2,5,3,0,1,4,1,1,1,1,5,1
KR_6739550186,420,2,-7,13,2,2,4,2,-2,4,6,-1,1,2,2,3,1,1,2,1,0,9,5,2,4,6,-2,0,-1,-1,-1,-1,1,4,1
KR_6714857264,420,3,71,28,4,4,5,1,0,3,3,-2,1,3,3,3,0,-1,1,2,0,0,-1,-2,8,6,-6,0,1,-1,1,1,1,2,1
KR_6729750796,420,4,48,-16,10,1,3,2,1,4,3,6,7,1,3,4,1,-1,0,1,1,18,-15,-1,5,4,-7,0,1,1,-1,1,-1,6,1
KR_6775464594,420,4,26,6,14,1,3,2,6,9,3,0,1,1,6,6,0,1,1,0,0,9,16,4,5,9,0,0,1,1,-1,1,1,5,1
KR_6736609721,420,2,29,16,4,2,3,1,0,2,2,1,2,1,1,4,3,0,0,0,1,5,2,1,7,8,0,0,1,0,1,1,1,0,1
KR_6777193672,420,1,30,7,-2,3,5,2,-2,0,2,1,1,0,-6,0,6,2,2,0,0,-8,-15,-2,8,6,7,0,1,-1,1,1,-1,3,1
KR_6753999356,420,1,32,24,0,3,3,0,2,5,3,1,2,1,-5,0,5,-1,1,2,0,-5,38,3,5,8,-3,0,1,1,1,1,1,4,1
KR_6772266276,420,-1,-42,-7,-7,-7,1,8,1,3,2,2,4,2,-3,2,5,0,0,0,0,2,-5,-1,6,5,0,0,0,-1,1,0,1,2,1
KR_6714911897,420,1,-35,14,3,-1,1,2,2,4,2,-1,2,3,4,4,0,-1,3,4,0,4,14,6,2,8,-3,0,0,-1,1,1,1,3,1
KR_6704632091,420,-4,-19,-20,-9,-10,1,11,-5,0,5,2,4,2,1,5,4,3,4,1,0,-11,-7,-2,7,5,-1,0,-3,-1,-1,-1,-1,1,1
KR_6774743160,420,2,10,20,1,-3,1,4,2,3,1,2,3,1,2,5,3,-2,0,2,0,1,1,0,6,6,0,0,1,1,-1,1,1,3,1
KR_6777251928,420,2,1,-24,-2,-1,2,3,-4,2,6,0,2,2,2,4,2,1,1,0,0,2,-5,-1,7,6,-4,0,2,1,1,1,-1,6,1
KR_6774127476,420,0,28,-7,2,3,7,4,-2,3,5,2,8,6,-1,3,4,0,0,0,1,4,-9,-3,8,5,7,0,0,1,1,1,1,1,1
KR_6739704333,420,6,2,19,13,-2,0,2,7,7,0,2,2,0,4,7,3,2,5,3,0,20,-22,-2,10,8,4,0,3,1,1,1,1,4,1
KR_6740828910,420,4,-7,12,12,-3,0,3,4,7,3,6,6,0,4,4,0,1,2,1,0,13,14,5,6,11,0,0,0,1,1,1,1,4,1
KR_6773243649,420,0,-16,4,2,-4,0,4,3,6,3,4,6,2,1,3,2,-2,0,2,0,9,3,0,6,6,6,0,-1,1,-1,-1,-1,6,1
KR_6776908858,420,1,-61,4,-3,3,5,2,-4,1,5,-2,0,2,1,2,1,-1,1,2,0,-10,-11,-5,11,6,2,0,-2,-1,1,-1,-1,4,1
KR_6765344758,420,5,69,6,5,1,3,2,1,1,0,1,4,3,0,3,3,2,4,2,0,4,2,1,7,8,2,0,1,-1,1,1,-1,1,1
KR_6751702672,420,-2,-67,12,-11,-5,0,5,-2,5,7,-1,3,4,-4,1,5,1,1,0,0,-5,-7,0,6,6,0,0,1,-1,1,1,1,5,1
KR_6738234660,420,1,13,40,1,3,3,0,2,6,4,-3,0,3,-1,2,3,0,1,1,1,1,-100,-3,6,3,5,0,0,1,1,0,1,4,1
KR_6758838548,420,4,26,12,9,-2,1,3,2,3,1,0,2,2,5,7,2,4,4,0,0,10,4,-1,9,8,-2,0,2,1,-1,1,-1,3,1
KR_6761699324,420,0,15,26,-2,1,3,2,0,1,1,2,5,3,0,2,2,-5,0,5,0,4,20,1,8,9,0,0,-1,1,-1,1,1,6,1
KR_6761136066,420,-2,-86,7,-4,2,6,4,-4,2,6,2,3,1,-4,5,9,0,1,1,0,-7,-24,-4,11,7,1,0,-1,1,-1,-1,-1,3,1
KR_6729703853,440,2,-29,-2,8,8,8,0,-5,1,6,-2,2,4,4,5,1,3,3,0,-1,6,-24,-3,8,5,1,0,-1,-1,0,-1,-1,1,1
KR_6762073882,420,2,32,-11,6,-1,1,2,1,3,2,-2,1,3,7,8,1,1,1,0,0,17,-11,-1,7,6,7,0,-1,1,-1,-1,-1,1,1
KR_6736490011,420,0,50,5,-4,2,3,1,-4,2,6,1,2,1,-2,1,3,-1,1,2,0,-9,-168,-5,10,5,1,0,1,-1,1,1,-1,3,1
KR_6750347226,420,-3,-4,6,-4,-1,4,5,4,10,6,0,3,3,-1,2,3,-6,0,6,-1,-14,-18,-3,6,3,-2,0,-1,1,1,-1,-1,1,1
KR_6777204233,420,1,11,8,0,2,2,0,-1,1,2,0,3,3,-1,1,2,0,1,1,0,-6,3,4,4,8,-6,0,0,0,-1,0,-1,0,1
KR_6748574197,420,2,1,10,-4,1,4,3,-6,1,7,1,3,2,2,2,0,-2,0,2,0,-9,-40,0,3,3,3,0,-1,1,-1,-1,-1,2,1
KR_6710467489,420,1,87,-25,2,0,3,3,1,4,3,0,1,1,1,1,0,0,0,0,0,1,3,4,6,10,-3,0,1,1,1,1,1,4,1
KR_6776875875,420,3,38,19,5,3,5,2,1,2,1,0,2,2,1,2,1,0,1,1,-1,-1,-26,-3,11,8,-3,0,2,1,1,1,-1,2,1
KR_6769805618,420,1,22,-48,3,2,2,0,2,2,0,-3,0,3,2,3,1,0,0,0,0,7,12,0,6,6,1,0,0,-1,1,0,1,6,1
KR_6749121578,420,2,9,30,17,4,4,0,3,5,2,5,6,1,4,4,0,1,3,2,0,22,-34,4,3,7,16,0,1,1,1,1,1,5,1
KR_6771650537,440,1,6,4,-4,5,5,0,-2,0,2,-3,2,5,-3,0,3,-1,1,2,-1,-15,-10,-8,11,3,1,0,0,-1,1,0,-1,2,1
KR_6770332764,440,3,1,-12,10,0,1,1,0,6,6,3,5,2,1,5,4,6,7,1,1,14,-4,-6,9,3,1,0,1,1,1,1,1,4,1
KR_6776797006,420,2,-28,-11,3,1,2,1,6,6,0,-5,0,5,-1,2,3,2,3,1,0,3,-59,0,9,9,19,0,1,-1,-1,1,1,4,1
KR_6763461794,440,3,69,21,2,3,3,0,-2,1,3,0,2,2,1,2,1,0,1,1,0,-1,-44,-3,7,4,14,0,0,1,-1,-1,1,3,1
KR_6736371391,420,1,37,-4,5,-1,1,2,1,2,1,-1,1,2,5,5,0,1,1,0,0,13,283,5,5,10,1,0,1,1,-1,1,1,5,1
KR_6769365655,440,1,11,21,0,-3,1,4,-3,2,5,2,4,2,3,4,1,1,4,3,0,-4,-4,-2,5,3,3,0,-1,-1,-1,-1,1,3,1
KR_6752232618,440,3,5,26,4,-1,2,3,0,2,2,3,4,1,2,4,2,0,0,0,0,7,11,4,4,8,0,0,1,1,1,1,1,6,1
KR_6750186140,420,1,26,15,5,3,4,1,-1,1,2,4,5,1,0,2,2,-1,0,1,0,1,11,5,4,9,8,0,0,-1,1,0,-1,5,1
KR_6766394184,420,1,9,9,0,-2,0,2,3,5,2,1,3,2,-2,3,5,0,0,0,0,-2,-6,-1,6,5,-4,0,1,1,-1,1,-1,2,1
KR_6775161167,440,2,15,-8,0,3,3,0,-4,1,5,-2,2,4,3,5,2,0,0,0,0,4,-6,1,4,5,-1,0,0,1,-1,-1,-1,4,1
KR_6774469464,420,-2,40,-10,0,0,1,1,-2,3,5,-4,1,5,3,4,1,3,3,0,0,2,-16,-3,7,4,-3,0,2,-1,-1,1,1,5,1
KR_6750533290,420,5,52,-8,11,5,5,0,2,4,2,3,5,2,2,4,2,-1,0,1,0,13,4,4,4,8,-1,0,3,1,1,1,1,4,1
KR_6743710093,440,0,6,40,-6,-1,0,1,-2,3,5,-6,2,8,2,4,2,1,1,0,0,-7,2,6,4,10,-3,0,0,-1,1,-1,1,6,1
KR_6744684350,420,0,23,17,-4,0,2,2,1,4,3,-1,2,3,-4,2,6,0,0,0,0,-5,-9,-4,10,6,-5,0,-1,1,-1,1,-1,3,1
KR_6772327134,420,6,164,-9,5,4,4,0,1,3,2,1,3,2,-2,0,2,1,2,1,1,7,26,-6,8,2,9,0,5,1,1,1,-1,2,1
KR_6755114066,420,3,-16,31,4,1,2,1,1,6,5,1,1,0,3,4,1,-2,0,2,0,8,5,-4,10,6,3,0,0,1,-1,0,-1,6,1
KR_6777313024,420,4,29,16,6,-1,2,3,3,5,2,-2,1,3,6,8,2,0,3,3,0,11,-2,-5,12,7,3,0,0,1,-1,0,-1,2,1
KR_6760139297,420,0,-14,0,7,-1,2,3,4,5,1,2,7,5,0,5,5,2,3,1,1,15,6,0,5,5,7,0,0,1,1,0,-1,6,1
KR_6770283994,440,1,45,6,6,1,1,0,6,6,0,3,6,3,-5,0,5,1,1,0,0,1,50,-1,6,5,0,0,0,1,0,0,1,4,1
KR_6732227844,420,2,-14,-9,2,0,1,1,-2,1,3,-1,5,6,5,6,1,0,0,0,0,11,5,2,4,6,-2,0,0,-1,-1,-1,-1,5,1
KR_6776790274,420,-2,-29,-15,-2,-1,1,2,-2,2,4,1,1,0,1,6,5,-1,2,3,1,4,-8,-3,11,8,7,0,0,1,1,-1,1,2,1
KR_6752691381,420,0,17,-13,-2,0,1,1,-3,1,4,0,1,1,0,2,2,1,1,0,0,-4,15,-3,10,7,6,0,0,-1,-1,0,-1,4,1
KR_6729199821,420,4,47,33,11,0,2,2,6,9,3,5,8,3,1,2,1,-1,1,2,0,10,0,-2,8,6,2,0,1,1,1,1,1,2,1
KR_6703056227,420,5,-22,40,7,3,4,1,0,2,2,0,2,2,4,4,0,0,2,2,0,7,-6,-4,12,8,9,0,0,1,-1,1,1,1,1
KR_6724372205,420,1,24,-35,8,-1,0,1,0,3,3,6,10,4,2,4,2,1,1,0,0,14,24,4,5,9,-2,0,0,1,-1,-1,1,5,1
KR_6776480636,420,1,61,15,5,1,1,0,0,4,4,2,5,3,0,2,2,2,4,2,0,3,-1,-2,7,5,-1,0,-1,1,-1,-1,-1,2,1
KR_6777847204,420,7,97,23,12,1,2,1,5,5,0,1,1,0,5,6,1,0,1,1,0,16,-8,-2,5,3,4,0,2,1,1,1,1,4,1
KR_6776553022,420,0,24,2,1,2,3,1,2,5,3,-1,1,2,-2,2,4,0,0,0,0,2,-2,-1,8,7,-6,0,0,-1,1,-1,1,4,1
KR_6772552132,420,-1,37,3,5,3,5,2,5,5,0,-4,0,4,1,3,2,0,0,0,1,5,8,2,4,6,0,0,0,1,1,1,1,6,1
KR_6773312192,420,1,0,16,7,6,6,0,4,6,2,0,3,3,-2,0,2,-1,0,1,-1,0,42,-1,5,4,-26,0,1,1,1,1,-1,3,1
KR_6771155838,420,2,34,13,3,1,3,2,0,1,1,2,4,2,0,2,2,0,1,1,0,0,3,-3,8,5,-3,0,0,1,-1,0,1,2,1
KR_6735466642,420,0,7,39,0,0,3,3,-4,0,4,4,4,0,-2,2,4,2,4,2,0,-4,0,4,6,10,-5,0,1,1,-1,1,1,4,1
KR_6776107212,420,3,49,-20,11,-1,0,1,2,2,0,5,7,2,4,4,0,1,2,1,0,13,2,1,4,5,0,0,1,1,1,1,-1,5,1
KR_6736603116,420,2,-6,11,6,-2,0,2,3,4,1,3,5,2,-2,2,4,4,5,1,0,6,10,4,3,7,-2,0,1,1,1,1,1,4,1
KR_6740664714,420,0,9,-22,-1,0,0,0,0,6,6,0,3,3,-2,2,4,1,2,1,0,-4,-2,4,5,9,1,0,2,-1,1,1,1,4,1
KR_6737310192,420,5,40,20,11,1,2,1,4,5,1,1,5,4,4,5,1,1,1,0,0,10,6,2,7,9,5,0,0,0,1,0,1,0,1
KR_6769857609,420,-1,65,-9,-6,0,1,1,-1,4,5,-5,3,8,0,1,1,0,0,0,0,-6,4,0,6,6,0,0,0,-1,1,1,1,1,1
KR_6749654925,420,3,16,7,6,-2,1,3,-3,1,4,0,1,1,8,9,1,3,3,0,1,8,2,-3,11,8,4,0,1,1,-1,1,1,3,1
KR_6770466679,440,5,95,33,8,2,3,1,3,3,0,0,2,2,1,4,3,2,2,0,0,5,8,0,4,4,2,0,2,1,1,1,1,4,1
KR_6755769520,420,0,62,3,4,4,5,1,-2,4,6,-2,0,2,1,2,1,3,7,4,0,-6,-40,0,7,7,6,0,1,1,1,1,-1,6,1
KR_6757292500,420,0,-32,4,2,0,0,0,8,12,4,-4,3,7,-1,2,3,-1,0,1,0,-2,-11,3,6,9,5,0,0,1,1,1,-1,4,1
KR_6774767480,420,4,-3,32,0,0,1,1,3,6,3,0,2,2,-1,1,2,-2,0,2,0,-1,1,1,6,7,1,0,1,-1,1,1,-1,6,1
KR_6761819312,420,4,22,-4,15,2,2,0,2,5,3,4,4,0,7,9,2,0,1,1,1,24,2,-1,6,5,-2,0,2,1,1,1,1,1,1
KR_6762301560,420,1,18,9,-6,2,2,0,-5,2,7,-2,3,5,-4,4,8,3,4,1,-1,-5,110,1,2,3,7,0,-2,1,-1,-1,1,3,1
KR_6774191430,420,0,36,9,2,-1,0,1,-3,0,3,5,7,2,2,2,0,-1,0,1,0,1,-15,-2,6,4,3,0,0,-1,1,0,1,5,1
KR_6776670360,420,-1,-27,25,-7,-3,1,4,-2,0,2,0,1,1,-1,2,3,-1,0,1,-1,-3,98,-6,10,4,9,0,0,-1,1,1,-1,4,1
KR_6774329344,420,1,7,11,3,-1,1,2,4,6,2,1,4,3,-1,2,3,0,0,0,0,9,7,2,7,9,0,0,0,1,-1,-1,1,4,1
KR_6709084791,420,3,31,-9,4,2,3,1,1,5,4,2,3,1,1,3,2,-2,0,2,0,6,11,6,7,13,1,0,-1,-1,-1,-1,-1,6,1
KR_6716911024,420,3,146,26,0,0,1,1,0,2,2,-2,0,2,2,2,0,0,2,2,0,4,10,3,1,4,-1,0,3,1,-1,1,-1,1,1
KR_6756290100,420,5,92,14,8,4,4,0,1,2,1,4,5,1,0,0,0,-1,0,1,0,10,26,2,3,5,0,0,2,-1,1,1,1,2,1
KR_6773312541,420,3,77,11,5,1,2,1,1,2,1,1,3,2,1,2,1,1,2,1,0,2,-7,0,5,5,4,0,1,-1,1,1,-1,2,1
KR_6726259923,420,3,-7,24,11,-1,2,3,4,4,0,2,6,4,6,7,1,0,1,1,1,10,8,7,7,14,3,0,2,1,-1,1,1,4,1
KR_6753021796,420,6,109,11,16,-1,0,1,0,4,4,6,6,0,7,9,2,4,4,0,2,27,6,6,1,7,4,0,5,1,1,1,1,1,1
KR_6773761915,440,2,-47,15,5,4,6,2,2,2,0,-4,0,4,2,2,0,1,1,0,0,5,-44,-5,8,3,16,0,-1,1,-1,-1,1,1,1
KR_6777678753,420,3,75,-5,3,1,1,0,3,7,4,1,2,1,-3,1,4,1,1,0,0,0,5,2,3,5,-1,0,2,-1,1,1,-1,5,1
KR_6742217409,420,0,-29,7,-4,0,2,2,0,1,1,0,3,3,-6,0,6,2,2,0,0,-19,29,-4,9,5,-7,0,0,-1,1,1,1,3,1
KR_6743637820,420,1,55,5,4,1,3,2,-1,0,1,2,2,0,2,3,1,0,1,1,0,8,12,0,3,3,0,0,1,1,1,1,1,3,1
KR_6726308040,420,6,84,-3,15,4,4,0,3,4,1,0,1,1,10,11,1,-2,1,3,1,22,20,10,4,14,0,1,3,1,-1,1,1,6,1
KR_6736961611,420,0,-14,20,3,0,2,2,2,4,2,0,1,1,0,0,0,1,1,0,0,4,11,-3,11,8,-7,0,1,1,-1,1,-1,3,1
KR_6746562417,420,-2,39,-12,0,-3,0,3,-3,1,4,2,3,1,0,1,1,4,5,1,-1,4,15,5,4,9,-8,0,1,-1,-1,1,-1,2,1
KR_6720346549,420,7,72,-6,18,5,5,0,5,7,2,5,5,0,-1,1,2,4,5,1,1,31,-32,5,5,10,3,0,2,1,1,1,1,2,1
KR_6741609867,420,-2,16,0,-10,-4,0,4,2,8,6,-5,0,5,-2,0,2,-1,1,2,0,-4,-4,3,3,6,-7,0,-2,-1,1,-1,-1,3,1
KR_6772928985,420,3,41,-44,9,1,2,1,1,2,1,0,2,2,3,4,1,4,4,0,-1,12,-21,4,4,8,3,0,3,1,-1,1,-1,5,1
KR_6731268853,420,1,38,1,6,0,0,0,-2,0,2,4,5,1,4,5,1,0,2,2,0,5,6,4,4,8,-3,0,0,1,-1,0,1,2,1
KR_6749984500,420,5,-11,12,10,1,2,1,2,3,1,4,5,1,1,1,0,2,2,0,0,13,8,1,6,7,-1,0,0,1,1,1,1,5,1
KR_6709123886,420,2,49,14,10,-2,0,2,10,12,2,1,3,2,0,1,1,1,2,1,0,17,25,3,5,8,6,0,1,1,-1,1,1,5,1
KR_6743114246,420,0,60,-8,2,0,1,1,0,2,2,0,0,0,1,1,0,1,1,0,0,6,-3,-4,8,4,7,0,0,-1,-1,0,-1,4,1
KR_6764568258,420,0,29,-17,5,-2,0,2,1,3,2,8,10,2,1,3,2,-3,0,3,0,0,8,-2,6,4,-1,0,0,-1,-1,0,1,2,1
KR_6744100734,420,-2,-17,-21,2,-4,0,4,1,1,0,0,2,2,5,8,3,0,1,1,1,8,2,-2,4,2,5,0,-2,1,-1,-1,1,1,1
KR_6679963543,420,3,65,23,6,-3,1,4,5,6,1,-1,3,4,3,5,2,2,2,0,0,5,-1,-5,13,8,3,0,-2,1,-1,1,1,3,1
KR_6770924966,420,-1,-21,-16,0,3,3,0,0,3,3,-2,2,4,-1,2,3,0,3,3,0,7,-2,-1,8,7,1,0,0,-1,-1,0,-1,5,1
KR_6768866177,420,5,59,15,4,6,8,2,-3,2,5,5,5,0,-4,0,4,0,1,1,0,3,11,3,1,4,-8,0,3,1,-1,1,-1,2,1
KR_6767807361,440,2,51,4,4,1,1,0,-1,3,4,4,4,0,3,6,3,-3,0,3,0,7,2,3,7,10,-2,0,-1,-1,1,-1,1,3,1
KR_6763390342,420,-1,0,-35,-5,-1,1,2,-1,5,6,-2,4,6,-3,2,5,2,2,0,0,1,-15,-2,8,6,-6,0,-1,1,1,1,1,2,1
KR_6769348922,420,2,-39,-5,4,0,4,4,2,2,0,3,4,1,1,4,3,-2,0,2,-1,11,-28,-2,8,6,2,0,0,1,-1,0,-1,1,1
KR_6769175991,440,-1,-6,24,1,-2,1,3,2,2,0,-1,1,2,2,3,1,0,3,3,0,1,-275,-1,6,5,-2,0,1,1,-1,1,1,1,1
KR_6757687425,420,3,4,50,5,4,5,1,3,7,4,-1,2,3,0,6,6,-1,0,1,1,-1,-8,3,7,10,-2,0,0,-1,1,-1,-1,2,1
KR_6774998339,440,3,135,-3,3,1,2,1,-1,3,4,4,4,0,-1,2,3,0,0,0,-1,-9,26,0,4,4,4,0,2,0,-1,1,-1,0,1
KR_6727188590,420,3,29,16,5,0,2,2,0,3,3,2,3,1,3,4,1,0,0,0,0,5,12,-1,11,10,5,0,2,-1,1,1,1,1,1
KR_6742395078,440,8,90,65,15,1,2,1,7,7,0,1,2,1,3,5,2,3,4,1,3,22,12,6,5,11,4,0,1,1,1,1,1,1,1
KR_6776317949,420,5,15,13,6,0,1,1,-2,1,3,3,5,2,3,8,5,2,2,0,0,15,-3,3,5,8,2,0,0,1,1,1,1,6,1
KR_6771824903,420,1,8,27,-4,1,3,2,-3,1,4,-2,2,4,-1,1,2,1,1,0,-1,-10,7,6,0,6,2,0,0,-1,1,1,-1,2,1
KR_6775904461,420,-2,1,-1,-10,-1,2,3,-3,2,5,-2,1,3,-6,3,9,2,2,0,0,-15,-14,-1,8,7,5,0,-1,-1,-1,-1,-1,3,1
KR_6713921922,420,0,-21,16,-1,-3,1,4,-1,1,2,0,1,1,2,5,3,1,3,2,0,-4,0,-2,6,4,-5,0,-1,-1,1,-1,-1,3,1
KR_6767646610,420,5,36,12,10,1,2,1,3,7,4,5,5,0,1,1,0,0,0,0,0,7,8,-4,7,3,0,0,2,-1,1,1,1,1,1
KR_6764581269,420,-1,-40,-7,-6,-1,1,2,-5,1,6,1,5,4,-2,4,6,1,1,0,0,-4,1,-4,10,6,-5,0,-1,-1,1,1,1,5,1
KR_6775982183,420,-5,-33,4,-3,0,3,3,-3,3,6,-1,0,1,1,3,2,0,0,0,0,6,2,1,3,4,-2,0,0,1,-1,1,1,6,1
KR_6767788158,420,0,-9,-35,5,2,2,0,1,6,5,2,3,1,0,1,1,0,1,1,0,1,23,5,3,8,0,0,-1,-1,-1,-1,1,3,1
KR_6710609107,420,-1,-1,25,0,1,3,2,-1,2,3,1,2,1,2,3,1,-3,1,4,0,-2,6,3,4,7,1,0,0,-1,1,1,1,6,1
KR_6769886493,440,2,26,-20,5,1,2,1,-1,1,2,6,6,0,0,3,3,-1,1,2,1,1,-4,-1,4,3,7,0,1,1,1,1,1,4,1
KR_6768665291,440,-1,-49,4,-10,7,9,2,-2,1,3,-3,1,4,-9,1,10,-3,0,3,-1,-19,10,-3,5,2,2,0,-1,-1,-1,-1,-1,2,1
KR_6777010961,420,0,-47,20,-2,4,4,0,0,3,3,1,2,1,-7,2,9,0,0,0,0,-5,3,-3,12,9,10,0,1,1,1,1,-1,4,1
KR_6734774342,420,6,37,-3,6,5,5,0,0,2,2,1,2,1,1,5,4,-1,0,1,0,11,26,0,4,4,0,0,3,1,1,1,-1,3,1
KR_6740633930,420,0,41,-36,-3,-1,2,3,0,1,1,2,5,3,-3,6,9,-1,2,3,0,-7,11,-6,8,2,0,0,0,-1,1,1,1,6,1
KR_6775590411,420,5,38,9,8,0,1,1,2,2,0,3,5,2,3,5,2,0,0,0,-1,10,-23,1,4,5,-5,0,0,1,-1,1,1,5,1
KR_6776999241,420,0,8,-17,7,0,2,2,5,8,3,-2,0,2,2,5,3,2,3,1,0,12,8,-1,4,3,0,0,0,-1,-1,1,1,5,1
KR_6740495795,420,-1,13,28,-8,-2,0,2,-6,0,6,0,2,2,2,4,2,-2,0,2,0,-20,-1,-4,11,7,-2,0,-1,1,-1,-1,1,6,1
KR_6777294560,420,4,63,36,9,3,4,1,4,4,0,8,10,2,-4,3,7,-2,2,4,0,1,16,-2,8,6,2,0,3,1,1,1,1,4,1
KR_6773531321,420,0,-11,-7,-2,2,4,2,3,3,0,-5,0,5,-3,1,4,1,1,0,-2,-5,-6,2,3,5,1,0,0,1,-1,0,-1,2,1
KR_6773406134,440,-1,-23,23,-10,0,4,4,0,4,4,0,1,1,-4,0,4,-6,0,6,0,-9,1,0,5,5,-3,0,0,1,1,-1,-1,4,1
KR_6776013753,420,-2,-21,-39,1,6,7,1,-4,1,5,-1,1,2,-1,1,2,1,1,0,0,1,-118,-1,8,7,-2,0,0,-1,1,0,1,1,1
KR_6665706727,420,-2,-76,23,2,-1,1,2,5,5,0,1,1,0,-1,2,3,-2,0,2,-1,-1,9,7,4,11,-6,0,0,1,1,0,-1,1,1
KR_6764462827,420,4,-1,8,6,-1,1,2,1,4,3,2,2,0,4,6,2,0,1,1,0,3,4,0,8,8,0,0,0,1,-1,1,1,5,1
KR_6775364030,420,0,-5,-20,6,-5,0,5,3,4,1,1,1,0,3,4,1,4,4,0,0,13,38,-4,9,5,4,0,0,1,-1,-1,-1,4,1
KR_6773305337,420,0,-23,-8,-3,-3,2,5,-1,2,3,1,3,2,0,0,0,0,1,1,0,2,6,3,5,8,-8,0,0,-1,1,-1,-1,5,1
KR_6727967224,420,3,90,23,7,1,3,2,2,6,4,0,1,1,4,4,0,0,0,0,1,7,9,1,6,7,-1,0,3,1,1,1,1,4,1
KR_6772317308,420,-1,-43,7,2,-1,1,2,0,3,3,1,4,3,2,4,2,0,2,2,0,4,3,1,2,3,3,0,0,-1,1,-1,1,6,1
KR_6743645905,420,-1,-53,-20,4,-3,1,4,3,6,3,0,3,3,4,6,2,0,1,1,0,10,7,4,3,7,-3,0,0,-1,-1,-1,-1,3,1
KR_6742346086,420,0,10,13,3,-2,2,4,0,2,2,1,3,2,5,6,1,-1,0,1,-1,15,-8,-2,7,5,1,0,0,1,-1,-1,-1,1,1
KR_6699310331,420,2,37,-10,0,-3,2,5,-2,3,5,2,4,2,1,5,4,2,4,2,-4,-6,-9,-1,8,7,4,0,1,1,-1,1,1,2,1
KR_6774115821,420,2,19,7,11,1,3,2,0,3,3,4,7,3,2,6,4,4,5,1,1,7,50,4,2,6,-17,0,2,1,1,1,1,2,1
KR_6773599536,420,3,-34,9,4,-1,0,1,0,2,2,0,3,3,6,6,0,-1,0,1,0,12,-7,-6,9,3,-5,0,-1,1,-1,-1,-1,5,1
KR_6756297354,420,-1,-13,-20,0,-1,1,2,5,6,1,1,2,1,-5,1,6,0,0,0,0,3,-9,1,9,10,3,0,1,-1,1,1,-1,1,1
KR_6767093030,420,0,-17,-5,-1,0,1,1,-1,7,8,2,5,3,-2,1,3,0,0,0,0,8,6,-6,8,2,0,0,1,1,1,1,-1,6,1
KR_6744708853,420,-1,44,-16,1,-3,1,4,-2,1,3,1,2,1,3,3,0,2,2,0,0,5,2,1,8,9,0,0,-1,1,-1,-1,-1,6,1
KR_6768415924,440,2,0,-2,-5,-4,0,4,-6,3,9,3,5,2,5,7,2,-3,1,4,0,1,13,3,4,7,-24,0,0,0,-1,-1,-1,0,1
KR_6777264812,420,-3,-5,-15,-5,0,0,0,0,2,2,-1,1,2,-4,0,4,0,0,0,0,-12,36,0,5,5,-5,0,0,-1,1,1,1,4,1
KR_6768684104,420,3,4,56,1,-2,1,3,0,3,3,4,5,1,0,2,2,-1,0,1,0,-3,37,0,5,5,-20,0,0,-1,1,1,1,1,1
KR_6774346696,420,3,101,19,5,1,3,2,-1,2,3,4,6,2,0,3,3,1,1,0,0,4,29,-5,8,3,-11,0,2,1,1,1,-1,1,1
KR_6770400794,420,2,-5,31,1,-1,2,3,3,4,1,0,2,2,0,2,2,-1,0,1,0,-3,-2,7,3,10,-1,0,1,1,1,-1,-1,4,1
KR_6700588030,420,2,84,-15,-2,-1,2,3,-3,1,4,2,4,2,1,4,3,-1,1,2,0,-1,8,-1,10,9,3,0,0,1,1,0,-1,3,1
KR_6774712985,420,3,38,0,12,5,7,2,1,2,1,2,5,3,2,2,0,2,3,1,1,12,33,5,7,12,3,0,0,1,1,1,1,1,1
KR_6758919911,420,1,-7,8,1,-4,0,4,-3,2,5,2,5,3,2,4,2,4,4,0,1,0,1,-4,11,7,2,0,0,1,1,0,1,6,1
KR_6751899748,420,4,80,24,10,9,10,1,-2,2,4,2,6,4,1,3,2,0,2,2,0,19,-4,-2,9,7,2,0,3,1,1,1,1,4,1
KR_6763006307,420,-3,-39,-31,-2,5,6,1,-3,1,4,-3,2,5,-1,3,4,0,0,0,0,-11,6,0,7,7,-5,0,-2,1,-1,-1,1,5,1
KR_6743853482,420,-2,-11,28,-3,-4,2,6,-3,3,6,2,3,1,2,2,0,0,1,1,-2,-5,24,-2,8,6,-4,0,-1,1,-1,-1,-1,2,1
KR_6761996748,420,2,15,15,8,2,2,0,-1,0,1,2,2,0,-3,4,7,8,9,1,0,8,14,2,5,7,-2,0,0,1,-1,1,1,4,1
KR_6776948858,420,0,15,-21,5,0,2,2,0,3,3,4,4,0,2,6,4,-1,0,1,0,19,-16,0,7,7,0,0,1,1,1,1,1,2,1
KR_6775934310,420,1,38,9,5,3,4,1,2,4,2,-3,2,5,4,4,0,-1,1,2,0,3,-116,1,4,5,0,0,0,-1,1,-1,1,3,1
KR_6769895297,420,-2,-70,12,-10,4,4,0,-4,3,7,0,3,3,-8,1,9,-2,0,2,-2,-18,264,6,3,9,-7,0,0,1,1,1,-1,4,1
KR_6767209383,420,1,54,-6,1,3,6,3,0,2,2,-1,4,5,-1,3,4,0,2,2,0,7,44,-3,5,2,-21,0,3,1,1,1,1,4,1
KR_6775532050,420,1,29,-11,0,1,1,0,1,3,2,0,3,3,-1,1,2,-1,0,1,0,0,7,4,3,7,4,0,0,-1,-1,0,1,3,1
KR_6767346198,420,0,6,5,1,0,2,2,1,2,1,2,2,0,-1,0,1,-1,0,1,0,3,-7,-3,7,4,1,0,1,1,-1,1,-1,5,1
KR_6768986826,420,2,44,-12,6,-2,0,2,2,5,3,1,5,4,5,5,0,0,0,0,0,6,-20,-2,6,4,5,0,1,1,1,1,1,3,1
KR_6765675756,420,9,142,31,12,0,1,1,1,4,3,7,7,0,2,4,2,2,2,0,1,22,2,2,3,5,2,0,5,1,1,1,1,3,1
KR_6774196023,420,3,93,0,5,0,2,2,5,7,2,1,2,1,-2,0,2,1,1,0,0,10,7,4,4,8,1,0,-1,1,-1,-1,1,5,1
KR_6696922599,420,4,18,15,10,4,5,1,1,5,4,2,3,1,2,8,6,1,2,1,0,16,0,1,8,9,-4,0,1,-1,1,1,1,1,1
KR_6646046768,420,0,27,-11,-4,6,6,0,-1,1,2,-3,6,9,-4,2,6,-2,0,2,0,-2,38,3,9,12,-4,0,-1,-1,1,-1,-1,3,1
KR_6699655422,420,-1,23,29,-13,1,3,2,-8,0,8,-6,1,7,0,1,1,0,1,1,-1,-22,31,1,6,7,-10,0,0,1,-1,1,-1,1,1
KR_6718710492,420,3,45,57,11,-3,3,6,9,13,4,1,1,0,5,7,2,-1,2,3,0,15,-201,8,2,10,-1,0,2,1,1,1,1,4,1
KR_6777219304,420,0,13,32,0,0,1,1,3,5,2,0,2,2,-4,2,6,1,3,2,0,-1,-68,0,8,8,4,0,1,-1,1,1,-1,1,1
KR_6745976079,420,3,33,-5,5,-1,0,1,2,3,1,1,2,1,4,4,0,-1,0,1,0,11,-57,5,3,8,29,0,0,1,-1,0,1,4,1
KR_6738302587,420,4,39,-8,11,0,2,2,2,6,4,0,2,2,7,7,0,2,2,0,-1,14,13,7,5,12,-3,0,3,1,-1,1,-1,3,1
KR_6775693278,420,1,-12,16,-7,0,1,1,-7,3,10,-2,1,3,3,5,2,-1,2,3,0,-5,0,3,4,7,4,0,0,1,-1,0,-1,2,1
KR_6765552478,420,2,38,25,5,2,2,0,4,4,0,-2,0,2,1,1,0,0,0,0,0,5,-4,2,2,4,8,0,2,1,1,1,1,2,1
KR_6710708138,420,2,29,-1,7,0,0,0,1,6,5,3,6,3,0,1,1,3,3,0,0,16,-41,0,10,10,9,0,-1,1,-1,-1,1,1,1
KR_6742776100,420,4,94,0,8,2,4,2,5,8,3,0,0,0,1,6,5,0,1,1,-1,1,-11,1,7,8,0,0,1,1,-1,1,-1,4,1
KR_6774401529,420,4,39,31,9,0,1,1,1,2,1,4,4,0,4,5,1,0,1,1,0,13,-199,4,3,7,3,0,1,1,-1,1,1,4,1
KR_6755975521,420,2,32,-7,-2,1,3,2,0,3,3,-3,0,3,0,1,1,0,2,2,0,-8,7,-3,8,5,-6,0,1,1,-1,1,-1,6,1
KR_6776908728,420,6,8,15,14,3,4,1,6,9,3,3,5,2,4,9,5,-2,0,2,0,18,-1,3,5,8,1,0,1,-1,1,1,-1,1,1
KR_6770751959,420,2,24,-32,6,-3,0,3,0,2,2,6,6,0,1,3,2,2,2,0,2,9,-2,-4,8,4,4,0,1,1,1,1,1,4,1
KR_6693766059,420,1,-43,34,-1,4,4,0,2,5,3,-3,4,7,-2,1,3,-2,2,4,1,1,8,-1,5,4,-4,0,1,1,1,1,1,6,1
KR_6748371695,420,2,-5,-17,8,3,6,3,0,2,2,3,5,2,1,3,2,1,1,0,0,11,-11,4,4,8,4,0,0,-1,1,1,1,5,1
KR_6727225155,420,1,61,-4,3,1,1,0,2,3,1,0,3,3,1,1,0,-1,0,1,0,11,9,-3,9,6,-24,0,1,-1,1,1,1,1,1
KR_6772998177,440,1,121,-5,-2,-3,0,3,-1,1,2,1,3,2,2,3,1,-1,0,1,0,-6,-129,3,2,5,-3,0,-1,-1,-1,-1,-1,5,1
KR_6761619429,420,-1,21,-3,-2,-4,0,4,-2,4,6,2,4,2,3,4,1,-1,0,1,1,1,21,1,6,7,2,0,0,-1,-1,0,1,6,1
KR_6770119574,420,-3,-2,-10,-3,1,2,1,-3,2,5,-1,0,1,3,7,4,-3,1,4,0,-11,6,5,4,9,-1,0,-1,-1,1,1,1,6,1
KR_6725936651,440,2,39,-8,7,1,2,1,0,4,4,-1,1,2,-1,0,1,8,8,0,0,4,-7,-2,3,1,1,0,3,-1,1,1,1,6,1
KR_6743658600,420,4,39,-4,16,9,11,2,5,6,1,4,5,1,-2,1,3,0,1,1,0,9,4,4,3,7,-2,0,2,-1,-1,1,1,3,1
KR_6777074121,420,1,-32,55,-4,-1,1,2,-1,1,2,-3,1,4,1,1,0,0,0,0,0,-9,-6,-3,11,8,-1,0,0,-1,1,0,1,1,1
KR_6777113579,420,-1,5,-14,0,2,3,1,3,6,3,-1,2,3,-3,1,4,-1,0,1,0,1,119,-2,8,6,2,0,1,1,1,1,-1,5,1
KR_6777103291,420,-1,42,-3,0,1,3,2,4,6,2,-3,0,3,-2,1,3,0,0,0,0,-10,-23,2,5,7,2,0,0,1,-1,0,1,5,1
KR_6750044578,420,-1,21,19,0,4,5,1,0,5,5,1,3,2,-5,1,6,0,1,1,-2,-10,3,1,8,9,-2,0,-1,1,1,-1,-1,5,1
KR_6743530686,420,5,71,20,9,0,1,1,3,4,1,5,5,0,2,4,2,-1,0,1,0,10,-38,-4,6,2,5,0,1,1,1,1,1,6,1
KR_6750031965,420,3,-9,-39,9,0,1,1,3,4,1,0,2,2,1,1,0,5,6,1,0,14,-231,0,5,5,1,0,0,1,-1,0,1,6,1
KR_6775385498,420,-2,-45,10,-4,2,4,2,-3,2,5,2,4,2,-6,0,6,1,1,0,0,-10,-1,-3,6,3,-4,0,0,-1,1,-1,-1,1,1
KR_6768706115,420,3,43,26,8,1,1,0,1,4,3,4,4,0,2,4,2,0,1,1,0,10,-1,-1,7,6,5,0,2,1,1,1,-1,4,1
KR_6701968057,420,4,65,17,9,5,5,0,-1,4,5,3,4,1,0,5,5,2,2,0,0,6,30,-1,7,6,8,0,2,-1,1,1,-1,6,1
KR_6776102595,420,5,90,11,10,5,5,0,3,3,0,-1,0,1,4,4,0,-1,0,1,0,9,25,-2,7,5,5,0,2,1,1,1,1,3,1
KR_6766186898,420,3,3,36,6,0,3,3,3,5,2,6,7,1,-2,3,5,-1,0,1,1,9,3,2,5,7,1,0,1,1,1,1,1,3,1
KR_6771324600,420,-1,-23,7,-2,3,4,1,-7,4,11,3,5,2,0,2,2,-1,0,1,-2,-11,-7,-5,10,5,-1,0,1,1,-1,1,-1,6,1
KR_6765024251,420,2,44,28,-4,0,2,2,-1,4,5,3,7,4,-6,1,7,0,0,0,-3,-6,25,-4,11,7,-1,0,2,-1,-1,1,-1,2,1
KR_6735556131,420,5,64,12,4,-1,0,1,6,6,0,1,5,4,-1,3,4,-1,0,1,-3,-1,33,-4,10,6,5,0,1,-1,-1,1,-1,5,1
KR_6689993749,420,7,66,47,13,2,4,2,6,9,3,2,3,1,2,4,2,1,2,1,1,9,-12,6,1,7,1,0,1,1,-1,1,1,6,1
KR_6698028282,420,1,-34,-9,4,-4,0,4,4,5,1,1,1,0,0,4,4,3,5,2,1,11,15,-1,6,5,-1,0,0,1,-1,-1,1,5,1
KR_6748246429,420,2,29,3,4,2,4,2,3,4,1,0,2,2,-1,4,5,0,1,1,0,2,-8,-6,11,5,0,0,1,1,-1,1,1,5,1
KR_6748850645,420,1,80,-3,-3,3,3,0,-4,1,5,-5,0,5,3,6,3,0,1,1,0,-14,7,2,6,8,1,0,2,-1,1,1,1,5,1
KR_6739646485,420,-3,-36,-12,-9,-3,2,5,2,4,2,-1,1,2,-3,0,3,-4,2,6,0,-3,6,-5,7,2,-3,0,0,-1,-1,0,1,1,1
KR_6737445538,420,1,-17,-4,5,-2,0,2,5,5,0,-3,3,6,2,3,1,3,4,1,0,15,-4,1,8,9,-1,0,1,-1,-1,1,1,2,1
KR_6758826968,420,1,19,-4,1,3,7,4,0,4,4,-2,0,2,0,2,2,0,0,0,0,-1,-24,4,3,7,-6,0,0,0,-1,0,-1,0,1
KR_6774840288,440,2,13,44,6,2,3,1,1,1,0,5,6,1,0,0,0,-2,0,2,0,9,-5,0,3,3,-1,0,0,1,1,0,1,1,1
KR_6751332181,420,6,123,8,14,2,3,1,10,15,5,2,4,2,0,3,3,0,1,1,-2,11,1,2,5,7,3,0,3,0,1,1,1,0,1
KR_6763591359,440,0,-10,-31,7,5,5,0,2,3,1,-3,0,3,2,6,4,1,1,0,1,12,4,1,6,7,4,0,1,1,1,-1,1,6,1
KR_6776532725,420,3,-2,21,2,-3,0,3,3,4,1,0,4,4,1,5,4,1,1,0,0,12,-26,-1,9,8,6,0,0,-1,1,0,-1,5,1
KR_6768867974,420,3,52,2,10,4,4,0,-1,2,3,2,4,2,3,5,2,2,3,1,0,6,1,2,5,7,1,0,1,1,1,1,-1,2,1
KR_6775844069,420,1,44,5,3,5,5,0,-4,0,4,2,2,0,0,0,0,0,0,0,0,5,11,4,4,8,-3,0,0,-1,1,0,1,5,1
KR_6768267915,420,-2,0,-8,-1,-2,1,3,0,2,2,-2,3,5,1,6,5,2,3,1,1,-8,7,7,3,10,-1,0,-1,-1,1,-1,-1,4,1
KR_6710070461,420,0,7,-10,0,5,5,0,0,2,2,-3,3,6,-4,1,5,2,3,1,0,-1,-16,3,4,7,-2,0,0,1,1,1,1,1,1
KR_6751442533,420,4,51,-20,15,3,3,0,3,4,1,3,4,1,6,7,1,0,1,1,0,26,66,1,5,6,-1,0,2,1,1,1,1,3,1
KR_6774431386,420,5,38,9,8,-1,0,1,7,8,1,-1,2,3,3,3,0,0,0,0,0,13,3,3,3,6,-3,0,1,1,1,1,1,1,1
KR_6731360442,420,4,46,-6,10,2,2,0,4,6,2,3,3,0,0,1,1,1,1,0,0,8,-1,-7,12,5,2,0,1,1,1,1,-1,2,1
KR_6776573688,420,1,-23,18,9,2,4,2,-3,4,7,4,4,0,5,6,1,1,3,2,2,13,-6,3,3,6,0,0,1,1,1,1,1,3,1
KR_6773672177,420,-2,-72,-15,1,0,1,1,1,4,3,-2,0,2,2,4,2,0,1,1,0,-2,81,-1,3,2,-3,0,-1,-1,1,1,-1,3,1
KR_6744314266,420,-3,-8,-8,3,-6,1,7,2,11,9,3,4,1,2,2,0,2,3,1,0,-3,3,2,6,8,2,0,0,1,1,1,-1,6,1
KR_6777343982,420,5,80,5,9,1,2,1,3,6,3,0,1,1,3,3,0,2,2,0,-1,10,129,1,5,6,-2,0,1,-1,-1,1,-1,5,1
KR_6715975866,420,-1,-45,-39,-1,2,5,3,-2,2,4,-4,2,6,3,4,1,0,0,0,-2,-6,-5,-2,7,5,12,0,-1,1,-1,-1,-1,3,1
KR_6718734688,420,2,9,0,6,0,2,2,3,6,3,1,3,2,-1,2,3,3,4,1,0,9,6,9,2,11,-4,0,1,-1,1,1,-1,1,1
KR_6737344947,420,-1,-27,-12,-4,-1,2,3,1,2,1,-4,0,4,0,2,2,0,0,0,0,-10,82,-6,9,3,-2,0,-2,1,-1,-1,-1,4,1
KR_6776973082,420,-2,-7,-18,-2,-2,0,2,-4,2,6,2,3,1,1,2,1,1,1,0,0,3,3,2,5,7,3,0,-1,-1,1,-1,1,4,1
KR_6716444537,420,4,55,27,18,-3,1,4,2,3,1,3,4,1,14,14,0,2,3,1,0,37,9,2,6,8,1,1,3,1,1,1,1,1,1
KR_6698665096,420,3,33,2,3,2,2,0,-2,3,5,4,5,1,1,5,4,-2,0,2,0,2,96,0,6,6,1,0,1,1,1,1,-1,2,1
KR_6720549408,420,1,23,30,8,0,2,2,5,6,1,-3,1,4,3,6,3,3,4,1,0,11,5,7,4,11,-1,0,0,1,1,0,1,6,1
KR_6743545504,420,0,-54,12,4,-1,2,3,0,1,1,0,1,1,3,3,0,2,2,0,0,5,40,4,6,10,-8,0,1,1,1,1,-1,6,1
KR_6711433705,420,5,-2,7,12,0,1,1,5,6,1,6,10,4,0,4,4,1,3,2,1,23,4,0,8,8,-4,0,2,1,1,1,1,6,1
KR_6775566596,420,2,39,19,9,2,3,1,-2,2,4,1,4,3,5,8,3,3,4,1,0,8,5,1,3,4,-1,0,0,-1,-1,1,1,2,1
KR_6775994204,420,3,8,0,6,1,2,1,2,3,1,1,1,0,2,4,2,0,1,1,0,15,16,1,7,8,-9,0,2,1,1,1,1,5,1
KR_6775726853,420,5,47,-13,4,6,6,0,1,3,2,-3,0,3,-3,1,4,3,3,0,0,-1,-20,3,6,9,20,0,0,-1,1,1,-1,4,1
KR_6719202685,420,2,73,17,2,2,3,1,2,3,1,1,2,1,-1,2,3,-2,1,3,0,0,-25,-1,11,10,5,0,1,1,1,1,-1,5,1
KR_6771478959,420,4,-37,23,-2,-2,1,3,0,1,1,5,7,2,-4,3,7,-1,1,2,0,1,-17,0,7,7,-6,0,0,1,1,0,1,6,1
KR_6776578140,420,-1,17,-31,0,-7,2,9,1,3,2,1,1,0,-1,1,2,6,6,0,0,-2,-63,-4,11,7,13,0,-1,-1,-1,-1,1,2,1
KR_6777779679,420,0,19,-12,5,-1,1,2,2,3,1,0,2,2,4,5,1,0,1,1,0,15,7,0,7,7,3,0,0,1,-1,1,-1,1,1
KR_6705760915,440,3,30,-19,3,0,5,5,6,6,0,0,3,3,5,6,1,-8,2,10,0,16,8,4,3,7,-1,0,2,1,1,1,-1,6,1
KR_6757181954,420,-1,-2,-7,0,0,2,2,-7,1,8,5,5,0,-2,5,7,4,6,2,0,-2,21,0,5,5,4,0,-1,1,-1,-1,-1,2,1
KR_6773644676,420,7,20,28,9,-1,0,1,2,6,4,3,4,1,4,4,0,1,1,0,0,13,32,1,3,4,-2,0,0,1,-1,0,1,6,1
KR_6707744766,420,1,56,6,3,0,3,3,1,6,5,0,3,3,2,2,0,0,0,0,0,-9,4,3,6,9,-3,0,0,1,-1,0,1,3,1
KR_6766221752,420,1,33,19,4,3,5,2,3,4,1,-2,0,2,0,1,1,0,1,1,0,3,-2,-5,9,4,3,0,0,-1,1,1,1,4,1
KR_6777505511,420,-1,-21,0,-1,0,1,1,3,5,2,-3,4,7,-1,1,2,0,0,0,0,3,-5,2,7,9,-2,0,-1,1,-1,-1,-1,1,1
KR_6745448919,420,6,42,14,10,1,1,0,-2,4,6,12,12,0,-1,3,4,0,1,1,0,10,-29,-7,9,2,3,0,2,1,-1,1,1,2,1
KR_6774803825,420,0,-69,4,14,1,1,0,6,9,3,2,4,2,4,5,1,1,1,0,0,13,-15,6,4,10,11,0,1,1,1,1,1,2,1
KR_6769441432,420,2,34,13,0,1,2,1,2,4,2,-1,4,5,-3,0,3,1,1,0,0,0,-17,-3,7,4,5,0,1,1,1,1,-1,2,1
KR_6755856364,420,1,-39,-28,13,1,3,2,1,2,1,10,11,1,0,2,2,1,1,0,0,30,3,2,5,7,4,0,-1,-1,0,-1,-1,2,1
KR_6769573850,420,1,-22,47,0,0,0,0,4,5,1,3,3,0,-3,3,6,-4,1,5,0,-6,13,-1,6,5,-1,0,0,1,1,0,-1,3,1
KR_6766212809,420,3,98,-20,12,8,8,0,-1,7,8,3,4,1,2,7,5,0,1,1,-1,1,-3,-4,10,6,-2,0,3,1,1,1,-1,3,1
KR_6725117415,420,4,3,-10,9,5,5,0,2,4,2,0,2,2,1,1,0,1,1,0,0,12,3,3,2,5,5,0,1,1,1,1,1,2,1
KR_6776637784,420,-3,-19,-14,-10,-3,2,5,-3,2,5,1,4,3,-3,4,7,-2,1,3,1,-10,12,2,6,8,-3,0,0,1,-1,-1,1,2,1
KR_6770042288,420,0,-24,-25,5,-1,2,3,-1,0,1,4,6,2,2,2,0,1,1,0,0,10,-15,-1,6,5,7,0,-1,1,1,1,1,4,1
KR_6776123645,420,3,16,8,5,6,6,0,-1,1,2,-1,1,2,0,2,2,1,1,0,0,2,12,-2,9,7,-6,0,0,1,-1,0,-1,5,1
KR_6777069518,420,1,9,-10,5,1,1,0,-3,4,7,7,8,1,-2,2,4,2,2,0,0,11,110,-2,8,6,0,0,0,1,-1,1,1,6,1
KR_6719882427,420,-1,21,9,2,0,3,3,2,5,3,-2,2,4,2,3,1,0,1,1,1,-2,-44,4,5,9,-2,0,0,-1,1,0,1,4,1
KR_6764857079,420,-1,-28,3,0,1,3,2,0,2,2,2,3,1,-3,2,5,0,1,1,0,4,-24,3,6,9,-1,0,0,1,1,-1,1,4,1
KR_6732979820,440,0,-10,-21,1,-3,0,3,0,4,4,5,6,1,-1,2,3,0,2,2,0,1,-3,-5,9,4,10,0,1,-1,1,1,1,4,1
KR_6734045097,420,-2,5,-14,3,1,2,1,4,5,1,1,3,2,-2,1,3,-1,0,1,0,6,-9,3,6,9,-2,0,-1,-1,1,-1,1,5,1
KR_6774120136,420,0,-19,33,-8,-1,2,3,-1,3,4,-5,1,6,-1,2,3,0,1,1,0,-3,28,-3,10,7,-7,0,0,-1,-1,-1,-1,1,1
KR_6766079797,420,1,67,-12,9,3,5,2,2,2,0,0,2,2,3,4,1,1,1,0,3,21,-11,5,4,9,2,0,1,-1,-1,1,1,5,1
KR_6740199080,420,3,-1,19,4,0,1,1,6,6,0,-2,3,5,-3,2,5,3,5,2,-1,4,12,-3,9,6,10,0,0,1,-1,1,-1,6,1
KR_6767394700,420,-1,-32,20,-1,-2,2,4,2,4,2,-2,2,4,2,3,1,-1,1,2,0,-4,30,-4,7,3,-1,0,0,-1,1,0,1,6,1
KR_6766663227,420,5,79,24,14,4,5,1,5,8,3,1,5,4,3,5,2,1,2,1,1,20,15,3,5,8,4,0,0,1,-1,1,1,2,1
KR_6768513812,440,-1,-40,8,3,1,2,1,-1,0,1,0,2,2,4,5,1,-1,0,1,1,2,4,-1,5,4,0,0,0,-1,1,0,1,4,1
KR_6743364099,420,8,122,20,11,1,2,1,4,6,2,1,1,0,3,4,1,2,2,0,0,12,11,2,4,6,1,0,2,1,-1,1,1,6,1
KR_6769256971,420,1,7,-5,-1,0,1,1,-2,4,6,0,0,0,1,5,4,0,2,2,0,-4,0,0,9,9,2,0,-1,-1,1,-1,-1,2,1
KR_6765784635,420,-1,-6,3,-2,-3,1,4,1,2,1,-2,4,6,1,1,0,1,1,0,0,-2,13,-2,7,5,-3,0,-1,1,-1,-1,-1,5,1
KR_6773946099,420,5,33,65,16,1,4,3,6,6,0,1,4,3,7,9,2,1,2,1,1,10,3,1,5,6,-1,0,3,-1,1,1,1,3,1
KR_6770390964,420,0,4,5,2,-3,1,4,-3,3,6,3,5,2,3,4,1,2,3,1,0,8,-5,-4,8,4,1,0,-2,1,-1,-1,-1,2,1
KR_6706173415,420,-1,-2,-8,6,2,3,1,-1,1,2,-2,2,4,8,8,0,-1,1,2,0,13,-216,0,5,5,2,0,0,-1,1,1,1,6,1
KR_6770036173,440,5,-13,24,9,0,1,1,3,4,1,0,4,4,3,5,2,3,3,0,0,13,4,4,1,5,1,0,0,1,1,1,1,1,1
KR_6740888853,420,1,21,-8,6,0,1,1,0,2,2,0,3,3,2,4,2,4,5,1,1,7,14,0,6,6,-3,0,1,1,-1,1,1,5,1
KR_6765308504,420,1,3,-7,-5,-5,0,5,4,5,1,3,6,3,-3,0,3,-4,0,4,-3,-13,-4,-1,5,4,-2,0,-1,-1,1,-1,-1,2,1
KR_6741150418,420,-1,35,3,-2,2,2,0,-1,2,3,-1,2,3,2,3,1,-4,1,5,0,2,12,5,5,10,-8,0,0,-1,1,1,1,4,1
KR_6760670468,420,2,42,3,-2,-7,0,7,2,5,3,3,3,0,0,2,2,0,0,0,0,-4,4,-3,9,6,-3,0,1,1,-1,1,-1,6,1
KR_6767391455,420,0,-52,-16,-5,0,3,3,-3,0,3,2,2,0,-4,2,6,0,1,1,0,-1,-11,-5,8,3,-1,0,-1,-1,-1,-1,-1,3,1
KR_6720758563,420,5,70,42,7,2,3,1,0,2,2,3,3,0,1,2,1,1,1,0,1,14,-2,1,10,11,5,0,1,1,1,1,1,1,1
KR_6747809359,420,1,-6,18,-3,-2,1,3,3,4,1,-1,3,4,0,4,4,-3,0,3,0,-1,-20,4,3,7,26,0,1,1,0,1,1,3,1
KR_6751199254,420,1,10,0,-3,-1,1,2,1,4,3,-4,4,8,1,4,3,0,2,2,0,0,194,-2,9,7,5,0,0,1,-1,0,1,5,1
KR_6775929370,420,-1,55,-10,0,-2,2,4,2,4,2,-2,5,7,3,6,3,-1,1,2,0,-7,-45,-1,11,10,0,0,0,-1,-1,-1,-1,2,1
KR_6777714614,420,0,-63,-5,1,0,2,2,0,1,1,-1,2,3,3,3,0,-1,0,1,0,2,-16,0,6,6,3,0,-1,1,1,-1,-1,2,1
KR_6741716121,420,2,79,16,3,2,3,1,4,7,3,-4,2,6,1,3,2,0,0,0,0,15,-16,-4,10,6,4,0,-1,1,-1,-1,-1,5,1
KR_6697124844,420,1,-20,32,-3,0,2,2,-3,2,5,-3,3,6,1,3,2,2,2,0,-1,-2,14,2,11,13,-6,0,0,1,-1,0,-1,3,1
KR_6699310363,420,-1,-7,7,1,-3,1,4,1,4,3,0,1,1,0,3,3,3,3,0,0,3,-18,0,5,5,-2,0,2,1,1,1,1,4,1
KR_6776639129,420,1,40,15,0,-2,2,4,-2,5,7,3,5,2,-5,0,5,6,10,4,0,-2,1,-3,5,2,-2,0,0,1,1,0,-1,5,1
KR_6777608688,420,1,48,-25,2,-6,0,6,-2,0,2,5,8,3,2,3,1,3,3,0,-1,6,-10,-2,6,4,13,0,0,1,-1,-1,-1,3,1
KR_6776813422,420,-2,-11,27,-9,-2,1,3,-3,1,4,-3,1,4,0,1,1,-1,0,1,0,-9,-14,-2,7,5,3,0,0,-1,1,1,-1,5,1
KR_6774176429,420,-2,-12,21,-4,-4,0,4,3,8,5,0,2,2,-1,0,1,-2,0,2,0,-5,48,1,6,7,2,0,0,1,1,1,1,3,1
KR_6773932367,420,2,-69,-20,6,3,3,0,3,5,2,2,2,0,0,1,1,-2,1,3,0,9,62,4,7,11,-1,0,0,1,1,-1,1,6,1
KR_6775221091,420,1,-4,0,5,2,4,2,0,2,2,5,6,1,2,2,0,-4,0,4,0,4,45,3,5,8,-4,0,0,1,0,0,1,6,1
KR_6735726908,420,0,20,4,-3,-1,1,2,-1,1,2,-1,2,3,-1,2,3,1,1,0,0,-4,-17,0,4,4,2,0,1,-1,1,1,-1,6,1
KR_6773512855,420,-2,1,-9,-4,1,2,1,-2,1,3,-5,1,6,0,1,1,2,2,0,0,-4,20,-1,6,5,-1,0,-2,-1,1,-1,1,3,1
KR_6774627448,420,-2,-4,-39,-2,0,1,1,6,8,2,-4,1,5,-4,2,6,0,0,0,0,-6,-35,-3,8,5,1,0,0,-1,-1,0,1,5,1
KR_6775889914,440,7,37,16,15,5,5,0,3,6,3,1,3,2,7,7,0,-1,0,1,0,19,5,2,7,9,-7,0,3,1,1,1,1,5,1
KR_6766610848,440,1,30,18,2,0,2,2,1,2,1,-3,1,4,-2,3,5,6,7,1,0,5,-11,-3,6,3,13,0,0,1,0,0,1,2,1
KR_6772394527,420,1,64,-1,1,5,5,0,-2,8,10,-2,2,4,2,3,1,-2,0,2,0,-10,-4,2,5,7,-5,0,1,1,-1,1,1,4,1
KR_6755678531,420,3,8,2,12,-2,1,3,5,5,0,-1,2,3,8,8,0,2,2,0,1,25,57,7,1,8,-7,0,0,1,1,1,1,5,1
KR_6711520496,420,2,-17,0,4,0,2,2,4,9,5,-1,1,2,2,4,2,-1,1,2,0,14,37,-1,7,6,-6,0,1,1,1,1,-1,5,1
KR_6777595863,420,7,118,-5,14,6,8,2,1,6,5,3,3,0,2,3,1,2,3,1,0,5,11,-3,7,4,5,0,2,1,1,1,1,4,1
KR_6765449610,420,-3,-68,-4,5,2,2,0,3,5,2,0,4,4,1,2,1,-1,7,8,3,10,-259,2,3,5,1,0,-1,-1,1,1,1,5,1
KR_6754750024,420,0,32,-28,4,5,7,2,0,1,1,0,2,2,2,3,1,-3,1,4,0,9,15,2,3,5,-2,0,1,-1,1,1,1,5,1
KR_6774499295,420,5,90,25,7,4,5,1,-1,0,1,2,4,2,0,2,2,2,2,0,0,8,-1,1,4,5,4,0,1,1,-1,1,1,3,1
KR_6769952918,420,4,89,-1,10,0,1,1,3,4,1,1,3,2,5,5,0,1,1,0,0,12,-46,-4,9,5,-27,0,3,1,1,1,1,4,1
KR_6760520257,420,-3,11,5,-7,-4,0,4,1,1,0,2,3,1,-4,0,4,-2,0,2,0,-13,-4,0,6,6,-4,0,0,1,-1,-1,1,6,1
KR_6760119096,420,-1,30,7,0,-3,3,6,3,5,2,2,2,0,0,2,2,-2,0,2,-1,-1,3,6,2,8,-4,0,1,0,1,1,-1,0,1
KR_6775175461,420,1,4,13,5,-1,0,1,1,4,3,4,5,1,1,4,3,0,1,1,0,4,34,4,4,8,-2,0,1,1,1,1,1,1,1
KR_6769066538,420,6,114,47,9,1,2,1,0,3,3,3,4,1,2,3,1,3,3,0,0,3,-1,-4,9,5,-1,0,2,-1,1,1,1,4,1
KR_6742419585,440,-3,10,-9,0,2,3,1,-1,0,1,3,4,1,-4,0,4,0,0,0,0,-6,17,2,1,3,-4,0,1,-1,1,1,1,5,1
KR_6775180635,420,1,14,-21,8,-2,1,3,2,2,0,4,7,3,5,7,2,-1,0,1,-1,7,-2,-1,5,4,3,0,0,1,-1,-1,-1,5,1
KR_6773825564,420,0,7,14,7,3,5,2,-1,3,4,4,4,0,4,6,2,-3,0,3,1,5,15,4,5,9,-8,0,0,-1,1,1,1,2,1
KR_6770931114,420,-1,-11,1,-1,-1,3,4,-1,1,2,0,2,2,0,2,2,1,1,0,0,1,-6,0,7,7,1,0,1,1,1,1,1,1,1
KR_6743758515,420,8,116,21,12,4,4,0,3,3,0,4,4,0,1,1,0,0,0,0,0,9,15,5,4,9,3,0,5,1,1,1,1,5,1
KR_6769184750,420,2,67,36,1,2,3,1,-1,2,3,2,3,1,-2,3,5,0,0,0,0,-3,5,-1,7,6,3,0,0,1,-1,0,-1,5,1
KR_6774179957,420,1,-34,-2,11,3,3,0,4,4,0,2,2,0,-1,0,1,3,3,0,0,14,3,-6,12,6,2,0,1,1,1,1,1,4,1
KR_6772539739,420,3,27,13,11,6,6,0,3,4,1,3,6,3,0,1,1,-1,0,1,0,1,-22,5,4,9,2,0,1,-1,1,1,1,2,1
KR_6734321852,440,2,-27,8,9,-1,1,2,7,9,2,1,2,1,-1,1,2,3,5,2,0,12,-7,0,5,5,-2,0,0,1,0,1,1,3,1
KR_6775213071,420,-3,-7,20,-2,-1,0,1,5,7,2,-2,2,4,-1,3,4,-3,0,3,0,-7,10,0,3,3,3,0,0,-1,1,0,1,3,1
KR_6764028400,420,1,-50,24,3,0,3,3,1,4,3,2,5,3,-3,2,5,3,3,0,0,0,-6,2,5,7,6,0,0,1,1,-1,1,2,1
KR_6726765081,420,1,8,12,4,-1,1,2,6,8,2,5,8,3,-6,0,6,0,1,1,-1,-7,11,-1,8,7,-2,0,1,1,1,-1,-1,1,1
KR_6771482913,420,4,-13,12,12,3,3,0,3,6,3,0,3,3,4,4,0,2,2,0,2,27,-39,1,6,7,23,0,2,1,1,1,1,4,1
KR_6772547038,420,1,19,-20,0,5,5,0,1,5,4,-5,0,5,0,3,3,-1,1,2,-1,-11,1,3,5,8,-1,0,2,-1,1,1,-1,6,1
KR_6744175503,420,0,-20,-3,4,7,7,0,0,4,4,1,2,1,-3,1,4,-1,1,2,-2,0,22,0,8,8,0,0,1,1,1,1,-1,6,1
KR_6725036737,420,1,-18,43,1,-2,0,2,-3,0,3,4,4,0,2,5,3,0,2,2,0,-5,-23,-4,7,3,-5,0,2,-1,1,1,-1,6,1
KR_6773125648,420,5,21,46,7,-3,2,5,2,2,0,0,2,2,5,5,0,3,3,0,0,12,27,-4,10,6,6,0,1,1,-1,1,1,4,1
KR_6770044302,420,3,94,-13,7,4,4,0,4,6,2,-4,1,5,3,6,3,0,2,2,0,7,16,3,7,10,-1,0,0,1,-1,0,1,4,1
KR_6770960877,420,1,25,13,4,1,4,3,0,4,4,2,2,0,1,2,1,0,0,0,0,-1,6,1,7,8,5,0,2,-1,1,1,1,3,1
KR_6776815335,420,-1,41,-16,-3,1,3,2,0,6,6,0,3,3,-2,2,4,-2,0,2,0,-4,-7,0,5,5,2,0,1,1,-1,1,1,3,1
KR_6712404988,420,0,12,-6,-3,-2,0,2,3,4,1,-4,4,8,1,3,2,-1,0,1,0,-11,-25,0,7,7,-1,0,1,-1,-1,1,1,6,1
KR_6777029430,420,7,117,43,11,3,3,0,6,6,0,6,8,2,-1,3,4,-3,0,3,0,6,-3,-4,13,9,6,0,3,1,1,1,1,4,1
KR_6761369920,420,0,28,-18,1,0,0,0,-3,1,4,4,5,1,0,3,3,0,2,2,-1,2,0,3,4,7,0,0,0,-1,0,0,-1,4,1
KR_6777077063,420,2,69,-16,0,0,5,5,-4,1,5,5,5,0,0,2,2,-1,0,1,0,14,2,0,7,7,2,0,-1,1,-1,-1,-1,4,1
KR_6774264149,420,1,10,27,10,3,3,0,3,5,2,4,8,4,0,0,0,0,0,0,0,8,2,1,3,4,3,0,2,1,1,1,1,6,1
KR_6770097115,440,1,-3,13,3,3,5,2,3,5,2,0,1,1,-2,1,3,-1,2,3,0,4,3,-1,6,5,-2,0,0,1,-1,0,-1,4,1
KR_6718745517,420,3,30,20,10,0,2,2,2,4,2,2,2,0,6,7,1,0,1,1,0,14,8,4,3,7,3,0,3,1,1,1,1,3,1
KR_6776485136,420,-1,7,-4,-2,0,1,1,-1,2,3,0,2,2,2,2,0,-3,1,4,0,-8,0,2,4,6,-9,0,0,-1,1,-1,-1,1,1
KR_6777718043,420,-4,-74,17,3,-2,1,3,4,4,0,0,0,0,1,3,2,0,0,0,0,9,-16,2,3,5,-4,0,0,1,1,0,1,5,1
KR_6731043049,420,5,82,49,9,0,1,1,7,11,4,5,5,0,-1,4,5,-2,0,2,0,2,12,-4,9,5,7,0,2,1,1,1,1,2,1
KR_6736114122,420,1,36,3,5,2,4,2,0,4,4,0,1,1,3,4,1,0,0,0,0,7,-46,4,5,9,0,0,0,-1,1,1,-1,6,1
KR_6738223372,440,-2,-55,-35,3,-5,0,5,1,6,5,1,1,0,1,3,2,5,7,2,0,9,-2,2,5,7,5,0,0,-1,-1,-1,-1,3,1
KR_6731094774,420,1,113,22,2,0,0,0,4,6,2,0,1,1,-1,5,6,-1,1,2,-2,2,-9,0,7,7,7,0,1,1,1,1,-1,3,1
KR_6748605773,420,1,8,70,4,1,3,2,0,3,3,3,4,1,1,1,0,-1,0,1,0,4,11,1,4,5,0,0,1,1,1,1,-1,2,1
KR_6774125730,420,2,18,-21,3,-1,2,3,-2,2,4,3,5,2,3,4,1,0,0,0,0,0,22,2,6,8,0,0,0,1,1,-1,1,6,1
KR_6716101480,420,2,47,-20,6,0,1,1,4,5,1,0,3,3,1,4,3,1,1,0,0,15,-17,1,5,6,25,0,-1,1,-1,-1,-1,1,1
KR_6773498832,420,0,-21,-12,6,0,0,0,0,1,1,2,2,0,3,3,0,1,1,0,0,13,-6,-1,8,7,9,0,0,-1,1,0,1,4,1
KR_6715242584,440,-3,-158,7,0,2,3,1,0,1,1,-3,1,4,-1,1,2,2,2,0,0,1,1,1,5,6,-2,0,-3,0,-1,-1,1,0,1
KR_6776289342,420,2,-7,17,-1,-3,0,3,1,3,2,2,3,1,-3,0,3,2,2,0,0,-5,-35,1,6,7,-3,0,0,1,-1,0,-1,1,1
KR_6776465075,420,1,-5,4,3,2,3,1,2,5,3,1,2,1,-4,2,6,2,4,2,1,7,4,0,5,5,-2,0,-1,1,-1,-1,1,6,1
KR_6741613139,420,2,25,-4,-1,3,8,5,-1,0,1,-3,1,4,2,4,2,-2,3,5,0,-9,2,-3,8,5,1,0,2,1,1,1,1,2,1
KR_6751365037,440,2,76,-22,4,-1,1,2,0,1,1,3,5,2,1,5,4,1,2,1,0,-5,2,-4,5,1,1,0,2,-1,1,1,1,3,1
KR_6736452706,420,-3,-33,5,-10,-2,1,3,-5,1,6,-1,2,3,-2,0,2,0,0,0,0,-16,-27,-4,6,2,4,0,-1,1,1,1,-1,1,1
KR_6753376159,420,1,-7,-4,7,6,8,2,-4,4,8,4,7,3,2,4,2,-1,1,2,1,15,26,0,5,5,4,0,-1,-1,1,-1,-1,6,1
KR_6738167718,420,5,97,37,18,6,8,2,5,8,3,2,3,1,3,5,2,2,2,0,1,19,3,3,4,7,-1,0,3,1,1,1,1,3,1
KR_6735238631,420,1,16,-57,5,-1,0,1,2,5,3,1,3,2,2,4,2,1,2,1,2,11,-9,1,6,7,-2,0,0,1,-1,-1,1,3,1
KR_6776587890,420,1,-26,-2,6,4,6,2,-1,1,2,7,9,2,-3,2,5,-1,1,2,0,12,8,3,6,9,-6,0,1,1,1,1,1,1,1
KR_6769568968,420,0,42,17,5,1,1,0,8,8,0,5,5,0,-7,3,10,-2,2,4,0,8,13,4,5,9,-1,0,1,-1,1,1,-1,1,1
KR_6775197678,420,0,40,-2,-1,1,2,1,1,4,3,-4,0,4,1,5,4,0,1,1,0,1,-9,-1,5,4,12,0,0,0,-1,0,1,0,1
KR_6714448352,420,2,13,12,4,-3,3,6,2,2,0,2,4,2,3,3,0,0,2,2,0,8,-18,3,3,6,6,0,2,1,1,1,-1,6,1
KR_6723750750,420,3,25,0,16,1,3,2,12,12,0,-4,2,6,7,7,0,0,1,1,0,19,27,0,5,5,4,0,0,0,1,1,1,0,1
KR_6772322792,420,2,-21,11,2,0,2,2,-1,2,3,0,1,1,2,6,4,1,1,0,0,-2,9,4,6,10,0,0,0,-1,1,0,1,6,1
KR_6734794924,420,2,39,-8,5,-1,1,2,0,1,1,4,5,1,1,2,1,1,1,0,0,3,-5,3,8,11,-9,0,0,-1,1,1,1,2,1
KR_6737133245,420,3,22,32,4,2,2,0,-2,3,5,4,6,2,1,3,2,-1,1,2,0,3,54,3,4,7,-4,0,0,1,-1,0,-1,5,1
KR_6761629254,420,3,68,25,8,1,2,1,0,5,5,2,3,1,5,8,3,0,3,3,1,11,-2,1,4,5,0,0,0,1,-1,1,1,2,1
KR_6740076015,420,-1,6,8,2,-2,1,3,1,4,3,0,2,2,2,5,3,1,3,2,1,3,-2,-3,8,5,-2,0,0,0,-1,-1,1,0,1
KR_6777143868,420,-5,-41,0,-6,-3,1,4,5,7,2,-6,1,7,-1,1,2,-1,1,2,0,-3,-14,-5,10,5,-2,0,-2,-1,1,-1,-1,6,1
KR_6774703453,420,7,45,20,16,1,3,2,4,4,0,4,4,0,3,4,1,4,5,1,0,16,2,3,3,6,-2,0,3,1,1,1,1,5,1
KR_6708580789,420,1,27,-4,1,0,4,4,0,3,3,1,2,1,0,5,5,0,1,1,0,-9,3,-2,11,9,-2,0,-1,-1,-1,-1,1,2,1
KR_6777482683,420,-2,-13,7,-3,1,2,1,2,5,3,-3,1,4,-3,2,5,0,1,1,0,-8,18,-1,6,5,-2,0,-1,-1,-1,1,-1,5,1
KR_6760093205,420,2,22,-2,6,2,5,3,4,8,4,4,4,0,-3,4,7,-1,1,2,1,8,-106,-5,7,2,5,0,0,1,1,1,1,1,1
KR_6762041046,420,1,-6,-5,0,-2,4,6,2,6,4,0,2,2,0,3,3,0,0,0,-2,1,4,2,5,7,6,0,-1,1,1,-1,-1,2,1
KR_6709750150,420,1,-10,16,-2,1,2,1,-2,5,7,5,6,1,-3,1,4,-3,0,3,0,-4,-5,-4,12,8,1,0,-2,1,1,-1,-1,4,1
KR_6726669851,420,1,42,-8,-3,0,2,2,-5,1,6,-2,1,3,2,4,2,2,2,0,0,-17,-10,5,5,10,-4,0,1,-1,1,1,1,1,1
KR_6768619810,420,1,54,20,4,1,1,0,1,8,7,-2,2,4,5,5,0,-1,2,3,0,13,2,6,0,6,-2,0,1,-1,1,1,-1,1,1
KR_6776826676,420,6,98,31,13,7,8,1,3,5,2,3,4,1,-2,3,5,2,2,0,1,8,-14,2,6,8,5,0,2,1,-1,1,1,4,1
KR_6710553089,420,1,-78,4,8,2,2,0,2,4,2,5,6,1,0,4,4,-1,0,1,0,10,2,0,7,7,-5,0,0,1,1,1,1,3,1
KR_6756632537,420,1,3,-7,1,0,0,0,1,3,2,-4,0,4,3,4,1,1,1,0,0,8,2,0,7,7,-3,0,0,-1,-1,0,1,1,1
KR_6742343775,420,4,34,37,1,0,2,2,1,4,3,-3,1,4,1,7,6,2,2,0,0,-5,51,2,6,8,2,0,1,-1,1,1,-1,6,1
KR_6706689986,420,2,60,-17,8,2,2,0,4,6,2,0,1,1,1,2,1,1,2,1,0,9,-6,-2,8,6,-1,0,2,-1,1,1,1,2,1
KR_6748128427,420,2,5,-17,5,2,2,0,0,1,1,-3,2,5,5,8,3,1,1,0,0,9,21,1,7,8,-6,0,1,1,1,1,-1,5,1
KR_6754631447,420,3,30,-4,16,0,1,1,9,10,1,2,3,1,2,6,4,3,3,0,1,17,-3,2,3,5,0,0,0,1,1,-1,1,4,1
KR_6775518883,420,2,5,-2,5,3,4,1,-3,5,8,1,1,0,3,4,1,1,1,0,0,8,4,5,4,9,-2,0,1,-1,1,1,-1,5,1
KR_6761913407,420,1,-4,12,2,4,4,0,-1,1,2,2,4,2,-3,1,4,0,0,0,1,4,-12,-5,8,3,4,0,1,0,-1,1,1,0,1
KR_6740636069,420,0,12,4,1,5,5,0,-2,3,5,-2,1,3,1,4,3,-1,0,1,0,-5,-18,-2,5,3,-5,0,1,-1,1,1,-1,2,1
KR_6716587074,420,0,6,8,-2,-1,2,3,-2,0,2,-1,3,4,2,3,1,0,1,1,0,-7,4,-6,8,2,-2,0,1,1,1,1,1,1,1
KR_6719897663,420,3,54,2,4,1,1,0,3,5,2,3,3,0,-1,2,3,-2,0,2,0,1,-14,-1,6,5,8,0,0,1,1,0,1,4,1
KR_6774510844,420,3,33,40,3,2,4,2,-5,2,7,6,7,1,0,1,1,0,1,1,1,1,23,2,4,6,-1,0,2,-1,1,1,-1,2,1
KR_6775596285,420,1,2,-8,4,1,1,0,4,9,5,0,2,2,-2,3,5,1,1,0,0,6,-5,-5,9,4,2,0,2,-1,1,1,-1,2,1
KR_6777014275,420,0,-19,-31,2,-1,1,2,1,2,1,3,3,0,0,3,3,-1,1,2,0,2,5,0,7,7,1,0,-1,1,1,-1,1,6,1
KR_6739975704,420,2,-8,31,6,1,2,1,3,6,3,2,2,0,0,2,2,0,0,0,0,6,2,1,5,6,0,0,2,1,1,1,1,4,1
KR_6744371493,420,5,27,34,9,4,4,0,0,0,0,0,0,0,2,4,2,3,3,0,0,8,-2,-3,8,5,-3,0,1,0,1,1,1,0,1
KR_6710614514,420,8,78,18,22,1,1,0,-9,3,12,4,4,0,22,24,2,4,4,0,3,20,10,4,4,8,0,0,4,-1,-1,1,-1,4,1
KR_6765116298,420,6,67,20,3,-1,1,2,-2,1,3,3,3,0,2,2,0,1,1,0,0,2,3,0,5,5,1,0,2,1,-1,1,1,6,1
KR_6743957396,420,2,-26,14,-5,2,3,1,2,6,4,0,2,2,-7,2,9,-2,0,2,0,-10,6,-1,8,7,2,0,-1,1,1,-1,1,1,1
KR_6757762911,420,2,33,-7,11,7,8,1,2,3,1,2,3,1,-1,2,3,1,2,1,0,1,-30,-5,7,2,2,0,0,-1,1,1,1,6,1
KR_6759375227,420,1,10,31,3,4,5,1,1,5,4,1,2,1,-2,1,3,-1,2,3,0,2,-17,1,4,5,1,0,0,1,1,1,-1,5,1
KR_6744742573,420,3,67,46,7,3,4,1,4,6,2,1,2,1,0,1,1,-1,0,1,0,1,13,2,4,6,7,0,2,1,-1,1,1,4,1
KR_6741088928,420,1,26,20,3,0,2,2,0,5,5,-1,1,2,3,5,2,1,2,1,0,5,34,2,8,10,3,0,1,-1,1,1,-1,5,1
KR_6771042807,420,1,31,12,-5,1,3,2,-5,0,5,0,3,3,-1,0,1,0,0,0,0,-6,-1,-2,9,7,-1,0,-1,0,1,-1,-1,0,1
KR_6777641888,420,2,46,3,4,-1,2,3,3,8,5,1,2,1,0,1,1,1,1,0,0,-2,-44,0,4,4,0,0,-1,-1,1,1,-1,4,1
KR_6776573027,420,1,47,-21,10,1,3,2,0,2,2,-1,2,3,5,5,0,5,5,0,0,15,4,1,4,5,-3,0,1,1,-1,1,1,3,1
KR_6736197599,420,-3,-46,-12,-5,-2,0,2,0,1,1,-1,0,1,-1,1,2,-1,1,2,0,-6,43,-2,8,6,-4,0,-1,-1,-1,-1,1,6,1
KR_6772127394,420,1,-14,-24,5,-4,0,4,6,6,0,1,2,1,2,3,1,0,0,0,0,9,3,-2,6,4,7,0,1,1,1,1,-1,5,1
KR_6777777169,420,6,103,11,5,-1,1,2,-3,4,7,-3,5,8,10,11,1,2,3,1,1,0,239,-7,10,3,6,0,1,1,1,1,-1,5,1
KR_6748675457,440,2,-18,8,7,-1,3,4,4,5,1,4,4,0,-1,3,4,1,2,1,0,3,14,-3,5,2,-2,0,1,1,1,1,-1,6,1
KR_6772933067,420,3,56,9,-3,-4,0,4,2,5,3,-1,3,4,-1,4,5,1,1,0,0,-5,-18,2,6,8,-2,0,1,1,1,1,1,4,1
KR_6771646277,440,3,45,8,11,1,1,0,3,3,0,-1,0,1,8,8,0,0,0,0,0,10,-4,6,3,9,4,0,2,1,1,1,1,6,1
KR_6752395983,420,-1,1,-8,1,-2,0,2,0,0,0,2,4,2,2,4,2,-1,3,4,0,-4,-9,5,3,8,1,0,1,1,1,1,-1,2,1
KR_6775677905,420,1,9,-15,6,-1,0,1,-1,3,4,-1,5,6,9,10,1,0,0,0,0,19,-2,2,4,6,-1,0,2,1,1,1,1,2,1
KR_6743028077,420,6,140,-21,14,1,1,0,8,9,1,5,5,0,0,1,1,0,0,0,0,10,27,6,6,12,8,0,2,-1,1,1,1,6,1
KR_6720640191,420,2,2,-3,2,1,2,1,0,2,2,2,3,1,0,4,4,-1,1,2,0,4,-8,-6,10,4,1,0,0,-1,1,0,-1,4,1
KR_6776359757,420,2,40,7,8,5,6,1,3,5,2,-2,0,2,1,5,4,1,1,0,0,3,3,-2,9,7,3,0,0,1,1,1,1,6,1
KR_6771389602,420,4,43,-9,4,-1,2,3,3,4,1,0,3,3,1,3,2,1,1,0,0,6,34,1,6,7,-4,0,1,-1,1,1,1,6,1
KR_6706949753,420,2,-14,47,10,2,2,0,5,9,4,0,0,0,1,4,3,2,3,1,0,12,-5,-2,4,2,7,0,2,1,1,1,1,1,1
KR_6744500580,420,3,-27,31,4,-1,1,2,5,9,4,1,4,3,0,4,4,-1,2,3,0,10,-289,0,6,6,4,0,0,-1,-1,-1,-1,5,1
KR_6777686408,420,2,44,12,7,0,1,1,-4,1,5,5,6,1,5,5,0,1,1,0,0,2,-179,3,5,8,5,0,1,1,1,1,-1,6,1
KR_6776488644,420,-2,-30,20,-3,0,0,0,-3,4,7,0,2,2,-1,0,1,1,1,0,0,-6,16,2,4,6,-6,0,0,-1,1,0,1,2,1
KR_6764875732,420,1,14,13,-1,1,2,1,-4,1,5,-2,2,4,5,5,0,-1,1,2,0,1,-17,0,8,8,5,0,0,1,-1,0,-1,1,1
KR_6777533743,420,5,66,11,13,0,1,1,3,4,1,2,4,2,5,10,5,3,5,2,0,9,7,0,8,8,-5,0,2,1,-1,1,1,1,1
KR_6775010207,420,1,17,-37,3,1,3,2,-3,2,5,-1,1,2,3,4,1,3,5,2,0,4,-10,-5,7,2,6,0,1,-1,1,1,-1,1,1
KR_6721759563,420,2,12,0,5,2,4,2,4,5,1,-2,1,3,1,3,2,0,0,0,0,1,-8,-4,8,4,0,0,1,1,1,1,1,2,1
KR_6770356769,440,1,-41,0,-3,-6,1,7,0,1,1,0,2,2,-1,4,5,4,4,0,0,7,30,5,2,7,0,0,0,1,-1,-1,1,2,1
KR_6729258156,420,4,40,-5,10,1,2,1,-1,4,5,6,7,1,2,6,4,2,2,0,0,4,-10,-3,9,6,7,0,1,1,1,1,1,6,1
KR_6773871534,420,0,-39,24,-2,-2,2,4,-2,2,4,-4,0,4,6,9,3,0,1,1,-1,5,0,-1,5,4,-3,0,0,1,1,1,-1,1,1
KR_6770387876,440,4,23,-16,3,-4,3,7,-1,0,1,4,5,1,3,5,2,1,1,0,0,-4,-13,0,2,2,1,0,0,-1,-1,1,-1,4,1
KR_6762499055,420,1,-8,23,2,1,3,2,-3,1,4,2,4,2,4,5,1,-2,1,3,0,5,-4,1,4,5,0,0,-1,-1,1,1,-1,1,1
KR_6748489184,420,3,26,-3,6,3,3,0,0,1,1,2,5,3,1,1,0,0,0,0,0,7,2,-4,9,5,4,0,0,-1,1,1,-1,5,1
KR_6771135807,420,0,-12,-20,3,1,3,2,-2,3,5,0,1,1,6,7,1,-2,0,2,0,4,-19,-1,4,3,3,0,0,-1,1,1,1,4,1
KR_6743122484,420,0,-5,-18,7,-3,0,3,1,3,2,1,1,0,4,5,1,4,4,0,0,11,23,3,3,6,2,0,0,1,-1,1,1,3,1
KR_6765533743,420,-2,-6,-4,-12,2,2,0,-6,0,6,0,4,4,-9,2,11,1,2,1,0,-13,36,3,7,10,-8,0,0,-1,-1,1,-1,6,1
KR_6770907570,420,-2,-4,18,-3,-4,1,5,-1,2,3,-2,3,5,2,4,2,2,2,0,0,8,26,-2,7,5,-24,0,0,1,-1,0,-1,6,1
KR_6776238633,420,5,68,6,4,1,4,3,1,2,1,0,5,5,5,7,2,-3,1,4,0,-5,-12,8,3,11,10,0,2,1,-1,1,1,5,1
KR_6766149285,440,0,83,1,-6,1,3,2,-3,3,6,-2,0,2,-3,3,6,1,1,0,0,-11,12,3,2,5,-1,0,1,1,0,1,1,6,1
KR_6766058251,420,3,78,-8,0,3,4,1,0,2,2,-2,2,4,2,6,4,-3,1,4,0,-2,-9,-2,6,4,-3,0,2,-1,1,1,-1,3,1
KR_6709022183,420,4,98,31,9,2,3,1,2,4,2,-2,2,4,7,10,3,0,0,0,0,18,7,3,7,10,7,0,1,1,1,1,1,2,1
KR_6736708214,420,-2,78,-22,0,0,4,4,-1,1,2,-2,0,2,4,6,2,-1,0,1,-1,6,-3,1,6,7,7,0,1,1,1,1,-1,2,1
KR_6732946377,420,5,29,18,9,1,1,0,5,8,3,1,1,0,0,1,1,2,2,0,0,14,55,-1,7,6,1,0,1,1,1,1,-1,4,1
KR_6764524424,420,3,24,-3,4,0,1,1,1,5,4,1,1,0,1,5,4,1,2,1,2,-2,-27,-1,8,7,6,0,1,-1,1,1,1,6,1
KR_6741465565,420,-2,40,-30,-1,1,1,0,-1,2,3,-5,0,5,4,5,1,0,0,0,0,-9,-16,2,5,7,-1,0,2,1,1,1,1,4,1
KR_6733759064,420,0,7,-4,-1,-2,2,4,-4,1,5,2,3,1,3,5,2,0,1,1,0,1,28,-2,8,6,5,0,-1,-1,-1,-1,1,1,1
KR_6744040062,420,-2,6,-22,2,-1,0,1,2,4,2,5,8,3,0,1,1,-4,0,4,0,-5,-2,3,3,6,-1,0,-1,1,-1,-1,-1,6,1
KR_6735953311,420,0,40,32,-2,0,1,1,-1,1,2,-1,0,1,1,1,0,-1,0,1,-1,-2,-3,0,8,8,2,0,0,-1,1,1,-1,2,1
KR_6746931162,420,2,91,30,10,1,3,2,5,10,5,4,4,0,-2,3,5,2,2,0,2,12,31,-5,12,7,5,0,3,1,1,1,1,6,1
KR_6752809242,420,1,-60,20,1,1,2,1,3,7,4,0,3,3,-5,1,6,2,2,0,0,1,36,0,5,5,3,0,-2,1,1,1,-1,1,1
KR_6719922398,420,4,38,12,8,3,4,1,0,2,2,3,5,2,2,5,3,0,3,3,1,7,-8,-4,12,8,-3,0,0,-1,1,0,-1,5,1
KR_6777607644,440,3,39,-1,8,3,5,2,2,2,0,4,5,1,-1,2,3,0,1,1,-1,7,-7,2,5,7,-5,0,1,-1,1,1,-1,6,1
KR_6777283778,420,0,24,17,3,1,1,0,4,5,1,0,1,1,-3,5,8,1,3,2,0,-4,-9,-6,12,6,0,0,1,1,1,-1,-1,4,1
KR_6768474675,440,1,-22,0,7,-1,2,3,1,2,1,1,3,2,1,2,1,5,6,1,1,14,-5,4,1,5,-2,0,0,0,1,0,1,0,1
KR_6763580054,440,0,-15,-3,7,0,1,1,-2,3,5,4,5,1,2,2,0,3,4,1,0,12,-5,0,4,4,7,0,1,1,1,1,1,4,1
KR_6775739611,420,7,68,8,13,4,5,1,1,1,0,0,2,2,8,11,3,0,0,0,0,15,-238,-2,4,2,6,0,2,1,1,1,-1,1,1
KR_6706841387,420,2,25,1,8,0,2,2,2,2,0,2,2,0,4,7,3,0,0,0,0,17,6,2,7,9,0,0,1,1,1,1,-1,2,1
KR_6769027039,420,0,27,-21,-1,-3,1,4,4,7,3,-2,0,2,0,1,1,0,1,1,0,-1,0,-3,6,3,-1,0,0,1,-1,-1,-1,5,1
KR_6739789134,440,3,14,4,2,1,4,3,1,4,3,0,2,2,-1,2,3,1,2,1,0,2,-3,-3,6,3,0,0,0,-1,0,-1,-1,2,1
KR_6737170890,420,3,16,11,1,-2,1,3,0,1,1,3,7,4,0,3,3,0,1,1,0,-9,5,0,6,6,2,0,2,1,1,1,1,5,1
KR_6766650917,420,2,65,17,3,0,2,2,8,9,1,2,7,5,-7,2,9,0,1,1,2,2,43,6,1,7,-2,0,4,0,1,1,1,0,1
KR_6773421229,420,-3,14,-33,-5,-1,2,3,-1,2,3,-3,0,3,2,4,2,-2,1,3,0,-5,-9,-3,7,4,0,0,0,0,-1,0,-1,0,1
KR_6755465627,420,3,105,-4,13,4,5,1,2,7,5,6,6,0,1,2,1,0,0,0,0,7,-1,3,2,5,2,0,2,1,1,1,1,6,1
KR_6776600738,420,2,4,-12,2,1,2,1,1,1,0,-1,4,5,-4,4,8,5,8,3,0,3,0,-3,13,10,2,0,-1,-1,-1,-1,-1,5,1
KR_6746497202,420,2,42,25,6,6,6,0,1,3,2,-3,1,4,0,2,2,2,2,0,0,-3,1,0,6,6,1,0,-1,1,1,-1,1,5,1
KR_6758738320,420,4,14,11,11,2,3,1,0,3,3,2,4,2,6,9,3,1,2,1,0,15,37,4,6,10,8,0,0,1,1,1,-1,2,1
KR_6711087581,420,6,21,60,8,3,3,0,-2,1,3,6,7,1,1,1,0,0,1,1,0,5,11,5,3,8,1,0,1,1,1,1,1,4,1
KR_6742379602,420,0,0,-19,-6,-1,0,1,-2,4,6,1,3,2,-3,2,5,-1,1,2,0,-3,-3,1,9,10,-1,0,0,1,1,1,1,2,1
KR_6767333136,420,0,-15,2,6,-1,2,3,2,4,2,7,9,2,1,4,3,-3,1,4,-2,10,-6,-1,7,6,-2,0,-1,-1,-1,-1,-1,4,1
KR_6775728113,420,4,22,25,10,4,4,0,4,6,2,0,3,3,1,3,2,1,1,0,0,7,-1,0,6,6,2,0,0,1,1,1,1,4,1
KR_6746706081,420,4,51,16,15,4,5,1,8,8,0,1,2,1,-3,0,3,5,5,0,0,18,5,-3,6,3,2,0,1,1,1,1,1,4,1
KR_6762690674,440,2,23,-3,0,-1,0,1,-1,3,4,1,4,3,3,3,0,-2,0,2,1,-2,7,0,9,9,-6,0,0,1,0,1,1,6,1
KR_6743062465,420,1,-58,-17,3,0,2,2,-1,2,3,2,2,0,-2,2,4,4,6,2,0,3,15,-2,6,4,-1,0,0,-1,1,-1,-1,2,1
KR_6749174137,420,4,79,-22,12,1,4,3,3,4,1,-1,4,5,10,10,0,-1,0,1,1,13,-18,2,3,5,-1,0,2,0,1,1,1,0,1
KR_6753853652,420,2,67,-19,4,0,1,1,4,6,2,3,7,4,0,2,2,-3,0,3,0,4,6,1,5,6,-3,0,0,1,-1,-1,1,2,1
KR_6769593325,420,1,-4,-1,9,0,2,2,2,4,2,1,3,2,5,5,0,1,1,0,0,15,-164,-3,12,9,2,0,0,1,1,1,1,1,1
KR_6770492888,420,4,34,-13,11,1,3,2,5,8,3,1,4,3,1,6,5,3,4,1,0,12,6,4,2,6,-5,0,0,0,0,0,1,0,1
KR_6734802251,420,1,-3,8,5,-2,0,2,0,2,2,-1,2,3,4,4,0,4,4,0,0,9,9,1,6,7,-1,0,0,1,-1,0,1,2,1
KR_6755452278,420,1,-4,33,7,-1,2,3,0,2,2,5,5,0,5,5,0,-2,1,3,0,1,-12,2,4,6,1,0,-1,1,-1,-1,-1,4,1
KR_6772986859,420,0,4,-20,0,0,2,2,2,5,3,-1,0,1,0,3,3,-1,1,2,0,-4,21,2,5,7,-3,0,0,1,-1,0,-1,4,1
KR_6748204397,420,3,76,24,6,1,2,1,0,2,2,3,6,3,0,6,6,2,5,3,-1,-1,-6,-2,5,3,0,0,2,1,1,1,1,1,1
KR_6777783201,420,-1,-5,-4,0,-2,2,4,-1,3,4,1,3,2,2,5,3,0,0,0,-2,-1,-195,-3,8,5,0,0,1,1,1,-1,-1,4,1
KR_6720456262,420,1,11,-4,11,1,1,0,0,3,3,3,3,0,7,9,2,0,0,0,2,18,5,5,5,10,2,0,1,1,1,1,1,5,1
KR_6720728961,420,-1,-39,15,2,-8,1,9,1,1,0,1,3,2,6,6,0,2,2,0,1,18,-4,2,8,10,1,0,-2,1,-1,-1,1,3,1
KR_6774444060,420,-3,32,-16,-3,-2,0,2,0,1,1,-1,1,2,1,2,1,-1,2,3,0,-1,25,3,3,6,-5,0,1,-1,1,1,1,5,1
KR_6774379687,420,1,-4,1,1,-1,0,1,-1,3,4,0,2,2,2,4,2,1,2,1,0,2,58,-1,8,7,2,0,0,-1,1,0,-1,2,1
KR_6763672538,420,1,-19,7,-4,-3,1,4,5,5,0,0,3,3,-6,1,7,0,1,1,0,-3,6,1,6,7,-2,0,-1,-1,1,-1,-1,3,1
KR_6735686986,420,5,17,51,10,-1,1,2,5,7,2,-2,2,4,7,8,1,1,2,1,1,17,3,0,5,5,2,0,2,1,1,1,1,5,1
KR_6769029635,420,4,76,-8,5,-2,1,3,1,1,0,2,4,2,3,4,1,1,2,1,0,8,5,7,1,8,2,0,0,-1,1,1,1,1,1
KR_6721738498,420,4,-23,17,4,-1,2,3,2,4,2,-1,1,2,3,4,1,1,2,1,0,6,-4,-6,8,2,-3,0,1,1,1,1,-1,3,1
KR_6760605815,420,0,15,-3,0,-5,4,9,2,4,2,0,3,3,1,6,5,2,3,1,0,-5,7,4,5,9,-8,0,-1,1,1,-1,-1,2,1
KR_6764257537,420,0,64,-4,-7,-3,0,3,-1,0,1,-4,3,7,2,5,3,-1,2,3,-1,-3,-22,1,6,7,2,0,1,-1,1,1,-1,6,1
KR_6776746919,420,-1,-30,2,4,1,3,2,1,3,2,-1,2,3,2,2,0,1,2,1,0,4,17,3,2,5,2,0,0,1,1,1,-1,2,1
KR_6776442876,420,0,15,-37,3,2,3,1,-1,2,3,-3,0,3,4,4,0,1,1,0,0,3,0,2,4,6,-1,0,0,-1,-1,0,1,2,1
KR_6771939353,420,0,-34,4,-6,-2,1,3,3,4,1,0,3,3,-4,1,5,-3,0,3,0,-10,-5,-3,8,5,3,0,0,-1,-1,-1,-1,3,1
KR_6740503469,420,5,86,7,14,4,6,2,4,5,1,3,4,1,2,3,1,1,2,1,0,12,-51,2,7,9,2,0,3,1,1,1,1,4,1
KR_6753464620,420,1,73,-3,-3,0,0,0,-7,1,8,1,1,0,5,8,3,-2,0,2,0,-3,-4,-1,9,8,2,0,0,1,-1,0,-1,5,1
KR_6748093789,420,8,44,12,11,3,5,2,0,1,1,9,11,2,-2,3,5,1,1,0,-1,11,29,0,4,4,-2,0,4,-1,1,1,-1,5,1
KR_6678681673,440,5,-15,23,7,1,4,3,4,5,1,2,3,1,2,5,3,-2,0,2,0,2,-5,-1,5,4,1,0,0,1,-1,0,1,5,1
KR_6766641778,420,4,89,-11,7,0,1,1,2,4,2,1,5,4,5,7,2,-1,1,2,1,15,-13,1,6,7,1,0,0,-1,-1,1,1,6,1
KR_6776087154,420,1,55,3,7,-1,0,1,0,3,3,-2,1,3,7,8,1,3,4,1,1,14,85,2,9,11,1,0,2,1,1,1,1,2,1
KR_6775407605,440,1,95,-25,6,1,4,3,3,3,0,3,5,2,0,3,3,-1,0,1,0,1,-27,-2,5,3,4,0,2,-1,1,1,1,5,1
KR_6762320202,420,0,17,9,3,-3,1,4,-1,1,2,4,4,0,3,6,3,0,1,1,0,8,2,0,5,5,1,0,-1,-1,1,-1,1,1,1
KR_6776058229,420,2,33,8,1,2,4,2,0,2,2,-1,1,2,2,3,1,-2,0,2,0,-5,39,3,8,11,-16,0,0,1,-1,0,1,2,1
KR_6770403606,440,0,9,9,4,2,3,1,-4,1,5,2,4,2,0,3,3,4,4,0,-1,-1,13,3,7,10,-2,0,0,1,1,0,-1,6,1
KR_6777759196,420,4,28,15,12,1,3,2,2,5,3,0,2,2,7,8,1,2,2,0,0,21,17,-5,8,3,3,0,1,1,1,1,1,2,1
KR_6776640469,420,1,110,-39,5,1,2,1,4,6,2,3,7,4,-2,3,5,-1,1,2,-1,3,24,0,7,7,3,0,0,1,-1,-1,1,5,1
KR_6764993862,420,4,25,36,3,1,2,1,3,4,1,1,5,4,-3,2,5,1,1,0,0,0,-11,-2,7,5,3,0,0,1,-1,-1,-1,6,1
KR_6775647772,420,2,42,11,9,9,10,1,-2,1,3,3,6,3,-2,3,5,1,2,1,0,2,2,6,3,9,-3,0,1,1,1,1,-1,6,1
KR_6774312751,420,-1,25,-8,-1,-2,0,2,-2,7,9,0,2,2,2,2,0,1,1,0,0,-5,-217,-1,6,5,6,0,1,1,1,1,1,1,1
KR_6736575057,420,5,76,31,16,6,6,0,5,5,0,2,2,0,0,2,2,3,3,0,0,12,-19,2,5,7,25,0,1,1,1,1,1,5,1
KR_6776134028,420,0,3,-16,1,0,1,1,5,7,2,-1,1,2,-3,2,5,0,0,0,0,7,-9,1,7,8,4,0,0,-1,1,1,-1,6,1
KR_6776044942,420,4,65,2,7,1,3,2,-1,3,4,-1,1,2,7,7,0,1,3,2,0,3,56,0,7,7,-13,0,1,1,1,1,-1,6,1
KR_6766418273,420,0,12,-21,2,1,3,2,-3,3,6,-1,2,3,4,6,2,1,1,0,1,0,154,-6,8,2,6,0,1,-1,1,1,1,4,1
KR_6731037592,440,-1,9,4,1,-1,4,5,-3,1,4,0,1,1,3,5,2,2,2,0,0,-5,6,-2,3,1,-1,0,0,1,-1,-1,-1,5,1
KR_6759002662,420,3,49,12,10,6,7,1,-1,4,5,1,3,2,4,10,6,0,2,2,0,16,5,0,6,6,3,0,2,1,-1,-1,1,6,1
KR_6744974687,420,4,85,11,7,1,2,1,0,3,3,5,5,0,1,3,2,0,0,0,0,4,7,4,4,8,3,0,1,1,-1,1,1,3,1
KR_6751695182,440,0,-9,-21,10,1,1,0,-1,2,3,6,10,4,1,5,4,3,5,2,0,17,35,4,4,8,-6,0,1,1,1,1,1,1,1
KR_6757785211,420,0,11,22,-8,-1,1,2,-5,0,5,-3,3,6,0,3,3,1,2,1,0,-13,33,-7,13,6,-27,0,-1,-1,-1,-1,-1,6,1
KR_6716903768,420,3,26,5,12,3,4,1,3,6,3,5,5,0,-1,2,3,2,3,1,1,13,20,1,4,5,6,0,1,1,-1,-1,1,2,1
KR_6776432207,420,2,27,4,4,-1,0,1,2,4,2,2,4,2,4,6,2,-3,0,3,0,9,-22,0,6,6,5,0,0,-1,-1,0,-1,1,1
KR_6775445212,420,4,114,24,9,-1,0,1,5,5,0,2,4,2,0,2,2,3,3,0,0,17,20,4,6,10,7,0,3,1,1,1,1,4,1
KR_6740935373,420,3,12,-3,8,2,4,2,5,7,2,4,6,2,-3,0,3,0,0,0,0,19,46,2,3,5,1,0,1,-1,-1,1,-1,4,1
KR_6738402024,420,3,-33,-5,13,1,2,1,5,5,0,2,3,1,5,5,0,0,0,0,0,22,-59,3,7,10,-1,0,1,-1,-1,1,1,5,1
KR_6760423716,420,0,13,12,-6,3,3,0,2,2,0,-4,1,5,-6,4,10,-1,1,2,0,-7,13,5,6,11,-8,0,-1,-1,1,-1,-1,1,1
KR_6772760519,420,5,48,23,6,0,2,2,4,5,1,0,2,2,1,4,3,1,4,3,0,12,1,2,6,8,6,0,1,1,-1,1,-1,3,1
KR_6767329963,420,1,-32,3,4,-3,2,5,-2,4,6,2,2,0,7,8,1,0,0,0,0,11,-39,0,8,8,2,0,0,1,-1,-1,-1,4,1
KR_6766985351,420,-1,-10,-4,-4,-8,0,8,4,4,0,4,6,2,-6,1,7,2,2,0,-1,-3,-2,2,5,7,-6,0,0,-1,-1,-1,-1,4,1
KR_6776569437,420,5,69,65,13,1,2,1,7,7,0,0,4,4,5,5,0,0,1,1,0,16,2,6,4,10,0,0,2,1,1,1,-1,1,1
KR_6743901328,420,-1,-24,8,0,1,4,3,-6,0,6,1,3,2,4,7,3,0,0,0,0,-4,6,4,9,13,-8,0,0,1,1,0,-1,1,1
KR_6736373936,420,8,93,14,14,5,6,1,5,7,2,-1,2,3,4,4,0,1,1,0,0,18,10,6,3,9,-3,0,4,1,1,1,-1,3,1
KR_6711958137,420,3,73,-46,4,1,5,4,-1,0,1,-1,4,5,6,9,3,-1,2,3,0,5,9,-1,8,7,-1,0,2,-1,-1,1,-1,6,1
KR_6775324563,420,0,36,6,7,0,4,4,0,2,2,4,4,0,3,4,1,0,0,0,1,13,-16,1,6,7,1,0,1,1,1,1,1,1,1
KR_6713123952,420,4,31,-16,8,1,3,2,3,5,2,1,2,1,3,4,1,0,1,1,0,9,-111,1,6,7,3,0,1,1,1,1,-1,6,1
KR_6737259327,420,2,43,-4,7,1,3,2,1,5,4,3,4,1,1,5,4,1,2,1,0,8,-17,2,3,5,7,0,1,1,1,1,1,4,1
KR_6769387757,420,-1,-14,-4,-8,0,2,2,-6,2,8,-2,1,3,-1,2,3,1,2,1,0,-8,14,3,6,9,-8,0,0,1,1,0,1,5,1
KR_6769933767,420,0,-15,8,1,0,1,1,1,4,3,0,2,2,2,6,4,-2,0,2,-1,-3,-3,-1,8,7,-2,0,0,-1,1,1,-1,4,1
KR_6769117354,420,3,-47,18,15,2,4,2,7,8,1,4,6,2,0,1,1,2,4,2,1,29,22,-1,5,4,-2,0,0,-1,1,1,1,2,1
KR_6767910432,440,1,21,8,4,-6,1,7,-1,1,2,0,0,0,7,9,2,4,5,1,0,9,-107,1,2,3,4,0,1,-1,-1,1,-1,6,1
KR_6725098117,420,-2,-29,3,-2,1,1,0,0,2,2,0,0,0,-4,2,6,1,1,0,0,-4,-2,-2,8,6,-2,0,-1,-1,-1,-1,1,5,1
KR_6732745113,420,4,9,16,2,0,3,3,1,4,3,1,1,0,-1,5,6,1,1,0,0,8,3,-3,13,10,0,0,2,1,1,1,1,5,1
KR_6761492732,420,0,-14,-24,4,4,5,1,-2,1,3,-3,0,3,-1,1,2,6,6,0,-1,17,-2,5,4,9,-4,0,0,-1,1,0,-1,6,1
KR_6776601667,420,-1,32,-19,-2,2,2,0,-6,2,8,0,2,2,4,6,2,-2,2,4,-1,-10,-16,0,7,7,-2,0,0,1,-1,0,1,1,1
KR_6743223907,420,2,70,-11,12,6,6,0,3,5,2,-1,3,4,3,5,2,1,3,2,2,4,-6,-2,9,7,0,0,3,1,1,1,1,3,1
KR_6772173442,420,4,54,-4,3,0,2,2,2,4,2,0,2,2,5,6,1,-4,0,4,0,7,-1,-1,6,5,3,0,0,-1,-1,0,-1,3,1
KR_6765899295,420,0,-16,-22,-2,-5,0,5,0,2,2,-1,3,4,3,3,0,1,1,0,-1,0,-12,2,5,7,-2,0,0,1,-1,0,-1,3,1
KR_6769659933,420,3,39,-17,12,3,3,0,3,6,3,2,2,0,5,5,0,-1,0,1,2,20,26,0,6,6,-2,0,0,1,-1,1,1,5,1
KR_6774087063,420,4,32,-4,13,3,4,1,1,2,1,2,7,5,7,8,1,0,1,1,0,20,0,1,7,8,5,0,2,1,1,1,1,6,1
KR_6775091512,420,0,18,6,12,2,2,0,9,9,0,1,4,3,0,2,2,0,0,0,1,20,28,-4,6,2,4,0,1,1,1,1,1,2,1
KR_6777678060,420,5,42,-4,12,3,3,0,1,2,1,2,3,1,3,4,1,3,4,1,0,10,16,0,7,7,0,0,3,1,1,1,1,2,1
KR_6776254542,440,5,69,30,7,-3,3,6,2,2,0,4,5,1,3,4,1,1,2,1,-1,6,16,-5,7,2,0,0,0,-1,1,1,-1,4,1
KR_6765105914,420,3,21,11,8,2,3,1,0,2,2,4,4,0,3,5,2,-1,1,2,0,7,-2,-1,6,5,1,0,3,-1,1,1,1,3,1
KR_6773637551,440,1,64,-6,11,4,4,0,3,6,3,0,2,2,1,4,3,3,4,1,0,12,-30,-1,5,4,11,0,1,1,-1,1,-1,1,1
KR_6742190429,420,-2,-3,-28,0,3,3,0,-5,0,5,2,2,0,2,3,1,-2,0,2,-1,0,-2,2,7,9,4,0,0,1,1,0,-1,1,1
KR_6719855376,420,-1,46,24,9,0,2,2,0,2,2,7,10,3,1,2,1,1,1,0,0,14,-13,5,5,10,7,0,1,1,1,1,1,6,1
KR_6765976161,420,1,32,-22,2,2,4,2,2,2,0,-4,1,5,2,3,1,0,0,0,0,6,-38,1,7,8,0,0,0,-1,-1,1,1,4,1
KR_6766501624,420,-2,-30,-8,-1,-2,1,3,-2,2,4,3,4,1,-1,3,4,1,2,1,-1,6,43,2,3,5,-1,0,-2,-1,-1,-1,-1,3,1
KR_6772733628,420,5,0,8,10,4,5,1,8,11,3,1,2,1,-3,0,3,0,0,0,-1,7,4,-1,7,6,-2,0,3,1,1,1,-1,3,1
KR_6759034734,420,5,13,32,15,7,7,0,6,9,3,2,2,0,1,2,1,-1,0,1,0,7,-2,4,4,8,7,0,1,-1,1,1,1,3,1
KR_6743673913,440,-2,-77,5,-4,0,1,1,0,3,3,-2,1,3,1,1,0,-3,0,3,1,-7,-7,-7,12,5,-5,0,0,1,-1,1,1,6,1
KR_6771759008,420,-1,-15,37,-1,-1,2,3,-1,0,1,-2,3,5,4,5,1,-1,0,1,0,-4,-1,-2,7,5,-4,0,0,1,1,-1,-1,4,1
KR_6776448851,420,1,-5,-17,0,-1,1,2,3,5,2,-2,6,8,-1,4,5,1,1,0,-1,-3,15,3,3,6,0,0,0,1,-1,0,-1,2,1
KR_6770781516,420,1,100,38,3,-2,0,2,1,4,3,0,1,1,3,8,5,1,1,0,0,3,-14,1,5,6,3,0,-1,1,-1,1,1,5,1
KR_6726807161,420,4,5,32,12,0,2,2,3,6,3,2,5,3,5,5,0,2,2,0,0,17,-11,1,7,8,0,0,1,1,1,1,1,2,1
KR_6754062336,420,1,68,3,1,0,3,3,2,4,2,0,3,3,-3,0,3,2,2,0,0,2,-41,-7,12,5,5,0,0,1,-1,0,-1,4,1
KR_6645565556,420,1,22,50,6,-3,0,3,6,7,1,2,5,3,1,3,2,0,2,2,0,6,22,4,3,7,0,0,1,1,1,1,-1,4,1
KR_6777873253,440,2,63,-4,2,0,0,0,-1,1,2,2,2,0,2,3,1,-1,0,1,0,-2,39,-3,7,4,3,0,0,1,1,1,1,6,1
KR_6752165987,420,1,-2,39,5,1,1,0,3,3,0,3,3,0,-3,0,3,1,1,0,0,6,10,1,6,7,-1,0,0,1,1,0,1,1,1
KR_6696201253,420,3,56,2,8,4,4,0,3,4,1,-1,2,3,3,3,0,-1,0,1,0,9,10,3,5,8,-1,0,0,-1,1,0,1,1,1
KR_6731629183,440,-4,-37,-10,-7,-5,0,5,4,6,2,3,3,0,-1,2,3,-8,0,8,1,6,10,-1,2,1,-2,0,0,1,-1,-1,1,6,1
KR_6754460943,420,2,11,-3,4,0,1,1,0,1,1,5,8,3,1,5,4,-2,2,4,0,-1,8,0,7,7,-7,0,1,1,1,1,1,4,1
KR_6777143130,420,2,27,6,3,-2,0,2,4,8,4,-4,4,8,4,4,0,1,2,1,0,-1,9,-1,10,9,1,0,2,1,1,1,-1,2,1
KR_6777325539,440,3,48,0,-1,-1,0,1,4,7,3,-4,0,4,2,3,1,-2,0,2,-1,5,-3,2,5,7,2,0,1,1,1,1,-1,2,1
KR_6775327211,420,0,-28,-13,14,7,7,0,3,3,0,1,2,1,3,4,1,0,0,0,0,14,12,-1,7,6,-1,0,0,1,1,1,1,1,1
KR_6771070191,420,-2,-10,4,-5,0,2,2,-5,0,5,-1,5,6,1,3,2,0,0,0,0,-10,-20,-1,5,4,6,0,-1,1,1,-1,-1,3,1
KR_6764005429,420,0,14,24,-3,1,2,1,-2,3,5,-1,2,3,0,3,3,-1,0,1,-1,-11,-22,-1,9,8,0,0,2,1,1,1,1,5,1
KR_6765747318,420,-1,37,46,1,0,2,2,2,2,0,-3,4,7,2,2,0,0,1,1,0,2,-8,1,5,6,6,0,3,1,1,1,-1,2,1
KR_6718773187,420,1,27,24,-4,1,1,0,-4,2,6,3,5,2,-6,2,8,2,2,0,0,-1,4,-1,5,4,-1,0,1,-1,1,1,1,1,1
KR_6751801877,420,4,17,22,9,3,4,1,4,4,0,0,3,3,-1,4,5,3,4,1,0,2,2,1,2,3,1,0,1,-1,-1,1,1,2,1
KR_6746607327,420,-2,-13,-18,0,2,3,1,2,2,0,-3,4,7,1,5,4,-2,0,2,0,1,-60,2,7,9,5,0,0,-1,-1,0,-1,4,1
KR_6697906249,420,6,22,9,9,5,5,0,2,4,2,-1,0,1,0,3,3,3,3,0,0,12,6,0,5,5,0,0,1,1,-1,1,-1,4,1
KR_6772623659,420,4,76,5,8,6,6,0,0,1,1,4,4,0,-1,0,1,-1,2,3,0,3,-1,-2,5,3,3,0,1,1,1,1,1,3,1
KR_6775846607,420,1,16,-20,4,2,3,1,0,1,1,-2,1,3,3,4,1,1,1,0,0,3,18,2,5,7,-7,0,0,1,1,0,1,1,1
KR_6734265520,440,5,63,3,14,1,2,1,0,2,2,3,4,1,8,9,1,2,2,0,1,18,-104,3,5,8,-17,0,1,1,1,1,1,4,1
KR_6757190714,420,5,12,-11,6,4,4,0,-2,1,3,-2,1,3,6,10,4,0,1,1,0,2,11,8,5,13,-9,0,1,1,-1,-1,1,1,1
KR_6741520384,420,-3,27,-17,-2,1,2,1,2,2,0,-5,3,8,0,3,3,0,0,0,0,3,1,3,5,8,-4,0,0,1,1,1,1,3,1
KR_6721644793,420,5,54,33,11,4,8,4,2,3,1,3,5,2,3,4,1,-1,1,2,0,10,2,2,3,5,0,0,-1,1,1,1,1,3,1
KR_6776155231,420,0,2,-3,4,3,4,1,1,3,2,-2,2,4,0,3,3,2,3,1,1,6,8,0,6,6,-10,0,1,-1,-1,1,1,6,1
KR_6728086861,420,1,57,7,-1,2,2,0,-1,4,5,3,5,2,-4,1,5,-1,0,1,0,-8,-27,-2,10,8,1,0,1,1,1,1,-1,3,1
KR_6746901298,420,2,-18,2,1,1,3,2,-2,0,2,1,3,2,0,0,0,1,2,1,0,4,20,3,3,6,-4,0,0,1,1,-1,1,2,1
KR_6775843691,420,3,52,36,6,-1,2,3,-1,1,2,1,1,0,8,8,0,-1,0,1,0,4,-9,3,3,6,3,0,0,1,-1,1,1,4,1
KR_6773894831,420,4,54,15,5,5,7,2,-2,1,3,0,3,3,3,7,4,-1,1,2,0,11,3,1,5,6,0,0,2,1,-1,1,-1,6,1
KR_6756577438,420,-1,34,20,-6,-1,0,1,-2,3,5,-1,2,3,0,3,3,-2,0,2,0,-15,-12,-4,11,7,5,0,1,-1,1,1,-1,2,1
KR_6777610891,420,2,73,-13,9,-2,1,3,0,0,0,4,6,2,2,4,2,5,5,0,1,8,11,5,4,9,-4,0,0,1,-1,-1,1,2,1
KR_6735882401,420,-4,-31,-23,-2,-3,0,3,3,4,1,2,2,0,-2,1,3,-2,1,3,0,3,8,6,6,12,-7,0,-1,-1,-1,-1,-1,6,1
KR_6709198094,420,4,15,29,0,-1,1,2,-2,2,4,1,6,5,4,4,0,-2,0,2,1,2,-9,-1,9,8,1,0,0,1,-1,0,1,4,1
KR_6765608455,420,2,9,9,4,3,4,1,2,6,4,-2,4,6,2,5,3,-1,1,2,1,3,7,-3,8,5,1,0,-1,1,-1,-1,1,6,1
KR_6756866336,420,0,-7,-16,3,1,2,1,0,3,3,2,2,0,2,3,1,-2,0,2,0,3,2,-2,7,5,-2,0,0,-1,-1,0,1,2,1
KR_6767372477,420,4,25,28,9,0,1,1,0,1,1,6,6,0,0,1,1,3,3,0,0,9,-57,-3,11,8,34,0,0,1,-1,-1,1,1,1
KR_6770761565,420,4,9,-17,4,-2,1,3,3,5,2,1,6,5,0,1,1,2,2,0,1,9,-3,-4,9,5,10,0,2,-1,-1,1,1,2,1
KR_6743427394,420,0,-13,26,-6,-2,1,3,-1,0,1,1,4,3,-5,0,5,1,1,0,0,-8,65,1,7,8,-4,0,1,1,1,1,-1,2,1
KR_6771237055,420,5,96,-16,14,6,6,0,2,3,1,1,2,1,2,4,2,3,4,1,0,11,-34,-1,5,4,5,0,1,1,1,1,1,6,1
KR_6726188526,440,0,-44,8,0,5,7,2,-5,0,5,-1,1,2,2,2,0,-1,2,3,1,-3,-1,-3,8,5,-2,0,0,-1,1,0,1,2,1
KR_6767555157,420,6,24,8,19,-1,0,1,4,5,1,1,2,1,12,13,1,3,4,1,0,24,15,5,5,10,-7,0,2,1,1,1,1,2,1
KR_6776312923,420,-1,7,4,-3,-2,0,2,1,5,4,-1,0,1,-1,1,2,0,1,1,0,0,10,1,6,7,-4,0,1,-1,1,1,1,2,1
KR_6763749411,420,3,-54,4,1,-2,0,2,-4,1,5,1,2,1,7,8,1,-1,1,2,1,1,-4,-2,6,4,-1,0,1,1,-1,1,1,6,1
KR_6749110926,420,4,70,39,18,2,5,3,3,6,3,7,8,1,5,8,3,1,2,1,1,14,21,3,6,9,-19,0,3,1,1,1,1,3,1
KR_6759819928,440,3,50,18,9,2,2,0,4,4,0,1,2,1,2,6,4,0,0,0,0,17,30,3,6,9,5,0,1,1,1,1,-1,6,1
KR_6777222390,420,6,83,1,5,1,3,2,0,3,3,-2,2,4,5,6,1,1,1,0,0,-6,-11,1,6,7,10,0,2,-1,1,1,-1,1,1
KR_6775979642,420,3,25,5,8,-1,1,2,6,7,1,1,4,3,2,4,2,0,1,1,0,17,-3,-1,7,6,5,0,-1,-1,1,-1,1,1,1
KR_6755404273,420,3,-8,20,8,0,0,0,2,4,2,3,4,1,2,5,3,1,2,1,0,15,26,3,7,10,-1,0,0,0,1,0,1,0,1
KR_6751696748,420,-2,28,-32,8,-5,0,5,8,10,2,-2,1,3,8,9,1,-1,0,1,0,20,-3,6,3,9,-1,0,0,1,-1,-1,1,4,1
KR_6755499984,420,2,17,-12,11,1,2,1,8,8,0,5,5,0,-1,0,1,-2,1,3,0,12,3,4,4,8,6,0,1,1,1,1,1,6,1
KR_6769608951,420,3,12,12,5,0,0,0,6,8,2,2,7,5,-1,1,2,-2,1,3,0,15,-3,-3,9,6,2,0,0,1,-1,0,-1,2,1
KR_6773772331,420,0,-15,0,-3,-1,2,3,-3,2,5,3,3,0,0,2,2,-2,1,3,0,-3,-81,0,8,8,0,0,0,-1,-1,-1,1,3,1
KR_6773021176,420,6,89,1,13,3,4,1,1,3,2,-1,0,1,10,10,0,0,1,1,0,18,48,-3,9,6,-20,0,2,1,-1,1,1,6,1
KR_6764503062,420,2,16,45,1,-1,1,2,1,1,0,2,3,1,1,2,1,-2,0,2,0,4,67,3,5,8,-3,0,3,-1,1,1,-1,2,1
KR_6776227238,420,4,85,18,6,-1,0,1,1,3,2,3,3,0,3,4,1,0,0,0,1,7,5,4,4,8,1,0,2,1,-1,1,1,4,1
KR_6764124861,420,3,-2,-1,1,3,7,4,0,3,3,-1,1,2,-2,3,5,1,1,0,0,6,-6,1,7,8,5,0,1,-1,1,1,1,5,1
KR_6775349284,420,1,7,17,4,-3,1,4,0,2,2,4,5,1,3,3,0,0,0,0,0,12,0,-1,9,8,3,0,1,1,1,1,1,4,1
KR_6776949420,420,2,63,-32,13,5,5,0,-2,1,3,10,11,1,0,2,2,0,1,1,0,13,16,5,6,11,1,0,3,0,1,1,1,0,1
KR_6770719325,420,6,10,19,14,7,7,0,6,6,0,3,6,3,-3,1,4,1,3,2,-1,18,18,0,7,7,1,0,2,1,1,1,-1,5,1
KR_6772127387,420,2,-2,44,8,1,1,0,3,4,1,3,3,0,1,2,1,0,1,1,0,11,31,-1,6,5,0,0,1,1,1,1,-1,5,1
KR_6777531208,420,0,-6,-23,0,1,3,2,3,5,2,-2,2,4,-1,1,2,-1,0,1,0,2,1,0,9,9,-4,0,0,-1,-1,1,-1,4,1
KR_6765010552,420,0,-41,-14,-3,-3,1,4,-3,2,5,0,7,7,3,4,1,0,2,2,0,5,-10,-4,9,5,2,0,0,1,-1,-1,-1,5,1
KR_6754622962,420,0,-8,7,0,-3,0,3,1,2,1,-4,0,4,5,7,2,1,1,0,0,2,8,1,4,5,-1,0,0,-1,1,0,1,6,1
KR_6765529013,420,2,26,3,-2,-1,0,1,-2,0,2,2,2,0,-2,0,2,1,2,1,0,-5,3,-1,7,6,-1,0,0,-1,-1,0,-1,5,1
KR_6777171156,420,-2,-9,-47,5,1,3,2,0,6,6,6,8,2,-3,2,5,1,2,1,1,8,-4,6,6,12,2,0,0,1,-1,0,1,1,1
KR_6742297610,440,0,46,12,1,-5,0,5,0,0,0,3,3,0,5,5,0,-2,2,4,0,-9,-1,-3,7,4,-3,0,0,1,1,0,-1,2,1
KR_6758668487,420,1,-1,-28,8,-1,0,1,2,3,1,2,2,0,4,4,0,1,1,0,0,10,4,4,3,7,-2,0,1,1,1,1,-1,4,1
KR_6772240957,420,-3,-99,4,-4,-9,2,11,-1,0,1,5,6,1,2,6,4,-1,1,2,3,7,26,-1,10,9,-2,0,-2,1,1,-1,1,3,1
KR_6727246817,420,-3,27,12,-5,0,0,0,2,2,0,-2,4,6,-2,2,4,-3,1,4,0,-20,-37,5,4,9,-8,0,2,-1,1,1,-1,1,1
KR_6765718343,420,4,41,-8,11,5,6,1,0,1,1,4,5,1,0,2,2,2,4,2,0,15,4,-1,5,4,4,0,3,-1,1,1,1,1,1
KR_6764272429,420,1,28,4,2,-1,1,2,0,4,4,-1,1,2,3,4,1,1,2,1,0,7,3,-3,9,6,4,0,1,1,-1,1,-1,1,1
KR_6775564743,420,4,-3,21,2,1,1,0,-5,2,7,0,3,3,2,5,3,4,5,1,0,5,10,1,6,7,-4,0,0,1,-1,1,-1,3,1
KR_6773510697,440,4,-5,18,6,5,6,1,-3,3,6,3,4,1,-1,1,2,2,2,0,0,2,44,1,8,9,-6,0,2,1,0,1,1,3,1
KR_6751248237,420,3,99,13,6,5,5,0,1,1,0,2,2,0,-2,1,3,0,0,0,0,2,-10,-5,8,3,5,0,0,1,1,1,1,3,1
KR_6775879722,420,0,-9,-3,-4,-2,1,3,-1,1,2,-4,2,6,1,3,2,2,3,1,0,0,-5,-3,9,6,4,0,1,1,1,1,1,1,1
KR_6754143838,420,5,63,20,18,4,4,0,4,4,0,8,8,0,3,7,4,-1,0,1,0,22,-1,-1,10,9,1,0,2,-1,1,1,1,6,1
KR_6741205850,420,1,-39,19,7,-1,2,3,3,5,2,5,9,4,-1,1,2,1,1,0,-1,4,26,-1,8,7,2,0,0,-1,1,1,-1,1,1
KR_6753285519,420,5,-40,6,15,0,1,1,13,14,1,1,6,5,0,5,5,1,2,1,1,33,-30,-1,4,3,28,0,3,1,1,1,1,2,1
KR_6777596850,420,4,-20,16,6,0,1,1,3,4,1,1,4,3,2,8,6,0,0,0,-1,2,-2,-1,5,4,0,0,0,1,1,1,-1,4,1
KR_6757151501,440,2,55,24,3,3,4,1,4,5,1,1,3,2,2,3,1,-7,0,7,2,-2,6,0,4,4,-2,0,3,1,1,1,1,6,1
KR_6776577022,420,1,-33,28,5,4,5,1,4,5,1,-3,0,3,-1,5,6,1,1,0,0,-1,-15,1,5,6,-4,0,-1,1,-1,-1,-1,1,1
KR_6761967325,420,4,13,3,7,-4,0,4,3,3,0,2,5,3,7,9,2,-1,1,2,0,17,-1,3,5,8,1,0,1,1,-1,1,-1,3,1
KR_6773053844,420,1,-9,-27,-2,-2,1,3,3,3,0,1,3,2,-4,1,5,0,2,2,0,3,-11,-6,8,2,1,0,-1,1,1,-1,1,5,1
KR_6698400470,420,2,-25,-1,1,0,3,3,0,3,3,1,1,0,-2,5,7,2,2,0,0,6,6,2,5,7,-2,0,-1,1,-1,-1,1,1,1
KR_6711314093,420,2,-12,45,7,4,4,0,-3,0,3,5,5,0,-1,4,5,2,4,2,0,4,-2,-5,9,4,8,0,1,1,1,1,-1,2,1
KR_6768053408,420,3,5,0,7,-1,2,3,2,2,0,4,4,0,2,3,1,0,1,1,0,5,-46,5,9,14,-4,0,1,1,1,1,1,2,1
KR_6742303673,420,4,46,20,5,0,2,2,3,4,1,-1,2,3,1,3,2,2,2,0,1,2,1,-3,10,7,-3,0,2,-1,1,1,1,2,1
KR_6744679079,440,2,93,10,11,4,6,2,-1,2,3,4,6,2,0,3,3,4,7,3,0,8,-12,-4,6,2,2,0,2,1,-1,1,1,4,1
KR_6762356588,440,-1,-19,11,-5,0,2,2,1,2,1,-6,1,7,6,6,0,-6,1,7,0,-14,2,-6,6,0,1,0,-1,0,1,-1,1,0,1
KR_6772834656,420,-1,37,14,3,-1,2,3,1,4,3,3,5,2,3,3,0,-3,0,3,0,-1,-2,4,5,9,5,0,3,-1,1,1,-1,3,1
KR_6771458535,420,2,34,-20,13,2,2,0,4,5,1,6,8,2,1,1,0,0,0,0,0,12,3,5,4,9,0,0,2,1,1,1,1,2,1
KR_6733684659,420,0,-14,27,0,0,1,1,-3,1,4,2,4,2,0,1,1,1,3,2,1,0,-77,5,5,10,2,0,0,-1,1,-1,1,3,1
KR_6776464062,420,4,64,31,8,0,0,0,4,5,1,3,3,0,-1,3,4,2,3,1,0,6,-2,4,2,6,2,0,2,1,1,1,1,6,1
KR_6776493907,440,-2,6,-20,-2,1,2,1,5,5,0,-8,2,10,-1,3,4,1,2,1,0,-1,-5,-4,7,3,-2,0,0,1,-1,-1,1,2,1
KR_6714777851,420,1,2,0,9,3,4,1,4,5,1,-1,3,4,2,2,0,1,2,1,0,6,1,-2,7,5,0,0,0,-1,1,-1,1,5,1
KR_6765411986,420,1,-2,-8,6,-4,0,4,4,6,2,-1,3,4,8,8,0,-1,0,1,0,15,134,-1,6,5,1,0,0,1,0,0,-1,5,1
KR_6766539973,440,8,166,13,15,5,5,0,0,0,0,7,8,1,4,5,1,-1,3,4,2,14,14,1,2,3,-2,0,2,1,0,1,1,6,1
KR_6774144559,420,3,-12,-7,8,3,4,1,2,3,1,1,1,0,2,5,3,0,2,2,0,11,-20,5,5,10,8,0,1,1,1,1,1,1,1
KR_6702761723,420,2,-16,-16,8,1,1,0,7,12,5,2,6,4,-1,2,3,-1,0,1,0,9,3,-3,10,7,1,0,-1,-1,-1,-1,-1,3,1
KR_6705610911,420,0,34,2,6,-2,1,3,5,7,2,1,3,2,1,3,2,1,2,1,0,1,0,2,9,11,-7,0,1,-1,1,1,-1,5,1
KR_6709035966,420,-1,-30,-17,3,2,4,2,0,1,1,-3,2,5,4,7,3,0,1,1,0,4,0,2,4,6,0,0,-1,-1,1,-1,-1,2,1
KR_6753116028,420,2,89,8,2,-2,1,3,3,4,1,-1,3,4,3,7,4,-1,2,3,0,9,-2,-4,9,5,1,0,2,-1,1,1,1,2,1
KR_6767330361,420,3,-16,28,2,0,0,0,-8,0,8,2,3,1,7,8,1,1,2,1,0,6,71,-4,11,7,5,0,0,1,1,1,-1,4,1
KR_6705751141,420,0,0,23,4,1,2,1,3,6,3,-1,3,4,0,3,3,1,2,1,0,-4,22,-7,15,8,7,0,0,-1,1,0,-1,4,1
KR_6740690576,420,1,-34,1,-2,1,3,2,-4,0,4,1,1,0,-1,1,2,1,1,0,0,-2,1,-2,10,8,0,0,0,1,-1,1,1,3,1
KR_6762715783,420,0,26,-18,-1,0,1,1,-1,1,2,0,1,1,-1,3,4,1,3,2,-1,-6,6,0,6,6,2,0,1,-1,1,1,-1,6,1
KR_6776897046,420,2,45,-23,-1,2,3,1,0,1,1,-1,2,3,-5,1,6,3,6,3,0,-3,30,0,8,8,-5,0,0,-1,1,1,1,4,1
KR_6740189259,440,0,40,-4,-2,-5,1,6,3,3,0,-2,0,2,1,3,2,1,2,1,0,-2,52,4,8,12,-18,0,0,1,1,-1,1,6,1
KR_6754466671,420,1,50,30,1,-4,0,4,0,4,4,1,3,2,0,0,0,4,5,1,0,-1,-48,-2,8,6,7,0,-1,1,-1,-1,1,4,1
KR_6777558500,440,1,37,32,1,-2,0,2,-2,4,6,2,4,2,2,3,1,1,2,1,0,3,-4,-2,6,4,0,0,0,1,-1,-1,1,4,1
KR_6775987274,420,3,55,20,4,10,10,0,-1,1,2,1,2,1,-2,2,4,-4,0,4,-1,-6,-2,-1,5,4,4,0,1,1,1,1,-1,2,1
KR_6753308735,420,0,-31,-22,0,-2,0,2,3,7,4,1,2,1,-2,4,6,0,1,1,0,9,-5,2,7,9,1,0,0,1,-1,-1,-1,2,1
KR_6776256856,420,3,64,0,15,1,3,2,9,9,0,4,7,3,1,4,3,0,2,2,1,11,9,4,7,11,5,0,2,1,1,1,1,2,1
KR_6772548821,420,5,25,8,12,5,5,0,3,4,1,2,2,0,3,4,1,-1,1,2,0,9,8,0,7,7,1,0,1,1,1,1,-1,3,1
KR_6755540202,420,9,92,52,16,2,3,1,1,5,4,4,4,0,8,8,0,1,1,0,0,18,0,-2,6,4,4,0,3,1,1,1,1,6,1
KR_6777842450,420,7,47,48,11,5,5,0,2,5,3,2,2,0,1,2,1,1,1,0,0,8,37,-1,10,9,5,0,2,1,1,1,1,1,1
KR_6765914636,420,1,32,9,7,3,3,0,1,7,6,-2,0,2,6,6,0,-1,2,3,0,11,4,6,7,13,-5,0,1,1,1,1,-1,4,1
KR_6777642776,420,4,13,0,10,6,6,0,5,8,3,1,3,2,-2,1,3,0,0,0,1,4,172,2,2,4,4,0,0,-1,1,1,1,3,1
KR_6777304293,420,-2,-13,-2,-2,-3,1,4,2,4,2,-1,1,2,0,1,1,0,0,0,0,5,-4,-2,8,6,3,0,0,1,-1,0,-1,1,1
KR_6776441899,420,0,-19,-8,-2,0,1,1,-2,1,3,-7,1,8,6,9,3,1,3,2,0,1,0,-1,4,3,-3,0,1,-1,1,1,1,5,1
KR_6729401437,420,1,-15,22,6,-1,1,2,2,3,1,1,6,5,6,8,2,-2,1,3,0,1,-11,-2,8,6,2,0,0,1,1,1,1,5,1
KR_6774663012,420,0,32,6,-3,1,3,2,-4,2,6,-1,3,4,0,2,2,1,2,1,3,-3,-5,-8,13,5,7,0,1,1,-1,1,1,1,1
KR_6766750190,420,2,24,15,1,5,5,0,-2,3,5,1,3,2,-4,2,6,1,3,2,0,-7,-13,4,3,7,-1,0,2,1,1,1,1,4,1
KR_6718749205,420,8,80,8,17,5,5,0,4,4,0,2,4,2,6,6,0,0,0,0,0,24,15,5,6,11,-1,0,3,1,1,1,1,1,1
KR_6766601893,420,1,44,-53,2,1,4,3,-2,2,4,4,5,1,0,3,3,-1,0,1,0,-2,3,2,5,7,0,0,0,-1,-1,0,-1,2,1
KR_6772300461,420,-1,2,10,0,-1,1,2,-5,0,5,6,8,2,2,5,3,-2,2,4,0,3,14,6,2,8,-4,0,1,-1,1,1,1,3,1
KR_6725070841,420,2,31,49,7,-2,2,4,3,5,2,0,1,1,6,7,1,0,1,1,1,13,9,-1,7,6,8,0,1,-1,1,1,1,4,1
KR_6745188290,420,0,-7,-21,-1,1,2,1,1,3,2,-4,3,7,1,4,3,0,1,1,0,1,1,-1,7,6,-4,0,1,1,1,1,1,1,1
KR_6753210756,420,0,-12,2,0,4,4,0,-4,0,4,-2,1,3,1,2,1,1,1,0,1,-4,16,-2,8,6,1,0,0,1,-1,0,1,4,1
KR_6774237685,420,2,-1,-4,1,2,3,1,0,2,2,0,1,1,-1,0,1,0,1,1,0,0,3,2,6,8,2,0,0,-1,1,1,-1,3,1
KR_6769681219,420,2,35,4,0,1,3,2,2,8,6,-3,1,4,0,2,2,0,1,1,0,-9,0,-2,6,4,-4,0,-1,1,1,-1,-1,3,1
KR_6731626327,420,2,74,24,3,2,6,4,-3,2,5,0,5,5,1,3,2,3,4,1,0,10,10,3,3,6,-2,0,0,1,1,1,-1,5,1
KR_6754246127,420,4,54,12,10,2,2,0,-1,2,3,0,1,1,5,5,0,4,4,0,1,6,21,0,4,4,1,0,1,1,1,1,1,2,1
KR_6776423450,420,2,62,-28,6,-2,3,5,-1,2,3,-4,0,4,11,11,0,2,2,0,0,7,0,2,4,6,2,0,1,1,-1,1,1,5,1
KR_6760552459,420,1,-15,-18,3,-1,0,1,4,6,2,3,4,1,-4,1,5,1,1,0,0,-3,12,0,6,6,-12,0,0,-1,1,0,1,6,1
KR_6776568086,420,0,25,-13,3,-1,0,1,1,2,1,-2,2,4,1,3,2,4,4,0,0,-6,-41,0,8,8,5,0,0,-1,1,1,1,5,1
KR_6756057895,420,0,-11,-10,1,2,3,1,-3,1,4,1,1,0,1,3,2,0,1,1,0,-5,-39,-1,7,6,-4,0,0,1,-1,0,-1,4,1
KR_6744224737,420,4,21,-3,10,2,4,2,5,6,1,-2,4,6,5,7,2,0,0,0,0,3,-3,1,7,8,4,0,2,1,1,-1,1,3,1
KR_6753337222,420,3,62,-8,8,2,3,1,3,3,0,0,2,2,3,3,0,0,0,0,0,12,-1,3,4,7,5,0,0,1,-1,1,1,5,1
KR_6756307666,420,3,8,36,5,4,4,0,-1,2,3,4,5,1,-1,3,4,-1,0,1,1,-4,30,-1,6,5,-6,0,0,-1,1,-1,1,5,1
KR_6769015456,420,5,-5,52,5,-2,1,3,2,4,2,4,4,0,1,3,2,0,0,0,0,13,2,1,9,10,7,0,2,1,1,1,1,1,1
KR_6733747517,420,2,68,4,3,3,3,0,2,3,1,-4,2,6,1,3,2,1,2,1,0,8,0,11,3,14,-3,0,0,1,-1,0,-1,1,1
KR_6735845605,440,4,52,3,13,4,4,0,5,8,3,-1,2,3,0,4,4,5,5,0,0,13,-20,-2,8,6,5,0,1,1,1,1,-1,6,1
KR_6697283267,420,3,24,41,-1,-8,0,8,0,2,2,3,4,1,3,3,0,1,2,1,0,6,-5,-2,4,2,5,0,-2,1,-1,-1,-1,2,1
KR_6747485320,420,1,-3,11,2,2,3,1,2,5,3,0,4,4,-1,0,1,-1,4,5,-1,8,-5,-2,7,5,0,0,-1,1,-1,-1,-1,1,1
KR_6773131085,420,0,-7,32,-5,-2,2,4,-3,2,5,6,9,3,-4,2,6,-2,0,2,0,-7,6,0,7,7,-2,0,0,-1,1,1,-1,5,1
KR_6769468045,420,-1,49,-16,-1,1,4,3,3,6,3,-4,1,5,-1,1,2,0,0,0,0,-4,-4,-3,9,6,-2,0,1,-1,1,1,1,1,1
KR_6769969958,420,-2,-53,0,1,-5,0,5,8,11,3,1,3,2,-4,3,7,1,3,2,-2,8,15,7,2,9,1,0,0,1,1,-1,-1,3,1
KR_6754133716,420,-1,-7,8,-6,0,1,1,-5,3,8,1,4,3,0,3,3,-2,0,2,0,-6,-2,-3,8,5,-3,0,-2,-1,-1,-1,1,3,1
KR_6776192944,420,1,6,-8,-1,-2,2,4,-4,2,6,0,1,1,4,7,3,1,1,0,0,0,17,-1,8,7,-1,0,0,1,1,0,-1,4,1
KR_6774813444,420,5,51,14,6,3,4,1,7,8,1,-2,3,5,-4,2,6,2,4,2,2,3,-12,3,6,9,2,0,3,1,1,1,1,3,1
KR_6771080723,420,1,72,-33,7,2,2,0,3,5,2,-3,1,4,5,5,0,0,0,0,0,11,-18,-6,9,3,6,0,1,1,1,1,1,5,1
KR_6760854147,420,1,-53,-1,5,1,1,0,-1,0,1,5,5,0,-1,2,3,1,1,0,0,6,-6,-3,8,5,-1,0,1,-1,1,1,-1,5,1
KR_6745547274,440,0,-19,-19,5,4,5,1,-2,1,3,1,3,2,3,6,3,-1,0,1,0,5,261,-1,7,6,-3,0,0,1,1,1,1,5,1
KR_6772864384,420,0,-22,-13,2,2,3,1,-3,2,5,-2,2,4,3,5,2,2,4,2,0,1,-3,-1,6,5,3,0,0,-1,1,1,1,1,1
KR_6756376961,420,3,10,-8,13,4,4,0,7,8,1,2,5,3,-1,7,8,1,2,1,0,15,36,1,7,8,1,0,1,0,1,1,-1,0,1
KR_6772415914,420,0,2,9,-4,-2,2,4,-4,0,4,1,1,0,0,3,3,1,1,0,0,-6,33,8,3,11,-8,0,1,1,-1,1,-1,2,1
KR_6747137485,420,0,24,36,3,-2,1,3,3,3,0,3,3,0,-1,3,4,0,1,1,0,5,1,0,5,5,1,0,0,1,1,1,1,3,1
KR_6772608111,420,1,-22,-24,10,-3,1,4,2,3,1,2,5,3,10,13,3,-1,1,2,0,14,12,4,3,7,-4,0,1,1,-1,1,-1,3,1
KR_6769204867,440,0,-55,14,6,-1,3,4,-2,0,2,1,2,1,9,12,3,-1,0,1,0,5,-5,0,2,2,1,0,-1,-1,1,-1,1,2,1
KR_6763623985,440,1,28,24,2,-13,0,13,1,1,0,4,5,1,7,10,3,3,4,1,1,2,-8,0,5,5,3,0,-1,1,1,1,-1,1,1
KR_6769354346,420,1,0,-3,0,-4,1,5,3,4,1,-1,3,4,2,3,1,0,0,0,0,0,167,-8,11,3,-3,0,-1,1,-1,-1,-1,3,1
KR_6776116847,420,2,9,27,4,-1,0,1,5,7,2,-1,1,2,1,5,4,0,4,4,0,1,4,2,5,7,-4,0,-1,0,1,1,1,0,1
KR_6776740887,420,2,8,41,1,0,1,1,-3,3,6,2,2,0,2,4,2,0,0,0,0,1,-2,5,8,13,-3,0,-1,0,-1,-1,-1,0,1
KR_6737304821,420,4,14,0,7,3,3,0,-5,0,5,2,3,1,5,6,1,2,2,0,0,5,7,3,4,7,-3,0,0,-1,-1,0,1,4,1
KR_6738459437,420,4,139,-20,7,-1,0,1,4,4,0,3,3,0,0,0,0,1,2,1,-1,7,34,1,3,4,-14,0,1,1,1,1,-1,2,1
KR_6746656440,420,5,22,4,11,1,2,1,8,8,0,2,4,2,2,3,1,-2,2,4,0,15,5,5,5,10,-4,0,1,1,-1,1,-1,6,1
KR_6763339860,440,0,-4,11,2,3,4,1,-3,1,4,-2,0,2,2,6,4,2,3,1,0,1,-66,-2,4,2,10,0,1,0,0,1,-1,0,1
KR_6769626750,420,3,9,8,14,7,7,0,0,2,2,5,5,0,1,3,2,1,3,2,0,7,11,4,4,8,-5,0,3,1,-1,1,1,6,1
KR_6776519789,420,1,-17,-8,-1,2,2,0,0,3,3,-1,2,3,-1,3,4,-1,0,1,0,-5,-5,1,7,8,-1,0,-1,-1,1,-1,-1,4,1
KR_6777824633,420,2,39,12,1,-1,3,4,3,4,1,2,5,3,-2,2,4,-1,1,2,0,-1,-19,4,7,11,1,0,0,1,1,-1,1,1,1
KR_6777176843,420,3,45,-28,8,3,3,0,5,9,4,4,4,0,-3,3,6,-1,1,2,0,6,-2,2,6,8,-3,0,0,1,1,1,1,3,1
KR_6775245006,420,3,-22,39,1,0,3,3,4,7,3,0,5,5,-2,1,3,-1,0,1,0,5,5,3,5,8,-5,0,0,-1,1,0,-1,5,1
KR_6770236258,420,2,54,-3,9,6,7,1,-1,6,7,0,3,3,2,4,2,2,4,2,0,6,-68,3,3,6,15,0,1,1,-1,1,1,2,1
KR_6728381885,420,-2,-47,-18,-8,5,5,0,1,4,3,-1,1,2,-10,1,11,-3,1,4,0,-10,-8,-1,4,3,-4,0,0,-1,1,-1,-1,1,1
KR_6775598938,420,5,58,20,16,6,6,0,4,7,3,6,8,2,-2,1,3,2,2,0,1,16,29,0,6,6,1,0,2,-1,1,1,1,5,1
KR_6776169069,420,-1,37,26,-6,0,1,1,-3,2,5,0,3,3,-1,3,4,-2,0,2,-1,-1,-9,-2,8,6,5,0,0,-1,1,0,-1,6,1
KR_6776762015,420,4,32,20,1,1,2,1,3,7,4,-2,3,5,0,2,2,-1,0,1,2,5,-1,-1,5,4,4,0,0,1,1,0,1,3,1
KR_6776905639,420,3,-6,-13,2,2,2,0,1,3,2,-1,0,1,0,2,2,0,1,1,0,3,36,-2,9,7,-8,0,-1,-1,1,1,1,6,1
KR_6747567561,420,-2,-31,5,-9,-2,0,2,-8,1,9,1,4,3,5,11,6,-5,0,5,0,-2,-9,4,7,11,-1,0,-1,1,-1,-1,-1,6,1
KR_6752802540,440,1,-40,15,0,-3,1,4,1,1,0,-3,1,4,4,7,3,1,4,3,0,3,-10,0,10,10,-4,0,-1,-1,0,-1,-1,1,1
KR_6764053210,420,4,67,-12,18,-4,1,5,3,5,2,1,3,2,13,14,1,5,6,1,0,18,8,3,3,6,-8,0,3,1,1,1,1,3,1
KR_6776067798,420,0,72,4,-5,-1,0,1,-6,0,6,1,3,2,1,2,1,0,0,0,0,-8,0,0,5,5,2,0,0,1,-1,-1,1,5,1
KR_6774333642,420,2,52,17,8,2,3,1,-1,4,5,6,6,0,-1,4,5,2,4,2,1,4,7,2,4,6,1,0,2,-1,1,1,1,1,1
KR_6772747950,420,-3,-26,22,-5,0,3,3,1,2,1,-2,3,5,-5,0,5,1,2,1,0,-8,-159,2,4,6,-19,0,0,1,-1,-1,-1,4,1
KR_6706445434,420,4,13,4,7,4,4,0,-1,3,4,6,8,2,-2,2,4,0,2,2,-1,11,5,-2,8,6,-1,0,3,1,1,1,-1,4,1
KR_6777772824,420,5,38,16,6,4,5,1,3,5,2,0,2,2,0,1,1,-1,0,1,0,9,27,0,8,8,4,0,1,1,1,1,-1,4,1
KR_6744988552,420,2,113,-16,7,1,1,0,-4,1,5,7,7,0,2,2,0,1,1,0,0,9,-21,3,7,10,0,0,1,1,-1,1,1,4,1
KR_6742832295,420,0,0,-37,6,1,1,0,3,3,0,-2,3,5,6,8,2,-2,0,2,1,15,-15,0,10,10,4,0,0,-1,-1,1,1,1,1
KR_6775622095,420,-1,-21,8,-2,-1,3,4,1,3,2,-2,2,4,1,2,1,-1,0,1,0,-5,-19,-1,8,7,1,0,2,-1,1,1,1,5,1
KR_6777475014,420,2,32,-16,-1,-2,1,3,-5,0,5,5,8,3,0,6,6,1,2,1,0,-7,21,-2,8,6,0,0,1,-1,-1,1,-1,4,1
KR_6749262395,420,3,28,-7,9,3,4,1,10,10,0,0,2,2,-4,3,7,0,2,2,3,26,-2,10,5,15,2,0,1,-1,1,-1,1,3,1
KR_6752434065,440,-1,40,-12,-6,1,3,2,-6,1,7,1,1,0,2,3,1,-4,0,4,0,-16,-13,3,7,10,2,0,0,-1,1,0,1,6,1
KR_6775041249,440,3,42,9,7,-1,1,2,3,4,1,5,7,2,0,2,2,0,1,1,1,2,7,0,5,5,-1,0,0,1,-1,0,1,1,1
KR_6679221928,420,1,21,12,4,0,2,2,-3,1,4,1,3,2,5,10,5,1,1,0,0,5,2,-2,12,10,-4,0,0,1,-1,-1,1,5,1
KR_6773515987,420,-2,2,-15,2,-1,2,3,2,2,0,0,1,1,1,2,1,0,1,1,0,7,-7,-3,8,5,6,0,0,1,1,1,-1,3,1
KR_6777142025,420,1,-54,7,0,-3,1,4,-3,3,6,-4,1,5,5,8,3,5,5,0,-1,1,9,-1,11,10,2,0,-1,1,-1,-1,-1,3,1
KR_6774869604,420,0,-4,7,-4,-2,2,4,1,4,3,-3,4,7,5,6,1,-5,0,5,0,-11,6,6,5,11,1,0,-1,1,-1,-1,1,4,1
KR_6766073930,420,0,26,0,-3,-2,1,3,1,2,1,0,0,0,-1,0,1,-1,1,2,0,-3,17,-4,8,4,-6,0,1,1,-1,-1,-1,3,1
KR_6773104141,420,2,22,7,-1,2,2,0,0,4,4,1,1,0,-2,4,6,-2,0,2,0,-4,12,2,6,8,4,0,0,1,-1,-1,1,4,1
KR_6704284363,420,1,-10,12,0,0,0,0,0,2,2,6,7,1,-5,0,5,-1,0,1,0,-7,-10,-1,7,6,6,0,1,1,1,1,-1,5,1
KR_6777341198,420,4,111,-3,4,1,1,0,-2,0,2,0,4,4,4,4,0,1,1,0,0,5,21,4,4,8,-2,0,2,0,1,1,-1,0,1
KR_6707917784,440,2,71,20,2,5,5,0,-2,2,4,-1,1,2,0,1,1,0,0,0,0,0,3,4,5,9,-4,0,0,1,-1,1,-1,6,1
KR_6713191278,420,-1,69,19,0,1,2,1,0,2,2,0,3,3,0,3,3,-1,0,1,-1,-3,-14,5,3,8,-1,0,0,1,-1,-1,-1,5,1
KR_6777866490,420,-1,-53,-4,5,1,2,1,0,3,3,-1,4,5,4,6,2,1,2,1,0,7,104,-3,10,7,4,0,0,-1,1,1,1,5,1
KR_6756525232,420,3,79,43,3,-1,0,1,5,5,0,0,2,2,0,5,5,-1,0,1,0,8,-21,1,8,9,3,0,1,1,1,1,-1,5,1
KR_6770126093,420,3,21,37,6,0,2,2,0,3,3,-1,2,3,7,8,1,0,2,2,1,9,8,0,6,6,3,0,1,1,-1,1,1,4,1
KR_6766447219,420,1,-22,-11,9,1,2,1,6,8,2,1,1,0,-1,2,3,2,2,0,-1,8,3,7,5,12,6,0,0,-1,1,1,-1,4,1
KR_6726846048,420,0,-6,20,-6,-3,0,3,-2,3,5,0,0,0,0,0,0,-1,0,1,0,-4,-32,-3,7,4,5,0,0,1,1,0,-1,6,1
KR_6763585568,420,4,-23,25,12,6,7,1,3,3,0,-1,5,6,2,4,2,2,2,0,0,11,126,1,3,4,-6,0,2,1,1,1,-1,4,1
KR_6755067509,420,5,46,-20,11,16,16,0,-1,1,2,-5,1,6,-1,0,1,2,2,0,0,20,27,0,5,5,1,0,3,-1,1,1,1,3,1
KR_6754576375,420,1,-3,-7,11,2,2,0,2,5,3,0,2,2,4,6,2,3,3,0,0,7,291,-2,7,5,1,0,1,1,-1,1,1,4,1
KR_6734253548,420,4,78,-17,7,0,2,2,2,4,2,2,3,1,3,7,4,0,0,0,1,10,-2,-9,12,3,4,0,1,1,1,1,1,2,1
KR_6774256006,420,0,54,-15,-3,1,2,1,-1,1,2,0,3,3,-2,2,4,-1,1,2,0,-13,-3,-3,7,4,0,0,0,1,-1,0,-1,2,1
KR_6651999900,420,2,-34,23,3,3,3,0,-2,1,3,2,3,1,-1,2,3,1,2,1,0,-2,-2,0,8,8,6,0,0,1,1,0,-1,5,1
KR_6765434483,420,0,96,-19,-2,1,1,0,-1,4,5,-5,0,5,3,4,1,0,2,2,0,-3,-15,0,8,8,5,0,0,1,-1,0,-1,2,1
KR_6774858864,420,4,38,-19,4,-4,1,5,1,2,1,2,3,1,4,4,0,1,2,1,1,14,-4,-8,8,0,-1,0,-1,1,-1,-1,1,6,1
KR_6729746728,440,3,18,0,11,0,2,2,2,2,0,1,1,0,8,8,0,0,0,0,2,18,44,2,8,10,-35,0,0,1,-1,1,1,4,1
KR_6703054265,440,4,76,24,10,1,1,0,0,4,4,-1,2,3,9,13,4,1,1,0,0,6,-4,4,0,4,1,0,0,1,0,1,-1,3,1
KR_6776467697,420,-1,33,-4,4,-1,1,2,-2,0,2,3,3,0,4,4,0,0,1,1,0,7,10,0,5,5,1,0,0,1,-1,1,1,4,1
KR_6761460858,420,-1,-51,-25,5,-1,3,4,-1,0,1,-1,0,1,6,7,1,2,2,0,0,4,36,-1,5,4,0,0,0,-1,1,-1,1,3,1
KR_6761662991,440,9,98,77,19,8,17,9,-4,0,4,10,10,0,0,3,3,5,5,0,0,9,27,-1,7,6,7,0,3,1,1,1,1,4,1
KR_6772649061,420,7,66,55,14,-1,0,1,4,5,1,2,2,0,9,10,1,0,0,0,0,28,4,3,7,10,3,0,1,-1,1,1,1,2,1
KR_6765943564,420,2,109,-29,5,8,8,0,0,1,1,-1,5,6,-2,1,3,0,3,3,0,-4,14,6,5,11,-5,0,2,-1,1,1,1,6,1
KR_6754893451,420,4,-9,27,3,-2,3,5,4,7,3,0,2,2,-1,0,1,2,2,0,0,6,-35,2,5,7,5,0,0,1,1,-1,-1,1,1
KR_6777674170,420,1,3,-1,2,7,7,0,-3,0,3,-2,1,3,0,1,1,0,1,1,0,-4,167,1,4,5,-5,0,0,1,1,1,-1,1,1
KR_6774333938,420,7,126,63,13,3,4,1,5,7,2,3,3,0,-2,3,5,4,4,0,0,6,-175,0,3,3,1,0,0,1,1,1,1,1,1
KR_6710565951,420,5,56,19,6,2,2,0,4,7,3,-1,1,2,0,2,2,1,1,0,0,9,-69,-1,9,8,-5,0,0,1,1,0,1,1,1
KR_6728414031,440,-2,-71,-28,-5,2,4,2,3,4,1,-3,9,12,-2,4,6,-5,4,9,0,-16,-12,7,1,8,-3,0,1,1,1,1,1,6,1
KR_6764220361,420,4,52,5,10,1,2,1,4,6,2,3,6,3,0,5,5,2,2,0,0,1,340,-1,4,3,1,0,1,1,1,1,1,3,1
KR_6744080428,420,3,3,12,2,-1,1,2,0,3,3,-2,0,2,4,5,1,1,1,0,0,6,-4,1,8,9,9,0,3,1,1,1,1,3,1
KR_6717460667,420,1,-41,11,-6,3,3,0,-4,0,4,1,2,1,-5,1,6,-1,0,1,-1,-15,3,-5,8,3,2,0,-2,-1,-1,-1,-1,5,1
KR_6721326887,420,2,-3,11,3,-1,0,1,3,3,0,1,1,0,0,2,2,0,0,0,0,7,43,0,8,8,-1,0,0,1,-1,-1,1,6,1
KR_6698197315,420,2,9,0,6,4,6,2,-1,2,3,1,3,2,3,4,1,-1,0,1,0,2,104,-3,7,4,2,0,1,1,-1,1,1,3,1
KR_6776959539,420,1,-28,11,5,2,2,0,4,5,1,4,4,0,-4,1,5,-1,0,1,0,10,-4,0,6,6,3,0,0,1,-1,0,-1,2,1
KR_6776813281,420,4,25,-2,5,0,1,1,-1,2,3,5,7,2,-3,1,4,4,5,1,0,11,6,-3,9,6,6,0,1,-1,1,1,-1,2,1
KR_6684216157,420,0,-41,16,3,-1,0,1,4,4,0,-1,1,2,3,4,1,-2,2,4,0,5,15,5,5,10,1,0,-2,1,-1,-1,-1,5,1
KR_6724865428,420,1,43,-14,3,4,4,0,-3,2,5,5,5,0,-3,1,4,0,4,4,0,-1,1,2,6,8,2,0,-1,-1,-1,-1,-1,1,1
KR_6710641606,420,-1,-45,3,6,-2,1,3,-3,1,4,0,0,0,7,8,1,4,5,1,0,13,6,0,6,6,-1,0,-2,1,-1,-1,1,4,1
KR_6719363159,420,0,-30,-8,3,4,4,0,-3,2,5,5,6,1,-2,1,3,-1,1,2,-1,2,-28,3,4,7,-3,0,-1,-1,-1,1,-1,5,1
KR_6770992660,420,3,66,-6,7,-1,1,2,-6,1,7,2,4,2,10,12,2,2,5,3,0,8,9,4,3,7,1,1,5,1,1,1,1,6,1
KR_6776085970,420,2,-10,34,8,-5,0,5,5,6,1,4,4,0,1,2,1,3,3,0,2,17,1,4,6,10,1,0,0,1,-1,1,-1,3,1
KR_6736665783,420,2,35,-10,12,6,6,0,1,4,3,4,4,0,0,2,2,1,1,0,0,13,-28,3,6,9,26,0,3,1,1,1,1,6,1
KR_6763696886,420,2,49,13,7,4,4,0,-4,1,5,7,8,1,0,3,3,0,1,1,-1,-4,0,-3,7,4,3,0,1,1,-1,1,-1,1,1
KR_6776835545,420,-1,-22,-19,0,0,1,1,-1,0,1,-2,3,5,2,2,0,1,1,0,0,-4,-1,-2,9,7,3,0,-1,-1,1,-1,1,6,1
KR_6732450359,420,1,4,-22,3,2,2,0,-3,1,4,1,2,1,1,2,1,2,2,0,0,-4,9,5,4,9,0,0,0,1,-1,0,1,2,1
KR_6755100140,420,0,-20,27,-3,-2,1,3,-2,2,4,1,2,1,0,3,3,0,1,1,0,-1,1,-2,6,4,-1,0,0,1,1,-1,-1,3,1
KR_6771924270,420,1,7,10,3,-3,1,4,2,5,3,1,1,0,2,4,2,1,1,0,-1,14,23,-2,10,8,0,0,0,1,-1,0,-1,4,1
KR_6776720264,420,2,-25,-10,2,0,2,2,1,1,0,0,2,2,2,4,2,-1,0,1,0,4,7,7,3,10,-5,0,1,1,1,1,-1,3,1
KR_6776450751,420,0,16,-12,1,3,5,2,-1,2,3,-1,2,3,0,4,4,0,2,2,-1,6,-22,2,8,10,2,0,-1,1,-1,-1,-1,4,1
KR_6761394431,420,2,-30,12,2,-1,1,2,6,6,0,-1,2,3,0,2,2,-2,0,2,0,3,10,4,4,8,-6,0,0,-1,-1,0,1,5,1
KR_6771396084,420,-2,2,21,-6,4,4,0,-3,5,8,-1,1,2,-4,2,6,-2,1,3,0,-14,-55,-1,4,3,1,0,0,1,-1,-1,1,6,1
KR_6716285387,420,2,29,4,2,-1,0,1,-4,2,6,3,6,3,3,3,0,1,1,0,-1,6,-1,3,5,8,0,0,1,1,1,1,-1,6,1
KR_6741323056,420,0,-12,-14,1,4,5,1,-1,0,1,0,3,3,0,6,6,-2,0,2,-1,1,3,-2,13,11,-4,0,-3,-1,-1,-1,-1,5,1
KR_6768400399,420,1,71,2,3,-2,2,4,2,4,2,0,3,3,4,5,1,-1,0,1,0,-3,-57,1,5,6,3,0,2,1,-1,1,1,3,1
KR_6665515464,420,-2,-27,-1,1,-3,0,3,0,1,1,1,5,4,2,3,1,1,2,1,0,7,-6,-2,10,8,6,0,0,-1,1,1,-1,1,1
KR_6774330784,420,1,36,-14,7,3,4,1,2,4,2,2,2,0,1,4,3,-1,1,2,0,7,6,9,2,11,0,0,1,-1,1,1,1,6,1
KR_6776074461,420,2,-15,4,4,-1,1,2,6,6,0,-3,2,5,-1,2,3,3,3,0,0,9,-1,1,6,7,1,0,0,1,-1,0,1,3,1
KR_6770211348,420,2,-24,0,7,0,1,1,1,3,2,0,0,0,5,7,2,1,3,2,-1,8,-24,2,3,5,5,0,-1,1,-1,-1,-1,6,1
KR_6775684366,420,2,54,-23,3,6,6,0,-1,0,1,0,0,0,-2,1,3,0,3,3,0,0,0,-4,9,5,-2,0,0,-1,1,1,-1,5,1
KR_6700530108,420,3,20,15,7,0,5,5,-2,3,5,2,4,2,6,7,1,1,1,0,0,12,0,1,6,7,1,0,2,1,-1,1,1,6,1
KR_6754213137,420,1,20,32,-5,0,2,2,-3,2,5,2,3,1,-2,0,2,-2,0,2,0,-5,-8,-6,10,4,5,0,-2,-1,-1,-1,-1,3,1
KR_6756349660,420,0,11,-40,0,-1,2,3,0,2,2,3,3,0,-1,0,1,-1,0,1,2,3,-1,0,5,5,0,0,-1,1,-1,-1,1,2,1
KR_6775263704,420,-1,-22,-29,1,-4,1,5,-1,1,2,1,1,0,4,4,0,1,1,0,0,9,9,0,6,6,-3,0,0,1,-1,-1,-1,2,1
KR_6773823940,420,8,120,35,18,5,5,0,2,3,1,6,7,1,2,2,0,3,3,0,0,27,4,3,4,7,2,0,3,1,1,1,1,1,1
KR_6753106418,420,3,-57,4,14,-2,0,2,1,2,1,8,9,1,3,5,2,4,4,0,0,27,15,4,3,7,1,0,0,-1,-1,-1,1,4,1
KR_6772355733,420,7,0,60,6,3,3,0,2,4,2,-1,6,7,4,6,2,-2,0,2,0,6,-6,-2,7,5,-1,0,1,1,1,1,-1,3,1
KR_6770751660,420,-1,-15,-12,-5,-2,1,3,-2,3,5,1,2,1,2,2,0,-4,0,4,0,-1,-12,-2,7,5,10,0,-2,-1,-1,-1,1,1,1
KR_6665805258,420,5,42,8,7,2,3,1,3,4,1,0,2,2,2,3,1,0,0,0,0,13,-4,-1,5,4,4,0,0,-1,1,1,-1,5,1
KR_6710396482,420,5,35,21,15,2,3,1,4,5,1,5,5,0,2,3,1,2,2,0,1,21,0,1,7,8,4,0,3,1,-1,1,1,6,1
KR_6776668504,420,1,-5,14,-6,-6,1,7,-2,3,5,-1,3,4,2,3,1,1,3,2,-1,1,1,3,6,9,-1,0,-2,-1,-1,-1,-1,5,1
KR_6774226208,420,3,19,4,6,1,1,0,6,7,1,-2,1,3,2,5,3,-1,0,1,0,12,1,2,6,8,-1,0,1,-1,1,1,1,6,1
KR_6774680027,420,1,2,-32,9,2,3,1,0,3,3,3,3,0,5,9,4,-1,0,1,0,2,-3,5,6,11,1,0,-1,1,-1,-1,1,2,1
KR_6775363497,420,1,34,-8,-6,0,0,0,1,4,3,4,5,1,-7,2,9,-4,1,5,-1,-10,-48,2,5,7,-5,0,-1,1,-1,1,-1,6,1
KR_6754079801,420,-1,-7,5,-4,-4,2,6,2,4,2,0,0,0,-1,2,3,-1,0,1,0,-6,-1,-1,8,7,4,0,-1,-1,1,-1,-1,3,1
KR_6774797084,420,6,106,28,11,3,3,0,2,3,1,3,4,1,2,7,5,1,2,1,1,9,18,4,4,8,-1,0,3,1,1,1,1,2,1
KR_6761683382,420,1,37,3,5,-2,0,2,-3,1,4,5,5,0,3,5,2,2,3,1,0,1,147,-3,10,7,4,0,1,1,-1,1,-1,6,1
KR_6666119313,420,0,-27,-11,-2,0,1,1,-1,5,6,-1,2,3,0,4,4,0,1,1,0,1,-10,6,3,9,2,0,-1,-1,1,-1,-1,1,1
KR_6735392172,420,2,-18,-12,1,-1,2,3,1,2,1,3,3,0,-2,1,3,0,0,0,0,-1,-9,-7,12,5,4,0,-1,-1,-1,-1,-1,4,1
KR_6777292442,420,2,37,23,6,2,4,2,6,6,0,-2,2,4,-2,2,4,2,2,0,1,9,173,0,9,9,7,0,2,1,-1,1,1,2,1
KR_6705949901,420,-1,-36,5,2,-5,0,5,4,6,2,0,1,1,4,6,2,-1,0,1,0,9,0,5,5,10,1,0,0,1,1,0,1,6,1
KR_6734916947,420,0,-6,36,-6,1,3,2,-4,0,4,-4,2,6,3,6,3,-2,0,2,-1,-14,-4,-6,10,4,-1,0,2,1,1,1,-1,4,1
KR_6770195438,420,5,-10,31,4,-2,1,3,5,8,3,0,1,1,-2,3,5,3,3,0,2,12,32,-1,6,5,4,0,0,1,-1,1,1,5,1
KR_6737158628,420,-1,31,-17,-1,0,1,1,1,3,2,-1,2,3,-2,1,3,1,1,0,0,-7,5,1,4,5,-3,0,-1,1,-1,-1,-1,3,1
KR_6754291104,420,1,5,7,-2,0,3,3,3,5,2,-3,1,4,-3,2,5,1,1,0,0,-10,221,-4,10,6,0,0,0,-1,1,1,-1,5,1
KR_6724322829,420,3,5,15,8,-2,0,2,3,3,0,2,4,2,4,4,0,1,3,2,0,13,18,0,6,6,4,0,1,1,-1,1,1,2,1
KR_6743246995,420,5,19,22,9,0,0,0,4,7,3,2,4,2,3,6,3,0,1,1,0,16,-13,-5,10,5,1,0,1,1,1,-1,-1,5,1
KR_6732973388,440,3,56,12,2,-4,0,4,4,7,3,-2,1,3,3,3,0,1,1,0,0,12,11,3,5,8,-1,0,1,1,-1,-1,1,2,1
KR_6742924943,420,7,47,17,14,0,1,1,10,10,0,0,1,1,4,5,1,0,0,0,0,17,25,-2,7,5,4,0,0,1,1,1,1,1,1
KR_6736546092,420,1,35,5,4,1,2,1,-3,2,5,3,4,1,3,4,1,0,1,1,0,4,47,0,7,7,-10,0,-1,-1,-1,-1,1,1,1
KR_6714736873,420,1,74,11,12,3,5,2,3,5,2,-1,3,4,7,8,1,0,2,2,2,10,3,3,6,9,2,0,1,1,1,1,1,5,1
KR_6777052756,440,-2,18,-27,-7,-1,3,4,-2,1,3,3,4,1,-2,0,2,-5,0,5,0,-8,5,2,3,5,0,0,-2,0,1,-1,-1,0,1
KR_6764638220,420,2,-21,-27,12,0,3,3,4,5,1,0,2,2,5,8,3,3,3,0,0,14,-2,0,5,5,1,0,2,-1,-1,1,-1,3,1
KR_6775902176,420,0,-23,8,-1,-1,3,4,1,3,2,-1,3,4,-5,2,7,5,5,0,3,3,8,-3,9,6,-5,0,-1,-1,1,-1,1,4,1
KR_6777855537,420,2,50,9,7,4,5,1,2,3,1,1,1,0,0,3,3,0,1,1,0,6,2,6,3,9,-4,0,1,-1,1,1,-1,5,1
KR_6755342566,420,7,49,13,9,3,3,0,4,6,2,3,3,0,-2,2,4,1,4,3,0,7,6,2,5,7,-2,0,1,1,1,1,-1,3,1
KR_6738691482,420,5,55,-12,15,0,1,1,2,4,2,7,7,0,5,7,2,1,2,1,0,21,8,4,1,5,0,0,0,1,-1,0,1,1,1
KR_6768112822,420,-1,51,-25,-3,-1,1,2,2,2,0,1,6,5,-3,3,6,-2,1,3,-2,3,-1,6,4,10,1,0,-1,-1,-1,-1,1,1,1
KR_6733134638,420,6,84,28,12,-1,1,2,4,4,0,2,4,2,1,3,2,6,7,1,1,30,10,4,0,4,1,0,1,1,1,1,1,5,1
KR_6643361886,420,0,-52,-12,3,-3,2,5,5,6,1,3,6,3,-3,1,4,1,4,3,0,17,3,-2,5,3,3,0,0,1,1,1,1,4,1
KR_6772618342,420,4,8,3,-1,1,2,1,-4,5,9,3,6,3,-1,6,7,0,2,2,-3,-2,7,1,8,9,-3,0,2,-1,-1,1,-1,4,1
KR_6774685868,420,-2,-40,-9,-7,2,2,0,-2,2,4,-6,0,6,2,2,0,-3,1,4,0,-9,-5,-3,8,5,-4,0,-1,-1,-1,-1,1,5,1
KR_6751427659,440,1,53,-6,-8,-8,0,8,1,2,1,-3,2,5,3,4,1,-1,2,3,0,-11,40,0,3,3,-28,0,0,0,1,1,-1,0,1
KR_6753833864,420,5,56,20,12,2,2,0,1,4,3,2,2,0,5,6,1,2,2,0,0,17,3,5,1,6,2,0,2,1,1,1,1,5,1
KR_6754110882,420,4,69,-5,7,1,1,0,3,4,1,1,3,2,0,1,1,2,2,0,0,9,-47,0,9,9,19,0,0,1,-1,0,-1,6,1
KR_6723471951,420,0,27,-22,-3,-8,0,8,2,2,0,-3,0,3,5,6,1,1,1,0,-3,3,42,3,5,8,0,0,0,-1,1,1,-1,5,1
KR_6772175564,420,2,29,-7,6,4,4,0,0,1,1,-1,4,5,4,6,2,-1,2,3,0,8,-13,3,3,6,-2,0,0,-1,1,0,-1,4,1
KR_6777715431,420,3,-3,-5,6,3,3,0,5,7,2,1,3,2,-2,2,4,-1,0,1,0,8,-3,-5,9,4,0,0,-2,-1,-1,-1,-1,5,1
KR_6773549114,440,4,49,3,15,1,1,0,1,6,5,4,7,3,5,6,1,4,4,0,0,15,5,5,3,8,2,0,1,1,-1,1,1,2,1
KR_6774592145,420,2,14,20,6,1,1,0,-2,3,5,0,2,2,7,7,0,0,0,0,0,7,-6,-3,9,6,-2,0,0,1,-1,0,1,4,1
KR_6755142297,420,1,80,8,8,6,9,3,1,4,3,-4,2,6,4,4,0,1,1,0,0,16,40,6,2,8,1,0,2,1,1,1,1,1,1
KR_6758456097,420,2,94,3,8,2,3,1,-1,4,5,5,6,1,2,4,2,0,1,1,0,6,1,-2,7,5,2,0,4,1,-1,-1,-1,3,1
KR_6704378328,420,6,125,29,7,2,4,2,0,0,0,3,3,0,0,2,2,2,2,0,0,12,-24,1,4,5,5,0,5,1,1,1,1,4,1
KR_6776193767,420,2,21,15,5,3,6,3,3,9,6,-1,1,2,1,2,1,-1,3,4,0,-1,-1,3,5,8,1,0,-1,1,-1,-1,1,4,1
KR_6729286331,420,2,-7,1,-2,0,1,1,-3,3,6,-2,5,7,4,6,2,-1,1,2,0,9,-6,1,8,9,0,0,-2,1,-1,-1,1,2,1
KR_6771391198,420,2,77,-2,11,-1,3,4,3,4,1,2,3,1,6,7,1,1,1,0,0,19,113,1,6,7,4,0,3,1,-1,1,-1,2,1
KR_6748139691,420,2,33,-4,10,3,5,2,-1,3,4,-1,1,2,6,8,2,3,3,0,0,21,11,4,7,11,-2,0,2,1,-1,1,1,5,1
KR_6776500472,420,0,-21,-26,-3,8,9,1,-6,1,7,-1,0,1,-3,1,4,-1,0,1,-1,-15,-5,-1,8,7,8,0,0,-1,-1,-1,-1,5,1
KR_6772762563,420,0,59,-10,0,2,2,0,-3,1,4,-4,0,4,6,7,1,-1,0,1,0,-9,-1,1,7,8,1,0,0,1,1,1,1,6,1
KR_6777616843,420,1,38,12,-7,4,5,1,-8,1,9,1,3,2,-3,1,4,-1,0,1,-1,-19,22,-9,14,5,-3,0,1,-1,1,-1,-1,3,1
KR_6727214395,440,-2,-14,2,-9,0,1,1,0,3,3,-5,1,6,-1,6,7,-3,0,3,0,-28,-33,1,7,8,5,0,-2,-1,-1,-1,1,5,1
KR_6722032708,420,-3,16,-4,-1,-1,2,3,1,4,3,0,4,4,1,2,1,-2,0,2,0,3,-7,1,8,9,5,0,-1,-1,-1,-1,1,6,1
KR_6737545793,420,5,88,41,3,5,6,1,1,1,0,0,2,2,-4,0,4,1,2,1,0,-8,15,2,5,7,-4,0,2,-1,1,1,-1,6,1
KR_6701837050,420,1,-4,22,4,1,1,0,0,2,2,3,4,1,0,1,1,0,0,0,0,9,6,6,6,12,-3,0,0,-1,1,1,1,5,1
KR_6775317359,420,2,6,1,10,-2,1,3,9,9,0,1,1,0,4,5,1,-2,0,2,0,12,-2,4,3,7,6,0,-2,1,-1,-1,1,1,1
KR_6763558585,440,4,70,-3,18,4,5,1,1,4,3,6,8,2,0,1,1,7,8,1,2,19,12,-1,6,5,-3,0,2,0,0,1,1,0,1
KR_6748146719,420,7,95,56,16,1,6,5,10,14,4,-1,2,3,4,6,2,2,3,1,1,17,-7,-4,10,6,8,0,2,1,1,1,-1,5,1
KR_6752205258,440,5,131,20,17,4,5,1,2,5,3,4,8,4,3,5,2,4,5,1,3,17,1,-1,1,0,4,0,2,1,1,1,1,6,1
KR_6776853343,420,0,66,11,-6,-2,1,3,-3,1,4,4,4,0,-3,4,7,-2,0,2,0,-3,0,3,4,7,-2,0,0,1,-1,1,1,2,1
KR_6777802480,420,2,34,28,-3,1,1,0,0,6,6,-1,1,2,-1,1,2,-2,0,2,0,-1,-8,-6,14,8,9,0,-1,-1,-1,-1,-1,1,1
KR_6775443286,420,0,-30,6,2,4,4,0,-5,1,6,0,3,3,5,6,1,-2,1,3,0,-3,13,6,3,9,0,0,2,1,1,1,1,3,1
KR_6777419460,420,-1,43,-8,3,1,2,1,0,2,2,1,1,0,0,2,2,1,2,1,0,1,68,1,4,5,-31,0,-1,-1,1,-1,-1,1,1
KR_6746682647,420,2,35,-16,6,1,3,2,1,2,1,2,2,0,-4,3,7,6,8,2,0,0,10,2,7,9,-7,0,1,1,-1,1,-1,6,1
KR_6743324494,420,-2,5,-5,0,1,1,0,-1,1,2,-1,0,1,3,3,0,-2,0,2,0,0,31,4,5,9,0,0,0,1,1,0,1,3,1
KR_6773170298,420,-3,28,-12,-2,-4,0,4,-6,2,8,3,5,2,3,4,1,2,3,1,0,-4,13,2,3,5,1,0,0,1,-1,0,1,4,1
KR_6755237069,420,4,6,23,4,0,0,0,-6,4,10,4,6,2,3,6,3,3,4,1,0,-2,-6,-2,8,6,-1,0,0,1,-1,-1,1,5,1
KR_6744652590,420,3,12,-33,12,4,5,1,-3,0,3,8,10,2,2,4,2,1,4,3,0,18,27,-3,8,5,1,0,-1,1,1,1,-1,2,1
KR_6776010165,420,1,4,9,8,-2,2,4,3,7,4,0,1,1,6,9,3,1,4,3,0,19,6,3,5,8,-1,0,4,1,1,1,1,3,1
KR_6775040263,420,-2,-21,-26,-5,0,3,3,1,5,4,-2,0,2,-4,3,7,0,0,0,0,-5,-45,-4,9,5,5,0,0,-1,-1,-1,-1,1,1
KR_6772830082,420,2,4,8,11,-4,0,4,6,7,1,3,4,1,3,5,2,3,4,1,1,21,6,2,3,5,1,0,0,1,-1,1,1,6,1
KR_6750060326,420,2,16,-15,8,2,3,1,3,5,2,0,2,2,3,6,3,0,1,1,0,7,3,-1,5,4,0,0,2,1,-1,1,1,1,1
KR_6728469702,420,4,89,32,5,3,3,0,-1,1,2,0,0,0,4,6,2,-1,0,1,0,7,2,-1,8,7,-1,0,1,1,1,1,-1,1,1
KR_6748681077,420,-1,10,-12,2,-1,1,2,-4,1,5,3,5,2,1,2,1,3,3,0,0,-1,21,3,7,10,-2,0,1,1,-1,1,1,4,1
KR_6751533016,420,4,-1,-6,11,-1,1,2,4,6,2,0,1,1,4,7,3,4,4,0,0,20,-1,-5,8,3,2,0,1,1,1,1,1,2,1
KR_6721329142,420,2,-3,62,0,3,3,0,4,4,0,-3,4,7,-3,3,6,-1,2,3,-1,-4,-67,2,5,7,28,0,1,1,1,1,-1,5,1
KR_6721253486,420,0,-41,-34,5,-3,0,3,1,4,3,0,1,1,6,8,2,1,1,0,1,17,-44,-3,8,5,28,0,1,1,-1,1,1,4,1
KR_6770495044,440,8,101,36,18,4,4,0,5,5,0,5,6,1,2,4,2,2,2,0,0,13,11,1,3,4,1,0,2,1,1,1,1,5,1
KR_6757048939,420,-1,28,-4,-1,-2,1,3,-2,2,4,3,5,2,-1,3,4,1,3,2,0,1,-8,-2,7,5,-4,0,0,-1,-1,-1,1,3,1
KR_6776190873,420,1,16,16,-1,-2,1,3,6,8,2,2,4,2,-4,0,4,-3,0,3,-1,-2,-6,1,5,6,0,0,0,-1,-1,0,-1,4,1
KR_6774259376,420,-1,-18,-4,-2,-5,0,5,2,4,2,3,4,1,-1,0,1,-1,2,3,0,4,1,1,3,4,-1,0,0,1,1,1,-1,5,1
KR_6777750845,420,1,37,4,5,0,2,2,1,5,4,1,4,3,4,4,0,-1,0,1,0,8,-9,-4,6,2,6,0,0,1,-1,0,1,4,1
KR_6769720130,420,5,76,8,10,2,5,3,6,8,2,0,1,1,-1,0,1,3,4,1,0,7,4,-1,6,5,5,0,1,1,-1,1,1,5,1
KR_6752940099,420,6,93,19,12,1,2,1,2,2,0,7,7,0,-2,2,4,4,4,0,2,11,7,0,5,5,6,0,4,1,1,1,-1,4,1
KR_6744793951,420,4,34,9,11,2,4,2,4,6,2,3,4,1,2,3,1,0,0,0,0,13,44,2,6,8,-5,0,1,1,1,1,-1,5,1
KR_6762218760,420,4,55,0,6,2,4,2,5,5,0,0,2,2,0,5,5,-1,0,1,0,-4,-114,-3,7,4,-1,0,2,-1,1,1,1,6,1
KR_6757465574,420,0,48,-44,7,4,5,1,4,7,3,0,3,3,-3,1,4,2,3,1,0,16,-10,5,2,7,-3,0,2,1,1,1,1,1,1
KR_6733453196,420,0,20,20,2,-1,1,2,0,3,3,-3,1,4,3,3,0,3,3,0,0,3,-22,1,8,9,-4,0,0,1,1,0,1,2,1
KR_6762182975,420,3,34,-11,5,1,1,0,3,5,2,1,1,0,0,4,4,0,0,0,1,3,-17,-1,10,9,-7,0,0,1,-1,0,1,1,1
KR_6766125854,420,0,18,-23,10,4,5,1,4,7,3,1,2,1,2,3,1,-1,2,3,0,16,19,6,2,8,-5,0,-1,-1,1,1,1,6,1
KR_6645946417,420,-1,10,6,-3,1,1,0,2,4,2,-5,2,7,1,3,2,-2,0,2,0,-9,-27,-1,10,9,3,0,-1,-1,1,-1,1,5,1
KR_6775736679,420,2,-8,14,7,1,1,0,-1,2,3,-3,3,6,10,10,0,0,2,2,0,16,18,3,4,7,-3,0,1,1,-1,1,-1,2,1
KR_6751105777,420,8,85,29,29,6,6,0,10,11,1,4,5,1,3,3,0,6,7,1,0,38,-10,5,4,9,1,0,4,0,1,1,1,0,1
KR_6711069518,440,2,29,12,6,1,2,1,4,4,0,-5,0,5,1,1,0,5,5,0,0,3,-28,0,7,7,7,0,1,-1,1,1,1,6,1
KR_6732227408,420,1,-10,17,4,3,4,1,2,4,2,0,3,3,-6,1,7,5,5,0,-2,-3,-1,-5,11,6,4,0,1,-1,1,1,-1,5,1
KR_6774480600,420,2,38,-3,7,4,4,0,3,4,1,1,4,3,-1,2,3,0,0,0,0,4,35,5,4,9,1,0,1,1,1,1,-1,3,1
KR_6763681883,420,-1,28,-6,2,0,0,0,-2,1,3,-1,0,1,6,8,2,-1,0,1,2,3,-24,0,6,6,1,0,1,1,-1,1,1,3,1
KR_6735433031,420,6,112,17,20,1,4,3,9,11,2,0,1,1,5,7,2,5,6,1,1,32,40,3,7,10,3,0,1,1,-1,1,1,1,1
KR_6768001072,440,1,7,3,5,-4,0,4,3,3,0,1,5,4,4,10,6,1,1,0,0,1,-2,-1,3,2,-2,0,0,-1,0,-1,-1,5,1
KR_6764091933,420,0,-11,5,3,-2,1,3,2,3,1,7,8,1,-4,0,4,0,0,0,1,6,-2,4,4,8,-1,0,1,-1,-1,1,1,4,1
KR_6752800228,420,5,37,-4,6,-2,2,4,5,7,2,1,3,2,3,5,2,-1,1,2,0,15,10,2,3,5,-4,0,0,1,-1,-1,-1,3,1
KR_6711977097,420,4,48,10,6,3,4,1,6,9,3,2,2,0,-3,3,6,-2,2,4,-1,10,28,3,5,8,-2,0,2,1,1,1,1,1,1
KR_6771842098,420,0,75,-6,6,3,4,1,1,3,2,1,2,1,2,4,2,-1,0,1,1,1,-2,6,5,11,-3,0,0,1,1,1,1,2,1
KR_6774877648,420,4,16,29,19,9,9,0,0,4,4,10,10,0,-2,0,2,2,2,0,1,18,1,9,1,10,1,0,3,1,1,1,1,3,1
KR_6737809656,420,6,12,0,11,2,3,1,6,7,1,3,3,0,-4,0,4,4,4,0,0,8,6,4,2,6,1,0,2,1,1,1,1,6,1
KR_6774945992,420,0,32,4,-2,0,1,1,6,7,1,-3,2,5,-5,0,5,0,0,0,1,-5,-8,-1,9,8,5,0,0,-1,1,1,1,6,1
KR_6769313117,420,5,61,6,8,4,6,2,9,11,2,-3,1,4,-2,1,3,0,1,1,1,4,4,0,5,5,1,0,3,1,1,1,1,6,1
KR_6638364100,420,-1,13,-24,2,2,2,0,3,6,3,-2,3,5,0,2,2,-1,3,4,1,6,-6,0,8,8,6,0,1,1,1,1,1,6,1
KR_6710316148,420,0,56,15,3,-1,2,3,-1,3,4,8,10,2,-2,3,5,-1,0,1,0,1,6,1,7,8,3,0,1,-1,1,1,1,2,1
KR_6776970675,420,1,24,-15,-3,2,3,1,-6,4,10,-2,1,3,3,4,1,0,0,0,0,-4,-5,-3,6,3,2,0,0,1,1,1,-1,3,1
KR_6764320891,420,5,107,4,15,3,3,0,5,5,0,7,7,0,1,6,5,-1,1,2,0,9,-114,1,6,7,4,0,3,1,1,1,-1,2,1
KR_6770169935,440,0,-22,33,5,2,3,1,0,4,4,4,7,3,1,2,1,-2,0,2,0,6,-4,-3,6,3,2,0,0,1,1,0,1,6,1
KR_6736954840,420,3,-13,32,10,1,3,2,4,5,1,2,2,0,2,6,4,1,1,0,0,10,11,-4,7,3,-1,0,1,-1,1,1,-1,2,1
KR_6769971159,440,0,-71,16,2,4,7,3,1,4,3,1,2,1,-2,1,3,-2,1,3,-1,4,-4,-2,7,5,5,0,-2,1,1,-1,-1,2,1
KR_6765912869,420,2,28,43,3,6,7,1,-1,3,4,-2,1,3,-1,5,6,1,2,1,1,-8,-3,-4,10,6,1,0,1,1,-1,1,1,3,1
KR_6761636125,420,3,50,6,-2,2,4,2,1,5,4,-4,1,5,-1,1,2,0,1,1,0,1,120,5,3,8,0,0,1,1,1,1,1,6,1
KR_6721898501,420,2,0,34,11,1,2,1,4,5,1,5,6,1,0,2,2,1,1,0,0,15,34,0,6,6,-1,0,1,1,1,1,1,1,1
KR_6738714752,420,-3,40,-3,0,-2,1,3,2,6,4,-1,1,2,1,1,0,0,0,0,0,3,3,1,6,7,-4,0,0,-1,1,0,-1,3,1
KR_6768750435,420,2,8,-7,4,2,2,0,0,1,1,-1,4,5,1,3,2,2,2,0,0,5,0,2,6,8,1,0,1,1,-1,1,-1,1,1
KR_6776463154,420,1,29,-13,4,3,3,0,1,3,2,1,1,0,-1,2,3,0,0,0,0,1,4,0,4,4,0,0,0,-1,1,0,1,3,1
KR_6724520239,420,3,65,25,2,-1,1,2,4,5,1,-2,4,6,2,3,1,-1,0,1,-2,0,25,-2,9,7,3,0,1,1,-1,1,-1,5,1
KR_6777739280,440,4,29,21,9,0,0,0,2,4,2,2,3,1,5,5,0,0,0,0,1,12,0,2,3,5,4,0,2,0,1,1,1,0,1
KR_6767669779,420,-2,36,9,0,-1,1,2,3,5,2,-2,0,2,1,2,1,-1,0,1,0,-2,331,0,6,6,0,0,-1,-1,-1,-1,1,4,1
KR_6759053643,420,4,98,8,10,1,2,1,1,5,4,3,5,2,5,6,1,0,2,2,-2,12,48,1,10,11,-4,0,1,1,1,1,-1,1,1
KR_6772234122,420,3,-49,45,1,-1,0,1,3,5,2,-1,1,2,0,1,1,0,0,0,0,6,-6,3,9,12,1,0,0,1,1,0,-1,3,1
KR_6775871275,420,-5,-44,-52,-11,2,3,1,0,2,2,-5,1,6,-5,4,9,-3,1,4,0,0,-6,-7,9,2,-3,0,-1,-1,-1,-1,-1,6,1
KR_6776400427,420,-1,-48,-22,1,2,2,0,2,5,3,-2,1,3,-1,3,4,0,1,1,0,0,-18,-1,7,6,-5,0,-1,-1,-1,-1,1,2,1
KR_6724544534,420,1,22,12,4,1,1,0,3,4,1,0,2,2,2,4,2,-2,1,3,0,4,9,5,3,8,2,0,0,1,-1,-1,1,5,1
KR_6744585742,420,3,60,4,15,2,3,1,4,7,3,5,5,0,4,4,0,0,1,1,1,16,8,3,4,7,2,0,1,1,1,1,1,2,1
KR_6765944457,420,0,24,-16,8,2,3,1,5,6,1,3,4,1,-1,0,1,-1,0,1,1,9,65,5,5,10,2,0,0,-1,1,1,1,1,1
KR_6746761351,420,-1,-12,-35,-1,-2,0,2,-5,1,6,3,3,0,2,7,5,1,2,1,0,2,-12,-3,12,9,1,0,-2,-1,-1,-1,1,2,1
KR_6741751375,440,0,16,-9,0,2,4,2,0,1,1,-1,1,2,0,1,1,-1,2,3,0,-2,5,-2,6,4,-4,0,1,1,-1,1,1,1,1
KR_6766971964,420,0,-12,12,-2,1,1,0,1,3,2,0,3,3,-4,0,4,0,0,0,2,3,-2,-1,7,6,-3,0,-1,-1,-1,-1,1,3,1
KR_6730309183,420,3,31,8,-1,0,0,0,-5,2,7,6,8,2,2,4,2,-4,0,4,1,3,10,-4,9,5,0,0,0,1,-1,0,1,3,1
KR_6740157769,420,1,36,-21,7,3,5,2,1,2,1,0,3,3,-2,1,3,5,5,0,0,4,11,5,7,12,4,0,1,1,1,1,-1,4,1
KR_6775631851,420,0,38,9,0,0,2,2,2,3,1,0,2,2,-1,1,2,-1,0,1,0,2,-58,-3,7,4,16,0,2,-1,1,1,-1,2,1
KR_6769222545,440,-1,60,-4,2,-1,1,2,2,3,1,4,4,0,-3,0,3,0,2,2,0,-1,-21,-2,5,3,2,0,-1,1,-1,-1,-1,6,1
KR_6774702811,420,0,30,5,-2,-1,3,4,1,4,3,0,3,3,-3,1,4,1,1,0,0,-6,8,1,8,9,-2,0,1,1,-1,1,1,6,1
KR_6763748532,420,-2,-59,0,-3,-4,0,4,1,5,4,0,5,5,1,4,3,-1,0,1,0,-3,-13,-9,10,1,3,0,-1,-1,1,-1,-1,1,1
KR_6773174574,420,2,55,7,3,0,0,0,3,6,3,-2,4,6,3,5,2,-1,0,1,0,6,-15,1,7,8,1,0,1,1,-1,1,-1,5,1
KR_6748985758,420,2,48,44,-3,1,1,0,0,2,2,-1,3,4,-4,2,6,1,2,1,-1,-6,8,0,6,6,-2,0,0,-1,-1,0,-1,4,1
KR_6702835202,420,3,56,-6,13,1,1,0,4,4,0,5,8,3,2,2,0,1,1,0,0,20,-42,-2,7,5,12,0,2,-1,1,1,-1,1,1
KR_6740181828,420,9,114,0,12,5,5,0,5,6,1,3,5,2,0,2,2,-1,0,1,0,10,26,3,5,8,-1,0,3,1,1,1,1,4,1
KR_6777687114,440,2,4,25,4,-2,2,4,-5,2,7,0,2,2,1,4,3,10,11,1,0,1,-10,1,1,2,-1,0,1,1,0,1,1,5,1
KR_6756433758,420,1,11,-13,6,-1,0,1,2,5,3,-2,0,2,2,5,3,5,5,0,0,3,4,4,4,8,-4,0,2,1,1,1,1,3,1
KR_6734404706,440,1,-45,-34,6,7,7,0,1,5,4,3,3,0,-3,1,4,-2,0,2,0,3,-2,4,2,6,2,0,-1,1,-1,-1,-1,6,1
KR_6770428059,440,0,-19,54,-3,-1,0,1,1,3,2,-5,0,5,0,4,4,2,2,0,0,2,3,0,7,7,-3,0,0,1,-1,-1,1,3,1
KR_6751889852,420,0,-25,-12,6,8,10,2,1,3,2,0,3,3,-3,1,4,0,1,1,0,-1,6,5,7,12,0,0,2,-1,1,1,-1,3,1
KR_6740404343,420,1,38,4,7,1,3,2,2,3,1,1,2,1,3,5,2,0,4,4,0,8,-4,3,3,6,2,0,1,1,1,1,1,3,1
KR_6770856035,420,5,20,-7,11,3,5,2,2,6,4,6,6,0,1,4,3,-1,1,2,-1,5,35,-2,10,8,-2,0,1,1,-1,1,-1,1,1
KR_6776548164,420,1,40,-7,0,1,3,2,0,1,1,1,1,0,-2,0,2,0,0,0,-1,-8,8,1,8,9,-9,0,1,1,-1,1,-1,4,1
KR_6760233710,420,4,50,40,12,6,7,1,-1,1,2,-1,2,3,7,10,3,1,1,0,3,13,9,3,5,8,-3,0,2,1,-1,1,1,6,1
KR_6746138184,420,2,24,37,5,2,3,1,-1,5,6,1,3,2,2,2,0,1,1,0,0,6,-14,-6,9,3,4,0,1,-1,1,1,1,2,1
KR_6777004062,420,-2,6,-20,2,-2,1,3,1,2,1,0,1,1,1,3,2,2,2,0,1,6,-2,0,6,6,6,0,-1,1,-1,-1,1,1,1
KR_6773078400,420,-2,-14,0,-8,-3,0,3,-3,0,3,-1,2,3,0,2,2,-1,0,1,0,-9,3,4,4,8,-6,0,0,1,-1,0,-1,6,1
KR_6777361224,420,0,-6,4,6,0,2,2,4,5,1,-2,0,2,4,9,5,0,1,1,2,16,20,-1,4,3,-3,0,1,1,1,1,1,1,1
KR_6706845617,420,1,-58,18,-1,-3,0,3,-1,3,4,1,3,2,4,4,0,-2,0,2,1,0,17,6,5,11,3,0,1,1,-1,1,1,1,1
KR_6774789510,420,1,-20,-13,2,0,2,2,0,2,2,0,2,2,2,4,2,0,0,0,0,9,-3,0,7,7,-2,0,-1,-1,-1,-1,-1,4,1
KR_6735526073,420,5,18,36,5,2,3,1,2,2,0,2,3,1,0,1,1,-1,0,1,0,2,1,3,7,10,3,0,1,-1,-1,1,1,4,1
KR_6775056670,440,5,75,23,12,-1,0,1,1,5,4,4,4,0,4,4,0,4,4,0,0,12,-11,3,1,4,0,0,2,1,1,1,1,6,1
KR_6717184567,420,0,-11,7,-2,-3,0,3,3,5,2,2,8,6,-3,2,5,-1,0,1,1,3,27,2,5,7,0,0,-1,1,-1,-1,1,1,1
KR_6770575483,440,1,62,46,5,1,2,1,7,7,0,0,5,5,0,2,2,-3,1,4,0,6,176,4,1,5,-3,0,2,1,-1,1,1,3,1
KR_6777167874,420,1,-28,4,7,1,3,2,0,3,3,1,2,1,3,3,0,2,2,0,0,10,-63,-1,6,5,22,0,0,1,-1,-1,1,2,1
KR_6736947033,420,5,36,34,8,2,5,3,2,3,1,0,4,4,4,5,1,0,1,1,-2,1,-9,-6,8,2,-1,0,0,1,-1,-1,-1,4,1
KR_6777454053,420,2,44,22,-5,1,3,2,-6,1,7,-3,2,5,4,4,0,-1,0,1,1,-1,-10,-8,13,5,6,0,1,-1,-1,1,1,1,1
KR_6670664656,420,-2,-11,8,0,-1,1,2,1,4,3,2,3,1,-2,1,3,0,1,1,0,-5,199,-2,6,4,4,0,1,-1,1,1,-1,5,1
KR_6775815517,420,5,73,51,13,3,3,0,1,2,1,13,14,1,-4,1,5,0,1,1,0,13,2,0,6,6,0,0,2,1,1,1,1,2,1
KR_6766480666,420,-3,-18,-23,-3,-2,0,2,0,5,5,-4,3,7,3,7,4,0,3,3,-1,-14,33,-2,9,7,0,0,1,1,-1,1,-1,5,1
KR_6771174027,440,1,12,-16,7,0,4,4,1,2,1,5,5,0,1,5,4,0,0,0,0,5,-58,-1,6,5,4,0,0,1,1,1,1,6,1
KR_6697658029,420,2,77,8,12,6,8,2,2,5,3,-1,4,5,3,6,3,2,2,0,0,10,-3,0,5,5,2,0,2,0,1,1,1,0,1
KR_6754640459,420,5,61,13,9,2,3,1,1,3,2,0,2,2,6,8,2,0,2,2,0,19,-14,-5,10,5,7,0,1,1,-1,1,1,4,1
KR_6777566262,420,0,13,30,-1,1,2,1,6,8,2,-6,1,7,-3,3,6,1,1,0,0,-10,-12,-2,8,6,-4,0,0,1,1,0,1,6,1
KR_6741288610,420,0,45,17,-2,2,2,0,-1,2,3,0,2,2,-1,1,2,-2,0,2,0,-6,49,-1,4,3,-3,0,-1,-1,1,-1,1,3,1
KR_6751663122,420,-1,-42,18,-2,2,3,1,-4,2,6,-2,2,4,2,4,2,0,2,2,0,3,-5,4,3,7,5,0,0,-1,1,-1,1,5,1
KR_6764175056,420,4,16,19,18,0,2,2,2,4,2,1,3,2,10,11,1,5,5,0,2,24,28,2,1,3,-1,0,1,0,1,1,1,0,1
KR_6731696987,440,1,37,30,3,0,4,4,0,3,3,7,7,0,-2,0,2,-2,2,4,0,5,8,-1,5,4,2,0,2,1,1,1,1,6,1
KR_6754162037,420,5,58,4,15,4,6,2,6,9,3,0,2,2,4,4,0,1,1,0,1,15,45,2,4,6,-5,0,3,-1,1,1,1,1,1
KR_6754629769,420,7,32,23,21,4,4,0,1,2,1,12,14,2,1,2,1,3,4,1,3,30,24,6,4,10,1,0,2,0,1,1,1,0,1
KR_6734432075,420,-2,7,-24,0,-3,3,6,-3,1,4,-2,3,5,4,4,0,4,4,0,2,6,-1,-5,10,5,-1,0,0,1,-1,1,1,5,1
KR_6736338500,420,1,49,-32,5,1,2,1,1,4,3,-2,3,5,6,6,0,-1,0,1,0,6,153,-5,7,2,4,0,0,-1,1,0,1,1,1
KR_6766898027,420,3,-25,-8,14,1,2,1,2,5,3,5,6,1,4,6,2,2,3,1,-1,5,10,-2,4,2,-1,0,2,-1,-1,1,-1,5,1
KR_6766032463,420,2,-17,4,1,-2,2,4,3,4,1,3,3,0,-3,2,5,0,1,1,-1,9,-271,2,4,6,3,0,-1,1,-1,-1,-1,3,1
KR_6732006028,420,3,5,4,5,-1,4,5,3,5,2,3,5,2,0,2,2,0,1,1,0,8,-22,2,5,7,-4,0,1,-1,-1,1,1,3,1
KR_6770220443,420,-1,-40,7,4,0,0,0,0,0,0,2,2,0,2,2,0,0,0,0,0,4,-111,-3,8,5,2,0,-1,1,-1,1,1,6,1
KR_6728156486,420,1,11,1,4,3,4,1,-3,3,6,5,5,0,-3,1,4,2,2,0,0,1,1,-3,9,6,6,0,1,-1,1,1,-1,1,1
KR_6742143525,420,2,27,-6,6,1,3,2,1,4,3,1,2,1,-1,3,4,4,5,1,0,5,2,3,4,7,1,0,0,-1,1,1,1,5,1
KR_6772870132,420,2,28,11,2,1,1,0,-1,1,2,1,2,1,1,3,2,0,0,0,0,-1,28,-2,6,4,1,0,0,1,1,1,1,1,1
KR_6752720801,420,-3,3,0,-3,-3,0,3,1,2,1,-3,1,4,4,5,1,-2,0,2,0,-4,-7,-5,8,3,5,0,0,1,-1,-1,1,4,1
KR_6766798883,420,0,45,-11,-6,1,5,4,-3,4,7,-4,1,5,-1,2,3,1,1,0,1,-9,-10,-1,6,5,1,0,1,-1,1,-1,1,3,1
KR_6763418745,440,-1,19,1,6,1,1,0,3,3,0,1,3,2,-4,0,4,5,7,2,0,2,-2,1,5,6,1,0,0,-1,-1,-1,1,2,1
KR_6737174389,420,3,69,1,10,2,4,2,0,1,1,-1,1,2,7,7,0,2,3,1,0,12,5,2,6,8,3,0,2,1,-1,1,1,2,1
KR_6763476766,440,-1,69,35,-3,-1,0,1,-3,1,4,-2,4,6,0,4,4,3,4,1,1,-4,-14,1,5,6,-3,0,0,-1,0,1,1,5,1
KR_6734186026,420,4,84,24,16,4,6,2,8,10,2,1,2,1,-1,4,5,4,6,2,0,14,-21,0,6,6,2,0,3,1,1,1,-1,3,1
KR_6777334183,420,1,-6,-16,10,0,0,0,5,7,2,-4,0,4,9,11,2,0,0,0,0,13,1,1,4,5,3,0,-1,1,-1,1,1,2,1
KR_6754259357,420,-2,-10,-1,7,-3,0,3,0,4,4,0,1,1,8,11,3,2,2,0,-1,11,3,-5,15,10,-7,0,0,1,-1,1,-1,4,1
KR_6774682646,420,2,62,-10,7,0,1,1,1,5,4,1,2,1,4,8,4,1,1,0,1,13,7,0,5,5,-2,0,1,1,1,1,1,6,1
KR_6749833335,420,0,65,1,-1,2,2,0,-4,0,4,0,2,2,3,4,1,-2,0,2,0,1,39,1,7,8,3,0,1,1,-1,1,-1,1,1
KR_6769886669,420,0,19,21,-5,1,1,0,-7,2,9,-2,0,2,2,2,0,1,1,0,0,-2,-4,-4,8,4,8,0,-1,1,-1,-1,-1,2,1
KR_6756917542,420,0,3,-5,7,-3,1,4,-1,2,3,1,2,1,6,7,1,4,4,0,0,16,2,-5,8,3,3,0,1,1,-1,1,1,6,1
KR_6777080356,420,3,4,28,8,-2,0,2,3,6,3,4,6,2,1,4,3,2,5,3,0,5,3,-6,8,2,2,0,1,1,-1,1,-1,3,1
KR_6698582831,420,-2,-92,2,2,0,1,1,5,6,1,0,2,2,-3,1,4,0,0,0,2,6,27,4,5,9,-6,0,-1,1,-1,-1,1,3,1
KR_6729230507,420,0,-47,11,5,-2,0,2,4,6,2,1,3,2,3,3,0,-1,1,2,0,20,2,7,5,12,-4,0,1,1,-1,1,-1,1,1
KR_6763683401,420,3,60,17,2,2,3,1,1,4,3,0,2,2,-1,2,3,0,0,0,0,-2,-3,0,3,3,-1,0,1,-1,-1,-1,-1,5,1
KR_6742693235,420,-1,-7,-5,1,1,1,0,0,3,3,0,2,2,2,2,0,-2,0,2,0,4,-36,0,7,7,2,0,0,1,1,-1,-1,4,1
KR_6777090849,420,-2,-35,4,0,-6,0,6,3,4,1,3,3,0,1,3,2,-1,0,1,0,2,8,-5,11,6,2,0,-1,-1,-1,-1,1,4,1
KR_6767247868,420,3,-3,-3,6,0,0,0,1,4,3,5,5,0,3,5,2,-3,0,3,0,8,3,2,6,8,1,0,0,1,-1,0,-1,1,1
KR_6774131889,420,-1,10,0,4,-4,2,6,6,8,2,2,4,2,0,4,4,0,1,1,0,0,-4,-1,7,6,-1,0,1,1,1,1,-1,6,1
KR_6746134558,420,8,67,56,24,0,3,3,2,3,1,2,5,3,18,18,0,2,2,0,2,33,-4,2,2,4,3,1,4,1,1,1,1,6,1
KR_6751636824,420,1,83,-19,1,0,2,2,0,3,3,2,2,0,-2,0,2,1,1,0,0,-4,6,7,4,11,0,0,1,1,-1,1,1,5,1
KR_6764961052,420,4,2,4,12,2,2,0,3,5,2,3,3,0,1,3,2,3,3,0,0,13,-17,0,6,6,0,0,0,1,-1,0,1,2,1
KR_6741101309,420,2,26,-21,7,4,5,1,0,5,5,-4,1,5,5,6,1,2,3,1,-1,19,1,1,7,8,-4,0,1,1,1,1,-1,4,1
KR_6710628814,420,4,-49,33,2,-4,0,4,2,2,0,3,3,0,-1,1,2,2,2,0,0,11,3,6,3,9,7,0,-1,1,1,-1,-1,4,1
KR_6750000250,420,4,13,36,2,0,1,1,7,8,1,-1,0,1,-1,3,4,-3,0,3,0,-2,27,2,7,9,5,0,1,1,1,1,-1,3,1
KR_6774754794,420,0,7,-25,2,5,6,1,1,4,3,0,1,1,-2,1,3,-2,0,2,0,3,23,1,5,6,5,0,-1,-1,1,-1,-1,6,1
KR_6722817815,420,2,-34,0,3,-1,1,2,5,6,1,5,6,1,-3,1,4,-3,2,5,0,3,-16,-2,8,6,0,0,0,-1,1,0,-1,5,1
KR_6743408786,420,4,17,-5,9,5,7,2,0,2,2,3,4,1,3,3,0,-2,0,2,0,17,-123,0,4,4,2,0,1,1,1,1,-1,4,1
KR_6772676745,420,0,-24,18,4,2,5,3,-1,1,2,3,3,0,1,2,1,-1,0,1,0,10,-11,-2,11,9,8,0,1,1,1,1,1,3,1
KR_6759180066,440,-1,-7,-7,1,0,1,1,0,1,1,3,3,0,-1,1,2,-1,2,3,0,5,1,-1,5,4,3,0,0,-1,1,0,-1,3,1
KR_6739316871,420,1,31,5,10,-1,3,4,5,8,3,3,5,2,4,7,3,-1,0,1,0,13,-11,-3,11,8,4,0,1,1,1,1,1,1,1
KR_6764040618,420,5,66,8,21,0,2,2,7,8,1,1,1,0,11,11,0,2,2,0,1,19,7,2,4,6,4,1,4,0,1,1,1,0,1
KR_6775948253,420,3,30,-8,9,2,3,1,-1,2,3,0,1,1,5,7,2,3,4,1,0,6,1,-2,8,6,-5,0,-1,1,1,-1,1,5,1
KR_6739618021,420,9,59,68,9,3,5,2,4,6,2,-5,0,5,8,10,2,-1,1,2,0,14,-21,-1,7,6,-3,0,2,-1,1,-1,-1,6,1
KR_6776618260,420,2,42,20,4,1,3,2,-1,3,4,0,1,1,2,6,4,2,4,2,0,8,5,0,4,4,1,0,0,1,-1,-1,-1,6,1
KR_6777357571,440,-1,26,-2,-2,-2,1,3,1,2,1,-1,2,3,-1,3,4,1,1,0,0,-1,43,-2,9,7,-26,0,1,1,-1,-1,1,5,1
KR_6712385952,420,1,45,15,4,-1,0,1,3,3,0,0,4,4,2,2,0,0,0,0,0,1,-30,-1,9,8,9,0,1,1,-1,1,1,4,1
KR_6737762418,420,5,54,8,8,-2,3,5,1,3,2,5,7,2,2,3,1,2,2,0,0,0,0,-1,5,4,-1,0,0,1,-1,0,1,3,1
KR_6740403304,420,3,13,-3,1,-2,1,3,4,4,0,-1,0,1,-1,4,5,1,1,0,-2,6,-36,5,8,13,2,0,0,-1,1,1,-1,2,1
KR_6750954045,420,-1,44,6,-3,0,1,1,-5,2,7,1,1,0,-4,1,5,5,5,0,0,-3,-49,-1,4,3,29,0,-1,1,-1,-1,1,1,1
KR_6776938083,420,7,32,-1,19,8,8,0,4,8,4,3,3,0,2,6,4,2,2,0,1,13,-41,-1,6,5,30,0,1,1,-1,1,1,5,1
KR_6766983731,420,1,16,-5,12,4,6,2,3,4,1,4,6,2,-2,2,4,3,5,2,0,5,-51,-1,8,7,19,0,0,1,-1,1,1,2,1
KR_6750520056,420,5,11,19,7,5,5,0,3,4,1,2,2,0,-2,6,8,-1,1,2,0,2,-18,-1,6,5,-1,0,0,1,1,1,1,1,1
KR_6753838911,420,0,-1,-10,7,1,1,0,4,6,2,7,11,4,-4,2,6,-1,2,3,0,15,-37,5,4,9,1,0,0,1,1,1,-1,6,1
KR_6775952137,420,0,48,-12,0,-2,0,2,-3,1,4,-2,2,4,3,3,0,4,4,0,0,0,-2,0,6,6,4,0,1,1,1,1,1,3,1
KR_6713773155,420,0,-17,-19,-2,0,2,2,-2,1,3,3,4,1,-3,3,6,0,0,0,0,-4,-11,-3,8,5,10,0,-1,-1,-1,-1,-1,6,1
KR_6774989000,420,0,19,-2,2,0,3,3,3,3,0,-2,1,3,-1,1,2,2,2,0,1,8,-11,1,5,6,-2,0,0,1,-1,0,1,1,1
KR_6774351816,420,0,73,-21,-1,-1,0,1,2,4,2,3,3,0,-3,2,5,-2,0,2,0,-2,3,1,2,3,1,0,0,1,-1,1,1,2,1
KR_6768334046,420,5,113,37,12,2,2,0,8,8,0,0,1,1,3,3,0,-1,0,1,0,12,-5,1,5,6,-3,0,6,1,1,1,1,2,1
KR_6745787683,420,2,17,24,3,2,3,1,4,5,1,0,1,1,-2,2,4,-1,0,1,0,6,-2,-2,7,5,1,0,1,-1,1,1,-1,3,1
KR_6774346562,420,-1,36,-71,1,-5,0,5,4,6,2,4,4,0,2,3,1,-4,2,6,-1,8,-104,8,2,10,23,0,1,1,-1,1,-1,6,1
KR_6743329276,420,2,44,8,6,6,6,0,2,4,2,-3,0,3,0,3,3,1,1,0,0,8,9,3,5,8,4,0,2,-1,1,1,1,3,1
KR_6737718397,420,1,-6,16,1,-2,3,5,0,4,4,0,1,1,1,2,1,2,2,0,0,1,51,-2,6,4,-3,0,1,0,-1,-1,1,0,1
KR_6777890106,420,-1,11,8,-1,3,3,0,-1,1,2,0,1,1,-1,0,1,-2,1,3,0,-4,10,7,4,11,-7,0,1,-1,1,1,1,5,1
KR_6777101178,420,6,14,20,6,2,2,0,2,3,1,1,6,5,0,1,1,1,1,0,1,12,10,3,4,7,-3,0,1,1,1,1,1,1,1
KR_6765486806,420,3,5,16,5,5,6,1,0,4,4,1,2,1,2,3,1,-3,0,3,0,1,150,0,7,7,-1,0,0,1,1,1,1,4,1
KR_6732295241,420,2,69,17,9,-2,2,4,3,5,2,5,7,2,3,9,6,0,1,1,2,1,5,4,7,11,2,0,5,1,1,1,-1,2,1
KR_6775781870,420,0,39,-24,1,4,4,0,0,3,3,-2,2,4,-1,2,3,0,2,2,1,0,-135,-1,6,5,5,0,1,1,1,1,1,6,1
KR_6747324478,420,3,42,21,9,4,4,0,1,2,1,6,9,3,-3,2,5,1,1,0,0,8,24,1,4,5,-1,0,2,0,1,1,-1,0,1
KR_6764868991,420,2,5,38,12,-1,0,1,7,7,0,4,4,0,2,3,1,0,1,1,0,12,0,-2,7,5,-1,0,1,1,1,1,1,4,1
KR_6731764703,440,-1,-63,3,1,-2,2,4,5,6,1,3,5,2,-8,1,9,3,5,2,1,8,28,-2,6,4,7,0,2,1,1,1,1,3,1
KR_6775887779,420,3,-20,-8,-1,0,0,0,4,6,2,-1,0,1,-4,0,4,0,1,1,0,-4,-13,-1,7,6,-3,0,0,-1,1,0,-1,6,1
KR_6772112561,420,2,-24,-39,4,2,2,0,2,3,1,-2,1,3,2,3,1,0,1,1,0,7,-8,-1,7,6,8,0,1,-1,-1,1,-1,2,1
KR_6758798122,420,2,36,21,1,2,3,1,3,5,2,-3,4,7,0,3,3,-1,0,1,0,4,-28,0,6,6,2,0,0,1,1,-1,1,5,1
KR_6721179360,420,3,-10,12,4,2,2,0,5,8,3,-5,1,6,2,6,4,0,0,0,-1,8,241,2,2,4,4,0,2,-1,1,1,-1,5,1
KR_6717286393,420,0,1,9,-2,-1,2,3,2,3,1,-1,0,1,-3,3,6,1,1,0,0,-3,4,-2,9,7,4,0,1,1,-1,-1,1,4,1
KR_6679449160,420,1,65,-9,7,2,3,1,6,7,1,0,2,2,0,3,3,-1,0,1,0,9,-4,1,6,7,-1,0,0,1,-1,-1,1,3,1
KR_6766231791,420,0,36,-31,0,2,4,2,-4,1,5,0,2,2,1,1,0,1,2,1,0,-2,5,-1,9,8,-3,0,2,-1,-1,1,-1,6,1
KR_6767162513,420,-3,-32,-12,-5,-4,0,4,-3,0,3,-2,0,2,4,6,2,0,0,0,0,-4,-29,-3,7,4,3,0,-1,1,-1,-1,-1,4,1
KR_6739161472,420,0,35,7,-1,1,4,3,-1,1,2,-2,0,2,0,3,3,1,1,0,0,-4,3,0,5,5,-5,0,0,1,-1,1,1,2,1
KR_6734507062,420,5,16,25,12,-2,1,3,7,8,1,0,3,3,5,9,4,2,2,0,1,24,-5,-5,7,2,8,0,1,1,-1,1,1,6,1
KR_6703794727,420,3,30,-17,10,2,4,2,3,6,3,-3,0,3,6,7,1,2,3,1,2,20,25,0,11,11,2,0,1,1,1,1,1,6,1
KR_6727879580,420,0,-9,-24,8,-2,1,3,7,12,5,3,3,0,-1,1,2,1,2,1,0,10,3,4,5,9,-2,0,1,-1,1,1,1,5,1
KR_6741405557,420,0,-29,-2,2,-1,1,2,1,4,3,0,3,3,0,3,3,2,2,0,0,7,-3,2,7,9,4,0,1,1,1,1,-1,4,1
KR_6723788841,420,2,27,8,7,1,1,0,-2,4,6,7,8,1,1,4,3,0,0,0,0,5,12,10,4,14,-4,0,2,1,1,1,-1,1,1
KR_6744195260,420,-3,-8,-3,-4,-6,1,7,1,3,2,-1,3,4,0,5,5,2,2,0,1,1,-12,-6,11,5,3,0,-1,-1,-1,-1,1,2,1
KR_6748078315,420,2,35,23,2,-1,1,2,0,2,2,1,5,4,2,2,0,0,1,1,0,3,-37,0,6,6,15,0,0,1,-1,0,1,6,1
KR_6768443463,420,1,22,-15,2,0,2,2,-2,1,3,0,1,1,3,3,0,1,1,0,0,6,10,6,5,11,2,0,0,1,1,1,-1,5,1
KR_6767667078,420,0,45,-44,3,-1,2,3,0,6,6,0,1,1,4,7,3,0,0,0,0,6,-2,-4,10,6,-1,0,1,1,-1,1,-1,4,1
KR_6766436716,420,0,4,26,-6,-4,1,5,-1,1,2,-1,4,5,1,3,2,-1,0,1,0,-11,3,-2,8,6,-1,0,0,-1,-1,-1,-1,1,1
KR_6744869914,420,2,46,-12,5,1,1,0,2,3,1,2,2,0,-1,2,3,1,4,3,0,7,31,-1,11,10,4,0,1,-1,1,1,-1,6,1
KR_6769827777,440,2,37,-31,10,1,2,1,0,1,1,1,3,2,2,4,2,6,7,1,0,12,46,6,3,9,2,0,0,0,1,0,1,0,1
KR_6743213379,420,3,84,23,8,0,3,3,5,8,3,0,2,2,0,3,3,3,3,0,0,16,4,0,8,8,1,0,1,-1,1,1,-1,5,1
KR_6777313016,420,-3,-46,-7,-9,-1,1,2,1,3,2,-2,0,2,-3,3,6,-4,0,4,0,-3,7,-4,10,6,-4,0,-1,-1,1,-1,-1,6,1
KR_6774357949,420,4,51,47,8,-1,0,1,2,4,2,5,7,2,2,2,0,0,0,0,1,11,7,3,2,5,0,0,3,-1,1,1,1,2,1
KR_6735071474,420,1,7,-3,5,4,4,0,-2,3,5,0,4,4,2,2,0,1,1,0,1,9,10,7,3,10,-5,0,1,1,-1,1,1,3,1
KR_6765929257,420,-3,12,-19,-3,-4,0,4,-3,0,3,1,5,4,2,3,1,1,1,0,-1,-2,17,-2,7,5,-3,0,-1,1,-1,-1,-1,3,1
KR_6763677869,420,-2,-8,1,-1,0,3,3,3,3,0,0,2,2,1,4,3,-5,0,5,0,-1,12,0,5,5,1,0,0,1,-1,-1,-1,1,1
KR_6777707298,420,4,90,-4,12,1,3,2,4,7,3,2,2,0,5,7,2,0,1,1,0,15,-46,0,6,6,3,0,1,1,-1,1,1,1,1
KR_6777606368,420,3,21,-13,8,-1,2,3,-1,3,4,2,3,1,7,10,3,1,1,0,0,10,10,7,4,11,-3,0,1,-1,1,1,-1,5,1
KR_6734891094,420,4,-25,45,12,3,3,0,1,4,3,2,3,1,3,4,1,3,3,0,0,21,6,0,7,7,4,0,2,0,1,1,-1,0,1
KR_6769830411,420,5,49,27,3,0,2,2,0,1,1,8,10,2,-1,4,5,-4,0,4,0,-1,17,0,7,7,0,0,0,-1,-1,-1,-1,4,1
KR_6776923436,420,-1,-43,12,-1,1,2,1,0,1,1,-2,3,5,-1,1,2,1,1,0,0,-13,-2,4,6,10,1,0,-1,1,-1,-1,1,5,1
KR_6765398638,420,1,-32,24,2,3,5,2,0,5,5,1,2,1,-2,2,4,0,1,1,0,6,36,-2,7,5,-4,0,0,1,1,0,1,1,1
KR_6776869857,420,1,34,10,9,-2,0,2,8,8,0,1,4,3,3,4,1,-1,0,1,0,8,-5,3,4,7,7,0,2,1,1,1,1,4,1
KR_6777153206,420,-3,-43,-15,-9,1,1,0,1,2,1,-3,2,5,-7,2,9,-1,0,1,0,-5,10,1,5,6,-3,0,0,1,-1,-1,-1,6,1
KR_6761947450,420,0,44,3,4,0,2,2,2,5,3,7,7,0,-5,1,6,0,3,3,0,-2,-13,2,2,4,0,0,0,-1,1,-1,1,1,1
KR_6759152756,420,-2,-44,9,0,-3,1,4,-2,1,3,3,3,0,1,5,4,1,1,0,0,1,184,2,9,11,4,0,-1,1,-1,-1,-1,2,1
KR_6775576154,420,1,25,17,-1,-1,0,1,0,2,2,-2,2,4,1,2,1,1,2,1,0,-4,10,3,4,7,-5,0,0,1,-1,0,-1,2,1
KR_6777033634,420,3,-10,-2,6,3,3,0,1,1,0,0,3,3,1,1,0,1,1,0,0,10,69,1,2,3,1,0,2,1,1,1,-1,6,1
KR_6769189907,420,2,34,-7,7,1,4,3,-1,0,1,4,5,1,4,6,2,-1,0,1,0,6,6,5,4,9,-4,0,3,1,1,1,-1,4,1
KR_6754003237,420,7,92,44,9,0,3,3,5,6,1,2,4,2,1,2,1,1,1,0,0,10,-1,-1,7,6,4,0,2,1,1,1,-1,1,1
KR_6744248091,420,3,40,28,3,0,3,3,-1,1,2,0,2,2,5,6,1,-1,0,1,0,2,-40,4,5,9,2,0,0,-1,1,0,1,6,1
KR_6777811685,420,4,105,29,10,0,0,0,1,4,3,3,4,1,5,5,0,1,2,1,-1,8,0,-2,6,4,2,0,2,1,-1,1,-1,4,1
KR_6735905229,420,0,41,39,-4,0,0,0,-4,5,9,2,3,1,-1,5,6,-1,0,1,-1,-10,-45,-1,9,8,3,0,0,-1,1,0,-1,3,1
KR_6728298096,420,2,-13,-7,11,-2,1,3,10,12,2,3,3,0,-1,5,6,1,1,0,0,18,-7,-2,8,6,2,0,0,-1,1,-1,-1,2,1
KR_6728064879,420,6,66,-12,14,1,3,2,-1,3,4,8,9,1,3,7,4,3,3,0,2,12,10,4,3,7,1,0,1,0,1,1,1,0,1
KR_6776393835,440,-1,-13,10,7,2,5,3,3,4,1,1,1,0,2,7,5,-1,1,2,0,5,-8,-1,7,6,0,0,1,1,1,-1,-1,3,1
KR_6776482431,420,1,-3,-17,4,-8,0,8,4,5,1,6,6,0,1,5,4,1,2,1,0,15,-116,-7,10,3,3,0,3,-1,1,1,-1,6,1
KR_6770887922,420,10,85,53,14,3,3,0,2,4,2,5,6,1,3,3,0,1,1,0,0,18,40,4,3,7,-2,0,4,1,1,1,1,4,1
KR_6729855829,440,3,56,10,2,0,1,1,-1,0,1,1,1,0,5,8,3,-3,1,4,0,1,152,-1,7,6,1,0,1,1,-1,1,-1,3,1
KR_6765186119,420,1,39,3,2,1,2,1,0,3,3,2,4,2,0,9,9,-1,0,1,0,1,-3,-1,5,4,-1,0,1,-1,1,1,1,2,1
KR_6732542017,420,5,59,4,16,-3,0,3,14,14,0,3,3,0,0,1,1,2,2,0,0,28,33,1,6,7,5,0,3,0,1,1,1,0,1
KR_6738049358,420,0,30,-28,1,7,8,1,-2,1,3,-3,2,5,-1,1,2,0,2,2,0,-8,4,4,3,7,2,0,1,1,1,1,1,3,1
KR_6776517359,440,-2,27,14,-1,-5,1,6,-2,3,5,1,2,1,2,2,0,3,7,4,1,7,-6,-2,6,4,5,0,0,1,1,-1,1,2,1
KR_6777263091,420,2,12,3,5,6,8,2,-3,1,4,1,3,2,1,3,2,0,0,0,3,12,-2,-4,9,5,8,0,1,1,1,1,1,2,1
KR_6740456143,420,0,8,-6,3,-2,3,5,-2,1,3,3,4,1,4,5,1,0,0,0,0,6,-3,-6,11,5,-1,0,0,1,-1,-1,1,4,1
KR_6775360225,420,3,-3,-5,8,-6,1,7,3,3,0,1,1,0,5,5,0,5,5,0,0,12,-5,-1,6,5,3,0,-2,1,-1,-1,-1,5,1
KR_6774914580,440,2,-55,-12,4,1,5,4,-1,0,1,-1,2,3,0,5,5,5,5,0,1,4,-9,1,2,3,0,0,0,-1,-1,0,1,1,1
KR_6746155767,420,5,84,16,8,2,3,1,1,5,4,0,2,2,6,8,2,-1,0,1,0,16,-7,-1,5,4,7,0,2,1,1,1,1,2,1
KR_6776932517,420,4,41,8,2,3,3,0,1,3,2,1,3,2,-4,1,5,1,2,1,0,-4,5,-3,11,8,-9,0,2,1,1,1,-1,6,1
KR_6753890742,420,2,62,5,5,-1,2,3,3,4,1,1,2,1,1,4,3,1,2,1,0,13,18,2,6,8,6,0,0,1,-1,0,1,5,1
KR_6777835754,420,1,51,7,7,3,4,1,-3,4,7,1,3,2,5,6,1,1,1,0,0,8,1,3,6,9,-1,0,1,1,1,1,1,2,1
KR_6769184595,420,2,39,19,5,4,4,0,-1,1,2,0,1,1,-2,0,2,4,4,0,0,1,149,1,5,6,-1,0,1,-1,1,1,1,2,1
KR_6774485037,420,1,0,-9,11,0,3,3,2,7,5,3,4,1,3,5,2,3,6,3,0,13,4,5,4,9,-3,0,0,-1,1,0,1,2,1
KR_6775241155,420,6,54,18,18,0,0,0,2,3,1,2,4,2,13,13,0,1,1,0,1,23,14,0,4,4,-6,0,2,1,1,1,1,5,1
KR_6766557785,420,2,63,-3,5,1,1,0,3,4,1,0,4,4,1,2,1,0,0,0,0,14,-1,1,7,8,1,0,0,-1,1,0,-1,6,1
KR_6763997183,420,0,45,-12,-8,-2,1,3,-3,0,3,-2,2,4,-2,2,4,1,1,0,-2,-9,4,-1,7,6,-2,0,-1,-1,-1,-1,-1,6,1
KR_6704885348,420,1,-6,0,3,0,2,2,5,7,2,-2,2,4,0,2,2,0,2,2,0,6,11,3,10,13,-4,0,1,-1,1,1,-1,3,1
KR_6753927385,420,-1,2,-17,-6,1,5,4,-3,2,5,4,5,1,-3,2,5,-5,0,5,-1,-8,-9,2,4,6,1,0,0,-1,1,-1,-1,6,1
KR_6764859760,420,3,89,-13,6,1,2,1,0,2,2,-2,3,5,7,8,1,0,0,0,0,3,-18,-4,9,5,8,0,2,1,-1,1,1,6,1
KR_6753889003,420,0,-12,8,2,-1,1,2,-2,2,4,0,1,1,3,3,0,2,2,0,0,6,-12,-1,6,5,-1,0,-1,1,-1,-1,1,1,1
KR_6775118239,420,8,108,55,5,2,2,0,-1,0,1,2,3,1,1,4,3,1,1,0,-1,-3,30,-1,3,2,-1,0,2,1,-1,1,-1,6,1
KR_6773668044,440,4,-1,-4,9,-1,1,2,1,1,0,0,1,1,9,11,2,0,1,1,0,6,-4,-3,8,5,6,0,0,1,1,0,-1,5,1
KR_6753157050,420,1,33,-16,11,-2,3,5,3,6,3,3,6,3,3,5,2,4,4,0,1,18,-110,3,4,7,2,0,1,-1,1,1,1,1,1
KR_6696840762,420,0,-16,-16,-1,1,2,1,0,6,6,-1,0,1,-1,1,2,0,1,1,0,-10,-2,-3,7,4,-1,0,0,-1,1,1,1,6,1
KR_6716950126,420,7,81,38,11,1,2,1,9,9,0,-1,2,3,2,4,2,0,2,2,1,17,31,1,6,7,3,0,3,1,1,1,1,1,1
KR_6651929466,420,3,72,-10,4,-2,1,3,3,6,3,2,3,1,0,2,2,1,2,1,-2,-5,-3,2,5,7,2,0,0,1,1,0,-1,6,1
KR_6718846129,420,3,18,4,8,2,2,0,4,7,3,1,2,1,0,2,2,1,1,0,0,13,-31,4,3,7,3,0,1,1,-1,1,1,3,1
KR_6764756296,420,0,14,31,1,0,0,0,3,3,0,0,0,0,-1,1,2,-1,0,1,0,-1,62,-3,8,5,6,0,1,-1,1,1,-1,5,1
KR_6765140286,420,3,12,15,7,-1,0,1,2,3,1,2,2,0,6,9,3,-2,1,3,-1,8,30,1,3,4,0,0,0,1,1,1,-1,1,1
KR_6743214683,420,5,54,42,12,1,2,1,5,6,1,-2,0,2,5,12,7,3,4,1,0,11,135,0,4,4,3,0,2,-1,0,1,1,1,1
KR_6746671922,420,1,14,-5,2,-2,4,6,-1,2,3,1,1,0,2,2,0,2,3,1,0,3,-51,3,6,9,11,0,-1,0,-1,-1,1,0,1
KR_6726515818,420,7,80,16,14,4,4,0,8,9,1,2,2,0,2,2,0,-2,0,2,1,18,-13,0,6,6,-4,0,3,1,1,1,1,3,1
KR_6774163472,420,1,40,-10,-7,-1,2,3,-11,0,11,-3,1,4,6,7,1,2,2,0,0,-12,0,0,4,4,2,0,1,1,-1,1,1,2,1
KR_6777788538,420,0,-58,-11,-1,3,4,1,-1,1,2,-1,0,1,0,1,1,-2,1,3,0,2,20,2,3,5,-2,0,-1,-1,-1,-1,-1,2,1
KR_6775103947,420,0,-13,-4,3,0,4,4,-1,3,4,1,1,0,3,4,1,0,0,0,0,6,8,2,4,6,-2,0,1,1,-1,1,1,4,1
KR_6750404348,420,3,13,9,11,-2,0,2,0,1,1,6,6,0,6,8,2,1,1,0,0,17,0,0,5,5,1,0,1,1,1,1,1,1,1
KR_6777738525,420,0,21,-12,-5,1,1,0,-2,1,3,-5,0,5,0,2,2,1,1,0,-1,-11,-91,0,8,8,1,0,0,1,-1,0,-1,3,1
KR_6767239920,420,0,-28,-17,5,2,6,4,-2,1,3,-1,2,3,2,2,0,4,4,0,0,15,-19,-9,15,6,2,0,-1,-1,-1,-1,-1,3,1
KR_6741376662,420,1,-9,8,8,2,3,1,5,6,1,-3,2,5,0,4,4,4,6,2,0,9,3,1,9,10,0,0,-1,1,-1,-1,1,1,1
KR_6748110076,420,3,-24,16,-1,0,3,3,0,3,3,-1,1,2,-1,2,3,1,3,2,0,-4,19,0,6,6,0,0,3,1,1,1,1,1,1
KR_6687041338,420,0,-45,8,4,-4,0,4,3,3,0,1,2,1,4,4,0,0,1,1,2,11,-13,-4,11,7,6,0,0,1,1,1,1,3,1
KR_6735126669,420,2,57,-1,-2,1,1,0,-2,2,4,-2,1,3,2,7,5,-1,0,1,0,-2,-3,-3,10,7,8,0,1,-1,-1,1,1,2,1
KR_6754596010,420,1,46,-27,-2,0,2,2,-5,2,7,2,3,1,1,2,1,0,0,0,0,-5,-21,-6,11,5,7,0,0,-1,-1,1,1,2,1
KR_6769217891,420,1,16,12,5,0,1,1,0,3,3,0,0,0,1,1,0,4,4,0,0,9,5,4,2,6,2,0,1,1,1,1,1,3,1
KR_6762327783,420,-3,-16,-4,-3,3,4,1,-7,0,7,-3,2,5,4,4,0,0,0,0,0,-1,-11,1,6,7,-4,0,-1,-1,-1,-1,-1,2,1
KR_6686985690,420,8,102,12,21,6,6,0,8,10,2,3,3,0,1,2,1,3,3,0,1,28,10,9,2,11,4,0,3,-1,1,1,1,2,1
KR_6714503427,420,0,52,-2,0,-1,2,3,5,6,1,0,2,2,-4,4,8,0,0,0,0,3,-20,2,7,9,-3,0,0,1,1,1,-1,2,1
KR_6753284604,420,2,65,6,4,2,5,3,10,11,1,-2,1,3,-8,0,8,2,3,1,-1,10,-31,2,4,6,-3,0,3,-1,1,-1,-1,4,1
KR_6762258379,420,6,21,30,18,0,2,2,10,11,1,2,3,1,3,5,2,3,3,0,1,24,205,1,6,7,-5,0,2,1,1,1,1,4,1
KR_6731371958,440,0,-53,-25,6,-4,1,5,7,7,0,1,2,1,0,5,5,2,3,1,1,9,118,8,1,9,-1,0,-1,1,-1,-1,1,1,1
KR_6760269771,420,3,31,48,11,-3,2,5,3,4,1,6,7,1,4,5,1,1,2,1,0,7,0,-1,4,3,3,0,0,1,1,-1,-1,6,1
KR_6709256594,420,-1,6,-15,-8,4,4,0,-9,0,9,1,1,0,-4,1,5,0,0,0,0,-23,0,0,7,7,1,0,1,-1,1,1,-1,6,1
KR_6763511701,440,-1,73,8,-3,-2,3,5,0,5,5,-1,0,1,2,2,0,-2,1,3,1,2,12,0,4,4,-6,0,-1,0,-1,-1,1,0,1
KR_6774040882,440,2,28,24,5,3,3,0,-3,2,5,3,3,0,-2,4,6,4,4,0,0,-3,49,2,2,4,-20,0,1,0,1,1,1,0,1
KR_6746710818,420,0,2,8,3,-1,0,1,5,7,2,0,2,2,-1,1,2,0,0,0,0,8,8,0,8,8,-10,0,-1,1,-1,-1,1,5,1
KR_6773067277,420,-1,18,24,2,0,2,2,0,2,2,2,3,1,0,2,2,0,1,1,0,-6,14,-3,9,6,2,0,-2,1,-1,-1,-1,1,1
KR_6743816132,420,5,10,7,2,1,2,1,1,6,5,1,1,0,-2,1,3,1,2,1,0,-1,-57,-1,7,6,21,0,0,-1,1,-1,1,5,1
KR_6745015475,420,-1,15,7,-4,-4,0,4,-1,2,3,0,2,2,-1,1,2,2,2,0,0,1,-13,-4,10,6,4,0,-1,-1,-1,1,-1,4,1
KR_6705573729,420,1,16,-11,-3,0,3,3,-1,4,5,1,2,1,-1,1,2,-2,0,2,0,-3,-3,-1,9,8,2,0,0,1,1,-1,1,1,1
KR_6777123969,420,2,-4,-19,13,3,3,0,2,4,2,1,2,1,8,8,0,-1,1,2,1,18,9,-1,6,5,-6,0,1,-1,1,1,1,5,1
KR_6776850489,420,0,-10,0,9,2,2,0,-2,1,3,2,4,2,6,8,2,1,1,0,0,11,27,-1,6,5,1,0,1,1,1,1,1,2,1
KR_6756479918,420,4,85,8,12,2,3,1,5,7,2,5,6,1,0,2,2,0,0,0,0,6,-10,2,5,7,1,0,2,1,-1,1,1,2,1
KR_6742787979,420,4,78,18,8,2,2,0,-3,3,6,-2,2,4,6,7,1,5,6,1,0,0,17,1,4,5,2,0,1,1,1,1,1,2,1
KR_6746034966,420,7,42,45,19,2,4,2,6,6,0,2,3,1,9,10,1,0,1,1,0,32,0,1,5,6,-4,0,3,1,1,1,1,1,1
KR_6740003118,440,5,66,27,9,0,4,4,2,4,2,1,2,1,4,4,0,2,5,3,0,2,4,7,3,10,-3,0,2,1,1,1,1,4,1
KR_6711748220,420,-1,-64,-12,-2,-5,0,5,6,7,1,0,3,3,-2,1,3,-1,1,2,0,9,7,4,8,12,-5,0,0,1,1,1,1,2,1
KR_6762155201,420,7,71,-4,22,1,4,3,12,13,1,6,7,1,0,2,2,3,4,1,0,23,33,-2,5,3,3,0,2,0,1,1,1,0,1
KR_6767131551,420,7,89,11,17,0,0,0,8,8,0,0,1,1,6,8,2,3,3,0,0,12,-169,6,4,10,0,0,2,0,-1,1,-1,0,1
KR_6764750045,420,2,-35,-8,3,0,3,3,2,2,0,2,2,0,-1,0,1,0,0,0,0,-2,1,0,5,5,-1,0,0,1,1,0,1,5,1
KR_6744641175,420,2,-5,25,4,-4,0,4,8,9,1,-2,4,6,2,4,2,0,2,2,0,9,-179,-2,7,5,-3,0,1,1,-1,-1,-1,2,1
KR_6740640920,420,2,7,30,1,2,5,3,-2,3,5,0,5,5,2,3,1,-1,1,2,0,-2,-3,-1,8,7,2,0,2,1,1,1,-1,1,1
KR_6732315225,420,0,5,-15,6,3,3,0,5,6,1,-4,0,4,1,1,0,1,1,0,0,5,-154,0,8,8,-2,0,-1,1,-1,-1,1,6,1
KR_6750810684,420,0,57,19,-6,1,3,2,0,5,5,-10,1,11,3,7,4,0,1,1,0,-3,38,-2,9,7,-26,0,-2,1,-1,-1,-1,5,1
KR_6769446072,420,4,76,9,6,7,8,1,0,1,1,-1,0,1,-2,1,3,2,2,0,0,-5,192,1,6,7,7,0,0,1,1,1,1,4,1
KR_6771748746,440,-2,-49,24,-3,-3,0,3,0,2,2,0,2,2,-1,2,3,1,1,0,0,-3,25,-1,4,3,-12,0,-1,-1,1,-1,-1,1,1
KR_6769307232,420,3,21,26,3,-1,1,2,-3,3,6,6,9,3,-1,1,2,2,2,0,1,2,1,-3,7,4,-2,0,1,-1,-1,1,1,5,1
KR_6776624864,420,2,-4,8,4,2,2,0,0,3,3,4,4,0,0,3,3,-2,1,3,0,-1,6,0,3,3,-1,0,1,1,1,1,1,1,1
KR_6775741486,420,1,22,-13,5,2,2,0,-2,1,3,0,3,3,5,6,1,0,0,0,0,12,8,2,4,6,-1,0,1,1,-1,1,1,2,1
KR_6755485682,420,2,-7,34,2,-2,0,2,2,4,2,-1,0,1,-1,2,3,4,4,0,0,7,1,1,4,5,2,0,1,1,1,1,1,2,1
KR_6764670738,420,3,30,8,6,2,3,1,6,6,0,0,2,2,-2,1,3,0,0,0,-1,5,-13,4,3,7,0,0,1,1,1,1,-1,6,1
KR_6772992490,420,-2,41,5,-7,1,3,2,0,4,4,-6,1,7,-2,2,4,0,0,0,0,-12,2,0,4,4,2,0,0,-1,-1,0,1,1,1
KR_6773951644,420,1,27,-22,8,2,3,1,2,4,2,2,5,3,1,3,2,1,2,1,1,9,3,4,2,6,-2,0,2,1,1,1,1,3,1
KR_6734256779,420,0,7,24,2,-3,1,4,2,7,5,1,3,2,-1,1,2,3,3,0,1,4,4,0,6,6,3,0,2,1,1,1,1,4,1
KR_6719804797,420,0,13,9,2,0,4,4,-1,1,2,2,6,4,2,2,0,-1,0,1,0,-5,-61,2,6,8,2,0,2,1,1,1,1,1,1
KR_6758942199,420,0,-21,23,0,-1,3,4,-2,2,4,-2,2,4,4,4,0,1,2,1,-1,-3,3,3,4,7,2,0,0,-1,1,1,-1,5,1
KR_6759265432,420,1,86,4,5,1,3,2,-1,4,5,-2,2,4,7,10,3,0,1,1,0,4,-36,4,7,11,6,0,4,-1,1,1,-1,4,1
KR_6774114416,420,-1,-24,-7,-1,-4,0,4,1,3,2,0,6,6,2,2,0,0,1,1,-2,6,-10,2,8,10,4,0,-1,-1,1,-1,-1,5,1
KR_6750460716,420,8,125,16,17,8,9,1,0,2,2,1,2,1,5,6,1,3,3,0,0,9,9,1,6,7,-4,0,0,1,-1,1,-1,1,1
KR_6774592765,420,-2,9,13,-4,-3,1,4,-4,1,5,2,4,2,1,1,0,0,1,1,0,-8,-8,-4,12,8,5,0,0,1,1,-1,1,2,1
KR_6716644417,420,0,69,4,1,-1,0,1,1,7,6,4,4,0,-2,4,6,-1,0,1,1,16,-2,-3,9,6,-4,0,-1,1,-1,-1,1,2,1
KR_6732892911,420,3,71,-2,12,1,5,4,5,6,1,2,6,4,6,8,2,-2,1,3,0,-4,11,6,3,9,2,0,3,1,1,1,1,4,1
KR_6738023604,420,5,83,-7,8,-2,0,2,-1,1,2,0,1,1,9,10,1,2,2,0,1,12,4,1,8,9,3,0,2,1,-1,1,1,5,1
KR_6777859352,420,1,7,27,3,3,3,0,-2,1,3,1,2,1,1,4,3,0,0,0,-2,-5,-17,1,5,6,7,0,1,-1,1,1,-1,4,1
KR_6746242555,420,-1,21,-10,4,4,4,0,2,6,4,5,6,1,-7,2,9,0,1,1,1,16,0,7,2,9,-4,0,0,1,1,-1,1,5,1
KR_6745873781,420,5,18,20,8,1,1,0,1,5,4,3,3,0,0,3,3,3,4,1,0,14,2,2,6,8,3,0,1,-1,1,1,-1,2,1
KR_6710526030,420,1,1,5,6,-3,1,4,4,7,3,2,3,1,2,5,3,1,1,0,2,12,41,-1,8,7,2,0,0,-1,1,0,1,5,1
KR_6777872030,440,-2,8,-1,-4,0,1,1,-2,1,3,0,1,1,-1,3,4,-1,0,1,0,0,0,2,7,9,-1,0,-1,1,-1,-1,-1,6,1
KR_6750019996,420,3,25,5,12,1,2,1,2,6,4,4,4,0,4,5,1,1,2,1,-1,16,-44,6,2,8,-4,0,1,1,1,1,-1,4,1
KR_6700517289,420,3,60,-4,11,2,3,1,0,1,1,5,5,0,3,5,2,1,1,0,0,5,5,2,7,9,7,0,2,1,1,1,1,5,1
KR_6738004736,420,2,75,-29,4,4,6,2,-2,4,6,1,2,1,3,5,2,-2,2,4,0,-3,8,0,8,8,0,0,1,-1,-1,1,1,3,1
KR_6684996809,420,-1,-44,-28,0,0,2,2,4,5,1,1,1,0,-5,2,7,0,1,1,0,-1,16,-2,6,4,1,0,-1,1,-1,-1,1,1,1
KR_6774813971,420,2,47,7,7,-4,1,5,3,4,1,3,5,2,6,6,0,-1,0,1,0,6,13,0,5,5,-3,0,1,1,-1,1,1,1,1
KR_6777025272,420,2,21,-5,4,1,2,1,-3,1,4,0,2,2,2,3,1,4,4,0,1,-1,-40,0,7,7,3,0,-2,1,-1,-1,1,1,1
KR_6763197368,440,1,-2,-6,6,0,2,2,1,1,0,1,1,0,0,1,1,4,4,0,0,14,18,1,7,8,0,0,0,1,-1,0,1,6,1
KR_6777212583,420,4,87,0,14,2,4,2,6,8,2,2,2,0,3,6,3,1,2,1,0,16,-12,-2,11,9,5,0,2,1,1,1,-1,2,1
KR_6703650000,420,4,69,48,9,3,5,2,1,7,6,-1,2,3,5,5,0,1,2,1,2,20,46,0,6,6,3,0,2,1,-1,1,1,3,1
KR_6749484121,420,-4,-73,-28,-13,1,5,4,-11,0,11,2,4,2,-4,2,6,-1,2,3,-1,-8,17,2,9,11,0,0,-3,1,-1,-1,-1,4,1
KR_6752874484,420,-3,-53,-31,-4,-5,0,5,0,1,1,-1,0,1,2,7,5,0,1,1,-1,5,-13,4,10,14,5,0,-1,-1,-1,-1,-1,4,1
KR_6760471256,420,-3,-48,-27,0,-1,1,2,2,5,3,2,7,5,-4,2,6,1,1,0,0,5,43,5,3,8,-1,0,-1,-1,1,-1,1,6,1
KR_6776485421,420,2,14,12,3,6,7,1,1,4,3,-1,2,3,-3,4,7,0,1,1,1,-3,-22,3,4,7,-1,0,1,1,1,1,1,6,1
KR_6744281923,420,-2,-73,16,-7,-1,2,3,3,6,3,-7,0,7,0,5,5,-2,0,2,-2,-5,22,-3,8,5,-2,0,-1,1,-1,-1,-1,3,1
KR_6764749900,420,1,8,4,1,1,4,3,-1,2,3,0,3,3,0,2,2,1,3,2,0,-2,16,-2,4,2,2,0,0,1,-1,1,-1,3,1
KR_6770355724,440,3,-3,-5,11,5,6,1,4,4,0,1,1,0,2,4,2,-1,0,1,1,22,4,3,1,4,-2,0,0,1,-1,0,1,1,1
KR_6732222304,420,5,84,0,8,1,1,0,1,2,1,2,4,2,3,4,1,1,1,0,0,16,17,-3,8,5,-10,0,1,-1,-1,1,-1,2,1
KR_6740111455,420,3,-11,-12,6,2,2,0,4,5,1,-1,2,3,3,4,1,-2,1,3,0,3,9,6,3,9,5,0,2,0,1,1,1,0,1
KR_6709873257,420,4,-1,-11,15,2,5,3,3,4,1,1,2,1,8,8,0,1,1,0,0,20,-1,0,9,9,8,0,1,-1,-1,1,1,3,1
KR_6736148809,420,0,30,-32,6,-1,2,3,0,3,3,2,4,2,4,4,0,1,2,1,0,0,15,2,3,5,2,0,2,0,1,1,1,0,1
KR_6775638961,420,2,10,-7,2,0,0,0,4,8,4,-1,2,3,-2,1,3,1,1,0,-1,11,-5,-3,6,3,2,0,0,-1,-1,0,-1,6,1
KR_6776651941,420,0,37,-8,3,0,1,1,-1,0,1,3,3,0,0,5,5,1,1,0,0,2,-40,1,8,9,30,0,1,1,1,-1,1,3,1
KR_6770202737,420,4,-16,-3,10,5,5,0,3,4,1,3,4,1,0,0,0,-1,0,1,0,4,-1,0,2,2,2,0,0,-1,1,0,-1,2,1
KR_6729019415,420,2,47,-26,10,1,1,0,0,5,5,5,6,1,3,4,1,1,1,0,0,18,20,5,5,10,-2,0,1,1,1,1,1,1,1
KR_6771461103,440,1,-60,8,-2,0,1,1,-2,0,2,-1,3,4,-1,1,2,2,2,0,0,-2,-23,0,6,6,6,0,0,-1,0,0,-1,2,1
KR_6776716221,420,-1,-12,12,0,-6,0,6,1,3,2,1,2,1,5,5,0,-1,1,2,0,10,-1,-1,4,3,0,0,1,1,-1,1,-1,5,1
KR_6773854099,420,0,0,20,-4,-1,1,2,-3,3,6,-1,2,3,1,3,2,0,1,1,0,-6,154,-1,5,4,-1,0,0,-1,1,0,-1,6,1
KR_6760875633,420,-2,10,-6,-13,0,3,3,-9,1,10,3,4,1,-2,3,5,-5,0,5,0,-30,-4,-2,6,4,-3,0,-1,0,-1,-1,-1,0,1
KR_6773662444,420,-2,37,-59,3,-2,1,3,0,4,4,2,3,1,4,5,1,-1,0,1,0,7,-11,0,5,5,-1,0,-1,1,-1,-1,1,1,1
KR_6763520277,420,3,17,47,2,-2,0,2,3,7,4,-2,2,4,1,3,2,2,2,0,-1,9,39,-1,7,6,4,0,0,1,-1,-1,-1,3,1
KR_6719151890,420,6,17,22,9,6,6,0,6,7,1,-1,3,4,-2,0,2,0,2,2,0,7,46,4,3,7,3,0,0,-1,1,1,1,6,1
KR_6774984734,420,-2,-35,-15,0,-1,0,1,-3,1,4,0,2,2,4,6,2,0,0,0,0,0,-10,-6,11,5,-4,0,0,1,-1,0,-1,2,1
KR_6707853973,420,3,80,0,3,-1,0,1,5,7,2,1,3,2,-2,0,2,0,0,0,-1,1,-1,-4,8,4,3,0,2,-1,1,1,-1,3,1
KR_6734067388,420,0,4,-11,0,0,2,2,-1,0,1,-3,1,4,4,4,0,0,0,0,0,0,0,3,4,7,-4,0,0,-1,1,-1,-1,3,1
KR_6738357325,420,5,-22,58,10,-3,0,3,4,5,1,2,2,0,6,8,2,1,3,2,0,8,125,1,5,6,-3,0,1,1,1,1,1,1,1
KR_6764144095,420,4,42,32,10,3,3,0,0,6,6,3,6,3,2,4,2,2,3,1,1,9,236,4,6,10,0,0,2,1,1,1,1,6,1
KR_6744312904,420,2,67,2,4,2,4,2,5,6,1,1,2,1,-1,1,2,-3,0,3,1,2,-6,0,5,5,-2,0,0,-1,-1,-1,1,5,1
KR_6777761177,420,6,39,15,15,3,4,1,6,6,0,2,5,3,8,9,1,-4,1,5,1,19,5,2,4,6,-5,0,1,1,1,-1,1,2,1
KR_6775916109,420,1,36,-4,1,0,2,2,3,6,3,-1,1,2,-3,3,6,2,3,1,1,-2,1,-2,8,6,-2,0,0,-1,1,0,1,1,1
KR_6770895637,420,0,46,0,-3,2,3,1,-5,1,6,3,5,2,-3,3,6,0,1,1,1,-9,13,5,5,10,-4,0,-1,1,-1,-1,1,2,1
KR_6775770410,420,1,2,-4,5,-1,0,1,-1,3,4,11,13,2,-3,3,6,-1,0,1,0,8,11,-3,9,6,-2,0,0,-1,-1,-1,1,3,1
KR_6777006906,420,2,82,20,4,2,2,0,4,5,1,-5,2,7,3,4,1,0,0,0,2,9,-2,4,7,11,-3,0,1,1,1,1,1,5,1
KR_6775397808,440,2,-13,-2,7,-2,0,2,4,10,6,0,1,1,4,5,1,1,2,1,0,10,36,-1,8,7,1,0,0,1,0,0,1,5,1
KR_6776344295,420,0,18,-16,-1,3,3,0,3,4,1,-4,0,4,-3,0,3,0,1,1,0,-6,0,2,7,9,-1,0,1,-1,1,1,1,6,1
KR_6775714434,420,0,5,-12,0,2,2,0,-1,1,2,-1,1,2,2,3,1,-2,0,2,1,-8,7,2,7,9,0,0,2,-1,1,1,1,6,1
KR_6746119578,420,2,49,25,4,1,1,0,-1,0,1,4,5,1,2,3,1,-2,1,3,0,-3,-9,3,7,10,0,0,2,1,1,1,1,5,1
KR_6765473087,420,1,-3,25,10,5,5,0,7,8,1,1,6,5,-5,4,9,2,3,1,0,19,-6,0,7,7,2,0,2,1,1,1,1,4,1
KR_6772818832,420,5,-2,6,9,-2,1,3,7,7,0,2,3,1,0,2,2,2,2,0,0,15,23,-1,5,4,6,0,1,1,1,1,-1,2,1
KR_6774092475,420,1,25,8,0,-2,1,3,1,4,3,-2,1,3,2,3,1,1,1,0,0,-1,-191,-3,8,5,0,0,-1,1,-1,-1,-1,4,1
KR_6774148781,420,-1,15,-19,0,0,4,4,-7,1,8,-4,0,4,11,12,1,0,5,5,1,-2,39,-2,8,6,1,0,-1,-1,1,1,-1,3,1
KR_6706683942,420,3,71,23,4,3,4,1,-1,2,3,1,4,3,1,1,0,0,0,0,0,10,2,5,6,11,1,0,1,1,1,1,-1,6,1
KR_6695078585,420,2,50,8,4,0,2,2,-2,0,2,5,5,0,3,4,1,-2,0,2,0,9,0,-2,5,3,-4,0,1,1,-1,1,1,6,1
KR_6776744283,420,7,67,8,17,2,3,1,3,4,1,6,6,0,3,4,1,3,3,0,1,16,-93,1,4,5,2,0,0,1,1,1,1,2,1
KR_6775912083,420,2,-63,0,10,1,4,3,2,5,3,5,7,2,2,3,1,0,0,0,0,5,4,3,3,6,-1,0,0,1,1,1,-1,3,1
KR_6714483951,420,1,-38,47,2,-1,1,2,1,4,3,1,3,2,0,5,5,1,1,0,0,4,-7,-4,9,5,6,0,0,1,-1,0,-1,2,1
KR_6749371141,420,-1,49,-17,-5,-1,0,1,0,2,2,-7,0,7,0,2,2,3,3,0,0,-4,-32,0,8,8,-5,0,1,-1,-1,1,1,2,1
KR_6766621120,420,3,-35,38,7,-1,1,2,0,3,3,7,7,0,-1,7,8,2,2,0,0,5,-2,-3,6,3,-2,0,0,1,1,1,1,6,1
KR_6772712576,420,2,65,-5,3,0,2,2,1,2,1,2,5,3,-1,1,2,1,3,2,0,-9,-1,-3,6,3,1,0,1,-1,1,1,1,6,1
KR_6767166789,420,6,70,5,14,11,12,1,3,3,0,0,2,2,-1,5,6,1,2,1,0,6,68,7,1,8,-1,0,2,1,1,1,1,4,1
KR_6772942031,420,3,26,12,2,-6,1,7,5,5,0,0,0,0,3,4,1,0,0,0,0,10,6,-2,6,4,3,0,0,1,-1,-1,-1,4,1
KR_6736289142,420,1,22,6,4,2,2,0,-2,5,7,1,1,0,2,5,3,1,1,0,0,7,-34,0,4,4,3,0,1,1,-1,1,-1,3,1
KR_6764064733,420,4,67,20,5,2,4,2,-2,2,4,1,2,1,3,7,4,1,1,0,1,11,8,1,5,6,-1,0,1,1,1,1,-1,6,1
KR_6741439317,420,1,-1,22,2,1,2,1,1,2,1,-3,0,3,1,4,3,2,3,1,0,-3,-6,2,9,11,-8,0,0,1,-1,0,-1,4,1
KR_6776881877,420,-2,21,-10,-6,3,3,0,-1,2,3,-1,0,1,-6,2,8,-1,2,3,0,-10,-8,-5,11,6,3,0,-1,-1,1,-1,-1,5,1
KR_6776993035,420,3,48,-22,9,4,5,1,2,3,1,2,3,1,2,3,1,-1,0,1,1,13,6,4,3,7,5,0,1,1,-1,1,1,4,1
KR_6774485128,420,2,58,2,3,0,1,1,-4,4,8,2,4,2,3,4,1,2,3,1,0,2,5,-1,6,5,9,0,2,1,1,1,1,2,1
KR_6776780226,420,4,35,12,9,1,2,1,1,4,3,3,5,2,2,5,3,2,3,1,0,-6,9,-2,8,6,2,0,0,-1,1,1,1,1,1
KR_6767450807,420,0,-54,-4,6,-2,1,3,2,4,2,0,2,2,1,3,2,5,5,0,0,9,-21,2,2,4,0,0,0,-1,-1,0,1,6,1
KR_6774904033,420,0,-62,18,-6,-2,1,3,-5,4,9,1,2,1,0,2,2,0,0,0,0,-7,88,3,6,9,-4,0,0,1,1,-1,-1,3,1
KR_6777655891,420,2,16,23,9,4,5,1,1,1,0,1,3,2,3,5,2,0,0,0,0,9,12,2,7,9,0,0,1,0,-1,1,1,0,1
KR_6760822843,420,5,53,2,6,0,2,2,3,5,2,-3,0,3,2,5,3,4,7,3,0,8,-6,-4,8,4,-1,0,1,-1,-1,1,-1,6,1
KR_6751426308,420,4,4,18,12,5,6,1,5,9,4,3,3,0,-1,0,1,0,0,0,0,9,-320,4,5,9,-7,0,3,0,1,1,1,0,1
KR_6744379535,420,5,19,24,8,1,1,0,0,3,3,0,1,1,5,5,0,2,3,1,0,16,6,2,4,6,-2,0,0,1,1,0,1,2,1
KR_6684949461,420,-1,25,-28,8,-1,2,3,1,2,1,5,6,1,3,4,1,0,1,1,0,20,3,0,5,5,-1,0,0,1,1,1,-1,1,1
KR_6776277314,440,1,43,19,4,1,3,2,4,5,1,1,4,3,-3,0,3,1,1,0,1,14,31,3,6,9,8,0,0,1,1,0,1,6,1
KR_6771671138,420,1,22,11,7,2,2,0,-7,2,9,0,2,2,10,12,2,2,2,0,1,8,40,3,5,8,-12,0,0,1,-1,1,-1,4,1
KR_6724239990,420,4,-10,17,9,1,2,1,8,8,0,0,1,1,-1,0,1,1,1,0,0,12,9,4,4,8,1,0,-1,-1,1,1,1,1,1
KR_6770455899,420,0,14,16,5,1,4,3,1,2,1,1,1,0,2,3,1,0,0,0,0,4,3,3,3,6,1,0,1,1,1,1,1,5,1
KR_6735613548,420,5,41,20,2,0,4,4,1,4,3,-2,0,2,4,6,2,-1,2,3,-1,10,3,4,5,9,-6,0,0,1,-1,0,-1,4,1
KR_6777342232,420,4,12,4,9,2,3,1,4,5,1,-1,1,2,5,8,3,-1,2,3,0,6,-2,-3,7,4,10,0,1,1,-1,1,1,1,1
KR_6777646923,420,-3,-35,20,-5,-2,0,2,-1,1,2,2,3,1,-2,0,2,-2,0,2,0,-3,-1,-3,6,3,-1,0,-2,-1,-1,-1,-1,2,1
KR_6740440819,420,0,2,28,-2,2,4,2,-1,2,3,-1,2,3,-2,0,2,0,0,0,0,-7,4,0,5,5,-4,0,1,1,1,1,1,2,1
KR_6713283318,420,1,-1,5,-1,0,0,0,5,6,1,-2,1,3,-3,1,4,-1,1,2,0,-7,1,3,10,13,-1,0,2,-1,1,1,1,3,1
KR_6719072563,420,-2,-77,-22,5,3,3,0,4,4,0,-3,3,6,1,4,3,0,2,2,0,11,15,1,5,6,-3,0,0,1,-1,-1,1,1,1
KR_6731639533,420,-1,13,19,7,-2,0,2,0,5,5,1,1,0,5,7,2,3,5,2,0,8,-32,1,5,6,0,0,2,-1,1,1,1,1,1
KR_6768876753,440,11,111,68,18,6,7,1,6,7,1,3,4,1,0,6,6,3,3,0,1,16,-7,3,4,7,4,0,2,0,0,1,1,0,1
KR_6764359054,420,1,4,10,-7,-1,2,3,-4,2,6,-1,1,2,-1,4,5,0,1,1,0,-7,-1,-3,10,7,4,0,0,1,-1,1,-1,6,1
KR_6768803696,420,1,0,46,-2,-1,2,3,0,5,5,0,2,2,-2,2,4,1,2,1,-3,-9,-101,3,2,5,-13,0,1,1,-1,1,-1,6,1
KR_6754034089,420,5,62,-23,2,2,5,3,2,3,1,-4,1,5,0,4,4,2,2,0,-3,-3,0,2,6,8,-3,0,0,-1,-1,-1,-1,5,1
KR_6769589379,420,2,60,3,8,-2,0,2,4,6,2,0,0,0,4,4,0,2,3,1,0,8,0,-1,7,6,-2,0,1,-1,-1,1,1,4,1
KR_6749955620,420,4,53,-5,10,1,4,3,5,9,4,2,4,2,3,3,0,-1,0,1,0,5,2,5,5,10,0,0,0,1,1,1,1,3,1
KR_6749710018,420,3,57,9,-1,-3,1,4,3,6,3,-2,1,3,3,5,2,-2,0,2,0,5,-103,-3,6,3,4,0,-1,1,-1,-1,-1,2,1
KR_6773281350,420,0,16,19,-1,1,1,0,-4,1,5,3,4,1,0,3,3,-1,0,1,0,-4,2,4,4,8,5,0,0,-1,1,0,1,6,1
KR_6752099933,420,-1,-32,10,-3,-1,0,1,1,2,1,-3,1,4,0,3,3,0,1,1,0,-8,4,2,4,6,-2,0,-2,1,-1,-1,-1,6,1
KR_6770602757,420,-2,-27,-9,5,4,8,4,1,4,3,0,1,1,0,2,2,0,1,1,0,3,6,-3,9,6,-5,0,-1,1,1,-1,-1,4,1
KR_6746013611,420,1,5,1,2,-2,2,4,3,5,2,1,2,1,0,1,1,0,1,1,0,5,-34,1,6,7,14,0,-1,1,-1,-1,-1,3,1
KR_6775928562,420,4,52,-23,12,0,3,3,3,3,0,6,6,0,2,3,1,1,1,0,1,19,-40,-3,8,5,8,0,0,-1,1,0,1,4,1
KR_6751471871,440,0,39,8,3,-2,5,7,4,4,0,1,2,1,0,2,2,0,0,0,0,2,-9,0,6,6,2,0,1,1,-1,1,-1,6,1
KR_6772919481,420,-4,29,-1,-6,-1,1,2,-1,1,2,-1,1,2,-3,0,3,0,0,0,0,-11,46,1,7,8,-21,0,2,-1,1,1,-1,4,1
KR_6756185549,420,0,-15,-11,5,2,3,1,1,3,2,1,3,2,-1,5,6,2,3,1,0,7,-4,-6,12,6,3,0,1,1,1,1,1,2,1
KR_6741157537,420,7,62,34,16,6,6,0,4,6,2,6,7,1,1,7,6,-1,0,1,4,27,-18,-5,11,6,3,0,3,-1,1,1,1,1,1
KR_6754141342,420,-2,27,-31,-1,-1,0,1,1,2,1,1,1,0,-3,0,3,1,1,0,1,-3,4,-2,6,4,1,0,-1,-1,1,-1,1,4,1
KR_6732354176,420,2,67,11,3,2,2,0,-1,0,1,2,2,0,0,1,1,0,1,1,0,0,10,-1,6,5,-3,0,0,1,1,0,1,2,1
KR_6762705560,420,0,-56,-16,5,1,2,1,4,5,1,1,3,2,-1,3,4,0,2,2,0,15,9,-3,5,2,-2,0,-1,1,-1,-1,-1,3,1
KR_6757139221,440,-5,-49,-28,-2,-5,2,7,4,4,0,2,4,2,-3,0,3,0,1,1,0,1,-294,0,5,5,-4,0,0,-1,1,0,1,1,1
KR_6767500002,420,1,0,-16,5,-1,2,3,3,4,1,2,3,1,1,6,5,0,0,0,0,-1,-37,0,7,7,-2,0,0,1,1,-1,-1,4,1
KR_6719738901,420,4,36,24,11,3,4,1,4,6,2,1,5,4,2,2,0,1,1,0,0,14,-5,-1,10,9,5,0,3,1,1,1,1,2,1
KR_6763464817,440,-1,-4,28,-2,-1,0,1,-3,3,6,0,0,0,3,5,2,-1,0,1,0,-1,10,3,2,5,0,0,1,0,1,1,1,0,1
KR_6772614033,420,6,79,2,10,-2,0,2,4,5,1,6,7,1,1,5,4,1,4,3,0,20,24,3,6,9,-13,0,2,1,1,1,1,1,1
KR_6679284524,440,-2,19,-14,-8,0,0,0,-2,3,5,-3,0,3,-6,2,8,3,3,0,-1,-15,250,0,5,5,9,0,0,-1,1,1,-1,1,1
KR_6736609866,420,3,-24,0,5,1,3,2,4,5,1,4,7,3,-3,2,5,-1,0,1,0,9,40,-2,9,7,-20,0,-1,1,-1,-1,-1,4,1
KR_6742101278,420,3,74,-42,3,1,3,2,-1,2,3,0,1,1,2,5,3,1,2,1,0,10,-4,-3,7,4,0,0,-1,1,-1,-1,1,3,1
KR_6777670950,420,2,2,-19,5,2,4,2,0,2,2,5,7,2,-1,1,2,-1,1,2,0,0,-1,-1,5,4,4,0,1,-1,1,1,1,2,1
KR_6768732227,420,1,12,25,-1,-1,0,1,0,5,5,0,2,2,0,0,0,0,1,1,-1,2,-5,-2,7,5,3,0,0,-1,1,1,-1,4,1
KR_6774993336,420,1,-31,-10,-1,0,1,1,1,4,3,0,1,1,1,1,0,-3,0,3,0,0,26,4,8,12,1,0,-1,1,-1,-1,1,2,1
KR_6713361186,420,1,66,-16,5,3,4,1,3,7,4,-2,1,3,1,5,4,0,2,2,0,5,-8,1,3,4,2,0,1,-1,1,1,-1,2,1
KR_6771985366,420,7,100,-1,13,1,2,1,1,3,2,7,7,0,4,7,3,0,1,1,0,14,9,1,5,6,-3,0,2,1,1,1,1,6,1
KR_6746680754,420,2,7,18,4,0,1,1,-1,1,2,-1,3,4,7,7,0,-1,1,2,0,3,-10,0,7,7,4,0,0,1,-1,1,-1,1,1
KR_6729832585,440,1,57,4,-4,-1,2,3,2,4,2,-2,1,3,-1,4,5,-2,0,2,0,-1,54,5,4,9,-31,0,-1,-1,-1,-1,-1,2,1
KR_6725874867,420,-1,26,-8,0,7,8,1,-8,2,10,1,2,1,-1,1,2,1,1,0,0,-7,-133,4,4,8,-1,0,1,-1,1,1,-1,3,1
KR_6777217195,420,0,-1,21,-1,-1,2,3,-1,5,6,0,3,3,2,2,0,-1,2,3,3,2,-5,2,6,8,-3,0,0,-1,1,-1,1,4,1
KR_6750121488,420,4,57,-15,13,1,1,0,7,9,2,1,2,1,1,3,2,3,4,1,1,19,-8,10,2,12,-1,0,1,1,1,-1,1,1,1
KR_6776534731,420,2,35,20,10,1,2,1,1,7,6,6,6,0,5,6,1,-3,2,5,1,13,5,-1,6,5,1,0,0,1,1,1,1,4,1
KR_6771738142,420,0,-12,9,0,-6,1,7,-1,1,2,2,4,2,2,2,0,3,3,0,0,9,9,1,7,8,0,0,-1,1,-1,-1,1,3,1
KR_6767795336,420,1,-3,44,-1,-1,0,1,-1,2,3,-1,1,2,1,2,1,1,2,1,0,-3,6,4,3,7,-3,0,0,-1,1,0,1,1,1
KR_6777367981,420,1,17,21,0,-2,3,5,-2,1,3,-2,0,2,6,6,0,0,1,1,0,2,6,-6,13,7,-2,0,3,1,1,1,1,2,1
KR_6711955792,420,3,30,7,3,3,4,1,-2,0,2,1,1,0,0,1,1,1,1,0,-1,-6,-8,-1,5,4,2,0,1,1,1,1,-1,3,1
KR_6729132101,420,5,78,42,15,7,7,0,10,11,1,-2,1,3,-2,1,3,2,2,0,0,13,-14,3,5,8,7,0,2,-1,1,1,1,3,1
KR_6733786606,420,-1,-16,-1,-5,-3,0,3,0,3,3,0,1,1,-4,3,7,2,2,0,-1,1,-16,-6,10,4,7,0,-1,-1,-1,-1,-1,3,1
KR_6773242672,420,1,30,51,-2,-3,2,5,-2,2,4,1,1,0,3,3,0,-1,1,2,0,-3,4,4,3,7,-1,0,1,1,1,1,1,3,1
KR_6757302185,420,-2,-84,7,1,-2,1,3,0,1,1,2,7,5,1,3,2,0,0,0,0,7,-12,0,3,3,-2,0,-1,1,1,1,-1,3,1
KR_6766371913,420,2,17,-11,9,4,4,0,1,7,6,0,2,2,3,5,2,1,3,2,1,8,3,3,2,5,0,0,2,-1,1,1,1,3,1
KR_6774394920,420,1,-4,21,4,-1,2,3,2,4,2,0,2,2,3,6,3,0,0,0,0,9,-3,3,5,8,5,0,1,-1,1,1,-1,3,1
KR_6762174196,420,0,26,-3,5,2,2,0,-3,2,5,0,2,2,2,2,0,4,5,1,0,7,-15,-1,7,6,1,0,1,1,1,1,-1,2,1
KR_6727871746,420,-1,7,-15,2,0,3,3,0,3,3,-1,1,2,5,5,0,-2,0,2,0,2,21,3,9,12,-4,0,-1,-1,-1,-1,1,2,1
KR_6770905842,420,3,22,-25,8,4,7,3,0,1,1,6,7,1,-2,2,4,0,1,1,0,4,-23,5,6,11,2,0,2,1,1,1,-1,5,1
KR_6773737297,420,1,-12,-6,6,3,5,2,3,4,1,-1,1,2,1,2,1,0,0,0,0,6,11,0,4,4,-6,0,1,-1,-1,1,1,5,1
KR_6769481637,420,0,-10,22,4,1,1,0,1,2,1,2,4,2,1,2,1,-1,0,1,0,-3,3,2,8,10,2,0,-1,1,1,1,1,6,1
KR_6735043876,420,0,-23,-4,5,-2,2,4,-2,2,4,2,4,2,5,6,1,2,3,1,1,8,34,0,6,6,3,0,0,1,1,-1,1,5,1
KR_6743403041,420,3,43,-2,8,4,5,1,0,5,5,2,3,1,2,5,3,0,0,0,0,8,0,3,6,9,1,0,2,0,1,1,1,0,1
KR_6756763983,420,1,2,2,8,1,2,1,-1,4,5,1,2,1,7,7,0,0,1,1,0,8,-3,1,6,7,1,0,-1,1,-1,-1,-1,5,1
KR_6739803214,420,-2,-32,-4,3,-1,1,2,9,9,0,0,2,2,-5,0,5,0,0,0,0,4,29,-3,8,5,5,0,0,-1,1,0,1,2,1
KR_6756351293,420,-1,-5,6,1,-1,1,2,-1,1,2,3,3,0,-1,1,2,1,1,0,1,8,8,4,5,9,-8,0,0,-1,-1,0,1,1,1
KR_6761222946,420,0,12,-8,1,-3,1,4,3,4,1,4,4,0,-1,3,4,-2,0,2,-2,2,-13,1,5,6,6,0,1,1,1,1,-1,3,1
KR_6743257646,420,3,13,16,11,2,2,0,2,4,2,-2,3,5,9,10,1,0,3,3,3,18,10,0,11,11,3,0,2,1,1,1,1,1,1
KR_6763766214,420,4,41,-15,16,-1,1,2,6,6,0,6,6,0,5,5,0,0,2,2,0,13,14,2,2,4,-4,0,2,0,1,1,1,0,1
KR_6774985043,420,-1,37,17,-2,-3,0,3,1,3,2,3,3,0,-2,2,4,-1,0,1,1,6,-3,0,5,5,6,0,0,1,-1,0,1,2,1
KR_6756109475,420,6,59,18,8,4,5,1,-1,1,2,-2,2,4,7,9,2,0,0,0,0,7,2,0,7,7,10,0,3,1,1,1,-1,5,1
KR_6710323021,420,4,13,0,7,3,4,1,2,3,1,0,2,2,-2,3,5,4,4,0,0,9,16,6,5,11,4,0,1,1,1,1,1,2,1
KR_6742169924,420,1,-54,30,10,2,2,0,3,6,3,5,5,0,0,4,4,0,2,2,0,10,2,6,3,9,-2,0,1,0,1,1,1,0,1
KR_6715142139,420,-1,16,0,-7,-1,2,3,-1,1,2,-1,1,2,-3,1,4,-1,0,1,-1,-6,-32,-3,8,5,6,0,1,1,-1,1,-1,2,1
KR_6776669598,420,1,-6,4,4,1,3,2,1,4,3,1,1,0,-1,2,3,2,3,1,0,2,8,6,6,12,-8,0,2,-1,1,1,-1,2,1
KR_6743335272,420,1,72,-13,1,-1,1,2,4,7,3,0,2,2,-2,8,10,0,2,2,-1,-9,-26,0,9,9,3,0,1,1,-1,1,-1,2,1
KR_6772777393,420,3,31,-4,6,3,5,2,-1,1,2,5,6,1,0,5,5,-1,0,1,0,7,-18,3,2,5,3,0,1,-1,1,1,1,1,1
KR_6755111301,420,2,37,-3,7,4,7,3,1,6,5,2,5,3,0,3,3,0,1,1,0,8,7,1,5,6,3,0,1,1,-1,1,-1,3,1
KR_6757506758,420,3,7,32,6,0,1,1,1,3,2,4,4,0,0,1,1,1,1,0,0,1,-10,3,5,8,5,0,1,1,1,1,1,4,1
KR_6748178019,420,6,92,34,7,-4,0,4,3,5,2,6,7,1,1,4,3,1,1,0,1,18,33,6,3,9,2,0,2,-1,1,1,1,5,1
KR_6775881704,420,1,2,8,7,2,2,0,0,2,2,0,0,0,1,1,0,4,4,0,0,8,-5,0,10,10,7,0,1,1,1,1,1,6,1
KR_6711758706,420,2,-10,-12,6,2,4,2,0,1,1,-2,4,6,2,4,2,4,5,1,1,7,2,-2,7,5,1,0,-2,-1,-1,-1,1,3,1
KR_6766193079,420,3,54,-15,6,3,5,2,-2,2,4,-2,2,4,10,11,1,-3,2,5,2,0,0,5,4,9,0,0,1,1,1,1,1,4,1
KR_6777537933,420,5,50,28,14,0,1,1,7,8,1,3,4,1,3,4,1,1,1,0,1,20,12,1,8,9,-6,0,2,-1,1,1,1,1,1
KR_6742534370,420,0,-4,-8,0,1,3,2,1,4,3,2,4,2,-1,2,3,-3,0,3,0,-5,-1,0,6,6,-5,0,-1,1,-1,-1,1,1,1
KR_6774514726,420,1,58,23,4,3,3,0,-2,2,4,1,3,2,-1,2,3,3,4,1,0,4,-2,-3,8,5,2,0,0,-1,1,1,1,2,1
KR_6737054970,420,5,44,24,10,2,3,1,1,5,4,5,6,1,-1,5,6,3,3,0,0,3,-23,4,4,8,0,0,1,1,1,1,-1,2,1
KR_6699329827,420,1,17,-2,0,1,1,0,1,4,3,-2,1,3,0,3,3,0,0,0,0,0,3,0,7,7,2,0,1,1,1,1,-1,1,1
KR_6769296390,440,-2,-62,4,-9,0,2,2,6,10,4,-7,1,8,-6,2,8,-2,1,3,0,-11,-5,-4,8,4,-2,0,-2,-1,1,-1,-1,4,1
KR_6757055936,420,0,0,4,-2,4,6,2,-5,0,5,-1,0,1,1,2,1,-1,1,2,0,-6,-3,-6,8,2,0,0,1,1,1,1,1,2,1
KR_6766791481,420,3,12,4,7,2,2,0,4,7,3,0,0,0,1,1,0,0,0,0,0,8,25,-1,8,7,-2,0,0,-1,1,1,1,1,1
KR_6715629543,420,2,36,-27,9,0,1,1,-2,3,5,4,5,1,6,8,2,1,1,0,0,15,-9,-1,5,4,3,0,1,1,-1,1,-1,3,1
KR_6735021970,420,-1,-3,-3,0,0,2,2,4,7,3,0,4,4,-3,3,6,-1,2,3,0,-7,-8,0,7,7,-5,0,-2,-1,1,-1,1,3,1
KR_6765646238,420,1,-20,8,5,2,3,1,0,4,4,-2,2,4,4,7,3,1,2,1,0,17,-10,-3,7,4,0,0,0,1,-1,0,1,2,1
KR_6756107103,420,-2,-15,17,-1,-7,0,7,0,3,3,1,1,0,3,3,0,2,2,0,0,5,-327,-2,4,2,4,0,-2,1,-1,-1,1,4,1
KR_6775953939,420,0,-12,-4,4,1,3,2,3,6,3,3,4,1,-1,2,3,-2,1,3,-2,1,0,-2,7,5,-5,0,-2,1,-1,-1,-1,5,1
KR_6775707814,420,7,76,-14,10,-1,2,3,0,2,2,6,7,1,5,6,1,0,1,1,1,9,6,4,4,8,-1,0,2,1,1,1,1,4,1
KR_6731503068,440,6,123,39,6,1,2,1,-2,2,4,1,7,6,5,5,0,1,2,1,0,2,2,1,5,6,5,0,0,1,1,1,1,5,1
KR_6766066390,420,-3,-44,-4,-6,1,2,1,-5,1,6,2,3,1,-5,2,7,1,3,2,-1,-6,-4,-7,9,2,3,0,-1,-1,-1,-1,-1,4,1
KR_6772099340,440,1,12,-23,3,1,1,0,0,1,1,-1,0,1,4,5,1,-1,0,1,0,4,3,-1,6,5,-1,0,0,-1,0,0,-1,5,1
KR_6772247979,440,0,19,-4,-2,5,5,0,-1,2,3,-4,0,4,-2,2,4,0,2,2,1,3,-30,3,5,8,1,0,0,1,-1,0,1,1,1
KR_6744336493,420,5,62,-29,12,2,2,0,4,5,1,3,6,3,4,7,3,-1,1,2,0,5,-4,-1,6,5,-2,0,1,-1,1,1,1,5,1
KR_6762077709,420,1,16,10,0,-1,1,2,-1,3,4,-1,1,2,3,5,2,0,0,0,1,0,3,0,9,9,-3,0,0,1,1,1,1,1,1
KR_6697943716,420,7,62,14,11,5,7,2,-1,2,3,3,7,4,3,3,0,1,1,0,-1,11,15,3,3,6,-1,0,0,1,-1,0,-1,1,1
KR_6708252976,420,4,69,3,12,3,3,0,4,4,0,4,7,3,2,4,2,-1,0,1,0,11,-34,7,4,11,3,0,2,1,1,1,-1,5,1
KR_6775429737,420,-1,43,6,2,2,2,0,3,5,2,-2,0,2,0,3,3,-1,1,2,3,4,0,3,5,8,-1,0,2,-1,1,1,1,6,1
KR_6775750825,420,0,16,5,-7,3,7,4,-8,0,8,-1,1,2,-1,4,5,0,1,1,-1,-13,3,3,7,10,-2,0,0,1,1,-1,-1,6,1
KR_6768724543,440,2,49,4,-4,1,2,1,-1,2,3,-4,5,9,-2,0,2,2,4,2,1,-12,-7,-1,5,4,2,0,0,-1,-1,0,1,4,1
KR_6758815082,420,1,-33,-6,3,-1,1,2,2,3,1,0,1,1,2,8,6,0,0,0,0,5,-4,-3,10,7,1,0,-1,-1,-1,-1,1,5,1
KR_6771467413,420,2,23,-6,6,5,6,1,0,0,0,1,3,2,0,3,3,0,2,2,0,0,119,-2,6,4,6,0,3,1,1,1,1,3,1
KR_6769507977,420,2,-15,-3,4,4,5,1,1,3,2,3,3,0,-2,0,2,-2,0,2,0,5,-5,3,5,8,-4,0,2,1,-1,1,1,6,1
KR_6765972180,440,-1,-8,-8,-4,-2,0,2,-1,4,5,2,2,0,-3,0,3,0,0,0,0,-7,-10,3,2,5,0,0,0,-1,-1,0,-1,4,1
KR_6768039896,420,1,17,-23,6,1,1,0,2,5,3,-1,0,1,1,1,0,3,6,3,0,9,-1,-3,8,5,2,0,0,-1,1,0,1,2,1
KR_6777088199,420,1,-14,4,5,0,1,1,0,1,1,2,3,1,2,4,2,1,1,0,0,5,-19,5,4,9,0,0,-1,1,-1,-1,1,4,1
KR_6777160194,420,0,65,-8,2,1,1,0,0,6,6,-2,4,6,1,3,2,2,2,0,-1,7,-25,2,6,8,2,0,2,-1,1,1,-1,6,1
KR_6774903180,440,1,24,-5,4,3,3,0,0,1,1,1,1,0,0,0,0,0,0,0,0,3,-8,-1,4,3,8,0,1,1,-1,1,1,3,1
KR_6768631024,420,2,-13,12,7,2,4,2,2,4,2,-2,3,5,3,5,2,2,3,1,0,10,-2,1,6,7,8,0,0,1,1,1,-1,6,1
KR_6733949772,420,0,3,-8,-1,-2,0,2,1,3,2,-1,1,2,1,3,2,0,2,2,0,1,44,3,3,6,-3,0,0,-1,1,0,-1,3,1
KR_6757092996,420,2,57,4,4,-1,2,3,-4,1,5,4,4,0,3,4,1,2,2,0,0,2,-8,-3,9,6,1,0,1,-1,1,1,1,6,1
KR_6753177386,420,2,73,-2,4,2,3,1,-1,1,2,4,4,0,-2,0,2,1,2,1,1,5,5,4,1,5,0,0,2,1,1,1,1,6,1
KR_6760588409,420,-2,13,22,-7,0,3,3,-6,1,7,1,3,2,0,1,1,-2,0,2,0,-16,-74,2,8,10,1,0,-1,-1,-1,-1,-1,4,1
KR_6743350665,420,6,50,15,11,2,2,0,2,7,5,4,5,1,2,3,1,1,1,0,0,16,-1,3,6,9,-2,0,2,1,1,1,1,2,1
KR_6746077234,420,4,72,0,9,3,3,0,0,2,2,3,6,3,4,6,2,-1,0,1,0,9,-4,-2,7,5,5,0,1,-1,1,1,1,5,1
KR_6755019971,420,-2,-42,-4,-2,-1,1,2,-1,3,4,0,2,2,0,0,0,0,2,2,0,1,-6,-6,11,5,5,0,-1,1,-1,-1,-1,6,1
KR_6764832410,420,0,32,-9,2,3,4,1,2,5,3,-3,0,3,-2,0,2,2,2,0,0,0,-4,0,6,6,-6,0,1,0,-1,1,1,0,1
KR_6766495027,420,4,-19,23,9,3,3,0,2,4,2,1,3,2,4,7,3,-1,1,2,0,14,6,-2,6,4,5,0,1,0,1,1,-1,0,1
KR_6684711490,420,7,80,55,9,1,2,1,3,5,2,5,6,1,-1,4,5,1,2,1,0,3,2,1,5,6,0,0,3,1,1,1,1,6,1
KR_6715773930,420,0,18,-20,0,3,4,1,-3,3,6,1,4,3,-1,3,4,0,1,1,0,0,-13,2,4,6,-2,0,2,-1,1,1,1,4,1
KR_6777842038,420,3,14,24,4,-1,1,2,4,5,1,-3,0,3,2,2,0,2,2,0,0,7,12,5,3,8,-6,0,1,1,1,1,1,4,1
KR_6772367935,420,1,-30,32,-1,-3,0,3,1,3,2,-2,3,5,3,3,0,0,2,2,0,2,-20,3,7,10,4,0,0,-1,1,1,-1,4,1
KR_6777130251,420,-3,5,-24,-9,3,4,1,-1,3,4,-7,0,7,-5,2,7,1,1,0,0,-13,3,-5,11,6,-5,0,-1,-1,1,-1,1,2,1
KR_6763667072,420,1,76,-32,-1,1,2,1,-4,1,5,1,3,2,1,1,0,0,0,0,0,-3,6,1,4,5,0,0,3,-1,1,1,1,5,1
KR_6774132903,420,6,37,-4,11,2,2,0,1,3,2,3,3,0,4,9,5,1,2,1,0,5,101,-2,7,5,0,0,3,1,-1,1,1,1,1
KR_6777530372,420,0,8,23,0,2,4,2,-1,1,2,1,2,1,-4,1,5,2,2,0,0,-4,98,-3,9,6,-3,0,0,-1,-1,1,1,2,1
KR_6721804801,420,4,35,6,17,4,4,0,-1,2,3,4,4,0,10,12,2,0,1,1,2,14,37,1,6,7,-3,0,2,0,1,1,1,0,1
KR_6769565025,420,0,27,-19,2,2,4,2,2,3,1,2,2,0,-3,1,4,-1,0,1,0,5,28,4,3,7,3,0,-1,1,-1,-1,1,3,1
KR_6769955827,420,0,-13,13,7,0,2,2,0,1,1,5,8,3,-1,2,3,3,3,0,0,21,0,-6,8,2,0,0,1,1,1,1,1,2,1
KR_6772421340,420,1,-49,4,3,0,1,1,-1,4,5,2,4,2,0,1,1,2,2,0,0,-1,14,3,2,5,2,0,0,1,-1,0,-1,2,1
KR_6776072322,420,0,-9,-1,8,2,3,1,2,4,2,-3,3,6,6,8,2,1,3,2,-1,10,3,2,5,7,0,0,1,-1,-1,1,-1,2,1
KR_6719714858,420,2,44,-8,5,0,2,2,3,4,1,-2,2,4,4,6,2,0,0,0,0,1,11,0,4,4,3,0,2,1,1,1,-1,5,1
KR_6768870326,420,2,-4,21,12,7,7,0,0,5,5,-1,1,2,7,9,2,-1,0,1,2,7,-28,3,8,11,0,0,2,-1,1,1,-1,4,1
KR_6760949575,420,1,36,-8,4,2,3,1,4,7,3,0,0,0,-1,2,3,-1,0,1,0,6,28,0,5,5,-7,0,2,-1,1,1,-1,4,1
KR_6730239875,420,1,17,5,6,-1,0,1,8,8,0,-1,3,4,0,3,3,0,1,1,0,11,4,1,9,10,-2,0,-1,1,-1,-1,-1,4,1
KR_6734912224,420,4,13,60,5,4,5,1,-5,1,6,6,6,0,0,1,1,0,1,1,0,7,-16,-5,8,3,5,0,2,0,1,1,-1,0,1
KR_6774299843,420,2,26,32,8,1,2,1,0,2,2,4,4,0,1,2,1,2,2,0,0,8,-232,3,6,9,8,0,0,1,1,0,-1,6,1
KR_6774909210,420,-2,9,-43,-2,1,2,1,-2,0,2,-1,3,4,-1,0,1,1,1,0,-1,-8,-38,-3,10,7,-1,0,0,-1,-1,0,-1,4,1
KR_6764905540,420,2,-19,13,2,0,1,1,5,8,3,0,2,2,-2,1,3,-1,0,1,0,7,-15,-5,9,4,1,0,0,1,1,0,1,5,1
KR_6720890112,420,4,-68,58,9,1,2,1,-2,3,5,6,7,1,4,5,1,0,1,1,0,15,23,4,5,9,0,0,0,1,1,-1,1,3,1
KR_6763528650,440,2,72,3,3,1,2,1,-2,1,3,0,2,2,6,6,0,-2,1,3,0,3,5,0,4,4,8,0,0,-1,-1,0,1,2,1
KR_6775374975,420,1,58,-40,7,-3,0,3,3,5,2,5,5,0,3,4,1,-1,0,1,0,21,-6,-1,7,6,6,0,0,1,-1,1,1,4,1
KR_6708429408,420,6,49,56,11,0,1,1,7,9,2,4,7,3,0,10,10,0,1,1,4,9,8,3,7,10,-2,0,3,1,1,1,-1,1,1
KR_6769710926,420,2,70,-56,9,3,4,1,1,1,0,-3,1,4,6,7,1,2,2,0,0,9,5,0,5,5,1,0,0,-1,-1,1,1,5,1
KR_6743874352,420,0,56,-9,1,-3,0,3,6,6,0,-3,0,3,0,3,3,1,2,1,-1,1,3,1,7,8,1,0,0,-1,1,1,-1,2,1
KR_6734260554,420,0,4,13,3,-1,1,2,4,8,4,3,5,2,-4,0,4,1,1,0,-1,-2,7,0,6,6,-6,0,1,-1,1,1,-1,1,1
KR_6776789963,420,1,51,1,2,-2,1,3,1,6,5,0,0,0,5,6,1,-2,0,2,1,15,5,-2,11,9,2,0,1,1,-1,1,1,3,1
KR_6702590092,420,3,54,-5,3,-3,2,5,3,3,0,1,2,1,3,4,1,-1,0,1,0,10,3,2,4,6,-6,0,0,-1,-1,0,-1,5,1
KR_6752084672,420,0,-26,24,1,1,2,1,1,4,3,0,0,0,0,4,4,-1,3,4,-1,1,-15,1,7,8,2,0,0,1,1,-1,-1,1,1
KR_6777856206,420,6,99,-12,15,3,3,0,9,9,0,0,1,1,0,4,4,3,3,0,0,22,26,2,7,9,2,0,2,1,1,1,1,3,1
KR_6774391757,420,2,61,16,0,2,3,1,0,1,1,-2,1,3,0,2,2,0,1,1,0,6,-2,4,6,10,1,0,2,1,1,1,-1,3,1
KR_6721127463,420,3,54,16,4,4,4,0,0,2,2,-2,2,4,3,4,1,-1,0,1,0,5,26,-3,8,5,3,0,1,-1,1,1,1,5,1
KR_6674685265,420,-1,-7,20,1,2,4,2,-3,1,4,1,1,0,2,5,3,-1,0,1,-1,-4,40,3,7,10,1,0,1,1,1,1,-1,4,1
KR_6734025446,420,5,45,8,5,-1,0,1,2,3,1,-1,0,1,2,3,1,3,3,0,0,6,41,3,4,7,0,0,2,-1,1,1,1,2,1
KR_6768748468,420,-1,-22,16,5,2,3,1,2,2,0,0,2,2,3,4,1,-2,2,4,0,6,24,0,6,6,5,0,1,1,1,1,1,4,1
KR_6747988896,440,1,-24,-36,5,6,7,1,-4,0,4,-1,3,4,2,3,1,2,2,0,1,1,-3,-1,7,6,-2,0,-2,1,-1,-1,1,5,1
KR_6776027727,420,-1,42,-20,1,1,1,0,0,1,1,-2,1,3,3,3,0,-1,0,1,0,3,3,1,6,7,2,0,1,-1,1,1,-1,1,1
KR_6768516590,420,-3,-33,-17,-7,-4,0,4,-4,1,5,-2,1,3,4,6,2,-1,1,2,0,-5,14,5,2,7,-5,0,1,-1,1,1,-1,2,1
KR_6735694639,420,2,5,-28,13,3,3,0,1,3,2,2,3,1,5,6,1,2,3,1,0,11,1,0,7,7,3,0,2,1,1,1,1,3,1
KR_6732119065,420,-3,-32,9,-6,3,3,0,-2,3,5,-7,3,10,1,5,4,-1,2,3,0,-7,21,-4,7,3,1,0,0,-1,1,-1,1,1,1
KR_6732668580,420,1,37,6,1,0,2,2,2,3,1,-1,1,2,0,1,1,0,1,1,0,-3,-10,0,6,6,3,0,-1,-1,-1,-1,1,3,1
KR_6714868630,420,1,29,37,1,4,4,0,-6,3,9,2,3,1,0,4,4,1,1,0,1,-11,8,4,6,10,-1,0,1,-1,1,1,1,1,1
KR_6776308686,440,4,78,-8,4,-1,1,2,0,1,1,2,5,3,4,7,3,-1,0,1,0,1,-4,-2,6,4,7,0,1,1,-1,1,1,5,1
KR_6750081104,420,3,20,13,9,2,3,1,-2,2,4,1,2,1,6,6,0,2,3,1,0,15,29,6,4,10,-1,0,3,1,1,1,1,2,1
KR_6762846539,420,-1,14,-9,4,0,2,2,2,6,4,5,8,3,-4,2,6,1,1,0,0,1,64,6,4,10,-4,0,0,-1,1,0,1,1,1
KR_6711937299,420,3,10,-35,9,-2,1,3,1,5,4,8,8,0,2,5,3,0,1,1,0,10,-3,3,8,11,6,0,1,1,-1,1,-1,4,1
KR_6723561481,420,6,43,-5,16,1,3,2,8,9,1,2,3,1,5,6,1,0,0,0,0,17,-10,-3,9,6,7,0,2,1,1,1,1,5,1
KR_6753880897,420,2,-9,28,7,-2,0,2,0,2,2,3,3,0,3,5,2,3,3,0,0,15,-14,-3,8,5,3,0,1,1,1,1,-1,4,1
KR_6770902952,420,0,-2,-8,5,-3,1,4,2,2,0,2,5,3,1,3,2,3,3,0,0,12,-3,-1,8,7,4,0,1,1,1,1,1,2,1
KR_6749332979,440,0,24,0,-2,1,1,0,-1,3,4,-1,1,2,-1,1,2,0,4,4,0,-10,-17,2,2,4,30,0,-1,-1,1,-1,1,4,1
KR_6742874861,420,3,95,12,3,3,4,1,-2,1,3,3,6,3,-2,0,2,1,2,1,0,-8,-1,3,2,5,-2,0,0,-1,1,1,1,4,1
KR_6775083246,420,-2,44,-15,2,3,4,1,-1,0,1,2,2,0,-2,1,3,0,0,0,0,0,-2,1,4,5,2,0,2,1,1,1,1,2,1
KR_6745338353,420,0,-49,24,3,0,1,1,-1,2,3,-1,2,3,4,5,1,1,2,1,0,3,21,1,7,8,0,0,-1,1,1,1,1,4,1
KR_6777147566,420,-1,-57,5,-2,-2,0,2,1,3,2,-1,0,1,0,3,3,0,0,0,-1,1,-4,-2,7,5,6,0,0,-1,0,0,-1,5,1
KR_6743511242,440,7,39,8,19,3,4,1,6,6,0,5,5,0,2,6,4,3,6,3,0,11,-10,2,2,4,-1,0,2,1,1,1,-1,1,1
KR_6711294671,420,2,46,-20,5,5,5,0,2,2,0,-3,2,5,1,1,0,0,0,0,0,-2,1,2,5,7,1,0,2,1,1,1,1,3,1
KR_6762431582,420,3,-3,3,7,-1,4,5,6,8,2,1,5,4,1,3,2,0,0,0,0,15,4,5,2,7,1,0,2,1,1,1,-1,4,1
KR_6764921728,420,3,24,19,7,3,5,2,2,3,1,-4,1,5,6,10,4,0,1,1,-1,2,7,1,8,9,-1,0,1,1,-1,1,1,4,1
KR_6696997425,420,3,44,32,3,-1,0,1,5,5,0,1,4,3,-2,2,4,0,0,0,0,3,-25,0,5,5,-6,0,0,1,1,0,1,5,1
KR_6652232482,420,5,86,26,13,2,4,2,3,5,2,4,4,0,4,5,1,0,0,0,0,10,74,8,2,10,1,0,1,1,1,1,1,6,1
KR_6762891790,420,4,43,23,6,3,5,2,-3,3,6,1,4,3,5,5,0,0,1,1,0,-5,-11,-4,11,7,7,0,2,1,-1,1,1,3,1
KR_6777830762,420,-2,-58,9,-7,-4,1,5,1,3,2,-2,1,3,-1,1,2,-1,0,1,0,-5,28,1,5,6,0,0,-1,1,-1,-1,-1,5,1
KR_6772303316,420,6,-1,11,11,5,5,0,-5,0,5,7,7,0,-4,1,5,8,8,0,0,4,11,-1,6,5,0,0,2,1,1,1,1,5,1
KR_6760260737,420,-1,-59,33,1,2,2,0,0,2,2,-1,3,4,-1,3,4,1,1,0,0,-5,34,8,3,11,-7,0,0,1,1,0,1,6,1
KR_6743140084,420,0,47,-36,0,1,2,1,-2,2,4,-2,2,4,-1,3,4,4,5,1,0,0,-8,-5,8,3,5,0,0,-1,-1,0,1,1,1
KR_6745170423,420,2,-3,16,3,-1,2,3,-1,3,4,4,6,2,0,3,3,1,2,1,-1,-3,8,1,8,9,-5,0,-1,1,-1,-1,-1,2,1
KR_6771830676,420,0,-50,-12,-1,-3,2,5,0,1,1,2,2,0,-1,2,3,1,1,0,0,9,-233,-4,6,2,2,0,0,-1,-1,0,-1,1,1
KR_6776773770,420,1,-45,-24,2,6,9,3,-3,2,5,-1,1,2,-3,3,6,3,3,0,-1,3,-30,-8,11,3,4,0,-2,-1,-1,-1,-1,4,1
KR_6706986522,420,10,78,47,22,5,5,0,6,7,1,6,7,1,4,5,1,1,2,1,-1,15,97,3,3,6,4,0,3,1,1,1,-1,5,1
KR_6777734466,420,3,33,10,13,4,6,2,1,3,2,4,5,1,3,4,1,1,1,0,0,18,-26,2,6,8,4,0,1,-1,-1,-1,1,2,1
KR_6689715247,420,-1,24,-13,-5,-3,0,3,-3,0,3,0,2,2,1,2,1,0,2,2,0,-5,-12,-4,10,6,8,0,0,-1,-1,1,1,6,1
KR_6754950949,420,3,89,4,8,2,2,0,4,4,0,2,3,1,2,2,0,-2,0,2,0,6,-38,-1,8,7,7,0,0,1,1,1,1,5,1
KR_6749017080,420,2,3,-13,2,-2,1,3,3,5,2,0,6,6,0,5,5,1,2,1,0,1,-23,2,6,8,6,0,1,1,-1,1,1,4,1
KR_6756597021,420,3,56,2,4,3,4,1,2,4,2,0,1,1,2,6,4,-3,0,3,0,1,4,-2,7,5,-1,0,0,1,-1,1,-1,2,1
KR_6768631253,420,-3,-62,0,-3,-3,0,3,3,6,3,-2,1,3,-1,1,2,0,2,2,0,0,-5,-1,4,3,4,0,0,1,1,-1,1,5,1
KR_6770798736,420,5,110,36,7,3,3,0,4,4,0,1,2,1,0,4,4,-1,0,1,0,11,5,-1,4,3,-2,0,1,1,-1,1,1,1,1
KR_6775360273,420,4,180,4,12,1,1,0,1,4,3,3,5,2,6,7,1,1,2,1,0,10,-184,2,4,6,2,0,4,1,1,1,1,6,1
KR_6771046377,420,1,-58,-4,11,3,5,2,3,3,0,0,1,1,3,4,1,2,3,1,0,14,-80,4,5,9,4,0,1,1,1,1,1,4,1
KR_6733094377,420,2,68,13,12,0,1,1,3,6,3,1,2,1,7,7,0,1,1,0,1,24,-3,-4,11,7,11,0,3,1,-1,1,1,1,1
KR_6754379912,420,0,32,9,8,0,1,1,-2,1,3,2,3,1,7,7,0,1,1,0,0,10,12,1,4,5,0,0,1,1,1,1,1,5,1
KR_6763727373,440,-3,8,-31,-9,-8,0,8,-1,1,2,1,1,0,-1,1,2,0,0,0,0,-7,-15,2,7,9,-8,0,0,-1,1,-1,-1,5,1
KR_6741762267,420,-1,49,-44,2,-1,0,1,0,4,4,-2,2,4,3,4,1,2,2,0,0,5,-98,3,7,10,-5,0,-1,-1,1,-1,1,3,1
KR_6769555081,420,5,82,-4,13,4,6,2,2,3,1,1,2,1,3,6,3,3,3,0,0,9,3,4,4,8,-1,0,2,-1,1,1,1,3,1
KR_6770987356,420,3,35,23,7,4,6,2,1,2,1,2,3,1,0,1,1,0,0,0,0,3,23,-5,8,3,-1,0,2,0,1,1,-1,0,1
KR_6766043750,420,1,9,-36,13,-1,1,2,12,13,1,1,3,2,-5,0,5,6,6,0,1,27,0,-4,11,7,6,0,1,1,1,1,1,4,1
KR_6770668407,420,1,-32,-7,1,-3,2,5,-4,3,7,3,3,0,5,6,1,0,0,0,0,7,13,2,8,10,-3,0,0,1,-1,-1,1,1,1
KR_6777529695,420,2,8,-18,4,-3,0,3,-2,0,2,-1,2,3,11,12,1,-1,0,1,0,8,-121,3,7,10,2,0,-2,-1,-1,-1,1,4,1
KR_6775910189,420,3,31,-3,4,-1,1,2,3,5,2,-1,1,2,3,3,0,0,0,0,1,5,3,1,5,6,5,0,1,1,-1,1,1,4,1
KR_6771958682,420,-5,-48,-12,0,-3,0,3,-2,2,4,-1,1,2,6,6,0,0,1,1,0,7,-3,0,7,7,-3,0,-2,1,-1,-1,1,3,1
KR_6735485281,420,7,19,56,11,1,3,2,5,6,1,3,6,3,3,5,2,-1,0,1,0,8,-4,2,5,7,-1,0,2,1,1,1,1,5,1
KR_6738136028,420,2,50,11,8,-1,1,2,2,3,1,-2,3,5,6,6,0,3,4,1,0,13,-2,0,7,7,3,0,2,1,1,1,1,2,1
KR_6773580202,420,-1,8,16,-3,-1,1,2,0,3,3,-1,1,2,-1,2,3,0,0,0,0,-3,-7,-7,12,5,3,0,1,1,1,1,-1,3,1
KR_6721693869,420,1,-59,34,-4,2,2,0,1,4,3,-2,3,5,-4,0,4,-1,1,2,0,-12,-5,-5,10,5,0,0,0,-1,1,1,1,5,1
KR_6777772347,420,-1,-16,17,-1,1,3,2,4,5,1,-2,1,3,-2,0,2,-2,1,3,0,-3,3,2,5,7,-4,0,1,-1,1,1,-1,4,1
KR_6737388933,420,3,47,30,13,2,2,0,6,6,0,2,4,2,3,5,2,0,0,0,1,17,-32,0,5,5,8,0,0,1,-1,0,1,4,1
KR_6729961775,420,4,27,47,3,3,6,3,2,6,4,1,4,3,-2,3,5,-1,1,2,0,-9,-3,0,6,6,6,0,0,1,1,1,1,1,1
KR_6739598507,420,4,-11,33,6,-2,0,2,3,3,0,2,4,2,3,4,1,0,0,0,0,11,6,-3,6,3,-1,0,1,-1,-1,1,1,2,1
KR_6774122902,420,3,42,4,7,1,2,1,0,5,5,1,2,1,3,3,0,2,2,0,0,10,192,0,6,6,4,0,-1,1,-1,-1,-1,3,1
KR_6769106618,420,1,60,-4,2,3,4,1,3,5,2,-2,2,4,0,2,2,-2,0,2,0,1,7,2,4,6,-1,0,1,-1,1,1,1,3,1
KR_6755142381,420,-2,6,-17,-4,-2,0,2,3,5,2,-1,3,4,-3,1,4,-1,3,4,1,-7,-6,-2,9,7,-6,0,0,-1,-1,0,1,4,1
KR_6752250523,420,-1,5,13,-4,2,2,0,-3,2,5,-2,2,4,1,2,1,-2,0,2,0,-4,0,0,7,7,3,0,0,-1,1,0,-1,3,1
KR_6746242383,420,-1,47,-7,0,-1,0,1,-1,4,5,-1,1,2,3,7,4,0,2,2,0,-2,17,4,7,11,-11,0,1,-1,1,1,1,6,1
KR_6755736741,420,7,90,17,19,2,2,0,3,5,2,-1,1,2,12,13,1,3,3,0,0,22,16,4,6,10,3,0,3,1,-1,1,1,3,1
KR_6756951662,420,-1,-58,-17,-6,-5,0,5,1,2,1,-2,0,2,0,1,1,0,2,2,0,-5,-28,-1,7,6,1,0,-1,-1,1,-1,-1,4,1
KR_6776460989,420,3,18,-9,5,0,1,1,2,3,1,3,3,0,2,2,0,-2,0,2,0,3,-8,-4,8,4,7,0,0,1,-1,0,1,5,1
KR_6710646694,420,4,83,47,11,0,3,3,7,8,1,2,3,1,2,4,2,0,1,1,0,16,0,6,5,11,0,0,1,1,1,1,1,5,1
KR_6741435880,420,0,25,17,-3,1,2,1,-2,1,3,-2,1,3,2,3,1,-2,3,5,1,-13,3,-2,9,7,-3,0,-1,1,-1,-1,1,2,1
KR_6774105154,420,1,23,18,3,2,2,0,1,6,5,3,3,0,-3,0,3,0,0,0,0,4,-5,-1,8,7,10,0,0,-1,1,1,-1,5,1
KR_6774526018,420,2,39,-7,3,-1,2,3,5,6,1,-1,0,1,2,3,1,-2,0,2,0,3,-2,-3,8,5,0,0,1,1,1,1,1,6,1
KR_6711879757,420,4,58,-10,14,2,3,1,1,3,2,2,2,0,10,11,1,-1,1,2,0,19,-5,-3,8,5,4,0,2,1,-1,1,1,6,1
KR_6776180463,420,4,107,-7,14,1,3,2,6,8,2,1,2,1,6,9,3,0,1,1,1,13,-29,0,6,6,-2,0,3,1,1,1,1,6,1
KR_6747367864,420,6,28,51,9,2,2,0,6,6,0,-2,1,3,3,4,1,0,0,0,0,12,-3,3,3,6,-2,0,0,1,1,1,1,2,1
KR_6730382436,420,-1,-15,1,4,0,2,2,4,6,2,-3,0,3,6,7,1,-3,0,3,0,8,26,-2,8,6,-1,0,1,-1,1,1,1,4,1
KR_6775559917,420,-3,16,1,-7,-1,2,3,-1,6,7,-3,3,6,0,1,1,-2,0,2,0,-8,-1,2,6,8,2,0,-2,-1,-1,-1,-1,5,1
KR_6773489816,420,-1,-95,2,6,2,3,1,1,5,4,3,6,3,1,2,1,-1,0,1,0,11,1,0,10,10,2,0,-1,1,-1,-1,-1,3,1
KR_6712313013,420,2,44,8,5,-1,1,2,2,6,4,2,5,3,5,5,0,-3,0,3,0,-7,-10,-1,7,6,4,0,2,1,1,1,1,2,1
KR_6748797003,420,4,39,6,0,3,5,2,-4,2,6,3,5,2,-2,2,4,0,1,1,-1,-7,0,-2,7,5,5,0,1,1,-1,1,-1,1,1
KR_6774508591,420,-1,2,-8,-5,-3,0,3,-2,1,3,-3,0,3,3,4,1,0,0,0,0,-5,0,3,5,8,-2,0,1,1,1,1,-1,1,1
KR_6777309514,420,0,15,23,2,-1,0,1,-2,1,3,0,2,2,4,5,1,1,1,0,1,7,18,3,7,10,-2,0,0,1,-1,0,1,2,1
KR_6777088118,420,0,9,4,-3,2,4,2,-1,1,2,-4,3,7,-1,1,2,1,1,0,0,-5,6,3,4,7,0,0,-1,0,-1,-1,-1,0,1
KR_6777299043,420,1,41,48,10,4,6,2,1,3,2,4,6,2,-1,1,2,2,3,1,0,3,35,-2,7,5,-1,0,1,1,1,1,1,1,1
KR_6776614301,420,1,22,-11,4,2,3,1,4,5,1,0,3,3,0,3,3,-2,1,3,0,10,1,-2,4,2,3,0,1,1,1,1,1,5,1
KR_6775582557,420,1,33,-23,-1,0,3,3,-1,3,4,0,4,4,3,3,0,-3,0,3,0,-5,20,1,6,7,-1,0,0,-1,-1,0,1,5,1
KR_6701117036,420,1,9,31,8,2,2,0,3,3,0,2,2,0,-1,3,4,2,3,1,0,11,12,3,7,10,-5,0,0,1,1,1,1,6,1
KR_6771535068,440,7,102,19,13,4,4,0,-1,2,3,2,4,2,3,6,3,5,5,0,0,15,16,-3,5,2,7,0,3,1,1,1,1,3,1
KR_6686984261,420,-3,-22,-29,-1,0,0,0,-4,0,4,0,1,1,2,2,0,1,1,0,-1,2,1,2,11,13,-3,0,0,1,-1,0,-1,3,1
KR_6745217549,420,1,30,-13,0,1,4,3,-4,2,6,3,6,3,1,4,3,-1,0,1,0,7,3,2,5,7,0,0,0,1,-1,0,1,6,1
KR_6776996864,420,5,105,37,0,4,4,0,1,5,4,0,1,1,-4,2,6,-1,0,1,-2,-8,-2,-6,12,6,-5,0,2,-1,1,1,-1,1,1
KR_6777790856,420,4,53,41,11,1,2,1,5,6,1,3,4,1,-1,1,2,3,3,0,0,10,8,4,2,6,2,0,1,1,-1,1,1,1,1
KR_6726470980,420,2,-7,5,-3,1,2,1,2,3,1,-4,0,4,-2,2,4,0,1,1,0,1,0,0,5,5,3,0,0,-1,1,0,1,1,1
KR_6748102438,440,1,47,-36,0,6,6,0,-3,1,4,-2,2,4,-2,2,4,1,2,1,0,-7,7,-9,11,2,4,0,0,-1,1,1,-1,5,1
KR_6777801533,420,1,-22,1,-1,-3,0,3,1,2,1,-3,1,4,1,2,1,3,3,0,-1,2,10,3,6,9,-5,0,-1,1,-1,-1,-1,3,1
KR_6735533476,420,6,130,33,4,-2,0,2,3,3,0,1,1,0,3,3,0,-1,0,1,0,5,7,4,3,7,1,0,2,1,1,1,-1,4,1
KR_6739195455,420,-3,-9,-20,-3,2,4,2,-2,0,2,0,3,3,-3,1,4,0,1,1,1,-4,0,3,4,7,-2,0,0,-1,-1,-1,1,3,1
KR_6777744085,420,5,58,38,9,0,1,1,3,4,1,4,4,0,2,3,1,0,0,0,0,12,-46,-7,10,3,4,0,0,1,-1,1,1,5,1
KR_6756181123,420,0,-17,5,3,1,3,2,5,6,1,0,2,2,-3,1,4,0,2,2,0,6,-6,-1,7,6,5,0,1,-1,1,1,1,2,1
KR_6764723144,420,2,21,-4,5,4,6,2,3,4,1,-2,4,6,-1,1,2,1,1,0,0,-1,1,1,5,6,2,0,1,1,1,1,-1,4,1
KR_6763808885,420,1,-45,20,-2,-3,0,3,0,5,5,-2,2,4,2,2,0,1,1,0,0,-1,-4,-3,8,5,0,0,1,1,-1,-1,-1,3,1
KR_6768223813,420,2,40,-23,15,4,5,1,2,3,1,6,7,1,4,6,2,-1,0,1,2,17,-1,-3,11,8,1,0,2,-1,1,1,1,1,1
KR_6746611451,420,2,20,4,5,-5,0,5,6,6,0,-1,1,2,5,6,1,0,1,1,0,12,-4,3,7,10,1,0,1,1,-1,1,1,1,1
KR_6775660495,420,-3,2,-7,-4,0,1,1,2,3,1,-2,4,6,0,1,1,-4,1,5,0,-3,-118,3,5,8,-8,0,-2,1,-1,-1,1,6,1
KR_6768542217,420,1,1,-6,6,2,4,2,4,5,1,-2,2,4,2,5,3,0,1,1,0,7,2,0,7,7,-1,0,1,-1,1,1,-1,1,1
KR_6771210946,420,-1,17,-34,9,9,10,1,-3,2,5,-2,2,4,2,4,2,3,3,0,0,2,-17,-1,8,7,-1,0,2,1,1,1,1,1,1
KR_6737117094,420,9,117,79,14,7,7,0,2,3,1,2,4,2,3,3,0,0,1,1,1,9,6,-2,5,3,0,0,4,1,1,1,1,4,1
KR_6771288093,420,3,21,24,0,-4,2,6,5,8,3,6,6,0,-9,2,11,2,2,0,0,-1,-5,-2,7,5,1,0,0,1,-1,-1,-1,4,1
KR_6776622924,420,0,-21,-25,-1,-4,2,6,-5,1,6,5,5,0,4,7,3,-1,0,1,0,2,7,2,5,7,2,0,-1,-1,-1,-1,-1,3,1
KR_6777838050,420,0,-43,-2,-1,-1,3,4,1,2,1,6,7,1,-5,3,8,-2,1,3,1,12,9,-1,7,6,-1,0,1,1,1,1,1,2,1
KR_6738481924,440,4,12,20,2,-4,0,4,-1,1,2,3,3,0,4,5,1,0,1,1,0,2,6,4,5,9,-6,0,2,1,1,1,1,4,1
KR_6752478151,420,2,-4,12,3,2,4,2,2,4,2,-1,0,1,0,3,3,0,1,1,0,4,0,-2,9,7,-4,0,-1,1,-1,-1,-1,3,1
KR_6764989568,420,4,-3,-4,5,-2,0,2,-1,3,4,5,5,0,3,5,2,0,0,0,-1,11,-5,2,5,7,7,0,-1,1,-1,-1,-1,1,1
KR_6706378735,420,0,43,8,2,1,6,5,1,1,0,-2,0,2,2,3,1,0,1,1,2,5,-1,-5,11,6,-1,0,0,1,-1,-1,1,5,1
KR_6770761559,420,2,-48,2,8,2,2,0,3,5,2,3,3,0,-1,1,2,1,1,0,0,9,2,3,5,8,2,0,1,1,-1,1,1,3,1
KR_6709252223,420,0,-27,0,-3,0,3,3,0,2,2,3,4,1,-2,3,5,-4,0,4,-1,-2,2,5,3,8,-5,0,-2,1,1,-1,-1,6,1
KR_6707788749,420,3,24,-13,3,3,5,2,7,9,2,-3,2,5,-4,1,5,0,2,2,1,0,44,-2,8,6,-5,0,1,-1,1,1,1,2,1
KR_6766098338,420,-1,2,15,-5,0,0,0,-1,1,2,-5,2,7,2,3,1,-1,0,1,0,-7,-70,-8,15,7,8,0,0,1,-1,-1,-1,2,1
KR_6773926489,420,2,31,-8,7,6,6,0,1,1,0,-1,0,1,1,2,1,0,1,1,0,1,122,9,2,11,-7,0,-1,-1,1,1,1,6,1
KR_6756454265,420,3,17,19,9,-1,0,1,3,3,0,8,9,1,0,2,2,-1,0,1,0,11,-4,4,4,8,6,0,-2,1,-1,-1,1,1,1
KR_6777747659,440,-1,35,0,1,5,5,0,-1,1,2,-1,0,1,-3,1,4,1,2,1,0,1,-29,-1,3,2,-1,0,1,1,-1,1,1,5,1
KR_6752390536,420,-3,44,-28,-2,4,5,1,1,3,2,1,2,1,-3,2,5,-5,1,6,-2,-6,2,-4,8,4,-6,0,-1,-1,1,1,-1,5,1
KR_6766796353,420,-2,-38,21,-5,-3,0,3,-1,1,2,-3,1,4,3,5,2,-1,1,2,-2,1,-2,-3,8,5,4,0,0,0,-1,-1,-1,0,1
KR_6755423587,420,-1,-46,3,-2,-2,2,4,-1,0,1,2,2,0,-1,3,4,0,1,1,0,-3,42,2,5,7,-7,0,0,1,-1,0,-1,5,1
KR_6776529319,420,7,108,25,12,-1,2,3,5,5,0,4,6,2,2,4,2,2,2,0,0,15,7,5,4,9,-1,0,3,1,-1,1,1,3,1
KR_6764598452,420,-1,32,-34,0,1,3,2,6,8,2,-5,0,5,-2,3,5,0,0,0,0,5,-130,-2,9,7,4,0,1,-1,1,1,-1,2,1
KR_6763705295,420,1,-68,22,0,-4,0,4,4,7,3,1,3,2,-3,2,5,2,2,0,0,13,39,-2,11,9,7,0,-1,1,-1,-1,-1,5,1
KR_6760432785,420,1,19,7,2,-1,1,2,1,4,3,0,3,3,2,3,1,0,2,2,1,1,1,0,6,6,2,0,0,-1,1,0,1,6,1
KR_6769127582,420,5,64,30,16,5,6,1,1,4,3,5,5,0,2,5,3,3,4,1,2,23,11,3,4,7,2,0,1,1,1,1,1,5,1
KR_6776983897,420,-2,-27,-8,-10,-6,0,6,-4,2,6,-1,4,5,2,3,1,-1,0,1,1,-8,-1,0,4,4,0,0,-1,-1,-1,-1,1,4,1
KR_6766007020,420,2,41,30,0,-1,0,1,0,2,2,-1,0,1,0,8,8,2,3,1,0,-13,-2,-6,9,3,2,0,0,1,-1,1,1,6,1
KR_6749782605,420,7,50,21,15,2,2,0,5,5,0,6,6,0,1,5,4,1,1,0,1,15,-14,4,2,6,-1,0,1,1,1,1,1,6,1
KR_6718796869,440,1,-23,24,1,3,5,2,4,5,1,-4,2,6,-2,1,3,0,0,0,0,1,7,5,0,5,-1,0,1,1,1,1,1,6,1
KR_6775169645,420,0,44,-9,1,0,2,2,3,3,0,-1,4,5,-1,3,4,0,1,1,0,0,72,5,6,11,3,0,2,1,-1,1,1,6,1
KR_6776208456,420,2,-17,26,9,0,0,0,4,4,0,4,5,1,2,6,4,-1,0,1,0,20,-27,-3,10,7,1,0,1,0,1,1,1,0,1
KR_6739767950,420,0,15,-6,7,1,2,1,4,7,3,4,6,2,-3,2,5,1,1,0,0,6,5,2,2,4,0,0,0,-1,-1,0,-1,2,1
KR_6771475364,420,4,37,5,8,-2,1,3,1,4,3,4,6,2,5,8,3,0,0,0,1,7,10,4,4,8,-5,0,1,1,-1,1,1,4,1
KR_6729720628,440,0,-47,19,-2,-4,1,5,0,1,1,-3,0,3,2,5,3,3,3,0,-2,-8,-7,1,3,4,4,0,1,1,1,1,-1,2,1
KR_6775775365,420,3,62,2,3,-3,1,4,3,4,1,4,5,1,0,7,7,-1,1,2,-1,-2,5,-3,8,5,-4,0,0,1,-1,0,-1,5,1
KR_6766932120,420,2,33,32,8,-3,0,3,1,3,2,4,4,0,4,4,0,2,3,1,0,13,9,-3,5,2,3,0,2,-1,1,1,1,5,1
KR_6740479831,420,-1,-18,-33,-2,0,3,3,3,5,2,-1,5,6,0,3,3,-4,1,5,-2,-2,-3,4,3,7,-5,0,0,1,1,1,-1,1,1
KR_6758868612,420,-2,-31,-14,-1,4,4,0,-2,3,5,0,2,2,-4,2,6,1,1,0,-1,-7,4,4,5,9,2,0,-1,-1,-1,-1,-1,2,1
KR_6735011288,420,-2,-37,-11,0,-2,0,2,7,7,0,-4,1,5,4,8,4,-5,0,5,0,6,19,-7,10,3,5,0,0,-1,1,0,-1,4,1
KR_6774571713,420,1,39,12,5,1,2,1,0,3,3,1,3,2,3,4,1,0,0,0,0,10,-3,-1,6,5,6,0,0,-1,-1,0,1,4,1
KR_6766463215,420,2,45,12,4,3,4,1,-3,2,5,2,4,2,1,1,0,1,1,0,0,0,25,1,7,8,-4,0,2,-1,1,1,1,2,1
KR_6743643318,420,2,40,-41,6,3,3,0,0,3,3,3,5,2,1,5,4,-1,1,2,0,3,4,5,5,10,0,0,0,-1,-1,1,1,6,1
KR_6686557967,420,2,-21,-6,14,1,2,1,7,7,0,2,2,0,2,4,2,2,2,0,1,22,2,2,6,8,-1,0,1,1,1,1,1,1,1
KR_6774282164,420,4,15,-17,5,0,0,0,5,5,0,0,2,2,-4,1,5,4,5,1,0,7,-2,-2,11,9,4,0,0,-1,-1,0,-1,4,1
KR_6756751720,420,4,15,-21,6,0,1,1,3,4,1,0,1,1,1,3,2,2,2,0,0,13,18,2,6,8,1,0,0,1,-1,1,1,3,1
KR_6739703431,420,8,100,8,14,1,3,2,3,4,1,8,8,0,2,3,1,0,0,0,1,17,288,2,2,4,-4,0,0,1,1,1,1,4,1
KR_6750273644,440,3,25,24,6,3,3,0,0,0,0,1,2,1,2,5,3,0,1,1,0,4,-8,-1,7,6,2,0,1,1,1,1,1,2,1
KR_6765981228,420,2,19,18,9,0,1,1,0,3,3,4,5,1,5,5,0,0,0,0,0,18,-14,-1,7,6,0,0,0,-1,-1,0,1,3,1
KR_6743334554,420,4,38,37,11,-1,4,5,2,3,1,-1,4,5,5,6,1,6,7,1,1,23,7,-6,11,5,-4,0,1,1,1,1,1,6,1
KR_6749814899,420,0,2,24,6,-2,0,2,0,1,1,0,1,1,3,3,0,5,5,0,0,8,-27,-6,10,4,1,0,2,1,1,1,-1,4,1
KR_6776775957,420,2,52,-33,12,6,6,0,0,1,1,3,5,2,2,2,0,1,1,0,0,5,-2,1,5,6,6,0,1,-1,1,1,1,6,1
KR_6718584751,420,1,23,19,5,-1,0,1,2,4,2,-2,0,2,3,4,1,3,3,0,0,11,-1,4,3,7,4,0,2,1,1,1,1,4,1
KR_6776942511,420,2,26,-7,10,-2,1,3,4,5,1,-2,0,2,9,9,0,1,1,0,1,19,43,7,2,9,-12,0,1,1,-1,1,1,2,1
KR_6774880561,420,3,59,-10,7,6,6,0,2,4,2,3,5,2,-2,0,2,-2,1,3,1,2,3,0,5,5,1,0,1,-1,-1,1,1,6,1
KR_6727647590,420,4,10,11,7,0,3,3,1,5,4,-1,1,2,5,6,1,2,2,0,0,10,7,2,5,7,5,0,1,1,-1,-1,1,1,1
KR_6761948814,420,1,12,-5,9,2,3,1,-1,3,4,3,4,1,5,6,1,0,1,1,1,13,3,-1,8,7,1,0,0,1,-1,0,1,1,1
KR_6709774328,420,0,-20,-5,3,1,2,1,6,9,3,1,4,3,-4,1,5,-1,0,1,0,6,11,1,5,6,-6,0,0,-1,1,0,1,6,1
KR_6738116235,420,-4,-4,8,-6,-1,1,2,-4,3,7,2,5,3,-2,1,3,-1,0,1,-1,-11,-3,3,6,9,-1,0,0,1,-1,0,1,2,1
KR_6768227013,420,7,43,32,15,2,2,0,4,5,1,5,7,2,3,5,2,1,2,1,0,23,4,3,3,6,2,0,0,1,1,1,1,5,1
KR_6743355946,440,2,-11,9,9,0,0,0,5,7,2,1,1,0,3,4,1,0,0,0,0,13,27,5,3,8,-9,0,0,1,1,-1,1,4,1
KR_6776667269,420,-3,14,-16,-3,-3,0,3,1,4,3,1,3,2,-3,4,7,1,1,0,1,-4,9,-2,8,6,-10,0,-1,1,-1,-1,1,2,1
KR_6771569744,420,2,12,-1,15,7,9,2,3,7,4,1,2,1,5,6,1,-1,0,1,0,5,-36,1,4,5,20,0,2,1,1,1,1,5,1
KR_6764442304,420,3,-37,49,7,3,5,2,2,3,1,0,0,0,-1,3,4,3,3,0,0,11,42,4,5,9,-3,0,0,-1,1,0,-1,6,1
KR_6754306054,420,1,25,-24,14,3,4,1,-1,2,3,3,4,1,9,10,1,0,1,1,0,18,4,7,2,9,-1,0,1,-1,1,1,1,1,1
KR_6764526059,420,-3,25,-5,-3,-3,1,4,-1,1,2,-2,1,3,4,4,0,-1,0,1,0,-4,-8,-1,8,7,5,0,1,-1,-1,1,1,3,1
KR_6744291920,420,2,-6,-24,4,-2,1,3,7,9,2,-2,4,6,2,5,3,-1,1,2,1,6,18,0,6,6,-2,0,1,0,1,1,1,0,1
KR_6686624380,420,4,26,31,16,6,6,0,3,4,1,7,7,0,-5,1,6,5,6,1,-1,16,8,3,5,8,0,0,2,0,-1,1,-1,0,1
KR_6746705388,440,2,-1,-24,4,2,4,2,-1,1,2,2,4,2,2,4,2,-1,2,3,0,9,-5,0,4,4,1,0,0,0,1,1,-1,0,1
KR_6777108182,420,0,-22,-1,1,1,3,2,5,5,0,4,5,1,-8,1,9,-1,0,1,0,1,6,1,4,5,0,0,1,1,1,1,1,2,1
KR_6769149774,420,-2,-58,30,2,-1,1,2,0,5,5,0,1,1,1,1,0,2,2,0,0,6,-37,-3,9,6,0,0,-1,1,-1,-1,1,5,1
KR_6775554336,420,4,58,2,18,7,8,1,6,6,0,-3,2,5,5,5,0,3,3,0,0,22,-6,3,5,8,1,0,2,1,1,1,1,3,1
KR_6716517116,420,2,45,22,0,-1,0,1,2,4,2,3,5,2,-4,0,4,0,1,1,0,-6,7,1,6,7,-5,0,1,-1,1,1,-1,2,1
KR_6770830216,420,2,71,3,-3,-2,2,4,2,3,1,-3,1,4,0,1,1,0,4,4,0,-6,-1,-1,7,6,2,0,0,1,-1,1,-1,2,1
KR_6692812174,420,2,67,-7,6,5,5,0,1,4,3,-1,2,3,2,6,4,-1,0,1,0,7,-8,-2,10,8,10,0,1,1,1,1,1,1,1
KR_6775964846,420,-1,-15,10,-3,-1,1,2,-4,2,6,-2,2,4,4,4,0,0,0,0,0,-10,-1,-1,6,5,0,0,-3,-1,1,-1,1,4,1
KR_6769081514,420,0,2,36,-2,-5,0,5,5,7,2,-5,1,6,1,2,1,2,2,0,0,0,-27,-5,9,4,1,0,2,-1,1,1,-1,6,1
KR_6771934864,420,3,102,8,5,-2,0,2,5,6,1,2,3,1,-1,0,1,1,2,1,0,8,17,7,3,10,-4,0,2,1,1,1,1,4,1
KR_6714933041,420,1,29,-28,7,2,2,0,1,6,5,4,4,0,-1,5,6,1,1,0,0,6,5,3,4,7,1,0,0,-1,1,-1,1,6,1
KR_6772080769,420,0,60,-23,6,6,7,1,-1,3,4,1,2,1,3,3,0,-3,0,3,0,5,5,3,4,7,0,0,1,-1,1,1,1,5,1
KR_6753862634,420,2,44,-1,11,-1,1,2,9,11,2,-2,3,5,2,2,0,3,4,1,0,19,-26,1,4,5,-4,0,1,1,1,1,1,2,1
KR_6711170966,420,1,2,-14,7,3,4,1,-2,2,4,4,8,4,1,4,3,1,1,0,1,-5,3,1,8,9,-7,0,1,1,-1,1,1,6,1
KR_6769178307,420,-1,19,20,-7,-4,0,4,-4,2,6,3,8,5,-1,0,1,-1,0,1,0,-14,41,-1,8,7,-28,0,2,-1,1,1,-1,3,1
KR_6750859183,420,-2,-37,-16,1,4,6,2,-1,2,3,-2,1,3,0,2,2,0,0,0,-1,7,18,2,4,6,-5,0,2,1,1,1,-1,6,1
KR_6757703381,420,6,3,20,15,1,2,1,5,6,1,3,6,3,2,2,0,4,4,0,0,10,24,-2,7,5,-3,0,3,1,1,1,1,6,1
KR_6741587641,420,-1,41,-11,1,1,1,0,-1,1,2,-1,1,2,2,3,1,0,2,2,-1,5,3,-1,5,4,3,0,2,1,1,1,-1,2,1
KR_6742799609,420,5,112,8,8,4,4,0,3,5,2,-1,2,3,2,2,0,0,1,1,2,14,10,-3,10,7,0,0,2,1,-1,1,1,1,1
KR_6758869788,440,0,10,5,-2,-1,1,2,-1,2,3,1,1,0,0,1,1,-1,1,2,0,-8,6,3,3,6,-8,0,-1,1,1,-1,1,2,1
KR_6747232293,420,4,33,57,10,5,5,0,4,6,2,0,1,1,1,2,1,0,0,0,0,7,135,-1,6,5,2,0,1,1,1,1,-1,2,1
KR_6706892806,420,0,-26,9,-5,-3,1,4,2,5,3,0,2,2,0,2,2,-4,0,4,0,-2,22,-2,3,1,-9,0,-2,1,-1,-1,-1,2,1
KR_6774104906,440,0,-17,25,2,1,1,0,-4,4,8,-1,4,5,4,5,1,2,6,4,0,-2,-2,3,3,6,-2,0,0,1,0,-1,-1,4,1
KR_6736592880,420,3,38,-1,4,-1,4,5,-1,4,5,7,7,0,-1,4,5,0,1,1,1,-1,-2,-1,6,5,3,0,1,-1,-1,1,1,2,1
KR_6777863980,420,2,29,19,6,2,2,0,2,2,0,3,3,0,0,2,2,-1,0,1,0,8,-7,0,6,6,4,0,0,1,0,0,1,4,1
KR_6750703410,420,1,-55,29,-3,-2,1,3,-3,2,5,2,4,2,2,4,2,-2,0,2,-1,-4,7,-2,8,6,-7,0,0,-1,1,-1,-1,5,1
KR_6742650122,440,0,-17,-44,-1,-6,2,8,-2,2,4,5,10,5,1,3,2,1,1,0,-1,11,-10,-2,6,4,2,0,1,-1,1,-1,1,6,1
KR_6761984082,420,-1,31,-45,3,-1,0,1,-1,2,3,3,4,1,0,3,3,2,3,1,0,-1,0,0,6,6,7,0,1,1,-1,1,1,6,1
KR_6741210686,420,0,15,12,6,3,4,1,1,4,3,1,3,2,0,3,3,1,1,0,1,4,15,0,6,6,7,0,0,1,-1,0,1,4,1
KR_6744674363,420,4,27,4,13,3,3,0,7,10,3,1,3,2,-1,2,3,3,3,0,0,13,-37,-2,8,6,9,0,1,-1,1,1,1,5,1
KR_6760945519,420,-3,71,-11,-3,-3,1,4,-1,1,2,0,6,6,1,2,1,0,1,1,0,1,1,1,5,6,3,0,0,1,1,0,1,4,1
KR_6734759575,420,1,-10,-9,7,1,1,0,6,7,1,0,1,1,0,3,3,0,0,0,0,9,5,4,7,11,-7,0,0,-1,1,0,-1,1,1
KR_6769547920,440,-1,52,2,2,3,6,3,2,3,1,0,2,2,-3,1,4,0,0,0,1,-3,-4,2,3,5,-1,0,0,1,1,-1,1,3,1
KR_6777871020,420,4,30,-14,4,-1,3,4,2,3,1,1,4,3,0,2,2,2,2,0,0,12,-122,-4,12,8,4,0,1,-1,-1,1,-1,5,1
KR_6774336654,420,3,45,-4,7,2,3,1,0,0,0,2,3,1,-2,3,5,5,6,1,0,7,8,4,2,6,-1,0,1,1,-1,1,1,3,1
KR_6763701370,420,2,21,10,6,-2,1,3,0,4,4,4,4,0,2,3,1,2,3,1,0,9,-4,-3,10,7,2,0,-1,-1,1,-1,1,3,1
KR_6774465822,420,-1,31,20,1,-1,2,3,3,5,2,0,1,1,0,2,2,-1,1,2,0,0,9,2,5,7,0,0,-1,-1,-1,-1,-1,1,1
KR_6735809719,420,-1,-22,8,7,1,2,1,7,8,1,4,4,0,-3,6,9,-2,1,3,0,3,17,1,4,5,-5,0,0,-1,1,1,1,2,1
KR_6777203945,420,3,8,-4,10,2,4,2,0,5,5,4,5,1,4,5,1,0,0,0,0,9,6,7,5,12,0,0,1,0,1,1,-1,0,1
KR_6762844135,440,6,70,-5,13,4,5,1,0,2,2,2,3,1,5,9,4,2,2,0,0,16,4,2,5,7,0,0,1,0,0,1,1,0,1
KR_6761993955,420,-2,-33,13,-2,-3,0,3,2,6,4,1,4,3,-2,1,3,0,1,1,0,-2,74,-3,9,6,-5,0,-2,-1,1,1,1,3,1
KR_6777397109,420,0,16,-4,1,2,3,1,0,0,0,2,2,0,-4,2,6,1,1,0,0,1,-35,0,6,6,13,0,-1,-1,1,-1,-1,1,1
KR_6753211792,420,1,17,16,2,-4,0,4,2,2,0,3,9,6,1,5,4,0,1,1,0,8,16,2,4,6,-1,0,2,-1,1,1,-1,6,1
KR_6776392078,420,3,-2,-8,7,-1,1,2,2,3,1,3,3,0,3,6,3,0,1,1,0,16,-6,4,5,9,-2,0,0,1,-1,0,-1,6,1
KR_6738183271,420,5,111,6,13,7,8,1,3,5,2,1,4,3,3,5,2,-1,0,1,1,11,5,1,6,7,1,0,1,1,-1,1,1,5,1
KR_6764104491,420,7,72,14,15,2,2,0,6,6,0,4,4,0,1,5,4,2,6,4,0,11,-22,-3,8,5,-3,0,2,1,1,1,1,1,1
KR_6760614586,420,4,6,11,18,3,4,1,8,9,1,3,3,0,3,4,1,1,1,0,1,28,19,3,11,14,0,0,2,1,1,1,1,2,1
KR_6765914258,420,2,6,24,7,0,1,1,1,5,4,2,3,1,5,5,0,-1,0,1,0,14,5,0,5,5,9,0,-1,1,-1,-1,-1,6,1
KR_6705716224,440,3,-3,-16,6,0,0,0,4,6,2,-2,3,5,1,6,5,3,3,0,0,4,14,2,3,5,-2,0,1,1,-1,-1,1,1,1
KR_6747981337,420,1,-50,18,-1,8,8,0,-9,3,12,1,3,2,-3,1,4,2,2,0,-1,-8,34,0,7,7,1,0,1,-1,1,-1,-1,3,1
KR_6775519415,420,1,14,0,4,-2,0,2,1,2,1,1,3,2,2,3,1,2,2,0,0,-2,-4,-3,6,3,5,0,0,-1,1,1,1,5,1
KR_6776666227,420,4,-1,26,9,2,3,1,5,5,0,3,7,4,-1,0,1,0,0,0,0,5,5,2,4,6,0,0,0,1,1,0,1,1,1
KR_6724239958,420,3,54,10,6,0,0,0,4,5,1,0,2,2,0,3,3,2,3,1,0,10,-74,2,4,6,0,0,1,1,1,1,1,4,1
KR_6774560405,420,1,7,11,4,0,1,1,0,1,1,0,1,1,6,8,2,-2,0,2,0,6,-4,-3,9,6,11,0,0,-1,-1,1,1,5,1
KR_6775062287,440,2,-7,-38,3,2,2,0,0,0,0,1,4,3,0,1,1,0,0,0,0,8,-2,1,5,6,-3,0,0,-1,-1,0,-1,1,1
KR_6743608883,420,0,20,20,-1,0,1,1,3,4,1,-5,0,5,0,2,2,1,2,1,0,-9,24,5,5,10,0,0,1,-1,1,1,1,1,1
KR_6776594261,420,-3,-67,-11,0,-1,3,4,0,2,2,1,4,3,-1,0,1,1,1,0,0,2,30,-2,8,6,-5,0,0,-1,1,0,1,3,1
KR_6750736624,420,1,9,15,1,1,2,1,-1,3,4,3,3,0,-2,2,4,0,1,1,1,-1,-2,5,4,9,0,0,0,1,1,1,1,3,1
KR_6761566333,420,5,90,25,19,3,4,1,8,10,2,0,3,3,4,7,3,4,4,0,1,20,3,-3,9,6,2,0,2,1,1,1,1,5,1
KR_6723155362,420,-2,-3,-4,1,1,2,1,2,5,3,4,6,2,-7,0,7,1,1,0,0,-3,5,-1,5,4,-4,0,1,1,1,1,1,2,1
KR_6731564391,420,2,49,16,7,-3,2,5,6,7,1,0,2,2,0,3,3,4,4,0,0,10,-2,-3,10,7,5,0,1,1,1,1,1,1,1
KR_6721213167,420,4,48,6,4,3,4,1,-1,1,2,-1,1,2,4,5,1,-1,1,2,1,3,43,4,5,9,-24,0,3,1,-1,1,1,5,1
KR_6726103190,420,3,44,-2,3,-1,1,2,-2,1,3,0,4,4,7,10,3,-1,1,2,-1,-4,15,5,3,8,1,0,0,1,-1,1,-1,4,1
KR_6750279353,420,5,130,30,3,4,4,0,1,2,1,0,2,2,-2,1,3,0,4,4,0,-6,-3,-1,6,5,2,0,1,-1,1,1,-1,4,1
KR_6741668400,420,-1,14,21,6,-2,1,3,3,4,1,3,6,3,0,1,1,2,3,1,0,12,-5,2,4,6,8,0,2,-1,1,1,1,2,1
KR_6772622639,440,0,27,12,0,0,5,5,1,2,1,2,3,1,0,1,1,-3,0,3,0,-1,-3,0,3,3,-4,0,0,1,-1,0,-1,6,1
KR_6773389132,420,1,12,2,1,-1,1,2,-2,1,3,1,2,1,4,6,2,-1,0,1,0,-4,3,1,5,6,-4,0,2,1,-1,1,1,2,1
KR_6727829709,420,0,-55,16,3,1,2,1,-1,3,4,-2,0,2,4,6,2,1,1,0,0,11,71,4,5,9,-4,0,1,1,-1,1,1,4,1
KR_6733223322,420,4,55,11,11,4,6,2,2,4,2,2,5,3,-3,2,5,6,7,1,2,12,-39,-2,6,4,7,0,1,1,1,1,1,1,1
KR_6752842418,420,1,6,-23,3,1,3,2,1,4,3,5,5,0,-4,2,6,0,2,2,-1,10,-53,2,7,9,19,0,-1,-1,-1,-1,-1,6,1
KR_6775316825,420,-2,8,-8,0,1,3,2,-2,1,3,1,3,2,0,3,3,0,2,2,0,2,-19,3,5,8,-3,0,1,1,-1,-1,-1,6,1
KR_6770889133,420,0,38,-4,3,0,2,2,3,5,2,-1,1,2,0,4,4,1,1,0,0,9,-1,-1,5,4,3,0,1,1,-1,1,1,2,1
KR_6764776993,420,-1,-4,12,-7,0,2,2,2,5,3,-2,0,2,-6,0,6,-1,0,1,0,-10,10,-3,7,4,0,0,0,-1,1,-1,-1,3,1
KR_6707220584,420,7,0,4,15,7,8,1,-2,1,3,2,4,2,8,11,3,0,1,1,0,9,9,3,2,5,1,0,2,1,1,1,1,3,1
KR_6771805598,420,0,52,16,-3,2,4,2,-5,3,8,2,5,3,1,4,3,-3,0,3,0,-8,-5,-5,7,2,2,0,-1,-1,-1,-1,-1,6,1
KR_6774159795,420,2,31,-2,5,2,3,1,-1,1,2,0,2,2,3,3,0,1,1,0,0,1,3,-2,8,6,-1,0,-1,1,1,-1,-1,3,1
KR_6776825079,420,2,-23,-1,5,3,5,2,3,5,2,-4,1,5,-2,3,5,5,5,0,-1,9,6,3,4,7,0,0,1,1,-1,1,-1,4,1
KR_6775419104,420,0,-15,-5,-2,-2,0,2,6,9,3,-3,0,3,2,2,0,-5,0,5,0,7,-1,1,7,8,0,0,-1,1,-1,-1,1,2,1
KR_6773706510,420,2,24,7,10,3,4,1,5,8,3,1,5,4,3,6,3,-2,1,3,2,5,-1,5,4,9,-3,0,-1,1,1,-1,1,2,1
KR_6775963762,420,2,15,8,10,0,1,1,6,10,4,2,5,3,-2,0,2,4,5,1,0,4,-2,-3,8,5,1,0,1,0,1,1,1,0,1
KR_6777619482,440,4,95,16,3,0,2,2,-6,1,7,4,7,3,4,6,2,1,2,1,-1,-6,4,3,2,5,-1,0,2,1,-1,1,-1,4,1
KR_6746711024,420,2,51,37,4,2,5,3,-2,3,5,0,0,0,4,4,0,0,0,0,0,4,7,-1,4,3,-5,0,1,1,1,1,1,6,1
KR_6775924497,420,1,-34,-6,2,-3,0,3,4,4,0,0,1,1,2,5,3,-1,0,1,0,6,4,4,7,11,2,0,0,-1,1,1,1,4,1
KR_6733588196,440,5,41,-12,9,3,5,2,0,2,2,3,5,2,2,2,0,1,1,0,0,10,-4,-4,7,3,6,0,1,0,0,1,1,0,1
KR_6710402716,420,-2,-39,17,1,-2,1,3,-6,2,8,-2,0,2,8,8,0,3,3,0,2,3,-11,-4,11,7,9,0,1,-1,1,1,1,4,1
KR_6771856486,440,9,31,-2,22,4,4,0,0,3,3,3,3,0,16,17,1,-1,1,2,-2,28,-13,5,1,6,-6,0,2,1,1,1,-1,6,1
KR_6764127706,420,3,8,59,7,4,4,0,-4,3,7,6,6,0,1,1,0,0,2,2,1,3,3,0,6,6,1,0,0,1,-1,1,1,4,1
KR_6773570146,420,5,98,36,8,2,3,1,3,4,1,0,3,3,0,2,2,3,3,0,0,4,0,3,7,10,-3,0,1,1,1,1,1,5,1
KR_6777492282,420,1,22,29,2,-2,0,2,2,5,3,1,4,3,1,3,2,0,0,0,0,7,-9,0,8,8,3,0,2,1,1,1,-1,3,1
KR_6684801937,420,0,-10,-39,1,0,1,1,2,3,1,-2,1,3,-1,0,1,2,2,0,0,0,5,-4,8,4,-2,0,1,1,-1,1,1,4,1
KR_6720812421,420,-4,-18,-24,-7,-1,1,2,7,8,1,-4,0,4,-8,0,8,-1,0,1,-1,-7,9,1,8,9,-10,0,0,-1,1,0,-1,4,1
KR_6745792483,420,4,-10,47,4,1,3,2,1,3,2,2,5,3,1,1,0,-1,0,1,0,-3,-23,-1,10,9,1,0,0,-1,1,-1,-1,1,1
KR_6772276009,420,-1,-5,9,5,0,1,1,0,4,4,3,6,3,2,2,0,0,0,0,0,9,-8,-2,8,6,2,0,0,-1,-1,1,1,3,1
KR_6770707154,420,3,33,18,10,6,6,0,-1,3,4,-1,1,2,6,7,1,0,2,2,0,4,-2,3,2,5,2,0,1,1,-1,1,1,3,1
KR_6775924657,420,1,33,12,-3,3,4,1,-2,2,4,2,2,0,-7,1,8,1,2,1,0,-8,0,2,3,5,0,0,1,-1,1,1,1,2,1
KR_6706761748,420,-1,0,-23,-4,-4,0,4,1,6,5,0,3,3,-2,3,5,1,4,3,-1,5,19,1,8,9,-2,0,-1,-1,-1,1,1,4,1
KR_6731316612,420,-1,-21,21,1,0,1,1,-2,0,2,0,2,2,3,3,0,0,0,0,0,2,5,5,7,12,-2,0,0,1,-1,-1,-1,4,1
KR_6707764405,420,3,91,-8,4,3,3,0,-2,1,3,0,1,1,1,1,0,2,2,0,0,5,4,-2,8,6,-1,0,0,0,-1,1,-1,0,1
KR_6777187849,420,-2,0,-13,-8,0,1,1,-4,4,8,-1,1,2,-5,0,5,2,2,0,0,-2,-4,-1,6,5,13,0,0,1,-1,-1,1,5,1
KR_6772515951,440,2,-17,12,5,-1,1,2,3,4,1,0,5,5,0,1,1,3,5,2,0,9,-3,-2,5,3,3,0,0,-1,-1,0,1,5,1
KR_6766154067,420,0,-1,8,4,2,3,1,2,4,2,0,4,4,0,3,3,0,1,1,0,4,2,4,6,10,-3,0,0,-1,-1,-1,-1,6,1
KR_6774903710,420,0,-37,0,4,3,3,0,5,6,1,2,5,3,-4,4,8,-2,0,2,1,17,0,1,8,9,-7,0,0,1,1,0,1,5,1
KR_6739692250,420,3,36,2,-3,-7,0,7,5,8,3,-3,0,3,1,3,2,1,3,2,0,-1,7,1,5,6,-5,0,1,1,-1,1,-1,1,1
KR_6709591751,420,3,57,10,7,3,4,1,2,3,1,3,3,0,-1,4,5,0,2,2,0,9,5,2,5,7,-2,0,2,1,1,1,1,4,1
KR_6748469813,420,-1,17,-7,0,2,2,0,-3,0,3,0,4,4,1,2,1,0,0,0,0,-4,64,-4,10,6,-3,0,-1,1,-1,-1,1,3,1
KR_6753198770,420,-1,-25,-6,3,0,3,3,-3,1,4,3,3,0,4,10,6,-1,2,3,1,0,0,3,7,10,5,0,0,-1,1,0,1,2,1
KR_6773715639,420,3,64,6,1,4,4,0,2,2,0,-4,0,4,1,2,1,-2,2,4,0,-2,8,4,9,13,7,0,0,-1,-1,-1,1,5,1
KR_6776616571,420,1,1,6,0,0,2,2,-1,0,1,2,2,0,-1,0,1,0,0,0,0,-3,1,2,5,7,1,0,-3,1,-1,-1,1,2,1
KR_6768659784,420,1,-6,6,-5,0,2,2,-5,2,7,-1,3,4,0,3,3,1,2,1,-1,0,-11,-5,10,5,4,0,0,1,-1,-1,1,5,1
KR_6742805643,420,2,28,16,8,1,1,0,3,4,1,2,2,0,3,4,1,-1,0,1,0,5,-5,3,5,8,0,0,1,1,1,1,-1,6,1
KR_6734581477,420,0,-27,7,3,1,2,1,-4,1,5,6,7,1,-3,1,4,3,3,0,0,-7,-4,-1,5,4,2,0,0,1,1,0,1,6,1
KR_6739823116,420,2,-10,-16,10,5,5,0,1,2,1,0,1,1,3,4,1,1,1,0,0,10,3,7,1,8,-4,0,2,1,1,1,-1,6,1
KR_6770706874,420,5,73,26,9,2,3,1,4,5,1,0,4,4,1,2,1,2,2,0,0,6,11,-2,8,6,-6,0,3,-1,-1,1,-1,5,1
KR_6744402190,420,2,12,23,17,5,6,1,3,4,1,3,4,1,4,6,2,2,3,1,2,18,1,0,6,6,-2,0,2,1,1,1,1,6,1
KR_6734718829,420,0,42,-33,6,5,5,0,-2,3,5,-1,4,5,4,4,0,0,1,1,0,-6,-9,2,5,7,-1,0,1,0,-1,1,-1,0,1
KR_6750260890,420,4,65,-12,8,1,1,0,3,6,3,1,1,0,3,6,3,0,2,2,0,16,-40,3,4,7,4,0,1,-1,1,1,-1,6,1
KR_6713320174,420,1,-22,15,0,0,1,1,-4,2,6,2,3,1,2,3,1,0,1,1,0,0,-5,3,2,5,5,0,0,1,1,0,1,1,1
KR_6764995360,420,0,-103,0,5,-2,2,4,5,6,1,6,6,0,-1,1,2,-3,2,5,0,10,2,2,5,7,1,0,0,1,1,-1,-1,6,1
KR_6743801624,420,-1,11,6,-4,0,4,4,-4,3,7,-3,1,4,3,4,1,0,0,0,0,-7,4,-7,8,1,0,0,0,1,-1,-1,-1,2,1
KR_6722632924,420,1,72,-45,4,1,3,2,1,5,4,-4,2,6,3,4,1,3,3,0,0,12,-26,4,9,13,6,0,1,1,-1,1,-1,4,1
KR_6774728233,420,-2,-18,-11,3,2,3,1,2,4,2,1,2,1,1,7,6,-3,4,7,0,0,0,4,8,12,-2,0,-1,1,-1,-1,-1,5,1
KR_6777826535,440,2,-8,-12,5,3,3,0,0,0,0,-1,1,2,6,6,0,-3,0,3,0,5,6,5,3,8,-6,0,0,-1,1,0,1,3,1
KR_6770439913,420,6,29,30,17,-1,2,3,6,7,1,7,7,0,5,6,1,0,1,1,0,25,24,1,2,3,0,0,2,1,-1,1,1,5,1
KR_6774218396,420,2,-18,20,6,3,3,0,4,7,3,3,5,2,-4,2,6,0,0,0,0,11,27,0,2,2,1,0,0,-1,-1,0,-1,1,1
KR_6775618502,420,1,12,7,1,0,1,1,0,1,1,2,4,2,-4,5,9,3,4,1,0,4,5,-1,6,5,1,0,-1,-1,1,-1,-1,4,1
KR_6766005031,440,2,-4,4,1,0,0,0,1,2,1,2,2,0,-2,1,3,0,0,0,0,0,3,3,7,10,-1,0,1,1,-1,1,-1,6,1
KR_6686577057,420,4,54,-12,10,-1,0,1,1,1,0,6,7,1,2,7,5,2,2,0,3,17,6,1,5,6,2,0,1,0,-1,1,1,0,1
KR_6775224659,420,8,103,35,14,3,3,0,1,3,2,5,5,0,4,5,1,1,1,0,0,13,-21,2,6,8,2,0,4,-1,1,1,1,6,1
KR_6724761508,420,0,4,5,3,-1,2,3,4,8,4,1,3,2,-1,3,4,0,3,3,1,8,-16,3,4,7,2,0,0,1,1,-1,1,3,1
KR_6735704167,420,0,16,-17,1,1,5,4,3,5,2,0,2,2,-3,2,5,0,2,2,1,10,-28,-1,5,4,4,0,0,1,-1,1,1,3,1
KR_6741000500,420,-2,27,-51,-2,2,5,3,1,2,1,-2,6,8,-4,4,8,1,2,1,-1,4,-4,-4,13,9,7,0,-1,-1,1,-1,-1,3,1
KR_6776789902,420,4,76,9,4,-3,2,5,2,3,1,-1,2,3,5,5,0,1,2,1,0,12,-2,-4,11,7,8,0,1,1,-1,1,-1,3,1
KR_6764950497,420,-3,19,10,-6,1,3,2,-3,0,3,-1,1,2,-4,1,5,1,2,1,0,-13,0,2,7,9,2,0,0,1,1,-1,1,3,1
KR_6729182595,420,6,122,37,12,6,7,1,5,7,2,3,3,0,-3,1,4,1,2,1,0,1,50,1,4,5,9,0,2,1,1,1,1,2,1
KR_6745095373,420,-1,65,-18,-1,-1,1,2,-1,3,4,-2,2,4,1,3,2,2,2,0,-1,-1,-163,5,5,10,3,0,0,-1,-1,0,-1,6,1
KR_6765612390,420,0,17,13,-3,-2,0,2,-1,2,3,1,3,2,-3,1,4,2,2,0,0,-11,9,-1,7,6,-2,0,-1,1,-1,-1,-1,6,1
KR_6754342365,420,5,12,-8,7,5,6,1,2,3,1,-5,0,5,3,6,3,2,2,0,-1,6,0,-1,7,6,-1,0,1,1,1,1,-1,2,1
KR_6744796571,440,1,-32,28,4,0,1,1,-3,2,5,2,4,2,3,5,2,2,2,0,0,13,21,1,3,4,2,0,-1,1,1,-1,-1,1,1
KR_6744735035,420,6,35,0,17,3,3,0,7,9,2,3,3,0,2,4,2,2,3,1,0,20,97,6,4,10,6,0,2,1,1,1,1,1,1
KR_6773013158,420,1,-56,0,1,1,2,1,3,4,1,-4,4,8,-1,2,3,2,2,0,0,-9,-13,2,6,8,-2,0,0,1,-1,0,1,1,1
KR_6776643065,420,-1,-58,3,3,-1,0,1,-1,2,3,-4,2,6,9,9,0,0,0,0,2,6,1,2,4,6,-2,0,1,0,1,1,1,0,1
KR_6758485647,420,-2,-39,-12,1,-1,0,1,2,6,4,2,3,1,-1,3,4,-1,1,2,0,9,-32,3,6,9,3,0,-3,1,-1,-1,-1,4,1
KR_6770213067,420,4,30,49,2,1,1,0,-1,1,2,3,3,0,-2,1,3,1,1,0,0,3,-52,-5,7,2,2,0,0,-1,-1,0,1,2,1
KR_6748467171,420,0,30,12,-7,2,3,1,1,3,2,-2,2,4,-4,1,5,-4,0,4,0,-12,2,-3,8,5,1,0,0,-1,-1,0,-1,5,1
KR_6768813267,420,4,10,20,9,0,2,2,3,4,1,9,10,1,-3,6,9,0,3,3,0,14,-7,-5,10,5,4,0,2,1,1,1,-1,1,1
KR_6752645794,420,3,41,17,5,6,7,1,-2,1,3,-1,1,2,1,3,2,1,1,0,1,10,-13,-5,9,4,10,0,1,1,1,1,1,2,1
KR_6752003900,420,1,9,5,2,4,4,0,-5,0,5,-2,0,2,4,4,0,1,2,1,0,0,15,-5,9,4,-5,0,2,-1,1,1,-1,3,1
KR_6766675212,420,-2,42,-32,-2,7,8,1,-3,1,4,-1,0,1,-5,1,6,0,0,0,1,-8,-1,-1,5,4,-5,0,0,-1,-1,1,1,5,1
KR_6727376857,420,2,59,-7,10,1,5,4,3,6,3,2,3,1,2,4,2,2,2,0,0,10,4,3,6,9,3,0,-1,1,-1,1,-1,5,1
KR_6773738042,440,-1,23,-1,-5,-4,0,4,2,2,0,4,4,0,-6,1,7,-1,2,3,0,-5,-1,0,5,5,-5,0,0,-1,1,-1,1,2,1
KR_6743954998,420,4,39,-12,10,5,5,0,3,3,0,1,2,1,1,3,2,0,2,2,0,7,-5,-1,7,6,4,0,1,1,-1,1,1,3,1
KR_6715173045,440,7,93,24,14,1,3,2,5,6,1,2,3,1,1,1,0,5,9,4,0,21,8,0,3,3,-3,0,4,1,1,1,-1,1,1
KR_6718801528,420,3,26,-6,10,0,2,2,9,9,0,1,2,1,-2,0,2,2,2,0,0,13,-52,8,3,11,-1,0,2,-1,1,1,1,5,1
KR_6742112494,420,1,30,8,5,1,1,0,4,5,1,1,2,1,0,0,0,-1,0,1,0,2,4,0,7,7,-2,0,1,-1,-1,1,1,6,1
KR_6743886417,420,3,32,-4,6,1,3,2,9,14,5,0,2,2,1,2,1,-5,0,5,1,8,-10,-2,6,4,2,0,3,1,1,1,1,2,1
KR_6776524827,420,0,-57,0,3,0,5,5,-2,3,5,4,5,1,-2,8,10,3,4,1,-1,12,29,-2,6,4,0,0,-5,1,-1,-1,-1,3,1
KR_6741030129,420,5,119,-19,11,1,1,0,-5,1,6,9,10,1,6,7,1,0,0,0,0,11,-1,1,4,5,-1,0,3,1,1,1,-1,3,1
KR_6773973555,420,4,43,-12,11,-1,0,1,2,4,2,5,6,1,1,2,1,4,4,0,0,11,14,3,3,6,1,0,2,1,1,1,-1,5,1
KR_6726573453,420,2,43,14,0,-2,6,8,3,5,2,1,4,3,2,5,3,-4,0,4,-1,4,-2,4,3,7,1,0,0,1,1,0,-1,1,1
KR_6775995735,420,2,21,-11,11,3,3,0,2,3,1,4,4,0,2,2,0,0,1,1,0,11,4,6,3,9,4,0,2,-1,-1,1,1,3,1
KR_6728145751,420,5,25,34,14,5,5,0,5,6,1,2,2,0,1,1,0,1,1,0,0,22,-1,-2,7,5,6,0,1,1,1,1,1,4,1
KR_6771433892,440,-2,-3,29,-6,2,3,1,-2,2,4,-1,0,1,-3,1,4,-2,1,3,0,-8,5,-5,5,0,-1,0,0,1,1,-1,1,2,1
KR_6739884868,440,1,47,0,-1,0,3,3,1,1,0,0,0,0,2,4,2,-4,0,4,0,-6,-9,0,5,5,0,0,1,-1,1,1,1,4,1
KR_6770037087,420,5,44,30,3,4,5,1,2,6,4,-4,3,7,3,4,1,-2,0,2,0,-7,16,2,5,7,-2,0,3,1,1,1,1,4,1
KR_6775446062,420,-1,-16,-5,0,-1,0,1,-2,1,3,-1,1,2,3,3,0,1,1,0,0,4,-152,4,6,10,4,0,-1,-1,-1,-1,1,4,1
KR_6724937431,420,3,4,28,8,3,3,0,6,6,0,-4,3,7,3,5,2,0,2,2,0,2,-4,-2,6,4,7,0,1,-1,1,-1,1,4,1
KR_6733695579,420,5,99,-24,10,2,2,0,3,4,1,-1,3,4,3,5,2,3,3,0,0,2,46,3,5,8,-8,0,4,-1,1,1,1,4,1
KR_6774460397,420,2,5,4,1,3,8,5,-2,2,4,3,8,5,-4,2,6,1,3,2,0,5,-5,0,3,3,2,0,0,-1,1,-1,1,2,1
KR_6753843088,420,3,50,16,2,0,3,3,1,3,2,0,3,3,0,4,4,1,3,2,1,0,-4,-2,7,5,-4,0,1,1,-1,-1,1,6,1
KR_6726360673,420,6,48,32,6,2,4,2,-1,1,2,3,4,1,3,4,1,-1,2,3,-1,8,3,1,5,6,0,0,1,-1,1,1,-1,2,1
KR_6764870415,420,4,38,12,10,2,5,3,4,7,3,0,1,1,2,3,1,2,2,0,0,9,22,3,3,6,-2,0,1,1,-1,1,1,3,1
KR_6775471073,420,0,17,1,1,0,3,3,2,4,2,3,3,0,-4,2,6,0,1,1,0,10,36,-2,8,6,6,0,0,1,1,1,-1,2,1
KR_6770027932,440,0,-75,0,2,-1,0,1,-1,0,1,0,1,1,0,1,1,4,4,0,0,4,-129,0,6,6,1,0,0,1,1,-1,-1,3,1
KR_6769690796,420,-1,-41,-12,5,0,2,2,-1,3,4,2,4,2,3,3,0,1,1,0,0,8,0,2,5,7,0,0,0,-1,1,-1,1,5,1
KR_6764527810,420,3,64,8,4,4,5,1,-1,3,4,-2,2,4,-1,1,2,4,5,1,0,3,-2,-2,8,6,1,0,2,1,1,1,1,2,1
KR_6749176143,420,-3,-27,-22,-4,0,2,2,-1,1,2,-4,1,5,0,4,4,1,2,1,1,-6,5,-1,6,5,-1,0,-1,1,-1,-1,1,1,1
KR_6770046745,440,3,47,-1,13,3,4,1,3,5,2,-2,0,2,4,6,2,5,7,2,0,5,-11,-4,8,4,1,0,2,-1,-1,1,-1,1,1
KR_6775155810,420,0,-20,-16,5,0,0,0,1,3,2,2,4,2,2,3,1,0,0,0,0,9,33,0,6,6,-4,0,1,1,-1,1,1,4,1
KR_6739931875,420,6,48,28,13,3,3,0,5,8,3,2,2,0,1,1,0,2,2,0,0,19,85,0,5,5,5,0,3,1,1,1,-1,3,1
KR_6763775060,420,1,21,7,7,2,2,0,3,6,3,2,2,0,-1,3,4,1,1,0,0,6,9,-2,5,3,0,0,0,-1,-1,0,1,1,1
KR_6696901191,420,-1,42,-22,-2,-3,1,4,1,4,3,2,3,1,-2,3,5,0,2,2,0,-3,5,-4,9,5,2,0,-1,1,-1,-1,-1,6,1
KR_6758268063,420,0,10,9,0,0,1,1,2,2,0,1,4,3,-2,2,4,-1,1,2,0,8,29,1,6,7,-5,0,1,1,1,1,1,1,1
KR_6771582755,420,-1,18,-13,6,4,5,1,0,2,2,-2,1,3,1,2,1,3,6,3,2,9,-30,0,9,9,0,0,1,0,-1,1,1,0,1
KR_6728306605,440,3,-19,-8,10,2,3,1,3,4,1,2,4,2,2,3,1,1,1,0,0,13,-1,3,6,9,-2,0,1,1,1,1,1,2,1
KR_6738462299,420,9,90,40,18,1,2,1,4,4,0,1,3,2,10,17,7,2,3,1,0,17,7,2,5,7,3,0,3,1,1,1,1,2,1
KR_6744617352,420,-1,15,0,1,-4,0,4,-1,3,4,2,3,1,3,5,2,1,1,0,0,-2,-31,0,7,7,0,0,1,-1,-1,1,-1,5,1
KR_6777391385,420,3,30,2,-2,-2,2,4,1,3,2,-1,1,2,-1,2,3,1,1,0,0,-2,0,-3,5,2,6,0,2,-1,1,1,1,3,1
KR_6726384351,420,2,16,16,11,2,4,2,5,6,1,4,5,1,-1,0,1,1,2,1,0,15,8,2,5,7,-1,0,1,1,1,1,-1,6,1
KR_6741002951,420,-2,-32,-13,-7,-3,1,4,-6,0,6,1,5,4,1,5,4,0,0,0,0,-3,-121,5,2,7,-1,0,-2,1,-1,-1,-1,3,1
KR_6756307433,420,-2,-40,-8,-3,0,3,3,-1,1,2,1,5,4,-2,3,5,-1,0,1,0,2,20,-1,7,6,-4,0,0,1,-1,-1,1,6,1
KR_6768675193,420,1,-11,4,10,1,1,0,4,7,3,-1,3,4,4,4,0,2,2,0,-1,17,23,-3,6,3,2,0,1,-1,1,1,-1,6,1
KR_6776334010,420,2,56,23,-1,-1,0,1,0,3,3,2,2,0,0,3,3,-2,1,3,-1,-7,5,-3,8,5,-2,0,1,1,-1,1,-1,4,1
KR_6775959421,420,1,21,0,9,1,2,1,3,5,2,4,5,1,1,4,3,0,1,1,0,14,20,1,5,6,2,0,1,1,1,1,1,1,1
KR_6774074595,440,-1,-41,6,-5,-5,0,5,0,2,2,-1,5,6,1,1,0,0,1,1,0,-1,12,-4,5,1,-3,0,0,0,0,0,-1,0,1
KR_6756132166,420,0,7,-16,-1,-5,0,5,-1,4,5,-4,0,4,8,8,0,1,2,1,0,7,-23,-2,5,3,1,0,-1,-1,-1,-1,-1,2,1
KR_6774101922,420,3,118,24,6,0,1,1,2,3,1,1,4,3,2,3,1,1,1,0,0,10,-22,-3,10,7,2,0,1,1,-1,1,-1,2,1
KR_6753786733,420,-2,-1,-7,-6,1,2,1,-3,2,5,-9,1,10,5,5,0,0,1,1,0,-10,-32,2,6,8,5,0,1,1,-1,1,1,3,1
KR_6744528439,420,0,4,12,-7,-3,1,4,0,3,3,-2,4,6,-2,2,4,0,1,1,-1,-6,41,-2,8,6,-9,0,-2,-1,-1,1,1,6,1
KR_6731324569,440,3,-9,-6,8,3,6,3,3,3,0,1,1,0,1,1,0,0,0,0,0,9,9,7,1,8,-1,0,1,0,-1,1,-1,0,1
KR_6770359745,420,-1,3,13,-3,2,3,1,-3,5,8,1,3,2,-2,2,4,-1,1,2,-1,-5,-1,-2,10,8,0,0,1,1,1,1,-1,4,1
KR_6710445972,420,1,39,-15,5,1,1,0,-1,2,3,1,4,3,6,6,0,-2,0,2,0,8,-7,1,4,5,0,0,1,1,-1,1,1,4,1
KR_6776631985,420,3,69,4,0,4,4,0,-1,2,3,-3,1,4,0,1,1,0,1,1,0,-5,-16,4,5,9,0,0,-1,1,-1,-1,1,6,1
KR_6747618545,420,3,14,15,3,1,3,2,-2,4,6,1,5,4,1,3,2,2,2,0,0,-2,25,4,6,10,1,0,1,1,1,1,1,6,1
KR_6769444911,420,4,48,34,0,1,1,0,4,6,2,-3,1,4,-3,2,5,1,3,2,-2,-11,0,3,6,9,-3,0,0,-1,1,0,-1,3,1
KR_6775782147,420,2,18,-2,8,2,5,3,3,3,0,1,3,2,-1,4,5,3,4,1,0,7,-83,-1,3,2,7,0,2,-1,1,1,-1,3,1
KR_6753276090,420,-1,-3,19,1,-1,3,4,2,3,1,0,1,1,2,4,2,-2,0,2,-1,7,4,3,9,12,1,0,0,1,-1,-1,-1,6,1
KR_6773609185,420,2,19,20,-3,3,4,1,0,2,2,-2,1,3,-1,2,3,-3,2,5,0,-3,-18,0,8,8,-4,0,0,1,-1,0,-1,3,1
KR_6775921844,420,1,5,-21,5,-1,1,2,3,4,1,1,2,1,0,3,3,2,2,0,0,6,4,-1,7,6,-1,0,0,1,-1,-1,1,4,1
KR_6776233030,420,6,60,35,16,2,2,0,11,13,2,3,4,1,0,1,1,0,0,0,1,19,31,6,2,8,1,0,2,1,1,1,1,2,1
KR_6756254439,420,1,26,8,0,0,0,0,4,4,0,-1,2,3,-3,2,5,0,0,0,0,-3,7,1,7,8,0,0,0,1,1,1,1,2,1
KR_6742677251,420,4,17,14,7,-1,1,2,-1,2,3,2,6,4,5,6,1,2,2,0,0,7,10,4,4,8,3,0,-1,1,-1,-1,-1,4,1
KR_6754048904,420,6,79,8,9,-2,1,3,-1,3,4,9,10,1,4,7,3,-1,0,1,-1,12,-1,1,6,7,0,0,0,1,0,0,-1,4,1
KR_6711186511,440,3,25,15,-2,-3,3,6,2,8,6,3,3,0,-3,1,4,-1,1,2,0,5,35,1,4,5,-2,0,-2,-1,1,-1,-1,6,1
KR_6756699115,420,0,17,7,5,0,1,1,-1,1,2,3,3,0,2,3,1,1,3,2,0,11,17,4,3,7,-8,0,-1,1,-1,-1,-1,1,1
KR_6751371030,420,1,98,-3,2,4,4,0,-3,3,6,0,1,1,-2,0,2,3,3,0,0,-9,-5,-2,7,5,-3,0,2,-1,-1,1,1,5,1
KR_6765659480,420,1,-3,-5,5,1,1,0,1,2,1,0,1,1,3,4,1,0,1,1,0,10,10,4,4,8,-3,0,0,1,-1,0,1,6,1
KR_6750426095,440,4,104,-7,10,3,3,0,4,4,0,2,4,2,-2,0,2,3,3,0,0,17,8,-1,5,4,-4,0,1,1,1,1,1,6,1
KR_6719691641,420,2,71,-1,-2,-3,2,5,2,3,1,1,2,1,-1,2,3,-1,1,2,0,-2,-6,0,8,8,4,0,0,0,-1,0,-1,0,1
KR_6742441846,420,3,97,-8,10,-1,1,2,2,4,2,5,6,1,2,7,5,2,2,0,0,11,-29,0,6,6,3,0,0,1,1,0,1,3,1
KR_6759306978,420,0,30,-42,0,0,1,1,-2,0,2,1,2,1,1,2,1,0,1,1,0,2,-25,4,3,7,5,0,0,1,-1,-1,-1,6,1
KR_6766066921,420,1,40,-5,7,-2,1,3,2,2,0,-5,3,8,11,11,0,1,1,0,0,12,1,-2,7,5,3,0,2,1,1,1,1,5,1
KR_6714139903,420,0,41,-8,-1,-2,3,5,0,1,1,3,4,1,0,2,2,-2,1,3,0,-2,3,-1,10,9,-5,0,2,0,1,1,-1,0,1
KR_6755940300,420,4,-9,16,6,1,2,1,3,5,2,-1,0,1,1,1,0,2,2,0,0,13,0,1,3,4,-4,0,0,1,1,0,-1,2,1
KR_6775847131,420,-2,-33,-43,-1,-1,1,2,2,3,1,2,3,1,-1,2,3,-3,1,4,-1,-2,-8,2,7,9,-10,0,-1,-1,-1,-1,-1,2,1
KR_6745596782,420,4,1,-30,9,0,1,1,0,0,0,7,7,0,3,4,1,-1,1,2,0,10,5,5,1,6,-2,0,0,-1,-1,0,1,2,1
KR_6774194262,420,6,80,20,11,4,4,0,2,2,0,4,5,1,0,1,1,1,3,2,0,9,35,-2,7,5,9,0,1,-1,1,1,1,2,1
KR_6727732535,420,-1,-2,-25,1,-3,0,3,4,6,2,2,5,3,-2,0,2,0,2,2,0,4,-36,-1,6,5,7,0,-1,-1,-1,-1,1,1,1
KR_6754659264,420,1,17,0,0,1,2,1,3,5,2,-2,0,2,-1,3,4,-1,0,1,0,2,12,-1,6,5,3,0,0,1,1,0,1,3,1
KR_6775040573,420,3,43,13,2,1,2,1,-1,4,5,1,3,2,1,1,0,0,0,0,0,3,-3,0,6,6,6,0,2,-1,1,1,-1,4,1
KR_6777549556,420,1,-7,22,-1,-1,2,3,5,5,0,1,2,1,-3,4,7,-3,1,4,0,3,-2,-1,6,5,4,0,0,1,1,1,-1,2,1
KR_6710994720,420,0,23,12,-5,-3,0,3,4,4,0,-6,0,6,1,2,1,-1,0,1,0,-8,4,4,8,12,-8,0,1,-1,1,1,-1,3,1
KR_6766635072,420,0,19,-11,-1,0,2,2,0,5,5,0,5,5,0,3,3,-1,0,1,2,-4,6,3,6,9,-2,0,2,-1,1,1,1,2,1
KR_6728509833,420,3,103,7,10,-1,0,1,2,4,2,2,2,0,5,8,3,2,2,0,0,7,-31,3,4,7,-25,0,2,1,1,1,1,6,1
KR_6699823836,420,4,48,-6,10,2,4,2,3,4,1,-5,1,6,8,10,2,2,2,0,2,10,-12,0,4,4,7,0,0,1,-1,1,1,6,1
KR_6716693127,420,0,9,20,-3,2,5,3,2,4,2,-1,1,2,-7,0,7,1,4,3,1,-16,-7,0,8,8,-3,0,2,-1,1,1,1,6,1
KR_6740618715,420,1,36,22,2,1,1,0,0,1,1,-4,3,7,5,5,0,0,1,1,1,17,19,0,6,6,1,0,1,1,-1,1,1,3,1
KR_6775341254,420,1,-29,12,3,0,4,4,2,3,1,0,3,3,1,1,0,0,1,1,0,9,59,-6,9,3,-6,0,-1,-1,-1,-1,1,5,1
KR_6713593936,440,3,89,-16,8,6,7,1,-1,2,3,3,4,1,2,5,3,-2,1,3,0,4,130,4,2,6,17,0,0,-1,1,0,1,1,1
KR_6753095864,420,1,13,-9,6,3,4,1,3,6,3,4,5,1,-2,1,3,-2,0,2,0,6,99,3,4,7,4,0,1,-1,1,1,-1,5,1
KR_6755409550,420,5,-17,-20,9,-1,3,4,3,4,1,2,3,1,5,5,0,0,1,1,-1,15,11,5,4,9,-1,0,1,1,1,1,-1,2,1
KR_6777121644,420,4,46,12,7,2,3,1,-2,2,4,0,2,2,6,7,1,1,2,1,0,9,-5,0,8,8,5,0,0,1,1,0,-1,3,1
KR_6763441792,420,0,13,1,0,-3,0,3,0,2,2,4,6,2,0,0,0,-1,1,2,0,-1,-6,-2,8,6,3,0,-1,1,-1,-1,1,3,1
KR_6733616292,420,-1,-7,8,1,1,3,2,2,4,2,-3,0,3,1,4,3,0,0,0,0,-5,7,0,8,8,2,0,2,-1,1,1,1,1,1
KR_6768895460,440,-1,56,8,-1,-1,1,2,-4,3,7,-1,2,3,5,11,6,0,1,1,-2,-6,-375,-2,4,2,3,0,1,0,-1,1,-1,0,1
KR_6772822236,420,2,83,20,3,3,3,0,0,3,3,1,2,1,-1,1,2,0,1,1,0,-9,11,4,7,11,-1,0,1,-1,1,1,1,6,1
KR_6760097947,420,4,-26,-2,6,2,2,0,1,5,4,1,5,4,2,3,1,0,1,1,0,-2,2,0,7,7,2,0,1,-1,1,1,-1,5,1
KR_6758467207,420,1,4,16,5,0,1,1,3,7,4,-3,1,4,4,6,2,1,1,0,0,14,10,8,6,14,0,0,0,1,1,1,-1,1,1
KR_6775949023,420,1,-35,-14,2,2,2,0,-2,2,4,3,3,0,0,0,0,-1,0,1,0,-3,39,-2,6,4,2,0,0,-1,1,0,1,6,1
KR_6741006225,420,3,38,2,6,6,8,2,-3,1,4,2,5,3,3,6,3,-2,0,2,0,5,5,6,3,9,-2,0,1,1,1,1,1,5,1
KR_6763741240,420,-7,-67,-21,-6,-3,1,4,0,4,4,-1,2,3,-1,3,4,-1,0,1,0,6,4,1,5,6,-1,0,0,-1,1,0,-1,4,1
KR_6751579447,420,4,61,-15,14,3,3,0,0,4,4,7,9,2,2,5,3,2,4,2,0,13,8,-5,11,6,7,0,0,1,-1,0,1,6,1
KR_6773083079,420,2,7,4,9,2,2,0,2,3,1,0,1,1,5,6,1,0,0,0,-2,14,83,2,7,9,4,0,-1,1,-1,-1,-1,2,1
KR_6760652424,420,4,10,-1,4,-4,2,6,0,3,3,3,7,4,2,4,2,3,5,2,0,17,-13,1,7,8,-4,0,1,1,-1,1,-1,6,1
KR_6776761635,420,4,64,40,5,-1,1,2,2,5,3,1,4,3,3,5,2,0,0,0,0,7,-2,-2,7,5,4,0,0,1,-1,1,1,1,1
KR_6773642346,440,-1,-11,-56,8,2,4,2,-1,1,2,1,2,1,3,6,3,3,3,0,0,18,0,4,4,8,1,0,0,-1,1,0,-1,6,1
KR_6775358102,420,3,30,9,15,7,8,1,-1,4,5,3,5,2,10,12,2,-4,0,4,4,27,4,3,5,8,5,0,2,1,1,1,1,2,1
KR_6774929711,420,1,1,3,-6,2,2,0,-1,3,4,1,1,0,-5,2,7,-3,1,4,0,-8,-9,-2,5,3,1,0,0,-1,-1,-1,-1,4,1
KR_6751386429,440,-3,-12,-23,-1,-1,2,3,5,5,0,-2,2,4,0,4,4,-3,4,7,3,4,114,1,5,6,2,0,-1,-1,-1,-1,1,1,1
KR_6776939286,420,3,17,-27,3,1,2,1,-2,5,7,3,4,1,1,2,1,0,0,0,0,7,-2,1,5,6,-1,0,0,-1,-1,0,1,3,1
KR_6746322229,420,2,15,20,7,-1,0,1,2,6,4,5,5,0,0,1,1,1,3,2,0,1,4,3,5,8,-3,0,0,1,1,0,1,2,1
KR_6744762244,420,0,3,9,3,-4,0,4,-3,0,3,1,2,1,7,8,1,2,4,2,-1,12,14,4,4,8,6,0,1,-1,1,1,-1,2,1
KR_6729674977,440,5,28,40,14,3,5,2,0,2,2,7,9,2,3,6,3,1,1,0,0,6,-8,1,3,4,-4,0,1,0,-1,1,1,0,1
KR_6749691304,420,5,10,21,9,1,3,2,3,5,2,5,7,2,2,4,2,-2,3,5,-1,11,-5,1,4,5,2,0,3,-1,1,1,-1,5,1
KR_6775289840,420,1,3,33,1,-1,0,1,1,4,3,0,1,1,-1,1,2,2,3,1,0,0,9,2,5,7,-4,0,-2,-1,1,1,-1,3,1
KR_6772693047,420,1,46,3,4,-4,0,4,1,3,2,3,5,2,2,3,1,2,2,0,1,10,-2,0,1,1,2,0,-1,-1,-1,1,1,3,1
KR_6740256611,420,6,70,40,9,1,4,3,-1,4,5,-2,1,3,9,11,2,2,2,0,0,0,6,4,4,8,-2,0,1,1,-1,1,1,4,1
KR_6767549138,420,-3,-52,-12,-7,0,2,2,4,5,1,-4,2,6,-7,1,8,0,4,4,-1,-7,4,-2,6,4,-8,0,-2,-1,1,1,-1,5,1
KR_6757570118,420,4,27,14,3,4,5,1,-3,2,5,6,8,2,-2,0,2,-2,1,3,0,-2,-11,-2,6,4,2,0,1,1,1,1,1,1,1
KR_6772592246,420,5,13,0,10,4,4,0,5,6,1,2,2,0,-2,0,2,1,1,0,-1,9,10,4,5,9,-4,0,1,1,1,1,-1,2,1
KR_6777219407,420,1,-38,0,1,3,4,1,1,1,0,-1,3,4,-5,0,5,3,3,0,0,-4,-3,-1,8,7,1,0,-1,-1,1,-1,-1,3,1
KR_6757711779,420,-1,-61,9,3,-4,0,4,2,4,2,1,2,1,3,5,2,1,1,0,-1,7,-4,5,3,8,-1,0,-2,1,1,-1,-1,1,1
KR_6737469160,420,7,56,13,15,4,4,0,-1,5,6,9,9,0,2,2,0,1,1,0,0,27,48,0,9,9,-3,0,2,0,1,1,-1,0,1
KR_6737167752,420,7,47,14,21,-1,0,1,3,4,1,11,11,0,5,6,1,3,3,0,2,30,-29,2,8,10,7,0,1,1,1,1,1,1,1
KR_6735207170,420,1,46,22,5,4,4,0,1,2,1,3,8,5,-2,1,3,-1,0,1,0,-1,-37,4,6,10,12,0,2,-1,1,1,1,4,1
KR_6751020066,420,3,16,8,7,1,3,2,4,6,2,-1,0,1,3,3,0,0,0,0,0,4,8,4,4,8,0,0,0,1,-1,0,1,4,1
KR_6772795775,440,-1,-22,-8,1,0,3,3,0,2,2,-1,1,2,0,2,2,2,2,0,0,9,-19,-4,7,3,-4,0,0,-1,-1,-1,1,6,1
KR_6772227450,420,0,72,0,-9,1,4,3,-2,2,4,-1,5,6,-4,0,4,-3,1,4,-2,-16,-9,-3,7,4,-2,0,0,-1,1,1,-1,6,1
KR_6772957426,420,1,20,17,-1,1,3,2,-3,0,3,2,3,1,0,2,2,-1,1,2,0,1,8,4,4,8,6,0,1,1,1,1,1,3,1
KR_6777631055,420,1,-15,28,4,-6,0,6,3,3,0,-2,2,4,5,6,1,4,4,0,0,7,7,2,5,7,2,0,0,1,1,1,1,6,1
KR_6699710166,420,3,-50,31,1,-1,2,3,-2,2,4,3,4,1,1,3,2,0,0,0,0,3,22,-2,6,4,-11,0,-1,1,-1,-1,1,5,1
KR_6750658423,420,3,26,13,14,-1,1,2,1,4,3,6,7,1,6,7,1,2,2,0,0,21,-2,1,5,6,6,0,2,1,1,1,-1,5,1
KR_6758990895,420,1,27,-4,6,0,1,1,-3,4,7,3,3,0,5,5,0,1,1,0,0,18,3,4,6,10,7,0,0,1,-1,0,1,2,1
KR_6777039095,420,2,51,15,7,-1,3,4,2,3,1,5,7,2,1,1,0,0,3,3,0,6,5,-1,7,6,5,0,0,0,1,1,1,0,1
KR_6770145661,420,3,35,-4,4,1,1,0,3,3,0,0,1,1,0,3,3,0,2,2,0,6,9,5,5,10,-2,0,0,1,-1,0,1,5,1
KR_6685122843,420,0,-14,-15,-2,0,2,2,1,2,1,-3,2,5,-2,1,3,2,3,1,0,-3,-2,0,6,6,5,0,0,0,-1,0,-1,0,1
KR_6756701582,440,1,63,13,-6,-3,2,5,0,5,5,2,3,1,-4,1,5,-1,1,2,0,-5,-60,-4,9,5,-1,0,0,-1,1,0,-1,2,1
KR_6755982519,420,1,-2,3,2,2,3,1,-3,0,3,-2,1,3,3,4,1,2,2,0,0,-1,-1,-2,8,6,-2,0,1,1,1,1,1,1,1
KR_6777892567,420,3,-66,19,7,1,3,2,1,5,4,0,2,2,0,2,2,5,5,0,-1,7,-34,4,5,9,6,0,0,1,1,-1,-1,2,1
KR_6698223963,420,10,139,33,14,2,2,0,1,2,1,5,5,0,6,6,0,0,1,1,0,18,-38,7,2,9,15,1,7,1,1,1,1,3,1
KR_6772009676,420,2,25,27,2,-3,0,3,3,8,5,-1,0,1,0,2,2,3,3,0,0,4,40,-3,9,6,0,0,2,1,1,1,1,2,1
KR_6763641031,420,7,106,-11,13,1,1,0,0,1,1,4,4,0,7,7,0,1,4,3,0,17,41,0,4,4,-3,0,2,1,1,1,1,5,1
KR_6731755269,420,1,25,-13,1,0,1,1,2,3,1,1,2,1,-2,0,2,0,0,0,1,3,-11,4,6,10,-2,0,2,1,1,1,1,6,1
KR_6768588909,420,4,28,8,12,5,5,0,6,6,0,5,5,0,-4,1,5,0,0,0,0,19,4,0,7,7,-1,0,1,1,-1,1,1,2,1
KR_6755343417,420,1,-8,3,10,4,4,0,4,5,1,1,1,0,1,1,0,0,0,0,0,19,-2,-1,6,5,0,0,0,1,-1,0,1,2,1
KR_6774420581,420,-3,4,16,-9,-3,2,5,0,2,2,-4,1,5,-2,0,2,0,0,0,0,-8,26,-4,11,7,-7,0,-1,-1,0,-1,-1,5,1
KR_6758529631,420,0,-2,-28,-1,0,1,1,4,5,1,-3,3,6,-4,0,4,2,2,0,-1,-3,-5,-4,8,4,0,0,1,-1,1,1,-1,1,1
KR_6777248703,420,4,57,16,-1,1,1,0,2,3,1,-1,1,2,-1,4,5,-2,0,2,0,-3,-24,-1,7,6,-4,0,0,-1,-1,-1,-1,3,1
KR_6743053858,420,3,55,-10,9,1,3,2,5,5,0,3,3,0,1,3,2,-1,0,1,0,10,9,3,8,11,3,0,1,1,1,1,1,3,1
KR_6777240645,420,3,15,3,3,1,2,1,2,2,0,-1,1,2,2,2,0,-1,0,1,0,7,-2,3,4,7,3,0,1,-1,1,1,1,2,1
KR_6751402655,420,3,59,32,8,2,4,2,6,9,3,2,4,2,1,3,2,-3,0,3,-1,4,19,-1,3,2,3,0,0,1,1,1,-1,3,1
KR_6774888976,420,2,20,9,8,-1,3,4,6,7,1,-1,1,2,5,6,1,-1,0,1,-1,10,70,6,3,9,1,0,-2,1,-1,-1,-1,4,1
KR_6747700676,420,-2,-21,27,-8,-1,3,4,1,2,1,-4,2,6,-5,1,6,1,1,0,0,-14,99,-12,14,2,1,0,-2,1,-1,-1,-1,1,1
KR_6774370518,420,2,38,22,6,-1,1,2,2,5,3,2,3,1,2,4,2,1,1,0,0,16,-50,0,7,7,2,0,0,1,-1,-1,-1,6,1
KR_6744192479,420,-1,-28,5,-1,0,1,1,-2,1,3,4,5,1,1,4,3,-4,2,6,2,-7,-9,-1,5,4,1,0,-1,-1,1,-1,1,2,1
KR_6770210940,440,6,49,4,15,4,4,0,5,7,2,1,3,2,3,4,1,2,2,0,1,10,33,0,3,3,-1,0,0,-1,1,0,1,4,1
KR_6766175292,420,-2,-27,-20,-2,2,4,2,-2,4,6,-1,4,5,-1,0,1,0,0,0,0,2,3,-1,6,5,2,0,0,1,1,0,1,6,1
KR_6769629729,420,2,-41,-4,4,5,5,0,0,4,4,0,3,3,-2,0,2,1,1,0,0,1,-7,2,6,8,-6,0,2,0,1,1,-1,0,1
KR_6776425477,420,2,27,20,3,3,3,0,2,3,1,1,1,0,-3,2,5,0,1,1,0,1,30,2,5,7,-3,0,1,-1,1,1,-1,1,1
KR_6768265946,420,1,14,-3,6,0,2,2,0,2,2,1,3,2,5,6,1,0,0,0,2,11,-20,-1,6,5,-1,0,0,-1,1,1,1,4,1
KR_6769266560,420,0,42,7,3,7,7,0,0,2,2,-1,2,3,-3,1,4,0,0,0,0,-7,8,-2,7,5,-4,0,0,-1,-1,1,1,6,1
KR_6718889239,420,5,64,16,11,7,7,0,3,5,2,3,3,0,-2,0,2,0,1,1,0,19,2,1,4,5,3,0,4,-1,1,1,1,3,1
KR_6775376403,420,-1,-41,28,-3,2,2,0,0,2,2,-5,1,6,-1,1,2,1,1,0,0,-3,5,-5,8,3,-1,0,0,-1,1,0,1,2,1
KR_6776038743,420,4,59,35,-3,3,3,0,0,1,1,-3,2,5,-3,3,6,0,1,1,0,-9,-3,-6,9,3,3,0,1,1,1,1,1,5,1
KR_6774237048,420,2,-31,12,6,2,3,1,4,7,3,-2,1,3,3,4,1,-1,0,1,0,8,-8,-5,10,5,0,0,0,-1,0,1,1,6,1
KR_6770178104,420,0,-4,-11,3,2,3,1,0,1,1,4,5,1,-3,0,3,0,0,0,0,2,23,1,3,4,-3,0,0,1,1,-1,1,5,1
KR_6775790664,420,0,5,8,-3,0,0,0,-7,3,10,-3,0,3,6,7,1,1,1,0,0,-6,52,-2,6,4,-4,0,0,-1,-1,-1,-1,5,1
KR_6748704072,420,1,41,5,6,0,5,5,2,3,1,6,8,2,-2,3,5,0,2,2,0,3,24,2,6,8,-6,0,0,-1,1,1,1,4,1
KR_6775701850,420,4,50,32,7,0,1,1,-1,4,5,7,7,0,2,4,2,-1,1,2,0,0,-5,-2,8,6,-3,0,1,1,-1,1,-1,5,1
KR_6737373405,420,1,53,9,4,0,1,1,1,7,6,4,6,2,2,2,0,-3,0,3,-1,1,10,7,1,8,5,0,0,1,1,0,-1,4,1
KR_6721791642,420,1,16,4,1,0,1,1,2,2,0,-3,1,4,1,4,3,1,1,0,0,0,10,2,8,10,-6,0,0,1,-1,0,-1,1,1
KR_6773332009,420,2,5,24,-1,1,2,1,-2,4,6,-2,2,4,0,2,2,2,2,0,0,-1,4,5,3,8,-1,0,1,-1,1,1,-1,1,1
KR_6775976410,420,3,36,20,12,2,2,0,0,4,4,7,8,1,1,2,1,2,2,0,0,14,8,6,2,8,6,0,0,1,1,1,1,3,1
KR_6770364335,420,2,-10,32,6,4,4,0,-3,3,6,3,3,0,-3,4,7,5,6,1,0,12,16,0,5,5,-1,0,0,-1,1,1,-1,1,1
KR_6742814645,420,0,-29,16,-4,1,3,2,-3,4,7,-1,1,2,-1,3,4,0,1,1,0,-3,-7,3,9,12,-6,0,-1,1,-1,-1,1,5,1
KR_6777220672,420,0,22,15,2,-1,4,5,-2,0,2,4,6,2,1,4,3,0,0,0,0,3,1,1,3,4,3,0,0,-1,1,0,-1,2,1
KR_6740650618,420,3,-40,9,3,0,2,2,0,6,6,-1,1,2,4,4,0,0,0,0,0,7,10,3,3,6,2,0,-1,1,-1,-1,-1,6,1
KR_6771688185,420,4,70,-7,17,-2,1,3,14,15,1,2,4,2,4,5,1,-1,2,3,0,15,-12,-1,6,5,2,0,2,0,1,1,1,0,1
KR_6776079910,420,3,11,37,9,1,3,2,4,6,2,4,4,0,0,5,5,0,1,1,0,7,-5,2,4,6,2,0,1,1,1,1,1,6,1
KR_6770290499,420,5,12,31,11,5,6,1,-1,3,4,0,2,2,3,5,2,4,4,0,2,19,-1,3,4,7,6,0,0,1,1,1,1,4,1
KR_6731695698,420,5,123,9,11,3,4,1,3,4,1,5,5,0,-2,1,3,2,2,0,0,11,3,0,7,7,4,0,3,1,1,1,1,3,1
KR_6673555518,420,2,64,-16,11,1,2,1,2,4,2,4,6,2,-1,3,4,5,5,0,0,9,-2,3,4,7,1,0,0,1,1,1,-1,2,1
KR_6770919011,420,1,45,-12,6,1,4,3,0,3,3,1,2,1,4,4,0,0,2,2,1,6,-43,2,6,8,25,0,1,1,1,1,1,6,1
KR_6710653683,420,2,-14,-16,8,3,5,2,6,7,1,-1,2,3,1,4,3,-1,0,1,0,13,6,0,5,5,-3,0,1,1,-1,1,1,2,1
KR_6743875728,420,4,61,5,11,0,1,1,0,7,7,5,6,1,3,6,3,3,4,1,1,0,3,-1,6,5,1,0,2,1,1,1,1,3,1
KR_6745372891,420,3,91,-22,4,5,5,0,-4,4,8,0,2,2,3,3,0,0,0,0,0,-2,-13,-2,8,6,9,0,2,1,-1,1,1,1,1
KR_6709899251,420,3,-22,-28,1,1,4,3,-1,6,7,-4,2,6,4,6,2,1,2,1,-1,-7,-1,-4,8,4,1,0,0,-1,1,1,-1,3,1
KR_6770246541,420,1,22,5,-3,2,4,2,-2,1,3,0,0,0,-3,1,4,0,0,0,0,-5,-1,-6,9,3,-6,0,-1,1,-1,-1,1,6,1
KR_6740457466,420,0,64,-1,-3,0,3,3,0,3,3,-5,2,7,2,5,3,0,1,1,0,-23,-67,-1,5,4,4,0,0,1,-1,1,-1,1,1
KR_6737285427,420,1,-1,-2,6,5,5,0,1,3,2,-1,2,3,1,3,2,0,0,0,0,1,-14,-3,8,5,4,0,1,1,1,1,1,5,1
KR_6737242178,420,6,130,47,16,5,5,0,3,6,3,0,1,1,11,13,2,-3,0,3,0,21,43,1,9,10,-5,0,2,-1,1,1,1,2,1
KR_6775990997,420,-1,56,13,-3,-1,0,1,3,4,1,-2,0,2,-3,4,7,0,0,0,1,-7,-11,4,3,7,-2,0,0,-1,1,0,1,1,1
KR_6724281003,420,1,2,-36,-2,3,3,0,-2,5,7,0,2,2,-4,1,5,1,2,1,0,0,-22,-6,9,3,1,0,0,-1,-1,-1,1,3,1
KR_6715219123,440,3,77,6,10,0,1,1,-5,1,6,2,7,5,5,6,1,8,8,0,0,11,3,5,0,5,-2,0,2,0,1,1,1,0,1
KR_6708946680,420,0,40,-23,-2,-2,0,2,1,5,4,2,2,0,-3,1,4,0,1,1,0,0,-4,1,8,9,-4,0,0,1,-1,0,1,2,1
KR_6742877408,420,3,34,0,8,2,2,0,3,4,1,-2,0,2,4,5,1,1,3,2,0,9,-1,3,7,10,-4,0,0,-1,-1,-1,-1,2,1
KR_6774735338,420,2,36,19,7,0,2,2,1,4,3,0,1,1,4,4,0,2,2,0,0,10,5,-1,5,4,-4,0,-1,-1,1,-1,-1,6,1
KR_6750121204,420,2,43,36,6,-2,1,3,5,6,1,1,2,1,1,4,3,1,2,1,1,12,6,-2,10,8,3,0,0,1,-1,0,1,5,1
KR_6776228687,420,2,86,16,3,3,4,1,-1,2,3,0,3,3,0,2,2,1,2,1,0,-4,2,4,5,9,0,0,0,1,1,1,1,6,1
KR_6774850317,420,1,-26,25,3,0,3,3,1,2,1,1,2,1,1,2,1,0,0,0,0,-2,-7,0,6,6,0,0,0,-1,1,0,-1,1,1
KR_6761310025,420,1,-72,4,6,2,5,3,6,8,2,-1,3,4,0,4,4,-1,0,1,0,18,10,11,3,14,-4,0,1,-1,1,1,-1,4,1
KR_6775008756,420,0,-11,-5,-1,5,5,0,-2,2,4,-4,1,5,1,2,1,-1,1,2,0,-7,-23,-4,12,8,0,0,0,-1,1,0,-1,1,1
KR_6739812404,420,3,27,-3,3,-1,1,2,1,2,1,1,3,2,3,5,2,-1,0,1,1,17,-2,10,2,12,-4,0,2,1,1,1,1,3,1
KR_6777006546,420,6,87,13,16,4,5,1,4,7,3,-3,1,4,10,10,0,1,1,0,0,14,7,6,6,12,-7,0,1,1,1,1,-1,1,1
KR_6777834932,420,-1,-29,-20,5,0,1,1,-2,3,5,-2,1,3,7,9,2,2,3,1,-1,8,-2,3,7,10,5,0,0,1,-1,-1,-1,2,1
KR_6754276228,420,0,11,24,0,-1,3,4,3,3,0,-2,2,4,0,2,2,0,0,0,0,0,2,0,5,5,-2,0,2,1,1,1,-1,4,1
KR_6753891511,420,-4,-2,-16,0,4,8,4,-1,3,4,2,5,3,-6,0,6,1,5,4,3,9,2,-1,6,5,5,0,-1,-1,-1,1,1,3,1
KR_6777069864,420,1,3,4,1,0,0,0,7,10,3,-9,2,11,1,3,2,2,2,0,0,-5,-1,0,7,7,-6,0,1,1,1,1,1,1,1
KR_6744316858,420,3,-14,0,14,2,4,2,9,10,1,-2,1,3,1,4,3,4,4,0,1,22,-5,4,3,7,-1,0,1,1,1,1,1,5,1
KR_6760385283,420,0,-30,17,-1,0,1,1,-2,2,4,-2,1,3,3,5,2,0,1,1,0,-12,-48,1,6,7,31,0,0,1,-1,-1,-1,4,1
KR_6754482672,420,-2,-12,1,-4,1,1,0,-1,5,6,-2,0,2,3,4,1,-5,0,5,0,1,120,-3,6,3,2,0,0,-1,-1,-1,-1,1,1
KR_6670608700,420,2,14,16,4,-3,1,4,1,2,1,1,3,2,5,6,1,0,1,1,0,3,-4,-1,5,4,1,0,0,-1,1,0,1,6,1
KR_6737273843,420,-1,2,6,-2,-2,1,3,5,5,0,-3,2,5,-3,1,4,1,2,1,0,3,1,1,4,5,3,0,0,1,1,0,-1,6,1
KR_6775503028,420,0,36,5,6,0,2,2,1,7,6,0,2,2,2,5,3,3,4,1,0,16,11,6,3,9,-2,0,1,1,1,1,1,4,1
KR_6753523167,420,7,81,24,11,2,4,2,3,5,2,-1,0,1,5,6,1,2,3,1,0,13,7,4,5,9,1,0,1,1,1,1,1,1,1
KR_6771565252,440,1,-19,10,4,0,2,2,4,4,0,-1,4,5,1,1,0,0,1,1,0,14,22,5,5,10,-3,0,0,1,1,0,-1,4,1
KR_6740636466,420,0,-1,0,3,2,4,2,4,6,2,1,4,3,-4,3,7,0,2,2,0,-2,-1,2,6,8,1,0,-1,0,-1,-1,-1,0,1
KR_6770789440,420,2,-13,36,2,4,6,2,-2,3,5,-2,0,2,5,5,0,-3,0,3,1,4,-119,4,5,9,0,0,0,1,-1,0,1,4,1
KR_6753124361,420,-2,11,-16,-3,0,1,1,1,3,2,2,2,0,-5,2,7,-1,1,2,0,3,-1,-3,11,8,-4,0,1,-1,-1,1,-1,1,1
KR_6765153766,420,2,24,-10,3,-5,0,5,7,7,0,0,1,1,3,10,7,-2,1,3,0,15,2,0,8,8,2,0,-1,-1,1,-1,-1,1,1
KR_6727607528,420,0,28,-13,11,0,1,1,0,1,1,4,4,0,7,8,1,0,1,1,-1,19,18,-1,5,4,2,0,1,1,1,1,-1,1,1
KR_6743793321,440,2,37,-21,12,1,3,2,10,11,1,0,2,2,2,3,1,-1,2,3,1,18,163,5,4,9,-2,0,0,0,-1,1,1,0,1
KR_6773012991,420,-2,-56,-18,-4,-3,3,6,-2,2,4,-3,0,3,4,4,0,0,1,1,0,7,46,3,6,9,-4,0,0,1,-1,-1,-1,1,1
KR_6766778770,420,2,11,-7,7,3,4,1,-2,2,4,1,1,0,3,3,0,2,2,0,0,-1,-3,-1,6,5,1,0,2,1,-1,1,1,1,1
KR_6773643180,440,-2,-14,-8,1,0,2,2,2,4,2,0,4,4,-1,1,2,0,2,2,1,3,-36,1,7,8,15,0,-1,1,-1,-1,1,3,1
KR_6743476022,420,2,54,-43,6,-1,0,1,2,6,4,2,4,2,1,4,3,2,2,0,0,6,-107,-3,9,6,6,0,1,1,-1,1,-1,4,1
KR_6771889127,420,3,84,39,5,3,4,1,-1,2,3,3,4,1,0,2,2,0,1,1,0,2,20,-3,9,6,3,0,1,-1,1,1,1,2,1
KR_6771125060,420,0,-27,-37,5,-1,3,4,-1,1,2,3,4,1,3,3,0,1,1,0,0,6,3,0,6,6,2,0,-1,1,-1,-1,1,3,1
KR_6776181995,420,0,-8,12,-1,0,3,3,-2,5,7,-1,0,1,1,1,0,1,2,1,0,2,17,1,7,8,-2,0,0,-1,1,0,1,5,1
KR_6773065625,420,0,-36,4,4,5,6,1,3,3,0,-4,0,4,0,3,3,0,2,2,0,6,-12,-2,8,6,-1,0,-1,-1,1,-1,1,5,1
KR_6763750786,420,1,26,-44,9,3,4,1,2,4,2,-1,2,3,3,5,2,2,2,0,2,23,0,4,1,5,1,0,1,1,-1,-1,1,2,1
KR_6776261855,420,-2,-21,-11,1,0,2,2,1,4,3,0,4,4,-1,3,4,1,2,1,2,-1,7,0,4,4,-5,0,-1,1,-1,-1,1,2,1
KR_6723577705,420,1,87,-11,5,-2,0,2,3,4,1,6,6,0,0,5,5,-2,2,4,0,1,0,1,5,6,-1,0,1,1,1,1,-1,1,1
KR_6738813065,420,4,39,17,4,2,2,0,2,4,2,0,1,1,0,3,3,0,0,0,0,5,-44,-3,10,7,25,0,1,1,1,1,-1,2,1
KR_6775984684,420,3,31,12,0,1,1,0,-1,2,3,2,5,3,-2,4,6,0,1,1,0,-7,0,-1,6,5,-5,0,0,1,1,1,1,5,1
KR_6715123805,440,0,68,48,-1,2,2,0,-6,2,8,-7,0,7,6,6,0,4,6,2,0,-6,0,-4,8,4,-1,0,2,0,1,1,1,0,1
KR_6738887942,420,0,104,15,-3,2,5,3,-6,0,6,-1,2,3,1,5,4,1,2,1,0,-12,38,-2,7,5,-3,0,0,-1,-1,1,-1,5,1
KR_6770409877,420,-1,52,3,-3,0,1,1,0,1,1,-4,0,4,5,6,1,-4,0,4,-1,-6,-13,-1,4,3,-1,0,0,-1,-1,0,-1,3,1
KR_6776508074,420,3,-23,16,10,1,2,1,3,4,1,2,3,1,4,8,4,0,2,2,0,6,0,3,4,7,-2,0,0,-1,1,0,1,4,1
KR_6756340648,420,0,-15,-25,0,4,5,1,-2,1,3,-1,2,3,-2,0,2,1,2,1,0,-3,-1,2,3,5,-1,0,0,-1,1,0,1,3,1
KR_6754485880,420,0,-15,-41,5,0,1,1,3,4,1,1,3,2,0,1,1,1,1,0,0,8,0,4,4,8,-2,0,0,0,-1,0,1,0,1
KR_6733537494,420,2,25,27,4,6,8,2,2,4,2,2,5,3,-3,0,3,-3,0,3,0,-3,-8,-1,9,8,1,0,0,1,1,-1,1,5,1
KR_6764690180,420,-4,22,-20,-6,-2,0,2,3,3,0,-1,2,3,-5,1,6,-1,1,2,0,-4,-54,-1,4,3,-4,0,1,-1,1,1,-1,3,1
KR_6774434983,420,-2,43,-10,-6,-2,0,2,-4,0,4,-2,2,4,-1,3,4,3,3,0,0,-9,-24,-4,8,4,-3,0,0,1,-1,0,1,5,1
KR_6739836003,420,3,-43,-9,1,-3,1,4,0,1,1,7,7,0,-2,2,4,-1,1,2,-2,4,0,-1,10,9,-7,0,0,-1,-1,-1,-1,3,1
KR_6775252316,420,4,74,5,6,2,3,1,6,7,1,0,1,1,-2,2,4,0,2,2,0,5,-2,-1,10,9,1,0,0,1,0,0,-1,1,1
KR_6736064260,420,3,53,-11,9,5,6,1,3,3,0,-2,1,3,4,4,0,-1,1,2,0,3,-4,8,1,9,2,0,2,1,1,1,1,6,1
KR_6743737058,420,4,35,8,5,3,4,1,-2,1,3,-1,7,8,3,5,2,2,3,1,0,-3,-20,-6,12,6,11,0,0,-1,-1,0,1,4,1
KR_6749368188,440,2,39,-8,2,-2,1,3,4,4,0,-5,0,5,2,5,3,3,3,0,0,-2,-12,-5,7,2,0,0,0,-1,0,1,-1,3,1
KR_6764682842,420,-3,1,-24,2,4,5,1,1,1,0,-4,0,4,0,5,5,1,1,0,0,3,-26,3,4,7,0,0,-1,1,-1,-1,1,5,1
KR_6700990454,420,-3,-32,-21,1,3,4,1,-4,5,9,0,1,1,2,3,1,0,0,0,0,-5,46,4,4,8,-5,0,-1,-1,1,-1,1,2,1
KR_6755073031,420,5,35,8,15,1,5,4,2,4,2,2,3,1,7,7,0,3,3,0,1,12,-9,-1,7,6,9,0,2,1,-1,1,1,6,1
KR_6765541902,420,0,60,25,-8,2,4,2,0,1,1,-8,3,11,-2,1,3,0,0,0,0,-16,24,-3,8,5,-2,0,0,-1,-1,-1,1,3,1
KR_6743679166,420,5,70,12,7,-1,1,2,3,4,1,4,4,0,2,2,0,-1,0,1,0,7,3,0,6,6,1,0,2,-1,1,1,-1,1,1
KR_6768790644,420,0,20,-24,4,0,4,4,4,7,3,-3,1,4,1,1,0,2,2,0,0,4,16,1,7,8,0,0,0,1,-1,1,1,1,1
KR_6774679568,420,0,-3,-32,5,-3,0,3,4,5,1,2,3,1,1,2,1,1,1,0,0,8,79,3,9,12,1,0,-1,-1,-1,-1,1,3,1
KR_6717341661,420,4,65,49,10,4,5,1,4,7,3,1,3,2,1,3,2,0,2,2,2,11,-3,-4,7,3,3,0,1,1,1,1,1,4,1
KR_6735720593,440,3,-21,30,0,-1,1,2,0,3,3,6,7,1,-4,4,8,-1,0,1,-1,2,-54,0,9,9,29,0,0,-1,1,-1,-1,3,1
KR_6776814792,420,4,67,17,13,1,1,0,5,5,0,4,6,2,6,6,0,-3,1,4,1,22,3,1,6,7,0,0,2,1,1,1,1,6,1
KR_6727259476,440,8,43,40,19,3,3,0,6,9,3,2,3,1,7,9,2,1,1,0,1,16,33,5,4,9,-4,0,2,1,1,1,1,3,1
KR_6771325169,420,-1,-11,7,-11,-2,0,2,0,3,3,-6,2,8,-3,0,3,0,1,1,0,-11,-34,-3,5,2,-3,0,0,1,-1,-1,1,2,1
KR_6776526430,440,3,54,24,8,2,2,0,2,3,1,-2,0,2,5,6,1,1,1,0,0,6,-46,-7,14,7,4,0,1,-1,1,1,1,1,1
KR_6758960306,440,0,3,28,-1,-1,2,3,1,3,2,-1,3,4,-2,3,5,2,2,0,-2,-11,19,5,3,8,0,0,0,1,1,0,1,6,1
KR_6763924620,420,1,65,-23,-1,3,5,2,-1,4,5,-2,2,4,0,0,0,-1,0,1,0,-2,-11,-2,6,4,3,0,1,-1,-1,1,-1,2,1
KR_6763803513,420,3,26,27,7,2,2,0,4,5,1,-2,5,7,0,3,3,3,3,0,0,11,9,2,5,7,-3,0,2,-1,1,1,1,3,1
KR_6770253141,420,5,63,43,13,2,3,1,2,3,1,6,7,1,4,4,0,-1,0,1,0,11,-1,0,7,7,4,0,2,1,1,1,-1,3,1
KR_6775061533,420,4,37,24,10,3,3,0,3,6,3,-1,4,5,4,5,1,1,1,0,0,6,-2,3,5,8,-2,0,1,1,1,1,1,5,1
KR_6737268615,420,-1,30,-31,5,-1,1,2,0,2,2,4,5,1,0,1,1,2,3,1,0,3,-16,0,6,6,0,0,0,-1,-1,0,1,6,1
KR_6752484000,440,3,43,12,-3,2,3,1,-1,2,3,-2,0,2,-4,3,7,2,4,2,0,-6,13,-8,12,4,2,0,2,-1,1,1,-1,5,1
KR_6775736261,420,3,23,-12,2,0,1,1,2,4,2,0,1,1,-1,3,4,1,3,2,0,10,1,0,6,6,3,0,1,1,1,1,-1,4,1
KR_6712826968,420,2,6,16,3,1,1,0,3,7,4,-3,0,3,-1,2,3,3,4,1,-1,9,11,-2,10,8,2,0,0,1,-1,1,-1,6,1
KR_6773384271,440,0,-46,-4,-1,1,1,0,3,3,0,-2,2,4,1,2,1,-4,0,4,0,2,-11,-4,5,1,-1,0,0,-1,0,0,1,3,1
KR_6753171704,420,7,111,23,14,3,3,0,3,3,0,3,5,2,6,7,1,-1,1,2,0,20,5,5,2,7,-1,0,2,1,-1,1,1,1,1
KR_6763296188,420,-4,2,-31,-11,0,1,1,-4,3,7,-3,0,3,-3,2,5,-1,1,2,-2,-7,-2,2,3,5,1,0,0,-1,1,1,-1,4,1
KR_6754946521,420,1,19,5,3,2,4,2,0,2,2,1,1,0,1,3,2,-1,0,1,1,1,12,0,6,6,-5,0,-1,1,1,-1,1,3,1
KR_6754522554,420,1,17,-15,8,1,1,0,4,6,2,3,6,3,-1,4,5,1,3,2,0,8,-20,-1,5,4,-1,0,0,1,-1,-1,1,3,1
KR_6764821181,420,4,-5,29,10,4,4,0,-1,1,2,3,3,0,6,8,2,-2,0,2,0,11,8,4,3,7,-1,0,1,1,-1,1,-1,1,1
KR_6742015755,440,4,84,-21,4,-2,5,7,1,1,0,1,3,2,4,5,1,0,4,4,0,0,-28,-1,3,2,-1,0,1,1,-1,-1,1,4,1
KR_6733331042,440,8,105,37,16,3,4,1,4,5,1,3,3,0,2,4,2,4,5,1,0,10,-2,2,4,6,0,0,2,1,-1,1,-1,2,1
KR_6759098564,420,1,-10,20,4,2,2,0,4,7,3,1,2,1,-3,0,3,0,0,0,0,6,3,-2,9,7,1,0,0,1,1,0,-1,6,1
KR_6697954484,420,1,36,32,-4,-2,2,4,-7,1,8,2,2,0,2,4,2,1,1,0,0,-14,-142,3,5,8,7,0,0,1,-1,0,-1,1,1
KR_6775867602,420,-1,-32,8,-5,-4,0,4,-1,1,2,0,2,2,0,1,1,0,1,1,0,-2,4,-1,8,7,3,0,0,-1,-1,0,-1,6,1
KR_6726068132,420,-1,-87,27,5,-1,2,3,2,3,1,3,4,1,0,2,2,1,1,0,0,5,-2,-6,10,4,7,0,0,1,1,1,-1,1,1
KR_6733344674,420,4,30,21,13,3,4,1,0,3,3,1,3,2,9,10,1,0,0,0,2,17,-7,-6,11,5,3,0,2,1,1,1,-1,3,1
KR_6770205615,440,4,132,24,5,2,2,0,-2,2,4,3,3,0,-1,3,4,3,3,0,0,0,-3,-6,10,4,10,0,0,-1,0,1,-1,3,1
KR_6693639501,420,2,5,8,7,1,5,4,2,4,2,1,6,5,3,6,3,0,2,2,0,7,15,2,5,7,-2,0,2,-1,1,1,1,3,1
KR_6759630548,440,-3,-36,-4,-5,-1,0,1,-1,2,3,-1,0,1,-1,1,2,-1,0,1,0,-7,-8,-3,7,4,-1,0,-1,-1,-1,-1,-1,5,1
KR_6770125836,420,3,-22,18,7,1,5,4,4,7,3,0,3,3,2,4,2,0,2,2,0,15,-5,0,4,4,4,0,0,1,1,-1,-1,4,1
KR_6751409226,420,3,7,31,7,0,1,1,3,5,2,0,0,0,3,4,1,1,2,1,0,8,-3,2,6,8,7,0,1,-1,1,1,1,2,1
