matchId,queueId,Diff_LV,Diff_CS,Diff_jglCS,Diff-K,Diff-K-top,K-WIN-top,K-LOSE-top,Diff-K-jug,K-WIN-jug,K-LOSE-jug,Diff-K-mid,K-WIN-mid,K-LOSE-mid,Diff-K-ad,K-WIN-ad,K-LOSE-ad,Diff-K-sup,K-WIN-sup,K-LOSE-sup,invadeKill,Diff-A,Diff_WARDplaced,Diff-ControlWARDplaced,LOSE_controlWARDPlaced,WIN_controlWARDPlaced,Diff_WARDkill,Diff_Inhibitor,Diff_TOWERkill,Diff_FirstDRAGON,Diff_FirstHERALD,Diff_Firsttower,Diff_FirstBLOOD,dragonType,result
KR_6765397720,420,1,73,-2,-2,-3,0,3,3,6,3,2,4,2,-1,1,2,-3,1,4,0,-6,-294,-2,8,6,4,0,0,1,-1,1,-1,4,1
KR_6765481053,420,-2,7,20,0,0,2,2,4,5,1,0,2,2,-3,2,5,-1,1,2,0,-4,-8,-4,5,1,0,0,1,-1,1,1,1,3,1
KR_6767440464,420,5,31,21,11,1,1,0,0,2,2,6,10,4,2,3,1,2,4,2,0,21,64,-2,6,4,4,0,0,1,-1,0,1,3,1
KR_6718843725,420,-1,4,-15,3,-2,1,3,6,10,4,1,2,1,0,3,3,-2,3,5,0,-4,-1,-6,6,0,4,0,0,1,-1,-1,1,5,1
KR_6677804298,420,1,39,13,9,4,6,2,3,3,0,0,3,3,1,3,2,1,2,1,0,15,-5,1,5,6,4,0,1,1,1,1,-1,5,1
KR_6748756901,420,2,63,-18,5,7,7,0,-2,0,2,1,2,1,2,6,4,-3,1,4,1,-7,-7,3,7,10,1,0,1,1,0,1,1,3,1
KR_6764174357,420,-1,36,-20,7,-2,0,2,6,8,2,4,5,1,0,2,2,-1,0,1,0,10,-1,0,5,5,3,0,1,-1,1,1,1,3,1
KR_6763044715,420,-1,8,-55,3,-1,5,6,1,5,4,1,2,1,2,6,4,0,1,1,0,8,-1,2,2,4,2,0,0,1,-1,0,1,1,1
KR_6769376190,420,0,-5,-21,-3,-7,0,7,2,4,2,2,5,3,1,1,0,-1,1,2,0,13,33,-3,5,2,-2,0,-1,-1,-1,-1,-1,3,1
KR_6757077688,420,4,84,24,7,0,0,0,1,4,3,2,4,2,3,4,1,1,3,2,0,10,-3,0,5,5,6,0,3,1,1,1,1,3,1
KR_6764903393,420,5,14,-11,2,0,2,2,3,4,1,-4,3,7,3,4,1,0,0,0,0,9,132,-3,9,6,26,0,0,1,-1,1,1,2,1
KR_6744200839,420,-4,-58,-34,-5,-4,0,4,-2,2,4,-5,1,6,4,6,2,2,3,1,0,3,-4,1,8,9,-1,0,-2,-1,-1,-1,-1,3,1
KR_6766479034,420,1,-8,-9,6,1,3,2,8,11,3,-1,1,2,0,1,1,-2,0,2,0,9,-3,3,3,6,2,0,-1,-1,1,-1,1,1,1
KR_6765849500,420,-2,-37,-11,-4,-7,0,7,3,5,2,-2,2,4,0,4,4,2,4,2,0,-7,-7,0,6,6,-1,0,1,-1,1,-1,-1,4,1
KR_6639348517,420,1,20,10,9,3,4,1,-1,0,1,0,2,2,8,9,1,-1,1,2,1,11,6,2,9,11,4,0,1,1,0,1,1,4,1
KR_6746062569,420,3,34,-5,12,1,4,3,-1,1,2,1,3,2,4,7,3,7,7,0,1,15,8,1,5,6,-2,0,1,1,1,1,1,2,1
KR_6769187513,420,2,4,-12,14,1,4,3,2,3,1,6,8,2,3,7,4,2,2,0,1,15,-11,2,5,7,-4,0,1,1,-1,1,1,1,1
KR_6613732166,420,6,64,20,13,0,1,1,6,8,2,2,3,1,3,4,1,2,2,0,1,18,77,4,5,9,-3,0,1,1,1,1,1,2,1
KR_6691827741,420,2,-25,6,6,2,4,2,-3,1,4,1,2,1,5,7,2,1,1,0,-1,0,15,1,8,9,0,0,-1,1,-1,-1,-1,3,1
KR_6769974327,420,4,26,16,11,4,4,0,0,1,1,5,5,0,2,3,1,0,2,2,0,7,6,4,2,6,-4,0,-1,1,1,-1,1,3,1
KR_6736402129,420,3,11,19,3,3,4,1,-2,3,5,-2,1,3,4,5,1,0,0,0,0,-1,2,-2,8,6,4,0,1,1,1,1,-1,2,1
KR_6749289671,420,7,211,-11,13,4,5,1,6,6,0,-1,1,2,3,3,0,1,1,0,0,17,13,0,5,5,1,0,4,1,-1,1,1,3,1
KR_6768317297,420,1,2,8,6,2,2,0,8,9,1,2,3,1,-6,4,10,0,1,1,0,2,-282,-1,7,6,-2,0,0,1,1,1,-1,2,1
KR_6713923844,420,4,-24,-2,5,3,3,0,-2,1,3,0,2,2,3,5,2,1,2,1,0,6,2,0,5,5,5,0,-1,1,-1,-1,-1,5,1
KR_6719879822,420,-2,-5,-12,-7,-2,1,3,-3,2,5,-1,1,2,0,0,0,-1,0,1,0,-11,-17,-8,10,2,3,0,0,1,-1,0,-1,2,1
KR_6769991644,440,-1,-20,-16,3,0,1,1,3,6,3,3,3,0,-1,0,1,-2,2,4,0,-2,-50,0,8,8,32,0,-2,-1,1,-1,1,4,1
KR_6767747897,420,4,-4,8,5,1,3,2,2,5,3,2,5,3,0,4,4,0,1,1,0,12,11,1,2,3,-1,0,-1,1,1,-1,1,5,1
KR_6748327501,420,0,6,-16,3,1,2,1,-1,2,3,1,2,1,2,3,1,0,0,0,0,4,31,5,4,9,-1,0,-1,1,-1,-1,1,1,1
KR_6743759095,420,5,51,24,12,0,0,0,6,7,1,3,5,2,1,4,3,2,2,0,0,11,-114,0,4,4,0,0,2,1,1,1,-1,2,1
KR_6736733160,420,0,-28,-1,2,-1,1,2,4,5,1,2,3,1,-3,0,3,0,1,1,0,0,9,-1,6,5,-3,0,0,1,-1,0,-1,6,1
KR_6740342540,420,3,-2,22,2,1,2,1,4,4,0,1,2,1,-4,0,4,0,1,1,0,-5,97,-3,4,1,0,0,0,1,-1,0,-1,1,1
KR_6763708053,420,-1,-36,20,1,-3,0,3,2,6,4,-4,1,5,4,6,2,2,2,0,0,8,4,3,5,8,-6,0,0,1,1,1,-1,5,1
KR_6732910641,420,0,-53,20,-2,3,7,4,-4,1,5,1,3,2,-1,3,4,-1,1,2,0,-2,0,-3,8,5,2,0,0,1,1,-1,-1,3,1
KR_6762960857,440,3,11,13,7,0,2,2,6,6,0,1,2,1,-1,1,2,1,2,1,0,5,-27,4,5,9,-3,0,3,1,1,1,1,1,1
KR_6768847046,420,-2,-114,-12,0,1,3,2,3,8,5,0,3,3,-2,1,3,-2,2,4,1,-1,2,4,5,9,2,0,0,-1,1,0,1,1,1
KR_6770189924,420,1,31,0,6,1,2,1,8,9,1,0,3,3,0,3,3,-3,0,3,0,5,18,1,6,7,-2,0,0,-1,-1,1,-1,2,1
KR_6752090859,420,3,64,-8,4,3,5,2,-1,0,1,-1,1,2,1,2,1,2,2,0,0,8,-10,-4,9,5,1,0,1,1,-1,1,-1,4,1
KR_6767260407,420,2,-9,4,1,-1,1,2,5,7,2,0,2,2,-4,1,5,1,3,2,-1,3,-5,-5,6,1,2,0,2,1,1,1,-1,1,1
KR_6747665893,420,-2,27,2,-1,2,2,0,-2,3,5,0,4,4,-2,1,3,1,1,0,0,-1,-2,1,6,7,1,0,0,-1,1,0,-1,5,1
KR_6588045065,420,-2,42,-23,-4,-1,1,2,0,1,1,-1,1,2,-2,3,5,0,1,1,0,-3,64,1,4,5,-15,0,-1,-1,1,1,-1,3,1
KR_6754473642,420,2,-29,10,2,-1,1,2,4,4,0,0,1,1,-1,4,5,0,0,0,0,5,-40,-4,9,5,3,0,0,-1,1,0,-1,2,1
KR_6597946915,420,0,-6,0,0,0,4,4,3,3,0,2,5,3,-4,1,5,-1,0,1,0,0,216,0,6,6,-1,0,2,1,-1,-1,-1,2,1
KR_6768505256,420,1,38,-10,5,2,2,0,2,4,2,6,10,4,-6,0,6,1,3,2,0,-3,-29,-6,8,2,1,0,0,1,-1,0,1,5,1
KR_6745228185,420,3,3,26,11,0,3,3,1,4,3,7,8,1,2,3,1,1,1,0,0,13,127,7,1,8,-1,0,3,1,0,1,-1,5,1
KR_6642881812,420,2,12,27,9,4,5,1,2,4,2,6,7,1,-4,1,5,1,1,0,0,7,-10,0,6,6,-4,0,1,1,1,1,-1,2,1
KR_6768540073,420,2,34,1,2,-3,0,3,3,5,2,-1,4,5,-2,2,4,5,5,0,0,-1,-114,-1,5,4,3,0,0,-1,1,0,-1,1,1
KR_6713025173,420,3,19,16,6,0,4,4,1,2,1,0,6,6,5,6,1,0,0,0,1,9,4,0,6,6,6,0,1,1,1,1,1,6,1
KR_6720416154,420,0,63,-16,6,-2,2,4,2,4,2,-1,1,2,3,5,2,4,4,0,0,13,-2,2,4,6,3,0,2,1,-1,1,1,5,1
KR_6679777722,440,0,-18,20,4,-1,2,3,2,5,3,0,2,2,2,3,1,1,4,3,0,4,-3,2,3,5,0,0,-1,-1,-1,-1,1,6,1
KR_6764856651,420,2,79,9,-1,0,1,1,3,4,1,-1,3,4,2,2,0,-5,0,5,0,0,7,5,1,6,1,0,1,1,-1,1,-1,6,1
KR_6681637084,420,1,-4,0,0,1,1,0,3,3,0,1,3,2,-1,4,5,-4,2,6,0,2,4,6,4,10,-2,0,1,1,1,1,1,4,1
KR_6764095496,420,2,47,14,0,-2,2,4,-4,0,4,6,7,1,0,0,0,0,0,0,0,2,26,4,4,8,-2,0,0,1,-1,0,-1,1,1
KR_6706137514,420,1,59,0,2,4,4,0,3,5,2,0,0,0,-6,0,6,1,1,0,0,7,3,-1,5,4,4,0,0,-1,1,0,-1,6,1
KR_6766167358,420,0,-34,15,-2,5,8,3,1,2,1,-3,1,4,-3,0,3,-2,0,2,0,-2,-4,0,4,4,-5,0,0,1,1,1,-1,6,1
KR_6758809918,420,2,1,-17,6,1,1,0,-2,2,4,2,6,4,4,4,0,1,1,0,0,19,2,5,2,7,-1,0,0,1,-1,0,-1,4,1
KR_6765916181,440,2,-3,31,6,-2,1,3,0,3,3,-1,1,2,1,1,0,8,9,1,0,8,3,3,2,5,9,0,1,1,1,1,1,4,1
KR_6768614826,420,2,-15,-9,9,0,1,1,2,5,3,1,1,0,5,6,1,1,1,0,0,9,120,-1,5,4,1,0,1,1,1,1,1,4,1
KR_6754525079,420,-2,-48,-8,-8,2,4,2,-3,1,4,-1,1,2,-5,0,5,-1,1,2,0,-16,-4,-2,7,5,0,0,0,1,1,1,1,2,1
KR_6634786410,420,-1,-29,16,-11,-7,0,7,-2,0,2,0,3,3,-2,3,5,0,2,2,0,-8,26,-1,9,8,-6,0,0,1,0,-1,-1,2,1
KR_6744637773,420,1,14,0,7,0,3,3,6,6,0,-3,1,4,3,5,2,1,1,0,0,16,2,0,5,5,-5,0,3,1,1,1,1,1,1
KR_6763413230,440,-3,-33,-4,-8,-5,0,5,0,1,1,-3,0,3,5,6,1,-5,0,5,0,-1,1,0,4,4,-2,0,-1,1,-1,-1,-1,4,1
KR_6766467729,420,3,68,4,12,-2,2,4,6,9,3,5,5,0,3,5,2,0,0,0,-1,18,-2,7,3,10,1,0,1,1,1,1,-1,4,1
KR_6768349586,420,4,125,-9,13,0,0,0,5,5,0,1,1,0,9,9,0,-2,0,2,0,24,-37,5,5,10,25,0,1,1,-1,1,1,5,1
KR_6770427382,420,2,-24,9,5,4,5,1,0,3,3,4,6,2,-1,1,2,-2,0,2,0,5,0,4,4,8,-1,0,-2,1,1,-1,1,3,1
KR_6761447977,420,-3,7,12,-1,-2,2,4,-3,4,7,2,4,2,4,6,2,-2,0,2,0,5,53,8,3,11,-29,0,-1,1,-1,-1,1,3,1
KR_6716081442,420,4,69,5,3,1,2,1,2,5,3,-2,1,3,2,4,2,0,3,3,0,3,4,-1,4,3,2,0,1,1,0,1,1,1,1
KR_6665275429,420,2,70,24,0,3,3,0,-1,0,1,-2,2,4,1,6,5,-1,1,2,-2,-11,-6,-1,6,5,2,0,1,-1,1,1,-1,6,1
KR_6746732410,420,-2,-32,19,3,3,4,1,2,5,3,-2,5,7,2,3,1,-2,0,2,0,7,2,2,3,5,-2,0,0,1,1,1,-1,6,1
KR_6684112919,440,0,-14,-24,-3,-4,2,6,-1,0,1,0,1,1,4,5,1,-2,3,5,1,-1,4,4,4,8,1,0,-1,1,-1,-1,1,5,1
KR_6745210065,420,-1,-51,12,-6,-6,2,8,-4,1,5,3,3,0,2,4,2,-1,0,1,-1,-1,-6,-2,8,6,8,0,-2,1,-1,-1,-1,5,1
KR_6733102085,420,0,1,7,-8,-1,0,1,-3,1,4,-4,0,4,0,3,3,0,0,0,-1,-12,-1,1,7,8,1,0,0,1,1,0,-1,2,1
KR_6760126166,420,1,28,-3,-1,-3,3,6,-3,1,4,1,2,1,3,4,1,1,1,0,1,-2,-11,-3,10,7,3,0,1,1,-1,1,1,6,1
KR_6707056082,420,1,2,19,7,2,3,1,1,3,2,4,5,1,0,0,0,0,1,1,0,5,2,-1,5,4,2,0,0,1,1,0,1,6,1
KR_6655307584,420,1,22,15,11,0,2,2,5,9,4,0,3,3,4,4,0,2,4,2,0,8,2,0,8,8,4,0,1,1,1,1,1,6,1
KR_6621590384,420,3,-4,-25,5,2,2,0,0,2,2,-1,2,3,4,4,0,0,0,0,0,12,5,-3,10,7,4,0,-1,1,-1,-1,1,3,1
KR_6763487396,420,3,52,16,9,1,3,2,6,7,1,2,3,1,2,3,1,-2,0,2,0,3,24,0,7,7,2,0,1,-1,1,1,1,1,1
KR_6766384085,420,0,-32,7,1,-4,0,4,4,4,0,2,3,1,-1,1,2,0,0,0,0,4,1,0,5,5,-2,0,-1,1,-1,-1,1,4,1
KR_6628540422,420,0,-9,17,3,0,2,2,5,8,3,-3,0,3,0,0,0,1,2,1,-2,4,26,1,8,9,2,0,-1,1,-1,-1,-1,2,1
KR_6667071606,420,0,25,24,3,0,1,1,-1,2,3,-2,1,3,4,4,0,2,3,1,0,6,23,2,2,4,-1,0,2,-1,-1,1,-1,2,1
KR_6769441591,420,1,-10,-16,11,-2,1,3,0,2,2,7,8,1,6,6,0,0,1,1,1,10,2,2,5,7,0,0,0,1,1,1,1,6,1
KR_6767952493,440,0,-63,-12,3,-1,1,2,4,7,3,0,3,3,0,2,2,0,4,4,-1,10,-8,-2,4,2,-1,0,1,-1,0,1,-1,2,1
KR_6770278689,420,0,-19,23,1,3,4,1,-4,0,4,-2,1,3,6,7,1,-2,1,3,0,-3,-7,-3,9,6,-1,0,0,-1,1,0,1,5,1
KR_6722244658,420,4,-3,-4,9,0,0,0,5,6,1,0,1,1,4,8,4,0,0,0,1,12,-2,-4,8,4,4,0,0,1,1,0,1,5,1
KR_6763335201,420,5,121,32,6,-1,1,2,-1,1,2,0,4,4,8,9,1,0,2,2,0,5,-3,0,6,6,3,0,1,1,-1,1,1,1,1
KR_6758632931,420,-4,-27,-16,-9,-2,3,5,-1,2,3,2,3,1,-6,1,7,-2,0,2,0,-10,-4,1,4,5,1,0,-1,1,-1,-1,1,3,1
KR_6697392879,420,2,40,32,10,2,4,2,7,9,2,0,2,2,1,6,5,0,0,0,0,17,-3,-1,6,5,4,0,1,1,1,1,1,1,1
KR_6678453588,420,2,0,-11,0,0,1,1,2,2,0,-1,1,2,-2,1,3,1,1,0,0,1,2,-2,4,2,-2,0,0,1,1,1,-1,4,1
KR_6554717272,420,-2,45,13,-6,-1,1,2,3,6,3,-3,0,3,-1,1,2,-4,0,4,0,-7,-1,-8,11,3,4,0,0,-1,1,0,1,1,1
KR_6763847741,420,2,74,20,2,2,2,0,-1,2,3,-2,1,3,3,4,1,0,2,2,0,-2,141,-3,6,3,2,0,0,-1,1,0,1,4,1
KR_6762131414,420,-3,-22,36,-1,4,4,0,-1,1,2,-1,0,1,-1,3,4,-2,2,4,-1,-8,0,-3,7,4,-5,0,-1,1,1,1,-1,3,1
KR_6756484991,420,2,31,-20,6,0,0,0,7,9,2,-3,3,6,2,3,1,0,0,0,0,17,8,2,5,7,3,0,0,1,1,1,-1,5,1
KR_6746056249,420,-1,12,16,3,-1,0,1,0,2,2,3,4,1,1,2,1,0,0,0,0,0,116,1,5,6,3,0,0,1,1,0,-1,4,1
KR_6767899856,420,-2,-14,-3,-7,0,3,3,-1,1,2,-7,4,11,0,2,2,1,1,0,0,-12,-1,-2,7,5,3,0,-1,-1,-1,-1,-1,6,1
KR_6760532232,420,1,30,-24,1,-3,0,3,0,2,2,1,2,1,3,5,2,0,0,0,0,7,10,-3,8,5,6,0,0,1,-1,0,-1,1,1
KR_6665129540,420,0,19,-4,-2,2,5,3,-2,1,3,-2,1,3,0,1,1,0,0,0,0,-3,26,1,4,5,-4,0,0,-1,-1,0,-1,6,1
KR_6765982308,420,2,96,-40,9,0,1,1,4,10,6,1,1,0,2,5,3,2,3,1,0,6,3,1,8,9,-7,0,2,-1,1,1,1,5,1
KR_6768159419,420,1,14,0,4,-5,0,5,4,6,2,0,2,2,5,6,1,0,0,0,-1,5,0,0,5,5,-3,0,0,0,1,1,-1,0,1
KR_6739338290,440,-2,-63,-59,4,0,1,1,3,4,1,-5,0,5,4,7,3,2,6,4,2,5,0,3,5,8,0,0,-2,-1,1,-1,1,3,1
KR_6695316180,420,2,-70,18,4,4,6,2,1,2,1,0,2,2,-5,1,6,4,4,0,0,0,24,3,3,6,0,0,1,1,1,1,1,2,1
KR_6763402682,420,-2,48,-12,-4,0,2,2,-3,2,5,0,3,3,-2,0,2,1,1,0,0,-17,-6,-2,4,2,-1,0,0,1,1,-1,1,4,1
KR_6765793734,420,0,-26,-32,-1,-2,1,3,0,2,2,2,4,2,-2,6,8,1,2,1,0,3,6,0,5,5,-3,0,-3,1,-1,-1,-1,3,1
KR_6724205903,420,6,103,9,7,5,6,1,1,2,1,3,4,1,0,3,3,-2,0,2,0,7,2,3,4,7,5,0,2,1,-1,1,1,3,1
KR_6767381438,420,1,-2,0,3,1,4,3,0,1,1,6,6,0,-4,0,4,0,0,0,0,0,2,0,7,7,-3,0,0,-1,-1,0,1,3,1
KR_6643568391,420,0,17,-16,-3,0,4,4,-1,2,3,0,2,2,1,3,2,-3,2,5,0,-6,-1,-1,5,4,2,0,0,-1,1,-1,1,4,1
KR_6740231286,420,-2,-6,-8,1,-2,1,3,2,4,2,3,3,0,-1,0,1,-1,1,2,0,4,24,2,6,8,-4,0,1,1,1,1,1,6,1
KR_6752345126,420,2,-22,-25,3,0,0,0,6,8,2,-2,1,3,-2,2,4,1,1,0,-2,0,2,1,5,6,-3,0,0,-1,1,1,-1,2,1
KR_6768212763,420,1,11,11,3,-2,0,2,3,7,4,0,2,2,-2,1,3,4,4,0,0,7,-1,4,4,8,-4,0,1,1,1,1,1,5,1
KR_6758561561,420,-1,-50,-22,-5,-6,1,7,-3,2,5,3,4,1,-2,1,3,3,4,1,0,5,-13,-2,6,4,-3,0,-3,-1,1,-1,1,5,1
KR_6693974671,420,1,54,4,7,1,1,0,2,3,1,-3,1,4,5,8,3,2,2,0,1,10,36,1,4,5,0,0,3,1,1,1,1,3,1
KR_6757956940,440,1,20,-12,-1,2,3,1,-7,0,7,0,2,2,3,5,2,1,2,1,-1,-2,7,1,1,2,-3,0,0,1,-1,-1,-1,1,1
KR_6739107294,420,2,22,24,7,1,5,4,-3,3,6,4,4,0,4,5,1,1,1,0,2,16,7,2,5,7,-4,0,1,0,1,1,1,0,1
KR_6762195424,420,3,49,8,1,2,3,1,0,2,2,-2,1,3,0,1,1,1,1,0,1,1,12,2,2,4,-1,0,0,0,-1,0,1,0,1
KR_6769538052,420,1,-56,6,6,-1,0,1,4,5,1,1,3,2,2,5,3,0,1,1,0,10,-3,-1,6,5,0,0,-1,1,-1,-1,1,2,1
KR_6762850636,440,-1,-41,15,2,-1,0,1,1,4,3,1,3,2,-2,2,4,3,3,0,1,2,27,-2,7,5,2,0,-1,-1,-1,-1,1,3,1
KR_6741518947,420,3,54,7,9,8,8,0,1,2,1,2,3,1,-2,3,5,0,0,0,1,7,-121,-1,6,5,3,0,0,1,1,1,1,6,1
KR_6767998771,420,0,13,12,6,10,13,3,-1,3,4,0,4,4,-4,2,6,1,1,0,0,1,11,3,4,7,2,0,3,-1,1,1,-1,1,1
KR_6730143365,420,6,103,8,13,1,6,5,-2,3,5,1,2,1,2,3,1,11,12,1,0,12,29,-6,9,3,5,0,3,-1,1,1,1,2,1
KR_6762788684,440,2,91,25,-3,0,5,5,4,5,1,-4,0,4,0,0,0,-3,1,4,0,-16,1,-2,7,5,-3,0,2,1,1,1,-1,6,1
KR_6722262886,420,1,-31,4,-3,-3,0,3,1,5,4,-4,0,4,1,2,1,2,3,1,0,3,-36,-1,8,7,25,0,0,1,1,1,-1,5,1
KR_6646526639,420,6,106,-4,13,4,5,1,1,6,5,2,4,2,6,6,0,0,0,0,0,7,20,0,4,4,5,0,1,0,0,1,1,0,1
KR_6748067467,420,0,48,-27,-1,-3,1,4,4,7,3,-3,2,5,2,2,0,-1,0,1,-2,-1,2,-4,8,4,4,0,2,1,-1,1,-1,5,1
KR_6715043619,420,6,3,24,10,5,5,0,0,3,3,5,5,0,0,0,0,0,0,0,0,2,-32,2,3,5,12,0,2,-1,1,1,1,2,1
KR_6734125256,420,3,48,-1,8,0,4,4,1,2,1,6,6,0,1,2,1,0,0,0,0,8,-26,1,3,4,16,0,0,-1,-1,1,-1,1,1
KR_6768772354,420,-1,-30,16,1,-3,2,5,-1,6,7,2,4,2,3,4,1,0,0,0,0,6,5,3,2,5,1,0,1,1,-1,1,-1,1,1
KR_6769066368,420,-2,-42,-11,-1,-1,1,2,0,2,2,1,2,1,0,1,1,-1,1,2,0,-2,109,-2,5,3,-1,0,-1,-1,-1,-1,-1,3,1
KR_6770097018,420,-3,-70,-40,-5,-2,0,2,-2,2,4,-1,2,3,6,7,1,-6,1,7,0,6,6,5,2,7,-8,0,-1,1,-1,-1,-1,6,1
KR_6742368508,420,5,78,-9,10,4,4,0,3,6,3,0,6,6,3,5,2,0,1,1,1,6,3,0,5,5,-1,0,0,-1,1,1,1,1,1
KR_6765843169,440,5,56,6,8,-1,3,4,3,6,3,1,4,3,4,4,0,1,1,0,0,11,-2,-4,6,2,-4,0,0,1,-1,1,-1,4,1
KR_6762348588,420,1,39,15,8,5,5,0,2,4,2,2,3,1,-2,4,6,1,1,0,0,3,1,2,6,8,9,0,1,-1,1,1,1,4,1
KR_6729404569,420,7,-2,55,9,-1,1,2,0,1,1,2,5,3,7,7,0,1,1,0,0,10,8,3,3,6,-4,0,1,1,-1,1,-1,1,1
KR_6712287782,420,0,38,-8,3,-1,1,2,0,2,2,1,1,0,3,3,0,0,1,1,2,3,-2,3,2,5,4,0,1,1,-1,1,1,3,1
KR_6759004989,420,7,55,10,17,-3,2,5,6,7,1,5,5,0,6,6,0,3,4,1,0,21,3,1,5,6,-1,0,2,1,-1,-1,1,1,1
KR_6766031951,420,3,80,29,1,2,2,0,-6,2,8,-1,3,4,5,7,2,1,3,2,0,-3,2,-1,8,7,8,0,2,-1,1,1,1,1,1
KR_6668507239,420,2,46,-16,4,0,2,2,-1,3,4,-1,1,2,4,4,0,2,2,0,0,12,-15,3,3,6,5,0,1,1,1,1,-1,2,1
KR_6769003569,420,0,26,35,-1,0,2,2,2,4,2,0,1,1,-2,0,2,-1,0,1,0,-6,28,-4,8,4,-29,0,1,1,1,1,-1,1,1
KR_6747785208,420,4,0,17,7,0,1,1,8,9,1,2,3,1,-2,2,4,-1,0,1,0,9,6,1,6,7,0,0,-1,-1,0,-1,-1,2,1
KR_6708039704,420,2,65,11,9,3,4,1,0,4,4,2,4,2,2,3,1,2,2,0,0,12,36,-2,8,6,0,0,3,-1,1,1,1,5,1
KR_6757737543,420,-2,-22,-21,3,5,7,2,-2,3,5,-3,0,3,3,4,1,0,1,1,0,3,16,0,5,5,0,0,0,1,-1,-1,-1,1,1
KR_6685797387,420,3,29,2,0,0,3,3,-3,0,3,-1,0,1,3,4,1,1,1,0,0,-4,-28,4,3,7,0,0,0,1,0,1,-1,2,1
KR_6769657403,420,4,41,11,7,2,2,0,3,5,2,0,2,2,1,3,2,1,2,1,-1,4,1,-1,6,5,-1,0,1,0,1,1,-1,0,1
KR_6763582618,420,6,77,12,12,5,6,1,1,3,2,3,3,0,5,6,1,-2,0,2,0,11,-1,4,3,7,8,0,2,1,-1,1,1,3,1
KR_6770199714,420,0,31,-8,-3,1,2,1,-2,0,2,1,2,1,-1,2,3,-2,1,3,1,0,2,0,3,3,-3,0,0,-1,-1,-1,1,4,1
KR_6740126757,420,0,34,4,-6,0,0,0,-2,2,4,3,4,1,-5,1,6,-2,2,4,0,-13,-7,-2,7,5,4,0,-1,1,1,1,-1,4,1
KR_6705007104,420,1,-17,-24,-1,-2,2,4,5,7,2,-6,1,7,1,3,2,1,4,3,0,-6,-5,1,5,6,4,0,-1,-1,-1,-1,-1,6,1
KR_6757982077,420,-3,-67,10,-9,-3,1,4,1,4,3,-1,2,3,-5,2,7,-1,0,1,0,-7,-4,0,7,7,-4,0,-1,0,1,-1,-1,0,1
KR_6728582030,420,-1,11,26,2,3,3,0,3,4,1,-5,1,6,2,6,4,-1,1,2,0,-6,-16,3,9,12,-3,0,0,-1,1,-1,1,4,1
KR_6675488124,420,2,54,-18,4,-1,1,2,0,5,5,3,6,3,3,3,0,-1,0,1,0,5,-9,-3,5,2,0,0,1,1,0,1,1,5,1
KR_6741915470,420,2,-23,24,0,-2,1,3,5,7,2,-2,2,4,-1,0,1,0,0,0,0,0,26,-4,6,2,-4,0,0,-1,1,0,-1,3,1
KR_6770004019,420,-1,-34,-3,-4,-3,2,5,4,8,4,-3,1,4,2,3,1,-4,0,4,-1,-6,-7,-7,10,3,-1,0,-1,1,-1,-1,-1,5,1
KR_6723312929,420,2,28,3,-5,-2,4,6,-4,4,8,-1,3,4,2,6,4,0,1,1,-1,-8,-4,3,4,7,1,0,2,-1,1,1,-1,6,1
KR_6668155031,420,1,35,-4,2,0,4,4,2,4,2,0,2,2,0,2,2,0,1,1,0,2,-14,-3,8,5,5,0,-1,1,-1,-1,1,3,1
KR_6769952367,420,5,104,33,8,3,3,0,0,3,3,0,3,3,3,4,1,2,2,0,0,4,29,1,3,4,0,0,1,1,1,1,-1,1,1
KR_6757505374,440,3,74,49,6,0,3,3,-2,1,3,5,7,2,3,5,2,0,0,0,1,1,-110,-2,4,2,-1,0,1,1,1,1,1,4,1
KR_6747807521,420,-2,-25,-31,1,1,4,3,-1,3,4,-1,2,3,1,3,2,1,1,0,-1,5,-7,-5,7,2,-4,0,1,-1,-1,1,-1,2,1
KR_6703005948,420,-1,54,0,-7,2,3,1,-4,1,5,2,3,1,-4,1,5,-3,0,3,0,-13,-12,-5,9,4,2,0,3,-1,1,1,1,2,1
KR_6711534350,420,-1,-59,13,-4,-3,3,6,0,0,0,-1,0,1,-2,1,3,2,3,1,0,4,9,-2,7,5,-5,0,-1,1,-1,-1,1,2,1
KR_6768876977,420,5,22,18,18,2,4,2,4,5,1,2,3,1,6,8,2,4,4,0,0,25,-2,-2,5,3,7,0,2,1,1,1,1,6,1
KR_6761407485,440,1,74,7,-3,1,2,1,-1,2,3,-2,0,2,-1,1,2,0,0,0,0,-4,-2,1,2,3,2,0,1,1,1,1,1,6,1
KR_6763128745,420,5,17,18,12,4,5,1,5,5,0,-1,2,3,6,6,0,-2,0,2,0,7,0,4,6,10,1,0,1,1,1,1,1,3,1
KR_6695578463,420,2,63,-11,7,0,3,3,-1,1,2,3,4,1,2,3,1,3,3,0,1,7,-23,-2,7,5,-2,0,-1,1,-1,-1,1,4,1
KR_6759011971,420,2,76,24,8,1,2,1,2,2,0,1,2,1,2,5,3,2,3,1,0,14,-15,-3,11,8,-1,0,1,-1,1,1,1,1,1
KR_6670739327,420,-1,-46,-5,3,2,4,2,2,2,0,-1,1,2,2,4,2,-2,0,2,0,12,-1,4,4,8,-2,0,0,-1,1,1,-1,3,1
KR_6770261652,420,0,-50,-4,1,-3,0,3,0,1,1,1,2,1,3,3,0,0,0,0,0,8,-6,2,5,7,0,0,0,1,-1,0,1,6,1
KR_6633808243,420,1,40,12,4,1,3,2,-3,1,4,-3,2,5,7,8,1,2,3,1,0,5,2,2,3,5,1,0,0,1,-1,0,1,2,1
KR_6767877460,420,-1,61,-7,4,2,4,2,3,5,2,0,1,1,-1,1,2,0,0,0,0,7,-74,4,3,7,23,0,-1,1,-1,-1,-1,2,1
KR_6743260675,420,0,-15,26,-6,1,1,0,0,4,4,-3,0,3,-3,0,3,-1,0,1,0,-2,-9,2,5,7,7,0,1,-1,1,1,-1,4,1
KR_6769849498,420,-1,-17,21,-1,-4,2,6,4,5,1,-3,1,4,2,3,1,0,0,0,0,4,-4,-5,9,4,2,0,-1,1,-1,-1,-1,5,1
KR_6748418765,420,-3,-33,20,-4,-1,0,1,-5,0,5,0,1,1,2,2,0,0,0,0,0,-6,4,2,5,7,-3,0,-2,1,1,-1,1,6,1
KR_6751056653,420,8,71,38,11,3,5,2,1,5,4,6,8,2,1,3,2,0,0,0,-1,-2,290,-1,7,6,5,0,2,1,-1,1,-1,6,1
KR_6762373909,420,4,-41,44,1,2,3,1,6,7,1,-2,0,2,-1,0,1,-4,0,4,0,0,6,2,5,7,-2,0,-2,-1,-1,-1,-1,6,1
KR_6697710377,420,-1,21,-8,-3,0,0,0,3,6,3,1,2,1,-5,4,9,-2,1,3,0,1,-10,-4,9,5,5,0,0,1,1,0,1,6,1
KR_6756374234,420,1,17,-22,7,1,1,0,1,3,2,2,3,1,3,5,2,0,0,0,0,8,1,-2,8,6,5,0,1,1,1,1,1,4,1
KR_6748411296,420,2,11,-12,2,1,3,2,0,5,5,-1,2,3,1,2,1,1,1,0,0,3,7,6,4,10,-3,0,0,-1,1,0,1,4,1
KR_6700048607,420,1,36,-32,4,-1,1,2,-1,1,2,3,3,0,4,7,3,-1,0,1,0,6,11,-1,6,5,2,0,0,1,-1,1,1,5,1
KR_6713866537,420,-1,3,-16,2,-2,1,3,2,4,2,2,4,2,1,2,1,-1,0,1,1,1,-6,0,4,4,-2,0,0,1,1,0,1,4,1
KR_6730037964,420,3,81,22,4,-3,1,4,1,5,4,4,8,4,3,6,3,-1,2,3,0,13,-85,0,4,4,5,0,2,1,1,1,1,4,1
KR_6699679370,420,1,43,8,-5,-5,0,5,2,5,3,-3,3,6,2,2,0,-1,0,1,0,-3,-56,2,3,5,35,0,-1,1,-1,-1,-1,2,1
KR_6718724688,420,2,78,-16,13,4,8,4,0,3,3,4,5,1,3,4,1,2,4,2,0,7,223,-3,5,2,0,0,2,1,-1,1,1,5,1
KR_6760984648,420,5,17,20,11,1,3,2,6,9,3,5,8,3,-2,1,3,1,1,0,0,10,-12,-4,8,4,1,0,0,-1,1,1,1,3,1
KR_6558632667,420,4,63,21,4,4,5,1,1,4,3,2,4,2,-4,2,6,1,1,0,-1,-8,-8,0,6,6,1,0,2,-1,1,-1,-1,1,1
KR_6770267557,420,-1,60,5,-1,1,3,2,2,4,2,0,3,3,-3,0,3,-1,0,1,2,5,4,2,3,5,-2,0,1,-1,-1,1,1,5,1
KR_6770201229,420,2,13,36,-1,-1,1,2,-4,2,6,-1,2,3,7,7,0,-2,0,2,-1,-1,22,0,6,6,-7,0,1,1,-1,-1,-1,3,1
KR_6730163315,420,-1,-23,31,4,1,2,1,3,7,4,2,5,3,-3,0,3,1,3,2,0,5,-9,-6,10,4,4,0,-1,1,1,-1,1,1,1
KR_6664462321,420,6,81,12,12,0,1,1,9,9,0,1,2,1,1,4,3,1,2,1,0,15,-3,2,4,6,3,0,0,-1,1,1,1,6,1
KR_6761822192,420,0,3,-4,5,1,1,0,4,4,0,0,0,0,0,3,3,0,1,1,1,6,0,-2,8,6,6,0,0,-1,-1,0,1,5,1
KR_6714555758,420,4,62,16,10,0,3,3,0,2,2,5,8,3,6,9,3,-1,0,1,0,-6,1,-3,5,2,1,0,3,-1,1,1,1,6,1
KR_6756080941,420,3,58,25,6,2,4,2,5,5,0,2,5,3,-2,0,2,-1,4,5,0,1,-9,2,3,5,2,0,0,1,1,1,-1,4,1
KR_6767297801,420,1,-20,-13,8,4,4,0,0,3,3,-2,3,5,7,8,1,-1,1,2,0,2,-17,1,5,6,3,0,1,-1,1,1,1,5,1
KR_6660464533,420,0,-19,16,1,2,4,2,-1,0,1,-1,1,2,0,2,2,1,1,0,0,4,-10,-2,6,4,3,0,-1,-1,-1,-1,-1,6,1
KR_6769868774,440,2,37,20,7,2,2,0,2,4,2,4,6,2,-3,3,6,2,2,0,0,-2,1,-1,6,5,1,0,2,-1,1,1,1,4,1
KR_6743251127,420,1,20,0,8,-1,1,2,5,8,3,-1,0,1,2,6,4,3,5,2,3,19,21,0,6,6,-1,0,0,-1,1,1,1,6,1
KR_6766835116,420,-3,-12,8,2,-5,1,6,3,5,2,0,2,2,5,5,0,-1,0,1,1,5,-6,-1,5,4,-5,0,0,1,-1,1,1,2,1
KR_6761023466,420,3,16,7,9,1,4,3,3,4,1,2,3,1,3,3,0,0,1,1,2,17,72,-1,7,6,0,0,-1,1,-1,-1,1,2,1
KR_6591932945,420,2,-24,-23,9,1,1,0,2,7,5,3,4,1,1,2,1,2,3,1,0,8,-25,3,3,6,2,0,0,1,-1,0,1,1,1
KR_6660560411,420,6,58,16,9,-1,1,2,8,9,1,4,5,1,-2,2,4,0,1,1,0,17,44,-1,4,3,-12,0,1,1,-1,1,1,2,1
KR_6689101801,420,1,-33,24,-3,6,8,2,-1,4,5,0,2,2,-2,2,4,-6,1,7,-1,-7,-13,-6,11,5,12,0,-2,-1,1,-1,1,5,1
KR_6752319915,420,2,53,8,-4,-2,1,3,-5,0,5,1,2,1,-1,1,2,3,4,1,-1,-6,-23,3,3,6,-1,0,0,-1,0,0,-1,2,1
KR_6768167346,420,2,47,-18,3,-2,1,3,-3,1,4,0,2,2,3,3,0,5,6,1,2,4,-5,-6,8,2,0,0,2,0,-1,1,1,0,1
KR_6770387765,420,0,21,11,4,0,0,0,4,4,0,1,1,0,1,2,1,-2,2,4,0,1,0,4,2,6,1,0,1,1,1,1,1,2,1
KR_6722044280,420,1,-29,-12,3,2,4,2,1,3,2,0,5,5,1,2,1,-1,0,1,0,-10,-2,0,7,7,4,0,1,-1,1,1,1,1,1
KR_6763531373,420,2,36,-14,5,0,1,1,3,3,0,2,5,3,1,1,0,-1,0,1,-1,1,0,1,8,9,-2,0,2,1,1,1,-1,2,1
KR_6753372410,420,7,92,1,14,2,3,1,2,4,2,3,3,0,7,8,1,0,2,2,1,22,10,3,3,6,0,0,2,-1,1,1,1,3,1
KR_6754494509,420,-2,15,-10,-2,0,1,1,-1,5,6,3,3,0,-3,1,4,-1,1,2,-1,-8,344,6,5,11,0,0,0,1,1,1,-1,2,1
KR_6759335248,420,-1,34,-2,-4,-1,1,2,-2,2,4,0,1,1,2,4,2,-3,0,3,0,-3,64,1,4,5,-21,0,0,1,1,0,-1,3,1
KR_6758662521,420,-1,-100,23,-6,0,2,2,-4,1,5,0,6,6,1,2,1,-3,1,4,0,-13,-20,-3,6,3,-5,0,-2,0,-1,-1,-1,0,1
KR_6665580206,420,8,43,52,12,6,6,0,3,6,3,6,7,1,0,1,1,-3,0,3,3,10,30,-2,6,4,0,0,3,1,-1,1,1,5,1
KR_6712397829,420,0,45,-9,2,-3,0,3,2,5,3,-1,3,4,6,9,3,-2,1,3,0,-3,1,2,5,7,-2,0,-1,1,-1,-1,1,6,1
KR_6744824139,440,3,37,-3,1,-3,0,3,5,6,1,0,3,3,-2,0,2,1,1,0,0,1,6,0,4,4,2,0,2,-1,1,1,-1,5,1
KR_6691729101,420,2,21,-7,2,-4,1,5,3,4,1,2,3,1,1,4,3,0,0,0,-2,5,-7,-1,5,4,7,0,1,-1,1,1,-1,3,1
KR_6738443313,420,-1,13,1,-6,-2,1,3,0,4,4,-6,1,7,2,2,0,0,3,3,0,1,7,1,7,8,-2,0,1,-1,1,1,-1,6,1
KR_6748665584,420,4,13,32,7,5,5,0,0,1,1,0,3,3,1,3,2,1,1,0,0,4,-5,0,4,4,-4,0,1,1,1,1,-1,6,1
KR_6759575911,420,0,6,8,-3,1,3,2,-3,1,4,-2,1,3,2,3,1,-1,0,1,0,-10,7,4,3,7,-5,0,-1,-1,1,1,1,1,1
KR_6765544942,420,-2,43,-9,-2,2,2,0,-2,1,3,-1,3,4,0,4,4,-1,0,1,0,-2,7,4,7,11,-2,0,0,-1,1,1,-1,5,1
KR_6658871890,420,-2,43,-40,-4,1,2,1,-5,1,6,-4,0,4,2,3,1,2,3,1,0,-7,-90,-3,6,3,-2,0,-1,1,-1,-1,1,2,1
KR_6765744082,420,2,-17,1,5,-3,0,3,3,3,0,0,5,5,4,5,1,1,1,0,1,15,-4,5,3,8,-4,0,-2,1,-1,-1,1,1,1
KR_6762002692,420,4,78,35,8,1,3,2,0,2,2,2,3,1,1,2,1,4,5,1,1,10,-9,-3,8,5,8,0,2,-1,1,1,1,4,1
KR_6744248528,420,0,-30,4,7,0,3,3,0,6,6,5,5,0,3,4,1,-1,1,2,0,7,14,-2,5,3,4,0,-1,-1,1,-1,-1,6,1
KR_6732896776,420,4,56,4,12,3,3,0,3,4,1,5,6,1,0,2,2,1,1,0,0,9,-15,1,4,5,4,0,0,1,1,1,1,1,1
KR_6740579775,420,1,26,-5,4,4,5,1,-7,1,8,4,8,4,6,9,3,-3,0,3,0,-8,-33,-4,8,4,1,0,0,1,1,1,1,5,1
KR_6709096098,420,3,22,0,3,0,1,1,-2,5,7,1,3,2,-4,2,6,8,9,1,2,11,5,2,3,5,0,0,1,1,-1,1,1,4,1
KR_6754402271,440,4,111,55,7,0,3,3,1,3,2,0,4,4,7,10,3,-1,2,3,0,8,1,0,5,5,-2,0,0,1,-1,-1,-1,1,1
KR_6754330131,420,1,45,20,-1,-1,0,1,1,3,2,2,4,2,-4,0,4,1,1,0,0,0,30,0,5,5,-34,0,0,1,0,0,-1,3,1
KR_6767145591,440,1,9,28,5,6,6,0,-2,3,5,-1,1,2,6,7,1,-4,0,4,0,-3,-4,5,2,7,-1,0,-1,1,1,-1,1,5,1
KR_6770205082,440,5,64,-12,8,-3,0,3,5,5,0,-2,0,2,-1,0,1,9,10,1,0,7,4,4,3,7,0,0,0,-1,1,1,-1,6,1
KR_6751283177,440,2,47,33,0,5,5,0,-3,2,5,-4,3,7,4,7,3,-2,1,3,1,5,0,1,8,9,3,0,1,-1,1,1,1,2,1
KR_6747002818,420,-1,6,7,3,-3,1,4,2,4,2,4,8,4,0,4,4,0,0,0,0,6,-3,-3,8,5,3,0,-1,1,-1,-1,1,4,1
KR_6736913965,420,0,16,-2,4,0,0,0,4,7,3,4,5,1,-6,2,8,2,4,2,0,-3,-109,2,6,8,1,0,0,-1,1,1,1,3,1
KR_6694669566,420,2,33,24,0,2,2,0,-1,4,5,-1,0,1,0,1,1,0,3,3,0,0,-115,2,6,8,-4,0,1,1,1,1,-1,2,1
KR_6769433439,420,-1,3,-1,-1,2,2,0,2,4,2,-4,1,5,-1,5,6,0,0,0,0,0,-13,3,6,9,11,0,-1,-1,1,-1,1,1,1
KR_6748804570,420,3,30,-4,6,1,3,2,-2,4,6,3,3,0,4,5,1,0,0,0,0,9,-3,1,2,3,0,0,2,1,0,1,1,1,1
KR_6753144471,420,0,45,-44,-1,-2,1,3,-4,0,4,2,5,3,1,1,0,2,2,0,0,7,-100,4,6,10,-5,0,-1,1,-1,-1,1,1,1
KR_6538836588,420,0,42,-12,-1,1,3,2,0,3,3,4,4,0,-5,0,5,-1,0,1,0,-7,-7,-1,6,5,3,0,-2,1,-1,-1,1,4,1
KR_6759216531,420,1,-50,7,9,1,2,1,2,6,4,6,6,0,0,2,2,0,1,1,0,7,-16,8,1,9,0,0,0,1,-1,1,1,3,1
KR_6758661866,420,-1,55,0,-2,0,2,2,-3,0,3,-5,4,9,6,6,0,0,0,0,0,-3,-2,-1,5,4,-2,0,0,1,-1,-1,-1,5,1
KR_6747172586,420,4,92,-6,5,2,3,1,-1,1,2,5,8,3,2,3,1,-3,0,3,0,0,-165,-3,7,4,24,0,2,1,1,1,1,5,1
KR_6754261006,420,2,54,8,9,1,3,2,5,7,2,-1,2,3,2,3,1,2,2,0,0,8,-8,0,6,6,5,0,1,-1,1,1,1,3,1
KR_6763252445,440,0,-25,-20,3,4,4,0,-4,1,5,1,4,3,1,1,0,1,1,0,-1,7,2,3,4,7,-2,0,-1,-1,-1,-1,-1,5,1
KR_6766892276,420,1,-45,-16,5,0,2,2,1,1,0,0,3,3,1,4,3,3,3,0,0,6,-2,-5,7,2,2,0,0,1,-1,1,1,5,1
KR_6766841024,420,3,31,54,2,0,1,1,-3,0,3,3,4,1,0,2,2,2,3,1,0,-1,-10,0,3,3,-2,0,2,-1,1,1,1,5,1
KR_6722098532,420,2,79,28,3,-2,0,2,1,5,4,1,4,3,3,3,0,0,2,2,0,8,-5,0,5,5,-1,0,1,1,1,1,1,2,1
KR_6763261724,420,-3,-68,19,-8,-4,3,7,-3,2,5,0,1,1,-2,0,2,1,2,1,0,-9,-116,-3,7,4,-3,0,-1,1,-1,-1,1,4,1
KR_6769377373,420,0,-38,8,2,-1,1,2,0,4,4,0,5,5,2,2,0,1,1,0,0,6,6,6,3,9,-2,0,-1,1,1,-1,-1,5,1
KR_6734981141,420,2,12,-2,10,3,4,1,6,6,0,-2,1,3,2,4,2,1,1,0,0,19,8,4,4,8,0,0,0,1,-1,-1,-1,6,1
KR_6761367799,420,6,55,21,7,-1,1,2,3,7,4,3,5,2,2,4,2,0,1,1,0,3,277,0,6,6,-3,0,-1,1,-1,-1,1,6,1
KR_6634935868,420,0,16,24,-2,-1,1,2,0,4,4,1,2,1,-1,2,3,-1,1,2,0,-2,-33,-2,8,6,-4,0,0,-1,1,0,1,6,1
KR_6754527739,420,1,-18,19,-2,-6,0,6,4,6,2,0,2,2,-3,4,7,3,4,1,-2,4,-9,-1,7,6,2,0,1,0,1,1,-1,0,1
KR_6708548676,420,9,121,8,24,8,9,1,3,5,2,2,5,3,10,10,0,1,2,1,0,21,8,6,1,7,2,0,5,0,-1,1,1,0,1
KR_6745804355,420,7,56,36,17,5,6,1,3,6,3,5,6,1,3,5,2,1,1,0,0,25,-31,1,5,6,20,0,2,1,-1,1,1,4,1
KR_6736367759,420,3,17,24,5,6,8,2,2,4,2,2,5,3,-2,1,3,-3,0,3,0,-4,1,-4,8,4,-4,0,1,1,1,1,1,3,1
KR_6748711978,420,2,14,-3,5,2,2,0,2,3,1,2,2,0,-1,3,4,0,0,0,0,5,11,-5,10,5,1,0,2,0,1,1,-1,0,1
KR_6705948610,420,0,11,5,-3,1,1,0,-1,1,2,-1,1,2,-2,0,2,0,0,0,0,-5,43,3,3,6,1,0,1,1,1,1,-1,2,1
KR_6769798707,420,4,72,-4,4,0,2,2,1,2,1,0,1,1,1,2,1,2,2,0,0,8,-1,1,4,5,2,0,0,1,1,1,1,1,1
KR_6765972895,420,0,17,8,-1,0,4,4,2,2,0,-2,1,3,1,4,3,-2,0,2,0,-1,6,8,3,11,-3,0,1,1,1,1,1,4,1
KR_6584459214,440,0,-16,13,1,-2,2,4,0,3,3,1,2,1,3,4,1,-1,0,1,0,6,7,3,2,5,-3,0,0,0,1,0,1,0,1
KR_6762536768,440,-1,-8,20,2,-1,4,5,-2,2,4,0,4,4,5,6,1,0,2,2,2,-9,17,1,6,7,-2,0,1,1,1,1,1,2,1
KR_6671692892,420,3,30,16,12,5,5,0,3,5,2,1,4,3,3,4,1,0,1,1,3,16,-24,-2,8,6,-3,0,1,-1,1,1,1,3,1
KR_6765271798,420,9,72,72,16,5,6,1,2,3,1,9,9,0,1,3,2,-1,1,2,1,17,7,4,3,7,6,0,3,1,1,1,1,4,1
KR_6734921722,420,5,-28,12,11,2,3,1,6,6,0,2,3,1,2,4,2,-1,1,2,0,20,-11,1,6,7,-2,0,1,1,-1,1,-1,1,1
KR_6769151223,420,1,63,8,3,3,5,2,-2,1,3,-2,1,3,2,3,1,2,2,0,0,0,6,9,3,12,0,0,0,1,-1,0,-1,1,1
KR_6764776415,420,0,-15,10,7,1,1,0,3,4,1,2,3,1,3,3,0,-2,1,3,0,9,187,5,3,8,-6,0,2,1,1,1,1,4,1
KR_6710302426,420,2,43,24,-11,0,2,2,-1,2,3,-1,2,3,-8,0,8,-1,1,2,0,-8,140,-2,4,2,1,0,1,0,-1,1,-1,0,1
KR_6738866535,420,-2,23,11,1,0,2,2,-2,0,2,3,3,0,-1,0,1,1,2,1,0,-1,27,1,5,6,4,0,-1,-1,0,-1,-1,5,1
KR_6767564356,420,1,78,34,-3,1,5,4,1,2,1,-1,1,2,-3,0,3,-1,0,1,-1,-3,3,-1,5,4,2,0,1,1,1,1,-1,4,1
KR_6756112597,420,1,-28,12,-6,-1,2,3,-4,0,4,-1,2,3,-1,2,3,1,1,0,-1,-5,9,4,3,7,-5,0,0,1,0,-1,-1,6,1
KR_6746467072,420,3,72,-8,6,9,10,1,-3,0,3,-3,1,4,3,6,3,0,1,1,-1,8,1,-3,6,3,5,0,2,1,1,1,-1,2,1
KR_6750713950,420,-1,-11,-4,-5,0,2,2,-5,3,8,2,3,1,0,6,6,-2,0,2,0,-7,-4,-7,8,1,5,0,0,1,-1,0,-1,6,1
KR_6763567472,420,0,27,-24,4,3,3,0,-2,3,5,2,3,1,1,2,1,0,1,1,0,3,3,7,3,10,5,0,1,1,1,1,-1,4,1
KR_6759117439,420,0,-27,-1,1,0,0,0,2,4,2,-1,1,2,0,1,1,0,0,0,0,-3,14,9,4,13,-3,0,0,1,1,0,-1,2,1
KR_6758159442,420,4,28,2,8,1,1,0,3,6,3,5,5,0,-2,0,2,1,4,3,0,5,0,-1,5,4,-3,0,2,-1,1,1,1,2,1
KR_6670494667,420,-1,-36,26,-2,2,2,0,-8,2,10,4,6,2,-1,5,6,1,1,0,0,-7,-1,-1,4,3,0,0,-1,0,-1,-1,1,0,1
KR_6746367926,420,2,86,-24,5,3,4,1,2,2,0,1,2,1,-1,0,1,0,0,0,0,-1,-37,3,3,6,6,0,1,1,1,1,1,5,1
KR_6741735843,420,-2,-40,-21,2,3,3,0,-1,1,2,2,3,1,-2,0,2,0,2,2,0,1,35,0,5,5,-7,0,0,0,0,0,-1,0,1
KR_6710507817,420,2,62,3,3,0,1,1,-1,2,3,2,5,3,2,3,1,0,0,0,0,6,-40,1,7,8,2,0,1,-1,1,1,1,4,1
KR_6742141388,420,3,60,42,11,-2,0,2,2,3,1,5,5,0,5,5,0,1,2,1,0,11,77,6,2,8,7,0,4,1,1,1,1,5,1
KR_6677770355,420,3,59,11,3,1,4,3,-4,1,5,3,4,1,1,1,0,2,2,0,0,-1,-39,-3,8,5,6,0,1,-1,1,1,1,4,1
KR_6725244940,420,1,-20,3,-2,0,3,3,4,10,6,-4,2,6,-1,4,5,-1,2,3,0,-4,0,-6,10,4,2,0,-1,-1,1,-1,1,2,1
KR_6764156347,420,-1,-43,24,0,-4,0,4,4,6,2,0,3,3,-3,2,5,3,3,0,0,-1,-19,0,4,4,-2,0,-5,1,1,-1,-1,6,1
KR_6730139150,420,1,-10,9,4,2,2,0,-3,3,6,4,5,1,0,3,3,1,1,0,0,5,-5,3,5,8,2,0,0,1,0,1,-1,3,1
KR_6767177744,420,-2,-8,8,-3,-3,0,3,-1,1,2,-1,0,1,2,3,1,0,1,1,0,-5,-40,-2,6,4,-1,0,0,1,-1,1,1,3,1
KR_6727735608,420,0,-61,0,-2,2,3,1,-7,2,9,4,5,1,-2,3,5,1,1,0,-3,-6,10,1,5,6,-3,0,-2,-1,-1,-1,-1,6,1
KR_6769748687,440,5,90,8,7,3,3,0,1,2,1,-2,0,2,1,2,1,4,5,1,0,6,1,2,6,8,2,0,1,-1,1,1,1,1,1
KR_6765530093,440,-1,4,-12,-2,-2,2,4,-1,0,1,1,1,0,0,0,0,0,0,0,0,-2,0,0,4,4,4,0,0,-1,-1,0,-1,4,1
KR_6672816668,420,5,84,13,8,-1,1,2,2,4,2,4,7,3,2,2,0,1,1,0,0,17,1,5,6,11,4,0,1,1,1,1,-1,5,1
KR_6728296311,420,1,48,20,5,4,4,0,-1,4,5,3,3,0,0,4,4,-1,1,2,0,0,37,2,8,10,0,0,1,1,1,1,-1,5,1
KR_6769886069,420,3,55,22,14,1,3,2,1,3,2,5,7,2,4,5,1,3,4,1,1,11,12,2,4,6,1,0,1,1,1,1,1,1,1
KR_6762525729,420,-4,-24,-8,-3,1,1,0,-1,1,2,0,1,1,-1,0,1,-2,1,3,0,-4,8,3,2,5,-7,0,-2,-1,-1,-1,-1,2,1
KR_6728630093,420,3,93,-16,7,1,4,3,1,6,5,4,4,0,0,3,3,1,1,0,1,2,3,2,6,8,4,0,1,1,-1,1,1,3,1
KR_6763985792,420,-2,-77,2,-6,-4,1,5,3,6,3,-1,3,4,-3,0,3,-1,1,2,0,-6,-5,-2,7,5,1,0,-1,-1,0,-1,-1,4,1
KR_6764254377,420,0,9,-13,4,-3,2,5,0,3,3,-3,2,5,4,9,5,6,6,0,3,18,121,3,4,7,-1,0,2,-1,-1,-1,1,1,1
KR_6765758247,440,3,1,24,3,1,1,0,2,6,4,1,2,1,3,3,0,-4,3,7,0,0,-5,-2,7,5,-2,0,0,1,1,1,1,2,1
KR_6621614911,420,2,-4,-8,7,1,3,2,5,7,2,-1,1,2,1,1,0,1,1,0,0,15,11,4,6,10,-2,0,2,1,1,1,-1,2,1
KR_6768203033,420,4,-36,11,13,3,4,1,6,6,0,1,4,3,3,5,2,0,3,3,0,10,-35,-2,6,4,25,0,0,1,1,0,1,6,1
KR_6733133538,420,4,51,0,7,1,4,3,1,4,3,2,3,1,4,5,1,-1,0,1,0,9,-22,-1,7,6,2,0,1,1,1,1,1,2,1
KR_6759547092,420,1,-5,4,7,2,6,4,-1,3,4,-2,1,3,3,5,2,5,5,0,0,5,-4,0,6,6,0,0,0,-1,1,1,1,3,1
KR_6670092213,420,3,4,1,8,4,5,1,0,1,1,0,3,3,5,7,2,-1,0,1,0,11,-111,7,1,8,5,0,1,1,1,1,-1,4,1
KR_6739335325,420,1,-10,11,8,3,4,1,-4,1,5,1,2,1,5,6,1,3,3,0,0,5,0,-1,6,5,-1,0,1,1,1,1,-1,3,1
KR_6765650070,420,3,49,5,3,0,1,1,-1,1,2,5,6,1,2,3,1,-3,0,3,0,-3,-2,-1,7,6,0,0,2,1,1,1,1,2,1
KR_6724689951,420,-2,-43,8,-5,-4,1,5,-1,0,1,-4,1,5,8,9,1,-4,1,5,-1,-1,2,-4,9,5,-1,0,-1,-1,-1,-1,-1,1,1
KR_6690313039,420,1,-28,12,4,0,2,2,1,4,3,0,3,3,0,5,5,3,3,0,1,2,23,2,10,12,-7,0,0,-1,-1,0,1,1,1
KR_6767810856,440,0,86,13,-2,5,6,1,-3,2,5,-1,1,2,-1,3,4,-2,1,3,-1,-10,-7,-1,4,3,1,0,1,1,1,1,-1,5,1
KR_6769645053,440,-1,-33,4,2,-2,0,2,4,4,0,1,4,3,0,2,2,-1,1,2,0,9,-9,2,5,7,-7,0,0,-1,1,0,-1,5,1
KR_6689534411,420,-2,-3,-12,-4,-1,2,3,0,7,7,1,1,0,-2,3,5,-2,0,2,0,-11,-265,1,6,7,-2,0,0,-1,1,1,1,4,1
KR_6767255813,420,2,0,16,14,4,4,0,-2,2,4,2,2,0,7,9,2,3,4,1,0,6,-29,0,11,11,-1,0,0,1,1,1,1,4,1
KR_6754440598,440,0,19,16,0,-5,0,5,-1,4,5,2,3,1,4,7,3,0,1,1,-1,-7,105,5,3,8,-3,0,-1,-1,-1,-1,-1,6,1
KR_6762897506,420,0,-56,32,4,1,4,3,-3,1,4,4,4,0,3,4,1,-1,1,2,0,10,4,7,3,10,-1,0,0,1,1,0,1,2,1
KR_6758812446,420,0,5,1,3,3,6,3,0,2,2,6,6,0,-3,1,4,-3,0,3,-2,-3,-2,0,5,5,1,0,1,1,1,1,-1,3,1
KR_6729971907,420,3,5,26,8,1,2,1,1,1,0,-2,0,2,3,3,0,5,5,0,0,12,-14,0,4,4,1,0,1,1,1,1,1,5,1
KR_6768042856,420,3,112,-12,-4,-3,0,3,2,3,1,-1,2,3,-1,2,3,-1,0,1,0,-8,13,-4,5,1,2,0,1,1,-1,-1,-1,6,1
KR_6742080814,440,4,22,29,6,-2,1,3,6,9,3,-1,1,2,-1,4,5,4,6,2,0,4,-1,2,4,6,-2,0,0,1,1,0,1,2,1
KR_6631218299,420,0,-7,10,-1,0,1,1,0,2,2,2,2,0,-3,0,3,0,0,0,0,-6,-1,3,4,7,2,0,-1,-1,1,-1,1,3,1
KR_6769143944,420,-1,36,-1,-5,-1,2,3,5,6,1,2,3,1,-6,1,7,-5,0,5,0,-3,-52,-1,8,7,7,0,0,1,-1,-1,1,5,1
KR_6750015231,420,3,46,-8,7,3,5,2,0,3,3,4,4,0,-2,4,6,2,2,0,0,1,-7,1,6,7,1,0,1,-1,1,1,-1,1,1
KR_6769576990,420,2,38,14,4,0,2,2,5,6,1,1,3,2,1,5,4,-3,1,4,0,8,-1,5,3,8,6,0,1,0,-1,1,-1,0,1
KR_6695726179,420,3,89,5,0,2,4,2,0,3,3,0,2,2,1,3,2,-3,0,3,0,1,24,0,6,6,-1,0,1,-1,-1,1,-1,3,1
KR_6743755070,420,3,80,22,2,-1,1,2,1,3,2,-1,2,3,4,4,0,-1,0,1,0,9,3,-2,5,3,9,0,-1,1,-1,-1,-1,4,1
KR_6768818635,440,3,25,8,0,-4,1,5,-1,0,1,-3,0,3,2,3,1,6,9,3,1,-2,-7,-1,2,1,-3,0,1,1,-1,-1,1,2,1
KR_6757873089,420,0,-29,7,-3,2,3,1,-5,0,5,-1,0,1,-1,1,2,2,2,0,-1,-3,-3,-2,6,4,2,0,0,0,-1,0,-1,0,1
KR_6770510706,420,0,-67,8,0,2,3,1,-1,5,6,5,5,0,-7,2,9,1,2,1,-1,-5,1,2,4,6,2,0,0,1,1,0,-1,6,1
KR_6673845627,420,2,45,16,-2,3,4,1,-1,4,5,-3,2,5,-2,3,5,1,2,1,-1,-8,49,-5,10,5,-19,0,0,-1,-1,-1,-1,4,1
KR_6653494588,420,2,32,1,10,5,5,0,0,2,2,3,4,1,2,3,1,0,1,1,0,6,21,-1,4,3,0,0,1,1,1,1,1,5,1
KR_6749582277,420,0,-18,5,2,4,6,2,-6,0,6,1,4,3,2,2,0,1,3,2,0,-3,-4,-6,9,3,-2,0,-1,-1,-1,-1,-1,5,1
KR_6752394750,420,2,45,20,9,3,3,0,6,6,0,-3,1,4,6,10,4,-3,0,3,0,6,3,7,4,11,-3,0,1,1,1,1,-1,4,1
KR_6748298366,420,4,47,-52,11,1,2,1,-1,2,3,3,4,1,5,5,0,3,4,1,0,18,6,-1,8,7,-1,0,-1,1,-1,1,-1,5,1
KR_6732823376,420,5,76,6,17,1,2,1,9,9,0,4,4,0,1,1,0,2,2,0,0,19,-33,2,6,8,20,0,3,1,1,1,1,5,1
KR_6708251925,440,2,67,0,5,4,6,2,1,4,3,3,6,3,-3,2,5,0,0,0,1,1,5,6,2,8,-5,0,1,1,0,1,1,5,1
KR_6765445774,420,2,26,-32,9,4,4,0,5,5,0,2,5,3,0,2,2,-2,0,2,0,13,18,1,4,5,2,0,-1,1,-1,1,1,4,1
KR_6738082304,420,1,2,14,4,4,4,0,-1,1,2,4,4,0,-3,0,3,0,3,3,2,3,29,1,2,3,-1,0,2,0,1,1,1,0,1
KR_6767095363,420,1,4,-4,-2,-4,1,5,-1,2,3,0,2,2,1,2,1,2,3,1,0,-3,360,2,4,6,0,0,0,1,0,0,-1,4,1
KR_6767825092,420,-1,9,-20,2,-2,1,3,-1,2,3,4,7,3,1,4,3,0,1,1,0,3,3,-1,4,3,-4,0,-1,1,-1,-1,-1,6,1
KR_6763742557,420,5,-5,10,11,4,5,1,3,6,3,-2,0,2,4,7,3,2,2,0,0,11,-44,-1,6,5,6,0,2,-1,1,1,1,2,1
KR_6739531580,420,1,74,-11,5,0,1,1,0,1,1,2,6,4,2,2,0,1,2,1,0,2,68,2,1,3,-46,0,1,-1,-1,1,1,3,1
KR_6756166234,420,0,0,-17,3,-2,1,3,2,6,4,-2,2,4,5,5,0,0,2,2,0,6,-5,-2,7,5,-1,0,1,1,0,1,1,4,1
KR_6758200727,420,-1,2,0,1,2,3,1,-2,3,5,-2,1,3,3,4,1,0,1,1,0,4,-20,2,4,6,3,0,-1,-1,-1,-1,-1,1,1
KR_6655903499,440,3,37,19,5,2,2,0,-1,1,2,3,4,1,0,1,1,1,2,1,0,4,-4,-1,4,3,2,0,-1,1,-1,1,-1,1,1
KR_6759429538,420,-2,8,2,-2,1,1,0,-1,0,1,0,3,3,0,3,3,-2,0,2,0,-4,-5,-2,5,3,2,0,2,1,1,1,1,5,1
KR_6739344140,420,0,-13,0,6,2,4,2,-1,2,3,-1,2,3,5,5,0,1,1,0,0,15,30,1,6,7,-1,0,2,-1,1,1,1,1,1
KR_6692852668,420,-3,25,-24,4,4,4,0,3,5,2,0,1,1,0,3,3,-3,0,3,1,2,-41,5,2,7,9,0,1,-1,-1,1,1,1,1
KR_6752538185,440,4,76,49,13,-1,1,2,9,10,1,1,5,4,4,5,1,0,1,1,-1,9,-7,0,5,5,4,0,1,1,0,1,-1,3,1
KR_6668906856,420,4,-18,29,6,0,1,1,3,5,2,2,5,3,3,3,0,-2,2,4,0,9,-1,-2,8,6,0,0,-1,1,1,-1,-1,2,1
KR_6654282510,440,1,-40,12,2,0,3,3,2,7,5,0,2,2,0,3,3,0,1,1,0,6,69,3,4,7,-9,0,-2,-1,1,-1,-1,6,1
KR_6768727884,420,0,1,11,-2,-3,0,3,0,3,3,3,4,1,1,2,1,-3,0,3,0,0,-16,-1,5,4,3,0,-1,1,1,-1,-1,4,1
KR_6770439672,420,-1,-35,-43,4,7,7,0,-2,2,4,-3,3,6,1,2,1,1,1,0,0,8,3,-2,6,4,9,0,-1,-1,1,-1,-1,5,1
KR_6728046420,420,1,-28,15,3,0,1,1,-1,2,3,5,5,0,-2,1,3,1,1,0,0,-3,319,1,5,6,2,0,0,1,1,0,1,2,1
KR_6764167299,420,-1,-11,4,-1,1,3,2,0,1,1,0,2,2,0,4,4,-2,0,2,0,4,-166,2,5,7,2,0,0,1,1,1,-1,6,1
KR_6768635896,420,3,45,19,10,-1,0,1,7,9,2,1,3,2,2,3,1,1,1,0,0,8,-25,1,4,5,1,0,2,1,0,1,1,1,1
KR_6760417051,420,7,139,53,11,1,3,2,1,5,4,1,2,1,3,10,7,5,6,1,0,8,-41,-2,8,6,5,0,1,1,1,1,1,4,1
KR_6752744555,420,4,31,22,10,1,4,3,-3,3,6,5,6,1,5,6,1,2,3,1,0,10,10,0,5,5,5,0,0,1,1,0,1,2,1
KR_6651521640,420,-3,-13,-17,-7,0,1,1,-2,0,2,-3,2,5,-2,0,2,0,0,0,-1,-6,2,3,5,8,-2,0,0,-1,1,1,-1,2,1
KR_6770209866,420,-4,1,-24,-1,-3,0,3,0,2,2,1,3,2,0,3,3,1,1,0,0,2,3,-3,7,4,-4,0,1,1,1,1,1,6,1
KR_6759151082,420,-1,-1,3,0,1,2,1,4,6,2,2,4,2,-5,1,6,-2,0,2,0,1,-48,1,6,7,3,0,1,1,1,1,-1,2,1
KR_6763697679,420,1,-28,-6,1,0,1,1,-4,1,5,1,2,1,6,8,2,-2,2,4,0,1,-102,5,3,8,-7,0,-1,1,-1,-1,1,4,1
KR_6766429033,420,5,83,15,14,11,12,1,1,4,3,-1,1,2,3,8,5,0,0,0,0,14,7,1,6,7,-1,0,2,1,-1,1,1,4,1
KR_6702477397,420,2,21,-5,-1,-3,2,5,2,6,4,1,3,2,-2,2,4,1,2,1,1,0,-37,0,5,5,3,0,-1,1,1,1,1,3,1
KR_6741080292,420,0,37,-14,2,-2,0,2,1,3,2,1,4,3,5,6,1,-3,0,3,0,-10,9,7,3,10,-1,0,-1,1,-1,1,1,4,1
KR_6765603808,420,4,66,18,-2,1,3,2,-2,1,3,-2,1,3,0,1,1,1,1,0,0,-9,-9,5,5,10,5,0,0,1,1,0,1,6,1
KR_6754289856,420,2,47,6,4,5,6,1,-1,4,5,-1,1,2,1,4,3,0,1,1,2,-8,-3,-1,5,4,0,0,1,1,1,1,1,1,1
KR_6765627816,420,0,8,8,-1,0,1,1,-3,0,3,-1,2,3,2,2,0,1,2,1,1,-1,-11,1,3,4,4,0,0,1,-1,0,1,2,1
KR_6762518084,420,1,-2,17,2,-1,4,5,1,2,1,0,3,3,0,3,3,2,2,0,0,1,0,-4,10,6,-1,0,0,1,-1,-1,1,3,1
KR_6758694023,420,5,15,28,8,-2,0,2,3,5,2,1,3,2,3,4,1,3,4,1,0,13,-6,-7,9,2,7,0,2,1,1,-1,-1,2,1
KR_6765360691,420,1,3,-15,1,0,1,1,-1,3,4,2,3,1,0,1,1,0,1,1,0,3,-4,1,4,5,-3,0,1,1,-1,1,-1,6,1
KR_6701679528,420,5,26,8,7,4,5,1,5,8,3,2,2,0,-4,0,4,0,3,3,0,-4,8,2,5,7,0,0,1,1,-1,1,1,6,1
KR_6750643940,420,1,-29,-4,1,-1,0,1,1,2,1,2,3,1,-2,2,4,1,1,0,0,1,-37,-5,9,4,27,0,-3,1,-1,-1,1,6,1
KR_6759708422,420,1,-63,12,6,-2,2,4,5,5,0,2,2,0,-1,0,1,2,4,2,0,12,-1,2,5,7,-3,0,0,0,1,0,-1,0,1
KR_6652313581,420,4,60,35,9,2,2,0,2,6,4,1,2,1,4,5,1,0,1,1,1,6,63,-1,7,6,22,0,0,1,-1,-1,-1,3,1
KR_6759888781,420,3,-41,-5,4,-2,3,5,2,7,5,3,3,0,4,4,0,-3,0,3,0,8,-25,4,4,8,14,0,-1,1,-1,-1,-1,4,1
KR_6754557724,420,1,-27,19,-1,-3,0,3,0,4,4,2,3,1,1,2,1,-1,1,2,0,0,-7,-5,9,4,-1,0,0,1,-1,0,1,1,1
KR_6747993110,420,-4,-30,-16,-6,-5,1,6,1,2,1,-2,3,5,0,3,3,0,0,0,-1,1,11,-3,4,1,2,0,0,0,-1,0,-1,0,1
KR_6724265349,420,0,-19,-24,4,3,3,0,2,4,2,0,3,3,1,4,3,-2,0,2,0,5,-5,1,6,7,1,0,0,1,-1,0,1,1,1
KR_6763934474,420,-1,-34,12,2,1,1,0,10,10,0,-3,0,3,-3,0,3,-3,0,3,0,3,39,7,4,11,-2,0,0,1,1,0,-1,3,1
KR_6720566892,420,5,20,32,9,3,3,0,0,2,2,4,4,0,-2,1,3,4,4,0,1,11,-70,-4,8,4,3,0,0,1,1,1,1,2,1
KR_6715656034,440,1,-49,13,6,-1,2,3,1,1,0,-2,1,3,5,8,3,3,4,1,0,2,-65,5,3,8,2,0,-1,-1,1,-1,1,3,1
KR_6704876608,420,1,-73,24,3,-1,0,1,0,4,4,2,4,2,-1,4,5,3,3,0,0,2,-7,-7,8,1,-1,0,1,1,1,-1,-1,2,1
KR_6756404815,440,5,18,38,8,-5,2,7,1,3,2,5,8,3,3,4,1,4,4,0,0,3,-5,0,7,7,1,0,1,-1,1,1,1,1,1
KR_6755155887,420,1,28,12,-3,-1,1,2,-3,0,3,-1,1,2,1,2,1,1,2,1,-1,-5,-26,0,3,3,0,0,1,-1,1,1,-1,1,1
KR_6730832780,440,2,55,16,2,-2,0,2,5,6,1,0,2,2,0,3,3,-1,3,4,0,7,32,-1,4,3,-10,0,0,0,-1,1,1,0,1
KR_6630554251,420,-2,-27,-2,-6,-1,0,1,-5,1,6,0,2,2,1,1,0,-1,0,1,0,-6,-28,2,5,7,-1,0,0,-1,1,0,-1,4,1
KR_6707736414,420,1,21,5,10,6,7,1,6,8,2,-2,1,3,-1,1,2,1,1,0,2,18,8,2,6,8,-1,0,0,1,1,-1,1,6,1
KR_6768858256,420,1,-38,0,-2,-3,0,3,-2,2,4,8,8,0,-4,0,4,-1,3,4,0,1,-16,-2,6,4,1,0,-1,-1,-1,-1,1,4,1
KR_6709921577,420,7,56,23,13,2,3,1,0,3,3,4,5,1,6,6,0,1,3,2,0,8,7,4,6,10,-4,0,2,1,1,1,1,5,1
KR_6727270812,420,0,-17,-29,4,-7,1,8,-1,1,2,7,9,2,4,4,0,1,2,1,0,4,-13,-2,6,4,1,0,1,1,-1,-1,1,4,1
KR_6765115411,420,4,48,7,11,-1,1,2,-3,3,6,14,14,0,0,1,1,1,2,1,0,17,48,8,3,11,-1,0,1,1,1,1,1,2,1
KR_6765402361,420,3,22,4,7,6,9,3,-5,1,6,3,4,1,4,8,4,-1,0,1,1,4,0,-3,9,6,5,0,0,1,1,1,-1,1,1
KR_6714152914,420,1,68,-23,1,1,2,1,1,3,2,1,1,0,-3,3,6,1,3,2,-2,-1,-208,1,7,8,0,0,0,-1,-1,1,-1,1,1
KR_6765456879,420,0,2,28,-1,-1,1,2,0,4,4,0,3,3,1,2,1,-1,1,2,0,5,-5,1,7,8,3,0,0,1,1,-1,1,6,1
KR_6623941596,420,0,2,19,-5,0,1,1,1,4,3,2,4,2,-4,0,4,-4,1,5,-2,-3,-14,-4,8,4,-1,0,0,1,-1,0,-1,2,1
KR_6745016886,420,1,-28,13,4,-1,2,3,1,4,3,6,7,1,0,2,2,-2,2,4,0,8,12,2,4,6,-2,0,-1,-1,1,-1,1,5,1
KR_6708601059,420,2,84,28,6,2,4,2,3,5,2,1,2,1,0,1,1,0,0,0,0,6,12,6,2,8,-5,0,2,1,1,1,1,1,1
KR_6752682092,440,0,-72,22,0,0,2,2,1,1,0,0,2,2,-1,0,1,0,1,1,0,0,3,3,6,9,-5,0,-3,-1,-1,-1,1,6,1
KR_6767454907,420,2,69,8,-3,4,6,2,-5,2,7,-3,1,4,1,4,3,0,1,1,0,-10,-8,0,7,7,5,0,-1,-1,-1,-1,-1,3,1
KR_6762613473,420,3,-11,0,7,-2,1,3,4,5,1,1,2,1,3,3,0,1,1,0,0,19,4,-3,8,5,0,0,1,1,-1,1,-1,4,1
KR_6766681343,420,2,55,-23,-2,5,6,1,-3,0,3,1,1,0,-3,2,5,-2,1,3,0,-6,22,1,3,4,-15,0,2,-1,1,1,1,1,1
KR_6627164087,420,2,61,25,8,6,6,0,1,3,2,1,3,2,1,3,2,-1,1,2,0,8,6,1,5,6,1,0,2,1,-1,1,1,1,1
KR_6770002343,440,2,17,-17,-4,2,4,2,-3,2,5,-2,3,5,-1,2,3,0,0,0,-1,-2,-109,-1,4,3,-2,0,0,-1,1,0,-1,2,1
KR_6684547701,420,5,50,-3,11,0,2,2,4,7,3,2,3,1,3,4,1,2,3,1,0,20,-21,-2,5,3,3,0,1,1,-1,1,-1,1,1
KR_6741466574,420,4,115,16,8,4,4,0,0,3,3,-2,0,2,4,4,0,2,2,0,0,10,5,0,6,6,3,0,2,1,1,1,1,4,1
KR_6767376657,420,2,99,-12,1,-4,0,4,2,4,2,0,3,3,1,4,3,2,3,1,0,3,-4,2,6,8,-10,0,2,1,1,1,1,5,1
KR_6718245512,420,2,-9,7,9,0,1,1,3,4,1,5,7,2,0,5,5,1,2,1,1,14,-48,-2,7,5,22,0,0,-1,-1,0,1,1,1
KR_6754388129,420,2,61,48,1,2,4,2,6,6,0,-2,0,2,-4,2,6,-1,0,1,0,-10,1,3,3,6,-2,0,3,-1,1,1,1,6,1
KR_6770183527,420,0,-35,24,0,0,0,0,1,3,2,2,4,2,-3,1,4,0,0,0,0,-3,-4,-2,7,5,3,0,0,-1,1,0,1,1,1
KR_6732849344,420,5,88,-4,10,4,4,0,5,6,1,6,6,0,-3,0,3,-2,1,3,0,12,8,3,6,9,1,0,1,-1,1,1,1,5,1
KR_6732236675,420,3,-8,25,-2,2,3,1,-7,1,8,-4,0,4,6,7,1,1,1,0,1,-2,40,-5,11,6,-12,0,1,-1,-1,1,-1,2,1
KR_6768142122,420,2,50,-9,2,0,2,2,1,3,2,3,3,0,-2,1,3,0,2,2,0,-1,-11,2,2,4,3,0,-1,1,-1,-1,1,2,1
KR_6769530316,420,5,65,20,10,9,9,0,-2,0,2,5,10,5,-2,2,4,0,0,0,0,2,-2,-1,4,3,3,0,3,1,0,1,1,4,1
KR_6762955700,420,1,13,8,3,-2,1,3,4,5,1,1,4,3,0,1,1,0,0,0,0,5,20,0,6,6,2,0,0,1,1,0,-1,5,1
KR_6748238564,420,2,-12,2,3,4,5,1,-1,0,1,1,3,2,4,4,0,-5,1,6,0,-1,-3,6,3,9,0,0,0,-1,1,1,-1,4,1
KR_6738400000,420,7,29,15,15,2,3,1,8,8,0,3,3,0,2,3,1,0,2,2,0,17,36,3,4,7,3,0,1,-1,1,1,1,1,1
KR_6764104835,420,-2,-15,-11,-4,0,2,2,-2,1,3,-1,1,2,1,2,1,-2,0,2,0,-1,1,-3,8,5,1,0,0,1,-1,-1,-1,6,1
KR_6656244897,420,-2,-31,-19,-3,-2,1,3,1,2,1,-4,3,7,-1,2,3,3,4,1,0,-6,2,-4,7,3,2,0,0,1,1,0,-1,5,1
KR_6630579537,420,-4,16,-40,-3,-2,0,2,0,3,3,1,3,2,3,3,0,-5,2,7,0,-6,-7,0,4,4,-1,0,1,1,-1,-1,1,1,1
KR_6764469626,420,5,8,27,6,5,5,0,-1,2,3,-1,1,2,2,4,2,1,2,1,0,8,135,-1,7,6,19,0,2,1,1,1,1,3,1
KR_6765490620,420,2,112,-3,4,3,3,0,-5,2,7,2,3,1,2,6,4,2,3,1,0,-3,-35,5,5,10,-1,0,0,1,-1,1,1,4,1
KR_6616790295,420,0,-43,-14,-7,-2,1,3,-4,3,7,1,1,0,1,4,3,-3,0,3,0,-3,-10,-3,10,7,4,0,0,1,1,-1,-1,4,1
KR_6765521977,420,-1,-15,-26,-6,0,2,2,-2,3,5,-2,0,2,-2,2,4,0,1,1,-1,-3,8,2,5,7,1,0,-1,-1,1,-1,-1,3,1
KR_6764579393,440,0,-67,-5,6,4,4,0,0,4,4,-1,0,1,1,2,1,2,4,2,0,17,76,-2,6,4,2,0,-1,1,-1,-1,1,3,1
KR_6699238244,420,3,38,11,8,3,5,2,6,7,1,1,2,1,-1,0,1,-1,0,1,0,0,33,1,4,5,-2,0,1,-1,-1,1,1,2,1
KR_6763430802,420,4,-4,32,6,0,1,1,7,8,1,1,2,1,-3,1,4,1,3,2,0,4,6,5,3,8,4,0,3,1,1,1,1,2,1
KR_6766084246,420,3,89,-4,7,1,2,1,-5,0,5,-1,2,3,13,15,2,-1,1,2,0,4,-4,0,7,7,5,0,0,1,-1,1,1,2,1
KR_6761076566,420,1,24,7,6,0,1,1,0,4,4,2,3,1,2,3,1,2,2,0,1,10,35,0,6,6,-7,0,-1,1,-1,-1,1,5,1
KR_6770356012,440,1,-52,24,3,2,2,0,0,1,1,1,1,0,0,2,2,0,0,0,0,3,2,-2,5,3,-4,0,0,1,-1,0,1,1,1
KR_6698319391,420,3,92,-6,7,2,4,2,3,5,2,-1,2,3,5,6,1,-2,0,2,0,6,-21,2,5,7,-2,0,1,-1,1,1,-1,2,1
KR_6769026665,420,8,93,-5,20,7,7,0,3,3,0,5,6,1,5,5,0,0,0,0,0,14,7,4,3,7,0,0,2,1,1,1,1,5,1
KR_6769319209,440,5,19,37,7,0,2,2,-3,3,6,-1,2,3,2,5,3,9,13,4,-2,2,-3,0,2,2,-1,0,2,1,1,1,-1,4,1
KR_6760863972,420,0,55,-5,3,4,4,0,1,3,2,-5,1,6,4,4,0,-1,0,1,1,0,-32,0,7,7,1,0,0,1,-1,0,1,1,1
KR_6755829964,420,0,41,-45,6,2,2,0,0,3,3,2,2,0,4,5,1,-2,0,2,1,5,1,1,5,6,1,0,2,-1,1,1,1,6,1
KR_6769252651,420,4,35,32,4,-2,1,3,2,3,1,5,7,2,-1,0,1,0,3,3,-2,-1,-4,-5,9,4,1,0,-1,1,-1,-1,-1,1,1
KR_6673710142,420,2,9,16,8,1,1,0,5,6,1,-1,1,2,3,5,2,0,1,1,-1,10,-27,0,3,3,0,0,0,1,1,1,1,2,1
KR_6761783289,420,2,-11,-27,5,-3,1,4,4,6,2,2,3,1,0,1,1,2,4,2,0,13,-11,-4,8,4,2,0,0,-1,-1,0,-1,2,1
KR_6741624713,420,-2,51,-15,1,-1,3,4,3,3,0,0,3,3,0,2,2,-1,0,1,1,-2,8,4,1,5,-5,0,1,1,1,1,1,2,1
KR_6745803458,420,6,53,33,9,2,4,2,-1,2,3,2,4,2,6,6,0,0,0,0,0,7,4,-1,5,4,-1,0,1,1,1,1,1,1,1
KR_6759514226,420,5,12,28,10,1,2,1,-2,1,3,2,3,1,8,10,2,1,2,1,0,8,-15,2,3,5,-1,0,1,1,1,1,1,1,1
KR_6761999869,420,2,12,-12,5,-1,0,1,2,4,2,-2,3,5,3,4,1,3,4,1,1,5,7,-3,8,5,1,0,-2,1,1,-1,1,1,1
KR_6767982920,420,1,62,31,-3,-1,2,3,0,3,3,0,0,0,-2,3,5,0,0,0,0,1,3,0,4,4,-2,0,1,1,1,1,1,5,1
KR_6674778873,420,0,15,-8,2,-1,1,2,3,3,0,2,3,1,-2,1,3,0,0,0,0,3,-5,2,7,9,0,0,0,-1,-1,0,-1,5,1
KR_6750550324,420,2,35,4,6,2,2,0,-1,1,2,5,7,2,0,3,3,0,0,0,0,0,23,0,5,5,-1,0,1,-1,1,1,-1,1,1
KR_6760124374,420,5,67,21,20,-1,1,2,5,6,1,6,6,0,5,7,2,5,5,0,1,25,26,-1,6,5,4,0,3,1,1,1,1,6,1
KR_6769663760,420,2,82,23,3,-2,2,4,2,5,3,0,1,1,4,5,1,-1,0,1,0,1,3,1,4,5,5,0,1,1,1,1,-1,3,1
KR_6679645038,420,3,-25,25,5,2,3,1,-4,1,5,1,3,2,3,5,2,3,3,0,1,3,20,3,4,7,-2,0,2,1,-1,1,1,3,1
KR_6760071256,440,3,85,-29,5,-2,2,4,3,6,3,0,5,5,6,6,0,-2,1,3,0,9,-31,-4,8,4,-1,0,1,-1,0,1,1,6,1
KR_6766153171,420,5,24,77,1,1,1,0,1,3,2,0,1,1,-1,2,3,0,0,0,0,-5,-1,0,8,8,9,0,1,1,1,1,-1,1,1
KR_6769357138,420,1,51,8,13,-1,1,2,2,4,2,2,4,2,10,11,1,0,1,1,2,10,4,2,3,5,4,0,1,1,1,1,1,3,1
KR_6652453897,420,2,55,8,6,2,3,1,-1,5,6,0,3,3,5,5,0,0,2,2,0,11,3,2,3,5,1,0,1,1,1,1,1,3,1
KR_6740558103,420,3,2,4,2,0,1,1,-1,3,4,0,4,4,0,3,3,3,3,0,0,3,0,3,6,9,0,0,2,-1,-1,-1,-1,3,1
KR_6699860203,420,3,-5,16,11,8,8,0,2,4,2,-3,3,6,4,4,0,0,0,0,1,13,-1,3,3,6,3,0,1,-1,1,1,1,3,1
KR_6769128816,420,0,-15,2,4,0,2,2,4,4,0,-3,3,6,3,5,2,0,0,0,1,11,-13,-4,8,4,1,0,0,0,0,0,1,0,1
KR_6766052359,420,6,36,14,5,3,4,1,-2,2,4,3,4,1,1,2,1,0,0,0,0,3,25,5,2,7,-2,0,1,1,1,1,-1,3,1
KR_6754177359,420,6,96,25,16,2,3,1,9,9,0,6,6,0,-2,2,4,1,2,1,3,21,30,4,1,5,1,0,1,1,1,1,-1,3,1
KR_6763033760,420,2,53,-12,10,2,2,0,4,5,1,4,4,0,0,2,2,0,0,0,0,3,3,0,4,4,1,0,1,1,1,1,1,2,1
KR_6597948089,420,4,5,12,5,1,3,2,-1,1,2,3,5,2,1,3,2,1,3,2,0,8,17,3,6,9,-1,0,1,1,-1,1,-1,5,1
KR_6769996564,420,5,52,33,3,1,1,0,3,4,1,0,0,0,-1,1,2,0,0,0,0,3,2,3,6,9,4,0,0,-1,1,0,-1,4,1
KR_6753301251,420,2,-39,-4,7,-2,1,3,-1,3,4,4,8,4,7,9,2,-1,0,1,-1,3,15,2,6,8,0,0,1,1,1,1,-1,1,1
KR_6769254987,420,2,12,0,2,2,2,0,1,3,2,-3,0,3,2,4,2,0,0,0,-1,-5,11,2,7,9,8,0,0,-1,-1,-1,-1,3,1
KR_6758692937,420,1,-1,8,7,3,5,2,-1,1,2,1,1,0,4,4,0,0,0,0,0,10,8,-1,9,8,9,0,1,-1,-1,1,1,6,1
KR_6761500785,420,5,6,-32,10,1,3,2,-1,1,2,3,3,0,5,9,4,2,3,1,0,6,2,-5,11,6,10,0,0,1,-1,1,1,5,1
KR_6768037286,440,1,-23,12,5,-1,1,2,0,3,3,6,6,0,-3,2,5,3,5,2,0,0,-44,1,2,3,41,0,0,0,-1,0,1,0,1
KR_6688482812,420,0,-41,4,-2,-2,0,2,0,3,3,2,2,0,0,2,2,-2,0,2,0,-3,5,1,3,4,1,0,-1,-1,1,1,-1,6,1
KR_6708294720,440,1,34,28,1,0,3,3,0,4,4,7,9,2,-5,0,5,-1,2,3,0,-5,-12,-3,5,2,-1,0,0,1,1,1,1,5,1
KR_6760022158,420,1,54,37,2,0,1,1,-2,1,3,-1,2,3,4,7,3,1,1,0,1,8,-12,3,3,6,1,0,0,1,-1,-1,1,1,1
KR_6737841792,420,1,70,-10,2,0,3,3,-4,1,5,5,6,1,1,4,3,0,0,0,0,1,1,-2,7,5,5,0,1,1,1,1,-1,4,1
KR_6770080427,420,1,28,4,2,3,3,0,-2,0,2,2,4,2,0,1,1,-1,0,1,0,1,124,1,4,5,2,0,1,1,1,1,1,3,1
KR_6760989605,420,3,63,24,7,3,3,0,-3,2,5,5,6,1,-2,3,5,4,6,2,0,-7,59,-4,7,3,-29,0,1,1,1,1,1,6,1
KR_6754318643,420,-2,9,-35,-4,-1,2,3,0,2,2,-1,1,2,1,3,2,-3,1,4,0,-2,5,-2,10,8,-2,0,2,-1,1,1,-1,5,1
KR_6694198441,420,6,103,11,10,2,5,3,4,4,0,4,6,2,-1,1,2,1,3,2,0,10,-17,1,2,3,2,0,3,-1,1,1,-1,3,1
KR_6750549618,420,3,45,14,9,1,1,0,5,7,2,1,2,1,1,2,1,1,2,1,0,7,122,-1,5,4,2,0,1,1,-1,1,1,1,1
KR_6767867803,420,-3,-31,-10,2,-4,0,4,5,5,0,6,6,0,-4,3,7,-1,1,2,0,3,37,3,5,8,6,0,1,1,-1,1,1,4,1
KR_6767481008,420,1,25,1,4,0,1,1,2,4,2,1,3,2,1,2,1,0,1,1,1,3,2,-2,7,5,0,0,0,-1,-1,0,1,2,1
KR_6759758303,420,5,28,3,11,5,5,0,0,2,2,4,5,1,2,6,4,0,1,1,0,15,2,3,5,8,-5,0,0,1,1,-1,1,1,1
KR_6761591764,420,1,70,-16,4,0,2,2,0,2,2,3,3,0,0,2,2,1,2,1,1,9,-27,-2,7,5,15,0,0,-1,-1,0,1,3,1
KR_6741458987,420,4,14,31,8,1,3,2,5,5,0,-1,3,4,1,3,2,2,2,0,-1,10,4,3,4,7,5,0,2,1,-1,1,-1,2,1
KR_6741083933,420,3,-14,11,7,4,7,3,-1,2,3,-2,3,5,1,2,1,5,6,1,-1,13,-8,0,5,5,3,0,0,1,-1,1,-1,3,1
KR_6702815545,420,2,68,16,3,0,2,2,-5,0,5,-1,2,3,6,6,0,3,5,2,0,2,-1,0,7,7,-8,0,2,1,1,1,1,6,1
KR_6769616078,420,4,36,-25,12,3,3,0,2,3,1,4,6,2,5,7,2,-2,1,3,0,19,30,2,4,6,1,0,2,0,1,1,1,0,1
KR_6754482886,440,5,105,31,14,3,3,0,3,3,0,5,6,1,3,3,0,0,0,0,0,10,-12,0,5,5,1,0,1,1,1,1,1,5,1
KR_6761220572,420,0,37,-20,1,2,5,3,1,2,1,-4,2,6,2,5,3,0,0,0,1,3,35,-5,8,3,-20,0,0,-1,-1,1,1,6,1
KR_6733438031,420,3,-8,8,1,-4,0,4,-1,3,4,1,3,2,4,4,0,1,1,0,1,9,8,6,2,8,1,0,-1,1,1,-1,1,1,1
KR_6763057970,420,1,41,12,5,-2,3,5,0,1,1,5,7,2,2,2,0,0,0,0,-1,2,42,2,4,6,-17,0,2,1,1,1,-1,3,1
KR_6768900602,420,4,15,27,7,2,3,1,1,6,5,1,3,2,1,3,2,2,2,0,0,13,-3,-3,5,2,5,0,1,1,1,1,-1,4,1
KR_6766903653,420,3,39,28,1,0,3,3,-1,1,2,-1,0,1,2,2,0,1,1,0,0,-2,-2,4,2,6,1,0,0,-1,1,1,-1,4,1
KR_6730369079,420,4,52,-4,17,-1,1,2,7,7,0,2,2,0,6,6,0,3,4,1,0,26,9,0,4,4,0,0,3,-1,1,1,1,6,1
KR_6749234890,420,1,61,-12,3,1,2,1,-1,1,2,3,4,1,0,2,2,0,1,1,0,4,-5,-5,7,2,1,0,0,-1,-1,1,-1,2,1
KR_6717225529,420,1,-39,17,4,1,2,1,4,5,1,-1,2,3,2,4,2,-2,2,4,1,-1,8,0,4,4,0,0,-1,-1,0,-1,1,4,1
KR_6720082205,420,-3,7,1,-4,-4,1,5,5,5,0,0,1,1,-1,1,2,-4,0,4,0,-6,-21,-4,9,5,1,0,0,-1,1,0,-1,3,1
KR_6763496374,420,1,50,52,-1,-1,0,1,1,2,1,-1,0,1,0,1,1,0,0,0,0,1,7,3,3,6,-2,0,0,-1,1,1,-1,6,1
KR_6728808166,420,6,39,28,17,2,3,1,5,6,1,4,4,0,7,8,1,-1,1,2,1,18,-23,6,4,10,-1,0,0,1,-1,0,1,2,1
KR_6770231592,420,-1,-23,20,-1,3,3,0,-2,1,3,4,5,1,-5,1,6,-1,0,1,0,-1,-2,-3,7,4,2,0,0,1,-1,-1,-1,1,1
KR_6766447483,420,6,19,20,15,6,7,1,3,4,1,6,7,1,-1,2,3,1,3,2,0,13,8,0,2,2,2,0,2,1,1,1,1,5,1
KR_6770153133,420,-1,12,-12,5,2,3,1,-4,2,6,3,3,0,6,7,1,-2,0,2,1,3,-4,0,3,3,-2,0,-1,1,0,1,1,1,1
KR_6670980074,420,1,-2,15,-1,-1,0,1,3,3,0,2,4,2,-3,2,5,-2,0,2,0,-4,-3,-8,11,3,6,0,0,-1,-1,1,-1,3,1
KR_6718676175,420,0,8,4,7,4,6,2,3,4,1,0,4,4,0,2,2,0,2,2,0,16,109,1,7,8,5,0,2,-1,1,1,1,4,1
KR_6718673177,420,4,89,-8,11,7,7,0,2,2,0,-2,0,2,1,3,2,3,3,0,0,12,24,-7,9,2,21,0,1,1,1,1,1,4,1
KR_6753104817,420,-1,14,-34,5,2,3,1,0,3,3,4,9,5,-1,1,2,0,3,3,0,2,2,-2,5,3,-3,0,1,1,1,1,1,2,1
KR_6768652966,440,0,-13,-12,-3,-3,3,6,3,5,2,0,1,1,-3,2,5,0,1,1,0,-4,-5,5,3,8,-4,0,0,1,1,1,1,2,1
KR_6705788683,440,4,33,36,8,1,3,2,-2,0,2,4,4,0,4,6,2,1,1,0,1,8,-332,2,3,5,0,0,1,-1,1,1,1,4,1
KR_6768862968,420,2,69,40,5,-1,0,1,3,7,4,-3,0,3,6,7,1,0,1,1,0,8,61,1,5,6,-18,0,1,1,1,1,1,5,1
KR_6688557708,420,1,31,12,1,-3,1,4,10,11,1,-3,2,5,-2,1,3,-1,0,1,1,0,2,1,4,5,-2,0,0,-1,-1,0,1,5,1
KR_6766000962,440,3,23,52,5,-2,4,6,0,1,1,2,3,1,4,8,4,1,2,1,0,6,11,5,1,6,-1,0,-1,1,0,1,1,6,1
KR_6768850722,420,2,-5,33,5,0,4,4,2,3,1,0,3,3,1,3,2,2,2,0,0,8,-3,0,4,4,1,0,1,-1,-1,1,1,1,1
KR_6766473184,420,1,-7,40,0,-3,0,3,0,4,4,4,4,0,1,2,1,-2,0,2,-1,0,2,2,5,7,8,0,1,-1,1,1,-1,6,1
KR_6684258894,420,7,90,12,9,3,3,0,-1,2,3,6,7,1,-1,1,2,2,2,0,0,-3,-10,0,2,2,6,0,5,-1,1,1,1,1,1
KR_6705645057,420,2,-6,20,7,0,2,2,1,5,4,0,2,2,7,7,0,-1,0,1,2,14,67,-1,7,6,1,0,1,-1,1,1,1,4,1
KR_6764280906,420,4,46,10,6,-3,0,3,1,4,3,2,3,1,4,6,2,2,2,0,0,5,19,5,5,10,-1,0,2,1,1,1,1,6,1
KR_6753262525,420,-2,-10,-9,4,1,3,2,-2,1,3,2,4,2,3,5,2,0,0,0,0,4,-1,0,5,5,3,0,0,1,-1,-1,1,4,1
KR_6761727068,420,5,98,-11,14,8,10,2,2,4,2,-1,3,4,5,6,1,0,0,0,0,9,4,0,4,4,4,0,3,0,1,1,1,0,1
KR_6737814374,420,-1,-21,-8,0,1,1,0,1,3,2,-1,4,5,-1,2,3,0,0,0,0,1,-8,-5,7,2,4,0,-1,1,-1,-1,1,5,1
KR_6691170717,420,1,-12,-1,2,0,1,1,3,3,0,-1,2,3,1,6,5,-1,1,2,0,7,46,2,5,7,-29,0,0,1,-1,1,1,2,1
KR_6769046567,440,-1,2,-7,1,1,3,2,0,5,5,-3,2,5,2,4,2,1,2,1,0,8,38,-4,8,4,4,0,1,-1,1,1,1,5,1
KR_6730029703,420,0,-8,7,-2,-3,0,3,-2,4,6,2,4,2,2,4,2,-1,1,2,-1,-12,11,5,3,8,0,0,-2,1,-1,-1,-1,6,1
KR_6742046707,420,1,9,20,8,1,3,2,2,4,2,0,1,1,0,1,1,5,11,6,2,9,6,-1,8,7,0,0,1,1,1,1,1,3,1
KR_6751367957,420,-3,-32,40,-10,-1,2,3,-7,0,7,-2,2,4,0,3,3,0,1,1,0,-14,9,-1,4,3,-2,0,-1,0,-1,-1,-1,0,1
KR_6708063463,420,-4,-48,0,-3,-6,0,6,-3,2,5,0,1,1,3,3,0,3,5,2,0,-3,-32,0,5,5,-2,0,-1,1,1,-1,-1,6,1
KR_6764857753,420,3,60,1,13,0,4,4,-3,2,5,3,6,3,6,7,1,7,10,3,0,6,48,-9,11,2,7,0,2,1,0,1,-1,6,1
KR_6715979464,420,0,-29,-19,7,5,6,1,-2,1,3,-1,2,3,0,6,6,5,5,0,0,2,-7,-1,5,4,-2,0,1,-1,1,1,1,3,1
KR_6767872700,420,3,64,16,1,0,3,3,-1,1,2,3,4,1,-2,0,2,1,1,0,-1,-5,-3,1,6,7,5,0,1,-1,1,1,-1,1,1
KR_6754590292,420,0,-47,-4,-1,-2,0,2,0,4,4,3,3,0,1,6,5,-3,1,4,0,9,45,-1,4,3,-10,0,0,0,-1,0,-1,0,1
KR_6715839120,420,-3,-44,-13,-4,0,2,2,1,2,1,-8,1,9,6,6,0,-3,1,4,0,5,10,-5,11,6,1,0,-1,-1,-1,-1,1,2,1
KR_6759069295,420,1,62,14,-1,0,1,1,-2,3,5,-1,1,2,2,2,0,0,1,1,0,1,41,2,4,6,0,0,2,1,1,1,-1,5,1
KR_6751356111,440,-2,42,-28,-1,-1,3,4,6,7,1,-10,1,11,3,6,3,1,3,2,0,-5,-3,3,1,4,0,0,-1,-1,1,-1,1,5,1
KR_6766573242,420,3,33,35,6,1,4,3,-1,0,1,4,4,0,2,2,0,0,1,1,0,1,47,-1,3,2,-6,0,2,1,1,1,1,6,1
KR_6756720164,420,1,45,-16,4,0,1,1,-2,3,5,0,2,2,7,8,1,-1,0,1,0,-2,-4,-3,6,3,2,0,0,1,-1,0,1,2,1
KR_6720398974,420,1,48,26,3,5,5,0,3,4,1,0,1,1,-1,1,2,-4,1,5,0,1,350,-5,9,4,1,0,0,1,1,0,1,3,1
KR_6664150413,420,7,68,67,14,2,4,2,11,12,1,-3,0,3,2,3,1,2,2,0,1,24,-2,9,2,11,1,0,3,1,1,1,1,6,1
KR_6728288846,420,3,30,18,2,1,4,3,0,3,3,4,8,4,-1,4,5,-2,0,2,0,-1,-13,-4,6,2,2,0,1,-1,-1,1,-1,3,1
KR_6767272385,420,-1,7,-22,1,-1,1,2,0,1,1,2,2,0,-1,6,7,1,1,0,1,5,15,-3,8,5,-4,0,1,1,-1,1,1,1,1
KR_6710156138,420,4,40,18,8,0,2,2,5,7,2,2,2,0,3,4,1,-2,1,3,0,10,5,5,3,8,-1,0,1,1,-1,1,-1,3,1
KR_6770067293,440,3,10,16,1,-3,2,5,-1,1,2,2,3,1,1,2,1,2,2,0,-1,-2,-16,-2,4,2,2,0,0,1,-1,0,-1,4,1
KR_6664884202,420,2,-5,-8,3,-1,0,1,1,2,1,-1,3,4,4,6,2,0,0,0,0,6,2,0,6,6,-2,0,0,-1,-1,0,1,1,1
KR_6697578009,420,0,8,8,1,-1,0,1,3,5,2,-1,2,3,-1,2,3,1,1,0,0,4,-2,2,5,7,2,0,0,1,-1,0,-1,5,1
KR_6763111190,420,2,16,32,8,1,3,2,0,1,1,4,4,0,2,5,3,1,1,0,0,-1,-14,-2,5,3,3,0,2,1,1,1,-1,5,1
KR_6769789951,420,-1,-32,-21,2,-2,0,2,1,8,7,-1,4,5,5,8,3,-1,1,2,-2,16,-40,0,7,7,2,0,1,1,1,1,1,4,1
KR_6750244410,420,0,-24,4,5,-1,1,2,0,4,4,5,5,0,-2,1,3,3,3,0,0,8,13,5,4,9,-4,0,0,0,0,0,1,0,1
KR_6767753822,420,-1,-2,18,4,0,2,2,3,5,2,-1,1,2,-1,2,3,3,3,0,0,12,0,0,5,5,4,0,1,-1,1,1,1,4,1
KR_6712010794,420,3,49,44,3,0,2,2,-1,4,5,8,8,0,-1,2,3,-3,0,3,0,4,110,2,4,6,3,0,2,1,1,1,-1,1,1
KR_6697251936,420,6,14,4,17,2,4,2,8,10,2,2,3,1,3,7,4,2,2,0,1,22,-20,-3,6,3,0,0,-1,-1,-1,1,1,5,1
KR_6769770715,420,3,15,17,7,1,3,2,1,6,5,3,3,0,1,1,0,1,1,0,1,8,-9,5,2,7,-2,0,2,1,1,1,1,3,1
KR_6766776414,420,0,-60,-9,2,1,2,1,3,5,2,0,0,0,-1,1,2,-1,0,1,0,-1,10,1,6,7,-2,0,-1,-1,1,-1,-1,6,1
KR_6762010490,420,4,26,45,13,4,4,0,2,4,2,-2,5,7,6,6,0,3,3,0,0,15,-6,-6,12,6,7,0,1,1,1,1,1,3,1
KR_6748915396,440,1,45,28,-4,-4,0,4,-6,1,7,1,2,1,3,4,1,2,2,0,0,4,35,0,3,3,-14,0,0,1,-1,0,-1,1,1
KR_6750826661,420,1,27,-20,-5,0,2,2,0,1,1,-3,1,4,0,3,3,-2,2,4,0,-5,-3,1,6,7,-3,0,0,-1,-1,0,-1,6,1
KR_6765826999,420,6,-24,-2,14,5,5,0,7,9,2,1,4,3,2,4,2,-1,0,1,0,9,-4,0,6,6,2,0,1,1,1,1,-1,5,1
KR_6707018053,420,-1,20,-16,0,3,5,2,-4,2,6,1,1,0,-1,4,5,1,1,0,0,1,1,0,7,7,0,0,-1,1,-1,-1,-1,2,1
KR_6769810436,420,3,13,45,13,-3,2,5,3,3,0,4,4,0,8,9,1,1,1,0,0,11,-1,1,3,4,5,0,1,1,1,1,1,6,1
KR_6767849708,440,2,19,27,6,-1,4,5,1,2,1,2,2,0,4,5,1,0,1,1,1,7,-10,-3,4,1,4,0,0,0,0,1,1,0,1
KR_6768578723,420,-1,1,12,-4,2,2,0,-4,2,6,0,3,3,-4,2,6,2,2,0,0,-11,1,5,5,10,2,0,-1,1,1,-1,-1,5,1
KR_6766490950,420,-1,27,-42,-4,-2,1,3,1,1,0,-2,1,3,-2,1,3,1,1,0,0,-6,-10,-2,8,6,3,0,0,-1,1,0,-1,6,1
KR_6749090521,420,-2,45,-13,-4,-4,1,5,-1,2,3,-2,2,4,3,5,2,0,1,1,-1,7,-13,0,6,6,-1,0,1,-1,-1,1,-1,1,1
KR_6760868590,420,2,23,-16,1,3,5,2,-4,1,5,1,2,1,2,4,2,-1,0,1,0,5,84,-6,7,1,5,0,1,1,-1,1,1,3,1
KR_6694383268,420,-2,40,8,-4,-2,1,3,0,3,3,-3,0,3,1,1,0,0,2,2,1,0,9,2,5,7,-6,0,-1,-1,1,-1,1,3,1
KR_6752401957,420,0,37,16,0,-1,3,4,-4,1,5,4,6,2,1,5,4,0,2,2,0,-2,-3,1,4,5,1,0,2,-1,1,1,1,3,1
KR_6768123949,420,1,10,-11,4,5,5,0,1,3,2,-2,1,3,1,2,1,-1,0,1,0,2,-1,-2,5,3,5,0,1,-1,1,1,-1,6,1
KR_6700261485,420,2,-1,-18,7,3,5,2,-1,1,2,3,3,0,2,3,1,0,1,1,0,7,8,3,6,9,2,0,1,1,1,1,1,4,1
KR_6770156146,420,1,9,0,5,-3,1,4,2,3,1,3,4,1,2,4,2,1,1,0,0,11,1,1,4,5,4,0,0,1,1,-1,1,6,1
KR_6720240361,420,0,5,-7,-3,1,2,1,-4,0,4,1,3,2,-1,0,1,0,0,0,0,-5,-4,-3,8,5,3,0,1,-1,1,1,1,5,1
KR_6766651181,420,5,-8,12,6,2,3,1,1,5,4,4,5,1,0,4,4,-1,2,3,0,-2,-39,-1,7,6,0,0,0,-1,1,1,1,6,1
KR_6741462575,420,1,31,20,6,1,3,2,3,7,4,1,2,1,-1,0,1,2,4,2,1,10,32,9,0,9,3,0,0,0,1,-1,1,0,1
KR_6746232927,420,4,22,23,9,3,5,2,4,5,1,0,4,4,0,1,1,2,2,0,0,10,-7,-2,6,4,0,0,1,1,1,1,1,3,1
KR_6769388448,420,1,67,-16,4,-3,3,6,0,4,4,2,4,2,3,6,3,2,3,1,-2,13,-29,-3,5,2,2,0,0,1,-1,-1,1,4,1
KR_6757607770,420,2,37,-16,1,2,2,0,-3,0,3,-1,3,4,2,4,2,1,1,0,0,5,4,1,3,4,0,0,2,1,1,1,1,6,1
KR_6678693576,420,4,60,16,6,1,3,2,-1,0,1,2,2,0,3,5,2,1,1,0,0,7,11,2,6,8,0,0,5,-1,1,1,1,4,1
KR_6611265219,420,0,17,-1,-1,2,2,0,-6,1,7,-2,0,2,3,3,0,2,2,0,0,-2,-24,3,4,7,-4,0,0,-1,-1,1,-1,2,1
KR_6769709361,420,1,53,0,-2,5,6,1,-3,0,3,-3,2,5,0,3,3,-1,1,2,0,-4,-36,-4,7,3,4,0,-1,-1,-1,-1,-1,1,1
KR_6695271495,420,1,5,47,-2,3,5,2,-2,2,4,1,3,2,-4,2,6,0,0,0,1,-7,12,7,2,9,-11,0,0,-1,1,1,1,1,1
KR_6747364810,420,5,66,31,15,3,3,0,3,5,2,8,8,0,1,2,1,0,1,1,0,10,7,0,6,6,-1,0,0,0,1,1,1,0,1
KR_6753224560,420,2,27,16,0,2,2,0,0,0,0,1,3,2,-2,0,2,-1,0,1,0,-3,5,-3,6,3,-1,0,0,-1,1,1,-1,2,1
KR_6648859710,420,4,20,-8,2,-2,1,3,5,6,1,-1,0,1,-1,0,1,1,2,1,0,10,46,1,7,8,-26,0,0,1,-1,0,-1,5,1
KR_6750323249,420,-1,-40,23,-9,0,1,1,2,6,4,-1,1,2,-4,3,7,-6,0,6,1,-9,-30,0,7,7,20,0,-2,-1,1,-1,1,6,1
KR_6631968324,420,-1,18,-14,0,-4,0,4,0,3,3,0,1,1,2,2,0,2,2,0,1,-3,-120,-1,6,5,2,0,0,1,1,0,1,2,1
KR_6758080232,420,1,-21,36,-3,2,3,1,-6,0,6,1,2,1,1,6,5,-1,3,4,-1,-7,-10,0,6,6,5,0,-1,1,-1,-1,-1,4,1
KR_6723822158,420,2,42,32,6,-2,3,5,3,11,8,6,8,2,-2,3,5,1,4,3,0,9,-13,-3,5,2,0,0,-1,-1,0,-1,1,6,1
KR_6679920512,420,5,66,0,11,0,0,0,0,3,3,5,5,0,6,6,0,0,0,0,0,13,-2,0,5,5,-3,0,1,1,-1,1,-1,4,1
KR_6704318536,420,3,32,15,0,0,2,2,-2,1,3,3,3,0,1,2,1,-2,0,2,-1,-4,43,-1,5,4,-6,0,1,-1,1,1,-1,2,1
KR_6661111002,420,2,38,-18,4,3,4,1,-1,0,1,-2,1,3,5,5,0,-1,0,1,0,3,6,3,4,7,0,0,0,-1,-1,1,-1,5,1
KR_6740636049,420,4,68,46,11,7,8,1,8,9,1,2,4,2,-4,3,7,-2,0,2,1,9,4,2,10,12,10,0,3,1,1,1,1,2,1
KR_6741662489,420,0,-2,-12,6,3,3,0,-1,1,2,0,1,1,2,4,2,2,2,0,1,8,-3,1,4,5,-2,0,1,1,-1,1,1,3,1
KR_6762898938,420,0,-45,-6,1,-1,0,1,-1,7,8,1,4,3,1,6,5,1,2,1,-1,-1,-9,-4,7,3,2,0,1,-1,-1,-1,-1,5,1
KR_6749352224,420,1,50,13,-1,0,1,1,-1,4,5,0,2,2,-1,4,5,1,2,1,0,-6,26,4,5,9,-1,0,1,-1,-1,1,1,4,1
KR_6760204223,420,-1,30,-4,-3,0,1,1,1,2,1,1,5,4,-4,2,6,-1,0,1,0,-6,18,-2,5,3,-2,0,1,-1,1,1,1,6,1
KR_6728069056,420,3,82,-19,3,3,6,3,-2,4,6,1,3,2,1,2,1,0,0,0,0,0,-37,1,5,6,5,0,1,-1,1,1,1,2,1
KR_6768609856,420,6,120,2,16,2,2,0,5,7,2,-1,1,2,8,9,1,2,2,0,0,16,-1,-2,7,5,0,0,1,1,1,1,1,5,1
KR_6767904160,420,2,31,1,9,5,5,0,3,3,0,-5,0,5,5,5,0,1,2,1,0,8,5,0,5,5,0,0,1,1,-1,1,1,1,1
KR_6689616654,420,4,-15,14,9,1,2,1,2,5,3,-2,1,3,6,6,0,2,2,0,0,17,8,6,2,8,0,0,0,1,-1,-1,1,5,1
KR_6708362191,420,0,4,-17,1,-1,2,3,0,2,2,-3,1,4,4,6,2,1,3,2,1,4,-17,-1,4,3,8,0,1,1,1,1,1,1,1
KR_6764996818,420,4,28,14,17,8,8,0,1,2,1,7,7,0,2,2,0,-1,0,1,1,15,-113,4,5,9,1,0,0,1,1,0,1,2,1
KR_6770110015,420,-1,-42,5,6,2,3,1,4,8,4,3,4,1,-3,3,6,0,1,1,1,6,5,2,7,9,3,0,1,1,-1,1,1,1,1
KR_6764778895,420,1,41,-16,3,1,2,1,1,3,2,-1,2,3,2,4,2,0,0,0,1,4,-2,4,3,7,2,0,0,1,1,1,1,2,1
KR_6741869787,420,3,42,29,6,2,2,0,0,3,3,1,3,2,4,6,2,-1,0,1,0,-2,15,2,3,5,-5,0,1,0,1,1,1,0,1
KR_6770303522,420,-4,-69,-16,-10,-2,1,3,-3,1,4,-4,2,6,0,3,3,-1,0,1,0,-3,1,-4,6,2,4,0,-1,-1,-1,-1,-1,6,1
KR_6749726969,420,0,5,11,-4,-2,0,2,-4,1,5,-2,0,2,3,6,3,1,2,1,0,-5,3,-1,6,5,2,0,0,-1,1,-1,1,5,1
KR_6691658409,420,8,101,60,16,-2,1,3,7,8,1,4,5,1,5,5,0,2,4,2,0,15,-4,-1,8,7,5,0,2,1,1,1,-1,2,1
KR_6688222944,420,1,13,-12,2,2,4,2,2,3,1,0,1,1,0,1,1,-2,0,2,0,1,4,-4,7,3,7,0,1,1,1,1,1,2,1
KR_6763500999,420,1,-15,7,5,-1,2,3,-2,2,4,3,4,1,2,5,3,3,3,0,0,8,-10,-2,8,6,0,0,-2,1,1,-1,-1,2,1
KR_6714538943,420,3,26,15,2,6,6,0,-5,3,8,4,4,0,0,2,2,-3,0,3,0,-5,5,-2,7,5,-4,0,2,-1,1,1,1,5,1
KR_6765185113,420,-2,25,-14,-5,5,6,1,-4,3,7,-3,0,3,-2,1,3,-1,0,1,-1,-8,-2,-3,8,5,-2,0,0,-1,0,0,-1,5,1
KR_6758979745,420,0,-18,-21,-2,1,5,4,1,4,3,-2,4,6,-1,3,4,-1,0,1,-1,-10,3,6,3,9,-1,0,-1,-1,-1,-1,-1,2,1
KR_6765535906,420,8,83,13,20,5,7,2,4,4,0,6,7,1,4,6,2,1,1,0,0,12,-24,3,4,7,4,0,2,1,1,1,1,6,1
KR_6763015876,440,3,61,-3,14,0,0,0,7,7,0,7,7,0,3,6,3,-3,1,4,0,13,-8,-2,8,6,2,0,0,1,1,0,1,4,1
KR_6730781338,440,-1,-11,4,-2,-1,1,2,3,5,2,-2,2,4,-3,3,6,1,2,1,0,-3,-24,-2,7,5,2,0,0,-1,1,0,1,4,1
KR_6687850470,420,1,14,8,2,4,4,0,2,3,1,-1,4,5,-2,3,5,-1,2,3,0,4,5,-2,7,5,3,0,1,1,1,1,1,2,1
KR_6764302249,420,2,13,-8,12,-2,1,3,5,7,2,2,2,0,8,8,0,-1,0,1,0,15,6,-3,9,6,-3,0,1,-1,1,1,1,3,1
KR_6767646619,420,3,66,47,6,5,5,0,-3,2,5,1,2,1,5,5,0,-2,0,2,0,7,-160,-5,8,3,13,0,1,-1,1,1,-1,6,1
KR_6620059490,420,1,30,-46,0,0,3,3,5,5,0,0,4,4,-6,0,6,1,4,3,-1,0,-4,4,6,10,2,0,0,-1,-1,1,-1,6,1
KR_6734346320,420,0,34,-9,4,-1,2,3,2,4,2,3,4,1,0,1,1,0,0,0,0,2,-4,0,9,9,-1,0,1,1,1,1,1,5,1
KR_6742644187,420,2,42,7,1,-1,3,4,1,2,1,0,3,3,1,3,2,0,1,1,0,3,19,-1,6,5,-1,0,0,1,1,1,-1,4,1
KR_6769507832,420,0,-13,0,-5,0,2,2,-1,2,3,0,0,0,-1,1,2,-3,0,3,0,-4,-2,1,2,3,3,0,-1,1,-1,-1,-1,2,1
KR_6748937780,420,2,-4,0,5,3,4,1,2,4,2,0,1,1,0,1,1,0,0,0,0,11,-3,0,7,7,2,0,0,0,1,0,1,0,1
KR_6769129208,420,5,42,22,17,-1,3,4,4,5,1,10,11,1,1,1,0,3,5,2,2,22,-4,-1,5,4,0,0,2,1,1,1,1,4,1
KR_6765638820,420,4,10,0,11,5,5,0,-2,3,5,3,4,1,5,7,2,0,1,1,0,2,0,4,5,9,1,0,2,1,-1,1,1,1,1
KR_6767027766,420,3,53,31,5,2,3,1,3,4,1,3,4,1,-4,1,5,1,1,0,0,6,15,7,2,9,2,0,0,1,1,0,1,2,1
KR_6769796976,420,3,66,-11,8,1,4,3,4,5,1,0,3,3,0,1,1,3,3,0,0,4,0,0,4,4,4,0,-2,1,-1,-1,1,4,1
KR_6769299588,420,-1,10,-16,-2,-4,1,5,4,5,1,0,1,1,0,4,4,-2,0,2,1,5,5,3,5,8,-6,0,1,1,-1,-1,1,5,1
KR_6762437240,420,5,8,23,11,4,5,1,3,5,2,-2,2,4,3,3,0,3,3,0,0,13,6,0,3,3,-1,0,2,1,1,1,1,1,1
KR_6765138275,420,1,-17,2,7,1,3,2,3,5,2,1,1,0,2,2,0,0,0,0,0,4,1,-3,6,3,7,0,0,1,-1,0,1,4,1
KR_6769565303,420,3,39,-16,8,3,4,1,-2,2,4,1,2,1,6,9,3,0,1,1,0,3,2,-2,9,7,6,0,0,1,-1,1,1,3,1
KR_6741378728,440,2,38,17,-1,1,5,4,0,2,2,0,0,0,-1,0,1,-1,0,1,-1,-3,-62,-3,7,4,-2,0,-1,1,1,1,-1,1,1
KR_6767770364,420,-2,6,1,-6,1,2,1,-5,2,7,1,3,2,-3,2,5,0,1,1,0,-14,0,0,3,3,1,0,1,-1,1,1,1,2,1
KR_6767696007,420,0,-9,7,4,-1,0,1,4,6,2,0,2,2,1,3,2,0,0,0,0,7,16,-2,6,4,31,0,0,0,0,-1,1,0,1
KR_6738484343,420,-1,2,15,4,6,7,1,-1,0,1,-1,1,2,0,2,2,0,4,4,0,7,-156,5,1,6,-2,0,2,1,1,1,1,5,1
KR_6755593585,440,-2,-8,4,-4,0,3,3,-1,0,1,-4,1,5,6,6,0,-5,1,6,0,-1,-4,-1,5,4,-3,0,1,1,1,1,-1,6,1
KR_6756511652,420,2,38,21,-1,-3,0,3,-2,0,2,0,4,4,1,3,2,3,3,0,0,4,-4,-9,11,2,5,0,2,0,-1,1,-1,0,1
KR_6711997099,420,2,61,-10,10,2,3,1,8,8,0,0,1,1,-1,2,3,1,2,1,-1,10,3,3,4,7,2,0,0,-1,1,1,-1,5,1
KR_6713233406,420,1,-43,10,-5,-4,1,5,-4,1,5,1,4,3,0,3,3,2,5,3,0,-2,-250,0,3,3,1,0,0,-1,-1,-1,1,3,1
KR_6735697927,440,6,69,29,10,0,2,2,4,12,8,3,3,0,3,4,1,0,1,1,0,5,-7,-1,4,3,1,0,1,1,1,1,-1,3,1
KR_6557941909,440,-2,20,-1,-7,-1,2,3,-6,0,6,2,3,1,-5,0,5,3,3,0,0,-5,-8,-2,9,7,10,0,0,1,1,0,1,4,1
KR_6754910838,420,3,6,23,4,-1,4,5,2,3,1,1,5,4,-1,4,5,3,4,1,1,4,0,-3,4,1,0,0,-1,1,1,1,1,6,1
KR_6731324282,420,-1,7,1,4,-1,3,4,0,3,3,1,1,0,4,4,0,0,1,1,0,11,5,-2,8,6,2,0,1,1,-1,1,1,5,1
KR_6747700732,420,0,5,-20,5,-1,4,5,0,1,1,-1,1,2,4,8,4,3,4,1,0,-1,60,1,6,7,-13,0,0,1,0,1,1,2,1
KR_6766013209,420,2,-30,28,-3,0,1,1,2,2,0,3,3,0,-3,1,4,-5,1,6,0,2,-4,-2,4,2,0,0,-2,-1,1,-1,-1,6,1
KR_6719124012,420,3,78,-20,5,2,2,0,4,4,0,-2,1,3,0,2,2,1,1,0,1,3,4,2,3,5,2,0,0,-1,0,0,1,3,1
KR_6689474849,420,0,-36,12,4,-1,1,2,4,5,1,-2,3,5,3,4,1,0,1,1,0,7,18,6,3,9,1,0,0,1,1,0,1,2,1
KR_6741991105,440,5,21,28,7,-1,0,1,1,4,3,-1,1,2,6,6,0,2,3,1,2,9,7,-2,7,5,-2,0,1,1,1,1,1,3,1
KR_6770058880,420,1,-24,50,-2,-2,3,5,0,3,3,0,1,1,1,1,0,-1,5,6,0,-1,1,1,3,4,-2,0,0,-1,1,1,-1,3,1
KR_6765540853,420,-1,-28,0,1,-5,2,7,2,2,0,1,2,1,3,5,2,0,0,0,-1,10,25,2,5,7,2,0,0,1,1,-1,-1,3,1
KR_6760265856,420,-1,30,-21,-3,4,5,1,1,3,2,-2,0,2,-6,5,11,0,0,0,0,-1,21,-2,5,3,2,0,1,-1,1,1,1,4,1
KR_6747121421,420,-1,61,-4,-1,1,3,2,3,6,3,-8,4,12,4,8,4,-1,0,1,1,10,-223,9,2,11,1,0,1,-1,1,1,1,1,1
KR_6693900782,420,-1,42,-24,2,-1,1,2,1,4,3,-3,1,4,4,5,1,1,2,1,1,3,-16,-1,7,6,0,0,0,-1,-1,1,1,1,1
KR_6770375663,420,-3,-36,-10,-11,-8,0,8,3,3,0,-2,4,6,-2,0,2,-2,0,2,0,-10,-7,-5,10,5,-3,0,-1,-1,-1,-1,-1,2,1
KR_6725239837,420,1,27,32,6,2,3,1,3,4,1,0,2,2,-1,2,3,2,2,0,0,8,-47,-1,5,4,23,0,0,-1,1,0,1,4,1
KR_6744639722,420,-4,-63,12,-9,-2,0,2,0,1,1,0,3,3,-9,1,10,2,3,1,0,-5,3,-6,7,1,0,0,-2,-1,1,-1,-1,1,1
KR_6763357706,420,-1,-34,-23,2,-3,3,6,1,5,4,1,2,1,3,4,1,0,0,0,0,0,-3,1,3,4,-2,0,-4,1,-1,-1,1,5,1
KR_6769843566,420,-1,-19,-28,-3,-1,0,1,2,3,1,0,3,3,-1,3,4,-3,0,3,0,3,2,-1,6,5,-3,0,-1,-1,-1,-1,-1,4,1
KR_6636465493,420,1,-4,-5,3,-2,1,3,-1,4,5,2,2,0,4,11,7,0,0,0,0,2,131,-1,5,4,-1,0,0,1,-1,1,1,6,1
KR_6769561713,420,3,65,17,12,1,3,2,2,5,3,1,1,0,7,7,0,1,1,0,1,9,6,5,1,6,-1,0,1,1,0,1,1,4,1
KR_6681692795,420,3,33,8,11,2,4,2,5,7,2,-2,0,2,1,3,2,5,5,0,0,11,8,3,6,9,-1,0,0,-1,1,1,1,5,1
KR_6750306188,420,3,52,-4,2,2,3,1,-2,1,3,-4,3,7,2,4,2,4,4,0,0,1,19,-2,8,6,4,0,0,1,0,1,1,3,1
KR_6675418037,420,3,25,-12,5,1,1,0,-1,2,3,1,1,0,4,5,1,0,1,1,1,14,3,4,2,6,2,0,1,1,1,1,1,3,1
KR_6758849680,440,0,-55,12,4,-1,1,2,9,10,1,-4,0,4,0,4,4,0,2,2,0,8,-314,0,2,2,-8,0,1,0,1,1,1,0,1
KR_6769880210,420,5,76,-22,10,2,4,2,7,11,4,-1,1,2,3,3,0,-1,1,2,0,11,-23,-6,11,5,4,0,1,-1,0,1,1,1,1
KR_6770130449,420,5,46,20,11,7,7,0,-5,1,6,4,7,3,3,4,1,2,4,2,0,10,12,5,1,6,-7,0,0,1,1,1,1,3,1
KR_6753717001,420,2,51,27,11,4,5,1,8,8,0,-3,1,4,3,6,3,-1,0,1,1,5,3,0,6,6,3,0,2,1,1,1,1,2,1
KR_6760396166,420,7,92,36,11,3,4,1,3,6,3,5,9,4,0,2,2,0,2,2,1,8,40,-2,6,4,-19,0,2,1,1,1,1,6,1
KR_6770248132,420,0,15,0,-5,-2,2,4,1,5,4,-2,2,4,1,4,3,-3,0,3,-1,-9,4,6,4,10,-2,0,1,1,1,1,-1,4,1
KR_6728508177,420,-1,-23,16,-3,-2,1,3,0,3,3,3,4,1,-3,1,4,-1,0,1,0,0,-15,0,4,4,-4,0,0,-1,1,0,1,6,1
KR_6701137087,440,2,14,4,4,2,5,3,-1,0,1,-2,0,2,5,6,1,0,2,2,0,3,-188,1,4,5,3,0,1,1,0,1,1,1,1
KR_6768841496,440,-1,-109,0,-2,-3,0,3,4,5,1,0,1,1,-3,5,8,0,2,2,-1,4,-4,-2,4,2,1,0,-1,-1,-1,-1,-1,2,1
KR_6766361249,420,2,-16,15,2,-2,2,4,-1,1,2,-2,3,5,5,6,1,2,2,0,0,1,1,4,7,11,5,0,1,1,1,1,1,1,1
KR_6644644730,420,2,42,-13,1,1,3,2,0,5,5,5,6,1,-3,2,5,-2,0,2,0,-3,-15,-3,8,5,1,0,0,1,1,1,1,1,1
KR_6747491383,420,3,29,13,4,1,2,1,0,1,1,4,6,2,-1,2,3,0,1,1,0,-3,2,2,6,8,-3,0,2,1,1,1,1,2,1
KR_6674089156,420,0,42,15,-8,2,3,1,-3,0,3,-7,2,9,0,3,3,0,1,1,0,-14,-22,-1,7,6,0,0,1,-1,1,1,-1,5,1
KR_6747476734,420,-4,-95,-10,-7,-3,0,3,-1,4,5,5,7,2,-6,3,9,-2,0,2,0,-6,-2,0,10,10,-1,0,-1,-1,1,-1,-1,1,1
KR_6734060004,420,0,16,0,9,1,2,1,0,1,1,5,7,2,3,5,2,0,0,0,1,5,-20,1,6,7,6,0,1,0,0,1,1,0,1
KR_6733250933,420,-2,-79,43,-6,-4,0,4,2,6,4,-3,1,4,3,4,1,-4,0,4,1,-2,-6,-1,5,4,1,0,0,1,-1,0,1,4,1
KR_6746391913,420,1,8,7,5,0,2,2,1,4,3,1,3,2,2,2,0,1,2,1,0,10,43,4,2,6,1,0,0,1,-1,-1,1,3,1
KR_6745340322,420,5,21,-8,13,0,3,3,-1,2,3,10,11,1,1,6,5,3,3,0,0,16,14,1,5,6,-3,0,2,1,-1,1,1,2,1
KR_6689614707,420,1,2,16,6,2,2,0,5,6,1,-3,0,3,-1,1,2,3,3,0,1,5,4,4,5,9,-3,0,0,1,0,0,1,4,1
KR_6710482327,420,6,73,3,13,2,2,0,3,4,1,3,5,2,5,5,0,0,3,3,0,13,-7,4,3,7,1,0,0,1,-1,1,1,5,1
KR_6769880021,420,3,25,0,6,1,1,0,4,4,0,0,4,4,0,4,4,1,3,2,0,11,6,1,4,5,2,0,0,-1,1,1,-1,4,1
KR_6768600702,420,-2,-43,-23,-1,-2,1,3,-1,1,2,-1,1,2,3,4,1,0,1,1,0,7,6,2,6,8,-2,0,-1,-1,-1,-1,1,3,1
KR_6752582349,420,2,78,-4,9,-2,0,2,3,3,0,1,3,2,6,6,0,1,2,1,0,9,-6,-2,10,8,5,0,2,1,-1,1,1,2,1
KR_6769046191,420,2,81,-13,3,-1,1,2,1,3,2,5,5,0,-3,4,7,1,1,0,0,-3,-112,3,3,6,0,0,0,-1,-1,0,1,1,1
KR_6764362803,420,0,-34,-1,-3,-1,1,2,-1,0,1,-1,2,3,1,3,2,-1,0,1,0,-7,-3,2,4,6,0,0,0,-1,-1,1,-1,3,1
KR_6737069606,420,1,86,-1,10,2,3,1,6,10,4,0,2,2,-1,1,2,3,4,1,0,16,36,4,1,5,-3,0,1,0,1,1,1,0,1
KR_6664823995,420,2,-39,35,8,-3,0,3,2,7,5,7,8,1,1,1,0,1,2,1,0,11,113,-4,10,6,3,0,2,1,-1,1,1,2,1
KR_6761179682,420,0,6,9,-1,1,3,2,1,4,3,-1,6,7,-1,2,3,-1,1,2,-1,-4,-10,-8,11,3,6,0,2,-1,-1,1,-1,4,1
KR_6764374267,420,-1,-8,4,-1,1,3,2,0,2,2,-2,0,2,-5,0,5,5,5,0,0,-8,0,-1,6,5,5,0,0,1,1,0,1,6,1
KR_6752417340,420,5,107,23,10,5,5,0,1,2,1,0,1,1,2,5,3,2,3,1,0,5,15,-1,5,4,-1,0,2,1,-1,1,1,3,1
KR_6769411665,420,6,136,-1,7,1,3,2,-1,2,3,0,3,3,4,6,2,3,6,3,0,5,1,1,4,5,1,0,2,1,-1,1,1,3,1
KR_6768308302,420,1,-21,32,4,-1,2,3,3,3,0,2,3,1,-2,0,2,2,2,0,0,3,-3,2,5,7,-2,0,-1,1,1,-1,1,4,1
KR_6708589431,420,4,81,25,8,3,5,2,2,7,5,-1,2,3,5,6,1,-1,0,1,0,6,7,4,2,6,-3,0,1,0,0,1,1,0,1
KR_6752158013,440,6,104,12,7,3,3,0,3,5,2,0,4,4,2,5,3,-1,0,1,0,0,11,5,2,7,-7,0,2,1,1,1,1,1,1
KR_6655685083,440,-3,-12,-28,-3,-4,3,7,2,5,3,-4,2,6,-1,1,2,4,4,0,0,-2,-3,-3,4,1,3,0,-1,-1,0,-1,-1,1,1
KR_6635462207,420,4,95,-7,14,9,9,0,2,5,3,2,3,1,0,4,4,1,2,1,0,9,-18,2,2,4,1,0,4,1,1,1,1,6,1
KR_6770176511,420,3,105,-4,6,-3,2,5,1,5,4,2,3,1,7,9,2,-1,1,2,0,8,42,1,4,5,-13,0,1,1,-1,1,1,4,1
KR_6713261285,420,1,-11,8,6,0,1,1,3,4,1,2,3,1,1,1,0,0,0,0,1,9,-78,0,4,4,21,0,0,1,-1,-1,1,1,1
KR_6758474537,420,-1,-9,8,-6,-3,0,3,-2,2,4,-3,0,3,2,2,0,0,2,2,0,-1,5,-3,7,4,-2,0,-1,1,-1,-1,-1,1,1
KR_6742225100,420,0,-29,0,-2,-1,0,1,1,3,2,1,2,1,-3,1,4,0,1,1,1,4,26,0,6,6,-10,0,0,-1,-1,0,1,2,1
KR_6769741148,420,1,12,35,0,-1,2,3,1,2,1,4,5,1,-2,2,4,-2,1,3,0,-9,-3,-4,6,2,-2,0,0,1,1,1,1,5,1
KR_6563049004,420,1,32,-4,-4,2,2,0,-4,1,5,-1,2,3,-2,0,2,1,1,0,0,-9,-107,4,1,5,0,0,1,1,1,1,-1,1,1
KR_6770213934,440,1,33,6,-6,1,1,0,1,2,1,-4,1,5,-4,0,4,0,1,1,0,-15,16,-2,6,4,-2,0,0,0,-1,0,-1,0,1
KR_6751552114,420,-1,-20,11,0,-2,0,2,0,1,1,3,4,1,-2,0,2,1,1,0,0,2,-30,-4,7,3,2,0,0,0,0,0,-1,0,1
KR_6666368407,420,3,74,1,7,3,7,4,1,5,4,0,4,4,2,4,2,1,2,1,0,5,-257,-6,7,1,6,0,1,1,1,1,1,4,1
KR_6738538567,420,0,34,20,1,-1,3,4,3,5,2,-3,0,3,-2,3,5,4,4,0,0,12,-13,3,5,8,4,0,0,1,1,1,-1,2,1
KR_6749063667,420,1,84,-4,3,-1,0,1,0,3,3,1,2,1,4,6,2,-1,0,1,0,6,6,-2,9,7,5,0,1,1,1,1,1,3,1
KR_6770161219,420,-1,-50,34,-3,-1,0,1,6,6,0,-3,0,3,-4,0,4,-1,0,1,0,-2,-4,-4,6,2,3,0,-1,1,1,-1,1,5,1
KR_6745145370,420,2,-85,-3,5,0,1,1,0,5,5,1,4,3,-1,1,2,5,6,1,0,4,14,4,2,6,-2,0,0,-1,1,0,1,1,1
KR_6683230313,420,0,-30,-6,1,-2,2,4,6,6,0,0,2,2,-2,1,3,-1,1,2,-1,7,-1,0,4,4,4,0,0,-1,-1,0,-1,4,1
KR_6748936019,420,4,36,-10,6,2,2,0,4,4,0,6,7,1,-8,1,9,2,2,0,0,3,-2,-3,7,4,1,0,1,-1,1,1,1,2,1
KR_6764807860,440,1,-37,24,3,-1,0,1,7,9,2,0,3,3,-4,1,5,1,2,1,0,-1,1,-5,7,2,3,0,0,-1,0,0,1,4,1
KR_6642344870,420,3,58,33,6,-3,0,3,11,12,1,-2,0,2,-2,1,3,2,4,2,0,11,31,0,6,6,8,0,1,-1,1,1,1,6,1
KR_6621541087,420,6,104,18,16,5,5,0,2,3,1,2,6,4,5,5,0,2,2,0,1,6,2,6,2,8,2,0,1,1,1,1,1,4,1
KR_6768188550,420,3,0,9,5,-1,1,2,2,4,2,-3,1,4,6,6,0,1,2,1,0,5,-9,-1,6,5,2,0,0,-1,1,0,-1,4,1
KR_6738596096,420,4,47,1,1,6,6,0,-7,0,7,2,5,3,0,1,1,0,0,0,0,-5,-2,1,6,7,3,0,0,-1,1,1,-1,3,1
KR_6739401599,440,5,41,36,3,2,3,1,5,7,2,0,2,2,-6,0,6,2,2,0,0,-4,-10,-1,7,6,9,0,3,1,1,1,1,6,1
KR_6756886250,420,3,-36,-35,2,1,4,3,-1,3,4,-2,3,5,0,2,2,4,4,0,0,3,5,-1,4,3,3,0,0,-1,1,-1,1,6,1
KR_6764071269,420,-1,-19,12,-4,0,1,1,-1,2,3,-1,0,1,-1,3,4,-1,0,1,0,-4,41,3,5,8,-6,0,-1,1,-1,-1,1,2,1
KR_6736371488,420,4,44,53,6,1,3,2,6,7,1,0,0,0,1,4,3,-2,1,3,0,7,7,5,4,9,-3,0,3,1,1,1,1,3,1
KR_6716171531,440,5,-12,16,10,3,3,0,1,6,5,6,6,0,0,3,3,0,0,0,0,6,-30,3,2,5,-4,0,1,1,1,-1,1,1,1
KR_6652049953,420,3,27,-6,7,0,0,0,3,5,2,2,4,2,3,3,0,-1,0,1,0,11,-7,3,2,5,2,0,0,1,1,0,1,1,1
KR_6724564785,420,0,36,-13,-1,7,7,0,-1,1,2,-4,1,5,-1,1,2,-2,0,2,-1,-2,-10,-5,7,2,1,0,-1,-1,-1,-1,-1,3,1
KR_6636548226,420,2,7,24,2,4,5,1,0,2,2,-2,1,3,2,6,4,-2,1,3,0,3,33,4,7,11,-10,0,0,-1,1,1,-1,4,1
KR_6738498959,420,0,-41,2,-5,0,1,1,-4,3,7,-2,1,3,2,3,1,-1,0,1,0,-1,-2,-4,7,3,0,0,0,1,-1,0,-1,2,1
KR_6710600344,420,2,33,5,8,1,2,1,6,7,1,-1,0,1,3,5,2,-1,0,1,0,5,31,1,5,6,-25,0,1,1,-1,1,1,3,1
KR_6729380851,420,9,121,17,12,2,2,0,10,11,1,0,2,2,0,2,2,0,1,1,-1,9,20,-7,12,5,9,0,1,1,-1,1,-1,3,1
KR_6631380387,420,-1,25,-32,1,1,2,1,-5,0,5,2,5,3,2,4,2,1,2,1,-1,1,4,1,3,4,0,0,0,1,1,1,-1,3,1
KR_6752751055,420,1,-2,8,6,-4,0,4,7,7,0,0,2,2,1,5,4,2,3,1,0,5,20,5,1,6,0,0,-1,1,-1,-1,-1,6,1
KR_6750784437,420,1,9,-48,-1,0,1,1,-3,2,5,2,3,1,5,5,0,-5,0,5,-2,-4,-191,1,5,6,-2,0,0,-1,-1,0,-1,6,1
KR_6753823825,420,0,25,34,-4,-2,1,3,-4,3,7,1,5,4,2,4,2,-1,0,1,0,-3,-8,-6,10,4,-5,0,-1,1,-1,-1,-1,2,1
KR_6767701578,420,5,28,-12,16,7,8,1,2,4,2,0,2,2,4,4,0,3,3,0,1,11,9,-3,7,4,-3,0,0,1,0,1,-1,3,1
KR_6765496849,420,3,16,33,4,0,2,2,3,3,0,5,7,2,-3,0,3,-1,0,1,0,0,-1,4,3,7,-1,0,0,-1,-1,-1,1,6,1
KR_6766016067,420,6,66,11,17,3,4,1,3,4,1,3,4,1,8,10,2,0,2,2,0,21,-1,-3,5,2,0,0,1,-1,1,1,1,1,1
KR_6766969187,420,-2,-23,-56,1,1,2,1,-1,5,6,-3,2,5,5,6,1,-1,0,1,0,1,-6,0,4,4,-1,0,0,-1,1,0,1,2,1
KR_6766699293,420,-1,-25,7,-3,1,2,1,-1,4,5,0,3,3,-3,1,4,0,1,1,0,1,1,1,4,5,-2,0,1,-1,1,1,1,5,1
KR_6767323436,420,0,-52,9,9,1,4,3,3,4,1,3,6,3,1,4,3,1,5,4,1,17,-6,-4,10,6,4,0,0,1,1,-1,1,5,1
KR_6759440697,420,3,-1,4,12,0,3,3,4,7,3,2,3,1,4,5,1,2,4,2,1,8,0,1,5,6,-4,0,0,-1,1,1,1,3,1
KR_6765415162,440,0,-73,-26,2,0,1,1,5,9,4,-2,2,4,-1,2,3,0,1,1,0,1,274,1,4,5,-3,0,0,-1,1,0,-1,5,1
KR_6758269176,420,0,-76,18,4,4,5,1,-1,0,1,0,2,2,1,2,1,0,1,1,0,1,-39,2,3,5,19,0,-1,-1,1,-1,1,6,1
KR_6716284392,440,5,47,-20,14,5,5,0,2,2,0,1,1,0,2,5,3,4,5,1,0,14,4,4,2,6,2,0,0,0,1,0,1,0,1
KR_6741368155,420,-1,-31,-24,6,1,3,2,1,5,4,0,2,2,4,5,1,0,0,0,0,7,25,5,4,9,1,0,-1,-1,1,1,-1,5,1
KR_6768121308,420,1,-43,60,3,3,4,1,-2,1,3,1,3,2,1,2,1,0,1,1,0,-1,-15,-2,5,3,-1,0,-1,1,-1,-1,-1,2,1
KR_6734758787,440,3,-8,10,-3,-1,1,2,-1,3,4,-4,0,4,3,3,0,0,0,0,0,-2,14,3,4,7,0,0,1,1,-1,1,-1,4,1
KR_6724985762,420,5,21,17,10,1,3,2,3,5,2,5,5,0,2,2,0,-1,0,1,0,10,-1,2,4,6,1,0,0,1,1,0,1,3,1
KR_6759889639,420,6,51,4,19,9,9,0,5,5,0,3,6,3,1,3,2,1,3,2,0,26,0,1,6,7,3,0,2,1,-1,1,1,6,1
KR_6764329236,420,-2,-28,10,0,-3,2,5,-2,4,6,1,2,1,2,4,2,2,3,1,0,13,-223,4,4,8,1,0,0,1,-1,0,-1,4,1
KR_6765123809,420,-2,4,-20,-3,-1,1,2,-3,2,5,0,1,1,1,2,1,0,0,0,0,0,39,3,4,7,-1,0,0,-1,-1,0,-1,1,1
KR_6762725843,420,6,71,7,15,5,6,1,7,8,1,3,4,1,1,4,3,-1,0,1,0,18,-3,-1,6,5,6,0,0,1,1,1,-1,6,1
KR_6763087698,420,0,14,0,-3,-1,0,1,-3,3,6,-1,1,2,1,3,2,1,2,1,0,-6,-2,0,4,4,-2,0,-1,-1,-1,-1,1,4,1
KR_6749142089,420,1,70,-10,5,-1,2,3,5,7,2,0,2,2,3,3,0,-2,1,3,1,6,-8,-2,6,4,3,0,2,1,1,1,1,1,1
KR_6768797882,420,2,-10,29,6,4,5,1,-3,1,4,-3,1,4,7,9,2,1,2,1,0,1,13,-1,6,5,-3,0,1,1,-1,-1,1,6,1
KR_6689603395,420,5,122,23,11,2,6,4,3,4,1,2,4,2,4,4,0,0,0,0,0,2,-2,0,5,5,9,0,1,1,1,1,1,5,1
KR_6690351772,420,2,40,17,0,-1,1,2,-3,3,6,-2,0,2,4,4,0,2,4,2,0,-2,-19,-3,6,3,1,0,0,1,-1,0,-1,3,1
KR_6768058569,420,3,-8,-32,7,-7,1,8,0,2,2,10,11,1,4,5,1,0,1,1,-1,18,-45,-4,6,2,12,0,0,1,-1,-1,-1,5,1
KR_6767718089,420,2,81,-7,11,2,4,2,7,7,0,3,3,0,2,2,0,-3,1,4,0,11,-30,1,4,5,4,0,1,-1,1,1,-1,6,1
KR_6757381071,420,0,3,9,1,-1,1,2,0,2,2,-4,0,4,4,7,3,2,2,0,0,7,-2,0,5,5,-4,0,0,-1,-1,1,1,6,1
KR_6708434995,420,2,46,12,4,-1,2,3,4,5,1,-1,2,3,0,1,1,2,3,1,0,-8,16,0,5,5,-2,0,2,1,1,1,1,6,1
KR_6767071286,420,-1,-7,21,1,0,1,1,2,4,2,-1,1,2,1,2,1,-1,1,2,0,2,1,1,6,7,-5,0,-1,0,1,-1,1,0,1
KR_6681951457,420,1,27,1,1,1,2,1,-2,0,2,0,1,1,2,2,0,0,0,0,0,-3,26,-5,10,5,5,0,1,1,-1,1,1,6,1
KR_6680653074,420,-4,31,-37,-3,2,4,2,1,7,6,1,4,3,-7,0,7,0,2,2,0,-9,-26,6,4,10,5,0,0,1,1,-1,-1,2,1
KR_6626370153,420,4,102,28,8,2,2,0,1,4,3,6,6,0,-1,5,6,0,1,1,0,4,-3,0,7,7,-1,0,4,1,1,1,1,5,1
KR_6770386880,420,-2,0,-4,-2,-2,1,3,-2,0,2,4,8,4,-2,0,2,0,2,2,3,-1,-2,1,4,5,-5,0,-1,-1,1,-1,-1,2,1
KR_6768894455,420,3,53,1,1,-1,3,4,-6,1,7,4,4,0,5,5,0,-1,0,1,0,-4,21,-2,6,4,5,0,1,1,-1,1,1,5,1
KR_6769683530,420,-2,30,32,-1,1,4,3,-2,2,4,-1,0,1,-2,1,3,3,3,0,0,-4,10,10,0,10,-1,0,1,1,1,1,1,5,1
KR_6764245565,420,3,31,-27,8,2,4,2,3,4,1,-2,2,4,3,3,0,2,2,0,1,9,-2,5,4,9,0,0,1,1,-1,-1,1,4,1
KR_6769556786,420,0,-19,-16,-1,2,4,2,-1,1,2,-2,3,5,2,4,2,-2,1,3,0,-4,-1,3,3,6,2,0,1,-1,-1,1,-1,3,1
KR_6753959092,420,-2,25,-9,3,1,2,1,-3,2,5,-2,5,7,4,4,0,3,5,2,3,7,4,-4,7,3,0,0,0,-1,1,-1,-1,5,1
KR_6769782969,420,4,123,6,11,2,2,0,1,1,0,2,4,2,6,10,4,0,2,2,0,11,-25,2,2,4,3,0,2,1,1,1,1,6,1
KR_6621730821,420,2,54,-11,2,-1,2,3,-1,1,2,-1,0,1,5,6,1,0,0,0,0,5,-20,2,4,6,2,0,1,1,-1,1,1,3,1
KR_6758350760,420,0,52,-8,9,-1,0,1,-1,1,2,4,5,1,6,9,3,1,1,0,0,24,183,3,9,12,5,0,2,1,1,1,1,4,1
KR_6715263464,420,5,-16,20,9,2,4,2,5,7,2,-1,6,7,1,3,2,2,3,1,0,0,-6,-6,10,4,-3,0,1,1,1,1,-1,1,1
KR_6768326694,440,2,74,16,1,-1,2,3,2,4,2,0,3,3,1,4,3,-1,0,1,0,-4,-30,-2,8,6,3,0,2,0,1,1,-1,0,1
KR_6749193672,420,2,29,12,0,-1,1,2,0,1,1,3,4,1,-4,2,6,2,2,0,0,-9,114,2,4,6,1,0,1,1,0,1,-1,3,1
KR_6759913965,440,5,22,2,5,2,2,0,1,2,1,-3,1,4,1,4,3,4,5,1,0,3,3,1,1,2,-1,0,1,-1,1,1,1,5,1
KR_6745319348,440,5,-15,4,20,3,4,1,7,7,0,0,3,3,7,9,2,3,4,1,0,21,5,6,2,8,3,0,2,1,1,1,1,4,1
KR_6750733455,420,-3,-4,-8,-6,-2,0,2,1,1,0,-1,1,2,-5,2,7,1,1,0,0,-10,-3,-2,7,5,-4,0,0,0,0,0,1,0,1
KR_6744432134,420,1,52,4,2,2,3,1,-2,5,7,1,4,3,4,6,2,-3,1,4,0,8,-1,-7,9,2,2,0,1,1,-1,1,-1,4,1
KR_6747641387,420,-1,76,-30,-2,4,5,1,-2,3,5,-4,1,5,2,4,2,-2,0,2,-2,-9,-5,-7,8,1,5,0,0,0,1,0,-1,0,1
KR_6763651428,420,2,-18,0,8,0,2,2,5,6,1,-1,1,2,3,4,1,1,1,0,0,5,-5,0,5,5,-2,0,0,1,-1,0,1,6,1
KR_6756112199,420,0,-19,3,4,4,6,2,-4,3,7,-1,1,2,4,5,1,1,2,1,0,0,2,3,4,7,-2,0,-1,1,-1,-1,1,3,1
KR_6758772635,420,4,54,14,4,1,3,2,3,5,2,0,2,2,0,2,2,0,2,2,0,7,8,-4,5,1,1,0,0,0,1,0,1,0,1
KR_6754218337,420,7,84,43,19,1,4,3,3,4,1,8,8,0,8,9,1,-1,1,2,4,24,120,7,5,12,9,0,3,1,-1,1,1,1,1
KR_6638366969,420,4,3,17,8,-1,2,3,5,9,4,5,5,0,1,4,3,-2,1,3,0,9,7,-1,2,1,-2,0,-1,1,-1,-1,-1,3,1
KR_6727550840,440,1,28,4,-10,-4,0,4,-1,2,3,-3,3,6,2,3,1,-4,0,4,0,-2,8,-1,2,1,4,0,1,1,1,1,-1,1,1
KR_6767121457,420,5,9,57,9,2,4,2,3,5,2,-1,0,1,4,4,0,1,2,1,0,7,5,2,4,6,-1,0,1,1,1,1,-1,3,1
KR_6768057433,420,3,37,40,4,5,6,1,2,4,2,-1,2,3,-1,1,2,-1,0,1,0,-3,0,0,4,4,3,0,1,1,1,1,-1,5,1
KR_6737063814,440,-1,47,8,-3,-5,0,5,8,9,1,-5,1,6,0,2,2,-1,0,1,0,-5,4,5,4,9,-2,0,0,-1,1,0,-1,2,1
KR_6729779575,420,2,19,27,5,0,3,3,-1,3,4,6,6,0,1,1,0,-1,0,1,0,3,11,5,5,10,-3,0,1,-1,1,1,1,3,1
KR_6767962442,420,2,45,-1,9,0,2,2,1,2,1,4,4,0,5,7,2,-1,0,1,-1,11,15,-3,8,5,5,0,1,1,1,1,-1,1,1
KR_6769588899,420,1,18,-8,-4,0,2,2,1,3,2,-3,0,3,0,2,2,-2,0,2,0,-6,20,-1,5,4,3,0,1,1,-1,1,-1,6,1
KR_6682901941,420,1,-4,14,7,-2,0,2,5,5,0,0,4,4,3,3,0,1,1,0,0,17,3,4,3,7,-3,0,2,1,1,1,-1,2,1
KR_6767406974,420,-1,-62,1,-5,2,2,0,-4,2,6,1,1,0,-1,2,3,-3,0,3,0,-5,114,3,3,6,-6,0,0,1,1,0,-1,4,1
KR_6765057138,420,-3,-67,-28,1,-1,0,1,1,1,0,3,6,3,-2,2,4,0,0,0,0,7,-4,1,4,5,1,0,-2,-1,-1,-1,1,6,1
KR_6768741382,440,3,41,9,6,4,6,2,-3,2,5,2,4,2,2,6,4,1,2,1,0,11,-303,0,5,5,6,0,0,-1,1,0,1,3,1
KR_6761951437,420,0,-39,-26,-3,-4,1,5,-2,3,5,-1,3,4,4,8,4,0,1,1,0,10,202,1,5,6,0,0,-1,1,-1,-1,-1,1,1
KR_6769811050,440,1,16,8,2,-4,2,6,3,4,1,-2,1,3,2,3,1,3,3,0,0,6,1,3,3,6,0,0,1,1,1,1,1,6,1
KR_6754384775,420,0,-22,-16,8,1,2,1,4,7,3,-1,0,1,-1,1,2,5,5,0,0,7,0,0,5,5,0,0,2,-1,1,1,1,3,1
KR_6708746809,420,3,44,10,5,6,6,0,-2,3,5,-1,1,2,1,3,2,1,1,0,0,3,-2,0,4,4,0,0,2,-1,1,1,1,1,1
KR_6701190789,420,0,-19,-5,-3,-3,5,8,-1,2,3,3,6,3,0,2,2,-2,2,4,1,6,-6,-2,7,5,-1,0,1,-1,-1,1,1,6,1
KR_6760214298,420,-1,2,20,2,4,4,0,4,4,0,-3,1,4,1,1,0,-4,1,5,-1,-5,-6,1,7,8,-1,0,0,-1,1,0,-1,4,1
KR_6770189157,420,1,-17,8,6,-4,0,4,2,3,1,-2,1,3,9,10,1,1,3,2,0,13,-5,0,5,5,-2,0,-1,1,1,-1,1,2,1
KR_6711208967,420,-2,-22,-26,3,2,2,0,1,5,4,3,4,1,0,4,4,-3,1,4,0,0,9,4,4,8,-5,0,1,1,1,1,1,4,1
KR_6769708664,420,2,15,15,1,1,3,2,-1,2,3,2,6,4,0,3,3,-1,0,1,0,5,-141,1,8,9,-4,0,0,1,-1,0,-1,1,1
KR_6668334240,420,3,17,26,4,6,6,0,2,3,1,3,3,0,-2,3,5,-5,0,5,-1,-2,2,0,9,9,0,0,1,1,1,1,-1,2,1
KR_6766195518,420,4,85,44,6,3,4,1,0,2,2,-1,0,1,4,7,3,0,0,0,1,9,-24,0,8,8,3,0,0,1,0,0,1,4,1
KR_6764608769,420,1,35,-19,8,3,3,0,0,1,1,-1,0,1,5,5,0,1,1,0,0,5,2,-4,5,1,2,0,2,-1,1,1,1,4,1
KR_6770116712,440,0,-16,22,-3,-2,0,2,0,2,2,-1,0,1,0,1,1,0,2,2,0,-4,-131,3,3,6,0,0,-1,1,-1,-1,-1,2,1
KR_6728868845,420,-4,-58,-8,-8,-6,0,6,0,0,0,2,5,3,-5,0,5,1,4,3,0,0,4,-3,10,7,-4,0,-1,-1,1,-1,1,6,1
KR_6768887107,420,1,39,-7,4,-1,0,1,-3,1,4,4,7,3,1,2,1,3,3,0,0,10,-1,-1,8,7,3,0,1,1,-1,1,1,5,1
KR_6746617326,420,1,10,-1,-1,-4,1,5,-1,1,2,2,3,1,2,5,3,0,1,1,0,0,-33,0,4,4,0,0,1,1,1,1,1,3,1
KR_6718656424,420,1,21,-13,4,2,3,1,3,6,3,-1,3,4,0,1,1,0,0,0,0,4,4,1,3,4,3,0,2,1,-1,1,1,4,1
KR_6768184994,440,3,58,0,8,4,6,2,-3,3,6,1,3,2,5,5,0,1,2,1,0,6,-1,0,5,5,23,0,2,1,0,1,1,2,1
KR_6764920610,420,2,58,-18,8,2,5,3,2,4,2,0,3,3,3,4,1,1,2,1,0,4,-6,-2,6,4,5,0,0,1,-1,-1,-1,4,1
KR_6768422070,420,0,-76,-10,-2,-4,1,5,0,4,4,0,1,1,0,8,8,2,3,1,-2,8,43,3,6,9,1,0,-2,-1,-1,-1,1,2,1
KR_6662134303,420,1,42,0,4,-1,2,3,-1,3,4,3,4,1,1,1,0,2,2,0,0,10,8,3,6,9,-1,0,0,1,-1,1,-1,6,1
KR_6760969857,420,2,3,-10,-1,-3,2,5,0,6,6,2,3,1,-1,2,3,1,1,0,0,-4,-55,6,2,8,0,0,0,1,-1,1,-1,6,1
KR_6769899160,420,1,4,-13,0,-3,2,5,-2,1,3,4,5,1,0,2,2,1,4,3,0,1,0,-2,5,3,0,0,-1,-1,1,1,-1,5,1
KR_6756922178,420,3,58,9,3,1,3,2,1,4,3,2,6,4,-1,0,1,0,0,0,0,2,44,-2,6,4,-2,0,1,1,1,1,1,3,1
KR_6755602338,420,7,105,-3,20,7,9,2,7,7,0,3,7,4,1,3,2,2,2,0,0,7,7,-3,6,3,3,0,0,1,-1,0,1,5,1
KR_6767687622,420,4,53,23,10,-1,3,4,2,3,1,9,9,0,1,3,2,-1,1,2,1,10,-6,1,5,6,2,0,2,1,1,1,1,5,1
KR_6695385198,420,4,63,30,10,1,3,2,4,4,0,2,2,0,4,5,1,-1,0,1,1,14,-2,5,2,7,-1,0,2,1,1,1,1,4,1
KR_6765326922,420,1,21,-10,4,0,1,1,-1,1,2,2,3,1,3,6,3,0,3,3,0,6,-22,-2,5,3,4,0,1,1,1,1,-1,1,1
KR_6743381585,420,7,49,43,10,-6,1,7,5,5,0,6,7,1,4,5,1,1,2,1,1,13,10,2,7,9,1,0,2,1,1,1,1,2,1
KR_6759975554,420,5,76,-3,15,5,6,1,3,4,1,0,2,2,4,6,2,3,3,0,0,19,-39,5,3,8,5,0,1,1,1,1,1,3,1
KR_6758335366,420,-3,-26,3,-4,-3,2,5,-2,1,3,0,1,1,1,2,1,0,1,1,1,-3,-1,-1,7,6,0,0,-1,1,-1,-1,1,6,1
KR_6769402152,420,-1,-4,-1,4,-1,0,1,3,4,1,-2,2,4,0,1,1,4,4,0,0,12,3,-1,4,3,-3,0,-1,1,-1,-1,1,2,1
KR_6760017651,420,4,65,26,8,1,2,1,5,7,2,-1,1,2,6,7,1,-3,0,3,0,4,5,7,4,11,-1,0,2,1,1,1,1,6,1
KR_6766077754,420,5,59,55,2,2,3,1,-6,1,7,-4,2,6,13,13,0,-3,1,4,0,-7,2,-2,8,6,0,0,2,1,1,1,-1,3,1
KR_6769941090,420,5,-32,19,6,3,3,0,2,3,1,-1,3,4,0,3,3,2,2,0,0,6,4,4,1,5,-2,0,0,1,-1,0,1,2,1
KR_6767998380,440,-3,-53,-32,-9,-3,4,7,1,3,2,-5,0,5,-3,0,3,1,3,2,0,-6,1,-1,1,0,0,0,0,-1,-1,-1,1,6,1
KR_6770228763,420,3,91,23,16,4,5,1,1,2,1,10,10,0,-2,3,5,3,4,1,0,7,10,2,3,5,-1,0,0,1,-1,1,1,2,1
KR_6667603137,420,3,30,8,9,2,4,2,3,3,0,3,4,1,4,4,0,-3,0,3,0,10,-6,2,3,5,2,0,0,-1,1,1,1,6,1
KR_6749518055,420,0,-21,31,6,2,2,0,4,8,4,1,5,4,-1,2,3,0,1,1,0,4,-6,0,6,6,5,0,0,1,1,1,1,3,1
KR_6766966565,420,2,-35,24,1,-1,0,1,-1,1,2,2,2,0,0,2,2,1,2,1,1,0,-3,-1,6,5,1,0,0,1,-1,0,1,3,1
KR_6685615322,420,1,-2,9,2,-2,1,3,4,6,2,2,2,0,2,3,1,-4,0,4,-3,-13,2,1,4,5,0,0,1,-1,1,1,-1,4,1
KR_6764264985,420,4,35,-1,9,1,2,1,-3,3,6,3,3,0,3,7,4,5,7,2,0,4,4,-1,3,2,2,0,0,1,1,1,1,5,1
KR_6657771699,420,-2,-38,11,-2,4,5,1,-2,3,5,0,3,3,-4,0,4,0,1,1,0,3,-4,1,5,6,3,0,0,-1,-1,0,1,5,1
KR_6693311682,420,2,47,-23,1,1,2,1,0,2,2,1,1,0,-1,1,2,0,0,0,0,-2,20,-1,4,3,3,0,0,0,-1,-1,-1,0,1
KR_6737870265,420,2,34,30,10,2,3,1,6,7,1,-2,2,4,2,3,1,2,2,0,0,8,18,0,4,4,3,0,2,1,1,1,1,1,1
KR_6759430603,420,4,46,36,9,1,2,1,4,5,1,3,3,0,2,2,0,-1,0,1,1,12,11,0,7,7,3,0,0,-1,1,0,1,6,1
KR_6766041432,420,-3,1,-25,-7,3,4,1,-5,3,8,-7,0,7,2,3,1,0,0,0,0,-13,2,-3,8,5,-3,0,-1,-1,1,-1,-1,4,1
KR_6722333585,420,-1,13,-15,-3,-3,1,4,-1,5,6,0,3,3,4,6,2,-3,0,3,-4,-17,-12,-6,11,5,7,0,0,1,-1,0,-1,3,1
KR_6767450497,420,-1,-10,-16,0,0,0,0,-1,4,5,0,1,1,-1,2,3,2,3,1,1,2,-14,-4,11,7,4,0,0,-1,1,0,1,3,1
KR_6767725932,420,2,-10,20,4,2,2,0,1,5,4,2,5,3,-1,2,3,0,0,0,0,-3,48,1,6,7,-3,0,-1,1,1,-1,-1,4,1
KR_6768739323,420,4,4,31,6,0,2,2,2,5,3,0,3,3,2,4,2,2,3,1,0,1,5,1,5,6,0,0,0,1,-1,0,1,3,1
KR_6652593799,420,2,56,-4,11,-2,4,6,5,6,1,2,3,1,5,6,1,1,2,1,0,17,-1,4,4,8,2,0,0,1,1,1,1,5,1
KR_6766067447,440,3,-7,0,4,0,3,3,3,3,0,-2,2,4,2,2,0,1,1,0,1,7,-43,-6,10,4,7,0,-1,-1,-1,-1,1,6,1
KR_6770221292,440,3,18,-9,9,3,3,0,2,2,0,0,1,1,1,3,2,3,3,0,0,11,12,2,6,8,-6,0,1,1,1,1,1,6,1
KR_6765853613,420,2,21,-18,-1,0,2,2,-1,2,3,-1,4,5,1,3,2,0,3,3,-1,8,-2,2,4,6,5,0,1,-1,1,1,-1,6,1
KR_6765258729,420,1,29,-1,2,1,1,0,-4,0,4,0,2,2,5,6,1,0,1,1,0,8,40,0,5,5,-22,0,0,-1,-1,0,-1,6,1
KR_6768353618,440,1,-6,7,3,0,1,1,6,6,0,2,5,3,1,4,3,-6,0,6,-1,5,-10,-2,2,0,2,0,-1,1,-1,-1,-1,5,1
KR_6769458745,420,-2,-2,-20,5,4,7,3,-1,1,2,1,2,1,1,4,3,0,1,1,0,7,-70,2,4,6,2,0,0,-1,1,0,1,3,1
KR_6752590146,440,0,38,27,3,3,3,0,2,3,1,0,2,2,-2,4,6,0,1,1,0,8,44,2,2,4,-17,0,1,-1,-1,1,1,1,1
KR_6757796758,420,4,27,-25,12,10,10,0,5,7,2,1,2,1,-4,2,6,0,2,2,2,32,2,-2,5,3,3,0,1,0,1,-1,1,0,1
KR_6716357508,440,2,19,25,4,0,3,3,-2,1,3,4,5,1,1,3,2,1,1,0,0,-3,4,-3,3,0,-1,0,0,1,0,1,1,6,1
KR_6728564301,420,-2,-64,3,-4,3,4,1,2,8,6,4,4,0,-10,1,11,-3,0,3,0,-6,-22,-3,7,4,2,0,0,-1,1,-1,1,1,1
KR_6766903263,440,1,18,2,-6,-2,1,3,1,3,2,1,2,1,-3,2,5,-3,1,4,-1,-10,-6,-12,13,1,4,0,0,-1,-1,-1,-1,4,1
KR_6763791432,420,0,19,-8,5,-2,2,4,-1,3,4,4,4,0,3,4,1,1,1,0,0,1,9,-3,7,4,2,0,1,-1,-1,1,1,1,1
KR_6698100518,420,2,37,-8,3,2,3,1,1,2,1,-2,2,4,2,2,0,0,2,2,0,3,1,3,3,6,-4,0,0,1,-1,0,-1,5,1
KR_6766870942,420,0,5,-7,-3,-1,1,2,0,2,2,-5,0,5,2,2,0,1,3,2,0,-7,-2,-3,8,5,-4,0,0,1,1,0,1,2,1
KR_6737764864,420,5,64,18,5,2,3,1,4,7,3,2,3,1,0,1,1,-3,0,3,0,7,-9,-2,5,3,3,0,1,1,-1,1,-1,6,1
KR_6764258893,420,1,-28,-8,-4,-5,0,5,8,9,1,-3,1,4,-5,1,6,1,2,1,0,-9,-13,6,3,9,-8,0,-1,-1,-1,-1,-1,3,1
KR_6769337991,420,4,24,26,6,-1,1,2,2,6,4,3,3,0,-1,1,2,3,3,0,0,-2,-38,-6,10,4,6,0,3,1,1,1,-1,1,1
KR_6652850339,420,4,27,-13,12,3,4,1,3,4,1,-4,3,7,6,7,1,4,5,1,0,16,121,-3,9,6,7,0,3,-1,1,1,1,3,1
KR_6757600447,420,0,38,-3,0,-2,0,2,2,6,4,2,3,1,-1,0,1,-1,0,1,0,1,17,5,1,6,-3,0,0,-1,1,0,1,6,1
KR_6742197287,420,3,-37,36,8,-2,1,3,7,7,0,1,4,3,2,3,1,0,2,2,0,10,466,0,6,6,-1,0,0,1,-1,-1,1,2,1
KR_6750998130,420,2,31,-1,3,2,3,1,2,4,2,-1,0,1,-1,1,2,1,1,0,0,12,-2,-1,6,5,2,0,1,-1,1,1,1,2,1
KR_6706818026,420,-1,12,60,-2,-7,1,8,-2,1,3,5,6,1,0,2,2,2,2,0,0,-7,-9,-1,6,5,-1,0,1,1,1,1,-1,5,1
KR_6769962238,420,-1,-20,2,-3,-1,2,3,1,5,4,-5,0,5,2,6,4,0,4,4,0,-10,-10,-6,8,2,4,0,-1,-1,-1,-1,1,1,1
KR_6768232355,420,2,5,16,3,1,3,2,1,7,6,-2,0,2,2,8,6,1,1,0,1,8,5,8,2,10,-1,0,0,-1,1,1,-1,2,1
KR_6766246448,420,0,52,-27,6,-4,0,4,4,5,1,1,1,0,7,7,0,-2,2,4,0,8,8,3,4,7,1,0,2,-1,1,1,1,1,1
KR_6656067589,420,0,4,12,1,-2,0,2,4,5,1,5,6,1,-5,1,6,-1,0,1,0,3,12,3,2,5,-3,0,0,-1,1,0,1,3,1
KR_6752437158,420,2,30,-12,8,0,1,1,1,2,1,7,7,0,1,4,3,-1,1,2,0,3,148,-2,6,4,3,0,2,1,1,1,1,6,1
KR_6763155735,440,4,31,17,5,3,4,1,2,6,4,-3,2,5,1,2,1,2,3,1,1,7,147,-1,2,1,2,0,1,1,1,1,1,2,1
KR_6759623682,420,5,16,20,10,0,2,2,6,9,3,2,2,0,0,5,5,2,3,1,1,11,-10,-4,8,4,1,0,1,1,1,1,1,5,1
KR_6739761361,420,-1,-43,16,-6,-1,1,2,-1,4,5,-4,2,6,1,5,4,-1,0,1,0,-7,-44,-2,7,5,13,0,0,-1,0,-1,1,2,1
KR_6762123585,420,0,2,-12,12,-1,4,5,4,6,2,2,5,3,4,5,1,3,3,0,3,26,-2,-4,6,2,2,0,1,0,0,1,1,0,1
KR_6765624102,420,0,30,-12,-1,2,3,1,5,5,0,-1,2,3,-4,5,9,-3,0,3,0,-8,-3,1,5,6,3,0,0,-1,1,0,-1,3,1
KR_6656228578,420,0,-23,-19,5,1,2,1,4,4,0,-1,0,1,0,1,1,1,2,1,0,6,-115,1,4,5,2,0,-1,1,1,-1,-1,5,1
KR_6740420962,420,4,72,33,9,3,4,1,2,5,3,3,3,0,1,5,4,0,0,0,0,8,5,-2,5,3,-1,0,2,1,1,1,1,5,1
KR_6765694089,420,0,-49,-45,0,-3,0,3,-4,0,4,1,5,4,5,7,2,1,2,1,0,6,-32,-2,5,3,0,0,0,-1,1,1,-1,2,1
KR_6746180434,420,4,56,4,10,1,1,0,0,2,2,-1,1,2,10,11,1,0,1,1,1,19,-10,2,1,3,-3,0,2,1,1,1,1,5,1
KR_6765552373,440,3,-41,15,5,-2,1,3,-1,2,3,5,7,2,-2,1,3,5,5,0,0,13,11,-1,9,8,2,0,-1,-1,-1,-1,-1,3,1
KR_6738793897,420,3,-23,19,9,1,2,1,1,3,2,3,6,3,4,6,2,0,1,1,-1,9,-3,0,7,7,3,0,1,1,1,1,-1,1,1
KR_6765463126,440,0,52,-8,3,2,3,1,2,3,1,2,2,0,-2,1,3,-1,0,1,0,3,-41,1,2,3,23,0,0,-1,1,-1,1,4,1
KR_6693698070,420,-4,-11,-50,-2,3,5,2,-6,1,7,-1,2,3,2,3,1,0,1,1,0,-1,-2,-3,7,4,-1,0,-1,-1,-1,-1,1,5,1
KR_6766956140,420,5,26,12,6,-1,1,2,-1,1,2,3,3,0,3,6,3,2,2,0,0,8,4,2,4,6,1,0,0,1,1,0,-1,2,1
KR_6763282111,420,-2,-62,-11,-6,-1,0,1,-2,2,4,-1,0,1,-4,2,6,2,2,0,0,-8,-5,-2,8,6,7,0,0,1,-1,0,-1,5,1
KR_6694736123,420,-2,-11,-5,-3,-1,0,1,-2,6,8,-2,1,3,3,5,2,-1,1,2,0,-3,6,-5,9,4,1,0,0,-1,-1,0,1,3,1
KR_6586917965,420,1,31,-15,4,-4,0,4,6,6,0,-1,1,2,2,2,0,1,1,0,0,10,-11,4,4,8,-5,0,0,1,-1,-1,1,6,1
KR_6761762589,420,1,49,12,7,3,3,0,1,2,1,0,3,3,3,3,0,0,0,0,0,4,-3,-2,6,4,10,0,0,1,1,0,-1,3,1
KR_6728707595,420,-2,-67,16,-14,-5,0,5,-6,3,9,2,3,1,-3,0,3,-2,3,5,0,-3,0,2,6,8,4,0,-1,1,0,-1,-1,2,1
KR_6747641732,440,2,123,0,10,1,3,2,2,3,1,6,8,2,0,0,0,1,1,0,0,13,6,1,7,8,4,0,0,1,1,1,1,5,1
KR_6764909715,420,2,23,0,3,-2,2,4,0,3,3,0,3,3,3,3,0,2,4,2,0,0,82,-4,7,3,0,0,0,1,-1,-1,1,4,1
KR_6752320644,420,0,-1,1,0,-1,1,2,-3,2,5,1,5,4,3,4,1,0,1,1,0,7,2,2,5,7,0,0,1,1,1,1,-1,4,1
KR_6767964154,420,4,-19,-2,7,4,5,1,0,2,2,3,3,0,1,4,3,-1,0,1,0,12,42,3,4,7,-6,0,-1,-1,-1,-1,1,3,1
KR_6769140939,420,-3,-30,-12,-6,0,1,1,-1,0,1,-4,0,4,-1,6,7,0,3,3,0,-3,-1,-1,8,7,-4,0,-2,-1,1,-1,-1,5,1
KR_6709842824,420,5,65,-2,10,2,3,1,-1,1,2,5,7,2,4,6,2,0,1,1,0,5,1,4,6,10,4,0,2,1,1,1,-1,6,1
KR_6750872770,440,-4,-89,-12,-5,-3,0,3,0,2,2,0,7,7,-2,3,5,0,1,1,-1,-1,3,5,4,9,1,0,-2,-1,1,-1,-1,5,1
KR_6584536232,440,3,25,-8,3,4,5,1,-3,2,5,2,3,1,-1,3,4,1,3,2,0,4,-17,1,6,7,-3,0,1,1,0,1,1,5,1
KR_6761854230,420,-4,-76,-3,-6,-6,0,6,1,1,0,-1,7,8,0,2,2,0,2,2,0,-2,-36,-2,6,4,0,0,0,-1,1,-1,-1,3,1
KR_6768829664,440,3,6,5,0,2,3,1,-3,4,7,1,4,3,-7,1,8,7,9,2,3,9,-2,3,3,6,5,0,0,-1,-1,-1,1,4,1
KR_6769595477,420,3,52,-16,12,8,8,0,-2,0,2,0,2,2,6,6,0,0,0,0,0,13,13,7,4,11,-2,0,2,-1,1,1,1,1,1
KR_6537000234,420,3,44,-15,12,1,2,1,0,3,3,12,12,0,-2,4,6,1,1,0,0,1,-7,1,6,7,8,0,3,0,1,1,1,0,1
KR_6737266037,440,5,54,20,9,1,3,2,0,4,4,-1,2,3,6,7,1,3,6,3,0,10,6,-5,8,3,1,0,1,1,1,-1,1,5,1
KR_6764231602,420,-1,44,0,-3,2,5,3,-3,5,8,0,1,1,-2,2,4,0,0,0,0,-6,353,1,6,7,-5,0,1,-1,1,1,-1,5,1
KR_6751981198,420,2,12,-4,12,-4,2,6,1,2,1,10,11,1,3,4,1,2,2,0,1,16,12,5,2,7,1,0,1,-1,-1,1,1,2,1
KR_6769767527,420,-1,-1,2,-2,1,3,2,-3,1,4,0,2,2,-1,3,4,1,1,0,0,-1,-9,-3,6,3,2,0,0,-1,0,0,-1,6,1
KR_6742977251,420,1,50,-8,6,-1,1,2,4,6,2,0,1,1,4,8,4,-1,0,1,0,7,26,2,7,9,1,0,-1,-1,-1,-1,1,6,1
KR_6755335727,420,2,-11,13,10,7,7,0,1,4,3,-2,5,7,3,4,1,1,1,0,1,9,7,4,1,5,-3,0,1,1,1,1,1,4,1
KR_6715937386,420,2,-26,-11,2,4,4,0,2,3,1,-3,1,4,1,3,2,-2,0,2,0,3,0,1,2,3,0,0,1,-1,0,1,1,3,1
KR_6710522530,420,6,108,28,15,5,5,0,3,4,1,5,5,0,0,3,3,2,2,0,1,16,-7,-1,7,6,3,0,4,1,1,1,1,6,1
KR_6769299781,420,6,68,33,9,3,3,0,2,3,1,-1,1,2,4,7,3,1,3,2,-1,6,16,2,6,8,-3,0,0,1,1,1,-1,6,1
KR_6729807046,420,7,38,14,23,3,4,1,4,6,2,9,10,1,3,3,0,4,5,1,0,21,-37,4,3,7,2,0,0,1,-1,1,1,1,1
KR_6716827874,420,7,67,2,14,-1,0,1,2,4,2,1,3,2,10,11,1,2,2,0,-1,10,53,2,4,6,3,0,0,1,-1,1,-1,1,1
KR_6760906454,440,3,12,22,7,3,3,0,3,3,0,-2,2,4,4,5,1,-1,2,3,0,1,-5,2,4,6,-2,0,1,1,1,1,1,1,1
KR_6768594504,440,0,-98,-10,8,2,2,0,7,7,0,3,3,0,-2,3,5,-2,3,5,0,12,74,3,2,5,2,0,-1,0,1,-1,1,0,1
KR_6757718967,420,4,109,16,7,6,6,0,-1,4,5,0,1,1,2,7,5,0,1,1,0,7,-3,1,5,6,1,0,1,-1,-1,1,-1,3,1
KR_6757740569,420,2,17,-20,5,5,5,0,0,1,1,2,4,2,-1,2,3,-1,0,1,1,0,-11,0,6,6,1,0,1,-1,1,1,1,5,1
KR_6741570792,440,2,-30,-8,6,4,5,1,1,2,1,1,4,3,0,4,4,0,0,0,0,9,-3,-2,3,1,-3,0,1,-1,1,1,1,1,1
KR_6763107089,420,1,-19,-16,3,3,3,0,-3,2,5,2,2,0,0,2,2,1,2,1,0,1,4,1,7,8,-6,0,0,1,-1,0,-1,2,1
KR_6756176314,440,5,65,24,22,9,13,4,5,6,1,3,3,0,1,4,3,4,5,1,0,14,7,0,2,2,3,0,3,1,1,1,1,5,1
KR_6656848803,420,5,61,16,18,3,3,0,7,8,1,5,5,0,2,4,2,1,2,1,0,19,-3,1,4,5,10,0,1,1,1,1,1,1,1
KR_6736249220,420,5,58,9,8,-2,3,5,2,4,2,0,2,2,10,11,1,-2,1,3,1,15,51,7,4,11,-11,0,2,1,-1,1,1,5,1
KR_6762480453,420,0,-14,16,-1,-1,1,2,1,2,1,3,4,1,-4,3,7,0,3,3,0,-5,-124,-7,10,3,2,0,0,-1,-1,0,-1,3,1
KR_6696360518,420,11,145,36,20,3,3,0,1,4,3,9,9,0,8,8,0,-1,0,1,1,20,114,2,2,4,1,0,1,1,1,1,1,1,1
KR_6761396768,420,-2,2,5,-2,-2,2,4,1,2,1,2,3,1,-3,1,4,0,2,2,0,0,9,-1,8,7,-3,0,0,0,-1,0,1,0,1
KR_6687057007,420,4,55,20,2,1,2,1,1,3,2,2,2,0,-2,0,2,0,1,1,0,-1,5,1,3,4,-2,0,0,1,-1,0,1,4,1
KR_6755839750,420,5,36,28,5,-1,1,2,0,2,2,1,2,1,6,7,1,-1,0,1,0,10,34,-1,6,5,-26,0,0,1,-1,0,-1,2,1
KR_6759374613,420,-3,-24,11,-7,1,3,2,-5,0,5,-3,0,3,1,4,3,-1,0,1,0,-16,-246,1,4,5,-1,0,0,-1,-1,-1,-1,4,1
KR_6736806840,440,-1,12,20,-6,-1,0,1,3,7,4,-1,0,1,-7,0,7,0,1,1,0,-14,-21,-2,8,6,2,0,-1,0,1,-1,-1,0,1
KR_6624080710,420,5,44,-8,8,2,4,2,5,6,1,1,2,1,2,4,2,-2,0,2,0,6,-8,-3,8,5,1,0,3,-1,1,1,-1,6,1
KR_6770264522,440,-2,5,-12,-4,5,5,0,0,2,2,3,5,2,-9,2,11,-3,0,3,-1,-3,-10,-1,5,4,0,0,0,-1,1,-1,-1,6,1
KR_6764480379,420,-2,-6,39,-11,0,1,1,-1,2,3,-3,1,4,-3,2,5,-4,3,7,0,-6,-3,0,7,7,-1,0,-1,1,-1,-1,-1,6,1
KR_6726952879,420,1,-29,3,-4,4,5,1,-4,4,8,0,0,0,-4,0,4,0,1,1,0,-8,-37,-2,11,9,16,0,0,1,-1,0,-1,5,1
KR_6704511749,420,3,-16,26,7,-1,1,2,-6,0,6,7,8,1,5,7,2,2,3,1,0,6,0,-3,8,5,1,0,2,1,-1,1,-1,2,1
KR_6764568250,420,0,-5,-1,3,1,3,2,1,3,2,-2,3,5,3,4,1,0,1,1,0,10,-200,1,8,9,5,0,1,-1,1,1,-1,4,1
KR_6652379979,420,3,-64,-6,7,-1,1,2,5,5,0,4,6,2,-3,0,3,2,2,0,0,12,3,-3,9,6,-1,0,-1,-1,-1,-1,-1,4,1
KR_6768425099,420,0,-27,7,-6,-1,1,2,-3,0,3,-3,0,3,2,5,3,-1,1,2,0,-10,90,4,5,9,-1,0,-1,-1,1,-1,1,1,1
KR_6761424004,420,3,7,14,2,3,4,1,-1,2,3,2,3,1,0,3,3,-2,0,2,0,-3,28,7,4,11,1,0,1,1,1,1,-1,3,1
KR_6668551560,420,1,7,5,2,-1,1,2,1,4,3,0,4,4,2,3,1,0,0,0,0,-4,-27,2,6,8,3,0,1,-1,1,1,-1,3,1
KR_6766503250,420,4,65,-4,22,2,3,1,3,4,1,10,10,0,6,10,4,1,2,1,0,18,13,5,1,6,0,0,1,1,1,1,1,5,1
KR_6685691683,420,4,27,16,4,5,5,0,5,8,3,-2,0,2,-1,3,4,-3,0,3,0,-6,1,-3,8,5,-4,0,1,1,1,1,1,2,1
KR_6762570883,440,0,13,3,4,-2,1,3,3,7,4,3,4,1,0,6,6,0,1,1,2,-2,9,5,2,7,-3,0,0,-1,1,1,-1,3,1
KR_6761815592,420,2,52,-7,3,2,2,0,0,1,1,0,4,4,1,2,1,0,2,2,0,-5,8,1,5,6,-3,0,1,1,-1,1,-1,1,1
KR_6769241697,420,2,25,16,4,0,0,0,3,4,1,-2,0,2,3,3,0,0,0,0,0,2,2,-3,7,4,-3,0,-1,-1,-1,-1,1,5,1
KR_6691846160,420,-3,46,-16,-8,3,4,1,-6,1,7,-2,1,3,-1,2,3,-2,0,2,0,-12,8,-3,8,5,-5,0,0,1,1,0,1,2,1
KR_6712284608,420,4,18,30,1,4,6,2,-1,3,4,-1,2,3,-2,0,2,1,1,0,0,-2,-1,-4,7,3,3,0,2,-1,1,1,-1,2,1
KR_6752357423,420,0,26,-23,4,6,6,0,-3,5,8,-2,1,3,5,6,1,-2,0,2,0,9,35,4,3,7,0,0,0,1,-1,1,1,2,1
KR_6764256313,440,3,29,2,11,11,11,0,0,1,1,3,4,1,-4,2,6,1,3,2,0,4,-7,-1,5,4,5,0,2,-1,0,1,1,1,1
KR_6751136250,420,2,-15,-16,0,2,5,3,-4,2,6,0,2,2,2,5,3,0,2,2,-1,-2,2,-2,6,4,-1,0,-1,-1,-1,1,-1,2,1
KR_6763035148,440,0,11,28,2,-1,1,2,1,1,0,2,3,1,0,0,0,0,1,1,0,2,-2,-1,7,6,-4,0,-1,-1,-1,-1,1,5,1
KR_6762903117,420,1,-30,1,1,-3,2,5,7,10,3,-1,2,3,-2,4,6,0,1,1,0,4,-2,2,3,5,5,0,1,1,1,1,-1,1,1
KR_6764925441,420,4,34,24,2,2,6,4,-1,2,3,-2,1,3,3,3,0,0,0,0,0,11,6,0,7,7,6,0,0,1,-1,0,-1,1,1
KR_6717551141,420,3,73,2,11,5,7,2,4,5,1,-1,1,2,1,4,3,2,2,0,0,16,-334,-1,5,4,6,0,2,1,1,1,1,6,1
KR_6724952086,420,2,19,25,6,-2,0,2,0,4,4,2,2,0,4,5,1,2,2,0,-1,5,-98,3,1,4,-2,0,1,1,1,1,1,4,1
KR_6768284587,420,2,5,0,6,4,4,0,0,2,2,0,1,1,2,6,4,0,1,1,0,8,222,0,8,8,2,0,1,1,1,1,1,1,1
KR_6766791193,420,4,20,8,13,3,4,1,-1,4,5,10,10,0,0,4,4,1,1,0,0,10,5,5,2,7,1,0,2,1,1,1,1,2,1
KR_6753353753,420,4,77,8,17,3,4,1,2,7,5,8,9,1,5,6,1,-1,1,2,0,13,-51,1,7,8,5,0,1,1,1,1,1,4,1
KR_6769329271,420,2,-15,-20,5,0,2,2,0,1,1,-2,2,4,7,8,1,0,4,4,2,13,-3,-4,7,3,5,0,0,-1,-1,1,1,2,1
KR_6766711412,420,0,22,-13,5,-2,3,5,-3,1,4,4,5,1,4,5,1,2,2,0,0,3,3,5,6,11,-9,0,1,1,1,1,1,1,1
KR_6765886479,440,-1,64,-2,-5,-1,2,3,0,2,2,-1,1,2,0,3,3,-3,0,3,0,-3,13,-1,8,7,-5,0,0,-1,1,0,-1,5,1
KR_6620656639,420,1,52,-7,5,-4,1,5,-1,2,3,1,3,2,8,8,0,1,1,0,0,17,4,3,3,6,1,0,1,1,0,1,-1,5,1
KR_6765655492,420,-1,-77,-8,4,0,3,3,1,3,2,5,6,1,-5,3,8,3,4,1,0,3,-2,2,5,7,-4,0,-1,1,1,-1,-1,5,1
KR_6631301349,420,-1,-70,-20,0,-4,1,5,3,6,3,1,2,1,-2,4,6,2,5,3,-1,-4,-1,2,5,7,-9,0,0,-1,-1,-1,-1,1,1
KR_6753568528,420,2,51,-15,12,1,4,3,0,1,1,6,8,2,2,3,1,3,3,0,-1,9,3,0,4,4,4,0,1,1,1,1,-1,1,1
KR_6760359763,420,2,104,49,6,3,4,1,3,5,2,-1,0,1,1,2,1,0,2,2,0,-1,6,3,4,7,5,0,3,1,1,1,-1,5,1
KR_6738217747,420,3,84,-9,10,0,3,3,3,6,3,1,1,0,6,7,1,0,0,0,0,6,8,0,6,6,5,0,2,1,-1,1,1,1,1
KR_6770433558,420,0,-34,-1,5,0,1,1,3,3,0,-1,3,4,2,5,3,1,2,1,0,12,-28,-1,5,4,3,0,0,1,1,1,-1,1,1
KR_6767847489,420,4,-2,6,13,-1,1,2,2,5,3,6,10,4,7,9,2,-1,1,2,0,3,-7,-3,6,3,0,0,0,-1,1,1,-1,3,1
KR_6770317503,420,-1,9,14,-1,2,3,1,-1,4,5,0,0,0,-1,0,1,-1,3,4,0,-6,11,0,6,6,0,0,1,1,1,1,-1,2,1
KR_6764525653,440,0,18,16,-3,-2,1,3,0,2,2,-1,1,2,-2,1,3,2,2,0,0,0,-3,0,6,6,0,0,1,-1,1,1,1,4,1
KR_6743469947,420,1,52,44,11,6,7,1,6,9,3,-1,0,1,0,2,2,0,1,1,2,13,7,3,5,8,-3,0,1,-1,1,1,1,1,1
KR_6751641763,420,3,33,4,7,4,4,0,-1,1,2,1,2,1,5,9,4,-2,1,3,0,4,8,1,8,9,6,0,0,1,-1,0,-1,2,1
KR_6639046813,420,0,20,-4,-2,0,1,1,0,6,6,3,5,2,-4,2,6,-1,1,2,-2,-11,1,-3,8,5,4,0,2,-1,1,1,-1,1,1
KR_6711922790,420,0,-28,-24,2,-2,1,3,5,7,2,-1,1,2,4,4,0,-4,0,4,2,11,-3,2,2,4,8,0,0,-1,1,1,1,5,1
KR_6759128151,420,-1,46,2,-4,-5,0,5,1,1,0,-5,1,6,1,5,4,4,4,0,1,-4,29,-1,6,5,0,0,1,1,-1,1,1,5,1
KR_6763375846,420,1,9,16,4,-2,4,6,6,8,2,0,1,1,-2,2,4,2,3,1,1,7,194,1,4,5,-7,0,0,-1,1,1,1,1,1
KR_6763842586,420,2,38,15,5,1,4,3,1,5,4,-3,1,4,6,6,0,0,1,1,0,9,305,-3,7,4,1,0,3,1,1,1,1,3,1
KR_6768105711,420,2,20,15,9,-3,1,4,1,2,1,1,2,1,4,4,0,6,6,0,1,4,6,-2,6,4,-4,0,0,1,1,1,1,4,1
KR_6732146848,420,5,67,40,10,-5,0,5,9,9,0,3,5,2,3,7,4,0,3,3,2,20,-5,-4,8,4,1,0,2,1,1,1,-1,6,1
KR_6767962642,420,4,69,26,4,7,7,0,-4,2,6,2,3,1,-3,1,4,2,2,0,0,-1,7,-2,7,5,1,0,1,-1,1,1,1,5,1
KR_6741653865,420,1,-19,-16,4,0,0,0,0,0,0,3,7,4,-1,1,2,2,2,0,0,5,-1,2,7,9,-2,0,0,0,-1,-1,1,0,1
KR_6747059228,420,1,-34,0,2,2,2,0,1,1,0,2,6,4,-3,2,5,0,0,0,0,-1,1,-2,7,5,-1,0,0,-1,1,1,-1,2,1
KR_6629141030,420,9,77,23,20,6,7,1,2,2,0,6,7,1,6,7,1,0,1,1,0,17,5,2,0,2,-1,0,4,1,1,1,1,3,1
KR_6758077486,420,5,22,32,13,-2,1,3,7,9,2,5,5,0,1,3,2,2,2,0,0,10,1,3,3,6,-1,0,2,-1,1,1,1,6,1
KR_6750617838,420,0,-50,8,2,-5,1,6,6,8,2,3,3,0,0,1,1,-2,0,2,0,7,-2,2,4,6,5,0,-1,-1,1,-1,-1,2,1
KR_6664510411,420,1,11,19,5,-1,0,1,2,3,1,-1,1,2,-1,0,1,6,6,0,1,10,-20,-6,9,3,4,0,0,1,-1,-1,1,3,1
KR_6768853842,420,7,120,-13,20,8,8,0,0,2,2,4,4,0,4,5,1,4,4,0,0,28,13,2,5,7,4,2,8,1,1,1,1,6,1
KR_6581845880,420,2,18,0,3,-3,0,3,-2,6,8,1,6,5,3,6,3,4,5,1,0,11,0,4,5,9,-3,0,1,1,1,1,-1,3,1
KR_6699783017,420,1,37,12,2,2,3,1,-1,2,3,0,2,2,0,2,2,1,2,1,0,4,5,3,4,7,-1,0,1,1,1,1,-1,5,1
KR_6754125413,420,4,45,15,3,-1,1,2,-5,1,6,3,3,0,3,3,0,3,3,0,0,5,7,1,3,4,-3,0,0,-1,-1,0,1,1,1
KR_6746119539,420,-3,-65,-4,-1,-2,0,2,0,3,3,-2,4,6,4,4,0,-1,0,1,0,3,-29,-3,8,5,9,0,-1,1,-1,-1,-1,5,1
KR_6765806628,420,4,33,48,8,8,10,2,-1,2,3,-1,0,1,-1,6,7,3,3,0,1,-3,-9,2,3,5,0,0,2,1,1,1,1,5,1
KR_6767465399,420,3,85,-7,12,-1,2,3,10,10,0,-1,0,1,3,3,0,1,1,0,0,11,37,1,8,9,3,0,2,1,1,1,1,6,1
KR_6753744452,420,1,-27,24,0,-2,2,4,4,4,0,-2,1,3,1,2,1,-1,1,2,-1,6,-1,-3,8,5,0,0,-1,1,1,1,-1,3,1
KR_6757346604,420,1,49,-13,-1,7,8,1,-5,0,5,-2,1,3,1,1,0,-2,0,2,0,-11,-1,-3,5,2,-2,0,0,-1,1,1,1,2,1
KR_6765982758,420,1,51,4,2,0,3,3,4,6,2,1,3,2,-3,2,5,0,0,0,0,-1,-12,-1,6,5,7,0,1,1,1,1,1,5,1
KR_6727413890,420,3,83,12,4,2,2,0,1,2,1,3,3,0,-1,2,3,-1,0,1,0,3,2,3,3,6,-1,0,0,-1,1,0,1,4,1
KR_6726935782,420,2,-2,13,-4,1,1,0,3,4,1,0,2,2,-7,2,9,-1,1,2,0,-2,106,-7,8,1,-1,0,0,-1,-1,0,-1,1,1
KR_6766781135,420,-1,15,31,0,5,6,1,2,5,3,-1,0,1,-3,2,5,-3,0,3,0,-4,1,4,1,5,1,0,2,1,-1,1,1,6,1
KR_6770262148,440,3,96,8,13,3,5,2,7,8,1,5,5,0,-3,0,3,1,1,0,1,17,8,3,0,3,-1,0,3,1,1,1,1,1,1
KR_6742152134,420,3,9,35,4,4,4,0,3,5,2,-2,2,4,0,3,3,-1,1,2,1,-4,44,1,5,6,-20,0,3,1,1,1,1,1,1
KR_6769586829,420,0,60,-41,5,-2,1,3,6,9,3,0,1,1,3,3,0,-2,0,2,0,2,-2,5,3,8,6,0,-1,1,-1,1,1,3,1
KR_6755285055,420,4,64,-4,5,2,3,1,0,3,3,2,2,0,0,2,2,1,2,1,0,4,8,3,3,6,-1,0,3,-1,-1,1,1,5,1
KR_6766999858,420,1,21,12,8,1,2,1,3,4,1,3,3,0,-1,0,1,2,2,0,0,8,9,-1,5,4,-1,0,0,-1,1,0,1,4,1
KR_6729322062,420,0,-5,1,7,4,4,0,2,3,1,6,8,2,-4,3,7,-1,1,2,0,3,4,-1,8,7,-3,0,0,1,1,0,1,1,1
KR_6756498283,420,1,-40,23,-2,1,2,1,0,3,3,3,3,0,-5,0,5,-1,2,3,0,-9,9,3,4,7,1,0,-2,1,-1,-1,-1,3,1
KR_6719790843,420,-4,-62,-20,-10,0,2,2,-10,2,12,-3,1,4,5,5,0,-2,1,3,0,-13,-24,1,4,5,-3,0,-1,1,-1,-1,1,6,1
KR_6656802500,420,-1,8,-12,5,0,2,2,4,5,1,-7,3,10,7,8,1,1,2,1,1,3,10,-1,7,6,-3,0,0,1,-1,1,1,4,1
KR_6711517724,420,1,-19,3,2,-3,1,4,4,5,1,1,2,1,1,2,1,-1,0,1,0,6,38,4,4,8,0,0,0,1,-1,0,1,1,1
KR_6768462352,420,-2,27,-37,-12,-2,1,3,-4,1,5,-1,2,3,-2,3,5,-3,1,4,0,-13,-1,2,8,10,-2,0,-1,-1,1,-1,-1,4,1
KR_6769348716,420,3,29,15,3,1,2,1,2,7,5,-2,0,2,1,4,3,1,1,0,0,-1,2,5,4,9,0,0,0,-1,1,0,-1,3,1
KR_6765682361,440,2,55,-17,6,0,1,1,1,1,0,3,4,1,3,6,3,-1,0,1,1,6,-26,-1,7,6,4,0,1,1,-1,1,1,5,1
KR_6615794105,420,4,30,-5,2,2,3,1,-1,5,6,2,5,3,-1,1,2,0,0,0,0,1,1,2,5,7,1,0,0,-1,1,1,1,1,1
KR_6751493929,420,1,-31,8,3,2,6,4,1,3,2,0,2,2,1,3,2,-1,1,2,1,3,2,5,2,7,-3,0,2,-1,1,1,1,6,1
KR_6768671656,420,3,48,17,6,-2,0,2,6,6,0,3,4,1,-1,0,1,0,1,1,0,6,115,5,1,6,-1,0,1,1,1,1,1,6,1
KR_6761556322,420,0,-7,-24,3,3,3,0,4,6,2,1,1,0,-2,2,4,-3,0,3,-1,10,-5,1,4,5,4,0,0,1,1,0,-1,6,1
KR_6722656344,420,-1,47,1,4,-1,1,2,3,4,1,4,6,2,-3,1,4,1,1,0,0,9,24,2,4,6,3,0,-1,1,1,-1,1,2,1
KR_6756598679,420,2,-1,35,1,2,2,0,5,5,0,0,2,2,-1,2,3,-5,1,6,-1,1,-5,0,6,6,1,0,0,1,1,0,-1,2,1
KR_6757211514,420,5,-19,4,10,3,6,3,2,3,1,4,5,1,0,4,4,1,1,0,-1,7,-6,0,4,4,1,0,-2,1,1,-1,-1,1,1
KR_6735951605,420,3,59,-11,4,2,3,1,-1,4,5,2,3,1,0,2,2,1,2,1,-2,0,-29,-2,6,4,1,0,2,1,1,1,-1,3,1
KR_6770307446,440,3,29,16,15,5,6,1,1,2,1,0,3,3,10,10,0,-1,2,3,0,15,11,1,5,6,2,0,3,-1,1,1,1,2,1
KR_6753435971,420,4,42,14,4,3,4,1,0,3,3,0,3,3,0,2,2,1,1,0,0,0,-2,-3,5,2,-3,0,0,-1,-1,0,1,6,1
KR_6754967130,440,2,11,4,1,-1,2,3,5,6,1,1,2,1,0,4,4,-4,0,4,0,-5,-90,1,3,4,-1,0,0,-1,1,0,1,3,1
KR_6597997546,420,0,13,1,-5,-5,1,6,4,9,5,1,5,4,-9,0,9,4,5,1,1,7,2,4,5,9,-2,0,0,-1,0,-1,1,2,1
KR_6737097133,420,0,18,-5,-1,-3,1,4,3,5,2,-3,2,5,0,2,2,2,2,0,-1,5,-1,1,6,7,1,0,0,-1,1,0,-1,2,1
KR_6762798782,420,0,-32,1,-7,-1,0,1,2,4,2,-4,0,4,-5,1,6,1,2,1,1,-1,-20,2,6,8,-4,0,0,1,-1,0,1,1,1
KR_6727495987,420,5,89,-12,18,0,3,3,7,7,0,2,5,3,9,10,1,0,2,2,0,12,20,7,0,7,-1,0,2,1,1,1,-1,5,1
KR_6723354869,420,-2,46,-4,-1,-2,0,2,-5,0,5,1,4,3,5,7,2,0,2,2,0,-1,24,2,8,10,3,0,2,-1,1,1,1,6,1
KR_6770356286,440,-1,32,-16,1,-4,0,4,3,6,3,0,2,2,3,6,3,-1,0,1,0,0,3,-2,6,4,-2,0,0,1,-1,-1,1,2,1
KR_6733161298,420,2,73,0,4,4,5,1,-1,3,4,-2,0,2,0,3,3,3,5,2,1,10,22,1,3,4,-1,0,0,1,1,0,1,6,1
KR_6769160229,420,2,49,-9,10,1,1,0,4,6,2,-4,2,6,10,10,0,-1,0,1,0,11,-1,-2,7,5,3,0,0,1,1,0,-1,6,1
KR_6721379257,420,3,73,32,4,3,5,2,-1,3,4,0,4,4,3,4,1,-1,1,2,0,0,13,2,6,8,0,0,1,1,1,1,1,1,1
KR_6739583505,440,-2,33,16,4,1,2,1,2,3,1,3,6,3,-1,6,7,-1,0,1,0,8,-5,3,4,7,1,0,-1,1,1,-1,1,6,1
KR_6711948763,420,-1,32,-4,-1,-2,0,2,0,3,3,-1,4,5,3,4,1,-1,0,1,0,3,1,-5,7,2,2,0,2,-1,1,1,-1,3,1
KR_6761818425,420,-1,-16,-23,2,-2,2,4,-1,3,4,3,4,1,2,5,3,0,0,0,-1,12,-43,0,7,7,21,0,-1,-1,1,-1,-1,5,1
KR_6724259622,420,5,24,36,6,3,3,0,4,5,1,4,5,1,-4,3,7,-1,1,2,0,5,11,-2,6,4,0,0,0,1,1,1,1,1,1
KR_6715513106,440,-1,-50,23,2,7,8,1,3,5,2,-1,0,1,-3,0,3,-4,0,4,-1,2,10,9,1,10,0,0,1,0,1,1,-1,0,1
KR_6759319871,440,2,100,-4,7,4,4,0,0,4,4,0,3,3,3,3,0,0,0,0,0,8,-72,3,4,7,-25,0,1,1,-1,1,1,2,1
KR_6751453591,420,2,14,3,10,2,5,3,2,5,3,-1,3,4,8,9,1,-1,0,1,0,8,9,-4,7,3,2,0,2,0,-1,1,1,0,1
KR_6722314645,420,0,5,3,-4,0,1,1,-4,2,6,-3,0,3,0,1,1,3,3,0,-1,-6,7,2,3,5,-2,0,1,-1,1,1,-1,5,1
KR_6748368425,420,4,66,-3,6,-1,1,2,-3,2,5,3,4,1,6,8,2,1,1,0,0,4,10,1,4,5,-3,0,1,-1,-1,1,-1,2,1
KR_6765544722,420,6,62,28,19,4,5,1,5,9,4,6,7,1,3,4,1,1,2,1,-1,9,-19,-4,10,6,1,0,1,1,1,-1,-1,2,1
KR_6769803069,420,6,79,16,14,5,5,0,2,2,0,2,3,1,4,5,1,1,1,0,0,11,2,-6,10,4,-6,0,0,-1,0,1,1,4,1
KR_6769978211,420,0,-50,-4,-5,-2,1,3,-4,2,6,0,2,2,0,1,1,1,1,0,0,0,-2,-6,11,5,3,0,0,-1,1,0,1,4,1
KR_6768171497,420,1,8,23,3,-1,0,1,0,3,3,4,5,1,0,5,5,0,0,0,0,8,-145,2,5,7,-2,0,0,-1,1,0,-1,3,1
KR_6762256822,420,3,-5,32,8,0,0,0,-5,0,5,3,6,3,8,8,0,2,3,1,0,11,7,0,8,8,5,0,1,1,-1,1,1,5,1
KR_6770042671,420,1,41,3,1,4,4,0,-3,2,5,0,1,1,1,4,3,-1,0,1,0,-6,13,-3,7,4,5,0,0,0,-1,1,1,0,1
KR_6720204879,420,3,56,17,4,5,7,2,1,1,0,-3,0,3,2,2,0,-1,0,1,0,5,-8,-2,5,3,3,0,1,1,-1,1,1,4,1
KR_6709809928,420,-1,-6,-16,-6,0,1,1,1,4,3,-1,0,1,-5,0,5,-1,0,1,0,-13,2,-1,5,4,1,0,-1,1,-1,-1,-1,4,1
KR_6766855540,420,5,74,16,9,3,4,1,-2,1,3,6,7,1,3,4,1,-1,0,1,0,3,29,5,3,8,-2,0,2,1,1,1,1,5,1
KR_6674667752,420,2,53,11,0,3,3,0,-4,1,5,2,4,2,-2,0,2,1,3,2,0,-6,4,-2,8,6,-2,0,0,1,1,0,1,6,1
KR_6729643005,420,0,-30,-11,2,4,4,0,-5,1,6,2,3,1,-1,2,3,2,2,0,0,6,103,3,2,5,3,0,1,1,1,1,-1,5,1
KR_6754353023,420,3,17,23,1,0,1,1,3,3,0,0,2,2,-1,2,3,-1,0,1,0,-3,-3,-5,8,3,4,0,0,-1,1,0,-1,3,1
KR_6767282684,420,-2,-14,-28,-1,-1,1,2,4,4,0,-3,1,4,1,1,0,-2,0,2,0,2,4,-1,4,3,-3,0,-1,1,-1,-1,1,5,1
KR_6767777923,420,0,-17,0,4,-1,2,3,5,6,1,1,1,0,0,1,1,-1,0,1,1,8,-7,2,7,9,2,0,0,1,-1,0,1,2,1
KR_6767608016,420,1,-18,25,2,1,3,2,2,4,2,3,4,1,-1,3,4,-3,2,5,0,3,15,0,4,4,-4,0,0,1,1,0,1,2,1
KR_6765651390,420,-2,33,4,-3,-1,1,2,0,2,2,0,1,1,-1,2,3,-1,0,1,0,-2,49,-1,4,3,-25,0,0,1,0,0,-1,5,1
KR_6754936893,420,0,9,4,-8,1,1,0,-3,2,5,-4,2,6,-2,6,8,0,1,1,0,-14,3,0,5,5,-8,0,-1,1,-1,-1,-1,2,1
KR_6726013760,420,9,135,49,21,4,5,1,5,5,0,7,8,1,4,5,1,1,1,0,0,20,-4,4,4,8,7,0,3,1,1,1,1,5,1
KR_6725983099,420,-2,10,-16,-1,1,3,2,0,3,3,1,1,0,-1,0,1,-2,0,2,0,0,5,2,5,7,-1,0,1,-1,-1,1,1,1,1
KR_6765260264,420,-1,-16,-12,-3,-3,1,4,-1,2,3,2,2,0,2,4,2,-3,0,3,0,-5,-4,-4,7,3,-1,0,1,1,-1,1,1,5,1
KR_6739382281,420,6,60,39,13,0,1,1,2,3,1,4,7,3,8,8,0,-1,1,2,-1,20,0,3,3,6,6,0,1,1,1,1,-1,2,1
KR_6699737177,420,5,30,96,12,-4,2,6,10,11,1,0,2,2,5,6,1,1,1,0,0,14,-4,6,3,9,1,0,1,1,1,1,1,5,1
KR_6745455372,420,0,-2,-13,3,-2,1,3,1,2,1,2,3,1,1,2,1,1,1,0,0,6,16,3,4,7,7,0,0,1,-1,0,1,5,1
KR_6767736413,420,-2,28,0,-3,0,1,1,-4,0,4,0,2,2,0,1,1,1,3,2,0,-4,-8,-3,9,6,7,0,0,1,-1,0,1,2,1
KR_6709205214,420,1,-40,4,3,-3,0,3,3,3,0,3,4,1,0,2,2,0,0,0,0,6,3,1,4,5,4,0,0,1,-1,0,-1,1,1
KR_6734172320,420,3,42,40,9,2,3,1,5,8,3,0,3,3,2,3,1,0,1,1,1,14,4,-1,6,5,0,0,0,-1,-1,1,1,1,1
KR_6658201011,420,6,67,52,12,4,5,1,-2,1,3,2,3,1,8,10,2,0,2,2,0,12,-3,3,5,8,8,0,3,1,1,1,1,3,1
KR_6710585387,420,-3,-71,0,-1,2,3,1,-2,1,3,0,1,1,0,3,3,-1,0,1,0,1,-4,3,3,6,1,0,0,0,-1,0,1,0,1
KR_6769596116,420,3,41,32,1,3,7,4,0,2,2,-5,1,6,3,4,1,0,3,3,-2,-6,4,2,8,10,2,0,2,1,-1,1,-1,5,1
KR_6767403475,420,5,22,8,13,3,3,0,6,7,1,5,5,0,0,1,1,-1,2,3,0,16,2,1,4,5,4,0,2,1,1,1,1,5,1
KR_6769327277,420,0,-11,8,1,-3,0,3,5,5,0,0,2,2,1,2,1,-2,0,2,1,4,5,-2,6,4,-3,0,0,1,1,-1,1,1,1
KR_6768768143,420,1,-17,13,6,-1,0,1,6,6,0,1,1,0,0,4,4,0,2,2,0,2,5,2,5,7,0,0,0,1,0,0,1,1,1
KR_6764350150,420,-1,12,-4,-1,-1,1,2,1,3,2,5,5,0,-4,2,6,-2,1,3,0,0,86,-1,4,3,-1,0,0,-1,1,0,1,1,1
KR_6769189165,420,1,18,16,7,0,2,2,1,4,3,-1,1,2,6,11,5,1,3,2,0,0,-2,-7,10,3,1,0,1,1,-1,1,1,2,1
KR_6769411168,420,3,-7,31,7,6,6,0,-2,1,3,1,3,2,0,1,1,2,2,0,0,-5,-3,1,4,5,3,0,1,-1,1,1,1,3,1
KR_6701524049,420,3,-11,7,7,1,2,1,3,3,0,-1,3,4,4,6,2,0,1,1,0,6,0,2,6,8,3,0,1,-1,1,1,1,6,1
KR_6714871615,420,2,24,-11,7,8,9,1,4,6,2,3,4,1,-7,0,7,-1,0,1,-2,1,-5,-1,7,6,-7,0,1,-1,1,1,-1,4,1
KR_6753917168,420,1,-8,11,-5,4,5,1,-4,3,7,2,4,2,-4,0,4,-3,0,3,0,-12,-6,0,5,5,-1,0,-3,1,-1,-1,-1,2,1
KR_6758385436,420,1,-37,7,-1,0,2,2,3,7,4,1,2,1,-5,1,6,0,0,0,0,5,2,4,5,9,-2,0,0,-1,1,-1,-1,4,1
KR_6746577333,440,-1,-9,-28,3,1,1,0,0,0,0,0,2,2,1,1,0,1,1,0,0,8,-17,2,3,5,-3,0,0,-1,-1,0,1,6,1
KR_6767182375,420,5,46,28,19,9,9,0,1,2,1,0,2,2,0,2,2,9,9,0,1,16,-17,1,5,6,1,0,3,1,1,1,1,2,1
KR_6764678328,420,5,45,4,14,1,3,2,2,2,0,4,4,0,4,4,0,3,3,0,0,15,10,5,3,8,-3,0,0,1,-1,0,1,6,1
KR_6710953433,420,-2,13,-16,-3,-2,1,3,0,4,4,-2,4,6,0,4,4,1,1,0,0,-8,3,-1,5,4,1,0,2,-1,1,1,-1,3,1
KR_6697291426,420,4,-17,7,7,5,6,1,3,4,1,0,1,1,0,1,1,-1,0,1,-1,9,9,8,1,9,2,0,0,1,1,0,-1,2,1
KR_6705953918,420,0,8,-5,-2,5,5,0,-5,0,5,4,5,1,-6,0,6,0,1,1,0,-9,-286,3,4,7,1,0,0,1,1,1,-1,6,1
KR_6742058178,420,-1,27,-36,5,5,5,0,8,9,1,-5,2,7,1,2,1,-4,1,5,0,5,-1,3,4,7,0,0,1,1,1,1,1,6,1
KR_6754985023,420,1,2,0,6,3,5,2,0,2,2,-1,2,3,1,1,0,3,3,0,0,8,1,-2,6,4,-1,0,1,1,-1,1,-1,6,1
KR_6764095856,420,0,-21,4,-2,-2,2,4,2,3,1,-5,2,7,4,5,1,-1,0,1,0,-9,22,3,7,10,4,0,0,1,1,1,1,4,1
KR_6762044292,420,0,-9,-9,0,-3,0,3,-1,0,1,1,2,1,6,8,2,-3,2,5,0,4,42,2,2,4,-16,0,0,-1,-1,-1,-1,6,1
KR_6763962726,420,4,14,17,7,7,8,1,2,2,0,4,4,0,-6,0,6,0,1,1,0,-3,-4,2,3,5,0,0,2,1,1,1,-1,5,1
KR_6756539928,420,7,20,43,13,0,0,0,5,5,0,0,1,1,7,9,2,1,1,0,0,9,-14,0,3,3,2,0,2,0,1,1,1,0,1
KR_6671271611,420,3,28,9,8,6,6,0,3,5,2,-1,2,3,-1,1,2,1,1,0,1,3,15,-1,7,6,4,0,0,-1,1,1,1,5,1
KR_6690528340,420,2,43,40,8,1,3,2,4,7,3,3,4,1,0,3,3,0,1,1,-2,9,-2,3,7,10,5,0,1,1,1,1,-1,4,1
KR_6770179091,420,1,37,-24,1,2,4,2,-1,4,5,2,2,0,0,0,0,-2,1,3,0,7,0,-1,5,4,2,0,0,1,-1,0,1,4,1
KR_6770105994,420,0,-20,14,6,0,2,2,3,3,0,1,1,0,1,1,0,1,1,0,0,7,-21,-5,9,4,-1,0,0,1,1,1,1,5,1
KR_6769759326,440,-3,-19,-24,-6,-1,3,4,-4,0,4,0,0,0,-2,2,4,1,1,0,-1,-9,15,4,4,8,-8,0,-1,-1,1,-1,-1,4,1
KR_6755192925,420,4,97,28,7,3,3,0,6,7,1,0,1,1,-2,2,4,0,1,1,0,9,7,4,2,6,-5,0,2,1,1,1,-1,1,1
KR_6748948702,420,-3,-26,4,-3,3,3,0,3,3,0,-7,2,9,-2,2,4,0,0,0,0,-4,10,5,5,10,-6,0,-1,1,-1,-1,1,1,1
KR_6756816014,420,3,15,29,-2,-2,0,2,0,2,2,0,1,1,-1,4,5,1,1,0,0,-9,-3,0,5,5,-2,0,-1,-1,-1,-1,-1,5,1
KR_6742315216,420,0,4,1,1,3,4,1,0,3,3,-3,2,5,1,2,1,0,0,0,0,-1,-9,-4,7,3,-2,0,0,1,-1,-1,1,2,1
KR_6665421716,420,1,-67,12,0,-1,2,3,2,3,1,1,2,1,-4,1,5,2,2,0,0,-1,-5,0,6,6,0,0,-3,-1,-1,-1,-1,4,1
KR_6672773573,420,3,24,3,8,1,3,2,1,5,4,2,4,2,2,3,1,2,2,0,0,14,-4,-1,6,5,2,0,0,-1,1,0,1,2,1
KR_6769496823,420,1,-16,11,4,3,3,0,3,4,1,2,6,4,-4,2,6,0,0,0,-1,-6,-1,1,3,4,1,0,2,-1,1,1,-1,6,1
KR_6751147913,420,0,-2,13,-2,2,3,1,-4,2,6,2,4,2,-2,2,4,0,1,1,0,-14,-21,-6,9,3,6,0,-1,-1,1,-1,-1,5,1
KR_6766877146,420,4,5,-1,5,2,2,0,4,5,1,1,6,5,0,1,1,-2,1,3,0,12,2,-3,7,4,0,0,-1,1,-1,-1,1,1,1
KR_6716017092,420,1,5,-13,1,-3,0,3,-1,2,3,1,1,0,1,3,2,3,3,0,0,4,15,6,5,11,1,0,1,1,-1,1,-1,3,1
KR_6639427185,420,6,111,4,9,4,5,1,3,4,1,-1,1,2,2,2,0,1,3,2,0,5,-11,1,4,5,-2,0,3,-1,-1,1,1,3,1
KR_6768048713,420,0,51,-12,-1,2,4,2,0,2,2,-2,0,2,-1,4,5,0,0,0,0,-7,88,4,3,7,2,0,1,-1,1,1,1,4,1
KR_6767318758,420,5,-10,22,6,1,1,0,0,3,3,-1,1,2,6,9,3,0,1,1,0,10,0,3,3,6,-1,0,0,1,0,0,-1,5,1
KR_6739033915,420,-1,6,-21,-3,3,4,1,-8,0,8,2,2,0,-1,5,6,1,3,2,0,-1,22,1,4,5,-9,0,1,-1,-1,1,-1,2,1
KR_6707691190,420,4,16,-16,15,6,7,1,4,6,2,0,1,1,5,8,3,0,4,4,0,27,-28,9,2,11,2,0,1,1,1,1,-1,2,1
KR_6769672765,420,0,-47,-22,-5,-8,2,10,3,6,3,-2,1,3,2,4,2,0,2,2,0,13,-5,0,7,7,-5,0,0,-1,-1,-1,1,4,1
KR_6712923210,420,2,108,15,9,-1,1,2,1,2,1,3,3,0,5,6,1,1,1,0,0,8,-6,-4,9,5,5,0,0,1,1,0,1,5,1
KR_6767533688,420,3,15,15,7,3,3,0,-3,0,3,1,3,2,8,8,0,-2,1,3,0,5,7,1,2,3,2,0,0,-1,1,0,-1,3,1
KR_6765725978,440,2,57,14,1,1,1,0,-2,0,2,3,4,1,0,1,1,-1,3,4,0,-2,-2,0,3,3,-1,0,0,0,1,1,-1,0,1
KR_6645628382,420,3,-22,21,7,3,3,0,-2,1,3,5,6,1,0,3,3,1,4,3,0,2,-6,1,3,4,-1,0,0,1,-1,0,-1,6,1
KR_6728700196,420,-1,8,8,-2,-2,0,2,1,4,3,-1,1,2,0,6,6,0,1,1,0,2,9,3,3,6,-1,0,-1,1,-1,-1,1,5,1
KR_6743555883,420,1,69,-43,5,3,5,2,2,3,1,0,3,3,2,5,3,-2,0,2,-3,8,-7,-1,4,3,0,0,0,-1,-1,0,-1,2,1
KR_6728073739,420,3,-19,10,3,3,5,2,1,5,4,1,5,4,0,2,2,-2,0,2,0,3,-4,2,8,10,-6,0,1,-1,1,1,-1,1,1
KR_6768392549,440,-1,-13,-12,-1,-2,0,2,-3,0,3,6,7,1,-3,0,3,1,1,0,0,-2,30,-2,6,4,-18,0,0,1,-1,0,-1,5,1
KR_6733687292,420,-1,7,-15,0,-1,0,1,-5,3,8,1,3,2,4,5,1,1,2,1,-1,1,7,0,6,6,-2,0,1,1,-1,1,-1,2,1
KR_6763862992,420,4,49,26,10,0,0,0,1,3,2,1,2,1,8,12,4,0,0,0,1,15,-10,-1,6,5,1,0,2,1,1,1,1,3,1
KR_6740595900,420,-2,18,-9,-1,0,2,2,1,2,1,0,3,3,-3,0,3,1,1,0,0,-1,-18,-8,10,2,5,0,0,1,-1,0,-1,4,1
KR_6764648803,420,4,61,17,9,0,0,0,-1,0,1,6,7,1,3,5,2,1,2,1,0,13,-8,1,3,4,-2,0,0,1,1,0,1,4,1
KR_6762905863,420,-2,40,-9,2,-1,0,1,0,3,3,-3,1,4,8,9,1,-2,0,2,-1,2,10,0,6,6,9,0,0,0,-1,1,-1,0,1
KR_6741012970,420,3,44,20,6,0,0,0,2,6,4,1,2,1,3,3,0,0,1,1,0,4,3,3,4,7,1,0,2,1,1,1,1,1,1
KR_6701026480,440,2,5,6,-2,6,7,1,-11,1,12,-2,0,2,2,4,2,3,5,2,0,-8,242,2,4,6,2,0,1,0,1,1,-1,0,1
KR_6629465526,420,1,-25,25,6,3,3,0,4,9,5,-2,0,2,1,2,1,0,0,0,0,7,1,-2,9,7,4,0,-2,1,-1,-1,1,3,1
KR_6767508338,420,3,87,2,10,2,4,2,1,5,4,0,1,1,8,9,1,-1,0,1,0,15,-9,2,3,5,-2,0,1,1,-1,1,1,6,1
KR_6743106866,440,-2,-56,-20,-3,2,3,1,-1,3,4,-2,3,5,-2,1,3,0,0,0,0,-5,6,2,3,5,1,0,0,-1,-1,0,1,6,1
KR_6714427108,420,3,22,5,13,3,4,1,-6,1,7,5,5,0,9,9,0,2,5,3,0,10,-30,2,5,7,22,0,1,1,1,1,-1,1,1
KR_6711391992,420,2,18,15,1,0,3,3,3,6,3,-1,1,2,-1,0,1,0,0,0,0,-1,-31,-5,8,3,2,0,1,-1,1,1,-1,6,1
KR_6764976215,420,0,-30,16,-1,2,5,3,0,1,1,0,1,1,-3,1,4,0,1,1,-1,-1,-5,2,3,5,1,0,-2,1,-1,-1,-1,2,1
KR_6770393601,440,-1,7,-20,-1,2,3,1,-3,0,3,1,1,0,1,5,4,-2,1,3,0,-3,3,1,4,5,-1,0,0,-1,-1,0,1,4,1
KR_6766177829,420,1,10,3,7,1,2,1,3,5,2,5,6,1,1,1,0,-3,0,3,0,4,123,0,8,8,-2,0,0,1,1,1,1,1,1
KR_6769495498,420,2,25,-8,5,1,3,2,0,4,4,1,3,2,2,6,4,1,1,0,-1,9,-2,2,3,5,2,0,0,1,1,0,1,4,1
KR_6743534788,420,1,-17,6,2,2,2,0,-1,3,4,2,2,0,-4,2,6,3,3,0,0,-1,-10,0,5,5,-6,0,1,-1,1,1,-1,4,1
KR_6639314686,420,-1,8,20,-7,1,2,1,-1,2,3,-3,1,4,-2,2,4,-2,1,3,0,-11,-1,1,3,4,-3,0,0,1,-1,1,-1,2,1
KR_6752134714,420,3,72,-17,8,5,6,1,0,4,4,1,1,0,4,5,1,-2,1,3,0,-1,12,4,2,6,-6,0,3,1,-1,1,1,2,1
KR_6688550471,420,2,-11,-8,6,-3,2,5,0,1,1,5,6,1,3,6,3,1,1,0,1,14,114,6,2,8,6,0,-1,1,-1,-1,1,2,1
KR_6727370171,420,1,13,-23,1,-2,0,2,-1,3,4,3,4,1,0,4,4,1,1,0,0,-1,13,2,3,5,-4,0,2,-1,-1,1,1,1,1
KR_6751467999,420,4,19,20,-1,1,3,2,2,3,1,2,3,1,-5,3,8,-1,0,1,0,2,-5,-6,8,2,3,0,1,-1,1,1,-1,1,1
KR_6769294968,420,-1,-89,5,-1,-1,0,1,-2,2,4,-1,1,2,2,2,0,1,1,0,0,6,-17,0,5,5,-1,0,0,1,1,0,-1,2,1
KR_6739694430,440,-3,-29,14,-11,0,2,2,1,3,2,-6,1,7,-4,0,4,-2,0,2,0,-13,350,-1,4,3,-4,0,-2,-1,-1,-1,-1,6,1
KR_6721642494,420,-3,-6,24,2,-3,0,3,-3,3,6,4,4,0,3,3,0,1,1,0,0,12,-15,5,4,9,-4,0,1,-1,1,1,-1,4,1
KR_6749605634,420,2,-32,0,5,3,4,1,3,5,2,0,2,2,3,6,3,-4,3,7,-2,8,-4,0,5,5,4,0,-1,1,1,1,-1,1,1
KR_6728563643,420,4,25,26,10,2,3,1,0,1,1,1,3,2,8,13,5,-1,0,1,0,5,-23,-1,7,6,5,0,2,1,1,1,1,3,1
KR_6692532968,420,6,-26,17,10,-1,0,1,4,7,3,2,4,2,5,7,2,0,0,0,0,5,8,5,2,7,2,0,1,1,-1,1,1,6,1
KR_6742995546,420,2,30,-2,8,1,2,1,4,6,2,2,3,1,1,3,2,0,1,1,1,15,-1,9,3,12,2,0,0,1,-1,1,1,3,1
KR_6717292187,420,2,60,-18,4,1,3,2,-1,5,6,0,2,2,5,5,0,-1,1,2,0,7,1,0,5,5,-3,0,1,1,1,1,1,3,1
KR_6756032711,420,1,-14,3,5,-1,0,1,0,2,2,-1,0,1,6,8,2,1,1,0,0,7,6,0,6,6,2,0,1,1,-1,1,1,5,1
KR_6675574631,420,0,28,-7,6,2,3,1,0,4,4,0,5,5,2,2,0,2,3,1,0,9,-5,1,3,4,3,0,1,-1,1,1,1,2,1
KR_6758862137,420,6,84,1,11,0,0,0,7,8,1,0,3,3,1,2,1,3,3,0,1,10,19,3,6,9,1,0,1,1,1,1,1,3,1
KR_6681939313,420,0,-2,1,3,1,1,0,0,2,2,1,2,1,0,4,4,1,1,0,0,1,8,2,6,8,3,0,1,-1,1,1,1,5,1
KR_6761805060,440,6,38,48,14,0,1,1,7,9,2,2,2,0,2,3,1,3,3,0,0,14,-2,0,7,7,4,0,0,1,-1,0,1,1,1
KR_6770058349,440,-1,-52,-11,-1,-2,3,5,0,3,3,-2,1,3,5,5,0,-2,0,2,-1,0,1,1,4,5,-1,0,0,1,-1,0,-1,1,1
KR_6737816415,420,4,44,20,9,3,5,2,4,4,0,0,1,1,1,1,0,1,1,0,0,7,11,1,5,6,-2,0,2,1,1,1,-1,1,1
KR_6765539374,420,-1,-46,11,-3,0,2,2,1,1,0,1,2,1,-1,2,3,-4,1,5,0,3,-32,-4,9,5,18,0,-2,1,-1,-1,1,6,1
KR_6752540910,420,-1,-24,-9,-5,-1,1,2,-2,0,2,0,4,4,-1,1,2,-1,0,1,0,-5,-116,-4,5,1,-3,0,-2,-1,-1,-1,-1,2,1
KR_6707737129,420,2,48,19,3,0,2,2,-1,3,4,-1,0,1,7,7,0,-2,3,5,-1,5,-4,0,3,3,-1,0,1,1,1,1,-1,1,1
KR_6762046253,420,1,36,-33,7,0,2,2,0,4,4,5,8,3,2,3,1,0,0,0,0,0,18,8,1,9,2,0,0,1,0,0,1,1,1
KR_6758329855,440,2,6,42,-1,2,5,3,1,4,3,-2,5,7,-2,3,5,0,0,0,0,-2,1,-2,6,4,2,0,1,-1,0,1,-1,1,1
KR_6769123812,420,6,22,25,14,0,2,2,1,4,3,6,6,0,5,7,2,2,3,1,0,13,42,1,6,7,6,0,3,1,1,1,1,6,1
KR_6685824788,440,-4,-21,-48,-5,0,0,0,-1,3,4,2,2,0,-4,1,5,-2,0,2,0,-7,15,-2,9,7,-6,0,0,-1,1,0,-1,4,1
KR_6710062153,420,2,78,-15,3,3,3,0,1,3,2,1,1,0,-2,1,3,0,0,0,0,-1,-6,-3,6,3,1,0,2,-1,1,1,1,1,1
KR_6764466454,420,2,30,7,3,1,2,1,0,1,1,-6,2,8,5,5,0,3,3,0,0,8,-9,2,6,8,2,0,1,-1,1,1,-1,3,1
KR_6761708340,420,-1,17,-43,4,2,3,1,1,2,1,0,2,2,0,1,1,1,1,0,0,1,-9,0,4,4,0,0,0,-1,1,0,-1,3,1
KR_6735572490,440,11,170,55,22,-1,1,2,6,6,0,8,9,1,8,9,1,1,3,2,0,21,0,-3,6,3,-2,0,2,1,1,1,1,6,1
KR_6756350229,440,4,116,26,11,1,4,3,-2,1,3,4,4,0,6,6,0,2,2,0,1,9,5,0,2,2,0,0,1,1,1,1,1,6,1
KR_6612058636,420,0,7,-4,3,3,3,0,1,2,1,0,2,2,-1,0,1,0,0,0,0,1,34,-6,11,5,3,0,0,-1,-1,1,-1,3,1
KR_6762079699,420,2,39,26,6,3,3,0,-2,1,3,2,3,1,3,4,1,0,0,0,2,9,182,0,8,8,-1,0,2,-1,1,1,1,5,1
KR_6767151924,420,2,45,12,3,-1,1,2,4,5,1,3,6,3,-3,3,6,0,1,1,-1,1,97,3,6,9,-6,0,2,-1,1,1,-1,2,1
KR_6764808372,420,2,-37,-1,6,0,1,1,7,7,0,-1,0,1,2,3,1,-2,0,2,0,12,2,-1,3,2,-3,0,0,-1,-1,0,1,2,1
KR_6762643597,420,0,-39,28,1,2,3,1,1,2,1,-3,1,4,2,4,2,-1,1,2,0,2,1,1,3,4,-7,0,1,1,-1,-1,1,6,1
KR_6650565542,440,1,43,7,5,4,5,1,1,3,2,2,3,1,0,6,6,-2,0,2,0,6,2,-4,4,0,-2,0,-1,-1,1,1,1,6,1
KR_6747666102,420,3,37,17,6,1,3,2,5,7,2,0,1,1,-1,3,4,1,2,1,0,9,-7,-1,6,5,1,0,0,1,-1,0,-1,4,1
KR_6725134385,420,2,26,22,4,-4,1,5,5,6,1,2,2,0,1,1,0,0,0,0,0,1,-2,-1,5,4,-5,0,0,1,-1,-1,1,5,1
KR_6760981073,420,1,23,24,1,0,0,0,-1,1,2,7,7,0,1,3,2,-6,1,7,0,0,116,2,5,7,2,0,0,1,1,1,1,5,1
KR_6760127605,420,0,27,35,-10,2,2,0,-4,3,7,1,4,3,-6,0,6,-3,3,6,0,-14,-3,-5,7,2,-1,0,-3,-1,-1,-1,-1,4,1
KR_6737906255,420,2,0,16,-1,-1,2,3,3,6,3,2,4,2,-2,2,4,-3,1,4,0,-2,29,-2,4,2,-1,0,-1,-1,1,-1,1,3,1
KR_6673605365,420,2,101,26,6,3,3,0,2,4,2,2,4,2,0,1,1,-1,0,1,0,-1,17,-2,4,2,3,0,1,1,1,1,-1,1,1
KR_6748202446,420,3,32,-14,7,1,2,1,-2,4,6,1,2,1,5,5,0,2,2,0,0,8,4,7,3,10,4,0,2,-1,-1,1,1,4,1
KR_6770359494,440,0,-43,-24,-3,-3,0,3,3,3,0,1,5,4,-4,0,4,0,0,0,0,-3,-3,5,4,9,-2,0,-2,1,-1,-1,-1,2,1
KR_6769986281,420,0,-62,2,1,1,1,0,3,3,0,-2,0,2,0,2,2,-1,0,1,0,2,-12,-7,11,4,1,0,0,-1,1,0,-1,3,1
KR_6769519480,420,-2,-35,19,-1,-6,1,7,4,5,1,1,1,0,0,0,0,0,0,0,0,11,20,1,6,7,-2,0,-1,1,-1,-1,1,6,1
KR_6761922945,420,2,22,23,10,3,4,1,2,3,1,0,2,2,3,3,0,2,3,1,1,7,-11,0,4,4,5,0,3,1,1,1,1,2,1
KR_6687114563,420,2,20,3,5,0,2,2,4,5,1,4,5,1,-3,2,5,0,0,0,1,3,4,0,6,6,1,0,1,1,1,1,1,1,1
KR_6714141216,420,3,-21,1,9,1,1,0,3,4,1,4,6,2,1,2,1,0,0,0,1,9,-1,1,5,6,7,0,0,1,-1,-1,1,4,1
KR_6730922659,440,1,30,-27,6,4,5,1,2,4,2,5,6,1,-5,0,5,0,0,0,0,-7,-11,3,4,7,0,0,0,-1,1,-1,1,2,1
KR_6745606105,440,1,55,52,5,1,1,0,4,10,6,-3,1,4,-1,2,3,4,6,2,0,-1,30,2,2,4,0,0,1,-1,1,1,-1,5,1
KR_6770398094,440,1,4,14,4,5,5,0,3,4,1,0,1,1,-3,0,3,-1,0,1,0,0,4,3,2,5,0,0,2,-1,1,1,1,1,1
KR_6730500840,440,2,10,43,-3,-3,0,3,-5,1,6,-2,4,6,2,3,1,5,6,1,-1,-10,2,-3,6,3,4,0,1,-1,-1,1,-1,1,1
KR_6767758159,420,0,-60,-29,4,-2,1,3,2,6,4,0,6,6,4,5,1,0,1,1,-1,9,0,-2,5,3,5,0,-1,1,-1,-1,-1,5,1
KR_6755666192,440,0,26,-4,6,-4,0,4,4,4,0,-1,2,3,6,8,2,1,4,3,0,14,-5,3,1,4,6,0,0,1,-1,-1,1,6,1
KR_6760719219,420,1,-19,5,3,-3,0,3,7,7,0,0,1,1,0,2,2,-1,0,1,0,8,7,4,3,7,-11,0,0,1,-1,-1,1,4,1
KR_6768096632,420,2,-7,16,10,0,1,1,4,6,2,2,3,1,3,5,2,1,1,0,0,8,4,0,6,6,-1,0,0,1,1,0,1,1,1
KR_6754080402,420,3,57,-32,12,3,4,1,4,6,2,-1,1,2,8,8,0,-2,0,2,4,23,0,-2,8,6,3,0,1,-1,1,1,1,2,1
KR_6768471289,420,2,-13,8,13,2,3,1,2,3,1,-2,1,3,7,9,2,4,4,0,0,11,-5,-7,10,3,3,0,1,1,0,1,1,1,1
KR_6768455836,420,-2,-16,8,5,1,4,3,0,1,1,-1,3,4,4,5,1,1,2,1,0,12,-17,4,3,7,1,0,-2,1,-1,-1,1,6,1
KR_6768443002,440,1,26,-27,-3,2,3,1,2,6,4,0,2,2,-1,2,3,-6,2,8,-1,-8,-1,4,1,5,-1,0,0,-1,1,1,-1,5,1
KR_6766997905,420,0,-22,15,3,3,6,3,0,3,3,-4,1,5,3,5,2,1,1,0,-1,2,-9,-1,7,6,5,0,-1,1,-1,-1,-1,6,1
KR_6760224156,420,0,-9,-12,-5,0,2,2,2,2,0,-5,0,5,-2,3,5,0,2,2,0,-3,3,0,7,7,-3,0,0,1,-1,0,1,2,1
KR_6770095386,420,-1,-3,-24,0,-1,0,1,0,1,1,3,4,1,-2,2,4,0,0,0,0,3,-5,-1,4,3,6,0,-1,-1,-1,-1,-1,2,1
KR_6709213369,420,-1,18,-12,1,-4,3,7,1,3,2,0,1,1,1,6,5,3,3,0,0,-5,3,1,4,5,3,0,2,1,1,1,1,4,1
KR_6717601435,420,3,82,0,9,-4,2,6,3,6,3,7,7,0,5,6,1,-2,0,2,0,8,5,6,0,6,2,0,1,1,1,-1,1,3,1
KR_6733060835,420,3,82,17,2,2,3,1,0,1,1,2,4,2,-1,1,2,-1,1,2,-1,-2,2,2,5,7,-2,0,1,-1,-1,1,-1,2,1
KR_6746789626,420,1,-25,-2,1,-1,1,2,-5,2,7,6,6,0,1,3,2,0,2,2,0,10,145,-1,5,4,-2,0,-1,0,-1,-1,-1,0,1
KR_6662268387,420,-1,2,17,-2,0,4,4,-4,6,10,5,6,1,-2,2,4,-1,1,2,0,-9,2,1,6,7,2,0,1,1,-1,1,-1,6,1
KR_6750789636,440,2,3,35,5,3,3,0,0,1,1,5,5,0,-3,0,3,0,0,0,0,-2,56,4,2,6,-2,0,1,1,1,1,1,2,1
KR_6770234255,420,5,63,-13,16,4,5,1,2,4,2,3,3,0,6,6,0,1,1,0,1,16,5,2,3,5,1,0,3,1,1,1,1,4,1
KR_6724326220,420,3,17,-14,8,3,3,0,0,7,7,0,1,1,-1,0,1,6,6,0,0,8,7,1,3,4,1,0,1,-1,-1,1,1,4,1
KR_6763594725,420,1,20,22,-5,-2,0,2,0,4,4,-1,1,2,-2,1,3,0,1,1,0,-10,-31,-1,7,6,-8,0,-1,1,-1,-1,-1,6,1
KR_6754535134,420,-1,18,-11,-4,0,3,3,-3,0,3,0,2,2,0,0,0,-1,1,2,0,-2,-9,2,2,4,4,0,1,1,-1,1,1,3,1
KR_6762492455,420,3,42,8,1,2,3,1,1,5,4,0,1,1,-3,0,3,1,2,1,0,-7,10,3,4,7,-2,0,1,-1,1,1,1,6,1
KR_6734593527,440,6,138,32,13,3,3,0,0,4,4,0,5,5,10,10,0,0,1,1,3,14,2,5,2,7,0,0,1,1,-1,1,1,6,1
KR_6708480062,420,3,7,0,8,4,4,0,-1,4,5,3,7,4,1,3,2,1,2,1,0,-1,0,3,2,5,1,0,1,1,1,1,1,1,1
KR_6727558464,420,-1,8,-18,0,-1,1,2,1,3,2,4,4,0,-5,0,5,1,1,0,0,1,44,1,4,5,-8,0,0,1,-1,1,1,6,1
KR_6741451924,420,0,-6,-11,-5,-3,2,5,-4,1,5,0,2,2,1,1,0,1,1,0,0,-7,-6,-3,8,5,4,0,0,-1,1,0,1,4,1
KR_6711971685,420,3,93,11,11,1,1,0,-4,4,8,8,12,4,5,7,2,1,2,1,0,6,44,3,4,7,3,0,2,1,-1,1,-1,1,1
KR_6700549694,420,0,14,7,5,1,1,0,-3,1,4,2,4,2,6,7,1,-1,1,2,2,3,-22,0,7,7,-1,0,1,1,-1,1,1,5,1
KR_6743467113,420,-3,11,-23,0,-3,0,3,-3,3,6,1,3,2,4,4,0,1,1,0,0,4,-3,-1,4,3,0,0,0,1,-1,-1,-1,2,1
KR_6766143972,420,0,-7,5,2,-1,3,4,1,4,3,1,4,3,1,2,1,0,1,1,0,3,0,0,6,6,3,0,0,1,-1,-1,-1,5,1
KR_6664862481,420,0,26,-26,-9,4,4,0,-2,2,4,0,1,1,-3,3,6,-8,0,8,0,-10,-14,0,7,7,6,0,-2,-1,1,-1,-1,2,1
KR_6755527054,440,0,-9,3,-3,-3,0,3,1,2,1,0,2,2,0,2,2,-1,0,1,0,3,24,1,4,5,1,0,-1,-1,0,-1,-1,2,1
KR_6644907783,420,2,71,0,3,-2,2,4,0,4,4,3,3,0,2,4,2,0,1,1,0,4,7,-5,7,2,2,0,2,0,-1,1,-1,0,1
KR_6742607956,420,1,-9,17,10,-3,1,4,-2,2,4,7,8,1,7,8,1,1,3,2,0,18,23,5,0,5,-7,0,2,-1,1,1,1,2,1
KR_6758714687,420,4,72,45,9,0,1,1,2,4,2,1,2,1,3,4,1,3,3,0,1,9,22,1,3,4,-4,0,1,1,1,1,1,2,1
KR_6741725073,420,5,56,4,5,-1,1,2,5,9,4,3,4,1,-5,0,5,3,3,0,0,5,-12,-2,6,4,5,0,3,1,1,1,1,6,1
KR_6730083921,420,6,102,-17,9,4,5,1,2,5,3,4,6,2,1,9,8,-2,0,2,-3,6,-20,6,1,7,2,0,0,1,-1,1,1,1,1
KR_6768617782,420,-1,-61,17,5,1,4,3,1,4,3,-1,1,2,4,4,0,0,0,0,0,7,-18,-2,7,5,16,0,-1,0,1,-1,1,0,1
KR_6769220769,420,2,14,-15,0,-1,1,2,-2,3,5,1,2,1,2,3,1,0,0,0,-1,0,-9,1,7,8,5,0,-1,1,-1,-1,-1,4,1
KR_6770454630,440,0,-4,35,-7,0,1,1,1,2,1,5,5,0,-10,1,11,-3,0,3,0,-6,2,-3,7,4,-4,0,-1,-1,-1,-1,-1,6,1
KR_6769771385,440,5,22,36,9,3,5,2,9,9,0,-5,5,10,2,2,0,0,3,3,1,5,2,1,4,5,-3,0,2,1,1,1,1,1,1
KR_6766197725,420,6,34,47,10,-2,0,2,1,3,2,9,9,0,2,4,2,0,0,0,0,11,9,4,7,11,-3,0,1,1,1,1,1,3,1
KR_6770184371,440,7,99,52,8,-2,1,3,3,4,1,5,6,1,3,4,1,-1,0,1,-1,1,54,2,3,5,-23,0,2,1,1,1,-1,6,1
KR_6745797645,420,3,30,4,0,-1,1,2,-1,3,4,-1,1,2,-2,4,6,5,5,0,0,-7,20,1,4,5,3,0,0,1,1,0,1,1,1
KR_6746279754,420,2,54,-19,5,1,1,0,2,3,1,-3,2,5,3,4,1,2,2,0,0,9,-4,1,6,7,1,0,1,-1,0,1,1,4,1
KR_6728387063,420,3,9,32,4,2,3,1,2,5,3,2,3,1,-2,1,3,0,0,0,0,3,-2,-3,5,2,4,0,0,1,1,1,-1,2,1
KR_6717416424,420,0,2,16,6,1,2,1,1,4,3,5,6,1,0,1,1,-1,1,2,0,16,4,0,5,5,2,0,1,1,1,1,1,6,1
KR_6768093276,420,2,-1,31,-4,2,3,1,-1,2,3,-5,3,8,1,3,2,-1,1,2,-1,-7,-9,-4,6,2,1,0,1,0,1,1,1,0,1
KR_6745407576,420,-1,-5,-5,0,1,1,0,3,5,2,-2,1,3,-2,4,6,0,2,2,-1,-2,5,1,8,9,5,0,0,1,-1,0,-1,4,1
KR_6762983556,440,5,87,-12,24,2,5,3,0,5,5,13,14,1,8,8,0,1,2,1,2,19,10,6,1,7,0,0,4,1,1,1,1,5,1
KR_6762917206,440,1,28,-4,8,1,1,0,2,6,4,3,4,1,2,3,1,0,0,0,0,18,151,-3,8,5,-3,0,0,1,1,0,1,5,1
KR_6749186131,420,7,87,28,9,1,1,0,-1,3,4,9,10,1,1,3,2,-1,0,1,0,6,10,3,5,8,-1,0,1,1,1,1,1,5,1
KR_6734512485,420,-1,11,8,-4,1,3,2,-6,0,6,0,4,4,1,3,2,0,0,0,0,5,27,-1,8,7,7,0,-1,1,1,-1,-1,2,1
KR_6761243140,420,3,30,-22,8,5,6,1,-1,1,2,-1,1,2,5,5,0,0,1,1,1,2,4,-4,6,2,2,0,2,-1,1,1,1,6,1
KR_6760200457,420,4,43,32,4,1,2,1,0,2,2,2,4,2,-1,4,5,2,2,0,-1,0,-7,-6,7,1,1,0,0,1,-1,0,-1,1,1
KR_6730112893,420,4,45,28,10,3,3,0,6,6,0,1,3,2,1,3,2,-1,0,1,0,8,16,3,3,6,1,0,1,1,1,1,1,3,1
KR_6730733012,420,5,-32,-22,10,-1,1,2,-5,0,5,4,4,0,11,12,1,1,2,1,0,8,-4,-2,5,3,-2,0,2,1,1,1,1,1,1
KR_6736254056,420,5,74,-16,3,0,1,1,3,5,2,0,2,2,0,1,1,0,1,1,0,-4,10,-3,8,5,2,0,1,-1,-1,1,-1,4,1
KR_6694791294,420,4,68,34,12,4,6,2,4,6,2,2,5,3,2,3,1,0,2,2,0,8,12,-2,6,4,2,0,2,1,1,1,1,1,1
KR_6770529523,420,5,40,0,10,5,5,0,3,4,1,2,2,0,-1,0,1,1,1,0,0,6,-3,-1,6,5,4,0,1,1,1,1,1,3,1
KR_6763104139,420,-3,30,-11,1,0,1,1,2,4,2,-2,2,4,0,3,3,1,2,1,0,7,7,2,3,5,2,0,2,-1,1,1,1,1,1
KR_6668351439,420,-4,-51,-4,3,3,4,1,-3,0,3,4,5,1,-1,5,6,0,0,0,0,9,-13,-3,11,8,4,0,0,1,1,1,1,6,1
KR_6767451809,420,-1,-1,-13,-2,-4,0,4,2,4,2,-5,1,6,2,3,1,3,3,0,0,5,7,0,3,3,-2,0,0,1,1,1,-1,3,1
KR_6769907403,420,-2,27,-40,1,1,1,0,-4,0,4,0,3,3,3,5,2,1,1,0,0,6,-47,1,7,8,24,0,0,1,-1,0,1,6,1
KR_6764206621,420,0,15,-8,1,0,4,4,-1,0,1,3,3,0,1,5,4,-2,0,2,-1,2,12,6,5,11,-2,0,1,-1,1,1,-1,3,1
KR_6762274440,420,-2,33,-27,-5,-1,0,1,-1,0,1,-3,3,6,1,1,0,-1,0,1,0,-8,-15,-9,13,4,4,0,0,-1,-1,0,1,5,1
KR_6690485484,420,0,-25,3,-1,-1,2,3,4,7,3,1,2,1,-3,1,4,-2,1,3,0,1,1,-6,10,4,-3,0,0,1,1,0,-1,2,1
KR_6707314750,420,2,14,0,1,1,3,2,-2,2,4,-1,1,2,3,4,1,0,1,1,0,1,8,4,6,10,1,0,0,-1,0,0,-1,6,1
KR_6725080783,420,-4,-9,-36,-4,-4,1,5,0,3,3,5,5,0,-2,3,5,-3,0,3,0,4,5,2,6,8,5,0,2,1,1,1,-1,3,1
KR_6749794105,420,-3,-59,24,-2,3,3,0,-2,0,2,2,3,1,-5,2,7,0,0,0,0,-7,-2,-2,6,4,3,0,0,0,1,0,-1,0,1
KR_6758198011,420,2,17,34,5,2,2,0,2,5,3,0,1,1,0,3,3,1,1,0,0,2,5,1,3,4,-1,0,2,-1,1,1,1,3,1
KR_6767531071,420,3,-2,-11,12,2,5,3,3,3,0,7,7,0,0,2,2,0,2,2,-1,10,9,3,4,7,1,0,0,1,1,1,-1,5,1
KR_6769728129,440,1,13,12,0,-4,0,4,-1,0,1,-1,0,1,0,1,1,6,6,0,0,-4,-5,0,5,5,0,0,0,1,-1,-1,1,3,1
KR_6698794034,420,3,-50,40,8,1,1,0,10,12,2,-1,0,1,-2,1,3,0,1,1,0,5,92,7,4,11,0,0,1,1,1,1,-1,1,1
KR_6765491242,420,8,86,15,15,8,8,0,0,1,1,5,6,1,-2,1,3,4,4,0,0,9,16,4,2,6,1,0,3,1,1,1,1,2,1
KR_6687983900,440,3,-38,4,8,-3,0,3,2,4,2,4,5,1,0,2,2,5,6,1,-1,9,-2,5,5,10,5,0,0,1,1,1,-1,1,1
KR_6741435173,420,5,47,48,12,1,1,0,4,5,1,2,3,1,6,7,1,-1,0,1,0,13,2,1,7,8,3,0,3,-1,1,1,1,4,1
KR_6768679900,420,3,72,37,2,1,2,1,2,2,0,-3,1,4,2,3,1,0,1,1,0,-4,5,1,3,4,1,0,1,1,1,1,1,2,1
KR_6762190419,420,6,106,31,10,4,4,0,0,2,2,3,3,0,2,3,1,1,2,1,0,4,1,-1,5,4,-1,0,2,1,1,1,1,1,1
KR_6730288863,440,-2,-24,-4,-4,-3,1,4,2,3,1,-2,3,5,-1,3,4,0,1,1,0,-6,32,-1,5,4,-3,0,0,1,1,0,-1,5,1
KR_6757837817,420,1,58,13,7,2,3,1,3,3,0,0,1,1,1,5,4,1,1,0,0,9,5,4,1,5,1,0,1,-1,1,1,1,2,1
KR_6689694002,420,0,-7,-16,-2,2,3,1,-3,2,5,-2,0,2,2,4,2,-1,1,2,1,-5,51,-5,7,2,-24,0,1,1,1,1,1,1,1
KR_6762357784,420,1,52,3,7,3,3,0,1,3,2,4,5,1,1,3,2,-2,1,3,0,10,-8,-1,6,5,6,0,1,1,-1,1,-1,1,1
KR_6754552013,420,5,11,11,18,2,4,2,5,5,0,4,6,2,5,5,0,2,3,1,1,20,-1,0,4,4,1,0,2,1,1,1,1,6,1
KR_6769587286,420,1,74,-10,-2,5,5,0,0,1,1,-3,0,3,-3,3,6,-1,0,1,0,-12,4,1,4,5,0,0,0,-1,1,0,1,6,1
KR_6748522847,420,1,-4,8,7,-1,1,2,3,5,2,-2,0,2,6,6,0,1,1,0,0,15,-20,0,5,5,-1,0,1,1,1,1,1,5,1
KR_6761288607,440,1,-69,12,5,-5,0,5,3,5,2,5,6,1,2,6,4,0,1,1,1,5,1,-1,3,2,1,0,0,1,1,0,1,5,1
KR_6761398577,440,2,45,-4,11,2,3,1,-1,1,2,12,12,0,1,5,4,-3,1,4,0,-3,1,-2,6,4,3,0,0,1,-1,-1,1,6,1
KR_6679528841,420,0,42,36,-1,0,4,4,2,2,0,-4,2,6,-1,5,6,2,2,0,-2,-5,6,3,5,8,3,0,0,-1,1,0,1,6,1
KR_6715893426,420,0,21,1,3,-2,1,3,0,3,3,-1,3,4,5,5,0,1,1,0,0,6,1,2,4,6,-1,0,-1,1,-1,-1,1,2,1
KR_6718738373,420,4,34,4,8,0,2,2,3,5,2,1,3,2,5,5,0,-1,0,1,0,7,-73,2,4,6,22,0,1,1,1,1,1,5,1
KR_6748923452,420,5,63,15,12,4,6,2,0,1,1,2,2,0,3,5,2,3,5,2,1,12,2,-4,10,6,8,0,3,1,1,1,1,4,1
KR_6768732789,420,3,65,-24,13,6,6,0,3,5,2,-1,3,4,4,6,2,1,1,0,2,10,-9,0,5,5,2,0,1,1,-1,1,1,5,1
KR_6721014879,420,0,-41,20,0,-4,1,5,2,5,3,-2,3,5,3,3,0,1,3,2,0,10,-3,-7,8,1,3,0,1,1,-1,1,1,2,1
KR_6756362757,420,1,31,1,6,8,8,0,-1,0,1,-2,2,4,2,4,2,-1,0,1,0,12,2,-5,7,2,2,0,0,1,-1,-1,-1,4,1
KR_6766650299,440,1,5,30,5,-2,2,4,2,3,1,4,6,2,1,3,2,0,2,2,2,8,-17,4,2,6,0,0,0,1,1,0,1,2,1
KR_6765208457,420,1,-10,-12,4,0,3,3,1,3,2,2,3,1,-1,1,2,2,4,2,0,4,-4,-2,5,3,2,0,0,1,-1,-1,1,3,1
KR_6767990577,440,3,52,41,-3,-1,0,1,1,1,0,0,3,3,-2,3,5,-1,2,3,-1,-8,-7,-3,7,4,-1,0,1,-1,1,1,-1,4,1
KR_6731072831,420,2,-26,11,3,-3,0,3,3,7,4,1,5,4,2,5,3,0,2,2,-1,-1,-19,-8,9,1,-1,0,0,-1,0,0,-1,2,1
KR_6768128178,420,-3,18,0,-8,-2,2,4,2,3,1,-3,1,4,-5,4,9,0,1,1,0,0,116,-2,5,3,3,0,0,1,-1,-1,-1,2,1
KR_6743200313,420,5,17,7,6,1,2,1,1,5,4,0,1,1,3,5,2,1,2,1,0,0,123,3,5,8,-9,0,1,-1,1,1,-1,2,1
KR_6764141464,420,-1,24,-21,0,-1,1,2,1,2,1,1,3,2,1,6,5,-2,0,2,0,-1,-22,-2,8,6,6,0,-1,1,-1,-1,-1,4,1
KR_6761212102,420,-2,-23,6,-3,2,3,1,-1,2,3,-2,1,3,-2,4,6,0,0,0,0,-3,-9,-4,10,6,-7,0,1,-1,1,-1,-1,5,1
KR_6709227807,420,1,98,3,5,0,3,3,2,4,2,4,5,1,1,6,5,-2,1,3,0,6,-4,-4,7,3,5,0,0,-1,-1,0,-1,5,1
KR_6753874182,440,0,100,0,-1,1,7,6,-3,3,6,-1,3,4,3,5,2,-1,1,2,-3,-16,-4,0,4,4,-1,0,1,-1,1,1,-1,1,1
KR_6764890877,420,-1,-39,-1,3,1,3,2,2,5,3,-1,0,1,2,3,1,-1,1,2,0,4,2,3,4,7,3,0,0,-1,1,0,1,2,1
KR_6738046438,420,1,52,-12,5,5,6,1,-4,2,6,3,4,1,2,5,3,-1,3,4,1,5,6,3,5,8,-1,0,2,1,1,1,1,2,1
KR_6638235615,420,4,53,-5,9,6,6,0,1,1,0,-4,2,6,6,6,0,0,0,0,0,16,6,4,4,8,3,0,1,1,-1,1,-1,1,1
KR_6765844846,420,1,-34,9,6,4,6,2,2,3,1,0,1,1,0,1,1,0,2,2,0,3,-33,0,6,6,27,0,0,1,-1,-1,-1,5,1
KR_6682250480,420,0,-3,7,0,2,3,1,2,4,2,0,2,2,-4,2,6,0,0,0,0,-3,-3,0,4,4,3,0,0,1,1,0,1,6,1
KR_6740498582,420,2,1,9,-5,-6,0,6,-5,1,6,-2,0,2,6,7,1,2,3,1,0,1,-44,-1,6,5,7,0,-1,1,-1,-1,-1,5,1
KR_6769686261,440,4,10,38,16,5,7,2,8,9,1,1,3,2,2,3,1,0,1,1,0,17,-1,1,4,5,2,0,1,1,1,1,1,4,1
KR_6752289162,420,4,28,52,5,2,2,0,1,1,0,4,5,1,-1,3,4,-1,0,1,1,9,6,6,0,6,0,0,2,1,1,1,1,4,1
KR_6693622747,420,2,9,0,12,0,1,1,7,9,2,5,6,1,0,3,3,0,2,2,1,13,115,1,4,5,1,0,1,1,1,1,1,3,1
KR_6762093421,420,-2,23,-8,-3,2,5,3,-1,3,4,-3,5,8,-1,1,2,0,0,0,1,-7,-6,0,7,7,0,0,1,-1,1,1,1,1,1
KR_6758427069,420,-2,-1,-52,1,1,2,1,1,9,8,-1,2,3,-3,0,3,3,4,1,0,-1,-5,-7,12,5,3,0,-1,-1,-1,-1,1,3,1
KR_6767473687,420,3,25,-31,2,0,2,2,2,6,4,-2,2,4,0,1,1,2,3,1,0,-1,60,0,2,2,-4,0,2,-1,1,1,-1,5,1
KR_6751956135,420,1,-13,-7,3,-3,1,4,3,6,3,1,1,0,2,3,1,0,0,0,0,6,0,-1,5,4,2,0,1,-1,1,1,-1,6,1
KR_6769847636,440,3,43,-4,12,9,10,1,1,3,2,1,7,6,-2,1,3,3,3,0,0,17,-11,2,2,4,0,0,1,1,0,1,1,3,1
KR_6710574280,440,5,42,9,16,1,1,0,7,7,0,5,7,2,2,2,0,1,3,2,1,16,3,2,4,6,5,0,1,-1,1,1,1,5,1
KR_6762157860,420,0,3,-43,10,0,1,1,2,2,0,0,0,0,9,10,1,-1,0,1,0,16,-3,5,2,7,1,0,-2,1,-1,-1,-1,3,1
KR_6761703997,420,5,22,22,1,2,3,1,-4,2,6,-1,3,4,0,3,3,4,5,1,0,4,6,-5,7,2,-3,0,2,-1,1,1,-1,1,1
KR_6761067477,440,2,-2,-12,-2,-2,0,2,-4,1,5,2,3,1,2,3,1,0,1,1,-1,-2,-3,-3,6,3,-4,0,0,1,-1,0,-1,6,1
KR_6758312793,420,2,44,22,-2,8,9,1,3,5,2,-2,3,5,-5,1,6,-6,0,6,0,-7,37,4,3,7,-3,0,1,-1,1,1,-1,5,1
KR_6767288003,420,-3,-76,-33,1,-2,0,2,0,5,5,7,7,0,-3,1,4,-1,0,1,0,10,-7,0,6,6,-4,0,0,1,1,-1,1,3,1
KR_6724212924,420,0,10,31,-4,0,0,0,-1,1,2,0,2,2,-3,0,3,0,0,0,0,-6,-2,1,6,7,4,0,1,1,1,1,1,3,1
KR_6764687990,440,4,87,-9,11,0,1,1,2,2,0,7,10,3,0,3,3,2,2,0,1,8,5,2,4,6,3,0,1,1,-1,1,1,2,1
KR_6597816138,420,-1,-9,-44,1,2,5,3,-4,1,5,2,4,2,0,2,2,1,1,0,0,-4,-1,4,5,9,1,0,-1,-1,-1,-1,-1,2,1
KR_6766915721,420,4,76,27,5,4,4,0,0,1,1,0,2,2,2,3,1,-1,1,2,0,1,19,-5,8,3,9,0,0,-1,-1,1,1,6,1
KR_6624484974,420,4,65,44,11,-1,1,2,3,5,2,4,6,2,4,5,1,1,1,0,0,9,-28,0,5,5,0,0,1,1,1,1,-1,4,1
KR_6763279745,420,5,95,48,7,2,3,1,1,3,2,-1,0,1,5,5,0,0,0,0,0,8,-13,-1,6,5,-1,0,0,1,-1,1,1,4,1
KR_6703425479,440,0,20,-28,-2,3,6,3,-6,1,7,0,2,2,1,5,4,0,2,2,1,-10,-19,2,2,4,-1,0,0,-1,-1,0,-1,6,1
KR_6759695607,420,5,69,13,14,1,3,2,0,3,3,1,6,5,12,15,3,0,1,1,0,8,14,6,4,10,-3,0,5,-1,1,1,1,3,1
KR_6767730421,420,4,41,21,0,4,4,0,1,1,0,3,3,0,-6,0,6,-2,0,2,0,-4,51,1,5,6,-19,0,2,-1,1,1,-1,4,1
KR_6700417887,420,2,38,12,5,4,5,1,3,5,2,1,3,2,-2,3,5,-1,0,1,0,3,-4,2,5,7,2,0,0,-1,1,1,1,5,1
KR_6769332823,420,3,31,11,11,3,5,2,-1,4,5,2,7,5,9,9,0,-2,1,3,0,9,-10,0,5,5,-2,1,3,1,1,1,1,4,1
KR_6766362870,420,1,42,-1,6,6,7,1,1,2,1,3,3,0,-1,1,2,-3,1,4,3,7,-10,-2,7,5,-1,0,0,-1,1,0,1,3,1
KR_6701117333,420,-1,-14,-9,-3,-3,0,3,0,5,5,0,4,4,-2,6,8,2,4,2,-1,3,-32,-2,6,4,-1,0,-1,-1,1,-1,1,2,1
KR_6722532562,420,1,29,-20,4,0,2,2,-3,3,6,3,3,0,3,6,3,1,2,1,0,4,4,-2,12,10,-2,0,1,1,1,1,1,3,1
KR_6715832508,420,0,22,-3,-7,1,2,1,-3,2,5,0,1,1,-6,2,8,1,2,1,0,-14,7,-6,9,3,1,0,1,1,-1,-1,-1,5,1
KR_6763472683,420,6,9,8,18,8,8,0,8,9,1,0,2,2,1,2,1,1,2,1,0,12,-21,0,8,8,-2,0,2,1,1,1,1,3,1
KR_6738495947,420,0,5,-8,7,-2,1,3,2,6,4,0,2,2,7,7,0,0,1,1,0,17,6,5,7,12,-4,0,0,1,1,0,1,5,1
KR_6764778537,420,3,23,23,11,1,2,1,3,3,0,1,2,1,7,8,1,-1,0,1,0,10,-1,3,4,7,-3,0,1,-1,1,1,1,1,1
KR_6754003399,420,-3,-51,-52,-2,0,2,2,1,7,6,1,1,0,-3,0,3,-1,0,1,0,0,-1,1,3,4,0,0,0,-1,-1,-1,1,4,1
KR_6704652117,420,4,25,40,8,-6,1,7,2,4,2,3,4,1,9,10,1,0,0,0,2,2,5,5,5,10,-1,0,0,1,-1,1,1,3,1
KR_6768714084,440,0,-2,-38,7,0,0,0,0,2,2,-3,0,3,5,6,1,5,6,1,0,8,18,6,3,9,-5,0,-1,1,-1,1,1,2,1
KR_6756433465,420,3,83,9,0,1,1,0,0,1,1,0,2,2,-2,1,3,1,1,0,0,1,3,0,5,5,7,0,1,-1,1,1,-1,4,1
KR_6765487968,420,0,1,-1,2,-1,1,2,1,2,1,3,5,2,-3,2,5,2,2,0,0,2,11,5,5,10,-1,0,1,1,-1,1,-1,6,1
KR_6721103957,420,0,-6,5,-1,2,4,2,-2,4,6,1,2,1,-1,1,2,-1,0,1,0,0,-8,-1,3,2,1,0,-2,-1,-1,-1,1,2,1
KR_6769906197,440,0,71,-8,3,4,5,1,-4,0,4,-2,0,2,8,9,1,-3,1,4,-1,5,-138,-1,6,5,1,0,1,-1,1,1,-1,4,1
KR_6744872095,420,-2,-30,-20,-5,0,3,3,-2,1,3,3,4,1,-6,0,6,0,0,0,-1,-10,-110,2,4,6,-11,0,0,0,-1,0,-1,0,1
KR_6767816245,420,0,21,-31,1,0,1,1,0,3,3,2,3,1,-1,1,2,0,2,2,0,5,-2,4,4,8,-1,0,0,-1,-1,-1,1,4,1
KR_6764718453,440,1,2,-10,5,1,3,2,0,2,2,5,7,2,-1,3,4,0,3,3,0,1,-40,0,2,2,21,0,2,1,0,1,1,2,1
KR_6763361048,420,-2,-13,-26,-1,0,1,1,0,3,3,-3,1,4,0,1,1,2,3,1,-1,4,10,0,7,7,2,0,0,1,-1,1,-1,4,1
KR_6768367804,420,-3,-44,-3,-2,0,1,1,-3,1,4,1,3,2,-2,1,3,2,2,0,0,-2,-16,-5,9,4,3,0,0,-1,-1,0,-1,5,1
KR_6668437642,420,4,78,-4,2,-1,1,2,5,6,1,1,4,3,-3,3,6,0,0,0,0,2,1,2,2,4,-1,0,1,-1,-1,-1,1,3,1
KR_6770243276,440,3,43,60,1,4,4,0,0,3,3,0,1,1,-2,5,7,-1,0,1,1,3,-16,2,3,5,2,0,1,1,1,1,1,2,1
KR_6742149150,420,2,38,16,5,-3,1,4,3,5,2,1,3,2,3,4,1,1,2,1,0,8,7,1,4,5,-4,0,1,1,1,1,1,2,1
KR_6768309921,440,-1,57,40,-5,-2,1,3,1,5,4,0,3,3,-4,0,4,0,1,1,0,-10,-37,0,3,3,8,0,1,-1,1,1,-1,3,1
KR_6719216573,420,4,40,23,1,2,5,3,1,2,1,-2,2,4,2,5,3,-2,1,3,0,6,-8,-4,6,2,-1,0,0,1,-1,-1,-1,3,1
KR_6615911461,420,2,34,40,4,5,6,1,0,3,3,0,2,2,-1,3,4,0,1,1,-1,-3,10,-2,7,5,-1,0,0,-1,1,1,-1,2,1
KR_6731226959,420,2,-13,-27,7,0,3,3,0,2,2,3,3,0,3,6,3,1,1,0,2,19,19,4,3,7,0,0,0,1,1,0,1,6,1
KR_6765795155,420,3,14,16,4,1,2,1,3,3,0,2,5,3,-1,1,2,-1,0,1,0,4,1,-3,7,4,7,0,0,-1,1,1,-1,6,1
KR_6650584856,420,2,54,21,-2,-1,1,2,0,3,3,-6,0,6,1,3,2,4,4,0,0,-3,2,0,7,7,8,0,1,-1,1,1,1,2,1
KR_6741650744,440,1,101,8,1,-2,2,4,3,4,1,0,3,3,-2,4,6,2,3,1,0,4,-4,-6,9,3,1,0,0,1,1,0,1,4,1
KR_6747073770,420,1,4,-7,3,5,9,4,-1,0,1,-2,1,3,1,3,2,0,1,1,-1,4,-364,-5,8,3,3,0,1,1,-1,1,-1,3,1
KR_6759651217,440,4,64,19,15,3,4,1,5,8,3,2,2,0,5,9,4,0,0,0,-1,8,5,9,0,9,0,0,0,1,-1,0,-1,5,1
KR_6653397856,420,-1,-50,1,-2,-1,2,3,-1,1,2,2,2,0,-3,0,3,1,2,1,0,-1,-6,-1,4,3,-3,0,0,1,-1,-1,-1,6,1
KR_6761432111,420,5,95,15,8,2,2,0,-1,1,2,1,3,2,6,10,4,0,0,0,0,5,-11,0,6,6,5,0,1,1,1,1,-1,3,1
KR_6705726039,420,-2,16,-43,-3,-2,0,2,2,3,1,-1,2,3,-3,0,3,1,1,0,0,-3,11,-2,6,4,-2,0,0,-1,-1,0,1,5,1
KR_6768076017,420,-5,-31,-22,-16,-4,0,4,-2,1,3,1,3,2,-8,1,9,-3,0,3,-2,-15,35,-8,10,2,0,0,-1,1,-1,-1,-1,1,1
KR_6664854388,420,0,-1,-8,4,1,1,0,2,3,1,-3,0,3,4,4,0,0,0,0,0,0,3,3,4,7,2,0,0,1,-1,0,1,3,1
KR_6763392420,420,1,9,-8,8,0,2,2,1,2,1,-3,0,3,7,8,1,3,3,0,1,13,5,0,3,3,-1,0,1,-1,1,1,1,2,1
KR_6693464507,420,3,13,0,5,2,2,0,-1,2,3,0,1,1,3,6,3,1,1,0,0,1,-6,-4,7,3,0,0,0,1,-1,0,1,1,1
KR_6731549681,420,-1,-12,1,2,-3,1,4,0,1,1,1,4,3,4,5,1,0,1,1,2,10,-8,-2,7,5,-4,0,0,1,-1,-1,1,5,1
KR_6727796235,420,4,-10,19,8,2,4,2,2,5,3,4,5,1,-2,1,3,2,3,1,-2,1,-1,0,6,6,4,0,1,1,1,1,-1,6,1
KR_6640896580,420,1,-16,-31,5,0,2,2,1,2,1,2,4,2,-1,2,3,3,6,3,0,8,2,1,5,6,-2,0,1,1,1,1,1,5,1
KR_6715136087,420,1,29,19,2,1,1,0,2,5,3,-1,2,3,0,1,1,0,1,1,0,-3,4,1,5,6,0,0,2,1,-1,1,1,1,1
KR_6710538655,420,3,62,43,2,8,10,2,0,4,4,0,3,3,-4,0,4,-2,0,2,0,-11,-7,-2,5,3,0,0,0,-1,1,1,1,1,1
KR_6754192381,420,4,-18,23,8,1,2,1,4,6,2,1,3,2,2,2,0,0,1,1,0,8,-2,-3,9,6,4,0,1,1,1,1,1,3,1
KR_6638311115,420,2,34,-4,6,0,1,1,3,3,0,0,4,4,3,4,1,0,1,1,0,12,7,4,4,8,-5,0,1,-1,1,1,1,6,1
KR_6763823420,420,6,100,16,13,3,3,0,4,4,0,-1,3,4,5,5,0,2,2,0,0,12,257,2,3,5,0,0,0,1,1,1,1,2,1
KR_6721996141,420,2,15,56,7,-1,3,4,-3,2,5,9,9,0,-1,2,3,3,4,1,-2,3,9,-1,3,2,3,0,2,1,1,1,-1,1,1
KR_6765509409,420,4,29,-23,8,3,3,0,0,1,1,5,5,0,1,2,1,-1,0,1,0,6,4,2,5,7,1,0,1,-1,1,1,-1,4,1
KR_6754035012,420,1,41,23,2,2,2,0,-1,3,4,3,6,3,-1,2,3,-1,1,2,0,-1,-110,-5,8,3,3,0,0,-1,1,0,1,6,1
KR_6767528291,420,-3,14,-25,-7,-4,0,4,-3,2,5,-1,3,4,-1,0,1,2,4,2,0,-1,0,3,4,7,0,0,0,1,-1,0,1,5,1
KR_6765531983,420,-1,-27,24,-8,-5,1,6,0,3,3,1,3,2,-2,1,3,-2,0,2,-2,-14,13,-1,10,9,-14,0,0,1,-1,0,-1,2,1
KR_6616851875,420,-4,30,-5,-2,-1,1,2,0,1,1,0,2,2,1,7,6,-2,0,2,0,1,-113,0,6,6,0,0,0,-1,0,0,1,5,1
KR_6751759693,420,0,-38,-12,7,-1,1,2,2,6,4,0,3,3,3,4,1,3,3,0,0,12,3,2,4,6,-6,0,-2,1,-1,-1,1,4,1
KR_6764163711,420,-1,16,20,-7,-3,0,3,1,3,2,-4,1,5,-1,2,3,0,1,1,-2,-8,3,3,5,8,-8,0,0,-1,-1,0,-1,5,1
KR_6746563446,420,-1,-12,16,1,1,5,4,0,2,2,-2,0,2,1,2,1,1,2,1,0,-13,22,-3,8,5,-5,0,1,1,1,1,1,1,1
KR_6711335198,420,0,15,0,4,0,1,1,-2,3,5,2,5,3,2,2,0,2,2,0,0,7,0,3,3,6,0,0,0,1,-1,0,1,4,1
KR_6761093432,420,6,53,-1,8,1,2,1,3,4,1,0,3,3,4,5,1,0,3,3,2,7,5,2,7,9,2,0,1,1,1,1,1,1,1
KR_6764449901,420,3,60,2,5,0,1,1,3,7,4,1,3,2,-1,4,5,2,2,0,0,6,-1,5,5,10,-1,0,1,1,1,1,1,6,1
KR_6767636449,440,3,46,-16,12,3,4,1,-4,1,5,7,8,1,5,7,2,1,1,0,2,6,-1,4,2,6,4,0,1,1,-1,1,1,3,1
KR_6706933200,420,1,40,10,3,4,4,0,-8,0,8,3,3,0,2,6,4,2,3,1,0,3,-2,1,3,4,1,0,1,1,1,1,-1,5,1
KR_6707024424,440,6,33,8,16,-1,1,2,6,6,0,0,4,4,7,7,0,4,4,0,0,12,7,2,4,6,1,0,0,1,1,1,-1,1,1
KR_6680159004,420,0,10,29,-1,-1,0,1,3,4,1,1,5,4,-3,0,3,-1,0,1,0,-7,-1,0,6,6,-4,0,1,-1,1,1,-1,5,1
KR_6769432571,420,6,23,31,7,1,3,2,4,6,2,1,2,1,1,5,4,0,0,0,0,11,19,2,5,7,-2,0,1,1,1,1,-1,6,1
KR_6765674983,420,0,39,5,-2,3,4,1,-2,1,3,-3,3,6,0,3,3,0,3,3,0,3,5,0,6,6,-1,0,1,-1,1,1,-1,6,1
KR_6759091346,440,-1,-63,-8,-1,1,3,2,-4,0,4,0,0,0,3,4,1,-1,3,4,0,4,7,0,3,3,-2,0,-2,1,-1,-1,1,1,1
KR_6760397684,420,2,-48,0,4,0,1,1,1,4,3,-2,0,2,1,4,3,4,5,1,0,5,-9,-3,12,9,4,0,0,1,-1,0,-1,6,1
KR_6766702656,420,2,14,16,11,3,5,2,-4,3,7,3,3,0,1,2,1,8,9,1,1,8,-15,3,4,7,4,0,1,-1,1,1,1,1,1
KR_6759482394,420,2,97,5,7,4,4,0,2,2,0,2,7,5,-3,0,3,2,3,1,0,6,-9,2,5,7,4,0,1,-1,1,1,1,6,1
KR_6739205506,420,-2,-17,-22,-3,5,5,0,-5,0,5,-3,2,5,1,6,5,-1,0,1,0,-3,2,1,2,3,-3,0,0,-1,1,1,1,4,1
KR_6699626970,420,1,30,-9,4,-5,0,5,7,10,3,2,2,0,0,2,2,0,0,0,0,7,52,1,5,6,-14,0,-1,1,-1,-1,1,3,1
KR_6763779278,420,2,70,-8,1,4,5,1,-2,0,2,-3,2,5,3,4,1,-1,0,1,0,-6,-21,3,4,7,-5,0,0,1,-1,1,1,1,1
KR_6688637646,420,2,53,13,1,3,4,1,4,5,1,-1,2,3,0,2,2,-5,1,6,0,-10,-29,3,5,8,6,0,0,1,1,-1,-1,2,1
KR_6755619962,420,0,31,1,2,0,0,0,1,4,3,3,4,1,-3,1,4,1,3,2,1,9,4,0,4,4,2,0,2,1,0,1,1,5,1
KR_6758926598,420,6,32,23,17,1,2,1,10,12,2,2,5,3,1,2,1,3,4,1,0,16,6,-1,7,6,-5,0,2,1,0,1,1,1,1
KR_6751007528,440,6,38,56,9,2,3,1,-2,3,5,-1,1,2,8,9,1,2,3,1,0,1,10,-2,4,2,1,0,2,1,1,1,-1,5,1
KR_6704395902,440,3,65,12,7,2,2,0,5,5,0,-1,1,2,-2,3,5,3,5,2,0,5,-86,-2,8,6,1,0,2,1,1,1,1,1,1
KR_6705720989,420,3,36,8,6,2,3,1,-4,2,6,4,6,2,4,5,1,0,0,0,0,4,-41,1,6,7,18,0,2,1,-1,1,-1,6,1
KR_6763620809,420,-2,18,-12,0,-2,1,3,0,3,3,1,2,1,-2,1,3,3,4,1,0,5,-2,3,6,9,0,0,0,-1,-1,0,-1,5,1
KR_6769838159,420,0,-30,11,7,0,2,2,6,7,1,2,3,1,-1,1,2,0,1,1,1,10,13,3,3,6,4,0,0,1,-1,0,1,2,1
KR_6767362077,420,0,51,16,2,-2,0,2,-6,1,7,0,3,3,9,10,1,1,1,0,0,0,-5,-1,5,4,3,0,0,1,-1,0,1,5,1
KR_6765595048,420,4,89,0,9,0,0,0,4,4,0,1,3,2,1,6,5,3,3,0,3,8,0,-2,8,6,7,0,0,0,1,0,1,0,1
KR_6745204988,440,1,-23,8,-5,-1,3,4,0,4,4,-3,1,4,2,3,1,-3,0,3,0,-2,-1,-7,10,3,-5,0,0,-1,1,0,-1,5,1
KR_6744297334,420,1,10,0,6,0,1,1,5,5,0,1,2,1,1,4,3,-1,1,2,0,9,33,1,7,8,3,0,0,1,1,1,-1,2,1
KR_6680625820,420,5,32,32,12,4,5,1,5,5,0,-1,0,1,5,7,2,-1,1,2,0,16,1,2,5,7,2,0,2,1,1,1,1,1,1
KR_6770397017,440,2,68,-11,3,1,1,0,-2,2,4,1,2,1,5,8,3,-2,0,2,0,6,2,-1,5,4,0,0,0,-1,-1,-1,1,5,1
KR_6765449510,420,1,14,1,4,-1,2,3,4,5,1,-2,1,3,3,5,2,0,0,0,0,7,159,4,5,9,1,0,-1,1,-1,-1,-1,3,1
KR_6727788965,420,3,41,20,7,4,7,3,-2,1,3,1,3,2,1,4,3,3,4,1,0,6,-17,2,3,5,2,0,0,-1,0,0,1,5,1
KR_6768877796,420,2,13,-10,4,-2,3,5,10,13,3,1,3,2,-5,1,6,0,1,1,-2,-5,-12,3,4,7,7,0,0,-1,1,-1,-1,2,1
KR_6769392414,420,1,-13,-3,6,3,4,1,0,3,3,-1,3,4,3,3,0,1,3,2,0,5,18,1,5,6,6,0,-1,1,-1,-1,1,4,1
KR_6734632511,420,6,39,2,10,1,2,1,1,4,3,1,2,1,2,6,4,5,5,0,1,9,144,-3,8,5,2,0,1,1,1,1,1,5,1
KR_6760858629,440,-5,-95,-8,-12,-3,1,4,0,4,4,-8,3,11,-3,3,6,2,4,2,-4,-22,-3,-2,4,2,-1,0,-1,-1,1,-1,-1,5,1
KR_6770291002,440,-5,-98,11,-1,2,4,2,-1,4,5,-2,0,2,2,6,4,-2,1,3,1,1,-15,-2,4,2,-2,0,-4,0,-1,-1,1,0,1
KR_6762768185,440,-3,13,2,-7,0,2,2,4,6,2,0,0,0,-3,0,3,-8,2,10,-2,-14,-2,-2,4,2,-2,0,0,1,-1,-1,-1,2,1
KR_6704480962,420,-2,-4,-17,-4,1,2,1,3,6,3,0,0,0,-6,0,6,-2,0,2,0,-11,-2,3,7,10,2,0,0,1,1,1,-1,1,1
KR_6752821364,420,2,63,28,9,1,2,1,3,3,0,2,2,0,3,5,2,0,0,0,0,9,4,5,3,8,0,0,2,1,1,1,1,3,1
KR_6769457659,440,-3,68,8,-7,3,4,1,-1,1,2,-2,1,3,-4,3,7,-3,2,5,0,-12,15,3,3,6,-5,0,1,-1,-1,1,1,5,1
KR_6770280208,420,7,75,49,14,5,7,2,3,4,1,3,6,3,2,3,1,1,1,0,0,8,9,-3,7,4,0,0,1,1,-1,1,1,3,1
KR_6724174875,420,0,-20,-44,3,1,2,1,0,3,3,1,5,4,2,3,1,-1,0,1,0,6,-3,-3,8,5,-2,0,0,-1,-1,-1,1,1,1
KR_6758470361,420,3,-1,16,5,0,3,3,3,6,3,0,2,2,0,2,2,2,4,2,0,4,9,3,3,6,0,0,1,1,-1,1,-1,4,1
KR_6742375439,420,3,48,12,4,4,7,3,3,5,2,-1,1,2,-2,3,5,0,0,0,1,8,7,3,6,9,0,0,2,1,1,1,-1,2,1
KR_6767735541,420,5,41,-4,13,-2,0,2,0,5,5,3,6,3,9,9,0,3,4,1,0,18,35,-2,6,4,4,0,2,1,1,1,1,4,1
KR_6638117117,420,1,-13,-7,6,-2,2,4,-1,1,2,6,7,1,3,3,0,0,1,1,0,12,8,-1,8,7,5,0,0,1,0,0,1,3,1
KR_6655959634,420,5,55,-5,15,7,8,1,5,6,1,2,2,0,1,2,1,0,2,2,0,20,0,0,7,7,2,0,0,1,0,1,1,1,1
KR_6764875210,420,5,62,30,2,3,3,0,-3,2,5,-1,1,2,2,3,1,1,1,0,0,-3,13,3,4,7,1,0,1,-1,-1,1,-1,2,1
KR_6763857349,420,3,55,29,7,1,2,1,0,8,8,0,2,2,4,6,2,2,3,1,-1,9,-5,-3,9,6,3,0,2,1,1,1,-1,2,1
KR_6732886055,440,-1,-57,9,-4,2,3,1,-1,1,2,-2,1,3,1,1,0,-4,1,5,0,0,13,2,5,7,-1,0,0,1,1,0,-1,5,1
KR_6769978973,420,-1,-50,-21,-1,1,3,2,0,3,3,-3,1,4,1,6,5,0,1,1,1,-6,3,2,5,7,-5,0,-2,-1,1,-1,1,2,1
KR_6661029249,420,3,45,-34,4,0,2,2,3,6,3,3,4,1,-1,2,3,-1,1,2,0,5,-7,3,4,7,4,0,0,1,-1,-1,-1,4,1
KR_6767948640,420,3,-11,52,7,-3,1,4,6,8,2,4,4,0,-2,2,4,2,2,0,2,8,10,-1,9,8,-4,0,0,1,-1,0,-1,2,1
KR_6760276112,420,1,10,5,-3,-2,0,2,-3,1,4,-4,1,5,2,6,4,4,5,1,1,6,7,-3,8,5,1,0,0,1,-1,1,1,4,1
KR_6687680624,420,4,53,21,10,-2,1,3,7,9,2,2,4,2,2,4,2,1,4,3,0,12,170,1,5,6,3,0,1,-1,1,1,-1,6,1
KR_6760667944,420,3,1,20,4,-2,1,3,2,4,2,0,3,3,2,2,0,2,4,2,1,3,4,-2,8,6,2,0,0,1,1,1,1,6,1
KR_6747522453,420,-1,17,8,-5,2,3,1,4,4,0,-6,1,7,-3,2,5,-2,0,2,0,-4,117,-1,7,6,-2,0,1,0,1,1,1,0,1
KR_6671928857,420,-2,6,6,-3,-4,1,5,2,6,4,-3,1,4,3,4,1,-1,0,1,0,-6,-17,3,2,5,-6,0,0,0,-1,1,1,0,1
KR_6765361070,420,-3,6,-8,0,-2,1,3,0,2,2,1,4,3,1,4,3,0,1,1,0,2,5,2,3,5,-5,0,0,1,-1,1,-1,3,1
KR_6769551764,420,3,63,16,7,2,2,0,-1,2,3,4,4,0,1,4,3,1,2,1,0,3,2,-2,6,4,2,0,2,1,1,1,-1,4,1
KR_6762932345,440,4,11,37,7,9,9,0,1,3,2,1,5,4,-1,1,2,-3,1,4,1,-5,-111,-2,4,2,-4,0,2,-1,1,1,1,6,1
KR_6753328091,420,4,67,24,8,1,3,2,4,5,1,4,5,1,-1,4,5,0,0,0,0,6,-3,4,1,5,0,0,2,1,1,1,1,6,1
KR_6652372142,420,4,83,-1,2,0,1,1,1,3,2,-1,1,2,1,1,0,1,1,0,0,1,-5,-3,8,5,4,0,1,1,-1,1,-1,2,1
KR_6683512842,420,2,-16,15,5,0,0,0,1,4,3,3,4,1,1,4,3,0,1,1,0,9,4,1,4,5,3,0,1,1,1,1,1,4,1
KR_6768747799,420,3,115,15,8,3,3,0,1,3,2,2,3,1,1,2,1,1,1,0,0,5,-18,2,6,8,1,0,1,-1,-1,1,-1,2,1
KR_6758116789,420,3,-4,19,7,3,5,2,-1,2,3,4,6,2,1,2,1,0,0,0,0,4,126,2,4,6,-2,0,1,1,0,1,1,3,1
KR_6765652131,420,5,51,16,11,3,3,0,-1,1,2,2,2,0,7,8,1,0,0,0,0,7,9,0,5,5,4,0,0,1,1,1,1,3,1
KR_6667816108,420,5,76,31,8,2,2,0,3,5,2,0,1,1,4,5,1,-1,0,1,0,13,-6,2,4,6,0,0,0,1,-1,0,1,5,1
KR_6769271175,420,-3,23,5,3,-1,1,2,1,1,0,-2,1,3,3,4,1,2,3,1,0,8,-4,1,5,6,1,0,0,1,-1,1,1,2,1
KR_6718282519,420,0,-46,-44,2,0,0,0,3,3,0,-1,1,2,-1,1,2,1,1,0,-2,1,-27,0,4,4,0,0,1,1,1,1,-1,2,1
KR_6765928760,420,3,47,2,8,9,9,0,1,3,2,0,3,3,-1,3,4,-1,0,1,0,12,-3,-5,10,5,0,0,2,-1,1,1,1,6,1
KR_6769102076,420,-2,53,-2,-3,2,2,0,-3,1,4,1,4,3,-3,0,3,0,0,0,0,-8,-5,-6,10,4,6,0,0,1,1,0,1,2,1
KR_6763724837,420,-1,43,-18,-4,1,3,2,-1,2,3,0,0,0,-1,0,1,-3,0,3,-1,-5,32,-7,11,4,-33,0,3,-1,1,1,-1,2,1
KR_6750090851,440,-1,20,-16,0,4,7,3,2,6,4,0,2,2,-7,1,8,1,1,0,-1,-3,-18,-2,4,2,8,0,-1,1,-1,-1,-1,1,1
KR_6719408637,420,3,31,8,6,3,3,0,3,4,1,1,3,2,0,2,2,-1,1,2,0,5,-14,1,4,5,1,0,1,1,1,1,-1,2,1
KR_6767905768,420,1,32,-13,1,1,3,2,1,6,5,0,2,2,2,6,4,-3,0,3,4,10,-4,0,8,8,-1,0,2,1,1,1,1,4,1
KR_6755679303,420,1,26,38,-1,4,4,0,-2,1,3,2,4,2,-4,1,5,-1,1,2,2,0,3,4,3,7,-1,0,0,-1,-1,1,1,1,1
KR_6766876391,420,2,69,9,7,1,1,0,1,1,0,-4,0,4,8,9,1,1,2,1,0,12,-57,0,6,6,2,0,0,1,-1,-1,1,4,1
KR_6761016774,420,3,73,1,6,4,7,3,-1,0,1,1,1,0,3,6,3,-1,0,1,1,1,17,0,4,4,3,0,1,1,1,1,1,5,1
KR_6764146039,420,2,50,-12,15,0,0,0,2,5,3,7,7,0,4,4,0,2,3,1,0,22,12,4,1,5,0,0,3,1,1,1,-1,5,1
KR_6769388663,420,4,47,0,9,2,3,1,2,3,1,2,2,0,2,7,5,1,2,1,0,6,-1,2,5,7,1,0,0,1,-1,0,1,4,1
KR_6742391777,420,3,18,-7,0,-2,0,2,1,4,3,0,2,2,-1,2,3,2,3,1,0,3,112,-2,8,6,1,0,1,-1,-1,1,1,6,1
KR_6769558686,420,8,78,24,13,6,7,1,3,6,3,2,2,0,1,4,3,1,2,1,0,4,-3,0,5,5,1,0,1,1,1,1,1,6,1
KR_6764419195,420,3,11,8,7,3,4,1,-1,2,3,5,6,1,2,7,5,-2,0,2,2,17,-16,1,3,4,1,0,1,1,-1,-1,1,3,1
KR_6754211932,420,2,-26,15,4,4,4,0,3,3,0,1,2,1,-3,4,7,-1,0,1,0,-1,-10,-1,5,4,2,0,-1,-1,1,-1,1,2,1
KR_6752165674,420,5,61,37,10,3,4,1,1,2,1,1,3,2,4,7,3,1,1,0,2,11,1,-2,6,4,-2,0,1,1,1,1,1,6,1
KR_6760901533,420,0,13,29,1,4,4,0,-1,1,2,2,3,1,-2,3,5,-2,0,2,0,-4,2,-2,5,3,3,0,1,1,1,1,1,6,1
KR_6736658175,420,2,15,4,8,1,6,5,3,4,1,2,5,3,3,6,3,-1,0,1,1,3,-9,4,3,7,1,0,4,-1,1,1,1,6,1
KR_6749139055,420,0,74,4,-4,0,2,2,0,3,3,-3,2,5,1,6,5,-2,0,2,0,-4,13,-1,7,6,0,0,0,1,-1,-1,-1,5,1
KR_6760132804,420,3,-8,-1,6,0,2,2,4,5,1,0,2,2,2,3,1,0,0,0,0,8,-3,0,8,8,0,0,1,1,1,1,1,1,1
KR_6733484824,420,3,-11,16,11,1,4,3,4,4,0,-2,1,3,0,3,3,8,8,0,0,13,124,-5,11,6,4,0,0,1,-1,0,-1,5,1
KR_6728953210,420,0,-60,-21,-1,-2,0,2,-1,2,3,0,1,1,0,1,1,2,2,0,0,0,79,2,5,7,3,0,-2,1,-1,-1,1,6,1
KR_6743826970,420,1,-15,-7,6,-1,1,2,2,4,2,2,6,4,5,5,0,-2,0,2,0,14,22,-2,9,7,3,0,1,1,1,1,-1,6,1
KR_6765603122,420,3,26,22,10,2,3,1,5,7,2,-1,2,3,5,8,3,-1,2,3,0,11,48,-2,9,7,-14,0,2,-1,1,1,-1,6,1
KR_6730577019,420,-1,-47,28,-1,-4,1,5,1,3,2,0,1,1,2,3,1,0,0,0,0,0,-3,-1,5,4,4,0,0,1,-1,-1,-1,1,1
KR_6748385329,420,1,25,40,0,3,4,1,0,3,3,1,5,4,-5,1,6,1,1,0,0,-7,-3,2,2,4,0,0,1,-1,1,1,-1,5,1
KR_6709144782,420,0,-36,-33,5,-1,0,1,3,4,1,0,3,3,0,2,2,3,4,1,0,8,-156,-1,5,4,37,0,0,-1,-1,0,-1,4,1
KR_6752781384,440,0,2,25,-1,0,0,0,0,4,4,0,1,1,0,0,0,-1,0,1,0,-2,2,1,6,7,2,0,0,-1,1,1,-1,3,1
KR_6766974093,420,3,18,1,10,-1,2,3,4,6,2,3,4,1,5,5,0,-1,0,1,0,10,7,6,1,7,2,0,1,1,1,1,1,6,1
KR_6768265008,420,3,28,8,5,0,1,1,-3,3,6,3,3,0,2,4,2,3,4,1,0,1,-7,-2,9,7,0,0,1,0,1,1,1,0,1
KR_6460934556,420,-2,10,-15,-8,-1,1,2,-4,5,9,-2,0,2,-1,3,4,0,0,0,-1,-8,0,0,4,4,0,0,0,1,-1,0,-1,6,1
KR_6762575107,420,7,118,-12,10,4,4,0,-1,4,5,0,2,2,7,8,1,0,2,2,0,20,-18,2,4,6,5,0,1,1,-1,1,-1,6,1
KR_6705776972,420,2,27,7,5,-5,0,5,0,2,2,4,6,2,7,7,0,-1,2,3,1,7,3,2,2,4,1,0,0,1,-1,1,1,3,1
KR_6753590652,420,1,-17,19,2,-5,0,5,1,7,6,5,6,1,1,4,3,0,1,1,0,2,-5,2,4,6,2,0,-1,1,-1,-1,1,3,1
KR_6769187853,420,1,64,9,3,1,2,1,0,2,2,0,4,4,1,4,3,1,1,0,0,4,46,3,5,8,4,0,2,1,1,1,-1,4,1
KR_6764756861,420,-1,-16,8,1,1,2,1,-2,1,3,0,2,2,1,4,3,1,2,1,1,3,1,-1,6,5,2,0,0,1,-1,0,1,4,1
KR_6770285461,440,3,44,28,6,1,1,0,1,2,1,1,1,0,1,1,0,2,2,0,0,5,2,1,6,7,6,0,0,1,-1,0,1,5,1
KR_6710284494,420,-1,-29,-7,-3,-2,2,4,2,2,0,-4,3,7,2,2,0,-1,0,1,0,3,11,1,5,6,-3,0,-1,-1,-1,-1,1,2,1
KR_6668461228,420,5,85,33,15,4,4,0,7,8,1,-1,1,2,2,2,0,3,4,1,0,20,-11,-1,6,5,0,0,2,0,1,1,1,0,1
KR_6665064195,440,2,11,12,6,7,7,0,-2,3,5,1,3,2,-2,0,2,2,3,1,0,-4,3,4,3,7,-6,0,0,-1,1,1,-1,6,1
KR_6692002263,420,0,107,-16,4,7,10,3,-11,0,11,2,3,1,6,7,1,0,0,0,-2,-3,10,4,4,8,1,0,0,-1,0,1,-1,3,1
KR_6766139544,420,2,29,-20,5,0,2,2,-2,1,3,2,4,2,6,6,0,-1,0,1,1,2,-6,1,4,5,1,0,1,0,1,1,1,0,1
KR_6666686516,420,1,58,11,3,0,1,1,-2,5,7,2,4,2,2,3,1,1,2,1,0,9,45,1,7,8,-8,0,1,1,-1,1,1,6,1
KR_6739783154,420,6,76,0,9,2,2,0,5,8,3,0,2,2,0,3,3,2,2,0,0,12,-3,1,4,5,1,0,0,-1,1,1,-1,3,1
KR_6748440833,420,3,2,5,3,1,1,0,2,3,1,2,4,2,-4,1,5,2,2,0,0,-6,2,2,9,11,5,0,1,-1,1,1,1,3,1
KR_6707932643,420,2,11,-7,11,3,5,2,6,6,0,3,7,4,-2,3,5,1,1,0,0,12,-141,1,4,5,13,0,0,-1,1,1,1,3,1
KR_6769870864,440,3,10,12,4,-3,0,3,0,1,1,4,6,2,3,5,2,0,0,0,0,2,22,1,1,2,1,0,1,1,1,1,-1,4,1
KR_6744189099,420,0,64,40,1,-2,1,3,1,2,1,0,3,3,1,2,1,1,1,0,0,2,-20,-2,6,4,-2,0,0,1,1,0,-1,4,1
KR_6768007651,420,0,7,12,4,3,3,0,-1,3,4,6,6,0,-3,2,5,-1,0,1,0,-2,-19,5,2,7,24,0,0,1,1,0,-1,5,1
KR_6744724718,420,-2,36,-4,-2,0,3,3,-2,2,4,1,5,4,-2,1,3,1,1,0,0,-7,-36,-2,5,3,-1,0,1,1,0,1,1,6,1
KR_6769591811,420,3,39,8,5,4,4,0,1,6,5,3,3,0,-3,1,4,0,0,0,0,4,-22,1,4,5,-4,0,-1,1,-1,-1,-1,5,1
KR_6693890149,420,5,103,13,15,5,5,0,4,6,2,2,2,0,4,5,1,0,0,0,0,16,-7,4,2,6,0,0,2,1,1,1,1,6,1
KR_6695942977,420,3,32,27,8,9,10,1,2,3,1,-1,2,3,-2,3,5,0,2,2,-1,0,277,-3,7,4,3,0,1,-1,1,1,-1,3,1
KR_6627118769,420,3,41,22,0,0,2,2,2,5,3,2,3,1,-1,1,2,-3,0,3,0,0,-11,-3,7,4,4,0,0,1,-1,-1,-1,2,1
KR_6766738569,420,0,15,-8,6,3,6,3,0,1,1,1,1,0,3,3,0,-1,0,1,0,3,-3,1,1,2,-5,0,2,-1,1,1,1,3,1
KR_6743317617,420,-1,-46,0,-3,0,2,2,-1,0,1,0,2,2,-2,4,6,0,1,1,0,-1,-41,3,2,5,29,0,-1,-1,-1,-1,-1,6,1
KR_6742421510,420,-3,-48,11,-11,-5,0,5,1,4,3,1,3,2,-5,3,8,-3,0,3,0,-11,-6,-4,10,6,-5,0,-2,-1,1,-1,-1,2,1
KR_6768835804,420,4,14,-1,3,2,2,0,2,3,1,3,4,1,-5,1,6,1,2,1,0,5,-3,-4,6,2,2,0,-1,-1,1,-1,-1,4,1
KR_6628462074,420,3,44,1,2,1,1,0,0,2,2,1,3,2,1,5,4,-1,2,3,0,-4,30,-1,8,7,0,0,1,-1,1,1,1,6,1
KR_6767328280,420,2,12,-6,2,-2,0,2,2,2,0,0,3,3,2,3,1,0,1,1,0,2,-4,2,5,7,2,0,0,1,-1,0,-1,2,1
KR_6748965910,420,-3,-3,-4,-3,-3,0,3,-1,1,2,1,3,2,-2,2,4,2,2,0,0,-1,-41,-3,5,2,2,0,-1,1,1,-1,-1,3,1
KR_6747610263,420,4,57,9,5,-1,1,2,3,7,4,-1,2,3,3,4,1,1,1,0,0,5,3,-2,7,5,5,0,1,1,-1,1,1,2,1
KR_6715910608,420,4,57,9,6,0,2,2,1,2,1,5,5,0,0,0,0,0,0,0,0,2,-1,0,4,4,3,0,0,1,1,1,1,5,1
KR_6745130511,420,1,13,5,5,-1,2,3,6,9,3,0,1,1,1,1,0,-1,1,2,0,6,44,1,7,8,-2,0,0,-1,-1,-1,-1,5,1
KR_6762319068,420,8,-33,-6,14,-1,0,1,-2,1,3,2,6,4,13,13,0,2,3,1,0,13,-108,5,1,6,-3,0,2,1,0,1,-1,6,1
KR_6763308376,420,5,60,-8,19,0,1,1,0,0,0,13,15,2,6,6,0,0,1,1,0,18,30,0,3,3,1,0,1,1,1,1,1,4,1
KR_6760636017,440,0,-7,-28,5,-1,1,2,-1,3,4,2,4,2,5,6,1,0,1,1,0,10,8,2,1,3,2,0,0,-1,1,0,-1,5,1
KR_6710606172,420,4,-8,-16,14,4,4,0,5,6,1,1,3,2,1,3,2,3,3,0,0,18,8,6,2,8,-4,0,0,-1,1,0,1,1,1
KR_6758788846,420,3,39,24,9,2,2,0,4,5,1,0,4,4,3,4,1,0,2,2,0,7,2,3,3,6,-1,0,1,1,1,1,-1,6,1
KR_6764189298,420,-2,-9,9,-1,1,3,2,1,4,3,-4,1,5,-2,2,4,3,5,2,0,-1,16,1,4,5,-1,0,0,1,1,1,1,4,1
KR_6743052144,420,5,109,33,6,6,6,0,5,5,0,-2,2,4,-5,4,9,2,2,0,3,9,17,2,7,9,-8,0,2,-1,1,1,1,1,1
KR_6750430386,420,5,63,23,9,4,5,1,1,2,1,-2,2,4,2,4,2,4,4,0,0,0,-5,-1,8,7,3,0,0,-1,1,1,1,6,1
KR_6709768255,420,-1,63,-41,5,0,3,3,0,6,6,1,2,1,0,2,2,4,5,1,0,-3,7,9,1,10,-5,0,2,1,-1,1,-1,6,1
KR_6766441686,420,-3,22,-9,-3,3,6,3,-1,3,4,-3,0,3,-2,2,4,0,0,0,-3,-17,8,5,2,7,-3,0,0,0,0,-1,-1,0,1
KR_6767938191,420,2,24,-7,8,4,5,1,4,9,5,-2,1,3,1,3,2,1,2,1,0,6,14,5,4,9,-1,0,2,-1,1,1,-1,3,1
KR_6760220437,420,3,45,16,2,2,2,0,0,4,4,2,4,2,-2,0,2,0,0,0,0,-3,-2,-3,10,7,3,0,1,1,1,1,-1,4,1
KR_6731982164,420,0,31,1,5,-1,1,2,-5,2,7,1,2,1,9,10,1,1,2,1,2,12,26,0,6,6,5,0,0,1,-1,0,1,5,1
KR_6761814180,420,1,39,-3,1,2,3,1,-2,1,3,1,2,1,2,6,4,-2,1,3,-1,-7,2,5,4,9,4,0,2,1,1,1,-1,4,1
KR_6761769192,420,1,-16,16,-3,-1,1,2,-1,1,2,-3,1,4,3,4,1,-1,0,1,0,-1,-2,-4,7,3,-6,0,1,-1,-1,1,-1,6,1
KR_6732580575,440,0,-3,7,3,0,0,0,1,4,3,4,5,1,-1,1,2,-1,1,2,-1,-1,6,4,4,8,-5,0,0,-1,1,1,-1,2,1
KR_6760195195,420,0,-77,4,1,-4,1,5,-6,0,6,9,9,0,-1,5,6,3,4,1,2,0,24,5,6,11,0,0,0,1,-1,-1,1,3,1
KR_6631829108,420,2,-18,2,1,5,5,0,-2,0,2,4,7,3,-6,0,6,0,1,1,0,-1,-2,-3,7,4,-2,0,2,1,-1,-1,1,4,1
KR_6769835870,420,3,61,-12,10,-1,1,2,2,5,3,-2,0,2,10,12,2,1,3,2,0,21,2,-1,5,4,2,0,0,-1,-1,1,-1,4,1
KR_6661095592,420,4,-6,30,5,0,2,2,3,3,0,-4,1,5,5,5,0,1,1,0,0,6,0,-1,6,5,2,0,1,1,1,1,-1,6,1
KR_6768288898,420,-3,8,34,-3,-2,0,2,-1,2,3,-1,0,1,0,0,0,1,2,1,0,-3,-14,-1,5,4,-1,0,0,1,1,1,-1,5,1
KR_6729723553,420,4,33,16,7,4,4,0,3,5,2,3,3,0,-3,0,3,0,0,0,0,3,31,4,2,6,-3,0,1,-1,1,1,1,4,1
KR_6726715931,420,5,0,16,11,2,3,1,2,3,1,5,8,3,3,4,1,-1,0,1,0,11,4,3,5,8,2,0,1,1,1,1,1,3,1
KR_6747564944,420,-3,9,-10,-8,1,2,1,-2,1,3,-1,2,3,-4,1,5,-2,1,3,-1,-15,-4,4,4,8,-8,0,-2,1,1,-1,-1,1,1
KR_6693127936,420,2,91,-3,9,-1,0,1,8,8,0,-4,2,6,5,9,4,1,1,0,0,9,-2,2,3,5,0,0,1,1,1,1,-1,4,1
KR_6769880971,420,0,31,-13,1,-3,0,3,2,5,3,4,4,0,-3,1,4,1,2,1,-1,3,-11,-2,6,4,10,0,0,-1,-1,-1,-1,3,1
KR_6745091037,420,4,46,-1,7,0,2,2,3,4,1,2,2,0,1,4,3,1,1,0,0,5,-8,-3,7,4,7,0,1,1,1,1,1,4,1
KR_6761865811,420,2,-76,16,2,0,2,2,4,4,0,-1,2,3,-3,1,4,2,2,0,0,4,-5,6,4,10,-1,0,-2,1,1,-1,1,1,1
KR_6763077229,420,-1,-31,0,-4,-3,0,3,0,3,3,0,0,0,-2,2,4,1,3,2,0,-1,-2,-4,9,5,1,0,0,-1,1,0,1,3,1
KR_6762787939,440,-1,-40,5,-1,-1,1,2,-1,4,5,-4,2,6,2,4,2,3,4,1,-1,7,5,7,2,9,-2,0,0,1,-1,-1,-1,6,1
KR_6748964541,420,-6,-28,-28,-12,-1,1,2,-3,2,5,-6,0,6,-2,2,4,0,1,1,0,-12,-24,-2,7,5,-1,0,0,1,-1,-1,1,5,1
KR_6753755424,420,1,-17,-14,-1,1,2,1,-1,1,2,1,3,2,-1,2,3,-1,0,1,0,-9,6,5,4,9,-2,0,0,-1,1,0,-1,1,1
KR_6760050728,420,1,27,-11,5,5,5,0,5,6,1,1,7,6,-4,0,4,-2,0,2,0,6,-32,-3,6,3,3,0,1,0,1,1,1,0,1
KR_6766376866,440,1,-10,5,6,3,4,1,-2,1,3,2,3,1,2,4,2,1,3,2,0,5,-44,0,4,4,14,0,0,1,-1,0,-1,6,1
KR_6745499389,420,5,9,16,7,1,1,0,2,4,2,4,6,2,-4,0,4,4,4,0,0,18,14,-2,7,5,4,0,0,-1,-1,0,-1,6,1
KR_6758496854,420,4,47,10,5,1,3,2,2,4,2,-4,4,8,3,6,3,3,3,0,0,-4,15,-6,8,2,1,0,3,1,-1,1,1,1,1
KR_6766520603,420,1,0,4,3,3,4,1,4,7,3,-3,0,3,-2,6,8,1,1,0,-1,1,3,3,2,5,-1,0,0,1,1,0,-1,1,1
KR_6739130577,440,1,79,4,5,3,6,3,4,5,1,0,2,2,-1,0,1,-1,0,1,0,0,-29,-1,3,2,1,0,3,1,1,1,1,2,1
KR_6763030944,440,3,111,-25,5,0,8,8,1,2,1,-6,1,7,-1,2,3,11,15,4,0,6,-14,1,2,3,3,0,2,0,1,1,1,0,1
KR_6747364310,420,3,17,12,5,-3,1,4,-3,2,5,5,5,0,4,8,4,2,2,0,0,3,-13,-1,9,8,1,0,0,1,-1,0,1,6,1
KR_6760471601,420,0,-37,-8,7,1,1,0,2,3,1,1,3,2,2,4,2,1,2,1,0,14,-8,6,1,7,1,0,-1,1,1,-1,1,5,1
KR_6760199078,420,0,45,-5,6,-1,0,1,-1,2,3,6,8,2,4,5,1,-2,1,3,2,3,6,-8,9,1,1,0,0,1,1,0,1,5,1
KR_6712157856,420,4,45,-8,7,1,1,0,2,5,3,1,2,1,3,5,2,0,2,2,0,10,-3,2,5,7,1,0,1,1,-1,1,1,3,1
KR_6696638452,420,2,-52,11,2,-1,1,2,-2,3,5,1,3,2,0,2,2,4,4,0,0,7,-71,-1,7,6,21,0,1,-1,-1,1,1,4,1
KR_6769619298,420,-3,-62,-10,-6,-2,0,2,2,2,0,-3,1,4,3,5,2,-6,1,7,0,-5,-43,1,5,6,14,0,0,0,1,-1,-1,0,1
KR_6758845836,420,4,31,48,7,-1,1,2,4,8,4,4,5,1,-1,1,2,1,1,0,0,9,-4,1,4,5,4,0,0,-1,1,1,-1,1,1
KR_6746819692,420,-4,-26,-16,0,4,5,1,-2,1,3,-4,3,7,2,3,1,0,0,0,0,-5,2,3,3,6,-7,0,1,1,-1,1,1,1,1
KR_6566642701,420,9,111,47,11,2,3,1,-2,1,3,6,6,0,6,9,3,-1,0,1,-1,0,-24,-3,7,4,0,0,2,1,1,1,-1,3,1
KR_6685497501,420,-1,7,8,0,2,5,3,-2,2,4,1,3,2,0,3,3,-1,1,2,-1,-2,5,1,5,6,-1,0,0,1,1,1,-1,5,1
KR_6617874448,420,2,81,7,10,3,3,0,4,6,2,0,2,2,2,4,2,1,3,2,0,4,30,4,6,10,0,0,1,1,-1,1,1,4,1
KR_6732670690,440,-1,32,-9,0,-3,0,3,3,5,2,3,3,0,-5,3,8,2,2,0,0,2,-11,-3,6,3,3,0,1,-1,1,1,-1,5,1
KR_6768266997,420,5,115,28,6,2,3,1,6,6,0,-1,1,2,-1,2,3,0,2,2,-1,-3,59,3,4,7,-21,0,4,1,-1,1,-1,5,1
KR_6754044684,420,-1,17,-14,2,6,7,1,1,2,1,1,1,0,-5,1,6,-1,0,1,0,-2,-4,-3,7,4,-1,0,0,-1,1,-1,-1,6,1
KR_6668564672,420,-2,27,-23,2,-3,2,5,0,1,1,2,2,0,3,3,0,0,0,0,0,5,2,-1,5,4,-1,0,1,1,-1,1,-1,1,1
KR_6675756433,420,5,43,69,3,-1,1,2,3,5,2,2,4,2,2,2,0,-3,2,5,0,6,15,1,4,5,6,0,0,1,-1,-1,-1,1,1
KR_6765393831,420,4,115,25,13,3,3,0,3,6,3,3,5,2,3,3,0,1,2,1,0,10,10,4,3,7,4,0,2,1,1,1,1,4,1
KR_6737532013,420,1,-13,68,6,1,3,2,0,4,4,2,5,3,3,4,1,0,1,1,1,1,5,6,2,8,-4,0,0,1,1,-1,1,6,1
KR_6737368532,420,-1,19,-2,-3,-5,1,6,0,0,0,2,3,1,0,1,1,0,1,1,-1,-1,0,3,2,5,1,0,0,1,-1,0,-1,2,1
KR_6732744097,440,2,3,1,2,7,7,0,4,4,0,1,1,0,-4,1,5,-6,1,7,0,10,177,-4,8,4,-1,0,1,1,-1,1,-1,4,1
KR_6770356873,440,4,-23,0,7,1,2,1,5,6,1,-1,1,2,2,3,1,0,3,3,0,8,-11,-1,5,4,-1,0,0,1,1,0,1,3,1
KR_6728797811,440,-1,-6,16,4,3,4,1,1,2,1,0,3,3,0,3,3,0,0,0,0,2,4,1,5,6,1,0,1,-1,1,1,1,1,1
KR_6760389744,420,3,18,2,4,1,4,3,3,4,1,-2,1,3,2,3,1,0,0,0,0,2,4,-2,7,5,1,0,0,1,1,1,1,3,1
KR_6760929267,420,2,16,2,14,5,6,1,0,3,3,4,4,0,3,4,1,2,2,0,0,14,45,-2,8,6,-21,0,1,1,1,1,-1,2,1
KR_6710437839,420,0,-52,39,3,0,3,3,6,6,0,-3,2,5,3,3,0,-3,1,4,2,14,-30,-5,10,5,4,0,0,1,1,0,1,3,1
KR_6704440543,420,2,-26,-5,4,3,4,1,7,7,0,3,4,1,-5,1,6,-4,3,7,1,1,26,6,3,9,1,0,-1,1,1,-1,1,6,1
KR_6768212984,420,3,49,17,9,1,1,0,1,2,1,2,5,3,5,8,3,0,0,0,0,6,-8,-7,10,3,-1,0,2,1,1,1,1,1,1
KR_6753932560,440,2,19,9,3,2,3,1,3,4,1,-4,0,4,1,2,1,1,2,1,1,-1,10,-1,7,6,-5,0,0,-1,1,0,1,2,1
KR_6755758984,420,4,37,5,17,4,4,0,6,7,1,3,4,1,3,3,0,1,1,0,0,23,7,3,5,8,-2,0,2,0,1,1,1,0,1
KR_6741544954,420,1,-10,-18,9,2,3,1,3,5,2,0,3,3,4,6,2,0,0,0,0,11,2,1,8,9,5,0,0,-1,1,1,-1,2,1
KR_6762777675,420,1,1,20,4,3,3,0,3,3,0,1,3,2,-2,2,4,-1,0,1,0,5,-8,-4,8,4,8,0,-2,-1,-1,-1,1,4,1
KR_6768225843,440,0,-15,15,-4,-4,0,4,0,4,4,0,3,3,2,3,1,-2,1,3,0,-3,1,2,2,4,-2,0,1,0,1,1,-1,0,1
KR_6762703016,420,2,9,0,9,2,5,3,1,1,0,0,3,3,3,4,1,3,4,1,0,7,0,-1,2,1,-2,0,1,1,1,1,1,1,1
KR_6700058893,420,1,15,11,6,1,3,2,-2,2,4,4,5,1,4,6,2,-1,1,2,1,10,3,5,5,10,-2,0,0,1,1,0,1,5,1
KR_6712026904,420,2,28,18,9,3,3,0,1,4,3,1,3,2,3,4,1,1,2,1,3,9,8,-1,5,4,0,0,0,1,-1,1,1,4,1
KR_6742880238,420,2,4,38,-2,0,2,2,1,2,1,2,4,2,-2,4,6,-3,1,4,0,-11,-14,0,4,4,-1,0,2,1,1,1,-1,3,1
KR_6761807333,420,5,41,26,7,-2,1,3,2,5,3,6,6,0,1,5,4,0,2,2,0,12,-3,-2,5,3,1,0,0,1,-1,-1,-1,3,1
KR_6727327517,420,4,-11,23,12,2,4,2,4,5,1,3,3,0,3,3,0,0,0,0,0,17,-5,-1,6,5,1,0,0,-1,-1,0,1,4,1
KR_6678909378,420,-3,-28,-4,-10,-6,0,6,-2,0,2,0,2,2,-3,2,5,1,2,1,0,-7,15,7,1,8,-1,0,1,-1,1,1,-1,6,1
KR_6761337232,420,2,-25,-8,6,1,2,1,2,3,1,1,1,0,2,3,1,0,1,1,0,5,3,-2,7,5,-6,0,0,1,-1,-1,-1,5,1
KR_6716576438,440,0,13,-44,11,2,5,3,3,3,0,-1,2,3,2,3,1,5,5,0,0,17,41,2,2,4,-6,0,2,-1,1,1,-1,3,1
KR_6742991010,420,-1,6,9,6,-1,1,2,0,1,1,-2,3,5,8,8,0,1,1,0,1,16,3,6,2,8,0,0,0,1,-1,1,1,2,1
KR_6768349451,420,7,77,11,23,5,5,0,4,4,0,3,4,1,9,9,0,2,2,0,0,21,11,3,3,6,-2,0,2,1,1,1,1,1,1
KR_6664147659,420,1,73,8,4,0,2,2,2,5,3,0,1,1,-1,4,5,3,3,0,1,8,8,0,7,7,2,0,0,0,1,1,-1,0,1
KR_6763578119,420,4,19,-1,7,-4,1,5,2,5,3,3,4,1,4,6,2,2,3,1,0,13,7,4,3,7,-3,0,0,1,-1,1,1,3,1
KR_6769149712,420,4,89,-4,10,1,1,0,3,3,0,4,4,0,2,3,1,0,2,2,0,10,4,2,3,5,-1,0,1,1,-1,1,-1,6,1
KR_6742420772,420,2,20,27,9,3,3,0,3,4,1,-1,1,2,4,6,2,0,1,1,0,12,-19,-1,4,3,-3,0,1,1,-1,1,1,3,1
KR_6764258169,420,2,54,3,-3,1,1,0,-1,0,1,-3,2,5,2,5,3,-2,2,4,0,-7,9,4,2,6,-4,0,1,-1,-1,-1,-1,2,1
KR_6765568434,420,-1,51,-20,-2,5,5,0,-2,2,4,-1,1,2,-2,4,6,-2,1,3,0,-14,-14,2,7,9,-5,0,2,-1,-1,1,1,3,1
KR_6728790671,420,1,-26,4,4,4,7,3,-1,4,5,-3,3,6,5,6,1,-1,0,1,0,6,-49,-2,5,3,25,0,0,1,-1,0,1,1,1
KR_6707639910,440,2,46,-15,5,2,3,1,0,3,3,2,2,0,2,5,3,-1,0,1,0,-1,4,3,6,9,4,0,1,1,-1,1,1,2,1
KR_6756556077,420,5,77,13,6,0,4,4,0,2,2,3,4,1,3,6,3,0,0,0,0,3,-8,-8,10,2,6,0,0,1,0,0,-1,2,1
KR_6734963698,420,6,67,27,13,1,1,0,2,3,1,3,3,0,3,3,0,4,6,2,0,8,9,6,1,7,5,0,2,1,1,1,1,5,1
KR_6715012901,420,-5,-38,1,-9,-4,2,6,-1,1,2,-4,1,5,-1,2,3,1,2,1,0,-11,-5,-3,9,6,-1,0,-1,1,1,1,1,6,1
KR_6758321474,420,-1,10,15,-3,3,4,1,-4,1,5,1,2,1,0,3,3,-3,2,5,0,-10,1,-1,5,4,3,0,0,1,1,1,1,2,1
KR_6656742409,420,-2,-47,-4,-5,-1,2,3,-5,4,9,0,2,2,-1,3,4,2,4,2,3,-2,0,-3,6,3,2,0,0,1,-1,0,1,2,1
KR_6736980434,420,2,86,-11,2,0,2,2,3,4,1,-2,2,4,2,3,1,-1,0,1,0,4,-6,3,4,7,-2,0,0,0,0,0,-1,0,1
KR_6624540108,420,-3,24,22,-5,-3,2,5,-3,2,5,-3,0,3,6,10,4,-2,0,2,0,-14,3,1,7,8,-5,0,1,-1,-1,1,1,1,1
KR_6728193335,420,1,43,24,1,-2,2,4,0,7,7,2,4,2,1,2,1,0,0,0,0,-1,-39,-2,6,4,5,0,1,1,-1,1,1,2,1
KR_6767880298,420,3,4,-7,13,0,1,1,2,4,2,4,4,0,7,9,2,0,0,0,0,13,11,5,2,7,1,0,0,1,-1,1,1,4,1
KR_6733822083,420,2,3,12,16,7,8,1,4,4,0,-4,2,6,7,7,0,2,4,2,1,19,1,3,4,7,-5,0,4,1,1,1,1,5,1
KR_6758312287,420,2,9,0,3,3,3,0,-2,2,4,0,4,4,-1,3,4,3,3,0,0,-1,-2,1,5,6,0,0,1,-1,1,1,1,6,1
KR_6761375327,420,1,10,-8,10,-2,1,3,0,1,1,4,4,0,8,8,0,0,2,2,0,20,5,-2,7,5,4,0,0,1,1,0,1,3,1
KR_6768277040,420,3,-7,-7,8,-2,0,2,2,4,2,7,7,0,0,2,2,1,3,2,1,10,-2,-2,5,3,-2,0,0,1,1,1,1,1,1
KR_6730038506,440,1,21,4,2,-1,1,2,-2,0,2,1,3,2,4,5,1,0,1,1,0,9,-8,1,5,6,-4,0,-1,1,-1,-1,-1,6,1
KR_6764436325,420,0,38,8,1,-2,2,4,-3,1,4,2,5,3,3,6,3,1,1,0,3,4,-25,-1,8,7,1,0,0,-1,-1,0,1,6,1
KR_6765460030,420,1,-44,-20,5,1,3,2,1,4,3,4,5,1,-5,0,5,4,4,0,0,8,-6,-1,7,6,2,0,-1,1,-1,-1,-1,2,1
KR_6758366457,420,0,9,1,4,3,3,0,1,5,4,2,4,2,-2,2,4,0,1,1,1,2,-47,-1,4,3,27,0,0,1,-1,0,1,3,1
KR_6769222170,420,3,-17,47,7,1,2,1,9,10,1,-2,2,4,1,1,0,-2,0,2,1,14,-1,8,2,10,-4,0,1,-1,1,1,1,4,1
KR_6623643996,420,3,64,31,3,6,6,0,-5,1,6,1,3,2,1,2,1,0,0,0,0,-1,5,6,4,10,3,0,0,1,1,0,-1,4,1
KR_6768983586,420,-1,-20,-16,-2,-1,1,2,-2,3,5,-1,1,2,3,3,0,-1,1,2,0,2,9,2,6,8,1,0,0,1,-1,-1,1,1,1
KR_6744715360,440,-3,-26,-11,-1,2,4,2,-3,1,4,0,1,1,1,3,2,-1,0,1,0,-1,-13,-4,5,1,5,0,-1,1,-1,-1,1,5,1
KR_6768557211,420,-1,11,28,-2,0,1,1,-2,2,4,-2,3,5,2,3,1,0,0,0,-1,-1,-1,-2,7,5,0,0,0,1,-1,1,-1,3,1
KR_6758077966,440,-1,57,-8,-5,6,7,1,-10,0,10,0,2,2,0,2,2,-1,0,1,0,-4,-1,-2,7,5,3,0,1,-1,1,1,-1,2,1
KR_6761062840,420,2,58,-11,0,0,5,5,-2,2,4,2,2,0,1,2,1,-1,0,1,-1,3,379,-2,4,2,1,0,0,1,1,0,-1,4,1
KR_6764111216,420,2,32,10,3,-2,1,3,0,2,2,3,4,1,1,1,0,1,1,0,0,5,7,-1,5,4,0,0,2,-1,-1,1,-1,2,1
KR_6709796660,440,1,-32,6,1,-5,0,5,3,4,1,3,4,1,-2,1,3,2,2,0,0,3,20,6,3,9,-5,0,-1,-1,-1,-1,-1,3,1
KR_6687281834,420,1,64,4,0,1,3,2,-1,2,3,0,2,2,-3,0,3,3,3,0,0,-5,1,-1,7,6,5,0,0,-1,0,0,1,5,1
KR_6766707965,420,1,13,-20,1,1,1,0,1,3,2,1,2,1,1,4,3,-3,0,3,0,1,28,3,3,6,0,0,-1,0,-1,-1,-1,0,1
KR_6763599906,420,3,-13,-4,10,1,3,2,2,3,1,6,7,1,0,1,1,1,1,0,0,10,103,4,5,9,-2,0,1,-1,1,1,1,2,1
KR_6766389269,440,-2,-42,29,1,3,3,0,-2,1,3,2,4,2,-3,2,5,1,3,2,0,0,3,0,7,7,-3,0,0,-1,1,0,1,2,1
KR_6763567065,440,0,-53,-15,4,-2,0,2,1,2,1,0,2,2,6,9,3,-1,2,3,0,-8,3,0,1,1,1,0,0,-1,-1,0,1,2,1
KR_6742371824,420,2,46,-24,1,2,3,1,5,7,2,-7,2,9,0,2,2,1,1,0,0,6,-6,0,4,4,6,0,0,-1,-1,0,1,6,1
KR_6765001215,420,1,48,13,6,-1,0,1,3,4,1,2,2,0,2,4,2,0,0,0,0,5,-12,-3,7,4,2,0,0,-1,1,0,1,1,1
KR_6768113026,420,6,10,8,15,3,3,0,7,8,1,2,3,1,-1,2,3,4,6,2,0,16,7,6,5,11,-6,0,1,-1,1,1,1,1,1
KR_6764827123,420,-1,44,-38,3,-1,1,2,2,4,2,5,7,2,-4,1,5,1,1,0,0,5,11,-2,8,6,-3,0,-1,1,1,-1,1,4,1
KR_6751161909,420,-1,-14,-3,4,3,3,0,-4,1,5,2,2,0,2,4,2,1,2,1,0,3,-10,0,6,6,-2,0,1,1,-1,1,1,2,1
KR_6755183918,420,9,129,97,11,3,8,5,3,3,0,0,2,2,5,9,4,0,1,1,3,12,17,5,1,6,8,0,3,1,1,1,1,2,1
KR_6732815292,420,4,62,12,8,-1,3,4,3,4,1,3,5,2,2,5,3,1,5,4,0,19,3,0,5,5,2,0,1,1,1,1,-1,4,1
KR_6736934099,420,2,-3,-27,7,3,4,1,9,9,0,-1,2,3,-3,3,6,-1,2,3,0,2,11,5,7,12,-4,0,1,-1,1,1,-1,3,1
KR_6678984144,420,-1,6,-12,6,-1,0,1,6,6,0,3,5,2,2,2,0,-4,0,4,1,12,0,-2,5,3,2,0,0,1,-1,-1,1,1,1
KR_6682274081,420,-1,-70,-22,1,-3,0,3,5,7,2,-4,1,5,2,5,3,1,3,2,0,3,10,-6,11,5,0,0,-2,1,-1,1,-1,2,1
KR_6673530850,420,0,5,37,3,1,1,0,3,4,1,-4,1,5,2,4,2,1,2,1,0,6,1,-3,8,5,6,0,1,1,1,1,-1,1,1
KR_6763420975,440,4,57,31,7,4,4,0,1,5,4,-3,0,3,5,6,1,0,0,0,0,5,-1,5,1,6,0,0,2,0,1,1,1,0,1
KR_6657479554,420,1,-8,28,6,1,1,0,5,6,1,1,4,3,-1,0,1,0,0,0,1,7,-18,0,5,5,0,0,-1,1,-1,-1,1,5,1
KR_6761433576,420,0,34,10,8,0,1,1,1,3,2,-2,2,4,10,10,0,-1,1,2,0,20,-10,-1,5,4,5,0,1,1,-1,1,1,6,1
KR_6765633046,420,4,31,17,6,1,1,0,1,3,2,1,3,2,1,1,0,2,2,0,0,6,-7,-2,5,3,5,0,1,1,1,1,1,4,1
KR_6739148301,420,2,-28,18,6,-2,2,4,3,3,0,-3,1,4,2,7,5,6,6,0,1,23,6,4,2,6,-1,0,1,1,0,1,1,3,1
KR_6770157343,420,5,-18,24,11,0,1,1,2,2,0,3,6,3,6,10,4,0,3,3,0,19,3,0,6,6,2,0,1,1,1,1,-1,6,1
KR_6757102369,420,-2,18,-4,-7,1,1,0,-2,1,3,-5,3,8,0,5,5,-1,1,2,0,-12,-26,-2,8,6,-6,0,-1,-1,-1,-1,-1,2,1
KR_6766833587,420,7,35,7,8,1,1,0,3,5,2,2,3,1,2,3,1,0,3,3,0,5,4,5,2,7,-1,0,1,1,-1,1,-1,1,1
KR_6712315177,420,5,33,24,7,2,3,1,2,3,1,-3,3,6,2,4,2,4,4,0,-1,3,-13,-1,5,4,-3,0,1,1,1,1,-1,4,1
KR_6674859610,420,1,-4,20,0,-3,0,3,2,5,3,1,5,4,2,4,2,-2,0,2,1,2,-127,-4,8,4,-1,0,0,-1,0,0,1,5,1
KR_6762366325,440,2,78,-3,0,-1,0,1,0,4,4,0,0,0,1,3,2,0,0,0,0,-2,6,5,3,8,-4,0,1,0,0,1,1,0,1
KR_6746623869,440,1,-9,9,1,0,2,2,2,4,2,-1,0,1,0,2,2,0,1,1,0,3,2,3,3,6,-3,0,0,-1,-1,0,1,1,1
KR_6750693685,420,-2,-29,8,-1,0,0,0,4,5,1,-3,1,4,-2,1,3,0,2,2,0,-5,-24,-4,7,3,-2,0,0,1,-1,0,1,1,1
KR_6753040448,420,3,11,-12,4,-1,4,5,3,5,2,1,1,0,-1,1,2,2,3,1,1,7,-26,3,3,6,-4,0,-2,0,-1,-1,1,0,1
KR_6764814497,420,0,100,-15,1,-1,4,5,-3,1,4,5,5,0,1,6,5,-1,0,1,0,-2,-2,2,2,4,2,0,0,1,-1,0,1,3,1
KR_6768819293,420,0,-29,14,8,3,3,0,3,3,0,0,4,4,2,4,2,0,1,1,2,5,133,-3,5,2,8,0,2,1,1,1,1,6,1
KR_6689092245,420,0,53,8,1,1,2,1,0,3,3,2,3,1,-1,3,4,-1,1,2,0,2,-1,0,7,7,3,0,0,1,1,1,1,1,1
KR_6768364186,420,-3,35,6,-6,-1,0,1,-2,1,3,1,2,1,-4,1,5,0,1,1,0,-6,-23,0,7,7,2,0,0,-1,1,0,-1,5,1
KR_6641532350,420,-2,27,18,-2,1,3,2,3,7,4,-2,4,6,-5,2,7,1,1,0,1,-3,23,-1,5,4,1,0,0,-1,-1,1,1,2,1
KR_6724914119,420,6,57,44,15,1,3,2,1,5,4,5,6,1,6,7,1,2,2,0,0,13,1,-4,5,1,1,0,3,1,1,1,1,3,1
KR_6664865430,420,4,35,30,11,4,5,1,6,6,0,1,3,2,-1,1,2,1,2,1,1,9,26,3,7,10,2,0,3,1,1,1,1,4,1
KR_6762696518,420,4,107,2,13,-1,3,4,2,2,0,3,4,1,6,12,6,3,3,0,1,19,7,7,5,12,-1,0,-1,1,-1,-1,1,4,1
KR_6738147580,420,-3,-26,-33,4,1,1,0,1,5,4,0,1,1,2,3,1,0,1,1,-1,5,4,1,4,5,-2,0,1,-1,1,1,-1,6,1
KR_6689758968,420,1,57,0,8,6,7,1,0,2,2,-1,3,4,3,3,0,0,0,0,1,12,15,-2,5,3,1,0,2,1,1,1,1,4,1
KR_6764179878,420,1,18,0,7,-2,1,3,4,5,1,0,2,2,6,10,4,-1,1,2,0,13,35,0,6,6,0,0,0,1,1,1,1,1,1
KR_6760857712,420,1,-16,4,3,-2,0,2,3,4,1,1,2,1,4,5,1,-3,0,3,0,2,3,0,6,6,-1,0,0,-1,1,1,1,3,1
KR_6767956118,420,4,33,-20,5,3,3,0,2,4,2,3,4,1,-4,0,4,1,2,1,0,-2,-3,0,1,1,3,0,0,-1,1,0,1,1,1
KR_6678961752,420,2,-1,-22,3,-1,2,3,5,5,0,-1,0,1,-1,4,5,1,2,1,0,5,-2,-2,5,3,2,0,0,-1,1,-1,-1,2,1
KR_6704838395,420,3,91,-7,9,0,0,0,2,7,5,1,1,0,3,3,0,3,3,0,1,12,3,-5,9,4,2,0,3,1,-1,1,1,6,1
KR_6763466089,440,0,-9,6,2,1,2,1,4,4,0,-1,0,1,-1,3,4,-1,0,1,1,4,-4,-3,9,6,8,0,1,1,1,1,1,1,1
KR_6764445036,420,-1,16,-16,3,1,3,2,1,6,5,2,3,1,1,4,3,-2,0,2,-1,-1,0,3,2,5,-1,0,0,1,-1,0,-1,1,1
KR_6769123626,420,3,50,-35,10,1,5,4,5,6,1,5,6,1,-1,1,2,0,1,1,0,-1,7,0,4,4,2,0,0,0,1,-1,1,0,1
KR_6767507520,420,-1,22,-8,6,0,1,1,2,3,1,3,4,1,2,3,1,-1,0,1,1,8,-2,-7,13,6,2,0,1,-1,1,1,1,1,1
KR_6770343335,420,4,42,16,10,3,3,0,2,5,3,2,2,0,2,4,2,1,2,1,0,7,2,6,3,9,1,0,1,1,1,1,1,5,1
KR_6746802969,420,0,-28,24,4,3,3,0,-5,2,7,2,4,2,0,3,3,4,4,0,0,6,0,-2,10,8,8,0,1,1,1,1,1,2,1
KR_6631179706,420,2,10,4,10,0,2,2,0,4,4,-1,2,3,2,2,0,9,9,0,1,12,67,4,4,8,-4,0,1,-1,1,1,1,6,1
KR_6763468248,440,1,-15,8,5,2,3,1,-1,2,3,5,5,0,0,3,3,-1,0,1,0,0,16,8,4,12,1,0,0,-1,0,0,1,5,1
KR_6744672644,440,3,97,-8,-1,4,4,0,-4,2,6,0,1,1,0,3,3,-1,2,3,0,-9,-9,-5,7,2,10,0,1,-1,-1,1,-1,1,1
KR_6768072951,420,5,99,13,12,6,6,0,2,4,2,5,7,2,1,2,1,-2,0,2,1,8,-6,4,2,6,-3,0,1,1,1,1,1,1,1
KR_6763376064,420,-2,-32,33,-1,1,2,1,-1,0,1,-2,2,4,-1,2,3,2,3,1,0,1,-3,-3,8,5,3,0,0,1,1,1,-1,2,1
KR_6770402158,440,4,35,0,7,2,3,1,7,8,1,-1,2,3,0,1,1,-1,0,1,0,5,-5,-2,6,4,3,0,0,1,-1,0,-1,2,1
KR_6768903267,420,1,-21,16,3,-4,1,5,-4,1,5,4,5,1,6,8,2,1,1,0,0,2,21,-2,8,6,2,0,-1,1,0,-1,-1,4,1
KR_6744911674,420,4,45,23,10,7,9,2,-1,0,1,2,3,1,2,4,2,0,1,1,0,4,13,1,6,7,4,0,2,1,1,1,-1,4,1
KR_6761084305,420,0,-29,9,-2,-3,2,5,1,3,2,0,2,2,0,4,4,0,1,1,0,-1,36,0,6,6,-1,0,1,1,-1,1,-1,3,1
KR_6620322958,420,0,41,-5,0,2,2,0,0,3,3,2,2,0,-4,2,6,0,0,0,0,3,100,1,8,9,5,0,0,1,-1,0,-1,5,1
KR_6695197643,420,2,4,-5,3,2,2,0,-1,4,5,1,1,0,1,3,2,0,1,1,0,1,-26,5,5,10,3,0,0,-1,1,1,1,5,1
KR_6769579668,420,-1,17,24,2,-2,3,5,1,4,3,0,1,1,0,3,3,3,5,2,-1,6,-117,1,4,5,5,0,0,1,-1,0,-1,2,1
KR_6765434979,420,0,54,-11,4,1,4,3,2,2,0,0,2,2,3,6,3,-2,0,2,1,16,-20,3,7,10,-2,0,0,-1,1,0,1,5,1
KR_6764145329,420,-1,12,-16,6,-3,1,4,3,4,1,0,2,2,4,5,1,2,2,0,0,12,-487,2,3,5,5,0,1,1,1,1,1,1,1
KR_6742444751,420,5,21,24,8,4,4,0,0,4,4,1,2,1,4,4,0,-1,1,2,0,9,-8,-1,6,5,6,0,0,1,0,0,1,6,1
KR_6754371579,420,4,49,22,9,4,5,1,8,9,1,-1,1,2,0,2,2,-2,1,3,0,3,1,-1,6,5,3,0,2,1,1,1,-1,3,1
KR_6732375528,420,2,30,13,4,0,4,4,-1,3,4,4,4,0,0,4,4,1,1,0,2,7,-144,-8,12,4,3,0,0,1,1,1,1,4,1
KR_6746004389,420,3,28,15,5,0,2,2,1,4,3,2,2,0,1,5,4,1,1,0,-1,-1,0,3,6,9,-2,0,0,1,-1,0,-1,1,1
KR_6741693617,440,2,52,50,5,0,0,0,3,5,2,1,3,2,0,5,5,1,2,1,0,3,68,4,3,7,3,0,1,1,1,1,1,3,1
KR_6657365234,420,-1,-14,8,1,-2,0,2,1,2,1,-2,1,3,2,2,0,2,2,0,0,4,67,-5,7,2,18,0,0,1,-1,-1,1,1,1
KR_6762442874,420,1,47,-40,7,-1,3,4,3,7,4,-3,2,5,8,10,2,0,1,1,0,5,-7,1,3,4,1,0,0,1,-1,1,1,4,1
KR_6660889818,420,0,-40,-17,1,0,2,2,3,3,0,0,2,2,-1,2,3,-1,0,1,0,4,77,1,4,5,4,0,0,1,-1,-1,-1,4,1
KR_6714868732,420,-2,13,-16,2,-3,1,4,0,2,2,3,4,1,0,4,4,2,2,0,0,0,16,0,4,4,5,0,0,1,0,-1,-1,4,1
KR_6629997638,420,-3,-17,26,1,-1,2,3,0,1,1,1,2,1,1,5,4,0,0,0,0,3,33,2,4,6,-7,0,1,1,1,1,-1,5,1
KR_6764860964,420,0,-32,1,7,-2,2,4,4,4,0,1,2,1,2,3,1,2,2,0,0,17,13,4,4,8,4,0,1,1,1,1,-1,3,1
KR_6741789251,440,-1,42,-9,-8,0,1,1,0,4,4,-2,2,4,-1,2,3,-5,2,7,0,-6,-33,0,4,4,1,0,0,0,-1,-1,-1,0,1
KR_6750744435,420,0,35,-24,6,4,6,2,1,1,0,0,0,0,3,4,1,-2,0,2,1,2,7,3,7,10,-3,0,0,-1,1,0,1,3,1
KR_6694125114,420,5,30,28,9,3,3,0,5,5,0,2,5,3,-1,3,4,0,0,0,0,5,-14,2,5,7,-4,0,1,1,1,1,1,4,1
KR_6761587486,440,0,0,11,2,-6,1,7,7,9,2,4,7,3,-5,2,7,2,2,0,3,1,-4,0,5,5,2,0,-2,1,1,-1,1,1,1
KR_6752827206,420,3,68,0,7,2,2,0,4,5,1,1,3,2,1,2,1,-1,0,1,0,4,-29,-2,6,4,7,0,0,1,-1,0,1,2,1
KR_6768870766,420,-3,14,-4,-1,3,4,1,-1,2,3,-3,2,5,0,0,0,0,0,0,0,-3,-36,-4,6,2,-1,0,1,-1,1,1,-1,4,1
KR_6766339541,440,6,39,34,22,2,2,0,9,14,5,0,1,1,2,2,0,9,11,2,0,21,-313,3,4,7,1,0,1,-1,-1,1,1,2,1
KR_6767221212,440,5,13,20,12,0,1,1,8,9,1,2,3,1,-1,3,4,3,6,3,0,10,17,0,7,7,1,0,2,0,1,1,1,0,1
KR_6758387905,440,-4,-10,-7,-11,-4,2,6,-1,0,1,-3,1,4,1,8,7,-4,6,10,0,-6,4,1,3,4,1,0,0,-1,0,0,1,4,1
KR_6726866013,440,-1,7,-5,-4,1,4,3,-7,0,7,3,3,0,-4,2,6,3,4,1,0,-4,-18,1,3,4,-1,0,-1,-1,1,-1,1,2,1
KR_6654175043,440,4,30,0,3,1,3,2,0,1,1,5,6,1,-4,1,5,1,3,2,0,2,4,-3,3,0,-2,0,0,-1,1,-1,1,6,1
KR_6738311917,420,1,-31,48,0,-5,1,6,0,1,1,2,4,2,1,3,2,2,3,1,0,-4,-1,-1,6,5,-4,0,-1,1,1,-1,1,5,1
KR_6763716197,420,2,-5,19,4,9,9,0,-5,4,9,-2,1,3,-3,0,3,5,6,1,0,-1,-25,1,5,6,-4,0,0,-1,1,-1,1,4,1
KR_6752561372,420,2,-44,0,5,1,2,1,0,4,4,-3,0,3,7,7,0,0,1,1,0,9,-30,5,3,8,22,0,0,1,-1,1,-1,3,1
KR_6767043480,440,-1,8,-18,3,2,2,0,-3,0,3,0,3,3,4,5,1,0,1,1,0,6,10,4,3,7,2,0,1,1,1,1,1,3,1
KR_6746104426,420,-1,-70,7,-3,-1,1,2,4,6,2,-4,0,4,-4,4,8,2,2,0,0,4,-11,1,6,7,-1,0,0,-1,-1,-1,-1,4,1
KR_6769857455,420,3,-15,0,6,4,5,1,-2,0,2,-3,0,3,6,8,2,1,2,1,-1,6,229,6,2,8,-1,0,0,1,-1,1,-1,2,1
KR_6652123990,420,1,27,-10,0,5,5,0,-7,0,7,1,4,3,1,2,1,0,0,0,0,-10,6,4,2,6,-6,0,1,-1,1,1,1,3,1
KR_6725473721,420,-2,-2,0,-7,1,2,1,-7,0,7,-4,3,7,1,7,6,2,2,0,0,-5,-2,1,5,6,3,0,-1,-1,1,-1,1,3,1
KR_6769531339,420,0,26,-24,-1,2,3,1,2,5,3,-2,1,3,-5,2,7,2,2,0,-1,-5,-15,0,6,6,-2,0,0,-1,-1,0,-1,4,1
KR_6769907170,420,1,-3,11,5,3,5,2,-2,2,4,0,2,2,3,5,2,1,1,0,1,3,9,4,5,9,-2,0,2,1,1,1,1,3,1
KR_6769617997,420,3,-9,46,8,4,5,1,2,4,2,1,3,2,1,1,0,0,3,3,0,8,57,2,5,7,4,0,2,0,1,1,-1,0,1
KR_6756417129,420,0,-36,12,0,2,2,0,2,3,1,3,3,0,-6,0,6,-1,0,1,0,-5,27,-5,7,2,3,0,1,-1,1,1,-1,5,1
KR_6750487000,420,3,-8,3,7,5,6,1,5,6,1,-4,0,4,2,3,1,-1,2,3,0,7,135,3,3,6,-2,0,0,-1,-1,1,1,4,1
KR_6760078070,420,2,-9,15,2,0,2,2,4,7,3,1,2,1,3,3,0,-6,0,6,0,3,4,5,3,8,1,0,1,1,-1,1,1,4,1
KR_6743424658,420,9,63,62,23,1,3,2,8,14,6,-1,2,3,10,13,3,5,5,0,1,29,-41,3,4,7,24,0,2,1,1,1,1,1,1
KR_6654585887,420,1,-17,0,-1,-5,2,7,0,3,3,-2,0,2,4,4,0,2,3,1,0,6,19,1,4,5,1,0,-1,-1,1,-1,-1,6,1
KR_6767684378,440,2,78,-20,7,2,6,4,0,1,1,-1,4,5,0,2,2,6,6,0,0,4,-17,0,3,3,1,0,0,1,1,1,1,5,1
KR_6757385498,440,-6,-80,-9,-1,-6,0,6,5,5,0,-2,1,3,3,4,1,-1,0,1,0,9,-3,-4,11,7,0,0,0,1,-1,0,-1,4,1
KR_6763330307,440,1,10,12,2,4,5,1,0,0,0,-2,0,2,0,2,2,0,2,2,0,5,-1,-1,4,3,-1,0,0,1,-1,-1,-1,3,1
KR_6738456985,420,4,-26,8,13,-1,2,3,7,10,3,4,5,1,2,3,1,1,1,0,0,20,33,5,0,5,3,0,2,1,1,1,1,1,1
KR_6734992318,420,4,-28,12,5,3,5,2,-3,1,4,1,2,1,3,5,2,1,1,0,-1,1,-1,-3,8,5,-2,0,-1,1,-1,-1,-1,6,1
KR_6749086485,420,3,-40,4,1,1,3,2,2,5,3,0,2,2,-2,1,3,0,0,0,0,-3,-123,9,1,10,-6,0,0,1,0,-1,-1,6,1
KR_6738526439,420,-3,-32,-6,-7,-2,1,3,-4,2,6,-1,1,2,-1,3,4,1,1,0,-1,-8,114,-1,5,4,2,0,0,1,1,1,-1,1,1
KR_6770089733,420,0,6,-4,4,-1,1,2,-1,3,4,3,4,1,3,4,1,0,1,1,0,7,-6,-3,6,3,4,0,0,1,1,-1,-1,2,1
KR_6770400232,420,-2,17,12,-7,-5,0,5,0,2,2,-1,0,1,-2,0,2,1,2,1,0,-8,2,-1,8,7,-1,0,-1,1,1,-1,-1,1,1
KR_6758717888,420,0,23,5,2,0,2,2,-2,0,2,1,2,1,3,4,1,0,1,1,0,1,8,-1,3,2,5,0,1,1,0,1,1,6,1
KR_6634281272,420,1,-40,9,8,-1,1,2,4,4,0,6,8,2,-1,2,3,0,1,1,0,10,6,4,5,9,-5,0,0,-1,1,0,1,6,1
KR_6750047633,440,4,-35,16,7,3,3,0,2,3,1,-1,1,2,3,5,2,0,3,3,0,0,-28,3,2,5,21,0,0,0,1,0,1,0,1
KR_6742956926,420,2,31,12,-3,2,3,1,-1,3,4,-1,1,2,-4,4,8,1,3,2,0,-7,3,-2,7,5,3,0,0,-1,-1,0,1,1,1
KR_6756361369,420,0,-48,-28,2,2,4,2,1,6,5,4,6,2,-6,3,9,1,2,1,0,1,-10,4,7,11,-2,0,0,-1,-1,-1,1,6,1
KR_6763273487,440,3,45,-2,1,1,3,2,4,5,1,1,1,0,-5,4,9,0,0,0,0,-1,16,-4,5,1,2,0,1,1,-1,1,-1,6,1
KR_6683289654,420,3,57,-20,15,-5,1,6,4,4,0,1,1,0,12,12,0,3,3,0,0,21,1,1,6,7,4,0,2,1,1,1,1,1,1
KR_6655312779,440,0,0,18,2,2,4,2,-2,0,2,2,4,2,-1,1,2,1,1,0,0,0,354,0,3,3,-25,0,0,1,1,1,-1,1,1
KR_6769257610,420,2,15,-12,-2,1,2,1,1,3,2,-1,3,4,0,1,1,-3,0,3,0,-2,6,-3,6,3,3,0,0,-1,-1,0,-1,3,1
KR_6673870110,420,-2,-19,32,-3,-1,1,2,-4,2,6,5,6,1,1,2,1,-4,1,5,0,-10,-14,-3,8,5,-3,0,0,0,1,-1,-1,0,1
KR_6744282860,420,5,91,7,14,3,3,0,2,2,0,2,3,1,3,4,1,4,4,0,0,9,7,6,1,7,1,0,0,1,1,1,1,6,1
KR_6765700141,420,5,48,11,12,-2,2,4,-2,1,3,6,8,2,7,7,0,3,4,1,0,15,0,0,4,4,1,0,2,1,1,1,-1,5,1
KR_6684116196,420,-2,16,-12,-6,0,1,1,-3,3,6,0,4,4,-1,3,4,-2,2,4,0,-10,8,-4,10,6,3,0,0,-1,1,1,1,2,1
KR_6770135193,420,0,-20,-1,2,-3,1,4,1,5,4,2,5,3,1,3,2,1,2,1,0,4,6,1,3,4,-1,0,0,-1,1,-1,1,3,1
KR_6758753244,420,1,-11,-4,7,1,2,1,0,4,4,3,4,1,1,4,3,2,3,1,0,8,8,1,6,7,1,0,1,-1,-1,1,1,4,1
KR_6768994541,420,7,41,11,12,2,2,0,3,3,0,0,4,4,5,5,0,2,2,0,1,16,9,7,2,9,-4,0,2,-1,1,1,1,5,1
KR_6767452371,420,-1,-35,-13,1,-1,1,2,-3,1,4,3,4,1,1,3,2,1,1,0,0,8,7,1,3,4,-2,0,0,-1,-1,0,1,2,1
KR_6740453446,420,0,-65,27,7,-4,2,6,5,6,1,2,6,4,1,3,2,3,4,1,1,14,-8,-4,6,2,4,0,1,1,1,1,1,6,1
KR_6738812987,420,1,12,12,8,3,3,0,-2,3,5,0,2,2,4,5,1,3,4,1,0,3,-18,0,4,4,-4,0,1,1,1,1,1,6,1
KR_6698072658,420,3,40,18,6,1,4,3,3,5,2,0,3,3,1,5,4,1,1,0,0,3,-11,-6,8,2,2,0,0,1,-1,1,1,5,1
KR_6727633396,440,2,35,-9,2,0,3,3,1,3,2,4,5,1,3,5,2,-6,0,6,0,-2,15,2,3,5,-5,0,1,-1,1,1,1,3,1
KR_6762025956,420,1,3,-14,-3,2,3,1,-5,0,5,0,1,1,1,5,4,-1,2,3,0,-2,139,0,7,7,1,0,1,-1,-1,1,-1,5,1
KR_6769643537,420,1,21,-12,-1,-1,0,1,2,3,1,0,2,2,3,4,1,-5,0,5,-1,0,2,-3,4,1,-3,0,0,-1,-1,0,-1,1,1
KR_6635204489,420,1,-41,2,-3,-7,0,7,0,1,1,8,10,2,-1,2,3,-3,0,3,-2,-6,-20,0,4,4,2,0,-1,-1,1,-1,1,6,1
KR_6762254204,420,-2,-17,8,-6,-1,2,3,-2,0,2,-4,1,5,0,7,7,1,1,0,1,0,20,6,5,11,0,0,0,-1,1,0,-1,1,1
KR_6756794614,420,3,-15,24,2,0,0,0,-2,2,4,3,4,1,3,4,1,-2,0,2,0,0,5,1,3,4,0,0,1,1,1,1,1,3,1
KR_6738146536,420,3,46,16,3,4,7,3,-1,4,5,1,2,1,-1,3,4,0,1,1,0,0,-13,-5,7,2,0,0,0,1,-1,-1,1,3,1
KR_6756461461,420,2,27,-17,1,1,3,2,-4,2,6,0,3,3,1,3,2,3,5,2,0,7,9,2,5,7,2,0,0,1,1,-1,-1,2,1
KR_6758942071,420,3,22,-4,2,2,4,2,-1,1,2,-2,1,3,0,4,4,3,3,0,0,-1,-20,-3,7,4,7,0,0,-1,-1,0,-1,6,1
KR_6731622863,420,0,23,-3,3,1,4,3,1,1,0,-3,2,5,4,6,2,0,0,0,0,-1,-18,-4,8,4,5,0,1,-1,-1,1,1,2,1
KR_6759922758,420,0,-12,-32,3,2,6,4,1,7,6,-7,0,7,1,4,3,6,8,2,-2,2,29,0,6,6,-3,0,-1,-1,0,-1,-1,1,1
KR_6769591788,440,1,25,16,-1,0,1,1,4,7,3,-4,2,6,1,2,1,-2,1,3,0,4,-5,-1,3,2,-1,0,0,-1,-1,1,1,2,1
KR_6763007289,420,2,37,-4,1,-1,1,2,4,4,0,-2,2,4,1,5,4,-1,0,1,0,-4,7,4,4,8,-1,0,1,-1,1,1,-1,4,1
KR_6664202194,420,3,86,8,8,2,2,0,4,6,2,-2,0,2,2,5,3,2,2,0,2,9,-1,-4,8,4,7,0,1,-1,1,1,1,3,1
KR_6768709278,420,-3,-47,-18,-2,1,3,2,1,4,3,-2,1,3,-3,3,6,1,2,1,0,-2,-15,1,6,7,7,0,-1,1,-1,-1,-1,6,1
KR_6758148863,420,1,-19,0,-4,1,1,0,-5,5,10,2,3,1,1,4,3,-3,0,3,-2,-9,16,-1,9,8,-2,0,1,-1,1,1,-1,5,1
KR_6745808842,420,2,2,-8,1,0,1,1,1,2,1,-6,2,8,5,7,2,1,1,0,0,-6,38,-1,7,6,-19,0,0,-1,0,0,1,3,1
KR_6766424060,420,0,37,-20,2,4,4,0,1,3,2,-3,2,5,1,4,3,-1,0,1,0,4,5,-1,7,6,4,0,1,1,1,1,1,5,1
KR_6657341658,440,2,48,8,6,2,2,0,2,3,1,1,5,4,-1,0,1,2,2,0,0,0,13,-3,5,2,-2,0,0,0,0,0,1,0,1
KR_6767338152,420,-1,45,7,-3,2,4,2,0,2,2,2,3,1,-2,1,3,-5,0,5,0,-9,-1,1,5,6,0,0,1,-1,-1,1,-1,6,1
KR_6766655476,420,1,48,25,2,-1,1,2,-1,1,2,1,2,1,7,7,0,-4,1,5,0,0,29,0,3,3,-14,0,3,-1,1,1,-1,2,1
KR_6729996510,420,2,30,36,12,5,6,1,-4,3,7,3,4,1,4,6,2,4,4,0,1,9,6,5,3,8,1,0,1,1,-1,1,1,2,1
KR_6732753523,420,-4,-24,-19,-4,0,3,3,-1,2,3,0,2,2,-4,0,4,1,1,0,0,-4,-31,-5,9,4,3,0,-1,-1,1,-1,1,5,1
KR_6763090782,420,2,2,-2,7,2,3,1,1,1,0,1,4,3,3,4,1,0,0,0,0,10,10,6,3,9,-1,0,-1,1,1,1,1,6,1
KR_6738404391,420,4,48,-28,10,1,1,0,2,3,1,3,4,1,4,7,3,0,1,1,1,5,50,1,2,3,-7,0,3,1,-1,1,1,5,1
KR_6611994564,420,-3,7,-17,-3,-2,0,2,0,7,7,0,2,2,-2,4,6,1,1,0,0,-7,8,3,7,10,0,0,0,1,1,0,1,3,1
KR_6754611730,420,-1,-21,-20,-5,1,1,0,-3,0,3,0,3,3,-3,2,5,0,1,1,0,-8,-6,1,3,4,3,0,0,-1,1,0,-1,1,1
KR_6734500640,420,2,-2,-7,-1,-1,3,4,4,5,1,-1,2,3,-3,2,5,0,2,2,-1,4,7,-4,8,4,-3,0,0,1,-1,0,-1,2,1
KR_6767931211,420,0,75,15,1,-3,1,4,-2,1,3,3,3,0,4,4,0,-1,1,2,0,4,7,3,2,5,-3,0,3,-1,-1,1,1,1,1
KR_6769693334,420,2,-19,2,5,-1,1,2,-3,0,3,3,3,0,4,4,0,2,3,1,0,7,-3,-5,8,3,3,0,0,1,-1,1,-1,4,1
KR_6769660440,420,5,65,2,3,6,6,0,-2,1,3,-2,3,5,1,2,1,0,0,0,0,-7,-35,-4,7,3,0,0,1,1,-1,1,1,6,1
KR_6763608809,440,-1,50,-17,-2,3,4,1,-4,1,5,-1,1,2,1,1,0,-1,1,2,0,-2,8,-5,9,4,-4,0,1,0,1,1,-1,0,1
KR_6611735599,420,3,3,30,12,2,3,1,4,6,2,1,1,0,1,3,2,4,4,0,1,22,3,-6,11,5,0,0,0,1,1,0,1,1,1
KR_6769288246,420,-1,-15,22,1,0,4,4,1,3,2,0,2,2,-3,3,6,3,4,1,0,-3,13,4,4,8,6,0,0,1,0,0,-1,1,1
KR_6765055014,420,-1,-12,1,0,3,3,0,-1,2,3,-7,4,11,5,6,1,0,1,1,0,0,8,1,2,3,-2,0,-1,1,-1,-1,1,2,1
KR_6735025188,420,3,10,-7,6,1,2,1,0,1,1,0,2,2,4,4,0,1,3,2,0,13,-11,2,6,8,10,0,0,1,-1,-1,1,4,1
KR_6654367779,440,3,13,23,18,12,12,0,2,2,0,8,9,1,-2,1,3,-2,0,2,0,12,-27,-3,6,3,4,0,0,0,0,1,1,0,1
KR_6763747321,420,3,72,-1,0,-1,0,1,7,8,1,-1,1,2,-3,0,3,-2,0,2,-1,5,15,-3,6,3,3,0,0,-1,1,0,-1,4,1
KR_6761761353,420,4,83,-4,6,4,4,0,3,3,0,-1,1,2,1,1,0,-1,0,1,0,3,-7,-7,12,5,6,0,1,-1,1,1,1,5,1
KR_6742232372,440,0,37,-12,1,0,1,1,-2,2,4,2,3,1,0,4,4,1,1,0,-1,3,-17,2,2,4,6,0,-1,-1,-1,-1,-1,3,1
KR_6759620711,420,2,19,4,5,-2,2,4,0,3,3,7,7,0,-2,0,2,2,2,0,0,14,0,1,6,7,7,0,-1,1,1,-1,1,4,1
KR_6755006415,420,0,20,-4,-1,3,3,0,-1,1,2,1,4,3,-3,2,5,-1,2,3,0,-2,2,-3,7,4,-1,0,2,-1,1,1,1,1,1
KR_6764160285,420,0,-23,-17,-2,0,1,1,0,2,2,-1,1,2,-3,1,4,2,3,1,0,-6,-14,0,6,6,0,0,0,1,1,0,1,6,1
KR_6726931181,420,3,18,7,5,2,3,1,-1,4,5,3,4,1,-1,1,2,2,2,0,0,0,-43,0,5,5,20,0,1,1,1,1,1,4,1
KR_6615650885,420,2,28,-8,10,-3,0,3,0,3,3,3,4,1,10,11,1,0,0,0,0,14,7,4,6,10,-1,0,2,1,1,1,1,5,1
KR_6752515871,420,1,9,7,-2,4,6,2,-1,0,1,5,7,2,-11,0,11,1,1,0,0,-5,2,1,7,8,-5,0,1,-1,-1,1,-1,5,1
KR_6744849249,420,5,31,55,8,0,2,2,3,6,3,2,3,1,3,6,3,0,0,0,0,10,17,5,2,7,-2,0,1,1,1,1,1,6,1
KR_6619939562,420,0,25,-7,0,-2,1,3,1,3,2,3,7,4,-2,4,6,0,0,0,0,-6,-2,-1,5,4,-2,0,0,1,1,1,1,2,1
KR_6741371884,420,2,-12,20,12,0,1,1,7,10,3,5,5,0,0,3,3,0,0,0,0,20,4,2,5,7,3,0,1,1,1,1,1,1,1
KR_6732054388,420,3,77,-3,19,7,7,0,3,4,1,0,1,1,6,6,0,3,6,3,0,10,6,5,2,7,0,0,4,0,1,1,1,0,1
KR_6758889011,420,2,-25,12,6,-1,0,1,2,4,2,1,2,1,3,5,2,1,2,1,1,11,4,1,6,7,-5,0,1,1,-1,1,1,1,1
KR_6767873596,420,-1,-27,-23,4,0,1,1,-2,2,4,1,2,1,5,5,0,0,1,1,0,2,1,6,1,7,-1,0,0,1,1,0,1,1,1
KR_6768242053,420,3,2,-2,6,2,4,2,1,2,1,0,2,2,3,5,2,0,1,1,0,6,3,-1,6,5,2,0,1,1,0,1,-1,2,1
KR_6755582128,420,-2,59,4,-7,4,6,2,2,4,2,-8,0,8,-2,3,5,-3,0,3,0,-15,38,-1,4,3,1,0,1,-1,0,1,1,3,1
KR_6723888026,420,3,89,-27,12,4,4,0,2,4,2,4,5,1,1,2,1,1,3,2,0,11,-3,2,7,9,1,0,0,-1,-1,0,-1,1,1
KR_6740467543,420,0,-33,8,4,3,3,0,4,8,4,0,1,1,-3,3,6,0,0,0,0,12,69,-2,6,4,-2,0,0,-1,1,1,-1,3,1
KR_6724621867,420,3,60,21,-2,1,1,0,-1,1,2,0,3,3,-2,0,2,0,1,1,0,-4,70,1,7,8,-9,0,1,-1,-1,1,-1,2,1
KR_6688502762,420,-2,-42,-10,5,-1,1,2,5,7,2,-2,3,5,3,7,4,0,0,0,2,20,23,5,5,10,-4,0,-1,1,-1,-1,1,5,1
KR_6770090536,420,2,0,3,5,2,2,0,6,8,2,2,3,1,-4,4,8,-1,1,2,0,2,67,0,7,7,2,0,-1,-1,-1,-1,1,2,1
KR_6766498626,420,-1,-22,-3,-4,-1,1,2,2,3,1,0,1,1,-4,1,5,-1,0,1,0,-6,112,2,3,5,-4,0,0,-1,-1,0,-1,6,1
KR_6761786048,420,4,22,40,7,2,2,0,3,5,2,-1,2,3,1,3,2,2,2,0,0,12,6,-6,10,4,10,0,0,1,1,0,1,2,1
KR_6769647082,420,0,56,-12,7,-3,0,3,1,3,2,4,4,0,6,6,0,-1,1,2,2,13,6,2,4,6,3,0,-1,1,-1,-1,1,3,1
KR_6737626202,420,0,-50,-11,2,-2,1,3,5,6,1,0,1,1,-3,0,3,2,4,2,0,4,-32,5,4,9,-4,0,0,1,1,0,-1,2,1
KR_6709232869,420,3,15,3,5,-2,2,4,-1,1,2,4,4,0,3,6,3,1,1,0,0,-2,-3,-3,6,3,1,0,0,1,-1,0,1,5,1
KR_6767893810,420,5,58,-8,12,6,8,2,2,5,3,0,2,2,2,6,4,2,2,0,0,2,251,5,0,5,-1,0,1,1,1,1,1,5,1
KR_6766683107,440,0,16,-14,-1,3,5,2,-3,4,7,1,2,1,2,2,0,-4,1,5,-1,1,-34,2,4,6,2,0,1,0,0,1,-1,0,1
KR_6760790766,420,-1,16,-4,4,-1,0,1,0,2,2,7,7,0,-2,2,4,0,1,1,0,10,-4,-2,6,4,8,0,0,1,0,0,-1,5,1
KR_6767616583,420,3,10,10,5,-2,2,4,3,6,3,0,3,3,3,4,1,1,1,0,0,6,-11,-8,8,0,1,0,0,1,0,0,1,2,1
KR_6686426387,440,2,85,-18,12,7,7,0,-3,0,3,4,5,1,3,3,0,1,2,1,0,8,-6,2,6,8,3,0,2,-1,1,1,1,5,1
KR_6751309974,420,-3,-1,-7,-6,1,1,0,-1,4,5,-6,1,7,0,3,3,0,0,0,0,-8,-13,1,6,7,-1,0,-1,1,-1,-1,-1,5,1
KR_6765418367,420,2,46,17,1,2,4,2,3,8,5,2,3,1,-3,1,4,-3,0,3,0,-3,11,0,5,5,-2,0,1,1,1,1,-1,4,1
KR_6766045430,420,4,30,31,3,-2,0,2,2,8,6,-1,1,2,3,5,2,1,1,0,0,0,7,2,4,6,0,0,1,1,1,1,-1,3,1
KR_6741613548,420,10,87,28,23,-2,1,3,8,9,1,8,9,1,7,9,2,2,2,0,0,17,2,2,7,9,2,0,2,1,-1,1,-1,6,1
KR_6746739928,420,4,10,-16,6,0,3,3,3,5,2,1,1,0,3,3,0,-1,0,1,0,7,11,4,1,5,-3,0,1,-1,1,1,1,3,1
KR_6767455210,420,1,45,0,5,3,3,0,1,4,3,4,7,3,-5,2,7,2,2,0,0,4,-4,3,3,6,3,0,-1,1,0,1,-1,6,1
KR_6744750069,420,4,28,11,13,2,3,1,2,4,2,1,1,0,4,5,1,4,4,0,0,17,19,-2,6,4,5,0,1,1,-1,1,1,2,1
KR_6760174933,420,1,-4,5,5,5,6,1,3,4,1,0,1,1,-1,2,3,-2,0,2,0,3,110,3,3,6,0,0,0,-1,1,1,1,6,1
KR_6718928199,420,1,16,-2,5,-2,2,4,3,5,2,4,4,0,0,4,4,0,2,2,0,7,-3,-1,5,4,3,0,1,1,1,1,1,2,1
KR_6755210540,420,-2,-23,23,-3,2,3,1,0,1,1,2,6,4,-5,0,5,-2,1,3,0,-7,13,5,5,10,-3,0,0,1,-1,0,1,5,1
KR_6761416334,420,2,-47,-19,3,1,1,0,0,1,1,-2,0,2,1,6,5,3,4,1,0,9,0,5,3,8,3,0,1,1,-1,-1,-1,4,1
KR_6768451100,420,0,-65,-38,7,-2,1,3,-1,3,4,3,5,2,6,6,0,1,1,0,-1,18,14,5,2,7,-6,0,1,1,1,1,-1,1,1
KR_6683235756,420,1,-43,4,3,1,2,1,0,2,2,3,4,1,-4,2,6,3,3,0,0,5,-2,0,7,7,3,0,0,1,-1,1,1,2,1
KR_6769987101,420,1,48,-16,7,3,4,1,0,3,3,-1,4,5,5,5,0,0,0,0,-1,12,6,1,3,4,1,0,-1,-1,-1,-1,-1,6,1
KR_6664595551,420,-1,-19,-16,5,0,0,0,-3,3,6,1,2,1,4,4,0,3,3,0,0,12,-26,-6,11,5,8,0,1,-1,-1,1,1,5,1
KR_6679804899,420,2,-35,24,1,-1,3,4,9,11,2,1,1,0,-3,0,3,-5,0,5,0,0,6,1,4,5,-8,0,2,-1,1,1,1,4,1
KR_6744161586,420,4,133,-19,7,3,5,2,-2,3,5,6,6,0,-1,1,2,1,1,0,0,3,1,-2,5,3,-1,0,4,1,1,1,1,1,1
KR_6611028080,420,0,18,-20,0,2,3,1,1,2,1,1,1,0,-4,1,5,0,0,0,0,-3,13,-2,8,6,10,0,0,0,-1,0,-1,0,1
KR_6762321011,420,-1,-43,-3,2,-1,3,4,-1,2,3,0,2,2,3,4,1,1,2,1,0,6,3,4,2,6,-2,0,-1,1,1,-1,-1,2,1
KR_6756389242,420,0,61,5,0,0,2,2,0,2,2,-1,2,3,2,3,1,-1,1,2,0,3,36,6,4,10,2,0,1,1,-1,1,1,5,1
KR_6726325345,420,5,101,-11,14,1,2,1,7,7,0,5,7,2,1,2,1,0,0,0,0,17,19,4,2,6,5,0,2,1,1,1,1,6,1
KR_6719006148,420,2,-1,33,4,-2,3,5,-1,4,5,4,4,0,3,5,2,0,1,1,0,4,5,0,9,9,0,0,0,1,1,-1,-1,1,1
KR_6739316760,420,1,36,-20,9,-2,2,4,1,3,2,11,12,1,1,4,3,-2,0,2,0,22,117,0,4,4,-1,0,0,-1,-1,0,1,4,1
KR_6766481452,420,2,6,-2,-2,1,1,0,1,4,3,-1,3,4,-3,0,3,0,1,1,0,-7,-13,3,4,7,-3,0,0,1,1,0,-1,6,1
KR_6699646087,420,4,85,46,9,5,6,1,3,5,2,-2,1,3,1,5,4,2,2,0,1,-4,8,2,4,6,1,0,4,1,1,1,1,4,1
KR_6758423163,440,0,113,1,3,4,4,0,-3,1,4,1,1,0,1,3,2,0,1,1,1,2,-39,-3,4,1,11,0,0,1,0,0,1,1,1
KR_6711902408,420,2,-3,16,2,3,4,1,2,4,2,-1,0,1,-2,0,2,0,0,0,0,0,-16,-2,9,7,5,0,0,1,1,0,1,4,1
KR_6737537348,420,-3,-14,-23,-2,1,1,0,-1,0,1,-1,0,1,-1,4,5,0,0,0,0,0,-31,4,5,9,-4,0,-1,1,-1,-1,1,3,1
KR_6742726494,420,6,65,38,18,1,3,2,3,3,0,4,4,0,9,11,2,1,1,0,1,18,-163,-1,7,6,1,0,3,1,-1,1,1,6,1
KR_6760825195,440,-1,38,-44,2,0,1,1,2,2,0,2,6,4,-3,4,7,1,3,2,0,7,-2,1,6,7,0,0,0,1,-1,0,1,4,1
KR_6764485834,440,0,31,-2,2,0,1,1,-1,2,3,-1,0,1,3,3,0,1,1,0,0,5,-39,1,6,7,12,0,0,1,1,0,1,6,1
KR_6763733545,420,7,130,16,9,0,1,1,0,3,3,4,6,2,3,5,2,2,2,0,1,6,174,1,4,5,0,0,3,1,-1,1,1,1,1
KR_6709978328,420,4,19,14,9,1,2,1,2,3,1,2,2,0,4,4,0,0,0,0,0,10,-1,3,3,6,3,0,2,1,1,1,1,4,1
KR_6748493205,420,2,28,8,6,0,2,2,-1,2,3,5,6,1,3,5,2,-1,0,1,0,-2,153,-2,7,5,-3,0,0,1,-1,1,1,5,1
KR_6756314574,440,6,77,-12,13,0,2,2,1,3,2,5,6,1,2,5,3,5,5,0,0,7,-8,7,0,7,1,0,1,-1,1,1,1,3,1
KR_6718303642,420,3,43,32,8,0,3,3,-3,0,3,5,6,1,6,6,0,0,0,0,1,10,7,-1,7,6,-1,0,1,1,1,1,-1,2,1
KR_6745141564,440,7,103,28,10,1,5,4,2,4,2,5,7,2,0,2,2,2,2,0,0,13,-4,-1,6,5,9,0,1,1,1,1,-1,5,1
KR_6764518135,420,0,26,9,1,-4,0,4,2,6,4,-2,1,3,4,4,0,1,1,0,0,5,-1,5,3,8,-1,0,0,1,-1,-1,1,5,1
KR_6741108855,420,-1,-28,-26,-2,2,2,0,-1,4,5,0,4,4,-2,0,2,-1,1,2,0,0,7,2,4,6,0,0,0,1,1,0,1,1,1
KR_6754129521,420,4,43,-16,16,8,10,2,2,4,2,6,7,1,2,5,3,-2,1,3,0,13,-44,5,2,7,14,0,1,1,1,1,1,5,1
KR_6729341053,420,1,31,24,2,0,1,1,-3,1,4,0,1,1,5,5,0,0,0,0,0,6,33,-3,9,6,1,0,0,1,-1,1,1,5,1
KR_6768665245,420,0,-61,-2,4,2,2,0,0,1,1,0,1,1,2,2,0,0,4,4,0,3,13,1,7,8,-4,0,-1,1,1,-1,1,5,1
KR_6767438071,420,6,48,0,8,5,5,0,0,3,3,4,6,2,-1,2,3,0,1,1,0,-1,-3,7,3,10,9,0,1,-1,1,1,1,5,1
KR_6768219619,420,0,7,-19,1,3,3,0,-3,3,6,-1,1,2,5,7,2,-3,0,3,0,-3,8,3,3,6,-1,0,0,-1,1,0,-1,4,1
KR_6682707910,420,7,46,34,14,1,2,1,2,4,2,3,3,0,4,5,1,4,4,0,1,21,120,6,3,9,-4,0,0,1,1,1,1,1,1
KR_6768562555,420,0,3,-28,-4,0,2,2,-1,1,2,-3,0,3,0,4,4,0,0,0,-1,-7,6,-2,8,6,0,0,1,1,1,1,-1,6,1
KR_6760540492,420,3,35,-26,7,3,4,1,3,4,1,2,4,2,-1,0,1,0,0,0,0,7,0,5,1,6,2,0,0,-1,1,0,1,6,1
KR_6739211620,440,2,81,23,5,5,7,2,-5,3,8,0,1,1,3,4,1,2,2,0,0,10,1,2,3,5,-1,0,2,1,1,1,1,3,1
KR_6687843541,420,0,-4,5,2,-1,2,3,-3,0,3,4,6,2,2,5,3,0,0,0,0,3,-25,-2,7,5,2,0,-1,1,1,-1,-1,2,1
KR_6748547874,420,-3,-39,-12,2,1,2,1,-2,1,3,-1,3,4,0,1,1,4,4,0,0,-3,19,2,4,6,-6,0,-1,1,1,1,1,2,1
KR_6711273667,420,0,16,-11,4,-1,3,4,-1,1,2,2,7,5,2,2,0,2,4,2,0,1,13,2,4,6,-3,0,2,0,1,1,1,0,1
KR_6588540368,420,2,65,2,9,-1,2,3,1,4,3,1,6,5,6,7,1,2,2,0,-1,0,26,5,4,9,-4,0,2,1,1,1,-1,4,1
KR_6710422708,420,2,-16,27,5,6,6,0,-1,1,2,0,3,3,-2,1,3,2,3,1,0,7,221,-5,8,3,2,0,1,-1,1,1,-1,6,1
KR_6742909175,420,2,8,26,5,-4,0,4,2,5,3,2,2,0,5,5,0,0,0,0,-1,3,4,2,1,3,-3,0,1,1,1,1,-1,5,1
KR_6768863167,420,1,-5,48,-8,-5,0,5,0,2,2,-3,0,3,0,5,5,0,2,2,0,-11,-11,-2,9,7,2,0,1,-1,1,1,1,1,1
KR_6618613028,420,-2,8,-20,3,-1,1,2,0,5,5,0,2,2,5,8,3,-1,1,2,1,9,5,1,6,7,1,0,0,-1,-1,1,1,5,1
KR_6708878447,440,1,32,15,-1,0,2,2,1,3,2,1,2,1,-1,2,3,-2,2,4,0,-2,5,-3,5,2,-4,0,0,1,-1,0,-1,1,1
KR_6611218827,420,3,115,-5,5,4,4,0,0,2,2,-1,2,3,2,2,0,0,0,0,0,-2,0,1,6,7,2,0,1,1,-1,1,1,6,1
KR_6735743873,440,-2,-4,-8,-9,-3,1,4,-3,4,7,1,3,2,-4,0,4,0,2,2,0,-8,198,-1,4,3,5,0,0,-1,-1,0,-1,5,1
KR_6768209478,440,2,0,-17,7,-3,1,4,4,4,0,3,4,1,1,1,0,2,2,0,0,4,3,-3,8,5,1,0,0,1,-1,1,1,6,1
KR_6749877645,420,-1,-24,18,2,0,2,2,1,4,3,4,5,1,-3,1,4,0,0,0,-2,-8,7,-3,6,3,-1,0,0,-1,1,1,-1,2,1
KR_6754208522,420,0,40,10,6,4,4,0,2,4,2,0,2,2,2,3,1,-2,3,5,0,-3,2,2,4,6,1,0,-1,1,1,-1,1,4,1
KR_6750820412,420,0,19,23,-5,1,4,3,2,3,1,0,3,3,-4,1,5,-4,0,4,0,-12,7,3,2,5,-1,0,1,-1,1,1,1,1,1
KR_6769483087,420,3,-12,1,7,4,4,0,1,3,2,5,7,2,-2,1,3,-1,0,1,0,4,4,1,8,9,4,0,0,1,1,1,-1,5,1
KR_6763907410,420,3,34,17,4,6,7,1,0,3,3,-2,1,3,1,7,6,-1,0,1,0,-2,37,3,1,4,2,0,2,-1,1,1,1,5,1
KR_6769688404,440,1,65,5,0,-1,0,1,0,3,3,1,3,2,-1,2,3,1,2,1,0,-2,-7,-7,9,2,5,0,1,0,-1,1,-1,0,1
KR_6767718996,420,-1,-41,12,-7,1,3,2,-1,2,3,1,3,2,-4,2,6,-4,0,4,0,-4,40,0,3,3,-3,0,-2,-1,-1,-1,-1,1,1
KR_6758619481,420,-1,-42,28,0,1,4,3,-3,0,3,0,1,1,1,2,1,1,1,0,0,0,16,0,8,8,-3,0,2,-1,1,1,1,5,1
KR_6751598059,420,3,5,16,1,-1,0,1,4,5,1,2,3,1,-5,2,7,1,5,4,0,4,46,4,4,8,-2,0,0,1,1,0,-1,2,1
KR_6683866010,420,-2,31,24,-4,-3,1,4,1,2,1,-2,0,2,0,5,5,0,2,2,1,-3,-49,-3,8,5,-2,0,0,-1,1,1,1,5,1
KR_6620025271,420,2,21,-28,2,0,1,1,-1,3,4,0,3,3,3,7,4,0,1,1,0,5,-33,-4,4,0,-2,0,0,-1,-1,1,-1,2,1
KR_6763408653,440,0,31,20,7,3,3,0,-4,0,4,1,1,0,3,8,5,4,4,0,0,-1,-1,1,4,5,1,0,3,1,1,1,1,3,1
KR_6750814411,420,2,126,9,11,3,4,1,3,5,2,0,4,4,4,4,0,1,1,0,2,10,166,0,3,3,4,0,1,1,1,1,1,1,1
KR_6682192520,420,5,37,55,14,5,6,1,7,8,1,3,4,1,-1,2,3,0,2,2,0,11,8,-2,5,3,0,0,0,1,1,1,1,5,1
KR_6766956139,420,2,41,-7,10,5,7,2,2,7,5,-1,3,4,2,3,1,2,2,0,0,1,0,3,6,9,2,0,3,1,1,1,1,3,1
KR_6684030275,440,1,7,13,4,3,3,0,5,6,1,-3,1,4,-1,1,2,0,1,1,0,6,-6,3,5,8,1,0,1,-1,1,1,-1,5,1
KR_6688056549,420,0,53,8,-5,-2,4,6,1,2,1,-3,1,4,-2,1,3,1,1,0,-1,-6,3,-1,4,3,-2,0,-1,1,-1,-1,-1,3,1
KR_6764987795,420,6,53,16,8,-3,1,4,2,3,1,3,3,0,4,4,0,2,2,0,0,16,-139,-3,8,5,5,0,3,-1,1,1,1,1,1
KR_6742534317,420,0,32,-7,-1,0,2,2,-3,3,6,-2,1,3,4,6,2,0,1,1,0,2,-31,-4,8,4,-2,0,0,1,-1,1,-1,4,1
KR_6770431226,440,0,-42,-24,2,2,3,1,3,5,2,-4,0,4,0,3,3,1,3,2,0,4,-9,0,5,5,-2,0,0,-1,1,1,1,1,1
KR_6634820717,420,4,-24,23,0,2,3,1,-1,3,4,0,2,2,-1,0,1,0,0,0,0,2,5,-1,6,5,0,0,-1,1,-1,-1,-1,3,1
KR_6769121962,420,-2,-4,-16,2,-2,0,2,2,4,2,2,3,1,0,4,4,0,1,1,1,9,5,0,5,5,-4,0,0,1,-1,0,1,3,1
KR_6769872710,420,-1,6,-1,-1,4,4,0,-3,1,4,2,2,0,-3,1,4,-1,1,2,0,-3,123,1,5,6,-5,0,0,1,-1,0,1,3,1
KR_6680041960,420,-2,-18,33,-3,-3,0,3,-1,2,3,-1,1,2,1,4,3,1,1,0,0,-5,16,-1,5,4,-6,0,0,-1,0,0,1,3,1
KR_6597895967,420,2,42,39,-6,1,3,2,1,3,2,-3,0,3,-4,2,6,-1,2,3,0,-11,-72,3,8,11,-6,0,0,-1,0,1,-1,5,1
KR_6750166957,440,2,132,-8,7,-1,3,4,-2,3,5,4,6,2,6,6,0,0,0,0,0,12,10,-2,6,4,3,0,4,-1,0,1,1,1,1
KR_6749419030,420,-2,-2,-25,-5,-1,1,2,-1,1,2,4,7,3,-6,2,8,-1,1,2,0,-10,-8,-1,6,5,-4,0,1,-1,-1,1,-1,3,1
KR_6719033865,420,10,123,51,24,6,6,0,6,6,0,5,6,1,5,8,3,2,2,0,0,21,-53,1,5,6,29,0,3,1,1,1,1,3,1
KR_6749937574,420,-4,-48,24,-7,2,2,0,-3,2,5,-5,0,5,-1,3,4,0,3,3,0,-11,-9,-4,9,5,4,0,1,1,1,1,1,4,1
KR_6729323216,420,0,-1,10,-2,4,5,1,-2,2,4,-3,3,6,1,1,0,-2,0,2,0,-2,-177,1,4,5,2,0,0,1,1,1,1,2,1
KR_6768168884,420,-1,-9,-3,-1,2,4,2,1,4,3,-1,1,2,-1,3,4,-2,0,2,0,-5,-2,5,2,7,-5,0,0,1,1,-1,-1,6,1
KR_6756238976,420,-1,-3,4,-4,3,4,1,1,2,1,-5,0,5,-4,1,5,1,1,0,0,-9,16,-1,7,6,1,0,0,1,-1,-1,-1,1,1
KR_6770489134,420,-1,25,-16,2,-1,1,2,5,10,5,4,6,2,-7,2,9,1,1,0,-2,-4,-27,5,6,11,6,0,1,1,-1,1,-1,5,1
KR_6767476303,420,1,-26,32,7,2,4,2,3,6,3,2,2,0,1,3,2,-1,1,2,1,6,9,3,4,7,-2,0,1,-1,1,1,1,6,1
KR_6770163506,420,3,60,-12,2,-1,1,2,1,3,2,-2,0,2,4,4,0,0,1,1,0,5,4,2,2,4,-4,0,0,1,1,1,1,5,1
KR_6722215908,420,4,-9,35,2,-1,0,1,-2,0,2,7,8,1,-2,0,2,0,2,2,0,-3,6,-5,7,2,-2,0,1,1,1,1,1,5,1
KR_6750540055,420,-5,-17,-1,-13,-6,1,7,-3,1,4,-1,3,4,-3,3,6,0,1,1,0,-10,0,0,4,4,-2,0,0,1,-1,-1,1,4,1
KR_6695400610,420,5,71,-11,10,0,2,2,5,6,1,3,6,3,2,5,3,0,1,1,0,8,-7,5,4,9,0,0,1,1,1,1,1,4,1
KR_6761633081,420,3,50,12,5,5,5,0,4,5,1,2,2,0,-4,0,4,-2,1,3,-1,1,-8,-3,8,5,1,0,2,-1,1,1,-1,6,1
KR_6695421016,420,0,-38,4,-4,-2,1,3,-6,2,8,1,4,3,-3,4,7,6,6,0,0,-4,6,-13,16,3,-4,0,0,1,-1,-1,1,3,1
KR_6745221238,420,2,73,7,2,1,3,2,3,4,1,1,3,2,-3,0,3,0,1,1,0,4,8,0,5,5,0,0,1,1,1,1,1,1,1
KR_6770377613,420,5,-6,31,11,1,2,1,0,3,3,3,5,2,4,5,1,3,3,0,0,16,9,-3,6,3,-1,0,0,1,1,-1,1,4,1
KR_6761827243,440,2,22,-16,1,-5,0,5,1,3,2,5,6,1,1,1,0,-1,3,4,-1,4,-4,-1,4,3,1,0,1,-1,-1,1,-1,4,1
KR_6769130627,420,3,27,-20,12,-2,0,2,3,3,0,7,7,0,2,3,1,2,6,4,0,8,6,4,1,5,0,0,1,-1,1,1,1,1,1
KR_6769792411,420,3,3,15,-2,2,3,1,-2,2,4,0,4,4,0,1,1,-2,0,2,0,-11,-9,-4,7,3,5,0,1,-1,1,1,1,2,1
KR_6725669755,420,2,-43,-20,10,2,2,0,1,4,3,1,1,0,6,7,1,0,1,1,0,17,26,0,4,4,0,0,1,1,-1,1,1,4,1
KR_6754227736,420,5,46,24,13,4,4,0,1,2,1,0,0,0,1,4,3,7,8,1,0,13,3,-1,6,5,-5,0,1,-1,1,1,1,3,1
KR_6761877075,420,-4,-69,-16,-12,-8,0,8,2,2,0,-4,1,5,-2,4,6,0,2,2,1,-6,0,-3,5,2,-3,0,-2,1,-1,-1,1,1,1
KR_6685408847,420,2,78,-24,4,1,2,1,-1,4,5,-2,0,2,6,7,1,0,3,3,2,4,-8,-1,6,5,7,0,1,1,1,1,-1,1,1
KR_6765607117,420,3,16,16,5,0,1,1,2,3,1,3,4,1,1,1,0,-1,0,1,0,5,0,5,3,8,-4,0,1,1,1,1,-1,2,1
KR_6745581129,420,0,27,6,3,2,3,1,-4,1,5,2,4,2,5,6,1,-2,1,3,0,4,-6,-4,11,7,1,0,-2,1,-1,-1,-1,6,1
KR_6742374140,440,5,58,22,10,0,1,1,0,1,1,6,6,0,1,3,2,3,5,2,0,5,-1,0,1,1,0,0,1,1,-1,1,1,6,1
KR_6682281719,420,2,60,52,5,0,2,2,-2,2,4,2,2,0,5,6,1,0,0,0,0,7,37,2,5,7,3,0,0,0,1,1,1,0,1
KR_6709298071,420,-4,-41,24,-8,-4,1,5,-2,2,4,0,1,1,-2,3,5,0,0,0,0,3,-2,-1,7,6,-1,0,0,-1,1,0,-1,5,1
KR_6769493042,420,9,153,22,16,6,7,1,1,4,3,4,6,2,2,2,0,3,3,0,0,2,2,2,3,5,-1,0,2,1,1,1,1,6,1
KR_6611579226,420,3,53,41,9,-1,1,2,3,5,2,2,6,4,5,5,0,0,0,0,1,21,9,-1,8,7,1,0,2,1,1,1,1,1,1
KR_6646652921,420,0,-12,3,3,2,4,2,1,2,1,4,5,1,-3,2,5,-1,1,2,0,1,-2,1,7,8,0,0,-1,-1,-1,-1,-1,5,1
KR_6713777757,420,4,0,13,3,-1,1,2,4,6,2,1,5,4,-2,0,2,1,1,0,0,1,-49,-5,7,2,29,0,1,1,1,-1,1,4,1
KR_6763778604,420,1,65,-5,4,0,2,2,3,4,1,0,1,1,0,2,2,1,2,1,0,7,-1,0,6,6,6,0,1,-1,1,1,1,5,1
KR_6707606487,420,0,-23,-4,-1,-3,1,4,2,3,1,2,3,1,-1,4,5,-1,0,1,-3,0,-3,-2,6,4,3,0,0,-1,-1,-1,-1,2,1
KR_6678449039,440,4,81,46,7,0,1,1,-1,1,2,3,9,6,4,4,0,1,3,2,0,3,10,2,3,5,-2,0,2,1,1,1,1,5,1
KR_6769003689,420,-1,-75,0,-2,-2,0,2,0,3,3,-1,1,2,-4,2,6,5,5,0,0,-2,-5,1,3,4,4,0,-1,1,1,-1,-1,3,1
KR_6660837226,420,7,64,39,18,1,2,1,3,4,1,7,7,0,6,6,0,1,2,1,0,22,19,3,0,3,0,0,4,1,1,1,1,6,1
KR_6769966223,420,0,19,-5,-4,-3,0,3,0,2,2,-2,2,4,2,2,0,-1,1,2,1,1,35,2,5,7,1,0,1,-1,1,1,1,6,1
KR_6755054702,420,2,11,0,6,1,4,3,4,7,3,1,3,2,0,1,1,0,1,1,0,1,10,5,3,8,-7,0,0,-1,1,-1,-1,4,1
KR_6764139953,420,1,99,11,3,0,2,2,3,5,2,-1,2,3,2,4,2,-1,2,3,0,2,4,1,3,4,3,0,0,-1,1,1,1,1,1
KR_6724408728,420,3,29,-18,6,-1,2,3,5,7,2,4,5,1,-1,3,4,-1,3,4,-1,-3,-6,3,5,8,7,0,2,-1,1,1,-1,5,1
KR_6767292439,440,1,2,15,4,1,1,0,4,5,1,2,2,0,-1,0,1,-2,0,2,0,5,-32,0,5,5,31,0,0,1,1,0,1,5,1
KR_6763845004,420,-1,-27,33,-1,-2,1,3,4,4,0,-2,1,3,-1,3,4,0,1,1,0,0,3,0,6,6,-1,0,0,1,-1,0,1,2,1
KR_6767050430,440,0,27,8,5,-1,3,4,-1,1,2,0,2,2,2,5,3,5,5,0,0,2,5,3,5,8,-1,0,0,1,1,0,1,3,1
KR_6725031920,440,2,-23,-15,1,3,5,2,0,4,4,0,3,3,-4,1,5,2,2,0,-3,-1,-8,-4,10,6,-3,0,-1,1,-1,-1,-1,2,1
KR_6736276995,420,-1,-7,19,1,3,3,0,-3,0,3,-3,1,4,2,6,4,2,3,1,0,5,51,4,6,10,-7,0,1,-1,1,1,1,2,1
KR_6706861984,420,4,27,25,10,0,3,3,1,3,2,1,2,1,7,7,0,1,1,0,0,11,2,4,2,6,4,0,2,-1,1,1,-1,6,1
KR_6737280381,440,0,25,15,-2,-1,1,2,-7,0,7,2,2,0,3,4,1,1,1,0,0,-4,19,0,5,5,-1,0,1,1,-1,1,-1,1,1
KR_6668392571,420,-2,-39,32,-4,-1,1,2,1,6,5,-2,0,2,-3,3,6,1,1,0,0,-1,-4,-6,9,3,-3,0,-1,1,-1,-1,-1,1,1
KR_6700324125,420,1,51,-31,4,0,0,0,2,3,1,-1,1,2,3,5,2,0,1,1,0,5,24,5,4,9,2,0,0,-1,-1,0,1,1,1
KR_6759144456,420,-2,27,-32,4,0,0,0,3,5,2,1,5,4,-3,1,4,3,3,0,0,0,5,-1,5,4,-2,0,0,-1,-1,-1,-1,3,1
KR_6730006947,420,4,81,12,8,0,1,1,-1,3,4,0,1,1,7,8,1,2,2,0,1,6,-9,-3,9,6,-1,0,1,1,1,1,1,3,1
KR_6733812354,420,6,76,33,15,1,2,1,6,6,0,0,1,1,4,6,2,4,4,0,1,20,17,7,3,10,-5,0,1,1,1,1,1,3,1
KR_6758746560,420,3,43,16,8,2,3,1,0,2,2,0,4,4,4,7,3,2,3,1,0,7,-21,1,5,6,8,0,0,-1,1,0,-1,3,1
KR_6667853553,420,-2,-44,-13,-8,-3,1,4,-2,1,3,-4,0,4,5,7,2,-4,1,5,0,3,36,2,7,9,-17,0,-1,-1,-1,-1,1,6,1
KR_6767366716,420,-2,10,-48,7,2,2,0,6,7,1,-3,2,5,1,3,2,1,1,0,0,10,-39,0,7,7,3,0,0,1,1,0,1,1,1
KR_6769929455,440,-3,-50,-8,-4,5,5,0,-5,1,6,1,2,1,-3,5,8,-2,1,3,0,-13,37,0,3,3,-2,0,-2,-1,1,-1,1,1,1
KR_6676959684,420,-2,-39,-3,-9,-1,4,5,-5,1,6,-2,0,2,-2,3,5,1,1,0,-1,-13,-1,0,5,5,0,0,0,1,1,1,-1,4,1
KR_6665195119,420,5,33,29,4,3,3,0,2,5,3,2,3,1,-2,3,5,-1,0,1,0,6,-4,-2,7,5,0,0,1,1,1,1,1,3,1
KR_6746067998,420,1,78,24,8,0,0,0,3,4,1,4,5,1,1,2,1,0,0,0,0,8,1,4,4,8,10,0,0,1,-1,-1,1,2,1
KR_6762162639,440,5,22,3,11,1,1,0,1,3,2,4,5,1,4,7,3,1,3,2,0,1,42,2,1,3,-26,0,1,-1,1,1,1,5,1
KR_6721572921,420,3,107,16,5,4,8,4,3,4,1,3,5,2,0,4,4,-5,3,8,-2,-3,-1,2,4,6,-1,0,1,1,1,1,-1,4,1
KR_6750966499,420,1,-18,-6,5,1,2,1,0,3,3,-2,2,4,4,4,0,2,2,0,0,14,-47,-5,9,4,31,0,0,1,1,-1,-1,5,1
KR_6749076611,420,1,56,25,12,3,5,2,3,5,2,3,4,1,3,4,1,0,1,1,0,8,-6,-4,7,3,0,0,1,1,1,1,1,5,1
KR_6696696667,420,1,71,-16,3,1,4,3,-1,2,3,-1,1,2,4,4,0,0,0,0,0,4,27,-1,2,1,2,0,1,-1,1,1,1,1,1
KR_6766107733,440,-1,23,31,-3,0,2,2,2,3,1,-1,0,1,-4,0,4,0,0,0,0,-3,42,3,5,8,3,0,0,1,1,0,1,2,1
KR_6760130581,420,6,86,0,9,-3,3,6,6,7,1,1,2,1,6,8,2,-1,0,1,-1,10,9,6,1,7,-2,0,2,1,-1,1,1,2,1
KR_6645147857,420,1,-42,4,-1,1,5,4,3,4,1,3,4,1,-3,2,5,-5,0,5,0,1,4,0,5,5,-2,0,-2,1,-1,-1,-1,6,1
KR_6655475811,420,2,12,3,5,-1,2,3,-2,3,5,8,8,0,0,1,1,0,2,2,1,5,1,4,4,8,1,0,1,1,1,1,1,3,1
KR_6742431983,420,2,-20,8,-1,-2,1,3,-2,0,2,1,1,0,3,3,0,-1,0,1,0,1,2,2,5,7,1,0,0,1,1,0,1,6,1
KR_6723721417,420,2,-18,8,4,1,3,2,0,2,2,3,4,1,-2,0,2,2,2,0,0,1,-38,-6,9,3,5,0,0,-1,1,0,1,5,1
KR_6724995601,420,6,56,31,10,2,5,3,5,7,2,8,8,0,-2,3,5,-3,2,5,0,2,-4,2,3,5,0,0,3,-1,1,1,-1,1,1
KR_6767131739,420,1,-31,-20,3,-1,1,2,1,2,1,2,3,1,0,7,7,1,1,0,2,15,0,1,5,6,-2,0,1,1,-1,1,1,3,1
KR_6760845898,420,-1,40,11,-1,1,1,0,1,5,4,0,4,4,-2,3,5,-1,0,1,0,-3,-2,6,3,9,-2,0,-1,1,1,-1,-1,4,1
KR_6691097817,420,0,5,-9,-2,-1,1,2,-8,1,9,1,2,1,5,5,0,1,2,1,-1,-6,2,2,5,7,-4,0,1,-1,-1,1,-1,4,1
KR_6764163044,420,3,85,33,3,3,3,0,1,2,1,1,3,2,-1,0,1,-1,0,1,0,1,-114,0,5,5,2,0,0,1,-1,-1,-1,6,1
KR_6707465775,420,3,31,-7,14,0,3,3,2,3,1,3,4,1,10,12,2,-1,2,3,3,17,3,3,2,5,-2,0,1,-1,1,1,1,1,1
KR_6763778800,420,4,78,28,15,4,5,1,3,4,1,5,7,2,1,3,2,2,3,1,1,7,-9,-2,6,4,-1,0,2,-1,-1,1,1,3,1
KR_6761625284,420,5,71,37,13,2,2,0,1,3,2,6,8,2,4,7,3,0,0,0,0,13,-34,-4,9,5,6,0,1,1,1,1,1,4,1
KR_6620502639,420,1,19,-27,3,-3,2,5,2,3,1,3,4,1,1,4,3,0,1,1,0,3,261,-2,8,6,3,0,0,1,-1,1,-1,6,1
KR_6761495362,440,2,31,27,1,0,4,4,4,4,0,-4,0,4,0,4,4,1,1,0,0,0,2,-1,7,6,-2,0,1,0,0,1,1,0,1
KR_6752327850,420,4,10,24,15,0,0,0,3,9,6,3,5,2,12,13,1,-3,0,3,3,20,-189,-2,6,4,4,0,0,1,1,1,1,3,1
KR_6752636926,420,-1,13,17,-3,1,1,0,-2,3,5,-3,0,3,0,1,1,1,1,0,0,-5,-3,1,5,6,2,0,0,1,-1,0,1,2,1
KR_6758176566,420,4,4,6,6,3,6,3,2,4,2,0,1,1,1,2,1,0,2,2,0,6,4,0,7,7,-4,0,1,1,1,1,-1,3,1
KR_6729668556,420,0,-53,7,-3,-3,1,4,3,6,3,1,2,1,-3,4,7,-1,0,1,0,-2,92,-2,7,5,2,0,-1,-1,-1,-1,1,3,1
KR_6766154242,420,6,67,10,16,1,1,0,5,8,3,2,3,1,7,8,1,1,2,1,0,12,1,8,0,8,-6,0,1,1,-1,1,1,1,1
KR_6768618852,420,1,19,0,3,-3,3,6,2,4,2,0,4,4,2,3,1,2,2,0,0,5,-1,4,3,7,2,0,0,1,1,0,1,3,1
KR_6760844792,420,3,41,25,4,0,1,1,1,4,3,-1,2,3,5,6,1,-1,1,2,0,5,-11,-3,9,6,2,0,0,-1,-1,0,1,5,1
KR_6712021068,420,-2,-101,-3,-2,6,7,1,-3,0,3,0,3,3,-2,6,8,-3,2,5,-1,-3,-3,-2,8,6,-2,0,1,1,1,-1,-1,2,1
KR_6756304629,420,1,-36,23,-4,3,3,0,2,5,3,-2,1,3,-7,1,8,0,4,4,0,-10,20,-2,8,6,-2,0,0,0,1,0,-1,0,1
KR_6768562102,420,-1,14,-14,-5,-3,0,3,3,6,3,-4,0,4,-1,0,1,0,0,0,0,-6,24,-1,7,6,-4,0,0,1,-1,0,1,2,1
KR_6724937540,420,-1,-27,-20,-3,-5,0,5,-4,0,4,3,5,2,3,3,0,0,1,1,-1,-10,5,0,5,5,-1,0,0,1,1,0,-1,3,1
KR_6759659347,420,1,26,8,0,-3,0,3,-1,0,1,0,1,1,4,5,1,0,0,0,0,1,-9,-5,7,2,7,0,-1,1,-1,-1,-1,1,1
KR_6761871195,440,9,110,21,12,3,3,0,5,5,0,0,1,1,2,2,0,2,4,2,0,10,-25,2,3,5,15,0,4,1,1,1,1,5,1
KR_6770362417,420,4,92,-4,7,5,6,1,1,2,1,-1,0,1,2,2,0,0,0,0,0,3,6,-1,5,4,-1,0,1,1,-1,1,1,2,1
KR_6711124164,420,0,47,10,3,3,6,3,0,3,3,0,2,2,1,3,2,-1,0,1,0,-4,11,-1,7,6,2,0,0,1,1,0,1,3,1
KR_6768314391,420,2,10,17,-3,4,4,0,0,2,2,2,4,2,-9,2,11,0,0,0,0,-9,-8,-8,11,3,1,0,0,-1,1,-1,1,2,1
KR_6762298954,420,1,2,-10,0,-2,2,4,5,8,3,-2,0,2,-1,1,2,0,1,1,-1,4,-8,-1,6,5,4,0,0,1,1,0,-1,2,1
KR_6744931204,420,-1,-4,-5,-6,-3,0,3,-4,1,5,-5,0,5,7,8,1,-1,0,1,-2,-1,9,2,4,6,-3,0,1,-1,-1,1,-1,6,1
KR_6749130305,420,1,9,5,-1,-2,3,5,0,4,4,0,2,2,1,2,1,0,2,2,0,6,10,0,3,3,1,0,0,1,1,1,1,4,1
KR_6739559286,420,3,54,43,5,2,4,2,2,4,2,1,1,0,0,3,3,0,2,2,1,5,-6,0,5,5,0,0,1,1,1,1,1,2,1
KR_6740383097,420,0,49,8,0,2,4,2,0,3,3,-2,0,2,1,2,1,-1,1,2,0,-2,42,0,6,6,-1,0,0,1,-1,0,1,1,1
KR_6770299691,420,0,48,-9,-5,0,2,2,-1,5,6,-1,3,4,-1,2,3,-2,0,2,0,-12,-19,3,6,9,0,0,1,-1,1,1,-1,1,1
KR_6765755852,420,2,21,-6,6,1,1,0,2,3,1,-1,1,2,3,3,0,1,2,1,0,1,-63,6,1,7,26,0,2,1,1,1,1,4,1
KR_6767493837,420,6,130,51,9,5,6,1,1,3,2,-3,0,3,8,9,1,-2,1,3,0,8,12,-1,3,2,-2,0,3,1,1,1,-1,6,1
KR_6741476366,420,0,36,18,2,1,1,0,2,2,0,2,5,3,-2,1,3,-1,0,1,0,-3,4,5,5,10,-4,0,1,1,1,1,-1,4,1
KR_6728596984,420,2,26,-12,11,4,5,1,4,9,5,3,5,2,0,1,1,0,0,0,-1,2,23,4,7,11,-4,0,4,1,1,1,-1,5,1
KR_6763311005,440,7,58,44,17,-1,1,2,2,6,4,4,6,2,9,10,1,3,4,1,0,18,-13,1,4,5,0,0,1,1,-1,1,1,6,1
KR_6767266916,420,3,45,-22,9,7,9,2,-3,0,3,0,1,1,4,7,3,1,1,0,0,9,13,2,6,8,2,0,1,-1,1,1,1,3,1
KR_6763716576,420,3,37,28,14,7,7,0,0,2,2,7,7,0,0,0,0,0,0,0,0,7,40,4,1,5,0,0,1,1,1,1,1,2,1
KR_6753783378,420,-2,-24,0,-4,4,5,1,-8,0,8,1,3,2,0,1,1,-1,0,1,0,-10,2,2,4,6,-3,0,1,1,1,1,-1,5,1
KR_6768172726,420,5,64,8,15,2,4,2,2,3,1,2,6,4,6,8,2,3,3,0,0,21,9,2,4,6,-2,0,1,1,1,1,1,4,1
KR_6764527307,420,-3,68,33,-5,1,2,1,-4,1,5,-2,2,4,2,5,3,-2,1,3,0,-6,-15,2,3,5,-4,0,0,0,0,0,-1,0,1
KR_6703275330,440,3,11,-9,3,5,6,1,0,3,3,6,8,2,-6,2,8,-2,0,2,0,-8,169,1,4,5,4,0,1,-1,1,1,1,1,1
KR_6743023668,420,0,-41,37,0,-1,2,3,1,2,1,6,7,1,-1,1,2,-5,0,5,0,6,-2,1,2,3,-3,0,0,1,1,0,-1,5,1
KR_6756359274,420,3,34,16,9,7,8,1,4,10,6,-7,1,8,3,3,0,2,3,1,1,5,24,4,2,6,2,0,1,-1,-1,1,1,3,1
KR_6769992722,420,1,20,-6,5,0,1,1,3,5,2,-1,1,2,1,2,1,2,4,2,0,11,116,2,6,8,-6,0,2,1,-1,1,-1,2,1
KR_6692548950,420,3,-19,6,7,5,5,0,0,2,2,2,2,0,-1,2,3,1,2,1,0,7,89,2,2,4,-2,0,0,1,1,0,-1,4,1
KR_6726130592,420,6,68,20,17,-3,3,6,1,4,3,15,15,0,2,4,2,2,2,0,0,18,-4,-2,6,4,5,0,1,1,1,1,1,1,1
KR_6767811939,420,-4,-3,-25,-3,0,2,2,-2,0,2,2,2,0,-3,0,3,0,1,1,-1,-6,15,-3,5,2,-5,0,0,-1,-1,0,-1,4,1
KR_6748468357,420,2,82,-8,6,1,1,0,-1,2,3,5,6,1,3,3,0,-2,0,2,0,2,37,2,7,9,4,0,0,1,0,1,1,4,1
KR_6750870925,420,-3,-33,1,-4,5,7,2,0,2,2,-1,0,1,-1,1,2,-7,2,9,0,-2,48,2,5,7,-12,0,2,-1,1,1,1,4,1
KR_6739262904,420,2,-7,15,0,-1,1,2,-2,3,5,2,5,3,-1,1,2,2,4,2,-2,-1,-2,-5,6,1,1,0,1,-1,-1,1,-1,6,1
KR_6767624086,420,-2,-24,10,-2,-1,1,2,2,2,0,0,1,1,-7,2,9,4,4,0,1,8,-108,1,4,5,-2,0,0,-1,1,-1,1,6,1
KR_6685542729,420,4,82,3,12,-1,1,2,4,5,1,4,4,0,3,4,1,2,2,0,1,17,32,0,6,6,-19,0,1,-1,1,1,1,2,1
KR_6710209815,420,4,60,32,6,0,0,0,-3,2,5,0,0,0,8,8,0,1,1,0,0,13,-3,0,8,8,1,0,1,1,-1,1,-1,5,1
KR_6767045187,420,2,58,-24,3,-2,2,4,-1,1,2,4,4,0,5,9,4,-3,1,4,-2,-3,-3,0,4,4,4,0,2,0,1,1,-1,0,1
KR_6752293678,420,6,114,47,14,4,6,2,4,4,0,0,2,2,6,6,0,0,2,2,0,20,3,2,2,4,1,0,3,1,1,1,1,6,1
KR_6769869505,420,-1,-26,0,-3,2,2,0,-1,3,4,2,5,3,-5,1,6,-1,0,1,0,-7,3,-3,6,3,-1,0,-1,-1,1,1,1,3,1
KR_6636143459,420,1,55,2,7,2,4,2,-1,4,5,1,1,0,7,8,1,-2,0,2,0,9,6,4,1,5,5,0,1,1,-1,1,1,3,1
KR_6754614042,420,2,63,-17,6,0,1,1,6,7,1,0,2,2,-1,2,3,1,1,0,0,12,29,3,3,6,-3,0,2,1,0,1,1,6,1
KR_6648768711,420,0,58,-4,4,3,3,0,0,5,5,-1,1,2,1,4,3,1,2,1,0,4,7,0,6,6,4,0,-1,1,0,1,1,3,1
KR_6769186774,420,0,-45,-4,2,2,2,0,2,4,2,2,3,1,-3,0,3,-1,1,2,0,6,4,-3,6,3,0,0,-1,-1,-1,-1,-1,5,1
KR_6721607825,420,-2,-14,-12,1,0,1,1,0,2,2,5,5,0,-3,0,3,-1,1,2,0,5,22,2,5,7,2,0,-1,-1,-1,-1,-1,4,1
KR_6760226231,420,3,74,3,8,2,3,1,2,3,1,2,4,2,0,5,5,2,5,3,0,8,5,-3,10,7,3,0,1,1,-1,1,-1,3,1
KR_6762214518,420,3,10,19,13,0,2,2,3,6,3,1,2,1,3,4,1,6,7,1,3,20,29,-1,7,6,2,0,1,1,1,1,1,3,1
KR_6732645572,440,4,103,-30,4,2,2,0,1,2,1,2,3,1,0,0,0,-1,1,2,0,2,3,0,3,3,-3,0,0,0,-1,0,-1,0,1
KR_6679747785,420,-4,-73,11,-6,-1,0,1,-3,1,4,-2,0,2,-1,1,2,1,1,0,0,-6,-30,-4,7,3,1,0,0,-1,-1,0,-1,5,1
KR_6758200009,420,-1,-10,48,-4,-3,0,3,4,4,0,1,2,1,-4,0,4,-2,0,2,0,-6,10,3,4,7,1,0,2,1,1,1,-1,5,1
KR_6752267777,420,1,82,-24,0,-1,0,1,2,4,2,-3,0,3,1,2,1,1,1,0,0,3,1,0,5,5,0,0,0,1,-1,0,1,2,1
KR_6753481450,420,-3,-72,-9,-3,-2,1,3,-2,1,3,0,3,3,2,5,3,-1,1,2,0,5,-12,5,3,8,4,0,-2,1,-1,-1,-1,2,1
KR_6747881597,420,4,40,4,11,6,6,0,-1,3,4,3,5,2,1,4,3,2,2,0,0,7,-44,-5,9,4,4,0,1,1,1,1,1,6,1
KR_6631133189,420,-2,-25,9,0,1,2,1,-2,3,5,2,4,2,0,2,2,-1,2,3,0,-2,0,1,5,6,1,0,0,1,1,-1,-1,6,1
KR_6764227091,420,5,50,-30,10,3,3,0,4,4,0,-1,2,3,4,8,4,0,1,1,0,11,0,6,3,9,-1,0,1,1,-1,1,-1,2,1
KR_6616724423,420,2,60,61,5,2,2,0,0,2,2,-1,1,2,4,4,0,0,0,0,0,6,-8,5,5,10,-6,0,0,1,1,1,1,6,1
KR_6769218524,420,2,-11,16,-2,-1,0,1,-4,1,5,-2,2,4,6,7,1,-1,0,1,0,3,-3,1,7,8,-4,0,3,1,1,1,1,3,1
KR_6616845024,420,3,33,15,10,3,3,0,0,5,5,2,2,0,4,6,2,1,1,0,0,10,-8,4,3,7,-1,0,1,-1,1,1,1,2,1
KR_6769022230,440,3,113,0,0,1,2,1,-1,1,2,1,2,1,1,3,2,-2,0,2,0,-10,7,8,2,10,-4,0,1,1,-1,1,-1,4,1
KR_6745941895,420,-2,4,-24,-4,1,2,1,-3,0,3,2,3,1,0,1,1,-4,1,5,-1,-3,-4,-3,8,5,3,0,-1,-1,-1,-1,-1,3,1
KR_6727882079,420,0,-3,4,0,6,6,0,-1,3,4,-2,1,3,-2,1,3,-1,0,1,0,-6,-4,-2,5,3,1,0,1,-1,1,1,-1,2,1
KR_6715782774,420,2,-13,13,10,0,1,1,8,9,1,2,6,4,1,3,2,-1,1,2,0,7,2,3,4,7,2,0,1,1,1,1,1,1,1
KR_6742306696,440,-2,-3,-35,-3,-7,1,8,3,3,0,2,3,1,3,4,1,-4,0,4,0,-3,-21,-1,4,3,-3,0,0,0,-1,0,1,0,1
KR_6768857510,420,-1,41,6,-2,0,2,2,-3,3,6,2,3,1,-1,2,3,0,0,0,0,-4,3,0,8,8,9,0,1,1,1,1,-1,1,1
KR_6613898576,420,7,27,56,11,-4,0,4,0,3,3,5,7,2,9,11,2,1,3,2,0,10,-5,-2,6,4,7,0,2,1,1,1,1,5,1
KR_6767168650,420,5,69,11,19,4,5,1,4,5,1,11,11,0,1,3,2,-1,1,2,0,26,5,-1,7,6,4,0,2,-1,-1,1,1,5,1
KR_6765689731,420,2,5,16,2,-1,1,2,2,2,0,1,2,1,1,3,2,-1,0,1,0,6,-19,-2,6,4,-1,0,2,1,1,1,1,2,1
KR_6769789481,440,2,35,-7,13,-1,0,1,8,8,0,5,6,1,4,4,0,-3,2,5,2,19,22,2,2,4,-32,0,2,1,1,1,1,3,1
KR_6768816856,420,4,-26,46,2,0,3,3,4,5,1,1,5,4,-4,1,5,1,1,0,0,4,9,3,3,6,8,0,1,1,1,1,-1,4,1
KR_6764362609,420,0,46,15,-4,-2,1,3,1,7,6,2,5,3,0,2,2,-5,4,9,-3,-5,-16,3,4,7,-2,0,1,1,1,1,1,5,1
KR_6770395842,420,3,9,-16,11,-1,1,2,3,5,2,0,1,1,5,6,1,4,4,0,1,23,8,1,4,5,4,0,1,1,1,1,1,1,1
KR_6764347202,420,1,19,6,-2,1,1,0,1,2,1,0,4,4,-2,2,4,-2,1,3,1,-8,-25,0,4,4,3,0,1,1,1,1,1,2,1
KR_6760558550,420,2,112,-12,5,6,6,0,-5,1,6,2,5,3,2,3,1,0,1,1,0,5,-26,1,4,5,-2,0,1,1,-1,1,-1,4,1
KR_6770396724,420,0,24,-4,0,5,7,2,-1,1,2,-4,3,7,-3,0,3,3,5,2,0,-9,1,0,3,3,4,0,-1,-1,1,-1,1,2,1
KR_6741341389,420,7,33,4,18,4,4,0,2,3,1,11,12,1,-1,1,2,2,2,0,0,11,32,-1,5,4,-4,0,1,-1,1,-1,-1,1,1
KR_6766692274,420,1,48,17,8,8,8,0,-6,0,6,2,4,2,4,5,1,0,1,1,0,0,10,1,6,7,0,0,0,1,1,1,1,4,1
KR_6758845814,420,0,-5,-1,6,-3,2,5,2,5,3,4,5,1,4,4,0,-1,0,1,0,6,1,-2,6,4,2,0,0,1,1,0,1,3,1
KR_6766838580,440,-5,43,-16,-12,-1,1,2,-3,0,3,1,3,2,-9,1,10,0,9,9,0,-5,-1,-5,6,1,5,0,1,0,0,1,-1,0,1
KR_6753672226,420,1,-42,-7,4,3,3,0,5,5,0,-2,3,5,-1,1,2,-1,1,2,0,3,96,-1,7,6,1,0,-1,1,1,-1,1,1,1
KR_6729933573,420,1,16,-40,4,6,7,1,2,6,4,1,1,0,-5,1,6,0,1,1,0,4,-7,2,3,5,2,0,1,-1,-1,1,1,1,1
KR_6757657418,420,5,58,37,11,1,2,1,4,8,4,2,4,2,4,5,1,0,0,0,0,16,0,3,4,7,5,0,0,1,1,0,-1,2,1
KR_6697153275,440,1,-16,24,8,3,3,0,5,8,3,1,2,1,-1,3,4,0,0,0,0,8,3,4,4,8,-5,0,0,1,1,0,1,4,1
KR_6746978165,420,4,84,-13,9,0,1,1,2,4,2,5,6,1,2,3,1,0,1,1,-1,1,-2,6,3,9,4,0,0,-1,1,1,-1,3,1
KR_6628509678,420,3,0,-2,-5,-3,1,4,0,4,4,4,5,1,-5,1,6,-1,0,1,0,-6,-31,1,5,6,1,0,0,1,-1,0,-1,4,1
KR_6770484544,420,0,-4,-10,0,0,0,0,5,7,2,-2,0,2,-4,2,6,1,1,0,0,0,1,1,8,9,3,0,0,-1,0,0,1,6,1
KR_6768556724,420,2,13,36,6,-1,4,5,4,7,3,6,8,2,-1,3,4,-2,2,4,0,-1,-16,-1,4,3,3,0,0,1,-1,-1,1,1,1
KR_6754550758,420,1,16,-20,-3,1,2,1,1,4,3,3,5,2,-7,2,9,-1,1,2,0,0,-20,-2,10,8,5,0,-1,-1,-1,-1,-1,1,1
KR_6714167538,420,-1,67,-11,2,4,6,2,0,2,2,-1,1,2,-1,1,2,0,0,0,0,2,5,5,4,9,1,0,0,1,1,1,1,6,1
KR_6762844651,440,-2,-90,5,2,3,3,0,5,6,1,2,3,1,-5,2,7,-3,2,5,0,14,34,5,3,8,-1,0,-3,-1,1,-1,1,5,1
KR_6769795768,420,2,39,19,5,-1,2,3,3,5,2,1,3,2,0,3,3,2,3,1,-1,4,-67,4,1,5,-1,0,0,1,-1,1,-1,1,1
KR_6765369393,420,2,57,-23,3,-2,1,3,4,8,4,3,3,0,-1,4,5,-1,1,2,0,2,-30,9,4,13,-5,0,3,-1,-1,1,-1,2,1
KR_6749616675,420,8,116,32,0,0,0,0,2,4,2,2,4,2,-2,0,2,-2,0,2,0,-1,1,0,3,3,1,0,3,1,1,1,-1,1,1
KR_6699720098,420,3,68,18,4,6,7,1,2,5,3,-3,2,5,0,1,1,-1,0,1,0,-11,21,5,3,8,-1,0,1,-1,1,1,1,6,1
KR_6765603940,420,1,5,-4,-1,-2,1,3,5,6,1,0,2,2,-3,2,5,-1,0,1,-1,6,54,4,2,6,-32,0,0,1,-1,0,-1,5,1
KR_6768200144,440,-2,-7,-10,-2,14,16,2,-3,1,4,-5,1,6,-7,2,9,-1,0,1,2,-2,-6,-2,6,4,-4,0,0,-1,1,-1,1,3,1
KR_6764143811,420,2,62,33,3,-2,1,3,-2,1,3,3,4,1,4,4,0,0,0,0,1,2,9,5,2,7,2,0,-1,1,-1,1,1,4,1
KR_6763946040,420,0,-23,12,2,0,1,1,-4,3,7,1,2,1,4,5,1,1,2,1,0,-4,-9,-5,10,5,1,0,-1,1,1,-1,-1,4,1
KR_6733948753,420,-1,-2,0,2,-3,0,3,1,3,2,3,5,2,2,4,2,-1,0,1,0,17,0,-2,8,6,0,0,3,1,-1,1,1,5,1
KR_6687165751,420,-1,-8,7,-1,-2,1,3,3,4,1,-2,2,4,1,3,2,-1,1,2,0,0,70,-7,14,7,3,0,-1,-1,1,-1,1,6,1
KR_6767560109,420,8,90,15,10,2,2,0,0,1,1,0,1,1,2,2,0,6,6,0,0,10,11,-1,4,3,4,0,1,1,1,1,1,4,1
KR_6688344930,420,3,23,35,12,0,2,2,6,7,1,1,1,0,4,5,1,1,1,0,0,13,-217,0,5,5,-3,0,2,1,1,1,1,4,1
KR_6679788304,420,2,3,2,3,-2,1,3,4,8,4,1,1,0,-3,3,6,3,3,0,2,14,8,2,5,7,-2,0,-1,1,1,-1,1,1,1
KR_6755451653,420,-2,17,-44,2,3,3,0,-1,1,2,1,3,2,-3,1,4,2,3,1,1,5,20,1,4,5,0,0,1,1,-1,1,1,3,1
KR_6764110815,420,2,23,7,6,3,4,1,-1,5,6,3,5,2,1,1,0,0,1,1,0,3,-6,7,3,10,11,0,1,-1,-1,1,1,2,1
KR_6746137819,420,7,131,8,14,4,5,1,-2,2,4,1,2,1,7,8,1,4,5,1,1,16,8,5,3,8,-1,0,3,1,1,1,1,2,1
KR_6760851238,420,3,-4,23,0,-1,1,2,-7,3,10,5,5,0,1,3,2,2,3,1,-1,10,0,0,6,6,0,0,2,1,1,1,-1,5,1
KR_6769174986,420,3,51,26,2,5,5,0,-3,0,3,0,4,4,-1,1,2,1,1,0,0,4,36,-2,7,5,-12,0,2,-1,1,1,1,2,1
KR_6752473405,420,4,69,18,13,5,5,0,5,10,5,-1,1,2,5,7,2,-1,0,1,0,9,10,5,4,9,-1,0,1,1,1,1,1,2,1
KR_6764191959,420,-1,-30,3,-8,-2,0,2,-3,0,3,3,4,1,0,2,2,-6,2,8,0,-8,103,-2,6,4,-1,0,-1,1,1,-1,-1,4,1
KR_6756044067,420,2,44,-17,3,-7,0,7,-3,0,3,0,3,3,4,4,0,9,9,0,0,13,-1,1,6,7,2,0,0,-1,-1,-1,1,6,1
KR_6743701305,420,5,9,5,3,2,4,2,3,4,1,-1,2,3,-1,3,4,0,1,1,0,9,-63,8,6,14,3,0,1,-1,1,1,-1,5,1
KR_6766979089,420,6,42,12,11,2,2,0,7,9,2,0,2,2,4,6,2,-2,1,3,0,0,-17,5,3,8,1,0,2,1,1,1,-1,3,1
KR_6760369449,420,5,22,2,1,6,8,2,-7,0,7,0,4,4,2,5,3,0,1,1,0,0,0,0,6,6,3,0,-1,1,-1,-1,1,4,1
KR_6620463399,420,4,50,28,6,-2,1,3,3,4,1,4,4,0,1,2,1,0,2,2,1,2,-5,2,7,9,1,0,1,1,1,1,1,6,1
KR_6761752384,420,4,-4,4,10,1,2,1,-1,3,4,2,2,0,5,8,3,3,3,0,1,6,-8,3,2,5,0,0,0,1,1,0,1,4,1
KR_6747027080,420,-3,-38,-20,-12,-4,1,5,-1,3,4,-5,3,8,-1,2,3,-1,1,2,0,-5,3,3,8,11,0,0,-1,-1,-1,-1,-1,3,1
KR_6725024299,420,5,68,58,8,-1,2,3,1,3,2,3,4,1,4,5,1,1,2,1,0,5,-2,0,6,6,4,0,2,1,1,1,-1,6,1
KR_6722357301,420,0,-11,-5,6,2,2,0,-1,2,3,1,8,7,3,3,0,1,1,0,0,6,-105,-1,2,1,2,0,1,1,-1,-1,-1,2,1
KR_6629500017,420,3,29,8,12,-1,0,1,2,5,3,4,5,1,4,5,1,3,3,0,0,19,1,-1,7,6,2,0,1,-1,1,1,1,2,1
KR_6671643271,420,1,8,-10,-2,-3,1,4,-2,2,4,3,4,1,1,4,3,-1,0,1,0,0,8,0,7,7,0,0,2,-1,0,1,-1,6,1
KR_6744540588,420,1,20,-17,-3,1,3,2,1,4,3,-5,0,5,-1,3,4,1,1,0,1,-3,6,5,5,10,0,0,-2,-1,1,-1,1,6,1
KR_6769856294,420,0,35,27,4,2,3,1,0,4,4,3,5,2,-1,0,1,0,1,1,2,2,19,4,5,9,4,0,2,1,1,1,1,3,1
KR_6765720695,420,1,38,11,1,1,4,3,-4,0,4,4,4,0,0,2,2,0,1,1,0,1,-164,1,4,5,-21,0,0,1,-1,-1,1,4,1
KR_6619061805,420,6,92,23,8,5,6,1,0,5,5,3,3,0,0,5,5,0,3,3,-1,7,-3,-2,5,3,4,0,2,1,1,1,-1,5,1
KR_6763462483,420,-2,-14,20,-7,-1,3,4,-2,2,4,-1,2,3,2,8,6,-5,0,5,0,-7,-2,-5,8,3,3,0,0,-1,1,1,-1,1,1
KR_6767895901,420,-1,-13,12,-3,4,6,2,0,2,2,-1,2,3,-6,3,9,0,1,1,0,-7,-37,-1,7,6,17,0,-1,-1,1,-1,-1,3,1
KR_6729968531,420,3,-3,8,14,5,5,0,3,5,2,-3,0,3,9,11,2,0,1,1,0,16,8,6,1,7,-1,0,1,-1,1,1,1,1,1
KR_6767146649,440,3,11,2,3,3,3,0,-3,1,4,3,4,1,-1,2,3,1,2,1,0,-5,-5,0,4,4,-5,0,0,1,0,-1,1,4,1
KR_6766290125,420,6,80,48,12,2,2,0,3,4,1,2,2,0,3,3,0,2,2,0,0,14,9,1,4,5,-1,0,4,1,0,1,1,2,1
KR_6770252055,420,2,90,-15,4,-1,3,4,4,5,1,-2,0,2,4,5,1,-1,1,2,0,7,4,1,5,6,1,0,0,-1,-1,0,-1,4,1
KR_6687027207,420,2,20,-5,8,3,4,1,0,1,1,3,4,1,4,6,2,-2,1,3,0,2,267,6,1,7,1,0,1,1,1,1,1,6,1
KR_6759552332,420,-4,-64,-36,-4,5,8,3,-5,0,5,2,3,1,-7,0,7,1,3,2,0,-15,-128,-4,7,3,-1,0,-1,-1,-1,-1,-1,2,1
KR_6766352855,420,4,22,3,12,2,2,0,1,5,4,2,2,0,6,8,2,1,2,1,0,16,-9,0,7,7,1,0,1,-1,1,1,1,4,1
KR_6760780220,420,3,81,5,8,8,8,0,2,3,1,-5,1,6,5,5,0,-2,1,3,0,9,1,2,2,4,1,0,2,-1,1,1,-1,1,1
KR_6710538699,420,6,68,12,9,2,2,0,4,5,1,3,3,0,0,4,4,0,1,1,0,7,10,3,5,8,6,0,-1,1,-1,1,1,2,1
KR_6745922348,420,-2,55,-21,-9,-1,1,2,-3,1,4,-4,3,7,0,0,0,-1,1,2,0,-9,-2,1,4,5,0,0,0,0,-1,0,-1,0,1
KR_6729824245,420,3,57,4,10,5,6,1,0,2,2,0,0,0,5,5,0,0,0,0,0,7,7,-3,10,7,5,0,3,1,1,1,1,3,1
KR_6767435838,420,1,16,-6,1,-2,0,2,6,8,2,0,3,3,-2,2,4,-1,0,1,0,-5,245,2,7,9,23,0,-1,-1,-1,-1,-1,5,1
KR_6741287587,420,0,17,-8,5,-1,1,2,2,3,1,2,2,0,0,2,2,2,2,0,0,6,0,-7,7,0,5,0,1,1,-1,1,1,4,1
KR_6744590894,420,3,9,35,9,6,6,0,3,4,1,3,4,1,-4,2,6,1,2,1,-1,5,-4,0,4,4,2,0,1,1,1,1,-1,2,1
KR_6764291058,440,1,34,-7,4,2,3,1,5,5,0,-2,1,3,-1,0,1,0,0,0,0,-1,-17,5,4,9,3,0,0,1,0,0,1,5,1
KR_6673631747,420,5,82,17,16,4,4,0,8,10,2,2,2,0,4,4,0,-2,2,4,1,24,5,4,3,7,1,0,2,1,1,1,1,4,1
KR_6768717421,420,-1,14,-4,-2,1,1,0,-1,3,4,0,2,2,0,3,3,-2,0,2,0,0,8,4,5,9,-3,0,0,1,-1,0,1,6,1
KR_6767527888,420,2,52,26,5,1,3,2,0,4,4,-2,0,2,5,6,1,1,2,1,0,3,27,-1,6,5,-3,0,1,1,1,1,1,6,1
KR_6767464754,420,-1,-29,-11,1,-1,2,3,-2,3,5,2,3,1,1,4,3,1,2,1,-1,2,12,4,2,6,-5,0,0,-1,0,0,-1,6,1
KR_6760047585,420,5,76,0,1,-3,0,3,1,3,2,3,4,1,0,6,6,0,1,1,0,-2,5,5,4,9,-6,0,2,-1,1,1,-1,6,1
KR_6755448591,420,-4,5,-7,-7,1,4,3,-5,1,6,-1,2,3,-2,2,4,0,1,1,-2,-18,-13,-9,14,5,7,0,1,-1,1,1,-1,3,1
KR_6653187912,420,-4,-12,-33,-5,-2,2,4,-2,0,2,-3,1,4,2,2,0,0,1,1,0,-3,-4,3,4,7,0,0,0,1,-1,0,1,1,1
KR_6767844311,420,-1,2,24,-3,0,1,1,2,2,0,-4,3,7,0,2,2,-1,0,1,0,-9,15,-2,7,5,0,0,1,-1,1,1,-1,5,1
KR_6666357176,420,3,42,37,3,5,5,0,1,2,1,1,3,2,-4,0,4,0,0,0,0,2,-88,-5,12,7,3,0,1,-1,1,1,1,3,1
KR_6687812631,420,2,32,4,13,2,3,1,7,10,3,-2,1,3,6,8,2,0,0,0,0,7,-4,1,10,11,7,0,3,-1,1,1,1,1,1
KR_6768239174,420,-1,-7,-24,10,-1,1,2,1,1,0,6,6,0,1,2,1,3,3,0,0,19,2,3,2,5,2,0,0,1,-1,0,-1,4,1
KR_6741291908,420,1,-11,15,3,-2,3,5,3,4,1,4,5,1,-1,0,1,-1,0,1,1,4,-2,2,4,6,-4,0,-1,-1,-1,-1,1,5,1
KR_6718205681,440,0,-3,-17,7,-1,1,2,0,2,2,4,4,0,3,3,0,1,1,0,0,15,2,-1,5,4,-8,0,0,1,-1,1,-1,3,1
KR_6748837437,420,3,28,28,6,3,3,0,0,3,3,2,2,0,1,1,0,0,0,0,0,6,2,2,4,6,3,0,1,1,-1,1,1,2,1
KR_6770467667,420,1,-2,-7,0,-3,1,4,5,7,2,0,3,3,-2,0,2,0,0,0,0,11,-40,-1,6,5,2,0,-1,-1,1,-1,1,3,1
KR_6611209196,420,7,55,36,11,2,2,0,3,5,2,2,3,1,3,5,2,1,2,1,0,11,48,-1,6,5,-32,0,1,-1,1,1,1,6,1
KR_6691781233,420,-1,-5,12,-4,0,0,0,4,6,2,-5,1,6,-2,1,3,-1,2,3,-1,-3,19,0,6,6,-6,0,-1,1,-1,-1,-1,2,1
KR_6743152266,420,6,96,6,10,1,2,1,2,2,0,5,8,3,2,5,3,0,2,2,0,18,4,1,5,6,0,0,3,1,1,1,1,3,1
KR_6752239821,420,-2,-46,-29,2,-3,2,5,3,3,0,4,6,2,-1,0,1,-1,1,2,0,3,-26,-2,6,4,2,0,-1,1,-1,-1,1,2,1
KR_6755219181,420,1,37,-4,6,1,2,1,0,1,1,6,6,0,-2,3,5,1,1,0,0,8,-65,4,5,9,20,0,1,1,1,1,1,1,1
KR_6743198214,420,0,28,-12,4,0,2,2,0,2,2,-2,1,3,5,6,1,1,1,0,0,12,-7,-4,7,3,0,0,1,-1,1,1,-1,1,1
KR_6725049995,420,2,-14,28,1,1,4,3,-1,2,3,4,6,2,-1,0,1,-2,0,2,0,-5,-11,-2,6,4,4,0,1,1,1,-1,1,2,1
KR_6754349562,420,-3,2,-20,-4,2,2,0,3,3,0,-4,3,7,-2,2,4,-3,0,3,0,-2,12,3,4,7,-3,0,1,-1,-1,1,-1,5,1
KR_6724922598,420,-1,9,-25,-3,-1,0,1,1,5,4,-1,4,5,-1,2,3,-1,1,2,0,-2,-22,1,6,7,5,0,0,1,1,0,1,3,1
KR_6764229118,420,0,-21,-7,1,1,1,0,-4,2,6,6,6,0,-1,2,3,-1,0,1,0,0,8,0,5,5,0,0,-2,-1,-1,-1,-1,2,1
KR_6765813883,420,1,36,4,5,3,4,1,-2,2,4,3,4,1,2,5,3,-1,1,2,0,-1,-2,-2,4,2,0,0,-1,1,-1,-1,-1,6,1
KR_6703147686,420,1,-11,20,1,1,3,2,-2,3,5,-1,3,4,2,3,1,1,2,1,-1,3,-26,1,10,11,-6,0,1,1,1,1,-1,6,1
KR_6725001702,420,2,10,0,-2,5,6,1,-5,0,5,0,2,2,-4,5,9,2,2,0,0,6,12,-1,6,5,4,0,0,1,-1,1,1,1,1
KR_6629976780,420,6,45,24,11,0,1,1,3,5,2,4,4,0,7,9,2,-3,0,3,0,5,-2,1,7,8,7,0,1,-1,0,1,1,4,1
KR_6763989715,420,0,28,19,-1,1,2,1,2,5,3,0,3,3,-2,1,3,-2,0,2,-1,-9,-10,1,5,6,1,0,0,-1,1,-1,-1,2,1
KR_6691739592,420,1,45,3,-3,-1,2,3,0,0,0,2,3,1,-6,1,7,2,3,1,0,-3,-2,2,5,7,-2,0,0,1,-1,0,-1,2,1
KR_6716578047,420,4,32,44,3,5,5,0,-4,2,6,2,2,0,0,1,1,0,1,1,0,2,0,-4,7,3,2,0,1,-1,1,1,1,4,1
KR_6764760361,420,4,81,5,6,3,4,1,1,2,1,1,2,1,0,2,2,1,1,0,0,4,7,5,3,8,4,0,2,1,1,1,1,2,1
KR_6768515041,420,2,4,16,10,3,5,2,-1,2,3,3,3,0,7,8,1,-2,1,3,-1,12,3,1,7,8,0,0,0,-1,1,1,-1,6,1
KR_6746627760,420,2,-21,-4,4,1,1,0,1,3,2,-1,2,3,3,7,4,0,2,2,0,7,21,0,6,6,1,0,1,1,1,1,1,3,1
KR_6698591006,420,2,21,6,-3,-1,2,3,2,3,1,-1,1,2,-2,3,5,-1,2,3,0,-1,1,-2,9,7,0,0,0,1,-1,-1,-1,6,1
KR_6687549343,420,3,76,-24,16,7,10,3,-5,2,7,2,3,1,12,12,0,0,1,1,0,31,30,1,6,7,9,0,1,1,-1,-1,-1,1,1
KR_6755238799,420,6,49,19,17,2,2,0,9,10,1,2,3,1,4,4,0,0,0,0,0,14,7,9,0,9,-4,0,2,1,1,1,-1,4,1
KR_6654565272,420,1,9,23,8,3,5,2,6,7,1,-6,1,7,5,5,0,0,0,0,1,7,0,1,3,4,0,0,2,1,1,1,1,5,1
KR_6754492551,420,-1,37,-10,-4,-2,1,3,-3,4,7,2,5,3,0,4,4,-1,3,4,0,-4,-22,4,4,8,-3,0,2,1,1,1,1,6,1
KR_6737558428,420,1,-71,-9,-1,0,2,2,-2,4,6,3,4,1,2,4,2,-4,0,4,0,-1,-2,-4,6,2,-3,0,-1,1,-1,-1,-1,5,1
KR_6752731977,440,4,4,-16,12,5,5,0,5,5,0,-2,0,2,1,1,0,3,3,0,1,22,10,3,4,7,1,0,0,1,-1,1,1,5,1
KR_6597870961,420,6,60,21,15,1,2,1,7,8,1,6,7,1,-1,3,4,2,3,1,1,17,5,-4,9,5,3,0,4,1,1,1,1,3,1
KR_6760553162,420,3,15,17,14,3,3,0,5,8,3,7,7,0,0,7,7,-1,1,2,2,26,41,9,4,13,-2,0,1,1,1,1,1,1,1
KR_6743331362,420,1,-4,18,-3,1,3,2,0,4,4,-2,2,4,-2,2,4,0,0,0,-2,-6,0,0,10,10,-2,0,-1,1,-1,-1,-1,5,1
KR_6713728477,420,-1,-8,-16,2,-3,0,3,4,6,2,2,4,2,-1,1,2,0,1,1,0,3,10,4,3,7,-2,0,0,1,1,1,1,1,1
KR_6760658752,420,0,-19,24,1,0,1,1,0,1,1,-1,3,4,2,5,3,0,0,0,-1,5,-3,-4,10,6,1,0,0,1,-1,0,-1,4,1
KR_6652755171,420,4,21,29,9,0,2,2,-2,2,4,1,1,0,10,12,2,0,0,0,0,11,14,1,7,8,4,0,1,1,1,1,-1,6,1
KR_6647788443,420,-1,-21,1,-4,-2,0,2,3,7,4,-1,3,4,1,5,4,-5,0,5,1,-4,-6,0,5,5,3,0,-1,-1,1,-1,1,3,1
KR_6671891054,420,2,65,28,1,2,3,1,2,5,3,-2,0,2,0,2,2,-1,0,1,0,-3,1,-3,7,4,2,0,1,1,0,1,1,5,1
KR_6725419097,420,-2,-12,-8,1,-3,0,3,4,4,0,-1,3,4,0,2,2,1,1,0,0,2,-4,-2,8,6,0,0,0,-1,-1,0,1,4,1
KR_6768793292,420,0,5,-12,1,1,1,0,0,3,3,1,6,5,3,3,0,-4,0,4,1,-3,1,1,6,7,1,0,0,1,-1,0,1,4,1
KR_6543029370,420,1,-14,16,6,-3,0,3,0,3,3,4,7,3,4,5,1,1,1,0,0,12,10,2,4,6,2,0,0,1,1,1,1,3,1
KR_6767220444,420,4,35,10,8,0,1,1,8,9,1,0,1,1,0,1,1,0,1,1,0,6,5,2,4,6,-3,0,0,1,1,1,1,6,1
KR_6742085374,420,1,0,3,2,2,3,1,1,1,0,0,4,4,-2,1,3,1,1,0,0,-4,3,-2,5,3,1,0,2,1,-1,1,1,4,1
KR_6747576322,420,6,62,42,17,0,1,1,8,8,0,5,5,0,2,3,1,2,2,0,0,23,9,1,4,5,-1,0,3,-1,1,1,1,2,1
KR_6751157928,420,0,-4,-24,7,2,3,1,2,3,1,-3,1,4,4,4,0,2,2,0,0,8,4,2,6,8,-2,0,0,1,1,0,1,1,1
KR_6765793842,420,1,-34,18,4,2,4,2,-2,1,3,3,4,1,2,2,0,-1,0,1,0,8,4,-1,7,6,1,0,1,-1,1,1,-1,3,1
KR_6677670982,420,2,36,36,3,3,5,2,-1,2,3,1,3,2,1,2,1,-1,1,2,0,4,0,3,4,7,-3,0,0,0,1,1,-1,0,1
KR_6765328898,420,0,-29,26,-11,-5,0,5,-2,1,3,0,3,3,-4,4,8,0,3,3,0,-11,184,-4,7,3,-2,0,1,1,-1,1,1,3,1
KR_6657799476,420,-4,-19,-9,-8,-4,4,8,1,6,5,-5,1,6,5,7,2,-5,0,5,-1,-14,-13,3,8,11,-2,0,-1,-1,1,-1,-1,1,1
KR_6646317524,420,0,-1,19,-8,-1,2,3,-2,2,4,1,3,2,-8,1,9,2,2,0,0,-9,-32,-3,10,7,3,0,0,-1,1,-1,-1,4,1
KR_6763111008,420,5,4,11,14,0,2,2,4,4,0,4,7,3,7,8,1,-1,0,1,0,10,27,-3,5,2,-22,0,2,-1,-1,1,1,6,1
KR_6754271922,420,2,-17,0,8,1,4,3,6,7,1,3,3,0,-1,3,4,-1,0,1,0,3,0,-2,5,3,5,0,1,1,1,1,-1,6,1
KR_6750026936,420,3,8,25,7,-3,0,3,1,3,2,0,1,1,9,9,0,0,0,0,0,13,1,-3,5,2,4,0,-1,1,-1,-1,-1,4,1
KR_6729486205,420,-8,-69,-24,-15,-2,0,2,-3,1,4,-4,1,5,-6,0,6,0,1,1,0,-17,-2,-4,7,3,-8,0,-2,-1,-1,-1,-1,1,1
KR_6769724705,440,2,-36,7,9,0,2,2,0,3,3,-1,1,2,4,5,1,6,7,1,1,11,17,4,5,9,-1,0,1,1,1,1,1,1,1
KR_6768464907,420,1,14,-5,4,-2,1,3,2,3,1,4,7,3,1,4,3,-1,1,2,2,7,0,-3,5,2,0,0,-1,-1,1,-1,1,1,1
KR_6707925849,420,-1,-13,11,7,-1,2,3,5,6,1,2,3,1,0,3,3,1,1,0,1,10,-3,-1,5,4,-2,0,0,1,1,1,1,3,1
KR_6761182060,420,8,112,27,20,2,3,1,1,2,1,8,8,0,3,6,3,6,7,1,-1,25,6,-1,4,3,6,0,1,1,1,1,-1,6,1
KR_6632187819,420,6,44,7,10,3,3,0,4,6,2,2,4,2,0,0,0,1,1,0,0,13,-29,2,3,5,2,0,2,1,1,1,1,2,1
KR_6770029454,420,6,73,38,14,7,7,0,0,2,2,8,8,0,-2,2,4,1,1,0,0,18,4,-3,8,5,2,0,0,1,-1,0,1,2,1
KR_6768055231,420,0,115,-26,-1,3,3,0,-1,2,3,-3,0,3,0,3,3,0,0,0,0,-3,9,2,2,4,6,0,0,-1,-1,-1,1,6,1
KR_6757785659,420,-1,42,15,9,-1,1,2,4,4,0,2,3,1,7,9,2,-3,1,4,0,12,-59,1,6,7,23,0,0,1,1,1,1,3,1
KR_6616849679,420,1,0,-13,7,2,3,1,0,3,3,-1,1,2,7,8,1,-1,0,1,0,7,10,-1,10,9,-3,0,1,-1,1,-1,-1,3,1
KR_6698860332,420,5,61,16,7,2,2,0,5,5,0,1,2,1,-1,1,2,0,0,0,0,5,-6,1,6,7,4,0,1,-1,1,1,-1,4,1
KR_6696415129,420,2,30,39,3,2,3,1,2,5,3,0,3,3,0,3,3,-1,0,1,1,8,257,-4,10,6,0,0,0,-1,1,0,1,6,1
KR_6751926415,420,1,8,-35,3,3,4,1,0,4,4,-1,1,2,-1,2,3,2,3,1,-1,2,-15,0,4,4,5,0,0,-1,1,0,-1,1,1
KR_6768111495,440,3,30,0,8,-1,1,2,2,5,3,1,1,0,6,7,1,0,1,1,0,4,0,1,1,2,1,0,2,1,1,1,-1,3,1
KR_6711752536,420,1,57,32,1,0,0,0,-1,0,1,5,8,3,-7,0,7,4,4,0,0,6,7,4,3,7,1,0,0,1,1,0,1,6,1
KR_6653919874,440,0,24,23,0,1,3,2,-3,2,5,-1,2,3,3,4,1,0,2,2,0,-1,8,9,0,9,-4,0,0,0,0,0,-1,0,1
KR_6674790336,420,1,9,9,2,2,4,2,-3,4,7,-2,1,3,5,9,4,0,1,1,1,-1,1,-1,6,5,-1,0,1,1,-1,1,1,6,1
KR_6688658789,420,5,67,4,12,3,6,3,6,7,1,0,0,0,2,4,2,1,1,0,0,7,-16,6,4,10,-1,0,2,1,1,1,1,2,1
KR_6664208874,420,-1,35,8,1,1,2,1,0,3,3,-2,1,3,-2,1,3,4,4,0,1,-1,-14,-1,6,5,4,0,-1,-1,-1,-1,1,5,1
KR_6716565427,420,5,53,21,7,0,1,1,4,7,3,1,2,1,2,3,1,0,0,0,0,10,36,0,3,3,3,0,1,-1,1,1,-1,1,1
KR_6723465122,420,0,-4,19,-1,4,5,1,-2,2,4,3,3,0,-5,0,5,-1,0,1,0,-5,-22,0,4,4,-2,0,-1,1,1,-1,-1,4,1
KR_6753838146,420,3,-8,-8,7,1,2,1,-1,4,5,3,4,1,2,2,0,2,2,0,0,4,7,0,5,5,-5,0,0,-1,1,0,1,3,1
KR_6762029079,420,0,8,-14,-6,3,6,3,-4,1,5,-2,2,4,0,2,2,-3,0,3,0,-2,-15,3,5,8,-3,0,1,-1,1,1,-1,6,1
KR_6751263312,420,4,20,1,18,0,3,3,5,7,2,2,4,2,8,9,1,3,3,0,0,20,21,-2,8,6,3,0,1,1,1,1,1,4,1
KR_6765225788,420,2,25,-3,9,11,13,2,0,2,2,1,1,0,-1,5,6,-2,2,4,-1,7,-11,-3,7,4,2,0,1,1,-1,1,-1,4,1
KR_6763241438,420,9,82,48,20,3,6,3,2,2,0,10,10,0,3,5,2,2,2,0,1,14,-2,1,3,4,-1,0,4,1,1,1,1,4,1
KR_6767340844,440,4,14,-7,14,4,5,1,1,1,0,1,2,1,5,6,1,3,4,1,0,13,15,3,3,6,-5,0,1,1,-1,1,1,5,1
KR_6770502580,420,4,68,-11,9,1,1,0,1,1,0,6,7,1,1,3,2,0,1,1,0,2,-27,3,6,9,-2,0,2,1,0,1,1,3,1
KR_6767847023,420,3,66,22,1,2,4,2,-2,2,4,2,3,1,-1,2,3,0,0,0,0,-3,-21,1,5,6,6,0,2,1,1,1,1,3,1
KR_6753870708,420,1,28,-27,7,4,5,1,0,3,3,-1,3,4,3,6,3,1,3,2,4,16,-30,-2,5,3,-3,0,2,1,-1,1,1,5,1
KR_6761113394,420,3,-6,16,10,-3,2,5,4,6,2,4,6,2,5,7,2,0,0,0,1,27,22,-1,4,3,4,0,-1,-1,-1,-1,1,2,1
KR_6769802734,420,2,1,-22,5,0,2,2,3,5,2,0,2,2,1,2,1,1,1,0,0,7,-2,6,5,11,-2,0,0,1,-1,0,1,1,1
KR_6687080682,420,-2,-28,-23,1,2,2,0,-8,0,8,2,3,1,4,5,1,1,1,0,2,3,-173,-1,4,3,28,0,0,1,-1,0,-1,5,1
KR_6616402046,420,1,-8,-7,11,8,8,0,1,3,2,2,2,0,0,2,2,0,0,0,0,2,3,3,4,7,-1,0,0,1,1,0,1,6,1
KR_6769769714,440,4,-14,10,15,1,2,1,2,5,3,7,9,2,8,8,0,-3,0,3,1,14,5,-2,4,2,-2,0,2,1,1,1,1,5,1
KR_6660722140,420,5,30,32,13,-3,0,3,9,9,0,4,5,1,2,2,0,1,1,0,-1,16,3,1,3,4,1,0,1,1,1,1,-1,4,1
KR_6768176554,420,2,-34,16,2,2,3,1,2,7,5,3,7,4,-4,3,7,-1,1,2,0,3,18,2,3,5,1,0,0,-1,1,-1,1,1,1
KR_6761031393,420,1,34,-32,2,3,5,2,-6,2,8,0,1,1,6,7,1,-1,2,3,0,0,-2,0,3,3,1,0,0,-1,-1,0,-1,3,1
KR_6674502061,420,4,-30,-4,3,-3,1,4,3,8,5,3,4,1,0,1,1,0,2,2,0,14,10,1,5,6,6,0,0,1,-1,-1,-1,6,1
KR_6666907742,420,4,79,6,5,0,3,3,4,5,1,4,8,4,-3,1,4,0,1,1,0,2,2,-3,7,4,1,0,1,1,1,1,-1,5,1
KR_6764219403,420,-2,-56,27,-12,-4,1,5,-4,2,6,-2,1,3,-2,4,6,0,2,2,-2,-12,4,-6,8,2,-1,0,1,-1,1,1,-1,4,1
KR_6710560750,420,0,13,21,-4,5,5,0,-4,3,7,-4,0,4,1,6,5,-2,0,2,0,-3,-5,-2,6,4,1,0,0,1,-1,-1,1,5,1
KR_6764031780,420,6,97,-15,10,2,3,1,0,2,2,2,3,1,5,6,1,1,2,1,0,3,1,2,3,5,1,0,1,1,1,1,-1,4,1
KR_6768732327,420,0,11,17,3,-4,0,4,2,4,2,1,4,3,2,3,1,2,2,0,0,8,-4,-4,8,4,-2,0,1,1,0,1,-1,4,1
KR_6727767212,420,-3,29,9,1,0,1,1,0,1,1,-3,2,5,4,4,0,0,1,1,0,-3,267,5,5,10,5,0,1,1,1,1,1,4,1
KR_6755955167,440,-2,-30,5,-3,-2,3,5,0,1,1,4,4,0,-3,5,8,-2,0,2,0,0,-4,-5,5,0,2,0,0,-1,1,1,1,6,1
KR_6716042175,420,-1,-84,12,-3,-1,6,7,-2,3,5,-4,0,4,5,7,2,-1,2,3,-1,3,7,-2,8,6,-9,0,-3,1,-1,-1,-1,4,1
KR_6764831791,420,-2,-6,12,1,-1,0,1,2,2,0,-1,0,1,1,6,5,0,1,1,0,7,-4,0,8,8,2,0,0,-1,-1,-1,-1,1,1
KR_6754109825,420,0,70,17,-4,2,2,0,1,3,2,1,5,4,-7,0,7,-1,0,1,0,-12,34,-5,7,2,-20,0,1,1,-1,1,1,3,1
KR_6666458717,420,0,24,2,-1,0,0,0,-2,4,6,0,4,4,0,6,6,1,2,1,-1,-3,-194,-2,5,3,4,0,1,1,-1,1,1,4,1
KR_6769510992,420,0,19,-8,-3,3,3,0,-2,4,6,-1,3,4,0,3,3,-3,1,4,0,-3,7,6,1,7,0,0,-1,-1,1,1,1,4,1
KR_6768265575,440,1,36,-4,1,-6,4,10,-1,2,3,-2,4,6,5,6,1,5,7,2,-1,2,14,8,0,8,-2,0,0,-1,0,-1,-1,1,1
KR_6765602210,420,2,97,8,4,-2,1,3,2,4,2,3,6,3,-1,3,4,2,2,0,0,1,9,4,5,9,0,0,1,1,1,1,1,6,1
KR_6766092131,420,2,80,-2,8,-4,0,4,6,6,0,3,3,0,-1,4,5,4,4,0,0,13,51,1,3,4,-26,0,1,1,-1,-1,1,5,1
KR_6739011926,420,3,57,15,1,2,2,0,0,3,3,1,1,0,-2,0,2,0,0,0,0,-2,4,3,4,7,5,0,1,1,1,1,-1,1,1
KR_6760479878,440,1,-20,-8,-1,-4,1,5,-1,3,4,7,8,1,-3,0,3,0,2,2,0,-6,3,-4,5,1,6,0,0,1,-1,0,1,6,1
KR_6749376111,420,-1,-17,0,-3,0,1,1,0,0,0,0,3,3,-2,1,3,-1,1,2,0,-7,3,-1,7,6,2,0,0,-1,1,0,1,4,1
KR_6664828743,420,0,2,4,-3,-3,3,6,5,6,1,-3,1,4,-3,2,5,1,1,0,0,-5,4,-3,6,3,-1,0,1,-1,1,1,-1,2,1
KR_6768194075,420,0,42,27,5,2,2,0,2,3,1,-2,1,3,2,5,3,1,1,0,0,7,-114,-2,6,4,2,0,1,1,0,1,1,6,1
KR_6768409585,420,-1,-4,-4,-2,-3,0,3,1,4,3,5,6,1,-1,3,4,-4,1,5,1,1,43,-2,6,4,4,0,-1,-1,0,-1,1,4,1
KR_6721954738,420,3,42,4,9,-1,0,1,3,5,2,4,5,1,1,3,2,2,2,0,0,8,9,3,4,7,2,0,0,1,1,1,1,2,1
KR_6763523564,420,1,13,16,-3,-1,0,1,-2,1,3,2,3,1,-1,1,2,-1,2,3,0,0,19,-4,9,5,3,0,2,1,1,1,-1,3,1
KR_6767854139,420,1,48,15,-1,-1,4,5,-1,3,4,-3,1,4,4,6,2,0,2,2,-2,-5,7,-3,10,7,-3,0,2,1,1,1,-1,1,1
KR_6664147315,420,-1,33,-24,1,1,1,0,1,2,1,0,2,2,4,6,2,-5,2,7,-2,-2,36,5,5,10,2,0,0,-1,-1,-1,-1,2,1
KR_6760262805,420,4,22,14,11,3,5,2,9,9,0,-2,0,2,2,2,0,-1,2,3,0,13,230,3,3,6,-3,0,1,1,1,1,1,6,1
KR_6755486206,420,3,54,8,13,1,1,0,1,4,3,2,3,1,8,8,0,1,3,2,0,15,-4,-4,8,4,-3,0,1,1,1,1,1,4,1
KR_6722611127,420,3,52,19,8,4,5,1,-2,3,5,2,4,2,4,6,2,0,2,2,0,5,10,6,3,9,-1,0,2,1,1,1,1,1,1
KR_6720163261,420,-1,-34,4,-5,-4,1,5,-3,1,4,-2,1,3,6,6,0,-2,1,3,0,1,10,-1,8,7,1,0,1,1,1,1,-1,5,1
KR_6757000081,420,2,25,22,-2,3,5,2,-3,0,3,-2,1,3,-1,3,4,1,1,0,0,-4,0,0,6,6,-4,0,0,1,1,0,-1,2,1
KR_6766441632,420,4,-1,4,11,4,4,0,2,5,3,4,5,1,-2,1,3,3,3,0,0,12,1,2,3,5,-1,0,0,0,1,1,1,0,1
KR_6715591670,440,3,48,24,1,-1,1,2,-1,2,3,1,1,0,0,1,1,2,2,0,0,1,4,6,3,9,3,0,1,-1,1,1,-1,3,1
KR_6770458873,420,1,32,14,11,-1,1,2,6,7,1,2,3,1,1,1,0,3,3,0,0,8,-63,5,4,9,16,0,0,1,1,-1,1,5,1
KR_6680218111,420,7,84,42,15,3,5,2,6,10,4,2,4,2,0,1,1,4,4,0,0,19,-1,3,3,6,2,0,0,1,1,1,1,6,1
KR_6768394974,420,0,-37,-32,3,0,0,0,2,4,2,-1,1,2,0,1,1,2,3,1,-1,7,1,0,4,4,2,0,1,1,-1,1,-1,5,1
KR_6766172437,420,-1,65,23,-2,-1,1,2,-1,3,4,-2,2,4,2,7,5,0,1,1,1,-1,-2,-4,7,3,-2,0,1,1,1,1,-1,5,1
KR_6759447165,420,2,84,-20,-1,0,2,2,-1,1,2,3,3,0,-4,0,4,1,1,0,0,-3,11,3,5,8,-3,0,1,1,-1,1,1,1,1
KR_6751290623,420,-1,12,21,-6,1,4,3,-7,1,8,2,4,2,-3,3,6,1,1,0,0,-13,4,2,3,5,-1,0,2,1,-1,1,1,6,1
KR_6770065229,420,-1,-10,-23,-6,-4,1,5,-3,1,4,-1,2,3,1,4,3,1,1,0,0,-13,-1,1,6,7,1,0,-1,-1,-1,-1,-1,5,1
KR_6754323813,420,0,-3,15,-7,5,6,1,-7,0,7,-1,1,2,-3,2,5,-1,2,3,-4,-16,-10,-7,11,4,3,0,0,-1,-1,0,-1,5,1
KR_6766954383,420,4,53,1,12,1,2,1,7,7,0,5,6,1,0,1,1,-1,1,2,0,9,-75,-1,3,2,-2,0,2,1,-1,1,1,2,1
KR_6768614950,440,0,-52,-33,5,3,5,2,0,1,1,1,1,0,-5,1,6,6,7,1,0,1,-13,-1,3,2,-5,0,0,1,-1,-1,1,2,1
KR_6767585320,420,0,14,6,7,0,4,4,5,7,2,3,4,1,-1,3,4,0,1,1,0,6,32,7,2,9,-1,0,1,0,1,1,-1,0,1
KR_6638242798,420,0,49,-20,4,2,2,0,4,4,0,-2,2,4,1,6,5,-1,2,3,0,5,-6,-3,6,3,-2,0,0,1,-1,0,1,2,1
KR_6762625346,420,-2,-59,-20,-4,-2,1,3,-4,0,4,6,8,2,-1,1,2,-3,0,3,0,-4,-6,-2,9,7,2,0,-2,-1,-1,-1,1,6,1
KR_6759894790,420,3,-22,-17,11,-1,1,2,2,5,3,2,3,1,6,6,0,2,3,1,0,11,5,5,4,9,2,0,0,1,1,1,1,6,1
KR_6766875507,420,4,14,9,17,1,2,1,4,4,0,2,4,2,7,7,0,3,3,0,1,15,145,3,5,8,-4,0,1,1,1,1,1,5,1
KR_6704360785,420,1,11,10,4,2,2,0,2,5,3,-4,3,7,0,3,3,4,4,0,0,3,18,-3,7,4,-2,0,1,1,-1,1,1,4,1
KR_6765678473,420,0,-25,-8,7,1,2,1,3,3,0,-4,2,6,0,2,2,7,8,1,1,9,22,3,4,7,-12,0,0,1,-1,0,1,1,1
KR_6665163994,420,2,48,28,4,0,2,2,0,3,3,-2,1,3,6,8,2,0,0,0,0,12,-4,0,6,6,2,0,1,1,0,1,1,5,1
KR_6767985318,420,2,0,-1,6,0,1,1,4,5,1,0,2,2,3,5,2,-1,1,2,1,9,60,3,1,4,-41,0,0,1,1,0,1,6,1
KR_6763019701,420,2,65,14,-1,0,2,2,2,4,2,-4,2,6,1,2,1,0,1,1,0,-4,-7,1,7,8,2,0,0,-1,1,0,1,3,1
KR_6766286585,420,3,61,10,0,-5,3,8,5,9,4,-1,2,3,1,2,1,0,1,1,1,4,317,-2,7,5,4,0,-1,1,-1,-1,1,4,1
KR_6766479033,420,5,49,15,9,3,4,1,3,6,3,-1,1,2,4,6,2,0,0,0,0,7,7,2,5,7,-1,0,2,-1,1,1,1,3,1
KR_6740382425,420,2,11,5,5,1,3,2,1,4,3,-2,3,5,5,6,1,0,0,0,0,10,6,1,7,8,-3,0,1,-1,1,1,-1,2,1
KR_6769368040,420,0,-12,20,6,1,2,1,2,7,5,5,6,1,-1,1,2,-1,0,1,0,3,3,-4,13,9,1,0,1,0,1,1,1,0,1
KR_6760035190,420,2,75,0,0,0,0,0,-4,1,5,0,2,2,6,9,3,-2,3,5,0,-1,-4,-1,3,2,0,0,2,-1,1,1,1,5,1
KR_6761917160,420,-2,-1,-24,-3,-3,0,3,-1,1,2,2,4,2,-3,2,5,2,2,0,0,-1,2,4,2,6,-1,0,-1,1,1,-1,-1,6,1
KR_6754635622,420,4,12,33,14,0,3,3,1,2,1,0,1,1,14,16,2,-1,1,2,0,13,-7,-2,4,2,2,0,0,0,1,1,1,0,1
KR_6713296386,420,3,77,-15,7,3,5,2,1,2,1,-3,0,3,6,7,1,0,0,0,0,14,4,8,0,8,-2,0,2,1,-1,1,-1,2,1
KR_6699625090,420,0,25,8,-1,0,1,1,1,4,3,-1,0,1,1,2,1,-2,0,2,0,-1,-34,-2,6,4,-6,0,-1,-1,-1,-1,1,1,1
KR_6749529269,420,2,9,-1,1,0,0,0,-1,0,1,-2,1,3,4,4,0,0,0,0,0,4,3,-6,7,1,-1,0,0,1,1,0,-1,4,1
KR_6709098336,420,3,27,5,3,0,1,1,6,9,3,5,5,0,-7,0,7,-1,1,2,0,0,0,3,3,6,3,0,0,-1,1,1,-1,3,1
KR_6689859007,420,4,77,3,2,5,5,0,-3,4,7,1,1,0,0,2,2,-1,0,1,-1,-6,-27,-5,10,5,4,0,1,1,-1,-1,-1,4,1
KR_6700409104,420,7,119,-40,16,4,4,0,4,5,1,7,7,0,1,1,0,0,1,1,0,18,9,0,4,4,3,0,4,1,1,1,1,2,1
KR_6759569300,420,4,64,29,16,1,3,2,6,8,2,5,7,2,0,6,6,4,5,1,0,3,12,3,3,6,3,0,3,1,1,1,-1,5,1
KR_6750933006,420,2,39,-34,4,0,3,3,1,1,0,-1,1,2,2,6,4,2,2,0,0,5,8,-1,5,4,-3,0,0,0,-1,0,1,0,1
KR_6761174342,420,-2,11,10,-4,0,2,2,-3,1,4,-2,1,3,0,1,1,1,3,2,1,-4,-9,-4,4,0,1,0,1,-1,1,1,1,1,1
KR_6665470090,420,-3,-79,7,-9,-5,1,6,1,2,1,-1,1,2,-3,2,5,-1,0,1,0,1,3,-3,7,4,-2,0,-2,-1,1,-1,-1,2,1
KR_6720926951,420,8,98,28,13,3,3,0,9,9,0,-1,3,4,2,6,4,0,1,1,0,5,22,-2,9,7,3,0,2,1,1,1,1,1,1
KR_6715943991,420,3,7,23,3,0,2,2,1,3,2,6,8,2,-3,1,4,-1,0,1,2,2,6,5,5,10,3,0,2,1,1,1,1,6,1
KR_6768324313,440,4,51,8,10,4,4,0,-2,1,3,4,4,0,3,4,1,1,1,0,0,3,-107,-1,7,6,-1,0,1,1,1,1,-1,6,1
KR_6756382494,440,0,28,0,7,-3,0,3,1,7,6,0,1,1,9,9,0,0,5,5,1,10,2,2,3,5,5,0,2,1,0,1,-1,5,1
KR_6675799838,420,3,77,5,12,1,1,0,3,3,0,3,4,1,3,5,2,2,2,0,0,19,33,3,5,8,2,0,2,0,0,1,1,0,1
KR_6768229280,420,3,9,-3,-4,0,1,1,3,6,3,0,1,1,-5,2,7,-2,1,3,0,-2,-21,-1,6,5,-2,0,-1,1,1,-1,-1,4,1
KR_6768766786,440,1,8,29,4,4,6,2,1,4,3,1,2,1,-1,1,2,-1,0,1,0,7,0,-5,7,2,2,0,0,-1,0,0,1,2,1
KR_6766535565,420,4,84,-4,15,3,3,0,1,3,2,4,5,1,5,5,0,2,2,0,0,12,21,3,5,8,3,0,2,-1,1,1,1,6,1
KR_6616757769,420,2,41,-18,5,-1,1,2,3,4,1,1,1,0,1,3,2,1,1,0,0,8,5,-3,7,4,1,0,0,-1,1,1,-1,1,1
KR_6738540223,420,2,15,22,2,3,3,0,-4,0,4,-5,0,5,7,8,1,1,1,0,0,0,-12,3,6,9,-8,0,0,-1,-1,-1,-1,3,1
KR_6770468959,440,3,85,26,7,-2,2,4,0,3,3,5,5,0,0,1,1,4,5,1,0,0,-10,-1,3,2,-2,0,2,-1,-1,1,-1,4,1
KR_6748893150,420,0,10,19,2,-1,2,3,0,2,2,3,4,1,0,2,2,0,0,0,0,-1,13,2,6,8,1,0,1,-1,-1,1,1,5,1
KR_6767922165,420,-6,-53,-8,-7,-3,1,4,3,6,3,0,3,3,-4,1,5,-3,0,3,-1,-7,2,-1,9,8,-5,0,-3,-1,-1,-1,-1,3,1
KR_6736782290,420,3,61,-24,15,1,3,2,1,3,2,7,8,1,2,5,3,4,5,1,0,6,273,-2,7,5,4,0,3,-1,1,1,1,6,1
KR_6620641033,420,2,16,13,4,2,3,1,-1,3,4,0,4,4,2,5,3,1,1,0,0,1,152,-3,4,1,4,0,2,0,1,1,-1,0,1
KR_6639436136,420,1,19,-17,3,2,2,0,3,3,0,-3,0,3,1,2,1,0,0,0,0,9,-44,0,3,3,4,0,3,1,1,1,-1,2,1
KR_6687105577,420,3,89,8,7,2,2,0,0,1,1,0,1,1,3,4,1,2,2,0,0,19,-6,-2,8,6,0,0,1,1,1,1,-1,2,1
KR_6748400596,420,2,47,-4,3,-1,3,4,1,4,3,-1,3,4,2,4,2,2,2,0,0,4,-3,-3,7,4,-1,0,0,-1,-1,0,-1,4,1
KR_6554762412,420,2,102,-36,10,3,4,1,3,4,1,0,1,1,6,7,1,-2,1,3,0,11,8,1,9,10,6,0,0,1,1,0,-1,4,1
KR_6752450821,420,-1,-5,-5,0,-2,1,3,-1,0,1,0,2,2,3,3,0,0,0,0,0,5,-45,-1,6,5,21,0,-1,-1,0,-1,-1,2,1
KR_6767881424,420,5,-62,1,6,1,2,1,1,2,1,5,6,1,-1,3,4,0,0,0,1,8,6,4,5,9,1,0,0,-1,0,0,1,4,1
KR_6763139447,420,2,47,6,7,1,1,0,0,2,2,1,4,3,3,5,2,2,2,0,0,12,-2,-3,8,5,6,0,0,1,-1,0,1,4,1
KR_6767946735,440,2,37,-3,5,-4,0,4,4,6,2,4,6,2,2,6,4,-1,1,2,0,-1,-27,1,5,6,3,0,1,0,1,1,-1,0,1
KR_6770308018,420,4,69,13,4,0,1,1,0,1,1,1,2,1,2,3,1,1,1,0,0,7,8,3,2,5,0,0,1,1,1,1,1,5,1
KR_6766211008,420,5,63,22,10,2,2,0,1,3,2,7,8,1,2,3,1,-2,1,3,0,10,-2,1,9,10,-3,0,1,1,1,1,-1,2,1
KR_6750983634,420,3,105,50,6,3,4,1,3,6,3,0,4,4,0,6,6,0,1,1,0,5,118,0,6,6,0,0,3,-1,1,1,1,3,1
KR_6766739185,420,3,-72,24,12,-1,3,4,0,3,3,6,6,0,2,3,1,5,6,1,0,16,5,1,4,5,1,0,1,1,1,-1,1,3,1
KR_6762644803,440,4,82,-13,-3,1,4,3,-5,2,7,3,3,0,-1,4,5,-1,3,4,0,-12,-20,2,5,7,1,0,2,1,-1,1,-1,4,1
KR_6758413999,440,0,-42,34,1,0,2,2,0,1,1,-1,1,2,2,2,0,0,1,1,0,3,-3,-2,6,4,-2,0,0,1,1,0,1,4,1
KR_6698823760,420,3,14,5,3,1,1,0,2,3,1,-2,0,2,2,3,1,0,0,0,0,5,1,0,5,5,4,0,2,1,-1,1,1,5,1
KR_6694071269,420,-2,-19,-16,2,-3,1,4,5,7,2,-2,0,2,1,5,4,1,1,0,0,11,126,-3,8,5,2,0,-1,-1,1,-1,-1,5,1
KR_6733814947,420,2,6,25,2,1,3,2,3,4,1,0,3,3,-2,0,2,0,0,0,0,-2,3,0,3,3,-1,0,1,1,-1,1,-1,1,1
KR_6759655483,420,1,51,13,6,2,5,3,-1,2,3,2,3,1,3,3,0,0,0,0,0,4,6,-3,6,3,3,0,0,-1,1,0,-1,3,1
KR_6741394604,420,0,37,13,-3,3,4,1,-5,2,7,-1,1,2,2,4,2,-2,1,3,0,-3,-18,6,4,10,3,0,0,1,-1,0,-1,6,1
KR_6751691472,420,1,47,-1,6,0,1,1,1,2,1,3,4,1,4,5,1,-2,0,2,0,5,8,4,3,7,-4,0,0,1,-1,0,1,1,1
KR_6734947701,420,3,73,7,12,1,2,1,-1,0,1,8,13,5,4,4,0,0,1,1,0,3,3,-1,3,2,2,0,3,0,1,1,1,0,1
KR_6769568113,420,2,58,-49,13,3,5,2,-1,4,5,5,6,1,4,6,2,2,2,0,0,9,136,0,6,6,-2,0,0,-1,1,1,-1,2,1
KR_6760303622,420,-2,-13,-3,0,-2,3,5,1,4,3,0,2,2,-2,1,3,3,4,1,0,-3,-2,3,3,6,0,0,0,-1,1,-1,1,3,1
KR_6768771534,420,1,-18,29,5,-1,1,2,4,5,1,2,5,3,-1,3,4,1,2,1,0,17,46,7,3,10,0,0,0,-1,-1,1,1,3,1
KR_6768364782,420,6,43,13,17,3,3,0,7,8,1,3,3,0,2,3,1,2,2,0,1,24,-7,0,5,5,7,0,1,1,-1,1,1,3,1
KR_6763116443,420,2,98,8,-3,3,3,0,-2,1,3,-2,3,5,-1,1,2,-1,0,1,-1,-9,24,-4,9,5,5,0,0,1,-1,1,-1,4,1
KR_6709244947,420,4,-6,31,14,3,6,3,8,9,1,1,2,1,1,3,2,1,2,1,0,12,1,-1,8,7,3,0,1,1,1,1,-1,3,1
KR_6678541392,420,0,-13,10,5,-1,1,2,5,8,3,-1,1,2,2,4,2,0,0,0,0,4,3,0,2,2,0,0,0,1,-1,-1,1,5,1
KR_6756604561,420,0,23,-21,6,0,2,2,1,3,2,5,7,2,2,3,1,-2,1,3,0,15,-5,-7,12,5,6,0,-1,1,-1,-1,-1,3,1
KR_6758211480,420,-1,10,-24,-1,2,4,2,-5,1,6,1,2,1,3,6,3,-2,0,2,1,4,-2,5,5,10,2,0,-1,-1,1,1,1,1,1
KR_6734031221,420,4,-6,24,0,0,1,1,0,1,1,0,0,0,-2,0,2,2,2,0,0,-1,3,-2,5,3,-3,0,0,-1,1,-1,-1,4,1
KR_6739162922,440,1,88,0,5,2,4,2,3,10,7,0,2,2,-2,5,7,2,4,2,0,4,0,-4,6,2,2,0,1,-1,-1,1,1,2,1
KR_6709207086,420,6,65,30,16,4,4,0,5,5,0,1,2,1,3,3,0,3,3,0,0,17,-29,3,4,7,25,0,2,1,1,1,1,1,1
KR_6733935213,420,-1,24,-8,6,7,7,0,-1,3,4,0,2,2,1,2,1,-1,0,1,1,2,0,-3,8,5,1,0,-1,1,1,1,1,2,1
KR_6711736857,420,0,20,-3,4,1,3,2,1,4,3,1,3,2,1,3,2,0,0,0,0,5,-4,-1,5,4,7,0,0,0,1,0,1,0,1
KR_6766936325,420,8,44,27,16,3,4,1,5,6,1,4,6,2,3,3,0,1,1,0,0,16,-4,-3,6,3,6,0,1,1,-1,1,-1,6,1
KR_6766709844,420,3,31,-7,0,2,5,3,1,1,0,-2,2,4,-2,0,2,1,1,0,0,1,-1,0,4,4,1,0,1,-1,1,1,-1,5,1
KR_6620380681,420,-2,-65,-7,-5,-2,3,5,-2,3,5,1,2,1,-2,7,9,0,1,1,-2,0,-2,-4,8,4,4,0,-1,1,1,-1,1,4,1
KR_6767056992,420,-1,-36,28,-6,1,2,1,-2,5,7,-2,1,3,-3,0,3,0,0,0,0,-10,-7,-4,9,5,-3,0,0,1,-1,0,-1,3,1
KR_6756271792,440,-3,-56,-20,-8,-2,1,3,1,5,4,-1,0,1,-5,1,6,-1,2,3,0,-3,-408,-1,4,3,0,0,-1,1,-1,-1,-1,2,1
KR_6763935572,440,1,41,-9,-1,1,3,2,-4,1,5,2,3,1,1,4,3,-1,5,6,0,-7,-41,5,3,8,-4,0,1,1,1,1,1,2,1
KR_6735933009,420,3,40,21,0,-3,1,4,1,5,4,-2,1,3,2,2,0,2,2,0,0,4,99,-1,6,5,4,0,1,1,1,1,-1,4,1
KR_6704958924,420,1,92,8,1,2,2,0,1,1,0,4,4,0,-3,0,3,-3,1,4,0,-1,-3,-1,4,3,1,0,-1,1,1,1,-1,1,1
KR_6769347255,420,6,35,6,7,6,7,1,0,3,3,1,1,0,-1,2,3,1,1,0,0,3,-10,-7,9,2,3,0,1,-1,1,1,-1,4,1
KR_6767485247,420,3,-12,26,9,1,2,1,3,4,1,2,2,0,1,3,2,2,3,1,0,12,-5,-1,7,6,-1,0,2,1,1,1,1,1,1
KR_6730078156,420,7,68,43,9,4,4,0,-1,1,2,-5,0,5,11,12,1,0,1,1,0,9,7,0,5,5,2,0,1,1,-1,1,1,6,1
KR_6684982302,440,0,33,42,-2,0,1,1,-2,2,4,1,1,0,0,1,1,-1,0,1,0,-3,-1,1,5,6,-1,0,1,-1,1,1,-1,1,1
KR_6694582096,420,4,48,22,10,1,3,2,3,5,2,4,6,2,2,7,5,0,0,0,3,16,2,2,6,8,5,0,1,1,1,1,1,3,1
KR_6764572850,420,5,16,4,15,3,3,0,2,5,3,3,5,2,7,8,1,0,0,0,-1,14,6,0,3,3,3,0,2,1,1,1,-1,2,1
KR_6724405070,420,0,39,11,-7,-1,0,1,-3,2,5,-2,1,3,-1,6,7,0,1,1,1,-9,5,0,5,5,2,0,0,1,1,0,1,6,1
KR_6769325727,420,2,37,24,2,2,5,3,-1,2,3,-1,2,3,3,4,1,-1,0,1,0,-7,-16,-1,5,4,2,0,0,1,-1,-1,1,3,1
KR_6760979433,420,-1,-2,6,-1,-2,1,3,-2,3,5,0,0,0,3,6,3,0,2,2,1,-2,-2,-1,6,5,2,0,1,-1,1,1,1,3,1
KR_6620421812,420,3,60,2,0,0,2,2,1,4,3,-3,2,5,1,2,1,1,1,0,0,3,-214,2,3,5,4,0,0,1,-1,0,1,5,1
KR_6769589775,420,2,20,-1,8,4,6,2,0,2,2,-2,2,4,4,4,0,2,2,0,-1,11,-2,3,4,7,2,0,0,-1,-1,1,-1,1,1
KR_6668400141,420,-1,23,-10,-3,0,0,0,2,3,1,-4,2,6,-1,2,3,0,1,1,0,-6,24,5,7,12,1,0,0,1,1,1,-1,2,1
KR_6761672174,420,1,29,-2,5,2,2,0,2,4,2,2,3,1,-1,2,3,0,0,0,0,4,47,-2,5,3,-13,0,0,-1,1,1,-1,1,1
KR_6664090424,420,2,-15,0,1,0,1,1,0,2,2,0,1,1,2,2,0,-1,0,1,1,2,6,6,2,8,-4,0,1,1,-1,1,1,4,1
KR_6769357571,420,0,37,-13,-4,1,3,2,-4,0,4,2,2,0,-3,2,5,0,0,0,0,-10,24,-4,9,5,-4,0,1,1,1,1,-1,5,1
KR_6718359449,420,5,53,17,3,1,1,0,0,4,4,4,5,1,-1,3,4,-1,0,1,-1,11,5,-3,11,8,-7,0,0,-1,-1,-1,-1,1,1
KR_6764285193,420,-1,27,-12,2,1,2,1,5,5,0,0,2,2,-1,1,2,-3,0,3,0,8,-28,-2,6,4,3,0,-1,-1,1,-1,-1,2,1
KR_6631020188,420,3,24,17,6,2,2,0,5,7,2,1,4,3,1,3,2,-3,1,4,0,2,3,-5,10,5,1,0,1,-1,-1,1,-1,3,1
KR_6768140438,420,-1,-9,-18,0,-1,1,2,-2,2,4,1,2,1,4,7,3,-2,1,3,0,-2,0,0,5,5,2,0,0,-1,-1,-1,-1,5,1
KR_6668255029,420,1,-14,-3,-5,-3,0,3,-2,5,7,1,2,1,-1,3,4,0,2,2,1,4,-16,-3,11,8,2,0,0,-1,-1,0,1,1,1
KR_6684380452,420,3,57,32,5,-1,1,2,-3,2,5,3,3,0,6,8,2,0,2,2,0,15,-1,-1,4,3,1,0,2,1,1,1,1,2,1
KR_6745954689,420,4,26,-36,9,1,4,3,1,4,3,0,3,3,7,8,1,0,1,1,2,13,-2,-2,4,2,-2,0,0,0,1,-1,1,0,1
KR_6764814894,420,2,-19,-5,8,0,0,0,6,6,0,4,5,1,-1,3,4,-1,0,1,0,14,124,2,4,6,4,0,-1,1,-1,-1,1,5,1
KR_6707411775,420,-2,-69,-14,0,0,2,2,1,2,1,-1,0,1,1,2,1,-1,0,1,0,4,7,0,4,4,-3,0,-1,1,1,-1,-1,4,1
KR_6767587450,420,-3,-10,-23,-1,-1,3,4,3,3,0,0,0,0,-1,4,5,-2,0,2,0,2,19,0,2,2,0,0,0,0,-1,0,-1,0,1
KR_6654516644,420,3,-13,23,7,-2,0,2,3,5,2,3,3,0,1,2,1,2,2,0,0,15,-6,-5,7,2,7,0,0,1,1,1,1,5,1
KR_6763798205,420,3,35,24,13,0,2,2,5,8,3,1,3,2,7,7,0,0,1,1,1,17,4,0,8,8,3,0,2,1,1,1,1,1,1
KR_6746003350,420,3,41,4,4,1,2,1,0,6,6,-3,3,6,6,7,1,0,0,0,0,-4,28,2,7,9,-1,0,1,-1,1,1,1,2,1
KR_6724389208,420,1,-8,-24,8,1,2,1,2,4,2,2,4,2,3,5,2,0,0,0,1,16,7,4,3,7,-4,0,2,-1,1,1,1,4,1
KR_6757790312,420,3,63,1,3,-3,0,3,0,2,2,-2,2,4,7,8,1,1,1,0,0,4,17,4,2,6,1,0,1,1,1,1,1,3,1
KR_6752140760,420,2,-27,2,6,-3,2,5,3,6,3,3,4,1,4,6,2,-1,0,1,0,12,-6,-2,8,6,5,0,0,1,1,1,1,6,1
KR_6634017030,420,5,50,20,6,2,3,1,6,6,0,2,2,0,-3,0,3,-1,0,1,0,12,9,-1,6,5,-3,0,0,1,1,1,1,4,1
KR_6682020714,440,4,17,-6,10,1,4,3,1,4,3,0,5,5,7,8,1,1,2,1,-1,5,-40,2,2,4,11,0,2,1,1,1,-1,5,1
KR_6770032363,420,3,44,0,4,3,4,1,-5,1,6,4,4,0,5,7,2,-3,0,3,0,-6,128,0,5,5,-5,0,0,1,-1,0,-1,3,1
KR_6714057889,420,4,-7,51,13,-1,1,2,4,6,2,7,9,2,-1,0,1,4,4,0,0,13,9,6,3,9,4,0,0,1,0,1,1,3,1
KR_6750160899,440,4,63,60,8,-1,3,4,5,8,3,-3,0,3,7,9,2,0,3,3,1,17,-15,-4,9,5,10,0,1,1,1,1,1,3,1
KR_6642437894,420,6,39,34,10,1,1,0,3,3,0,5,5,0,-2,2,4,3,3,0,0,8,17,-5,7,2,1,0,3,1,1,1,-1,4,1
KR_6687880438,420,0,10,3,-2,-1,1,2,0,2,2,0,0,0,-1,0,1,0,1,1,0,-4,-3,-2,9,7,0,0,0,1,1,-1,1,3,1
KR_6755083055,440,8,64,24,29,4,4,0,-1,0,1,3,4,1,24,25,1,-1,0,1,1,26,6,6,0,6,-1,0,3,1,1,1,1,5,1
KR_6764771182,440,2,13,8,8,4,4,0,3,4,1,0,3,3,2,5,3,-1,0,1,1,4,-20,1,2,3,-4,0,1,0,1,1,1,0,1
KR_6762236533,420,0,8,4,0,1,2,1,-1,2,3,-1,2,3,0,2,2,1,1,0,0,-4,249,-2,4,2,1,0,0,0,1,0,-1,0,1
KR_6758892420,420,1,45,-20,9,0,4,4,3,5,2,4,5,1,0,3,3,2,2,0,0,10,-8,-9,11,2,9,0,0,1,-1,-1,-1,5,1
KR_6761662631,420,5,29,34,7,1,1,0,3,4,1,0,1,1,3,5,2,0,0,0,0,10,1,-1,7,6,-1,0,0,1,1,0,1,5,1
KR_6758666588,420,0,-23,4,3,-2,0,2,-2,1,3,2,3,1,4,5,1,1,1,0,1,7,5,5,6,11,-1,0,1,1,-1,1,1,3,1
KR_6768343023,420,3,-28,32,-3,-2,0,2,4,4,0,3,3,0,-5,1,6,-3,1,4,0,0,-5,1,5,6,1,0,-1,-1,-1,-1,-1,6,1
KR_6757221163,420,2,-34,22,4,5,6,1,2,2,0,-3,2,5,0,3,3,0,0,0,0,2,4,-4,7,3,-2,0,-1,-1,-1,-1,1,5,1
KR_6755158810,420,3,12,8,14,0,1,1,5,5,0,4,4,0,3,5,2,2,3,1,0,15,12,0,6,6,5,0,1,1,1,1,1,2,1
KR_6627188548,420,2,47,12,0,0,3,3,-2,3,5,-3,3,6,4,5,1,1,1,0,0,5,159,-3,8,5,-1,0,1,1,-1,1,-1,5,1
KR_6729935434,420,-1,51,5,-4,2,5,3,-3,1,4,0,0,0,-2,1,3,-1,2,3,0,-2,2,0,7,7,-2,0,-1,-1,1,1,-1,2,1
KR_6754433028,420,2,-17,20,2,-1,1,2,-3,1,4,5,6,1,0,2,2,1,2,1,0,9,6,1,8,9,2,0,0,1,1,1,1,1,1
KR_6761052386,440,3,45,12,4,1,2,1,3,3,0,-1,1,2,3,3,0,-2,0,2,0,2,-11,-4,4,0,3,0,1,0,0,1,1,0,1
KR_6721346131,420,2,23,13,4,0,2,2,-2,0,2,-1,0,1,7,9,2,0,0,0,0,15,11,0,4,4,0,0,0,1,1,1,-1,4,1
KR_6747506159,420,0,-14,7,1,-1,1,2,-3,3,6,0,2,2,3,5,2,2,2,0,0,-2,-304,3,4,7,4,0,0,-1,-1,0,-1,1,1
KR_6689256037,420,1,58,-16,10,-3,2,5,3,5,2,4,4,0,6,6,0,0,5,5,1,10,-26,3,5,8,4,0,-1,1,-1,1,1,5,1
KR_6741745169,420,1,-24,12,-2,0,3,3,0,3,3,-3,0,3,-1,2,3,2,2,0,0,-2,-25,0,8,8,5,0,-1,-1,0,-1,1,6,1
KR_6700467540,420,2,25,20,3,2,3,1,4,6,2,-4,2,6,1,5,4,0,0,0,0,2,-7,2,7,9,4,0,0,1,-1,-1,1,6,1
KR_6752471910,420,3,3,2,5,-1,4,5,4,5,1,0,6,6,1,3,2,1,2,1,0,12,117,1,2,3,0,0,-1,1,1,-1,-1,2,1
KR_6751438963,420,3,3,31,12,1,3,2,-2,1,3,6,7,1,6,7,1,1,1,0,0,4,33,-2,8,6,-1,0,1,-1,1,1,-1,3,1
KR_6753701134,420,-1,-31,28,-1,2,3,1,-2,3,5,-2,1,3,1,2,1,0,0,0,0,-5,21,-3,7,4,-1,0,1,-1,1,1,1,5,1
KR_6758263955,420,5,12,8,6,3,4,1,2,6,4,0,2,2,-2,2,4,3,3,0,0,3,118,-3,8,5,0,0,0,1,-1,0,1,1,1
KR_6726933677,420,-2,8,-12,-3,-3,2,5,0,3,3,3,5,2,2,4,2,-5,0,5,-1,11,14,3,5,8,-4,0,-1,-1,-1,-1,-1,1,1
KR_6762992556,420,4,37,-8,10,3,4,1,7,8,1,1,1,0,-1,1,2,0,0,0,0,14,-10,-2,4,2,-2,0,2,1,1,1,1,4,1
KR_6761711333,420,0,-41,-2,8,-1,4,5,0,5,5,2,4,2,2,3,1,5,5,0,0,17,-25,0,7,7,5,0,0,0,1,0,1,0,1
KR_6751581977,420,2,0,11,7,2,5,3,2,2,0,4,8,4,-1,1,2,0,2,2,0,9,7,-1,6,5,6,0,0,0,0,-1,-1,0,1
KR_6688204208,420,3,27,1,10,2,3,1,-2,2,4,3,4,1,5,6,1,2,2,0,0,16,2,-1,7,6,-1,0,0,1,0,0,1,1,1
KR_6769965413,420,-2,-61,-6,1,1,3,2,3,8,5,0,2,2,-1,6,7,-2,2,4,0,0,-100,1,3,4,-4,0,0,-1,1,1,-1,6,1
KR_6758841427,420,-2,19,-18,1,2,5,3,-4,1,5,-2,4,6,4,6,2,1,2,1,0,-3,-27,0,5,5,0,0,-1,1,-1,1,1,1,1
KR_6766076960,420,2,70,17,0,-1,0,1,-2,2,4,9,9,0,-6,2,8,0,1,1,0,-4,-2,0,5,5,2,0,0,1,-1,1,1,2,1
KR_6741533623,420,6,-50,33,11,0,1,1,6,6,0,-1,3,4,5,8,3,1,1,0,0,4,-4,0,8,8,9,0,0,1,1,0,1,4,1
KR_6763046118,420,-2,-53,-4,2,-3,0,3,9,10,1,-4,1,5,2,5,3,-2,2,4,0,11,-16,5,4,9,-6,0,0,1,-1,-1,1,2,1
KR_6666404192,420,7,107,65,8,1,2,1,1,2,1,6,10,4,0,1,1,0,0,0,0,3,224,1,3,4,3,0,3,1,-1,1,1,5,1
KR_6769612418,420,0,-50,9,-1,-2,0,2,3,5,2,-3,0,3,-1,3,4,2,3,1,0,0,9,3,2,5,-5,0,-1,-1,1,-1,1,1,1
KR_6755591142,420,2,118,6,-3,2,3,1,0,1,1,-3,1,4,-2,1,3,0,0,0,-1,-8,-10,-3,7,4,8,0,1,-1,1,1,-1,4,1
KR_6725972308,420,-1,12,0,0,-3,1,4,1,2,1,0,3,3,3,6,3,-1,0,1,-1,-2,1,6,5,11,1,0,1,-1,1,1,-1,1,1
KR_6664841776,420,1,5,4,7,5,5,0,1,2,1,-6,1,7,5,5,0,2,2,0,0,8,6,4,3,7,-5,0,1,-1,1,1,1,5,1
KR_6768300081,420,-1,6,-16,-3,2,3,1,-3,2,5,-1,2,3,-1,2,3,0,2,2,0,-6,-2,0,5,5,-2,0,0,1,1,-1,-1,2,1
KR_6750970970,420,3,120,0,3,1,1,0,-1,1,2,3,4,1,-1,0,1,1,1,0,-1,-2,-157,-3,6,3,5,0,0,1,-1,1,-1,3,1
KR_6710357842,420,4,-2,-3,7,2,2,0,-1,4,5,3,3,0,4,4,0,-1,0,1,0,15,-4,-2,7,5,7,0,0,1,1,1,1,3,1
KR_6743770185,440,0,-39,-24,6,1,2,1,1,3,2,1,4,3,1,2,1,2,2,0,0,10,-116,-2,7,5,1,0,0,0,-1,0,1,0,1
KR_6676430900,420,4,58,3,11,4,4,0,-3,0,3,1,5,4,10,12,2,-1,0,1,0,6,0,1,3,4,-3,0,4,1,1,1,1,5,1
KR_6769127452,420,2,-11,-3,9,-2,1,3,1,6,5,-2,2,4,3,3,0,9,9,0,0,8,2,1,3,4,-1,0,2,1,1,1,1,5,1
KR_6759057921,420,6,93,12,13,4,4,0,2,6,4,1,1,0,2,4,2,4,4,0,0,8,22,0,8,8,2,0,0,1,1,1,1,4,1
KR_6760316561,420,-1,-5,24,6,-1,0,1,5,7,2,-3,1,4,3,4,1,2,2,0,0,7,9,-4,8,4,3,0,0,1,-1,0,1,1,1
KR_6764858311,440,-2,31,-10,3,-6,0,6,3,4,1,-1,3,4,5,5,0,2,3,1,0,2,0,2,1,3,3,0,0,1,-1,0,1,6,1
KR_6616840249,420,-1,16,-5,-6,1,1,0,1,3,2,-1,0,1,-6,1,7,-1,0,1,0,-1,2,2,5,7,-8,0,-1,-1,-1,-1,-1,6,1
KR_6768758231,420,-1,48,-16,4,-1,0,1,-2,1,3,2,3,1,4,4,0,1,2,1,0,4,-1,1,6,7,-2,0,1,-1,1,1,1,3,1
KR_6680606761,420,6,63,3,8,3,4,1,-3,4,7,0,4,4,7,7,0,1,2,1,-1,11,-1,2,5,7,3,0,2,1,-1,1,-1,1,1
KR_6768277999,420,0,35,-13,1,-3,0,3,4,4,0,-1,2,3,1,2,1,0,0,0,0,4,53,-2,7,5,-20,0,0,1,-1,1,-1,3,1
KR_6742175413,440,1,34,28,5,3,4,1,1,3,2,-3,0,3,1,2,1,3,3,0,0,4,1,-1,8,7,-1,0,-1,1,-1,-1,1,3,1
KR_6724059186,420,3,105,-39,-2,3,5,2,-2,2,4,-1,1,2,-2,1,3,0,0,0,0,1,0,-3,7,4,-4,0,1,-1,-1,1,-1,6,1
KR_6692312292,420,4,64,9,14,3,5,2,2,3,1,6,8,2,4,4,0,-1,0,1,0,16,4,2,3,5,2,0,1,1,1,1,-1,1,1
KR_6662343602,420,3,38,3,4,0,2,2,2,4,2,-1,1,2,2,4,2,1,1,0,0,2,3,-3,10,7,-1,0,0,-1,1,1,1,1,1
KR_6767815946,420,-5,-42,-16,-11,-2,1,3,-2,3,5,-1,2,3,-3,3,6,-3,0,3,0,-4,52,2,3,5,-16,0,-1,1,1,1,-1,5,1
KR_6692386156,420,6,55,31,16,-2,0,2,8,8,0,6,7,1,5,5,0,-1,0,1,0,13,31,6,3,9,-1,0,1,1,1,1,1,2,1
KR_6709314861,420,7,61,32,16,0,1,1,10,11,1,0,4,4,4,4,0,2,2,0,0,16,259,8,3,11,3,0,2,-1,-1,1,1,1,1
KR_6770301349,420,3,11,8,10,0,1,1,4,6,2,3,4,1,3,7,4,0,0,0,2,7,16,5,4,9,-1,0,2,1,-1,1,1,3,1
KR_6711195235,420,-2,-56,-8,-2,-5,0,5,2,3,1,1,2,1,0,3,3,0,0,0,0,4,-11,-4,8,4,6,0,-1,-1,1,-1,-1,2,1
KR_6768817469,420,-1,-31,20,1,-3,0,3,1,1,0,4,4,0,-2,3,5,1,1,0,0,3,-3,5,2,7,-10,0,1,-1,1,1,1,2,1
KR_6766833106,420,0,-39,12,-3,-2,0,2,-3,3,6,0,4,4,2,3,1,0,2,2,1,-1,2,-1,5,4,1,0,-1,1,-1,-1,1,4,1
KR_6750441629,420,-2,-43,-20,2,-2,0,2,2,4,2,-3,2,5,5,7,2,0,0,0,0,11,9,-4,11,7,3,0,0,1,1,1,-1,2,1
KR_6736888257,440,3,38,36,1,2,2,0,0,0,0,0,0,0,1,2,1,-2,2,4,0,1,-4,2,4,6,9,0,0,1,-1,0,-1,3,1
KR_6756541942,440,3,16,-3,6,2,3,1,1,2,1,-1,0,1,4,4,0,0,1,1,0,1,-33,-2,6,4,-6,0,0,0,1,0,1,0,1
KR_6637626716,420,-2,-4,-16,0,-2,0,2,2,4,2,0,5,5,-2,4,6,2,2,0,0,-2,2,-3,6,3,2,0,2,-1,1,1,1,4,1
KR_6756154941,420,0,-46,25,-3,1,4,3,1,4,3,1,4,3,-6,1,7,0,2,2,1,-3,-4,2,6,8,-4,0,0,1,1,0,1,3,1
KR_6768224674,420,0,93,8,0,0,0,0,-1,2,3,0,6,6,0,3,3,1,1,0,0,-4,23,-8,11,3,-23,0,2,1,-1,1,1,1,1
KR_6742489638,420,-1,-15,35,8,1,4,3,-3,4,7,3,3,0,5,5,0,2,2,0,0,16,15,-1,5,4,0,0,1,1,-1,1,1,5,1
KR_6767879654,420,1,-27,-7,5,-3,0,3,0,4,4,5,6,1,5,5,0,-2,1,3,4,18,-17,3,4,7,3,0,-1,-1,-1,-1,1,6,1
KR_6770445914,420,-1,-52,-12,-6,-1,0,1,1,2,1,-4,1,5,0,3,3,-2,1,3,0,1,-13,-3,8,5,1,0,0,-1,-1,0,-1,4,1
KR_6760765166,420,1,1,22,4,-2,1,3,-1,1,2,5,5,0,2,5,3,0,1,1,1,7,68,-1,10,9,5,0,0,-1,1,0,1,4,1
KR_6756442940,420,6,18,47,13,2,3,1,3,7,4,7,8,1,2,4,2,-1,0,1,0,7,39,-1,6,5,2,0,1,1,1,1,1,5,1
KR_6746517217,440,6,46,36,13,1,1,0,-1,3,4,2,2,0,14,14,0,-3,0,3,1,13,-2,3,2,5,2,0,0,-1,1,0,1,2,1
KR_6767149750,420,4,44,11,11,1,3,2,6,8,2,5,6,1,0,1,1,-1,1,2,2,12,4,0,5,5,2,0,1,1,-1,-1,1,4,1
KR_6747126828,420,8,63,35,18,1,4,3,4,5,1,6,8,2,3,5,2,4,4,0,1,9,-15,1,6,7,10,0,2,1,1,1,-1,5,1
KR_6747506245,420,0,41,0,-1,0,3,3,2,3,1,-1,0,1,-3,3,6,1,2,1,0,4,1,2,4,6,5,0,0,-1,0,0,1,2,1
KR_6765919025,420,4,54,4,10,3,5,2,3,4,1,3,4,1,5,6,1,-4,0,4,1,6,13,1,7,8,7,0,2,0,1,1,1,0,1
KR_6754377336,420,2,38,4,0,4,4,0,1,4,3,-2,2,4,-3,1,4,0,2,2,0,-7,-89,-3,7,4,0,0,1,-1,-1,1,-1,5,1
KR_6758740462,420,1,15,2,0,0,1,1,-2,2,4,2,2,0,-1,1,2,1,1,0,0,-3,-9,5,1,6,1,0,0,-1,1,0,1,1,1
KR_6760621457,420,0,-52,50,-1,2,2,0,-5,0,5,-1,1,2,1,2,1,2,2,0,0,3,3,3,5,8,0,0,-1,1,1,-1,1,1,1
KR_6678211661,440,7,80,36,3,3,4,1,1,1,0,1,3,2,0,2,2,-2,0,2,0,4,13,2,2,4,-4,0,3,-1,1,1,-1,4,1
KR_6754221252,420,5,65,1,13,1,2,1,-4,2,6,10,10,0,-2,0,2,8,10,2,0,4,50,6,2,8,-18,0,0,1,1,1,-1,2,1
KR_6762186112,420,3,17,15,10,2,3,1,7,7,0,0,1,1,1,2,1,0,0,0,0,9,0,4,2,6,1,0,0,-1,1,0,1,2,1
KR_6769744215,420,1,-1,31,6,3,4,1,-2,4,6,0,1,1,4,5,1,1,1,0,1,7,-3,-4,9,5,2,0,-2,-1,-1,-1,1,2,1
KR_6767951976,440,5,53,10,2,0,2,2,-4,2,6,3,3,0,4,6,2,-1,0,1,0,0,-4,-1,2,1,2,0,1,-1,1,1,-1,4,1
KR_6694816046,420,-1,-33,-27,2,3,4,1,4,6,2,-1,1,2,-2,1,3,-2,0,2,0,-1,-2,3,5,8,-5,0,0,-1,-1,1,-1,6,1
KR_6766496618,420,2,-1,-20,2,-4,0,4,1,4,3,2,4,2,1,1,0,2,3,1,0,7,6,2,4,6,-2,0,-1,-1,-1,-1,-1,3,1
KR_6759984345,420,3,-8,7,5,2,3,1,-3,1,4,0,3,3,6,7,1,0,0,0,-1,7,45,-1,7,6,1,0,0,1,-1,0,-1,3,1
KR_6642178931,420,2,79,8,1,-2,1,3,-1,2,3,3,5,2,1,5,4,0,0,0,-1,6,30,3,4,7,-1,0,2,1,-1,1,-1,1,1
KR_6725102505,420,2,61,9,4,0,4,4,6,6,0,2,3,1,-2,1,3,-2,1,3,1,2,-1,1,3,4,-2,0,0,-1,1,1,1,2,1
KR_6756977849,420,4,54,12,6,2,4,2,2,3,1,-1,7,8,2,3,1,1,1,0,1,3,25,3,3,6,-6,0,2,1,1,1,1,5,1
KR_6770131322,420,4,55,17,9,-1,1,2,3,4,1,4,5,1,3,4,1,0,2,2,0,11,27,5,2,7,-10,0,0,0,1,1,1,0,1
KR_6769960016,420,7,40,28,15,0,2,2,7,7,0,4,5,1,2,4,2,2,2,0,0,16,6,2,4,6,1,0,1,1,1,1,1,1,1
KR_6762338404,420,2,33,-2,8,-2,0,2,2,3,1,2,4,2,2,3,1,4,4,0,0,12,-4,-4,8,4,0,0,1,0,1,1,1,0,1
KR_6707639459,420,4,63,23,8,0,2,2,0,0,0,2,4,2,2,2,0,4,4,0,0,11,5,7,2,9,2,0,2,1,1,1,-1,5,1
KR_6644960219,420,3,54,-3,4,-4,1,5,-1,1,2,2,4,2,7,9,2,0,0,0,0,11,2,-6,9,3,5,0,1,1,-1,1,-1,3,1
KR_6768892252,420,4,88,9,9,3,8,5,-1,1,2,8,8,0,-1,1,2,0,0,0,0,7,0,0,3,3,2,0,1,0,1,1,-1,0,1
KR_6769632409,420,1,-26,-44,-4,1,3,2,1,1,0,-4,1,5,-2,3,5,0,0,0,0,4,1,-3,8,5,0,0,-1,-1,-1,-1,-1,3,1
KR_6611808164,420,2,52,15,8,3,4,1,4,4,0,-2,1,3,0,1,1,3,5,2,0,11,-5,-2,8,6,0,0,0,1,-1,-1,1,6,1
KR_6766431409,420,1,13,-4,4,3,4,1,3,4,1,-2,1,3,0,1,1,0,0,0,0,13,-11,1,7,8,2,0,1,-1,1,1,-1,1,1
KR_6627634510,420,-4,9,-4,-12,-4,1,5,-2,3,5,-3,2,5,-4,1,5,1,3,2,-2,-11,-42,-3,8,5,0,0,-1,1,-1,-1,-1,3,1
KR_6765455118,420,5,56,35,12,2,3,1,-2,1,3,5,9,4,7,7,0,0,0,0,0,15,-5,3,3,6,4,0,1,1,1,1,1,2,1
KR_6679752347,420,0,24,41,-2,-2,2,4,1,6,5,1,3,2,1,3,2,-3,0,3,-1,-1,28,2,11,13,-3,0,1,1,-1,1,-1,1,1
KR_6768525847,420,-2,10,-24,-1,2,3,1,0,2,2,0,0,0,-3,0,3,0,0,0,0,-1,7,5,5,10,-2,0,0,-1,1,0,-1,1,1
KR_6696670868,420,7,15,18,13,1,3,2,2,9,7,2,6,4,4,5,1,4,4,0,0,11,28,-3,6,3,1,0,2,1,1,1,1,4,1
KR_6710580490,420,4,19,24,14,-1,2,3,9,12,3,6,6,0,-2,0,2,2,3,1,0,13,-3,4,3,7,2,0,1,-1,1,-1,-1,2,1
KR_6768623673,420,5,87,23,12,3,5,2,5,6,1,0,2,2,3,3,0,1,1,0,0,11,22,6,1,7,0,0,2,1,1,1,-1,4,1
KR_6657616481,420,0,30,-12,2,-2,1,3,-2,1,3,2,4,2,1,4,3,3,3,0,0,1,25,-1,6,5,3,0,-1,-1,-1,-1,1,6,1
KR_6767704652,420,0,32,-19,1,2,3,1,4,7,3,-2,1,3,-3,0,3,0,0,0,0,4,-10,4,3,7,-2,0,1,-1,1,1,-1,2,1
KR_6724128005,420,1,30,-12,-3,2,3,1,-2,2,4,-1,3,4,-1,1,2,-1,0,1,0,-7,-8,-5,11,6,4,0,1,1,-1,1,-1,2,1
KR_6698066183,420,2,30,23,3,2,2,0,0,4,4,1,2,1,0,2,2,0,2,2,0,5,12,4,4,8,-3,0,1,0,1,1,1,0,1
KR_6753372751,420,5,159,-29,11,1,3,2,3,5,2,6,10,4,4,4,0,-3,1,4,0,5,-3,2,4,6,2,0,1,-1,1,1,-1,4,1
KR_6769656129,440,6,90,39,14,5,11,6,-3,2,5,-1,4,5,6,6,0,7,8,1,2,12,13,-4,6,2,3,0,3,1,1,1,1,4,1
KR_6646689863,420,1,18,11,4,3,3,0,0,2,2,-3,1,4,1,5,4,3,3,0,0,-7,8,4,2,6,-3,0,0,-1,1,1,1,5,1
KR_6753792161,420,1,23,18,4,-1,1,2,5,6,1,3,3,0,-5,2,7,2,4,2,1,11,4,1,5,6,2,0,1,1,1,1,1,4,1
KR_6674971550,420,5,59,-3,15,3,3,0,3,6,3,1,2,1,7,10,3,1,2,1,0,17,-7,1,6,7,8,0,1,-1,1,1,1,5,1
KR_6764056217,420,3,43,40,1,2,5,3,0,5,5,1,2,1,-3,2,5,1,2,1,0,-12,-14,4,4,8,0,0,2,1,1,1,1,2,1
KR_6677296376,420,1,27,-18,6,-2,0,2,0,6,6,3,5,2,6,6,0,-1,0,1,1,10,-240,4,4,8,4,0,1,1,-1,1,1,2,1
KR_6749211677,420,1,10,-23,-2,-8,0,8,1,2,1,0,3,3,3,4,1,2,2,0,-1,0,-164,-5,8,3,1,0,1,1,-1,-1,-1,4,1
KR_6543066123,420,-1,-17,12,6,-1,2,3,3,5,2,1,5,4,1,3,2,2,2,0,0,17,13,2,4,6,1,0,0,1,-1,1,-1,3,1
KR_6769674176,420,2,48,-4,5,3,3,0,1,3,2,5,7,2,-4,3,7,0,2,2,0,2,20,-3,6,3,7,0,1,-1,-1,-1,-1,3,1
KR_6694270047,440,1,-3,-21,2,0,1,1,0,3,3,1,3,2,-1,2,3,2,2,0,0,5,-3,2,5,7,0,0,0,1,-1,0,-1,5,1
KR_6757683237,420,4,73,32,6,-2,0,2,3,5,2,5,5,0,0,1,1,0,0,0,0,13,2,0,6,6,-1,0,0,1,1,0,-1,5,1
KR_6770045408,440,3,-21,-4,6,3,3,0,-1,1,2,-2,1,3,4,6,2,2,5,3,0,13,83,1,4,5,-1,0,1,1,1,1,1,6,1
KR_6763944044,420,-2,23,-32,-1,1,2,1,-2,3,5,1,3,2,-1,2,3,0,1,1,-1,-2,25,3,5,8,-22,0,0,1,1,0,-1,5,1
KR_6666429788,420,4,26,20,4,-1,0,1,-2,2,4,3,5,2,5,7,2,-1,1,2,-1,2,219,3,4,7,8,0,0,1,-1,0,-1,4,1
KR_6769520253,440,1,-26,1,-1,0,1,1,0,3,3,-4,2,6,-1,3,4,4,4,0,1,-1,-4,2,2,4,0,0,1,1,-1,1,1,2,1
KR_6767921579,420,5,41,-3,16,2,2,0,6,6,0,0,3,3,8,8,0,0,3,3,0,22,-7,3,4,7,-2,0,0,1,-1,0,-1,1,1
KR_6743079096,420,-1,-11,-3,-6,-1,0,1,0,1,1,-3,0,3,-2,0,2,0,1,1,0,-11,-10,-2,7,5,-5,0,0,1,1,0,-1,2,1
KR_6708351976,440,2,92,-8,9,5,5,0,1,4,3,0,0,0,3,5,2,0,2,2,0,10,-1,0,5,5,4,0,1,1,1,1,1,5,1
KR_6770132116,420,4,40,-12,9,3,3,0,5,7,2,0,3,3,0,1,1,1,1,0,0,8,8,0,3,3,-3,0,2,-1,1,1,1,2,1
KR_6747327595,440,1,50,-12,5,0,1,1,-3,3,6,1,2,1,7,7,0,0,0,0,1,8,-22,-2,9,7,4,0,0,1,0,0,1,1,1
KR_6769336409,420,-2,-7,-37,-5,2,3,1,-6,0,6,0,1,1,-1,3,4,0,0,0,0,-10,-3,-2,5,3,3,0,1,-1,-1,1,-1,1,1
KR_6746170531,420,5,65,26,5,-1,1,2,-2,1,3,1,2,1,3,4,1,4,4,0,0,9,-184,2,3,5,-1,0,1,1,1,1,1,1,1
KR_6751101009,440,-3,-39,9,-5,2,3,1,-1,3,4,-5,0,5,0,0,0,-1,1,2,0,0,-6,-3,9,6,2,0,-1,-1,1,-1,1,3,1
KR_6735052065,420,0,19,-4,5,0,2,2,0,0,0,1,3,2,4,4,0,0,0,0,0,3,-5,1,7,8,-7,0,1,1,1,1,1,2,1
KR_6750342472,420,4,62,52,7,3,5,2,3,6,3,1,5,4,1,6,5,-1,0,1,2,16,-1,1,5,6,3,0,1,1,1,1,1,4,1
KR_6746157281,420,3,22,31,10,6,7,1,4,10,6,0,2,2,0,0,0,0,0,0,0,12,2,2,4,6,4,0,1,0,1,1,-1,0,1
KR_6736804082,420,2,61,12,4,-1,2,3,0,3,3,6,8,2,-1,0,1,0,0,0,0,0,60,-1,4,3,25,0,1,1,1,1,1,4,1
KR_6769538407,420,0,-17,-20,9,1,1,0,1,3,2,2,3,1,0,2,2,5,5,0,2,13,74,-2,7,5,0,0,1,1,-1,1,1,6,1
KR_6758457201,420,1,38,7,0,-1,1,2,-1,3,4,1,2,1,3,6,3,-2,1,3,1,-5,6,5,4,9,4,0,0,-1,1,0,1,3,1
KR_6767186032,420,3,66,-4,8,6,6,0,-1,3,4,-1,2,3,1,3,2,3,3,0,0,-1,-14,6,5,11,5,0,0,1,1,0,1,6,1
KR_6765299008,420,4,49,25,7,1,3,2,4,7,3,2,2,0,2,3,1,-2,0,2,1,14,-387,-10,11,1,6,0,0,1,-1,0,1,6,1
KR_6759945132,420,4,56,21,7,4,6,2,4,4,0,3,4,1,-2,2,4,-2,1,3,1,3,70,3,3,6,-27,0,1,1,1,1,1,1,1
KR_6765395934,440,-1,19,-14,-2,2,3,1,-2,5,7,0,1,1,-1,3,4,-1,3,4,0,5,-6,1,3,4,1,0,-1,0,1,-1,-1,0,1
KR_6664251944,420,-2,2,-11,-5,-1,1,2,-5,3,8,-5,0,5,4,6,2,2,2,0,0,-2,-14,-3,9,6,2,0,0,-1,-1,-1,-1,2,1
KR_6757010063,440,3,59,-5,1,5,5,0,-8,1,9,0,2,2,0,6,6,4,6,2,0,1,3,-4,6,2,-1,0,0,1,1,1,1,5,1
KR_6756783280,420,3,45,24,10,4,5,1,2,5,3,-1,1,2,3,4,1,2,2,0,0,9,66,-3,9,6,1,0,2,1,1,1,1,2,1
KR_6728485540,420,1,27,33,4,-2,1,3,-1,1,2,0,1,1,5,5,0,2,3,1,0,6,-5,-5,9,4,-1,0,0,1,-1,0,-1,5,1
KR_6770025815,440,0,-110,-17,-1,2,3,1,-4,1,5,0,7,7,3,3,0,-2,0,2,0,1,4,1,4,5,5,0,-1,-1,1,-1,-1,3,1
KR_6750641862,420,0,48,-13,0,0,1,1,1,2,1,-1,1,2,0,2,2,0,2,2,0,2,-9,5,3,8,-2,0,0,1,-1,0,-1,3,1
KR_6754647440,420,3,0,20,12,0,1,1,6,8,2,7,8,1,0,1,1,-1,0,1,0,9,4,-1,5,4,-2,0,1,-1,1,1,1,2,1
KR_6764774953,420,4,61,36,2,3,5,2,2,4,2,-1,1,2,-1,1,2,-1,1,2,0,-10,23,4,5,9,0,0,0,-1,1,1,-1,2,1
KR_6758442987,440,0,10,8,-5,-5,0,5,4,5,1,-1,2,3,-4,2,6,1,2,1,0,-2,18,2,2,4,-3,0,1,1,-1,1,1,1,1
KR_6761685458,440,2,65,-12,9,0,1,1,1,1,0,6,6,0,2,2,0,0,0,0,0,7,-5,3,5,8,0,0,0,1,1,1,1,3,1
KR_6769600865,420,0,-6,31,1,1,2,1,-1,2,3,-2,3,5,3,5,2,0,2,2,0,-5,19,-1,6,5,1,0,1,1,1,1,-1,6,1
KR_6766241119,420,5,72,-4,0,-4,0,4,1,2,1,1,1,0,1,1,0,1,2,1,0,5,43,1,5,6,-16,0,0,1,1,1,1,1,1
KR_6751144279,420,4,65,9,12,3,5,2,1,1,0,2,3,1,0,2,2,6,6,0,0,14,54,6,4,10,-4,0,2,1,-1,1,1,1,1
KR_6734267458,420,0,8,29,3,0,1,1,2,7,5,0,2,2,-1,3,4,2,2,0,1,5,-6,-3,6,3,1,0,2,1,-1,1,-1,1,1
KR_6761410831,420,2,-9,-28,9,1,5,4,3,5,2,1,1,0,6,6,0,-2,0,2,0,10,4,2,4,6,-5,0,-1,-1,-1,-1,-1,1,1
KR_6766223432,420,2,85,37,8,2,3,1,2,4,2,2,8,6,0,1,1,2,2,0,1,4,29,1,7,8,-5,0,2,1,1,1,1,2,1
KR_6762440168,440,1,6,9,0,0,1,1,-2,3,5,0,2,2,0,2,2,2,2,0,0,7,-1,-3,8,5,-6,0,0,-1,1,1,-1,3,1
KR_6692190588,420,2,-36,-4,2,-2,1,3,3,3,0,-2,2,4,4,8,4,-1,1,2,-1,3,79,1,7,8,-2,0,0,1,1,1,-1,4,1
KR_6766752882,420,3,-1,11,8,1,1,0,0,4,4,4,5,1,-2,1,3,5,8,3,0,12,2,2,5,7,3,0,1,1,1,1,1,1,1
KR_6759088526,420,5,46,59,6,3,3,0,2,3,1,3,3,0,-3,4,7,1,1,0,0,6,34,-1,6,5,1,0,3,1,1,1,-1,6,1
KR_6711864414,420,5,85,-16,13,3,4,1,5,6,1,0,0,0,5,7,2,0,0,0,-1,17,-26,-3,7,4,16,0,1,1,1,1,-1,1,1
KR_6768673208,420,2,-10,-7,7,1,1,0,1,4,3,4,5,1,1,3,2,0,1,1,0,5,-232,0,9,9,6,0,1,1,1,1,1,2,1
KR_6720179434,420,1,15,-8,4,0,1,1,1,2,1,-1,3,4,4,5,1,0,1,1,0,4,2,4,1,5,-1,0,-1,1,1,-1,1,4,1
KR_6690343304,420,0,33,39,1,4,5,1,0,5,5,-4,0,4,0,1,1,1,1,0,0,4,-24,-2,9,7,4,0,1,0,1,1,1,0,1
KR_6756206353,420,3,49,-8,0,3,4,1,-4,1,5,1,2,1,-1,3,4,1,1,0,0,-4,54,-1,5,4,-18,0,-1,-1,-1,-1,1,6,1
KR_6671938168,420,2,5,-41,11,0,2,2,1,1,0,5,5,0,5,5,0,0,1,1,0,19,1,6,2,8,1,0,0,1,1,0,-1,4,1
KR_6762851131,440,2,41,21,4,-1,3,4,-5,0,5,3,3,0,6,6,0,1,1,0,0,7,-2,3,5,8,-1,0,0,1,0,0,1,1,1
KR_6765247126,420,-6,-12,-29,-12,-2,3,5,-4,2,6,-1,0,1,-5,2,7,0,0,0,0,-8,-1,2,3,5,-7,0,-2,-1,-1,-1,1,3,1
KR_6752333739,420,-2,13,19,-4,2,3,1,2,4,2,-5,0,5,-1,2,3,-2,1,3,0,-2,-5,-3,6,3,-3,0,-1,-1,-1,-1,-1,3,1
KR_6764954731,420,-2,-38,8,2,-4,0,4,0,2,2,2,3,1,1,5,4,3,4,1,0,10,-6,0,5,5,1,0,-1,-1,0,-1,1,6,1
KR_6657093814,420,4,24,16,10,7,8,1,2,3,1,4,4,0,-2,3,5,-1,0,1,0,4,-9,-4,8,4,1,0,0,-1,1,1,1,1,1
KR_6768370843,420,-2,16,-4,-8,-2,1,3,-5,0,5,-4,0,4,3,3,0,0,0,0,0,-6,1,-2,8,6,-6,0,-1,1,-1,-1,-1,1,1
KR_6744460072,420,1,76,38,1,1,3,2,3,6,3,1,3,2,-1,1,2,-3,0,3,0,-4,-27,0,6,6,1,0,0,1,1,1,-1,4,1
KR_6763506841,420,1,61,16,5,-3,2,5,5,5,0,0,1,1,5,7,2,-2,0,2,1,7,9,8,3,11,-3,0,1,1,-1,1,1,3,1
KR_6765582086,420,2,15,12,-3,1,1,0,-4,1,5,2,3,1,0,1,1,-2,0,2,0,-7,4,2,3,5,0,0,0,-1,1,0,-1,3,1
KR_6658979456,420,2,-3,45,6,-4,0,4,3,7,4,-1,3,4,6,7,1,2,3,1,0,14,-25,0,8,8,1,0,2,1,1,1,-1,3,1
KR_6770322196,420,2,36,-25,9,1,1,0,10,13,3,-1,3,4,-3,0,3,2,2,0,0,4,1,4,6,10,4,0,0,1,0,1,-1,5,1
KR_6668348411,420,3,17,-11,6,0,0,0,1,3,2,4,4,0,1,1,0,0,1,1,0,5,5,-6,11,5,-4,0,1,1,-1,1,1,4,1
KR_6639385708,420,4,28,28,0,-1,0,1,1,6,5,2,7,5,-2,1,3,0,1,1,0,-7,-33,2,3,5,1,0,0,1,1,-1,1,1,1
KR_6757879313,440,2,38,9,7,-1,1,2,2,2,0,6,6,0,-6,2,8,6,6,0,1,7,4,-5,7,2,-3,0,2,-1,1,1,1,5,1
KR_6737858347,420,-1,-27,0,3,2,5,3,0,3,3,-1,1,2,1,3,2,1,3,2,1,14,6,0,5,5,-4,0,0,1,-1,-1,1,2,1
KR_6651583261,420,0,73,-8,3,1,1,0,0,4,4,0,3,3,1,1,0,1,1,0,0,3,4,0,5,5,2,0,0,1,1,0,-1,5,1
KR_6769867981,440,-2,75,5,-5,-1,1,2,-6,0,6,4,6,2,-1,4,5,-1,0,1,1,-1,11,-1,5,4,0,0,-1,1,1,1,1,4,1
KR_6763962714,420,3,-49,-5,7,-6,0,6,2,4,2,8,9,1,5,7,2,-2,1,3,0,15,149,-2,7,5,-1,0,0,1,1,-1,1,6,1
KR_6708821260,440,4,81,36,13,7,8,1,6,7,1,0,1,1,-1,0,1,1,2,1,0,14,-2,6,0,6,3,0,2,1,0,1,1,6,1
KR_6765318693,420,4,36,0,11,4,5,1,0,3,3,0,2,2,5,6,1,2,3,1,0,10,0,2,2,4,2,0,1,1,-1,1,1,1,1
KR_6726377866,420,1,12,18,-1,0,1,1,2,3,1,0,2,2,-3,0,3,0,1,1,0,-4,-4,0,7,7,6,0,0,1,0,0,1,5,1
KR_6678092904,420,1,42,-18,5,0,2,2,5,5,0,0,1,1,-1,2,3,1,2,1,0,4,-2,0,4,4,1,0,1,-1,1,1,1,6,1
KR_6765514696,420,-1,-39,6,0,3,3,0,0,4,4,0,1,1,-2,2,4,-1,1,2,0,-1,6,4,5,9,-6,0,-3,1,1,-1,-1,6,1
KR_6645231669,420,9,115,12,19,3,3,0,9,11,2,0,1,1,6,6,0,1,1,0,2,16,-2,1,7,8,6,0,2,-1,1,1,1,6,1
KR_6768123456,420,2,23,-4,5,-4,2,6,5,10,5,1,1,0,4,5,1,-1,0,1,0,10,-9,3,6,9,1,0,0,1,-1,0,-1,1,1
KR_6768681632,420,-2,-13,4,3,-3,0,3,1,2,1,3,3,0,4,4,0,-2,1,3,0,2,1,-6,10,4,2,0,0,1,1,0,-1,1,1
KR_6770199199,420,0,-38,16,-1,0,3,3,0,3,3,0,1,1,-2,2,4,1,3,2,0,-1,0,-2,5,3,3,0,1,1,1,1,-1,2,1
KR_6747739693,420,-2,-24,-2,-7,-1,0,1,-3,2,5,1,3,2,-2,1,3,-2,1,3,0,-4,-2,-2,4,2,4,0,0,0,-1,0,-1,0,1
KR_6713157257,420,-1,-4,-13,-6,0,1,1,-2,4,6,-4,4,8,3,4,1,-3,3,6,-2,-3,-6,-7,10,3,-1,0,0,-1,-1,-1,-1,2,1
KR_6740254434,420,-1,-7,18,-1,-1,0,1,-2,3,5,-2,0,2,5,6,1,-1,0,1,0,2,-266,-3,4,1,0,0,0,1,-1,-1,-1,1,1
KR_6695562497,420,0,71,-1,-3,0,0,0,-3,2,5,3,6,3,-2,0,2,-1,0,1,0,0,-2,-4,7,3,0,0,1,-1,-1,1,1,5,1
KR_6759530420,420,3,-22,31,6,-1,0,1,4,5,1,1,1,0,-1,1,2,3,3,0,1,10,0,0,8,8,0,0,0,1,-1,0,1,2,1
KR_6763386849,420,2,-49,40,-2,-1,1,2,1,5,4,0,2,2,1,5,4,-3,1,4,0,-10,-2,-1,6,5,-5,0,-1,0,-1,-1,1,0,1
KR_6720735953,420,2,39,-9,5,3,4,1,-6,0,6,2,4,2,7,7,0,-1,0,1,2,11,-4,3,4,7,3,0,-1,1,1,-1,1,2,1
KR_6719727878,420,0,-11,28,11,-4,2,6,7,7,0,3,5,2,4,4,0,1,1,0,0,10,11,5,2,7,0,0,1,1,1,1,1,2,1
KR_6753652894,420,4,14,47,6,0,1,1,2,3,1,-2,2,4,4,4,0,2,2,0,-1,7,24,1,2,3,0,0,1,1,0,1,-1,3,1
KR_6769474474,440,4,35,17,11,4,4,0,3,4,1,0,4,4,-1,2,3,5,5,0,0,11,3,7,0,7,2,0,2,0,1,1,1,0,1
KR_6764029431,420,-1,41,-4,0,2,3,1,-3,2,5,1,3,2,1,2,1,-1,1,2,0,-3,-8,-5,7,2,4,0,-1,1,-1,-1,1,4,1
KR_6763450842,420,-4,-9,-3,-6,2,5,3,-6,4,10,-1,1,2,-3,3,6,2,3,1,0,-6,-28,3,5,8,7,0,0,-1,-1,-1,1,5,1
KR_6738595393,420,3,-6,0,10,4,6,2,5,8,3,0,3,3,2,5,3,-1,1,2,0,7,-23,-3,8,5,6,0,0,1,1,0,1,6,1
KR_6725714922,420,-2,-13,-24,-5,-1,1,2,-1,3,4,-2,0,2,0,3,3,-1,0,1,0,-8,28,6,5,11,-4,0,-1,-1,1,-1,-1,2,1
KR_6751224041,420,-1,-12,-24,-3,-1,1,2,3,4,1,-5,0,5,-2,2,4,2,2,0,0,0,-3,-2,7,5,3,0,-2,1,-1,-1,-1,1,1
KR_6696615950,420,-3,-49,-12,-1,-2,1,3,-3,1,4,-2,4,6,5,6,1,1,1,0,0,-1,24,-2,8,6,-2,0,0,1,1,0,1,4,1
KR_6764608206,440,-1,5,6,8,0,1,1,1,3,2,5,7,2,1,1,0,1,1,0,0,12,0,5,4,9,3,0,1,1,1,1,1,6,1
KR_6768661652,420,6,9,2,13,2,2,0,3,8,5,4,4,0,4,5,1,0,2,2,0,8,1,1,2,3,5,0,1,-1,1,1,-1,5,1
KR_6711687910,420,-1,-26,-1,0,-3,2,5,3,5,2,1,1,0,-1,0,1,0,1,1,-1,2,11,-4,8,4,-1,0,2,-1,1,1,-1,2,1
KR_6720411209,420,1,-59,-20,13,5,5,0,2,2,0,-2,1,3,8,10,2,0,0,0,0,13,3,0,5,5,-2,0,2,1,1,1,1,1,1
KR_6746097721,420,2,64,12,11,1,2,1,0,4,4,3,5,2,6,8,2,1,2,1,1,6,23,4,4,8,1,0,1,1,1,1,1,5,1
KR_6764200405,420,6,59,8,14,2,3,1,2,5,3,3,3,0,3,5,2,4,4,0,0,17,-3,-2,6,4,8,0,1,1,-1,1,1,3,1
KR_6759980653,420,7,91,24,9,1,2,1,4,5,1,2,2,0,-2,1,3,4,4,0,0,8,3,2,5,7,-2,0,2,1,1,1,-1,2,1
KR_6629267751,420,-2,-4,-8,0,-1,1,2,4,4,0,0,3,3,-4,1,5,1,1,0,0,-4,2,-2,8,6,0,0,0,1,-1,0,-1,3,1
KR_6768341412,420,-1,38,2,-5,-2,2,4,0,4,4,0,3,3,-1,1,2,-2,0,2,0,-2,-5,2,7,9,3,0,1,-1,1,-1,1,3,1
KR_6762969565,420,3,-14,22,3,3,3,0,-3,3,6,-2,1,3,2,2,0,3,3,0,0,2,177,0,5,5,1,0,1,1,-1,1,1,3,1
KR_6678290154,420,1,-15,-1,2,-4,0,4,5,6,1,-2,2,4,2,7,5,1,2,1,-1,1,-18,3,3,6,-8,0,0,-1,-1,1,-1,6,1
KR_6749643714,420,2,-16,-2,6,0,2,2,5,5,0,-2,1,3,2,2,0,1,2,1,0,10,13,5,2,7,-7,0,0,-1,0,0,1,2,1
KR_6701077829,440,1,-14,5,12,1,2,1,4,5,1,4,6,2,2,5,3,1,5,4,2,15,197,4,1,5,1,0,0,1,-1,1,1,1,1
KR_6760096080,420,-4,-63,5,-3,-1,0,1,-1,1,2,4,4,0,-5,0,5,0,1,1,0,-6,16,2,6,8,-1,0,0,1,-1,0,1,1,1
KR_6746588677,440,0,-31,-15,7,6,6,0,0,5,5,-2,1,3,1,2,1,2,3,1,0,6,-3,4,2,6,-1,0,2,0,0,1,1,0,1
KR_6743665465,420,1,30,14,-1,-4,1,5,5,6,1,3,5,2,-3,3,6,-2,0,2,0,1,52,-2,6,4,-15,0,0,-1,1,0,1,3,1
KR_6732400892,420,0,-2,-35,1,-3,2,5,-3,3,6,0,2,2,2,4,2,5,6,1,1,8,-16,-5,8,3,-2,0,-1,1,-1,1,1,6,1
KR_6768219674,420,1,4,13,2,1,3,2,4,5,1,1,5,4,-2,3,5,-2,0,2,3,8,16,-9,12,3,-1,0,0,1,1,0,1,4,1
KR_6734545593,440,6,64,11,12,1,2,1,0,3,3,2,3,1,4,4,0,5,8,3,1,8,13,2,3,5,6,0,1,1,-1,1,1,3,1
KR_6639397995,420,-1,-21,9,-2,1,3,2,-5,1,6,5,6,1,-1,0,1,-2,2,4,-2,-12,5,0,8,8,5,0,0,1,1,1,-1,2,1
KR_6725047820,420,1,0,63,1,4,6,2,2,2,0,1,4,3,-5,0,5,-1,3,4,-2,-10,-13,1,3,4,2,0,2,1,1,1,-1,3,1
KR_6749075606,420,2,13,2,3,-3,1,4,1,1,0,2,6,4,3,3,0,0,0,0,-1,1,-152,2,4,6,5,0,-1,1,-1,-1,-1,5,1
KR_6768281458,420,2,36,26,-2,0,2,2,-4,2,6,-1,1,2,5,6,1,-2,1,3,0,-3,9,-2,6,4,-3,0,1,0,1,1,-1,0,1
KR_6729444305,420,3,37,20,7,2,3,1,1,6,5,0,2,2,3,4,1,1,1,0,0,3,11,3,5,8,5,0,3,-1,1,1,1,3,1
KR_6768306201,420,1,34,-1,-5,0,3,3,-1,5,6,-2,2,4,2,6,4,-4,1,5,-2,-12,-28,2,6,8,1,0,-1,1,-1,-1,-1,6,1
KR_6732414202,440,-1,2,1,3,1,1,0,2,3,1,-2,0,2,1,3,2,1,1,0,0,0,3,0,7,7,3,0,0,-1,0,0,1,5,1
KR_6761153265,420,3,38,48,4,0,3,3,2,5,3,1,5,4,3,6,3,-2,3,5,2,11,5,-3,8,5,-2,0,1,1,-1,1,1,6,1
KR_6768380937,420,-3,-44,-2,-8,2,4,2,-3,1,4,-6,3,9,0,4,4,-1,4,5,0,-7,-8,-4,9,5,1,0,-3,1,-1,-1,-1,3,1
KR_6759080297,420,2,43,12,2,2,3,1,2,2,0,-1,0,1,-1,2,3,0,1,1,0,-4,133,-6,10,4,4,0,0,1,-1,0,1,2,1
KR_6699769861,420,4,55,5,9,2,3,1,3,7,4,2,2,0,1,2,1,1,2,1,0,15,-19,0,6,6,-1,0,1,1,-1,1,-1,1,1
KR_6705110758,420,2,-23,20,-7,-3,2,5,-3,3,6,4,5,1,-6,0,6,1,3,2,-2,-11,-6,-4,5,1,-1,0,1,-1,1,1,-1,4,1
KR_6720638079,420,0,7,4,1,-3,1,4,2,3,1,4,4,0,-1,1,2,-1,1,2,0,5,-6,2,4,6,-2,0,1,-1,1,1,-1,1,1
KR_6722640874,420,6,97,36,7,9,10,1,-4,2,6,0,1,1,1,2,1,1,2,1,0,-7,-36,2,6,8,17,0,2,1,1,1,-1,4,1
KR_6750812950,420,0,13,-24,9,5,7,2,4,6,2,2,4,2,-1,2,3,-1,1,2,0,6,-59,0,6,6,18,0,0,-1,1,0,1,5,1
KR_6741767653,420,-1,9,0,7,1,3,2,1,1,0,0,3,3,5,6,1,0,0,0,0,11,13,7,2,9,-1,0,1,-1,1,1,1,2,1
KR_6738430913,420,2,25,-36,-2,-4,0,4,1,3,2,0,2,2,1,5,4,0,2,2,1,4,-5,-8,11,3,1,0,1,1,-1,1,1,5,1
KR_6741601564,420,5,92,37,11,-2,1,3,4,7,3,6,7,1,5,8,3,-2,0,2,0,4,-11,4,4,8,3,0,1,1,1,1,-1,2,1
KR_6691890606,420,1,3,12,1,3,3,0,-5,0,5,0,3,3,4,6,2,-1,0,1,0,7,13,0,7,7,3,0,0,1,-1,0,-1,2,1
KR_6763160744,420,-2,-12,9,-8,0,1,1,-1,2,3,-2,5,7,2,6,4,-7,2,9,0,-12,-7,-2,5,3,0,0,-1,-1,-1,-1,-1,2,1
KR_6690410899,420,3,-2,-3,0,0,1,1,2,6,4,0,2,2,-1,1,2,-1,0,1,0,-5,-21,3,5,8,1,0,1,1,1,1,-1,5,1
KR_6755566715,420,5,32,17,10,-7,0,7,5,6,1,6,7,1,0,5,5,6,6,0,-1,15,-3,2,4,6,6,0,1,1,-1,1,-1,4,1
KR_6746839541,420,2,25,-5,5,2,4,2,2,2,0,-3,2,5,7,8,1,-3,0,3,0,6,-10,1,5,6,7,0,0,1,-1,1,1,2,1
KR_6734102542,420,1,-12,-8,-2,2,3,1,1,2,1,-1,4,5,-3,0,3,-1,2,3,-1,-3,0,2,2,4,7,0,-1,1,-1,-1,-1,4,1
KR_6728174450,420,4,47,28,-1,-2,1,3,-2,1,3,1,2,1,1,1,0,1,1,0,0,4,-7,-1,8,7,-1,0,0,1,0,1,-1,3,1
KR_6754095746,420,3,1,12,-1,0,1,1,1,3,2,-2,1,3,1,1,0,-1,0,1,0,-1,7,3,5,8,3,0,1,-1,1,1,1,4,1
KR_6763730994,420,-2,-67,-13,4,-2,0,2,-4,0,4,4,4,0,4,8,4,2,2,0,0,7,3,0,6,6,-1,0,-1,-1,-1,-1,1,5,1
KR_6769102692,420,2,30,0,3,0,1,1,5,6,1,-2,2,4,-1,4,5,1,2,1,-1,12,5,-4,9,5,0,0,1,1,1,1,-1,4,1
KR_6729372688,420,1,-11,-4,8,-1,1,2,7,10,3,3,5,2,-1,0,1,0,0,0,0,5,-4,3,4,7,1,0,1,1,1,1,1,3,1
KR_6748263726,420,0,0,22,-1,0,2,2,-2,1,3,-1,4,5,1,3,2,1,1,0,0,-1,192,-7,10,3,0,0,0,-1,-1,0,1,1,1
KR_6736858196,420,2,9,3,7,1,3,2,4,6,2,1,2,1,2,4,2,-1,3,4,0,8,6,3,5,8,-1,0,1,1,1,1,1,2,1
KR_6687725040,420,0,44,-20,3,0,2,2,3,5,2,1,1,0,2,5,3,-3,0,3,0,2,-25,-3,6,3,5,0,-1,-1,-1,1,-1,2,1
KR_6761415443,420,2,44,-1,2,3,3,0,-5,1,6,5,6,1,0,5,5,-1,1,2,0,2,7,5,3,8,0,0,0,1,-1,1,1,1,1
KR_6728093035,420,0,-10,-5,-2,-2,1,3,-2,2,4,5,5,0,2,4,2,-5,3,8,-1,-5,-6,-2,6,4,-1,0,0,1,-1,1,-1,5,1
KR_6768527482,420,-1,-8,-32,5,-2,3,5,-2,3,5,3,4,1,7,7,0,-1,2,3,0,9,-14,-6,13,7,9,0,1,1,-1,-1,1,2,1
KR_6770246889,420,0,-58,4,-7,-1,0,1,-3,3,6,0,3,3,-1,1,2,-2,0,2,-1,-1,13,6,7,13,-4,0,-1,-1,-1,-1,-1,1,1
KR_6664903403,420,8,61,0,15,1,1,0,6,9,3,8,11,3,-1,2,3,1,2,1,-1,12,-32,0,4,4,5,0,1,1,-1,-1,-1,6,1
KR_6768759786,440,2,26,4,6,0,2,2,1,4,3,3,5,2,0,0,0,2,2,0,0,3,-7,-4,6,2,7,0,2,-1,0,1,-1,5,1
KR_6756622150,420,-2,-29,24,-2,-1,3,4,0,3,3,-3,2,5,-1,0,1,3,3,0,0,-3,0,0,7,7,-3,0,0,1,1,-1,-1,4,1
KR_6668503126,420,-1,-32,-33,1,3,5,2,2,3,1,4,4,0,-6,1,7,-2,1,3,0,-1,104,2,4,6,5,0,0,1,1,1,-1,4,1
KR_6705601112,420,3,32,7,8,1,2,1,0,6,6,8,8,0,-1,3,4,0,1,1,0,11,5,0,4,4,-1,0,0,-1,1,1,-1,5,1
KR_6741486573,420,1,77,21,-1,4,5,1,1,4,3,-2,7,9,1,3,2,-5,0,5,0,-10,24,-1,5,4,-3,0,3,1,1,1,-1,6,1
KR_6748131541,420,2,-18,11,4,2,5,3,-1,2,3,0,3,3,1,6,5,2,2,0,-1,5,5,3,6,9,-4,0,0,0,1,0,1,0,1
KR_6696033201,420,2,35,-19,0,2,4,2,1,5,4,1,3,2,-4,2,6,0,2,2,-1,3,275,-2,4,2,5,0,1,-1,1,1,-1,4,1
KR_6763228588,420,-1,-23,12,3,0,3,3,-2,1,3,0,3,3,2,2,0,3,3,0,0,4,31,1,9,10,1,0,0,1,1,0,1,5,1
KR_6765858791,420,0,57,-13,4,-1,2,3,-1,0,1,6,7,1,0,3,3,0,2,2,1,5,-19,1,2,3,0,0,1,-1,-1,1,1,1,1
KR_6699830478,420,8,139,41,11,0,2,2,6,7,1,-1,1,2,5,7,2,1,2,1,0,16,0,3,3,6,-4,0,2,1,-1,1,1,5,1
KR_6768576062,420,2,56,8,6,-1,1,2,1,1,0,2,3,1,4,6,2,0,0,0,0,9,-3,-3,9,6,4,0,0,-1,1,0,-1,2,1
KR_6704270219,420,2,61,-15,3,0,4,4,3,3,0,0,1,1,-2,1,3,2,3,1,1,2,10,7,2,9,-7,0,2,-1,1,1,1,1,1
KR_6770296587,440,-3,39,-1,-2,-1,1,2,0,4,4,-1,0,1,1,3,2,-1,0,1,0,1,7,1,4,5,-2,0,0,1,-1,0,1,2,1
KR_6616802629,420,0,20,8,-2,1,2,1,-2,3,5,0,1,1,-3,0,3,2,3,1,0,-4,-7,-3,7,4,1,0,1,1,1,1,1,5,1
KR_6725218265,420,1,15,-20,8,2,3,1,3,4,1,-3,1,4,6,8,2,0,1,1,0,9,0,4,2,6,-6,0,0,1,1,1,1,5,1
KR_6696437018,440,4,60,24,10,-1,2,3,-2,1,3,5,7,2,6,8,2,2,4,2,0,6,-27,3,6,9,-3,0,0,-1,1,0,1,3,1
KR_6745897914,420,4,56,-5,5,-1,1,2,1,2,1,-1,4,5,3,5,2,3,3,0,0,10,-56,1,4,5,29,0,2,1,-1,1,-1,5,1
KR_6754591969,420,7,85,43,9,7,9,2,4,6,2,1,3,2,-1,1,2,-2,0,2,0,11,11,0,4,4,0,0,3,1,1,1,1,3,1
KR_6766167957,420,4,-28,3,7,-2,2,4,1,2,1,0,3,3,7,8,1,1,1,0,0,15,0,-3,7,4,-4,0,-1,1,0,-1,1,4,1
KR_6748389177,440,-2,-13,12,-2,-4,0,4,-2,1,3,-4,1,5,5,6,1,3,3,0,0,-5,-1,-2,5,3,-4,0,0,1,-1,0,-1,4,1
KR_6752423790,420,2,62,-3,2,1,3,2,-1,1,2,4,6,2,-4,0,4,2,3,1,0,2,2,1,5,6,-5,0,0,1,1,0,1,4,1
KR_6748349015,420,3,22,-9,4,1,1,0,3,8,5,0,5,5,2,4,2,-2,1,3,0,10,3,3,3,6,8,0,1,1,1,1,-1,1,1
KR_6750394817,420,-3,-50,0,-10,1,3,2,-3,0,3,-2,0,2,-3,0,3,-3,0,3,0,-8,-4,0,4,4,-4,0,0,1,1,-1,-1,3,1
KR_6759381814,420,2,-3,12,8,5,5,0,-2,1,3,0,2,2,2,3,1,3,4,1,0,6,-153,6,3,9,0,0,0,-1,1,0,1,4,1
KR_6754280443,420,-1,-102,-12,5,3,4,1,0,0,0,-3,3,6,2,5,3,3,5,2,-1,9,6,2,2,4,-4,0,-2,1,-1,-1,-1,6,1
KR_6668092233,420,4,-22,17,4,4,7,3,-1,1,2,0,2,2,3,3,0,-2,0,2,1,6,-3,-3,4,1,3,0,2,0,1,1,1,0,1
KR_6652460516,420,1,-14,-21,7,-2,2,4,-1,6,7,9,11,2,0,2,2,1,1,0,3,9,10,1,7,8,1,0,1,1,-1,1,1,1,1
KR_6768554703,420,-2,-65,9,-7,-3,0,3,0,2,2,-2,0,2,0,1,1,-2,2,4,0,-6,-2,-2,6,4,-2,0,-1,-1,-1,-1,-1,4,1
KR_6764195192,420,-1,7,31,-6,0,3,3,0,3,3,1,2,1,-7,0,7,0,1,1,0,-18,186,-2,4,2,0,0,2,1,1,1,1,2,1
KR_6760942004,420,0,42,0,1,-3,0,3,-2,0,2,0,3,3,4,4,0,2,2,0,1,-7,7,2,5,7,-1,0,1,1,1,1,1,6,1
KR_6768109254,420,4,66,-11,12,2,2,0,4,7,3,4,5,1,2,5,3,0,1,1,0,9,11,6,2,8,8,0,0,1,-1,1,1,2,1
KR_6674704880,420,0,-49,-24,1,1,1,0,1,6,5,-4,0,4,1,4,3,2,2,0,0,-1,42,-2,7,5,-6,0,0,1,1,0,1,3,1
KR_6763280437,440,5,18,-8,3,1,1,0,0,1,1,4,4,0,-2,3,5,0,2,2,0,1,-2,-3,4,1,-3,0,0,1,1,0,1,2,1
KR_6688301004,420,2,18,12,7,1,2,1,-2,2,4,4,5,1,5,6,1,-1,1,2,0,6,-4,-2,5,3,-1,0,0,0,-1,-1,1,0,1
KR_6703495447,420,5,3,20,13,8,9,1,2,3,1,5,5,0,-2,1,3,0,0,0,0,6,-10,-6,7,1,-2,0,3,1,1,1,-1,1,1
KR_6769620412,440,4,49,28,3,1,4,3,5,5,0,1,6,5,-2,1,3,-2,2,4,0,5,-6,-2,5,3,0,0,0,-1,-1,-1,1,4,1
KR_6755009252,440,4,41,28,-2,2,3,1,2,4,2,-7,2,9,-2,2,4,3,4,1,0,8,38,6,3,9,-1,0,2,1,1,1,-1,5,1
KR_6768842551,420,1,-4,17,3,-3,1,4,4,5,1,3,4,1,-2,2,4,1,2,1,0,6,0,-2,5,3,5,0,1,-1,-1,1,1,2,1
KR_6684284419,420,-1,2,22,-2,3,5,2,1,5,4,-3,0,3,-2,4,6,-1,0,1,0,-3,-3,-5,9,4,3,0,-1,-1,1,1,-1,6,1
KR_6766916710,440,0,82,19,-1,-2,2,4,2,5,3,-1,1,2,1,1,0,-1,0,1,0,4,-7,1,3,4,-3,0,1,-1,1,1,-1,2,1
KR_6763071268,440,2,11,-18,9,0,1,1,0,2,2,5,6,1,3,4,1,1,2,1,2,18,-5,1,4,5,3,0,1,1,-1,1,-1,5,1
KR_6639342820,420,7,129,-15,15,8,9,1,0,1,1,8,9,1,0,4,4,-1,0,1,0,6,351,4,2,6,2,0,1,1,1,1,1,1,1
KR_6751205972,440,5,72,42,3,2,3,1,0,7,7,-3,1,4,-2,1,3,6,7,1,0,3,1,-5,8,3,-1,0,0,1,1,1,-1,2,1
KR_6768516134,420,2,30,2,0,1,1,0,2,4,2,0,1,1,-2,2,4,-1,0,1,0,2,-146,2,6,8,5,0,0,-1,1,1,-1,2,1
KR_6768517039,440,1,3,-13,8,0,2,2,3,5,2,1,2,1,1,2,1,3,5,2,0,10,243,5,4,9,1,0,0,-1,0,0,1,1,1
KR_6679703515,420,3,-37,-10,8,6,7,1,-1,2,3,2,4,2,1,5,4,0,1,1,2,16,-15,5,5,10,-1,0,0,1,-1,-1,1,6,1
KR_6679979142,420,0,38,13,1,2,3,1,-1,5,6,-5,1,6,5,5,0,0,0,0,2,13,5,-2,5,3,1,0,1,-1,0,1,1,6,1
KR_6707714667,420,0,64,0,10,2,5,3,6,7,1,0,1,1,0,3,3,2,2,0,1,2,11,-2,6,4,-4,0,2,-1,1,1,1,3,1
KR_6770071087,420,2,12,8,8,-2,2,4,1,2,1,7,9,2,3,5,2,-1,1,2,2,5,-315,2,2,4,-2,0,0,0,1,0,1,0,1
KR_6764978801,420,-1,-15,12,1,-4,0,4,5,7,2,7,10,3,-6,1,7,-1,1,2,0,-4,-11,-2,6,4,0,0,0,1,1,1,1,6,1
KR_6708746955,440,1,2,14,-1,3,6,3,-3,3,6,3,4,1,-1,2,3,-3,0,3,1,2,3,5,0,5,1,0,1,0,1,1,1,0,1
KR_6768446787,440,1,48,-3,9,-1,1,2,-1,3,4,-1,2,3,6,6,0,6,7,1,2,14,3,2,5,7,-1,0,-1,1,1,-1,1,6,1
KR_6768494928,420,3,57,-24,9,5,5,0,-6,2,8,4,5,1,5,7,2,1,2,1,0,11,19,4,5,9,1,0,1,1,1,1,1,3,1
KR_6763871288,420,-2,39,-12,-2,1,2,1,-2,4,6,-4,2,6,3,4,1,0,1,1,1,-4,-3,6,1,7,7,0,1,-1,-1,-1,1,4,1
KR_6675960179,420,3,28,0,6,3,4,1,3,3,0,2,4,2,-2,1,3,0,0,0,0,4,-35,1,5,6,12,0,0,1,1,0,1,5,1
KR_6769384965,420,4,14,24,13,2,3,1,0,4,4,4,6,2,4,5,1,3,3,0,0,10,7,5,1,6,2,0,0,1,1,1,1,3,1
KR_6761288690,420,4,10,16,6,-2,0,2,4,6,2,0,4,4,4,6,2,0,1,1,1,8,1,4,3,7,-5,0,0,1,1,1,1,5,1
KR_6758069186,420,2,13,42,-1,1,2,1,0,2,2,-2,1,3,-1,2,3,1,2,1,2,2,-38,-1,7,6,0,0,1,1,1,1,1,4,1
KR_6763904799,420,0,-2,-4,7,0,2,2,7,7,0,-1,2,3,2,3,1,-1,0,1,0,2,9,2,3,5,-5,0,0,1,-1,0,1,3,1
KR_6759879041,420,6,13,8,18,5,5,0,3,4,1,3,3,0,6,7,1,1,2,1,1,29,5,3,3,6,0,0,0,1,-1,1,1,5,1
KR_6764035120,420,1,-27,22,3,3,3,0,4,8,4,-3,0,3,-2,2,4,1,3,2,0,1,6,-1,4,3,1,0,0,1,0,0,1,3,1
KR_6767526083,420,5,109,18,7,-1,1,2,0,6,6,5,6,1,3,6,3,0,1,1,0,-4,0,0,6,6,9,0,0,-1,1,1,1,6,1
KR_6729273452,420,4,48,20,7,-7,0,7,5,6,1,6,7,1,5,7,2,-2,2,4,1,14,25,2,3,5,-2,0,1,-1,-1,1,-1,6,1
KR_6769092369,420,-1,22,-6,-8,1,2,1,1,3,2,-5,0,5,-2,5,7,-3,1,4,0,-13,-4,1,4,5,-2,0,-1,-1,-1,-1,1,6,1
KR_6753962816,420,2,15,24,2,1,2,1,-1,0,1,0,2,2,1,2,1,1,2,1,0,3,122,-1,6,5,-4,0,-1,0,-1,-1,-1,0,1
KR_6761647149,420,4,45,35,9,3,3,0,-3,0,3,2,3,1,5,7,2,2,3,1,0,7,7,-1,6,5,2,0,0,1,-1,0,1,2,1
KR_6636177219,420,4,53,42,7,3,3,0,3,4,1,-1,1,2,2,2,0,0,1,1,0,8,-211,2,4,6,0,0,2,1,1,1,1,1,1
KR_6714822819,420,0,-9,13,1,0,3,3,-1,1,2,1,3,2,1,3,2,0,2,2,0,2,3,9,3,12,1,0,1,1,1,1,1,2,1
KR_6769021630,420,5,84,-3,2,0,4,4,-3,2,5,-1,5,6,-2,1,3,8,8,0,-1,-12,-27,-3,5,2,3,0,2,1,-1,1,-1,1,1
KR_6640770739,420,6,37,30,11,-1,1,2,0,1,1,4,4,0,7,9,2,1,1,0,0,8,6,5,6,11,3,0,0,-1,1,0,1,4,1
KR_6770295785,440,4,25,10,18,8,8,0,0,1,1,10,12,2,-1,3,4,1,1,0,1,7,-29,7,0,7,0,0,3,1,0,1,1,3,1
KR_6759134573,420,-1,-111,3,6,-4,1,5,0,3,3,0,1,1,10,10,0,0,0,0,0,12,2,0,6,6,-6,0,1,1,1,-1,-1,4,1
KR_6750957176,420,0,-24,18,6,1,2,1,6,8,2,-5,1,6,3,8,5,1,2,1,1,5,19,2,4,6,1,0,2,0,1,1,-1,0,1
KR_6657682639,420,0,-50,14,3,1,1,0,-1,1,2,4,5,1,-1,3,4,0,1,1,0,8,6,1,6,7,-2,0,0,-1,1,-1,-1,4,1
KR_6768679509,420,2,33,-20,2,2,5,3,-3,0,3,1,4,3,2,5,3,0,0,0,0,1,13,0,7,7,-7,0,0,1,-1,-1,1,1,1
KR_6597166447,420,0,14,25,6,-3,0,3,1,5,4,3,4,1,5,7,2,0,1,1,0,10,2,4,5,9,0,0,1,-1,1,1,1,1,1
KR_6764657941,420,2,24,21,-1,-1,3,4,3,3,0,-3,0,3,2,3,1,-2,0,2,0,-1,-7,-6,9,3,6,0,3,-1,1,1,1,6,1
KR_6751370751,420,-1,-49,12,8,-1,1,2,3,4,1,2,3,1,0,6,6,4,6,2,0,13,-18,4,2,6,3,0,-1,0,1,-1,1,0,1
KR_6738959850,420,4,35,28,13,4,6,2,3,5,2,5,6,1,1,1,0,0,0,0,0,11,-31,-3,6,3,7,0,1,1,1,1,1,5,1
KR_6759847374,420,5,28,2,3,5,5,0,2,4,2,-1,3,4,0,4,4,-3,0,3,0,3,3,-1,6,5,-2,0,1,1,-1,1,-1,4,1
KR_6722168144,420,0,9,2,-6,-3,0,3,0,3,3,-1,2,3,-2,1,3,0,0,0,0,-10,2,-2,8,6,2,0,1,-1,1,1,-1,2,1
KR_6770159017,420,-2,31,29,-2,-4,0,4,0,4,4,3,4,1,-1,2,3,0,0,0,0,-5,-11,1,3,4,-1,0,1,1,-1,-1,-1,5,1
KR_6759585282,420,1,4,-9,2,-2,2,4,4,7,3,0,3,3,0,4,4,0,0,0,0,-2,116,5,4,9,1,0,2,1,-1,1,-1,3,1
KR_6741779225,420,2,-1,14,2,4,4,0,-2,0,2,-3,1,4,3,6,3,0,0,0,0,-1,-32,-4,9,5,5,0,1,-1,1,1,1,6,1
KR_6754924274,420,-1,26,4,-7,1,2,1,-4,4,8,0,1,1,-1,0,1,-3,0,3,0,-11,110,0,8,8,5,0,1,1,1,1,1,2,1
KR_6723519749,420,0,-10,4,4,3,4,1,3,5,2,0,1,1,0,5,5,-2,1,3,0,0,2,0,7,7,3,0,0,-1,-1,-1,1,2,1
KR_6768695629,420,0,46,-8,9,6,6,0,2,3,1,-3,0,3,2,2,0,2,2,0,0,7,37,-1,5,4,1,0,1,1,1,1,1,4,1
KR_6615800602,420,5,85,21,7,2,3,1,0,2,2,5,7,2,1,2,1,-1,0,1,0,1,6,6,2,8,-7,0,1,-1,1,1,1,4,1
KR_6723722008,420,6,107,39,14,2,2,0,0,5,5,7,7,0,5,5,0,0,1,1,1,14,6,3,2,5,-3,0,3,1,1,1,1,6,1
KR_6766765873,420,4,33,12,8,1,2,1,3,4,1,2,2,0,2,2,0,0,1,1,0,11,-3,0,8,8,8,0,0,-1,-1,0,-1,5,1
KR_6694636287,420,5,90,4,11,-1,2,3,1,3,2,4,5,1,3,3,0,4,4,0,0,4,9,0,5,5,1,0,0,1,-1,1,1,2,1
KR_6760322446,420,0,-16,4,-3,0,1,1,5,5,0,-2,2,4,-5,0,5,-1,2,3,0,2,126,-1,6,5,8,0,0,1,1,1,1,3,1
KR_6732268011,420,4,-30,40,6,2,6,4,2,2,0,1,4,3,1,3,2,0,2,2,0,9,-4,2,4,6,-4,0,2,1,-1,1,-1,4,1
KR_6761811136,420,4,29,22,3,0,2,2,2,4,2,2,3,1,-3,5,8,2,3,1,1,3,11,1,3,4,1,0,0,-1,1,1,1,4,1
KR_6752979092,420,1,45,5,4,3,3,0,0,1,1,2,2,0,0,6,6,-1,1,2,0,1,-57,1,6,7,2,0,1,-1,1,1,1,3,1
KR_6760535189,420,0,-6,-20,-3,2,3,1,3,7,4,-3,3,6,-3,2,5,-2,0,2,0,-10,156,-2,8,6,3,0,3,-1,1,1,1,2,1
KR_6756448749,420,4,37,-9,3,3,3,0,3,6,3,-1,7,8,0,4,4,-2,0,2,-3,-7,-1,2,6,8,-4,0,-2,-1,0,-1,-1,6,1
KR_6749162267,420,-1,-68,28,4,4,4,0,-1,0,1,2,4,2,-1,0,1,0,1,1,-1,6,9,-2,6,4,1,0,0,-1,1,-1,-1,2,1
KR_6629198338,420,6,16,23,12,4,5,1,1,5,4,4,6,2,3,8,5,0,0,0,-1,10,29,4,7,11,8,0,3,1,1,1,-1,1,1
KR_6753743685,420,3,-9,-6,9,2,2,0,2,2,0,1,3,2,4,5,1,0,1,1,0,7,-40,0,6,6,-1,0,1,1,-1,1,1,1,1
KR_6673680480,420,-3,-68,-15,-6,-1,2,3,-3,1,4,0,2,2,-4,2,6,2,2,0,0,-1,2,4,2,6,-6,0,-3,-1,-1,-1,1,6,1
KR_6747715269,420,1,68,-8,-4,4,4,0,0,2,2,-2,0,2,-7,1,8,1,2,1,0,-8,3,-1,6,5,0,0,1,-1,-1,1,1,1,1
KR_6767907647,440,-2,31,-8,-7,-2,1,3,3,3,0,2,3,1,-13,0,13,3,3,0,1,0,41,-6,7,1,6,0,0,0,-1,1,1,0,1
KR_6751590933,420,3,17,-8,16,2,2,0,3,4,1,8,10,2,-1,0,1,4,5,1,0,10,-238,5,3,8,0,0,2,-1,1,1,1,6,1
KR_6746039964,420,3,126,-11,5,-1,0,1,-1,2,3,7,7,0,1,1,0,-1,0,1,0,1,37,-3,5,2,-30,0,2,1,-1,1,1,2,1
KR_6764617985,420,1,21,13,3,4,5,1,-1,2,3,1,1,0,0,1,1,-1,0,1,0,7,24,5,3,8,6,0,1,-1,1,1,1,5,1
KR_6750934891,440,3,31,-3,8,1,4,3,-1,4,5,0,2,2,4,7,3,4,4,0,0,19,-48,4,4,8,19,0,0,1,1,-1,1,1,1
KR_6760793288,420,1,17,12,-3,1,1,0,-3,3,6,0,1,1,-1,0,1,0,0,0,0,1,-3,-5,11,6,6,0,1,1,0,1,-1,5,1
KR_6751569623,420,5,96,33,9,0,0,0,0,2,2,1,5,4,6,10,4,2,2,0,0,0,-31,0,5,5,-7,0,2,1,1,1,-1,2,1
KR_6743348822,420,1,5,-8,5,3,4,1,-1,1,2,6,9,3,-1,1,2,-2,2,4,1,6,13,5,2,7,-3,0,0,-1,-1,-1,1,1,1
KR_6739489899,420,4,27,27,11,4,6,2,4,4,0,4,4,0,-2,3,5,1,1,0,1,14,3,3,4,7,3,0,2,1,1,1,1,5,1
KR_6736558010,420,0,6,0,-8,-3,0,3,-1,4,5,0,1,1,-5,2,7,1,1,0,0,-10,-5,-4,7,3,0,0,-1,0,-1,-1,-1,0,1
KR_6728228593,420,6,109,-4,9,5,6,1,0,4,4,4,5,1,-1,0,1,1,1,0,0,6,31,-2,6,4,7,0,0,-1,-1,1,1,1,1
KR_6766107961,420,1,-23,-20,-1,2,7,5,-1,2,3,0,1,1,-1,3,4,-1,0,1,0,-11,-1,-1,4,3,0,0,0,1,1,-1,-1,2,1
KR_6751610111,420,3,25,13,-2,0,2,2,1,5,4,2,2,0,-1,1,2,-4,0,4,0,-4,-5,-5,11,6,0,0,1,-1,1,1,1,3,1
KR_6768323865,420,3,55,20,4,0,1,1,-1,1,2,0,1,1,0,3,3,5,5,0,0,6,89,0,5,5,-1,0,2,1,0,1,-1,1,1
KR_6642852260,420,3,18,-13,6,0,4,4,3,3,0,3,3,0,-1,3,4,1,1,0,0,-2,7,-4,6,2,-3,0,-1,-1,-1,-1,1,6,1
KR_6766722735,420,1,-5,-16,1,1,2,1,-5,1,6,1,1,0,5,7,2,-1,2,3,0,-4,5,0,4,4,-1,0,0,1,1,0,-1,1,1
KR_6668810612,420,-1,104,-17,0,-3,2,5,-1,2,3,-3,2,5,2,5,3,5,5,0,0,-2,9,-1,6,5,-3,0,4,1,1,1,1,3,1
KR_6768125192,440,4,25,46,11,3,3,0,6,7,1,7,7,0,-3,3,6,-2,1,3,0,4,-5,2,4,6,2,0,1,1,0,1,1,1,1
KR_6769063764,420,1,-40,3,10,-1,1,2,4,6,2,7,7,0,0,3,3,0,1,1,0,4,-2,2,5,7,-2,0,0,-1,1,0,1,3,1
KR_6728680867,420,0,32,16,2,0,0,0,3,4,1,-2,1,3,2,3,1,-1,0,1,0,-5,5,3,5,8,-1,0,-1,1,-1,-1,-1,6,1
KR_6709258896,420,3,47,23,11,7,8,1,1,4,3,6,6,0,-2,4,6,-1,0,1,-1,9,35,4,5,9,4,0,2,1,1,1,-1,4,1
KR_6768709970,440,1,-40,-28,3,0,0,0,-2,0,2,3,3,0,4,4,0,-2,0,2,-1,2,4,3,6,9,0,0,0,-1,1,0,-1,5,1
KR_6727317279,420,2,23,-24,6,4,6,2,4,8,4,-1,1,2,-2,4,6,1,2,1,1,2,4,-3,6,3,3,0,1,0,-1,1,1,0,1
KR_6753987189,420,1,-3,16,-7,0,2,2,-3,0,3,1,3,2,-4,3,7,-1,1,2,1,-15,-4,-5,7,2,1,0,0,-1,-1,1,1,6,1
KR_6764066359,420,2,28,8,4,4,4,0,-2,1,3,1,3,2,-2,1,3,3,4,1,0,0,6,0,5,5,3,0,1,-1,-1,1,-1,4,1
KR_6768716209,440,-2,-52,-12,4,-1,1,2,1,3,2,0,2,2,0,1,1,4,7,3,0,6,6,1,5,6,-5,0,0,-1,1,0,-1,2,1
KR_6719063939,420,0,-59,-15,-1,-3,2,5,-2,1,3,1,1,0,3,3,0,0,0,0,0,8,-1,-4,6,2,1,0,-2,-1,-1,-1,-1,4,1
KR_6766449553,420,-2,57,-58,9,4,5,1,2,4,2,1,2,1,2,5,3,0,0,0,0,8,-5,-1,4,3,4,0,1,-1,-1,1,1,4,1
KR_6764887918,420,5,39,-12,7,3,3,0,3,5,2,0,1,1,1,2,1,0,1,1,0,11,-32,1,5,6,1,0,3,0,1,1,-1,0,1
KR_6705728464,420,0,26,13,-4,1,3,2,0,6,6,0,2,2,-1,2,3,-4,2,6,-1,-8,1,-2,7,5,1,0,0,1,-1,0,-1,6,1
KR_6725787530,420,0,17,-25,1,-2,0,2,0,2,2,1,2,1,3,5,2,-1,0,1,0,-3,-31,1,3,4,-2,0,0,-1,1,0,-1,5,1
KR_6764606031,420,4,-42,9,12,1,1,0,6,6,0,4,5,1,2,3,1,-1,0,1,0,15,32,-2,5,3,-1,0,0,1,1,0,1,6,1
KR_6725202067,420,0,-49,4,-2,0,0,0,1,6,5,-5,3,8,0,4,4,2,3,1,1,1,16,8,1,9,-3,0,0,1,1,-1,1,3,1
KR_6695881003,420,2,-4,4,6,4,5,1,3,3,0,1,1,0,-4,0,4,2,2,0,0,1,165,3,5,8,-5,0,-1,-1,1,-1,-1,1,1
KR_6759225849,440,0,67,-15,4,5,7,2,4,6,2,-3,2,5,1,5,4,-3,0,3,0,-4,-10,0,3,3,4,0,0,-1,0,0,1,1,1
KR_6737185582,420,3,20,9,6,3,6,3,3,3,0,-2,5,7,3,4,1,-1,1,2,0,0,239,-3,5,2,3,0,1,1,1,1,1,6,1
KR_6770370434,420,2,31,-8,2,4,5,1,-2,1,3,-1,3,4,2,3,1,-1,0,1,1,3,5,4,3,7,-3,0,2,-1,1,1,1,3,1
KR_6734489339,440,1,46,13,3,0,4,4,2,6,4,2,5,3,-2,0,2,1,4,3,0,-2,23,2,7,9,1,0,1,-1,1,1,-1,6,1
KR_6766236570,420,5,14,11,8,0,2,2,6,8,2,1,3,2,3,5,2,-2,0,2,1,4,24,7,3,10,-1,0,1,1,1,1,1,3,1
KR_6742263677,420,2,6,3,0,-5,0,5,-2,2,4,3,6,3,3,4,1,1,2,1,0,1,-7,-1,4,3,4,0,1,1,1,1,-1,3,1
KR_6727484096,440,5,17,37,7,-4,1,5,2,3,1,6,7,1,-1,2,3,4,5,1,0,8,-5,0,4,4,3,0,-1,-1,-1,-1,1,3,1
KR_6764580189,420,2,-2,20,11,4,4,0,5,6,1,0,1,1,1,2,1,1,1,0,0,13,-28,-4,9,5,6,0,1,1,1,1,1,5,1
KR_6740177687,420,6,29,-2,2,3,3,0,3,6,3,1,3,2,-6,0,6,1,1,0,-2,-2,29,0,6,6,-1,0,2,1,1,1,-1,1,1
KR_6743414061,420,-3,-23,14,-6,-3,0,3,-2,2,4,-2,3,5,1,4,3,0,0,0,0,-6,44,0,4,4,-20,0,0,1,-1,0,1,1,1
KR_6770331690,440,2,-1,-23,-3,-3,1,4,-1,2,3,4,5,1,-3,0,3,0,0,0,0,-5,44,-2,4,2,-37,0,0,0,-1,0,-1,0,1
KR_6697826265,420,1,7,12,-7,-4,0,4,-5,1,6,3,7,4,-2,1,3,1,1,0,0,-3,29,-2,6,4,5,0,0,0,-1,0,-1,0,1
KR_6743243030,440,1,10,-30,4,2,4,2,-2,1,3,2,4,2,3,5,2,-1,0,1,1,1,-4,-3,4,1,0,0,0,0,0,1,1,0,1
KR_6681861499,420,3,21,20,7,1,3,2,9,9,0,-4,0,4,1,1,0,0,1,1,-1,5,9,1,5,6,-4,0,-1,1,1,-1,-1,4,1
KR_6760960795,420,1,-13,-3,-2,1,3,2,6,6,0,-3,0,3,-4,0,4,-2,1,3,0,0,6,-1,7,6,-6,0,-1,1,-1,-1,1,5,1
KR_6730722137,440,1,-16,11,12,0,1,1,4,4,0,0,3,3,4,5,1,4,5,1,1,14,-4,3,2,5,1,0,0,1,0,1,1,4,1
KR_6755986475,420,6,48,-8,10,2,3,1,5,7,2,0,2,2,0,0,0,3,3,0,0,12,0,4,2,6,7,0,3,-1,1,1,1,1,1
KR_6761301397,420,5,13,20,15,1,2,1,1,4,3,4,5,1,8,9,1,1,2,1,1,17,1,1,6,7,5,0,0,-1,1,1,1,1,1
KR_6764932525,420,0,47,-3,-4,-3,1,4,-2,0,2,0,3,3,0,3,3,1,1,0,-1,-1,-103,0,5,5,-25,0,0,1,-1,-1,-1,1,1
KR_6768831441,420,-2,-9,-14,-2,1,2,1,-1,0,1,-1,2,3,-1,0,1,0,1,1,0,-3,-10,-7,9,2,1,0,1,-1,1,1,-1,5,1
KR_6645044177,420,7,88,11,11,2,3,1,7,8,1,0,2,2,1,1,0,1,1,0,3,13,13,3,3,6,-1,0,1,-1,1,1,1,4,1
KR_6770106105,440,-2,-9,-4,-5,3,3,0,0,1,1,-7,0,7,1,4,3,-2,0,2,0,-4,-7,-5,8,3,-1,0,-1,-1,-1,-1,-1,2,1
KR_6652951284,420,3,44,-7,1,0,0,0,4,6,2,-1,0,1,0,3,3,-2,0,2,0,6,1,-4,6,2,10,0,0,1,-1,0,1,6,1
KR_6766250224,420,1,-3,-17,4,-2,0,2,-1,4,5,0,1,1,6,6,0,1,4,3,0,-3,-3,1,8,9,7,0,0,-1,1,0,-1,5,1
KR_6752732687,420,6,34,15,17,0,4,4,1,3,2,4,7,3,8,9,1,4,5,1,4,22,-7,-7,11,4,2,0,4,1,1,1,1,5,1
KR_6770320654,420,1,40,-16,7,2,3,1,-2,3,5,3,3,0,1,1,0,3,4,1,0,9,-315,-2,6,4,36,0,0,-1,-1,0,1,6,1
KR_6696472689,420,3,65,-28,10,1,2,1,0,2,2,4,6,2,4,4,0,1,2,1,0,9,-389,1,3,4,5,0,1,-1,1,1,1,2,1
KR_6759257481,440,6,58,12,19,4,4,0,2,2,0,-2,0,2,11,12,1,4,4,0,2,27,-5,0,5,5,0,0,2,1,-1,1,1,3,1
KR_6759033284,420,-4,-32,-29,-4,2,3,1,-5,1,6,-3,0,3,0,3,3,2,3,1,-1,-11,149,-4,7,3,4,0,-1,-1,-1,-1,-1,5,1
KR_6766188933,420,3,53,43,7,-2,1,3,2,7,5,1,2,1,6,7,1,0,1,1,0,0,-44,-1,5,4,5,0,1,1,1,1,1,5,1
KR_6613829747,420,-1,-16,22,-1,-2,1,3,1,4,3,-1,1,2,0,1,1,1,1,0,0,-1,2,1,6,7,4,0,-1,1,1,-1,1,5,1
KR_6767775846,420,3,40,5,8,0,1,1,-2,3,5,3,3,0,7,9,2,0,0,0,0,3,6,4,5,9,-2,0,0,-1,0,1,1,4,1
KR_6764745600,420,6,51,7,16,2,3,1,6,8,2,3,5,2,6,7,1,-1,0,1,-1,12,1,7,3,10,0,0,0,-1,1,1,-1,6,1
KR_6761568915,440,2,25,19,4,0,1,1,3,5,2,-2,2,4,4,5,1,-1,1,2,1,7,58,-1,7,6,1,0,0,1,-1,0,1,4,1
KR_6766753824,420,0,71,7,-4,0,4,4,-1,1,2,-1,1,2,2,5,3,-4,0,4,0,-6,-21,3,4,7,10,0,0,-1,0,1,1,3,1
KR_6660393850,420,1,65,-12,0,0,2,2,1,4,3,-4,0,4,3,6,3,0,0,0,0,1,40,0,6,6,-19,0,0,1,0,1,1,1,1
KR_6762840284,420,3,90,44,4,5,6,1,8,8,0,-2,3,5,-4,2,6,-3,0,3,0,0,-5,-1,3,2,2,0,3,1,1,1,1,4,1
KR_6749035672,420,5,19,24,11,1,4,3,2,2,0,2,3,1,6,6,0,0,2,2,0,14,22,3,4,7,2,0,-1,-1,1,-1,1,3,1
KR_6747906801,420,3,63,0,15,2,4,2,-2,1,3,6,6,0,5,5,0,4,4,0,1,18,14,3,5,8,-1,0,2,1,1,1,1,2,1
KR_6707086149,440,4,17,12,6,-3,0,3,10,13,3,-2,1,3,1,1,0,0,0,0,-1,-3,-1,0,5,5,5,0,1,-1,-1,1,-1,6,1
KR_6739375719,420,4,112,34,18,8,8,0,4,5,1,5,6,1,2,4,2,-1,0,1,2,23,-1,3,4,7,3,0,3,1,1,1,1,1,1
KR_6753974356,420,-1,-4,-29,-1,2,3,1,-1,1,2,-1,3,4,-2,0,2,1,1,0,0,5,38,-1,6,5,-24,0,0,-1,0,-1,1,5,1
KR_6689988575,420,-1,-12,-36,0,-1,2,3,2,3,1,2,2,0,-2,2,4,-1,1,2,-1,2,-4,-4,9,5,3,0,0,-1,1,0,-1,1,1
KR_6711589805,420,-2,-47,24,-5,1,2,1,1,6,5,-1,4,5,-3,1,4,-3,0,3,0,-16,-6,2,6,8,1,0,2,-1,1,1,1,6,1
KR_6761669919,420,1,1,8,-2,-2,0,2,1,2,1,0,1,1,0,2,2,-1,1,2,-3,-3,14,5,2,7,1,0,0,1,-1,0,-1,5,1
KR_6766699429,420,2,19,8,3,5,6,1,-2,0,2,-1,1,2,1,2,1,0,1,1,0,-1,-8,-1,8,7,4,0,1,-1,-1,1,1,4,1
KR_6751064331,420,1,98,-7,3,3,3,0,-5,0,5,-2,1,3,7,8,1,0,1,1,0,3,36,-2,9,7,-18,0,1,1,1,1,1,1,1
KR_6768866882,420,-1,26,-7,-7,0,2,2,-1,2,3,1,1,0,-6,1,7,-1,0,1,0,-9,-102,1,7,8,0,0,0,-1,0,-1,-1,2,1
KR_6704950554,420,5,-43,43,15,0,3,3,10,10,0,4,6,2,2,5,3,-1,1,2,-1,17,-4,-3,6,3,2,0,2,1,1,1,-1,5,1
KR_6767936689,420,-1,2,-4,-1,2,3,1,0,5,5,1,2,1,-2,2,4,-2,1,3,0,-5,4,4,4,8,-5,0,1,-1,1,1,-1,2,1
KR_6766052485,440,4,18,15,10,-1,1,2,5,7,2,2,3,1,4,4,0,0,0,0,0,9,0,1,6,7,4,0,0,1,1,0,1,1,1
KR_6769422597,420,8,11,25,11,6,7,1,3,4,1,-1,2,3,1,4,3,2,2,0,0,19,14,-4,7,3,5,0,1,1,0,1,1,3,1
KR_6763686043,420,-1,-58,-4,-2,2,3,1,-2,2,4,0,1,1,-1,0,1,-1,0,1,0,-5,22,2,3,5,-6,0,-1,1,1,-1,-1,2,1
KR_6760128694,440,4,46,8,2,4,4,0,0,5,5,3,3,0,-6,0,6,1,2,1,-1,-6,-14,0,3,3,-1,0,1,-1,1,1,-1,6,1
KR_6766673817,420,0,-48,2,-2,-1,2,3,-1,0,1,3,4,1,-3,2,5,0,1,1,0,-4,15,-3,5,2,-1,0,-1,-1,-1,-1,-1,5,1
KR_6736938229,420,3,47,21,9,1,1,0,6,6,0,3,6,3,1,4,3,-2,2,4,0,12,-1,2,4,6,1,0,1,-1,1,1,-1,2,1
KR_6697979780,420,-1,-3,-13,-7,-5,1,6,2,4,2,-2,2,4,-2,3,5,0,0,0,-1,-3,-4,1,6,7,3,0,-2,-1,-1,-1,-1,2,1
KR_6765932104,420,3,1,14,3,2,2,0,6,6,0,-3,2,5,-4,0,4,2,4,2,0,5,-11,2,1,3,-4,0,1,1,-1,1,1,5,1
KR_6761764304,420,3,39,19,16,5,6,1,3,4,1,1,2,1,8,9,1,-1,0,1,0,19,-2,1,4,5,-1,0,5,1,-1,1,1,3,1
KR_6743029234,420,2,2,10,2,0,1,1,3,6,3,-1,2,3,-1,3,4,1,1,0,0,8,39,5,1,6,-9,0,0,1,-1,0,-1,6,1
KR_6746790294,420,7,117,37,16,1,2,1,0,2,2,1,1,0,12,13,1,2,2,0,0,16,-135,-2,4,2,1,0,1,1,-1,1,1,5,1
KR_6686914540,420,2,8,0,2,0,1,1,-1,0,1,2,2,0,0,1,1,1,2,1,0,4,120,5,4,9,2,0,0,1,-1,0,-1,4,1
KR_6746328022,420,1,37,8,4,0,1,1,-1,1,2,-1,3,4,4,5,1,2,3,1,0,3,-32,-3,6,3,2,0,0,1,-1,1,1,3,1
KR_6768240630,420,4,-28,30,10,1,1,0,2,3,1,-1,1,2,2,2,0,6,6,0,1,10,34,-4,8,4,-1,0,2,1,1,1,1,1,1
KR_6767381920,420,3,36,44,4,1,1,0,6,6,0,-1,1,2,1,1,0,-3,1,4,0,-2,-14,5,3,8,-1,0,0,-1,1,0,-1,3,1
KR_6736694351,420,4,63,26,12,-2,0,2,6,8,2,3,3,0,3,3,0,2,2,0,0,9,103,4,3,7,-2,0,0,-1,1,1,1,5,1
KR_6749289579,420,4,49,15,2,-3,0,3,6,7,1,4,4,0,-5,1,6,0,0,0,-2,-1,-1,2,5,7,3,0,0,-1,1,1,-1,5,1
KR_6768029698,420,0,2,10,2,-4,0,4,-4,1,5,7,8,1,3,5,2,0,0,0,0,-6,-36,3,4,7,4,0,2,1,1,1,1,2,1
KR_6769851750,420,8,116,39,22,1,3,2,9,13,4,9,10,1,3,4,1,0,0,0,2,34,0,4,4,8,-2,0,2,1,-1,1,1,6,1
KR_6770354449,420,-1,10,-43,2,0,3,3,0,3,3,2,3,1,1,2,1,-1,1,2,0,-2,-193,3,3,6,0,0,0,1,-1,-1,1,2,1
KR_6711814214,420,-5,-13,-36,-3,1,2,1,-4,2,6,-2,1,3,1,1,0,1,1,0,0,-6,8,1,7,8,2,0,0,-1,0,0,1,5,1
KR_6656884505,420,5,2,5,11,-1,0,1,-1,0,1,4,4,0,8,9,1,1,1,0,0,9,0,2,5,7,-3,0,1,1,-1,1,1,1,1
KR_6760425169,420,3,-15,3,3,-1,1,2,2,3,1,0,1,1,2,5,3,0,1,1,0,4,4,0,5,5,1,0,0,1,-1,0,1,3,1
KR_6762556947,420,-1,-47,16,-4,-3,1,4,-2,2,4,2,3,1,-1,0,1,0,1,1,0,1,-282,-4,6,2,1,0,-1,1,0,-1,-1,4,1
KR_6747761885,420,3,75,-13,7,0,3,3,0,3,3,2,4,2,2,4,2,3,3,0,0,10,-13,-1,7,6,9,0,2,-1,1,1,-1,2,1
KR_6755147009,440,5,82,-3,13,3,4,1,7,7,0,1,1,0,1,1,0,1,2,1,0,8,-12,2,3,5,5,0,0,1,1,0,1,1,1
KR_6571666093,440,3,2,-1,13,0,1,1,3,8,5,0,1,1,4,4,0,6,6,0,2,9,0,2,8,10,3,0,0,-1,1,1,1,3,1
KR_6668491602,420,1,6,16,3,1,2,1,4,6,2,-2,0,2,1,3,2,-1,0,1,0,7,-11,0,5,5,3,0,0,1,1,0,1,6,1
KR_6744243727,420,-2,-40,-9,-4,-5,0,5,1,5,4,4,4,0,-3,1,4,-1,0,1,0,6,101,-2,8,6,-1,0,0,1,1,0,-1,4,1
KR_6704607266,420,-1,-10,24,-6,-1,0,1,0,3,3,-1,1,2,-4,0,4,0,1,1,0,-7,6,6,3,9,-2,0,0,-1,1,0,-1,2,1
KR_6758258218,420,-1,55,14,-3,-5,0,5,1,2,1,0,4,4,1,4,3,0,0,0,-1,-13,8,3,7,10,4,0,2,-1,1,1,-1,3,1
KR_6762559765,420,2,-28,1,6,0,4,4,4,6,2,1,3,2,-1,2,3,2,3,1,0,12,1,5,3,8,1,0,0,1,1,1,1,1,1
KR_6763747088,420,9,114,63,10,-1,3,4,1,2,1,8,8,0,2,2,0,0,1,1,0,9,100,2,2,4,0,0,2,0,-1,1,1,0,1
KR_6629510708,420,2,-8,-4,7,2,4,2,1,3,2,0,3,3,4,7,3,0,1,1,0,7,9,8,2,10,-3,0,0,-1,-1,0,-1,6,1
KR_6721564629,420,6,80,17,15,1,4,3,1,3,2,9,9,0,4,5,1,0,0,0,0,5,23,3,7,10,0,0,3,1,1,1,1,3,1
KR_6724780916,420,0,9,11,-2,-5,0,5,0,1,1,-1,4,5,1,2,1,3,3,0,0,-3,3,0,5,5,-2,0,0,-1,-1,-1,-1,5,1
KR_6749339469,420,1,30,-6,5,3,5,2,5,6,1,-3,4,7,2,3,1,-2,1,3,0,5,5,1,5,6,1,0,1,1,1,1,-1,3,1
KR_6751790698,420,0,62,10,-2,0,1,1,1,4,3,-1,4,5,0,4,4,-2,0,2,0,5,88,2,2,4,-5,0,3,-1,1,1,-1,1,1
KR_6762633991,420,3,5,18,5,-2,3,5,3,7,4,2,4,2,3,7,4,-1,0,1,0,13,17,3,5,8,-2,0,-1,-1,-1,-1,-1,4,1
KR_6745069359,440,1,2,14,1,2,3,1,-1,2,3,1,2,1,-2,1,3,1,2,1,0,1,-31,1,6,7,0,0,0,1,-1,-1,1,2,1
KR_6760596014,420,4,10,-4,7,6,6,0,3,7,4,0,2,2,-1,1,2,-1,0,1,0,6,-39,6,1,7,13,0,1,-1,1,1,-1,5,1
KR_6749109717,420,2,-6,11,2,5,6,1,-3,2,5,3,4,1,-1,4,5,-2,0,2,0,-9,33,2,5,7,0,0,0,0,-1,1,1,0,1
KR_6768925929,420,0,-43,32,-1,-2,0,2,-1,2,3,5,6,1,-4,0,4,1,1,0,0,3,-14,-3,7,4,8,0,0,0,-1,0,-1,0,1
KR_6699675139,420,1,53,-8,3,1,1,0,-2,1,3,0,1,1,4,5,1,0,2,2,1,7,-31,-5,7,2,-1,0,0,1,1,0,1,5,1
KR_6761763566,420,2,65,12,6,0,2,2,4,5,1,-1,3,4,-1,3,4,4,5,1,0,9,16,5,3,8,2,0,2,-1,1,1,-1,4,1
KR_6768799701,440,3,9,4,7,0,3,3,5,6,1,0,1,1,2,5,3,0,0,0,0,16,4,4,4,8,2,0,0,1,-1,-1,1,2,1
KR_6760258580,420,8,67,-27,16,7,7,0,2,6,4,6,11,5,-1,1,2,2,2,0,0,11,5,-7,8,1,7,0,2,1,-1,1,1,3,1
KR_6759527589,420,3,49,36,-2,0,1,1,0,1,1,0,4,4,1,2,1,-3,1,4,0,-6,-76,-1,7,6,1,0,0,-1,1,0,-1,6,1
KR_6767007590,420,1,79,-22,6,-3,0,3,1,3,2,2,2,0,5,6,1,1,2,1,0,11,-2,1,5,6,1,0,1,0,1,1,1,0,1
KR_6754141239,420,0,-66,13,4,-3,2,5,2,3,1,3,3,0,1,2,1,1,1,0,3,8,1,-1,9,8,-2,0,1,-1,1,1,1,2,1
KR_6678232409,420,3,33,16,8,-1,2,3,3,3,0,2,3,1,2,3,1,2,2,0,0,11,19,-2,7,5,5,0,2,1,1,1,1,1,1
KR_6767980247,420,1,28,-4,5,5,5,0,-1,0,1,-3,1,4,2,3,1,2,3,1,0,4,-5,6,0,6,-2,0,0,1,-1,-1,1,4,1
KR_6685697997,440,-1,-18,8,-3,-3,0,3,-5,0,5,1,3,2,0,3,3,4,6,2,0,-2,31,0,8,8,-6,0,0,1,-1,0,-1,1,1
KR_6766644111,420,-4,-45,1,-8,-4,1,5,-1,2,3,-2,1,3,-1,2,3,0,1,1,0,-4,4,1,5,6,-9,0,-1,1,-1,-1,1,6,1
KR_6751548202,420,-4,-11,-11,-1,0,2,2,-3,4,7,2,5,3,0,2,2,0,0,0,0,8,-18,2,4,6,3,0,-1,1,-1,-1,1,4,1
KR_6760395901,420,-1,-13,-20,10,-3,1,4,6,7,1,3,7,4,4,5,1,0,1,1,1,16,6,5,2,7,-2,0,-1,-1,1,-1,1,3,1
KR_6757739248,420,3,18,-2,7,2,3,1,0,1,1,3,4,1,2,4,2,0,3,3,0,5,-44,-1,6,5,31,0,1,-1,1,1,1,2,1
KR_6768327227,420,2,50,-20,10,0,2,2,4,7,3,-3,2,5,7,7,0,2,2,0,0,5,9,4,2,6,-4,0,2,1,1,1,1,5,1
KR_6764209042,420,-1,-36,-9,2,2,3,1,-1,4,5,-1,0,1,3,3,0,-1,0,1,0,4,130,-4,7,3,0,0,1,-1,1,1,-1,4,1
KR_6770327035,440,0,65,-12,5,1,1,0,2,2,0,-2,2,4,5,7,2,-1,2,3,0,3,5,1,3,4,0,0,0,-1,1,1,-1,4,1
KR_6633909245,420,0,-49,1,3,3,4,1,6,6,0,-1,1,2,-3,0,3,-2,2,4,0,8,35,-1,7,6,-2,0,-1,-1,1,-1,-1,1,1
KR_6762737666,440,1,-26,33,3,-1,2,3,2,3,1,0,3,3,2,2,0,0,1,1,0,9,30,-2,4,2,-1,0,0,1,-1,-1,1,1,1
KR_6613770320,420,1,-2,20,0,0,1,1,1,4,3,-3,1,4,1,3,2,1,2,1,0,3,7,2,5,7,-5,0,0,0,1,0,1,0,1
KR_6760555277,420,0,5,28,-9,-2,3,5,1,7,6,-3,2,5,-6,0,6,1,1,0,1,-8,-1,-7,12,5,-2,0,-1,1,-1,-1,1,5,1
KR_6751613377,420,5,2,12,13,3,3,0,0,1,1,2,2,0,7,11,4,1,1,0,0,14,1,1,3,4,7,0,1,1,-1,-1,1,4,1
KR_6760003958,440,-1,1,-19,-3,-1,0,1,-1,1,2,-4,0,4,1,1,0,2,2,0,0,2,22,-1,3,2,-2,0,-1,1,-1,-1,-1,2,1
KR_6678314661,440,1,1,28,2,-1,7,8,2,3,1,2,2,0,1,1,0,-2,3,5,0,-2,-111,-3,6,3,0,0,1,1,-1,-1,-1,1,1
KR_6761977156,420,2,35,26,3,-1,1,2,4,5,1,-2,2,4,3,5,2,-1,0,1,0,6,39,-4,8,4,-3,0,0,1,-1,1,1,4,1
KR_6740681228,420,4,67,23,10,4,5,1,-1,2,3,4,4,0,2,4,2,1,4,3,0,6,7,3,4,7,-5,0,1,-1,1,1,1,5,1
KR_6758227247,420,0,-7,-4,3,2,3,1,2,3,1,-1,1,2,4,5,1,-4,0,4,0,5,0,1,6,7,2,0,0,1,-1,0,1,5,1
KR_6763534100,440,2,53,-7,1,1,4,3,-1,2,3,-1,0,1,-2,0,2,4,4,0,0,-2,-8,-6,11,5,1,0,0,0,-1,0,-1,0,1
KR_6629988855,420,2,94,9,2,4,4,0,-7,5,12,3,6,3,0,4,4,2,2,0,0,-3,67,-2,5,3,-12,0,-1,-1,-1,-1,1,2,1
KR_6761579193,420,2,-19,12,8,1,2,1,5,9,4,0,3,3,1,5,4,1,2,1,0,9,0,2,5,7,1,0,0,1,1,1,1,2,1
KR_6770517616,420,-1,-18,27,9,4,7,3,3,3,0,2,4,2,2,8,6,-2,0,2,2,10,0,5,3,8,0,0,-1,1,1,-1,1,6,1
KR_6704123727,420,2,73,-1,1,5,6,1,-3,0,3,-3,2,5,1,1,0,1,1,0,0,0,4,1,4,5,-2,0,1,-1,1,1,-1,4,1
KR_6760222856,420,3,-34,21,7,2,2,0,-1,0,1,1,3,2,5,6,1,0,0,0,0,8,-6,1,6,7,3,0,0,1,1,0,1,4,1
KR_6770021675,440,-2,4,-36,2,-2,2,4,-2,6,8,3,3,0,1,3,2,2,2,0,0,10,-49,-6,10,4,10,0,-1,1,0,-1,1,5,1
KR_6753044707,440,4,103,-4,11,4,5,1,2,4,2,4,6,2,2,5,3,-1,7,8,0,11,-1,3,3,6,2,0,1,1,-1,1,-1,3,1
KR_6762912008,420,0,-8,12,-2,-4,0,4,-3,0,3,-1,2,3,5,5,0,1,2,1,0,8,-5,1,4,5,1,0,-1,1,-1,-1,1,5,1
KR_6749861874,420,4,33,7,6,0,0,0,-1,2,3,6,8,2,4,6,2,-3,1,4,0,12,12,0,4,4,-6,0,1,-1,1,1,-1,1,1
KR_6754167404,420,0,12,-21,6,3,4,1,0,4,4,1,3,2,2,6,4,0,0,0,0,-2,-6,-1,7,6,5,0,0,-1,1,0,1,5,1
KR_6760101820,420,-1,12,12,-4,-4,1,5,-2,3,5,1,3,2,-5,3,8,6,6,0,0,-2,2,-3,9,6,1,0,1,-1,1,-1,1,5,1
KR_6710207458,420,0,5,-20,5,-1,3,4,5,6,1,-1,1,2,1,2,1,1,1,0,-3,5,16,5,1,6,9,0,0,1,1,0,1,1,1
KR_6762006903,420,4,56,40,8,4,4,0,2,5,3,-3,3,6,4,5,1,1,1,0,1,17,-6,1,3,4,1,0,2,-1,1,1,1,5,1
KR_6767800196,440,4,26,16,6,-1,2,3,-2,2,4,3,4,1,3,3,0,3,4,1,0,8,0,3,3,6,4,0,1,1,1,1,1,1,1
KR_6743523746,440,5,60,20,14,0,2,2,2,3,1,5,5,0,1,5,4,6,8,2,0,14,-1,-2,5,3,-1,0,0,1,1,0,1,1,1
KR_6769208547,420,2,112,-6,0,4,4,0,-1,1,2,0,4,4,-3,3,6,0,2,2,0,-11,6,1,8,9,-6,0,2,-1,-1,1,1,4,1
KR_6642866788,420,2,-8,1,9,-2,0,2,2,3,1,2,6,4,4,4,0,3,3,0,0,15,-13,-1,7,6,-1,0,1,1,1,1,-1,5,1
KR_6743056096,420,3,59,-16,1,1,1,0,1,2,1,-3,0,3,3,4,1,-1,0,1,0,-5,71,-2,4,2,-2,0,0,1,-1,0,1,1,1
KR_6760103301,420,5,95,1,10,2,3,1,3,6,3,1,3,2,2,7,5,2,3,1,0,11,33,2,3,5,-3,0,1,1,-1,1,1,5,1
KR_6734513591,420,3,29,-9,10,5,5,0,-1,2,3,4,4,0,2,4,2,0,1,1,0,3,-30,3,6,9,24,0,1,1,-1,1,-1,6,1
KR_6730100588,440,4,-3,31,9,5,6,1,6,6,0,-2,3,5,-1,1,2,1,1,0,0,9,-29,-1,6,5,-1,0,1,1,1,1,1,4,1
KR_6769374129,420,0,17,-6,-1,0,1,1,-2,1,3,0,1,1,3,6,3,-2,0,2,-1,-4,20,0,5,5,-3,0,1,1,-1,1,-1,1,1
KR_6656012957,420,-1,-5,12,-6,-1,3,4,0,5,5,-3,0,3,-3,3,6,1,1,0,0,-10,8,4,7,11,-3,0,-1,1,1,-1,-1,3,1
KR_6743598960,420,2,3,5,1,3,3,0,0,1,1,1,4,3,-3,0,3,0,0,0,0,-3,4,3,5,8,2,0,0,-1,1,0,-1,1,1
KR_6749574269,420,1,51,-19,3,1,3,2,-4,1,5,1,5,4,3,5,2,2,2,0,0,12,53,2,3,5,0,0,1,1,1,1,-1,1,1
KR_6757517018,420,2,-2,8,-2,3,4,1,5,5,0,-7,0,7,-2,3,5,-1,1,2,0,0,7,2,7,9,-8,0,0,-1,1,0,-1,6,1
KR_6769918408,420,4,3,4,6,2,3,1,3,3,0,2,3,1,-1,0,1,0,0,0,0,4,-8,2,3,5,3,0,1,1,1,1,1,2,1
KR_6749226127,420,4,143,8,12,1,4,3,1,3,2,3,4,1,7,9,2,0,2,2,1,17,7,2,2,4,4,0,2,1,0,1,1,3,1
KR_6769944408,420,5,41,48,6,-2,1,3,3,5,2,-1,2,3,4,5,1,2,3,1,0,2,3,-4,6,2,2,0,1,1,1,1,-1,2,1
KR_6732891064,420,2,9,23,3,2,5,3,-5,1,6,0,0,0,4,5,1,2,3,1,1,6,11,6,6,12,0,0,1,1,1,-1,-1,3,1
KR_6770008315,420,0,-21,15,6,6,8,2,1,9,8,0,4,4,-1,0,1,0,1,1,2,7,-105,2,6,8,1,0,2,-1,1,1,1,1,1
KR_6761858163,420,1,4,34,-1,-5,1,6,4,9,5,4,8,4,-1,5,6,-3,0,3,0,-5,-26,1,2,3,18,0,-1,1,1,1,1,2,1
KR_6738627591,420,0,61,8,4,-1,1,2,3,6,3,-1,2,3,3,3,0,0,0,0,2,7,-13,-1,5,4,17,0,2,1,1,1,1,1,1
KR_6758801429,420,-1,-5,-35,-1,0,1,1,0,1,1,2,4,2,-3,2,5,0,0,0,-1,-3,-36,-2,6,4,1,0,0,0,-1,0,-1,0,1
KR_6753773127,420,2,-35,8,-1,-1,1,2,3,4,1,-3,3,6,2,6,4,-2,1,3,0,4,-9,-8,11,3,3,0,1,-1,1,1,-1,1,1
KR_6756136554,420,2,45,17,7,1,1,0,8,11,3,1,5,4,-1,1,2,-2,1,3,0,4,23,2,4,6,2,0,1,1,-1,1,-1,4,1
KR_6763225652,420,3,43,-9,7,1,2,1,-1,2,3,6,6,0,0,2,2,1,3,2,0,1,2,2,5,7,-3,0,0,0,-1,0,1,0,1
KR_6769039313,420,1,23,1,5,-1,0,1,0,0,0,3,6,3,3,3,0,0,0,0,0,11,2,-3,11,8,0,0,0,1,-1,0,1,5,1
KR_6763549116,420,3,19,-16,10,-1,4,5,1,1,0,1,3,2,8,9,1,1,2,1,0,7,7,3,4,7,-4,0,0,1,-1,1,1,5,1
KR_6769223113,420,5,106,40,9,2,3,1,5,8,3,3,5,2,-1,0,1,0,1,1,0,0,-6,0,5,5,10,0,2,1,1,1,-1,4,1
KR_6709857889,420,5,93,-40,13,2,2,0,6,9,3,-2,0,2,4,6,2,3,3,0,0,8,16,10,2,12,-5,0,1,1,-1,1,-1,5,1
KR_6766472040,420,3,27,28,8,0,3,3,-1,2,3,0,1,1,4,4,0,5,5,0,0,10,1,0,8,8,6,0,1,1,-1,1,-1,5,1
KR_6762654759,440,0,78,-16,-4,3,5,2,-1,2,3,-4,1,5,-2,2,4,0,0,0,1,-7,7,2,3,5,-2,0,1,-1,-1,1,1,1,1
KR_6714473569,420,-1,-27,9,-7,-8,0,8,-4,2,6,3,5,2,3,7,4,-1,0,1,-2,-4,-15,-2,6,4,-2,0,-4,1,-1,-1,-1,3,1
KR_6733446228,420,2,57,0,4,3,3,0,3,5,2,-2,2,4,-1,2,3,1,1,0,0,-3,1,-2,7,5,-2,0,0,1,1,0,1,2,1
KR_6687859932,420,0,20,-11,1,3,3,0,-4,2,6,3,5,2,1,1,0,-2,1,3,0,4,3,3,4,7,1,0,1,1,-1,1,1,5,1
KR_6696671537,420,1,-19,-8,-1,1,2,1,-3,4,7,2,3,1,-1,5,6,0,0,0,0,4,6,1,7,8,-6,0,1,-1,-1,1,-1,2,1
KR_6761132010,420,0,-31,-8,5,-1,0,1,1,3,2,0,2,2,6,9,3,-1,1,2,2,12,2,3,1,4,1,0,0,1,1,-1,1,2,1
KR_6762238452,420,7,60,32,19,5,6,1,4,7,3,6,6,0,4,5,1,0,0,0,0,18,-3,-5,7,2,0,0,0,1,-1,1,1,1,1
KR_6754887051,420,2,-52,33,5,1,3,2,4,4,0,0,2,2,-2,0,2,2,2,0,0,1,-56,-1,6,5,25,0,0,1,-1,0,1,6,1
KR_6731841098,420,0,-6,9,-2,-4,1,5,4,5,1,1,3,2,-3,1,4,0,2,2,-1,-6,-7,-4,7,3,3,0,2,-1,1,1,1,4,1
KR_6751716434,420,1,-89,4,10,2,3,1,7,7,0,3,5,2,0,4,4,-2,1,3,0,19,-11,-3,6,3,2,0,-2,1,-1,-1,1,2,1
KR_6762675964,420,3,66,24,7,6,6,0,-5,0,5,2,3,1,3,3,0,1,2,1,0,5,5,1,4,5,7,0,0,1,1,-1,-1,5,1
KR_6746650054,420,4,103,10,12,0,1,1,-3,0,3,1,3,2,15,17,2,-1,1,2,0,12,-4,3,3,6,4,0,1,1,1,1,-1,1,1
KR_6767925893,420,2,13,-2,8,5,6,1,1,2,1,1,4,3,-2,2,4,3,3,0,2,3,43,-4,11,7,-17,0,0,1,1,1,1,5,1
KR_6769763045,420,4,-16,19,3,-1,2,3,7,10,3,-1,0,1,1,2,1,-3,3,6,-1,2,0,0,6,6,-1,0,0,1,-1,0,-1,6,1
KR_6768260607,440,1,30,29,1,2,2,0,0,3,3,-1,2,3,0,5,5,0,1,1,0,-2,-1,-1,4,3,-1,0,0,1,0,0,1,5,1
KR_6752881327,420,0,46,-25,8,4,5,1,3,5,2,1,4,3,0,2,2,0,2,2,0,5,60,3,5,8,6,0,0,-1,0,0,1,4,1
KR_6704693508,420,3,14,12,13,4,6,2,4,5,1,0,3,3,3,5,2,2,3,1,0,10,16,-1,7,6,4,0,2,1,-1,1,-1,4,1
KR_6744994655,420,5,-5,27,6,1,2,1,3,4,1,0,3,3,-2,0,2,4,4,0,0,6,-116,-4,8,4,9,0,1,-1,1,1,1,3,1
KR_6769472924,420,3,-1,4,11,2,2,0,4,5,1,0,1,1,4,4,0,1,1,0,0,15,-10,-1,5,4,-2,0,0,1,1,1,1,6,1
KR_6763537960,440,1,11,-8,3,6,6,0,-3,1,4,-2,2,4,0,1,1,2,3,1,0,0,-179,0,4,4,3,0,0,-1,1,1,-1,2,1
KR_6717497011,420,5,63,27,12,1,4,3,6,7,1,0,2,2,4,5,1,1,2,1,0,15,-47,2,5,7,23,0,2,1,1,1,1,4,1
KR_6744966913,420,-1,42,-18,0,-1,3,4,7,7,0,-2,2,4,-3,0,3,-1,3,4,-1,4,-3,-2,9,7,7,0,1,1,1,1,-1,2,1
KR_6703166671,440,1,-17,24,-1,-1,0,1,-4,0,4,3,4,1,-2,4,6,3,3,0,0,0,-140,1,6,7,-1,0,0,-1,1,0,-1,1,1
KR_6733918373,420,-3,-21,10,1,1,1,0,-3,1,4,-2,1,3,6,7,1,-1,1,2,2,1,0,1,6,7,3,0,-2,1,-1,-1,1,5,1
KR_6689762193,420,2,2,-8,7,0,1,1,5,6,1,-2,0,2,3,3,0,1,1,0,0,10,0,-4,10,6,2,0,0,1,1,0,1,4,1
KR_6649405980,420,1,-22,14,6,0,1,1,1,4,3,3,3,0,1,2,1,1,2,1,0,2,-43,0,4,4,29,0,0,1,-1,0,1,2,1
KR_6589465968,440,2,-45,41,4,0,1,1,-1,3,4,2,2,0,-3,0,3,6,6,0,0,10,-5,-4,8,4,7,0,-1,1,1,1,-1,3,1
KR_6630276410,420,4,63,25,12,0,4,4,4,5,1,3,5,2,3,3,0,2,4,2,1,17,15,3,6,9,-4,0,4,1,1,1,1,6,1
KR_6768937922,420,2,-5,47,0,0,1,1,1,4,3,-1,1,2,-6,1,7,6,8,2,0,-1,3,-4,8,4,0,0,1,0,0,1,-1,0,1
KR_6753459753,420,0,28,17,1,3,3,0,-1,3,4,-3,2,5,2,3,1,0,1,1,0,1,-20,-7,9,2,2,0,1,1,1,1,-1,4,1
KR_6764115814,420,4,24,25,5,-5,2,7,2,3,1,1,1,0,6,6,0,1,1,0,0,13,6,8,1,9,1,0,1,1,1,-1,-1,5,1
KR_6618033619,420,1,-50,38,-4,0,0,0,-2,3,5,2,4,2,-2,0,2,-2,0,2,0,-4,-14,-1,6,5,-3,0,-1,1,-1,-1,-1,5,1
KR_6729467899,420,-2,23,-33,-5,-2,0,2,-4,1,5,-2,0,2,4,5,1,-1,2,3,-1,-4,10,0,4,4,-23,0,0,1,-1,0,-1,6,1
KR_6683160950,420,1,8,-20,0,2,3,1,0,2,2,0,4,4,-3,3,6,1,2,1,-2,-2,0,4,5,9,1,0,-1,1,-1,-1,-1,3,1
KR_6735220493,420,4,6,14,10,2,5,3,0,3,3,0,3,3,9,9,0,-1,1,2,0,9,3,5,4,9,-3,0,1,1,1,1,1,1,1
KR_6769214546,420,-3,-41,-2,-9,-2,1,3,-6,2,8,0,2,2,-1,2,3,0,0,0,0,-6,5,-4,5,1,-1,0,0,1,1,1,1,4,1
KR_6741646688,420,1,-17,5,2,1,4,3,5,8,3,-2,3,5,-2,2,4,0,2,2,0,18,52,4,3,7,0,0,-1,1,1,-1,-1,6,1
KR_6736407790,420,2,74,8,5,0,1,1,-5,2,7,6,9,3,4,4,0,0,1,1,0,12,3,2,8,10,-4,0,1,1,-1,1,1,1,1
KR_6767485749,420,10,87,48,18,5,5,0,5,6,1,2,4,2,4,4,0,2,2,0,1,12,49,7,2,9,-4,0,1,1,1,1,1,1,1
KR_6766537392,420,1,0,-9,-2,0,2,2,-1,0,1,-1,2,3,0,2,2,0,1,1,0,-5,-3,-1,6,5,-1,0,0,-1,-1,1,-1,3,1
KR_6712238423,420,2,-1,-32,5,3,3,0,-1,2,3,1,3,2,2,2,0,0,0,0,0,3,6,-1,4,3,0,0,-1,-1,-1,-1,1,2,1
KR_6769556211,440,3,31,-4,12,1,1,0,0,2,2,1,3,2,7,8,1,3,4,1,1,10,7,-1,4,3,0,0,1,1,-1,-1,1,6,1
KR_6728511085,420,1,45,-17,3,-2,0,2,-2,2,4,2,6,4,3,6,3,2,3,1,0,3,26,-2,6,4,5,0,0,1,-1,1,-1,5,1
KR_6768438713,420,1,28,-8,0,2,2,0,-1,1,2,-2,1,3,1,3,2,0,1,1,0,0,4,1,6,7,-1,0,0,-1,0,0,-1,6,1
KR_6767875920,420,-1,30,-29,0,2,4,2,-5,1,6,-1,0,1,3,3,0,1,1,0,0,-2,-59,3,3,6,-9,0,1,1,-1,1,-1,2,1
KR_6719963906,420,1,16,11,4,0,1,1,6,6,0,-3,1,4,0,1,1,1,1,0,0,8,10,2,6,8,0,0,1,1,1,1,1,3,1
KR_6620168464,420,0,6,21,6,1,1,0,4,4,0,-1,3,4,2,4,2,0,0,0,0,11,61,-2,4,2,-1,0,1,1,-1,1,1,5,1
KR_6748036513,420,4,96,10,12,2,2,0,2,4,2,7,10,3,1,1,0,0,2,2,2,10,-49,8,0,8,-1,0,1,0,1,1,1,0,1
KR_6742059555,420,5,31,38,14,3,3,0,1,2,1,4,6,2,4,4,0,2,2,0,1,16,-4,-2,8,6,2,0,2,1,1,1,1,4,1
KR_6734744311,440,1,34,4,0,1,6,5,-1,2,3,1,2,1,0,2,2,-1,1,2,1,2,-2,2,3,5,0,0,0,-1,1,0,1,5,1
KR_6745979007,420,3,-17,4,5,1,3,2,1,3,2,1,2,1,1,2,1,1,2,1,0,0,130,-1,6,5,3,0,0,-1,1,0,-1,5,1
KR_6713703232,420,8,129,48,17,3,4,1,4,6,2,3,4,1,4,5,1,3,3,0,2,22,11,1,3,4,4,0,5,1,1,1,1,4,1
KR_6760763466,420,-2,0,0,-7,0,2,2,1,5,4,-2,1,3,-3,3,6,-3,1,4,-1,-11,-1,1,4,5,-1,0,0,1,-1,-1,-1,5,1
KR_6763886586,440,1,22,-11,6,1,2,1,1,1,0,0,2,2,5,6,1,-1,3,4,0,11,4,4,2,6,0,0,1,1,-1,1,1,1,1
KR_6764863950,420,4,50,40,4,2,2,0,4,9,5,0,3,3,1,4,3,-3,0,3,0,0,-8,-3,8,5,2,0,1,1,0,1,-1,6,1
KR_6668222048,420,2,40,17,8,0,1,1,2,2,0,3,6,3,3,3,0,0,0,0,0,5,8,0,2,2,2,0,0,1,1,1,1,1,1
KR_6759161796,440,3,32,19,2,4,5,1,0,3,3,0,2,2,-1,1,2,-1,5,6,-1,-5,0,-2,5,3,-1,0,1,1,-1,1,-1,1,1
KR_6721301095,420,-1,28,0,-4,2,3,1,-3,1,4,-4,0,4,1,2,1,0,2,2,0,-9,-100,5,1,6,0,0,0,-1,1,1,1,6,1
KR_6664849346,420,2,72,28,6,3,3,0,-2,3,5,2,2,0,-1,2,3,4,4,0,0,5,-29,-2,5,3,16,0,2,1,-1,1,1,1,1
KR_6640306771,420,7,70,27,11,0,3,3,7,8,1,4,4,0,1,2,1,-1,0,1,-1,15,-1,1,6,7,5,0,1,1,1,1,-1,5,1
KR_6634092979,420,0,20,-7,3,1,2,1,4,4,0,1,2,1,-1,0,1,-2,1,3,0,6,-17,-3,6,3,8,0,0,-1,-1,0,1,2,1
KR_6687529163,420,2,12,-2,2,1,1,0,-1,6,7,2,4,2,0,2,2,0,1,1,-1,-3,5,1,7,8,1,0,0,1,1,0,-1,6,1
KR_6715100893,420,5,9,40,16,1,3,2,8,9,1,4,4,0,0,2,2,3,3,0,1,15,5,3,0,3,-4,0,2,1,1,1,1,2,1
KR_6749070332,420,0,-18,-34,4,1,2,1,3,5,2,0,2,2,-3,1,4,3,3,0,0,6,-33,-1,7,6,-1,0,-1,1,-1,1,-1,1,1
KR_6748993768,420,2,-4,-9,3,-1,1,2,0,2,2,5,5,0,-1,1,2,0,1,1,0,3,-8,2,6,8,-3,0,0,1,1,0,-1,1,1
KR_6661731756,420,0,31,-16,-1,-1,2,3,-1,4,5,0,2,2,0,2,2,1,2,1,0,2,-3,5,3,8,1,0,-1,1,-1,-1,1,3,1
KR_6762875867,440,-2,-38,-13,5,2,2,0,7,9,2,2,2,0,-7,0,7,1,2,1,0,13,197,-3,6,3,-2,0,0,1,1,-1,-1,2,1
KR_6755830020,420,1,28,28,-1,-2,0,2,1,3,2,1,1,0,-1,0,1,0,0,0,0,4,42,-2,5,3,2,0,0,1,1,0,1,2,1
KR_6768817796,420,5,68,11,5,0,1,1,3,3,0,-1,4,5,2,3,1,1,1,0,0,5,11,3,7,10,2,0,1,1,-1,-1,-1,3,1
KR_6731985437,420,1,34,16,4,0,3,3,2,4,2,-1,2,3,4,5,1,-1,0,1,0,6,-18,-2,7,5,-2,1,5,1,1,1,1,2,1
KR_6620109988,420,1,27,-8,7,2,2,0,3,4,1,3,6,3,-1,1,2,0,1,1,0,4,-2,0,5,5,-8,0,1,1,-1,1,1,2,1
KR_6760720129,420,0,-4,-8,-3,3,3,0,-1,4,5,1,7,6,-7,1,8,1,1,0,1,-1,10,-1,5,4,1,0,-1,1,-1,-1,1,1,1
KR_6763204112,420,3,-18,25,15,0,2,2,2,5,3,6,6,0,1,1,0,6,8,2,1,8,272,2,4,6,4,0,2,1,1,1,1,4,1
KR_6742814822,420,-2,-25,-16,2,-5,1,6,1,1,0,-2,3,5,5,5,0,3,3,0,0,12,-7,2,4,6,8,0,0,1,1,-1,-1,1,1
KR_6768532884,420,0,-3,9,0,0,5,5,2,4,2,-3,1,4,0,1,1,1,1,0,-1,-6,10,0,6,6,-4,0,-1,-1,1,-1,-1,2,1
KR_6719164465,420,2,5,15,3,-1,0,1,0,2,2,1,3,2,0,2,2,3,3,0,0,-1,1,5,3,8,1,0,0,1,-1,0,1,2,1
KR_6726710534,420,0,32,-24,3,-2,2,4,2,4,2,0,2,2,0,0,0,3,3,0,-1,10,28,5,3,8,0,0,0,-1,1,0,-1,2,1
KR_6765966079,420,0,-3,20,-1,-2,0,2,-1,2,3,2,2,0,1,2,1,-1,0,1,0,-3,4,2,7,9,-2,0,1,-1,1,1,-1,2,1
KR_6709739075,420,-1,11,24,-6,1,4,3,-1,4,5,-2,1,3,-3,0,3,-1,0,1,0,-8,2,-1,5,4,-4,0,-1,1,-1,-1,-1,3,1
KR_6686896968,420,1,36,21,1,2,2,0,-3,1,4,1,1,0,0,2,2,1,2,1,0,-3,25,-2,7,5,2,0,0,-1,-1,-1,-1,3,1
KR_6762583278,420,-2,-61,-36,-1,-1,1,2,-1,1,2,-1,1,2,3,4,1,-1,0,1,1,4,6,-3,8,5,27,0,-2,-1,-1,-1,1,2,1
KR_6748549860,420,0,-8,-8,4,-1,2,3,1,2,1,3,5,2,-1,4,5,2,2,0,0,13,-16,-1,8,7,6,0,1,-1,-1,1,-1,4,1
KR_6763986819,420,4,83,16,7,-1,2,3,0,3,3,5,8,3,-2,2,4,5,6,1,-1,-6,-143,1,4,5,-1,0,1,1,1,1,-1,3,1
KR_6769280346,420,3,-17,9,4,2,5,3,2,3,1,5,5,0,-4,2,6,-1,0,1,0,8,4,2,7,9,0,0,0,1,-1,1,-1,5,1
KR_6750469470,420,4,61,16,5,1,1,0,2,3,1,0,1,1,2,6,4,0,2,2,0,7,-10,-2,9,7,12,0,2,-1,-1,1,1,5,1
KR_6765134872,420,2,26,-7,7,-2,0,2,6,6,0,-2,3,5,6,6,0,-1,0,1,0,12,23,1,5,6,2,0,1,1,-1,1,1,3,1
KR_6768267672,440,-1,-42,-16,-8,1,1,0,-3,4,7,-5,2,7,0,2,2,-1,1,2,0,-4,0,3,3,6,-5,0,0,-1,0,0,1,5,1
KR_6747792540,440,3,20,4,3,1,2,1,-2,1,3,4,5,1,1,1,0,-1,0,1,0,-2,20,-3,5,2,2,0,1,-1,0,1,-1,5,1
KR_6733308875,420,8,98,59,19,5,8,3,4,4,0,4,5,1,4,7,3,2,2,0,-1,3,63,-2,3,1,-20,0,0,1,1,1,-1,1,1
KR_6758514884,420,2,30,22,10,-3,0,3,7,7,0,2,2,0,4,5,1,0,2,2,0,5,-2,1,2,3,2,0,0,1,1,1,1,1,1
KR_6756296168,420,3,25,-1,15,13,13,0,3,4,1,-3,4,7,2,3,1,0,0,0,2,8,2,-1,3,2,3,0,1,1,1,1,1,4,1
KR_6753795223,440,1,20,-20,-1,-4,3,7,2,2,0,-3,0,3,1,1,0,3,4,1,0,-6,-146,0,4,4,2,0,0,-1,-1,1,1,5,1
KR_6767306681,420,-2,24,12,-7,-2,1,3,-3,3,6,0,2,2,0,3,3,-2,0,2,1,-6,24,1,8,9,1,0,-1,-1,-1,-1,1,2,1
KR_6762198522,440,0,-6,-4,5,0,0,0,0,2,2,2,2,0,3,4,1,0,3,3,0,12,-159,-2,2,0,1,0,1,1,1,1,-1,1,1
KR_6749280211,420,-1,59,-6,6,2,2,0,1,2,1,6,7,1,-3,2,5,0,2,2,1,3,-29,2,3,5,0,0,2,-1,1,1,1,6,1
KR_6768674919,440,7,78,-20,8,3,4,1,0,2,2,-2,1,3,8,8,0,-1,2,3,0,16,1,-3,8,5,4,0,1,-1,-1,1,1,3,1
KR_6770107104,420,0,-7,8,1,0,2,2,-3,3,6,0,2,2,2,3,1,2,3,1,0,-1,-49,-1,7,6,22,0,0,-1,-1,1,-1,3,1
KR_6747788620,420,0,40,4,-1,2,3,1,-3,3,6,-2,1,3,2,3,1,0,1,1,0,-4,-14,-6,11,5,-2,0,0,1,-1,1,1,4,1
KR_6741667183,420,1,48,12,4,2,2,0,1,3,2,3,7,4,-2,1,3,0,0,0,1,2,-1,-1,9,8,-2,0,0,-1,-1,1,1,4,1
KR_6768344919,440,-4,9,-28,-6,-3,2,5,-4,1,5,1,3,2,3,3,0,-3,0,3,0,-6,-5,-5,8,3,0,0,-1,-1,-1,-1,-1,5,1
KR_6756205112,420,0,22,4,-1,1,4,3,-2,3,5,4,4,0,-3,0,3,-1,2,3,0,-4,-2,-2,8,6,-2,0,0,-1,1,-1,1,5,1
KR_6746383533,420,2,-44,6,4,2,3,1,4,5,1,0,2,2,-1,2,3,-1,1,2,1,4,1,-6,10,4,-2,0,0,1,-1,0,1,3,1
KR_6768695544,440,-2,-46,-19,1,-2,2,4,0,4,4,2,2,0,2,4,2,-1,1,2,2,9,14,2,5,7,-3,0,-1,1,1,-1,1,1,1
KR_6743753451,420,2,-24,12,5,0,4,4,7,8,1,1,3,2,-2,1,3,-1,1,2,0,5,-7,-1,6,5,-5,0,-1,1,1,-1,-1,2,1
KR_6761782992,420,-1,10,10,-2,-1,0,1,1,5,4,-1,2,3,-1,1,2,0,0,0,0,-1,5,-1,6,5,-6,0,0,-1,1,0,1,1,1
KR_6754440466,420,5,7,-5,1,-1,3,4,1,3,2,-4,1,5,5,12,7,0,1,1,0,12,-2,-4,7,3,0,0,0,-1,-1,0,-1,2,1
KR_6708726456,420,-1,4,-12,-4,-1,2,3,1,4,3,1,4,3,-2,0,2,-3,0,3,0,-4,1,2,3,5,-1,0,0,1,1,0,-1,5,1
KR_6742199839,420,4,30,19,7,3,3,0,0,3,3,1,5,4,0,1,1,3,6,3,0,4,-3,2,2,4,6,0,1,1,-1,1,1,4,1
KR_6739273450,440,-2,-80,-4,-4,-1,1,2,1,5,4,0,4,4,0,1,1,-4,2,6,0,2,-210,4,1,5,-1,0,-1,-1,0,-1,-1,5,1
KR_6753748347,420,-1,29,-24,1,0,1,1,4,7,3,0,1,1,-2,1,3,-1,0,1,1,1,0,-2,7,5,-9,0,-1,-1,1,1,1,2,1
KR_6757369596,420,1,35,-8,0,-5,1,6,2,5,3,0,2,2,1,5,4,2,2,0,0,2,2,-3,8,5,-1,0,-1,1,-1,-1,1,3,1
KR_6744752089,420,1,-60,40,-4,0,3,3,0,3,3,3,5,2,-6,0,6,-1,0,1,0,-3,269,-6,8,2,7,0,1,1,1,1,1,4,1
KR_6767263263,420,1,-4,9,6,1,2,1,-1,3,4,0,1,1,6,7,1,0,2,2,0,8,-47,-1,6,5,25,0,1,1,1,-1,-1,3,1
KR_6642995001,420,0,39,-20,1,1,1,0,3,7,4,0,2,2,-1,3,4,-2,0,2,0,-2,6,2,3,5,-2,0,1,1,-1,1,1,4,1
KR_6766727182,420,0,29,-3,3,-2,2,4,1,1,0,0,3,3,4,4,0,0,0,0,0,10,0,4,0,4,1,0,0,1,-1,1,1,4,1
KR_6740613673,420,5,108,28,9,3,4,1,-5,3,8,3,5,2,7,9,2,1,2,1,0,5,2,4,3,7,-4,0,1,1,-1,1,1,4,1
KR_6769626831,420,-1,24,-5,4,-8,0,8,3,3,0,3,3,0,6,7,1,0,0,0,0,9,0,-2,7,5,0,0,0,1,-1,1,1,5,1
KR_6724882793,440,0,-16,-8,1,0,0,0,0,3,3,-1,2,3,2,3,1,0,1,1,0,5,6,0,5,5,2,0,1,1,1,1,-1,4,1
KR_6639432958,420,3,45,-1,3,6,8,2,2,6,4,1,1,0,-6,3,9,0,2,2,0,-11,-2,-2,6,4,1,0,0,-1,1,-1,-1,3,1
KR_6713880793,420,2,-17,2,3,5,5,0,5,6,1,0,0,0,-7,1,8,0,1,1,0,8,21,-3,5,2,-2,0,-2,1,1,-1,-1,4,1
KR_6695460317,420,-1,-40,8,-3,-3,1,4,1,5,4,-1,3,4,1,2,1,-1,0,1,0,1,-100,5,4,9,-1,0,-1,-1,-1,-1,1,3,1
KR_6664525304,420,0,46,16,-5,-3,2,5,-4,1,5,3,4,1,-1,0,1,0,0,0,0,-9,32,-3,10,7,-1,0,0,-1,-1,1,1,6,1
KR_6737648769,420,0,36,25,-1,0,1,1,0,9,9,-1,0,1,0,2,2,0,2,2,0,-2,23,-5,10,5,1,0,0,1,-1,-1,1,4,1
KR_6670820488,420,-1,-16,32,-3,-4,3,7,1,3,2,1,1,0,-2,0,2,1,5,4,-1,-1,-3,-5,12,7,6,0,0,1,1,0,-1,5,1
KR_6762608643,420,1,43,-4,3,-2,2,4,0,2,2,0,0,0,4,4,0,1,2,1,1,10,2,-4,8,4,-7,0,0,1,1,1,1,5,1
KR_6727911804,420,3,-12,15,12,6,7,1,2,4,2,1,2,1,2,4,2,1,1,0,0,11,28,3,5,8,-2,0,1,1,-1,1,1,5,1
KR_6766814381,440,6,67,10,15,2,2,0,3,4,1,2,2,0,7,11,4,1,1,0,0,13,-12,-3,6,3,2,0,1,1,1,1,1,1,1
KR_6768458943,420,2,-8,8,5,-5,0,5,4,4,0,-2,1,3,1,3,2,7,8,1,0,8,39,1,3,4,-20,0,1,1,1,1,-1,6,1
KR_6767460873,420,1,85,-17,1,1,3,2,-2,0,2,-1,1,2,2,2,0,1,1,0,0,2,-1,0,6,6,-4,0,2,-1,-1,1,1,6,1
KR_6768383628,420,5,58,20,10,1,4,3,1,3,2,5,5,0,4,4,0,-1,0,1,0,18,10,5,5,10,6,0,2,1,-1,1,1,5,1
KR_6753093699,420,5,93,18,16,6,7,1,5,5,0,-3,1,4,6,6,0,2,3,1,1,15,-20,-2,8,6,0,0,2,1,1,1,1,3,1
KR_6759701949,420,-3,-40,8,-7,-4,0,4,-1,2,3,-1,1,2,0,5,5,-1,2,3,0,-6,-5,0,8,8,1,0,-3,-1,1,-1,-1,1,1
KR_6571713647,440,2,39,7,4,3,4,1,-3,1,4,6,6,0,-1,2,3,-1,0,1,0,5,5,4,5,9,2,0,1,-1,1,1,-1,2,1
KR_6739072399,420,-1,12,4,-8,3,3,0,-6,1,7,-2,1,3,0,2,2,-3,1,4,0,-11,-11,-2,8,6,0,0,0,-1,-1,0,1,2,1
KR_6749010730,420,4,100,17,10,-5,0,5,7,8,1,6,7,1,3,7,4,-1,0,1,1,13,13,3,3,6,0,0,2,1,1,1,1,3,1
KR_6766867634,420,-2,-68,-16,-12,-11,0,11,-1,4,5,-1,2,3,1,1,0,0,0,0,0,-10,-19,3,3,6,-2,0,0,-1,-1,1,-1,6,1
KR_6725837066,420,10,85,73,17,5,7,2,3,3,0,4,4,0,2,2,0,3,4,1,0,14,7,4,5,9,5,0,4,1,1,1,1,6,1
KR_6746531380,420,-4,5,24,0,0,2,2,-1,2,3,2,4,2,0,2,2,-1,0,1,0,1,10,6,3,9,3,0,1,1,1,1,-1,5,1
KR_6707936901,420,2,8,0,7,-1,2,3,5,7,2,2,2,0,1,3,2,0,0,0,0,10,-35,-5,8,3,-8,0,1,0,1,1,1,0,1
KR_6757791875,420,0,-4,-19,2,-2,0,2,0,2,2,-1,3,4,2,8,6,3,3,0,0,9,5,2,4,6,-2,0,0,-1,-1,-1,-1,5,1
KR_6760802591,420,5,32,-6,11,3,4,1,1,3,2,0,0,0,3,3,0,4,5,1,1,11,-5,-2,6,4,4,0,3,1,0,1,1,1,1
KR_6767655668,420,0,-25,-8,-1,2,2,0,-2,1,3,1,2,1,-2,4,6,0,0,0,0,-4,5,0,5,5,3,0,0,1,1,0,-1,6,1
KR_6679858190,420,-1,-7,9,2,0,3,3,3,4,1,-2,1,3,-1,4,5,2,6,4,0,-3,2,3,2,5,1,0,0,1,-1,0,-1,6,1
KR_6770056774,420,4,35,29,11,2,3,1,2,2,0,3,6,3,2,5,3,2,2,0,1,9,-16,4,4,8,3,0,2,1,1,1,1,2,1
KR_6702881378,420,-1,4,5,1,-1,2,3,-1,3,4,2,2,0,3,6,3,-2,0,2,0,-3,-9,-3,8,5,-1,0,1,-1,1,1,1,6,1
KR_6613576655,420,-1,87,-8,-6,0,2,2,-2,3,5,-3,1,4,3,4,1,-4,0,4,0,-9,-8,2,6,8,3,0,0,-1,1,1,-1,2,1
KR_6748429520,440,2,16,-4,4,-7,1,8,0,2,2,6,7,1,5,7,2,0,0,0,0,7,-5,-6,7,1,4,0,-1,-1,1,-1,1,4,1
KR_6769746821,420,2,65,-16,1,-1,1,2,1,4,3,-1,3,4,2,3,1,0,2,2,-1,-3,13,-1,4,3,2,0,1,1,-1,1,-1,3,1
KR_6769363550,420,2,27,4,6,-1,3,4,0,3,3,2,3,1,6,7,1,-1,0,1,1,14,-16,-2,7,5,7,0,0,1,-1,0,1,1,1
KR_6720366746,420,5,44,0,14,5,6,1,-2,3,5,9,9,0,2,5,3,0,2,2,0,7,8,-7,10,3,2,0,2,-1,1,1,-1,2,1
KR_6765224490,420,1,12,-7,6,-3,2,5,1,3,2,5,6,1,3,4,1,0,0,0,0,11,3,-2,5,3,1,0,1,1,0,1,1,4,1
KR_6620484024,420,0,-22,-29,-3,0,1,1,-3,2,5,-1,3,4,1,4,3,0,0,0,0,0,-1,2,8,10,1,0,0,-1,-1,0,1,1,1
KR_6688472190,420,0,7,-19,1,0,1,1,5,7,2,-5,0,5,1,3,2,0,2,2,1,2,66,1,4,5,-1,0,1,1,-1,1,1,4,1
KR_6766808236,420,-1,-29,9,2,4,4,0,4,5,1,-3,3,6,1,3,2,-4,1,5,0,-6,-9,1,7,8,-4,0,1,-1,1,1,1,5,1
KR_6763230775,420,4,55,8,5,0,1,1,3,6,3,1,4,3,-1,4,5,2,2,0,0,0,104,2,2,4,-1,0,0,1,-1,0,-1,2,1
KR_6765308026,420,3,36,23,-1,-3,1,4,6,7,1,0,2,2,-1,0,1,-3,0,3,0,-14,2,1,5,6,-4,0,2,1,-1,1,1,5,1
KR_6742560882,420,3,72,25,9,-1,4,5,5,6,1,1,3,2,3,3,0,1,1,0,0,14,1,3,1,4,4,0,2,1,1,1,1,1,1
KR_6644822768,420,4,46,0,6,-1,2,3,3,6,3,-2,1,3,3,6,3,3,3,0,0,3,29,-2,7,5,4,0,2,1,-1,1,-1,2,1
KR_6738296588,420,4,34,4,9,0,1,1,5,5,0,-3,2,5,2,2,0,5,5,0,0,14,50,3,4,7,-2,0,2,1,-1,1,1,1,1
KR_6765797104,440,1,-44,15,7,0,4,4,-2,0,2,3,5,2,4,6,2,2,4,2,-1,13,17,-1,4,3,-1,0,0,1,-1,1,-1,6,1
KR_6767844856,420,-1,-29,6,-3,-2,3,5,-1,1,2,-3,2,5,2,3,1,1,3,2,0,-3,-11,1,7,8,0,0,0,1,-1,-1,1,5,1
KR_6675508304,420,0,17,18,1,-3,0,3,1,1,0,-1,0,1,4,5,1,0,0,0,0,5,-194,-3,8,5,0,0,-1,1,-1,-1,1,5,1
KR_6629936956,420,0,-32,6,4,0,0,0,-2,3,5,1,1,0,5,6,1,0,2,2,0,2,-15,0,4,4,1,0,0,1,1,0,1,6,1
KR_6758146785,420,1,13,-32,7,0,1,1,2,3,1,0,2,2,3,3,0,2,2,0,0,11,103,2,6,8,6,0,1,-1,1,1,-1,3,1
KR_6769891432,440,1,-40,-8,8,6,6,0,1,2,1,-1,2,3,0,4,4,2,2,0,0,8,10,4,3,7,-4,0,0,1,1,1,-1,3,1
KR_6762597903,440,2,67,0,1,4,4,0,2,2,0,-1,1,2,-2,0,2,-2,0,2,0,-3,3,-1,7,6,1,0,2,-1,0,1,1,1,1
KR_6733365894,420,0,-24,-12,6,2,3,1,-2,2,4,4,4,0,0,3,3,2,2,0,0,-1,16,3,5,8,0,0,1,1,1,1,1,5,1
KR_6770002129,420,5,96,16,6,2,4,2,-1,2,3,1,2,1,2,4,2,2,2,0,0,7,-15,-2,7,5,2,0,1,-1,-1,1,1,2,1
KR_6762970463,420,0,50,15,4,-2,1,3,0,2,2,-1,0,1,3,4,1,4,5,1,0,5,12,-4,7,3,2,0,1,1,1,1,-1,5,1
KR_6751058768,420,4,44,-7,9,5,7,2,0,3,3,1,3,2,3,4,1,0,1,1,0,4,4,0,4,4,3,0,0,-1,1,1,1,2,1
KR_6616814557,420,2,-16,-16,7,2,2,0,1,2,1,5,5,0,-1,3,4,0,0,0,0,4,-2,1,10,11,7,0,1,1,1,1,1,2,1
KR_6769323090,420,1,-9,7,9,3,3,0,5,6,1,1,4,3,0,2,2,0,1,1,0,0,1,1,3,4,4,0,2,1,1,1,-1,1,1
KR_6750543014,420,0,-14,-4,1,0,1,1,-1,3,4,4,5,1,-1,2,3,-1,0,1,0,4,-50,-4,8,4,9,0,0,1,-1,-1,1,4,1
KR_6755529291,420,7,93,40,14,3,3,0,1,3,2,3,5,2,2,5,3,5,7,2,0,7,6,-2,7,5,7,0,4,1,1,1,1,1,1
KR_6687241163,420,2,5,-4,7,0,1,1,-2,1,3,8,8,0,2,7,5,-1,0,1,0,11,41,5,2,7,-29,0,0,1,-1,0,-1,2,1
KR_6639245188,420,-3,56,6,-9,-3,1,4,-3,2,5,-2,2,4,0,3,3,-1,3,4,-1,-20,-11,2,8,10,6,0,-1,1,-1,-1,-1,2,1
KR_6764180753,420,-2,-14,64,-7,-5,1,6,1,3,2,-1,2,3,-2,1,3,0,1,1,0,-9,-29,1,4,5,2,0,2,1,1,1,-1,6,1
KR_6744932612,420,1,-32,-1,-1,0,1,1,0,1,1,-5,1,6,6,10,4,-2,0,2,0,1,-102,5,4,9,-4,0,1,1,1,1,-1,2,1
KR_6769532449,420,2,-28,0,0,0,3,3,2,4,2,-1,2,3,0,4,4,-1,1,2,0,4,1,1,3,4,0,0,1,-1,1,1,-1,3,1
KR_6769680098,420,2,71,32,11,-1,2,3,6,6,0,3,3,0,3,5,2,0,0,0,0,9,7,7,1,8,0,0,3,1,1,1,1,6,1
KR_6766224055,420,2,33,20,12,3,4,1,3,3,0,-2,1,3,2,2,0,6,6,0,0,14,-19,-1,7,6,8,0,2,1,1,1,1,3,1
KR_6644965586,420,3,-6,-4,8,2,2,0,3,5,2,1,1,0,0,3,3,2,2,0,0,2,0,-1,6,5,0,0,1,1,1,1,-1,6,1
KR_6764993114,420,5,88,43,18,2,4,2,3,6,3,2,4,2,10,10,0,1,2,1,2,22,7,2,5,7,4,0,4,-1,1,1,1,6,1
KR_6760270901,420,-2,11,-6,1,-1,0,1,-4,4,8,1,3,2,3,7,4,2,2,0,0,-2,3,-4,7,3,6,0,1,1,1,1,1,2,1
KR_6768252305,420,4,35,7,8,-1,1,2,-1,2,3,9,10,1,1,3,2,0,0,0,0,12,36,5,0,5,0,0,3,-1,1,1,1,2,1
KR_6767298892,420,-1,18,-36,2,2,5,3,-1,2,3,0,3,3,-4,0,4,5,7,2,2,9,-11,1,4,5,5,0,0,-1,-1,-1,1,6,1
KR_6707729588,420,2,78,20,7,5,6,1,1,7,6,-1,2,3,1,2,1,1,3,2,1,10,-41,-1,6,5,15,0,1,1,1,1,1,6,1
KR_6751082150,420,2,66,-15,5,7,8,1,-5,1,6,2,3,1,0,3,3,1,1,0,-1,4,8,2,3,5,7,0,1,1,-1,1,-1,5,1
KR_6766219715,420,-1,3,1,4,2,5,3,1,4,3,1,2,1,-1,0,1,1,1,0,0,-7,20,-1,7,6,2,0,0,-1,1,0,1,1,1
KR_6738993908,440,1,-19,27,3,-1,0,1,1,4,3,0,0,0,3,5,2,0,0,0,2,6,8,2,6,8,2,0,1,1,1,1,1,3,1
KR_6761067466,420,3,63,12,5,-3,1,4,7,8,1,1,2,1,1,2,1,-1,3,4,1,7,-112,2,2,4,1,0,0,-1,-1,0,1,6,1
KR_6682126666,420,0,-16,-7,3,-5,1,6,4,6,2,-3,2,5,1,3,2,6,6,0,1,18,-253,-6,10,4,7,0,0,-1,1,0,1,6,1
KR_6727633380,420,7,28,40,20,1,4,3,3,7,4,7,8,1,8,9,1,1,2,1,2,17,-11,-4,9,5,7,0,1,1,-1,1,1,2,1
KR_6765794282,420,-2,30,10,2,-3,1,4,1,1,0,-2,1,3,5,5,0,1,1,0,0,3,-143,-1,8,7,-2,0,-1,1,-1,1,1,4,1
KR_6752464441,420,0,27,-17,2,0,2,2,0,2,2,-3,1,4,5,5,0,0,0,0,0,7,8,6,1,7,-1,0,1,-1,1,1,-1,4,1
KR_6684241404,420,-4,-17,-4,-4,-1,2,3,-1,1,2,-5,4,9,1,4,3,2,4,2,0,-4,-4,-3,7,4,6,0,-2,0,-1,1,1,0,1
KR_6764440200,420,-1,-1,4,-6,-2,0,2,-1,1,2,-1,0,1,0,2,2,-2,0,2,0,-10,4,2,4,6,-3,0,1,1,-1,1,1,1,1
KR_6644628031,420,-3,-1,-16,-1,2,3,1,2,2,0,-4,2,6,-2,1,3,1,2,1,-1,-6,0,-5,7,2,2,0,-2,-1,-1,-1,-1,5,1
KR_6759435502,420,3,43,-7,6,-1,2,3,2,3,1,2,5,3,3,3,0,0,0,0,0,13,10,4,0,4,2,0,1,1,1,1,-1,5,1
KR_6758888828,420,1,-28,-8,-2,-3,1,4,5,6,1,1,2,1,-4,2,6,-1,0,1,0,-1,10,-1,9,8,2,0,0,-1,1,0,-1,6,1
KR_6713201531,420,0,7,30,7,-1,3,4,8,11,3,-2,3,5,3,4,1,-1,1,2,1,7,6,0,6,6,2,0,1,1,1,1,-1,6,1
KR_6758734214,420,0,11,7,-2,-2,1,3,1,2,1,0,2,2,0,1,1,-1,0,1,-1,-3,-3,-3,4,1,1,0,-1,1,-1,-1,-1,4,1
KR_6766867887,420,2,51,-32,7,6,6,0,1,4,3,-3,0,3,3,5,2,0,0,0,0,7,4,2,6,8,-4,0,1,1,1,1,-1,1,1
KR_6767536415,420,4,19,-6,13,8,9,1,5,6,1,0,3,3,2,2,0,-2,0,2,0,18,3,-1,4,3,-2,0,0,-1,1,1,1,5,1
KR_6768890316,420,5,14,4,4,0,2,2,1,7,6,0,1,1,-1,4,5,4,4,0,0,8,35,1,2,3,-21,0,1,0,-1,1,1,0,1
KR_6767066426,420,4,46,-16,13,3,3,0,8,8,0,0,1,1,3,5,2,-1,1,2,0,14,8,-5,9,4,0,0,2,-1,-1,1,1,1,1
KR_6768219553,440,-1,-77,-24,0,-2,1,3,-5,0,5,1,3,2,2,3,1,4,4,0,0,8,36,-1,2,1,-19,0,0,1,1,-1,-1,2,1
KR_6770327007,420,2,10,17,6,1,1,0,2,3,1,0,1,1,2,4,2,1,2,1,0,3,-2,-3,9,6,3,0,2,-1,1,1,1,5,1
KR_6696650562,420,2,57,14,7,2,3,1,0,2,2,3,4,1,1,2,1,1,1,0,1,5,6,-1,4,3,-2,0,2,-1,1,1,1,2,1
KR_6752180555,420,0,68,4,-5,3,4,1,-2,4,6,-4,2,6,-3,2,5,1,3,2,-3,-18,-10,-2,7,5,-1,0,0,-1,-1,-1,-1,1,1
KR_6758313993,420,-2,42,7,-4,-3,1,4,1,3,2,1,3,2,-3,7,10,0,0,0,0,-3,-7,0,6,6,-4,0,-2,1,-1,-1,1,2,1
KR_6770031407,420,1,-28,-14,8,4,6,2,3,5,2,-1,0,1,1,4,3,1,2,1,0,7,1,-2,6,4,0,0,2,-1,1,1,1,5,1
KR_6760065587,440,1,-25,0,7,-2,0,2,13,14,1,-1,3,4,-1,3,4,-2,1,3,0,2,-6,3,2,5,2,0,1,-1,1,1,-1,3,1
KR_6761332081,440,0,56,-20,5,0,2,2,1,5,4,-2,1,3,3,3,0,3,3,0,0,10,-37,-2,7,5,18,0,0,1,0,1,1,4,1
KR_6761752010,420,1,61,25,8,3,5,2,1,3,2,-2,2,4,6,10,4,0,1,1,0,9,-1,2,2,4,-2,0,-1,-1,-1,1,1,1,1
KR_6704074678,420,0,18,1,-4,1,3,2,-5,3,8,0,3,3,2,4,2,-2,1,3,0,5,-1,2,6,8,4,0,-1,-1,-1,-1,1,1,1
KR_6754607322,420,4,38,12,10,2,2,0,2,3,1,-6,0,6,11,12,1,1,1,0,2,14,2,-2,6,4,1,0,1,1,1,1,1,2,1
KR_6768205237,420,2,29,19,4,-2,0,2,-1,5,6,6,6,0,0,4,4,1,1,0,0,6,-7,-5,8,3,5,0,0,1,1,1,1,5,1
KR_6745871549,420,0,-44,-39,-4,1,2,1,-3,0,3,1,4,3,-3,1,4,0,1,1,0,-4,-108,3,3,6,-1,0,-1,-1,1,-1,-1,1,1
KR_6770055445,420,-1,-39,-8,7,3,4,1,1,3,2,1,1,0,4,4,0,-2,0,2,0,9,0,6,2,8,-6,0,0,1,-1,0,1,5,1
KR_6750574284,420,2,16,10,5,2,2,0,0,1,1,3,5,2,-3,3,6,3,4,1,-1,1,2,-1,8,7,2,0,1,1,-1,1,-1,1,1
KR_6770108686,420,0,48,-14,-1,-5,1,6,0,3,3,1,1,0,4,4,0,-1,0,1,-1,2,-25,-10,13,3,4,0,0,1,-1,-1,-1,4,1
KR_6734579652,420,-1,-2,9,-1,-1,1,2,1,3,2,1,2,1,-2,0,2,0,0,0,0,-4,-32,0,4,4,-3,0,1,-1,1,1,1,4,1
KR_6758233372,440,2,83,11,7,-2,1,3,0,6,6,2,2,0,1,4,3,6,8,2,0,6,2,0,6,6,3,0,1,-1,1,1,1,4,1
KR_6768087258,420,2,4,-14,-1,0,4,4,-2,3,5,-1,1,2,2,5,3,0,0,0,-2,4,-11,-1,7,6,5,0,2,-1,1,1,-1,4,1
KR_6770245089,420,-1,-12,4,-2,0,3,3,-3,4,7,2,3,1,3,6,3,-4,0,4,0,-3,-11,3,3,6,1,0,0,1,-1,-1,1,6,1
KR_6718709774,420,-2,-19,-5,-5,0,0,0,-5,0,5,0,3,3,-1,4,5,1,2,1,0,-2,3,2,2,4,1,0,0,1,1,1,1,5,1
KR_6745941341,420,0,34,-42,7,3,4,1,0,4,4,0,1,1,5,5,0,-1,2,3,0,4,0,4,7,11,6,0,2,1,1,1,1,3,1
KR_6740620018,420,1,-16,8,-1,-2,0,2,-2,1,3,-5,7,12,5,5,0,3,4,1,-2,1,-15,-3,4,1,1,0,0,1,-1,-1,-1,1,1
KR_6768033246,420,2,30,-10,11,3,3,0,0,5,5,4,5,1,2,2,0,2,3,1,0,9,49,4,2,6,-13,0,2,1,1,1,1,6,1
KR_6763227363,440,4,26,20,2,2,2,0,-1,1,2,0,2,2,0,0,0,1,3,2,0,-1,2,0,7,7,-1,0,0,-1,1,1,1,4,1
KR_6749130463,420,4,27,18,12,0,2,2,4,7,3,4,5,1,6,8,2,-2,0,2,-1,18,-1,0,6,6,-2,0,3,1,1,1,-1,4,1
KR_6729918236,420,1,16,-35,12,1,2,1,1,4,3,2,2,0,0,2,2,8,11,3,2,7,-39,-4,5,1,4,0,3,1,1,1,1,3,1
KR_6762844050,420,3,82,25,4,0,4,4,1,6,5,2,4,2,-1,1,2,2,2,0,0,-1,0,-4,7,3,-2,0,0,-1,-1,-1,-1,1,1
KR_6769226233,420,0,19,-5,8,-1,3,4,1,6,5,4,5,1,4,4,0,0,2,2,0,13,-21,1,6,7,6,0,1,1,-1,-1,-1,1,1
KR_6674984503,420,6,62,7,13,5,9,4,-1,2,3,2,4,2,5,7,2,2,2,0,0,-1,18,5,2,7,-3,0,1,0,1,1,1,0,1
KR_6767308161,420,1,40,15,1,1,2,1,2,5,3,-2,3,5,1,4,3,-1,3,4,0,0,-2,-2,8,6,3,0,2,-1,1,1,-1,2,1
KR_6743693950,420,5,3,12,13,2,3,1,5,7,2,-1,4,5,7,9,2,0,0,0,0,15,32,-1,4,3,4,0,2,1,1,1,-1,5,1
KR_6766502744,420,3,26,-1,8,0,2,2,6,7,1,0,1,1,2,3,1,0,0,0,0,9,5,0,7,7,6,0,1,1,1,1,-1,5,1
KR_6731644406,420,3,40,4,2,6,7,1,2,5,3,-3,2,5,-4,0,4,1,2,1,0,1,-1,4,1,5,-5,0,1,0,1,1,1,0,1
KR_6767405863,420,0,8,-12,5,-1,1,2,-5,5,10,2,5,3,4,4,0,5,5,0,0,9,-42,2,3,5,23,0,0,1,-1,0,-1,5,1
KR_6764147119,420,-2,22,-3,-1,-3,2,5,-1,5,6,0,4,4,2,2,0,1,2,1,1,0,12,3,3,6,-7,0,2,1,1,1,1,6,1
KR_6761897151,420,-4,-12,-32,-3,-3,0,3,-1,2,3,1,5,4,0,2,2,0,0,0,0,-2,12,1,6,7,-7,0,-1,1,-1,-1,1,3,1
KR_6769884008,440,4,40,16,7,0,2,2,1,3,2,3,6,3,2,4,2,1,1,0,1,9,4,-1,6,5,-3,0,0,1,-1,0,1,6,1
KR_6748380042,420,-3,-11,-6,3,-2,2,4,-1,4,5,1,3,2,4,7,3,1,1,0,1,3,8,-6,12,6,1,0,0,-1,1,0,1,5,1
KR_6749402019,420,3,66,-36,5,1,2,1,0,5,5,-1,2,3,5,7,2,0,1,1,0,7,-12,-5,9,4,6,0,0,1,-1,1,1,3,1
KR_6696651008,420,1,42,-32,0,-6,0,6,3,5,2,5,7,2,3,7,4,-5,0,5,3,15,27,-1,5,4,-6,0,0,1,-1,0,1,5,1
KR_6699890746,420,0,26,6,-3,-3,3,6,1,7,6,2,4,2,-1,3,4,-2,1,3,0,-3,-1,2,6,8,-2,0,0,1,-1,-1,-1,2,1
KR_6678601375,420,7,88,12,9,2,4,2,3,5,2,4,4,0,0,1,1,0,0,0,0,11,3,2,4,6,1,0,3,-1,1,1,-1,5,1
KR_6747640368,420,1,45,36,5,5,6,1,-1,2,3,-5,0,5,5,5,0,1,1,0,0,4,5,2,4,6,0,0,1,1,1,1,1,5,1
KR_6766925130,420,4,58,-5,19,4,4,0,4,6,2,4,6,2,7,9,2,0,0,0,2,24,35,12,1,13,-4,0,0,1,1,1,1,5,1
KR_6747463018,420,4,40,30,3,-2,4,6,-1,1,2,2,4,2,0,3,3,4,4,0,1,2,26,-3,5,2,1,0,1,-1,1,1,1,4,1
KR_6585867219,420,-1,-22,18,2,0,1,1,-4,4,8,0,2,2,6,6,0,0,1,1,0,5,12,-2,8,6,-2,0,1,1,-1,1,1,2,1
KR_6740377630,420,1,-45,-20,0,2,5,3,1,7,6,0,6,6,-2,3,5,-1,2,3,0,9,1,-2,7,5,4,0,-1,0,-1,-1,-1,0,1
KR_6763631124,440,3,36,4,5,-4,2,6,5,5,0,2,3,1,1,3,2,1,6,5,0,2,-1,-4,5,1,2,0,1,1,-1,-1,1,5,1
KR_6766213262,420,2,-57,12,2,-1,0,1,-1,1,2,7,7,0,-1,0,1,-2,0,2,0,3,3,4,2,6,-2,0,0,1,-1,0,-1,2,1
KR_6764945539,420,-4,-10,-3,-6,-2,1,3,0,2,2,-1,4,5,-3,2,5,0,0,0,0,-6,-5,2,5,7,-6,0,0,-1,1,0,1,2,1
KR_6730819019,420,-2,71,8,-7,0,2,2,-3,3,6,-2,1,3,-1,1,2,-1,1,2,0,-17,-1,-3,5,2,0,0,1,-1,1,1,-1,4,1
KR_6765026688,420,0,-12,-30,0,-2,1,3,1,3,2,5,5,0,-3,2,5,-1,1,2,1,-3,-1,2,4,6,4,0,-1,-1,-1,-1,1,1,1
KR_6764911666,440,2,19,4,4,2,2,0,2,3,1,-1,3,4,1,3,2,0,1,1,0,9,12,4,2,6,-1,0,1,1,0,1,1,1,1
KR_6664330769,420,-2,-37,5,-5,-4,0,4,-1,1,2,2,2,0,0,1,1,-2,0,2,0,-4,148,3,5,8,2,0,-1,-1,1,-1,-1,6,1
KR_6762031683,420,4,32,21,6,-1,2,3,-3,2,5,3,5,2,7,9,2,0,2,2,1,6,-3,0,5,5,4,0,1,1,1,1,1,4,1
KR_6578862759,440,3,8,20,5,4,5,1,1,2,1,-3,1,4,2,3,1,1,1,0,0,8,1,0,4,4,-1,0,2,-1,1,1,1,5,1
KR_6769509476,420,0,-6,-8,4,-2,3,5,2,5,3,-1,2,3,5,7,2,0,1,1,0,11,-1,-5,12,7,3,0,0,1,-1,-1,1,1,1
KR_6712012211,420,3,68,12,9,6,7,1,0,1,1,4,4,0,-2,2,4,1,1,0,0,1,18,0,6,6,3,0,2,1,1,1,1,4,1
KR_6760798132,420,2,23,12,0,-1,1,2,2,5,3,2,3,1,-1,1,2,-2,0,2,0,3,54,3,6,9,-17,0,1,1,1,1,1,6,1
KR_6760324944,420,1,-11,18,3,1,1,0,0,3,3,4,5,1,-1,2,3,-1,0,1,0,2,-42,0,5,5,5,0,1,-1,1,1,1,3,1
KR_6741614171,420,4,89,28,12,1,2,1,2,3,1,6,6,0,3,3,0,0,2,2,0,11,12,1,4,5,-3,0,2,1,1,1,1,3,1
KR_6727956843,420,1,56,-36,8,6,7,1,-1,2,3,4,4,0,0,3,3,-1,1,2,1,2,-1,3,4,7,-4,0,2,1,1,1,1,3,1
KR_6764779147,420,2,35,14,11,-2,2,4,1,2,1,3,4,1,10,10,0,-1,0,1,1,17,11,-1,6,5,0,0,1,1,1,1,1,2,1
KR_6686860412,420,2,0,18,0,4,4,0,1,3,2,-4,0,4,-1,2,3,0,0,0,0,-8,422,0,6,6,2,0,0,-1,1,0,-1,4,1
KR_6765206497,420,3,30,-17,7,0,3,3,0,6,6,5,8,3,1,2,1,1,1,0,0,8,9,-2,8,6,2,0,0,1,-1,0,1,6,1
KR_6723828080,420,3,98,-2,4,1,4,3,-1,2,3,-2,0,2,3,3,0,3,3,0,0,3,229,-2,5,3,4,0,1,1,1,1,1,1,1
KR_6724987534,420,3,28,16,6,1,2,1,3,4,1,5,5,0,-2,2,4,-1,0,1,0,7,-5,3,4,7,-2,0,2,-1,1,1,1,6,1
KR_6759033732,420,5,90,-2,14,0,3,3,-1,1,2,-1,0,1,5,8,3,11,11,0,0,11,3,0,2,2,0,0,4,1,1,1,1,3,1
KR_6770207764,420,1,24,-36,3,-3,1,4,2,5,3,-2,0,2,3,5,2,3,3,0,0,4,23,3,3,6,-2,0,1,-1,1,1,1,1,1
KR_6725554183,420,4,15,15,10,2,2,0,0,2,2,2,3,1,5,5,0,1,1,0,0,18,-9,2,6,8,1,0,1,1,1,1,1,2,1
KR_6764920738,420,0,15,-8,2,6,7,1,1,2,1,-3,1,4,3,3,0,-5,1,6,1,6,-1,0,4,4,-4,0,0,-1,-1,-1,1,2,1
KR_6746115219,420,4,37,13,5,-3,3,6,4,5,1,2,4,2,1,6,5,1,1,0,0,-7,-8,-3,7,4,-1,0,0,0,-1,0,1,0,1
KR_6612353207,420,0,-2,14,0,-5,0,5,4,5,1,1,4,3,1,2,1,-1,0,1,0,4,-53,-1,8,7,21,0,0,1,1,1,1,2,1
KR_6769096437,420,3,70,8,5,3,3,0,0,2,2,0,4,4,0,1,1,2,3,1,0,0,-10,0,4,4,-2,0,2,1,1,1,1,6,1
KR_6698902335,420,2,12,-24,9,3,3,0,6,7,1,2,2,0,0,3,3,-2,0,2,0,7,13,5,3,8,0,0,1,-1,1,1,1,3,1
KR_6619280703,420,5,50,25,11,1,1,0,2,2,0,3,10,7,3,5,2,2,2,0,2,16,1,2,5,7,6,0,1,1,-1,1,-1,4,1
KR_6667818867,420,-3,-34,-12,-1,-2,1,3,1,2,1,-2,1,3,4,8,4,-2,0,2,1,7,24,1,3,4,4,0,-3,1,1,-1,1,2,1
KR_6742716071,420,2,32,27,6,-4,1,5,3,4,1,-2,2,4,5,6,1,4,4,0,1,8,14,0,4,4,-2,0,0,1,1,-1,1,2,1
KR_6748456559,420,6,85,26,9,4,6,2,4,7,3,0,2,2,-3,5,8,4,5,1,0,11,197,-2,7,5,-1,0,1,1,-1,1,-1,5,1
KR_6765423643,420,7,58,38,9,3,3,0,0,4,4,2,4,2,3,8,5,1,2,1,1,8,18,6,2,8,-8,0,1,1,1,1,1,4,1
KR_6621913232,420,1,-42,-19,5,2,2,0,1,4,3,1,1,0,-1,2,3,2,3,1,0,1,1,-4,7,3,1,0,0,-1,-1,1,-1,5,1
KR_6769265378,420,0,-37,11,0,-1,0,1,1,3,2,-1,2,3,2,2,0,-1,1,2,0,1,-11,-4,8,4,4,0,0,-1,1,0,1,6,1
KR_6756087560,420,2,55,-5,14,6,6,0,6,8,2,2,2,0,-1,1,2,1,1,0,0,10,-1,1,6,7,4,0,2,1,-1,1,1,2,1
KR_6760802637,420,4,-12,15,5,4,6,2,2,4,2,1,4,3,-1,3,4,-1,1,2,0,-1,-230,2,5,7,-6,0,4,-1,1,1,-1,3,1
KR_6769333239,420,4,27,13,4,0,0,0,0,2,2,1,2,1,3,5,2,0,2,2,0,-3,5,4,4,8,1,0,-1,1,-1,-1,1,1,1
KR_6768975067,420,-1,48,-4,-8,-2,1,3,-1,3,4,-2,1,3,0,1,1,-3,1,4,-2,-14,0,-3,6,3,-3,0,-1,-1,-1,-1,-1,4,1
KR_6691643430,420,2,38,15,1,2,2,0,-1,1,2,-3,1,4,3,6,3,0,1,1,-1,2,15,4,2,6,-5,0,1,1,-1,1,-1,3,1
KR_6712274478,420,0,60,0,4,0,1,1,-7,1,8,2,3,1,8,8,0,1,1,0,0,10,4,1,4,5,2,0,1,-1,-1,1,1,3,1
KR_6768638172,420,2,11,4,8,-2,0,2,-1,2,3,2,5,3,6,7,1,3,4,1,0,11,42,3,5,8,-17,0,0,1,1,0,1,1,1
KR_6662017787,420,0,33,40,1,-1,2,3,0,1,1,3,4,1,-1,3,4,0,1,1,0,3,8,-3,6,3,1,0,1,1,1,1,-1,2,1
KR_6764860203,420,1,33,16,-2,1,4,3,-3,4,7,0,1,1,0,1,1,0,1,1,0,-3,8,0,7,7,-1,0,0,0,1,0,-1,0,1
KR_6760703763,420,-2,-12,3,2,-2,0,2,2,5,3,0,2,2,0,4,4,2,3,1,2,14,-6,0,4,4,6,0,0,1,1,-1,1,3,1
KR_6728805893,420,0,37,20,-4,-1,1,2,-1,1,2,1,1,0,-1,2,3,-2,1,3,-1,-7,-2,2,5,7,0,0,0,1,-1,0,-1,1,1
KR_6762066374,420,0,56,-38,-5,0,0,0,-1,1,2,-1,0,1,-3,3,6,0,2,2,0,-3,-3,-4,8,4,0,0,-1,-1,-1,-1,-1,3,1
KR_6769853444,420,-1,41,-11,-1,3,3,0,-1,0,1,0,1,1,0,3,3,-3,0,3,0,-2,5,1,3,4,-4,0,1,-1,1,1,1,1,1
KR_6769493385,420,-1,20,-36,5,1,3,2,5,8,3,0,4,4,0,3,3,-1,0,1,0,10,-9,2,4,6,2,0,1,1,1,-1,1,4,1
KR_6770323057,420,3,52,-15,10,0,1,1,2,3,1,3,3,0,4,4,0,1,1,0,0,12,4,-1,5,4,4,0,1,1,-1,1,1,5,1
KR_6765594653,440,1,27,6,6,-1,0,1,0,0,0,1,2,1,4,6,2,2,2,0,0,9,9,-5,7,2,6,0,0,1,1,0,-1,5,1
KR_6755281711,440,3,95,11,19,7,8,1,6,8,2,1,2,1,-2,0,2,7,10,3,0,7,147,2,2,4,-4,0,2,0,1,1,1,0,1
KR_6758913092,440,1,60,24,0,2,5,3,1,1,0,-5,1,6,2,2,0,0,2,2,0,2,7,0,2,2,2,0,0,1,-1,0,-1,1,1
KR_6718309885,420,2,-26,-16,0,1,2,1,1,5,4,-4,2,6,-1,2,3,3,4,1,0,1,-24,1,4,5,10,0,0,1,-1,0,-1,5,1
KR_6765483473,420,-2,-7,-27,0,0,1,1,1,4,3,-4,0,4,0,4,4,3,3,0,0,-6,8,1,6,7,1,0,1,-1,-1,1,1,1,1
KR_6769011367,420,-1,39,-2,2,0,2,2,6,6,0,-2,0,2,-1,0,1,-1,0,1,0,1,16,3,2,5,-2,0,0,1,-1,0,1,2,1
KR_6733892564,420,0,5,-37,2,-1,0,1,-3,2,5,2,3,1,4,4,0,0,1,1,0,7,2,-2,7,5,-3,0,-1,1,-1,-1,1,1,1
KR_6685440849,420,-1,18,-5,-3,8,8,0,0,4,4,-4,3,7,-4,1,5,-3,0,3,0,-13,10,1,6,7,1,0,0,-1,1,1,-1,1,1
KR_6698411797,420,4,64,37,5,4,6,2,0,5,5,-3,2,5,4,7,3,0,0,0,0,3,4,4,5,9,2,0,1,-1,-1,1,-1,4,1
KR_6761946742,420,4,36,-5,11,0,1,1,8,9,1,0,2,2,3,4,1,0,0,0,0,17,2,5,3,8,-2,0,0,1,1,0,1,5,1
KR_6767200487,440,0,-12,7,5,1,2,1,1,1,0,-2,1,3,5,6,1,0,2,2,0,3,-7,3,6,9,-1,0,0,-1,1,0,-1,2,1
KR_6766216132,420,6,61,16,19,4,4,0,6,6,0,3,4,1,5,8,3,1,1,0,0,18,-32,1,2,3,17,0,3,1,1,1,-1,4,1
KR_6764227977,420,1,-21,-4,2,-1,2,3,0,1,1,0,1,1,3,3,0,0,1,1,0,8,-2,-5,8,3,-4,0,0,-1,-1,1,-1,1,1
KR_6760005355,420,-1,33,-7,-4,-2,0,2,0,1,1,0,0,0,-1,1,2,-1,0,1,0,-1,2,4,4,8,3,0,0,1,1,0,1,1,1
KR_6708662375,420,0,-50,22,2,0,1,1,0,2,2,-3,1,4,2,8,6,3,3,0,0,4,-6,-4,9,5,-3,0,1,1,-1,1,1,1,1
KR_6767614740,420,2,-8,0,7,-1,2,3,6,7,1,-2,0,2,5,5,0,-1,3,4,-1,3,130,-5,10,5,-4,0,2,1,-1,1,-1,3,1
KR_6671852078,420,5,43,32,11,1,2,1,2,3,1,4,7,3,1,2,1,3,3,0,0,15,8,3,4,7,0,0,1,1,1,1,1,3,1
KR_6761200892,440,-2,-5,-6,2,0,1,1,3,3,0,5,6,1,1,2,1,-7,2,9,0,0,-1,3,5,8,3,0,-1,-1,1,-1,-1,3,1
KR_6769288112,420,4,44,-36,12,4,4,0,1,2,1,0,1,1,8,8,0,-1,0,1,3,17,-4,2,1,3,3,0,0,1,-1,1,1,3,1
KR_6765904819,420,1,-19,28,-5,2,2,0,-5,1,6,0,4,4,-1,2,3,-1,2,3,0,-6,2,-3,6,3,-1,0,-1,1,-1,-1,-1,5,1
KR_6712252835,420,-2,-19,-16,2,3,4,1,-1,1,2,-2,2,4,1,2,1,1,1,0,0,2,-4,4,6,10,3,0,1,1,1,1,-1,1,1
KR_6673767099,420,3,37,9,-2,0,3,3,0,4,4,-2,2,4,1,3,2,-1,0,1,0,-4,11,0,6,6,-5,0,0,0,1,0,-1,0,1
KR_6736435407,420,-2,14,-35,-2,2,3,1,2,3,1,-4,4,8,1,2,1,-3,1,4,0,-4,9,2,3,5,0,0,0,1,-1,0,-1,2,1
KR_6687737375,420,2,-8,-24,11,9,10,1,-2,2,4,0,1,1,6,7,1,-2,1,3,0,17,32,-1,9,8,4,0,0,-1,1,-1,-1,2,1
KR_6761783209,420,4,5,4,6,-1,1,2,6,7,1,-3,1,4,5,5,0,-1,0,1,-1,10,-3,1,7,8,-2,0,0,1,1,0,-1,5,1
KR_6770490814,420,2,30,27,9,3,5,2,5,8,3,1,3,2,3,3,0,-3,1,4,0,15,-36,3,2,5,0,0,0,1,-1,0,-1,2,1
KR_6755780634,420,3,6,8,4,-1,2,3,0,1,1,4,4,0,0,0,0,1,1,0,0,9,-3,-2,4,2,1,0,1,1,1,1,-1,6,1
KR_6760944834,440,0,-8,-16,11,4,5,1,1,3,2,0,1,1,7,10,3,-1,0,1,0,16,13,-2,5,3,6,0,-1,1,-1,-1,1,6,1
KR_6714656418,420,4,-75,24,4,1,1,0,1,3,2,-3,5,8,5,6,1,0,0,0,0,9,0,6,6,12,0,0,1,1,1,1,-1,4,1
KR_6760462161,420,-1,40,-33,0,5,5,0,-7,2,9,0,0,0,3,3,0,-1,0,1,0,-8,23,4,3,7,-4,0,0,1,-1,0,1,3,1
KR_6732294236,420,4,77,12,-4,1,2,1,-4,0,4,-1,1,2,0,1,1,0,0,0,-1,-9,92,-5,11,6,5,0,1,1,1,1,-1,6,1
KR_6769851753,440,2,-3,4,-1,-2,0,2,7,7,0,1,2,1,-2,0,2,-5,2,7,0,-3,24,4,5,9,4,0,1,-1,1,1,-1,2,1
KR_6742916069,420,1,-32,-9,1,0,2,2,3,5,2,-1,0,1,0,3,3,-1,3,4,1,8,61,-2,8,6,3,0,-1,1,0,-1,1,5,1
KR_6750328993,420,1,8,-9,6,-2,0,2,-3,3,6,5,5,0,6,8,2,0,0,0,0,10,-3,-1,5,4,2,0,-1,-1,1,-1,-1,1,1
KR_6714213897,420,2,52,-7,7,6,8,2,2,4,2,2,2,0,-4,0,4,1,1,0,0,0,-25,2,2,4,2,0,2,1,1,1,-1,6,1
KR_6670885302,420,2,5,28,5,1,2,1,1,2,1,-3,5,8,2,3,1,4,5,1,0,14,158,0,3,3,2,0,1,1,1,1,1,1,1
KR_6765972269,440,0,38,4,2,1,3,2,3,4,1,-3,1,4,0,3,3,1,1,0,0,7,-70,-1,6,5,3,0,0,1,1,0,1,5,1
KR_6616456818,420,3,62,-16,10,3,4,1,3,5,2,0,1,1,4,6,2,0,1,1,1,12,8,4,4,8,0,0,0,1,-1,0,1,3,1
KR_6769786864,420,-3,34,-41,-5,-2,0,2,-2,0,2,1,1,0,-1,0,1,-1,1,2,0,-4,9,4,4,8,0,0,0,1,-1,1,-1,1,1
KR_6732505439,420,0,-28,-2,-1,-6,2,8,3,6,3,2,3,1,4,6,2,-4,0,4,0,9,1,-3,5,2,-2,0,-1,-1,-1,-1,-1,4,1
KR_6758308295,440,-1,-18,36,-1,-1,1,2,-1,3,4,2,4,2,4,4,0,-5,0,5,-1,-10,-144,-1,3,2,-7,0,0,1,-1,0,-1,1,1
KR_6748784382,420,2,22,0,4,0,4,4,1,4,3,-2,0,2,5,6,1,0,1,1,0,4,2,-1,6,5,0,0,1,1,-1,1,1,4,1
KR_6769409334,440,-2,-36,-14,2,1,3,2,1,6,5,-1,4,5,-2,2,4,3,3,0,0,5,-2,3,1,4,-1,0,-1,0,1,-1,-1,0,1
KR_6763648150,420,1,4,27,4,0,1,1,3,3,0,-1,0,1,2,3,1,0,0,0,0,7,0,1,5,6,3,0,0,1,1,0,1,2,1
KR_6739832771,420,1,9,-14,12,1,5,4,0,5,5,6,6,0,6,7,1,-1,0,1,0,16,-83,-6,12,6,22,0,0,1,1,-1,1,2,1
KR_6769185046,420,0,17,23,0,1,1,0,-2,4,6,-2,1,3,1,5,4,2,2,0,0,-6,7,8,3,11,-6,0,1,1,1,1,1,6,1
KR_6770467031,420,3,60,1,7,5,6,1,1,5,4,-4,0,4,1,2,1,4,5,1,0,-1,7,6,4,10,-5,0,2,1,1,1,1,3,1
KR_6769038154,440,0,-53,10,3,-1,0,1,4,6,2,1,4,3,-2,3,5,1,1,0,0,12,31,3,6,9,-21,0,0,1,1,0,1,5,1
KR_6750155082,420,7,68,18,17,6,7,1,5,5,0,2,2,0,3,3,0,1,2,1,1,13,81,2,3,5,-14,0,3,1,1,1,1,3,1
KR_6756474031,440,-2,33,-22,-11,1,2,1,-5,3,8,-1,2,3,-6,6,12,0,0,0,-3,-13,9,0,7,7,3,0,-1,-1,-1,-1,-1,3,1
KR_6767204486,420,3,-1,-4,8,-1,2,3,-2,1,3,2,6,4,8,10,2,1,2,1,0,0,0,-2,6,4,-3,0,1,1,1,1,1,5,1
KR_6768308209,420,0,99,40,2,-2,1,3,-3,1,4,6,9,3,2,2,0,-1,2,3,0,5,41,5,0,5,-24,0,0,1,1,1,1,1,1
KR_6750221770,420,3,48,-8,5,1,2,1,1,3,2,2,3,1,-1,2,3,2,3,1,0,9,5,5,6,11,5,0,-1,1,-1,-1,-1,5,1
KR_6709573880,420,1,-37,39,-1,-3,0,3,-4,3,7,5,5,0,1,1,0,0,3,3,0,3,5,0,5,5,3,0,0,0,1,0,-1,0,1
KR_6767570456,420,1,-1,11,1,3,4,1,3,4,1,-3,1,4,0,2,2,-2,0,2,-1,-1,4,1,6,7,-1,0,1,-1,1,1,-1,2,1
KR_6763323582,420,6,25,6,14,0,2,2,9,9,0,1,2,1,3,6,3,1,2,1,1,17,-4,-2,9,7,1,0,0,0,1,1,1,0,1
KR_6744437398,420,3,28,-7,8,4,4,0,3,4,1,1,3,2,0,4,4,0,1,1,0,7,-5,-6,10,4,4,0,1,1,1,1,1,6,1
KR_6688608411,420,5,60,30,6,7,8,1,-1,2,3,0,3,3,0,0,0,0,0,0,0,-1,126,4,3,7,-3,0,3,1,1,1,1,6,1
KR_6667702260,420,3,9,-11,8,-1,1,2,1,2,1,8,10,2,-1,5,6,1,1,0,0,19,12,6,3,9,-2,0,1,1,-1,1,1,6,1
KR_6719388335,440,6,120,-4,13,0,1,1,4,5,1,4,4,0,6,7,1,-1,0,1,0,20,-90,1,6,7,3,0,0,-1,1,1,1,2,1
KR_6747020874,420,12,102,54,-1,2,2,0,1,3,2,4,5,1,-7,3,10,-1,0,1,-1,-4,7,3,3,6,0,0,3,1,1,1,-1,1,1
KR_6765973814,440,3,108,14,7,0,2,2,4,5,1,0,2,2,1,1,0,2,2,0,0,8,0,-2,6,4,0,0,2,-1,1,1,-1,6,1
KR_6760504198,420,0,-3,26,1,6,6,0,-4,1,5,-2,1,3,1,3,2,0,2,2,0,-10,2,-4,9,5,-3,0,1,1,-1,1,-1,2,1
KR_6696658590,420,3,-31,6,7,-1,1,2,5,6,1,-1,2,3,3,5,2,1,3,2,0,9,11,4,6,10,6,0,1,1,-1,1,1,4,1
KR_6759848120,420,5,96,17,14,4,5,1,1,3,2,2,3,1,3,4,1,4,4,0,0,10,11,-3,10,7,1,0,2,1,-1,1,1,4,1
KR_6763608071,420,-2,-25,19,0,-2,2,4,0,1,1,-1,1,2,2,4,2,1,1,0,1,4,21,3,3,6,1,0,0,-1,-1,0,1,4,1
KR_6698919974,420,1,-33,-8,6,-1,2,3,5,7,2,1,3,2,2,2,0,-1,0,1,0,17,-37,2,2,4,7,0,-2,1,1,-1,-1,3,1
KR_6736006038,420,-1,-6,-8,-4,-2,0,2,2,4,2,-3,0,3,2,3,1,-3,0,3,0,-1,-6,2,5,7,3,0,-1,-1,-1,-1,-1,2,1
KR_6744985957,420,2,39,4,2,3,3,0,1,2,1,1,3,2,0,2,2,-3,2,5,1,3,27,-1,8,7,0,0,-1,1,-1,-1,1,5,1
KR_6678258072,440,-3,-40,-16,4,6,6,0,0,0,0,-3,1,4,-2,0,2,3,3,0,0,-1,-5,0,2,2,-1,0,1,1,1,1,1,6,1
KR_6765445058,420,1,-59,23,3,0,1,1,-5,1,6,3,6,3,3,3,0,2,3,1,0,2,-4,2,6,8,5,0,0,1,1,-1,-1,3,1
KR_6633989994,420,5,11,27,8,5,5,0,3,3,0,1,1,0,0,2,2,-1,0,1,0,6,6,-1,7,6,2,0,0,1,1,0,1,6,1
KR_6761933429,420,6,82,-23,9,1,2,1,4,8,4,4,4,0,-1,3,4,1,2,1,1,10,9,1,5,6,0,0,1,-1,-1,1,1,1,1
