matchId,queueId,Diff_LV,Diff_CS,Diff_jglCS,Diff-K,Diff-K-top,K-WIN-top,K-LOSE-top,Diff-K-jug,K-WIN-jug,K-LOSE-jug,Diff-K-mid,K-WIN-mid,K-LOSE-mid,Diff-K-ad,K-WIN-ad,K-LOSE-ad,Diff-K-sup,K-WIN-sup,K-LOSE-sup,invadeKill,Diff-A,Diff_WARDplaced,Diff-ControlWARDplaced,LOSE_controlWARDPlaced,WIN_controlWARDPlaced,Diff_WARDkill,Diff_Inhibitor,Diff_TOWERkill,Diff_FirstDRAGON,Diff_FirstHERALD,Diff_Firsttower,Diff_FirstBLOOD,dragonType,result
KR_6728675184,420,-3,-12,-10,-10,1,3,2,-3,4,7,1,2,1,-6,1,7,-3,0,3,0,-21,-4,0,7,7,-7,0,-1,-1,1,1,-1,4,1
KR_6755780484,440,4,81,28,9,1,1,0,4,4,0,0,1,1,4,6,2,0,1,1,0,9,14,6,1,7,0,0,3,-1,-1,1,-1,6,1
KR_6768062927,440,-3,24,-23,-4,5,5,0,0,4,4,-2,1,3,-6,2,8,-1,1,2,0,-6,-12,1,3,4,0,0,-2,0,-1,-1,1,0,1
KR_6759156095,420,1,67,12,5,2,3,1,7,7,0,-5,1,6,1,1,0,0,0,0,0,8,-6,-2,6,4,9,0,-1,-1,1,-1,-1,5,1
KR_6605744824,440,1,-12,-28,8,10,10,0,2,3,1,4,6,2,-7,1,8,-1,2,3,0,3,-118,2,2,4,-4,0,-1,-1,-1,-1,-1,3,1
KR_6576144646,420,1,38,-1,0,-1,1,2,0,3,3,0,1,1,1,2,1,0,0,0,-2,-11,11,6,5,11,-5,0,-1,-1,-1,-1,-1,6,1
KR_6740473921,440,-4,-50,-25,-5,-3,1,4,-1,1,2,-2,2,4,1,2,1,0,1,1,0,-9,-353,-1,5,4,2,0,-1,-1,-1,-1,-1,5,1
KR_6764071941,420,2,16,-12,6,0,1,1,6,10,4,0,0,0,-1,2,3,1,2,1,0,3,-21,-3,6,3,28,0,0,1,-1,-1,-1,4,1
KR_6725945643,420,2,97,16,-1,4,5,1,0,0,0,-1,2,3,-3,1,4,-1,0,1,0,-10,-21,-2,7,5,7,0,2,-1,1,1,1,5,1
KR_6728143061,420,6,95,53,3,1,1,0,1,1,0,0,0,0,-4,1,5,5,9,4,1,-3,6,-1,4,3,0,0,2,1,1,1,1,3,1
KR_6719767809,420,2,-10,12,2,1,1,0,2,8,6,-1,0,1,1,3,2,-1,0,1,0,0,29,6,3,9,-9,0,1,-1,1,1,1,1,1
KR_6759340949,440,0,-28,-8,4,2,3,1,0,3,3,0,1,1,1,2,1,1,4,3,-1,1,-8,1,5,6,25,0,1,1,1,1,-1,5,1
KR_6675545238,440,0,-24,15,3,-5,0,5,7,9,2,-4,0,4,2,3,1,3,3,0,-1,4,-1,0,3,3,1,0,1,-1,-1,1,-1,6,1
KR_6765075193,420,1,-47,4,6,3,6,3,5,5,0,3,4,1,-5,0,5,0,1,1,0,4,11,2,6,8,0,0,-1,-1,1,-1,1,5,1
KR_6744658636,420,1,-25,-34,7,0,1,1,3,6,3,0,1,1,3,4,1,1,1,0,0,10,6,6,5,11,4,0,0,0,1,0,1,0,1
KR_6769430382,440,-1,-17,0,1,1,2,1,2,4,2,7,10,3,-5,4,9,-4,0,4,-1,-5,3,4,2,6,-4,0,0,1,1,1,-1,3,1
KR_6721673281,420,2,-27,61,1,-2,2,4,1,3,2,1,1,0,2,3,1,-1,0,1,-1,4,31,-6,10,4,7,0,-1,-1,1,-1,-1,3,1
KR_6768389845,420,3,-12,4,7,2,3,1,-4,2,6,3,3,0,5,7,2,1,1,0,0,7,15,2,4,6,7,0,-2,1,-1,-1,1,3,1
KR_6636063987,420,0,66,8,8,1,1,0,3,7,4,3,5,2,-1,3,4,2,2,0,2,6,-7,1,5,6,3,0,1,1,1,1,1,3,1
KR_6503822193,420,1,16,9,2,4,5,1,-1,1,2,0,2,2,-1,2,3,0,0,0,0,1,10,-3,6,3,0,0,1,0,1,1,-1,0,1
KR_6771276043,420,5,44,-7,12,-2,0,2,7,9,2,4,5,1,2,5,3,1,2,1,0,18,7,3,2,5,-2,0,1,1,-1,-1,1,1,1
KR_6751004132,440,3,-8,-4,-1,3,3,0,-2,0,2,2,2,0,-1,1,2,-3,0,3,-1,-10,4,-3,5,2,1,0,1,-1,1,1,-1,2,1
KR_6736891949,420,0,21,1,-3,-1,2,3,-4,3,7,0,0,0,1,6,5,1,1,0,0,-6,0,-1,5,4,2,0,1,-1,1,1,1,4,1
KR_6649036211,420,-1,-34,-2,2,-1,1,2,3,6,3,2,3,1,-2,1,3,0,0,0,0,0,0,1,5,6,-1,0,-1,1,1,-1,1,6,1
KR_6715647555,440,-5,-41,-30,-9,-3,0,3,-4,0,4,-2,1,3,-1,3,4,1,1,0,0,-9,-9,-2,5,3,4,0,-1,-1,-1,1,1,1,1
KR_6742525604,420,1,80,0,5,3,3,0,1,5,4,1,4,3,0,4,4,0,1,1,0,5,-1,1,4,5,2,0,0,1,1,1,1,3,1
KR_6771864459,420,3,-11,28,5,-4,1,5,1,4,3,6,7,1,0,2,2,2,2,0,1,6,-81,-1,4,3,1,0,2,1,1,1,1,1,1
KR_6740460059,440,2,65,-7,7,-2,1,3,5,6,1,5,8,3,0,1,1,-1,0,1,0,12,144,-2,4,2,2,0,1,1,1,1,1,1,1
KR_6702855471,440,3,13,-8,5,2,4,2,2,3,1,1,2,1,-1,0,1,1,1,0,0,5,-1,-4,5,1,-1,0,0,-1,-1,0,1,5,1
KR_6666728566,420,-2,-18,8,-1,-2,0,2,1,6,5,-1,0,1,0,3,3,1,2,1,0,2,-4,6,1,7,-2,0,0,1,1,0,-1,6,1
KR_6668689251,420,5,72,-7,6,2,2,0,5,9,4,-1,1,2,0,1,1,0,0,0,0,3,172,0,5,5,-1,0,3,-1,1,1,1,6,1
KR_6672552192,420,4,22,4,13,1,2,1,4,4,0,6,6,0,0,0,0,2,2,0,0,11,-2,-2,6,4,2,0,1,1,1,1,1,1,1
KR_6381786789,420,6,97,26,18,1,3,2,8,9,1,0,3,3,8,9,1,1,2,1,1,20,68,7,1,8,-20,0,1,1,1,1,1,3,1
KR_6724904126,420,0,-41,-6,-1,-1,1,2,-1,1,2,-1,1,2,1,2,1,1,3,2,0,1,-40,1,1,2,19,0,1,1,1,1,-1,1,1
KR_6614612671,420,3,28,13,12,8,9,1,0,2,2,4,6,2,0,2,2,0,0,0,0,10,-23,-2,6,4,3,0,1,1,-1,1,1,1,1
KR_6770113402,420,-2,60,-7,-6,0,1,1,-2,2,4,-2,1,3,-1,0,1,-1,0,1,0,-7,-4,-4,7,3,0,0,0,-1,1,0,-1,3,1
KR_6573769962,420,0,20,-28,4,3,3,0,-3,3,6,5,5,0,-1,0,1,0,2,2,0,3,5,1,5,6,2,0,1,1,1,1,1,6,1
KR_6770491741,420,-1,-5,8,-4,1,1,0,-1,1,2,-2,1,3,0,1,1,-2,0,2,-1,-6,-111,0,5,5,-5,0,0,-1,-1,-1,-1,1,1
KR_6744866235,420,0,-92,1,2,-1,1,2,1,4,3,4,4,0,0,4,4,-2,0,2,-1,3,26,0,7,7,19,0,-1,1,1,-1,-1,6,1
KR_6737890064,420,2,55,33,0,1,2,1,3,3,0,-7,3,10,1,3,2,2,2,0,0,-8,12,3,2,5,-1,0,1,1,0,1,1,2,1
KR_6769179822,420,-2,1,8,-3,1,2,1,3,5,2,-4,1,5,0,4,4,-3,1,4,0,3,-3,5,5,10,1,0,1,1,1,1,1,5,1
KR_6325662463,420,1,-70,26,2,0,2,2,1,2,1,2,4,2,0,2,2,-1,2,3,0,0,10,3,5,8,4,0,-1,0,1,1,1,0,1
KR_6709991703,440,6,90,22,18,4,6,2,7,7,0,-4,2,6,2,2,0,9,11,2,0,28,9,3,4,7,0,0,2,1,1,1,1,6,1
KR_6768896801,420,2,16,-16,5,5,5,0,0,1,1,-2,1,3,0,1,1,2,2,0,0,3,12,3,3,6,1,0,1,1,1,1,1,4,1
KR_6757001319,440,2,2,-4,6,3,4,1,0,2,2,-1,1,2,3,5,2,1,3,2,0,4,-4,0,2,2,3,0,-1,1,-1,-1,1,3,1
KR_6753898772,420,1,-32,-56,12,6,6,0,1,4,3,1,2,1,4,4,0,0,0,0,2,16,-5,1,3,4,2,0,0,1,-1,0,1,3,1
KR_6729873877,420,2,47,-6,2,-1,0,1,3,4,1,-2,2,4,-2,1,3,4,6,2,0,4,2,2,4,6,4,0,0,-1,1,1,1,1,1
KR_6705342229,420,2,26,-16,3,0,4,4,-3,1,4,1,2,1,5,6,1,0,0,0,0,3,2,0,3,3,-2,0,0,-1,-1,0,1,5,1
KR_6758218442,420,-1,-14,8,-4,1,2,1,-2,0,2,-5,2,7,0,3,3,2,2,0,0,-7,-59,-2,4,2,2,0,1,1,-1,1,1,3,1
KR_6557906272,420,4,6,0,19,3,3,0,3,6,3,4,5,1,5,6,1,4,5,1,-1,19,25,-2,5,3,1,0,0,1,1,1,-1,1,1
KR_6724896542,420,3,99,-2,5,1,1,0,2,5,3,-2,3,5,5,8,3,-1,1,2,1,6,-15,-5,10,5,7,0,1,1,-1,1,1,6,1
KR_6732570432,420,4,45,7,7,2,2,0,1,4,3,6,6,0,0,2,2,-2,0,2,-1,1,-144,3,1,4,-1,0,0,-1,1,1,-1,5,1
KR_6727610383,420,-2,-46,-28,-1,-1,1,2,3,4,1,1,7,6,-1,4,5,-3,2,5,-2,0,1,-2,5,3,-3,0,-1,-1,-1,-1,-1,3,1
KR_6575611528,420,1,47,11,3,3,4,1,1,2,1,1,1,0,-2,2,4,0,0,0,0,-3,-4,4,5,9,5,0,1,0,-1,1,1,0,1
KR_6768041063,440,1,-33,8,2,1,3,2,1,2,1,-3,1,4,2,5,3,1,2,1,0,1,46,2,5,7,-6,0,-1,1,-1,-1,1,1,1
KR_6751547772,420,-4,-35,16,-7,-2,3,5,-3,0,3,-2,1,3,3,7,4,-3,3,6,-1,-7,-11,1,4,5,5,0,-1,0,1,-1,1,0,1
KR_6762575882,420,0,34,7,5,4,5,1,2,2,0,2,4,2,-5,1,6,2,2,0,1,2,7,3,3,6,-3,0,0,1,-1,1,1,1,1
KR_6679352526,420,1,3,-5,-1,-1,4,5,-4,0,4,0,2,2,5,7,2,-1,1,2,0,-4,-16,2,4,6,0,0,1,-1,1,1,1,6,1
KR_6768149697,420,-4,-70,-25,-1,2,3,1,0,2,2,0,3,3,-1,0,1,-2,1,3,1,3,60,-10,13,3,0,0,1,1,1,1,1,2,1
KR_6762634495,420,3,20,-4,6,0,1,1,-2,3,5,2,3,1,6,6,0,0,0,0,1,8,-7,-2,8,6,7,0,1,-1,0,1,1,5,1
KR_6673590166,440,4,62,32,8,2,2,0,2,7,5,-1,0,1,3,7,4,2,2,0,0,-4,-18,2,3,5,2,0,1,1,1,1,1,6,1
KR_6765610125,420,2,74,28,14,6,9,3,3,6,3,1,3,2,5,5,0,-1,3,4,2,5,7,5,3,8,2,0,1,1,1,1,-1,4,1
KR_6756987538,440,-2,40,-6,-5,-1,1,2,1,4,3,-1,1,2,-3,4,7,-1,1,2,1,-10,-3,1,3,4,2,0,0,-1,1,0,1,5,1
KR_6704459810,420,1,5,17,7,-2,1,3,-1,3,4,2,3,1,9,9,0,-1,0,1,0,4,13,-3,7,4,0,0,0,1,1,1,1,2,1
KR_6769755621,420,2,60,12,3,1,2,1,5,6,1,1,1,0,0,1,1,-4,1,5,1,4,5,-2,6,4,1,0,2,1,1,1,1,6,1
KR_6747686204,420,7,134,-2,19,1,3,2,4,4,0,5,5,0,11,11,0,-2,0,2,0,13,27,0,3,3,2,0,2,0,1,1,1,0,1
KR_6750951223,420,5,19,11,6,3,3,0,-2,2,4,0,2,2,0,2,2,5,6,1,0,6,7,0,4,4,-1,0,2,1,1,1,-1,3,1
KR_6666696353,420,4,43,6,-2,1,2,1,2,5,3,-3,1,4,0,2,2,-2,0,2,0,-9,-42,-1,6,5,8,0,1,-1,-1,1,-1,1,1
KR_6650785507,420,0,16,-6,-4,1,2,1,0,2,2,-2,2,4,-2,2,4,-1,2,3,0,-1,-9,-5,6,1,2,0,0,-1,1,1,-1,4,1
KR_6703277973,420,-1,-47,-10,-1,2,3,1,5,6,1,-5,1,6,-4,1,5,1,2,1,0,-4,0,-1,4,3,-3,0,1,-1,-1,1,1,6,1
KR_6614520908,420,3,58,3,5,-1,3,4,3,4,1,-2,1,3,5,7,2,0,0,0,0,9,2,2,3,5,2,0,1,1,1,1,1,5,1
KR_6717310616,420,4,41,4,16,4,4,0,7,7,0,-1,1,2,4,7,3,2,2,0,0,16,-10,1,4,5,-2,0,0,-1,1,0,1,2,1
KR_6771785549,420,0,-29,18,2,2,3,1,2,3,1,1,1,0,-1,1,2,-2,2,4,0,2,11,7,3,10,-7,0,0,1,1,-1,1,6,1
KR_6398057722,440,4,69,20,15,5,6,1,-3,0,3,1,2,1,4,4,0,8,8,0,2,11,48,7,2,9,-3,0,4,1,1,1,1,6,1
KR_6726873374,420,3,86,47,6,2,3,1,0,2,2,2,5,3,1,2,1,1,1,0,0,3,-3,0,3,3,5,0,0,-1,1,1,1,4,1
KR_6664421059,440,0,34,-19,1,1,2,1,-5,2,7,5,5,0,0,1,1,0,1,1,0,10,-24,1,7,8,-5,0,0,1,-1,1,-1,1,1
KR_6497675533,420,-4,-61,-8,-6,1,3,2,-3,0,3,-4,3,7,0,1,1,0,0,0,-2,-6,-11,-7,9,2,0,0,0,-1,-1,0,-1,1,1
KR_6767746204,420,2,24,-2,4,1,1,0,3,3,0,-2,0,2,0,1,1,2,2,0,0,0,28,-6,9,3,-18,0,0,-1,1,1,1,6,1
KR_6653205725,420,2,-2,19,5,-2,0,2,5,8,3,3,6,3,-1,1,2,0,0,0,0,2,-22,0,6,6,-1,0,0,-1,1,0,-1,1,1
KR_6768664294,420,-1,-21,-6,3,1,4,3,1,1,0,-1,1,2,2,3,1,0,1,1,0,-2,15,1,3,4,-1,0,0,-1,1,0,1,1,1
KR_6713271843,420,2,30,-4,9,1,1,0,0,3,3,3,4,1,7,7,0,-2,1,3,0,4,-25,4,4,8,0,0,0,0,0,0,1,0,1
KR_6757607688,420,2,88,2,8,-1,1,2,0,3,3,6,6,0,1,1,0,2,2,0,0,13,5,1,4,5,3,0,0,-1,-1,1,-1,5,1
KR_6717541501,420,7,91,44,14,5,5,0,2,4,2,1,3,2,4,5,1,2,2,0,0,9,-144,-1,6,5,-1,0,3,1,1,1,-1,5,1
KR_6767109696,420,1,17,-9,4,0,2,2,4,5,1,2,3,1,-2,0,2,0,1,1,0,2,-6,-4,8,4,4,0,0,-1,-1,0,1,6,1
KR_6613669727,420,6,70,39,12,-1,0,1,2,3,1,5,5,0,6,7,1,0,0,0,0,7,135,4,1,5,2,0,1,1,1,1,-1,1,1
KR_6768025745,420,-1,-23,-8,-2,1,4,3,5,7,2,-6,2,8,-3,0,3,1,2,1,0,1,14,4,2,6,0,0,-1,0,-1,-1,-1,0,1
KR_6761861774,440,1,29,12,-1,-1,1,2,1,2,1,-2,1,3,4,4,0,-3,2,5,0,8,-17,-4,5,1,2,0,-1,1,-1,-1,1,6,1
KR_6717801658,420,-1,-8,-24,-1,0,1,1,-2,0,2,-4,3,7,1,2,1,4,6,2,0,2,-6,-1,7,6,-2,0,0,1,1,0,1,2,1
KR_6728270670,420,0,-19,12,1,-1,2,3,2,4,2,0,2,2,-2,4,6,2,3,1,0,7,22,2,5,7,-2,0,-1,1,-1,-1,-1,5,1
KR_6351412596,420,0,-4,-21,5,0,3,3,-3,2,5,4,6,2,4,7,3,0,0,0,0,7,0,6,3,9,0,0,1,-1,1,1,-1,6,1
KR_6763172569,420,0,30,4,4,4,4,0,3,7,4,-2,0,2,1,1,0,-2,0,2,0,-2,10,3,4,7,6,0,1,1,-1,1,-1,5,1
KR_6750162883,420,1,-3,7,5,2,2,0,-1,2,3,2,4,2,-1,3,4,3,4,1,0,2,203,-10,11,1,4,0,0,1,-1,0,1,6,1
KR_6732860687,420,4,115,35,5,3,3,0,3,3,0,3,5,2,-3,3,6,-1,1,2,0,0,22,4,3,7,3,0,2,-1,1,1,1,5,1
KR_6771899760,420,2,90,13,2,-4,0,4,-2,1,3,1,1,0,5,5,0,2,2,0,0,5,5,2,4,6,0,0,1,1,-1,-1,-1,2,1
KR_6767554989,420,0,-90,-16,7,-1,0,1,0,3,3,4,4,0,3,4,1,1,1,0,0,13,2,-1,5,4,-1,0,1,-1,1,1,-1,3,1
KR_6771877578,440,3,-6,0,5,2,3,1,2,2,0,-3,0,3,1,1,0,3,3,0,0,3,5,0,6,6,0,0,0,1,1,0,-1,1,1
KR_6767950748,440,-1,-55,-56,9,2,3,1,1,8,7,0,1,1,2,2,0,4,5,1,0,8,-37,1,2,3,0,0,0,-1,1,-1,1,5,1
KR_6702244759,420,4,14,27,8,-2,3,5,4,5,1,2,2,0,5,6,1,-1,0,1,3,20,2,2,4,6,2,0,0,1,-1,0,1,4,1
KR_6761644178,440,0,7,-16,-2,-1,0,1,-2,1,3,-1,2,3,2,5,3,0,0,0,0,-4,-182,-4,8,4,-2,0,1,-1,-1,1,1,3,1
KR_6738885976,420,-1,-56,12,-6,-8,0,8,2,3,1,4,6,2,-3,0,3,-1,1,2,1,1,2,-2,6,4,-3,0,-2,-1,0,-1,1,4,1
KR_6671318501,420,1,34,18,-3,-5,0,5,-2,1,3,-4,1,5,8,8,0,0,0,0,0,7,5,6,1,7,0,0,-1,-1,-1,-1,-1,4,1
KR_6768338147,440,4,39,-58,7,0,2,2,-1,1,2,1,3,2,3,6,3,4,5,1,0,1,-20,0,5,5,7,0,0,-1,1,0,-1,2,1
KR_6763332179,420,0,-62,21,3,0,1,1,-2,2,4,4,5,1,1,4,3,0,1,1,0,4,-108,-4,5,1,2,0,0,1,1,0,1,2,1
KR_6769444664,420,1,36,-17,-1,-2,2,4,3,4,1,2,4,2,-2,0,2,-2,1,3,0,1,29,3,6,9,4,0,1,-1,1,1,-1,3,1
KR_6661966923,420,1,11,15,7,0,2,2,1,3,2,-2,1,3,5,5,0,3,3,0,0,9,2,0,8,8,2,0,3,1,1,1,1,4,1
KR_6760618206,440,3,33,16,2,-3,0,3,-2,2,4,5,8,3,1,5,4,1,2,1,0,-3,34,2,4,6,-12,0,2,1,1,1,-1,2,1
KR_6766654157,420,2,-37,19,2,0,2,2,0,3,3,2,4,2,0,6,6,0,1,1,0,8,5,3,3,6,-4,0,-1,0,-1,-1,-1,0,1
KR_6720797267,420,2,39,-37,11,5,5,0,3,5,2,-2,0,2,4,6,2,1,2,1,0,18,12,-1,5,4,5,0,1,1,1,1,1,4,1
KR_6693605106,420,3,3,-12,10,2,3,1,8,9,1,0,2,2,1,1,0,-1,1,2,0,5,4,3,3,6,-2,0,0,0,1,1,1,0,1
KR_6770735340,420,4,42,47,10,0,2,2,5,6,1,2,2,0,2,2,0,1,2,1,0,13,-306,3,3,6,2,0,2,1,1,1,1,6,1
KR_6771933625,420,-2,-22,0,5,3,4,1,-2,1,3,0,2,2,0,3,3,4,4,0,1,4,-32,6,3,9,2,0,0,1,1,-1,1,3,1
KR_6762293722,420,0,24,-8,1,-2,2,4,7,8,1,0,3,3,-1,2,3,-3,1,4,0,7,-125,8,1,9,-7,0,0,1,1,0,-1,2,1
KR_6688535614,420,4,17,51,10,1,2,1,1,3,2,5,6,1,1,3,2,2,4,2,0,7,6,3,4,7,0,0,0,0,0,0,1,0,1
KR_6653303112,420,1,46,-12,0,-3,0,3,-1,1,2,1,1,0,3,6,3,0,0,0,0,0,142,-2,5,3,4,0,0,1,-1,-1,-1,5,1
KR_6706207434,420,1,-5,-4,2,-1,0,1,-2,4,6,3,4,1,0,0,0,2,3,1,0,9,-113,-2,4,2,0,0,0,1,1,1,1,2,1
KR_6602343859,420,1,17,14,7,0,3,3,4,4,0,2,3,1,6,7,1,-5,0,5,0,9,1,6,4,10,4,0,0,1,-1,0,1,6,1
KR_6768670974,420,0,-2,-7,2,1,2,1,2,2,0,3,4,1,-5,0,5,1,1,0,0,-1,-4,0,6,6,6,0,1,1,1,1,-1,6,1
KR_6594924760,420,-2,-112,-4,0,-1,3,4,-2,1,3,2,3,1,1,3,2,0,2,2,0,1,7,2,2,4,-5,0,0,-1,1,-1,1,1,1
KR_6395696053,420,2,-12,10,1,-1,0,1,9,9,0,-1,0,1,-4,1,5,-2,0,2,0,-4,-2,-1,5,4,0,0,0,1,1,0,1,3,1
KR_6768404051,420,0,-14,-13,6,1,1,0,2,2,0,1,1,0,4,5,1,-2,0,2,0,10,-3,0,5,5,3,0,1,-1,1,1,1,6,1
KR_6763022500,420,3,53,18,10,3,5,2,-2,0,2,0,2,2,6,7,1,3,3,0,4,14,7,4,2,6,1,0,2,1,-1,1,1,3,1
KR_6723559629,420,2,-22,-12,10,0,2,2,0,5,5,3,3,0,5,6,1,2,2,0,0,5,-35,-1,4,3,-1,0,0,-1,1,0,1,6,1
KR_6657401876,420,2,10,-9,-4,0,2,2,1,2,1,-2,1,3,-1,5,6,-2,0,2,0,0,-29,-7,8,1,3,0,0,-1,-1,0,1,6,1
KR_6722744156,420,4,6,58,8,1,2,1,1,4,3,11,12,1,-5,2,7,0,1,1,3,14,5,3,2,5,1,0,0,1,1,0,1,3,1
KR_6623442657,440,-2,3,-33,-3,-5,1,6,1,4,3,1,1,0,3,5,2,-3,2,5,-2,0,203,1,3,4,-2,0,1,1,1,1,-1,3,1
KR_6755321183,420,8,44,-4,9,3,3,0,-1,4,5,-1,1,2,8,12,4,0,0,0,0,8,-22,-5,9,4,9,0,3,1,1,1,1,1,1
KR_6771908755,420,1,-37,12,7,0,2,2,2,5,3,4,5,1,1,1,0,0,0,0,0,2,6,4,2,6,5,0,1,1,1,1,1,6,1
KR_6563219900,420,2,41,-29,1,5,5,0,-4,2,6,2,2,0,3,7,4,-5,0,5,0,-3,-33,0,6,6,4,0,0,1,0,0,-1,2,1
KR_6743117788,440,2,73,8,4,2,3,1,-1,3,4,1,3,2,0,5,5,2,2,0,0,5,10,5,4,9,-3,0,1,1,1,1,1,1,1
KR_6658097361,420,2,28,-14,4,0,3,3,-2,3,5,-1,2,3,8,8,0,-1,1,2,0,0,-237,0,5,5,18,0,0,-1,-1,0,1,5,1
KR_6737249056,420,9,94,43,15,3,3,0,4,5,1,-2,0,2,10,10,0,0,0,0,0,12,-18,4,5,9,-1,0,3,1,-1,1,1,6,1
KR_6700720657,420,0,29,-16,1,2,5,3,-2,1,3,0,2,2,1,2,1,0,0,0,0,1,-112,3,3,6,-4,0,2,-1,1,1,1,1,1
KR_6690117003,420,6,92,42,13,4,5,1,-1,2,3,3,3,0,5,8,3,2,2,0,0,15,2,5,4,9,3,0,2,1,-1,1,1,2,1
KR_6759913509,420,-2,-9,2,0,1,2,1,0,2,2,5,6,1,-2,1,3,-4,1,5,0,-7,-64,5,2,7,14,0,-1,1,0,-1,1,3,1
KR_6740670486,420,-2,33,-15,-2,3,7,4,1,1,0,-2,0,2,-1,1,2,-3,0,3,0,-5,-3,-1,5,4,0,0,0,-1,-1,0,1,2,1
KR_6756772756,440,4,11,28,3,1,1,0,-1,2,3,0,1,1,1,1,0,2,3,1,0,1,215,1,3,4,-2,0,2,1,1,1,1,5,1
KR_6755206636,420,2,29,16,4,5,6,1,0,3,3,-1,1,2,2,3,1,-2,1,3,0,0,-17,0,4,4,0,0,2,1,-1,1,1,2,1
KR_6738280352,420,-1,32,14,3,2,3,1,3,6,3,0,3,3,-1,2,3,-1,0,1,0,3,-2,0,5,5,-4,0,-2,1,-1,-1,-1,4,1
KR_6744588010,420,1,-77,50,2,0,1,1,2,5,3,1,2,1,0,3,3,-1,3,4,0,-1,-7,-2,5,3,3,0,0,1,1,-1,-1,4,1
KR_6721022585,420,6,23,4,9,7,7,0,-6,0,6,1,2,1,7,8,1,0,0,0,1,1,5,1,5,6,-2,0,0,1,1,1,1,1,1
KR_6738766377,440,3,46,-16,4,-1,0,1,-2,2,4,1,3,2,6,6,0,0,0,0,0,10,206,1,6,7,3,0,2,1,-1,1,-1,5,1
KR_6742570160,420,6,75,4,13,-3,2,5,7,8,1,6,7,1,3,4,1,0,1,1,0,17,2,1,4,5,3,0,2,1,1,1,1,5,1
KR_6742756445,420,-2,9,4,0,1,1,0,-2,3,5,0,2,2,1,2,1,0,0,0,0,-8,18,0,5,5,1,0,0,1,1,0,-1,3,1
KR_6694132487,420,-2,14,-30,-2,1,3,2,-3,3,6,-2,1,3,2,3,1,0,0,0,0,1,-34,3,4,7,0,0,0,1,-1,0,1,6,1
KR_6735754824,420,4,17,36,11,2,4,2,5,5,0,1,2,1,2,2,0,1,1,0,0,9,147,2,4,6,1,0,1,1,1,1,1,3,1
KR_6767355625,420,-1,-51,26,-3,0,1,1,-2,2,4,6,6,0,0,4,4,-7,4,11,0,-8,-8,0,5,5,2,0,0,-1,-1,0,1,1,1
KR_6670527452,420,0,8,1,0,3,4,1,2,3,1,3,3,0,-7,1,8,-1,0,1,0,-8,-2,-2,7,5,1,0,-2,-1,1,-1,-1,1,1
KR_6731847101,420,5,68,17,19,1,3,2,1,3,2,3,4,1,15,15,0,-1,1,2,2,26,-10,3,3,6,-2,0,2,1,1,1,-1,2,1
KR_6765750532,420,7,91,33,13,6,7,1,2,5,3,2,2,0,3,5,2,0,0,0,0,6,10,3,5,8,5,0,2,1,-1,1,1,4,1
KR_6657427818,420,2,71,-13,2,-3,0,3,0,1,1,5,5,0,0,0,0,0,1,1,-1,9,-3,-4,4,0,3,0,1,1,1,1,-1,5,1
KR_6398477622,420,3,-29,-4,-3,-3,1,4,1,8,7,2,3,1,-1,3,4,-2,1,3,0,2,-6,-2,3,1,4,0,1,1,-1,1,1,3,1
KR_6744010347,420,0,42,-11,3,-4,1,5,4,4,0,6,6,0,-1,2,3,-2,0,2,0,6,-11,-2,6,4,7,0,0,1,-1,0,-1,3,1
KR_6729647381,420,-2,-30,13,-2,-1,1,2,-2,0,2,4,9,5,-3,1,4,0,1,1,-1,-6,4,-1,6,5,-6,0,0,1,-1,0,-1,3,1
KR_6762708158,420,2,-26,-8,3,-2,0,2,0,3,3,-2,4,6,5,6,1,2,2,0,0,13,7,-7,9,2,5,0,1,1,-1,1,-1,5,1
KR_6757136410,420,4,37,32,10,5,6,1,-2,1,3,2,5,3,3,5,2,2,2,0,0,1,18,1,4,5,2,0,0,0,1,1,-1,0,1
KR_6752769047,420,4,79,-1,15,4,7,3,5,5,0,6,6,0,1,2,1,-1,1,2,0,12,-27,6,3,9,3,0,1,1,0,1,-1,2,1
KR_6738519273,420,-1,-23,4,-2,5,5,0,-1,1,2,0,1,1,-4,1,5,-2,1,3,1,-2,-10,1,4,5,8,0,1,-1,-1,1,1,1,1
KR_6770803411,420,2,63,9,9,-1,2,3,0,1,1,7,7,0,1,1,0,2,2,0,0,13,58,2,4,6,-2,0,2,-1,-1,1,1,1,1
KR_6647818600,420,1,45,-46,9,3,3,0,4,6,2,-1,3,4,1,3,2,2,3,1,1,24,-10,7,3,10,-2,0,4,-1,1,1,1,1,1
KR_6617841112,420,2,92,9,7,2,4,2,6,10,4,-2,0,2,2,2,0,-1,1,2,0,5,-29,3,6,9,5,0,3,1,-1,1,1,1,1
KR_6771784436,420,-1,-62,17,2,0,1,1,5,6,1,-1,1,2,-2,4,6,0,1,1,0,2,-20,-10,12,2,0,0,0,1,-1,-1,1,4,1
KR_6761729121,420,6,96,21,8,3,5,2,2,3,1,-2,4,6,3,4,1,2,3,1,0,2,15,0,6,6,2,0,0,1,-1,-1,1,3,1
KR_6690488512,420,4,41,43,8,-1,4,5,5,5,0,0,2,2,5,7,2,-1,1,2,0,14,5,5,3,8,5,0,-1,1,-1,-1,1,2,1
KR_6767975151,420,1,-20,-24,6,2,2,0,-1,3,4,3,3,0,1,3,2,1,2,1,0,4,-40,3,2,5,25,0,1,1,1,1,1,3,1
KR_6703660275,420,4,-21,35,7,0,1,1,5,7,2,4,4,0,-3,3,6,1,1,0,0,10,5,-3,5,2,0,0,0,1,0,0,1,2,1
KR_6723536833,420,3,66,15,6,-1,0,1,6,7,1,0,0,0,2,3,1,-1,0,1,1,17,181,2,7,9,3,0,2,0,1,1,1,0,1
KR_6578937510,420,3,-30,23,6,-1,0,1,-1,2,3,1,2,1,7,8,1,0,2,2,0,5,-51,-2,9,7,29,0,0,1,-1,0,1,2,1
KR_6764611548,420,2,-22,20,-1,0,0,0,-3,1,4,-3,3,6,4,7,3,1,1,0,0,-6,196,-1,8,7,0,0,0,1,1,1,1,2,1
KR_6703148288,420,0,46,-12,-1,-1,2,3,0,2,2,-2,2,4,2,3,1,0,0,0,-1,-1,-1,0,4,4,2,0,-2,1,-1,-1,-1,5,1
KR_6761931571,420,-1,-8,-7,4,-1,4,5,-5,3,8,8,9,1,0,3,3,2,2,0,0,2,1,0,4,4,2,0,-1,-1,1,-1,1,2,1
KR_6727779668,420,2,0,37,1,-4,1,5,3,4,1,4,5,1,-3,1,4,1,3,2,0,2,4,-4,6,2,2,0,0,1,-1,0,1,1,1
KR_6729692621,420,8,76,53,10,4,5,1,0,1,1,1,1,0,1,1,0,4,6,2,0,11,9,6,0,6,0,0,3,1,1,1,1,6,1
KR_6693933064,420,3,44,16,1,0,3,3,-2,0,2,-2,1,3,5,8,3,0,1,1,0,-4,-5,-4,5,1,3,0,1,1,0,1,1,3,1
KR_6770275881,440,1,7,17,7,0,0,0,1,1,0,0,1,1,5,6,1,1,2,1,0,8,2,1,5,6,-7,0,0,1,1,0,1,3,1
KR_6768120858,420,3,82,-39,7,3,3,0,4,5,1,0,3,3,-1,3,4,1,1,0,0,7,5,-4,5,1,1,0,0,1,0,1,1,5,1
KR_6751468986,420,2,8,0,4,0,1,1,4,6,2,5,6,1,0,2,2,-5,0,5,0,1,0,1,3,4,-3,0,0,1,-1,0,-1,2,1
KR_6760760485,420,3,24,-5,6,0,2,2,6,6,0,0,0,0,1,2,1,-1,0,1,0,6,5,2,5,7,4,0,0,1,0,0,1,2,1
KR_6688348737,420,3,53,-16,9,2,3,1,2,2,0,3,5,2,1,1,0,1,1,0,0,1,5,1,4,5,2,0,1,1,1,1,1,1,1
KR_6496653756,420,-1,-7,7,-1,1,2,1,-1,5,6,-1,2,3,1,3,2,-1,0,1,0,-6,0,3,4,7,1,0,1,1,-1,-1,-1,6,1
KR_6756090914,420,3,15,13,0,-4,0,4,3,3,0,3,4,1,-3,1,4,1,1,0,0,-1,7,-1,7,6,5,0,-1,-1,1,-1,1,3,1
KR_6622223445,420,2,58,26,6,3,5,2,4,5,1,0,3,3,-1,3,4,0,0,0,0,2,-50,-3,5,2,14,0,0,1,1,1,1,1,1
KR_6738808639,420,5,-4,13,11,5,5,0,4,6,2,0,2,2,2,4,2,0,2,2,0,5,3,0,5,5,0,0,0,-1,-1,1,-1,6,1
KR_6759606313,440,3,52,15,5,-6,1,7,4,6,2,3,3,0,3,4,1,1,2,1,0,11,-3,1,4,5,3,0,3,1,1,1,1,5,1
KR_6654937542,420,3,36,28,1,-1,2,3,1,2,1,-4,2,6,3,6,3,2,3,1,1,0,10,1,1,2,-1,0,1,-1,1,1,1,3,1
KR_6595018829,420,3,35,-8,11,0,3,3,8,9,1,5,6,1,-4,0,4,2,2,0,0,17,8,6,3,9,-4,0,1,0,1,1,-1,0,1
KR_6765487925,420,3,127,-16,4,2,2,0,-1,1,2,3,5,2,1,1,0,-1,2,3,0,1,37,1,4,5,-23,0,0,1,-1,1,1,5,1
KR_6438600628,420,-4,-82,-32,-6,-3,1,4,0,5,5,0,3,3,-2,1,3,-1,0,1,0,1,-12,-5,10,5,1,0,-3,-1,-1,-1,1,2,1
KR_6759037585,420,-2,-39,38,1,-1,1,2,-3,3,6,-1,1,2,4,5,1,2,2,0,0,0,9,-3,5,2,-1,0,1,1,1,1,1,4,1
KR_6674791823,420,5,55,32,12,4,4,0,10,12,2,-2,1,3,2,4,2,-2,1,3,0,14,-94,1,5,6,-1,0,3,1,-1,1,1,6,1
KR_6718752805,420,0,-14,4,1,3,3,0,-1,1,2,1,2,1,-3,1,4,1,1,0,0,1,6,2,1,3,1,0,0,1,1,0,1,4,1
KR_6758232593,420,-2,-40,-12,-2,-1,2,3,1,3,2,0,2,2,-1,4,5,-1,1,2,-1,-6,0,-1,6,5,1,0,0,-1,1,0,-1,5,1
KR_6700583395,420,1,55,10,4,4,4,0,-3,0,3,1,5,4,0,1,1,2,2,0,0,1,11,2,4,6,-3,0,0,1,1,1,1,2,1
KR_6657021709,420,5,-2,10,8,-3,1,4,5,7,2,-1,4,5,2,2,0,5,5,0,-1,13,13,-1,8,7,-1,0,0,-1,-1,0,-1,1,1
KR_6751241414,420,3,16,12,10,-4,0,4,1,4,3,1,1,0,9,9,0,3,3,0,0,12,5,3,3,6,-1,0,1,1,-1,-1,1,2,1
KR_6694775624,420,2,22,21,-3,-3,0,3,-1,2,3,0,1,1,2,3,1,-1,0,1,0,1,0,2,3,5,4,0,0,1,-1,0,-1,2,1
KR_6757696053,420,0,1,-16,-4,0,0,0,-3,2,5,-3,1,4,0,5,5,2,2,0,0,0,-2,-3,6,3,0,0,0,-1,-1,0,-1,3,1
KR_6712006751,420,-2,-35,16,-7,-1,2,3,0,1,1,0,2,2,-7,0,7,1,1,0,0,-12,-5,-7,7,0,0,0,1,-1,1,1,-1,1,1
KR_6732761829,420,2,22,11,5,-3,2,5,0,2,2,5,7,2,3,5,2,0,2,2,1,10,-6,1,4,5,6,0,0,1,-1,1,1,6,1
KR_6752818185,420,0,2,5,-1,1,3,2,4,6,2,-8,0,8,2,3,1,0,0,0,0,-1,-44,-2,6,4,-4,0,-1,1,-1,-1,1,3,1
KR_6611680390,420,3,46,2,13,3,4,1,-1,2,3,5,5,0,8,10,2,-2,0,2,0,8,5,-1,4,3,-3,0,1,0,-1,1,1,0,1
KR_6748847160,440,1,93,-20,12,3,3,0,-1,4,5,-2,5,7,9,11,2,3,4,1,1,7,-105,1,4,5,1,0,1,1,-1,1,-1,3,1
KR_6737637179,420,3,-25,4,5,5,6,1,4,5,1,-3,2,5,-4,0,4,3,3,0,1,4,18,4,2,6,-4,0,0,-1,1,0,1,3,1
KR_6653390150,420,-2,-39,-12,-3,3,5,2,0,4,4,-1,0,1,-5,1,6,0,0,0,0,-5,3,-1,5,4,-2,0,-1,1,1,-1,1,3,1
KR_6771649910,420,0,20,11,6,1,1,0,2,4,2,5,6,1,-1,2,3,-1,0,1,0,7,-1,-3,8,5,3,0,-1,-1,1,-1,1,2,1
KR_6767299314,440,1,-1,16,8,5,5,0,-2,2,4,5,5,0,-1,1,2,1,1,0,0,0,-12,0,4,4,-2,0,1,1,1,1,1,5,1
KR_6771873289,420,2,39,16,-1,-1,0,1,5,6,1,0,2,2,-2,2,4,-3,3,6,-1,-3,-1,-3,5,2,1,0,1,-1,0,1,-1,1,1
KR_6764222090,420,2,27,18,4,0,2,2,-3,1,4,3,3,0,3,4,1,1,1,0,0,13,-13,2,5,7,-1,0,2,1,-1,1,-1,2,1
KR_6637272733,420,-2,49,-36,-2,1,2,1,3,5,2,-3,1,4,-4,2,6,1,2,1,0,-15,-1,2,4,6,0,0,1,1,1,1,-1,2,1
KR_6428367497,440,1,10,-30,6,5,7,2,0,3,3,4,4,0,-3,1,4,0,0,0,1,5,12,4,1,5,1,0,0,-1,1,1,1,4,1
KR_6748183970,420,2,84,-5,-1,1,1,0,-3,0,3,0,1,1,1,3,2,0,0,0,-1,-3,-27,0,3,3,-2,0,1,1,-1,1,-1,1,1
KR_6739575644,420,3,-12,19,1,1,2,1,3,5,2,1,3,2,-5,1,6,1,1,0,0,0,4,-3,7,4,-1,0,0,-1,-1,0,-1,3,1
KR_6769491728,420,1,-7,20,1,0,3,3,-1,2,3,3,4,1,0,3,3,-1,1,2,0,4,19,1,4,5,-23,0,0,0,1,0,1,0,1
KR_6771224531,420,2,18,7,1,1,3,2,-2,4,6,-1,1,2,2,4,2,1,3,2,-1,0,132,3,1,4,0,0,2,1,1,-1,-1,5,1
KR_6766427069,420,-4,-71,-30,-3,-2,1,3,4,5,1,0,4,4,-4,3,7,-1,0,1,-1,-2,-1,1,6,7,-6,0,-3,-1,-1,-1,-1,5,1
KR_6760990436,420,2,9,12,5,1,3,2,3,3,0,-1,0,1,2,4,2,0,1,1,0,2,9,3,2,5,-1,0,2,-1,0,1,1,5,1
KR_5679735593,420,1,-79,22,6,1,2,1,4,5,1,1,2,1,0,2,2,0,0,0,0,7,-7,-4,10,6,0,0,0,-1,1,0,1,5,1
KR_6699521572,420,3,63,-6,1,0,4,4,1,5,4,1,4,3,-1,2,3,0,1,1,0,0,10,-3,8,5,3,0,0,-1,-1,0,1,6,1
KR_6704818729,420,1,17,6,2,2,3,1,-1,2,3,-4,3,7,5,7,2,0,1,1,0,0,-4,-1,4,3,0,0,1,-1,1,1,1,3,1
KR_6754938100,420,0,20,4,-1,0,1,1,-1,0,1,2,4,2,-4,5,9,2,4,2,0,-5,62,0,4,4,-22,0,1,1,-1,1,1,1,1
KR_6751263053,420,1,-2,-10,0,-4,1,5,-1,5,6,2,2,0,4,5,1,-1,1,2,0,3,-5,4,4,8,-7,0,-1,1,1,-1,1,3,1
KR_6681324062,420,2,39,-5,9,4,5,1,2,6,4,1,2,1,2,3,1,0,1,1,0,4,234,0,1,1,-2,0,0,-1,0,0,1,6,1
KR_6694265933,420,1,-27,-5,7,0,1,1,10,10,0,1,6,5,-3,0,3,-1,0,1,0,9,-3,0,3,3,3,0,3,-1,1,1,1,1,1
KR_6748148593,420,1,50,29,-1,0,4,4,0,2,2,-5,0,5,3,8,5,1,2,1,0,-1,49,1,5,6,-20,0,2,1,1,1,-1,3,1
KR_6732384014,420,0,-28,-11,-1,1,1,0,1,2,1,-1,2,3,-1,0,1,-1,1,2,0,-4,11,3,3,6,3,0,1,0,1,1,-1,0,1
KR_6743366016,440,1,24,20,0,3,3,0,-2,1,3,-1,0,1,-1,1,2,1,2,1,0,-2,3,-5,10,5,-3,0,1,1,-1,1,1,1,1
KR_6754083741,420,8,60,21,17,4,6,2,4,6,2,4,5,1,6,7,1,-1,1,2,0,12,29,3,3,6,2,0,2,1,1,1,1,4,1
KR_6648456505,440,1,59,-8,-1,2,3,1,-6,1,7,2,2,0,-1,1,2,2,3,1,0,-5,-3,1,5,6,1,0,0,1,1,1,-1,4,1
KR_6734657887,420,3,28,43,3,2,3,1,1,3,2,-4,1,5,2,5,3,2,4,2,0,1,-14,0,4,4,6,0,1,-1,-1,1,1,6,1
KR_6668320612,420,3,-1,25,7,0,4,4,2,3,1,-1,2,3,3,3,0,3,3,0,0,6,42,-1,3,2,-18,0,2,1,0,1,1,5,1
KR_6749951517,420,6,43,32,8,1,3,2,1,2,1,2,3,1,2,3,1,2,2,0,0,8,14,5,3,8,-6,0,1,1,1,1,1,2,1
KR_6752463432,420,0,-30,30,-7,1,2,1,0,4,4,1,3,2,-7,0,7,-2,0,2,-1,-14,17,-7,9,2,1,0,-1,-1,1,-1,-1,6,1
KR_6728949805,420,2,14,1,2,1,2,1,-2,3,5,2,4,2,1,4,3,0,2,2,-1,6,-39,4,5,9,-5,0,1,-1,1,1,-1,2,1
KR_6686133904,420,3,-3,4,-2,0,2,2,-6,0,6,4,6,2,0,3,3,0,0,0,1,0,3,1,3,4,-2,0,0,-1,1,1,1,1,1
KR_6768294521,420,0,-25,3,1,-3,0,3,3,5,2,1,1,0,1,4,3,-1,1,2,0,0,0,4,3,7,0,0,1,1,1,1,1,6,1
KR_6766611327,420,1,21,-20,8,3,4,1,1,3,2,6,6,0,-2,3,5,0,0,0,0,5,13,4,1,5,1,0,0,1,0,0,1,1,1
KR_6750326254,420,2,86,-16,9,1,3,2,4,6,2,2,2,0,5,5,0,-3,0,3,0,9,52,4,5,9,1,0,1,-1,1,1,-1,3,1
KR_6770599405,420,2,87,-2,2,3,3,0,0,1,1,0,2,2,2,3,1,-3,0,3,0,-5,-15,3,3,6,-3,0,0,-1,1,1,1,4,1
KR_6672751127,440,-3,-39,-40,-5,-4,0,4,-2,1,3,-1,4,5,3,4,1,-1,0,1,0,-3,-1,0,5,5,-3,0,1,-1,1,1,-1,4,1
KR_6732831670,420,0,-22,30,0,0,3,3,1,1,0,0,1,1,-1,1,2,0,1,1,0,-4,-7,0,5,5,0,0,0,1,1,0,-1,4,1
KR_6606197130,440,2,42,32,5,-3,0,3,2,8,6,5,6,1,0,3,3,1,1,0,0,5,-5,-3,7,4,3,0,0,1,0,1,1,5,1
KR_6717098377,420,0,-46,22,1,-3,0,3,1,4,3,-2,1,3,2,4,2,3,3,0,-1,0,-24,-6,11,5,0,0,0,1,-1,-1,-1,6,1
KR_6760578922,420,2,13,9,6,-4,0,4,2,3,1,3,3,0,3,5,2,2,3,1,0,6,-10,-1,3,2,3,0,0,1,-1,-1,1,6,1
KR_6752482370,420,1,-38,12,3,2,3,1,2,5,3,1,2,1,-3,1,4,1,2,1,0,0,22,1,7,8,-4,0,1,-1,1,1,-1,5,1
KR_6771027311,420,0,-29,0,1,0,1,1,-3,1,4,1,2,1,1,5,4,2,3,1,0,4,1,-1,4,3,1,0,2,-1,1,1,1,2,1
KR_6655047874,420,2,42,25,5,-4,2,6,5,8,3,-5,3,8,10,10,0,-1,1,2,1,2,5,3,2,5,-4,0,1,1,1,1,-1,4,1
KR_6736596206,420,2,29,2,1,-1,4,5,-3,0,3,5,8,3,0,3,3,0,3,3,1,-1,-86,-3,7,4,1,0,1,0,1,1,1,0,1
KR_6768081852,420,-1,45,12,-8,-5,0,5,-1,0,1,-3,0,3,0,1,1,1,4,3,-1,-11,0,2,6,8,-1,0,1,-1,-1,1,-1,5,1
KR_6737278025,420,2,33,32,1,-2,1,3,4,6,2,5,7,2,-1,3,4,-5,0,5,0,-9,-3,5,1,6,2,0,-1,1,1,-1,1,4,1
KR_6769909046,440,2,23,-36,5,-1,1,2,-1,2,3,4,6,2,5,7,2,-2,0,2,-1,9,-7,-1,7,6,5,0,1,1,-1,1,-1,2,1
KR_6768495172,420,0,4,-1,-1,-1,2,3,-2,3,5,2,2,0,3,5,2,-3,1,4,-1,-1,-24,3,3,6,-3,0,0,1,1,0,-1,3,1
KR_6732894347,420,-1,-31,3,2,-2,1,3,6,6,0,-1,2,3,-1,1,2,0,1,1,0,4,-271,-2,4,2,5,0,-1,-1,-1,-1,1,3,1
KR_6725785456,420,6,94,8,12,0,2,2,6,6,0,2,3,1,3,4,1,1,1,0,1,23,110,1,4,5,3,0,1,-1,1,1,1,6,1
KR_6768187544,420,5,128,36,6,1,2,1,5,7,2,-2,1,3,2,3,1,0,1,1,0,0,8,0,5,5,2,0,2,1,1,1,1,4,1
KR_6723886480,420,0,-26,-19,-2,2,2,0,1,3,2,-2,1,3,-2,1,3,-1,2,3,0,1,-9,2,3,5,-5,0,0,-1,1,0,1,3,1
KR_6382750537,420,4,62,29,11,-1,2,3,1,6,5,3,7,4,1,2,1,7,9,2,0,18,1,1,5,6,2,0,2,1,1,1,1,5,1
KR_6771123213,420,7,79,44,20,3,4,1,3,4,1,1,4,3,12,13,1,1,1,0,-1,21,9,10,1,11,-3,0,1,1,1,-1,1,2,1
KR_6712573119,420,4,56,-4,5,-2,2,4,4,5,1,-1,1,2,4,6,2,0,0,0,0,7,-6,-2,7,5,0,0,0,-1,1,1,-1,1,1
KR_6727869273,420,2,114,-4,0,3,4,1,2,4,2,1,2,1,-5,1,6,-1,2,3,0,-6,16,7,2,9,1,0,2,0,1,1,1,0,1
KR_6767937324,440,-1,-12,-7,-4,0,2,2,3,4,1,-5,1,6,-1,2,3,-1,0,1,0,0,-2,-1,4,3,-5,0,-1,0,0,-1,1,0,1
KR_6407188740,420,-1,-59,0,0,3,3,0,1,1,0,-1,1,2,-4,2,6,1,2,1,0,0,2,3,6,9,-3,0,0,-1,1,0,1,5,1
KR_6655617828,420,4,83,36,9,2,3,1,6,7,1,0,1,1,0,2,2,1,1,0,0,7,-3,-7,11,4,3,0,2,1,1,1,1,6,1
KR_6542518426,420,3,53,-8,6,1,1,0,4,7,3,2,4,2,-1,2,3,0,0,0,1,8,-10,-5,7,2,2,0,0,-1,1,1,1,3,1
KR_6739254421,420,3,57,23,3,0,3,3,0,6,6,1,2,1,4,4,0,-2,0,2,1,10,-17,-1,4,3,-1,0,1,1,1,1,1,1,1
KR_6446877042,420,-1,-42,-8,4,-2,2,4,5,6,1,2,2,0,-2,1,3,1,1,0,0,9,6,4,4,8,0,0,0,1,-1,0,1,2,1
KR_6754501323,440,2,40,0,-3,0,1,1,-1,0,1,-5,0,5,3,4,1,0,1,1,0,-2,-11,-2,4,2,0,0,2,-1,1,1,-1,6,1
KR_6705402548,420,2,45,5,3,7,7,0,-1,4,5,-1,2,3,-1,2,3,-1,0,1,0,1,-274,-3,4,1,19,0,1,-1,1,1,1,4,1
KR_6728764222,420,1,-20,-40,1,0,0,0,-1,1,2,3,5,2,0,2,2,-1,0,1,1,8,-9,-5,9,4,6,0,0,1,-1,-1,1,4,1
KR_6647725226,420,2,19,40,4,2,2,0,-1,1,2,0,1,1,0,3,3,3,3,0,0,2,-8,-8,10,2,-1,0,1,1,1,1,1,5,1
KR_6728764222,420,1,-20,-40,1,0,0,0,-1,1,2,3,5,2,0,2,2,-1,0,1,1,8,-9,-5,9,4,6,0,0,1,-1,-1,1,4,1
KR_6647725226,420,2,19,40,4,2,2,0,-1,1,2,0,1,1,0,3,3,3,3,0,0,2,-8,-8,10,2,-1,0,1,1,1,1,1,5,1
KR_6766970543,420,4,27,-11,10,4,6,2,-3,3,6,2,3,1,2,4,2,5,6,1,0,10,15,-7,9,2,0,0,0,1,-1,-1,-1,2,1
KR_6683139155,420,3,7,15,7,2,3,1,5,6,1,3,7,4,-3,2,5,0,1,1,0,4,2,-4,8,4,4,0,1,-1,1,1,-1,5,1
KR_6768898453,420,1,-16,-3,2,0,2,2,2,5,3,2,4,2,-2,1,3,0,0,0,0,-5,7,1,3,4,3,0,1,0,1,1,1,0,1
KR_6734468820,420,1,-23,8,10,4,5,1,1,3,2,0,4,4,3,4,1,2,2,0,0,12,5,-2,5,3,0,0,0,-1,1,0,1,2,1
KR_6743589204,420,2,22,-8,9,-1,1,2,4,5,1,7,7,0,-1,2,3,0,0,0,0,5,30,3,3,6,-2,0,1,1,1,1,1,3,1
KR_6722477311,420,4,-30,-1,13,-2,2,4,4,6,2,5,6,1,3,6,3,3,3,0,1,28,1,0,8,8,3,0,0,1,-1,1,1,6,1
KR_6662520693,420,1,53,18,2,-1,1,2,1,2,1,1,2,1,1,2,1,0,1,1,0,2,3,4,2,6,-1,0,0,1,-1,1,1,2,1
KR_6702790904,440,0,35,-4,-4,-4,0,4,0,1,1,-1,1,2,2,5,3,-1,0,1,0,-6,1,1,4,5,3,0,1,-1,0,1,-1,6,1
KR_6591617770,420,3,1,10,6,3,5,2,5,5,0,-1,2,3,-3,3,6,2,2,0,0,7,55,4,3,7,1,0,0,1,1,1,1,1,1
KR_6732697802,420,3,67,12,0,6,7,1,0,2,2,-4,1,5,-1,0,1,-1,1,2,0,-3,1,2,5,7,-7,0,1,1,1,1,1,2,1
KR_6761028477,420,3,17,8,-1,3,5,2,3,4,1,0,5,5,-6,1,7,-1,0,1,0,-5,-3,-4,6,2,3,0,1,1,1,1,1,1,1
KR_6051989278,420,2,64,5,4,-1,3,4,4,5,1,1,4,3,4,8,4,-4,0,4,-1,5,-21,-1,10,9,10,0,0,-1,-1,1,-1,1,1
KR_6303239191,420,-1,21,-9,0,1,2,1,0,2,2,-2,1,3,1,1,0,0,0,0,-1,-3,-26,-1,8,7,-3,0,0,1,1,0,-1,5,1
KR_6769298709,440,3,9,7,8,2,3,1,-8,0,8,5,6,1,9,9,0,0,2,2,0,1,13,0,4,4,7,0,2,-1,-1,1,1,4,1
KR_6658790298,420,0,39,-33,3,-1,3,4,4,10,6,2,3,1,1,3,2,-3,1,4,0,10,-7,-1,7,6,4,0,-1,-1,-1,-1,-1,4,1
KR_6764961710,420,0,18,-28,5,6,9,3,-1,3,4,-2,2,4,1,5,4,1,3,2,1,3,2,0,5,5,-1,0,0,-1,-1,1,1,5,1
KR_6654499404,420,3,67,-36,10,1,4,3,10,10,0,-2,1,3,0,2,2,1,1,0,0,9,-1,1,2,3,1,0,2,1,-1,1,-1,1,1
KR_6756187515,420,3,16,15,2,-2,1,3,-1,1,2,1,3,2,1,1,0,3,5,2,0,5,9,5,5,10,6,0,1,1,1,1,-1,2,1
KR_6758160639,420,0,19,-12,11,2,3,1,5,5,0,-1,1,2,4,4,0,1,1,0,0,8,-5,-4,6,2,-2,0,1,-1,1,1,1,2,1
KR_6756676072,420,-3,39,-39,-7,1,2,1,-3,1,4,-1,3,4,-4,0,4,0,0,0,0,-10,-25,-2,6,4,4,0,0,-1,-1,1,1,2,1
KR_6731696360,440,5,135,-16,10,-2,2,4,-1,3,4,3,3,0,4,6,2,6,6,0,0,20,4,3,3,6,2,0,2,0,0,1,1,0,1
KR_6668751755,420,0,57,-4,-4,-1,1,2,1,4,3,-1,2,3,-3,4,7,0,0,0,0,0,-34,-6,10,4,-3,0,1,-1,1,1,-1,4,1
KR_6619031857,420,2,52,-17,14,4,5,1,4,5,1,3,5,2,3,5,2,0,2,2,0,8,3,5,1,6,3,0,1,-1,-1,1,1,5,1
KR_6748007214,420,6,75,11,11,0,1,1,5,7,2,1,2,1,2,2,0,3,3,0,0,22,-1,0,4,4,5,0,2,-1,-1,1,1,6,1
KR_6636659935,440,-1,46,4,-1,-1,1,2,2,5,3,-2,1,3,-2,2,4,2,3,1,0,-1,45,-3,6,3,-19,0,0,-1,1,1,-1,4,1
KR_6767559244,420,0,10,11,12,-1,0,1,10,11,1,-1,3,4,3,5,2,1,1,0,1,18,33,4,3,7,-2,0,1,1,-1,1,1,5,1
KR_6764045897,420,1,32,15,1,-2,2,4,-2,3,5,-2,1,3,2,2,0,5,7,2,0,1,5,-1,4,3,2,0,2,1,1,1,-1,5,1
KR_6766178510,440,6,52,32,15,0,2,2,5,5,0,1,3,2,6,7,1,3,3,0,0,14,5,4,5,9,-1,0,2,0,1,1,-1,0,1
KR_6754215084,420,-1,-40,0,-2,-2,2,4,2,6,4,0,2,2,-2,2,4,0,1,1,0,-3,5,1,3,4,3,0,-2,-1,0,-1,-1,5,1
KR_6445302003,420,2,-34,6,7,1,1,0,4,7,3,1,4,3,1,1,0,0,0,0,0,13,-20,0,6,6,8,0,0,-1,1,0,1,3,1
KR_6721365657,420,4,56,32,5,4,4,0,4,8,4,-1,0,1,-2,4,6,0,3,3,-1,-4,0,-3,7,4,0,0,2,1,1,1,-1,1,1
KR_6648034800,420,-2,-29,-4,-1,-2,0,2,3,5,2,1,2,1,-1,1,2,-2,0,2,0,2,56,3,3,6,2,0,0,1,1,0,1,2,1
KR_6136176572,420,5,36,16,14,1,1,0,1,4,3,0,1,1,5,6,1,7,7,0,0,11,255,1,6,7,-3,0,1,1,1,1,1,1,1
KR_6686107144,420,1,-23,-37,6,-2,1,3,1,3,2,1,2,1,7,8,1,-1,0,1,0,11,-2,-4,10,6,-2,0,1,1,-1,-1,-1,1,1
KR_6444110766,420,2,-15,25,6,1,2,1,1,4,3,-2,2,4,6,6,0,0,0,0,0,8,-1,-2,5,3,-2,0,1,0,1,1,-1,0,1
KR_6758712366,440,2,45,16,6,3,4,1,1,2,1,-4,1,5,5,8,3,1,1,0,0,0,-7,1,3,4,3,0,0,1,1,1,1,2,1
KR_6737655036,420,3,-39,-32,4,-3,1,4,-1,3,4,4,5,1,3,4,1,1,2,1,0,13,17,-4,6,2,3,0,-1,-1,-1,-1,1,6,1
KR_6673970013,420,8,146,48,22,3,5,2,-1,1,2,5,5,0,8,9,1,7,7,0,0,16,-346,-1,7,6,5,1,4,1,1,1,1,6,1
KR_6628797640,420,-1,-19,13,2,4,6,2,-6,2,8,1,2,1,0,1,1,3,3,0,0,-5,3,5,2,7,0,0,0,-1,1,1,1,4,1
KR_6726906736,420,0,26,43,0,0,2,2,2,3,1,-2,2,4,1,1,0,-1,0,1,0,-1,-2,-4,8,4,1,0,0,1,1,0,-1,6,1
KR_6771734707,440,-1,10,14,-6,0,1,1,-3,5,8,-2,2,4,-2,4,6,1,2,1,0,-13,0,-5,6,1,5,0,1,0,1,1,1,0,1
KR_6757037845,420,0,-6,-4,-1,-1,2,3,-1,3,4,-2,1,3,3,7,4,0,2,2,-1,-3,-2,-6,7,1,1,0,0,1,-1,0,-1,5,1
KR_6768415178,420,0,-14,32,-4,-3,2,5,-3,3,6,1,1,0,2,2,0,-1,0,1,0,-5,28,-3,8,5,1,0,0,0,1,0,1,0,1
KR_6764040964,420,11,149,32,7,4,5,1,-1,2,3,1,2,1,0,1,1,3,4,1,0,5,3,2,1,3,6,0,3,1,-1,1,1,4,1
KR_6657789568,420,-1,37,-31,0,4,4,0,-3,1,4,-4,3,7,2,3,1,1,2,1,0,6,181,3,2,5,-1,0,0,-1,1,1,1,5,1
KR_6759781769,420,-3,55,-8,-7,1,3,2,-4,1,5,-1,1,2,0,2,2,-3,0,3,0,-4,-105,0,4,4,1,0,2,-1,1,1,1,5,1
KR_6591915434,420,2,80,35,8,-1,0,1,0,3,3,2,4,2,6,6,0,1,1,0,1,11,9,3,3,6,0,0,1,1,1,1,1,4,1
KR_6696002305,440,-1,4,0,2,4,4,0,2,5,3,0,1,1,-1,0,1,-3,1,4,-1,-5,6,0,3,3,-1,0,1,-1,1,1,-1,1,1
KR_6711116941,420,3,25,16,10,5,6,1,1,4,3,1,2,1,0,1,1,3,3,0,0,10,-1,5,4,9,-2,0,2,-1,1,1,-1,5,1
KR_6536111402,420,2,66,4,4,3,3,0,1,4,3,0,6,6,1,2,1,-1,2,3,0,0,12,6,3,9,1,0,1,-1,1,1,1,6,1
KR_6764978736,420,4,52,-29,11,4,4,0,1,4,3,-2,2,4,6,11,5,2,2,0,1,7,5,8,1,9,2,0,1,-1,-1,1,1,2,1
KR_6562968750,420,-1,-17,-8,-4,4,5,1,1,3,2,0,3,3,-9,1,10,0,1,1,0,-5,94,-3,4,1,0,0,-1,1,1,-1,1,3,1
KR_6684307792,420,5,56,34,6,5,6,1,2,3,1,6,6,0,-7,0,7,0,0,0,-1,-1,-2,-2,6,4,-1,0,1,0,1,-1,-1,0,1
KR_6540484778,420,2,8,-24,4,3,3,0,3,4,1,0,4,4,0,1,1,-2,0,2,-1,10,-18,3,3,6,1,0,1,1,1,1,-1,2,1
KR_6760657012,440,0,-13,16,-4,-2,3,5,4,4,0,-1,0,1,-5,2,7,0,1,1,-1,-6,0,1,1,2,-2,0,0,0,-1,1,-1,0,1
KR_6702026432,420,4,100,37,7,1,4,3,0,3,3,3,5,2,-1,1,2,4,4,0,0,1,115,5,2,7,1,0,1,1,1,1,1,6,1
KR_6771666446,420,3,51,9,5,1,1,0,2,5,3,3,3,0,-2,0,2,1,1,0,0,4,9,4,1,5,2,0,1,1,1,1,1,3,1
KR_6721160465,420,3,27,37,8,-3,1,4,3,8,5,3,6,3,5,7,2,0,2,2,0,5,36,9,6,15,2,0,1,1,1,1,-1,4,1
KR_6767917524,420,3,31,36,9,-1,0,1,3,4,1,3,3,0,4,6,2,0,0,0,2,9,3,0,6,6,1,0,0,1,1,0,1,6,1
KR_6767957524,420,2,68,-11,6,0,1,1,-7,1,8,7,8,1,8,8,0,-2,1,3,0,3,11,2,2,4,7,0,0,1,-1,1,1,1,1
KR_6694723761,420,0,1,-4,-1,1,4,3,4,5,1,0,2,2,-5,2,7,-1,0,1,0,-2,-7,-3,10,7,12,0,0,-1,1,1,-1,6,1
KR_6734600650,420,0,22,1,2,-5,1,6,-1,1,2,2,2,0,3,4,1,3,3,0,0,5,4,4,2,6,-6,0,-1,0,-1,-1,-1,0,1
KR_6763030718,420,2,62,-23,3,-1,2,3,-3,1,4,3,3,0,3,4,1,1,1,0,1,4,-15,1,5,6,8,0,0,1,-1,-1,1,1,1
KR_5607803714,420,0,-30,11,-15,-7,2,9,-2,6,8,-5,0,5,-2,4,6,1,1,0,0,-13,3,-1,10,9,2,0,-2,1,-1,-1,-1,2,1
KR_6751698862,420,1,-36,-15,5,3,5,2,3,5,2,1,2,1,-2,2,4,0,0,0,0,6,-6,-1,3,2,-3,0,0,-1,1,1,1,6,1
KR_6750582663,420,2,64,4,9,3,4,1,0,1,1,4,6,2,3,6,3,-1,0,1,0,3,-6,-1,7,6,1,0,2,1,1,1,1,3,1
KR_6686880502,420,0,19,5,0,1,1,0,1,3,2,-1,1,2,-1,2,3,0,1,1,0,3,36,-1,5,4,4,0,0,-1,1,1,-1,6,1
KR_6763720976,440,1,33,-4,1,0,1,1,4,4,0,-2,3,5,-1,3,4,0,0,0,0,-1,-52,-1,5,4,21,0,0,-1,1,1,-1,6,1
KR_6729159850,420,3,-25,38,2,-4,0,4,2,2,0,0,1,1,4,4,0,0,0,0,0,5,10,1,3,4,-1,0,0,1,-1,0,1,4,1
KR_6771795843,420,1,48,-32,4,-3,2,5,1,4,3,0,3,3,7,8,1,-1,1,2,0,8,7,7,3,10,-1,0,2,1,0,1,1,3,1
KR_6680895256,420,4,61,12,10,4,5,1,0,3,3,0,1,1,6,8,2,0,1,1,0,16,-294,-4,5,1,3,0,1,-1,1,1,-1,3,1
KR_6752209128,420,0,-86,-24,-2,0,0,0,-3,1,4,3,4,1,-3,3,6,1,2,1,0,2,3,1,3,4,-4,0,-1,-1,-1,-1,-1,5,1
KR_6713918434,420,-1,-40,16,-8,3,6,3,-2,1,3,-1,0,1,-8,1,9,0,1,1,-2,-14,-15,-5,10,5,4,0,1,-1,1,1,-1,3,1
KR_6758292818,440,2,46,29,6,-1,0,1,0,1,1,0,1,1,-1,2,3,8,10,2,0,-2,-42,-1,4,3,7,0,2,1,1,1,1,5,1
KR_6734564778,420,3,14,22,-1,-1,1,2,5,7,2,-3,1,4,-2,0,2,0,0,0,-1,4,35,1,2,3,-3,0,0,1,1,0,-1,1,1
KR_6717209199,420,3,49,33,15,3,5,2,1,2,1,4,7,3,3,3,0,4,4,0,3,12,-3,7,2,9,1,0,1,1,-1,1,1,2,1
KR_6759753414,440,0,24,7,-3,2,4,2,-2,3,5,3,4,1,-4,3,7,-2,0,2,0,-9,-3,3,3,6,19,0,0,-1,1,0,-1,5,1
KR_6766868470,440,4,-20,36,14,-1,1,2,8,9,1,-1,4,5,3,5,2,5,6,1,0,13,-2,2,2,4,3,0,0,1,1,1,1,5,1
KR_6657090659,420,1,16,18,0,1,2,1,0,1,1,2,2,0,3,3,0,-6,0,6,0,-5,-10,-1,4,3,3,0,0,1,1,1,-1,6,1
KR_6760330157,440,3,58,37,6,-5,0,5,1,4,3,2,4,2,7,9,2,1,2,1,0,9,8,1,5,6,3,0,1,1,1,1,1,3,1
KR_6768152716,420,2,26,11,3,2,2,0,1,2,1,-1,1,2,1,3,2,0,0,0,0,6,0,0,5,5,2,0,1,-1,1,1,1,5,1
KR_6769303873,420,1,-40,9,-3,-1,3,4,-2,0,2,1,1,0,0,3,3,-1,0,1,-2,-7,-150,-1,6,5,2,0,0,1,-1,0,-1,5,1
KR_6770353058,420,7,28,44,2,2,4,2,4,4,0,2,4,2,-3,2,5,-3,0,3,0,0,8,4,2,6,1,0,-1,1,-1,-1,-1,5,1
KR_6541623641,420,5,80,25,14,6,8,2,3,3,0,-1,0,1,5,6,1,1,1,0,0,12,0,2,6,8,3,0,3,1,1,1,1,4,1
KR_6755040027,420,2,19,-12,7,-2,1,3,9,10,1,-2,4,6,2,6,4,0,0,0,0,16,135,-2,7,5,3,0,0,-1,1,0,1,1,1
KR_6639193702,420,-2,-10,-6,-4,0,2,2,1,2,1,-2,0,2,-3,0,3,0,0,0,0,-3,16,2,4,6,-3,0,1,1,1,1,-1,1,1
KR_6743297035,420,3,76,-9,11,-1,4,5,4,5,1,0,1,1,6,6,0,2,2,0,0,16,2,3,4,7,1,0,2,1,1,1,1,6,1
KR_6768536449,420,4,32,-9,14,4,4,0,3,4,1,5,6,1,1,6,5,1,2,1,0,18,137,-3,8,5,0,0,2,1,-1,1,1,5,1
KR_6731627622,440,-1,55,-8,3,0,2,2,-1,1,2,3,4,1,-1,1,2,2,3,1,0,1,2,1,5,6,1,0,0,0,0,0,-1,0,1
KR_6762502699,420,0,-80,-9,-2,1,1,0,2,5,3,1,6,5,-6,3,9,0,1,1,-1,-2,-3,0,4,4,2,0,-1,1,-1,-1,-1,1,1
KR_6771447331,420,0,-42,7,6,0,1,1,2,3,1,0,2,2,5,5,0,-1,0,1,0,9,-15,2,5,7,1,0,0,1,1,0,1,1,1
KR_6662547774,420,2,59,7,2,0,1,1,3,7,4,-2,1,3,0,3,3,1,1,0,-2,7,99,-5,8,3,5,0,2,1,-1,1,-1,5,1
KR_6653022443,420,2,-48,-15,3,3,4,1,3,4,1,0,1,1,-3,3,6,0,2,2,0,8,5,3,3,6,1,0,0,1,-1,0,1,3,1
KR_6749333604,440,1,-34,12,1,-2,2,4,-2,0,2,6,9,3,0,1,1,-1,2,3,0,0,-10,-9,11,2,1,0,-1,1,0,-1,-1,2,1
KR_6745044646,420,2,43,16,3,1,2,1,2,4,2,0,1,1,2,4,2,-2,1,3,0,3,41,-4,6,2,-12,0,1,1,-1,1,-1,5,1
KR_6752452571,420,0,-9,20,1,-2,1,3,0,3,3,-1,2,3,3,6,3,1,2,1,0,-3,276,-6,10,4,0,0,1,1,1,1,1,1,1
KR_6768638382,420,5,66,-24,8,1,3,2,4,6,2,-2,2,4,3,4,1,2,2,0,0,7,2,4,1,5,-3,0,0,1,-1,0,-1,4,1
KR_6765604985,420,-3,-32,-1,2,4,5,1,1,5,4,-4,3,7,-1,1,2,2,3,1,0,6,29,1,3,4,-5,0,-1,-1,-1,-1,-1,6,1
KR_6770191643,420,-1,6,0,-2,1,2,1,-4,1,5,-1,1,2,1,5,4,1,2,1,0,-8,2,1,5,6,-4,0,1,1,-1,1,-1,1,1
KR_6762802135,420,3,51,14,2,-2,1,3,1,2,1,2,4,2,2,6,4,-1,1,2,0,-1,-15,-3,8,5,8,0,1,1,1,1,-1,2,1
KR_6751579020,420,5,-15,64,10,2,3,1,4,5,1,1,3,2,4,5,1,-1,0,1,0,7,0,-1,6,5,2,0,1,0,1,1,1,0,1
KR_6767357154,440,7,97,31,8,2,3,1,1,3,2,0,1,1,4,6,2,1,2,1,0,8,-21,1,5,6,1,0,3,-1,1,1,1,4,1
KR_6696627135,440,2,22,15,6,1,2,1,1,7,6,2,2,0,2,5,3,0,0,0,0,0,19,-2,6,4,-2,0,-1,1,-1,-1,-1,3,1
KR_6756812530,420,1,81,1,5,2,6,4,1,3,2,-2,0,2,4,4,0,0,1,1,1,3,6,-2,6,4,0,0,2,1,0,1,1,6,1
KR_6768107372,420,5,16,41,12,-2,0,2,6,9,3,4,8,4,5,11,6,-1,2,3,0,19,-3,0,5,5,-7,0,0,1,-1,1,1,1,1
KR_6700969971,420,4,45,-9,8,0,2,2,1,4,3,4,5,1,5,7,2,-2,0,2,0,5,6,5,3,8,2,0,1,1,1,1,1,1,1
KR_6734292197,440,-2,-15,7,-6,3,6,3,-1,3,4,-4,1,5,-1,1,2,-3,0,3,0,-8,-224,-5,6,1,1,0,-1,-1,1,-1,-1,4,1
KR_6725360923,420,1,53,0,-1,0,3,3,0,3,3,-4,1,5,5,10,5,-2,2,4,0,0,-1,-2,5,3,2,0,0,-1,1,1,-1,3,1
KR_6731446360,420,2,31,12,7,0,0,0,3,5,2,3,7,4,1,3,2,0,2,2,0,5,-92,-2,6,4,4,0,1,-1,0,1,1,3,1
KR_6714168431,420,-1,10,-2,-4,0,2,2,0,2,2,1,2,1,-2,1,3,-3,1,4,0,-10,308,4,2,6,-4,0,-2,1,-1,-1,-1,4,1
KR_6739030496,420,-2,-58,-19,-6,0,2,2,1,1,0,-1,2,3,-6,2,8,0,1,1,-1,-3,3,-4,8,4,-5,0,-1,-1,1,-1,-1,6,1
KR_6769642104,420,5,-28,0,10,4,5,1,1,2,1,0,3,3,4,5,1,1,1,0,0,8,-5,-2,4,2,-3,0,1,1,1,1,1,1,1
KR_6751421863,440,1,59,23,1,2,4,2,0,0,0,3,5,2,0,3,3,-4,1,5,1,-11,-7,-4,6,2,-1,0,2,1,1,1,1,2,1
KR_6619122121,420,5,62,4,10,3,3,0,1,3,2,6,7,1,0,4,4,0,1,1,0,-6,-6,-2,6,4,1,0,1,1,1,1,1,6,1
KR_6771050741,420,0,-9,16,4,1,1,0,9,9,0,-4,1,5,-2,1,3,0,0,0,0,5,-97,0,3,3,0,0,0,-1,1,0,1,4,1
KR_6769175175,420,4,3,15,14,0,1,1,1,4,3,4,5,1,8,8,0,1,1,0,1,17,-4,3,6,9,0,0,1,1,1,1,1,2,1
KR_6706728347,420,3,-22,14,5,3,5,2,7,7,0,-5,1,6,-4,0,4,4,4,0,-1,13,0,1,3,4,0,0,1,-1,1,-1,-1,4,1
KR_6051869296,420,0,48,15,-4,-1,1,2,2,8,6,-5,0,5,-1,2,3,1,4,3,0,-1,116,-1,4,3,-2,0,1,-1,1,1,-1,1,1
KR_6740520270,420,-2,37,-6,-4,-4,1,5,1,4,3,-4,2,6,-1,3,4,4,5,1,-2,-5,-4,-3,4,1,-3,0,-2,-1,-1,-1,-1,4,1
KR_6694369523,440,3,34,-12,5,2,4,2,4,5,1,3,4,1,-2,1,3,-2,2,4,0,0,-8,1,3,4,-3,0,3,0,1,1,1,0,1
KR_6647080286,420,3,29,26,7,-4,0,4,2,3,1,0,2,2,7,7,0,2,2,0,0,15,47,4,4,8,-10,0,0,-1,1,1,1,1,1
KR_6726106372,420,1,21,19,11,1,4,3,1,3,2,5,7,2,3,5,2,1,1,0,1,17,4,2,4,6,1,0,2,1,-1,1,1,5,1
KR_6514979584,420,-3,-40,7,-2,1,3,2,-1,1,2,-3,1,4,1,3,2,0,0,0,1,3,-55,-5,7,2,3,0,0,1,1,1,1,3,1
KR_6723387242,420,-1,-2,20,0,2,3,1,-3,2,5,2,4,2,-3,2,5,2,2,0,1,-1,63,4,4,8,1,0,0,-1,-1,0,1,6,1
KR_6738250605,420,1,44,15,2,4,6,2,-4,2,6,2,2,0,-2,0,2,2,2,0,-1,-1,-8,-1,5,4,5,0,0,1,1,0,-1,2,1
KR_6732682385,420,5,75,15,7,3,4,1,0,3,3,2,4,2,2,3,1,0,3,3,0,4,6,0,4,4,-2,0,1,-1,1,1,1,6,1
KR_6767040678,420,0,3,26,-3,-7,1,8,0,2,2,1,3,2,5,9,4,-2,0,2,0,-4,9,3,6,9,-1,0,-1,1,-1,-1,-1,4,1
KR_6767152283,440,0,41,-8,0,0,0,0,0,2,2,2,3,1,-4,2,6,2,3,1,0,1,-31,-3,6,3,4,0,-1,-1,0,-1,1,3,1
KR_6717363557,420,0,-47,20,4,-3,2,5,1,4,3,-2,2,4,9,9,0,-1,2,3,1,9,15,2,3,5,-3,0,1,1,1,1,1,3,1
KR_6736947552,440,-1,15,51,1,-1,1,2,-6,3,9,2,3,1,2,3,1,4,4,0,1,-5,34,5,1,6,-25,0,0,-1,1,1,1,6,1
KR_6765443398,420,3,21,38,10,2,3,1,3,4,1,2,4,2,2,9,7,1,1,0,0,4,12,6,4,10,2,0,1,1,1,1,-1,6,1
KR_6763085534,420,-3,21,-4,-5,-3,1,4,-2,1,3,1,4,3,0,2,2,-1,0,1,0,-7,-6,-1,3,2,2,0,-1,-1,-1,-1,-1,6,1
KR_6769334007,440,3,56,0,9,0,0,0,3,5,2,0,1,1,5,5,0,1,1,0,0,6,-5,2,3,5,0,0,1,0,1,1,1,0,1
KR_6688419237,420,2,75,-13,8,-1,1,2,0,0,0,4,9,5,1,1,0,4,5,1,0,6,4,3,2,5,-2,0,2,1,-1,1,1,5,1
KR_6737276014,440,6,50,9,17,4,4,0,3,3,0,5,5,0,3,5,2,2,2,0,0,25,1,-2,4,2,-3,0,0,1,-1,1,1,4,1
KR_6618876710,420,3,52,34,6,-1,2,3,2,4,2,1,2,1,4,5,1,0,1,1,0,8,32,2,4,6,-1,0,1,1,-1,1,1,3,1
KR_6497708624,420,1,-23,31,7,-2,1,3,1,2,1,1,5,4,6,6,0,1,2,1,0,8,24,3,3,6,3,0,3,1,1,1,1,2,1
KR_6722396224,420,1,8,-24,1,-3,1,4,-1,2,3,3,4,1,-1,1,2,3,3,0,0,-1,27,1,3,4,1,0,1,-1,0,1,-1,6,1
KR_6663349153,420,0,7,-10,4,-2,0,2,0,2,2,0,2,2,7,7,0,-1,1,2,0,10,6,0,4,4,2,0,1,1,-1,1,-1,6,1
KR_6734443993,420,0,-78,-3,5,-1,1,2,5,7,2,-2,2,4,3,4,1,0,1,1,0,9,-2,-1,7,6,-3,0,-2,1,-1,-1,-1,3,1
KR_6768638660,420,-1,71,8,2,-2,1,3,2,3,1,-2,2,4,3,4,1,1,1,0,0,1,-1,-2,8,6,6,0,2,1,1,1,-1,1,1
KR_6755590935,420,0,-22,-8,3,0,0,0,1,3,2,0,3,3,2,5,3,0,1,1,0,1,-8,-4,6,2,3,0,2,-1,1,1,1,1,1
KR_6609689229,420,4,19,-10,7,4,4,0,1,4,3,0,2,2,2,5,3,0,1,1,0,3,4,-1,6,5,1,0,1,1,-1,1,1,2,1
KR_6767010977,420,1,13,-4,13,4,6,2,4,6,2,2,4,2,4,7,3,-1,0,1,1,19,-6,-3,5,2,0,0,3,-1,1,1,1,5,1
KR_6767534827,420,5,55,19,14,6,6,0,-4,0,4,0,1,1,9,11,2,3,4,1,1,6,4,1,6,7,1,0,2,-1,1,1,1,1,1
KR_6759108952,420,7,21,-4,16,1,2,1,4,6,2,6,7,1,4,6,2,1,2,1,1,10,1,0,5,5,1,0,0,0,-1,0,1,0,1
KR_6767987564,420,8,118,19,16,6,7,1,6,8,2,4,5,1,2,6,4,-2,1,3,0,11,-37,3,3,6,17,0,1,1,1,1,-1,4,1
KR_6761213157,420,6,61,32,14,2,3,1,4,6,2,1,2,1,1,2,1,6,7,1,0,14,8,1,4,5,1,0,1,1,-1,1,-1,4,1
KR_6745455079,440,0,11,-16,0,2,3,1,1,4,3,-2,0,2,1,4,3,-2,0,2,0,-1,8,4,4,8,-2,0,-1,-1,0,-1,1,1,1
KR_6743827153,420,3,76,21,15,10,11,1,6,7,1,-1,2,3,1,3,2,-1,1,2,0,7,-8,1,3,4,1,0,2,1,1,1,-1,5,1
KR_6689259776,420,5,-5,23,12,0,0,0,5,7,2,4,7,3,0,5,5,3,4,1,1,8,3,0,3,3,0,0,0,1,1,1,1,5,1
KR_6758269665,420,0,46,23,6,0,2,2,2,3,1,1,4,3,3,4,1,0,3,3,0,8,-4,0,3,3,4,0,0,-1,1,1,-1,1,1
KR_6759532351,420,2,-8,12,4,-2,2,4,0,3,3,0,4,4,3,5,2,3,3,0,-1,5,13,1,4,5,2,0,0,-1,1,-1,-1,1,1
KR_6701194443,420,0,39,8,-2,1,1,0,2,4,2,1,2,1,-9,0,9,3,3,0,0,-5,-4,-2,8,6,-2,0,1,-1,1,-1,-1,3,1
KR_6665293013,420,1,-27,-24,10,0,1,1,2,4,2,3,3,0,5,6,1,0,1,1,0,17,-24,0,7,7,4,0,1,-1,1,1,1,2,1
KR_6696606684,420,5,87,45,14,-1,1,2,7,8,1,0,2,2,8,8,0,0,1,1,0,15,-24,2,6,8,-2,0,2,1,1,1,1,6,1
KR_6769894813,420,3,16,16,0,0,1,1,-4,2,6,1,1,0,1,2,1,2,2,0,0,1,-5,-5,8,3,7,0,0,1,0,0,1,2,1
KR_6764116816,420,1,-20,-23,6,1,3,2,-2,1,3,6,7,1,1,2,1,0,0,0,0,10,4,3,3,6,-2,0,-1,1,1,-1,-1,3,1
KR_6759197999,420,-1,-20,-18,1,-3,0,3,-1,1,2,3,4,1,1,3,2,1,1,0,0,-2,192,0,6,6,-1,0,0,-1,1,0,1,2,1
KR_6768049998,420,0,4,1,-1,0,1,1,4,4,0,-6,0,6,2,4,2,-1,0,1,0,7,1,-2,7,5,4,0,-1,-1,-1,1,-1,4,1
KR_6587872109,420,-3,56,-8,3,0,3,3,1,2,1,4,5,1,1,4,3,-3,0,3,0,1,21,0,5,5,4,0,-2,1,-1,-1,1,6,1
KR_6719836836,420,0,34,2,-3,-2,2,4,-3,2,5,-1,2,3,2,2,0,1,1,0,0,-3,1,-5,6,1,2,0,0,1,-1,1,-1,2,1
KR_6765573004,420,3,38,-1,3,-3,2,5,2,5,3,4,4,0,1,5,4,-1,0,1,0,9,465,0,5,5,-2,0,0,1,1,0,-1,3,1
KR_6693944353,420,1,-24,20,5,2,5,3,0,3,3,-2,1,3,4,4,0,1,2,1,0,7,5,4,4,8,1,0,0,1,-1,1,-1,6,1
KR_6715049400,420,7,64,20,17,2,4,2,5,6,1,3,5,2,7,7,0,0,0,0,0,8,-26,3,4,7,12,0,1,1,-1,1,1,5,1
KR_6675441229,440,1,23,12,5,5,5,0,1,8,7,1,2,1,1,2,1,-3,1,4,0,1,0,1,5,6,-2,0,1,1,1,1,1,5,1
KR_6755273571,420,-3,15,-2,-7,1,1,0,-1,0,1,-2,0,2,-5,1,6,0,3,3,1,-8,-3,4,3,7,-1,0,1,-1,1,1,1,1,1
KR_6708732445,420,6,36,16,8,1,1,0,8,10,2,1,2,1,-1,1,2,-1,0,1,0,3,274,1,2,3,6,0,1,-1,1,1,-1,1,1
KR_6760222613,420,-4,-10,4,-3,-4,2,6,0,3,3,-2,0,2,0,3,3,3,4,1,0,-1,25,1,4,5,-3,0,1,1,1,1,-1,3,1
KR_6742414235,420,5,70,26,9,-1,1,2,7,7,0,7,7,0,-2,0,2,-2,1,3,0,4,316,4,3,7,-2,0,2,-1,1,1,1,4,1
KR_6771926092,420,1,27,8,2,2,5,3,-1,1,2,-2,3,5,1,3,2,2,2,0,1,2,9,2,3,5,1,0,0,1,0,1,1,6,1
KR_6629438517,420,5,70,28,9,2,3,1,2,3,1,4,5,1,0,5,5,1,3,2,0,4,5,2,5,7,-3,0,2,1,1,1,1,2,1
KR_6657528316,420,4,101,24,7,3,4,1,5,5,0,1,3,2,-1,2,3,-1,0,1,-2,1,-9,2,5,7,0,0,2,1,1,1,-1,5,1
KR_6768667007,420,3,-15,28,6,4,4,0,-4,1,5,-3,3,6,8,8,0,1,2,1,-1,8,-2,0,7,7,1,0,0,1,1,0,-1,2,1
KR_6755664687,420,3,78,-16,9,4,4,0,1,4,3,0,4,4,2,3,1,2,2,0,0,4,-25,-3,6,3,3,0,1,-1,-1,1,1,5,1
KR_6532035591,420,2,53,24,4,2,3,1,1,4,3,0,1,1,1,4,3,0,0,0,0,6,41,-1,10,9,-2,0,1,1,-1,1,1,2,1
KR_6751329175,440,-1,-7,0,-3,2,3,1,-2,0,2,5,6,1,-4,1,5,-4,0,4,1,-4,29,0,5,5,4,0,1,-1,1,1,1,1,1
KR_6673890322,420,1,24,-16,11,4,4,0,2,3,1,-2,1,3,6,7,1,1,1,0,0,8,1,4,5,9,3,0,1,1,1,1,-1,3,1
KR_6563461930,420,0,38,-4,8,2,4,2,0,2,2,4,5,1,3,5,2,-1,0,1,0,5,202,4,3,7,-1,0,0,1,-1,1,-1,3,1
KR_6709796893,420,0,-1,-51,11,-5,3,8,1,1,0,5,5,0,7,7,0,3,3,0,0,10,3,-2,8,6,3,0,2,1,-1,1,1,2,1
KR_6698502243,420,3,43,0,7,1,2,1,3,4,1,3,4,1,-1,2,3,1,1,0,0,4,-4,-2,5,3,2,0,1,-1,1,1,1,4,1
KR_6744487430,420,1,-2,-8,-2,-1,1,2,1,4,3,-1,1,2,1,4,3,-2,0,2,0,-2,1,1,4,5,-2,0,1,-1,1,1,-1,5,1
KR_6625052049,420,0,31,-8,-4,0,3,3,-2,2,4,0,0,0,-1,2,3,-1,0,1,0,-8,-8,-2,5,3,-1,0,1,1,1,1,1,5,1
KR_6755496728,420,3,34,-16,5,5,8,3,0,3,3,-1,1,2,0,2,2,1,1,0,0,-1,3,2,4,6,4,0,0,-1,1,1,1,5,1
KR_6761093124,440,3,11,-4,8,0,0,0,2,2,0,6,7,1,-6,1,7,6,7,1,0,0,-6,-2,5,3,2,0,1,1,0,1,-1,2,1
KR_6746771882,420,5,-5,12,9,0,0,0,4,6,2,2,5,3,0,3,3,3,4,1,0,9,0,-2,6,4,3,0,0,1,-1,-1,-1,5,1
KR_6713134060,420,3,22,4,4,-7,0,7,2,4,2,5,6,1,3,4,1,1,2,1,0,6,18,-1,9,8,1,0,1,-1,1,1,-1,2,1
KR_6695465282,420,-1,18,0,-6,1,2,1,3,3,0,-6,1,7,0,1,1,-4,0,4,0,-7,-8,-4,5,1,2,0,1,-1,1,1,-1,5,1
KR_6766637344,440,-1,12,15,-1,-2,0,2,-3,0,3,4,5,1,0,3,3,0,1,1,0,2,4,3,2,5,2,0,-1,-1,1,-1,1,6,1
KR_6760378292,440,3,80,-7,4,0,3,3,0,3,3,2,3,1,0,1,1,2,2,0,1,3,-1,-3,9,6,1,0,0,0,-1,0,1,0,1
KR_6703180621,420,1,-4,-1,7,-2,2,4,6,7,1,0,3,3,2,8,6,1,1,0,0,8,-13,1,7,8,2,0,1,1,-1,1,-1,1,1
KR_6565803485,420,-1,14,8,-1,0,1,1,2,8,6,-2,5,7,1,4,3,-2,2,4,0,1,12,5,1,6,3,0,1,1,1,1,1,4,1
KR_6745659554,420,2,32,16,3,0,2,2,3,7,4,4,5,1,-6,1,7,2,4,2,0,2,-12,0,5,5,3,0,-1,1,-1,-1,-1,2,1
KR_6751058849,420,-4,5,-12,-1,0,1,1,4,7,3,-6,1,7,0,5,5,1,3,2,0,4,-23,0,5,5,-1,0,0,-1,1,-1,-1,1,1
KR_6724338485,420,-5,-53,-20,-10,-3,0,3,1,2,1,1,2,1,-7,0,7,-2,0,2,0,-6,15,3,5,8,-12,0,0,-1,0,0,-1,6,1
KR_6762803411,420,2,77,16,11,2,5,3,2,4,2,0,2,2,8,8,0,-1,5,6,0,11,-3,3,2,5,4,0,0,1,-1,0,1,1,1
KR_6643337163,420,3,-37,17,-2,1,3,2,-2,1,3,1,2,1,-2,1,3,0,1,1,0,-5,6,-1,5,4,-1,0,0,-1,-1,0,-1,6,1
KR_6749717095,420,1,18,-16,2,0,1,1,0,2,2,5,6,1,-2,1,3,-1,0,1,0,5,233,-2,6,4,5,0,-1,1,-1,-1,-1,3,1
KR_6770461360,420,6,159,69,16,3,3,0,3,5,2,4,4,0,4,6,2,2,2,0,0,12,5,5,2,7,2,0,3,1,1,1,1,3,1
KR_6766581558,420,1,-32,16,1,-2,0,2,-2,1,3,2,6,4,2,3,1,1,2,1,-1,4,135,0,7,7,4,0,1,1,-1,1,-1,5,1
KR_6744512672,420,3,53,6,14,10,11,1,3,5,2,-1,0,1,4,5,1,-2,1,3,1,13,5,1,5,6,0,0,1,1,-1,1,1,3,1
KR_6576255732,420,0,-6,-8,4,4,4,0,4,5,1,-1,3,4,-3,0,3,0,0,0,0,-1,-3,1,6,7,0,0,1,1,1,1,1,4,1
KR_6364648651,420,1,15,-1,5,3,3,0,-1,2,3,2,2,0,0,2,2,1,2,1,0,9,0,0,0,0,4,0,0,-1,1,0,-1,2,1
KR_6753249727,420,1,-20,23,3,-2,2,4,5,7,2,-1,3,4,1,1,0,0,0,0,-1,5,-70,-8,10,2,17,0,0,1,-1,-1,-1,5,1
KR_6738757412,440,0,-16,-24,3,0,0,0,-1,2,3,-1,4,5,4,7,3,1,1,0,-1,10,2,1,4,5,0,0,-1,-1,-1,-1,-1,2,1
KR_6680040654,420,5,56,3,14,5,7,2,3,4,1,2,2,0,3,4,1,1,1,0,0,11,2,0,7,7,2,0,2,1,1,1,1,2,1
KR_6715753210,440,0,60,1,2,-3,3,6,3,3,0,3,6,3,0,8,8,-1,0,1,0,5,292,1,5,6,0,0,2,1,1,1,1,1,1
KR_6750263496,420,1,-14,15,0,-1,0,1,-1,1,2,2,3,1,0,0,0,0,0,0,0,4,-9,3,3,6,0,0,0,1,1,0,-1,1,1
KR_6727478416,420,0,-2,4,0,0,3,3,-2,3,5,0,1,1,1,2,1,1,3,2,-1,0,7,-2,6,4,-2,0,0,-1,1,0,-1,5,1
KR_6720615343,420,3,30,-8,11,5,6,1,6,7,1,2,5,3,-3,1,4,1,2,1,0,6,7,1,5,6,-16,0,0,1,-1,1,-1,4,1
KR_6664820668,420,0,-15,8,2,1,4,3,-3,0,3,0,0,0,1,4,3,3,4,1,0,5,0,0,5,5,2,0,0,1,1,1,1,2,1
KR_6397776263,420,1,26,-20,6,-5,0,5,3,4,1,4,4,0,5,6,1,-1,0,1,0,10,3,-3,5,2,-2,0,-1,1,-1,-1,-1,5,1
KR_6737681769,420,2,-5,8,9,1,2,1,1,5,4,2,2,0,4,4,0,1,3,2,1,12,-11,-1,6,5,8,0,1,0,1,1,1,0,1
KR_6736215125,420,-1,-58,-12,0,-1,1,2,3,4,1,-1,0,1,-2,1,3,1,2,1,0,2,-8,0,3,3,3,0,0,-1,1,0,-1,3,1
KR_6137163820,420,8,80,33,14,4,7,3,4,5,1,2,4,2,3,6,3,1,1,0,2,12,163,3,5,8,-1,0,2,1,1,1,1,4,1
KR_6757191608,420,-2,6,-8,-7,-2,2,4,-1,4,5,-2,1,3,-2,3,5,0,3,3,1,-11,4,1,5,6,5,0,0,-1,1,0,1,1,1
KR_6722886303,420,2,27,9,0,3,3,0,-3,1,4,-2,2,4,-1,3,4,3,3,0,1,-5,-7,0,9,9,-1,0,1,1,1,1,1,3,1
KR_6649503815,420,2,-26,8,7,0,1,1,5,9,4,4,7,3,-2,2,4,0,1,1,-1,-1,1,1,5,6,4,0,1,-1,1,1,-1,4,1
KR_6769893779,420,2,75,26,2,4,5,1,-2,1,3,0,3,3,0,4,4,0,0,0,0,2,9,0,3,3,1,0,2,0,-1,1,1,0,1
KR_6768097284,420,1,-6,21,2,0,3,3,-4,1,5,1,2,1,5,5,0,0,2,2,-2,-10,14,-10,11,1,0,0,0,-1,1,0,-1,5,1
KR_6768572264,420,-2,-92,32,-3,0,0,0,-3,5,8,1,10,9,-2,2,4,1,1,0,2,0,-9,3,5,8,5,0,-1,-1,1,-1,1,1,1
KR_6760296085,420,4,76,10,3,2,2,0,-1,0,1,0,3,3,3,7,4,-1,0,1,0,-2,6,2,7,9,0,0,1,1,1,1,-1,5,1
KR_6698195327,420,2,-20,-16,0,-2,3,5,-1,2,3,-1,0,1,2,4,2,2,2,0,0,6,-10,-3,8,5,4,0,-1,1,-1,1,1,3,1
KR_6767212616,440,-3,-26,8,-5,1,2,1,0,3,3,2,3,1,-2,4,6,-6,1,7,1,-11,-19,0,5,5,3,0,-1,0,-1,-1,1,0,1
KR_6724484958,420,5,101,56,5,2,4,2,4,6,2,-2,2,4,2,2,0,-1,0,1,1,2,12,6,0,6,4,0,2,1,1,1,1,4,1
KR_6760710987,420,4,23,-11,12,1,1,0,6,6,0,2,2,0,3,3,0,0,0,0,0,13,16,1,4,5,7,0,1,1,-1,1,1,5,1
KR_6744922526,420,5,67,-4,17,6,6,0,-2,0,2,4,5,1,4,5,1,5,5,0,0,12,22,2,5,7,-1,0,0,1,1,1,1,5,1
KR_6768976964,420,3,31,42,1,-3,0,3,1,4,3,-1,2,3,1,2,1,3,3,0,0,-9,-13,-1,7,6,2,0,1,1,1,1,-1,3,1
KR_6705777779,420,-3,-73,-32,-5,-5,0,5,3,8,5,1,2,1,-3,2,5,-1,1,2,0,2,-10,-2,3,1,2,0,0,1,-1,-1,-1,2,1
KR_6545808892,420,6,77,29,7,1,3,2,1,3,2,8,10,2,-3,1,4,0,1,1,0,4,2,1,5,6,-1,0,0,-1,-1,1,-1,3,1
KR_6771377812,420,0,1,6,3,1,2,1,3,5,2,-4,1,5,3,3,0,0,0,0,0,6,3,-2,5,3,-3,0,0,0,0,0,-1,0,1
KR_6657993513,420,2,6,-44,11,2,2,0,-1,1,2,3,5,2,3,3,0,4,4,0,0,13,-2,5,3,8,-2,0,1,-1,1,1,-1,1,1
KR_6757207822,420,1,6,23,1,-2,1,3,-2,2,4,3,7,4,2,3,1,0,2,2,0,3,-116,-8,11,3,6,0,-2,1,-1,-1,1,3,1
KR_6771300860,420,1,-29,20,2,0,2,2,0,3,3,3,3,0,0,3,3,-1,2,3,0,6,-3,-2,6,4,2,0,0,1,1,0,-1,2,1
KR_6768610357,420,-2,-15,3,4,0,1,1,2,4,2,0,2,2,2,2,0,0,1,1,0,4,3,2,4,6,2,0,0,-1,-1,0,1,1,1
KR_6758074608,420,1,-41,16,3,-1,2,3,-2,1,3,3,4,1,3,3,0,0,0,0,0,2,-46,-3,7,4,21,0,0,1,-1,0,1,3,1
KR_6770566189,420,4,16,15,5,-2,1,3,5,6,1,0,2,2,1,4,3,1,2,1,0,13,-9,-6,9,3,7,0,1,-1,1,1,1,2,1
KR_6753262805,440,5,116,17,13,-3,0,3,5,6,1,7,7,0,3,3,0,1,1,0,1,15,-17,1,4,5,-2,0,1,1,0,1,1,3,1
KR_6701286577,420,-1,-26,8,-3,-2,0,2,-6,1,7,0,4,4,5,8,3,0,1,1,0,-5,-7,-7,7,0,2,0,1,-1,1,1,-1,2,1
KR_6679223636,420,-2,-107,16,-4,-3,2,5,-1,1,2,0,2,2,-1,0,1,1,1,0,0,0,-67,4,5,9,4,0,0,1,-1,-1,-1,1,1
KR_6679035037,420,4,55,-4,3,1,2,1,-4,1,5,2,3,1,3,3,0,1,1,0,0,2,-5,3,3,6,6,0,2,1,1,1,-1,6,1
KR_6705385695,440,2,78,26,-9,-3,4,7,-1,6,7,1,3,2,-4,1,5,-2,2,4,0,-5,-3,0,5,5,1,0,0,-1,0,1,-1,3,1
KR_6671623990,440,5,71,32,5,1,1,0,0,4,4,5,5,0,1,4,3,-2,0,2,0,3,132,0,5,5,-1,0,2,1,1,1,1,5,1
KR_6770747664,440,0,73,-4,2,4,4,0,3,4,1,0,3,3,-4,1,5,-1,3,4,0,2,-6,9,4,13,2,0,0,1,1,-1,-1,2,1
KR_6438639196,420,-2,-56,-11,-9,-2,1,3,0,4,4,-1,0,1,-6,1,7,0,2,2,0,-10,3,-2,5,3,-5,0,-1,-1,1,-1,-1,3,1
KR_6764293711,420,6,101,29,11,5,6,1,1,5,4,1,2,1,2,2,0,2,2,0,-1,9,5,3,2,5,2,0,4,1,1,1,-1,3,1
KR_6696357391,420,3,35,-7,9,5,5,0,5,6,1,-2,1,3,2,2,0,-1,0,1,0,5,-5,5,3,8,4,0,0,-1,0,0,1,2,1
KR_6746545866,420,1,-3,15,1,-4,0,4,-1,3,4,5,8,3,1,2,1,0,2,2,2,7,-5,1,2,3,-1,0,0,1,-1,1,1,6,1
KR_6702831592,420,-4,3,-4,-5,-5,0,5,0,1,1,-4,1,5,2,4,2,2,3,1,0,-5,-15,6,2,8,-1,0,0,1,-1,-1,-1,3,1
KR_6693219623,420,5,94,0,9,0,2,2,2,5,3,0,3,3,5,5,0,2,2,0,0,14,0,2,2,4,4,0,3,1,1,1,1,2,1
KR_6755531973,420,3,27,9,9,3,4,1,4,4,0,2,4,2,0,2,2,0,1,1,0,4,261,-3,7,4,1,0,0,1,-1,0,1,2,1
KR_6755560004,420,1,21,-22,5,1,2,1,0,2,2,1,5,4,0,3,3,3,6,3,-1,6,-5,0,3,3,-1,0,0,0,1,0,-1,0,1
KR_6706542920,440,1,-44,33,3,-6,1,7,2,5,3,0,4,4,4,4,0,3,3,0,0,1,21,0,3,3,-5,0,-1,1,-1,-1,-1,5,1
KR_6738089462,420,4,33,10,10,5,7,2,-1,2,3,-2,0,2,7,8,1,1,3,2,1,17,-3,-3,5,2,3,0,0,1,-1,1,1,1,1
KR_6709615807,420,3,20,24,5,-1,2,3,6,9,3,4,7,3,-3,0,3,-1,1,2,1,-4,-31,0,7,7,2,0,1,1,1,1,1,2,1
KR_6769825371,420,-2,-64,-11,2,1,4,3,0,1,1,-2,2,4,2,3,1,1,1,0,0,9,-6,3,6,9,1,0,0,0,1,0,-1,0,1
KR_6711779445,440,1,16,16,-2,3,3,0,-3,0,3,-3,1,4,0,4,4,1,1,0,0,-4,-9,4,3,7,-6,0,1,-1,1,1,1,6,1
KR_6759861852,420,4,74,38,7,0,5,5,3,4,1,2,3,1,0,3,3,2,3,1,1,4,16,5,2,7,-2,0,1,1,1,1,1,3,1
KR_6759205591,420,6,56,-16,9,1,1,0,-3,3,6,6,6,0,-2,3,5,7,7,0,0,-2,9,8,2,10,-3,0,2,1,1,1,1,3,1
KR_6387086349,420,3,76,19,10,-4,1,5,7,10,3,2,2,0,5,5,0,0,1,1,0,11,4,0,6,6,2,0,1,0,1,1,1,0,1
KR_6768350103,420,2,15,5,3,1,2,1,0,3,3,-2,3,5,2,4,2,2,4,2,0,2,-1,0,5,5,-1,0,1,1,-1,1,1,4,1
KR_6677877901,420,1,26,5,1,-4,1,5,2,2,0,-1,3,4,4,4,0,0,1,1,0,4,-4,-3,5,2,1,0,1,1,-1,1,1,3,1
KR_6759942411,440,3,33,11,13,1,3,2,1,4,3,5,5,0,5,6,1,1,1,0,0,15,3,5,5,10,3,0,2,1,1,1,-1,4,1
KR_6726469466,420,-1,4,21,2,0,3,3,4,6,2,-2,2,4,3,3,0,-3,0,3,1,-4,9,1,5,6,-1,0,-1,1,1,1,1,5,1
KR_6543338989,420,3,53,8,1,0,0,0,-6,1,7,5,6,1,-2,1,3,4,4,0,0,6,7,-1,7,6,0,0,1,-1,-1,-1,1,6,1
KR_6744602798,440,2,18,11,3,4,5,1,1,1,0,1,1,0,-1,1,2,-2,0,2,0,-1,2,-2,7,5,0,0,1,-1,1,1,1,1,1
KR_6722953833,440,4,69,4,10,3,3,0,2,4,2,0,3,3,5,7,2,0,1,1,0,6,-6,-1,6,5,-1,0,3,1,1,1,1,1,1
KR_6728690955,420,-2,37,8,-6,0,4,4,-2,2,4,-1,1,2,-1,2,3,-2,0,2,0,-4,1,3,4,7,-1,0,0,1,-1,0,-1,3,1
KR_6667705336,420,3,70,16,7,1,3,2,3,5,2,4,6,2,1,3,2,-2,0,2,0,9,17,-5,8,3,-1,0,2,1,1,1,1,5,1
KR_6727142532,440,0,69,12,3,1,2,1,1,1,0,1,1,0,2,2,0,-2,1,3,0,5,-2,5,1,6,-2,0,1,0,1,1,1,0,1
KR_6761552823,440,0,26,7,2,0,1,1,3,3,0,-4,3,7,5,8,3,-2,1,3,0,-2,-4,1,2,3,2,0,0,1,0,0,1,3,1
KR_6743212851,440,1,-12,13,7,-1,0,1,3,6,3,6,9,3,0,2,2,-1,1,2,0,1,11,5,6,11,-1,0,2,1,1,1,1,2,1
KR_6695327862,420,2,-34,-8,5,-1,2,3,9,10,1,-1,3,4,2,5,3,-4,1,5,0,13,-2,-2,3,1,1,0,-1,-1,-1,-1,-1,6,1
KR_6749333561,420,-1,27,3,-1,0,1,1,1,1,0,0,1,1,0,3,3,-2,2,4,0,3,-4,-3,6,3,-4,0,-1,0,1,-1,-1,0,1
KR_6738487989,440,1,25,-1,9,1,1,0,-3,3,6,5,5,0,5,5,0,1,1,0,0,10,43,2,5,7,-35,0,0,1,1,0,1,2,1
KR_6768336231,420,-1,-8,0,2,-2,1,3,-2,1,3,2,3,1,2,6,4,2,2,0,0,5,-4,-5,8,3,7,0,0,1,-1,0,1,2,1
KR_6703612516,420,2,25,9,6,1,2,1,6,10,4,-1,2,3,-1,2,3,1,2,1,1,3,-1,3,9,12,-4,0,1,-1,1,1,1,1,1
KR_6771627663,420,1,108,7,5,2,3,1,1,2,1,-1,3,4,2,3,1,1,1,0,0,-1,-6,-2,7,5,4,0,0,1,-1,1,1,2,1
KR_6668621093,420,2,8,-5,9,-3,0,3,2,4,2,0,1,1,10,11,1,0,2,2,-1,18,4,-1,4,3,7,0,0,-1,1,1,-1,1,1
KR_6771047422,420,-1,26,-16,4,3,4,1,-4,0,4,0,1,1,-1,4,5,6,6,0,1,-2,-36,0,5,5,1,0,1,-1,1,1,1,6,1
KR_6760455828,420,-1,-12,-4,-2,-1,1,2,-1,0,1,-4,2,6,3,4,1,1,1,0,0,-1,7,3,3,6,-3,0,-1,1,-1,-1,1,4,1
KR_6717869043,420,3,-2,23,7,-1,1,2,1,4,3,3,3,0,4,4,0,0,2,2,0,15,-3,-1,8,7,5,0,2,1,1,1,1,4,1
KR_6712437709,420,4,-12,46,11,0,2,2,6,9,3,1,2,1,1,4,3,3,4,1,1,21,1,2,3,5,-2,0,0,1,-1,0,1,5,1
KR_6740396166,420,-1,-28,-15,0,-4,0,4,-3,2,5,1,3,2,3,4,1,3,3,0,0,2,30,4,3,7,-1,0,0,1,1,1,-1,3,1
KR_6552109738,420,-2,59,8,2,2,3,1,-1,2,3,0,2,2,2,5,3,-1,1,2,0,6,-23,3,2,5,5,0,0,1,-1,-1,-1,1,1
KR_6762764458,420,8,87,52,15,0,2,2,5,5,0,2,3,1,0,3,3,8,8,0,1,8,-156,1,3,4,-1,0,2,1,1,1,1,5,1
KR_6725372830,420,4,-7,20,7,4,4,0,-4,1,5,7,7,0,-2,2,4,2,4,2,0,-2,-34,2,4,6,3,0,1,0,1,1,1,0,1
KR_6768438962,420,3,-22,4,8,-1,1,2,-2,1,3,2,3,1,8,10,2,1,1,0,0,14,7,-2,6,4,-1,0,-1,1,-1,-1,1,6,1
KR_6765068715,420,5,81,25,9,2,2,0,6,6,0,1,3,2,1,5,4,-1,0,1,0,3,2,-6,10,4,0,0,1,1,1,1,1,5,1
KR_6768190038,420,1,77,12,0,2,6,4,-1,1,2,-1,3,4,0,1,1,0,0,0,0,-5,10,0,3,3,-1,0,2,-1,1,1,-1,6,1
KR_6766145196,420,4,141,5,4,2,5,3,-2,0,2,5,7,2,-2,2,4,1,2,1,0,2,6,4,1,5,-2,0,6,-1,1,1,1,5,1
KR_6734088411,420,2,25,30,8,2,3,1,-4,1,5,-2,1,3,3,4,1,9,9,0,-1,2,9,1,2,3,0,0,0,1,-1,0,-1,6,1
KR_6717030138,420,0,-102,-7,1,-6,1,7,1,4,3,2,7,5,3,5,2,1,1,0,-1,18,-5,0,8,8,4,0,-1,1,-1,-1,-1,2,1
KR_6577470669,420,-1,-26,12,-1,-1,0,1,3,3,0,0,3,3,-2,3,5,-1,0,1,0,-9,2,1,5,6,-5,0,0,1,-1,0,-1,2,1
KR_6755734613,420,-3,-22,-16,-6,-1,1,2,0,0,0,-3,2,5,-3,0,3,1,2,1,0,-4,2,1,3,4,-2,0,0,0,-1,0,-1,0,1
KR_6505510567,420,6,26,24,15,3,3,0,6,7,1,1,2,1,5,6,1,0,0,0,1,19,-31,3,5,8,35,0,1,1,1,1,1,2,1
KR_6765738380,420,3,44,15,16,7,8,1,1,5,4,8,8,0,-1,4,5,1,2,1,1,14,7,3,1,4,2,0,2,1,1,1,1,5,1
KR_6768812876,420,3,31,20,7,-1,3,4,2,3,1,1,4,3,2,4,2,3,3,0,0,12,3,1,4,5,-3,0,1,1,1,1,1,5,1
KR_6764435080,420,2,3,-7,10,0,3,3,1,2,1,0,2,2,8,8,0,1,1,0,0,12,0,4,2,6,1,0,-1,1,1,1,1,2,1
KR_6750811784,420,2,-19,48,5,0,3,3,4,7,3,1,3,2,0,2,2,0,1,1,0,9,-6,2,4,6,3,0,2,0,1,1,1,0,1
KR_6769208417,420,1,60,-6,11,0,3,3,6,9,3,2,3,1,2,3,1,1,5,4,0,12,3,8,2,10,3,0,2,1,-1,1,-1,4,1
KR_6581155874,420,0,59,37,3,-5,1,6,-1,3,4,2,6,4,4,4,0,3,3,0,1,13,4,1,2,3,1,0,0,-1,-1,1,1,6,1
KR_6319469874,420,4,51,-12,2,0,0,0,1,2,1,3,5,2,-1,0,1,-1,0,1,0,0,-7,4,3,7,-2,0,0,-1,-1,0,1,4,1
KR_6749463562,440,-2,85,-12,0,1,2,1,2,5,3,-3,0,3,0,3,3,0,2,2,0,-1,438,2,3,5,-1,0,0,-1,1,0,1,1,1
KR_6548503911,420,-2,18,28,-3,-1,0,1,0,2,2,-2,1,3,0,4,4,0,1,1,0,-8,-9,-2,8,6,1,0,-1,1,1,-1,1,4,1
KR_6718662296,420,5,-12,33,16,6,6,0,7,7,0,1,3,2,1,5,4,1,4,3,2,20,20,6,0,6,-1,0,2,1,1,1,1,3,1
KR_6728572284,440,2,-3,0,12,0,2,2,2,3,1,-1,0,1,6,7,1,5,5,0,0,13,8,4,3,7,1,0,2,-1,1,1,-1,1,1
KR_6762604091,440,-2,-44,-19,2,0,1,1,1,2,1,-3,0,3,1,3,2,3,5,2,0,7,-46,-3,8,5,1,0,0,1,-1,0,1,5,1
KR_6725271088,420,-1,33,6,-1,1,3,2,1,1,0,-2,2,4,-1,2,3,0,1,1,0,-5,4,3,2,5,-3,0,1,1,1,1,1,2,1
KR_6742861474,420,-1,-1,-32,-1,-1,0,1,0,4,4,1,3,2,1,2,1,-2,1,3,0,2,-79,-5,7,2,1,0,0,-1,1,-1,-1,3,1
KR_6741514590,440,4,71,11,5,5,6,1,-3,6,9,-1,2,3,0,2,2,4,5,1,0,1,37,-2,5,3,-11,0,3,1,0,1,1,2,1
KR_6770156989,420,3,67,32,5,2,3,1,1,4,3,-3,0,3,5,8,3,0,3,3,-2,2,-294,1,4,5,4,0,1,1,1,1,1,3,1
KR_6767262179,420,6,-25,28,14,8,8,0,1,3,2,0,1,1,4,5,1,1,4,3,-2,11,13,-1,6,5,-3,0,0,0,1,0,-1,0,1
KR_6771480943,420,3,89,-4,9,2,3,1,-2,1,3,1,3,2,-2,0,2,10,13,3,0,9,-14,1,2,3,7,0,1,1,1,1,1,3,1
KR_6747954187,420,3,23,-1,5,-1,1,2,-1,4,5,4,5,1,4,6,2,-1,0,1,0,1,3,0,5,5,-2,0,0,1,1,0,1,2,1
KR_6768387139,420,0,-7,24,4,1,2,1,8,9,1,2,2,0,-6,0,6,-1,2,3,0,5,0,-5,9,4,3,0,0,1,1,0,-1,4,1
KR_6764458723,440,-5,-10,-31,-7,-2,2,4,-1,1,2,-3,5,8,-1,7,8,0,4,4,0,-7,-37,2,2,4,-1,0,0,1,0,-1,-1,5,1
KR_6755703239,420,4,41,-32,10,2,2,0,-1,1,2,3,3,0,5,5,0,1,2,1,0,6,-9,2,4,6,4,0,1,1,-1,1,1,4,1
KR_6767929582,420,5,7,20,10,-2,1,3,5,6,1,5,6,1,2,2,0,0,0,0,0,12,-6,0,5,5,0,0,1,1,-1,1,-1,5,1
KR_6680181130,420,2,60,1,4,3,5,2,2,3,1,-1,1,2,0,5,5,0,1,1,0,3,14,3,3,6,-6,0,1,1,-1,1,1,6,1
KR_6743186192,440,3,27,5,0,2,7,5,-2,1,3,-2,1,3,2,5,3,0,1,1,-1,-1,100,-6,10,4,-2,0,2,0,1,1,-1,0,1
KR_6679195114,420,4,40,24,4,2,4,2,1,4,3,1,2,1,2,3,1,-2,1,3,0,9,10,5,3,8,-2,0,0,1,-1,1,-1,2,1
KR_6762575337,420,0,-16,-3,2,6,6,0,0,2,2,-3,0,3,-1,2,3,0,0,0,0,0,-27,0,6,6,4,0,0,-1,1,0,1,2,1
KR_6771001736,420,2,46,0,6,2,2,0,0,5,5,-2,2,4,4,5,1,2,2,0,-1,13,-7,5,0,5,1,0,1,-1,-1,1,-1,2,1
KR_6718451998,420,2,87,8,8,8,8,0,2,6,4,4,5,1,2,5,3,-8,0,8,-1,-2,2,-1,3,2,-4,0,3,0,0,1,-1,0,1
KR_6750934015,440,-2,-7,-10,0,2,2,0,0,3,3,2,3,1,-3,4,7,-1,2,3,0,3,-5,-3,5,2,6,0,0,-1,1,1,1,3,1
KR_6768869728,420,3,-31,35,8,-6,0,6,2,4,2,3,4,1,2,5,3,7,7,0,0,11,9,1,4,5,-1,0,-1,1,-1,-1,-1,4,1
KR_6767548658,420,2,-10,-12,3,5,6,1,-2,0,2,1,3,2,-2,3,5,1,1,0,0,0,-22,1,7,8,3,0,1,-1,1,1,1,1,1
KR_6760650072,420,0,4,-17,-2,3,3,0,5,9,4,-3,1,4,-7,0,7,0,2,2,1,3,-19,2,3,5,-1,0,-2,-1,-1,-1,1,1,1
KR_6714233977,420,4,76,-10,10,-1,1,2,6,8,2,-1,1,2,6,8,2,0,2,2,1,17,2,0,4,4,8,0,2,1,1,1,1,5,1
KR_6769644761,420,1,71,28,3,3,3,0,-5,3,8,4,7,3,1,7,6,0,2,2,2,-7,-58,4,2,6,2,0,0,1,-1,0,1,4,1
KR_6737125095,420,1,30,25,3,-2,4,6,-2,1,3,9,11,2,-3,3,6,1,2,1,0,4,-19,-2,7,5,4,0,0,1,1,-1,1,1,1
KR_6686944240,420,4,76,1,11,1,2,1,6,6,0,2,2,0,3,4,1,-1,1,2,-1,20,-103,3,2,5,2,0,2,-1,-1,1,-1,6,1
KR_6766773504,440,0,35,-16,-1,-2,0,2,-2,0,2,3,4,1,-2,1,3,2,3,1,0,-2,2,0,5,5,1,0,0,1,1,1,1,3,1
KR_6349548319,420,3,34,3,5,-3,1,4,6,7,1,2,2,0,1,3,2,-1,1,2,0,3,27,7,1,8,0,0,2,-1,1,1,1,2,1
KR_6139989013,420,8,100,34,15,5,5,0,2,3,1,2,3,1,6,7,1,0,0,0,0,10,1,0,5,5,3,1,5,1,1,1,-1,4,1
KR_6761915859,420,3,34,32,1,-2,0,2,3,3,0,-1,0,1,2,2,0,-1,0,1,0,-1,-53,3,2,5,0,0,1,1,-1,1,-1,4,1
KR_6768253792,420,0,29,5,2,0,1,1,-1,2,3,0,1,1,4,7,3,-1,0,1,0,2,4,-1,6,5,-6,0,0,1,-1,0,1,2,1
KR_6662619343,420,-4,-17,-8,0,-2,0,2,1,4,3,-1,1,2,-1,2,3,3,3,0,0,-6,-268,-2,5,3,3,0,-1,1,-1,-1,1,3,1
KR_6735184202,420,6,60,12,5,0,2,2,6,7,1,2,4,2,-3,4,7,0,1,1,0,4,3,2,2,4,3,0,1,-1,1,1,1,3,1
KR_6609741358,420,0,18,-12,-4,0,2,2,-1,2,3,2,2,0,-4,2,6,-1,1,2,0,-7,2,0,4,4,-2,0,0,-1,-1,-1,-1,1,1
KR_6743801648,420,2,75,7,-2,-1,1,2,2,3,1,2,2,0,-4,0,4,-1,1,2,0,0,9,3,3,6,3,0,2,1,1,1,-1,3,1
KR_6651059542,440,-2,10,-4,0,0,2,2,-1,4,5,0,2,2,1,2,1,0,1,1,0,-6,0,-3,10,7,-1,0,0,1,1,0,-1,5,1
KR_6621561625,420,-1,22,20,-6,-1,0,1,0,3,3,-1,1,2,-1,1,2,-3,0,3,0,-6,-32,0,5,5,4,0,0,1,-1,0,-1,5,1
KR_6762166467,420,-6,-24,-15,-9,-1,2,3,4,5,1,-2,1,3,-3,2,5,-7,0,7,-1,-11,5,-3,5,2,2,0,-1,-1,1,-1,-1,6,1
KR_6767925184,440,2,34,-8,11,6,6,0,1,3,2,0,2,2,3,6,3,1,1,0,0,7,-3,-2,5,3,1,0,0,-1,0,0,1,6,1
KR_6763542973,420,5,50,12,6,0,1,1,6,9,3,0,1,1,1,3,2,-1,1,2,-2,0,8,4,2,6,3,0,0,1,1,1,-1,3,1
KR_6301120703,420,5,-31,-6,12,5,5,0,2,5,3,1,3,2,3,5,2,1,1,0,0,9,-21,-1,6,5,-4,0,1,-1,1,1,-1,6,1
KR_6750100752,420,1,17,-4,6,2,2,0,1,1,0,1,1,0,2,3,1,0,0,0,0,6,-245,3,1,4,1,0,1,1,1,1,1,4,1
KR_6737643321,420,2,58,8,4,2,2,0,3,5,2,2,3,1,-1,3,4,-2,1,3,0,3,-1,-1,4,3,5,0,2,-1,1,1,-1,3,1
KR_6665658105,420,0,-15,9,2,-1,3,4,1,1,0,2,4,2,-3,1,4,3,5,2,0,-1,17,-2,4,2,-3,0,-1,1,-1,-1,-1,6,1
KR_6625787073,440,2,-24,88,4,-1,0,1,0,2,2,1,1,0,3,4,1,1,1,0,0,6,-41,-2,4,2,22,0,1,1,1,1,1,6,1
KR_6683884813,420,0,-42,5,-7,2,3,1,-6,0,6,-1,1,2,-2,2,4,0,1,1,-1,-9,4,-3,6,3,0,0,0,1,1,1,-1,3,1
KR_6767520845,420,1,12,-2,5,3,3,0,-3,2,5,3,4,1,-1,5,6,3,3,0,0,3,1,-5,7,2,4,0,0,1,-1,1,1,1,1
KR_6762813963,420,-1,-5,-16,0,-1,0,1,2,3,1,-1,2,3,0,3,3,0,1,1,0,-4,-3,2,8,10,2,0,1,1,1,1,1,4,1
KR_6540376342,420,2,-5,25,10,-1,0,1,6,7,1,2,3,1,2,3,1,1,2,1,0,9,-33,-2,6,4,29,0,3,1,-1,1,1,5,1
KR_6771791216,420,-2,-66,-8,2,-2,1,3,2,7,5,1,4,3,-3,3,6,4,4,0,0,4,-10,3,2,5,1,0,0,1,0,0,1,1,1
KR_6682065811,420,6,138,9,10,5,5,0,-3,1,4,5,5,0,4,5,1,-1,0,1,0,10,11,0,2,2,-1,0,1,-1,1,1,1,3,1
KR_6720540832,420,3,11,12,-1,-2,2,4,-2,0,2,3,7,4,0,1,1,0,1,1,0,3,-1,1,3,4,4,0,1,0,1,1,-1,0,1
KR_6771799337,420,2,70,-9,3,0,1,1,-4,1,5,4,4,0,1,2,1,2,2,0,-1,4,-1,-1,5,4,-1,0,1,-1,-1,1,-1,4,1
KR_6684370797,420,0,8,-12,-2,1,3,2,-7,1,8,1,4,3,4,5,1,-1,1,2,2,-1,7,7,6,13,-5,0,0,1,1,1,1,3,1
KR_6771671017,420,3,72,24,9,5,7,2,-1,1,2,4,6,2,0,2,2,1,2,1,0,5,-38,-6,8,2,0,0,0,1,1,1,1,6,1
KR_6740380922,420,3,22,7,7,1,2,1,-2,2,4,1,2,1,6,7,1,1,1,0,0,11,3,4,4,8,0,0,0,1,-1,0,1,2,1
KR_6606253490,440,3,27,-15,3,-1,1,2,4,6,2,0,2,2,-1,3,4,1,1,0,-3,2,22,1,7,8,-1,0,1,1,-1,1,-1,3,1
KR_6732268636,420,5,70,36,1,-3,0,3,1,3,2,2,3,1,1,2,1,0,0,0,0,0,1,2,3,5,1,0,1,1,1,1,-1,1,1
KR_6659764984,420,2,82,-7,5,2,3,1,1,3,2,0,3,3,2,3,1,0,1,1,-1,-1,9,4,4,8,-1,0,2,1,1,1,-1,2,1
KR_6733715685,420,4,19,20,7,6,8,2,-2,1,3,1,2,1,-1,0,1,3,3,0,0,5,104,-2,7,5,6,0,1,0,1,1,-1,0,1
KR_6448567538,420,2,65,-14,5,-3,1,4,4,8,4,0,1,1,2,7,5,2,2,0,0,4,-1,4,1,5,-1,0,1,0,1,1,-1,0,1
KR_6687072598,420,5,98,-22,7,6,6,0,1,3,2,-2,2,4,1,3,2,1,2,1,-1,4,-6,-3,6,3,-7,0,1,0,-1,1,-1,0,1
KR_6759285562,420,2,-2,-8,0,5,5,0,-2,2,4,-5,0,5,0,2,2,2,2,0,0,-5,-51,-2,6,4,3,0,1,-1,1,1,1,4,1
KR_6770422849,420,3,7,33,1,1,3,2,-6,5,11,6,8,2,0,2,2,0,2,2,-2,18,-4,-2,7,5,2,0,1,1,0,-1,-1,2,1
KR_6771215912,440,-2,-13,19,2,2,6,4,0,3,3,4,5,1,-2,2,4,-2,0,2,1,7,-21,3,4,7,5,0,1,-1,1,1,1,6,1
KR_6767985347,420,1,-70,-10,1,-1,0,1,-2,3,5,3,3,0,0,1,1,1,2,1,0,6,-37,-2,6,4,18,0,-2,-1,-1,-1,1,2,1
KR_6770095481,420,3,-7,52,0,0,1,1,1,3,2,0,1,1,0,1,1,-1,0,1,0,-1,-1,0,5,5,0,0,0,-1,-1,0,-1,5,1
KR_6627134234,420,3,54,0,17,3,3,0,5,9,4,5,5,0,2,4,2,2,3,1,0,9,4,2,3,5,6,0,1,0,0,1,1,0,1
KR_6691781747,420,0,135,-16,12,6,7,1,3,6,3,2,4,2,1,1,0,0,1,1,0,3,-181,0,3,3,-1,0,-1,1,-1,-1,1,5,1
KR_6614797068,420,0,28,12,5,0,2,2,1,4,3,2,3,1,2,3,1,0,0,0,1,4,-2,-3,5,2,3,0,1,1,-1,1,1,6,1
KR_6737792719,420,3,55,-18,13,-3,1,4,5,5,0,7,9,2,5,6,1,-1,2,3,0,9,-20,-3,9,6,3,0,-1,-1,-1,1,1,6,1
KR_6745483383,420,3,-32,28,7,1,3,2,8,8,0,-3,3,6,-1,1,2,2,3,1,0,1,-3,-2,5,3,-3,0,0,-1,1,0,-1,1,1
KR_6685145392,440,2,62,12,4,-2,1,3,-2,0,2,5,8,3,1,3,2,2,6,4,0,5,-10,1,4,5,5,0,2,1,1,1,1,3,1
KR_6680313525,420,-1,5,-31,1,-3,0,3,3,3,0,-1,1,2,2,5,3,0,1,1,1,3,6,-1,7,6,-3,0,0,1,-1,0,1,4,1
KR_6717764192,420,3,21,20,12,-1,1,2,0,2,2,4,4,0,7,8,1,2,5,3,2,12,-5,-5,7,2,3,0,1,1,-1,1,1,3,1
KR_6767109211,420,4,41,-3,6,0,1,1,2,3,1,0,1,1,-1,3,4,5,5,0,0,4,-52,-1,4,3,5,0,0,-1,-1,0,1,1,1
KR_6755741272,420,3,68,6,8,1,2,1,3,4,1,0,4,4,7,9,2,-3,0,3,1,0,-3,2,6,8,0,0,2,1,1,1,1,3,1
KR_6742507993,440,2,34,4,5,3,3,0,1,2,1,-2,2,4,5,8,3,-2,1,3,2,9,-3,-4,7,3,3,0,2,1,-1,1,1,2,1
KR_6698947299,420,0,6,-14,-3,-1,1,2,-3,3,6,-5,2,7,4,5,1,2,3,1,0,0,32,0,4,4,-4,0,1,1,-1,1,-1,3,1
KR_6485750272,420,6,65,31,12,2,2,0,3,3,0,2,3,1,5,6,1,0,3,3,0,13,-15,2,3,5,3,0,1,1,-1,1,1,5,1
KR_6735285177,420,1,43,16,2,-1,3,4,0,1,1,3,6,3,-1,1,2,1,2,1,0,-2,47,3,3,6,-18,0,2,-1,1,1,1,1,1
KR_6587155067,420,1,26,-8,2,4,5,1,-6,2,8,2,2,0,2,5,3,0,0,0,0,0,-59,3,3,6,3,0,0,1,-1,1,-1,4,1
KR_6721643834,420,5,74,-14,5,4,4,0,-2,1,3,0,2,2,1,6,5,2,2,0,0,4,25,7,3,10,1,0,3,-1,1,1,1,6,1
KR_6768320699,420,2,72,28,8,6,9,3,2,4,2,-1,2,3,1,5,4,0,1,1,0,7,-6,-5,8,3,2,0,3,-1,1,1,-1,4,1
KR_6687271657,420,3,33,14,6,-2,1,3,3,4,1,5,5,0,0,3,3,0,2,2,0,7,0,-2,9,7,3,0,1,1,-1,1,1,2,1
KR_6768642608,440,1,14,-7,5,2,3,1,-1,2,3,0,1,1,6,7,1,-2,1,3,1,9,-20,2,7,9,-1,0,-1,-1,-1,-1,1,2,1
KR_6762894302,420,0,44,4,6,0,2,2,2,2,0,0,1,1,3,3,0,1,2,1,0,11,5,1,5,6,2,0,1,-1,1,1,1,6,1
KR_6743317774,420,-3,35,-12,-6,1,3,2,1,2,1,0,2,2,-3,0,3,-5,1,6,0,-10,-5,-4,8,4,1,0,0,-1,1,1,-1,1,1
KR_6757917680,420,2,-36,29,9,1,1,0,1,3,2,2,3,1,2,4,2,3,3,0,0,9,12,-1,8,7,6,0,0,1,1,1,1,2,1
KR_6742147906,420,6,52,36,10,6,7,1,5,6,1,-1,2,3,-2,3,5,2,4,2,0,11,-203,-2,7,5,2,0,0,1,1,1,-1,1,1
KR_6731612800,420,5,50,-4,8,1,4,3,-1,3,4,2,2,0,7,10,3,-1,0,1,0,4,6,5,3,8,-2,0,1,-1,1,1,1,2,1
KR_6685967769,420,2,-16,-4,2,-1,1,2,-1,2,3,0,2,2,4,4,0,0,1,1,0,9,-17,0,5,5,0,0,1,-1,-1,-1,-1,3,1
KR_6705245183,420,2,63,18,8,-2,1,3,2,2,0,1,2,1,7,8,1,0,0,0,0,12,4,-2,6,4,0,0,1,1,-1,1,1,3,1
KR_6763123487,420,3,121,33,4,3,3,0,3,3,0,-1,3,4,-3,4,7,2,3,1,1,0,-28,-5,6,1,4,0,2,1,1,1,1,4,1
KR_6768888109,420,-3,-57,18,1,-1,2,3,-1,2,3,5,5,0,-2,1,3,0,0,0,0,4,10,-5,6,1,2,0,0,0,0,0,-1,0,1
KR_6728739298,420,4,67,15,2,3,3,0,-2,0,2,-2,4,6,4,4,0,-1,0,1,-1,-5,-12,-3,9,6,2,0,0,-1,1,1,-1,6,1
KR_6767380815,420,-2,17,-20,1,-2,1,3,2,4,2,0,0,0,4,6,2,-3,2,5,0,8,-9,-1,3,2,2,0,-1,1,-1,-1,-1,6,1
KR_6750806452,420,-2,29,16,-7,2,3,1,-4,0,4,0,4,4,-3,5,8,-2,1,3,0,-18,-21,-2,7,5,2,0,1,1,-1,1,1,4,1
KR_6490595440,420,5,28,50,18,5,6,1,0,1,1,7,7,0,3,8,5,3,3,0,3,15,3,2,3,5,3,0,1,1,-1,1,1,4,1
KR_6719613052,420,3,61,1,7,0,1,1,3,4,1,4,5,1,1,2,1,-1,0,1,1,11,5,3,2,5,1,0,1,1,1,1,1,1,1
KR_6397950230,420,-1,-50,-16,0,3,5,2,-2,1,3,4,4,0,-3,0,3,-2,1,3,0,7,1,1,3,4,2,0,0,-1,-1,-1,-1,5,1
KR_6714403802,420,0,13,-7,4,-6,0,6,3,6,3,1,4,3,4,6,2,2,2,0,3,19,1,0,5,5,-6,0,-1,1,-1,-1,1,2,1
KR_6530611813,420,6,5,46,11,2,6,4,-5,0,5,6,7,1,6,6,0,2,4,2,-1,12,4,-6,8,2,3,0,2,1,1,1,-1,4,1
KR_6154420381,440,4,101,-16,5,1,4,3,-3,1,4,1,3,2,4,6,2,2,2,0,-2,-2,-21,3,6,9,4,0,1,1,-1,1,-1,3,1
KR_6767165090,420,4,47,29,5,1,2,1,2,4,2,0,3,3,2,2,0,0,0,0,0,0,-17,0,3,3,5,0,1,1,-1,1,1,2,1
KR_6728811022,420,5,32,43,5,4,5,1,-1,1,2,3,4,1,-3,0,3,2,2,0,0,5,-1,-1,5,4,-2,0,1,-1,1,1,-1,1,1
KR_6707715409,440,-3,-11,-1,-1,0,2,2,-1,2,3,4,6,2,-5,1,6,1,2,1,0,-5,26,1,0,1,-3,0,0,1,1,-1,-1,2,1
KR_6319460407,420,-1,10,0,-2,2,3,1,0,4,4,-5,1,6,1,7,6,0,3,3,1,6,6,4,6,10,-10,0,1,1,1,1,1,1,1
KR_6761831106,420,-3,6,-11,-5,-4,4,8,1,3,2,-2,3,5,4,4,0,-4,1,5,0,-1,0,0,3,3,1,0,-2,-1,-1,-1,1,5,1
KR_6767890564,420,2,-13,-19,3,-3,1,4,-1,1,2,2,3,1,4,5,1,1,1,0,-1,6,0,-3,8,5,-2,0,0,-1,1,0,-1,6,1
KR_6728110814,440,-3,6,-8,-3,-5,1,6,3,3,0,1,1,0,-1,3,4,-1,1,2,0,5,7,3,1,4,-4,0,-2,0,-1,-1,1,0,1
KR_6770921991,420,3,61,24,12,3,3,0,1,2,1,4,7,3,4,4,0,0,1,1,1,4,-10,2,2,4,0,0,3,1,1,1,1,3,1
KR_6641773397,420,2,88,-16,9,3,3,0,2,4,2,1,2,1,5,5,0,-2,2,4,1,14,-1,3,5,8,1,0,0,1,-1,1,1,2,1
KR_6723846604,420,3,78,-24,3,-2,1,3,-2,1,3,1,3,2,2,2,0,4,5,1,0,3,-4,-3,5,2,2,0,0,1,-1,1,-1,6,1
KR_6765438950,420,1,64,14,1,3,4,1,1,1,0,0,3,3,-3,2,5,0,0,0,0,-2,29,-3,7,4,3,0,-1,1,1,-1,-1,6,1
KR_6765278997,420,-1,71,-2,-6,0,1,1,5,5,0,-2,1,3,-4,4,8,-5,1,6,0,-5,-6,-1,4,3,-1,0,-1,-1,1,-1,-1,2,1
KR_6769314550,420,3,34,12,1,0,3,3,2,6,4,2,3,1,0,3,3,-3,0,3,-2,-11,-3,9,1,10,-2,0,2,-1,1,1,-1,6,1
KR_6467317050,420,0,40,19,-7,3,6,3,-2,4,6,-4,0,4,-3,2,5,-1,3,4,-1,-7,11,-1,6,5,-1,0,1,1,1,1,-1,2,1
KR_6770970154,420,0,34,0,4,-2,1,3,1,4,3,5,5,0,-2,2,4,2,2,0,1,10,-36,-1,8,7,2,0,1,1,-1,1,1,6,1
KR_6771145606,420,-1,8,-28,2,-1,2,3,-1,1,2,3,4,1,-1,2,3,2,3,1,0,3,3,2,4,6,-1,0,0,-1,0,0,1,6,1
KR_6740478371,420,3,51,-12,7,5,6,1,0,4,4,2,4,2,1,3,2,-1,0,1,-1,2,-3,1,5,6,8,0,0,-1,-1,0,1,5,1
KR_6766239712,420,5,58,-4,7,5,6,1,1,2,1,0,1,1,1,2,1,0,0,0,0,5,-65,1,4,5,20,0,0,1,1,1,1,4,1
KR_6770589353,420,2,46,-23,12,-1,2,3,5,8,3,5,7,2,2,3,1,1,1,0,0,17,232,-1,5,4,3,0,0,0,0,1,-1,0,1
KR_6672428307,440,0,28,-8,1,-3,2,5,0,1,1,-1,2,3,4,7,3,1,1,0,0,1,2,0,6,6,2,0,1,1,-1,-1,-1,3,1
KR_6716437014,420,4,73,28,14,0,3,3,6,7,1,1,5,4,4,5,1,3,3,0,2,17,-1,1,5,6,2,0,1,1,1,1,1,6,1
KR_6758000067,420,2,11,10,8,1,2,1,0,2,2,-1,2,3,6,6,0,2,2,0,0,12,90,5,0,5,-3,0,1,1,1,1,1,5,1
KR_6706385924,420,-2,-6,15,-7,-4,1,5,1,5,4,-4,0,4,-1,0,1,1,1,0,0,-6,2,0,6,6,-7,0,0,0,-1,0,-1,0,1
KR_6769145553,420,-1,-33,-10,-1,0,3,3,0,4,4,1,4,3,2,3,1,-4,1,5,0,-4,-6,-3,5,2,-3,0,1,0,-1,1,-1,0,1
KR_6767712022,420,3,11,28,6,6,6,0,2,4,2,0,1,1,-2,2,4,0,0,0,0,3,-7,1,6,7,3,0,2,1,1,1,-1,2,1
KR_6696599921,440,4,68,7,8,1,2,1,3,3,0,4,7,3,0,0,0,0,1,1,0,1,-1,6,1,7,2,0,1,-1,-1,1,1,6,1
KR_6724920203,420,2,42,20,6,1,2,1,2,3,1,3,3,0,-1,3,4,1,4,3,0,7,0,1,4,5,-2,0,0,1,1,0,1,2,1
KR_6614467280,420,4,86,59,12,7,7,0,0,2,2,-2,0,2,4,4,0,3,3,0,0,9,-4,1,2,3,4,0,0,1,-1,-1,1,5,1
KR_6737424588,440,6,76,0,7,5,6,1,3,4,1,-1,1,2,-1,4,5,1,1,0,1,0,-6,-2,6,4,4,0,1,-1,1,1,1,3,1
KR_6398069325,420,2,-2,-11,4,1,1,0,-1,3,4,3,3,0,0,2,2,1,1,0,1,8,30,2,8,10,-3,0,0,1,-1,0,1,1,1
KR_6764182026,420,0,-30,-5,2,0,1,1,5,8,3,0,1,1,-1,1,2,-2,1,3,-1,-1,-3,4,3,7,-2,0,0,1,-1,0,-1,2,1
KR_6738459450,420,1,65,16,5,-1,2,3,-3,0,3,4,4,0,4,5,1,1,3,2,2,4,-3,-2,7,5,1,0,2,1,0,1,1,1,1
KR_6716352912,420,0,31,8,2,2,2,0,5,8,3,-2,1,3,-1,3,4,-2,0,2,2,1,-446,6,4,10,-8,0,1,1,-1,1,1,5,1
KR_6764602909,420,3,-29,32,2,0,1,1,3,5,2,-2,2,4,-1,0,1,2,2,0,0,-3,12,-3,8,5,1,0,0,-1,1,1,-1,5,1
KR_6671373085,420,2,-29,7,4,1,1,0,3,4,1,5,5,0,-1,1,2,-4,0,4,0,7,-118,1,5,6,-3,0,0,-1,1,0,-1,4,1
KR_6747456501,440,0,-43,-9,-5,-2,4,6,0,1,1,-3,1,4,2,6,4,-2,2,4,0,-3,-17,5,4,9,-1,0,-1,0,-1,-1,-1,0,1
KR_6730556568,420,4,44,-4,10,0,0,0,3,5,2,2,3,1,7,9,2,-2,0,2,1,16,7,2,3,5,-2,0,-1,1,-1,-1,1,1,1
KR_6728920594,420,1,39,24,4,1,1,0,-5,1,6,4,4,0,2,3,1,2,3,1,0,2,-11,-3,5,2,5,0,0,0,1,0,1,0,1
KR_6635382672,420,3,76,8,6,-1,1,2,2,3,1,2,2,0,3,5,2,0,3,3,0,6,13,0,8,8,7,0,2,0,1,1,1,0,1
KR_6664653075,440,3,31,55,2,-1,1,2,3,6,3,1,2,1,-1,0,1,0,0,0,0,4,-3,6,2,8,2,0,1,1,1,1,1,3,1
KR_6743410642,440,-3,63,-2,-10,5,6,1,-2,1,3,-4,1,5,-5,0,5,-4,0,4,0,-10,-10,0,5,5,1,0,0,-1,-1,-1,-1,6,1
KR_6557228646,420,2,-23,23,4,2,3,1,4,7,3,-3,0,3,3,5,2,-2,0,2,1,1,-1,-1,6,5,-1,0,1,1,-1,1,1,6,1
KR_6707629123,440,3,50,37,11,1,1,0,-3,0,3,7,11,4,6,6,0,0,1,1,1,9,16,-2,5,3,-3,0,1,1,1,1,1,4,1
KR_6674155075,420,-2,0,4,-9,0,0,0,-1,4,5,-7,2,9,0,4,4,-1,0,1,0,-13,195,1,5,6,4,0,1,-1,0,1,-1,1,1
KR_6660166608,440,-1,-8,-18,5,1,2,1,-2,4,6,8,10,2,-1,3,4,-1,1,2,1,6,-83,3,5,8,1,0,0,-1,-1,1,1,6,1
KR_6771662959,420,2,2,-22,6,1,2,1,5,6,1,-2,2,4,4,4,0,-2,0,2,0,6,8,4,1,5,-1,0,0,-1,0,0,1,1,1
KR_6768104868,420,2,24,-11,3,3,5,2,-2,1,3,-1,0,1,4,5,1,-1,0,1,0,-3,3,-1,5,4,2,0,1,-1,1,1,-1,3,1
KR_6732541766,420,-1,5,18,-3,-4,0,4,3,3,0,-4,0,4,0,1,1,2,3,1,-1,0,8,6,3,9,0,0,1,1,-1,1,-1,6,1
KR_6744061713,420,2,29,-22,2,2,2,0,0,2,2,5,6,1,-4,1,5,-1,0,1,0,1,-2,-1,4,3,3,0,1,-1,1,1,1,6,1
KR_6762639260,420,5,85,7,13,1,2,1,2,2,0,7,8,1,2,3,1,1,1,0,0,7,-1,1,6,7,1,0,3,1,1,1,1,2,1
KR_6771176427,420,-3,2,-24,-4,-2,1,3,1,1,0,2,2,0,-2,0,2,-3,0,3,0,-2,-238,1,4,5,-6,0,0,-1,-1,0,-1,1,1
KR_6749027576,440,-1,-14,-20,4,1,3,2,-1,2,3,1,3,2,-1,1,2,4,5,1,0,5,2,-2,7,5,1,0,-1,-1,1,-1,-1,4,1
KR_6728947379,420,5,59,26,11,3,4,1,3,7,4,3,5,2,0,2,2,2,3,1,0,15,6,-1,7,6,0,0,2,1,1,1,1,3,1
KR_6518943866,420,3,34,-20,9,-1,1,2,5,5,0,1,4,3,4,5,1,0,0,0,0,16,162,0,8,8,6,0,2,1,1,1,-1,2,1
KR_6769860217,420,2,68,0,5,2,3,1,2,2,0,0,2,2,1,4,3,0,0,0,0,-3,12,2,5,7,4,0,-1,1,1,1,1,3,1
KR_6086422017,440,5,3,3,19,-1,3,4,7,9,2,1,5,4,11,11,0,1,1,0,1,31,2,-3,5,2,-1,0,2,1,0,1,1,5,1
KR_6763310703,420,-2,-2,-35,-4,1,3,2,1,4,3,-2,2,4,-4,0,4,0,0,0,1,-8,4,4,7,11,-5,0,-1,1,-1,-1,1,1,1
KR_6398765232,420,0,-1,-4,-3,0,1,1,1,3,2,-4,0,4,-3,2,5,3,6,3,-2,-3,-10,-3,9,6,2,0,0,-1,-1,0,-1,1,1
KR_6762938982,420,6,44,42,12,4,4,0,0,3,3,9,10,1,-1,1,2,0,4,4,0,13,-3,2,2,4,5,0,0,1,-1,-1,1,6,1
KR_6691213835,420,1,4,1,0,2,3,1,-2,2,4,1,2,1,-1,1,2,0,0,0,0,-3,-145,0,7,7,2,0,1,-1,1,1,1,1,1
KR_6680628146,420,1,-23,-1,4,-6,2,8,2,3,1,4,5,1,4,6,2,0,1,1,-1,16,7,2,4,6,-1,0,-1,-1,1,-1,-1,6,1
KR_6711585437,420,-2,-65,16,-2,-2,1,3,-9,0,9,7,7,0,2,2,0,0,0,0,0,0,4,4,2,6,-5,0,1,1,1,1,-1,4,1
KR_6749480838,440,2,54,31,0,1,3,2,1,7,6,-2,1,3,-1,0,1,1,2,1,0,-7,-2,0,5,5,-2,0,1,1,1,1,-1,6,1
KR_6762014708,420,1,72,0,13,0,2,2,0,1,1,7,7,0,6,9,3,0,0,0,2,10,5,-2,6,4,-1,0,3,1,-1,1,1,5,1
KR_6757633789,420,0,-13,-1,4,-4,2,6,4,6,2,-2,1,3,5,5,0,1,1,0,0,21,44,5,5,10,-22,0,1,1,1,1,-1,2,1
KR_6721680273,420,-1,33,-9,3,4,4,0,-1,3,4,3,5,2,0,2,2,-3,0,3,0,-2,0,-6,6,0,-2,0,1,-1,1,1,1,1,1
KR_6764670148,420,-2,-22,0,-2,0,2,2,-1,4,5,1,3,2,0,3,3,-2,2,4,0,-6,1,1,3,4,0,0,-1,1,-1,-1,-1,3,1
KR_6641754444,420,4,87,-3,12,5,5,0,0,2,2,1,2,1,5,8,3,1,1,0,0,15,5,-1,5,4,3,0,2,1,1,1,1,6,1
KR_6648528025,420,1,-20,1,6,5,6,1,5,6,1,1,4,3,-5,1,6,0,1,1,2,5,68,-5,7,2,3,0,1,-1,1,1,1,4,1
KR_6742862806,420,-5,-29,-24,-12,0,0,0,-4,2,6,-2,3,5,-6,0,6,0,1,1,0,-2,-10,-1,5,4,-2,0,-1,-1,1,-1,-1,1,1
KR_6768076322,440,0,-18,-32,-3,-1,2,3,-2,0,2,4,6,2,-4,1,5,0,2,2,0,-2,7,5,4,9,1,0,-1,1,-1,-1,-1,6,1
KR_6703558168,420,4,42,1,13,3,3,0,2,4,2,3,4,1,3,6,3,2,3,1,0,9,-33,0,6,6,16,0,0,1,0,0,1,3,1
KR_6635788657,420,2,32,14,3,3,3,0,-7,0,7,2,2,0,3,4,1,2,2,0,0,3,8,1,4,5,0,0,0,1,-1,1,-1,1,1
KR_6761206918,420,4,98,9,10,4,5,1,3,3,0,4,4,0,2,4,2,-3,0,3,0,7,1,0,5,5,-1,0,2,1,1,1,1,4,1
KR_6768780004,420,4,66,4,-2,-2,0,2,2,5,3,-2,2,4,1,3,2,-1,0,1,0,-2,-5,-3,7,4,1,0,-1,-1,1,-1,-1,6,1
KR_6628690975,420,-2,-37,20,-4,-3,0,3,-1,4,5,0,0,0,0,1,1,0,1,1,1,2,-103,1,3,4,-1,0,0,1,1,0,1,6,1
KR_6726331609,420,0,53,-32,4,3,3,0,-5,1,6,0,1,1,7,7,0,-1,1,2,1,8,-20,1,5,6,15,0,1,1,0,1,1,6,1
KR_6746076100,420,3,39,15,0,-1,1,2,1,4,3,2,3,1,-3,6,9,1,1,0,-3,-2,5,-4,8,4,-1,0,0,-1,-1,0,-1,6,1
KR_6763174039,420,3,24,-8,1,4,5,1,-1,4,5,1,2,1,1,1,0,-4,0,4,0,-14,4,0,5,5,1,0,0,-1,-1,0,1,1,1
KR_6749310523,420,1,-12,13,-1,2,5,3,2,3,1,-5,0,5,-1,2,3,1,2,1,0,3,51,3,4,7,-23,0,3,-1,1,1,1,2,1
KR_6768859445,420,2,30,13,9,1,2,1,-3,2,5,8,8,0,2,4,2,1,3,2,0,-2,18,1,4,5,4,0,1,1,1,1,1,3,1
KR_6690579402,420,2,36,9,0,0,1,1,1,4,3,-4,1,5,4,5,1,-1,0,1,0,2,-23,4,7,11,0,0,0,1,1,0,-1,4,1
KR_6701357389,420,0,63,23,0,-4,2,6,-1,0,1,2,4,2,3,4,1,0,0,0,0,6,-9,3,3,6,-2,0,-1,1,-1,-1,-1,3,1
KR_6768671146,440,-1,-26,8,-3,1,2,1,4,5,1,-2,0,2,-1,1,2,-5,1,6,0,-4,5,3,3,6,-7,0,1,-1,1,1,1,5,1
KR_6647372299,420,0,-23,28,5,-5,1,6,4,5,1,-4,0,4,5,5,0,5,5,0,0,9,19,-2,5,3,2,0,0,1,1,1,-1,4,1
KR_6621393665,420,-1,-32,-16,-2,-4,0,4,4,5,1,-2,1,3,4,7,3,-4,1,5,0,-2,-126,-3,7,4,4,0,-1,0,-1,-1,1,0,1
KR_6679331012,440,5,-12,16,7,2,2,0,3,4,1,-1,1,2,1,8,7,2,2,0,-1,2,-4,0,4,4,2,0,0,0,-1,0,-1,0,1
KR_6741069086,420,5,11,3,17,0,1,1,6,9,3,6,7,1,7,7,0,-2,3,5,0,12,1,1,4,5,3,0,1,1,1,1,1,6,1
KR_6659698075,420,1,42,8,-4,0,0,0,-1,3,4,-2,1,3,-1,2,3,0,0,0,0,-4,34,-1,6,5,-10,0,-1,1,-1,-1,1,2,1
KR_6770046109,420,3,68,19,6,-1,0,1,4,5,1,-3,2,5,7,8,1,-1,0,1,0,12,7,1,1,2,0,0,2,1,1,1,-1,3,1
KR_6693215636,420,2,49,-3,1,2,4,2,-2,4,6,2,4,2,-1,2,3,0,0,0,0,3,9,4,1,5,0,0,1,1,1,1,-1,5,1
KR_6692275082,420,3,36,-24,9,1,2,1,2,4,2,-1,2,3,6,8,2,1,2,1,3,10,-7,1,4,5,-5,0,1,1,0,1,-1,2,1
KR_6766741461,420,2,20,4,5,1,1,0,2,4,2,2,4,2,1,2,1,-1,0,1,1,7,2,3,4,7,1,0,0,0,1,0,1,0,1
KR_6755694432,420,0,29,18,4,1,1,0,3,3,0,0,1,1,0,2,2,0,0,0,0,4,28,-2,5,3,-7,0,1,-1,1,1,1,2,1
KR_6767922394,420,2,33,-10,9,-2,0,2,3,4,1,1,1,0,6,6,0,1,1,0,0,10,135,-1,4,3,6,0,2,-1,1,1,1,2,1
KR_6654149147,420,-1,-17,16,0,2,3,1,0,3,3,-1,3,4,-3,2,5,2,2,0,0,0,-41,-3,8,5,11,0,-1,1,-1,-1,1,5,1
KR_6702015577,420,0,-32,0,-7,-1,3,4,-2,5,7,-3,3,6,1,6,5,-2,1,3,-2,-19,-1,0,6,6,-3,0,-2,1,-1,-1,-1,4,1
KR_6769459551,420,2,114,12,3,6,6,0,-4,0,4,2,4,2,1,1,0,-2,1,3,3,5,-45,-1,3,2,27,0,2,1,1,1,1,3,1
KR_6767389754,420,0,75,-12,2,1,2,1,5,8,3,0,2,2,-5,0,5,1,1,0,0,3,68,0,4,4,-17,0,0,1,0,1,1,3,1
KR_6771790218,420,1,-18,-13,2,-3,2,5,3,3,0,0,4,4,1,1,0,1,2,1,0,5,-9,-1,7,6,1,0,-1,1,-1,-1,1,2,1
KR_6737054911,420,-4,-63,-2,1,-1,1,2,4,4,0,-1,2,3,-4,0,4,3,3,0,0,3,-2,3,4,7,0,0,0,1,1,-1,-1,3,1
KR_6740427278,420,-6,-91,-22,-13,-2,1,3,-3,0,3,-1,0,1,-5,5,10,-2,1,3,-1,-17,-10,-1,6,5,1,0,0,-1,-1,1,-1,3,1
KR_6696642138,420,1,68,27,8,-1,2,3,-1,3,4,1,2,1,8,10,2,1,2,1,0,8,3,1,2,3,-1,0,0,-1,0,0,1,3,1
KR_6750929176,420,-3,-42,-36,-2,1,2,1,-1,3,4,-4,0,4,5,9,4,-3,0,3,0,-1,3,1,4,5,1,0,0,1,1,0,1,1,1
KR_6766775462,440,2,36,10,5,0,2,2,2,4,2,2,5,3,3,6,3,-2,0,2,-1,-9,-4,-2,4,2,3,0,1,1,1,1,-1,5,1
KR_6725658214,420,-1,11,-16,-2,1,5,4,-3,2,5,0,3,3,-1,3,4,1,2,1,-1,-6,-4,-2,6,4,0,0,1,1,1,1,-1,2,1
KR_6679084003,420,0,-60,17,-1,-2,1,3,1,4,3,-4,1,5,2,2,0,2,2,0,-1,3,4,2,2,4,-3,0,0,-1,1,0,-1,5,1
KR_6747397872,420,0,-30,-4,7,-2,1,3,9,9,0,1,4,3,-1,2,3,0,2,2,0,10,8,3,2,5,-4,0,1,1,1,1,1,2,1
KR_6768132465,440,1,9,5,0,-3,0,3,3,3,0,0,2,2,-4,1,5,4,4,0,1,9,9,-4,5,1,3,0,0,-1,-1,-1,1,3,1
KR_6728229786,440,-1,16,14,1,1,5,4,1,5,4,1,2,1,-5,3,8,3,3,0,0,-12,116,1,4,5,-4,0,0,1,1,1,1,3,1
KR_6686346842,420,-2,-90,-28,-3,-2,1,3,0,2,2,-3,4,7,0,1,1,2,3,1,-1,4,-15,3,4,7,-5,0,-1,1,-1,1,-1,1,1
KR_6078817214,420,1,20,-3,1,-1,2,3,-2,3,5,1,4,3,1,2,1,2,2,0,0,4,7,2,3,5,-3,0,0,-1,0,0,-1,2,1
KR_6679525055,420,1,2,1,1,0,3,3,-2,3,5,6,6,0,-3,1,4,0,0,0,1,-5,-4,-2,7,5,0,0,1,-1,1,1,-1,5,1
KR_6698227032,420,-1,9,-7,5,0,4,4,-1,0,1,-1,3,4,8,8,0,-1,0,1,0,2,263,-1,8,7,3,0,1,1,-1,1,-1,5,1
KR_6664289491,440,6,79,52,9,2,2,0,4,4,0,-2,0,2,6,9,3,-1,1,2,0,2,-5,2,5,7,-2,0,-1,1,1,1,1,2,1
KR_6758431513,420,0,55,-13,-3,-1,0,1,-2,3,5,-6,0,6,3,3,0,3,3,0,0,1,6,-2,4,2,6,0,2,-1,1,1,-1,5,1
KR_6624311652,420,0,47,-22,4,1,1,0,1,3,2,1,4,3,1,3,2,0,0,0,3,11,-2,3,5,8,3,0,0,-1,1,0,1,1,1
KR_6745989944,420,4,66,4,15,0,1,1,7,9,2,4,5,1,2,4,2,2,4,2,-1,3,-1,1,4,5,2,0,1,1,-1,1,-1,1,1
KR_6684201365,420,-1,16,4,-3,-5,0,5,1,2,1,2,2,0,-1,4,5,0,1,1,0,-2,-17,3,2,5,-2,0,0,1,1,1,-1,6,1
KR_6745899516,420,3,56,12,7,3,5,2,-3,1,4,-1,2,3,3,5,2,5,5,0,2,13,1,-3,10,7,6,0,1,1,1,1,1,1,1
KR_6748070386,420,9,194,26,15,7,7,0,3,6,3,1,5,4,-1,3,4,5,5,0,0,8,3,1,2,3,1,0,4,1,1,1,1,1,1
KR_6713239773,420,-4,-10,-12,-7,0,2,2,1,5,4,-2,3,5,-4,1,5,-2,0,2,0,-11,-3,0,3,3,-3,0,1,-1,1,1,1,2,1
KR_6642686897,420,2,9,19,6,0,2,2,5,5,0,4,5,1,-2,0,2,-1,0,1,0,8,-20,-5,6,1,1,0,1,1,1,1,-1,4,1
KR_6770667165,420,-1,-2,-16,0,0,1,1,-5,1,6,3,3,0,2,4,2,0,0,0,0,12,-2,-1,5,4,8,0,-1,1,-1,-1,1,1,1
KR_6746432510,440,1,24,-4,1,1,5,4,-2,3,5,3,3,0,-1,3,4,0,1,1,1,-2,-24,1,3,4,1,0,0,-1,1,0,1,3,1
KR_6767794157,420,5,82,15,13,2,2,0,-3,0,3,9,9,0,3,4,1,2,3,1,0,9,-18,-3,8,5,8,0,2,1,-1,1,1,6,1
KR_6695601437,420,6,58,26,7,6,7,1,2,3,1,1,1,0,-2,4,6,0,0,0,0,2,-3,5,5,10,0,0,2,1,1,1,1,3,1
KR_6614742535,420,1,60,5,3,-4,1,5,5,6,1,-4,1,5,-1,4,5,7,7,0,0,11,6,3,2,5,1,0,0,1,-1,-1,-1,1,1
KR_6763342006,420,-1,61,-4,0,-1,2,3,-4,1,5,3,3,0,3,4,1,-1,0,1,-2,-6,-9,-3,5,2,0,0,1,-1,-1,1,-1,3,1
KR_6768696344,420,2,10,-7,4,3,5,2,1,2,1,0,3,3,1,3,2,-1,1,2,1,9,13,2,3,5,0,0,0,1,-1,0,-1,4,1
KR_6693602054,420,-1,-15,-24,-5,1,2,1,0,2,2,-3,0,3,-2,1,3,-1,0,1,0,-4,94,3,4,7,-1,0,1,-1,1,1,-1,5,1
KR_6658249422,420,1,18,-12,-2,1,2,1,0,1,1,-3,0,3,-4,2,6,4,5,1,0,-7,2,-3,9,6,1,0,0,1,1,-1,-1,2,1
KR_6654479291,440,-1,-34,0,-4,4,4,0,-4,3,7,3,4,1,-8,1,9,1,3,2,-1,-5,-309,-1,3,2,-2,0,-1,-1,-1,-1,-1,2,1
KR_6718405605,420,2,52,12,5,2,6,4,1,1,0,-1,1,2,2,2,0,1,2,1,0,3,7,1,4,5,4,0,3,1,1,1,-1,5,1
KR_6656754409,420,1,59,-40,5,0,2,2,1,1,0,0,2,2,3,3,0,1,1,0,0,4,6,0,7,7,-1,0,2,-1,1,1,-1,1,1
KR_6737813672,420,-2,-7,3,-1,-8,0,8,3,3,0,5,5,0,-3,1,4,2,2,0,0,5,18,-6,8,2,-8,0,1,1,0,1,1,2,1
KR_6671679587,440,0,3,3,2,-3,1,4,4,5,1,2,3,1,-1,2,3,0,0,0,0,2,15,3,1,4,4,0,1,1,1,1,1,4,1
KR_6608585654,420,-1,-13,-24,2,-3,0,3,2,2,0,3,8,5,-1,3,4,1,1,0,0,6,-3,6,2,8,-4,0,-1,0,0,-1,-1,0,1
KR_6767304494,420,0,38,-12,10,6,7,1,-1,0,1,1,3,2,3,4,1,1,1,0,0,4,-4,0,6,6,3,0,2,0,1,1,1,0,1
KR_6745786092,420,5,52,-8,6,5,6,1,1,1,0,-1,1,2,0,1,1,1,3,2,0,1,11,1,3,4,-6,0,2,-1,-1,1,-1,1,1
KR_6606001384,420,5,69,59,11,4,4,0,1,5,4,5,7,2,1,4,3,0,0,0,0,8,-9,-2,8,6,-1,0,1,1,1,1,1,4,1
KR_6701951763,420,2,36,12,3,-2,0,2,1,1,0,1,3,2,2,2,0,1,1,0,0,5,36,-3,6,3,-4,0,1,1,1,1,1,2,1
KR_6721087871,420,-3,-76,-16,-8,-3,1,4,-2,3,5,-1,0,1,-1,4,5,-1,0,1,0,-7,23,-2,6,4,-5,0,-2,1,-1,-1,1,3,1
KR_6593192402,420,2,1,15,2,2,3,1,0,2,2,-2,1,3,2,3,1,0,2,2,0,0,0,3,3,6,4,0,0,0,1,0,-1,0,1
KR_6694038727,420,0,46,-5,-7,-7,2,9,-2,0,2,0,2,2,0,2,2,2,5,3,0,-10,5,0,3,3,-2,0,1,-1,-1,1,1,4,1
KR_6737066122,420,0,-26,-15,-3,3,3,0,-4,2,6,-3,2,5,1,2,1,0,0,0,0,2,-1,-1,2,1,4,0,-1,-1,-1,-1,1,2,1
KR_6768893201,420,-1,13,-6,2,0,2,2,2,3,1,-5,0,5,4,5,1,1,1,0,0,8,8,3,3,6,-1,0,0,0,-1,0,1,0,1
KR_6734091151,420,0,-10,26,-6,-1,1,2,-2,0,2,-2,1,3,0,4,4,-1,0,1,0,-7,-126,-3,8,5,11,0,1,1,1,1,-1,3,1
KR_6768792901,420,-3,-57,-40,2,0,2,2,-2,0,2,1,1,0,6,6,0,-3,0,3,0,9,-8,1,4,5,1,0,-1,-1,-1,-1,1,4,1
KR_6664828894,420,1,78,-14,7,7,10,3,5,5,0,0,2,2,0,4,4,-5,0,5,0,7,1,1,5,6,0,0,1,1,1,1,-1,2,1
KR_6767289669,440,1,47,22,1,1,3,2,0,0,0,-2,1,3,-1,5,6,3,3,0,0,-1,12,-2,3,1,3,0,1,-1,1,-1,1,2,1
KR_6732972262,420,4,-11,1,11,4,4,0,4,4,0,-3,3,6,6,8,2,0,1,1,0,17,-59,1,3,4,14,0,1,1,-1,1,-1,4,1
KR_6740574565,420,2,55,24,6,1,5,4,4,6,2,-3,2,5,3,6,3,1,1,0,-2,14,5,3,3,6,-4,0,-1,-1,1,-1,-1,6,1
KR_6766060277,420,3,66,47,-1,-5,0,5,1,2,1,-1,5,6,6,7,1,-2,2,4,0,1,5,0,4,4,2,0,-1,1,-1,1,-1,5,1
KR_6423119526,420,2,-5,37,5,0,0,0,2,3,1,1,3,2,1,1,0,1,1,0,0,5,127,2,3,5,-9,0,1,1,-1,1,1,5,1
KR_6751683511,420,2,75,8,1,1,2,1,3,5,2,-2,1,3,-1,1,2,0,1,1,0,2,-10,-3,6,3,1,0,0,1,-1,0,1,2,1
KR_6533578641,420,4,55,25,3,-3,0,3,0,3,3,5,8,3,1,1,0,0,1,1,0,6,-2,0,7,7,2,0,0,0,-1,0,-1,0,1
KR_6741603219,420,2,28,4,-3,0,2,2,-1,1,2,-1,1,2,2,4,2,-3,1,4,0,-1,-1,0,5,5,5,0,1,1,1,1,-1,1,1
KR_6768742142,420,3,52,8,12,-1,2,3,11,11,0,4,5,1,0,5,5,-2,1,3,0,10,1,3,1,4,1,0,1,1,1,1,1,6,1
KR_6726387008,420,0,-10,8,-1,0,3,3,1,4,3,0,2,2,-1,4,5,-1,0,1,0,1,2,-1,7,6,1,0,-1,-1,-1,1,-1,5,1
KR_6757300778,420,0,15,-16,2,4,4,0,0,1,1,0,1,1,3,9,6,-5,0,5,0,6,-28,-3,10,7,2,0,0,-1,0,-1,-1,1,1
KR_6725838735,420,0,14,-4,4,-2,0,2,-3,1,4,7,8,1,5,5,0,-3,1,4,0,4,11,1,5,6,3,0,0,-1,1,0,-1,4,1
KR_6694658124,420,2,45,8,-8,-4,2,6,-2,5,7,-1,1,2,0,4,4,-1,3,4,-1,1,-5,-2,5,3,1,0,0,-1,-1,0,-1,2,1
KR_6747727390,420,6,108,-3,12,3,3,0,4,4,0,3,3,0,-1,2,3,3,3,0,0,9,2,4,4,8,1,0,2,1,1,1,-1,2,1
KR_6748550645,440,0,-68,13,1,-3,0,3,-2,0,2,3,6,3,4,6,2,-1,3,4,0,10,23,3,4,7,-4,0,-2,-1,-1,-1,1,2,1
KR_6750318715,420,-1,15,10,4,3,4,1,0,1,1,2,6,4,-5,0,5,4,4,0,0,-5,0,0,2,2,0,0,1,1,1,1,1,4,1
KR_6624999524,420,-2,-22,-4,-7,1,4,3,-2,1,3,-2,1,3,-3,3,6,-1,0,1,0,-5,-5,-4,11,7,1,0,1,1,1,1,-1,1,1
KR_6755145445,420,2,-15,0,5,1,2,1,4,5,1,7,7,0,-6,0,6,-1,1,2,0,9,-3,4,4,8,-2,0,-1,1,-1,-1,1,1,1
KR_6680237959,420,2,13,52,6,-4,1,5,4,6,2,4,5,1,1,4,3,1,1,0,-1,5,5,5,3,8,0,0,1,1,1,1,-1,4,1
KR_5896826715,440,1,-23,12,-5,-3,1,4,1,2,1,1,7,6,-5,0,5,1,3,2,0,-16,-3,-3,5,2,-2,0,0,1,0,0,-1,5,1
KR_6759953011,420,2,-6,-8,3,1,2,1,3,7,4,-4,0,4,3,6,3,0,0,0,0,8,-1,4,2,6,-3,0,0,1,-1,0,-1,5,1
KR_6750834502,420,-1,31,-20,-4,0,4,4,0,3,3,-1,4,5,2,4,2,-5,0,5,0,-5,-3,-3,6,3,0,0,1,-1,1,1,-1,1,1
KR_6751989590,420,2,46,27,3,1,3,2,-2,2,4,-2,0,2,5,5,0,1,2,1,0,1,-1,-2,7,5,2,0,-1,-1,1,1,1,4,1
KR_6758220553,440,-1,31,-20,3,1,3,2,1,2,1,3,3,0,-2,0,2,0,3,3,-1,5,-208,-1,7,6,-1,0,-1,1,-1,-1,-1,6,1
KR_6731393411,420,3,27,-15,9,4,5,1,1,5,4,8,9,1,-2,2,4,-2,1,3,-1,-4,-44,-1,3,2,20,0,1,1,0,1,-1,6,1
KR_6749426025,420,5,-17,9,6,3,3,0,2,2,0,0,2,2,1,2,1,0,0,0,0,2,-14,1,4,5,4,0,1,1,0,1,-1,5,1
KR_6745805859,420,3,47,-8,7,0,3,3,-1,2,3,1,3,2,5,5,0,2,2,0,0,5,17,-2,6,4,-1,0,0,1,-1,0,1,1,1
KR_6732806490,420,1,48,-23,-1,0,0,0,-4,0,4,1,1,0,2,2,0,0,1,1,0,-5,1,0,5,5,-1,0,0,-1,1,1,1,5,1
KR_6688571715,420,4,73,-1,17,4,4,0,4,5,1,7,9,2,2,4,2,0,1,1,0,8,10,3,1,4,1,0,2,1,-1,1,1,5,1
KR_6768232109,420,3,25,16,7,3,4,1,6,8,2,2,3,1,-4,0,4,0,0,0,0,2,29,-4,5,1,-25,0,2,1,0,1,-1,2,1
KR_6673175775,420,2,2,29,8,-1,1,2,8,8,0,3,4,1,2,4,2,-4,0,4,0,11,5,1,5,6,0,0,0,-1,1,0,1,5,1
KR_6761401083,440,2,22,21,6,3,5,2,-1,1,2,3,7,4,2,6,4,-1,0,1,-1,-8,-4,4,1,5,1,0,0,-1,1,0,-1,2,1
KR_6727838395,420,2,73,20,7,1,5,4,0,4,4,2,2,0,4,5,1,0,2,2,0,6,2,6,2,8,-2,0,-1,1,1,1,-1,1,1
KR_6540849832,420,6,64,8,17,3,4,1,6,9,3,3,4,1,1,5,4,4,6,2,0,10,11,0,5,5,-3,0,2,1,1,1,-1,1,1
KR_6768718242,420,3,3,0,10,1,3,2,3,4,1,3,3,0,5,6,1,-2,1,3,0,7,4,-2,4,2,2,0,0,0,-1,1,1,0,1
KR_6760191252,420,-3,48,-25,-5,2,3,1,-4,1,5,2,5,3,-4,0,4,-1,1,2,0,-6,19,1,3,4,-2,0,0,-1,-1,0,-1,3,1
KR_6760284798,420,1,26,3,5,-4,0,4,3,4,1,-1,1,2,5,5,0,2,3,1,0,11,-41,4,2,6,-1,0,1,1,-1,-1,1,3,1
KR_6716264545,420,1,96,-8,6,2,4,2,1,4,3,-1,1,2,5,6,1,-1,0,1,0,9,-41,-1,7,6,22,0,1,-1,1,1,1,1,1
KR_6495188428,440,2,89,0,12,-1,1,2,2,4,2,3,3,0,7,7,0,1,2,1,1,9,0,2,3,5,3,0,1,1,0,1,1,3,1
KR_6768003359,420,1,-21,-7,4,-2,0,2,2,4,2,5,6,1,1,3,2,-2,0,2,0,5,9,2,3,5,-2,0,1,1,1,-1,1,2,1
KR_6762307421,420,1,43,-20,6,4,5,1,7,9,2,-1,1,2,-6,0,6,2,3,1,1,4,-16,1,4,5,0,0,0,-1,1,1,1,3,1
KR_6610144111,420,1,-25,-8,-1,-3,0,3,0,4,4,2,2,0,1,2,1,-1,1,2,0,-1,-2,0,3,3,-2,0,-1,-1,-1,-1,-1,5,1
KR_6601165221,420,4,39,-16,8,-1,0,1,3,4,1,3,4,1,0,2,2,3,3,0,1,7,4,0,4,4,2,0,0,-1,-1,0,1,6,1
KR_6726312850,420,-1,-34,-16,10,7,7,0,-2,4,6,-2,3,5,5,7,2,2,2,0,2,8,-28,6,5,11,-5,0,-2,1,-1,-1,1,6,1
KR_6754967582,420,1,83,-11,4,1,3,2,-1,0,1,-4,1,5,5,6,1,3,3,0,0,0,30,-2,9,7,3,0,1,1,1,1,1,6,1
KR_6717178931,420,0,32,23,3,-1,0,1,-2,2,4,3,5,2,4,5,1,-1,2,3,1,-1,-165,1,3,4,0,0,0,-1,-1,0,1,3,1
KR_6755671710,420,2,-35,-28,7,4,4,0,2,4,2,1,4,3,0,5,5,0,3,3,1,8,2,0,5,5,1,0,0,-1,-1,1,1,3,1
KR_6726214356,420,-3,52,-20,-3,0,2,2,-3,1,4,-1,1,2,2,3,1,-1,0,1,0,-3,4,1,6,7,-1,0,0,1,1,1,-1,2,1
KR_6630879286,420,4,82,12,8,4,4,0,-1,2,3,2,2,0,1,1,0,2,4,2,1,5,10,0,4,4,5,0,3,1,1,1,1,5,1
KR_6738545255,420,0,61,-15,0,1,1,0,0,4,4,1,3,2,-2,3,5,0,0,0,0,-4,-3,2,2,4,-1,0,1,1,1,1,-1,2,1
KR_6767137694,440,1,-30,12,8,5,5,0,-1,1,2,0,1,1,0,1,1,4,4,0,0,7,-88,-2,5,3,4,0,-1,1,-1,-1,1,4,1
KR_6768768768,420,4,61,-7,7,0,3,3,-2,0,2,5,5,0,4,6,2,0,2,2,0,-2,-2,-3,6,3,6,0,2,0,0,1,1,0,1
KR_6768938767,420,-2,17,20,-2,0,1,1,-2,2,4,-1,5,6,2,3,1,-1,0,1,0,-7,-9,-4,6,2,-1,0,1,-1,1,1,-1,2,1
KR_6737737194,420,3,17,18,8,2,3,1,6,6,0,3,4,1,-2,1,3,-1,0,1,0,10,8,1,3,4,-5,0,1,1,-1,1,1,5,1
KR_6551623666,420,5,-25,6,8,2,3,1,2,4,2,3,6,3,0,1,1,1,1,0,0,6,0,-1,6,5,-2,0,1,1,1,1,1,6,1
KR_6757711513,420,2,19,-24,5,-2,2,4,1,4,3,5,6,1,0,3,3,1,1,0,0,5,33,2,4,6,-5,0,1,1,0,1,-1,2,1
KR_6703580365,420,6,122,32,14,3,4,1,4,5,1,5,8,3,4,6,2,-2,0,2,2,6,40,6,2,8,3,0,4,-1,1,1,1,2,1
KR_6680791925,420,2,105,-20,5,5,5,0,2,3,1,-1,2,3,2,4,2,-3,1,4,0,2,0,0,4,4,1,0,0,0,-1,1,1,0,1
KR_6426417909,420,1,-17,-24,-1,3,4,1,5,5,0,-5,1,6,0,3,3,-4,3,7,1,-5,202,-1,6,5,1,0,0,1,-1,0,1,6,1
KR_6724740531,420,0,19,24,0,-1,2,3,-3,3,6,2,2,0,1,2,1,1,4,3,0,-2,-56,-2,6,4,0,0,0,1,-1,0,1,6,1
KR_6749563114,420,3,15,12,5,1,3,2,3,4,1,-1,2,3,3,5,2,-1,1,2,0,7,2,4,2,6,-4,0,-1,-1,1,1,1,4,1
KR_6636975095,440,2,-36,-20,6,1,4,3,0,3,3,0,0,0,5,9,4,0,1,1,0,-2,3,2,1,3,3,0,0,-1,1,0,-1,6,1
KR_6578831198,420,3,1,8,9,-2,1,3,5,9,4,3,7,4,-1,1,2,4,5,1,1,18,-258,-3,6,3,1,0,1,1,-1,1,-1,1,1
KR_6759949298,420,4,-9,21,13,2,2,0,1,1,0,1,1,0,7,9,2,2,4,2,0,14,3,3,5,8,-1,0,2,1,1,1,1,1,1
KR_6687762213,440,1,-54,-8,14,3,3,0,3,5,2,-3,2,5,6,6,0,5,6,1,1,25,-38,-1,4,3,32,0,0,0,1,-1,1,0,1
KR_6732697627,420,3,32,4,4,2,3,1,3,5,2,1,3,2,-1,1,2,-1,0,1,-1,-2,-33,2,3,5,19,0,3,-1,1,1,-1,1,1
KR_6548458317,420,5,116,40,8,1,2,1,0,2,2,2,2,0,5,6,1,0,0,0,0,6,5,1,4,5,-2,0,2,-1,-1,1,1,4,1
KR_6665708190,420,1,37,4,2,2,3,1,-1,2,3,-1,3,4,2,2,0,0,1,1,0,3,6,-2,6,4,2,0,0,-1,-1,-1,-1,5,1
KR_6767870899,420,1,60,0,3,-3,0,3,1,1,0,2,4,2,2,2,0,1,2,1,2,10,-3,-1,9,8,2,0,-1,1,-1,-1,1,2,1
KR_6765375338,420,1,36,8,0,-3,1,4,-1,3,4,6,6,0,-2,0,2,0,0,0,0,1,-21,0,4,4,0,0,0,1,-1,0,1,6,1
KR_6760341647,420,-5,-61,9,-5,-1,1,2,-5,1,6,2,4,2,-1,2,3,0,6,6,0,-1,-379,1,3,4,1,0,-1,-1,-1,-1,1,4,1
KR_6730058865,420,-2,-51,0,-4,-3,0,3,1,4,3,0,3,3,0,3,3,-2,0,2,-1,-9,1,-1,5,4,-4,0,0,0,-1,1,-1,0,1
KR_6733080308,420,5,0,68,9,0,2,2,3,4,1,4,4,0,2,4,2,0,2,2,0,10,-2,-3,5,2,1,0,0,1,1,1,-1,3,1
KR_6748272682,440,-2,-28,-24,5,2,2,0,-1,3,4,2,4,2,1,4,3,1,1,0,1,0,73,2,1,3,3,0,0,0,-1,0,1,0,1
KR_6662409309,440,8,71,44,14,2,3,1,4,6,2,7,7,0,-1,1,2,2,2,0,0,10,42,1,2,3,-13,0,1,1,0,1,1,5,1
KR_6766385545,420,0,34,-2,-3,-2,1,3,5,9,4,1,3,2,-6,1,7,-1,2,3,-1,-4,0,6,5,11,-5,0,0,-1,-1,0,-1,5,1
KR_6738384701,420,1,13,9,-2,0,0,0,-1,3,4,-1,2,3,0,6,6,0,0,0,0,-6,0,-2,5,3,-2,0,0,-1,1,0,-1,1,1
KR_6725964400,420,-1,-25,27,-2,2,2,0,-1,1,2,1,1,0,-6,1,7,2,3,1,0,-7,-4,-1,7,6,3,0,-1,1,1,-1,-1,3,1
KR_6728505136,420,5,68,-7,6,-5,0,5,-1,2,3,2,3,1,9,9,0,1,2,1,1,11,-4,-5,10,5,0,0,1,1,-1,1,1,4,1
KR_6186887427,420,2,13,-5,6,-1,1,2,1,2,1,-1,3,4,6,6,0,1,2,1,0,9,-6,-2,8,6,7,0,1,1,-1,1,-1,5,1
KR_6769267624,420,5,86,-4,16,4,6,2,3,5,2,4,4,0,3,3,0,2,4,2,0,12,2,3,4,7,1,0,1,1,-1,1,1,5,1
KR_6665939882,420,-3,52,-6,-3,3,5,2,-4,2,6,1,2,1,1,2,1,-4,0,4,0,-7,-9,-3,5,2,2,0,0,-1,1,0,1,4,1
KR_6671453950,420,0,10,-12,-1,-2,0,2,-5,2,7,2,2,0,2,3,1,2,3,1,0,3,-203,-2,5,3,1,0,1,-1,1,1,1,2,1
KR_6759143814,420,0,77,12,-4,3,5,2,-1,1,2,-6,1,7,-1,0,1,1,1,0,0,-8,-6,-2,4,2,-1,0,2,-1,1,1,1,5,1
KR_6771099785,420,4,31,3,4,-1,0,1,5,7,2,-1,1,2,1,3,2,0,2,2,-1,1,-36,-7,11,4,-1,0,1,1,1,1,-1,2,1
KR_6711347762,420,3,7,-18,14,4,4,0,1,3,2,8,9,1,2,2,0,-1,4,5,1,26,3,5,4,9,3,0,2,1,-1,1,1,3,1
KR_6747217055,440,2,16,0,8,4,4,0,0,1,1,1,4,3,7,7,0,-4,3,7,0,4,-6,-7,10,3,6,0,1,1,1,1,-1,5,1
KR_6765437111,440,6,100,30,15,1,1,0,8,8,0,2,3,1,4,9,5,0,0,0,0,16,6,7,3,10,-2,0,1,1,0,1,-1,3,1
KR_6741396125,440,-2,-18,-20,-4,0,2,2,-2,2,4,-3,2,5,-1,2,3,2,2,0,0,-4,-40,-3,5,2,24,0,-1,1,-1,-1,1,2,1
KR_6742274896,420,1,11,28,1,4,4,0,3,5,2,0,0,0,-4,0,4,-2,1,3,0,-3,3,-1,7,6,-6,0,0,1,1,0,-1,5,1
KR_6657308913,420,2,68,-27,4,-2,4,6,1,3,2,1,2,1,7,8,1,-3,2,5,1,1,11,2,4,6,3,0,1,1,-1,-1,1,5,1
KR_6768984522,420,0,46,-12,2,3,4,1,-5,1,6,0,4,4,6,8,2,-2,0,2,0,11,0,-1,3,2,3,0,0,-1,-1,-1,-1,6,1
KR_6768113252,420,1,9,-10,4,6,7,1,-3,2,5,2,5,3,-2,2,4,1,3,2,0,-4,-160,2,4,6,5,0,2,1,1,1,-1,3,1
KR_6714978387,420,2,13,7,-2,2,3,1,1,2,1,0,1,1,-4,1,5,-1,0,1,-1,-5,0,1,4,5,4,0,1,-1,1,1,-1,4,1
KR_6704020335,420,2,36,11,8,3,3,0,3,4,1,0,3,3,3,3,0,-1,0,1,-1,1,12,-1,6,5,1,0,0,1,1,1,-1,6,1
KR_6747485396,420,2,27,-8,6,4,4,0,4,4,0,0,1,1,-3,1,4,1,1,0,0,6,6,2,3,5,-3,0,0,1,1,0,-1,4,1
KR_6744758159,440,3,19,12,6,-2,0,2,2,6,4,9,9,0,-2,4,6,-1,0,1,0,5,14,0,3,3,1,0,-1,1,-1,-1,1,3,1
KR_6730533979,420,5,68,18,10,8,8,0,-2,3,5,2,7,5,1,1,0,1,1,0,0,13,0,3,2,5,4,0,0,1,1,1,1,5,1
KR_6663374106,420,2,26,-28,4,0,3,3,0,2,2,2,4,2,-1,2,3,3,7,4,0,5,10,2,3,5,0,0,0,-1,1,1,-1,2,1
KR_6760581275,440,1,-4,0,1,3,5,2,0,2,2,-2,0,2,-5,0,5,5,10,5,0,4,6,3,0,3,0,0,1,0,1,1,1,0,1
KR_6760425079,420,4,68,-3,13,3,4,1,1,2,1,1,3,2,7,8,1,1,2,1,2,19,-4,1,2,3,0,0,2,1,0,1,1,2,1
KR_6766548965,420,0,63,-31,-3,3,4,1,0,2,2,-2,2,4,-1,3,4,-3,0,3,-1,-3,8,8,3,11,1,0,0,1,0,0,-1,4,1
KR_6656650034,420,1,21,25,-1,-4,0,4,1,3,2,5,5,0,-2,3,5,-1,0,1,1,1,8,3,3,6,-2,0,0,1,-1,0,1,6,1
KR_6653866792,420,0,43,-40,-7,0,1,1,-3,1,4,-3,0,3,-2,2,4,1,3,2,0,-6,2,-5,6,1,0,0,0,-1,-1,1,-1,1,1
KR_6768574148,420,0,-57,12,-7,3,4,1,0,2,2,-6,0,6,-5,1,6,1,1,0,1,-8,0,-2,5,3,0,0,1,1,1,1,1,5,1
KR_6731902691,420,0,64,32,-5,-2,1,3,-3,0,3,-3,1,4,0,0,0,3,3,0,-1,0,-1,-4,8,4,3,0,0,-1,0,0,-1,1,1
KR_6767977346,420,3,-25,33,3,2,2,0,1,3,2,0,2,2,-1,2,3,1,2,1,0,-1,-10,-5,9,4,3,0,0,-1,-1,0,-1,2,1
KR_6766836418,440,4,10,28,12,0,3,3,7,8,1,2,6,4,1,2,1,2,3,1,0,11,22,1,6,7,4,0,0,1,-1,0,1,3,1
KR_6753119515,420,3,85,-5,11,0,2,2,6,6,0,1,1,0,3,3,0,1,2,1,0,14,40,3,6,9,-3,0,1,1,-1,1,1,6,1
KR_6768908609,420,3,100,44,7,4,5,1,1,4,3,1,5,4,0,0,0,1,1,0,0,2,4,-1,3,2,2,0,2,1,0,1,-1,2,1
KR_6672171205,420,0,-24,24,-1,-6,1,7,3,3,0,2,5,3,-1,3,4,1,1,0,0,2,-3,-3,5,2,6,0,1,1,0,-1,-1,6,1
KR_6728972529,420,3,49,6,9,8,8,0,-1,1,2,-2,1,3,-4,1,5,8,9,1,0,8,0,3,5,8,-1,0,1,1,-1,1,1,2,1
KR_6722490803,420,-2,54,-3,-6,3,3,0,0,3,3,-1,0,1,-8,0,8,0,1,1,0,-11,-10,-1,6,5,2,0,-2,-1,0,-1,1,5,1
KR_6759276816,420,6,121,28,13,2,2,0,4,4,0,1,2,1,5,6,1,1,1,0,0,18,38,6,2,8,-7,0,4,1,1,1,-1,2,1
KR_6701297847,420,2,-1,8,6,-2,2,4,2,5,3,-1,1,2,5,6,1,2,2,0,0,12,2,3,6,9,-1,0,0,1,-1,0,1,3,1
KR_6629879303,420,6,38,19,8,2,4,2,-1,4,5,4,4,0,4,5,1,-1,1,2,-1,-1,-39,2,6,8,-4,0,3,-1,1,1,-1,6,1
KR_6737315463,420,1,72,39,1,1,3,2,0,3,3,-2,0,2,0,4,4,2,2,0,0,1,116,4,4,8,2,0,1,1,1,1,1,1,1
KR_6769110002,420,4,65,8,11,3,4,1,5,6,1,1,2,1,3,5,2,-1,0,1,0,7,-9,0,7,7,4,0,2,0,1,1,-1,0,1
KR_6758848562,420,3,33,36,6,1,4,3,1,2,1,0,3,3,2,6,4,2,2,0,-1,0,5,0,5,5,2,1,3,1,1,1,-1,1,1
KR_6740412477,420,-6,3,-34,-8,1,1,0,-6,4,10,-5,3,8,1,4,3,1,2,1,-2,-18,6,1,6,7,-2,0,0,1,1,1,-1,2,1
KR_6688469934,420,0,15,-9,6,0,3,3,3,5,2,1,5,4,2,3,1,0,0,0,0,1,-10,0,7,7,-2,0,0,-1,1,0,1,6,1
KR_6751462647,420,0,-45,28,2,-1,2,3,6,8,2,2,5,3,-5,0,5,0,1,1,-1,2,346,3,2,5,-3,0,0,1,1,1,-1,6,1
KR_6724543119,440,-1,-15,-13,0,1,1,0,0,8,8,0,2,2,1,2,1,-2,3,5,1,-4,4,3,7,10,-2,0,0,1,1,0,1,4,1
KR_6734595739,420,5,68,43,9,3,4,1,5,5,0,1,2,1,-2,0,2,2,2,0,1,9,57,2,5,7,-16,0,1,1,1,1,1,6,1
KR_6446611951,420,2,-10,30,12,0,1,1,5,6,1,1,5,4,5,6,1,1,1,0,1,10,-131,5,5,10,-26,0,-1,1,1,1,1,3,1
KR_6351514055,420,4,8,20,9,-4,0,4,4,4,0,1,3,2,7,7,0,1,1,0,0,19,46,3,2,5,-13,0,1,1,1,1,-1,6,1
KR_6712117404,420,2,13,-28,14,5,5,0,2,3,1,1,2,1,4,5,1,2,3,1,0,13,7,-3,7,4,4,0,2,1,1,1,1,5,1
KR_6702011031,420,1,-46,17,3,2,2,0,1,1,0,0,2,2,0,1,1,0,0,0,0,5,129,4,5,9,2,0,0,-1,-1,0,-1,2,1
KR_6704617389,420,6,55,24,11,6,6,0,2,5,3,5,6,1,-5,2,7,3,3,0,1,5,-7,0,4,4,-2,0,1,1,0,1,1,5,1
KR_6769988437,420,-1,-22,8,2,1,1,0,3,4,1,-7,0,7,1,3,2,4,5,1,0,3,1,0,4,4,-3,0,1,0,-1,1,-1,0,1
KR_6738113995,420,1,-1,-15,5,-3,1,4,5,10,5,3,4,1,1,2,1,-1,0,1,0,6,3,1,3,4,5,0,-1,-1,1,1,-1,3,1
KR_6682765592,420,4,44,26,6,1,3,2,-2,4,6,2,2,0,3,5,2,2,4,2,0,10,-2,5,3,8,2,0,2,1,-1,-1,1,2,1
KR_6754313049,440,1,13,-12,2,4,5,1,2,2,0,-4,0,4,0,2,2,0,3,3,-1,5,5,0,3,3,-1,0,-1,1,-1,-1,-1,4,1
KR_6738869168,420,3,14,-4,8,0,3,3,4,5,1,3,4,1,1,1,0,0,0,0,0,7,9,3,2,5,1,0,0,1,1,1,1,1,1
KR_6575388494,420,2,3,16,7,-3,1,4,3,4,1,5,5,0,1,3,2,1,1,0,0,14,9,3,2,5,1,0,-1,1,1,-1,-1,1,1
KR_6685294476,440,4,96,24,6,-4,1,5,-1,0,1,9,10,1,1,1,0,1,2,1,0,11,-33,4,5,9,2,0,0,1,-1,0,1,5,1
KR_6759960792,420,2,56,-8,6,2,2,0,3,4,1,1,2,1,-2,3,5,2,2,0,0,9,1,-1,4,3,0,0,1,1,0,1,-1,3,1
KR_6696563705,440,5,47,96,4,3,3,0,4,4,0,0,3,3,-2,1,3,-1,0,1,0,3,-23,1,3,4,31,0,-1,0,0,-1,1,0,1
KR_6767213007,420,6,91,8,12,1,3,2,6,6,0,2,3,1,1,6,5,2,2,0,0,13,13,0,5,5,2,0,3,1,-1,1,1,3,1
KR_6770558077,420,1,55,36,3,-2,2,4,2,5,3,0,0,0,3,5,2,0,0,0,0,6,-12,2,2,4,-3,0,0,1,1,1,1,3,1
KR_5979657137,440,6,87,33,11,2,3,1,5,6,1,-1,2,3,5,5,0,0,1,1,0,8,3,-4,6,2,-2,0,3,0,1,1,1,0,1
KR_6768129754,420,5,59,0,15,1,3,2,1,3,2,6,8,2,3,5,2,4,4,0,0,4,5,0,5,5,3,0,1,0,0,1,1,0,1
KR_6743833390,440,6,44,34,6,3,3,0,1,2,1,2,2,0,-2,0,2,2,5,3,-1,7,-72,-1,7,6,3,0,3,1,-1,1,-1,1,1
KR_6652494557,420,3,54,37,10,-1,2,3,0,1,1,8,8,0,3,3,0,0,1,1,-1,10,44,4,3,7,-17,0,2,1,1,1,-1,2,1
KR_6757896240,420,-1,-13,-9,-8,-4,1,5,-4,0,4,2,3,1,-4,1,5,2,2,0,0,-5,-10,-3,7,4,6,0,-2,-1,-1,-1,-1,3,1
KR_6756754557,440,1,48,28,1,0,2,2,1,1,0,2,5,3,-2,2,4,0,1,1,0,4,5,-1,5,4,1,0,3,1,1,1,-1,1,1
KR_6737580062,420,-2,15,-21,-5,-1,0,1,0,5,5,1,2,1,-1,2,3,-4,1,5,0,5,-7,3,4,7,5,0,0,1,1,0,-1,2,1
KR_6473344016,420,1,9,12,-3,-6,0,6,3,3,0,-1,0,1,0,5,5,1,2,1,0,1,13,5,4,9,0,0,0,1,-1,1,1,3,1
KR_6755939715,420,3,78,9,15,2,2,0,1,3,2,5,7,2,5,6,1,2,3,1,0,9,-100,0,5,5,2,0,1,1,1,1,1,1,1
KR_6766227822,420,2,49,-14,7,0,3,3,3,3,0,5,5,0,-1,1,2,0,0,0,0,2,-12,0,6,6,1,0,0,0,-1,-1,1,0,1
KR_6746115365,420,3,87,0,15,2,3,1,1,2,1,3,3,0,2,3,1,7,7,0,1,23,-26,3,4,7,8,0,1,1,1,1,1,3,1
KR_6766831848,420,0,27,8,5,3,3,0,0,1,1,1,3,2,4,4,0,-3,0,3,0,4,9,3,6,9,1,0,0,-1,1,-1,1,2,1
KR_6563577251,420,4,0,9,8,1,1,0,2,3,1,2,4,2,3,3,0,0,0,0,0,9,10,-1,2,1,-1,0,0,1,1,0,1,2,1
KR_6755626617,420,5,43,-2,6,-2,3,5,2,3,1,0,2,2,4,8,4,2,4,2,0,10,13,8,3,11,-2,0,-1,0,-1,-1,-1,0,1
KR_6616804108,420,-3,-21,-10,-5,-2,1,3,0,2,2,-3,1,4,-1,3,4,1,2,1,0,-2,-41,-4,10,6,-1,0,-2,-1,-1,-1,1,5,1
KR_6744676824,440,3,40,23,6,-3,0,3,5,7,2,-1,3,4,3,4,1,2,2,0,0,6,-7,-5,9,4,2,0,1,1,1,1,-1,1,1
KR_6703201671,420,-1,-7,31,-4,3,3,0,-2,2,4,-5,2,7,0,1,1,0,0,0,1,-6,-2,-5,7,2,3,0,0,-1,1,0,1,2,1
KR_6664209528,420,3,18,0,7,-1,3,4,6,6,0,2,7,5,1,6,5,-1,0,1,-2,0,3,4,2,6,-2,0,2,-1,-1,1,-1,5,1
KR_6624146120,420,1,-21,-29,4,1,3,2,2,4,2,1,2,1,2,3,1,-2,0,2,0,7,14,0,5,5,3,0,0,-1,1,0,-1,4,1
KR_6749331300,440,-2,-54,-9,-11,2,2,0,-4,0,4,0,4,4,-2,2,4,-7,0,7,-1,-10,-255,0,4,4,3,0,-2,-1,-1,-1,-1,2,1
KR_6722354648,420,-1,23,-44,11,6,6,0,-1,4,5,4,4,0,3,3,0,-1,0,1,0,16,-4,0,4,4,1,0,0,-1,-1,-1,1,3,1
KR_6690772099,420,1,44,5,0,1,2,1,-1,0,1,3,4,1,-2,1,3,-1,2,3,0,1,-39,-2,6,4,4,0,0,1,-1,1,1,1,1
KR_6655376883,420,2,15,-11,5,2,3,1,1,4,3,4,4,0,-1,6,7,-1,1,2,0,5,0,1,6,7,5,0,1,-1,1,1,1,3,1
KR_6186883001,420,4,70,16,9,1,2,1,3,3,0,6,6,0,-1,0,1,0,3,3,0,12,3,-1,5,4,3,0,0,1,1,0,1,3,1
KR_6694647592,440,3,75,12,6,-4,0,4,6,8,2,-1,0,1,4,5,1,1,1,0,0,12,5,-2,5,3,1,0,0,1,-1,1,-1,2,1
KR_6749484090,420,8,44,28,22,10,11,1,-3,1,4,7,9,2,6,9,3,2,2,0,0,21,14,2,3,5,5,0,2,1,-1,1,1,1,1
KR_6759566783,440,0,75,-40,2,1,2,1,0,3,3,0,1,1,-2,0,2,3,4,1,1,8,-20,-2,3,1,1,0,1,-1,-1,1,1,6,1
KR_6613864966,420,4,33,20,6,0,2,2,5,7,2,3,5,2,-2,2,4,0,1,1,0,4,-17,-2,8,6,0,0,2,-1,1,1,-1,4,1
KR_6750264921,420,-1,-2,-7,6,1,2,1,1,2,1,-1,0,1,5,6,1,0,1,1,0,8,-466,2,4,6,-4,0,0,1,1,0,1,6,1
KR_6763149442,420,2,88,-28,10,2,2,0,-1,1,2,1,4,3,6,6,0,2,2,0,0,6,45,1,3,4,-2,0,1,1,-1,1,1,5,1
KR_6764624507,420,4,14,32,12,1,3,2,6,7,1,3,3,0,2,4,2,0,0,0,-1,11,34,3,2,5,-17,0,0,1,1,0,-1,6,1
KR_6703448145,420,2,-1,52,2,-1,2,3,-3,2,5,3,5,2,3,4,1,0,0,0,0,-4,8,1,4,5,-3,0,1,0,1,1,1,0,1
KR_6765396296,420,3,56,-16,3,0,2,2,-4,0,4,1,2,1,3,4,1,3,3,0,0,-1,4,2,2,4,4,0,1,0,0,1,1,0,1
KR_6746898000,420,1,14,20,2,0,4,4,2,5,3,1,1,0,-2,3,5,1,1,0,0,5,0,-4,8,4,-1,0,0,-1,0,-1,-1,1,1
KR_6635401837,420,1,-3,-4,3,3,4,1,-1,2,3,2,5,3,-1,2,3,0,0,0,0,-1,-13,-4,5,1,3,0,1,1,1,1,1,2,1
KR_6756876452,440,3,41,-7,9,1,2,1,4,6,2,4,4,0,-1,2,3,1,2,1,0,4,-12,-6,7,1,2,0,0,-1,1,0,-1,2,1
KR_6744553683,420,4,27,-12,6,5,5,0,-5,1,6,4,7,3,1,3,2,1,3,2,-2,-7,-5,-2,7,5,5,0,1,0,-1,1,-1,0,1
KR_6732117434,420,2,83,44,6,2,3,1,-1,3,4,2,3,1,1,1,0,2,2,0,1,2,2,-1,7,6,8,0,2,1,1,1,1,5,1
KR_6761629109,420,3,4,8,7,0,1,1,4,5,1,3,4,1,2,4,2,-2,1,3,0,9,10,2,4,6,-1,0,1,-1,1,1,-1,4,1
KR_6762440489,420,4,91,19,15,7,7,0,3,6,3,0,3,3,3,8,5,2,3,1,0,4,0,2,3,5,0,0,2,1,1,1,1,3,1
KR_6614822464,420,3,16,-14,2,4,5,1,-1,2,3,-2,1,3,1,2,1,0,0,0,0,0,2,-1,5,4,1,0,2,-1,1,1,1,2,1
KR_6769665184,420,1,37,8,-1,4,5,1,-1,0,1,-3,2,5,1,4,3,-2,0,2,-2,-7,-1,-5,11,6,6,0,0,-1,-1,1,-1,3,1
KR_6702001086,420,3,91,-17,5,3,3,0,-1,4,5,-2,1,3,4,4,0,1,2,1,0,7,39,5,4,9,-22,0,0,-1,1,1,-1,6,1
KR_6655537177,420,1,-7,12,2,5,7,2,-3,2,5,0,4,4,2,8,6,-2,0,2,0,-2,7,1,5,6,-2,0,0,1,1,0,-1,3,1
KR_6736001739,420,2,45,-5,12,-1,1,2,3,7,4,3,3,0,6,8,2,1,1,0,1,13,-223,9,2,11,5,0,2,1,-1,1,1,4,1
KR_6596987452,420,8,38,28,8,3,5,2,0,1,1,0,2,2,3,6,3,2,2,0,0,9,-7,-3,6,3,7,0,2,1,1,1,-1,6,1
KR_6695243478,420,2,-65,13,8,5,6,1,0,1,1,4,6,2,-2,1,3,1,2,1,0,5,-262,0,4,4,0,0,2,-1,1,1,1,3,1
KR_6748853361,420,3,95,-4,11,5,6,1,-3,2,5,-1,1,2,7,11,4,3,3,0,1,11,12,-1,7,6,0,0,1,1,-1,1,1,3,1
KR_6769545721,420,1,40,-12,2,1,1,0,-1,2,3,-3,3,6,3,5,2,2,2,0,0,5,31,1,10,11,0,0,0,0,-1,0,-1,0,1
KR_6724384831,420,0,52,28,1,4,4,0,-2,2,4,-1,3,4,6,7,1,-6,0,6,0,3,-3,1,6,7,2,0,1,-1,1,1,1,2,1
KR_6745108603,420,3,41,8,6,6,6,0,-1,0,1,-3,1,4,4,4,0,0,1,1,0,1,-29,-3,7,4,-7,0,0,1,0,1,1,4,1
KR_6636534121,440,1,39,32,0,3,3,0,0,6,6,-2,1,3,0,2,2,-1,1,2,0,-9,-38,-1,6,5,22,0,0,1,-1,-1,1,1,1
KR_6730508604,440,0,7,9,3,4,5,1,3,4,1,-8,2,10,3,3,0,1,4,3,0,-2,1,-1,3,2,-3,0,1,0,1,1,1,0,1
KR_6723173281,420,-1,13,0,2,-4,0,4,2,3,1,-4,1,5,7,7,0,1,2,1,0,9,226,-2,7,5,0,0,2,0,1,1,-1,0,1
KR_6744202435,420,4,106,8,10,-1,1,2,5,8,3,5,5,0,1,2,1,0,0,0,0,13,20,1,2,3,-1,0,1,1,1,1,1,4,1
KR_6738350273,440,-1,14,-21,-2,-3,1,4,-3,1,4,-4,0,4,4,5,1,4,4,0,0,-4,-1,2,2,4,0,0,0,-1,-1,0,-1,6,1
KR_6662557722,440,-4,-3,9,-12,-4,0,4,-7,0,7,-3,0,3,1,3,2,1,1,0,0,-12,1,-3,5,2,-1,0,0,-1,1,-1,-1,1,1
KR_6672942301,440,-1,-1,-11,1,0,0,0,0,3,3,0,1,1,0,4,4,1,2,1,0,-6,-18,1,5,6,-2,0,1,1,1,1,1,1,1
KR_6682581066,420,-2,-13,13,-3,-4,1,5,3,3,0,0,0,0,-3,1,4,1,3,2,0,-6,5,1,4,5,1,0,0,1,-1,0,1,5,1
KR_6769269635,420,5,97,7,14,4,5,1,0,0,0,1,1,0,4,4,0,5,5,0,0,14,-224,4,6,10,3,0,0,1,1,1,1,3,1
KR_6718978621,440,3,-26,0,7,-5,1,6,3,4,1,5,5,0,5,5,0,-1,1,2,0,13,-12,0,4,4,0,0,0,-1,-1,-1,1,4,1
KR_6767178661,420,0,38,0,-1,1,3,2,0,1,1,-2,3,5,0,5,5,0,0,0,0,-2,24,-6,10,4,1,0,1,1,-1,1,1,1,1
KR_6643280556,420,6,60,-8,16,5,5,0,9,9,0,1,3,2,3,5,2,-2,0,2,0,14,0,-2,6,4,4,0,2,-1,-1,1,1,4,1
KR_6668692083,420,0,-21,4,10,7,8,1,4,4,0,1,6,5,-1,1,2,-1,1,2,1,12,7,3,2,5,-3,0,0,-1,1,1,-1,1,1
KR_6756856357,420,3,2,3,3,-3,0,3,0,1,1,3,3,0,3,4,1,0,0,0,0,3,1,1,3,4,2,0,0,-1,-1,0,-1,5,1
KR_6683603491,420,4,-7,12,8,1,3,2,1,2,1,4,6,2,0,2,2,2,3,1,0,10,-21,2,5,7,1,0,-1,1,1,-1,1,1,1
KR_6760248365,420,-2,-23,-7,-3,2,5,3,-1,2,3,1,3,2,-1,3,4,-4,1,5,-3,-13,-6,-3,9,6,6,0,-1,1,-1,-1,-1,5,1
KR_6742265034,420,4,-27,7,16,2,6,4,4,7,3,2,2,0,6,8,2,2,2,0,0,23,15,9,2,11,-3,0,1,1,1,1,1,1,1
KR_6737537622,440,5,65,20,7,5,5,0,0,5,5,4,4,0,-3,3,6,1,1,0,0,1,2,2,2,4,-1,0,2,1,1,1,1,5,1
KR_6728885541,440,1,-28,31,-1,0,1,1,1,2,1,-3,0,3,1,3,2,0,0,0,-1,-3,3,0,4,4,0,0,0,1,1,1,-1,6,1
KR_6768734867,420,11,124,112,17,1,2,1,5,5,0,2,3,1,1,2,1,8,11,3,0,12,-6,1,1,2,2,0,4,1,1,1,1,6,1
KR_6761134447,440,6,63,34,16,2,2,0,-3,2,5,7,9,2,2,6,4,8,10,2,2,6,-22,0,4,4,-3,0,2,1,1,1,-1,5,1
KR_6659458148,420,-2,-35,35,-3,-3,0,3,3,5,2,-5,0,5,2,2,0,0,1,1,0,4,-91,-2,4,2,2,0,-2,1,-1,-1,1,3,1
KR_6710049248,420,5,79,-20,18,7,7,0,6,7,1,2,3,1,1,2,1,2,2,0,0,23,60,2,5,7,1,0,0,-1,-1,1,1,1,1
KR_6760525252,440,3,-37,-16,-5,-10,3,13,-3,1,4,2,2,0,7,8,1,-1,3,4,-1,11,2,1,2,3,0,0,-2,-1,0,-1,-1,6,1
KR_6718532243,420,7,81,39,10,2,4,2,3,8,5,0,3,3,5,6,1,0,2,2,0,-1,-3,-4,4,0,1,0,1,1,-1,1,1,5,1
KR_6766410876,420,1,50,-7,-1,-1,0,1,2,2,0,-3,0,3,2,5,3,-1,0,1,1,3,-5,-5,7,2,3,0,-1,1,-1,-1,1,3,1
KR_6770141550,420,1,83,-4,3,-1,1,2,5,7,2,-1,1,2,-1,0,1,1,1,0,0,-2,-5,-1,7,6,1,0,1,-1,-1,1,1,1,1
KR_6753154419,440,0,-73,4,7,2,3,1,0,2,2,0,1,1,4,6,2,1,1,0,0,17,-29,0,4,4,16,0,1,1,1,1,-1,3,1
KR_6664342637,440,0,1,-23,1,1,2,1,-1,3,4,0,2,2,1,4,3,0,1,1,1,0,-9,-6,9,3,4,0,0,-1,-1,0,1,4,1
KR_6587756629,440,-1,14,-1,7,-1,1,2,3,5,2,2,5,3,2,6,4,1,2,1,0,8,292,-2,5,3,7,0,2,1,-1,1,-1,3,1
KR_6769792030,420,0,2,20,2,-2,2,4,6,6,0,2,4,2,-2,1,3,-2,0,2,1,2,0,1,5,6,1,0,0,1,0,0,1,5,1
KR_6769056458,420,0,28,37,1,0,0,0,-2,0,2,2,2,0,3,4,1,-2,3,5,0,0,-10,-1,4,3,-2,0,1,1,-1,1,-1,5,1
KR_6691912737,420,5,71,20,9,4,5,1,9,11,2,-1,2,3,-3,0,3,0,1,1,0,1,-1,1,4,5,0,0,1,1,-1,1,-1,1,1
KR_6717280244,420,3,78,16,10,3,4,1,0,1,1,3,3,0,4,4,0,0,3,3,2,8,-30,-1,4,3,4,0,1,1,1,1,1,2,1
KR_6770449051,420,4,26,96,4,3,4,1,1,1,0,1,1,0,0,2,2,-1,0,1,0,-6,3,3,2,5,1,0,0,0,1,1,1,0,1
KR_6768190581,420,5,50,35,12,0,0,0,6,6,0,2,2,0,-2,2,4,6,6,0,0,14,10,5,3,8,0,0,2,1,1,1,1,2,1
KR_6719022427,440,5,66,-14,22,4,5,1,5,5,0,7,7,0,4,5,1,2,2,0,0,10,-6,2,4,6,4,0,2,-1,1,1,1,1,1
KR_6756587977,420,2,-43,9,6,0,2,2,2,4,2,2,5,3,1,3,2,1,2,1,0,-1,-2,6,4,10,3,0,0,0,1,1,-1,0,1
KR_6622300578,420,2,1,15,5,2,2,0,2,4,2,-1,1,2,3,3,0,-1,0,1,0,8,-140,1,0,1,1,0,0,1,-1,0,1,1,1
KR_6622066866,420,6,64,2,9,2,3,1,3,6,3,-2,1,3,3,4,1,3,4,1,0,7,2,-1,4,3,2,0,2,1,1,1,-1,4,1
KR_6769267839,420,1,57,36,-4,-4,0,4,0,4,4,-1,0,1,1,3,2,0,0,0,0,-5,-1,0,4,4,-2,0,1,-1,1,1,-1,4,1
KR_6732803696,440,5,46,36,8,0,0,0,-2,2,4,7,7,0,2,3,1,1,2,1,0,2,4,0,5,5,0,0,1,-1,1,1,1,4,1
KR_6758942775,420,-2,-67,-10,-4,-6,0,6,0,1,1,-1,3,4,2,4,2,1,2,1,-1,1,47,0,4,4,-17,0,0,-1,-1,1,-1,5,1
KR_6298608699,420,1,-34,-5,7,1,3,2,1,4,3,7,8,1,-4,2,6,2,2,0,3,12,22,-1,8,7,7,0,-1,1,1,1,1,5,1
KR_6760580435,420,1,42,-41,3,3,5,2,-4,3,7,4,8,4,2,3,1,-2,0,2,0,-11,2,4,4,8,-1,0,1,-1,1,1,-1,6,1
KR_6465921263,420,-1,21,-8,3,-1,3,4,0,4,4,2,3,1,1,3,2,1,1,0,5,9,-20,-1,7,6,-4,0,0,1,-1,0,1,2,1
KR_6771142397,420,0,8,-8,0,2,2,0,2,3,1,-1,1,2,-2,1,3,-1,1,2,0,1,-115,5,3,8,-1,0,0,1,-1,0,-1,4,1
KR_6659539638,420,4,3,26,15,1,1,0,8,9,1,2,5,3,3,4,1,1,1,0,0,25,9,2,2,4,5,0,4,1,1,1,1,2,1
KR_6748936123,420,-3,107,10,-4,-1,1,2,-2,1,3,2,4,2,-2,1,3,-1,1,2,0,-11,24,-1,5,4,2,0,1,1,-1,1,1,3,1
KR_6593989990,420,1,41,4,3,4,5,1,-5,0,5,-2,0,2,2,4,2,4,5,1,1,1,7,2,4,6,4,0,1,-1,1,-1,1,4,1
KR_6628640230,420,-1,-43,-4,3,1,1,0,4,5,1,2,4,2,-2,1,3,-2,0,2,0,0,2,4,2,6,-4,0,0,-1,1,-1,1,1,1
KR_6755471871,420,1,113,6,-1,0,2,2,3,5,2,-2,0,2,-1,4,5,-1,0,1,0,-4,16,-1,3,2,3,0,0,1,1,1,1,5,1
KR_6763388636,420,1,5,7,-1,0,2,2,-1,1,2,1,4,3,-1,3,4,0,1,1,0,0,17,-2,5,3,2,0,0,1,0,0,1,1,1
KR_6769852970,420,4,113,-21,14,3,3,0,1,3,2,5,5,0,4,6,2,1,1,0,1,10,-35,2,2,4,2,0,1,1,1,1,1,1,1
KR_6733687057,420,1,-9,-20,2,-1,4,5,0,6,6,-1,0,1,2,4,2,2,2,0,0,1,1,2,3,5,0,0,2,-1,1,1,-1,1,1
KR_6731608401,420,2,19,28,4,0,2,2,1,4,3,3,4,1,-2,2,4,2,3,1,0,6,7,0,4,4,2,0,1,1,1,1,-1,2,1
KR_6759641129,420,-4,-30,-27,-10,-7,1,8,-1,2,3,-1,2,3,0,4,4,-1,2,3,-1,-12,8,1,3,4,-2,0,0,-1,-1,0,-1,1,1
KR_6771423167,420,-1,-53,8,-1,3,4,1,6,6,0,-4,0,4,-5,2,7,-1,1,2,0,4,14,5,5,10,-3,0,-1,1,1,-1,-1,6,1
KR_6743172917,440,2,-3,6,3,-3,0,3,1,4,3,0,1,1,3,3,0,2,4,2,0,-3,-8,0,5,5,2,0,0,-1,1,1,-1,5,1
KR_6763661745,440,2,-60,13,7,2,3,1,0,4,4,3,6,3,2,3,1,0,0,0,0,14,7,3,2,5,-2,0,0,0,-1,0,-1,0,1
KR_6771082771,420,3,26,-24,13,1,3,2,5,6,1,0,1,1,1,4,3,6,7,1,1,13,-1,0,5,5,6,0,2,-1,1,1,1,1,1
KR_6351328450,420,3,11,4,3,4,4,0,2,5,3,-3,2,5,2,3,1,-2,0,2,0,10,-57,-1,7,6,27,0,-1,1,1,-1,-1,5,1
KR_6760219013,420,2,-22,9,5,4,4,0,1,1,0,0,4,4,-3,1,4,3,3,0,0,1,1,-1,4,3,1,0,1,1,1,1,1,4,1
KR_6768372079,420,-1,-37,-4,0,-1,3,4,-2,5,7,5,6,1,0,3,3,-2,0,2,0,-4,2,1,5,6,1,0,0,1,1,0,1,4,1
KR_6715715299,440,5,51,25,15,1,2,1,3,4,1,-1,1,2,11,13,2,1,1,0,1,6,-3,-1,5,4,1,0,2,-1,0,1,1,5,1
KR_6771299170,420,0,-26,-12,-9,-3,1,4,-1,0,1,-3,2,5,-1,1,2,-1,2,3,0,-19,2,-1,6,5,-5,0,0,-1,-1,0,-1,2,1
KR_6763396271,420,-1,14,25,-2,0,0,0,2,2,0,-1,1,2,-2,0,2,-1,0,1,0,-8,14,2,5,7,1,0,0,1,1,1,-1,4,1
KR_6759799853,420,3,-15,37,9,-1,3,4,-1,1,2,2,2,0,8,11,3,1,2,1,1,13,-3,3,4,7,4,0,0,-1,1,0,1,3,1
KR_6650518586,420,5,86,-4,15,2,2,0,4,8,4,4,5,1,5,7,2,0,0,0,0,12,8,3,4,7,-2,0,1,1,1,1,1,6,1
KR_6727255018,420,1,35,12,5,-1,2,3,1,2,1,6,7,1,1,3,2,-2,1,3,1,0,-3,-2,7,5,-1,0,0,1,1,0,1,3,1
KR_6052012755,420,3,26,-15,4,2,2,0,-1,2,3,1,3,2,1,6,5,1,1,0,-1,10,-3,0,8,8,3,1,2,1,1,1,1,3,1
KR_6587849103,440,-1,-2,-4,0,-3,0,3,3,5,2,-3,2,5,5,5,0,-2,0,2,0,-2,-9,3,4,7,0,0,0,1,-1,-1,1,3,1
KR_6762481400,420,4,-19,31,1,-1,6,7,-1,1,2,-2,1,3,0,1,1,5,5,0,0,3,-313,-5,6,1,4,0,1,1,-1,-1,-1,1,1
KR_6769795941,420,3,22,4,8,2,3,1,5,6,1,-1,3,4,2,2,0,0,0,0,1,9,8,-1,6,5,2,0,1,1,1,1,1,3,1
KR_6770825030,420,1,24,1,7,-3,0,3,4,6,2,4,5,1,3,4,1,-1,1,2,0,13,-4,-6,8,2,2,0,2,1,1,1,1,2,1
KR_6730456732,420,3,-25,20,2,4,5,1,-4,0,4,1,2,1,0,2,2,1,1,0,0,-2,-12,1,4,5,-4,0,2,0,1,1,1,0,1
KR_6687026993,440,3,-11,-8,4,3,4,1,5,6,1,-2,0,2,0,2,2,-2,0,2,0,0,10,1,2,3,1,0,1,-1,1,1,1,2,1
KR_6756645698,440,1,-20,8,7,0,0,0,0,6,6,1,2,1,4,4,0,2,2,0,2,17,3,-1,4,3,5,0,0,1,0,-1,-1,5,1
KR_6686827509,420,2,57,-17,11,0,2,2,5,7,2,4,4,0,-1,2,3,3,4,1,0,14,-5,0,5,5,2,0,1,1,1,1,1,5,1
KR_6769502504,420,1,16,2,3,0,1,1,5,6,1,-5,1,6,2,3,1,1,1,0,0,3,-41,4,2,6,24,0,0,1,1,0,1,5,1
KR_6742133396,420,4,-24,13,7,5,5,0,0,4,4,2,3,1,0,4,4,0,2,2,2,5,-7,3,2,5,-3,0,-1,-1,1,-1,1,2,1
KR_6752300034,420,1,47,0,-1,-1,3,4,-3,3,6,1,1,0,2,4,2,0,1,1,-1,-3,8,1,7,8,1,0,1,1,-1,1,-1,2,1
KR_6319418986,420,1,37,1,2,0,1,1,-1,2,3,0,2,2,3,3,0,0,1,1,0,-1,1,-7,11,4,1,0,0,1,-1,1,1,2,1
KR_6397913292,420,1,10,-13,2,3,3,0,-2,1,3,-1,0,1,2,2,0,0,0,0,0,-2,-8,0,4,4,4,0,2,1,1,1,1,2,1
KR_6754205414,420,2,42,-5,3,5,5,0,0,2,2,-2,1,3,2,2,0,-2,1,3,0,4,-29,1,8,9,19,0,2,-1,1,1,-1,1,1
KR_6767968978,420,1,5,9,3,0,1,1,2,3,1,1,5,4,-1,1,2,1,1,0,0,5,-2,4,4,8,2,0,0,1,0,0,-1,5,1
KR_6711998145,420,2,32,36,5,1,3,2,-3,0,3,-4,1,5,9,9,0,2,2,0,0,9,-3,-1,6,5,8,0,1,0,-1,1,1,0,1
KR_6381138298,420,4,4,3,5,1,2,1,0,1,1,-1,3,4,1,2,1,4,7,3,0,0,7,1,3,4,2,0,1,-1,1,1,1,4,1
KR_6764564586,440,3,63,16,3,3,5,2,-4,0,4,-2,1,3,3,3,0,3,3,0,0,1,-2,-1,7,6,-4,0,1,1,1,1,-1,5,1
KR_6747990564,420,2,-78,16,4,4,4,0,4,7,3,-1,2,3,-3,0,3,0,2,2,0,-2,-38,-3,3,0,18,0,-1,0,1,-1,-1,0,1
KR_6723901486,420,0,48,-10,8,0,2,2,-2,1,3,6,8,2,5,6,1,-1,1,2,0,14,4,3,3,6,3,0,2,1,-1,1,1,4,1
KR_6744343813,420,3,30,15,3,5,5,0,-2,1,3,-1,0,1,4,8,4,-3,3,6,0,0,-2,2,5,7,3,0,1,1,1,1,1,3,1
KR_6754953888,420,4,99,9,7,5,5,0,1,5,4,-4,1,5,2,4,2,3,3,0,-1,6,23,4,4,8,6,0,0,-1,-1,1,-1,1,1
KR_6764523223,420,1,-38,-8,3,0,1,1,4,5,1,0,1,1,0,6,6,-1,0,1,0,0,12,6,3,9,-4,0,0,-1,1,0,-1,3,1
KR_6752663732,420,-4,-52,-5,-12,-1,0,1,-8,1,9,-2,1,3,1,2,1,-2,1,3,0,-14,-11,-3,8,5,5,0,-1,1,1,-1,-1,3,1
KR_6765762516,420,8,36,36,14,2,2,0,6,7,1,0,4,4,8,9,1,-2,0,2,0,8,-5,-1,4,3,-1,0,1,1,1,1,1,4,1
KR_6656649848,420,-1,39,0,-1,-1,0,1,2,3,1,-2,0,2,1,3,2,-1,2,3,0,4,-6,5,4,9,-1,0,0,1,0,0,1,5,1
KR_6762461300,420,2,38,0,-3,0,2,2,0,3,3,3,3,0,-6,1,7,0,1,1,0,-9,-3,0,3,3,-1,0,0,1,1,1,-1,5,1
KR_6387453830,420,-3,10,-3,-7,-1,0,1,-6,1,7,-3,0,3,1,2,1,2,2,0,-1,-10,-6,-3,6,3,2,0,1,1,-1,-1,-1,4,1
KR_6747757813,420,0,40,24,1,-1,0,1,-1,1,2,3,4,1,1,5,4,-1,1,2,1,3,141,-1,7,6,4,0,0,1,1,0,1,6,1
KR_6768156764,420,-4,-105,-8,-7,-5,1,6,6,6,0,-1,1,2,-3,0,3,-4,0,4,1,-7,17,1,4,5,-4,0,0,-1,1,-1,1,5,1
KR_6705090271,420,4,49,2,14,-1,2,3,4,4,0,7,9,2,1,4,3,3,4,1,0,8,-1,-1,5,4,2,0,0,1,1,-1,1,5,1
KR_6759148558,420,-1,-12,10,3,-1,0,1,0,1,1,-2,4,6,3,4,1,3,5,2,-1,4,-2,3,4,7,1,0,-1,1,-1,-1,-1,3,1
KR_6751586044,420,3,38,38,10,4,4,0,5,6,1,3,3,0,-2,3,5,0,1,1,0,9,-4,2,4,6,3,0,1,1,1,1,1,6,1
KR_6675461613,420,6,140,39,20,0,3,3,3,3,0,6,6,0,10,10,0,1,1,0,1,23,28,-1,7,6,11,0,2,1,1,1,1,2,1
KR_6652541603,420,1,26,19,0,1,2,1,1,6,5,0,1,1,-2,0,2,0,0,0,0,-1,41,1,5,6,-4,0,0,-1,-1,0,-1,2,1
KR_6740232499,420,4,21,23,7,0,1,1,-3,0,3,8,8,0,2,3,1,0,0,0,0,7,2,2,2,4,-2,0,0,1,1,1,1,3,1
KR_6734006951,420,2,-2,-23,7,6,8,2,2,2,0,0,3,3,2,2,0,-3,0,3,1,1,25,3,4,7,-1,0,1,-1,1,1,1,5,1
KR_6679138714,420,4,-6,14,7,1,2,1,0,1,1,3,4,1,3,5,2,0,1,1,0,3,-12,2,5,7,4,0,1,-1,1,1,1,3,1
KR_6738599849,420,-1,-61,-4,3,2,2,0,-1,0,1,1,3,2,-1,0,1,2,3,1,0,3,2,0,6,6,1,0,-2,-1,-1,-1,1,4,1
KR_6707637633,420,5,96,20,3,0,1,1,2,5,3,-4,2,6,6,6,0,-1,2,3,-1,-3,106,-2,4,2,3,0,2,-1,-1,1,-1,3,1
KR_6768960957,420,0,-34,4,5,1,1,0,0,3,3,-3,0,3,8,8,0,-1,0,1,0,11,-7,-3,7,4,4,0,1,-1,1,1,1,5,1
KR_6722273294,420,-1,-23,11,3,0,4,4,0,3,3,-1,3,4,1,3,2,3,3,0,0,-2,-3,-2,7,5,4,0,0,1,-1,1,1,6,1
KR_6479816035,420,2,37,13,4,-3,0,3,0,4,4,-1,2,3,3,3,0,5,5,0,0,4,25,0,4,4,3,0,1,1,-1,1,-1,3,1
KR_6758252201,420,2,59,12,9,2,3,1,3,5,2,4,4,0,2,3,1,-2,1,3,1,6,-32,1,8,9,5,0,-1,1,1,-1,1,2,1
KR_6765613172,420,-2,-20,-61,-2,3,3,0,-3,0,3,0,1,1,-3,0,3,1,2,1,0,-10,3,-1,2,1,-1,0,0,1,-1,1,-1,6,1
KR_6728549422,420,-1,-22,20,-2,0,0,0,-2,2,4,2,4,2,-3,2,5,1,1,0,0,-2,-1,-2,8,6,5,0,0,1,1,0,1,3,1
KR_6763470951,420,-1,-16,-8,8,1,2,1,4,5,1,2,4,2,0,2,2,1,1,0,0,16,13,5,1,6,2,0,3,1,1,1,1,3,1
KR_6770579284,420,-1,21,24,2,-1,2,3,0,5,5,1,1,0,1,3,2,1,1,0,0,1,-99,2,5,7,0,0,0,1,-1,0,1,3,1
KR_6730865678,420,6,46,36,17,8,8,0,0,0,0,8,10,2,2,5,3,-1,0,1,0,9,9,-2,3,1,0,0,4,1,1,1,-1,3,1
KR_6554182750,420,6,125,38,9,5,5,0,-3,1,4,3,4,1,5,5,0,-1,0,1,0,4,-12,-2,8,6,0,0,2,-1,1,1,-1,4,1
KR_6706316061,420,-2,20,-8,-2,1,2,1,1,6,5,-7,1,8,4,4,0,-1,0,1,0,1,12,-3,5,2,3,0,0,0,-1,-1,1,0,1
KR_6718909180,440,3,33,12,7,5,5,0,3,3,0,0,2,2,1,2,1,-2,0,2,0,9,10,2,4,6,1,0,1,-1,1,1,1,3,1
KR_6747211757,420,5,90,56,2,1,1,0,-6,2,8,-2,1,3,9,13,4,0,0,0,0,2,-206,3,1,4,-2,0,1,-1,0,1,1,2,1
KR_6764898828,420,3,52,-15,13,3,6,3,5,5,0,0,2,2,5,5,0,0,2,2,0,9,2,0,3,3,-2,0,2,1,1,1,1,5,1
KR_6761233743,440,4,83,18,18,7,8,1,3,4,1,0,1,1,8,11,3,0,3,3,4,16,-40,3,6,9,1,0,0,1,0,0,1,1,1
KR_6763725569,420,3,37,4,-1,-2,1,3,0,3,3,0,2,2,0,1,1,1,2,1,0,4,0,-2,5,3,-3,0,0,0,1,1,1,0,1
KR_6600126219,420,3,-42,11,6,-3,1,4,2,5,3,1,1,0,5,6,1,1,2,1,0,15,9,4,5,9,-3,0,-1,1,-1,-1,1,5,1
KR_6636905380,440,3,82,8,7,-1,0,1,7,8,1,3,3,0,-2,0,2,0,0,0,0,5,20,1,1,2,-4,0,1,1,-1,1,1,2,1
KR_6763702625,440,3,-5,11,-3,0,2,2,-1,1,2,4,4,0,-4,0,4,-2,2,4,0,2,87,2,5,7,26,0,1,1,1,1,-1,1,1
KR_6726004022,420,4,2,14,5,1,4,3,0,4,4,0,1,1,1,3,2,3,3,0,0,0,-11,-4,6,2,3,0,1,1,1,1,1,4,1
KR_6764152673,440,0,44,-16,-1,5,5,0,-1,1,2,-1,2,3,-4,1,5,0,3,3,0,-7,1,-4,5,1,1,0,0,1,1,-1,-1,5,1
KR_6765742509,420,3,-33,44,0,-2,2,4,3,4,1,-2,0,2,-1,1,2,2,2,0,0,2,5,-1,7,6,-3,0,1,1,-1,1,1,1,1
KR_6730008520,420,3,-11,13,3,-1,1,2,4,6,2,-2,2,4,-1,3,4,3,4,1,0,5,-28,0,7,7,1,0,0,1,0,0,1,4,1
KR_6716727596,440,2,31,20,6,-1,2,3,-2,3,5,9,9,0,1,2,1,-1,1,2,1,3,269,-3,4,1,6,0,0,1,0,-1,1,4,1
KR_6759998959,440,0,-55,-20,9,-1,2,3,6,6,0,3,5,2,1,3,2,0,1,1,0,17,-21,1,6,7,0,0,0,1,0,1,-1,4,1
KR_6763419270,420,3,26,19,7,5,5,0,-3,1,4,1,1,0,3,5,2,1,1,0,0,0,5,2,3,5,-1,0,0,1,-1,1,-1,4,1
KR_6770284552,420,1,-73,17,7,0,4,4,5,7,2,4,5,1,-1,1,2,-1,1,2,-1,11,3,3,2,5,2,0,0,1,1,1,-1,2,1
KR_6578774299,420,2,111,-24,9,5,5,0,-4,2,6,2,2,0,6,6,0,0,2,2,1,6,5,-3,10,7,3,0,1,-1,-1,1,1,3,1
KR_6729741131,420,-1,-4,-7,2,0,2,2,-3,2,5,3,3,0,1,5,4,1,2,1,0,-2,14,3,5,8,3,0,0,1,1,0,-1,4,1
KR_6722992919,440,1,36,3,3,-1,0,1,7,7,0,-1,2,3,3,3,0,-5,0,5,0,6,4,-2,6,4,-1,0,0,-1,1,0,1,2,1
KR_6621794605,420,-1,-6,-9,4,0,2,2,1,3,2,4,5,1,-2,3,5,1,2,1,1,9,1,-3,6,3,3,0,1,0,1,1,1,0,1
KR_6753693119,440,1,142,-10,2,1,2,1,2,4,2,-3,1,4,0,1,1,2,2,0,0,4,1,2,0,2,3,0,1,-1,1,1,-1,2,1
KR_6770454331,420,2,33,-8,14,2,5,3,0,3,3,7,8,1,5,5,0,0,0,0,0,10,13,4,4,8,2,0,0,0,0,0,-1,0,1
KR_6767951388,420,2,-87,16,0,-3,0,3,2,3,1,-2,1,3,3,4,1,0,0,0,0,1,-346,-3,6,3,-1,0,0,1,-1,0,-1,1,1
KR_6769750306,420,2,90,-22,4,1,2,1,2,4,2,-6,1,7,8,10,2,-1,1,2,-1,-5,-3,6,3,9,-1,0,1,1,-1,1,-1,3,1
KR_6760440361,440,-1,55,12,-2,0,3,3,-1,5,6,0,1,1,-3,1,4,2,2,0,0,-7,9,-2,2,0,1,0,0,-1,0,0,1,1,1
KR_6738452935,420,3,47,8,3,5,5,0,2,2,0,-1,2,3,-5,3,8,2,3,1,0,-4,-1,-2,6,4,2,0,1,0,1,1,-1,0,1
KR_6751593705,420,4,-11,44,18,-2,4,6,4,4,0,11,12,1,4,5,1,1,1,0,0,20,-1,-2,6,4,2,0,2,1,1,1,1,5,1
KR_6771708267,420,-1,26,-1,2,1,2,1,3,4,1,0,3,3,-1,0,1,-1,0,1,0,4,224,3,3,6,-3,0,1,1,1,1,1,5,1
KR_6766929369,420,-2,-73,-24,-5,1,1,0,1,2,1,0,2,2,-4,0,4,-3,0,3,0,-7,-45,-5,8,3,1,0,0,-1,-1,0,-1,5,1
KR_6767543666,420,0,-18,21,1,0,1,1,-4,2,6,4,5,1,1,4,3,0,1,1,0,-6,11,5,4,9,5,0,1,1,1,1,1,5,1
KR_6768712766,420,3,65,12,11,0,1,1,2,5,3,3,5,2,3,4,1,3,3,0,0,17,12,2,3,5,4,0,0,1,-1,1,1,1,1
KR_6766778367,420,0,-14,-20,1,0,2,2,-3,2,5,-1,1,2,2,3,1,3,3,0,0,6,95,-1,5,4,5,0,-1,1,-1,-1,1,3,1
KR_6764382831,420,4,76,-3,4,1,2,1,-1,0,1,-1,1,2,5,7,2,0,0,0,-1,4,4,4,2,6,0,0,3,1,-1,1,-1,3,1
KR_6727054951,420,-1,-31,-12,-3,1,2,1,-2,3,5,0,3,3,-1,1,2,-1,0,1,-1,-6,-29,2,5,7,-6,0,0,1,1,0,-1,4,1
KR_6761928687,420,3,5,51,-1,4,4,0,-5,1,6,3,5,2,-4,4,8,1,2,1,0,-6,12,4,1,5,-3,0,1,1,1,1,-1,3,1
KR_6732832838,420,0,-12,41,3,-1,2,3,1,3,2,4,6,2,0,2,2,-1,0,1,1,2,-10,0,7,7,0,0,0,-1,1,-1,1,2,1
KR_6575391415,420,6,33,36,4,-4,1,5,1,2,1,5,6,1,3,3,0,-1,0,1,0,6,26,0,4,4,-1,0,0,1,-1,1,1,4,1
KR_6769216820,420,3,40,-3,14,0,1,1,7,9,2,-1,4,5,5,5,0,3,4,1,0,15,5,3,1,4,-2,0,1,1,1,1,1,6,1
KR_6618535745,420,4,6,-3,7,0,1,1,-2,2,4,7,7,0,3,4,1,-1,0,1,0,6,5,-1,3,2,2,0,1,-1,1,1,-1,5,1
KR_6618468663,420,2,68,4,8,2,4,2,2,5,3,-2,1,3,5,8,3,1,1,0,0,10,3,4,2,6,5,0,1,1,1,1,-1,5,1
KR_6737245564,440,4,0,18,10,-1,1,2,-1,2,3,1,3,2,9,9,0,2,2,0,0,14,-206,0,5,5,3,0,2,-1,1,1,1,6,1
KR_6745356871,440,2,90,35,4,0,0,0,2,5,3,-2,1,3,5,11,6,-1,1,2,2,3,5,-3,7,4,-3,0,1,1,-1,1,1,3,1
KR_6743228265,420,5,53,0,6,5,6,1,0,2,2,0,3,3,-1,0,1,2,2,0,0,3,-2,2,8,10,-1,0,2,0,1,1,1,0,1
KR_6536051879,420,3,-6,0,6,-1,1,2,1,7,6,0,1,1,3,5,2,3,3,0,0,12,18,0,3,3,2,0,0,1,-1,0,1,6,1
KR_6613586856,420,0,47,0,7,1,2,1,-2,1,3,-2,1,3,8,8,0,2,2,0,0,11,-18,2,5,7,2,0,-1,1,1,-1,1,3,1
KR_6614823734,420,5,78,8,16,3,3,0,7,8,1,2,4,2,5,6,1,-1,0,1,0,22,119,0,7,7,1,0,3,1,0,1,1,6,1
KR_6584934602,440,-1,-35,21,7,-3,0,3,1,5,4,3,4,1,5,6,1,1,1,0,0,4,-7,0,4,4,-4,0,1,-1,1,1,1,1,1
KR_6578642452,420,2,27,35,5,0,3,3,3,4,1,-1,2,3,2,3,1,1,1,0,1,4,0,-3,7,4,6,0,2,1,1,1,1,4,1
KR_6676956087,420,0,-36,1,5,2,2,0,0,2,2,1,2,1,2,3,1,0,0,0,0,5,5,-1,5,4,4,0,0,1,-1,0,1,6,1
KR_6721038382,420,3,35,-11,8,3,5,2,2,3,1,0,0,0,4,5,1,-1,1,2,0,10,81,3,3,6,-1,0,2,-1,1,1,1,5,1
KR_6718879267,420,2,23,16,2,-1,5,6,0,1,1,2,4,2,1,3,2,0,1,1,-1,-3,-14,-1,6,5,1,0,-1,1,-1,-1,-1,1,1
KR_6387410189,420,6,25,-3,17,4,5,1,5,6,1,-5,0,5,9,9,0,4,4,0,1,16,-110,7,4,11,-3,0,1,1,1,1,1,3,1
KR_6762978749,440,3,32,34,6,0,1,1,2,3,1,3,4,1,0,5,5,1,1,0,0,11,2,0,2,2,0,0,0,1,1,0,1,4,1
KR_6746450686,440,-6,-62,16,-11,-4,2,6,0,2,2,-2,0,2,1,2,1,-6,1,7,0,-13,-10,-6,11,5,0,0,0,-1,1,0,1,6,1
KR_6733434891,420,1,-9,8,9,0,4,4,5,8,3,-1,2,3,3,8,5,2,2,0,1,17,27,5,1,6,-6,0,0,-1,1,1,1,5,1
KR_6752796290,420,5,30,12,8,2,2,0,-1,1,2,2,2,0,2,4,2,3,3,0,0,4,-10,-3,6,3,6,0,0,-1,-1,0,-1,6,1
KR_6769115838,420,-2,42,19,-4,-1,0,1,0,2,2,-2,2,4,-1,2,3,0,0,0,0,-1,1,-1,4,3,2,0,0,-1,1,0,1,1,1
KR_6757728353,420,3,50,24,4,0,0,0,3,5,2,-1,2,3,0,1,1,2,2,0,0,2,-6,-3,5,2,0,0,0,1,-1,0,-1,6,1
KR_6768641013,420,1,-31,1,-1,-1,1,2,1,3,2,-2,0,2,0,3,3,1,1,0,0,4,-3,4,4,8,2,0,1,1,0,1,-1,4,1
KR_6654410890,420,4,31,5,6,-1,2,3,1,4,3,0,2,2,3,3,0,3,3,0,0,12,351,1,3,4,3,0,2,1,1,1,-1,2,1
KR_6688084350,420,-2,-10,-11,-10,2,4,2,-5,1,6,-2,0,2,-5,1,6,0,0,0,-1,-18,-10,0,5,5,3,0,-1,1,-1,-1,-1,6,1
KR_6658563586,420,2,31,16,2,2,3,1,1,4,3,-6,0,6,4,5,1,1,1,0,0,2,2,2,7,9,2,0,2,1,-1,1,1,5,1
KR_6751391103,440,2,17,10,9,-1,3,4,-1,4,5,4,6,2,0,2,2,7,9,2,0,8,3,0,3,3,1,0,3,1,1,1,-1,6,1
KR_6750409529,420,-1,-40,0,4,-1,3,4,2,3,1,3,3,0,-1,2,3,1,1,0,0,3,5,2,4,6,-1,0,0,-1,1,0,-1,2,1
KR_6663567173,420,0,36,16,-3,-2,1,3,1,3,2,0,3,3,-1,3,4,-1,2,3,3,-3,-8,4,3,7,-5,0,1,-1,1,1,1,2,1
KR_6734531728,420,0,-21,6,-4,0,2,2,-1,4,5,2,4,2,-2,1,3,-3,0,3,0,-3,16,2,4,6,-3,0,0,1,-1,-1,-1,5,1
KR_6745944721,420,3,12,-3,-1,-3,2,5,-1,1,2,1,1,0,4,5,1,-2,0,2,-1,-1,6,0,5,5,-1,0,-1,1,-1,-1,-1,1,1
KR_6753747918,420,3,123,28,3,-2,2,4,6,8,2,-2,1,3,5,5,0,-4,2,6,0,9,-7,-3,6,3,2,0,2,-1,-1,1,1,3,1
KR_6460607494,420,3,5,5,13,0,2,2,6,9,3,1,4,3,4,5,1,2,3,1,0,14,3,4,4,8,-5,0,0,0,-1,1,1,0,1
KR_6770657408,420,0,15,-1,3,4,6,2,0,3,3,-5,0,5,2,2,0,2,3,1,0,2,-3,2,4,6,-2,0,1,-1,0,1,1,5,1
KR_6771105146,420,0,23,-16,7,5,5,0,1,2,1,0,3,3,2,5,3,-1,0,1,0,8,-33,0,3,3,4,0,1,1,-1,1,1,4,1
KR_6664124862,440,-1,-52,66,2,-5,0,5,6,6,0,0,1,1,1,5,4,0,0,0,-1,-7,-9,-2,11,9,2,0,0,1,1,0,-1,5,1
KR_6746515357,440,5,75,8,11,2,3,1,-1,0,1,3,4,1,6,8,2,1,2,1,0,16,82,4,1,5,0,0,2,1,0,1,1,6,1
KR_6695948393,420,4,38,31,13,1,2,1,5,9,4,9,10,1,-1,2,3,-1,2,3,0,6,7,2,4,6,2,0,1,-1,1,1,-1,2,1
KR_6761266817,420,0,-10,-11,6,-2,0,2,3,6,3,1,2,1,3,3,0,1,2,1,0,4,0,1,3,4,0,0,0,1,1,1,1,6,1
KR_5539864683,420,1,68,-5,10,0,2,2,1,3,2,1,1,0,6,9,3,2,4,2,1,6,3,0,6,6,6,0,0,-1,-1,0,1,4,1
KR_6723060709,420,2,72,-35,1,2,4,2,1,3,2,-4,1,5,3,3,0,-1,1,2,0,4,-34,4,1,5,17,0,0,-1,-1,1,-1,5,1
KR_6768784399,420,5,106,8,9,1,3,2,1,2,1,5,6,1,5,6,1,-3,1,4,0,5,13,1,2,3,5,0,3,1,1,1,1,2,1
KR_6745398340,440,2,-47,2,13,1,4,3,0,1,1,6,8,2,4,6,2,2,2,0,1,19,-7,1,4,5,4,0,-1,1,-1,-1,1,4,1
KR_6714239115,420,3,46,15,9,1,2,1,-2,1,3,2,4,2,7,9,2,1,2,1,0,0,-440,2,3,5,-2,0,1,1,0,1,1,1,1
KR_6738715860,440,-1,6,19,-3,1,2,1,1,2,1,-1,0,1,1,7,6,-5,1,6,0,-4,-222,-2,6,4,2,0,0,1,0,0,1,2,1
KR_6702901595,420,-4,-32,-41,-4,5,6,1,-3,1,4,-2,2,4,-3,0,3,-1,1,2,-1,-6,3,4,3,7,-4,0,-1,-1,-1,-1,-1,4,1
KR_6700950705,420,-3,-68,-12,-10,-3,2,5,1,3,2,-2,1,3,-4,4,8,-2,1,3,0,-11,39,-2,5,3,-22,0,1,-1,1,1,-1,3,1
KR_6771874021,440,2,-22,18,7,0,1,1,1,5,4,2,2,0,6,11,5,-2,1,3,3,10,3,5,3,8,-1,0,1,-1,1,1,1,4,1
KR_6636958531,420,5,24,8,7,1,2,1,4,8,4,4,8,4,0,1,1,-2,1,3,0,5,408,-4,8,4,2,0,2,1,1,1,1,2,1
KR_6594836206,420,3,23,8,2,3,3,0,-4,3,7,0,3,3,2,2,0,1,1,0,0,-2,-2,1,7,8,10,0,-1,-1,1,1,1,4,1
KR_6719982762,420,0,-10,-5,-3,-2,2,4,-2,1,3,2,2,0,-1,1,2,0,1,1,1,0,341,-1,5,4,-2,0,0,-1,-1,-1,1,3,1
KR_6593910401,420,4,84,30,11,4,5,1,2,5,3,4,6,2,1,2,1,0,0,0,1,7,-5,4,5,9,2,0,1,1,0,1,1,3,1
KR_6768523049,420,3,27,8,4,4,5,1,0,1,1,2,5,3,1,1,0,-3,0,3,0,1,-3,-1,3,2,1,0,0,1,-1,1,-1,6,1
KR_6730206087,420,2,-65,16,9,-4,1,5,4,5,1,5,6,1,3,4,1,1,2,1,1,12,36,0,4,4,-1,0,2,1,1,1,1,4,1
KR_6770284781,420,2,49,32,0,-2,2,4,2,4,2,0,2,2,0,4,4,0,1,1,0,1,0,-1,4,3,0,0,0,1,1,0,-1,2,1
KR_6747773468,420,-3,-56,-37,-6,1,2,1,0,2,2,-2,2,4,-4,2,6,-1,1,2,0,0,1,1,3,4,-2,0,-1,-1,1,-1,1,5,1
KR_6717629667,420,0,-3,12,0,-2,3,5,0,4,4,5,5,0,-3,1,4,0,1,1,0,4,-120,-3,4,1,0,0,-1,1,-1,-1,1,6,1
KR_6756230010,420,-1,-33,-12,-7,2,3,1,-2,2,4,1,1,0,-6,1,7,-2,1,3,0,-11,-24,0,5,5,2,0,-1,-1,1,-1,-1,6,1
KR_6759380077,440,0,28,-23,4,-2,0,2,6,6,0,1,3,2,-1,0,1,0,0,0,0,1,-12,-2,11,9,4,0,0,1,1,1,-1,3,1
KR_6747418474,420,2,4,35,1,5,7,2,-1,0,1,0,3,3,-2,4,6,-1,0,1,0,-10,22,0,4,4,0,0,0,0,0,1,-1,0,1
KR_6770660656,420,0,-16,31,-5,-1,1,2,-2,3,5,-3,1,4,2,5,3,-1,0,1,0,-5,-2,-1,7,6,7,0,1,-1,0,1,-1,2,1
KR_6692948039,420,1,7,16,0,2,2,0,-1,2,3,1,4,3,0,6,6,-2,0,2,0,6,-5,-4,7,3,0,0,-1,1,-1,-1,-1,1,1
KR_6704763803,420,4,30,21,15,8,9,1,4,6,2,0,5,5,1,3,2,2,2,0,0,7,8,2,3,5,5,0,2,1,1,1,1,6,1
KR_6764703656,420,4,31,0,11,5,5,0,2,2,0,5,7,2,1,2,1,-2,0,2,0,9,16,3,5,8,-1,0,3,1,1,1,1,6,1
KR_6693543299,420,3,73,4,9,2,3,1,1,5,4,1,4,3,5,6,1,0,1,1,4,19,53,-1,8,7,-22,0,1,1,1,1,1,2,1
KR_6575452920,420,-2,-26,0,-1,-1,1,2,-3,1,4,-1,5,6,4,4,0,0,0,0,0,-7,-4,0,5,5,3,0,-1,1,-1,-1,1,4,1
KR_6689792372,420,1,31,-1,4,3,4,1,4,4,0,-4,2,6,2,4,2,-1,1,2,1,1,10,5,2,7,5,0,2,1,1,1,1,2,1
KR_6764664985,420,4,47,16,4,3,4,1,3,5,2,1,2,1,0,1,1,-3,0,3,0,-4,6,2,5,7,-1,0,2,-1,-1,1,1,6,1
KR_6746761766,420,0,-39,14,6,1,1,0,-2,0,2,3,6,3,1,3,2,3,4,1,0,9,-17,-2,5,3,3,0,0,-1,-1,-1,-1,2,1
KR_6689279164,420,3,33,7,17,3,4,1,10,13,3,3,5,2,-1,0,1,2,4,2,0,16,5,5,1,6,-1,0,2,1,1,1,1,5,1
KR_6737718380,420,-2,-18,11,3,4,4,0,-4,0,4,0,2,2,-1,5,6,4,6,2,-1,7,11,0,11,11,-1,0,0,1,1,-1,-1,6,1
KR_6621551107,420,-1,24,20,3,3,4,1,3,11,8,-2,1,3,0,1,1,-1,2,3,0,-3,32,-3,6,3,-2,0,0,-1,1,1,1,5,1
KR_6770351578,420,-1,-18,-8,0,3,5,2,2,4,2,-2,1,3,-1,1,2,-2,0,2,0,-6,-9,0,6,6,-2,0,2,-1,1,1,-1,6,1
KR_6587943535,440,3,11,23,0,-1,4,5,-2,1,3,-2,2,4,5,7,2,0,1,1,0,-2,2,1,5,6,2,0,0,1,-1,1,-1,5,1
KR_6729995951,440,4,29,17,4,2,4,2,3,6,3,-1,1,2,2,4,2,-2,1,3,1,7,7,-5,5,0,-2,0,2,-1,1,1,1,2,1
KR_6769370632,420,3,9,27,7,1,2,1,2,3,1,-1,1,2,4,7,3,1,2,1,0,13,-20,1,2,3,2,0,1,1,1,1,1,6,1
KR_6704663345,420,3,58,-1,6,0,1,1,1,4,3,1,2,1,3,7,4,1,2,1,0,4,-9,0,7,7,4,0,1,1,1,1,-1,5,1
KR_6684755744,420,6,94,3,16,1,2,1,4,4,0,5,6,1,1,3,2,5,6,1,3,19,25,0,2,2,0,0,3,0,1,1,1,0,1
KR_6767011975,420,0,-25,40,-9,-2,4,6,1,3,2,-8,1,9,1,3,2,-1,0,1,-1,-11,-9,-6,9,3,-1,0,2,1,1,1,-1,6,1
KR_6768514373,420,-2,-1,-40,-1,-2,6,8,-1,1,2,-1,1,2,3,3,0,0,0,0,1,-6,33,2,2,4,-13,0,-1,1,-1,-1,1,4,1
KR_6701161308,420,6,91,31,11,3,9,6,7,7,0,2,3,1,-2,3,5,1,2,1,-1,3,5,2,2,4,0,0,5,-1,1,1,1,2,1
KR_6703975594,420,4,61,14,9,0,2,2,-5,0,5,2,2,0,6,7,1,6,8,2,0,2,-1,1,2,3,2,0,1,1,1,1,-1,2,1
KR_6763691754,420,1,6,-17,1,-1,1,2,4,7,3,-1,1,2,-1,3,4,0,3,3,0,-1,0,-4,9,5,-3,0,2,-1,1,1,1,1,1
KR_6652535666,420,-1,58,15,-1,0,2,2,-3,1,4,3,3,0,1,3,2,-2,1,3,0,-7,-148,8,4,12,-3,0,1,1,1,1,-1,6,1
KR_6711424591,420,0,47,23,-5,-3,0,3,0,2,2,0,2,2,-1,1,2,-1,0,1,0,-5,123,0,5,5,0,0,0,1,-1,0,-1,4,1
KR_6695953922,420,3,67,32,-5,-1,1,2,-7,0,7,1,4,3,3,5,2,-1,0,1,0,-7,4,2,2,4,0,0,-1,-1,1,-1,1,1,1
KR_6544029058,420,3,101,2,3,0,1,1,0,6,6,0,1,1,4,6,2,-1,0,1,0,-1,19,0,3,3,-25,0,0,-1,-1,1,1,4,1
KR_6768096535,420,-1,-32,-20,2,4,4,0,-4,2,6,2,2,0,1,3,2,-1,0,1,0,3,9,1,3,4,0,0,0,-1,-1,0,1,5,1
KR_6589440299,420,3,44,-8,10,0,0,0,2,3,1,1,5,4,6,9,3,1,1,0,0,13,9,4,3,7,-2,0,2,0,1,1,1,0,1
KR_6742830915,420,0,5,-32,0,0,3,3,0,1,1,3,3,0,-3,1,4,0,1,1,1,-4,1,-1,6,5,0,0,0,-1,1,0,1,4,1
KR_6752510316,420,2,113,3,-2,3,3,0,-4,1,5,-3,1,4,1,3,2,1,2,1,0,-1,-7,-1,4,3,-4,0,0,0,0,0,1,0,1
KR_6722336479,420,0,72,-16,0,-3,0,3,1,4,3,5,5,0,-4,2,6,1,2,1,0,-2,4,3,4,7,1,0,1,-1,1,1,-1,2,1
KR_6724013669,420,1,-18,-18,5,3,8,5,2,3,1,0,1,1,0,2,2,0,2,2,1,11,-13,-1,6,5,-3,0,0,0,0,0,1,0,1
KR_6742049325,420,-4,-62,10,-10,-2,1,3,1,3,2,-1,4,5,-8,1,9,0,1,1,0,-9,-11,-1,4,3,0,0,-1,1,0,-1,-1,4,1
KR_6764610569,420,3,8,6,8,3,3,0,4,4,0,3,6,3,-1,2,3,-1,0,1,-2,-1,-3,-2,6,4,6,0,1,1,-1,1,-1,1,1
KR_6740192995,420,-2,-9,9,7,-3,3,6,2,3,1,4,7,3,4,5,1,0,2,2,1,14,-7,3,6,9,7,0,1,1,1,1,1,4,1
KR_6655432701,420,5,39,2,11,2,3,1,3,3,0,1,3,2,5,7,2,0,3,3,0,5,0,0,3,3,4,0,2,-1,1,1,1,1,1
KR_6753012011,420,1,-15,32,-1,3,4,1,3,3,0,0,2,2,-5,2,7,-2,0,2,0,-7,-13,1,5,6,1,0,0,-1,1,1,1,6,1
KR_6136208806,420,5,50,41,11,0,2,2,0,2,2,3,4,1,5,5,0,3,3,0,0,6,-1,6,1,7,-2,0,1,1,-1,1,1,4,1
KR_6740409815,420,3,47,11,4,1,4,3,0,2,2,0,3,3,2,3,1,1,1,0,0,4,-2,1,2,3,-1,0,1,-1,-1,1,-1,1,1
KR_6485111263,440,2,-14,-5,5,0,2,2,-2,2,4,1,1,0,5,6,1,1,2,1,0,13,-34,5,3,8,-1,0,-1,-1,1,-1,1,1,1
KR_6745898395,420,4,78,-27,9,4,4,0,2,2,0,2,3,1,2,4,2,-1,0,1,0,12,20,4,3,7,0,0,1,-1,-1,1,-1,5,1
KR_6675853164,440,-3,-25,-24,-2,1,2,1,0,3,3,0,1,1,-4,1,5,1,1,0,0,-6,-6,-2,6,4,-1,0,-1,-1,1,-1,1,4,1
KR_6760654914,420,1,-15,-31,9,2,2,0,5,6,1,3,5,2,3,4,1,-4,0,4,0,10,5,5,2,7,1,0,2,1,1,1,1,2,1
KR_6716681297,420,1,-32,3,6,1,2,1,3,5,2,-3,1,4,3,3,0,2,2,0,0,9,-16,1,4,5,-1,0,1,-1,1,1,1,2,1
KR_6767856010,420,0,31,-11,1,6,8,2,-7,0,7,1,2,1,0,2,2,1,3,2,1,-8,9,2,7,9,-2,0,-1,-1,1,1,1,1,1
KR_6764074131,420,1,13,5,5,0,4,4,3,5,2,1,2,1,1,3,2,0,2,2,0,11,9,1,1,2,0,0,1,-1,1,1,1,4,1
KR_6733633094,420,-4,-17,3,2,1,1,0,-1,2,3,3,3,0,-1,5,6,0,2,2,0,2,-7,-5,8,3,2,0,0,-1,1,0,-1,6,1
KR_6763578545,420,0,11,4,2,1,3,2,-2,0,2,2,2,0,0,3,3,1,2,1,0,2,-51,0,6,6,-1,0,0,1,1,0,1,3,1
KR_6725611676,420,5,21,64,6,2,4,2,2,6,4,-3,2,5,2,4,2,3,3,0,1,10,-3,-3,8,5,0,0,2,1,0,1,1,1,1
KR_6687650579,440,7,122,8,20,4,4,0,4,5,1,8,9,1,3,5,2,1,2,1,0,10,8,-1,3,2,0,0,2,1,1,1,1,4,1
KR_6703085994,420,1,26,-2,-2,3,4,1,2,6,4,-8,0,8,1,5,4,0,1,1,0,-4,44,0,7,7,-13,0,1,1,-1,1,-1,3,1
KR_6729440891,420,2,53,22,14,-2,1,3,5,5,0,6,6,0,4,4,0,1,2,1,0,10,-3,-1,4,3,5,0,0,1,1,-1,1,1,1
KR_6698907879,420,0,19,-20,11,2,3,1,0,2,2,3,3,0,5,6,1,1,2,1,0,16,-1,4,2,6,2,0,1,0,1,1,1,0,1
KR_6733806021,420,4,38,-19,5,3,3,0,-2,2,4,-3,2,5,7,8,1,0,1,1,0,2,-151,-3,7,4,0,0,0,-1,1,0,-1,6,1
KR_6744015026,420,4,107,16,1,-2,0,2,3,4,1,1,4,3,0,2,2,-1,1,2,-1,-4,1,-1,5,4,5,0,2,1,-1,1,-1,6,1
KR_6677560108,420,-1,-23,5,-6,1,2,1,-1,2,3,-5,0,5,-1,3,4,0,2,2,-1,-3,13,-2,8,6,-3,0,0,1,-1,1,-1,6,1
KR_6760934757,420,0,-30,4,6,0,4,4,3,4,1,0,2,2,3,4,1,0,0,0,-1,14,-9,4,1,5,-1,0,-2,1,0,-1,-1,1,1
KR_6764366145,420,0,-58,12,-4,-2,0,2,1,6,5,-2,0,2,-4,0,4,3,3,0,-1,-16,-4,-5,10,5,-2,0,-1,1,0,-1,-1,6,1
KR_6712087229,420,0,40,12,2,-1,1,2,0,1,1,1,4,3,2,3,1,0,0,0,0,0,2,4,1,5,2,0,0,-1,-1,0,-1,6,1
KR_6692086851,420,5,40,11,9,3,4,1,3,5,2,3,4,1,0,2,2,0,0,0,0,9,-20,-1,4,3,2,0,2,1,1,1,-1,2,1
KR_6726214024,420,3,70,7,6,5,5,0,2,4,2,1,3,2,-1,1,2,-1,1,2,0,3,-59,-2,8,6,17,0,1,1,1,1,-1,4,1
KR_6728895901,440,6,6,3,9,5,6,1,3,4,1,-3,1,4,3,3,0,1,1,0,0,5,9,3,4,7,-1,0,-1,1,-1,-1,-1,6,1
KR_6741230459,420,3,23,39,8,3,5,2,3,4,1,4,7,3,2,5,3,-4,1,5,1,6,-107,6,2,8,-2,0,2,1,-1,1,1,5,1
KR_6738783529,440,2,5,12,5,0,0,0,2,7,5,1,2,1,3,3,0,-1,1,2,0,5,-34,-6,7,1,30,0,0,0,1,1,-1,0,1
KR_6767499548,420,-3,52,4,-9,2,2,0,-5,2,7,-2,0,2,-3,1,4,-1,2,3,0,-8,-4,-1,9,8,-1,0,1,0,1,1,1,0,1
KR_6728910907,420,0,48,13,6,0,0,0,2,4,2,-3,0,3,2,3,1,5,5,0,0,10,25,7,3,10,-2,0,0,1,1,0,1,2,1
KR_6743498679,440,2,78,26,7,1,1,0,3,5,2,1,2,1,3,4,1,-1,2,3,1,11,11,-2,5,3,3,0,1,1,-1,1,1,6,1
KR_6768281684,420,4,66,-9,11,1,3,2,6,6,0,1,1,0,2,3,1,1,1,0,0,16,23,5,3,8,-1,0,1,1,1,1,1,5,1
KR_6712006749,420,2,57,29,2,4,5,1,-1,1,2,1,2,1,0,1,1,-2,1,3,0,0,14,7,1,8,0,0,1,1,1,1,1,2,1
KR_6747130164,420,2,88,-6,7,2,5,3,2,3,1,-1,4,5,2,4,2,2,3,1,1,11,42,-5,8,3,-12,0,2,0,1,1,-1,0,1
KR_6662879558,420,1,44,6,2,-1,0,1,-2,1,3,3,4,1,3,6,3,-1,2,3,0,1,20,0,5,5,-19,0,0,-1,1,1,-1,5,1
KR_6756251711,420,-1,-1,12,-1,1,3,2,1,4,3,0,5,5,0,5,5,-3,0,3,0,8,-5,0,6,6,-3,0,-1,-1,1,-1,-1,2,1
KR_6740526080,420,3,99,3,6,1,4,3,2,4,2,-3,0,3,5,6,1,1,1,0,0,7,12,-1,3,2,2,0,2,1,-1,1,1,1,1
KR_6768927137,420,-1,55,-12,-2,-4,0,4,-6,1,7,3,7,4,2,3,1,3,5,2,0,-2,-12,-3,8,5,0,0,-1,1,-1,-1,-1,4,1
KR_6575870266,420,2,77,-11,3,1,3,2,-1,2,3,1,4,3,1,1,0,1,2,1,-1,4,3,1,5,6,-2,0,1,1,0,1,-1,4,1
KR_6764085308,420,1,46,14,5,0,1,1,10,10,0,-1,4,5,-5,1,6,1,1,0,0,8,7,-1,6,5,3,0,0,1,0,0,-1,1,1
KR_6770837525,420,1,-25,-31,2,4,4,0,-4,0,4,3,4,1,-2,0,2,1,1,0,0,0,12,-2,6,4,1,0,0,-1,1,1,1,5,1
KR_6658878464,420,1,-1,14,3,-4,1,5,3,8,5,1,1,0,0,1,1,3,5,2,1,9,13,1,4,5,-1,0,0,1,1,0,1,3,1
KR_6756966762,420,4,86,13,7,4,5,1,-3,2,5,-1,2,3,5,6,1,2,3,1,0,13,2,1,2,3,-1,0,3,1,-1,1,1,2,1
KR_6765786538,420,1,50,5,2,-2,0,2,4,4,0,0,1,1,-2,3,5,2,2,0,0,-4,-11,-3,6,3,-2,0,0,1,-1,0,1,1,1
KR_6691172132,420,0,-2,7,2,-2,1,3,0,4,4,-2,2,4,5,5,0,1,2,1,0,11,-9,1,4,5,-1,0,0,-1,1,-1,-1,2,1
KR_6750325257,420,3,74,28,-1,4,5,1,-5,1,6,2,4,2,4,4,0,-6,2,8,0,-6,22,2,3,5,-2,0,1,1,1,1,1,1,1
KR_6757224987,420,0,18,-9,-1,-1,2,3,-2,0,2,3,3,0,-1,4,5,0,2,2,0,-6,18,0,6,6,-1,0,0,1,1,0,-1,4,1
KR_6770288793,420,1,21,-25,-1,-2,0,2,-1,4,5,-1,2,3,5,6,1,-2,0,2,0,0,5,2,5,7,1,0,0,-1,-1,-1,-1,6,1
KR_6745353550,420,0,-77,5,5,1,3,2,2,6,4,-2,1,3,3,5,2,1,1,0,0,15,-2,-2,6,4,-2,0,0,1,0,0,-1,1,1
KR_6625696676,440,1,40,0,5,1,2,1,1,2,1,0,3,3,3,4,1,0,1,1,0,8,12,4,1,5,1,0,2,1,0,1,1,4,1
KR_6705056583,420,3,36,20,2,-3,0,3,4,6,2,1,2,1,0,1,1,0,0,0,0,5,2,1,2,3,3,0,1,1,-1,1,-1,5,1
KR_6751328235,420,5,24,27,12,3,5,2,1,6,5,1,2,1,4,4,0,3,5,2,0,10,13,-2,8,6,0,0,1,1,1,1,1,1,1
KR_6709861681,420,5,104,11,12,-1,1,2,5,6,1,1,3,2,5,9,4,2,2,0,0,25,-7,-1,6,5,5,0,2,1,-1,-1,1,6,1
KR_6738724955,420,3,43,18,7,2,2,0,3,8,5,2,5,3,-2,0,2,2,3,1,0,5,2,-2,6,4,3,0,1,1,1,1,1,4,1
KR_6770492111,420,5,-4,12,6,3,4,1,4,5,1,1,6,5,-1,3,4,-1,0,1,0,7,-1,-1,5,4,0,0,1,1,0,1,-1,6,1
KR_6767815695,420,0,-66,1,3,0,2,2,2,3,1,4,6,2,0,0,0,-3,0,3,0,9,-10,-1,6,5,-6,0,0,1,-1,0,1,6,1
KR_6653111866,420,0,42,28,-6,0,0,0,-4,2,6,0,1,1,-3,1,4,1,1,0,0,-14,6,-1,8,7,3,0,0,1,-1,1,1,2,1
KR_6768536518,420,2,-22,20,2,4,6,2,4,4,0,-4,1,5,0,1,1,-2,0,2,0,-1,-3,-2,9,7,0,0,-1,-1,1,-1,-1,3,1
KR_6503925152,420,3,54,12,3,-4,1,5,3,3,0,2,2,0,0,3,3,2,2,0,0,7,-272,-1,7,6,0,0,1,-1,1,1,1,4,1
KR_6351012442,420,1,22,3,6,-2,2,4,2,3,1,6,9,3,1,3,2,-1,1,2,3,12,-2,2,2,4,1,0,1,1,-1,1,1,3,1
KR_6725898722,420,3,-8,-4,6,5,6,1,1,4,3,3,6,3,-1,1,2,-2,0,2,0,7,-32,3,3,6,5,0,2,-1,1,1,1,3,1
KR_6748488504,420,1,20,8,-1,3,3,0,-2,3,5,0,2,2,-3,3,6,1,1,0,0,-3,5,0,6,6,-5,0,-1,-1,1,-1,-1,3,1
KR_6692191398,420,0,-59,8,-5,-2,0,2,-3,0,3,3,3,0,0,3,3,-3,0,3,-1,-1,-1,4,2,6,-1,0,-1,0,1,-1,-1,0,1
KR_6619070682,420,6,27,-5,11,5,6,1,0,5,5,0,4,4,7,8,1,-1,1,2,0,14,-2,0,3,3,2,0,1,-1,0,-1,1,3,1
KR_6763528389,420,0,-54,-12,-5,3,3,0,-2,1,3,-2,1,3,-2,0,2,-2,0,2,0,-11,-11,1,2,3,-4,0,-1,1,-1,-1,-1,1,1
KR_6700918934,420,3,45,3,3,5,6,1,-3,1,4,-3,2,5,4,4,0,0,2,2,0,1,-6,-2,7,5,1,0,0,-1,1,0,1,4,1
KR_6694197688,440,0,27,12,-3,0,3,3,1,4,3,1,2,1,-4,0,4,-1,4,5,0,-12,-29,2,5,7,0,0,0,1,1,1,1,5,1
KR_6751527549,420,2,-6,-12,2,-1,1,2,1,3,2,2,6,4,0,1,1,0,0,0,2,6,1,3,1,4,2,0,1,-1,1,1,1,5,1
KR_6769507155,420,2,18,9,6,4,5,1,1,3,2,0,2,2,1,3,2,0,0,0,1,11,10,0,4,4,-1,0,1,1,-1,1,1,6,1
KR_6757547118,420,5,45,9,9,1,1,0,0,2,2,5,5,0,2,3,1,1,2,1,0,8,-8,-4,7,3,6,0,0,1,1,0,1,1,1
KR_6770227841,420,-1,19,-26,2,2,2,0,2,2,0,-3,1,4,2,2,0,-1,1,2,0,3,-10,0,4,4,-3,0,0,-1,0,0,1,2,1
KR_6771012268,420,4,94,28,8,6,6,0,-1,3,4,0,2,2,0,2,2,3,4,1,0,1,5,0,2,2,-1,0,1,-1,1,1,1,4,1
KR_6543349073,420,1,-42,-24,9,2,2,0,4,4,0,-2,0,2,5,5,0,0,0,0,0,7,-55,4,3,7,0,0,2,1,1,1,1,2,1
KR_6690513926,420,0,30,-16,0,0,4,4,0,5,5,0,2,2,-2,0,2,2,3,1,1,11,96,1,5,6,-1,0,0,1,0,0,1,1,1
KR_6731557822,440,2,-10,16,1,1,3,2,-5,3,8,-1,1,2,3,4,1,3,4,1,0,2,12,-6,8,2,1,0,1,-1,1,1,-1,2,1
KR_6685190554,440,2,-24,9,5,-1,0,1,1,4,3,2,4,2,0,0,0,3,6,3,1,13,-10,2,6,8,-3,0,-2,-1,-1,-1,1,4,1
KR_6770564717,420,2,57,12,1,1,1,0,-3,2,5,2,2,0,2,4,2,-1,0,1,0,1,-17,1,4,5,-3,0,1,1,1,1,1,4,1
KR_6757911931,420,1,-21,23,-2,0,1,1,0,2,2,-5,2,7,3,5,2,0,0,0,-1,0,-4,0,5,5,1,0,1,1,1,1,-1,3,1
KR_6742477415,420,3,57,-2,8,2,3,1,1,4,3,3,3,0,2,2,0,0,0,0,0,11,-12,-2,6,4,-2,0,0,1,-1,0,1,6,1
KR_6743102638,420,7,42,16,9,-1,0,1,5,5,0,4,4,0,-1,3,4,2,2,0,0,5,-6,-2,10,8,9,0,0,-1,-1,0,1,1,1
KR_6736015656,420,3,49,17,2,3,5,2,1,3,2,-1,1,2,2,4,2,-3,1,4,0,-3,-16,-1,4,3,5,0,-1,1,-1,1,1,4,1
KR_6301541287,420,5,28,4,11,1,1,0,-1,0,1,6,6,0,4,4,0,1,1,0,0,10,10,2,4,6,-2,0,2,1,-1,1,-1,2,1
KR_6730540428,420,-3,-35,19,-2,-1,2,3,2,2,0,-2,3,5,-1,3,4,0,0,0,0,-4,7,-4,7,3,-3,0,0,1,-1,0,1,4,1
KR_6717586481,420,3,-4,-24,4,0,2,2,-1,1,2,0,0,0,2,3,1,3,3,0,0,5,3,0,6,6,3,0,0,0,-1,1,1,0,1
KR_6728858101,420,0,76,-39,1,2,3,1,2,4,2,-4,0,4,2,5,3,-1,0,1,0,3,-41,-2,5,3,0,0,0,1,-1,0,-1,1,1
KR_6749128478,440,4,8,14,10,2,4,2,3,4,1,0,2,2,0,0,0,5,7,2,0,10,0,1,8,9,3,0,-1,-1,1,1,1,3,1
KR_6713189525,420,3,57,42,9,5,6,1,-1,4,5,4,6,2,2,5,3,-1,0,1,1,-2,2,1,3,4,-1,0,2,1,1,1,1,4,1
KR_6762389901,420,3,102,-7,5,-1,3,4,1,3,2,-1,4,5,2,4,2,4,4,0,0,6,136,-2,4,2,0,0,-2,1,-1,-1,-1,6,1
KR_6717032746,420,4,96,52,10,1,1,0,2,6,4,5,5,0,4,6,2,-2,1,3,0,2,-192,1,2,3,1,0,2,0,1,1,1,0,1
KR_6759281089,420,1,37,20,-3,-2,1,3,1,5,4,4,7,3,-1,1,2,-5,0,5,0,-6,8,3,2,5,1,0,0,1,1,0,-1,2,1
KR_6714826922,440,5,73,-5,-3,0,0,0,-2,9,11,0,1,1,-3,7,10,2,4,2,-1,-2,-5,0,0,0,0,0,0,0,-1,1,-1,0,1
KR_6744239243,420,3,43,-4,9,2,3,1,0,2,2,1,4,3,6,7,1,0,2,2,0,19,7,-2,8,6,-4,0,2,1,1,1,-1,5,1
KR_6656946777,420,5,59,-3,16,8,8,0,0,1,1,1,2,1,6,7,1,1,2,1,0,10,9,4,1,5,0,0,2,1,-1,1,1,6,1
KR_6428424218,440,1,19,12,3,0,4,4,2,4,2,1,2,1,2,4,2,-2,4,6,0,0,50,7,4,11,-2,0,0,-1,1,0,-1,3,1
KR_6760583014,420,3,55,3,2,-2,1,3,2,2,0,1,1,0,-1,1,2,2,3,1,0,1,52,1,3,4,-21,0,0,1,1,1,1,4,1
KR_6765726268,420,4,-21,26,6,5,6,1,4,5,1,-1,0,1,-2,0,2,0,0,0,0,0,1,2,4,6,-2,0,1,1,1,1,-1,1,1
KR_6760196844,420,3,91,-8,5,3,5,2,-2,3,5,-2,0,2,4,5,1,2,3,1,0,12,-30,0,6,6,0,0,1,1,1,1,-1,5,1
KR_6732890978,420,3,39,16,7,2,4,2,0,3,3,0,3,3,4,6,2,1,2,1,-1,11,48,0,3,3,0,0,1,-1,-1,1,-1,2,1
KR_6725123491,420,3,46,23,16,4,5,1,4,4,0,4,5,1,1,5,4,3,3,0,1,18,4,2,2,4,-1,0,3,1,1,1,1,5,1
KR_6703390372,420,1,1,32,-1,1,3,2,0,2,2,-5,0,5,3,3,0,0,1,1,0,-3,25,-6,9,3,8,0,3,1,1,1,-1,5,1
KR_6394674106,420,3,-50,61,2,-2,1,3,5,8,3,1,2,1,-6,0,6,4,4,0,1,8,18,3,7,10,-4,0,0,1,1,0,1,5,1
KR_6727305098,420,-2,25,-14,-12,3,5,2,-3,0,3,-5,1,6,-5,1,6,-2,0,2,0,-25,-16,-1,3,2,-1,0,0,-1,-1,-1,1,5,1
KR_6679192924,420,3,19,3,9,0,0,0,4,5,1,5,6,1,-1,0,1,1,1,0,1,17,172,0,6,6,0,0,2,0,1,1,1,0,1
KR_6725850881,420,2,-9,5,6,6,6,0,2,4,2,0,1,1,-2,2,4,0,0,0,0,10,-25,-5,9,4,2,0,3,1,1,1,-1,3,1
KR_6739045706,420,0,1,-16,-4,0,1,1,-1,3,4,-6,0,6,1,6,5,2,2,0,-1,7,18,0,5,5,-1,0,0,1,1,-1,-1,5,1
KR_6766596528,420,1,0,12,2,-2,0,2,1,2,1,2,3,1,0,3,3,1,2,1,1,3,2,-1,6,5,3,0,0,1,-1,-1,1,3,1
KR_6301533621,420,4,-8,19,5,-4,3,7,3,3,0,3,3,0,3,3,0,0,0,0,0,4,3,1,6,7,0,0,1,1,-1,1,-1,5,1
KR_6766773037,440,1,74,12,-6,-1,1,2,2,3,1,-7,1,8,-1,2,3,1,1,0,-1,-9,-2,-3,5,2,1,0,0,1,-1,-1,-1,3,1
KR_6751728950,420,0,46,36,-13,1,2,1,-4,2,6,-3,0,3,-4,2,6,-3,1,4,0,-21,-35,-6,10,4,-1,0,-1,-1,-1,1,-1,5,1
KR_6769219583,420,0,54,20,1,0,1,1,1,3,2,1,4,3,0,2,2,-1,1,2,0,0,-5,0,3,3,3,0,1,-1,1,1,1,6,1
KR_6770966878,420,0,-65,-20,5,-3,1,4,0,1,1,3,4,1,5,6,1,0,1,1,0,11,-3,3,2,5,-6,0,-1,-1,-1,-1,1,4,1
KR_6738372010,420,1,21,-8,4,-2,2,4,1,4,3,1,3,2,5,5,0,-1,1,2,0,9,3,-2,7,5,6,0,0,1,0,0,1,4,1
KR_6765479751,420,6,66,24,12,5,5,0,9,10,1,-2,2,4,0,3,3,0,0,0,0,2,32,0,4,4,2,0,3,1,1,1,1,6,1
KR_6758911985,420,4,60,-5,0,1,4,3,-3,1,4,-1,2,3,2,4,2,1,2,1,0,-2,-3,0,4,4,0,0,0,1,-1,-1,-1,6,1
KR_6681317928,420,-1,48,-6,1,2,2,0,4,6,2,-7,1,8,1,2,1,1,1,0,0,5,-5,1,4,5,0,0,-1,-1,1,1,1,6,1
KR_6666173284,420,2,61,19,-1,-1,2,3,3,4,1,1,3,2,-2,1,3,-2,0,2,-1,1,110,0,7,7,4,0,1,-1,1,1,-1,1,1
KR_6766651369,420,2,18,-8,6,1,3,2,0,2,2,6,8,2,-4,2,6,3,3,0,0,5,-140,-2,6,4,24,0,0,1,-1,0,-1,5,1
KR_6767731916,420,4,83,52,9,5,5,0,-1,1,2,4,6,2,-1,2,3,2,2,0,0,5,-112,3,0,3,0,0,2,1,1,1,1,2,1
KR_6768599075,440,0,66,16,-7,0,2,2,-3,3,6,-2,1,3,0,1,1,-2,0,2,0,-4,437,4,1,5,3,0,0,0,-1,0,-1,0,1
KR_6688428049,420,3,81,-12,9,1,1,0,3,4,1,4,5,1,5,6,1,-4,0,4,0,8,-20,0,6,6,2,0,2,1,1,1,-1,2,1
KR_6638845915,420,2,42,-8,4,1,1,0,-4,2,6,4,4,0,3,7,4,0,1,1,-1,4,-8,4,5,9,-2,0,0,-1,1,1,-1,3,1
KR_6701992951,420,-3,-31,-7,-1,4,6,2,0,4,4,-4,2,6,-4,2,6,3,3,0,1,1,4,4,2,6,-1,0,0,-1,1,1,1,6,1
KR_6701011706,420,2,-8,8,5,2,3,1,3,7,4,1,1,0,4,5,1,-5,0,5,0,10,-39,6,2,8,15,0,0,1,-1,-1,-1,6,1
KR_6743165834,420,0,40,4,1,0,3,3,-2,2,4,4,6,2,0,4,4,-1,2,3,0,2,6,3,5,8,5,0,0,-1,0,1,-1,5,1
KR_6154222334,440,0,-24,17,4,0,0,0,-1,4,5,5,5,0,-2,1,3,2,2,0,1,6,-3,-3,9,6,-4,0,0,0,1,0,1,0,1
KR_6625066933,420,2,41,34,-1,0,0,0,0,3,3,4,5,1,-3,1,4,-2,1,3,-2,-10,5,0,3,3,-5,0,1,1,1,1,-1,3,1
KR_6745955923,420,5,70,24,10,2,3,1,-1,1,2,2,4,2,2,3,1,5,5,0,0,8,3,-1,6,5,2,0,2,1,-1,1,1,5,1
KR_6633534588,420,3,140,-16,3,-1,2,3,-2,2,4,-4,1,5,9,9,0,1,4,3,-1,-4,4,1,2,3,4,0,1,1,-1,1,-1,5,1
KR_6486655119,440,-2,0,4,-9,-3,2,5,-6,0,6,-4,0,4,0,1,1,4,4,0,-2,-19,-3,-4,10,6,-3,0,0,-1,0,-1,-1,6,1
KR_6767229937,420,7,22,76,14,0,1,1,5,5,0,5,6,1,-1,3,4,5,6,1,0,5,91,-5,7,2,6,0,1,0,-1,1,1,0,1
KR_6057158618,440,4,77,-20,6,1,2,1,0,1,1,7,9,2,-3,0,3,1,4,3,0,7,7,-1,5,4,2,0,1,1,0,1,1,5,1
KR_6694131309,420,0,-32,-13,-3,5,6,1,0,3,3,1,4,3,-6,1,7,-3,0,3,0,-7,-1,1,4,5,-2,0,0,1,-1,1,-1,6,1
KR_6693307350,420,4,53,12,12,2,3,1,-2,0,2,6,9,3,0,2,2,6,6,0,1,14,-1,-2,6,4,-1,0,1,1,1,1,1,4,1
KR_6762268436,420,5,73,52,17,5,5,0,1,2,1,13,13,0,0,4,4,-2,1,3,0,3,-5,-2,7,5,7,0,3,1,1,1,-1,1,1
KR_6740474269,420,0,57,5,2,-2,0,2,4,7,3,0,1,1,1,2,1,-1,1,2,0,4,3,3,2,5,0,0,0,1,1,0,-1,4,1
KR_6767371283,420,4,47,40,-2,-3,0,3,0,2,2,2,4,2,0,6,6,-1,0,1,0,-4,-1,3,4,7,-4,0,1,1,1,1,1,2,1
KR_6647623220,420,3,50,6,9,4,5,1,-2,0,2,0,1,1,6,7,1,1,2,1,1,5,2,-2,7,5,3,0,2,1,1,1,1,3,1
KR_6745178598,420,4,21,11,9,-1,1,2,-2,0,2,5,5,0,7,10,3,0,0,0,0,6,-20,-2,5,3,7,0,0,1,1,0,-1,5,1
KR_6651367135,420,1,41,0,5,6,6,0,-4,4,8,5,8,3,-1,2,3,-1,0,1,2,7,-7,1,5,6,1,0,1,0,1,1,1,0,1
KR_6752113383,420,4,61,9,10,0,1,1,2,3,1,4,4,0,5,5,0,-1,1,2,0,7,3,1,5,6,-2,0,0,-1,0,0,1,3,1
KR_6765079852,420,2,-22,32,2,1,2,1,-2,4,6,1,3,2,0,5,5,2,3,1,0,0,-1,2,3,5,-3,0,0,1,1,0,1,3,1
KR_6537543839,420,1,33,13,3,0,3,3,3,3,0,2,3,1,-1,2,3,-1,0,1,0,-4,34,-4,7,3,-16,0,2,1,1,1,1,1,1
KR_6701975686,420,5,3,10,10,3,3,0,3,3,0,6,7,1,-2,1,3,0,0,0,0,-1,7,2,2,4,2,0,3,1,1,1,1,6,1
KR_6762043117,420,3,47,-4,2,0,2,2,0,2,2,1,1,0,4,4,0,-3,0,3,0,-1,25,2,4,6,2,0,1,-1,-1,1,-1,3,1
KR_6681942105,420,2,39,-4,4,3,5,2,-1,0,1,0,3,3,2,2,0,0,3,3,0,0,-1,0,5,5,2,0,0,-1,1,1,-1,3,1
KR_6716166920,420,4,26,-12,3,1,2,1,1,3,2,3,3,0,-1,1,2,-1,0,1,0,5,-343,0,6,6,1,0,0,1,-1,0,1,6,1
KR_6736156855,420,-1,10,-40,-3,-4,0,4,4,5,1,2,2,0,-2,1,3,-3,2,5,-1,-4,-33,-1,5,4,5,0,-1,1,-1,-1,-1,5,1
KR_6764879508,420,2,71,-8,6,-1,1,2,0,1,1,-4,0,4,9,12,3,2,2,0,0,12,41,-4,8,4,-26,0,0,1,-1,1,1,5,1
KR_6760425829,420,4,-19,35,3,4,4,0,3,5,2,-2,2,4,-2,1,3,0,3,3,0,10,2,3,3,6,1,0,0,1,-1,1,-1,6,1
KR_6760650893,440,3,7,-7,9,1,1,0,1,2,1,4,6,2,2,3,1,1,3,2,0,19,-68,2,3,5,0,0,1,-1,-1,1,1,4,1
KR_6660108692,440,1,66,15,1,0,2,2,1,6,5,-3,3,6,2,6,4,1,1,0,0,4,8,8,3,11,-4,0,2,1,1,1,1,1,1
KR_6768070509,420,0,34,-15,2,3,4,1,2,4,2,-3,1,4,0,2,2,0,0,0,0,3,0,2,3,5,1,0,1,-1,1,1,1,2,1
KR_6766937286,420,1,11,4,3,5,6,1,2,4,2,-3,5,8,-1,3,4,0,1,1,0,8,-5,-6,7,1,-1,0,0,1,-1,0,1,5,1
KR_6750064276,420,2,67,9,2,5,6,1,-5,3,8,1,3,2,-2,1,3,3,3,0,-1,-14,-5,0,7,7,-6,0,1,-1,1,1,-1,3,1
KR_6765522004,420,-1,-23,8,-1,-1,3,4,3,3,0,0,3,3,-5,1,6,2,2,0,-1,3,-5,-1,6,5,1,0,-2,1,-1,-1,-1,2,1
KR_6752204694,420,-3,-22,18,-4,0,1,1,-1,3,4,1,1,0,-2,1,3,-2,0,2,0,-8,-277,5,4,9,-8,0,0,1,0,-1,1,3,1
KR_6770222181,420,1,51,28,4,2,3,1,7,9,2,-5,1,6,1,2,1,-1,0,1,0,3,1,-3,8,5,1,0,0,1,1,1,-1,2,1
KR_6728866668,420,3,25,16,7,6,6,0,3,4,1,-3,5,8,0,2,2,1,2,1,0,8,16,0,5,5,0,0,1,0,-1,1,-1,0,1
KR_6686916312,420,1,-9,16,1,-2,2,4,0,2,2,-2,0,2,4,6,2,1,1,0,0,1,-1,-2,5,3,2,0,1,-1,1,1,-1,1,1
KR_6771791566,420,-1,41,-16,1,1,2,1,2,3,1,0,1,1,-3,2,5,1,2,1,0,-4,-5,-3,10,7,1,0,0,1,1,0,-1,5,1
KR_6754130383,440,0,-22,24,6,0,1,1,1,1,0,4,5,1,1,1,0,0,1,1,0,7,11,1,4,5,2,0,0,1,-1,0,-1,3,1
KR_6759384327,420,2,13,-29,10,2,2,0,4,4,0,3,3,0,3,5,2,-2,0,2,0,16,4,2,4,6,-4,0,1,1,-1,1,-1,5,1
KR_6685100928,420,-2,-63,11,-1,-3,1,4,1,2,1,0,2,2,0,2,2,1,1,0,0,-5,-5,-2,5,3,0,0,0,-1,1,1,1,2,1
KR_6740593247,420,2,78,-13,1,1,2,1,-2,6,8,-1,2,3,1,5,4,2,2,0,0,5,11,7,2,9,-6,0,1,1,1,1,-1,3,1
KR_6752924445,420,6,69,40,12,0,0,0,13,13,0,-2,0,2,2,2,0,-1,1,2,0,9,-18,1,5,6,3,0,0,0,1,0,-1,0,1
KR_6749267821,440,3,74,-13,3,4,4,0,-1,2,3,1,4,3,0,1,1,-1,2,3,0,-2,-3,-2,5,3,3,0,1,1,1,1,1,6,1
KR_6763725209,420,1,-38,-27,4,3,3,0,1,2,1,-1,2,3,1,2,1,0,0,0,0,-5,7,2,5,7,-1,0,0,1,-1,0,-1,2,1
KR_6730453048,420,2,6,5,9,2,5,3,-6,0,6,0,1,1,4,4,0,9,11,2,0,16,-8,-1,6,5,7,0,-1,1,1,-1,1,6,1
KR_6768886585,420,2,15,4,10,-3,1,4,3,4,1,1,6,5,9,10,1,0,1,1,0,19,-19,-2,9,7,2,0,0,1,-1,1,1,1,1
KR_6749227850,420,-1,-60,16,-1,-5,1,6,0,3,3,3,3,0,0,6,6,1,2,1,0,5,-278,-4,8,4,-7,0,-2,1,-1,-1,1,2,1
KR_6718673301,420,3,-9,-16,9,8,9,1,-6,1,7,1,2,1,5,6,1,1,1,0,-1,12,123,-1,7,6,7,0,2,1,1,1,-1,6,1
KR_6638201769,420,2,-12,4,2,-3,0,3,-4,1,5,4,5,1,4,4,0,1,1,0,0,4,9,-5,8,3,7,0,-1,1,-1,-1,1,2,1
KR_6708756162,420,1,15,28,5,-1,3,4,-2,2,4,6,7,1,1,5,4,1,1,0,0,5,-7,-1,5,4,0,0,0,1,0,0,1,2,1
KR_6750475113,420,-1,-43,-30,-4,-1,2,3,4,6,2,-5,0,5,-2,0,2,0,1,1,0,-2,4,5,2,7,-3,0,-2,-1,-1,-1,-1,4,1
KR_6616688925,420,3,50,10,-2,3,5,2,-3,1,4,-1,1,2,-4,1,5,3,3,0,0,-9,3,0,3,3,0,0,1,1,1,1,-1,2,1
KR_6647034030,420,1,19,6,3,0,3,3,2,3,1,5,6,1,-4,0,4,0,1,1,0,3,136,-7,8,1,2,0,-1,1,-1,-1,1,1,1
KR_6770271705,420,3,11,-6,-3,1,1,0,0,4,4,0,3,3,-8,0,8,4,6,2,2,-5,7,-3,6,3,0,0,2,1,0,1,1,2,1
KR_6744975626,420,2,5,-4,6,-1,0,1,3,7,4,5,5,0,-2,1,3,1,2,1,2,11,48,2,5,7,-35,0,-1,-1,-1,1,1,5,1
KR_6527635571,420,3,31,16,5,2,3,1,3,4,1,4,4,0,-2,1,3,-2,0,2,0,-3,-136,-2,7,5,3,0,-1,-1,1,-1,-1,4,1
KR_6496514096,420,1,-4,8,-1,-3,0,3,1,2,1,3,7,4,-1,2,3,-1,0,1,0,-2,-9,-2,6,4,3,0,0,1,-1,0,1,5,1
KR_6552260521,420,2,60,12,8,0,2,2,2,3,1,7,7,0,0,4,4,-1,0,1,0,2,-9,1,4,5,1,0,0,-1,1,1,1,4,1
KR_6735755654,420,-1,47,-23,-7,1,6,5,-1,2,3,-5,0,5,-2,1,3,0,0,0,1,-13,-10,-4,10,6,4,0,2,-1,-1,1,1,4,1
KR_6770789934,420,3,29,8,10,3,4,1,2,4,2,4,4,0,1,2,1,0,1,1,-1,10,9,7,1,8,-2,0,2,1,-1,1,-1,5,1
KR_6673209485,420,-2,-37,-16,-1,-3,0,3,1,5,4,1,2,1,1,1,0,-1,2,3,0,8,-15,6,4,10,-9,0,-1,1,-1,-1,1,1,1
KR_6578709456,420,3,47,-18,8,-3,3,6,3,5,2,2,2,0,6,6,0,0,2,2,0,14,-4,1,6,7,-1,0,1,1,1,1,-1,5,1
KR_6744519456,420,1,-36,10,-1,-1,5,6,0,1,1,-5,2,7,4,6,2,1,1,0,0,6,275,5,6,11,-4,0,-1,1,-1,-1,-1,3,1
KR_6752203569,420,-1,-7,-4,3,-3,0,3,3,4,1,-3,3,6,4,6,2,2,3,1,0,0,-7,-1,7,6,3,0,1,-1,1,1,1,5,1
KR_6766626136,420,4,52,-3,4,4,4,0,-2,1,3,2,5,3,-1,3,4,1,1,0,0,0,235,-2,4,2,-1,0,0,1,0,0,-1,3,1
KR_6758669252,420,1,89,-32,4,-1,0,1,1,3,2,1,3,2,1,4,3,2,2,0,0,-2,24,2,2,4,-3,0,0,-1,1,1,1,2,1
KR_6771036270,420,4,92,9,6,4,4,0,1,4,3,-7,2,9,6,6,0,2,2,0,1,10,-6,-1,4,3,3,0,2,0,1,1,1,0,1
KR_6579188803,420,9,102,-8,15,4,5,1,2,3,1,3,6,3,5,5,0,1,1,0,0,19,1,5,2,7,7,0,1,-1,1,1,-1,4,1
KR_6765545015,420,3,-16,4,8,1,3,2,3,6,3,0,4,4,2,4,2,2,2,0,-1,11,-45,1,3,4,0,0,1,-1,-1,1,-1,5,1
KR_6557218517,420,4,18,-4,14,4,4,0,7,8,1,4,4,0,-1,3,4,0,0,0,0,14,3,4,2,6,1,0,1,1,1,1,1,2,1
KR_6770602230,420,-1,1,-47,-1,1,1,0,1,2,1,1,1,0,-2,0,2,-2,0,2,0,-3,-5,-1,9,8,2,0,0,-1,0,0,1,3,1
KR_6724457562,420,-1,50,-6,-2,4,4,0,0,1,1,-3,2,5,-1,3,4,-2,1,3,0,-6,-5,1,5,6,-2,0,2,-1,1,1,1,2,1
KR_6751202712,420,-2,5,-17,0,-2,0,2,6,7,1,0,3,3,-3,1,4,-1,0,1,0,5,9,-4,7,3,-9,0,-1,1,-1,-1,-1,6,1
KR_6748091036,420,1,-54,24,1,0,1,1,-2,1,3,-1,4,5,3,3,0,1,2,1,0,1,-5,-5,10,5,-2,0,-1,1,0,-1,-1,3,1
KR_6762044400,420,0,-11,-26,3,-2,1,3,1,5,4,-1,5,6,5,6,1,0,0,0,0,-2,12,5,1,6,3,0,1,1,-1,1,1,6,1
KR_6748402706,420,1,-24,31,2,-1,1,2,2,7,5,1,2,1,-1,4,5,1,1,0,0,5,-322,-1,7,6,0,0,0,-1,-1,-1,-1,6,1
KR_6763468984,420,-3,-12,-23,1,0,3,3,0,2,2,2,3,1,2,4,2,-3,0,3,0,-4,15,5,2,7,-2,0,0,-1,1,0,1,3,1
KR_6538336783,420,4,48,24,5,4,4,0,2,5,3,0,0,0,-2,2,4,1,1,0,0,1,1,-2,6,4,3,0,2,-1,-1,1,1,2,1
KR_6577640703,420,7,129,4,12,1,2,1,2,3,1,6,8,2,1,3,2,2,2,0,0,10,-8,-2,6,4,6,0,1,1,1,1,1,4,1
KR_6565842727,420,2,-6,44,3,2,2,0,1,5,4,1,3,2,-1,2,3,0,4,4,0,-3,-4,-7,9,2,4,0,1,-1,1,1,-1,6,1
KR_6708867247,420,1,8,0,4,-1,1,2,1,3,2,0,3,3,2,5,3,2,2,0,0,9,-6,-1,5,4,4,0,1,1,-1,1,1,5,1
KR_6685940079,420,2,16,-2,5,1,2,1,4,7,3,0,2,2,1,1,0,-1,0,1,0,3,14,-3,6,3,4,0,0,0,1,0,1,0,1
KR_6487465124,420,-2,-30,-14,-1,1,6,5,-1,2,3,1,4,3,0,4,4,-2,1,3,1,1,4,-2,4,2,1,0,2,1,1,1,1,6,1
KR_6635467669,420,2,116,-20,3,0,2,2,-1,5,6,1,4,3,6,6,0,-3,2,5,-1,3,-43,-1,4,3,16,0,1,-1,1,1,-1,2,1
KR_6748279396,420,1,66,16,0,0,2,2,-1,5,6,0,6,6,0,2,2,1,4,3,-1,-5,-13,-4,8,4,6,0,0,-1,1,1,-1,4,1
KR_6613534832,420,3,50,21,8,1,3,2,1,4,3,1,2,1,1,3,2,4,4,0,0,11,3,5,3,8,-2,0,0,1,-1,0,1,3,1
KR_6717100105,420,3,75,22,10,1,2,1,4,4,0,7,7,0,-2,4,6,0,0,0,0,6,-105,-3,7,4,-5,0,0,1,-1,-1,1,1,1
KR_6767523287,420,2,24,-15,2,2,6,4,-3,3,6,2,2,0,4,5,1,-3,1,4,0,-4,-3,6,2,8,1,0,1,-1,1,1,-1,4,1
KR_6769557848,420,-2,22,0,-3,-3,1,4,-3,4,7,-1,0,1,3,5,2,1,1,0,0,5,-26,0,6,6,1,0,1,1,1,-1,-1,2,1
KR_6769328180,420,4,39,-8,9,-3,1,4,8,8,0,4,5,1,-1,0,1,1,3,2,0,11,-11,-6,8,2,4,0,1,-1,-1,1,1,6,1
KR_6759164630,420,2,6,14,5,4,4,0,-3,3,6,1,1,0,1,1,0,2,2,0,0,6,104,-1,7,6,1,0,1,1,1,1,1,6,1
KR_6768934987,420,-2,-34,-18,2,-1,2,3,-2,1,3,1,5,4,3,5,2,1,1,0,1,14,10,6,1,7,0,0,0,-1,1,0,1,4,1
KR_6763483250,420,2,-27,21,9,2,2,0,5,7,2,4,5,1,-3,2,5,1,1,0,0,7,-40,-4,9,5,20,0,1,1,1,1,-1,1,1
KR_6577580661,420,0,-17,-16,4,-2,0,2,3,6,3,1,3,2,2,3,1,0,2,2,0,8,4,7,2,9,0,0,-1,1,-1,-1,-1,3,1
KR_6596141698,440,2,-10,14,7,1,3,2,1,4,3,0,0,0,7,9,2,-2,0,2,0,5,-31,2,4,6,19,0,1,-1,1,1,1,3,1
KR_6671712126,440,4,24,28,17,16,16,0,3,5,2,-4,0,4,2,2,0,0,0,0,1,1,109,2,0,2,-2,0,4,1,1,1,1,1,1
KR_6765426824,420,3,-3,-2,2,2,4,2,-2,2,4,-3,3,6,4,4,0,1,1,0,0,9,11,3,1,4,3,0,1,1,-1,1,-1,6,1
KR_6756861155,440,1,-15,-17,-1,2,3,1,2,2,0,-2,4,6,-2,0,2,-1,0,1,0,-4,2,0,4,4,1,0,-2,-1,-1,-1,1,5,1
KR_6676725839,420,0,25,-35,6,0,2,2,3,4,1,-1,0,1,4,6,2,0,0,0,-1,8,0,0,6,6,6,0,0,-1,-1,0,-1,1,1
KR_6759601386,420,-2,-59,26,-10,-6,1,7,1,3,2,-1,0,1,-4,2,6,0,1,1,0,-7,17,-7,10,3,0,0,0,-1,1,0,-1,3,1
KR_6653229876,420,-1,7,-1,-3,0,3,3,3,5,2,-2,0,2,-4,1,5,0,3,3,0,-9,-9,0,6,6,2,0,1,-1,1,1,1,4,1
KR_6767896877,420,2,105,-22,3,1,4,3,-2,3,5,1,5,4,2,6,4,1,2,1,0,-1,144,-8,9,1,2,0,2,-1,1,1,1,2,1
KR_6687694703,440,1,54,-12,4,-3,1,4,-3,1,4,1,4,3,9,10,1,0,1,1,1,7,18,4,3,7,1,0,0,1,-1,-1,-1,4,1
KR_6763108684,420,1,92,-4,-3,1,2,1,0,2,2,-1,3,4,-1,2,3,-2,2,4,-1,-3,-43,-1,6,5,29,0,0,-1,-1,-1,-1,5,1
KR_6701258571,420,2,33,-19,3,1,1,0,0,1,1,0,0,0,2,3,1,0,2,2,0,3,-6,1,6,7,-2,0,0,-1,1,0,1,2,1
KR_6769117170,420,4,13,16,16,2,3,1,5,6,1,2,4,2,5,5,0,2,2,0,0,21,-6,3,5,8,-4,0,1,-1,1,1,1,6,1
KR_6770782049,420,1,81,8,1,9,9,0,-6,0,6,-3,1,4,0,6,6,1,1,0,0,-8,-2,2,3,5,5,0,1,-1,1,1,1,4,1
KR_6701193654,420,6,80,47,4,-2,1,3,7,8,1,-1,1,2,1,4,3,-1,0,1,1,7,-17,2,4,6,0,0,1,1,1,1,1,2,1
KR_6737656511,420,5,40,33,1,1,4,3,0,1,1,-2,2,4,2,4,2,0,2,2,-2,-13,1,2,3,5,3,0,1,1,1,1,-1,3,1
KR_6656890537,420,3,-19,17,6,4,4,0,3,5,2,-1,3,4,-2,1,3,2,2,0,0,-1,-21,1,5,6,2,0,0,1,1,1,-1,4,1
KR_6762176214,420,1,10,24,3,3,3,0,0,2,2,-2,3,5,1,4,3,1,3,2,0,4,-8,-4,7,3,4,0,0,-1,-1,0,1,4,1
KR_6752988344,420,4,-4,22,5,1,2,1,3,5,2,-1,1,2,3,4,1,-1,1,2,0,3,2,-1,4,3,-2,0,0,1,1,0,-1,2,1
KR_6764992176,420,0,-15,-20,2,2,4,2,-2,1,3,1,3,2,2,4,2,-1,0,1,-1,-1,-11,-3,7,4,8,0,-1,1,-1,-1,-1,1,1
KR_6692304451,420,-1,45,-8,-1,5,7,2,-3,1,4,-3,0,3,0,4,4,0,2,2,0,-10,6,-2,5,3,-1,0,1,-1,1,1,1,2,1
KR_6701702195,420,4,19,0,7,2,3,1,-3,0,3,6,7,1,1,2,1,1,5,4,0,3,82,-1,4,3,1,0,0,1,1,0,1,6,1
KR_6657496158,420,-3,-5,-51,-4,-1,0,1,-2,1,3,0,2,2,1,1,0,-2,0,2,0,-10,-35,1,1,2,1,0,-1,-1,-1,-1,-1,1,1
KR_6736545833,420,0,-31,46,-2,0,1,1,-3,1,4,1,5,4,-1,2,3,1,2,1,0,4,18,0,8,8,6,0,-1,1,-1,-1,1,3,1
KR_6657987718,420,5,53,15,5,0,1,1,1,3,2,3,4,1,-1,3,4,2,2,0,-1,2,34,-4,4,0,-26,0,1,1,1,1,-1,5,1
KR_6768596601,440,-1,-9,-12,2,2,2,0,3,4,1,-1,0,1,0,1,1,-2,0,2,0,2,5,4,2,6,-2,0,0,1,-1,0,1,1,1
KR_6764099634,440,7,80,12,23,3,4,1,0,1,1,5,5,0,7,9,2,8,8,0,1,22,148,2,4,6,0,0,3,1,1,1,1,5,1
KR_6737532263,420,-1,24,-28,2,-2,2,4,-2,3,5,4,4,0,1,3,2,1,2,1,0,7,3,1,3,4,2,0,-1,-1,-1,-1,1,5,1
KR_6756676079,420,1,-4,-32,-3,-10,0,10,-1,4,5,1,1,0,4,4,0,3,3,0,0,11,-1,4,4,8,-1,0,-1,1,0,-1,-1,4,1
KR_6752363542,420,-2,-32,-20,-5,1,1,0,-6,1,7,0,1,1,1,3,2,-1,0,1,0,-1,-362,-1,5,4,-1,0,-1,-1,-1,-1,-1,4,1
KR_6699420752,420,2,15,25,7,0,1,1,-1,4,5,1,2,1,9,9,0,-2,2,4,0,2,-101,1,7,8,-1,0,0,1,1,1,1,4,1
KR_6764665592,420,7,116,-12,11,-1,0,1,-1,0,1,7,8,1,5,5,0,1,1,0,0,9,8,4,1,5,2,0,5,1,1,1,1,2,1
KR_6446761996,420,-1,-46,12,-2,4,6,2,-2,2,4,-1,2,3,-6,0,6,3,3,0,-2,-6,1,-2,4,2,1,0,0,1,1,1,-1,1,1
KR_6652511672,420,7,105,34,14,8,9,1,3,4,1,5,6,1,-2,1,3,0,1,1,0,2,-4,-1,5,4,-2,0,5,-1,1,1,1,3,1
KR_6758180875,440,1,-30,20,2,-1,2,3,-2,1,3,4,4,0,1,1,0,0,2,2,0,0,-3,-5,7,2,3,0,0,-1,1,0,1,5,1
KR_6749319608,440,5,49,8,14,5,6,1,1,3,2,2,4,2,4,5,1,2,4,2,0,13,38,2,3,5,-2,0,2,1,1,1,1,6,1
KR_6762844033,420,3,84,8,6,3,4,1,4,5,1,1,2,1,-3,1,4,1,2,1,0,-2,-2,-4,4,0,2,0,0,-1,1,1,-1,3,1
KR_6771262537,420,4,13,0,5,-2,2,4,3,6,3,4,5,1,0,1,1,0,0,0,0,4,4,-1,5,4,4,0,0,-1,-1,0,-1,1,1
KR_6768228866,420,4,23,24,9,1,1,0,6,8,2,3,5,2,-1,4,5,0,1,1,2,18,-7,2,2,4,2,0,0,1,-1,1,1,1,1
KR_6750716614,420,1,48,-24,6,3,4,1,0,4,4,2,3,1,3,4,1,-2,0,2,1,2,2,-1,5,4,0,0,1,1,-1,1,1,4,1
KR_6716063875,420,3,32,37,5,4,6,2,1,3,2,3,6,3,-2,0,2,-1,1,2,0,0,-3,6,1,7,-4,0,2,1,-1,1,1,1,1
KR_6629689974,420,5,66,22,8,1,4,3,1,3,2,3,4,1,2,3,1,1,2,1,0,8,-5,-3,9,6,-1,0,2,1,1,1,1,4,1
KR_6768746837,420,2,17,8,-3,-1,1,2,0,4,4,2,4,2,-2,5,7,-2,0,2,0,-5,-4,0,5,5,-5,0,0,0,-1,1,-1,0,1
KR_6398726881,420,3,14,6,-4,3,4,1,-6,1,7,-6,1,7,4,6,2,1,1,0,0,-7,16,7,2,9,-6,0,0,0,-1,0,-1,0,1
KR_6718844937,420,-2,15,8,2,1,3,2,4,5,1,-2,2,4,-3,3,6,2,4,2,0,1,14,3,3,6,0,0,0,-1,1,1,-1,4,1
KR_6768458418,420,-1,-3,-27,-1,1,1,0,-3,1,4,0,0,0,2,3,1,-1,0,1,0,-3,4,1,5,6,1,0,-1,-1,1,-1,-1,3,1
KR_6769133033,420,3,22,3,5,-1,2,3,-1,4,5,11,11,0,-3,4,7,-1,0,1,1,0,-1,-1,5,4,1,0,1,1,-1,1,1,4,1
KR_6728973701,420,-1,14,-24,-5,0,2,2,-4,5,9,-1,1,2,-1,4,5,1,1,0,0,-9,-25,-2,6,4,2,0,1,1,-1,1,1,6,1
KR_6552195444,420,0,30,1,9,4,5,1,1,4,3,1,4,3,3,4,1,0,0,0,1,14,2,0,8,8,4,0,0,1,1,0,1,2,1
KR_6751173452,420,-1,-35,-12,-1,1,1,0,2,3,1,-1,1,2,-2,2,4,-1,0,1,0,0,39,4,3,7,-6,0,0,1,-1,0,1,1,1
KR_6653704886,420,4,98,12,12,3,3,0,6,7,1,4,6,2,-1,1,2,0,0,0,1,19,-15,5,2,7,6,0,2,0,1,1,1,0,1
KR_6760714080,420,0,24,-30,-2,-1,1,2,0,4,4,-5,1,6,5,5,0,-1,1,2,-1,-1,30,1,10,11,-15,0,1,-1,1,1,-1,6,1
KR_6687202112,420,-2,-45,-28,-6,0,1,1,4,5,1,-4,0,4,-4,3,7,-2,3,5,-1,-14,15,1,5,6,-5,0,0,-1,1,0,1,4,1
KR_6717785731,440,-1,13,-33,6,-2,2,4,-1,3,4,2,2,0,5,5,0,2,2,0,0,11,24,0,4,4,0,0,3,1,1,1,1,3,1
KR_6769327031,420,4,-4,-16,9,0,1,1,7,8,1,4,5,1,-2,3,5,0,1,1,0,14,-3,0,7,7,0,0,1,-1,-1,1,1,5,1
KR_6748347288,420,1,-25,1,5,1,2,1,0,3,3,2,4,2,-1,2,3,3,3,0,0,5,-1,2,3,5,-3,0,-1,1,-1,-1,1,5,1
KR_6719137788,420,0,-18,-15,-2,-1,0,1,0,2,2,-1,2,3,4,5,1,-4,1,5,0,-1,3,1,5,6,-1,0,0,-1,-1,0,1,1,1
KR_6763113096,420,-1,17,-6,0,-1,0,1,-3,4,7,3,6,3,3,4,1,-2,0,2,2,4,-121,-3,5,2,1,0,0,-1,1,0,1,5,1
KR_6619428159,420,0,46,-24,-2,-3,0,3,-4,4,8,-4,2,6,9,11,2,0,3,3,0,-2,-9,0,5,5,-1,0,-1,-1,-1,-1,-1,1,1
KR_6759903925,420,2,19,10,11,5,7,2,2,5,3,2,4,2,-2,3,5,4,4,0,2,7,4,3,4,7,-1,0,1,-1,1,1,-1,2,1
KR_6756546129,420,-2,-48,-45,-3,3,3,0,0,4,4,-4,4,8,0,2,2,-2,0,2,0,-11,-1,-5,6,1,3,0,-3,0,-1,-1,-1,0,1
KR_6767021241,420,5,71,15,11,-1,1,2,3,3,0,8,10,2,2,6,4,-1,0,1,0,6,-38,-6,9,3,3,0,1,-1,-1,1,1,1,1
KR_6758957154,420,7,118,28,8,1,2,1,-5,4,9,6,6,0,4,6,2,2,3,1,3,13,11,2,4,6,3,0,0,-1,1,1,1,4,1
KR_6760524311,420,-1,53,-8,-5,0,0,0,-2,0,2,0,3,3,-2,0,2,-1,0,1,0,-9,-5,5,0,5,1,0,1,1,1,1,1,2,1
KR_6766869689,440,0,19,-1,0,6,6,0,0,1,1,-1,2,3,-3,2,5,-2,0,2,0,-3,-14,1,6,7,-2,0,0,-1,1,0,1,3,1
KR_6709572840,420,-1,27,14,4,2,5,3,1,3,2,1,1,0,0,1,1,0,1,1,0,-1,4,9,1,10,-7,0,0,1,-1,0,1,6,1
KR_6747882639,420,-1,-4,-19,-6,1,4,3,1,4,3,-2,2,4,5,10,5,-11,0,11,1,6,-203,6,5,11,-3,0,0,-1,-1,1,1,1,1
KR_6769402683,420,1,-16,31,4,-1,0,1,-2,1,3,9,9,0,-1,4,5,-1,2,3,-1,2,24,-1,4,3,-25,0,1,1,1,1,-1,5,1
KR_6662791658,420,2,56,-20,1,0,1,1,-3,2,5,1,2,1,2,3,1,1,2,1,0,2,-6,-2,5,3,1,0,2,1,1,1,1,2,1
KR_6741159415,420,-2,29,-28,-4,-2,2,4,2,3,1,1,4,3,-4,1,5,-1,0,1,0,-7,-170,1,7,8,-2,0,-1,1,-1,-1,1,1,1
KR_6654207990,440,2,38,4,2,-1,5,6,2,3,1,-1,0,1,0,1,1,2,3,1,0,4,8,0,7,7,-1,0,1,-1,-1,1,1,2,1
KR_6770671523,420,4,51,-28,5,-2,2,4,3,8,5,4,4,0,0,1,1,0,1,1,0,6,-217,1,7,8,-1,0,-2,-1,-1,-1,-1,5,1
KR_6731328993,420,-6,-22,-14,-7,-2,0,2,0,3,3,-6,0,6,0,1,1,1,1,0,0,1,-37,-3,8,5,1,0,-1,1,-1,-1,-1,4,1
KR_6752131096,420,-1,41,1,-8,2,4,2,-3,1,4,-4,1,5,-3,0,3,0,0,0,0,-18,2,-4,8,4,-2,0,-1,-1,-1,1,1,1,1
KR_6766179214,420,2,66,0,4,4,4,0,-5,1,6,3,3,0,1,3,2,1,1,0,0,1,-1,-3,7,4,3,0,1,1,1,1,-1,4,1
KR_6618950209,420,1,33,20,-1,1,5,4,0,2,2,-3,1,4,1,2,1,0,0,0,0,-8,5,1,3,4,-2,0,0,1,-1,1,-1,4,1
KR_6756685388,420,6,87,19,17,1,3,2,5,7,2,5,6,1,6,6,0,0,1,1,0,9,-4,-3,8,5,0,0,0,1,-1,1,1,2,1
KR_6718776082,420,3,47,20,10,1,2,1,3,4,1,4,6,2,1,1,0,1,2,1,0,13,2,4,3,7,-1,0,3,-1,1,1,1,4,1
KR_6771485155,420,-1,-76,4,-5,-1,0,1,0,6,6,-3,2,5,-1,1,2,0,1,1,0,-2,-6,0,3,3,4,0,0,1,1,-1,1,1,1
KR_6768062770,440,1,21,-32,1,1,2,1,-3,2,5,-1,4,5,1,1,0,3,3,0,0,5,-32,-3,7,4,-3,0,-1,-1,-1,-1,-1,3,1
KR_6693414412,420,-1,-9,-24,-1,-1,2,3,3,4,1,-1,2,3,0,3,3,-2,1,3,0,2,3,-3,5,2,1,0,0,-1,-1,0,-1,3,1
KR_6684004074,420,2,-37,-12,7,3,5,2,4,5,1,0,2,2,-1,0,1,1,1,0,1,8,-6,1,5,6,4,0,0,-1,-1,-1,1,2,1
KR_6700132547,440,2,49,-36,10,-1,1,2,1,3,2,0,2,2,5,7,2,5,5,0,1,10,-3,0,8,8,1,0,1,-1,1,1,1,4,1
KR_6768496758,420,3,13,11,0,1,2,1,4,6,2,-5,2,7,-1,2,3,1,1,0,-1,6,-9,0,6,6,-1,0,-2,0,-1,-1,-1,0,1
KR_6737694579,420,4,71,28,12,4,4,0,-4,2,6,8,9,1,4,6,2,0,1,1,1,17,-12,-3,9,6,3,0,1,-1,-1,1,1,4,1
KR_6739946295,420,-1,-76,3,-5,-1,0,1,1,4,3,-1,1,2,-2,0,2,-2,0,2,0,-7,-9,0,5,5,-6,0,0,-1,1,0,-1,4,1
KR_6758133890,440,1,-40,-3,2,-1,2,3,3,5,2,1,3,2,2,6,4,-3,0,3,-2,-3,-5,-2,5,3,2,0,1,-1,1,-1,1,3,1
KR_6707604745,420,1,-64,18,-3,-1,1,2,0,3,3,-2,1,3,-1,0,1,1,2,1,0,-10,8,6,4,10,1,0,0,1,1,0,-1,6,1
KR_6744822792,420,5,145,-12,16,7,8,1,-2,2,4,3,3,0,7,8,1,1,2,1,0,10,14,2,4,6,1,0,3,1,1,1,1,4,1
KR_6730335431,420,0,77,-8,3,-2,1,3,1,5,4,2,5,3,1,2,1,1,2,1,0,6,-131,-5,9,4,1,0,0,-1,-1,0,1,6,1
KR_6771822878,440,4,63,0,13,3,3,0,10,10,0,-5,2,7,6,6,0,-1,0,1,1,20,-19,1,5,6,1,0,1,1,-1,1,1,2,1
KR_6745301462,420,-1,-15,-12,1,1,1,0,2,5,3,2,5,3,-3,1,4,-1,0,1,0,-2,-16,1,6,7,0,0,1,-1,1,-1,1,4,1
KR_6766717729,440,3,-58,12,9,0,4,4,2,2,0,3,4,1,5,7,2,-1,0,1,0,12,8,6,1,7,3,0,2,1,1,1,1,3,1
KR_6738279598,420,-1,8,1,-3,-1,2,3,-3,1,4,2,4,2,-2,0,2,1,1,0,0,-4,2,2,3,5,-2,0,2,1,1,-1,1,6,1
KR_6741364991,420,-1,-9,-9,0,0,2,2,2,2,0,-3,4,7,2,3,1,-1,1,2,1,4,-86,2,7,9,-5,0,0,-1,1,0,1,4,1
KR_6738423141,420,3,26,10,5,-3,1,4,4,6,2,4,4,0,2,4,2,-2,0,2,0,2,-1,-1,2,1,-3,0,2,1,0,1,-1,6,1
KR_6769690993,420,1,35,7,-3,1,1,0,-3,1,4,2,4,2,-3,4,7,0,1,1,-4,-6,-29,-2,4,2,4,0,0,-1,-1,0,-1,4,1
KR_6736151087,420,1,42,26,7,2,4,2,-1,0,1,0,4,4,5,5,0,1,3,2,1,10,-20,-2,3,1,-1,0,2,1,1,1,1,4,1
KR_6681489736,420,-1,-4,-12,0,-1,2,3,-4,1,5,2,2,0,3,5,2,0,0,0,-2,-4,-3,0,6,6,3,0,-1,1,-1,-1,-1,1,1
KR_6757035285,440,1,-16,-24,4,2,2,0,1,2,1,0,3,3,2,4,2,-1,5,6,-1,3,-4,1,5,6,3,0,-2,-1,1,-1,-1,6,1
KR_6501183244,420,-1,-3,0,-3,1,2,1,-1,3,4,-2,1,3,-1,1,2,0,0,0,0,-4,-3,0,8,8,-1,0,0,-1,1,-1,1,6,1
KR_6769232457,420,0,-34,3,-3,0,0,0,0,3,3,2,3,1,-4,3,7,-1,1,2,0,-2,-5,5,2,7,-1,0,-1,1,1,-1,1,6,1
KR_6622146963,420,4,-2,33,4,-2,0,2,0,4,4,4,6,2,2,5,3,0,0,0,0,5,31,2,4,6,-3,0,-1,1,-1,-1,-1,6,1
KR_6652358410,420,1,47,5,5,1,4,3,-1,1,2,1,1,0,1,4,3,3,5,2,1,10,0,2,4,6,2,0,-1,1,-1,-1,1,6,1
KR_6726436620,420,2,48,8,6,-2,1,3,6,6,0,0,5,5,2,5,3,0,0,0,2,18,5,1,5,6,2,0,0,1,-1,0,1,3,1
KR_6725719607,420,5,63,3,10,4,5,1,1,3,2,-3,1,4,6,6,0,2,2,0,0,3,3,3,1,4,2,0,0,1,-1,1,1,4,1
KR_6485810530,420,2,-4,13,10,3,3,0,4,8,4,0,1,1,2,5,3,1,2,1,0,8,6,5,5,10,-2,0,1,-1,1,1,-1,2,1
KR_6740620753,420,-1,-57,-5,-5,-2,3,5,-5,1,6,3,6,3,-1,2,3,0,1,1,-2,-7,-19,-3,7,4,1,0,-1,1,-1,-1,-1,1,1
KR_6749860840,420,1,45,0,5,2,2,0,3,5,2,2,3,1,-1,1,2,-1,3,4,0,1,16,-1,7,6,-3,0,0,1,1,1,1,3,1
KR_6576218537,420,3,28,9,6,4,4,0,4,5,1,-1,2,3,0,6,6,-1,0,1,0,8,-17,-2,7,5,7,0,2,1,1,1,1,5,1
KR_6770467594,420,1,50,0,6,1,4,3,4,6,2,3,7,4,-2,0,2,0,3,3,0,-1,3,-1,4,3,-2,0,2,-1,1,1,1,6,1
KR_6731692484,440,1,-9,-5,6,3,4,1,4,4,0,1,4,3,1,4,3,-3,6,9,2,15,-10,-7,10,3,1,0,1,1,-1,1,1,6,1
KR_6735516325,420,-3,-63,-4,-4,-4,0,4,-3,4,7,-1,1,2,1,4,3,3,4,1,-1,1,-3,-5,7,2,1,0,-1,1,-1,-1,-1,1,1
KR_6755326754,420,2,65,-5,6,2,2,0,2,5,3,1,3,2,-1,3,4,2,2,0,0,-2,13,6,5,11,-1,0,1,-1,1,1,-1,3,1
KR_6728521150,420,1,57,0,-2,-3,3,6,3,4,1,2,4,2,-3,1,4,-1,0,1,0,-8,8,-3,7,4,-2,0,1,1,-1,1,-1,4,1
KR_6769681692,420,0,5,-13,0,0,1,1,0,2,2,-2,2,4,1,1,0,1,2,1,0,2,424,-2,5,3,0,0,-1,1,-1,-1,1,3,1
KR_6717243678,420,4,54,-22,8,2,4,2,5,6,1,3,5,2,2,3,1,-4,0,4,-1,8,-12,1,5,6,5,0,0,1,-1,1,-1,6,1
KR_6769938894,440,6,50,48,4,-1,2,3,0,3,3,0,1,1,4,4,0,1,1,0,-2,-1,-3,-5,9,4,2,0,0,1,1,1,-1,2,1
KR_6615367366,420,-3,18,-26,0,-2,1,3,-5,5,10,1,4,3,3,4,1,3,3,0,0,11,23,2,7,9,1,0,-2,-1,1,1,1,4,1
KR_6766687535,420,-1,0,-12,-1,-1,2,3,-1,6,7,3,5,2,-1,3,4,-1,0,1,2,8,-4,2,5,7,-2,0,-1,-1,1,-1,1,1,1
KR_6609828421,420,5,53,38,10,2,2,0,1,3,2,5,6,1,3,5,2,-1,2,3,-1,13,-11,2,4,6,3,0,0,-1,1,1,-1,4,1
KR_6770388222,420,0,-25,21,0,-2,0,2,0,4,4,1,4,3,0,3,3,1,1,0,-1,1,3,0,5,5,-1,0,0,1,0,0,-1,5,1
KR_6655676653,420,1,42,24,4,2,5,3,0,3,3,4,6,2,-1,1,2,-1,0,1,0,2,5,0,4,4,2,0,2,1,1,1,-1,2,1
KR_6637138815,420,1,47,-3,10,2,2,0,6,7,1,1,1,0,2,3,1,-1,0,1,0,14,4,0,6,6,2,0,2,-1,1,1,1,4,1
KR_6763022358,420,4,36,9,6,-1,0,1,-3,0,3,2,4,2,9,9,0,-1,1,2,0,0,76,-2,12,10,3,0,2,1,1,1,1,2,1
KR_6713216239,420,-1,-24,17,-2,-1,0,1,6,11,5,-5,2,7,-2,1,3,0,1,1,-2,-10,13,-2,6,4,-22,0,0,-1,-1,-1,-1,1,1
KR_6471799405,420,4,37,41,8,6,6,0,1,2,1,-2,0,2,3,4,1,0,0,0,0,11,17,3,5,8,1,0,1,1,1,1,1,4,1
KR_6762576605,420,4,70,38,11,0,1,1,6,8,2,-1,0,1,4,4,0,2,2,0,0,12,-12,1,3,4,5,0,2,0,1,1,1,0,1
KR_6597113202,420,0,19,-5,-1,2,2,0,-3,2,5,1,3,2,0,2,2,-1,0,1,0,1,-4,-4,6,2,4,0,1,1,1,1,-1,5,1
KR_6768658327,420,2,0,0,0,2,3,1,-1,4,5,-3,2,5,1,5,4,1,2,1,0,4,-1,-5,9,4,-1,0,1,-1,1,1,-1,6,1
KR_6686758049,420,3,102,-9,8,3,5,2,2,4,2,1,2,1,2,4,2,0,0,0,0,10,-9,-2,8,6,3,0,1,-1,1,1,-1,5,1
KR_6768880055,420,-1,91,12,5,2,3,1,0,7,7,0,1,1,3,5,2,0,1,1,0,5,7,1,4,5,-3,0,0,1,0,0,1,4,1
KR_6679970253,420,-1,31,-11,-4,0,1,1,3,4,1,-2,1,3,-3,2,5,-2,1,3,-1,-9,-19,4,4,8,11,0,0,-1,-1,0,-1,4,1
KR_6137484566,420,3,17,17,6,-1,1,2,-2,2,4,3,3,0,4,9,5,2,2,0,0,14,-36,-1,5,4,2,0,-1,1,-1,-1,1,3,1
KR_6723723168,420,-1,-2,9,-6,-3,1,4,-1,0,1,-1,2,3,-1,3,4,0,0,0,0,-4,1,2,4,6,-6,0,-1,1,1,-1,1,5,1
KR_6725690068,420,4,35,6,-1,-3,0,3,5,8,3,-4,5,9,1,3,2,0,0,0,0,9,-15,1,6,7,1,0,-1,-1,-1,-1,1,4,1
KR_6609407584,420,2,61,-4,2,-4,0,4,1,1,0,-2,1,3,5,5,0,2,2,0,0,8,2,0,6,6,1,0,0,1,-1,0,1,4,1
KR_6704760797,440,-1,-27,8,-2,3,3,0,-2,2,4,-1,2,3,-3,4,7,1,3,2,1,-3,159,0,3,3,2,0,0,-1,-1,1,1,3,1
KR_6636792862,420,1,-3,24,6,4,4,0,3,4,1,2,5,3,-2,2,4,-1,0,1,1,-2,259,-6,10,4,-7,0,1,1,1,1,1,3,1
KR_6724499889,420,4,35,20,2,2,5,3,-6,1,7,2,2,0,2,6,4,2,4,2,-2,0,-6,-8,12,4,10,0,1,1,1,1,-1,5,1
KR_6764985204,420,-3,-30,-3,-1,0,2,2,1,2,1,-1,1,2,-1,3,4,0,0,0,0,1,-2,8,1,9,-2,0,1,0,1,1,1,0,1
KR_6623314365,440,3,35,24,9,1,2,1,-1,4,5,4,5,1,2,4,2,3,4,1,0,9,6,2,2,4,2,0,0,1,1,1,-1,1,1
KR_6592444605,440,-2,17,4,-2,-1,3,4,-1,1,2,-2,8,10,-1,2,3,3,3,0,0,6,24,3,2,5,-2,0,1,-1,1,1,1,4,1
KR_6759492996,440,6,21,48,12,0,4,4,0,2,2,5,5,0,6,6,0,1,1,0,0,12,8,6,4,10,-4,0,2,-1,-1,-1,-1,3,1
KR_6691494000,420,5,60,9,5,0,2,2,3,7,4,2,3,1,-1,2,3,1,2,1,-2,-4,13,4,2,6,-3,0,-1,-1,1,-1,-1,6,1
KR_6673870127,420,-1,25,16,-1,-3,1,4,3,3,0,1,3,2,-2,3,5,0,2,2,2,-2,6,0,7,7,1,0,0,-1,-1,0,1,1,1
KR_6648246332,420,2,45,4,1,2,4,2,-5,0,5,1,3,2,3,5,2,0,1,1,0,0,-4,1,4,5,2,0,1,1,1,1,1,1,1
KR_6726002029,420,5,71,25,18,1,1,0,3,4,1,6,6,0,3,3,0,5,5,0,0,20,-21,1,5,6,3,0,1,1,0,1,-1,1,1
KR_6771590006,420,4,54,14,4,-3,2,5,1,2,1,0,5,5,6,7,1,0,1,1,0,-4,437,0,2,2,4,0,1,1,1,1,-1,5,1
KR_6662366042,420,5,-17,16,8,1,1,0,1,1,0,3,7,4,3,3,0,0,0,0,0,9,110,4,4,8,6,0,0,1,1,1,-1,4,1
KR_6742025308,420,-1,-26,12,-5,-4,1,5,1,6,5,-2,0,2,-2,0,2,2,3,1,0,2,-13,0,4,4,-2,0,-1,-1,-1,-1,-1,3,1
KR_6317739163,420,4,19,30,6,-1,0,1,7,10,3,1,1,0,0,2,2,-1,0,1,0,8,0,5,3,8,-4,0,2,1,1,1,-1,4,1
KR_6725019775,420,3,44,2,9,0,1,1,4,7,3,4,5,1,3,5,2,-2,0,2,-1,10,-2,-1,7,6,3,0,1,1,1,1,-1,3,1
KR_6769193393,420,2,23,-14,15,-1,2,3,5,6,1,4,5,1,4,7,3,3,3,0,1,16,3,5,4,9,-1,0,1,1,1,1,1,6,1
KR_6743617195,440,2,19,4,4,1,1,0,-1,3,4,-2,1,3,6,9,3,0,1,1,0,4,-2,-1,7,6,4,0,2,-1,-1,1,-1,4,1
KR_6728879290,420,4,43,4,10,2,3,1,-2,3,5,2,2,0,6,6,0,2,2,0,0,6,-4,2,3,5,-1,0,0,-1,-1,0,1,5,1
KR_6574599112,420,-1,-7,1,5,5,6,1,2,3,1,3,5,2,-6,4,10,1,2,1,-1,7,6,1,2,3,1,0,1,0,1,1,1,0,1
KR_6426466963,420,4,91,-13,4,2,3,1,-2,1,3,-1,1,2,5,5,0,0,0,0,0,15,-37,4,4,8,4,0,3,-1,1,1,1,4,1
KR_6742366028,420,0,34,-16,-4,5,5,0,-1,1,2,-4,2,6,-3,4,7,-1,1,2,1,-4,-15,-5,9,4,8,0,1,-1,1,1,1,5,1
KR_6771570106,420,4,-42,22,9,0,1,1,4,6,2,2,2,0,-1,2,3,4,5,1,-1,7,27,-3,6,3,2,0,-1,1,-1,-1,-1,2,1
KR_6715497144,420,-2,-55,6,-5,-2,0,2,-1,1,2,4,6,2,0,1,1,-6,2,8,0,-8,-16,-2,6,4,-1,0,1,-1,1,1,1,2,1
KR_6762136482,420,2,28,11,3,1,3,2,3,4,1,0,6,6,-3,1,4,2,2,0,1,5,0,2,7,9,0,0,1,1,1,1,1,4,1
KR_6654778850,420,-2,-34,13,-5,-3,0,3,-1,4,5,-1,0,1,0,0,0,0,0,0,0,-5,4,3,5,8,-8,0,0,1,1,0,1,4,1
KR_6709353539,420,3,28,4,5,-1,4,5,1,3,2,3,5,2,3,6,3,-1,0,1,1,2,6,2,3,5,-1,0,1,1,-1,1,1,3,1
KR_6633703613,420,-2,33,-15,0,0,3,3,0,1,1,-2,1,3,0,6,6,2,2,0,2,4,26,-2,4,2,2,0,-1,-1,-1,-1,1,3,1
KR_6662068164,420,1,-5,-20,3,-1,4,5,2,3,1,1,1,0,2,3,1,-1,0,1,0,3,14,3,2,5,2,0,1,-1,-1,-1,-1,5,1
KR_6771239892,420,-2,-10,-10,-3,2,4,2,0,3,3,1,5,4,-6,1,7,0,1,1,0,-13,1,-2,7,5,-3,0,0,-1,-1,0,1,2,1
KR_6743540981,420,0,28,8,6,-2,4,6,3,3,0,-3,1,4,2,5,3,6,6,0,1,10,-71,-8,11,3,12,0,1,1,-1,1,1,4,1
KR_6538208525,420,3,-3,12,2,3,4,1,-3,2,5,0,1,1,0,4,4,2,2,0,0,2,10,3,6,9,-4,0,2,-1,1,1,1,6,1
KR_6764183901,420,5,30,8,12,1,1,0,0,2,2,6,6,0,3,4,1,2,3,1,0,12,129,1,4,5,0,0,-1,-1,-1,-1,1,4,1
KR_6701944138,420,-1,2,-4,-2,-2,1,3,0,4,4,1,1,0,-1,3,4,0,1,1,0,-2,-30,-6,10,4,-1,0,0,-1,1,0,1,4,1
KR_6609767543,420,5,91,-6,6,0,0,0,0,1,1,3,4,1,3,7,4,0,0,0,0,10,117,4,5,9,2,0,1,1,1,1,-1,2,1
KR_6753016238,420,-2,2,-6,-4,2,2,0,-7,2,9,4,4,0,-3,2,5,0,1,1,-1,-12,-32,0,7,7,16,0,0,-1,1,0,-1,2,1
KR_6768452090,420,0,-9,17,6,2,5,3,-1,2,3,-1,3,4,5,8,3,1,3,2,0,6,-1,4,3,7,5,0,0,1,1,0,-1,3,1
KR_6769544267,440,-5,-65,-17,-6,1,1,0,-9,2,11,0,3,3,1,4,3,1,1,0,0,-5,-4,-2,6,4,1,0,0,-1,1,1,-1,2,1
KR_6764513265,420,-1,-90,4,-6,-4,1,5,2,3,1,-1,0,1,-1,3,4,-2,0,2,0,-2,1,3,4,7,1,0,0,-1,-1,0,1,3,1
KR_6759105455,440,3,47,-12,4,4,7,3,0,0,0,3,4,1,-2,2,4,-1,0,1,0,-6,-4,0,4,4,0,0,0,0,-1,-1,1,0,1
KR_6719999493,420,-1,-20,8,7,0,2,2,2,4,2,2,2,0,3,5,2,0,2,2,0,12,-12,-2,5,3,21,0,-2,1,-1,-1,1,1,1
KR_6662056394,440,5,57,28,11,2,3,1,6,11,5,3,4,1,1,1,0,-1,0,1,0,4,-1,4,2,6,1,0,0,1,1,0,1,1,1
KR_6752462096,420,-1,-47,-3,-3,-1,0,1,-3,0,3,-1,4,5,2,4,2,0,1,1,0,0,4,-3,6,3,-2,0,0,-1,1,0,-1,2,1
KR_6761378226,420,-4,-61,2,-5,-1,2,3,-2,2,4,0,5,5,-1,1,2,-1,1,2,-1,-4,4,-3,3,0,-4,0,0,1,0,-1,-1,3,1
KR_6759221455,420,5,-12,21,12,1,1,0,3,6,3,0,2,2,8,11,3,0,1,1,0,16,13,3,3,6,4,0,1,1,1,1,-1,5,1
KR_6735032439,420,-1,-12,42,-7,1,2,1,-1,3,4,-2,0,2,-4,2,6,-1,2,3,0,-11,18,0,4,4,-3,0,-1,1,1,-1,1,1,1
KR_6771668676,440,1,-7,8,9,4,6,2,3,3,0,0,1,1,3,4,1,-1,0,1,1,10,14,-4,5,1,0,0,1,1,1,1,1,6,1
KR_6762476033,440,5,110,-24,13,6,7,1,-1,2,3,2,2,0,6,6,0,0,0,0,0,14,9,5,0,5,-1,0,2,1,-1,1,1,5,1
KR_6768924903,420,0,-61,-16,7,-1,0,1,5,6,1,2,3,1,-1,2,3,2,3,1,0,5,-8,2,1,3,3,0,0,1,1,-1,1,3,1
KR_6352629619,420,-2,-18,-20,-2,-5,0,5,0,3,3,0,1,1,2,2,0,1,1,0,0,1,0,0,0,0,-3,0,1,1,1,1,1,3,1
KR_6765672164,420,3,-21,0,5,1,2,1,3,3,0,1,5,4,1,3,2,-1,0,1,0,9,-5,1,5,6,0,0,0,1,1,0,1,3,1
KR_6724829823,420,0,43,-8,-1,1,2,1,-1,1,2,-2,0,2,2,5,3,-1,1,2,0,3,93,3,4,7,2,0,0,-1,0,0,-1,5,1
KR_6764950832,420,-3,-95,-38,-4,2,2,0,-2,3,5,0,2,2,-5,1,6,1,1,0,0,-5,-28,-8,12,4,-4,0,-1,-1,1,-1,-1,4,1
KR_6594775735,420,-1,-25,-2,-3,-3,2,5,2,4,2,-3,2,5,1,4,3,0,2,2,-1,-3,-3,-5,6,1,2,0,0,-1,1,0,-1,3,1
KR_6767761883,420,9,144,52,19,4,5,1,6,7,1,3,6,3,2,5,3,4,6,2,0,8,6,-2,6,4,4,0,3,1,1,1,-1,6,1
KR_6765784832,420,4,-32,42,3,1,1,0,1,1,0,-2,0,2,1,2,1,2,2,0,0,1,-113,4,4,8,6,0,0,1,-1,0,-1,3,1
KR_6657407249,420,-2,25,-45,-7,1,2,1,-2,1,3,-1,0,1,-2,2,4,-3,0,3,0,-6,-23,-2,5,3,8,0,1,-1,1,1,-1,3,1
KR_6768133733,420,1,27,16,2,4,4,0,-3,4,7,0,3,3,3,6,3,-2,0,2,0,-7,6,-2,4,2,-2,0,0,-1,1,0,1,2,1
KR_6766542170,420,5,-20,28,12,2,2,0,6,9,3,3,4,1,1,2,1,0,1,1,0,8,56,-4,7,3,-1,0,1,1,-1,1,1,4,1
KR_6667627454,420,3,19,17,8,4,4,0,3,5,2,-1,1,2,0,3,3,2,3,1,0,7,-13,5,4,9,5,0,1,1,0,1,-1,2,1
KR_6758396439,420,-3,13,12,-3,-3,2,5,-3,2,5,0,1,1,1,1,0,2,2,0,0,-8,-1,-3,4,1,5,0,1,-1,1,1,-1,1,1
KR_6762518550,420,1,-24,9,1,2,3,1,2,4,2,-1,1,2,-1,1,2,-1,0,1,0,1,3,-1,8,7,-2,0,1,-1,1,1,1,5,1
KR_6732286455,420,1,69,-3,-4,-1,0,1,-4,1,5,-1,1,2,1,6,5,1,1,0,0,-9,-1,0,6,6,3,0,0,1,1,0,1,3,1
KR_6752994251,420,0,-25,4,3,2,3,1,2,2,0,0,3,3,-2,0,2,1,2,1,0,-2,-24,-2,4,2,3,0,0,1,1,0,1,6,1
KR_6767390069,420,3,15,22,0,-1,0,1,-2,3,5,0,3,3,2,6,4,1,2,1,-1,7,4,1,5,6,-1,0,0,-1,1,0,-1,3,1
KR_6694530130,420,-1,-4,12,6,-2,0,2,1,3,2,3,5,2,0,2,2,4,5,1,0,7,4,6,3,9,2,0,-1,1,-1,-1,-1,5,1
KR_6764348064,420,-2,-44,-26,0,-1,0,1,-2,2,4,-3,1,4,6,7,1,0,0,0,0,0,2,0,4,4,-5,0,0,-1,-1,-1,1,6,1
KR_6728831267,420,0,101,4,-6,1,2,1,2,4,2,-7,1,8,-2,1,3,0,1,1,0,-11,-1,1,3,4,-2,0,0,-1,-1,0,1,5,1
KR_6743152507,440,2,2,24,2,-1,0,1,0,4,4,-3,2,5,5,9,4,1,1,0,1,8,-2,-6,12,6,1,0,0,1,-1,1,1,1,1
KR_6743898569,440,2,-11,0,3,-2,1,3,2,2,0,0,0,0,1,3,2,2,2,0,0,4,4,3,3,6,-4,0,0,1,1,0,1,5,1
KR_6763324255,440,2,60,27,3,-3,2,5,-2,2,4,4,7,3,4,4,0,0,1,1,-1,2,-353,-3,5,2,1,0,1,1,0,1,-1,5,1
KR_6767900230,440,3,31,12,16,3,3,0,4,6,2,3,4,1,6,9,3,0,1,1,0,17,-2,6,3,9,0,0,0,1,0,1,1,1,1
KR_6570468881,420,-2,-7,-15,-5,-3,0,3,1,2,1,2,6,4,-3,4,7,-2,0,2,0,6,206,2,0,2,-3,0,0,-1,1,-1,-1,2,1
KR_6768911253,420,0,0,4,3,-1,2,3,1,4,3,1,3,2,2,2,0,0,3,3,-1,5,14,2,3,5,0,0,-2,1,-1,-1,-1,4,1
KR_6667161708,420,2,-16,28,-2,-1,1,2,3,4,1,1,3,2,-3,0,3,-2,1,3,0,3,-4,0,6,6,-1,0,0,1,1,0,-1,5,1
KR_6767501739,420,1,41,-19,0,0,1,1,-4,0,4,-5,0,5,7,8,1,2,2,0,0,5,3,2,8,10,0,0,1,-1,1,1,1,6,1
KR_6767453921,420,4,62,25,11,2,4,2,6,6,0,-3,1,4,5,5,0,1,1,0,0,11,28,3,6,9,1,0,0,1,1,0,1,5,1
KR_6768675952,420,1,38,-20,-1,0,1,1,1,3,2,-6,1,7,3,5,2,1,2,1,0,2,160,0,3,3,3,0,1,1,1,1,-1,6,1
KR_6746092338,420,2,6,-27,8,1,1,0,5,6,1,-1,0,1,4,4,0,-1,1,2,0,16,3,1,3,4,-4,0,0,-1,-1,0,1,2,1
KR_6743049204,440,0,77,16,-1,3,4,1,1,3,2,2,5,3,-6,2,8,-1,0,1,0,-6,9,3,1,4,-4,0,1,1,1,1,-1,1,1
KR_6690286154,420,-3,6,3,-10,2,2,0,-4,1,5,-4,3,7,-3,4,7,-1,2,3,0,-16,258,3,2,5,-3,0,-1,-1,1,-1,1,4,1
KR_6752092967,420,-1,-40,1,-3,-3,0,3,2,2,0,-1,3,4,0,2,2,-1,0,1,0,-2,18,1,3,4,-4,0,0,1,-1,0,1,3,1
KR_6570098916,420,2,102,0,-4,-2,0,2,-1,1,2,-2,1,3,3,6,3,-2,2,4,0,-1,-21,0,4,4,-3,0,0,1,1,1,1,3,1
KR_6496431684,420,4,85,18,3,0,2,2,-1,4,5,10,12,2,-1,2,3,-5,0,5,-2,-3,7,4,2,6,1,0,1,-1,-1,1,-1,1,1
KR_6740440057,420,0,1,28,-2,3,3,0,-2,2,4,3,8,5,-4,2,6,-2,3,5,3,2,5,3,6,9,-7,0,1,-1,1,1,1,4,1
KR_6768723310,420,1,-14,13,3,1,2,1,3,6,3,0,3,3,0,0,0,-1,0,1,0,1,4,2,5,7,0,0,0,1,1,0,1,2,1
KR_6741653393,440,1,30,0,-1,3,5,2,-1,2,3,0,2,2,2,2,0,-5,2,7,0,-9,25,1,6,7,4,0,0,-1,-1,1,1,2,1
KR_6695040282,420,1,-28,-40,3,1,2,1,2,3,1,3,9,6,-2,2,4,-1,0,1,0,11,-5,-6,9,3,6,0,-1,-1,-1,-1,-1,3,1
KR_6675951802,420,0,37,14,1,0,1,1,0,4,4,2,3,1,0,2,2,-1,0,1,0,-5,225,3,3,6,-2,0,1,-1,1,1,-1,5,1
KR_6750647919,420,0,-30,-28,1,-3,3,6,-1,3,4,3,3,0,3,4,1,-1,0,1,2,6,7,4,4,8,2,0,0,1,-1,0,1,3,1
KR_6695667232,420,4,12,16,5,0,1,1,2,5,3,1,3,2,4,5,1,-2,1,3,0,-4,2,4,5,9,2,0,-1,1,-1,-1,1,3,1
KR_6763217338,440,5,109,4,14,2,3,1,3,4,1,2,2,0,6,6,0,1,1,0,0,14,5,3,2,5,1,0,2,1,1,1,1,2,1
KR_6761065447,440,1,62,-33,1,6,9,3,3,3,0,1,4,3,-5,3,8,-4,1,5,1,-6,412,2,0,2,1,0,2,-1,1,1,-1,5,1
KR_6769956096,440,2,35,4,2,0,2,2,3,4,1,1,1,0,-3,3,6,1,5,4,0,6,-6,-1,7,6,3,0,0,-1,-1,0,-1,2,1
KR_6716829530,420,1,-8,0,1,1,4,3,-1,1,2,3,4,1,1,3,2,-3,0,3,-1,-1,3,-1,4,3,-2,0,0,-1,-1,-1,-1,3,1
KR_6746016466,420,4,53,9,4,1,3,2,5,6,1,-2,2,4,0,4,4,0,1,1,1,14,18,-1,2,1,-2,0,1,1,1,1,1,2,1
KR_6757822155,420,0,-24,-17,0,1,2,1,-3,0,3,2,6,4,0,4,4,0,0,0,-1,-9,-25,-5,8,3,0,0,0,1,-1,0,-1,3,1
KR_6747847455,420,3,11,0,12,3,3,0,7,8,1,0,1,1,2,3,1,0,0,0,0,14,266,-1,3,2,1,0,-1,1,1,-1,1,5,1
KR_6765671158,420,3,-3,5,0,3,4,1,1,2,1,0,2,2,-3,2,5,-1,0,1,-1,-1,-2,2,3,5,0,0,2,-1,1,1,-1,1,1
KR_6753674390,420,3,24,30,7,-1,3,4,2,2,0,3,3,0,1,3,2,2,4,2,0,1,8,3,5,8,0,0,1,1,1,1,1,5,1
KR_6705480512,440,3,26,11,2,0,2,2,4,5,1,-1,1,2,2,4,2,-3,2,5,0,-2,5,6,4,10,-2,0,1,1,-1,1,1,3,1
KR_6740730233,420,3,32,20,12,8,9,1,2,5,3,3,6,3,0,1,1,-1,0,1,1,0,-40,-1,5,4,13,0,2,1,1,1,1,6,1
KR_6079031814,420,2,46,13,12,2,3,1,-4,0,4,7,7,0,2,2,0,5,6,1,1,17,-19,0,5,5,11,0,-1,1,-1,1,1,5,1
KR_6728331212,440,4,16,31,12,0,3,3,4,5,1,4,6,2,6,6,0,-2,0,2,0,15,-99,2,5,7,-1,0,2,0,1,1,1,0,1
KR_6751436953,420,1,-22,-7,15,3,3,0,1,5,4,5,6,1,4,4,0,2,2,0,0,13,9,6,1,7,-1,0,1,1,1,1,1,6,1
KR_6731810523,440,2,-3,-8,6,-2,1,3,1,5,4,0,3,3,5,7,2,2,3,1,0,9,34,-1,7,6,-5,0,0,-1,-1,-1,1,1,1
KR_6757448385,420,0,-21,44,-3,2,2,0,-2,1,3,-3,1,4,2,3,1,-2,0,2,0,-11,-9,-3,3,0,-1,0,0,-1,1,1,1,5,1
KR_6667371005,440,7,54,33,11,2,5,3,1,4,3,5,5,0,2,4,2,1,2,1,0,-2,9,0,4,4,2,0,1,-1,1,1,1,4,1
KR_6643401167,420,-1,-21,33,3,-3,1,4,0,3,3,0,2,2,5,7,2,1,1,0,0,2,3,1,8,9,-4,0,2,1,1,1,-1,6,1
KR_6757674906,420,2,33,3,4,1,2,1,2,4,2,2,4,2,0,4,4,-1,1,2,2,10,-16,0,7,7,8,0,1,1,1,1,1,6,1
KR_6770322796,420,-3,-24,-55,-4,4,5,1,-3,0,3,-2,2,4,0,4,4,-3,1,4,-1,-6,7,6,5,11,-7,0,-2,-1,-1,-1,-1,5,1
KR_6702016077,420,6,77,29,6,-1,2,3,4,7,3,2,2,0,0,1,1,1,2,1,0,8,-9,-1,7,6,1,0,3,1,1,1,-1,2,1
KR_6761108685,420,-4,-36,1,-3,-1,1,2,-4,3,7,0,1,1,2,2,0,0,0,0,0,-1,6,-4,10,6,-4,0,0,0,1,0,-1,0,1
KR_6621607233,420,0,25,42,9,2,5,3,1,5,4,0,3,3,7,8,1,-1,1,2,0,6,2,-1,5,4,0,0,2,1,1,1,-1,3,1
KR_6700871803,420,0,3,4,-5,1,2,1,0,1,1,0,0,0,-4,0,4,-2,0,2,0,-3,26,0,6,6,-3,0,0,0,0,0,1,0,1
KR_6745486478,440,0,-1,0,-1,-2,2,4,-1,4,5,1,2,1,-1,2,3,2,2,0,0,-8,-1,-3,3,0,0,0,0,-1,1,0,-1,4,1
KR_6751027660,420,6,20,44,16,8,9,1,4,5,1,-1,3,4,1,1,0,4,5,1,0,5,-8,0,2,2,-1,0,2,1,0,1,1,1,1
KR_6722610996,420,-1,-45,-10,-7,-2,0,2,-1,0,1,-6,0,6,3,5,2,-1,1,2,0,-8,-11,-3,6,3,2,0,-2,-1,-1,-1,-1,3,1
KR_6770755201,420,0,11,-12,4,2,2,0,0,5,5,3,6,3,-2,2,4,1,2,1,0,2,16,1,5,6,-6,0,0,0,0,0,-1,0,1
KR_6693882905,420,-3,-64,-9,-4,-4,1,5,3,4,1,-5,0,5,-5,0,5,7,7,0,0,4,3,-2,4,2,12,0,-1,1,0,-1,-1,6,1
KR_6472421691,420,1,-3,4,1,-2,0,2,-1,1,2,-3,0,3,5,7,2,2,2,0,0,12,47,-6,9,3,-1,0,0,1,-1,1,1,6,1
KR_6751471590,420,2,-6,-16,14,-3,1,4,10,10,0,-4,0,4,10,10,0,1,2,1,0,14,7,-2,7,5,5,0,3,1,1,1,1,3,1
KR_6737015760,440,0,36,-8,-5,-1,1,2,-3,0,3,-2,1,3,3,4,1,-2,2,4,0,-3,3,0,6,6,-6,0,-1,1,-1,-1,1,6,1
KR_6642574630,420,1,-21,32,0,4,4,0,0,2,2,3,4,1,-7,1,8,0,0,0,0,1,4,3,2,5,-4,0,1,1,1,1,1,4,1
KR_6770446782,420,2,44,-17,-3,2,4,2,-1,1,2,-2,0,2,-3,0,3,1,1,0,-1,-5,9,2,4,6,-1,0,1,1,1,-1,-1,2,1
KR_6694995599,420,-1,21,2,-6,-3,0,3,-3,2,5,2,2,0,1,3,2,-3,0,3,0,-9,8,0,7,7,3,0,-1,1,-1,-1,-1,6,1
KR_6735775102,420,6,58,0,14,1,2,1,2,2,0,4,6,2,4,5,1,3,3,0,0,12,-5,-2,4,2,2,0,0,1,1,-1,1,4,1
KR_6702031675,420,-2,-6,16,0,-1,0,1,2,4,2,-3,1,4,0,1,1,2,2,0,0,2,1,-4,6,2,0,0,0,1,-1,0,1,2,1
KR_6709965092,420,0,-24,0,0,-2,3,5,0,1,1,3,8,5,-2,2,4,1,1,0,-1,2,5,-1,6,5,3,0,0,-1,1,0,-1,2,1
KR_6531571691,420,-1,39,24,2,0,1,1,0,5,5,-4,2,6,5,10,5,1,1,0,-1,-10,17,4,2,6,0,0,1,1,1,1,-1,3,1
KR_6687818626,440,0,2,20,-7,-2,0,2,-1,1,2,-1,2,3,-2,1,3,-1,2,3,0,0,4,-1,4,3,3,0,-1,0,0,-1,-1,0,1
KR_6739546430,420,3,2,23,10,4,4,0,0,1,1,1,3,2,5,9,4,0,2,2,1,20,31,-2,3,1,-4,0,1,1,1,1,1,2,1
KR_6619737860,420,4,4,20,6,-1,1,2,4,5,1,2,2,0,0,3,3,1,2,1,0,4,-8,-2,6,4,1,0,0,1,1,0,1,2,1
KR_6769875232,420,4,93,-1,12,5,6,1,2,3,1,0,1,1,3,6,3,2,2,0,0,5,-30,2,4,6,28,0,1,1,1,1,1,5,1
KR_6739496248,420,3,34,36,4,-2,1,3,3,4,1,2,4,2,2,4,2,-1,1,2,0,18,19,1,7,8,-3,0,1,1,-1,1,-1,3,1
KR_6764042691,420,1,29,-12,0,1,1,0,3,4,1,4,4,0,-2,3,5,-6,0,6,0,-5,2,3,3,6,-3,0,0,1,1,0,-1,4,1
KR_6770021507,420,1,13,9,2,-1,2,3,2,3,1,0,1,1,-1,1,2,2,2,0,0,3,-6,0,5,5,-2,0,0,1,1,1,1,3,1
KR_6770912573,420,1,54,-36,7,-1,1,2,1,3,2,7,8,1,2,5,3,-2,2,4,0,7,2,1,6,7,-3,0,0,1,0,1,-1,4,1
KR_6681794675,420,1,-76,40,8,-1,0,1,3,3,0,2,4,2,4,6,2,0,1,1,0,20,172,6,1,7,-1,0,1,1,1,1,1,5,1
KR_6770269140,420,3,23,47,2,-1,0,1,-2,0,2,2,3,1,1,5,4,2,2,0,1,3,-27,4,3,7,-11,0,1,1,1,1,1,3,1
KR_6351468335,420,1,62,-4,4,3,4,1,3,6,3,0,0,0,-1,1,2,-1,3,4,0,0,-12,2,5,7,3,0,1,1,-1,1,1,5,1
KR_6597045739,420,10,136,36,13,11,11,0,1,3,2,0,4,4,1,4,3,0,0,0,0,7,170,-2,4,2,-1,0,4,1,1,1,1,5,1
KR_6696028975,420,1,-14,17,-4,-2,1,3,-2,5,7,2,4,2,-2,0,2,0,0,0,0,-9,-3,0,5,5,1,0,0,1,1,0,-1,6,1
KR_6742301284,420,5,73,47,8,4,5,1,0,3,3,-1,1,2,6,7,1,-1,0,1,0,7,-1,-1,4,3,-3,0,1,1,-1,1,-1,6,1
KR_6762915117,420,0,86,-36,3,-1,0,1,1,3,2,-1,1,2,5,6,1,-1,0,1,1,2,-1,2,5,7,4,0,0,-1,-1,0,1,5,1
KR_6702014586,420,3,33,11,6,0,1,1,4,4,0,1,3,2,3,6,3,-2,0,2,-1,6,0,1,6,7,7,0,0,1,1,0,-1,5,1
KR_6732835883,420,1,17,16,5,2,3,1,-1,2,3,0,2,2,1,2,1,3,3,0,0,2,7,1,3,4,1,0,-1,1,0,-1,1,3,1
KR_6676854434,420,1,36,28,9,-5,0,5,0,2,2,0,7,7,3,4,1,11,11,0,0,21,5,-2,6,4,1,0,1,1,-1,1,1,2,1
KR_6762052501,420,-2,8,6,-2,-2,1,3,-1,2,3,-1,4,5,1,1,0,1,1,0,0,6,9,6,3,9,0,0,0,1,0,0,1,3,1
KR_6768921207,420,-1,18,-35,-7,6,6,0,-3,2,5,-4,0,4,-5,1,6,-1,0,1,-1,-4,-2,0,4,4,0,0,0,-1,-1,1,-1,6,1
KR_6771674944,420,3,84,23,4,2,3,1,0,2,2,4,4,0,-2,0,2,0,1,1,0,4,-6,-1,6,5,2,0,0,1,1,0,1,4,1
KR_6515074274,420,6,0,21,11,0,1,1,5,9,4,4,6,2,0,2,2,2,3,1,0,15,19,1,5,6,-6,0,0,1,0,0,1,1,1
KR_6728262952,420,0,-1,-35,1,2,4,2,-1,0,1,4,7,3,-3,0,3,-1,0,1,0,3,0,-1,6,5,1,0,0,1,-1,-1,1,5,1
KR_6591584081,420,6,88,23,11,4,6,2,-2,0,2,3,3,0,4,6,2,2,2,0,0,8,5,-1,5,4,2,0,1,1,0,1,-1,1,1
KR_6674792838,420,1,81,-27,3,2,2,0,2,3,1,-4,0,4,2,2,0,1,1,0,1,3,0,1,5,6,-1,0,0,-1,-1,0,1,5,1
KR_6758689966,420,0,-53,-3,3,1,2,1,2,6,4,-3,2,5,5,5,0,-2,1,3,0,3,-3,0,4,4,-3,0,1,1,-1,1,1,4,1
KR_6576062859,420,3,92,-3,5,2,2,0,-1,3,4,3,7,4,2,7,5,-1,1,2,1,2,50,-2,6,4,25,0,1,1,-1,1,1,5,1
KR_6764746325,420,0,19,-12,1,-1,2,3,-2,2,4,0,4,4,3,3,0,1,1,0,0,-1,-118,1,6,7,1,0,0,1,-1,-1,-1,4,1
KR_6471859832,420,3,108,11,2,5,6,1,2,5,3,-1,1,2,2,2,0,-6,0,6,1,3,22,0,8,8,7,0,1,1,1,1,1,1,1
KR_6679698753,420,-2,43,-32,2,-2,0,2,-1,1,2,3,3,0,0,0,0,2,2,0,0,1,5,0,5,5,0,0,0,1,-1,0,-1,1,1
KR_6652421225,420,2,51,32,1,0,1,1,-2,1,3,-4,0,4,6,6,0,1,1,0,1,5,30,0,4,4,0,0,-1,1,-1,-1,1,1,1
KR_6640017461,420,1,49,6,0,-3,0,3,5,6,1,-3,3,6,1,3,2,0,0,0,-1,10,33,-6,8,2,0,0,0,-1,-1,1,-1,2,1
KR_6771285040,420,0,24,9,2,-1,1,2,-3,1,4,2,3,1,4,6,2,0,1,1,-2,9,20,1,3,4,-2,0,-1,-1,-1,-1,-1,2,1
KR_6763926016,420,0,13,9,-4,2,2,0,-6,1,7,2,3,1,4,7,3,-6,1,7,-1,-12,8,0,1,1,-1,0,1,-1,-1,1,-1,6,1
KR_6753045226,420,1,6,13,2,-1,2,3,2,6,4,-1,1,2,1,2,1,1,1,0,0,-2,3,3,5,8,-1,0,0,1,1,1,-1,1,1
KR_5549113315,420,1,-32,-5,3,-5,3,8,-2,2,4,8,8,0,2,2,0,0,0,0,0,10,-8,5,4,9,0,0,0,1,-1,-1,1,3,1
KR_6754272390,420,-1,-53,-5,-1,0,1,1,0,2,2,0,3,3,-2,2,4,1,2,1,0,-3,43,-1,6,5,27,0,1,1,1,1,-1,1,1
KR_6747833240,420,0,17,8,-2,-3,2,5,0,1,1,1,4,3,1,5,4,-1,0,1,-2,2,-6,0,4,4,7,0,1,-1,-1,1,-1,3,1
KR_6609493360,420,0,-32,24,4,0,1,1,2,3,1,-1,1,2,2,2,0,1,1,0,0,10,3,0,5,5,-2,0,0,1,-1,-1,1,3,1
KR_6550661336,420,0,-5,18,2,1,1,0,-4,2,6,1,2,1,4,6,2,0,0,0,0,-1,-3,1,6,7,5,0,0,1,1,1,1,2,1
KR_6735091412,420,-2,-28,-16,-1,-2,1,3,4,5,1,-2,1,3,1,3,2,-2,1,3,0,0,24,-7,9,2,1,0,1,1,-1,1,-1,3,1
KR_6741228776,420,5,31,31,9,2,3,1,0,4,4,4,5,1,-1,0,1,4,6,2,0,-1,2,-4,8,4,1,0,1,-1,1,1,-1,1,1
KR_6676097852,420,4,17,25,7,2,3,1,7,8,1,0,1,1,0,5,5,-2,0,2,0,7,59,4,5,9,1,0,1,1,1,1,1,2,1
KR_6747087688,420,1,-15,12,1,-1,2,3,0,3,3,2,5,3,1,3,2,-1,1,2,0,0,5,5,0,5,1,0,0,1,0,0,-1,5,1
KR_6768225169,420,2,37,-3,6,8,9,1,-7,0,7,3,4,1,2,3,1,0,1,1,0,-3,15,1,4,5,-6,0,1,-1,1,1,-1,2,1
KR_6716742082,420,0,-57,-16,4,2,2,0,4,7,3,4,5,1,-4,6,10,-2,1,3,3,12,2,4,2,6,-7,0,0,-1,1,1,1,3,1
KR_6769365445,420,1,4,28,-1,-2,2,4,1,3,2,-1,1,2,0,4,4,1,1,0,0,-5,-14,1,7,8,0,0,2,1,1,1,1,1,1
KR_6768589422,420,0,-25,19,5,1,4,3,0,1,1,4,5,1,0,3,3,0,1,1,0,1,1,-1,5,4,1,0,0,1,1,0,1,4,1
KR_6732943170,420,3,82,24,7,2,2,0,2,2,0,7,7,0,-3,2,5,-1,0,1,0,2,-16,1,3,4,5,0,1,1,1,1,1,3,1
KR_6751750167,420,-2,-46,-49,-4,-4,2,6,4,5,1,5,6,1,-6,2,8,-3,1,4,0,2,-17,1,3,4,-2,0,-2,-1,-1,-1,1,2,1
KR_6679909686,420,2,50,0,12,7,7,0,0,3,3,0,2,2,4,6,2,1,1,0,0,5,8,2,3,5,-4,0,1,-1,1,1,1,3,1
KR_6766167864,440,6,63,40,10,0,1,1,4,5,1,2,4,2,3,5,2,1,2,1,0,9,-2,3,4,7,2,0,2,0,0,1,1,0,1
KR_6770641112,420,3,53,-10,9,2,2,0,4,5,1,0,6,6,1,4,3,2,3,1,0,17,-157,2,4,6,-20,0,1,-1,-1,1,-1,5,1
KR_6771479280,420,3,72,-6,-1,1,2,1,2,3,1,-1,3,4,-4,1,5,1,1,0,0,-10,-5,-2,4,2,5,0,0,1,-1,1,1,3,1
KR_6653319341,420,7,144,51,13,5,5,0,1,5,4,9,11,2,0,1,1,-2,1,3,1,10,5,2,1,3,-1,0,2,1,-1,1,1,5,1
KR_6760600962,420,-1,8,-25,-1,0,1,1,-2,1,3,-1,3,4,2,4,2,0,0,0,0,-2,4,7,6,13,5,0,-1,-1,-1,-1,-1,6,1
KR_6714483944,420,-3,-26,4,-6,-2,0,2,-2,1,3,1,3,2,-4,2,6,1,3,2,-1,-8,-2,-1,4,3,3,0,0,-1,1,0,-1,1,1
KR_6744593771,420,1,151,-11,-1,4,5,1,-5,2,7,1,6,5,-2,1,3,1,1,0,0,-10,-11,0,5,5,1,0,2,1,1,1,-1,5,1
KR_6686920409,420,1,8,16,-2,2,2,0,2,3,1,0,1,1,-6,2,8,0,0,0,0,-7,5,3,4,7,2,0,-1,1,1,-1,-1,4,1
KR_6573821897,420,2,13,4,9,-2,0,2,2,3,1,8,9,1,1,5,4,0,0,0,0,13,37,-3,8,5,-19,0,2,-1,1,1,-1,2,1
KR_6767231324,440,-1,-35,-24,0,0,2,2,-4,3,7,-2,1,3,2,4,2,4,4,0,-2,-2,-19,-1,3,2,-2,0,0,1,-1,0,-1,3,1
KR_6767269011,420,1,-9,7,1,0,4,4,2,4,2,-1,4,5,1,3,2,-1,1,2,2,2,41,4,2,6,-13,0,1,1,1,-1,1,4,1
KR_6753450877,420,4,76,4,17,5,5,0,-3,2,5,11,13,2,0,2,2,4,5,1,0,13,0,0,7,7,0,0,1,1,-1,-1,1,6,1
KR_6771553108,420,-1,23,11,-5,-1,2,3,0,3,3,-5,0,5,2,5,3,-1,1,2,0,-15,2,-1,5,4,-2,0,2,1,0,1,1,6,1
KR_6696302726,420,3,9,0,9,2,2,0,3,5,2,3,4,1,1,2,1,0,0,0,0,6,-3,-1,4,3,4,0,1,1,1,1,1,4,1
KR_6704656944,420,2,47,-16,1,-2,1,3,1,5,4,1,1,0,0,3,3,1,3,2,0,1,0,3,3,6,4,0,1,1,-1,1,-1,5,1
KR_6768498901,420,3,22,8,2,3,4,1,-1,2,3,3,5,2,-3,1,4,0,1,1,0,0,-1,0,5,5,1,0,2,1,1,1,1,1,1
KR_6769420004,420,0,34,11,4,3,4,1,1,4,3,-4,1,5,3,4,1,1,1,0,3,7,3,-2,5,3,5,0,1,1,-1,1,1,1,1
KR_6769246656,420,2,24,-12,11,1,1,0,2,3,1,1,6,5,9,9,0,-2,0,2,0,8,-1,0,5,5,3,0,1,1,1,1,1,4,1
KR_6736384692,440,-1,-87,28,-5,-7,0,7,-1,0,1,1,1,0,2,3,1,0,0,0,-1,-1,6,-1,3,2,-2,0,0,-1,1,0,-1,5,1
KR_6734234689,420,2,34,20,1,1,5,4,-4,0,4,2,3,1,3,6,3,-1,0,1,-2,-3,-6,1,3,4,6,0,0,1,-1,-1,-1,4,1
KR_6749207735,420,-3,-6,-12,-11,1,1,0,-1,0,1,-4,3,7,-1,2,3,-6,0,6,0,-13,2,-2,5,3,-4,0,1,-1,1,1,1,3,1
KR_6746380586,420,3,75,-3,5,4,6,2,8,9,1,-2,7,9,-1,2,3,-4,0,4,-1,-3,-7,2,5,7,0,0,1,1,1,1,-1,1,1
KR_6690925422,420,0,80,-13,-6,-2,1,3,-3,2,5,-1,1,2,-1,8,9,1,1,0,0,-10,25,-8,9,1,-9,0,0,1,-1,0,-1,2,1
KR_6768004830,420,-2,-67,-18,-3,-1,3,4,2,3,1,0,2,2,0,2,2,-4,0,4,0,4,-24,2,7,9,-5,0,0,0,0,-1,1,0,1
KR_6766022573,420,-2,-64,2,-2,1,3,2,-2,2,4,-3,0,3,2,2,0,0,1,1,0,-5,-7,-4,5,1,2,0,0,1,-1,0,-1,3,1
KR_6760364334,420,1,4,-6,7,6,6,0,0,1,1,1,3,2,0,4,4,0,1,1,0,4,7,4,1,5,1,0,-1,0,1,-1,1,0,1
KR_6616638191,420,3,26,9,2,2,3,1,2,2,0,1,3,2,-3,3,6,0,1,1,1,-2,0,-2,7,5,-1,0,1,1,-1,1,1,4,1
KR_6693230923,420,3,93,24,10,7,8,1,-1,4,5,3,3,0,2,4,2,-1,1,2,0,2,-4,3,2,5,0,0,4,1,1,1,1,2,1
KR_6664581915,440,0,15,23,-1,1,2,1,-3,1,4,1,2,1,-1,0,1,1,2,1,0,-5,-6,5,0,5,-1,0,0,1,1,0,-1,5,1
KR_6755297225,440,2,59,-3,0,0,1,1,2,2,0,-4,0,4,1,2,1,1,2,1,0,2,129,3,4,7,-10,0,-1,-1,-1,-1,-1,1,1
KR_6742591304,420,-1,49,-16,8,3,4,1,-2,0,2,2,5,3,5,7,2,0,1,1,1,3,22,4,2,6,1,0,2,1,1,1,1,4,1
KR_6688607341,420,0,-5,-9,11,2,3,1,5,7,2,-2,2,4,5,6,1,1,2,1,3,17,-4,-4,9,5,1,0,0,1,1,1,1,4,1
KR_6635328820,420,2,20,-7,0,1,2,1,1,3,2,-2,2,4,0,1,1,0,0,0,0,5,19,-2,10,8,0,0,1,-1,1,1,-1,1,1
KR_6764764234,420,2,40,13,-5,-4,1,5,-4,4,8,4,4,0,-3,1,4,2,2,0,-2,-7,-6,-6,12,6,1,0,1,1,-1,1,-1,1,1
KR_6387243684,420,-1,-49,19,2,-3,1,4,1,3,2,2,5,3,3,4,1,-1,2,3,-1,-4,-34,1,7,8,24,0,-1,1,-1,-1,-1,4,1
KR_6767338793,420,4,32,15,3,-1,4,5,3,3,0,-3,0,3,2,4,2,2,3,1,0,2,-5,-3,8,5,3,0,0,1,1,1,1,1,1
KR_6737186401,440,0,-23,1,5,0,1,1,0,1,1,-1,0,1,8,8,0,-2,0,2,1,8,216,-2,7,5,-14,0,1,1,1,1,1,4,1
KR_6555421091,440,0,-48,16,-1,2,4,2,-4,0,4,0,2,2,1,3,2,0,2,2,0,-6,-4,-3,4,1,2,0,-1,1,1,1,-1,4,1
KR_6760378250,420,1,-14,-8,-1,-1,1,2,-2,2,4,-2,2,4,3,6,3,1,1,0,1,4,7,-7,9,2,4,0,1,-1,-1,1,1,3,1
KR_6746007402,420,-4,-76,0,-5,-1,2,3,2,6,4,-5,0,5,-2,1,3,1,3,2,1,0,-2,-5,9,4,-2,0,1,0,-1,1,1,0,1
KR_6614871001,420,3,-7,5,4,0,2,2,5,5,0,0,3,3,-1,1,2,0,1,1,0,4,-3,-1,7,6,2,0,0,1,1,0,-1,3,1
KR_6771020290,420,-2,-17,-18,-1,0,2,2,-2,3,5,0,3,3,-2,2,4,3,4,1,0,-5,22,-4,6,2,2,0,2,-1,1,1,1,1,1
KR_6315922999,420,-1,-58,-11,-1,2,3,1,-2,5,7,-2,1,3,1,2,1,0,0,0,2,6,-8,-4,9,5,1,0,-1,-1,-1,-1,1,2,1
KR_6770256703,440,3,45,32,4,1,2,1,-8,1,9,-2,2,4,12,12,0,1,2,1,-1,1,-4,1,4,5,3,0,2,-1,-1,1,-1,3,1
KR_6769154511,420,3,-6,4,20,6,6,0,2,5,3,3,5,2,6,7,1,3,4,1,0,23,-8,5,5,10,7,0,1,1,1,1,1,6,1
KR_6769113669,420,0,23,21,-2,-1,1,2,-2,1,3,0,4,4,1,4,3,0,0,0,-1,1,7,5,1,6,-2,0,0,1,1,1,-1,2,1
KR_6697945092,420,5,20,12,10,4,4,0,2,5,3,-1,2,3,1,5,4,4,4,0,3,15,34,2,3,5,-1,0,3,1,1,1,1,2,1
KR_6768796953,420,0,24,12,1,-2,3,5,1,2,1,-2,2,4,3,4,1,1,1,0,0,11,3,-2,5,3,2,0,1,-1,1,1,1,5,1
KR_6762919544,420,4,14,4,5,3,3,0,-1,3,4,-2,1,3,2,3,1,3,3,0,0,7,14,3,4,7,0,0,0,1,-1,-1,-1,5,1
KR_6634584846,440,-1,-27,30,-4,-3,1,4,1,3,2,1,2,1,-1,1,2,-2,2,4,0,-3,109,3,4,7,4,0,-1,1,-1,-1,1,6,1
KR_6759861379,420,1,-95,-2,-3,-1,2,3,-1,3,4,4,4,0,-5,1,6,0,0,0,0,0,-6,1,3,4,-1,0,0,-1,-1,-1,-1,6,1
KR_6771322167,420,0,-35,-4,0,-2,0,2,2,3,1,1,4,3,1,3,2,-2,0,2,0,3,6,5,0,5,1,0,0,1,1,0,1,5,1
KR_6767123506,420,4,78,9,6,4,7,3,-5,0,5,0,0,0,6,7,1,1,2,1,1,4,4,0,6,6,-2,0,3,1,1,1,1,5,1
KR_6748779694,420,2,-3,-24,5,2,3,1,-3,2,5,2,2,0,1,2,1,3,3,0,0,6,241,3,4,7,2,0,2,1,1,1,-1,5,1
KR_6686094033,420,3,29,-16,5,-1,3,4,-5,1,6,3,5,2,6,7,1,2,3,1,1,4,-6,-5,7,2,5,0,1,-1,1,1,1,6,1
KR_6617975239,420,-3,-10,-11,-1,-5,0,5,2,5,3,-2,2,4,2,4,2,2,2,0,-2,2,-14,-3,6,3,5,0,1,1,-1,1,-1,2,1
KR_6728678316,440,0,18,-40,0,2,2,0,0,0,0,1,2,1,-3,0,3,0,0,0,0,-3,26,4,1,5,2,0,0,1,-1,0,1,2,1
KR_6764533397,420,7,29,28,10,2,2,0,0,3,3,2,7,5,6,7,1,0,0,0,0,12,-194,0,4,4,1,0,2,-1,-1,1,-1,5,1
KR_6612713536,440,2,19,44,8,1,2,1,0,4,4,5,5,0,3,4,1,-1,1,2,0,8,4,-1,4,3,1,0,1,1,1,1,-1,1,1
KR_6757015329,420,4,64,-17,8,-1,0,1,2,4,2,2,3,1,4,8,4,1,3,2,0,7,-9,2,6,8,7,0,2,1,1,1,1,2,1
KR_6525778510,420,-1,-64,13,0,3,5,2,-4,1,5,1,2,1,-1,3,4,1,2,1,0,-9,1,0,2,2,2,0,1,-1,1,1,1,1,1
KR_6670971606,420,1,-14,-25,-2,-1,1,2,-5,3,8,-1,2,3,7,9,2,-2,0,2,0,7,-4,1,5,6,2,0,0,1,-1,-1,1,2,1
KR_6744396327,420,3,6,3,4,-2,0,2,3,7,4,-3,1,4,8,8,0,-2,0,2,-1,0,15,3,5,8,0,0,0,1,-1,0,-1,3,1
KR_6699609177,420,4,35,29,11,2,3,1,3,4,1,4,6,2,3,4,1,-1,0,1,0,6,-23,6,3,9,-2,0,1,1,1,1,1,2,1
KR_6660777793,420,5,88,-16,8,8,9,1,1,3,2,0,4,4,-2,1,3,1,2,1,0,9,-4,1,4,5,-2,0,1,1,0,1,1,4,1
KR_6723484617,420,0,-44,-7,-2,-1,0,1,3,9,6,2,3,1,-4,0,4,-2,1,3,0,-1,-110,2,2,4,5,0,-3,1,-1,-1,-1,4,1
KR_6768797128,420,3,86,-2,7,0,3,3,5,6,1,1,3,2,1,1,0,0,2,2,0,4,8,2,1,3,2,0,-1,1,1,-1,-1,3,1
KR_6737739237,420,-2,-18,29,0,-2,1,3,6,8,2,-3,2,5,-2,1,3,1,2,1,0,1,31,-10,13,3,-2,0,1,1,1,1,1,5,1
KR_6687659856,440,-4,59,-11,-11,-4,2,6,-7,1,8,-1,2,3,0,3,3,1,3,2,1,-1,-37,-3,5,2,0,0,0,1,-1,1,1,4,1
KR_6761291216,420,5,66,6,7,3,4,1,4,6,2,1,3,2,2,3,1,-3,1,4,0,11,13,0,4,4,1,0,1,1,0,1,1,5,1
KR_6756958593,420,-1,-21,19,-5,0,3,3,-2,2,4,4,6,2,-3,1,4,-4,0,4,0,-2,-268,2,3,5,-3,0,-1,-1,-1,-1,-1,3,1
KR_6680772850,420,1,-23,-1,4,3,3,0,2,3,1,1,3,2,-3,2,5,1,2,1,-1,4,-8,-4,6,2,-1,0,1,1,1,1,-1,3,1
KR_6765325520,420,-2,20,-15,1,0,1,1,1,8,7,-1,1,2,2,3,1,-1,0,1,0,6,10,-2,6,4,-4,0,0,-1,-1,0,-1,5,1
KR_6746475063,420,1,-11,-3,5,-3,0,3,0,4,4,9,9,0,0,1,1,-1,1,2,0,18,6,3,2,5,2,0,0,1,1,0,-1,6,1
KR_6759225023,420,0,-44,24,6,1,2,1,4,7,3,1,3,2,-3,4,7,3,5,2,0,0,14,4,4,8,0,0,0,1,1,0,1,5,1
KR_6770822574,420,2,-33,13,3,2,2,0,5,5,0,1,3,2,-4,1,5,-1,0,1,0,5,-16,1,3,4,0,0,2,-1,1,1,1,2,1
KR_6771789166,420,0,27,47,0,-1,2,3,-1,4,5,6,6,0,-5,1,6,1,1,0,2,-4,-4,0,6,6,-2,0,0,1,1,0,1,5,1
KR_6652424325,420,7,70,-14,17,3,4,1,5,5,0,0,2,2,10,12,2,-1,1,2,0,17,2,1,2,3,3,0,2,-1,1,1,1,2,1
KR_6758448748,420,2,10,23,4,1,2,1,2,4,2,-3,5,8,4,5,1,0,1,1,1,0,0,0,4,4,0,0,1,-1,1,1,1,3,1
KR_6722964664,420,2,18,6,-5,1,3,2,-4,2,6,2,4,2,-2,4,6,-2,0,2,1,1,8,7,2,9,-4,0,0,1,0,-1,1,1,1
KR_6694604913,420,2,13,-7,1,-1,0,1,-1,1,2,0,2,2,1,2,1,2,3,1,1,4,13,0,4,4,7,0,0,1,-1,0,1,6,1
KR_6557675349,420,0,33,-9,3,-2,0,2,2,6,4,0,2,2,3,4,1,0,0,0,0,4,-5,1,9,10,-4,0,1,-1,1,1,1,1,1
KR_6458302782,420,2,-18,-12,17,4,5,1,1,1,0,2,4,2,7,8,1,3,5,2,0,17,-35,5,1,6,2,0,0,1,1,1,1,3,1
KR_6663609599,420,5,45,48,12,0,1,1,10,11,1,2,3,1,1,4,3,-1,2,3,0,13,-9,2,2,4,3,0,0,-1,1,0,1,4,1
KR_6591597153,420,2,14,2,5,1,2,1,0,2,2,7,8,1,0,2,2,-3,1,4,0,0,143,1,1,2,0,0,0,1,1,0,-1,3,1
KR_6762257547,420,3,71,16,9,2,2,0,0,1,1,0,2,2,5,5,0,2,2,0,0,10,80,-1,6,5,3,0,0,1,1,1,-1,3,1
KR_6760747769,420,-1,34,-16,0,-3,2,5,2,5,3,0,3,3,-1,2,3,2,3,1,0,-2,-125,-1,10,9,-3,0,1,1,1,1,-1,4,1
KR_6751775528,420,2,12,6,2,4,4,0,-1,2,3,-1,1,2,1,4,3,-1,0,1,0,-4,-13,0,3,3,-3,0,2,-1,1,1,-1,5,1
KR_6747351037,420,-1,-49,-28,3,5,5,0,-2,2,4,1,1,0,0,2,2,-1,1,2,0,-1,29,-1,4,3,18,0,0,-1,1,-1,1,2,1
KR_6742208225,420,0,-12,8,3,5,5,0,1,1,0,1,2,1,-4,1,5,0,2,2,0,0,-2,-1,5,4,2,0,0,-1,1,1,1,1,1
KR_6562329884,420,3,-10,7,13,1,2,1,5,9,4,2,2,0,7,9,2,-2,1,3,1,11,67,2,2,4,-2,0,0,1,-1,-1,1,6,1
KR_6657851241,420,3,-18,-5,10,2,2,0,3,8,5,-1,0,1,4,5,1,2,3,1,0,17,-7,6,2,8,1,0,0,1,-1,0,1,5,1
KR_6760427525,420,0,-28,-28,2,0,1,1,0,1,1,3,5,2,0,3,3,-1,2,3,0,1,-15,0,5,5,-4,0,0,1,-1,0,-1,2,1
KR_6749265156,440,-3,-16,-16,-4,1,1,0,-4,1,5,-3,2,5,2,5,3,0,1,1,0,-3,-37,0,5,5,18,0,0,0,1,0,-1,0,1
KR_6654477001,420,9,137,16,20,9,10,1,0,2,2,3,5,2,6,6,0,2,3,1,0,12,64,5,3,8,-8,0,2,1,1,1,1,6,1
KR_6765800865,420,-1,29,13,0,1,3,2,1,2,1,0,3,3,1,6,5,-3,0,3,0,-6,-14,2,0,2,4,0,1,1,-1,1,1,5,1
KR_6758085597,420,1,15,3,-1,-2,0,2,-1,2,3,0,1,1,-1,3,4,3,5,2,0,-4,4,0,4,4,-1,0,1,0,0,1,-1,0,1
KR_6713781392,420,6,93,55,12,2,3,1,1,2,1,8,9,1,3,6,3,-2,0,2,-1,12,67,2,3,5,-23,0,0,1,-1,1,-1,1,1
KR_6683400669,420,2,101,10,10,3,3,0,5,5,0,0,3,3,0,3,3,2,2,0,0,10,3,5,3,8,1,0,1,1,-1,1,1,5,1
KR_6713173719,420,-2,-4,0,2,-2,3,5,-3,1,4,5,8,3,1,8,7,1,3,2,0,5,7,1,5,6,-2,0,0,1,1,1,1,1,1
KR_6771682765,420,-1,-34,-40,0,0,0,0,1,4,3,-3,3,6,2,6,4,0,4,4,1,9,-105,0,5,5,2,0,1,-1,0,1,1,3,1
KR_6740370553,420,4,78,2,9,5,6,1,1,1,0,0,2,2,4,5,1,-1,0,1,0,10,20,-1,8,7,0,0,1,0,1,1,1,0,1
KR_6758168015,420,6,84,2,11,9,9,0,3,5,2,-1,2,3,-1,1,2,1,2,1,0,11,111,-1,7,6,3,0,1,-1,-1,1,-1,3,1
KR_6657921473,420,0,0,-5,6,-1,3,4,0,2,2,-2,2,4,7,8,1,2,3,1,1,8,-10,5,6,11,4,0,0,1,1,1,-1,1,1
KR_6753637403,420,-2,-34,4,-4,0,0,0,-3,2,5,-2,1,3,3,4,1,-2,1,3,0,-5,-43,0,5,5,-2,0,1,-1,1,1,-1,5,1
KR_6718115818,440,-1,3,-19,-2,0,5,5,5,7,2,-11,0,11,2,4,2,2,2,0,0,9,-23,-4,4,0,1,0,1,0,0,1,-1,0,1
KR_6714308840,420,2,-26,-6,9,2,3,1,5,5,0,4,4,0,0,1,1,-2,0,2,0,7,-46,-1,4,3,10,0,1,1,1,1,-1,4,1
KR_6771602756,440,1,-11,-12,3,2,2,0,3,4,1,-2,2,4,-3,3,6,3,5,2,0,3,1,2,3,5,-1,0,1,-1,1,1,-1,5,1
KR_6747542854,420,2,-3,12,7,5,7,2,0,2,2,4,5,1,-1,2,3,-1,1,2,0,9,-7,-1,7,6,-1,0,-1,0,0,-1,-1,0,1
KR_6768207301,420,1,-46,8,-1,-3,0,3,3,3,0,2,2,0,-3,1,4,0,0,0,0,-1,0,-6,8,2,3,0,0,-1,-1,0,-1,5,1
KR_6725748779,420,5,44,12,11,0,2,2,7,8,1,1,1,0,5,5,0,-2,4,6,0,12,12,3,3,6,1,0,1,0,1,1,-1,0,1
KR_6760781771,420,-3,-19,-1,-5,0,1,1,-1,1,2,-3,3,6,0,2,2,-1,1,2,0,-12,-7,1,6,7,-8,0,1,1,1,1,1,2,1
KR_6724948383,420,2,91,9,12,4,4,0,0,5,5,1,5,4,6,8,2,1,1,0,0,15,-5,2,5,7,6,0,2,1,-1,1,1,3,1
KR_6768193486,420,3,64,8,3,2,3,1,-2,1,3,5,6,1,0,2,2,-2,2,4,0,4,49,-2,5,3,-12,0,2,1,1,1,1,6,1
KR_6759789730,420,2,13,5,-3,0,1,1,-1,6,7,-3,3,6,3,5,2,-2,3,5,0,7,300,0,7,7,1,0,0,0,1,0,1,0,1
KR_6763001693,420,0,-21,-3,-3,-6,0,6,-1,1,2,3,4,1,0,4,4,1,1,0,-1,-1,-288,-5,8,3,4,0,-1,-1,-1,-1,-1,4,1
KR_6755360362,420,3,89,-30,3,2,3,1,1,3,2,-4,2,6,1,3,2,3,3,0,0,0,-4,-3,5,2,3,0,1,1,-1,1,-1,2,1
KR_6667459874,420,2,65,14,2,1,1,0,0,4,4,0,2,2,3,4,1,-2,1,3,0,3,0,4,2,6,-2,0,0,1,-1,0,1,1,1
KR_6423200017,420,5,66,28,5,-1,1,2,3,5,2,2,5,3,2,3,1,-1,2,3,0,1,-7,-1,7,6,5,0,0,1,1,0,1,2,1
KR_6755731781,420,3,-1,28,2,4,4,0,1,4,3,-1,0,1,-2,1,3,0,0,0,0,-1,-161,-2,7,5,-2,0,0,1,-1,0,-1,5,1
KR_6769323975,420,1,48,0,-2,2,3,1,-5,1,6,-2,0,2,2,3,1,1,1,0,1,0,2,3,4,7,7,0,2,1,1,1,1,5,1
KR_6768718626,420,-1,-18,-14,-1,-5,2,7,-1,3,4,2,3,1,3,3,0,0,0,0,0,1,12,-2,6,4,-2,-1,-3,-1,-1,-1,-1,2,1
KR_6624837377,420,5,52,55,6,4,6,2,1,2,1,6,7,1,-4,0,4,-1,1,2,0,-1,7,0,4,4,3,0,1,1,-1,1,1,5,1
KR_6770232842,420,-1,82,-8,-2,0,6,6,-2,1,3,-3,0,3,0,1,1,3,3,0,-1,-6,2,1,2,3,1,0,1,1,1,1,-1,1,1
KR_6746360705,420,1,3,-4,5,-2,2,4,-2,1,3,2,2,0,5,5,0,2,3,1,0,7,-2,1,3,4,1,0,1,1,1,1,-1,4,1
KR_6767790033,420,1,-9,16,9,1,2,1,6,9,3,-1,2,3,1,1,0,2,2,0,0,10,12,1,5,6,2,0,-2,1,-1,-1,-1,3,1
KR_6668311801,420,1,18,-24,1,-2,1,3,0,3,3,3,3,0,1,4,3,-1,0,1,0,3,1,2,7,9,-4,0,0,-1,1,0,1,4,1
KR_6731722258,420,-3,-9,-8,-16,-1,2,3,-3,2,5,-4,1,5,-6,1,7,-2,1,3,0,-17,-2,2,5,7,-4,0,-1,-1,0,-1,-1,5,1
KR_6768465848,440,2,20,-4,2,1,1,0,-3,1,4,6,6,0,0,1,1,-2,0,2,0,-7,40,6,2,8,-25,0,0,1,1,1,1,6,1
KR_6756874501,420,3,19,-12,8,-1,2,3,4,7,3,3,4,1,1,5,4,1,2,1,1,8,0,0,3,3,4,0,0,1,-1,0,1,3,1
KR_6770394044,420,5,17,16,4,2,2,0,4,6,2,-1,1,2,-4,2,6,3,4,1,0,1,31,2,4,6,0,0,0,-1,1,0,1,5,1
KR_6555354599,440,-1,17,-20,-2,4,7,3,1,3,2,-1,1,2,-6,2,8,0,2,2,0,1,1,1,2,3,0,0,1,-1,-1,1,1,1,1
KR_6769969548,420,2,86,-4,2,0,1,1,-2,3,5,0,0,0,1,2,1,3,3,0,0,0,4,-6,7,1,2,0,1,1,-1,1,1,3,1
KR_6753111987,440,0,93,-17,1,-2,1,3,1,3,2,2,2,0,1,2,1,-1,4,5,0,5,40,1,1,2,-28,0,2,0,1,1,1,0,1
KR_6757118930,420,5,35,39,4,3,4,1,5,8,3,-1,1,2,-2,3,5,-1,2,3,0,1,-20,1,4,5,0,0,2,1,1,1,1,6,1
KR_6651752747,440,2,-3,20,2,0,1,1,3,3,0,-4,0,4,5,6,1,-2,1,3,2,1,2,0,4,4,3,0,-1,0,-1,-1,1,0,1
KR_6767169696,440,5,51,-12,14,0,0,0,1,2,1,4,4,0,2,2,0,7,8,1,0,9,-10,4,1,5,1,0,2,1,1,1,1,6,1
KR_6723358534,420,3,65,19,6,1,2,1,0,5,5,6,6,0,0,2,2,-1,0,1,0,0,24,-3,3,0,0,0,0,-1,-1,1,1,1,1
KR_6764295046,420,0,-55,20,0,5,5,0,-6,1,7,1,3,2,-2,1,3,2,2,0,1,-6,-149,-5,9,4,5,0,1,0,1,1,1,0,1
KR_6754425205,420,7,62,53,15,2,3,1,9,9,0,1,4,3,3,3,0,0,1,1,0,15,8,1,2,3,1,0,0,1,1,0,1,2,1
KR_6759824912,440,1,-35,0,3,2,3,1,0,0,0,0,1,1,0,5,5,1,9,8,0,7,-5,3,4,7,-6,0,0,0,1,0,-1,0,1
KR_6709334560,420,1,25,-2,3,3,4,1,-1,2,3,2,4,2,2,3,1,-3,0,3,-1,-3,175,-2,5,3,3,0,0,1,-1,0,-1,5,1
KR_6770634375,420,-1,-4,-22,1,3,3,0,-2,1,3,1,6,5,-1,2,3,0,1,1,3,15,-12,4,2,6,3,0,1,1,-1,1,1,1,1
KR_6740648705,420,-2,-32,-15,-7,0,2,2,-4,3,7,3,5,2,-4,0,4,-2,2,4,2,1,-26,-5,6,1,4,0,0,-1,-1,-1,1,6,1
KR_6738240724,420,4,69,4,4,5,6,1,-1,1,2,3,5,2,0,2,2,-3,0,3,1,3,1,-2,5,3,3,0,0,-1,1,0,1,3,1
KR_6596342244,420,1,47,-4,3,1,2,1,3,5,2,-1,2,3,0,2,2,0,1,1,0,-2,3,-2,6,4,3,0,0,-1,1,1,1,1,1
KR_6771627050,420,-2,-87,0,3,-2,0,2,2,3,1,-1,1,2,3,3,0,1,1,0,0,6,-10,3,3,6,-4,0,-1,1,-1,-1,1,3,1
KR_6671192442,420,1,45,16,2,4,4,0,-3,2,5,0,3,3,2,7,5,-1,2,3,2,-1,13,6,4,10,-4,0,0,-1,1,1,1,5,1
KR_6769998486,440,4,58,12,9,4,5,1,2,5,3,0,1,1,3,6,3,0,1,1,0,5,10,0,3,3,1,0,2,-1,1,1,-1,5,1
KR_6755374103,420,2,54,-24,3,4,4,0,0,1,1,-1,1,2,1,1,0,-1,0,1,0,-3,40,2,6,8,5,0,0,0,-1,0,1,0,1
KR_6771088574,420,3,31,16,-1,0,1,1,-2,2,4,1,4,3,0,3,3,0,1,1,0,0,3,-1,5,4,1,0,0,1,1,0,1,6,1
KR_6739205317,420,3,22,45,7,-1,1,2,5,5,0,1,3,2,3,5,2,-1,1,2,0,10,3,7,0,7,2,0,-1,1,-1,-1,1,2,1
KR_6734519515,420,3,16,36,6,1,2,1,0,1,1,5,5,0,-1,2,3,1,4,3,0,4,3,-3,8,5,0,0,0,-1,1,0,1,1,1
KR_6761700812,420,2,37,23,5,2,4,2,2,3,1,1,3,2,0,0,0,0,0,0,1,2,32,-1,1,0,-2,0,0,1,1,1,1,6,1
KR_6709766477,420,5,79,20,6,4,7,3,-1,2,3,1,2,1,0,2,2,2,2,0,1,5,-13,-1,4,3,3,0,1,1,1,1,1,6,1
KR_6725111176,420,1,-20,8,-3,-1,1,2,-2,0,2,-1,3,4,1,4,3,0,0,0,-2,-7,9,4,7,11,-6,0,-1,-1,-1,-1,-1,6,1
KR_6757942285,420,5,44,23,7,4,7,3,-2,3,5,5,5,0,-1,1,2,1,2,1,0,7,308,1,5,6,0,0,2,1,1,1,-1,2,1
KR_6761569606,420,3,51,27,9,2,2,0,1,3,2,-1,2,3,7,10,3,0,0,0,0,11,207,5,6,11,5,0,2,1,1,1,1,3,1
KR_6760262537,420,3,-6,0,7,4,4,0,3,3,0,1,3,2,1,2,1,-2,0,2,0,-1,-21,-1,5,4,0,0,0,1,1,0,1,2,1
KR_6609841173,420,2,-10,-15,7,-2,0,2,4,5,1,1,2,1,3,4,1,1,1,0,0,6,4,0,2,2,0,0,1,1,-1,1,1,3,1
KR_6387148471,420,3,64,-24,3,4,4,0,0,3,3,-2,0,2,0,0,0,1,1,0,0,-1,13,-5,10,5,-2,0,1,-1,-1,1,1,1,1
KR_6771111699,420,9,85,-12,22,5,6,1,4,4,0,4,7,3,4,7,3,5,5,0,0,15,1,2,3,5,3,0,2,-1,1,1,1,2,1
KR_6725037132,420,3,13,33,5,1,3,2,-2,1,3,4,5,1,2,2,0,0,0,0,0,2,5,2,6,8,-6,0,1,1,1,1,1,3,1
KR_6771631774,420,2,32,-28,4,1,2,1,1,4,3,2,4,2,-1,2,3,1,2,1,0,7,-9,0,5,5,5,0,1,-1,1,1,1,5,1
KR_6766363193,420,0,-34,-5,1,-2,0,2,4,6,2,1,2,1,1,4,3,-3,0,3,0,4,-2,-1,5,4,3,0,0,1,1,0,-1,4,1
KR_6394860618,420,-5,-23,-20,-4,2,3,1,-3,2,5,0,2,2,-3,1,4,0,0,0,0,-9,-21,1,3,4,-5,0,1,-1,-1,1,1,6,1
KR_6749182374,440,-1,-71,-29,0,2,3,1,1,1,0,-2,0,2,0,1,1,-1,5,6,-1,-1,-9,-8,11,3,-1,0,-2,-1,-1,-1,-1,2,1
KR_6763411912,420,-2,-1,4,-1,0,1,1,0,2,2,1,3,2,-2,1,3,0,0,0,0,-3,9,1,3,4,-1,0,-1,1,1,-1,1,6,1
KR_6742366325,420,4,95,-4,7,3,3,0,0,2,2,2,3,1,1,4,3,1,1,0,0,1,14,2,3,5,1,0,0,-1,1,0,1,5,1
KR_6707409892,440,-3,56,30,-7,3,4,1,-1,1,2,-7,2,9,-2,1,3,0,4,4,2,1,-121,-2,5,3,1,0,0,1,-1,-1,1,3,1
KR_6768756464,440,-1,-53,-7,3,0,1,1,3,4,1,-2,1,3,2,4,2,0,0,0,0,7,3,5,2,7,-2,0,0,-1,1,0,1,3,1
KR_6771206265,420,1,11,14,4,-1,1,2,1,2,1,4,6,2,0,0,0,0,0,0,0,4,-15,-1,6,5,6,0,1,1,1,1,1,1,1
KR_6645758486,420,1,44,12,-1,1,2,1,-2,2,4,-3,0,3,2,2,0,1,6,5,0,0,-67,-6,9,3,4,0,0,-1,-1,0,1,2,1
KR_6747048758,420,4,-2,8,7,-2,2,4,3,7,4,3,4,1,3,4,1,0,0,0,0,6,-6,-2,10,8,-2,0,-1,1,1,-1,1,4,1
KR_6594069829,420,7,33,-28,14,10,10,0,1,3,2,2,6,4,1,3,2,0,0,0,0,17,6,2,3,5,2,0,1,0,1,1,-1,0,1
KR_6679347504,420,0,-1,7,3,1,1,0,0,3,3,-2,1,3,1,3,2,3,4,1,0,2,4,6,5,11,3,0,0,-1,1,0,1,2,1
KR_6467359920,420,0,29,28,4,2,3,1,-1,6,7,-2,1,3,2,3,1,3,4,1,0,5,250,-4,7,3,2,0,2,-1,1,1,-1,6,1
KR_6769654442,420,3,71,0,6,0,0,0,6,9,3,-1,1,2,-1,0,1,2,3,1,0,7,-14,6,2,8,4,0,0,1,1,-1,1,2,1
KR_6606150524,420,3,-48,5,6,2,3,1,0,2,2,6,8,2,-2,1,3,0,2,2,0,3,-44,3,2,5,16,0,-1,-1,1,-1,-1,1,1
KR_6646390380,420,-4,-38,-17,-3,-2,3,5,0,2,2,0,3,3,-3,1,4,2,2,0,0,0,4,-2,6,4,-1,0,1,-1,0,1,1,6,1
KR_6670993496,420,-1,-82,23,2,1,4,3,0,4,4,-2,0,2,4,5,1,-1,1,2,1,5,7,5,5,10,0,0,-1,-1,-1,-1,1,4,1
KR_6760701273,420,1,-34,-5,2,-1,0,1,-1,1,2,-4,1,5,8,9,1,0,0,0,1,11,28,0,3,3,4,0,1,1,-1,1,1,5,1
KR_6743506300,420,3,13,16,2,-1,1,2,0,0,0,1,1,0,1,3,2,1,2,1,0,1,-18,3,0,3,5,0,1,1,-1,1,-1,6,1
KR_6769169609,420,1,-1,28,2,0,3,3,1,3,2,-1,0,1,2,2,0,0,0,0,0,2,-105,0,2,2,-5,0,0,1,-1,-1,1,2,1
KR_6722998019,420,5,-17,31,7,2,2,0,0,3,3,4,5,1,1,4,3,0,1,1,-1,3,-18,-2,8,6,1,0,1,0,1,1,1,0,1
KR_6683709057,420,-4,-4,8,-1,1,2,1,0,2,2,0,2,2,-3,0,3,1,1,0,0,-4,-1,3,7,10,3,0,0,1,-1,0,1,6,1
KR_6741696401,420,3,-14,9,7,0,1,1,4,4,0,0,0,0,2,10,8,1,2,1,0,2,-9,-3,7,4,2,0,1,-1,1,1,1,1,1
KR_6654053242,420,1,-46,2,4,0,1,1,1,2,1,3,4,1,2,3,1,-2,1,3,-1,10,-4,0,4,4,6,0,-1,1,-1,-1,-1,1,1
KR_6588076354,420,3,10,-8,6,0,1,1,-1,5,6,0,4,4,2,4,2,5,5,0,0,12,12,4,3,7,-2,0,0,-1,1,1,1,6,1
KR_6768253280,420,-2,-2,-18,5,2,2,0,0,2,2,-4,3,7,4,4,0,3,4,1,0,14,16,6,4,10,0,0,-1,1,-1,-1,1,5,1
KR_6674031637,420,-2,-11,20,-5,-2,0,2,0,3,3,0,1,1,-3,1,4,0,0,0,0,-7,-2,3,5,8,-3,0,0,1,1,0,-1,6,1
KR_6764425096,420,6,70,-32,9,3,6,3,1,2,1,2,2,0,3,4,1,0,1,1,0,2,6,1,4,5,5,0,1,-1,1,1,1,2,1
KR_6770067809,440,1,-48,18,2,-3,0,3,3,4,1,2,3,1,0,0,0,0,0,0,0,2,60,2,2,4,-3,0,0,1,0,0,-1,6,1
KR_6770758603,420,-4,-51,-19,-7,-3,1,4,3,7,4,-1,1,2,-3,1,4,-3,1,4,0,-2,-7,1,4,5,-2,0,-2,-1,0,-1,-1,5,1
KR_6662430759,420,3,21,-4,8,-1,2,3,1,1,0,1,3,2,6,6,0,1,1,0,0,11,-11,0,6,6,4,0,1,1,-1,1,1,3,1
KR_6731279295,420,2,26,-5,2,0,0,0,4,4,0,-1,1,2,-1,3,4,0,0,0,0,-2,3,5,2,7,-4,0,0,1,-1,0,-1,4,1
KR_6629527292,420,-1,28,39,3,-4,1,5,0,7,7,4,5,1,1,2,1,2,3,1,-2,1,-2,6,1,7,-2,0,2,1,-1,1,-1,4,1
KR_6768851108,420,0,-22,-6,2,3,3,0,-2,1,3,2,4,2,1,3,2,-2,2,4,1,4,-11,2,3,5,-3,0,0,-1,1,0,1,1,1
KR_6762036006,420,-2,-42,-36,4,3,6,3,1,2,1,-2,2,4,1,1,0,1,2,1,0,7,-19,5,3,8,1,0,1,-1,1,1,1,3,1
KR_6685805793,420,0,-29,-20,-1,6,6,0,-1,2,3,-3,1,4,-3,1,4,0,0,0,0,-4,7,4,6,10,-5,0,0,-1,1,1,1,2,1
KR_6384247172,420,2,-22,-29,1,5,6,1,1,1,0,-5,1,6,1,2,1,-1,0,1,0,2,-279,-4,8,4,-1,0,-1,1,-1,-1,-1,6,1
KR_6642351650,420,-1,2,-5,-2,-2,0,2,2,5,3,-4,0,4,4,4,0,-2,0,2,-1,-2,-27,-3,7,4,0,0,0,0,0,-1,-1,0,1
KR_6727057399,420,2,74,20,-2,1,2,1,-2,3,5,1,3,2,-2,1,3,0,1,1,0,0,38,-3,4,1,-28,0,1,-1,1,1,1,2,1
KR_6766494966,420,1,8,-11,0,0,2,2,-2,1,3,0,1,1,3,6,3,-1,1,2,0,0,3,6,0,6,-2,0,0,-1,-1,0,1,1,1
KR_6724698132,420,5,66,-16,17,6,7,1,6,6,0,4,4,0,1,2,1,0,2,2,0,13,-3,8,2,10,1,0,2,0,1,1,1,0,1
KR_6687413736,420,1,15,-4,-3,-2,1,3,0,3,3,0,1,1,-1,2,3,0,0,0,0,-3,113,2,4,6,-5,0,0,1,-1,0,1,5,1
KR_6667605890,420,0,21,8,6,1,2,1,1,3,2,0,3,3,4,4,0,0,0,0,0,7,4,4,3,7,5,0,0,1,1,0,1,6,1
KR_6714043006,420,9,85,30,16,1,2,1,3,5,2,5,5,0,3,3,0,4,4,0,0,13,4,-1,3,2,0,0,3,-1,1,1,1,3,1
KR_6694257484,420,3,45,17,6,0,2,2,2,4,2,4,6,2,1,3,2,-1,0,1,1,7,7,2,5,7,0,0,2,1,1,1,-1,3,1
KR_6742514166,420,4,36,13,11,0,3,3,4,6,2,2,3,1,2,5,3,3,5,2,1,19,14,1,4,5,4,0,2,1,1,1,1,5,1
KR_6701328665,420,6,40,28,11,1,4,3,4,6,2,1,2,1,0,0,0,5,5,0,0,12,6,-2,5,3,5,0,2,1,-1,-1,1,2,1
KR_6739325550,420,0,-7,-2,7,0,0,0,3,4,1,4,6,2,0,1,1,0,0,0,0,10,12,3,2,5,1,0,1,1,1,1,1,1,1
KR_6761291589,420,2,-11,4,1,4,5,1,-2,1,3,-2,0,2,0,3,3,1,1,0,0,-7,-7,-4,5,1,2,0,0,1,-1,0,1,3,1
KR_6739106294,420,1,52,22,1,5,5,0,-3,1,4,3,4,1,-4,2,6,0,0,0,0,-12,11,2,3,5,-4,0,0,1,1,0,-1,1,1
KR_6711642573,420,-2,18,-24,-4,-2,2,4,-4,0,4,1,3,2,0,2,2,1,1,0,0,-6,-132,0,6,6,0,0,1,1,-1,1,1,5,1
KR_6767326174,420,4,55,-2,8,3,3,0,4,6,2,-4,0,4,6,6,0,-1,1,2,0,10,-22,-4,8,4,8,0,1,-1,1,1,1,3,1
KR_6756745031,420,1,-51,-9,6,4,5,1,0,2,2,1,1,0,-3,1,4,4,5,1,0,6,4,-2,5,3,-1,0,0,1,1,1,-1,2,1
KR_6730396081,440,5,119,-30,12,6,8,2,4,5,1,1,4,3,1,3,2,0,0,0,0,11,46,2,4,6,-3,0,3,0,1,1,1,0,1
KR_6764906773,420,-1,-61,11,-7,-7,0,7,-4,0,4,3,4,1,-1,3,4,2,3,1,0,-5,0,-5,7,2,6,0,-1,0,-1,-1,1,0,1
KR_6769970993,420,0,20,15,5,0,1,1,1,8,7,4,4,0,-3,1,4,3,3,0,1,7,3,-2,7,5,0,0,0,-1,1,1,1,6,1
KR_6548004476,420,-2,-41,-6,2,0,2,2,-4,4,8,5,6,1,2,3,1,-1,0,1,0,0,-45,-1,5,4,17,0,0,1,-1,-1,1,4,1
KR_6762998649,420,2,45,41,0,2,3,1,1,2,1,1,6,5,-2,2,4,-2,2,4,-1,-6,-1,-3,6,3,0,0,1,1,1,1,-1,1,1
KR_6769672162,420,0,-35,11,3,-3,3,6,-1,0,1,2,2,0,7,10,3,-2,1,3,-1,4,5,6,2,8,2,0,0,-1,1,0,-1,4,1
KR_6769218466,420,2,41,-7,7,8,8,0,-4,2,6,4,7,3,-1,1,2,0,0,0,1,6,6,5,2,7,0,0,1,0,0,1,1,0,1
KR_6724954311,420,6,84,52,16,4,4,0,2,3,1,4,5,1,3,5,2,3,4,1,0,10,11,1,4,5,1,0,2,1,-1,1,1,1,1
KR_6771771090,420,2,46,0,9,4,4,0,4,5,1,2,5,3,-2,1,3,1,2,1,0,14,101,-2,5,3,1,0,0,1,0,0,1,3,1
KR_6763090680,440,1,13,-12,5,0,0,0,1,2,1,1,4,3,4,5,1,-1,2,3,1,12,-20,4,2,6,4,0,0,1,1,0,1,1,1
KR_6754149918,420,0,28,-1,-1,1,3,2,-5,2,7,4,4,0,-2,1,3,1,2,1,-2,-6,-2,-2,7,5,1,0,-1,1,1,-1,-1,6,1
KR_6732254120,420,-1,-51,7,1,-2,1,3,-2,2,4,4,5,1,2,4,2,-1,0,1,0,-1,5,-1,4,3,-2,0,0,1,-1,-1,-1,5,1
KR_6704251235,420,3,72,8,5,3,3,0,-2,1,3,2,5,3,-1,3,4,3,3,0,0,5,-6,0,4,4,0,0,0,1,1,1,1,4,1
KR_6701242981,420,3,77,10,6,7,8,1,-4,3,7,1,3,2,1,2,1,1,1,0,0,-2,45,7,3,10,-7,0,1,-1,1,1,1,6,1
KR_6749583452,420,3,56,-8,10,-1,1,2,1,4,3,4,5,1,2,8,6,4,5,1,0,14,5,3,2,5,2,0,1,1,1,1,1,6,1
KR_6733122197,420,9,130,44,20,4,4,0,-4,1,5,5,5,0,17,17,0,-2,3,5,2,14,2,-3,6,3,1,0,3,1,1,1,-1,4,1
KR_6763568429,420,0,99,4,6,3,5,2,2,2,0,-1,1,2,0,2,2,2,2,0,0,-1,1,-2,3,1,1,0,0,-1,0,0,1,4,1
KR_6497721452,420,-1,25,32,-4,-4,1,5,0,5,5,1,5,4,0,2,2,-1,0,1,0,-11,-12,0,5,5,-3,0,0,1,0,0,-1,2,1
KR_6768889882,420,7,57,30,18,1,1,0,9,10,1,3,5,2,5,5,0,0,0,0,0,27,106,0,6,6,3,0,2,1,1,1,1,4,1
KR_6651809466,420,1,-5,23,0,1,1,0,-3,1,4,1,2,1,0,2,2,1,2,1,0,-5,-5,3,4,7,-1,0,0,0,1,0,-1,0,1
KR_6681994657,420,1,53,8,-2,0,3,3,-1,3,4,-4,0,4,3,7,4,0,0,0,0,2,28,5,5,10,2,0,1,-1,1,1,-1,2,1
KR_6548323988,420,3,35,9,5,2,4,2,1,2,1,-3,1,4,1,2,1,4,4,0,0,0,2,2,5,7,6,0,0,1,-1,0,1,4,1
KR_6746076909,420,5,38,1,8,2,2,0,1,2,1,-2,3,5,3,3,0,4,4,0,0,17,175,-6,9,3,0,0,1,1,1,1,-1,1,1
KR_6394823694,420,3,35,8,6,1,2,1,4,6,2,1,2,1,1,2,1,-1,0,1,0,6,120,3,4,7,1,0,1,-1,1,1,-1,3,1
KR_6762137988,420,3,63,19,9,3,5,2,2,3,1,-1,1,2,1,2,1,4,4,0,1,5,-46,-1,7,6,-3,0,1,1,0,1,1,4,1
KR_6767806141,420,0,-15,23,-1,4,4,0,-3,2,5,-4,0,4,1,3,2,1,2,1,0,-4,0,7,1,8,2,0,0,1,-1,-1,-1,5,1
KR_6746480975,420,4,68,15,8,1,4,3,7,7,0,-3,1,4,1,4,3,2,2,0,0,15,9,0,5,5,2,0,0,1,-1,1,1,1,1
KR_6689384382,420,5,61,-11,13,1,4,3,2,3,1,-2,1,3,12,13,1,0,1,1,0,15,33,2,4,6,-9,0,0,1,-1,1,1,6,1
KR_6759149640,420,0,-21,0,2,0,2,2,2,3,1,0,0,0,0,3,3,0,0,0,0,6,4,-2,11,9,2,0,0,1,-1,0,-1,2,1
KR_6684850594,420,2,76,27,11,2,3,1,3,3,0,4,4,0,-1,2,3,3,3,0,0,12,-2,1,5,6,4,0,1,-1,1,1,1,3,1
KR_6766629241,420,3,78,5,14,7,8,1,0,0,0,2,4,2,4,5,1,1,2,1,0,15,-3,-2,6,4,3,0,1,0,1,1,1,0,1
KR_6755441699,420,1,48,-37,6,1,2,1,4,6,2,1,2,1,0,2,2,0,0,0,0,9,-14,4,3,7,3,0,0,-1,-1,0,-1,4,1
KR_6596213773,420,5,154,4,6,1,2,1,4,6,2,2,5,3,-1,4,5,0,1,1,0,-3,19,4,4,8,-17,0,3,-1,1,1,-1,3,1
KR_6766164897,420,1,-89,32,7,1,3,2,2,4,2,1,3,2,-2,1,3,5,6,1,3,17,-3,1,5,6,-1,0,-1,-1,1,-1,1,2,1
KR_6682840399,420,-3,-60,0,-12,-3,0,3,-1,4,5,-5,2,7,-3,4,7,0,2,2,0,-13,-10,-5,11,6,4,0,-2,-1,-1,-1,1,5,1
KR_6701276664,420,4,-9,23,1,0,3,3,4,7,3,3,6,3,-3,1,4,-3,2,5,1,-2,-6,1,5,6,0,0,0,1,-1,-1,1,5,1
KR_6768783272,420,0,-43,-27,0,-1,2,3,-1,2,3,0,1,1,1,2,1,1,2,1,0,0,2,1,2,3,1,0,1,0,1,1,-1,0,1
KR_6681279573,420,3,53,4,3,4,4,0,2,4,2,2,5,3,-2,3,5,-3,0,3,0,-1,2,-2,6,4,-2,0,-1,-1,0,-1,-1,4,1
KR_6691239656,420,1,62,-21,2,1,5,4,-2,5,7,0,3,3,3,8,5,0,2,2,0,-3,-7,-7,8,1,4,0,1,-1,1,1,-1,1,1
KR_6768773073,420,5,81,-1,14,0,4,4,5,8,3,2,3,1,7,7,0,0,0,0,0,16,6,-2,5,3,2,0,0,1,-1,1,1,3,1
KR_6613732423,420,1,-14,-19,1,1,1,0,-2,2,4,-2,2,4,2,5,3,2,2,0,0,1,1,-2,9,7,-2,0,-1,-1,-1,-1,1,2,1
KR_6769471688,420,2,39,12,9,4,5,1,-1,1,2,0,1,1,3,3,0,3,6,3,3,9,-29,-1,4,3,4,0,0,1,-1,0,1,6,1
KR_6770905933,420,2,67,13,10,0,1,1,5,6,1,1,1,0,3,6,3,1,1,0,1,11,5,-2,5,3,2,0,1,1,1,1,1,5,1
KR_6768683074,420,1,73,-11,5,3,4,1,-1,4,5,2,3,1,-1,4,5,2,3,1,1,-2,-9,1,5,6,5,0,1,-1,1,1,1,4,1
KR_6755776938,420,4,54,-18,14,5,5,0,1,2,1,4,4,0,2,2,0,2,3,1,0,11,10,5,2,7,3,0,1,-1,0,1,1,3,1
KR_6770079801,420,5,60,-12,13,5,5,0,5,7,2,2,3,1,1,5,4,0,0,0,0,20,1,1,4,5,4,0,1,1,-1,1,1,3,1
KR_6763322637,420,3,127,20,9,5,8,3,-1,0,1,0,2,2,7,8,1,-2,1,3,0,-1,-28,1,5,6,4,0,1,1,-1,1,1,2,1
KR_6764750146,420,0,1,47,-1,0,1,1,-1,0,1,2,4,2,-2,4,6,0,0,0,-1,-1,-116,-2,7,5,-17,0,0,-1,-1,-1,-1,2,1
KR_6732718158,420,4,66,-1,11,3,3,0,-3,2,5,-1,2,3,11,12,1,1,1,0,1,15,1,3,0,3,2,0,2,0,1,1,1,0,1
KR_6747611628,420,-1,-46,-24,4,-1,1,2,3,6,3,0,1,1,2,3,1,0,0,0,0,2,55,1,5,6,4,0,0,-1,0,0,1,5,1
KR_6768978271,420,-2,8,18,-3,-2,0,2,0,0,0,1,3,2,-1,1,2,-1,1,2,0,-6,3,-1,7,6,-2,0,-1,-1,1,-1,-1,5,1
KR_6688331933,420,3,-15,21,9,4,4,0,4,6,2,1,2,1,1,6,5,-1,2,3,0,8,12,8,1,9,-9,0,-1,1,1,-1,-1,6,1
KR_6746389946,420,3,80,8,9,4,4,0,0,1,1,3,4,1,0,1,1,2,2,0,0,7,5,0,4,4,2,0,0,1,-1,0,1,2,1
KR_6738580457,420,1,7,4,-1,7,8,1,-3,2,5,-5,3,8,1,3,2,-1,2,3,0,-10,2,-7,9,2,-3,0,2,-1,1,1,-1,3,1
KR_6754416683,420,1,45,-25,0,-6,1,7,3,5,2,1,2,1,2,3,1,0,0,0,0,3,8,-7,10,3,5,0,-1,1,-1,-1,-1,5,1
KR_6726957977,420,6,-10,48,12,4,4,0,-1,3,4,9,10,1,1,5,4,-1,0,1,0,0,9,-3,5,2,2,0,0,1,0,0,-1,4,1
KR_6692695678,420,-1,50,-8,-3,1,1,0,-4,1,5,-2,2,4,1,1,0,1,2,1,0,-6,-5,4,4,8,1,0,-1,1,-1,-1,1,6,1
KR_6766086486,420,1,-2,6,-2,1,3,2,-4,3,7,-1,1,2,2,6,4,0,0,0,0,-3,27,2,3,5,-1,0,0,-1,1,0,1,2,1
KR_6751001064,440,3,53,24,2,-2,0,2,3,5,2,1,1,0,1,4,3,-1,0,1,1,1,-44,-2,7,5,3,0,0,1,-1,0,1,3,1
KR_6757997519,420,1,11,-4,5,1,2,1,0,2,2,-1,1,2,3,4,1,2,5,3,0,5,4,1,5,6,-6,0,0,-1,1,1,-1,3,1
KR_6722728701,420,1,20,8,0,1,2,1,0,2,2,-1,3,4,0,5,5,0,1,1,0,3,16,3,7,10,-2,0,-1,0,-1,-1,-1,0,1
KR_6715026707,420,-1,9,8,-2,-3,0,3,3,5,2,-2,1,3,1,4,3,-1,1,2,0,1,-269,0,6,6,-4,0,-2,1,-1,-1,-1,4,1
KR_6769806203,420,4,55,4,11,5,6,1,7,7,0,4,5,1,-5,3,8,0,1,1,0,10,-27,-4,9,5,18,0,1,1,1,1,-1,3,1
KR_6771939196,420,0,23,-16,7,-3,1,4,2,4,2,0,0,0,7,8,1,1,2,1,0,6,3,2,1,3,2,0,1,1,1,1,1,5,1
KR_6767861747,420,-1,-5,9,0,-1,0,1,0,5,5,3,5,2,-1,1,2,-1,0,1,0,1,-16,-3,4,1,-3,0,0,1,1,0,1,6,1
KR_6767443806,420,0,7,-1,-4,-5,0,5,1,3,2,4,5,1,-2,3,5,-2,2,4,0,-4,10,-2,6,4,3,0,0,1,-1,-1,-1,2,1
KR_6764221735,420,2,104,36,2,2,2,0,3,5,2,-1,1,2,-1,4,5,-1,0,1,0,-6,8,-6,7,1,-1,0,0,1,-1,0,-1,1,1
KR_6747981202,420,5,111,20,11,-2,1,3,2,2,0,5,5,0,3,5,2,3,4,1,0,9,1,-2,3,1,2,0,0,1,1,1,1,6,1
KR_6759919334,420,2,105,38,0,3,3,0,-4,1,5,2,2,0,-1,4,5,0,1,1,0,1,-14,4,2,6,0,0,2,-1,1,1,1,1,1
KR_6769939352,420,1,65,12,-1,4,5,1,-4,3,7,2,2,0,-3,1,4,0,1,1,-1,-10,25,4,2,6,-1,0,1,-1,1,1,-1,3,1
KR_6748136114,420,1,0,9,6,0,3,3,1,4,3,1,2,1,4,8,4,0,0,0,1,10,-40,-4,6,2,17,0,0,0,0,0,1,0,1
KR_6770379299,440,0,20,36,2,-2,2,4,2,6,4,1,1,0,4,4,0,-3,1,4,-1,7,-4,-5,10,5,-2,0,-1,-1,-1,-1,-1,3,1
KR_6668753098,420,2,52,20,3,-1,3,4,1,2,1,-1,0,1,-1,1,2,5,5,0,-1,7,-1,-1,7,6,-1,0,0,1,1,1,-1,5,1
KR_6705265890,420,-2,8,5,-4,0,1,1,0,4,4,-2,1,3,-1,1,2,-1,0,1,1,0,15,2,4,6,2,0,0,-1,1,1,1,1,1
KR_6614344319,420,-3,14,-12,-4,-2,0,2,-1,3,4,1,4,3,0,2,2,-2,0,2,0,-2,-1,4,4,8,0,0,0,-1,0,0,1,4,1
KR_6745381964,420,3,-17,36,5,-3,1,4,5,6,1,1,4,3,0,2,2,2,2,0,0,7,-3,-5,9,4,-4,0,0,1,-1,1,-1,1,1
KR_6762297520,420,-1,-14,-25,-4,-1,2,3,-6,1,7,5,9,4,-4,1,5,2,4,2,-1,-10,-6,-3,5,2,1,0,0,-1,-1,-1,-1,6,1
KR_6769113645,420,0,9,0,-3,0,2,2,-1,1,2,-1,1,2,-2,0,2,1,1,0,0,-3,-24,-1,4,3,1,0,-1,1,-1,-1,1,1,1
KR_6768416270,420,0,-29,40,5,1,1,0,3,5,2,1,2,1,1,1,0,-1,0,1,0,5,-4,-1,6,5,2,0,1,-1,1,1,1,4,1
KR_6703537925,420,2,-22,0,9,2,4,2,3,3,0,4,9,5,0,3,3,0,1,1,1,10,-4,-2,9,7,1,0,1,1,1,-1,1,2,1
KR_6739006948,420,5,73,28,5,-4,1,5,3,5,2,0,1,1,6,6,0,0,0,0,0,5,-1,-3,5,2,4,0,1,-1,-1,1,1,4,1
KR_6663616854,420,0,-14,-8,0,4,5,1,-5,1,6,-1,0,1,0,2,2,2,2,0,0,-5,-12,0,7,7,-2,0,0,-1,-1,1,1,4,1
KR_6717458003,420,0,3,8,3,1,1,0,0,4,4,1,1,0,4,4,0,-3,0,3,0,1,-4,1,5,6,2,0,0,0,-1,0,-1,0,1
KR_6745448372,420,1,19,16,-2,6,6,0,1,4,3,-5,0,5,-3,0,3,-1,0,1,0,-18,2,2,2,4,1,0,1,-1,1,1,-1,5,1
KR_6558369790,440,-1,8,28,1,2,2,0,-1,4,5,0,2,2,2,4,2,-2,1,3,1,-2,-11,1,4,5,7,0,1,1,1,1,1,5,1
KR_6717619936,420,-3,-18,-4,-4,-3,0,3,2,3,1,0,2,2,-2,0,2,-1,0,1,0,0,-10,-6,8,2,3,0,0,0,-1,0,-1,0,1
KR_6737578998,440,0,-33,6,7,0,2,2,1,4,3,1,4,3,5,5,0,0,2,2,0,6,3,5,3,8,0,0,0,-1,-1,0,-1,4,1
KR_6686996543,420,2,-8,-12,5,3,4,1,3,5,2,-3,1,4,3,3,0,-1,0,1,0,7,1,-1,6,5,0,0,1,1,1,1,1,2,1
KR_6759917890,420,-3,-66,8,-4,-2,1,3,3,5,2,-2,0,2,-3,1,4,0,0,0,0,-3,-2,-1,6,5,7,0,-2,-1,1,-1,-1,6,1
KR_6699512222,420,4,49,4,9,-3,2,5,4,4,0,3,5,2,4,6,2,1,1,0,0,7,3,3,4,7,0,0,2,1,1,1,1,6,1
KR_6435606367,420,3,-8,-17,1,-1,3,4,0,3,3,3,4,1,0,1,1,-1,2,3,0,0,-2,3,3,6,3,0,1,1,-1,1,1,5,1
KR_6147005590,420,0,-16,-25,10,6,7,1,-3,5,8,3,3,0,3,5,2,1,2,1,1,8,36,4,4,8,0,0,2,1,1,1,1,5,1
KR_6764360849,420,0,-79,-8,8,-4,1,5,1,4,3,2,2,0,4,4,0,5,5,0,0,17,-168,5,3,8,-2,0,0,1,1,-1,1,5,1
KR_6742049622,420,2,18,-1,0,1,2,1,1,4,3,-4,1,5,2,2,0,0,1,1,0,2,-121,-2,6,4,4,0,1,1,-1,1,-1,1,1
KR_6741458048,420,2,47,-11,-1,-4,1,5,0,3,3,0,4,4,3,7,4,0,1,1,-1,4,324,-4,7,3,-1,0,0,1,1,1,-1,6,1
KR_6745929033,420,0,54,-15,4,4,4,0,2,5,3,-4,0,4,3,6,3,-1,1,2,0,2,-4,5,4,9,-1,0,0,1,1,0,1,2,1
KR_6729783626,420,4,80,17,14,0,1,1,3,4,1,8,11,3,1,3,2,2,3,1,0,11,5,1,3,4,4,0,1,1,-1,1,1,1,1
KR_6674912571,420,1,53,-9,4,2,3,1,-1,2,3,-2,0,2,5,5,0,0,0,0,0,10,-4,0,5,5,6,0,0,1,-1,0,1,2,1
KR_6672667899,440,1,37,5,-1,-1,3,4,-6,2,8,8,8,0,-2,0,2,0,5,5,1,-3,5,5,2,7,2,0,0,-1,0,0,1,2,1
KR_6738219185,440,0,-5,44,5,0,1,1,6,6,0,0,2,2,5,5,0,-6,0,6,0,18,-3,-4,7,3,0,0,1,1,1,1,1,3,1
KR_6609241757,420,2,34,1,6,4,4,0,-1,4,5,1,3,2,1,5,4,1,1,0,0,7,-3,-2,7,5,1,0,0,1,-1,0,1,6,1
KR_6769300915,420,1,40,11,6,0,1,1,4,5,1,2,2,0,0,1,1,0,0,0,0,4,3,7,2,9,1,0,1,1,1,1,1,1,1
KR_6747860764,420,3,8,15,10,3,4,1,4,6,2,3,3,0,0,2,2,0,1,1,2,9,13,7,1,8,1,0,1,1,1,1,1,3,1
KR_6656884519,420,2,-16,29,2,-4,0,4,4,6,2,3,6,3,-1,3,4,0,1,1,-3,-2,39,-1,5,4,2,0,0,-1,0,0,1,6,1
KR_6648747306,420,1,31,-12,3,0,1,1,0,3,3,3,4,1,-1,2,3,1,2,1,0,-2,-179,-3,8,5,0,0,0,-1,1,1,1,6,1
KR_6737713061,420,1,-31,-19,7,2,3,1,3,5,2,3,4,1,0,7,7,-1,1,2,1,8,-121,0,6,6,-3,0,0,0,-1,0,1,0,1
KR_6673580386,420,-3,-19,-5,-2,0,1,1,-1,2,3,2,3,1,-3,0,3,0,0,0,0,-7,4,4,5,9,-3,0,1,1,1,-1,1,5,1
KR_6763735488,440,-1,-19,-20,5,-2,0,2,7,7,0,-1,4,5,1,2,1,0,0,0,0,3,-16,-1,4,3,2,0,1,-1,1,1,1,2,1
KR_6714475658,420,6,24,26,10,1,1,0,2,3,1,2,2,0,6,6,0,-1,0,1,0,11,9,1,8,9,5,0,1,-1,1,1,1,6,1
KR_6749374321,440,1,68,-16,-1,3,3,0,-8,1,9,1,2,1,3,4,1,0,3,3,0,1,5,1,3,4,-2,0,0,-1,1,-1,-1,3,1
KR_6762858263,420,3,51,28,4,-2,0,2,2,5,3,1,3,2,2,4,2,1,1,0,0,5,-2,-6,12,6,0,0,1,1,1,1,1,4,1
KR_6591640703,420,0,15,-20,8,3,5,2,3,5,2,3,3,0,-2,3,5,1,1,0,0,8,2,-1,6,5,1,0,1,-1,1,1,1,4,1
KR_6758075436,420,-1,-8,-8,0,-2,1,3,2,4,2,2,3,1,0,1,1,-2,1,3,0,4,12,2,5,7,1,0,1,1,-1,1,-1,3,1
KR_6751598937,420,5,73,14,8,3,4,1,6,8,2,3,6,3,-4,0,4,0,1,1,1,8,-5,0,7,7,0,0,0,1,-1,-1,-1,5,1
KR_6766102817,420,4,18,13,16,1,4,3,4,5,1,-2,0,2,12,13,1,1,1,0,1,22,4,1,4,5,1,0,1,1,1,1,1,1,1
KR_6767248968,420,1,-18,6,5,3,3,0,3,5,2,-2,1,3,1,3,2,0,1,1,0,2,28,-2,8,6,9,0,1,1,1,1,1,1,1
KR_6770811487,420,3,35,-2,7,2,2,0,0,4,4,6,7,1,2,5,3,-3,0,3,0,11,5,2,5,7,-6,0,2,-1,1,1,1,2,1
KR_6556101627,420,3,36,22,11,2,3,1,3,4,1,1,2,1,0,3,3,5,5,0,0,10,4,1,5,6,-1,0,0,1,-1,1,1,6,1
KR_6768025606,420,0,-3,18,10,4,4,0,7,7,0,0,3,3,-2,0,2,1,1,0,0,16,15,0,3,3,1,0,0,0,-1,0,1,0,1
KR_6770178494,420,1,83,-45,6,3,4,1,0,3,3,1,2,1,-1,4,5,3,4,1,0,9,10,6,2,8,-3,0,0,1,-1,-1,-1,6,1
KR_6725090472,420,2,34,-34,8,-1,1,2,2,4,2,5,6,1,1,3,2,1,2,1,0,15,4,9,1,10,4,0,2,-1,1,1,1,4,1
KR_6771437173,420,7,36,-2,22,2,3,1,5,8,3,9,10,1,5,5,0,1,2,1,0,19,250,4,3,7,-7,0,1,1,1,1,1,5,1
KR_6744827224,420,5,96,0,17,2,2,0,1,4,3,0,4,4,12,13,1,2,2,0,0,21,6,4,3,7,4,0,1,1,-1,1,1,2,1
KR_6723919162,420,2,41,-16,7,2,3,1,-1,3,4,2,5,3,3,3,0,1,2,1,0,6,0,-2,7,5,2,0,1,1,-1,1,1,2,1
KR_6722485900,440,1,15,8,2,2,3,1,2,7,5,-3,3,6,1,2,1,0,0,0,0,1,5,-4,4,0,0,0,0,-1,1,1,-1,1,1
KR_6748177151,420,5,72,-11,4,11,11,0,-3,1,4,-2,0,2,1,3,2,-3,1,4,0,-1,-5,0,4,4,2,0,1,-1,0,-1,-1,1,1
KR_6706257974,420,5,28,50,15,4,4,0,-1,3,4,9,10,1,3,5,2,0,0,0,0,8,-116,-3,5,2,2,0,1,1,1,1,1,1,1
KR_6615408967,420,2,53,-13,1,3,4,1,0,2,2,0,0,0,-2,1,3,0,0,0,0,-1,53,1,3,4,-2,0,1,-1,-1,1,1,6,1
KR_6744253377,420,4,30,12,11,6,6,0,2,4,2,1,2,1,2,5,3,0,0,0,0,14,9,-1,9,8,2,0,1,1,-1,1,-1,6,1
KR_6716000915,420,-2,-25,24,3,-3,0,3,5,6,1,-3,1,4,4,4,0,0,0,0,1,6,5,3,1,4,-2,0,0,-1,1,1,1,1,1
KR_6767255060,420,1,44,4,3,1,3,2,0,3,3,3,5,2,-1,0,1,0,1,1,0,0,1,-7,11,4,1,0,1,-1,1,1,-1,4,1
KR_6736601030,420,0,9,8,-5,0,1,1,-1,2,3,-5,0,5,3,3,0,-2,1,3,0,-13,-17,0,6,6,-2,0,0,0,0,1,-1,0,1
KR_6661524406,420,1,-25,11,6,1,3,2,0,2,2,1,3,2,2,4,2,2,4,2,0,3,3,3,3,6,-2,0,0,-1,1,-1,1,3,1
KR_6766030009,420,1,29,-8,0,-1,0,1,-1,1,2,0,3,3,6,8,2,-4,0,4,0,-2,-31,-1,4,3,37,0,1,-1,1,1,-1,3,1
KR_6722563740,420,-4,8,-6,-5,1,3,2,-3,1,4,-6,1,7,2,2,0,1,1,0,0,-5,2,2,4,6,0,0,0,-1,0,0,1,4,1
KR_6680578099,420,-4,-11,-20,-6,-6,0,6,-2,2,4,-2,1,3,2,3,1,2,2,0,0,-7,-6,-7,8,1,4,0,0,1,-1,-1,-1,1,1
KR_6757002460,420,-1,-20,4,-5,0,3,3,-2,3,5,-4,0,4,-1,1,2,2,2,0,0,-2,-27,0,6,6,13,0,0,-1,1,0,1,5,1
KR_6737481563,420,1,-49,-4,10,1,3,2,2,3,1,4,8,4,2,2,0,1,2,1,1,1,6,1,6,7,1,0,0,-1,1,1,1,6,1
KR_6747182013,420,-1,19,-12,-5,2,3,1,5,7,2,-2,1,3,-7,1,8,-3,0,3,0,-6,1,-4,6,2,3,0,-1,-1,0,-1,-1,3,1
KR_6759556962,440,7,139,11,15,6,6,0,3,4,1,-4,2,6,3,5,2,7,7,0,0,10,5,3,4,7,-1,0,5,1,1,1,1,3,1
KR_6744277319,420,4,62,36,2,1,1,0,2,5,3,4,6,2,-3,0,3,-2,1,3,0,-1,-117,0,4,4,-3,0,0,1,1,0,-1,2,1
KR_6737687738,420,-1,-30,-18,5,2,3,1,6,9,3,-4,1,5,3,4,1,-2,0,2,0,-2,-24,-7,8,1,0,0,0,0,0,0,-1,0,1
KR_6766303702,420,2,-11,27,3,0,2,2,1,2,1,0,1,1,2,3,1,0,0,0,0,7,-133,0,6,6,-1,0,1,0,-1,1,-1,0,1
KR_6543287140,420,0,64,-7,-1,2,4,2,-1,1,2,3,4,1,-5,3,8,0,0,0,0,-4,1,2,5,7,0,0,0,-1,1,1,1,4,1
KR_6757997195,420,4,27,-8,6,0,0,0,1,4,3,1,2,1,3,4,1,1,1,0,0,8,-3,-4,7,3,1,0,0,1,-1,0,1,5,1
KR_6695861492,420,4,13,8,9,5,5,0,0,4,4,-1,2,3,4,7,3,1,3,2,0,1,-5,0,8,8,-3,0,0,-1,-1,0,1,6,1
KR_6735762745,420,2,-31,5,5,1,1,0,4,5,1,2,4,2,-4,0,4,2,2,0,0,8,-3,0,2,2,5,0,0,1,0,0,-1,2,1
KR_6715698666,420,-1,38,-40,-1,-2,1,3,0,4,4,2,3,1,1,2,1,-2,1,3,0,-1,57,-2,4,2,-15,0,0,0,-1,1,1,0,1
KR_6647773684,420,-2,8,-3,4,7,7,0,0,3,3,1,3,2,-3,1,4,-1,1,2,0,-2,8,2,3,5,0,0,-1,-1,1,-1,1,4,1
KR_6765747287,420,5,26,-1,7,3,3,0,-3,1,4,1,3,2,3,7,4,3,3,0,0,7,8,2,2,4,-4,0,1,1,1,1,1,5,1
KR_6761780114,420,2,-12,24,8,3,5,2,7,8,1,1,3,2,-4,3,7,1,2,1,2,8,-504,-2,5,3,-6,0,0,-1,0,0,-1,3,1
KR_6759901138,440,3,40,-5,1,-2,1,3,1,3,2,2,2,0,-1,1,2,1,3,2,0,-1,0,-1,4,3,-1,0,1,1,1,1,-1,1,1
KR_6757617967,420,5,3,20,11,3,3,0,2,3,1,2,2,0,2,5,3,2,3,1,0,10,2,1,5,6,3,0,1,1,-1,1,-1,2,1
KR_6769669153,440,-1,-20,4,1,0,0,0,-4,1,5,5,6,1,0,2,2,0,1,1,0,-6,5,-1,5,4,1,0,1,0,1,1,1,0,1
KR_6733503568,420,3,-15,16,10,5,5,0,3,7,4,0,1,1,2,5,3,0,0,0,0,9,4,-2,6,4,0,0,1,1,-1,1,1,3,1
KR_6768262417,420,3,53,-24,13,0,4,4,6,8,2,1,2,1,7,8,1,-1,0,1,1,17,4,5,2,7,1,0,2,-1,1,1,1,1,1
KR_6764267522,440,1,21,10,0,-1,2,3,-1,1,2,4,6,2,-1,4,5,-1,0,1,0,-6,-37,1,5,6,4,0,-1,1,-1,-1,1,5,1
KR_6711730454,440,2,-16,1,3,1,3,2,-1,6,7,0,2,2,2,4,2,1,1,0,0,1,-4,-8,9,1,0,0,1,1,1,1,-1,6,1
KR_6768807649,420,-2,-37,-36,-1,7,7,0,-2,2,4,-3,0,3,-2,1,3,-1,0,1,0,-12,119,3,2,5,1,0,-1,1,1,1,-1,5,1
KR_6759835810,420,2,6,-17,0,-5,2,7,0,2,2,0,2,2,3,4,1,2,3,1,-1,-1,-24,1,4,5,4,0,0,1,-1,0,-1,4,1
KR_6668518944,420,-3,-28,-12,-14,-3,1,4,-6,0,6,1,2,1,-4,0,4,-2,1,3,-1,-18,-25,-3,7,4,-2,0,0,0,-1,0,-1,0,1
KR_6768921818,420,0,35,-16,-1,-2,0,2,4,6,2,-6,2,8,1,1,0,2,2,0,0,-1,-28,-6,9,3,10,0,-1,-1,-1,-1,1,5,1
KR_6645130540,420,1,25,1,2,3,4,1,3,3,0,-4,0,4,0,4,4,0,0,0,0,4,31,5,4,9,0,0,1,-1,-1,1,-1,4,1
KR_6748673908,420,4,16,12,15,-2,2,4,5,5,0,13,14,1,2,4,2,-3,0,3,1,11,-286,1,4,5,2,0,1,-1,1,1,1,5,1
KR_6744204764,420,2,59,11,9,2,2,0,0,2,2,1,4,3,6,7,1,0,0,0,0,13,0,0,6,6,1,0,2,1,1,1,1,4,1
KR_6662566979,420,2,-16,-5,2,-3,0,3,2,6,4,4,7,3,-1,1,2,0,1,1,0,7,-8,1,3,4,3,0,1,-1,-1,1,1,4,1
KR_6707576507,420,3,29,20,13,4,4,0,-1,2,3,7,7,0,2,4,2,1,2,1,0,10,-3,-7,9,2,0,0,1,1,1,1,1,5,1
KR_6728627049,420,5,11,17,8,-1,1,2,9,9,0,1,2,1,-1,1,2,0,0,0,0,6,-1,3,2,5,-3,0,0,1,0,1,-1,2,1
KR_6687010980,420,1,13,-73,5,3,3,0,-1,1,2,4,5,1,3,5,2,-4,1,5,0,11,-2,5,4,9,2,0,1,1,-1,1,-1,5,1
KR_6762082204,420,1,13,32,1,1,3,2,-2,3,5,1,7,6,1,4,3,0,1,1,1,-3,-13,3,3,6,-2,0,1,0,1,1,1,0,1
KR_6747157452,420,-2,15,-35,5,-2,1,3,1,3,2,2,3,1,4,4,0,0,0,0,0,8,10,4,4,8,1,0,0,1,1,0,1,3,1
KR_6752680003,420,6,52,8,14,5,5,0,3,4,1,3,4,1,3,3,0,0,1,1,1,12,14,7,0,7,4,0,2,1,1,1,1,1,1
KR_6501213760,420,6,73,29,12,1,2,1,5,7,2,3,4,1,-1,4,5,4,4,0,0,3,-9,5,6,11,-2,0,1,1,1,1,1,5,1
KR_6761393964,420,0,-3,3,4,-1,0,1,1,3,2,4,5,1,-1,0,1,1,1,0,0,8,-119,-4,8,4,4,0,-1,1,1,-1,1,5,1
KR_6485591663,420,2,-20,-19,-3,-1,3,4,0,3,3,-4,2,6,1,4,3,1,1,0,-1,-6,5,-4,6,2,3,0,0,1,-1,0,-1,3,1
KR_6767943534,420,3,58,32,3,0,0,0,3,4,1,3,4,1,-1,3,4,-2,1,3,0,-1,33,3,4,7,1,0,0,1,1,0,1,5,1
KR_6745621633,420,-2,-11,15,-2,1,2,1,6,7,1,0,1,1,-6,4,10,-3,0,3,-1,-10,5,5,4,9,5,0,1,1,1,1,-1,2,1
KR_6588014760,420,2,61,23,-2,-2,0,2,2,3,1,-2,2,4,0,4,4,0,1,1,0,0,-120,1,2,3,0,0,1,1,1,1,1,4,1
KR_6743125464,420,1,99,-51,9,3,3,0,-3,4,7,0,2,2,6,6,0,3,3,0,0,9,-94,6,0,6,2,0,1,1,1,1,1,4,1
KR_6739917911,420,5,47,12,9,1,1,0,2,4,2,3,7,4,4,6,2,-1,0,1,0,16,-6,3,4,7,9,0,-1,1,-1,-1,-1,4,1
KR_6769747862,420,-3,-40,8,-4,-2,1,3,-1,2,3,-1,2,3,0,3,3,0,1,1,0,-3,-22,-2,6,4,-1,0,0,1,0,0,1,2,1
KR_6770177996,440,0,9,-3,-2,5,5,0,0,4,4,-2,1,3,3,7,4,-8,1,9,-2,-6,3,2,4,6,-3,0,1,0,1,1,-1,0,1
KR_6767923145,420,4,42,21,3,0,0,0,-3,3,6,3,5,2,2,4,2,1,2,1,0,-3,-2,3,6,9,5,0,0,1,1,0,-1,5,1
KR_6735341650,420,-4,-22,-19,-7,0,2,2,3,6,3,-4,0,4,-4,0,4,-2,2,4,-2,-10,-14,-1,6,5,6,0,0,1,1,1,-1,3,1
KR_6743061277,420,3,44,-12,6,1,2,1,5,5,0,1,2,1,1,5,4,-2,1,3,0,1,5,3,3,6,2,0,1,-1,0,1,1,5,1
KR_6637392538,420,2,11,-4,6,1,2,1,-1,2,3,1,3,2,4,4,0,1,1,0,0,12,-36,3,5,8,22,0,1,1,1,1,1,5,1
KR_6769829280,420,2,26,-12,8,5,5,0,3,4,1,-1,3,4,1,2,1,0,1,1,1,6,1,3,3,6,-2,0,1,1,1,1,1,2,1
KR_6748973168,440,1,42,8,8,-2,3,5,3,5,2,3,9,6,-3,0,3,7,8,1,1,7,3,-4,8,4,1,0,2,1,-1,1,-1,3,1
KR_6729405580,420,-3,-48,-19,-4,5,5,0,1,2,1,0,2,2,-7,0,7,-3,0,3,0,-4,4,1,4,5,1,0,-1,1,-1,-1,-1,5,1
KR_6737374708,420,6,99,23,13,1,4,3,0,1,1,4,4,0,6,6,0,2,2,0,0,14,15,3,5,8,0,0,3,1,1,1,1,4,1
KR_6769391789,420,0,17,4,-3,0,1,1,3,4,1,2,4,2,-5,0,5,-3,0,3,0,-5,4,2,5,7,0,0,0,-1,1,0,1,2,1
KR_6605506500,440,3,68,30,11,-1,0,1,3,5,2,3,3,0,4,6,2,2,3,1,0,7,65,-1,3,2,-14,0,2,1,1,1,1,2,1
KR_6726410780,440,1,51,-30,9,-3,4,7,4,4,0,8,9,1,0,1,1,0,0,0,0,2,2,3,4,7,3,0,1,-1,-1,1,-1,6,1
KR_6745335299,420,8,140,25,25,7,8,1,3,4,1,4,4,0,9,9,0,2,2,0,1,20,-3,5,1,6,0,0,2,1,1,1,1,6,1
KR_6759078838,420,0,58,-1,-1,1,2,1,-2,0,2,-1,2,3,1,1,0,0,1,1,0,-4,0,1,5,6,2,0,-1,1,-1,-1,-1,3,1
KR_6768210972,420,0,-28,-23,-2,-2,3,5,6,6,0,-2,3,5,-1,3,4,-3,0,3,0,4,31,1,5,6,5,0,-1,1,-1,-1,1,6,1
KR_6761389196,440,2,72,-12,3,1,2,1,-1,1,2,-2,0,2,-3,0,3,8,8,0,0,3,-20,2,5,7,1,0,1,-1,1,1,-1,1,1
KR_6732646453,420,3,-12,16,8,0,0,0,11,13,2,0,2,2,-2,1,3,-1,0,1,0,13,42,5,3,8,-14,0,0,1,1,1,-1,1,1
KR_6724392180,420,5,37,29,6,0,2,2,3,7,4,3,4,1,1,1,0,-1,0,1,-2,5,-1,1,4,5,0,0,1,1,1,1,-1,3,1
KR_6691208900,420,0,-18,-3,4,-2,0,2,-5,1,6,6,9,3,3,4,1,2,3,1,2,9,118,3,5,8,5,0,0,1,-1,0,-1,1,1
KR_6768652255,420,4,35,15,1,0,1,1,-1,2,3,3,3,0,1,3,2,-2,1,3,0,3,-4,-3,6,3,1,0,0,1,1,0,-1,5,1
KR_6723950334,440,5,52,-13,13,1,1,0,1,6,5,-3,2,5,11,11,0,3,3,0,2,24,13,-3,7,4,2,0,0,1,0,1,1,5,1
KR_6766052423,420,2,24,20,7,-1,1,2,0,3,3,0,2,2,8,8,0,0,1,1,1,17,194,0,3,3,3,0,1,1,-1,1,1,5,1
KR_6645508144,420,3,76,4,11,3,3,0,-2,4,6,3,5,2,5,6,1,2,2,0,2,14,16,9,2,11,0,0,2,1,1,1,1,1,1
KR_6770076983,440,4,138,29,6,0,2,2,1,2,1,3,3,0,2,5,3,0,1,1,-1,6,5,0,2,2,-1,0,0,1,0,1,-1,5,1
KR_6418661182,420,0,-45,-3,9,1,1,0,4,6,2,4,5,1,-1,3,4,1,3,2,2,16,3,0,5,5,3,0,2,1,1,1,1,2,1
KR_6767390484,420,0,27,-9,9,-1,2,3,2,2,0,0,6,6,6,6,0,2,3,1,1,18,0,-3,8,5,-3,0,2,-1,1,1,1,4,1
KR_6764457821,420,4,58,72,6,-2,0,2,4,6,2,4,5,1,-1,1,2,1,1,0,0,4,3,1,5,6,-3,0,1,1,-1,1,-1,4,1
KR_6751600231,420,2,-33,5,2,1,2,1,-1,2,3,2,4,2,0,1,1,0,2,2,0,3,-15,3,4,7,-3,0,0,1,0,0,-1,1,1
KR_6767493466,420,3,29,20,7,4,4,0,3,4,1,-3,2,5,4,6,2,-1,0,1,0,8,-62,5,5,10,31,0,1,1,-1,1,1,3,1
KR_6694706532,440,4,61,8,11,2,3,1,2,3,1,1,3,2,7,11,4,-1,1,2,0,13,1,3,5,8,4,0,1,-1,1,1,1,4,1
KR_6765457758,440,3,-16,16,7,2,3,1,0,2,2,8,8,0,0,2,2,-3,1,4,0,2,-7,-2,4,2,-4,0,2,-1,1,1,-1,2,1
KR_6756535587,440,2,55,-22,14,2,2,0,5,7,2,5,7,2,1,2,1,1,1,0,0,11,-1,2,1,3,3,0,0,1,-1,0,-1,3,1
KR_6713381089,420,-2,5,12,-4,5,6,1,-4,0,4,-1,2,3,-3,1,4,-1,0,1,1,-3,-6,0,8,8,5,0,-1,1,-1,-1,1,6,1
KR_6755693593,420,3,2,16,3,-1,0,1,4,5,1,1,3,2,0,3,3,-1,2,3,0,-3,-84,5,2,7,0,0,0,1,1,0,1,2,1
KR_6752350641,420,-1,24,-3,-10,-4,1,5,-2,3,5,-2,1,3,0,1,1,-2,0,2,0,-6,0,0,3,3,-1,0,0,-1,-1,0,-1,4,1
KR_6634056496,420,2,70,0,8,1,3,2,1,4,3,-2,1,3,5,5,0,3,3,0,0,7,6,-1,5,4,-1,0,1,1,1,1,1,2,1
KR_6771643889,420,1,58,4,0,1,2,1,-4,3,7,-3,0,3,4,5,1,2,3,1,0,-5,3,1,2,3,0,0,0,-1,-1,1,-1,1,1
KR_6760026782,420,-2,-11,-32,-4,3,3,0,2,3,1,-4,0,4,-5,0,5,0,1,1,0,-1,9,4,2,6,0,0,-1,-1,-1,-1,-1,5,1
KR_6713224903,420,3,13,12,7,1,4,3,2,3,1,3,3,0,1,3,2,0,3,3,0,6,-7,0,6,6,3,0,0,1,-1,0,1,3,1
KR_6739443883,420,2,12,0,8,4,4,0,1,4,3,-2,1,3,4,7,3,1,1,0,0,8,253,-4,8,4,4,0,1,1,1,1,1,4,1
KR_6614900713,420,0,-21,-12,4,1,2,1,1,2,1,-1,4,5,2,2,0,1,1,0,0,6,24,2,3,5,-2,0,0,1,-1,0,-1,3,1
KR_6764990998,420,-1,33,-16,5,-3,0,3,7,8,1,1,1,0,1,2,1,-1,0,1,0,12,6,-1,7,6,7,0,0,1,-1,1,-1,3,1
KR_6593624351,420,3,29,24,6,0,0,0,3,4,1,1,2,1,0,5,5,2,2,0,1,-1,8,-2,9,7,-2,0,2,1,-1,1,1,6,1
KR_6724985428,420,0,-1,-17,2,2,2,0,-3,0,3,3,4,1,-2,2,4,2,2,0,1,4,101,-2,8,6,2,0,0,1,1,1,1,5,1
KR_6760003349,420,0,37,4,7,0,2,2,-3,2,5,4,7,3,6,6,0,0,1,1,0,8,16,1,5,6,3,0,1,-1,1,1,1,5,1
KR_6650556537,440,-1,-48,62,-3,-2,2,4,-4,1,5,-2,2,4,4,6,2,1,1,0,2,1,2,1,7,8,0,0,1,-1,1,1,1,5,1
KR_6762575610,420,4,98,24,6,-2,2,4,2,3,1,6,6,0,0,1,1,0,0,0,1,2,-9,1,3,4,-3,0,1,1,1,1,1,4,1
KR_6713741177,420,4,-42,28,5,-1,4,5,3,5,2,4,5,1,2,6,4,-3,1,4,0,4,0,-2,7,5,2,0,2,1,1,1,-1,6,1
KR_6749563639,420,-2,14,20,-2,-1,1,2,-3,1,4,-2,0,2,1,5,4,3,3,0,0,3,6,6,5,11,6,0,-1,1,-1,-1,1,6,1
KR_6767522294,420,1,0,12,4,1,1,0,1,2,1,1,2,1,2,2,0,-1,1,2,0,3,-10,-1,7,6,10,0,0,1,0,0,1,2,1
KR_6769919567,420,-2,-3,-4,2,-4,1,5,3,4,1,-2,2,4,0,0,0,5,5,0,0,2,10,5,3,8,-1,0,1,-1,1,1,-1,4,1
KR_6770695651,420,0,-21,-3,-6,4,5,1,-4,0,4,-2,0,2,-3,3,6,-1,0,1,-1,-9,21,-3,8,5,-2,0,-1,-1,-1,-1,-1,5,1
KR_6770169088,440,3,-27,38,12,0,0,0,8,9,1,4,5,1,0,5,5,0,0,0,0,11,-13,2,2,4,3,0,1,-1,1,1,1,6,1
KR_6771317183,420,7,27,20,12,2,3,1,2,5,3,7,9,2,1,4,3,0,2,2,0,6,9,3,2,5,-1,0,2,1,1,1,1,3,1
KR_6690934782,420,2,42,-22,6,2,3,1,3,3,0,2,2,0,-1,2,3,0,0,0,0,9,-3,2,2,4,-1,0,0,1,1,-1,1,3,1
KR_6771885787,420,1,70,21,-4,-1,1,2,1,4,3,1,4,3,-1,2,3,-4,1,5,1,-12,-14,-2,7,5,0,0,1,1,-1,1,1,3,1
KR_6725332403,420,0,10,4,4,5,6,1,0,4,4,-3,0,3,5,7,2,-3,2,5,-1,1,-236,7,4,11,1,0,1,1,1,1,-1,3,1
KR_6768531340,420,0,-69,-11,13,1,1,0,6,7,1,1,3,2,3,4,1,2,4,2,0,20,-1,0,4,4,1,0,-2,-1,1,-1,1,5,1
KR_6629901227,420,1,2,-12,4,-1,0,1,-1,3,4,-3,3,6,4,9,5,5,5,0,2,2,-13,1,6,7,2,0,2,1,1,1,1,1,1
KR_6640645113,420,5,1,31,13,10,10,0,1,4,3,1,2,1,-1,3,4,2,2,0,0,18,103,-2,7,5,1,0,3,-1,1,1,1,5,1
KR_6057293470,440,4,-4,-5,7,1,4,3,2,3,1,0,1,1,3,5,2,1,1,0,0,10,1,1,4,5,3,0,0,-1,0,0,-1,4,1
KR_6763490837,420,0,-11,16,1,2,2,0,3,6,3,-1,1,2,-4,1,5,1,1,0,0,-3,2,2,3,5,2,0,1,1,1,1,-1,5,1
KR_6651722722,420,0,-16,2,2,2,4,2,2,3,1,3,4,1,-3,0,3,-2,0,2,0,-7,4,3,3,6,-5,0,1,-1,1,1,-1,3,1
KR_6687446909,420,3,118,4,-7,-1,0,1,-1,2,3,-2,0,2,-2,4,6,-1,1,2,-1,-21,64,1,3,4,4,0,1,-1,1,1,-1,2,1
KR_6633665955,420,-1,25,6,-9,-2,0,2,-1,4,5,-3,2,5,-3,3,6,0,0,0,0,-5,-143,0,4,4,0,0,-1,-1,-1,-1,-1,1,1
KR_6764921891,420,3,14,14,4,-1,1,2,0,3,3,-1,2,3,4,5,1,2,2,0,0,-1,39,3,5,8,1,0,1,1,1,1,-1,4,1
KR_6756875267,440,2,20,0,4,0,0,0,2,2,0,7,7,0,-3,1,4,-2,0,2,0,3,7,7,5,12,-3,0,1,1,1,1,1,2,1
KR_6768322602,420,3,1,50,4,0,1,1,0,2,2,-5,1,6,4,4,0,5,5,0,0,2,-16,-1,4,3,1,0,1,-1,-1,1,1,2,1
KR_6739093071,420,3,57,4,7,-2,1,3,5,6,1,3,4,1,2,3,1,-1,1,2,0,10,-94,1,1,2,4,0,-1,1,-1,-1,-1,2,1
KR_6771499414,420,0,15,0,15,6,8,2,1,1,0,2,2,0,6,7,1,0,0,0,0,17,5,3,3,6,-2,0,2,1,1,1,1,2,1
KR_6729777246,440,5,132,37,8,0,1,1,0,4,4,2,3,1,4,4,0,2,2,0,1,7,37,0,4,4,1,0,2,1,1,1,1,2,1
KR_5979535697,440,-2,-19,-17,-2,2,6,4,1,2,1,-1,1,2,-1,6,7,-3,0,3,0,-4,-6,-2,6,4,-1,0,0,1,0,0,-1,1,1
KR_6643227572,420,4,71,24,6,2,5,3,1,2,1,1,1,0,1,6,5,1,2,1,0,5,14,-4,6,2,2,0,2,1,1,1,1,1,1
KR_6768698586,440,1,4,19,5,2,2,0,6,7,1,-1,0,1,0,2,2,-2,0,2,0,7,24,1,1,2,26,0,0,-1,1,0,-1,5,1
KR_6703722716,420,1,47,-8,10,1,1,0,2,3,1,3,4,1,1,4,3,3,4,1,1,13,8,6,2,8,-1,0,1,1,1,1,1,6,1
KR_6723956790,420,5,122,1,7,0,2,2,1,3,2,1,4,3,4,5,1,1,1,0,0,9,-7,0,6,6,5,0,1,1,1,1,1,6,1
KR_6755416542,440,3,57,8,1,1,1,0,0,1,1,-1,0,1,1,1,0,0,0,0,0,1,9,-2,5,3,1,0,-1,1,-1,-1,-1,1,1
KR_6755580086,420,-2,-35,-9,-4,-1,1,2,6,7,1,0,2,2,-3,2,5,-6,0,6,0,3,24,1,5,6,-2,0,0,1,-1,-1,1,3,1
KR_6743111545,440,3,53,-11,9,5,6,1,2,2,0,1,8,7,-1,2,3,2,3,1,0,7,1,2,9,11,-7,0,2,1,1,1,-1,1,1
KR_6750043386,420,-3,-88,-24,-5,-1,0,1,1,5,4,-8,5,13,1,4,3,2,2,0,0,-10,250,0,7,7,-1,0,-1,-1,1,-1,-1,1,1
KR_6762523635,420,6,105,36,10,-1,2,3,1,1,0,2,4,2,6,6,0,2,3,1,0,13,9,0,5,5,-3,0,3,1,1,1,1,3,1
KR_6722938865,420,4,35,-14,18,1,2,1,8,9,1,5,6,1,4,4,0,0,5,5,0,8,-29,5,1,6,-5,0,3,1,1,1,1,3,1
KR_5565929711,420,4,69,-39,9,3,4,1,2,6,4,2,4,2,1,3,2,1,2,1,0,0,22,0,5,5,-2,0,1,-1,-1,1,-1,3,1
KR_6771890468,420,6,-7,-8,12,0,2,2,-1,4,5,14,14,0,3,3,0,-4,0,4,0,13,0,-4,9,5,3,0,0,1,1,-1,-1,1,1
KR_6653234423,420,-1,-23,4,0,-1,1,2,2,4,2,0,1,1,-1,2,3,0,2,2,0,2,6,2,5,7,1,0,-1,1,-1,-1,-1,4,1
KR_6736545277,420,2,-51,-19,3,0,1,1,2,4,2,-1,2,3,2,2,0,0,1,1,0,3,1,2,3,5,-2,0,0,1,1,0,1,5,1
KR_6538522620,420,-1,17,30,1,1,3,2,0,1,1,-1,2,3,0,3,3,1,2,1,0,-4,-8,-2,6,4,1,0,-2,-1,1,-1,1,1,1
KR_6739383588,420,3,28,24,5,-1,0,1,0,2,2,-3,0,3,7,8,1,2,3,1,-1,0,4,2,4,6,-4,0,1,1,-1,1,-1,3,1
KR_6734200874,420,-3,27,-25,-7,0,2,2,-2,2,4,-4,1,5,-1,3,4,0,0,0,0,-11,0,1,5,6,0,0,0,-1,-1,0,-1,1,1
KR_6764478274,420,-2,-40,-16,-4,3,4,1,-4,3,7,-3,3,6,1,2,1,-1,0,1,0,-1,3,2,2,4,1,0,0,-1,-1,-1,-1,6,1
KR_6706657122,420,2,7,7,3,2,4,2,0,5,5,2,5,3,-3,4,7,2,2,0,0,1,44,3,4,7,-12,0,1,-1,1,1,1,2,1
KR_6451781582,420,2,-15,-4,2,-2,0,2,0,4,4,2,5,3,2,3,1,0,2,2,0,13,2,0,6,6,0,0,1,1,-1,-1,1,2,1
KR_6660861246,420,3,61,-4,4,2,2,0,3,4,1,-5,0,5,4,5,1,0,1,1,0,4,3,-3,7,4,3,0,1,1,1,1,1,1,1
KR_6747408320,440,3,21,0,4,-1,1,2,1,6,5,6,8,2,-2,2,4,0,1,1,0,6,80,-9,11,2,4,0,-1,1,-1,-1,1,6,1
KR_6398248445,420,1,-33,10,6,-3,1,4,5,6,1,-1,1,2,2,5,3,3,3,0,0,14,1,5,2,7,2,0,2,-1,-1,1,1,4,1
KR_6771735002,440,-5,-23,-56,-13,-1,0,1,-7,1,8,-2,4,6,-3,2,5,0,1,1,1,-4,-6,1,7,8,3,0,-1,-1,-1,-1,1,5,1
KR_6759360386,440,3,69,-8,0,1,1,0,-2,1,3,0,2,2,-2,3,5,3,5,2,0,-7,-76,1,5,6,-23,0,0,1,-1,0,1,1,1
KR_6766061498,440,1,-22,-20,3,0,1,1,-2,0,2,4,4,0,2,3,1,-1,0,1,0,5,-4,-2,7,5,0,0,0,0,-1,1,1,0,1
KR_6748331095,420,5,48,34,11,3,5,2,11,13,2,3,3,0,-4,1,5,-2,1,3,0,5,5,5,3,8,-1,0,3,1,1,1,-1,1,1
KR_6769353561,420,6,35,16,8,6,6,0,0,2,2,-2,1,3,2,7,5,2,3,1,0,5,-8,-2,6,4,0,0,0,1,1,0,1,5,1
KR_6768311366,420,1,93,8,7,-1,1,2,3,4,1,6,8,2,1,3,2,-2,0,2,0,6,-6,-3,6,3,-1,0,1,-1,0,1,1,3,1
KR_6758352702,420,2,-25,20,6,7,7,0,-1,4,5,0,2,2,1,5,4,-1,1,2,0,9,12,-1,6,5,2,0,1,1,1,1,-1,2,1
KR_6548394214,420,3,57,32,5,2,2,0,-1,4,5,1,1,0,2,5,3,1,1,0,0,-2,1,3,6,9,2,0,1,1,1,1,1,3,1
KR_6769594449,420,0,9,-28,4,5,6,1,3,4,1,1,5,4,-2,1,3,-3,0,3,0,15,25,-3,8,5,5,0,0,1,1,0,1,2,1
KR_6328643027,420,4,41,29,8,2,2,0,-3,1,4,5,6,1,1,3,2,3,3,0,0,5,-47,-1,8,7,41,0,2,1,1,1,1,6,1
KR_6618510646,420,2,125,9,2,-1,2,3,-4,1,5,3,4,1,3,3,0,1,2,1,0,2,16,9,0,9,-3,0,2,1,1,1,1,6,1
KR_6768148295,420,1,-30,-15,3,0,4,4,-1,1,2,-1,1,2,5,8,3,0,1,1,0,6,-6,-1,6,5,13,0,-2,-1,-1,-1,1,4,1
KR_6757225794,420,3,43,-32,12,1,3,2,2,6,4,7,7,0,1,1,0,1,1,0,1,19,-107,-2,6,4,4,0,1,1,-1,1,1,3,1
KR_6763091339,420,2,45,-31,10,1,2,1,5,6,1,5,6,1,-3,0,3,2,2,0,0,4,79,0,3,3,2,0,1,1,-1,1,1,4,1
KR_6694691134,440,0,-23,11,1,0,0,0,0,3,3,0,2,2,0,5,5,1,2,1,0,9,0,1,6,7,2,0,0,-1,1,0,-1,1,1
KR_6711287799,420,3,24,-12,17,2,2,0,4,6,2,3,4,1,2,2,0,6,6,0,0,18,-8,0,6,6,2,0,2,1,1,1,1,6,1
KR_6727542705,420,3,53,33,6,0,1,1,3,5,2,3,4,1,-2,0,2,2,2,0,0,8,-3,1,3,4,2,0,0,1,-1,1,1,6,1
KR_6737218878,420,2,-35,24,4,1,3,2,-2,3,5,0,1,1,5,8,3,0,1,1,0,4,-146,2,4,6,-6,0,-1,1,-1,-1,1,2,1
KR_6635305512,420,-2,-20,17,-5,-7,2,9,0,3,3,-1,2,3,3,3,0,0,1,1,0,5,-7,-5,9,4,-4,0,-1,-1,1,-1,1,6,1
KR_6751296037,440,-1,-43,8,-6,1,1,0,-1,2,3,-3,5,8,-2,3,5,-1,1,2,0,-8,-305,2,4,6,4,0,0,-1,-1,-1,-1,5,1
KR_6763362701,420,2,50,20,5,-4,0,4,1,3,2,1,3,2,4,6,2,3,6,3,0,7,-3,-2,8,6,6,0,1,1,-1,-1,-1,6,1
KR_6634581404,440,1,-34,-28,1,3,5,2,2,4,2,1,2,1,0,2,2,-5,0,5,-1,7,-7,1,3,4,0,0,-1,-1,0,-1,-1,5,1
KR_6767322839,420,1,-7,4,6,-1,2,3,3,4,1,-1,2,3,4,6,2,1,2,1,0,4,-9,4,2,6,3,0,2,-1,1,1,1,2,1
KR_6641044222,420,3,24,-8,7,3,4,1,-3,1,4,1,2,1,-1,3,4,7,7,0,-1,6,-8,-1,4,3,4,0,-1,-1,1,-1,-1,5,1
KR_6763254164,420,-1,4,-2,5,2,3,1,0,4,4,2,5,3,4,5,1,-3,1,4,0,4,-8,2,7,9,3,0,1,1,1,1,1,5,1
KR_6768365884,420,7,89,4,20,2,2,0,9,9,0,3,3,0,5,5,0,1,2,1,0,21,-39,5,0,5,24,0,2,0,1,1,1,0,1
KR_6760439192,420,1,50,-29,6,5,6,1,-1,1,2,0,1,1,2,3,1,0,2,2,0,0,14,3,3,6,-1,0,2,-1,1,1,1,3,1
KR_6745242632,440,-1,1,-4,-7,0,2,2,-2,1,3,0,0,0,-4,3,7,-1,0,1,0,-8,93,-7,8,1,3,0,0,1,-1,0,1,2,1
KR_6749157169,420,5,22,-1,11,2,3,1,5,6,1,5,5,0,-2,3,5,1,1,0,0,7,0,3,4,7,0,0,1,1,-1,1,-1,5,1
KR_6765587138,420,7,124,12,19,5,6,1,2,2,0,3,4,1,6,7,1,3,5,2,0,24,-109,-2,5,3,5,0,2,1,-1,1,1,4,1
KR_6771033541,420,4,42,27,4,3,4,1,-5,2,7,-1,3,4,8,11,3,-1,1,2,0,9,26,-5,9,4,-7,0,0,1,1,1,1,4,1
KR_6691257884,420,2,47,16,7,3,3,0,5,6,1,-3,2,5,4,5,1,-2,1,3,0,11,6,1,7,8,-1,0,0,1,-1,1,-1,2,1
KR_6767846357,420,2,-11,24,2,-3,1,4,3,3,0,-3,1,4,5,6,1,0,0,0,0,2,12,-2,8,6,2,0,0,1,-1,-1,-1,3,1
KR_6619587862,420,-1,-14,-16,8,-4,0,4,7,7,0,0,2,2,3,6,3,2,2,0,0,11,124,-2,9,7,3,0,0,-1,-1,1,1,3,1
KR_6687125401,420,-2,-12,0,-5,0,2,2,-2,2,4,-6,0,6,0,3,3,3,3,0,0,1,-7,1,4,5,-4,0,-2,-1,-1,-1,-1,2,1
KR_6625095582,420,3,41,31,10,-2,1,3,4,4,0,4,4,0,4,5,1,0,0,0,0,8,15,5,4,9,3,0,2,1,1,1,-1,1,1
KR_6563270174,420,5,58,18,11,-3,2,5,8,8,0,1,3,2,3,4,1,2,2,0,0,9,137,-1,5,4,3,0,1,1,1,1,1,2,1
KR_6724334017,420,1,9,28,4,1,4,3,-2,2,4,7,8,1,0,0,0,-2,2,4,0,11,-14,0,5,5,3,0,1,1,1,1,-1,2,1
KR_6552439667,440,-1,9,3,-3,-3,2,5,0,4,4,-1,0,1,0,1,1,1,1,0,0,4,84,-5,7,2,0,0,-1,-1,-1,1,1,1,1
KR_6731413299,420,0,-18,5,-4,-4,0,4,2,3,1,1,3,2,-2,3,5,-1,0,1,0,2,-3,2,5,7,1,0,-1,-1,-1,-1,1,6,1
KR_6746288183,420,1,47,13,3,2,4,2,6,6,0,1,2,1,-4,1,5,-2,0,2,-1,-7,2,5,3,8,-2,0,0,-1,1,1,-1,5,1
KR_6757868355,420,0,26,-8,2,1,2,1,-1,2,3,1,2,1,2,7,5,-1,1,2,0,0,10,-3,8,5,6,0,1,1,1,1,1,5,1
KR_6760781931,420,5,58,28,11,4,4,0,7,8,1,4,5,1,-4,2,6,0,1,1,0,6,-143,0,3,3,2,0,1,1,1,1,1,3,1
KR_6709959387,420,3,29,25,12,1,2,1,2,4,2,8,10,2,-2,1,3,3,3,0,0,1,1,2,4,6,1,0,1,0,0,1,-1,0,1
KR_6757324882,420,0,42,-4,-7,-1,1,2,3,3,0,0,7,7,-7,1,8,-2,1,3,-1,-10,4,2,4,6,1,0,1,-1,1,1,-1,2,1
KR_6664016771,420,1,55,-8,3,3,4,1,3,4,1,-4,0,4,1,3,2,0,0,0,0,12,0,-3,6,3,0,0,-1,1,1,-1,-1,2,1
KR_6750771183,420,0,-28,43,3,0,1,1,-1,3,4,2,4,2,4,5,1,-2,0,2,0,2,-3,-3,6,3,3,0,1,1,0,1,1,4,1
KR_6771317371,420,5,26,36,9,1,2,1,4,5,1,3,4,1,-1,3,4,2,2,0,0,9,227,-2,5,3,0,0,3,1,1,1,1,3,1
KR_6768593260,440,2,80,7,-1,0,1,1,-1,0,1,1,1,0,3,4,1,-4,0,4,0,0,-6,-1,7,6,-3,0,-1,-1,-1,-1,-1,5,1
KR_6768970128,420,0,9,8,-2,-1,1,2,1,1,0,2,4,2,-4,3,7,0,1,1,-1,-5,-13,0,5,5,9,0,0,0,1,0,-1,0,1
KR_6691930448,440,2,52,-4,7,8,11,3,3,4,1,0,1,1,-6,2,8,2,3,1,0,0,13,0,4,4,-1,0,-1,-1,-1,1,1,6,1
KR_6761495214,420,0,37,0,3,-3,1,4,4,4,0,0,2,2,2,2,0,0,0,0,0,4,35,-2,6,4,-15,0,-1,1,-1,-1,1,4,1
KR_6719105984,420,2,16,19,8,-1,1,2,0,2,2,4,4,0,5,7,2,0,1,1,0,14,8,7,2,9,-1,0,0,-1,1,0,1,4,1
KR_6700848290,420,-2,-39,-14,-5,1,1,0,-4,0,4,-2,1,3,-1,0,1,1,1,0,0,-8,3,5,4,9,-5,0,0,-1,-1,-1,-1,6,1
KR_6647873031,420,0,25,-4,-9,-3,0,3,0,7,7,-3,1,4,-1,4,5,-2,0,2,0,-8,-249,-1,6,5,0,0,1,1,1,1,1,5,1
KR_6713982931,420,4,42,23,16,11,11,0,0,2,2,1,3,2,3,5,2,1,1,0,0,8,10,4,5,9,4,0,3,-1,1,1,1,1,1
KR_6653377650,420,1,-58,31,0,1,1,0,-2,1,3,-2,0,2,1,1,0,2,2,0,0,0,104,0,5,5,-4,0,0,1,-1,0,-1,4,1
KR_6738080078,420,2,40,4,8,2,3,1,0,2,2,1,3,2,3,4,1,2,2,0,0,7,15,0,4,4,0,0,0,1,1,0,1,2,1
KR_6731464150,420,3,64,8,-3,1,1,0,-4,1,5,0,3,3,1,8,7,-1,1,2,0,-10,-1,-2,5,3,3,0,1,-1,1,1,1,3,1
KR_6762784645,420,3,48,-32,6,2,2,0,0,3,3,1,3,2,2,6,4,1,1,0,0,4,-57,-2,6,4,40,0,0,-1,1,1,1,2,1
KR_6762037568,420,7,128,12,11,2,3,1,7,8,1,2,4,2,0,2,2,0,0,0,0,9,11,3,2,5,1,0,2,1,-1,1,1,1,1
KR_6770371605,420,3,19,13,7,-2,0,2,2,5,3,4,5,1,6,8,2,-3,1,4,0,16,11,5,2,7,1,0,-1,0,-1,-1,1,0,1
KR_6770903347,420,-1,-6,-4,-2,0,1,1,-5,2,7,-2,1,3,4,4,0,1,1,0,0,-4,20,-4,6,2,-22,0,0,-1,-1,1,1,4,1
KR_6718668902,420,8,121,28,16,5,7,2,0,4,4,5,6,1,7,7,0,-1,0,1,0,3,-111,4,3,7,0,0,0,1,1,1,1,3,1
KR_6718056601,440,0,93,-16,-1,1,3,2,-3,2,5,1,4,3,2,4,2,-2,2,4,0,0,6,9,2,11,-2,0,1,-1,-1,1,-1,3,1
KR_6717256824,420,3,6,14,9,-1,0,1,6,6,0,-1,4,5,5,5,0,0,1,1,0,6,30,2,5,7,4,0,0,1,-1,1,1,2,1
KR_6766584741,420,4,91,33,11,7,7,0,-1,1,2,-1,1,2,3,4,1,3,4,1,0,5,13,-1,7,6,1,0,3,-1,1,1,1,6,1
KR_6670212054,420,3,80,-34,0,-1,0,1,-2,1,3,0,2,2,3,5,2,0,1,1,0,-1,-8,-2,4,2,2,0,0,1,-1,0,1,1,1
KR_6751254186,420,0,9,2,-2,-4,0,4,4,5,1,-1,0,1,0,5,5,-1,0,1,0,3,-28,2,3,5,1,0,0,1,-1,0,1,6,1
KR_6771800058,420,-3,-28,6,-11,-1,1,2,0,2,2,-6,0,6,-3,4,7,-1,0,1,0,-12,8,-1,4,3,0,0,-2,-1,-1,-1,1,5,1
KR_6714185437,420,2,-58,9,1,-2,1,3,1,5,4,1,3,2,0,1,1,1,1,0,-1,1,-1,-7,13,6,4,0,1,1,1,1,-1,3,1
KR_6744770877,420,3,13,8,6,1,3,2,-1,4,5,1,2,1,3,8,5,2,2,0,0,-1,6,0,6,6,0,0,0,1,1,0,-1,3,1
KR_6557478385,420,1,39,-9,7,0,1,1,0,3,3,2,4,2,4,6,2,1,1,0,0,8,5,-2,5,3,-1,0,0,-1,1,1,1,4,1
KR_6650059150,440,0,-53,-8,-5,4,5,1,-3,1,4,0,3,3,-4,3,7,-2,0,2,0,-7,-2,2,3,5,-4,0,0,-1,1,-1,1,3,1
KR_6578328238,420,4,68,15,2,-2,3,5,0,3,3,2,4,2,2,6,4,0,2,2,-1,-3,-13,-7,12,5,6,0,2,1,-1,1,-1,3,1
KR_6730824831,440,5,41,4,5,4,4,0,-3,1,4,-1,2,3,2,2,0,3,4,1,0,-3,10,1,2,3,1,0,1,1,-1,1,1,2,1
KR_6647750811,420,2,1,14,-3,0,3,3,2,4,2,-3,3,6,0,3,3,-2,0,2,0,1,-100,-3,7,4,-1,0,-1,-1,-1,-1,-1,3,1
KR_6351365905,420,-1,12,-15,3,0,2,2,-1,4,5,1,4,3,2,7,5,1,1,0,0,10,-69,1,5,6,-10,0,0,1,1,0,1,3,1
KR_6741879472,440,5,84,-12,13,0,3,3,1,1,0,3,3,0,9,10,1,0,2,2,0,13,-3,-3,8,5,6,0,3,1,-1,1,1,2,1
KR_6767493523,420,3,55,22,5,4,6,2,1,4,3,0,3,3,0,3,3,0,0,0,0,5,5,5,4,9,1,0,3,0,1,1,1,0,1
KR_6713212932,420,3,106,-24,10,4,7,3,0,0,0,2,4,2,1,4,3,3,3,0,0,5,16,4,2,6,-18,0,2,-1,1,1,1,6,1
KR_6696087890,420,4,35,24,5,-2,1,3,2,2,0,0,2,2,4,4,0,1,1,0,0,11,8,6,2,8,-5,0,1,1,1,1,-1,6,1
KR_6137438174,420,-1,18,-13,-2,1,2,1,-5,0,5,0,3,3,2,2,0,0,0,0,0,4,-3,-1,6,5,-1,0,1,-1,1,1,-1,2,1
KR_6768623080,420,2,72,13,1,-2,3,5,0,2,2,1,3,2,0,0,0,2,2,0,0,-9,62,0,3,3,1,0,2,-1,1,1,1,3,1
KR_6466488372,440,1,-48,28,8,2,4,2,8,10,2,-5,0,5,1,8,7,2,4,2,-1,14,-6,2,3,5,2,0,-1,1,0,-1,1,5,1
KR_6696583791,440,5,81,16,8,0,1,1,6,8,2,1,4,3,1,4,3,0,0,0,0,3,9,7,2,9,-1,0,4,1,1,1,1,2,1
KR_6724579540,420,5,106,2,16,4,5,1,2,2,0,4,5,1,4,5,1,2,4,2,0,11,-1,0,6,6,2,0,2,1,1,1,1,6,1
KR_6734535053,420,-4,-67,-20,1,-3,0,3,-1,2,3,0,2,2,4,7,3,1,1,0,0,12,-7,-3,7,4,-3,0,-1,-1,1,-1,-1,3,1
KR_6657556010,420,-1,26,-8,-3,-2,2,4,3,4,1,-1,0,1,-2,6,8,-1,1,2,0,-2,-2,1,6,7,2,0,-1,1,-1,-1,1,5,1
KR_6722646619,440,3,38,-2,4,0,0,0,2,4,2,0,3,3,1,4,3,1,2,1,0,6,-12,4,1,5,5,0,0,0,1,-1,1,0,1
KR_6744457606,420,2,-6,9,2,0,1,1,1,2,1,0,0,0,1,1,0,0,0,0,0,3,-11,2,5,7,-4,0,0,-1,1,0,-1,1,1
KR_6771692797,420,3,12,24,8,-5,1,6,8,9,1,1,2,1,4,6,2,0,0,0,0,16,1,-2,5,3,3,0,0,1,-1,-1,-1,5,1
KR_6708129670,420,-2,11,-5,1,2,3,1,1,2,1,0,3,3,1,2,1,-3,0,3,0,-1,1,0,5,5,4,0,1,-1,1,1,1,2,1
KR_6603990448,420,4,49,14,2,0,2,2,2,5,3,1,1,0,0,1,1,-1,1,2,0,5,24,5,6,11,-8,0,0,1,1,0,1,2,1
KR_6674867638,420,2,32,-9,6,0,1,1,3,5,2,0,4,4,2,2,0,1,2,1,1,7,4,0,8,8,-4,0,-1,1,-1,-1,1,2,1
KR_6495143020,440,5,74,16,9,2,2,0,2,7,5,4,5,1,1,4,3,0,1,1,1,4,4,1,3,4,0,0,1,1,0,1,1,5,1
KR_6764818061,420,2,79,23,1,2,5,3,3,3,0,0,2,2,-5,1,6,1,2,1,0,-2,15,3,1,4,4,0,2,-1,1,1,-1,3,1
KR_6744719117,440,-1,1,24,3,-1,2,3,5,5,0,-1,4,5,1,1,0,-1,1,2,0,6,1,0,4,4,-1,0,0,0,-1,0,1,0,1
KR_6691294790,420,3,55,16,4,0,3,3,5,5,0,0,2,2,-1,3,4,0,3,3,0,4,138,2,5,7,0,0,0,0,-1,0,-1,0,1
KR_6696086429,440,3,25,31,5,0,1,1,5,5,0,3,3,0,-2,1,3,-1,3,4,0,11,0,1,4,5,-1,0,0,-1,-1,1,1,6,1
KR_6763250382,420,-1,-12,-19,1,-1,1,2,1,1,0,2,2,0,-1,1,2,0,1,1,0,-1,-56,3,1,4,17,0,-1,1,1,-1,1,2,1
KR_6764376917,420,0,54,-4,1,-1,0,1,0,4,4,2,3,1,-2,1,3,2,4,2,0,-3,-13,5,3,8,4,0,1,-1,-1,1,1,3,1
KR_6746770814,420,2,-23,14,4,0,0,0,1,2,1,3,6,3,1,5,4,-1,0,1,0,6,4,5,2,7,-3,0,0,-1,-1,0,1,4,1
KR_6771882149,420,5,58,14,7,3,3,0,0,3,3,2,2,0,2,5,3,0,3,3,0,9,-23,1,5,6,-1,0,1,1,-1,-1,1,3,1
KR_6761708799,420,-2,26,-20,-2,5,6,1,-5,2,7,1,4,3,-2,2,4,-1,1,2,0,-12,102,2,4,6,-3,0,0,-1,1,1,1,2,1
KR_6767692925,420,-1,-19,28,-1,6,8,2,1,3,2,2,5,3,-8,0,8,-2,0,2,0,-8,-7,-1,6,5,1,0,1,0,1,1,1,0,1
KR_6771380467,420,2,-21,0,5,-2,0,2,-3,1,4,5,6,1,2,3,1,3,3,0,0,8,-12,3,4,7,6,0,0,-1,-1,0,-1,4,1
KR_6734719341,420,0,-19,-8,5,3,4,1,-2,1,3,3,3,0,0,0,0,1,1,0,0,3,-44,-1,4,3,23,0,0,1,0,0,1,2,1
KR_6750018749,440,2,-10,12,3,-3,0,3,-1,2,3,6,8,2,-1,2,3,2,2,0,0,6,0,-1,6,5,-4,0,1,1,0,1,-1,1,1
KR_6769124203,420,3,70,16,8,2,3,1,2,3,1,0,1,1,0,3,3,4,6,2,0,9,2,1,6,7,12,0,1,1,1,1,1,4,1
KR_6740416143,420,5,69,20,12,3,3,0,0,4,4,6,7,1,1,1,0,2,2,0,0,7,7,0,6,6,1,0,1,1,1,1,1,4,1
KR_6751426560,420,-1,13,-16,-1,3,4,1,-1,1,2,2,5,3,-6,1,7,1,1,0,0,-8,-7,4,3,7,0,0,0,-1,1,0,1,3,1
KR_6760729408,440,2,6,19,2,9,11,2,-2,2,4,0,3,3,-3,0,3,-2,1,3,1,-3,7,1,1,2,-2,0,0,1,1,1,1,4,1
KR_6761408804,420,5,36,20,14,2,5,3,0,1,1,5,8,3,2,3,1,5,5,0,0,11,3,-2,5,3,2,0,2,1,1,1,-1,5,1
KR_6746789221,420,1,62,-10,1,1,5,4,2,2,0,0,2,2,0,2,2,-2,2,4,0,2,6,2,4,6,3,0,1,0,1,1,-1,0,1
KR_6641011124,420,-2,-4,11,-5,0,1,1,3,5,2,-4,1,5,-2,1,3,-2,0,2,0,-8,-5,-3,6,3,-3,0,0,1,1,0,-1,3,1
KR_6768762957,420,4,84,16,4,-1,0,1,2,3,1,2,2,0,2,2,0,-1,2,3,0,6,18,-1,5,4,1,0,1,1,1,1,1,6,1
KR_6676305246,420,1,4,-5,9,-3,0,3,11,11,0,-1,0,1,4,4,0,-2,1,3,0,10,-6,2,4,6,-1,0,2,-1,1,1,1,4,1
KR_6474228090,420,1,-16,24,4,2,5,3,2,4,2,0,3,3,-2,1,3,2,2,0,0,4,12,-2,4,2,-3,0,2,1,1,1,1,1,1
KR_6696171822,440,2,24,-28,7,4,4,0,-2,4,6,5,7,2,-1,1,2,1,3,2,0,8,-5,0,2,2,0,0,0,1,-1,0,1,1,1
KR_6563620840,420,2,-29,6,7,-1,1,2,1,3,2,2,3,1,3,8,5,2,3,1,0,8,-4,-3,7,4,1,0,-1,-1,-1,-1,1,4,1
KR_6724215429,420,4,-15,41,9,3,5,2,3,7,4,4,6,2,-1,0,1,0,1,1,1,10,6,2,6,8,1,0,1,1,1,1,1,1,1
KR_6724857620,420,-2,-44,-21,-5,1,2,1,-9,2,11,5,6,1,1,1,0,-3,1,4,0,-10,15,3,3,6,-4,0,1,-1,1,1,1,3,1
KR_6672823698,440,-1,-40,-2,-4,-3,1,4,0,3,3,1,5,4,0,2,2,-2,3,5,0,5,3,-1,5,4,0,0,-1,0,-1,-1,-1,0,1
KR_6771325694,440,7,124,37,18,6,7,1,1,1,0,5,5,0,5,5,0,1,2,1,0,9,1,6,2,8,4,0,2,1,1,1,-1,5,1
KR_6769180969,420,1,59,7,10,4,5,1,-3,2,5,1,2,1,9,12,3,-1,0,1,2,11,-4,-7,8,1,3,0,1,1,1,1,1,3,1
KR_6717131916,420,2,-7,6,5,-1,4,5,4,4,0,3,4,1,-1,1,2,0,0,0,3,6,2,5,4,9,-3,0,0,1,1,0,-1,4,1
KR_6769800464,420,0,57,19,5,4,5,1,3,6,3,-2,1,3,0,1,1,0,1,1,2,4,-6,-5,6,1,-5,0,-1,1,-1,1,1,6,1
KR_6670138965,420,6,93,-16,5,0,1,1,0,1,1,3,4,1,-1,1,2,3,4,1,0,-2,5,-3,8,5,-5,0,1,-1,-1,1,-1,5,1
KR_6625945582,420,-3,12,0,-2,-4,2,6,-3,3,6,3,4,1,1,2,1,1,1,0,0,7,-6,2,6,8,3,0,-1,1,1,-1,1,4,1
KR_6765679074,440,-1,26,-12,-1,0,1,1,-3,1,4,2,5,3,1,1,0,-1,3,4,0,1,-21,2,3,5,-1,0,0,0,0,0,-1,0,1
KR_6734326469,420,2,34,1,8,6,6,0,-4,1,5,2,2,0,-1,3,4,5,5,0,0,8,-43,1,5,6,17,0,2,-1,1,1,1,1,1
KR_6733645821,420,1,26,-16,9,1,1,0,1,4,3,4,5,1,4,6,2,-1,0,1,0,14,6,3,4,7,-1,0,2,1,1,1,1,3,1
KR_6763538269,420,1,-34,4,9,-2,0,2,2,3,1,2,7,5,5,6,1,2,4,2,0,10,-2,2,6,8,0,0,-1,-1,-1,1,-1,4,1
KR_6747341810,420,4,46,32,2,3,3,0,-1,3,4,-2,1,3,1,2,1,1,2,1,0,-2,-4,-8,9,1,3,0,1,1,-1,1,1,3,1
KR_6745674092,420,1,4,-29,4,-1,1,2,5,6,1,0,2,2,1,6,5,-1,0,1,0,3,-2,0,6,6,-3,0,0,1,1,0,-1,5,1
KR_6595839656,420,0,-2,-2,3,0,2,2,-4,1,5,3,5,2,3,3,0,1,2,1,0,0,-26,-4,6,2,4,0,0,1,-1,0,1,5,1
KR_6619670631,420,3,36,-12,12,7,8,1,5,9,4,-2,4,6,4,4,0,-2,0,2,0,8,-1,-1,6,5,-1,0,0,0,1,1,1,0,1
KR_6723318264,420,1,-1,3,-2,-1,1,2,0,2,2,-1,1,2,3,5,2,-3,0,3,0,-4,-167,1,2,3,0,0,0,-1,-1,-1,1,5,1
KR_6771847072,420,4,51,-8,4,3,5,2,-1,2,3,4,6,2,-1,4,5,-1,0,1,0,4,-1,0,4,4,-2,0,0,0,1,1,1,0,1
KR_6592734414,420,6,29,9,13,0,2,2,2,4,2,4,6,2,5,6,1,2,3,1,-1,3,-70,3,4,7,0,0,3,1,1,1,-1,1,1
KR_6736004501,420,2,-9,24,11,1,1,0,4,5,1,-3,1,4,6,7,1,3,3,0,0,17,48,-3,12,9,8,0,0,1,1,0,1,1,1
KR_6647684940,420,3,16,1,6,0,1,1,2,2,0,1,1,0,3,4,1,0,0,0,0,6,204,2,5,7,-37,0,1,1,-1,1,1,4,1
KR_6602287909,420,5,79,12,9,2,4,2,0,3,3,2,4,2,5,5,0,0,2,2,0,4,16,7,2,9,-2,0,3,1,1,1,1,3,1
KR_6696451473,440,2,49,-12,5,-3,1,4,7,10,3,1,1,0,1,1,0,-1,1,2,1,11,37,0,4,4,-6,0,2,1,-1,1,1,5,1
KR_6646242736,420,0,44,11,0,-1,2,3,-1,4,5,0,2,2,3,6,3,-1,0,1,-1,-3,118,1,5,6,5,0,0,1,0,0,-1,2,1
KR_6735985153,420,-1,71,16,4,0,0,0,4,7,3,4,5,1,-1,0,1,-3,0,3,0,4,3,5,3,8,6,0,-1,-1,0,1,1,4,1
KR_6769355736,440,4,43,36,9,2,3,1,2,3,1,4,6,2,1,5,4,0,3,3,0,1,2,5,4,9,-2,0,2,-1,1,1,1,5,1
KR_6769405025,420,4,31,6,14,2,2,0,0,6,6,7,8,1,2,2,0,3,3,0,2,6,16,6,0,6,-7,0,3,1,1,1,-1,4,1
KR_6549145058,420,2,4,-35,10,0,1,1,5,5,0,5,5,0,-3,2,5,3,3,0,0,13,0,2,3,5,1,0,1,0,1,1,1,0,1
KR_6683531930,420,3,-7,-20,2,0,1,1,3,7,4,-2,2,4,-1,2,3,2,3,1,-1,-6,6,4,3,7,0,0,-1,-1,1,-1,-1,3,1
KR_6728016049,420,-1,14,-15,-5,1,2,1,0,2,2,1,1,0,-6,0,6,-1,0,1,0,-7,-33,-4,5,1,4,0,1,-1,1,1,1,6,1
KR_6558998285,420,3,65,-24,8,5,6,1,-2,0,2,-5,1,6,10,11,1,0,1,1,0,4,21,3,2,5,1,0,2,-1,1,1,1,4,1
KR_6771151548,420,6,43,13,6,1,3,2,-2,2,4,7,7,0,-1,6,7,1,3,2,0,2,10,-2,4,2,0,0,1,1,-1,1,-1,4,1
KR_6759093294,440,5,54,15,4,4,5,1,1,3,2,0,3,3,-2,1,3,1,2,1,0,4,-107,1,6,7,-8,0,0,1,1,1,-1,1,1
KR_6649507915,420,2,40,-7,1,0,1,1,0,2,2,1,3,2,0,0,0,0,1,1,0,-2,-112,-3,6,3,3,0,0,0,1,0,-1,0,1
KR_6763203126,420,4,63,25,4,2,4,2,1,3,2,1,3,2,1,3,2,-1,0,1,0,11,-18,4,7,11,-3,0,0,1,1,1,-1,2,1
KR_6771950522,440,1,-131,7,6,-1,4,5,0,2,2,2,3,1,3,3,0,2,2,0,0,14,-414,-1,8,7,-1,0,-2,0,0,-1,-1,0,1
KR_6721742526,420,5,-37,12,14,3,4,1,0,4,4,3,4,1,7,9,2,1,3,2,1,16,44,4,2,6,3,0,1,1,-1,1,1,3,1
KR_6501208514,420,1,16,20,7,0,2,2,-2,1,3,1,3,2,8,12,4,0,0,0,0,2,-23,-2,6,4,3,0,0,0,1,0,1,0,1
KR_6564549064,420,3,55,-20,9,1,2,1,5,6,1,4,4,0,-2,1,3,1,2,1,0,3,7,1,4,5,2,0,2,1,1,1,1,2,1
KR_6768485418,440,1,-47,13,8,2,2,0,1,2,1,2,5,3,0,2,2,3,3,0,0,12,34,2,4,6,-28,0,1,-1,-1,1,1,2,1
KR_6760264350,420,1,-36,35,2,-4,1,5,-2,5,7,2,4,2,6,6,0,0,1,1,0,13,-303,1,4,5,1,0,0,1,-1,-1,-1,4,1
KR_6766755906,440,2,69,4,8,4,5,1,1,2,1,2,4,2,1,1,0,0,0,0,0,1,33,1,3,4,5,0,2,1,0,1,1,5,1
KR_6683210734,420,2,11,-4,4,2,2,0,0,4,4,3,4,1,0,2,2,-1,0,1,0,7,9,4,2,6,-3,0,0,1,1,0,-1,1,1
KR_6749044038,420,-1,-41,20,9,-1,3,4,4,4,0,3,3,0,1,5,4,2,3,1,1,16,-28,-1,11,10,0,0,1,1,0,1,1,3,1
KR_6734231713,440,6,74,46,14,-1,1,2,-1,0,1,9,9,0,4,5,1,3,6,3,0,12,-222,0,4,4,0,0,3,1,1,1,1,5,1
KR_6677794408,420,4,12,-4,6,1,3,2,2,4,2,1,3,2,1,1,0,1,2,1,0,5,34,0,3,3,-1,0,1,1,1,1,1,3,1
KR_6768961910,420,4,21,40,6,3,3,0,2,5,3,0,1,1,0,1,1,1,1,0,0,4,-11,-3,8,5,5,0,0,1,0,0,-1,3,1
KR_6683552999,420,-1,57,17,-4,2,3,1,2,3,1,-4,0,4,-3,3,6,-1,0,1,0,-5,-62,2,5,7,5,0,-1,1,1,1,1,1,1
KR_6764660035,440,6,67,14,17,-2,0,2,14,17,3,-1,0,1,-1,1,2,7,10,3,-1,27,-7,-2,7,5,6,0,2,-1,1,1,1,2,1
KR_6762788939,420,3,18,4,4,3,4,1,1,2,1,-2,4,6,2,2,0,0,0,0,0,6,-183,-2,3,1,1,0,1,1,1,1,-1,5,1
KR_6724817049,420,0,51,1,1,-2,2,4,-1,1,2,-1,2,3,5,5,0,0,0,0,0,-1,16,-5,8,3,2,0,1,-1,1,1,-1,4,1
KR_6729370670,440,4,89,-2,12,2,2,0,4,6,2,5,5,0,1,4,3,0,1,1,0,2,-2,3,1,4,-2,0,2,1,1,1,1,4,1
KR_6695990249,440,0,28,33,2,-1,1,2,2,4,2,0,1,1,-1,2,3,2,4,2,0,0,16,3,6,9,4,0,0,0,1,0,1,0,1
KR_6718679269,420,-1,-18,-29,-5,-3,1,4,-5,0,5,3,3,0,1,3,2,-1,2,3,0,-6,-60,5,4,9,-1,0,1,-1,1,-1,-1,3,1
KR_6555217464,420,-3,-61,-3,-7,-4,0,4,-1,0,1,1,3,2,-1,2,3,-2,0,2,0,-4,-44,4,1,5,18,0,-1,-1,-1,-1,1,3,1
KR_6708965444,420,2,75,-7,-4,0,0,0,0,4,4,-1,0,1,-2,1,3,-1,1,2,0,-3,-1,1,5,6,6,0,0,0,1,1,-1,0,1
KR_6742537575,440,-3,-46,-42,-2,1,3,2,-4,4,8,-2,4,6,4,8,4,-1,1,2,1,2,10,1,4,5,-4,0,0,0,1,-1,1,0,1
KR_6741999232,420,4,8,32,10,6,6,0,2,5,3,4,7,3,-2,2,4,0,2,2,1,-3,103,1,6,7,0,0,2,-1,1,1,1,3,1
KR_6666765070,420,-2,45,-16,-7,1,3,2,-2,0,2,-3,0,3,-3,0,3,0,0,0,0,-8,9,4,4,8,-1,0,0,1,1,0,-1,6,1
KR_6730073128,440,1,-35,-12,5,2,2,0,5,5,0,-3,3,6,1,2,1,0,1,1,0,10,25,-2,7,5,-4,0,0,1,-1,0,-1,1,1
KR_6771148734,420,-1,-82,-8,-7,-3,1,4,-3,0,3,0,3,3,1,6,5,-2,1,3,0,2,0,-4,9,5,1,0,-1,-1,-1,-1,-1,1,1
KR_6758457652,420,1,-29,44,13,2,5,3,4,4,0,1,5,4,6,6,0,0,0,0,1,8,-34,1,1,2,5,0,0,0,-1,1,1,0,1
KR_6692820485,440,1,-20,24,-2,4,5,1,-2,1,3,1,3,2,-3,0,3,-2,0,2,0,-6,24,0,5,5,0,0,0,-1,1,-1,-1,6,1
KR_6711074784,420,0,-10,14,1,-4,1,5,-4,1,5,-2,1,3,12,12,0,-1,0,1,0,0,8,1,5,6,2,0,0,1,-1,1,1,2,1
KR_6758296534,420,1,7,-17,-1,-6,0,6,2,4,2,-3,3,6,3,3,0,3,3,0,0,8,24,4,3,7,-2,0,0,-1,-1,1,1,6,1
KR_6768713932,420,1,55,-3,2,0,2,2,-1,2,3,0,2,2,2,2,0,1,1,0,0,10,-2,1,3,4,3,0,0,1,1,0,1,4,1
KR_6658035904,420,1,16,-13,11,0,0,0,-5,5,10,5,6,1,7,10,3,4,6,2,0,13,-105,1,4,5,1,0,1,-1,1,1,1,3,1
KR_6655227328,420,1,-24,0,3,-2,0,2,3,5,2,0,2,2,1,2,1,1,1,0,-1,6,15,2,2,4,2,0,0,-1,1,1,-1,5,1
KR_6560410949,420,1,-16,4,8,1,2,1,1,4,3,1,3,2,4,5,1,1,2,1,0,16,14,1,5,6,-1,0,1,1,1,1,1,5,1
KR_6744120326,420,2,-3,-3,8,-4,1,5,2,4,2,2,3,1,7,7,0,1,1,0,-2,14,204,4,3,7,6,0,0,1,-1,0,-1,1,1
KR_6530673429,420,-1,22,-20,-7,4,4,0,-2,2,4,-8,0,8,-1,0,1,0,0,0,0,-10,10,-3,5,2,-6,0,1,-1,1,1,1,2,1
KR_6683153161,420,1,21,21,-9,-2,0,2,4,5,1,-3,3,6,-6,0,6,-2,0,2,0,-12,-12,1,8,9,-1,0,0,1,-1,0,-1,1,1
KR_6764933526,420,1,60,32,11,-6,2,8,-2,0,2,3,5,2,13,13,0,3,3,0,1,-3,0,-1,3,2,1,0,3,0,1,1,1,0,1
KR_6758172560,420,-2,7,-34,6,4,4,0,0,2,2,0,2,2,3,3,0,-1,0,1,1,7,3,3,2,5,-1,0,1,1,-1,1,1,4,1
KR_6726879839,420,-1,-23,-7,-4,0,4,4,-4,0,4,0,3,3,-3,5,8,3,3,0,0,-1,-39,-3,11,8,1,0,1,-1,1,1,1,2,1
KR_6726478551,420,1,19,28,-3,3,8,5,-4,1,5,2,4,2,-2,2,4,-2,0,2,0,-12,-32,0,6,6,-2,0,2,-1,0,1,-1,2,1
KR_6659441406,420,1,103,5,-7,1,2,1,-6,1,7,-5,1,6,2,3,1,1,1,0,0,-15,5,-1,5,4,-1,0,0,-1,-1,0,-1,1,1
KR_6558468919,440,4,39,28,9,5,6,1,-3,5,8,7,8,1,-1,0,1,1,2,1,0,2,-16,-4,7,3,2,0,-1,1,-1,-1,1,6,1
KR_6680799239,420,2,50,-13,5,-3,2,5,-2,2,4,5,6,1,1,4,3,4,5,1,-1,15,3,7,2,9,-2,0,0,1,1,1,-1,1,1
KR_6738683327,440,9,75,12,16,3,4,1,5,6,1,1,4,3,4,4,0,3,3,0,0,24,16,8,0,8,0,0,3,1,0,1,1,6,1
KR_6767343213,420,-2,-5,-8,-1,1,2,1,0,1,1,5,5,0,-4,3,7,-3,1,4,0,-2,-14,3,3,6,-2,0,-1,-1,-1,-1,1,2,1
KR_6685228198,420,2,69,-3,5,5,7,2,-1,1,2,0,0,0,-3,2,5,4,4,0,0,2,-10,0,6,6,-1,0,0,-1,1,1,1,3,1
KR_6728860692,440,0,-88,12,3,1,3,2,-2,1,3,-3,2,5,7,8,1,0,1,1,0,8,-38,4,1,5,-1,0,1,-1,-1,-1,1,4,1
KR_6681246947,420,2,1,43,-3,3,3,0,-1,1,2,-3,0,3,-5,0,5,3,3,0,0,-9,5,-1,6,5,3,0,-1,-1,1,-1,1,2,1
KR_6766741485,420,4,92,20,0,-1,0,1,3,5,2,-2,1,3,-1,1,2,1,1,0,-1,-3,-7,0,5,5,2,0,0,0,0,0,-1,0,1
KR_6766156797,440,5,133,20,13,2,3,1,7,8,1,1,1,0,4,4,0,-1,1,2,0,7,1,-1,6,5,1,0,2,1,-1,1,1,1,1
KR_6759471349,440,3,33,47,4,0,1,1,3,3,0,3,4,1,-2,1,3,0,0,0,0,3,-5,-4,7,3,0,0,2,1,1,1,1,3,1
KR_6518864575,420,4,42,24,14,-4,1,5,2,2,0,4,4,0,9,12,3,3,3,0,0,14,9,0,5,5,-4,0,0,1,-1,1,-1,6,1
KR_6768352750,420,7,88,39,13,6,6,0,2,4,2,1,1,0,4,5,1,0,1,1,1,10,10,4,4,8,-4,0,1,1,-1,1,1,6,1
KR_6717061871,420,-2,-46,4,2,-3,0,3,2,4,2,3,4,1,0,0,0,0,0,0,0,5,-3,5,1,6,3,0,-1,1,1,-1,1,5,1
KR_6748333555,420,-2,-14,-43,5,0,3,3,5,5,0,-2,1,3,2,4,2,0,0,0,0,17,21,7,2,9,-3,0,0,1,-1,1,-1,6,1
KR_6633624592,420,4,4,7,10,1,3,2,4,8,4,-5,0,5,9,11,2,1,1,0,-1,1,-137,-2,7,5,2,0,1,0,1,1,-1,0,1
KR_6722597971,420,4,22,24,4,-1,3,4,4,4,0,-1,2,3,2,5,3,0,0,0,-1,9,8,11,1,12,0,0,-1,1,1,-1,-1,3,1
KR_6682986371,420,0,-11,-8,-2,0,4,4,0,3,3,-1,1,2,1,2,1,-2,1,3,0,1,-1,-3,5,2,1,0,-1,-1,-1,-1,-1,6,1
KR_6750573805,420,-1,-29,-24,5,-1,3,4,0,1,1,3,4,1,1,1,0,2,2,0,-1,4,0,2,5,7,-2,0,0,0,-1,-1,-1,0,1
KR_6747199682,420,9,38,42,26,5,6,1,-3,3,6,6,6,0,9,10,1,9,9,0,1,27,-3,2,0,2,-1,0,3,1,1,1,1,4,1
KR_6754197000,420,-1,8,-4,-9,-6,0,6,-3,1,4,0,1,1,0,4,4,0,1,1,0,-6,3,-3,8,5,1,0,0,-1,-1,-1,-1,4,1
KR_6735408179,420,2,-4,8,7,3,5,2,4,6,2,1,6,5,-2,2,4,1,2,1,0,9,-8,-3,9,6,-1,0,-1,1,1,-1,-1,6,1
KR_6724621938,420,4,25,-4,11,2,2,0,3,4,1,5,7,2,1,3,2,0,1,1,1,12,8,3,1,4,-3,0,2,1,1,1,1,1,1
KR_6532112878,420,4,72,12,14,4,5,1,1,1,0,1,2,1,4,5,1,4,4,0,0,15,-12,-2,6,4,8,0,0,1,1,1,1,5,1
KR_6716679924,420,1,25,31,4,0,1,1,3,5,2,2,6,4,-1,0,1,0,1,1,0,5,314,0,2,2,-3,0,0,-1,1,1,1,6,1
KR_6760758826,440,2,-32,8,1,-1,0,1,0,2,2,-1,3,4,2,7,5,1,5,4,0,7,-2,1,4,5,-5,0,0,-1,-1,0,-1,1,1
KR_6737747168,420,3,34,48,8,1,1,0,3,7,4,1,2,1,3,6,3,0,2,2,1,4,16,-1,7,6,3,0,0,1,1,1,1,5,1
KR_6768525952,420,0,75,4,4,2,2,0,0,1,1,0,1,1,3,7,4,-1,0,1,0,5,50,2,6,8,-23,0,1,-1,1,1,1,4,1
KR_6637039191,420,-2,-11,19,-4,-2,2,4,-1,1,2,-2,0,2,0,4,4,1,2,1,0,-3,-131,-2,11,9,-4,0,-2,1,-1,-1,1,6,1
KR_6621327791,420,4,35,-5,3,0,4,4,-2,0,2,0,4,4,3,6,3,2,3,1,0,-3,-21,-4,9,5,1,0,1,1,-1,-1,1,4,1
KR_6672989648,420,3,42,0,2,0,3,3,2,4,2,-2,2,4,3,4,1,-1,1,2,0,5,29,-2,7,5,-9,0,0,-1,1,0,1,1,1
KR_6581734449,420,1,11,-41,4,1,2,1,3,5,2,2,4,2,-2,1,3,0,0,0,0,9,-8,5,2,7,-4,0,-1,0,0,-1,-1,0,1
KR_6768795274,420,2,-29,6,6,0,2,2,2,3,1,-3,2,5,4,5,1,3,3,0,0,6,-2,-6,10,4,7,0,0,0,1,1,1,0,1
KR_6745048843,420,0,-6,15,-4,0,2,2,2,4,2,-4,1,5,-3,0,3,1,1,0,0,-9,149,2,5,7,-29,0,0,-1,-1,0,-1,2,1
KR_6624243542,420,2,-27,11,6,0,1,1,2,7,5,3,4,1,4,8,4,-3,0,3,-2,17,5,-2,8,6,3,0,0,1,-1,-1,-1,2,1
KR_6680497211,420,-2,1,-5,-2,0,2,2,0,4,4,3,3,0,-4,0,4,-1,0,1,0,-3,-5,1,4,5,0,0,0,1,1,1,-1,4,1
KR_6767599216,420,2,-43,6,13,0,1,1,6,7,1,-1,3,4,8,9,1,0,1,1,0,16,-17,3,2,5,0,0,0,1,1,0,-1,4,1
KR_6596306427,420,7,58,12,11,-2,0,2,2,6,4,1,3,2,11,12,1,-1,2,3,0,5,127,1,5,6,2,0,4,1,1,1,1,2,1
KR_6717129712,420,4,23,1,13,2,5,3,4,6,2,5,5,0,1,3,2,1,2,1,0,20,3,1,7,8,1,0,1,-1,1,1,-1,6,1
KR_6768028496,440,1,-14,7,3,3,4,1,0,1,1,1,1,0,1,2,1,-2,0,2,0,3,284,2,2,4,0,0,2,1,1,1,1,4,1
KR_6759775219,420,2,29,-21,5,6,6,0,-4,0,4,1,3,2,2,4,2,0,2,2,0,14,-36,-2,6,4,-3,0,-2,-1,-1,-1,1,2,1
KR_6725902846,420,6,91,-20,16,3,5,2,6,6,0,5,5,0,-1,3,4,3,4,1,0,18,15,-2,5,3,6,0,2,1,1,1,1,4,1
KR_6665243175,420,2,72,-28,4,6,6,0,-3,3,6,0,2,2,1,3,2,0,2,2,0,-14,3,1,6,7,5,0,0,1,-1,1,1,6,1
KR_6744770248,420,-1,0,10,-1,1,1,0,0,4,4,0,5,5,-1,0,1,-1,2,3,0,-3,27,6,4,10,-3,0,1,1,-1,1,-1,6,1
KR_6764433594,420,6,119,9,11,5,5,0,-1,0,1,6,7,1,-1,4,5,2,2,0,1,11,331,2,3,5,6,0,2,1,-1,1,1,4,1
KR_6706510023,420,1,29,-20,0,3,6,3,3,3,0,-2,2,4,-4,1,5,0,0,0,0,1,0,3,3,6,1,0,0,-1,1,-1,1,4,1
KR_6753478143,420,2,-29,8,1,0,0,0,-3,1,4,0,2,2,4,5,1,0,0,0,0,5,14,2,5,7,-3,0,-1,1,-1,-1,-1,6,1
KR_6696632219,420,0,17,9,2,1,3,2,-1,2,3,-3,1,4,2,3,1,3,3,0,1,8,4,1,3,4,2,0,1,1,-1,1,1,3,1
KR_6752395197,420,4,66,-4,0,1,3,2,2,3,1,-1,1,2,0,2,2,-2,0,2,0,-1,-16,1,3,4,3,0,1,1,1,1,-1,6,1
KR_6762738619,420,3,-11,20,12,-1,0,1,0,2,2,4,6,2,6,6,0,3,4,1,0,17,-1,-1,4,3,0,0,2,1,1,1,1,4,1
KR_6759309852,440,2,68,7,8,3,5,2,2,2,0,0,4,4,5,13,8,-2,1,3,0,11,-12,-1,6,5,2,0,1,1,-1,1,1,5,1
KR_6558909561,420,-1,3,-19,-1,8,9,1,0,5,5,-1,1,2,-6,0,6,-2,0,2,0,-5,-2,-1,6,5,-1,0,0,-1,1,-1,1,5,1
KR_6555153307,420,2,-1,21,1,-3,0,3,-1,2,3,-2,2,4,0,3,3,7,8,1,1,5,249,6,2,8,-1,0,1,1,1,1,1,3,1
KR_6755440221,420,1,-12,11,6,-3,1,4,5,6,1,3,3,0,0,3,3,1,2,1,2,20,161,6,3,9,1,0,1,1,1,1,1,3,1
KR_6232721649,420,-1,4,20,5,-4,0,4,3,4,1,-2,3,5,5,7,2,3,4,1,1,14,15,-1,6,5,-2,0,0,1,-1,-1,1,6,1
KR_6756936122,440,0,-7,-23,6,2,3,1,-1,2,3,2,3,1,0,6,6,3,3,0,-1,2,-44,-1,7,6,15,0,0,-1,1,-1,-1,4,1
KR_6666963060,420,-2,-46,1,-2,-2,3,5,2,4,2,2,2,0,-2,4,6,-2,0,2,1,0,5,5,3,8,-5,0,-2,-1,-1,-1,1,5,1
KR_6737680639,420,7,85,51,15,1,1,0,3,5,2,4,4,0,4,5,1,3,5,2,0,11,6,0,6,6,3,0,2,1,1,1,1,2,1
KR_6706154242,420,2,115,20,-5,0,0,0,-1,1,2,2,5,3,-5,1,6,-1,0,1,-1,-5,-8,-3,8,5,3,0,-1,1,-1,1,1,4,1
KR_6771575695,420,1,0,14,4,1,1,0,0,2,2,2,2,0,0,0,0,1,1,0,0,4,2,-1,4,3,-1,0,0,1,-1,0,-1,4,1
KR_6768088863,420,4,53,-2,7,4,4,0,2,2,0,1,3,2,-1,2,3,1,4,3,0,6,5,4,2,6,-2,0,0,-1,1,-1,1,2,1
KR_5896878584,440,1,-8,-4,2,0,0,0,1,5,4,-4,2,6,1,2,1,4,5,1,0,-4,7,2,5,7,2,0,1,1,1,1,-1,5,1
KR_6736551152,420,4,-32,18,7,0,0,0,4,5,1,0,3,3,2,2,0,1,2,1,0,5,11,5,1,6,-1,0,1,1,1,1,1,2,1
KR_6716571664,420,0,-20,-24,-1,2,3,1,-2,2,4,2,3,1,-2,0,2,-1,1,2,0,2,0,0,5,5,2,0,0,1,-1,0,1,5,1
KR_6702249605,420,3,37,12,10,-1,2,3,3,6,3,2,3,1,5,6,1,1,1,0,1,18,6,1,4,5,3,0,1,-1,-1,1,1,6,1
KR_6762979975,420,2,64,-23,10,3,4,1,3,5,2,3,4,1,1,4,3,0,2,2,1,4,-7,0,4,4,-2,0,1,1,-1,1,1,2,1
KR_6384680963,420,4,41,24,5,4,4,0,-1,2,3,3,3,0,0,1,1,-1,2,3,0,0,-1,4,5,9,-4,0,1,1,-1,1,1,4,1
KR_6767144266,420,3,11,-8,5,0,0,0,-3,0,3,0,1,1,7,7,0,1,1,0,0,9,-10,-1,6,5,1,0,-1,0,1,-1,1,0,1
KR_6756763717,420,3,-37,4,3,0,3,3,4,4,0,2,3,1,-3,2,5,0,1,1,0,-3,-9,-1,4,3,-1,0,-2,1,-1,-1,1,2,1
KR_6770233013,440,3,82,9,8,2,2,0,2,4,2,3,6,3,5,5,0,-4,0,4,0,12,0,-1,8,7,2,0,0,0,0,0,1,0,1
KR_6767217482,420,1,52,-19,6,-2,3,5,-2,1,3,8,10,2,-2,0,2,4,5,1,-1,7,-55,-3,3,0,12,0,1,0,-1,1,-1,0,1
KR_6758455897,420,0,13,18,-5,2,3,1,-2,4,6,-2,2,4,-2,1,3,-1,1,2,1,-15,-221,0,2,2,-3,0,1,1,1,1,1,2,1
KR_6759290934,440,3,-25,19,5,2,7,5,-1,1,2,-1,2,3,1,2,1,4,4,0,0,12,-3,-3,8,5,3,0,1,1,1,1,1,4,1
KR_6685418108,420,3,71,-3,7,1,1,0,1,4,3,2,2,0,5,5,0,-2,0,2,0,8,-1,-7,9,2,0,0,2,1,1,1,1,4,1
KR_6734522541,420,2,31,16,2,0,0,0,-1,3,4,3,4,1,0,2,2,0,0,0,0,0,-6,0,6,6,4,0,-1,1,-1,-1,-1,5,1
KR_6738069870,420,1,74,-28,4,4,5,1,-2,0,2,3,5,2,2,3,1,-3,0,3,0,12,18,1,5,6,3,0,0,1,-1,0,1,3,1
KR_6522971791,420,5,1,24,10,1,2,1,5,5,0,1,2,1,2,8,6,1,1,0,0,10,63,8,0,8,-3,0,-1,1,-1,-1,-1,5,1
KR_6756462867,420,3,29,-4,-4,0,2,2,-2,3,5,-4,2,6,1,3,2,1,2,1,0,-2,-1,-4,9,5,2,0,0,-1,-1,0,-1,2,1
KR_6750152377,420,4,117,14,6,3,3,0,-1,2,3,0,3,3,4,4,0,0,1,1,0,5,-3,-1,6,5,3,0,3,1,1,1,1,3,1
KR_6606023607,440,3,60,44,7,4,4,0,2,2,0,-1,1,2,3,6,3,-1,0,1,0,9,0,0,6,6,9,0,0,-1,1,0,1,6,1
KR_6733571058,420,2,29,16,4,1,3,2,-2,2,4,0,1,1,4,5,1,1,1,0,0,7,-39,0,7,7,20,0,0,1,1,1,1,4,1
KR_6762360173,420,1,46,-15,6,4,5,1,0,2,2,3,5,2,-1,3,4,0,1,1,0,2,-103,1,2,3,-1,0,1,1,1,1,-1,6,1
KR_6738860149,420,1,-40,63,2,-1,1,2,1,3,2,2,2,0,1,3,2,-1,0,1,0,3,0,3,4,7,-3,0,-3,-1,-1,-1,-1,3,1
KR_6768420691,420,-4,18,-3,-4,-5,0,5,0,2,2,2,3,1,-2,1,3,1,2,1,0,-4,4,-3,6,3,-3,0,0,1,-1,1,-1,2,1
KR_6726283373,420,3,-2,24,8,6,8,2,4,4,0,-1,0,1,-2,1,3,1,2,1,-2,4,37,3,4,7,0,0,0,-1,1,1,-1,6,1
KR_6743549756,420,0,68,-31,5,1,2,1,3,3,0,3,3,0,-1,1,2,-1,1,2,0,8,-14,-6,10,4,5,0,1,-1,1,1,1,5,1
KR_6673831957,420,2,-20,36,8,1,3,2,-1,0,1,-3,2,5,3,7,4,8,9,1,1,5,3,2,4,6,1,0,1,1,-1,1,1,4,1
KR_6702325625,420,3,18,7,6,-1,3,4,3,5,2,3,5,2,3,4,1,-2,1,3,2,15,65,0,6,6,3,0,1,1,-1,-1,1,1,1
KR_6771690846,440,2,1,12,7,-1,4,5,0,0,0,2,3,1,2,2,0,4,4,0,0,11,5,6,2,8,-1,0,0,1,0,-1,-1,3,1
KR_6653969959,420,3,42,4,5,5,7,2,-1,0,1,-1,0,1,2,4,2,0,0,0,0,2,-10,-6,11,5,6,0,1,1,1,1,-1,5,1
KR_6735382431,420,6,5,4,14,2,4,2,5,6,1,4,4,0,2,4,2,1,2,1,0,18,-2,-1,10,9,9,0,2,1,1,1,-1,6,1
KR_6771746620,420,4,53,24,13,1,2,1,7,7,0,3,4,1,4,5,1,-2,1,3,0,13,-11,0,6,6,4,0,1,1,1,1,1,1,1
KR_6759465554,440,-3,-72,-8,-1,-3,0,3,1,4,3,2,4,2,0,1,1,-1,0,1,0,4,-52,-6,8,2,22,0,0,-1,1,0,1,4,1
KR_6731523372,440,3,36,16,11,1,4,3,0,2,2,10,11,1,0,1,1,0,0,0,1,10,12,-2,2,0,1,0,1,1,-1,-1,1,5,1
KR_6767404689,440,6,12,12,6,0,2,2,2,3,1,-5,1,6,9,9,0,0,1,1,-2,8,0,-2,2,0,2,0,0,1,0,1,-1,6,1
KR_6632814973,420,-1,-56,28,-3,1,3,2,-7,2,9,2,3,1,1,2,1,0,1,1,0,-3,2,-1,7,6,0,0,0,-1,0,-1,-1,2,1
KR_6704083320,420,-2,-6,-8,-2,-3,1,4,-2,3,5,-1,0,1,4,7,3,0,1,1,0,6,-49,-5,7,2,21,0,-1,-1,-1,-1,1,3,1
KR_6744712604,420,-2,2,-10,-2,-2,0,2,-1,0,1,2,4,2,-1,1,2,0,0,0,0,-7,-7,0,6,6,-1,0,0,-1,1,0,1,1,1
KR_6770482537,420,0,-35,12,0,3,3,0,-3,1,4,-3,0,3,4,5,1,-1,0,1,0,-6,-2,-1,7,6,1,0,0,1,0,0,1,4,1
KR_6715039506,420,7,38,28,11,1,1,0,2,2,0,4,6,2,3,3,0,1,1,0,0,9,-1,-1,5,4,4,0,1,0,1,1,-1,0,1
KR_6632098525,420,2,0,-2,4,-2,0,2,3,7,4,5,5,0,-1,2,3,-1,1,2,1,3,0,-4,6,2,-1,0,0,-1,1,0,1,5,1
KR_6758104143,440,2,-15,-12,4,-1,0,1,-1,1,2,2,3,1,2,2,0,2,3,1,0,0,3,2,3,5,-4,0,0,1,-1,0,1,3,1
KR_6767909642,440,3,-49,20,4,-4,0,4,1,3,2,3,6,3,2,4,2,2,4,2,-2,9,23,4,2,6,0,0,-1,1,-1,-1,1,4,1
KR_6630773829,420,0,-8,-17,2,2,4,2,5,8,3,0,3,3,-5,1,6,0,1,1,1,0,53,3,5,8,-27,0,0,-1,-1,1,1,1,1
KR_6613917345,420,0,-10,13,3,2,2,0,0,4,4,-1,0,1,1,5,4,1,1,0,0,-3,-5,2,4,6,-2,0,1,1,1,1,1,4,1
KR_6760790240,440,-1,-42,-8,-7,0,1,1,4,5,1,-3,3,6,-1,4,5,-7,0,7,0,-2,-3,-5,7,2,-1,0,-1,-1,1,-1,1,6,1
KR_6752533979,420,5,135,-12,18,1,1,0,1,3,2,2,5,3,12,13,1,2,4,2,0,17,-7,0,8,8,1,0,1,0,-1,1,1,0,1
KR_6701827149,420,-3,-41,-16,5,-1,2,3,2,2,0,-1,3,4,2,3,1,3,4,1,-1,5,2,0,5,5,-2,0,1,-1,-1,1,-1,1,1
KR_6587032810,420,1,42,3,-4,0,1,1,4,4,0,-2,0,2,-4,0,4,-2,0,2,0,-3,6,1,3,4,-3,0,1,1,1,1,-1,2,1
KR_6769155532,420,2,49,8,-2,-3,0,3,3,3,0,-1,0,1,0,4,4,-1,0,1,0,-4,21,2,4,6,0,0,0,1,-1,0,1,2,1
KR_6637201387,420,3,62,7,10,-2,0,2,4,4,0,3,3,0,4,6,2,1,4,3,0,27,-4,-1,7,6,-1,0,2,-1,1,1,-1,6,1
KR_6770961427,420,-1,-23,3,3,-2,0,2,1,6,5,6,6,0,0,1,1,-2,1,3,1,4,1,4,0,4,-2,0,-1,1,1,1,1,2,1
KR_6754563169,440,8,55,29,23,4,4,0,2,3,1,7,9,2,7,8,1,3,3,0,0,11,311,1,1,2,1,0,3,1,1,1,1,4,1
KR_6771236057,420,0,-10,4,0,-2,1,3,-3,3,6,1,1,0,3,3,0,1,1,0,0,0,-2,0,3,3,-3,0,0,1,1,0,-1,4,1
KR_6325503400,420,-2,-43,5,1,-4,0,4,-1,2,3,3,4,1,3,5,2,0,1,1,0,6,-10,0,7,7,1,0,-1,1,1,-1,-1,3,1
KR_6435515549,420,1,-64,28,2,-2,1,3,1,5,4,-4,0,4,7,7,0,0,0,0,0,6,117,-3,7,4,-3,0,1,-1,1,1,1,4,1
KR_6770080641,420,-4,15,-34,-8,-6,0,6,-3,2,5,-1,1,2,6,6,0,-4,0,4,-1,7,1,-1,4,3,1,0,0,-1,1,-1,-1,5,1
KR_6755387348,420,5,89,34,13,8,8,0,4,5,1,1,4,3,1,5,4,-1,0,1,1,10,5,0,6,6,7,0,3,1,1,1,-1,4,1
KR_6735351153,420,-3,-27,-12,1,1,2,1,-2,0,2,2,7,5,-1,2,3,1,3,2,0,6,-1,-3,6,3,-1,0,-1,1,-1,-1,-1,1,1
KR_6756763609,420,0,20,4,2,-1,1,2,0,3,3,0,3,3,5,5,0,-2,1,3,0,3,-16,-1,8,7,1,0,0,1,-1,-1,-1,5,1
KR_6732761682,420,3,21,0,9,5,5,0,2,4,2,-1,1,2,2,2,0,1,2,1,0,9,36,2,1,3,-3,0,1,1,-1,1,-1,6,1
KR_6753709147,420,-4,-24,-4,-5,-6,0,6,0,1,1,-3,0,3,4,4,0,0,3,3,-1,5,-25,0,3,3,9,0,1,-1,-1,-1,-1,4,1
KR_6662160039,440,0,45,4,5,0,2,2,1,2,1,-1,0,1,6,6,0,-1,1,2,0,7,7,-1,3,2,2,0,1,1,-1,1,1,2,1
KR_6767503519,420,1,33,12,4,4,4,0,-1,0,1,-5,0,5,4,7,3,2,3,1,1,-2,-21,4,2,6,4,0,0,1,1,0,1,4,1
KR_6610744476,420,2,52,-9,6,4,4,0,-1,2,3,1,1,0,1,3,2,1,2,1,0,4,3,4,2,6,0,0,1,1,1,1,1,5,1
KR_6754239642,420,-2,-74,0,-1,3,6,3,-7,1,8,2,3,1,0,3,3,1,1,0,0,-2,-4,-3,9,6,-3,0,-1,-1,-1,-1,-1,1,1
KR_6728791359,420,1,-33,47,-6,-3,1,4,6,6,0,-3,0,3,-4,2,6,-2,2,4,0,-4,-6,0,5,5,-2,0,-2,0,-1,-1,1,0,1
KR_6460537746,420,5,75,10,7,-1,2,3,-1,0,1,8,9,1,1,2,1,0,0,0,0,4,27,1,8,9,-2,0,1,1,1,1,-1,2,1
KR_6725032404,440,1,75,-1,2,2,4,2,-4,2,6,0,2,2,4,4,0,0,1,1,0,-4,-32,-2,5,3,5,0,1,-1,-1,1,1,1,1
KR_6485666325,420,-1,-25,40,-3,4,4,0,-2,0,2,-3,0,3,-1,2,3,-1,0,1,0,-8,2,4,4,8,-4,0,0,-1,1,1,-1,1,1
KR_6770728587,420,5,85,36,8,1,2,1,4,5,1,2,2,0,1,4,3,0,0,0,0,13,38,3,1,4,-1,0,1,1,-1,1,1,2,1
KR_6633228197,420,3,2,-10,4,2,3,1,2,6,4,2,3,1,-2,0,2,0,0,0,-3,-2,11,-5,9,4,-3,0,0,-1,1,0,-1,2,1
KR_6517041522,420,-3,13,-8,-3,-1,2,3,3,5,2,-3,2,5,-1,1,2,-1,0,1,1,2,14,0,5,5,-1,0,0,-1,1,1,1,6,1
KR_6724311784,420,-1,-20,-7,-11,3,5,2,-1,3,4,-3,1,4,-5,1,6,-5,0,5,-1,-14,4,0,7,7,2,0,-2,-1,1,-1,-1,4,1
KR_6725782207,420,3,14,16,-3,0,1,1,-1,2,3,-1,2,3,-1,0,1,0,0,0,0,-3,29,5,3,8,1,0,0,1,1,0,1,1,1
KR_6418694905,420,-1,44,32,-8,0,0,0,-3,4,7,-1,1,2,3,3,0,-7,0,7,0,-10,-7,3,3,6,-2,0,0,-1,-1,0,1,1,1
KR_6736985459,420,0,10,12,2,-3,3,6,1,5,4,4,5,1,-1,2,3,1,1,0,0,7,-1,2,4,6,1,0,0,1,-1,0,1,1,1
KR_6732895466,440,4,38,32,11,0,0,0,-1,0,1,8,9,1,2,2,0,2,4,2,0,18,-183,0,6,6,5,0,0,1,1,1,1,3,1
KR_6736316267,420,3,14,10,8,4,8,4,2,4,2,1,1,0,2,3,1,-1,0,1,-1,7,4,0,3,3,1,0,3,1,1,1,-1,1,1
KR_6769751482,420,1,81,-32,8,2,3,1,0,1,1,-2,0,2,4,5,1,4,4,0,0,4,-1,1,5,6,0,0,2,1,-1,1,1,6,1
KR_6770367412,420,-1,-11,-17,-1,-8,1,9,0,2,2,0,1,1,5,6,1,2,3,1,0,5,-3,-1,8,7,1,0,0,-1,-1,-1,1,6,1
KR_6740456557,420,2,61,-4,2,2,2,0,5,9,4,-1,2,3,-4,1,5,0,2,2,0,0,-1,3,5,8,-2,0,2,1,1,1,1,2,1
KR_6738061882,420,5,42,27,9,3,3,0,-6,1,7,0,3,3,13,18,5,-1,0,1,1,19,-305,1,3,4,1,0,2,0,1,1,1,0,1
KR_6699565253,440,2,15,0,5,3,5,2,2,4,2,-1,2,3,0,0,0,1,3,2,-1,7,-4,0,2,2,1,0,1,1,1,1,-1,5,1
KR_6528464404,420,4,67,12,6,2,4,2,3,4,1,-3,4,7,1,3,2,3,4,1,0,6,385,-4,8,4,-21,0,2,1,1,1,-1,1,1
KR_6749750196,420,-5,-44,8,-5,-5,1,6,-2,1,3,-1,1,2,1,2,1,2,2,0,0,-5,1,3,6,9,-10,0,-1,-1,-1,-1,-1,2,1
KR_6754427080,420,2,73,4,8,3,3,0,-2,3,5,2,4,2,5,7,2,0,1,1,1,3,6,-1,5,4,1,0,2,-1,1,1,1,3,1
KR_6764496328,440,2,-3,4,-6,1,2,1,0,1,1,-2,4,6,-3,4,7,-2,0,2,-2,-14,-10,-1,6,5,2,0,1,-1,1,1,-1,2,1
KR_6771329403,420,5,66,8,15,5,6,1,6,6,0,-2,0,2,6,7,1,0,0,0,0,8,2,-1,4,3,-3,0,1,1,1,1,1,4,1
KR_6693860382,420,-2,43,-20,3,-4,1,5,1,6,5,6,6,0,0,2,2,0,1,1,0,0,-7,0,5,5,-1,0,-1,0,-1,1,1,0,1
KR_6726135136,420,0,-25,-9,-2,1,1,0,-1,2,3,0,1,1,0,3,3,-2,0,2,-2,3,-1,0,4,4,-5,0,0,-1,1,0,-1,4,1
KR_6639812874,420,0,-44,-39,3,0,0,0,1,3,2,3,4,1,-1,0,1,0,1,1,0,4,-27,-2,3,1,3,0,0,1,-1,0,-1,4,1
KR_6676765994,420,5,20,15,11,3,4,1,4,6,2,2,3,1,3,5,2,-1,0,1,1,24,-10,-4,6,2,7,0,1,1,0,1,1,2,1
KR_6653163955,420,-3,-44,7,-5,1,2,1,-3,6,9,-5,0,5,2,4,2,0,1,1,0,0,48,5,3,8,-32,0,-1,-1,1,-1,1,4,1
KR_6446669000,420,-2,34,-8,-3,-4,0,4,0,2,2,-2,1,3,-1,2,3,4,4,0,0,-2,43,1,4,5,-26,0,0,-1,1,0,-1,4,1
KR_6761736843,420,3,56,2,9,-1,1,2,2,4,2,3,4,1,5,9,4,0,3,3,0,9,-1,2,2,4,2,0,1,1,-1,1,-1,6,1
KR_6739907037,420,2,0,20,7,0,3,3,-1,2,3,1,3,2,6,6,0,1,1,0,1,11,-13,0,5,5,3,0,1,1,1,1,1,4,1
KR_6348987200,420,3,31,32,12,-4,1,5,13,13,0,1,4,3,1,4,3,1,2,1,1,23,41,5,2,7,1,0,1,1,-1,-1,1,1,1
KR_6765701442,420,0,-32,23,-4,1,1,0,2,6,4,-4,1,5,-2,1,3,-1,1,2,0,-3,-1,-2,5,3,2,0,0,0,1,-1,-1,0,1
KR_6762936867,420,-1,-8,-1,1,-1,0,1,2,5,3,-2,1,3,2,4,2,0,1,1,0,1,-144,1,4,5,-3,0,-1,1,0,-1,1,5,1
KR_6737470719,440,4,75,-24,7,2,2,0,5,8,3,2,3,1,-2,2,4,0,3,3,0,0,-6,1,3,4,-1,0,1,1,1,1,1,3,1
KR_6727724880,420,6,-1,23,12,0,2,2,0,1,1,3,4,1,1,3,2,8,9,1,1,13,185,7,1,8,0,0,1,1,-1,-1,1,5,1
KR_6747681390,420,-1,-62,-12,-3,-3,2,5,3,3,0,-1,1,2,-1,2,3,-1,0,1,-1,-1,133,2,4,6,0,0,0,0,1,0,-1,0,1
KR_6723724068,420,-6,-55,-4,-14,-5,0,5,-5,3,8,1,2,1,-6,1,7,1,1,0,0,-18,-6,-3,7,4,0,0,-2,-1,-1,-1,-1,5,1
KR_6768813782,440,1,-43,20,3,-3,0,3,6,6,0,-1,1,2,2,4,2,-1,0,1,0,1,11,0,2,2,-3,0,0,1,-1,0,1,3,1
KR_6728791012,420,1,-15,12,9,-2,3,5,4,4,0,4,7,3,2,4,2,1,2,1,3,16,4,3,1,4,2,0,0,1,1,1,1,2,1
KR_6757268770,440,5,66,-2,7,0,3,3,1,5,4,6,7,1,-1,2,3,1,3,2,0,-2,42,-6,6,0,-6,0,1,1,-1,1,1,4,1
KR_6766072828,420,2,-61,-7,10,4,5,1,4,6,2,0,3,3,3,4,1,-1,0,1,1,11,5,6,2,8,-2,0,0,0,1,1,1,0,1
KR_6771458328,420,3,9,20,8,-1,1,2,7,7,0,-1,2,3,4,6,2,-1,1,2,2,12,-2,-2,6,4,6,0,2,0,-1,1,1,0,1
KR_6651994926,440,-2,-9,-4,-7,-1,0,1,-4,1,5,0,0,0,-1,2,3,-1,4,5,0,-9,-12,-3,8,5,0,0,1,1,-1,1,-1,5,1
KR_6688121385,420,-3,-22,-23,-1,-1,2,3,-2,1,3,-1,2,3,1,3,2,2,2,0,0,1,0,-3,7,4,-1,0,0,1,1,-1,-1,3,1
KR_6770146482,420,0,-48,-26,2,0,2,2,1,2,1,0,2,2,0,2,2,1,1,0,0,4,7,7,2,9,2,0,1,1,-1,1,-1,6,1
KR_6765373430,420,4,59,38,9,1,4,3,1,2,1,-1,3,4,6,8,2,2,2,0,0,3,15,7,3,10,-1,0,3,1,1,1,1,1,1
KR_6769163335,420,6,63,-12,9,-3,1,4,8,10,2,1,2,1,4,5,1,-1,0,1,0,9,-4,-2,5,3,2,0,1,-1,-1,1,1,1,1
KR_6767541427,420,2,-5,25,4,3,3,0,2,2,0,3,3,0,-8,1,9,4,5,1,1,-2,32,-4,7,3,-10,0,1,1,1,1,1,5,1
KR_6768495324,420,-1,12,-7,-3,0,3,3,-3,1,4,1,1,0,0,1,1,-1,0,1,0,-5,-17,1,4,5,2,0,0,-1,-1,0,1,1,1
KR_6763404341,420,2,38,36,4,-3,2,5,3,5,2,-1,1,2,4,5,1,1,1,0,0,1,11,-3,8,5,2,0,1,1,1,1,1,5,1
KR_6771982250,440,1,55,8,13,0,1,1,1,3,2,1,1,0,11,12,1,0,2,2,4,17,2,0,5,5,6,0,2,1,1,1,1,5,1
KR_6349562651,420,1,91,-15,-2,2,2,0,-5,1,6,5,6,1,-3,4,7,-1,0,1,0,-3,-118,3,4,7,-8,0,1,1,-1,1,-1,6,1
KR_6770638522,420,-1,-43,12,6,0,3,3,3,5,2,2,2,0,-3,2,5,4,5,1,0,19,120,2,4,6,0,0,-1,1,1,-1,1,2,1
KR_6738690397,420,1,60,11,1,-1,4,5,0,1,1,-1,1,2,1,6,5,2,3,1,4,11,3,1,4,5,0,0,2,-1,1,1,1,4,1
KR_6757405590,440,3,42,-4,8,4,4,0,-4,2,6,1,8,7,8,9,1,-1,2,3,-1,1,45,0,5,5,-18,0,1,1,0,1,-1,1,1
KR_6722249350,420,5,39,12,4,-5,0,5,1,5,4,1,2,1,5,8,3,2,3,1,1,-3,30,4,4,8,0,0,-1,1,-1,-1,1,6,1
KR_6769215537,420,-1,7,-18,-1,0,1,1,2,2,0,1,2,1,-1,1,2,-3,0,3,0,-2,4,2,5,7,-2,0,0,-1,1,0,-1,6,1
KR_6761917246,420,2,88,20,7,4,4,0,4,4,0,3,3,0,-4,0,4,0,2,2,0,7,-16,-1,4,3,2,0,0,1,0,1,1,1,1
KR_6769441601,420,6,10,-5,8,3,3,0,3,4,1,3,7,4,0,0,0,-1,1,2,0,5,3,-3,6,3,4,0,1,1,-1,1,-1,5,1
KR_6771684241,420,-2,-69,2,-4,-2,0,2,2,6,4,2,3,1,-2,1,3,-4,2,6,0,0,-222,-1,3,2,2,0,-2,1,-1,-1,-1,6,1
KR_6578706427,420,0,42,-20,0,6,6,0,1,4,3,-4,0,4,-2,1,3,-1,0,1,1,-4,422,-2,5,3,2,0,0,1,1,1,1,4,1
KR_6762068337,420,2,11,10,1,2,3,1,6,7,1,-6,0,6,-4,1,5,3,3,0,2,14,-5,-6,12,6,2,0,1,-1,1,-1,1,4,1
KR_6762510594,420,-3,-32,-12,-2,-1,2,3,3,8,5,-2,1,3,-2,1,3,0,1,1,0,5,12,1,7,8,0,0,0,-1,1,0,-1,4,1
KR_6723287084,420,1,-25,-20,7,-1,2,3,2,2,0,2,4,2,2,7,5,2,2,0,0,11,4,2,3,5,3,0,2,1,-1,1,-1,3,1
KR_6764733282,420,-3,22,26,-8,-1,0,1,3,3,0,-5,0,5,-5,0,5,0,0,0,0,-15,16,0,7,7,-6,0,0,-1,1,0,1,1,1
KR_6765531461,420,0,-25,3,0,-4,0,4,4,5,1,0,6,6,0,3,3,0,2,2,0,5,-3,-3,6,3,4,0,-1,1,-1,-1,-1,4,1
KR_6751182008,420,4,19,19,13,2,3,1,-1,2,3,3,3,0,8,8,0,1,1,0,0,14,-27,-3,6,3,-3,0,-1,1,-1,-1,1,6,1
KR_6735910060,420,-1,-1,4,0,-2,0,2,5,5,0,-1,2,3,2,2,0,-4,2,6,0,1,9,-4,8,4,2,0,0,1,0,0,-1,1,1
KR_6765866675,420,-2,-23,15,-7,3,3,0,-7,1,8,-1,1,2,-2,0,2,0,0,0,-1,-14,-4,-4,8,4,0,0,-2,-1,-1,-1,-1,6,1
KR_6621272015,420,3,27,40,8,-2,1,3,7,13,6,-1,3,4,1,1,0,3,3,0,0,8,6,-1,4,3,3,0,-1,1,1,1,1,5,1
KR_6736366687,420,0,53,22,-2,1,2,1,-4,1,5,-3,0,3,3,4,1,1,1,0,0,-3,4,-2,5,3,-3,0,-1,-1,1,1,-1,1,1
KR_6540511763,420,4,26,8,11,0,1,1,0,4,4,8,8,0,4,4,0,-1,1,2,0,6,1,1,2,3,0,0,2,1,1,1,1,6,1
KR_6730246057,440,2,-25,-8,5,-3,0,3,2,3,1,2,2,0,3,4,1,1,1,0,1,4,15,-1,2,1,3,0,0,-1,1,0,1,6,1
KR_6654018358,420,0,23,-21,5,8,8,0,2,6,4,-2,1,3,-2,1,3,-1,0,1,1,1,2,1,6,7,2,0,2,-1,1,1,1,1,1
KR_6756912822,440,0,-25,-12,-1,-2,0,2,1,2,1,0,2,2,-1,0,1,1,1,0,0,3,2,-3,9,6,2,0,0,0,-1,-1,1,0,1
KR_6767213114,420,0,90,-15,7,5,6,1,3,4,1,-1,0,1,1,2,1,-1,0,1,0,8,-5,-2,7,5,0,0,1,-1,1,1,1,4,1
KR_6769437575,420,2,22,40,0,-2,0,2,-1,2,3,1,3,2,2,3,1,0,1,1,0,-3,7,-1,6,5,1,0,1,1,-1,1,-1,3,1
KR_6732838285,420,-2,-9,-15,-4,4,5,1,-1,4,5,-2,0,2,-6,0,6,1,1,0,0,-7,-38,-1,3,2,2,0,-1,1,-1,-1,-1,6,1
KR_6766935266,420,2,37,-15,3,-2,2,4,6,8,2,-1,1,2,0,2,2,0,0,0,0,6,-1,-1,8,7,6,0,0,1,1,-1,-1,5,1
KR_6760369882,420,2,-62,33,1,-2,1,3,0,5,5,3,3,0,0,2,2,0,0,0,0,5,7,0,3,3,-4,0,1,1,-1,-1,-1,3,1
KR_6725221607,420,0,-30,0,1,-1,3,4,4,5,1,-1,2,3,-1,3,4,0,1,1,0,6,-129,-5,9,4,0,0,1,-1,1,1,-1,3,1
KR_6625404188,420,3,29,-22,9,-1,3,4,6,7,1,5,6,1,5,6,1,-6,1,7,0,12,6,1,4,5,3,0,0,1,-1,0,1,6,1
KR_6749722083,420,4,64,8,11,2,3,1,-1,1,2,1,2,1,7,7,0,2,3,1,0,6,-4,-4,9,5,-3,0,1,1,-1,1,1,5,1
KR_6768924755,420,3,29,4,5,0,1,1,-4,0,4,2,2,0,3,3,0,4,4,0,1,9,8,-2,7,5,1,0,1,1,0,1,1,2,1
KR_6385361795,420,0,-16,-12,1,0,2,2,0,3,3,-2,2,4,0,4,4,3,3,0,0,6,-5,3,4,7,2,0,-1,-1,-1,-1,1,1,1
KR_6653565663,420,1,60,11,-3,1,1,0,-5,0,5,1,2,1,2,3,1,-2,0,2,0,-4,-23,-2,4,2,2,0,0,-1,0,1,1,2,1
KR_6640433951,420,7,92,51,12,4,5,1,2,3,1,2,3,1,5,5,0,-1,1,2,0,8,3,0,7,7,1,0,2,1,1,1,1,1,1
KR_6609505773,420,0,-27,17,6,2,3,1,2,4,2,0,1,1,2,4,2,0,0,0,0,3,29,-2,5,3,0,0,1,1,-1,-1,1,3,1
KR_6751375214,420,-1,-9,9,-1,0,2,2,0,2,2,-3,1,4,2,4,2,0,0,0,0,-2,14,-1,6,5,-1,0,0,1,-1,-1,-1,4,1
KR_6690137389,420,3,30,-5,7,1,3,2,2,4,2,3,5,2,-5,0,5,6,7,1,1,14,2,-1,4,3,1,0,1,1,1,1,1,4,1
KR_6686017033,420,4,68,-29,11,-2,0,2,5,5,0,2,2,0,6,6,0,0,0,0,1,10,-4,-2,5,3,0,0,2,1,-1,1,1,3,1
KR_6738485681,440,-3,16,24,-6,-1,0,1,-1,3,4,-1,2,3,-4,0,4,1,2,1,0,-16,3,-4,6,2,7,0,1,0,1,1,-1,0,1
KR_6654577349,420,0,-13,17,-5,-1,2,3,-3,1,4,-2,0,2,2,3,1,-1,2,3,0,-3,-2,2,2,4,-2,0,-2,1,-1,-1,1,3,1
KR_6751508200,420,0,41,-11,0,2,4,2,0,2,2,-1,2,3,-1,3,4,0,0,0,0,2,-90,0,3,3,3,0,1,0,-1,1,-1,0,1
KR_6763272205,420,2,-28,12,5,3,3,0,0,4,4,-1,2,3,4,5,1,-1,1,2,0,5,22,-3,6,3,-1,0,0,1,-1,-1,1,6,1
KR_6747472361,420,1,43,-23,-1,1,2,1,-2,0,2,3,3,0,-3,6,9,0,0,0,0,-6,484,-1,5,4,1,0,0,-1,1,1,-1,5,1
KR_6754470591,420,-1,-44,17,1,-6,1,7,4,8,4,3,3,0,-1,2,3,1,2,1,0,2,7,1,5,6,0,0,1,1,-1,1,1,4,1
KR_6683333794,420,3,35,-1,8,5,6,1,5,6,1,0,3,3,2,3,1,-4,0,4,0,1,317,-4,7,3,2,0,2,-1,1,1,1,3,1
KR_6766413123,420,1,72,19,1,0,4,4,-1,3,4,1,3,2,0,3,3,1,1,0,0,-3,-8,-2,8,6,8,0,1,1,1,1,-1,3,1
KR_6351540783,420,3,43,-7,6,3,4,1,4,6,2,0,2,2,-1,2,3,0,2,2,0,3,-1,3,7,10,2,0,1,-1,1,1,1,4,1
KR_6757892523,420,-2,-74,5,-1,4,4,0,-3,0,3,-2,4,6,2,3,1,-2,0,2,0,-1,177,3,4,7,-1,0,-1,1,-1,-1,1,4,1
KR_6761881687,420,3,68,-32,13,4,5,1,3,6,3,4,6,2,1,3,2,1,1,0,1,25,-10,3,3,6,1,0,2,0,1,1,1,0,1
KR_6690632651,420,2,22,-4,13,0,1,1,1,3,2,3,5,2,9,10,1,0,1,1,0,15,1,2,5,7,-1,0,1,1,0,1,1,4,1
KR_6760722442,420,-2,-43,0,-8,1,1,0,-2,1,3,-1,1,2,-5,0,5,-1,1,2,0,-8,-85,2,5,7,-10,0,-1,-1,1,-1,-1,4,1
KR_6642482154,420,2,64,20,9,1,1,0,5,7,2,1,2,1,2,9,7,0,1,1,0,14,-218,-3,9,6,4,0,1,0,1,1,-1,0,1
KR_6769313376,420,3,39,20,9,3,3,0,2,2,0,2,3,1,1,3,2,1,1,0,0,7,14,-2,5,3,0,0,1,0,-1,1,1,0,1
KR_6497768166,420,0,38,-32,0,1,4,3,3,7,4,-3,4,7,-1,2,3,0,1,1,0,4,-73,-4,8,4,1,0,0,-1,-1,0,1,1,1
KR_6769025104,420,0,-37,-33,4,0,0,0,6,6,0,-2,0,2,-1,3,4,1,3,2,0,6,-1,0,5,5,0,0,0,-1,1,0,1,2,1
KR_6771263598,420,-1,81,-21,5,3,3,0,1,3,2,-1,2,3,1,2,1,1,3,2,0,1,-1,0,5,5,2,0,1,-1,1,1,1,4,1
KR_6634951240,420,3,53,-7,9,1,2,1,2,6,4,1,5,4,4,4,0,1,1,0,0,8,-4,-3,6,3,5,0,1,-1,-1,1,1,4,1
KR_6725909739,420,4,47,4,6,2,4,2,-3,3,6,0,3,3,6,8,2,1,2,1,0,2,10,6,2,8,-2,0,2,-1,1,1,-1,6,1
KR_6516949295,420,-1,5,-24,5,-2,2,4,2,3,1,6,6,0,-1,1,2,0,1,1,0,6,-8,0,4,4,2,0,0,-1,1,0,1,6,1
KR_6722258920,420,3,19,8,5,-1,3,4,4,6,2,-3,0,3,4,5,1,1,1,0,0,8,4,-2,6,4,10,0,1,1,1,1,1,5,1
KR_6431611140,420,0,40,-4,-3,1,1,0,-3,1,4,3,3,0,-4,1,5,0,1,1,0,-4,-16,2,7,9,-3,0,0,-1,1,1,1,1,1
KR_6574662606,420,0,-4,4,0,5,5,0,-1,4,5,-1,2,3,-2,0,2,-1,0,1,0,-12,-22,1,4,5,0,0,0,-1,1,0,-1,4,1
KR_6763207304,420,3,15,20,4,-7,0,7,4,7,3,1,2,1,4,6,2,2,4,2,0,14,-4,5,1,6,0,0,0,1,-1,-1,1,5,1
KR_6742447869,420,-1,-46,15,3,-2,2,4,0,3,3,-4,1,5,6,9,3,3,4,1,1,3,-10,-1,6,5,-3,0,-2,-1,-1,-1,1,1,1
KR_6767927887,420,1,-19,4,0,-1,1,2,2,2,0,1,4,3,-1,3,4,-1,2,3,-3,3,5,2,6,8,-1,0,-1,-1,1,-1,-1,2,1
KR_6625121347,420,4,90,32,8,2,2,0,8,11,3,4,5,1,-6,0,6,0,1,1,0,7,-1,1,3,4,3,0,2,1,1,1,1,3,1
KR_6768173643,420,1,-34,-20,3,1,2,1,-1,2,3,4,6,2,1,4,3,-2,0,2,0,1,8,4,4,8,-4,0,0,-1,-1,0,-1,4,1
KR_6368568652,420,6,61,-13,13,3,3,0,3,4,1,1,3,2,6,6,0,0,2,2,0,15,0,0,0,0,1,0,0,-1,1,0,-1,4,1
KR_6749209987,420,0,-47,-20,9,0,2,2,2,3,1,6,8,2,2,3,1,-1,3,4,0,11,6,5,2,7,2,0,0,1,-1,0,1,2,1
KR_6664798742,420,2,33,-14,1,-3,2,5,-1,2,3,2,2,0,5,5,0,-2,0,2,0,0,3,1,4,5,2,0,0,1,-1,0,-1,3,1
KR_6691244198,420,-1,-6,-12,2,0,6,6,0,2,2,3,4,1,2,3,1,-3,0,3,0,-4,-1,2,2,4,4,0,0,1,-1,1,1,5,1
KR_6694250431,420,0,-15,13,1,-3,3,6,0,2,2,1,5,4,0,1,1,3,6,3,0,8,-5,-1,7,6,6,0,0,1,1,1,-1,5,1
KR_6694727298,420,1,11,27,-1,-1,1,2,-5,1,6,5,7,2,-1,2,3,1,3,2,0,-3,-4,-3,5,2,-1,0,1,-1,1,1,-1,6,1
KR_6303099829,420,5,44,-3,14,1,2,1,0,3,3,7,8,1,8,9,1,-2,0,2,-1,12,8,4,3,7,-1,0,1,-1,1,1,-1,6,1
KR_6770466879,420,5,35,8,11,2,2,0,3,4,1,-3,1,4,5,6,1,4,5,1,1,7,-28,7,1,8,-1,0,0,1,1,1,1,5,1
KR_6704559752,420,-2,-6,15,-2,2,2,0,-5,3,8,0,1,1,-1,1,2,2,2,0,0,-10,110,-5,8,3,0,0,1,-1,-1,1,-1,4,1
KR_6743719193,420,1,31,-1,4,3,3,0,1,3,2,5,5,0,-4,2,6,-1,0,1,0,-2,1,0,8,8,6,0,3,1,1,1,1,3,1
KR_6755752480,420,5,44,-17,14,3,4,1,0,3,3,-1,0,1,11,11,0,1,1,0,0,16,-1,-3,8,5,3,0,1,1,1,1,-1,4,1
KR_6747223593,420,3,45,4,7,4,4,0,1,5,4,4,4,0,0,2,2,-2,0,2,-1,6,0,-1,7,6,1,0,1,1,1,1,-1,1,1
KR_6635155980,420,1,19,8,4,3,3,0,-2,2,4,1,5,4,3,4,1,-1,1,2,0,0,10,3,2,5,-8,0,2,1,1,1,1,6,1
KR_6713009816,420,4,11,4,7,-4,0,4,4,4,0,2,2,0,7,8,1,-2,1,3,-2,11,33,-4,7,3,3,0,1,1,1,1,-1,1,1
KR_6721289073,420,0,-39,8,0,0,2,2,-5,3,8,3,3,0,3,5,2,-1,2,3,1,-4,96,-2,7,5,1,0,0,-1,1,0,1,5,1
KR_6761852386,420,2,-20,33,9,3,4,1,3,6,3,1,2,1,2,3,1,0,1,1,0,13,-3,-4,7,3,-3,0,0,-1,1,1,-1,1,1
KR_6767993784,440,2,18,-11,6,9,9,0,-1,1,2,0,2,2,-1,4,5,-1,4,5,0,7,114,-3,4,1,0,0,1,1,1,1,1,4,1
KR_6756558022,420,0,9,-10,3,-2,2,4,-1,1,2,2,4,2,4,4,0,0,0,0,0,4,-12,1,5,6,0,0,0,1,-1,1,1,3,1
KR_6752605712,440,-1,121,-52,-7,0,0,0,-1,1,2,-1,1,2,-5,1,6,0,1,1,0,-3,44,7,1,8,-29,0,0,-1,1,-1,-1,5,1
KR_6638038097,420,-2,-7,-17,-5,-3,0,3,0,2,2,1,2,1,-4,1,5,1,4,3,0,-4,-32,0,5,5,2,0,0,1,1,0,1,4,1
KR_6663999546,440,2,-43,52,4,0,1,1,3,4,1,6,7,1,-5,0,5,0,0,0,-1,-6,-5,6,4,10,0,0,0,-1,1,0,-1,2,1
KR_6701115961,420,3,66,27,10,5,5,0,1,4,3,2,4,2,1,3,2,1,1,0,0,4,-6,-2,6,4,8,0,1,1,1,1,1,2,1
KR_6768591911,420,5,92,57,9,0,0,0,3,6,3,2,6,4,2,8,6,2,2,0,2,10,-60,0,6,6,-1,0,2,1,-1,1,1,6,1
KR_6770419269,420,0,-21,0,2,2,5,3,1,2,1,-6,4,10,4,6,2,1,4,3,-1,8,-9,-3,3,0,2,0,0,1,1,-1,-1,5,1
KR_6728168591,420,2,-66,60,-4,2,2,0,-3,3,6,0,1,1,-5,0,5,2,2,0,0,-14,-5,-2,6,4,-3,0,0,-1,0,0,1,4,1
KR_6767842359,420,-1,-40,-24,7,3,4,1,2,5,3,-4,0,4,6,7,1,0,1,1,-1,9,31,5,3,8,-3,0,1,-1,1,1,-1,3,1
KR_6729778983,420,-1,2,4,4,-2,0,2,-3,3,6,7,7,0,1,6,5,1,1,0,1,15,-20,2,7,9,0,0,0,1,1,-1,1,5,1
KR_6748090792,420,2,48,-26,6,0,3,3,-4,0,4,-1,0,1,8,9,1,3,4,1,0,2,2,-4,5,1,4,0,0,1,-1,0,1,4,1
KR_6712936629,420,2,21,18,-5,1,2,1,1,2,1,-2,5,7,-6,1,7,1,2,1,0,1,1,-5,7,2,3,0,1,-1,0,1,1,5,1
KR_6652459780,420,2,36,5,1,0,1,1,6,7,1,1,3,2,-2,1,3,-4,0,4,0,-2,-50,0,8,8,-6,0,0,1,-1,0,1,5,1
KR_6749309240,420,-3,-40,-1,-10,-4,2,6,-1,5,6,-7,0,7,0,4,4,2,2,0,-1,-1,-33,-3,8,5,0,0,-2,1,-1,-1,-1,1,1
KR_6769021839,420,-2,-42,-4,2,-3,0,3,-3,3,6,1,3,2,7,8,1,0,0,0,-1,10,10,2,4,6,-1,0,-1,1,-1,-1,-1,2,1
KR_6078874008,420,3,16,8,5,1,2,1,6,8,2,0,2,2,-1,0,1,-1,0,1,0,11,-11,1,6,7,6,0,-1,0,0,-1,1,0,1
KR_6505583615,420,1,-7,-7,8,0,1,1,0,5,5,4,6,2,4,5,1,0,0,0,0,13,7,9,1,10,-1,0,0,1,1,0,1,1,1
KR_6746259895,420,1,81,7,-1,2,3,1,-1,0,1,-3,2,5,1,4,3,0,1,1,0,-7,2,3,6,9,4,0,0,1,-1,0,1,2,1
KR_6759064825,440,6,80,10,7,3,3,0,0,1,1,0,2,2,2,2,0,2,2,0,0,10,-32,2,1,3,22,0,1,1,0,1,1,1,1
KR_6666619925,420,0,14,28,4,-4,1,5,6,6,0,2,3,1,1,5,4,-1,0,1,0,5,-27,-2,7,5,1,0,0,1,-1,1,1,6,1
KR_6761593078,420,3,-13,11,8,2,4,2,0,1,1,3,5,2,7,7,0,-4,0,4,0,9,14,1,6,7,7,0,0,1,1,-1,1,2,1
KR_6717666315,420,1,-41,48,6,-6,2,8,12,15,3,-1,1,2,1,1,0,0,0,0,1,9,29,1,2,3,-4,0,0,1,1,-1,1,6,1
KR_6765400942,440,3,69,12,9,1,2,1,5,5,0,-1,0,1,6,6,0,-2,1,3,1,10,43,3,1,4,-14,0,4,-1,1,1,1,3,1
KR_6765474415,420,2,36,26,5,2,4,2,-5,0,5,3,3,0,3,6,3,2,4,2,1,5,0,2,3,5,4,0,0,1,0,0,1,3,1
KR_6638003661,420,4,22,-24,11,4,4,0,4,5,1,-4,0,4,5,5,0,2,2,0,0,16,110,-2,6,4,5,0,2,1,1,1,1,5,1
KR_6767529108,420,0,-34,12,-1,-3,0,3,1,4,3,3,3,0,-1,2,3,-1,0,1,0,-1,11,4,5,9,-1,0,-1,1,-1,-1,-1,3,1
KR_6765834185,420,4,65,28,10,1,1,0,8,9,1,-2,3,5,2,4,2,1,1,0,0,8,-7,-2,5,3,3,0,1,1,0,1,-1,5,1
KR_6759652956,440,0,22,4,2,5,5,0,-3,2,5,-1,2,3,0,6,6,1,2,1,1,1,8,3,3,6,2,0,2,1,1,1,1,2,1
KR_6768713636,420,1,15,32,0,-2,1,3,1,5,4,1,4,3,-2,0,2,2,3,1,0,-6,0,1,3,4,-1,0,0,1,1,0,1,5,1
KR_6771261023,420,1,12,-16,1,2,2,0,0,4,4,-2,2,4,2,2,0,-1,1,2,0,0,3,1,6,7,-9,0,0,-1,1,0,1,4,1
KR_6764071694,420,3,16,-18,8,3,3,0,2,5,3,1,2,1,-4,0,4,6,6,0,0,9,4,3,3,6,-5,0,0,0,1,0,1,0,1
KR_6750406808,420,-1,-10,24,0,-1,3,4,1,2,1,-1,1,2,2,3,1,-1,0,1,1,4,-1,1,3,4,-3,0,0,0,1,-1,-1,0,1
KR_6767289257,420,3,-9,6,10,1,3,2,4,4,0,3,6,3,1,1,0,1,1,0,0,12,14,2,5,7,-2,0,0,-1,1,1,1,1,1
KR_6707305221,420,5,102,26,14,6,6,0,1,4,3,10,11,1,-1,4,5,-2,1,3,2,5,17,2,5,7,-1,0,4,1,-1,1,1,3,1
KR_6768911356,420,1,15,-1,0,-1,1,2,6,6,0,-5,2,7,-1,1,2,1,1,0,0,7,-6,1,5,6,0,0,0,0,1,0,1,0,1
KR_6655941165,420,0,-53,-3,5,-2,1,3,2,3,1,1,3,2,2,3,1,2,2,0,0,7,0,-1,4,3,1,0,0,-1,1,1,-1,1,1
KR_6764467190,420,2,17,19,4,2,2,0,2,4,2,-3,0,3,2,2,0,1,2,1,0,4,3,0,6,6,0,0,0,1,-1,0,1,2,1
KR_6653642025,420,2,34,-3,6,2,3,1,0,2,2,2,4,2,5,6,1,-3,1,4,1,2,3,1,1,2,-1,0,1,1,1,1,1,5,1
KR_6657376810,420,0,-23,5,2,-1,4,5,2,3,1,-1,5,6,0,3,3,2,3,1,2,8,16,1,3,4,-1,0,0,-1,-1,0,1,1,1
KR_6769434648,420,1,10,8,5,-1,3,4,0,3,3,4,7,3,2,4,2,0,2,2,0,12,2,-1,8,7,0,0,1,-1,1,1,1,3,1
KR_6689126172,420,0,-76,-4,7,0,1,1,2,5,3,6,9,3,5,5,0,-6,0,6,0,15,5,4,3,7,1,0,0,1,1,1,1,3,1
KR_6755325636,420,-1,8,-44,-4,2,2,0,-1,1,2,1,2,1,0,0,0,-6,0,6,0,-6,-10,-4,8,4,2,0,0,-1,-1,0,1,4,1
KR_6760675973,440,-3,-46,-36,-4,-1,2,3,6,8,2,0,3,3,-3,2,5,-6,2,8,0,3,-20,0,4,4,3,0,-1,1,-1,-1,1,3,1
KR_6728445106,420,0,15,12,3,1,3,2,2,4,2,1,2,1,1,5,4,-2,0,2,1,0,17,1,4,5,-3,0,1,1,0,1,1,1,1
KR_6730370727,420,2,23,-2,7,2,3,1,0,3,3,5,5,0,0,0,0,0,0,0,0,1,-8,5,3,8,-1,0,0,0,1,0,1,0,1
KR_6709372667,420,2,-7,17,5,0,3,3,3,5,2,-4,2,6,2,3,1,4,4,0,0,-1,-2,4,2,6,2,0,-1,1,-1,-1,-1,2,1
KR_6700846966,420,2,-4,20,12,-1,3,4,6,6,0,2,2,0,4,5,1,1,1,0,0,15,15,3,4,7,1,0,0,1,-1,-1,-1,6,1
KR_6737484101,420,2,57,12,-4,4,4,0,-3,1,4,1,1,0,-2,2,4,-4,1,5,1,0,15,2,5,7,0,0,1,1,-1,1,1,2,1
KR_6468502471,440,-1,-26,-33,-5,-5,2,7,-3,2,5,0,5,5,4,6,2,-1,2,3,1,-2,-4,-2,5,3,1,0,-1,-1,0,-1,1,3,1
KR_6717012455,420,6,101,21,19,1,1,0,3,4,1,6,7,1,10,11,1,-1,0,1,0,7,3,4,1,5,-1,0,1,-1,1,1,1,1,1
KR_6665836074,420,-1,55,-22,2,4,6,2,3,3,0,3,5,2,-2,0,2,-6,0,6,-1,-6,-3,-5,10,5,-4,0,3,-1,1,1,-1,1,1
KR_6751109837,440,0,-59,-16,6,0,2,2,4,4,0,2,4,2,0,2,2,0,1,1,0,5,-11,1,1,2,3,0,-1,-1,-1,-1,1,5,1
KR_6690318451,420,0,69,-14,2,-1,2,3,1,4,3,1,2,1,-1,2,3,2,2,0,0,-2,31,2,3,5,-5,0,1,1,1,1,-1,5,1
KR_6768911923,420,-1,27,-12,-2,4,5,1,-3,0,3,-7,2,9,4,4,0,0,0,0,0,2,7,-3,5,2,1,0,1,1,-1,1,1,4,1
KR_6764288138,420,3,39,-7,9,2,3,1,6,8,2,0,0,0,2,2,0,-1,0,1,-1,1,4,1,4,5,5,0,0,1,-1,1,-1,6,1
KR_6761194691,420,0,10,24,2,5,5,0,-1,1,2,3,6,3,-5,1,6,0,0,0,0,-9,-1,1,6,7,-5,0,0,-1,-1,1,1,1,1
KR_6752623870,420,-2,4,15,-1,5,5,0,-2,2,4,-1,6,7,-3,2,5,0,1,1,0,-12,-13,-4,8,4,0,0,-1,-1,-1,-1,-1,4,1
KR_6662308853,440,-2,25,4,-4,-1,1,2,1,3,2,-5,0,5,1,1,0,0,1,1,0,-3,33,0,7,7,0,0,-1,-1,-1,-1,1,3,1
KR_6771507634,420,0,13,28,1,0,2,2,-2,2,4,-1,0,1,3,3,0,1,1,0,0,3,6,1,6,7,-3,0,1,1,1,1,1,2,1
KR_6771777890,420,-5,10,-32,-4,2,5,3,3,4,1,1,2,1,-10,2,12,0,0,0,0,-7,2,0,6,6,-3,0,-1,1,-1,-1,1,5,1
KR_6760692712,420,6,56,22,14,-3,1,4,5,7,2,4,6,2,7,9,2,1,1,0,0,11,-7,0,2,2,2,0,1,1,0,1,1,4,1
KR_6385298847,420,2,30,35,-1,-1,2,3,0,2,2,1,3,2,0,2,2,-1,0,1,-1,-4,4,0,5,5,-4,0,1,-1,1,1,-1,3,1
KR_6731393632,420,0,-3,-8,-2,2,2,0,-2,1,3,1,7,6,-3,1,4,0,0,0,0,0,11,1,3,4,2,0,0,-1,-1,1,-1,4,1
KR_6771481094,420,8,153,46,21,2,3,1,4,6,2,-4,2,6,14,14,0,5,7,2,0,19,6,5,2,7,-1,0,2,1,1,1,1,5,1
KR_6741286956,420,2,17,12,3,5,5,0,0,3,3,-2,1,3,2,2,0,-2,1,3,0,-2,2,4,4,8,2,0,0,0,1,1,1,0,1
KR_6654857190,420,3,77,27,3,-1,2,3,-4,1,5,4,5,1,6,8,2,-2,2,4,0,1,-2,-3,8,5,0,0,1,-1,1,1,1,4,1
KR_6756756853,420,-2,33,-24,-4,2,5,3,-6,1,7,1,2,1,-1,2,3,0,1,1,0,-11,77,4,5,9,10,0,2,-1,-1,1,1,4,1
KR_6745504068,420,0,48,14,3,-1,0,1,6,7,1,-3,2,5,0,5,5,1,1,0,0,10,-21,3,2,5,2,0,-1,-1,-1,-1,1,3,1
KR_6709544802,420,3,22,5,10,2,2,0,1,5,4,2,5,3,4,7,3,1,2,1,-1,2,-41,-1,7,6,8,0,0,1,0,-1,-1,6,1
KR_6764765143,440,2,60,-16,2,1,4,3,-1,1,2,-3,2,5,2,4,2,3,3,0,1,4,1,1,4,5,-3,0,1,1,0,1,1,6,1
KR_6755405970,420,4,26,17,6,-1,1,2,7,8,1,-2,2,4,3,5,2,-1,1,2,0,7,3,2,3,5,2,0,0,1,0,0,-1,6,1
KR_6770154357,420,2,-6,3,7,2,3,1,1,1,0,2,4,2,1,2,1,1,3,2,1,15,-41,-2,5,3,3,0,0,-1,0,0,1,1,1
KR_6716574958,420,-1,78,-14,-1,-1,3,4,-3,1,4,-3,2,5,5,5,0,1,1,0,1,2,30,0,5,5,-6,0,0,1,-1,1,1,6,1
KR_6636031320,420,5,66,52,10,2,3,1,8,9,1,-1,4,5,3,3,0,-2,0,2,0,9,112,-3,10,7,8,0,1,1,1,1,1,5,1
KR_6749827297,420,-1,-63,-4,0,0,2,2,3,5,2,2,5,3,-6,1,7,1,1,0,0,-1,3,1,3,4,-1,0,0,-1,1,-1,-1,1,1
KR_6668379777,420,3,86,8,4,1,2,1,7,10,3,-3,0,3,-2,4,6,1,2,1,0,-5,0,-4,10,6,2,0,1,-1,-1,1,-1,5,1
KR_6723145762,420,6,86,27,11,3,3,0,3,4,1,3,5,2,2,3,1,0,1,1,0,14,44,3,1,4,-11,0,3,1,-1,1,1,4,1
KR_6736216767,420,-2,-67,-5,6,1,2,1,5,7,2,0,1,1,0,1,1,0,1,1,0,2,63,-4,9,5,4,0,-1,-1,1,1,1,2,1
KR_6701399288,420,8,118,39,18,2,2,0,5,7,2,7,7,0,3,5,2,1,1,0,3,27,5,1,5,6,8,0,2,1,0,1,1,1,1
KR_6764013234,420,3,55,7,4,1,1,0,-3,3,6,5,6,1,-1,2,3,2,2,0,0,5,32,4,1,5,0,0,0,1,-1,0,-1,1,1
KR_6737507156,440,-2,-83,15,-9,-3,3,6,0,1,1,-6,1,7,-1,6,7,1,3,2,1,8,-3,1,3,4,-2,0,-2,-1,0,-1,1,1,1
KR_6642728822,420,-1,8,1,3,-1,1,2,0,3,3,1,2,1,2,4,2,1,2,1,0,10,3,-5,7,2,1,0,0,1,-1,0,-1,6,1
KR_6762854521,420,-1,-48,3,-9,0,1,1,-1,1,2,-7,1,8,-2,4,6,1,3,2,0,-1,-4,-3,4,1,-1,0,-1,1,-1,-1,-1,6,1
KR_6640494207,420,5,37,3,11,2,4,2,1,3,2,2,3,1,3,4,1,3,4,1,0,7,51,1,4,5,-31,0,0,1,-1,1,1,1,1
KR_6398360023,420,0,0,0,-9,-5,1,6,0,3,3,-3,1,4,0,3,3,-1,0,1,0,-10,-3,2,2,4,-3,0,0,-1,0,0,-1,4,1
KR_6688460273,420,1,35,12,11,6,8,2,2,3,1,2,4,2,3,6,3,-2,2,4,0,7,3,-1,3,2,2,0,2,1,1,1,1,3,1
KR_6654306383,440,-4,33,-22,-3,-1,1,2,0,3,3,2,3,1,-1,2,3,-3,2,5,0,-6,-20,3,5,8,0,0,-1,-1,0,-1,1,5,1
KR_6679945849,420,-1,30,-17,3,1,3,2,4,5,1,0,2,2,-2,2,4,0,0,0,0,1,-5,1,4,5,1,0,0,1,-1,0,-1,2,1
KR_6760709053,440,1,82,24,2,3,3,0,2,2,0,2,5,3,-5,1,6,0,1,1,1,0,-13,2,3,5,2,0,0,1,-1,1,1,3,1
KR_6731719527,420,5,60,-12,12,7,9,2,1,3,2,-8,2,10,11,11,0,1,3,2,3,17,-103,3,4,7,1,0,2,1,-1,1,-1,5,1
KR_6764132746,420,4,6,24,7,2,5,3,6,7,1,2,4,2,-1,6,7,-2,0,2,0,3,-6,-3,7,4,5,0,-1,-1,-1,-1,1,2,1
KR_6650794712,420,1,-1,17,1,-4,0,4,0,2,2,2,2,0,3,4,1,0,0,0,0,3,-2,4,3,7,2,0,0,-1,1,0,1,4,1
KR_6744112692,420,1,71,28,5,3,5,2,4,6,2,0,2,2,-3,1,4,1,1,0,0,0,-10,0,6,6,3,0,2,-1,1,1,1,5,1
KR_6767120305,420,4,76,6,5,-1,0,1,7,7,0,-1,4,5,1,4,3,-1,1,2,0,2,-3,0,3,3,-2,0,0,1,-1,1,-1,3,1
KR_6735772884,440,4,45,11,4,5,6,1,-3,3,6,2,5,3,0,2,2,0,2,2,0,-3,25,1,5,6,-1,0,0,0,1,1,-1,0,1
KR_6768706766,420,1,-22,-8,-1,0,1,1,0,1,1,1,3,2,-2,1,3,0,1,1,0,-11,-1,0,6,6,-9,0,0,-1,1,0,1,2,1
KR_5999813498,420,1,-12,-8,3,-4,0,4,3,3,0,1,2,1,3,3,0,0,0,0,0,8,-31,1,4,5,3,0,-1,1,-1,-1,-1,3,1
KR_6742214475,420,2,2,0,0,0,4,4,0,5,5,-1,0,1,0,3,3,1,2,1,0,3,28,-1,4,3,3,0,0,1,-1,-1,-1,5,1
KR_6768786449,440,-2,-47,0,-5,1,1,0,-6,0,6,3,3,0,-2,0,2,-1,2,3,0,-8,20,0,5,5,0,0,0,1,1,0,-1,2,1
KR_6764153182,420,2,-3,2,5,3,5,2,1,4,3,-6,2,8,5,7,2,2,5,3,-1,3,2,2,4,6,4,0,0,1,1,0,-1,2,1
KR_6727101717,440,2,64,4,7,4,4,0,2,5,3,3,4,1,-2,3,5,0,1,1,0,-1,-15,-3,4,1,3,0,0,1,1,0,1,3,1
KR_6496375224,420,2,90,36,5,0,0,0,-1,1,2,2,4,2,3,4,1,1,1,0,1,1,-41,0,4,4,2,0,1,1,1,1,1,4,1
KR_6763515270,420,4,5,16,9,-2,1,3,2,3,1,3,3,0,5,7,2,1,2,1,0,9,2,1,3,4,0,0,2,1,0,1,1,4,1
KR_6579037170,420,-2,17,-10,-9,-5,1,6,-2,0,2,1,2,1,-4,2,6,1,1,0,0,-13,367,-3,7,4,-1,0,0,1,0,0,-1,4,1
KR_6681065245,420,5,138,-20,11,2,3,1,4,5,1,2,4,2,4,5,1,-1,0,1,0,12,4,6,2,8,-1,0,1,1,-1,1,1,3,1
KR_6767412458,420,2,0,0,8,1,3,2,4,5,1,1,3,2,2,2,0,0,0,0,0,5,-10,2,4,6,2,0,0,1,0,0,1,4,1
KR_5539752580,420,3,30,15,6,0,3,3,3,4,1,-2,2,4,6,7,1,-1,0,1,0,5,4,-5,11,6,1,0,1,1,0,1,1,2,1
KR_6768430426,420,5,16,28,9,3,3,0,3,7,4,2,3,1,0,4,4,1,1,0,1,12,-2,0,5,5,-3,0,0,-1,1,1,1,1,1
KR_6769997791,420,2,33,-9,4,4,7,3,2,4,2,1,1,0,-3,1,4,0,0,0,-1,6,-1,-2,6,4,1,0,-1,-1,-1,-1,-1,3,1
KR_6762971119,420,1,28,24,0,0,0,0,0,1,1,3,3,0,-1,0,1,-2,0,2,0,-6,-45,2,5,7,-7,0,0,1,1,0,1,3,1
KR_6731120524,440,6,54,23,26,9,10,1,5,8,3,10,11,1,3,5,2,-1,2,3,3,32,-2,-1,3,2,2,0,2,1,1,1,1,3,1
KR_6760378603,420,-1,0,9,-1,0,1,1,0,2,2,-3,1,4,4,9,5,-2,0,2,-1,5,-1,1,3,4,-1,0,0,1,1,1,-1,3,1
KR_6766967187,440,3,66,3,8,6,7,1,-3,1,4,0,1,1,3,7,4,2,2,0,0,-1,-1,2,3,5,5,0,1,-1,1,1,1,5,1
KR_6716512840,420,-3,15,-2,-2,-2,0,2,-1,2,3,1,1,0,0,0,0,0,0,0,0,-3,-29,3,4,7,0,0,0,1,1,0,-1,5,1
KR_6739340735,420,2,8,11,4,-3,2,5,3,5,2,3,3,0,-1,4,5,2,3,1,0,3,-1,-1,7,6,-1,0,-1,1,-1,-1,1,5,1
KR_6697949307,420,2,53,4,4,4,5,1,2,3,1,0,1,1,-1,1,2,-1,0,1,0,5,-27,4,2,6,-2,0,0,0,0,1,-1,0,1
KR_6574619406,420,0,22,-16,0,-1,2,3,-3,4,7,-1,3,4,5,6,1,0,1,1,-1,5,14,-5,10,5,0,0,1,1,1,1,1,3,1
KR_6767510227,420,2,34,27,13,2,4,2,6,8,2,4,4,0,1,2,1,0,0,0,4,19,7,5,0,5,-3,0,0,1,1,1,1,5,1
KR_6767113586,420,0,51,-34,-3,-1,3,4,-1,2,3,-2,1,3,2,2,0,-1,1,2,0,-3,-31,1,6,7,-1,0,-1,1,-1,-1,-1,2,1
KR_6717935276,420,4,53,12,4,1,2,1,0,5,5,1,4,3,-1,2,3,3,3,0,0,3,-57,1,3,4,5,0,1,1,1,1,1,2,1
KR_6398488972,420,3,-57,-16,2,0,0,0,3,5,2,-1,1,2,0,1,1,0,1,1,0,10,3,2,3,5,-5,0,0,-1,1,0,-1,1,1
KR_6759814001,420,-1,3,-4,0,1,4,3,0,1,1,-2,3,5,4,12,8,-3,0,3,-1,-7,-6,-5,9,4,1,0,2,-1,0,1,-1,5,1
KR_6728376126,420,2,19,0,5,2,2,0,3,7,4,0,1,1,0,1,1,0,0,0,0,0,39,-1,4,3,-3,0,0,1,1,1,1,6,1
KR_6727533755,440,0,9,-3,-3,2,5,3,-1,1,2,-3,0,3,1,2,1,-2,0,2,1,-6,26,-1,1,0,0,0,0,-1,-1,1,1,3,1
KR_6761312651,420,0,24,11,0,0,1,1,-2,0,2,1,2,1,1,2,1,0,1,1,0,1,0,2,4,6,0,0,0,0,-1,0,1,0,1
KR_6770698859,420,-1,-77,-9,1,-2,5,7,-2,1,3,6,8,2,0,0,0,-1,0,1,-1,3,-108,1,5,6,-4,0,-1,-1,1,-1,-1,4,1
KR_6622562996,420,4,83,40,7,3,3,0,4,5,1,0,2,2,0,2,2,0,1,1,0,4,-2,1,3,4,4,0,1,1,1,1,1,6,1
KR_6760001154,420,2,30,0,0,3,4,1,-6,3,9,-1,3,4,4,4,0,0,0,0,0,-7,7,0,5,5,3,0,2,-1,1,1,1,3,1
KR_6727940317,440,0,-9,-8,7,0,0,0,9,9,0,2,2,0,0,1,1,-4,1,5,0,0,0,0,7,7,2,0,0,1,0,0,1,4,1
KR_6558830425,420,0,22,12,-4,0,0,0,1,6,5,-2,3,5,1,4,3,-4,0,4,0,-9,10,-1,5,4,0,0,1,0,1,1,-1,0,1
KR_6751035047,420,4,22,32,8,3,3,0,8,8,0,6,6,0,-8,2,10,-1,1,2,0,0,-7,-2,7,5,4,0,0,-1,1,1,1,5,1
KR_6768634824,420,-1,-72,1,-3,-7,0,7,0,5,5,0,3,3,4,4,0,0,2,2,0,5,2,2,4,6,-3,0,-2,1,-1,-1,1,1,1
KR_6722744048,420,1,33,28,4,-2,0,2,-2,2,4,4,5,1,3,6,3,1,2,1,-1,7,-2,-2,4,2,2,0,2,1,-1,1,-1,1,1
KR_6667138728,440,4,72,20,8,-2,1,3,1,2,1,6,6,0,3,3,0,0,0,0,0,6,8,0,5,5,2,0,0,1,1,1,-1,2,1
KR_6662415841,420,1,-9,-37,4,-3,3,6,1,7,6,3,3,0,3,3,0,0,0,0,0,7,-113,2,6,8,-7,0,-2,1,-1,-1,-1,6,1
KR_6760114168,420,4,61,-2,7,4,5,1,3,4,1,4,4,0,-3,1,4,-1,0,1,0,0,-2,-3,5,2,-1,0,1,-1,1,1,1,3,1
KR_6662698512,440,4,81,12,6,1,3,2,0,1,1,1,2,1,4,5,1,0,1,1,0,2,2,0,2,2,-1,0,1,1,1,1,-1,3,1
KR_6758175708,440,0,5,14,-2,-1,0,1,1,3,2,-4,1,5,0,3,3,2,2,0,0,-9,-162,-5,6,1,0,0,-1,-1,1,-1,1,6,1
KR_6666149888,420,0,29,4,-3,2,2,0,-1,1,2,-2,3,5,-3,2,5,1,1,0,1,-2,75,-3,9,6,-17,0,1,-1,1,1,1,6,1
KR_6679289858,440,2,44,-9,9,1,2,1,4,5,1,-1,2,3,3,3,0,2,3,1,0,12,5,0,4,4,3,0,0,1,1,0,1,1,1
KR_6674825729,420,0,-9,19,4,3,4,1,2,3,1,-1,1,2,-6,2,8,6,6,0,0,3,3,1,6,7,4,0,0,1,0,0,1,5,1
KR_6557237698,420,1,47,0,12,3,3,0,2,4,2,-1,1,2,8,9,1,0,1,1,0,12,13,1,5,6,0,0,1,1,1,1,1,4,1
KR_6681213349,420,5,58,16,12,3,3,0,1,1,0,6,7,1,3,3,0,-1,0,1,0,12,-4,5,4,9,-1,0,2,1,1,1,1,4,1
KR_6629704981,420,5,49,32,9,2,4,2,2,4,2,3,5,2,2,2,0,0,0,0,0,6,-22,-7,7,0,1,0,2,1,1,1,1,6,1
KR_6725308634,420,2,36,-19,3,4,4,0,2,4,2,1,1,0,-3,0,3,-1,1,2,0,-3,1,1,8,9,2,0,0,-1,1,1,-1,6,1
KR_6717352097,420,5,63,-12,7,2,2,0,4,5,1,1,2,1,0,4,4,0,2,2,0,-1,50,0,6,6,-11,0,0,-1,1,1,1,6,1
KR_6750961953,420,7,71,22,14,4,5,1,1,5,4,2,4,2,5,5,0,2,2,0,1,15,1,1,6,7,2,0,1,1,1,1,1,2,1
KR_6654902356,420,1,12,9,1,5,5,0,-5,2,7,-2,1,3,0,2,2,3,4,1,0,0,-6,0,3,3,3,0,1,1,1,1,-1,4,1
KR_6438675631,420,-3,15,-13,-3,3,3,0,-2,1,3,-2,0,2,2,2,0,-4,2,6,0,-6,9,2,5,7,-3,0,0,1,1,0,1,5,1
KR_6758091959,440,3,56,21,4,2,4,2,-2,0,2,0,4,4,2,3,1,2,2,0,0,6,-13,-1,2,1,2,0,0,1,-1,-1,-1,5,1
KR_6742299591,420,3,20,28,3,-1,2,3,6,8,2,0,3,3,-3,1,4,1,2,1,0,3,-5,-6,7,1,2,0,-1,0,1,-1,-1,0,1
KR_6694159246,420,2,43,-6,3,-1,2,3,0,2,2,2,4,2,1,3,2,1,1,0,0,8,-7,6,2,8,0,0,0,-1,0,0,-1,3,1
KR_6755195626,420,3,2,9,10,5,6,1,2,2,0,-4,0,4,8,11,3,-1,1,2,0,10,12,2,8,10,-1,0,1,1,0,1,-1,3,1
KR_6570288949,420,3,-21,-4,4,-1,1,2,2,4,2,-4,1,5,4,5,1,3,3,0,0,1,-16,2,3,5,4,0,2,0,1,1,1,0,1
KR_6758087774,420,-3,-37,-9,-11,-3,1,4,0,4,4,-2,0,2,-6,3,9,0,1,1,0,-9,-5,-7,10,3,2,0,-2,-1,-1,-1,-1,5,1
KR_6315921116,420,3,21,38,8,9,9,0,1,5,4,3,3,0,-1,0,1,-4,0,4,1,-4,-20,-3,8,5,2,0,2,1,1,1,1,5,1
KR_6771561764,420,-1,-10,1,6,-1,3,4,6,8,2,-1,0,1,2,4,2,0,3,3,0,-2,-14,0,3,3,5,0,-1,1,1,1,1,1,1
KR_6738883204,420,6,116,12,10,7,7,0,-2,3,5,4,5,1,-1,2,3,2,2,0,0,14,-19,2,2,4,5,0,2,1,1,1,-1,2,1
KR_6770107838,420,3,-13,16,6,-2,1,3,4,7,3,2,2,0,1,3,2,1,1,0,0,10,7,6,2,8,1,0,-1,1,-1,-1,1,4,1
KR_6761911135,420,4,2,12,10,0,1,1,7,8,1,3,3,0,-1,2,3,1,4,3,0,1,-5,-1,5,4,2,0,0,0,0,0,1,0,1
KR_6722814955,420,-1,-26,12,0,-6,0,6,-3,1,4,-2,1,3,11,11,0,0,1,1,2,6,-6,1,4,5,3,0,0,1,-1,-1,1,4,1
KR_6601508958,420,3,71,56,11,-1,1,2,5,7,2,2,2,0,3,5,2,2,3,1,2,11,11,1,5,6,-1,0,2,1,1,1,1,5,1
KR_6675589395,440,1,-54,-12,5,-2,0,2,0,2,2,3,4,1,2,4,2,2,2,0,0,14,-410,-3,4,1,4,0,0,1,-1,0,1,3,1
KR_6737509848,420,2,51,12,2,-7,0,7,3,4,1,1,4,3,5,5,0,0,0,0,-1,8,-122,-2,7,5,2,0,2,1,1,1,-1,4,1
KR_6662202941,420,0,16,-2,-4,4,5,1,-4,4,8,3,4,1,-6,2,8,-1,0,1,1,-13,6,1,8,9,-4,0,0,-1,-1,-1,1,5,1
KR_6761635462,420,-1,7,-5,-3,0,4,4,3,4,1,-3,2,5,-3,3,6,0,4,4,0,2,-113,-5,6,1,1,0,0,-1,-1,-1,-1,6,1
KR_6695704526,420,5,144,12,16,6,6,0,1,2,1,1,4,3,7,8,1,1,2,1,0,12,-111,-4,7,3,5,0,1,1,-1,1,1,2,1
KR_6771082523,420,0,-2,16,2,5,5,0,-3,3,6,1,2,1,0,1,1,-1,0,1,0,4,9,-3,7,4,-5,0,0,1,1,0,1,6,1
KR_6753288001,420,3,97,-32,7,6,7,1,0,1,1,-1,2,3,2,5,3,0,2,2,2,8,13,-2,8,6,-2,0,1,0,-1,1,1,0,1
KR_6769499202,420,-3,-46,-29,4,2,2,0,2,2,0,1,3,2,0,3,3,-1,2,3,0,1,-10,-1,5,4,-1,0,-1,-1,-1,-1,1,2,1
KR_6736861813,420,2,71,23,-2,1,1,0,0,2,2,-4,0,4,1,3,2,0,1,1,0,-3,4,0,5,5,-1,0,0,1,0,0,-1,5,1
KR_6755480713,420,2,14,12,3,0,2,2,2,4,2,1,3,2,-3,1,4,3,3,0,-1,-2,2,1,2,3,1,0,0,1,1,0,-1,1,1
KR_6769302045,420,-2,-84,21,-4,3,4,1,2,3,1,-2,5,7,-4,3,7,-3,0,3,0,-16,-8,-5,8,3,1,0,0,-1,1,1,-1,1,1
KR_6749471721,420,3,52,-26,11,7,9,2,2,6,4,3,5,2,3,5,2,-4,0,4,0,3,5,4,4,8,3,0,2,-1,1,1,1,3,1
KR_6769811093,420,4,68,-2,15,3,4,1,9,9,0,1,1,0,1,1,0,1,1,0,1,16,15,7,1,8,-4,0,3,1,1,1,1,2,1
KR_6556151361,420,3,-11,-7,7,1,2,1,-2,1,3,1,1,0,4,6,2,3,3,0,0,3,6,1,4,5,-5,0,1,-1,-1,1,1,5,1
KR_6684350535,420,0,-20,13,5,0,3,3,1,7,6,-1,4,5,5,5,0,0,0,0,0,14,-134,-1,8,7,3,0,0,-1,-1,0,1,3,1
KR_6684376075,420,2,5,27,3,0,3,3,7,10,3,0,4,4,-4,1,5,0,1,1,1,1,0,1,4,5,1,0,0,-1,-1,1,1,2,1
KR_6744429965,440,0,107,-16,11,-3,2,5,5,9,4,11,12,1,-2,0,2,0,3,3,-1,14,-20,2,7,9,0,0,4,1,1,1,-1,3,1
KR_6652369397,420,5,40,12,13,3,3,0,5,5,0,-4,1,5,4,5,1,5,6,1,1,19,-4,1,6,7,4,0,2,1,1,1,1,1,1
KR_6768574737,420,-2,53,12,-5,-6,0,6,3,3,0,-2,0,2,-1,1,2,1,1,0,0,-7,4,-5,7,2,4,0,0,1,1,1,1,5,1
KR_6555484826,440,0,27,-4,4,2,2,0,4,7,3,0,5,5,-4,2,6,2,6,4,2,7,3,0,2,2,-2,0,1,-1,1,1,1,2,1
KR_6693081314,420,4,23,17,3,2,3,1,-3,2,5,3,3,0,0,6,6,1,1,0,0,5,4,2,5,7,-1,0,0,1,1,0,-1,2,1
KR_6657211897,420,3,77,11,6,1,2,1,3,4,1,-2,3,5,4,6,2,0,0,0,1,-2,-1,-1,5,4,4,0,0,1,1,1,-1,3,1
KR_6624964633,420,4,15,13,8,1,2,1,1,2,1,2,3,1,3,3,0,1,2,1,0,13,-20,4,5,9,2,0,1,0,1,1,1,0,1
KR_6658127442,420,6,73,11,11,4,4,0,1,1,0,0,4,4,5,5,0,1,1,0,0,14,40,1,3,4,3,0,1,1,1,1,1,1,1
KR_6763525068,420,-3,-21,-8,-2,-3,0,3,-3,2,5,2,3,1,3,4,1,-1,1,2,0,1,-27,1,5,6,5,0,1,1,1,1,1,1,1
KR_6771786879,440,1,60,-6,0,1,3,2,2,2,0,-2,0,2,-3,1,4,2,2,0,0,1,32,-6,8,2,1,0,1,1,0,1,1,2,1
KR_6759057921,420,6,93,12,13,4,4,0,2,6,4,1,1,0,2,4,2,4,4,0,0,8,22,0,8,8,2,0,0,1,1,1,1,4,1
KR_6770949918,440,5,120,-4,11,-1,2,3,2,6,4,6,7,1,1,1,0,3,3,0,0,13,22,-2,5,3,-23,0,2,1,1,1,1,6,1
KR_6730185848,440,3,31,-12,7,2,2,0,-3,0,3,-1,1,2,5,6,1,4,4,0,0,11,240,-7,10,3,4,0,1,1,-1,1,1,6,1
KR_6767890319,420,-1,37,-8,-4,3,5,2,1,3,2,0,3,3,-5,0,5,-3,1,4,-1,-9,-1,2,2,4,1,0,1,-1,1,1,-1,2,1
KR_6737322633,420,3,73,12,9,0,1,1,0,2,2,4,4,0,1,4,3,4,4,0,0,10,22,4,3,7,1,0,2,1,1,1,1,5,1
KR_6435479102,420,2,-57,29,7,-2,1,3,3,5,2,0,2,2,6,7,1,0,0,0,0,15,-1,-1,4,3,2,0,0,1,1,-1,-1,4,1
KR_6734398998,420,2,80,4,5,2,3,1,3,6,3,-4,1,5,4,6,2,0,2,2,0,-2,-11,1,4,5,2,0,0,-1,1,0,-1,2,1
KR_6686070575,420,1,29,-43,7,2,3,1,-3,2,5,3,5,2,6,7,1,-1,0,1,0,4,4,0,3,3,-3,0,1,-1,1,1,-1,5,1
KR_6587204083,420,3,31,32,5,-3,3,6,1,5,4,2,4,2,3,6,3,2,3,1,-1,-1,-210,0,12,12,3,0,1,-1,1,1,-1,1,1
KR_6749976268,420,6,77,68,7,1,2,1,2,2,0,2,2,0,2,2,0,0,0,0,0,6,11,1,6,7,3,0,1,1,1,1,1,1,1
KR_6741706693,440,2,43,0,-4,4,4,0,-1,3,4,0,4,4,-1,2,3,-6,0,6,-2,-16,6,0,1,1,-1,0,1,0,-1,1,-1,0,1
KR_6761240110,420,2,0,4,8,2,3,1,2,3,1,2,4,2,4,5,1,-2,0,2,0,20,61,-2,6,4,-2,0,1,-1,1,1,-1,6,1
KR_6657196372,420,1,48,-21,0,-2,2,4,2,6,4,1,4,3,0,3,3,-1,1,2,0,0,6,0,4,4,0,0,1,0,1,1,-1,0,1
KR_6766089763,420,3,34,40,8,3,4,1,3,7,4,1,2,1,5,6,1,-4,1,5,0,4,-28,-2,4,2,-3,0,-1,1,1,-1,1,3,1
KR_6729714882,420,7,21,41,8,3,3,0,-1,3,4,-1,0,1,6,6,0,1,1,0,1,6,-42,2,3,5,44,0,0,1,1,0,1,3,1
KR_6754117868,420,0,94,-4,6,4,4,0,-4,1,5,2,4,2,2,5,3,2,3,1,1,0,-44,1,5,6,28,0,1,-1,-1,1,1,4,1
KR_6771162425,420,-5,-23,-28,-9,-2,0,2,-7,2,9,0,0,0,-3,2,5,3,3,0,0,-8,11,0,6,6,-2,0,0,-1,-1,-1,-1,2,1
KR_6652591149,420,0,26,8,5,4,4,0,1,4,3,2,2,0,-2,1,3,0,0,0,0,1,0,4,3,7,-4,0,1,1,1,1,1,4,1
KR_6770462915,420,-1,-11,36,1,3,3,0,1,2,1,-2,1,3,-1,0,1,0,2,2,1,-6,-4,5,5,10,-4,0,1,1,-1,1,1,5,1
KR_6711507585,420,-3,0,-36,-2,-2,1,3,5,5,0,-5,1,6,-2,0,2,2,3,1,-1,2,260,0,3,3,0,0,-1,1,1,-1,-1,2,1
KR_6742422342,420,1,-31,6,6,1,1,0,2,4,2,2,4,2,1,4,3,0,0,0,0,7,0,7,1,8,-2,0,-1,1,-1,-1,1,3,1
KR_6638253611,420,11,111,63,20,5,5,0,3,3,0,3,3,0,6,6,0,3,5,2,3,22,-58,7,4,11,3,0,5,1,1,1,1,6,1
KR_6733524787,420,-1,25,-5,-5,0,4,4,2,4,2,-5,1,6,-1,1,2,-1,0,1,1,-2,216,-2,7,5,-1,0,2,1,1,1,1,2,1
KR_6698846836,420,2,-65,8,5,2,6,4,0,2,2,-1,1,2,1,3,2,3,3,0,0,6,1,-2,5,3,5,0,1,1,1,1,-1,6,1
KR_6648940888,420,2,0,23,3,1,2,1,0,3,3,1,3,2,0,1,1,1,2,1,0,-1,-53,-2,7,5,29,0,0,1,1,0,1,6,1
KR_6739968862,420,2,103,49,4,0,2,2,0,3,3,3,3,0,-2,3,5,3,3,0,0,2,-2,5,2,7,0,0,0,1,-1,-1,-1,4,1
KR_6767817956,420,4,54,31,11,3,3,0,4,4,0,-2,1,3,7,10,3,-1,0,1,0,7,2,-1,6,5,1,0,0,1,1,1,1,3,1
KR_6765694259,420,-1,-17,4,4,-2,2,4,3,3,0,-1,0,1,2,3,1,2,4,2,0,3,3,2,2,4,-2,0,0,-1,1,1,1,1,1
KR_6631240692,420,2,-10,16,0,-3,0,3,3,5,2,4,4,0,-3,2,5,-1,0,1,0,9,26,-1,5,4,1,0,-1,0,-1,-1,-1,0,1
KR_6767146425,420,-2,-21,10,-10,-4,1,5,-2,3,5,-1,1,2,-2,3,5,-1,1,2,-1,-13,249,-4,8,4,1,0,0,-1,1,0,-1,3,1
KR_6767375555,420,1,16,-39,6,3,5,2,3,6,3,-4,0,4,1,4,3,3,4,1,0,-1,-16,0,5,5,-1,0,1,-1,-1,1,-1,4,1
KR_6766578994,440,-1,32,-32,-1,-2,2,4,-5,4,9,-1,1,2,2,3,1,5,5,0,0,2,37,2,4,6,-7,0,-1,1,-1,-1,1,5,1
KR_6746269984,420,-1,8,-48,1,0,2,2,-2,2,4,5,5,0,-1,1,2,-1,0,1,0,-6,5,-1,6,5,3,0,1,1,1,1,1,5,1
KR_6744472295,420,2,40,-12,1,-5,0,5,0,2,2,-1,0,1,5,5,0,2,2,0,0,3,5,2,4,6,-2,0,2,1,1,1,1,3,1
KR_6656952362,420,4,-16,16,5,2,3,1,0,5,5,3,5,2,-1,0,1,1,1,0,0,4,4,-2,5,3,2,0,0,-1,-1,0,-1,3,1
KR_6750985793,420,-1,-31,1,3,1,2,1,2,5,3,4,5,1,-6,0,6,2,2,0,0,-2,-2,-3,6,3,1,0,0,0,1,1,-1,0,1
KR_6664782274,420,4,64,46,5,1,3,2,2,4,2,1,2,1,1,1,0,0,0,0,0,4,53,9,2,11,2,0,1,1,1,1,-1,6,1
KR_6613223299,420,5,98,-12,7,3,3,0,-1,2,3,1,3,2,3,4,1,1,3,2,0,4,4,-2,5,3,2,0,1,-1,1,1,1,2,1
KR_6751595101,420,3,-7,23,5,1,3,2,2,2,0,1,1,0,2,4,2,-1,0,1,0,3,34,1,3,4,0,0,1,1,-1,1,1,2,1
KR_6694756416,440,3,-13,8,6,-2,0,2,9,9,0,-3,2,5,2,4,2,0,0,0,-1,15,2,0,5,5,1,0,0,1,-1,0,-1,3,1
KR_6739303292,420,2,46,23,7,-1,4,5,7,7,0,-1,3,4,4,5,1,-2,0,2,0,6,13,4,4,8,0,0,2,1,-1,1,1,3,1
KR_6746892588,420,2,68,2,3,3,5,2,-3,3,6,0,3,3,2,3,1,1,1,0,0,1,1,4,2,6,1,0,0,-1,-1,0,1,6,1
KR_6735647154,420,3,-47,31,3,-2,0,2,2,4,2,3,5,2,-1,2,3,1,2,1,-1,3,-13,-1,9,8,3,0,1,1,-1,1,-1,6,1
KR_6320301407,420,-1,-75,4,-6,-2,2,4,4,8,4,-2,2,4,-5,0,5,-1,1,2,0,-7,-4,-4,6,2,-2,0,-1,-1,-1,-1,-1,6,1
KR_6759574121,420,2,-19,-19,-1,1,2,1,-1,1,2,1,1,0,-2,6,8,0,3,3,0,1,-8,1,6,7,7,0,-1,1,1,-1,-1,2,1
KR_6758336787,420,0,-21,9,3,0,1,1,1,4,3,3,8,5,-1,2,3,0,1,1,0,8,178,-1,3,2,3,0,0,1,-1,0,-1,4,1
KR_6712023201,420,0,72,-27,3,-2,5,7,3,4,1,0,4,4,1,2,1,1,3,2,1,16,-6,0,6,6,5,0,1,1,1,1,1,5,1
KR_6627190047,420,1,-9,-10,-3,-3,0,3,-3,4,7,0,2,2,1,3,2,2,2,0,0,2,61,-1,5,4,2,0,-2,1,-1,-1,-1,2,1
KR_6730019204,420,4,30,-12,8,0,0,0,3,6,3,3,4,1,3,5,2,-1,0,1,0,5,3,0,4,4,3,0,0,0,1,1,1,0,1
KR_6695294447,420,-2,-36,-8,3,-2,2,4,2,5,3,-1,3,4,2,3,1,2,3,1,0,11,-274,-2,7,5,2,0,0,-1,1,-1,1,3,1
KR_6703650117,420,5,99,40,9,2,2,0,4,7,3,3,4,1,0,4,4,0,0,0,0,18,-2,0,5,5,2,0,2,-1,1,1,-1,1,1
KR_6734883482,420,2,-60,40,-1,-6,0,6,-1,2,3,1,5,4,5,5,0,0,0,0,-2,1,3,1,3,4,-4,0,1,1,1,1,-1,5,1
KR_6759878088,420,2,19,20,3,-3,2,5,3,3,0,-2,2,4,5,5,0,0,0,0,-1,6,12,3,3,6,-4,0,3,1,1,1,-1,4,1
KR_6735424089,420,-2,2,-7,-1,-2,0,2,1,3,2,0,2,2,1,3,2,-1,0,1,0,0,1,4,4,8,4,0,-1,1,1,1,1,3,1
KR_6745839708,420,-5,11,-3,-1,0,2,2,-3,0,3,2,4,2,0,1,1,0,1,1,0,1,-21,0,3,3,0,0,-1,1,0,-1,-1,1,1
KR_6644512508,420,2,18,16,6,7,9,2,-3,3,6,6,8,2,-3,4,7,-1,0,1,0,-1,-8,-3,9,6,0,0,1,0,1,1,-1,0,1
KR_6767037381,420,5,119,0,9,1,2,1,1,1,0,0,2,2,6,6,0,1,1,0,0,16,10,2,4,6,-3,0,0,1,1,1,1,5,1
KR_6744424894,420,1,47,14,5,-3,3,6,2,4,2,7,7,0,-1,2,3,0,1,1,0,3,5,4,2,6,3,0,2,1,1,1,-1,1,1
KR_6770878526,440,2,36,-12,9,1,3,2,-6,2,8,0,4,4,12,12,0,2,3,1,1,9,2,2,1,3,4,0,2,1,1,1,1,4,1
KR_6725403749,420,6,48,7,14,-2,4,6,5,7,2,7,8,1,3,7,4,1,1,0,1,5,294,-1,6,5,2,0,1,1,1,1,1,1,1
KR_6721358731,440,2,68,16,6,3,5,2,0,1,1,2,2,0,2,7,5,-1,0,1,1,10,23,2,4,6,0,0,2,1,-1,1,1,6,1
KR_6769382998,420,-1,90,0,-4,3,3,0,-4,1,5,-4,1,5,-1,1,2,2,2,0,0,-7,12,-2,3,1,3,0,0,-1,-1,0,-1,2,1
KR_6660567674,420,1,28,-7,0,0,3,3,1,1,0,0,1,1,0,2,2,-1,0,1,1,-1,-3,-3,5,2,3,0,0,1,1,0,1,3,1
KR_6768763491,420,2,-21,43,3,-1,1,2,-6,3,9,4,4,0,5,5,0,1,3,2,0,0,-34,-5,7,2,7,0,0,1,-1,1,-1,1,1
KR_6769483439,420,7,84,34,10,0,1,1,5,6,1,0,2,2,0,1,1,5,5,0,1,6,-47,1,2,3,35,0,2,0,1,1,1,0,1
KR_6769241352,420,6,34,42,15,6,6,0,3,5,2,4,7,3,2,3,1,0,2,2,1,10,-44,1,4,5,21,0,0,-1,1,1,1,3,1
KR_6724414591,420,1,10,16,0,0,2,2,0,3,3,1,1,0,0,3,3,-1,1,2,-2,-1,-9,0,3,3,4,0,0,1,-1,1,-1,1,1
KR_6760527616,420,2,82,1,10,0,2,2,0,4,4,2,2,0,6,10,4,2,2,0,1,17,15,1,4,5,2,0,1,1,0,1,1,3,1
KR_6771882803,420,5,133,2,15,5,6,1,3,4,1,2,4,2,5,6,1,0,0,0,0,11,0,0,7,7,2,0,3,-1,1,1,1,6,1
KR_6748116429,420,-1,33,-8,-2,2,4,2,-3,2,5,-3,0,3,5,6,1,-3,0,3,0,-1,-12,-2,6,4,4,0,1,-1,1,1,-1,3,1
KR_6759289725,420,1,0,12,-3,0,2,2,-3,2,5,-2,2,4,3,6,3,-1,0,1,1,-1,338,-4,10,6,-3,0,1,1,0,1,1,1,1
KR_6690849456,420,1,14,-1,4,0,1,1,-1,2,3,1,1,0,3,5,2,1,1,0,-1,3,-5,-2,6,4,0,0,0,1,0,0,-1,5,1
KR_6738567481,440,-2,-58,1,2,0,0,0,1,1,0,1,2,1,-1,3,4,1,1,0,0,0,-1,0,3,3,-1,0,-1,-1,1,-1,1,5,1
KR_6693263082,420,3,67,0,12,1,1,0,7,10,3,3,3,0,0,1,1,1,1,0,0,10,1,3,2,5,-3,0,-1,1,1,1,1,2,1
KR_6600381691,420,4,87,-21,7,1,4,3,1,3,2,2,4,2,5,6,1,-2,0,2,0,8,15,1,8,9,1,0,2,1,-1,1,1,4,1
KR_6664697324,440,3,26,65,5,1,1,0,2,2,0,2,3,1,1,2,1,-1,0,1,0,2,-5,1,4,5,4,0,0,1,1,1,1,4,1
KR_6541037137,440,5,96,0,11,4,4,0,3,5,2,6,8,2,0,3,3,-2,1,3,0,4,-46,-2,5,3,24,0,3,1,1,1,1,6,1
KR_6695391106,420,3,35,-2,6,-1,2,3,-2,2,4,8,9,1,1,3,2,0,0,0,0,10,6,-1,3,2,3,0,1,1,1,1,1,4,1
KR_6767739239,420,7,90,-8,12,3,4,1,-2,1,3,3,3,0,3,6,3,5,5,0,0,4,-23,2,1,3,24,0,2,-1,1,1,1,5,1
KR_6674238102,420,0,33,14,4,1,2,1,-2,3,5,1,5,4,1,3,2,3,4,1,0,6,-395,6,3,9,-1,0,1,1,-1,-1,1,5,1
KR_6655954384,420,4,32,3,13,2,2,0,0,2,2,9,11,2,1,3,2,1,1,0,0,3,-98,3,4,7,0,0,0,0,-1,-1,1,0,1
KR_6690579963,420,0,31,4,1,-5,0,5,1,3,2,-1,0,1,4,6,2,2,3,1,0,2,39,2,5,7,-6,0,1,1,-1,1,1,5,1
KR_6770026709,440,0,55,-10,2,-4,1,5,2,2,0,-1,3,4,6,10,4,-1,0,1,0,3,-32,0,6,6,5,0,0,1,-1,1,1,1,1
KR_6767954108,420,0,17,-11,4,0,2,2,-1,1,2,4,6,2,1,4,3,0,0,0,0,2,10,3,5,8,0,0,1,1,-1,1,-1,2,1
KR_6714089591,420,0,23,-5,0,-3,2,5,3,4,1,6,6,0,-3,1,4,-3,2,5,0,-6,-5,0,6,6,-2,0,0,-1,0,1,1,4,1
KR_6497658070,420,0,2,22,-3,1,1,0,-1,3,4,-2,1,3,-1,1,2,0,1,1,0,-7,9,-3,5,2,-1,0,0,1,1,1,1,6,1
KR_6695647239,440,3,20,28,2,4,4,0,4,5,1,0,2,2,-7,1,8,1,2,1,2,5,-221,0,3,3,1,0,0,1,-1,1,1,5,1
KR_6771314304,420,4,87,4,15,2,2,0,2,4,2,3,3,0,8,9,1,0,0,0,0,16,12,3,5,8,2,1,3,1,1,1,1,5,1
KR_6589511787,420,6,102,24,15,6,8,2,5,5,0,1,3,2,1,4,3,2,3,1,0,21,-8,-2,5,3,1,0,5,1,1,1,1,4,1
KR_6683509181,420,-1,-21,-19,3,-3,3,6,-5,1,6,4,4,0,6,8,2,1,1,0,0,8,4,1,4,5,-3,0,2,-1,1,-1,1,3,1
KR_6731095653,440,3,75,-4,7,3,3,0,-3,2,5,2,3,1,0,2,2,5,6,1,1,4,7,-1,3,2,-2,0,1,-1,1,1,1,5,1
KR_6656553892,420,2,19,28,2,-1,1,2,-1,1,2,0,3,3,0,2,2,4,5,1,0,2,5,1,4,5,-1,0,0,-1,-1,1,1,6,1
KR_6688432839,420,6,19,28,13,-2,2,4,5,7,2,6,6,0,2,3,1,2,3,1,0,16,-115,1,3,4,-2,0,3,1,1,1,1,2,1
KR_6693663464,420,-2,-23,8,2,-3,1,4,0,6,6,-1,3,4,5,5,0,1,1,0,0,9,4,0,5,5,0,0,-1,1,-1,-1,-1,1,1
KR_6769591504,420,1,19,-1,-1,1,3,2,-5,1,6,3,4,1,1,4,3,-1,1,2,0,-3,1,-2,5,3,1,0,0,1,1,0,-1,4,1
KR_6737993575,420,4,56,28,15,6,6,0,2,5,3,3,3,0,2,3,1,2,3,1,0,20,6,2,5,7,-2,0,2,1,1,1,1,2,1
KR_6600081638,420,2,-12,32,-2,-6,0,6,6,11,5,-1,3,4,1,5,4,-2,0,2,-1,0,-4,-2,5,3,1,0,-1,1,-1,-1,-1,3,1
KR_6763726679,420,0,-20,-12,0,2,3,1,-2,3,5,-2,2,4,-2,2,4,4,4,0,0,-2,-234,-1,2,1,0,0,-1,-1,-1,-1,-1,5,1
KR_6711034449,420,4,2,-6,8,4,5,1,4,5,1,2,3,1,-3,1,4,1,4,3,0,13,39,4,5,9,1,0,-1,-1,1,-1,-1,4,1
KR_6757258162,440,2,12,19,4,0,2,2,4,5,1,-1,3,4,1,4,3,0,0,0,0,0,0,-3,4,1,-3,0,1,1,1,1,1,6,1
KR_6730522264,440,-3,8,1,-9,-5,2,7,-6,0,6,1,2,1,2,4,2,-1,2,3,0,-11,-3,-1,4,3,3,0,-2,1,-1,-1,-1,5,1
KR_6765901537,420,2,122,-24,10,4,6,2,-1,2,3,3,5,2,3,5,2,1,1,0,0,-6,-7,-3,6,3,5,0,3,1,1,1,1,4,1
KR_6766467761,420,2,-14,10,3,-4,0,4,2,3,1,2,3,1,4,4,0,-1,0,1,0,-2,6,0,7,7,3,0,1,1,1,1,1,5,1
KR_6762155636,440,-3,-12,-32,-8,1,4,3,2,4,2,-5,2,7,-5,0,5,-1,0,1,-1,-11,-43,-1,4,3,0,0,0,-1,1,0,-1,2,1
KR_6743266017,420,1,-22,4,5,-1,3,4,2,3,1,-3,1,4,2,4,2,5,8,3,0,1,-5,-2,5,3,-2,0,-1,1,-1,-1,1,6,1
KR_6624813540,420,-1,33,13,0,-1,2,3,4,5,1,1,4,3,-2,1,3,-2,2,4,1,-9,4,1,2,3,1,0,0,1,1,1,1,2,1
KR_6730464754,440,3,73,44,11,3,5,2,6,8,2,-2,0,2,0,2,2,4,7,3,0,4,-4,2,1,3,3,0,1,0,1,1,1,0,1
KR_6631131644,420,4,81,50,11,6,7,1,8,10,2,1,3,2,-3,4,7,-1,1,2,0,3,26,-8,12,4,4,0,2,1,0,1,-1,5,1
KR_6709648755,420,2,95,16,8,2,2,0,3,5,2,1,2,1,3,3,0,-1,1,2,0,6,-14,3,5,8,3,0,2,1,1,1,1,2,1
KR_6768399901,420,-2,8,-3,-6,1,3,2,-4,1,5,-3,5,8,0,1,1,0,1,1,0,-13,-19,-2,4,2,5,0,2,-1,1,1,-1,5,1
KR_6756737712,420,2,60,-8,1,-2,1,3,3,5,2,-1,2,3,1,2,1,0,0,0,0,1,10,0,5,5,2,0,0,-1,-1,0,1,3,1
KR_6748256799,440,4,3,12,5,0,1,1,3,3,0,4,4,0,-2,0,2,0,0,0,0,0,21,0,2,2,-1,0,1,0,-1,1,-1,0,1
KR_6732885942,420,-1,29,-16,-6,-3,1,4,-1,1,2,-2,1,3,0,2,2,0,3,3,-1,-10,21,-2,4,2,-1,0,1,0,1,1,-1,0,1
KR_6761517416,420,0,-21,1,-5,-2,0,2,-2,0,2,-2,0,2,2,3,1,-1,2,3,0,-4,37,2,5,7,-3,0,0,0,1,0,-1,0,1
KR_6761881968,420,0,7,-5,-2,-1,1,2,-2,1,3,0,3,3,2,2,0,-1,3,4,0,-7,0,-1,4,3,2,0,0,1,-1,1,-1,3,1
KR_6705712110,420,3,33,24,4,1,1,0,-1,1,2,-2,2,4,4,7,3,2,2,0,0,4,-6,-1,7,6,6,0,1,1,-1,1,1,5,1
KR_6767351621,440,1,21,4,4,2,3,1,-3,2,5,1,1,0,-1,2,3,5,6,1,3,12,0,3,2,5,2,0,1,1,-1,1,-1,5,1
KR_6716075185,420,-2,-47,19,2,0,0,0,-2,5,7,-1,0,1,3,4,1,2,2,0,0,4,8,-1,6,5,-4,0,1,1,1,1,-1,1,1
KR_6755512790,420,5,4,8,8,1,1,0,3,5,2,1,4,3,4,4,0,-1,1,2,0,9,-8,-3,6,3,2,0,1,-1,1,1,1,4,1
KR_6685087763,420,9,98,49,15,7,7,0,-1,0,1,5,5,0,1,3,2,3,4,1,0,7,-2,4,0,4,-4,0,1,1,1,1,1,4,1
KR_6768561868,420,4,3,29,-2,-6,2,8,-4,0,4,1,2,1,2,4,2,5,6,1,0,-3,13,-2,6,4,-1,0,0,1,1,1,-1,6,1
KR_6709875818,420,0,2,9,2,1,1,0,3,5,2,0,1,1,-2,1,3,0,0,0,0,4,16,1,3,4,-5,0,0,-1,-1,0,1,4,1
KR_6752393403,420,2,53,0,6,0,1,1,-2,0,2,2,2,0,8,10,2,-2,0,2,0,3,-3,-6,8,2,3,0,0,-1,-1,0,1,1,1
KR_6761141889,440,0,56,12,3,-1,3,4,0,1,1,2,4,2,8,11,3,-6,1,7,0,-7,-169,0,0,0,-5,0,1,-1,0,1,-1,5,1
KR_6757203390,420,4,-37,21,5,-1,1,2,-1,2,3,3,4,1,2,3,1,2,2,0,0,4,-26,0,8,8,15,0,-1,-1,1,-1,-1,2,1
KR_6614529413,420,4,-12,-11,12,5,7,2,2,4,2,-1,0,1,5,7,2,1,2,1,0,15,8,1,0,1,-1,0,1,1,1,1,-1,4,1
KR_6723288915,420,-2,54,-12,-1,-1,1,2,-3,2,5,-2,1,3,5,6,1,0,2,2,0,-3,-52,-1,4,3,34,0,-1,1,1,-1,1,3,1
KR_6759298113,440,2,37,17,0,-3,2,5,0,3,3,2,2,0,1,2,1,0,1,1,1,0,-29,3,4,7,1,0,0,1,1,-1,1,5,1
KR_6771077162,420,-2,-24,-10,-6,-3,0,3,0,0,0,0,0,0,-7,1,8,4,4,0,0,-2,0,0,3,3,6,0,-1,1,1,-1,-1,1,1
KR_6762357117,420,-1,46,-1,-4,-4,1,5,3,4,1,0,1,1,-1,2,3,-2,1,3,0,-13,8,4,5,9,2,0,0,1,0,0,1,5,1
KR_6752339881,420,3,54,32,11,-1,1,2,0,4,4,2,3,1,3,3,0,7,7,0,0,7,-1,1,4,5,5,0,1,1,1,1,1,2,1
KR_6649718573,420,-1,24,7,0,-4,2,6,1,4,3,5,5,0,-1,1,2,-1,0,1,1,-2,41,5,6,11,-11,0,2,1,1,1,1,4,1
KR_6662498114,440,3,55,8,0,-1,3,4,-2,2,4,3,6,3,-2,2,4,2,4,2,-1,-4,8,-1,6,5,2,0,1,-1,-1,1,-1,6,1
KR_6709367229,420,5,94,19,8,2,4,2,5,6,1,-1,1,2,2,3,1,0,1,1,0,9,21,0,8,8,6,0,1,1,1,1,-1,5,1
KR_6688286185,420,2,-28,13,4,3,4,1,-1,2,3,3,3,0,-1,0,1,0,0,0,0,-1,-8,-4,8,4,3,0,1,1,-1,1,-1,5,1
KR_6763025869,420,-1,-43,12,-1,3,3,0,-5,1,6,1,4,3,1,2,1,-1,1,2,0,-2,-6,-5,6,1,-1,0,0,-1,0,-1,1,1,1
KR_6688471944,420,6,94,0,7,-4,0,4,6,8,2,-3,1,4,8,9,1,0,2,2,0,14,0,1,4,5,5,0,2,1,-1,1,1,4,1
KR_6717054817,420,3,88,35,3,4,5,1,-1,3,4,-3,2,5,4,5,1,-1,1,2,0,0,-9,-2,5,3,6,0,1,1,1,1,1,5,1
KR_6629803316,420,5,69,-28,8,0,0,0,2,5,3,3,3,0,-1,2,3,4,5,1,1,17,6,1,7,8,1,0,1,1,-1,1,1,4,1
KR_6758289774,420,4,58,8,5,1,1,0,-1,5,6,2,2,0,3,5,2,0,0,0,0,8,-2,2,4,6,1,0,1,-1,1,1,-1,1,1
KR_6762128269,420,0,49,-26,0,4,5,1,0,2,2,-3,3,6,-1,0,1,0,0,0,0,-6,-9,3,1,4,2,0,0,-1,-1,-1,1,5,1
KR_6766994912,420,2,11,7,12,-1,3,4,9,11,2,3,3,0,0,3,3,1,1,0,0,15,9,4,1,5,-3,0,0,1,-1,1,1,3,1
KR_6768098224,420,-1,19,16,6,1,2,1,1,2,1,2,2,0,0,4,4,2,2,0,0,10,-3,-4,6,2,0,0,1,1,-1,1,1,5,1
KR_6752294306,420,0,0,-13,-1,0,0,0,4,7,3,-1,2,3,-3,2,5,-1,0,1,0,-1,5,-1,4,3,-2,0,0,-1,1,-1,-1,2,1
KR_6699456417,420,0,-32,8,1,-3,1,4,1,2,1,4,5,1,-1,1,2,0,0,0,0,0,103,2,6,8,0,0,0,1,1,1,-1,5,1
KR_6619280459,420,7,65,8,22,2,2,0,4,5,1,5,7,2,13,13,0,-2,1,3,0,21,-35,3,2,5,1,0,2,0,0,1,1,0,1
KR_6766854596,420,0,23,-23,-6,1,4,3,-1,1,2,0,1,1,-3,1,4,-3,2,5,-2,-4,-12,-5,7,2,2,0,0,1,-1,0,1,6,1
KR_6764312385,420,2,78,-8,-2,5,5,0,2,2,0,-2,1,3,-5,2,7,-2,2,4,-1,-16,-29,0,5,5,7,0,1,-1,1,1,-1,2,1
KR_6712201871,420,6,65,20,13,3,3,0,3,3,0,3,4,1,2,2,0,2,2,0,0,15,-55,-1,5,4,33,0,0,1,-1,1,1,1,1
KR_6658872121,420,0,5,39,8,-2,0,2,0,2,2,4,8,4,5,8,3,1,1,0,1,0,20,-2,6,4,3,0,0,1,1,1,-1,4,1
KR_6715385478,420,-1,36,12,-5,-1,3,4,-1,4,5,-2,1,3,1,4,3,-2,0,2,0,4,2,3,5,8,2,0,0,0,1,-1,-1,0,1
KR_6652631009,420,1,51,-7,1,1,2,1,-4,1,5,-2,0,2,4,5,1,2,3,1,0,-2,-9,-6,7,1,-1,0,0,1,-1,0,1,3,1
KR_6640632379,420,1,14,4,-5,-1,0,1,-2,2,4,0,1,1,-1,2,3,-1,0,1,0,-5,-1,-4,10,6,0,0,0,-1,-1,0,-1,6,1
KR_6758239709,420,5,71,39,7,4,4,0,3,4,1,1,4,3,-2,1,3,1,2,1,0,9,11,4,2,6,2,0,2,1,1,1,-1,5,1
KR_6726386145,420,0,75,9,-2,3,5,2,-1,2,3,0,3,3,2,4,2,-6,2,8,0,-12,0,-2,8,6,-2,0,0,1,-1,1,1,1,1
KR_6718343239,420,2,-22,-4,3,1,2,1,5,6,1,-5,1,6,3,5,2,-1,0,1,1,9,9,1,4,5,-2,0,0,1,1,1,1,6,1
KR_6771329315,420,0,4,-21,3,0,2,2,0,1,1,-2,1,3,-2,0,2,7,8,1,3,5,24,0,3,3,-2,0,1,0,1,1,1,0,1
KR_6415956683,420,2,-1,11,-4,-2,0,2,1,2,1,-6,1,7,0,3,3,3,4,1,0,-3,15,0,6,6,-7,0,0,1,0,1,-1,4,1
KR_6754907184,420,5,58,25,13,-1,0,1,0,4,4,11,12,1,1,1,0,2,2,0,0,5,-7,-2,8,6,3,0,1,1,1,1,1,2,1
KR_6719970506,420,0,-3,18,3,0,1,1,9,13,4,-2,2,4,-3,2,5,-1,0,1,-2,-5,4,6,3,9,3,0,-1,1,-1,-1,-1,4,1
KR_6573723007,420,-3,-10,-16,-6,-2,0,2,2,4,2,-4,1,5,1,5,4,-3,1,4,0,-7,-42,-1,6,5,3,0,0,1,1,1,1,4,1
KR_6751601781,420,2,17,14,7,1,2,1,1,3,2,-1,0,1,-3,1,4,9,10,1,1,11,1,6,1,7,-2,0,0,1,-1,0,1,2,1
KR_6768589426,440,5,74,60,11,4,5,1,1,4,3,0,2,2,5,5,0,1,2,1,0,3,4,-1,7,6,4,0,3,1,1,1,1,2,1
KR_6717789586,420,-1,-40,-27,2,6,7,1,0,1,1,0,4,4,-3,1,4,-1,0,1,0,1,7,4,2,6,0,0,1,-1,1,1,1,6,1
KR_6662560905,440,1,-7,13,-1,1,2,1,-1,2,3,-1,4,5,0,2,2,0,1,1,0,-2,-12,2,1,3,1,0,1,-1,1,1,1,4,1
KR_6736733902,420,0,-56,-30,3,2,2,0,-1,2,3,-1,1,2,4,6,2,-1,1,2,0,8,-4,2,4,6,3,0,-1,1,-1,1,1,2,1
KR_6636410623,420,2,7,-20,2,-4,0,4,-1,3,4,3,3,0,4,6,2,0,0,0,0,2,-3,0,8,8,-4,0,0,-1,1,1,1,2,1
KR_6741689423,440,0,4,24,3,6,7,1,2,3,1,1,3,2,-6,0,6,0,1,1,3,-3,-27,-1,7,6,3,0,1,1,1,1,1,2,1
KR_6651429065,420,-1,-33,3,0,0,0,0,1,6,5,0,3,3,-3,0,3,2,2,0,-1,1,-10,-3,6,3,1,0,0,-1,1,0,-1,2,1
KR_6680917767,420,2,10,15,4,0,1,1,4,4,0,0,1,1,-1,2,3,1,2,1,2,9,6,-3,6,3,0,0,0,-1,1,1,1,2,1
KR_6749459255,440,2,41,2,6,-1,3,4,2,4,2,0,0,0,4,4,0,1,2,1,0,9,-28,0,6,6,3,0,1,1,0,1,-1,6,1
KR_6760331340,420,0,-17,-3,5,-1,2,3,3,4,1,5,5,0,-2,0,2,0,0,0,0,2,-28,0,2,2,5,0,0,1,-1,-1,1,1,1
KR_6640714679,420,0,-28,-28,6,6,6,0,1,2,1,-4,0,4,2,2,0,1,2,1,0,1,-1,-5,6,1,0,0,0,-1,-1,0,1,6,1
KR_6771028710,440,4,28,8,5,0,0,0,0,0,0,4,5,1,1,5,4,0,1,1,0,5,2,1,5,6,1,0,0,0,0,1,-1,0,1
