matchId,queueId,Diff_LV,Diff_CS,Diff_jglCS,Diff-K,Diff-K-top,K-WIN-top,K-LOSE-top,Diff-K-jug,K-WIN-jug,K-LOSE-jug,Diff-K-mid,K-WIN-mid,K-LOSE-mid,Diff-K-ad,K-WIN-ad,K-LOSE-ad,Diff-K-sup,K-WIN-sup,K-LOSE-sup,invadeKill,Diff-A,Diff_WARDplaced,Diff-ControlWARDplaced,LOSE_controlWARDPlaced,WIN_controlWARDPlaced,Diff_WARDkill,Diff_Inhibitor,Diff_TOWERkill,Diff_FirstDRAGON,Diff_FirstHERALD,Diff_Firsttower,Diff_FirstBLOOD,dragonType,result
KR_6766851498,420,4,15,-16,8,6,6,0,4,4,0,-1,3,4,0,3,3,-1,2,3,0,6,4,4,2,6,5,0,0,1,1,0,1,2,1
KR_6670657063,420,4,57,15,10,-1,3,4,5,8,3,2,4,2,4,6,2,0,1,1,1,23,38,1,5,6,2,0,0,-1,1,1,1,5,1
KR_6757888605,420,-1,-7,22,-3,5,5,0,2,4,2,-4,1,5,-6,1,7,0,3,3,0,-4,-16,2,3,5,-2,0,2,1,1,1,1,6,1
KR_6729375659,420,1,-27,23,6,1,2,1,-2,3,5,1,3,2,4,4,0,2,2,0,0,1,117,5,4,9,0,0,1,1,1,1,-1,1,1
KR_6740289803,420,0,46,0,1,-2,1,3,2,3,1,-3,1,4,1,3,2,3,3,0,0,-2,350,0,8,8,0,0,1,1,-1,1,1,3,1
KR_6716608510,440,2,40,7,6,4,4,0,1,2,1,1,3,2,0,0,0,0,1,1,0,8,11,2,4,6,-4,0,1,1,1,1,1,4,1
KR_6763080013,420,-1,-56,-4,-3,-1,3,4,-1,3,4,4,6,2,-1,2,3,-4,1,5,0,1,-119,0,5,5,-2,0,-2,-1,1,1,-1,1,1
KR_6763452424,420,0,-37,5,7,0,1,1,6,6,0,-3,0,3,3,5,2,1,2,1,1,3,-2,-2,6,4,6,0,0,-1,1,0,1,1,1
KR_6715358399,420,5,-10,-12,12,-1,0,1,3,7,4,4,5,1,6,7,1,0,1,1,0,16,122,2,4,6,-1,0,2,1,1,1,1,2,1
KR_6715937256,420,3,-4,30,0,0,3,3,0,2,2,-1,2,3,0,4,4,1,2,1,0,-4,-5,-2,5,3,1,0,0,-1,1,1,1,3,1
KR_6546903638,420,10,37,91,9,-4,0,4,5,5,0,3,4,1,3,7,4,2,2,0,3,9,8,3,3,6,1,0,2,1,1,1,1,2,1
KR_6730910041,420,3,25,16,1,-1,0,1,0,3,3,4,5,1,-2,0,2,0,0,0,0,0,-5,0,5,5,1,0,0,1,1,0,-1,1,1
KR_6768838466,420,5,82,4,13,6,6,0,2,2,0,1,2,1,2,2,0,2,2,0,0,9,11,2,3,5,-1,0,1,1,-1,1,1,1,1
KR_6765957194,420,-1,57,-4,-2,-2,2,4,-2,3,5,2,2,0,1,4,3,-1,0,1,0,2,6,-2,6,4,0,0,2,1,1,1,-1,5,1
KR_6605614025,420,3,-18,5,5,2,3,1,2,2,0,1,4,3,2,3,1,-2,1,3,1,10,25,-1,5,4,-2,0,0,-1,-1,1,1,5,1
KR_6680981762,420,6,75,-2,5,0,2,2,2,5,3,-3,1,4,0,2,2,6,6,0,0,9,-261,-5,9,4,8,0,2,1,1,1,-1,4,1
KR_6745313492,420,1,52,-20,-2,-1,2,3,-2,1,3,3,4,1,-3,1,4,1,3,2,-1,-4,-125,2,3,5,1,0,0,1,1,1,-1,2,1
KR_6761582888,420,1,55,3,1,3,5,2,-2,2,4,-4,1,5,4,5,1,0,0,0,0,-3,-53,5,3,8,2,0,1,1,0,1,1,3,1
KR_6739841016,420,1,-35,24,-2,6,6,0,-2,4,6,-1,1,2,-5,0,5,0,0,0,-2,-12,9,4,4,8,-1,0,1,1,1,-1,-1,3,1
KR_6766627564,420,4,47,-9,11,5,9,4,1,3,2,4,4,0,-1,0,1,2,2,0,0,4,1,1,4,5,2,0,2,-1,-1,1,1,6,1
KR_6767102391,420,0,19,-20,4,2,3,1,1,3,2,-2,0,2,2,3,1,1,1,0,4,14,1,0,5,5,3,0,3,-1,1,1,1,1,1
KR_6760873950,420,4,45,9,9,2,3,1,-2,0,2,1,2,1,7,7,0,1,1,0,0,8,7,4,5,9,0,0,2,1,1,1,1,1,1
KR_6674007238,440,1,30,-4,1,0,1,1,4,4,0,0,1,1,-1,2,3,-2,0,2,0,2,0,1,3,4,-1,0,0,-1,1,0,1,5,1
KR_6622026272,420,-1,19,-15,-1,-2,0,2,0,2,2,0,1,1,0,1,1,1,1,0,-1,-2,-5,-2,6,4,7,0,0,-1,1,-1,-1,1,1
KR_6760810245,420,4,67,11,14,4,4,0,1,4,3,9,9,0,0,5,5,0,2,2,0,9,-3,2,4,6,-4,0,1,1,1,1,-1,5,1
KR_6614534321,420,4,49,-8,3,2,4,2,3,6,3,5,6,1,-7,0,7,0,1,1,0,4,50,2,2,4,-6,0,2,1,1,1,1,5,1
KR_6759727139,440,-1,47,7,-2,-1,3,4,2,4,2,-3,3,6,2,5,3,-2,0,2,0,7,269,0,3,3,-2,0,-2,0,1,-1,1,0,1
KR_6317970019,420,3,-7,28,-1,-1,2,3,-1,1,2,4,8,4,-3,1,4,0,1,1,0,-1,1,-2,6,4,2,0,0,0,1,1,-1,0,1
KR_6768249122,420,1,7,16,4,6,6,0,-1,1,2,-2,0,2,-1,2,3,2,2,0,1,3,5,1,2,3,-2,0,1,-1,1,1,1,4,1
KR_6732170827,440,-3,-60,13,-8,0,2,2,-2,3,5,-6,2,8,-1,2,3,1,1,0,0,-3,-34,2,3,5,-4,0,-1,1,1,-1,1,4,1
KR_6739323977,420,3,106,32,8,-1,0,1,1,3,2,6,6,0,0,4,4,2,2,0,0,6,2,0,4,4,4,0,2,1,1,1,1,3,1
KR_6710312775,440,2,1,0,6,1,3,2,4,6,2,4,4,0,-2,1,3,-1,0,1,1,3,-30,3,3,6,-2,0,2,-1,1,1,1,2,1
KR_6767403026,420,4,33,5,9,3,4,1,-1,1,2,-2,2,4,5,6,1,4,5,1,0,11,-11,-5,6,1,6,0,2,-1,1,1,1,3,1
KR_6661944305,440,4,128,24,9,2,10,8,4,5,1,-1,1,2,0,6,6,4,4,0,0,5,17,8,2,10,-3,0,0,-1,0,1,1,1,1
KR_6763282657,420,1,39,-16,4,2,2,0,2,5,3,1,4,3,-1,1,2,0,0,0,0,-2,6,-3,9,6,6,0,1,-1,1,1,1,6,1
KR_6719669113,440,6,46,47,6,3,4,1,3,9,6,4,5,1,-2,0,2,-2,0,2,0,1,-4,0,5,5,3,0,1,-1,-1,1,1,5,1
KR_6767186732,420,-3,-61,0,1,-2,2,4,0,2,2,-2,1,3,3,5,2,2,3,1,-1,8,6,4,1,5,-2,0,-1,1,1,-1,-1,2,1
KR_6762863184,420,2,11,-19,11,1,2,1,2,2,0,2,3,1,7,7,0,-1,0,1,0,11,4,-1,6,5,-2,0,0,1,1,1,1,5,1
KR_6759978131,420,-1,-32,20,6,-1,0,1,6,6,0,0,4,4,3,8,5,-2,1,3,2,9,25,3,4,7,-3,0,0,0,1,0,-1,0,1
KR_6652359579,420,-1,43,24,-5,0,0,0,-3,5,8,-2,0,2,0,0,0,0,1,1,0,-2,-6,-1,8,7,-1,0,1,1,-1,1,1,5,1
KR_6755786515,440,3,1,4,0,6,6,0,-3,1,4,0,3,3,0,5,5,-3,1,4,-1,-7,18,-3,5,2,2,0,0,0,0,0,-1,0,1
KR_6759312028,420,-1,-33,-5,3,2,3,1,0,4,4,-1,0,1,0,3,3,2,2,0,0,1,0,0,8,8,-1,0,1,1,-1,1,-1,6,1
KR_6755820651,420,-2,1,-16,0,-1,1,2,-1,5,6,0,2,2,1,2,1,1,3,2,0,1,-6,0,7,7,2,0,-1,1,-1,-1,1,5,1
KR_6698165498,420,3,-35,21,6,0,2,2,4,5,1,0,1,1,0,2,2,2,2,0,0,13,-11,5,0,5,6,0,0,1,1,-1,-1,1,1
KR_6759214679,420,1,-21,0,-2,-2,1,3,6,8,2,-2,2,4,-4,1,5,0,0,0,0,-6,125,-6,9,3,1,0,0,-1,1,0,-1,5,1
KR_6767312401,420,2,15,-10,3,2,3,1,-1,4,5,-1,2,3,4,4,0,-1,0,1,-1,6,-9,-1,7,6,3,0,0,1,1,0,-1,2,1
KR_6746125785,420,6,61,13,8,-1,0,1,-1,1,2,5,9,4,2,3,1,3,3,0,0,14,14,0,4,4,1,0,1,-1,1,1,1,3,1
KR_6747629324,420,4,42,8,16,2,2,0,2,3,1,6,7,1,6,6,0,0,0,0,0,19,168,4,2,6,-3,0,0,1,-1,1,1,1,1
KR_6754528377,420,0,23,-7,-2,1,1,0,-4,0,4,-1,1,2,3,7,4,-1,0,1,0,-7,-6,-2,4,2,1,0,0,1,-1,0,-1,4,1
KR_6499659178,420,4,47,45,2,5,5,0,3,5,2,-1,1,2,-5,0,5,0,0,0,0,-4,25,-1,6,5,2,0,1,1,1,1,-1,4,1
KR_6722082272,420,0,-5,15,-4,1,1,0,1,2,1,1,4,3,-5,0,5,-2,0,2,0,-6,116,-2,5,3,3,0,1,-1,1,1,-1,2,1
KR_6705603724,420,10,131,112,14,1,1,0,5,5,0,5,6,1,-2,1,3,5,7,2,-1,4,22,-1,3,2,1,0,3,1,1,1,-1,3,1
KR_6609869224,420,5,46,-3,11,3,6,3,-1,1,2,-1,2,3,6,7,1,4,4,0,0,8,0,0,6,6,-2,0,0,-1,1,0,1,6,1
KR_6751274994,420,1,-48,-8,-4,4,4,0,3,4,1,-2,1,3,-8,0,8,-1,0,1,0,-1,-8,-2,5,3,3,0,-1,1,-1,-1,-1,5,1
KR_6767260340,420,2,-3,36,5,2,3,1,2,2,0,3,5,2,-3,0,3,1,1,0,0,3,-8,-2,5,3,3,0,1,-1,1,-1,1,2,1
KR_6758911084,420,1,44,16,2,1,2,1,-2,0,2,3,4,1,-2,2,4,2,2,0,0,-2,6,-2,7,5,1,0,0,1,-1,0,1,1,1
KR_6634390256,420,1,78,-4,5,-2,0,2,2,5,3,2,4,2,3,5,2,0,2,2,0,2,-1,-1,6,5,3,0,1,1,1,1,1,1,1
KR_6743645154,420,-2,-44,-9,-3,-1,1,2,0,3,3,-6,1,7,5,5,0,-1,0,1,0,1,-2,-4,6,2,-7,0,0,1,1,0,-1,1,1
KR_6693405056,420,0,2,3,6,0,1,1,2,5,3,4,6,2,-1,1,2,1,2,1,-1,6,6,4,2,6,1,0,-2,1,-1,-1,-1,3,1
KR_6769284354,420,6,63,6,17,3,3,0,5,5,0,6,6,0,2,2,0,1,1,0,0,29,49,3,1,4,0,0,2,-1,1,1,1,5,1
KR_6698045302,420,-2,-14,-40,-8,0,1,1,-1,4,5,0,2,2,-6,3,9,-1,1,2,-2,-16,1,-3,9,6,-3,0,0,1,-1,0,-1,1,1
KR_6584464135,420,4,64,12,11,6,6,0,-1,0,1,4,4,0,3,3,0,-1,1,2,0,7,2,2,5,7,-2,0,2,1,1,1,1,6,1
KR_6764225949,420,3,-37,9,10,5,6,1,-1,0,1,5,5,0,1,3,2,0,1,1,0,7,4,3,3,6,3,0,0,0,1,1,-1,0,1
KR_6761925971,420,-2,8,28,-6,0,4,4,-5,2,7,-5,1,6,4,4,0,0,0,0,-1,-6,3,-1,8,7,0,0,1,1,-1,1,-1,1,1
KR_6740645442,420,1,-5,-1,12,1,6,5,3,3,0,5,7,2,3,5,2,0,3,3,0,29,-20,5,2,7,2,0,0,1,1,-1,-1,5,1
KR_6726173068,420,2,24,0,5,2,2,0,-1,0,1,0,2,2,-1,1,2,5,5,0,0,9,8,4,5,9,2,0,0,-1,0,0,-1,1,1
KR_6644831098,420,2,22,3,6,2,2,0,1,4,3,2,8,6,1,3,2,0,0,0,0,5,-6,0,4,4,1,0,2,1,-1,1,1,1,1
KR_6769171458,420,-1,-47,18,0,-2,1,3,-1,3,4,4,5,1,-1,4,5,0,2,2,0,-1,3,-1,9,8,-3,0,0,0,1,-1,1,0,1
KR_6735181935,420,3,19,20,4,3,4,1,-1,2,3,0,4,4,-1,0,1,3,3,0,1,0,-15,3,3,6,0,0,0,-1,1,1,1,4,1
KR_6762976518,420,1,-20,29,3,2,2,0,0,1,1,1,3,2,0,4,4,0,0,0,0,-7,-99,2,4,6,2,0,1,1,1,1,-1,4,1
KR_6766483034,420,1,24,53,-2,-2,0,2,3,5,2,0,4,4,-2,2,4,-1,1,2,0,-5,12,-4,5,1,3,0,0,1,1,1,1,6,1
KR_6694751984,420,0,-10,-13,3,3,5,2,0,2,2,-1,2,3,0,4,4,1,1,0,1,-3,-10,-3,6,3,1,0,1,1,1,1,1,4,1
KR_6675192509,420,1,94,-24,1,2,3,1,0,3,3,-3,1,4,2,5,3,0,0,0,0,7,-54,5,5,10,3,0,1,1,-1,1,1,2,1
KR_6762791814,440,5,71,16,9,1,2,1,5,5,0,0,1,1,3,3,0,0,1,1,0,8,-22,1,4,5,-4,0,0,1,-1,0,1,4,1
KR_6509173550,420,-1,-43,25,2,-1,0,1,6,6,0,-3,2,5,-1,1,2,1,1,0,0,6,46,4,1,5,-1,0,0,-1,1,0,1,3,1
KR_6749633519,440,5,78,28,6,12,13,1,3,4,1,-6,0,6,-2,6,8,-1,1,2,-1,-10,1,-1,6,5,0,0,3,1,1,1,-1,6,1
KR_6699102706,420,4,101,24,5,0,2,2,-4,0,4,9,10,1,-1,4,5,1,1,0,-1,-1,45,3,2,5,-19,0,6,1,1,1,-1,2,1
KR_6733388254,420,3,-2,0,7,2,2,0,1,3,2,-2,0,2,6,8,2,0,1,1,0,8,257,0,5,5,5,0,0,1,-1,0,-1,4,1
KR_6743620752,420,6,27,52,15,7,7,0,-1,3,4,7,7,0,3,5,2,-1,1,2,2,11,30,4,2,6,-1,0,1,-1,1,1,1,3,1
KR_6766787213,420,0,-32,7,1,3,3,0,-1,4,5,1,4,3,0,1,1,-2,1,3,0,3,9,-2,6,4,-7,0,-1,-1,1,-1,-1,6,1
KR_6745441582,420,-2,4,-10,-7,2,3,1,-1,3,4,0,2,2,-3,3,6,-5,1,6,0,-11,-85,-5,7,2,-37,0,2,-1,1,1,1,5,1
KR_6726063203,420,3,6,33,10,3,3,0,4,4,0,0,1,1,0,3,3,3,3,0,0,5,137,4,1,5,-3,0,1,1,0,1,1,5,1
KR_6735957162,420,0,35,11,-3,0,1,1,4,6,2,1,1,0,-4,0,4,-4,1,5,0,-8,6,6,2,8,-4,0,-1,1,-1,-1,-1,6,1
KR_6765754914,420,-1,-38,-13,-1,0,4,4,-1,0,1,4,5,1,-2,4,6,-2,2,4,1,-9,6,4,1,5,-1,0,-2,-1,-1,-1,1,6,1
KR_6768873280,420,1,0,19,-1,-2,2,4,-3,1,4,1,3,2,4,6,2,-1,0,1,0,3,-1,2,5,7,-2,0,-1,-1,1,-1,1,2,1
KR_6714461477,440,-2,-72,-12,-7,1,5,4,-3,6,9,-3,2,5,-2,0,2,0,1,1,-1,-4,7,-1,1,0,2,0,0,-1,1,-1,-1,6,1
KR_6685286610,440,4,15,-3,13,0,0,0,4,4,0,5,5,0,3,3,0,1,3,2,1,15,10,2,2,4,-3,0,2,1,1,1,1,4,1
KR_6509158373,420,2,58,-4,1,1,1,0,-3,1,4,3,5,2,1,4,3,-1,0,1,0,-4,-1,-1,5,4,1,0,1,1,-1,1,-1,2,1
KR_6763190563,420,2,59,-5,6,-1,0,1,4,4,0,0,3,3,2,5,3,1,2,1,0,4,156,7,0,7,1,0,1,1,-1,1,-1,5,1
KR_6624857251,420,-1,71,-21,5,3,4,1,0,1,1,4,4,0,-2,1,3,0,3,3,0,4,-1,1,5,6,4,0,2,1,1,1,1,5,1
KR_6634513934,420,3,21,-4,5,2,3,1,1,2,1,0,3,3,1,5,4,1,2,1,0,8,1,0,8,8,10,0,0,-1,1,1,-1,1,1
KR_6727044149,420,0,27,-1,2,5,8,3,-6,2,8,-1,3,4,2,6,4,2,2,0,0,-6,3,-4,8,4,-3,0,-2,-1,-1,-1,-1,5,1
KR_6536819262,420,2,19,22,4,1,2,1,5,9,4,0,2,2,-3,2,5,1,1,0,3,7,-11,0,3,3,2,0,1,1,-1,1,1,2,1
KR_6298308354,420,-1,23,-20,4,1,1,0,-2,3,5,0,3,3,2,2,0,3,5,2,0,-4,8,-2,4,2,3,0,0,-1,-1,0,1,6,1
KR_6767422656,420,3,44,40,3,-1,1,2,6,9,3,-1,0,1,-2,5,7,1,1,0,0,2,3,-4,7,3,-1,0,0,1,1,0,-1,4,1
KR_6759123663,440,-1,-12,0,3,6,8,2,-2,1,3,-2,1,3,1,5,4,0,3,3,0,6,-1,1,3,4,-2,0,-1,-1,1,-1,-1,6,1
KR_6765493894,420,0,-49,25,-2,2,2,0,-2,2,4,-2,1,3,0,1,1,0,0,0,0,-4,35,-2,3,1,-1,0,-1,-1,1,-1,1,4,1
KR_6763732868,420,5,43,-1,17,6,7,1,2,3,1,2,6,4,4,7,3,3,3,0,0,10,9,0,5,5,-9,0,1,1,1,1,1,4,1
KR_6768581217,440,4,11,-12,5,-1,1,2,1,2,1,2,2,0,3,3,0,0,1,1,0,9,-32,4,2,6,1,0,0,-1,1,0,1,6,1
KR_6763164402,420,5,33,35,5,-3,3,6,0,1,1,2,4,2,4,4,0,2,3,1,0,10,8,-1,2,1,0,0,-1,1,-1,-1,-1,3,1
KR_6761960313,440,4,81,-10,6,-1,0,1,0,2,2,1,3,2,6,6,0,0,0,0,0,5,102,6,2,8,2,0,1,1,-1,1,-1,2,1
KR_6758298735,420,0,-98,21,-4,-3,5,8,-1,3,4,-5,0,5,4,6,2,1,1,0,-1,5,140,-2,3,1,1,0,-1,1,-1,-1,-1,6,1
KR_6767274556,420,0,26,-4,6,-2,2,4,-2,2,4,2,2,0,9,9,0,-1,0,1,0,3,22,-1,4,3,-2,0,1,1,-1,1,1,6,1
KR_6682216794,420,3,49,20,9,2,3,1,-2,2,4,1,3,2,6,8,2,2,3,1,-1,1,5,3,4,7,4,0,1,1,0,1,-1,2,1
KR_6710630575,420,-1,-24,6,-5,0,2,2,-5,1,6,2,3,1,-3,1,4,1,1,0,-1,-17,-5,0,4,4,0,0,0,-1,-1,0,-1,6,1
KR_6747675652,420,0,5,17,3,-1,0,1,-2,1,3,0,3,3,4,6,2,2,4,2,0,6,-142,-4,6,2,-2,0,-3,1,-1,-1,1,2,1
KR_6717620810,420,-1,-1,-24,-6,-3,1,4,-1,4,5,-1,5,6,0,2,2,-1,0,1,0,2,-30,1,3,4,4,0,0,-1,-1,1,-1,2,1
KR_6708202506,420,0,-44,16,-4,-2,2,4,-2,0,2,5,6,1,-7,0,7,2,3,1,0,-3,-68,-5,9,4,-1,0,0,1,-1,0,-1,3,1
KR_6766117762,420,-1,-1,-12,2,1,1,0,1,6,5,-3,0,3,2,5,3,1,1,0,-1,6,-3,-5,7,2,2,0,1,1,-1,1,-1,6,1
KR_6763380496,420,0,25,17,-3,0,1,1,1,1,0,1,3,2,-7,0,7,2,2,0,0,-6,-6,6,1,7,-1,0,1,-1,1,1,1,4,1
KR_6734929392,420,5,42,19,9,7,9,2,1,3,2,1,1,0,-1,1,2,1,1,0,0,15,4,3,4,7,2,0,2,1,1,1,1,3,1
KR_6679769955,420,3,72,-20,15,4,4,0,2,5,3,4,4,0,3,4,1,2,2,0,0,13,14,0,3,3,0,0,1,1,-1,1,1,1,1
KR_6723008739,440,0,53,20,-5,0,2,2,1,6,5,-5,1,6,-2,1,3,1,2,1,0,-13,45,-4,6,2,0,0,0,0,1,1,-1,0,1
KR_6741760050,420,2,-9,19,3,0,0,0,4,4,0,2,5,3,-5,2,7,2,3,1,-1,1,77,0,4,4,-28,0,2,1,1,1,-1,5,1
KR_6761597415,420,1,19,14,3,1,1,0,7,7,0,-6,1,7,6,7,1,-5,1,6,0,5,0,-2,4,2,1,0,1,1,-1,1,-1,2,1
KR_6761605390,440,-2,-53,24,-4,-4,0,4,1,5,4,5,5,0,-3,0,3,-3,1,4,0,-4,4,0,2,2,0,0,-1,1,1,-1,1,3,1
KR_6767693032,420,3,61,11,8,1,2,1,2,6,4,3,3,0,0,5,5,2,4,2,-1,-1,6,-2,4,2,2,0,1,0,1,1,-1,0,1
KR_6760433358,420,0,-36,-6,-6,0,3,3,-6,1,7,0,1,1,-2,0,2,2,4,2,0,-7,-13,1,3,4,-1,0,0,-1,-1,-1,-1,4,1
KR_6680496590,420,2,25,29,5,-2,0,2,3,6,3,0,0,0,2,3,1,2,4,2,0,6,1,-3,7,4,6,0,1,1,-1,1,-1,2,1
KR_6412929797,420,1,14,-1,9,1,1,0,4,5,1,-1,0,1,4,6,2,1,1,0,0,10,-32,-2,6,4,16,0,0,1,1,0,1,3,1
KR_6728243571,420,1,6,7,1,0,1,1,2,3,1,-1,5,6,-1,2,3,1,3,2,0,2,3,8,2,10,0,0,0,1,1,1,1,5,1
KR_6194779881,420,0,51,-13,-1,4,4,0,-5,1,6,1,2,1,0,1,1,-1,0,1,0,-5,14,-3,6,3,3,0,1,-1,-1,1,1,5,1
KR_6758989144,420,-1,-18,4,2,-4,0,4,3,3,0,3,5,2,-2,0,2,2,2,0,0,8,-17,-2,6,4,1,0,-1,1,-1,-1,1,3,1
KR_6764760859,420,-2,-54,-23,-3,0,1,1,1,2,1,0,1,1,-3,0,3,-1,0,1,0,-10,-2,-1,7,6,-1,0,0,-1,1,-1,-1,1,1
KR_6759388449,420,-5,-41,-8,-10,-4,1,5,-7,0,7,2,4,2,-2,3,5,1,5,4,0,-3,-25,0,2,2,0,0,-1,0,1,-1,-1,0,1
KR_6634321188,420,-1,-26,-12,2,0,2,2,-1,1,2,-1,2,3,3,5,2,1,1,0,0,-2,4,5,2,7,-2,0,0,1,1,0,1,6,1
KR_6746608422,420,2,22,-16,6,1,2,1,-4,0,4,2,2,0,7,8,1,0,1,1,0,9,-41,1,5,6,-2,0,1,0,-1,1,-1,0,1
KR_6744992781,420,2,65,4,5,-2,0,2,3,3,0,6,6,0,1,2,1,-3,0,3,0,1,-29,-2,6,4,7,0,1,1,-1,1,1,5,1
KR_6759659351,440,0,22,20,-5,-2,2,4,-3,0,3,2,4,2,-3,1,4,1,4,3,-1,-1,-1,0,7,7,-1,0,1,0,-1,1,-1,0,1
KR_6764138477,420,3,8,-8,17,4,6,2,3,5,2,7,7,0,2,3,1,1,2,1,1,19,124,6,2,8,1,0,1,1,1,1,1,2,1
KR_6757300946,420,0,51,0,0,-1,4,5,1,3,2,4,5,1,-1,1,2,-3,0,3,0,-5,-1,3,2,5,2,0,0,1,0,0,1,5,1
KR_6681134535,420,-1,17,-12,0,4,4,0,-2,3,5,2,3,1,-4,0,4,0,0,0,0,-4,112,0,4,4,1,0,1,0,1,1,-1,0,1
KR_6702517742,420,1,-2,-4,0,0,2,2,5,7,2,-5,3,8,3,6,3,-3,0,3,0,-3,6,0,3,3,0,0,0,1,-1,1,1,1,1
KR_6722143345,420,0,-97,-20,3,-1,0,1,0,1,1,2,3,1,2,2,0,0,0,0,0,7,35,3,9,12,-9,0,0,1,1,-1,1,1,1
KR_6767420987,420,6,66,-9,14,4,4,0,5,6,1,-1,5,6,5,5,0,1,1,0,-1,19,9,1,3,4,-1,0,1,1,1,1,-1,1,1
KR_6738569769,420,4,-22,28,7,3,4,1,5,8,3,-1,1,2,-1,3,4,1,1,0,0,5,5,3,3,6,-2,0,1,-1,1,1,-1,3,1
KR_6762532368,420,2,-3,-20,-3,-5,0,5,3,3,0,7,8,1,-5,0,5,-3,1,4,0,-6,12,1,1,2,-2,0,1,-1,1,1,1,3,1
KR_6751034795,440,2,91,22,-2,3,7,4,-2,1,3,-3,1,4,-2,1,3,2,2,0,0,-12,2,1,2,3,-3,0,2,-1,1,1,-1,4,1
KR_6768477290,420,0,-18,-1,-3,3,5,2,-1,2,3,-2,3,5,-2,4,6,-1,1,2,-1,-4,113,-4,8,4,3,0,0,-1,1,0,-1,2,1
KR_6650936521,420,0,37,23,5,3,3,0,1,2,1,-1,3,4,0,4,4,2,3,1,0,4,-36,5,0,5,1,0,2,1,-1,1,1,1,1
KR_6753337529,440,2,29,28,-2,-1,0,1,3,3,0,2,2,0,-5,0,5,-1,1,2,0,0,-11,-6,10,4,8,0,1,-1,1,1,-1,1,1
KR_6745419781,420,2,64,-2,1,2,4,2,1,3,2,0,3,3,-3,0,3,1,1,0,0,-4,428,1,3,4,-3,0,1,-1,1,1,-1,2,1
KR_6758405047,420,0,-5,2,7,-2,1,3,-1,1,2,3,6,3,4,5,1,3,3,0,0,4,-111,-5,9,4,4,0,1,1,1,1,1,5,1
KR_6749077462,420,-1,28,24,-4,2,3,1,-2,2,4,-5,2,7,1,7,6,0,1,1,1,-8,6,-2,6,4,1,0,0,0,1,1,1,0,1
KR_6758424872,420,-1,-14,-12,1,0,2,2,2,4,2,-2,1,3,2,5,3,-1,1,2,1,4,36,-2,5,3,-35,0,1,1,0,1,1,1,1
KR_6766904191,420,7,21,20,16,1,1,0,2,5,3,6,7,1,4,6,2,3,3,0,0,17,7,4,0,4,1,0,1,-1,0,1,1,6,1
KR_6697853620,420,1,-39,16,-1,0,1,1,2,4,2,2,4,2,-6,1,7,1,1,0,0,2,4,2,4,6,0,0,-1,0,-1,-1,-1,0,1
KR_6768134401,420,4,-3,-3,4,2,2,0,1,1,0,2,2,0,-1,5,6,0,2,2,0,0,-1,-3,8,5,1,0,0,1,1,0,-1,5,1
KR_6733156506,420,6,118,28,17,5,6,1,3,4,1,3,8,5,4,7,3,2,4,2,2,15,-18,5,3,8,0,0,2,1,1,1,1,5,1
KR_6730989081,420,5,58,43,11,-2,1,3,7,7,0,1,2,1,5,6,1,0,2,2,0,6,12,0,1,1,-4,0,2,1,1,1,1,6,1
KR_6636716819,440,0,-2,4,3,1,2,1,2,2,0,3,4,1,1,3,2,-4,0,4,0,-1,-16,-6,11,5,5,0,1,1,1,1,-1,3,1
KR_6762282099,420,1,56,-24,2,-1,1,2,3,4,1,-4,2,6,5,7,2,-1,0,1,0,15,32,4,3,7,1,0,2,1,1,1,-1,1,1
KR_6732598045,440,1,22,8,3,1,3,2,0,1,1,-2,1,3,3,3,0,1,1,0,0,6,-6,-1,6,5,5,0,1,1,0,1,1,3,1
KR_6720206013,420,2,29,-12,3,0,1,1,-4,4,8,6,8,2,3,3,0,-2,0,2,-1,7,7,-3,7,4,2,0,-1,1,-1,-1,-1,2,1
KR_6744269671,420,1,8,6,6,2,5,3,-1,1,2,0,2,2,4,5,1,1,1,0,0,11,-23,7,3,10,1,0,0,1,1,-1,-1,6,1
KR_6698203580,420,5,48,16,10,0,1,1,3,4,1,5,7,2,2,3,1,0,1,1,2,11,36,4,4,8,1,0,0,0,1,0,1,0,1
KR_6761951136,420,3,25,19,2,3,4,1,-1,2,3,2,2,0,-3,3,6,1,1,0,0,-1,-3,-4,7,3,3,0,1,1,1,1,1,5,1
KR_6668632748,420,-1,13,-5,1,-3,0,3,-3,2,5,2,2,0,3,3,0,2,2,0,0,-1,2,5,2,7,3,0,0,1,-1,0,-1,2,1
KR_6667558722,420,0,-23,21,-5,-1,1,2,-1,2,3,-5,1,6,2,4,2,0,0,0,0,-1,-42,-4,7,3,-2,0,0,-1,0,0,-1,4,1
KR_6636110094,420,0,45,40,10,1,3,2,7,7,0,-2,4,6,4,6,2,0,1,1,2,18,-1,-1,4,3,-6,0,1,1,-1,1,1,2,1
KR_6724480822,420,0,25,16,-6,0,1,1,-1,0,1,3,4,1,-8,0,8,0,2,2,0,-9,2,-3,4,1,2,0,0,1,-1,0,1,3,1
KR_6745189253,420,1,26,5,1,0,1,1,5,9,4,-2,1,3,2,4,2,-4,0,4,-1,8,41,1,5,6,-1,0,1,1,1,1,-1,3,1
KR_6742999276,420,4,12,23,8,-2,2,4,-1,4,5,4,5,1,8,8,0,-1,1,2,1,13,10,2,4,6,5,0,0,1,1,1,1,5,1
KR_6767726476,420,-1,45,1,-6,-1,1,2,2,5,3,-8,3,11,0,0,0,1,2,1,0,-7,317,-2,7,5,1,0,1,1,1,1,1,4,1
KR_6767274661,420,2,-43,-15,1,1,3,2,7,7,0,-1,1,2,-1,5,6,-5,1,6,0,-3,222,-2,3,1,-11,0,0,0,1,0,-1,0,1
KR_6735361363,420,3,97,27,4,3,5,2,0,2,2,-3,1,4,3,3,0,1,1,0,0,-1,3,1,1,2,-2,0,0,1,-1,1,1,5,1
KR_6749885397,420,7,113,20,15,-1,1,2,9,10,1,2,3,1,3,7,4,2,3,1,0,18,13,2,2,4,5,0,0,1,0,1,1,6,1
KR_6679000386,420,1,68,12,6,2,2,0,1,3,2,2,2,0,2,4,2,-1,0,1,0,1,-13,2,4,6,1,0,1,1,1,1,1,5,1
KR_6736021369,420,4,65,-40,13,5,5,0,2,8,6,7,8,1,0,2,2,-1,0,1,0,15,7,1,5,6,-1,0,2,-1,1,1,1,5,1
KR_6717511395,420,7,44,33,12,1,2,1,0,3,3,0,4,4,6,7,1,5,6,1,0,6,150,0,4,4,2,0,3,1,1,1,1,3,1
KR_6726873297,440,0,72,-16,-6,-2,1,3,-5,3,8,-1,4,5,1,6,5,1,2,1,1,-1,-5,-6,11,5,-4,0,-1,0,-1,-1,1,0,1
KR_6768421478,420,1,-45,-4,6,0,1,1,1,2,1,2,2,0,2,4,2,1,2,1,0,8,25,0,4,4,4,0,0,1,1,0,-1,2,1
KR_6645303077,420,-1,92,-11,3,3,3,0,-2,3,5,-7,3,10,7,8,1,2,3,1,0,5,-9,-1,6,5,7,0,1,1,1,1,1,4,1
KR_6387519858,420,1,61,18,0,-5,0,5,3,4,1,-3,0,3,3,4,1,2,2,0,0,-3,120,5,5,10,-3,0,0,-1,-1,0,-1,2,1
KR_6674038470,420,4,5,27,5,3,4,1,1,2,1,1,3,2,-1,0,1,1,2,1,0,2,0,2,4,6,1,0,0,1,1,0,1,6,1
KR_6714208794,420,2,28,-4,-2,-1,4,5,2,2,0,-4,1,5,1,1,0,0,1,1,0,0,4,3,4,7,-1,0,2,-1,1,1,-1,1,1
KR_6681463153,420,4,20,32,4,0,0,0,-1,2,3,2,4,2,2,3,1,1,4,3,0,4,110,-5,7,2,4,0,0,1,-1,0,-1,3,1
KR_6767288859,420,1,10,-12,5,-3,0,3,2,6,4,0,3,3,5,5,0,1,4,3,0,0,-111,-1,6,5,-1,0,2,-1,0,1,-1,2,1
KR_6747868182,440,3,104,4,9,3,4,1,-3,2,5,3,4,1,6,6,0,0,2,2,0,7,113,2,2,4,6,0,1,1,-1,1,1,5,1
KR_6734287481,440,1,-10,-12,-2,4,4,0,-2,2,4,-1,1,2,-3,1,4,0,0,0,0,-2,5,1,4,5,-2,0,-1,-1,0,-1,-1,4,1
KR_6631912592,420,2,59,20,6,1,1,0,-1,4,5,6,7,1,1,1,0,-1,0,1,0,3,5,5,5,10,-5,0,0,1,1,0,-1,2,1
KR_6768717749,420,3,32,38,5,1,2,1,5,7,2,-1,2,3,-1,2,3,1,3,2,0,7,78,1,4,5,-4,0,1,0,0,1,1,0,1
KR_6703066051,420,1,-51,7,1,-3,1,4,0,1,1,1,3,2,2,5,3,1,1,0,0,0,-45,5,1,6,24,0,1,1,1,-1,1,4,1
KR_6661522275,420,3,46,1,8,2,3,1,4,6,2,1,2,1,0,0,0,1,1,0,0,5,8,0,4,4,-3,0,2,-1,1,1,1,1,1
KR_6656676989,420,5,44,16,9,6,7,1,-2,3,5,4,4,0,2,3,1,-1,0,1,0,-2,-3,5,2,7,13,0,1,1,1,1,1,2,1
KR_6738664263,420,-3,-2,-4,-13,1,3,2,4,7,3,-11,1,12,-2,2,4,-5,0,5,0,-13,4,4,2,6,-5,0,0,-1,-1,1,1,1,1
KR_6721522571,420,4,112,15,15,3,3,0,4,4,0,-1,3,4,3,5,2,6,8,2,0,16,3,-2,6,4,4,0,4,-1,1,1,1,1,1
KR_6710618625,420,-1,-79,-24,4,3,5,2,2,6,4,0,1,1,-1,0,1,0,1,1,0,9,32,1,6,7,-1,0,-1,1,1,-1,-1,4,1
KR_6484066456,420,-2,11,-4,1,-1,1,2,0,2,2,-1,0,1,4,6,2,-1,1,2,0,-1,-7,-2,5,3,5,0,1,1,-1,1,-1,2,1
KR_6748048665,440,6,7,20,13,5,5,0,2,2,0,2,2,0,1,3,2,3,3,0,0,3,29,-3,7,4,8,0,0,1,-1,-1,1,4,1
KR_6769162832,420,4,40,18,14,0,1,1,1,2,1,7,7,0,3,5,2,3,3,0,0,14,5,1,5,6,-4,0,1,1,1,1,-1,3,1
KR_6765699030,420,4,58,23,9,1,2,1,-1,1,2,8,8,0,0,1,1,1,2,1,0,2,122,0,4,4,4,0,0,1,0,0,1,6,1
KR_6762851647,420,2,47,12,4,2,3,1,4,4,0,0,0,0,-1,2,3,-1,1,2,0,4,-18,1,6,7,7,0,1,-1,0,1,-1,3,1
KR_6768788948,420,2,-14,-46,9,-2,0,2,-2,1,3,2,3,1,11,13,2,0,2,2,0,16,-3,-1,6,5,6,0,0,1,-1,-1,1,6,1
KR_6742956920,420,1,15,28,10,1,3,2,0,4,4,2,3,1,7,7,0,0,1,1,0,10,318,1,4,5,21,0,0,1,1,1,1,4,1
KR_6758980049,420,3,39,1,6,1,4,3,1,1,0,-1,2,3,5,5,0,0,0,0,0,7,-255,-1,4,3,3,0,-1,-1,-1,1,1,4,1
KR_6547043609,420,2,50,-12,2,-1,0,1,-2,0,2,-3,1,4,8,8,0,0,1,1,0,6,-6,-1,8,7,6,0,1,-1,1,1,-1,3,1
KR_6675281573,420,4,79,-4,19,4,6,2,4,7,3,11,12,1,2,9,7,-2,0,2,2,22,8,6,2,8,-1,0,3,1,1,1,1,1,1
KR_6760983461,420,3,-2,4,-1,1,3,2,-4,2,6,2,3,1,2,4,2,-2,0,2,-1,-9,3,3,3,6,0,0,-1,0,1,-1,-1,0,1
KR_6724772322,420,1,-82,16,3,-1,3,4,1,3,2,2,3,1,0,2,2,1,2,1,-1,2,309,-2,6,4,-3,0,0,-1,1,0,-1,6,1
KR_6740637430,420,5,63,26,20,-2,1,3,5,8,3,10,14,4,5,9,4,2,4,2,0,11,-12,5,1,6,-1,0,1,1,0,1,-1,6,1
KR_6755726067,420,0,51,-12,0,3,3,0,0,2,2,3,7,4,-3,1,4,-3,2,5,0,-3,-28,-3,7,4,4,0,-2,1,-1,-1,-1,4,1
KR_6758810635,420,2,10,13,2,0,2,2,5,7,2,1,2,1,-4,2,6,0,2,2,0,-6,6,-1,5,4,0,0,0,-1,1,0,1,3,1
KR_6670128738,420,2,20,13,4,0,2,2,3,7,4,-4,1,5,5,7,2,0,3,3,0,7,67,3,0,3,0,0,-1,1,1,-1,1,1,1
KR_6756398512,420,-1,-112,-17,2,-3,1,4,5,8,3,-4,2,6,0,2,2,4,6,2,0,1,17,0,6,6,-1,0,0,-1,1,0,-1,6,1
KR_6679224915,420,2,18,23,5,1,1,0,0,1,1,1,2,1,1,5,4,2,2,0,0,7,73,3,6,9,1,0,1,-1,1,1,-1,2,1
KR_6721269883,420,-3,0,-24,-1,-1,2,3,0,5,5,-1,4,5,1,3,2,0,1,1,-1,3,25,3,3,6,-6,0,0,-1,1,1,-1,4,1
KR_6740971366,440,7,95,45,12,3,4,1,-1,2,3,6,7,1,3,4,1,1,2,1,-1,4,51,-1,1,0,-23,0,2,1,-1,1,-1,1,1
KR_6761884762,440,-2,-40,-9,-2,-5,1,6,5,5,0,1,3,2,-2,2,4,-1,2,3,0,4,2,2,5,7,6,0,-1,0,-1,-1,1,0,1
KR_6767304810,440,4,92,5,7,-3,1,4,-1,2,3,4,5,1,2,7,5,5,5,0,1,2,16,-2,8,6,2,0,1,1,1,1,1,1,1
KR_6753072005,420,-2,-3,7,-10,0,1,1,-1,3,4,-5,0,5,-2,0,2,-2,0,2,-1,-4,-6,-5,8,3,1,0,-1,0,-1,-1,-1,0,1
KR_6765964492,420,-1,-24,12,-4,1,4,3,3,5,2,0,1,1,-1,1,2,-7,1,8,0,-13,-19,5,4,9,-1,0,0,1,1,0,1,5,1
KR_6756435859,440,-3,-75,-22,-6,-3,1,4,-1,0,1,-1,2,3,0,4,4,-1,1,2,0,-2,-311,2,2,4,-1,0,-1,-1,-1,-1,-1,3,1
KR_6762137031,420,0,56,0,6,1,1,0,1,6,5,6,7,1,-1,3,4,-1,1,2,0,1,28,-1,7,6,7,0,1,0,1,1,1,0,1
KR_6630606402,420,-1,43,24,1,-2,1,3,-2,0,2,4,4,0,-1,2,3,2,2,0,0,1,117,-1,4,3,0,0,1,-1,0,1,1,4,1
KR_6746955576,440,2,8,8,8,3,4,1,6,9,3,3,6,3,-2,1,3,-2,1,3,1,7,-20,1,3,4,-1,0,0,1,-1,0,1,6,1
KR_6758078295,440,4,61,4,3,-1,4,5,-1,0,1,3,5,2,-4,3,7,6,7,1,2,-1,-167,-4,7,3,0,0,0,-1,0,1,1,2,1
KR_6765842253,420,-1,-11,2,3,-2,0,2,-1,4,5,5,5,0,0,0,0,1,1,0,0,8,-13,4,2,6,-2,0,1,-1,-1,1,1,3,1
KR_6766239207,420,4,27,35,5,1,2,1,1,3,2,0,2,2,2,5,3,1,1,0,1,6,0,6,1,7,-1,0,0,1,-1,0,1,3,1
KR_6755308212,420,0,55,5,-2,2,6,4,0,6,6,3,4,1,-6,1,7,-1,0,1,-1,1,-1,-2,7,5,-5,0,1,1,1,1,-1,2,1
KR_6751242919,440,-1,-5,-36,7,-1,0,1,2,5,3,3,5,2,-1,2,3,4,4,0,0,13,-3,-1,6,5,5,0,0,1,0,0,-1,2,1
KR_6735628998,420,4,93,37,9,5,5,0,6,7,1,2,3,1,-3,3,6,-1,0,1,2,6,-107,3,2,5,2,0,1,1,1,1,1,5,1
KR_6728371072,420,0,27,0,4,-4,1,5,-2,2,4,3,3,0,8,11,3,-1,1,2,0,3,3,3,3,6,0,0,-1,1,0,-1,1,1,1
KR_6748924672,440,3,-8,3,7,3,4,1,-2,0,2,0,2,2,2,4,2,4,4,0,0,7,-15,3,2,5,-1,0,0,1,0,0,1,4,1
KR_6767901742,420,2,48,16,6,0,0,0,-2,3,5,0,0,0,7,9,2,1,2,1,0,6,2,-2,10,8,3,0,1,1,-1,1,1,6,1
KR_6723925344,420,3,114,-14,9,4,4,0,-1,2,3,6,7,1,0,0,0,0,0,0,0,4,13,-1,6,5,0,0,0,0,-1,1,1,0,1
KR_6729701449,420,-1,-96,20,-3,1,1,0,1,3,2,-6,1,7,1,1,0,0,2,2,0,-4,106,0,5,5,5,0,-1,1,1,-1,-1,2,1
KR_6634479402,420,3,43,16,6,2,2,0,2,2,0,1,1,0,1,3,2,0,0,0,0,9,-15,6,4,10,-6,0,0,-1,1,0,-1,3,1
KR_6647881511,420,6,57,61,13,1,2,1,2,5,3,7,7,0,3,4,1,0,0,0,0,5,-83,8,2,10,0,0,2,1,1,1,1,3,1
KR_6761412918,420,0,-11,34,7,6,7,1,2,4,2,-2,2,4,1,3,2,0,3,3,0,7,2,2,1,3,3,0,0,0,0,0,1,0,1
KR_6754131933,420,-2,-44,15,-7,4,5,1,-4,4,8,-3,1,4,-3,0,3,-1,1,2,0,-10,-3,1,5,6,2,0,-1,-1,1,1,-1,6,1
KR_6754197187,420,1,42,23,2,1,2,1,0,2,2,0,3,3,1,1,0,0,0,0,0,-4,-3,-1,6,5,-3,0,2,-1,1,1,1,6,1
KR_6730486160,420,2,44,-8,10,3,3,0,-1,0,1,2,5,3,3,4,1,3,3,0,1,13,5,4,2,6,2,0,0,-1,1,1,1,1,1
KR_6735789270,420,1,4,36,2,0,0,0,1,2,1,1,1,0,1,2,1,-1,0,1,0,2,21,-2,9,7,-1,0,0,1,1,0,1,6,1
KR_6769101906,420,1,-24,40,-7,-1,2,3,-1,1,2,-3,1,4,-2,0,2,0,1,1,0,-7,-19,-5,6,1,4,0,-1,1,-1,-1,-1,3,1
KR_6761727976,440,3,84,23,5,2,2,0,3,7,4,0,2,2,-1,0,1,1,2,1,0,8,6,3,4,7,-3,0,1,1,-1,1,-1,5,1
KR_6732667723,420,4,29,13,9,1,1,0,6,7,1,-3,1,4,2,5,3,3,4,1,0,7,4,-2,6,4,0,0,2,-1,1,1,1,6,1
KR_6758478487,420,1,-7,0,4,4,5,1,-3,1,4,2,2,0,2,7,5,-1,1,2,0,-1,-1,0,6,6,4,0,0,-1,1,-1,1,4,1
KR_6762092310,420,7,151,17,16,1,2,1,3,4,1,3,3,0,6,7,1,3,3,0,0,12,-18,3,1,4,-2,0,4,1,1,1,1,2,1
KR_6703724976,420,2,67,-16,11,4,4,0,3,3,0,2,2,0,3,6,3,-1,0,1,0,9,-9,-1,5,4,-2,0,0,1,-1,1,1,2,1
KR_6755745001,440,0,-32,44,2,0,5,5,3,3,0,-6,0,6,4,5,1,1,1,0,0,2,-106,-1,2,1,-1,0,0,1,0,0,1,3,1
KR_6766832509,420,0,61,23,5,6,7,1,-1,2,3,0,2,2,0,3,3,0,0,0,1,3,-5,-3,5,2,-1,0,1,-1,1,1,1,4,1
KR_6465285993,420,1,-5,-17,12,0,1,1,8,9,1,2,2,0,1,2,1,1,1,0,2,13,12,7,2,9,1,0,0,1,-1,1,1,2,1
KR_6659483491,420,-4,-54,2,-1,2,2,0,-2,3,5,2,4,2,0,1,1,-3,1,4,0,4,-7,0,4,4,-3,0,0,-1,1,1,-1,1,1
KR_6713675303,420,5,-22,4,15,4,4,0,5,5,0,0,2,2,5,6,1,1,1,0,0,19,-1,0,6,6,1,0,1,1,1,1,1,6,1
KR_6761968523,420,2,-27,-14,5,3,6,3,-2,0,2,4,4,0,0,2,2,0,0,0,0,9,-3,1,4,5,4,0,0,-1,-1,1,1,2,1
KR_6750694651,420,2,-16,17,6,0,3,3,6,8,2,-1,2,3,-1,3,4,2,2,0,0,4,-44,4,6,10,28,0,1,1,1,1,-1,4,1
KR_6688437600,440,-1,-7,6,1,-2,0,2,1,2,1,-2,0,2,4,4,0,0,0,0,0,7,-12,0,3,3,4,0,1,1,1,1,-1,1,1
KR_6721031047,420,-1,-3,5,-1,5,5,0,-4,2,6,5,6,1,-6,1,7,-1,1,2,0,-6,-2,3,5,8,-1,0,0,1,-1,1,1,5,1
KR_6629807327,440,1,38,20,3,4,4,0,1,1,0,1,7,6,1,2,1,-4,1,5,0,6,-103,2,2,4,3,0,0,1,-1,0,-1,1,1
KR_6719012642,420,1,19,23,1,5,5,0,0,2,2,0,3,3,-4,0,4,0,0,0,0,-5,-7,-3,6,3,-1,0,0,-1,1,1,-1,4,1
KR_6763628772,420,-1,29,12,-4,5,6,1,0,4,4,-8,1,9,-1,1,2,0,1,1,1,-15,37,6,3,9,-2,0,1,0,0,1,1,0,1
KR_6761962379,420,4,51,47,9,1,2,1,0,0,0,5,6,1,1,3,2,2,3,1,0,4,-3,1,3,4,-2,0,2,1,1,1,1,1,1
KR_6708767079,420,4,8,30,4,4,4,0,-1,1,2,2,2,0,0,1,1,-1,0,1,0,0,16,-2,7,5,1,0,1,-1,1,1,-1,1,1
KR_6768056011,440,1,31,34,6,1,1,0,-3,3,6,1,5,4,3,6,3,4,4,0,0,4,17,0,5,5,4,0,1,1,1,1,1,5,1
KR_6722488226,420,1,-6,-18,-5,0,4,4,-3,1,4,-3,2,5,1,5,4,0,1,1,-2,-10,-10,-3,6,3,3,0,0,1,-1,0,-1,6,1
KR_6768128787,420,1,11,-3,3,0,0,0,1,1,0,7,11,4,-3,0,3,-2,1,3,1,8,-117,2,3,5,-2,0,-1,1,-1,-1,1,3,1
KR_6748591608,420,1,49,7,5,0,2,2,-1,1,2,4,6,2,3,7,4,-1,1,2,1,3,-20,-2,6,4,5,0,0,1,-1,1,1,5,1
KR_6600973600,420,-4,-44,-2,-5,-8,1,9,0,4,4,-1,2,3,2,6,4,2,3,1,1,3,-10,-3,7,4,-3,0,-1,0,1,-1,1,0,1
KR_6751562297,420,2,-74,24,14,-2,1,3,3,4,1,4,4,0,3,3,0,6,6,0,1,16,353,1,3,4,6,0,0,1,1,1,1,4,1
KR_6613470253,420,1,-45,19,-7,5,6,1,1,1,0,-2,2,4,-10,0,10,-1,0,1,-1,-13,-2,-2,6,4,-4,0,0,-1,1,1,-1,1,1
KR_6747534691,420,-1,-56,-32,-4,-3,2,5,-3,3,6,0,2,2,3,5,2,-1,2,3,0,-4,-56,1,5,6,36,0,-2,1,-1,-1,1,6,1
KR_6765385261,420,-2,-2,8,-1,-2,0,2,4,4,0,-6,3,9,4,8,4,-1,1,2,-2,3,-10,-1,8,7,-2,0,-1,1,-1,1,-1,6,1
KR_6580792049,420,-1,-2,17,2,0,1,1,2,4,2,-2,0,2,3,3,0,-1,2,3,0,2,-37,-2,3,1,-3,0,0,1,1,0,1,4,1
KR_6613415895,420,2,31,-16,2,1,3,2,3,5,2,-2,5,7,1,3,2,-1,1,2,0,10,-4,1,3,4,-1,0,0,1,1,-1,-1,2,1
KR_6659814014,420,5,91,22,8,2,4,2,2,5,3,2,4,2,2,5,3,0,0,0,-1,11,94,-2,5,3,0,0,1,-1,1,1,-1,3,1
KR_6745591737,420,6,50,2,6,-1,3,4,1,2,1,-1,4,5,6,6,0,1,1,0,0,15,-5,2,2,4,1,0,1,1,0,1,1,5,1
KR_6673268646,420,0,52,14,0,1,1,0,2,3,1,0,1,1,-3,3,6,0,1,1,0,1,103,4,2,6,25,0,0,1,0,0,1,5,1
KR_6757926945,420,0,80,-31,3,1,3,2,-7,0,7,6,7,1,2,3,1,1,3,2,0,-1,-11,4,0,4,6,0,0,1,-1,1,-1,6,1
KR_6703959994,420,-3,-61,-4,-5,0,2,2,-2,2,4,-1,3,4,-3,1,4,1,2,1,0,1,9,1,5,6,-3,0,-1,0,0,-1,-1,0,1
KR_6757844258,420,4,59,4,6,2,2,0,-4,2,6,3,3,0,-1,1,2,6,7,1,0,7,-5,4,6,10,-1,0,0,1,0,0,1,4,1
KR_6760539143,420,5,59,-4,9,2,6,4,0,2,2,8,8,0,-1,2,3,0,0,0,0,5,-43,3,1,4,7,0,2,1,1,1,1,1,1
KR_6764055474,420,-2,-47,-12,-3,4,4,0,1,1,0,1,4,3,-8,0,8,-1,0,1,0,-7,-1,-4,5,1,3,0,-1,1,-1,-1,-1,5,1
KR_6766744826,420,1,24,-16,9,1,2,1,0,1,1,9,11,2,-3,4,7,2,3,1,0,9,11,1,3,4,-3,0,1,1,0,1,1,6,1
KR_6555788997,420,4,25,12,4,3,3,0,3,6,3,1,2,1,-3,1,4,0,1,1,-1,-1,-40,-2,5,3,2,0,0,1,-1,0,-1,4,1
KR_6769001062,440,-4,-28,-24,-6,0,1,1,0,0,0,-7,2,9,2,2,0,-1,1,2,-1,0,13,1,4,5,-1,0,0,0,1,0,-1,0,1
KR_6768132121,440,0,-38,3,-3,-7,2,9,4,6,2,-3,2,5,1,4,3,2,2,0,0,-5,-7,-1,5,4,-2,0,-2,1,-1,-1,1,6,1
KR_6499776688,420,0,25,-8,1,-4,1,5,3,4,1,6,7,1,0,5,5,-4,0,4,0,-4,-24,-5,10,5,1,0,0,-1,1,1,1,4,1
KR_6751450945,420,1,77,2,2,3,3,0,-9,2,11,7,9,2,-1,1,2,2,2,0,-3,-10,-8,-3,6,3,4,0,0,1,-1,0,-1,4,1
KR_6740453445,420,1,46,32,4,5,5,0,1,3,2,0,4,4,-2,0,2,0,1,1,0,-3,3,-2,5,3,0,0,1,1,1,1,1,3,1
KR_6765851533,420,0,-48,4,0,0,0,0,0,0,0,-2,4,6,3,4,1,-1,1,2,-1,9,-152,-6,7,1,1,0,-1,1,-1,-1,-1,1,1
KR_6755439404,420,-1,-58,0,2,2,2,0,0,3,3,-1,1,2,2,2,0,-1,0,1,0,6,-261,-2,4,2,-1,0,-1,1,-1,-1,-1,1,1
KR_6760216681,440,5,78,25,12,0,1,1,4,5,1,-1,0,1,7,7,0,2,4,2,0,15,-49,1,4,5,1,0,1,1,1,1,1,1,1
KR_6766190373,420,4,26,0,4,-1,1,2,2,5,3,3,7,4,1,4,3,-1,1,2,0,-4,6,-1,4,3,-1,0,0,1,-1,0,-1,6,1
KR_6687716431,420,2,-2,4,3,0,0,0,-4,1,5,2,4,2,1,7,6,4,4,0,0,5,4,-2,5,3,0,0,1,-1,1,-1,-1,3,1
KR_6761416732,420,1,-14,-16,0,2,2,0,-2,2,4,0,5,5,-4,1,5,4,4,0,0,6,16,0,5,5,1,0,0,1,1,0,-1,1,1
KR_6763305727,420,4,5,39,6,5,5,0,-1,2,3,-1,0,1,2,2,0,1,1,0,0,-2,5,4,4,8,1,0,1,1,1,1,1,2,1
KR_6752592437,420,3,53,34,8,-1,2,3,0,2,2,-1,0,1,2,2,0,8,9,1,1,13,-35,5,1,6,24,0,1,1,-1,1,1,1,1
KR_6767006112,420,1,-4,30,5,0,1,1,0,4,4,1,2,1,3,3,0,1,1,0,-1,4,-14,-8,9,1,5,0,0,1,-1,1,-1,1,1
KR_6749630148,440,6,83,24,9,4,4,0,2,7,5,0,1,1,0,4,4,3,3,0,0,8,9,4,5,9,0,0,1,1,-1,1,-1,2,1
KR_6752324388,420,0,-13,16,4,-1,2,3,3,6,3,0,2,2,3,4,1,-1,2,3,4,14,-19,0,6,6,0,0,0,1,1,1,1,4,1
KR_6732641046,420,0,-64,9,-1,1,4,3,0,2,2,0,2,2,-1,1,2,-1,0,1,-1,-1,-6,3,2,5,-3,0,-2,1,1,-1,-1,1,1
KR_6649404396,420,-2,-37,7,-2,-1,2,3,5,6,1,-3,1,4,-4,2,6,1,2,1,0,0,-8,4,4,8,4,0,-1,-1,1,-1,-1,5,1
KR_6765347639,420,0,40,-7,-3,-5,3,8,-1,0,1,-1,1,2,4,4,0,0,1,1,0,-7,0,1,2,3,2,0,1,1,-1,1,-1,2,1
KR_6726841308,420,5,41,20,18,1,3,2,8,8,0,1,2,1,2,4,2,6,7,1,1,14,-1,0,4,4,4,0,1,-1,0,1,1,2,1
KR_6765906413,420,0,-21,9,-1,-5,0,5,4,5,1,-5,1,6,2,5,3,3,4,1,0,0,-2,-5,6,1,2,0,1,1,1,1,1,1,1
KR_6717579219,420,2,20,30,0,-2,1,3,3,5,2,-1,1,2,-1,5,6,1,1,0,0,2,-1,-2,4,2,6,0,-1,-1,1,-1,-1,5,1
KR_6765777118,420,3,76,9,8,1,2,1,-1,4,5,2,3,1,5,8,3,1,1,0,0,4,4,2,5,7,-7,0,2,-1,1,1,1,6,1
KR_6700932560,440,-2,28,8,-6,-3,4,7,0,2,2,-3,1,4,2,3,1,-2,0,2,0,-4,15,2,0,2,0,0,1,-1,0,1,1,5,1
KR_6761643849,440,6,85,0,13,2,4,2,3,6,3,2,2,0,4,5,1,2,3,1,0,7,-3,1,4,5,1,0,1,1,-1,1,-1,2,1
KR_6661821303,420,2,-2,4,3,-1,0,1,3,3,0,5,5,0,-1,3,4,-3,0,3,0,11,-57,-1,8,7,1,0,0,1,-1,0,-1,5,1
KR_6753807598,420,-1,-3,-13,3,0,1,1,-2,1,3,1,1,0,4,5,1,0,2,2,-1,10,-16,-7,8,1,5,0,-1,1,-1,-1,-1,3,1
KR_6676103014,420,2,13,36,0,3,3,0,-6,2,8,1,3,2,2,4,2,0,0,0,0,-3,-2,-3,6,3,-3,0,0,0,-1,0,1,0,1
KR_6715682932,420,-2,7,9,-4,2,2,0,-5,0,5,-3,0,3,3,4,1,-1,0,1,-1,-9,21,1,4,5,0,0,0,0,1,0,-1,0,1
KR_6737910856,420,5,-12,23,13,3,4,1,0,3,3,4,4,0,1,3,2,5,5,0,0,13,-20,1,5,6,21,0,0,0,-1,1,1,0,1
KR_6759876840,420,1,50,20,-5,4,4,0,0,3,3,-2,1,3,-4,1,5,-3,1,4,0,-12,42,-3,7,4,-20,0,0,-1,1,-1,-1,2,1
KR_6728704847,420,3,-20,4,5,-2,2,4,0,5,5,2,4,2,3,3,0,2,2,0,0,8,2,4,5,9,-1,0,0,0,0,1,-1,0,1
KR_6746793354,420,6,83,11,22,5,5,0,4,5,1,0,4,4,7,7,0,6,6,0,0,18,20,-4,7,3,1,0,2,-1,-1,1,1,5,1
KR_6722332210,420,-1,-70,-32,2,-2,2,4,-2,0,2,4,4,0,1,3,2,1,2,1,-1,3,-9,-4,7,3,1,0,0,1,1,0,-1,2,1
KR_6694705770,420,1,90,-12,-1,-2,0,2,0,5,5,-1,3,4,3,3,0,-1,1,2,0,1,-13,-1,4,3,5,0,1,-1,-1,1,1,1,1
KR_6759575727,440,3,45,-20,5,0,2,2,-1,1,2,0,1,1,7,7,0,-1,0,1,0,8,-38,-1,6,5,9,0,1,1,1,1,1,6,1
KR_6631400122,420,2,44,-5,7,-1,0,1,5,6,1,2,2,0,0,1,1,1,1,0,0,9,3,0,4,4,-5,0,1,-1,1,1,1,2,1
KR_6733263559,420,0,35,-10,-2,2,4,2,-7,3,10,1,2,1,2,4,2,0,1,1,0,-4,-2,4,5,9,1,0,0,1,-1,1,-1,3,1
KR_6701023281,440,3,67,7,10,2,5,3,-2,1,3,3,6,3,7,11,4,0,3,3,0,-6,3,1,2,3,3,0,3,1,1,1,1,1,1
KR_6704345951,440,1,2,20,11,-2,0,2,1,2,1,8,8,0,6,6,0,-2,1,3,1,14,3,0,4,4,2,0,-1,1,0,-1,1,1,1
KR_6753040843,420,2,61,12,3,0,1,1,0,4,4,3,4,1,2,3,1,-2,0,2,-1,-1,69,-1,7,6,-2,0,1,1,1,1,-1,2,1
KR_6730648948,440,-1,-42,-16,9,3,3,0,-4,0,4,3,3,0,7,7,0,0,1,1,0,11,5,4,2,6,1,0,-1,1,-1,-1,1,2,1
KR_6703766200,420,6,30,36,7,3,3,0,-1,2,3,1,2,1,2,3,1,2,4,2,1,9,-8,-4,6,2,5,0,0,-1,1,0,1,4,1
KR_6766690998,420,3,13,-15,19,3,3,0,2,3,1,0,3,3,15,17,2,-1,3,4,1,19,63,0,5,5,3,0,2,1,0,1,1,2,1
KR_6573478905,440,4,9,-1,8,-1,2,3,4,5,1,-1,1,2,6,8,2,0,0,0,0,11,14,-3,5,2,0,0,2,1,1,1,-1,1,1
KR_6765922792,440,-2,-48,-28,-9,1,1,0,5,6,1,-3,2,5,-1,3,4,-11,1,12,-1,-5,1,0,2,2,-2,0,0,-1,-1,1,-1,6,1
KR_6660946261,420,2,37,6,5,3,3,0,0,3,3,1,5,4,2,3,1,-1,0,1,1,10,-13,-2,6,4,0,0,0,1,0,1,1,5,1
KR_6763964925,420,3,70,0,3,-2,1,3,1,1,0,5,6,1,-2,2,4,1,3,2,0,-4,3,0,7,7,-8,0,1,1,-1,-1,-1,1,1
KR_6499760343,420,7,96,33,16,5,6,1,3,4,1,6,7,1,2,8,6,0,0,0,3,8,2,2,2,4,-1,0,2,1,1,1,1,3,1
KR_6762327901,420,0,4,-4,1,4,5,1,-2,1,3,1,1,0,-1,3,4,-1,0,1,0,4,-5,-1,4,3,0,0,1,1,-1,1,-1,5,1
KR_6716609488,420,3,2,28,10,-1,0,1,5,5,0,0,1,1,5,7,2,1,1,0,0,11,-309,4,3,7,3,0,0,-1,1,0,1,5,1
KR_6756204128,440,6,69,-35,8,1,3,2,2,3,1,5,5,0,-3,0,3,3,3,0,0,5,9,3,3,6,1,0,1,0,0,1,-1,0,1
KR_6759284521,420,0,22,-16,3,0,1,1,-2,4,6,0,3,3,6,7,1,-1,0,1,-1,8,-17,5,1,6,-2,0,-1,1,-1,-1,-1,1,1
KR_6764545700,420,0,14,-39,11,4,4,0,-2,3,5,7,9,2,4,4,0,-2,0,2,0,21,-11,-1,6,5,5,0,0,1,0,0,1,4,1
KR_6746786675,420,3,-55,8,2,0,1,1,1,2,1,-2,0,2,3,4,1,0,2,2,0,6,-2,-2,7,5,-3,0,0,0,-1,-1,-1,0,1
KR_6747719581,420,4,75,20,1,-1,1,2,-1,3,4,1,1,0,0,1,1,2,2,0,0,-5,-11,-4,6,2,5,0,1,1,-1,1,-1,1,1
KR_6728535060,420,-2,-108,28,-8,2,3,1,2,3,1,-3,0,3,-7,0,7,-2,0,2,0,-9,10,3,1,4,-7,0,1,-1,1,-1,-1,3,1
KR_6757676883,420,5,105,4,13,1,5,4,4,5,1,6,9,3,2,4,2,0,1,1,0,10,13,4,2,6,-4,0,1,1,1,1,1,3,1
KR_6740909951,420,4,47,16,9,-2,0,2,6,6,0,2,2,0,4,5,1,-1,0,1,0,13,-4,-3,3,0,1,0,2,-1,1,1,-1,5,1
KR_6763927710,440,-2,9,-11,-3,5,5,0,-7,0,7,-1,1,2,2,3,1,-2,0,2,0,-1,-4,1,5,6,7,0,1,-1,-1,1,-1,1,1
KR_6643507798,420,5,89,31,9,0,1,1,7,7,0,-3,3,6,7,7,0,-2,0,2,1,23,-64,1,3,4,2,0,2,1,1,1,1,6,1
KR_6764448848,420,3,24,-20,1,-2,0,2,-6,0,6,2,2,0,3,3,0,4,4,0,0,3,-2,-3,8,5,6,0,0,-1,-1,0,-1,5,1
KR_6760388142,420,3,58,-15,6,1,2,1,3,4,1,2,3,1,0,3,3,0,0,0,0,0,9,7,3,10,-1,0,1,-1,1,1,1,1,1
KR_6706826371,440,1,-13,-16,5,4,5,1,-2,2,4,2,5,3,-1,0,1,2,2,0,0,1,-1,-1,2,1,-6,0,0,-1,1,0,1,6,1
KR_6704304851,420,3,59,-13,3,4,4,0,-3,1,4,1,5,4,-1,1,2,2,2,0,0,7,7,1,1,2,3,0,2,-1,1,1,1,3,1
KR_6726715835,420,3,62,-4,10,2,3,1,1,2,1,3,3,0,3,3,0,1,1,0,0,9,-7,-2,7,5,9,0,1,1,1,1,1,4,1
KR_6733768461,420,2,26,-36,6,-2,1,3,6,8,2,-3,1,4,5,6,1,0,3,3,0,18,7,7,1,8,-4,0,1,-1,-1,1,-1,3,1
KR_6765831327,420,4,90,7,7,2,2,0,1,1,0,-2,0,2,7,8,1,-1,1,2,0,10,0,0,7,7,4,0,1,0,-1,1,1,0,1
KR_6698605329,420,4,35,12,7,-2,0,2,6,7,1,-1,0,1,1,2,1,3,3,0,0,7,-18,2,4,6,2,0,0,1,-1,0,1,5,1
KR_6734419845,420,2,-10,33,2,3,3,0,0,4,4,1,3,2,-3,0,3,1,1,0,0,-1,5,0,7,7,-6,0,1,0,1,1,1,0,1
KR_6768804122,420,4,42,-25,11,5,7,2,0,2,2,5,5,0,-1,3,4,2,3,1,0,5,-43,3,2,5,14,0,1,1,1,1,-1,4,1
KR_6643559948,420,5,43,40,13,2,2,0,5,7,2,0,1,1,7,7,0,-1,2,3,1,14,-2,-2,5,3,2,0,2,1,1,1,1,4,1
KR_6767205325,420,1,24,7,2,2,2,0,-1,2,3,1,4,3,0,1,1,0,0,0,0,5,-25,0,4,4,-1,0,-1,1,0,-1,1,1,1
KR_6697567534,420,7,68,9,19,7,8,1,5,5,0,5,7,2,-2,2,4,4,4,0,3,25,-17,5,3,8,1,0,0,1,1,-1,1,1,1
KR_6716715820,440,2,-63,26,2,3,3,0,-1,2,3,2,2,0,-2,1,3,0,1,1,0,5,0,0,4,4,5,0,0,-1,1,1,1,2,1
KR_6763611719,420,1,29,0,0,1,4,3,1,3,2,-4,0,4,0,1,1,2,3,1,0,-3,-5,-2,5,3,-1,0,0,-1,-1,1,1,2,1
KR_6600986908,420,1,-8,-11,6,1,2,1,-1,3,4,1,3,2,4,5,1,1,1,0,0,6,105,0,5,5,3,0,1,1,1,1,1,5,1
KR_6749288169,420,2,25,8,1,-2,0,2,7,10,3,0,0,0,-4,3,7,0,0,0,-1,6,6,-2,5,3,-1,0,1,1,1,1,-1,2,1
KR_6678894298,420,1,-6,11,4,1,3,2,2,4,2,3,4,1,-2,1,3,0,0,0,1,3,-10,2,3,5,-3,0,0,1,-1,0,1,5,1
KR_6768423516,420,2,50,12,8,-4,0,4,4,6,2,1,2,1,7,7,0,0,1,1,1,13,22,0,5,5,-7,0,2,1,0,1,1,3,1
KR_6658609939,420,1,21,-27,7,0,2,2,-1,1,2,1,2,1,4,5,1,3,3,0,0,14,-7,-3,7,4,6,0,0,1,-1,1,1,3,1
KR_6694896773,420,2,3,-8,2,0,2,2,1,2,1,0,4,4,-1,1,2,2,2,0,0,0,-19,1,5,6,1,0,0,1,-1,0,-1,6,1
KR_6707923675,420,4,51,-1,6,7,8,1,-4,4,8,2,6,4,4,7,3,-3,1,4,2,6,-17,2,5,7,2,0,0,1,0,1,1,2,1
KR_6655673732,420,3,39,23,2,-1,2,3,1,1,0,-1,1,2,3,3,0,0,0,0,0,4,31,4,2,6,-5,0,1,-1,1,1,-1,3,1
KR_6736127584,440,0,51,-75,3,5,5,0,0,2,2,-3,1,4,-2,1,3,3,4,1,0,5,203,-2,5,3,-3,0,2,1,1,1,-1,6,1
KR_6768482501,440,6,51,46,8,3,4,1,-4,1,5,6,8,2,3,3,0,0,0,0,1,3,-47,1,3,4,20,0,0,0,1,0,1,0,1
KR_6757244698,420,3,-3,5,4,3,3,0,0,4,4,1,1,0,1,6,5,-1,0,1,0,2,0,-2,4,2,-1,0,0,-1,-1,0,1,6,1
KR_6760798100,420,-1,10,-23,-5,-2,1,3,-2,1,3,4,5,1,-4,1,5,-1,0,1,-1,-9,-316,-4,5,1,-3,0,0,-1,-1,-1,-1,2,1
KR_6767177129,420,3,64,4,5,1,4,3,2,2,0,-2,0,2,2,5,3,2,3,1,0,9,122,-1,5,4,7,0,0,-1,-1,1,-1,3,1
KR_6737799005,420,1,-46,12,-1,1,2,1,-2,2,4,4,4,0,-2,4,6,-2,2,4,0,-4,12,-2,5,3,1,0,2,0,1,1,-1,0,1
KR_6766761843,420,2,6,8,7,1,1,0,1,2,1,4,6,2,0,2,2,1,1,0,0,11,1,0,5,5,1,0,1,1,-1,1,-1,2,1
KR_6767520661,420,5,0,13,9,0,2,2,1,1,0,4,4,0,3,3,0,1,2,1,1,14,-12,10,0,10,4,0,1,1,-1,1,1,3,1
KR_6753585386,420,-1,-14,-15,4,2,2,0,2,6,4,1,2,1,-2,1,3,1,2,1,0,7,-10,0,7,7,4,0,0,1,0,0,1,5,1
KR_6769243924,420,1,37,-15,-4,-4,1,5,-1,0,1,2,3,1,0,1,1,-1,0,1,0,-4,-13,5,2,7,-2,0,2,1,1,1,-1,2,1
KR_6734736024,420,0,18,4,0,-2,1,3,4,4,0,-1,1,2,1,2,1,-2,1,3,1,2,-3,-1,7,6,1,0,0,0,0,0,1,0,1
KR_6732181254,440,-2,11,-14,-3,3,4,1,-1,5,6,3,3,0,-8,2,10,0,0,0,0,-6,-43,1,4,5,3,0,0,1,-1,-1,1,2,1
KR_6745624337,420,2,57,-20,6,3,4,1,3,3,0,-1,1,2,0,3,3,1,1,0,0,3,44,5,0,5,-25,0,1,-1,1,1,-1,1,1
KR_6694437271,420,2,43,4,2,0,0,0,-3,3,6,0,1,1,3,5,2,2,3,1,0,5,-6,-4,8,4,3,0,-1,1,-1,-1,1,3,1
KR_6734460377,420,-2,-82,1,-3,-2,1,3,-1,2,3,-3,0,3,0,4,4,3,3,0,0,1,17,-1,6,5,-3,0,0,-1,-1,-1,1,6,1
KR_6760700164,420,1,26,17,3,1,1,0,2,4,2,0,1,1,-1,2,3,1,1,0,0,8,10,2,5,7,0,0,0,-1,1,0,-1,3,1
KR_6762867886,440,3,68,28,10,0,1,1,3,5,2,5,6,1,5,5,0,-3,2,5,0,3,13,1,0,1,0,0,2,1,0,1,-1,5,1
KR_6760462729,420,2,59,4,-7,-1,2,3,-3,0,3,1,2,1,-3,1,4,-1,1,2,0,-6,28,-3,6,3,-18,0,0,-1,1,1,-1,6,1
KR_6769299301,420,1,62,28,-7,2,4,2,-7,0,7,-1,1,2,0,4,4,-1,0,1,0,-15,0,1,6,7,1,0,2,-1,1,1,-1,6,1
KR_6753761211,440,5,33,4,8,2,4,2,4,4,0,2,3,1,0,2,2,0,0,0,0,2,1,1,4,5,2,0,1,1,0,1,1,4,1
KR_6761933869,440,10,158,65,19,3,4,1,2,4,2,4,9,5,7,9,2,3,3,0,1,16,-4,7,2,9,-1,0,4,0,1,1,1,0,1
KR_6720736066,420,0,-18,16,4,-1,2,3,-1,1,2,2,2,0,6,7,1,-2,1,3,1,1,6,-1,7,6,3,0,1,1,1,1,-1,1,1
KR_6733626232,420,2,19,-12,7,3,4,1,9,11,2,-5,0,5,0,1,1,0,2,2,0,12,3,4,2,6,-5,0,0,1,-1,0,1,1,1
KR_6680259520,420,-1,0,-8,-3,-1,0,1,-4,0,4,1,1,0,1,2,1,0,0,0,0,-2,5,0,6,6,0,0,0,1,1,0,-1,1,1
KR_6759505521,420,2,35,-8,3,1,3,2,0,2,2,0,3,3,1,2,1,1,3,2,0,3,5,3,2,5,-1,0,1,-1,1,1,1,4,1
KR_6688215231,420,5,55,1,9,2,5,3,3,3,0,4,5,1,-1,2,3,1,1,0,-1,5,22,-1,5,4,3,0,2,1,1,1,-1,3,1
KR_6757609016,440,0,-21,-1,4,0,0,0,0,4,4,3,5,2,-6,3,9,7,7,0,0,-6,-6,2,0,2,0,0,1,1,1,1,1,6,1
KR_6708665014,420,0,-31,2,-3,1,5,4,-4,2,6,1,3,2,1,2,1,-2,0,2,0,1,-7,1,5,6,-3,0,-2,-1,1,-1,-1,3,1
KR_6730689813,420,2,130,11,4,-2,0,2,0,2,2,0,2,2,4,4,0,2,2,0,1,8,-13,2,3,5,6,0,1,1,1,1,1,3,1
KR_6714717182,420,4,22,27,10,1,2,1,2,6,4,0,1,1,4,5,1,3,3,0,0,13,26,1,4,5,3,0,2,1,-1,1,-1,6,1
KR_6762912501,420,3,55,-6,10,1,1,0,1,5,4,6,6,0,2,3,1,0,2,2,0,8,7,2,5,7,-1,0,0,1,1,1,1,5,1
KR_6743142897,420,1,-49,-18,5,3,3,0,-3,5,8,0,0,0,4,5,1,1,1,0,0,1,-3,0,5,5,-4,0,-1,-1,-1,-1,1,3,1
KR_6765182972,420,-2,23,-20,-2,-1,0,1,-6,1,7,-1,4,5,6,6,0,0,1,1,1,-7,-5,1,4,5,0,0,0,-1,-1,-1,1,4,1
KR_6705550191,420,2,47,16,6,0,0,0,4,4,0,-2,3,5,3,4,1,1,1,0,0,5,-2,1,5,6,4,0,0,1,1,1,-1,1,1
KR_6764623349,420,-3,-29,-20,0,-3,2,5,-1,3,4,-1,1,2,2,2,0,3,5,2,0,4,8,2,4,6,-2,0,1,1,-1,1,1,4,1
KR_6586505250,440,5,113,19,8,4,5,1,0,3,3,-1,2,3,3,5,2,2,3,1,-1,9,-58,4,3,7,1,0,0,-1,1,0,-1,6,1
KR_6755344504,420,1,29,-43,-3,0,3,3,3,4,1,-3,2,5,-6,2,8,3,3,0,1,1,-13,1,8,9,-2,0,1,-1,-1,1,1,3,1
KR_6643653031,420,2,55,-28,3,-2,4,6,3,4,1,0,2,2,3,6,3,-1,5,6,-3,-2,110,-3,6,3,2,0,1,1,1,1,-1,5,1
KR_6764626099,440,6,127,16,12,2,2,0,-2,2,4,4,6,2,7,7,0,1,1,0,1,16,55,-2,4,2,-10,0,3,-1,1,1,1,2,1
KR_6765531368,420,7,86,14,11,1,2,1,2,5,3,1,4,3,5,7,2,2,2,0,0,7,25,2,3,5,6,0,1,0,1,1,-1,0,1
KR_6760800094,420,2,3,-24,12,5,6,1,4,6,2,4,5,1,-1,1,2,0,1,1,1,14,-36,-2,6,4,1,0,1,0,1,1,1,0,1
KR_6760192532,420,0,-22,-11,3,-1,0,1,2,3,1,2,2,0,-1,0,1,1,1,0,0,2,-4,-1,6,5,3,0,0,-1,0,0,1,4,1
KR_6759862805,420,3,42,23,7,0,0,0,4,7,3,5,6,1,-2,1,3,0,0,0,0,7,9,-2,6,4,4,0,1,-1,1,1,-1,6,1
KR_6742792772,420,-1,-46,-28,-7,-2,0,2,-2,2,4,-1,2,3,-1,2,3,-1,0,1,0,-6,142,0,5,5,-2,0,-1,-1,-1,-1,-1,2,1
KR_6755977132,440,1,67,-9,10,5,8,3,-1,0,1,6,9,3,1,3,2,-1,0,1,0,9,6,3,1,4,-1,0,1,1,-1,1,-1,6,1
KR_6694822757,420,-2,-4,24,9,-1,4,5,0,1,1,1,5,4,6,7,1,3,3,0,0,13,3,-6,9,3,0,0,1,-1,0,-1,1,2,1
KR_6752177434,420,0,-24,7,-4,-2,1,3,-2,4,6,4,5,1,1,4,3,-5,1,6,0,3,4,5,2,7,-2,0,1,1,-1,1,1,2,1
KR_6536725035,420,4,11,28,8,4,5,1,7,7,0,-2,0,2,-1,0,1,0,1,1,0,4,-263,0,3,3,-1,0,0,1,1,0,-1,3,1
KR_6747441554,420,7,69,-4,13,-4,0,4,2,3,1,5,6,1,10,12,2,0,3,3,-1,21,6,2,9,11,3,0,1,1,-1,1,-1,6,1
KR_6754340990,420,1,21,44,5,-2,1,3,3,7,4,1,3,2,4,4,0,-1,2,3,1,6,-1,-1,5,4,1,0,-2,-1,0,1,1,3,1
KR_6662481277,420,8,81,-12,18,4,6,2,7,8,1,1,3,2,4,6,2,2,3,1,0,17,11,2,2,4,-1,0,2,1,1,1,1,2,1
KR_6715777862,420,1,-20,-8,5,-1,2,3,4,8,4,1,2,1,1,3,2,0,0,0,0,1,-3,1,4,5,1,0,0,-1,-1,0,1,1,1
KR_6761141835,420,-1,-17,15,2,-4,1,5,-3,0,3,6,6,0,4,4,0,-1,0,1,0,7,4,5,0,5,-2,0,-1,1,-1,-1,1,3,1
KR_6679793980,440,5,66,15,5,0,1,1,1,3,2,7,7,0,-1,3,4,-2,2,4,1,3,-5,2,3,5,0,0,1,0,-1,1,1,0,1
KR_6762994476,420,1,-8,-4,4,2,4,2,-3,2,5,3,3,0,3,5,2,-1,1,2,0,-3,1,-1,6,5,0,0,0,0,-1,0,1,0,1
KR_6766023816,420,2,2,41,2,0,1,1,-4,1,5,1,9,8,2,4,2,3,4,1,0,-3,-6,-4,8,4,0,0,0,1,1,1,-1,6,1
KR_6761290269,440,13,201,32,34,9,11,2,2,3,1,13,14,1,9,9,0,1,2,1,0,18,5,1,0,1,0,0,5,1,1,1,1,2,1
KR_6737969059,420,1,10,4,1,1,1,0,2,2,0,3,5,2,-4,0,4,-1,0,1,0,1,-123,0,3,3,-3,0,0,-1,1,0,-1,4,1
KR_6761212853,420,1,48,-17,-3,-2,1,3,0,4,4,0,2,2,0,3,3,-1,0,1,-1,-4,-21,1,4,5,-2,0,1,0,1,1,-1,0,1
KR_6767220851,420,4,45,28,14,8,8,0,5,5,0,-2,0,2,1,2,1,2,3,1,1,4,-160,-4,6,2,21,0,3,1,1,1,1,1,1
KR_6697846905,420,6,74,19,-2,1,3,2,1,2,1,-1,3,4,0,2,2,-3,0,3,0,-7,-280,3,4,7,2,0,0,-1,-1,0,-1,3,1
KR_6632681296,420,-1,-76,-7,1,0,0,0,0,4,4,1,1,0,1,1,0,-1,0,1,-1,-6,0,0,5,5,-2,0,0,1,-1,-1,-1,6,1
KR_6664468302,420,-1,21,25,-1,-3,1,4,5,8,3,-1,2,3,0,1,1,-2,0,2,0,1,5,3,2,5,-1,0,0,-1,-1,0,1,4,1
KR_6743765967,440,2,33,-16,-2,-2,2,4,-1,1,2,-1,0,1,2,2,0,0,0,0,0,-4,25,-1,7,6,-2,0,1,-1,-1,1,-1,2,1
KR_6729494405,420,1,20,20,5,-3,0,3,1,4,3,3,3,0,3,4,1,1,1,0,0,14,2,0,4,4,1,0,0,-1,1,0,1,3,1
KR_6701901542,440,2,73,-3,12,1,7,6,2,3,1,6,6,0,3,8,5,0,1,1,1,17,0,-1,5,4,-3,0,0,0,-1,-1,1,0,1
KR_6745143900,420,1,-38,4,4,-3,1,4,6,6,0,1,2,1,0,1,1,0,1,1,0,11,2,3,8,11,4,0,-1,-1,-1,-1,1,5,1
KR_6712555080,420,2,68,-4,5,2,5,3,9,10,1,4,5,1,-4,0,4,-6,3,9,-1,3,3,2,3,5,0,0,1,1,-1,1,1,1,1
KR_6768685376,420,1,-3,28,4,1,2,1,2,6,4,-2,2,4,3,6,3,0,2,2,0,6,-28,-5,11,6,15,0,-1,1,-1,-1,1,4,1
KR_6675591366,420,1,-11,16,2,1,3,2,-1,0,1,-3,1,4,4,4,0,1,2,1,0,3,7,3,4,7,-3,0,1,-1,1,1,-1,6,1
KR_6701753201,420,4,51,28,6,-2,4,6,5,5,0,0,4,4,1,6,5,2,3,1,0,2,2,5,0,5,-1,0,2,1,1,1,1,6,1
KR_6753337375,420,2,1,-12,9,2,4,2,-2,3,5,2,2,0,5,8,3,2,2,0,0,12,-18,-3,7,4,0,0,2,1,1,1,1,6,1
KR_6618995712,420,0,34,-4,-1,2,2,0,-3,3,6,1,3,2,2,4,2,-3,1,4,1,0,-5,3,6,9,1,0,1,-1,1,-1,1,5,1
KR_6753151053,420,1,-73,11,-1,-3,0,3,0,3,3,-1,1,2,1,5,4,2,4,2,0,1,12,0,2,2,-1,0,1,1,0,1,1,6,1
KR_6671879449,420,4,27,23,8,1,1,0,0,2,2,-1,1,2,8,8,0,0,1,1,1,9,-4,4,4,8,22,0,1,1,1,1,1,5,1
KR_6730596623,420,6,107,23,9,1,2,1,1,1,0,2,4,2,4,5,1,1,1,0,0,7,4,-2,5,3,-1,0,1,1,1,1,-1,3,1
KR_6768615249,420,3,4,4,5,1,1,0,-1,3,4,3,3,0,-1,1,2,3,4,1,0,8,1,1,2,3,5,0,1,1,1,1,1,3,1
KR_6755461913,420,0,-22,-45,6,1,2,1,3,3,0,2,2,0,-1,1,2,1,4,3,0,9,7,0,3,3,-3,0,-1,-1,1,-1,1,1,1
KR_6396486628,420,2,-5,-9,3,-3,1,4,9,11,2,-1,1,2,-3,2,5,1,1,0,0,3,-1,0,7,7,-3,0,1,-1,0,1,1,6,1
KR_6688666736,420,-1,1,-48,0,5,7,2,3,4,1,-4,0,4,-3,0,3,-1,1,2,1,-4,9,1,4,5,-1,0,1,-1,1,1,1,3,1
KR_6693612958,420,2,79,12,7,-5,0,5,5,5,0,2,4,2,3,6,3,2,3,1,0,7,-6,1,5,6,-3,0,1,1,1,1,1,2,1
KR_6752628585,420,2,-11,21,0,-3,1,4,5,6,1,1,1,0,-2,2,4,-1,0,1,-1,1,1,-1,4,3,-1,0,0,1,1,0,-1,3,1
KR_6754946872,420,3,-26,3,13,4,4,0,0,2,2,1,3,2,5,6,1,3,3,0,0,19,5,6,1,7,-2,0,0,1,-1,-1,1,6,1
KR_6760846785,420,0,-35,-12,-4,0,2,2,-3,0,3,0,0,0,-2,1,3,1,1,0,0,-6,-1,-1,4,3,0,0,0,-1,1,0,-1,4,1
KR_6694912229,420,1,22,24,-3,-3,1,4,3,3,0,-3,4,7,0,3,3,0,1,1,0,1,7,0,3,3,-1,0,-1,1,-1,-1,1,1,1
KR_6716544857,420,2,18,17,2,-7,0,7,0,3,3,4,5,1,3,5,2,2,2,0,0,2,-8,-8,12,4,8,0,0,1,1,1,-1,3,1
KR_6766965495,420,-2,20,-4,0,1,3,2,3,5,2,1,1,0,-6,0,6,1,3,2,0,-2,-178,3,1,4,-1,0,0,1,-1,1,-1,1,1
KR_6689897306,420,3,58,-26,6,-1,2,3,4,7,3,4,5,1,-1,3,4,0,2,2,0,6,362,0,7,7,1,0,1,-1,1,1,1,5,1
KR_6723841110,420,3,-6,12,6,1,3,2,3,4,1,-2,0,2,1,2,1,3,3,0,0,9,-16,-1,5,4,5,0,0,1,1,0,-1,2,1
KR_6730749627,440,1,44,-8,-1,-1,0,1,0,1,1,1,2,1,0,3,3,-1,1,2,0,-3,-6,3,1,4,2,0,-1,0,-1,-1,-1,0,1
KR_6644564191,440,4,-18,32,6,-5,0,5,8,10,2,2,2,0,1,2,1,0,3,3,0,2,-12,-2,7,5,10,0,0,-1,1,0,1,2,1
KR_6729971285,440,3,-24,-11,6,0,1,1,3,4,1,2,6,4,1,1,0,0,0,0,0,13,128,0,5,5,-3,0,1,1,0,-1,-1,4,1
KR_6737287376,420,-3,-75,-4,-2,-3,1,4,2,6,4,1,2,1,-4,2,6,2,4,2,0,2,21,0,8,8,-2,0,0,-1,-1,0,1,3,1
KR_6684059361,440,1,-35,24,8,-2,4,6,6,9,3,4,5,1,0,6,6,0,3,3,1,13,-355,-6,8,2,1,0,-1,1,1,1,-1,1,1
KR_6728812220,440,4,91,13,7,2,4,2,1,2,1,3,7,4,-1,2,3,2,3,1,1,5,4,2,3,5,0,0,0,0,1,0,1,0,1
KR_6614213088,420,2,-7,31,-1,1,1,0,5,6,1,-5,1,6,-1,3,4,-1,1,2,0,-3,33,0,3,3,-21,0,-1,1,-1,-1,-1,5,1
KR_6761831059,440,1,24,5,2,-5,1,6,3,4,1,4,7,3,-1,3,4,1,2,1,-1,3,6,2,6,8,-3,0,1,-1,1,1,-1,3,1
KR_6765617410,440,-2,6,-14,-6,-2,0,2,-6,0,6,1,3,2,1,2,1,0,1,1,0,-5,9,0,3,3,0,0,-2,1,-1,-1,-1,3,1
KR_6766029117,420,7,31,24,16,1,4,3,11,12,1,2,3,1,0,3,3,2,3,1,0,18,3,1,5,6,-1,0,1,1,1,1,1,4,1
KR_6765165078,420,1,3,-8,6,-1,2,3,2,5,3,0,2,2,4,5,1,1,1,0,0,9,-14,0,4,4,1,0,2,0,1,1,1,0,1
KR_6724526903,420,8,81,-14,17,6,6,0,2,4,2,6,7,1,4,4,0,-1,0,1,0,22,8,2,1,3,1,0,4,1,1,1,1,5,1
KR_6768398433,420,4,91,28,11,5,7,2,-3,7,10,2,3,1,8,12,4,-1,0,1,0,18,-223,-4,6,2,4,0,3,1,-1,1,1,4,1
KR_6769146099,420,5,0,8,10,1,2,1,0,2,2,5,5,0,2,6,4,2,3,1,-1,13,7,0,7,7,-5,0,1,1,-1,1,-1,4,1
KR_6764976418,420,1,-10,-4,-2,-1,0,1,0,2,2,0,4,4,-1,2,3,0,1,1,0,-7,-20,-1,5,4,-2,0,-1,-1,-1,-1,-1,1,1
KR_6764699971,420,3,55,-21,4,0,3,3,2,4,2,-1,1,2,5,6,1,-2,0,2,1,7,61,5,0,5,-20,0,1,-1,-1,1,1,6,1
KR_6767783147,420,-1,-4,0,2,3,3,0,2,3,1,-8,1,9,5,6,1,0,0,0,0,9,-111,-3,4,1,0,0,1,1,-1,1,1,6,1
KR_6672505433,440,4,47,-16,15,2,3,1,2,4,2,3,6,3,8,10,2,0,2,2,3,20,17,3,6,9,0,0,1,1,0,1,1,2,1
KR_6767075587,420,2,45,-3,-1,0,2,2,-4,0,4,1,2,1,2,2,0,0,0,0,0,-4,-10,-2,5,3,1,0,1,1,-1,1,-1,4,1
KR_6757408944,420,-2,-14,31,-1,-4,1,5,1,2,1,5,7,2,0,3,3,-3,0,3,-1,-3,10,1,2,3,-1,0,0,1,1,-1,-1,4,1
KR_6729704662,420,-2,-41,25,-3,-1,2,3,-1,0,1,-5,2,7,4,5,1,0,0,0,0,4,-55,0,4,4,30,-1,-2,-1,0,-1,-1,2,1
KR_6752367260,420,0,39,-6,8,-1,0,1,8,9,1,0,1,1,-1,3,4,2,2,0,0,12,-7,1,2,3,-1,0,1,1,1,1,1,3,1
KR_6726454327,420,2,81,15,10,-2,1,3,-1,2,3,5,7,2,9,13,4,-1,1,2,0,5,-31,-3,7,4,5,0,1,1,1,1,1,1,1
KR_6721997134,420,1,17,56,-6,-3,0,3,0,1,1,0,0,0,-3,4,7,0,2,2,0,-11,-8,-4,7,3,3,0,-1,-1,-1,-1,1,3,1
KR_6761547726,420,8,75,13,19,6,7,1,-3,1,4,1,1,0,11,13,2,4,5,1,0,20,-54,0,4,4,15,0,1,0,1,1,1,0,1
KR_6753614794,420,5,45,8,15,-1,1,2,2,5,3,6,7,1,5,5,0,3,3,0,0,12,5,2,4,6,1,0,0,1,1,1,1,5,1
KR_6747557893,420,6,95,25,10,5,6,1,1,1,0,2,3,1,5,6,1,-3,0,3,-1,5,-5,0,9,9,10,0,2,1,1,1,-1,5,1
KR_6759680736,440,0,-30,-32,8,7,7,0,-1,2,3,2,2,0,1,3,2,-1,1,2,0,10,-27,3,4,7,-3,0,-1,1,-1,-1,-1,3,1
KR_6747245564,420,2,-35,-13,-1,-2,0,2,1,4,3,-4,2,6,1,4,3,3,4,1,0,-7,2,-2,7,5,-4,0,0,-1,1,1,-1,2,1
KR_6758934170,420,-1,-30,19,-6,-1,0,1,1,1,0,-2,2,4,-4,3,7,0,2,2,0,-5,4,-3,3,0,1,0,-1,1,0,-1,-1,6,1
KR_6690815614,420,6,76,8,10,0,2,2,0,4,4,2,3,1,4,4,0,4,4,0,-1,9,7,0,2,2,1,0,2,1,-1,1,-1,3,1
KR_6621403366,420,0,-77,56,3,-3,1,4,0,2,2,3,3,0,1,2,1,2,3,1,0,3,3,-3,5,2,2,0,-1,1,-1,-1,1,3,1
KR_6764278917,420,-2,-19,-4,-1,-1,2,3,1,2,1,-2,1,3,0,2,2,1,2,1,0,-1,1,0,2,2,2,0,0,1,0,0,1,2,1
KR_6763920147,440,4,47,-13,13,0,1,1,-2,0,2,3,3,0,10,11,1,2,2,0,0,20,4,2,4,6,7,0,2,1,1,1,1,2,1
KR_6743087307,420,2,48,-2,4,3,4,1,5,7,2,-4,0,4,0,6,6,0,0,0,0,-3,-229,4,3,7,-3,0,0,-1,-1,0,1,1,1
KR_6762808038,420,0,40,-8,0,0,2,2,2,3,1,2,4,2,-1,3,4,-3,1,4,0,1,-1,-2,5,3,3,0,-1,-1,-1,-1,-1,3,1
KR_6762234666,440,3,19,0,5,1,2,1,2,2,0,-4,2,6,2,3,1,4,4,0,0,2,-8,-2,4,2,3,0,0,1,0,1,-1,6,1
KR_6702800681,420,1,4,-20,3,2,5,3,5,6,1,-2,2,4,-3,3,6,1,2,1,2,14,1,0,7,7,-3,0,-1,-1,-1,-1,1,1,1
KR_6765465855,420,5,2,0,12,3,6,3,4,6,2,4,5,1,0,3,3,1,2,1,0,10,28,2,3,5,-4,0,1,1,1,1,1,1,1
KR_6764784145,420,2,30,14,-1,0,1,1,-1,2,3,-3,0,3,3,3,0,0,1,1,0,-2,10,1,1,2,0,0,1,1,1,1,-1,2,1
KR_6738739498,420,4,72,-13,5,2,3,1,3,4,1,-3,2,5,2,5,3,1,2,1,0,4,-20,4,3,7,-1,0,1,1,-1,1,1,6,1
KR_6755589619,440,-1,32,-13,5,3,3,0,0,2,2,1,3,2,3,8,5,-2,2,4,0,-5,-6,4,2,6,1,0,1,1,1,1,-1,4,1
KR_6610223582,420,4,24,11,8,3,3,0,2,2,0,0,1,1,2,3,1,1,1,0,0,8,31,-4,6,2,3,0,0,-1,1,0,1,6,1
KR_6741469535,420,1,23,28,4,7,7,0,-3,2,5,-1,0,1,0,1,1,1,2,1,0,-7,-58,3,3,6,15,0,-1,1,1,-1,1,4,1
KR_6684535494,420,4,82,-16,7,-5,1,6,3,5,2,3,4,1,5,7,2,1,1,0,-1,14,19,2,2,4,4,0,0,1,1,-1,-1,2,1
KR_6764854399,420,1,-63,-8,3,0,1,1,5,7,2,-2,1,3,1,2,1,-1,1,2,0,9,2,1,4,5,1,0,1,-1,1,1,-1,6,1
KR_6740877544,420,1,-1,-24,-1,2,4,2,-1,3,4,3,4,1,-5,1,6,0,1,1,0,-7,-7,-2,7,5,0,0,0,-1,1,1,-1,3,1
KR_6751409048,420,-1,-57,24,-1,-2,0,2,-1,2,3,1,1,0,2,2,0,-1,1,2,0,1,6,6,1,7,-7,0,1,1,-1,-1,1,5,1
KR_6759455017,420,3,41,20,3,2,4,2,4,4,0,-2,0,2,-1,1,2,0,1,1,0,-1,3,-2,4,2,4,0,1,1,-1,1,1,2,1
KR_6317894286,420,1,18,4,1,2,2,0,-6,2,8,3,5,2,2,4,2,0,1,1,0,4,-20,1,6,7,2,0,0,-1,-1,0,1,2,1
KR_6697793751,420,2,29,14,2,-2,0,2,-5,3,8,1,9,8,2,4,2,6,7,1,-1,8,2,0,5,5,-2,0,1,-1,-1,-1,-1,1,1
KR_6766066893,440,7,128,44,18,7,7,0,6,7,1,0,1,1,-1,0,1,6,6,0,0,11,-4,-2,6,4,0,0,3,0,1,1,1,0,1
KR_6751446750,420,1,-47,16,-1,3,4,1,2,2,0,0,2,2,-6,1,7,0,0,0,0,-2,-2,2,6,8,-1,0,0,1,1,0,-1,5,1
KR_6731361667,420,1,61,7,5,-4,0,4,3,6,3,2,2,0,4,5,1,0,2,2,0,13,24,1,4,5,-2,0,1,1,1,-1,-1,4,1
KR_6749073785,440,0,-4,8,9,-4,1,5,9,9,0,3,4,1,0,0,0,1,2,1,0,8,-9,2,1,3,0,0,-2,1,-1,-1,-1,5,1
KR_6763026848,440,2,23,-36,5,-3,0,3,2,3,1,-1,1,2,1,2,1,6,6,0,0,9,20,0,7,7,-1,0,1,1,1,1,1,5,1
KR_6769237466,420,-3,19,0,2,0,1,1,0,2,2,2,3,1,2,2,0,-2,0,2,0,1,-3,-1,4,3,-4,0,0,-1,-1,-1,1,3,1
KR_6756514657,420,2,68,-1,0,1,3,2,5,6,1,1,1,0,-5,0,5,-2,0,2,0,5,15,1,4,5,-6,0,1,1,1,1,-1,2,1
KR_6625344611,420,-1,-33,6,8,-3,0,3,7,7,0,3,3,0,3,8,5,-2,0,2,2,13,7,-2,6,4,-1,0,-1,-1,1,-1,1,1,1
KR_6737069934,420,6,74,9,13,-1,2,3,3,4,1,3,7,4,6,6,0,2,2,0,1,13,14,4,2,6,-1,0,3,1,1,1,-1,3,1
KR_6764855312,420,1,-17,-3,0,-1,2,3,0,3,3,2,2,0,-1,3,4,0,3,3,0,1,0,2,1,3,1,0,-1,1,1,1,-1,2,1
KR_6760789713,420,0,12,-36,0,-1,1,2,-2,1,3,1,3,2,3,5,2,-1,0,1,0,2,-2,1,7,8,4,0,1,-1,0,1,-1,3,1
KR_6755156871,420,5,45,5,15,4,4,0,2,5,3,3,3,0,5,8,3,1,1,0,0,11,14,1,4,5,-2,0,2,1,1,1,1,5,1
KR_6762750046,420,2,29,5,6,2,4,2,2,2,0,1,1,0,1,5,4,0,1,1,0,6,8,-4,7,3,1,0,1,-1,1,1,1,6,1
KR_6553334861,420,0,-6,20,1,1,1,0,5,5,0,-2,4,6,-3,1,4,0,0,0,0,-3,2,-1,6,5,3,0,0,0,-1,0,1,0,1
KR_6757464415,420,1,-14,-12,-2,-3,0,3,0,1,1,3,5,2,0,2,2,-2,0,2,0,2,164,-2,3,1,-2,0,0,-1,1,0,-1,3,1
KR_6662664920,420,9,59,18,13,12,12,0,0,1,1,1,1,0,0,2,2,0,0,0,0,7,-39,2,3,5,14,0,0,1,-1,1,-1,5,1
KR_6766209875,420,1,-76,-5,9,-3,3,6,1,1,0,4,6,2,3,4,1,4,4,0,1,11,-28,-2,5,3,2,0,1,1,-1,1,1,4,1
KR_6723515254,420,3,99,-5,11,4,6,2,2,4,2,3,3,0,2,3,1,0,0,0,0,2,-1,2,1,3,1,0,3,1,1,1,1,6,1
KR_6755721973,420,2,2,-4,1,0,4,4,-1,0,1,-2,1,3,3,6,3,1,2,1,-1,2,-1,-1,5,4,-1,0,1,1,1,1,-1,1,1
KR_6573298840,420,3,5,3,5,-1,4,5,1,5,4,0,0,0,5,9,4,0,1,1,1,1,-86,-4,5,1,3,0,0,-1,1,0,-1,6,1
KR_6763170247,420,-2,12,-32,-2,2,3,1,-1,2,3,4,8,4,-7,2,9,0,0,0,1,0,43,3,2,5,-14,0,0,-1,1,-1,1,1,1
KR_6601073564,420,4,22,30,4,3,4,1,2,6,4,1,3,2,-2,1,3,0,0,0,0,3,0,-2,8,6,0,0,2,-1,1,1,1,6,1
KR_6640535656,420,2,-23,11,2,2,2,0,1,6,5,2,4,2,-2,0,2,-1,1,2,0,-3,-108,-1,5,4,-1,0,-1,1,-1,-1,-1,3,1
KR_6760723972,440,5,7,14,22,0,2,2,5,6,1,2,2,0,13,17,4,2,2,0,0,22,99,0,1,1,3,0,2,0,1,1,1,0,1
KR_6679674876,440,2,10,29,4,3,5,2,3,3,0,4,5,1,-6,0,6,0,0,0,0,1,5,0,0,0,-1,0,1,1,1,1,1,1,1
KR_6752550423,420,2,2,3,0,-3,0,3,3,4,1,1,2,1,-1,0,1,0,2,2,0,0,-137,-1,5,4,2,0,0,1,1,0,-1,6,1
KR_6737051826,440,4,56,-8,11,1,1,0,3,4,1,1,2,1,5,5,0,1,2,1,0,14,19,3,0,3,1,0,1,1,0,1,1,4,1
KR_6714156367,420,5,65,56,6,1,2,1,5,5,0,0,1,1,-1,6,7,1,1,0,2,12,0,-2,7,5,4,0,3,-1,1,1,1,5,1
KR_6761528109,420,3,7,26,11,2,4,2,4,5,1,1,1,0,-1,5,6,5,7,2,0,18,-4,-6,11,5,3,0,0,1,1,0,1,3,1
KR_6692645144,420,3,82,0,4,6,7,1,-5,2,7,2,4,2,-1,1,2,2,3,1,0,-5,-4,-2,6,4,3,0,2,-1,1,1,1,2,1
KR_6465219019,420,-1,10,3,-3,-3,1,4,-4,1,5,-2,2,4,6,8,2,0,2,2,1,-3,37,-2,8,6,-24,0,-1,1,1,-1,1,6,1
KR_6692594175,420,5,107,38,10,2,3,1,-2,0,2,4,5,1,5,7,2,1,1,0,1,-4,60,3,2,5,-24,0,3,1,1,1,1,3,1
KR_6692479964,420,-3,-19,-1,-5,1,2,1,-1,4,5,-7,0,7,1,1,0,1,2,1,1,-1,-1,-4,7,3,0,0,-1,1,1,-1,1,1,1
KR_6741030986,420,2,-8,15,4,1,3,2,0,1,1,2,4,2,2,2,0,-1,1,2,0,1,8,-1,5,4,-3,0,2,1,1,1,1,6,1
KR_6641472904,420,3,76,-13,6,1,1,0,7,8,1,-1,2,3,0,1,1,-1,0,1,0,6,1,0,4,4,6,0,1,-1,-1,1,-1,5,1
KR_6721163760,420,0,-51,22,2,1,3,2,2,4,2,-1,1,2,-1,2,3,1,2,1,0,6,27,24,5,29,-27,0,-1,1,-1,-1,-1,3,1
KR_6763596366,420,-1,-93,-20,-4,4,5,1,1,1,0,-4,1,5,-3,2,5,-2,2,4,1,-2,-257,0,3,3,-2,0,-1,-1,0,-1,1,4,1
KR_6500964518,420,1,-13,25,4,-2,1,3,5,7,2,1,2,1,-1,5,6,1,1,0,-1,9,17,-3,4,1,-3,0,0,1,-1,-1,-1,1,1
KR_6697692713,420,-1,41,16,1,2,3,1,2,4,2,-4,2,6,2,3,1,-1,1,2,0,4,-2,-1,4,3,-1,0,0,1,0,0,1,5,1
KR_6766890783,420,3,-17,-17,8,4,6,2,-3,2,5,3,3,0,5,6,1,-1,1,2,0,9,3,1,5,6,5,0,0,1,-1,1,1,4,1
KR_6716537958,440,2,-103,-8,4,1,3,2,1,4,3,-2,0,2,4,5,1,0,0,0,0,4,14,5,2,7,2,0,1,1,1,1,-1,1,1
KR_6751291884,440,6,84,5,12,4,6,2,5,5,0,0,1,1,2,4,2,1,1,0,0,8,323,2,2,4,-1,0,2,1,1,1,-1,2,1
KR_6743164265,420,1,-37,7,1,1,5,4,2,2,0,-2,1,3,0,1,1,0,1,1,0,-1,-17,1,5,6,-2,0,1,1,-1,1,-1,2,1
KR_6396560916,420,-1,-19,5,2,-3,1,4,3,4,1,-1,2,3,4,8,4,-1,0,1,0,8,-42,1,4,5,11,0,-1,1,-1,-1,1,5,1
KR_6763108509,420,2,29,13,4,0,2,2,2,4,2,1,2,1,1,2,1,0,0,0,0,5,25,4,3,7,-5,0,1,0,0,1,-1,0,1
KR_6767758508,420,5,44,-20,13,4,4,0,1,4,3,6,7,1,5,6,1,-3,0,3,-1,16,20,4,5,9,2,0,1,-1,1,1,-1,3,1
KR_6752643918,420,3,58,-7,15,2,3,1,6,6,0,1,4,3,5,5,0,1,1,0,0,20,-24,2,3,5,6,0,0,1,0,1,-1,4,1
KR_6767712241,420,2,63,24,8,3,3,0,4,4,0,3,6,3,-2,1,3,0,1,1,0,8,-12,-1,9,8,7,0,2,1,1,1,1,6,1
KR_6705950890,420,2,69,21,2,-1,1,2,-2,7,9,1,4,3,1,1,0,3,4,1,0,3,-189,7,3,10,2,0,2,1,1,1,1,1,1
KR_6740348349,440,3,80,20,8,3,3,0,-1,2,3,4,5,1,2,7,5,0,2,2,0,4,7,-2,3,1,3,0,3,0,1,1,-1,0,1
KR_6738376771,420,4,55,8,8,3,4,1,4,4,0,0,1,1,0,2,2,1,2,1,0,0,-13,0,4,4,4,0,2,0,0,1,1,0,1
KR_6751005801,420,0,11,5,-2,-1,1,2,0,1,1,2,3,1,2,2,0,-5,2,7,-1,-1,-4,0,7,7,2,0,-2,1,-1,-1,-1,2,1
KR_6484455752,420,-4,59,-25,-4,-3,1,4,-3,6,9,-1,1,2,5,6,1,-2,2,4,0,2,-8,-3,6,3,0,0,2,-1,0,1,1,6,1
KR_6765306767,420,0,91,-13,0,-4,0,4,1,1,0,0,2,2,1,3,2,2,3,1,0,2,4,1,5,6,5,0,1,1,1,1,1,2,1
KR_6762064575,420,0,-47,-10,4,-4,0,4,4,4,0,0,3,3,4,4,0,0,0,0,0,12,6,4,4,8,-1,0,1,1,1,1,1,2,1
KR_6748661623,420,1,41,-20,4,2,3,1,-3,3,6,3,4,1,2,3,1,0,0,0,0,3,-3,0,2,2,2,0,1,0,1,1,1,0,1
KR_6631329384,420,3,82,32,14,3,3,0,2,2,0,5,5,0,3,8,5,1,2,1,0,11,23,-1,7,6,4,0,1,-1,-1,1,1,3,1
KR_6726949831,420,3,-6,12,4,0,1,1,-2,1,3,1,2,1,3,3,0,2,2,0,0,5,11,-2,7,5,-2,0,0,1,-1,0,1,2,1
KR_6766855277,420,5,71,35,3,2,4,2,-4,2,6,1,3,2,5,6,1,-1,1,2,1,2,56,2,2,4,-20,0,0,0,-1,-1,1,0,1
KR_6750809702,420,5,78,39,13,7,7,0,1,3,2,2,3,1,2,2,0,1,2,1,0,5,24,-1,8,7,10,0,0,1,1,1,1,5,1
KR_6755833308,420,3,86,21,6,1,1,0,-1,1,2,4,4,0,1,2,1,1,1,0,0,3,53,-3,5,2,0,0,4,1,1,1,1,2,1
KR_6765550104,420,2,-2,4,4,4,6,2,1,2,1,0,2,2,6,6,0,-7,0,7,-1,1,1,0,5,5,2,0,0,1,-1,0,-1,4,1
KR_6762153174,420,4,60,12,7,0,3,3,1,8,7,2,5,3,0,2,2,4,4,0,0,0,-1,0,4,4,4,0,0,-1,-1,1,1,1,1
KR_6761158949,420,3,70,16,8,-2,1,3,0,1,1,4,8,4,2,6,4,4,4,0,0,4,1,1,3,4,2,0,1,1,1,1,-1,4,1
KR_6740040807,420,2,17,16,11,5,6,1,3,4,1,2,3,1,1,2,1,0,0,0,0,7,3,1,5,6,0,0,1,1,1,1,1,6,1
KR_6673852910,420,2,37,-1,4,-2,2,4,5,6,1,-1,1,2,3,4,1,-1,1,2,-2,4,8,-3,5,2,1,0,0,-1,1,0,-1,5,1
KR_6768554931,420,4,135,-8,11,8,9,1,1,3,2,3,3,0,-1,1,2,0,1,1,-1,3,7,3,4,7,4,0,1,1,-1,1,-1,4,1
KR_6679609190,440,0,-31,20,1,-2,1,3,3,4,1,-5,4,9,1,1,0,4,4,0,-1,2,16,1,1,2,-1,0,-1,1,0,-1,-1,2,1
KR_6758005799,420,-3,-18,-9,-1,6,7,1,-5,1,6,-5,2,7,4,6,2,-1,0,1,1,-12,2,4,3,7,-3,0,0,-1,1,1,1,5,1
KR_6742845384,420,-2,-19,-27,4,1,3,2,1,1,0,2,6,4,1,1,0,-1,0,1,0,11,1,1,6,7,2,0,-1,1,-1,-1,1,2,1
KR_6744806929,420,-2,-32,-24,1,-1,2,3,0,0,0,0,1,1,0,3,3,2,2,0,0,5,98,0,4,4,0,0,0,1,-1,-1,1,6,1
KR_6694816614,420,-3,-28,-22,-7,0,5,5,-2,1,3,-6,0,6,2,2,0,-1,0,1,1,-1,-25,-5,9,4,3,0,0,-1,-1,-1,1,3,1
KR_6722105143,420,3,22,-8,8,5,5,0,-1,1,2,4,4,0,1,3,2,-1,0,1,0,5,7,1,5,6,-1,0,0,1,0,1,1,1,1
KR_6660175061,420,3,18,-16,15,6,7,1,-1,5,6,6,6,0,6,9,3,-2,0,2,1,10,2,5,3,8,1,0,2,1,1,1,1,6,1
KR_6762036832,420,1,80,29,-5,1,2,1,-4,0,4,2,3,1,-4,1,5,0,2,2,0,-13,0,1,4,5,3,0,1,-1,1,1,-1,2,1
KR_6768189971,420,3,63,-1,5,-2,1,3,2,3,1,2,3,1,2,5,3,1,2,1,-1,10,21,-1,5,4,1,0,0,1,0,0,-1,6,1
KR_6747695662,440,2,12,8,4,4,4,0,2,4,2,4,6,2,1,3,2,-7,0,7,1,5,108,3,5,8,-1,0,1,0,1,1,1,0,1
KR_6732685238,420,2,17,-12,3,-1,1,2,-2,2,4,3,3,0,0,1,1,3,3,0,0,-2,13,-3,7,4,8,0,1,-1,1,1,1,6,1
KR_6621058182,420,2,26,-3,14,1,1,0,6,7,1,2,4,2,0,3,3,5,6,1,1,26,13,0,5,5,1,0,1,1,0,1,1,4,1
KR_6767898225,440,-2,7,4,-3,4,5,1,0,1,1,1,3,2,-5,2,7,-3,0,3,0,0,-115,-2,7,5,-5,0,1,-1,1,1,1,6,1
KR_6747037291,420,3,69,0,3,1,4,3,0,4,4,-2,0,2,2,4,2,2,2,0,-1,-1,-19,4,3,7,4,0,2,1,-1,1,-1,1,1
KR_6681523101,420,3,-38,6,3,1,4,3,0,3,3,-4,1,5,3,3,0,3,3,0,-2,-2,118,5,1,6,-3,0,1,-1,-1,1,-1,5,1
KR_6708825435,440,5,76,51,6,5,8,3,-5,0,5,3,4,1,-1,1,2,4,4,0,0,-3,164,7,2,9,-4,0,2,1,-1,1,1,2,1
KR_6640385667,420,4,46,35,2,4,4,0,2,5,3,-2,0,2,1,4,3,-3,0,3,0,-3,-4,0,5,5,2,0,-1,1,-1,-1,-1,3,1
KR_6741109011,420,1,47,4,3,1,1,0,2,2,0,1,3,2,-2,2,4,1,1,0,0,6,72,1,5,6,6,0,1,1,0,1,-1,6,1
KR_6764036673,420,-1,-43,12,-1,-2,1,3,0,2,2,0,1,1,2,4,2,-1,1,2,0,-1,-16,-5,9,4,0,0,0,1,-1,0,-1,2,1
KR_6755546702,420,-2,43,-33,-4,2,2,0,0,2,2,-4,1,5,-2,0,2,0,3,3,1,-8,-23,-1,6,5,7,0,0,-1,1,-1,1,6,1
KR_6761366998,420,2,-29,12,0,-4,2,6,-4,0,4,2,3,1,5,6,1,1,1,0,0,4,12,-1,5,4,2,0,-2,1,1,-1,-1,1,1
KR_6766424332,420,3,79,6,5,4,7,3,-5,0,5,0,2,2,0,4,4,6,6,0,0,3,26,3,1,4,2,0,1,1,1,1,-1,6,1
KR_6679029624,420,1,59,14,4,-1,1,2,0,2,2,5,6,1,1,3,2,-1,0,1,0,7,5,-2,5,3,2,0,0,1,-1,1,-1,5,1
KR_6724793026,420,8,64,-4,17,6,6,0,1,3,2,3,5,2,5,7,2,2,2,0,0,17,-2,3,3,6,1,0,2,1,1,1,1,5,1
KR_6546219500,420,4,3,39,8,5,5,0,3,4,1,-2,1,3,2,4,2,0,1,1,1,11,16,1,3,4,2,0,0,-1,1,1,-1,1,1
KR_6696414130,420,3,-11,6,3,1,6,5,0,1,1,2,3,1,-1,1,2,1,5,4,1,3,1,-2,6,4,2,0,0,-1,1,-1,1,6,1
KR_6762655305,420,3,21,12,7,4,5,1,2,4,2,2,3,1,-2,1,3,1,1,0,0,2,42,-1,7,6,5,0,0,-1,1,1,1,6,1
KR_6762993699,420,5,96,28,14,-3,1,4,3,3,0,6,7,1,9,9,0,-1,1,2,0,17,-3,-3,5,2,1,0,2,0,1,1,1,0,1
KR_6702570479,420,2,-49,11,3,3,5,2,3,4,1,2,3,1,-3,2,5,-2,0,2,0,-3,-1,1,4,5,-2,0,0,-1,1,1,1,6,1
KR_6733318691,420,0,2,20,0,3,4,1,0,4,4,4,6,2,-5,1,6,-2,0,2,0,6,-139,3,4,7,30,0,0,1,1,0,-1,4,1
KR_6737015099,420,4,55,28,1,1,1,0,2,3,1,3,5,2,-3,0,3,-2,0,2,0,-1,-1,2,4,6,-1,0,2,0,1,1,-1,0,1
KR_6732826742,420,1,-3,1,6,3,3,0,3,6,3,2,4,2,-6,2,8,4,6,2,0,5,-5,4,2,6,-3,0,0,-1,1,0,1,5,1
KR_6633512548,420,-1,-34,-50,1,-1,2,3,-2,6,8,3,3,0,1,5,4,0,1,1,0,12,7,1,6,7,-2,0,1,-1,1,-1,1,3,1
KR_6732618283,420,4,3,4,14,0,1,1,3,6,3,2,2,0,9,10,1,0,1,1,2,21,-10,3,2,5,2,0,1,-1,1,1,1,2,1
KR_6761805211,420,4,42,5,5,0,3,3,3,4,1,1,3,2,-3,3,6,4,4,0,0,-2,6,-2,5,3,7,0,1,0,0,1,1,0,1
KR_6751566627,420,2,6,-20,7,3,5,2,1,3,2,2,5,3,2,6,4,-1,3,4,0,11,-8,-2,5,3,3,0,2,-1,-1,1,1,2,1
KR_6762606051,420,4,65,-3,4,-3,1,4,4,4,0,-2,2,4,5,5,0,0,0,0,2,9,5,-1,6,5,2,0,0,1,-1,1,1,5,1
KR_6662670375,420,0,37,25,-1,-2,1,3,3,4,1,0,2,2,-2,4,6,0,0,0,1,-3,118,3,3,6,1,0,1,1,-1,1,1,4,1
KR_6763156881,420,-1,-58,-5,-5,2,3,1,-2,0,2,1,1,0,-2,0,2,-4,2,6,0,-3,-5,-5,7,2,-1,0,-1,-1,1,-1,-1,1,1
KR_6754526101,420,5,68,36,11,4,5,1,1,4,3,1,4,3,6,8,2,-1,1,2,1,2,3,6,4,10,3,0,1,1,-1,1,1,2,1
KR_6754638759,420,3,24,-20,1,2,2,0,-1,7,8,3,5,2,-3,3,6,0,3,3,0,0,-10,2,5,7,4,0,0,-1,-1,0,1,2,1
KR_6725416610,420,1,33,-4,2,1,3,2,-5,3,8,5,5,0,2,4,2,-1,0,1,-1,-7,1,-6,9,3,3,0,1,1,-1,1,-1,3,1
KR_6740526171,420,4,68,11,8,0,3,3,1,3,2,-3,2,5,9,9,0,1,1,0,0,7,-2,1,7,8,0,0,2,1,-1,1,1,2,1
KR_6732806910,440,2,69,22,1,0,1,1,-2,1,3,-4,2,6,4,4,0,3,4,1,0,-5,-37,0,7,7,5,0,-1,-1,1,-1,-1,1,1
KR_6713639941,420,2,45,-24,9,2,4,2,2,4,2,2,5,3,3,5,2,0,1,1,0,11,5,4,2,6,0,0,0,1,1,1,1,4,1
KR_6681391957,420,1,28,0,0,3,3,0,-2,2,4,0,1,1,-2,0,2,1,1,0,0,1,-5,5,2,7,-1,0,1,1,1,1,-1,4,1
KR_6732412601,420,2,32,4,2,0,2,2,1,3,2,1,3,2,-1,3,4,1,2,1,0,4,65,0,5,5,-21,0,1,1,1,1,1,5,1
KR_6598477671,420,0,6,-16,-2,-2,1,3,0,0,0,-2,4,6,0,1,1,2,3,1,0,-2,47,-6,8,2,-23,0,1,1,-1,1,-1,6,1
KR_6681606559,420,-1,-3,18,-7,2,4,2,-2,1,3,-1,0,1,-3,2,5,-3,0,3,0,-13,-12,-4,10,6,-4,0,-1,-1,1,1,1,5,1
KR_6767081677,420,2,55,13,9,3,4,1,1,1,0,-1,0,1,2,3,1,4,4,0,0,16,7,8,0,8,5,0,0,1,1,1,1,1,1
KR_6480655666,420,1,4,8,5,3,4,1,3,4,1,0,2,2,1,2,1,-2,0,2,0,-2,-7,4,4,8,1,0,0,-1,1,0,1,4,1
KR_6762396674,440,5,89,3,14,7,7,0,-3,2,5,1,2,1,5,7,2,4,5,1,0,3,41,-4,6,2,-20,0,1,1,0,1,1,6,1
KR_6699035871,420,-1,9,-5,2,0,5,5,1,4,3,2,2,0,-1,1,2,0,2,2,-1,-1,-4,2,5,7,-5,0,0,1,1,0,-1,4,1
KR_6637541553,420,2,21,-1,5,-1,1,2,3,3,0,4,6,2,-1,2,3,0,1,1,1,4,-4,1,5,6,1,0,0,-1,1,1,1,6,1
KR_6766146742,420,10,178,37,25,2,2,0,4,4,0,5,5,0,12,12,0,2,3,1,0,17,9,3,0,3,2,0,6,1,1,1,1,6,1
KR_6727444432,440,4,30,4,11,-2,1,3,0,3,3,5,5,0,6,10,4,2,3,1,1,14,-1,1,1,2,1,0,2,0,1,1,-1,0,1
KR_6760530953,420,0,-34,-24,6,1,1,0,0,3,3,2,4,2,1,3,2,2,2,0,0,6,2,0,6,6,-3,0,-1,-1,1,-1,-1,1,1
KR_6725876600,440,4,56,12,7,-2,1,3,-2,2,4,3,3,0,9,9,0,-1,0,1,0,6,2,1,2,3,-2,0,0,1,-1,1,1,6,1
KR_6664070041,420,2,77,-20,6,6,6,0,-2,1,3,4,5,1,-1,3,4,-1,1,2,1,2,-3,5,4,9,-5,0,1,-1,1,1,1,5,1
KR_6413983590,420,3,66,7,7,3,4,1,2,5,3,0,0,0,3,5,2,-1,0,1,0,15,13,5,5,10,-3,0,2,-1,1,1,-1,5,1
KR_6742702093,420,4,-36,59,12,-1,0,1,2,4,2,4,5,1,7,8,1,0,1,1,1,8,-12,5,1,6,-3,0,1,1,-1,-1,1,3,1
KR_6712203710,420,-2,-45,-8,-3,-7,0,7,0,0,0,-1,0,1,1,3,2,4,5,1,0,10,4,-1,5,4,-2,0,1,1,0,1,1,1,1
KR_6754135442,420,-3,-31,-12,-3,-4,1,5,0,3,3,2,3,1,-1,4,5,0,0,0,0,-3,-1,-2,3,1,2,0,0,-1,1,0,-1,1,1
KR_6754397040,420,4,70,-5,9,0,1,1,2,4,2,3,3,0,3,4,1,1,2,1,1,10,-7,1,4,5,4,0,2,0,0,1,1,0,1
KR_6747572428,420,0,-28,3,-4,-3,1,4,2,4,2,0,0,0,0,0,0,-3,0,3,0,-8,5,1,3,4,0,0,0,-1,1,0,-1,5,1
KR_6675266962,420,6,48,53,7,0,2,2,0,2,2,11,12,1,-2,0,2,-2,0,2,0,2,-2,-4,8,4,7,0,0,1,-1,1,1,5,1
KR_6759511321,420,0,72,15,-2,-1,1,2,5,5,0,-4,0,4,-2,2,4,0,0,0,0,-7,-5,-1,6,5,1,0,0,1,1,0,-1,5,1
KR_6679711693,440,0,-18,-12,-3,4,4,0,-1,0,1,-4,2,6,-2,2,4,0,1,1,0,-2,3,0,2,2,-1,0,-1,-1,-1,-1,-1,4,1
KR_6767219142,420,-1,-2,4,-1,1,3,2,4,4,0,-1,2,3,-3,0,3,-2,0,2,0,-4,-27,3,0,3,-3,0,-2,1,1,-1,-1,5,1
KR_6745907950,420,2,24,20,0,1,2,1,-4,3,7,2,3,1,0,2,2,1,3,2,0,-2,2,-1,7,6,-3,0,1,1,1,1,1,6,1
KR_6752082966,420,2,59,-13,8,3,3,0,0,5,5,2,2,0,2,2,0,1,2,1,0,5,15,1,1,2,2,0,-1,1,-1,-1,-1,4,1
KR_6752196056,420,-1,-32,-20,-3,0,1,1,-5,1,6,-5,0,5,5,7,2,2,2,0,1,2,1,0,7,7,0,0,0,1,-1,1,-1,6,1
KR_6762189517,420,-2,-42,7,-6,3,5,2,-6,3,9,-3,3,6,-2,1,3,2,5,3,-1,-6,11,-3,3,0,-2,0,-1,1,0,1,-1,6,1
KR_6741452343,420,-1,48,7,1,1,2,1,-1,1,2,0,6,6,1,1,0,0,2,2,0,-4,-57,-5,8,3,4,0,0,-1,1,1,1,5,1
KR_6637509748,420,-2,13,-6,-2,-3,0,3,-1,3,4,0,2,2,2,4,2,0,0,0,0,4,-3,2,4,6,2,0,0,-1,1,0,1,5,1
KR_6620996753,420,5,58,8,3,3,6,3,0,1,1,0,3,3,-1,0,1,1,1,0,0,1,18,5,2,7,-2,0,1,1,1,1,-1,6,1
KR_6705486277,420,4,60,28,2,-3,1,4,0,2,2,-1,2,3,6,7,1,0,0,0,1,0,46,6,4,10,-26,0,0,1,1,1,1,2,1
KR_6727750932,420,-1,101,-43,3,4,4,0,-4,0,4,-1,2,3,3,3,0,1,1,0,0,1,4,0,6,6,2,0,0,1,-1,0,1,6,1
KR_6764472498,420,1,8,0,2,-1,0,1,-8,0,8,1,3,2,10,10,0,0,0,0,0,4,3,3,2,5,3,0,2,0,1,1,1,0,1
KR_6762854994,420,2,59,-8,-4,2,3,1,1,2,1,-2,3,5,-4,2,6,-1,2,3,0,-3,-8,-3,6,3,2,0,1,-1,1,1,1,4,1
KR_6765746090,420,1,-4,-37,0,1,3,2,0,4,4,0,2,2,-1,2,3,0,0,0,0,4,-11,5,2,7,1,0,0,1,-1,0,1,5,1
KR_6318093618,420,3,71,16,6,-2,1,3,0,1,1,3,4,1,2,3,1,3,3,0,0,8,7,-1,4,3,-1,0,0,1,-1,-1,1,6,1
KR_6573520770,440,-3,-2,-33,1,-3,1,4,3,3,0,2,2,0,3,3,0,-4,1,5,0,3,-15,0,5,5,2,0,-1,-1,-1,-1,-1,5,1
KR_6720916001,420,3,63,8,3,4,5,1,1,3,2,-3,1,4,2,3,1,-1,1,2,0,-2,115,0,5,5,2,0,1,1,-1,-1,-1,1,1
KR_6731928001,420,1,-6,-27,1,3,4,1,2,5,3,-4,0,4,-1,3,4,1,1,0,0,4,-4,0,5,5,-1,0,-2,1,-1,-1,1,5,1
KR_6737411827,420,-1,-27,8,4,0,1,1,0,4,4,2,2,0,3,6,3,-1,0,1,3,3,21,2,4,6,-3,0,0,1,-1,0,1,4,1
KR_6731364199,420,4,15,20,4,-3,1,4,0,3,3,6,8,2,-2,2,4,3,3,0,-1,9,15,1,3,4,2,0,0,1,1,-1,-1,2,1
KR_6741967980,420,2,4,-16,3,3,3,0,-2,3,5,0,4,4,1,4,3,1,2,1,0,1,-18,1,4,5,0,0,2,-1,1,1,-1,1,1
KR_6749167372,420,5,133,44,4,-1,2,3,3,3,0,4,6,2,0,2,2,-2,1,3,0,2,48,0,1,1,-15,0,2,1,1,1,1,3,1
KR_6726320367,420,-2,4,-37,-7,-2,0,2,-9,1,10,-3,2,5,6,7,1,1,3,2,-1,-2,-8,-5,9,4,-3,0,1,-1,-1,-1,1,1,1
KR_6755435016,420,2,55,-11,4,0,1,1,-1,1,2,-1,3,4,3,5,2,3,3,0,0,-2,-1,2,3,5,2,0,1,1,0,1,-1,3,1
KR_6589186687,420,3,-32,13,6,2,3,1,0,1,1,-1,1,2,2,7,5,3,5,2,0,4,212,-3,6,3,3,0,1,1,1,1,1,5,1
KR_6761937857,440,4,71,52,4,3,5,2,5,7,2,-3,8,11,0,4,4,-1,3,4,1,10,-21,-2,4,2,2,0,2,0,1,1,1,0,1
KR_6662188088,420,3,57,13,2,0,3,3,0,4,4,1,3,2,-1,3,4,2,2,0,1,2,18,-3,8,5,-1,0,1,-1,-1,1,1,6,1
KR_6629989993,420,1,-29,-5,-2,5,5,0,-1,2,3,-1,3,4,-5,4,9,0,2,2,-1,-10,-4,0,6,6,2,0,1,0,1,-1,-1,0,1
KR_6761136794,420,-2,3,-4,-4,4,6,2,-1,2,3,0,1,1,-4,1,5,-3,1,4,0,-7,8,3,4,7,0,0,0,1,1,0,1,2,1
KR_6728272484,420,5,53,-18,11,3,3,0,2,4,2,4,5,1,2,2,0,0,1,1,-2,7,-8,-3,7,4,2,0,1,1,1,1,1,1,1
KR_6698168536,420,4,51,-12,6,-2,1,3,0,3,3,4,5,1,4,4,0,0,0,0,0,-1,34,-2,6,4,-23,0,2,1,-1,1,1,6,1
KR_6755767175,420,-1,14,-16,3,1,2,1,1,3,2,-2,1,3,1,3,2,2,2,0,0,4,-13,2,4,6,1,0,0,1,0,0,-1,6,1
KR_6755725301,440,5,-4,4,15,0,3,3,4,5,1,1,1,0,4,5,1,6,6,0,0,14,27,6,1,7,0,0,1,1,1,1,1,2,1
KR_6766040908,420,4,10,1,7,0,3,3,2,3,1,9,12,3,-1,1,2,-3,0,3,1,1,13,0,4,4,-3,0,0,-1,1,1,1,4,1
KR_6765524030,420,9,84,108,16,2,2,0,1,1,0,3,7,4,10,10,0,0,0,0,0,12,11,4,1,5,2,0,1,1,1,1,1,1,1
KR_6739277436,420,1,31,-8,2,0,2,2,0,4,4,3,5,2,-1,3,4,0,1,1,0,6,-47,0,7,7,-3,0,0,-1,-1,1,-1,4,1
KR_6709290139,440,2,38,12,5,2,3,1,-3,2,5,1,3,2,3,5,2,2,2,0,0,4,14,-2,2,0,-1,0,2,-1,1,1,-1,1,1
KR_6713844615,420,3,82,-12,11,1,3,2,6,7,1,3,4,1,4,4,0,-3,1,4,0,6,-27,3,3,6,-4,0,1,1,1,1,1,3,1
KR_6758382089,440,-2,2,-19,5,1,5,4,1,3,2,6,7,1,-5,1,6,2,4,2,1,5,-2,-6,9,3,-2,0,1,0,-1,1,1,0,1
KR_6768093362,420,-1,-60,28,0,0,3,3,-3,2,5,3,4,1,1,4,3,-1,1,2,-1,1,-5,-1,4,3,1,0,0,1,-1,-1,-1,1,1
KR_6746806049,420,6,-9,15,13,2,2,0,2,3,1,7,8,1,0,1,1,2,3,1,0,12,17,3,1,4,-1,0,1,1,-1,1,1,1,1
KR_6614363433,440,3,85,12,17,3,6,3,4,5,1,8,12,4,2,3,1,0,2,2,2,25,5,3,3,6,-3,0,2,-1,1,1,1,3,1
KR_6756297007,420,3,47,4,10,0,2,2,0,1,1,5,5,0,4,4,0,1,1,0,0,9,-7,1,1,2,3,0,0,1,1,1,1,3,1
KR_6762136860,420,-1,26,2,-7,0,1,1,2,3,1,-2,3,5,-6,1,7,-1,1,2,0,-13,-129,-6,8,2,3,0,1,-1,1,1,-1,2,1
KR_6723106099,420,2,50,7,4,0,3,3,-1,4,5,3,4,1,3,4,1,-1,0,1,0,6,-6,-1,4,3,4,0,0,1,-1,1,-1,1,1
KR_6761011428,420,-2,-35,-18,-2,-3,0,3,1,3,2,-1,3,4,2,7,5,-1,3,4,0,6,112,1,3,4,-1,0,1,1,-1,-1,1,5,1
KR_6680335219,420,0,-16,4,-5,1,2,1,-2,3,5,-4,0,4,0,0,0,0,0,0,0,-2,104,-4,6,2,2,0,1,1,1,1,1,4,1
KR_6766017722,420,2,48,-29,1,2,4,2,-1,2,3,-3,1,4,3,4,1,0,0,0,0,4,46,1,3,4,-18,0,1,-1,-1,1,-1,6,1
KR_6633894202,440,8,75,64,20,5,5,0,7,9,2,4,5,1,1,2,1,3,4,1,0,6,2,1,3,4,0,0,4,0,1,1,1,0,1
KR_6761109196,420,2,-25,16,5,2,3,1,-2,3,5,4,6,2,0,4,4,1,1,0,0,0,-22,-3,12,9,-1,0,0,-1,1,0,-1,2,1
KR_6761437202,420,-2,-39,-12,-6,-3,3,6,-4,2,6,0,4,4,-1,2,3,2,3,1,0,-1,-10,-4,7,3,-3,0,0,-1,1,1,-1,5,1
KR_6664262830,420,4,47,5,15,3,4,1,3,5,2,-2,1,3,10,12,2,1,1,0,0,13,-4,-1,5,4,-1,0,0,1,1,1,1,4,1
KR_6734530670,420,2,-19,16,5,5,5,0,3,3,0,1,2,1,-2,1,3,-2,2,4,0,3,208,6,1,7,1,0,2,-1,-1,1,-1,1,1
KR_6298237041,420,2,-26,-4,9,-2,1,3,8,11,3,1,1,0,0,0,0,2,3,1,0,3,333,5,2,7,-4,0,0,1,1,1,1,6,1
KR_6709269536,440,-2,-74,16,-4,-4,0,4,2,3,1,-1,2,3,-1,4,5,0,3,3,2,8,-10,-2,4,2,4,0,-1,1,-1,-1,1,2,1
KR_6737149188,420,2,88,4,10,5,5,0,0,2,2,1,3,2,2,4,2,2,2,0,0,8,5,-2,3,1,-1,0,0,-1,-1,-1,1,3,1
KR_6761246017,420,4,-4,-1,10,1,3,2,6,6,0,1,6,5,1,3,2,1,1,0,0,13,-288,1,2,3,1,0,2,1,1,1,-1,5,1
KR_6716190198,420,3,51,1,10,1,2,1,-2,1,3,5,8,3,8,14,6,-2,0,2,0,0,10,2,2,4,0,0,1,-1,1,1,1,3,1
KR_6754685737,420,-1,57,-31,-2,1,1,0,0,1,1,1,3,2,-3,0,3,-1,1,2,0,-1,-1,-1,5,4,3,0,1,0,1,1,-1,0,1
KR_6768356248,420,3,94,-12,9,3,4,1,5,6,1,1,2,1,0,2,2,0,1,1,0,14,3,-1,4,3,0,0,1,1,1,1,1,6,1
KR_6768124961,420,-3,-37,-25,-10,-1,0,1,0,3,3,-5,1,6,-4,1,5,0,2,2,0,-1,24,-2,5,3,-4,0,-1,-1,-1,-1,-1,4,1
KR_6759709174,440,10,19,76,10,4,6,2,4,4,0,-3,1,4,8,8,0,-3,0,3,1,16,24,1,1,2,2,0,1,1,1,1,1,1,1
KR_6759902366,440,2,120,4,10,1,3,2,4,5,1,3,3,0,1,4,3,1,2,1,0,10,2,-2,6,4,1,0,3,1,0,1,1,4,1
KR_6611351713,420,1,-51,22,1,6,7,1,2,4,2,2,3,1,-9,0,9,0,0,0,0,-11,16,-1,7,6,2,0,-1,-1,1,1,1,3,1
KR_6768027217,420,-1,6,21,-1,5,5,0,-5,0,5,1,5,4,-3,2,5,1,1,0,-1,0,-6,-5,6,1,2,0,1,1,-1,1,1,4,1
KR_6750360167,420,-1,-26,7,1,-2,1,3,3,3,0,-4,2,6,2,4,2,2,2,0,0,4,19,3,3,6,0,0,0,-1,1,0,-1,5,1
KR_6738573781,420,0,2,7,0,0,1,1,1,3,2,0,2,2,-6,2,8,5,6,1,1,0,-1,0,4,4,3,0,0,1,1,-1,1,5,1
KR_6678269051,420,2,-17,25,1,0,1,1,0,3,3,0,3,3,2,3,1,-1,0,1,0,4,-2,-2,6,4,-1,0,0,1,-1,1,-1,4,1
KR_6726371086,420,-1,17,-8,-7,-3,2,5,-2,2,4,2,2,0,-3,0,3,-1,0,1,1,-2,20,3,1,4,0,0,0,-1,0,0,1,3,1
KR_6768658881,420,3,113,13,6,1,2,1,-4,1,5,6,7,1,3,4,1,0,2,2,0,1,-19,0,8,8,6,0,0,1,0,0,1,1,1
KR_6757977638,420,-1,-36,-4,0,4,4,0,1,2,1,1,1,0,-5,0,5,-1,1,2,0,-6,118,-1,6,5,-5,0,0,-1,1,1,-1,4,1
KR_6302252821,420,0,24,-15,0,-1,0,1,3,4,1,2,2,0,-4,0,4,0,0,0,0,-1,-5,0,10,10,1,0,-1,-1,1,-1,1,6,1
KR_6767660073,420,-2,-21,-37,1,-1,1,2,1,3,2,-1,0,1,0,2,2,2,3,1,0,1,0,-1,3,2,-1,0,-1,1,-1,1,-1,4,1
KR_6629528580,420,0,44,-8,7,2,2,0,2,4,2,1,2,1,1,2,1,1,2,1,0,8,-10,-1,4,3,0,0,0,1,-1,0,1,6,1
KR_6757930335,440,-2,-43,39,2,-2,1,3,-2,0,2,-1,1,2,6,7,1,1,3,2,-1,3,8,7,1,8,0,0,-1,1,-1,-1,-1,5,1
KR_6737612327,420,0,25,-31,-2,-1,3,4,1,3,2,-3,2,5,-4,1,5,5,7,2,0,8,3,0,5,5,0,0,-1,-1,-1,-1,1,1,1
KR_6768278035,420,-1,29,3,3,1,1,0,1,2,1,4,4,0,-3,3,6,0,0,0,1,9,24,-4,6,2,-1,0,0,0,0,0,1,0,1
KR_6745982367,420,0,-26,22,3,-1,2,3,2,6,4,-2,0,2,3,5,2,1,1,0,0,3,6,2,4,6,-1,0,0,1,-1,0,1,6,1
KR_6692042371,420,2,16,8,1,4,5,1,-4,2,6,-1,0,1,-1,1,2,3,3,0,0,-1,6,-1,6,5,-3,0,1,1,1,1,1,4,1
KR_6739467656,420,2,34,-1,3,3,3,0,-1,3,4,1,2,1,-3,5,8,3,5,2,0,6,24,2,3,5,-5,0,0,1,-1,-1,1,6,1
KR_6667403612,420,-1,2,-12,-6,1,2,1,-2,4,6,1,4,3,-4,1,5,-2,1,3,0,-8,109,-1,5,4,4,0,2,1,1,1,-1,6,1
KR_6724716662,420,3,68,12,11,4,4,0,-1,5,6,4,6,2,4,5,1,0,2,2,1,10,-163,5,4,9,0,0,3,1,1,1,1,5,1
KR_6740083373,420,6,-4,44,10,5,6,1,2,7,5,-2,1,3,3,4,1,2,2,0,0,6,5,4,3,7,2,0,2,-1,1,1,-1,2,1
KR_6732526054,420,1,5,1,2,1,2,1,1,4,3,0,1,1,-1,3,4,1,2,1,0,3,1,-3,8,5,-3,0,0,1,1,0,-1,5,1
KR_6764286516,420,-2,-41,-9,-3,5,7,2,-5,0,5,-7,2,9,4,5,1,0,0,0,0,-5,1,-3,7,4,-1,0,0,0,0,0,1,0,1
KR_6766688537,420,3,77,-25,9,5,5,0,2,4,2,0,2,2,0,4,4,2,3,1,0,13,1,1,5,6,1,0,1,1,-1,1,-1,1,1
KR_6735100080,420,0,-25,8,2,0,2,2,-1,0,1,7,8,1,-2,3,5,-2,0,2,0,0,5,3,2,5,1,0,0,1,1,1,1,6,1
KR_6732038483,420,2,16,18,2,-4,0,4,2,5,3,1,4,3,2,2,0,1,2,1,0,6,4,4,2,6,2,0,1,1,1,-1,-1,6,1
KR_6768415273,440,0,-10,1,2,2,2,0,-2,0,2,0,4,4,2,3,1,0,0,0,0,-7,-19,-4,8,4,-2,0,0,1,0,0,1,3,1
KR_6761450530,420,1,-47,-42,8,-1,1,2,1,3,2,2,4,2,4,4,0,2,3,1,0,14,5,6,1,7,2,0,0,-1,0,-1,1,2,1
KR_6661626423,420,4,60,23,4,2,5,3,-2,4,6,3,4,1,1,2,1,0,1,1,0,0,10,-2,7,5,3,0,1,1,1,1,-1,5,1
KR_6715759533,420,-1,-44,-2,-7,-8,2,10,-1,0,1,-1,1,2,3,6,3,0,4,4,-2,-11,-8,-8,11,3,-1,0,-2,1,-1,-1,-1,3,1
KR_6760708216,420,0,-10,28,3,1,1,0,-2,2,4,2,3,1,3,6,3,-1,1,2,0,-1,8,3,3,6,-2,0,0,1,1,0,-1,5,1
KR_6715942543,420,3,-26,-11,2,-6,0,6,0,1,1,1,4,3,7,7,0,0,2,2,-1,7,12,3,2,5,-1,0,-1,-1,1,-1,-1,4,1
KR_6586293402,420,1,31,-13,-3,3,4,1,-1,4,5,-4,1,5,0,3,3,-1,0,1,0,-2,2,-3,6,3,-2,0,0,1,-1,-1,-1,2,1
KR_6761442631,420,3,-10,-3,3,-3,0,3,0,1,1,5,6,1,2,2,0,-1,0,1,0,0,5,-6,8,2,1,0,-1,1,-1,-1,-1,2,1
KR_6766232598,420,3,42,28,11,6,8,2,1,3,2,-1,4,5,5,6,1,0,2,2,1,2,27,2,5,7,-1,0,0,1,1,0,1,5,1
KR_6769257754,420,3,-79,24,5,0,3,3,4,5,1,2,5,3,-2,2,4,1,1,0,0,11,-6,0,5,5,-3,0,0,1,-1,-1,-1,5,1
KR_6766055950,420,6,8,-8,13,-2,1,3,4,5,1,6,7,1,2,2,0,3,5,2,2,24,8,6,3,9,-5,0,1,-1,1,1,1,3,1
KR_6764697715,420,2,-53,0,2,-1,2,3,-1,1,2,0,3,3,2,2,0,2,2,0,0,5,-18,0,3,3,3,0,0,1,-1,0,-1,1,1
KR_6755794306,420,2,35,20,-1,1,1,0,0,2,2,-5,0,5,2,5,3,1,1,0,0,-4,5,-6,13,7,2,0,1,-1,1,1,-1,5,1
KR_6752798644,420,-1,-35,4,2,0,0,0,-1,3,4,1,2,1,-1,2,3,3,3,0,0,2,115,-3,7,4,-1,0,0,-1,-1,1,1,6,1
KR_6636868453,420,0,11,-4,4,3,4,1,2,3,1,5,8,3,-5,3,8,-1,0,1,1,5,-39,-1,5,4,19,0,1,-1,1,1,1,6,1
KR_6732310328,420,1,14,36,-4,-1,0,1,-1,1,2,3,3,0,-5,0,5,0,0,0,0,-11,-33,2,2,4,20,0,0,1,-1,0,1,6,1
KR_6768147326,420,0,-17,0,-3,-4,0,4,-2,5,7,0,1,1,0,0,0,3,3,0,0,-2,2,0,5,5,8,0,0,1,-1,-1,-1,2,1
KR_6633828233,440,2,45,9,1,0,2,2,1,2,1,-3,0,3,1,3,2,2,3,1,0,4,-45,-4,7,3,4,0,1,1,-1,1,-1,6,1
KR_6738791807,420,-1,69,12,-1,5,9,4,-2,0,2,-6,1,7,1,3,2,1,1,0,0,-8,27,2,2,4,2,0,0,-1,0,1,-1,6,1
KR_6761356938,440,1,49,11,-3,-1,1,2,6,7,1,-3,5,8,-4,0,4,-1,0,1,0,2,-43,2,1,3,1,0,1,-1,1,-1,-1,6,1
KR_6718891030,420,-3,-41,-8,-7,5,5,0,-3,4,7,-5,0,5,-2,6,8,-2,1,3,3,-2,106,4,2,6,-5,0,-2,1,-1,-1,-1,4,1
KR_6612264672,420,4,47,1,7,0,1,1,2,4,2,2,3,1,0,0,0,3,3,0,0,6,16,5,2,7,3,0,3,1,1,1,-1,6,1
KR_6733589130,440,4,69,12,8,5,6,1,3,5,2,0,1,1,3,7,4,-3,0,3,0,5,6,0,4,4,2,0,3,0,1,1,1,0,1
KR_6685057706,440,-1,-5,27,3,2,3,1,-1,0,1,4,5,1,2,4,2,-4,2,6,0,3,-9,3,3,6,-4,0,-1,-1,1,-1,1,5,1
KR_6764063037,420,-4,-71,-9,-3,-5,0,5,-3,0,3,1,5,4,4,4,0,0,3,3,0,1,2,0,7,7,-1,0,0,-1,1,1,1,1,1
KR_6762468617,420,-3,-26,8,-5,-1,1,2,-5,1,6,1,1,0,1,1,0,-1,1,2,0,-4,-30,-2,6,4,2,0,0,1,-1,-1,-1,5,1
KR_6755398356,420,4,25,-8,11,3,5,2,-1,1,2,2,3,1,6,6,0,1,1,0,1,12,41,3,1,4,-19,0,0,1,-1,1,1,5,1
KR_6759426407,420,-1,37,-24,-1,6,6,0,-4,3,7,7,7,0,-5,1,6,-5,0,5,0,0,-231,-1,7,6,-1,0,1,-1,-1,1,-1,2,1
KR_6757132449,420,2,45,36,4,1,1,0,-1,3,4,3,4,1,0,0,0,1,1,0,0,5,-1,2,3,5,1,0,1,1,1,1,1,1,1
KR_6733352010,420,-2,-10,-42,6,2,2,0,2,5,3,-1,1,2,3,4,1,0,0,0,0,12,-38,-2,5,3,19,0,1,1,0,1,-1,2,1
KR_6768647233,420,3,33,-8,10,1,2,1,8,10,2,-4,0,4,5,5,0,0,1,1,2,19,6,-2,5,3,1,0,0,1,1,0,1,6,1
KR_6762222821,420,3,69,-8,2,-1,0,1,2,4,2,-2,0,2,1,3,2,2,3,1,0,4,6,2,2,4,-2,0,1,-1,1,1,1,2,1
KR_6583226431,420,0,-33,8,0,-2,1,3,0,4,4,-2,0,2,0,3,3,4,6,2,-1,-1,-3,-1,6,5,-1,0,0,1,1,0,-1,1,1
KR_6765570292,420,2,6,11,1,1,1,0,2,2,0,-1,3,4,-1,1,2,0,1,1,0,11,1,2,7,9,0,0,0,1,-1,0,-1,4,1
KR_6762527302,420,3,7,-19,2,5,6,1,-2,0,2,-3,1,4,3,4,1,-1,2,3,1,0,-4,-4,7,3,5,0,-2,0,-1,-1,1,0,1
KR_6732345650,440,3,-26,23,6,0,0,0,3,5,2,1,4,3,5,5,0,-3,0,3,0,8,-19,-1,4,3,5,0,0,1,-1,-1,1,5,1
KR_6703529777,420,-1,8,7,-2,1,3,2,4,5,1,2,3,1,-8,4,12,-1,3,4,1,4,263,2,1,3,-2,0,1,1,1,1,1,4,1
KR_6755684607,440,4,4,-4,8,1,3,2,2,4,2,2,4,2,1,2,1,2,2,0,0,4,4,5,1,6,-7,0,0,0,0,0,-1,0,1
KR_6661149713,420,4,85,16,8,6,6,0,0,6,6,-3,0,3,3,5,2,2,2,0,0,11,1,-3,7,4,-5,0,2,1,-1,1,1,3,1
KR_6762002618,420,2,-11,8,5,3,3,0,-2,3,5,-2,0,2,5,5,0,1,2,1,0,1,-20,1,5,6,2,0,1,0,1,1,1,0,1
KR_6748563028,420,2,25,-1,2,4,5,1,-3,1,4,-1,2,3,2,2,0,0,3,3,0,0,156,-2,6,4,-1,0,0,0,-1,-1,-1,0,1
KR_6687538255,420,3,3,35,2,-1,3,4,-2,1,3,3,4,1,1,2,1,1,2,1,0,0,7,-1,5,4,1,0,0,1,1,0,-1,3,1
KR_6759887219,420,4,53,-16,10,-5,0,5,4,4,0,5,6,1,7,7,0,-1,0,1,0,14,-192,2,3,5,1,0,2,1,-1,1,-1,3,1
KR_6768033039,420,-1,1,-17,-2,0,1,1,-1,0,1,-1,1,2,1,1,0,-1,0,1,0,-2,-3,2,4,6,-5,0,0,1,-1,0,-1,1,1
KR_6646963809,420,2,21,24,5,1,1,0,2,3,1,-1,3,4,1,2,1,2,2,0,-1,5,9,-3,7,4,0,0,0,1,-1,0,-1,4,1
KR_6764634207,420,0,-49,-16,-3,-8,2,10,1,5,4,2,4,2,3,4,1,-1,0,1,0,8,-3,1,3,4,2,0,-2,1,-1,-1,-1,4,1
KR_6765735381,420,-1,42,24,1,0,5,5,3,3,0,-3,0,3,0,6,6,1,1,0,0,-6,-190,3,3,6,1,0,-1,-1,1,-1,-1,5,1
KR_6761669945,420,2,36,-4,2,0,1,1,0,2,2,2,3,1,3,5,2,-3,2,5,0,6,82,3,4,7,-25,0,3,1,1,1,-1,4,1
KR_6755983274,420,2,35,-16,12,0,2,2,7,7,0,1,2,1,3,6,3,1,2,1,0,15,10,3,3,6,-4,0,1,-1,1,1,1,5,1
KR_6766025402,440,4,73,-7,10,1,1,0,2,4,2,4,4,0,2,3,1,1,2,1,1,14,3,4,2,6,0,0,1,1,0,1,1,6,1
KR_6749659799,420,0,34,7,4,-1,2,3,5,5,0,4,5,1,-1,1,2,-3,1,4,1,2,-6,3,3,6,0,0,1,1,1,1,1,1,1
KR_6741497263,440,-1,9,40,-3,-5,0,5,2,6,4,-2,2,4,3,3,0,-1,4,5,0,-2,-1,-1,4,3,-4,0,-1,0,-1,-1,1,0,1
KR_6768837619,420,1,-12,24,-2,0,0,0,4,5,1,0,0,0,-4,0,4,-2,0,2,-1,-1,2,-3,5,2,0,0,-1,-1,-1,-1,-1,4,1
KR_6716182312,440,-1,2,-3,-5,-2,0,2,-1,2,3,-1,0,1,1,4,3,-2,4,6,-1,0,-1,0,1,1,0,0,0,-1,-1,0,-1,3,1
KR_6618492022,420,1,108,32,-2,-1,1,2,-4,3,7,-5,1,6,7,8,1,1,1,0,4,2,-1,2,4,6,5,0,1,1,1,1,1,4,1
KR_6751476364,420,0,-52,-12,-4,-2,0,2,1,2,1,2,2,0,-5,1,6,0,0,0,0,-11,2,2,3,5,3,0,0,0,0,0,1,0,1
KR_6767142418,420,2,33,52,4,-4,0,4,6,7,1,1,2,1,2,3,1,-1,0,1,-1,12,34,5,2,7,1,0,0,1,-1,0,-1,1,1
KR_6754273758,420,3,33,4,4,8,9,1,-1,0,1,1,3,2,-4,3,7,0,0,0,0,-1,-3,2,3,5,-3,0,0,0,-1,0,-1,0,1
KR_6763223050,420,0,68,-4,6,2,5,3,1,3,2,-1,2,3,3,3,0,1,1,0,0,4,-25,-1,5,4,1,0,1,1,1,1,1,6,1
KR_6743815649,420,7,35,0,21,5,7,2,6,6,0,6,6,0,0,3,3,4,4,0,0,9,1,-4,11,7,2,0,2,1,1,1,1,6,1
KR_6727478570,420,4,67,0,6,1,2,1,1,2,1,1,4,3,2,3,1,1,1,0,0,4,2,2,3,5,2,0,0,1,-1,0,1,3,1
KR_6759958366,420,-3,-34,-14,-7,-2,2,4,1,6,5,-1,4,5,-3,2,5,-2,1,3,0,-8,3,-5,5,0,-5,0,-2,1,-1,-1,1,2,1
KR_6708461844,420,1,19,6,-5,1,1,0,2,5,3,2,3,1,-7,2,9,-3,0,3,0,-9,-81,5,5,10,-31,0,0,1,-1,0,-1,1,1
KR_6764619748,420,3,-9,54,7,2,2,0,1,3,2,-5,0,5,7,8,1,2,3,1,-1,6,0,1,6,7,1,0,0,1,1,0,-1,6,1
KR_6767976932,420,6,38,16,16,1,2,1,3,4,1,3,5,2,7,7,0,2,2,0,1,13,118,0,3,3,0,0,-1,1,-1,-1,1,1,1
KR_6751749679,420,1,33,-4,6,0,0,0,1,2,1,0,4,4,4,6,2,1,4,3,0,7,4,-1,3,2,-2,0,2,1,-1,1,-1,5,1
KR_6767213485,420,1,-6,-12,9,-2,1,3,7,9,2,1,4,3,0,1,1,3,3,0,0,3,-27,-1,7,6,3,0,-1,-1,0,-1,1,5,1
KR_6732251956,420,1,30,22,-1,-1,1,2,4,4,0,-1,2,3,1,1,0,-4,1,5,0,-5,-6,0,5,5,6,0,1,0,1,1,1,0,1
KR_6768116535,440,2,36,-5,3,2,4,2,2,5,3,0,2,2,0,0,0,-1,0,1,0,1,-38,2,2,4,-3,0,1,0,0,1,1,0,1
KR_6756696122,420,2,45,-24,9,9,10,1,-1,4,5,0,1,1,0,0,0,1,1,0,0,6,2,1,4,5,3,0,2,-1,1,1,1,6,1
KR_6756282994,420,1,67,-22,5,1,2,1,5,6,1,5,6,1,-6,0,6,0,0,0,0,-6,-2,2,4,6,-4,0,0,1,1,1,-1,4,1
KR_6763667332,420,0,5,-12,3,-2,2,4,-1,2,3,3,3,0,2,4,2,1,3,2,0,9,12,4,1,5,-1,0,0,0,1,0,1,0,1
KR_6760565749,420,4,56,0,6,3,3,0,1,6,5,-1,3,4,4,8,4,-1,1,2,-1,1,14,1,3,4,4,0,2,1,1,1,-1,6,1
KR_6758240811,420,5,81,36,14,1,6,5,0,3,3,7,9,2,4,5,1,2,2,0,2,16,-1,6,3,9,0,0,3,1,-1,1,1,5,1
KR_6650957757,420,10,122,16,18,4,4,0,1,5,4,10,10,0,3,4,1,0,1,1,1,10,5,-3,4,1,3,0,5,0,-1,1,1,0,1
KR_6750736177,440,1,52,-15,3,3,6,3,-1,2,3,2,4,2,0,0,0,-1,0,1,0,-1,297,0,4,4,3,0,0,1,-1,0,-1,3,1
KR_6760861121,420,5,25,24,1,2,3,1,-1,4,5,-2,2,4,3,4,1,-1,0,1,0,3,-15,-4,8,4,3,0,0,1,-1,-1,-1,1,1
KR_6755443867,420,-1,-16,10,-2,-2,2,4,-1,0,1,0,3,3,1,1,0,0,0,0,0,0,196,-4,7,3,-5,0,0,0,0,0,1,0,1
KR_6768538587,420,0,2,9,0,0,2,2,1,2,1,-2,0,2,1,1,0,0,1,1,0,3,-2,-1,4,3,2,0,0,1,0,0,-1,1,1
KR_6748159761,420,-1,37,-10,0,0,1,1,-3,2,5,4,5,1,-2,0,2,1,1,0,0,2,13,0,2,2,0,0,1,1,-1,1,-1,2,1
KR_6298562948,420,0,104,4,-3,-1,0,1,-5,2,7,-1,3,4,5,6,1,-1,0,1,2,1,-2,1,3,4,-1,0,0,-1,-1,0,1,2,1
KR_6613828665,420,2,69,22,1,-1,2,3,1,2,1,4,5,1,-3,1,4,0,1,1,0,-2,6,1,8,9,5,0,1,-1,1,1,1,4,1
KR_6762974469,420,4,75,-10,10,6,6,0,1,3,2,1,3,2,2,3,1,0,0,0,0,5,10,2,2,4,0,0,1,-1,-1,1,1,2,1
KR_6661982318,420,2,66,32,-2,-4,2,6,1,3,2,5,6,1,-4,0,4,0,0,0,0,3,1,1,3,4,-1,0,1,-1,-1,1,-1,5,1
KR_6760982924,420,5,30,12,5,3,4,1,-2,4,6,1,3,2,3,5,2,0,0,0,0,6,-1,0,5,5,1,0,1,-1,1,1,1,2,1
KR_6766139008,420,2,40,-12,4,1,2,1,0,1,1,1,2,1,2,3,1,0,0,0,1,7,-6,-2,4,2,4,0,1,1,1,1,1,5,1
KR_6758205237,440,0,-32,20,8,-4,1,5,3,4,1,0,2,2,12,12,0,-3,1,4,0,16,-8,1,3,4,-1,0,0,-1,1,1,1,2,1
KR_6713349957,420,7,32,-3,4,-8,0,8,5,5,0,3,3,0,3,4,1,1,1,0,-1,7,-37,-7,7,0,6,0,2,1,1,1,-1,3,1
KR_6728211896,420,3,6,-15,6,4,4,0,2,3,1,0,3,3,0,2,2,0,0,0,0,5,5,4,3,7,-6,0,0,-1,0,0,-1,4,1
KR_6705602605,420,3,41,37,7,0,2,2,-1,1,2,3,4,1,-2,1,3,7,7,0,0,4,8,0,5,5,0,0,0,1,1,0,1,6,1
KR_6735858178,420,4,53,14,6,-3,0,3,2,3,1,3,6,3,4,4,0,0,0,0,0,11,18,-1,4,3,2,0,2,1,-1,1,-1,4,1
KR_6630515205,420,5,57,15,15,2,5,3,1,3,2,5,5,0,4,4,0,3,3,0,-1,15,1,-2,8,6,-3,0,2,1,-1,1,-1,5,1
KR_6705596116,420,3,-10,24,2,-4,2,6,1,4,3,0,2,2,3,4,1,2,2,0,0,4,51,3,2,5,3,0,-1,1,1,-1,-1,6,1
KR_6758953053,420,5,67,8,12,3,3,0,1,2,1,4,5,1,1,2,1,3,5,2,0,8,6,4,3,7,-2,0,1,-1,1,1,1,2,1
KR_6723878511,420,4,75,12,7,2,2,0,-5,1,6,8,8,0,1,2,1,1,2,1,0,5,4,0,4,4,4,0,1,1,1,1,1,3,1
KR_6707904424,420,6,75,43,13,6,6,0,2,2,0,3,3,0,0,1,1,2,2,0,0,9,6,1,2,3,2,0,3,1,1,1,1,4,1
KR_6754706047,420,1,-31,36,1,-1,2,3,1,2,1,2,2,0,1,2,1,-2,0,2,0,-1,0,5,2,7,1,0,0,1,1,0,-1,5,1
KR_6762941253,420,0,-44,16,-6,-1,1,2,-1,2,3,2,2,0,-7,3,10,1,3,2,2,-5,7,-2,4,2,1,0,-2,1,0,-1,1,5,1
KR_6754500356,420,0,-29,0,-1,-4,1,5,1,1,0,4,4,0,0,3,3,-2,1,3,0,1,-350,-3,4,1,1,0,0,-1,1,0,-1,3,1
KR_6741009751,420,-3,9,17,-13,-3,0,3,-6,0,6,-5,0,5,-1,2,3,2,2,0,-3,-23,-2,-3,6,3,1,0,0,-1,1,0,-1,2,1
KR_6706839154,420,2,47,-8,4,-1,0,1,5,7,2,-1,1,2,1,2,1,0,0,0,0,2,7,5,3,8,4,0,0,1,-1,0,-1,6,1
KR_6738257052,420,2,-60,27,9,3,5,2,5,7,2,0,1,1,0,3,3,1,4,3,0,16,8,7,5,12,-2,0,2,1,1,1,1,2,1
KR_6650845084,420,4,9,29,7,3,5,2,3,4,1,-1,2,3,3,3,0,-1,0,1,3,9,296,-2,4,2,3,0,1,1,-1,1,1,5,1
KR_6675317723,420,5,83,18,11,-1,1,2,4,4,0,-1,2,3,7,7,0,2,3,1,0,18,4,-1,5,4,1,0,1,1,0,1,-1,6,1
KR_6755587564,440,1,-5,4,0,-1,0,1,-4,1,5,2,3,1,1,3,2,2,2,0,0,-4,-11,-8,10,2,2,0,0,-1,1,0,-1,2,1
KR_6763029247,420,-3,-50,-18,-4,2,3,1,-6,0,6,0,3,3,1,1,0,-1,0,1,0,-6,-35,0,6,6,0,0,-1,-1,-1,-1,-1,4,1
KR_6741328951,420,2,33,-28,2,1,1,0,1,2,1,0,0,0,-2,1,3,2,2,0,0,-2,-28,3,3,6,7,0,0,1,-1,0,1,2,1
KR_6703545262,420,2,114,12,10,2,3,1,3,7,4,4,5,1,1,4,3,0,2,2,0,6,-2,4,2,6,3,0,2,1,1,1,1,6,1
KR_6716648316,420,1,7,28,4,1,3,2,-2,2,4,2,4,2,1,2,1,2,2,0,0,4,11,5,2,7,-1,0,1,1,1,1,-1,4,1
KR_6764346161,420,5,17,-11,13,0,3,3,7,7,0,2,2,0,3,4,1,1,1,0,1,16,-3,0,4,4,0,0,0,-1,0,0,1,4,1
KR_6737905456,420,1,39,10,0,-3,1,4,-1,1,2,2,3,1,1,3,2,1,1,0,0,0,6,1,2,3,-1,0,1,1,1,1,-1,3,1
KR_6609305647,420,2,2,12,15,1,5,4,2,4,2,2,4,2,8,8,0,2,2,0,0,10,293,4,3,7,5,0,0,1,1,1,-1,1,1
KR_6681906850,420,6,97,-7,16,0,0,0,1,1,0,4,4,0,7,11,4,4,6,2,0,14,4,-2,5,3,0,0,0,1,1,1,1,3,1
KR_6747412951,420,-2,-48,32,4,-5,0,5,6,8,2,-1,2,3,3,5,2,1,2,1,0,14,-5,2,4,6,2,0,-1,1,-1,-1,1,3,1
KR_6733220877,420,2,69,-20,4,0,0,0,-5,3,8,5,5,0,3,4,1,1,4,3,0,1,15,-1,5,4,4,0,1,-1,-1,1,-1,1,1
KR_6719589498,420,0,-6,-20,-5,3,5,2,-2,2,4,0,2,2,-5,0,5,-1,1,2,0,-4,-14,0,5,5,4,0,1,-1,1,1,-1,1,1
KR_6732514311,420,2,74,14,-5,0,2,2,-3,1,4,-2,0,2,0,3,3,0,2,2,0,-10,69,1,5,6,-24,0,0,0,1,1,-1,0,1
KR_6537804313,420,4,43,47,6,1,2,1,-3,2,5,2,2,0,4,4,0,2,2,0,0,10,-59,-2,7,5,-2,0,0,-1,-1,1,-1,6,1
KR_6723883501,420,3,42,43,17,7,10,3,-2,2,4,7,7,0,4,5,1,1,2,1,3,10,14,3,1,4,-3,0,2,1,1,1,1,4,1
KR_6758339168,420,2,-5,15,-1,-1,0,1,-2,2,4,-1,2,3,5,7,2,-2,0,2,-1,-4,5,2,6,8,-1,0,0,1,-1,0,-1,2,1
KR_6701514416,440,1,-24,-1,-3,-3,0,3,-5,1,6,2,3,1,0,3,3,3,3,0,0,3,27,-3,5,2,7,0,0,-1,-1,0,-1,4,1
KR_6724635558,420,3,64,13,11,1,2,1,3,6,3,3,4,1,3,5,2,1,1,0,0,10,4,4,1,5,-1,0,1,-1,1,1,1,5,1
KR_6749762966,420,1,-3,-14,2,-4,0,4,1,2,1,4,5,1,1,3,2,0,0,0,0,4,-2,2,3,5,0,0,0,-1,1,1,-1,2,1
KR_6478913423,420,5,66,-16,9,0,1,1,-1,3,4,8,9,1,-1,3,4,3,3,0,0,4,7,1,4,5,-3,0,2,-1,1,1,-1,2,1
KR_6691022403,420,-2,38,-1,0,-3,0,3,5,5,0,-1,2,3,-2,2,4,1,1,0,-1,-6,5,5,3,8,4,0,0,-1,1,0,-1,6,1
KR_6759304378,420,3,16,-13,5,-2,0,2,6,6,0,1,2,1,-1,0,1,1,1,0,0,7,-8,-2,6,4,6,0,0,1,-1,1,1,1,1
KR_6754799647,420,3,19,28,8,1,3,2,-2,4,6,1,3,2,8,9,1,0,2,2,0,13,40,1,5,6,-20,0,1,1,1,1,1,1,1
KR_6767638356,420,0,33,-8,3,-3,0,3,-2,1,3,1,2,1,4,4,0,3,5,2,0,5,14,2,2,4,1,0,-1,1,-1,-1,1,2,1
KR_6751382789,420,1,24,-2,12,-1,2,3,8,8,0,5,7,2,-1,3,4,1,3,2,0,14,-3,2,5,7,2,0,0,1,1,-1,1,6,1
KR_6762966893,420,0,33,-31,5,2,3,1,6,6,0,-1,3,4,-1,2,3,-1,1,2,0,7,4,1,2,3,3,0,0,-1,1,0,1,2,1
KR_6751104919,420,3,16,20,3,0,1,1,2,5,3,0,3,3,-1,3,4,2,2,0,-1,-1,-40,-7,7,0,2,0,1,-1,1,1,-1,2,1
KR_6737424409,420,4,43,-2,7,2,2,0,3,4,1,0,1,1,3,3,0,-1,0,1,0,7,35,1,7,8,3,0,1,1,1,1,1,2,1
KR_6744854975,420,-1,86,0,6,6,6,0,0,1,1,-4,0,4,4,7,3,0,2,2,0,3,-4,2,3,5,1,0,0,1,1,1,1,2,1
KR_6756731027,420,3,28,4,5,0,2,2,5,6,1,-3,2,5,2,4,2,1,1,0,0,4,1,2,4,6,-1,0,0,1,1,1,1,5,1
KR_6759016237,420,0,-17,-21,-4,-1,1,2,-6,2,8,6,8,2,-2,0,2,-1,0,1,0,-11,-5,3,6,9,0,0,0,1,1,0,-1,3,1
KR_6761714435,420,4,29,-21,9,5,6,1,2,4,2,2,4,2,-1,3,4,1,3,2,-1,8,3,4,2,6,-1,0,2,0,1,1,-1,0,1
KR_6704812396,420,5,-12,8,15,7,7,0,7,7,0,-1,1,2,0,0,0,2,2,0,0,14,-1,1,6,7,-3,0,1,1,-1,-1,1,3,1
KR_6762284633,440,2,63,-19,12,2,5,3,0,1,1,9,10,1,1,1,0,0,0,0,0,4,5,-2,3,1,-5,0,0,-1,-1,0,1,3,1
KR_6686189441,440,5,16,36,11,3,5,2,3,3,0,-3,1,4,8,8,0,0,1,1,-1,8,0,1,5,6,1,0,1,-1,1,1,-1,5,1
KR_6745025726,420,4,-29,3,5,3,4,1,-4,0,4,0,1,1,9,10,1,-3,1,4,0,10,49,1,5,6,-10,0,0,-1,-1,1,1,5,1
KR_6750037697,420,0,11,7,1,0,2,2,1,3,2,2,6,4,1,2,1,-3,3,6,0,2,-4,1,3,4,-4,0,-1,1,0,1,-1,4,1
KR_6114144306,420,5,68,-4,10,1,1,0,0,1,1,5,5,0,3,3,0,1,1,0,0,10,7,1,3,4,1,0,1,0,0,1,1,0,1
KR_6763512855,440,0,-28,29,-2,-1,0,1,-3,2,5,-1,1,2,3,4,1,0,0,0,0,-5,-3,1,3,4,0,0,1,-1,1,1,-1,4,1
KR_6742061240,420,3,-35,32,8,4,4,0,0,2,2,2,2,0,1,2,1,1,1,0,0,3,0,0,5,5,0,0,1,-1,1,1,1,1,1
KR_6464041346,420,7,87,15,11,3,6,3,2,3,1,2,6,4,4,5,1,0,0,0,0,14,4,-1,9,8,0,0,0,-1,0,0,-1,1,1
KR_6722074664,420,0,22,-8,2,-4,1,5,-1,3,4,1,3,2,2,2,0,4,5,1,0,11,1,1,3,4,-3,0,0,1,1,0,-1,1,1
KR_6737120422,420,6,-3,5,9,7,7,0,-2,3,5,1,3,2,0,2,2,3,5,2,0,0,-207,0,5,5,-20,0,0,-1,1,1,-1,2,1
KR_6721898448,420,3,64,24,4,4,7,3,1,3,2,1,5,4,0,3,3,-2,0,2,0,6,19,-3,6,3,0,0,0,1,1,1,1,6,1
KR_6762858147,440,1,-23,8,1,3,4,1,4,4,0,-5,1,6,-2,1,3,1,2,1,0,2,-7,-1,6,5,1,0,1,1,1,1,1,1,1
KR_6756213628,440,1,26,9,5,3,4,1,1,3,2,2,2,0,-1,3,4,0,0,0,0,-4,8,0,6,6,4,0,1,1,-1,1,1,5,1
KR_6681298099,420,6,47,15,10,1,3,2,5,5,0,0,2,2,3,4,1,1,1,0,0,9,-27,-2,5,3,2,0,1,1,1,1,-1,1,1
KR_6688167198,420,1,67,23,1,2,3,1,-2,0,2,-1,2,3,-1,0,1,3,3,0,0,-3,14,-3,7,4,5,0,0,0,0,0,-1,0,1
KR_6745224641,420,1,-56,3,5,-2,1,3,-2,2,4,5,5,0,4,8,4,0,1,1,-2,3,-5,1,5,6,4,0,0,1,0,-1,-1,2,1
KR_6739468843,420,-2,-14,-12,-2,-1,0,1,-3,0,3,0,0,0,2,2,0,0,0,0,0,-5,135,-1,5,4,-7,0,1,1,1,1,-1,2,1
KR_6731432774,420,1,5,6,9,-1,1,2,2,3,1,3,4,1,4,6,2,1,2,1,-1,3,15,3,3,6,-2,0,0,1,1,1,-1,1,1
KR_6753645946,420,3,36,12,7,-1,2,3,1,2,1,3,3,0,0,1,1,4,4,0,1,-1,1,1,3,4,5,0,2,1,1,1,1,4,1
KR_6743073733,420,2,41,15,5,-1,2,3,4,6,2,3,5,2,-1,2,3,0,0,0,1,2,-1,-5,7,2,2,0,0,1,1,1,1,4,1
KR_6766994646,420,2,81,0,-1,2,2,0,-2,1,3,-1,0,1,0,3,3,0,1,1,-1,-2,-24,-5,9,4,3,0,0,-1,1,0,-1,1,1
KR_6752482774,420,1,88,-8,2,5,6,1,1,2,1,-4,1,5,4,5,1,-4,0,4,0,0,12,3,2,5,-1,0,0,-1,0,1,1,6,1
KR_6761530872,440,4,-2,21,10,8,10,2,3,4,1,0,2,2,-1,0,1,0,1,1,0,13,-10,4,3,7,12,0,1,1,1,1,1,3,1
KR_6722852101,420,2,-5,32,4,0,2,2,1,2,1,1,3,2,1,3,2,1,2,1,1,8,-8,2,4,6,-3,0,0,0,1,0,1,0,1
KR_6760222613,420,-4,-10,4,-3,-4,2,6,0,3,3,-2,0,2,0,3,3,3,4,1,0,-1,25,1,4,5,-3,0,1,1,1,1,-1,3,1
KR_6754491464,420,5,63,36,7,1,1,0,3,3,0,-3,1,4,6,7,1,0,0,0,0,8,-5,-2,5,3,2,0,1,1,0,1,-1,3,1
KR_6767234140,420,1,35,-12,6,4,4,0,1,5,4,0,1,1,2,2,0,-1,0,1,0,9,5,3,4,7,0,0,0,-1,1,0,1,6,1
KR_6762709793,420,-1,40,-16,-1,2,2,0,-1,1,2,0,2,2,-1,2,3,-1,0,1,0,-1,9,0,5,5,0,0,0,-1,1,1,1,5,1
KR_6756555784,420,6,40,3,12,0,1,1,0,2,2,2,2,0,3,4,1,7,8,1,0,11,7,8,1,9,3,0,0,1,1,0,1,3,1
KR_6613582768,420,3,46,-3,9,0,2,2,1,1,0,-1,1,2,8,8,0,1,1,0,0,13,-18,1,5,6,2,0,1,-1,-1,1,-1,4,1
KR_6414046709,420,-1,-92,22,-4,-1,1,2,-1,3,4,-3,3,6,0,1,1,1,2,1,0,-7,0,-4,10,6,3,0,-1,1,1,-1,-1,2,1
KR_6699602033,420,1,-49,-5,5,-2,2,4,3,4,1,6,6,0,-2,0,2,0,0,0,0,9,-243,2,3,5,-4,0,0,-1,1,1,1,5,1
KR_6753335984,420,4,42,1,9,2,2,0,0,1,1,0,3,3,8,11,3,-1,4,5,0,8,6,4,2,6,0,0,0,1,0,1,1,3,1
KR_6752320620,420,2,8,27,4,0,2,2,1,1,0,0,2,2,2,2,0,1,1,0,-1,2,-1,1,3,4,1,0,1,1,-1,1,-1,2,1
KR_6741285595,420,4,113,16,16,3,4,1,0,5,5,0,1,1,11,13,2,2,3,1,0,15,-72,1,6,7,12,0,0,1,-1,1,-1,5,1
KR_6736082265,420,1,6,36,12,-1,1,2,2,5,3,-4,1,5,10,13,3,5,5,0,1,16,-10,-3,9,6,-1,0,1,1,-1,1,1,4,1
KR_6759402646,420,2,-17,-12,3,-3,2,5,-3,3,6,4,4,0,4,5,1,1,1,0,0,10,2,1,4,5,-2,0,0,1,-1,0,1,3,1
KR_6725570803,420,-1,69,5,2,-4,0,4,-1,4,5,2,5,3,4,7,3,1,1,0,0,9,-24,1,4,5,0,0,1,0,1,1,1,0,1
KR_6759496278,420,1,45,-7,-3,-3,1,4,-1,1,2,2,2,0,-1,2,3,0,1,1,-1,-1,-14,3,3,6,-1,0,0,-1,1,0,-1,5,1
KR_6763601865,420,-2,32,46,-3,-1,0,1,-6,2,8,3,3,0,-1,5,6,2,2,0,1,-3,7,4,2,6,0,0,0,1,-1,0,1,5,1
KR_6765506058,420,-1,-7,10,-1,0,3,3,3,6,3,-1,0,1,-1,1,2,-2,0,2,0,-9,-1,-1,3,2,0,0,1,1,1,1,1,6,1
KR_6767235902,420,-1,-86,12,-2,2,2,0,4,5,1,-3,1,4,-2,4,6,-3,1,4,-1,6,3,2,4,6,-2,0,0,-1,1,0,-1,2,1
KR_6756726060,420,1,-9,8,4,4,6,2,3,3,0,-1,1,2,3,3,0,-5,2,7,0,-3,8,3,3,6,0,0,1,1,1,1,1,2,1
KR_6763254655,440,-2,-11,-13,-1,4,6,2,0,2,2,-9,2,11,2,5,3,2,4,2,0,-4,-22,5,0,5,-2,0,0,1,1,-1,1,3,1
KR_6758491410,420,1,38,9,3,1,3,2,2,3,1,-2,2,4,0,3,3,2,2,0,0,2,5,1,2,3,1,0,1,1,0,1,-1,3,1
KR_6696974785,420,0,21,-2,-3,2,3,1,-2,1,3,2,2,0,-2,3,5,-3,0,3,0,-6,4,0,2,2,-1,0,-1,0,1,-1,1,0,1
KR_6724541868,420,1,-2,8,1,6,7,1,-1,1,2,-2,3,5,0,0,0,-2,0,2,-1,2,-4,-1,5,4,4,0,0,1,1,1,1,1,1
KR_6767703085,420,4,13,-8,10,5,5,0,1,2,1,0,3,3,8,9,1,-4,1,5,0,7,1,2,3,5,1,0,1,1,0,1,1,5,1
KR_6712826226,420,2,-6,-13,3,1,2,1,-3,2,5,4,6,2,1,5,4,0,2,2,0,0,-33,0,6,6,1,0,1,1,-1,1,-1,1,1
KR_6663696332,420,0,-16,16,-3,0,2,2,-1,2,3,-5,4,9,1,3,2,2,2,0,0,-5,4,0,6,6,-4,0,0,0,-1,0,-1,0,1
KR_6761177470,420,1,5,-3,9,2,3,1,0,2,2,5,5,0,2,4,2,0,0,0,0,10,-15,3,4,7,-5,0,0,1,-1,0,1,4,1
KR_6762264737,420,4,-15,49,3,5,6,1,-2,1,3,2,2,0,-3,4,7,1,2,1,0,-3,-1,-4,6,2,-5,0,0,1,1,1,-1,3,1
KR_6726287708,420,-1,38,12,4,-2,1,3,6,6,0,-3,1,4,2,6,4,1,1,0,0,6,-1,2,3,5,3,0,0,1,0,0,1,5,1
KR_6715874358,420,2,19,4,4,0,1,1,0,3,3,4,7,3,-1,0,1,1,1,0,0,1,36,0,5,5,-21,0,1,1,1,1,1,1,1
KR_6751442126,440,3,27,8,9,3,4,1,0,1,1,2,4,2,0,3,3,4,4,0,0,10,127,5,1,6,3,0,1,1,1,1,1,1,1
KR_6753774311,420,3,73,20,7,0,1,1,7,9,2,2,2,0,-2,3,5,0,1,1,0,5,-4,5,3,8,1,0,1,1,1,1,-1,1,1
KR_6730603029,420,-2,-46,0,-4,-1,1,2,0,2,2,0,2,2,-2,2,4,-1,0,1,1,-1,7,0,6,6,-4,0,-1,1,-1,-1,1,4,1
KR_6683154237,420,2,51,32,4,4,7,3,-4,0,4,1,4,3,5,6,1,-2,0,2,1,5,5,-1,7,6,1,0,1,1,-1,1,1,1,1
KR_6752977136,420,-1,2,-16,-2,-1,0,1,-1,1,2,0,3,3,0,1,1,0,1,1,0,-3,9,0,5,5,-1,0,0,1,-1,-1,1,6,1
KR_6721520631,420,-1,-16,0,-3,0,4,4,-4,1,5,0,5,5,0,3,3,1,2,1,-1,-11,0,5,1,6,-1,0,-1,1,1,-1,-1,1,1
KR_6758063666,420,1,-15,-6,3,-2,0,2,0,3,3,4,5,1,-1,2,3,2,2,0,0,-1,3,-1,6,5,2,0,0,1,0,0,-1,5,1
KR_6737069584,420,-1,-13,15,5,2,4,2,-4,3,7,1,2,1,6,6,0,0,0,0,0,14,-13,1,10,11,2,0,1,1,1,1,1,6,1
KR_6762498902,420,4,42,-20,13,4,4,0,9,9,0,1,4,3,0,2,2,-1,0,1,0,11,6,0,3,3,1,0,0,1,0,0,1,3,1
KR_6743444789,420,0,2,-16,5,-4,3,7,3,4,1,4,5,1,1,4,3,1,2,1,0,9,-2,0,7,7,1,0,-1,0,-1,-1,1,0,1
KR_6764691067,420,0,11,-19,-8,-1,1,2,1,2,1,-1,0,1,-5,0,5,-2,0,2,0,-5,-6,-5,8,3,-5,0,-3,-1,1,-1,-1,2,1
KR_6691089051,420,-2,25,-16,-3,2,3,1,-3,3,6,0,2,2,-2,4,6,0,0,0,0,-9,-55,-4,6,2,26,0,0,-1,-1,-1,-1,6,1
KR_6731548447,420,2,-20,4,6,1,3,2,0,3,3,-3,1,4,3,3,0,5,5,0,1,8,4,-1,4,3,-2,0,0,1,0,0,1,4,1
KR_6747554170,420,0,-46,-8,-8,3,3,0,-4,0,4,2,3,1,-6,3,9,-3,1,4,-1,-10,3,0,3,3,1,0,-1,-1,-1,-1,-1,1,1
KR_6762932518,420,3,11,44,10,1,2,1,2,3,1,6,6,0,2,3,1,-1,0,1,0,11,5,2,4,6,0,0,1,1,1,1,1,1,1
KR_6766814245,420,1,-20,-23,6,2,2,0,1,5,4,0,2,2,3,3,0,0,1,1,0,13,1,3,5,8,0,0,1,-1,-1,1,-1,2,1
KR_6387385069,420,2,43,6,5,1,2,1,6,6,0,-1,1,2,-1,1,2,0,2,2,1,9,-9,5,5,10,0,0,0,1,1,0,1,4,1
KR_6738674908,420,1,30,-5,2,1,1,0,0,2,2,-1,1,2,0,3,3,2,3,1,0,1,26,1,6,7,4,0,0,1,-1,0,1,2,1
KR_6705938385,420,4,42,9,4,3,5,2,2,3,1,3,6,3,-2,2,4,-2,1,3,-1,-13,2,0,2,2,0,0,0,-1,-1,1,-1,6,1
KR_6759707853,420,-3,18,-28,-8,2,3,1,-3,6,9,1,1,0,-5,1,6,-3,1,4,0,-13,0,0,7,7,0,0,-1,-1,1,-1,1,4,1
KR_6759633403,420,2,24,-7,11,4,5,1,9,9,0,-1,0,1,-1,5,6,0,0,0,1,12,4,-2,7,5,6,0,2,1,1,1,-1,4,1
KR_6689116288,420,-1,12,-11,0,-3,0,3,0,2,2,-1,2,3,4,6,2,0,0,0,0,1,-9,-2,4,2,5,0,0,1,-1,0,1,4,1
KR_6765519046,420,5,59,18,14,2,3,1,1,1,0,6,6,0,2,5,3,3,6,3,2,20,5,-3,8,5,3,0,1,-1,1,1,1,6,1
KR_6754370814,420,0,18,14,0,1,1,0,0,2,2,-1,0,1,-1,0,1,1,1,0,0,0,67,-1,4,3,15,0,0,-1,0,0,1,5,1
KR_6604343384,420,5,31,5,10,6,6,0,-5,1,6,-1,6,7,9,11,2,1,2,1,0,6,6,1,4,5,-2,0,1,1,-1,1,-1,6,1
KR_6729726147,440,0,-26,-12,3,0,2,2,2,3,1,-3,0,3,-1,3,4,5,5,0,1,10,-17,2,5,7,15,0,0,1,0,1,1,5,1
KR_6726588437,420,-1,10,-49,-2,-2,1,3,4,6,2,1,6,5,-4,1,5,-1,1,2,0,-4,2,3,2,5,-1,0,0,1,1,1,-1,1,1
KR_6633923868,440,2,-64,24,10,0,2,2,8,8,0,-2,1,3,5,8,3,-1,0,1,0,17,14,0,5,5,2,0,2,1,1,1,1,6,1
KR_6755185220,420,4,43,-32,2,5,5,0,-1,2,3,0,1,1,-4,1,5,2,2,0,0,-2,14,-3,6,3,-2,0,1,-1,1,1,1,4,1
KR_6759496668,420,-3,-24,-39,-1,-1,1,2,-1,4,5,-2,1,3,0,5,5,3,4,1,0,-4,-34,-2,5,3,6,0,0,1,1,0,1,2,1
KR_6747026205,420,4,72,-12,10,5,7,2,5,7,2,-5,1,6,1,4,3,4,5,1,-1,15,-33,3,6,9,4,0,2,1,1,1,1,2,1
KR_6675346663,420,2,46,9,4,-1,1,2,1,3,2,1,3,2,3,4,1,0,3,3,0,6,13,2,3,5,2,0,0,1,1,0,1,5,1
KR_6769267721,420,4,43,-10,10,2,4,2,2,7,5,0,0,0,3,3,0,3,5,2,0,10,-4,1,3,4,-2,0,0,1,-1,0,-1,2,1
KR_6752278678,420,3,66,-8,8,0,2,2,5,7,2,5,6,1,-1,3,4,-1,2,3,1,3,-3,-2,6,4,1,0,-1,1,1,-1,1,1,1
KR_6730049704,420,-1,15,20,2,3,5,2,-4,1,5,1,1,0,-1,4,5,3,3,0,2,-1,0,1,4,5,2,0,-1,1,-1,-1,1,2,1
KR_6766020107,420,5,21,6,13,2,2,0,3,3,0,-2,1,3,7,8,1,3,3,0,0,16,-2,0,6,6,-3,0,2,0,-1,1,1,0,1
KR_6767773114,420,0,60,-8,3,0,2,2,-3,1,4,1,4,3,4,5,1,1,2,1,0,-3,-6,-1,7,6,-1,0,0,-1,-1,0,1,3,1
KR_6667077630,420,5,8,-6,13,0,1,1,8,9,1,-1,2,3,5,7,2,1,1,0,0,12,-6,-1,6,5,0,0,2,1,0,1,1,1,1
KR_6765962263,420,4,40,16,11,-2,2,4,3,3,0,0,2,2,9,9,0,1,1,0,0,14,-3,-1,4,3,1,0,1,1,-1,1,1,4,1
KR_6663295720,420,1,28,-1,7,2,2,0,7,7,0,-2,1,3,0,3,3,0,1,1,1,5,-2,-1,4,3,2,0,4,1,1,1,1,4,1
KR_6763583164,420,0,-7,4,-1,0,3,3,-1,1,2,0,3,3,0,2,2,0,0,0,0,-1,10,4,4,8,-1,0,2,-1,1,1,-1,5,1
KR_6699957338,420,3,53,28,9,5,6,1,-1,3,4,-4,2,6,8,8,0,1,2,1,2,13,-1,0,3,3,-2,0,3,-1,1,1,1,3,1
KR_6759916235,420,3,23,32,6,4,4,0,1,5,4,2,2,0,0,1,1,-1,0,1,0,7,0,4,0,4,0,0,-1,0,1,-1,1,0,1
KR_6740502094,420,2,-58,23,6,1,2,1,4,7,3,1,2,1,-3,4,7,3,3,0,-1,6,42,-4,8,4,2,0,-1,1,-1,-1,-1,5,1
KR_6733030147,420,6,40,24,13,6,6,0,3,4,1,-1,1,2,5,5,0,0,0,0,0,10,1,-1,5,4,1,0,3,1,-1,1,1,3,1
KR_6707887792,420,0,38,-8,3,0,0,0,0,2,2,-3,0,3,6,8,2,0,1,1,0,4,4,2,4,6,-2,0,-1,1,-1,-1,1,2,1
KR_6636047011,420,1,12,-4,9,0,1,1,-1,1,2,4,4,0,3,5,2,3,3,0,0,6,2,4,1,5,0,0,1,1,1,1,1,6,1
KR_6620313300,420,1,42,22,2,2,3,1,4,4,0,-1,1,2,-2,1,3,-1,0,1,0,-5,-13,-6,8,2,3,0,2,1,-1,1,1,5,1
KR_6766914667,420,-2,-36,6,-4,-2,3,5,6,9,3,-3,1,4,-4,2,6,-1,0,1,0,-2,-8,-3,7,4,4,0,-1,1,-1,-1,-1,1,1
KR_6634448541,420,3,4,30,5,-2,2,4,2,4,2,3,4,1,3,4,1,-1,0,1,0,8,-11,4,4,8,-2,0,0,-1,1,0,-1,4,1
KR_6736413226,420,1,-2,-1,3,-4,1,5,5,5,0,2,3,1,2,3,1,-2,1,3,0,5,2,2,4,6,3,0,1,1,0,1,1,5,1
KR_6764442375,420,2,49,13,-2,6,7,1,2,2,0,-8,0,8,0,3,3,-2,0,2,0,-13,-14,-1,5,4,-1,0,1,-1,1,1,-1,2,1
KR_6692677740,420,0,55,9,-3,-1,3,4,3,8,5,-6,0,6,2,5,3,-1,0,1,0,-5,8,-3,4,1,1,0,0,0,0,1,-1,0,1
KR_6761669239,420,3,-14,56,5,1,3,2,2,3,1,1,3,2,1,1,0,0,0,0,0,6,-105,0,3,3,1,0,0,1,1,0,1,5,1
KR_6722031232,420,1,11,9,5,2,4,2,1,4,3,0,3,3,-1,1,2,3,4,1,1,7,14,15,6,21,-17,0,1,1,1,1,1,1,1
KR_6751909096,420,2,-40,38,8,3,3,0,-1,2,3,3,4,1,0,3,3,3,4,1,0,2,5,1,3,4,-8,0,-1,0,1,-1,-1,0,1
KR_6751318415,440,4,10,6,9,2,2,0,-3,1,4,0,2,2,7,8,1,3,3,0,4,22,-22,6,4,10,-6,0,2,1,1,1,1,6,1
KR_6677066967,440,5,48,26,13,5,5,0,4,5,1,3,3,0,-1,2,3,2,4,2,0,6,-3,-3,5,2,0,0,2,-1,1,1,1,1,1
KR_6742041259,420,3,42,-20,6,-2,1,3,3,4,1,0,2,2,5,5,0,0,0,0,0,0,8,-1,6,5,4,0,1,1,1,1,1,3,1
KR_6749062472,420,4,32,36,12,5,6,1,1,3,2,7,8,1,-1,2,3,0,2,2,0,7,12,1,1,2,1,0,0,1,1,1,-1,5,1
KR_6762145960,420,4,88,-5,4,-1,2,3,5,6,1,1,5,4,2,8,6,-3,0,3,0,4,2,3,4,7,-1,0,2,0,0,1,-1,0,1
KR_6658056122,440,-3,10,-48,0,2,2,0,-4,0,4,-2,0,2,2,7,5,2,3,1,1,5,45,-4,4,0,-1,0,0,-1,-1,1,1,3,1
KR_6650993201,420,0,31,-8,5,1,2,1,1,2,1,2,3,1,0,3,3,1,2,1,0,2,-18,-2,5,3,23,0,1,0,1,1,-1,0,1
KR_6731889567,420,2,59,24,4,2,3,1,0,2,2,2,3,1,0,1,1,0,0,0,0,3,7,0,4,4,0,0,0,1,1,1,1,2,1
KR_6745169941,420,3,46,15,2,6,6,0,-3,3,6,-1,0,1,-2,3,5,2,2,0,0,6,1,0,5,5,1,0,0,1,1,1,1,5,1
KR_6665698965,420,1,51,-8,2,-3,1,4,-1,2,3,2,2,0,3,4,1,1,2,1,0,6,339,-3,6,3,1,0,1,1,1,-1,-1,4,1
KR_6759576612,440,5,107,28,6,5,8,3,0,1,1,-2,2,4,3,6,3,0,4,4,0,4,-5,-4,6,2,0,0,1,1,0,1,1,3,1
KR_6764170699,420,1,-33,-20,-3,1,1,0,0,2,2,-4,3,7,0,3,3,0,2,2,0,2,-83,-3,6,3,2,0,-1,1,-1,-1,-1,2,1
KR_6705211144,420,-4,-39,7,8,-1,0,1,4,7,3,3,5,2,2,2,0,0,0,0,0,4,-7,-4,7,3,5,0,0,1,0,1,1,1,1
KR_6764893395,420,0,51,-25,-2,3,4,1,0,1,1,0,4,4,-5,0,5,0,0,0,0,-4,44,4,4,8,-25,0,2,1,1,1,1,5,1
KR_6765640980,420,4,34,31,2,1,5,4,4,7,3,-3,1,4,2,2,0,-2,0,2,-1,8,-245,1,2,3,4,0,0,0,1,1,1,0,1
KR_6765821725,420,-6,14,36,-3,1,1,0,-2,4,6,-1,2,3,0,2,2,-1,1,2,0,-2,-9,-1,3,2,-1,0,0,1,-1,-1,1,2,1
KR_6757809295,440,2,8,4,6,2,2,0,1,3,2,0,1,1,1,2,1,2,2,0,0,1,-290,3,5,8,-3,0,0,1,-1,0,1,3,1
KR_6761607047,440,1,90,31,-1,0,0,0,1,3,2,0,1,1,-3,1,4,1,1,0,-1,-6,-45,-1,7,6,2,0,0,1,1,0,-1,3,1
KR_6695001701,420,-4,-5,-44,-7,-2,1,3,-3,2,5,-3,1,4,6,8,2,-5,1,6,0,0,-13,4,3,7,5,0,-2,1,-1,-1,-1,5,1
KR_6767140728,420,0,25,-12,2,1,3,2,1,2,1,0,0,0,0,2,2,0,1,1,0,3,6,3,6,9,-2,0,0,-1,1,0,1,5,1
KR_6767876790,420,1,18,0,0,3,3,0,1,1,0,-1,4,5,-3,1,4,0,1,1,1,0,33,4,2,6,-5,0,0,-1,-1,0,1,1,1
KR_6746323481,420,2,56,1,9,1,3,2,5,5,0,0,6,6,4,4,0,-1,0,1,0,6,2,2,3,5,2,0,1,-1,-1,1,-1,5,1
KR_6763758810,420,3,98,-1,11,6,6,0,2,6,4,2,4,2,-1,0,1,2,2,0,0,4,-7,0,8,8,2,0,1,0,1,1,1,0,1
KR_6728183000,420,3,60,3,7,-3,1,4,1,1,0,0,1,1,7,9,2,2,3,1,0,10,140,1,5,6,1,0,1,1,-1,1,1,2,1
KR_6753418065,440,6,80,20,14,3,4,1,6,7,1,5,6,1,-2,2,4,2,3,1,0,18,3,0,5,5,-4,0,1,1,1,1,-1,3,1
KR_6730512979,440,4,61,-10,11,-2,0,2,1,3,2,6,7,1,4,6,2,2,2,0,0,11,0,2,3,5,1,0,2,1,1,1,-1,1,1
KR_6734378746,440,3,32,28,1,1,5,4,-1,3,4,-4,0,4,-1,4,5,6,6,0,0,-7,0,-3,4,1,0,0,1,0,1,1,1,0,1
KR_6768696691,420,4,40,28,13,2,3,1,4,4,0,-1,0,1,5,8,3,3,4,1,0,12,5,1,3,4,-2,0,3,1,1,1,1,2,1
KR_6676845857,420,2,1,-35,8,2,2,0,4,5,1,1,4,3,2,4,2,-1,0,1,0,10,-305,6,2,8,-4,0,1,1,-1,1,1,6,1
KR_6766810262,420,4,71,32,7,-1,0,1,1,2,1,1,1,0,3,3,0,3,3,0,1,9,-22,-1,6,5,-1,0,1,1,1,1,1,6,1
KR_6737009757,420,1,53,8,4,3,5,2,4,5,1,0,2,2,-5,0,5,2,2,0,0,-2,139,1,4,5,-3,0,1,1,1,1,1,6,1
KR_6712865231,420,-1,-25,20,-2,-8,0,8,2,6,4,5,8,3,-1,3,4,0,0,0,-1,-4,9,-5,8,3,3,0,-1,1,-1,-1,-1,5,1
KR_6769172250,440,3,0,32,10,-3,1,4,9,10,1,0,2,2,4,5,1,0,1,1,0,13,116,1,3,4,1,0,0,1,1,0,-1,6,1
KR_6743059006,420,3,-44,-7,7,0,1,1,1,2,1,-3,0,3,6,6,0,3,4,1,0,9,8,-1,7,6,0,0,1,-1,-1,1,-1,1,1
KR_6767780415,420,4,35,-23,14,2,2,0,5,8,3,-2,0,2,5,6,1,4,5,1,0,17,-13,4,1,5,1,0,2,1,1,1,-1,1,1
KR_6676977799,440,3,124,4,5,4,4,0,-2,1,3,4,6,2,-4,0,4,3,3,0,0,-3,-4,1,1,2,2,0,0,-1,1,1,1,6,1
KR_6757387159,420,2,71,-35,9,1,4,3,5,6,1,0,3,3,3,3,0,0,1,1,0,12,41,-1,6,5,-5,0,2,-1,1,1,1,6,1
KR_6549722133,420,0,46,29,3,1,1,0,1,3,2,1,2,1,0,2,2,0,3,3,0,1,4,2,2,4,3,0,1,1,1,1,1,4,1
KR_6702631973,420,7,73,0,18,6,6,0,0,2,2,7,7,0,2,4,2,3,3,0,1,12,-22,0,3,3,6,0,2,1,1,1,1,6,1
KR_6732264870,420,1,-45,60,0,-1,1,2,-1,2,3,7,9,2,-5,1,6,0,0,0,0,-8,4,2,5,7,0,0,-1,1,1,-1,-1,4,1
KR_6695509558,440,4,-24,10,3,-2,0,2,4,6,2,-3,0,3,6,6,0,-2,0,2,-1,7,-18,3,5,8,6,0,1,-1,0,1,-1,2,1
KR_6761277126,440,-1,40,-6,-9,-2,0,2,-2,3,5,-1,0,1,-1,1,2,-3,1,4,-1,-12,-6,2,4,6,3,0,0,-1,-1,0,-1,2,1
KR_6743501726,440,0,-51,8,-3,0,2,2,-3,0,3,0,4,4,-1,2,3,1,2,1,2,-3,3,4,2,6,-8,0,0,1,-1,0,1,5,1
KR_6746047349,420,4,60,24,11,5,7,2,4,6,2,5,7,2,-4,2,6,1,3,2,0,7,9,-4,6,2,0,0,2,1,1,1,1,3,1
KR_6761776075,440,0,87,-3,-4,4,4,0,1,3,2,6,7,1,-6,1,7,-9,0,9,-1,-8,-4,-1,5,4,1,0,1,-1,-1,1,-1,6,1
KR_6758408173,420,0,30,-4,5,4,6,2,4,4,0,3,3,0,-6,1,7,0,0,0,0,-5,4,4,0,4,2,0,1,1,1,1,1,4,1
KR_6761445290,440,0,19,-24,-10,-3,5,8,-3,1,4,-2,0,2,-2,0,2,0,4,4,-1,0,-130,2,2,4,-16,0,-2,1,-1,-1,-1,1,1
KR_6582997135,420,8,105,12,16,2,2,0,2,3,1,5,7,2,5,5,0,2,2,0,0,7,-232,-2,6,4,5,0,1,1,1,1,1,6,1
KR_6689637685,420,4,31,1,12,3,4,1,2,3,1,-1,1,2,1,1,0,7,8,1,0,12,-109,2,4,6,6,0,1,1,1,1,1,4,1
KR_6753535926,420,2,-14,-14,3,2,2,0,-2,2,4,-1,1,2,5,6,1,-1,1,2,1,6,-24,-5,8,3,1,0,0,-1,-1,0,1,4,1
KR_6753558773,420,1,-16,3,5,-1,2,3,2,3,1,2,5,3,4,5,1,-2,0,2,0,5,7,2,5,7,3,0,-1,-1,-1,1,-1,6,1
KR_6761567447,420,1,30,-12,5,0,2,2,-1,1,2,0,2,2,5,6,1,1,3,2,0,8,-1,0,4,4,0,0,1,1,1,1,1,5,1
KR_6751953734,420,0,-9,8,5,-1,0,1,-1,1,2,0,2,2,4,6,2,3,3,0,1,10,3,-2,7,5,2,0,0,1,-1,1,1,1,1
KR_6762586172,420,0,38,-25,0,0,0,0,6,7,1,-5,4,9,0,5,5,-1,2,3,0,3,9,2,1,3,-6,0,1,-1,1,1,1,1,1
KR_6634855809,420,5,51,23,14,2,2,0,7,9,2,3,5,2,1,3,2,1,2,1,2,8,150,4,1,5,-7,0,1,1,1,1,-1,5,1
KR_6623673025,440,1,26,-13,3,1,3,2,2,5,3,2,3,1,0,0,0,-2,0,2,0,0,10,0,4,4,-4,0,0,1,1,0,1,2,1
KR_6693713720,420,0,39,3,2,2,5,3,-2,2,4,2,2,0,2,3,1,-2,0,2,0,-2,17,-2,6,4,-2,0,2,1,0,1,-1,6,1
KR_6754500971,440,-1,-2,2,-1,-5,0,5,3,7,4,0,1,1,-1,1,2,2,4,2,0,8,50,0,4,4,-34,0,-1,-1,-1,-1,-1,6,1
KR_6760769637,420,6,75,55,8,2,4,2,2,3,1,-1,3,4,1,2,1,4,4,0,0,10,-3,-5,7,2,3,0,3,1,1,1,-1,2,1
KR_6764936710,420,2,-10,-42,-1,1,1,0,-3,1,4,2,4,2,-2,0,2,1,1,0,0,2,185,-3,6,3,5,0,0,0,0,0,1,0,1
KR_6766753913,440,1,10,15,5,3,7,4,1,3,2,2,2,0,0,3,3,-1,2,3,1,-7,0,3,4,7,2,0,1,1,1,1,1,4,1
KR_6655910401,420,3,36,-8,14,2,2,0,4,5,1,4,5,1,2,4,2,2,2,0,2,18,7,4,1,5,2,0,2,1,0,1,1,1,1
KR_6766734332,420,-1,-40,-17,-5,1,3,2,-2,2,4,-2,0,2,-3,0,3,1,2,1,0,-5,39,1,3,4,-9,0,-1,-1,-1,-1,-1,6,1
KR_6707871861,420,5,139,45,8,2,2,0,-5,2,7,4,4,0,4,7,3,3,3,0,3,9,-3,4,0,4,0,0,3,1,1,1,1,3,1
KR_6749336257,420,2,-4,55,2,0,1,1,2,6,4,3,7,4,-2,0,2,-1,0,1,0,-6,5,4,2,6,-4,0,1,-1,-1,1,1,3,1
KR_6761665764,420,5,2,45,7,5,6,1,-1,1,2,1,3,2,3,5,2,-1,0,1,-2,-3,-5,-2,6,4,3,0,1,-1,1,1,-1,2,1
KR_6749868909,420,1,32,8,-5,4,4,0,-4,1,5,-2,1,3,-3,1,4,0,2,2,-2,-3,10,1,5,6,-7,0,0,0,1,0,-1,0,1
KR_6751530926,420,1,-55,4,5,-6,0,6,4,5,1,1,1,0,2,3,1,4,7,3,0,7,228,-2,5,3,1,0,-1,1,-1,-1,1,1,1
KR_6768804451,420,-3,46,-40,-5,-3,2,5,0,3,3,-2,2,4,0,0,0,0,0,0,0,-1,-14,-1,4,3,1,0,-2,-1,-1,-1,-1,3,1
KR_6764528922,420,4,123,12,7,3,3,0,1,4,3,2,2,0,0,2,2,1,1,0,0,-2,-27,0,5,5,25,0,2,-1,1,1,1,3,1
KR_6690144907,420,-1,51,6,-4,-1,0,1,-6,1,7,-2,3,5,4,4,0,1,2,1,0,-3,-8,-6,8,2,4,0,2,-1,1,1,1,2,1
KR_6755425433,440,3,52,28,1,0,3,3,5,6,1,4,5,1,-6,0,6,-2,2,4,0,-5,-9,-3,6,3,5,0,1,1,-1,1,-1,3,1
KR_6768661999,420,1,49,-12,4,0,1,1,1,2,1,-2,1,3,4,6,2,1,1,0,1,5,4,1,2,3,-2,0,0,-1,1,0,1,1,1
KR_6655741146,420,3,69,8,10,0,2,2,0,2,2,6,6,0,4,4,0,0,0,0,0,7,3,2,3,5,-2,0,0,1,-1,1,1,5,1
KR_6721980304,420,0,77,32,1,-1,0,1,1,3,2,2,4,2,-1,1,2,0,0,0,3,4,29,-2,7,5,3,0,1,-1,1,1,1,3,1
KR_6751335751,420,2,16,12,9,0,3,3,2,3,1,2,5,3,3,4,1,2,2,0,0,11,-4,3,1,4,1,0,1,1,1,1,1,4,1
KR_6726668754,420,4,44,24,5,4,4,0,5,7,2,-1,3,4,-1,1,2,-2,0,2,0,0,-1,-2,6,4,2,0,2,1,1,1,-1,1,1
KR_6750330073,420,2,52,-6,3,0,3,3,-1,1,2,6,7,1,0,2,2,-2,0,2,0,-4,15,3,2,5,-1,0,0,1,-1,1,-1,4,1
KR_6689074642,420,3,12,12,0,-1,1,2,4,7,3,-2,0,2,-2,1,3,1,1,0,0,-1,-9,-5,9,4,7,0,1,1,1,1,-1,1,1
KR_6753676855,420,3,36,24,15,3,4,1,0,3,3,8,8,0,3,3,0,1,1,0,0,12,138,1,3,4,2,0,0,1,-1,0,-1,3,1
KR_6761183763,440,2,-14,-4,11,-1,2,3,1,5,4,6,6,0,3,5,2,2,4,2,0,8,3,2,1,3,3,0,0,1,1,1,1,3,1
KR_6628350364,420,2,-34,16,3,-4,1,5,1,4,3,2,3,1,3,7,4,1,2,1,0,4,6,0,6,6,-4,0,0,-1,1,0,1,1,1
KR_6676196484,420,-2,54,21,-2,-5,1,6,4,4,0,0,0,0,-1,0,1,0,0,0,0,0,23,5,2,7,-2,0,-1,1,-1,-1,-1,6,1
KR_6748127326,420,2,68,34,9,2,4,2,-1,2,3,5,6,1,2,2,0,1,1,0,0,10,-16,-1,6,5,1,0,0,1,1,1,1,4,1
KR_6696013632,420,1,-18,4,7,-3,2,5,4,4,0,2,2,0,3,6,3,1,1,0,0,12,-8,-2,6,4,3,0,0,1,-1,1,1,1,1
KR_6762336683,420,-1,-33,-24,-5,0,1,1,-1,1,2,7,9,2,-5,2,7,-6,0,6,0,-1,-17,4,1,5,0,0,-2,-1,0,-1,-1,2,1
KR_6760485233,420,4,83,32,15,5,5,0,4,4,0,6,9,3,-1,2,3,1,1,0,0,11,12,2,2,4,1,0,1,1,1,1,-1,1,1
KR_6734563931,420,-1,17,-13,-3,-2,0,2,-1,3,4,-3,3,6,2,2,0,1,1,0,1,-2,14,-1,5,4,1,0,0,1,-1,1,1,2,1
KR_6715857111,420,5,99,23,14,2,3,1,5,6,1,3,4,1,2,4,2,2,4,2,0,9,-63,4,6,10,-22,0,4,1,1,1,1,1,1
KR_6764125896,420,1,-54,-12,-3,3,3,0,-4,0,4,-1,0,1,-1,4,5,0,0,0,0,-8,23,-1,4,3,3,0,1,-1,1,1,-1,1,1
KR_6749787971,420,2,84,9,6,6,6,0,5,8,3,-4,1,5,1,4,3,-2,1,3,-1,11,-7,-1,5,4,0,0,0,-1,-1,1,1,2,1
KR_6712359694,420,0,13,4,-1,-1,0,1,1,3,2,-2,2,4,1,4,3,0,1,1,0,-6,5,4,2,6,-3,0,1,-1,1,1,1,6,1
KR_6694647800,420,-6,-61,-19,-7,-2,0,2,-2,0,2,-2,2,4,0,2,2,-1,1,2,0,-2,5,-3,6,3,0,0,-2,-1,-1,-1,-1,4,1
KR_6760824447,440,4,17,0,11,-2,4,6,0,3,3,0,0,0,9,9,0,4,4,0,0,8,-26,-1,3,2,3,0,0,1,-1,1,-1,1,1
KR_6712874156,420,1,-6,8,4,-1,2,3,3,6,3,6,6,0,-4,2,6,0,1,1,0,3,-6,0,3,3,2,0,1,0,1,1,-1,0,1
KR_6703430132,420,1,9,-17,6,0,2,2,1,4,3,5,5,0,1,2,1,-1,0,1,0,14,-45,4,4,8,26,0,-1,1,1,-1,1,5,1
KR_6732366616,420,3,9,8,7,3,5,2,2,3,1,-1,0,1,2,2,0,1,2,1,0,4,-49,2,2,4,29,0,1,-1,0,1,1,3,1
KR_6671787989,420,1,39,-24,8,2,3,1,1,4,3,4,4,0,0,1,1,1,1,0,0,12,-4,0,6,6,3,0,-1,-1,-1,-1,1,1,1
KR_6764988038,420,2,-29,-4,8,1,1,0,8,8,0,2,4,2,-2,0,2,-1,1,2,0,1,92,2,2,4,1,0,1,1,1,1,1,5,1
KR_6650871573,420,2,41,-21,6,0,0,0,7,8,1,-3,0,3,3,6,3,-1,2,3,0,7,7,1,5,6,5,0,-1,1,-1,-1,-1,5,1
KR_6765324014,420,2,31,-7,14,1,2,1,-2,2,4,1,4,3,13,13,0,1,1,0,0,12,-5,2,2,4,5,0,2,1,-1,1,1,4,1
KR_6686596157,440,3,4,4,4,2,2,0,0,2,2,1,3,2,-1,1,2,2,4,2,0,0,-1,4,3,7,0,0,1,-1,-1,1,-1,1,1
KR_6730482961,420,2,33,0,9,1,3,2,-1,2,3,2,7,5,6,9,3,1,1,0,1,-2,154,-2,8,6,-1,0,1,1,1,1,1,3,1
KR_6740876514,420,2,-5,35,0,-3,1,4,1,3,2,-2,1,3,4,5,1,0,0,0,0,1,24,0,6,6,1,0,-1,1,-1,-1,1,6,1
KR_6763106923,420,3,-52,-20,5,-1,3,4,3,3,0,1,3,2,2,3,1,0,1,1,0,11,4,2,2,4,2,0,0,-1,1,0,-1,2,1
KR_6738530985,420,2,46,-25,10,5,5,0,2,4,2,5,5,0,-2,2,4,0,0,0,0,4,-6,3,6,9,-1,0,1,1,-1,1,1,5,1
KR_6620120775,420,3,85,28,3,-4,2,6,3,4,1,3,3,0,0,1,1,1,1,0,0,3,13,-1,7,6,2,0,1,-1,1,1,1,1,1
KR_6761203779,420,5,38,5,6,0,3,3,2,3,1,6,6,0,-3,1,4,1,2,1,0,5,1,1,7,8,3,0,0,-1,-1,0,-1,5,1
KR_6763133553,420,3,29,13,7,-1,2,3,3,3,0,2,5,3,0,1,1,3,4,1,0,7,-28,0,2,2,5,0,1,1,-1,1,1,4,1
KR_6766155173,420,4,-20,8,6,-2,0,2,2,3,1,3,6,3,-1,3,4,4,5,1,-1,10,-11,-2,4,2,2,0,1,1,-1,1,-1,5,1
KR_6757688123,420,-4,-63,-1,-9,-5,3,8,-1,3,4,-1,2,3,-1,1,2,-1,2,3,1,-9,0,-5,10,5,0,0,-2,-1,-1,-1,1,2,1
KR_6761852153,420,4,-35,-8,13,2,2,0,6,6,0,2,3,1,3,4,1,0,1,1,1,20,3,4,5,9,-4,0,0,1,1,1,1,4,1
KR_6748961090,420,4,-20,3,9,1,2,1,4,5,1,3,4,1,2,3,1,-1,2,3,0,1,3,0,3,3,-2,0,0,1,1,0,1,4,1
KR_6763540534,420,5,41,12,9,4,4,0,3,4,1,0,2,2,1,2,1,1,1,0,0,3,6,5,2,7,0,0,2,1,1,1,1,5,1
KR_6758371577,420,0,-31,16,9,10,10,0,-1,3,4,-2,1,3,4,7,3,-2,0,2,0,11,-4,-1,4,3,3,0,0,1,-1,1,1,4,1
KR_6732788712,420,9,102,34,14,-4,1,5,1,4,3,10,11,1,3,5,2,4,4,0,1,19,-30,-3,4,1,2,0,4,-1,1,1,1,6,1
KR_6755184937,420,-1,60,5,-1,0,3,3,-4,1,5,2,2,0,2,6,4,-1,0,1,-2,-8,4,2,4,6,1,0,1,1,-1,1,-1,4,1
KR_6759032446,420,5,3,12,2,6,6,0,1,1,0,0,2,2,-5,1,6,0,1,1,0,0,-1,-4,7,3,-4,0,-1,1,-1,-1,-1,1,1
KR_6690589973,420,-1,16,3,1,1,1,0,-2,2,4,-1,3,4,2,3,1,1,1,0,0,4,-87,-8,11,3,3,0,0,1,0,0,1,3,1
KR_6726506516,420,4,71,-4,11,1,3,2,4,6,2,0,4,4,8,9,1,-2,0,2,0,10,3,0,3,3,1,0,2,0,-1,1,1,0,1
KR_6741233043,420,-1,9,-4,-4,-4,0,4,0,3,3,2,3,1,-4,1,5,2,2,0,0,-4,-1,1,4,5,3,0,0,1,-1,-1,1,4,1
KR_6748184609,420,0,-22,-4,5,-1,1,2,0,3,3,0,2,2,5,6,1,1,1,0,0,6,-80,-8,8,0,-1,0,0,0,1,0,1,0,1
KR_6753727285,420,1,22,-40,-1,0,2,2,0,3,3,-3,2,5,2,5,3,0,1,1,0,5,8,2,2,4,-1,0,1,-1,0,1,-1,1,1
KR_6761334661,420,2,65,-16,2,2,3,1,-2,0,2,1,2,1,0,3,3,1,1,0,0,3,-2,2,5,7,1,0,0,0,-1,0,1,0,1
KR_6752933936,420,-1,19,0,-6,1,1,0,-4,1,5,0,1,1,-3,2,5,0,2,2,-2,-18,34,-3,6,3,-20,0,2,1,1,1,-1,5,1
KR_6634679999,420,1,23,20,4,-2,0,2,1,6,5,4,5,1,0,2,2,1,1,0,0,1,-8,-2,6,4,2,0,-1,1,-1,-1,1,3,1
KR_6768752454,440,3,60,13,5,3,6,3,2,3,1,2,3,1,0,2,2,-2,1,3,0,-7,-6,-1,6,5,0,0,1,-1,1,1,1,1,1
KR_6760194197,420,5,75,32,8,5,6,1,-3,1,4,5,6,1,0,1,1,1,1,0,0,2,5,1,6,7,5,0,0,0,-1,-1,1,0,1
KR_6679661215,440,3,-17,8,12,3,5,2,-1,1,2,-2,1,3,4,7,3,8,9,1,0,13,10,3,3,6,-3,0,1,1,1,1,-1,2,1
KR_6767963546,420,-2,-74,13,-1,1,4,3,-2,1,3,0,0,0,2,5,3,-2,0,2,-2,-1,-3,-7,10,3,3,0,-2,0,-1,-1,-1,0,1
KR_6759816343,420,2,43,8,1,2,2,0,-2,2,4,3,5,2,-1,1,2,-1,0,1,0,-1,6,3,2,5,-4,0,-1,1,-1,-1,1,3,1
KR_6750652888,420,0,-65,16,4,0,3,3,0,2,2,6,6,0,0,2,2,-2,1,3,-1,8,3,0,6,6,2,0,0,1,0,-1,-1,1,1
KR_6630763786,420,1,87,5,12,-1,0,1,7,8,1,1,2,1,3,3,0,2,2,0,0,17,9,4,2,6,-3,0,1,1,1,1,1,4,1
KR_6765903490,420,1,58,-4,5,3,4,1,-2,0,2,2,2,0,2,2,0,0,0,0,0,4,5,7,1,8,-1,0,1,1,1,1,1,5,1
KR_6684718508,420,-2,-35,23,-7,-2,0,2,1,4,3,-4,1,5,-1,2,3,-1,0,1,0,-3,0,5,4,9,-2,0,-1,1,-1,-1,1,3,1
KR_6768002518,420,4,21,16,7,4,4,0,4,4,0,-4,2,6,0,1,1,3,4,1,0,11,21,-1,4,3,-4,0,0,-1,-1,0,-1,4,1
KR_6762233796,420,4,39,16,6,-3,2,5,-1,4,5,4,6,2,3,5,2,3,5,2,-2,-8,13,0,3,3,0,0,1,1,1,1,-1,2,1
KR_6613972566,420,2,24,28,5,3,5,2,3,6,3,1,3,2,-2,2,4,0,1,1,1,2,-1,0,5,5,8,0,2,-1,1,1,1,6,1
KR_6662053238,420,3,-7,15,13,7,7,0,3,4,1,0,1,1,4,5,1,-1,0,1,0,7,-4,-3,7,4,1,0,1,1,-1,1,1,4,1
KR_6759637648,420,-2,-50,12,2,-2,0,2,3,3,0,-1,1,2,2,6,4,0,3,3,1,6,110,2,2,4,1,0,1,0,1,1,1,0,1
KR_6651059557,420,1,-48,16,5,1,2,1,2,3,1,3,3,0,-3,1,4,2,2,0,0,2,29,4,4,8,-5,0,-1,1,1,-1,1,4,1
KR_6697879393,420,3,70,7,-3,1,1,0,0,2,2,2,7,5,-7,2,9,1,1,0,-1,-2,-32,4,3,7,4,0,-1,1,-1,1,-1,4,1
KR_6761894275,420,-3,-32,-46,0,-3,2,5,2,6,4,1,1,0,2,6,4,-2,0,2,-1,4,5,1,5,6,-2,0,-2,1,-1,-1,-1,6,1
KR_6762974649,420,1,23,-12,3,-4,0,4,1,2,1,1,4,3,3,4,1,2,3,1,0,8,35,-4,7,3,-12,0,-1,1,-1,-1,1,1,1
KR_6724195027,420,1,49,0,8,7,7,0,1,4,3,1,3,2,-1,4,5,0,2,2,1,-4,22,3,1,4,4,0,2,1,1,1,1,2,1
KR_6722830594,440,0,-20,-12,-1,1,1,0,0,1,1,4,4,0,-3,0,3,-3,1,4,0,-4,11,1,4,5,1,0,0,-1,1,1,-1,1,1
KR_6756672076,420,-1,-47,31,4,0,3,3,0,3,3,-2,2,4,6,6,0,0,1,1,2,16,12,7,4,11,0,0,0,1,-1,-1,1,1,1
KR_6752895550,420,2,-26,-9,5,1,2,1,1,1,0,1,2,1,2,4,2,0,1,1,0,5,113,1,5,6,1,0,0,-1,1,0,-1,1,1
KR_6729776434,420,4,105,32,11,0,2,2,-3,2,5,4,7,3,6,8,2,4,4,0,0,6,1,1,4,5,-3,0,2,1,1,1,1,6,1
KR_6765922544,420,0,-19,7,-5,-1,1,2,2,4,2,-4,2,6,-4,1,5,2,2,0,-1,-4,36,-2,7,5,-21,0,0,1,-1,0,-1,4,1
KR_6756149110,420,-1,10,0,-2,0,2,2,2,2,0,3,4,1,-5,2,7,-2,0,2,0,0,-4,3,1,4,2,0,-1,1,-1,-1,-1,3,1
KR_6651303272,420,-1,25,1,5,3,6,3,-2,1,3,-1,0,1,6,7,1,-1,0,1,0,0,323,0,4,4,-3,0,2,1,1,1,-1,4,1
KR_6753909433,420,1,25,8,8,0,3,3,8,10,2,4,6,2,-6,1,7,2,2,0,0,10,0,1,6,7,1,0,0,1,1,1,-1,1,1
KR_6766764313,420,9,96,55,16,4,4,0,7,8,1,3,4,1,2,4,2,0,0,0,0,5,19,0,4,4,1,0,2,1,1,1,1,5,1
KR_6722251319,420,-4,1,21,-5,0,1,1,-1,1,2,-1,2,3,-1,2,3,-2,0,2,0,-8,-20,-2,6,4,9,0,0,-1,1,-1,-1,2,1
KR_6733013876,420,3,72,-4,9,2,4,2,-2,2,4,2,3,1,3,5,2,4,4,0,0,9,-5,-5,6,1,0,0,1,1,-1,1,1,3,1
KR_6738320986,420,0,-32,18,5,5,5,0,0,5,5,-1,1,2,2,5,3,-1,0,1,0,2,-2,-1,6,5,0,0,-2,1,1,-1,1,5,1
KR_6746990206,440,2,-33,22,3,0,4,4,4,6,2,3,4,1,-5,3,8,1,2,1,1,0,-7,-5,5,0,-3,0,0,0,-1,-1,1,0,1
KR_6738042578,420,-3,-40,-3,-5,-1,2,3,-3,0,3,-1,3,4,0,2,2,0,1,1,0,0,11,2,4,6,-6,0,0,-1,-1,-1,1,4,1
KR_6751044296,440,3,-34,-7,5,3,3,0,1,3,2,-2,1,3,1,3,2,2,2,0,0,9,11,0,4,4,-1,0,-1,0,-1,-1,1,0,1
KR_6768696009,420,0,7,17,-3,-1,3,4,-2,1,3,-3,0,3,-1,3,4,4,4,0,0,-7,106,-2,8,6,-2,0,-1,1,-1,-1,-1,1,1
KR_6727670958,420,6,48,-8,8,0,4,4,3,4,1,6,8,2,1,5,4,-2,1,3,0,12,31,4,4,8,-2,0,1,1,1,1,1,2,1
KR_6729990769,440,1,15,8,3,-1,2,3,-2,2,4,0,1,1,5,8,3,1,2,1,0,14,29,6,1,7,3,0,1,0,0,1,1,0,1
KR_6765806330,420,0,22,1,1,-1,0,1,1,3,2,1,4,3,3,3,0,-3,0,3,0,9,-17,0,5,5,3,0,0,1,-1,0,-1,1,1
KR_6645202439,420,-3,-58,-33,-5,-1,2,3,6,9,3,-1,0,1,-5,2,7,-4,0,4,0,6,111,2,2,4,3,0,0,1,0,0,-1,6,1
KR_6764359049,420,0,-60,9,0,2,2,0,2,3,1,-1,2,3,0,0,0,-3,2,5,-1,-3,6,2,5,7,-1,0,0,0,0,0,-1,0,1
KR_6733506523,440,-1,-55,-8,0,2,4,2,3,3,0,-5,0,5,-1,2,3,1,2,1,0,-1,241,1,4,5,1,0,1,1,1,1,-1,1,1
KR_6764275900,420,2,51,2,3,-1,1,2,2,4,2,0,3,3,2,3,1,0,0,0,0,4,-103,-1,8,7,-4,0,0,-1,1,0,-1,1,1
KR_6767737405,420,4,62,-5,5,2,3,1,-5,0,5,3,3,0,3,5,2,2,2,0,1,9,-80,-5,6,1,5,0,2,-1,1,1,1,1,1
KR_6764540743,420,8,119,8,10,1,4,3,1,2,1,3,4,1,5,6,1,0,1,1,0,13,0,4,4,8,0,0,0,1,-1,1,-1,4,1
KR_6757378646,420,1,24,-5,5,2,2,0,5,6,1,0,3,3,-2,0,2,0,0,0,0,1,-17,-4,7,3,11,0,1,1,1,1,-1,2,1
KR_6759509157,440,4,48,-1,15,5,5,0,0,3,3,-1,2,3,8,9,1,3,3,0,0,13,0,2,2,4,0,0,1,1,1,1,1,5,1
KR_6754334358,420,0,75,-20,0,-1,0,1,2,2,0,1,3,2,-2,2,4,0,0,0,0,-4,-123,1,4,5,3,0,-1,-1,0,-1,1,3,1
KR_6728071315,420,1,36,-9,4,1,3,2,3,4,1,0,2,2,0,3,3,0,6,6,-1,8,-15,-2,7,5,3,0,0,1,-1,1,-1,3,1
KR_6768715767,420,-1,10,-12,0,1,1,0,0,3,3,0,1,1,0,3,3,-1,0,1,0,-4,-4,-1,6,5,3,0,0,1,1,0,1,5,1
KR_6612569047,420,3,-2,0,6,-1,1,2,3,3,0,1,3,2,4,6,2,-1,0,1,-2,13,-3,0,5,5,3,0,2,1,-1,1,-1,4,1
KR_6696650180,420,1,29,0,3,1,1,0,3,5,2,0,0,0,3,3,0,-4,0,4,0,6,-85,3,1,4,0,0,0,-1,1,0,1,1,1
KR_6745889410,420,0,9,14,3,-2,1,3,6,8,2,0,3,3,-1,4,5,0,0,0,0,5,-9,-3,4,1,1,0,0,1,1,-1,-1,3,1
KR_6698508891,420,4,58,-4,6,6,6,0,-2,1,3,-3,0,3,4,5,1,1,2,1,0,3,4,-2,5,3,-1,0,0,1,-1,1,1,4,1
KR_6730958114,420,-1,42,-3,2,3,4,1,-1,3,4,-1,1,2,4,5,1,-3,1,4,0,11,-29,0,7,7,30,0,0,-1,-1,0,1,4,1
KR_6763670816,420,-3,-59,0,3,2,4,2,3,4,1,2,5,3,-5,0,5,1,3,2,-1,4,155,1,5,6,-3,0,1,0,1,1,-1,0,1
KR_6693549506,420,2,56,-16,6,5,5,0,-2,2,4,1,3,2,0,1,1,2,3,1,0,-1,105,1,2,3,-9,0,1,1,-1,1,-1,4,1
KR_6667570384,420,6,79,3,10,3,3,0,0,2,2,4,7,3,2,3,1,1,2,1,0,7,43,3,5,8,-1,0,1,1,-1,1,1,4,1
KR_6608378580,420,2,21,33,9,2,3,1,4,4,0,3,3,0,0,0,0,0,0,0,0,9,73,-2,6,4,-1,0,1,1,-1,1,1,2,1
KR_6758430428,420,4,118,-1,5,1,2,1,1,3,2,0,0,0,2,5,3,1,2,1,0,4,8,3,4,7,-1,0,0,-1,-1,1,-1,1,1
KR_6767922266,420,2,79,-23,4,-4,3,7,1,2,1,1,3,2,3,4,1,3,3,0,0,1,-2,2,4,6,4,0,2,1,-1,1,1,4,1
KR_6764610165,420,-1,74,16,-5,1,2,1,2,4,2,-2,0,2,-4,2,6,-2,0,2,-1,-14,11,2,5,7,3,0,0,-1,1,0,1,3,1
KR_6765517729,420,1,31,23,1,-4,0,4,2,2,0,2,2,0,3,3,0,-2,0,2,0,7,25,2,3,5,1,0,0,-1,-1,-1,1,2,1
KR_6752518046,420,-2,0,-8,-1,-1,1,2,1,2,1,1,4,3,-2,1,3,0,1,1,0,8,-12,-3,9,6,-3,0,0,1,-1,0,1,3,1
KR_6765530901,420,1,4,11,3,-3,1,4,1,5,4,7,7,0,1,4,3,-3,0,3,0,-5,-7,-3,6,3,4,0,1,1,1,1,1,4,1
KR_6594709995,420,-1,-15,-12,-5,-2,0,2,-5,1,6,1,1,0,0,2,2,1,2,1,0,-4,-2,1,4,5,3,0,1,1,-1,1,1,6,1
KR_6767213842,420,1,0,27,2,-2,0,2,1,1,0,2,3,1,1,1,0,0,0,0,0,3,117,-3,7,4,-2,0,0,1,1,0,1,4,1
KR_6761423821,440,2,77,-4,8,7,7,0,-1,0,1,1,4,3,2,5,3,-1,0,1,0,11,-140,3,1,4,3,0,0,1,0,1,1,2,1
KR_6724724976,420,-1,75,12,-5,2,3,1,-4,1,5,2,3,1,-1,1,2,-4,0,4,-1,-11,-4,6,3,9,-4,0,-1,0,0,-1,-1,0,1
KR_6763096049,420,4,-32,41,14,4,6,2,3,4,1,8,9,1,-5,0,5,4,5,1,4,9,-7,1,3,4,3,0,-1,1,1,-1,1,6,1
KR_6633841083,420,2,-15,11,5,-2,0,2,2,3,1,-3,0,3,8,9,1,0,0,0,0,6,-8,-1,7,6,5,0,1,1,-1,1,-1,5,1
KR_6748014783,440,4,-24,31,3,-2,1,3,2,2,0,-1,0,1,3,5,2,1,1,0,0,2,-2,0,6,6,-2,0,0,1,-1,-1,1,4,1
KR_6754478385,440,-1,-20,27,3,3,4,1,1,3,2,0,3,3,0,2,2,-1,2,3,2,5,-2,-1,6,5,-1,0,1,-1,1,1,1,4,1
KR_6586896109,420,2,-7,-18,4,-4,1,5,-1,5,6,1,2,1,5,5,0,3,3,0,1,10,-3,4,3,7,5,0,0,1,1,-1,1,6,1
KR_6694644995,420,2,-4,18,5,-7,0,7,9,9,0,0,2,2,2,6,4,1,2,1,3,17,0,4,3,7,-1,0,1,1,1,-1,1,3,1
KR_6765199783,420,3,27,34,2,-2,0,2,7,7,0,-2,0,2,-1,3,4,0,0,0,0,-2,11,4,3,7,-1,0,1,1,1,1,1,1,1
KR_6769037938,420,8,59,24,24,-1,1,2,8,12,4,7,8,1,5,6,1,5,5,0,0,22,168,4,1,5,2,0,3,1,1,1,1,5,1
KR_6746337769,420,1,44,-5,-5,0,2,2,-1,1,2,0,2,2,-1,3,4,-3,0,3,0,-9,2,0,6,6,-3,0,0,0,1,0,-1,0,1
KR_6766364600,420,0,-11,10,7,-5,0,5,5,7,2,1,3,2,4,5,1,2,2,0,0,14,8,2,3,5,-4,0,0,1,-1,-1,-1,2,1
KR_6663628419,420,1,-101,-32,5,-2,2,4,3,5,2,2,2,0,1,2,1,1,1,0,0,11,-4,2,2,4,1,0,-2,1,-1,-1,-1,3,1
KR_6639703735,420,-3,-23,-24,-5,-1,0,1,-3,0,3,0,3,3,0,2,2,-1,0,1,0,-4,4,-1,4,3,0,0,0,0,0,-1,1,0,1
KR_6769145937,420,7,2,32,12,4,4,0,5,5,0,3,3,0,1,4,3,-1,0,1,0,10,-15,-3,6,3,5,0,1,1,1,1,-1,1,1
KR_6624822816,420,0,76,28,5,6,8,2,-5,1,6,-3,1,4,5,7,2,2,3,1,-1,5,10,1,5,6,4,0,2,1,1,1,-1,3,1
KR_6748577440,420,2,62,16,-2,1,1,0,2,3,1,-2,1,3,0,1,1,-3,1,4,-1,-5,-2,-1,5,4,2,0,0,1,-1,0,-1,1,1
KR_6765868261,420,-1,-16,31,-3,2,3,1,-4,0,4,2,3,1,-1,2,3,-2,1,3,0,-8,-20,0,5,5,0,0,0,-1,1,0,1,4,1
KR_6768499805,420,0,84,4,-5,-2,0,2,-1,2,3,3,4,1,-1,3,4,-4,1,5,0,-10,14,1,5,6,-5,0,0,-1,-1,-1,-1,5,1
KR_6768141653,420,2,77,42,13,-3,2,5,10,10,0,7,8,1,0,6,6,-1,1,2,1,11,-12,0,2,2,8,0,3,1,1,1,1,6,1
KR_6652439987,440,6,78,22,5,-2,0,2,8,8,0,-1,1,2,-1,4,5,1,2,1,0,5,-5,1,3,4,4,0,1,1,0,1,1,4,1
KR_6730837313,440,1,-28,32,3,1,3,2,-2,0,2,5,6,1,4,6,2,-5,0,5,0,1,8,4,3,7,0,0,0,1,1,1,-1,4,1
KR_6727992085,420,1,-26,-8,1,3,4,1,2,4,2,-2,1,3,-2,1,3,0,2,2,0,-5,4,-1,5,4,1,0,0,-1,1,-1,-1,1,1
KR_6763296609,420,0,27,-24,-6,1,5,4,-3,0,3,-4,2,6,-1,6,7,1,1,0,-2,-6,6,-3,5,2,-4,0,-1,-1,-1,-1,-1,3,1
KR_6413783727,420,-1,-7,7,-4,-2,1,3,2,5,3,-2,2,4,-2,2,4,0,0,0,0,-8,61,-2,6,4,-30,0,-1,1,-1,-1,-1,6,1
KR_6765512168,420,3,-24,20,9,2,3,1,3,4,1,6,6,0,-2,0,2,0,0,0,0,1,-7,4,2,6,1,0,0,0,1,0,1,0,1
KR_6566305655,420,-2,1,-5,0,-3,1,4,5,5,0,-6,0,6,1,4,3,3,3,0,1,8,2,6,2,8,3,0,0,1,-1,-1,1,6,1
KR_6761896680,440,-3,-47,11,-9,-1,1,2,0,2,2,0,3,3,4,9,5,-12,0,12,0,-7,4,4,1,5,0,0,-3,-1,-1,-1,-1,2,1
KR_6765568682,440,0,-36,-30,0,2,5,3,1,4,3,-3,2,5,4,7,3,-4,2,6,1,2,-34,7,1,8,2,0,-1,-1,0,1,1,5,1
KR_6761815715,440,3,50,23,5,-2,0,2,1,3,2,3,4,1,4,5,1,-1,1,2,0,7,5,2,5,7,5,0,0,0,0,0,1,0,1
KR_6752741028,420,-1,-16,16,3,-1,2,3,1,2,1,0,2,2,4,5,1,-1,0,1,1,1,4,-1,2,1,1,0,0,-1,1,0,1,4,1
KR_6706649312,440,-1,-22,-5,-5,-2,4,6,-2,2,4,1,2,1,-2,1,3,0,0,0,-1,-5,0,-1,4,3,-3,0,0,-1,-1,0,1,5,1
KR_6668528770,420,3,25,20,5,3,4,1,2,5,3,1,2,1,-4,2,6,3,4,1,0,0,-9,-1,6,5,2,0,1,0,1,1,1,0,1
KR_6671069279,420,3,67,29,8,3,5,2,1,3,2,1,6,5,3,6,3,0,0,0,-1,-1,2,2,3,5,0,0,1,1,-1,-1,-1,2,1
KR_6686477162,440,0,-19,12,2,3,5,2,0,3,3,0,3,3,-6,1,7,5,5,0,0,-2,6,4,2,6,1,0,0,1,1,1,1,3,1
KR_6722422401,420,3,34,24,0,2,2,0,0,1,1,-1,1,2,-1,2,3,0,0,0,0,-2,-106,4,3,7,3,0,0,1,1,0,1,1,1
KR_6735576878,420,7,130,0,13,3,3,0,0,0,0,3,3,0,6,7,1,1,1,0,1,10,-19,3,1,4,2,0,2,1,1,1,1,6,1
KR_6735874875,420,2,24,29,8,4,4,0,3,5,2,4,5,1,-2,0,2,-1,0,1,0,5,41,0,8,8,-2,0,3,1,1,1,1,5,1
KR_6646935779,420,0,-3,3,5,6,6,0,-5,0,5,5,5,0,-1,3,4,0,1,1,1,-6,8,3,2,5,-2,0,1,0,-1,1,1,0,1
KR_6726503569,420,2,42,-11,-1,-3,0,3,1,2,1,0,1,1,2,3,1,-1,0,1,0,1,2,0,6,6,0,0,2,1,1,1,-1,6,1
KR_6705145752,420,-1,13,-3,3,3,3,0,-2,1,3,2,3,1,-1,2,3,1,1,0,1,5,7,1,5,6,-3,0,0,0,1,0,1,0,1
KR_6754007546,420,-3,14,-3,2,-1,0,1,-1,5,6,2,6,4,0,2,2,2,3,1,1,4,-6,1,4,5,3,0,-1,-1,1,1,1,2,1
KR_6768908290,420,1,41,-4,4,-1,2,3,0,2,2,1,1,0,4,5,1,0,1,1,0,0,17,1,3,4,-1,0,0,-1,-1,0,1,1,1
KR_6745720659,420,6,50,28,9,1,3,2,6,6,0,1,1,0,1,2,1,0,1,1,0,11,-16,1,6,7,1,0,2,1,1,1,1,4,1
KR_6760364329,420,0,23,-8,7,-3,4,7,2,3,1,-3,4,7,4,4,0,7,7,0,0,6,-13,1,5,6,-1,0,0,1,1,1,1,6,1
KR_6742330525,420,1,-16,11,5,3,4,1,-2,4,6,-2,0,2,4,5,1,2,4,2,0,2,7,4,3,7,1,0,0,1,-1,1,1,1,1
KR_6762672697,420,2,37,38,11,-1,2,3,7,7,0,2,5,3,1,1,0,2,2,0,-1,9,-5,-1,4,3,4,0,1,-1,1,1,-1,3,1
KR_6727826248,440,1,50,8,4,7,7,0,0,4,4,4,4,0,-7,0,7,0,0,0,0,-4,3,-1,3,2,-4,0,1,1,1,1,-1,1,1
KR_6579442210,420,0,-61,22,2,1,1,0,6,6,0,1,2,1,-3,1,4,-3,0,3,0,-4,4,2,5,7,-6,0,0,-1,1,1,1,2,1
KR_6656035892,420,4,82,44,6,2,3,1,0,1,1,-3,2,5,0,2,2,7,7,0,0,2,10,0,3,3,-3,0,2,1,1,1,-1,6,1
KR_6763326408,420,2,-10,-16,7,-4,1,5,3,3,0,2,4,2,5,6,1,1,3,2,0,15,-86,2,3,5,-6,0,1,1,1,1,1,5,1
KR_6769232736,420,2,6,12,5,3,3,0,1,3,2,-1,3,4,-2,2,4,4,6,2,2,9,-1,1,5,6,0,0,1,1,1,1,1,2,1
KR_6768600687,420,2,29,15,9,2,4,2,2,3,1,3,7,4,3,4,1,-1,1,2,2,1,2,5,4,9,3,0,0,1,-1,0,1,5,1
KR_6675476589,420,4,71,38,6,-3,2,5,3,4,1,3,5,2,4,4,0,-1,1,2,1,10,10,2,7,9,4,0,2,1,1,1,1,2,1
KR_6705142539,440,2,50,1,7,2,2,0,3,4,1,-2,4,6,-2,1,3,6,7,1,0,0,-31,-3,8,5,1,0,1,-1,1,1,1,6,1
KR_6719480244,420,0,36,22,-3,3,4,1,3,4,1,-2,4,6,-4,0,4,-3,2,5,0,-7,2,0,3,3,2,0,1,0,1,1,-1,0,1
KR_6752823659,420,2,12,-8,3,0,1,1,-1,4,5,3,3,0,2,3,1,-1,0,1,0,-9,26,-2,6,4,2,0,0,-1,-1,0,-1,1,1
KR_6695673447,420,5,79,20,8,7,7,0,-5,0,5,2,3,1,4,5,1,0,1,1,-1,-3,-4,2,3,5,3,0,0,1,1,1,-1,1,1
KR_6751458045,420,3,41,36,12,-1,1,2,4,5,1,4,7,3,5,6,1,0,0,0,1,11,25,-3,6,3,7,0,0,1,-1,1,1,1,1
KR_6761548587,420,0,19,5,0,0,2,2,-1,3,4,5,5,0,-2,2,4,-2,1,3,0,-6,10,-1,3,2,1,0,-1,1,1,1,1,6,1
KR_6722151932,420,4,3,13,6,3,5,2,0,1,1,-1,1,2,5,5,0,-1,0,1,-1,4,6,2,3,5,1,0,2,1,1,1,-1,2,1
KR_6767432260,420,1,-25,24,9,1,3,2,4,7,3,2,3,1,1,3,2,1,1,0,0,9,-407,2,2,4,21,0,0,1,1,0,-1,1,1
KR_6768030210,420,-3,-71,5,-3,-4,2,6,-3,2,5,2,7,5,0,1,1,2,2,0,-1,1,6,-4,8,4,-2,0,-2,-1,-1,-1,-1,5,1
KR_6733202462,420,1,40,12,4,-2,2,4,2,4,2,6,8,2,1,4,3,-3,0,3,2,8,-46,4,3,7,16,0,1,-1,1,1,1,5,1
KR_6762270334,420,2,16,-8,11,-1,2,3,1,4,3,7,7,0,0,1,1,4,4,0,-1,15,1,-3,8,5,5,0,1,1,-1,-1,-1,5,1
KR_6766865923,440,2,37,12,9,5,5,0,7,8,1,2,4,2,-5,2,7,0,0,0,0,-1,-16,-1,3,2,2,0,1,-1,-1,1,-1,3,1
KR_6759910464,420,1,-37,-4,9,3,4,1,2,4,2,3,4,1,1,2,1,0,0,0,0,10,-116,0,5,5,-5,0,-1,0,-1,-1,1,0,1
KR_6624802763,420,4,63,-24,7,-1,2,3,4,5,1,0,2,2,5,5,0,-1,0,1,0,12,6,5,1,6,3,0,1,1,1,1,1,3,1
KR_6764815885,420,3,-10,-2,6,-1,0,1,0,1,1,2,5,3,5,6,1,0,0,0,0,10,8,0,6,6,-2,0,0,-1,0,-1,1,6,1
KR_6710079311,440,1,42,-6,-3,-2,1,3,-1,0,1,0,3,3,0,5,5,0,0,0,0,-10,7,3,3,6,2,0,0,1,-1,0,-1,2,1
KR_6451581742,420,-1,-14,-31,0,0,3,3,0,4,4,-4,1,5,7,7,0,-3,4,7,-1,-5,-36,3,4,7,17,0,0,-1,-1,-1,-1,3,1
KR_6715884955,420,1,96,-15,10,4,5,1,-5,0,5,3,3,0,5,6,1,3,3,0,0,6,156,-1,2,1,0,0,3,1,-1,1,1,3,1
KR_6719132380,420,0,-24,0,4,1,4,3,1,2,1,1,4,3,-1,2,3,2,4,2,0,9,-283,-4,5,1,-1,0,0,-1,1,0,-1,4,1
KR_6762211226,420,2,78,-16,7,-1,1,2,3,3,0,-2,1,3,3,6,3,4,4,0,1,7,4,-1,4,3,1,0,2,1,0,1,1,3,1
KR_6740724394,420,0,53,-16,-7,2,2,0,-2,0,2,1,3,2,-1,1,2,-7,0,7,-1,-9,33,-1,4,3,-6,0,0,-1,0,0,-1,5,1
KR_6751080759,420,0,-16,-12,-1,0,1,1,1,6,5,-1,3,4,-1,3,4,0,1,1,0,-6,21,-2,7,5,-2,0,1,-1,1,1,1,3,1
KR_6753315217,420,4,106,-3,5,7,9,2,1,3,2,-1,2,3,-1,1,2,-1,0,1,0,-8,467,0,6,6,1,0,3,1,1,1,1,4,1
KR_6693353262,420,-2,-17,-16,-6,0,2,2,-2,0,2,-5,1,6,1,2,1,0,0,0,0,-3,-7,3,2,5,1,0,0,-1,0,0,-1,4,1
KR_6625280543,420,-3,-13,4,0,-1,0,1,-4,2,6,-4,0,4,8,9,1,1,1,0,0,5,-13,-6,9,3,2,0,-1,1,-1,-1,-1,5,1
KR_6766745572,440,0,-21,14,2,0,0,0,-2,1,3,4,6,2,-2,3,5,2,2,0,-1,-6,-5,0,7,7,-3,0,0,1,1,0,-1,4,1
KR_6712232134,420,-2,-22,-5,-7,-1,2,3,-4,4,8,-2,2,4,3,6,3,-3,0,3,3,-7,11,5,1,6,-3,0,0,1,-1,0,-1,5,1
KR_6762347021,440,1,-45,-40,10,-1,1,2,7,7,0,2,2,0,1,1,0,1,1,0,0,16,37,-3,5,2,-21,0,0,-1,-1,0,1,2,1
KR_6610319227,420,2,4,-19,3,3,4,1,4,8,4,4,5,1,-6,2,8,-2,0,2,-1,-11,-3,0,3,3,-2,0,1,0,1,1,-1,0,1
KR_6644007874,420,1,49,13,1,1,2,1,-2,1,3,0,1,1,2,3,1,0,2,2,0,0,-4,-4,7,3,-1,0,0,-1,1,0,1,4,1
KR_6750002570,420,1,34,0,9,4,6,2,1,3,2,-1,2,3,3,5,2,2,2,0,1,8,-3,1,1,2,-1,0,1,-1,0,1,1,6,1
KR_6745134313,420,2,18,-23,1,7,9,2,-6,2,8,2,5,3,0,1,1,-2,0,2,0,2,10,5,5,10,2,0,-1,-1,-1,1,-1,2,1
KR_6746783526,420,0,-37,8,4,-5,0,5,11,11,0,2,2,0,-3,1,4,-1,0,1,0,5,42,3,3,6,-14,0,-1,1,-1,-1,1,6,1
KR_6719587050,440,3,81,0,1,2,4,2,1,2,1,-3,0,3,0,2,2,1,2,1,0,6,2,-1,4,3,1,0,0,-1,-1,0,-1,6,1
KR_6703478309,420,4,110,21,4,2,4,2,-2,5,7,6,8,2,-2,6,8,0,0,0,-3,-19,-13,-4,7,3,0,0,3,1,1,1,-1,4,1
KR_6716617094,420,2,-46,15,0,0,4,4,-3,3,6,4,6,2,1,2,1,-2,1,3,0,-4,-6,-1,8,7,0,0,0,-1,1,1,1,3,1
KR_6632637382,420,2,67,24,0,2,2,0,-2,1,3,1,3,2,0,6,6,-1,0,1,0,-7,-2,1,7,8,0,0,2,-1,1,1,-1,2,1
KR_6732690546,440,2,0,12,6,1,2,1,5,5,0,1,6,5,-1,0,1,0,0,0,1,11,3,6,4,10,-2,0,0,1,0,0,1,6,1
KR_6601119484,420,-2,30,-27,4,2,2,0,-2,1,3,6,7,1,-3,2,5,1,2,1,0,0,5,2,5,7,-1,0,1,1,1,1,1,5,1
KR_6702795488,420,-1,7,28,-6,-2,0,2,0,5,5,-3,1,4,0,3,3,-1,0,1,-1,-13,-10,-5,8,3,1,0,0,-1,1,1,-1,2,1
KR_6693899797,420,1,-16,0,-1,-3,1,4,0,0,0,-1,1,2,3,4,1,0,1,1,0,-2,26,-5,7,2,2,0,0,1,1,0,1,1,1
KR_6767093189,420,2,-3,8,4,-3,0,3,1,3,2,5,5,0,-1,2,3,2,2,0,0,2,6,0,5,5,-3,0,0,1,-1,-1,1,3,1
KR_6741026578,420,4,54,3,10,-2,2,4,0,4,4,3,6,3,8,8,0,1,2,1,1,11,6,0,4,4,1,0,2,1,1,1,1,5,1
KR_6755148570,420,-2,-22,-16,-9,0,0,0,0,0,0,-5,0,5,-1,2,3,-3,0,3,0,-6,-31,2,3,5,25,0,0,0,-1,0,-1,0,1
KR_6766077770,420,3,36,22,9,3,4,1,1,3,2,1,1,0,2,2,0,2,2,0,0,5,2,-2,3,1,1,0,0,1,-1,-1,-1,6,1
KR_6751403275,420,-1,30,-4,-4,2,3,1,2,4,2,1,2,1,-7,0,7,-2,0,2,0,-6,-15,1,5,6,3,0,-1,-1,-1,-1,-1,3,1
KR_6768098565,420,2,-42,-4,0,5,5,0,4,6,2,-7,0,7,-4,1,5,2,3,1,-1,-11,13,-2,9,7,-1,0,1,-1,1,1,-1,6,1
KR_6764263922,420,1,-41,6,2,6,7,1,-2,0,2,-1,0,1,-2,1,3,1,1,0,0,-2,-11,-4,7,3,5,0,0,1,1,1,-1,5,1
KR_6759414007,440,3,109,8,12,1,2,1,0,1,1,7,9,2,5,5,0,-1,0,1,1,-4,11,2,1,3,0,0,2,1,1,1,1,6,1
KR_6643941451,420,6,4,-4,4,5,5,0,0,2,2,-1,1,2,1,3,2,-1,1,2,0,3,21,2,2,4,3,0,1,1,1,1,1,4,1
KR_6717870060,420,2,-2,18,1,0,1,1,-3,3,6,-2,1,3,3,5,2,3,4,1,0,3,-6,-1,6,5,0,0,0,1,1,0,1,1,1
KR_6761847853,420,-1,26,12,-5,5,7,2,-8,2,10,-1,1,2,-1,1,2,0,2,2,0,-5,19,3,4,7,-1,0,0,1,-1,0,-1,3,1
KR_6757721967,420,4,23,4,7,2,4,2,1,2,1,3,4,1,2,4,2,-1,0,1,0,6,163,1,3,4,4,0,1,0,1,1,1,0,1
KR_6729642797,440,6,151,4,9,4,5,1,9,11,2,-2,2,4,-2,4,6,0,2,2,0,11,9,1,6,7,-1,0,2,1,1,1,-1,1,1
KR_6728728331,420,4,42,-4,7,0,2,2,3,4,1,3,3,0,-1,0,1,2,2,0,0,6,8,4,5,9,-2,0,1,1,1,1,1,5,1
KR_6709641037,420,0,-47,-6,-2,1,3,2,1,3,2,-3,1,4,-2,2,4,1,2,1,1,-4,24,-3,6,3,2,0,0,-1,1,0,1,1,1
KR_6747180614,420,5,27,52,13,5,6,1,6,9,3,-2,1,3,4,4,0,0,0,0,1,14,-279,6,1,7,-6,0,1,1,1,1,1,4,1
KR_6756063838,420,6,30,20,12,4,4,0,-2,0,2,4,6,2,4,8,4,2,2,0,0,7,0,-5,5,0,-2,0,1,1,0,1,1,5,1
KR_6768453939,440,2,21,-24,11,-1,1,2,4,6,2,-2,0,2,3,8,5,7,8,1,0,4,22,2,1,3,4,0,2,1,-1,1,1,1,1
KR_6763942466,420,4,69,15,9,0,3,3,2,5,3,0,3,3,6,8,2,1,2,1,0,3,-7,1,7,8,-1,0,0,1,-1,0,-1,5,1
KR_6757465821,420,4,39,16,5,1,3,2,4,5,1,0,1,1,1,2,1,-1,0,1,1,9,-20,2,2,4,2,0,-1,1,1,-1,1,2,1
KR_6767748884,420,5,74,-4,13,5,6,1,1,4,3,3,3,0,4,6,2,0,0,0,0,6,-2,3,2,5,3,0,0,1,-1,0,1,5,1
KR_6763831292,440,2,88,23,18,1,1,0,6,7,1,7,10,3,1,2,1,3,4,1,1,21,-5,-1,5,4,2,0,2,1,1,1,1,2,1
KR_6764025866,420,0,12,0,0,-3,1,4,-3,2,5,3,3,0,3,6,3,0,0,0,0,-6,-20,2,5,7,0,0,1,-1,-1,1,1,1,1
KR_6764275986,420,1,15,12,5,1,1,0,1,5,4,-1,3,4,1,5,4,3,6,3,0,7,-374,0,4,4,3,0,0,1,1,0,1,2,1
KR_6754046794,420,1,14,15,2,2,5,3,4,5,1,-2,2,4,-1,3,4,-1,1,2,0,-3,-9,-4,6,2,-6,0,1,1,1,1,1,6,1
KR_6678316050,420,7,59,42,15,5,6,1,4,7,3,-4,2,6,7,9,2,3,3,0,3,8,5,0,4,4,1,0,2,1,1,1,1,2,1
KR_6762757265,440,-2,12,7,-10,-6,2,8,-2,2,4,0,2,2,-1,2,3,-1,0,1,0,-7,-3,-3,4,1,1,0,-1,-1,-1,-1,-1,2,1
KR_6741449043,420,2,64,-1,8,2,4,2,-2,1,3,0,1,1,6,8,2,2,2,0,1,15,112,3,2,5,5,0,2,1,1,1,1,5,1
KR_6713697524,420,4,17,48,0,5,5,0,5,5,0,-3,2,5,-6,1,7,-1,0,1,0,-2,8,2,3,5,-1,0,2,-1,-1,1,-1,3,1
KR_6747828145,440,2,8,-4,7,1,4,3,4,5,1,-3,1,4,5,5,0,0,0,0,0,9,-4,-1,6,5,3,0,2,1,1,1,-1,4,1
KR_6744793333,420,-1,11,-11,2,-1,2,3,-2,1,3,0,4,4,7,8,1,-2,0,2,0,3,18,4,2,6,0,0,0,1,1,1,1,1,1
KR_6699215454,420,2,75,-20,4,1,3,2,-1,1,2,-1,0,1,4,4,0,1,1,0,0,1,3,-3,5,2,5,0,1,1,1,1,1,2,1
KR_6735011821,420,2,70,-4,1,3,3,0,2,2,0,-6,0,6,2,4,2,0,1,1,0,8,2,6,1,7,3,0,0,1,-1,1,1,4,1
KR_6640594854,420,-2,-10,-11,-3,-1,1,2,-1,3,4,-6,0,6,5,6,1,0,1,1,0,3,24,1,6,7,-2,0,0,-1,1,1,-1,3,1
KR_6760197117,420,3,120,-8,4,0,3,3,2,3,1,2,4,2,-1,4,5,1,2,1,0,0,-1,-1,5,4,4,0,1,-1,1,1,-1,1,1
KR_6725290418,420,3,76,-16,3,2,4,2,2,3,1,-3,1,4,1,2,1,1,3,2,0,-9,-13,-4,11,7,-3,0,1,-1,-1,1,1,1,1
KR_6669690160,420,5,37,19,12,0,0,0,4,4,0,-1,2,3,4,6,2,5,7,2,0,11,-124,4,3,7,1,0,2,1,1,1,1,3,1
KR_6762464137,420,2,31,8,5,-1,1,2,4,5,1,2,3,1,1,2,1,-1,1,2,0,5,18,0,5,5,0,0,0,0,-1,1,1,0,1
KR_6762149658,420,1,25,-20,0,0,1,1,1,1,0,-1,3,4,2,3,1,-2,0,2,0,2,7,2,3,5,-2,0,0,1,0,0,-1,5,1
KR_6612324560,420,3,14,4,5,1,3,2,3,4,1,0,4,4,0,1,1,1,2,1,0,9,-203,6,2,8,-6,0,1,1,1,1,1,4,1
KR_6734749142,420,2,25,4,2,-1,3,4,-1,2,3,5,7,2,-1,1,2,0,0,0,0,8,7,1,2,3,0,0,0,-1,1,1,-1,6,1
KR_6667493366,420,2,4,8,-3,0,0,0,-2,2,4,-4,2,6,3,6,3,0,0,0,0,-5,-1,1,5,6,-1,0,0,-1,-1,1,-1,2,1
KR_6723559329,420,7,108,35,12,2,2,0,3,5,2,3,4,1,4,4,0,0,0,0,0,7,13,-1,5,4,1,0,2,1,1,1,1,3,1
KR_6762802330,420,1,22,2,9,-1,2,3,4,6,2,3,4,1,1,1,0,2,2,0,0,3,6,1,5,6,2,0,-2,1,-1,1,1,4,1
KR_6768191914,420,-1,0,20,-2,-3,0,3,0,4,4,1,3,2,1,4,3,-1,1,2,0,-1,-6,-2,3,1,3,0,0,1,0,0,-1,5,1
KR_6721832624,420,0,-11,-6,-1,0,2,2,-1,3,4,-2,3,5,2,3,1,0,0,0,0,3,-20,-2,6,4,2,0,-1,-1,0,-1,1,4,1
KR_6750490860,420,-3,-11,-4,-9,2,2,0,-2,4,6,-7,0,7,-2,1,3,0,2,2,0,-7,3,-4,5,1,-5,0,-1,1,-1,-1,-1,3,1
KR_6688681955,420,0,-11,37,1,2,4,2,-6,2,8,2,3,1,2,5,3,1,4,3,0,-2,8,-5,9,4,4,0,0,-1,1,-1,1,1,1
KR_6610021614,420,1,-24,-8,11,-2,0,2,5,6,1,3,4,1,2,4,2,3,3,0,-1,17,-39,3,1,4,21,0,1,1,1,1,-1,4,1
KR_6765962479,420,4,67,12,6,1,4,3,3,3,0,4,4,0,-2,2,4,0,1,1,1,1,-5,-5,9,4,4,0,1,1,1,1,1,1,1
KR_6598338649,420,5,42,16,12,2,3,1,3,5,2,-1,2,3,11,15,4,-3,0,3,0,16,-19,5,3,8,4,0,2,1,1,-1,1,2,1
KR_6750038773,420,0,-1,-44,-1,0,1,1,-4,1,5,3,4,1,-4,1,5,4,9,5,0,-5,2,-4,7,3,-6,0,-2,-1,-1,-1,1,5,1
KR_6765681151,420,3,57,8,1,-1,3,4,1,3,2,-2,2,4,3,6,3,0,0,0,0,0,-12,3,2,5,-1,0,1,0,0,1,-1,0,1
KR_6760943174,440,0,-60,-12,0,2,4,2,5,6,1,3,4,1,-8,0,8,-2,0,2,-1,3,-3,-1,5,4,4,0,-1,-1,-1,-1,-1,3,1
KR_6704829845,420,1,66,-16,-1,1,4,3,-3,0,3,0,1,1,-3,1,4,4,5,1,0,-4,-2,-2,5,3,1,0,1,-1,1,1,-1,3,1
KR_6708312686,420,1,39,14,-3,1,2,1,2,2,0,-3,0,3,-4,0,4,1,1,0,0,-7,-1,4,2,6,5,0,0,-1,0,0,1,2,1
KR_6753664556,440,0,24,-16,2,10,11,1,-4,0,4,2,3,1,-1,0,1,-5,0,5,0,-4,-13,1,3,4,3,0,2,1,-1,1,-1,5,1
KR_6762468882,420,-1,-29,-8,4,1,2,1,1,2,1,1,4,3,0,2,2,1,2,1,0,9,9,0,6,6,1,0,-1,-1,1,-1,-1,4,1
KR_6675487845,420,3,6,-36,8,2,4,2,3,4,1,6,8,2,0,3,3,-3,0,3,0,15,-3,2,3,5,2,0,2,1,1,1,-1,6,1
KR_6768315572,420,2,75,-9,5,6,7,1,0,1,1,4,5,1,1,3,2,-6,1,7,0,-5,327,-2,7,5,11,0,1,1,-1,1,-1,1,1
KR_6747905127,440,-1,17,-24,-4,-1,1,2,1,2,1,0,2,2,-1,2,3,-3,3,6,-1,-3,-7,0,5,5,-2,0,0,-1,0,-1,-1,5,1
KR_6724844063,420,6,54,24,9,2,2,0,4,5,1,5,5,0,1,3,2,-3,1,4,0,2,25,3,5,8,-3,0,1,-1,1,1,1,3,1
KR_6723047112,420,-1,-37,-12,0,-1,2,3,-2,3,5,-1,1,2,2,4,2,2,2,0,0,4,202,-6,7,1,-2,0,-1,-1,1,-1,-1,3,1
KR_6629616945,440,1,39,4,2,2,2,0,1,2,1,0,1,1,-1,1,2,0,0,0,0,3,-15,-1,3,2,2,0,0,1,-1,0,-1,4,1
KR_6769227969,440,1,32,-10,-1,1,2,1,1,5,4,0,2,2,-3,2,5,0,1,1,0,-3,4,1,4,5,-1,0,-1,1,-1,-1,-1,2,1
KR_6761588897,440,-2,-2,-31,-7,-1,1,2,-6,1,7,0,1,1,0,3,3,0,0,0,0,-6,-6,2,5,7,-5,0,0,1,0,-1,-1,5,1
KR_6745397054,420,-2,-29,-23,-3,0,3,3,-3,2,5,1,2,1,0,2,2,-1,0,1,0,1,5,1,5,6,-2,0,1,1,-1,1,-1,1,1
KR_6717998705,420,2,49,-34,6,3,3,0,-1,3,4,-1,2,3,5,7,2,0,1,1,0,4,12,2,2,4,1,0,0,-1,-1,-1,1,4,1
KR_6760390721,420,1,-12,-4,8,0,0,0,5,7,2,2,5,3,0,1,1,1,1,0,0,14,69,5,0,5,-1,0,1,-1,1,1,-1,5,1
KR_6758307950,420,3,-13,10,3,3,3,0,2,2,0,-3,0,3,0,3,3,1,3,2,0,6,38,2,3,5,-6,0,0,-1,1,0,1,3,1
KR_6740957629,420,-2,-45,-1,-1,0,2,2,-2,0,2,1,2,1,1,4,3,-1,1,2,0,-2,-22,-1,3,2,0,0,-1,-1,0,-1,-1,4,1
KR_6755173442,420,0,-16,-13,2,0,3,3,2,4,2,-1,2,3,0,1,1,1,1,0,0,4,89,2,5,7,0,0,-1,-1,1,-1,1,2,1
KR_6768316900,420,3,9,8,9,1,4,3,2,4,2,0,3,3,4,4,0,2,3,1,0,5,-10,6,1,7,-1,0,1,-1,1,1,1,3,1
KR_6665703380,420,2,10,68,2,-2,2,4,3,4,1,2,3,1,-3,1,4,2,2,0,0,-1,15,1,3,4,-3,0,1,1,1,1,1,2,1
KR_6762846606,420,2,-4,-19,9,-1,1,2,-6,3,9,9,9,0,6,6,0,1,1,0,0,3,7,1,2,3,-2,0,0,-1,-1,-1,-1,1,1
KR_6744729686,440,6,110,26,13,1,1,0,2,8,6,0,3,3,11,12,1,-1,1,2,0,13,-73,1,5,6,3,0,2,1,1,1,1,3,1
KR_6753882902,420,4,12,21,5,1,1,0,0,1,1,0,0,0,5,6,1,-1,0,1,0,7,13,1,3,4,2,0,0,-1,-1,0,1,3,1
KR_6736341359,420,1,24,-2,-4,2,2,0,-2,2,4,-1,2,3,-2,2,4,-1,0,1,0,-4,1,0,4,4,-5,0,1,-1,1,1,1,3,1
KR_6655218104,420,4,71,16,10,-2,0,2,2,4,2,8,10,2,-1,2,3,3,4,1,0,5,11,5,2,7,1,0,2,1,1,1,1,5,1
KR_6740945039,420,-1,42,-24,-1,1,3,2,3,5,2,-5,1,6,0,1,1,0,0,0,0,3,5,3,5,8,2,0,0,-1,-1,-1,1,6,1
KR_6763466377,420,3,40,12,5,3,7,4,2,2,0,-1,2,3,2,4,2,-1,0,1,0,2,154,6,1,7,0,0,1,1,-1,1,-1,4,1
KR_6767786804,420,8,93,4,10,2,4,2,0,2,2,6,6,0,1,1,0,1,1,0,0,12,1,2,2,4,2,0,3,1,-1,1,-1,2,1
KR_6769287927,420,5,68,38,7,3,6,3,2,4,2,3,4,1,-4,1,5,3,5,2,1,2,-8,-3,4,1,0,0,3,-1,1,1,1,2,1
KR_6761046248,420,2,70,-4,14,5,6,1,1,2,1,5,6,1,3,7,4,0,2,2,1,5,196,4,2,6,3,0,2,1,-1,1,1,4,1
KR_6413406591,420,-4,-114,-24,-4,-3,1,4,-2,2,4,-1,1,2,-1,1,2,3,5,2,1,8,-104,-1,7,6,-1,0,-2,-1,1,-1,1,3,1
KR_6725067429,420,3,28,-8,18,3,6,3,6,6,0,3,4,1,5,6,1,1,2,1,2,25,14,2,3,5,2,0,1,1,1,1,1,2,1
KR_6766059111,420,4,90,8,6,2,3,1,-2,1,3,2,4,2,1,2,1,3,3,0,0,1,1,-1,7,6,5,0,0,1,-1,-1,1,2,1
KR_6698642768,420,0,-16,-4,0,-2,1,3,-1,3,4,-1,1,2,6,9,3,-2,0,2,-2,6,-11,0,4,4,0,0,0,1,1,0,-1,4,1
KR_6758198570,420,-3,-55,-4,0,-4,1,5,3,3,0,0,2,2,1,3,2,0,0,0,0,5,3,-1,4,3,-2,0,-1,1,1,-1,1,6,1
KR_6765910435,420,4,132,0,11,3,4,1,-2,1,3,1,1,0,11,12,1,-2,0,2,0,5,9,-1,4,3,0,0,2,1,1,1,1,5,1
KR_6768357694,420,6,48,4,11,6,6,0,2,2,0,-1,4,5,6,7,1,-2,2,4,-1,-1,8,3,3,6,3,0,1,1,-1,1,-1,4,1
KR_6761355542,420,2,-5,4,3,-1,0,1,-1,3,4,2,5,3,2,6,4,1,3,2,0,-1,-3,-4,4,0,1,0,1,0,-1,1,-1,0,1
KR_6734569270,420,-2,24,0,-3,-2,1,3,0,4,4,1,2,1,-2,1,3,0,1,1,0,3,6,0,5,5,0,0,0,1,-1,1,-1,2,1
KR_6681576058,420,3,100,5,8,4,4,0,0,2,2,5,9,4,0,2,2,-1,0,1,0,-5,-3,0,4,4,4,0,5,1,1,1,1,4,1
KR_6626669618,420,3,52,20,2,-4,0,4,2,4,2,1,1,0,1,1,0,2,3,1,1,6,6,2,5,7,1,0,1,1,1,1,1,3,1
KR_6717497007,420,1,-19,2,2,1,1,0,5,5,0,-2,0,2,-1,2,3,-1,1,2,0,1,-5,-4,7,3,1,0,0,1,-1,0,-1,6,1
KR_6687366432,420,8,43,12,19,6,7,1,6,7,1,3,4,1,2,2,0,2,2,0,0,20,-7,-2,7,5,7,0,2,1,0,1,-1,4,1
KR_6739565132,420,1,11,-15,8,2,4,2,2,4,2,1,3,2,2,5,3,1,3,2,0,6,2,-2,7,5,2,0,1,1,1,1,1,4,1
KR_6763794245,420,0,-33,5,-3,0,2,2,0,0,0,-2,2,4,-1,0,1,0,0,0,0,-2,-3,-1,7,6,-3,0,0,1,-1,0,1,3,1
KR_6741893231,420,3,-32,6,0,2,2,0,2,7,5,0,2,2,-6,2,8,2,2,0,0,1,-62,-6,8,2,27,0,1,-1,1,1,-1,4,1
KR_6747891505,420,3,-75,-16,11,1,4,3,3,4,1,4,6,2,3,7,4,0,1,1,1,11,-37,3,2,5,17,0,-1,1,1,-1,1,4,1
KR_6679748012,440,-5,-63,-13,-10,0,1,1,-6,0,6,-2,0,2,2,4,2,-4,0,4,0,-7,98,4,4,8,-2,0,-1,-1,-1,-1,1,4,1
KR_6746667363,420,-1,-33,12,7,2,2,0,3,4,1,0,2,2,4,4,0,-2,0,2,2,12,5,3,4,7,1,0,1,1,1,1,1,1,1
KR_6761443757,420,-3,-27,-10,-11,4,6,2,-1,2,3,-5,2,7,-10,4,14,1,1,0,-1,-22,-9,-5,8,3,1,0,1,-1,1,1,-1,6,1
KR_6735047988,420,0,17,-16,8,1,2,1,2,5,3,3,4,1,2,3,1,0,3,3,2,18,7,-1,5,4,0,0,0,0,1,1,1,0,1
KR_6114113123,420,2,-14,-12,5,-2,1,3,2,2,0,1,1,0,5,5,0,-1,0,1,1,4,-1,0,5,5,9,0,-1,1,-1,-1,1,1,1
KR_6728932060,420,-2,-31,17,-6,-4,1,5,6,7,1,-3,0,3,-1,2,3,-4,0,4,0,-13,2,-1,7,6,-2,0,1,1,1,1,-1,2,1
KR_6691154371,420,3,81,10,4,-2,0,2,3,5,2,5,6,1,-4,0,4,2,3,1,0,0,45,-1,4,3,-36,0,1,1,1,1,-1,3,1
KR_6760523287,420,1,33,-8,4,1,2,1,-1,1,2,3,6,3,1,3,2,0,2,2,0,9,2,5,3,8,0,0,0,0,0,0,1,0,1
KR_6750825808,420,3,19,36,8,5,5,0,0,2,2,0,1,1,2,2,0,1,3,2,0,6,-8,-2,7,5,6,0,1,1,1,1,1,2,1
KR_6613273887,420,2,48,-9,3,-3,1,4,0,1,1,0,1,1,3,5,2,3,3,0,1,6,-4,0,3,3,2,0,1,1,-1,1,1,4,1
KR_6760104192,420,4,84,16,8,5,5,0,-3,3,6,1,3,2,2,3,1,3,3,0,0,15,2,-2,7,5,2,0,2,0,1,1,1,0,1
KR_6769226034,420,5,36,-12,4,2,3,1,-1,1,2,3,4,1,-1,4,5,1,1,0,0,5,-4,2,3,5,0,0,1,0,0,-1,-1,0,1
KR_6611118260,420,-3,-49,12,-5,2,2,0,1,4,3,-1,1,2,-5,2,7,-2,0,2,0,-6,129,3,3,6,4,0,-1,1,1,1,1,1,1
KR_6741141267,440,1,11,25,5,2,5,3,3,4,1,-5,0,5,0,0,0,5,6,1,2,12,2,3,2,5,1,0,2,0,1,1,1,0,1
KR_6757632451,420,-1,-26,-43,3,1,2,1,0,5,5,4,5,1,-2,2,4,0,1,1,0,7,-27,-5,7,2,12,0,0,-1,-1,0,-1,2,1
KR_6755513860,440,2,66,3,5,1,3,2,-2,2,4,0,3,3,6,7,1,0,0,0,1,-4,-1,-2,7,5,2,0,2,1,1,1,1,6,1
KR_6767492473,420,1,0,-44,4,-1,1,2,-2,0,2,4,4,0,4,4,0,-1,0,1,0,4,-20,7,2,9,0,0,0,1,-1,0,-1,4,1
KR_6734968863,440,1,93,-13,2,-1,2,3,0,0,0,1,1,0,-3,0,3,5,5,0,0,3,3,2,2,4,0,0,0,1,0,0,1,3,1
KR_6768119813,420,3,45,24,11,1,2,1,2,2,0,0,2,2,5,6,1,3,3,0,0,12,-5,1,3,4,3,0,1,-1,1,1,1,5,1
KR_6666799509,440,5,24,0,4,0,6,6,-7,0,7,1,4,3,2,2,0,8,12,4,1,3,30,0,6,6,1,0,1,0,1,1,1,0,1
KR_6737280681,420,-1,-46,-12,-1,-5,0,5,-2,1,3,-1,1,2,5,6,1,2,3,1,0,6,-5,-1,3,2,-1,0,-2,1,1,1,-1,2,1
KR_6763055193,420,1,19,5,2,-3,1,4,2,6,4,2,2,0,0,0,0,1,1,0,0,-5,41,1,3,4,-23,0,1,-1,1,1,1,6,1
KR_6767845220,420,-1,-52,12,0,-2,1,3,3,5,2,0,2,2,-2,2,4,1,3,2,0,-1,-26,-1,3,2,12,0,-1,1,1,-1,-1,5,1
KR_6727262941,440,4,-8,43,0,2,3,1,3,3,0,1,1,0,-3,1,4,-3,1,4,0,-5,43,-3,7,4,2,0,-1,-1,1,1,-1,6,1
KR_6766216894,420,-1,-62,9,11,1,1,0,0,2,2,9,9,0,0,2,2,1,1,0,0,12,13,3,4,7,-5,0,0,1,1,-1,1,6,1
KR_6690760882,420,8,77,44,13,-1,3,4,6,8,2,3,8,5,5,8,3,0,2,2,0,13,-180,4,1,5,2,0,2,1,1,1,1,2,1
KR_6585664673,420,3,98,12,7,2,3,1,0,2,2,-1,0,1,6,8,2,0,2,2,2,0,4,-1,7,6,1,0,1,-1,1,1,1,2,1
KR_6759253866,420,3,47,0,-1,-1,2,3,1,3,2,0,1,1,1,4,3,-2,0,2,0,-4,58,-2,6,4,-34,0,1,1,-1,1,-1,3,1
KR_6769144186,420,3,16,-3,8,0,0,0,3,5,2,4,5,1,1,2,1,0,2,2,1,9,2,5,2,7,-2,0,1,0,1,1,1,0,1
KR_6767507559,420,0,44,8,-3,1,2,1,3,3,0,-6,2,8,-1,2,3,0,0,0,0,-9,12,0,8,8,6,0,0,0,-1,0,1,0,1
KR_6727324937,440,1,9,-1,-3,0,2,2,-2,2,4,3,7,4,2,3,1,-6,0,6,1,-7,1,1,3,4,1,0,0,-1,1,0,1,6,1
KR_6764401466,420,1,-2,-9,3,1,3,2,1,3,2,1,2,1,0,0,0,0,0,0,0,3,-2,-1,5,4,-4,0,-1,1,-1,-1,1,4,1
KR_6749078946,440,-2,-50,-4,-4,1,3,2,0,2,2,-2,1,3,-3,1,4,0,0,0,1,-5,3,-1,5,4,-2,0,0,-1,1,0,1,5,1
KR_6651115233,420,2,-11,4,6,-5,0,5,9,10,1,-1,0,1,2,4,2,1,1,0,0,19,2,0,6,6,1,0,1,1,1,1,1,5,1
KR_6649800164,420,2,63,-1,0,-2,0,2,-2,0,2,5,7,2,-1,0,1,0,0,0,0,0,-7,-5,7,2,5,0,1,1,-1,1,-1,5,1
KR_6763037753,420,2,57,-8,9,0,0,0,4,5,1,4,5,1,1,1,0,0,0,0,0,13,20,4,5,9,3,0,0,1,-1,0,1,6,1
KR_6733710051,420,2,6,8,3,-1,3,4,2,3,1,0,4,4,2,4,2,0,1,1,0,-4,-2,-2,5,3,0,0,2,0,1,1,-1,0,1
KR_6768446855,420,0,-15,-4,2,4,5,1,-4,2,6,-3,1,4,5,5,0,0,0,0,0,4,5,2,3,5,2,0,0,-1,-1,0,1,2,1
KR_6769091290,420,2,-8,20,5,1,1,0,1,4,3,-3,1,4,4,6,2,2,2,0,2,11,-102,-1,4,3,2,0,0,0,-1,0,1,0,1
KR_6766014661,420,-1,-49,-12,-3,0,1,1,2,3,1,-1,2,3,-3,0,3,-1,2,3,0,1,1,-2,5,3,0,0,0,1,-1,-1,-1,2,1
KR_6754109736,420,2,44,24,3,-1,0,1,0,4,4,-1,0,1,2,3,1,3,3,0,0,-3,5,-2,8,6,-3,0,0,-1,1,0,1,5,1
KR_6732985171,420,5,-10,-20,15,5,6,1,3,5,2,4,5,1,-1,1,2,4,4,0,-1,15,6,-2,6,4,0,0,1,1,1,1,-1,6,1
KR_6746859915,420,5,28,27,6,2,3,1,-2,1,3,3,4,1,3,3,0,0,1,1,1,2,4,4,4,8,0,0,0,1,1,1,1,6,1
KR_6727999516,420,-1,-16,5,4,-1,1,2,0,1,1,-4,1,5,3,3,0,6,6,0,0,11,38,2,4,6,-22,0,0,0,-1,-1,-1,0,1
KR_6615525050,440,1,-29,21,1,-5,1,6,-2,4,6,6,8,2,-3,1,4,5,8,3,0,-5,-16,-1,3,2,4,0,1,1,1,1,-1,5,1
KR_6761192087,440,0,-74,-32,-5,-4,1,5,-2,2,4,2,3,1,0,2,2,-1,0,1,0,2,-187,1,0,1,7,0,-1,-1,-1,-1,-1,2,1
KR_6758213561,440,-2,3,-5,-7,-4,0,4,-1,2,3,0,1,1,-1,1,2,-1,2,3,0,-7,-229,-4,4,0,-4,0,-1,-1,-1,-1,-1,6,1
KR_6747701625,420,0,-9,-5,5,-2,0,2,-1,1,2,5,5,0,-1,1,2,4,4,0,2,11,34,0,5,5,4,0,1,1,1,1,1,4,1
KR_6753264682,420,5,55,31,10,1,3,2,0,1,1,5,5,0,0,4,4,4,4,0,0,4,-40,4,1,5,21,0,2,1,1,1,-1,4,1
KR_6738767660,420,3,-13,35,4,-4,0,4,4,4,0,1,1,0,4,5,1,-1,1,2,0,9,5,1,3,4,-3,0,0,1,1,1,-1,3,1
KR_6734340046,420,0,2,12,10,2,4,2,0,2,2,2,2,0,6,6,0,0,1,1,0,14,-2,1,4,5,1,0,0,-1,1,-1,1,3,1
KR_6754242229,420,2,17,-16,4,-1,0,1,1,2,1,3,3,0,2,2,0,-1,0,1,0,4,-1,-1,2,1,-1,0,1,-1,1,1,-1,3,1
KR_6661575533,440,1,25,-14,6,-2,2,4,1,1,0,1,2,1,3,3,0,3,4,1,1,11,14,4,2,6,4,0,-1,1,-1,-1,1,2,1
KR_6767827187,420,4,92,-12,10,3,4,1,4,8,4,4,4,0,0,2,2,-1,1,2,0,9,8,2,2,4,-2,0,2,-1,1,1,1,2,1
KR_6764244231,420,-1,46,6,-3,-5,1,6,-1,1,2,2,4,2,2,2,0,-1,1,2,2,-4,129,2,3,5,-4,0,0,1,-1,-1,1,1,1
KR_6681662685,420,2,30,25,-1,-3,2,5,-4,3,7,1,4,3,4,6,2,1,2,1,0,-1,-22,2,3,5,-1,0,0,-1,0,0,-1,1,1
KR_6639139947,420,1,56,0,-3,1,4,3,0,2,2,0,0,0,-3,0,3,-1,0,1,0,-4,116,-3,5,2,4,0,0,1,1,1,-1,6,1
KR_6653813777,420,0,12,5,-3,1,5,4,-1,2,3,1,4,3,-4,3,7,0,0,0,0,0,-3,-2,6,4,1,0,-1,-1,-1,-1,1,1,1
KR_6739364293,420,3,19,16,8,2,4,2,1,3,2,4,6,2,2,5,3,-1,0,1,0,15,13,3,3,6,4,0,2,1,1,1,-1,2,1
KR_6723187089,420,0,10,16,-4,2,5,3,-2,1,3,-4,0,4,3,5,2,-3,0,3,0,-8,13,3,4,7,2,0,1,-1,1,1,-1,4,1
KR_6768480451,440,-2,16,11,2,-2,1,3,3,4,1,3,3,0,0,5,5,-2,0,2,2,1,-18,4,4,8,-7,0,2,-1,1,1,1,2,1
KR_6753832240,420,2,91,32,12,5,8,3,6,7,1,-2,3,5,4,7,3,-1,0,1,1,14,4,1,5,6,2,0,0,0,1,1,1,0,1
KR_6625265053,420,2,52,16,4,3,4,1,2,3,1,-1,1,2,1,2,1,-1,0,1,0,2,33,2,6,8,-4,0,1,0,-1,1,1,0,1
KR_6641532540,420,0,36,13,-4,0,1,1,-2,0,2,2,4,2,-1,1,2,-3,0,3,0,-13,53,4,1,5,-1,0,0,-1,1,0,-1,6,1
KR_6766406668,420,-1,12,-20,4,6,8,2,5,5,0,-4,0,4,-1,2,3,-2,1,3,1,5,4,4,2,6,-4,0,0,1,-1,0,-1,5,1
KR_6758987877,420,4,-3,33,4,0,1,1,2,6,4,2,3,1,0,2,2,0,1,1,0,3,114,2,3,5,-1,0,0,1,-1,1,-1,4,1
KR_6733280452,420,1,49,4,8,4,5,1,-1,1,2,1,3,2,5,6,1,-1,2,3,0,3,110,1,4,5,-2,0,2,-1,-1,1,1,4,1
KR_6752438148,420,5,11,8,12,3,4,1,-1,2,3,3,3,0,5,6,1,2,2,0,1,9,-4,0,3,3,2,0,1,-1,1,1,1,1,1
KR_6679118042,420,4,7,-24,5,-3,0,3,0,3,3,2,3,1,5,6,1,1,2,1,0,-2,220,-1,4,3,2,0,-2,0,-1,-1,1,0,1
KR_6736313823,420,-2,29,-20,-5,1,5,4,2,4,2,-1,2,3,-3,1,4,-4,0,4,0,-5,-6,2,2,4,4,0,1,-1,1,-1,-1,5,1
KR_6767389628,420,-1,8,-12,-2,2,4,2,-3,0,3,-1,0,1,-2,0,2,2,2,0,0,-7,31,1,4,5,0,0,0,-1,1,1,-1,4,1
KR_6769148969,420,5,58,8,8,3,3,0,1,4,3,-1,2,3,7,7,0,-2,0,2,0,8,-129,5,3,8,1,0,0,1,-1,1,1,4,1
KR_6735582980,440,3,80,-27,13,-2,0,2,2,2,0,1,4,3,11,12,1,1,1,0,0,23,-17,-2,9,7,2,0,2,1,-1,1,1,5,1
KR_6739395945,420,3,44,20,8,-1,1,2,5,5,0,3,5,2,1,1,0,0,2,2,0,11,26,4,1,5,1,0,1,1,-1,1,1,5,1
KR_6722959720,440,1,68,-28,1,-1,1,2,0,5,5,1,1,0,1,5,4,0,1,1,0,-5,-1,-1,5,4,-2,0,0,-1,-1,0,-1,5,1
KR_6745075062,420,2,60,-16,11,1,1,0,2,3,1,5,5,0,2,3,1,1,2,1,1,12,1,5,1,6,2,0,1,1,0,1,1,5,1
KR_6611087088,420,4,34,34,9,2,2,0,2,4,2,3,3,0,3,4,1,-1,0,1,1,7,-31,-1,5,4,9,0,1,1,1,1,1,6,1
KR_6759485573,420,0,6,-13,4,2,5,3,4,5,1,0,1,1,-3,0,3,1,1,0,0,0,380,1,2,3,-1,0,0,-1,1,1,-1,2,1
KR_6758863767,420,-1,54,-24,3,2,3,1,2,4,2,-1,1,2,-1,5,6,1,1,0,1,2,2,0,4,4,5,0,1,-1,1,1,1,2,1
KR_6731525951,420,5,76,12,4,4,4,0,-2,1,3,4,4,0,0,4,4,-2,1,3,0,-1,-1,-6,10,4,2,0,3,1,1,1,-1,2,1
KR_6732116813,420,4,27,27,5,4,7,3,1,4,3,1,4,3,0,3,3,-1,1,2,0,1,-9,-4,6,2,-2,0,2,1,1,1,1,5,1
KR_6736385234,420,0,52,-12,1,3,4,1,1,3,2,0,4,4,-4,2,6,1,2,1,0,4,-23,3,2,5,2,0,0,-1,1,1,1,5,1
KR_6707633390,420,0,-48,1,4,0,1,1,-1,2,3,-3,0,3,7,7,0,1,1,0,0,8,-6,-2,8,6,-2,0,2,1,1,1,1,1,1
KR_6761048074,420,-3,-56,8,-1,0,3,3,5,5,0,-7,0,7,1,3,2,0,2,2,2,2,2,1,8,9,-3,0,0,1,1,0,1,4,1
KR_6724488490,420,4,96,1,14,5,7,2,4,4,0,-1,3,4,4,8,4,2,3,1,0,10,5,1,2,3,1,0,1,0,1,1,1,0,1
KR_6761119142,420,1,-15,-24,1,1,2,1,-2,1,3,0,1,1,2,4,2,0,1,1,0,6,-21,0,6,6,-4,0,0,1,1,0,-1,2,1
KR_6737760897,420,-4,-62,-28,-5,0,2,2,-2,1,3,6,6,0,-3,0,3,-6,0,6,0,-3,-11,3,2,5,2,0,-2,-1,0,-1,1,6,1
KR_6726607969,420,2,-6,1,8,5,5,0,6,9,3,-2,2,4,0,3,3,-1,0,1,0,3,-34,-5,9,4,-5,0,-1,1,0,-1,-1,1,1
KR_6766186036,420,1,31,16,-1,0,1,1,-2,1,3,0,1,1,0,4,4,1,2,1,-1,-7,118,1,3,4,-3,0,0,1,1,0,-1,1,1
KR_6753986186,420,-1,-37,4,-5,-3,0,3,-3,3,6,-1,0,1,2,3,1,0,0,0,0,-5,-1,-4,7,3,5,0,0,1,1,1,-1,3,1
KR_6757740115,420,0,-62,16,-2,2,2,0,-2,2,4,0,1,1,-4,5,9,2,2,0,-2,-5,-48,0,6,6,27,0,-1,0,1,-1,-1,0,1
KR_6595014116,420,4,71,8,4,5,7,2,-3,0,3,1,6,5,1,3,2,0,0,0,0,-3,-13,4,1,5,4,0,2,0,1,1,-1,0,1
KR_6719918196,420,3,6,-4,2,-1,1,2,4,5,1,-1,3,4,-1,3,4,1,1,0,0,6,0,-5,9,4,3,0,1,0,1,1,1,0,1
KR_6751145867,420,-1,-12,12,1,-2,0,2,0,3,3,0,2,2,2,3,1,1,1,0,0,0,-127,-2,5,3,-1,0,-2,0,1,-1,1,0,1
KR_6702952536,420,0,0,-3,-6,3,4,1,1,1,0,-3,1,4,-7,1,8,0,0,0,0,-12,116,2,3,5,1,0,0,1,-1,0,1,3,1
KR_6740994038,420,4,57,16,12,5,7,2,2,4,2,0,1,1,7,8,1,-2,1,3,0,12,-3,-2,7,5,6,0,3,1,1,1,1,1,1
KR_6762261340,420,1,41,-10,1,1,3,2,-2,3,5,-1,4,5,3,4,1,0,0,0,0,-4,16,0,4,4,0,0,1,-1,1,1,1,3,1
KR_6744059222,420,3,-10,20,6,-1,1,2,3,7,4,4,4,0,-1,2,3,1,1,0,0,-1,15,0,4,4,-1,0,2,1,1,1,1,2,1
KR_6750993425,420,0,-39,-76,4,-2,3,5,3,3,0,-4,3,7,7,8,1,0,1,1,0,5,10,5,2,7,-1,0,-1,1,-1,-1,-1,2,1
KR_6746908620,420,3,-29,12,11,-1,0,1,2,2,0,1,4,3,10,11,1,-1,0,1,1,15,1,-1,3,2,4,0,0,1,-1,0,1,4,1
KR_6758475614,420,3,-59,-2,10,3,6,3,1,5,4,2,3,1,1,2,1,3,4,1,0,6,4,3,3,6,-4,0,0,1,1,1,-1,2,1
KR_6746517192,420,3,61,32,5,-2,1,3,-1,0,1,0,4,4,8,10,2,0,0,0,0,6,23,-1,6,5,-21,0,2,1,1,1,1,1,1
KR_6760566817,440,3,3,8,2,2,2,0,1,4,3,4,7,3,-3,4,7,-2,0,2,0,-7,8,-1,7,6,0,0,0,1,-1,0,-1,2,1
KR_6726976177,420,4,113,15,7,-2,2,4,-2,1,3,4,5,1,6,7,1,1,1,0,2,9,-194,-1,3,2,2,0,2,1,-1,-1,1,1,1
KR_6767094709,420,2,59,-22,4,4,4,0,0,2,2,3,3,0,-5,0,5,2,2,0,0,1,-127,-3,4,1,-3,0,0,-1,1,-1,1,3,1
KR_6767943130,420,1,-7,0,3,1,2,1,0,1,1,2,3,1,0,2,2,0,1,1,0,5,-18,-1,4,3,1,0,0,-1,1,0,-1,3,1
KR_6756911422,420,-2,1,-8,-10,-3,0,3,-5,1,6,1,2,1,1,1,0,-4,1,5,-1,-15,2,0,5,5,-2,0,-1,-1,-1,-1,-1,5,1
KR_6761506035,420,2,-37,28,5,1,4,3,0,1,1,-4,0,4,5,5,0,3,5,2,0,7,-27,-3,6,3,-2,0,1,0,1,1,1,0,1
KR_6760796448,420,1,-30,-19,2,2,2,0,-3,2,5,2,3,1,1,2,1,0,0,0,0,-4,-2,-2,4,2,4,0,-1,1,-1,-1,-1,3,1
KR_6767979137,420,0,36,-4,-1,-3,0,3,0,3,3,-2,1,3,2,5,3,2,3,1,-1,0,-5,7,2,9,-2,0,1,1,-1,1,-1,4,1
KR_6736973147,420,-2,-50,3,-1,5,5,0,-1,2,3,-1,1,2,-4,2,6,0,2,2,0,-7,4,-1,7,6,3,0,1,-1,-1,1,1,4,1
KR_6729622874,420,-3,-59,5,-4,-3,0,3,1,3,2,-2,1,3,-1,2,3,1,1,0,0,0,-7,-1,3,2,0,0,-1,-1,-1,-1,-1,3,1
KR_6724606261,420,5,-22,54,5,-2,0,2,2,4,2,1,1,0,1,5,4,3,4,1,0,1,-6,-9,9,0,6,0,0,1,-1,0,1,3,1
KR_6698233242,420,5,58,8,13,2,2,0,8,9,1,0,1,1,3,4,1,0,1,1,0,18,-126,-1,4,3,5,0,0,1,-1,1,-1,3,1
KR_6762425578,420,2,-12,2,7,4,5,1,-2,1,3,-2,1,3,5,7,2,2,3,1,0,10,3,1,1,2,1,0,2,0,1,1,-1,0,1
KR_6727852131,420,4,117,17,18,4,5,1,12,14,2,2,3,1,1,5,4,-1,1,2,2,19,29,-5,7,2,1,0,1,1,-1,1,1,4,1
KR_6726947715,420,0,43,16,3,1,3,2,1,4,3,2,2,0,0,1,1,-1,0,1,0,2,39,4,0,4,-2,0,2,1,1,1,-1,1,1
KR_6723154174,420,0,-37,16,5,-8,1,9,4,7,3,-5,1,6,5,5,0,9,9,0,1,10,24,2,4,6,3,0,-1,1,-1,-1,1,1,1
KR_6751282503,420,4,36,-8,14,2,2,0,-1,0,1,5,5,0,8,9,1,0,0,0,0,17,-236,-2,8,6,2,0,1,1,-1,1,-1,4,1
KR_6647499144,420,1,-29,-10,8,0,1,1,4,4,0,2,4,2,-1,1,2,3,4,1,1,12,-1,2,3,5,1,0,1,1,1,1,1,1,1
KR_6553410161,420,-1,-10,-11,5,6,6,0,2,3,1,-2,0,2,-1,2,3,0,0,0,0,7,4,2,2,4,-3,0,1,1,1,1,1,5,1
KR_6757579108,420,3,12,24,4,1,3,2,2,3,1,1,2,1,2,5,3,-2,2,4,0,8,-2,2,2,4,2,0,0,-1,-1,0,-1,3,1
KR_6726261811,420,2,70,-14,9,3,6,3,2,5,3,6,6,0,-3,3,6,1,2,1,0,5,1,5,2,7,-2,0,2,1,1,1,1,5,1
KR_6757771289,440,8,61,12,15,5,5,0,-1,1,2,2,3,1,5,9,4,4,4,0,0,13,-10,-1,8,7,2,0,2,1,1,1,1,4,1
KR_6743684958,420,-1,-7,-16,-1,-3,0,3,4,4,0,0,3,3,0,1,1,-2,0,2,0,3,154,-5,9,4,3,0,0,1,1,0,-1,4,1
KR_6716377958,420,6,84,8,16,10,11,1,4,4,0,-1,2,3,2,2,0,1,2,1,0,15,4,6,2,8,3,0,0,1,1,1,1,6,1
KR_6760344579,420,0,53,-20,2,2,3,1,-3,0,3,4,5,1,-1,1,2,0,1,1,0,-1,25,3,1,4,-31,0,0,-1,1,-1,1,6,1
KR_6663567479,420,6,54,28,14,0,2,2,8,10,2,2,2,0,5,5,0,-1,0,1,0,13,0,-2,7,5,-2,0,0,1,-1,1,-1,1,1
KR_6755065207,420,-2,17,-43,-3,2,4,2,1,1,0,-2,2,4,-4,2,6,0,1,1,0,3,3,2,2,4,-3,0,1,-1,1,1,-1,1,1
KR_6765978649,420,-2,-4,-8,-5,-3,4,7,-1,5,6,-2,0,2,1,1,0,0,1,1,0,-1,-6,-1,7,6,1,0,0,-1,-1,0,-1,5,1
KR_6698266238,420,0,-12,2,-1,3,3,0,2,2,0,0,4,4,-5,1,6,-1,2,3,0,-3,11,-4,6,2,0,0,0,1,-1,-1,1,6,1
KR_6649906580,420,1,45,-28,6,0,4,4,-2,2,4,8,9,1,-2,0,2,2,3,1,1,0,-1,-1,4,3,-1,0,1,1,1,1,1,1,1
KR_6763000757,420,-1,-15,-12,-3,-3,0,3,1,3,2,-2,0,2,1,5,4,0,2,2,0,3,7,2,7,9,1,0,-1,1,-1,-1,1,3,1
KR_6755476995,420,4,-21,0,5,0,0,0,7,7,0,-1,3,4,1,3,2,-2,0,2,0,5,8,-1,8,7,-2,0,0,-1,1,1,1,4,1
KR_6654914484,420,2,-26,27,11,-1,0,1,1,3,2,4,4,0,4,5,1,3,4,1,0,11,3,3,4,7,2,0,1,-1,1,1,1,6,1
KR_6724050406,420,1,55,20,8,-4,1,5,3,4,1,1,4,3,5,6,1,3,3,0,0,8,14,1,5,6,-3,0,-1,-1,-1,-1,1,1,1
KR_6583996834,420,4,17,-15,8,1,2,1,-1,1,2,1,3,2,2,3,1,5,6,1,0,10,-25,-6,9,3,16,0,2,1,1,1,1,2,1
KR_6722249568,420,1,13,11,9,3,4,1,0,4,4,1,2,1,6,6,0,-1,2,3,1,13,37,2,8,10,-1,0,0,1,1,1,1,2,1
KR_6766076051,420,2,74,4,0,3,4,1,-4,1,5,2,4,2,-1,0,1,0,0,0,0,-9,-7,-2,3,1,0,0,0,-1,1,1,1,3,1
KR_6676043696,420,0,17,-16,1,0,3,3,0,5,5,0,4,4,3,5,2,-2,0,2,0,4,6,5,2,7,-2,0,0,1,-1,0,-1,2,1
KR_6752501653,420,-4,-53,0,-2,1,2,1,-1,1,2,-1,0,1,0,2,2,-1,1,2,0,-1,9,-4,5,1,-3,0,1,-1,1,1,-1,6,1
KR_6767110548,420,1,-70,28,-4,-1,2,3,-1,2,3,0,2,2,-3,1,4,1,1,0,0,-8,12,3,5,8,-2,0,1,-1,1,1,1,6,1
KR_6768583141,420,1,9,8,3,2,2,0,1,1,0,-1,0,1,2,2,0,-1,0,1,0,1,1,-2,4,2,1,0,0,-1,1,0,1,2,1
KR_6721583180,420,5,97,12,15,1,2,1,-1,4,5,6,7,1,5,10,5,4,4,0,2,16,22,1,3,4,-31,0,3,1,1,1,-1,1,1
KR_6753329129,420,-3,3,-5,-5,9,9,0,-7,1,8,-3,0,3,-4,0,4,0,1,1,0,-11,1,1,6,7,1,0,0,1,1,1,1,5,1
KR_6380691770,420,2,76,17,0,2,2,0,0,3,3,-2,0,2,1,2,1,-1,0,1,0,2,2,1,4,5,0,0,0,-1,1,1,-1,5,1
KR_6756454533,440,4,109,52,10,-1,1,2,5,8,3,3,4,1,-4,0,4,7,7,0,0,2,0,2,4,6,-2,0,0,-1,1,1,-1,4,1
KR_6769191675,420,-3,-64,-12,1,-2,0,2,4,6,2,-2,1,3,2,3,1,-1,3,4,-1,2,-3,-1,3,2,-2,0,-2,1,-1,-1,-1,3,1
KR_6728624312,420,-2,-25,4,-4,-3,0,3,3,5,2,-2,2,4,-3,2,5,1,3,2,-1,-4,-14,-1,6,5,2,0,-1,1,1,-1,-1,2,1
KR_6663975295,420,3,48,17,9,-2,2,4,1,3,2,10,10,0,1,3,2,-1,0,1,0,5,10,2,4,6,-3,0,2,1,1,1,-1,2,1
KR_6766858405,420,3,15,49,8,3,3,0,3,3,0,4,6,2,-2,1,3,0,2,2,0,-2,21,0,5,5,-5,0,0,1,1,0,1,5,1
KR_6621097427,420,3,4,22,1,3,4,1,-1,2,3,0,1,1,-3,3,6,2,2,0,0,-3,8,-2,6,4,-1,0,0,1,1,0,1,5,1
KR_6739364416,420,3,-2,35,5,2,2,0,0,0,0,1,1,0,1,2,1,1,1,0,0,1,-11,-2,5,3,4,0,0,0,0,0,1,0,1
KR_6623603710,440,4,14,8,4,2,2,0,4,4,0,2,4,2,0,4,4,-4,0,4,-1,-4,-18,-2,4,2,1,0,0,1,1,1,-1,3,1
KR_6766917946,440,2,14,3,7,6,6,0,-1,3,4,-3,0,3,5,7,2,0,0,0,0,5,1,-1,4,3,0,0,2,1,0,-1,-1,6,1
KR_6673685822,420,3,-41,4,1,0,2,2,1,6,5,-2,1,3,1,4,3,1,2,1,0,-2,-12,-7,10,3,3,0,0,1,-1,0,1,1,1
KR_6628637828,420,4,95,0,6,5,7,2,-1,3,4,0,2,2,3,4,1,-1,0,1,1,-1,1,0,5,5,5,0,2,0,1,1,1,0,1
KR_5918984317,420,3,-21,0,7,-5,1,6,0,4,4,6,8,2,3,4,1,3,4,1,0,1,0,-2,5,3,0,0,1,1,1,1,1,3,1
KR_6768477138,440,-1,-17,-12,-3,-1,2,3,-3,0,3,-2,0,2,-2,3,5,5,6,1,0,3,1,3,2,5,-5,0,1,1,1,1,-1,3,1
KR_6768440749,420,2,41,-12,-1,3,3,0,-7,0,7,1,2,1,2,6,4,0,0,0,-1,-1,-16,-2,5,3,4,0,1,1,-1,1,-1,5,1
KR_6766471058,420,1,21,-1,11,3,5,2,2,2,0,-2,3,5,6,6,0,2,2,0,0,19,-3,-4,8,4,-1,0,2,1,1,1,1,5,1
KR_6684914253,420,-1,-69,-11,1,1,1,0,-1,2,3,-4,2,6,2,3,1,3,4,1,0,2,-1,1,6,7,5,0,0,1,-1,1,-1,1,1
KR_6675374933,420,-1,29,4,2,-1,0,1,-1,3,4,5,5,0,2,4,2,-3,2,5,-1,1,-14,5,3,8,1,0,2,1,-1,1,-1,4,1
KR_6768055547,420,4,61,7,9,0,5,5,-2,3,5,4,6,2,5,5,0,2,3,1,-1,-2,-5,-1,8,7,5,0,2,1,1,1,1,5,1
KR_6595224049,440,9,157,38,19,4,4,0,1,2,1,6,6,0,6,7,1,2,2,0,1,23,19,-1,4,3,0,0,4,0,1,1,1,0,1
KR_6764019526,420,0,26,0,-2,-5,1,6,-1,1,2,2,2,0,4,4,0,-2,2,4,0,-2,-142,0,2,2,2,0,0,1,1,1,-1,2,1
KR_6616322329,420,2,9,28,2,0,1,1,1,4,3,1,2,1,2,3,1,-2,2,4,0,-3,-10,-4,4,0,-2,0,1,1,-1,1,-1,4,1
KR_6768076542,440,-1,33,-20,6,4,4,0,0,3,3,-3,2,5,6,11,5,-1,0,1,3,14,-2,1,7,8,-2,0,1,-1,0,1,1,2,1
KR_6637447561,420,2,-18,1,1,0,1,1,3,3,0,-1,1,2,-2,3,5,1,1,0,0,5,1,3,3,6,-1,0,1,-1,1,1,-1,6,1
KR_6768277679,420,4,-27,20,0,2,4,2,-2,3,5,-1,1,2,-2,0,2,3,3,0,0,0,-7,-3,5,2,3,0,0,1,1,0,-1,6,1
KR_6741153326,420,7,92,67,17,11,13,2,7,9,2,-3,0,3,3,5,2,-1,0,1,5,22,7,6,1,7,4,0,3,1,1,1,1,1,1
KR_6762423081,420,7,80,37,19,2,2,0,3,5,2,3,6,3,11,11,0,0,2,2,0,11,15,3,5,8,-1,0,0,1,-1,1,-1,1,1
KR_6767788875,420,5,-19,11,8,1,6,5,2,2,0,8,9,1,-4,1,5,1,4,3,-3,1,6,0,4,4,-1,0,1,-1,1,1,-1,3,1
KR_6762243201,420,-1,35,-12,4,5,6,1,-2,1,3,-1,1,2,4,8,4,-2,0,2,0,-3,-255,2,2,4,-2,0,2,-1,1,1,-1,5,1
KR_6734393409,420,4,29,24,9,1,2,1,6,8,2,-2,2,4,2,5,3,2,2,0,1,9,-8,1,6,7,-1,0,1,1,1,1,-1,1,1
KR_6755547440,420,1,4,8,8,-3,1,4,5,5,0,-1,0,1,8,8,0,-1,0,1,1,7,-5,3,3,6,2,0,1,1,1,1,1,6,1
KR_6755388281,420,3,81,24,14,1,3,2,2,3,1,4,6,2,6,8,2,1,1,0,0,21,2,-2,6,4,4,0,0,1,-1,1,1,4,1
KR_6691772512,420,1,8,40,1,-1,3,4,1,2,1,-3,0,3,-1,2,3,5,6,1,0,4,1,-2,4,2,0,0,2,-1,0,1,-1,3,1
KR_6743796293,420,6,59,25,11,1,1,0,5,6,1,3,4,1,1,3,2,1,1,0,0,6,-132,1,7,8,3,0,2,1,1,1,1,1,1
KR_6757453245,420,3,63,9,7,1,1,0,0,3,3,1,1,0,4,4,0,1,2,1,0,11,223,2,4,6,-4,0,2,1,1,1,-1,3,1
KR_6729625312,440,-2,-88,-8,1,0,1,1,-2,0,2,7,9,2,-4,3,7,0,0,0,1,2,10,3,3,6,1,0,-2,1,-1,-1,1,1,1
KR_6696435968,420,4,4,15,5,-1,0,1,2,2,0,6,7,1,-2,5,7,0,0,0,0,12,0,2,2,4,0,0,0,1,1,0,1,1,1
KR_6613263709,420,5,36,12,13,3,4,1,1,4,3,9,12,3,2,3,1,-2,0,2,0,17,-1,5,4,9,-5,0,1,1,-1,1,-1,5,1
KR_6768194019,420,-3,-16,-15,-6,2,2,0,0,3,3,-5,3,8,-1,0,1,-2,2,4,0,1,-34,-2,4,2,-3,0,-1,-1,1,1,-1,6,1
KR_6757499381,420,2,31,16,6,3,5,2,0,3,3,0,2,2,2,4,2,1,1,0,1,2,267,0,5,5,2,0,0,1,1,1,1,6,1
KR_6675816080,420,3,-34,21,13,3,4,1,3,4,1,2,2,0,2,4,2,3,5,2,0,18,122,4,3,7,-1,0,3,1,1,1,1,5,1
KR_6661422725,420,3,37,-23,7,3,3,0,4,5,1,3,5,2,-4,1,5,1,4,3,0,6,40,3,3,6,-3,0,0,-1,1,-1,-1,3,1
KR_6749154332,420,3,30,11,0,1,1,0,0,2,2,-2,1,3,-1,3,4,2,2,0,0,-8,10,0,4,4,-1,0,0,1,-1,-1,-1,2,1
KR_6578818563,420,1,-20,-17,2,5,5,0,-4,2,6,-1,1,2,3,4,1,-1,0,1,0,-1,-18,-1,6,5,1,0,1,-1,-1,1,1,1,1
KR_6765625321,440,0,37,-31,3,3,3,0,-4,4,8,3,3,0,1,6,5,0,1,1,1,11,14,6,5,11,-2,0,2,1,-1,1,1,3,1
KR_6753126942,420,2,17,-6,0,3,3,0,-1,3,4,1,3,2,0,2,2,-3,2,5,0,-1,-6,-3,7,4,-1,0,-1,-1,-1,-1,1,1,1
KR_6760493952,420,5,57,9,11,4,5,1,1,2,1,3,10,7,1,5,4,2,3,1,1,2,-10,-4,8,4,3,0,2,1,-1,1,1,1,1
KR_6752700606,420,4,-59,24,7,-1,1,2,3,7,4,5,8,3,1,3,2,-1,0,1,0,4,-198,2,1,3,5,0,1,0,0,1,-1,0,1
KR_6757434328,420,2,6,34,8,-3,1,4,8,9,1,1,6,5,0,3,3,2,3,1,0,0,-15,2,1,3,3,0,0,1,-1,-1,1,1,1
KR_6761731228,440,1,39,13,-1,0,1,1,-5,0,5,2,2,0,-3,3,6,5,5,0,0,-9,7,-2,5,3,-5,0,1,-1,1,1,-1,1,1
KR_6756536401,420,5,76,12,12,5,6,1,4,6,2,-1,0,1,5,5,0,-1,0,1,0,3,-3,1,5,6,-1,0,2,1,-1,1,1,4,1
KR_6701650842,420,6,100,-8,12,2,4,2,2,2,0,4,4,0,4,4,0,0,1,1,1,11,14,-1,5,4,1,0,1,1,1,1,1,5,1
KR_6746479407,420,3,-17,3,3,-2,0,2,-1,1,2,1,5,4,4,6,2,1,2,1,0,7,127,-1,6,5,0,0,1,1,0,1,1,5,1
KR_6769157961,420,-1,-66,8,-1,-1,0,1,2,2,0,-2,0,2,0,2,2,0,0,0,0,3,36,-2,4,2,0,0,0,-1,-1,0,-1,2,1
KR_6766670668,440,-1,28,-19,-3,2,4,2,-1,1,2,-1,2,3,-2,1,3,-1,1,2,-1,-7,-7,-1,5,4,1,0,1,-1,1,1,-1,2,1
KR_6769066254,420,4,59,0,13,1,1,0,-1,5,6,5,6,1,6,8,2,2,3,1,2,15,-11,5,1,6,1,0,1,-1,1,1,1,6,1
KR_6761385211,420,-2,39,-4,3,4,5,1,1,3,2,-2,2,4,0,3,3,0,0,0,1,2,-10,-1,7,6,0,0,-1,1,1,-1,1,4,1
KR_6755446249,420,4,123,61,6,0,1,1,4,4,0,2,5,3,1,3,2,-1,2,3,1,12,0,0,2,2,2,0,1,1,1,1,1,4,1
KR_6758649372,420,4,86,21,9,4,4,0,2,4,2,0,1,1,1,4,3,2,2,0,1,4,7,3,3,6,-1,0,1,1,1,1,1,6,1
KR_6750225787,420,4,51,34,6,5,5,0,4,4,0,1,2,1,-6,3,9,2,5,3,1,2,4,3,1,4,0,0,0,-1,1,1,1,5,1
KR_6732781362,420,6,1,17,12,2,3,1,4,5,1,3,5,2,0,1,1,3,3,0,0,11,-7,1,5,6,2,0,2,-1,1,1,1,2,1
KR_6764297464,420,1,40,4,-4,-1,1,2,-1,1,2,-3,1,4,2,7,5,-1,0,1,0,-5,-6,1,7,8,4,0,0,-1,-1,0,1,1,1
KR_6765965804,420,2,50,-16,1,0,3,3,-1,2,3,3,3,0,0,2,2,-1,1,2,0,4,-1,-1,6,5,4,0,0,1,0,0,1,3,1
KR_6682543786,420,2,55,12,10,6,6,0,1,4,3,-1,3,4,4,7,3,0,0,0,1,4,9,4,2,6,1,0,2,1,1,1,1,4,1
KR_6759868026,420,2,77,10,8,3,4,1,-1,4,5,3,4,1,1,4,3,2,2,0,0,-4,14,0,3,3,-1,0,3,1,1,1,1,6,1
KR_6743585452,420,-2,11,4,-6,-1,1,2,-1,3,4,1,3,2,-3,0,3,-2,0,2,0,-11,0,-1,7,6,0,0,0,-1,-1,-1,-1,5,1
KR_6672829801,420,2,16,-4,3,2,3,1,-2,1,3,3,5,2,-1,1,2,1,1,0,0,-1,-7,1,3,4,-4,0,1,-1,1,1,-1,1,1
KR_6626967671,420,1,67,-38,11,-1,1,2,1,3,2,3,4,1,5,7,2,3,4,1,0,11,-2,-3,6,3,1,0,1,1,1,1,1,3,1
KR_6672953580,420,3,-22,13,4,8,8,0,1,1,0,-4,0,4,0,1,1,-1,0,1,0,0,-53,-3,3,0,1,0,0,1,-1,1,-1,1,1
KR_6723928206,420,2,68,25,2,1,1,0,1,3,2,3,3,0,-2,1,3,-1,1,2,0,0,-64,0,3,3,0,0,0,1,1,0,1,6,1
KR_6730187900,420,3,49,24,-1,2,2,0,-4,2,6,1,2,1,0,2,2,0,1,1,0,-6,1,4,5,9,3,0,1,1,1,1,-1,6,1
KR_6731268669,420,4,62,17,5,4,4,0,0,0,0,-1,2,3,1,4,3,1,1,0,0,10,-1,-1,8,7,1,0,1,1,1,1,-1,6,1
KR_6664137017,420,0,34,-9,7,7,7,0,-1,3,4,1,4,3,-1,2,3,1,2,1,-1,-5,8,4,7,11,0,0,0,0,-1,-1,-1,0,1
KR_6766029590,420,7,70,-5,17,3,4,1,-1,1,2,1,3,2,9,9,0,5,5,0,0,17,115,2,4,6,2,0,2,1,1,1,1,5,1
KR_6766077552,420,7,89,40,15,1,2,1,2,2,0,7,7,0,-2,2,4,7,7,0,0,9,-1,-5,8,3,9,0,2,1,-1,1,1,2,1
KR_6677107331,440,2,134,-20,-7,-4,1,5,-3,2,5,-3,2,5,2,3,1,1,5,4,-1,-10,5,3,2,5,-2,0,1,-1,1,-1,-1,6,1
KR_6721536833,420,1,-20,-37,4,1,1,0,-1,2,3,-1,3,4,6,6,0,-1,1,2,0,7,-2,3,4,7,0,0,0,1,-1,1,-1,6,1
KR_6679693626,420,3,7,-4,8,-2,0,2,3,4,1,6,7,1,1,1,0,0,0,0,0,11,-14,1,4,5,3,0,2,1,1,1,-1,4,1
KR_6767451752,420,3,21,-5,2,0,1,1,4,6,2,-4,1,5,1,1,0,1,1,0,1,6,19,4,2,6,0,0,-1,1,-1,-1,1,1,1
KR_6764924613,420,5,94,-15,15,8,8,0,2,2,0,3,4,1,3,4,1,-1,0,1,0,13,14,0,2,2,2,0,3,1,1,1,-1,1,1
KR_6759648154,440,2,-7,-1,8,2,3,1,4,4,0,-1,1,2,2,6,4,1,1,0,0,12,-2,1,3,4,2,0,1,1,1,1,1,2,1
KR_6767203406,420,-1,74,-4,2,4,5,1,-2,0,2,-6,1,7,1,2,1,5,6,1,2,10,4,-2,6,4,-3,0,0,-1,-1,0,1,1,1
KR_6726902904,440,1,72,-32,14,-3,1,4,-1,1,2,0,1,1,8,9,1,10,10,0,5,27,50,2,2,4,-25,0,2,1,-1,1,1,3,1
KR_6756539483,420,5,13,-16,13,2,2,0,5,7,2,4,6,2,2,4,2,0,2,2,0,17,-1,0,5,5,2,0,1,1,1,1,-1,2,1
KR_6766845694,420,1,47,-4,9,1,1,0,0,3,3,4,5,1,3,7,4,1,1,0,0,8,0,-1,5,4,3,0,0,0,-1,0,1,0,1
KR_6733173891,420,4,27,9,11,5,6,1,0,0,0,4,4,0,2,4,2,0,1,1,0,5,-2,2,3,5,-4,0,2,-1,1,1,1,2,1
KR_6760019190,440,4,26,19,9,6,7,1,-1,2,3,-3,1,4,4,4,0,3,3,0,0,12,6,4,2,6,-3,0,0,-1,1,-1,-1,3,1
KR_6768218659,420,1,39,-8,2,-1,1,2,0,3,3,3,5,2,0,5,5,0,1,1,0,-1,44,0,5,5,-34,0,0,1,1,1,-1,4,1
KR_6761472906,440,3,35,9,5,0,1,1,0,3,3,3,4,1,2,2,0,0,0,0,0,3,-6,-1,7,6,5,0,1,-1,0,1,-1,2,1
KR_6761288880,420,2,48,5,8,-2,0,2,1,1,0,2,4,2,7,8,1,0,0,0,0,6,-7,1,5,6,3,0,1,1,-1,1,1,3,1
KR_6750381358,420,-1,-38,0,3,-2,2,4,0,2,2,9,11,2,-6,1,7,2,3,1,1,3,48,1,3,4,-23,0,0,1,0,-1,1,1,1
KR_6596624783,420,5,-3,18,12,1,1,0,11,11,0,4,4,0,-1,2,3,-3,0,3,0,8,8,-2,8,6,2,0,1,-1,1,1,-1,2,1
KR_6742563344,420,-1,-14,-35,-6,0,1,1,-3,3,6,-6,5,11,2,5,3,1,1,0,0,9,-4,-2,5,3,2,0,-1,0,-1,-1,1,0,1
KR_6661017013,420,-1,-5,17,-1,0,1,1,3,5,2,3,3,0,-4,1,5,-3,0,3,0,-2,-3,-2,4,2,-2,0,0,-1,-1,0,1,3,1
KR_6767289022,420,0,5,-19,6,1,1,0,0,2,2,-2,0,2,6,6,0,1,1,0,0,1,7,3,2,5,-3,0,1,-1,0,1,1,2,1
KR_6667586688,420,-4,11,-25,-1,-1,2,3,1,1,0,2,3,1,0,2,2,-3,0,3,0,3,32,5,1,6,3,0,1,0,0,1,1,0,1
KR_6754188814,420,1,137,16,9,3,5,2,1,2,1,-3,1,4,10,15,5,-2,0,2,0,-5,-5,-7,11,4,2,0,1,-1,-1,1,1,5,1
KR_6758346004,420,0,-6,23,3,-4,0,4,3,4,1,-2,1,3,7,7,0,-1,0,1,0,6,-1,3,3,6,-1,0,1,1,-1,1,-1,4,1
KR_6767195350,420,1,31,4,-8,2,3,1,-3,2,5,-2,0,2,-5,0,5,0,1,1,0,-14,-10,0,2,2,-3,0,0,-1,1,0,-1,6,1
KR_6674931368,420,-1,-32,12,1,1,4,3,4,5,1,0,2,2,-5,2,7,1,1,0,0,6,-106,-3,6,3,-4,0,0,1,1,0,1,5,1
KR_6594359984,420,1,24,4,5,1,3,2,-2,2,4,-1,3,4,6,6,0,1,1,0,0,6,7,4,4,8,0,0,2,1,1,1,1,1,1
KR_6715625273,420,2,-16,4,5,-2,0,2,7,8,1,-1,2,3,0,6,6,1,1,0,0,16,-92,-6,8,2,0,0,-1,-1,-1,-1,-1,3,1
KR_6665645138,420,2,62,-41,7,0,2,2,6,7,1,4,7,3,3,3,0,-6,0,6,0,16,-41,-4,6,2,2,0,1,-1,1,-1,-1,5,1
KR_6738458751,420,2,65,26,7,2,2,0,2,5,3,0,1,1,4,6,2,-1,0,1,1,6,-3,-3,4,1,1,0,3,1,1,1,1,2,1
KR_6674948079,420,-1,-9,12,0,2,3,1,0,5,5,-1,1,2,-2,0,2,1,1,0,0,-5,-54,-1,4,3,0,0,1,-1,1,1,1,4,1
KR_6730724600,420,-1,-11,17,-2,2,2,0,1,3,2,0,5,5,1,3,2,-6,1,7,1,1,200,1,3,4,1,0,0,-1,-1,-1,1,4,1
KR_6748496153,440,2,42,28,3,1,1,0,0,1,1,0,3,3,2,3,1,0,1,1,0,0,-5,0,5,5,2,0,1,1,1,1,-1,1,1
KR_6751277554,420,3,27,4,11,0,0,0,1,4,3,2,3,1,6,8,2,2,2,0,0,9,-181,3,2,5,2,0,1,1,0,1,-1,5,1
KR_6729330269,420,6,35,20,8,4,4,0,0,2,2,-1,5,6,1,6,5,4,5,1,2,10,34,0,2,2,-3,0,1,-1,-1,1,1,1,1
KR_6746540937,420,5,22,-12,18,4,6,2,2,3,1,7,8,1,6,10,4,-1,1,2,-2,13,7,-1,5,4,2,0,1,1,-1,1,-1,4,1
KR_6762885988,420,4,56,31,7,0,4,4,2,4,2,2,3,1,1,1,0,2,3,1,1,5,-4,1,5,6,-1,0,1,1,1,1,1,3,1
KR_6703907459,420,5,55,26,14,4,5,1,2,2,0,-2,0,2,10,10,0,0,2,2,0,9,2,3,2,5,2,0,3,1,1,1,1,5,1
KR_6720150195,420,1,99,0,3,2,4,2,-2,3,5,0,1,1,3,4,1,0,5,5,0,-4,0,-3,5,2,6,0,2,0,-1,1,1,0,1
KR_6746987402,420,0,50,-12,2,1,2,1,2,5,3,-3,2,5,3,5,2,-1,2,3,1,4,-25,-2,4,2,2,0,1,1,1,1,1,4,1
KR_6767605355,420,2,85,12,7,4,5,1,2,2,0,-3,2,5,4,6,2,0,2,2,0,10,15,-3,7,4,-6,0,2,1,1,1,-1,3,1
KR_6728545979,420,-1,-47,-4,-3,0,0,0,2,7,5,-3,0,3,-3,2,5,1,1,0,-1,-1,18,0,4,4,2,0,0,0,1,0,-1,0,1
KR_6753785595,420,-1,5,29,-2,0,1,1,-1,2,3,2,3,1,-1,2,3,-2,1,3,0,0,-4,-4,6,2,2,0,0,1,-1,0,-1,1,1
KR_6688647513,420,7,30,0,13,2,3,1,1,3,2,6,7,1,3,7,4,1,1,0,-1,10,27,-1,6,5,0,0,2,1,1,1,-1,2,1
KR_6691636680,420,5,69,34,7,2,5,3,4,4,0,0,3,3,2,6,4,-1,1,2,0,9,2,1,3,4,-1,0,1,1,-1,1,1,5,1
KR_6754399937,420,6,89,0,19,3,4,1,2,4,2,7,9,2,6,7,1,1,1,0,1,15,-38,2,4,6,31,0,0,-1,1,1,1,4,1
KR_6760420861,420,5,95,18,15,2,3,1,7,8,1,3,6,3,-2,0,2,5,6,1,1,10,4,-5,9,4,7,0,2,-1,1,1,1,5,1
KR_6656414170,420,1,35,12,10,5,6,1,6,9,3,0,0,0,-1,5,6,0,0,0,0,9,63,7,3,10,-14,0,2,1,-1,1,1,5,1
KR_6761328284,440,-3,26,-28,-6,-2,2,4,-3,2,5,0,5,5,-1,2,3,0,1,1,0,0,129,5,2,7,-1,0,-2,-1,-1,-1,-1,2,1
KR_6665917313,420,3,41,6,2,-2,0,2,-1,1,2,-4,0,4,7,8,1,2,2,0,0,4,3,2,1,3,-2,0,1,-1,1,1,1,6,1
KR_6756833771,420,2,9,-11,6,3,5,2,1,2,1,3,6,3,1,2,1,-2,1,3,0,-3,0,1,4,5,1,0,1,-1,1,1,-1,6,1
KR_6636010575,420,-3,-14,-7,-7,-3,2,5,0,3,3,-1,1,2,-3,0,3,0,1,1,0,-4,-1,-3,5,2,-2,0,0,1,0,0,1,5,1
KR_6761810832,440,1,37,-1,-3,4,4,0,-4,2,6,0,3,3,-5,2,7,2,3,1,1,-4,-1,-3,5,2,-3,0,1,-1,1,1,1,3,1
KR_6759250304,420,3,70,12,12,0,1,1,0,1,1,1,2,1,6,12,6,5,5,0,0,15,15,7,2,9,-1,0,3,1,1,1,1,4,1
KR_6746843506,420,3,16,12,11,-1,0,1,9,10,1,4,4,0,-2,5,7,1,2,1,0,12,-18,1,6,7,0,0,0,1,0,1,1,6,1
KR_6765407939,420,2,-1,-12,2,-8,1,9,0,2,2,-2,1,3,6,9,3,6,7,1,0,12,302,2,1,3,-2,0,0,1,1,-1,-1,2,1
KR_6738278672,420,2,44,0,4,2,2,0,3,4,1,-3,2,5,3,4,1,-1,0,1,0,5,0,0,3,3,-1,0,1,-1,1,1,1,5,1
KR_6698045860,420,3,78,0,6,-4,0,4,1,2,1,3,6,3,1,5,4,5,5,0,0,5,48,1,4,5,-28,0,0,-1,-1,1,-1,4,1
KR_6766699541,420,-2,-110,-29,-4,-1,0,1,0,1,1,-2,1,3,1,3,2,-2,1,3,0,-3,18,-1,6,5,-4,0,-1,-1,-1,-1,-1,5,1
KR_6757370443,420,1,-78,-2,2,0,2,2,7,7,0,2,3,1,-6,4,10,-1,0,1,0,0,-27,-3,7,4,2,0,-1,-1,1,-1,-1,6,1
KR_6763749080,420,3,-15,26,7,5,6,1,3,4,1,-3,0,3,2,4,2,0,1,1,2,7,-7,-4,7,3,3,0,1,1,1,1,1,3,1
KR_6737867279,420,3,-44,2,3,-3,1,4,-2,1,3,3,4,1,3,3,0,2,3,1,0,7,-2,1,5,6,-5,0,-1,1,-1,-1,-1,3,1
KR_6740420065,420,0,57,-48,-2,1,2,1,-2,1,3,-1,2,3,0,4,4,0,1,1,-1,1,-5,0,5,5,2,0,2,0,1,1,-1,0,1
KR_6710750634,420,4,27,20,6,5,5,0,-4,2,6,4,5,1,2,3,1,-1,0,1,1,6,8,6,4,10,1,0,0,1,0,1,1,2,1
KR_6702733547,420,6,86,1,13,-2,4,6,4,5,1,5,6,1,3,7,4,3,4,1,0,16,9,-1,7,6,-4,0,2,1,0,1,1,4,1
KR_6757406347,420,3,34,3,5,-1,3,4,3,4,1,4,6,2,-4,1,5,3,3,0,-1,6,-1,-1,3,2,-1,0,0,1,-1,1,-1,1,1
KR_6767502703,420,1,32,39,-4,0,0,0,1,1,0,-1,0,1,-1,3,4,-3,0,3,0,-4,174,1,3,4,2,0,0,-1,1,-1,-1,4,1
KR_6724923997,420,3,52,-21,7,3,3,0,4,4,0,-2,1,3,2,5,3,0,0,0,1,10,-8,3,4,7,-2,0,0,1,-1,0,1,1,1
KR_6764601460,420,-2,-39,-55,-5,-1,0,1,-5,1,6,-3,0,3,4,5,1,0,0,0,0,-7,38,-1,5,4,-19,0,0,-1,-1,0,1,2,1
KR_6576034818,420,-1,-29,3,-6,-4,4,8,-6,1,7,-1,3,4,5,8,3,0,2,2,-2,-1,180,0,3,3,1,0,-1,-1,-1,-1,-1,6,1
KR_6744730808,420,8,43,-5,19,1,2,1,7,9,2,6,6,0,2,5,3,3,3,0,0,19,0,-1,5,4,0,0,2,0,1,1,1,0,1
KR_6612637718,420,0,-100,-6,5,-1,1,2,7,8,1,1,3,2,0,3,3,-2,0,2,0,11,-10,-1,4,3,1,0,-1,-1,1,-1,-1,6,1
KR_6613904830,420,-3,-28,27,1,2,5,3,-4,1,5,7,10,3,-2,4,6,-2,0,2,0,-1,-20,1,5,6,-2,0,-2,1,1,-1,-1,6,1
KR_6623732681,440,-1,13,-4,-7,-1,1,2,-7,1,8,1,3,2,0,0,0,0,0,0,0,-3,19,-3,9,6,2,0,0,1,-1,0,-1,5,1
KR_6605707463,420,2,-14,28,2,0,1,1,2,4,2,2,2,0,-3,1,4,1,1,0,0,-2,-20,-4,7,3,9,0,1,-1,1,1,1,6,1
KR_6721595934,420,0,32,17,4,0,3,3,3,3,0,6,8,2,-5,3,8,0,1,1,-1,3,23,4,2,6,-6,0,0,0,1,1,1,0,1
KR_6729841258,440,-3,-138,-5,-5,-2,4,6,0,3,3,0,0,0,-4,0,4,1,9,8,0,-4,-16,-1,4,3,0,0,-2,1,-1,-1,-1,1,1
KR_6749931040,420,1,45,8,0,3,4,1,-1,3,4,-3,0,3,1,2,1,0,0,0,0,-1,23,1,3,4,-5,0,0,1,-1,0,-1,5,1
KR_6630795681,420,1,69,22,-2,-3,1,4,-4,1,5,3,7,4,0,3,3,2,2,0,0,2,16,0,6,6,-4,0,1,-1,-1,-1,1,4,1
KR_6765565735,420,0,76,-28,-7,2,2,0,-4,0,4,-2,1,3,-3,2,5,0,3,3,0,-6,4,0,7,7,-1,0,0,-1,-1,1,1,4,1
KR_6738484876,420,0,10,-11,-2,2,2,0,0,3,3,-4,0,4,2,2,0,-2,0,2,0,-9,-16,-1,8,7,1,0,1,-1,1,1,-1,3,1
KR_6755754354,440,1,-18,16,3,-3,0,3,5,9,4,3,4,1,-2,0,2,0,0,0,0,5,-9,-4,8,4,-1,0,-1,1,-1,-1,-1,3,1
KR_6758439740,420,1,40,-4,5,2,4,2,1,2,1,-4,1,5,6,6,0,0,1,1,2,2,5,-1,11,10,-2,0,-1,1,-1,1,1,5,1
KR_6659397414,420,0,19,-15,1,-3,1,4,-3,3,6,1,2,1,4,7,3,2,2,0,1,4,4,3,2,5,-2,0,0,1,-1,-1,1,1,1
KR_6720931925,420,0,14,-13,8,-2,1,3,2,5,3,-1,1,2,3,3,0,6,9,3,0,7,10,1,6,7,-1,0,0,1,-1,0,1,5,1
KR_6731587172,420,2,49,18,9,2,3,1,-2,3,5,3,5,2,6,7,1,0,0,0,0,12,44,2,6,8,-26,0,1,1,1,1,1,2,1
KR_6614065202,420,2,2,-7,6,2,3,1,0,4,4,1,1,0,4,5,1,-1,1,2,0,6,7,0,5,5,-1,0,0,1,-1,0,1,5,1
KR_6759215841,420,5,56,4,7,2,3,1,4,4,0,-2,0,2,2,2,0,1,1,0,0,6,6,3,1,4,-1,0,0,0,1,0,1,0,1
KR_6766171214,420,2,47,-32,6,4,4,0,0,3,3,-2,6,8,2,3,1,2,4,2,0,16,62,2,3,5,-20,0,0,1,-1,1,-1,5,1
KR_6716924947,420,4,5,31,3,2,6,4,2,2,0,3,4,1,-3,2,5,-1,0,1,0,11,-1,1,4,5,3,0,-1,-1,-1,-1,1,4,1
KR_6768733856,420,2,-4,7,13,6,8,2,8,8,0,1,3,2,-2,1,3,0,1,1,0,7,33,4,1,5,-4,0,0,0,0,1,1,0,1
KR_6760986034,420,1,120,-10,4,1,2,1,0,0,0,-2,1,3,2,6,4,3,3,0,0,5,8,-2,8,6,3,0,1,1,0,1,1,2,1
KR_6766350417,420,2,15,8,2,-3,3,6,4,4,0,2,5,3,-1,0,1,0,0,0,0,3,-1,1,3,4,-2,0,0,1,-1,-1,1,3,1
KR_6627035028,420,4,16,0,5,0,0,0,7,8,1,0,1,1,-2,1,3,0,0,0,0,10,7,0,5,5,-4,0,1,1,-1,1,1,1,1
KR_6623555887,440,4,99,36,5,0,1,1,-5,1,6,-1,2,3,7,8,1,4,4,0,1,5,2,-1,7,6,6,0,3,1,1,1,1,6,1
KR_6726701469,440,4,88,37,9,0,1,1,7,9,2,6,6,0,-4,2,6,0,1,1,1,-6,28,-3,6,3,-2,0,2,-1,1,1,1,6,1
KR_6737787288,420,2,45,-27,2,2,2,0,-2,1,3,2,5,3,0,1,1,0,2,2,0,0,-300,4,0,4,14,0,1,1,-1,1,1,2,1
KR_6737958265,420,8,106,76,10,2,2,0,4,8,4,1,2,1,1,3,2,2,2,0,0,3,12,-1,4,3,0,0,3,1,1,1,1,4,1
KR_6759505846,440,-1,9,16,8,2,4,2,3,6,3,-2,2,4,4,6,2,1,5,4,1,-5,10,-1,7,6,0,0,1,1,0,1,1,4,1
KR_6741871816,420,2,-38,3,13,-2,0,2,10,11,1,0,0,0,4,7,3,1,2,1,0,12,112,-2,7,5,-4,0,2,1,1,1,1,3,1
KR_6739604647,420,3,-22,-4,9,1,1,0,4,5,1,4,4,0,0,3,3,0,0,0,0,5,-248,6,1,7,-2,0,1,-1,1,1,1,2,1
KR_6659877860,420,-2,-47,18,-6,-5,0,5,4,5,1,-1,1,2,-2,1,3,-2,0,2,0,-4,4,5,4,9,0,0,-1,-1,1,-1,-1,6,1
KR_6763284783,420,3,30,9,5,1,1,0,-1,1,2,8,8,0,-1,1,2,-2,0,2,0,4,-45,-1,2,1,19,0,0,1,1,1,1,2,1
KR_6742224152,420,-1,16,-28,7,4,5,1,1,4,3,3,3,0,-2,1,3,1,1,0,0,1,4,2,3,5,2,0,1,-1,0,1,1,3,1
KR_6749414430,440,-1,23,0,-1,-3,0,3,1,2,1,-3,1,4,3,3,0,1,2,1,0,3,-25,0,4,4,-1,0,0,1,-1,0,1,1,1
KR_6738330075,420,2,90,-8,9,-1,1,2,-1,0,1,2,2,0,5,5,0,4,4,0,0,9,10,2,5,7,0,0,1,1,1,1,-1,1,1
KR_6765073981,420,-2,-50,16,2,2,2,0,3,6,3,0,4,4,-1,4,5,-2,0,2,1,7,7,4,2,6,-5,0,1,1,1,1,1,5,1
KR_6769228058,420,6,133,29,11,2,5,3,1,2,1,7,8,1,2,3,1,-1,1,2,0,6,13,-1,5,4,1,1,3,1,1,1,1,4,1
KR_6740797501,420,-2,1,13,-5,-1,1,2,-3,1,4,1,4,3,-2,1,3,0,1,1,0,-7,-2,4,6,10,-1,0,-1,0,-1,-1,1,0,1
KR_6753477726,420,1,7,-16,-1,-1,0,1,5,6,1,-2,1,3,-4,2,6,1,1,0,0,2,3,0,8,8,-1,0,-1,1,-1,-1,-1,4,1
KR_6765859970,420,-3,-33,24,-4,-3,0,3,3,6,3,0,2,2,-2,4,6,-2,0,2,0,2,-1,0,8,8,6,0,0,1,1,0,-1,6,1
KR_6747738015,420,2,16,-6,8,3,4,1,-5,1,6,4,4,0,8,11,3,-2,0,2,0,10,-27,-6,9,3,7,0,1,1,1,1,1,1,1
KR_6763237087,420,-1,-52,-24,2,1,1,0,-2,1,3,2,3,1,2,3,1,-1,0,1,0,2,146,-2,8,6,2,0,0,-1,-1,0,-1,6,1
KR_6767328491,420,1,2,11,1,-1,2,3,2,3,1,-1,4,5,1,2,1,0,0,0,1,2,7,2,3,5,-4,0,-1,-1,-1,-1,-1,1,1
KR_6609700556,420,0,41,11,4,1,3,2,-6,3,9,2,3,1,4,4,0,3,3,0,0,5,30,5,1,6,-5,0,1,-1,1,1,1,5,1
KR_6609945634,420,7,34,27,13,4,4,0,4,4,0,1,3,2,4,5,1,0,1,1,0,16,-20,-4,7,3,2,0,2,1,1,1,1,6,1
KR_6729570553,440,5,92,13,14,3,4,1,3,5,2,4,5,1,6,7,1,-2,3,5,1,24,59,5,2,7,10,0,1,0,0,1,1,0,1
KR_6767433076,420,1,45,-7,8,6,7,1,-4,2,6,3,5,2,2,4,2,1,3,2,0,-1,0,-1,6,5,-1,0,1,-1,1,1,1,2,1
KR_6634018506,420,1,36,1,0,-1,3,4,2,4,2,-3,0,3,0,2,2,2,2,0,-1,1,-6,-4,7,3,-3,0,2,1,-1,1,-1,3,1
KR_6753976694,420,2,-65,12,5,3,4,1,1,4,3,1,3,2,-2,4,6,2,2,0,0,5,7,4,1,5,-6,0,0,-1,1,0,1,1,1
KR_6530756622,440,5,124,-2,6,1,1,0,1,2,1,2,3,1,0,4,4,2,4,2,-1,6,2,-6,9,3,0,0,0,1,1,1,-1,1,1
KR_6764544569,420,5,46,12,11,2,2,0,1,2,1,5,5,0,1,4,3,2,2,0,0,6,-92,-1,3,2,2,0,2,-1,1,1,1,2,1
KR_6732018108,440,3,-7,-16,8,0,2,2,3,4,1,4,5,1,-2,3,5,3,3,0,0,5,84,-3,6,3,3,0,1,1,-1,1,-1,2,1
KR_6765687870,440,5,49,1,4,-2,1,3,3,5,2,1,3,2,4,5,1,-2,3,5,0,1,-14,-1,4,3,4,0,2,-1,1,1,-1,3,1
KR_6722927917,440,2,-5,-12,-1,0,0,0,-2,0,2,0,3,3,0,4,4,1,1,0,0,-5,-17,6,5,11,-2,0,0,0,0,0,-1,0,1
KR_6739163128,420,-4,-3,-20,-2,1,4,3,-2,1,3,4,4,0,-5,1,6,0,0,0,0,-9,2,5,1,6,-2,0,-1,-1,1,-1,1,5,1
KR_6764662755,420,0,-19,6,-3,0,3,3,-2,0,2,3,7,4,-6,0,6,2,3,1,0,-4,-13,-8,10,2,5,0,0,1,1,1,1,2,1
KR_6722053976,420,0,23,0,5,5,5,0,1,3,2,5,6,1,-3,2,5,-3,0,3,1,-7,-5,-3,7,4,0,0,0,-1,-1,-1,1,4,1
KR_6763592285,420,-1,-73,8,0,-4,0,4,4,5,1,-3,5,8,1,3,2,2,2,0,0,12,129,-1,4,3,2,0,1,0,-1,-1,-1,0,1
KR_6732468650,420,5,65,-20,3,-6,2,8,0,1,1,2,3,1,12,14,2,-5,0,5,1,15,-1,3,1,4,-2,0,3,-1,-1,1,1,1,1
KR_6746423297,420,0,2,25,-2,-7,0,7,1,1,0,3,4,1,1,1,0,0,2,2,0,1,-38,1,2,3,6,0,0,1,1,1,-1,3,1
KR_6661617049,440,-2,3,-12,3,2,2,0,-1,5,6,1,5,4,2,5,3,-1,1,2,1,6,-4,-2,6,4,1,0,0,-1,0,0,1,1,1
KR_6767528638,420,-2,55,16,-6,-3,0,3,-3,2,5,-2,3,5,1,4,3,1,3,2,0,-15,37,2,2,4,-20,0,2,-1,1,1,1,2,1
KR_6758263990,420,6,-7,-15,9,1,1,0,5,6,1,0,2,2,0,4,4,3,3,0,-1,15,-24,4,3,7,-1,0,1,1,1,1,-1,4,1
KR_6734287365,440,3,98,31,8,-3,0,3,0,2,2,0,0,0,8,8,0,3,5,2,1,11,-124,-2,2,0,-20,0,0,-1,-1,1,1,1,1
KR_6732096464,440,-2,-28,-12,-3,-2,1,3,0,4,4,1,1,0,-1,3,4,-1,0,1,0,-4,1,1,4,5,-1,0,-1,-1,1,-1,-1,6,1
KR_6763124884,440,-3,-12,-24,-5,2,2,0,-2,1,3,-2,1,3,-2,1,3,-1,0,1,0,-8,3,2,4,6,-2,0,1,0,1,1,1,0,1
KR_6746373633,420,1,1,2,0,-1,2,3,2,4,2,-1,2,3,0,2,2,0,1,1,1,4,-11,-2,5,3,2,0,-2,0,1,-1,1,0,1
KR_6764574412,420,8,106,46,9,1,2,1,3,4,1,0,3,3,3,3,0,2,4,2,1,4,-12,-1,6,5,5,0,2,0,1,1,1,0,1
KR_6705646646,420,-2,-83,-15,1,-1,2,3,-1,3,4,4,5,1,-1,2,3,0,2,2,0,5,8,-1,3,2,-3,0,-1,-1,0,-1,-1,1,1
KR_6764118637,420,4,96,29,10,-6,0,6,7,8,1,1,1,0,9,9,0,-1,0,1,0,9,-14,1,3,4,0,0,1,1,1,1,-1,6,1
KR_6764038529,420,1,19,19,6,-4,0,4,2,4,2,6,8,2,-2,0,2,4,5,1,1,8,28,0,4,4,1,0,-1,0,0,-1,1,0,1
KR_6768170432,420,3,36,-16,10,-2,0,2,-1,2,3,5,5,0,7,7,0,1,2,1,0,8,3,0,5,5,3,0,1,1,-1,1,1,2,1
KR_6742921283,420,3,37,4,1,-2,1,3,-1,2,3,4,5,1,1,4,3,-1,0,1,2,1,293,-6,10,4,0,0,0,-1,-1,1,1,6,1
KR_6753511754,420,3,72,24,4,1,1,0,-1,1,2,4,6,2,0,4,4,0,1,1,-1,-6,25,-3,6,3,4,0,0,0,1,1,-1,0,1
KR_6709976999,420,-1,-4,37,-4,-3,1,4,-1,4,5,-1,2,3,1,4,3,0,1,1,0,-9,2,2,2,4,-2,0,-1,1,-1,-1,1,5,1
KR_6766150957,420,2,102,12,4,2,2,0,2,2,0,-1,4,5,0,2,2,1,2,1,-1,2,0,0,2,2,0,0,1,1,-1,1,-1,6,1
KR_6688452544,420,1,8,48,-4,-3,1,4,4,7,3,-1,2,3,-5,1,6,1,1,0,-3,-8,2,-6,7,1,0,0,0,1,-1,-1,-1,5,1
KR_6735221053,420,4,57,20,15,6,7,1,6,8,2,3,4,1,2,5,3,-2,1,3,1,15,3,0,8,8,5,0,1,0,1,1,1,0,1
KR_6741289240,440,-4,-53,5,-3,-2,3,5,-4,1,5,2,3,1,0,8,8,1,1,0,0,6,-3,2,4,6,2,0,0,1,0,-1,1,5,1
KR_6759346552,420,0,11,18,-1,3,3,0,1,3,2,0,2,2,0,2,2,-5,0,5,0,-6,6,2,3,5,2,0,1,-1,1,1,-1,3,1
KR_6758454345,420,3,34,12,11,5,6,1,-4,1,5,-1,2,3,8,12,4,3,4,1,0,1,37,1,5,6,-29,0,1,1,1,1,1,5,1
KR_6763095879,440,-5,-76,-13,-11,-1,2,3,-5,0,5,1,3,2,-3,0,3,-3,0,3,1,-8,4,4,3,7,-2,0,0,1,0,-1,1,6,1
KR_6584900906,420,-2,-40,-32,-1,0,3,3,0,0,0,2,3,1,-3,0,3,0,1,1,0,-3,19,5,3,8,-9,0,1,-1,1,1,-1,6,1
KR_6743737922,420,-3,-6,8,-4,-3,0,3,3,4,1,0,3,3,-1,0,1,-3,0,3,0,-2,-1,-4,7,3,4,0,0,-1,1,0,-1,6,1
KR_6671876086,420,5,73,24,5,2,2,0,-2,4,6,1,3,2,4,5,1,0,0,0,0,7,-3,2,5,7,5,0,2,1,1,1,-1,4,1
KR_6748523038,420,2,92,-29,8,1,1,0,2,3,1,-1,0,1,5,5,0,1,5,4,0,4,-246,1,2,3,-7,0,1,0,1,1,1,0,1
KR_6766913007,420,0,25,-4,10,1,4,3,-1,2,3,5,8,3,2,3,1,3,4,1,0,14,122,1,2,3,-2,0,2,1,1,1,1,5,1
KR_6761161965,440,2,53,-4,4,-2,2,4,0,2,2,4,5,1,6,7,1,-4,1,5,0,7,-4,-2,2,0,3,0,0,-1,-1,0,-1,3,1
KR_6696081515,420,-3,-78,4,-7,-4,0,4,-5,0,5,1,6,5,2,3,1,-1,1,2,-2,-11,-7,-3,7,4,8,0,-2,1,-1,-1,-1,4,1
KR_6675441444,420,0,7,4,-1,0,2,2,3,5,2,-3,1,4,-2,5,7,1,2,1,1,-3,37,-6,9,3,-26,0,0,1,-1,-1,1,3,1
KR_6302313230,420,2,68,5,5,1,2,1,1,5,4,1,1,0,3,5,2,-1,1,2,0,2,-10,0,5,5,6,0,0,1,1,0,-1,2,1
KR_6765603071,420,4,52,18,7,5,6,1,0,2,2,1,4,3,1,3,2,0,1,1,0,1,-3,-5,8,3,3,0,1,1,1,1,1,3,1
KR_6743033279,420,-1,0,24,-4,-3,2,5,-3,1,4,5,7,2,-3,3,6,0,3,3,-1,-3,-235,0,6,6,-2,0,-2,1,-1,-1,-1,3,1
KR_6768822153,420,0,2,4,-2,-1,0,1,2,2,0,-2,1,3,-2,1,3,1,1,0,0,0,26,4,3,7,-3,0,0,1,1,0,-1,4,1
KR_6747556667,420,-3,-2,-4,-7,-2,0,2,0,2,2,0,2,2,-1,6,7,-4,1,5,-1,-9,-43,6,3,9,0,0,0,-1,-1,-1,-1,5,1
KR_6759113712,440,0,-41,-6,3,-3,0,3,4,4,0,-2,2,4,3,3,0,1,2,1,0,11,-7,-2,6,4,1,0,2,-1,1,1,1,6,1
KR_6767156016,420,4,33,28,3,1,1,0,0,3,3,-4,1,5,4,5,1,2,2,0,-1,9,-8,-1,6,5,-3,0,1,1,1,1,-1,2,1
KR_6720786884,420,1,57,4,3,0,2,2,2,6,4,2,3,1,1,1,0,-2,3,5,1,-4,-17,5,4,9,-1,0,0,-1,-1,1,1,1,1
KR_6743492261,420,-1,-65,-19,-2,-2,1,3,-1,1,2,3,4,1,-3,3,6,1,2,1,-1,6,-32,1,4,5,-2,0,1,-1,1,-1,-1,3,1
KR_6699073487,420,1,0,1,4,2,5,3,3,4,1,1,2,1,-2,2,4,0,2,2,1,0,-2,-1,6,5,1,0,-1,-1,1,-1,1,5,1
KR_6764882677,420,4,1,50,17,-1,1,2,12,12,0,-1,5,6,1,4,3,6,7,1,1,17,-2,-2,5,3,3,0,1,1,1,1,1,4,1
KR_6759273365,420,0,23,32,0,-2,1,3,-4,1,5,0,4,4,8,12,4,-2,0,2,0,-7,1,-2,6,4,0,0,-1,1,-1,-1,1,4,1
KR_6755792140,420,2,24,12,5,4,4,0,2,5,3,1,2,1,1,2,1,-3,0,3,0,7,-29,2,3,5,-2,0,2,1,1,1,1,6,1
KR_6762495214,420,3,32,16,12,-1,1,2,0,5,5,6,6,0,7,7,0,0,0,0,0,12,7,4,2,6,0,0,2,1,1,1,1,4,1
KR_6751530303,420,1,0,16,5,1,3,2,-2,5,7,0,2,2,3,6,3,3,4,1,0,10,-7,-7,11,4,2,0,1,1,-1,1,-1,5,1
KR_6731612119,420,2,41,20,4,3,3,0,3,4,1,1,2,1,1,4,3,-4,2,6,1,4,-7,6,3,9,0,0,-1,-1,-1,1,-1,4,1
KR_6755953471,440,5,48,-4,23,10,10,0,5,6,1,1,2,1,4,4,0,3,7,4,0,23,-24,3,3,6,5,0,1,1,-1,1,1,2,1
KR_6716289733,440,3,-25,8,8,1,6,5,2,2,0,1,3,2,3,4,1,1,5,4,0,7,11,4,1,5,-2,0,1,-1,1,1,1,5,1
KR_6761515657,420,-2,-17,15,-2,-5,0,5,-1,3,4,1,4,3,4,5,1,-1,1,2,2,12,-1,-1,3,2,-2,0,-3,1,1,-1,1,5,1
KR_6714720215,440,-1,94,-4,0,-4,0,4,0,2,2,0,2,2,4,8,4,0,1,1,0,2,-11,-1,2,1,3,0,1,0,0,1,-1,0,1
KR_6736242161,420,1,16,24,3,0,1,1,4,5,1,3,5,2,-1,1,2,-3,0,3,1,-7,6,2,4,6,-2,0,-1,0,-1,-1,1,0,1
KR_6740303154,440,-2,-73,-12,-3,-4,0,4,-4,0,4,2,3,1,4,6,2,-1,2,3,0,6,1,-7,8,1,2,0,-1,1,-1,-1,-1,4,1
KR_6724122595,420,-5,-56,-8,-9,-3,1,4,-4,2,6,-1,2,3,-1,2,3,0,2,2,0,-6,-21,7,1,8,6,0,-2,-1,-1,-1,-1,6,1
KR_6673165861,420,1,-33,12,3,1,4,3,-1,0,1,0,0,0,2,2,0,1,2,1,0,3,4,1,5,6,-4,0,0,1,1,0,-1,6,1
KR_6722180538,420,2,19,20,10,-2,0,2,0,4,4,4,6,2,8,10,2,0,0,0,0,11,-5,-3,7,4,0,0,1,1,-1,1,1,1,1
KR_6761041298,420,3,9,-7,5,-2,1,3,0,1,1,1,4,3,5,8,3,1,2,1,0,2,-5,1,6,7,1,0,0,-1,0,1,-1,5,1
KR_6739282641,440,-1,-38,-12,-2,1,2,1,3,5,2,-5,0,5,-1,0,1,0,0,0,-1,1,-13,-1,2,1,0,0,0,0,0,0,-1,0,1
KR_6760835841,420,3,3,20,4,2,3,1,-1,2,3,7,7,0,-1,4,5,-3,1,4,0,4,2,6,2,8,-6,0,-2,-1,-1,-1,-1,1,1
KR_6717163338,440,0,21,-28,4,0,2,2,-3,1,4,-3,2,5,10,12,2,0,0,0,0,9,-21,-2,3,1,3,0,-1,0,-1,-1,-1,0,1
KR_6610142000,420,7,128,17,13,8,8,0,3,4,1,1,3,2,2,2,0,-1,0,1,0,15,10,4,0,4,0,0,4,1,1,1,1,3,1
KR_6660355640,440,6,54,11,17,8,8,0,0,3,3,3,6,3,5,6,1,1,2,1,0,8,-1,3,2,5,-2,0,1,1,-1,1,1,2,1
KR_6684442924,420,-2,4,-16,1,-1,2,3,2,3,1,0,3,3,0,4,4,0,1,1,0,-6,4,-1,5,4,-5,0,-1,-1,1,1,1,3,1
KR_6739322534,420,5,64,34,9,1,1,0,3,3,0,1,4,3,3,7,4,1,2,1,0,10,-8,-6,9,3,1,0,1,-1,1,1,1,6,1
KR_6693294593,420,-1,-58,8,2,2,2,0,0,1,1,3,4,1,-3,0,3,0,2,2,0,1,5,1,2,3,-2,0,-1,1,-1,-1,1,4,1
KR_6749683110,420,1,16,-3,0,1,1,0,-2,4,6,3,4,1,-3,0,3,1,1,0,0,-5,-17,0,8,8,5,0,1,0,1,1,-1,0,1
KR_6412999422,420,1,55,-20,7,-2,2,4,5,5,0,2,2,0,2,3,1,0,0,0,0,8,18,1,5,6,-3,0,2,1,1,1,-1,4,1
KR_6633100411,420,3,124,8,1,2,3,1,0,3,3,2,3,1,-1,2,3,-2,2,4,0,-3,5,0,5,5,1,0,1,1,1,1,-1,3,1
KR_6767949340,420,-2,-64,11,0,-7,1,8,1,5,4,1,2,1,5,8,3,0,3,3,1,9,25,2,5,7,1,0,-2,0,-1,-1,1,0,1
KR_6767417032,420,4,40,19,7,6,7,1,-2,0,2,4,6,2,-1,0,1,0,0,0,0,-3,-18,-1,2,1,1,0,1,1,1,1,1,6,1
KR_6757065335,420,2,90,19,-3,-1,0,1,6,7,1,-2,1,3,-3,0,3,-3,0,3,0,-3,-16,-1,5,4,3,0,2,-1,1,1,1,5,1
KR_6755405054,440,4,-1,-3,9,0,2,2,1,5,4,-2,1,3,6,6,0,4,4,0,0,9,-452,-1,6,5,-2,0,1,-1,-1,1,1,2,1
KR_6762677045,420,0,5,12,-3,0,1,1,-2,0,2,-4,2,6,3,4,1,0,1,1,0,2,-5,2,2,4,-1,0,0,1,-1,-1,1,1,1
KR_6653977030,420,4,56,32,7,0,0,0,3,3,0,1,1,0,3,4,1,0,0,0,0,5,52,7,3,10,-2,0,1,1,1,1,-1,6,1
KR_6705813390,420,-3,19,-41,-6,1,2,1,-1,0,1,-4,2,6,-3,0,3,1,4,3,0,-1,-2,2,2,4,-2,0,-1,-1,1,-1,-1,1,1
KR_6742060200,420,1,-6,-4,6,4,4,0,0,0,0,2,7,5,-2,2,4,2,3,1,0,2,234,0,7,7,0,0,1,1,1,1,1,1,1
KR_6768631328,420,-1,9,-4,2,-5,0,5,-7,0,7,6,7,1,7,8,1,1,4,3,3,15,38,-4,7,3,-20,0,0,-1,1,1,1,6,1
KR_6762453815,420,4,47,44,5,-1,0,1,5,6,1,1,1,0,-1,2,3,1,1,0,0,8,2,3,2,5,1,0,2,1,1,1,1,2,1
KR_6739147732,420,-1,-63,32,4,5,6,1,-1,2,3,-2,3,5,1,1,0,1,3,2,0,4,-3,0,4,4,2,0,-1,1,-1,-1,1,5,1
KR_6660141909,420,5,76,-2,7,-3,1,4,4,5,1,0,2,2,3,4,1,3,4,1,0,13,18,-4,5,1,1,0,2,1,1,1,1,5,1
KR_6688804641,420,0,-15,-8,-3,-1,1,2,1,2,1,4,5,1,-2,2,4,-5,0,5,0,-6,-38,1,3,4,1,0,1,0,-1,1,1,0,1
KR_6766568620,420,1,-26,-28,7,-5,2,7,1,5,4,0,3,3,7,7,0,4,4,0,1,9,21,-3,6,3,3,0,-2,0,-1,-1,1,0,1
KR_6737095990,420,-2,-20,-8,-4,-3,1,4,-4,1,5,-3,2,5,5,6,1,1,2,1,0,-2,-111,-5,11,6,2,0,0,0,-1,-1,-1,0,1
KR_6736920375,420,-5,-54,-1,-8,0,1,1,-1,4,5,0,2,2,-2,2,4,-5,0,5,-2,-13,322,-1,3,2,1,0,-1,1,1,-1,-1,6,1
KR_6751127015,440,3,15,10,11,1,2,1,5,7,2,1,3,2,6,6,0,-2,1,3,2,21,-211,6,2,8,2,0,1,-1,1,1,1,4,1
KR_6675244741,420,3,82,8,7,-1,2,3,4,5,1,-2,0,2,5,5,0,1,2,1,1,12,1,0,4,4,7,0,1,1,1,1,1,3,1
KR_6755249424,420,3,40,-1,10,1,1,0,1,1,0,6,6,0,1,2,1,1,2,1,0,6,-48,-1,7,6,28,0,0,1,-1,1,1,3,1
KR_6751276085,420,4,140,-4,9,2,3,1,3,4,1,2,3,1,2,2,0,0,1,1,0,3,8,1,2,3,-1,0,2,0,1,1,1,0,1
KR_6618296463,420,4,32,12,8,3,3,0,3,4,1,3,4,1,-1,1,2,0,0,0,0,9,12,-1,4,3,-7,0,2,1,1,1,1,2,1
KR_6752433271,420,-3,6,16,0,-6,0,6,6,7,1,-4,0,4,5,6,1,-1,0,1,0,6,1,-2,5,3,0,0,1,0,1,1,1,0,1
KR_6742895249,420,0,21,-5,8,6,6,0,3,4,1,3,6,3,-2,2,4,-2,0,2,1,5,232,5,3,8,21,0,1,1,1,1,1,2,1
KR_6766110244,420,2,66,-4,3,2,2,0,-2,1,3,1,2,1,1,1,0,1,1,0,0,2,2,-2,5,3,2,0,1,-1,1,1,1,4,1
KR_6767256237,440,0,1,-5,3,-4,2,6,3,3,0,4,5,1,-1,3,4,1,1,0,0,4,2,3,2,5,4,0,-1,1,-1,-1,-1,3,1
KR_6730470187,440,0,-33,54,3,2,3,1,5,5,0,-2,2,4,-2,1,3,0,1,1,0,8,-1,-4,8,4,0,0,1,1,1,1,-1,3,1
KR_6736964949,420,8,143,46,13,0,1,1,0,1,1,7,9,2,6,7,1,0,1,1,0,8,7,4,4,8,0,0,4,1,1,1,1,3,1
KR_6764289666,420,-1,-16,-21,-5,-1,2,3,2,4,2,-2,1,3,-5,0,5,1,3,2,0,-2,-14,-5,7,2,2,0,0,-1,1,-1,1,6,1
KR_6697830426,420,3,15,-19,13,2,2,0,0,2,2,4,6,2,6,11,5,1,2,1,0,10,10,4,2,6,0,0,1,-1,1,1,1,3,1
KR_6651687799,420,3,7,16,7,0,1,1,-1,0,1,3,3,0,2,4,2,3,3,0,1,11,11,3,3,6,-2,0,2,1,-1,1,1,1,1
KR_6757333845,420,-3,-49,-4,4,-1,1,2,3,5,2,1,4,3,-1,3,4,2,2,0,0,0,20,8,1,9,-6,0,0,1,0,0,-1,1,1
KR_6750291291,420,7,80,40,9,0,1,1,0,1,1,8,9,1,1,1,0,0,0,0,0,6,31,4,4,8,3,0,1,1,1,1,1,5,1
KR_6760661079,420,0,-27,-4,3,1,1,0,4,4,0,0,0,0,-1,4,5,-1,1,2,0,4,2,4,3,7,-1,0,-1,1,-1,-1,1,2,1
KR_6768613079,420,-1,20,-16,1,2,4,2,0,3,3,0,3,3,2,5,3,-3,0,3,-1,3,-13,-4,9,5,4,0,-1,-1,1,-1,-1,4,1
KR_6546990264,420,-1,5,-24,-2,4,4,0,-1,2,3,-3,1,4,3,5,2,-5,0,5,0,-2,-13,0,2,2,0,0,0,-1,-1,-1,1,6,1
KR_6692779131,420,2,56,12,4,3,4,1,-1,3,4,0,1,1,2,4,2,0,1,1,1,4,-1,0,7,7,1,0,0,1,-1,0,1,5,1
KR_6656356087,420,4,49,25,2,1,3,2,0,3,3,2,3,1,-2,2,4,1,1,0,0,-3,-7,0,6,6,-3,0,0,1,1,1,-1,1,1
KR_6740889515,420,3,18,-12,5,2,5,3,3,6,3,0,1,1,0,0,0,0,1,1,0,3,-327,6,0,6,0,0,0,-1,-1,0,-1,3,1
KR_6753269170,420,-2,-43,0,-2,2,3,1,-4,1,5,-1,4,5,2,7,5,-1,1,2,0,1,16,-4,11,7,-6,0,-1,1,1,-1,-1,2,1
KR_6761963069,420,3,69,8,9,1,3,2,0,2,2,3,5,2,4,7,3,1,2,1,0,10,17,-2,6,4,-1,0,2,0,1,1,1,0,1
KR_6756842615,420,-1,-7,-12,4,3,6,3,0,4,4,1,1,0,-2,1,3,2,3,1,0,4,-29,2,2,4,0,0,1,1,-1,1,1,2,1
KR_6756803597,440,4,53,-11,7,4,4,0,0,1,1,1,4,3,2,4,2,0,0,0,0,9,-13,-5,8,3,1,0,0,1,-1,0,-1,1,1
KR_6735419117,420,0,59,-24,-2,1,1,0,-3,0,3,-3,0,3,2,3,1,1,2,1,-1,-5,-3,1,3,4,1,0,0,-1,0,0,-1,4,1
KR_6731749576,420,1,44,0,7,4,5,1,0,6,6,-2,4,6,1,3,2,4,4,0,0,-3,38,5,3,8,-4,0,2,1,1,1,1,2,1
KR_6732397731,420,1,20,12,-1,-1,1,2,-2,4,6,-4,2,6,4,4,0,2,2,0,2,8,123,1,2,3,-2,0,1,1,1,1,1,1,1
KR_6760817642,420,3,58,-2,7,3,4,1,3,5,2,0,2,2,1,2,1,0,1,1,0,6,3,1,3,4,-1,0,0,1,-1,-1,-1,1,1
KR_6764482933,420,0,20,0,2,-1,1,2,1,2,1,-4,0,4,4,6,2,2,2,0,0,1,5,3,2,5,-4,0,2,-1,1,1,1,3,1
KR_6750147758,420,-1,28,-11,-2,1,3,2,0,0,0,3,6,3,-2,1,3,-4,0,4,0,-4,-7,-4,6,2,1,0,-1,0,0,-1,-1,0,1
KR_6759026418,420,2,38,12,1,3,3,0,-2,1,3,1,3,2,1,2,1,-2,0,2,-1,-5,-20,-4,6,2,2,0,0,1,0,0,-1,6,1
KR_6747132978,420,2,48,8,10,-2,1,3,3,4,1,2,4,2,2,4,2,5,6,1,0,5,5,5,2,7,-1,0,2,1,1,1,1,2,1
KR_6741636728,440,3,-4,3,2,4,4,0,2,3,1,2,2,0,-3,0,3,-3,0,3,0,6,9,-2,5,3,1,0,0,1,1,0,-1,5,1
KR_6695591810,420,2,-65,5,3,0,1,1,0,6,6,2,3,1,0,0,0,1,1,0,0,0,115,-1,6,5,-9,0,-1,-1,1,-1,-1,3,1
KR_6748855136,440,5,44,8,5,0,1,1,6,7,1,4,4,0,0,3,3,-5,3,8,0,-1,-7,-5,5,0,0,0,2,-1,1,1,1,6,1
KR_6767163185,420,4,31,20,10,-1,1,2,4,5,1,3,4,1,7,8,1,-3,0,3,-1,15,-6,3,4,7,1,0,0,1,-1,-1,-1,3,1
KR_6765824052,420,4,63,11,7,8,8,0,0,4,4,1,4,3,-2,4,6,0,0,0,0,-5,6,0,5,5,-2,0,3,1,1,1,-1,2,1
KR_6760342096,420,1,57,4,0,-1,4,5,-6,2,8,3,6,3,4,5,1,0,2,2,0,5,-256,0,3,3,2,0,1,1,1,1,-1,1,1
KR_6766850290,420,8,64,1,19,3,4,1,6,10,4,4,4,0,4,4,0,2,3,1,0,15,23,-7,10,3,4,0,2,1,-1,1,1,3,1
KR_6726440612,420,5,15,-36,6,-3,1,4,9,9,0,-3,0,3,4,5,1,-1,2,3,-1,9,12,4,2,6,-1,0,1,-1,1,1,-1,3,1
KR_6755291080,420,-4,-76,-5,-5,0,3,3,-5,1,6,4,4,0,-4,2,6,0,1,1,0,-6,-12,3,6,9,2,0,-1,-1,1,-1,1,4,1
KR_6741429473,420,7,103,18,20,7,8,1,4,5,1,4,8,4,1,3,2,4,4,0,1,13,29,0,7,7,-2,0,1,1,1,1,1,4,1
KR_6732077476,440,8,71,44,13,4,4,0,6,6,0,-2,0,2,5,5,0,0,2,2,0,11,275,-1,3,2,2,0,1,1,-1,1,-1,5,1
KR_6764221474,420,3,-18,87,3,2,3,1,2,4,2,-3,2,5,-1,2,3,3,5,2,-1,-1,-7,7,1,8,-3,0,0,0,1,0,-1,0,1
KR_6682421700,420,0,12,-8,6,-1,1,2,2,3,1,1,3,2,2,6,4,2,4,2,1,8,12,6,1,7,1,0,1,1,1,1,1,5,1
KR_6757315356,420,1,21,-32,5,4,4,0,4,4,0,-1,3,4,-4,1,5,2,2,0,0,7,-10,-1,5,4,-5,0,1,0,-1,1,-1,0,1
KR_6740045734,420,1,30,-27,2,0,3,3,-3,0,3,-1,1,2,5,7,2,1,1,0,0,0,-136,-3,6,3,0,0,-1,1,-1,1,1,4,1
KR_6755687240,420,2,-98,28,-3,-2,0,2,0,5,5,1,3,2,-3,0,3,1,1,0,0,-2,-1,0,5,5,-3,0,-1,1,-1,-1,1,1,1
KR_6573349523,420,2,25,3,7,1,1,0,2,6,4,-1,2,3,2,3,1,3,3,0,0,15,124,-2,6,4,1,0,0,-1,1,0,1,6,1
KR_6583180624,420,5,4,34,0,-7,1,8,6,9,3,-3,0,3,5,7,2,-1,1,2,-1,7,13,2,4,6,3,0,0,-1,1,0,-1,2,1
KR_6719301691,420,1,72,8,3,0,0,0,-1,1,2,-2,2,4,2,4,2,4,5,1,0,-4,-4,-1,3,2,4,0,2,-1,1,1,1,2,1
KR_6761858831,420,4,93,14,7,3,5,2,-3,2,5,0,1,1,6,6,0,1,2,1,0,-1,-5,0,4,4,0,0,3,0,1,1,1,0,1
KR_6751860124,420,2,-5,-16,8,-1,1,2,1,2,1,2,2,0,5,8,3,1,2,1,0,11,229,0,3,3,-5,0,1,1,-1,1,1,3,1
KR_6748701924,420,1,31,0,4,-1,3,4,-2,3,5,5,6,1,3,4,1,-1,1,2,0,3,5,0,5,5,2,0,2,1,1,1,-1,5,1
KR_6768026655,420,5,22,23,9,4,4,0,0,3,3,0,4,4,-2,2,4,7,7,0,1,8,12,-1,4,3,2,0,2,1,-1,1,1,6,1
KR_6733416130,420,4,62,7,6,5,6,1,2,3,1,-2,1,3,2,4,2,-1,1,2,0,5,30,3,3,6,0,0,-1,-1,-1,-1,1,6,1
KR_6759686883,420,-1,-19,-23,3,2,3,1,0,1,1,3,3,0,-2,1,3,0,0,0,0,3,-7,-1,6,5,3,0,0,-1,1,0,1,6,1
KR_6752278726,420,6,64,-4,15,2,3,1,-1,0,1,0,1,1,11,12,1,3,3,0,0,11,-8,-3,5,2,7,0,1,0,1,1,1,0,1
KR_6766979981,420,-1,15,-39,7,0,0,0,1,1,0,-1,4,5,6,8,2,1,2,1,0,7,23,0,3,3,-1,0,-1,0,-1,-1,1,0,1
KR_6709649190,420,5,3,8,9,-2,3,5,10,11,1,0,0,0,3,5,2,-2,0,2,-1,6,1,-5,7,2,5,0,2,1,1,1,-1,5,1
KR_6760623441,420,-3,-44,-19,-6,-4,2,6,-1,1,2,2,3,1,-1,4,5,-2,1,3,0,-1,7,0,4,4,-1,0,-1,0,1,-1,-1,0,1
KR_6659387325,420,4,41,32,10,6,7,1,3,5,2,2,7,5,2,6,4,-3,1,4,0,2,-1,5,4,9,2,0,1,1,1,1,1,2,1
KR_6761918959,420,3,-5,4,2,1,1,0,5,6,1,-3,0,3,-3,3,6,2,3,1,0,7,-11,2,3,5,2,0,0,-1,1,0,1,6,1
KR_6721953692,420,1,-30,16,4,0,1,1,4,6,2,4,5,1,-4,2,6,0,0,0,0,7,1,2,3,5,-1,0,2,1,1,1,1,5,1
KR_6752949073,420,5,51,25,8,1,5,4,0,1,1,1,4,3,6,6,0,0,1,1,0,9,-167,-3,5,2,-2,0,1,1,-1,1,1,6,1
KR_6694707054,440,-2,8,-20,-6,-3,1,4,-3,2,5,0,3,3,0,5,5,0,0,0,0,-10,224,-3,6,3,-4,0,2,1,1,1,-1,1,1
KR_6742833833,440,0,57,19,5,10,10,0,0,3,3,5,7,2,-6,3,9,-4,0,4,1,-3,-9,1,1,2,1,0,4,0,1,1,1,0,1
KR_6732812096,440,0,51,11,-1,-1,0,1,-5,0,5,1,3,2,4,4,0,0,0,0,0,2,41,-1,7,6,-8,0,2,1,0,1,-1,3,1
KR_6741608483,420,-1,-3,-2,-5,-6,1,7,1,3,2,-1,2,3,0,2,2,1,1,0,0,1,5,-3,9,6,6,0,-1,-1,-1,-1,-1,4,1
KR_6712104140,440,1,0,-31,11,3,4,1,-1,1,2,2,4,2,6,6,0,1,1,0,0,19,-254,0,4,4,0,0,1,1,-1,1,1,2,1
KR_6759749126,440,-1,34,-25,-6,-1,2,3,1,7,6,-3,1,4,0,6,6,-3,1,4,-1,-1,-6,-5,7,2,4,0,1,1,-1,-1,-1,4,1
KR_6730142582,420,1,22,-44,8,-3,1,4,3,3,0,2,3,1,6,9,3,0,1,1,2,15,-4,3,5,8,3,0,0,-1,1,1,1,4,1
KR_6296006335,420,3,29,12,20,4,4,0,4,7,3,12,13,1,2,3,1,-2,0,2,-1,20,-34,2,0,2,20,0,2,1,1,1,-1,6,1
KR_6759399499,420,2,-22,19,6,-3,0,3,4,7,3,2,3,1,1,3,2,2,4,2,0,5,6,4,2,6,2,0,0,1,1,0,1,2,1
KR_6768756773,420,1,-7,-9,1,0,2,2,1,1,0,-1,1,2,0,3,3,1,2,1,0,5,21,-3,8,5,4,0,-1,-1,-1,-1,1,6,1
KR_6750613325,420,0,33,0,3,-3,3,6,-1,2,3,1,1,0,6,8,2,0,0,0,0,1,6,4,3,7,-2,0,1,-1,1,1,-1,4,1
KR_6744538234,420,5,58,26,10,1,1,0,5,7,2,1,3,2,4,4,0,-1,0,1,0,12,30,-1,6,5,0,0,3,1,1,1,1,2,1
KR_6594829217,420,0,42,-19,1,0,1,1,0,3,3,0,2,2,1,3,2,0,0,0,0,3,18,-1,4,3,0,0,-1,1,-1,-1,1,5,1
KR_6636798310,440,2,97,-24,14,1,2,1,3,8,5,4,5,1,5,9,4,1,2,1,3,15,-11,-3,5,2,1,0,1,0,0,1,1,0,1
KR_6763195041,440,6,2,116,8,2,4,2,6,6,0,3,3,0,-5,1,6,2,4,2,0,8,2,1,5,6,-6,0,0,1,1,0,1,2,1
KR_6573443688,440,2,2,-8,9,5,7,2,2,5,3,3,5,2,0,2,2,-1,0,1,0,8,-21,-8,11,3,3,0,0,-1,-1,0,-1,1,1
KR_6757412275,420,1,-26,-48,3,0,4,4,5,6,1,-1,2,3,0,0,0,-1,0,1,0,8,-22,1,1,2,-2,0,2,-1,0,-1,-1,1,1
KR_6653908369,420,2,55,6,5,4,5,1,2,6,4,-1,1,2,-2,0,2,2,2,0,0,0,-7,-2,4,2,2,0,2,-1,-1,1,1,1,1
KR_6704284398,420,1,97,13,3,1,4,3,-2,4,6,2,3,1,4,5,1,-2,0,2,0,-7,3,3,3,6,-2,0,1,-1,1,1,1,6,1
KR_6714704364,420,0,38,-28,9,4,6,2,-1,1,2,2,5,3,5,5,0,-1,1,2,0,5,-4,4,0,4,1,0,2,1,1,1,1,2,1
KR_6740687513,420,2,54,-29,10,0,2,2,-2,2,4,4,8,4,7,7,0,1,4,3,0,13,0,2,4,6,3,0,0,1,-1,-1,-1,6,1
KR_6762590462,420,3,31,4,1,5,8,3,-1,3,4,-2,3,5,0,3,3,-1,0,1,0,0,34,0,8,8,-11,0,1,-1,1,1,1,2,1
KR_6766978540,420,1,63,17,6,2,2,0,4,5,1,5,7,2,-3,2,5,-2,0,2,0,-3,-28,-3,7,4,25,0,0,-1,1,1,1,6,1
KR_6765905951,420,4,54,-5,6,0,2,2,0,3,3,2,5,3,2,5,3,2,2,0,0,0,1,-1,6,5,-1,0,3,1,-1,1,-1,6,1
KR_6761440988,420,4,59,5,10,0,2,2,1,2,1,3,4,1,3,5,2,3,3,0,0,8,-2,-2,5,3,2,0,0,1,-1,0,1,4,1
KR_6767306932,440,2,-50,-4,1,1,3,2,-1,3,4,2,2,0,1,2,1,-2,1,3,0,4,141,4,3,7,3,0,0,0,0,0,-1,0,1
KR_6734646221,420,4,64,-8,7,5,5,0,-3,2,5,0,0,0,3,4,1,2,2,0,0,-1,2,6,3,9,5,0,2,1,1,1,1,4,1
KR_6767442208,420,0,-61,12,9,2,3,1,-6,2,8,1,2,1,7,10,3,5,5,0,0,3,-4,-4,7,3,-6,0,0,-1,1,1,1,1,1
KR_6759352173,420,4,79,-10,17,5,5,0,1,3,2,4,9,5,2,4,2,5,6,1,2,17,-3,-3,7,4,1,0,2,-1,-1,1,1,6,1
KR_6765718274,420,6,37,8,15,5,6,1,3,5,2,2,3,1,5,6,1,0,1,1,0,11,379,-1,5,4,0,0,2,-1,1,1,1,1,1
KR_6768834720,420,1,51,31,-1,3,3,0,-1,1,2,-1,2,3,-2,2,4,0,1,1,0,0,2,6,2,8,-1,0,0,1,1,1,-1,6,1
KR_6755845575,420,0,39,-17,11,6,6,0,1,2,1,-1,1,2,6,6,0,-1,2,3,0,13,-179,5,2,7,-17,0,2,0,-1,1,1,0,1
KR_6766543033,440,0,52,2,-4,0,1,1,-1,3,4,-3,0,3,5,8,3,-5,0,5,0,-10,-3,-1,5,4,-3,0,0,0,-1,1,1,0,1
KR_6633995952,420,0,87,-41,1,2,4,2,-2,1,3,1,2,1,2,4,2,-2,0,2,0,1,-4,4,4,8,1,0,1,1,1,1,1,1,1
KR_6673653125,420,1,23,39,5,5,5,0,2,3,1,0,1,1,-2,3,5,0,3,3,0,2,-6,-1,8,7,1,0,0,-1,1,-1,-1,1,1
KR_6654969208,420,1,81,16,-2,-4,1,5,-2,2,4,4,5,1,0,1,1,0,1,1,0,-13,-14,-2,8,6,2,0,1,1,1,1,-1,5,1
KR_6765712714,420,-3,-19,5,-11,-1,2,3,-4,0,4,-3,1,4,-2,0,2,-1,0,1,0,-9,-2,-7,9,2,0,0,1,-1,-1,1,-1,6,1
KR_6706667184,420,-1,-23,-11,-2,1,2,1,3,3,0,0,1,1,-4,0,4,-2,1,3,0,2,5,-1,6,5,0,0,0,-1,-1,0,-1,4,1
KR_6740895474,420,-4,-31,-24,-8,4,4,0,-1,2,3,-1,0,1,-11,0,11,1,3,2,0,-12,41,-6,8,2,-32,0,-2,1,0,-1,-1,4,1
KR_6759109253,420,0,52,7,-2,1,2,1,-1,3,4,0,2,2,-1,1,2,-1,1,2,0,1,-15,0,5,5,4,0,1,-1,1,1,-1,4,1
KR_6758357727,420,4,53,16,4,1,4,3,-1,1,2,2,2,0,2,6,4,0,1,1,0,-3,-8,-1,7,6,1,0,0,0,0,0,-1,0,1
KR_6696620018,420,2,-9,25,3,-2,2,4,1,2,1,6,6,0,-1,2,3,-1,1,2,0,8,-2,0,4,4,1,0,-1,1,-1,-1,-1,3,1
KR_6760236601,440,-1,-55,6,-1,-1,1,2,0,1,1,-4,0,4,0,2,2,4,4,0,0,3,-1,0,5,5,0,0,-1,1,-1,-1,1,6,1
KR_6603972290,440,6,3,40,7,-1,1,2,1,3,2,-2,3,5,5,6,1,4,6,2,0,6,2,1,3,4,0,0,1,-1,0,1,-1,5,1
KR_6739369187,420,1,-4,4,3,-2,0,2,5,7,2,-3,3,6,-1,3,4,4,4,0,0,11,9,1,3,4,1,0,1,1,1,1,-1,1,1
KR_6754305403,420,4,58,7,11,2,2,0,0,0,0,-2,0,2,9,9,0,2,3,1,0,8,6,0,6,6,1,0,1,1,1,1,-1,1,1
KR_6754491429,420,1,37,19,0,1,3,2,3,4,1,-5,0,5,-1,3,4,2,3,1,0,-8,99,-4,8,4,-4,0,0,0,0,1,-1,0,1
KR_6726200720,420,4,35,12,2,2,6,4,-1,1,2,1,3,2,-3,3,6,3,3,0,-1,1,-8,-7,9,2,2,0,-1,1,1,1,-1,3,1
KR_6749422966,440,5,19,-16,12,-1,1,2,4,5,1,2,4,2,7,8,1,0,1,1,0,14,2,0,4,4,-1,0,0,1,-1,1,1,1,1
KR_6752010496,420,-2,49,1,0,-1,0,1,-2,3,5,0,0,0,2,5,3,1,4,3,0,-1,-152,-4,5,1,2,0,-1,1,-1,-1,-1,1,1
KR_6731596576,420,6,113,7,10,4,5,1,-3,0,3,6,7,1,3,3,0,0,0,0,0,5,12,4,1,5,1,0,1,1,1,1,1,2,1
KR_6759669707,420,-2,-27,-32,0,-3,1,4,7,8,1,-3,2,5,0,4,4,-1,0,1,0,7,6,3,2,5,0,0,1,-1,-1,1,1,1,1
KR_6660688962,420,4,26,36,5,3,5,2,2,2,0,0,2,2,3,7,4,-3,1,4,-1,2,-2,2,4,6,2,0,0,-1,1,0,-1,4,1
KR_6767812596,420,7,66,-11,15,4,4,0,3,7,4,1,1,0,6,6,0,1,2,1,1,12,-4,3,1,4,2,0,1,1,1,1,1,5,1
KR_6764002670,420,-3,-18,-3,0,-2,2,4,4,7,3,-1,1,2,0,1,1,-1,0,1,0,7,15,-2,6,4,2,0,-2,-1,1,-1,1,4,1
KR_6713000508,420,-1,37,-36,-3,4,5,1,-4,2,6,-1,1,2,2,6,4,-4,0,4,0,-6,26,5,3,8,5,0,1,-1,0,1,-1,5,1
KR_6632884418,420,1,2,11,1,-4,0,4,2,3,1,2,5,3,1,5,4,0,0,0,0,5,162,-2,8,6,0,0,-1,1,-1,-1,1,4,1
KR_6757088463,420,1,27,20,-1,0,3,3,-3,0,3,4,4,0,2,5,3,-4,0,4,-1,-4,50,1,4,5,-19,0,1,1,1,1,-1,6,1
KR_6706409210,440,1,-23,16,8,0,2,2,5,9,4,-1,2,3,4,5,1,0,1,1,3,16,5,-3,5,2,0,0,1,1,1,1,1,4,1
KR_6747951608,420,2,27,-1,7,2,2,0,1,3,2,0,5,5,4,5,1,0,2,2,0,3,52,6,5,11,1,0,-1,-1,1,-1,1,2,1
KR_6766668393,420,2,40,20,-3,-3,2,5,1,8,7,1,4,3,-1,4,5,-1,1,2,-1,-6,-125,-2,6,4,-1,0,-1,0,-1,-1,-1,0,1
KR_6652587616,420,1,16,-24,4,3,3,0,4,4,0,-5,3,8,3,6,3,-1,1,2,0,10,0,4,2,6,1,0,0,-1,-1,0,1,2,1
KR_6766810954,420,2,3,31,6,2,2,0,4,4,0,2,2,0,-4,4,8,2,4,2,1,5,4,6,4,10,1,0,0,1,0,0,1,6,1
KR_6681738688,420,-3,14,16,-5,-1,3,4,-2,0,2,-2,1,3,-1,2,3,1,1,0,0,-19,-10,-3,5,2,1,0,0,1,-1,0,-1,4,1
KR_6681617998,420,0,-78,8,-1,-1,1,2,4,5,1,-2,1,3,-1,2,3,-1,0,1,1,2,116,0,7,7,2,0,0,1,1,0,1,3,1
KR_6757421931,440,2,16,4,6,5,5,0,2,5,3,-1,1,2,-1,4,5,1,3,2,0,9,-3,-1,4,3,1,0,2,-1,1,1,1,6,1
KR_6748853441,420,4,39,28,6,4,6,2,1,3,2,1,3,2,-2,1,3,2,4,2,1,2,3,-3,6,3,2,0,0,1,1,0,1,2,1
KR_6749425410,440,3,25,8,12,3,4,1,7,8,1,1,2,1,-2,3,5,3,3,0,0,3,-19,5,5,10,5,0,1,1,1,1,1,2,1
KR_6583918488,420,2,6,15,3,4,4,0,0,2,2,-2,0,2,1,4,3,0,2,2,0,3,200,-1,7,6,0,0,1,1,-1,1,1,6,1
KR_6765258843,420,3,114,-12,5,2,3,1,1,3,2,1,1,0,4,7,3,-3,0,3,-2,-5,17,-3,10,7,4,0,0,0,-1,1,-1,0,1
KR_6763690599,420,-2,2,-28,-2,-4,0,4,-1,2,3,6,6,0,-4,1,5,1,1,0,0,0,-9,1,3,4,-1,0,-1,0,-1,-1,-1,0,1
KR_6617350803,420,0,-9,5,3,0,0,0,3,6,3,2,4,2,-4,0,4,2,4,2,0,6,-3,3,3,6,-2,0,-1,1,-1,-1,1,2,1
KR_6696999564,420,3,59,20,5,-1,1,2,0,4,4,2,4,2,5,6,1,-1,1,2,0,6,-108,0,5,5,0,0,-1,1,-1,-1,-1,4,1
KR_6761921368,420,4,93,4,7,2,2,0,-2,1,3,-3,0,3,9,10,1,1,2,1,0,4,-106,-1,4,3,5,0,2,1,1,1,1,5,1
KR_6740999940,440,-2,-16,0,-2,4,6,2,1,3,2,-3,2,5,-4,8,12,0,1,1,0,4,6,5,1,6,-1,0,2,-1,1,1,-1,5,1
KR_6762085393,420,-1,55,17,-1,2,2,0,1,7,6,-2,1,3,-1,1,2,-1,0,1,0,3,2,-6,7,1,3,0,0,1,-1,0,1,3,1
KR_6746793739,420,5,151,38,2,1,2,1,-3,0,3,3,3,0,1,4,3,0,1,1,-2,2,-193,3,2,5,0,0,2,1,1,1,1,1,1
KR_6733298891,420,5,11,24,9,-5,0,5,2,3,1,3,4,1,5,8,3,4,5,1,0,13,2,-2,6,4,4,0,1,1,-1,-1,1,4,1
KR_6748114587,420,6,96,24,7,0,1,1,1,1,0,5,8,3,0,3,3,1,2,1,-1,0,12,4,1,5,-2,0,1,-1,1,1,-1,1,1
KR_6661541844,420,3,12,4,9,5,5,0,4,6,2,1,1,0,-1,3,4,0,3,3,-1,9,-4,1,4,5,0,0,0,0,1,0,-1,0,1
KR_6652631340,420,-2,8,16,-8,2,2,0,-2,5,7,-3,4,7,-2,0,2,-3,0,3,0,-21,-6,2,3,5,-1,0,-1,-1,-1,-1,-1,1,1
KR_6747673234,420,3,30,-16,2,3,3,0,2,3,1,-3,2,5,0,3,3,0,0,0,1,8,-14,-3,6,3,0,0,-1,1,-1,-1,1,1,1
KR_6639244088,420,4,44,26,3,2,3,1,-1,3,4,4,4,0,-1,2,3,-1,0,1,0,-3,-14,1,2,3,0,0,0,1,0,1,-1,2,1
KR_6755003464,440,5,62,46,15,7,7,0,1,3,2,0,2,2,6,8,2,1,2,1,1,8,41,4,1,5,-28,0,2,1,0,1,1,3,1
KR_6757458791,420,2,25,12,-2,-5,2,7,-2,0,2,2,3,1,2,2,0,1,4,3,0,4,4,3,5,8,-1,0,1,-1,1,1,-1,4,1
KR_6761838604,440,5,51,7,12,2,3,1,2,6,4,0,3,3,6,9,3,2,2,0,-3,23,-5,-1,3,2,5,0,1,1,1,1,-1,3,1
KR_6612494126,420,5,64,28,4,1,5,4,0,5,5,0,3,3,3,5,2,0,2,2,0,9,-7,-5,7,2,6,0,1,1,1,1,-1,5,1
KR_6762350055,420,4,88,20,5,1,2,1,4,6,2,3,5,2,0,4,4,-3,2,5,1,7,15,1,3,4,-4,0,1,1,1,1,1,6,1
KR_6739419461,420,2,19,20,9,4,4,0,2,6,4,1,1,0,1,3,2,1,1,0,2,13,-1,1,4,5,3,0,1,1,1,1,1,6,1
KR_6741941222,420,0,42,-4,-3,-2,2,4,3,3,0,-2,0,2,-3,1,4,1,2,1,-1,1,-6,-3,8,5,2,0,1,-1,1,1,-1,5,1
KR_6704397409,440,5,-15,-8,12,2,2,0,6,6,0,3,3,0,2,6,4,-1,0,1,2,17,-24,-1,5,4,40,0,0,0,0,0,-1,0,1
KR_6768384343,420,2,41,-16,2,3,4,1,1,1,0,2,3,1,-5,0,5,1,2,1,0,1,51,-5,8,3,1,0,0,1,-1,1,-1,4,1
KR_6760647454,420,5,5,34,15,1,2,1,-1,5,6,10,11,1,6,7,1,-1,2,3,0,8,-16,1,4,5,2,0,0,1,-1,-1,1,2,1
KR_6740867774,420,2,62,8,1,-3,1,4,-3,3,6,3,4,1,1,2,1,3,3,0,0,2,-3,0,4,4,1,0,0,1,-1,1,-1,5,1
KR_6713374104,420,3,48,33,1,3,4,1,1,4,3,0,2,2,-2,3,5,-1,1,2,-1,-9,-58,-2,8,6,5,0,1,1,1,1,-1,4,1
KR_6751354724,440,2,52,-9,2,-3,4,7,-1,0,1,2,2,0,3,3,0,1,2,1,-1,1,-55,2,4,6,-22,0,1,-1,1,1,-1,3,1
KR_6765311520,420,2,31,24,2,1,1,0,0,2,2,-3,2,5,2,3,1,2,3,1,0,3,2,2,5,7,2,0,2,-1,1,1,1,3,1
KR_6765288068,420,0,-42,-4,3,-1,2,3,6,6,0,-2,0,2,0,3,3,0,1,1,-1,-2,-4,1,6,7,1,0,0,1,-1,0,-1,2,1
KR_6761148159,420,3,-38,-9,1,0,1,1,6,7,1,0,3,3,-5,1,6,0,1,1,-1,3,11,1,3,4,0,0,0,-1,1,-1,1,6,1
KR_6685366967,420,4,53,-8,8,7,7,0,-4,0,4,2,2,0,4,6,2,-1,1,2,0,6,15,1,4,5,1,0,1,-1,1,1,-1,6,1
KR_6741428820,440,0,-15,1,1,-2,1,3,0,1,1,-4,2,6,7,7,0,0,2,2,-1,9,2,3,3,6,-6,0,0,-1,1,-1,1,4,1
KR_6609377721,420,-2,-64,29,-8,-2,0,2,-1,2,3,-9,0,9,4,5,1,0,0,0,0,-4,-2,2,6,8,-1,0,-1,-1,1,-1,-1,2,1
KR_6757098920,420,-1,-8,8,-2,-5,1,6,0,4,4,1,2,1,2,2,0,0,0,0,0,3,6,-4,6,2,3,0,0,1,-1,0,1,5,1
KR_6642121727,420,2,64,12,5,1,2,1,3,3,0,2,5,3,-1,1,2,0,1,1,0,1,-117,2,3,5,1,0,0,1,-1,1,1,5,1
KR_6727908001,420,0,37,0,3,0,2,2,2,2,0,-4,2,6,3,5,2,2,2,0,0,5,3,0,3,3,3,0,1,1,1,1,-1,1,1
KR_6764564827,420,2,26,-12,7,-1,0,1,3,4,1,2,4,2,0,2,2,3,3,0,0,5,0,0,3,3,-1,0,2,0,1,1,1,0,1
KR_6764376425,420,0,21,-4,-1,-1,2,3,-5,1,6,1,5,4,4,5,1,0,0,0,0,-4,-10,-2,7,5,5,0,0,1,-1,1,1,3,1
KR_6694901607,420,3,12,24,7,3,3,0,4,5,1,0,2,2,-4,3,7,4,5,1,1,2,-1,-2,4,2,0,0,-1,-1,1,-1,1,2,1
KR_6660737615,440,1,27,4,8,4,4,0,-4,3,7,4,4,0,4,5,1,0,0,0,0,9,17,6,3,9,-5,0,1,-1,1,1,-1,4,1
KR_6761617851,420,7,58,28,15,5,6,1,4,4,0,3,7,4,3,4,1,0,1,1,0,19,-2,-2,2,0,5,0,3,1,-1,1,1,5,1
KR_6634208173,420,1,26,0,3,1,4,3,-1,2,3,1,4,3,4,8,4,-2,0,2,0,7,48,2,1,3,-17,0,2,1,1,1,1,1,1
KR_6762464586,420,0,26,-48,8,1,2,1,3,4,1,-2,3,5,5,7,2,1,1,0,1,14,-7,5,4,9,5,0,1,1,-1,1,1,5,1
KR_6753852850,420,-1,10,16,-6,5,5,0,3,5,2,-5,1,6,-10,1,11,1,3,2,-1,-8,145,2,8,10,-1,0,2,1,1,1,-1,6,1
KR_6114083396,420,0,81,24,0,-1,1,2,-4,0,4,2,3,1,3,4,1,0,0,0,0,-1,14,4,5,9,0,0,2,1,1,1,1,5,1
KR_6769255564,420,4,1,0,9,2,4,2,-1,1,2,5,5,0,2,2,0,1,1,0,0,2,3,2,2,4,-1,0,0,1,1,1,1,2,1
KR_6685988924,420,2,-8,13,6,1,1,0,0,3,3,2,4,2,2,4,2,1,2,1,1,3,18,-1,4,3,-13,0,1,1,1,1,1,3,1
KR_6746929743,420,2,9,-12,11,6,6,0,2,4,2,1,1,0,2,4,2,0,1,1,4,19,-7,7,3,10,3,0,-1,-1,1,-1,1,4,1
KR_6694046730,420,1,56,-12,6,0,1,1,1,2,1,2,3,1,4,5,1,-1,0,1,0,6,34,2,6,8,-2,0,0,-1,1,0,1,6,1
KR_6753759404,440,3,77,-17,12,5,6,1,-4,1,5,8,8,0,1,3,2,2,2,0,0,7,4,2,1,3,0,0,0,1,0,1,1,4,1
KR_6755858416,420,0,90,6,1,-1,1,2,-1,1,2,0,0,0,1,1,0,2,2,0,0,5,-75,1,4,5,1,0,1,-1,1,1,-1,3,1
KR_6747592495,420,4,61,-3,13,4,4,0,5,5,0,2,2,0,1,2,1,1,2,1,0,8,11,-5,7,2,-2,0,0,1,1,1,1,6,1
KR_6611010700,420,3,-16,26,4,2,3,1,2,5,3,-5,1,6,5,8,3,0,0,0,0,6,-3,-1,2,1,0,0,0,-1,0,0,-1,4,1
KR_6677498655,420,1,-33,12,3,-2,0,2,10,12,2,-2,0,2,-4,0,4,1,3,2,0,-1,4,0,5,5,-1,0,1,1,-1,1,1,4,1
KR_6758268729,420,6,90,1,16,-2,1,3,3,3,0,2,4,2,10,10,0,3,3,0,0,15,2,1,3,4,4,0,1,1,1,1,1,3,1
KR_6741097749,420,0,11,-35,10,1,1,0,0,1,1,5,6,1,4,6,2,0,0,0,0,13,-31,4,1,5,13,0,-1,-1,-1,-1,-1,4,1
KR_6760764621,440,5,125,19,17,4,4,0,4,4,0,4,4,0,5,7,2,0,1,1,1,20,-4,-4,6,2,6,0,2,1,-1,1,1,1,1
KR_6726184813,420,0,-6,3,1,1,2,1,-3,5,8,3,3,0,-2,2,4,2,4,2,0,0,21,-3,6,3,1,0,0,1,0,0,1,2,1
KR_6759731689,440,0,40,32,-2,0,4,4,-1,1,2,-1,1,2,-2,4,6,2,3,1,0,0,0,0,8,8,-5,0,0,-1,1,0,1,6,1
KR_6758943918,420,3,53,25,2,2,5,3,0,3,3,0,1,1,0,4,4,0,1,1,1,1,13,2,3,5,-6,0,2,-1,1,1,1,2,1
KR_6705889317,420,3,-24,20,6,1,2,1,2,3,1,1,1,0,-3,2,5,5,6,1,0,-1,0,3,1,4,-1,0,0,1,1,1,1,1,1
KR_6728159833,420,4,44,16,5,-1,2,3,2,2,0,2,2,0,-1,2,3,3,3,0,0,4,-1,-2,5,3,5,0,0,1,-1,-1,-1,1,1
KR_6765903033,420,1,29,5,8,0,0,0,-1,3,4,7,8,1,1,1,0,1,1,0,0,5,1,2,1,3,1,0,1,1,1,1,1,5,1
KR_6762306197,420,-2,8,-12,-9,-3,0,3,-1,4,5,-6,0,6,2,5,3,-1,0,1,0,-15,-14,-4,9,5,1,0,-1,1,-1,-1,1,2,1
KR_6741901514,420,1,100,-12,3,0,1,1,0,2,2,3,3,0,0,2,2,0,0,0,0,1,-17,4,5,9,-7,0,1,-1,1,1,1,6,1
KR_6650985902,420,0,-55,24,-1,6,7,1,0,2,2,-2,2,4,-5,0,5,0,0,0,0,-9,1,4,3,7,-3,0,-1,-1,-1,-1,-1,2,1
KR_6698041516,420,3,7,-20,7,-4,0,4,7,9,2,4,5,1,2,2,0,-2,0,2,0,6,-1,0,3,3,6,0,1,-1,-1,1,-1,2,1
KR_6631716654,420,-1,35,-8,-9,-1,2,3,-5,2,7,-1,1,2,-1,3,4,-1,0,1,0,-16,-25,0,4,4,-4,0,-1,1,-1,1,-1,1,1
KR_6769240697,420,5,101,-24,6,-1,0,1,4,6,2,2,3,1,0,0,0,1,1,0,0,2,9,2,3,5,1,0,0,0,-1,0,1,0,1
KR_6766517649,420,2,45,28,2,1,1,0,-3,2,5,6,6,0,-3,3,6,1,3,2,0,1,45,-1,4,3,-23,0,1,1,1,1,-1,4,1
KR_6634596899,420,-2,-11,-11,-2,0,1,1,-7,1,8,0,2,2,3,3,0,2,4,2,0,-3,119,0,4,4,1,0,0,-1,1,0,-1,2,1
KR_6724653104,420,-1,28,0,0,0,1,1,5,6,1,-2,1,3,-4,1,5,1,3,2,2,-4,-1,-3,9,6,5,0,-1,-1,-1,-1,1,4,1
KR_6759763359,420,1,0,0,10,0,3,3,3,4,1,3,6,3,3,7,4,1,1,0,0,9,315,0,3,3,0,0,1,-1,1,1,-1,6,1
KR_6671721541,420,0,-4,-9,-7,1,2,1,-3,2,5,-3,0,3,-3,2,5,1,1,0,0,-7,-13,-5,7,2,4,0,-1,1,-1,-1,1,2,1
KR_6768204706,420,2,-2,27,6,3,4,1,0,1,1,-3,2,5,3,4,1,3,3,0,0,7,-1,4,3,7,0,0,0,1,1,0,-1,6,1
KR_6698855689,420,1,33,-10,6,0,2,2,1,2,1,2,5,3,2,3,1,1,2,1,1,7,8,3,6,9,7,0,-1,-1,1,-1,1,2,1
KR_6764973238,420,4,-13,4,13,-1,2,3,2,5,3,3,5,2,9,10,1,0,1,1,0,10,-2,-2,3,1,3,0,1,-1,-1,1,-1,6,1
KR_6661981498,440,-2,42,-19,-5,0,2,2,-2,2,4,-1,0,1,-1,2,3,-1,0,1,0,-3,42,-1,6,5,-26,0,-1,-1,1,1,1,4,1
KR_6762245363,420,2,-46,-24,2,0,1,1,-5,2,7,1,3,2,6,7,1,0,1,1,-1,6,-18,-1,6,5,4,0,-1,-1,-1,-1,-1,5,1
KR_6634125589,420,1,48,-26,3,1,2,1,0,5,5,4,6,2,-2,3,5,0,0,0,-1,-3,2,7,3,10,0,0,1,1,1,1,-1,1,1
KR_6759705920,420,-1,-49,-8,-4,1,5,4,0,2,2,3,4,1,-7,0,7,-1,1,2,-2,-4,1,2,3,5,-1,0,0,-1,1,1,-1,6,1
KR_6724508550,420,-2,-67,-24,-1,1,3,2,-6,1,7,2,4,2,0,2,2,2,2,0,0,-9,-3,-3,5,2,1,0,-3,-1,-1,-1,1,1,1
KR_6698440420,420,3,113,57,11,2,4,2,-1,2,3,5,6,1,5,6,1,0,2,2,1,15,-8,3,2,5,-2,0,3,0,1,1,1,0,1
KR_6749056124,420,5,44,12,18,-1,4,5,5,5,0,1,4,3,11,13,2,2,2,0,0,21,28,4,2,6,0,0,2,1,1,1,1,3,1
KR_6681590711,420,3,32,-12,7,6,6,0,0,4,4,-3,0,3,3,5,2,1,1,0,-2,-1,13,-1,6,5,-5,0,2,1,1,1,1,3,1
KR_6708961144,440,1,70,-12,-2,-5,1,6,2,4,2,4,5,1,-2,0,2,-1,0,1,0,-4,-3,0,4,4,-1,0,1,1,-1,-1,-1,3,1
KR_6630464835,420,1,-67,24,8,4,4,0,4,4,0,1,1,0,0,0,0,-1,0,1,0,14,195,3,3,6,1,0,-1,-1,1,1,1,4,1
KR_6625195619,420,-3,5,-17,-2,5,5,0,1,4,3,-1,0,1,-9,1,10,2,4,2,1,-3,-119,2,4,6,7,0,-1,-1,1,1,1,3,1
KR_6752177652,420,0,-8,0,2,7,7,0,-3,0,3,2,3,1,-2,2,4,-2,1,3,0,-1,-21,-3,6,3,5,0,1,1,1,1,1,2,1
KR_6610083042,420,3,52,8,10,0,3,3,5,7,2,1,1,0,4,5,1,0,0,0,1,18,51,-2,7,5,-1,0,2,1,1,1,1,1,1
KR_6769275126,420,-1,-60,6,-2,-1,0,1,1,6,5,-3,0,3,0,1,1,1,1,0,0,5,3,-2,5,3,0,0,0,-1,-1,-1,1,2,1
KR_6756568794,420,4,57,3,11,1,1,0,2,2,0,5,5,0,-1,1,2,4,4,0,0,9,10,4,2,6,-1,0,1,1,1,1,-1,6,1
KR_6761646979,440,0,7,4,1,5,5,0,1,4,3,-4,0,4,-2,4,6,1,1,0,0,0,-1,-4,7,3,5,0,0,0,-1,0,1,0,1
KR_6769272760,420,3,9,-5,13,0,0,0,1,2,1,1,1,0,7,7,0,4,4,0,0,15,-2,-2,6,4,1,0,1,1,1,1,-1,6,1
KR_6767942413,420,2,2,12,7,-1,0,1,3,7,4,2,4,2,1,2,1,2,3,1,1,-1,-3,-6,11,5,-1,0,0,-1,-1,0,1,6,1
KR_6768557365,420,-1,49,-13,0,-4,1,5,3,4,1,4,4,0,-1,1,2,-2,1,3,2,3,-8,-3,6,3,-1,0,1,-1,1,-1,1,2,1
KR_6764636196,420,3,19,-14,6,1,1,0,1,3,2,2,3,1,-1,1,2,3,3,0,-1,0,3,2,5,7,2,0,2,-1,1,1,-1,5,1
KR_6750899515,440,2,45,20,2,-1,2,3,-1,3,4,0,2,2,4,7,3,0,0,0,1,1,-11,-8,8,0,1,0,1,1,1,1,1,2,1
KR_6768080251,420,4,42,9,8,5,6,1,2,3,1,-4,1,5,5,7,2,0,2,2,0,7,106,5,3,8,-6,0,1,1,1,1,-1,6,1
KR_6761864080,420,1,19,-7,1,-2,2,4,-2,2,4,0,2,2,5,6,1,0,2,2,-1,0,-5,-5,6,1,4,0,1,0,-1,1,-1,0,1
KR_6663371833,420,4,13,32,11,0,2,2,4,7,3,6,7,1,1,2,1,0,1,1,0,10,65,0,3,3,0,0,0,1,-1,1,1,5,1
KR_6764530564,420,0,-10,1,-4,-1,0,1,1,2,1,0,1,1,-3,3,6,-1,1,2,0,-8,99,-6,8,2,5,0,-1,-1,1,-1,-1,5,1
KR_6762573735,420,2,4,4,7,0,2,2,1,2,1,3,7,4,5,5,0,-2,2,4,0,-1,112,4,2,6,-3,0,1,0,1,1,-1,0,1
KR_6630934956,420,3,112,-12,12,3,3,0,6,8,2,3,5,2,2,2,0,-2,0,2,0,9,60,2,4,6,-3,0,4,1,1,1,1,5,1
KR_6769307440,420,1,19,16,6,0,1,1,2,7,5,2,6,4,3,3,0,-1,1,2,1,1,3,6,1,7,5,0,0,1,1,-1,1,6,1
KR_6749544069,420,1,-26,11,0,-2,1,3,-3,1,4,2,5,3,3,4,1,0,0,0,0,5,1,-5,9,4,3,0,-1,1,-1,-1,1,6,1
KR_6705658245,420,1,47,17,-2,2,4,2,-2,3,5,-1,1,2,0,3,3,-1,0,1,0,-3,-46,2,3,5,18,0,0,0,0,1,1,0,1
KR_6763628960,420,2,36,31,5,-1,3,4,-3,1,4,6,6,0,4,4,0,-1,1,2,0,4,10,3,4,7,-1,0,0,1,0,0,1,4,1
KR_6716963958,420,2,0,-8,8,1,2,1,0,2,2,3,3,0,3,4,1,1,1,0,0,9,-146,-5,8,3,2,0,0,1,-1,-1,-1,1,1
KR_6765726415,420,0,-19,-13,-3,3,3,0,-1,3,4,0,4,4,-3,1,4,-2,0,2,0,-3,18,-2,5,3,2,0,1,-1,-1,1,-1,5,1
KR_6614165027,420,4,50,-4,8,0,1,1,3,4,1,1,2,1,4,6,2,0,2,2,0,2,-8,-1,6,5,0,0,1,0,1,1,1,0,1
KR_6671191019,420,2,12,24,3,1,3,2,5,7,2,-1,2,3,-2,1,3,0,3,3,0,8,-1,1,5,6,-3,0,0,-1,1,1,-1,6,1
KR_6611758899,420,-1,44,-3,-1,5,6,1,-4,1,5,-7,0,7,6,8,2,-1,3,4,0,-4,2,0,7,7,-1,0,1,1,-1,1,1,2,1
KR_6756921506,420,3,98,-23,5,0,1,1,0,1,1,1,3,2,4,6,2,0,1,1,0,13,29,-2,5,3,2,0,2,-1,-1,1,1,5,1
KR_6730828292,420,3,16,6,5,3,4,1,0,3,3,1,4,3,-1,0,1,2,2,0,0,-4,1,-2,5,3,-1,0,0,1,-1,1,1,4,1
KR_6723811231,420,-1,15,-27,-1,-4,0,4,0,1,1,2,3,1,0,2,2,1,1,0,0,2,13,3,2,5,5,0,1,1,1,1,-1,5,1
KR_6537987673,420,3,10,45,5,2,2,0,1,4,3,3,6,3,-1,0,1,0,0,0,0,3,1,1,7,8,-3,0,0,-1,1,1,1,5,1
KR_6754655581,420,-1,-37,10,1,-4,1,5,1,2,1,-1,1,2,5,8,3,0,1,1,0,4,-7,0,2,2,0,0,-2,1,-1,-1,-1,4,1
KR_6733621034,420,0,22,28,11,5,6,1,-3,2,5,1,6,5,7,9,2,1,4,3,0,11,-17,0,7,7,3,0,0,1,-1,-1,1,6,1
KR_6735676016,440,1,17,23,5,-2,1,3,1,4,3,4,6,2,3,6,3,-1,0,1,0,3,-3,0,4,4,8,0,2,1,1,1,1,5,1
KR_6762414711,420,1,-8,22,2,0,2,2,1,3,2,0,2,2,1,5,4,0,2,2,0,4,-2,1,4,5,0,0,2,1,1,1,-1,4,1
KR_6656372647,420,0,-37,8,5,1,4,3,1,4,3,4,5,1,1,4,3,-2,0,2,0,8,25,-1,10,9,-3,0,0,1,-1,1,1,4,1
KR_6760156064,420,0,-15,12,1,5,5,0,2,2,0,-4,0,4,-1,2,3,-1,1,2,-1,-3,213,4,0,4,1,0,1,-1,0,1,-1,3,1
KR_6743227888,420,-1,39,-55,-3,-2,1,3,4,6,2,-5,0,5,0,5,5,0,1,1,0,3,-7,-3,4,1,1,0,0,-1,-1,0,1,4,1
KR_6767871052,420,-1,45,12,-3,-2,1,3,1,2,1,2,2,0,-4,0,4,0,0,0,0,-2,15,1,3,4,-5,0,0,1,1,1,-1,3,1
KR_6738646670,420,3,70,36,1,2,2,0,-1,2,3,8,8,0,-8,2,10,0,0,0,0,-7,2,3,6,9,-1,0,0,0,0,1,-1,0,1
KR_6724183733,440,1,-39,-4,1,-3,2,5,2,6,4,0,1,1,4,4,0,-2,0,2,0,5,-20,0,6,6,1,0,-1,-1,-1,-1,-1,2,1
KR_6747845782,440,0,3,-3,9,1,1,0,1,2,1,2,8,6,2,3,1,3,3,0,3,6,-2,-1,4,3,0,0,0,-1,1,1,1,3,1
KR_6750270018,420,-2,24,-20,1,-1,1,2,-2,0,2,8,9,1,-3,1,4,-1,0,1,2,1,1,-2,5,3,3,0,-1,-1,1,-1,1,4,1
KR_6737401472,420,-3,-16,-11,2,-2,0,2,3,6,3,-1,1,2,2,2,0,0,0,0,0,5,-6,-4,8,4,5,0,-1,1,1,-1,1,1,1
KR_6722968759,420,2,67,-35,12,3,3,0,1,2,1,1,1,0,2,4,2,5,6,1,0,9,6,5,2,7,-1,0,1,1,1,1,-1,2,1
KR_6659466743,420,7,136,-4,24,2,4,2,6,6,0,5,5,0,4,4,0,7,10,3,1,24,1,0,2,2,1,0,3,1,-1,1,1,4,1
KR_6633676599,420,-1,6,-3,-4,3,3,0,-1,1,2,2,4,2,-9,1,10,1,2,1,0,-6,26,-2,4,2,-2,0,-2,1,-1,-1,-1,6,1
KR_6758133598,440,2,52,36,3,-2,1,3,0,3,3,1,2,1,6,9,3,-2,0,2,0,4,-3,-2,6,4,2,0,1,1,0,1,-1,5,1
KR_6661323408,440,0,35,-12,5,1,2,1,-1,1,2,3,3,0,1,4,3,1,6,5,0,2,-462,3,2,5,-1,0,0,0,0,0,1,0,1
KR_6752389357,420,1,8,-20,-2,4,5,1,-1,2,3,-1,3,4,-3,2,5,-1,1,2,0,1,151,-1,5,4,-2,0,3,-1,1,1,-1,3,1
KR_6649499012,420,6,116,-8,5,2,2,0,2,3,1,-2,0,2,2,3,1,1,3,2,0,11,53,2,5,7,-34,0,1,1,0,1,1,6,1
KR_6741136610,420,4,-9,4,6,3,3,0,-1,2,3,3,5,2,0,4,4,1,1,0,0,3,4,1,4,5,0,0,0,1,1,0,1,6,1
KR_6767225450,440,1,39,-3,0,0,1,1,1,2,1,-2,1,3,2,3,1,-1,3,4,0,0,-9,3,4,7,0,0,0,0,0,1,-1,0,1
KR_6739458281,440,1,49,27,2,1,3,2,3,6,3,1,2,1,-3,1,4,0,1,1,0,1,-8,-1,4,3,-3,0,1,0,0,1,1,0,1
KR_6753338462,420,1,6,6,-2,0,2,2,-1,2,3,2,4,2,-2,2,4,-1,0,1,0,-4,1,2,4,6,1,0,0,1,-1,-1,1,2,1
KR_6731231762,420,6,25,31,11,-2,2,4,2,4,2,3,3,0,7,7,0,1,1,0,0,11,24,0,6,6,-7,0,0,-1,-1,0,1,6,1
KR_6728443550,420,1,58,14,0,1,2,1,-1,3,4,1,2,1,-2,2,4,1,1,0,0,-6,-17,-5,6,1,4,0,0,0,1,0,1,0,1
KR_6747973650,420,3,-31,-10,9,-6,0,6,2,3,1,11,12,1,1,1,0,1,1,0,0,10,2,1,3,4,-1,0,1,1,1,1,1,5,1
KR_6750313826,420,0,4,0,3,-2,1,3,6,7,1,2,4,2,-2,1,3,-1,0,1,0,7,26,2,5,7,-26,0,0,0,0,0,1,0,1
KR_6763730295,420,-3,-35,24,3,0,2,2,0,1,1,4,6,2,0,4,4,-1,2,3,0,-1,10,4,2,6,-4,0,0,0,1,0,1,0,1
KR_6764185443,420,2,15,0,4,1,3,2,0,5,5,2,2,0,1,3,2,0,1,1,0,9,-4,1,3,4,1,0,-1,-1,-1,-1,1,3,1
KR_6758771358,420,0,2,35,2,-2,0,2,5,6,1,-2,2,4,2,5,3,-1,2,3,0,8,-188,3,1,4,-3,0,0,-1,0,1,1,4,1
KR_6758874455,420,-1,17,18,-1,-2,4,6,-1,2,3,1,2,1,1,4,3,0,2,2,0,-4,-2,-1,6,5,-2,0,0,-1,-1,0,1,1,1
KR_6768176928,440,2,33,7,8,3,4,1,5,7,2,3,3,0,-2,2,4,-1,0,1,0,3,4,0,4,4,-6,0,0,1,0,0,1,1,1
KR_6645263406,420,6,124,19,14,0,1,1,3,4,1,4,7,3,5,6,1,2,4,2,1,16,6,-1,3,2,-22,0,3,1,-1,1,1,3,1
KR_6655954168,420,1,-23,-14,3,3,3,0,-1,0,1,3,4,1,-2,0,2,0,1,1,0,5,270,-1,4,3,0,0,1,1,1,1,-1,2,1
KR_6715394437,420,2,40,11,-3,1,3,2,6,6,0,-8,0,8,-2,2,4,0,1,1,-1,-3,-26,-2,5,3,11,0,0,-1,1,-1,-1,4,1
KR_6737300786,420,1,92,16,7,4,4,0,-2,0,2,8,9,1,2,4,2,-5,1,6,0,6,3,1,4,5,5,0,2,1,1,1,1,4,1
KR_6764626941,420,1,-1,42,7,1,1,0,2,4,2,-1,2,3,4,6,2,1,2,1,0,5,-111,-1,4,3,4,0,3,1,1,1,1,4,1
KR_6690682138,440,-1,-33,20,3,2,2,0,-1,0,1,-3,1,4,4,4,0,1,3,2,0,8,29,0,5,5,-25,0,-1,1,-1,-1,-1,3,1
KR_6722422417,440,1,-36,-8,3,-1,1,2,0,4,4,-1,1,2,5,7,2,0,0,0,0,0,-5,-5,7,2,-1,0,1,1,-1,1,-1,2,1
KR_6763262085,420,3,58,14,12,4,4,0,2,3,1,3,4,1,1,3,2,2,2,0,0,16,-2,-1,5,4,3,0,1,1,1,1,1,5,1
KR_6748547908,420,3,2,34,3,0,1,1,1,5,4,0,3,3,-2,2,4,4,4,0,0,-6,-2,-7,8,1,8,0,1,-1,1,1,1,3,1
KR_6757118470,420,1,46,-3,5,1,2,1,3,3,0,1,4,3,0,2,2,0,0,0,0,7,9,4,1,5,-4,0,0,1,-1,1,1,5,1
KR_6634588743,420,5,21,17,17,5,6,1,4,5,1,0,6,6,8,8,0,0,2,2,2,25,1,5,1,6,-1,0,2,1,0,1,1,6,1
KR_6764904026,420,1,36,5,5,2,2,0,4,6,2,-1,2,3,-1,3,4,1,1,0,0,6,-8,-7,7,0,2,0,2,1,-1,1,1,1,1
KR_6711830424,440,-2,1,-25,-8,0,1,1,-4,1,5,0,3,3,-2,0,2,-2,0,2,0,-12,-7,0,2,2,1,0,0,-1,1,0,-1,1,1
KR_6768746922,440,3,26,-20,-1,0,1,1,3,6,3,0,2,2,-3,1,4,-1,0,1,0,-5,13,-3,6,3,-2,0,0,1,1,0,1,2,1
KR_6729320072,420,-1,-17,-24,-1,-2,2,4,-2,3,5,1,4,3,2,3,1,0,3,3,0,5,57,8,4,12,-25,0,0,-1,1,1,-1,5,1
KR_6684653925,420,3,-6,-9,14,1,2,1,4,6,2,4,5,1,5,6,1,0,2,2,0,11,2,2,4,6,-5,0,0,1,1,0,-1,5,1
KR_6631208348,420,-1,20,21,-5,0,1,1,-7,1,8,-1,0,1,0,4,4,3,5,2,0,-16,12,4,2,6,-6,0,-1,1,-1,-1,1,4,1
KR_6755244312,420,-1,51,-20,2,1,2,1,3,5,2,-2,4,6,-2,4,6,2,2,0,0,-3,-4,-6,8,2,-1,0,0,0,-1,0,1,0,1
KR_6762536941,420,2,24,-5,8,2,2,0,0,0,0,6,7,1,-2,0,2,2,3,1,0,1,8,7,2,9,-1,0,0,-1,1,0,1,6,1
KR_6758276959,440,5,46,55,7,-1,0,1,6,8,2,3,3,0,-2,0,2,1,2,1,0,7,36,-1,4,3,-1,0,2,1,1,1,-1,1,1
KR_6451657547,420,2,7,17,4,0,1,1,1,4,3,5,6,1,-3,3,6,1,2,1,0,-1,7,-2,7,5,2,0,0,1,1,0,-1,3,1
KR_6685501430,440,0,-21,18,-4,-8,1,9,1,1,0,-6,0,6,4,7,3,5,6,1,1,-10,1,-2,2,0,0,0,1,0,1,1,1,0,1
KR_6752736092,420,1,-6,16,3,2,3,1,-1,0,1,4,6,2,-6,2,8,4,4,0,0,-3,7,-4,10,6,0,0,-1,0,-1,-1,1,0,1
KR_6755132784,420,1,-24,4,5,0,0,0,5,6,1,1,3,2,1,2,1,-2,0,2,0,12,4,4,4,8,-1,0,0,1,1,0,1,4,1
KR_6761474742,420,6,46,14,7,-1,1,2,1,3,2,1,4,3,2,3,1,4,4,0,0,5,9,2,1,3,-1,0,3,1,0,1,1,4,1
KR_6748080701,420,1,34,0,6,-1,1,2,0,1,1,3,3,0,2,5,3,2,3,1,0,7,-2,-4,9,5,1,0,1,1,-1,1,-1,3,1
KR_6738331978,420,3,6,6,5,2,4,2,-1,4,5,2,3,1,2,3,1,0,2,2,0,1,12,-1,7,6,2,0,2,-1,1,1,1,1,1
KR_6756529315,420,1,-2,-4,4,3,3,0,-2,3,5,-1,4,5,5,6,1,-1,1,2,0,9,-9,-5,8,3,5,0,0,-1,1,1,1,6,1
KR_6717337748,440,1,-13,-6,2,2,4,2,-1,3,4,-5,0,5,7,9,2,-1,0,1,-1,6,1,4,0,4,3,0,1,-1,-1,1,-1,5,1
KR_6725261778,420,3,16,40,-4,-3,2,5,-4,1,5,0,2,2,2,2,0,1,1,0,2,0,42,1,3,4,-6,0,2,-1,1,1,1,6,1
KR_6753949438,420,2,-19,12,3,1,1,0,-1,2,3,4,4,0,-1,3,4,0,1,1,0,2,-17,-3,6,3,5,0,0,-1,1,0,1,4,1
KR_6739217574,420,1,1,-12,-3,-1,2,3,-4,7,11,1,3,2,2,4,2,-1,1,2,0,0,-2,-2,4,2,-5,0,1,1,-1,1,1,6,1
KR_6761243723,420,-1,-11,-28,5,1,3,2,1,2,1,2,4,2,0,4,4,1,2,1,0,9,-13,1,4,5,1,0,-1,1,0,-1,-1,5,1
KR_6720271395,420,3,81,40,8,0,1,1,1,2,1,0,2,2,4,5,1,3,4,1,0,0,29,2,4,6,-11,0,1,1,1,1,1,4,1
KR_6748728313,420,1,51,-8,-1,3,3,0,-6,0,6,1,3,2,-1,1,2,2,5,3,1,-7,-19,-2,7,5,-3,0,1,1,0,1,1,3,1
KR_6747049545,420,3,43,13,3,1,1,0,-2,2,4,3,4,1,0,1,1,1,3,2,0,-1,2,2,4,6,0,0,0,0,-1,0,-1,0,1
KR_6689552010,420,2,-6,9,5,-2,1,3,4,5,1,-1,0,1,1,3,2,3,3,0,0,11,121,-3,4,1,6,0,0,1,0,0,-1,4,1
KR_6646390867,420,2,19,0,8,-1,1,2,0,2,2,5,6,1,4,4,0,0,0,0,0,6,8,3,5,8,0,0,0,0,1,0,1,0,1
KR_6764889868,420,0,-48,-17,0,4,4,0,-3,1,4,-1,2,3,2,2,0,-2,1,3,0,-4,8,0,5,5,2,0,1,-1,1,1,-1,4,1
KR_6759448759,440,3,45,0,4,3,4,1,0,3,3,0,2,2,0,0,0,1,2,1,1,-2,1,3,2,5,-2,0,0,0,0,0,1,0,1
KR_6759227168,420,3,47,-4,9,3,3,0,1,3,2,0,1,1,6,6,0,-1,2,3,0,5,2,-5,7,2,2,0,1,-1,1,1,-1,2,1
KR_6760049078,420,0,-22,15,1,3,3,0,-4,0,4,3,3,0,-3,1,4,2,2,0,0,-5,16,0,2,2,-5,0,0,1,0,0,1,4,1
KR_6727490983,420,2,-48,28,-1,0,1,1,3,3,0,-1,3,4,-5,1,6,2,2,0,0,2,36,-1,5,4,-27,0,2,-1,1,1,-1,5,1
KR_6499466178,420,4,41,29,7,4,4,0,1,6,5,2,6,4,0,2,2,0,1,1,-1,4,10,0,5,5,-6,0,0,1,1,1,1,3,1
KR_6769258726,440,3,25,36,16,-2,1,3,2,3,1,-2,3,5,10,10,0,8,8,0,0,18,0,-1,2,1,1,0,2,1,1,1,-1,4,1
KR_6737844711,420,2,52,21,6,1,1,0,2,5,3,2,3,1,0,4,4,1,1,0,-1,5,-108,-3,9,6,-1,0,0,1,0,1,-1,2,1
KR_6688504618,420,3,80,4,9,6,6,0,2,3,1,3,5,2,1,3,2,-3,0,3,0,1,18,-1,3,2,1,0,5,1,1,1,1,3,1
KR_6767806910,420,4,54,-6,13,3,3,0,5,9,4,-2,3,5,5,6,1,2,2,0,1,18,14,5,2,7,6,0,1,1,1,1,1,2,1
KR_6701415437,420,4,49,-8,7,2,5,3,6,8,2,-2,1,3,0,5,5,1,1,0,-3,-2,12,-2,8,6,6,0,2,-1,1,1,-1,3,1
KR_6713853265,420,3,32,-12,7,1,2,1,3,4,1,2,4,2,2,2,0,-1,0,1,0,10,-4,1,3,4,5,0,1,1,-1,1,-1,1,1
KR_6714677441,420,2,59,36,2,1,4,3,1,3,2,0,0,0,-1,2,3,1,1,0,0,-2,2,-3,8,5,1,0,0,1,0,0,1,6,1
KR_6764678975,420,1,3,29,0,-2,0,2,0,2,2,4,4,0,1,3,2,-3,2,5,0,0,5,4,2,6,4,0,0,1,1,0,-1,5,1
KR_6759674262,420,1,73,6,-3,0,2,2,-1,2,3,1,3,2,-4,2,6,1,2,1,0,-6,-4,-2,4,2,4,0,1,-1,1,1,1,3,1
KR_6763674851,420,-2,-3,-6,2,-2,1,3,1,5,4,4,4,0,0,5,5,-1,1,2,1,12,62,4,3,7,-24,0,0,1,-1,0,1,5,1
KR_6732013808,440,-3,-18,5,-3,-6,0,6,4,4,0,2,2,0,-5,0,5,2,3,1,0,-4,-4,3,5,8,2,0,-1,1,-1,-1,-1,4,1
KR_6712592833,440,4,32,0,10,-6,4,10,3,3,0,1,1,0,5,5,0,7,9,2,-1,2,0,-4,9,5,1,0,1,-1,1,1,-1,2,1
KR_6752026520,420,7,12,12,9,4,4,0,1,2,1,-1,2,3,3,3,0,2,3,1,0,12,70,0,4,4,29,0,0,-1,-1,0,-1,2,1
KR_6736035702,420,3,34,25,1,1,1,0,2,4,2,-1,1,2,1,3,2,-2,1,3,0,3,-8,-3,8,5,0,0,1,-1,1,1,-1,6,1
KR_6711507298,440,1,-100,36,-2,-3,1,4,-3,2,5,2,4,2,-1,0,1,3,3,0,0,-3,13,-3,4,1,2,0,0,1,1,1,1,3,1
KR_6661647660,420,-5,-18,-20,-10,-5,0,5,-1,2,3,2,4,2,-3,1,4,-3,0,3,-1,-15,6,3,5,8,2,0,-1,-1,-1,-1,-1,3,1
KR_6762787077,420,3,-24,32,5,-3,1,4,7,8,1,-2,2,4,0,1,1,3,3,0,0,6,1,-2,6,4,-1,0,-1,1,-1,-1,-1,3,1
KR_6760005612,420,1,-59,0,-7,-1,2,3,-3,3,6,0,3,3,-1,9,10,-2,1,3,-1,0,3,1,5,6,5,0,0,1,-1,0,1,2,1
KR_6761310259,420,2,-29,9,-3,-2,0,2,-2,3,5,0,2,2,0,4,4,1,2,1,0,4,5,2,3,5,-3,0,2,1,1,1,-1,6,1
KR_6631282666,420,0,-1,-2,-1,3,4,1,1,6,5,2,3,1,-5,0,5,-2,0,2,0,2,3,-1,5,4,0,0,0,-1,-1,-1,-1,3,1
KR_6766627492,420,-2,-8,38,3,0,3,3,1,1,0,4,4,0,-5,1,6,3,3,0,0,7,-34,0,4,4,27,0,1,-1,0,1,1,1,1
KR_6766153304,420,-2,13,-28,0,-5,1,6,4,6,2,1,3,2,0,0,0,0,2,2,0,12,3,5,2,7,3,0,-2,1,-1,-1,1,2,1
KR_6765806024,420,1,26,-24,-3,2,3,1,-3,2,5,2,4,2,-2,1,3,-2,0,2,1,-5,0,4,5,9,-6,0,1,1,-1,1,1,4,1
KR_6705785273,420,2,-11,8,-4,2,3,1,1,3,2,-4,0,4,-2,0,2,-1,0,1,0,-7,0,-5,6,1,-1,0,0,-1,1,0,-1,2,1
KR_6746394771,420,-1,-79,-13,2,-3,1,4,2,3,1,6,8,2,-3,2,5,0,1,1,0,6,18,-1,5,4,3,0,-1,0,0,-1,-1,0,1
KR_6757570053,420,1,-43,0,6,1,3,2,5,6,1,-2,0,2,4,4,0,-2,2,4,1,12,21,1,6,7,2,0,1,-1,1,1,1,3,1
KR_6670321045,420,-2,-4,18,-3,-1,1,2,-1,2,3,3,4,1,-5,3,8,1,1,0,0,-10,3,0,6,6,-1,0,0,-1,1,-1,1,4,1
KR_6756791276,420,-3,18,-31,-12,0,3,3,-12,0,12,-2,1,3,1,2,1,1,1,0,-2,-7,0,0,4,4,5,0,0,1,-1,1,-1,1,1
KR_6608116472,420,4,45,11,6,2,3,1,2,4,2,-3,0,3,6,8,2,-1,1,2,0,9,-1,1,3,4,-2,0,0,-1,1,0,-1,2,1
KR_6732603744,420,0,40,4,1,-1,4,5,0,3,3,1,1,0,-2,1,3,3,3,0,0,0,1,4,1,5,0,0,0,1,1,1,1,4,1
KR_6755500376,420,-1,2,35,-3,-2,0,2,-4,0,4,-1,2,3,1,3,2,3,3,0,-1,2,14,3,3,6,-3,0,0,0,-1,0,-1,0,1
KR_6756825161,420,2,19,-8,6,3,4,1,2,8,6,-2,2,4,1,3,2,2,2,0,0,3,110,2,4,6,2,0,1,1,0,1,1,5,1
KR_6732523371,420,2,-12,2,3,1,2,1,5,7,2,-1,2,3,-3,0,3,1,1,0,0,-3,-2,-1,7,6,2,0,1,1,1,1,-1,5,1
KR_6650912723,420,4,86,-24,4,2,4,2,1,4,3,-1,1,2,1,5,4,1,2,1,0,-1,33,0,5,5,-1,0,1,1,1,1,1,3,1
KR_6762057418,420,6,60,22,12,2,4,2,1,2,1,5,5,0,3,6,3,1,2,1,0,15,418,5,2,7,-2,0,1,1,1,1,1,2,1
KR_6722053797,420,0,-85,40,2,-2,2,4,-3,2,5,8,8,0,-1,2,3,0,0,0,0,1,-39,-3,6,3,23,0,-2,1,-1,-1,1,3,1
KR_6760304867,420,3,33,2,7,1,2,1,8,8,0,0,1,1,-3,1,4,1,1,0,0,2,7,-1,7,6,3,0,0,-1,1,0,1,6,1
KR_6763148417,440,5,77,16,10,9,9,0,-1,1,2,2,4,2,2,3,1,-2,0,2,0,-2,-1,-1,3,2,0,0,1,1,1,1,1,4,1
KR_6697871958,440,2,-12,24,5,-2,1,3,3,5,2,0,0,0,-1,2,3,5,5,0,0,-2,29,-8,9,1,-16,0,1,1,1,1,1,2,1
KR_6766014819,420,0,-15,-19,5,1,1,0,1,2,1,2,4,2,0,3,3,1,2,1,0,7,-2,-3,6,3,2,0,0,1,1,0,-1,5,1
KR_6763657606,420,3,69,18,6,5,5,0,1,5,4,-3,0,3,-1,5,6,4,4,0,0,11,-158,1,4,5,-3,0,2,1,1,1,1,3,1
KR_6768017936,420,-4,32,-47,-9,-5,1,6,-4,1,5,2,4,2,-2,1,3,0,0,0,0,-5,-6,-2,4,2,3,0,-1,1,-1,-1,1,4,1
KR_6768253637,440,4,93,10,5,2,3,1,-2,0,2,1,1,0,2,2,0,2,2,0,0,7,3,0,4,4,3,0,1,1,-1,1,-1,2,1
KR_6768814034,420,3,47,2,9,2,3,1,2,3,1,0,1,1,4,5,1,1,1,0,0,14,-8,-5,9,4,1,0,2,1,1,1,-1,3,1
KR_6750465177,420,5,121,32,8,2,2,0,6,11,5,-3,3,6,1,5,4,2,2,0,0,6,8,6,2,8,-3,0,1,1,1,1,1,3,1
KR_6681587058,420,0,29,-21,5,3,5,2,3,4,1,0,2,2,0,1,1,-1,0,1,0,4,18,8,1,9,-2,0,1,-1,1,1,1,2,1
KR_6679874450,420,2,48,27,3,4,4,0,1,3,2,-1,1,2,-1,4,5,0,3,3,1,1,-29,0,5,5,6,0,0,-1,-1,0,1,2,1
KR_6740097028,420,3,80,0,5,3,4,1,0,4,4,2,4,2,-1,2,3,1,3,2,0,-3,1,-3,4,1,-1,0,0,1,-1,0,-1,1,1
KR_6768082840,420,3,13,31,5,-3,1,4,2,3,1,0,3,3,5,8,3,1,1,0,0,7,-1,5,4,9,-4,0,0,1,1,0,-1,4,1
KR_6762446714,420,4,57,-2,5,0,4,4,2,3,1,6,7,1,-3,2,5,0,0,0,0,-6,14,3,5,8,-2,0,2,0,0,1,1,0,1
KR_6763482813,420,3,67,44,2,1,2,1,-4,0,4,4,4,0,0,3,3,1,1,0,0,-1,11,1,4,5,-3,0,0,1,1,1,1,5,1
KR_6752465178,420,4,-57,22,10,3,4,1,2,7,5,1,1,0,4,5,1,0,0,0,0,15,93,10,0,10,-3,0,-1,1,0,-1,1,5,1
KR_6737185351,420,4,1,-14,12,3,5,2,0,3,3,9,10,1,3,4,1,-3,0,3,0,12,4,-3,9,6,2,0,2,1,1,1,-1,2,1
KR_6753798753,420,0,22,0,-4,-1,1,2,0,2,2,1,3,2,-2,0,2,-2,0,2,-3,-9,16,-2,3,1,0,0,0,1,1,0,-1,2,1
KR_6718969835,420,1,6,17,4,3,3,0,3,4,1,-3,1,4,2,6,4,-1,1,2,0,2,-156,-2,6,4,5,0,-1,-1,1,1,1,6,1
KR_6767861536,420,-3,-35,15,-11,-6,0,6,0,2,2,-2,1,3,-1,1,2,-2,1,3,-1,-7,1,-5,8,3,-1,0,1,-1,1,1,-1,3,1
KR_6699945589,420,2,5,-12,2,3,3,0,-6,0,6,0,3,3,4,7,3,1,1,0,0,-1,5,1,6,7,-2,0,-1,-1,-1,-1,1,2,1
KR_6664274566,420,5,54,-11,19,1,1,0,6,7,1,2,4,2,4,5,1,6,6,0,3,19,15,-1,7,6,-1,0,1,1,1,1,1,2,1
KR_6764955732,420,2,40,-4,2,1,2,1,0,2,2,1,4,3,-3,1,4,3,3,0,0,0,6,-3,8,5,0,0,0,1,-1,-1,1,1,1
KR_6757355029,420,1,16,-9,3,5,5,0,-5,0,5,3,3,0,0,1,1,0,2,2,0,-1,-111,-4,7,3,0,0,-1,1,1,-1,1,1,1
KR_6738452551,420,1,16,19,5,-1,0,1,4,5,1,2,5,3,-1,1,2,1,1,0,0,8,-57,0,3,3,-19,0,0,-1,-1,0,-1,2,1
KR_6718907957,420,0,8,-4,2,-1,1,2,-1,3,4,3,4,1,1,1,0,0,1,1,0,1,5,2,6,8,-1,0,0,1,1,1,1,6,1
KR_6747090105,420,-1,-8,-20,3,-3,0,3,-2,2,4,4,6,2,4,5,1,0,0,0,0,6,-8,-1,6,5,-1,0,0,0,-1,0,1,0,1
KR_6736323203,420,1,1,1,8,2,3,1,1,3,2,7,7,0,-2,0,2,0,0,0,0,3,6,3,3,6,4,0,1,1,1,1,1,6,1
KR_6712240483,420,5,98,18,9,4,6,2,-1,0,1,2,4,2,5,5,0,-1,1,2,0,13,-30,0,6,6,6,0,0,1,-1,0,1,3,1
KR_6739506450,420,0,84,-19,6,-3,2,5,0,5,5,1,2,1,7,9,2,1,2,1,0,7,39,-1,3,2,5,0,0,1,1,1,1,2,1
KR_6762181916,420,1,26,16,-1,3,4,1,1,3,2,-4,0,4,-1,1,2,0,0,0,0,3,-7,0,5,5,2,0,0,-1,1,1,1,6,1
KR_6762442659,440,2,28,26,7,1,1,0,-1,3,4,-1,1,2,7,7,0,1,1,0,0,6,-202,3,4,7,3,0,0,1,-1,0,1,3,1
KR_6681506639,420,2,61,-12,4,1,5,4,2,4,2,1,1,0,0,2,2,0,0,0,-1,6,-2,3,1,4,2,0,1,-1,1,1,-1,3,1
KR_6636576403,440,-3,38,-12,-4,3,4,1,-3,0,3,1,3,2,-5,0,5,0,0,0,0,-2,-3,0,1,1,0,0,0,-1,0,1,1,5,1
KR_6768292523,420,-3,-35,-14,-7,-3,2,5,2,6,4,-1,1,2,-3,2,5,-2,0,2,0,-12,-18,4,4,8,-3,0,-1,-1,-1,-1,-1,5,1
KR_6738998084,420,0,28,-7,4,2,2,0,2,3,1,3,6,3,-2,3,5,-1,2,3,1,8,-6,-2,9,7,-1,0,0,-1,1,0,1,6,1
KR_6763222457,420,0,26,-10,1,-2,0,2,-3,2,5,1,2,1,6,8,2,-1,0,1,0,0,-119,-2,5,3,0,0,1,1,1,1,1,6,1
KR_6709671777,420,-1,-21,32,3,4,5,1,2,4,2,-2,3,5,-1,0,1,0,0,0,0,-6,1,-1,6,5,-1,0,0,1,1,1,1,4,1
KR_6758733310,420,1,10,-29,-4,2,2,0,-4,3,7,1,2,1,-2,2,4,-1,0,1,0,-8,-26,-2,5,3,4,0,1,-1,-1,1,1,5,1
KR_6769013419,420,-1,-25,8,0,-2,0,2,0,2,2,1,2,1,2,5,3,-1,2,3,0,-2,-20,1,3,4,4,0,0,0,-1,0,-1,0,1
KR_6743545470,440,4,47,31,8,-3,2,5,6,7,1,6,6,0,-1,1,2,0,0,0,1,1,111,-7,11,4,4,0,1,1,1,1,1,3,1
KR_6761303108,440,8,130,3,13,3,5,2,1,2,1,2,5,3,2,6,4,5,5,0,0,9,4,5,3,8,-1,0,1,0,1,1,1,0,1
KR_6692604699,420,1,26,60,8,1,2,1,-1,6,7,-1,1,2,9,9,0,0,4,4,0,0,1,2,4,6,1,0,1,1,0,1,1,6,1
KR_6729221972,420,-1,17,9,-1,0,2,2,3,4,1,1,2,1,-2,0,2,-3,0,3,0,2,-157,-7,9,2,15,0,0,-1,1,0,-1,5,1
KR_6613395054,420,3,39,0,9,1,1,0,3,6,3,2,2,0,2,2,0,1,2,1,0,15,114,5,4,9,2,0,0,-1,1,1,1,5,1
KR_6740418456,420,2,61,-5,3,0,1,1,7,7,0,1,2,1,-6,0,6,1,2,1,1,4,149,-4,9,5,3,0,1,1,1,1,1,6,1
KR_6598832078,420,0,4,28,0,-1,0,1,2,4,2,2,3,1,1,3,2,-4,0,4,0,-1,-2,-1,6,5,-3,0,0,1,0,0,1,1,1
KR_6762395501,420,0,-37,13,3,-2,0,2,0,2,2,8,8,0,-4,4,8,1,2,1,-1,2,-1,0,5,5,-1,0,0,-1,0,0,-1,3,1
KR_6761795291,440,1,5,1,8,1,1,0,1,2,1,6,6,0,2,2,0,-2,0,2,0,7,-8,-3,5,2,3,0,0,1,1,0,1,4,1
KR_6726008119,420,9,150,64,19,3,3,0,4,4,0,4,5,1,6,8,2,2,2,0,2,23,4,5,1,6,2,1,4,-1,1,1,1,6,1
KR_6760598203,420,2,63,16,9,5,6,1,1,3,2,1,3,2,2,3,1,0,0,0,0,16,-94,-1,6,5,0,0,0,1,1,0,1,1,1
KR_6675308653,420,0,61,-4,4,-1,3,4,-1,2,3,3,5,2,3,3,0,0,1,1,0,6,12,7,4,11,-6,0,0,0,1,1,1,0,1
KR_6725526987,420,1,26,4,3,2,5,3,-2,3,5,-3,0,3,4,5,1,2,2,0,-2,-3,-158,1,2,3,1,0,3,-1,1,1,-1,5,1
KR_6723064223,420,0,-42,-21,4,0,2,2,-1,2,3,0,4,4,0,2,2,5,5,0,1,4,-189,-1,3,2,0,0,-2,-1,-1,-1,1,1,1
KR_6766661963,420,0,16,-12,5,3,3,0,0,3,3,1,5,4,0,2,2,1,2,1,0,6,-22,-3,5,2,3,0,1,1,1,1,1,2,1
KR_6702867394,420,0,59,-1,-1,0,0,0,-1,1,2,-2,2,4,0,4,4,2,3,1,-1,-6,-2,-2,7,5,4,0,1,-1,-1,-1,-1,6,1
KR_6694502607,420,1,-57,-4,2,-1,2,3,0,4,4,0,7,7,1,2,1,2,2,0,0,8,-6,3,2,5,-5,0,-1,1,-1,1,-1,1,1
KR_6692074745,420,2,42,4,9,-7,0,7,0,3,3,7,8,1,8,8,0,1,2,1,0,13,-2,-5,6,1,5,0,1,1,-1,-1,-1,3,1
KR_6760750421,420,1,29,20,2,1,2,1,-3,5,8,0,1,1,2,5,3,2,5,3,-2,-1,-4,1,4,5,3,0,-1,1,1,1,-1,5,1
KR_6754260206,420,0,-26,12,0,2,2,0,-4,1,5,-2,3,5,1,2,1,3,4,1,0,-2,-230,5,3,8,-5,0,1,-1,-1,1,1,5,1
KR_6732226836,420,3,78,-4,-1,2,2,0,-7,0,7,1,5,4,3,3,0,0,2,2,0,-5,-2,0,5,5,0,0,2,1,1,1,-1,3,1
KR_6741804535,440,3,91,24,4,-1,0,1,3,3,0,-4,1,5,3,3,0,3,3,0,1,6,1,2,3,5,1,0,1,-1,0,1,1,3,1
KR_6741603558,420,2,27,12,9,3,3,0,1,5,4,1,4,3,1,1,0,3,4,1,1,13,10,-2,5,3,6,0,0,1,-1,0,1,6,1
KR_6759744790,420,1,40,-12,2,-1,2,3,3,3,0,-3,1,4,3,3,0,0,1,1,0,2,2,-4,8,4,4,0,0,0,1,0,1,0,1
KR_6690614074,420,0,-20,1,3,0,1,1,2,3,1,5,5,0,-3,1,4,-1,1,2,0,-1,3,2,3,5,-2,0,-1,-1,-1,-1,1,5,1
KR_6767181536,420,0,-63,4,-4,-1,1,2,3,3,0,-5,1,6,-2,2,4,1,2,1,0,-6,-434,-2,4,2,3,0,-1,1,-1,-1,1,3,1
KR_6684374468,420,-3,1,7,4,-3,1,4,-1,1,2,4,4,0,6,6,0,-2,0,2,0,1,-3,2,4,6,3,0,0,-1,1,0,-1,3,1
KR_6751740342,420,0,40,7,-1,4,5,1,-2,2,4,-4,1,5,2,2,0,-1,0,1,0,-1,-3,-2,5,3,5,0,1,-1,1,1,1,3,1
KR_6766162915,420,-2,-3,-25,-8,1,3,2,-4,1,5,-1,1,2,-1,3,4,-3,1,4,0,-5,-4,2,1,3,-3,0,0,1,-1,1,1,3,1
KR_6767138868,420,-1,34,-37,-2,-1,1,2,0,0,0,-5,2,7,4,4,0,0,1,1,-1,-7,-18,-1,4,3,0,0,1,1,0,1,-1,6,1
KR_6763043092,420,2,32,5,3,2,3,1,1,1,0,-1,2,3,0,0,0,1,3,2,0,0,3,0,6,6,3,0,0,1,-1,1,1,1,1
KR_6747478971,420,2,51,21,8,3,4,1,-1,2,3,0,2,2,10,10,0,-4,0,4,2,10,-11,-4,8,4,0,0,1,1,-1,1,1,3,1
KR_6711146837,440,0,44,4,0,-2,4,6,-5,1,6,2,5,3,4,4,0,1,1,0,0,-2,48,-3,4,1,-9,0,1,1,1,1,1,1,1
KR_6766104158,420,1,48,-20,4,-3,2,5,0,1,1,-3,1,4,11,13,2,-1,2,3,1,7,3,1,5,6,0,0,2,1,1,1,1,6,1
KR_6752247962,440,3,-6,-22,4,2,4,2,-2,2,4,5,5,0,-1,1,2,0,0,0,0,5,-156,0,5,5,25,0,-1,-1,-1,-1,-1,1,1
KR_6751877698,420,0,5,4,8,1,2,1,-2,2,4,6,9,3,4,5,1,-1,2,3,1,11,4,5,2,7,-1,0,1,-1,1,1,1,5,1
KR_6761110738,420,2,20,-33,8,5,7,2,0,2,2,1,2,1,3,4,1,-1,0,1,1,4,29,0,4,4,-6,0,0,0,0,0,1,0,1
KR_6765673448,420,5,82,1,5,-1,2,3,2,5,3,-3,3,6,4,5,1,3,3,0,1,12,9,2,5,7,1,0,1,1,-1,1,1,1,1
KR_6737246742,420,4,17,15,9,1,1,0,3,4,1,6,6,0,-2,3,5,1,1,0,-1,5,-6,1,9,10,9,0,0,-1,1,0,-1,2,1
KR_6745745776,440,4,90,36,8,-2,5,7,3,7,4,3,5,2,6,6,0,-2,1,3,4,21,3,0,4,4,2,0,2,1,1,1,1,1,1
KR_6768328016,440,0,-15,13,-6,3,4,1,-1,0,1,-3,0,3,-4,1,5,-1,3,4,0,-16,11,0,7,7,-6,0,1,1,-1,1,1,2,1
KR_6767950279,420,1,-30,9,-10,2,2,0,-1,1,2,-5,1,6,-5,2,7,-1,0,1,0,-13,1,-1,5,4,0,0,-1,-1,1,-1,-1,5,1
KR_6765566026,420,2,27,28,4,0,1,1,0,1,1,6,8,2,0,2,2,-2,0,2,0,2,-18,-4,5,1,-1,0,0,-1,1,0,-1,2,1
KR_6761123213,440,0,-1,-20,2,1,1,0,-4,0,4,-1,1,2,5,6,1,1,1,0,0,5,10,-1,7,6,0,0,0,1,-1,1,-1,5,1
KR_6752874925,420,0,2,-8,-2,0,1,1,0,2,2,3,3,0,-4,1,5,-1,0,1,0,-5,84,0,3,3,2,0,0,1,0,0,-1,2,1
KR_6619050331,420,-2,-10,16,-5,-1,1,2,0,2,2,-3,2,5,-2,0,2,1,1,0,-1,-7,-2,-1,4,3,2,0,-1,1,-1,-1,-1,2,1
KR_6751416568,420,0,-1,-11,0,-1,1,2,2,2,0,1,3,2,-2,0,2,0,1,1,0,-3,4,-1,7,6,5,0,0,1,-1,-1,1,2,1
KR_6727782457,420,1,46,4,7,2,3,1,1,2,1,8,8,0,-3,1,4,-1,2,3,2,6,18,1,4,5,-2,0,0,1,-1,0,1,3,1
KR_6737736300,420,3,-27,12,7,-2,0,2,2,3,1,0,3,3,7,7,0,0,0,0,0,12,-6,-1,5,4,2,0,-1,-1,-1,1,-1,6,1
KR_6741055422,420,6,74,8,19,4,5,1,5,6,1,4,7,3,5,5,0,1,2,1,0,14,8,1,1,2,3,0,2,1,-1,1,1,2,1
KR_6750882944,420,-1,54,-9,-1,-2,1,3,4,7,3,-1,1,2,-3,4,7,1,3,2,2,15,5,2,2,4,-3,0,0,1,-1,-1,1,5,1
KR_6739670729,420,3,37,32,6,-4,1,5,0,3,3,1,3,2,8,10,2,1,1,0,0,9,37,1,5,6,3,0,3,1,-1,1,1,1,1
KR_6749001852,440,4,118,18,2,-2,0,2,6,6,0,-1,1,2,-2,1,3,1,2,1,0,-7,2,4,0,4,-1,0,0,1,-1,1,1,4,1
KR_6702061234,420,2,25,32,1,-2,0,2,0,3,3,3,4,1,-3,1,4,3,3,0,0,3,-216,-3,6,3,2,0,0,-1,1,-1,-1,2,1
KR_6637172744,420,0,74,-7,8,0,2,2,1,2,1,-1,2,3,0,0,0,8,9,1,0,7,4,0,3,3,-1,0,1,0,1,1,1,0,1
KR_6663321366,420,1,16,-12,3,2,2,0,-1,3,4,-2,1,3,4,6,2,0,1,1,0,2,5,2,7,9,-8,0,0,1,-1,1,-1,4,1
KR_6761771247,420,2,43,2,5,0,4,4,4,5,1,0,3,3,-1,1,2,2,2,0,0,-4,9,2,4,6,1,0,2,-1,1,1,1,6,1
KR_6762412749,420,2,40,5,11,-2,1,3,2,5,3,6,9,3,2,3,1,3,3,0,2,5,12,3,3,6,-1,0,0,-1,-1,0,1,4,1
KR_6766915411,420,4,47,35,4,1,2,1,0,2,2,3,4,1,2,3,1,-2,0,2,0,2,6,2,1,3,-2,0,1,1,1,1,-1,2,1
KR_6767379945,420,-1,-6,9,-10,1,1,0,-5,1,6,0,0,0,-5,0,5,-1,2,3,1,-16,1,-2,4,2,-1,0,0,-1,0,0,1,1,1
KR_6752674112,420,-2,-68,11,-8,-6,0,6,-2,1,3,-3,1,4,2,4,2,1,1,0,0,4,3,-4,8,4,-4,0,-1,-1,0,-1,1,5,1
KR_6698122774,420,3,41,27,5,3,4,1,0,3,3,2,4,2,-1,2,3,1,1,0,2,-5,0,6,1,7,1,0,3,-1,1,1,1,1,1
KR_6634546077,420,2,78,-4,7,4,5,1,2,2,0,-6,2,8,8,8,0,-1,0,1,0,11,-20,-4,6,2,4,0,1,-1,-1,1,1,5,1
KR_6597651447,420,3,33,47,3,4,4,0,-4,2,6,2,4,2,1,4,3,0,1,1,1,-4,1,-4,8,4,-5,0,-1,1,-1,-1,1,6,1
KR_6726930403,420,5,103,36,2,2,2,0,1,2,1,-2,0,2,0,1,1,1,2,1,1,6,8,1,4,5,-1,0,0,0,1,0,1,0,1
KR_6736053445,420,-1,53,-4,6,1,2,1,1,4,3,-1,1,2,5,7,2,0,1,1,0,5,-35,-1,3,2,5,0,1,1,0,1,1,5,1
KR_6636979273,420,4,27,8,9,2,2,0,4,6,2,3,5,2,-1,3,4,1,1,0,0,4,1,-1,3,2,4,0,2,1,1,1,-1,4,1
KR_6765880097,420,4,59,0,5,0,1,1,-2,0,2,2,3,1,5,6,1,0,2,2,0,3,-12,4,0,4,1,0,2,1,1,1,-1,5,1
KR_6727155782,420,1,97,4,3,5,6,1,0,1,1,-1,1,2,-1,3,4,0,0,0,0,-3,51,5,2,7,-14,0,0,1,-1,1,-1,3,1
KR_6768223513,420,-2,-47,-13,7,5,5,0,4,4,0,-2,1,3,5,7,2,-5,0,5,1,5,8,-1,4,3,-4,0,3,-1,1,1,1,4,1
KR_6484323952,420,-1,-9,24,0,4,5,1,-4,0,4,-1,3,4,0,1,1,1,1,0,0,-2,-8,-4,7,3,2,0,-1,-1,1,-1,1,3,1
KR_6755202050,420,2,9,-12,5,10,12,2,-5,1,6,-1,1,2,0,3,3,1,1,0,1,0,6,2,5,7,-1,0,4,1,1,1,1,3,1
KR_6756779484,420,-1,10,-32,2,0,2,2,3,3,0,2,4,2,-1,0,1,-2,0,2,0,8,25,4,6,10,-8,0,0,1,-1,0,-1,1,1
KR_6672005035,420,1,61,24,10,1,5,4,1,4,3,2,3,1,5,5,0,1,3,2,0,7,5,2,3,5,-2,0,1,1,1,1,-1,5,1
KR_6761136644,440,3,-67,9,8,2,2,0,-1,1,2,5,6,1,0,3,3,2,2,0,0,5,1,-3,7,4,4,0,0,-1,-1,0,-1,3,1
KR_6726934331,440,-1,61,-21,5,2,4,2,5,7,2,1,2,1,-2,1,3,-1,0,1,2,8,20,0,5,5,3,0,1,1,1,1,1,6,1
KR_6762777847,420,2,37,12,7,6,7,1,-3,1,4,0,4,4,2,3,1,2,2,0,0,9,2,-2,5,3,-3,0,1,1,0,1,1,3,1
KR_6291175145,420,4,16,9,6,3,4,1,-1,3,4,1,1,0,0,1,1,3,4,1,0,4,-20,-5,6,1,1,0,1,0,1,1,1,0,1
KR_6731593688,420,1,-12,15,-2,-2,0,2,4,9,5,2,2,0,-5,0,5,-1,2,3,-1,-1,57,2,6,8,-33,0,0,1,-1,-1,-1,6,1
KR_6674449386,420,0,28,-8,-1,2,2,0,-1,1,2,-1,3,4,-1,0,1,0,0,0,0,-5,-19,2,4,6,0,0,0,1,1,0,1,1,1
KR_6639292997,440,6,42,35,13,4,4,0,-1,4,5,4,6,2,5,6,1,1,2,1,0,8,5,4,1,5,-1,0,0,0,1,1,1,0,1
KR_6740608742,420,3,56,31,-3,-6,0,6,1,5,4,0,2,2,3,4,1,-1,2,3,0,-2,3,-4,8,4,3,0,1,1,0,1,1,3,1
KR_6768797931,440,6,77,42,23,2,6,4,0,0,0,2,5,3,16,16,0,3,3,0,0,20,-12,1,3,4,4,0,1,1,1,1,1,2,1
KR_6620428540,420,0,-13,4,2,3,4,1,0,1,1,-5,0,5,4,6,2,0,0,0,0,2,-12,5,5,10,4,0,1,-1,1,1,1,1,1
KR_6743801753,420,1,9,-8,2,0,0,0,2,3,1,0,2,2,0,2,2,0,1,1,0,3,-1,-2,7,5,4,0,0,0,-1,0,1,0,1
KR_6711699779,440,3,41,8,5,1,2,1,0,0,0,2,5,3,1,3,2,1,1,0,0,7,35,-1,5,4,-18,0,0,1,-1,-1,1,6,1
KR_6753099345,420,5,58,45,9,4,6,2,0,1,1,7,9,2,-4,2,6,2,4,2,0,9,16,2,3,5,1,0,2,1,0,1,1,2,1
KR_6685075386,420,2,35,16,4,1,3,2,3,9,6,1,3,2,0,0,0,-1,1,2,0,5,-42,3,4,7,10,0,2,1,1,1,-1,3,1
KR_6741577309,440,-1,-28,12,-3,1,2,1,-1,1,2,-1,1,2,-2,0,2,0,3,3,0,-4,104,-3,5,2,-4,0,1,-1,1,1,-1,4,1
KR_6769186544,440,-1,75,-4,-10,-6,1,7,-6,1,7,2,7,5,-2,2,4,2,3,1,1,-7,-5,-3,3,0,-1,0,-1,-1,-1,-1,1,6,1
KR_6734653408,420,0,45,-8,-1,1,5,4,3,3,0,0,1,1,-5,4,9,0,0,0,1,-9,30,-1,8,7,5,0,1,-1,1,1,-1,1,1
KR_6769123598,420,-2,-29,-12,-2,2,2,0,2,3,1,2,3,1,-6,5,11,-2,0,2,0,-6,16,1,3,4,-9,0,-1,-1,-1,-1,-1,6,1
KR_6756719803,420,-4,-87,-27,-9,-3,0,3,2,2,0,0,3,3,-7,3,10,-1,1,2,1,-7,-7,-2,4,2,2,0,-1,0,-1,-1,1,0,1
KR_6742787969,420,-2,-48,-21,1,-3,2,5,3,3,0,0,5,5,-1,3,4,2,2,0,0,11,20,-6,8,2,-3,0,1,-1,1,1,1,4,1
KR_6685309561,420,3,-17,32,6,0,1,1,-3,1,4,3,5,2,3,6,3,3,3,0,0,9,-23,-2,6,4,3,0,1,1,1,1,-1,2,1
KR_6763439394,420,-1,28,-14,2,-1,2,3,2,4,2,-3,0,3,3,4,1,1,2,1,-1,12,219,2,2,4,-1,0,-1,1,-1,-1,-1,2,1
KR_6761451110,420,-2,-96,16,0,-2,0,2,1,3,2,3,6,3,0,1,1,-2,0,2,0,2,-40,-2,4,2,23,0,2,0,1,-1,1,0,1
KR_6719663845,420,0,70,-4,1,3,4,1,-2,2,4,1,5,4,-2,1,3,1,2,1,0,-2,463,0,3,3,-1,0,2,1,1,1,-1,3,1
KR_6764976220,420,-1,-25,21,5,3,5,2,5,7,2,-4,1,5,1,3,2,0,0,0,0,4,12,7,2,9,-7,0,0,1,1,0,1,1,1
KR_6754423686,420,-1,34,9,-2,-1,3,4,1,1,0,-3,0,3,2,3,1,-1,2,3,1,0,-3,4,3,7,4,0,-1,1,-1,-1,1,4,1
KR_6768714665,420,3,87,-14,6,1,3,2,4,6,2,5,7,2,2,3,1,-6,1,7,1,1,322,2,4,6,-1,0,0,1,1,1,1,3,1
KR_6690302888,420,-3,-34,6,-1,-1,0,1,-1,3,4,-1,2,3,1,7,6,1,1,0,-1,-4,17,4,5,9,0,0,0,1,-1,0,1,4,1
KR_6704396860,440,2,17,4,5,-2,0,2,2,3,1,0,1,1,1,1,0,4,6,2,2,21,65,2,6,8,2,0,1,1,1,1,1,2,1
KR_6692192614,420,0,71,-30,3,2,2,0,-7,3,10,2,3,1,5,6,1,1,2,1,0,10,362,4,5,9,-1,0,0,1,-1,1,1,2,1
KR_6414146081,420,2,59,12,3,3,3,0,-2,1,3,-4,1,5,4,4,0,2,2,0,0,0,27,5,1,6,-3,0,1,1,-1,1,-1,3,1
KR_6737191735,420,-4,24,-21,0,-2,3,5,1,3,2,-1,1,2,1,4,3,1,2,1,0,0,-27,-1,5,4,0,0,-2,-1,1,1,1,5,1
KR_6737014689,420,-2,-55,-5,-2,-2,0,2,2,3,1,0,1,1,1,4,3,-3,0,3,0,2,-30,1,5,6,7,0,0,1,1,-1,1,3,1
KR_6746829702,420,3,80,-4,11,2,3,1,-1,0,1,1,1,0,2,2,0,7,7,0,0,10,14,4,3,7,-4,0,1,1,-1,1,1,3,1
KR_6704311814,440,4,-24,8,1,-1,2,3,0,5,5,-3,3,6,8,8,0,-3,0,3,-1,6,0,0,7,7,-1,0,0,-1,1,1,-1,5,1
KR_6761735221,420,3,7,1,2,-2,0,2,3,5,2,2,2,0,0,2,2,-1,0,1,0,4,-1,-4,12,8,4,0,0,1,-1,0,-1,3,1
KR_6747923718,420,2,45,26,4,2,4,2,-3,1,4,2,3,1,0,4,4,3,3,0,0,0,129,-1,3,2,0,0,1,0,1,1,1,0,1
KR_6764849651,420,0,-28,25,4,1,2,1,0,3,3,3,6,3,1,3,2,-1,0,1,-1,-2,-21,1,6,7,30,0,-2,1,-1,-1,-1,6,1
KR_6767488758,440,2,67,52,1,3,4,1,2,3,1,-1,0,1,-2,1,3,-1,0,1,0,-8,-1,1,6,7,4,0,1,-1,1,1,1,4,1
KR_6655121429,420,3,79,13,4,0,0,0,4,4,0,0,0,0,1,3,2,-1,0,1,0,2,6,0,5,5,2,0,0,1,1,0,1,5,1
KR_6752992509,420,-2,-41,-12,-5,-5,1,6,-1,0,1,-1,2,3,3,5,2,-1,2,3,0,-2,3,-4,5,1,-1,0,-1,0,-1,-1,-1,0,1
KR_6756868094,420,0,35,29,6,-3,3,6,2,2,0,4,8,4,2,3,1,1,1,0,0,8,15,-1,4,3,1,0,1,0,0,1,1,0,1
KR_6761802524,420,0,24,-4,3,3,4,1,3,4,1,1,1,0,-6,2,8,2,2,0,0,-2,-6,1,2,3,-2,0,1,-1,1,1,1,4,1
KR_6741957224,420,0,-8,0,-1,-2,1,3,-2,0,2,2,3,1,0,5,5,1,3,2,-1,0,162,0,7,7,-4,0,2,1,-1,1,-1,2,1
KR_6763296792,420,-1,-89,28,-2,-3,2,5,2,6,4,-2,0,2,1,4,3,0,1,1,0,-3,-94,-2,4,2,0,0,0,1,1,0,-1,3,1
KR_6760694199,420,-3,-67,-2,-4,-1,1,2,-1,2,3,-2,4,6,-1,2,3,1,2,1,0,-9,5,6,3,9,-3,0,0,-1,1,0,-1,2,1
KR_6761353344,420,0,43,12,-5,2,3,1,0,1,1,-6,2,8,-3,1,4,2,2,0,0,-13,2,2,5,7,-4,0,2,1,-1,1,1,4,1
KR_6761184491,420,3,29,8,8,-2,0,2,5,6,1,2,2,0,2,3,1,1,1,0,0,13,0,2,5,7,4,0,0,1,-1,-1,1,1,1
KR_6701380471,420,5,84,12,4,1,2,1,-4,1,5,5,6,1,2,2,0,0,2,2,0,-2,0,-2,7,5,-3,0,1,1,1,1,1,5,1
KR_6484427488,420,1,47,0,2,0,3,3,-2,2,4,6,6,0,-4,3,7,2,3,1,0,6,11,6,2,8,4,0,2,1,1,-1,-1,5,1
KR_6660787446,420,-1,-28,12,0,-3,1,4,2,3,1,-1,2,3,2,5,3,0,1,1,0,8,8,1,5,6,-4,0,0,-1,1,1,1,2,1
KR_6766409788,420,0,-42,-12,1,-5,1,6,2,3,1,4,5,1,1,2,1,-1,0,1,0,10,8,-3,5,2,3,0,0,-1,1,0,-1,5,1
KR_6666678948,420,7,91,20,12,1,2,1,7,7,0,1,3,2,4,4,0,-1,0,1,1,11,65,2,4,6,-1,0,1,1,-1,1,1,5,1
KR_6760264350,420,1,-36,35,2,-4,1,5,-2,5,7,2,4,2,6,6,0,0,1,1,0,13,-303,1,4,5,1,0,0,1,-1,-1,-1,4,1
KR_6752432692,420,1,-18,27,0,8,8,0,-1,1,2,0,3,3,-5,2,7,-2,0,2,0,-1,345,0,3,3,-4,0,1,-1,0,1,1,1,1
KR_6501103915,420,6,56,36,11,3,4,1,2,4,2,-2,1,3,9,10,1,-1,2,3,0,7,127,3,2,5,-3,0,1,1,1,1,1,1,1
KR_6768993717,420,2,68,32,4,-1,1,2,-3,1,4,-2,1,3,6,6,0,4,5,1,0,10,38,5,0,5,-16,0,0,1,1,1,1,3,1
KR_6767189974,440,3,37,1,6,1,1,0,5,5,0,-5,1,6,1,2,1,4,5,1,0,12,11,-3,6,3,-1,0,0,1,0,0,-1,2,1
KR_6703308458,440,2,7,-7,7,1,2,1,-1,6,7,6,8,2,2,4,2,-1,2,3,0,6,0,-3,6,3,8,0,0,-1,-1,0,1,4,1
KR_6750945637,440,1,20,31,3,0,3,3,1,2,1,2,4,2,3,6,3,-3,1,4,0,5,17,6,2,8,2,0,0,1,1,0,-1,3,1
KR_6756879146,420,-1,7,0,0,-2,0,2,-4,4,8,3,4,1,2,4,2,1,1,0,0,-2,-57,-6,9,3,30,0,-1,1,-1,-1,1,1,1
KR_6758468485,420,2,59,8,5,-2,0,2,2,7,5,3,3,0,4,4,0,-2,0,2,0,4,-17,-4,6,2,0,0,0,1,-1,-1,1,5,1
KR_6612411858,420,2,19,45,6,-2,1,3,3,5,2,0,2,2,7,7,0,-2,1,3,0,10,2,2,3,5,-2,0,1,1,1,1,1,3,1
KR_6756797218,440,5,37,45,13,-2,0,2,2,4,2,4,5,1,9,9,0,0,0,0,0,11,14,4,3,7,2,0,2,1,1,1,1,1,1
KR_6763620847,440,-1,82,-21,7,6,7,1,-4,0,4,0,0,0,3,3,0,2,4,2,0,12,118,4,3,7,6,0,1,-1,1,1,1,6,1
KR_6761877858,440,-2,-14,16,-3,-2,3,5,0,2,2,-2,0,2,2,5,3,-1,3,4,-1,-21,-10,-1,4,3,1,0,1,1,1,1,-1,3,1
KR_6656587872,420,2,8,-4,1,2,3,1,-2,1,3,1,2,1,0,1,1,0,0,0,0,2,-8,0,4,4,2,0,0,-1,1,0,1,5,1
KR_6753712373,440,2,-58,24,-1,-3,1,4,6,7,1,-1,3,4,-1,3,4,-2,0,2,0,-2,57,3,3,6,-16,0,0,-1,1,-1,-1,3,1
KR_6740671412,420,7,47,27,17,3,4,1,1,2,1,6,10,4,5,6,1,2,4,2,0,17,7,-1,4,3,0,0,0,1,1,1,1,1,1
KR_6758612445,420,0,-32,8,2,6,6,0,-1,0,1,-2,1,3,0,1,1,-1,0,1,0,-1,-12,-3,8,5,-5,0,0,0,-1,0,1,0,1
KR_6746956095,420,3,39,20,4,-1,1,2,-1,3,4,-3,1,4,6,7,1,3,5,2,0,5,5,1,3,4,-11,0,1,1,-1,1,-1,2,1
KR_6764964723,420,3,-15,-4,9,-2,0,2,1,4,3,1,4,3,3,6,3,6,6,0,0,5,-11,-5,5,0,1,0,1,1,1,1,1,4,1
KR_6758931256,420,3,-2,15,10,1,1,0,1,2,1,3,3,0,2,5,3,3,3,0,0,1,-11,5,2,7,-1,0,2,1,-1,1,1,3,1
KR_6760092432,420,-1,48,12,0,1,1,0,-5,3,8,2,2,0,3,5,2,-1,0,1,0,-3,-13,0,5,5,4,0,0,-1,1,1,-1,2,1
KR_6756335330,420,-2,9,4,4,0,2,2,-1,2,3,1,3,2,5,7,2,-1,2,3,3,11,-4,-2,7,5,-2,0,2,-1,1,1,1,4,1
KR_6748058035,420,-2,-35,-5,2,2,4,2,0,2,2,-3,2,5,1,4,3,2,3,1,0,3,-5,-2,6,4,1,0,-1,-1,-1,-1,1,3,1
KR_6690007230,420,4,115,20,8,4,5,1,3,3,0,1,2,1,1,9,8,-1,2,3,0,-3,47,4,2,6,-18,0,4,1,1,1,1,4,1
KR_6758412571,420,0,93,13,1,4,6,2,0,4,4,1,4,3,-3,0,3,-1,1,2,0,-7,0,1,2,3,-3,0,3,1,1,1,1,4,1
KR_6743453381,420,2,33,-7,5,-2,1,3,7,7,0,-1,1,2,0,3,3,1,2,1,0,1,-3,-2,5,3,-1,0,1,1,1,1,-1,3,1
KR_6731963092,420,3,-7,8,5,2,4,2,2,3,1,-3,0,3,2,3,1,2,5,3,0,7,32,-1,5,4,8,0,2,-1,1,1,1,3,1
KR_6707155917,440,0,22,-6,-2,-1,0,1,2,4,2,-3,2,5,1,2,1,-1,0,1,0,0,4,-1,4,3,0,0,0,1,1,0,-1,2,1
KR_6764522669,420,5,92,1,10,2,3,1,0,1,1,5,5,0,2,2,0,1,1,0,0,6,-3,3,5,8,-1,0,2,1,1,1,1,2,1
KR_6750877144,440,2,-1,-32,8,-1,2,3,4,5,1,0,2,2,6,7,1,-1,0,1,1,5,-2,0,3,3,5,0,1,-1,1,1,1,3,1
KR_6762182560,420,-1,-30,16,-4,-2,3,5,-2,3,5,-2,1,3,1,3,2,1,3,2,0,-1,0,-2,4,2,3,0,-1,0,-1,-1,1,0,1
KR_6765837978,420,2,37,11,8,0,3,3,-2,0,2,2,3,1,7,8,1,1,1,0,1,10,29,4,4,8,-2,0,1,1,-1,1,1,3,1
KR_6748444979,440,3,64,-9,9,1,1,0,5,8,3,0,2,2,3,7,4,0,0,0,0,20,48,2,5,7,-19,0,0,1,-1,1,1,5,1
KR_6762650365,420,1,-19,4,-4,1,1,0,4,7,3,-1,3,4,-7,1,8,-1,1,2,0,-1,4,2,4,6,-2,0,1,-1,1,1,-1,4,1
KR_6703015856,420,2,-11,12,10,0,2,2,3,4,1,0,2,2,7,10,3,0,0,0,0,11,3,5,4,9,2,0,0,1,1,1,1,5,1
KR_6655998206,420,-3,-18,-4,-5,-4,0,4,4,6,2,-3,1,4,0,0,0,-2,0,2,0,-9,-4,4,1,5,-3,0,0,0,-1,0,-1,0,1
KR_6741367757,420,5,39,0,10,2,3,1,2,5,3,1,1,0,1,2,1,4,4,0,1,8,7,3,3,6,2,0,2,1,1,1,1,5,1
KR_6639012346,420,6,86,-10,15,3,4,1,2,6,4,2,2,0,1,2,1,7,8,1,0,14,-21,1,5,6,8,0,1,0,1,1,1,0,1
KR_6720539276,420,-1,37,-23,2,-2,3,5,5,7,2,2,2,0,-1,2,3,-2,0,2,3,11,-22,1,3,4,0,0,-1,1,-1,-1,1,2,1
KR_6758403846,420,1,17,12,5,0,1,1,7,7,0,0,2,2,2,2,0,-4,1,5,0,10,-11,-4,6,2,4,0,0,-1,1,1,-1,4,1
KR_6720294088,420,2,81,8,5,0,2,2,0,0,0,3,3,0,3,3,0,-1,0,1,0,8,43,4,3,7,-20,0,1,-1,-1,1,1,2,1
KR_6669953559,420,-3,-64,-34,-5,0,1,1,0,3,3,-3,2,5,2,4,2,-4,1,5,-1,-1,14,-7,12,5,0,0,0,-1,1,1,-1,6,1
KR_6674666129,420,4,62,12,6,3,5,2,-2,0,2,-2,0,2,4,4,0,3,3,0,-1,1,-11,-2,6,4,-3,0,0,1,-1,1,-1,6,1
KR_6754296717,420,2,15,6,5,1,2,1,2,4,2,0,0,0,2,3,1,0,1,1,0,6,-251,1,4,5,4,0,1,1,-1,1,-1,5,1
KR_6738372785,420,2,-3,2,6,1,3,2,2,4,2,3,4,1,-1,2,3,1,2,1,0,13,5,5,4,9,3,0,0,0,1,1,1,0,1
KR_6760278699,420,1,-19,-16,2,-4,0,4,-3,2,5,2,2,0,6,7,1,1,1,0,0,13,2,0,3,3,0,0,0,1,-1,-1,-1,3,1
KR_6749149306,420,4,64,-20,14,4,4,0,3,3,0,3,6,3,0,0,0,4,4,0,0,9,11,6,1,7,4,0,2,-1,1,1,1,1,1
KR_6761239021,420,-2,-27,-20,-2,-1,1,2,1,2,1,3,4,1,-6,0,6,1,1,0,0,-4,5,0,4,4,-1,0,-1,0,-1,-1,1,0,1
KR_6762721832,420,0,-22,10,2,6,7,1,2,2,0,-2,3,5,-1,4,5,-3,1,4,0,8,26,-1,6,5,-1,0,2,1,1,1,1,6,1
KR_6728547083,420,4,57,18,9,1,2,1,1,2,1,-2,1,3,11,12,1,-2,0,2,1,14,17,6,3,9,-4,0,1,1,-1,1,1,3,1
KR_6740547152,420,4,23,-4,10,2,4,2,1,1,0,1,5,4,4,6,2,2,4,2,0,20,4,2,2,4,0,0,1,1,-1,1,1,3,1
KR_6537897212,420,5,45,11,11,3,3,0,1,3,2,4,4,0,2,4,2,1,1,0,0,9,-9,-2,7,5,3,0,0,-1,-1,0,1,2,1
KR_6759900856,420,0,40,-23,-6,-2,2,4,1,2,1,0,1,1,0,3,3,-5,1,6,0,-5,3,-4,6,2,-5,0,0,1,-1,1,-1,4,1
KR_6724666590,420,-2,-25,-3,-5,-1,0,1,-1,1,2,-2,3,5,1,2,1,-2,0,2,1,-1,1,0,4,4,-3,0,0,-1,1,0,1,4,1
KR_6768266541,420,2,80,14,8,1,2,1,3,5,2,3,5,2,1,3,2,0,1,1,0,1,34,2,8,10,3,0,1,0,1,1,1,0,1
KR_6636880136,440,1,-5,-19,10,1,1,0,0,3,3,1,2,1,7,7,0,1,1,0,0,18,-6,0,5,5,2,0,-1,1,-1,-1,1,1,1
KR_6733523526,420,0,10,-40,-2,-1,2,3,-2,2,4,0,1,1,2,2,0,-1,0,1,0,-5,12,0,5,5,-1,0,0,-1,1,1,1,5,1
KR_6766203835,420,0,29,8,0,2,5,3,1,4,3,-3,1,4,-2,2,4,2,2,0,-1,0,-6,1,2,3,-1,0,-1,1,-1,1,-1,3,1
KR_6727593519,420,-2,-49,7,-2,2,4,2,1,1,0,-2,2,4,-4,2,6,1,1,0,1,6,10,1,5,6,-1,0,0,1,1,0,1,4,1
KR_6744874135,420,-2,-18,-9,0,0,2,2,0,2,2,0,3,3,-1,0,1,1,2,1,0,5,2,0,6,6,-2,0,0,-1,1,0,-1,2,1
KR_6759732621,420,0,91,-24,4,3,5,2,-1,6,7,-1,1,2,7,12,5,-4,0,4,1,7,-13,2,3,5,-2,0,3,-1,1,1,1,3,1
KR_6769247939,420,2,42,-3,3,1,4,3,1,3,2,1,1,0,0,1,1,0,1,1,1,8,25,4,2,6,0,0,0,1,-1,0,1,2,1
KR_6549727671,420,4,55,24,5,-1,1,2,2,4,2,2,3,1,1,1,0,1,3,2,0,10,1,-3,5,2,1,0,2,1,-1,-1,-1,2,1
KR_6743561559,420,5,33,19,6,-1,1,2,3,5,2,2,4,2,0,1,1,2,2,0,0,4,-1,-2,6,4,1,0,0,1,-1,0,1,6,1
KR_6650899034,420,5,55,13,13,6,7,1,1,3,2,4,6,2,2,2,0,0,1,1,4,18,38,0,3,3,-1,0,0,1,1,1,1,5,1
KR_6766568370,420,5,119,-8,12,1,1,0,-1,0,1,6,7,1,5,6,1,1,1,0,0,9,4,0,4,4,3,0,1,1,1,1,1,6,1
KR_6740491382,420,2,131,32,6,-1,1,2,1,6,5,-2,3,5,8,9,1,0,2,2,1,15,14,3,4,7,1,0,1,1,1,1,1,1,1
KR_6622120819,420,2,27,-11,15,3,3,0,-1,0,1,2,4,2,8,10,2,3,3,0,0,5,4,1,6,7,-2,0,1,-1,-1,1,1,4,1
KR_6759780154,440,5,81,-14,10,1,3,2,1,2,1,7,7,0,1,4,3,0,1,1,0,8,-24,0,3,3,-1,0,1,1,-1,1,1,1,1
KR_6757487649,420,1,0,20,-6,-1,2,3,0,1,1,-3,2,5,-1,0,1,-1,0,1,0,-9,-1,-3,8,5,1,0,0,1,-1,0,-1,6,1
KR_6671928102,420,3,73,0,8,0,0,0,-2,2,4,2,5,3,3,3,0,5,5,0,0,14,3,0,5,5,0,0,1,1,-1,1,1,4,1
KR_6659364009,440,3,29,-21,7,-4,1,5,1,2,1,2,7,5,6,6,0,2,2,0,0,11,-30,2,2,4,1,0,1,1,0,-1,-1,2,1
KR_6745443403,420,10,120,15,28,7,7,0,1,2,1,11,11,0,4,4,0,5,5,0,0,7,-23,1,1,2,22,0,3,1,1,1,1,1,1
KR_6740166804,420,2,49,16,5,-1,1,2,6,6,0,3,3,0,0,0,0,-3,0,3,0,3,-3,1,5,6,-1,0,2,-1,1,1,-1,2,1
KR_6642765139,420,0,28,12,0,4,5,1,-3,0,3,2,3,1,-3,4,7,0,1,1,0,0,30,1,7,8,-29,0,1,1,1,1,-1,6,1
KR_6739520805,420,4,94,43,15,-2,0,2,3,4,1,8,8,0,2,5,3,4,6,2,0,10,30,3,2,5,9,0,1,1,1,1,1,2,1
KR_6750985962,420,2,39,56,5,1,2,1,5,6,1,1,7,6,-3,1,4,1,2,1,0,-1,2,3,4,7,1,0,2,1,1,1,-1,6,1
KR_6768264177,420,1,10,-20,2,1,3,2,-4,2,6,5,7,2,0,1,1,0,1,1,0,2,3,0,3,3,-6,0,-1,-1,-1,-1,1,6,1
KR_6759151887,440,1,69,8,0,0,3,3,1,2,1,-2,1,3,3,5,2,-2,0,2,0,4,-4,-1,2,1,0,0,0,1,1,0,1,4,1
KR_6754711988,420,-4,-28,-37,-5,-1,3,4,-6,1,7,6,6,0,-1,1,2,-3,1,4,1,-5,1,-2,3,1,0,0,0,-1,1,1,1,2,1
KR_6719740309,440,3,-18,1,6,-3,1,4,-1,1,2,6,7,1,3,4,1,1,2,1,0,7,11,1,3,4,0,0,1,1,1,1,-1,5,1
KR_6707904567,420,4,33,3,7,3,7,4,-1,1,2,4,6,2,1,4,3,0,0,0,-1,5,27,5,2,7,-3,0,3,-1,1,1,-1,3,1
KR_6754625831,420,4,59,16,10,6,7,1,0,2,2,3,4,1,-2,6,8,3,4,1,3,15,14,-3,6,3,-3,0,2,1,1,1,1,2,1
KR_6637780441,420,3,21,11,6,5,5,0,-1,2,3,1,2,1,-1,1,2,2,2,0,0,3,-19,0,3,3,-2,0,1,-1,1,1,1,3,1
KR_6759616214,420,2,24,24,9,-4,2,6,4,4,0,1,3,2,5,6,1,3,4,1,0,8,-5,2,1,3,1,0,0,1,-1,1,1,3,1
KR_6678723678,420,3,67,7,4,0,3,3,0,2,2,0,3,3,2,3,1,2,2,0,0,13,17,4,4,8,-2,0,0,1,-1,-1,1,4,1
KR_6602309052,420,3,0,47,7,1,3,2,1,5,4,1,5,4,4,5,1,0,1,1,0,13,56,0,4,4,-17,0,1,0,1,1,1,0,1
KR_6767064705,420,2,-13,28,6,-2,1,3,-3,2,5,8,9,1,3,4,1,0,0,0,0,9,-371,3,4,7,0,0,0,1,1,0,1,6,1
KR_6758195937,420,1,-95,43,4,-1,0,1,2,4,2,2,4,2,1,2,1,0,1,1,0,10,8,2,3,5,-2,0,0,1,1,0,-1,6,1
KR_6751170644,420,2,-39,7,2,2,3,1,4,5,1,-1,2,3,0,0,0,-3,0,3,0,7,5,1,3,4,-7,0,0,-1,1,-1,-1,3,1
KR_6732326408,440,4,7,8,12,3,3,0,10,10,0,1,2,1,-2,1,3,0,0,0,0,9,10,3,4,7,1,0,1,1,1,1,1,2,1
KR_6751852550,420,2,-19,12,8,-1,2,3,3,3,0,0,1,1,5,5,0,1,2,1,-1,9,21,0,5,5,-5,0,0,1,-1,0,-1,6,1
KR_6724350760,420,1,20,19,10,1,1,0,4,7,3,6,8,2,-2,1,3,1,2,1,-1,7,8,3,2,5,-2,0,1,1,0,1,-1,6,1
KR_6755846354,420,3,10,11,4,0,1,1,-1,1,2,2,2,0,4,5,1,-1,0,1,1,6,-7,-1,6,5,2,0,0,-1,0,0,1,6,1
KR_6628078803,440,4,1,-3,9,6,6,0,2,2,0,5,7,2,-4,4,8,0,1,1,0,1,21,1,4,5,-10,0,2,1,1,1,1,6,1
KR_6643725376,420,1,11,4,7,0,3,3,1,2,1,3,4,1,5,7,2,-2,1,3,-1,10,-113,-3,8,5,4,0,0,1,-1,0,-1,2,1
KR_6724692811,420,-3,-25,-11,-9,1,4,3,-2,2,4,-4,0,4,-3,3,6,-1,1,2,0,-14,0,-2,5,3,-2,0,1,1,1,1,-1,1,1
KR_6692695519,420,-2,-12,-4,-4,-4,1,5,1,1,0,6,7,1,-7,0,7,0,2,2,-1,0,-2,-6,10,4,1,0,0,-1,-1,-1,-1,5,1
KR_6675624409,440,3,-10,28,2,1,1,0,-2,1,3,-2,0,2,2,5,3,3,5,2,0,0,0,-2,6,4,3,0,0,1,1,0,-1,1,1
KR_6609667104,420,2,3,4,2,1,3,2,7,8,1,-5,2,7,0,2,2,-1,0,1,0,2,142,3,2,5,4,0,0,0,1,0,-1,0,1
KR_6667130075,420,3,10,-7,-3,0,2,2,-3,1,4,-1,1,2,3,4,1,-2,2,4,0,5,6,5,5,10,3,0,-1,-1,1,-1,1,6,1
KR_6767405604,420,4,7,9,5,-4,0,4,0,2,2,9,10,1,-3,4,7,3,4,1,1,10,0,1,4,5,0,0,1,1,1,1,1,3,1
KR_6745620686,420,7,14,16,6,2,2,0,3,4,1,0,2,2,4,5,1,-3,0,3,1,4,-138,1,6,7,-4,0,0,-1,1,0,1,6,1
KR_6675380221,420,-2,11,-19,3,1,2,1,0,2,2,-5,0,5,5,6,1,2,2,0,0,7,-43,-4,8,4,14,0,-2,1,-1,-1,1,3,1
KR_6743895925,420,1,-18,16,-1,0,1,1,0,2,2,3,3,0,-3,2,5,-1,0,1,0,-2,20,-4,9,5,2,0,0,-1,-1,0,-1,3,1
KR_6722028555,420,3,54,15,9,0,2,2,-2,1,3,5,7,2,7,11,4,-1,0,1,1,7,-3,1,6,7,2,0,1,1,-1,-1,-1,6,1
KR_6670205993,420,1,40,14,7,4,4,0,0,4,4,-1,0,1,2,4,2,2,4,2,0,3,-15,5,5,10,-2,0,0,-1,-1,0,1,3,1
KR_6318026181,420,5,131,44,10,-2,2,4,4,5,1,4,5,1,2,4,2,2,2,0,0,12,6,3,1,4,1,0,2,1,1,1,-1,2,1
KR_6642634897,440,-2,-26,0,-5,-2,2,4,2,5,3,-1,2,3,2,3,1,-6,0,6,0,-5,-212,-2,4,2,1,0,-3,-1,-1,-1,-1,3,1
KR_6723501441,420,8,62,44,13,3,4,1,1,1,0,4,6,2,0,2,2,5,5,0,0,11,6,4,2,6,0,0,2,1,1,1,-1,6,1
KR_6696546118,420,2,10,-28,5,1,2,1,-3,4,7,1,3,2,8,10,2,-2,0,2,-1,0,0,3,5,8,-3,0,1,-1,1,1,-1,3,1
KR_6767469909,440,-1,-36,-5,0,2,3,1,-1,1,2,-1,0,1,-2,0,2,2,4,2,0,-7,28,-2,8,6,0,0,1,1,1,1,-1,4,1
KR_6690126724,420,3,-36,13,10,2,2,0,1,2,1,6,7,1,1,3,2,0,1,1,0,14,49,-3,6,3,-20,0,-1,1,-1,-1,1,4,1
KR_6767835585,440,0,17,15,5,1,4,3,-2,0,2,4,4,0,2,3,1,0,0,0,0,6,6,1,0,1,2,0,1,1,1,1,1,5,1
KR_6765346472,420,1,6,-28,6,0,0,0,0,1,1,3,3,0,2,2,0,1,2,1,0,5,-30,4,2,6,0,0,1,1,1,1,1,2,1
KR_6650371920,420,2,7,32,11,2,3,1,1,2,1,1,1,0,5,8,3,2,2,0,0,10,-1,0,6,6,1,0,1,1,0,1,1,6,1
KR_6767288480,420,4,76,6,10,2,2,0,6,6,0,-1,1,2,3,5,2,0,1,1,0,6,22,-3,6,3,0,0,0,1,0,0,-1,1,1
KR_6768071885,420,0,7,-5,0,3,3,0,0,3,3,2,3,1,-3,1,4,-2,0,2,1,-4,8,7,2,9,-7,0,-2,-1,1,-1,1,6,1
KR_6672882772,420,0,-46,-5,8,-6,0,6,3,5,2,2,2,0,8,9,1,1,1,0,0,14,-64,4,4,8,-2,0,0,-1,1,-1,-1,1,1
KR_6711818654,420,0,36,-12,-3,0,1,1,-2,1,3,1,4,3,-4,3,7,2,3,1,0,-5,4,2,2,4,-5,0,0,-1,1,1,-1,4,1
KR_6298519267,420,-3,-9,-16,-6,-7,0,7,1,4,3,-1,1,2,-1,1,2,2,2,0,-1,-5,2,-3,7,4,2,0,-1,0,0,-1,-1,0,1
KR_6762246733,420,0,-15,-16,6,0,4,4,2,2,0,1,2,1,6,6,0,-3,3,6,0,15,-13,2,0,2,2,0,1,1,-1,1,1,4,1
KR_6746233731,420,-1,11,-20,-4,2,4,2,-5,0,5,2,3,1,-3,3,6,0,0,0,0,-12,-21,0,5,5,-3,0,0,-1,0,0,-1,2,1
KR_6759085485,440,2,-13,-8,1,0,1,1,-2,0,2,1,6,5,0,5,5,2,2,0,0,-1,3,1,2,3,0,0,0,-1,0,0,-1,5,1
KR_6763168028,420,-3,37,-4,-11,-3,0,3,-2,1,3,-4,0,4,-4,2,6,2,4,2,0,-11,3,0,2,2,0,0,0,-1,1,1,1,1,1
KR_6706971521,420,1,-47,-12,4,-4,0,4,3,6,3,0,4,4,6,6,0,-1,2,3,0,-2,12,5,3,8,-2,0,-1,1,1,1,1,2,1
KR_6585319782,420,0,-3,-4,4,2,2,0,-2,0,2,5,5,0,-1,5,6,0,2,2,0,3,9,-1,3,2,-3,0,0,-1,1,1,-1,1,1
KR_6734433932,420,0,32,66,-2,4,5,1,0,2,2,-3,1,4,-1,2,3,-2,1,3,0,-6,-6,-5,9,4,35,0,-1,-1,0,-1,1,2,1
KR_6738502357,420,1,11,27,2,0,3,3,3,4,1,-2,3,5,-1,3,4,2,2,0,-1,-5,95,-6,9,3,-4,0,2,1,0,1,-1,2,1
KR_6738641801,420,3,33,-6,3,1,2,1,5,7,2,0,1,1,-2,3,5,-1,2,3,0,6,-168,-6,7,1,1,0,0,-1,-1,0,-1,1,1
KR_6694883857,420,-1,-32,16,1,0,2,2,1,2,1,0,0,0,3,5,2,-3,1,4,0,-4,-2,-2,5,3,0,0,0,1,1,1,-1,5,1
KR_6742595977,420,0,58,16,3,0,1,1,1,2,1,0,3,3,2,2,0,0,0,0,0,4,31,0,4,4,0,0,0,-1,-1,0,1,1,1
KR_6698519638,420,-4,-9,8,-13,-3,0,3,2,3,1,-7,3,10,0,3,3,-5,1,6,2,-7,-12,-7,9,2,4,0,-1,-1,-1,-1,1,6,1
KR_6736932548,420,4,67,0,13,-4,2,6,5,5,0,4,5,1,5,8,3,3,4,1,0,20,239,2,2,4,-2,0,1,-1,-1,1,-1,1,1
KR_6633484882,420,5,47,4,10,2,3,1,2,2,0,0,0,0,3,4,1,3,3,0,0,13,-18,-2,6,4,1,0,1,-1,1,1,1,1,1
KR_6767413314,440,1,-11,12,-3,0,2,2,-2,2,4,0,0,0,-1,3,4,0,0,0,0,-4,82,-3,6,3,-1,0,0,0,0,0,-1,0,1
KR_6675583751,420,3,-13,-15,6,2,2,0,-1,1,2,1,1,0,7,7,0,-3,0,3,0,4,1,1,2,3,1,0,1,1,0,1,-1,2,1
KR_6764066614,420,-1,-57,-28,1,1,3,2,-1,4,5,2,4,2,0,1,1,-1,1,2,0,0,182,1,1,2,1,0,0,1,-1,-1,1,3,1
KR_6766167774,420,3,95,23,7,2,2,0,1,2,1,-2,0,2,3,3,0,3,3,0,0,6,-21,0,4,4,1,0,0,-1,1,0,1,5,1
KR_6763285938,420,1,29,-12,0,-4,1,5,4,5,1,3,3,0,0,2,2,-3,1,4,0,1,43,4,2,6,-12,0,0,1,-1,0,-1,4,1
KR_6734525692,420,7,83,-2,10,2,3,1,5,6,1,0,0,0,3,5,2,0,2,2,0,6,23,-3,8,5,-1,0,3,-1,1,1,1,2,1
KR_6740182188,420,1,24,-3,5,4,5,1,0,1,1,-4,0,4,2,5,3,3,3,0,0,7,38,-3,8,5,2,0,1,-1,-1,1,-1,5,1
KR_6753695156,440,2,17,8,5,2,3,1,0,2,2,0,2,2,2,6,4,1,2,1,0,9,-2,-4,6,2,4,0,0,1,-1,1,1,4,1
KR_6749427438,420,0,1,8,5,-1,1,2,-1,2,3,4,4,0,3,4,1,0,0,0,1,6,3,2,3,5,-1,0,1,-1,1,1,1,6,1
KR_6766651264,420,1,-27,-8,5,3,5,2,3,4,1,-1,4,5,1,5,4,-1,2,3,0,12,-288,5,2,7,2,0,0,-1,1,-1,-1,6,1
KR_6763847161,440,7,119,8,15,5,5,0,-2,1,3,-2,3,5,12,13,1,2,3,1,0,14,-4,3,4,7,0,0,2,1,0,1,1,5,1
KR_6738299299,420,-1,20,8,4,1,2,1,-1,3,4,0,4,4,5,6,1,-1,2,3,0,4,1,4,3,7,-3,0,0,-1,1,1,-1,1,1
KR_6718340399,440,1,-48,-8,4,-2,0,2,4,5,1,-4,2,6,3,3,0,3,3,0,-1,6,-252,2,3,5,5,0,0,-1,1,0,-1,4,1
KR_6763662346,420,3,95,-1,12,1,2,1,3,5,2,1,6,5,8,11,3,-1,0,1,0,10,0,4,1,5,0,0,2,1,1,1,1,5,1
KR_6737733252,420,3,61,-6,16,1,2,1,6,9,3,8,8,0,1,2,1,0,1,1,0,11,17,7,3,10,-2,0,1,-1,1,1,1,2,1
KR_6767211308,420,2,155,-10,7,2,2,0,0,2,2,-2,0,2,7,7,0,0,2,2,1,13,-161,0,4,4,2,0,1,0,1,1,1,0,1
KR_6524605549,420,-2,-73,22,-5,1,2,1,0,0,0,-6,1,7,-3,4,7,3,3,0,0,4,8,-1,6,5,-3,0,-2,1,1,-1,-1,2,1
KR_6709419258,440,3,51,6,12,0,6,6,2,2,0,6,8,2,3,3,0,1,1,0,-1,0,2,4,2,6,2,0,3,1,1,1,-1,2,1
KR_6763348322,440,0,33,-19,-3,0,3,3,-1,1,2,-2,1,3,0,0,0,0,1,1,0,-2,-2,-3,7,4,0,0,-2,-1,-1,-1,1,4,1
KR_6765319482,420,1,-7,25,1,3,3,0,0,6,6,-3,0,3,0,3,3,1,2,1,0,5,-1,1,1,2,5,0,0,1,1,0,-1,4,1
KR_6712761860,420,1,26,-1,10,4,4,0,5,9,4,-1,0,1,-1,1,2,3,4,1,0,5,273,2,5,7,-1,0,1,-1,1,1,1,2,1
KR_6723453182,420,-1,40,-32,-7,-1,2,3,-4,1,5,0,2,2,0,3,3,-2,0,2,-1,-11,-3,1,2,3,-1,0,0,-1,-1,0,-1,5,1
KR_6766795401,420,-3,23,10,-2,-3,2,5,-1,2,3,-1,2,3,2,8,6,1,2,1,0,7,6,5,3,8,-2,0,1,1,1,1,1,3,1
KR_6766947308,420,2,21,4,7,-3,0,3,4,5,1,2,3,1,2,5,3,2,2,0,1,14,12,7,1,8,2,0,0,1,-1,1,1,5,1
KR_6764504085,420,1,-25,28,3,-1,1,2,1,3,2,4,5,1,-1,1,2,0,0,0,0,2,-4,1,5,6,-6,0,0,1,0,0,1,2,1
KR_6484232331,420,0,8,4,-4,-2,0,2,-5,2,7,-3,0,3,4,4,0,2,2,0,0,5,15,2,4,6,-4,0,0,1,-1,-1,-1,5,1
KR_6750817183,420,1,-9,12,-1,-2,1,3,0,3,3,-2,0,2,1,3,2,2,2,0,1,2,4,2,4,6,1,0,0,0,0,0,1,0,1
KR_6758066461,420,1,17,-5,5,2,2,0,6,6,0,-3,1,4,1,3,2,-1,0,1,0,8,-5,1,5,6,-4,0,1,1,1,1,1,2,1
KR_6714078705,420,2,115,-9,7,4,4,0,0,2,2,3,3,0,-1,2,3,1,1,0,0,0,0,5,4,9,-1,0,1,-1,1,1,1,2,1
KR_6768270894,420,2,26,28,4,0,4,4,-2,0,2,0,1,1,5,5,0,1,2,1,0,5,-10,1,3,4,0,0,0,1,0,0,-1,1,1
KR_6722165678,420,-2,-128,9,6,-3,0,3,2,3,1,5,7,2,0,2,2,2,2,0,0,11,15,4,2,6,-8,0,-1,1,1,-1,1,6,1
KR_6763399336,420,3,54,4,-3,0,1,1,-2,0,2,0,3,3,2,2,0,-3,1,4,0,-7,15,-3,5,2,-6,0,1,0,1,1,-1,0,1
KR_6694976430,420,3,57,24,9,2,5,3,2,2,0,2,4,2,1,2,1,2,3,1,0,5,-21,0,2,2,-1,0,1,1,1,1,1,1,1
KR_6698347413,420,7,160,7,14,5,5,0,-1,4,5,-1,1,2,9,10,1,2,3,1,-1,10,31,4,2,6,1,0,6,1,1,1,-1,4,1
KR_6767416547,420,3,60,-12,11,1,1,0,3,3,0,1,3,2,6,6,0,0,1,1,0,12,6,5,2,7,1,0,1,1,1,1,1,5,1
KR_6647433327,420,1,-40,-3,1,-1,0,1,-2,1,3,0,3,3,3,3,0,1,1,0,0,6,34,-1,4,3,-16,0,0,-1,-1,0,1,1,1
KR_6748615925,420,2,28,8,10,0,1,1,3,8,5,3,4,1,1,2,1,3,3,0,-1,20,-18,-2,3,1,-3,0,0,1,1,-1,-1,2,1
KR_6732372761,440,-4,-116,-12,-8,-2,0,2,4,9,5,-5,0,5,0,1,1,-5,2,7,0,-7,9,2,1,3,-3,0,0,0,1,0,1,0,1
KR_6751069808,440,3,81,-8,5,11,13,2,0,1,1,2,3,1,-8,5,13,0,1,1,0,4,-3,2,1,3,1,0,3,1,1,1,-1,2,1
KR_6689258519,420,1,11,39,8,-2,2,4,7,10,3,-3,1,4,1,3,2,5,6,1,-2,16,5,-2,6,4,4,0,1,1,1,1,-1,1,1
KR_6767254883,420,6,85,34,9,2,2,0,3,6,3,1,1,0,2,4,2,1,1,0,0,5,47,2,4,6,-24,0,2,1,1,1,1,4,1
KR_6740947516,420,0,-4,-11,-5,3,3,0,-3,0,3,2,4,2,-8,4,12,1,2,1,0,-9,5,2,3,5,1,0,0,-1,-1,1,1,6,1
KR_6751203040,420,7,64,20,17,4,4,0,3,3,0,3,3,0,7,7,0,0,1,1,0,20,-8,5,0,5,4,0,1,0,1,1,1,0,1
KR_6740158135,420,1,36,-12,5,3,4,1,2,2,0,1,1,0,-2,0,2,1,1,0,0,1,-8,-6,9,3,4,0,0,-1,1,0,1,2,1
KR_6750732423,420,-3,-50,-12,3,0,2,2,0,4,4,2,4,2,1,3,2,0,0,0,0,2,-7,0,4,4,-1,0,-1,1,1,-1,1,5,1
KR_6726794312,420,3,32,8,5,2,5,3,4,7,3,0,3,3,-1,1,2,0,1,1,1,11,-8,-3,5,2,5,0,1,0,1,1,1,0,1
KR_6743137007,420,1,-25,-4,3,0,0,0,-2,4,6,8,9,1,-3,4,7,0,1,1,0,2,-15,-1,8,7,1,0,1,1,1,1,-1,4,1
KR_6733479640,420,3,119,24,2,6,6,0,-6,2,8,0,2,2,0,3,3,2,2,0,0,-2,-16,3,2,5,19,0,1,-1,1,1,1,5,1
KR_6729560534,440,-2,-3,-59,-2,0,2,2,0,4,4,-1,2,3,0,3,3,-1,1,2,2,3,111,3,4,7,0,0,-2,1,-1,-1,-1,6,1
KR_6767006198,420,0,-19,-13,7,-1,1,2,3,4,1,-1,2,3,4,4,0,2,2,0,1,11,143,-2,6,4,-1,0,0,1,-1,1,1,1,1
KR_6766689141,420,1,14,28,4,-3,0,3,-1,3,4,-2,1,3,3,6,3,7,7,0,0,10,-4,-2,3,1,2,0,0,1,0,1,1,4,1
KR_6736955780,420,0,30,-27,0,0,4,4,1,6,5,6,6,0,-5,0,5,-2,2,4,0,-1,-4,4,4,8,0,0,1,1,1,1,-1,6,1
KR_6644083570,420,-1,48,0,0,-1,3,4,4,5,1,0,2,2,-1,3,4,-2,1,3,0,0,-2,-1,9,8,-5,0,-2,-1,1,-1,-1,1,1
KR_6762713599,420,0,45,4,-3,-1,2,3,-1,1,2,-1,3,4,0,3,3,0,1,1,1,-1,7,7,2,9,-6,0,1,-1,1,1,1,3,1
KR_6725827041,440,-3,-61,-15,-8,-3,1,4,-5,0,5,-2,2,4,0,5,5,2,3,1,0,-2,5,0,2,2,1,0,-1,1,1,-1,-1,1,1
KR_6762312656,420,2,78,1,2,4,4,0,-1,2,3,5,6,1,-3,0,3,-3,0,3,-2,-2,8,5,3,8,-9,0,0,-1,-1,1,-1,2,1
KR_6768358710,420,1,14,4,3,4,6,2,7,7,0,-3,0,3,-5,2,7,0,2,2,1,3,-26,1,3,4,4,0,0,-1,1,1,1,2,1
KR_6767367949,420,-1,-17,-36,5,-1,1,2,1,4,3,5,5,0,-2,1,3,2,2,0,0,3,8,2,6,8,-2,0,1,-1,1,1,-1,1,1
KR_6769219061,420,1,58,-2,-1,1,1,0,-1,2,3,-4,1,5,4,7,3,-1,0,1,0,0,-23,-2,5,3,3,0,2,-1,1,1,-1,3,1
KR_6715088796,420,2,51,-32,6,4,4,0,3,5,2,0,2,2,-1,3,4,0,0,0,0,4,-3,1,3,4,3,0,1,1,-1,1,1,3,1
KR_6762369881,420,3,47,-24,9,1,3,2,4,6,2,1,3,2,3,3,0,0,2,2,0,13,-2,1,2,3,3,0,2,-1,1,1,1,1,1
KR_6760415657,420,3,53,18,9,-2,0,2,6,7,1,2,3,1,1,3,2,2,3,1,0,11,-21,0,4,4,2,0,1,1,0,1,1,6,1
KR_6740489781,420,-1,-26,9,-7,1,2,1,-2,1,3,0,2,2,-3,1,4,-3,0,3,0,-10,1,3,2,5,-1,0,0,1,-1,1,1,5,1
KR_6762860133,420,1,78,-4,3,0,1,1,0,2,2,3,6,3,0,5,5,0,0,0,1,-1,3,0,7,7,-5,0,1,1,1,1,1,6,1
KR_6755246967,420,5,42,-4,11,-1,0,1,0,2,2,8,9,1,3,6,3,1,4,3,0,15,14,2,2,4,1,0,1,1,0,1,1,5,1
KR_6716684089,440,4,74,2,5,0,3,3,7,7,0,1,3,2,-2,0,2,-1,2,3,0,5,-60,0,3,3,-8,0,2,-1,-1,1,1,3,1
KR_6763112335,420,2,25,31,1,2,2,0,-4,3,7,-1,1,2,2,4,2,2,2,0,0,8,-321,6,2,8,1,0,0,1,-1,1,1,1,1
KR_6740657116,420,2,31,44,1,2,2,0,3,5,2,0,2,2,-4,2,6,0,0,0,0,5,-1,0,5,5,3,0,0,-1,1,-1,-1,6,1
KR_6736208738,420,1,-16,4,4,0,2,2,0,1,1,-1,3,4,3,3,0,2,2,0,0,3,4,-1,3,2,3,0,0,0,-1,1,-1,0,1
KR_6762979728,420,0,16,20,5,0,1,1,4,4,0,-2,6,8,4,7,3,-1,3,4,1,-2,-3,0,4,4,-1,0,0,-1,1,0,1,6,1
KR_6584143292,420,7,74,29,16,4,5,1,10,11,1,-2,2,4,3,3,0,1,7,6,0,17,14,0,5,5,-5,0,2,1,1,1,1,5,1
KR_6732348193,420,5,23,28,8,1,2,1,8,9,1,-4,0,4,3,4,1,0,0,0,-1,9,2,4,4,8,1,0,2,1,1,1,-1,5,1
KR_6758230677,420,-1,17,-20,-5,1,3,2,2,4,2,-1,0,1,-5,1,6,-2,1,3,-1,-7,-128,-1,6,5,3,0,-1,-1,1,1,-1,1,1
KR_6744286473,420,3,40,-1,12,2,3,1,4,6,2,-1,0,1,3,4,1,4,4,0,0,9,-40,4,4,8,1,0,0,1,-1,1,1,1,1
KR_6764810236,420,0,17,-8,1,-1,1,2,0,2,2,2,2,0,-1,3,4,1,4,3,0,1,244,-1,5,4,-3,0,0,1,0,1,1,1,1
KR_6720490796,420,1,19,27,7,8,9,1,1,3,2,0,1,1,-2,2,4,0,1,1,0,0,-324,-4,7,3,1,0,1,-1,1,1,1,1,1
KR_6750428240,420,3,154,12,7,2,2,0,0,2,2,3,4,1,2,2,0,0,0,0,0,7,7,-2,5,3,0,0,1,-1,-1,1,1,3,1
KR_6655859538,420,5,162,9,15,4,5,1,6,7,1,3,3,0,1,1,0,1,3,2,0,6,-5,1,2,3,4,0,2,1,1,1,1,2,1
KR_6762101635,420,-4,14,0,-2,0,1,1,-2,3,5,-4,1,5,2,6,4,2,3,1,0,-9,-7,0,4,4,3,0,1,1,-1,1,1,1,1
KR_6634415322,420,3,-33,7,9,3,3,0,8,9,1,-3,1,4,1,4,3,0,0,0,0,10,19,0,4,4,1,0,1,1,-1,1,-1,6,1
KR_6728665241,420,4,75,14,5,1,2,1,3,5,2,3,3,0,-1,2,3,-1,0,1,0,1,-16,-1,4,3,4,0,1,0,0,1,-1,0,1
KR_6650741858,420,-2,0,-10,-2,6,6,0,-2,0,2,-1,1,2,-2,3,5,-3,0,3,0,-9,5,3,5,8,-3,0,0,0,-1,-1,1,0,1
KR_6729875644,420,-1,-62,4,5,-2,1,3,4,4,0,-1,2,3,3,4,1,1,2,1,0,10,-45,0,4,4,22,0,0,1,1,1,1,3,1
KR_6766061971,420,2,-53,8,8,4,5,1,2,4,2,4,5,1,-3,1,4,1,1,0,0,1,-4,5,3,8,1,0,0,0,1,1,1,0,1
KR_6747018459,420,5,87,-20,2,-2,0,2,-1,2,3,-1,0,1,4,4,0,2,2,0,0,5,-16,1,1,2,2,0,-1,1,-1,-1,-1,4,1
KR_6726541368,420,1,25,-11,4,1,3,2,1,7,6,0,2,2,3,5,2,-1,1,2,0,6,-442,2,3,5,0,0,0,-1,-1,1,1,2,1
KR_6739212426,420,2,56,10,4,-2,1,3,1,4,3,2,4,2,2,2,0,1,2,1,1,9,-23,2,4,6,0,0,2,1,1,1,1,1,1
KR_6731709551,440,2,51,4,5,0,1,1,-1,4,5,5,5,0,2,5,3,-1,0,1,0,9,-16,-2,5,3,7,0,0,0,0,0,1,0,1
KR_6757940960,420,1,6,-4,0,2,3,1,-2,0,2,3,3,0,-3,0,3,0,0,0,0,-7,-6,-2,6,4,-3,0,1,-1,1,1,1,2,1
KR_6698186927,420,1,-11,-13,4,1,5,4,1,3,2,-1,1,2,5,8,3,-2,1,3,0,10,-1,5,2,7,2,0,1,1,-1,1,1,3,1
KR_6730882993,420,5,78,-1,12,-3,1,4,5,6,1,6,7,1,4,4,0,0,0,0,0,18,-33,3,3,6,17,0,1,1,1,1,1,6,1
KR_6765395934,440,-1,19,-14,-2,2,3,1,-2,5,7,0,1,1,-1,3,4,-1,3,4,0,5,-6,1,3,4,1,0,-1,0,1,-1,-1,0,1
KR_6735302698,420,-2,-33,7,-2,0,1,1,2,5,3,-1,2,3,-3,0,3,0,2,2,0,-4,0,-3,7,4,-2,0,0,-1,1,0,1,2,1
KR_6758169253,420,1,42,12,-5,2,4,2,-1,3,4,-6,0,6,0,2,2,0,0,0,1,-9,7,5,2,7,-7,0,0,-1,-1,0,1,4,1
KR_6720243053,420,1,69,-23,1,5,6,1,-4,0,4,-1,2,3,-1,2,3,2,3,1,-1,-9,-1,2,2,4,4,0,1,-1,1,1,-1,4,1
KR_6758941531,420,0,31,4,6,-2,2,4,2,3,1,-3,1,4,5,8,3,4,5,1,-1,9,143,-1,3,2,-1,0,0,1,-1,1,-1,5,1
KR_6763251246,420,2,-18,15,12,5,6,1,4,5,1,2,4,2,1,2,1,0,0,0,0,8,9,4,3,7,-2,0,1,1,-1,1,1,2,1
KR_6731210780,420,3,116,-4,11,2,2,0,-1,3,4,4,5,1,1,5,4,5,6,1,0,6,10,3,4,7,2,0,1,0,1,1,1,0,1
KR_6754542008,440,0,14,17,1,1,3,2,0,4,4,-1,0,1,3,6,3,-2,2,4,0,5,0,1,5,6,2,0,-1,1,1,-1,1,2,1
KR_6758198850,420,4,115,8,12,3,3,0,4,6,2,3,5,2,2,4,2,0,4,4,0,5,8,2,2,4,1,0,3,1,1,1,1,4,1
KR_6753693929,420,4,87,17,10,4,5,1,-1,2,3,0,1,1,7,8,1,0,0,0,0,6,122,1,4,5,1,0,1,1,1,1,1,6,1
KR_6726233639,420,0,-75,9,4,-2,1,3,-5,0,5,2,4,2,9,10,1,0,1,1,1,7,-28,3,6,9,0,0,0,1,-1,-1,1,6,1
KR_6500918298,420,9,103,20,13,5,5,0,5,6,1,2,5,3,1,1,0,0,0,0,0,4,-210,2,3,5,1,0,2,1,-1,1,1,4,1
KR_6740447512,420,0,-21,20,-2,-5,0,5,1,2,1,-2,1,3,3,7,4,1,3,2,-2,3,10,0,5,5,-4,0,1,1,-1,1,-1,4,1
KR_6762113134,420,6,68,26,11,0,1,1,6,6,0,3,5,2,1,3,2,1,2,1,0,12,23,7,1,8,-3,0,1,-1,1,1,1,4,1
KR_6595151247,440,5,63,-12,18,4,4,0,2,4,2,2,3,1,6,6,0,4,4,0,0,14,3,-2,6,4,0,0,2,1,1,1,1,4,1
KR_6724532574,420,1,-27,0,2,0,1,1,0,2,2,-2,1,3,3,3,0,1,1,0,0,5,-370,5,4,9,7,0,0,1,0,0,-1,3,1
KR_6681032318,420,3,-2,-12,1,-5,0,5,1,2,1,-1,0,1,4,4,0,2,2,0,0,5,-19,-2,7,5,1,0,-1,1,-1,-1,-1,2,1
KR_6764586143,420,3,-7,29,8,2,2,0,3,4,1,0,1,1,4,5,1,-1,1,2,0,11,-1,-3,5,2,-2,0,0,1,0,0,1,4,1
KR_6765555411,420,-2,-19,-24,0,2,5,3,-2,2,4,2,2,0,0,3,3,-2,1,3,0,0,8,0,7,7,-2,0,1,-1,-1,1,-1,3,1
KR_6761069676,420,3,76,8,9,1,1,0,-2,0,2,10,11,1,-2,1,3,2,3,1,0,2,0,-1,4,3,-3,0,2,-1,1,1,1,1,1
KR_6761282128,420,5,39,32,15,1,2,1,8,10,2,4,5,1,3,5,2,-1,0,1,1,9,1,6,3,9,1,0,1,1,-1,1,1,4,1
KR_6737655445,420,-2,-11,36,-4,-3,0,3,0,4,4,-4,0,4,4,4,0,-1,0,1,0,2,-8,0,6,6,5,0,0,1,0,0,-1,3,1
KR_6667614962,420,3,34,20,13,-2,2,4,8,11,3,1,2,1,5,6,1,1,2,1,0,16,1,1,3,4,0,0,1,-1,1,1,1,1,1
KR_6636292295,420,-4,-56,0,-3,-2,1,3,-1,2,3,1,1,0,-1,0,1,0,0,0,0,-1,9,1,3,4,1,0,0,-1,1,0,1,4,1
KR_6746448137,420,1,28,31,4,1,1,0,4,7,3,1,3,2,-1,0,1,-1,0,1,0,4,-14,0,4,4,4,0,1,-1,1,1,1,1,1
KR_6754677536,420,4,67,-16,17,3,4,1,10,11,1,2,3,1,0,2,2,2,2,0,0,8,-5,1,2,3,0,0,2,1,1,1,1,5,1
KR_6755862240,420,-1,22,21,-6,-2,1,3,1,1,0,-4,0,4,-1,1,2,0,0,0,0,-9,-4,-3,8,5,-5,0,3,1,1,1,-1,5,1
KR_6738168765,420,2,33,-25,6,-1,3,4,1,4,3,2,4,2,3,4,1,1,3,2,2,12,-2,-5,8,3,4,0,0,1,-1,1,1,5,1
KR_6715055862,420,-3,-36,-2,-12,-3,3,6,-5,1,6,-2,2,4,-4,2,6,2,2,0,0,-5,-25,-3,4,1,4,0,0,-1,1,-1,1,3,1
KR_6758095637,420,3,20,21,6,2,4,2,0,1,1,5,6,1,0,2,2,-1,2,3,0,1,-183,-6,7,1,5,0,0,-1,1,0,1,1,1
KR_6546150674,420,2,-12,24,7,-3,1,4,-2,0,2,7,8,1,4,4,0,1,1,0,0,10,27,2,4,6,2,0,1,1,-1,1,1,5,1
KR_6753954315,420,3,-31,46,-1,3,4,1,2,3,1,-3,4,7,-3,1,4,0,1,1,0,-2,40,3,3,6,-21,0,0,-1,1,1,-1,4,1
KR_6733071244,420,5,48,25,8,6,9,3,0,1,1,1,2,1,-1,1,2,2,2,0,0,4,-1,-3,3,0,0,0,1,0,1,1,-1,0,1
KR_6740626550,420,1,29,8,5,0,1,1,5,7,2,-1,5,6,-2,2,4,3,3,0,-1,3,-47,-2,7,5,20,0,1,-1,-1,1,-1,1,1
KR_6767357257,420,-1,-33,20,-5,-8,2,10,0,4,4,-3,2,5,5,5,0,1,2,1,0,9,-2,-3,4,1,-3,0,-2,-1,-1,-1,-1,6,1
KR_6602314971,420,6,15,7,15,-1,0,1,7,8,1,5,5,0,3,3,0,1,1,0,0,17,1,-2,6,4,3,0,2,1,1,1,1,3,1
KR_6684847752,420,6,48,23,5,2,3,1,0,2,2,-1,1,2,1,4,3,3,3,0,0,5,2,0,5,5,3,0,3,-1,1,1,-1,6,1
KR_6762396558,420,-2,-53,-4,-1,-2,1,3,4,5,1,1,1,0,-1,1,2,-3,0,3,0,-2,-5,1,6,7,-3,0,-1,1,1,-1,1,2,1
KR_6752198867,420,4,86,33,2,3,3,0,-2,4,6,0,1,1,1,6,5,0,0,0,0,-8,-34,-4,6,2,12,0,2,1,1,1,1,4,1
KR_6732853701,440,1,20,9,-3,-2,0,2,4,5,1,-1,2,3,-4,0,4,0,1,1,0,-4,38,4,4,8,-12,0,0,0,0,0,-1,0,1
KR_6750301515,420,3,87,50,11,4,6,2,3,4,1,2,2,0,-2,1,3,4,5,1,1,3,-11,2,3,5,8,0,3,1,1,1,1,6,1
KR_6745289308,420,3,15,28,4,2,3,1,4,5,1,3,5,2,-5,0,5,0,1,1,0,0,12,-2,3,1,-1,0,1,1,1,1,-1,3,1
KR_6769295261,420,2,94,16,9,7,8,1,2,4,2,-1,1,2,-1,4,5,2,2,0,0,6,1,1,4,5,4,0,1,1,1,1,1,1,1
KR_6673201777,420,0,-45,0,2,-2,0,2,2,4,2,1,3,2,0,5,5,1,1,0,-1,4,-4,-3,5,2,-4,0,-1,1,-1,-1,1,6,1
KR_6738730085,420,1,-5,0,5,2,2,0,0,1,1,5,9,4,-1,3,4,-1,0,1,4,11,7,3,2,5,-5,0,0,1,0,0,-1,6,1
KR_6318191984,420,3,62,13,-3,1,1,0,0,1,1,-1,3,4,-3,0,3,0,0,0,0,-13,108,3,3,6,-2,0,2,-1,-1,1,-1,4,1
KR_6766483432,420,3,59,8,7,5,6,1,0,4,4,-3,1,4,4,4,0,1,3,2,0,5,8,3,4,7,-6,0,-1,-1,-1,-1,1,2,1
KR_6681444603,420,1,-12,13,4,1,1,0,1,1,0,2,5,3,0,3,3,0,2,2,0,-1,3,7,3,10,-6,0,0,1,1,0,-1,6,1
KR_6740407491,440,2,43,28,8,-2,0,2,-4,0,4,3,3,0,3,4,1,8,8,0,0,4,-7,2,2,4,-1,0,2,1,0,1,-1,4,1
KR_6736043769,420,2,56,0,5,1,2,1,-1,2,3,2,3,1,3,5,2,0,1,1,0,14,7,-1,7,6,-2,0,0,-1,1,0,1,2,1
KR_6628172985,440,4,84,22,6,0,3,3,1,3,2,6,7,1,-1,5,6,0,2,2,-1,5,-126,-3,4,1,2,0,1,1,1,1,-1,3,1
KR_6757825888,420,-2,-13,-8,-3,2,3,1,0,0,0,-4,2,6,-1,2,3,0,0,0,0,2,4,-1,6,5,5,0,1,0,-1,1,-1,0,1
KR_6729698551,440,1,86,16,5,0,1,1,2,3,1,0,1,1,3,4,1,0,3,3,0,-1,163,6,2,8,3,0,1,1,1,1,1,6,1
KR_6700226476,420,0,47,11,1,0,2,2,4,6,2,2,4,2,-3,3,6,-2,1,3,0,-3,-3,-1,3,2,-4,0,1,1,-1,1,1,1,1
KR_6685006173,440,1,64,-8,0,5,7,2,0,0,0,1,1,0,-4,0,4,-2,0,2,0,-12,-4,0,6,6,-3,0,0,1,-1,1,1,4,1
KR_6589143960,420,2,-15,24,2,-2,0,2,2,4,2,2,3,1,1,3,2,-1,0,1,0,3,-7,1,9,10,1,0,0,1,-1,0,1,3,1
KR_6749456999,440,5,137,0,5,-2,3,5,1,1,0,5,7,2,1,1,0,0,0,0,0,-5,6,3,0,3,3,0,4,1,1,1,-1,1,1
KR_6763422111,420,0,-58,36,3,-4,3,7,3,4,1,6,9,3,-2,3,5,0,1,1,0,3,16,3,5,8,2,0,1,1,1,1,-1,3,1
KR_6724525087,420,3,13,-6,11,1,3,2,5,5,0,1,3,2,2,4,2,2,3,1,0,12,-3,1,6,7,4,0,1,-1,0,1,1,1,1
KR_6749365268,420,-3,-35,-9,-9,-3,1,4,1,2,1,-3,1,4,-2,2,4,-2,1,3,-1,-10,-33,0,4,4,-3,0,1,-1,1,1,-1,1,1
KR_6692635698,420,3,-15,-10,6,5,6,1,4,5,1,-2,0,2,-1,0,1,0,1,1,0,8,-357,5,2,7,-1,0,0,1,1,0,-1,3,1
KR_6549761161,420,1,21,13,4,0,1,1,-1,1,2,2,5,3,2,3,1,1,1,0,1,8,18,1,6,7,1,0,1,-1,1,1,1,1,1
KR_6748014012,420,6,12,24,12,1,3,2,6,8,2,6,6,0,-4,0,4,3,5,2,0,8,38,1,2,3,-4,0,0,0,0,-1,-1,0,1
KR_6722945357,420,0,23,0,5,-3,5,8,1,2,1,1,4,3,4,4,0,2,2,0,1,-1,396,4,2,6,-6,0,0,1,1,0,1,1,1
KR_6722591407,420,1,-20,-4,4,-6,0,6,3,6,3,3,6,3,1,4,3,3,4,1,0,18,121,3,2,5,3,0,1,1,-1,1,-1,4,1
KR_6709676019,420,-2,-12,-25,1,2,3,1,3,4,1,-5,1,6,0,4,4,1,2,1,0,4,168,0,5,5,-20,0,1,-1,1,1,-1,5,1
KR_6761466084,420,3,-47,-26,9,-1,1,2,2,4,2,1,1,0,5,6,1,2,2,0,0,7,-5,2,4,6,4,0,0,1,1,0,1,5,1
KR_6751252538,420,3,39,0,4,-3,0,3,-1,2,3,4,4,0,5,5,0,-1,0,1,0,1,7,0,5,5,2,0,1,1,1,1,-1,5,1
KR_6732613391,420,0,51,16,-4,-2,1,3,2,4,2,0,1,1,-2,1,3,-2,0,2,0,-5,-52,-6,10,4,-3,0,-1,-1,1,-1,-1,6,1
KR_6751307298,440,-1,23,-8,0,1,4,3,2,3,1,-1,0,1,-2,2,4,0,1,1,0,4,4,-3,3,0,-3,0,0,-1,1,0,1,4,1
KR_6756566186,420,5,32,16,9,1,2,1,1,1,0,3,3,0,4,5,1,0,1,1,0,9,-2,-1,4,3,1,0,1,-1,0,1,1,3,1
KR_6633659166,420,2,27,15,3,-3,2,5,2,4,2,2,5,3,-4,2,6,6,7,1,0,-4,-3,-2,4,2,-2,0,0,1,1,1,-1,1,1
KR_6767240920,420,-1,-4,-3,4,-2,0,2,4,6,2,-2,2,4,4,4,0,0,0,0,0,4,6,1,3,4,1,0,0,-1,1,-1,1,3,1
KR_6764097447,420,-1,-27,19,3,5,6,1,2,5,3,1,1,0,-3,1,4,-2,2,4,0,-4,-4,-1,6,5,0,0,1,1,-1,-1,1,1,1
KR_6761329281,420,1,-13,-19,1,1,3,2,4,5,1,2,3,1,-2,1,3,-4,0,4,0,1,-12,2,5,7,-4,0,0,1,-1,0,-1,5,1
KR_6724089226,440,5,11,17,10,0,3,3,6,9,3,-1,2,3,6,7,1,-1,1,2,0,7,11,4,1,5,0,0,1,1,1,1,1,5,1
KR_6585302855,420,-1,30,12,-2,0,4,4,-2,2,4,1,6,5,-5,1,6,4,5,1,0,-6,0,-1,5,4,-1,0,2,1,-1,1,1,4,1
KR_6763685434,440,3,-18,-8,2,-4,0,4,-2,1,3,-1,1,2,7,9,2,2,3,1,0,1,-220,-3,4,1,1,0,0,0,-1,-1,1,0,1
KR_6768237126,420,4,87,-12,8,0,0,0,0,0,0,4,4,0,3,4,1,1,1,0,0,9,-119,2,2,4,2,0,0,-1,1,1,1,3,1
KR_6752301798,420,3,-5,27,9,3,5,2,-1,1,2,0,3,3,6,6,0,1,2,1,0,5,3,-3,5,2,1,0,-1,-1,-1,-1,-1,2,1
KR_6760351954,420,-1,-6,-18,6,1,2,1,1,4,3,-1,1,2,2,4,2,3,3,0,0,9,9,1,4,5,-1,0,1,-1,1,1,1,6,1
KR_6749067845,440,-1,43,0,1,1,2,1,1,7,6,1,1,0,1,5,4,-3,1,4,0,-7,-3,6,5,11,-3,0,1,1,-1,1,1,3,1
KR_6605984582,440,1,67,-12,-1,0,3,3,-5,0,5,0,3,3,3,5,2,1,2,1,0,-11,10,1,5,6,-2,0,2,1,1,1,1,1,1
KR_6768510733,420,-1,12,0,-3,1,3,2,-2,0,2,-2,2,4,-2,1,3,2,2,0,0,-10,5,2,5,7,2,0,0,1,-1,0,-1,2,1
KR_6724635926,420,4,64,0,15,-1,0,1,4,5,1,8,8,0,5,6,1,-1,4,5,0,6,1,2,2,4,2,0,2,1,1,1,1,6,1
KR_6762287639,420,3,23,17,4,4,4,0,-4,1,5,2,4,2,-5,3,8,7,7,0,2,13,10,0,5,5,0,0,1,1,0,1,1,1,1
KR_6614011501,420,3,9,-8,2,-2,3,5,1,1,0,5,6,1,-1,1,2,-1,0,1,-1,7,22,1,5,6,-1,0,-1,-1,0,-1,-1,4,1
KR_6761991057,420,0,22,13,0,0,0,0,2,4,2,-1,1,2,-1,1,2,0,1,1,0,0,0,-1,7,6,5,0,0,0,1,0,1,0,1
KR_6694991751,420,3,43,15,8,3,3,0,0,1,1,-1,1,2,5,6,1,1,2,1,0,6,17,1,3,4,-6,0,1,-1,1,1,1,6,1
KR_6714127542,420,4,40,-16,9,3,3,0,5,6,1,-3,2,5,3,3,0,1,1,0,0,4,7,4,3,7,-5,0,1,-1,1,1,1,2,1
KR_6694067023,420,5,76,-3,13,0,2,2,2,2,0,3,4,1,7,7,0,1,1,0,1,17,-4,5,1,6,2,0,2,0,1,1,1,0,1
KR_6763553588,440,2,48,-28,5,-4,0,4,1,2,1,4,5,1,1,4,3,3,5,2,0,13,-2,-1,6,5,5,0,-1,1,-1,-1,1,5,1
KR_6620203962,420,6,15,19,11,7,8,1,6,7,1,0,3,3,-1,3,4,-1,1,2,0,11,8,-2,7,5,1,0,0,1,-1,0,1,4,1
KR_6707563613,420,3,7,23,5,1,4,3,1,6,5,-1,1,2,4,5,1,0,1,1,-2,-1,-56,-1,7,6,2,0,0,-1,1,1,-1,1,1
KR_6757896742,420,-1,35,-9,-1,3,4,1,-3,0,3,-1,1,2,-1,1,2,1,2,1,-2,-8,6,5,2,7,-2,0,0,-1,1,0,-1,1,1
KR_6752412258,420,2,18,16,-1,2,3,1,5,7,2,1,4,3,-9,2,11,0,2,2,0,-1,15,-1,5,4,-2,0,1,1,1,1,-1,1,1
KR_6659383510,440,-6,-90,-10,4,-2,1,3,1,1,0,8,9,1,-4,1,5,1,5,4,1,6,-8,0,1,1,1,0,-1,-1,1,-1,1,4,1
KR_6712912152,420,-4,-34,-15,-10,-6,1,7,-2,2,4,-1,1,2,2,4,2,-3,2,5,0,-7,12,0,3,3,-1,0,0,1,1,-1,1,1,1
KR_6721569352,420,1,-19,13,2,-2,1,3,-4,2,6,4,5,1,3,8,5,1,1,0,-1,-7,-44,2,4,6,16,0,0,1,1,-1,-1,5,1
KR_6709056563,420,2,22,-7,5,3,5,2,1,2,1,-1,1,2,1,1,0,1,2,1,0,0,5,3,3,6,-3,0,3,1,1,1,1,4,1
KR_6748917169,420,4,136,1,5,3,5,2,-3,1,4,-1,2,3,6,8,2,0,1,1,0,4,2,2,4,6,2,0,2,1,1,1,1,1,1
KR_6659697380,420,3,-2,7,8,6,7,1,3,4,1,5,8,3,-3,0,3,-3,0,3,0,2,-8,1,2,3,0,0,1,-1,1,1,-1,6,1
KR_6766962855,420,1,11,-24,10,-2,1,3,4,4,0,0,2,2,7,8,1,1,2,1,0,8,11,5,3,8,-4,0,1,1,-1,-1,1,4,1
KR_6716465509,440,-4,-10,-16,-7,3,5,2,-4,3,7,0,0,0,-4,1,5,-2,3,5,-1,-11,5,-2,6,4,-3,0,0,1,1,0,-1,5,1
KR_6619522031,420,-3,24,-33,2,-2,0,2,1,6,5,-1,0,1,7,7,0,-3,0,3,1,12,6,4,7,11,-4,0,1,1,-1,1,1,1,1
KR_6743378077,420,5,76,29,15,1,2,1,2,4,2,4,4,0,8,10,2,0,1,1,0,11,-7,-3,6,3,5,0,3,1,1,1,1,6,1
KR_6724115972,420,6,87,18,16,-1,1,2,10,11,1,-2,0,2,4,5,1,5,5,0,1,13,9,3,4,7,4,0,2,0,1,1,1,0,1
KR_6765566676,420,1,-40,-52,7,0,2,2,1,3,2,9,9,0,-1,0,1,-2,0,2,0,8,0,-2,5,3,3,0,0,-1,0,0,-1,5,1
KR_6758767288,420,3,-33,-12,14,0,2,2,6,6,0,6,6,0,2,3,1,0,0,0,0,19,-1,0,4,4,-1,0,1,1,1,1,1,3,1
KR_6736711995,420,-1,70,-16,4,4,4,0,-4,1,5,1,1,0,2,6,4,1,4,3,0,-4,-4,-2,6,4,1,0,1,1,1,1,1,5,1
KR_6763486438,420,0,-7,32,-3,-1,0,1,1,4,3,-5,2,7,0,2,2,2,2,0,0,-2,-9,2,4,6,0,0,0,-1,1,0,-1,2,1
KR_6664018403,420,-2,-84,-7,2,1,1,0,6,9,3,0,2,2,-6,0,6,1,1,0,0,-1,-40,-4,11,7,2,0,0,-1,1,-1,-1,4,1
KR_6730550119,420,5,72,12,17,1,3,2,0,2,2,1,1,0,8,8,0,7,8,1,1,18,4,4,3,7,7,0,1,-1,1,1,1,5,1
KR_6689033888,420,3,58,-7,9,1,1,0,6,6,0,0,1,1,3,3,0,-1,0,1,0,8,0,0,7,7,2,0,1,1,-1,1,1,5,1
KR_6760970409,420,2,33,11,8,0,2,2,-4,1,5,4,6,2,7,10,3,1,2,1,0,8,0,0,1,1,-2,0,1,-1,1,1,-1,2,1
KR_6760872941,420,4,22,12,15,5,5,0,3,5,2,2,3,1,1,2,1,4,4,0,0,16,2,3,1,4,-2,0,1,1,-1,1,1,4,1
KR_6722337239,420,-2,-10,-14,2,0,2,2,6,7,1,-1,2,3,-2,0,2,-1,0,1,0,3,-46,-2,5,3,21,0,-1,1,0,-1,1,2,1
KR_6762897041,420,-3,-17,-10,-11,-7,1,8,-1,2,3,1,1,0,-1,1,2,-3,1,4,-1,-9,1,-2,9,7,-2,0,-1,1,-1,-1,-1,1,1
KR_6675412978,420,4,38,32,9,-3,0,3,3,4,1,5,7,2,3,3,0,1,1,0,0,11,-10,9,3,12,7,0,1,1,1,1,1,5,1
KR_6635433241,420,-1,35,6,1,0,0,0,-1,3,4,-2,1,3,3,3,0,1,2,1,0,4,-225,-5,10,5,-2,0,-1,1,-1,-1,-1,2,1
KR_6763658562,420,-4,12,8,-8,0,6,6,-1,2,3,3,3,0,-9,0,9,-1,0,1,1,-8,-4,-1,5,4,-7,0,0,-1,1,-1,1,5,1
KR_6738917320,420,1,-2,-9,-8,-5,0,5,1,5,4,-6,1,7,3,5,2,-1,0,1,0,2,431,0,4,4,-2,0,0,-1,-1,0,-1,6,1
KR_6768701836,440,0,79,-10,1,-1,0,1,2,7,5,0,2,2,2,4,2,-2,0,2,0,6,-13,-6,7,1,6,0,0,1,-1,0,1,6,1
KR_6736604818,420,2,19,23,3,-3,1,4,4,4,0,2,3,1,1,1,0,-1,1,2,0,7,-17,1,4,5,5,0,1,0,1,1,-1,0,1
KR_6467232199,420,3,0,11,7,-1,2,3,-5,2,7,1,2,1,6,7,1,6,7,1,0,7,-7,-4,6,2,1,0,2,1,1,1,-1,3,1
KR_6736781796,420,2,75,-2,0,3,4,1,4,9,5,-3,0,3,-1,2,3,-3,0,3,0,-7,17,3,4,7,1,0,1,-1,1,1,1,2,1
KR_6743128238,420,2,80,16,0,-1,0,1,3,4,1,0,3,3,-2,0,2,0,0,0,0,2,107,-5,9,4,2,0,1,-1,1,1,-1,5,1
KR_6681456375,420,2,72,-10,0,0,2,2,-2,2,4,2,3,1,0,1,1,0,1,1,0,-6,1,-3,4,1,3,0,1,-1,-1,1,1,2,1
KR_6744812906,420,1,24,-40,6,2,2,0,1,4,3,1,3,2,1,3,2,1,1,0,1,13,74,1,2,3,1,0,0,-1,1,0,1,5,1
KR_6467264992,420,1,-21,20,3,1,2,1,-4,8,12,4,4,0,0,2,2,2,2,0,2,9,65,4,1,5,0,0,1,1,1,1,1,6,1
KR_6614632788,420,7,101,6,13,2,2,0,0,4,4,4,7,3,5,5,0,2,2,0,0,15,1,0,5,5,5,0,2,1,1,1,1,5,1
KR_6638153435,420,-1,-24,4,3,-2,2,4,0,2,2,3,4,1,3,8,5,-1,1,2,2,4,13,1,6,7,-4,0,-1,-1,-1,-1,1,1,1
KR_6737554882,420,-1,-28,-10,4,-6,0,6,-1,2,3,4,5,1,6,7,1,1,1,0,0,7,2,2,3,5,-1,0,1,1,1,1,-1,6,1
KR_6622209813,420,4,86,8,9,3,4,1,1,3,2,6,9,3,-2,6,8,1,1,0,-1,-5,135,5,4,9,-2,0,1,1,-1,1,-1,5,1
KR_6761193428,440,-4,-67,15,8,2,4,2,4,6,2,2,4,2,1,2,1,-1,0,1,0,2,-3,-2,4,2,4,0,-1,1,0,-1,-1,4,1
KR_6675913185,420,1,30,-4,-2,1,1,0,1,4,3,-4,0,4,-2,1,3,2,3,1,-1,0,4,2,4,6,-1,0,0,1,1,1,-1,4,1
KR_6745874313,420,1,69,9,2,-1,4,5,0,3,3,2,4,2,0,2,2,1,1,0,1,-1,-40,-2,5,3,1,0,1,0,1,1,1,0,1
KR_6763169343,420,3,-15,3,1,-4,1,5,5,5,0,-1,5,6,1,1,0,0,0,0,-1,9,-10,-5,7,2,1,0,0,-1,-1,-1,-1,1,1
KR_6607523869,420,0,-81,-20,-6,-3,1,4,0,2,2,2,6,4,-5,1,6,0,1,1,0,-5,-7,-9,10,1,-2,0,-1,-1,-1,-1,-1,6,1
KR_6759598800,440,2,5,37,6,1,3,2,1,3,2,-1,1,2,3,6,3,2,4,2,0,-2,1,4,4,8,-4,0,1,1,-1,1,1,4,1
KR_6766246572,420,2,16,15,1,-4,0,4,3,5,2,-1,1,2,3,4,1,0,2,2,0,4,-5,1,3,4,-1,0,0,0,1,0,-1,0,1
KR_6734356687,420,-1,-17,-18,1,2,4,2,-2,0,2,3,3,0,-2,0,2,0,2,2,0,-6,10,5,0,5,-3,0,0,-1,1,0,1,6,1
KR_6734935856,440,2,48,24,4,3,5,2,3,7,4,2,3,1,-3,1,4,-1,3,4,1,-4,10,3,6,9,2,0,1,1,1,1,1,5,1
KR_6765774159,420,3,53,3,9,1,2,1,-1,2,3,9,10,1,0,1,1,0,1,1,0,3,-5,0,3,3,-1,0,2,1,0,1,-1,1,1
KR_6733482113,420,0,-35,15,1,-5,0,5,1,3,2,3,3,0,0,3,3,2,4,2,0,3,6,2,3,5,-4,0,0,1,-1,1,1,4,1
KR_6729250321,420,-1,-77,46,0,6,7,1,-1,0,1,1,4,3,-8,2,10,2,2,0,0,-1,-28,-2,5,3,-4,0,0,1,-1,1,1,1,1
KR_5918961060,420,0,-54,-16,-5,6,6,0,1,2,1,-4,2,6,-8,0,8,0,5,5,-3,-7,5,-1,6,5,-1,0,-1,1,-1,-1,-1,4,1
KR_6754959028,420,0,-8,16,0,0,2,2,-3,1,4,1,2,1,3,3,0,-1,2,3,0,5,0,3,5,8,3,0,-1,1,1,-1,-1,1,1
KR_6703287853,420,2,-45,-7,7,0,2,2,2,2,0,3,5,2,1,2,1,1,4,3,0,8,219,-1,7,6,4,0,2,1,-1,1,1,2,1
KR_6725369010,420,-3,-3,-36,-3,-2,2,4,6,6,0,-3,2,5,-3,2,5,-1,1,2,0,1,0,6,4,10,4,0,-2,-1,1,-1,1,3,1
KR_6671156720,420,1,6,24,3,-5,0,5,1,3,2,2,3,1,0,1,1,5,5,0,-1,4,167,3,4,7,-2,0,-1,-1,1,-1,-1,5,1
KR_6726083383,420,-2,50,8,-6,-1,2,3,-3,4,7,1,2,1,-2,1,3,-1,1,2,0,-16,2,3,2,5,-2,0,-2,1,-1,-1,-1,1,1
KR_6732720328,420,1,28,15,3,1,2,1,1,4,3,-1,2,3,3,4,1,-1,0,1,0,-4,-126,-3,6,3,-1,0,1,-1,-1,1,1,2,1
KR_6764358104,420,2,48,60,4,6,7,1,-7,0,7,-1,0,1,6,6,0,0,0,0,0,3,2,-3,3,0,2,0,0,1,1,0,1,1,1
KR_6724309575,420,3,39,24,6,-1,0,1,-1,2,3,7,7,0,0,4,4,1,2,1,-1,-4,-67,-1,3,2,0,0,0,1,1,1,-1,3,1
KR_6751746948,420,4,100,40,4,0,3,3,2,2,0,2,3,1,1,7,6,-1,0,1,0,3,45,5,2,7,-3,0,2,0,1,1,-1,0,1
KR_6690241828,420,-1,-23,-5,2,1,1,0,0,3,3,-2,1,3,4,6,2,-1,3,4,0,4,7,11,3,14,0,0,-1,-1,1,-1,-1,2,1
KR_6766099279,420,0,37,21,7,1,2,1,1,5,4,0,1,1,5,10,5,0,0,0,0,7,-109,2,5,7,-1,0,1,-1,1,1,1,1,1
KR_6730454820,440,0,-27,1,-5,2,3,1,2,6,4,-1,3,4,-8,3,11,0,2,2,-2,-3,4,-3,4,1,-2,0,0,-1,1,0,-1,6,1
KR_6765939970,420,1,-21,-25,3,3,3,0,-5,2,7,1,1,0,2,2,0,2,2,0,1,4,1,0,5,5,-2,0,0,-1,1,1,1,1,1
KR_6755759804,420,5,66,31,10,3,3,0,-1,4,5,2,5,3,4,5,1,2,2,0,0,4,-2,3,0,3,0,0,1,1,0,1,1,3,1
KR_6769323254,420,7,130,2,14,0,1,1,6,8,2,4,4,0,3,6,3,1,1,0,0,14,-10,1,2,3,-1,0,3,-1,1,1,1,2,1
KR_6743472218,440,2,-25,22,6,-3,2,5,2,6,4,1,3,2,6,6,0,0,0,0,0,11,8,0,3,3,1,0,0,1,0,1,-1,6,1
KR_6633442439,420,-1,-14,1,-6,-2,1,3,-3,2,5,-1,2,3,0,1,1,0,1,1,0,3,4,1,2,3,1,0,-1,-1,1,-1,-1,4,1
KR_6760285453,420,3,-12,16,3,2,3,1,-1,4,5,1,2,1,-1,1,2,2,3,1,0,-3,369,-2,6,4,-2,0,1,1,1,1,1,1,1
KR_6760716731,420,-2,-11,8,-5,2,3,1,-4,0,4,-3,2,5,0,4,4,0,2,2,0,-5,17,-1,5,4,1,0,0,-1,0,-1,-1,4,1
KR_6740375793,420,5,40,14,14,2,3,1,7,8,1,1,2,1,2,3,1,2,2,0,0,12,-6,2,4,6,0,0,1,-1,-1,1,-1,2,1
KR_6761719880,420,2,10,-3,16,1,3,2,3,6,3,10,10,0,1,3,2,1,2,1,0,16,29,0,4,4,-1,0,0,1,1,1,1,5,1
KR_6748681776,420,2,87,-32,6,2,3,1,1,3,2,-1,3,4,5,5,0,-1,3,4,3,15,-45,0,4,4,29,0,1,-1,1,1,1,3,1
KR_6654868961,420,1,18,20,-8,0,2,2,0,4,4,-7,0,7,-2,3,5,1,1,0,0,-1,9,4,1,5,-1,0,0,1,-1,-1,-1,3,1
KR_6734402164,420,-1,-25,0,-4,-1,1,2,1,4,3,1,2,1,-6,2,8,1,2,1,0,-3,1,-1,7,6,0,0,-1,1,-1,-1,-1,3,1
