matchId,queueId,Diff_LV,Diff_CS,Diff_jglCS,Diff-K,Diff-K-top,K-WIN-top,K-LOSE-top,Diff-K-jug,K-WIN-jug,K-LOSE-jug,Diff-K-mid,K-WIN-mid,K-LOSE-mid,Diff-K-ad,K-WIN-ad,K-LOSE-ad,Diff-K-sup,K-WIN-sup,K-LOSE-sup,invadeKill,Diff-A,Diff_WARDplaced,Diff-ControlWARDplaced,LOSE_controlWARDPlaced,WIN_controlWARDPlaced,Diff_WARDkill,Diff_Inhibitor,Diff_TOWERkill,Diff_FirstDRAGON,Diff_FirstHERALD,Diff_Firsttower,Diff_FirstBLOOD,dragonType,result
KR_6705675166,420,-2,-1,8,-8,0,4,4,-4,0,4,-4,1,5,0,1,1,0,0,0,0,-10,3,-1,3,2,-2,0,0,-1,-1,-1,1,3,1
KR_6762512502,420,1,8,42,8,3,4,1,7,7,0,-1,3,4,-1,2,3,0,1,1,0,10,-21,0,5,5,0,0,1,1,1,1,1,4,1
KR_6760233224,420,3,40,-15,5,4,5,1,-1,2,3,1,1,0,2,4,2,-1,0,1,0,-1,0,2,4,6,-1,0,2,1,0,1,1,5,1
KR_6745065998,420,-1,66,-24,0,-2,2,4,-5,5,10,5,5,0,-1,5,6,3,3,0,1,2,-26,1,3,4,6,0,0,-1,1,1,1,6,1
KR_6745080043,420,0,17,-8,2,1,5,4,0,2,2,-1,2,3,2,2,0,0,1,1,0,1,9,-1,5,4,-1,0,1,-1,-1,1,-1,3,1
KR_6595923382,440,1,-20,11,16,-2,1,3,3,4,1,9,10,1,6,6,0,0,1,1,1,14,10,0,4,4,1,0,0,1,1,1,1,1,1
KR_6623457832,420,6,65,27,10,4,5,1,-1,1,2,9,11,2,-1,4,5,-1,0,1,1,1,-45,3,6,9,30,0,2,1,1,1,1,5,1
KR_6763701645,420,5,45,-35,10,1,3,2,4,4,0,5,8,3,1,2,1,-1,0,1,0,10,-5,3,3,6,3,0,0,1,-1,0,-1,3,1
KR_6748608457,420,4,142,-4,3,-2,0,2,-3,3,6,2,3,1,2,5,3,4,4,0,0,3,-39,-1,4,3,1,0,1,1,-1,1,1,2,1
KR_6731374198,420,4,71,44,5,4,5,1,3,6,3,2,3,1,-1,0,1,-3,0,3,1,-3,70,4,2,6,-10,0,0,1,1,1,1,4,1
KR_6616250380,420,2,-50,29,3,1,3,2,0,0,0,-1,2,3,2,2,0,1,1,0,0,6,8,-5,8,3,0,0,1,1,1,1,-1,2,1
KR_6491823710,420,6,41,32,10,1,3,2,2,2,0,-1,1,2,3,5,2,5,5,0,0,7,4,1,4,5,5,0,2,1,1,1,1,4,1
KR_6753768751,420,4,36,-19,8,2,3,1,2,2,0,3,4,1,-3,0,3,4,4,0,0,6,-3,1,5,6,5,0,1,1,1,1,1,6,1
KR_6764173971,420,-3,-19,-24,-4,5,7,2,4,4,0,-3,0,3,-1,1,2,-9,0,9,0,-1,6,-1,3,2,-5,0,-1,1,-1,-1,1,5,1
KR_6760675346,420,1,30,-11,4,-1,3,4,4,4,0,0,2,2,1,1,0,0,1,1,0,6,-4,0,3,3,1,0,2,-1,1,1,-1,1,1
KR_6759604357,420,-1,-38,15,-1,1,2,1,1,1,0,-2,0,2,1,3,2,-2,0,2,0,-1,3,2,7,9,2,0,0,-1,1,-1,-1,6,1
KR_6760063054,420,4,99,7,10,1,2,1,1,2,1,2,2,0,4,4,0,2,2,0,0,16,2,-1,5,4,-2,0,2,1,1,1,1,6,1
KR_6766283186,420,1,17,24,0,-2,1,3,-2,2,4,-2,2,4,5,6,1,1,2,1,0,-2,-183,-1,4,3,8,0,0,1,1,1,1,3,1
KR_6740858324,420,2,-12,28,6,6,6,0,1,3,2,0,1,1,-2,3,5,1,2,1,0,-1,3,-7,10,3,-1,0,2,1,1,1,1,3,1
KR_6746057146,420,-3,-62,-5,-2,1,2,1,2,3,1,-4,2,6,-2,1,3,1,1,0,0,-1,-31,-1,3,2,4,0,0,-1,-1,0,-1,4,1
KR_6634963884,420,0,-11,8,0,-1,1,2,2,5,3,3,3,0,-6,1,7,2,4,2,1,9,-3,2,7,9,-3,0,1,1,-1,1,1,5,1
KR_6703549317,440,5,35,12,8,1,2,1,4,6,2,-3,3,6,6,10,4,0,4,4,0,0,-11,0,8,8,5,0,1,1,0,1,-1,4,1
KR_6761352555,420,7,60,16,18,6,8,2,-1,3,4,10,10,0,3,4,1,0,1,1,-1,4,4,3,2,5,12,0,3,-1,1,1,-1,1,1
KR_6751302053,420,-1,29,-4,-3,3,3,0,-8,1,9,-1,3,4,2,8,6,1,1,0,-2,-16,-1,4,2,6,2,0,1,0,1,1,-1,0,1
KR_6756155402,420,1,99,-9,6,1,2,1,-1,3,4,0,4,4,4,5,1,2,2,0,1,9,-35,3,3,6,3,0,3,1,-1,1,1,3,1
KR_6703470690,440,4,28,0,5,-1,3,4,6,6,0,-4,1,5,6,6,0,-2,1,3,1,7,-40,2,6,8,16,0,0,-1,-1,0,1,6,1
KR_6731499657,420,5,48,8,8,1,3,2,-2,3,5,2,3,1,7,9,2,0,1,1,2,11,-23,0,3,3,-1,0,1,1,-1,-1,1,3,1
KR_6760657952,420,1,14,-19,1,-4,0,4,1,5,4,2,2,0,0,4,4,2,2,0,0,8,27,-6,8,2,-18,0,1,-1,-1,1,1,4,1
KR_6634787627,420,-1,-14,-12,-4,3,3,0,-2,0,2,-1,1,2,-1,2,3,-3,0,3,0,1,9,2,4,6,0,0,0,-1,1,-1,1,4,1
KR_6756697720,420,-3,25,27,-1,-2,0,2,1,2,1,-4,4,8,2,3,1,2,2,0,0,6,-1,-2,5,3,-2,0,1,1,1,1,1,2,1
KR_6763238532,420,-1,53,-8,1,0,2,2,0,1,1,1,1,0,-1,0,1,1,2,1,1,4,0,3,2,5,-1,0,0,1,0,0,1,4,1
KR_6756889366,440,-1,15,-8,-1,5,5,0,2,3,1,-4,3,7,-3,2,5,-1,2,3,3,-4,-25,0,4,4,6,0,2,-1,1,1,1,4,1
KR_6761189358,420,3,40,11,7,0,2,2,-1,2,3,5,6,1,3,7,4,0,2,2,0,10,5,1,3,4,-1,0,1,1,-1,1,-1,3,1
KR_6648479461,420,4,37,37,-1,2,3,1,-4,0,4,0,1,1,3,4,1,-2,0,2,0,-5,1,-3,5,2,1,0,1,-1,-1,1,1,3,1
KR_6741092299,440,5,65,25,6,-2,2,4,9,10,1,-1,2,3,1,4,3,-1,0,1,0,12,35,9,1,10,-3,0,1,1,0,1,-1,5,1
KR_6758907146,420,3,-35,24,3,3,4,1,0,1,1,0,1,1,-1,3,4,1,1,0,-1,2,-11,-3,6,3,2,0,0,-1,1,0,-1,2,1
KR_6765259939,420,-1,-4,-16,-3,1,2,1,2,4,2,-4,0,4,0,4,4,-2,0,2,0,-3,0,-1,6,5,1,0,0,-1,1,0,-1,4,1
KR_6716374189,420,2,106,16,5,3,4,1,-2,3,5,-1,0,1,4,7,3,1,2,1,-1,4,4,-3,5,2,1,0,2,1,1,1,-1,1,1
KR_6743635121,420,-1,37,24,0,2,3,1,-1,2,3,-3,1,4,-1,2,3,3,3,0,0,-1,-41,-1,5,4,19,0,1,-1,1,1,1,3,1
KR_6744174095,420,1,79,-17,7,1,2,1,2,5,3,1,1,0,2,2,0,1,2,1,0,7,7,-2,5,3,-2,0,1,-1,1,1,1,6,1
KR_6750787900,420,4,-20,36,-2,-1,1,2,-2,2,4,1,2,1,-1,4,5,1,2,1,0,-6,-4,-4,8,4,1,0,0,1,1,0,1,6,1
KR_6634274767,420,0,-4,-20,2,0,2,2,3,6,3,2,5,3,1,3,2,-4,2,6,1,-2,8,2,4,6,2,0,-1,1,1,1,1,3,1
KR_6764288502,420,0,37,-46,5,1,2,1,-1,1,2,0,1,1,5,6,1,0,0,0,0,10,4,8,3,11,1,0,0,-1,-1,0,-1,2,1
KR_6690207875,420,-2,-58,-8,-4,1,2,1,-5,1,6,3,4,1,-1,0,1,-2,1,3,0,-8,-5,-4,9,5,2,0,0,-1,-1,1,1,2,1
KR_6763217549,440,2,45,16,4,1,1,0,0,2,2,-1,1,2,2,2,0,2,2,0,0,3,-12,-2,7,5,8,0,0,1,-1,0,-1,2,1
KR_6482121201,420,3,104,20,9,2,3,1,1,4,3,5,7,2,1,2,1,0,1,1,0,4,68,1,4,5,5,0,2,1,0,1,1,1,1
KR_6689025443,420,1,31,28,4,1,1,0,0,1,1,3,4,1,1,1,0,-1,0,1,0,2,27,6,2,8,-4,0,1,1,1,1,1,6,1
KR_6739446167,420,1,42,-8,1,5,6,1,1,3,2,-1,0,1,-3,1,4,-1,0,1,0,-2,2,-6,8,2,5,0,0,-1,1,0,1,4,1
KR_6599589895,420,-4,52,-1,-10,-5,1,6,-1,3,4,-7,0,7,4,6,2,-1,2,3,1,-4,11,-2,5,3,1,0,-1,-1,-1,-1,-1,3,1
KR_6719698380,420,-3,10,-4,-3,-3,1,4,2,2,0,1,5,4,-3,3,6,0,3,3,1,-2,-6,-3,8,5,2,0,0,1,1,0,1,2,1
KR_6648948808,420,-2,-35,8,-3,1,4,3,-3,0,3,0,4,4,0,3,3,-1,1,2,2,-1,12,-1,4,3,-4,0,0,-1,1,1,1,3,1
KR_6765323781,420,-1,-45,-7,3,-2,1,3,-1,4,5,3,5,2,-1,2,3,4,4,0,0,7,2,2,3,5,5,0,1,1,1,1,-1,3,1
KR_6597883260,420,3,62,38,9,4,4,0,2,4,2,4,7,3,-1,4,5,0,0,0,0,9,0,0,8,8,3,0,2,1,1,1,1,2,1
KR_6762719446,420,0,21,3,-2,0,2,2,-1,1,2,1,1,0,-6,3,9,4,4,0,0,-8,-3,-4,7,3,4,0,2,1,1,1,1,2,1
KR_6652235474,420,0,-3,18,1,0,1,1,-1,2,3,2,5,3,1,7,6,-1,0,1,1,-7,0,0,8,8,-1,0,1,1,1,1,-1,2,1
KR_6734180354,440,4,40,12,7,1,1,0,1,3,2,5,5,0,0,2,2,0,0,0,0,6,5,-2,3,1,2,0,0,1,-1,1,-1,2,1
KR_6622449437,420,0,-6,2,5,8,9,1,2,2,0,-1,1,2,0,3,3,-4,0,4,0,-5,16,2,2,4,-1,0,0,-1,1,1,-1,1,1
KR_6723021496,420,2,43,18,5,9,9,0,-6,3,9,-3,0,3,4,5,1,1,1,0,0,-7,28,0,5,5,-1,0,1,1,-1,1,1,6,1
KR_6754577556,420,0,58,-12,4,-1,1,2,3,3,0,5,5,0,-2,1,3,-1,1,2,0,2,16,2,2,4,-5,0,1,-1,1,1,1,2,1
KR_6758763126,420,-1,-23,-4,0,0,1,1,-5,2,7,-1,4,5,5,5,0,1,1,0,0,-3,23,2,3,5,0,0,0,-1,1,0,1,5,1
KR_6751007511,420,0,25,5,2,1,6,5,-2,1,3,-2,0,2,2,2,0,3,3,0,0,2,2,1,4,5,-3,0,1,1,-1,-1,-1,5,1
KR_6683900259,420,1,32,11,4,-3,1,4,-2,4,6,8,13,5,0,2,2,1,1,0,0,-3,0,3,3,6,0,0,1,1,1,-1,1,2,1
KR_6743221142,420,-1,-6,-4,-2,-3,1,4,-1,3,4,-3,2,5,4,8,4,1,3,2,0,18,0,5,5,10,-3,0,-1,1,1,-1,1,5,1
KR_6745647983,420,2,39,9,-4,-4,0,4,-1,3,4,0,2,2,2,3,1,-1,0,1,0,1,32,1,6,7,-2,0,0,1,-1,1,-1,6,1
KR_6734291053,440,2,-37,12,1,1,2,1,3,4,1,0,2,2,-3,2,5,0,2,2,0,3,0,0,1,1,0,0,1,1,1,1,1,1,1
KR_6729671410,420,2,56,-36,-5,0,2,2,-3,2,5,-1,1,2,0,2,2,-1,0,1,0,-8,-67,2,3,5,0,0,1,-1,1,1,-1,5,1
KR_6652642098,420,4,-17,8,10,0,1,1,1,3,2,3,5,2,3,3,0,3,4,1,0,14,0,2,6,8,-2,0,0,1,-1,0,1,4,1
KR_6757560006,440,4,91,11,2,0,4,4,2,7,5,0,3,3,1,4,3,-1,2,3,-1,-5,3,4,2,6,-2,0,2,1,1,1,-1,3,1
KR_6760250323,420,-2,-85,-16,-2,-1,1,2,-1,3,4,2,3,1,-2,4,6,0,1,1,0,0,16,-6,8,2,5,0,0,0,-1,0,-1,0,1
KR_6698358582,420,2,23,3,8,5,5,0,5,6,1,-2,2,4,2,3,1,-2,3,5,0,9,14,3,2,5,-1,0,1,1,1,1,1,1,1
KR_6606337189,420,4,90,19,17,4,6,2,4,4,0,1,4,3,12,12,0,-4,1,5,1,22,100,8,2,10,4,0,3,-1,1,1,1,4,1
KR_6680821870,420,1,65,9,8,5,6,1,3,3,0,-4,0,4,5,6,1,-1,1,2,0,1,120,-1,4,3,4,0,3,-1,1,1,1,4,1
KR_6747772942,420,0,63,8,-3,-1,0,1,0,8,8,1,2,1,-5,2,7,2,3,1,-1,-13,-29,-7,11,4,4,0,-1,-1,-1,-1,-1,2,1
KR_6750817477,420,4,-7,-8,12,1,1,0,5,6,1,1,2,1,5,7,2,0,0,0,0,6,10,5,2,7,-2,0,1,1,1,1,1,6,1
KR_6746921065,420,0,46,-17,-2,0,0,0,1,4,3,-5,2,7,1,1,0,1,2,1,-2,-4,-32,2,7,9,-1,0,0,1,-1,1,-1,3,1
KR_6732382903,440,1,65,-16,2,-1,1,2,-2,1,3,3,4,1,4,4,0,-2,0,2,0,4,4,1,3,4,4,0,0,-1,1,1,1,2,1
KR_6740567149,420,-4,19,-6,-4,-5,0,5,0,3,3,-3,0,3,4,5,1,0,0,0,0,4,9,-3,7,4,-3,0,-2,1,-1,-1,-1,5,1
KR_6762440441,440,5,48,2,14,0,1,1,6,7,1,1,5,4,5,6,1,2,4,2,0,14,1,-5,8,3,10,0,1,1,1,1,1,6,1
KR_6755662320,440,5,122,8,14,4,5,1,4,4,0,3,5,2,2,3,1,1,2,1,2,16,2,0,6,6,6,0,1,1,1,1,1,3,1
KR_6751003321,440,1,37,18,3,1,2,1,-2,2,4,3,7,4,1,2,1,0,1,1,0,-5,3,4,1,5,4,0,1,1,1,1,1,2,1
KR_6749529123,420,3,50,13,13,-2,1,3,3,6,3,1,2,1,11,12,1,0,2,2,0,16,17,4,5,9,1,0,1,-1,1,1,1,2,1
KR_6744936846,420,2,33,48,6,3,4,1,2,4,2,1,3,2,0,4,4,0,1,1,0,1,9,1,5,6,-3,0,0,1,1,1,1,3,1
KR_6759065245,420,1,-17,8,11,4,4,0,2,3,1,-3,1,4,5,5,0,3,3,0,0,13,-3,4,1,5,-2,0,1,-1,1,1,1,5,1
KR_6753123759,420,3,90,-5,2,3,6,3,-2,1,3,2,3,1,1,2,1,-2,0,2,0,4,31,1,4,5,-2,0,0,1,1,0,-1,3,1
KR_6680632599,420,4,56,30,5,-1,0,1,2,3,1,1,4,3,2,5,3,1,2,1,0,0,3,-2,7,5,-1,0,0,1,1,0,1,5,1
KR_6744832402,440,-1,14,8,0,-2,2,4,0,3,3,2,2,0,-1,3,4,1,1,0,0,10,14,-1,6,5,1,0,1,-1,1,1,-1,5,1
KR_6759624871,420,3,99,-1,9,4,5,1,2,4,2,-1,2,3,3,6,3,1,1,0,1,7,-39,0,6,6,-1,0,2,-1,-1,1,1,5,1
KR_6662878690,420,0,82,4,1,3,5,2,-5,1,6,0,2,2,4,7,3,-1,1,2,-3,-9,-4,-3,6,3,3,0,1,1,-1,1,-1,6,1
KR_6739246406,420,4,117,-4,1,4,4,0,-1,0,1,-1,0,1,2,4,2,-3,0,3,1,0,0,-2,7,5,2,0,2,-1,1,1,1,3,1
KR_6764201929,420,2,52,29,11,10,10,0,-1,3,4,7,7,0,-2,2,4,-3,1,4,0,-6,-15,-2,6,4,7,0,1,-1,1,1,1,6,1
KR_6762433987,420,-2,-64,-13,-11,-3,2,5,-2,1,3,1,1,0,-2,1,3,-5,0,5,0,-4,-2,1,1,2,-4,0,-3,-1,-1,-1,1,4,1
KR_6722324113,420,1,52,-8,6,-6,1,7,1,2,1,2,2,0,6,6,0,3,3,0,0,16,7,-1,4,3,3,0,1,0,1,1,-1,0,1
KR_6736303844,420,3,46,-14,5,2,3,1,-1,2,3,4,5,1,-1,2,3,1,1,0,0,7,1,-2,6,4,0,0,0,-1,-1,0,1,4,1
KR_6729550403,420,-2,-28,21,2,-2,1,3,-2,2,4,1,1,0,2,3,1,3,4,1,0,7,-27,-1,3,2,7,0,1,0,1,1,-1,0,1
KR_6747478908,420,1,-49,12,4,-2,2,4,2,3,1,1,4,3,0,4,4,3,3,0,-3,4,12,4,6,10,-5,0,0,1,1,0,-1,3,1
KR_6745039586,420,3,47,36,5,5,9,4,1,4,3,0,4,4,-2,3,5,1,1,0,2,-9,-1,0,6,6,3,0,1,1,1,1,1,5,1
KR_6758388027,440,5,65,15,14,4,4,0,8,8,0,3,4,1,-2,1,3,1,1,0,0,12,-5,1,4,5,-1,0,0,1,-1,1,1,5,1
KR_6763564281,420,-2,-16,2,-6,-4,0,4,6,7,1,-7,0,7,-2,2,4,1,1,0,0,-10,3,1,5,6,0,0,0,-1,-1,1,1,6,1
KR_6729571784,420,2,17,35,10,0,1,1,-4,1,5,9,10,1,3,3,0,2,2,0,0,13,-11,5,5,10,3,0,1,1,1,1,1,6,1
KR_6764906282,420,0,-30,-20,5,3,4,1,1,2,1,2,3,1,-1,2,3,0,0,0,0,7,12,9,4,13,-3,0,-1,1,-1,-1,-1,2,1
KR_6744165059,420,5,73,5,3,2,4,2,2,2,0,1,1,0,-1,0,1,-1,0,1,0,6,21,3,1,4,-2,0,0,1,1,0,1,5,1
KR_6757192747,420,3,12,27,3,3,4,1,-5,1,6,1,2,1,6,8,2,-2,0,2,0,-4,2,0,7,7,-3,0,1,1,-1,1,1,6,1
KR_6712309905,420,3,53,-3,8,3,4,1,3,8,5,0,2,2,2,4,2,0,2,2,0,-7,228,-3,5,2,0,0,-1,1,-1,-1,-1,2,1
KR_6757027799,420,1,63,3,6,2,2,0,6,9,3,-4,1,5,-1,0,1,3,4,1,0,3,-14,1,5,6,2,0,2,1,1,1,1,4,1
KR_6764944449,420,1,36,28,4,4,4,0,-2,1,3,1,1,0,0,0,0,1,1,0,0,2,16,3,3,6,-1,0,1,1,1,1,1,2,1
KR_6754339901,420,1,-29,19,11,0,1,1,1,1,0,1,4,3,0,2,2,9,9,0,0,5,48,0,6,6,4,0,0,0,1,1,1,0,1
KR_6759317909,420,2,29,-14,4,4,6,2,0,1,1,-5,2,7,2,3,1,3,3,0,2,18,41,4,4,8,5,0,0,1,1,1,-1,3,1
KR_6748437289,420,4,66,-9,13,-3,1,4,6,6,0,1,2,1,5,5,0,4,7,3,0,10,-11,-1,5,4,3,0,1,1,-1,1,1,1,1
KR_6751455554,420,-5,7,-8,-12,-2,0,2,-3,2,5,-4,0,4,1,3,2,-4,1,5,0,-13,-13,-1,3,2,1,0,-1,0,-1,-1,-1,0,1
KR_6709392787,420,1,43,7,-5,3,3,0,-2,2,4,-2,1,3,-2,1,3,-2,0,2,0,-3,-6,6,4,10,-5,0,-1,-1,0,-1,-1,4,1
KR_6666469126,420,3,29,28,5,-1,2,3,-3,2,5,1,2,1,8,10,2,0,0,0,0,3,5,5,3,8,-1,0,1,-1,1,1,-1,6,1
KR_6765628082,420,1,45,29,9,1,1,0,6,7,1,1,4,3,1,2,1,0,0,0,0,9,19,-4,6,2,-4,0,0,0,0,1,1,0,1
KR_6763873422,420,0,4,-2,-4,3,4,1,-7,2,9,-1,1,2,1,2,1,0,3,3,0,-8,-313,1,5,6,0,0,-1,-1,1,-1,-1,5,1
KR_6652701142,420,4,57,46,9,3,3,0,3,3,0,-2,3,5,1,2,1,4,7,3,2,7,-29,6,3,9,20,0,0,1,1,1,1,3,1
KR_6746857533,420,2,12,22,2,1,2,1,4,5,1,-1,1,2,-3,0,3,1,3,2,-1,5,-15,-3,5,2,28,0,-1,1,-1,-1,1,1,1
KR_6612039084,420,3,63,29,1,1,1,0,2,3,1,-1,3,4,1,3,2,-2,1,3,0,-1,-5,-2,6,4,4,0,1,1,-1,1,1,3,1
KR_6760531026,420,2,4,7,0,4,4,0,0,3,3,1,2,1,-4,1,5,-1,0,1,0,-6,-9,3,2,5,1,0,0,-1,1,-1,-1,1,1
KR_6723054464,420,2,-1,21,4,0,2,2,1,4,3,0,3,3,0,1,1,3,3,0,1,3,6,6,2,8,-1,0,0,1,1,0,1,6,1
KR_6646358015,420,4,52,36,7,2,2,0,0,4,4,2,2,0,2,6,4,1,1,0,0,8,3,-1,5,4,6,0,1,1,1,1,-1,6,1
KR_6737841937,420,2,13,44,4,1,1,0,4,6,2,-4,1,5,2,3,1,1,2,1,0,7,1,-1,5,4,0,0,0,0,1,0,-1,0,1
KR_6730146692,420,0,-11,-8,4,-1,0,1,0,2,2,3,4,1,1,1,0,1,2,1,0,5,-119,3,6,9,2,0,0,-1,1,1,-1,2,1
KR_6709786915,420,1,51,3,-1,0,2,2,-3,3,6,4,6,2,-1,4,5,-1,2,3,0,-2,-1,2,0,2,0,0,1,1,-1,1,1,3,1
KR_6765910821,420,2,2,18,9,2,3,1,5,6,1,1,1,0,2,5,3,-1,0,1,0,11,37,0,4,4,-1,0,1,1,1,1,1,5,1
KR_6665389631,420,0,-14,4,5,2,3,1,4,4,0,-2,0,2,2,3,1,-1,1,2,0,9,-329,2,3,5,-3,0,-1,1,1,-1,1,2,1
KR_6686513590,420,-2,-16,-22,1,1,4,3,2,3,1,1,4,3,-3,3,6,0,1,1,0,-3,-4,-5,8,3,6,0,0,-1,-1,-1,1,1,1
KR_6762203843,440,11,185,6,30,3,5,2,0,2,2,13,13,0,13,14,1,1,2,1,0,21,8,6,2,8,0,0,4,1,1,1,1,5,1
KR_6727840560,420,2,42,35,3,-2,0,2,1,2,1,2,2,0,0,0,0,2,2,0,0,2,12,4,2,6,-3,0,1,1,1,1,1,4,1
KR_6748565027,420,-1,15,-7,-4,-1,1,2,-1,1,2,-2,2,4,1,4,3,-1,0,1,0,-9,-32,1,3,4,18,0,-1,-1,-1,-1,-1,1,1
KR_6757176896,420,2,21,-2,3,2,2,0,1,2,1,0,0,0,-1,5,6,1,1,0,0,-5,0,0,4,4,2,0,1,-1,1,1,1,6,1
KR_6761636520,420,3,81,39,3,-4,1,5,-6,2,8,1,4,3,12,12,0,0,0,0,0,1,-6,-2,6,4,4,0,1,1,-1,1,1,6,1
KR_6762844362,420,8,35,19,20,5,7,2,8,9,1,9,10,1,-1,1,2,-1,1,2,2,18,7,5,3,8,-1,0,2,1,1,1,1,3,1
KR_6735849449,420,8,118,18,14,-1,1,2,6,7,1,5,7,2,5,6,1,-1,1,2,1,11,3,7,2,9,1,0,3,1,1,1,1,4,1
KR_6760398424,420,-2,15,8,1,1,4,3,-3,0,3,-2,2,4,2,3,1,3,3,0,1,3,-2,1,6,7,5,0,1,1,-1,1,1,4,1
KR_6601354177,420,3,33,17,7,2,4,2,-2,4,6,5,6,1,-2,1,3,4,7,3,0,6,-5,-2,6,4,1,0,0,1,0,1,-1,1,1
KR_6650916565,420,2,-38,-4,3,6,7,1,-3,0,3,0,3,3,1,1,0,-1,1,2,0,2,7,6,3,9,1,0,0,-1,1,1,-1,3,1
KR_6686224725,420,-1,22,28,-4,-2,2,4,-2,2,4,-1,1,2,1,2,1,0,0,0,0,-4,7,2,4,6,0,0,0,1,1,1,-1,1,1
KR_6742090297,440,-2,59,0,-5,1,2,1,-6,2,8,-3,0,3,1,2,1,2,2,0,0,-7,8,0,5,5,-5,0,-2,-1,-1,-1,-1,6,1
KR_6744050900,440,3,-3,0,3,0,3,3,2,3,1,0,1,1,1,2,1,0,0,0,0,6,9,2,2,4,1,0,1,-1,-1,1,-1,6,1
KR_6725816075,420,4,67,5,6,4,4,0,0,1,1,0,3,3,3,4,1,-1,1,2,0,2,2,0,3,3,2,0,2,1,1,1,-1,3,1
KR_6695041431,420,1,-59,0,1,4,4,0,4,7,3,-7,1,8,-1,4,5,1,2,1,-2,1,9,4,6,10,-3,0,-1,-1,1,1,-1,4,1
KR_6748540938,420,0,33,-8,-3,1,3,2,-3,2,5,-3,3,6,2,2,0,0,0,0,0,2,2,0,1,1,2,0,0,1,-1,-1,1,4,1
KR_6741583550,420,-1,-76,-2,9,3,3,0,2,4,2,0,1,1,4,4,0,0,0,0,0,13,1,-3,6,3,-1,0,0,0,0,0,1,0,1
KR_6615880480,420,-1,13,24,-4,2,2,0,-3,0,3,0,3,3,-2,1,3,-1,0,1,0,-9,-9,-2,6,4,4,0,0,1,-1,0,1,2,1
KR_6746172180,420,0,-19,-21,3,3,5,2,1,2,1,0,2,2,0,1,1,-1,0,1,-1,-1,3,5,4,9,0,0,-1,-1,1,-1,-1,4,1
KR_6687483978,420,1,30,9,0,3,4,1,4,5,1,-5,1,6,5,10,5,-7,0,7,-2,-7,-20,-2,7,5,2,0,0,1,-1,-1,-1,1,1
KR_6765193400,420,-3,-26,3,-9,-2,1,3,-3,0,3,0,0,0,-2,1,3,-2,1,3,0,-10,-2,-2,8,6,3,0,-1,-1,-1,-1,-1,5,1
KR_6689071928,420,1,31,9,3,5,7,2,-1,3,4,-2,1,3,-1,2,3,2,2,0,0,3,12,2,5,7,5,0,0,1,-1,1,-1,3,1
KR_6748589954,420,-2,-8,20,2,0,1,1,-2,1,3,1,2,1,4,6,2,-1,0,1,0,8,7,0,5,5,-1,0,0,-1,1,0,-1,4,1
KR_6734592825,420,4,38,25,8,3,5,2,-4,2,6,5,7,2,6,7,1,-2,1,3,0,14,11,8,2,10,-4,0,3,-1,1,1,-1,1,1
KR_6765717425,420,0,46,-8,-2,0,1,1,-1,0,1,-2,2,4,1,2,1,0,0,0,0,-4,94,-3,6,3,4,0,1,1,1,1,1,1,1
KR_6758726703,420,4,77,32,13,5,5,0,5,6,1,-2,3,5,7,9,2,-2,2,4,0,13,6,6,1,7,0,0,4,1,1,1,1,4,1
KR_6743087959,420,3,29,-4,4,0,1,1,2,4,2,1,1,0,2,5,3,-1,1,2,0,9,145,6,2,8,-1,0,0,-1,1,0,-1,6,1
KR_6664064244,420,-2,-2,16,-5,-1,1,2,-2,1,3,0,2,2,0,4,4,-2,0,2,0,-9,-7,-1,6,5,1,0,0,-1,1,1,-1,5,1
KR_6716817698,420,2,-11,20,2,3,3,0,-1,2,3,3,5,2,-2,2,4,-1,2,3,-1,-1,0,0,3,3,-9,0,1,1,1,1,-1,4,1
KR_6726779087,420,-2,-17,2,-3,0,2,2,-4,2,6,-1,4,5,3,5,2,-1,1,2,0,-6,6,-3,6,3,-5,0,0,-1,1,0,1,1,1
KR_6753531857,420,5,23,63,7,-1,0,1,2,6,4,3,4,1,3,3,0,0,1,1,0,7,20,3,4,7,-3,0,1,1,-1,1,1,3,1
KR_6686594104,420,1,44,-3,-1,-1,1,2,-1,3,4,-3,0,3,1,2,1,3,4,1,0,0,-141,-2,6,4,3,0,1,-1,-1,1,-1,3,1
KR_6763220066,440,2,20,18,0,-1,1,2,-1,1,2,0,3,3,0,0,0,2,3,1,0,2,12,4,6,10,1,0,2,1,1,1,-1,4,1
KR_6688375434,440,2,33,32,7,0,0,0,3,6,3,1,2,1,-1,2,3,4,5,1,0,13,0,-6,10,4,7,0,1,-1,1,1,-1,4,1
KR_6740146293,420,5,-5,16,10,0,3,3,7,7,0,3,3,0,-1,2,3,1,3,2,0,16,-44,-1,7,6,26,0,2,1,1,1,1,4,1
KR_6737952485,420,0,-7,10,-1,2,4,2,-3,3,6,0,2,2,-1,2,3,1,2,1,0,-2,9,4,1,5,-4,0,0,1,1,0,-1,1,1
KR_6758150931,420,3,17,11,3,4,6,2,1,2,1,2,2,0,-5,2,7,1,1,0,0,-5,8,3,1,4,2,0,2,1,1,1,1,3,1
KR_6743110480,440,-5,-21,-18,-6,-2,0,2,-2,0,2,1,5,4,-4,5,9,1,1,0,0,-12,-3,1,6,7,0,0,-1,0,1,-1,-1,0,1
KR_6702179080,440,3,4,4,13,1,1,0,4,6,2,4,5,1,4,5,1,0,0,0,1,14,-67,2,4,6,-1,0,1,1,1,1,1,5,1
KR_6759773365,420,0,7,-12,4,0,1,1,-1,1,2,6,10,4,-2,2,4,1,1,0,1,2,74,5,2,7,-25,0,1,1,-1,1,1,2,1
KR_6280531002,420,6,66,20,6,-1,1,2,4,7,3,0,1,1,2,2,0,1,1,0,0,6,2,1,6,7,0,0,1,1,1,1,1,6,1
KR_6724574547,440,-1,-25,24,-2,4,5,1,-1,5,6,-1,2,3,-3,3,6,-1,0,1,0,-1,-285,4,2,6,-3,0,-2,0,-1,-1,-1,0,1
KR_6742092548,420,5,71,31,10,1,1,0,6,8,2,1,1,0,4,5,1,-2,0,2,2,15,34,-3,8,5,5,0,2,1,1,1,-1,6,1
KR_6633198776,420,2,40,32,5,-2,1,3,-1,4,5,3,4,1,4,8,4,1,2,1,0,-2,-4,-3,6,3,8,0,0,-1,1,0,1,3,1
KR_6712498548,420,5,74,6,12,2,4,2,1,1,0,5,8,3,5,6,1,-1,0,1,0,10,23,-5,7,2,4,0,2,1,-1,1,-1,4,1
KR_6725529690,420,4,126,8,8,3,5,2,0,2,2,1,1,0,1,3,2,3,4,1,0,1,-1,-7,10,3,2,0,1,-1,-1,1,1,1,1
KR_6727165051,420,-2,22,19,-3,1,2,1,-7,1,8,1,1,0,4,5,1,-2,1,3,0,-8,4,1,3,4,1,0,-1,1,-1,1,1,4,1
KR_6764616082,420,3,79,8,12,3,3,0,1,1,0,9,10,1,-2,1,3,1,2,1,3,22,25,1,2,3,-1,0,1,1,-1,1,1,4,1
KR_6650570118,420,-1,29,-15,1,-1,0,1,1,4,3,0,2,2,-1,0,1,2,2,0,0,5,0,-7,13,6,4,0,0,-1,-1,0,1,3,1
KR_6765706240,440,4,90,16,2,-2,0,2,2,2,0,2,3,1,3,4,1,-3,1,4,-1,1,-15,-2,9,7,0,0,2,0,-1,1,-1,0,1
KR_6685516551,420,4,45,0,0,2,4,2,-3,2,5,2,3,1,-4,0,4,3,3,0,0,0,-4,-3,7,4,2,0,1,1,1,1,1,1,1
KR_6759040469,420,1,37,32,5,-2,0,2,2,4,2,0,2,2,5,6,1,0,0,0,0,9,-3,-1,7,6,-1,0,1,1,1,1,-1,3,1
KR_6738366079,420,-2,35,-20,-7,-4,1,5,-1,2,3,-2,0,2,0,3,3,0,0,0,-1,-8,2,0,8,8,-8,0,0,-1,1,0,-1,2,1
KR_6637176957,420,5,93,-4,13,1,1,0,0,4,4,5,5,0,6,8,2,1,2,1,0,14,6,2,5,7,2,0,3,-1,-1,1,1,6,1
KR_6725148727,420,5,1,12,12,9,10,1,2,3,1,1,1,0,-1,0,1,1,1,0,0,3,4,-1,4,3,-4,0,1,1,-1,1,1,6,1
KR_6760570102,420,3,63,12,10,2,5,3,3,5,2,3,3,0,-1,2,3,3,7,4,0,9,-3,2,2,4,0,0,2,1,1,1,1,4,1
KR_6649771682,420,0,37,12,0,1,3,2,-3,1,4,-1,1,2,3,6,3,0,0,0,0,-3,0,1,5,6,-1,0,0,-1,-1,0,-1,3,1
KR_6765122812,420,1,-10,-7,1,1,3,2,0,3,3,-3,0,3,2,7,5,1,1,0,0,-3,-1,2,6,8,2,0,0,-1,1,0,1,1,1
KR_6745397623,420,4,30,18,9,9,9,0,5,5,0,-2,1,3,-4,0,4,1,1,0,0,1,-2,1,4,5,-1,0,0,-1,1,1,1,6,1
KR_6764562804,420,-1,54,32,-4,-2,1,3,1,3,2,0,0,0,-5,0,5,2,5,3,0,-1,-16,-5,10,5,3,0,1,1,1,1,1,2,1
KR_6764279081,420,7,229,18,18,-1,2,3,11,11,0,-6,1,7,13,13,0,1,2,1,2,20,11,0,2,2,0,0,3,1,-1,1,1,5,1
KR_6764258100,440,7,78,1,18,6,9,3,-1,0,1,5,7,2,1,5,4,7,8,1,-2,6,0,-3,6,3,1,0,3,1,-1,1,-1,2,1
KR_6758756272,420,1,0,4,-4,-5,2,7,-1,4,5,-1,2,3,4,4,0,-1,0,1,-1,-5,154,-4,7,3,5,0,1,0,1,1,-1,0,1
KR_6721642001,420,5,53,28,13,4,4,0,2,3,1,-1,0,1,8,8,0,0,0,0,1,22,5,-2,7,5,7,0,1,1,-1,1,1,6,1
KR_6760861662,440,3,33,24,4,2,3,1,2,3,1,2,3,1,1,3,2,-3,1,4,0,-3,-6,-7,9,2,7,0,1,1,-1,1,1,1,1
KR_6730358023,420,4,93,1,6,0,1,1,0,2,2,3,5,2,3,5,2,0,0,0,0,0,-8,-4,10,6,1,0,0,1,1,1,1,1,1
KR_6749647675,420,5,72,12,8,2,2,0,4,4,0,-1,5,6,3,5,2,0,2,2,-1,-8,-7,-4,6,2,5,0,-1,-1,1,-1,-1,2,1
KR_6642889991,420,2,62,2,11,4,4,0,0,3,3,2,2,0,3,6,3,2,2,0,2,12,0,2,5,7,1,0,2,-1,1,1,1,4,1
KR_6678164293,420,-2,-52,-12,-4,-2,1,3,-1,2,3,1,5,4,-1,2,3,-1,0,1,0,-4,135,1,5,6,2,0,0,1,-1,0,-1,2,1
KR_6705762525,440,-3,96,2,-3,-2,1,3,4,9,5,2,4,2,-8,2,10,1,1,0,0,-8,-3,-1,10,9,1,0,1,1,-1,1,1,4,1
KR_6697202229,420,2,8,3,9,0,1,1,0,5,5,4,5,1,1,3,2,4,4,0,-1,3,0,4,3,7,0,0,-1,-1,-1,-1,-1,3,1
KR_6733159765,420,1,16,4,4,3,3,0,0,4,4,-1,1,2,1,2,1,1,2,1,0,3,-3,-2,6,4,5,0,0,-1,-1,0,1,2,1
KR_6761742524,420,2,43,38,5,-2,2,4,2,4,2,0,2,2,2,4,2,3,3,0,0,10,38,-4,8,4,1,0,0,0,0,1,1,0,1
KR_6725986673,440,0,67,33,0,1,4,3,5,6,1,1,3,2,-3,2,5,-4,0,4,0,-7,3,4,5,9,0,0,1,-1,1,1,-1,2,1
KR_6702698771,420,-1,-36,24,2,-3,0,3,3,9,6,5,5,0,-3,1,4,0,1,1,0,0,-6,1,4,5,2,0,0,-1,1,0,1,1,1
KR_6698171975,420,5,-9,16,10,2,3,1,5,6,1,2,2,0,3,4,1,-2,1,3,0,8,32,4,4,8,-2,0,0,-1,1,1,1,2,1
KR_6711431330,420,3,50,-20,12,-1,0,1,4,6,2,1,2,1,3,4,1,5,5,0,0,9,-100,1,4,5,3,0,2,1,1,1,1,1,1
KR_6693035867,420,-3,-3,-27,-6,3,4,1,-4,0,4,-1,3,4,-6,0,6,2,2,0,0,-3,-11,1,6,7,3,0,0,0,1,1,-1,0,1
KR_6764280695,420,2,67,-10,0,1,2,1,-4,1,5,1,4,3,-1,3,4,3,4,1,0,-1,39,1,4,5,-18,0,1,1,1,1,-1,5,1
KR_6734360812,420,-1,58,-16,-3,2,5,3,1,5,4,-1,4,5,-4,3,7,-1,1,2,-1,-11,-17,0,4,4,2,0,1,-1,1,1,-1,1,1
KR_6758127349,420,1,16,-4,7,1,1,0,-1,1,2,5,6,1,-1,4,5,3,3,0,0,10,12,6,2,8,2,0,1,-1,-1,1,1,1,1
KR_6683712022,420,0,36,-20,2,-3,1,4,2,2,0,4,4,0,-4,1,5,3,3,0,0,7,6,-11,12,1,6,0,0,-1,-1,0,-1,3,1
KR_6419111160,420,5,54,21,5,8,8,0,-1,5,6,-3,1,4,0,2,2,1,1,0,0,1,10,6,3,9,3,0,1,1,1,1,1,4,1
KR_6485264718,420,1,-7,9,4,0,1,1,6,8,2,-4,2,6,3,3,0,-1,0,1,0,0,9,1,7,8,-3,0,0,1,1,0,-1,1,1
KR_6736512221,420,3,48,-32,15,3,4,1,4,7,3,4,6,2,3,3,0,1,1,0,0,8,-6,1,4,5,0,0,2,1,1,1,1,5,1
KR_6700551722,420,0,57,-10,0,-7,1,8,4,5,1,6,8,2,0,3,3,-3,0,3,0,-4,13,1,4,5,-6,0,1,-1,-1,1,-1,5,1
KR_6727727677,420,-2,59,32,-3,-4,1,5,2,5,3,1,2,1,-3,2,5,1,4,3,0,-7,-14,-3,4,1,4,0,1,1,1,1,1,3,1
KR_6703187591,440,-5,-115,-8,-8,-6,0,6,2,4,2,-1,2,3,3,3,0,-6,0,6,0,-2,1,1,2,3,-5,0,-1,1,0,-1,-1,1,1
KR_6758872930,440,3,41,16,7,0,0,0,1,2,1,4,5,1,3,5,2,-1,0,1,0,2,7,8,2,10,-4,0,2,1,1,1,1,4,1
KR_6713150584,420,3,20,9,9,2,3,1,-1,0,1,2,3,1,1,2,1,5,5,0,1,10,7,5,1,6,1,0,0,1,1,-1,1,5,1
KR_6761307370,420,1,52,-15,-2,3,4,1,3,6,3,-1,2,3,-3,2,5,-4,0,4,0,-6,5,3,2,5,-2,0,-1,-1,-1,-1,-1,6,1
KR_6765126129,420,1,-48,-2,5,2,3,1,-5,0,5,10,10,0,-5,0,5,3,3,0,-1,3,16,-1,8,7,3,0,2,-1,1,1,-1,6,1
KR_6655474760,420,3,47,36,1,2,2,0,0,1,1,-1,4,5,0,2,2,0,0,0,0,1,-5,-2,5,3,4,0,1,1,1,1,-1,4,1
KR_6624147938,420,2,-17,5,0,-1,2,3,3,6,3,-3,2,5,3,4,1,-2,2,4,-3,1,2,2,2,4,5,0,0,1,-1,1,-1,1,1
KR_6753320604,420,2,8,-8,5,-1,0,1,5,5,0,-1,2,3,2,2,0,0,0,0,0,9,6,4,3,7,-2,0,0,0,-1,0,1,0,1
KR_6729806862,440,1,34,23,5,2,5,3,1,2,1,-1,1,2,3,3,0,0,1,1,0,3,-7,1,2,3,0,0,0,1,-1,0,1,1,1
KR_6748532389,420,2,19,8,7,0,1,1,3,3,0,4,4,0,1,2,1,-1,0,1,0,9,3,6,2,8,3,0,1,1,1,1,1,5,1
KR_6758162935,420,6,88,7,17,2,6,4,0,2,2,2,5,3,12,12,0,1,1,0,0,14,10,3,1,4,3,0,2,1,1,1,1,5,1
KR_6435326906,420,0,-14,19,3,-3,2,5,-2,3,5,5,5,0,2,2,0,1,3,2,0,0,-20,2,2,4,5,0,0,-1,0,1,1,5,1
KR_6764434398,420,1,5,20,3,-1,0,1,2,3,1,-2,0,2,1,1,0,3,4,1,0,8,0,2,2,4,-1,0,0,1,-1,0,1,6,1
KR_6765968529,440,0,-1,-8,-1,0,0,0,-1,1,2,1,2,1,-1,1,2,0,1,1,0,2,1,-1,5,4,5,0,1,1,-1,1,1,1,1
KR_6764466998,420,3,61,-8,11,4,5,1,0,0,0,5,5,0,3,4,1,-1,1,2,2,5,71,1,4,5,2,0,0,1,1,1,1,3,1
KR_6701697757,420,4,34,34,7,3,5,2,-1,1,2,2,4,2,0,3,3,3,3,0,1,5,-20,2,3,5,4,0,0,1,1,1,1,4,1
KR_6764593514,420,-1,63,-34,-1,4,6,2,-1,1,2,-1,1,2,-2,0,2,-1,0,1,-1,-6,-5,-1,5,4,-2,0,1,-1,-1,1,-1,1,1
KR_6763799233,420,-1,13,17,-2,2,3,1,0,1,1,-3,1,4,-1,2,3,0,0,0,0,-2,-6,1,6,7,1,0,-1,0,-1,-1,1,0,1
KR_6728506178,420,3,89,4,11,5,7,2,2,3,1,1,1,0,1,4,3,2,2,0,0,7,115,1,3,4,1,0,3,1,-1,1,1,4,1
KR_6735594378,440,3,-30,-8,7,5,8,3,5,6,1,-2,0,2,-2,2,4,1,2,1,-1,0,-20,5,3,8,0,0,0,1,-1,1,-1,2,1
KR_6736741188,420,0,57,23,1,0,0,0,-1,0,1,-3,2,5,3,4,1,2,4,2,0,3,6,-1,7,6,-1,0,0,1,-1,1,-1,5,1
KR_6716705521,420,-4,-28,-17,-3,-6,0,6,-2,4,6,2,3,1,2,4,2,1,1,0,0,3,-7,-5,7,2,0,0,1,1,-1,1,-1,3,1
KR_6693174453,420,3,-29,-20,4,1,2,1,0,3,3,3,5,2,0,3,3,0,0,0,0,4,-1,2,2,4,-1,0,1,1,1,1,-1,3,1
KR_6757650831,420,0,26,-7,4,2,5,3,1,3,2,2,3,1,0,2,2,-1,2,3,1,7,81,4,1,5,1,0,1,-1,1,1,1,6,1
KR_6703148206,420,2,13,16,10,2,2,0,1,1,0,1,2,1,4,5,1,2,2,0,0,8,-34,-1,9,8,1,0,0,1,1,0,1,5,1
KR_6618147890,420,1,41,4,0,0,1,1,-2,3,5,5,7,2,1,4,3,-4,1,5,-1,-4,0,-2,4,2,-2,0,2,-1,-1,1,-1,1,1
KR_6598015164,420,6,52,-21,16,7,7,0,5,6,1,0,0,0,3,7,4,1,1,0,0,16,-10,-1,7,6,2,0,2,-1,-1,1,1,4,1
KR_6740956841,420,2,36,-7,4,3,3,0,1,2,1,-2,1,3,2,4,2,0,1,1,1,6,14,4,2,6,-3,0,0,-1,-1,0,1,5,1
KR_6698460795,440,0,32,0,4,0,0,0,-2,3,5,0,2,2,5,6,1,1,1,0,0,3,-28,0,4,4,4,0,0,1,-1,1,-1,3,1
KR_6715957758,420,0,77,8,-4,2,4,2,-1,2,3,0,1,1,-5,0,5,0,0,0,0,-10,-2,-1,3,2,-1,0,1,-1,1,1,1,4,1
KR_6727939943,420,6,-7,20,18,0,1,1,0,3,3,5,6,1,10,12,2,3,4,1,0,17,11,1,4,5,-5,0,1,1,1,1,1,4,1
KR_6566944133,440,4,31,-11,7,6,8,2,-3,1,4,-1,3,4,6,8,2,-1,1,2,1,7,-14,0,3,3,3,0,0,-1,1,1,1,4,1
KR_6649816055,420,3,33,4,9,5,5,0,0,3,3,4,4,0,1,2,1,-1,0,1,1,3,7,1,4,5,-1,0,0,-1,1,0,1,5,1
KR_6671053600,420,3,-5,40,2,-3,2,5,0,2,2,-2,3,5,2,4,2,5,5,0,0,4,7,-4,5,1,-1,0,1,-1,1,1,-1,2,1
KR_6708290290,420,4,-2,0,10,4,6,2,0,4,4,-1,0,1,4,6,2,3,4,1,0,9,-3,0,3,3,4,0,0,1,-1,0,1,3,1
KR_6754535299,420,0,63,2,4,1,1,0,-2,2,4,1,3,2,4,5,1,0,1,1,0,-3,-6,-6,8,2,0,0,0,0,1,1,-1,0,1
KR_6712424775,420,2,59,10,2,-2,2,4,3,6,3,-1,3,4,2,3,1,0,0,0,1,4,6,2,5,7,1,0,1,0,-1,1,1,0,1
KR_6729478790,420,1,7,7,1,1,3,2,-1,2,3,1,2,1,-1,4,5,1,2,1,0,-1,7,-1,8,7,-1,0,0,1,1,1,1,5,1
KR_6740860144,420,3,13,0,8,1,2,1,7,9,2,2,2,0,-2,2,4,0,0,0,1,5,12,-4,8,4,-3,0,1,-1,1,1,1,3,1
KR_6747715459,420,5,36,28,8,4,4,0,4,7,3,0,2,2,2,2,0,-2,0,2,0,5,-2,2,2,4,2,0,2,1,1,1,1,3,1
KR_6749774010,420,2,26,21,6,2,8,6,1,2,1,3,4,1,0,2,2,0,1,1,0,8,3,0,4,4,3,0,2,1,0,1,-1,2,1
KR_6762657698,420,0,32,-28,1,7,7,0,-1,1,2,0,0,0,-5,0,5,0,1,1,0,-3,102,-3,5,2,1,0,0,-1,1,0,-1,2,1
KR_6745183290,420,3,73,-6,8,7,7,0,0,2,2,-2,0,2,3,4,1,0,2,2,1,5,24,0,3,3,1,0,1,0,1,1,1,0,1
KR_6634914296,420,2,7,24,4,0,2,2,1,5,4,-2,1,3,7,7,0,-2,1,3,1,14,53,-4,9,5,-2,0,-1,-1,-1,-1,1,4,1
KR_6680891596,420,2,49,4,5,0,3,3,5,5,0,0,4,4,1,3,2,-1,1,2,1,7,-22,3,5,8,6,0,1,-1,1,1,1,6,1
KR_6622463659,420,-1,38,12,1,-1,1,2,0,3,3,1,3,2,1,3,2,0,1,1,0,7,-31,4,5,9,1,0,0,-1,-1,0,1,3,1
KR_6748746003,420,-1,-71,14,-7,1,3,2,-2,3,5,-6,1,7,0,3,3,0,1,1,0,-5,0,-2,2,0,0,0,-1,1,1,1,-1,2,1
KR_6742932505,420,2,9,-16,3,-1,1,2,0,0,0,4,8,4,-3,1,4,3,3,0,0,6,-10,-3,6,3,3,0,0,-1,-1,0,-1,5,1
KR_6757940846,420,1,5,13,3,-3,1,4,2,2,0,2,4,2,1,2,1,1,1,0,0,7,7,2,5,7,-7,0,1,1,1,1,1,2,1
KR_6696981477,420,3,-9,-5,7,-3,2,5,5,8,3,6,6,0,0,2,2,-1,0,1,0,8,-143,1,3,4,2,0,0,1,0,0,1,4,1
KR_6766418589,420,0,2,-12,-1,-3,1,4,1,2,1,2,3,1,0,3,3,-1,0,1,0,4,4,7,2,9,4,0,0,-1,1,-1,-1,4,1
KR_6698209847,420,3,56,0,2,2,4,2,2,5,3,-3,2,5,1,4,3,0,1,1,1,-3,14,0,3,3,-3,0,1,1,-1,1,1,3,1
KR_6758779289,420,0,12,-35,0,3,7,4,0,0,0,0,1,1,-4,0,4,1,1,0,0,-4,-6,1,4,5,-1,0,2,-1,1,1,1,6,1
KR_6628982671,420,0,-36,14,0,-4,1,5,0,3,3,-2,0,2,5,7,2,1,1,0,0,5,-2,-4,7,3,-2,0,0,-1,0,1,-1,4,1
KR_6697557087,420,3,87,-17,4,-1,0,1,-2,1,3,1,1,0,2,2,0,4,4,0,0,4,43,-3,7,4,2,0,1,0,1,1,1,0,1
KR_6766438565,440,4,70,40,0,-1,2,3,0,2,2,1,2,1,1,6,5,-1,0,1,0,-6,-25,-2,3,1,1,0,1,1,-1,1,-1,4,1
KR_6762115908,420,1,28,-12,3,1,6,5,1,4,3,6,10,4,-2,6,8,-3,0,3,1,13,9,2,2,4,-5,0,0,1,-1,1,1,6,1
KR_6275104789,420,1,-39,-29,11,3,3,0,-1,0,1,2,2,0,3,5,2,4,5,1,0,6,7,3,7,10,-3,0,1,-1,1,1,1,6,1
KR_6755197617,420,-2,-14,-17,-5,0,1,1,3,4,1,0,0,0,-8,0,8,0,0,0,-1,-8,-56,-2,4,2,3,0,-1,-1,1,-1,-1,6,1
KR_6555655143,420,0,52,23,0,2,2,0,3,3,0,-1,1,2,-1,1,2,-3,0,3,0,-3,-6,-3,8,5,3,0,0,1,1,1,1,6,1
KR_6749148662,420,1,-1,15,6,4,5,1,6,7,1,0,2,2,-6,3,9,2,3,1,-1,-2,6,4,5,9,-4,0,3,1,1,1,-1,5,1
KR_6746199766,440,-4,-41,-26,-4,-1,0,1,3,4,1,1,3,2,-1,2,3,-6,0,6,0,1,-15,-6,10,4,1,0,-2,-1,-1,-1,1,5,1
KR_6740403452,420,-4,-83,8,-5,-1,0,1,0,1,1,2,3,1,-7,0,7,1,3,2,0,0,13,2,2,4,-1,0,-3,1,-1,-1,-1,3,1
KR_6743977564,420,1,77,-8,2,-3,1,4,1,4,3,-1,1,2,6,8,2,-1,1,2,-1,2,-13,-1,7,6,0,0,0,1,-1,1,-1,2,1
KR_6679459268,420,0,9,4,1,2,2,0,3,5,2,-2,1,3,-1,4,5,-1,0,1,0,2,25,0,6,6,-4,0,0,1,-1,0,1,6,1
KR_6680124880,420,1,-26,20,4,-2,2,4,-4,2,6,4,5,1,0,2,2,6,7,1,-1,5,5,-1,7,6,3,0,-1,1,-1,-1,-1,2,1
KR_6758069111,420,0,23,4,5,0,1,1,4,5,1,-1,6,7,2,2,0,0,2,2,0,7,-10,3,0,3,1,0,0,0,-1,0,1,0,1
KR_6761531924,420,0,21,-34,6,-5,0,5,-1,0,1,2,4,2,10,11,1,0,0,0,0,21,8,0,7,7,-1,0,0,-1,-1,-1,1,6,1
KR_6758843237,420,3,-4,17,1,0,1,1,4,4,0,2,4,2,-4,0,4,-1,0,1,0,7,0,-2,3,1,-1,0,0,1,-1,0,-1,6,1
KR_6766545487,420,3,32,26,6,0,0,0,1,2,1,-1,1,2,7,8,1,-1,1,2,0,9,-7,-1,6,5,1,0,0,1,-1,0,1,1,1
KR_6686940736,420,-1,-40,-22,1,-1,1,2,2,4,2,0,3,3,0,4,4,0,0,0,0,14,155,1,7,8,-7,0,0,1,1,0,-1,3,1
KR_6692962212,440,0,-5,0,-3,-5,2,7,-5,0,5,5,6,1,1,2,1,1,2,1,0,-10,-6,-1,7,6,0,0,0,0,1,-1,1,0,1
KR_6738495293,420,-4,-68,-16,-5,-2,3,5,2,5,3,-7,2,9,1,2,1,1,1,0,1,-2,3,2,4,6,1,0,-2,0,-1,-1,1,0,1
KR_6722792524,420,5,60,30,8,3,3,0,3,3,0,4,4,0,0,3,3,-2,7,9,0,8,13,5,1,6,-2,0,2,-1,1,1,1,1,1
KR_6763169162,440,5,31,16,12,4,6,2,0,3,3,-2,0,2,9,12,3,1,3,2,0,13,11,0,1,1,1,0,3,0,0,1,1,0,1
KR_6734639711,440,3,-27,16,4,-1,1,2,0,4,4,-1,2,3,3,3,0,3,4,1,0,4,30,0,3,3,-9,0,1,1,-1,-1,1,6,1
KR_6611550223,420,2,3,-16,7,0,0,0,1,1,0,2,2,0,4,5,1,0,1,1,0,7,-180,3,5,8,1,0,-1,1,-1,-1,1,4,1
KR_6272719929,420,3,30,0,7,6,6,0,6,7,1,-2,3,5,-3,0,3,0,1,1,0,6,-5,-2,6,4,10,0,2,1,1,1,1,3,1
KR_6749433270,420,1,-13,16,4,2,2,0,-2,3,5,2,2,0,-1,2,3,3,4,1,0,7,23,0,4,4,-1,0,1,-1,1,1,-1,1,1
KR_6762162261,420,-1,35,-28,3,0,2,2,1,1,0,0,1,1,1,2,1,1,1,0,0,2,-1,-2,6,4,5,0,0,-1,1,-1,1,6,1
KR_6715423472,420,4,111,3,6,0,2,2,2,2,0,0,3,3,3,6,3,1,2,1,0,5,4,3,2,5,0,0,0,-1,-1,-1,-1,2,1
KR_6723909268,420,4,2,-8,8,1,2,1,-3,2,5,4,4,0,3,4,1,3,3,0,0,7,36,5,3,8,-13,0,1,-1,1,1,-1,3,1
KR_6751178152,420,-1,-61,63,1,3,5,2,-2,2,4,3,5,2,0,1,1,-3,0,3,1,-7,-36,-1,6,5,0,0,0,1,-1,0,1,5,1
KR_6766298671,420,-3,-36,-11,-6,-4,1,5,-2,0,2,-1,0,1,2,2,0,-1,0,1,0,-8,0,1,5,6,0,0,1,0,1,1,1,0,1
KR_6762637317,420,2,28,8,5,-1,4,5,0,4,4,1,3,2,5,7,2,0,1,1,-1,-1,3,-2,6,4,2,0,1,-1,-1,1,-1,2,1
KR_6755951378,420,4,52,14,5,0,2,2,4,5,1,2,3,1,1,7,6,-2,0,2,3,10,10,1,3,4,0,0,3,1,1,1,1,6,1
KR_6760172920,420,-1,-49,-14,-4,-2,3,5,3,5,2,0,2,2,-4,0,4,-1,1,2,0,6,-6,-2,4,2,2,0,-4,0,-1,-1,1,0,1
KR_6705756327,420,4,127,-6,7,6,6,0,0,3,3,4,6,2,0,2,2,-3,0,3,0,-2,8,-1,4,3,2,0,2,-1,0,1,1,4,1
KR_6648720099,420,2,73,-33,6,-1,1,2,-1,2,3,5,5,0,2,5,3,1,1,0,0,9,2,-3,8,5,6,0,0,0,1,1,1,0,1
KR_6760681596,440,4,74,-15,9,2,3,1,5,6,1,4,4,0,-2,1,3,0,1,1,1,8,9,2,2,4,-2,0,2,1,-1,1,1,2,1
KR_6756192462,440,3,-25,8,8,1,4,3,2,2,0,-1,3,4,0,3,3,6,7,1,1,10,61,1,3,4,0,0,1,0,0,1,1,0,1
KR_6702965916,420,2,-21,28,7,3,4,1,2,2,0,6,6,0,-5,1,6,1,1,0,0,14,7,6,5,11,2,0,0,1,1,0,-1,4,1
KR_6727993383,420,5,72,-8,9,6,7,1,3,9,6,1,3,2,3,5,2,-4,0,4,-1,9,-2,2,2,4,-2,0,1,1,-1,-1,-1,2,1
KR_6649153969,420,-1,8,22,-1,1,4,3,0,3,3,0,5,5,-2,0,2,0,1,1,0,-5,-91,5,5,10,-2,0,0,1,1,1,-1,1,1
KR_6760153908,420,-2,16,4,0,-1,0,1,-1,2,3,2,5,3,1,4,3,-1,1,2,0,-3,40,0,4,4,-8,0,1,-1,1,1,1,5,1
KR_6760307978,420,1,-2,6,7,0,2,2,2,4,2,-1,1,2,5,7,2,1,2,1,-1,11,-1,3,4,7,5,0,2,-1,1,1,-1,6,1
KR_6752711405,420,6,106,13,19,3,5,2,2,3,1,1,2,1,13,15,2,0,1,1,0,19,4,1,5,6,4,0,2,1,-1,1,1,5,1
KR_6743744712,440,2,13,28,4,-3,0,3,3,4,1,3,3,0,1,2,1,0,3,3,0,10,-4,2,2,4,3,0,1,1,1,1,1,2,1
KR_6270254909,420,0,-13,14,3,-1,1,2,0,2,2,-1,5,6,5,7,2,0,2,2,0,5,-19,3,3,6,2,0,0,1,-1,0,1,2,1
KR_6760858466,420,0,-3,12,4,0,1,1,4,4,0,1,6,5,-2,2,4,1,1,0,-1,1,-8,-4,6,2,4,0,0,-1,1,1,-1,2,1
KR_6688726887,420,-2,17,0,-8,-2,0,2,-3,4,7,-5,1,6,3,3,0,-1,0,1,0,-6,-11,-5,8,3,0,0,1,-1,-1,1,-1,3,1
KR_6731549216,420,4,15,28,8,4,4,0,0,1,1,0,2,2,4,5,1,0,0,0,0,3,0,-2,4,2,3,0,3,1,1,1,-1,4,1
KR_6690114234,420,3,24,4,5,0,1,1,1,5,4,3,4,1,0,3,3,1,2,1,0,11,-229,1,6,7,0,0,0,-1,-1,0,1,6,1
KR_6759682168,420,0,36,-24,-5,-2,1,3,-5,4,9,-2,1,3,5,8,3,-1,2,3,-2,-14,-25,-2,6,4,-3,0,-1,1,-1,-1,-1,2,1
KR_6619985547,420,1,-44,19,7,0,2,2,3,4,1,1,5,4,3,4,1,0,1,1,0,14,2,6,1,7,1,0,0,1,1,0,-1,5,1
KR_6731511032,440,3,-7,-40,7,1,3,2,0,4,4,3,3,0,4,6,2,-1,0,1,0,9,-6,-1,4,3,1,0,-1,1,-1,-1,1,4,1
KR_6708510168,420,0,-43,17,3,2,3,1,2,4,2,1,3,2,-2,1,3,0,2,2,0,1,22,-4,7,3,0,0,1,-1,1,1,1,4,1
KR_6755723818,420,3,-8,41,7,-5,0,5,4,5,1,3,3,0,2,3,1,3,3,0,1,13,2,-1,4,3,-1,0,0,1,0,0,1,1,1
KR_6763192048,420,-1,-19,-9,0,0,3,3,0,3,3,3,3,0,-1,1,2,-2,1,3,0,0,-4,-2,7,5,-1,0,-1,1,-1,-1,-1,1,1
KR_6603048183,420,5,-5,3,18,2,2,0,3,4,1,3,5,2,6,6,0,4,6,2,0,20,-1,1,2,3,1,0,2,1,1,1,1,6,1
KR_6728416965,440,1,111,-8,2,-1,1,2,0,2,2,0,1,1,1,2,1,2,3,1,0,5,-4,0,4,4,6,0,0,1,-1,0,1,6,1
KR_6610573431,420,2,31,-3,-2,-1,2,3,0,4,4,1,1,0,-1,2,3,-1,1,2,-1,-4,50,0,5,5,-14,0,0,-1,1,-1,-1,3,1
KR_6753077072,420,2,24,15,6,-2,2,4,-3,0,3,8,10,2,1,3,2,2,2,0,2,14,14,3,4,7,8,0,0,1,1,0,1,1,1
KR_6762903000,420,1,20,8,3,1,2,1,-2,0,2,1,2,1,1,1,0,2,2,0,0,1,5,5,2,7,1,0,0,1,-1,0,1,6,1
KR_6766161366,420,2,-12,-5,3,4,6,2,2,4,2,2,4,2,-6,1,7,1,1,0,0,4,-4,2,2,4,2,0,0,1,0,0,-1,3,1
KR_6716811236,420,4,77,-3,14,5,5,0,0,2,2,2,2,0,0,3,3,7,8,1,1,22,-111,4,2,6,6,0,1,1,1,1,1,2,1
KR_6728554629,420,5,12,40,11,-1,1,2,3,4,1,3,3,0,5,5,0,1,1,0,0,15,8,0,6,6,3,0,1,1,-1,1,1,5,1
KR_6732600889,440,-1,45,0,0,-1,3,4,6,7,1,2,2,0,1,3,2,-8,1,9,0,-4,0,3,1,4,0,0,1,1,1,1,1,6,1
KR_6746946742,420,1,2,-5,8,1,2,1,-2,3,5,0,2,2,8,11,3,1,1,0,0,10,5,0,5,5,3,0,1,1,0,1,1,2,1
KR_6744002953,420,1,9,14,0,0,1,1,3,5,2,2,2,0,-5,0,5,0,2,2,0,-3,-1,-3,7,4,6,0,-1,-1,1,-1,-1,3,1
KR_6574485495,420,1,26,8,3,-5,0,5,0,2,2,2,2,0,4,4,0,2,3,1,0,-2,4,1,5,6,0,0,0,1,-1,1,-1,6,1
KR_6761916824,440,-2,-17,-9,-6,0,2,2,1,3,2,-2,0,2,-4,1,5,-1,1,2,0,-2,0,0,3,3,3,0,0,-1,1,-1,1,3,1
KR_6700684177,420,2,16,-17,9,1,1,0,3,5,2,1,3,2,2,2,0,2,2,0,0,8,-6,0,3,3,0,0,0,-1,-1,-1,1,2,1
KR_6675622464,420,3,22,-32,5,-1,1,2,6,7,1,0,2,2,0,4,4,0,0,0,0,8,-15,-7,9,2,-1,0,0,0,0,0,1,0,1
KR_6632598820,420,2,57,-22,1,4,4,0,-2,0,2,-4,0,4,3,3,0,0,2,2,0,-4,-2,3,3,6,4,0,2,1,1,1,1,1,1
KR_6760558282,420,1,37,-20,0,-2,0,2,-1,4,5,2,4,2,1,1,0,0,1,1,0,10,-3,-2,5,3,1,0,-1,0,-1,-1,-1,0,1
KR_6747354291,440,-4,-69,4,-8,0,2,2,-7,0,7,-1,2,3,2,4,2,-2,0,2,0,-1,9,0,5,5,-2,0,-1,-1,1,-1,1,6,1
KR_6763148279,420,2,11,1,-1,-1,0,1,0,3,3,1,1,0,-1,0,1,0,1,1,0,2,5,3,5,8,8,0,1,1,1,1,-1,3,1
KR_6717502209,420,5,21,9,6,2,2,0,1,1,0,1,3,2,2,3,1,0,0,0,0,4,-5,1,4,5,1,0,0,1,1,0,1,2,1
KR_6725315612,420,1,-22,-35,-1,3,5,2,-5,3,8,2,3,1,-2,3,5,1,1,0,2,-1,180,-7,10,3,13,0,0,1,1,1,1,2,1
KR_6705670022,420,7,103,11,17,0,1,1,8,13,5,3,3,0,3,4,1,3,4,1,0,17,-6,1,3,4,8,0,1,1,-1,1,1,4,1
KR_6741962930,420,-5,-53,-35,-6,-6,1,7,-2,0,2,-3,2,5,6,6,0,-1,0,1,0,5,-12,-8,8,0,2,0,-3,1,-1,-1,-1,5,1
KR_6740284762,440,2,-40,6,8,1,2,1,1,7,6,1,2,1,5,5,0,0,1,1,0,6,17,-5,6,1,5,0,0,0,1,0,-1,0,1
KR_6750923526,440,-3,6,-8,-2,0,2,2,0,2,2,-6,0,6,0,3,3,4,4,0,1,0,4,2,1,3,-3,0,1,-1,0,1,1,1,1
KR_6724347081,420,-1,-30,-8,-3,-2,1,3,3,6,3,1,4,3,-1,0,1,-4,2,6,0,0,43,-3,4,1,-31,0,0,-1,1,0,1,6,1
KR_6676697533,420,0,7,20,-3,0,4,4,-1,1,2,0,3,3,-3,4,7,1,1,0,0,-1,-8,2,6,8,4,0,3,1,1,1,-1,1,1
KR_6762539378,420,-3,-49,-34,-3,-2,1,3,-2,3,5,1,3,2,-2,0,2,2,4,2,0,-7,-37,0,5,5,0,0,-1,-1,1,-1,-1,4,1
KR_6633449940,420,3,87,-16,10,-2,1,3,2,2,0,3,3,0,6,6,0,1,1,0,1,21,-7,-1,3,2,4,0,1,1,-1,1,1,4,1
KR_6749755665,420,1,18,0,-1,-3,0,3,-3,3,6,3,3,0,2,6,4,0,5,5,0,3,109,-1,5,4,-2,0,1,1,-1,1,-1,4,1
KR_6759503200,420,3,35,25,7,0,1,1,3,4,1,0,2,2,3,4,1,1,1,0,1,17,-1,-2,7,5,2,0,1,1,1,1,1,3,1
KR_6763873931,420,-1,-33,-12,1,0,2,2,0,1,1,-1,1,2,0,2,2,2,2,0,0,5,0,-2,6,4,-3,0,0,1,-1,-1,1,3,1
KR_6750015477,420,3,32,23,3,-2,1,3,5,7,2,3,3,0,-1,3,4,-2,2,4,-1,4,21,4,2,6,-6,0,0,-1,1,-1,-1,2,1
KR_6716615814,420,-1,43,-8,-1,0,4,4,1,2,1,-5,1,6,2,4,2,1,1,0,3,6,6,-3,5,2,1,0,1,1,-1,1,1,6,1
KR_6760370250,420,3,6,-12,9,4,4,0,-2,3,5,2,3,1,4,4,0,1,1,0,-1,10,-25,4,3,7,3,0,0,1,-1,0,-1,3,1
KR_6758236180,440,2,70,-9,3,4,5,1,-1,1,2,0,1,1,-4,1,5,4,5,1,0,-2,18,5,3,8,-1,0,2,1,-1,1,1,1,1
KR_6763910548,420,-1,7,-4,-2,1,1,0,3,3,0,-4,0,4,-4,1,5,2,3,1,0,-2,-2,-5,6,1,3,0,-1,1,-1,-1,-1,4,1
KR_6749458041,420,-1,-38,-11,4,0,3,3,1,4,3,4,6,2,-1,0,1,0,0,0,0,-3,369,-4,6,2,-1,0,-1,1,-1,-1,1,5,1
KR_6617672099,420,1,5,-16,3,1,2,1,-3,1,4,5,5,0,1,2,1,-1,0,1,0,0,0,1,4,5,1,0,0,-1,-1,0,1,5,1
KR_6736818635,420,0,15,-12,-1,2,3,1,-1,3,4,3,3,0,-3,1,4,-2,0,2,0,-2,10,3,7,10,-6,0,1,1,1,1,-1,6,1
KR_6742014607,420,-2,-6,24,-6,1,2,1,1,4,3,-2,0,2,-3,1,4,-3,0,3,1,-11,6,1,9,10,-6,0,0,-1,-1,0,1,5,1
KR_6758631752,420,3,17,33,12,0,3,3,7,9,2,0,4,4,4,5,1,1,1,0,0,-1,-23,2,5,7,-4,0,1,1,-1,-1,1,4,1
KR_6683116376,420,-3,0,0,-12,-2,2,4,0,4,4,-3,5,8,-4,2,6,-3,2,5,0,-8,0,-2,10,8,-3,0,0,-1,1,0,-1,4,1
KR_6760522152,420,-2,-18,-50,-2,-3,2,5,3,4,1,1,2,1,-3,3,6,0,0,0,0,-1,126,-1,4,3,0,0,1,-1,1,1,-1,6,1
KR_6746604952,420,2,55,0,7,3,4,1,6,9,3,0,3,3,-3,0,3,1,2,1,1,17,6,0,5,5,-1,0,1,1,-1,1,1,2,1
KR_6706880331,420,0,-12,-12,-5,0,1,1,-2,3,5,-1,0,1,-2,2,4,0,0,0,0,-10,-7,-1,6,5,4,0,0,-1,-1,0,-1,4,1
KR_6756274198,420,-1,-47,-2,-5,-1,1,2,-2,2,4,0,2,2,0,7,7,-2,0,2,0,1,16,-1,6,5,-4,0,-1,0,-1,-1,-1,0,1
KR_6759517370,420,-3,-45,-21,-7,0,3,3,0,2,2,-1,1,2,-3,0,3,-3,2,5,0,-6,0,-1,7,6,-4,0,0,-1,1,1,-1,5,1
KR_6726325163,420,7,75,-1,16,7,7,0,1,4,3,4,4,0,3,6,3,1,1,0,0,13,-34,1,5,6,7,0,3,-1,1,1,-1,6,1
KR_6765536285,420,2,83,-19,0,1,1,0,-1,5,6,0,2,2,0,2,2,0,2,2,1,6,11,-2,5,3,6,0,0,0,-1,1,1,0,1
KR_6759647234,420,7,94,41,11,2,2,0,1,1,0,3,4,1,3,7,4,2,3,1,0,14,6,-2,7,5,5,0,2,1,-1,1,-1,3,1
KR_6744574365,420,2,33,4,1,3,5,2,-8,2,10,5,8,3,0,2,2,1,1,0,0,6,4,2,5,7,6,0,0,-1,-1,0,-1,3,1
KR_6689949320,420,1,32,-17,1,3,4,1,0,1,1,-4,1,5,-1,0,1,3,3,0,0,-1,6,2,4,6,-2,0,1,-1,1,1,-1,6,1
KR_6601705234,420,2,29,1,1,-4,0,4,1,2,1,2,3,1,2,3,1,0,0,0,0,2,47,-5,14,9,1,0,0,-1,1,1,1,2,1
KR_6764869775,420,1,45,6,4,-1,3,4,5,5,0,-3,2,5,3,4,1,0,2,2,0,13,212,0,6,6,6,0,-2,1,-1,-1,1,1,1
KR_6644467462,420,4,39,40,9,2,3,1,2,4,2,1,5,4,4,6,2,0,0,0,0,3,14,0,7,7,3,0,0,1,0,1,1,6,1
KR_6717648211,420,5,82,-11,6,5,5,0,-2,1,3,-2,1,3,4,11,7,1,1,0,0,7,2,2,4,6,3,0,1,1,0,1,-1,3,1
KR_6763777835,420,3,58,8,12,4,5,1,1,2,1,-1,2,3,7,7,0,1,2,1,1,17,14,11,1,12,-1,0,0,1,1,1,1,4,1
KR_6645397831,420,2,64,-11,1,1,4,3,-2,1,3,-5,1,6,6,6,0,1,1,0,0,2,1,-5,12,7,1,0,2,-1,-1,1,1,4,1
KR_6750691315,420,1,40,22,6,-2,0,2,3,4,1,2,4,2,6,10,4,-3,4,7,0,5,-111,-5,9,4,5,0,-1,1,-1,1,1,4,1
KR_6760045269,420,2,-15,32,1,4,5,1,1,4,3,-2,1,3,-2,1,3,0,1,1,0,7,2,5,3,8,0,0,1,1,1,1,-1,2,1
KR_6491892115,420,2,41,-4,2,3,3,0,-1,1,2,1,3,2,-3,2,5,2,2,0,0,-6,0,-1,7,6,-3,0,0,1,1,0,-1,2,1
KR_6700592558,420,-2,24,-20,-6,-2,0,2,-3,0,3,2,3,1,0,3,3,-3,0,3,0,-6,-6,-3,5,2,1,0,0,0,-1,-1,-1,0,1
KR_6764041573,440,1,-18,-4,0,1,1,0,5,6,1,-2,3,5,2,2,0,-6,0,6,0,1,2,4,3,7,-3,0,0,-1,1,1,-1,3,1
KR_6696010084,420,5,63,26,14,6,7,1,2,3,1,5,5,0,2,4,2,-1,2,3,0,8,353,-2,8,6,-3,0,0,1,1,0,1,1,1
KR_6766181531,420,3,10,10,0,-5,0,5,2,3,1,3,7,4,-2,0,2,2,3,1,1,-3,-12,-3,8,5,1,0,2,0,1,1,1,0,1
KR_6756147506,420,-1,35,3,1,4,6,2,2,4,2,5,6,1,-8,0,8,-2,1,3,0,-5,0,0,7,7,-7,0,2,-1,1,1,1,6,1
KR_6654561458,440,0,-1,-10,-3,-1,0,1,0,3,3,-1,1,2,-2,2,4,1,1,0,0,-1,6,0,5,5,2,0,2,-1,1,1,-1,6,1
KR_6735329263,420,-1,30,13,-1,0,0,0,0,1,1,6,6,0,-4,1,5,-3,0,3,0,-6,24,1,5,6,-16,0,1,1,1,1,-1,3,1
KR_6756119830,420,2,27,-24,1,0,2,2,0,2,2,2,4,2,-1,2,3,0,0,0,0,2,-19,2,2,4,3,0,0,-1,1,0,1,4,1
KR_6746875396,420,-3,-67,-15,-4,7,7,0,-5,2,7,-7,1,8,0,4,4,1,1,0,0,-9,-7,2,3,5,-4,0,0,1,1,1,1,4,1
KR_6659328576,420,1,61,38,-4,-1,2,3,0,5,5,1,2,1,-3,0,3,-1,0,1,-1,-5,0,-4,9,5,-4,0,0,1,1,1,-1,6,1
KR_6760388634,420,-1,10,-3,1,1,2,1,2,3,1,-2,1,3,2,8,6,-2,0,2,2,2,-265,-4,9,5,0,0,0,1,0,-1,1,2,1
KR_6651183427,420,0,-23,-17,2,0,0,0,-4,2,6,3,3,0,3,4,1,0,0,0,0,1,-2,-3,6,3,3,0,0,-1,-1,0,1,1,1
KR_6678875425,420,-2,18,-16,0,2,2,0,-2,1,3,2,2,0,-1,2,3,-1,0,1,0,2,-8,1,8,9,3,0,1,-1,-1,1,1,6,1
KR_6766207881,420,2,39,4,6,0,1,1,2,3,1,0,2,2,1,2,1,3,3,0,0,0,8,3,3,6,2,0,0,0,-1,0,1,0,1
KR_6272692124,420,1,39,-3,5,2,2,0,3,3,0,2,4,2,-3,0,3,1,2,1,0,0,18,-1,5,4,5,0,1,-1,1,1,1,6,1
KR_6725559096,420,2,82,16,1,-3,1,4,-9,0,9,6,6,0,6,6,0,1,1,0,0,5,64,2,4,6,-23,0,1,1,1,1,1,1,1
KR_6656945144,420,3,12,-7,1,1,3,2,0,3,3,2,3,1,-3,1,4,1,1,0,0,-5,38,3,4,7,-25,0,1,1,-1,1,-1,6,1
KR_6765512449,420,-2,-1,-11,-6,-2,1,3,-1,1,2,-2,2,4,1,5,4,-2,0,2,0,0,9,2,5,7,-5,0,-3,-1,-1,-1,-1,3,1
KR_6672368522,420,5,20,48,11,0,0,0,5,8,3,4,4,0,0,5,5,2,2,0,0,7,-155,-4,5,1,2,0,1,1,1,1,-1,2,1
KR_6764319420,420,0,58,-8,6,4,8,4,1,2,1,1,5,4,1,3,2,-1,1,2,0,9,-2,-2,8,6,4,0,2,1,1,1,1,6,1
KR_6601312632,420,-1,-87,-35,-6,2,2,0,-3,1,4,-4,0,4,0,2,2,-1,0,1,0,-5,11,-1,6,5,0,0,-1,-1,-1,-1,1,6,1
KR_6725991478,420,4,31,-7,5,1,1,0,3,3,0,-1,1,2,3,7,4,-1,0,1,-1,2,124,3,4,7,-2,0,0,-1,1,0,-1,1,1
KR_6656510849,420,2,7,12,7,2,2,0,4,5,1,0,2,2,2,4,2,-1,1,2,0,6,5,-2,7,5,-1,0,0,1,0,0,-1,4,1
KR_6764961394,420,-2,-10,12,-4,-3,1,4,0,5,5,0,2,2,0,3,3,-1,0,1,0,2,5,1,3,4,0,0,1,-1,1,1,1,1,1
KR_6703404561,420,-2,-45,-25,-3,0,2,2,2,3,1,-4,1,5,-1,2,3,0,2,2,0,-1,4,0,8,8,2,0,1,1,1,1,1,6,1
KR_6724467431,440,0,-26,-1,0,-4,0,4,4,5,1,-2,1,3,3,5,2,-1,0,1,0,4,2,-2,4,2,-1,0,0,0,1,-1,-1,0,1
KR_6762569386,420,0,26,3,4,-1,1,2,2,4,2,5,6,1,0,2,2,-2,0,2,0,4,-7,2,4,6,2,0,1,1,-1,1,-1,6,1
KR_6757689390,420,0,32,2,-5,0,2,2,-2,5,7,-1,2,3,-6,3,9,4,4,0,1,-5,-58,1,4,5,-7,0,1,-1,-1,-1,1,3,1
KR_6563576325,420,3,14,48,3,1,4,3,0,5,5,1,4,3,0,6,6,1,1,0,1,0,3,-7,10,3,2,0,2,1,1,1,1,4,1
KR_6646980541,420,6,53,-13,12,2,7,5,1,3,2,2,2,0,7,7,0,0,2,2,1,11,-1,1,7,8,6,0,2,1,-1,1,1,2,1
KR_6761452071,420,4,51,4,6,-2,4,6,1,2,1,5,6,1,3,5,2,-1,1,2,0,6,-1,-1,6,5,-3,0,1,0,-1,1,-1,0,1
KR_6760922695,420,0,-4,5,0,0,2,2,-9,0,9,5,5,0,3,4,1,1,2,1,0,-8,-35,-2,5,3,3,0,0,1,-1,1,-1,5,1
KR_6367220166,440,12,94,42,23,0,0,0,13,13,0,4,4,0,7,8,1,-1,1,2,1,28,0,0,0,0,3,0,1,-1,0,1,1,4,1
KR_6729959277,420,5,99,12,13,1,1,0,5,6,1,2,2,0,4,4,0,1,2,1,0,12,112,3,2,5,2,0,1,1,-1,1,1,4,1
KR_6753144477,420,3,7,6,-2,-1,3,4,-2,3,5,-5,2,7,6,6,0,0,0,0,-1,3,-9,-1,3,2,2,0,0,-1,-1,-1,-1,3,1
KR_6761070120,420,-2,11,-8,-2,-2,1,3,0,5,5,1,3,2,3,4,1,-4,0,4,0,-2,39,-1,6,5,-24,0,0,1,-1,-1,-1,5,1
KR_6762094808,420,3,28,5,7,3,4,1,3,4,1,-4,2,6,1,3,2,4,4,0,1,4,-1,1,5,6,4,0,1,-1,-1,1,1,4,1
KR_6746308566,420,4,65,-18,16,2,2,0,4,5,1,3,6,3,6,6,0,1,2,1,-1,24,-2,1,2,3,4,0,2,0,-1,1,-1,0,1
KR_6602959895,420,4,57,-7,13,3,3,0,2,4,2,5,5,0,3,4,1,0,0,0,0,13,23,1,4,5,-1,0,0,1,0,1,1,1,1
KR_6750075633,420,0,11,-12,-1,-2,3,5,2,3,1,2,2,0,-1,2,3,-2,2,4,0,-1,-16,3,4,7,-4,0,0,1,-1,0,-1,5,1
KR_6735908969,420,3,-20,1,4,5,5,0,0,3,3,2,4,2,-1,0,1,-2,0,2,0,4,-90,4,3,7,-5,0,0,-1,-1,0,1,5,1
KR_6740853941,440,6,73,-8,17,3,5,2,3,5,2,0,2,2,12,12,0,-1,1,2,0,7,-16,-4,7,3,3,0,2,1,-1,1,1,3,1
KR_6763760833,420,5,0,7,8,0,5,5,4,6,2,-5,1,6,5,5,0,4,5,1,0,8,4,-3,7,4,1,0,1,-1,1,1,1,6,1
KR_6728689400,420,2,-2,23,4,3,3,0,7,7,0,-3,2,5,-3,1,4,0,1,1,0,1,29,3,0,3,-2,0,0,1,-1,1,1,5,1
KR_6764326794,420,2,23,10,6,5,6,1,3,7,4,0,0,0,-2,0,2,0,2,2,0,1,-39,3,2,5,19,0,1,-1,1,1,-1,6,1
KR_6597752210,420,5,57,-20,5,1,3,2,1,3,2,3,4,1,0,3,3,0,1,1,0,2,15,5,5,10,-2,0,1,-1,1,1,1,1,1
KR_6733836368,420,1,55,-4,3,-4,0,4,6,6,0,0,2,2,1,3,2,0,0,0,0,3,-16,-3,7,4,5,0,1,-1,-1,1,1,1,1
KR_6681891190,420,1,-33,43,-4,-3,0,3,-2,5,7,3,4,1,-1,1,2,-1,0,1,0,-3,-14,-6,8,2,1,0,1,1,1,1,-1,2,1
KR_6666299043,420,1,23,-4,-4,1,2,1,-1,3,4,1,2,1,-7,3,10,2,2,0,-2,-15,-4,0,5,5,1,0,1,1,-1,1,-1,2,1
KR_6762668159,420,2,49,-32,8,1,1,0,-3,4,7,-1,2,3,5,5,0,6,6,0,0,8,-119,-5,9,4,6,0,1,1,1,1,1,4,1
KR_6765724693,420,0,39,-32,3,2,3,1,3,3,0,1,3,2,-1,1,2,-2,0,2,0,-1,19,-1,7,6,-3,0,0,-1,0,0,-1,2,1
KR_6727123738,420,4,126,28,8,6,6,0,1,2,1,3,4,1,1,4,3,-3,0,3,0,1,5,3,0,3,-2,0,3,1,0,1,1,2,1
KR_6684436519,420,1,13,17,4,-1,2,3,3,3,0,2,6,4,0,3,3,0,1,1,0,2,2,0,4,4,2,0,2,1,-1,1,-1,1,1
KR_6757779336,420,2,19,15,4,6,6,0,1,2,1,-4,1,5,-2,3,5,3,3,0,1,6,4,-2,6,4,-2,0,1,-1,1,1,1,4,1
KR_6760612063,420,2,4,12,-1,4,5,1,0,3,3,-2,3,5,-1,1,2,-2,1,3,0,-1,-9,-2,3,1,-2,0,-1,1,0,-1,-1,2,1
KR_6754488336,440,6,50,-7,15,0,0,0,0,0,0,3,8,5,9,11,2,3,3,0,2,10,-40,-1,4,3,2,0,1,0,-1,1,1,0,1
KR_6681415604,440,4,12,8,11,3,3,0,-5,0,5,7,7,0,-1,0,1,7,8,1,0,5,-4,0,5,5,0,0,1,0,-1,1,1,0,1
KR_6741912647,420,4,58,2,15,2,2,0,4,4,0,2,2,0,6,7,1,1,4,3,2,22,-9,2,5,7,7,0,1,-1,-1,1,1,1,1
KR_6728236088,440,5,23,-4,9,3,5,2,2,4,2,4,5,1,1,3,2,-1,1,2,0,0,-2,-3,6,3,2,0,2,1,1,1,1,1,1
KR_6755595685,420,-2,-21,40,-3,0,0,0,1,3,2,-4,1,5,1,4,3,-1,2,3,1,5,-5,0,5,5,-2,0,0,1,1,0,1,4,1
KR_6682196453,420,0,-20,-1,0,0,1,1,3,5,2,0,3,3,-1,4,5,-2,1,3,0,5,-3,2,5,7,1,0,0,1,-1,0,1,6,1
KR_6739887169,420,3,10,-1,3,-1,0,1,4,5,1,1,2,1,-2,2,4,1,4,3,0,7,7,0,6,6,-1,0,0,1,-1,0,1,5,1
KR_6757914711,420,0,14,23,-2,0,2,2,-1,4,5,0,3,3,0,3,3,-1,2,3,0,1,-67,-2,7,5,3,0,0,1,1,-1,-1,2,1
KR_6601839685,420,4,19,-20,10,1,3,2,-1,3,4,7,8,1,3,3,0,0,0,0,0,4,37,5,5,10,-2,0,1,1,-1,1,1,4,1
KR_6724558705,420,0,43,-16,3,1,4,3,4,6,2,4,4,0,-4,0,4,-2,0,2,-1,3,-69,-5,7,2,2,0,0,1,1,1,-1,5,1
KR_6633157163,420,3,20,-13,3,0,2,2,-1,0,1,4,4,0,-2,2,4,2,3,1,1,6,-2,-1,8,7,6,0,1,-1,-1,1,1,1,1
KR_6702875523,420,3,22,4,-1,-1,1,2,-2,1,3,2,2,0,1,2,1,-1,0,1,0,2,-27,0,7,7,1,0,0,1,1,0,1,1,1
KR_6761752404,440,0,78,-31,5,-2,0,2,9,9,0,0,4,4,-2,0,2,0,1,1,0,6,4,5,4,9,1,0,1,1,-1,1,-1,3,1
KR_6761447539,420,5,66,35,11,2,4,2,8,9,1,1,2,1,1,3,2,-1,1,2,1,2,33,3,3,6,-2,0,1,1,1,1,1,4,1
KR_6758802064,420,-2,27,0,-10,-4,1,5,1,6,5,-3,0,3,-2,2,4,-2,0,2,0,-17,160,-3,9,6,3,0,1,-1,1,1,-1,5,1
KR_6751245872,420,5,83,8,16,4,5,1,3,7,4,2,3,1,6,7,1,1,2,1,1,21,2,-4,7,3,5,0,-1,1,-1,-1,1,3,1
KR_6751993558,420,1,-14,26,5,-3,0,3,-5,1,6,1,3,2,9,9,0,3,4,1,0,15,-47,0,5,5,21,0,0,1,-1,1,1,4,1
KR_6706309393,420,4,51,38,4,7,7,0,-3,2,5,1,1,0,-1,2,3,0,0,0,0,-11,33,5,5,10,-6,0,1,1,1,1,1,2,1
KR_6725327211,420,0,-6,-13,7,-1,0,1,4,5,1,-2,3,5,5,5,0,1,1,0,0,16,0,6,5,11,-4,0,1,-1,-1,1,1,3,1
KR_6756297436,420,3,17,20,7,-2,2,4,-1,2,3,-2,3,5,12,13,1,0,0,0,0,6,8,-2,7,5,5,0,2,1,1,1,1,4,1
KR_6723152476,420,5,48,3,9,10,10,0,2,3,1,-3,2,5,0,4,4,0,1,1,0,-1,-23,-4,7,3,0,0,2,1,1,1,1,4,1
KR_6765562968,420,2,14,12,3,-3,0,3,3,5,2,4,6,2,-2,1,3,1,2,1,0,3,-1,-1,8,7,0,0,0,-1,1,1,1,4,1
KR_6706796720,420,5,49,4,6,0,0,0,2,5,3,1,3,2,1,2,1,2,6,4,-1,10,-27,-2,7,5,1,0,0,-1,-1,-1,-1,3,1
KR_6760467857,420,-4,-2,-29,-11,0,2,2,-2,1,3,-6,1,7,-1,1,2,-2,0,2,0,-10,3,0,4,4,-7,0,-2,1,-1,-1,-1,5,1
KR_6761328426,420,3,-1,17,-1,5,5,0,-2,3,5,0,1,1,-3,0,3,-1,0,1,0,-8,35,2,3,5,-4,0,0,-1,0,0,1,6,1
KR_6765627349,440,4,-46,8,9,-1,0,1,-1,2,3,6,6,0,2,2,0,3,3,0,0,6,58,2,6,8,6,0,0,1,1,0,1,6,1
KR_6753751697,420,0,-26,25,-1,0,2,2,2,4,2,-1,2,3,0,4,4,-2,1,3,0,5,0,-2,4,2,0,0,-1,1,1,-1,1,3,1
KR_6749968804,420,-2,0,-45,-3,1,1,0,-2,0,2,-1,3,4,1,3,2,-2,0,2,0,-4,-1,1,4,5,-5,0,0,0,1,0,-1,0,1
KR_6687256139,420,3,-18,-5,10,3,3,0,1,2,1,4,4,0,-1,2,3,3,5,2,0,8,6,2,4,6,-1,0,0,1,1,1,1,4,1
KR_6743342786,440,0,-17,8,0,-3,0,3,-4,0,4,4,4,0,-1,1,2,4,6,2,0,-4,0,-3,9,6,-4,0,0,-1,1,0,-1,1,1
KR_6751899684,420,5,45,-19,6,1,2,1,5,7,2,0,2,2,3,5,2,-3,1,4,0,6,78,-2,6,4,2,0,0,1,-1,0,1,4,1
KR_6732198432,420,-2,-30,-8,-7,-5,2,7,4,7,3,-6,1,7,-2,3,5,2,3,1,-3,-4,0,-5,8,3,-5,0,0,1,-1,-1,-1,2,1
KR_6762944618,420,6,40,28,9,0,0,0,8,9,1,2,2,0,0,4,4,-1,0,1,0,6,7,-1,4,3,0,0,1,1,1,1,-1,2,1
KR_6757860701,420,0,-38,21,0,-3,1,4,-1,0,1,0,1,1,-1,1,2,5,5,0,0,1,170,-1,3,2,-4,0,0,-1,1,0,-1,1,1
KR_6749695807,420,2,-4,8,6,1,3,2,-4,1,5,4,5,1,5,8,3,0,0,0,0,2,-46,-1,6,5,23,0,1,0,0,1,-1,0,1
KR_6716365477,420,2,66,6,2,0,0,0,2,4,2,-2,0,2,0,1,1,2,2,0,0,2,22,3,4,7,-2,0,1,-1,1,1,1,5,1
KR_6734129739,420,2,55,13,0,-4,2,6,6,6,0,-1,2,3,-1,0,1,0,2,2,0,3,-21,-3,8,5,3,0,2,-1,1,1,-1,4,1
KR_6759980677,420,2,30,28,3,-7,0,7,1,7,6,7,7,0,1,3,2,1,1,0,0,6,0,-7,8,1,0,0,2,1,1,1,-1,3,1
KR_6761028384,420,4,109,4,-1,2,3,1,-3,1,4,-1,0,1,0,2,2,1,2,1,0,0,-34,2,4,6,-5,0,0,0,-1,1,-1,0,1
KR_6727159579,420,-3,-9,-16,-1,0,1,1,2,3,1,-3,0,3,-1,1,2,1,1,0,0,1,-4,0,4,4,0,0,0,-1,1,0,1,4,1
KR_6761839540,420,4,106,21,3,2,3,1,-2,1,3,3,3,0,0,1,1,0,1,1,0,2,-42,4,5,9,5,0,1,-1,1,1,1,5,1
KR_6744035601,420,2,51,-2,10,1,4,3,4,5,1,2,5,3,3,6,3,0,2,2,0,4,25,5,3,8,1,0,1,0,0,1,-1,0,1
KR_6761253903,420,-1,29,-8,-5,1,4,3,-5,2,7,1,2,1,-1,3,4,-1,0,1,0,-10,2,0,7,7,-3,0,1,1,-1,1,-1,3,1
KR_6718167109,420,-1,-24,11,1,-1,1,2,4,5,1,1,2,1,-3,0,3,0,1,1,0,-1,12,2,4,6,-9,0,-1,1,1,-1,-1,5,1
KR_6757441521,420,-4,-92,-15,-15,-2,1,3,-3,0,3,-1,3,4,-5,2,7,-4,0,4,-1,-15,-7,-4,7,3,4,0,-2,-1,-1,-1,-1,3,1
KR_6753234458,420,0,-2,-1,-3,-1,1,2,1,2,1,0,1,1,1,1,0,-4,2,6,0,-3,29,2,8,10,-1,0,2,1,1,1,-1,4,1
KR_6764065931,420,1,-32,45,0,8,8,0,-2,2,4,-1,1,2,-1,3,4,-4,1,5,-1,-4,113,3,3,6,-5,0,3,1,1,1,-1,4,1
KR_6760744187,420,3,43,43,9,1,3,2,4,6,2,3,5,2,0,4,4,1,2,1,-1,6,-34,-2,5,3,18,0,0,1,1,1,1,2,1
KR_6752602990,420,-1,-10,20,3,1,3,2,-2,2,4,1,5,4,0,0,0,3,3,0,0,-3,-33,4,3,7,17,0,0,1,1,-1,1,1,1
KR_6764821206,420,1,-11,20,8,2,2,0,2,2,0,-1,1,2,4,7,3,1,1,0,0,12,4,0,7,7,-4,0,0,1,1,1,1,1,1
KR_6748247672,420,1,10,24,0,0,0,0,-2,4,6,6,6,0,-1,2,3,-3,0,3,0,0,-170,-4,6,2,26,0,0,1,1,1,-1,2,1
KR_6690548810,420,4,-20,4,5,-1,1,2,0,6,6,1,3,2,3,4,1,2,2,0,0,12,3,0,5,5,3,0,0,1,-1,-1,-1,5,1
KR_6761377130,420,2,19,-6,3,2,2,0,-1,3,4,-1,4,5,5,6,1,-2,1,3,0,1,-3,-2,5,3,4,0,0,-1,1,1,1,5,1
KR_6729295646,420,3,48,18,11,6,7,1,-1,2,3,4,6,2,2,4,2,0,2,2,3,6,29,-1,5,4,3,0,3,1,1,1,1,2,1
KR_6744192883,420,1,-10,-46,2,2,3,1,0,2,2,1,3,2,-1,1,2,0,1,1,-1,-4,-26,0,6,6,4,0,0,0,-1,-1,-1,0,1
KR_6738905225,420,-1,20,-6,-4,-1,0,1,1,3,2,-3,1,4,0,3,3,-1,0,1,0,-3,-7,1,4,5,6,0,1,-1,1,1,1,5,1
KR_6743912347,440,4,10,36,8,4,4,0,0,1,1,-1,0,1,3,5,2,2,2,0,0,11,-7,-3,7,4,2,0,0,1,-1,0,-1,4,1
KR_6766082446,420,1,14,-37,3,0,1,1,-1,2,3,6,7,1,-1,1,2,-1,0,1,0,-1,0,-2,6,4,1,0,1,-1,1,-1,-1,4,1
KR_6764646607,420,4,33,24,1,0,2,2,6,8,2,0,3,3,-3,0,3,-2,0,2,0,-2,-10,0,6,6,2,0,1,1,1,1,-1,6,1
KR_6707631698,420,2,86,33,11,1,2,1,2,3,1,5,5,0,5,7,2,-2,0,2,0,9,37,0,5,5,-28,0,2,1,1,1,-1,1,1
KR_6753616005,440,2,94,25,7,-5,0,5,2,3,1,4,4,0,9,9,0,-3,0,3,1,6,-3,3,5,8,4,0,-1,1,-1,-1,1,4,1
KR_6698795146,420,1,9,10,10,0,5,5,5,6,1,4,4,0,0,3,3,1,4,3,2,19,34,2,3,5,2,0,2,1,1,1,1,4,1
KR_6687478354,420,0,54,-8,-3,1,3,2,-1,4,5,-3,1,4,-4,0,4,4,6,2,-1,-14,3,0,6,6,-2,0,0,1,-1,0,1,2,1
KR_6729968101,420,2,25,0,2,1,1,0,4,4,0,0,3,3,-2,2,4,-1,0,1,1,2,-3,2,5,7,2,0,0,-1,1,0,1,1,1
KR_6763236902,420,3,58,-29,8,5,7,2,-3,2,5,6,6,0,-1,5,6,1,1,0,0,4,8,4,4,8,2,0,0,-1,-1,1,1,1,1
KR_6722643319,440,1,12,15,1,-1,0,1,1,4,3,5,6,1,-1,2,3,-3,0,3,0,5,-15,-2,5,3,17,0,0,-1,1,0,-1,3,1
KR_6658077457,420,-5,29,-35,-4,-3,0,3,7,7,0,-5,1,6,-3,1,4,0,0,0,0,-9,26,5,5,10,-2,0,0,-1,-1,1,-1,3,1
KR_6525837325,420,-2,-66,24,-1,-1,1,2,1,1,0,1,1,0,0,2,2,-2,0,2,0,1,129,3,4,7,5,0,0,1,1,0,1,5,1
KR_6670254687,420,7,73,23,20,2,4,2,5,6,1,8,9,1,7,8,1,-2,2,4,4,19,-1,2,3,5,5,0,1,1,1,1,1,3,1
KR_6712567365,440,3,101,-10,0,-3,3,6,2,3,1,0,2,2,-2,3,5,3,3,0,0,-4,0,-4,5,1,2,0,2,0,1,1,-1,0,1
KR_6692972103,420,-3,47,-11,-12,-1,1,2,-1,3,4,-5,2,7,-2,2,4,-3,1,4,0,-13,-8,-3,6,3,2,0,0,-1,-1,0,-1,2,1
KR_6764750146,420,0,1,47,-1,0,1,1,-1,0,1,2,4,2,-2,4,6,0,0,0,-1,-1,-116,-2,7,5,-17,0,0,-1,-1,-1,-1,2,1
KR_6765546486,420,1,24,5,14,2,4,2,4,4,0,2,2,0,5,6,1,1,1,0,1,13,-139,3,6,9,-2,0,0,1,1,0,1,1,1
KR_6747911041,420,-1,-74,-1,2,0,1,1,0,4,4,0,1,1,2,3,1,0,0,0,0,4,7,6,3,9,-6,0,-1,1,-1,-1,-1,5,1
KR_6763613893,440,6,83,4,16,7,8,1,7,9,2,5,6,1,-1,1,2,-2,0,2,0,15,-12,1,2,3,1,0,1,0,0,1,-1,0,1
KR_6763039696,420,7,-22,43,11,-1,2,3,0,2,2,1,4,3,9,9,0,2,3,1,1,12,9,0,3,3,1,0,3,0,1,1,1,0,1
KR_6758582895,420,2,12,-24,6,3,5,2,1,3,2,0,2,2,2,3,1,0,1,1,0,11,-3,-2,7,5,2,0,0,-1,-1,0,1,4,1
KR_6762458528,420,2,11,5,3,-1,0,1,-1,1,2,-2,2,4,8,10,2,-1,0,1,0,3,-3,1,2,3,4,0,0,0,-1,0,1,0,1
KR_6755945749,420,4,67,7,13,2,2,0,2,3,1,4,5,1,3,5,2,2,2,0,0,22,1,1,4,5,1,0,0,0,1,0,1,0,1
KR_6729030362,420,-1,-32,0,-5,4,7,3,-7,0,7,0,3,3,0,3,3,-2,1,3,0,-10,8,0,7,7,0,0,0,1,-1,-1,-1,1,1
KR_6757597551,440,4,49,54,13,4,4,0,2,5,3,4,7,3,4,5,1,-1,1,2,0,13,14,5,0,5,1,0,0,0,1,1,1,0,1
KR_6760363353,440,6,87,26,10,3,3,0,3,6,3,3,8,5,-1,3,4,2,2,0,2,8,286,0,3,3,2,0,2,1,1,1,1,4,1
KR_6674583780,420,-2,-15,-2,-1,3,3,0,0,2,2,4,4,0,-6,0,6,-2,0,2,-1,-4,-5,-3,10,7,2,0,-2,-1,-1,-1,-1,2,1
KR_6729786237,420,5,33,22,6,1,2,1,2,5,3,-1,1,2,3,6,3,1,1,0,0,6,4,3,3,6,5,0,0,-1,1,1,1,3,1
KR_6753360047,420,2,67,32,7,2,3,1,4,5,1,4,5,1,-1,3,4,-2,0,2,-1,-2,4,0,4,4,0,0,0,1,0,0,-1,6,1
KR_6764164303,420,-1,24,2,2,2,3,1,-1,0,1,-1,2,3,0,3,3,2,3,1,0,8,-1,2,3,5,-2,0,0,-1,1,0,-1,6,1
KR_6658679275,420,-1,-6,1,1,2,2,0,-1,3,4,0,0,0,0,4,4,0,2,2,0,3,3,3,8,11,0,0,1,1,-1,1,-1,2,1
KR_6703052838,420,0,30,-19,1,6,6,0,-3,0,3,-1,5,6,-4,1,5,3,5,2,0,2,21,-3,8,5,0,0,2,1,1,1,-1,6,1
KR_6758844571,420,2,2,12,10,4,6,2,-1,2,3,1,2,1,1,4,3,5,5,0,0,7,54,0,3,3,2,0,2,1,1,1,1,4,1
KR_6710147307,440,5,56,38,10,-2,2,4,6,6,0,1,4,3,3,3,0,2,2,0,0,13,-294,4,2,6,-2,0,2,1,1,1,-1,3,1
KR_6739637703,420,5,23,-12,12,3,3,0,3,3,0,2,2,0,1,2,1,3,4,1,1,13,-7,0,4,4,2,0,0,1,-1,0,1,1,1
KR_6741607234,420,0,-52,13,6,-1,1,2,2,3,1,0,4,4,4,4,0,1,1,0,0,5,48,2,3,5,-4,0,-1,1,-1,-1,1,2,1
KR_6761455452,420,-1,-46,8,3,1,2,1,2,5,3,1,3,2,1,1,0,-2,0,2,0,9,-28,-2,6,4,3,0,-1,1,-1,-1,-1,2,1
KR_6677930327,420,2,79,17,6,2,2,0,-1,2,3,3,3,0,2,5,3,0,0,0,0,0,9,4,4,8,1,0,0,1,-1,0,1,2,1
KR_6765877857,420,0,46,-8,-4,1,2,1,-1,2,3,-3,1,4,0,3,3,-1,0,1,0,-7,-7,-2,7,5,1,0,-2,-1,-1,-1,-1,5,1
KR_6724817898,420,4,74,-2,15,1,4,3,2,3,1,1,2,1,7,8,1,4,4,0,0,20,-21,0,7,7,6,0,2,1,1,1,1,3,1
KR_6719448802,420,2,20,-17,4,1,2,1,0,3,3,1,2,1,2,4,2,0,0,0,0,5,0,-1,6,5,8,0,0,0,0,1,-1,0,1
KR_6752923555,420,0,12,8,0,-5,0,5,2,3,1,-3,2,5,7,13,6,-1,2,3,0,1,-8,0,6,6,-2,0,1,1,-1,-1,1,1,1
KR_6761541844,420,0,52,16,5,-1,1,2,-1,3,4,0,2,2,5,5,0,2,2,0,0,7,-5,0,5,5,2,0,1,1,1,1,1,2,1
KR_6764344519,420,1,-5,16,-1,2,2,0,-3,0,3,-2,0,2,2,3,1,0,0,0,0,-3,-206,-5,7,2,1,0,1,-1,-1,1,-1,6,1
KR_6722186513,420,7,112,28,12,9,10,1,0,3,3,6,7,1,-1,0,1,-2,0,2,0,8,109,2,5,7,-1,0,2,1,0,1,1,1,1
KR_6597879550,420,1,-11,-3,0,-1,1,2,2,2,0,0,6,6,0,3,3,-1,0,1,0,6,-22,0,8,8,-1,0,-1,-1,-1,-1,1,6,1
KR_6658973377,420,1,-52,-4,1,2,2,0,0,2,2,-2,1,3,-1,2,3,2,3,1,-1,2,-4,-5,7,2,-1,0,0,-1,1,0,-1,3,1
KR_6760438396,420,-1,-8,-10,4,0,2,2,1,6,5,1,4,3,2,3,1,0,1,1,0,5,4,5,3,8,0,0,-1,1,-1,1,1,1,1
KR_6753795020,420,0,10,8,-4,2,4,2,-2,4,6,1,1,0,-3,0,3,-2,0,2,0,-13,-14,0,7,7,3,0,-1,-1,-1,-1,1,3,1
KR_6742468395,420,1,17,1,2,1,2,1,0,1,1,-1,1,2,2,2,0,0,0,0,0,1,21,-2,7,5,3,0,1,-1,-1,1,-1,4,1
KR_6760681455,420,1,60,17,-3,-2,1,3,-2,1,3,0,4,4,1,3,2,0,1,1,0,-8,-7,3,2,5,0,0,0,0,-1,0,1,0,1
KR_6734868890,420,-3,-46,-21,0,-6,0,6,6,6,0,2,3,1,-2,1,3,0,1,1,-1,5,-3,-3,10,7,2,0,-2,1,-1,-1,-1,3,1
KR_6750963631,420,2,29,24,2,5,6,1,-2,0,2,-3,0,3,1,2,1,1,1,0,1,5,3,-2,6,4,-1,0,1,0,1,1,1,0,1
KR_6760732271,420,1,2,12,5,2,3,1,0,1,1,2,3,1,3,5,2,-2,0,2,0,9,1,2,6,8,-1,0,0,1,1,0,1,4,1
KR_6646717467,420,1,33,-20,-1,0,1,1,0,6,6,-3,1,4,2,6,4,0,1,1,0,5,7,-1,7,6,-2,0,0,-1,1,0,-1,4,1
KR_6713741063,420,-2,-28,36,-7,0,1,1,2,2,0,0,1,1,-9,1,10,0,3,3,0,-9,-25,-4,8,4,0,0,-1,-1,1,-1,1,3,1
KR_6656391262,420,1,30,8,7,4,5,1,2,4,2,6,9,3,-4,2,6,-1,0,1,-1,3,9,8,2,10,-3,0,1,1,1,1,-1,3,1
KR_6760035456,420,-1,-34,21,4,2,3,1,2,3,1,3,5,2,-5,4,9,2,2,0,0,9,-4,-4,7,3,2,0,-1,1,0,-1,1,5,1
KR_6765529225,420,0,12,20,-2,-1,1,2,-3,1,4,-5,1,6,5,6,1,2,2,0,0,4,0,3,5,8,-1,0,0,1,-1,0,1,5,1
KR_6763010836,420,7,97,20,9,2,2,0,3,4,1,0,2,2,5,7,2,-1,0,1,0,7,6,0,3,3,2,0,2,1,1,1,-1,6,1
KR_6756226278,440,5,66,4,23,5,5,0,-4,1,5,11,11,0,6,7,1,5,6,1,0,12,-8,-2,4,2,4,0,3,1,1,1,1,5,1
KR_6762079563,420,1,35,39,-2,-3,1,4,0,3,3,1,1,0,-3,0,3,3,3,0,0,-1,0,0,5,5,3,0,0,1,1,0,-1,5,1
KR_6744021256,420,1,-49,4,2,3,4,1,2,2,0,-2,0,2,-4,2,6,3,3,0,0,8,55,-3,8,5,1,0,0,1,1,1,-1,1,1
KR_6731333095,420,4,35,28,4,4,6,2,-2,2,4,2,6,4,2,3,1,-2,0,2,-1,-2,21,8,1,9,0,0,1,1,1,1,-1,6,1
KR_6748783109,420,1,23,-4,-2,-3,1,4,5,6,1,-7,0,7,3,3,0,0,0,0,0,-1,7,1,3,4,-1,0,-1,1,1,-1,-1,2,1
KR_6763799680,420,-1,-14,18,-8,-1,1,2,-2,1,3,-2,1,3,-1,3,4,-2,0,2,-1,-11,-5,2,6,8,-1,0,0,-1,1,-1,-1,5,1
KR_6748643520,420,-2,6,-32,-5,-4,1,5,-4,3,7,1,2,1,0,2,2,2,5,3,-1,-8,-15,3,5,8,0,0,-1,1,-1,-1,-1,3,1
KR_6755250652,420,5,57,20,8,-1,2,3,-1,3,4,6,9,3,3,3,0,1,1,0,1,20,-34,2,1,3,4,0,1,1,0,1,1,4,1
KR_6760926195,440,-2,-63,10,-3,1,1,0,-2,1,3,-1,1,2,-3,2,5,2,4,2,0,-2,1,5,2,7,-3,0,-1,-1,1,-1,-1,4,1
KR_6760077116,420,-2,-21,12,-4,2,2,0,0,4,4,-5,1,6,-1,3,4,0,0,0,0,-2,-12,7,4,11,1,0,0,1,1,0,-1,5,1
KR_6765593268,420,1,-27,9,4,3,6,3,-3,2,5,0,4,4,1,2,1,3,3,0,0,-1,-5,-2,5,3,-2,0,0,-1,1,0,1,1,1
KR_6759370914,420,2,36,-7,6,1,4,3,1,3,2,1,2,1,2,5,3,1,2,1,0,7,19,-4,9,5,-6,0,2,1,1,1,1,4,1
KR_6653100583,420,-2,-42,18,-3,-4,1,5,4,5,1,1,2,1,-3,3,6,-1,0,1,-1,1,2,0,4,4,0,0,0,0,1,0,-1,0,1
KR_6762604161,420,1,35,11,-3,3,3,0,-3,0,3,2,2,0,-4,1,5,-1,0,1,-1,-8,142,-1,4,3,3,0,0,1,-1,0,-1,2,1
KR_6729207733,420,1,64,11,5,-1,1,2,5,10,5,-1,1,2,1,4,3,1,1,0,1,8,-32,0,9,9,1,0,0,1,-1,0,1,5,1
KR_6655018992,420,0,62,9,-4,-2,2,4,-2,1,3,2,3,1,-2,2,4,0,0,0,0,-6,1,3,1,4,-1,0,0,1,1,1,1,6,1
KR_6737825879,420,1,0,-4,4,1,3,2,2,5,3,1,2,1,3,9,6,-3,2,5,0,1,6,-5,8,3,-4,0,0,1,0,0,-1,1,1
KR_6761774233,420,5,21,34,9,1,1,0,1,4,3,8,9,1,-1,1,2,0,0,0,0,7,-5,0,4,4,2,0,-1,1,1,1,1,2,1
KR_6055850558,420,-5,-33,-15,-17,-4,0,4,-7,3,10,2,3,1,-9,0,9,1,1,0,0,-9,14,-2,6,4,-2,0,-1,-1,-1,-1,-1,2,1
KR_6630004639,420,3,37,6,4,-1,2,3,3,5,2,1,2,1,1,2,1,0,0,0,0,-1,-5,3,4,7,5,0,0,1,-1,0,-1,2,1
KR_6743758051,440,-1,-70,4,-2,0,1,1,-1,3,4,0,3,3,0,4,4,-1,1,2,0,3,77,-1,5,4,18,0,0,1,0,0,1,4,1
KR_6758847489,420,0,-34,24,4,-3,0,3,6,8,2,-1,1,2,4,8,4,-2,1,3,0,-1,18,4,4,8,1,0,-1,-1,0,-1,-1,6,1
KR_6763493526,420,-1,-29,8,1,-3,0,3,1,2,1,3,3,0,-1,3,4,1,2,1,0,3,-2,-2,7,5,6,0,0,1,-1,0,-1,6,1
KR_6684448767,420,3,19,12,8,-1,1,2,5,6,1,6,6,0,2,3,1,-4,0,4,0,11,-262,3,3,6,0,0,1,1,0,1,1,4,1
KR_6750182283,420,2,13,4,10,-1,2,3,1,2,1,6,7,1,2,4,2,2,2,0,0,14,13,7,1,8,-1,0,-1,1,1,-1,1,2,1
KR_6724603824,420,3,30,-2,6,0,1,1,2,5,3,-2,0,2,3,3,0,3,4,1,0,10,7,2,6,8,-4,0,1,1,0,1,1,6,1
KR_6723689155,420,8,68,40,23,6,7,1,6,6,0,6,6,0,5,6,1,0,1,1,1,20,-2,-2,5,3,1,0,2,1,1,1,1,4,1
KR_6663711165,420,0,54,41,6,0,2,2,-1,2,3,2,5,3,2,3,1,3,5,2,0,-3,1,-3,8,5,2,0,2,1,1,1,1,2,1
KR_6744824502,420,1,68,-37,-3,0,2,2,3,4,1,-2,2,4,-3,1,4,-1,1,2,-1,-11,8,1,2,3,-3,0,-1,1,-1,-1,-1,5,1
KR_6615288576,420,-3,-41,-4,0,1,2,1,6,7,1,3,5,2,-3,0,3,-7,1,8,0,2,-12,2,5,7,-1,0,-1,-1,-1,-1,1,5,1
KR_6656355034,420,-1,-31,-18,2,0,1,1,4,4,0,-1,3,4,3,4,1,-4,0,4,0,6,-7,1,5,6,-5,0,-1,1,-1,-1,-1,6,1
KR_6667564824,420,0,-40,3,2,0,0,0,3,5,2,-1,0,1,1,2,1,-1,0,1,0,3,8,2,5,7,-6,0,0,1,1,0,1,1,1
KR_6753923317,420,2,-31,-2,4,0,2,2,1,3,2,3,6,3,3,6,3,-3,0,3,-1,12,-329,-2,6,4,2,0,-1,1,-1,-1,-1,5,1
KR_6740459592,420,6,19,51,14,10,11,1,5,5,0,3,4,1,-4,2,6,0,1,1,0,-1,8,2,2,4,3,1,4,1,1,1,1,1,1
KR_6746024367,420,4,113,13,16,7,7,0,0,1,1,3,8,5,2,2,0,4,4,0,0,7,0,3,0,3,3,0,1,1,1,1,1,2,1
KR_6763578717,420,-3,7,-12,-1,2,2,0,1,4,3,-4,1,5,1,5,4,-1,1,2,0,-4,4,-6,10,4,-5,0,1,-1,1,1,1,6,1
KR_6683816238,420,2,80,32,2,3,4,1,-1,5,6,1,1,0,-1,5,6,0,1,1,-2,-7,22,2,3,5,1,0,1,1,-1,1,-1,2,1
KR_6680922678,420,0,-1,19,-4,1,1,0,2,4,2,-5,1,6,-4,1,5,2,2,0,0,-9,-42,-4,7,3,3,0,0,1,-1,0,-1,6,1
KR_6763891060,420,0,4,23,3,-3,1,4,4,6,2,4,5,1,-1,0,1,-1,0,1,0,-1,-4,0,5,5,0,0,-1,1,-1,-1,-1,6,1
KR_6600850265,420,3,33,9,6,-3,2,5,3,4,1,3,3,0,2,2,0,1,1,0,1,14,-12,-6,7,1,7,0,0,1,1,0,1,4,1
KR_6730234747,420,-1,-30,-23,6,-1,2,3,3,4,1,1,3,2,3,4,1,0,0,0,0,12,-35,6,2,8,14,0,1,1,1,-1,1,2,1
KR_6520587051,420,-2,10,-22,11,-2,3,5,2,3,1,0,0,0,10,10,0,1,2,1,2,18,6,-2,7,5,0,0,0,1,1,1,1,2,1
KR_6760727147,420,1,12,48,0,-2,1,3,1,2,1,-1,1,2,2,3,1,0,1,1,0,-5,-398,-3,4,1,5,0,-1,1,-1,-1,1,4,1
KR_6696911422,420,2,23,16,1,-2,0,2,1,4,3,2,3,1,1,2,1,-1,1,2,0,0,-17,-3,5,2,1,0,0,1,0,-1,-1,3,1
KR_6729104684,420,0,-36,-4,0,0,2,2,0,1,1,1,4,3,-1,1,2,0,1,1,-1,7,-93,5,6,11,3,0,1,-1,1,1,-1,3,1
KR_6679124535,420,0,44,-32,0,-2,0,2,-1,1,2,2,3,1,0,0,0,1,2,1,0,-4,2,1,6,7,0,0,0,-1,0,0,-1,5,1
KR_6750460784,420,0,-2,-12,5,-5,1,6,-2,0,2,5,6,1,4,5,1,3,4,1,0,4,15,-2,5,3,2,0,0,-1,-1,1,-1,4,1
KR_6737419774,420,3,15,44,5,2,4,2,1,3,2,0,1,1,1,3,2,1,1,0,0,4,-8,-1,5,4,2,0,2,-1,1,1,1,5,1
KR_6759416586,420,2,-46,40,-1,2,3,1,0,4,4,0,2,2,-4,0,4,1,1,0,0,-2,3,2,4,6,-2,0,1,-1,1,1,-1,5,1
KR_6734296108,440,0,-9,0,-5,0,1,1,3,4,1,-7,2,9,-1,0,1,0,1,1,0,-7,5,-2,7,5,0,0,-1,1,1,-1,-1,2,1
KR_6765626033,420,2,4,-7,2,-3,0,3,0,2,2,3,3,0,1,2,1,1,1,0,0,6,6,-1,4,3,2,0,1,1,-1,1,1,6,1
KR_6766565766,420,4,56,24,12,2,2,0,5,6,1,4,7,3,-2,0,2,3,3,0,2,21,-18,-1,5,4,0,0,2,1,1,1,1,2,1
KR_6757512454,440,3,-18,-15,2,0,1,1,2,2,0,4,4,0,-1,4,5,-3,1,4,0,1,7,-2,3,1,-2,0,0,1,-1,0,-1,4,1
KR_6762052215,420,2,-11,8,0,-2,0,2,1,3,2,-1,0,1,2,4,2,0,2,2,0,0,1,-2,8,6,-4,0,0,1,-1,0,-1,1,1
KR_6740785292,440,1,-67,-8,-2,0,1,1,-1,1,2,-3,2,5,4,5,1,-2,0,2,0,6,35,0,5,5,-2,0,0,-1,1,0,1,5,1
KR_6683261202,420,5,76,34,11,-4,1,5,8,10,2,2,8,6,6,8,2,-1,0,1,0,19,44,4,4,8,1,0,1,1,1,1,-1,5,1
KR_6747488105,440,2,95,28,3,2,3,1,-3,1,4,0,1,1,1,3,2,3,3,0,0,6,8,0,3,3,5,0,0,1,1,0,1,2,1
KR_6725343506,420,-2,28,0,7,7,10,3,-2,5,7,-3,1,4,7,9,2,-2,1,3,3,17,-28,4,2,6,1,0,-1,1,1,1,1,5,1
KR_6752127146,440,0,38,-8,5,2,4,2,1,3,2,1,3,2,-2,0,2,3,3,0,0,14,0,0,6,6,-1,0,1,-1,-1,1,-1,5,1
KR_6683148580,420,3,25,-8,9,2,3,1,4,4,0,1,1,0,3,5,2,-1,0,1,0,9,5,8,3,11,2,0,0,1,1,0,1,5,1
KR_6754391501,440,2,-20,12,7,-1,3,4,1,4,3,4,5,1,-1,1,2,4,4,0,0,11,-19,-2,7,5,6,0,1,-1,1,1,1,5,1
KR_6743559601,420,2,86,9,0,0,2,2,1,3,2,0,1,1,-3,3,6,2,2,0,0,-3,47,-1,5,4,-10,0,1,1,-1,1,1,1,1
KR_6734036647,420,-7,-104,-20,-3,5,6,1,-2,4,6,-6,1,7,0,1,1,0,1,1,0,8,-6,-7,9,2,4,0,-1,-1,-1,-1,1,6,1
KR_6623412641,420,3,56,6,2,5,7,2,-1,2,3,1,4,3,-2,4,6,-1,0,1,-3,-12,-29,2,4,6,4,0,0,0,1,1,-1,0,1
KR_6763104118,420,0,63,-4,1,0,0,0,-3,2,5,5,5,0,-1,2,3,0,1,1,1,2,4,2,2,4,0,0,1,1,-1,1,1,5,1
KR_6761806045,440,-1,-20,-32,4,-1,1,2,5,5,0,1,2,1,-3,1,4,2,2,0,0,8,-11,1,7,8,1,0,-1,1,1,-1,1,1,1
KR_6667842677,420,-3,-45,3,3,-2,1,3,5,6,1,-4,0,4,2,4,2,2,2,0,0,9,1,-2,4,2,2,0,0,1,-1,-1,-1,6,1
KR_6752519099,420,1,14,20,1,-4,0,4,1,4,3,2,3,1,0,3,3,2,3,1,0,-2,1,0,5,5,2,0,0,-1,1,-1,-1,2,1
KR_6757768093,420,2,-11,-6,6,2,2,0,-2,2,4,4,5,1,0,1,1,2,2,0,0,6,131,-6,9,3,2,0,1,-1,1,1,-1,3,1
KR_6675577422,420,3,20,-8,7,1,2,1,0,2,2,5,5,0,1,2,1,0,0,0,0,4,-9,-4,7,3,6,0,0,-1,1,1,1,4,1
KR_6722530206,440,2,-12,1,5,-1,1,2,4,6,2,2,3,1,-1,3,4,1,1,0,1,3,1,4,3,7,-4,0,-1,0,-1,-1,1,0,1
KR_6762434870,420,-3,-6,-19,-3,-4,0,4,1,3,2,-4,0,4,5,6,1,-1,0,1,2,-2,-4,-6,10,4,0,0,-2,-1,-1,-1,1,1,1
KR_6646648622,440,0,-26,22,1,-1,1,2,2,3,1,0,0,0,0,5,5,0,0,0,0,3,-7,-1,6,5,4,0,-1,1,-1,-1,-1,4,1
KR_6755158733,420,1,21,-25,10,5,7,2,-1,2,3,6,6,0,0,1,1,0,2,2,0,7,-3,3,4,7,1,0,0,-1,1,-1,1,4,1
KR_6747078751,420,4,-10,20,14,-1,2,3,5,5,0,1,1,0,5,5,0,4,4,0,0,16,24,-3,6,3,-3,0,1,1,1,-1,1,3,1
KR_6752303383,420,2,55,-8,10,14,14,0,1,1,0,-5,0,5,0,2,2,0,0,0,0,4,-38,1,6,7,21,0,1,-1,-1,1,1,2,1
KR_6686567366,420,0,10,0,2,1,4,3,3,4,1,0,1,1,-3,2,5,1,3,2,-2,0,2,-1,6,5,-1,0,-2,1,-1,-1,1,5,1
KR_6746561027,420,0,-34,-22,5,0,2,2,2,4,2,3,3,0,1,3,2,-1,1,2,0,9,-4,-3,6,3,1,0,0,-1,1,0,-1,3,1
KR_6751446032,420,0,-24,16,0,1,2,1,2,3,1,-1,4,5,-2,1,3,0,0,0,0,-6,383,-3,5,2,-2,0,-1,-1,1,-1,-1,5,1
KR_6726842250,420,5,74,48,3,4,5,1,1,5,4,1,3,2,-2,1,3,-1,1,2,1,-1,25,-1,7,6,-9,0,2,-1,1,1,1,4,1
KR_6735927827,420,0,17,-28,2,1,2,1,-4,4,8,-3,1,4,3,5,2,5,5,0,0,7,37,0,2,2,-24,0,2,1,-1,1,1,6,1
KR_6744025547,420,5,107,-5,10,-1,2,3,6,6,0,5,5,0,1,1,0,-1,0,1,0,12,-2,7,2,9,3,0,2,1,1,1,-1,3,1
KR_6736703187,420,2,67,20,5,3,6,3,0,4,4,-1,1,2,2,4,2,1,1,0,0,5,-50,5,3,8,4,0,0,1,1,1,-1,1,1
KR_6764937518,440,-3,-41,-10,-4,6,6,0,-6,1,7,-1,1,2,-3,2,5,0,1,1,-1,-1,-28,1,4,5,-6,0,0,0,-1,0,-1,0,1
KR_6704888331,440,7,89,37,15,1,1,0,5,5,0,6,6,0,2,3,1,1,1,0,1,15,-106,2,3,5,-4,0,1,0,-1,1,1,0,1
KR_6764243994,420,1,-9,29,2,0,1,1,1,4,3,0,1,1,1,4,3,0,2,2,0,-2,8,2,4,6,-4,0,0,-1,1,1,1,3,1
KR_6748052498,420,2,-2,23,1,-1,1,2,5,6,1,2,6,4,-6,0,6,1,3,2,1,-8,20,-3,5,2,-1,0,0,-1,1,1,1,5,1
KR_6765288869,420,3,26,-5,5,4,5,1,2,2,0,-1,2,3,0,0,0,0,0,0,0,8,5,3,2,5,2,0,0,1,-1,1,-1,5,1
KR_6765742630,420,-5,-54,-11,-13,-5,2,7,-3,2,5,-7,1,8,0,1,1,2,3,1,-1,-5,12,-3,7,4,-2,0,-1,-1,-1,-1,-1,3,1
KR_6760369010,420,-1,20,-15,0,-2,2,4,4,4,0,-3,1,4,1,2,1,0,1,1,0,2,316,1,6,7,-8,0,0,0,-1,0,1,0,1
KR_6752920334,420,4,-29,-16,15,0,2,2,1,2,1,4,5,1,8,8,0,2,3,1,1,16,15,2,3,5,6,0,0,1,1,1,1,1,1
KR_6746959116,420,-1,-14,35,-1,0,0,0,0,3,3,-2,2,4,0,2,2,1,2,1,0,1,1,-1,8,7,-5,0,0,-1,1,0,1,2,1
KR_6706759803,420,1,2,23,3,1,3,2,-3,3,6,1,3,2,3,5,2,1,4,3,-1,4,7,-1,6,5,-2,0,2,0,1,1,-1,0,1
KR_6600942821,420,1,-32,25,5,0,1,1,2,2,0,2,4,2,1,5,4,0,2,2,-1,11,5,1,6,7,0,0,0,1,-1,0,-1,6,1
KR_6758771135,420,-2,33,16,-4,4,6,2,-5,1,6,0,2,2,0,2,2,-3,1,4,0,-5,-17,4,5,9,-9,0,1,0,1,1,-1,0,1
KR_6765169914,420,0,25,-28,1,4,4,0,0,2,2,0,2,2,-2,1,3,-1,0,1,0,-1,229,0,4,4,0,0,1,1,-1,1,1,1,1
KR_6617746159,420,3,-27,0,8,6,7,1,3,3,0,-2,3,5,-1,4,5,2,2,0,0,14,3,0,5,5,0,0,1,-1,1,1,-1,3,1
KR_6722448126,440,4,12,32,13,2,4,2,3,4,1,4,4,0,2,3,1,2,2,0,0,10,-4,1,3,4,6,0,2,1,1,1,-1,4,1
KR_6750848528,420,1,1,14,4,-2,1,3,3,3,0,2,4,2,0,1,1,1,1,0,0,3,1,4,3,7,-3,0,0,1,0,0,1,6,1
KR_6728061268,420,1,49,-12,0,0,3,3,6,8,2,1,2,1,-6,0,6,-1,0,1,-2,-4,-287,-4,7,3,4,0,0,-1,1,1,-1,6,1
KR_6763025134,420,-3,-16,0,-5,0,2,2,-6,1,7,2,5,3,1,4,3,-2,0,2,0,-3,-3,-4,10,6,4,0,-1,1,-1,-1,1,5,1
KR_6748815349,420,-3,-29,3,-7,-2,0,2,3,5,2,-1,1,2,-5,1,6,-2,1,3,0,-3,86,-8,8,0,1,0,0,-1,-1,0,1,1,1
KR_6668205096,420,0,-18,25,-3,1,1,0,-7,2,9,-1,6,7,4,5,1,0,0,0,-1,-1,6,1,4,5,-2,0,0,0,0,0,-1,0,1
KR_6752995929,420,2,56,-11,5,2,3,1,0,3,3,0,7,7,2,4,2,1,2,1,0,0,1,1,5,6,0,0,1,1,-1,1,-1,4,1
KR_6764079827,420,2,-42,16,5,-5,0,5,1,3,2,2,3,1,7,7,0,0,0,0,2,20,6,2,7,9,0,0,0,-1,-1,0,1,1,1
KR_6747842875,440,2,-15,12,7,2,3,1,-1,3,4,1,2,1,4,4,0,1,2,1,0,3,-4,5,5,10,2,0,1,1,1,1,1,5,1
KR_6757229230,420,0,78,-11,5,-4,0,4,2,3,1,0,4,4,6,7,1,1,1,0,-1,6,-22,1,4,5,-1,0,1,1,-1,1,-1,2,1
KR_6605255908,420,3,51,-19,3,-3,2,5,4,8,4,1,2,1,0,1,1,1,1,0,0,-3,-18,3,5,8,2,0,1,1,1,1,1,2,1
KR_6684711026,420,2,32,-29,13,-1,1,2,3,5,2,4,4,0,4,4,0,3,3,0,0,16,12,6,1,7,1,0,1,1,-1,1,1,3,1
KR_6756953122,420,1,-63,-32,1,5,5,0,-3,1,4,-3,0,3,4,6,2,-2,0,2,0,-1,-22,-2,7,5,-5,0,-1,-1,-1,-1,-1,5,1
KR_6562364769,420,4,55,17,8,2,3,1,0,4,4,5,7,2,1,5,4,0,1,1,1,5,13,-3,7,4,4,0,1,-1,1,1,1,1,1
KR_6591616466,420,1,15,-3,1,-3,0,3,-4,0,4,4,8,4,4,4,0,0,0,0,0,8,5,-4,10,6,4,0,-1,-1,-1,-1,-1,4,1
KR_6673934987,420,0,-40,-8,-3,-4,2,6,5,6,1,-3,1,4,2,2,0,-3,0,3,1,1,8,6,1,7,-5,0,0,1,-1,0,1,5,1
KR_6762228079,420,-1,11,-17,0,5,5,0,0,1,1,-1,0,1,-1,1,2,-3,0,3,0,-3,7,1,4,5,1,0,3,-1,1,1,1,3,1
KR_6568071171,420,-2,-30,-7,-1,2,2,0,0,3,3,-6,0,6,0,1,1,3,4,1,0,-7,10,0,2,2,5,0,0,1,-1,-1,1,6,1
KR_6739945346,420,2,-5,40,1,0,1,1,0,4,4,3,5,2,-1,3,4,-1,1,2,0,4,39,-1,3,2,-22,0,1,-1,1,1,-1,5,1
KR_6684634623,420,2,13,-7,4,0,2,2,3,8,5,1,2,1,-3,5,8,3,3,0,-2,-10,-2,1,6,7,-1,0,0,-1,0,0,-1,1,1
KR_6756790925,440,4,4,25,-3,3,5,2,2,3,1,1,3,2,-2,2,4,-7,0,7,0,-6,5,5,3,8,2,0,1,1,0,1,-1,6,1
KR_6695266367,420,0,24,-7,-2,0,2,2,-5,0,5,-1,3,4,3,3,0,1,2,1,0,0,7,5,3,8,-2,0,1,-1,-1,1,-1,4,1
KR_6757867347,420,2,0,-20,3,-5,1,6,8,8,0,-2,2,4,1,2,1,1,2,1,0,11,12,1,4,5,3,0,0,1,-1,-1,1,5,1
KR_6755089417,420,1,21,16,-1,0,2,2,6,8,2,-6,0,6,-1,4,5,0,1,1,-1,-16,7,-1,5,4,-1,0,1,1,1,1,-1,4,1
KR_6761763566,420,2,65,12,6,0,2,2,4,5,1,-1,3,4,-1,3,4,4,5,1,0,9,16,5,3,8,2,0,2,-1,1,1,-1,4,1
KR_6743183058,420,1,105,-8,3,2,2,0,4,4,0,-3,1,4,1,2,1,-1,0,1,0,3,-4,-3,9,6,6,0,0,-1,-1,1,1,5,1
KR_6736072650,420,1,-83,12,3,-3,1,4,2,3,1,6,7,1,-3,0,3,1,2,1,0,9,6,0,4,4,-4,0,0,-1,1,-1,-1,1,1
KR_6765589249,420,1,12,-9,1,5,5,0,-4,1,5,1,1,0,-2,1,3,1,2,1,0,-4,-5,-4,7,3,0,0,0,-1,-1,-1,1,1,1
KR_6736074865,420,1,-4,24,0,1,1,0,2,4,2,-4,2,6,2,4,2,-1,3,4,0,4,-29,-3,7,4,2,0,-1,1,-1,1,1,6,1
KR_6714978469,420,6,105,19,7,1,3,2,4,6,2,0,1,1,-4,2,6,6,7,1,0,8,13,-3,9,6,-1,0,1,1,1,1,-1,5,1
KR_6750876097,420,4,51,12,15,4,4,0,5,5,0,7,9,2,4,6,2,-5,2,7,1,13,1,2,6,8,6,0,0,1,-1,0,1,5,1
KR_6734661991,420,-1,7,-3,-4,-1,1,2,-3,3,6,1,3,2,0,0,0,-1,0,1,0,-10,-18,3,3,6,1,0,-1,-1,1,-1,-1,4,1
KR_6686937796,420,-2,-68,1,-3,1,1,0,0,3,3,3,4,1,-6,0,6,-1,1,2,0,-6,-5,-2,5,3,-1,0,-2,1,-1,-1,1,3,1
KR_6715663366,420,5,68,-13,3,7,7,0,1,5,4,-7,4,11,3,5,2,-1,1,2,0,4,4,2,2,4,-1,0,0,-1,1,1,-1,4,1
KR_6658539831,420,3,-18,-4,1,1,3,2,0,2,2,0,0,0,1,2,1,-1,0,1,1,-3,2,4,2,6,6,0,1,-1,1,1,1,1,1
KR_6709669569,420,1,37,-40,5,1,1,0,2,4,2,2,2,0,1,1,0,-1,1,2,0,4,9,0,5,5,-2,0,1,1,1,1,-1,4,1
KR_6652632921,420,2,35,-12,8,-5,3,8,3,5,2,3,4,1,7,7,0,0,1,1,0,19,-6,-3,6,3,6,0,0,0,0,-1,-1,0,1
KR_6750244060,420,5,55,-2,14,4,5,1,0,4,4,2,3,1,6,6,0,2,3,1,0,12,8,1,2,3,-4,0,1,1,-1,1,1,3,1
KR_6756919026,440,-1,-57,-9,4,-4,0,4,5,7,2,2,3,1,2,2,0,-1,0,1,0,-2,-29,1,4,5,13,0,0,-1,0,0,1,1,1
KR_6738033493,420,7,13,28,11,1,1,0,3,4,1,-1,1,2,3,4,1,5,5,0,0,16,6,2,5,7,0,0,2,1,-1,1,1,1,1
KR_6761107569,440,3,89,26,3,1,2,1,0,0,0,-1,0,1,1,2,1,2,3,1,0,2,-154,0,3,3,-1,0,1,-1,1,1,-1,4,1
KR_6750997551,420,0,-20,16,-3,2,2,0,-7,1,8,2,3,1,0,1,1,0,0,0,1,-8,3,-4,8,4,-7,0,-1,-1,1,-1,1,5,1
KR_6679426155,420,4,35,1,2,2,2,0,-2,1,3,1,3,2,2,5,3,-1,1,2,0,4,2,-2,7,5,-1,0,1,-1,-1,1,1,4,1
KR_6671036555,420,1,21,-32,10,3,7,4,1,2,1,10,11,1,-2,0,2,-2,3,5,1,-7,-8,0,7,7,-1,0,2,1,0,1,1,3,1
KR_6693622514,420,-1,8,6,8,-1,1,2,5,5,0,-1,3,4,5,7,2,0,1,1,0,10,-25,-1,6,5,8,0,0,-1,1,-1,1,6,1
KR_6706792148,420,-1,-93,27,-3,-3,1,4,-2,2,4,1,2,1,-3,4,7,4,4,0,-1,-3,-43,1,7,8,22,0,-2,1,-1,-1,-1,6,1
KR_6752261394,420,2,21,-3,9,-1,2,3,3,6,3,2,2,0,5,5,0,0,0,0,0,12,8,6,3,9,3,0,0,-1,1,0,1,4,1
KR_6693537878,420,0,-32,-16,1,2,3,1,-2,2,4,0,4,4,1,1,0,0,1,1,0,6,-127,-1,5,4,1,0,0,-1,-1,-1,-1,2,1
KR_6760478321,420,7,101,14,7,4,5,1,3,4,1,-1,3,4,0,1,1,1,3,2,-1,3,3,1,3,4,1,0,2,1,1,1,-1,4,1
KR_6686467360,420,1,-18,29,-1,-2,0,2,1,3,2,-1,0,1,-1,3,4,2,2,0,0,0,49,0,6,6,5,0,0,1,1,0,-1,1,1
KR_6671007423,420,-1,-36,3,-11,-1,0,1,-4,4,8,-5,1,6,-2,2,4,1,3,2,0,-7,-8,-2,6,4,-2,0,0,1,1,0,-1,1,1
KR_6760069935,420,1,9,22,6,3,3,0,5,10,5,-2,0,2,-2,2,4,2,2,0,0,6,12,3,8,11,-3,0,1,1,-1,1,-1,5,1
KR_6764605494,420,2,20,-26,6,-1,3,4,8,9,1,-1,1,2,1,2,1,-1,0,1,0,17,37,7,5,12,-2,0,3,-1,1,1,-1,4,1
KR_6741422661,420,0,52,1,5,-1,1,2,3,6,3,-1,3,4,4,4,0,0,1,1,1,0,-35,-2,6,4,1,0,0,1,1,1,1,6,1
KR_6599498186,420,4,62,37,9,-2,3,5,5,7,2,1,1,0,1,1,0,4,4,0,0,12,4,2,3,5,1,0,1,1,1,1,-1,1,1
KR_6748948195,420,-1,-9,10,-1,-2,0,2,-2,1,3,3,6,3,2,5,3,-2,1,3,1,1,216,2,6,8,-2,0,0,-1,1,0,1,1,1
KR_6758003036,420,-4,-21,8,-6,1,1,0,-4,2,6,-1,0,1,0,3,3,-2,1,3,0,-10,0,1,4,5,-2,0,-2,1,-1,-1,-1,5,1
KR_6758644963,420,3,14,-14,10,1,2,1,0,4,4,5,6,1,3,5,2,1,2,1,0,12,1,-1,5,4,2,0,-1,1,-1,-1,-1,1,1
KR_6718233103,420,0,-60,29,1,0,3,3,-2,1,3,0,2,2,5,6,1,-2,0,2,0,11,-12,-7,9,2,3,0,0,1,-1,1,-1,1,1
KR_6752180446,440,-2,24,-3,-8,6,8,2,-3,1,4,-3,2,5,-5,1,6,-3,1,4,0,-5,14,-4,9,5,-4,0,1,1,-1,1,1,1,1
KR_6700653777,420,2,92,16,4,1,1,0,0,9,9,3,3,0,-1,1,2,1,1,0,0,0,6,-1,5,4,2,0,3,1,1,1,1,5,1
KR_6765201427,420,-2,31,-9,-4,4,5,1,-6,1,7,0,4,4,-2,1,3,0,0,0,0,-11,3,3,3,6,-3,0,1,-1,-1,1,-1,2,1
KR_6745944942,420,3,29,13,7,-3,1,4,7,7,0,-1,0,1,3,4,1,1,2,1,0,17,10,1,5,6,2,0,2,1,1,1,1,4,1
KR_6764347299,420,3,10,14,10,-2,2,4,5,8,3,7,7,0,0,1,1,0,0,0,0,9,-1,-2,6,4,3,0,0,1,-1,-1,1,6,1
KR_6761817533,420,-1,-6,-7,-6,0,5,5,-1,4,5,-3,2,5,-5,0,5,3,4,1,1,0,-5,-2,7,5,3,0,0,1,0,0,1,5,1
KR_6761503433,440,3,19,16,2,1,2,1,-1,0,1,1,3,2,0,2,2,1,1,0,0,2,-16,0,4,4,-1,0,1,-1,1,1,1,1,1
KR_6733712642,420,4,46,30,7,2,3,1,4,7,3,2,3,1,-1,1,2,0,1,1,0,-2,52,2,3,5,-5,0,3,0,1,1,1,0,1
KR_6737788358,420,-1,-25,-11,-5,-4,0,4,-3,0,3,2,3,1,0,4,4,0,0,0,0,-1,-7,2,5,7,4,0,-1,1,-1,-1,-1,6,1
KR_6764459005,420,1,72,-28,5,0,2,2,4,8,4,-1,2,3,2,5,3,0,1,1,3,13,17,3,4,7,2,0,0,1,1,0,1,4,1
KR_6507101573,420,4,42,27,9,0,3,3,2,2,0,3,4,1,1,4,3,3,5,2,-2,9,5,0,4,4,-3,0,1,1,1,1,-1,4,1
KR_6736672310,420,3,14,-4,5,-1,1,2,2,4,2,0,1,1,3,4,1,1,2,1,0,10,-36,0,8,8,5,0,0,1,-1,1,-1,4,1
KR_6765515860,420,-1,4,20,3,-3,1,4,5,5,0,1,1,0,4,5,1,-4,0,4,0,0,-5,-4,10,6,1,0,-1,1,1,-1,-1,2,1
KR_6562159611,420,5,46,18,13,3,4,1,-2,0,2,-1,2,3,12,13,1,1,2,1,0,21,25,3,4,7,-2,0,2,1,-1,1,1,2,1
KR_6759326238,420,1,-10,28,1,1,2,1,3,3,0,0,2,2,-2,4,6,-1,2,3,0,3,-101,-3,6,3,0,0,0,1,-1,-1,-1,1,1
KR_6678358542,420,1,38,-8,2,2,2,0,-1,3,4,-1,1,2,3,3,0,-1,1,2,0,5,-130,-2,7,5,-1,0,0,-1,1,0,1,1,1
KR_6765813930,420,-2,-31,0,-2,0,0,0,-3,2,5,2,2,0,-1,0,1,0,0,0,0,-4,4,0,7,7,-3,0,1,-1,1,1,-1,1,1
KR_6669556683,420,-1,-31,34,-2,-3,0,3,5,7,2,-2,0,2,-2,2,4,0,1,1,-1,2,-16,-6,9,3,7,0,2,-1,1,1,-1,3,1
KR_6718132189,420,4,57,16,11,-1,2,3,7,10,3,4,9,5,-1,5,6,2,3,1,4,29,-18,0,6,6,4,0,0,-1,-1,1,1,3,1
KR_6759008948,440,3,-6,21,13,1,2,1,5,5,0,3,5,2,4,4,0,0,0,0,0,7,5,5,2,7,-2,0,1,0,-1,1,1,0,1
KR_6750852056,420,-3,-54,13,-9,-4,2,6,-4,1,5,1,2,1,3,5,2,-5,0,5,-1,-4,8,0,3,3,-3,0,-1,1,-1,-1,-1,2,1
KR_6755110826,420,4,35,-20,13,3,4,1,1,1,0,0,3,3,6,7,1,3,4,1,0,9,1,6,0,6,-3,0,0,1,-1,1,-1,6,1
KR_6713223822,420,6,68,16,31,5,5,0,10,10,0,8,11,3,4,4,0,4,6,2,-1,30,11,2,1,3,-2,1,5,0,1,1,-1,0,1
KR_6633100651,420,3,130,-8,0,-3,0,3,3,4,1,-1,3,4,3,6,3,-2,0,2,-1,2,1,6,4,10,1,0,2,-1,1,1,1,2,1
KR_6637369950,420,-1,-46,-24,-3,-6,0,6,-1,3,4,0,3,3,2,2,0,2,2,0,0,-5,-1,-3,6,3,4,0,0,1,-1,1,-1,3,1
KR_6743644858,420,1,1,-4,7,0,1,1,0,3,3,6,6,0,0,2,2,1,2,1,0,8,-1,1,5,6,-1,0,0,-1,1,1,-1,3,1
KR_6738571422,420,0,-28,-8,3,9,9,0,-5,0,5,-3,3,6,-1,2,3,3,5,2,0,-5,-15,-2,2,0,-3,0,-1,-1,-1,-1,1,2,1
KR_6738371438,420,1,-21,23,8,0,1,1,3,3,0,0,3,3,5,6,1,0,0,0,1,18,-13,-4,6,2,7,0,0,1,-1,0,1,5,1
KR_6687984721,420,-1,16,-34,-7,-1,2,3,1,3,2,-2,1,3,-3,3,6,-2,0,2,0,-8,-3,-5,8,3,-3,0,-1,1,-1,-1,-1,3,1
KR_6698857083,420,-2,33,-4,-5,1,2,1,0,1,1,-5,0,5,0,3,3,-1,1,2,0,-2,0,-3,6,3,-5,0,-1,-1,-1,-1,1,5,1
KR_6733520558,440,4,65,8,11,-1,0,1,6,8,2,0,1,1,6,7,1,0,0,0,0,12,11,5,2,7,-1,0,1,0,-1,1,-1,0,1
KR_6627956555,420,4,67,8,6,1,1,0,3,4,1,-1,1,2,1,3,2,2,5,3,0,9,8,3,4,7,6,0,1,0,1,1,1,0,1
KR_6730360815,420,3,-20,32,6,-1,0,1,0,3,3,0,4,4,6,6,0,1,1,0,0,16,-4,-2,7,5,2,0,1,1,-1,1,1,3,1
KR_6756891499,440,-2,-40,18,-1,-4,0,4,2,2,0,0,1,1,2,3,1,-1,4,5,-2,-2,9,-3,5,2,1,0,0,-1,-1,0,-1,5,1
KR_6762122996,420,0,-1,-7,7,3,3,0,-2,2,4,0,0,0,5,5,0,1,1,0,0,7,14,6,4,10,1,0,0,-1,-1,1,1,6,1
KR_6766093857,420,-1,17,-23,-8,-4,2,6,1,4,3,-5,0,5,1,2,1,-1,1,2,0,-2,16,2,4,6,-2,0,0,-1,1,1,-1,3,1
KR_6717656847,420,5,36,42,11,1,3,2,4,5,1,1,3,2,4,4,0,1,1,0,0,5,-16,9,3,12,3,0,0,1,1,1,1,4,1
KR_6743859827,420,2,4,16,2,1,1,0,-1,0,1,-1,2,3,2,7,5,1,2,1,0,-3,-31,0,2,2,-1,0,1,1,1,1,1,1,1
KR_6633727091,420,1,66,0,1,-3,0,3,2,5,3,3,3,0,-1,1,2,0,0,0,0,1,-3,-2,9,7,3,0,0,1,-1,0,1,5,1
KR_6756142295,420,2,16,27,11,-3,2,5,1,2,1,9,11,2,4,5,1,0,0,0,0,8,9,3,4,7,2,0,0,1,-1,1,1,3,1
KR_6713940659,420,3,4,-30,2,-4,2,6,3,8,5,1,7,6,-1,2,3,3,4,1,0,2,3,1,5,6,-1,0,2,-1,-1,1,1,6,1
KR_6751226955,420,-4,-1,-20,-3,-5,2,7,-3,1,4,-1,1,2,7,8,1,-1,1,2,1,4,-28,-1,3,2,6,0,1,1,-1,1,1,4,1
KR_6658729707,420,6,170,48,7,5,5,0,-3,2,5,1,2,1,3,4,1,1,1,0,0,-2,3,-1,5,4,3,0,1,1,-1,1,1,4,1
KR_6765780679,420,3,-6,27,8,2,4,2,0,5,5,2,3,1,2,3,1,2,4,2,0,10,-6,-2,5,3,6,0,3,0,1,1,1,0,1
KR_6701582512,440,3,45,-15,-1,0,3,3,1,3,2,3,3,0,-3,2,5,-2,0,2,0,-9,-18,3,3,6,8,0,1,-1,1,1,-1,1,1
KR_6648672599,420,-1,10,20,-5,1,2,1,-2,4,6,-4,1,5,-1,3,4,1,1,0,0,-6,0,-1,6,5,3,0,0,-1,-1,-1,-1,2,1
KR_6706624068,420,1,-48,14,2,2,5,3,2,3,1,1,2,1,0,3,3,-3,0,3,0,4,-1,0,6,6,-2,0,0,1,-1,0,-1,5,1
KR_6762227871,440,5,150,36,14,2,2,0,0,4,4,2,5,3,5,7,2,5,5,0,0,5,-2,0,3,3,5,0,2,1,0,1,1,6,1
KR_6706947930,420,4,62,-44,12,5,6,1,4,5,1,2,5,3,4,6,2,-3,1,4,0,6,-172,3,2,5,1,0,4,0,1,1,1,0,1
KR_6762701298,420,1,22,21,4,4,5,1,1,3,2,1,2,1,-1,1,2,-1,1,2,0,-1,27,1,4,5,-2,0,3,1,1,1,1,6,1
KR_6630910529,420,-1,-54,-4,5,-3,0,3,-1,3,4,-1,1,2,5,5,0,5,5,0,0,5,-6,0,7,7,-4,0,-1,1,-1,-1,1,6,1
KR_6600919250,420,4,7,34,11,2,2,0,4,4,0,4,4,0,1,4,3,0,2,2,3,18,-2,-1,6,5,-3,0,1,1,-1,1,1,1,1
KR_6762664788,420,0,-57,8,3,1,4,3,0,3,3,0,3,3,1,2,1,1,1,0,0,3,11,0,5,5,0,0,-1,1,1,-1,1,2,1
KR_6695529537,420,1,31,-20,6,4,5,1,1,2,1,3,4,1,-2,1,3,0,0,0,0,3,-1,-4,5,1,1,0,1,-1,1,1,-1,2,1
KR_6729275982,420,-1,44,-20,-2,-3,0,3,0,2,2,1,5,4,0,6,6,0,1,1,0,1,-6,4,4,8,5,0,0,1,-1,-1,1,6,1
KR_6759620038,440,3,51,-11,3,2,2,0,0,0,0,2,2,0,0,2,2,-1,4,5,0,9,2,1,3,4,5,0,2,-1,1,1,-1,2,1
KR_6700768244,420,0,51,0,-2,-4,2,6,0,1,1,3,4,1,0,2,2,-1,0,1,1,-2,78,2,3,5,-26,0,3,1,1,1,1,2,1
KR_6720342857,420,-2,9,-20,-8,0,2,2,-1,2,3,-7,1,8,-4,4,8,4,5,1,-2,-9,-9,-6,11,5,3,0,2,1,-1,1,-1,6,1
KR_6700047807,420,5,-35,-1,4,2,2,0,0,5,5,4,5,1,-1,2,3,-1,0,1,-1,14,-2,-3,6,3,4,0,0,-1,0,1,-1,2,1
KR_6748435348,420,3,59,-8,2,-2,3,5,5,6,1,-4,1,5,2,4,2,1,2,1,0,3,-5,0,6,6,3,0,0,1,-1,1,-1,3,1
KR_6670338408,420,2,-33,4,4,-5,1,6,2,5,3,2,4,2,4,6,2,1,1,0,0,13,3,-3,7,4,-3,0,-1,1,-1,-1,-1,2,1
KR_6765900819,420,4,27,10,8,-1,0,1,0,2,2,4,5,1,4,5,1,1,1,0,0,3,-2,3,2,5,5,0,2,1,1,1,1,6,1
KR_6764144009,420,1,51,-8,3,1,4,3,-4,1,5,1,2,1,3,3,0,2,2,0,0,-1,5,-5,9,4,4,0,2,0,0,1,-1,0,1
KR_6763097352,420,0,7,32,7,1,2,1,1,1,0,3,4,1,1,4,3,1,1,0,0,2,-21,4,3,7,1,0,1,1,1,1,1,2,1
KR_6748770309,440,-1,50,-3,-8,-12,0,12,-1,0,1,2,4,2,1,6,5,2,4,2,0,-10,7,3,2,5,-5,0,0,-1,-1,1,1,2,1
KR_6751597905,420,2,-12,5,4,-1,1,2,4,6,2,-1,1,2,4,4,0,-2,0,2,0,2,-13,1,4,5,17,0,0,1,-1,1,1,2,1
KR_6760256963,420,8,65,41,15,3,4,1,6,6,0,7,8,1,1,4,3,-2,0,2,0,17,2,1,5,6,0,0,2,-1,1,1,1,6,1
KR_6684492485,420,3,31,52,8,5,5,0,1,3,2,-1,2,3,5,5,0,-2,0,2,0,11,14,3,2,5,0,0,1,1,0,1,1,4,1
KR_6277994099,420,1,-49,4,3,1,3,2,4,6,2,1,1,0,-1,0,1,-2,1,3,0,0,2,6,5,11,-2,0,0,1,1,0,1,1,1
KR_6764228019,420,2,34,-9,9,-2,1,3,2,3,1,1,2,1,7,7,0,1,2,1,0,18,4,6,5,11,1,0,1,1,0,1,-1,4,1
KR_6647134667,440,4,78,16,2,1,3,2,1,2,1,2,2,0,0,2,2,-2,0,2,0,0,-1,0,4,4,1,0,0,1,-1,0,1,2,1
KR_6729830014,420,0,-17,11,-2,2,4,2,-2,3,5,1,3,2,-4,3,7,1,1,0,0,5,13,0,8,8,-5,0,-1,-1,-1,-1,-1,5,1
KR_6759720681,420,0,-14,12,-1,1,1,0,1,2,1,1,1,0,-4,1,5,0,0,0,0,-6,21,-4,7,3,-6,0,0,1,-1,0,-1,2,1
KR_6731215646,420,0,64,0,5,1,2,1,2,2,0,1,5,4,-1,1,2,2,3,1,1,5,-9,0,4,4,-1,0,0,0,-1,1,1,0,1
KR_6727965009,420,2,32,3,-1,-2,0,2,0,3,3,1,1,0,0,0,0,0,0,0,0,-3,-16,1,5,6,1,0,0,1,-1,0,-1,6,1
KR_6766191917,420,2,-23,12,-2,1,2,1,-1,0,1,-4,5,9,2,3,1,0,0,0,0,4,-8,4,5,9,-1,0,0,1,1,0,-1,6,1
KR_6766449765,420,1,58,-4,1,1,1,0,5,8,3,-1,2,3,-4,1,5,0,1,1,0,-3,-14,-4,6,2,-1,0,4,-1,1,1,1,3,1
KR_6609124256,420,3,62,3,6,0,3,3,2,4,2,1,4,3,2,4,2,1,3,2,0,3,3,-3,6,3,4,0,2,1,-1,1,-1,3,1
KR_6735856313,440,2,82,-7,6,4,5,1,3,7,4,2,4,2,-3,2,5,0,0,0,0,8,-5,-6,7,1,2,0,1,0,-1,1,1,0,1
KR_6762449433,440,2,17,9,5,-2,1,3,4,5,1,1,2,1,1,3,2,1,1,0,0,12,4,4,3,7,0,0,2,1,1,1,-1,2,1
KR_6756206802,420,-3,-1,-20,-3,-2,0,2,3,4,1,-3,1,4,0,2,2,-1,1,2,0,-3,6,1,5,6,-1,0,0,1,-1,-1,-1,2,1
KR_6685251968,420,6,63,20,17,8,9,1,4,4,0,2,5,3,3,4,1,0,1,1,1,20,47,5,2,7,6,0,1,1,1,1,1,6,1
KR_6765182046,420,1,18,-44,8,3,5,2,0,2,2,3,3,0,2,2,0,0,1,1,0,12,0,2,2,4,4,0,3,-1,1,1,-1,5,1
KR_6763551447,440,6,45,-8,15,1,1,0,2,6,4,8,9,1,1,1,0,3,3,0,0,14,25,9,2,11,-1,0,2,1,1,1,1,2,1
KR_6744120373,420,3,13,20,8,0,0,0,3,3,0,1,2,1,3,4,1,1,1,0,1,11,-5,0,5,5,4,0,1,1,-1,1,1,3,1
KR_6743156442,420,4,19,-12,9,-4,1,5,7,7,0,1,2,1,5,6,1,0,2,2,0,13,-10,-2,5,3,-1,0,2,1,1,1,1,6,1
KR_6741604088,440,0,1,32,3,1,1,0,5,6,1,0,3,3,-2,1,3,-1,1,2,-1,-2,1,2,3,5,-1,0,-2,1,-1,-1,-1,6,1
KR_6749192787,420,-2,2,14,0,5,5,0,0,3,3,-1,1,2,-5,2,7,1,2,1,0,-3,-237,1,3,4,0,0,0,-1,1,1,1,1,1
KR_6764872429,420,-1,31,16,0,-1,1,2,-1,1,2,0,2,2,2,7,5,0,0,0,0,1,5,-3,5,2,0,0,1,1,-1,1,1,2,1
KR_6748609579,420,2,108,-14,5,0,0,0,-4,1,5,1,1,0,6,10,4,2,3,1,0,4,9,-3,6,3,-4,0,2,-1,1,1,1,3,1
KR_6694703295,420,4,-46,38,9,0,4,4,1,1,0,6,6,0,2,2,0,0,0,0,0,15,-2,-3,6,3,-3,0,1,1,-1,1,1,6,1
KR_6705178254,420,7,52,28,9,4,5,1,5,6,1,-2,1,3,1,4,3,1,1,0,0,4,27,-3,8,5,-4,0,0,0,1,1,1,0,1
KR_6686607031,440,0,12,4,-4,-2,1,3,0,1,1,-4,1,5,1,3,2,1,1,0,0,0,10,0,6,6,-4,0,-1,-1,-1,-1,-1,5,1
KR_6696071488,420,1,-6,-10,7,0,1,1,0,1,1,4,5,1,2,2,0,1,1,0,0,11,33,-2,7,5,8,0,2,1,1,1,1,3,1
KR_6765102450,420,6,87,2,14,1,2,1,9,9,0,0,2,2,1,6,5,3,4,1,1,12,-3,-4,7,3,6,0,1,-1,1,1,1,3,1
KR_6601577565,420,1,45,4,6,1,5,4,1,1,0,4,6,2,1,3,2,-1,1,2,0,8,-2,0,2,2,2,0,-1,1,1,-1,-1,5,1
KR_6731739463,420,0,87,1,4,-1,0,1,1,4,3,3,3,0,1,2,1,0,2,2,0,8,-7,3,3,6,6,0,1,-1,-1,1,1,2,1
KR_6751422823,420,5,-2,27,10,-2,2,4,5,5,0,4,6,2,1,2,1,2,2,0,0,21,14,4,5,9,0,0,2,1,1,1,-1,3,1
KR_6688245303,440,5,83,-5,8,2,4,2,1,7,6,2,5,3,2,4,2,1,1,0,1,10,-2,2,2,4,1,0,1,1,-1,1,1,4,1
KR_6753498555,420,0,-51,-16,4,-1,1,2,3,3,0,-1,0,1,2,4,2,1,2,1,-1,7,22,5,2,7,1,0,1,-1,1,1,-1,5,1
KR_6655977951,420,-3,-37,-19,4,-4,1,5,5,5,0,2,7,5,1,1,0,0,0,0,0,7,-12,-6,8,2,2,0,1,-1,-1,-1,1,3,1
KR_6680051421,420,1,-32,12,2,-5,2,7,2,5,3,5,5,0,0,2,2,0,1,1,0,12,1,2,3,5,4,0,0,1,1,1,-1,4,1
KR_6686570656,420,-1,-66,5,2,1,3,2,-1,1,2,0,1,1,6,6,0,-4,0,4,0,3,-4,-3,5,2,1,0,0,1,0,0,1,5,1
KR_6747428720,420,-2,11,-7,4,-1,0,1,-2,2,4,-3,0,3,5,5,0,5,7,2,-1,-1,2,-5,5,0,1,0,1,1,-1,1,-1,5,1
KR_6605122725,420,1,-3,-19,1,4,4,0,2,7,5,-1,3,4,-3,3,6,-1,0,1,-1,-10,7,3,3,6,2,0,1,1,-1,-1,-1,3,1
KR_6766571288,420,5,62,2,11,2,4,2,0,3,3,4,4,0,0,3,3,5,6,1,0,5,54,0,4,4,-3,0,0,1,1,1,1,3,1
KR_6645152747,420,2,-19,-1,5,1,2,1,6,6,0,2,2,0,-2,0,2,-2,0,2,0,4,6,3,4,7,-4,0,1,-1,1,-1,1,3,1
KR_6761614994,440,0,-42,1,7,0,3,3,3,3,0,3,5,2,0,4,4,1,2,1,0,17,-2,3,2,5,0,0,-1,1,1,1,1,5,1
KR_6764508590,420,0,-34,31,3,1,1,0,9,9,0,-2,1,3,-2,3,5,-3,1,4,-1,5,179,0,5,5,-3,0,1,1,1,-1,-1,5,1
KR_6754152152,420,-1,12,-24,-2,-2,0,2,-2,2,4,5,7,2,2,5,3,-5,5,10,0,4,2,3,4,7,3,0,-1,-1,-1,-1,-1,6,1
KR_6729232108,420,2,49,6,4,-1,2,3,-1,2,3,1,3,2,-3,1,4,8,8,0,0,-3,9,-5,5,0,0,0,1,1,1,1,-1,6,1
KR_6714950159,420,-1,19,-4,4,-4,1,5,3,4,1,-1,0,1,5,5,0,1,1,0,-1,11,6,2,4,6,3,0,1,1,-1,1,-1,3,1
KR_6683559286,420,0,14,-32,7,4,6,2,2,4,2,0,1,1,0,4,4,1,1,0,2,5,2,-3,7,4,3,0,-1,-1,1,-1,1,3,1
KR_6738328928,420,-1,1,2,0,2,2,0,1,3,2,0,1,1,1,2,1,-4,1,5,0,-4,10,-1,7,6,-4,0,0,1,1,0,1,6,1
KR_6740521857,440,6,83,9,23,8,9,1,5,5,0,2,5,3,8,9,1,0,0,0,0,14,0,0,5,5,3,0,3,-1,0,1,1,4,1
KR_6765560984,420,1,-29,-11,4,1,2,1,1,5,4,1,1,0,1,5,4,0,1,1,0,4,-119,2,4,6,-1,0,1,-1,-1,1,1,2,1
KR_6707257887,420,2,-66,16,6,2,2,0,2,3,1,1,3,2,-1,0,1,2,2,0,1,14,8,1,4,5,-6,0,1,1,1,1,1,4,1
KR_6714960146,420,0,-40,32,0,1,2,1,0,0,0,-1,1,2,-2,3,5,2,2,0,0,-1,-138,0,7,7,1,0,0,1,1,1,1,4,1
KR_6760597582,420,3,43,8,-1,-1,1,2,1,3,2,-1,2,3,0,5,5,0,1,1,-1,-4,-1,3,2,5,4,0,0,0,-1,0,-1,0,1
KR_6646683596,420,8,82,24,13,2,4,2,10,10,0,-2,0,2,2,3,1,1,1,0,1,19,-3,-1,7,6,1,0,1,1,1,1,1,1,1
KR_6749895610,420,0,-8,25,1,-4,3,7,2,3,1,0,1,1,1,1,0,2,2,0,0,4,10,-4,5,1,2,0,1,1,-1,1,-1,1,1
KR_6753678329,420,6,65,20,11,2,2,0,-2,3,5,2,3,1,1,3,2,8,9,1,0,8,7,-2,10,8,6,0,1,1,1,1,1,3,1
KR_6756157549,440,2,74,-16,4,0,0,0,-6,1,7,6,6,0,4,5,1,0,3,3,1,5,-3,0,3,3,1,0,1,1,1,1,1,3,1
KR_6730385114,420,3,15,12,11,1,1,0,-1,3,4,2,2,0,6,8,2,3,3,0,0,12,-33,0,7,7,30,0,2,1,1,1,1,1,1
KR_6750346592,440,-4,-28,-7,0,2,2,0,-4,1,5,-2,0,2,6,6,0,-2,1,3,0,-5,-1,3,4,7,-7,0,-1,1,-1,-1,1,4,1
KR_6719496701,420,1,-29,20,1,-4,0,4,0,1,1,3,3,0,2,3,1,0,1,1,0,13,-5,-1,8,7,2,0,-1,1,1,1,-1,3,1
KR_6762295926,420,3,-21,13,8,1,2,1,2,2,0,3,5,2,3,5,2,-1,0,1,0,13,14,0,3,3,1,0,-1,1,-1,-1,1,2,1
KR_6761700612,420,-1,-35,0,0,-1,2,3,3,5,2,-2,3,5,-1,4,5,1,4,3,0,1,22,3,2,5,-4,0,1,-1,0,1,-1,4,1
KR_6603010080,420,2,37,20,2,-5,1,6,6,7,1,1,4,3,0,1,1,0,0,0,0,3,10,1,4,5,1,0,1,1,1,1,-1,1,1
KR_6679845127,420,2,28,-16,6,2,3,1,1,3,2,0,0,0,3,7,4,0,3,3,0,5,2,5,4,9,2,0,1,-1,0,1,1,3,1
KR_6764827245,420,5,63,-4,13,5,6,1,2,4,2,2,6,4,2,2,0,2,2,0,0,7,7,1,4,5,4,0,2,0,0,1,1,0,1
KR_6738830376,420,2,23,63,3,4,5,1,0,3,3,0,2,2,-1,1,2,0,1,1,0,0,438,1,4,5,3,0,0,-1,0,1,-1,2,1
KR_6737191629,420,2,-16,40,10,-2,0,2,3,7,4,2,3,1,5,8,3,2,2,0,0,11,-10,-4,9,5,7,0,1,1,1,1,1,1,1
KR_6737587805,420,0,25,16,-2,5,5,0,-1,3,4,-2,1,3,-2,0,2,-2,0,2,0,-5,-11,0,4,4,2,0,2,1,1,1,-1,5,1
KR_6634768911,420,3,-8,16,0,0,2,2,0,2,2,-3,0,3,3,3,0,0,0,0,1,1,0,0,6,6,-1,0,-1,1,-1,-1,1,2,1
KR_6695418890,420,4,17,-16,10,-1,0,1,3,5,2,0,1,1,5,9,4,3,4,1,1,14,9,1,7,8,3,0,2,-1,-1,1,1,1,1
KR_6746363170,420,6,44,-20,11,2,2,0,3,5,2,4,4,0,2,4,2,0,0,0,2,18,9,3,6,9,5,0,2,1,1,1,1,5,1
KR_6679111140,420,6,40,68,6,2,2,0,0,3,3,3,5,2,3,5,2,-2,0,2,0,12,5,3,3,6,1,0,0,1,1,1,-1,6,1
KR_6702394415,420,3,-26,-26,11,6,7,1,-1,1,2,2,5,3,3,5,2,1,1,0,0,11,207,4,3,7,14,0,1,-1,1,-1,-1,4,1
KR_6746407589,420,1,-42,19,2,0,0,0,1,4,3,2,4,2,-1,2,3,0,1,1,0,-3,6,-3,7,4,-6,0,-2,-1,1,-1,-1,2,1
KR_6739720785,420,1,-11,24,4,-1,0,1,-1,1,2,-1,1,2,4,7,3,3,3,0,0,4,-3,-3,7,4,-2,0,1,1,1,1,1,2,1
KR_6656025962,440,2,19,-8,6,0,4,4,2,4,2,-1,0,1,3,7,4,2,3,1,0,6,6,0,4,4,1,0,0,1,1,0,1,4,1
KR_6695222234,420,4,-10,40,8,-3,2,5,3,4,1,1,3,2,5,6,1,2,2,0,-1,10,-6,-4,8,4,4,0,2,1,-1,1,-1,4,1
KR_6758324835,420,6,70,57,9,3,4,1,-2,1,3,7,8,1,0,5,5,1,1,0,-1,8,-2,-4,10,6,3,0,1,1,-1,1,-1,3,1
KR_6741873928,420,1,50,-16,-2,3,3,0,0,3,3,3,3,0,-8,0,8,0,0,0,0,-4,3,2,3,5,0,0,2,1,-1,1,1,1,1
KR_6752364318,420,-1,37,-8,4,2,3,1,0,3,3,1,2,1,1,4,3,0,1,1,0,1,-20,3,4,7,-4,0,0,1,1,-1,1,6,1
KR_6387918750,420,0,-16,-8,-1,0,3,3,-1,4,5,-3,0,3,0,2,2,3,3,0,0,3,-4,-2,7,5,2,0,0,1,-1,0,-1,3,1
KR_6367337284,440,3,9,-23,5,4,5,1,-1,2,3,2,4,2,-3,0,3,3,4,1,0,6,0,0,0,0,-5,0,1,1,1,1,-1,2,1
KR_6666201751,420,1,18,-28,3,4,4,0,-4,0,4,1,5,4,3,5,2,-1,1,2,0,0,-32,1,5,6,15,0,0,-1,1,0,1,5,1
KR_6765584319,440,0,14,12,3,-3,3,6,4,4,0,-4,1,5,4,4,0,2,5,3,1,1,-4,-4,9,5,7,0,0,-1,-1,0,1,2,1
KR_6766138796,420,3,9,-4,-3,1,3,2,1,5,4,1,3,2,-4,1,5,-2,0,2,0,-7,102,-2,6,4,0,0,0,0,0,0,1,0,1
KR_6760158827,420,-3,29,6,-4,1,2,1,-2,2,4,-5,1,6,3,4,1,-1,0,1,0,-5,-100,2,4,6,-2,0,0,-1,1,0,1,4,1
KR_6763080312,420,-1,26,10,0,1,3,2,4,7,3,-1,1,2,-1,1,2,-3,1,4,2,5,5,-8,11,3,2,0,0,1,-1,0,1,6,1
KR_6759705864,420,-3,33,-7,-6,-5,0,5,-2,4,6,1,1,0,2,6,4,-2,0,2,0,-1,-6,-3,6,3,3,0,0,1,1,0,-1,5,1
KR_6678630082,420,-1,13,3,1,-4,0,4,-2,3,5,4,4,0,2,3,1,1,3,2,0,6,-3,-1,5,4,4,0,-1,0,1,-1,-1,0,1
KR_6705378687,420,5,114,0,15,2,4,2,7,7,0,0,1,1,4,5,1,2,2,0,0,26,12,5,9,14,0,0,1,1,-1,1,1,2,1
KR_6728035018,420,7,70,5,7,-1,1,2,4,5,1,2,5,3,2,2,0,0,0,0,0,9,-13,4,1,5,5,0,1,1,0,1,1,2,1
KR_6626434887,420,3,44,-12,8,3,3,0,9,10,1,-3,0,3,1,3,2,-2,1,3,0,10,1,3,5,8,5,0,0,1,-1,-1,1,1,1
KR_6762622707,420,3,26,29,2,3,4,1,-1,3,4,1,1,0,0,2,2,-1,0,1,1,0,22,3,3,6,2,0,0,0,0,0,1,0,1
KR_6531649092,420,5,71,40,6,3,5,2,-2,5,7,1,3,2,4,6,2,0,2,2,0,2,0,-2,7,5,3,0,3,-1,1,1,-1,2,1
KR_6509405630,420,4,66,26,10,3,3,0,-2,1,3,1,3,2,8,9,1,0,1,1,0,13,28,2,4,6,0,0,0,1,-1,1,-1,1,1
KR_6756179695,420,-1,-37,13,1,0,3,3,3,7,4,1,1,0,0,4,4,-3,0,3,0,2,2,-5,7,2,-1,0,0,1,0,-1,1,3,1
KR_6656899756,420,2,19,-4,1,-1,1,2,5,6,1,-6,2,8,3,6,3,0,1,1,0,-2,2,1,3,4,0,0,0,1,-1,-1,1,4,1
KR_6407771415,420,4,58,4,11,2,2,0,8,8,0,-1,0,1,2,8,6,0,1,1,-1,7,7,4,4,8,-2,0,1,1,1,1,-1,4,1
KR_6627940699,420,5,47,24,11,1,1,0,6,7,1,-2,2,4,7,7,0,-1,3,4,0,8,2,0,7,7,5,0,2,1,1,1,1,4,1
KR_6765588083,440,1,-15,-21,4,0,0,0,5,5,0,-2,0,2,-1,0,1,2,3,1,0,8,-16,-3,8,5,2,0,0,-1,1,0,1,5,1
KR_6646459466,420,1,27,31,-3,0,2,2,0,5,5,0,4,4,-4,2,6,1,1,0,-3,-7,6,0,5,5,2,0,1,-1,1,1,-1,3,1
KR_6659333033,420,10,129,103,22,5,6,1,10,12,2,3,6,3,3,4,1,1,2,1,3,12,144,-1,3,2,3,1,4,1,1,1,1,1,1
KR_6278082571,420,-1,13,14,-4,3,3,0,-4,1,5,1,3,2,-1,5,6,-3,0,3,0,-4,292,-1,5,4,0,0,1,1,-1,1,1,3,1
KR_6759703512,420,-1,10,-12,3,-1,0,1,5,8,3,-2,0,2,-1,1,2,2,2,0,0,4,3,5,3,8,3,0,1,1,1,1,1,5,1
KR_6738435398,420,0,-12,11,1,2,2,0,4,5,1,2,2,0,-6,0,6,-1,0,1,0,-6,-12,4,5,9,2,0,1,-1,1,-1,1,5,1
KR_6560427068,420,-2,-31,8,-3,-7,1,8,3,5,2,-3,2,5,4,4,0,0,0,0,0,16,4,-1,4,3,-5,0,0,1,0,-1,-1,4,1
KR_6734470644,440,2,12,7,7,4,4,0,-2,0,2,2,2,0,6,7,1,-3,1,4,1,6,-12,0,1,1,3,0,1,1,1,1,1,5,1
KR_6697453014,440,-3,-51,-36,-7,0,4,4,-4,3,7,1,5,4,-4,2,6,0,1,1,0,-15,72,-2,7,5,-5,0,1,1,1,1,-1,6,1
KR_6761077792,420,1,32,8,6,4,4,0,1,5,4,4,4,0,-3,2,5,0,1,1,-1,4,49,6,1,7,-26,0,0,1,1,1,-1,6,1
KR_6750561550,420,2,38,-14,6,1,2,1,-1,0,1,3,6,3,2,3,1,1,2,1,0,13,48,-2,5,3,-26,0,1,1,0,1,-1,6,1
KR_6766220383,420,5,162,21,10,4,5,1,-2,0,2,-1,6,7,8,11,3,1,1,0,2,2,-5,0,3,3,5,0,1,1,0,1,1,1,1
KR_6712203671,420,2,43,14,5,2,3,1,-5,1,6,1,3,2,6,6,0,1,1,0,0,11,6,3,2,5,-1,0,1,1,-1,1,1,4,1
KR_6703389733,440,-1,-33,-20,3,1,3,2,3,3,0,-10,0,10,12,14,2,-3,2,5,2,20,-210,-3,7,4,3,0,-1,1,-1,-1,1,1,1
KR_6705346520,420,3,15,21,7,2,4,2,0,1,1,2,2,0,1,6,5,2,2,0,0,3,5,4,4,8,-1,0,2,1,1,1,-1,1,1
KR_6740863173,440,0,-4,26,-4,4,4,0,1,3,2,-2,3,5,-5,3,8,-2,1,3,-1,-16,9,4,4,8,-1,0,-1,0,0,-1,-1,0,1
KR_6744101213,420,-3,-37,4,-9,-6,0,6,-2,1,3,-1,3,4,-2,4,6,2,2,0,0,-5,435,-1,7,6,0,0,-1,-1,-1,-1,-1,3,1
KR_6734307015,440,2,30,10,5,1,2,1,1,4,3,4,5,1,-1,0,1,0,2,2,0,4,-4,0,9,9,4,0,0,1,1,0,1,5,1
KR_6746781616,420,1,12,-19,-1,2,2,0,-2,2,4,1,3,2,-4,0,4,2,3,1,0,-5,-12,-4,6,2,1,0,1,-1,-1,1,1,1,1
KR_6604203837,420,5,84,28,12,2,2,0,4,6,2,-3,0,3,9,9,0,0,0,0,1,15,1,0,8,8,1,0,1,1,0,1,1,6,1
KR_6762320821,420,0,1,8,3,0,0,0,3,4,1,-2,0,2,2,5,3,0,0,0,1,9,8,3,4,7,-1,0,0,1,1,0,1,4,1
KR_6751129722,440,0,27,-8,0,-1,3,4,0,1,1,3,4,1,-3,2,5,1,2,1,0,2,-38,4,6,10,20,0,-2,-1,1,-1,-1,1,1
KR_6720992193,440,2,57,-7,3,-1,1,2,-2,2,4,-1,1,2,7,9,2,0,0,0,1,1,48,-1,6,5,-23,0,0,1,-1,0,1,1,1
KR_6750269882,420,2,89,32,6,2,3,1,3,3,0,-2,1,3,3,5,2,0,0,0,0,5,-37,3,1,4,-2,0,1,1,1,1,1,2,1
KR_6764334332,420,5,81,28,6,4,7,3,4,6,2,2,2,0,-4,3,7,0,0,0,0,1,-18,1,5,6,6,0,1,1,1,1,1,2,1
KR_6761638460,420,-1,-49,-8,-5,0,1,1,-5,1,6,-1,1,2,1,5,4,0,1,1,0,1,-19,9,1,10,-6,0,-1,-1,1,-1,-1,2,1
KR_6766187445,420,0,83,-12,3,4,5,1,0,5,5,-3,0,3,0,4,4,2,2,0,-1,5,-3,0,4,4,1,0,1,-1,1,1,-1,3,1
KR_6745935482,420,-1,44,-4,1,0,0,0,2,5,3,2,3,1,-1,1,2,-2,0,2,0,-3,-22,3,4,7,-1,0,1,-1,1,1,-1,6,1
KR_6751499488,420,0,5,2,2,3,4,1,0,1,1,-1,2,3,2,5,3,-2,0,2,0,-4,1,7,3,10,-2,0,0,1,-1,0,1,4,1
KR_6765637572,420,2,23,23,9,2,4,2,5,5,0,1,1,0,1,6,5,0,3,3,0,13,-7,-3,8,5,4,0,1,0,0,1,1,0,1
KR_6756007117,420,-2,11,-12,2,-1,2,3,-2,2,4,-1,1,2,3,4,1,3,3,0,0,-4,-2,5,4,9,-2,0,0,1,0,0,-1,2,1
KR_6739601119,420,0,8,43,-2,-4,0,4,6,7,1,-2,0,2,-2,1,3,0,1,1,2,4,-9,-2,10,8,-3,0,2,-1,-1,1,1,4,1
KR_6761600739,440,8,140,64,22,1,4,3,5,7,2,8,9,1,6,7,1,2,3,1,1,7,12,2,3,5,0,0,3,1,0,1,1,3,1
KR_6758047814,440,-1,29,12,-1,-1,1,2,1,1,0,1,2,1,-3,1,4,1,2,1,0,-4,1,1,4,5,-3,0,0,1,1,0,1,6,1
KR_6754543122,420,0,-85,-12,-2,-1,0,1,3,4,1,-2,3,5,0,0,0,-2,1,3,1,4,2,-3,5,2,2,0,-1,-1,-1,1,1,1,1
KR_6758060476,440,5,40,20,12,3,3,0,-1,2,3,2,4,2,6,7,1,2,2,0,0,6,5,-1,3,2,-3,0,2,0,0,1,-1,0,1
KR_6275192817,420,1,28,0,4,0,1,1,5,6,1,-1,2,3,0,2,2,0,0,0,0,9,0,-1,5,4,4,0,1,-1,1,1,-1,4,1
KR_6756206655,420,-2,9,-20,0,0,3,3,2,4,2,-1,2,3,0,3,3,-1,0,1,0,0,-12,-2,6,4,-3,0,-1,1,1,-1,1,6,1
KR_6757565293,420,2,40,22,10,5,5,0,2,4,2,2,3,1,-1,1,2,2,2,0,0,7,-3,2,2,4,2,0,0,1,1,1,1,6,1
KR_6435402918,420,-1,15,-14,-9,-5,0,5,-3,2,5,-1,2,3,0,3,3,0,1,1,0,-9,9,2,5,7,1,0,-1,0,-1,-1,-1,0,1
KR_6764943854,420,1,44,-13,10,0,2,2,1,8,7,4,6,2,4,6,2,1,2,1,0,14,-5,-1,5,4,1,0,1,1,-1,1,1,5,1
KR_6745227657,420,2,11,9,2,3,4,1,0,2,2,4,5,1,-5,0,5,0,0,0,0,1,1,-3,7,4,0,0,-2,1,-1,-1,-1,1,1
KR_6749892708,420,6,104,7,7,2,2,0,3,4,1,1,2,1,1,2,1,0,1,1,2,10,-10,1,3,4,2,0,1,-1,1,1,1,3,1
KR_6485516461,420,0,-25,3,0,-3,2,5,2,4,2,0,2,2,-1,1,2,2,2,0,0,4,2,-6,7,1,5,0,1,1,1,-1,-1,5,1
KR_6755008566,440,-1,14,-8,10,2,4,2,7,7,0,1,2,1,1,8,7,-1,1,2,2,12,15,4,0,4,1,0,1,1,-1,1,1,4,1
KR_6684635048,420,3,36,51,3,2,2,0,3,5,2,0,2,2,-3,2,5,1,1,0,1,-5,-40,0,5,5,1,0,1,1,1,1,1,5,1
KR_6648895062,420,2,-10,8,5,2,3,1,0,1,1,1,3,2,1,2,1,1,1,0,0,8,3,0,6,6,0,0,0,1,-1,1,-1,4,1
KR_6761358090,420,-1,19,-14,3,2,3,1,-4,1,5,3,3,0,1,2,1,1,1,0,2,1,10,-1,5,4,4,0,0,0,-1,0,1,0,1
KR_6695908174,420,0,21,8,-2,0,1,1,-1,2,3,4,5,1,-1,1,2,-4,0,4,0,-3,13,-5,8,3,-1,0,0,0,-1,0,1,0,1
KR_6756855920,420,-1,-60,-9,5,1,2,1,5,6,1,2,4,2,-3,3,6,0,0,0,0,3,9,6,3,9,-5,0,0,0,0,0,-1,0,1
KR_6713196750,420,1,15,8,0,-3,0,3,-4,2,6,2,5,3,5,5,0,0,2,2,0,-4,5,-4,8,4,-1,0,-1,1,-1,-1,1,6,1
KR_6686690648,420,2,2,-12,8,3,4,1,1,3,2,2,6,4,1,3,2,1,2,1,0,11,12,3,3,6,-2,0,1,-1,1,1,-1,2,1
KR_6765666650,420,3,-35,5,10,-1,1,2,3,3,0,2,3,1,3,4,1,3,3,0,0,15,-4,-1,4,3,0,0,-1,1,-1,-1,1,3,1
KR_6714741787,420,5,83,3,17,3,3,0,4,7,3,3,4,1,4,5,1,3,3,0,0,21,23,5,1,6,-6,0,2,1,0,1,1,4,1
KR_6756018049,420,0,-54,-12,2,0,1,1,1,4,3,1,2,1,0,3,3,0,0,0,0,5,14,3,4,7,-4,0,0,-1,-1,0,-1,3,1
KR_6760716592,420,0,20,-1,4,0,3,3,3,4,1,5,7,2,-4,0,4,0,0,0,0,4,4,4,3,7,-4,0,0,-1,1,0,-1,5,1
KR_6749477942,420,-1,-55,-5,0,-2,3,5,0,2,2,-1,3,4,-1,3,4,4,4,0,0,5,30,6,3,9,-2,0,0,1,-1,-1,-1,1,1
KR_6755520263,420,2,116,44,4,1,2,1,0,3,3,2,3,1,1,2,1,0,0,0,3,7,15,-1,6,5,0,0,1,1,-1,1,1,2,1
KR_6748475677,420,0,20,18,4,1,1,0,3,4,1,1,2,1,1,2,1,-2,0,2,0,6,-21,3,3,6,20,0,0,1,0,0,1,2,1
KR_6716151654,420,4,106,-7,9,4,4,0,0,2,2,1,4,3,4,4,0,0,2,2,1,6,-5,0,4,4,2,0,1,1,1,1,1,6,1
KR_6758765134,420,5,7,32,8,3,4,1,3,3,0,-1,2,3,3,4,1,0,1,1,0,10,32,1,4,5,-1,0,2,1,1,1,-1,5,1
KR_6758808228,420,4,67,17,2,0,1,1,1,1,0,0,0,0,1,6,5,0,0,0,-1,3,42,-1,8,7,-10,0,2,1,1,1,1,1,1
KR_6761612206,420,0,-57,-9,-1,-1,1,2,5,5,0,-1,1,2,-1,3,4,-3,1,4,-1,-1,-4,5,4,9,-3,0,-2,-1,1,-1,-1,2,1
KR_6631385212,420,1,11,28,3,2,2,0,-3,2,5,1,2,1,2,2,0,1,1,0,0,2,-1,-1,6,5,3,0,1,1,1,1,-1,4,1
KR_6604084882,440,2,8,4,2,4,4,0,0,7,7,-4,1,5,2,3,1,0,1,1,0,8,17,2,2,4,-3,0,1,1,0,1,-1,6,1
KR_6703943589,420,2,15,16,1,2,2,0,-2,1,3,1,3,2,0,4,4,0,2,2,0,-3,-15,0,8,8,6,0,0,1,-1,0,-1,1,1
KR_6707215046,420,-2,17,1,1,-3,2,5,2,5,3,0,0,0,3,7,4,-1,0,1,0,4,-2,-2,7,5,5,0,0,-1,1,0,1,2,1
KR_6743988190,440,5,74,22,10,0,0,0,2,6,4,1,4,3,2,5,3,5,5,0,0,7,6,-2,5,3,1,0,1,1,1,1,-1,3,1
KR_6686390664,440,-1,-54,-11,-3,-2,2,4,0,5,5,1,3,2,-4,5,9,2,4,2,-1,-3,-9,-3,6,3,4,0,0,0,1,-1,-1,0,1
KR_6755661459,420,1,69,16,6,-1,2,3,-3,0,3,1,2,1,8,9,1,1,1,0,1,6,4,2,5,7,6,0,1,1,1,1,1,5,1
KR_6756729367,420,3,35,8,11,0,0,0,2,3,1,0,2,2,7,9,2,2,2,0,1,19,12,5,3,8,-1,0,3,1,-1,1,1,3,1
KR_6763088620,420,4,138,-40,9,3,3,0,7,8,1,3,3,0,-4,0,4,0,1,1,0,6,378,5,2,7,1,0,3,0,1,1,1,0,1
KR_6758483376,420,4,69,25,4,3,3,0,-1,4,5,-2,2,4,4,6,2,0,1,1,0,-3,-11,-4,9,5,10,0,1,1,1,1,1,3,1
KR_6685204358,420,7,145,6,8,2,2,0,0,3,3,6,7,1,1,2,1,-1,0,1,1,7,10,3,2,5,0,0,5,1,1,1,1,6,1
KR_6736024613,420,4,45,20,10,8,8,0,-2,0,2,6,7,1,1,5,4,-3,1,4,0,0,12,6,1,7,2,0,2,-1,1,1,1,1,1
KR_6753195303,420,4,77,27,4,4,5,1,0,2,2,-3,2,5,3,4,1,0,1,1,1,-3,4,1,0,1,0,0,1,1,-1,1,1,5,1
KR_6722604191,420,2,82,-5,6,-2,3,5,5,6,1,1,3,2,3,5,2,-1,0,1,2,11,4,0,7,7,4,0,2,1,-1,1,1,4,1
KR_6648415505,420,3,39,32,17,-2,2,4,4,5,1,1,5,4,10,12,2,4,4,0,1,24,-7,0,5,5,-1,0,4,1,1,1,1,4,1
KR_6757974998,420,0,-32,-28,3,0,2,2,1,3,2,2,2,0,3,5,2,-3,0,3,0,4,-50,0,4,4,-4,0,0,0,0,0,1,0,1
KR_6682700350,420,-1,-39,-12,2,-2,1,3,2,3,1,-1,4,5,1,3,2,2,2,0,0,-2,9,3,3,6,-1,0,0,-1,-1,-1,1,1,1
KR_6736928540,420,3,50,0,2,1,4,3,1,1,0,-2,0,2,2,3,1,0,1,1,0,1,-111,5,3,8,4,0,0,-1,-1,0,-1,3,1
KR_6716618744,420,4,40,16,4,3,4,1,-4,2,6,2,4,2,3,5,2,0,0,0,1,3,15,1,5,6,0,0,2,1,-1,1,1,1,1
KR_6748641418,420,3,52,16,11,2,3,1,6,8,2,3,4,1,-1,0,1,1,2,1,0,6,-3,-3,6,3,2,0,0,-1,1,1,1,6,1
KR_6736303491,420,6,87,35,16,2,3,1,7,9,2,5,5,0,3,4,1,-1,0,1,0,17,-44,6,3,9,2,0,2,1,1,1,1,5,1
KR_6765943603,420,2,53,1,4,-2,1,3,4,5,1,0,2,2,2,3,1,0,1,1,0,3,7,1,7,8,4,0,2,1,1,1,1,4,1
KR_6747729898,420,4,9,15,11,-4,0,4,5,8,3,1,5,4,10,12,2,-1,1,2,1,19,5,-4,8,4,7,0,0,1,-1,0,1,5,1
KR_6701568341,420,5,72,8,6,2,3,1,2,3,1,5,5,0,-2,0,2,-1,1,2,0,14,-3,0,5,5,2,0,-1,1,1,-1,-1,3,1
KR_6728783844,420,3,36,3,15,0,1,1,3,4,1,5,5,0,6,6,0,1,2,1,0,19,7,2,3,5,-5,0,2,1,-1,1,1,1,1
KR_6761029832,440,1,76,-29,0,-4,1,5,4,7,3,2,3,1,-2,0,2,0,3,3,-1,6,-2,1,2,3,2,0,3,-1,-1,1,-1,3,1
KR_6728235781,440,-2,-21,-16,-1,-2,1,3,3,3,0,-5,6,11,0,1,1,3,3,0,0,4,17,2,5,7,2,0,-1,1,-1,-1,-1,1,1
KR_6675043859,420,2,-2,21,9,3,5,2,7,9,2,3,4,1,-1,4,5,-3,1,4,0,7,-9,0,4,4,-1,0,2,1,-1,1,1,1,1
KR_6622122952,420,1,-49,16,3,0,1,1,8,8,0,-5,0,5,1,7,6,-1,2,3,3,8,-1,-4,8,4,-2,0,0,1,1,-1,1,2,1
KR_6751064752,420,-3,-70,0,-3,-4,3,7,-2,0,2,2,8,6,1,3,2,0,0,0,-1,1,-314,-2,4,2,0,0,-1,1,-1,-1,-1,6,1
KR_6629521975,420,2,24,-5,9,0,1,1,5,5,0,2,2,0,1,2,1,1,2,1,0,15,0,1,5,6,5,0,1,-1,1,1,1,4,1
KR_6757935923,440,0,56,-28,2,5,6,1,-4,1,5,0,2,2,1,5,4,0,1,1,1,-5,-36,-4,6,2,21,0,2,-1,1,1,1,3,1
KR_6746701482,440,1,86,3,1,-2,1,3,0,1,1,0,2,2,3,6,3,0,1,1,0,-1,-2,0,4,4,-1,0,1,1,1,1,1,1,1
KR_6759640165,420,-1,49,-8,-6,1,1,0,-1,2,3,-4,2,6,-1,1,2,-1,2,3,0,-7,4,3,3,6,-6,0,0,-1,1,-1,-1,4,1
KR_6761248467,420,-1,0,31,-6,-4,0,4,-3,2,5,3,5,2,-2,4,6,0,0,0,0,-10,0,-2,8,6,-1,0,0,1,1,-1,-1,6,1
KR_6744638052,420,2,80,-16,1,2,3,1,-2,0,2,2,3,1,0,7,7,-1,0,1,-1,-2,-122,0,5,5,-4,0,0,-1,1,1,-1,6,1
KR_6757221164,420,0,52,-40,0,0,1,1,2,3,1,0,2,2,-3,2,5,1,1,0,0,-2,22,0,3,3,-19,0,0,-1,-1,-1,1,1,1
KR_6765745790,420,1,-17,-3,5,3,5,2,3,4,1,2,3,1,-2,1,3,-1,0,1,0,-1,17,3,4,7,-4,0,1,-1,1,1,1,2,1
KR_6682821880,420,3,50,-27,9,5,5,0,8,10,2,-3,2,5,-2,2,4,1,2,1,0,14,-62,-1,5,4,-2,0,0,1,-1,0,-1,4,1
KR_6730272487,420,0,64,5,-1,-1,2,3,-5,2,7,3,4,1,2,5,3,0,1,1,0,-6,4,1,5,6,2,0,0,-1,1,0,-1,4,1
KR_6753637773,420,4,-1,38,4,4,4,0,0,4,4,0,3,3,0,1,1,0,2,2,0,3,-138,4,4,8,1,0,2,1,1,1,-1,3,1
KR_6752059326,420,3,41,15,5,4,6,2,-1,3,4,-1,2,3,5,5,0,-2,0,2,0,10,7,2,3,5,-5,0,0,1,0,0,1,4,1
KR_6692358819,420,2,38,4,4,-7,0,7,1,2,1,5,6,1,4,5,1,1,2,1,0,5,-9,0,4,4,-3,0,-1,1,-1,-1,1,3,1
KR_6749853534,420,8,101,40,13,5,6,1,3,3,0,2,4,2,1,5,4,2,4,2,-4,3,-9,-3,7,4,0,0,2,1,0,1,-1,4,1
KR_6670240480,440,-1,-11,-12,1,3,3,0,3,4,1,-4,1,5,1,4,3,-2,0,2,0,5,-90,2,6,8,2,0,1,-1,1,1,-1,1,1
KR_6597950328,420,4,-29,43,10,2,3,1,3,5,2,4,4,0,1,4,3,0,1,1,0,14,9,5,2,7,0,0,3,1,1,1,-1,1,1
KR_6760676395,420,3,76,15,9,-1,1,2,0,1,1,6,6,0,5,7,2,-1,2,3,1,11,-426,5,1,6,0,0,0,1,-1,1,1,6,1
KR_6757330542,420,2,-33,16,3,2,3,1,0,3,3,1,2,1,2,3,1,-2,0,2,0,-4,29,-2,5,3,1,0,-1,1,-1,-1,-1,6,1
KR_6271034487,420,-1,-63,32,-1,3,3,0,-2,1,3,-2,1,3,2,2,0,-2,1,3,0,-2,6,-4,8,4,0,0,1,-1,1,1,-1,4,1
KR_6727308352,420,-1,0,16,2,-2,1,3,3,4,1,4,5,1,-4,1,5,1,1,0,1,-1,5,-4,6,2,-2,0,0,1,-1,0,1,2,1
KR_6742732516,420,-1,12,-31,-2,-1,1,2,0,4,4,0,3,3,0,4,4,-1,1,2,0,-1,-21,1,5,6,-2,0,-1,-1,-1,-1,-1,3,1
KR_6686544798,420,4,14,7,4,3,4,1,0,3,3,-1,0,1,2,4,2,0,3,3,0,16,-356,-1,6,5,0,0,2,1,1,1,-1,6,1
KR_6687736773,420,0,1,12,1,-1,1,2,4,5,1,2,4,2,-3,4,7,-1,1,2,0,3,31,4,3,7,4,0,0,1,-1,0,1,6,1
KR_6624262432,420,2,29,11,7,-3,2,5,-2,3,5,6,8,2,4,4,0,2,3,1,-1,1,8,0,3,3,1,0,2,1,1,1,-1,6,1
KR_6749560047,440,2,-104,21,9,-3,3,6,4,6,2,3,4,1,1,8,7,4,6,2,1,23,-3,-2,9,7,3,0,0,-1,1,-1,1,5,1
KR_6604077044,440,4,115,9,7,-1,1,2,1,6,5,1,4,3,5,7,2,1,2,1,0,3,-29,-1,4,3,1,0,0,1,-1,0,1,5,1
KR_6729651546,420,1,-31,52,6,1,2,1,4,5,1,-1,2,3,0,5,5,2,3,1,-1,6,15,5,4,9,1,0,1,1,1,1,-1,4,1
KR_6609037273,420,0,-9,36,-2,-2,0,2,2,3,1,3,5,2,-2,3,5,-3,1,4,-2,-11,-4,-3,6,3,-1,0,0,1,1,0,-1,5,1
KR_6753592009,420,5,133,28,14,-1,0,1,6,7,1,0,4,4,5,7,2,4,4,0,0,17,20,0,5,5,2,0,2,1,-1,1,1,5,1
KR_6725309100,420,4,85,11,5,0,1,1,-5,1,6,2,5,3,8,8,0,0,1,1,0,1,-14,-1,5,4,20,0,1,1,-1,1,1,6,1
KR_6758747737,420,1,16,24,-2,1,1,0,-1,1,2,-3,0,3,0,2,2,1,1,0,0,1,4,2,4,6,-1,0,1,-1,1,1,1,4,1
KR_6762714155,420,0,19,-14,3,4,4,0,2,5,3,1,3,2,-3,1,4,-1,0,1,0,-1,-1,-4,6,2,1,0,0,-1,1,1,-1,3,1
KR_6743885662,440,2,66,20,7,0,1,1,10,11,1,-2,0,2,-1,1,2,0,0,0,1,5,35,0,3,3,0,0,0,1,-1,0,1,2,1
KR_6760773988,440,1,90,-15,4,-1,2,3,6,6,0,-3,3,6,3,7,4,-1,0,1,0,7,39,4,2,6,2,0,2,-1,1,1,1,3,1
KR_6601530033,420,0,8,-9,-2,3,5,2,-3,2,5,1,3,2,-3,1,4,0,1,1,0,-9,12,5,4,9,1,0,1,-1,1,1,1,6,1
KR_6729510622,420,0,-15,-4,3,1,3,2,1,1,0,4,4,0,-2,2,4,-1,0,1,0,0,95,3,5,8,-3,0,-1,1,-1,-1,-1,5,1
KR_6766533431,420,2,91,12,-2,1,3,2,0,3,3,-7,1,8,3,6,3,1,1,0,-1,-4,4,-1,5,4,0,0,1,1,1,1,-1,3,1
KR_6754623291,420,1,1,-24,8,2,3,1,3,3,0,0,3,3,2,3,1,1,2,1,1,7,5,-2,6,4,0,0,0,1,-1,0,1,2,1
KR_6757576105,420,1,5,24,4,1,1,0,2,2,0,0,0,0,1,2,1,0,0,0,0,8,-1,-1,5,4,0,0,0,1,1,0,1,5,1
KR_6750315194,420,2,26,0,8,0,2,2,1,3,2,-1,1,2,9,9,0,-1,0,1,0,8,0,-6,9,3,-1,0,0,1,-1,-1,-1,3,1
KR_6641236136,420,2,-49,43,-1,-3,2,5,0,3,3,5,7,2,-2,3,5,-1,0,1,0,-5,8,-1,4,3,-2,0,-1,1,-1,-1,-1,4,1
KR_6759874407,420,3,42,-1,3,0,1,1,2,3,1,5,6,1,-3,0,3,-1,0,1,1,2,14,3,2,5,1,0,1,-1,-1,1,1,5,1
KR_6685968479,420,1,23,9,7,6,7,1,-3,1,4,6,6,0,-1,2,3,-1,1,2,0,-2,225,1,7,8,4,0,2,1,1,1,1,5,1
KR_6744935067,420,4,33,35,3,2,2,0,6,6,0,-2,1,3,-2,0,2,-1,0,1,1,0,-2,3,3,6,0,0,2,-1,1,1,1,3,1
KR_6761855090,440,-5,-37,-8,-15,1,1,0,-11,1,12,1,2,1,-4,1,5,-2,0,2,0,-11,-16,-3,8,5,-1,0,-1,1,0,-1,-1,5,1
KR_6692548293,420,6,-13,-4,17,7,7,0,4,5,1,3,5,2,1,4,3,2,2,0,1,14,-47,1,3,4,21,0,0,-1,-1,1,1,1,1
KR_6629578359,420,5,23,-3,9,2,2,0,5,5,0,0,1,1,1,2,1,1,1,0,0,9,2,4,2,6,8,0,1,1,1,1,1,4,1
KR_6697655944,440,1,-21,15,7,-3,1,4,0,3,3,2,4,2,7,8,1,1,2,1,0,8,48,3,2,5,-24,0,-1,1,-1,1,1,6,1
KR_6748710570,440,0,29,-13,5,0,1,1,-1,2,3,0,0,0,4,4,0,2,3,1,1,5,4,-2,4,2,0,0,0,1,1,1,1,3,1
KR_6764223885,420,1,58,28,3,-3,0,3,2,5,3,1,1,0,5,6,1,-2,1,3,0,4,-117,-1,5,4,3,0,0,1,1,0,1,1,1
KR_6684113511,440,1,30,12,0,-4,0,4,3,4,1,1,5,4,-2,3,5,2,2,0,1,5,12,1,4,5,5,0,-1,1,-1,-1,1,3,1
KR_6717692687,420,7,134,13,17,5,6,1,-1,3,4,1,1,0,12,14,2,0,2,2,0,12,5,3,2,5,-2,0,2,1,-1,1,-1,6,1
KR_6765735800,420,1,-39,12,8,3,3,0,0,1,1,3,5,2,1,2,1,1,2,1,0,6,-1,0,6,6,4,0,0,1,1,0,1,5,1
KR_6599602396,420,5,40,28,9,-2,3,5,4,5,1,8,8,0,-1,1,2,0,0,0,0,14,-8,0,3,3,4,0,1,-1,1,1,1,2,1
KR_6730862778,420,-2,-62,-28,-2,-9,1,10,4,6,2,-1,1,2,3,5,2,1,2,1,0,9,17,0,7,7,3,0,1,1,0,1,1,4,1
KR_6762255465,420,3,51,-4,11,-1,0,1,-2,2,4,1,3,2,11,12,1,2,2,0,0,12,14,2,5,7,0,0,1,1,-1,1,1,5,1
KR_6731757582,420,-1,51,4,-1,1,1,0,0,4,4,2,4,2,-5,1,6,1,1,0,0,-4,4,0,3,3,0,0,0,1,1,0,1,6,1
KR_6758290441,420,0,-1,8,-2,0,1,1,0,1,1,0,3,3,-4,2,6,2,2,0,0,1,20,2,6,8,-2,0,0,1,-1,0,1,3,1
KR_6751276083,440,0,-44,-37,1,0,2,2,0,3,3,6,7,1,-4,2,6,-1,0,1,-1,14,34,2,3,5,2,0,-2,-1,-1,-1,-1,4,1
KR_6748646825,440,4,-14,0,9,1,4,3,2,5,3,-2,0,2,5,5,0,3,3,0,1,13,8,4,1,5,-3,0,0,0,-1,1,1,0,1
KR_6696892676,420,4,50,31,15,1,2,1,9,12,3,0,2,2,3,4,1,2,2,0,0,23,-5,4,3,7,5,0,1,1,1,1,1,3,1
KR_6711678288,420,-1,-75,-27,-3,-5,0,5,2,3,1,-2,1,3,5,5,0,-3,0,3,-1,4,-1,-2,6,4,-6,0,0,1,1,0,-1,3,1
KR_6756637808,420,1,-48,8,2,2,3,1,1,2,1,1,4,3,0,3,3,-2,0,2,1,-1,-4,-2,3,1,0,0,0,-1,1,0,1,3,1
KR_6621344233,420,2,43,-12,9,1,3,2,5,5,0,1,3,2,1,2,1,1,1,0,0,11,-1,-3,8,5,4,0,0,1,1,1,1,2,1
KR_6763069696,440,2,64,0,0,2,4,2,-1,0,1,1,3,2,-1,2,3,-1,1,2,0,-6,-9,-3,6,3,1,0,0,1,-1,0,-1,1,1
KR_6748810010,440,7,151,48,11,3,5,2,-1,1,2,5,5,0,4,6,2,0,0,0,0,8,-14,-2,5,3,6,0,2,1,1,1,1,5,1
KR_6763505561,420,2,-12,28,1,2,2,0,0,3,3,0,2,2,0,0,0,-1,0,1,0,-5,9,4,5,9,2,0,1,0,1,1,-1,0,1
KR_6696254328,420,4,-13,0,8,3,3,0,6,8,2,4,5,1,-4,0,4,-1,1,2,1,10,-18,5,4,9,1,0,0,-1,1,1,1,1,1
KR_6761677019,420,0,91,9,-1,3,4,1,-1,2,3,0,1,1,-4,1,5,1,3,2,1,-1,-109,3,3,6,-3,0,3,-1,1,1,1,1,1
KR_6764127976,440,1,16,-8,-1,-1,1,2,1,4,3,2,3,1,1,5,4,-4,1,5,0,-2,31,6,2,8,-7,0,0,1,1,1,-1,4,1
KR_6763996067,440,3,41,28,15,0,1,1,9,11,2,3,4,1,4,4,0,-1,0,1,0,19,5,2,3,5,-2,0,1,1,1,1,-1,1,1
KR_6757040969,420,1,-11,16,5,-2,2,4,0,4,4,2,4,2,5,7,2,0,1,1,0,6,-2,0,5,5,2,0,2,-1,1,1,-1,3,1
KR_6559104409,420,0,35,-23,-1,0,2,2,-1,4,5,-1,2,3,4,4,0,-3,2,5,0,-8,-1,2,2,4,2,0,-1,1,-1,-1,1,4,1
KR_6741577762,420,-2,4,-21,-7,0,2,2,-2,0,2,-8,1,9,2,4,2,1,2,1,-2,-11,23,1,4,5,-2,0,-1,-1,-1,-1,1,2,1
KR_6764526277,420,3,22,7,0,2,2,0,1,4,3,0,3,3,-4,0,4,1,1,0,0,3,-27,-1,7,6,-3,0,0,-1,-1,1,1,6,1
KR_6730449830,420,-1,5,-4,3,-1,1,2,4,6,2,2,2,0,-3,0,3,1,3,2,0,6,35,6,2,8,-14,0,0,1,1,-1,1,4,1
KR_6632970682,420,-1,-17,12,0,0,2,2,1,2,1,-2,2,4,-1,0,1,2,2,0,0,1,-4,-1,5,4,4,0,0,-1,1,0,-1,2,1
KR_6716715831,420,4,54,15,4,-2,1,3,2,6,4,1,2,1,4,8,4,-1,0,1,0,17,-117,-6,8,2,4,0,1,-1,-1,1,-1,6,1
KR_6748143984,420,2,6,-4,8,3,5,2,2,4,2,-3,0,3,3,4,1,3,4,1,0,11,5,2,5,7,6,0,1,1,1,1,1,5,1
KR_6671125180,420,2,-2,11,11,7,8,1,2,3,1,1,1,0,2,3,1,-1,0,1,0,13,10,9,2,11,-7,0,0,1,1,1,1,1,1
KR_6419272191,420,2,59,16,3,2,2,0,1,4,3,-2,0,2,3,3,0,-1,0,1,0,2,-2,-2,7,5,0,0,-1,1,-1,-1,1,3,1
KR_6724881964,420,0,18,-20,0,7,8,1,-2,1,3,4,4,0,-6,1,7,-3,2,5,0,-5,9,1,6,7,0,0,1,-1,1,-1,1,3,1
KR_6525976979,420,3,3,4,7,3,4,1,2,5,3,-1,3,4,2,3,1,1,2,1,0,11,-49,-1,6,5,1,0,1,1,-1,1,1,4,1
KR_6688946836,420,-2,0,-12,-1,1,4,3,-2,0,2,0,0,0,-2,0,2,2,2,0,0,-2,5,-2,7,5,3,0,0,-1,-1,-1,-1,3,1
KR_6757563039,420,-1,-12,14,2,-1,1,2,2,3,1,3,3,0,-1,1,2,-1,0,1,0,1,3,2,6,8,3,0,0,-1,-1,0,1,1,1
KR_6764214447,420,6,114,-5,11,2,3,1,7,8,1,4,8,4,2,2,0,-4,0,4,0,3,25,-2,4,2,-3,0,2,1,0,1,1,6,1
KR_6757149855,420,1,36,11,-1,3,3,0,-5,1,6,3,5,2,-4,4,8,2,2,0,1,-9,-38,-1,6,5,1,0,-1,1,-1,-1,1,1,1
KR_6736010603,420,3,38,-4,3,3,3,0,-1,2,3,-1,5,6,0,3,3,2,3,1,0,0,-5,3,4,7,-2,0,0,-1,1,1,1,6,1
KR_6738010591,420,8,87,13,13,2,3,1,6,6,0,3,6,3,2,2,0,0,0,0,0,13,8,-2,6,4,4,0,3,1,1,1,1,3,1
KR_6737736406,420,1,18,8,5,1,1,0,-1,4,5,0,2,2,3,4,1,2,3,1,0,3,-19,-6,9,3,8,0,0,1,1,0,1,3,1
KR_6758089601,420,-1,32,8,-5,-4,0,4,3,3,0,3,3,0,-1,3,4,-6,1,7,0,-4,7,-3,5,2,-21,0,0,-1,-1,0,1,5,1
KR_6676752449,420,2,-11,28,6,-1,3,4,1,1,0,2,3,1,4,6,2,0,0,0,-1,8,5,0,4,4,-3,0,-1,-1,1,-1,-1,4,1
KR_6753941722,420,3,49,10,7,-1,2,3,0,1,1,2,3,1,4,4,0,2,2,0,0,7,-1,3,5,8,-2,0,1,1,-1,1,1,2,1
KR_6764097319,420,0,52,-24,1,-2,2,4,-1,1,2,2,3,1,2,5,3,0,0,0,0,1,-11,-9,12,3,4,0,2,-1,1,1,-1,4,1
KR_6703470729,420,2,62,17,10,1,1,0,2,5,3,6,6,0,2,5,3,-1,1,2,0,11,4,1,6,7,4,0,1,1,1,1,1,3,1
KR_6441002265,420,3,-34,5,5,2,2,0,2,5,3,5,5,0,-4,0,4,0,1,1,0,4,79,-3,9,6,-1,0,0,-1,1,0,-1,3,1
KR_6703346474,420,-2,-13,-12,4,2,3,1,-3,1,4,3,3,0,1,3,2,1,2,1,0,3,28,1,8,9,1,0,1,1,1,1,-1,1,1
KR_6700998732,420,-1,-4,-11,-1,2,5,3,-6,3,9,2,4,2,1,4,3,0,0,0,0,-6,1,-5,6,1,3,0,-1,-1,-1,-1,-1,5,1
KR_6764383019,440,3,68,12,16,3,4,1,3,3,0,1,3,2,8,11,3,1,2,1,1,18,-5,0,2,2,4,0,3,1,1,1,1,4,1
KR_6683768372,420,3,29,37,-2,-3,2,5,-7,0,7,2,3,1,3,4,1,3,3,0,-1,-5,-3,-3,6,3,6,0,2,1,1,1,-1,5,1
KR_6753790711,420,3,1,-8,10,-1,1,2,1,3,2,9,9,0,1,6,5,0,0,0,0,9,-5,0,2,2,2,0,1,-1,-1,1,1,2,1
KR_6685923150,420,4,43,24,3,1,1,0,2,4,2,2,2,0,-1,0,1,-1,0,1,0,6,-51,2,6,8,0,0,0,1,-1,0,-1,4,1
KR_6744064842,420,4,44,0,6,4,5,1,0,4,4,0,0,0,2,2,0,0,1,1,0,-2,-1,1,4,5,0,0,1,-1,1,1,1,1,1
KR_6748198935,440,-1,43,-17,5,0,3,3,1,6,5,2,2,0,1,2,1,1,2,1,0,4,-5,1,2,3,3,0,0,1,0,0,1,4,1
KR_6724324934,420,2,30,4,4,-1,1,2,8,8,0,2,2,0,-3,0,3,-2,0,2,0,4,11,-2,4,2,-1,0,0,-1,1,1,-1,1,1
KR_6763950789,420,-2,-14,-27,0,3,5,2,0,1,1,3,4,1,-2,0,2,-4,2,6,-1,-4,-18,4,4,8,0,0,0,1,-1,0,-1,6,1
KR_6727894718,440,11,120,75,23,7,9,2,4,7,3,3,3,0,7,7,0,2,2,0,3,26,20,3,2,5,3,0,3,1,1,1,1,5,1
KR_6600878794,420,0,88,-20,-3,6,6,0,-3,3,6,1,3,2,-3,2,5,-4,1,5,0,-13,-142,3,4,7,3,0,0,1,-1,-1,-1,5,1
KR_6757763543,420,-2,-30,28,-3,0,1,1,-3,1,4,0,1,1,0,3,3,0,2,2,0,-5,-19,-3,6,3,1,0,0,1,0,0,-1,5,1
KR_6764632434,420,2,40,13,6,0,2,2,1,2,1,1,4,3,5,7,2,-1,0,1,-1,10,0,1,2,3,2,0,0,1,-1,0,-1,1,1
KR_6679618241,420,3,31,14,9,4,5,1,0,0,0,6,7,1,-1,1,2,0,0,0,0,13,5,-1,7,6,4,0,1,-1,1,1,1,4,1
KR_6737075434,420,3,-2,4,2,2,3,1,0,3,3,-2,2,4,2,3,1,0,1,1,0,0,-7,-1,5,4,-1,0,-1,0,-1,-1,1,0,1
KR_6744283491,440,-1,45,-24,4,3,4,1,2,5,3,0,0,0,0,3,3,-1,2,3,0,2,2,-3,6,3,0,0,0,-1,-1,0,1,2,1
KR_6760026905,440,2,-69,23,-4,4,5,1,0,4,4,1,4,3,-5,0,5,-4,0,4,1,-7,-5,-4,4,0,-1,0,-1,0,1,-1,1,0,1
KR_6740346231,420,-2,-36,-29,-3,1,3,2,0,3,3,2,5,3,-7,0,7,1,2,1,-1,-4,-9,-6,9,3,2,0,-2,-1,-1,-1,-1,2,1
KR_6678062110,420,0,49,7,1,4,8,4,-4,1,5,1,3,2,-1,3,4,1,1,0,3,-1,-4,7,4,11,6,0,1,1,1,1,-1,5,1
KR_6737325578,420,1,-17,-67,13,1,1,0,1,3,2,5,5,0,6,10,4,0,3,3,1,10,-5,1,3,4,-1,0,-1,1,-1,1,1,4,1
KR_6761344632,420,0,21,5,-1,5,7,2,-4,2,6,2,2,0,0,3,3,-4,1,5,0,-8,-10,0,4,4,2,0,-1,-1,1,-1,1,5,1
KR_6765631974,420,-2,-9,-16,-9,2,5,3,-1,2,3,-3,0,3,-6,2,8,-1,0,1,1,-7,1,6,5,11,1,0,0,0,-1,-1,1,0,1
KR_6696486140,420,1,57,-7,4,-1,2,3,3,6,3,1,6,5,0,2,2,1,2,1,0,5,8,4,5,9,5,0,0,1,1,1,-1,6,1
KR_6763797070,420,2,46,14,9,-3,0,3,5,5,0,4,8,4,0,3,3,3,4,1,0,8,-12,0,7,7,8,0,0,1,1,1,1,4,1
KR_6744385842,420,0,-39,6,1,-2,0,2,4,5,1,2,3,1,-1,2,3,-2,0,2,0,4,54,2,1,3,-2,0,0,1,1,0,-1,5,1
KR_6752571492,420,7,124,50,11,-1,1,2,5,5,0,2,2,0,5,5,0,0,0,0,0,11,12,4,4,8,3,0,2,1,1,1,-1,5,1
KR_6758033813,440,1,87,16,6,0,1,1,0,1,1,6,8,2,-1,2,3,1,1,0,0,2,-9,-3,8,5,6,0,1,1,-1,1,1,5,1
KR_6758238123,420,0,5,-28,5,-3,2,5,-1,4,5,3,3,0,4,6,2,2,2,0,0,16,-8,-5,7,2,1,0,0,1,1,0,1,2,1
KR_6686281516,420,-1,40,24,-6,1,1,0,-3,5,8,-2,1,3,-2,0,2,0,1,1,0,-15,24,-3,8,5,1,0,1,-1,1,1,-1,5,1
KR_6742273528,440,-1,-33,-8,-1,-3,0,3,5,7,2,1,2,1,-6,1,7,2,2,0,4,5,25,-5,6,1,2,0,0,1,1,-1,1,5,1
KR_6730036043,420,-1,-16,4,0,-1,1,2,3,6,3,6,7,1,-3,0,3,-5,1,6,-1,-9,-14,-3,8,5,8,0,0,1,-1,-1,-1,3,1
KR_6731180940,420,4,60,-9,11,2,2,0,-1,1,2,4,6,2,3,4,1,3,5,2,-1,3,-3,2,6,8,-2,0,1,1,-1,1,-1,1,1
KR_6737043658,420,7,45,38,8,0,2,2,1,3,2,9,9,0,-2,2,4,0,2,2,1,4,-31,-3,7,4,3,0,2,1,-1,1,1,2,1
KR_6734604896,420,-1,-42,0,0,0,2,2,-2,2,4,4,4,0,-2,3,5,0,1,1,-1,5,1,-2,6,4,5,0,-1,1,-1,-1,-1,2,1
KR_6756780654,420,-3,-79,20,-6,-1,0,1,-4,1,5,0,1,1,-2,0,2,1,1,0,0,-4,-345,0,2,2,-2,0,-2,-1,1,-1,-1,3,1
KR_6745212057,420,0,30,-21,6,-1,1,2,1,2,1,3,6,3,1,5,4,2,2,0,0,10,15,5,4,9,0,0,0,1,1,0,1,4,1
KR_6700528154,420,-1,-47,12,-1,-8,0,8,4,5,1,2,5,3,2,3,1,-1,0,1,-1,0,-10,-4,6,2,1,0,-1,1,-1,-1,-1,3,1
KR_6742371111,440,-1,38,12,3,6,6,0,1,3,2,-1,3,4,-2,1,3,-1,2,3,4,4,9,6,2,8,-6,0,0,-1,1,0,1,4,1
KR_6758065991,420,-1,13,21,3,0,2,2,3,3,0,-1,2,3,0,2,2,1,2,1,0,-2,6,3,3,6,1,0,0,1,-1,1,1,4,1
KR_6665603319,420,6,69,34,12,4,4,0,4,4,0,3,3,0,1,1,0,0,1,1,-1,8,-4,1,7,8,-3,0,1,1,1,1,-1,4,1
KR_6757455124,420,1,-25,4,7,-3,1,4,0,2,2,11,11,0,0,2,2,-1,0,1,1,8,249,4,2,6,-1,0,0,1,1,1,1,3,1
KR_6704484300,420,2,38,24,8,-1,3,4,1,5,4,4,4,0,3,6,3,1,2,1,0,8,3,2,8,10,-4,0,0,1,1,0,-1,5,1
KR_6753002868,420,2,17,24,7,-1,1,2,7,7,0,1,3,2,2,3,1,-2,0,2,0,17,50,-1,5,4,2,0,2,1,-1,1,-1,3,1
KR_6728416686,420,3,7,-2,4,2,3,1,1,5,4,1,2,1,-1,3,4,1,1,0,-1,-2,-9,-1,8,7,1,0,1,-1,1,1,-1,3,1
KR_6763848681,420,3,47,24,7,1,2,1,1,2,1,2,4,2,5,6,1,-2,0,2,1,10,0,-1,6,5,2,0,1,1,-1,1,1,4,1
KR_6749937339,420,-3,-44,-4,-2,2,3,1,-3,0,3,1,2,1,-2,3,5,0,1,1,0,-4,-3,0,9,9,-2,0,0,-1,0,-1,-1,4,1
KR_6759754137,420,2,3,-4,6,-1,1,2,0,1,1,5,6,1,1,4,3,1,2,1,0,3,29,3,6,9,-1,0,0,0,-1,1,1,0,1
KR_6631208927,420,1,37,0,0,0,1,1,1,5,4,-3,1,4,2,4,2,0,0,0,0,-3,3,6,4,10,0,0,1,1,1,-1,-1,2,1
KR_6742982646,420,-3,-4,4,-7,-3,1,4,-2,1,3,1,4,3,-1,1,2,-2,4,6,1,-5,9,5,1,6,-5,0,0,-1,1,0,1,5,1
KR_6761121470,420,1,29,-2,1,2,2,0,0,2,2,-3,0,3,1,3,2,1,2,1,0,2,-8,2,4,6,3,0,0,1,1,0,1,2,1
KR_6760998641,420,0,37,-7,0,1,1,0,-3,0,3,1,1,0,1,4,3,0,0,0,0,0,55,1,5,6,-1,0,1,-1,1,1,1,3,1
KR_6599848280,420,-4,2,-40,6,-3,1,4,-1,1,2,7,7,0,1,4,3,2,4,2,0,17,47,2,5,7,-19,0,-1,1,-1,-1,1,1,1
KR_6748183970,420,2,84,-5,-1,1,1,0,-3,0,3,0,1,1,1,3,2,0,0,0,-1,-3,-27,0,3,3,-2,0,1,1,-1,1,-1,1,1
KR_6759810907,440,4,9,16,11,1,2,1,5,8,3,-2,2,4,3,5,2,4,4,0,0,10,171,-3,4,1,3,0,0,1,-1,0,-1,1,1
KR_6747059818,420,6,32,28,12,2,4,2,-5,0,5,2,3,1,13,17,4,0,0,0,3,21,-2,1,3,4,0,0,2,-1,1,1,-1,5,1
KR_6716724572,420,2,0,16,12,1,3,2,8,9,1,0,1,1,0,0,0,3,4,1,0,14,-41,1,5,6,21,0,0,1,1,0,1,5,1
KR_6660899729,420,1,60,-28,4,2,2,0,-3,1,4,5,6,1,1,4,3,-1,0,1,0,-1,11,3,4,7,-1,0,1,-1,-1,1,1,6,1
KR_6763029420,440,2,81,15,7,1,1,0,7,8,1,-1,1,2,1,3,2,-1,1,2,0,6,5,1,2,3,-3,0,0,1,-1,1,1,1,1
KR_6718743348,420,1,25,23,4,5,5,0,-2,2,4,1,1,0,-2,1,3,2,2,0,0,-4,-2,0,3,3,3,0,0,1,1,1,1,3,1
KR_6764154702,420,-1,-72,-32,5,-3,0,3,1,6,5,3,3,0,0,5,5,4,4,0,1,20,3,-4,10,6,0,0,0,0,0,0,1,0,1
KR_6690788854,440,5,68,27,13,3,6,3,0,0,0,8,11,3,1,1,0,1,2,1,0,4,6,1,4,5,2,0,2,1,1,1,1,1,1
KR_6766021992,420,2,21,-6,-1,-2,1,3,2,2,0,-1,2,3,-1,0,1,1,1,0,0,1,3,3,3,6,-2,0,0,-1,1,-1,-1,5,1
KR_6766040864,420,4,-42,0,7,0,2,2,0,3,3,4,7,3,1,2,1,2,2,0,0,11,117,-1,4,3,4,0,0,1,-1,1,-1,6,1
KR_6713180248,420,3,22,23,11,3,5,2,3,8,5,4,5,1,2,2,0,-1,0,1,0,4,10,6,1,7,-1,0,0,-1,1,1,1,5,1
KR_6766078645,420,1,29,-28,-1,-1,0,1,0,5,5,0,5,5,1,4,3,-1,1,2,0,-5,297,1,4,5,-2,0,1,-1,-1,1,1,2,1
KR_6764480353,420,2,28,12,5,-3,0,3,0,2,2,2,3,1,5,8,3,1,2,1,0,2,4,3,3,6,-4,0,2,1,1,1,1,6,1
KR_6507169988,420,1,18,-27,-2,0,4,4,-2,1,3,0,4,4,1,4,3,-1,1,2,-1,-4,10,-1,4,3,2,0,1,-1,1,1,-1,2,1
KR_6742235207,420,-1,-20,25,-1,-4,3,7,0,2,2,3,4,1,-1,1,2,1,3,2,0,1,-28,5,2,7,-3,0,1,1,1,1,1,2,1
KR_6745781523,420,-4,-16,-12,-5,1,1,0,-1,4,5,-1,1,2,-3,4,7,-1,1,2,0,0,-41,2,3,5,2,0,-2,1,1,-1,-1,6,1
KR_6747439684,420,-3,-54,-15,-5,-6,2,8,1,4,3,-1,1,2,-2,1,3,3,5,2,0,2,12,3,4,7,-6,0,-1,1,1,-1,1,1,1
KR_6736585768,440,1,1,20,4,-3,1,4,5,5,0,0,2,2,3,6,3,-1,0,1,0,13,4,3,3,6,0,0,0,1,1,1,1,1,1
KR_6644655345,420,5,49,15,5,-1,0,1,-1,2,3,0,3,3,5,7,2,2,3,1,0,1,0,3,5,8,-4,0,1,1,1,1,-1,4,1
KR_6764683853,420,-3,-30,21,-4,0,1,1,2,2,0,-3,3,6,-2,2,4,-1,0,1,0,1,138,1,2,3,2,0,0,0,-1,0,-1,0,1
KR_6490624523,420,5,74,4,9,3,4,1,4,4,0,0,0,0,2,2,0,0,1,1,0,10,5,7,2,9,-2,0,3,1,-1,1,1,4,1
KR_6591591862,420,2,47,8,8,8,10,2,1,1,0,-4,1,5,3,4,1,0,1,1,0,6,6,2,5,7,-2,0,1,1,1,1,1,6,1
KR_6718447324,420,2,27,-16,2,0,2,2,-3,1,4,2,3,1,2,3,1,1,3,2,0,-2,-22,-1,3,2,1,0,0,1,1,-1,1,6,1
KR_6765350639,420,-1,60,0,-3,1,1,0,-2,3,5,-1,0,1,0,1,1,-1,0,1,0,-2,-10,-2,5,3,1,0,1,-1,1,1,1,2,1
KR_6640285500,420,3,66,-9,8,0,0,0,4,4,0,0,1,1,3,6,3,1,1,0,0,14,38,3,3,6,-24,0,0,1,0,0,-1,2,1
KR_6757104052,420,2,78,4,1,0,0,0,2,7,5,1,3,2,-2,2,4,0,3,3,0,5,-43,0,4,4,19,0,1,-1,-1,1,-1,1,1
KR_6762722185,420,3,-8,43,-5,0,1,1,3,4,1,-2,2,4,-1,2,3,-5,0,5,0,-7,77,3,3,6,17,0,0,1,-1,-1,-1,1,1
KR_6719623594,420,1,26,0,11,2,2,0,6,6,0,3,5,2,-1,1,2,1,3,2,0,16,4,4,3,7,1,0,-1,-1,1,1,-1,3,1
KR_6663753055,420,-1,-67,-15,7,-5,0,5,8,10,2,4,6,2,-1,2,3,1,1,0,1,16,2,4,5,9,1,0,0,1,-1,-1,1,3,1
KR_6705312912,420,5,75,7,6,4,6,2,-5,0,5,1,3,2,6,8,2,0,0,0,0,1,1,-1,5,4,0,0,3,1,1,1,-1,3,1
KR_6760687443,420,2,41,-16,4,7,8,1,2,7,5,-1,1,2,-2,1,3,-2,1,3,0,0,3,-3,6,3,-3,0,1,1,-1,1,-1,5,1
KR_6638827245,420,3,79,35,3,-1,1,2,0,1,1,0,3,3,4,5,1,0,1,1,0,0,3,3,6,9,-2,0,1,1,-1,1,1,4,1
KR_6766148033,420,0,-37,7,-3,-1,1,2,0,4,4,-6,2,8,3,7,4,1,1,0,0,6,-7,-3,6,3,1,0,-1,-1,-1,-1,-1,4,1
KR_6744894789,440,-1,18,2,-3,0,3,3,-6,3,9,-3,3,6,7,9,2,-1,0,1,1,4,-4,-3,6,3,4,0,1,1,-1,1,-1,5,1
KR_6758975465,420,0,-20,8,5,1,2,1,3,7,4,-2,2,4,-1,2,3,4,6,2,0,4,0,2,7,9,5,0,0,-1,0,0,1,1,1
KR_6761779631,420,2,-11,-20,6,0,2,2,5,6,1,0,2,2,1,2,1,0,2,2,0,4,-312,5,5,10,-2,0,0,-1,-1,-1,1,2,1
KR_6703671394,440,3,-15,-3,13,0,4,4,2,3,1,-1,7,8,5,8,3,7,7,0,1,13,-13,-2,6,4,3,0,-1,0,-1,1,1,0,1
KR_6697097227,420,-7,-106,-19,-13,-3,2,5,0,5,5,-3,1,4,-8,0,8,1,1,0,0,-1,5,-1,4,3,-2,0,-2,1,-1,-1,-1,1,1
KR_6742330912,420,0,-60,21,3,-3,1,4,2,3,1,5,6,1,-1,1,2,0,1,1,0,9,-11,-3,7,4,4,0,0,1,1,0,1,1,1
KR_6762982633,420,1,-19,14,-1,-3,1,4,0,3,3,1,2,1,0,2,2,1,1,0,-1,-2,-3,3,6,9,1,0,0,-1,-1,0,-1,4,1
KR_6758664563,420,0,-51,15,5,-1,1,2,2,2,0,2,4,2,3,5,2,-1,1,2,0,7,19,0,3,3,-4,0,0,0,1,0,-1,0,1
KR_6663884832,420,9,65,73,15,3,3,0,4,5,1,2,3,1,5,5,0,1,1,0,1,13,4,3,3,6,5,0,3,1,1,1,1,3,1
KR_6717600909,420,4,-44,24,0,1,2,1,-2,0,2,-1,5,6,3,4,1,-1,1,2,0,-2,13,-3,11,8,-3,0,0,1,1,0,-1,4,1
KR_6746336922,440,3,20,-12,6,4,4,0,0,1,1,-1,3,4,2,4,2,1,1,0,0,6,28,5,1,6,0,0,1,1,1,1,1,1,1
KR_6680611329,420,2,-10,-12,4,-1,0,1,0,3,3,-1,2,3,5,6,1,1,1,0,2,3,-2,-1,9,8,-4,0,0,1,1,0,1,3,1
KR_6742147173,420,-1,-2,20,-4,0,4,4,0,1,1,0,2,2,-3,2,5,-1,0,1,1,-8,13,-1,5,4,0,0,-1,1,-1,-1,1,4,1
KR_6698030724,420,3,65,0,3,0,0,0,0,3,3,2,4,2,2,3,1,-1,0,1,0,5,1,-3,8,5,0,0,1,1,-1,1,1,3,1
KR_6723005078,440,5,49,8,11,5,5,0,2,3,1,1,4,3,2,4,2,1,1,0,0,10,41,-1,3,2,4,0,0,1,-1,1,1,3,1
KR_6760203514,420,0,25,-4,4,3,5,2,0,3,3,1,2,1,2,5,3,-2,2,4,-1,3,0,-1,5,4,4,0,1,0,1,1,-1,0,1
KR_6743647360,440,-1,20,-36,-4,-1,1,2,1,3,2,0,2,2,-4,0,4,0,1,1,0,-6,-189,-3,6,3,3,0,-1,-1,-1,-1,-1,2,1
KR_6737343730,420,5,35,45,13,1,1,0,6,7,1,5,5,0,1,4,3,0,0,0,1,9,120,4,3,7,0,0,1,1,-1,1,1,5,1
KR_6762701679,420,-1,4,17,-6,0,1,1,-2,1,3,0,1,1,-5,3,8,1,3,2,0,-4,-3,0,8,8,3,0,1,-1,1,1,-1,6,1
KR_6756012996,420,4,16,20,4,-2,0,2,0,3,3,1,3,2,7,8,1,-2,0,2,0,1,27,5,2,7,-1,0,1,1,0,1,-1,2,1
KR_6761513099,420,2,51,38,3,1,3,2,-1,2,3,1,1,0,0,2,2,2,3,1,0,0,1,-4,8,4,5,0,1,1,1,1,-1,2,1
KR_6761185412,420,0,32,-47,4,1,2,1,3,4,1,0,2,2,1,2,1,-1,0,1,0,8,-5,-2,6,4,1,0,0,-1,-1,0,-1,4,1
KR_6745168781,420,4,72,8,14,-1,1,2,9,9,0,4,4,0,0,0,0,2,2,0,1,16,3,4,2,6,1,0,3,1,1,1,1,6,1
KR_6704251352,420,0,-9,16,11,-3,0,3,3,4,1,0,1,1,4,4,0,7,7,0,0,16,11,4,4,8,-4,0,0,1,1,1,1,3,1
KR_6605394180,420,4,64,36,4,3,4,1,2,5,3,-1,2,3,1,3,2,-1,1,2,0,-2,-42,5,2,7,-2,0,-1,0,1,1,-1,0,1
KR_6724658638,440,3,83,-20,2,1,3,2,-1,1,2,1,4,3,-2,2,4,3,4,1,0,-1,4,-3,5,2,5,0,0,1,-1,0,-1,4,1
KR_6758559849,420,2,10,19,-4,-1,1,2,2,3,1,-5,0,5,1,3,2,-1,1,2,0,-3,-2,3,6,9,0,0,0,1,1,1,-1,6,1
KR_6762465487,420,-3,-35,-10,-2,-1,1,2,-2,1,3,1,4,3,1,2,1,-1,1,2,0,-8,5,3,3,6,1,0,-1,1,1,1,1,5,1
KR_6735291422,420,1,39,-12,3,-1,1,2,1,4,3,3,4,1,-1,1,2,1,1,0,0,5,15,2,2,4,0,0,0,-1,1,0,-1,4,1
KR_6658639862,420,1,32,6,6,-3,1,4,0,2,2,7,8,1,1,2,1,1,2,1,0,4,-30,-5,6,1,20,0,-1,-1,-1,-1,-1,3,1
KR_6712232924,420,0,33,-20,7,2,4,2,5,6,1,-2,3,5,0,2,2,2,3,1,1,5,12,5,1,6,1,0,1,-1,-1,-1,1,2,1
KR_6740749290,440,1,-11,-12,0,1,3,2,2,4,2,2,4,2,-3,2,5,-2,0,2,0,5,-10,3,3,6,3,0,-1,-1,-1,-1,1,2,1
KR_6670789122,420,1,29,-24,1,0,1,1,-2,3,5,0,0,0,4,4,0,-1,0,1,0,6,-2,-3,6,3,-5,0,0,-1,-1,0,-1,3,1
KR_6687019987,420,5,99,36,9,5,6,1,3,4,1,1,3,2,-1,3,4,1,2,1,-1,6,-279,2,4,6,-2,0,2,0,1,1,-1,0,1
KR_6729745406,420,-3,-6,-1,0,-2,1,3,2,5,3,0,3,3,0,3,3,0,0,0,0,4,23,-2,6,4,-3,0,0,-1,1,-1,1,5,1
KR_6741716988,420,1,28,9,2,-1,3,4,2,3,1,-5,0,5,5,8,3,1,3,2,0,-5,2,1,3,4,-5,0,-1,1,-1,-1,1,3,1
KR_6761687573,420,4,6,-12,11,4,4,0,-1,3,4,2,4,2,1,2,1,5,5,0,0,9,15,-1,6,5,4,0,1,0,1,1,-1,0,1
KR_6706772642,420,2,33,8,-2,-1,1,2,-5,1,6,-2,1,3,-2,1,3,8,10,2,0,-7,167,-1,7,6,-7,0,0,1,1,0,1,2,1
KR_6721760241,420,3,32,21,1,-1,1,2,5,6,1,-1,3,4,-2,4,6,0,0,0,0,3,3,-1,8,7,0,0,0,1,-1,-1,-1,2,1
KR_6759187955,420,4,18,62,2,1,2,1,5,6,1,-2,0,2,-1,2,3,-1,0,1,0,6,0,0,6,6,3,0,1,1,1,1,-1,3,1
KR_6758371866,420,0,-23,-43,-1,2,2,0,0,1,1,0,3,3,-2,1,3,-1,0,1,0,-1,9,3,3,6,-6,0,-1,0,-1,-1,-1,0,1
KR_6597860073,420,3,87,12,6,5,5,0,-3,1,4,5,5,0,-1,2,3,0,1,1,0,5,-24,-2,6,4,3,0,2,1,-1,1,1,2,1
KR_6764118570,420,-1,-19,9,1,-4,1,5,1,2,1,0,2,2,5,6,1,-1,1,2,-2,-2,3,-4,6,2,4,0,0,1,0,0,-1,6,1
KR_6636967117,420,-2,2,-4,-6,2,4,2,1,2,1,-3,1,4,-6,0,6,0,0,0,0,-9,1,1,5,6,-5,0,-1,-1,-1,-1,-1,5,1
KR_6753845914,420,1,44,-4,-1,-1,1,2,1,4,3,0,2,2,-2,1,3,1,2,1,0,-4,8,3,4,7,0,0,0,1,-1,1,1,4,1
KR_6736012750,420,2,-37,-19,10,6,6,0,4,5,1,1,4,3,-1,2,3,0,0,0,0,7,-10,0,5,5,-1,0,0,-1,-1,1,-1,6,1
KR_6754347253,440,-1,23,-17,-1,-3,1,4,2,3,1,1,1,0,-1,3,4,0,2,2,0,3,-2,-2,5,3,2,0,0,-1,1,0,1,2,1
KR_6634668798,440,4,47,28,-1,-1,2,3,-2,1,3,2,2,0,0,2,2,0,2,2,0,-4,13,3,6,9,-4,0,-1,1,-1,-1,1,2,1
KR_6759154519,420,1,0,0,7,-1,2,3,3,3,0,1,3,2,4,4,0,0,0,0,0,5,349,4,2,6,-3,0,1,1,1,1,-1,4,1
KR_6743120264,420,5,56,0,12,1,1,0,8,11,3,2,3,1,-1,1,2,2,2,0,1,14,-22,-1,5,4,5,0,1,1,-1,1,1,2,1
KR_6763831451,420,2,-52,3,-3,-1,4,5,-1,1,2,2,4,2,-3,0,3,0,1,1,0,-5,123,0,4,4,-3,0,2,1,1,1,-1,2,1
KR_6764874445,440,4,107,5,3,1,3,2,1,2,1,-1,2,3,2,2,0,0,0,0,0,-1,0,0,2,2,-1,0,1,0,0,1,-1,0,1
KR_6650733039,420,1,-12,-20,2,2,3,1,-4,3,7,1,3,2,2,5,3,1,1,0,-2,-2,64,-2,9,7,-2,0,1,1,1,1,-1,3,1
KR_6728283292,420,1,79,9,1,3,5,2,0,2,2,-1,2,3,0,2,2,-1,1,2,0,-3,5,4,4,8,-2,0,0,-1,1,1,-1,5,1
KR_6732330604,420,-3,94,-12,-4,-1,0,1,-5,0,5,0,0,0,5,6,1,-3,0,3,0,-7,2,-1,4,3,-17,0,0,-1,1,0,1,3,1
KR_6704194179,420,5,59,60,7,3,4,1,4,9,5,0,2,2,-1,3,4,1,4,3,1,5,-31,-1,9,8,4,0,-1,1,-1,-1,1,4,1
KR_6692225596,420,-1,13,15,2,-1,1,2,1,4,3,-2,0,2,3,3,0,1,1,0,0,0,-132,6,2,8,0,0,0,1,1,0,1,6,1
KR_6758725231,420,3,0,8,4,1,1,0,-4,1,5,0,2,2,4,5,1,3,3,0,0,3,-12,0,3,3,1,0,1,0,0,1,1,0,1
KR_6749512813,420,-1,7,27,-5,-3,0,3,2,3,1,-3,1,4,0,3,3,-1,0,1,0,-3,-10,-4,5,1,2,0,-2,-1,1,-1,1,4,1
KR_6764138862,420,5,-11,8,11,3,4,1,5,6,1,2,2,0,1,3,2,0,1,1,0,6,-52,-1,7,6,18,0,0,-1,1,0,1,5,1
KR_6755227026,420,2,31,17,5,4,4,0,-2,1,3,3,4,1,3,6,3,-3,1,4,1,7,3,1,2,3,1,0,0,-1,1,0,1,5,1
KR_6746863006,420,3,69,-4,4,3,4,1,1,1,0,-2,0,2,3,5,2,-1,2,3,0,2,0,0,5,5,3,0,1,1,1,1,1,1,1
KR_6761843526,440,-3,22,-28,2,-1,1,2,0,3,3,1,3,2,3,4,1,-1,2,3,1,7,57,-2,5,3,-33,0,0,-1,1,1,1,4,1
KR_6703526994,420,5,26,-3,5,-5,0,5,1,2,1,4,4,0,5,8,3,0,0,0,0,2,9,-1,7,6,-1,0,0,1,0,1,-1,1,1
KR_6746493203,420,-2,-24,-1,-4,-5,1,6,-5,1,6,-2,3,5,4,5,1,4,4,0,0,7,-7,-5,10,5,0,0,0,-1,0,-1,1,5,1
KR_6275317055,420,6,7,-3,17,3,4,1,8,8,0,3,6,3,1,2,1,2,2,0,0,14,113,2,1,3,6,0,2,-1,-1,1,-1,6,1
KR_6742772486,420,4,4,32,8,1,1,0,1,6,5,4,6,2,1,2,1,1,1,0,0,7,-13,-1,5,4,9,0,1,1,-1,1,-1,3,1
KR_6742697751,420,-2,2,7,1,-4,0,4,4,5,1,-1,0,1,3,4,1,-1,0,1,0,6,-7,-1,5,4,-1,0,0,1,-1,0,-1,2,1
KR_6705091219,420,1,-4,4,0,0,4,4,-1,0,1,4,5,1,-1,1,2,-2,1,3,0,4,-5,2,7,9,-2,0,0,1,-1,-1,1,2,1
KR_6699688794,420,5,102,-1,11,2,5,3,4,5,1,1,2,1,4,6,2,0,2,2,0,13,39,1,0,1,-24,0,0,-1,1,1,1,5,1
KR_6742814568,420,4,25,-4,7,2,2,0,4,6,2,0,2,2,1,2,1,0,1,1,0,5,14,0,4,4,-4,0,1,1,1,1,1,6,1
KR_6652095598,420,2,64,15,3,0,2,2,4,4,0,-3,0,3,2,2,0,0,0,0,0,-1,9,3,1,4,-3,0,3,1,1,1,-1,2,1
KR_6766210489,420,-5,-72,7,-13,-2,2,4,-6,1,7,-2,1,3,1,4,3,-4,1,5,0,-16,-3,1,5,6,0,0,-3,1,-1,-1,1,4,1
KR_6656172705,420,2,28,-8,3,3,3,0,0,1,1,-1,0,1,1,3,2,0,2,2,0,-1,11,5,1,6,-1,0,1,1,1,1,1,1,1
KR_6686460410,420,-1,-10,-18,-2,-3,0,3,0,2,2,2,4,2,-2,0,2,1,5,4,0,-10,-3,-3,7,4,3,0,-3,-1,-1,-1,1,3,1
KR_6763418595,420,6,71,15,13,4,4,0,-2,0,2,8,8,0,2,2,0,1,2,1,1,5,-1,-2,4,2,1,0,1,1,-1,1,1,6,1
KR_6723716430,420,4,79,0,2,3,5,2,0,2,2,0,2,2,1,5,4,-2,0,2,-1,-5,11,7,4,11,3,0,3,0,1,1,-1,0,1
KR_6688630671,420,1,64,4,8,4,4,0,4,5,1,0,3,3,-1,3,4,1,1,0,0,10,96,-8,12,4,5,0,0,-1,-1,1,1,3,1
KR_6759450062,420,1,-10,7,8,-3,0,3,3,6,3,2,2,0,6,7,1,0,1,1,1,14,45,3,4,7,-12,0,0,1,0,0,1,5,1
KR_6761547620,440,-2,84,-20,-4,-1,2,3,-1,1,2,2,4,2,-3,1,4,-1,1,2,0,0,107,0,6,6,1,0,0,1,1,0,-1,4,1
KR_6700525461,420,-1,-1,4,-5,-1,1,2,-2,1,3,3,4,1,-5,0,5,0,0,0,0,-12,-11,-5,6,1,2,0,1,-1,1,1,-1,5,1
KR_6686517733,420,-2,-91,1,-4,0,0,0,-3,2,5,-2,1,3,-2,2,4,3,3,0,-1,-4,-36,0,4,4,1,0,0,1,-1,0,-1,4,1
KR_6703824009,420,-1,17,21,6,0,6,6,1,4,3,2,3,1,1,3,2,2,3,1,0,8,5,2,3,5,3,0,0,1,1,0,1,6,1
KR_6708459205,420,4,40,8,13,0,3,3,4,5,1,4,6,2,4,5,1,1,1,0,0,22,-104,6,2,8,2,0,2,1,1,1,1,2,1
KR_6760102333,420,-2,-6,0,-2,-3,0,3,3,6,3,0,2,2,-5,1,6,3,4,1,1,6,-10,2,5,7,-2,0,0,1,-1,1,1,1,1
KR_6734731926,420,3,61,-2,12,0,1,1,3,4,1,2,2,0,3,3,0,4,4,0,0,14,2,4,4,8,6,0,2,1,1,1,1,1,1
KR_6754601650,420,0,82,4,2,1,1,0,-5,0,5,1,2,1,4,6,2,1,1,0,0,-4,-1,3,3,6,5,0,1,-1,0,1,-1,1,1
KR_6650640800,420,0,38,13,-6,1,2,1,0,2,2,-6,2,8,1,4,3,-2,0,2,0,-3,0,-2,6,4,-2,0,-1,1,1,-1,-1,2,1
KR_6762522040,420,2,117,16,11,6,7,1,-5,4,9,4,7,3,9,9,0,-3,0,3,0,9,-196,-2,6,4,1,0,0,0,-1,0,1,0,1
KR_6763776775,420,7,53,-8,20,3,4,1,3,4,1,5,6,1,7,7,0,2,3,1,0,14,34,2,2,4,-4,0,0,1,0,1,1,1,1
KR_6762269473,420,2,-25,4,0,0,1,1,0,2,2,5,7,2,-3,0,3,-2,0,2,-1,-2,10,1,5,6,-2,0,0,1,1,-1,-1,3,1
KR_6747839868,420,3,-24,21,8,3,4,1,3,9,6,1,3,2,-1,1,2,2,2,0,1,7,-2,-1,9,8,-1,0,0,1,1,1,1,4,1
KR_6725437130,420,1,21,12,-2,1,2,1,2,5,3,-3,2,5,1,6,5,-3,0,3,0,-10,21,2,6,8,-1,0,0,1,-1,0,1,2,1
KR_6652821711,420,-4,-69,-16,-8,-2,0,2,0,4,4,0,0,0,-5,1,6,-1,1,2,0,-6,-6,-6,9,3,-1,0,0,-1,1,0,-1,3,1
KR_6659254178,420,2,-25,24,2,-2,1,3,2,5,3,1,2,1,0,2,2,1,1,0,0,5,-3,1,3,4,2,0,0,-1,-1,0,1,6,1
KR_6757830346,420,-5,-57,-28,-5,-5,1,6,0,2,2,-2,0,2,2,4,2,0,1,1,0,4,0,-1,5,4,-1,0,0,1,1,-1,1,3,1
KR_6764976418,420,1,-10,-4,-2,-1,0,1,0,2,2,0,4,4,-1,2,3,0,1,1,0,-7,-20,-1,5,4,-2,0,-1,-1,-1,-1,-1,1,1
KR_6650495303,420,1,46,24,7,2,3,1,1,1,0,-1,2,3,3,4,1,2,2,0,0,10,29,3,4,7,0,0,1,1,-1,1,1,5,1
KR_6764078341,420,2,63,0,4,5,5,0,2,4,2,-3,0,3,0,2,2,0,1,1,-1,0,-2,0,3,3,-5,0,1,-1,1,1,-1,2,1
KR_6747221987,440,3,32,70,7,4,5,1,3,4,1,1,3,2,-1,1,2,0,0,0,0,1,1,6,2,8,-2,0,0,1,-1,1,1,2,1
KR_6738544768,420,4,52,4,13,3,3,0,3,5,2,1,4,3,3,4,1,3,4,1,0,18,9,-4,8,4,2,0,1,1,1,1,1,3,1
KR_6729453107,420,3,1,-21,4,5,5,0,5,6,1,-2,4,6,-2,2,4,-2,2,4,1,6,0,-3,3,0,-2,0,1,0,0,1,1,0,1
KR_6753033735,420,1,-20,12,-2,-2,0,2,1,3,2,-1,2,3,-1,1,2,1,1,0,0,-1,241,1,3,4,-3,0,0,-1,1,0,-1,2,1
KR_6761206160,420,-1,-6,39,5,3,5,2,-1,1,2,1,1,0,2,6,4,0,2,2,2,-2,-94,5,1,6,1,0,0,1,1,-1,1,6,1
KR_6744321599,420,1,55,-3,0,0,0,0,1,5,4,0,1,1,-1,0,1,0,0,0,0,-1,-14,3,5,8,2,0,1,-1,1,1,-1,5,1
KR_6765188847,420,-2,4,-25,1,5,8,3,0,3,3,-2,1,3,-1,3,4,-1,2,3,1,4,-5,-3,10,7,-1,0,-1,-1,1,1,1,4,1
KR_6754840710,420,1,-31,-23,4,2,2,0,-2,1,3,-1,3,4,6,10,4,-1,0,1,1,5,3,-3,10,7,4,0,1,1,1,1,1,3,1
KR_6633288566,420,1,-33,4,5,2,3,1,2,4,2,-1,2,3,1,2,1,1,1,0,0,6,0,5,2,7,1,0,1,1,1,1,-1,1,1
KR_6732684688,420,1,60,5,-3,3,4,1,-1,3,4,1,3,2,-2,2,4,-4,0,4,0,-2,3,6,2,8,-1,0,1,-1,1,1,-1,4,1
KR_6764223382,420,2,-13,31,9,4,4,0,2,6,4,2,4,2,2,5,3,-1,0,1,0,5,-4,2,4,6,2,0,1,1,1,1,1,2,1
KR_6759840047,420,7,59,48,-3,0,0,0,-2,2,4,5,6,1,-7,1,8,1,5,4,-2,-5,-1,1,5,6,-1,0,0,1,1,1,-1,4,1
KR_6726500162,420,-1,-88,-5,5,-2,2,4,2,3,1,0,3,3,3,5,2,2,5,3,0,14,-262,0,4,4,0,0,0,-1,1,1,-1,4,1
KR_6678996011,420,3,58,20,1,2,2,0,1,2,1,-1,2,3,-2,2,4,1,1,0,0,5,32,2,3,5,-3,0,1,1,-1,1,1,4,1
KR_6684178862,420,0,-25,0,10,-1,3,4,4,4,0,2,4,2,3,3,0,2,3,1,0,16,-1,-1,2,1,3,0,0,1,1,1,-1,3,1
KR_6760747756,420,6,22,52,13,2,2,0,1,3,2,5,5,0,5,7,2,0,3,3,0,7,0,0,3,3,0,0,1,1,1,1,1,2,1
KR_6761283014,420,1,62,9,0,-1,2,3,5,5,0,0,2,2,-1,3,4,-3,1,4,0,1,0,-3,6,3,4,0,0,1,1,1,1,3,1
KR_6759763895,440,2,10,12,5,0,1,1,0,1,1,7,9,2,-2,0,2,0,0,0,0,5,-3,3,3,6,1,0,0,0,1,0,1,0,1
KR_6760239585,420,0,-7,-16,1,3,4,1,2,3,1,-2,1,3,-2,0,2,0,0,0,1,0,4,2,4,6,2,0,0,-1,1,0,1,6,1
KR_6754827470,420,1,-44,-11,8,0,1,1,-2,1,3,4,4,0,4,6,2,2,3,1,1,7,-5,-3,5,2,-1,0,0,-1,1,0,1,1,1
KR_6762515413,440,-2,41,-16,2,-1,2,3,3,4,1,3,5,2,-3,2,5,0,0,0,1,2,7,5,0,5,-1,0,1,1,1,1,1,3,1
KR_6690710488,440,3,57,14,5,-1,2,3,3,6,3,1,1,0,2,3,1,0,2,2,0,2,-7,-4,9,5,0,0,1,1,-1,1,-1,6,1
KR_6658367618,420,0,34,13,-1,3,4,1,2,3,1,-6,0,6,0,7,7,0,2,2,1,-1,2,-4,9,5,-4,0,-1,1,-1,-1,1,5,1
KR_6763003414,420,3,95,7,7,0,1,1,2,3,1,0,2,2,5,5,0,0,1,1,0,5,-61,5,4,9,-2,0,3,1,1,1,1,3,1
KR_6748513415,420,4,65,-17,8,1,1,0,3,4,1,-1,1,2,4,8,4,1,3,2,0,7,-5,0,5,5,-2,0,3,1,1,1,1,3,1
KR_6649198959,420,0,39,4,0,0,3,3,1,3,2,1,1,0,-3,1,4,1,1,0,0,-1,2,-8,11,3,3,0,-1,1,-1,-1,-1,1,1
KR_6748903249,440,0,-66,1,4,2,4,2,10,11,1,-2,2,4,-4,0,4,-2,0,2,0,1,-2,1,2,3,-3,0,0,0,0,-1,-1,0,1
KR_6760506794,420,4,70,13,11,3,4,1,3,3,0,6,6,0,-2,0,2,1,2,1,0,2,-2,0,6,6,5,0,1,1,1,1,1,1,1
KR_6764867340,440,-1,-16,-28,-8,-1,3,4,-8,0,8,-2,0,2,2,5,3,1,1,0,0,-8,-2,-3,4,1,1,0,0,-1,-1,-1,-1,5,1
KR_6745154696,420,1,12,0,-1,2,5,3,-1,1,2,1,2,1,-4,0,4,1,2,1,0,-5,-4,2,3,5,2,0,0,1,-1,0,-1,3,1
KR_6666660369,420,-2,-34,-4,-5,-7,1,8,-1,3,4,0,2,2,3,4,1,0,0,0,-2,-4,125,-2,3,1,-6,0,-1,1,0,-1,-1,1,1
KR_6739323065,420,0,35,12,-3,2,4,2,1,2,1,0,2,2,-4,2,6,-2,0,2,0,-9,-16,-4,7,3,6,0,0,1,1,1,-1,1,1
KR_6719639615,420,4,46,19,10,2,2,0,2,2,0,7,8,1,0,1,1,-1,0,1,0,11,-110,-3,7,4,1,0,1,1,1,1,1,4,1
KR_6724500262,420,5,52,24,7,3,3,0,0,3,3,3,3,0,1,3,2,0,2,2,0,4,23,-3,9,6,-1,0,0,0,1,1,1,0,1
KR_6601232954,420,3,11,-1,11,0,1,1,2,5,3,8,9,1,0,1,1,1,1,0,0,12,3,-2,5,3,1,0,0,1,1,0,1,6,1
KR_6732493218,420,1,8,15,-4,-2,0,2,-1,3,4,4,5,1,-3,0,3,-2,0,2,-1,-5,11,-4,8,4,2,0,1,0,1,1,-1,0,1
KR_6644593375,420,1,48,9,1,0,0,0,-4,0,4,0,2,2,1,4,3,4,4,0,1,2,11,5,2,7,0,0,0,0,-1,0,1,0,1
KR_6653935226,420,4,19,17,7,1,3,2,2,3,1,1,2,1,2,3,1,1,2,1,0,10,34,3,5,8,-19,0,3,1,1,1,1,1,1
KR_6734555436,420,3,78,4,12,1,1,0,2,3,1,2,4,2,5,5,0,2,2,0,0,11,40,7,3,10,-19,0,1,1,1,1,1,4,1
KR_6750156728,420,2,61,4,9,3,3,0,0,3,3,5,6,1,2,3,1,-1,0,1,0,8,-111,1,6,7,0,0,1,-1,1,1,1,6,1
KR_6731275765,420,5,25,44,6,7,8,1,-6,1,7,1,2,1,4,5,1,0,0,0,0,-5,-46,-5,7,2,19,0,2,1,1,1,1,5,1
KR_6761386577,420,1,-23,18,4,1,2,1,0,2,2,2,3,1,1,4,3,0,1,1,0,5,3,2,4,6,-5,0,0,-1,1,0,-1,5,1
KR_6764283894,440,5,4,8,11,2,2,0,3,3,0,6,7,1,0,0,0,0,1,1,0,9,1,3,4,7,-1,0,1,1,1,1,1,2,1
KR_6742984939,440,-2,-6,1,-2,0,1,1,-1,4,5,1,2,1,-2,4,6,0,0,0,0,0,4,1,4,5,-2,0,0,1,-1,0,-1,2,1
KR_6640140425,420,1,57,-4,13,3,4,1,5,6,1,3,3,0,2,8,6,0,2,2,0,14,8,6,2,8,1,0,1,1,1,1,1,3,1
KR_6756848777,440,2,59,6,6,4,4,0,-2,1,3,3,5,2,2,3,1,-1,0,1,1,13,3,3,4,7,-2,0,1,1,-1,1,1,1,1
KR_6731667137,420,2,-12,19,4,-2,0,2,-1,3,4,8,8,0,-1,1,2,0,1,1,0,2,-6,0,7,7,1,0,1,0,1,1,1,0,1
KR_6753700832,420,2,27,12,5,1,4,3,2,2,0,0,3,3,1,4,3,1,1,0,0,8,0,-1,5,4,1,0,1,1,1,1,-1,1,1
KR_6562214097,420,3,13,24,11,3,5,2,-3,1,4,2,3,1,6,6,0,3,4,1,2,23,17,4,1,5,-2,0,2,1,1,1,1,2,1
KR_6655836683,440,4,-7,30,9,4,5,1,3,5,2,1,5,4,1,2,1,0,2,2,0,7,-14,-4,6,2,4,0,0,1,-1,1,1,5,1
KR_6763327389,420,-4,-48,-36,1,4,4,0,-2,1,3,-1,2,3,3,4,1,-3,1,4,0,2,57,8,1,9,-3,0,0,-1,1,0,1,4,1
KR_6696819165,420,3,81,-4,0,0,1,1,3,4,1,-1,0,1,-2,2,4,0,0,0,0,-1,-374,-2,7,5,9,0,1,1,-1,1,-1,6,1
KR_6725301865,420,5,79,24,11,4,4,0,4,6,2,-2,2,4,5,6,1,0,0,0,0,0,-5,5,3,8,1,0,2,-1,1,1,1,1,1
KR_6764779620,420,1,-15,60,-1,-1,3,4,-2,0,2,2,3,1,0,0,0,0,0,0,0,-4,6,3,2,5,1,0,0,1,1,0,-1,5,1
KR_6759336879,440,3,8,25,8,-3,1,4,7,8,1,-1,0,1,5,5,0,0,3,3,0,14,7,0,4,4,1,0,0,1,1,0,-1,3,1
KR_6684045563,440,1,10,48,1,1,4,3,0,4,4,3,6,3,-4,1,5,1,2,1,0,-5,-3,4,0,4,-1,0,1,1,1,1,-1,4,1
KR_6734192571,440,1,-61,-34,2,-1,4,5,0,3,3,-1,0,1,1,1,0,3,4,1,-1,6,28,1,0,1,0,0,0,1,1,1,-1,1,1
KR_6763109814,440,0,-2,-12,8,-1,0,1,4,7,3,4,4,0,2,4,2,-1,0,1,1,11,4,7,2,9,0,0,1,0,0,1,1,0,1
KR_6765739382,420,1,55,-8,8,0,0,0,-1,0,1,1,3,2,7,7,0,1,1,0,0,17,-5,-3,8,5,4,0,0,1,0,0,1,1,1
KR_6759676065,420,2,34,19,5,2,3,1,1,1,0,4,5,1,1,2,1,-3,0,3,0,3,-19,3,2,5,-1,0,0,1,-1,0,1,3,1
KR_6764194721,420,1,33,-24,5,1,4,3,-2,0,2,3,3,0,3,5,2,0,1,1,0,11,-185,-3,6,3,1,0,1,-1,-1,-1,1,4,1
KR_6699892425,420,-1,-20,16,1,2,6,4,-8,1,9,7,7,0,0,4,4,0,2,2,0,-8,-11,-1,5,4,3,0,0,-1,-1,-1,1,2,1
KR_6752256085,420,2,85,24,-1,-2,0,2,0,0,0,1,3,2,-2,2,4,2,4,2,0,-8,-43,-2,7,5,-24,0,0,1,-1,1,-1,5,1
KR_6753145813,420,2,-54,13,5,-1,1,2,9,9,0,0,3,3,-1,2,3,-2,1,3,0,6,32,-1,6,5,-1,0,1,1,1,1,-1,5,1
KR_6666711175,420,1,-24,7,1,4,7,3,3,4,1,-4,2,6,-2,1,3,0,1,1,0,2,-221,1,2,3,-2,0,1,1,1,1,-1,3,1
KR_6618164546,420,2,56,27,6,0,2,2,3,5,2,0,1,1,4,7,3,-1,0,1,0,11,10,1,5,6,2,0,1,-1,1,1,1,1,1
KR_6762583023,440,2,0,0,4,1,2,1,-1,1,2,6,8,2,-1,2,3,-1,2,3,0,7,-4,-2,6,4,-1,0,0,1,1,-1,1,3,1
KR_6740221811,420,-1,12,26,2,-1,0,1,5,5,0,1,2,1,-2,1,3,-1,0,1,0,-1,-98,6,4,10,-4,0,0,1,1,0,-1,5,1
KR_6703949558,420,5,48,20,17,-3,1,4,15,16,1,4,4,0,3,4,1,-2,0,2,-2,17,36,4,4,8,-6,0,3,0,0,1,1,0,1
KR_6740138728,420,0,83,2,-10,2,2,0,-8,1,9,-1,6,7,0,5,5,-3,2,5,2,-19,21,0,4,4,-1,0,2,1,1,1,1,6,1
KR_6704557570,420,2,90,28,0,4,4,0,-2,1,3,2,4,2,-2,0,2,-2,0,2,0,-7,-47,-4,7,3,3,0,1,1,1,1,-1,6,1
KR_6765416178,420,2,56,-12,8,0,1,1,-1,1,2,5,6,1,3,3,0,1,1,0,0,7,-124,1,2,3,3,0,-1,1,-1,-1,1,1,1
KR_6711656067,420,2,118,-29,6,1,1,0,1,5,4,1,4,3,4,7,3,-1,2,3,2,1,-89,1,4,5,1,0,5,-1,1,1,1,5,1
KR_6634348949,420,3,27,8,2,-1,0,1,0,2,2,-4,0,4,5,7,2,2,3,1,0,7,9,-3,7,4,-4,0,0,-1,1,0,-1,5,1
KR_6676127356,420,5,-22,16,11,6,7,1,2,5,3,2,3,1,1,1,0,0,0,0,-1,12,-9,2,3,5,-2,0,-1,1,-1,-1,-1,5,1
KR_6745687250,420,5,111,0,15,-1,4,5,3,3,0,3,5,2,8,8,0,2,2,0,0,21,-25,4,3,7,3,0,1,-1,1,1,1,4,1
KR_6751092701,420,1,-63,-2,8,1,1,0,5,7,2,2,3,1,-1,1,2,1,1,0,0,15,-4,4,5,9,6,0,1,1,1,1,1,2,1
KR_6702223627,420,4,81,-20,7,4,4,0,6,6,0,1,4,3,-3,0,3,-1,1,2,0,4,6,0,3,3,1,0,3,-1,-1,1,1,3,1
KR_6654434516,420,5,91,3,14,4,5,1,10,11,1,-1,1,2,0,1,1,1,1,0,0,16,1,2,5,7,0,0,1,1,1,1,1,5,1
KR_6753626118,420,5,40,6,15,5,6,1,3,4,1,4,6,2,2,4,2,1,2,1,0,11,-1,-1,6,5,-1,0,1,-1,1,1,-1,6,1
KR_6705289668,420,3,76,4,5,7,8,1,1,3,2,-1,0,1,-1,0,1,-1,0,1,0,-1,-23,1,2,3,-2,0,0,1,1,0,1,4,1
KR_6763810038,420,2,-9,-12,2,-1,0,1,4,5,1,0,2,2,3,5,2,-4,2,6,0,2,210,-5,7,2,1,0,0,0,1,0,-1,0,1
KR_6729811779,440,3,27,-16,11,3,3,0,2,5,3,2,2,0,2,3,1,2,3,1,0,12,6,4,2,6,2,0,0,1,-1,1,1,4,1
KR_6750669817,420,5,10,27,9,-1,1,2,1,4,3,-1,1,2,5,5,0,5,6,1,2,9,-6,0,3,3,1,0,0,-1,1,0,1,4,1
KR_6765825175,420,2,56,-19,9,3,4,1,3,5,2,-2,0,2,5,8,3,0,0,0,0,18,3,7,0,7,0,0,0,0,0,0,1,0,1
KR_6750326469,420,2,-7,12,8,3,4,1,2,5,3,2,3,1,1,3,2,0,1,1,1,10,-2,3,1,4,-5,0,0,1,1,1,1,6,1
KR_6722115237,420,6,89,20,6,2,3,1,5,5,0,-2,0,2,1,2,1,0,0,0,0,3,2,3,3,6,-5,0,1,1,1,1,1,1,1
KR_6766543806,420,1,64,-8,7,2,3,1,1,4,3,0,0,0,5,6,1,-1,0,1,0,8,50,4,4,8,-13,0,0,-1,1,1,-1,6,1
KR_6722744703,440,-1,-11,16,1,-2,0,2,3,6,3,-5,0,5,4,4,0,1,1,0,0,2,0,4,3,7,0,0,1,1,-1,1,1,2,1
KR_6630966846,420,1,38,20,1,0,2,2,2,3,1,-1,3,4,-1,1,2,1,2,1,0,7,5,-1,6,5,4,0,0,0,0,1,-1,0,1
KR_6716606011,420,3,-5,4,3,-1,3,4,2,3,1,0,2,2,2,3,1,0,0,0,0,8,-2,-2,8,6,-4,0,1,-1,1,1,1,3,1
KR_6710903795,420,6,133,48,6,0,1,1,5,5,0,2,2,0,-1,0,1,0,0,0,0,5,35,4,2,6,0,0,3,1,0,1,1,3,1
KR_6749421566,420,6,59,24,12,1,2,1,4,6,2,1,1,0,1,6,5,5,5,0,0,5,-271,0,5,5,2,0,0,1,1,0,1,1,1
KR_6728092168,440,3,-30,-22,9,2,7,5,0,1,1,-1,2,3,6,6,0,2,2,0,1,20,-12,-2,7,5,-5,0,2,1,1,1,1,1,1
KR_6753460013,420,5,90,44,4,3,5,2,2,3,1,-4,1,5,3,4,1,0,1,1,0,1,-37,-4,6,2,2,0,0,1,-1,1,1,2,1
KR_6731653694,440,6,99,32,16,4,4,0,-3,0,3,5,8,3,5,6,1,5,7,2,0,7,-19,-2,4,2,0,0,2,1,1,1,1,2,1
KR_6764736014,420,2,34,8,-2,2,4,2,0,4,4,-1,1,2,-1,0,1,-2,0,2,0,-6,-7,3,4,7,3,0,0,1,1,0,-1,6,1
KR_6749257517,420,4,77,18,10,2,2,0,5,7,2,2,6,4,2,3,1,-1,1,2,0,15,-8,0,3,3,1,0,0,1,-1,1,-1,6,1
KR_6679444048,420,0,67,-28,-1,0,0,0,6,8,2,-4,0,4,0,2,2,-3,2,5,0,-2,-3,-4,7,3,-1,0,1,-1,-1,1,1,4,1
KR_6756042881,420,4,31,26,10,0,2,2,0,3,3,-1,1,2,10,12,2,1,2,1,0,14,66,4,0,4,-18,0,0,1,1,-1,1,6,1
KR_6651144039,420,1,8,20,5,-1,2,3,1,2,1,7,7,0,-2,1,3,0,1,1,0,1,-3,3,0,3,0,0,1,-1,1,1,1,3,1
KR_6758040486,420,2,35,12,1,-5,0,5,3,5,2,-1,0,1,5,6,1,-1,2,3,0,6,-7,-2,8,6,4,0,1,1,-1,1,1,5,1
KR_6646711132,420,2,-21,10,7,2,4,2,9,10,1,-2,0,2,-2,2,4,0,1,1,0,6,-12,-1,9,8,2,0,0,1,1,1,-1,1,1
KR_6745171223,420,2,7,-8,0,3,3,0,-1,2,3,3,5,2,0,2,2,-5,0,5,0,-5,-22,-3,5,2,-1,0,1,1,1,1,1,1,1
KR_6761627447,420,4,53,16,8,-2,0,2,2,4,2,3,4,1,1,3,2,4,5,1,-1,11,3,0,4,4,3,0,0,1,-1,-1,-1,4,1
KR_6724529645,420,-1,-18,-7,3,-1,4,5,-3,4,7,1,2,1,5,6,1,1,1,0,0,5,-46,-3,7,4,18,0,0,0,1,-1,-1,0,1
KR_6563435312,420,6,52,1,16,3,6,3,1,2,1,4,4,0,4,6,2,4,5,1,0,22,0,1,5,6,2,0,1,1,1,1,1,6,1
KR_6651657335,440,-2,-20,0,-2,-4,0,4,5,7,2,0,2,2,0,1,1,-3,1,4,0,1,2,-2,4,2,-6,0,-1,-1,-1,-1,-1,3,1
KR_6705083082,420,-2,-89,9,-1,-2,3,5,8,10,2,-7,0,7,0,2,2,0,2,2,1,-1,-6,-1,3,2,3,0,1,1,-1,1,1,1,1
KR_6711853642,420,3,57,-4,7,-1,1,2,-2,2,4,2,2,0,4,5,1,4,4,0,0,17,-223,0,6,6,4,0,0,-1,1,-1,1,6,1
KR_6760898627,420,4,33,20,3,2,2,0,-1,2,3,4,4,0,-2,1,3,0,1,1,0,-5,3,-2,4,2,2,0,1,1,1,1,1,6,1
KR_6685055516,440,-1,-83,12,-5,0,0,0,-2,1,3,-1,1,2,-2,2,4,0,0,0,0,-6,2,-3,5,2,0,0,0,-1,1,0,1,4,1
KR_6764849872,420,1,-17,-6,5,-2,0,2,-2,1,3,8,12,4,-1,2,3,2,3,1,0,4,-1,2,3,5,3,0,0,-1,-1,0,1,1,1
KR_6647015101,420,4,68,30,5,-1,1,2,3,6,3,0,2,2,1,5,4,2,2,0,-1,1,-16,2,2,4,-1,0,0,1,-1,0,-1,6,1
KR_6629069121,420,4,35,-2,12,3,4,1,7,7,0,4,5,1,-1,0,1,-1,1,2,0,3,12,6,1,7,0,0,2,1,1,1,1,2,1
KR_6672026124,420,3,2,30,5,0,1,1,6,8,2,2,2,0,-4,0,4,1,2,1,0,0,1,0,4,4,1,0,0,1,1,0,1,1,1
KR_6758182797,440,1,28,-21,4,1,1,0,-3,1,4,3,5,2,0,0,0,3,6,3,0,-5,6,1,4,5,0,0,1,-1,-1,1,-1,6,1
KR_6750427394,440,-1,-16,-16,-4,1,6,5,2,2,0,-1,0,1,-2,0,2,-4,0,4,1,-5,1,-2,5,3,2,0,0,-1,1,-1,1,2,1
KR_6753353203,420,1,47,62,7,0,1,1,7,9,2,4,6,2,-5,1,6,1,1,0,0,-6,6,3,0,3,-2,0,-1,0,1,-1,-1,0,1
KR_6723953447,420,2,57,24,4,1,1,0,-1,2,3,0,5,5,2,5,3,2,3,1,0,6,-3,4,2,6,-1,0,1,1,1,1,-1,4,1
KR_6765075916,440,3,97,-28,7,1,2,1,1,2,1,3,4,1,2,2,0,0,0,0,0,6,0,3,1,4,1,0,2,1,1,1,1,6,1
KR_6726552904,420,3,79,21,3,1,1,0,0,4,4,-3,1,4,3,4,1,2,2,0,0,-3,31,1,4,5,-12,0,1,1,-1,1,-1,4,1
KR_6751555161,420,1,31,-8,1,0,2,2,-3,1,4,0,1,1,3,4,1,1,1,0,-1,2,-56,0,6,6,1,0,1,1,1,1,-1,3,1
KR_6748933260,420,2,-9,-44,7,2,5,3,1,1,0,1,2,1,-1,2,3,4,4,0,0,10,-25,2,4,6,-1,0,0,-1,-1,-1,1,1,1
KR_6763796139,420,4,94,-9,8,4,4,0,-2,2,4,5,5,0,-1,0,1,2,2,0,0,4,91,3,1,4,1,0,1,0,1,1,1,0,1
KR_6756582515,420,0,2,4,7,1,1,0,-2,1,3,3,4,1,2,6,4,3,3,0,0,4,5,3,5,8,1,0,1,1,1,1,1,5,1
KR_6744877448,420,3,44,41,3,3,5,2,2,5,3,3,4,1,-4,2,6,-1,1,2,1,0,-10,-2,6,4,2,0,1,1,0,1,1,4,1
KR_6725352196,420,0,9,-18,-1,-1,2,3,-2,1,3,4,6,2,-3,1,4,1,2,1,0,-10,-20,1,3,4,1,0,-2,1,1,-1,1,1,1
KR_6724656928,420,0,-43,25,-6,1,2,1,-2,1,3,-4,1,5,0,3,3,-1,2,3,0,-6,-5,0,6,6,2,0,1,-1,1,-1,1,5,1
KR_6746121056,420,2,40,-11,7,0,2,2,6,7,1,1,1,0,0,2,2,0,2,2,-1,4,-11,4,3,7,5,0,0,1,-1,0,1,1,1
KR_6703193103,420,-2,50,19,-2,-2,1,3,1,2,1,-3,2,5,4,4,0,-2,1,3,0,-2,1,-4,6,2,0,0,1,1,-1,1,1,6,1
KR_6737896477,420,-2,30,0,-1,-5,1,6,-2,4,6,2,6,4,4,8,4,0,2,2,0,7,-13,-8,12,4,8,0,-1,1,-1,-1,-1,4,1
KR_6748170422,420,-1,-9,-12,-3,1,2,1,-5,1,6,1,3,2,-1,2,3,1,1,0,0,4,-1,-2,7,5,0,0,1,-1,-1,1,1,6,1
KR_6755245170,420,3,68,38,-1,0,2,2,-2,1,3,0,1,1,1,4,3,0,0,0,0,3,1,2,3,5,3,0,0,1,-1,0,-1,6,1
KR_6760217013,420,5,96,20,10,3,3,0,3,4,1,2,5,3,3,8,5,-1,0,1,0,6,-3,-2,3,1,2,0,1,1,-1,1,1,5,1
KR_6762777965,420,3,31,-16,13,10,10,0,-2,4,6,1,2,1,3,8,5,1,2,1,0,0,13,8,2,10,-7,0,1,1,1,1,-1,6,1
KR_6723144516,420,1,54,8,7,3,3,0,-1,4,5,0,3,3,3,4,1,2,2,0,0,7,-12,3,4,7,0,0,1,-1,1,1,1,1,1
KR_6629684958,420,0,12,8,4,-3,1,4,-1,6,7,5,7,2,2,3,1,1,2,1,1,0,24,-1,4,3,0,0,0,1,1,1,1,3,1
KR_6601143999,420,-1,-28,17,2,-1,0,1,1,1,0,1,1,0,-1,1,2,2,2,0,0,2,31,-1,7,6,-4,0,1,1,1,1,1,1,1
KR_6749530446,420,5,36,8,10,5,6,1,3,3,0,0,2,2,1,4,3,1,1,0,0,3,-4,3,3,6,-3,0,0,1,-1,1,1,5,1
KR_6655256239,420,2,-16,19,8,-4,0,4,1,5,4,2,4,2,8,11,3,1,2,1,0,13,3,4,4,8,1,0,2,1,1,1,-1,4,1
KR_6763252653,420,-2,43,3,-2,-1,2,3,-1,3,4,0,4,4,1,3,2,-1,0,1,0,0,7,-2,6,4,2,0,1,0,1,1,-1,0,1
KR_6739030310,420,3,24,28,-2,1,3,2,-2,1,3,4,9,5,-4,0,4,-1,0,1,0,1,1,3,5,8,0,0,1,1,1,1,-1,3,1
KR_6734161355,420,3,111,-12,9,4,4,0,-1,2,3,1,3,2,4,5,1,1,1,0,0,2,-112,3,9,12,7,0,-1,1,1,1,1,3,1
KR_6758983655,440,6,114,32,12,4,6,2,-3,0,3,3,4,1,8,9,1,0,3,3,2,19,6,6,4,10,2,0,1,1,-1,1,1,3,1
KR_6752641168,420,1,-62,36,0,2,3,1,-2,1,3,0,1,1,-1,2,3,1,1,0,0,-1,0,0,5,5,-4,0,0,-1,1,0,1,3,1
KR_6713402866,420,7,47,44,8,0,1,1,6,7,1,5,8,3,-4,1,5,1,2,1,0,6,29,-1,3,2,-2,0,3,-1,1,1,1,1,1
KR_6742117561,420,2,-14,-12,1,2,2,0,-1,2,3,-1,1,2,-1,1,2,2,3,1,-1,-3,17,-4,9,5,10,0,-1,1,-1,-1,-1,5,1
KR_6751489817,420,2,-3,24,2,-6,1,7,2,3,1,0,3,3,6,7,1,0,0,0,1,6,-7,2,4,6,6,0,1,0,1,1,1,0,1
KR_6755985542,420,4,52,0,8,0,1,1,5,6,1,3,5,2,0,0,0,0,0,0,0,3,122,3,4,7,14,0,0,0,1,0,1,0,1
KR_6740861308,420,3,0,29,4,0,1,1,0,2,2,2,3,1,0,2,2,2,3,1,0,-1,-1,-1,4,3,2,0,1,1,1,1,-1,6,1
KR_6763049363,420,7,64,5,21,1,1,0,-2,2,4,9,9,0,10,11,1,3,3,0,0,21,-187,5,2,7,1,0,1,1,-1,1,1,6,1
KR_6684553049,420,4,71,0,9,1,3,2,2,2,0,3,5,2,3,5,2,0,1,1,-1,19,-3,0,7,7,-1,0,3,1,1,1,-1,3,1
KR_6671370746,420,4,29,-12,13,0,2,2,1,3,2,0,2,2,8,9,1,4,4,0,0,17,16,2,5,7,7,0,1,1,1,1,1,5,1
KR_6764855434,420,0,16,17,0,0,1,1,-1,1,2,1,3,2,1,2,1,-1,0,1,0,0,-3,-4,8,4,6,0,0,0,0,0,1,0,1
KR_6732582735,420,0,34,-21,-3,1,5,4,2,3,1,-2,5,7,-3,0,3,-1,0,1,0,-4,-2,-4,8,4,-1,0,0,-1,-1,-1,1,6,1
KR_6746266893,440,0,-38,16,2,0,1,1,2,5,3,2,5,3,-5,0,5,3,5,2,0,-2,-2,0,4,4,-1,0,1,-1,1,1,-1,5,1
KR_6729376009,420,4,49,-13,12,4,4,0,0,3,3,0,2,2,9,10,1,-1,1,2,-1,11,0,0,3,3,-4,0,2,1,1,1,-1,2,1
KR_6762464610,420,0,-7,-8,5,-1,2,3,1,3,2,4,5,1,2,4,2,-1,1,2,0,3,0,0,4,4,0,0,-2,-1,-1,-1,1,5,1
KR_6659303394,420,0,-30,17,-1,-5,0,5,2,4,2,5,7,2,-4,0,4,1,1,0,0,5,8,1,3,4,-1,0,0,1,0,-1,-1,3,1
KR_6764898828,420,3,52,-15,13,3,6,3,5,5,0,0,2,2,5,5,0,0,2,2,0,9,2,0,3,3,-2,0,2,1,1,1,1,5,1
KR_6751934991,420,2,59,4,4,2,4,2,0,2,2,-2,0,2,-1,2,3,5,5,0,0,11,-6,-1,5,4,4,0,1,-1,1,1,-1,1,1
KR_6704916041,420,0,50,4,2,0,3,3,4,8,4,-1,1,2,-4,0,4,3,4,1,0,-4,13,0,4,4,6,0,1,1,0,1,-1,3,1
KR_6722204744,440,3,20,-4,-5,1,6,5,1,2,1,-4,1,5,-1,3,4,-2,0,2,0,-4,47,0,3,3,-24,0,1,1,0,1,1,1,1
KR_6760158962,420,3,-66,-16,8,-1,1,2,7,10,3,2,6,4,0,2,2,0,1,1,0,7,12,-2,5,3,-2,0,2,1,1,1,1,2,1
KR_6633028236,420,2,21,-9,9,3,5,2,3,4,1,2,6,4,0,3,3,1,2,1,0,11,46,0,6,6,-21,0,1,1,-1,1,-1,1,1
KR_6747976809,420,2,64,0,8,2,2,0,3,4,1,1,2,1,-1,4,5,3,4,1,0,8,0,1,3,4,0,0,1,-1,1,1,1,2,1
KR_6622496270,420,0,26,7,-1,6,6,0,-2,2,4,3,6,3,-6,0,6,-2,0,2,-1,-10,-6,1,4,5,-1,0,1,0,1,1,-1,0,1
KR_6625228648,420,4,47,-5,8,3,3,0,-2,2,4,0,1,1,3,4,1,4,6,2,0,12,4,1,3,4,-4,0,0,1,1,1,1,2,1
KR_6728060365,420,2,-17,-11,0,-2,0,2,2,6,4,-1,1,2,0,3,3,1,1,0,0,7,-1,2,2,4,0,0,0,1,0,-1,-1,6,1
KR_6760653412,420,4,14,22,12,0,1,1,5,5,0,5,6,1,3,4,1,-1,0,1,0,7,229,-5,7,2,24,0,1,1,0,1,1,2,1
KR_6754088601,420,1,3,-19,9,5,7,2,-1,3,4,2,3,1,2,3,1,1,1,0,0,9,-2,-1,4,3,1,0,0,0,1,0,-1,0,1
KR_6730962919,420,1,-11,27,1,-2,2,4,2,4,2,1,2,1,1,6,5,-1,2,3,0,4,-7,-6,10,4,-2,0,-1,1,-1,-1,1,5,1
KR_6759903252,420,3,92,0,10,0,1,1,9,14,5,2,3,1,2,4,2,-3,0,3,1,6,4,-1,6,5,-1,0,2,-1,1,1,-1,1,1
KR_6725373999,420,0,-17,20,9,1,1,0,6,7,1,1,2,1,0,2,2,1,1,0,0,10,-5,-3,7,4,3,0,0,1,1,0,1,3,1
KR_6758922892,420,0,29,10,2,-1,3,4,0,2,2,0,3,3,1,3,2,2,4,2,1,1,116,-3,6,3,2,0,1,0,1,1,1,0,1
KR_6761242228,420,1,39,-8,7,1,4,3,2,4,2,-1,1,2,3,6,3,2,2,0,0,10,-11,2,3,5,2,0,0,0,1,0,1,0,1
KR_6731200969,420,-1,9,4,-6,-3,0,3,-1,0,1,-4,2,6,3,4,1,-1,0,1,0,-4,-3,-1,6,5,-1,0,0,-1,-1,1,-1,5,1
KR_6755470790,420,0,-13,18,3,2,2,0,3,4,1,-1,0,1,-1,2,3,0,0,0,0,1,0,4,5,9,-1,0,0,1,1,0,1,5,1
KR_6720095475,420,2,-14,6,4,0,1,1,0,2,2,-1,1,2,6,6,0,-1,0,1,0,10,4,2,7,9,4,0,1,1,1,1,-1,5,1
KR_6744548680,420,2,58,-12,2,4,5,1,2,5,3,0,1,1,-4,1,5,0,0,0,2,-3,-32,4,5,9,13,0,2,1,-1,1,1,3,1
KR_6652805167,420,4,-5,0,10,1,2,1,3,9,6,4,5,1,0,2,2,2,2,0,0,9,2,3,4,7,5,0,2,1,1,1,-1,6,1
KR_6756281366,420,-4,-37,-25,0,0,2,2,1,4,3,1,2,1,-2,2,4,0,1,1,0,-4,-7,4,6,10,4,0,-1,-1,1,1,1,3,1
KR_6742865607,420,3,56,28,5,3,4,1,1,5,4,-1,1,2,0,2,2,2,3,1,0,2,124,1,3,4,-1,0,1,1,1,1,1,1,1
KR_6671044426,420,1,53,13,4,-1,2,3,-1,0,1,3,4,1,2,6,4,1,2,1,0,16,7,1,4,5,5,0,0,1,-1,0,-1,6,1
KR_6751850692,420,1,62,32,6,4,6,2,3,3,0,6,8,2,-6,1,7,-1,0,1,2,4,0,3,1,4,2,0,1,1,1,1,1,1,1
KR_6670446938,440,-3,-14,7,-7,-1,0,1,-1,0,1,1,2,1,-6,4,10,0,0,0,0,-14,-6,0,8,8,1,0,0,1,1,-1,-1,6,1
KR_6760952748,420,4,9,14,15,2,3,1,6,6,0,4,7,3,1,3,2,2,3,1,0,25,-5,1,3,4,-2,0,0,-1,-1,0,1,6,1
KR_6700514685,420,1,-19,6,0,0,1,1,3,3,0,-3,1,4,-2,1,3,2,2,0,0,-2,18,-3,7,4,0,0,0,-1,1,-1,-1,6,1
KR_6762211231,420,2,117,-20,1,0,2,2,-1,2,3,-3,0,3,3,5,2,2,2,0,0,1,6,-1,6,5,4,0,1,-1,-1,1,-1,4,1
KR_6760834879,420,3,57,7,-1,0,1,1,0,0,0,-4,0,4,-1,3,4,4,4,0,0,1,11,1,5,6,-1,0,-1,-1,-1,1,1,5,1
KR_6753048298,420,1,28,8,5,3,4,1,-2,0,2,4,4,0,-1,3,4,1,1,0,0,8,93,4,5,9,-3,0,0,-1,1,0,1,2,1
KR_6752813458,420,1,20,-8,9,1,5,4,4,5,1,3,3,0,3,5,2,-2,0,2,1,4,37,3,6,9,-29,0,-1,1,-1,-1,1,2,1
KR_6749714871,420,4,37,26,11,-1,0,1,2,4,2,1,3,2,2,3,1,7,7,0,0,14,29,4,1,5,2,0,2,1,-1,1,1,6,1
KR_6701097860,420,1,53,8,-2,0,3,3,-2,4,6,-3,1,4,3,4,1,0,0,0,-1,-2,4,3,4,7,-6,0,0,1,0,0,-1,1,1
KR_6727598510,420,4,61,-29,14,4,4,0,1,6,5,2,4,2,4,4,0,3,3,0,0,9,6,7,5,12,-1,0,1,-1,1,1,1,1,1
KR_6633621525,420,2,-28,-9,12,3,3,0,2,5,3,4,5,1,2,3,1,1,3,2,0,19,-2,-4,10,6,4,0,2,1,1,1,-1,4,1
KR_6749789796,420,-2,-3,-4,-7,-2,1,3,0,1,1,-5,0,5,0,4,4,0,2,2,0,-3,-30,1,3,4,12,0,1,1,1,1,-1,6,1
KR_6746795349,420,5,73,11,15,2,3,1,4,7,3,2,4,2,8,9,1,-1,1,2,1,10,0,-4,11,7,3,0,4,-1,1,1,1,1,1
KR_6706915668,440,11,125,24,15,7,8,1,-1,2,3,2,4,2,9,9,0,-2,0,2,0,4,8,1,4,5,0,0,4,1,-1,1,1,5,1
KR_6679049568,420,1,15,-18,0,-2,1,3,3,5,2,-1,0,1,2,4,2,-2,2,4,0,5,-4,0,5,5,0,0,1,-1,1,1,1,3,1
KR_6745313357,420,3,67,0,10,0,1,1,3,5,2,3,4,1,2,3,1,2,2,0,0,9,-6,-3,6,3,4,0,1,1,-1,1,1,4,1
KR_6732995366,420,2,-18,-2,4,2,2,0,-1,1,2,3,5,2,0,4,4,0,1,1,-1,2,10,3,4,7,3,0,0,-1,1,1,-1,3,1
KR_6686387358,420,4,76,20,4,2,2,0,1,4,3,-1,1,2,1,2,1,1,1,0,0,7,32,2,5,7,1,0,1,1,1,1,1,3,1
KR_6683302424,420,3,110,-11,15,4,6,2,4,6,2,2,7,5,4,5,1,1,3,2,1,15,-9,-1,5,4,0,0,1,-1,-1,1,1,4,1
KR_6696628925,420,4,50,-23,8,-1,1,2,2,5,3,0,0,0,6,10,4,1,2,1,1,10,0,1,3,4,-1,0,2,1,0,1,1,1,1
KR_6760439152,420,2,-3,-4,9,0,5,5,0,1,1,2,3,1,5,6,1,2,2,0,0,13,-1,4,0,4,0,0,0,1,-1,0,1,5,1
KR_6739556158,420,1,34,-7,2,-1,1,2,2,3,1,-1,2,3,3,3,0,-1,0,1,0,2,11,4,0,4,2,0,1,1,-1,-1,1,3,1
KR_6743054554,420,0,73,16,1,0,3,3,0,2,2,3,4,1,0,4,4,-2,1,3,-1,-7,1,-1,4,3,1,0,0,-1,1,1,-1,1,1
KR_6722193110,420,-1,-33,16,4,0,1,1,8,9,1,-5,1,6,1,3,2,0,0,0,0,14,-2,4,7,11,4,0,-1,1,1,-1,1,3,1
KR_6752116489,440,-1,-19,4,-4,-1,1,2,-4,2,6,2,5,3,2,7,5,-3,0,3,0,-4,-32,-1,6,5,1,0,1,0,-1,-1,-1,0,1
KR_6488711981,420,1,-87,23,12,1,2,1,3,8,5,3,4,1,-2,3,5,7,7,0,0,13,-1,-1,7,6,-7,0,-1,1,1,-1,1,5,1
KR_6750250280,420,-1,17,-6,-7,-2,0,2,-2,2,4,1,4,3,-3,2,5,-1,0,1,0,-3,71,0,4,4,-20,0,2,1,1,1,1,3,1
KR_6755522644,420,1,55,20,2,4,6,2,-3,5,8,3,4,1,-2,1,3,0,0,0,0,-12,1,-2,8,6,3,0,2,1,1,1,1,4,1
KR_6644661583,420,6,61,24,15,3,4,1,5,7,2,2,5,3,6,7,1,-1,0,1,0,12,8,2,5,7,2,0,2,0,1,1,-1,0,1
KR_6755168325,440,4,33,5,9,-1,2,3,1,3,2,1,1,0,7,9,2,1,2,1,0,11,-3,1,4,5,4,0,2,1,-1,1,1,3,1
KR_6649288163,440,-1,-31,12,3,-2,0,2,-1,3,4,1,2,1,4,7,3,1,2,1,0,14,1,-2,4,2,1,0,0,1,-1,0,1,4,1
KR_6765259444,420,-2,-52,4,-2,-5,1,6,-2,0,2,0,3,3,2,3,1,3,4,1,0,-6,12,1,6,7,0,0,0,-1,-1,0,1,2,1
KR_6555230110,420,2,29,-12,6,-5,1,6,5,6,1,1,3,2,2,2,0,3,3,0,0,19,-340,1,5,6,2,0,0,-1,-1,-1,-1,1,1
KR_6753941888,440,-1,32,-4,3,-3,1,4,0,2,2,4,5,1,3,3,0,-1,0,1,0,13,42,2,6,8,-19,0,0,0,-1,0,1,0,1
KR_6749945027,420,2,30,10,8,6,7,1,1,3,2,2,3,1,0,2,2,-1,0,1,1,1,4,-1,6,5,2,0,2,1,1,1,1,1,1
KR_6765718530,440,-1,-26,-19,3,0,0,0,-3,2,5,4,5,1,1,1,0,1,3,2,0,-1,9,-5,6,1,2,0,0,0,1,0,1,0,1
KR_6741828785,420,-1,-18,5,5,1,3,2,10,10,0,3,6,3,-6,2,8,-3,0,3,0,14,37,-4,5,1,1,0,0,0,1,1,-1,0,1
KR_6708535944,420,2,44,8,-2,-8,0,8,0,0,0,3,3,0,2,2,0,1,1,0,0,3,12,5,5,10,1,0,1,1,-1,1,1,1,1
KR_6731713211,420,5,50,21,10,0,2,2,5,7,2,1,3,2,4,4,0,0,0,0,0,14,-1,0,6,6,-1,0,1,1,-1,1,1,3,1
KR_6759335354,420,4,26,0,16,3,3,0,7,8,1,1,1,0,3,3,0,2,2,0,0,15,4,2,3,5,0,0,1,1,1,1,1,4,1
KR_6686482194,420,2,29,-26,2,1,2,1,-2,2,4,3,5,2,0,3,3,0,1,1,-1,-11,-29,5,2,7,2,0,0,-1,1,1,-1,3,1
KR_6750356447,420,-1,-9,-27,10,6,6,0,2,2,0,0,0,0,1,8,7,1,1,0,2,15,-35,1,7,8,15,0,1,1,1,1,1,2,1
KR_6744914330,420,4,43,33,5,2,2,0,-1,2,3,3,4,1,-1,1,2,2,2,0,0,0,-275,1,2,3,1,0,1,1,1,1,-1,2,1
KR_6758393797,420,2,35,4,2,0,2,2,1,2,1,-2,0,2,1,2,1,2,4,2,0,4,2,1,6,7,-2,0,0,0,1,0,-1,0,1
KR_6721893136,420,3,36,-8,10,3,4,1,3,4,1,1,2,1,2,3,1,1,1,0,0,13,-4,0,4,4,-2,0,1,-1,1,1,1,6,1
KR_6629981070,420,0,65,9,0,-3,0,3,1,4,3,0,1,1,2,5,3,0,1,1,0,5,0,-4,6,2,-1,0,0,0,-1,0,1,0,1
KR_6708641224,420,3,49,7,1,2,2,0,-1,2,3,0,1,1,0,1,1,0,0,0,-1,-5,29,0,7,7,1,0,0,1,1,0,-1,2,1
KR_6761311671,420,0,14,-9,7,4,5,1,-1,0,1,-3,1,4,5,5,0,2,2,0,1,12,3,1,4,5,-1,0,0,-1,0,0,1,3,1
KR_6756254893,420,7,28,64,20,3,4,1,10,12,2,2,4,2,4,6,2,1,1,0,0,16,33,7,0,7,1,0,2,1,1,1,1,6,1
KR_6751278786,440,4,54,17,3,0,1,1,-1,0,1,5,8,3,6,7,1,-7,0,7,0,5,3,1,5,6,0,0,1,1,1,1,1,1,1
KR_6630725881,420,2,60,1,7,1,5,4,1,4,3,-1,2,3,8,12,4,-2,0,2,0,2,8,1,5,6,3,0,2,1,1,1,-1,4,1
KR_6690888141,440,5,46,48,7,0,1,1,7,7,0,6,6,0,-4,0,4,-2,0,2,0,-2,-6,-3,10,7,-1,0,1,1,1,1,1,1,1
KR_6647785535,420,1,71,-19,4,-4,0,4,-1,4,5,-1,4,5,10,12,2,0,1,1,-1,-4,-7,1,7,8,-3,0,2,1,1,1,-1,2,1
KR_6740721105,420,-1,43,0,2,1,4,3,1,4,3,0,5,5,0,2,2,0,0,0,0,2,-18,5,3,8,-1,0,1,-1,0,1,-1,6,1
KR_6756289106,420,4,-32,1,10,1,1,0,3,5,2,3,4,1,2,4,2,1,2,1,0,15,2,0,3,3,2,0,1,-1,-1,1,-1,2,1
KR_6761435263,420,-2,18,-11,0,-1,0,1,-2,3,5,6,7,1,0,2,2,-3,0,3,0,3,-4,0,6,6,0,0,1,-1,-1,1,1,3,1
KR_6750745385,420,2,-26,-16,7,1,2,1,1,3,2,0,2,2,5,6,1,0,1,1,0,8,4,3,1,4,-1,0,0,-1,-1,0,1,4,1
KR_6739863186,420,5,51,-3,15,9,10,1,-3,0,3,5,6,1,4,5,1,0,0,0,1,7,1,3,5,8,3,0,2,1,1,1,1,6,1
KR_6760197888,420,3,69,-2,9,2,2,0,5,7,2,1,1,0,1,4,3,0,3,3,0,7,-2,-1,5,4,3,0,1,-1,1,1,1,6,1
KR_6746668748,440,2,33,8,0,2,4,2,0,3,3,-4,2,6,1,4,3,1,2,1,0,-3,100,-1,5,4,-3,0,1,0,0,1,1,0,1
KR_6763489832,420,5,48,24,9,0,2,2,2,4,2,1,2,1,5,6,1,1,1,0,0,6,-13,1,5,6,0,0,0,1,-1,1,-1,5,1
KR_6705453681,420,1,46,-13,6,4,5,1,0,2,2,1,1,0,1,6,5,0,4,4,1,2,-12,-1,7,6,0,0,2,1,1,1,1,3,1
KR_6601095292,420,1,-60,11,4,2,3,1,2,2,0,0,2,2,0,1,1,0,2,2,0,1,48,6,2,8,-2,0,0,1,1,0,1,1,1
KR_6704602500,440,5,54,44,5,-1,3,4,1,3,2,3,5,2,2,4,2,0,1,1,0,8,5,2,2,4,-1,0,2,1,-1,1,1,6,1
KR_6702282029,420,2,83,-16,3,3,3,0,0,3,3,0,2,2,0,3,3,0,0,0,0,2,-13,-1,5,4,30,0,0,0,0,0,-1,0,1
KR_6618807594,420,7,92,24,16,5,5,0,1,4,3,5,5,0,5,6,1,0,0,0,2,14,7,1,3,4,-3,0,2,1,1,1,1,4,1
KR_6704089125,420,3,47,23,8,5,7,2,3,6,3,-4,2,6,1,3,2,3,3,0,0,4,-12,2,0,2,4,0,1,1,1,1,-1,6,1
KR_6754563781,420,-1,14,-4,-2,0,2,2,-4,0,4,0,3,3,3,3,0,-1,0,1,1,-1,-6,2,1,3,-5,0,0,-1,1,0,1,1,1
KR_6661380204,420,0,47,-5,-2,0,1,1,-4,2,6,0,6,6,3,4,1,-1,1,2,0,-7,-37,0,2,2,3,0,0,-1,-1,-1,-1,2,1
KR_6733639671,420,-2,-7,13,-7,-1,0,1,-7,1,8,2,4,2,-6,2,8,5,5,0,-1,-11,69,-3,6,3,-3,0,-1,-1,-1,-1,-1,4,1
KR_6744403710,420,2,36,12,8,-1,0,1,8,9,1,6,6,0,-6,1,7,1,2,1,0,6,0,-6,8,2,5,0,0,-1,-1,1,-1,6,1
KR_6748387674,420,1,17,-20,3,-1,2,3,-1,1,2,2,2,0,3,4,1,0,3,3,0,-3,-24,4,4,8,1,0,1,-1,1,1,-1,4,1
KR_6734486321,440,2,32,-10,4,3,7,4,-2,2,4,2,2,0,2,5,3,-1,0,1,0,-6,5,0,2,2,-4,0,1,1,-1,1,-1,5,1
KR_6656755863,420,1,-3,20,0,-3,2,5,0,5,5,1,3,2,2,2,0,0,2,2,0,3,-1,1,6,7,-3,0,-2,1,-1,-1,1,2,1
KR_6652596668,420,-1,17,-21,-6,1,3,2,-5,1,6,-3,3,6,0,2,2,1,1,0,1,-2,-5,-6,8,2,-1,0,0,1,-1,0,1,1,1
KR_6763429745,440,3,82,-1,13,-1,0,1,2,3,1,3,3,0,3,3,0,6,6,0,0,16,99,3,4,7,0,0,1,1,-1,1,-1,6,1
KR_6674026169,420,0,0,18,-3,-1,1,2,-6,1,7,0,3,3,6,10,4,-2,0,2,0,6,-54,0,4,4,1,0,0,1,-1,-1,-1,2,1
KR_6717413455,440,3,89,0,5,-3,0,3,2,3,1,2,2,0,0,0,0,4,4,0,0,7,16,8,2,10,-1,0,1,1,1,1,-1,1,1
KR_6740613789,440,4,-13,20,5,4,4,0,3,3,0,0,5,5,-2,0,2,0,6,6,0,11,0,-3,8,5,-2,0,1,0,-1,1,1,0,1
KR_6562114007,420,6,114,-23,15,2,3,1,0,0,0,6,6,0,6,6,0,1,2,1,2,21,-7,2,2,4,-1,0,3,1,-1,1,1,5,1
KR_6723880980,420,0,5,-20,7,3,3,0,-1,2,3,2,2,0,4,5,1,-1,2,3,0,10,0,1,2,3,3,0,-1,1,-1,-1,-1,2,1
KR_6632506391,420,3,27,24,8,7,8,1,2,4,2,-2,1,3,-1,1,2,2,3,1,1,8,-3,-3,8,5,8,0,0,1,1,1,1,6,1
KR_6765475390,420,2,1,-9,3,2,2,0,0,6,6,0,3,3,2,3,1,-1,0,1,0,1,-4,0,4,4,1,0,1,0,1,1,1,0,1
KR_6724114919,420,3,2,13,-1,1,2,1,-3,0,3,2,4,2,-3,3,6,2,3,1,0,-4,-24,0,5,5,6,0,1,-1,1,1,-1,4,1
KR_6651577187,420,6,67,28,14,2,3,1,6,8,2,5,6,1,0,1,1,1,2,1,0,14,-122,-6,7,1,2,0,3,1,1,1,1,5,1
KR_6622380556,420,2,14,24,3,1,3,2,3,5,2,-1,1,2,-3,0,3,3,3,0,0,-1,3,-6,14,8,2,0,2,1,1,1,-1,3,1
KR_6762585618,420,-1,8,-4,-3,4,4,0,-2,0,2,-2,1,3,1,2,1,-4,0,4,0,-2,5,0,3,3,-6,0,0,-1,1,0,1,4,1
KR_6729915959,440,-3,-21,-27,-6,-2,1,3,-7,1,8,0,1,1,-1,0,1,4,4,0,0,-8,-2,-5,7,2,3,0,0,1,-1,0,1,3,1
KR_6759494648,420,-1,1,25,-15,2,6,4,-7,2,9,-2,0,2,-3,1,4,-5,0,5,-2,-21,-3,-5,7,2,2,0,-1,-1,0,1,-1,3,1
KR_6765644756,420,5,79,4,17,5,5,0,-1,1,2,4,10,6,10,13,3,-1,0,1,0,27,-1,-1,5,4,-2,0,3,-1,1,1,1,6,1
KR_6735442509,440,1,1,-4,-3,-2,2,4,-2,3,5,0,3,3,4,5,1,-3,0,3,0,-1,-17,-1,7,6,-1,0,0,-1,0,0,-1,3,1
KR_6738711552,420,7,104,34,10,-3,0,3,2,2,0,7,8,1,2,5,3,2,2,0,1,20,-94,4,2,6,-3,0,2,1,-1,1,1,3,1
KR_6617804212,420,1,19,-35,3,1,3,2,1,3,2,3,4,1,-2,1,3,0,0,0,0,0,4,-2,5,3,1,0,0,-1,1,1,1,6,1
KR_6684690538,420,3,79,-16,2,1,1,0,4,5,1,-5,1,6,0,5,5,2,2,0,0,-3,364,6,2,8,0,0,2,-1,1,1,1,6,1
KR_6661058032,420,5,74,13,18,2,2,0,3,3,0,1,3,2,9,9,0,3,3,0,0,21,272,-2,7,5,-6,0,2,1,1,1,1,2,1
KR_6744482574,420,1,48,-2,3,-3,0,3,0,3,3,2,4,2,2,6,4,2,3,1,0,4,7,4,3,7,2,0,0,-1,1,0,1,2,1
KR_6761549953,420,6,58,4,11,1,1,0,4,4,0,-1,0,1,3,4,1,4,5,1,0,16,6,0,6,6,1,0,1,1,-1,1,1,3,1
KR_6755031113,420,3,91,21,1,2,4,2,-1,5,6,0,3,3,-1,4,5,1,3,2,1,2,7,2,2,4,-3,0,2,1,1,1,1,1,1
KR_6679977911,420,1,5,-4,5,1,1,0,1,3,2,-1,2,3,3,4,1,1,3,2,1,10,-14,2,3,5,3,0,1,0,1,1,1,0,1
KR_6723758985,420,3,-11,1,4,-3,1,4,-4,2,6,3,4,1,7,7,0,1,1,0,0,4,-3,4,1,5,-4,0,2,1,1,1,1,4,1
KR_6702124989,440,3,88,12,11,3,4,1,6,7,1,3,4,1,-2,2,4,1,1,0,0,4,47,2,2,4,-28,0,1,-1,1,1,1,1,1
KR_6720488155,420,3,70,14,5,0,3,3,2,4,2,6,8,2,-2,3,5,-1,1,2,0,1,2,4,6,10,2,0,0,-1,1,-1,-1,1,1
KR_6696078071,420,4,12,23,6,-1,0,1,-2,5,7,1,2,1,7,10,3,1,2,1,0,-3,9,2,3,5,2,0,2,1,-1,1,-1,2,1
KR_6765686530,420,4,57,29,9,2,2,0,2,3,1,2,4,2,2,3,1,1,1,0,0,17,-1,-3,8,5,2,0,2,1,1,1,1,4,1
KR_6764818061,420,2,79,23,1,2,5,3,3,3,0,0,2,2,-5,1,6,1,2,1,0,-2,15,3,1,4,4,0,2,-1,1,1,-1,3,1
KR_6635753874,420,1,-109,24,2,1,2,1,-2,4,6,2,3,1,-3,2,5,4,5,1,-1,-9,29,-5,9,4,0,0,-1,1,-1,-1,-1,2,1
KR_6725423317,420,3,57,44,2,2,3,1,5,6,1,-3,3,6,-2,0,2,0,1,1,0,-1,0,5,3,8,4,0,1,1,-1,1,1,1,1
KR_6761450041,420,-1,12,-12,-3,-3,0,3,-1,4,5,-2,1,3,2,3,1,1,2,1,0,3,8,4,2,6,-3,0,0,1,0,0,-1,1,1
KR_6639795073,420,0,-17,1,1,0,1,1,3,3,0,-1,1,2,-2,3,5,1,3,2,0,3,-38,-1,7,6,4,0,1,1,-1,1,1,4,1
KR_6765868002,420,1,-9,23,2,-3,1,4,3,3,0,2,4,2,0,4,4,0,1,1,1,9,13,5,3,8,-5,0,-1,-1,0,-1,1,4,1
KR_6697812812,420,2,49,-19,2,-1,0,1,-4,5,9,2,2,0,5,5,0,0,0,0,0,6,13,3,3,6,3,0,2,0,-1,1,1,0,1
KR_6764731730,420,-1,18,13,-3,2,2,0,-5,1,6,1,2,1,0,1,1,-1,1,2,0,-8,-6,4,3,7,-3,0,0,1,1,0,1,4,1
KR_6752039099,420,5,66,-11,18,9,9,0,5,6,1,0,1,1,6,7,1,-2,1,3,1,23,1,1,5,6,4,0,4,1,1,1,-1,5,1
KR_6750696782,420,0,60,-14,5,0,0,0,2,6,4,-3,1,4,2,5,3,4,5,1,-1,5,4,1,5,6,-1,0,0,-1,-1,0,-1,5,1
KR_6717153123,420,-1,30,7,-4,1,2,1,-3,2,5,0,4,4,-1,0,1,-1,0,1,0,-9,21,-5,7,2,2,0,0,0,-1,0,1,0,1
KR_6725030931,420,5,49,34,7,1,1,0,1,1,0,-3,0,3,6,7,1,2,2,0,0,5,-122,-3,7,4,0,0,2,1,-1,1,1,4,1
KR_6603952023,440,4,-1,-1,10,1,1,0,5,6,1,1,1,0,2,5,3,1,3,2,0,7,4,-3,6,3,2,0,1,-1,1,1,1,6,1
KR_6764555380,420,3,42,33,3,2,2,0,-1,1,2,0,2,2,3,3,0,-1,0,1,0,5,-55,-4,9,5,1,0,1,-1,1,1,1,4,1
KR_6753300489,420,2,-8,0,1,0,1,1,-1,3,4,2,2,0,1,4,3,-1,0,1,0,-2,18,0,5,5,7,0,0,-1,1,0,1,5,1
KR_6765785177,440,1,41,17,2,-1,1,2,0,0,0,2,2,0,0,0,0,1,1,0,0,5,-5,3,6,9,0,0,0,0,1,0,-1,0,1
KR_6765154450,420,0,21,20,4,1,4,3,3,4,1,3,3,0,-4,1,5,1,2,1,0,7,3,4,2,6,-3,0,1,0,1,-1,1,0,1
KR_6752092459,420,0,83,-4,3,-3,1,4,2,3,1,7,7,0,-2,4,6,-1,0,1,0,3,47,-1,5,4,7,0,1,0,1,1,-1,0,1
KR_6761282040,420,0,109,-22,-3,-1,2,3,-2,0,2,-1,0,1,0,1,1,1,1,0,0,-2,23,3,2,5,-4,0,0,1,-1,0,1,2,1
KR_6764238199,420,0,-17,-27,2,2,2,0,-2,2,4,1,1,0,-1,4,5,2,2,0,0,4,-6,1,4,5,2,0,-1,-1,-1,-1,-1,5,1
KR_6737960387,420,-1,-6,-9,3,-1,0,1,3,5,2,1,1,0,-1,2,3,1,1,0,0,1,11,-4,8,4,1,0,1,1,1,1,1,1,1
KR_6730008274,420,-1,-48,-4,-7,2,3,1,-5,0,5,1,4,3,-3,1,4,-2,0,2,-4,-12,-12,-5,5,0,3,0,0,1,0,0,-1,6,1
KR_6709035569,420,3,-3,-4,9,0,3,3,6,6,0,3,4,1,1,3,2,-1,1,2,-1,4,-10,-3,10,7,7,0,0,1,-1,0,-1,2,1
KR_6735852476,440,0,-26,-44,10,1,3,2,0,0,0,1,1,0,0,1,1,8,8,0,0,20,2,3,3,6,4,0,1,1,-1,1,1,1,1
KR_6036498277,420,5,30,13,9,-1,1,2,0,7,7,8,8,0,1,2,1,1,2,1,0,9,2,0,4,4,4,0,1,-1,1,1,-1,2,1
KR_6765240527,440,5,104,44,9,4,4,0,1,4,3,5,5,0,0,2,2,-1,0,1,0,1,-90,0,1,1,-9,0,2,1,-1,1,1,1,1
KR_6766467080,440,6,5,32,17,2,3,1,4,5,1,3,9,6,0,0,0,8,8,0,0,23,-27,-3,5,2,1,0,0,1,1,0,-1,1,1
KR_6761690440,420,2,3,-2,-5,2,2,0,-1,1,2,2,3,1,-9,0,9,1,2,1,0,-8,92,1,3,4,-2,0,1,-1,1,1,-1,3,1
KR_6764812867,420,2,86,-4,6,1,3,2,4,5,1,1,4,3,1,2,1,-1,1,2,0,5,11,7,2,9,-2,0,0,1,1,1,1,3,1
KR_6748680943,420,1,-6,6,11,4,4,0,3,6,3,-1,1,2,5,6,1,0,0,0,1,19,-17,-1,10,9,9,0,-1,1,0,1,1,4,1
KR_6649779127,420,2,60,-22,5,1,2,1,3,3,0,-3,0,3,1,3,2,3,4,1,0,7,-13,5,3,8,2,0,0,1,-1,1,1,4,1
KR_6765525867,420,1,-8,1,1,1,1,0,-1,2,3,1,1,0,0,0,0,0,0,0,0,1,-2,-1,6,5,1,0,0,1,1,0,1,4,1
KR_6752737035,420,-3,-31,-23,-4,1,2,1,-7,1,8,0,3,3,2,5,3,0,2,2,0,0,-25,1,6,7,1,0,-1,1,-1,-1,-1,2,1
KR_6739287243,420,8,99,36,15,5,5,0,8,8,0,2,5,3,1,3,2,-1,1,2,1,14,59,5,2,7,0,1,5,1,1,1,1,2,1
KR_6763904229,420,1,7,-3,-3,-1,0,1,-4,1,5,-1,3,4,0,2,2,3,3,0,0,-5,-1,3,1,4,3,0,1,0,1,1,1,0,1
KR_6721931042,420,1,-2,-11,0,-3,0,3,0,0,0,7,8,1,-4,2,6,0,2,2,0,12,-34,-2,7,5,14,0,1,-1,1,1,-1,3,1
KR_6693942632,420,-3,-12,-35,0,-5,1,6,4,6,2,0,1,1,1,1,0,0,0,0,0,3,54,0,5,5,-11,0,-1,-1,-1,-1,1,3,1
KR_6732097512,420,2,59,19,11,0,0,0,1,5,4,3,5,2,5,5,0,2,2,0,0,14,8,-4,6,2,2,0,1,-1,1,1,1,6,1
KR_6762366962,420,5,46,18,8,-1,0,1,2,8,6,0,0,0,5,6,1,2,2,0,0,13,4,0,4,4,2,0,1,1,0,1,1,5,1
KR_6752615659,420,4,47,19,13,1,4,3,2,2,0,5,5,0,5,6,1,0,1,1,0,9,0,2,4,6,-5,0,2,1,0,1,-1,6,1
KR_6701160381,420,2,-17,24,3,2,3,1,0,5,5,4,4,0,-2,1,3,-1,1,2,0,6,4,4,3,7,-6,0,0,-1,1,1,-1,4,1
KR_6751149812,420,2,-29,-13,2,2,4,2,2,3,1,-3,2,5,1,1,0,0,1,1,-1,-3,-4,-4,10,6,1,0,1,-1,1,1,-1,3,1
KR_6763903455,420,2,13,15,2,-1,1,2,3,5,2,1,1,0,-3,2,5,2,3,1,-1,-2,-160,-2,6,4,-2,0,0,1,-1,1,-1,3,1
KR_6750522069,420,1,13,0,-2,-1,3,4,-5,3,8,0,0,0,4,7,3,0,1,1,0,3,5,2,5,7,-7,0,0,-1,1,1,-1,4,1
KR_6738887165,420,0,52,-18,1,3,4,1,-1,1,2,3,4,1,-3,2,5,-1,1,2,0,-3,-126,-4,6,2,5,0,1,-1,1,1,1,4,1
KR_6763367417,420,-1,8,-4,3,3,6,3,1,7,6,-2,0,2,3,4,1,-2,1,3,0,-2,-2,1,7,8,4,0,0,1,1,0,1,2,1
KR_6764669642,420,3,21,19,3,1,3,2,-2,1,3,1,3,2,5,7,2,-2,0,2,-3,-9,339,0,5,5,-2,0,1,1,1,1,-1,2,1
KR_6766180900,420,0,-37,4,-2,1,1,0,0,3,3,2,3,1,-3,2,5,-2,0,2,0,-2,-3,-9,12,3,-4,0,3,1,1,1,1,2,1
KR_6764686233,420,3,69,8,4,4,4,0,1,1,0,2,2,0,-1,1,2,-2,0,2,-1,1,4,6,1,7,-1,0,1,1,-1,1,-1,4,1
KR_6740281057,440,2,22,8,1,2,3,1,-2,2,4,-3,1,4,3,4,1,1,1,0,0,-1,-2,0,6,6,7,0,1,-1,-1,1,-1,3,1
KR_6743929635,440,2,-5,-1,3,5,5,0,-1,1,2,-1,2,3,0,2,2,0,3,3,0,1,-12,1,4,5,-5,0,0,-1,1,0,-1,6,1
KR_6763037140,420,3,30,36,10,4,5,1,1,2,1,1,4,3,2,6,4,2,2,0,0,12,24,0,3,3,2,0,2,-1,1,1,1,2,1
KR_6656353799,420,4,9,44,0,0,1,1,-4,0,4,2,3,1,3,6,3,-1,0,1,-1,-9,-11,-2,9,7,5,0,2,-1,1,1,-1,4,1
KR_6738476005,420,0,60,-8,-5,-3,0,3,-1,1,2,0,0,0,-2,0,2,1,1,0,0,-4,-8,-3,7,4,5,0,0,-1,1,0,-1,2,1
KR_6710182437,420,-1,7,15,-2,0,2,2,-1,5,6,2,5,3,1,1,0,-4,0,4,0,-11,-2,2,4,6,1,0,-3,1,-1,-1,1,1,1
KR_6760622808,420,5,56,61,9,-4,2,6,-1,3,4,3,4,1,10,12,2,1,2,1,0,14,13,0,6,6,5,0,1,1,1,-1,1,3,1
KR_6626449944,440,1,42,36,3,2,2,0,1,2,1,-1,1,2,-3,0,3,4,4,0,0,3,-31,4,3,7,6,0,0,1,-1,1,-1,4,1
KR_6761463484,420,2,-9,20,1,1,3,2,1,6,5,-3,3,6,1,3,2,1,1,0,0,4,-151,-2,4,2,-1,0,0,1,-1,0,-1,2,1
KR_6760773123,420,1,68,-3,-4,0,1,1,-6,1,7,3,3,0,1,2,1,-2,1,3,0,-5,-26,1,4,5,5,0,0,1,1,0,-1,3,1
KR_6714714665,420,-2,-80,26,-11,0,2,2,2,2,0,-3,0,3,-8,1,9,-2,1,3,0,-9,1,1,5,6,-3,0,-3,-1,1,-1,-1,2,1
KR_6765387492,420,4,90,4,5,4,4,0,0,0,0,2,3,1,0,2,2,-1,0,1,0,-1,-2,1,2,3,1,0,1,1,1,1,1,3,1
KR_6718049204,420,3,-1,57,2,-1,2,3,7,7,0,2,3,1,-5,1,6,-1,0,1,0,1,8,0,6,6,2,0,2,1,1,1,-1,5,1
KR_6728629576,420,0,-42,-4,-1,0,1,1,-3,2,5,0,2,2,1,3,2,1,1,0,0,1,114,-2,5,3,-2,0,-1,1,1,-1,1,6,1
KR_6752117682,420,5,36,6,17,1,2,1,7,8,1,6,8,2,4,5,1,-1,1,2,2,19,-11,0,5,5,3,0,0,1,1,0,-1,4,1
KR_6750049706,440,0,-24,23,-3,-3,0,3,5,6,1,-4,1,5,-1,2,3,0,1,1,0,3,6,-1,5,4,-8,0,-1,1,1,-1,-1,6,1
KR_6762679279,420,5,70,37,5,2,2,0,0,4,4,1,4,3,1,2,1,1,2,1,0,2,24,0,6,6,0,0,1,1,-1,1,-1,1,1
KR_6729917671,420,6,115,19,18,0,6,6,2,3,1,7,8,1,4,5,1,5,5,0,0,12,-9,-6,9,3,6,0,2,-1,1,1,1,6,1
KR_6763630873,420,2,45,23,5,0,3,3,5,6,1,0,4,4,-1,3,4,1,1,0,0,0,-3,2,7,9,-1,0,0,1,-1,1,1,5,1
KR_6728753583,420,5,54,16,6,3,4,1,-1,2,3,-2,1,3,3,8,5,3,4,1,0,7,-22,0,5,5,0,0,1,1,1,1,-1,4,1
KR_6418786945,420,2,44,11,4,-4,0,4,3,4,1,6,6,0,-2,0,2,1,1,0,1,3,22,0,4,4,-2,0,1,0,1,1,1,0,1
KR_6737944677,420,-1,-32,-8,-1,1,1,0,-2,3,5,3,3,0,1,3,2,-4,0,4,0,2,3,-2,5,3,-3,0,0,0,-1,0,-1,0,1
KR_6759572819,420,4,37,16,9,3,4,1,2,3,1,0,1,1,2,2,0,2,2,0,0,11,46,0,6,6,-20,0,1,1,1,1,-1,1,1
KR_6759231775,420,3,-2,0,5,2,3,1,0,5,5,5,8,3,-2,1,3,0,4,4,0,8,-5,-5,10,5,3,0,1,-1,1,1,-1,3,1
KR_6760614347,420,1,-17,-24,3,-2,1,3,-2,1,3,2,2,0,4,8,4,1,1,0,0,2,116,0,3,3,-2,0,0,1,0,-1,1,6,1
KR_6731221133,420,1,38,-25,3,3,3,0,0,3,3,-2,1,3,1,2,1,1,2,1,1,5,5,4,5,9,1,0,-1,1,0,-1,1,1,1
KR_6685589709,420,5,88,20,11,1,3,2,4,7,3,-2,2,4,6,7,1,2,3,1,0,14,1,-5,9,4,5,0,0,1,1,1,1,4,1
KR_6652508565,420,3,10,12,5,-4,1,5,-1,3,4,3,3,0,4,4,0,3,3,0,0,11,2,-1,4,3,2,0,-1,-1,-1,-1,1,5,1
KR_6741312541,440,0,18,-32,0,-3,0,3,2,6,4,2,3,1,-1,4,5,0,1,1,0,3,36,2,5,7,-20,0,0,1,-1,0,1,1,1
KR_6763932208,420,3,25,-7,6,1,4,3,3,4,1,0,4,4,-2,2,4,4,4,0,0,7,0,1,4,5,4,0,1,1,-1,1,1,1,1
KR_6610226327,420,-1,21,-36,0,0,0,0,-4,3,7,-5,1,6,6,8,2,3,3,0,1,0,162,-3,5,2,0,0,-1,-1,-1,-1,1,4,1
KR_6687253381,420,3,-46,15,6,-3,2,5,1,4,3,7,9,2,0,3,3,1,3,2,0,7,-319,-3,8,5,3,0,1,1,-1,-1,-1,5,1
KR_6758786048,420,2,70,-9,-4,-5,0,5,-2,2,4,2,6,4,-2,3,5,3,4,1,0,2,163,-2,5,3,-1,0,0,-1,-1,1,1,5,1
KR_6719292061,420,0,48,-22,4,3,4,1,2,2,0,-2,0,2,-1,2,3,2,2,0,1,8,-4,4,3,7,6,0,0,1,-1,0,1,6,1
KR_6737581541,420,0,-28,18,4,-1,3,4,3,3,0,-1,1,2,3,3,0,0,0,0,0,12,1,2,3,5,2,0,0,1,0,0,-1,1,1
KR_6719368375,420,-3,-39,7,-10,-2,1,3,-5,1,6,4,7,3,-4,0,4,-3,2,5,-1,-18,7,1,5,6,-7,0,-2,-1,-1,-1,-1,5,1
KR_6761319428,420,1,45,27,1,1,4,3,-3,3,6,1,2,1,2,3,1,0,0,0,0,-2,7,1,4,5,3,0,0,1,1,1,1,5,1
KR_6679579382,420,1,44,-5,3,-1,0,1,-1,2,3,1,2,1,3,3,0,1,2,1,0,4,7,4,2,6,2,0,1,-1,1,1,1,5,1
KR_6713529640,420,-1,-48,-15,-4,-3,0,3,-4,3,7,-2,3,5,4,10,6,1,2,1,-3,-10,-38,-4,9,5,18,0,-2,1,-1,-1,-1,2,1
KR_6652509072,420,6,23,28,13,2,3,1,1,1,0,0,0,0,5,6,1,5,5,0,-1,16,8,3,6,9,-1,0,0,1,1,1,-1,2,1
KR_6760473852,420,2,16,-12,3,2,2,0,1,3,2,-1,3,4,0,2,2,1,1,0,0,-2,9,0,4,4,-3,0,1,0,0,1,-1,0,1
KR_6738892525,420,-2,13,-12,-5,-4,2,6,0,4,4,3,5,2,1,2,1,-5,1,6,0,-4,7,3,3,6,2,0,0,1,-1,0,-1,6,1
KR_6706685679,420,0,-20,2,0,1,3,2,1,5,4,0,3,3,-2,1,3,0,2,2,0,-4,-33,-5,6,1,1,0,1,-1,1,1,-1,3,1
KR_6760190203,420,2,-41,-11,5,3,4,1,0,2,2,4,6,2,2,4,2,-4,0,4,0,-3,0,0,4,4,-2,0,1,1,1,1,1,5,1
KR_6763750881,420,4,5,21,17,3,4,1,8,10,2,2,2,0,1,3,2,3,4,1,0,17,-2,1,5,6,5,0,-2,-1,-1,-1,1,3,1
KR_6738636551,420,3,48,12,5,0,1,1,5,5,0,2,3,1,0,1,1,-2,0,2,0,12,-10,1,6,7,0,0,1,1,1,1,1,6,1
KR_6682203040,420,4,101,-4,9,3,3,0,8,10,2,0,2,2,-2,1,3,0,3,3,0,8,3,1,4,5,1,0,3,1,1,1,1,4,1
KR_6755667358,420,0,-23,-4,-1,-2,1,3,1,3,2,0,1,1,0,1,1,0,0,0,0,0,1,2,3,5,0,0,-2,1,-1,-1,1,4,1
KR_6752814882,420,2,35,-20,1,1,2,1,0,4,4,2,2,0,1,5,4,-3,0,3,0,-3,14,2,5,7,5,0,1,1,-1,1,1,1,1
KR_6631494653,420,0,31,-15,-3,1,2,1,-3,1,4,2,2,0,-2,3,5,-1,0,1,0,-10,-5,-3,8,5,6,0,-1,1,-1,-1,1,2,1
KR_6750291894,420,0,38,8,7,0,1,1,-1,2,3,9,11,2,0,1,1,-1,1,2,2,5,-10,-2,5,3,2,0,1,1,1,1,1,5,1
KR_6704598261,420,0,16,8,5,0,2,2,2,4,2,3,7,4,-1,2,3,1,2,1,0,2,-18,1,5,6,1,0,0,1,1,1,-1,4,1
KR_6698070187,420,1,27,-27,7,3,4,1,-4,0,4,3,6,3,2,4,2,3,3,0,0,13,16,5,3,8,1,0,3,1,1,1,1,2,1
KR_6697686822,420,9,53,28,16,5,5,0,3,3,0,1,1,0,4,4,0,3,4,1,0,16,11,1,3,4,0,0,2,0,1,1,1,0,1
KR_6684438865,420,-1,-47,-24,-8,3,4,1,-5,2,7,-1,2,3,-2,1,3,-3,0,3,0,-7,-1,0,5,5,-2,0,0,-1,-1,-1,1,3,1
KR_6559062297,420,3,0,-11,7,2,4,2,-2,1,3,2,2,0,1,2,1,4,5,1,0,5,16,-2,5,3,-5,0,0,1,-1,0,-1,5,1
KR_6761731579,440,2,14,-4,9,3,4,1,1,2,1,3,4,1,3,6,3,-1,1,2,0,4,3,5,1,6,-1,0,1,1,1,1,1,4,1
KR_6663153087,420,3,28,6,5,0,1,1,0,2,2,5,8,3,0,2,2,0,0,0,0,5,1,5,1,6,7,0,0,1,0,0,1,5,1
KR_6655383130,440,3,63,36,9,-1,3,4,5,8,3,1,1,0,-1,3,4,5,5,0,1,0,0,2,3,5,-2,0,1,-1,1,1,1,6,1
KR_6722618668,420,6,66,23,21,5,5,0,9,9,0,6,7,1,0,2,2,1,1,0,0,20,2,3,1,4,3,0,2,1,1,1,1,1,1
KR_6753495414,420,2,21,4,6,2,2,0,-3,3,6,2,4,2,6,9,3,-1,1,2,0,15,-5,-3,7,4,5,0,0,1,-1,1,-1,2,1
KR_6764916566,420,7,23,-2,18,-1,1,2,8,8,0,0,4,4,8,9,1,3,4,1,0,23,-14,3,3,6,3,0,2,1,1,1,1,5,1
KR_6759896053,420,0,-26,29,-1,-3,0,3,3,5,2,-2,1,3,3,4,1,-2,3,5,-1,3,19,0,7,7,-5,0,0,1,-1,0,-1,5,1
KR_6763319221,420,3,60,13,4,-3,1,4,1,1,0,4,4,0,2,2,0,0,1,1,0,3,22,-1,4,3,1,0,0,1,1,1,1,1,1
KR_6753604429,420,4,-12,5,7,0,0,0,0,2,2,0,1,1,3,5,2,4,5,1,0,5,8,-4,5,1,0,0,0,1,1,1,1,3,1
KR_6743221647,420,1,27,13,3,1,1,0,1,2,1,0,2,2,0,3,3,1,1,0,0,1,1,-2,4,2,2,0,1,-1,1,1,1,1,1
KR_6763469681,440,1,-3,13,0,-1,1,2,-1,0,1,-1,3,4,0,1,1,3,6,3,0,-4,5,-1,10,9,-1,0,1,1,-1,1,-1,4,1
KR_6734676073,420,3,-10,33,3,2,2,0,2,3,1,-1,1,2,-1,0,1,1,2,1,0,-1,-114,4,4,8,1,0,0,-1,1,0,-1,4,1
KR_6752305830,420,2,54,-16,8,0,3,3,1,2,1,-2,0,2,5,8,3,4,4,0,2,10,12,7,1,8,0,0,2,1,-1,1,1,4,1
KR_6757215418,420,8,55,74,8,0,1,1,4,6,2,1,6,5,2,4,2,1,1,0,0,6,16,-3,4,1,-2,0,1,1,1,1,-1,5,1
KR_6761177198,420,1,-23,8,3,-2,4,6,2,4,2,4,5,1,-2,3,5,1,1,0,0,4,2,-2,6,4,4,0,0,1,1,-1,1,3,1
KR_6764587336,420,4,37,4,6,2,2,0,1,2,1,3,4,1,3,3,0,-3,1,4,0,7,6,6,2,8,-6,0,0,1,-1,1,-1,2,1
KR_6754534009,440,4,84,0,12,1,1,0,3,6,3,5,7,2,3,4,1,0,0,0,1,10,14,-3,7,4,3,0,1,1,1,1,1,2,1
KR_6709699872,420,-3,-35,-31,-6,1,2,1,-6,1,7,3,5,2,-4,0,4,0,2,2,-1,-6,108,0,2,2,-4,0,-1,-1,-1,-1,-1,5,1
KR_6632745134,420,3,17,40,5,0,2,2,3,4,1,1,1,0,-1,6,7,2,2,0,0,5,16,0,5,5,3,0,2,1,1,1,1,4,1
KR_6764676955,440,-2,-41,-15,-9,-3,1,4,-1,1,2,-4,2,6,-4,5,9,3,3,0,0,5,4,2,2,4,-5,0,-1,-1,-1,-1,-1,3,1
KR_6766521056,420,0,-31,13,5,0,2,2,3,5,2,1,2,1,0,1,1,1,1,0,1,7,-33,1,6,7,23,0,0,-1,1,0,1,2,1
KR_6611514703,420,2,-14,14,9,1,3,2,5,7,2,2,4,2,2,4,2,-1,0,1,0,11,-12,10,1,11,-2,0,0,-1,1,0,-1,2,1
KR_6763862587,420,4,-2,40,10,2,3,1,2,4,2,0,1,1,4,5,1,2,3,1,0,10,7,3,1,4,0,0,3,1,1,1,1,6,1
KR_6758265277,420,3,57,2,3,2,2,0,1,4,3,1,1,0,-1,1,2,0,3,3,0,5,-16,-3,6,3,-1,0,0,1,1,0,-1,2,1
KR_6689984570,420,4,56,5,8,0,2,2,0,1,1,8,8,0,2,5,3,-2,0,2,0,4,8,-3,6,3,2,0,3,1,1,1,-1,5,1
KR_6764778550,420,3,11,-5,8,0,1,1,3,3,0,-3,1,4,8,8,0,0,1,1,0,14,5,-3,6,3,3,0,1,1,1,1,-1,2,1
KR_6743384186,420,1,45,-2,2,-3,0,3,0,3,3,1,4,3,3,3,0,1,1,0,1,5,-9,2,8,10,5,0,0,1,1,1,1,2,1
KR_6763456576,440,-2,16,-8,-8,-2,2,4,-2,2,4,-4,2,6,-1,3,4,1,1,0,0,-8,1,-3,7,4,0,0,0,0,0,0,-1,0,1
KR_6762496587,440,2,50,-4,7,-2,3,5,0,1,1,1,2,1,2,3,1,6,7,1,0,10,41,3,3,6,-24,0,2,1,1,1,1,1,1
KR_6725974729,420,-2,15,1,-3,-4,0,4,0,2,2,2,3,1,0,0,0,-1,0,1,1,1,7,3,4,7,-1,0,-1,1,-1,-1,1,2,1
KR_6701659311,440,0,38,20,-1,-1,3,4,0,0,0,3,4,1,-3,3,6,0,1,1,0,-10,3,-2,5,3,-2,0,0,-1,0,-1,-1,4,1
KR_6758290241,420,1,71,29,0,4,6,2,-2,3,5,0,2,2,-1,1,2,-1,0,1,0,-9,-4,0,4,4,1,0,2,1,1,1,1,4,1
KR_6747313924,420,8,50,-8,19,6,6,0,4,4,0,3,4,1,6,7,1,0,0,0,0,15,34,4,3,7,3,0,2,0,1,1,1,0,1
KR_6707202642,420,2,72,0,4,-2,0,2,0,2,2,3,4,1,2,3,1,1,1,0,0,9,23,-1,9,8,4,0,1,1,-1,1,1,2,1
KR_6705248418,420,0,49,-1,4,3,3,0,-2,2,4,4,5,1,-1,2,3,0,1,1,0,14,119,1,3,4,0,0,0,1,-1,1,-1,3,1
KR_6689080448,420,2,56,8,4,1,1,0,-3,1,4,0,3,3,5,6,1,1,2,1,0,3,6,2,3,5,-6,0,1,1,1,1,1,3,1
KR_6710072113,420,-2,-20,-42,2,0,3,3,5,5,0,-4,1,5,-1,3,4,2,2,0,0,13,-116,0,3,3,-3,0,-2,-1,-1,-1,1,2,1
KR_6634840263,420,-1,-18,-9,-8,-2,3,5,-4,2,6,0,2,2,-2,3,5,0,3,3,-1,-6,-1,-1,6,5,6,0,-1,-1,1,-1,-1,3,1
KR_6675374587,420,6,2,23,6,2,4,2,2,3,1,-6,1,7,6,8,2,2,4,2,0,5,-2,2,3,5,0,0,0,1,1,-1,-1,1,1
KR_6728208310,420,-1,-16,8,-5,-2,0,2,0,1,1,2,3,1,-6,0,6,1,1,0,0,-5,-20,-1,5,4,-1,0,-1,-1,1,-1,1,1,1
KR_6508486643,420,0,11,0,-1,0,2,2,2,4,2,-3,1,4,2,5,3,-2,1,3,-1,-8,12,2,6,8,-2,0,0,1,1,-1,-1,3,1
KR_6725930933,420,1,67,-1,9,2,4,2,-1,3,4,4,7,3,3,3,0,1,2,1,0,3,2,1,5,6,5,0,1,1,1,1,-1,2,1
KR_6755926753,420,0,-17,-12,4,-2,1,3,1,3,2,1,3,2,3,4,1,1,3,2,0,8,5,0,5,5,-1,0,0,1,1,0,-1,4,1
KR_6597989040,420,4,63,-1,9,2,3,1,1,2,1,4,5,1,0,3,3,2,2,0,0,17,-4,-3,6,3,-1,0,2,1,1,1,1,1,1
KR_6695447473,420,-2,-5,-20,-4,-6,1,7,1,3,2,4,7,3,1,4,3,-4,0,4,1,5,67,3,3,6,20,0,-2,-1,-1,-1,1,3,1
KR_6644762005,440,0,-13,9,5,1,3,2,4,4,0,0,2,2,1,3,2,-1,0,1,0,5,-36,1,6,7,-3,0,0,1,1,1,1,4,1
KR_6696861363,420,1,16,-3,9,-2,0,2,7,8,1,-2,1,3,4,4,0,2,2,0,0,10,-120,-3,7,4,3,0,1,-1,1,1,-1,4,1
KR_6740587806,440,7,63,36,16,3,3,0,3,6,3,6,6,0,1,4,3,3,4,1,1,11,10,1,3,4,0,0,1,1,1,1,1,1,1
KR_6696067277,420,1,11,-32,4,-4,1,5,4,4,0,4,5,1,-1,1,2,1,2,1,0,9,24,-2,4,2,-5,0,1,-1,1,1,1,5,1
KR_6763658515,420,1,28,12,0,-2,1,3,2,4,2,-1,2,3,2,6,4,-1,1,2,-1,-2,97,-2,7,5,3,0,1,1,0,1,-1,1,1
KR_6766218768,420,-1,50,12,-3,0,0,0,-3,0,3,2,3,1,-1,2,3,-1,1,2,0,-4,5,1,4,5,1,0,0,1,1,0,1,5,1
KR_6766198917,420,2,64,-2,9,1,2,1,1,2,1,-1,5,6,4,4,0,4,4,0,1,5,88,-3,9,6,5,0,0,1,-1,1,1,3,1
KR_6755086456,440,5,19,-4,15,3,5,2,-1,1,2,4,4,0,5,7,2,4,5,1,0,15,8,2,0,2,2,0,2,1,1,1,-1,6,1
KR_6763356283,440,2,44,0,3,0,2,2,-2,2,4,2,3,1,1,3,2,2,4,2,0,0,-9,-4,9,5,1,0,0,1,-1,1,1,2,1
KR_6763814671,420,4,64,31,10,2,3,1,4,6,2,1,2,1,2,3,1,1,1,0,0,9,-112,2,1,3,0,0,1,1,1,1,1,6,1
KR_6762352481,420,5,52,0,5,3,4,1,-2,0,2,4,6,2,0,0,0,0,0,0,0,14,-12,-1,5,4,1,0,1,1,-1,1,-1,4,1
KR_6646866478,420,1,-9,0,4,5,6,1,2,3,1,-2,2,4,-1,3,4,0,1,1,-1,2,-7,-4,8,4,3,0,0,-1,1,0,-1,2,1
KR_6712616409,420,1,-30,14,-2,-3,0,3,1,6,5,-1,1,2,-2,1,3,3,3,0,-1,-14,-11,-4,6,2,1,0,1,-1,1,1,-1,3,1
KR_6722081265,420,3,26,0,12,1,2,1,2,5,3,6,8,2,2,3,1,1,2,1,1,13,7,1,4,5,1,0,1,1,-1,1,1,1,1
KR_6632225349,420,3,-4,8,5,0,0,0,3,8,5,1,5,4,4,4,0,-3,1,4,0,-2,-25,3,4,7,-6,0,4,-1,1,1,-1,2,1
KR_6755440503,440,2,81,-24,-1,2,3,1,2,3,1,0,2,2,-4,0,4,-1,0,1,0,-3,2,-1,5,4,-2,0,1,-1,1,1,-1,2,1
KR_6761198202,440,4,-4,20,4,0,2,2,5,8,3,-1,1,2,3,3,0,-3,2,5,0,9,23,0,2,2,-3,0,0,1,1,-1,-1,6,1
KR_6760145366,420,-2,-14,12,0,-7,0,7,5,6,1,2,2,0,-2,1,3,2,2,0,-1,6,25,-4,10,6,0,0,0,-1,1,1,-1,4,1
KR_6665544345,420,4,103,8,7,5,5,0,0,2,2,2,3,1,0,1,1,0,1,1,0,3,0,3,5,8,-2,0,2,-1,1,1,1,3,1
KR_6757040991,420,0,46,-25,-2,3,5,2,-3,2,5,-2,0,2,3,4,1,-3,0,3,0,3,-31,-2,9,7,3,0,0,0,1,0,1,0,1
KR_6562539363,420,3,8,20,14,1,1,0,9,10,1,2,3,1,4,4,0,-2,0,2,0,18,43,9,1,10,1,0,1,0,1,1,1,0,1
KR_6735712341,420,4,69,0,8,4,5,1,3,3,0,-5,1,6,7,7,0,-1,0,1,0,17,16,-3,6,3,3,0,1,1,1,1,1,5,1
KR_6702355058,420,1,-44,5,2,-3,2,5,-1,3,4,-1,1,2,4,6,2,3,4,1,-1,15,2,0,4,4,0,0,2,1,1,1,-1,5,1
KR_6669913653,420,1,1,-8,1,3,5,2,2,3,1,2,5,3,-5,2,7,-1,1,2,-1,3,6,-3,6,3,-4,0,0,1,1,1,-1,1,1
KR_6706531501,420,2,64,0,7,2,2,0,0,0,0,0,1,1,6,7,1,-1,0,1,0,11,8,2,4,6,4,0,2,1,-1,1,1,4,1
KR_6694073902,440,2,9,34,2,-3,1,4,1,3,2,5,5,0,-1,0,1,0,0,0,0,-2,-8,1,6,7,10,0,1,1,1,1,1,6,1
KR_6755267912,420,-2,-22,-28,7,1,2,1,3,5,2,3,6,3,0,3,3,0,0,0,0,7,-8,4,4,8,-4,0,0,-1,1,0,1,2,1
KR_6762924699,420,0,-60,7,1,2,2,0,-6,2,8,-4,2,6,5,6,1,4,5,1,0,0,6,1,4,5,0,0,0,-1,1,0,-1,5,1
KR_6726032467,420,2,44,-4,3,-2,0,2,3,5,2,0,2,2,3,4,1,-1,1,2,0,8,-43,-6,9,3,3,0,2,-1,-1,1,1,4,1
KR_6761445700,420,0,-33,-12,3,-2,2,4,-1,2,3,4,4,0,0,4,4,2,2,0,0,5,3,-6,6,0,-1,0,1,1,-1,1,1,5,1
KR_6705458800,420,7,105,37,19,5,7,2,10,11,1,-2,1,3,4,11,7,2,3,1,1,17,-3,3,0,3,-1,0,1,0,0,1,-1,0,1
KR_6742983691,420,4,12,22,8,0,3,3,0,3,3,1,3,2,6,7,1,1,2,1,0,9,4,2,7,9,4,0,0,1,-1,1,1,5,1
KR_6764028941,420,2,16,22,2,-4,0,4,-3,2,5,0,0,0,9,10,1,0,0,0,0,1,-6,-4,8,4,4,0,1,1,-1,1,1,1,1
KR_6766240989,440,2,61,0,1,0,2,2,2,4,2,2,4,2,-2,3,5,-1,2,3,0,-5,13,3,1,4,-5,0,2,-1,1,1,-1,2,1
KR_6748500100,420,-2,16,-7,-5,1,2,1,-5,1,6,2,3,1,-2,1,3,-1,0,1,0,-15,1,3,4,7,-4,0,-1,-1,-1,1,-1,6,1
KR_6745890819,420,3,29,36,14,1,2,1,1,6,5,2,4,2,9,9,0,1,1,0,2,16,-10,2,4,6,4,0,1,1,1,1,1,5,1
KR_6651640488,420,3,121,36,3,1,2,1,2,3,1,5,5,0,-4,2,6,-1,0,1,1,0,31,0,9,9,-3,0,0,1,-1,1,1,4,1
KR_6725731691,420,4,-20,27,4,1,2,1,2,4,2,0,2,2,-1,2,3,2,2,0,0,2,-61,1,4,5,-2,0,-1,-1,-1,-1,1,6,1
KR_6744418018,420,5,98,16,6,0,3,3,-1,0,1,3,5,2,3,4,1,1,1,0,-1,4,36,-3,6,3,2,0,1,1,1,1,-1,6,1
KR_6762944307,420,3,35,-25,6,3,3,0,1,2,1,-1,2,3,3,4,1,0,1,1,0,10,220,-3,5,2,2,0,0,1,1,1,-1,4,1
KR_6728135320,420,3,41,-8,6,-3,1,4,2,4,2,1,4,3,3,3,0,3,4,1,0,12,-3,-2,8,6,5,0,1,1,0,1,1,1,1
KR_6741363626,420,1,33,-40,4,1,1,0,-3,1,4,4,5,1,1,4,3,1,1,0,0,-1,4,3,4,7,0,0,1,-1,1,1,-1,4,1
KR_6751333348,440,0,39,-7,1,0,0,0,-4,0,4,2,2,0,6,6,0,-3,0,3,0,-3,15,0,4,4,1,0,0,1,1,1,-1,1,1
KR_6754944467,420,5,82,0,13,4,5,1,4,4,0,1,3,2,1,3,2,3,4,1,0,8,0,-2,5,3,-1,0,2,1,1,1,-1,4,1
KR_6660087687,420,0,-40,-12,7,1,2,1,1,3,2,6,6,0,0,2,2,-1,1,2,0,6,14,2,9,11,-1,0,0,-1,1,1,1,5,1
KR_6756155381,420,2,79,-10,7,-1,1,2,2,2,0,0,1,1,5,7,2,1,1,0,0,9,25,4,1,5,-13,0,1,1,0,1,1,2,1
KR_6713609568,420,1,-10,1,0,-3,1,4,-1,1,2,4,5,1,3,4,1,-3,0,3,0,0,11,4,4,8,-3,0,1,-1,0,1,1,3,1
KR_6755379311,420,6,98,26,12,-1,0,1,1,1,0,12,13,1,-1,1,2,1,1,0,0,9,26,2,5,7,1,0,2,1,1,1,1,5,1
KR_6761294384,420,0,17,8,5,3,3,0,-3,0,3,3,4,1,3,4,1,-1,2,3,1,5,21,1,7,8,-1,0,1,1,-1,1,1,3,1
KR_6591202554,420,-2,-24,-28,-7,-1,1,2,-5,3,8,-1,2,3,0,2,2,0,1,1,0,-3,-6,2,7,9,-3,0,1,-1,1,1,-1,4,1
KR_6745902594,420,-3,24,13,-9,-5,0,5,1,2,1,-2,3,5,-2,1,3,-1,0,1,-1,-7,-6,0,5,5,3,0,-1,-1,-1,-1,-1,6,1
KR_6763300698,440,1,25,20,-1,-2,1,3,-1,1,2,2,3,1,0,2,2,0,0,0,0,-2,5,1,6,7,0,0,0,1,-1,0,1,5,1
KR_6702474893,420,5,28,8,9,1,1,0,-2,2,4,5,6,1,4,7,3,1,1,0,1,15,1,3,3,6,-1,0,3,-1,1,1,-1,1,1
KR_6764895119,420,-2,-44,17,-9,-1,3,4,4,9,5,-5,1,6,-6,0,6,-1,0,1,0,-7,-6,-2,9,7,-1,0,-1,1,-1,-1,1,5,1
KR_6647080437,440,5,42,10,14,0,2,2,8,8,0,3,5,2,-1,2,3,4,5,1,0,13,1,0,5,5,4,0,0,1,-1,1,1,3,1
KR_6753314353,420,3,70,28,10,0,1,1,0,3,3,2,2,0,5,7,2,3,3,0,1,13,-19,-4,6,2,1,0,2,1,-1,1,1,5,1
KR_6749442152,420,-1,-14,10,-3,2,4,2,-4,2,6,-2,1,3,2,2,0,-1,0,1,1,0,-5,-1,7,6,1,0,0,-1,-1,-1,1,3,1
KR_6764781287,420,-1,-11,1,9,2,4,2,1,5,4,-1,1,2,3,5,2,4,5,1,1,9,-1,-4,10,6,8,0,2,1,1,1,1,2,1
KR_6659378537,420,-2,-33,-24,0,2,3,1,-3,3,6,0,1,1,0,1,1,1,1,0,0,2,119,0,6,6,0,0,1,1,1,1,1,6,1
KR_6750478225,420,5,45,20,7,2,3,1,-1,4,5,-1,2,3,4,5,1,3,5,2,-1,12,305,4,3,7,-5,0,2,1,-1,1,-1,4,1
KR_6743851959,440,2,91,7,7,2,4,2,3,6,3,1,2,1,0,1,1,1,2,1,1,1,41,3,3,6,2,0,2,1,1,1,1,3,1
KR_6718397451,420,0,-23,-5,-1,3,3,0,0,4,4,-2,2,4,-3,2,5,1,1,0,0,3,-2,2,5,7,-2,0,1,1,1,-1,1,4,1
KR_6696709855,420,2,92,1,2,-1,2,3,0,5,5,2,2,0,0,1,1,1,1,0,1,9,-8,-3,10,7,1,0,0,1,1,0,1,1,1
KR_6633419430,420,3,69,22,5,1,2,1,5,9,4,-2,1,3,1,2,1,0,1,1,0,1,-3,2,3,5,1,0,0,1,-1,-1,-1,6,1
KR_6766397067,420,3,32,18,10,3,3,0,4,5,1,0,0,0,-2,1,3,5,6,1,1,10,6,-1,5,4,-2,0,1,-1,-1,1,1,4,1
KR_6716783322,420,1,14,-3,5,-1,0,1,-7,0,7,1,4,3,6,7,1,6,6,0,0,7,45,-4,7,3,-17,0,2,1,-1,1,1,1,1
KR_6765484336,420,4,35,6,9,3,4,1,2,3,1,-2,1,3,6,7,1,0,1,1,1,9,31,2,3,5,2,0,3,1,1,1,1,3,1
KR_6753794701,440,2,10,14,3,-8,0,8,-1,0,1,1,1,0,9,11,2,2,2,0,0,11,-31,3,8,11,1,0,1,-1,1,1,-1,2,1
KR_6750186836,420,-1,4,-29,6,2,2,0,1,6,5,3,3,0,2,5,3,-2,1,3,0,2,1,2,3,5,-1,0,0,-1,-1,0,1,3,1
KR_6679437893,420,0,21,0,-2,2,3,1,-2,2,4,0,4,4,0,0,0,-2,2,4,0,-7,63,3,3,6,-16,0,-1,0,1,-1,-1,0,1
KR_6764988292,420,-1,-73,8,-4,-4,0,4,4,8,4,-1,4,5,-2,4,6,-1,1,2,0,0,-1,-4,8,4,-5,0,-2,1,-1,-1,-1,5,1
KR_6759169091,420,2,7,21,9,1,1,0,5,6,1,-1,1,2,2,8,6,2,2,0,0,5,-2,3,3,6,1,0,0,0,1,0,1,0,1
KR_6760124850,420,1,-10,-7,-5,4,6,2,0,3,3,-8,1,9,-2,2,4,1,3,2,-1,-9,10,5,3,8,0,0,0,-1,-1,0,-1,5,1
KR_6703789366,420,5,59,14,8,1,3,2,3,3,0,0,4,4,3,4,1,1,3,2,0,1,318,-3,8,5,2,0,2,1,1,1,1,6,1
KR_6666272065,420,0,42,-24,5,2,3,1,2,5,3,0,2,2,1,3,2,0,0,0,0,4,-11,3,3,6,-1,0,1,1,-1,-1,1,5,1
KR_6763368453,420,0,-32,-12,-2,1,2,1,-1,2,3,-1,4,5,-1,0,1,0,0,0,0,3,-6,-4,8,4,-1,0,0,-1,0,0,-1,1,1
KR_6677933719,420,-1,-9,-20,-5,0,1,1,-4,1,5,2,3,1,-2,2,4,-1,0,1,-1,-7,88,-4,7,3,4,0,0,1,-1,0,-1,1,1
KR_6601031011,420,-2,-2,-13,-5,-1,2,3,-4,0,4,1,3,2,1,2,1,-2,0,2,0,-7,-35,0,5,5,-5,0,0,-1,1,0,1,5,1
KR_6762729276,420,-3,-1,-28,-1,-1,4,5,-1,3,4,-2,0,2,3,7,4,0,2,2,0,6,-93,-5,9,4,3,0,1,1,1,1,1,1,1
KR_6692445941,420,4,13,60,12,4,5,1,1,1,0,5,5,0,-1,2,3,3,3,0,0,3,-171,-1,5,4,0,0,2,1,1,1,1,1,1
KR_6704144149,420,1,-101,32,1,-2,3,5,6,6,0,-1,2,3,1,2,1,-3,0,3,0,11,-104,6,6,12,5,0,-1,-1,1,-1,-1,3,1
KR_6735411316,420,0,-9,26,-5,0,1,1,2,5,3,-2,4,6,-2,2,4,-3,1,4,0,0,6,1,4,5,-3,0,-1,-1,1,-1,-1,6,1
KR_6762436579,420,3,-22,-6,7,-4,0,4,5,6,1,3,4,1,1,2,1,2,2,0,0,12,-1,1,2,3,3,0,-1,1,-1,-1,1,2,1
KR_6757315833,420,4,8,-18,17,3,4,1,2,3,1,3,3,0,8,9,1,1,1,0,0,16,265,-6,8,2,2,0,2,1,-1,1,1,2,1
KR_6759687109,420,-6,-63,-16,-7,-3,4,7,1,1,0,1,2,1,-2,2,4,-4,1,5,1,4,10,3,4,7,3,0,0,-1,1,1,1,1,1
KR_6729352058,420,-2,-31,-11,-11,-3,1,4,-1,1,2,2,4,2,-7,0,7,-2,2,4,-1,-12,2,-3,7,4,2,0,0,-1,1,0,-1,5,1
KR_6763431471,420,3,26,32,8,-2,3,5,6,9,3,-3,1,4,5,5,0,2,2,0,3,21,5,0,3,3,-1,0,0,1,-1,1,1,5,1
KR_6705372785,420,0,40,-12,5,2,2,0,3,4,1,-1,2,3,0,1,1,1,1,0,1,8,-23,1,4,5,3,0,0,-1,1,1,1,1,1
KR_6763243319,440,2,97,6,8,-1,3,4,4,5,1,3,4,1,-2,2,4,4,5,1,0,-1,10,2,6,8,-4,0,1,1,0,1,1,1,1
KR_6726411526,420,0,-8,12,6,0,2,2,4,4,0,0,3,3,6,9,3,-4,1,5,1,8,-1,4,2,6,2,0,-1,-1,1,-1,1,1,1
KR_6758779958,420,1,49,-20,6,2,3,1,1,3,2,-1,0,1,2,3,1,2,2,0,0,1,15,-4,8,4,-4,0,1,-1,-1,1,1,6,1
KR_6764617194,440,2,29,-2,6,2,2,0,-5,1,6,3,3,0,5,6,1,1,2,1,0,9,-4,1,2,3,-1,0,0,-1,1,0,-1,5,1
KR_6712185066,420,2,24,20,3,0,2,2,-1,1,2,3,3,0,1,2,1,0,1,1,0,1,-17,6,3,9,-5,0,2,1,1,1,-1,4,1
KR_6677810578,420,3,-23,11,9,4,4,0,1,4,3,-3,0,3,6,8,2,1,3,2,-1,8,-5,3,6,9,6,0,0,1,1,1,-1,6,1
KR_6766136218,420,1,63,7,3,2,3,1,0,3,3,1,4,3,-3,5,8,3,4,1,0,9,6,2,5,7,0,0,-2,1,1,-1,1,4,1
KR_6652463314,420,3,3,-15,10,-2,0,2,3,7,4,3,6,3,2,4,2,4,5,1,0,9,8,0,2,2,2,0,1,1,-1,1,1,5,1
KR_6743445826,420,2,-28,0,3,-1,2,3,-2,1,3,2,4,2,1,2,1,3,4,1,1,10,-8,0,6,6,1,0,0,1,1,0,1,1,1
KR_6697208399,420,5,69,32,7,-2,2,4,1,3,2,1,4,3,8,9,1,-1,0,1,0,9,38,3,4,7,-11,0,1,1,1,1,-1,4,1
KR_6367281525,440,3,-42,12,10,-2,0,2,1,2,1,-2,1,3,13,15,2,0,2,2,0,8,0,0,0,0,-5,0,0,1,1,-1,-1,2,1
KR_6753656064,420,-1,90,-26,-4,0,2,2,1,3,2,-2,0,2,-1,1,2,-2,0,2,0,-5,-9,1,3,4,-14,0,2,-1,-1,1,-1,3,1
KR_6751987262,420,0,34,-28,8,0,1,1,0,2,2,-2,1,3,7,7,0,3,3,0,0,9,121,-2,8,6,-5,0,0,-1,1,1,1,3,1
KR_6756453567,420,5,47,8,8,3,5,2,3,4,1,2,3,1,-2,4,6,2,2,0,1,8,9,-1,6,5,3,0,2,-1,1,1,1,3,1
KR_6759996377,440,5,43,45,10,-2,1,3,4,5,1,1,4,3,0,0,0,7,8,1,0,11,-5,-2,3,1,11,0,1,1,-1,1,1,5,1
KR_6762536333,420,0,24,21,1,-5,4,9,3,6,3,0,3,3,4,7,3,-1,3,4,-3,-6,-113,-2,5,3,3,0,-1,-1,-1,1,-1,6,1
KR_6745309532,420,-2,40,0,0,1,2,1,0,5,5,0,1,1,-2,2,4,1,1,0,0,1,5,-1,5,4,-4,0,0,-1,-1,0,1,5,1
KR_6756106888,420,4,35,8,9,3,3,0,5,9,4,-3,0,3,4,6,2,0,0,0,2,12,1,0,5,5,-1,0,0,-1,1,0,1,3,1
KR_6725275093,420,-3,-5,2,-7,-2,0,2,-6,0,6,-3,2,5,0,3,3,4,5,1,-1,-5,9,3,5,8,1,0,0,-1,-1,-1,-1,2,1
KR_6509143334,420,1,63,-6,2,0,3,3,1,5,4,-3,1,4,3,3,0,1,1,0,0,5,2,0,5,5,-1,0,2,-1,-1,1,-1,1,1
KR_6722080285,420,1,65,0,2,5,5,0,0,0,0,-2,1,3,0,3,3,-1,0,1,0,1,-19,-6,8,2,-2,0,1,-1,1,1,-1,2,1
KR_6764517921,420,3,43,-3,-6,3,4,1,-4,1,5,-2,1,3,-3,0,3,0,0,0,0,-10,-166,-3,10,7,-2,0,-1,-1,0,-1,-1,3,1
KR_6760624020,420,-2,23,-12,-5,-1,0,1,1,1,0,-2,3,5,-3,4,7,0,1,1,0,-2,2,-2,4,2,-2,0,0,1,-1,-1,1,4,1
KR_6617558898,420,-2,19,-8,-6,0,1,1,2,6,4,-2,0,2,-3,3,6,-3,0,3,0,-2,7,0,6,6,-7,0,0,1,1,0,-1,3,1
KR_6758960453,420,-1,53,-9,0,3,4,1,1,2,1,-1,3,4,-1,2,3,-2,0,2,0,-3,-31,3,3,6,0,0,0,1,1,0,1,4,1
KR_6739795535,420,3,47,28,-3,-1,1,2,-2,1,3,-1,1,2,3,6,3,-2,0,2,0,-7,-19,4,5,9,3,0,0,1,1,1,-1,2,1
KR_6579168813,420,1,10,11,5,0,1,1,3,5,2,1,3,2,-1,1,2,2,2,0,0,0,-4,1,7,8,1,0,0,1,-1,-1,1,6,1
KR_6766452144,420,3,82,43,10,0,1,1,-1,2,3,-2,2,4,13,14,1,0,1,1,0,4,22,2,6,8,-3,0,2,1,1,1,1,6,1
KR_6755447086,420,1,-4,-9,-3,-3,2,5,-2,0,2,3,7,4,-2,2,4,1,3,2,-1,-1,8,-2,6,4,-5,0,-1,-1,-1,-1,-1,3,1
KR_6743785825,420,0,-11,-24,4,2,2,0,-1,4,5,5,6,1,0,3,3,-2,0,2,0,-2,208,2,3,5,-2,0,0,1,-1,0,1,6,1
KR_6735524272,440,-7,-40,-18,-7,-2,0,2,-3,1,4,-2,3,5,0,2,2,0,2,2,0,-3,2,3,3,6,-1,0,0,-1,1,0,-1,3,1
KR_6722922401,420,1,76,27,8,1,2,1,1,4,3,3,5,2,1,3,2,2,3,1,0,5,7,-2,8,6,-2,0,0,1,0,0,1,4,1
KR_6757603131,420,2,33,-28,0,-1,1,2,-2,1,3,0,2,2,2,3,1,1,1,0,0,6,5,-3,6,3,-2,0,-1,-1,0,-1,-1,5,1
KR_6766465965,420,1,4,-7,-3,3,6,3,-5,0,5,-2,1,3,1,2,1,0,3,3,0,-1,4,-5,8,3,5,0,0,-1,1,0,-1,2,1
KR_6764720187,420,-1,-21,-15,2,-1,3,4,-1,0,1,1,3,2,1,4,3,2,2,0,-3,-8,313,0,6,6,3,0,-1,-1,-1,-1,-1,2,1
KR_6734134175,420,2,-2,4,0,-3,2,5,-1,5,6,2,3,1,2,10,8,0,1,1,-2,-4,6,4,5,9,-4,0,2,1,1,1,-1,3,1
KR_6764168385,420,6,54,27,10,5,5,0,10,10,0,0,0,0,-6,0,6,1,2,1,0,5,-3,3,4,7,1,0,1,-1,0,1,1,5,1
KR_6714746377,420,-1,17,-8,3,-1,1,2,8,10,2,-4,3,7,-1,6,7,1,1,0,-1,-1,38,-4,9,5,-15,0,1,-1,0,1,-1,2,1
KR_6751172554,420,4,55,7,13,3,4,1,0,5,5,6,6,0,3,3,0,1,1,0,0,6,-4,-1,6,5,4,0,2,1,1,1,1,2,1
KR_6601385103,420,3,20,0,2,1,1,0,5,9,4,-2,1,3,1,2,1,-3,0,3,1,8,-8,1,4,5,-1,0,2,0,1,1,1,0,1
KR_6758685749,420,0,-13,8,2,1,2,1,0,2,2,-1,1,2,3,10,7,-1,1,2,0,2,16,2,4,6,-3,0,-1,1,-1,-1,-1,5,1
KR_6765106560,420,4,53,-15,14,2,3,1,5,6,1,5,6,1,5,5,0,-3,0,3,1,12,20,0,4,4,-1,0,1,-1,-1,1,1,6,1
KR_6751361041,420,0,-15,-24,6,-1,0,1,1,2,1,-1,1,2,8,10,2,-1,1,2,0,14,2,1,7,8,-2,0,0,1,-1,0,1,4,1
KR_6683864851,420,-1,-25,28,-3,0,2,2,-4,0,4,3,5,2,-3,2,5,1,1,0,0,0,-135,-6,8,2,2,0,-1,0,0,-1,1,0,1
KR_6750709945,420,0,53,-2,4,-1,3,4,-1,3,4,6,6,0,0,2,2,0,0,0,0,-4,-5,0,4,4,-4,0,1,1,1,1,-1,3,1
KR_6597771920,420,-3,15,13,-12,-1,0,1,-9,0,9,-1,5,6,2,2,0,-3,0,3,0,-26,40,-1,7,6,-17,0,0,-1,0,0,1,3,1
KR_6602799879,420,1,-38,16,4,-2,0,2,1,4,3,-1,3,4,3,4,1,3,3,0,0,5,14,0,7,7,-2,0,0,1,-1,1,1,5,1
KR_6740280714,420,3,28,14,10,-1,0,1,1,3,2,-2,0,2,10,11,1,2,2,0,0,12,-3,4,6,10,0,0,0,1,-1,1,1,2,1
KR_6752183268,420,3,45,-1,8,4,4,0,3,3,0,-1,3,4,4,5,1,-2,0,2,0,-1,106,3,4,7,4,0,1,-1,1,1,1,2,1
KR_6755304355,420,0,-17,-24,5,0,2,2,-1,3,4,0,2,2,3,5,2,3,3,0,0,10,16,4,3,7,-2,0,1,1,-1,-1,1,5,1
KR_6728509981,440,0,25,-8,1,-1,3,4,2,2,0,2,4,2,-2,1,3,0,3,3,1,-3,3,0,4,4,-1,0,0,-1,0,0,1,6,1
KR_6758752550,420,1,27,20,0,-3,1,4,-1,0,1,2,4,2,1,2,1,1,3,2,0,-8,-7,0,4,4,0,0,2,0,0,1,1,0,1
KR_6753953601,420,4,46,3,2,0,0,0,-1,1,2,-2,1,3,4,4,0,1,1,0,0,3,115,2,4,6,-3,0,0,-1,-1,-1,1,6,1
KR_6645991708,440,3,3,-4,1,2,2,0,0,0,0,1,2,1,-3,4,7,1,2,1,0,-2,8,-5,6,1,2,0,1,1,-1,1,1,5,1
KR_6367403131,440,4,97,-16,-2,-3,1,4,0,5,5,-4,3,7,5,10,5,0,2,2,0,4,0,0,0,0,8,0,1,-1,0,1,-1,5,1
KR_6722840024,420,-1,16,-4,-2,-1,1,2,0,3,3,0,3,3,-1,0,1,0,0,0,0,-3,1,1,2,3,0,0,1,1,1,1,-1,1,1
KR_6744022550,440,2,-2,20,5,1,1,0,-1,6,7,2,4,2,4,7,3,-1,0,1,0,7,0,-2,5,3,-4,0,1,1,0,1,1,6,1
KR_6766042944,420,0,8,-5,-1,0,3,3,-3,2,5,2,2,0,0,2,2,0,1,1,0,-5,-26,-3,9,6,-2,0,-1,1,1,-1,1,6,1
KR_6749855265,440,-2,-14,-16,10,-1,1,2,6,8,2,3,5,2,-2,1,3,4,4,0,2,15,1,1,2,3,-1,0,0,0,1,0,1,0,1
KR_6748627995,420,4,10,-13,8,3,7,4,5,5,0,1,5,4,-1,3,4,0,1,1,0,8,7,6,1,7,-2,0,0,-1,-1,1,-1,5,1
KR_6736590061,420,-2,-87,0,1,-3,3,6,1,1,0,3,4,1,-3,1,4,3,3,0,0,8,-9,1,5,6,-1,0,0,-1,1,1,-1,1,1
KR_6758291090,420,1,5,20,4,-1,1,2,1,1,0,2,5,3,-1,2,3,3,3,0,0,7,-4,0,6,6,2,0,0,-1,1,0,-1,5,1
KR_6738792491,420,1,27,12,5,1,1,0,0,2,2,2,4,2,1,1,0,1,1,0,0,7,4,4,6,10,-2,0,1,1,1,1,1,2,1
KR_6596608586,420,2,-34,-8,0,2,3,1,1,6,5,-1,1,2,-1,2,3,-1,0,1,0,9,-4,0,7,7,-4,0,0,1,-1,0,-1,4,1
KR_6737889118,420,0,-44,41,7,-2,0,2,3,4,1,2,4,2,1,3,2,3,3,0,2,7,8,2,4,6,-2,0,0,1,-1,0,1,2,1
KR_6752309167,420,5,24,3,6,-3,1,4,3,5,2,1,1,0,3,3,0,2,3,1,0,7,-2,-2,7,5,-2,0,1,1,1,1,1,5,1
KR_6732488895,440,-3,-44,-7,1,0,3,3,5,5,0,-1,3,4,-3,0,3,0,0,0,0,6,7,-2,7,5,-8,0,-1,-1,-1,-1,1,4,1
KR_6747055469,420,3,30,20,5,-1,1,2,3,4,1,2,3,1,2,2,0,-1,1,2,0,6,177,-2,7,5,6,0,1,1,-1,1,1,4,1
KR_6733073072,420,-1,-82,-27,-4,0,2,2,-1,3,4,-5,0,5,2,4,2,0,2,2,0,7,-88,1,4,5,2,0,-1,-1,-1,-1,-1,5,1
KR_6764944740,420,4,25,9,10,2,2,0,1,2,1,5,7,2,1,3,2,1,1,0,0,10,-2,3,3,6,2,0,0,1,-1,0,1,6,1
KR_6671267030,420,2,109,16,3,-1,1,2,-1,1,2,3,5,2,3,4,1,-1,0,1,0,0,-23,3,4,7,-3,0,2,-1,1,1,1,1,1
KR_6739303445,420,-1,-32,34,0,3,5,2,-1,2,3,1,2,1,-1,2,3,-2,0,2,0,-2,11,-5,10,5,4,0,1,1,1,1,1,3,1
KR_6738505413,420,-1,-70,5,2,-3,0,3,2,4,2,5,6,1,-2,2,4,0,1,1,1,3,1,0,4,4,-4,0,0,-1,1,0,1,1,1
KR_6742457276,420,7,34,15,11,-4,1,5,4,5,1,8,8,0,1,1,0,2,2,0,1,9,145,2,7,9,4,0,0,1,1,1,1,1,1
KR_6679645170,420,-1,-29,13,-3,-4,0,4,5,6,1,-3,2,5,-1,4,5,0,3,3,-1,5,16,0,8,8,0,0,-1,1,-1,-1,1,3,1
KR_6736805540,420,3,85,12,8,5,6,1,2,3,1,0,2,2,3,7,4,-2,0,2,0,9,5,-1,5,4,-3,0,2,1,0,1,1,5,1
KR_6723644203,420,1,25,16,4,0,1,1,0,2,2,1,2,1,0,2,2,3,3,0,0,1,-1,1,3,4,5,0,0,1,-1,0,1,1,1
KR_6766547142,420,1,35,-16,5,-2,1,3,5,6,1,2,3,1,1,2,1,-1,2,3,0,7,-124,4,4,8,4,0,1,1,1,1,1,2,1
KR_6637052942,420,2,28,36,7,2,3,1,3,3,0,3,4,1,2,2,0,-3,0,3,0,5,18,-1,6,5,-13,0,0,1,1,0,-1,5,1
KR_6684961963,440,-1,-29,12,1,1,1,0,2,3,1,1,2,1,0,4,4,-3,3,6,0,8,18,3,8,11,-7,0,-3,-1,1,-1,1,2,1
KR_6753643951,440,3,64,23,7,1,1,0,-2,2,4,7,7,0,1,4,3,0,1,1,0,4,8,5,4,9,-4,0,2,-1,1,1,1,2,1
KR_6750594260,420,-2,20,7,1,2,2,0,-6,1,7,4,6,2,2,6,4,-1,1,2,0,3,9,5,4,9,-3,0,-2,1,-1,-1,1,5,1
KR_6529274792,420,-1,12,-14,-1,0,2,2,1,3,2,1,1,0,-3,2,5,0,0,0,0,-2,-3,-4,9,5,6,0,0,1,-1,-1,1,1,1
KR_6755698277,440,-1,-10,-16,4,0,1,1,3,3,0,0,3,3,1,1,0,0,2,2,0,5,23,0,6,6,-1,0,0,-1,-1,1,1,5,1
KR_6760582565,420,1,15,-2,4,-1,2,3,6,6,0,3,5,2,1,2,1,-5,0,5,0,14,-1,-3,6,3,5,0,1,-1,1,1,-1,2,1
KR_6760784298,440,0,-23,5,3,-1,4,5,1,1,0,8,9,1,-4,1,5,-1,2,3,0,6,64,-3,5,2,1,0,-2,-1,1,1,1,1,1
KR_6709182540,420,1,2,6,7,-3,1,4,4,4,0,0,2,2,5,7,2,1,1,0,1,11,-3,-2,10,8,1,0,0,0,1,0,1,0,1
KR_6738961527,420,2,-27,15,6,1,4,3,5,5,0,1,2,1,-1,1,2,0,1,1,0,9,-13,-2,6,4,1,0,0,1,1,0,1,2,1
KR_6726651614,420,1,35,4,3,-3,2,5,4,5,1,-1,1,2,4,7,3,-1,1,2,0,6,10,1,5,6,0,0,-1,1,-1,-1,-1,4,1
KR_6765599559,420,0,-20,6,7,-1,3,4,2,4,2,2,4,2,1,3,2,3,3,0,0,10,1,4,3,7,-1,0,1,1,-1,-1,1,2,1
KR_6642115933,420,3,40,-8,7,-1,2,3,1,2,1,3,6,3,3,7,4,1,4,3,0,16,3,2,7,9,0,0,-1,1,-1,-1,1,5,1
KR_6760531097,420,0,62,-27,3,1,1,0,3,4,1,-4,2,6,3,4,1,0,2,2,0,-1,22,0,6,6,-3,0,1,-1,1,1,1,1,1
KR_6762346985,420,2,46,-9,3,0,2,2,1,5,4,-2,0,2,4,4,0,0,0,0,0,6,-3,-1,6,5,-2,0,0,-1,-1,-1,1,3,1
KR_6672092305,420,1,88,-1,0,-1,3,4,1,2,1,0,0,0,2,3,1,-2,0,2,0,4,-19,1,6,7,5,0,0,1,-1,1,-1,1,1
KR_6766101184,420,3,31,12,7,3,4,1,-2,3,5,5,7,2,-1,4,5,2,4,2,-1,4,-8,-5,6,1,-2,0,1,0,0,1,-1,0,1
KR_6766484550,440,5,28,12,11,-3,0,3,4,7,3,-2,1,3,5,7,2,7,9,2,2,21,131,4,0,4,4,0,2,-1,1,1,1,3,1
KR_6753706465,420,-1,-59,-21,0,2,2,0,0,3,3,0,1,1,-1,3,4,-1,1,2,1,4,9,-3,6,3,1,0,-1,1,-1,-1,1,5,1
KR_6683576608,420,1,-12,-9,-5,4,6,2,-7,3,10,1,2,1,-2,1,3,-1,0,1,0,-5,-3,0,1,1,0,0,0,-1,1,1,1,5,1
KR_6752948338,420,4,7,-4,11,2,3,1,1,3,2,1,2,1,2,6,4,5,5,0,0,11,-102,-1,8,7,0,0,3,1,1,1,1,1,1
KR_6747081548,420,-3,-2,20,1,-1,0,1,1,1,0,3,6,3,-1,1,2,-1,0,1,0,-4,0,-1,5,4,6,0,1,-1,0,-1,1,6,1
KR_6766150789,420,5,18,42,3,2,4,2,-3,2,5,7,7,0,-2,2,4,-1,1,2,-1,-2,-25,0,6,6,4,0,1,1,1,1,-1,4,1
KR_6753559846,420,0,-14,-12,3,3,5,2,2,7,5,-4,0,4,0,4,4,2,2,0,0,1,-20,-4,5,1,2,0,1,-1,-1,1,-1,1,1
KR_6617484017,420,5,55,-16,8,5,6,1,-2,3,5,0,2,2,3,3,0,2,2,0,-1,6,-159,-4,5,1,3,0,1,1,-1,1,-1,5,1
KR_6717718531,420,0,-27,3,4,4,4,0,7,8,1,0,2,2,-3,0,3,-4,1,5,-1,7,-1,2,4,6,0,0,0,-1,1,-1,-1,4,1
KR_6752365222,420,0,-55,8,9,-1,1,2,8,9,1,1,3,2,1,3,2,0,2,2,2,14,-2,-2,7,5,3,0,0,1,-1,0,1,4,1
KR_6764465288,420,3,40,-10,6,-1,0,1,1,2,1,6,8,2,0,0,0,0,0,0,0,3,-110,-3,6,3,1,0,1,-1,1,1,1,4,1
KR_6740229140,440,-1,-9,-9,0,1,4,3,-1,3,4,-1,3,4,-1,4,5,2,4,2,1,3,-2,1,2,3,-1,0,1,0,1,1,1,0,1
KR_6633434361,420,7,83,40,15,3,3,0,1,2,1,4,5,1,5,6,1,2,2,0,1,16,3,1,6,7,1,0,1,1,1,1,1,1,1
KR_6766471831,420,1,42,-4,3,1,2,1,-2,4,6,1,2,1,1,2,1,2,2,0,2,2,-31,4,5,9,2,0,0,1,-1,0,1,1,1
KR_6732821505,420,2,46,23,4,-1,2,3,2,3,1,0,2,2,4,6,2,-1,0,1,0,0,-5,-3,6,3,1,0,2,-1,1,1,1,4,1
KR_6742839620,420,2,81,9,-2,0,1,1,-3,2,5,-1,0,1,0,1,1,2,2,0,0,-5,-113,3,5,8,-3,0,0,1,-1,0,1,4,1
KR_6734696769,420,2,-5,8,-2,0,1,1,6,7,1,-1,2,3,-4,0,4,-3,3,6,0,-1,15,1,4,5,1,0,0,-1,-1,-1,-1,1,1
KR_6743228949,420,2,-2,-8,7,1,5,4,4,5,1,2,2,0,0,2,2,0,1,1,0,0,135,-1,7,6,2,0,1,1,1,1,1,3,1
KR_6746643729,420,5,91,-14,19,2,2,0,3,6,3,4,7,3,8,8,0,2,2,0,0,11,2,4,2,6,-1,0,2,1,1,1,1,2,1
KR_6765408727,420,-2,-39,-24,1,-3,1,4,2,6,4,-1,3,4,4,5,1,-1,2,3,0,5,7,3,3,6,0,0,0,0,1,0,-1,0,1
KR_6701004206,420,0,-48,32,-1,-4,1,5,-1,1,2,-2,1,3,-4,1,5,10,10,0,0,6,-5,-1,6,5,1,0,0,1,1,-1,1,1,1
KR_6758045208,420,8,57,28,20,2,2,0,1,4,3,10,10,0,5,5,0,2,3,1,1,14,26,1,1,2,2,0,2,1,1,1,-1,2,1
KR_6687796216,420,6,90,28,16,1,2,1,3,4,1,11,12,1,3,4,1,-2,2,4,0,13,4,3,4,7,2,0,1,0,1,1,-1,0,1
KR_6738142443,420,0,21,16,3,3,3,0,3,5,2,2,5,3,-6,2,8,1,1,0,0,-3,-3,-3,5,2,3,0,1,1,1,1,-1,4,1
KR_6568118805,420,3,89,-24,13,1,4,3,5,6,1,2,2,0,5,6,1,0,0,0,0,13,10,3,6,9,-3,0,2,1,-1,1,-1,5,1
KR_6563467590,420,8,-14,23,20,4,4,0,12,13,1,3,3,0,1,2,1,0,0,0,0,23,-17,2,2,4,2,0,0,1,-1,0,1,6,1
KR_6760381932,440,2,13,-4,-3,-4,1,5,1,1,0,-1,4,5,1,3,2,0,2,2,-2,-2,13,-5,6,1,-1,0,1,-1,-1,1,-1,5,1
KR_6652668910,420,5,16,14,13,1,4,3,5,6,1,2,4,2,2,3,1,3,3,0,0,14,11,2,7,9,4,0,2,1,-1,1,-1,1,1
KR_6765786610,420,5,95,-16,11,9,9,0,1,6,5,5,6,1,-2,3,5,-2,0,2,0,4,9,0,4,4,2,0,3,1,1,1,1,5,1
KR_6601636671,420,4,27,7,8,-2,4,6,4,5,1,5,6,1,0,2,2,1,1,0,0,10,121,-5,11,6,4,0,1,1,1,1,1,1,1
KR_6729984884,420,0,51,-16,0,2,2,0,-1,3,4,1,2,1,-2,3,5,0,2,2,0,-5,-11,1,2,3,2,0,1,-1,1,1,-1,3,1
KR_6705463347,420,-1,-17,8,1,-2,1,3,-2,2,4,2,3,1,3,3,0,0,1,1,0,0,-6,-5,9,4,5,0,0,1,-1,-1,-1,5,1
KR_6757960477,420,1,64,11,4,-1,1,2,-2,3,5,6,8,2,-2,2,4,3,3,0,0,-3,-6,1,6,7,2,0,2,-1,-1,1,1,3,1
KR_6658127853,420,3,44,1,0,-4,1,5,1,3,2,-3,0,3,5,9,4,1,1,0,0,-2,202,-3,9,6,5,0,1,1,-1,-1,1,2,1
KR_6742820494,420,0,19,-4,0,-1,0,1,1,5,4,1,3,2,1,3,2,-2,0,2,0,4,9,2,4,6,-2,0,0,1,1,1,1,4,1
KR_6710928270,420,6,20,23,16,2,2,0,8,8,0,2,4,2,2,3,1,2,2,0,0,14,-26,4,4,8,4,0,3,1,1,1,1,2,1
KR_6764215437,440,5,10,-20,13,5,5,0,1,3,2,1,1,0,6,6,0,0,0,0,1,12,-16,0,5,5,4,0,0,-1,1,0,1,6,1
KR_6718477506,420,5,27,23,16,-2,0,2,7,7,0,9,10,1,2,2,0,0,1,1,0,17,5,3,4,7,1,0,-1,-1,-1,-1,1,4,1
KR_6765902524,420,0,-64,-23,-2,1,2,1,-3,0,3,-1,1,2,-1,2,3,2,2,0,0,8,8,4,4,8,-5,0,0,-1,1,0,-1,2,1
KR_6688706020,420,-4,2,-4,1,0,2,2,4,8,4,-4,2,6,2,3,1,-1,0,1,0,3,15,-2,3,1,0,0,0,0,1,0,1,0,1
KR_6742221165,420,4,-27,-16,7,1,2,1,1,5,4,5,5,0,3,7,4,-3,0,3,0,14,1,4,2,6,4,0,-1,0,1,-1,-1,0,1
KR_6765582456,440,2,11,2,-2,-1,0,1,-4,3,7,4,5,1,0,7,7,-1,4,5,0,1,0,2,4,6,5,0,0,1,-1,-1,1,5,1
KR_6748673908,420,4,16,12,15,-2,2,4,5,5,0,13,14,1,2,4,2,-3,0,3,1,11,-286,1,4,5,2,0,1,-1,1,1,1,5,1
KR_6759872511,420,6,63,17,14,3,7,4,6,7,1,0,3,3,3,4,1,2,2,0,1,26,2,2,5,7,4,0,2,-1,0,1,1,1,1
KR_6729419024,420,-3,-28,6,-4,1,2,1,-3,0,3,0,3,3,-3,4,7,1,3,2,0,-6,-7,2,3,5,3,0,-1,1,-1,-1,1,5,1
KR_6748281631,420,-1,-40,4,-3,2,2,0,1,3,2,-2,2,4,0,2,2,-4,0,4,-3,-9,-7,2,3,5,4,0,0,-1,0,0,-1,1,1
KR_6762848933,420,1,25,2,-1,-1,1,2,2,4,2,0,5,5,-1,1,2,-1,0,1,0,2,2,0,6,6,3,0,1,1,1,1,-1,5,1
KR_6725140526,420,2,59,19,6,2,2,0,2,6,4,2,2,0,-3,2,5,3,4,1,0,3,9,3,5,8,4,0,1,1,1,1,-1,6,1
KR_6684088297,420,0,-29,-14,5,-2,0,2,4,7,3,1,3,2,1,3,2,1,3,2,0,8,-106,-1,6,5,4,0,-1,-1,-1,-1,1,3,1
KR_6689880336,420,1,-33,24,2,-1,2,3,2,5,3,2,4,2,0,1,1,-1,0,1,0,5,2,2,10,12,0,0,0,1,-1,0,-1,2,1
KR_6710073597,440,-1,-45,62,-1,0,3,3,2,3,1,1,1,0,-5,3,8,1,5,4,0,-6,-21,-6,6,0,1,0,-1,1,1,-1,-1,6,1
KR_6732971726,420,2,62,1,9,2,3,1,-2,3,5,4,5,1,6,7,1,-1,0,1,0,6,23,9,0,9,-4,0,0,1,-1,1,-1,1,1
KR_6597917745,420,0,3,4,4,1,3,2,-1,4,5,1,2,1,1,2,1,2,3,1,0,6,125,1,4,5,-6,0,0,1,0,0,1,6,1
KR_6744047173,420,1,-4,3,4,-2,1,3,6,7,1,-1,2,3,2,2,0,-1,0,1,0,2,26,2,3,5,0,0,0,1,-1,0,1,4,1
KR_6747164746,420,-1,27,0,-3,1,3,2,0,2,2,-3,2,5,-3,0,3,2,3,1,0,-6,-109,0,4,4,-18,0,0,1,-1,1,1,5,1
KR_6763768175,420,-2,32,-6,0,1,2,1,1,5,4,0,1,1,-2,2,4,0,0,0,0,0,-140,-5,13,8,8,0,0,-1,1,0,1,5,1
KR_6567187056,420,0,17,-13,2,-3,0,3,1,5,4,2,2,0,2,4,2,0,0,0,0,7,3,-3,8,5,0,0,0,-1,1,0,1,3,1
KR_6739380021,420,-2,7,28,-8,0,4,4,-4,0,4,-2,0,2,-3,1,4,1,2,1,1,-13,8,0,5,5,3,0,0,1,-1,0,1,3,1
KR_6737786940,420,-2,-8,-27,2,1,3,2,-2,1,3,1,3,2,1,2,1,1,3,2,0,12,7,0,6,6,-4,0,0,-1,0,0,1,2,1
KR_6756180292,420,4,77,28,7,2,4,2,0,4,4,0,2,2,3,3,0,2,3,1,0,7,-4,3,4,7,9,0,1,0,1,1,1,0,1
KR_6758558594,420,5,112,12,16,-2,0,2,1,7,6,6,7,1,7,9,2,4,4,0,0,9,0,2,2,4,2,0,2,1,-1,1,1,2,1
KR_6754915049,420,2,-7,0,9,1,2,1,1,2,1,7,8,1,1,4,3,-1,0,1,1,14,-9,-1,4,3,0,0,2,1,1,1,1,2,1
KR_6763810563,420,0,-10,12,-1,-1,1,2,0,4,4,-4,2,6,1,5,4,3,4,1,2,12,-31,3,2,5,32,0,-2,1,-1,1,-1,5,1
KR_6706857531,420,0,48,-28,3,-7,1,8,4,4,0,6,6,0,-1,3,4,1,3,2,0,2,-5,2,3,5,2,0,0,1,-1,-1,1,2,1
KR_6701473116,440,-1,21,-12,-1,0,2,2,-1,0,1,-3,0,3,0,2,2,3,6,3,0,-3,3,5,1,6,-3,0,-1,1,-1,-1,1,2,1
KR_6628557084,420,1,20,12,1,0,0,0,-3,1,4,3,5,2,1,1,0,0,0,0,0,1,107,3,4,7,1,0,0,1,-1,0,1,2,1
KR_6744402025,420,5,39,39,16,3,5,2,1,4,3,2,3,1,9,10,1,1,2,1,1,17,4,-4,8,4,7,0,1,1,1,1,1,6,1
KR_6763487405,420,4,60,-5,3,0,3,3,1,3,2,6,7,1,-2,1,3,-2,1,3,0,12,-4,-4,7,3,-1,0,2,-1,-1,1,-1,4,1
KR_6762371395,420,0,43,17,-1,-3,2,5,-2,0,2,1,1,0,4,6,2,-1,1,2,0,1,121,0,8,8,2,0,0,1,-1,0,1,5,1
KR_6760095568,420,-1,0,-28,1,1,2,1,-2,4,6,2,2,0,-2,0,2,2,3,1,-1,-1,-14,0,4,4,-1,0,0,-1,-1,0,-1,6,1
KR_6743965260,420,1,17,-34,7,2,3,1,0,2,2,3,3,0,0,4,4,2,2,0,0,15,-147,-1,5,4,-3,0,0,1,1,-1,1,1,1
KR_6763708808,420,5,54,3,9,4,4,0,0,2,2,2,2,0,2,3,1,1,1,0,0,4,-5,-2,6,4,5,0,1,1,-1,1,1,6,1
KR_6759991739,420,0,35,28,0,5,6,1,0,2,2,-4,1,5,0,2,2,-1,0,1,1,-7,5,-2,10,8,-3,0,0,1,-1,-1,1,4,1
KR_6754630805,420,3,21,24,5,0,0,0,2,3,1,5,7,2,0,8,8,-2,1,3,0,8,12,0,5,5,-5,0,1,-1,-1,1,1,5,1
KR_6761949307,440,0,38,0,-4,2,2,0,-3,1,4,-3,2,5,2,6,4,-2,1,3,0,-5,4,-6,8,2,-3,0,-1,-1,-1,-1,-1,3,1
KR_6758276563,440,-2,-36,-12,2,0,1,1,-3,0,3,4,5,1,1,2,1,0,5,5,1,6,15,1,6,7,0,0,0,0,0,0,1,0,1
KR_6765997652,420,5,89,-8,9,1,2,1,2,2,0,4,5,1,0,4,4,2,2,0,0,8,111,-1,6,5,-1,0,1,1,1,1,1,4,1
KR_6757576554,440,1,55,27,4,5,5,0,0,0,0,0,2,2,0,2,2,-1,0,1,0,-7,-4,0,3,3,2,0,0,1,-1,0,1,5,1
KR_6706683796,420,2,-2,15,3,1,2,1,7,8,1,0,3,3,-4,1,5,-1,0,1,0,-2,6,-1,7,6,0,0,1,1,1,1,1,4,1
KR_6751299666,420,0,83,12,3,1,4,3,0,4,4,-2,1,3,4,5,1,0,2,2,0,-1,20,5,4,9,-1,0,2,1,1,1,-1,5,1
KR_6741709938,420,-1,21,-4,5,2,3,1,0,3,3,2,3,1,1,2,1,0,1,1,0,8,0,0,5,5,-1,0,1,1,0,1,1,4,1
KR_6754941649,420,2,-17,3,4,0,1,1,1,1,0,0,3,3,3,3,0,0,1,1,0,4,1,1,4,5,-4,0,-1,-1,-1,-1,-1,2,1
KR_6745255532,420,3,5,-28,8,0,1,1,3,4,1,4,5,1,-3,0,3,4,4,0,0,6,-1,4,3,7,-2,0,1,-1,1,1,-1,2,1
KR_6756968350,420,1,66,4,5,0,4,4,1,2,1,0,3,3,1,3,2,3,3,0,0,4,-7,-1,4,3,3,0,1,1,1,1,1,4,1
KR_6707512590,420,4,59,13,2,1,2,1,-4,3,7,3,4,1,2,5,3,0,0,0,2,-6,-150,0,8,8,-1,0,1,1,-1,1,1,2,1
KR_6755262395,420,0,-23,-13,1,-2,0,2,5,6,1,-2,4,6,1,2,1,-1,1,2,-1,14,1,0,5,5,-2,0,0,-1,-1,0,-1,3,1
KR_6763330569,440,3,59,9,0,2,3,1,0,2,2,-3,2,5,-1,1,2,2,2,0,-2,-3,-7,-3,7,4,4,0,0,1,0,1,-1,6,1
KR_6648439253,420,6,79,60,17,4,4,0,1,3,2,3,7,4,5,6,1,4,5,1,1,17,1,3,1,4,7,0,1,1,0,1,1,3,1
KR_6752353182,420,3,52,9,9,-1,1,2,3,7,4,1,3,2,6,8,2,0,0,0,0,4,23,0,8,8,-8,0,1,1,-1,1,1,6,1
KR_6658544586,420,2,14,0,5,1,1,0,4,4,0,-1,0,1,1,5,4,0,0,0,0,5,1,0,5,5,2,0,0,-1,-1,0,1,1,1
KR_6757715843,420,3,-4,0,14,1,4,3,1,3,2,5,5,0,7,7,0,0,1,1,0,13,-12,1,4,5,0,0,-1,0,1,-1,1,0,1
KR_6753788284,420,2,42,13,6,-2,0,2,-3,1,4,4,5,1,7,8,1,0,1,1,1,15,245,1,4,5,7,0,1,1,-1,1,1,4,1
KR_6709780668,420,-3,-27,-21,-5,3,4,1,-1,2,3,-8,0,8,-2,3,5,3,3,0,0,-1,39,0,2,2,-14,0,1,1,-1,-1,1,6,1
KR_6714304834,420,0,-1,15,-1,-2,1,3,2,3,1,1,1,0,1,6,5,-3,0,3,0,0,42,1,4,5,-21,0,0,-1,-1,0,-1,4,1
KR_6730585376,420,-1,-15,-16,-1,2,2,0,3,6,3,-1,1,2,-6,1,7,1,1,0,0,2,46,-3,7,4,-16,0,0,-1,-1,-1,-1,5,1
KR_6646539048,420,-3,-1,-16,-5,-9,0,9,-1,1,2,3,3,0,6,6,0,-4,1,5,1,6,6,-4,6,2,-2,0,1,1,-1,1,1,4,1
KR_6763354896,420,3,87,-28,7,3,3,0,-1,1,2,2,4,2,1,3,2,2,2,0,0,6,-81,-2,6,4,7,0,2,-1,-1,1,-1,3,1
KR_6507279870,420,-3,5,-16,-7,-1,1,2,-3,1,4,-1,0,1,-1,1,2,-1,2,3,0,-6,4,2,2,4,-3,0,0,-1,-1,0,-1,6,1
KR_6763376517,420,1,57,4,-1,0,2,2,0,6,6,1,2,1,-2,2,4,0,1,1,0,-2,-3,0,2,2,-3,0,1,-1,1,-1,1,4,1
KR_6764354667,420,3,-17,-24,3,0,1,1,-1,3,4,-1,1,2,2,5,3,3,3,0,0,2,16,2,3,5,-26,0,1,-1,-1,1,-1,4,1
KR_6736376139,420,2,58,5,4,-1,0,1,6,7,1,0,4,4,1,2,1,-2,0,2,0,3,-41,-2,9,7,1,0,1,-1,1,1,1,4,1
KR_6743115268,420,0,-14,5,-2,2,5,3,3,4,1,2,3,1,-7,0,7,-2,0,2,0,-6,-3,1,4,5,1,0,-1,-1,1,-1,-1,1,1
KR_6760960000,420,3,-5,44,4,-1,2,3,2,3,1,4,5,1,-1,2,3,0,0,0,0,0,1,-1,3,2,-1,0,0,1,1,1,-1,6,1
KR_6752411851,420,1,11,-6,-2,-3,0,3,0,3,3,-3,0,3,2,5,3,2,3,1,1,2,1,1,2,3,-2,0,-1,1,-1,-1,1,6,1
KR_6562285425,420,3,60,-19,4,2,4,2,1,3,2,-1,3,4,1,1,0,1,1,0,-2,-6,11,0,5,5,3,0,1,1,1,1,-1,1,1
KR_6634237150,420,1,64,33,4,-1,0,1,1,5,4,2,3,1,2,3,1,0,2,2,0,4,41,3,4,7,-29,0,1,1,1,1,1,3,1
KR_6740334897,440,-4,29,-16,-10,0,1,1,-6,1,7,-3,0,3,-1,0,1,0,1,1,0,-14,-6,1,6,7,2,0,1,0,1,1,-1,0,1
KR_6693992278,420,3,93,-12,6,-3,0,3,3,6,3,0,2,2,8,9,1,-2,1,3,0,1,3,0,6,6,1,0,1,1,-1,1,1,6,1
KR_6651556538,440,3,100,-12,5,1,1,0,-1,1,2,0,0,0,4,5,1,1,2,1,0,4,50,1,3,4,-26,0,0,1,-1,1,1,3,1
KR_6684804571,420,1,29,-27,-3,-1,3,4,2,4,2,1,4,3,-1,3,4,-4,2,6,0,-1,3,1,4,5,-2,0,1,-1,1,1,-1,5,1
KR_6654945182,420,2,64,-2,5,-1,1,2,-1,1,2,0,4,4,6,7,1,1,3,2,1,5,-5,1,3,4,3,0,0,1,-1,1,1,5,1
KR_6765360939,420,0,21,15,4,0,1,1,4,6,2,2,5,3,-2,0,2,0,1,1,0,3,1,0,3,3,-3,0,-1,0,0,-1,-1,0,1
KR_6628078304,420,-1,-3,-60,-1,0,1,1,-1,2,3,2,4,2,1,3,2,-3,0,3,0,1,0,-3,8,5,1,0,0,-1,-1,0,-1,2,1
KR_6760144484,420,4,27,9,10,-3,0,3,4,6,2,5,5,0,1,1,0,3,3,0,0,17,22,1,6,7,-20,0,1,1,-1,1,-1,4,1
KR_6685020215,420,3,-18,-4,0,-1,3,4,0,3,3,2,3,1,-2,2,4,1,1,0,0,-1,-19,-2,8,6,8,0,-1,1,-1,-1,-1,4,1
KR_6575873951,420,5,64,3,21,9,11,2,8,10,2,1,2,1,1,2,1,2,2,0,0,14,16,5,1,6,-3,0,3,1,1,1,1,5,1
KR_6645238845,420,4,115,-13,15,-2,3,5,4,8,4,2,2,0,11,11,0,0,0,0,0,15,1,3,3,6,2,0,3,-1,1,1,1,6,1
KR_6743530053,420,1,9,12,5,4,5,1,3,5,2,-3,1,4,1,3,2,0,0,0,0,-1,-1,-4,6,2,0,0,0,1,1,0,1,4,1
KR_6272932114,420,10,183,8,20,4,4,0,1,1,0,5,5,0,6,8,2,4,5,1,1,16,16,2,6,8,-1,0,5,1,-1,1,-1,1,1
KR_6747551794,420,0,72,-24,4,5,5,0,-8,0,8,-1,0,1,7,8,1,1,2,1,0,4,-6,-2,7,5,8,0,-1,1,-1,-1,-1,6,1
KR_6727091884,420,-1,24,4,0,1,3,2,1,2,1,2,2,0,-4,3,7,0,1,1,0,4,10,-1,4,3,0,0,1,1,1,1,-1,1,1
KR_6618248885,420,4,90,-17,12,10,10,0,1,2,1,0,2,2,0,0,0,1,2,1,0,8,-1,4,4,8,0,0,1,1,1,1,1,6,1
KR_6754440363,440,0,36,-9,2,4,7,3,-1,2,3,-1,2,3,4,4,0,-4,0,4,-1,0,-4,-1,8,7,5,0,0,1,1,0,-1,1,1
KR_6657539349,420,-2,-26,8,-1,-3,1,4,-4,0,4,2,5,3,5,6,1,-1,0,1,0,2,0,-8,11,3,3,0,0,-1,-1,1,-1,6,1
KR_6748981328,440,-3,-22,-18,-5,2,3,1,-2,2,4,-2,1,3,-2,3,5,-1,2,3,0,-8,9,1,6,7,1,0,0,0,1,0,1,0,1
KR_6736271903,420,2,-8,-15,1,1,2,1,-2,3,5,1,3,2,3,6,3,-2,1,3,0,3,11,4,5,9,-3,0,1,1,-1,-1,1,3,1
KR_6727298592,420,2,52,4,3,2,3,1,3,3,0,-3,1,4,2,8,6,-1,0,1,0,3,11,3,4,7,-2,0,1,-1,1,1,-1,1,1
KR_6755670836,420,0,23,29,1,-4,2,6,1,2,1,0,2,2,0,3,3,4,5,1,2,7,-4,-4,7,3,0,0,2,1,-1,-1,1,1,1
KR_6746759415,420,2,42,18,6,0,4,4,4,6,2,-1,1,2,3,5,2,0,0,0,0,5,-27,-3,7,4,-2,0,0,-1,-1,1,1,1,1
KR_6707317136,420,2,30,19,0,2,7,5,1,4,3,2,2,0,-5,0,5,0,0,0,0,-11,-43,0,4,4,4,0,1,1,1,1,-1,4,1
KR_6709692687,420,5,34,-8,15,5,5,0,1,2,1,2,4,2,6,7,1,1,1,0,1,21,0,4,2,6,6,0,2,1,1,1,1,3,1
KR_6764272610,420,1,-1,0,0,1,4,3,1,2,1,-5,3,8,3,4,1,0,3,3,0,-10,8,1,5,6,-2,0,1,1,1,1,1,1,1
KR_6678123851,420,1,-39,12,5,2,2,0,2,3,1,-2,2,4,1,3,2,2,3,1,0,3,54,6,2,8,-7,0,0,1,1,0,1,5,1
KR_6689958747,420,0,-27,12,-1,4,4,0,2,4,2,-1,1,2,-1,1,2,-5,2,7,0,-2,-1,3,4,7,-1,0,0,0,1,-1,-1,0,1
KR_6763836248,420,2,1,16,11,2,2,0,5,6,1,1,2,1,2,3,1,1,2,1,0,3,1,-2,4,2,6,0,1,1,1,1,1,6,1
KR_6743109471,420,7,67,62,13,0,2,2,7,8,1,3,3,0,5,5,0,-2,1,3,2,11,-4,-3,6,3,0,0,2,1,1,1,1,5,1
KR_6763606980,420,2,85,16,9,2,3,1,1,3,2,4,6,2,4,7,3,-2,1,3,0,9,5,-1,6,5,6,0,2,0,1,1,-1,0,1
KR_6686510291,420,4,19,1,13,0,2,2,3,5,2,2,2,0,9,9,0,-1,1,2,1,20,57,4,2,6,4,0,3,1,1,1,1,5,1
KR_6757844311,440,-3,-23,-8,-8,-2,1,3,2,3,1,5,5,0,-8,1,9,-5,0,5,0,-8,7,5,3,8,-1,0,1,1,1,1,-1,2,1
KR_6749551944,420,1,-12,9,9,0,1,1,5,6,1,1,3,2,2,3,1,1,1,0,0,11,-12,-4,7,3,-2,0,0,1,0,0,1,5,1
KR_6718508023,420,0,-34,4,-6,-1,2,3,2,2,0,0,3,3,-6,0,6,-1,0,1,0,-5,46,1,7,8,-21,0,0,1,1,-1,1,4,1
KR_6733998516,440,3,42,32,2,4,4,0,7,8,1,-1,0,1,-6,1,7,-2,0,2,0,-10,-4,-7,8,1,2,0,1,-1,-1,1,1,6,1
KR_6753563096,420,5,68,-33,8,1,2,1,-1,1,2,0,1,1,10,12,2,-2,1,3,1,9,-160,5,4,9,1,0,0,1,-1,1,1,5,1
KR_6748612221,420,4,81,0,8,4,5,1,-1,1,2,3,4,1,3,4,1,-1,2,3,0,4,0,2,2,4,4,0,1,1,-1,1,1,2,1
KR_6763573705,440,2,85,15,-1,0,3,3,-3,0,3,-1,0,1,3,6,3,0,0,0,0,-2,-5,-1,4,3,-1,0,2,1,-1,1,-1,4,1
KR_6750367131,420,4,75,-22,5,2,3,1,3,5,2,-5,2,7,4,5,1,1,2,1,0,10,114,6,0,6,3,0,0,-1,1,1,-1,3,1
KR_6761374747,420,1,63,16,-5,2,3,1,-4,1,5,0,3,3,-3,2,5,0,1,1,0,-12,9,1,6,7,-4,0,0,1,-1,-1,-1,1,1
KR_6765201470,420,0,0,-24,0,4,4,0,-4,2,6,2,5,3,-4,2,6,2,2,0,0,-10,13,1,5,6,-6,0,0,1,-1,-1,1,4,1
KR_6648856835,420,1,9,21,-3,1,1,0,-2,1,3,-1,0,1,-3,1,4,2,2,0,0,-6,7,2,4,6,5,0,0,1,1,0,-1,3,1
KR_6729806728,440,3,21,-12,-3,-2,1,3,-5,2,7,2,2,0,1,3,2,1,1,0,0,-5,-4,-3,6,3,-1,0,0,1,0,1,1,2,1
KR_6742153260,420,4,96,-1,10,6,7,1,5,7,2,-2,1,3,1,3,2,0,0,0,1,10,23,1,3,4,4,0,2,1,1,1,1,6,1
KR_6699365463,420,4,4,39,9,6,6,0,2,5,3,1,4,3,3,4,1,-3,2,5,0,2,213,-1,4,3,-1,0,2,1,1,1,1,5,1
KR_6726680415,420,4,11,32,14,3,3,0,3,3,0,1,4,3,5,6,1,2,2,0,1,11,2,-2,6,4,1,0,-1,1,1,-1,1,5,1
KR_6688038221,420,2,-16,32,7,-1,0,1,3,4,1,3,4,1,2,5,3,0,1,1,0,6,-70,0,6,6,-2,0,1,0,1,1,1,0,1
KR_6724828028,440,-3,-30,-11,-13,-7,0,7,1,5,4,-1,1,2,-1,0,1,-5,2,7,0,-12,-37,1,1,2,19,0,0,-1,0,-1,-1,3,1
KR_6744121037,440,5,56,-10,8,3,6,3,3,7,4,-1,1,2,1,4,3,2,2,0,0,4,-11,-11,12,1,6,0,2,0,1,1,-1,0,1
KR_6743814230,440,0,40,0,-2,-3,1,4,-2,1,3,3,5,2,-1,3,4,1,2,1,0,1,9,1,2,3,-1,0,0,1,-1,1,-1,1,1
KR_6693437469,420,1,81,-2,2,-2,1,3,0,2,2,1,3,2,3,3,0,0,1,1,0,1,6,3,3,6,-1,0,0,-1,1,1,1,4,1
KR_6725100612,420,4,18,30,7,1,1,0,1,3,2,3,5,2,2,3,1,0,0,0,0,3,-3,-2,6,4,5,0,0,1,1,0,-1,2,1
KR_6754239365,420,0,19,35,6,3,4,1,3,5,2,0,2,2,-1,2,3,1,3,2,0,0,212,-3,6,3,-1,0,1,1,-1,1,1,6,1
KR_6750977535,420,1,35,20,-1,-1,2,3,-1,2,3,1,1,0,2,3,1,-2,2,4,0,-5,24,-3,10,7,3,0,0,1,1,0,1,4,1
KR_6754337378,440,2,20,0,13,1,2,1,0,3,3,1,1,0,10,10,0,1,1,0,0,16,5,-2,3,1,-1,0,1,1,1,1,1,2,1
KR_6728848950,420,-2,-73,0,0,-2,3,5,0,3,3,-3,0,3,6,7,1,-1,1,2,-2,-4,4,-2,6,4,5,0,0,0,0,0,-1,0,1
KR_6718367604,420,-1,49,14,-5,0,1,1,-6,1,7,-3,1,4,4,9,5,0,1,1,0,2,44,4,4,8,-19,0,1,-1,-1,1,1,2,1
KR_6741845959,420,3,-24,21,2,1,4,3,3,4,1,1,1,0,-4,0,4,1,2,1,0,3,-6,-4,9,5,3,0,1,-1,1,1,1,2,1
KR_6737383167,420,-3,10,-1,-2,1,2,1,-1,1,2,-1,1,2,-1,0,1,0,0,0,0,0,128,-2,6,4,0,0,2,1,1,1,1,1,1
KR_6722940925,420,1,56,-23,2,2,2,0,3,5,2,-2,1,3,-1,3,4,0,0,0,0,-7,-11,-2,8,6,5,0,1,1,-1,1,1,6,1
KR_6731372243,420,5,17,17,6,2,4,2,-2,3,5,5,5,0,1,1,0,0,0,0,0,2,3,1,3,4,1,0,-1,1,0,1,-1,5,1
KR_6696846216,420,2,-1,28,7,0,0,0,11,13,2,-2,0,2,-1,1,2,-1,0,1,2,7,-1,-1,8,7,2,0,1,1,1,1,-1,3,1
KR_6688535647,420,0,-25,7,4,1,2,1,-5,2,7,6,7,1,1,5,4,1,1,0,2,0,-1,3,4,7,-4,0,0,0,-1,0,-1,0,1
KR_6749107316,440,-1,-21,-9,-5,-5,0,5,2,5,3,1,2,1,-3,1,4,0,4,4,1,3,-4,0,3,3,-2,0,-1,-1,1,-1,1,1,1
KR_6729383258,420,4,13,28,5,6,7,1,-1,0,1,-1,1,2,4,5,1,-3,1,4,0,7,-39,-1,6,5,15,0,2,-1,1,1,-1,3,1
KR_6746892588,420,2,68,2,3,3,5,2,-3,3,6,0,3,3,2,3,1,1,1,0,0,1,1,4,2,6,1,0,0,-1,-1,0,1,6,1
KR_6697869525,420,-1,16,-6,-4,0,2,2,0,3,3,-2,0,2,0,1,1,-2,0,2,0,-7,-1,-7,10,3,3,0,0,1,-1,0,-1,5,1
KR_6488751226,440,2,-31,41,-1,-1,7,8,2,3,1,-2,2,4,-1,1,2,1,1,0,1,-5,-16,-6,7,1,-4,0,1,0,0,1,1,0,1
KR_6726488712,420,0,15,-8,3,-1,0,1,1,3,2,2,3,1,1,4,3,0,1,1,0,0,8,-2,7,5,-3,0,0,1,-1,0,-1,1,1
KR_6602867615,420,2,105,-5,-5,0,2,2,2,7,5,-7,0,7,0,1,1,0,1,1,1,-8,23,0,4,4,6,0,1,-1,-1,1,1,2,1
KR_6686137604,420,3,43,-9,14,3,4,1,4,7,3,2,3,1,2,2,0,3,5,2,1,26,-165,-3,8,5,0,0,1,-1,1,-1,1,1,1
KR_6763066525,420,5,55,-4,16,2,2,0,0,1,1,1,4,3,4,5,1,9,9,0,2,18,-5,-1,5,4,2,0,2,1,1,1,1,1,1
KR_6741413981,420,9,100,36,19,6,7,1,6,7,1,3,4,1,3,7,4,1,1,0,3,11,17,0,9,9,11,0,1,1,1,1,1,4,1
KR_6764111655,420,2,8,24,3,-2,0,2,-4,0,4,-3,1,4,6,7,1,6,7,1,-1,5,16,2,7,9,6,0,1,1,1,1,-1,3,1
KR_6638733755,420,-1,-52,4,3,1,2,1,1,6,5,-2,2,4,2,4,2,1,3,2,0,13,61,-6,7,1,-4,0,0,1,1,0,1,1,1
KR_6418863194,420,2,24,-5,2,-7,0,7,5,9,4,1,2,1,4,7,3,-1,0,1,0,16,2,2,4,6,0,0,-2,1,-1,-1,-1,3,1
KR_6407819731,420,5,10,9,13,3,3,0,1,3,2,-1,2,3,6,7,1,4,5,1,-2,21,-6,-1,7,6,-1,0,1,1,1,1,-1,4,1
KR_6740895395,420,0,-65,41,-2,-3,1,4,1,2,1,-1,3,4,-4,5,9,5,6,1,0,3,-4,-6,9,3,2,0,0,1,-1,0,-1,4,1
KR_6753122733,420,1,76,36,-7,-7,2,9,2,3,1,4,4,0,-6,1,7,0,2,2,0,-25,-14,-3,7,4,5,0,-1,-1,1,1,-1,5,1
KR_6760080270,420,1,26,-27,5,1,3,2,0,4,4,0,2,2,1,2,1,3,4,1,0,7,-15,7,3,10,4,0,2,1,1,1,1,2,1
KR_6757622167,420,2,-31,7,3,-3,1,4,8,9,1,-1,3,4,-1,3,4,0,1,1,0,10,0,-1,8,7,-1,0,0,1,1,1,-1,1,1
KR_6687937934,440,1,35,-4,5,3,4,1,-3,0,3,1,2,1,1,3,2,3,6,3,1,1,0,1,3,4,-1,0,1,1,1,1,1,5,1
KR_6753868612,420,-2,17,-14,-8,-6,0,6,-4,2,6,0,1,1,3,6,3,-1,2,3,0,-4,12,1,3,4,-9,0,0,-1,-1,-1,-1,5,1
KR_6694172677,420,1,21,4,-2,1,3,2,1,4,3,-2,1,3,-3,0,3,1,1,0,0,-7,62,5,4,9,-21,0,0,-1,0,0,1,6,1
KR_6757818204,420,1,30,29,-1,2,3,1,2,6,4,1,4,3,-5,2,7,-1,1,2,0,-3,-2,-2,6,4,3,0,0,1,-1,0,1,5,1
KR_6732179301,420,5,13,49,7,2,2,0,1,4,3,1,3,2,0,2,2,3,3,0,0,7,14,3,5,8,4,0,-1,-1,1,-1,-1,5,1
KR_6658605180,420,2,55,-3,-1,0,0,0,3,3,0,1,3,2,-3,4,7,-2,0,2,0,-1,-7,-4,7,3,2,0,0,1,-1,0,1,2,1
KR_6734708474,420,0,-12,-12,9,-5,1,6,9,10,1,4,5,1,2,4,2,-1,0,1,0,14,-117,0,6,6,2,0,-1,1,1,-1,1,3,1
KR_6703242133,420,-3,-14,-24,-2,-2,0,2,-1,2,3,-2,2,4,2,2,0,1,2,1,0,0,0,-5,8,3,-6,0,1,1,-1,-1,-1,2,1
KR_6753119986,420,-2,29,-8,-1,4,5,1,-5,2,7,1,3,2,1,1,0,-2,1,3,0,-2,15,3,6,9,-4,0,2,-1,1,1,-1,1,1
KR_6716556854,420,5,26,-8,1,2,4,2,0,4,4,0,0,0,0,1,1,-1,1,2,0,5,115,1,4,5,2,0,1,1,-1,1,-1,1,1
KR_6747483243,440,1,-12,-4,5,-3,0,3,2,4,2,5,7,2,1,2,1,0,1,1,0,2,21,0,5,5,0,0,-1,-1,1,-1,-1,1,1
KR_6763314804,420,2,53,-16,0,0,1,1,-4,0,4,-3,0,3,10,10,0,-3,2,5,1,0,-2,2,4,6,0,0,0,1,-1,0,1,1,1
KR_6748021534,420,4,37,4,19,4,4,0,3,3,0,7,11,4,4,4,0,1,1,0,0,13,5,0,3,3,3,0,3,1,1,1,1,5,1
KR_6442792380,420,2,14,21,7,-3,0,3,3,4,1,4,5,1,3,4,1,0,0,0,0,9,-6,0,6,6,3,0,1,-1,1,1,-1,6,1
KR_6766138165,420,3,48,10,-1,-1,0,1,0,4,4,0,2,2,0,2,2,0,2,2,0,2,21,-6,7,1,-3,0,1,-1,1,1,-1,2,1
KR_6756605811,420,9,101,24,11,2,6,4,2,3,1,2,3,1,5,5,0,0,1,1,-1,5,-5,1,6,7,5,0,2,1,1,1,-1,3,1
KR_6749836591,420,0,-65,-16,6,1,1,0,2,3,1,0,2,2,3,5,2,0,2,2,-1,3,-37,4,3,7,-2,0,0,1,-1,0,-1,6,1
KR_6716352692,420,2,20,19,2,-3,1,4,3,6,3,1,2,1,1,1,0,0,0,0,0,10,17,1,9,10,-1,0,1,-1,1,1,1,3,1
KR_6748367353,420,0,-40,-8,-3,1,1,0,-2,0,2,2,3,1,-5,3,8,1,1,0,0,0,-116,-1,7,6,1,0,0,-1,1,1,1,5,1
KR_6752153525,420,2,47,4,1,0,2,2,-1,1,2,-1,1,2,2,3,1,1,1,0,0,3,-2,0,7,7,2,0,0,-1,-1,0,1,3,1
KR_6753056025,420,0,-48,12,2,2,2,0,1,1,0,2,4,2,-4,0,4,1,2,1,0,-2,-21,-2,7,5,-1,0,-2,-1,-1,-1,-1,3,1
KR_6754865274,420,3,23,-12,6,0,1,1,0,3,3,1,3,2,4,6,2,1,1,0,0,3,-3,2,3,5,-2,0,0,0,0,1,1,0,1
KR_6705043570,420,2,19,8,5,3,4,1,-1,6,7,2,5,3,2,4,2,-1,1,2,0,2,-2,0,7,7,4,0,0,0,-1,1,-1,0,1
KR_6702432657,420,3,38,-10,13,2,4,2,-1,1,2,2,4,2,10,10,0,0,0,0,3,22,23,1,4,5,0,0,2,-1,1,1,1,5,1
KR_6729578824,420,-3,-49,-2,-3,1,2,1,-2,0,2,-1,3,4,-3,1,4,2,2,0,0,-7,8,5,2,7,-4,0,0,-1,1,0,-1,6,1
KR_6762458061,420,3,-53,19,4,1,4,3,2,9,7,1,3,2,2,5,3,-2,0,2,-1,1,-10,-4,10,6,2,0,0,1,1,1,-1,3,1
KR_6662800961,420,-2,-48,-16,0,0,3,3,1,6,5,0,2,2,0,2,2,-1,3,4,-1,3,-6,1,4,5,-1,0,0,-1,1,0,-1,3,1
KR_6753714361,420,2,-38,8,10,3,6,3,-1,2,3,1,3,2,1,5,4,6,6,0,0,12,341,0,3,3,-3,0,1,1,-1,1,-1,3,1
KR_6757495731,420,-5,-13,-11,-9,-2,0,2,-3,1,4,-3,0,3,0,3,3,-1,0,1,0,0,60,-3,5,2,0,0,0,-1,-1,0,-1,1,1
KR_6652404076,420,-1,20,-31,2,-2,1,3,1,4,3,-1,3,4,6,6,0,-2,0,2,0,3,-3,1,6,7,7,0,1,1,1,1,-1,2,1
KR_6667828886,420,3,4,43,8,-2,0,2,2,4,2,9,9,0,-1,4,5,0,1,1,1,7,-5,2,3,5,1,0,1,1,1,1,1,6,1
KR_6726177800,420,3,79,0,-1,1,2,1,5,8,3,-7,1,8,1,1,0,-1,0,1,1,-5,-3,2,5,7,1,0,2,1,1,1,1,3,1
KR_6766034383,420,3,99,0,2,-4,2,6,4,6,2,3,3,0,1,3,2,-2,0,2,0,7,42,1,1,2,-10,0,1,0,1,1,1,0,1
KR_6757522076,420,0,-14,-11,1,-2,2,4,1,2,1,5,5,0,-2,2,4,-1,1,2,0,3,32,1,3,4,3,0,0,-1,1,0,1,5,1
KR_6728144479,420,1,-1,15,8,1,2,1,5,6,1,0,2,2,1,4,3,1,2,1,0,12,24,0,6,6,-1,0,0,1,0,0,1,2,1
KR_6652655463,420,0,6,0,4,1,2,1,2,5,3,-2,4,6,1,2,1,2,2,0,0,11,8,-5,7,2,4,0,0,1,-1,-1,1,4,1
KR_6735990992,420,6,73,9,11,2,3,1,2,4,2,-1,1,2,5,5,0,3,3,0,1,15,-2,-3,5,2,3,0,1,1,-1,1,1,4,1
KR_6729679259,420,3,-8,1,10,2,4,2,5,6,1,1,3,2,2,4,2,0,0,0,2,19,-7,1,4,5,2,0,-1,1,-1,-1,1,3,1
KR_6747497083,420,3,-10,12,9,4,6,2,1,2,1,2,3,1,2,2,0,0,2,2,0,13,177,0,8,8,-3,0,-1,1,-1,-1,1,4,1
KR_6760066284,420,2,62,47,9,0,0,0,1,3,2,6,6,0,4,4,0,-2,0,2,0,2,1,1,4,5,-1,0,0,1,1,1,1,2,1
KR_6761083719,420,-3,-22,-8,-2,4,4,0,1,3,2,-4,0,4,-2,3,5,-1,1,2,0,1,-5,-2,7,5,0,0,0,-1,-1,-1,-1,6,1
KR_6685453769,420,0,5,9,1,-2,1,3,-1,2,3,8,8,0,-3,0,3,-1,1,2,0,-3,26,-2,6,4,-19,0,1,-1,1,1,1,6,1
KR_6728729197,440,4,31,21,4,-1,0,1,-1,1,2,6,6,0,0,0,0,0,2,2,0,3,-140,0,5,5,-1,0,0,1,-1,-1,-1,2,1
KR_6716179679,420,2,4,27,7,1,3,2,2,5,3,0,2,2,1,2,1,3,4,1,0,3,-20,4,3,7,6,0,0,1,1,1,-1,4,1
KR_6684753424,440,5,54,8,11,2,4,2,2,3,1,0,3,3,-2,0,2,9,9,0,0,9,20,-1,5,4,3,0,1,-1,-1,1,1,5,1
KR_6760299711,420,1,41,8,-4,3,4,1,-4,1,5,-2,0,2,1,2,1,-2,0,2,0,-18,5,4,6,10,-7,0,-1,-1,1,-1,-1,3,1
KR_6759784821,420,6,67,5,16,1,2,1,2,5,3,7,8,1,2,4,2,4,6,2,0,17,-5,3,2,5,1,0,1,1,0,1,1,2,1
KR_6761453116,440,5,-5,44,11,-3,1,4,3,4,1,8,9,1,2,5,3,1,1,0,-4,8,-20,7,1,8,4,0,1,-1,-1,1,-1,5,1
KR_6752480590,420,-2,-29,7,-6,-4,1,5,-1,1,2,0,1,1,0,3,3,-1,3,4,-1,-10,16,1,4,5,0,0,0,-1,1,0,-1,4,1
KR_6745613529,420,4,46,20,15,4,4,0,2,6,4,3,3,0,3,5,2,3,3,0,2,19,8,3,2,5,-2,0,2,-1,1,1,1,2,1
KR_6759201866,420,1,-11,-17,2,-2,0,2,0,1,1,2,3,1,-1,2,3,3,5,2,0,-1,-130,-4,6,2,-1,0,0,1,-1,0,-1,5,1
KR_6763281293,440,4,31,40,5,3,5,2,3,4,1,2,2,0,1,3,2,-4,0,4,0,6,-3,0,5,5,-3,0,1,1,1,1,-1,6,1
KR_6724579456,420,0,68,0,0,-1,2,3,-1,1,2,3,8,5,0,3,3,-1,0,1,0,-6,18,1,6,7,2,0,4,1,1,1,-1,1,1
KR_6763824116,420,4,20,16,9,-3,1,4,3,6,3,1,3,2,2,3,1,6,6,0,0,11,-2,-6,7,1,5,0,1,1,-1,1,-1,1,1
KR_6764929373,420,-2,74,-19,2,2,4,2,3,4,1,-5,0,5,3,4,1,-1,0,1,0,6,8,4,3,7,-3,0,2,-1,1,1,-1,3,1
KR_6764260480,440,1,0,3,4,-2,0,2,1,2,1,4,4,0,-2,2,4,3,4,1,0,7,6,-1,7,6,4,0,0,1,1,0,-1,4,1
KR_6738109357,420,4,56,32,4,-3,1,4,3,3,0,-1,1,2,2,3,1,3,3,0,0,3,-21,-1,6,5,1,0,2,1,1,1,1,3,1
KR_6725391732,420,1,8,28,6,2,6,4,0,5,5,-2,1,3,4,7,3,2,3,1,1,8,10,-1,6,5,-2,0,1,1,-1,1,-1,4,1
KR_6715136540,420,1,11,-17,2,3,6,3,1,5,4,-1,2,3,0,2,2,-1,1,2,0,1,9,1,5,6,-1,0,-1,-1,1,-1,1,4,1
KR_6712728504,420,-2,73,0,-6,3,4,1,-5,2,7,-3,1,4,-1,2,3,0,1,1,0,-12,-21,-4,10,6,-3,0,-1,0,-1,1,1,0,1
KR_6716031340,420,-4,34,-12,-10,-3,1,4,-2,2,4,-2,2,4,-1,4,5,-2,3,5,0,-6,-6,4,2,6,6,0,0,1,-1,0,1,1,1
KR_6652436679,420,0,65,-25,2,3,3,0,1,2,1,-1,2,3,-4,1,5,3,3,0,0,6,67,0,7,7,3,0,1,-1,1,1,-1,3,1
KR_6759650680,420,0,-21,-45,6,2,6,4,-2,2,4,4,9,5,4,5,1,-2,1,3,1,-2,-3,4,3,7,1,0,0,1,-1,-1,1,6,1
KR_6716450787,420,-1,-35,12,-3,-6,0,6,-1,5,6,-2,0,2,6,7,1,0,1,1,0,2,20,-1,4,3,3,0,-1,0,0,-1,1,0,1
KR_6656904444,420,7,130,23,10,4,5,1,-2,1,3,3,4,1,1,5,4,4,4,0,0,4,11,4,2,6,-1,0,2,1,1,1,1,5,1
KR_6751332486,420,-1,63,-51,2,0,1,1,-1,0,1,-1,2,3,5,5,0,-1,0,1,2,0,-2,-3,9,6,3,0,1,-1,1,1,1,3,1
KR_6683424198,420,0,22,-16,6,3,3,0,2,2,0,-2,2,4,1,3,2,2,2,0,1,4,13,1,5,6,8,0,1,-1,1,1,1,6,1
KR_6718309341,420,1,65,-11,5,4,4,0,-1,2,3,0,2,2,3,3,0,-1,0,1,0,6,3,1,5,6,3,0,0,1,1,0,-1,2,1
KR_6759166192,440,4,8,18,10,-4,3,7,0,2,2,7,8,1,7,8,1,0,0,0,0,13,239,3,3,6,2,0,-1,1,1,-1,-1,4,1
KR_6741925062,440,6,102,9,6,1,3,2,5,6,1,2,2,0,1,3,2,-3,0,3,0,14,8,0,5,5,-3,0,3,-1,1,1,1,3,1
KR_6765365586,420,2,49,11,4,1,2,1,-4,0,4,0,3,3,4,4,0,3,3,0,0,-1,3,-3,9,6,2,0,0,1,1,1,-1,6,1
KR_6716365501,420,7,91,12,16,6,6,0,4,4,0,4,5,1,0,2,2,2,4,2,0,14,9,1,4,5,4,0,2,1,1,1,1,6,1
KR_6742212406,420,2,-6,16,-1,-1,0,1,3,5,2,2,2,0,-4,2,6,-1,0,1,-1,-5,5,-3,5,2,0,0,0,-1,1,0,-1,6,1
KR_6759222371,420,-1,3,-3,-10,-2,3,5,2,3,1,-2,4,6,-7,0,7,-1,1,2,0,-7,-2,0,6,6,0,0,0,-1,0,-1,1,3,1
KR_6720394665,420,1,-19,-28,0,1,2,1,4,5,1,-6,0,6,2,5,3,-1,2,3,0,4,37,2,7,9,-19,0,-3,1,-1,-1,-1,5,1
KR_6738681782,420,9,147,43,20,5,5,0,3,6,3,6,8,2,5,8,3,1,3,2,0,12,18,3,2,5,1,0,3,1,1,1,-1,6,1
KR_6706985260,420,1,-46,-7,7,-4,1,5,5,8,3,-3,1,4,9,10,1,0,1,1,0,22,-26,0,6,6,1,0,0,1,1,0,-1,2,1
KR_6765629457,420,3,64,-18,6,0,1,1,-1,2,3,-1,1,2,6,7,1,2,2,0,0,11,-125,1,6,7,9,0,0,-1,-1,-1,-1,6,1
KR_6761055644,420,0,49,-6,-2,-3,0,3,-3,2,5,5,5,0,1,2,1,-2,0,2,0,-1,-10,-2,4,2,-5,0,-1,-1,0,-1,-1,3,1
KR_6764107730,420,2,25,-4,6,-1,0,1,-3,3,6,1,4,3,7,10,3,2,3,1,-1,5,32,7,5,12,3,0,1,-1,-1,1,1,6,1
KR_6710364586,420,0,14,4,-1,-2,1,3,-2,4,6,3,6,3,2,3,1,-2,0,2,0,1,-11,-1,6,5,3,0,1,1,-1,1,1,2,1
KR_6747377542,420,-2,-65,-16,-2,1,1,0,-2,1,3,-4,1,5,0,2,2,3,6,3,0,-2,5,1,9,10,3,0,-1,1,-1,-1,-1,1,1
KR_6751632837,440,0,10,20,0,5,5,0,0,2,2,-3,1,4,-2,2,4,0,1,1,0,0,-2,-5,8,3,5,0,0,-1,1,1,1,1,1
KR_6615415581,420,4,30,13,13,4,4,0,0,2,2,4,4,0,3,5,2,2,2,0,1,20,8,0,5,5,-2,0,0,-1,-1,0,1,2,1
KR_6670188172,420,1,28,27,0,2,4,2,-1,2,3,1,4,3,-3,3,6,1,1,0,-1,-4,-21,0,4,4,7,0,0,1,-1,0,-1,6,1
KR_6760444142,420,1,4,4,4,-1,2,3,3,4,1,2,2,0,0,1,1,0,0,0,0,1,-17,2,4,6,9,0,-1,1,-1,-1,1,6,1
KR_6654094049,420,1,66,20,2,2,5,3,0,2,2,-3,2,5,3,5,2,0,3,3,0,0,-117,1,4,5,-1,0,1,1,-1,1,1,6,1
KR_6703007055,420,-2,37,0,-3,2,4,2,-2,4,6,1,2,1,-7,0,7,3,3,0,-2,-13,-1,-2,10,8,1,0,1,-1,1,1,-1,6,1
KR_6658734475,440,5,39,38,8,-5,1,6,2,6,4,5,6,1,6,7,1,0,1,1,0,7,1,4,2,6,-1,0,2,1,1,1,-1,5,1
KR_6702272919,420,-3,14,8,-5,3,4,1,-3,0,3,-5,1,6,-1,3,4,1,2,1,0,-9,119,2,3,5,-2,0,1,-1,1,1,-1,5,1
KR_6273555367,420,0,-24,-16,-3,1,2,1,-1,3,4,1,1,0,0,1,1,-4,0,4,0,-7,-12,1,6,7,4,0,0,-1,1,1,-1,5,1
KR_6644742759,420,4,35,37,9,2,2,0,4,6,2,0,0,0,3,5,2,0,0,0,0,9,-7,-5,8,3,0,0,1,1,1,1,1,4,1
KR_6739231676,420,0,23,-19,-7,0,2,2,1,3,2,-6,3,9,-4,2,6,2,2,0,0,-10,7,-6,6,0,-1,0,-2,1,-1,-1,1,6,1
KR_6758744856,420,1,24,-39,6,1,2,1,1,3,2,3,4,1,-1,4,5,2,3,1,0,6,0,0,7,7,-1,0,0,1,-1,0,-1,6,1
KR_6678859159,420,5,114,35,10,1,1,0,10,11,1,-3,0,3,-2,4,6,4,4,0,0,9,-12,0,4,4,5,0,2,1,1,1,-1,1,1
KR_6654925523,420,1,49,-8,6,3,4,1,-1,5,6,3,3,0,0,3,3,1,1,0,0,0,0,-3,5,2,2,0,4,1,1,1,1,3,1
KR_6750503101,420,1,-70,-41,12,2,4,2,1,2,1,2,4,2,5,6,1,2,2,0,0,24,24,0,3,3,0,0,0,-1,1,1,1,1,1
KR_6505957418,420,3,51,16,7,1,2,1,0,3,3,5,6,1,1,2,1,0,0,0,0,12,-4,0,2,2,-2,0,0,-1,1,0,1,6,1
KR_6763555133,420,1,26,30,4,1,2,1,-1,4,5,4,5,1,0,2,2,0,1,1,1,5,6,3,3,6,-2,0,1,-1,1,1,1,4,1
KR_6747014265,420,5,66,12,9,2,3,1,7,9,2,-1,3,4,0,2,2,1,1,0,0,10,22,0,8,8,8,0,2,0,1,1,1,0,1
KR_6738095679,420,1,-45,-20,-3,2,3,1,0,2,2,-1,1,2,-2,0,2,-2,1,3,0,-12,16,1,4,5,-9,0,0,1,-1,0,1,2,1
KR_6761856166,440,1,53,-37,7,6,6,0,-5,0,5,1,3,2,1,2,1,4,4,0,0,3,-2,-2,4,2,3,0,0,-1,1,1,1,1,1
KR_6753905375,420,1,38,12,-2,-2,1,3,3,5,2,-5,1,6,1,4,3,1,1,0,0,1,6,1,6,7,-2,0,1,-1,-1,1,-1,1,1
KR_6689050011,420,0,-48,-7,-2,0,2,2,3,6,3,0,4,4,-3,1,4,-2,0,2,0,5,7,4,1,5,-5,0,1,-1,1,1,-1,5,1
KR_6757157840,420,2,87,-2,5,1,3,2,3,5,2,1,2,1,0,2,2,0,1,1,0,11,0,0,6,6,2,0,1,1,-1,1,-1,6,1
KR_6762271770,420,2,-6,17,4,0,0,0,-1,0,1,1,2,1,0,2,2,4,4,0,0,3,-2,0,5,5,3,0,1,-1,1,1,1,3,1
KR_6743921856,420,5,40,16,15,-1,2,3,1,2,1,0,3,3,10,10,0,5,5,0,0,15,6,1,7,8,5,0,2,-1,1,1,-1,6,1
KR_6760620407,420,2,-12,52,-2,1,3,2,-2,3,5,1,2,1,-3,1,4,1,2,1,0,-1,-5,-4,8,4,0,0,0,1,-1,-1,-1,3,1
KR_6762900721,420,1,25,4,-1,-1,1,2,3,4,1,-1,1,2,-4,1,5,2,2,0,0,4,-4,0,5,5,1,0,0,1,-1,0,1,4,1
KR_6738663493,420,0,-29,12,-5,-1,2,3,-3,1,4,0,3,3,-1,5,6,0,0,0,0,-5,1,1,9,10,1,0,0,1,-1,0,1,1,1
KR_6760604437,420,2,100,22,11,7,7,0,0,1,1,4,5,1,1,6,5,-1,0,1,1,-3,0,1,4,5,-1,0,2,1,1,1,1,1,1
KR_6731552516,420,4,37,-9,10,3,3,0,4,5,1,1,2,1,2,4,2,0,1,1,0,18,213,3,4,7,1,0,0,1,-1,1,1,4,1
KR_6737370134,420,-2,-35,-16,-2,-2,0,2,1,2,1,0,2,2,3,7,4,-4,2,6,0,3,193,-4,8,4,0,0,0,1,-1,0,-1,6,1
KR_6763272217,420,0,-80,-7,5,-1,0,1,1,4,3,2,5,3,3,5,2,0,1,1,0,9,2,3,2,5,5,0,-1,-1,0,-1,-1,5,1
KR_6749078839,420,1,-1,-13,0,2,5,3,-1,5,6,0,2,2,-1,0,1,0,2,2,0,0,-19,-3,6,3,-2,0,-1,0,-1,-1,-1,0,1
KR_6751470343,420,-2,-102,-5,-4,0,2,2,-1,2,3,-1,2,3,-2,2,4,0,2,2,0,-2,0,-3,5,2,1,0,-3,1,-1,-1,-1,1,1
KR_6763418254,420,1,-8,-7,4,-1,2,3,0,0,0,5,6,1,3,8,5,-3,1,4,0,1,-5,-3,9,6,4,0,-1,1,-1,-1,1,4,1
KR_6752059980,440,4,19,-20,4,2,5,3,-4,1,5,-3,4,7,7,9,2,2,3,1,2,3,8,0,5,5,0,0,0,1,-1,1,1,1,1
KR_6683689101,420,2,-20,8,3,-2,1,3,3,3,0,-2,0,2,5,5,0,-1,0,1,0,9,-200,0,4,4,5,0,1,1,-1,1,-1,5,1
KR_6765529814,420,0,0,-1,-6,-7,1,8,1,4,3,5,6,1,-5,4,9,0,1,1,0,-1,1,4,3,7,1,0,-1,-1,-1,-1,-1,6,1
KR_6634970611,420,0,-5,20,-2,-2,0,2,4,6,2,2,3,1,-6,0,6,0,1,1,-1,-10,-5,-2,7,5,0,0,0,1,-1,0,-1,3,1
KR_6753121621,420,1,19,-44,2,-2,0,2,1,2,1,3,4,1,1,1,0,-1,3,4,0,6,7,2,5,7,3,0,0,-1,1,0,-1,6,1
KR_6760956835,420,5,83,40,19,4,5,1,4,5,1,1,3,2,8,8,0,2,3,1,0,22,41,-1,5,4,-15,0,4,1,1,1,1,1,1
KR_6759815175,420,-1,-4,10,-7,0,1,1,-4,0,4,1,4,3,-3,2,5,-1,2,3,0,-9,-34,2,4,6,7,0,-1,0,-1,-1,-1,0,1
KR_6754462286,420,-4,-57,-28,-2,-1,1,2,-3,2,5,1,1,0,1,6,5,0,1,1,1,0,-17,6,7,13,1,0,0,1,-1,-1,1,6,1
KR_6739210687,420,4,45,-9,12,5,6,1,4,6,2,1,3,2,3,4,1,-1,1,2,0,6,4,3,5,8,-1,0,1,-1,1,1,-1,2,1
KR_6672578622,420,-1,-43,33,2,-1,1,2,-3,2,5,4,4,0,2,4,2,0,1,1,0,1,4,3,3,6,-3,0,0,1,1,-1,1,2,1
KR_6762223653,420,2,42,47,6,1,1,0,0,4,4,1,5,4,-1,1,2,5,5,0,0,5,-8,-2,6,4,0,0,0,1,0,0,-1,3,1
KR_6755654879,420,1,29,15,7,0,0,0,3,4,1,0,2,2,2,2,0,2,2,0,0,3,14,-1,10,9,1,0,0,-1,1,0,1,1,1
KR_6745286076,420,4,28,43,7,2,2,0,-3,1,4,3,4,1,5,6,1,0,0,0,0,6,17,0,5,5,0,0,1,1,1,1,1,6,1
KR_6696778600,420,-1,-45,12,5,1,2,1,3,6,3,0,3,3,1,1,0,0,0,0,0,2,-2,-5,8,3,3,0,1,1,1,-1,-1,2,1
KR_6743965685,420,0,32,12,-2,0,0,0,1,2,1,-2,4,6,-1,0,1,0,1,1,0,0,10,5,5,10,5,0,0,1,1,0,1,2,1
KR_6764897846,420,2,38,32,5,4,5,1,-4,1,5,0,3,3,3,4,1,2,4,2,0,-2,-3,8,3,11,0,0,2,1,1,1,-1,4,1
KR_6705407166,440,1,71,12,-1,1,4,3,2,2,0,2,2,0,-5,0,5,-1,0,1,0,-11,-22,0,2,2,-1,0,1,-1,1,1,1,3,1
KR_6634072681,420,3,55,-28,1,3,3,0,5,6,1,-3,2,5,-4,4,8,0,1,1,0,0,-4,3,3,6,3,0,2,-1,1,1,-1,3,1
KR_6765577872,420,5,94,23,17,5,7,2,2,2,0,4,5,1,6,7,1,0,1,1,0,11,-2,4,3,7,0,0,1,1,1,1,1,1,1
KR_6632597895,420,1,-13,-7,7,0,0,0,6,8,2,1,2,1,-1,1,2,1,2,1,0,8,6,3,5,8,2,0,0,1,-1,0,1,3,1
KR_6760908265,420,-1,32,-22,-1,3,4,1,0,3,3,-2,2,4,4,5,1,-6,0,6,0,0,5,-1,5,4,-3,0,-1,-1,-1,-1,1,6,1
KR_6762449061,420,1,-17,5,-1,-1,2,3,1,2,1,1,1,0,-1,2,3,-1,0,1,0,2,-3,3,5,8,1,0,1,1,1,1,-1,5,1
KR_6630886751,420,-1,67,-32,4,-1,1,2,6,9,3,3,8,5,-3,0,3,-1,0,1,-1,4,-25,3,6,9,-4,0,0,-1,-1,1,-1,5,1
KR_6758704064,420,1,-8,24,2,1,2,1,1,2,1,0,2,2,-3,1,4,3,3,0,0,-1,1,-1,5,4,-5,0,0,1,1,1,-1,4,1
KR_6751188230,420,6,129,-29,13,3,4,1,1,3,2,1,5,4,0,1,1,8,9,1,0,14,-19,0,4,4,1,0,0,1,-1,1,1,5,1
KR_6724644529,420,3,-39,24,12,-3,0,3,0,2,2,7,7,0,3,4,1,5,6,1,0,10,2,2,4,6,-1,0,-2,1,-1,-1,1,3,1
KR_6752013949,440,2,49,-12,4,1,1,0,1,1,0,-2,3,5,4,5,1,0,2,2,0,2,0,-2,4,2,6,0,0,0,-1,0,1,0,1
KR_6424586859,420,0,-33,1,-3,1,2,1,2,2,0,-3,2,5,-1,2,3,-2,0,2,0,0,-14,-1,9,8,3,0,-1,1,-1,-1,-1,3,1
KR_6663217218,420,4,86,8,2,2,4,2,-2,0,2,1,3,2,0,3,3,1,1,0,0,5,8,0,4,4,-5,0,1,1,1,1,-1,6,1
KR_6706691161,420,1,8,44,1,-4,0,4,-1,4,5,7,10,3,0,1,1,-1,0,1,1,-1,38,0,6,6,-2,0,3,1,1,1,1,4,1
KR_6762769981,420,2,43,0,7,6,6,0,0,2,2,3,3,0,2,4,2,-4,0,4,-1,3,0,0,6,6,1,0,1,1,-1,1,-1,1,1
KR_6752421193,420,4,-5,-10,6,1,1,0,5,6,1,3,4,1,-4,2,6,1,1,0,1,0,-3,2,3,5,2,0,1,-1,1,1,1,4,1
KR_6766028206,440,0,49,16,-1,-6,0,6,-1,2,3,0,1,1,6,6,0,0,1,1,0,5,0,3,3,6,-1,0,-1,1,-1,-1,-1,5,1
KR_6700528781,420,0,59,-5,1,-4,1,5,4,4,0,6,7,1,-3,0,3,-2,1,3,0,3,3,2,3,5,1,0,-1,-1,1,1,-1,1,1
KR_6602988799,420,0,17,-6,1,4,5,1,-1,5,6,0,3,3,0,4,4,-2,1,3,0,2,14,14,3,17,-4,0,-1,1,-1,-1,-1,6,1
KR_6762963124,420,4,14,-6,7,1,3,2,0,3,3,2,4,2,-1,0,1,5,5,0,0,10,0,-2,7,5,1,0,2,1,-1,1,-1,1,1
KR_6765650536,440,0,-7,25,2,0,1,1,0,3,3,8,9,1,-5,3,8,-1,1,2,0,-5,-3,1,4,5,-1,0,0,1,0,1,1,3,1
KR_6759976262,440,3,51,-36,8,3,3,0,2,3,1,-1,2,3,1,2,1,3,4,1,0,12,-3,3,4,7,-7,0,1,1,-1,1,1,1,1
KR_6722335226,420,1,68,8,6,0,1,1,0,1,1,4,4,0,4,5,1,-2,2,4,0,9,-52,-2,8,6,3,0,2,-1,1,1,-1,2,1
KR_6725471175,420,2,-21,6,7,2,5,3,-5,1,6,7,8,1,-1,1,2,4,4,0,1,3,16,-7,8,1,0,0,1,1,1,1,1,5,1
KR_6727360473,420,-1,-34,16,-5,1,1,0,-1,4,5,3,3,0,-3,3,6,-5,0,5,0,-7,0,3,4,7,1,0,-1,1,-1,-1,1,6,1
KR_6763890130,420,-3,41,16,-7,-1,0,1,-4,0,4,-4,0,4,3,7,4,-1,1,2,0,0,-9,-2,4,2,2,0,0,1,-1,0,1,1,1
KR_6763975827,420,0,14,32,-9,1,3,2,-2,2,4,-5,0,5,-1,2,3,-2,4,6,-2,-20,6,-1,5,4,-2,0,0,1,-1,-1,-1,6,1
KR_6683042981,420,0,16,-41,-2,3,3,0,-1,2,3,-5,0,5,1,6,5,0,1,1,0,2,-23,1,5,6,0,0,-1,-1,-1,-1,-1,3,1
KR_6760406428,420,1,22,10,2,1,5,4,3,6,3,4,5,1,-5,2,7,-1,1,2,-1,1,-147,-1,5,4,0,0,0,1,-1,1,-1,3,1
KR_6618098388,440,3,47,18,7,-1,1,2,2,8,6,1,5,4,3,6,3,2,4,2,1,3,-4,3,4,7,3,0,0,1,-1,1,1,6,1
KR_6688197742,440,3,-10,19,9,-2,0,2,4,5,1,5,5,0,3,4,1,-1,0,1,1,7,19,-1,3,2,1,0,2,0,-1,1,1,0,1
KR_6687045170,420,2,23,28,0,3,4,1,-2,3,5,-1,1,2,0,1,1,0,1,1,0,-4,-13,-3,6,3,0,0,0,1,1,0,-1,3,1
KR_6710149050,420,2,72,-20,11,0,3,3,0,1,1,4,5,1,4,5,1,3,4,1,0,7,61,3,2,5,-17,0,-1,1,1,1,1,1,1
KR_6651134698,420,2,-9,8,8,1,2,1,1,2,1,2,3,1,3,4,1,1,1,0,0,12,5,4,6,10,1,0,0,-1,1,0,-1,6,1
KR_6756712464,440,7,105,21,17,7,9,2,9,10,1,2,2,0,2,3,1,-3,0,3,2,20,190,3,2,5,2,0,2,-1,1,1,1,1,1
KR_6646712898,420,6,66,31,9,2,3,1,2,3,1,0,3,3,4,7,3,1,1,0,0,16,-139,-2,8,6,1,0,2,1,-1,1,1,3,1
KR_6755933390,420,1,6,12,10,0,3,3,5,5,0,0,2,2,6,6,0,-1,1,2,0,13,-2,1,4,5,3,0,1,1,-1,1,1,1,1
KR_6746770342,420,5,-15,15,15,8,8,0,-3,0,3,5,6,1,1,3,2,4,4,0,1,15,0,-1,4,3,0,0,4,-1,1,1,1,2,1
KR_6761335224,420,-1,19,4,4,3,8,5,2,3,1,4,6,2,-1,0,1,-4,0,4,0,0,8,4,2,6,-5,0,1,0,1,1,1,0,1
KR_6731208197,420,-2,13,8,6,2,2,0,-2,6,8,4,4,0,2,3,1,0,1,1,0,7,-7,2,6,8,1,0,1,1,1,1,1,2,1
KR_6744874291,420,3,9,25,10,1,1,0,2,4,2,4,5,1,3,6,3,0,1,1,0,15,63,3,6,9,11,0,1,1,1,1,1,6,1
KR_6631014727,420,0,69,4,1,0,2,2,0,2,2,0,1,1,1,3,2,0,0,0,0,1,-9,-1,6,5,3,0,1,1,1,1,1,3,1
KR_6697872678,420,1,74,32,3,-2,0,2,0,4,4,3,5,2,2,3,1,0,1,1,0,8,22,-1,7,6,0,0,0,1,-1,-1,1,1,1
KR_6748486728,420,2,49,1,0,1,1,0,-2,2,4,0,0,0,0,1,1,1,1,0,0,-6,-260,1,5,6,-1,0,0,-1,-1,0,-1,5,1
KR_6747691909,440,1,-17,-32,6,1,5,4,2,3,1,-3,1,4,4,4,0,2,2,0,1,18,4,7,4,11,-1,0,0,1,-1,-1,1,5,1
KR_6488728616,420,1,20,52,-7,-6,0,6,3,4,1,-2,1,3,-1,1,2,-1,0,1,0,-4,41,1,6,7,-10,0,1,0,0,1,-1,0,1
KR_6617801276,420,4,50,3,8,3,3,0,1,1,0,-1,0,1,4,5,1,1,2,1,0,7,-37,5,4,9,-2,0,0,-1,-1,1,1,6,1
KR_6698198165,420,1,30,-12,3,2,3,1,-3,1,4,4,5,1,0,3,3,0,2,2,1,5,-1,-5,9,4,7,0,0,1,-1,0,1,3,1
KR_6756230234,420,-2,-12,8,-5,-1,1,2,-2,1,3,0,5,5,-2,3,5,0,1,1,-1,-16,4,3,4,7,-5,0,1,-1,1,1,-1,6,1
KR_6759049990,420,0,45,36,1,2,3,1,0,4,4,-6,2,8,3,4,1,2,3,1,0,-4,-1,0,5,5,-5,0,1,0,1,1,1,0,1
KR_6750558282,420,1,-29,15,-1,-6,0,6,2,2,0,0,5,5,4,5,1,-1,1,2,0,9,7,2,5,7,-1,0,0,-1,1,0,-1,3,1
KR_6750542789,420,4,23,-3,12,-1,2,3,3,4,1,-1,2,3,4,5,1,7,8,1,0,10,120,3,3,6,-1,0,0,1,-1,1,1,1,1
KR_6765279178,420,1,16,24,5,0,3,3,1,1,0,-1,0,1,5,7,2,0,1,1,-1,1,16,-1,6,5,0,0,1,1,-1,1,-1,6,1
KR_6756785974,420,4,9,27,13,1,2,1,5,7,2,2,4,2,5,10,5,0,2,2,-1,13,4,0,5,5,-2,0,1,-1,1,1,-1,1,1
KR_6741541163,420,3,35,0,2,-2,2,4,1,3,2,3,4,1,-2,4,6,2,2,0,0,6,-4,1,7,8,8,0,1,-1,0,1,-1,4,1
KR_6735118188,420,0,23,-16,-1,0,2,2,0,2,2,2,2,0,-1,1,2,-2,0,2,0,-3,-8,4,3,7,2,0,0,1,1,0,1,4,1
KR_6745148852,440,1,44,12,-1,3,3,0,-2,2,4,0,1,1,-2,3,5,0,0,0,0,-3,9,2,4,6,-1,0,1,0,1,1,1,0,1
KR_6725423166,420,2,46,1,6,2,3,1,1,3,2,0,1,1,2,4,2,1,2,1,0,6,31,0,4,4,-1,0,0,-1,-1,1,1,5,1
KR_6644710808,420,2,20,-17,2,5,5,0,1,2,1,-1,1,2,-2,0,2,-1,0,1,0,-3,46,-1,5,4,-12,0,1,-1,1,1,-1,6,1
KR_6751559728,420,4,63,7,1,2,2,0,-2,1,3,4,6,2,-1,4,5,-2,1,3,0,1,-7,3,6,9,6,0,0,-1,1,1,1,5,1
KR_6559134684,420,0,38,28,0,2,3,1,2,6,4,-1,1,2,-1,0,1,-2,0,2,-1,-5,2,-3,9,6,0,0,0,1,-1,0,1,3,1
KR_6667475474,420,1,58,-13,7,1,2,1,-2,1,3,6,6,0,1,3,2,1,1,0,0,8,-4,2,3,5,4,0,1,1,1,1,1,4,1
KR_6759236741,420,1,16,13,3,1,2,1,-2,1,3,3,5,2,0,2,2,1,1,0,0,6,3,0,7,7,6,0,0,-1,0,0,-1,4,1
KR_6759760803,420,3,20,12,7,0,0,0,5,5,0,-1,1,2,4,6,2,-1,0,1,0,6,4,-1,2,1,2,0,0,-1,1,0,1,1,1
KR_6693523074,420,0,-30,0,2,2,2,0,1,4,3,-1,2,3,-2,2,4,2,2,0,0,6,-1,-2,6,4,3,0,0,1,0,0,-1,2,1
KR_6700579408,420,5,60,60,6,2,2,0,-2,2,4,4,8,4,2,4,2,0,1,1,-1,-1,6,2,1,3,2,0,2,1,-1,1,-1,1,1
KR_6747520050,420,1,29,-19,8,2,2,0,5,10,5,0,3,3,4,5,1,-3,0,3,0,8,-3,6,5,11,3,0,-1,-1,1,-1,1,6,1
KR_6678699808,420,3,16,13,6,2,3,1,-2,1,3,2,3,1,3,6,3,1,3,2,-1,0,7,0,10,10,1,0,0,1,1,1,-1,3,1
KR_6725845981,420,6,52,24,13,4,4,0,5,6,1,2,5,3,3,3,0,-1,1,2,0,11,-30,-3,10,7,-2,0,0,-1,1,1,1,5,1
KR_6658888293,420,1,78,-6,-2,-2,0,2,-3,1,4,1,1,0,4,4,0,-2,2,4,0,-4,10,5,3,8,5,0,0,0,1,0,-1,0,1
KR_6750422395,420,2,9,-24,2,2,3,1,-1,0,1,0,5,5,2,5,3,-1,0,1,0,-2,115,-1,6,5,7,0,0,-1,1,0,1,6,1
KR_6732147611,440,0,3,12,-4,4,6,2,-1,1,2,-5,1,6,-3,2,5,1,1,0,0,0,-9,-1,3,2,-1,0,-1,-1,1,-1,-1,2,1
KR_6622160134,420,-5,-94,-20,-5,0,3,3,-2,2,4,1,2,1,0,3,3,-4,0,4,0,-7,8,-6,10,4,-5,0,0,-1,-1,-1,1,2,1
KR_6702398564,420,1,53,-10,-1,-1,0,1,0,4,4,0,2,2,4,4,0,-4,1,5,0,-5,-56,1,6,7,16,0,0,-1,-1,0,-1,4,1
KR_6756530198,420,-1,-23,12,1,1,3,2,-3,3,6,3,5,2,-1,1,2,1,1,0,2,2,-2,-1,4,3,0,0,0,1,-1,0,1,2,1
KR_6766208215,420,2,19,9,-4,1,2,1,-3,2,5,0,0,0,-2,1,3,0,1,1,0,-9,2,-6,9,3,2,0,0,0,-1,0,-1,0,1
KR_6706580355,420,0,48,28,2,2,4,2,4,6,2,2,4,2,-2,4,6,-4,1,5,1,12,-7,-4,7,3,0,0,1,1,1,1,1,6,1
KR_6762879679,420,1,-10,-12,4,-3,1,4,9,10,1,-4,2,6,2,2,0,0,1,1,0,18,22,0,6,6,2,0,0,-1,-1,1,-1,5,1
KR_6674015952,420,-1,-97,-18,-1,0,2,2,-1,2,3,4,5,1,-4,4,8,0,0,0,0,3,-30,2,5,7,2,0,-1,1,-1,-1,1,3,1
KR_6724009867,420,2,48,-7,6,1,3,2,5,7,2,-2,1,3,3,5,2,-1,0,1,0,3,-17,-1,3,2,1,0,2,1,1,1,1,2,1
KR_6679042961,420,1,21,-20,5,0,2,2,-1,6,7,-1,1,2,5,5,0,2,2,0,0,7,8,-3,7,4,3,0,1,1,1,1,1,4,1
KR_6633324485,420,6,98,3,11,6,6,0,0,4,4,-4,0,4,10,11,1,-1,0,1,1,12,19,4,2,6,0,0,2,1,1,1,1,4,1
KR_6743468127,420,1,-8,16,2,0,3,3,5,7,2,0,4,4,-2,1,3,-1,0,1,1,7,9,2,5,7,-1,0,0,1,-1,-1,1,1,1
KR_6749999030,420,-3,9,-7,-5,-5,2,7,-2,2,4,-2,2,4,5,5,0,-1,0,1,0,1,-229,-1,4,3,2,0,-1,1,1,-1,1,1,1
KR_6761601807,420,1,-28,-32,1,2,4,2,0,1,1,-1,4,5,1,4,3,-1,0,1,0,3,-2,2,3,5,5,0,1,-1,1,1,-1,6,1
KR_6757423338,420,0,61,-1,3,1,4,3,0,1,1,4,5,1,-3,1,4,1,4,3,0,1,4,-3,5,2,-2,0,1,1,1,1,1,6,1
KR_6736060759,420,5,35,-10,7,1,2,1,8,9,1,2,3,1,-2,2,4,-2,1,3,0,13,26,-1,7,6,2,0,0,-1,1,1,-1,1,1
KR_6739581101,420,-3,54,20,-3,0,2,2,0,1,1,-2,0,2,-1,1,2,0,0,0,0,-7,27,-6,9,3,0,0,0,1,1,0,1,1,1
KR_6743814707,440,0,-39,4,-5,3,6,3,1,3,2,-3,0,3,-5,0,5,-1,0,1,1,-8,-3,-2,5,3,-1,0,0,-1,1,1,1,5,1
KR_6692678368,420,1,-45,11,-2,3,4,1,1,2,1,-3,1,4,-3,0,3,0,1,1,0,-5,5,0,4,4,-1,0,1,-1,1,-1,1,2,1
KR_6753605304,420,2,2,45,4,-3,0,3,1,4,3,4,6,2,2,7,5,0,2,2,0,2,107,0,5,5,2,0,1,1,1,1,1,2,1
KR_6718080059,420,-3,11,-28,-2,-2,1,3,0,2,2,-1,2,3,2,5,3,-1,0,1,0,5,0,4,3,7,6,0,1,1,1,1,1,1,1
KR_6765148668,420,3,2,15,8,0,0,0,6,7,1,1,4,3,1,2,1,0,2,2,0,13,46,6,1,7,1,0,0,1,1,1,1,1,1
KR_6747031638,420,-3,-24,0,-3,-4,0,4,0,4,4,1,4,3,1,6,5,-1,1,2,0,10,-11,3,6,9,-1,0,1,1,1,1,-1,4,1
KR_6762568865,420,-1,4,-4,-6,4,4,0,-2,1,3,4,5,1,-12,1,13,0,0,0,0,-10,5,-6,7,1,0,0,1,-1,1,1,-1,5,1
KR_6753514364,420,4,61,-4,3,1,4,3,1,1,0,0,1,1,1,2,1,0,0,0,0,2,0,2,5,7,3,0,2,1,1,1,1,4,1
KR_6764499065,420,1,-25,42,-3,-3,1,4,-1,3,4,3,5,2,-4,1,5,2,3,1,0,-11,3,1,4,5,1,0,1,1,1,1,-1,6,1
KR_6763111569,440,1,-6,3,-2,0,2,2,-2,1,3,0,1,1,0,2,2,0,0,0,0,-1,3,-1,4,3,-3,0,0,-1,1,0,1,1,1
KR_6739195085,420,3,70,25,-5,0,1,1,1,3,2,-3,0,3,-2,1,3,-1,1,2,0,-8,107,-4,8,4,1,0,2,1,-1,1,-1,5,1
KR_6759604657,420,6,33,8,13,8,9,1,4,4,0,0,2,2,1,3,2,0,0,0,0,11,18,3,5,8,-3,0,1,1,1,1,1,1,1
KR_6764873807,440,0,-20,33,-3,-3,0,3,-3,0,3,-3,1,4,5,5,0,1,3,2,-1,-5,2,-8,10,2,5,0,2,1,-1,1,-1,1,1
KR_6751843088,420,4,70,8,9,3,5,2,5,5,0,-5,1,6,5,6,1,1,2,1,1,15,4,9,2,11,-5,0,1,1,0,1,1,6,1
KR_6761260156,420,4,13,12,7,1,1,0,0,2,2,0,0,0,4,4,0,2,2,0,1,3,-65,-4,6,2,28,0,-1,-1,-1,-1,1,6,1
KR_6468216926,440,2,13,28,5,-2,3,5,3,5,2,2,5,3,0,5,5,2,5,3,1,2,22,0,3,3,0,0,-1,1,0,-1,1,1,1
KR_6759069272,420,2,37,-12,0,2,3,1,2,3,1,-1,2,3,-3,2,5,0,2,2,0,-2,-2,0,8,8,-3,0,0,-1,1,0,1,1,1
KR_6664854785,420,3,93,-8,2,1,1,0,1,4,3,0,1,1,-1,2,3,1,1,0,0,4,49,-3,7,4,-12,0,2,-1,-1,1,-1,1,1
KR_6751148125,420,3,28,21,-5,2,2,0,1,2,1,-3,1,4,-1,2,3,-4,1,5,0,-4,119,5,4,9,19,0,0,1,1,0,-1,2,1
KR_6617863768,420,-1,44,8,1,-4,1,5,-3,0,3,0,3,3,5,5,0,3,3,0,0,6,-5,-1,6,5,6,0,1,-1,1,1,1,5,1
KR_6665436101,420,0,79,9,-2,3,5,2,0,3,3,1,1,0,-5,2,7,-1,0,1,0,-10,-8,5,6,11,-3,0,-1,-1,1,-1,-1,5,1
KR_6763194498,420,1,88,3,-3,-3,0,3,-1,1,2,-2,3,5,3,4,1,0,1,1,0,-1,10,-1,7,6,1,0,2,-1,1,1,1,1,1
KR_6652383890,420,3,79,14,9,3,3,0,-1,2,3,3,3,0,4,8,4,0,1,1,3,13,5,-5,9,4,3,0,3,1,1,1,1,2,1
KR_6761594548,420,1,40,11,-1,3,4,1,-1,2,3,-1,1,2,-2,3,5,0,0,0,0,-2,16,3,4,7,-4,0,0,0,-1,0,-1,0,1
KR_6676786505,420,1,28,-28,2,0,4,4,0,1,1,0,1,1,1,2,1,1,2,1,0,7,244,0,3,3,5,0,1,1,1,1,-1,6,1
KR_6757372589,420,5,42,8,5,6,7,1,-2,0,2,0,1,1,1,2,1,0,1,1,-1,-7,4,2,3,5,-5,0,1,0,1,1,-1,0,1
KR_6763109428,420,0,55,29,8,3,3,0,2,6,4,1,4,3,3,5,2,-1,0,1,0,7,12,4,3,7,-2,0,2,1,1,1,-1,4,1
KR_6690576640,420,4,16,-12,8,4,4,0,-2,3,5,2,3,1,2,5,3,2,2,0,3,7,0,-3,7,4,4,0,0,1,1,0,1,1,1
KR_6618177182,440,0,31,-19,4,1,2,1,1,3,2,0,1,1,-2,3,5,4,4,0,0,2,4,8,5,13,-6,0,0,1,0,0,1,1,1
KR_6737078093,420,0,51,3,6,-1,3,4,1,4,3,-3,0,3,3,5,2,6,7,1,-1,3,-5,-1,8,7,9,0,1,-1,1,1,-1,2,1
KR_6579003351,420,6,75,25,10,4,4,0,7,7,0,3,5,2,-1,1,2,-3,1,4,0,9,3,2,3,5,0,0,1,1,1,1,1,6,1
KR_6509896684,420,1,-9,-36,14,-2,0,2,7,10,3,4,6,2,7,7,0,-2,1,3,1,16,-3,1,4,5,1,0,1,-1,-1,1,1,1,1
KR_6763631060,440,1,25,-12,4,5,5,0,-3,1,4,0,3,3,6,7,1,-4,1,5,2,-1,-2,1,3,4,-2,0,1,0,1,1,1,0,1
KR_6741056836,420,3,68,8,7,4,5,1,1,2,1,-5,0,5,4,4,0,3,4,1,0,7,2,-4,9,5,-4,0,3,1,-1,1,1,3,1
KR_6606841983,420,5,63,42,8,1,3,2,5,8,3,4,6,2,-1,2,3,-1,0,1,0,-2,-10,3,2,5,0,0,4,1,1,1,1,2,1
KR_6756167441,420,-1,0,-16,-6,-5,0,5,1,2,1,2,2,0,-1,3,4,-3,0,3,1,-3,-1,3,6,9,-1,0,0,-1,-1,0,1,2,1
KR_6753839857,440,-1,-2,26,-6,1,2,1,3,4,1,-4,0,4,-1,4,5,-5,2,7,0,-11,-8,2,5,7,-1,0,0,-1,1,-1,-1,6,1
KR_6764507039,420,-1,33,1,4,0,2,2,-3,0,3,1,2,1,0,1,1,6,6,0,0,3,15,3,3,6,-3,0,0,-1,1,-1,-1,3,1
KR_6766089942,420,0,-3,-28,-3,1,1,0,1,3,2,0,3,3,-3,0,3,-2,0,2,0,-5,-4,-2,6,4,0,0,0,-1,1,-1,-1,5,1
KR_6766492566,420,-1,34,9,-5,2,2,0,1,3,2,-4,0,4,-4,1,5,0,0,0,0,-6,4,0,5,5,3,0,1,1,1,1,-1,5,1
KR_6717475977,440,-1,38,-29,0,0,2,2,-1,2,3,-4,2,6,4,4,0,1,3,2,1,6,-8,-4,5,1,1,0,0,-1,1,1,1,3,1
KR_6765052941,420,4,72,59,14,-1,0,1,7,9,2,0,6,6,8,9,1,0,2,2,2,19,39,7,0,7,2,0,2,1,1,1,1,6,1
KR_6741803190,420,-3,27,-21,-8,-3,1,4,-4,2,6,-3,0,3,2,8,6,0,0,0,0,-13,-104,-2,5,3,-1,0,0,0,-1,0,1,0,1
KR_6761672438,420,0,-34,-3,0,6,6,0,-4,2,6,4,4,0,-7,1,8,1,2,1,0,0,-1,-1,8,7,-5,0,-1,1,-1,-1,-1,3,1
KR_6738878149,420,9,141,72,9,2,2,0,3,5,2,2,2,0,1,2,1,1,1,0,0,11,-2,5,0,5,-2,0,2,1,1,1,-1,2,1
KR_6603316544,420,5,50,17,6,-2,0,2,9,12,3,2,2,0,0,2,2,-3,0,3,0,8,4,-2,7,5,1,0,0,1,-1,1,1,5,1
KR_6751214743,420,0,37,-2,0,5,5,0,2,4,2,-4,2,6,-2,4,6,-1,0,1,0,-8,-5,-4,6,2,6,0,2,-1,1,1,1,3,1
KR_6739940322,420,1,-31,10,1,-2,2,4,1,2,1,0,3,3,1,4,3,1,1,0,0,3,4,-1,3,2,-1,0,0,1,-1,0,1,4,1
KR_6764715222,420,-2,30,28,-4,-1,3,4,-6,0,6,-1,1,2,3,3,0,1,1,0,1,-1,0,-4,5,1,4,0,1,-1,1,-1,1,6,1
KR_6566454135,420,4,-17,33,6,1,3,2,3,5,2,0,3,3,4,5,1,-2,0,2,-1,6,62,3,4,7,1,0,0,1,0,0,-1,3,1
KR_6757401531,420,1,37,6,3,2,3,1,1,4,3,-3,0,3,1,7,6,2,3,1,0,2,3,0,6,6,3,0,1,0,1,1,1,0,1
KR_6729181539,420,2,55,-32,7,4,4,0,5,7,2,-1,1,2,1,2,1,-2,0,2,0,8,6,3,4,7,-2,0,0,1,-1,0,1,3,1
KR_6667250107,420,-3,-41,-4,-7,3,3,0,-3,4,7,1,2,1,-7,0,7,-1,2,3,-3,-15,14,0,5,5,3,0,-1,0,-1,-1,-1,0,1
KR_6688369188,420,2,29,4,2,-1,2,3,4,5,1,0,0,0,-1,0,1,0,0,0,0,0,6,2,6,8,-1,0,1,1,-1,1,-1,5,1
KR_6748140106,420,3,62,-16,8,3,4,1,2,5,3,3,4,1,4,8,4,-4,0,4,0,10,0,3,6,9,5,0,1,1,0,1,1,5,1
KR_6763197646,420,3,17,0,16,-2,0,2,5,6,1,10,11,1,5,6,1,-2,1,3,0,10,11,2,2,4,0,0,3,-1,1,1,1,2,1
KR_6754150507,420,-2,-38,0,-10,2,2,0,-8,2,10,-1,3,4,-3,0,3,0,0,0,0,-13,-6,2,3,5,-4,0,-2,-1,-1,-1,-1,4,1
KR_6708200669,420,2,6,-23,6,1,1,0,2,4,2,5,8,3,0,3,3,-2,1,3,0,4,5,5,4,9,0,0,-1,1,-1,-1,1,2,1
KR_6738413810,420,1,17,3,7,0,3,3,6,6,0,0,3,3,2,3,1,-1,0,1,0,12,6,2,5,7,1,0,0,1,-1,0,-1,4,1
KR_6662508694,420,6,8,-9,14,4,4,0,-1,2,3,8,8,0,1,3,2,2,3,1,0,10,11,4,1,5,1,0,0,0,-1,1,1,0,1
KR_6746776452,420,6,84,37,11,2,3,1,1,3,2,6,6,0,-1,4,5,3,3,0,-1,3,-12,-1,4,3,2,0,3,0,-1,1,-1,0,1
KR_6743899439,420,2,23,35,3,-6,0,6,-1,1,2,2,7,5,3,4,1,5,5,0,1,-4,30,-6,10,4,-14,0,0,-1,-1,0,-1,4,1
KR_6755689265,420,3,40,14,11,0,1,1,3,4,1,2,4,2,7,7,0,-1,0,1,0,15,4,-1,5,4,2,0,0,1,-1,1,1,3,1
KR_6740555584,420,0,-19,5,-5,-2,2,4,1,4,3,0,1,1,-5,2,7,1,1,0,0,-2,7,0,7,7,0,0,-3,1,-1,-1,-1,2,1
KR_6737491629,420,2,21,39,9,-1,3,4,3,3,0,0,1,1,5,6,1,2,2,0,0,13,-3,-2,9,7,1,0,1,-1,1,1,1,6,1
KR_6663619825,420,0,-24,-8,-3,4,4,0,0,1,1,1,4,3,-9,0,9,1,2,1,0,-4,1,-2,10,8,-2,0,-1,-1,1,-1,-1,1,1
KR_6750247826,420,7,67,30,12,6,6,0,6,7,1,1,3,2,1,3,2,-2,0,2,0,9,4,4,4,8,2,0,-1,1,-1,1,1,1,1
KR_6681595451,420,3,73,16,7,1,2,1,2,3,1,-2,1,3,7,10,3,-1,0,1,0,16,-316,-7,9,2,6,0,1,1,1,1,-1,1,1
KR_6596840340,420,0,36,12,-5,-1,1,2,1,3,2,-4,2,6,-1,4,5,0,0,0,0,-3,0,2,4,6,-1,0,0,-1,1,0,-1,5,1
KR_6525920709,420,1,-13,-3,12,5,6,1,-3,3,6,5,6,1,0,5,5,5,6,1,-2,11,-14,-1,5,4,2,0,2,1,1,1,-1,1,1
KR_6612172229,420,0,42,-12,-2,-1,4,5,-2,1,3,0,2,2,1,2,1,0,0,0,0,3,5,4,4,8,-1,0,1,1,1,1,1,6,1
KR_6597294321,420,1,9,-23,-5,1,3,2,-8,1,9,3,5,2,-2,1,3,1,2,1,-3,-10,332,-3,7,4,6,0,0,1,-1,1,-1,4,1
KR_6755354991,420,0,25,23,1,-3,0,3,0,2,2,-3,0,3,0,2,2,7,7,0,0,8,-6,0,6,6,1,0,1,1,-1,1,1,6,1
KR_6688659506,420,3,62,19,9,0,2,2,5,6,1,0,2,2,4,6,2,0,1,1,1,9,0,1,2,3,3,0,1,0,0,1,1,0,1
KR_6766352592,440,1,87,18,-1,5,5,0,0,3,3,1,1,0,0,2,2,-7,0,7,0,-14,6,3,2,5,0,0,0,-1,1,1,1,3,1
KR_6632397936,420,6,78,8,16,1,3,2,3,3,0,8,8,0,1,3,2,3,3,0,1,16,2,-1,6,5,-3,2,5,1,1,1,1,2,1
KR_6755501937,420,0,-48,10,1,4,4,0,3,3,0,-2,4,6,-3,2,5,-1,0,1,-1,-3,3,1,6,7,-3,0,0,-1,1,-1,-1,2,1
KR_6749876570,420,4,11,36,8,1,3,2,3,3,0,5,5,0,-1,4,5,0,1,1,0,11,-40,0,3,3,15,0,-1,-1,1,-1,-1,2,1
KR_6658313599,420,4,96,27,6,1,3,2,-2,0,2,2,3,1,6,7,1,-1,0,1,1,7,12,-2,6,4,-3,0,1,1,1,1,1,2,1
KR_6759851724,440,5,103,20,13,0,4,4,0,4,4,7,8,1,4,5,1,2,2,0,0,5,1,0,6,6,5,0,2,1,-1,1,1,1,1
KR_6712280791,420,1,-4,-16,3,0,2,2,3,3,0,4,5,1,-5,1,6,1,2,1,0,-2,8,0,7,7,0,0,-1,1,1,-1,-1,6,1
KR_6732318954,440,2,171,23,7,0,2,2,0,2,2,3,4,1,5,5,0,-1,2,3,0,0,5,2,2,4,0,0,2,1,1,1,1,1,1
KR_6732318034,440,2,9,-24,6,-1,0,1,1,3,2,0,2,2,6,9,3,0,0,0,0,5,3,-2,4,2,-2,0,0,1,-1,-1,1,3,1
KR_6757078733,420,4,7,17,15,5,5,0,1,1,0,7,9,2,2,2,0,0,0,0,0,16,4,4,1,5,1,0,3,1,-1,1,1,3,1
KR_6763621138,440,2,-33,-11,-4,-2,0,2,-3,0,3,0,2,2,1,1,0,0,7,7,0,-13,-1,-2,2,0,-4,0,0,-1,1,-1,-1,3,1
KR_6737933637,420,4,-1,8,9,-2,0,2,9,10,1,3,4,1,-2,1,3,1,1,0,0,20,134,3,5,8,-6,0,2,-1,1,1,1,2,1
KR_6735194076,420,1,18,8,0,-5,0,5,5,6,1,-3,0,3,3,6,3,0,0,0,0,5,31,3,4,7,-4,0,-1,1,-1,-1,1,5,1
KR_6702330681,420,-1,-7,15,-2,4,4,0,-2,3,5,0,0,0,-4,1,5,0,0,0,0,-9,-3,-1,7,6,1,0,0,1,1,1,-1,6,1
KR_6701918626,420,5,31,14,8,3,4,1,-1,1,2,1,5,4,4,4,0,1,4,3,-1,6,92,5,1,6,-3,0,3,1,1,1,-1,6,1
KR_6737134167,420,4,-14,15,4,-3,1,4,5,6,1,1,1,0,5,7,2,-4,2,6,0,7,-5,-3,7,4,1,0,-1,-1,-1,-1,-1,1,1
KR_6763168801,420,3,51,23,6,5,6,1,-1,3,4,2,2,0,-2,2,4,2,4,2,0,0,2,1,3,4,13,0,2,1,1,1,1,1,1
KR_6431133669,420,2,31,-7,6,5,5,0,-2,4,6,4,6,2,1,2,1,-2,0,2,0,1,4,6,2,8,-6,0,2,1,1,1,1,2,1
KR_6765855340,420,0,3,-2,3,0,0,0,0,0,0,-1,2,3,4,4,0,0,0,0,0,6,0,-4,10,6,1,0,0,1,0,0,-1,4,1
KR_6760696293,420,-1,-84,12,3,-1,1,2,4,5,1,1,4,3,-2,2,4,1,5,4,0,9,-6,-3,7,4,-2,0,0,1,-1,-1,1,2,1
KR_6763919132,420,0,22,-8,0,2,2,0,1,3,2,-2,1,3,1,1,0,-2,1,3,0,-1,6,4,5,9,-5,0,1,-1,1,1,-1,6,1
KR_6758449647,420,0,-16,9,2,2,5,3,2,3,1,-3,2,5,0,4,4,1,3,2,4,8,8,-1,4,3,0,0,0,-1,1,-1,1,4,1
KR_6756660519,420,-1,22,17,-4,2,2,0,1,3,2,-7,0,7,0,2,2,0,0,0,0,-8,19,-2,6,4,4,0,0,1,1,-1,1,6,1
KR_6731906543,420,6,34,32,11,2,3,1,7,8,1,0,3,3,2,2,0,0,0,0,-1,4,15,-1,5,4,-3,0,3,1,1,1,-1,3,1
KR_6720456034,420,2,17,-25,3,6,6,0,-3,0,3,-1,1,2,-1,0,1,2,2,0,0,-3,-9,1,5,6,-2,0,2,1,-1,1,1,3,1
KR_6760126554,420,1,-6,-7,-2,1,1,0,0,4,4,-4,1,5,1,1,0,0,3,3,0,4,113,4,4,8,-1,0,0,1,-1,0,-1,3,1
KR_6505701005,420,-4,-82,-1,-4,-3,0,3,1,5,4,0,3,3,-2,2,4,0,0,0,0,-7,4,-3,7,4,-3,0,-2,1,-1,-1,-1,1,1
KR_6747335518,420,-2,23,-8,-6,1,3,2,-9,0,9,3,6,3,-1,1,2,0,0,0,-1,-11,-6,-4,8,4,7,0,-1,-1,1,-1,-1,3,1
KR_6763575601,420,1,-27,-13,9,-2,0,2,0,2,2,1,1,0,2,3,1,8,8,0,0,9,3,8,2,10,0,0,0,1,1,0,1,3,1
KR_6754177100,420,-2,6,-19,-3,1,1,0,-1,3,4,0,0,0,-1,0,1,-2,0,2,0,-3,3,0,4,4,2,0,-1,-1,1,-1,1,2,1
KR_6697841958,420,3,40,44,2,2,3,1,3,6,3,-2,2,4,0,4,4,-1,1,2,0,4,-3,1,5,6,0,0,0,1,1,1,-1,2,1
KR_6759160216,420,3,11,24,4,3,4,1,4,5,1,0,1,1,-3,0,3,0,0,0,0,-1,46,3,2,5,-28,0,1,1,-1,1,-1,5,1
KR_6743231202,440,4,19,52,9,3,3,0,-2,3,5,3,6,3,4,5,1,1,1,0,0,16,5,-2,4,2,5,0,1,1,1,1,1,6,1
KR_6760346223,420,0,25,2,-2,-3,2,5,-2,4,6,0,3,3,4,5,1,-1,1,2,0,7,1,-1,7,6,1,0,1,1,-1,1,1,3,1
KR_6764181994,420,3,81,16,10,0,2,2,0,3,3,6,6,0,4,5,1,0,1,1,2,9,0,3,4,7,1,0,0,-1,-1,1,1,6,1
KR_6751455778,420,2,46,-1,2,0,1,1,1,4,3,1,4,3,1,3,2,-1,0,1,0,4,-352,2,5,7,-3,0,0,1,-1,0,-1,2,1
KR_6753098135,420,2,50,3,3,5,7,2,-2,0,2,1,5,4,-3,1,4,2,2,0,-1,-4,175,-1,3,2,1,0,1,-1,1,1,-1,2,1
KR_6747481403,420,-1,50,-20,7,-1,1,2,4,5,1,2,3,1,5,6,1,-3,0,3,2,17,10,6,3,9,0,0,1,1,1,1,1,4,1
KR_6735397682,440,-3,-2,9,0,-2,0,2,0,5,5,0,3,3,1,2,1,1,3,2,0,1,3,2,3,5,-1,0,0,1,-1,-1,1,4,1
KR_6712120599,420,1,58,16,2,2,2,0,-2,2,4,2,2,0,-2,3,5,2,2,0,0,-2,-8,-1,6,5,3,0,1,1,0,1,1,1,1
KR_6765479821,420,0,-11,-12,2,-1,0,1,3,7,4,2,3,1,1,2,1,-3,0,3,0,3,-13,-5,9,4,-1,0,0,1,-1,-1,1,4,1
KR_6759145392,420,4,72,-7,16,2,5,3,7,7,0,3,3,0,7,8,1,-3,1,4,-1,15,3,4,2,6,-1,0,1,0,1,1,-1,0,1
KR_6765074858,420,3,7,26,3,4,4,0,2,2,0,1,2,1,-5,2,7,1,1,0,0,-1,1,0,4,4,-2,0,1,-1,1,1,1,1,1
KR_6763663342,420,2,50,23,5,0,2,2,-3,0,3,6,8,2,1,2,1,1,1,0,0,6,8,2,5,7,4,0,0,-1,-1,1,-1,4,1
KR_6653391298,420,2,35,12,3,2,2,0,1,2,1,0,4,4,-2,3,5,2,2,0,0,-3,24,0,8,8,1,0,1,-1,1,1,1,6,1
KR_6575797361,420,6,-10,24,10,1,3,2,4,6,2,5,5,0,0,2,2,0,0,0,0,7,2,4,4,8,2,0,1,1,1,1,1,2,1
KR_6764946812,420,-3,-13,-24,-9,-3,3,6,-1,1,2,-1,1,2,-2,1,3,-2,2,4,1,-5,-4,-4,7,3,0,0,-2,-1,-1,-1,1,6,1
KR_6642093236,420,0,16,-36,2,3,6,3,2,4,2,-5,0,5,3,3,0,-1,1,2,0,5,14,3,2,5,-2,0,0,1,-1,0,1,2,1
KR_6756536794,420,3,-15,25,4,-2,0,2,0,1,1,1,3,2,2,6,4,3,3,0,0,6,3,1,7,8,0,0,0,-1,1,1,1,3,1
KR_6740703828,420,-1,-12,-12,3,0,3,3,-2,1,3,-3,0,3,8,8,0,0,4,4,0,5,1,0,6,6,-2,0,0,1,-1,0,1,1,1
KR_6696788828,420,-3,4,-4,-7,-2,1,3,-2,2,4,0,1,1,0,0,0,-3,0,3,0,-9,5,2,2,4,-1,0,-1,-1,-1,-1,-1,6,1
KR_6762540836,420,3,79,8,4,1,3,2,-1,0,1,4,4,0,0,1,1,0,1,1,0,2,-10,-1,3,2,8,0,0,1,-1,0,-1,2,1
KR_6763987661,420,2,33,-9,6,1,2,1,-1,1,2,-1,0,1,5,6,1,2,3,1,0,10,3,4,5,9,-2,0,0,0,-1,-1,1,0,1
KR_6716846015,420,1,-10,-15,1,2,3,1,5,6,1,1,2,1,-6,0,6,-1,1,2,0,4,-3,-4,6,2,1,0,1,-1,1,1,1,1,1
KR_6658268984,420,4,32,28,11,-1,2,3,4,5,1,-2,1,3,8,10,2,2,3,1,0,14,-3,2,3,5,0,0,3,1,1,1,1,6,1
KR_6761075749,420,-3,23,-27,-5,-4,1,5,0,1,1,0,0,0,-2,3,5,1,2,1,0,-7,-22,5,3,8,2,0,0,1,1,1,-1,3,1
KR_6717889039,420,-2,-18,16,-3,-4,3,7,4,8,4,0,1,1,-1,1,2,-2,0,2,0,2,23,-1,5,4,-1,0,-2,1,-1,-1,-1,4,1
KR_6759079595,440,1,6,3,3,3,3,0,-1,2,3,-2,2,4,2,6,4,1,1,0,-1,1,24,-3,4,1,0,0,3,-1,1,1,1,5,1
KR_6697814068,420,2,72,0,5,1,3,2,6,6,0,-1,1,2,0,1,1,-1,1,2,0,3,269,3,3,6,1,0,1,1,1,1,1,3,1
KR_6750893529,420,3,45,23,5,1,3,2,0,3,3,2,3,1,2,5,3,0,1,1,1,6,-35,-11,13,2,6,0,2,-1,1,1,-1,2,1
KR_6758327795,420,1,15,24,-3,0,1,1,1,5,4,-1,3,4,-1,0,1,-2,0,2,0,0,2,0,6,6,-1,0,0,1,1,1,1,1,1
KR_6762171358,420,1,2,4,3,-2,0,2,6,7,1,2,2,0,-1,2,3,-2,3,5,0,4,29,-2,6,4,7,0,1,1,1,1,1,5,1
KR_6759977370,420,0,-3,-4,4,4,4,0,4,5,1,0,1,1,-2,1,3,-2,0,2,0,7,4,-2,5,3,-4,0,0,1,1,1,1,1,1
KR_6750107458,420,5,100,1,11,1,2,1,3,4,1,2,4,2,6,8,2,-1,0,1,0,1,4,-4,7,3,2,0,3,1,1,1,1,5,1
KR_6507242070,420,0,22,-5,5,1,1,0,2,2,0,-1,0,1,2,3,1,1,1,0,0,9,0,-1,6,5,5,0,1,1,-1,1,1,5,1
KR_6648849130,420,2,70,5,6,0,0,0,1,8,7,2,2,0,-2,1,3,5,5,0,0,12,210,0,6,6,7,0,3,1,1,1,1,6,1
KR_6716848957,420,-1,-18,0,4,1,3,2,0,5,5,2,4,2,2,2,0,-1,2,3,0,6,-6,-4,8,4,1,0,-1,1,-1,-1,1,1,1
KR_6566407752,420,7,80,20,5,7,7,0,-2,2,4,1,1,0,-1,1,2,0,1,1,0,-3,49,2,6,8,-2,0,4,1,1,1,-1,1,1
KR_6671089493,420,1,-5,16,5,-1,1,2,4,4,0,2,3,1,2,4,2,-2,0,2,1,7,21,0,4,4,2,0,2,0,-1,1,1,0,1
KR_6619869807,420,0,12,8,-4,-1,2,3,2,4,2,-3,1,4,-2,1,3,0,1,1,0,-6,99,4,3,7,-2,0,0,-1,-1,0,1,1,1
KR_6709662128,420,-3,-52,21,1,-1,1,2,1,4,3,7,7,0,-3,0,3,-3,0,3,0,-1,-3,-1,4,3,-3,0,0,-1,-1,0,1,6,1
KR_6597987228,420,7,98,2,16,2,2,0,5,6,1,-1,0,1,7,7,0,3,3,0,0,12,-2,3,1,4,0,0,3,1,1,1,1,1,1
KR_6651010035,420,-3,-26,8,-7,-5,1,6,2,5,3,-1,0,1,-1,3,4,-2,1,3,0,-12,45,-3,6,3,-12,0,1,1,1,1,-1,3,1
KR_6754401239,440,2,-13,5,12,2,4,2,2,4,2,0,0,0,1,2,1,7,10,3,0,12,4,0,9,9,1,0,0,1,1,0,1,4,1
KR_6729195897,420,4,73,-31,9,0,1,1,-2,2,4,2,3,1,8,8,0,1,2,1,0,7,30,-2,5,3,1,0,1,1,1,1,1,6,1
KR_6753059986,420,1,49,-4,5,-1,2,3,0,0,0,0,4,4,3,3,0,3,3,0,1,13,128,3,1,4,-1,0,1,1,1,1,1,5,1
KR_6622238993,420,-1,33,15,2,-1,0,1,-1,2,3,1,2,1,3,4,1,0,0,0,1,8,-4,-2,6,4,5,0,2,1,1,1,1,4,1
KR_6750809760,420,6,16,11,12,5,5,0,5,5,0,5,5,0,-4,2,6,1,6,5,0,13,23,-1,5,4,-1,0,0,1,1,1,1,4,1
KR_6733068921,420,2,25,24,1,4,5,1,-4,0,4,3,5,2,-2,4,6,0,1,1,0,-4,-2,-1,7,6,3,0,0,1,-1,1,1,2,1
KR_6730455800,420,2,48,14,1,0,3,3,1,3,2,1,1,0,0,2,2,-1,1,2,-1,-2,-2,-3,7,4,4,0,1,1,1,1,-1,2,1
KR_6759078737,420,-1,35,-7,-2,1,1,0,-4,1,5,-4,0,4,2,3,1,3,3,0,0,-2,0,2,6,8,3,0,0,1,1,0,1,1,1
KR_6765406992,420,2,-18,3,-1,-3,0,3,-2,4,6,0,2,2,2,4,2,2,3,1,0,2,-7,-9,11,2,3,0,-1,1,-1,-1,-1,3,1
KR_6720303169,420,2,-13,43,2,1,3,2,1,4,3,0,4,4,-2,2,4,2,2,0,0,1,1,-1,10,9,2,0,0,1,1,1,1,1,1
KR_6760446422,420,3,18,4,7,3,5,2,-1,1,2,1,3,2,3,3,0,1,2,1,0,6,-3,-2,5,3,2,0,0,0,0,0,-1,0,1
KR_6752168272,420,-1,-29,-2,-3,1,3,2,-1,2,3,-2,1,3,0,1,1,-1,0,1,-1,-7,-68,-2,8,6,36,0,0,-1,1,0,-1,6,1
KR_6684145104,420,3,71,8,8,1,2,1,1,4,3,-1,1,2,5,5,0,2,2,0,0,12,24,6,2,8,4,0,1,1,1,1,1,4,1
KR_6753723546,420,1,4,11,3,1,2,1,1,3,2,1,2,1,1,4,3,-1,0,1,1,3,-3,-4,10,6,-2,0,1,-1,-1,1,1,5,1
KR_6684021863,420,2,-9,8,8,-1,0,1,3,3,0,1,3,2,0,2,2,5,5,0,0,11,-26,4,1,5,4,0,0,1,-1,1,1,6,1
KR_6764722999,420,2,40,-39,8,0,0,0,-1,4,5,6,7,1,2,4,2,1,1,0,-2,15,-45,-9,13,4,6,0,1,1,-1,-1,-1,4,1
KR_6761459253,440,2,67,-12,1,3,5,2,-1,3,4,3,3,0,-6,1,7,2,2,0,-1,-7,-2,0,9,9,-2,0,1,-1,-1,1,-1,4,1
KR_6646839844,420,2,24,22,4,1,2,1,-1,3,4,1,4,3,3,4,1,0,2,2,0,0,4,2,4,6,2,0,0,1,0,0,-1,6,1
KR_6765089471,420,3,53,3,8,4,4,0,2,6,4,-1,3,4,2,3,1,1,4,3,0,8,-1,1,4,5,-5,0,1,0,1,1,1,0,1
KR_6764016196,420,1,-4,-16,3,-3,2,5,1,2,1,-4,1,5,8,8,0,1,4,3,0,8,1,3,5,8,-2,0,-1,-1,-1,-1,1,3,1
KR_6558687896,420,2,93,-24,8,2,3,1,5,6,1,1,1,0,2,5,3,-2,0,2,1,10,321,1,4,5,2,0,0,1,1,0,1,6,1
KR_6740691463,420,1,46,-8,6,0,0,0,0,2,2,1,2,1,4,6,2,1,1,0,0,10,-157,-3,7,4,4,0,0,1,1,0,1,5,1
KR_6746628299,440,7,134,9,12,8,11,3,1,1,0,1,5,4,2,4,2,0,1,1,0,3,-20,2,1,3,5,0,2,1,1,1,-1,2,1
KR_6751099505,420,-1,27,19,-5,2,3,1,1,2,1,-2,1,3,-2,0,2,-4,0,4,1,-2,-36,-3,7,4,1,0,0,-1,1,-1,1,5,1
KR_6747302612,440,4,28,28,5,0,0,0,4,5,1,5,6,1,-4,0,4,0,1,1,0,2,-30,-4,7,3,-2,0,1,1,-1,1,1,3,1
KR_6752590699,420,1,-1,4,0,-1,1,2,3,3,0,-2,2,4,-1,1,2,1,1,0,0,-2,-6,0,6,6,6,0,-1,-1,1,-1,1,2,1
KR_6633440110,420,0,-20,-24,3,-3,1,4,0,2,2,5,6,1,1,3,2,0,2,2,0,5,126,4,4,8,0,0,0,-1,1,1,1,5,1
KR_6710589791,420,0,-14,-5,0,1,1,0,0,2,2,-6,1,7,3,7,4,2,2,0,0,5,1,4,3,7,-5,0,0,1,-1,1,-1,3,1
KR_6743321144,420,6,57,-9,20,2,4,2,2,4,2,5,8,3,7,7,0,4,4,0,1,28,136,2,3,5,-1,0,3,1,1,1,1,2,1
KR_6744364926,420,2,-24,52,-1,1,5,4,1,3,2,-2,2,4,-2,1,3,1,2,1,0,3,-6,-4,9,5,-1,0,1,-1,1,-1,1,3,1
KR_6733060528,420,6,75,16,8,3,5,2,0,2,2,1,2,1,4,4,0,0,0,0,1,14,4,2,6,8,0,0,1,1,1,1,1,3,1
KR_6760214307,420,1,-19,-16,-3,-3,4,7,0,3,3,0,2,2,-2,3,5,2,2,0,-1,2,-120,-4,7,3,7,0,-1,1,-1,-1,-1,6,1
KR_6681512377,420,-1,21,-23,7,-1,2,3,0,2,2,3,5,2,2,3,1,3,3,0,0,4,1,6,3,9,-2,0,0,1,-1,0,1,1,1
KR_6762909248,420,1,-35,15,5,1,3,2,0,1,1,2,5,3,2,4,2,0,1,1,0,7,27,-1,7,6,-3,0,2,1,1,1,-1,5,1
KR_6752128773,420,1,40,-30,9,-4,0,4,1,1,0,1,4,3,8,8,0,3,4,1,0,10,148,-1,6,5,-6,0,1,1,1,1,1,1,1
KR_6597348569,420,6,64,17,9,-3,0,3,7,7,0,1,1,0,4,5,1,0,0,0,0,18,-13,-5,8,3,0,0,0,1,-1,1,-1,1,1
KR_6760197496,420,2,-28,27,-3,5,6,1,-3,2,5,-1,0,1,-5,0,5,1,1,0,0,-11,-10,-7,13,6,6,0,0,1,1,0,1,1,1
KR_6756435184,420,3,100,-39,8,4,5,1,-2,0,2,3,4,1,3,3,0,0,0,0,0,6,-29,-1,5,4,4,0,1,-1,1,1,1,3,1
KR_6755048874,420,1,-3,-22,1,-3,2,5,-1,1,2,3,4,1,0,5,5,2,2,0,0,6,-16,1,4,5,4,0,0,1,-1,-1,-1,3,1
KR_6752249049,420,2,32,12,4,0,0,0,1,3,2,5,6,1,-2,3,5,0,1,1,0,2,82,-2,6,4,20,0,0,0,1,0,-1,0,1
KR_6738253624,420,2,39,-3,3,-1,2,3,3,3,0,2,5,3,-1,0,1,0,0,0,0,6,-1,5,3,8,4,0,2,1,1,1,1,5,1
KR_6762376410,440,4,78,18,7,3,3,0,4,4,0,2,4,2,-1,2,3,-1,0,1,0,4,1,2,1,3,0,0,2,1,1,1,1,3,1
KR_6754405777,420,4,80,-23,5,7,7,0,-4,0,4,4,4,0,-1,2,3,-1,1,2,0,2,-1,1,6,7,0,0,1,1,-1,1,-1,5,1
KR_6686735390,420,-1,-22,-48,2,3,5,2,1,4,3,0,3,3,-1,0,1,-1,0,1,0,0,231,3,5,8,-1,0,1,-1,1,1,1,5,1
KR_6752224844,420,2,40,20,4,4,7,3,-2,0,2,-1,3,4,-1,4,5,4,4,0,0,-5,-1,-1,3,2,2,0,1,1,0,1,1,2,1
KR_6725502966,420,6,34,21,11,0,3,3,4,5,1,3,5,2,3,4,1,1,1,0,1,6,3,2,4,6,2,0,2,1,-1,1,1,5,1
KR_6749087428,420,3,32,3,10,0,1,1,3,5,2,8,9,1,-2,4,6,1,2,1,1,7,-303,8,2,10,1,0,1,1,1,1,1,3,1
KR_6705645141,420,-1,-20,4,2,-4,1,5,4,5,1,-4,2,6,3,5,2,3,3,0,0,7,47,3,2,5,-5,0,0,1,-1,0,-1,3,1
KR_6762580952,440,-1,-23,7,0,-5,0,5,-3,0,3,4,5,1,2,4,2,2,4,2,-1,1,31,-2,7,5,6,0,2,1,1,1,-1,3,1
KR_6741953350,420,-1,13,-1,-3,-4,3,7,2,6,4,1,3,2,-1,3,4,-1,0,1,0,-4,105,-4,7,3,-1,0,1,1,-1,-1,1,5,1
KR_6597903988,420,4,-37,22,10,0,1,1,7,8,1,3,3,0,1,3,2,-1,2,3,0,11,-17,2,4,6,-1,0,1,1,1,1,1,5,1
KR_6740597469,420,5,0,28,5,1,4,3,5,5,0,-2,2,4,0,1,1,1,1,0,0,9,-84,-2,7,5,4,0,1,-1,-1,1,-1,6,1
KR_6684771154,420,0,-35,26,-2,-2,2,4,-2,1,3,3,6,3,-1,3,4,0,0,0,0,-1,12,2,5,7,-4,0,0,1,1,1,1,2,1
KR_6765517240,420,2,17,12,7,2,2,0,1,4,3,0,1,1,0,0,0,4,5,1,0,11,-342,-2,4,2,3,0,0,-1,-1,0,1,5,1
KR_6729108319,420,-1,-62,14,-1,-6,0,6,2,3,1,1,3,2,1,1,0,1,1,0,0,1,1,-7,9,2,0,0,-2,1,-1,-1,1,6,1
KR_6765148810,420,0,-1,-3,1,2,3,1,-3,2,5,1,2,1,0,5,5,1,2,1,-1,1,14,0,8,8,0,0,1,-1,1,1,-1,6,1
KR_6753554508,420,3,66,-16,4,0,1,1,-1,2,3,-1,0,1,5,5,0,1,2,1,0,2,7,3,1,4,2,0,0,-1,-1,0,1,3,1
KR_6720087373,420,1,41,20,4,-1,4,5,0,2,2,5,6,1,2,4,2,-2,0,2,0,1,-25,-5,8,3,3,0,2,1,1,1,-1,4,1
KR_6762487782,440,7,104,24,13,5,5,0,0,2,2,4,4,0,-2,6,8,6,7,1,0,7,4,1,2,3,-3,0,2,1,1,1,1,5,1
KR_6670843679,420,-4,-43,-36,-2,-6,0,6,-1,0,1,8,10,2,0,3,3,-3,1,4,0,4,-24,-2,9,7,2,0,-3,-1,-1,-1,1,2,1
KR_6759392938,420,3,50,15,10,-3,0,3,0,1,1,0,4,4,11,11,0,2,3,1,0,9,14,6,2,8,-1,0,2,1,0,1,1,3,1
KR_6731567896,420,1,26,12,2,0,1,1,-1,0,1,2,5,3,1,3,2,0,0,0,0,13,9,1,4,5,-4,0,1,1,-1,1,-1,5,1
KR_6707577061,420,3,0,4,5,2,4,2,-2,7,9,2,3,1,3,6,3,0,1,1,1,6,-19,2,4,6,-13,0,1,1,1,1,1,4,1
KR_6752251146,420,1,21,-12,6,0,2,2,0,2,2,-1,3,4,4,5,1,3,5,2,0,9,-4,-3,6,3,4,0,0,1,-1,0,1,1,1
KR_6729253420,420,5,12,24,13,3,4,1,0,0,0,3,5,2,7,9,2,0,0,0,0,12,2,-2,7,5,2,0,1,1,1,1,-1,3,1
KR_6762523711,420,3,44,16,6,-2,1,3,4,5,1,2,3,1,3,3,0,-1,0,1,0,8,4,-3,6,3,-2,0,3,1,1,1,1,3,1
KR_6764892667,440,-4,-49,-2,-10,-1,0,1,0,4,4,-3,2,5,-2,2,4,-4,0,4,0,-5,15,2,3,5,2,0,1,-1,-1,-1,-1,1,1
KR_6747530578,420,3,35,-8,4,1,2,1,0,3,3,5,6,1,-1,5,6,-1,2,3,1,7,-6,5,6,11,4,0,1,1,0,-1,1,2,1
KR_6735959114,420,5,6,20,9,2,2,0,0,2,2,0,3,3,3,5,2,4,5,1,0,12,0,-3,7,4,3,0,1,1,0,1,-1,1,1
KR_6705895742,420,4,83,32,10,-2,0,2,2,6,4,2,2,0,6,9,3,2,3,1,0,4,7,-2,5,3,3,0,0,1,-1,-1,1,2,1
KR_6759732178,420,3,30,4,5,1,1,0,-1,1,2,-2,0,2,3,4,1,4,5,1,0,3,4,-4,9,5,0,0,0,1,-1,0,-1,4,1
KR_6738327338,420,3,56,7,0,1,1,0,0,5,5,2,2,0,-3,0,3,0,1,1,0,-2,13,5,4,9,-6,0,0,0,1,0,-1,0,1
KR_6760163908,440,2,-6,-4,6,-2,0,2,2,4,2,2,2,0,1,4,3,3,6,3,0,6,-46,-3,7,4,30,0,-1,-1,1,-1,1,4,1
KR_6681142456,420,6,68,7,18,5,6,1,2,7,5,5,5,0,5,6,1,1,1,0,-1,15,-8,3,2,5,0,0,2,-1,1,1,-1,5,1
KR_6706837616,420,-3,-42,-21,1,0,4,4,-1,2,3,4,4,0,-2,2,4,0,1,1,0,-1,-5,1,5,6,1,0,0,-1,-1,-1,1,3,1
KR_6759035361,420,-1,14,1,-5,-5,0,5,-1,1,2,4,4,0,-4,2,6,1,1,0,0,1,24,1,3,4,-3,0,1,0,1,1,-1,0,1
KR_6701120859,420,0,62,-20,5,4,4,0,-1,2,3,0,2,2,-1,1,2,3,3,0,0,3,118,1,5,6,1,0,3,1,1,1,1,5,1
KR_6717472741,420,1,33,-8,7,0,0,0,2,5,3,-1,3,4,5,6,1,1,2,1,0,11,50,-3,8,5,4,0,-1,1,1,-1,1,3,1
KR_6708297061,420,7,159,4,7,-4,0,4,0,1,1,5,5,0,1,1,0,5,5,0,0,11,-209,5,0,5,-4,0,1,1,1,1,-1,6,1
KR_6763450359,420,1,-3,9,-1,-4,0,4,-1,0,1,3,4,1,6,8,2,-5,2,7,0,0,3,3,6,9,-3,0,0,1,1,0,-1,5,1
KR_6759722552,440,-1,-8,-11,0,-3,1,4,-3,1,4,4,6,2,3,4,1,-1,0,1,0,-6,-1,1,2,3,0,0,-1,1,-1,-1,1,1,1
KR_6751031201,420,1,-34,-20,5,0,1,1,1,2,1,1,2,1,3,3,0,0,0,0,0,6,8,4,4,8,-2,0,0,1,1,0,1,1,1
KR_6699330764,420,0,-32,16,-3,0,1,1,2,2,0,-4,3,7,1,2,1,-2,0,2,0,0,20,2,2,4,0,0,0,1,1,1,1,2,1
KR_6747370648,420,0,42,-9,5,1,2,1,0,3,3,4,5,1,-1,0,1,1,2,1,0,4,-5,1,6,7,2,0,1,1,1,1,1,5,1
KR_6696325412,420,0,-33,7,-3,0,4,4,3,6,3,-4,0,4,-1,3,4,-1,2,3,0,-6,8,4,3,7,-6,0,0,0,0,0,-1,0,1
KR_6688299536,440,0,0,4,3,-1,1,2,0,3,3,4,6,2,1,3,2,-1,1,2,0,3,4,-2,6,4,0,0,-1,-1,-1,-1,-1,6,1
KR_6757635454,420,4,-26,10,9,1,3,2,7,7,0,-1,3,4,-1,2,3,3,3,0,0,6,-13,-5,10,5,3,0,0,1,-1,-1,1,5,1
KR_6678803688,420,-2,-41,-5,-2,-1,2,3,0,2,2,-3,0,3,2,4,2,0,0,0,0,7,-18,0,6,6,0,0,0,1,-1,-1,1,5,1
KR_6748972018,420,4,68,-1,9,4,6,2,2,3,1,0,1,1,2,2,0,1,1,0,0,10,4,7,2,9,4,0,2,1,0,1,1,6,1
KR_6651098309,420,2,39,-11,7,2,4,2,-2,3,5,7,8,1,0,3,3,0,2,2,0,0,7,3,4,7,-2,0,1,1,1,1,1,6,1
KR_6741219303,420,4,50,3,13,4,4,0,3,5,2,-3,1,4,9,11,2,0,0,0,0,16,-5,1,7,8,-1,0,0,1,1,1,1,6,1
KR_6750618649,420,3,43,-8,5,2,2,0,1,5,4,-3,2,5,6,6,0,-1,0,1,0,8,-2,-1,7,6,4,0,2,0,-1,1,1,0,1
KR_6762892967,420,1,-12,-10,4,3,3,0,-2,3,5,0,1,1,2,2,0,1,2,1,0,4,2,1,6,7,5,0,-1,1,1,-1,1,6,1
KR_6753279437,420,2,9,21,5,1,1,0,5,5,0,-5,4,9,3,4,1,1,2,1,0,4,-4,-4,6,2,0,0,0,0,-1,1,-1,0,1
KR_6677793163,420,1,14,-20,7,0,1,1,1,4,3,2,4,2,2,3,1,2,2,0,0,7,1,2,5,7,-5,0,3,-1,1,1,1,1,1
KR_6750449572,420,2,6,-11,10,2,4,2,3,4,1,-1,2,3,4,6,2,2,3,1,0,14,27,3,5,8,0,0,0,1,1,0,-1,6,1
KR_6759905718,420,-2,-49,-24,-8,2,4,2,-4,1,5,1,2,1,-4,0,4,-3,0,3,0,-11,-3,0,5,5,-3,0,0,-1,1,1,-1,1,1
KR_6760725233,440,2,-26,1,6,1,7,6,-4,0,4,5,8,3,0,1,1,4,5,1,0,1,7,4,1,5,0,0,0,1,0,0,-1,3,1
KR_6678652029,420,3,-7,-17,11,1,3,2,6,7,1,2,2,0,2,3,1,0,1,1,0,16,0,1,8,9,3,0,1,1,1,1,-1,4,1
KR_6696885308,420,0,24,-5,6,3,5,2,0,2,2,2,2,0,0,1,1,1,3,2,0,4,-2,0,7,7,3,0,0,-1,1,0,1,5,1
KR_6697158610,420,-2,31,-16,0,2,2,0,1,2,1,2,3,1,-1,3,4,-4,0,4,1,0,-2,7,5,12,6,0,0,-1,1,1,1,3,1
KR_6762477375,420,6,70,24,20,3,7,4,3,3,0,5,6,1,5,6,1,4,4,0,2,23,6,2,2,4,1,0,4,1,1,1,1,3,1
KR_6727933818,420,2,4,-8,6,1,3,2,1,4,3,-3,2,5,1,2,1,6,6,0,0,11,6,0,3,3,4,0,-1,1,-1,1,-1,2,1
KR_6666230637,420,0,22,26,4,1,4,3,2,4,2,-1,2,3,1,10,9,1,1,0,0,0,6,-1,8,7,-1,0,1,-1,1,1,-1,2,1
KR_6746144452,440,-2,75,28,1,-5,0,5,1,3,2,5,5,0,1,4,3,-1,2,3,0,-3,-13,-3,6,3,-1,0,1,1,1,1,1,4,1
KR_6741484584,420,3,16,6,10,4,4,0,2,4,2,3,3,0,2,2,0,-1,0,1,1,9,-209,-3,10,7,2,0,2,1,1,1,1,4,1
KR_6509116522,420,1,-19,-7,3,0,1,1,-1,3,4,6,6,0,-1,2,3,-1,1,2,0,4,0,8,4,12,-1,0,0,1,0,0,1,1,1
KR_6699743721,420,0,26,-13,6,-2,1,3,0,1,1,1,1,0,4,4,0,3,4,1,0,13,-212,-6,9,3,1,0,0,-1,1,-1,-1,1,1
KR_6629567246,420,1,-9,-9,2,-2,1,3,-3,1,4,1,3,2,5,6,1,1,2,1,-1,6,-2,0,4,4,2,0,1,-1,1,1,-1,3,1
KR_6764297125,420,1,-37,8,-2,2,2,0,-2,0,2,1,5,4,-3,1,4,0,1,1,-1,-4,-5,0,4,4,-2,0,-3,-1,1,-1,-1,3,1
KR_6709742854,420,1,-13,8,-1,-2,1,3,-1,2,3,1,2,1,1,3,2,0,1,1,0,-4,105,1,5,6,4,0,1,1,-1,1,-1,5,1
KR_6762128595,420,5,1,2,10,0,2,2,-1,0,1,2,2,0,7,8,1,2,2,0,0,9,-163,-2,4,2,2,0,1,1,-1,-1,1,2,1
KR_6632661779,420,-2,-8,-24,-1,1,2,1,-1,4,5,0,1,1,0,4,4,-1,2,3,0,2,4,0,7,7,2,0,0,-1,1,0,-1,5,1
KR_6106868485,420,4,108,-4,5,1,3,2,-1,3,4,-1,0,1,5,6,1,1,1,0,0,9,-5,-7,14,7,1,0,1,-1,1,1,1,4,1
KR_6685668817,420,1,11,1,9,0,4,4,-3,2,5,2,5,3,8,8,0,2,3,1,2,13,3,-3,8,5,2,0,1,-1,1,1,1,4,1
KR_6757518119,420,2,60,-36,7,3,3,0,1,4,3,0,3,3,3,4,1,0,1,1,1,6,-6,1,6,7,-2,0,1,-1,1,1,1,6,1
KR_6684941092,420,2,9,-16,2,4,6,2,-2,1,3,0,2,2,3,4,1,-3,0,3,-2,-4,-10,-2,5,3,0,0,1,1,1,1,-1,5,1
KR_6663904108,420,4,52,15,6,2,4,2,4,6,2,-1,2,3,1,2,1,0,2,2,0,7,-1,-3,6,3,0,0,0,1,1,1,1,6,1
KR_6702411385,420,0,79,-8,1,2,2,0,1,2,1,-1,1,2,-1,1,2,0,0,0,0,1,-22,-2,7,5,-1,0,1,0,1,1,-1,0,1
KR_6756790313,420,2,88,16,2,2,3,1,-3,4,7,7,7,0,-3,0,3,-1,1,2,0,5,3,-1,4,3,1,0,3,1,1,1,-1,1,1
KR_6620144764,420,3,-4,-2,-4,0,2,2,0,3,3,-6,0,6,2,3,1,0,2,2,0,0,2,-2,6,4,0,0,0,-1,-1,0,-1,4,1
KR_6689758738,420,-1,-7,2,6,2,2,0,-1,1,2,0,3,3,4,5,1,1,3,2,0,-2,-39,4,2,6,26,0,-1,1,-1,-1,-1,4,1
KR_6756760236,440,-2,22,12,1,-1,1,2,-1,1,2,0,2,2,4,5,1,-1,2,3,3,-2,0,-1,6,5,-1,0,1,1,1,1,1,1,1
KR_6760416028,420,9,68,108,13,0,1,1,5,5,0,4,5,1,1,2,1,3,3,0,0,7,12,-1,3,2,2,0,2,1,1,1,1,5,1
KR_6753829503,440,4,44,29,10,3,3,0,-2,1,3,5,5,0,3,5,2,1,3,2,0,6,25,-1,4,3,-29,0,1,1,1,1,-1,3,1
KR_6749430202,420,3,35,0,4,2,4,2,-4,1,5,2,3,1,4,4,0,0,1,1,0,7,5,1,7,8,-3,0,1,1,1,1,1,6,1
KR_6701639931,420,1,-18,12,8,1,2,1,1,3,2,1,2,1,6,7,1,-1,2,3,0,5,1,-2,6,4,0,0,0,-1,-1,-1,1,5,1
KR_6690254478,420,0,-38,-4,-4,0,0,0,-2,0,2,1,1,0,-2,2,4,-1,1,2,0,-9,-7,-1,6,5,-3,0,0,1,1,0,1,1,1
KR_6758606826,420,-4,41,8,-9,2,3,1,2,4,2,-5,1,6,-8,4,12,0,0,0,1,-10,9,2,1,3,-3,0,-1,-1,1,-1,1,5,1
KR_6748894419,420,-1,-111,-14,-1,-5,0,5,0,1,1,0,1,1,2,4,2,2,2,0,0,2,-47,7,1,8,27,0,-1,1,0,-1,1,2,1
KR_6744439099,420,3,55,-6,9,4,4,0,1,1,0,2,2,0,2,2,0,0,0,0,0,6,-9,4,1,5,0,0,1,1,-1,1,1,5,1
KR_6765652765,420,5,127,-15,9,1,2,1,3,3,0,1,1,0,1,3,2,3,3,0,0,9,35,0,5,5,0,0,1,1,1,1,1,4,1
KR_6721716209,420,3,-15,-11,7,3,3,0,-1,5,6,0,2,2,3,4,1,2,2,0,0,2,-43,6,6,12,21,0,-1,-1,1,-1,1,4,1
KR_6750322790,420,6,83,31,16,1,1,0,7,7,0,2,3,1,7,7,0,-1,0,1,2,30,-17,-1,7,6,3,0,0,1,1,1,1,2,1
KR_6656599423,420,2,-16,6,8,0,1,1,-4,1,5,1,2,1,10,10,0,1,1,0,0,13,-1,-2,4,2,1,0,3,1,1,1,1,4,1
KR_6761692271,440,6,94,62,15,3,4,1,5,8,3,-1,1,2,3,5,2,5,5,0,0,6,-12,-3,4,1,3,0,3,1,1,1,1,3,1
KR_6641824474,420,3,1,-32,9,2,2,0,1,4,3,5,6,1,-4,5,9,5,5,0,0,7,3,3,5,8,3,0,0,1,-1,1,-1,2,1
KR_6685777576,420,-2,-52,10,-1,0,2,2,-5,1,6,5,6,1,-2,2,4,1,2,1,0,-3,-205,3,3,6,0,0,-1,1,-1,-1,1,3,1
KR_6620155150,420,4,78,40,8,1,3,2,2,6,4,4,6,2,2,6,4,-1,0,1,0,9,-11,4,2,6,0,0,1,1,1,1,1,3,1
KR_6764635290,420,4,33,34,7,-3,0,3,1,5,4,1,1,0,7,7,0,1,1,0,0,0,2,0,5,5,1,0,3,1,0,1,1,3,1
KR_6599517816,420,4,23,12,11,2,4,2,6,8,2,1,2,1,3,5,2,-1,0,1,1,9,13,-2,6,4,3,0,0,1,1,1,1,1,1
KR_6765454336,420,1,1,-23,11,5,5,0,2,4,2,3,3,0,0,1,1,1,4,3,0,6,-14,2,4,6,3,0,0,1,1,0,1,1,1
KR_6761646146,420,-1,-57,33,3,2,2,0,-5,0,5,1,2,1,5,6,1,0,0,0,0,-2,-14,4,2,6,4,0,0,1,1,0,-1,3,1
KR_6744157180,420,2,-35,0,8,2,4,2,2,3,1,1,1,0,3,3,0,0,2,2,0,9,-13,6,2,8,0,0,1,1,1,1,-1,2,1
KR_6748297699,420,1,-62,11,3,1,3,2,4,5,1,-3,1,4,0,1,1,1,1,0,0,6,22,-4,7,3,5,0,1,1,1,1,-1,3,1
KR_6757515949,420,4,28,43,10,1,1,0,5,7,2,1,3,2,0,1,1,3,4,1,0,8,10,1,9,10,-1,0,0,1,1,0,-1,4,1
KR_6737859216,420,1,77,0,1,3,5,2,-4,1,5,2,5,3,0,0,0,0,0,0,0,2,-5,-5,10,5,0,0,3,1,1,1,1,3,1
KR_6666130852,420,6,18,-17,15,3,5,2,4,6,2,2,2,0,5,5,0,1,1,0,-1,13,11,1,4,5,-3,0,1,-1,1,1,-1,6,1
KR_6760746511,420,3,23,0,12,0,2,2,-1,0,1,0,3,3,11,12,1,2,2,0,0,10,1,4,4,8,-8,0,0,1,-1,-1,1,5,1
KR_6764605169,440,2,0,20,3,4,4,0,-1,1,2,2,2,0,-4,0,4,2,5,3,0,-1,-5,-2,5,3,-2,0,-1,-1,1,-1,-1,4,1
KR_6764283944,420,1,40,-15,5,1,2,1,-4,0,4,1,2,1,8,8,0,-1,1,2,0,5,-8,-1,6,5,-1,0,0,1,1,-1,1,3,1
KR_6714524273,440,-2,54,-13,1,-1,2,3,0,2,2,2,2,0,2,2,0,-2,0,2,0,-1,-16,0,3,3,3,0,0,1,0,0,1,2,1
KR_6634319090,420,-1,19,-7,7,2,2,0,-2,0,2,3,4,1,4,5,1,0,1,1,0,6,-4,0,7,7,1,0,1,-1,1,1,1,2,1
KR_6748576080,420,2,55,4,3,2,3,1,1,3,2,-2,4,6,0,2,2,2,4,2,0,-1,4,0,4,4,7,0,2,1,1,1,1,1,1
KR_6748345224,440,2,-2,-4,3,-1,2,3,5,6,1,1,3,2,-1,1,2,-1,0,1,0,10,-32,3,3,6,22,0,0,-1,1,1,1,1,1
KR_6757944893,440,-1,-1,8,-2,0,3,3,-2,1,3,2,4,2,0,0,0,-2,0,2,0,-3,-18,3,4,7,5,0,1,-1,-1,1,1,6,1
KR_6652535221,420,3,7,4,10,0,1,1,3,5,2,2,2,0,5,5,0,0,1,1,0,12,-29,-1,8,7,7,0,0,-1,-1,0,1,3,1
KR_6740521354,440,0,2,-27,0,-1,4,5,4,5,1,-2,3,5,3,4,1,-4,1,5,1,0,8,3,2,5,-1,0,2,-1,1,1,1,2,1
KR_6751765011,420,2,-42,26,8,-3,0,3,4,4,0,3,4,1,4,4,0,0,0,0,0,13,-103,6,4,10,1,0,1,1,1,1,1,6,1
KR_6748631049,420,1,-13,22,0,2,4,2,0,2,2,0,2,2,-1,0,1,-1,1,2,0,-3,10,2,4,6,1,0,0,0,1,0,-1,0,1
KR_6560512318,420,3,16,-6,11,-2,1,3,5,5,0,0,2,2,4,6,2,4,4,0,0,10,10,2,5,7,-7,0,0,1,-1,1,-1,6,1
KR_6764778616,420,-1,-29,-1,1,2,2,0,0,1,1,-1,2,3,0,2,2,0,0,0,0,-2,-7,-4,7,3,-1,0,0,-1,-1,1,1,1,1
KR_6757708486,420,1,-1,-7,6,3,4,1,3,4,1,-1,1,2,0,2,2,1,2,1,0,2,-36,2,4,6,0,0,1,1,1,1,-1,1,1
KR_6738098545,420,2,15,25,9,3,3,0,4,8,4,3,4,1,-2,2,4,1,1,0,2,1,43,2,3,5,-17,0,0,1,1,1,1,5,1
KR_6755137543,440,-1,-65,5,3,-1,1,2,-1,1,2,2,3,1,0,4,4,3,4,1,0,3,15,0,6,6,2,0,0,-1,1,1,1,2,1
KR_6756753259,420,0,-22,-19,5,0,3,3,2,3,1,-4,2,6,5,6,1,2,2,0,0,19,64,3,5,8,-2,0,-2,1,-1,-1,1,2,1
KR_6760487911,420,2,58,4,2,3,3,0,-8,1,9,6,7,1,-1,1,2,2,4,2,0,-5,127,-1,4,3,2,0,-1,-1,-1,-1,1,5,1
KR_6666090614,420,6,114,-2,2,6,6,0,-6,1,7,2,4,2,2,3,1,-2,0,2,1,-3,-8,-1,5,4,6,0,2,-1,1,1,1,2,1
KR_6747547926,420,0,19,-12,-4,0,2,2,-3,2,5,-3,2,5,3,7,4,-1,0,1,1,-6,-1,3,4,7,-1,0,0,1,-1,1,-1,3,1
KR_6736049952,420,-2,-3,2,-5,0,5,5,-2,3,5,-4,1,5,0,0,0,1,1,0,1,-5,-40,-2,8,6,3,0,-1,0,-1,-1,1,0,1
KR_6765827701,420,2,-6,-2,0,-5,0,5,2,2,0,-1,1,2,5,5,0,-1,0,1,0,4,-20,-4,8,4,2,0,-1,-1,-1,-1,1,5,1
KR_6764246252,420,-3,-41,46,-6,-1,1,2,-2,5,7,2,3,1,-1,0,1,-4,0,4,0,-14,5,3,3,6,1,0,0,-1,1,0,1,1,1
KR_6746862762,420,1,32,4,-2,2,2,0,-2,4,6,5,5,0,-7,0,7,0,1,1,-1,-4,-18,-2,5,3,-2,0,-1,-1,-1,-1,-1,4,1
KR_6757395725,420,5,77,35,4,3,3,0,-3,0,3,-1,1,2,2,2,0,3,4,1,0,7,-3,-3,4,1,4,0,0,-1,-1,1,-1,1,1
KR_6750289693,420,2,53,-21,11,2,3,1,5,8,3,2,3,1,1,4,3,1,3,2,0,12,42,1,4,5,-21,0,1,1,1,1,1,2,1
KR_6746845089,420,3,69,5,7,5,5,0,3,3,0,3,6,3,-2,3,5,-2,1,3,0,-1,-106,-1,7,6,6,0,2,1,1,1,-1,2,1
KR_6725121120,420,1,-14,20,4,3,5,2,1,6,5,0,0,0,0,4,4,0,0,0,0,-2,11,-1,3,2,0,0,-1,1,1,1,-1,4,1
KR_6766232588,420,1,1,17,0,-2,0,2,1,2,1,-2,1,3,3,3,0,0,0,0,0,-2,-3,-1,4,3,10,0,0,0,1,0,-1,0,1
KR_6759200192,440,-3,26,15,-12,3,5,2,-2,0,2,-8,0,8,-2,2,4,-3,0,3,0,-9,9,4,1,5,-2,0,3,1,-1,1,1,4,1
KR_6749927889,420,-1,31,-16,4,3,4,1,0,4,4,0,3,3,0,1,1,1,2,1,0,4,3,2,3,5,5,0,0,-1,1,-1,1,3,1
KR_6760062703,420,5,23,19,6,8,10,2,1,4,3,2,2,0,-5,0,5,0,0,0,0,1,-10,-1,4,3,1,0,1,1,1,1,1,1,1
KR_6690067336,420,0,-9,-4,5,-2,0,2,2,6,4,0,4,4,4,4,0,1,1,0,0,7,10,5,4,9,-1,0,2,1,1,1,1,5,1
KR_6762078256,420,3,18,20,7,2,4,2,3,3,0,0,3,3,2,3,1,0,0,0,0,6,2,-2,7,5,-3,0,2,1,-1,1,1,6,1
KR_6628694784,420,-1,16,-1,1,-4,1,5,1,1,0,2,5,3,3,3,0,-1,0,1,1,11,-3,-2,7,5,4,0,0,1,-1,-1,1,5,1
KR_6706071841,420,-3,38,-35,-3,0,1,1,4,4,0,-1,6,7,-6,0,6,0,2,2,0,-5,-4,-4,7,3,3,0,0,1,1,0,1,5,1
KR_6690035016,420,3,23,-4,6,1,2,1,2,3,1,3,4,1,1,1,0,-1,0,1,0,4,12,-3,5,2,5,0,0,1,1,0,-1,3,1
KR_6764052999,420,3,49,40,11,-3,0,3,4,6,2,7,10,3,-2,1,3,5,5,0,3,14,4,3,6,9,-3,0,1,1,1,1,1,6,1
KR_6746696806,420,3,42,-8,1,3,3,0,2,2,0,-4,1,5,0,2,2,0,0,0,0,-8,6,2,5,7,-1,0,-1,-1,-1,-1,-1,5,1
KR_6761545019,420,2,85,4,4,2,3,1,0,1,1,1,2,1,0,2,2,1,1,0,0,1,20,3,3,6,-3,0,1,-1,1,1,-1,2,1
KR_6761321636,420,-4,-75,-21,-5,1,4,3,0,0,0,-2,0,2,-3,0,3,-1,1,2,0,-4,34,3,2,5,-13,0,-1,-1,1,-1,-1,3,1
KR_6759002332,420,-1,41,-15,0,1,2,1,-4,1,5,1,1,0,1,2,1,1,1,0,0,-3,-22,-2,7,5,-22,0,0,1,-1,0,1,5,1
KR_6766407491,420,1,25,-32,5,-1,2,3,3,6,3,3,3,0,0,2,2,0,0,0,0,11,-16,0,2,2,-1,0,0,0,1,0,1,0,1
KR_6712340603,420,2,110,-7,10,-1,0,1,14,14,0,-6,2,8,2,4,2,1,3,2,0,2,0,-2,6,4,2,0,3,-1,-1,1,1,1,1
KR_6704293975,420,4,103,21,7,1,1,0,0,0,0,3,5,2,3,6,3,0,2,2,0,2,0,-3,6,3,1,0,0,1,-1,0,1,6,1
KR_6750281674,440,4,-10,8,11,-2,1,3,1,2,1,5,6,1,3,7,4,4,8,4,-2,5,-9,0,6,6,-2,0,-1,-1,-1,-1,-1,1,1
KR_6605846375,420,3,-2,44,4,-2,2,4,1,4,3,2,4,2,4,6,2,-1,1,2,1,1,2,-1,5,4,0,0,1,1,1,1,1,5,1
KR_6632268228,420,1,14,-7,7,0,2,2,2,2,0,2,2,0,5,7,2,-2,1,3,0,8,1,1,3,4,-1,0,0,1,-1,0,-1,2,1
KR_6647228662,440,5,21,-16,18,-4,2,6,2,5,3,7,8,1,11,14,3,2,2,0,-2,18,155,0,4,4,5,0,1,1,1,-1,-1,3,1
KR_6468195491,420,-1,-60,0,5,1,2,1,-3,5,8,4,4,0,4,5,1,-1,1,2,0,6,8,5,4,9,-2,0,0,1,1,0,1,2,1
KR_6766413516,440,2,33,20,2,-1,3,4,-3,1,4,0,1,1,1,2,1,5,5,0,0,8,-3,-4,7,3,0,0,0,1,-1,-1,1,5,1
KR_6654284712,420,2,33,26,0,-2,0,2,1,1,0,-1,1,2,1,3,2,1,1,0,0,-3,5,-1,6,5,-1,0,0,1,0,0,-1,4,1
KR_6700120202,420,1,-16,20,3,5,5,0,-3,2,5,-2,1,3,4,4,0,-1,2,3,0,1,97,2,4,6,-19,0,2,-1,1,1,1,4,1
KR_6744190628,440,1,-8,23,1,0,0,0,5,5,0,0,2,2,-4,0,4,0,7,7,0,-5,10,-4,6,2,-3,0,0,1,1,1,-1,3,1
KR_6686638304,420,-3,-42,-20,-3,5,6,1,-4,2,6,-2,4,6,-3,0,3,1,2,1,-1,-3,-2,1,4,5,4,0,-1,-1,-1,-1,-1,5,1
KR_6713559447,420,-1,42,44,-7,-1,0,1,-2,0,2,-2,3,5,-3,2,5,1,2,1,0,-17,-3,2,5,7,2,0,0,1,0,0,1,4,1
KR_6716670690,420,0,-53,-25,5,-1,1,2,5,5,0,-4,0,4,2,3,1,3,4,1,0,16,40,4,3,7,-21,0,1,1,-1,1,1,5,1
KR_6686529364,420,6,-10,8,11,2,3,1,0,7,7,4,4,0,3,4,1,2,2,0,0,14,0,-4,7,3,2,0,2,1,-1,1,-1,5,1
KR_6763161415,420,3,60,-4,0,1,1,0,0,2,2,-1,2,3,1,4,3,-1,2,3,0,-9,-40,-4,8,4,5,0,0,1,1,1,1,6,1
KR_6710611665,420,2,6,22,0,-1,0,1,2,4,2,-1,1,2,0,1,1,0,2,2,1,7,13,1,5,6,6,0,0,1,-1,-1,1,3,1
KR_6656173813,420,1,53,6,6,0,1,1,-2,5,7,6,6,0,0,3,3,2,3,1,0,3,57,3,7,10,3,0,1,1,-1,1,1,1,1
KR_6509097023,420,6,-59,60,11,-5,0,5,3,4,1,5,8,3,9,10,1,-1,1,2,0,19,0,-4,7,3,1,0,0,1,1,1,-1,3,1
KR_6766509112,420,-1,16,13,-2,-2,0,2,0,2,2,-1,0,1,1,1,0,0,1,1,0,-2,142,2,0,2,-2,0,2,1,-1,1,1,2,1
KR_6760257141,420,-1,-35,16,4,-1,1,2,-1,0,1,2,3,1,5,5,0,-1,1,2,0,7,2,3,4,7,-2,0,0,-1,1,0,1,5,1
KR_6272964242,420,1,9,11,3,0,2,2,0,2,2,-2,1,3,4,5,1,1,1,0,0,6,42,3,7,10,-18,0,1,1,1,1,1,5,1
KR_6754696357,420,1,-99,21,10,1,3,2,6,6,0,-1,0,1,5,6,1,-1,0,1,0,10,4,4,2,6,1,0,0,1,1,-1,-1,3,1
KR_6739900082,420,5,57,14,15,0,3,3,1,3,2,4,5,1,8,9,1,2,2,0,1,10,6,3,3,6,2,0,2,1,-1,1,1,5,1
KR_6750093800,420,-3,16,16,-11,-7,0,7,-7,1,8,-1,1,2,3,5,2,1,1,0,0,-15,3,2,9,11,0,0,-2,-1,-1,-1,1,5,1
KR_6695501359,420,0,22,8,-1,-1,0,1,-3,4,7,1,2,1,2,2,0,0,1,1,0,5,53,3,4,7,1,0,3,-1,1,1,1,4,1
KR_6764779867,420,2,21,-17,3,-2,1,3,6,6,0,4,5,1,-3,0,3,-2,0,2,1,1,24,-3,5,2,-12,0,-1,-1,-1,-1,1,1,1
KR_6715769151,420,6,70,44,14,2,4,2,4,6,2,4,5,1,4,5,1,0,1,1,0,13,-4,4,3,7,8,0,0,-1,0,0,1,6,1
KR_6759494777,420,3,1,19,-1,0,0,0,1,3,2,1,1,0,-3,0,3,0,0,0,0,0,60,0,3,3,-34,0,1,-1,1,1,1,5,1
KR_6757107015,440,3,-5,0,4,3,4,1,2,3,1,5,7,2,-1,5,6,-5,1,6,1,2,-15,-1,5,4,6,0,0,1,-1,1,1,2,1
KR_6689013247,420,2,26,16,0,3,4,1,-2,2,4,0,3,3,-3,0,3,2,2,0,0,0,19,-2,7,5,-7,0,0,0,-1,1,-1,0,1
KR_6669595212,420,2,52,-13,7,-3,0,3,4,11,7,3,3,0,6,8,2,-3,1,4,0,1,-116,0,6,6,-1,0,1,1,-1,1,-1,4,1
KR_6738131227,420,3,-40,-4,8,-3,2,5,3,4,1,5,5,0,1,3,2,2,2,0,0,13,180,-2,6,4,5,0,-1,1,-1,-1,-1,5,1
KR_6720111538,420,7,139,20,13,2,4,2,4,4,0,-4,1,5,11,11,0,0,1,1,-1,14,29,-1,7,6,2,2,7,1,1,1,-1,1,1
KR_6744484353,420,6,98,8,16,4,7,3,2,3,1,2,3,1,8,8,0,0,0,0,1,19,-3,-1,7,6,4,0,0,1,0,-1,1,5,1
KR_6752490885,420,5,40,12,14,5,5,0,3,3,0,-5,2,7,2,4,2,9,10,1,-1,18,12,6,0,6,-4,0,1,-1,0,1,1,4,1
KR_6697855278,420,6,35,21,7,-1,2,3,8,10,2,0,2,2,0,2,2,0,1,1,1,12,40,3,3,6,1,0,1,-1,1,1,1,1,1
KR_6763632442,420,3,5,6,7,3,3,0,3,3,0,-2,2,4,3,5,2,0,0,0,0,4,-1,-5,8,3,-5,0,0,-1,-1,0,1,3,1
KR_6629529249,420,4,75,16,10,-1,2,3,5,7,2,4,4,0,2,2,0,0,0,0,0,8,7,4,5,9,0,0,2,1,-1,-1,1,6,1
KR_6708784133,420,1,22,18,8,-2,2,4,5,6,1,3,5,2,3,3,0,-1,0,1,0,12,-270,2,2,4,0,0,1,-1,-1,-1,1,2,1
KR_6765638549,440,-1,-53,-1,-1,2,5,3,-1,1,2,0,0,0,-5,0,5,3,3,0,0,-6,-10,-1,7,6,5,0,0,-1,-1,0,1,3,1
KR_6762857557,420,1,23,10,-2,0,2,2,-3,2,5,1,3,2,-2,0,2,2,2,0,0,-1,-8,-4,9,5,-2,0,0,1,1,1,-1,3,1
KR_6727133928,420,3,97,-8,10,4,5,1,0,4,4,4,7,3,3,4,1,-1,0,1,0,3,4,8,1,9,1,0,2,0,1,1,1,0,1
KR_6763945729,420,3,55,0,16,0,1,1,1,3,2,3,5,2,5,5,0,7,7,0,0,16,2,4,7,11,4,0,1,-1,0,1,1,4,1
KR_6632474614,420,-2,-17,4,2,4,4,0,-4,2,6,1,2,1,1,3,2,0,1,1,0,-5,-152,-2,6,4,3,0,1,1,1,1,1,2,1
KR_6763126678,420,3,1,20,11,4,5,1,-1,2,3,-3,2,5,11,12,1,0,1,1,0,10,3,0,5,5,-2,0,1,1,-1,1,-1,3,1
KR_6764600703,420,1,10,-12,-2,1,3,2,1,4,3,-1,3,4,-2,1,3,-1,0,1,0,-6,7,2,4,6,4,0,0,-1,0,-1,1,5,1
KR_6759490126,420,0,14,-13,1,0,2,2,4,4,0,5,5,0,-3,2,5,-5,0,5,0,-7,46,3,4,7,4,0,-1,1,1,-1,-1,2,1
KR_6761370125,420,2,88,4,5,0,3,3,2,4,2,-3,1,4,5,7,2,1,3,2,0,6,135,-8,10,2,0,0,0,-1,-1,0,1,6,1
KR_6753590396,420,0,3,35,-6,-2,2,4,-4,1,5,1,3,2,-1,3,4,0,0,0,0,-3,3,0,3,3,3,0,0,1,-1,0,-1,1,1
KR_6660450672,440,4,102,9,14,1,3,2,2,3,1,11,13,2,1,5,4,-1,0,1,0,4,-1,2,3,5,1,0,0,1,1,0,-1,4,1
KR_6764806813,420,3,16,7,1,-1,3,4,1,5,4,-2,1,3,0,1,1,3,4,1,0,-7,-4,-2,5,3,-2,0,0,1,-1,0,-1,5,1
KR_6749887264,440,2,62,-8,8,5,6,1,-4,3,7,3,3,0,5,6,1,-1,1,2,1,17,52,0,2,2,-1,0,1,0,1,1,1,0,1
KR_6712367043,420,3,15,7,6,0,1,1,1,7,6,-1,3,4,9,10,1,-3,0,3,0,2,33,0,2,2,-2,0,1,0,-1,1,-1,0,1
KR_6764455021,440,-1,41,-36,4,-1,0,1,5,7,2,-3,1,4,1,2,1,2,2,0,0,2,15,7,3,10,-4,0,0,-1,1,1,1,6,1
KR_6752191004,420,4,37,8,6,0,3,3,5,6,1,0,4,4,-2,3,5,3,3,0,0,4,0,-5,7,2,1,0,0,1,-1,0,-1,4,1
KR_6746874388,420,2,62,20,3,-1,0,1,2,2,0,4,7,3,-1,2,3,-1,0,1,0,1,-56,4,4,8,3,0,1,-1,-1,1,1,5,1
KR_6682236219,420,4,47,15,14,1,4,3,8,9,1,-2,1,3,2,3,1,5,5,0,1,19,-4,0,3,3,2,0,2,1,1,1,1,4,1
KR_6597207759,420,2,47,2,3,-2,1,3,0,2,2,2,4,2,2,5,3,1,2,1,0,3,1,-5,9,4,-2,0,-1,1,-1,-1,-1,4,1
KR_6666522787,420,5,84,17,10,2,3,1,5,8,3,6,6,0,-4,2,6,1,2,1,0,10,1,-1,8,7,1,0,2,1,1,1,-1,5,1
KR_6760474323,420,4,76,36,7,2,4,2,-1,4,5,5,7,2,-1,3,4,2,3,1,-1,14,7,-2,5,3,0,0,3,-1,-1,1,-1,6,1
KR_6760007135,440,2,24,13,7,3,3,0,2,4,2,-2,3,5,1,3,2,3,5,2,0,0,20,-5,10,5,-3,0,1,1,-1,-1,-1,1,1
KR_6677206760,420,5,78,-32,16,5,5,0,9,10,1,0,5,5,3,4,1,-1,0,1,0,20,-4,-2,8,6,1,0,1,1,1,1,-1,1,1
KR_6764330967,420,4,-4,64,9,0,1,1,5,5,0,3,4,1,0,5,5,1,2,1,0,6,20,1,4,5,-2,0,0,0,1,1,1,0,1
KR_6761751602,440,1,26,-36,7,4,5,1,-2,1,3,4,5,1,0,3,3,1,2,1,0,10,7,6,5,11,0,0,1,1,1,1,-1,5,1
KR_6715699527,420,7,102,31,19,5,5,0,3,5,2,11,11,0,0,5,5,0,0,0,0,11,-41,-4,9,5,28,0,1,1,0,1,1,5,1
KR_6732181856,420,-1,-47,-10,-1,-2,4,6,3,5,2,-2,4,6,2,3,1,-2,0,2,0,7,36,-1,4,3,-22,0,-1,1,-1,-1,1,2,1
KR_6766055302,420,5,81,-8,7,1,4,3,4,4,0,1,2,1,1,3,2,0,1,1,0,-1,24,-3,8,5,5,0,3,1,1,1,1,4,1
KR_6738245188,420,1,32,-3,10,1,2,1,1,5,4,2,3,1,5,6,1,1,1,0,0,14,-2,1,8,9,3,0,1,1,-1,1,1,5,1
KR_6734746564,420,-1,36,52,3,1,3,2,2,5,3,1,3,2,-1,2,3,0,0,0,0,1,-6,4,3,7,3,0,1,1,1,1,1,3,1
KR_6704548461,440,5,31,-13,20,3,4,1,4,7,3,5,5,0,1,3,2,7,7,0,1,28,33,7,1,8,-2,0,1,1,1,1,1,1,1
KR_6748338640,420,-1,18,8,-7,-6,1,7,4,6,2,0,3,3,-3,2,5,-2,3,5,0,-7,-35,0,5,5,-5,0,-1,1,-1,-1,-1,5,1
KR_6697150321,420,-3,19,-20,0,-2,0,2,0,1,1,3,4,1,1,1,0,-2,1,3,0,7,-34,1,8,9,-2,0,0,1,-1,0,-1,3,1
KR_6703254449,440,3,-3,44,-2,2,2,0,-3,4,7,0,1,1,-1,2,3,0,1,1,0,-6,-64,-1,2,1,19,0,0,0,0,0,-1,0,1
KR_6766551741,420,5,15,28,19,-1,2,3,2,3,1,0,4,4,15,17,2,3,4,1,2,22,-1,4,3,7,1,0,1,1,-1,1,1,6,1
KR_6731897150,420,2,12,-5,6,4,5,1,2,5,3,-5,3,8,6,6,0,-1,0,1,0,2,0,0,7,7,-4,0,1,1,1,1,1,2,1
KR_6696147393,420,2,-5,8,0,-2,1,3,0,2,2,-6,1,7,1,3,2,7,7,0,0,-1,-1,2,5,7,1,0,1,1,1,1,1,1,1
KR_6632635167,420,6,66,0,16,6,7,1,2,4,2,4,6,2,4,5,1,0,1,1,3,19,28,2,5,7,-1,0,2,1,1,1,1,5,1
KR_6731316903,420,3,41,-3,14,1,1,0,0,5,5,3,3,0,8,10,2,2,2,0,2,22,2,3,2,5,-2,0,2,1,1,1,1,5,1
KR_6753795674,420,5,-10,10,6,1,4,3,-1,4,5,2,2,0,4,5,1,0,2,2,0,1,2,-1,6,5,-1,0,1,0,-1,1,1,0,1
KR_6647079515,420,-1,39,-53,3,-3,1,4,6,6,0,0,3,3,0,2,2,0,2,2,0,8,-1,-2,4,2,9,0,1,1,-1,1,-1,1,1
KR_6706484966,420,2,42,-7,4,-3,2,5,1,4,3,3,6,3,3,4,1,0,0,0,0,11,-2,3,3,6,4,0,-1,-1,1,-1,1,4,1
KR_6617872204,420,0,52,-43,5,2,3,1,3,5,2,-4,1,5,4,8,4,0,0,0,0,9,-22,3,3,6,-2,0,0,-1,1,0,-1,5,1
KR_6742997872,420,3,36,-16,7,3,4,1,6,9,3,0,1,1,-1,1,2,-1,0,1,1,9,-1,4,3,7,3,0,1,1,1,1,1,2,1
KR_6737707553,420,4,0,24,9,3,3,0,3,3,0,4,4,0,-1,1,2,0,0,0,0,8,7,4,2,6,0,0,1,1,-1,1,1,2,1
KR_6737970724,420,4,80,10,6,6,7,1,-3,1,4,1,3,2,2,4,2,0,0,0,0,-2,0,1,3,4,1,0,-1,1,-1,1,1,3,1
KR_6739460844,420,0,-30,-5,-1,1,2,1,-1,2,3,-5,1,6,3,5,2,1,3,2,0,1,23,0,4,4,4,0,1,-1,-1,1,1,2,1
KR_6752440081,420,1,-6,33,1,0,0,0,-2,2,4,4,5,1,-1,1,2,0,0,0,0,3,25,3,5,8,5,0,0,-1,0,0,-1,6,1
KR_6737022113,420,1,24,18,0,0,1,1,-2,4,6,1,3,2,2,4,2,-1,1,2,0,-4,0,-5,9,4,0,0,1,1,-1,1,-1,2,1
KR_6765243772,420,3,43,-7,9,2,2,0,5,6,1,1,2,1,0,3,3,1,1,0,0,7,5,5,2,7,-2,0,1,1,-1,1,-1,4,1
KR_6751505207,420,-1,-36,-20,8,3,3,0,0,2,2,3,4,1,0,5,5,2,3,1,0,9,-8,2,4,6,-3,0,-1,-1,1,-1,1,1,1
KR_6743174285,420,-1,8,-15,-1,0,2,2,7,7,0,-1,3,4,-5,0,5,-2,2,4,-1,-10,9,2,1,3,3,0,-2,1,-1,-1,-1,3,1
KR_6655916138,440,4,44,34,9,2,2,0,2,4,2,0,1,1,1,4,3,4,4,0,0,9,-340,0,3,3,5,0,0,1,0,0,1,1,1
KR_6712319157,420,2,14,16,11,4,5,1,4,5,1,0,4,4,1,3,2,2,3,1,0,6,14,7,1,8,1,0,1,0,1,1,-1,0,1
KR_6686531590,420,2,42,-9,9,-3,0,3,2,4,2,5,7,2,2,2,0,3,6,3,2,11,-5,-9,11,2,2,0,1,-1,-1,1,1,4,1
KR_6766292197,420,6,119,-19,17,0,1,1,5,5,0,0,1,1,4,4,0,8,8,0,1,26,-28,2,3,5,1,0,3,1,1,1,1,1,1
KR_6717498467,420,2,56,12,8,2,2,0,3,4,1,2,3,1,1,5,4,0,0,0,0,8,-4,1,5,6,7,0,2,1,1,1,-1,5,1
KR_6722858411,420,1,-26,12,1,-4,0,4,-1,1,2,3,5,2,0,6,6,3,3,0,0,8,17,-3,5,2,0,0,0,1,1,0,-1,2,1
KR_6716568907,440,6,76,36,20,4,7,3,1,3,2,4,6,2,2,4,2,9,12,3,3,7,-3,0,6,6,4,0,1,1,0,1,1,2,1
KR_6763989778,420,1,15,25,2,1,3,2,4,4,0,-1,1,2,-1,1,2,-1,0,1,0,4,19,2,5,7,1,0,0,1,1,1,1,2,1
KR_6702607754,420,6,56,-7,11,-3,2,5,-1,2,3,7,7,0,6,6,0,2,2,0,0,7,-23,-6,10,4,-2,0,2,-1,-1,1,-1,5,1
KR_6761816846,420,1,2,-20,1,6,7,1,-4,3,7,-4,1,5,3,3,0,0,1,1,2,6,3,0,4,4,0,0,0,-1,-1,-1,1,2,1
KR_6622516542,420,2,12,29,2,4,5,1,-1,2,3,-2,2,4,1,2,1,0,1,1,0,3,282,1,3,4,0,0,2,1,1,1,-1,6,1
KR_6701715181,420,-1,-11,-17,-1,-2,0,2,-1,3,4,-1,1,2,3,3,0,0,2,2,0,0,20,1,7,8,-18,0,0,-1,1,0,1,6,1
KR_6759566087,420,0,17,7,1,3,3,0,-1,2,3,0,3,3,-2,5,7,1,1,0,-1,-5,-13,2,6,8,-1,0,1,1,1,1,1,3,1
KR_6734627903,420,0,4,-15,6,-3,2,5,1,2,1,-1,2,3,6,7,1,3,3,0,2,8,9,2,4,6,4,0,-1,1,-1,1,1,5,1
KR_6765021445,420,-2,-55,12,2,1,2,1,1,2,1,0,3,3,0,3,3,0,0,0,0,2,42,3,3,6,-19,0,1,-1,1,1,1,2,1
KR_6741366152,420,1,-16,27,10,3,4,1,4,5,1,2,6,4,0,1,1,1,2,1,0,10,-53,0,5,5,10,0,1,1,1,1,1,3,1
KR_6730411923,420,6,79,33,17,1,2,1,1,2,1,5,5,0,9,11,2,1,1,0,0,15,-397,-2,4,2,6,0,1,1,-1,1,1,6,1
KR_6697477481,420,8,66,33,10,4,4,0,1,5,4,1,2,1,0,2,2,4,5,1,0,3,157,-1,4,3,-14,0,3,1,1,1,1,3,1
KR_6762546518,420,0,57,-3,2,2,4,2,-1,2,3,0,5,5,-1,3,4,2,2,0,0,1,22,-1,7,6,5,0,0,-1,1,1,1,1,1
KR_6749512559,420,5,77,-12,14,7,9,2,5,7,2,-1,0,1,4,9,5,-1,1,2,0,19,12,-1,6,5,6,0,0,1,-1,1,-1,1,1
KR_6621524457,420,2,-5,30,10,0,3,3,6,6,0,0,2,2,3,6,3,1,2,1,0,11,1,6,2,8,-2,0,0,1,1,1,-1,6,1
KR_6704786534,420,3,12,8,14,6,6,0,0,4,4,1,2,1,9,9,0,-2,2,4,0,18,-19,4,2,6,2,0,1,1,1,1,1,2,1
KR_6735910212,420,-2,15,-6,4,5,5,0,-3,1,4,-3,0,3,4,4,0,1,1,0,0,8,-20,2,5,7,4,0,0,0,-1,0,-1,0,1
KR_6748037269,420,1,-20,-23,5,1,2,1,1,3,2,1,4,3,-2,6,8,4,4,0,1,6,-6,5,4,9,4,0,1,-1,1,1,-1,3,1
KR_6691075470,420,2,19,17,1,-1,0,1,2,5,3,0,4,4,4,5,1,-4,0,4,0,-1,19,-1,6,5,3,0,0,-1,1,0,-1,2,1
KR_6750234435,440,1,-31,0,-1,1,3,2,1,4,3,-3,0,3,1,2,1,-1,2,3,0,0,-6,-1,5,4,3,0,-1,1,1,-1,-1,2,1
KR_6765171876,420,4,74,16,15,3,3,0,5,5,0,3,4,1,4,5,1,0,0,0,0,9,8,-2,6,4,5,0,3,1,1,1,1,1,1
KR_6758381123,420,3,-6,8,2,1,2,1,0,2,2,0,1,1,1,1,0,0,0,0,0,4,-4,-2,7,5,-1,0,0,1,-1,0,-1,6,1
KR_6750697926,420,1,-5,4,5,0,0,0,2,4,2,0,2,2,1,3,2,2,2,0,0,10,126,-2,7,5,-4,0,0,-1,1,0,1,3,1
KR_6752210624,420,1,8,7,0,1,1,0,1,6,5,1,3,2,-4,0,4,1,4,3,0,0,3,-3,6,3,0,0,2,-1,1,1,-1,3,1
KR_6518368641,440,4,19,-11,5,-1,3,4,3,3,0,3,4,1,0,1,1,0,1,1,0,2,155,2,3,5,21,0,1,-1,0,1,1,2,1
KR_6764893424,420,-2,-52,-10,-2,1,3,2,0,2,2,0,3,3,-1,3,4,-2,0,2,0,7,-1,4,2,6,1,0,-2,-1,-1,-1,-1,4,1
KR_6705364915,420,2,30,-7,-1,0,3,3,6,8,2,-2,0,2,-3,1,4,-2,0,2,0,2,-4,-1,7,6,2,0,1,-1,1,1,-1,6,1
KR_6156231722,420,5,41,8,5,-1,0,1,2,5,3,2,3,1,2,3,1,0,1,1,0,4,28,4,3,7,-2,0,0,1,1,1,-1,4,1
KR_6765501944,420,-1,-17,-12,0,-2,0,2,2,2,0,0,5,5,-1,6,7,1,1,0,-1,8,2,0,1,1,2,0,0,1,0,0,-1,6,1
KR_6698860562,420,4,83,8,1,2,4,2,-4,1,5,1,2,1,0,0,0,2,2,0,0,-2,9,2,5,7,-4,0,1,1,-1,1,1,3,1
KR_6667858894,420,-1,-29,10,1,2,2,0,-1,3,4,2,5,3,0,3,3,-2,1,3,0,2,11,-1,4,3,-1,0,-1,1,0,-1,1,4,1
KR_6729245965,420,1,45,16,-3,4,4,0,-4,0,4,-6,2,8,2,5,3,1,2,1,0,-8,10,-2,6,4,-4,0,2,1,-1,1,-1,6,1
KR_6758146022,420,4,56,-16,10,3,3,0,4,4,0,2,4,2,1,1,0,0,0,0,0,8,118,-1,5,4,3,0,2,1,1,1,1,6,1
KR_6756367176,420,2,-10,24,1,4,4,0,-1,1,2,0,2,2,0,0,0,-2,0,2,0,-1,1,2,1,3,1,0,-1,0,1,-1,1,0,1
KR_6705036021,420,4,49,28,9,0,2,2,3,4,1,5,6,1,0,1,1,1,1,0,0,11,7,6,3,9,0,0,0,1,1,1,1,4,1
KR_6645199017,420,4,-16,15,14,3,3,0,-1,1,2,1,3,2,8,9,1,3,3,0,0,16,102,3,2,5,-3,0,3,-1,1,1,1,5,1
KR_6751975751,440,3,53,-4,10,0,2,2,0,3,3,9,11,2,2,2,0,-1,1,2,0,2,1,-2,5,3,3,0,3,1,1,1,1,5,1
KR_6631219122,420,1,1,6,-3,-3,2,5,1,3,2,-2,1,3,4,5,1,-3,1,4,2,2,13,2,2,4,1,0,-2,1,1,-1,1,1,1
KR_6765488378,420,6,61,14,12,5,6,1,2,4,2,2,2,0,2,5,3,1,1,0,0,9,-24,3,6,9,9,0,0,1,-1,1,-1,5,1
KR_6736086620,420,-1,11,-22,2,-9,0,9,4,7,3,3,4,1,2,4,2,2,3,1,2,5,-10,-1,5,4,0,0,0,1,-1,1,-1,1,1
KR_6734225077,420,3,86,-4,4,2,3,1,-3,2,5,7,7,0,0,1,1,-2,1,3,0,4,-42,-1,6,5,5,0,0,1,-1,0,1,2,1
KR_6603970746,440,0,-24,-13,6,1,3,2,-2,1,3,4,6,2,3,6,3,0,0,0,0,2,-9,0,3,3,-1,0,-1,1,-1,-1,1,6,1
KR_6724661819,420,-2,6,2,-5,2,2,0,-3,2,5,2,2,0,-3,0,3,-3,0,3,0,-7,-38,3,3,6,-1,0,0,-1,1,0,-1,6,1
KR_6765307442,420,4,-16,23,12,5,8,3,2,2,0,1,2,1,2,2,0,2,4,2,0,7,1,3,4,7,1,0,1,1,1,1,1,2,1
KR_6738717871,420,3,-19,-5,10,2,3,1,5,5,0,1,1,0,1,1,0,1,2,1,0,14,4,2,5,7,-3,0,0,-1,1,0,1,5,1
KR_6714219237,420,0,8,-21,2,-2,0,2,3,3,0,0,3,3,0,2,2,1,1,0,0,8,-4,-3,5,2,2,0,1,1,-1,1,-1,3,1
KR_6723116960,420,1,54,43,-2,2,6,4,-4,2,6,-2,1,3,6,8,2,-4,0,4,1,-16,-3,-2,5,3,0,0,0,-1,-1,1,1,5,1
KR_6655482269,440,1,4,17,3,-2,1,3,2,5,3,2,6,4,2,8,6,-1,0,1,0,4,-2,1,2,3,4,0,0,-1,1,0,-1,2,1
KR_6759652930,420,0,12,12,-4,-1,1,2,-2,1,3,1,1,0,-3,5,8,1,2,1,0,-7,2,0,5,5,-3,0,0,-1,-1,1,-1,6,1
KR_6732240719,420,1,59,-3,3,-5,2,7,0,1,1,3,4,1,6,9,3,-1,0,1,0,3,-10,3,4,7,2,0,3,1,1,1,-1,5,1
KR_6747546007,440,3,40,9,6,-2,0,2,3,6,3,3,4,1,1,3,2,1,1,0,0,6,1,5,1,6,-1,0,0,1,1,0,-1,2,1
KR_6760841840,420,0,-26,-21,-3,2,3,1,-5,1,6,2,2,0,-3,1,4,1,3,2,0,-3,124,-2,3,1,2,0,1,-1,1,1,-1,1,1
KR_6750502093,440,0,-18,8,2,-3,1,4,0,2,2,-2,1,3,4,6,2,3,4,1,0,1,1,0,3,3,3,0,-1,0,0,-1,1,0,1
KR_6604046585,440,-1,-3,-23,4,-2,2,4,-3,4,7,6,6,0,3,6,3,0,0,0,0,13,-3,2,2,4,0,0,1,-1,1,1,1,4,1
KR_6766190305,420,1,54,12,3,0,0,0,-1,2,3,1,3,2,0,1,1,3,3,0,0,-1,1,5,2,7,5,0,1,-1,1,1,1,3,1
KR_6632813838,420,11,135,22,16,0,3,3,1,2,1,5,6,1,10,15,5,0,1,1,0,11,0,0,6,6,4,0,1,-1,1,1,-1,2,1
KR_6756479313,420,-1,49,-7,-1,1,2,1,-2,0,2,2,3,1,1,2,1,-3,0,3,0,-2,-4,0,6,6,0,0,0,1,-1,0,1,3,1
KR_6711753041,420,4,84,38,18,-1,3,4,7,8,1,-1,2,3,10,12,2,3,3,0,1,25,6,-3,6,3,4,0,2,-1,1,1,1,2,1
KR_6717197933,420,4,142,8,11,7,7,0,4,5,1,-4,1,5,1,3,2,3,3,0,0,9,3,1,4,5,5,0,4,-1,1,1,1,5,1
KR_6705921098,420,3,26,32,8,2,3,1,3,4,1,7,7,0,-4,1,5,0,0,0,0,6,4,0,7,7,1,0,0,1,1,1,1,1,1
KR_6766465958,420,4,114,11,-1,4,6,2,2,6,4,-1,1,2,-5,1,6,-1,1,2,0,-2,14,-1,3,2,-3,0,2,1,1,1,1,5,1
KR_6605195051,420,0,-35,28,2,-2,1,3,3,5,2,3,5,2,0,3,3,-2,1,3,0,2,-3,1,4,5,-3,0,-1,-1,-1,-1,-1,1,1
KR_6757823483,420,-2,-77,-23,-1,-1,1,2,1,3,2,-1,1,2,1,1,0,-1,0,1,0,2,5,-2,6,4,-5,0,-1,0,0,-1,1,0,1
KR_6763498375,420,1,8,0,-1,-1,1,2,-1,2,3,0,4,4,1,5,4,0,0,0,0,5,21,-4,8,4,0,0,0,1,-1,0,-1,5,1
KR_6734424194,420,2,38,-20,9,2,5,3,2,5,3,2,3,1,2,3,1,1,1,0,0,12,-5,-4,7,3,3,0,-2,1,-1,-1,1,5,1
KR_6738882529,420,4,66,-12,15,5,5,0,1,2,1,5,5,0,3,4,1,1,2,1,0,14,-5,-2,6,4,3,0,1,1,1,1,1,5,1
KR_6695194328,420,0,50,16,0,0,0,0,3,6,3,-5,1,6,1,2,1,1,1,0,0,3,47,0,4,4,-45,0,-1,1,-1,-1,-1,5,1
KR_6601196370,420,-1,-42,-13,-7,3,6,3,-1,1,2,-3,1,4,-4,2,6,-2,1,3,0,-5,2,1,2,3,2,0,-1,1,-1,-1,-1,6,1
KR_6744988431,420,5,28,-16,6,-1,0,1,-2,0,2,0,2,2,7,11,4,2,2,0,-2,6,-15,-3,5,2,23,0,1,0,0,1,-1,0,1
KR_6759661296,420,-2,-33,-11,-2,0,1,1,0,4,4,2,2,0,-4,2,6,0,1,1,0,-6,-3,1,4,5,-2,0,0,-1,1,0,1,6,1
KR_6725571534,420,1,31,-19,6,2,4,2,-1,1,2,1,1,0,2,4,2,2,4,2,0,5,4,-2,7,5,-2,0,1,1,-1,1,1,6,1
KR_6678860407,420,0,-69,28,1,0,1,1,1,4,3,0,0,0,-1,0,1,1,1,0,0,-1,2,1,4,5,0,0,0,1,-1,0,-1,2,1
KR_6762744775,440,-2,-52,-8,-5,-9,0,9,-2,2,4,2,4,2,4,8,4,0,1,1,0,4,-2,-2,6,4,-2,0,-1,0,0,-1,-1,0,1
KR_6763772728,420,7,80,35,17,2,4,2,3,4,1,6,8,2,5,5,0,1,3,2,0,12,260,3,1,4,2,0,1,1,1,1,1,6,1
KR_6750513933,420,4,65,6,9,6,8,2,1,2,1,-2,1,3,2,3,1,2,2,0,0,8,4,4,4,8,0,0,2,1,1,1,1,4,1
KR_6633380138,420,0,55,4,1,0,2,2,1,7,6,-3,0,3,3,5,2,0,1,1,-1,7,200,-1,7,6,4,0,1,0,1,1,-1,0,1
KR_6758792419,420,2,-16,-12,10,-2,0,2,4,5,1,2,4,2,5,6,1,1,1,0,0,12,174,2,2,4,-1,0,1,-1,0,1,-1,2,1
KR_6765524917,440,2,48,33,5,3,3,0,-1,1,2,3,4,1,0,0,0,0,1,1,0,5,-3,6,2,8,-4,0,1,-1,1,1,1,3,1
KR_6713899270,420,3,23,4,5,1,2,1,-2,0,2,1,5,4,2,4,2,3,3,0,0,8,-166,-1,4,3,3,0,1,1,1,1,1,5,1
KR_6341615945,420,3,26,25,5,4,4,0,-1,3,4,3,3,0,-2,1,3,1,2,1,0,7,-36,-2,9,7,25,0,1,1,1,1,1,2,1
KR_6722597665,420,5,75,-1,9,7,8,1,-1,3,4,4,4,0,-2,1,3,1,1,0,-1,9,-5,1,4,5,0,0,1,-1,1,-1,-1,6,1
KR_6656189657,420,4,43,8,10,3,3,0,4,4,0,1,3,2,2,3,1,0,1,1,0,13,35,0,6,6,-2,0,1,1,-1,1,-1,5,1
KR_6715053555,420,-1,12,-24,-4,-2,2,4,-1,1,2,-1,3,4,-1,3,4,1,2,1,-1,-4,-5,0,3,3,-1,0,1,0,0,1,-1,0,1
KR_6649371311,420,3,130,0,3,-1,1,2,-4,1,5,1,2,1,4,5,1,3,3,0,0,1,18,0,5,5,-3,0,2,1,-1,1,-1,4,1
KR_6765868028,420,3,9,-14,1,3,4,1,2,4,2,-5,2,7,2,6,4,-1,1,2,0,6,6,-1,5,4,0,0,1,-1,-1,1,-1,1,1
KR_6743127960,420,6,134,-3,18,6,6,0,0,5,5,7,8,1,2,2,0,3,5,2,0,13,14,-1,5,4,-2,0,0,1,1,1,1,1,1
KR_6736755262,420,3,-8,11,7,3,3,0,4,7,3,1,3,2,-1,2,3,0,0,0,0,10,24,2,3,5,0,0,1,-1,1,1,1,6,1
KR_6731224064,420,5,84,40,17,4,5,1,4,8,4,-1,5,6,8,8,0,2,4,2,1,23,-6,4,3,7,0,0,1,1,1,1,1,1,1
KR_6732785244,420,2,42,-39,0,-3,2,5,-4,2,6,2,3,1,3,3,0,2,3,1,0,0,11,5,2,7,-1,0,0,1,1,1,-1,4,1
KR_6763793399,420,0,-23,-12,2,-1,0,1,2,4,2,-2,2,4,1,2,1,2,2,0,0,9,-9,-1,3,2,1,0,0,-1,0,0,1,5,1
KR_6761851296,420,3,77,4,-4,4,7,3,-2,0,2,-5,1,6,1,3,2,-2,0,2,0,-13,-161,-3,9,6,-2,0,1,-1,-1,1,1,4,1
KR_6726338439,420,6,95,52,10,0,1,1,6,6,0,0,3,3,4,4,0,0,0,0,0,13,7,-1,5,4,1,0,-1,0,-1,-1,1,0,1
KR_6759859178,420,3,72,0,9,-1,1,2,-1,3,4,8,11,3,3,3,0,0,1,1,0,3,0,0,3,3,-1,0,0,1,1,1,1,2,1
KR_6749993174,420,-3,-48,-8,-5,3,3,0,-3,1,4,3,3,0,-8,1,9,0,2,2,0,-1,-4,3,1,4,-1,0,-1,-1,1,-1,-1,5,1
KR_6678890900,420,4,6,28,7,3,4,1,1,2,1,2,2,0,1,1,0,0,0,0,0,8,-29,0,3,3,0,0,1,1,0,1,1,3,1
KR_6750154868,420,0,-8,19,6,5,5,0,-3,2,5,4,7,3,1,4,3,-1,1,2,0,6,0,4,3,7,1,0,0,1,1,1,-1,4,1
KR_6696501986,420,3,57,-12,2,0,3,3,-2,1,3,1,2,1,1,1,0,2,2,0,0,5,-24,-3,7,4,6,0,0,-1,1,1,-1,6,1
KR_6729174545,420,6,81,16,15,6,6,0,1,4,3,0,3,3,5,6,1,3,4,1,1,14,1,2,6,8,7,0,1,-1,1,1,1,4,1
KR_6751218828,420,2,79,7,11,4,5,1,3,3,0,3,3,0,1,2,1,0,1,1,1,9,-46,2,6,8,6,0,2,-1,1,1,1,4,1
KR_6753570517,420,-1,-19,9,-1,-4,1,5,-1,3,4,5,7,2,-1,1,2,0,1,1,0,2,-8,-2,4,2,4,0,0,1,-1,-1,1,6,1
KR_6761633840,440,-1,-86,19,2,-6,0,6,6,6,0,1,2,1,-1,1,2,2,4,2,0,5,22,-1,8,7,-3,0,0,1,1,1,1,6,1
KR_6756766833,420,0,15,16,4,1,3,2,-1,3,4,6,7,1,-3,1,4,1,2,1,0,-2,-6,-5,8,3,4,0,1,1,1,1,1,1,1
KR_6686752492,420,5,72,20,11,0,1,1,2,3,1,3,4,1,5,8,3,1,2,1,0,11,37,3,4,7,2,0,2,1,1,1,-1,1,1
KR_6726149174,440,0,61,12,2,0,3,3,3,4,1,-2,0,2,0,7,7,1,2,1,0,-3,-2,2,5,7,-3,0,0,-1,1,0,1,4,1
KR_6744199079,420,0,20,-33,7,2,2,0,2,5,3,3,5,2,-1,1,2,1,1,0,0,11,23,4,3,7,-3,0,-1,0,1,1,1,0,1
KR_6744079196,420,1,32,-4,1,1,2,1,-2,0,2,-3,0,3,4,5,1,1,2,1,0,4,2,2,5,7,0,0,0,0,-1,0,1,0,1
KR_6604105622,420,2,55,7,6,-2,1,3,-2,1,3,4,4,0,2,4,2,4,5,1,0,9,27,5,4,9,2,0,0,1,-1,0,1,5,1
KR_6727816224,420,6,38,-16,15,0,2,2,9,11,2,4,4,0,2,5,3,0,0,0,0,19,-2,0,6,6,4,0,0,1,-1,1,1,2,1
KR_6681003924,420,1,1,3,4,-1,0,1,5,5,0,-1,4,5,0,4,4,1,1,0,0,8,-7,-5,7,2,4,0,-2,1,-1,-1,1,6,1
KR_6753766398,420,4,17,2,5,-1,2,3,-1,0,1,5,6,1,-2,5,7,4,5,1,1,-1,9,-4,5,1,1,0,2,1,1,1,1,4,1
KR_6732039409,420,3,-50,32,-2,0,1,1,1,2,1,-1,7,8,-1,1,2,-1,1,2,0,-1,-2,-2,5,3,3,0,-2,1,-1,-1,-1,4,1
KR_6698519690,420,6,81,7,12,7,9,2,5,6,1,-2,1,3,1,1,0,1,1,0,0,11,5,3,3,6,2,0,2,1,-1,1,1,3,1
KR_6765619204,420,2,30,35,-1,3,3,0,1,1,0,1,2,1,-5,1,6,-1,0,1,0,-5,48,1,4,5,-4,0,1,1,1,1,1,5,1
KR_6689896163,420,2,-1,16,4,1,3,2,2,6,4,0,2,2,1,5,4,0,0,0,0,8,13,7,2,9,-4,0,0,-1,1,1,-1,1,1
KR_6695014268,420,5,80,37,10,4,5,1,1,6,5,7,7,0,-3,1,4,1,2,1,2,9,1,2,4,6,5,0,3,-1,1,1,1,6,1
KR_6762973967,420,3,64,2,8,0,1,1,4,5,1,2,4,2,2,2,0,0,0,0,0,6,-5,1,2,3,-6,0,0,1,-1,0,1,1,1
KR_6758142032,440,0,10,26,-7,-2,0,2,-4,0,4,1,2,1,-4,0,4,2,2,0,0,-7,4,-3,5,2,-5,0,0,-1,1,1,-1,6,1
KR_6705052548,420,2,16,-11,2,2,3,1,-1,3,4,6,6,0,-4,2,6,-1,0,1,1,-7,52,0,5,5,-17,0,1,-1,-1,1,1,3,1
KR_6705159459,420,3,-10,3,5,4,5,1,0,3,3,1,2,1,1,2,1,-1,0,1,0,5,-7,-5,9,4,2,0,2,-1,1,1,1,5,1
KR_6760158880,420,0,16,-4,9,-1,1,2,3,5,2,-1,1,2,7,8,1,1,2,1,1,18,6,2,4,6,1,0,-1,1,-1,-1,1,5,1
KR_6749647727,420,0,-54,-11,4,-2,0,2,2,2,0,-4,2,6,5,6,1,3,3,0,1,22,11,6,2,8,-9,0,-1,1,-1,-1,1,3,1
KR_6766445668,420,1,53,10,3,1,4,3,-2,2,4,-1,4,5,3,8,5,2,3,1,0,-1,19,0,3,3,1,0,0,1,1,0,-1,4,1
KR_6751294791,440,3,84,37,21,2,3,1,4,5,1,4,4,0,14,15,1,-3,1,4,0,17,-4,2,2,4,3,0,4,1,1,1,1,4,1
KR_6533978704,420,3,22,38,8,-4,1,5,0,2,2,2,5,3,6,7,1,4,5,1,0,14,8,-3,8,5,6,0,-1,1,1,-1,-1,4,1
KR_6764382019,420,-2,6,18,-2,1,1,0,-4,2,6,0,2,2,1,3,2,0,0,0,-1,-5,-4,1,5,6,0,0,-1,1,1,-1,-1,1,1
KR_6764693797,420,4,51,20,14,2,3,1,7,9,2,0,2,2,2,3,1,3,3,0,0,14,17,-3,8,5,0,0,1,1,1,1,1,4,1
KR_6760448271,420,2,19,-17,4,-2,1,3,-2,1,3,1,1,0,6,6,0,1,2,1,0,10,16,3,4,7,2,0,0,1,-1,-1,1,5,1
KR_6763448575,420,5,68,0,15,4,5,1,1,2,1,4,5,1,1,4,3,5,5,0,0,18,-217,1,3,4,4,0,0,1,-1,1,-1,4,1
KR_6648983714,420,1,-55,21,1,-2,0,2,0,1,1,-3,1,4,6,6,0,0,0,0,0,9,0,5,4,9,6,0,0,1,1,1,1,2,1
KR_6753046694,420,1,51,-12,10,2,5,3,2,2,0,6,7,1,-2,0,2,2,3,1,0,14,-5,0,4,4,3,0,1,1,1,1,1,6,1
KR_6729951277,420,-3,-47,24,2,-2,0,2,2,3,1,-1,1,2,3,6,3,0,5,5,0,1,3,3,1,4,0,0,-2,1,1,-1,1,2,1
KR_6746991647,420,2,90,0,7,3,3,0,2,5,3,-4,2,6,5,7,2,1,1,0,0,16,-6,-1,5,4,3,0,1,1,-1,1,-1,4,1
KR_6761810451,440,0,37,-43,8,0,1,1,1,4,3,3,3,0,0,1,1,4,5,1,0,7,-12,0,8,8,6,0,1,-1,1,1,1,3,1
KR_6762600012,420,0,12,4,-5,0,3,3,-1,1,2,1,1,0,-4,0,4,-1,0,1,0,-12,-28,-2,3,1,-2,0,1,-1,1,1,-1,3,1
KR_6760344725,420,1,-10,18,-2,-1,3,4,2,4,2,0,3,3,-1,4,5,-2,0,2,0,-3,73,-1,4,3,-15,0,0,1,-1,1,-1,2,1
KR_6690483663,420,0,11,7,3,1,3,2,-2,2,4,1,5,4,1,1,0,2,3,1,1,8,-12,2,4,6,-2,0,0,1,1,0,1,4,1
KR_6764881803,420,-3,-77,0,-8,0,0,0,-7,0,7,3,5,2,-4,1,5,0,1,1,0,-5,-12,-1,6,5,3,0,-1,1,-1,-1,-1,5,1
KR_6537696663,420,4,54,10,2,1,2,1,1,1,0,-5,2,7,5,7,2,0,2,2,0,4,-13,3,3,6,-1,0,1,1,-1,1,1,4,1
KR_6764293141,420,4,41,44,10,-1,2,3,0,1,1,3,3,0,3,3,0,5,5,0,0,9,114,1,2,3,4,0,2,-1,-1,1,1,1,1
KR_6651722215,440,5,27,28,9,0,0,0,3,4,1,1,2,1,4,8,4,1,2,1,0,7,12,2,1,3,-1,0,1,1,1,1,-1,6,1
KR_6726114716,420,2,33,8,6,1,3,2,1,2,1,0,3,3,3,4,1,1,2,1,0,12,3,-2,8,6,-2,0,0,1,0,1,-1,3,1
KR_6706624276,420,1,1,3,5,5,5,0,-1,2,3,2,2,0,-1,7,8,0,0,0,0,-4,8,1,4,5,-3,0,1,1,1,1,1,3,1
KR_6749803030,420,5,31,-4,15,1,4,3,3,5,2,5,5,0,4,5,1,2,2,0,0,16,5,5,1,6,0,0,2,1,1,1,1,5,1
KR_6685885970,420,0,7,44,-4,-2,2,4,5,6,1,-3,1,4,-5,2,7,1,1,0,0,-9,107,-1,6,5,-2,1,4,1,1,1,-1,1,1
KR_6718405130,420,5,112,-4,5,1,2,1,0,2,2,-3,2,5,5,5,0,2,2,0,0,9,-10,-3,6,3,4,0,2,1,1,1,1,4,1
KR_6654255555,420,3,84,32,8,1,1,0,0,3,3,2,4,2,6,7,1,-1,0,1,0,5,-177,1,4,5,2,0,2,1,1,1,1,1,1
KR_6763014028,420,3,60,-29,8,1,1,0,2,7,5,2,2,0,0,4,4,3,3,0,0,4,8,2,5,7,-3,0,1,1,1,1,1,5,1
KR_6686569438,420,2,28,12,7,-2,0,2,0,5,5,8,9,1,0,0,0,1,2,1,0,5,-29,0,4,4,-4,0,-1,-1,-1,-1,1,2,1
KR_6505464447,420,0,-7,-1,-1,-4,0,4,2,5,3,0,0,0,2,3,1,-1,0,1,0,-1,-17,-1,7,6,2,0,-1,-1,-1,-1,1,4,1
KR_6726090859,440,6,111,32,14,-8,1,9,8,8,0,2,2,0,5,12,7,7,7,0,0,16,1,-6,9,3,4,0,1,1,-1,1,1,3,1
KR_6631704119,420,-1,-36,-4,0,2,3,1,-2,2,4,0,2,2,-1,1,2,1,1,0,0,-2,-95,5,5,10,-25,0,0,-1,-1,0,-1,2,1
KR_6764415774,420,2,27,15,8,7,7,0,1,3,2,-2,1,3,-3,2,5,5,5,0,0,0,-50,-3,8,5,20,0,2,-1,1,1,1,6,1
KR_6762154633,420,0,-23,0,-6,5,5,0,-6,0,6,0,0,0,-2,0,2,-3,0,3,0,-14,-12,-9,11,2,-2,0,0,-1,1,1,-1,5,1
KR_6756602189,420,3,28,8,5,1,1,0,0,3,3,1,2,1,2,4,2,1,4,3,0,7,-3,-4,7,3,-2,0,1,0,0,1,1,0,1
KR_6728183114,420,5,4,-4,12,2,3,1,2,4,2,3,4,1,6,8,2,-1,1,2,0,5,-15,-1,5,4,1,0,3,1,1,1,1,5,1
KR_6764610347,420,1,41,-23,11,0,3,3,-1,4,5,1,3,2,10,11,1,1,1,0,0,5,4,2,5,7,-2,0,2,1,-1,1,1,3,1
KR_6683520403,420,-1,-72,20,5,2,4,2,3,7,4,-5,1,6,3,6,3,2,3,1,2,17,66,0,4,4,0,0,-1,0,1,-1,1,0,1
KR_6731307735,420,2,-16,8,3,1,2,1,0,2,2,-1,4,5,-1,1,2,4,4,0,0,-3,2,2,2,4,-1,0,1,1,1,1,1,5,1
KR_6662459310,420,5,46,-48,8,1,2,1,1,3,2,5,5,0,1,2,1,0,0,0,0,7,31,1,3,4,-10,0,0,-1,1,1,-1,1,1
KR_6627345769,420,6,109,11,23,7,8,1,5,6,1,9,11,2,1,2,1,1,2,1,1,20,3,2,3,5,3,0,4,1,0,1,1,3,1
KR_6763184593,420,6,104,-15,10,2,3,1,1,3,2,5,5,0,2,4,2,0,1,1,1,11,-1,-1,5,4,1,0,0,1,-1,1,1,1,1
KR_6764195667,420,3,31,-21,4,3,5,2,-2,0,2,2,5,3,0,1,1,1,1,0,0,3,35,-3,7,4,3,0,0,1,-1,0,-1,1,1
KR_6763131202,440,0,5,29,-1,6,8,2,-3,3,6,-1,1,2,-1,2,3,-2,0,2,1,-3,16,-4,5,1,3,0,0,1,1,0,1,1,1
KR_6742791510,420,-1,-51,-5,-4,1,4,3,0,1,1,-2,3,5,-4,1,5,1,1,0,0,-4,-30,-1,6,5,3,0,1,-1,0,1,-1,6,1
KR_6761525502,420,2,47,-18,3,-4,1,5,2,3,1,3,3,0,1,3,2,1,1,0,0,12,-6,0,5,5,3,0,0,1,-1,0,1,2,1
KR_6634028156,420,-2,45,-29,-7,0,2,2,-1,1,2,-6,1,7,-2,1,3,2,2,0,-2,-7,-19,-2,6,4,1,0,-1,-1,-1,-1,-1,1,1
KR_6753694953,420,3,37,26,3,0,1,1,3,3,0,-1,2,3,2,3,1,-1,1,2,0,3,46,3,3,6,4,0,1,1,1,1,1,3,1
KR_6563381329,420,3,34,42,-1,-1,0,1,-4,3,7,5,5,0,1,5,4,-2,0,2,-1,-16,8,-4,9,5,-5,0,0,-1,1,-1,1,2,1
KR_6742406887,440,2,91,28,2,4,5,1,-2,0,2,-4,0,4,1,1,0,3,9,6,0,-1,1,2,4,6,3,0,4,-1,-1,1,1,6,1
KR_6757139525,420,0,6,-20,2,0,0,0,-1,1,2,-1,1,2,4,5,1,0,1,1,0,2,-8,4,3,7,-2,0,0,-1,-1,1,1,1,1
KR_6762608619,420,3,-11,0,9,3,4,1,1,4,3,1,4,3,5,8,3,-1,1,2,1,3,6,8,2,10,-1,0,0,1,1,-1,1,3,1
KR_6751079129,420,2,-7,16,3,-2,0,2,-4,2,6,7,8,1,1,4,3,1,1,0,0,2,-12,-6,9,3,0,0,-1,1,-1,-1,-1,1,1
KR_6754984044,420,2,3,14,3,-7,0,7,1,2,1,4,7,3,1,3,2,4,4,0,-1,5,-7,-3,7,4,-2,0,-1,1,-1,-1,-1,2,1
KR_6749962620,420,2,30,52,3,1,3,2,-1,0,1,4,4,0,-1,1,2,0,1,1,0,-1,4,1,2,3,1,0,0,0,1,0,1,0,1
KR_6717450701,420,-3,62,12,-4,-2,1,3,3,3,0,-1,3,4,-6,1,7,2,4,2,0,-3,-126,-2,9,7,3,0,0,-1,-1,-1,-1,3,1
KR_6644094029,420,-1,-46,35,0,-5,1,6,1,4,3,4,5,1,-1,3,4,1,1,0,0,1,-4,-4,7,3,-1,0,0,1,1,0,1,6,1
KR_6729602343,420,0,37,-20,-2,0,1,1,3,5,2,-1,1,2,-2,1,3,-2,2,4,0,1,26,3,6,9,2,0,1,-1,1,1,-1,6,1
KR_6741083675,420,1,8,8,0,0,2,2,3,6,3,2,3,1,-3,0,3,-2,0,2,0,-4,-1,-1,5,4,0,0,-1,-1,0,-1,-1,6,1
KR_6762960691,420,0,-46,-10,-1,-5,2,7,1,3,2,1,4,3,1,3,2,1,1,0,-1,-4,115,1,3,4,0,0,0,1,-1,0,-1,6,1
KR_6674196874,420,1,59,-18,-6,-7,0,7,-6,1,7,3,8,5,1,3,2,3,3,0,-3,-1,52,2,1,3,-13,0,0,-1,1,1,-1,1,1
KR_6751621253,440,3,23,39,-1,8,8,0,-2,3,5,-3,2,5,-3,3,6,-1,1,2,1,1,-4,0,3,3,1,0,0,1,1,-1,1,5,1
KR_6733827288,420,2,39,21,5,1,3,2,1,3,2,-1,1,2,4,7,3,0,0,0,0,1,-6,4,5,9,0,0,2,1,-1,1,1,5,1
KR_6751129249,420,2,25,36,-1,0,3,3,-1,2,3,2,3,1,-1,1,2,-1,0,1,0,-8,-122,-2,6,4,-5,0,0,1,1,1,-1,4,1
KR_6750584613,420,1,-4,3,-2,4,6,2,2,4,2,-3,1,4,-3,5,8,-2,1,3,-1,-9,21,3,3,6,-5,0,1,1,1,1,-1,5,1
KR_6705136671,420,-2,-8,12,-7,-5,0,5,-1,3,4,0,1,1,-3,4,7,2,4,2,-2,-10,-5,-3,10,7,8,0,2,-1,1,1,1,3,1
KR_6615243183,420,3,16,31,6,3,4,1,1,2,1,0,2,2,1,2,1,1,1,0,0,8,7,4,4,8,-1,0,0,1,-1,0,-1,6,1
KR_6632354740,420,3,50,20,8,1,2,1,0,3,3,0,1,1,7,7,0,0,3,3,0,7,6,7,1,8,-4,0,0,-1,1,0,1,6,1
KR_6672458760,420,2,-33,6,6,-1,1,2,2,3,1,-2,0,2,3,3,0,4,5,1,0,11,0,-2,8,6,3,0,0,1,0,0,-1,2,1
KR_6678079100,420,2,11,7,5,11,12,1,-2,0,2,-2,1,3,-2,2,4,0,1,1,1,1,11,0,4,4,-7,0,0,1,-1,1,1,2,1
KR_6764543302,420,3,43,33,10,0,2,2,2,5,3,5,6,1,3,4,1,0,1,1,0,7,-4,-1,5,4,-1,0,2,1,1,1,1,3,1
KR_6738196158,420,5,51,24,16,6,6,0,2,4,2,2,5,3,5,6,1,1,2,1,0,16,9,1,6,7,0,0,0,-1,-1,1,-1,3,1
KR_6758397372,420,-4,-98,-18,-12,-3,0,3,-4,1,5,-2,2,4,-1,0,1,-2,0,2,0,-11,-30,3,3,6,0,0,-1,-1,-1,-1,-1,2,1
KR_6518405836,440,3,34,8,9,2,4,2,2,2,0,4,7,3,1,2,1,0,0,0,0,1,12,-1,9,8,1,0,2,0,1,1,1,0,1
KR_6697672559,420,5,44,36,17,0,1,1,1,2,1,8,9,1,6,7,1,2,3,1,2,14,4,2,4,6,4,0,4,1,1,1,1,4,1
KR_6748983011,420,-2,-41,-26,-3,-2,2,4,-3,2,5,1,1,0,2,3,1,-1,2,3,0,-3,-2,-1,5,4,-3,0,-1,1,-1,-1,-1,4,1
KR_6759965759,420,1,9,-50,2,3,3,0,-1,7,8,0,1,1,-1,2,3,1,1,0,-1,1,6,1,6,7,1,0,0,-1,1,1,-1,4,1
KR_6640979019,420,4,86,32,7,0,2,2,1,1,0,7,8,1,-1,2,3,0,1,1,0,5,2,-3,4,1,3,0,2,1,-1,1,1,1,1
KR_6700787964,420,1,10,-4,10,-2,1,3,8,8,0,-3,2,5,6,7,1,1,1,0,2,22,44,4,2,6,-16,0,0,1,1,-1,1,4,1
KR_6704470739,420,0,-17,4,0,-3,2,5,2,2,0,-3,0,3,2,3,1,2,2,0,0,4,-26,-2,7,5,4,0,0,1,-1,0,-1,4,1
KR_6747635132,420,-1,-8,-4,4,-2,2,4,-4,2,6,7,11,4,4,8,4,-1,2,3,1,5,2,1,5,6,3,0,1,-1,1,1,-1,1,1
KR_6742127203,420,2,40,-11,10,3,3,0,-1,2,3,4,4,0,3,6,3,1,1,0,1,8,-7,5,2,7,-4,0,2,1,1,1,1,3,1
KR_6627390561,420,0,27,33,0,-2,3,5,-4,2,6,-2,2,4,7,8,1,1,2,1,0,2,0,-2,8,6,5,0,1,1,-1,1,1,5,1
KR_6641601253,440,4,93,12,9,2,3,1,2,5,3,-2,1,3,4,6,2,3,3,0,0,2,1,-1,5,4,3,0,0,1,1,1,1,5,1
KR_6742066376,420,0,28,20,-1,-1,2,3,2,2,0,-2,0,2,0,2,2,0,2,2,0,-2,1,-1,6,5,0,0,0,1,-1,0,-1,6,1
KR_6755000479,420,-1,16,-24,8,-3,2,5,4,4,0,4,7,3,2,3,1,1,1,0,0,9,-18,5,3,8,2,0,-2,1,-1,-1,1,6,1
KR_6765358568,420,0,8,-7,6,-1,2,3,-1,3,4,4,6,2,4,5,1,0,0,0,0,2,114,1,3,4,-5,0,0,1,-1,-1,-1,1,1
KR_6743247471,420,3,33,-1,8,0,1,1,5,6,1,4,6,2,-2,1,3,1,2,1,0,2,-2,-3,6,3,3,0,1,1,-1,1,1,4,1
KR_6744922605,420,-2,3,-15,-3,-6,2,8,5,5,0,-1,0,1,-1,0,1,0,2,2,0,0,-1,4,4,8,-4,0,-2,1,-1,-1,1,4,1
KR_6156678251,420,1,41,1,7,2,2,0,1,3,2,1,6,5,2,3,1,1,1,0,0,11,-14,1,5,6,3,0,2,-1,1,1,1,3,1
KR_6431546262,420,1,-27,10,-2,-4,2,6,-3,1,4,1,1,0,2,3,1,2,2,0,1,4,9,-2,8,6,0,0,-1,-1,-1,-1,1,5,1
KR_6700708435,420,3,70,-1,2,-4,0,4,2,3,1,0,2,2,3,6,3,1,2,1,0,-4,-18,3,7,10,0,0,1,-1,-1,1,1,3,1
KR_6734621000,420,4,109,38,7,4,5,1,3,3,0,0,3,3,-1,3,4,1,1,0,0,-1,-1,-4,9,5,3,0,0,1,1,1,1,4,1
KR_6651522541,440,0,21,24,3,-1,2,3,-2,0,2,5,7,2,2,3,1,-1,2,3,0,-1,-2,-3,7,4,2,0,1,-1,1,1,1,5,1
KR_6753340304,420,0,-57,10,-2,1,3,2,1,1,0,0,1,1,-3,2,5,-1,1,2,0,1,-16,-2,7,5,2,0,-1,1,1,-1,-1,6,1
KR_6752823437,420,1,-50,14,10,0,1,1,8,8,0,0,2,2,2,3,1,0,0,0,2,18,16,1,7,8,-3,0,1,1,1,1,1,4,1
KR_6742342616,440,2,37,-21,9,6,7,1,1,3,2,0,2,2,0,2,2,2,3,1,0,11,-2,-1,5,4,1,0,-1,1,-1,-1,1,2,1
KR_6753651264,420,0,22,13,-3,1,5,4,0,2,2,-4,2,6,-1,2,3,1,1,0,0,-1,-38,4,3,7,18,0,0,-1,1,0,-1,2,1
KR_6738151182,420,0,49,10,-1,0,1,1,2,4,2,0,2,2,-2,2,4,-1,2,3,0,-7,108,0,8,8,8,0,0,1,-1,0,-1,5,1
KR_6752751330,440,4,153,24,6,2,2,0,1,1,0,-1,3,4,-1,0,1,5,5,0,0,8,10,3,4,7,5,0,3,1,1,1,-1,5,1
KR_6737581457,420,5,13,21,8,3,4,1,1,5,4,2,2,0,0,4,4,2,3,1,-1,0,4,0,4,4,-5,0,1,1,-1,1,-1,4,1
KR_6735863408,420,-2,21,-12,-2,2,2,0,-5,2,7,2,5,3,0,1,1,-1,0,1,0,0,1,-1,7,6,1,0,1,1,1,1,-1,4,1
KR_6761488355,420,2,17,20,-3,-1,0,1,-5,4,9,0,3,3,2,2,0,1,2,1,0,-1,-6,-1,4,3,3,0,1,1,-1,1,1,2,1
KR_6764302382,420,-4,5,-11,-7,-2,3,5,2,4,2,-2,3,5,-5,5,10,0,1,1,0,-2,7,5,5,10,-3,0,1,-1,1,1,1,2,1
KR_6763025869,420,-1,-43,12,-1,3,3,0,-5,1,6,1,4,3,1,2,1,-1,1,2,0,-2,-6,-5,6,1,-1,0,0,-1,0,-1,1,1,1
KR_6756222093,420,5,25,23,10,-2,2,4,3,4,1,1,5,4,5,6,1,3,3,0,0,16,-1,4,2,6,-2,0,2,1,1,1,1,5,1
KR_6666481304,420,0,-65,49,-2,1,4,3,-3,1,4,2,3,1,-4,1,5,2,2,0,-1,-3,5,3,2,5,1,0,0,1,1,1,-1,6,1
KR_6760361036,420,2,-10,0,5,3,3,0,0,3,3,0,1,1,-1,1,2,3,3,0,0,6,58,5,4,9,-29,0,0,0,0,0,1,0,1
KR_6757143527,420,-1,28,4,-2,1,2,1,-2,1,3,-2,4,6,-1,1,2,2,4,2,0,-5,-2,-2,4,2,1,0,0,0,1,0,-1,0,1
KR_6651911367,440,3,-1,-4,9,1,1,0,8,8,0,-3,0,3,5,9,4,-2,1,3,0,11,-5,3,2,5,0,0,1,1,1,1,-1,5,1
KR_6746332961,420,-1,-5,-28,3,2,2,0,-2,2,4,2,5,3,2,3,1,-1,0,1,0,7,132,-1,4,3,1,0,0,-1,0,0,1,2,1
KR_6731915359,420,1,-3,14,4,0,0,0,0,5,5,-3,0,3,5,6,1,2,2,0,0,8,-21,1,4,5,5,0,0,-1,0,0,-1,4,1
KR_6508532877,420,-3,-81,32,-10,-3,2,5,-2,4,6,0,2,2,-3,2,5,-2,0,2,-1,-9,0,-4,8,4,-3,0,0,-1,1,-1,-1,6,1
KR_6632151790,420,1,21,-24,2,0,2,2,-3,2,5,-2,5,7,5,7,2,2,2,0,0,-7,-8,2,1,3,3,0,-1,-1,-1,-1,-1,1,1
KR_6746015392,420,3,43,21,0,-2,2,4,2,4,2,2,3,1,-1,4,5,-1,0,1,0,4,124,1,6,7,3,0,1,1,0,1,-1,1,1
KR_6721826625,420,3,45,8,0,0,2,2,1,4,3,0,4,4,0,1,1,-1,1,2,0,1,108,-3,8,5,0,0,1,-1,1,1,-1,2,1
KR_6754270427,440,0,-74,4,2,1,2,1,5,5,0,-2,1,3,-1,1,2,-1,1,2,0,0,-1,4,3,7,0,0,0,-1,1,0,-1,6,1
KR_6647273041,440,1,77,-1,-2,-1,2,3,0,1,1,-1,2,3,2,3,1,-2,1,3,0,-2,-83,1,5,6,-2,0,1,-1,-1,1,-1,1,1
KR_6744116305,420,1,-10,-4,-1,3,5,2,0,2,2,-4,0,4,-1,3,4,1,1,0,0,0,3,-1,5,4,-1,0,0,1,1,1,1,6,1
KR_6730650711,420,-1,-85,-36,2,0,0,0,7,10,3,1,2,1,-7,0,7,1,1,0,-1,-1,45,1,6,7,-4,0,0,1,1,0,-1,5,1
KR_6683585184,420,3,43,43,0,-1,1,2,0,4,4,2,4,2,-1,2,3,0,0,0,0,-8,-6,-1,3,2,-3,0,0,-1,1,1,1,3,1
KR_6712672016,420,-2,-52,-9,-5,-4,1,5,-4,1,5,1,2,1,3,4,1,-1,2,3,0,-7,-10,2,2,4,2,0,1,-1,-1,1,1,4,1
KR_6728405507,420,2,11,12,0,-2,2,4,2,3,1,-4,0,4,3,3,0,1,1,0,0,1,2,1,5,6,-3,0,0,0,-1,0,-1,0,1
KR_6763251195,420,-1,61,-10,-3,-5,0,5,3,4,1,1,2,1,-2,2,4,0,0,0,0,2,-5,-2,6,4,4,0,0,1,1,0,1,6,1
KR_6708457632,420,6,48,17,17,3,6,3,3,6,3,2,4,2,7,8,1,2,2,0,1,12,11,4,5,9,5,0,3,1,1,1,1,6,1
KR_6650782441,420,2,-18,3,10,-2,0,2,3,5,2,0,1,1,9,10,1,0,0,0,0,10,-36,-5,7,2,3,0,0,1,-1,1,1,1,1
KR_6731502352,420,1,-36,1,3,0,3,3,1,3,2,-1,1,2,3,4,1,0,1,1,0,12,-8,3,4,7,3,0,0,1,-1,0,-1,3,1
KR_6764550352,420,1,-2,8,6,7,7,0,-4,4,8,1,3,2,1,3,2,1,3,2,0,-2,-138,-3,4,1,2,0,-1,-1,1,-1,1,5,1
KR_6712338578,420,1,0,3,3,-2,0,2,6,9,3,3,8,5,-4,0,4,0,1,1,0,10,3,0,2,2,-1,0,2,1,1,1,1,6,1
KR_6738547062,440,1,14,20,-1,-8,0,8,0,1,1,6,7,1,1,2,1,0,0,0,0,-5,8,4,3,7,-7,0,0,1,-1,1,-1,5,1
KR_6736337123,420,5,62,22,17,4,4,0,4,5,1,2,3,1,8,9,1,-1,0,1,0,12,-3,3,4,7,2,0,2,1,1,1,1,4,1
KR_6750942674,420,3,22,3,6,2,2,0,0,1,1,-4,0,4,6,7,1,2,3,1,0,5,-12,1,4,5,3,0,0,1,-1,0,1,2,1
KR_6744930692,420,3,46,8,5,0,0,0,4,5,1,-3,0,3,1,6,5,3,3,0,0,2,32,-4,7,3,-34,0,1,1,-1,1,-1,4,1
KR_6764080882,420,3,25,4,6,1,2,1,-6,0,6,4,8,4,3,4,1,4,4,0,-1,9,-2,0,5,5,2,0,1,1,1,1,-1,2,1
KR_6747677058,420,2,50,-38,10,6,7,1,3,5,2,-3,1,4,4,7,3,0,1,1,0,8,-1,6,1,7,2,0,0,-1,1,1,1,6,1
KR_6748693608,440,-4,-68,7,-6,-1,0,1,-3,3,6,-1,6,7,-4,2,6,3,3,0,0,-9,-4,-7,7,0,1,0,-1,1,0,-1,-1,5,1
KR_6759488830,420,3,14,-20,6,4,4,0,2,2,0,3,4,1,-1,3,4,-2,1,3,0,9,-5,3,4,7,2,0,0,-1,1,-1,-1,2,1
KR_6759843727,420,10,137,62,12,2,2,0,0,2,2,8,8,0,1,4,3,1,2,1,-1,-1,-4,-1,6,5,2,0,4,1,1,1,-1,4,1
KR_6758603034,420,1,71,17,2,2,3,1,1,4,3,-1,0,1,0,1,1,0,0,0,0,-3,119,1,8,9,5,0,1,1,1,1,1,4,1
KR_6643608132,420,2,51,39,-8,-1,3,4,1,2,1,0,1,1,-8,0,8,0,0,0,-1,-11,-237,-3,4,1,-3,0,0,1,-1,0,-1,6,1
KR_6758364211,420,3,63,16,13,3,5,2,4,6,2,4,5,1,3,4,1,-1,0,1,0,6,146,0,4,4,-1,0,2,1,1,1,1,4,1
KR_6732489072,420,1,31,-10,-3,-1,0,1,2,3,1,-2,0,2,-1,2,3,-1,1,2,0,1,-6,-3,8,5,-1,0,0,1,-1,0,-1,2,1
KR_6740988864,440,2,-10,-15,-1,4,5,1,-1,1,2,1,2,1,-4,1,5,-1,2,3,0,-11,-1,-2,4,2,5,0,-1,1,1,-1,1,5,1
KR_6633063798,420,4,31,7,17,1,2,1,5,6,1,1,3,2,11,11,0,-1,0,1,2,24,-9,4,5,9,5,0,1,-1,1,1,1,1,1
KR_6705852149,420,1,11,24,-1,2,2,0,-2,4,6,0,3,3,-3,4,7,2,2,0,0,-1,20,-2,5,3,2,0,1,-1,1,1,1,5,1
KR_6763083317,420,2,27,33,0,-1,0,1,-1,0,1,0,2,2,4,5,1,-2,0,2,0,-2,1,-2,5,3,0,0,0,1,-1,0,-1,1,1
KR_6717955974,420,3,42,0,3,-2,2,4,-2,1,3,5,6,1,5,7,2,-3,0,3,0,9,8,0,5,5,-1,0,1,1,1,1,1,4,1
KR_6677155675,420,-2,31,-15,-6,0,2,2,-1,3,4,1,2,1,-3,2,5,-3,0,3,0,-7,1,-3,6,3,1,0,0,-1,-1,0,-1,2,1
KR_6764077672,420,4,45,16,3,0,2,2,-1,2,3,4,5,1,0,2,2,0,2,2,0,5,-175,-1,5,4,4,0,0,-1,-1,0,1,4,1
KR_6592501767,420,-1,-30,-21,4,1,3,2,0,5,5,-1,1,2,3,4,1,1,1,0,2,3,4,3,2,5,3,0,-1,1,-1,-1,1,3,1
KR_6765376911,420,2,-27,32,3,1,2,1,2,3,1,-1,3,4,4,5,1,-3,0,3,0,-2,-4,2,5,7,-1,0,0,1,1,0,1,2,1
KR_6668961373,420,4,83,9,3,-2,0,2,-2,1,3,6,6,0,1,3,2,0,2,2,0,-2,52,6,6,12,-43,0,2,1,1,1,1,1,1
KR_6757125447,420,-2,44,0,-3,0,0,0,-1,1,2,-4,0,4,1,1,0,1,1,0,0,-2,8,0,7,7,1,0,1,-1,1,1,1,2,1
KR_6699650899,420,0,16,16,0,-4,2,6,-1,2,3,2,4,2,-1,2,3,4,4,0,0,-2,5,-2,4,2,2,0,0,1,1,0,-1,1,1
KR_6712100528,420,0,-39,37,-6,-2,0,2,-3,2,5,-1,1,2,-2,0,2,2,4,2,0,-9,47,2,3,5,-27,0,0,1,-1,-1,-1,6,1
KR_6757661818,420,0,8,31,6,-3,0,3,2,2,0,-1,3,4,5,7,2,3,4,1,0,9,0,0,8,8,-3,0,0,-1,-1,-1,-1,3,1
KR_6765338804,420,0,-37,21,-4,-4,0,4,0,4,4,0,2,2,2,5,3,-2,0,2,0,4,-1,-1,4,3,4,0,-1,1,-1,-1,-1,3,1
KR_6761737019,420,1,-11,16,4,-1,0,1,5,5,0,-1,2,3,1,2,1,0,0,0,0,10,96,3,2,5,0,0,2,1,1,1,1,4,1
KR_6671453661,420,-1,17,-36,-2,2,2,0,0,2,2,0,2,2,-3,2,5,-1,0,1,0,1,-2,-2,5,3,0,0,-1,-1,-1,-1,-1,2,1
KR_6763065779,420,1,8,9,3,2,3,1,-2,5,7,4,4,0,0,4,4,-1,0,1,0,2,8,4,5,9,-1,0,0,1,0,-1,1,3,1
KR_6686014423,440,2,37,4,7,-2,1,3,2,2,0,3,4,1,0,2,2,4,6,2,1,13,0,0,7,7,2,0,2,1,-1,1,1,6,1
KR_6750659337,420,-2,-59,-10,1,1,3,2,1,2,1,2,4,2,-2,0,2,-1,0,1,-1,-9,11,5,3,8,-1,0,0,-1,1,0,-1,2,1
KR_6419194355,420,4,72,36,-3,4,4,0,-6,0,6,-2,2,4,0,1,1,1,2,1,0,-9,-4,-4,8,4,-1,0,0,-1,-1,0,1,3,1
KR_6646348754,420,2,56,4,7,3,3,0,8,9,1,-3,1,4,0,3,3,-1,2,3,0,6,6,0,5,5,-1,0,1,1,1,1,1,5,1
KR_6762627782,420,2,68,24,1,-3,0,3,2,3,1,3,5,2,-3,0,3,2,2,0,0,4,-5,1,3,4,2,0,0,1,1,0,1,4,1
KR_6764832541,440,2,107,-19,7,1,1,0,0,1,1,2,2,0,2,4,2,2,3,1,0,9,-13,-3,5,2,1,0,0,-1,0,0,1,5,1
KR_6727993301,420,-1,-1,-24,-2,-1,2,3,1,4,3,3,6,3,-5,1,6,0,1,1,1,-10,-1,1,3,4,-7,0,1,-1,1,1,1,2,1
KR_6738100196,420,1,0,-4,4,-1,0,1,0,1,1,0,5,5,-2,2,4,7,7,0,0,-1,4,-5,6,1,6,0,1,1,-1,1,1,5,1
KR_6753296900,420,7,97,29,12,2,2,0,1,3,2,0,3,3,7,8,1,2,2,0,0,14,3,-1,6,5,1,0,3,1,1,1,1,6,1
KR_6649747212,420,1,32,1,5,2,2,0,-2,3,5,2,4,2,0,3,3,3,3,0,0,10,24,7,4,11,2,0,0,1,-1,0,-1,6,1
KR_6762642342,420,5,43,13,10,0,1,1,3,4,1,-1,0,1,8,8,0,0,0,0,0,10,5,-2,4,2,2,0,0,-1,-1,1,1,4,1
KR_6747804733,420,3,53,34,13,2,3,1,4,5,1,3,3,0,1,1,0,3,4,1,0,14,69,0,3,3,0,0,0,1,1,1,1,6,1
KR_6741123284,440,2,83,-4,3,3,4,1,0,5,5,-3,0,3,2,3,1,1,1,0,-1,1,17,-2,5,3,3,0,2,1,-1,1,-1,6,1
KR_6748376223,440,2,-40,24,5,5,6,1,-1,3,4,-1,1,2,3,7,4,-1,0,1,0,7,5,4,4,8,-3,0,0,0,1,0,-1,0,1
KR_6738994364,420,-1,36,-20,2,1,4,3,0,2,2,0,4,4,-1,3,4,2,2,0,1,4,-5,0,4,4,2,0,0,1,-1,-1,1,1,1
KR_6156057454,420,12,120,63,17,2,5,3,7,8,1,4,4,0,3,4,1,1,1,0,0,13,4,-2,4,2,3,0,4,0,1,1,-1,0,1
KR_6740738137,420,4,11,31,0,1,1,0,1,2,1,-1,0,1,1,3,2,-2,0,2,-1,-6,1,1,3,4,-4,0,1,1,1,1,-1,5,1
KR_6655854081,420,3,-10,8,10,2,4,2,-1,1,2,5,5,0,2,4,2,2,2,0,0,20,233,7,3,10,2,0,1,1,1,1,1,4,1
KR_6670957436,420,1,49,4,6,0,2,2,-1,2,3,2,4,2,5,8,3,0,2,2,0,5,3,-1,9,8,6,0,1,1,-1,1,-1,1,1
KR_6766178246,420,0,15,-28,4,1,1,0,1,3,2,3,3,0,-1,3,4,0,2,2,0,3,-4,1,4,5,1,0,1,-1,-1,1,-1,4,1
KR_6759451101,420,3,-19,17,2,-1,2,3,-2,2,4,-1,3,4,5,7,2,1,2,1,0,12,-60,1,4,5,30,0,-2,1,-1,-1,-1,2,1
KR_6749513296,420,0,19,-29,3,-1,3,4,5,5,0,4,4,0,-3,3,6,-2,0,2,1,5,5,-1,9,8,2,0,0,1,1,1,1,6,1
KR_6749362786,420,-1,5,12,4,-2,0,2,8,9,1,2,5,3,-3,1,4,-1,1,2,2,11,24,0,7,7,-5,0,0,-1,1,1,1,2,1
KR_6754086288,420,2,69,35,1,2,2,0,2,2,0,-4,0,4,1,2,1,0,0,0,0,2,-126,1,4,5,2,0,0,1,1,1,-1,2,1
KR_6700540578,420,5,61,0,9,1,1,0,0,4,4,9,9,0,3,4,1,-4,0,4,1,1,-4,-1,4,3,1,0,2,1,1,1,1,1,1
KR_6669819654,420,0,10,-9,-4,-2,1,3,-3,3,6,0,2,2,-2,3,5,3,3,0,0,7,0,-1,7,6,1,0,1,-1,-1,1,1,3,1
KR_6749868602,440,3,73,-12,5,0,2,2,-2,3,5,1,2,1,6,6,0,0,0,0,0,4,-4,0,3,3,0,0,1,-1,1,1,1,2,1
KR_6732096322,420,1,6,10,3,-3,1,4,1,3,2,1,1,0,3,4,1,1,3,2,0,1,77,6,4,10,-4,0,0,-1,1,1,1,2,1
KR_6715828688,420,0,17,-20,3,5,6,1,1,2,1,-3,1,4,0,3,3,0,0,0,0,9,24,-4,9,5,2,0,1,1,-1,1,-1,1,1
KR_6731183284,420,3,10,14,11,4,5,1,2,3,1,2,2,0,2,5,3,1,3,2,0,7,-10,3,4,7,0,0,0,1,0,0,1,5,1
KR_6755555893,420,3,-12,-3,9,-2,1,3,2,2,0,1,2,1,7,7,0,1,1,0,0,15,8,6,3,9,-6,0,-2,1,-1,-1,1,5,1
KR_6757616213,440,2,43,-2,5,-3,4,7,2,4,2,1,3,2,3,6,3,2,3,1,0,9,-241,0,3,3,1,0,2,0,-1,1,-1,0,1
KR_6715557514,420,2,-26,0,1,-2,1,3,-2,3,5,-2,1,3,7,9,2,0,0,0,0,9,4,4,1,5,-4,0,1,1,1,1,1,2,1
KR_6754291324,420,0,27,28,1,3,4,1,2,2,0,-1,1,2,-3,0,3,0,1,1,0,-1,-23,-3,10,7,1,0,-1,1,-1,-1,1,3,1
KR_6764089145,420,0,30,-32,3,2,2,0,3,5,2,-1,0,1,-1,2,3,0,0,0,0,3,-123,3,3,6,2,0,-1,1,-1,-1,1,6,1
KR_6762358342,420,-1,-14,-8,-2,0,2,2,2,3,1,1,2,1,-2,4,6,-3,0,3,1,-2,-139,7,3,10,5,0,-2,1,1,-1,1,3,1
KR_6708586665,420,10,93,56,3,2,2,0,0,1,1,-1,2,3,3,4,1,-1,1,2,0,0,91,1,3,4,7,0,1,1,1,1,1,5,1
KR_6700810570,420,0,-25,-40,0,-2,0,2,-2,1,3,-2,2,4,6,7,1,0,0,0,0,10,-6,-2,5,3,-1,0,-1,-1,-1,-1,-1,4,1
KR_6535906418,420,3,104,58,9,4,5,1,2,4,2,4,4,0,-1,1,2,0,0,0,0,-4,-40,3,6,9,3,0,0,1,1,1,1,6,1
KR_6762206142,420,3,41,-16,5,1,1,0,3,5,2,6,8,2,-4,1,5,-1,0,1,0,4,26,2,5,7,-3,0,1,-1,1,1,-1,6,1
KR_6649270941,420,2,-10,20,6,4,4,0,5,9,4,-2,1,3,-1,2,3,0,1,1,3,7,-40,2,6,8,15,0,0,1,1,0,1,3,1
KR_6731433786,420,2,-13,-2,1,-1,2,3,5,5,0,-5,1,6,3,4,1,-1,0,1,0,4,-11,2,3,5,2,0,0,1,-1,0,-1,1,1
KR_6752360271,420,1,35,26,4,1,2,1,3,5,2,-1,3,4,1,1,0,0,0,0,0,4,0,2,7,9,8,0,0,1,1,0,1,5,1
KR_6680737829,420,1,66,8,3,-3,1,4,-3,1,4,4,7,3,1,2,1,4,4,0,0,-1,45,-1,6,5,-13,0,1,1,1,1,-1,6,1
KR_6763662384,420,2,37,38,-4,0,1,1,3,5,2,-6,1,7,-3,2,5,2,2,0,0,-2,-11,-3,5,2,2,0,0,1,1,-1,1,1,1
KR_6758285949,440,1,-25,16,9,0,3,3,0,5,5,8,9,1,1,5,4,0,2,2,-1,5,118,6,1,7,-8,0,2,1,1,1,1,4,1
KR_6755292479,420,3,-11,19,2,2,2,0,0,2,2,6,6,0,-3,2,5,-3,0,3,0,-5,4,1,2,3,0,0,3,1,1,1,1,5,1
KR_6698925660,420,-2,-10,-8,1,2,2,0,1,2,1,-1,0,1,-2,2,4,1,1,0,1,-3,71,-2,5,3,0,0,0,1,-1,0,1,1,1
KR_6740519476,420,0,51,-13,2,2,2,0,-4,0,4,0,1,1,5,6,1,-1,0,1,0,0,4,-2,2,0,-1,0,0,1,-1,0,-1,6,1
KR_6764136310,420,-2,-19,-16,-7,1,2,1,-6,2,8,-1,1,2,0,1,1,-1,5,6,-1,-8,-3,-4,9,5,3,0,1,1,-1,1,-1,5,1
KR_6702113916,440,2,76,-15,12,4,6,2,5,8,3,-1,0,1,1,2,1,3,3,0,1,8,7,0,4,4,-3,0,2,1,1,1,1,3,1
KR_6749508987,420,-1,29,-7,-1,0,1,1,0,5,5,3,4,1,-2,3,5,-2,0,2,0,-4,-17,-2,8,6,0,0,1,-1,1,1,1,6,1
KR_6682071838,420,1,107,-41,2,1,3,2,5,6,1,-6,1,7,3,5,2,-1,1,2,1,9,-58,-4,11,7,8,0,0,1,1,0,1,5,1
KR_6508189391,420,4,22,18,11,6,8,2,4,6,2,-3,1,4,3,3,0,1,2,1,0,7,31,4,3,7,-4,0,1,1,1,1,1,2,1
KR_6655407824,440,-3,-36,-4,-7,-4,0,4,-1,2,3,-3,2,5,3,5,2,-2,1,3,1,-6,-1,-3,4,1,-2,0,-2,-1,1,-1,1,6,1
KR_6628801415,420,3,68,7,10,2,2,0,5,6,1,3,4,1,2,3,1,-2,0,2,0,17,1,2,4,6,3,0,1,-1,1,1,1,1,1
KR_6757856926,420,-5,-5,-32,-12,-3,2,5,-6,0,6,1,3,2,-5,1,6,1,1,0,-1,-9,-5,0,7,7,-3,0,-1,-1,1,-1,-1,4,1
KR_6763206052,420,1,44,7,0,-4,1,5,3,4,1,-1,3,4,2,2,0,0,2,2,0,-1,1,-2,6,4,3,0,-1,1,-1,-1,-1,5,1
KR_6739536559,440,4,66,12,6,-2,3,5,2,2,0,3,5,2,1,3,2,2,2,0,1,13,-6,-1,8,7,6,0,1,1,-1,1,1,6,1
KR_6703557974,420,2,31,-9,8,-1,0,1,1,4,3,2,2,0,5,5,0,1,1,0,0,18,-70,0,5,5,0,0,1,1,-1,1,1,1,1
KR_6694533400,420,4,-10,25,3,3,4,1,-1,0,1,-2,0,2,4,4,0,-1,0,1,0,-1,102,-2,9,7,-3,0,2,1,-1,1,1,2,1
KR_6724842125,420,-3,33,-8,-5,-1,2,3,-4,0,4,-2,4,6,3,4,1,-1,0,1,0,-6,25,3,5,8,3,0,-1,-1,-1,-1,-1,3,1
KR_6753018621,420,3,58,-4,10,-2,0,2,2,3,1,5,6,1,7,9,2,-2,0,2,1,9,1,4,2,6,-3,0,0,1,-1,0,1,5,1
KR_6724596754,420,4,65,-20,12,3,4,1,0,5,5,2,5,3,6,6,0,1,1,0,1,13,-8,1,5,6,1,0,3,1,0,1,1,2,1
KR_6727987916,420,2,90,-40,9,0,1,1,-3,2,5,5,5,0,1,1,0,6,6,0,0,7,1,-3,5,2,1,0,0,1,1,0,1,4,1
KR_6622309255,420,-1,-25,-28,6,3,3,0,3,3,0,1,2,1,0,4,4,-1,0,1,0,5,7,4,3,7,0,0,0,-1,1,1,-1,2,1
KR_6737885868,420,0,13,-4,2,1,2,1,-2,1,3,1,2,1,0,2,2,2,2,0,0,0,-98,3,2,5,-1,0,-1,-1,1,-1,-1,6,1
KR_6747362647,440,6,55,39,9,-4,1,5,5,6,1,7,8,1,2,3,1,-1,0,1,0,12,24,-7,10,3,8,0,1,1,1,1,-1,2,1
KR_6670356913,440,1,66,-20,4,7,7,0,-4,2,6,1,2,1,0,2,2,0,1,1,0,6,-116,4,2,6,-2,0,0,1,1,1,-1,5,1
KR_6743052350,420,0,10,-27,1,3,4,1,0,3,3,0,1,1,0,2,2,-2,0,2,-1,4,-11,1,6,7,0,0,0,1,-1,0,-1,3,1
KR_6758415173,440,2,35,24,2,2,3,1,0,1,1,0,2,2,0,0,0,0,0,0,0,-3,-2,-3,6,3,0,0,1,1,-1,1,1,6,1
KR_6756637748,440,3,93,0,3,-2,1,3,-2,0,2,5,5,0,4,4,0,-2,1,3,0,-4,4,-1,6,5,0,0,1,1,-1,1,1,3,1
KR_6732351208,420,3,3,13,8,-4,1,5,3,4,1,3,4,1,4,4,0,2,2,0,0,13,7,-3,6,3,-4,0,1,-1,1,1,-1,4,1
KR_6634854039,440,0,-3,0,1,1,4,3,-1,3,4,-2,1,3,2,3,1,1,3,2,0,5,6,-1,8,7,4,0,0,1,-1,0,1,1,1
KR_6764588184,420,3,16,0,10,9,9,0,-2,0,2,-1,0,1,3,4,1,1,1,0,0,9,155,1,5,6,-4,0,0,1,-1,0,1,3,1
KR_6705705071,420,10,78,80,20,9,9,0,3,4,1,2,3,1,5,7,2,1,1,0,1,8,-38,1,3,4,15,0,2,1,1,1,1,2,1
KR_6755064991,440,2,11,8,7,3,3,0,3,5,2,1,1,0,0,2,2,0,3,3,0,5,0,4,5,9,-3,0,0,-1,1,1,1,1,1
KR_6700904077,420,2,42,-14,5,2,2,0,2,4,2,-2,0,2,3,4,1,0,0,0,0,5,2,-7,9,2,3,0,0,-1,1,1,-1,5,1
KR_6760082778,420,5,9,28,8,0,2,2,2,5,3,-6,0,6,4,7,3,8,8,0,0,11,-6,-1,9,8,6,0,1,1,-1,-1,1,6,1
KR_6750069822,420,-3,-39,-4,-9,-3,0,3,-5,0,5,-1,2,3,-1,2,3,1,1,0,0,0,-52,-5,8,3,17,0,-1,-1,-1,-1,1,6,1
KR_6741766091,420,0,-29,-2,3,1,2,1,-1,3,4,6,6,0,-2,2,4,-1,0,1,0,4,-2,5,3,8,-2,0,-1,-1,-1,-1,-1,6,1
KR_6755613591,420,0,-5,-20,2,5,5,0,1,2,1,-1,0,1,-2,2,4,-1,0,1,0,-5,-4,-3,7,4,2,0,0,-1,1,0,1,4,1
KR_6632916238,420,-1,17,-8,3,1,2,1,3,3,0,2,2,0,-1,4,5,-2,0,2,0,0,25,2,7,9,-4,0,1,-1,-1,-1,1,1,1
KR_6756832801,440,1,28,0,4,1,1,0,0,3,3,0,2,2,4,5,1,-1,1,2,0,8,1,1,8,9,2,0,0,1,0,0,-1,5,1
KR_6654500677,420,-2,-42,16,-4,0,2,2,-1,0,1,4,5,1,-5,2,7,-2,3,5,0,-4,-3,2,4,6,-7,0,-1,1,-1,-1,1,3,1
KR_6734310748,420,2,85,-23,4,-1,1,2,1,1,0,-2,1,3,3,4,1,3,3,0,0,1,-7,-2,7,5,6,0,1,1,1,1,1,6,1
KR_6635340291,420,1,2,24,-3,-2,0,2,-1,1,2,-6,2,8,6,7,1,0,1,1,0,3,-126,-2,8,6,1,0,-2,1,-1,-1,-1,1,1
KR_6758158687,420,2,11,39,2,0,2,2,-1,2,3,3,5,2,0,3,3,0,0,0,0,-1,-6,0,4,4,1,0,2,-1,1,1,-1,5,1
KR_6728386118,440,0,74,0,-2,-2,1,3,3,3,0,-5,1,6,2,2,0,0,2,2,0,2,3,4,1,5,-1,0,0,1,-1,0,-1,6,1
KR_6749891332,420,0,-6,20,4,-2,2,4,2,3,1,5,9,4,3,4,1,-4,0,4,0,1,6,-1,2,1,-2,0,0,1,1,0,1,2,1
KR_6759583644,420,1,26,11,10,1,1,0,5,6,1,4,6,2,0,6,6,0,0,0,0,7,38,0,7,7,1,0,0,1,1,1,1,6,1
KR_6765566560,420,3,81,11,3,3,3,0,4,4,0,-6,1,7,2,2,0,0,1,1,0,1,-41,1,2,3,26,0,1,1,-1,1,1,1,1
KR_6601185710,420,3,10,-3,14,5,5,0,0,3,3,3,4,1,4,7,3,2,2,0,1,20,9,0,6,6,-2,0,1,1,1,1,1,5,1
KR_6723725691,420,-4,81,-12,-6,2,2,0,-7,1,8,4,4,0,-3,2,5,-2,0,2,0,-7,-19,3,5,8,0,0,-1,-1,-1,-1,-1,2,1
KR_6758345311,440,-1,-21,-2,0,0,2,2,-2,0,2,3,3,0,-2,1,3,1,4,3,1,2,-45,1,5,6,21,0,-2,-1,-1,-1,1,5,1
KR_6740894193,440,4,108,27,9,4,6,2,2,3,1,2,2,0,1,1,0,0,3,3,0,1,7,3,5,8,4,0,2,1,1,1,1,5,1
KR_6732671536,420,0,-11,-6,5,3,3,0,2,4,2,-4,1,5,3,5,2,1,2,1,0,3,1,-2,9,7,3,0,0,1,-1,0,-1,4,1
KR_6750787251,420,-2,29,-13,0,1,2,1,1,2,1,-3,2,5,1,5,4,0,1,1,0,-4,1,1,4,5,1,0,0,0,-1,0,1,0,1
KR_6759915147,420,9,59,96,27,-1,0,1,4,5,1,12,13,1,6,7,1,6,7,1,0,20,23,8,0,8,1,0,2,1,1,1,1,4,1
KR_6676545811,420,0,40,2,0,0,2,2,-2,3,5,0,4,4,1,1,0,1,3,2,1,-3,280,-6,8,2,4,0,0,1,-1,0,1,4,1
KR_6753637507,420,2,-10,12,0,2,4,2,-2,4,6,1,4,3,1,6,5,-2,1,3,-2,-3,-13,2,2,4,5,0,0,-1,1,1,-1,1,1
KR_6722255434,420,7,91,29,8,-1,2,3,4,5,1,-2,1,3,5,5,0,2,3,1,1,4,-4,1,7,8,5,0,2,-1,-1,1,1,6,1
KR_6738330537,440,5,57,7,5,6,6,0,0,2,2,1,3,2,-1,4,5,-1,1,2,0,7,7,1,4,5,1,0,0,0,0,1,1,0,1
KR_6717971894,420,1,37,-8,4,-1,0,1,1,5,4,1,4,3,3,5,2,0,0,0,0,5,9,3,4,7,4,0,1,1,-1,1,1,1,1
KR_6761188912,420,2,2,-36,5,5,7,2,-3,2,5,-1,4,5,2,2,0,2,2,0,0,8,7,2,1,3,-1,0,2,0,0,1,-1,0,1
KR_6746916000,420,3,104,0,9,0,1,1,1,2,1,0,3,3,5,5,0,3,3,0,0,12,-2,-3,9,6,3,0,2,1,-1,1,1,5,1
KR_6753134724,420,2,29,12,6,5,5,0,0,2,2,0,3,3,0,2,2,1,2,1,1,3,298,0,7,7,-2,0,1,1,0,1,1,4,1
KR_6634046347,420,1,-26,24,1,2,3,1,5,5,0,1,3,2,-3,4,7,-4,0,4,0,-3,18,-1,5,4,-2,0,0,1,-1,0,-1,6,1
KR_6525753458,420,0,-26,-12,4,0,2,2,4,7,3,0,3,3,-2,1,3,2,2,0,1,10,197,5,3,8,-3,0,2,1,1,1,1,2,1
KR_6740918024,420,-1,64,-13,-1,-1,1,2,-1,1,2,-1,2,3,4,6,2,-2,2,4,0,-1,11,6,4,10,3,0,1,-1,-1,1,1,2,1
KR_6764846548,420,6,35,32,8,-2,0,2,-2,1,3,3,4,1,5,7,2,4,4,0,2,6,-4,1,5,6,5,0,1,-1,1,1,1,5,1
KR_6762319319,420,0,-35,13,4,1,3,2,0,1,1,1,5,4,1,3,2,1,1,0,0,2,-28,2,1,3,31,0,0,-1,1,0,-1,4,1
KR_6753176898,420,-4,-100,18,1,-1,1,2,2,2,0,2,4,2,-1,6,7,-1,1,2,0,4,-10,-8,10,2,0,0,-1,1,-1,-1,1,4,1
KR_6765480695,420,2,6,-7,13,3,3,0,2,2,0,0,8,8,7,9,2,1,2,1,1,10,-213,3,1,4,-4,0,2,1,1,1,1,6,1
KR_6761786219,420,5,52,-10,8,2,2,0,2,3,1,2,3,1,1,3,2,1,1,0,0,7,-136,0,2,2,1,0,2,-1,1,1,-1,4,1
KR_6696462165,420,4,48,36,2,2,3,1,-2,1,3,-1,1,2,2,6,4,1,1,0,-1,-4,-2,0,8,8,5,0,0,-1,1,0,-1,2,1
KR_6656623884,420,4,22,12,13,-2,2,4,3,3,0,3,4,1,9,9,0,0,0,0,0,21,-2,0,5,5,5,0,0,1,-1,-1,1,5,1
KR_6749366424,420,-3,-33,-20,-8,-3,0,3,-5,4,9,0,3,3,-2,0,2,2,2,0,0,-3,0,-1,11,10,-3,0,-2,1,0,-1,-1,1,1
KR_6761201649,420,5,26,-8,17,4,4,0,3,4,1,1,3,2,8,9,1,1,3,2,0,23,141,-1,5,4,4,0,0,1,1,1,1,4,1
KR_6763318923,420,3,120,-5,11,-4,2,6,3,5,2,9,9,0,2,2,0,1,1,0,0,15,159,-1,3,2,3,0,2,1,-1,1,1,3,1
KR_6707131964,420,9,42,56,11,4,4,0,2,3,1,1,3,2,4,5,1,0,0,0,0,16,-27,0,4,4,6,0,3,1,-1,1,1,4,1
KR_6756903771,440,2,7,15,-2,2,3,1,0,2,2,0,2,2,-5,1,6,1,1,0,0,-8,-7,-1,7,6,3,0,0,-1,1,1,1,3,1
KR_6765307978,420,5,73,2,15,6,7,1,1,2,1,7,8,1,1,2,1,0,1,1,0,12,-19,5,4,9,1,0,2,1,1,1,1,1,1
KR_6760392752,420,1,66,-31,8,1,3,2,2,4,2,4,5,1,1,4,3,0,0,0,0,7,3,6,2,8,0,0,1,-1,-1,1,1,3,1
KR_6726495526,420,4,27,11,9,3,4,1,1,3,2,0,2,2,3,4,1,2,2,0,0,13,8,11,1,12,2,0,2,1,1,1,-1,4,1
KR_6670893625,420,2,81,16,3,-2,0,2,3,5,2,2,2,0,1,1,0,-1,0,1,0,7,33,2,2,4,-8,0,0,1,-1,0,1,1,1
KR_6764199255,420,2,10,24,5,2,2,0,3,3,0,3,5,2,-2,2,4,-1,0,1,0,8,13,1,2,3,2,0,0,1,1,1,1,1,1
KR_6669950709,420,2,68,-40,5,2,3,1,1,7,6,-5,2,7,7,8,1,0,2,2,-2,13,-7,8,3,11,-1,0,2,-1,-1,1,-1,1,1
KR_6748306434,420,2,24,5,10,2,4,2,2,4,2,5,8,3,1,4,3,0,0,0,0,13,8,0,4,4,-1,0,1,-1,1,1,1,1,1
KR_6756672321,420,-1,-14,-12,0,3,3,0,6,6,0,-7,0,7,-1,1,2,-1,0,1,0,5,0,2,2,4,-5,0,-1,-1,-1,-1,1,1,1
KR_6765403614,420,2,9,1,7,0,3,3,2,3,1,8,9,1,-1,4,5,-2,0,2,0,8,-23,1,4,5,0,0,0,1,0,0,1,2,1
KR_6706128416,420,4,63,13,10,5,5,0,2,4,2,2,3,1,0,3,3,1,3,2,0,7,0,2,6,8,5,0,1,-1,1,1,-1,6,1
KR_6746780323,420,0,-12,-3,5,2,4,2,5,9,4,0,2,2,-1,2,3,-1,1,2,1,6,1,1,6,7,-3,0,1,-1,1,1,1,1,1
KR_6753533042,420,5,92,16,10,3,3,0,0,2,2,5,7,2,3,3,0,-1,0,1,1,3,5,3,2,5,0,0,2,1,1,1,1,4,1
KR_6760112429,420,0,49,-16,7,0,2,2,4,6,2,0,5,5,2,4,2,1,3,2,0,4,-29,-1,7,6,1,0,1,1,1,1,-1,6,1
KR_6529337221,420,4,95,32,7,1,2,1,2,2,0,1,4,3,4,4,0,-1,0,1,0,5,-11,5,2,7,27,0,2,1,-1,1,1,2,1
KR_6646660225,420,1,23,9,7,5,5,0,1,1,0,-1,3,4,2,2,0,0,0,0,0,11,-24,-2,7,5,2,0,2,1,1,1,1,6,1
KR_6701543766,440,-3,-29,-34,2,5,9,4,0,1,1,-1,1,2,-1,2,3,-1,0,1,0,10,7,3,2,5,0,0,0,-1,-1,-1,-1,6,1
KR_6762638597,420,2,37,43,1,4,5,1,-1,2,3,-1,2,3,-1,2,3,0,0,0,-1,-9,-6,-1,8,7,4,0,0,-1,1,1,-1,3,1
KR_6764191403,420,0,2,-16,2,0,0,0,1,2,1,0,2,2,1,3,2,0,4,4,0,3,2,-1,6,5,1,0,0,1,-1,1,1,6,1
KR_6763536657,420,0,14,-20,4,-2,2,4,3,4,1,8,8,0,0,1,1,-5,0,5,0,6,0,-1,5,4,4,0,-1,1,-1,-1,1,4,1
KR_6759184000,420,7,70,0,16,1,3,2,5,6,1,3,3,0,6,10,4,1,2,1,-1,5,-15,0,6,6,4,0,0,1,-1,1,-1,4,1
KR_6615352760,420,2,29,-4,10,3,5,2,0,1,1,2,4,2,0,3,3,5,5,0,0,5,23,4,4,8,-2,0,-1,1,-1,-1,1,3,1
KR_6604090200,420,-1,0,14,-9,-1,1,2,-1,1,2,1,4,3,-7,3,10,-1,0,1,-1,-6,3,-4,11,7,-1,0,-2,0,-1,-1,-1,0,1
KR_6759130499,420,3,48,-12,13,4,4,0,2,3,1,3,5,2,5,8,3,-1,2,3,0,13,8,2,2,4,-3,0,3,1,1,1,-1,2,1
KR_6764299445,440,3,27,14,4,-1,0,1,1,2,1,4,4,0,0,1,1,0,4,4,0,2,4,5,4,9,0,0,1,1,-1,1,-1,4,1
KR_6748337034,440,2,0,-12,9,4,5,1,2,3,1,2,4,2,5,7,2,-4,0,4,0,10,2,3,1,4,2,0,1,1,0,1,1,6,1
KR_6749546060,420,-3,-62,-14,-2,2,3,1,0,5,5,-1,0,1,-3,1,4,0,0,0,0,-1,-12,0,8,8,3,0,-2,-1,1,-1,1,4,1
KR_6662724476,420,1,63,-20,7,3,3,0,1,3,2,1,3,2,2,4,2,0,1,1,0,3,-3,2,1,3,-2,0,0,-1,-1,1,1,6,1
KR_6738174537,420,0,-31,-4,-4,-1,3,4,-4,2,6,-1,0,1,3,4,1,-1,0,1,0,-1,1,2,1,3,-2,0,0,-1,-1,0,1,4,1
KR_6658787277,420,0,7,20,0,1,2,1,2,2,0,1,3,2,-1,2,3,-3,0,3,0,2,26,3,5,8,-3,0,0,1,-1,0,-1,3,1
KR_6727383456,420,0,30,2,8,-1,0,1,0,1,1,0,1,1,4,4,0,5,7,2,0,10,3,1,4,5,1,0,0,1,1,0,1,4,1
KR_6746616969,420,-1,14,-9,0,-2,0,2,1,2,1,-1,2,3,1,3,2,1,1,0,1,1,-3,-4,11,7,1,0,0,0,-1,0,1,0,1
KR_6732281308,420,2,52,26,5,1,6,5,-1,1,2,1,2,1,4,4,0,0,0,0,0,-2,-6,0,4,4,4,0,0,1,-1,0,1,1,1
KR_6665346363,420,1,38,0,3,0,0,0,5,5,0,-1,2,3,1,2,1,-2,0,2,0,0,-201,-1,5,4,-1,0,1,1,-1,-1,1,1,1
KR_6765892755,420,4,56,7,12,5,5,0,4,4,0,2,4,2,1,1,0,0,0,0,0,8,7,3,4,7,-5,0,3,1,1,1,1,4,1
KR_6760086213,420,2,-60,6,2,0,3,3,0,3,3,2,2,0,1,4,3,-1,0,1,0,3,-5,5,5,10,-3,0,0,1,1,0,1,4,1
KR_6639731430,420,-1,-27,-21,-3,0,1,1,-5,1,6,0,2,2,1,5,4,1,3,2,1,-3,1,0,5,5,0,0,-1,1,-1,-1,1,4,1
KR_6510670813,420,0,-14,-3,-5,1,1,0,-2,1,3,-6,0,6,2,2,0,0,0,0,0,-2,0,3,5,8,-4,0,0,-1,-1,0,-1,2,1
KR_6734610521,440,1,21,-15,7,2,4,2,1,3,2,3,3,0,1,4,3,0,0,0,0,7,1,2,2,4,2,0,0,1,1,0,1,5,1
KR_6758867328,420,2,46,21,1,0,1,1,-2,1,3,6,6,0,-3,2,5,0,0,0,0,-5,-5,-3,5,2,-1,0,1,-1,1,1,1,6,1
KR_6741824371,420,0,-29,-5,2,-1,3,4,5,10,5,-2,0,2,0,4,4,0,0,0,2,12,-279,-1,7,6,-3,0,2,-1,1,1,1,5,1
KR_6761152943,420,3,25,6,6,1,2,1,6,10,4,-2,1,3,1,3,2,0,1,1,0,5,-1,-3,6,3,1,0,1,1,-1,1,1,6,1
KR_6751350615,440,3,56,11,6,1,4,3,1,3,2,-1,0,1,5,10,5,0,1,1,1,6,128,0,3,3,-3,0,1,0,0,1,1,0,1
KR_6732025551,420,1,-66,-1,1,1,2,1,0,4,4,1,2,1,-3,0,3,2,2,0,0,4,10,-1,6,5,2,0,-1,-1,-1,-1,-1,2,1
KR_6748684100,420,1,16,3,6,2,3,1,3,3,0,-1,0,1,3,5,2,-1,1,2,0,12,-110,-2,8,6,0,0,0,-1,1,0,1,4,1
KR_6678320315,420,5,105,71,5,6,6,0,2,5,3,-1,3,4,0,4,4,-2,0,2,0,-6,336,2,3,5,1,0,2,1,1,1,1,5,1
KR_6744202445,420,-2,-8,-7,-3,-2,1,3,-2,2,4,1,4,3,5,8,3,-5,1,6,0,-5,-10,-1,7,6,-3,0,-1,1,-1,-1,1,1,1
KR_6678386849,420,-3,-63,20,-5,-1,0,1,0,2,2,0,2,2,-3,1,4,-1,0,1,0,-7,-64,2,5,7,26,0,-1,1,-1,-1,-1,1,1
KR_6765757442,420,2,-34,4,-3,-3,0,3,1,6,5,2,3,1,-2,1,3,-1,0,1,-3,-7,11,1,5,6,4,0,0,1,-1,0,-1,4,1
KR_6688677916,420,3,78,3,7,3,3,0,3,6,3,0,3,3,-1,6,7,2,3,1,0,14,21,-3,9,6,-2,0,0,1,-1,0,-1,6,1
KR_6716474822,420,-3,24,-16,-9,0,2,2,-4,1,5,-4,3,7,0,5,5,-1,0,1,0,-12,35,4,4,8,2,0,0,1,-1,-1,1,3,1
KR_6754029905,420,1,6,8,5,4,6,2,1,2,1,2,4,2,2,3,1,-4,0,4,0,-1,16,4,3,7,-2,0,0,1,0,-1,-1,3,1
KR_6738168133,420,-5,-26,-9,-9,0,2,2,-1,3,4,-3,1,4,-5,0,5,0,0,0,0,-9,-8,-4,7,3,-4,0,-2,-1,-1,-1,1,1,1
KR_6764114634,420,-1,-36,-16,2,0,1,1,4,4,0,-3,0,3,2,3,1,-1,0,1,0,2,-14,2,5,7,0,0,-1,-1,1,-1,-1,1,1
KR_6753759133,440,0,58,19,0,1,1,0,-1,7,8,1,1,0,1,2,1,-2,0,2,0,3,-19,-2,6,4,3,0,1,-1,1,1,1,1,1
KR_6736341397,420,3,54,26,5,1,1,0,3,4,1,1,2,1,1,1,0,-1,1,2,0,2,-2,2,4,6,-2,0,0,1,1,0,1,5,1
KR_6652556235,420,1,1,24,-1,2,2,0,-4,1,5,0,0,0,2,2,0,-1,0,1,0,-2,175,2,7,9,-5,0,1,0,1,1,-1,0,1
KR_6505791973,420,1,-14,16,4,-1,2,3,0,1,1,0,2,2,6,6,0,-1,1,2,0,14,-2,-1,7,6,3,0,1,1,1,1,-1,1,1
KR_6743111931,420,6,115,-16,14,2,3,1,4,4,0,-1,1,2,8,10,2,1,2,1,0,16,16,5,2,7,2,2,7,1,-1,1,1,1,1
KR_6706363950,420,2,3,6,2,0,1,1,2,3,1,-1,0,1,1,3,2,0,0,0,0,7,4,1,7,8,-4,0,0,1,1,0,-1,4,1
KR_6724606938,420,3,42,-7,3,2,4,2,1,4,3,0,0,0,0,1,1,0,0,0,0,2,-6,3,2,5,4,0,3,1,1,1,-1,5,1
KR_6703600758,420,-2,9,31,-3,-1,2,3,-1,1,2,0,4,4,-1,1,2,0,0,0,0,-6,-179,3,4,7,-17,0,0,-1,1,1,1,6,1
KR_6752143295,420,3,42,-3,2,3,5,2,2,2,0,-2,0,2,1,5,4,-2,0,2,0,-5,81,1,8,9,1,0,1,1,-1,1,1,5,1
KR_6738086664,440,1,-12,-5,0,-1,1,2,-2,0,2,3,3,0,2,2,0,-2,0,2,0,-1,4,-1,2,1,3,0,1,-1,1,1,1,3,1
KR_6746900161,420,2,8,12,3,3,5,2,-1,1,2,-3,1,4,3,4,1,1,2,1,0,1,-1,-5,7,2,-2,0,2,1,-1,-1,-1,2,1
KR_6733642354,420,3,75,8,5,4,4,0,0,1,1,-1,2,3,3,3,0,-1,0,1,-1,0,10,3,2,5,0,0,1,1,-1,1,-1,2,1
KR_6725593461,420,0,-41,4,4,1,1,0,6,8,2,-1,1,2,-2,0,2,0,1,1,0,12,-6,-3,7,4,-5,0,-2,1,-1,-1,-1,2,1
KR_6342069443,420,4,79,0,1,2,3,1,1,2,1,0,1,1,-2,0,2,0,0,0,0,-3,-22,-1,9,8,9,0,-1,1,-1,1,1,2,1
KR_6595079179,420,1,49,-3,2,-1,0,1,-1,1,2,-1,2,3,4,5,1,1,2,1,0,8,-173,-5,5,0,3,0,0,-1,-1,-1,-1,6,1
KR_6750195461,420,2,40,28,1,3,3,0,-4,1,5,2,4,2,-1,4,5,1,2,1,2,-8,-7,3,4,7,4,0,0,-1,1,1,1,3,1
KR_6685714664,420,0,-45,3,3,-1,1,2,-1,5,6,0,0,0,3,5,2,2,3,1,-1,7,4,2,5,7,1,0,1,-1,1,1,-1,4,1
KR_6725724599,420,0,-23,0,1,0,2,2,1,2,1,-1,2,3,2,4,2,-1,0,1,1,-3,8,-5,7,2,-1,0,1,-1,1,1,1,6,1
KR_6734245444,420,2,75,24,-4,-4,1,5,-1,3,4,-4,1,5,4,6,2,1,2,1,0,-5,0,5,2,7,-2,0,1,1,1,1,-1,1,1
KR_6712384815,420,-2,-9,-11,4,-3,0,3,1,2,1,4,4,0,1,2,1,1,2,1,0,8,71,3,1,4,2,0,-1,1,-1,-1,1,4,1
KR_6759030548,420,2,23,19,0,3,3,0,-1,1,2,-2,1,3,0,1,1,0,1,1,0,-8,-7,-3,6,3,1,0,0,-1,1,0,-1,4,1
KR_6508167505,420,2,54,-1,5,-1,1,2,-3,2,5,6,7,1,3,3,0,0,0,0,0,6,-5,3,5,8,2,0,0,1,-1,0,-1,4,1
KR_6606774409,420,-1,-41,-39,0,-3,1,4,2,4,2,0,3,3,0,1,1,1,1,0,0,6,-5,0,3,3,0,0,2,-1,-1,1,-1,2,1
KR_6655300167,420,-1,-43,-14,-1,1,2,1,2,3,1,1,2,1,-2,1,3,-3,1,4,0,2,3,-3,6,3,-3,0,0,1,-1,-1,-1,6,1
KR_6745973403,420,0,-29,-1,1,-2,0,2,1,3,2,-4,0,4,6,7,1,0,0,0,0,6,2,4,3,7,-5,0,0,1,1,1,-1,5,1
KR_6688708519,420,3,39,-4,3,0,3,3,0,2,2,2,3,1,2,3,1,-1,1,2,0,-1,-2,1,4,5,2,0,0,-1,1,1,1,5,1
KR_6734697710,420,-2,-7,16,-3,-2,2,4,1,3,2,2,4,2,-3,0,3,-1,0,1,0,-3,8,1,4,5,1,0,0,1,-1,0,-1,5,1
KR_6765510979,420,0,12,-21,4,0,2,2,1,1,0,3,3,0,1,4,3,-1,1,2,0,-3,2,5,5,10,1,0,0,-1,1,-1,-1,6,1
KR_6710070293,420,-1,-28,-5,2,-2,0,2,2,4,2,5,7,2,1,4,3,-4,0,4,0,3,-2,1,4,5,-2,0,0,-1,1,-1,-1,3,1
KR_6682665180,420,3,13,6,7,2,4,2,0,2,2,3,3,0,2,2,0,0,1,1,0,11,-4,-2,8,6,2,0,0,0,1,0,-1,0,1
KR_6750959569,420,3,49,16,7,1,2,1,3,5,2,1,2,1,2,3,1,0,0,0,1,12,28,2,6,8,1,0,-1,1,-1,-1,1,5,1
KR_6737335401,420,3,21,8,8,7,7,0,1,3,2,1,4,3,-2,1,3,1,2,1,-1,3,8,3,2,5,3,0,0,-1,1,1,-1,2,1
KR_6757026032,420,4,123,22,12,-3,3,6,5,5,0,7,9,2,2,3,1,1,1,0,1,16,5,3,4,7,-1,0,4,0,1,1,1,0,1
KR_6757074381,420,2,13,0,1,1,2,1,1,5,4,-4,0,4,0,2,2,3,4,1,-1,4,15,-6,7,1,5,0,0,0,-1,0,-1,0,1
KR_6696419186,420,3,10,20,7,2,4,2,3,6,3,3,4,1,-1,1,2,0,1,1,0,9,22,3,4,7,-3,0,1,1,-1,1,-1,3,1
KR_6707475131,420,3,73,-8,4,3,3,0,0,4,4,0,2,2,2,4,2,-1,1,2,0,-8,12,2,2,4,-1,0,1,1,-1,1,1,2,1
KR_6687091852,420,-2,-70,10,-6,-4,2,6,0,4,4,0,4,4,0,2,2,-2,0,2,0,5,-134,-3,7,4,-1,0,0,1,-1,0,1,5,1
KR_6743837994,420,0,-9,-9,3,-2,1,3,-1,2,3,1,1,0,3,4,1,2,2,0,0,4,-7,-2,6,4,3,0,1,1,-1,1,1,6,1
KR_6764173194,420,-1,4,4,-3,0,1,1,-2,0,2,4,4,0,-2,1,3,-3,0,3,0,-4,104,0,6,6,1,0,-2,1,-1,-1,-1,1,1
KR_6728311045,420,4,-32,10,11,3,3,0,0,1,1,1,3,2,8,9,1,-1,0,1,0,13,5,0,7,7,1,0,1,1,1,1,1,4,1
KR_6704253184,420,1,-64,-10,5,-2,1,3,1,6,5,2,2,0,1,2,1,3,3,0,0,4,9,2,5,7,-1,0,0,-1,1,0,-1,5,1
KR_6340768261,420,2,5,-16,11,4,7,3,-1,0,1,4,6,2,4,7,3,0,1,1,0,10,-29,4,4,8,28,0,1,1,-1,1,-1,3,1
KR_6759827564,440,0,-48,6,0,0,1,1,-3,1,4,1,3,2,3,9,6,-1,2,3,0,2,-195,0,5,5,-8,0,-3,1,0,-1,1,6,1
KR_6750260200,420,0,-35,3,0,1,2,1,3,3,0,-3,0,3,-1,2,3,0,1,1,0,-5,0,2,3,5,-1,0,1,1,-1,1,1,4,1
KR_6735823044,440,6,40,-8,10,2,2,0,1,2,1,5,6,1,3,4,1,-1,0,1,-1,12,12,1,3,4,0,0,1,1,1,1,-1,5,1
KR_6739195747,420,7,131,20,11,3,5,2,5,6,1,7,7,0,-3,2,5,-1,0,1,1,-1,-55,-2,5,3,3,0,1,1,1,1,1,2,1
KR_6745144128,420,0,33,-1,2,-3,2,5,1,2,1,-1,1,2,3,5,2,2,3,1,0,2,4,2,4,6,-2,0,-1,-1,-1,-1,-1,4,1
KR_6766155637,420,2,57,7,-2,1,1,0,-3,1,4,-1,3,4,-1,1,2,2,3,1,2,-8,-29,-4,9,5,0,0,0,-1,1,0,1,1,1
KR_6765167936,420,2,38,-12,10,3,3,0,3,5,2,2,6,4,2,2,0,0,4,4,0,13,40,1,3,4,-3,0,0,-1,1,1,1,1,1
KR_6764408000,420,2,18,-14,5,0,0,0,-2,0,2,2,3,1,3,4,1,2,2,0,0,7,50,-4,7,3,4,0,1,1,0,1,-1,6,1
KR_6665285919,420,3,70,20,-1,2,3,1,-1,1,2,-1,3,4,-2,2,4,1,1,0,0,-3,8,0,4,4,-1,0,1,1,1,1,-1,3,1
KR_6645863941,420,2,48,26,15,0,1,1,5,7,2,1,5,4,6,6,0,3,3,0,0,14,-5,-1,3,2,5,0,2,1,1,1,1,6,1
KR_6746923226,420,1,45,0,5,3,3,0,-1,2,3,0,2,2,3,6,3,0,1,1,0,5,-2,-2,5,3,1,0,1,-1,-1,1,1,2,1
KR_6712193820,420,0,15,12,2,7,7,0,4,8,4,-3,1,4,-6,1,7,0,1,1,1,-11,-114,0,5,5,1,0,0,-1,1,1,1,4,1
KR_6755443780,420,-2,-1,-32,-5,-1,1,2,2,3,1,1,3,2,-6,0,6,-1,0,1,0,-5,27,-7,10,3,-2,0,0,1,1,1,1,5,1
KR_6604018373,440,1,7,9,2,1,1,0,4,8,4,0,0,0,1,2,1,-4,0,4,-1,2,2,-5,8,3,4,0,1,1,1,1,-1,3,1
KR_6765580538,420,6,32,-4,26,9,11,2,0,2,2,5,7,2,9,11,2,3,3,0,1,24,9,0,3,3,-2,0,2,1,0,1,1,5,1
KR_6739061920,420,-2,-73,3,5,-4,0,4,2,3,1,7,9,2,2,4,2,-2,0,2,0,6,1,3,1,4,-3,0,1,-1,-1,-1,-1,1,1
KR_6644783616,420,3,98,-4,5,3,3,0,-5,1,6,5,5,0,1,3,2,1,1,0,1,2,-5,-6,10,4,3,0,1,1,-1,1,1,5,1
KR_6559167152,420,-2,-17,-14,-2,-4,0,4,3,4,1,1,1,0,-1,2,3,-1,0,1,0,2,3,-2,4,2,-4,0,-1,1,-1,-1,-1,2,1
KR_6656166921,420,3,47,46,12,-2,0,2,2,2,0,4,5,1,8,9,1,0,1,1,0,10,-5,0,7,7,7,0,2,1,1,1,-1,5,1
KR_6652617175,420,-1,34,16,-1,4,4,0,2,4,2,1,1,0,-3,2,5,-5,0,5,0,-7,-13,0,4,4,0,0,1,1,1,1,1,6,1
KR_6725308608,420,2,5,-16,4,1,2,1,-1,3,4,5,7,2,-1,1,2,0,2,2,-1,1,12,1,4,5,2,0,0,-1,1,1,-1,2,1
KR_6766393020,440,-1,-15,15,5,0,2,2,4,4,0,-1,5,6,3,4,1,-1,2,3,1,14,-70,4,0,4,0,0,1,-1,1,1,1,5,1
KR_6716858425,420,5,108,10,8,-2,2,4,3,3,0,5,6,1,0,1,1,2,3,1,0,5,43,2,3,5,-13,0,2,1,1,1,1,1,1
KR_6729083102,420,3,29,0,4,1,1,0,4,5,1,-3,2,5,2,4,2,0,1,1,0,0,49,6,4,10,-17,0,1,-1,1,1,1,5,1
KR_6678913713,420,3,54,24,12,1,2,1,1,3,2,8,8,0,1,4,3,1,1,0,1,9,5,6,1,7,1,0,2,1,1,1,1,3,1
KR_6741140751,440,4,33,-8,16,8,8,0,-1,1,2,0,4,4,11,11,0,-2,1,3,1,14,-7,2,3,5,2,0,1,-1,1,1,1,1,1
KR_6724813271,420,4,60,-8,0,2,4,2,-3,2,5,1,4,3,-1,0,1,1,1,0,0,-2,-2,-1,4,3,1,0,0,0,-1,0,1,0,1
KR_6745461181,420,4,45,16,7,-1,0,1,3,4,1,0,2,2,5,6,1,0,1,1,1,6,0,-1,5,4,5,0,1,1,1,1,1,2,1
KR_6757145843,420,3,74,18,7,-1,3,4,0,2,2,2,2,0,5,8,3,1,2,1,0,9,0,-1,3,2,4,0,1,1,-1,1,1,2,1
KR_6688533967,420,1,-2,6,6,-7,0,7,3,5,2,2,2,0,5,7,2,3,3,0,0,9,40,-1,6,5,-12,0,-1,-1,1,-1,1,2,1
KR_6756885860,420,3,74,-4,5,4,4,0,1,3,2,3,3,0,-5,1,6,2,2,0,0,3,3,-1,6,5,-2,0,-1,1,-1,-1,-1,2,1
KR_6766236212,420,3,42,-11,3,1,2,1,-1,2,3,1,3,2,2,5,3,0,1,1,0,3,16,4,2,6,-3,0,-1,-1,-1,-1,1,2,1
KR_6752046008,420,3,31,16,3,-1,1,2,0,4,4,0,1,1,5,5,0,-1,3,4,0,9,349,0,5,5,0,0,0,1,-1,0,-1,6,1
KR_6763303938,420,-3,-60,6,1,1,1,0,-1,0,1,0,1,1,-1,2,3,2,2,0,0,4,-23,-6,6,0,25,0,-1,-1,-1,-1,1,2,1
KR_6761314557,420,1,50,-4,-2,3,3,0,0,1,1,-5,2,7,0,0,0,0,0,0,0,-2,170,-2,12,10,-3,0,1,1,1,1,-1,4,1
KR_6746978534,420,0,15,-12,2,-1,0,1,2,3,1,4,5,1,0,3,3,-3,0,3,-1,2,22,6,0,6,-1,0,0,-1,1,0,-1,5,1
KR_6763178718,420,4,109,-12,4,-3,2,5,3,5,2,1,2,1,3,5,2,0,1,1,-1,9,2,1,5,6,2,0,1,-1,1,1,-1,5,1
KR_6751683452,440,4,40,7,5,5,5,0,-3,3,6,3,6,3,1,1,0,-1,1,2,0,2,-42,-3,6,3,21,0,2,1,0,1,-1,1,1
KR_6603894797,440,2,49,4,6,1,2,1,-2,3,5,1,3,2,-1,2,3,7,8,1,1,6,17,1,5,6,3,0,2,1,-1,1,1,4,1
KR_6756618393,420,1,-29,24,4,-1,2,3,2,3,1,-3,1,4,4,6,2,2,2,0,0,7,-2,-2,5,3,4,0,0,1,1,-1,1,4,1
KR_6716468663,420,0,25,-10,4,2,4,2,-2,1,3,2,2,0,2,2,0,0,3,3,0,1,62,2,5,7,-15,0,0,1,1,0,-1,6,1
KR_6745855210,420,0,-69,0,-1,-2,2,4,1,2,1,-4,2,6,4,6,2,0,0,0,1,12,-1,4,4,8,4,0,-1,1,-1,-1,1,5,1
KR_6729726359,420,4,20,16,10,0,2,2,3,4,1,2,4,2,2,3,1,3,3,0,0,14,4,2,1,3,-2,0,0,1,-1,0,-1,1,1
KR_6660608372,440,7,56,36,18,4,5,1,3,5,2,9,10,1,0,1,1,2,2,0,0,12,5,-1,7,6,-2,0,1,1,1,1,1,2,1
KR_6759373029,420,3,22,4,5,6,6,0,-3,0,3,-2,5,7,2,2,0,2,3,1,0,-2,18,-2,4,2,-1,0,1,-1,-1,1,1,3,1
KR_6761318425,440,0,-49,12,10,-4,0,4,-1,3,4,8,8,0,2,6,4,5,7,2,0,5,-4,-5,5,0,-1,0,0,0,0,1,1,0,1
KR_6760561291,420,-1,43,-13,0,1,1,0,-2,0,2,0,2,2,5,5,0,-4,1,5,0,2,-8,-1,5,4,2,0,-1,-1,-1,-1,1,6,1
KR_6760154245,420,0,107,-28,5,3,6,3,-3,0,3,3,4,1,-1,3,4,3,3,0,0,-1,311,0,2,2,0,0,0,1,-1,-1,1,4,1
KR_6740216852,420,2,13,17,5,-1,1,2,9,11,2,0,3,3,-3,1,4,0,1,1,0,5,-6,0,4,4,3,0,1,1,1,1,1,1,1
KR_6651829475,440,-1,-15,-12,2,-2,1,3,0,3,3,-5,0,5,8,10,2,1,1,0,-2,11,-18,-1,5,4,0,0,-1,1,-1,-1,-1,1,1
KR_6638984225,420,6,108,56,10,1,4,3,2,6,4,0,2,2,7,8,1,0,1,1,0,14,292,-4,8,4,9,0,2,1,1,1,1,1,1
KR_6632672792,420,5,72,-6,6,0,1,1,6,7,1,0,3,3,1,3,2,-1,0,1,0,10,13,-1,5,4,3,0,0,1,1,1,-1,1,1
KR_6765499417,420,5,69,24,9,2,4,2,-2,1,3,1,3,2,3,5,2,5,7,2,0,13,10,0,3,3,2,0,1,-1,-1,1,-1,4,1
KR_6749325184,420,3,26,4,14,3,3,0,1,1,0,4,5,1,5,5,0,1,1,0,0,15,-27,1,6,7,16,0,2,0,1,1,1,0,1
KR_6665492303,420,-1,24,5,-1,0,1,1,-1,5,6,0,2,2,0,2,2,0,0,0,0,-7,10,0,3,3,6,0,1,-1,1,1,-1,6,1
KR_6753813901,420,2,-49,10,-1,1,2,1,3,6,3,-4,2,6,-2,2,4,1,1,0,-1,-4,194,5,3,8,-2,0,0,1,1,1,-1,3,1
KR_6676739864,420,-2,-49,-43,-12,-3,0,3,-1,1,2,-2,3,5,1,5,4,-7,0,7,0,-12,-23,-1,5,4,-4,0,1,1,1,1,1,2,1
KR_6762032588,420,2,-94,29,0,0,2,2,2,7,5,0,1,1,-2,2,4,0,2,2,0,-1,4,1,5,6,-2,0,0,1,-1,-1,-1,4,1
KR_6759910335,440,-1,38,-8,-9,0,2,2,-4,4,8,0,1,1,-4,0,4,-1,4,5,0,-19,1,-1,7,6,0,0,0,-1,1,1,1,3,1
KR_6729032990,420,1,12,26,0,0,1,1,0,1,1,0,2,2,0,1,1,0,0,0,0,-1,1,1,3,4,0,0,0,1,-1,0,1,2,1
KR_6736868277,420,2,57,-7,5,-6,2,8,4,6,2,2,4,2,5,5,0,0,0,0,3,13,118,1,9,10,3,0,0,-1,-1,1,1,3,1
KR_6749397077,420,5,47,24,11,0,1,1,3,3,0,3,4,1,4,4,0,1,3,2,0,12,-95,-1,5,4,1,0,1,1,1,1,1,4,1
KR_6758334831,440,1,-61,9,-2,0,1,1,0,5,5,1,2,1,-1,2,3,-2,2,4,0,2,22,0,5,5,-5,0,0,-1,1,0,-1,4,1
KR_6760889850,420,2,31,25,1,3,4,1,-1,1,2,1,1,0,0,2,2,-2,1,3,0,-3,114,-1,5,4,-3,0,1,-1,1,1,1,4,1
KR_6730618436,420,1,36,-29,5,-4,2,6,-2,4,6,2,4,2,7,9,2,2,2,0,0,10,4,7,4,11,4,0,1,-1,1,1,1,4,1
KR_6766173563,420,-2,14,-4,-1,-2,0,2,3,6,3,0,1,1,0,4,4,-2,0,2,0,3,0,3,3,6,0,0,0,1,-1,0,1,3,1
KR_6637263306,420,-1,-43,9,3,-2,0,2,3,6,3,-1,1,2,0,2,2,3,4,1,0,11,-44,-3,7,4,27,0,-1,1,-1,-1,1,1,1
KR_6728414515,440,4,75,20,3,-1,1,2,1,1,0,3,4,1,4,4,0,-4,2,6,0,8,5,3,8,11,-6,0,1,-1,1,1,-1,2,1
KR_6761570158,420,5,65,0,16,1,1,0,7,10,3,1,2,1,3,3,0,4,4,0,0,14,-327,2,1,3,4,0,2,0,0,1,-1,0,1
KR_6758170615,420,-2,-28,12,-3,1,2,1,-2,1,3,-2,1,3,-6,3,9,6,6,0,0,0,50,3,2,5,-23,0,0,0,1,-1,-1,0,1
KR_6761774420,440,1,63,4,3,-1,2,3,-3,0,3,8,9,1,-1,1,2,0,1,1,0,1,34,1,3,4,2,0,0,1,1,-1,1,6,1
KR_6765142930,440,1,21,-4,3,4,6,2,-1,1,2,0,3,3,-2,2,4,2,2,0,0,1,36,2,4,6,3,0,2,1,1,1,1,2,1
KR_6676726024,420,3,8,-11,11,-1,2,3,6,9,3,2,2,0,3,3,0,1,1,0,0,17,1,4,7,11,3,0,-1,1,-1,-1,1,6,1
KR_6760174210,420,1,19,2,3,-3,1,4,2,3,1,1,2,1,2,2,0,1,1,0,0,7,-3,1,6,7,4,0,0,1,-1,0,1,3,1
KR_6678273235,420,3,14,12,4,-3,0,3,2,4,2,2,3,1,4,5,1,-1,0,1,0,5,-1,2,6,8,2,0,1,1,1,1,-1,5,1
KR_6695583305,420,3,85,0,10,1,3,2,3,3,0,-5,1,6,7,8,1,4,5,1,2,17,-4,2,3,5,1,0,3,1,1,1,1,6,1
KR_6765503182,420,6,59,3,15,4,4,0,1,1,0,2,4,2,5,5,0,3,3,0,0,15,3,2,4,6,6,0,1,1,1,1,1,5,1
KR_6744781167,420,6,96,-13,13,3,4,1,1,1,0,7,8,1,2,3,1,0,3,3,-1,2,-2,0,3,3,6,0,0,1,-1,1,-1,1,1
KR_6749477779,420,4,11,31,1,0,0,0,5,6,1,-2,1,3,-2,3,5,0,1,1,0,-4,4,2,1,3,-3,0,1,1,1,1,1,4,1
KR_6751886201,420,0,-11,0,10,0,0,0,3,5,2,1,4,3,4,6,2,2,2,0,2,12,-3,-4,8,4,1,0,0,0,1,0,1,0,1
KR_6711842918,420,0,27,-8,-2,0,2,2,-4,3,7,0,0,0,1,2,1,1,1,0,0,-3,-2,-2,7,5,5,0,-2,0,-1,-1,1,0,1
KR_6709729727,420,1,-6,3,1,4,4,0,-1,1,2,0,3,3,-1,1,2,-1,0,1,0,-6,3,3,3,6,-2,0,0,1,-1,0,1,1,1
KR_6660769940,440,3,60,4,5,5,5,0,-4,1,5,1,2,1,4,4,0,-1,0,1,-1,2,-19,0,6,6,2,0,0,1,1,1,-1,6,1
KR_6678413184,420,-3,65,-8,-7,-1,1,2,-8,0,8,-2,0,2,1,2,1,3,4,1,0,-5,11,2,3,5,-1,0,1,-1,-1,1,-1,6,1
KR_6684487455,420,0,0,8,-2,-1,2,3,1,5,4,-4,1,5,1,3,2,1,1,0,0,-3,-12,3,1,4,5,0,-1,1,-1,-1,-1,1,1
KR_6762252454,420,2,57,44,-1,0,3,3,-3,3,6,-1,5,6,5,5,0,-2,1,3,2,1,6,0,6,6,-1,0,2,-1,1,1,-1,6,1
KR_6757621577,420,1,10,-16,4,2,2,0,2,3,1,-2,1,3,2,4,2,0,2,2,0,7,-2,2,3,5,4,0,0,-1,1,0,-1,1,1
KR_6748949156,420,-4,27,-4,-5,0,3,3,-3,1,4,-3,1,4,0,2,2,1,1,0,0,-8,1,3,2,5,0,0,-1,-1,1,-1,-1,6,1
KR_6622757909,420,5,63,28,5,1,1,0,0,3,3,1,3,2,2,4,2,1,2,1,0,-2,-2,-1,7,6,1,0,2,-1,1,1,1,3,1
KR_6766229867,420,1,-33,23,2,4,4,0,-4,2,6,1,1,0,1,1,0,0,1,1,0,-3,-11,-3,6,3,1,0,0,-1,1,0,-1,5,1
KR_6754384878,420,5,85,12,8,5,6,1,2,4,2,-5,0,5,4,5,1,2,2,0,0,7,194,-2,7,5,-4,0,0,1,1,1,1,6,1
KR_6764185167,420,-1,47,0,-3,6,6,0,-3,5,8,-4,0,4,-2,4,6,0,1,1,0,-11,4,6,1,7,-2,0,2,-1,1,1,1,6,1
KR_6731618450,420,0,20,12,0,4,5,1,1,2,1,0,3,3,-3,1,4,-2,1,3,0,-10,145,4,4,8,-20,0,1,-1,1,1,1,4,1
KR_6738070408,420,3,0,-9,4,-3,0,3,6,7,1,-2,1,3,1,4,3,2,2,0,0,4,-1,4,4,8,-1,0,-2,-1,-1,-1,1,6,1
KR_6601421544,420,3,-15,-12,7,1,1,0,3,3,0,0,3,3,1,5,4,2,2,0,0,8,5,3,1,4,-3,0,0,0,1,0,-1,0,1
KR_6734389922,420,3,38,35,7,6,7,1,2,3,1,-1,0,1,-2,2,4,2,2,0,0,3,-12,-4,7,3,1,0,2,1,-1,1,1,1,1
KR_6765747338,420,2,-49,-4,5,1,1,0,1,2,1,-4,0,4,6,6,0,1,1,0,0,11,6,2,3,5,0,0,-2,1,-1,-1,1,1,1
KR_6740618029,440,5,84,16,6,-1,1,2,8,9,1,-3,3,6,1,2,1,1,2,1,0,8,3,-2,4,2,0,0,2,0,1,1,-1,0,1
KR_6644709347,440,-4,-36,-12,-5,0,0,0,0,0,0,-3,1,4,-4,1,5,2,2,0,0,0,-15,0,4,4,1,0,-1,1,-1,-1,-1,6,1
KR_6758501305,420,2,12,28,6,4,6,2,0,3,3,3,5,2,-1,3,4,0,0,0,0,5,-10,-6,10,4,-2,0,0,1,1,0,1,5,1
KR_6757946347,420,0,-17,8,3,3,4,1,1,2,1,-1,3,4,0,4,4,0,2,2,0,2,-173,-5,7,2,-3,0,-1,-1,1,-1,-1,4,1
KR_6765555811,420,3,76,-4,6,2,3,1,-3,3,6,5,7,2,0,3,3,2,3,1,0,0,-55,-2,7,5,28,0,2,-1,1,1,1,3,1
KR_6751864410,420,7,56,12,16,4,5,1,0,1,1,1,2,1,10,10,0,1,2,1,0,11,-38,1,3,4,25,0,1,1,-1,1,1,3,1
KR_6757152580,420,-1,32,29,-6,-1,0,1,-2,3,5,-3,0,3,1,5,4,-1,0,1,-1,-12,-4,-4,9,5,-3,0,-1,-1,1,-1,-1,3,1
KR_6747160699,440,-3,55,-12,-5,0,2,2,0,2,2,-5,3,8,2,7,5,-2,0,2,0,-11,7,2,8,10,-2,0,0,1,-1,0,1,3,1
KR_6701896745,420,4,1,44,5,2,5,3,4,6,2,-2,2,4,-1,1,2,2,3,1,0,7,42,1,3,4,-5,0,-1,1,1,-1,-1,4,1
KR_6677009463,420,3,48,-17,5,1,2,1,0,2,2,2,2,0,1,1,0,1,1,0,0,7,2,1,5,6,2,0,0,1,-1,0,1,5,1
KR_6750141606,420,3,70,-28,5,3,3,0,-1,2,3,2,2,0,0,2,2,1,1,0,0,4,-3,-1,7,6,-3,0,0,1,1,0,1,3,1
KR_6754431196,420,1,-24,20,3,-5,1,6,1,2,1,4,5,1,3,3,0,0,0,0,0,0,36,2,3,5,0,0,-1,1,0,-1,1,3,1
KR_6507133550,420,0,39,16,5,0,1,1,2,3,1,0,4,4,0,2,2,3,3,0,1,8,-5,-2,4,2,1,0,0,1,-1,-1,1,3,1
KR_6760075394,420,2,80,21,10,4,6,2,2,2,0,5,10,5,2,5,3,-3,0,3,0,-8,22,2,5,7,2,0,2,1,-1,1,-1,4,1
KR_6615702312,420,1,29,58,-2,-4,0,4,0,5,5,0,2,2,0,1,1,2,2,0,0,-1,-21,-1,6,5,-1,0,-1,-1,1,1,-1,2,1
KR_6713669262,420,1,81,1,2,0,3,3,-1,1,2,-2,0,2,4,5,1,1,1,0,-1,3,10,8,4,12,-4,0,1,1,-1,1,-1,4,1
KR_6744809489,420,0,-10,-31,0,-1,1,2,2,3,1,0,2,2,-1,2,3,0,2,2,0,1,0,3,4,7,-24,0,0,1,1,0,-1,5,1
KR_6743251755,420,4,-2,28,5,4,4,0,1,1,0,0,0,0,-2,2,4,2,2,0,0,-3,104,0,5,5,5,0,2,0,1,1,1,0,1
KR_6758952395,420,2,43,15,3,1,1,0,2,2,0,-2,3,5,-2,0,2,4,6,2,0,-1,45,-1,7,6,4,0,0,-1,1,1,1,2,1
KR_6761901026,440,2,-8,30,5,0,0,0,-2,3,5,2,3,1,4,4,0,1,1,0,0,6,4,-2,8,6,2,0,0,1,-1,0,1,3,1
KR_6717638837,420,4,31,7,6,0,2,2,1,4,3,1,2,1,2,3,1,2,4,2,1,6,-3,2,3,5,7,0,1,0,0,1,1,0,1
KR_6687822778,420,8,69,36,17,4,5,1,3,5,2,2,5,3,5,5,0,3,3,0,0,19,34,7,1,8,0,0,2,1,1,1,1,6,1
KR_6490743708,420,4,92,-13,2,1,2,1,-1,1,2,3,5,2,0,2,2,-1,0,1,0,-3,-1,3,5,8,0,0,-1,1,-1,-1,-1,6,1
KR_6746977236,420,0,5,11,0,0,1,1,-3,0,3,1,3,2,1,5,4,1,2,1,0,1,-3,5,3,8,-6,0,0,1,0,1,1,2,1
KR_6624248406,420,3,32,28,5,1,2,1,0,1,1,1,3,2,3,7,4,0,0,0,0,5,-2,2,6,8,-1,0,0,1,-1,0,-1,1,1
KR_6638898218,420,-3,-23,2,-7,1,3,2,0,2,2,-5,0,5,3,6,3,-6,1,7,0,-8,253,-6,7,1,5,0,1,0,1,1,1,0,1
KR_6765877239,440,0,28,22,13,-1,1,2,4,5,1,3,3,0,-2,0,2,9,11,2,3,12,4,2,2,4,0,0,1,1,1,1,1,3,1
KR_6764856919,420,1,-51,-14,2,4,6,2,-1,1,2,0,3,3,-3,1,4,2,2,0,0,3,-2,-2,3,1,0,0,1,0,-1,1,-1,0,1
KR_6762841368,420,1,-26,5,11,2,2,0,-1,2,3,2,4,2,6,8,2,2,2,0,1,10,4,0,4,4,4,0,0,1,-1,1,1,3,1
KR_6744605199,420,2,86,13,-2,-1,1,2,1,4,3,4,4,0,-6,0,6,0,1,1,0,-7,163,3,3,6,-24,0,1,1,1,1,1,2,1
KR_6763178045,420,2,112,-8,4,-2,0,2,0,3,3,-1,1,2,7,7,0,0,1,1,0,2,16,-2,7,5,-5,0,0,1,0,0,1,1,1
KR_6700937816,420,1,-14,-4,-1,1,2,1,3,3,0,-1,2,3,-2,0,2,-2,0,2,0,-6,-319,0,5,5,2,0,0,-1,-1,0,1,4,1
KR_6738409272,420,1,88,-14,5,3,4,1,0,2,2,0,1,1,2,2,0,0,2,2,0,4,-13,6,2,8,4,0,0,-1,1,0,1,1,1
KR_6746590172,420,1,-22,-16,2,2,3,1,4,5,1,-2,3,5,-1,1,2,-1,0,1,1,4,-1,1,2,3,5,0,1,1,1,1,1,3,1
KR_6763968563,420,-3,-30,15,-10,-7,1,8,2,2,0,4,5,1,-4,1,5,-5,0,5,0,-6,-23,-3,7,4,4,0,0,1,1,1,1,5,1
KR_6711638253,420,4,18,24,11,-2,2,4,0,4,4,7,8,1,7,9,2,-1,0,1,0,5,12,-4,7,3,6,0,3,1,1,1,1,6,1
KR_6736031840,420,5,60,12,7,1,5,4,4,5,1,1,2,1,2,2,0,-1,0,1,0,10,-104,-5,7,2,1,0,1,1,1,1,-1,4,1
KR_6747950279,420,1,-57,4,6,1,2,1,5,6,1,0,1,1,-3,0,3,3,5,2,0,12,120,4,2,6,-2,0,-1,1,1,-1,-1,5,1
KR_6728818112,420,3,10,36,7,-2,4,6,3,3,0,2,6,4,2,6,4,2,2,0,-3,2,-3,-2,6,4,2,0,0,-1,0,1,-1,2,1
KR_6647365146,420,2,53,-12,-1,-1,2,3,1,2,1,3,4,1,-3,5,8,-1,1,2,0,2,70,-1,7,6,-1,0,1,-1,1,1,-1,2,1
KR_6739407893,420,-1,-23,-16,0,1,2,1,5,6,1,-8,0,8,3,4,1,-1,2,3,0,12,110,3,2,5,1,0,1,-1,1,1,1,4,1
KR_6758024778,420,5,70,-16,4,6,6,0,-2,4,6,-1,2,3,4,6,2,-3,0,3,0,1,3,-1,4,3,2,0,1,1,0,1,1,3,1
KR_6605476916,420,-1,9,-22,0,-4,1,5,2,4,2,0,1,1,2,5,3,0,0,0,1,-5,3,2,3,5,2,0,1,1,-1,1,1,5,1
KR_6609085119,420,2,-19,-40,1,-1,1,2,0,3,3,0,1,1,2,4,2,0,1,1,0,5,-2,4,6,10,1,0,1,-1,-1,-1,1,5,1
KR_6764813201,420,2,26,28,5,-3,1,4,3,5,2,1,1,0,4,7,3,0,3,3,1,6,146,9,5,14,-3,0,0,1,1,0,1,6,1
KR_6630807605,420,0,14,3,3,1,2,1,3,3,0,-1,4,5,0,2,2,0,2,2,-2,-2,-10,-4,6,2,-1,0,0,0,0,1,-1,0,1
KR_6765754623,420,2,99,-28,0,-1,3,4,-2,1,3,0,1,1,2,3,1,1,2,1,0,-7,-4,-1,7,6,6,0,1,1,1,1,1,6,1
KR_6764762240,420,3,28,20,6,-4,1,5,4,6,2,2,3,1,4,4,0,0,0,0,0,9,12,0,5,5,2,0,2,1,1,1,-1,6,1
KR_6764908465,420,2,16,-20,5,2,4,2,4,4,0,1,1,0,-2,2,4,0,2,2,0,2,8,4,2,6,0,0,0,0,-1,0,1,0,1
KR_6744663108,420,-1,101,-29,1,-1,2,3,2,2,0,-3,2,5,3,3,0,0,0,0,0,5,12,3,5,8,0,0,0,1,1,0,1,1,1
KR_6762830225,420,0,26,-1,0,-1,0,1,2,2,0,1,1,0,-2,0,2,0,0,0,0,-1,-3,-2,7,5,-3,0,0,1,-1,0,1,1,1
KR_6757640481,420,-3,-9,19,-5,0,1,1,2,3,1,-2,3,5,-4,0,4,-1,0,1,0,-1,0,1,4,5,-6,0,0,1,-1,0,1,6,1
KR_6764361044,420,-1,-5,-4,-2,3,5,2,1,2,1,-2,1,3,-1,2,3,-3,2,5,0,2,-4,2,4,6,-6,0,1,1,-1,1,-1,1,1
KR_6750050408,420,-1,-56,-17,-4,0,2,2,1,1,0,0,0,0,-4,0,4,-1,0,1,0,-3,-6,0,7,7,-4,0,-1,-1,1,-1,-1,5,1
KR_6757190379,420,0,-2,7,-4,2,7,5,-3,0,3,-2,3,5,-3,1,4,2,2,0,0,2,-7,-4,4,0,4,0,-1,-1,-1,-1,-1,5,1
KR_6761516291,420,0,6,-7,0,-2,3,5,3,5,2,0,1,1,-5,0,5,4,4,0,0,-3,37,-1,6,5,2,0,1,1,-1,-1,1,5,1
KR_6761231486,420,0,56,32,-5,5,6,1,-2,2,4,-1,4,5,-6,0,6,-1,0,1,0,-6,0,-2,5,3,4,0,0,1,-1,1,1,2,1
KR_6751581278,420,4,11,9,9,5,6,1,3,4,1,1,1,0,0,4,4,0,2,2,0,4,-111,0,6,6,-3,0,0,-1,1,0,1,5,1
KR_6728180338,440,1,21,-12,-7,-6,1,7,-4,1,5,3,3,0,2,4,2,-2,1,3,-2,-6,-9,-7,11,4,-2,0,-1,-1,-1,-1,-1,4,1
KR_6765866128,420,1,-7,4,-4,-4,0,4,1,2,1,-1,1,2,0,2,2,0,0,0,-1,-3,-6,-4,8,4,5,0,0,-1,1,0,1,2,1
KR_6760234924,420,-5,-17,-20,-6,1,1,0,2,4,2,1,1,0,-9,0,9,-1,1,2,1,-5,354,6,3,9,-6,0,-1,-1,-1,-1,1,3,1
KR_6722841082,440,2,-1,-14,7,3,5,2,5,6,1,-4,0,4,1,3,2,2,3,1,1,9,0,2,4,6,1,0,2,1,1,1,1,2,1
KR_6762697871,420,-1,-6,-20,-6,1,2,1,-1,2,3,-1,0,1,-5,3,8,0,0,0,0,-4,10,4,2,6,-4,0,0,1,-1,0,-1,2,1
KR_6636072196,420,-1,-30,12,-1,0,2,2,2,2,0,-4,1,5,2,2,0,-1,0,1,0,3,0,3,6,9,-5,0,0,-1,1,0,1,2,1
KR_6748636721,420,5,102,-4,15,1,1,0,8,10,2,2,3,1,2,4,2,2,2,0,0,13,1,7,2,9,-1,0,1,1,-1,1,1,4,1
KR_6729812821,420,6,55,23,11,1,1,0,3,5,2,3,5,2,2,4,2,2,2,0,1,12,-11,2,5,7,-2,0,2,0,1,1,1,0,1
KR_6759834073,420,1,-26,-12,6,1,3,2,2,6,4,-1,0,1,2,5,3,2,2,0,0,11,-2,1,3,4,-4,0,1,1,1,1,-1,3,1
KR_6709215283,420,0,-26,-4,4,2,5,3,2,2,0,-2,1,3,2,2,0,0,1,1,0,5,-32,-5,9,4,1,0,-2,1,-1,-1,1,1,1
KR_6760601945,420,-3,-24,-8,-3,2,4,2,-6,1,7,2,2,0,-1,5,6,0,0,0,0,-7,-21,-3,8,5,8,0,-1,1,1,-1,-1,4,1
KR_6678961492,420,4,12,43,9,1,1,0,2,4,2,3,6,3,1,2,1,2,2,0,0,13,0,-2,5,3,0,0,1,1,1,1,1,3,1
KR_6752840615,420,1,-6,-17,-1,2,5,3,-3,1,4,-4,0,4,3,4,1,1,1,0,-1,-3,7,0,2,2,-4,0,-1,-1,-1,1,-1,3,1
KR_6747740417,420,2,15,-2,9,3,4,1,2,3,1,3,6,3,0,1,1,1,2,1,0,1,-258,-2,5,3,0,0,1,-1,-1,1,1,3,1
KR_6762695686,420,0,74,-20,2,4,4,0,3,3,0,-1,1,2,-5,0,5,1,1,0,0,-5,98,1,3,4,2,0,2,-1,1,1,1,1,1
KR_6754886865,420,-2,-48,-40,2,1,2,1,-5,2,7,4,4,0,-2,2,4,4,4,0,0,7,-2,-1,5,4,2,0,-1,-1,0,-1,1,2,1
KR_6762120534,420,0,14,17,3,2,3,1,2,4,2,1,3,2,0,1,1,-2,0,2,0,-2,4,1,2,3,1,0,0,-1,1,0,-1,2,1
KR_6752907808,420,3,14,4,2,1,2,1,0,4,4,1,2,1,2,3,1,-2,2,4,0,0,-4,-1,10,9,3,0,1,1,-1,1,-1,1,1
KR_6761653553,420,0,78,-19,1,2,3,1,-5,2,7,1,5,4,1,3,2,2,2,0,0,8,-2,-3,5,2,5,0,1,-1,0,1,-1,5,1
KR_6705332941,420,1,18,8,1,5,5,0,-1,0,1,-2,1,3,-1,0,1,0,1,1,0,-3,-40,-2,8,6,21,0,-1,1,1,1,1,2,1
KR_6752697586,420,0,62,-7,-2,2,2,0,1,1,0,0,3,3,-4,1,5,-1,0,1,0,-4,-5,-1,5,4,-2,0,-1,-1,1,-1,1,5,1
KR_6758974945,440,3,-14,-12,16,2,4,2,7,7,0,2,5,3,3,5,2,2,2,0,0,9,3,2,1,3,0,0,-1,1,1,-1,1,4,1
KR_6750680886,420,-2,-20,-4,-2,-5,1,6,0,1,1,1,3,2,1,2,1,1,2,1,0,6,0,7,5,12,-3,0,0,-1,1,0,1,2,1
KR_6764008182,420,3,76,-15,3,2,2,0,0,3,3,0,4,4,2,6,4,-1,0,1,0,-5,2,-1,6,5,2,0,1,-1,1,1,1,6,1
KR_6756255819,420,3,5,-15,1,-2,3,5,-1,0,1,2,4,2,4,4,0,-2,0,2,0,3,3,3,3,6,-1,0,0,0,-1,0,1,0,1
KR_6753665712,420,6,65,12,15,2,5,3,0,3,3,3,6,3,5,8,3,5,5,0,0,19,349,5,2,7,0,0,1,1,1,1,-1,5,1
KR_6761545449,420,-2,67,30,-5,-3,0,3,-3,0,3,0,0,0,2,2,0,-1,0,1,0,-8,4,-2,5,3,-32,0,1,-1,1,1,-1,4,1
KR_6746389946,420,3,80,8,9,4,4,0,0,1,1,3,4,1,0,1,1,2,2,0,0,7,5,0,4,4,2,0,0,1,-1,0,1,2,1
KR_6758792374,420,2,52,48,5,1,3,2,0,1,1,0,1,1,3,6,3,1,1,0,0,0,6,3,3,6,-1,0,1,1,1,1,-1,4,1
KR_6702187740,440,0,-60,4,9,3,6,3,3,3,0,-1,1,2,0,1,1,4,5,1,0,15,13,4,2,6,1,0,1,-1,1,1,1,1,1
KR_6744582102,420,1,-5,37,6,0,0,0,-1,0,1,1,2,1,3,3,0,3,3,0,0,7,100,6,1,7,2,0,2,1,1,1,-1,6,1
KR_6758814791,420,8,134,36,14,1,2,1,0,3,3,3,4,1,8,8,0,2,3,1,0,17,-2,2,1,3,5,0,2,1,1,1,1,6,1
KR_6746892781,420,-4,11,8,-6,-6,0,6,-1,1,2,-3,0,3,-4,1,5,8,8,0,0,-7,4,1,4,5,3,0,0,1,-1,1,-1,4,1
KR_6719237134,420,-1,6,32,-7,-2,3,5,-4,1,5,1,3,2,-2,4,6,0,1,1,0,-13,2,-3,7,4,-4,0,-2,-1,1,1,-1,2,1
KR_6622228692,420,-1,-11,8,3,5,7,2,-2,0,2,0,2,2,0,2,2,0,1,1,1,3,7,3,4,7,0,0,1,1,1,1,1,2,1
KR_6762969115,440,2,63,15,5,1,1,0,0,2,2,3,6,3,1,2,1,0,1,1,0,9,-12,-7,14,7,4,0,0,1,1,1,1,6,1
KR_6755221607,420,-2,38,25,-3,3,4,1,0,1,1,2,3,1,-5,1,6,-3,0,3,1,-6,3,-3,9,6,-4,0,0,0,1,0,1,0,1
KR_6751398019,420,-2,7,-28,-6,-7,1,8,1,4,3,0,1,1,1,4,3,-1,2,3,0,-11,3,5,2,7,0,0,1,1,1,-1,-1,5,1
KR_6760195020,420,-1,-50,-40,2,3,3,0,2,3,1,-1,0,1,-2,0,2,0,0,0,0,3,-2,2,4,6,-3,0,-1,1,1,-1,1,4,1
KR_6761322568,420,1,47,0,3,0,1,1,4,5,1,2,3,1,-3,3,6,0,1,1,0,-2,-9,-2,6,4,3,0,1,1,0,1,1,5,1
KR_6762550818,420,1,19,-8,-1,0,2,2,0,0,0,2,2,0,-3,0,3,0,1,1,0,-5,-5,3,8,11,3,0,1,0,1,1,-1,0,1
KR_6749657751,420,2,99,9,7,5,5,0,-1,3,4,-2,3,5,1,3,2,4,4,0,2,2,50,4,4,8,-16,0,1,1,1,1,1,6,1
KR_6739655911,440,2,-8,20,8,0,1,1,4,6,2,4,5,1,1,3,2,-1,0,1,0,3,52,-2,4,2,3,0,1,-1,1,1,-1,3,1
KR_6712214964,420,-1,21,5,-1,2,5,3,-2,1,3,-1,2,3,0,2,2,0,0,0,0,-5,-28,-3,7,4,-1,0,-1,1,-1,-1,-1,4,1
KR_6762679151,420,4,35,12,12,0,1,1,3,3,0,2,3,1,5,7,2,2,2,0,1,19,5,3,3,6,5,0,1,1,1,1,1,5,1
KR_6675526277,420,0,62,-28,-1,-1,2,3,1,2,1,-2,0,2,0,0,0,1,1,0,1,5,-9,-2,4,2,6,0,0,1,1,0,1,2,1
KR_6617514188,420,1,84,26,-6,0,2,2,0,1,1,-3,2,5,-1,1,2,-2,0,2,0,-4,-11,-4,9,5,4,0,2,1,1,1,1,1,1
KR_6756557222,440,10,144,59,12,7,7,0,3,3,0,-1,1,2,2,3,1,1,2,1,1,10,33,0,2,2,-2,0,4,1,1,1,1,1,1
KR_6726444197,420,5,182,25,12,4,4,0,5,6,1,-1,1,2,3,5,2,1,2,1,0,15,18,5,0,5,-2,0,5,1,1,1,1,2,1
KR_6738864501,420,3,-20,8,3,-1,1,2,5,6,1,-3,4,7,0,4,4,2,2,0,-1,2,-2,-2,8,6,3,0,0,1,-1,0,-1,5,1
KR_6766436308,420,1,19,-1,9,3,3,0,-3,2,5,2,4,2,2,4,2,5,5,0,0,8,-205,2,4,6,-1,0,-1,1,-1,-1,-1,1,1
KR_6727353256,420,-1,25,-7,-2,0,1,1,-3,1,4,2,2,0,-2,1,3,1,1,0,-1,-2,-9,-7,10,3,3,0,0,0,-1,0,-1,0,1
KR_6758900035,420,0,-5,16,-5,1,2,1,0,1,1,-1,5,6,-2,1,3,-3,1,4,0,-2,61,-1,10,9,1,0,0,-1,-1,0,-1,6,1
KR_6705261856,420,3,36,13,5,4,4,0,2,3,1,2,4,2,-3,1,4,0,0,0,0,2,-2,1,2,3,2,0,-1,1,1,-1,1,2,1
KR_6658264032,420,-3,-4,-4,-10,1,4,3,-4,1,5,2,2,0,-2,0,2,-7,0,7,1,-5,-1,1,5,6,-4,0,-1,1,-1,-1,1,4,1
KR_6730649680,420,4,41,14,17,1,2,1,3,6,3,3,3,0,5,5,0,5,5,0,0,13,2,-2,3,1,0,0,2,1,0,1,1,1,1
KR_6765530791,440,3,107,1,7,2,3,1,-3,0,3,4,5,1,6,9,3,-2,0,2,-2,3,-47,2,1,3,1,0,2,1,1,1,-1,4,1
KR_6764590616,420,2,8,0,1,0,1,1,2,4,2,1,2,1,-4,0,4,2,3,1,0,-1,-28,-1,5,4,-3,0,0,1,1,0,-1,5,1
KR_6756070168,420,3,125,11,5,0,2,2,-2,2,4,5,6,1,0,4,4,2,2,0,0,2,8,-1,4,3,4,0,0,1,-1,0,1,2,1
KR_6705725024,420,4,55,31,15,0,2,2,1,5,4,10,11,1,5,7,2,-1,0,1,0,8,10,1,3,4,-13,0,2,1,1,1,1,5,1
KR_6761468559,420,-1,-56,-7,-5,1,3,2,-3,1,4,1,2,1,-2,2,4,-2,1,3,0,-13,-4,-1,7,6,-3,0,0,-1,1,0,1,2,1
KR_6764265199,420,5,54,8,11,0,0,0,7,8,1,4,4,0,-1,4,5,1,3,2,0,7,3,-2,6,4,2,0,1,1,-1,1,1,5,1
KR_6760794816,420,3,21,36,-1,3,4,1,2,5,3,-3,2,5,-4,0,4,1,1,0,0,-6,-4,3,2,5,-3,0,1,1,-1,1,-1,3,1
KR_6748883705,420,0,60,-2,-3,4,5,1,-1,4,5,-2,0,2,-1,2,3,-3,1,4,0,-8,-8,-1,5,4,3,0,0,-1,-1,-1,1,3,1
KR_6763369732,440,1,11,3,7,1,2,1,2,7,5,5,5,0,-3,2,5,2,3,1,1,11,23,-2,8,6,3,0,3,-1,1,1,1,6,1
KR_6759749616,420,5,13,10,10,2,6,4,-3,0,3,1,1,0,6,7,1,4,8,4,-1,5,1,2,3,5,2,0,3,1,1,1,-1,5,1
KR_6722659457,420,7,79,39,11,7,9,2,3,4,1,1,1,0,1,6,5,-1,0,1,2,7,-27,-2,7,5,6,0,1,1,1,-1,1,2,1
KR_6758340145,420,0,-14,-12,8,0,3,3,0,3,3,4,4,0,3,6,3,1,1,0,0,10,56,6,0,6,-1,0,-1,-1,1,1,1,4,1
KR_6749262122,440,-3,-9,-9,-12,-3,1,4,2,5,3,-10,0,10,-2,5,7,1,3,2,1,-7,-5,0,1,1,1,0,0,-1,1,-1,1,5,1
KR_6761236996,420,3,0,4,6,2,2,0,1,3,2,-1,0,1,4,6,2,0,2,2,-1,1,12,-4,9,5,2,0,0,-1,1,1,-1,5,1
KR_6521204958,420,1,-1,-4,8,0,2,2,5,5,0,-1,2,3,3,3,0,1,1,0,0,8,14,-1,5,4,3,0,1,1,1,1,1,4,1
KR_6763125514,420,2,6,-7,5,2,2,0,3,5,2,-1,1,2,0,1,1,1,2,1,2,11,48,2,3,5,1,0,0,1,1,1,1,6,1
KR_6763519621,440,2,9,-12,9,1,3,2,1,3,2,0,2,2,6,7,1,1,3,2,-1,2,-1,1,4,5,0,0,0,-1,1,0,-1,5,1
KR_6709691476,420,1,68,10,3,1,2,1,5,5,0,0,1,1,-1,4,5,-2,2,4,0,5,4,6,3,9,-10,0,0,1,-1,1,1,4,1
KR_6743242830,420,4,79,31,14,3,3,0,7,9,2,3,4,1,1,2,1,0,0,0,1,11,10,5,2,7,0,0,0,1,1,1,1,1,1
KR_6765317755,420,5,84,12,16,1,2,1,-1,3,4,1,2,1,13,13,0,2,2,0,0,21,5,-3,8,5,7,0,2,1,1,1,1,6,1
KR_6761206451,420,-5,-25,-4,-13,-1,2,3,-6,1,7,-6,1,7,0,2,2,0,1,1,2,-8,2,-2,4,2,0,0,0,-1,-1,0,1,5,1
KR_6631206517,440,1,-53,0,6,0,2,2,6,7,1,0,1,1,0,4,4,0,0,0,0,7,31,-2,6,4,2,0,0,-1,1,1,-1,6,1
KR_6760529529,420,0,-10,15,6,-1,0,1,-2,2,4,5,6,1,4,5,1,0,1,1,0,9,56,-2,4,2,-3,0,-2,1,-1,-1,-1,2,1
KR_6705262968,420,-1,-11,-12,5,4,5,1,0,1,1,-2,3,5,3,5,2,0,1,1,0,4,0,-3,6,3,0,0,0,1,-1,0,-1,4,1
KR_6641713705,420,3,-35,-1,14,3,4,1,2,5,3,8,8,0,-3,3,6,4,4,0,1,17,7,5,3,8,-1,0,2,1,1,1,-1,2,1
KR_6756036980,420,1,20,4,-2,-5,2,7,-1,2,3,0,1,1,4,4,0,0,0,0,0,2,-19,-1,4,3,5,0,0,-1,1,1,1,5,1
KR_6764460965,420,-1,71,0,-4,-1,1,2,-1,2,3,1,2,1,-2,3,5,-1,0,1,0,-2,-47,-4,10,6,3,0,1,-1,1,1,-1,1,1
KR_6703545755,420,4,44,14,7,1,2,1,4,4,0,3,5,2,0,0,0,-1,0,1,0,-1,4,1,4,5,-7,0,3,1,1,1,1,4,1
KR_6736050360,420,2,12,28,6,0,1,1,4,5,1,3,7,4,0,2,2,-1,1,2,0,8,-95,2,4,6,1,0,-1,1,1,-1,-1,3,1
KR_6751329989,440,2,-13,30,5,-1,2,3,0,2,2,2,3,1,3,8,5,1,1,0,0,7,3,-3,6,3,2,0,-1,1,-1,-1,-1,4,1
KR_6746423765,420,1,29,1,0,1,3,2,-3,0,3,-1,2,3,3,5,2,0,1,1,0,-1,-109,-1,5,4,0,0,1,0,-1,1,1,0,1
KR_6703142720,420,-2,7,-16,-1,0,2,2,1,5,4,-5,0,5,3,3,0,0,2,2,0,2,-7,1,4,5,2,0,-2,1,-1,-1,-1,5,1
KR_6744457606,420,2,-6,9,2,0,1,1,1,2,1,0,0,0,1,1,0,0,0,0,0,3,-11,2,5,7,-4,0,0,-1,1,0,-1,1,1
KR_6765471119,420,1,-6,-8,-4,0,1,1,2,2,0,-1,1,2,-4,1,5,-1,0,1,0,-6,1,3,3,6,1,0,0,-1,0,0,-1,5,1
KR_6747656852,420,-1,-24,-41,3,1,2,1,0,3,3,0,1,1,1,3,2,1,3,2,0,6,-5,2,7,9,3,0,0,1,-1,0,1,4,1
KR_6672562794,440,-3,9,-15,-5,-1,0,1,-2,0,2,-3,0,3,6,7,1,-5,1,6,0,-4,-19,0,7,7,0,0,0,1,-1,0,1,1,1
KR_6758993139,420,-1,-29,16,-2,-1,0,1,0,0,0,2,3,1,-1,1,2,-2,0,2,-1,0,-11,-4,8,4,7,0,0,-1,-1,0,-1,3,1
KR_6764781494,420,-2,1,0,4,1,1,0,-3,0,3,-4,2,6,8,12,4,2,2,0,1,3,-15,-4,10,6,1,0,-1,1,-1,-1,1,3,1
KR_6722959539,420,3,73,20,10,3,7,4,2,3,1,0,1,1,0,3,3,5,6,1,0,8,-25,-2,3,1,14,0,2,-1,1,1,1,1,1
KR_6628593304,420,2,69,-19,4,-1,1,2,1,4,3,3,4,1,0,4,4,1,2,1,0,-4,1,1,5,6,-2,0,1,0,1,1,-1,0,1
KR_6765882626,420,0,-5,-8,-2,0,3,3,0,1,1,-3,0,3,2,3,1,-1,0,1,0,-2,0,6,1,7,-2,0,-1,1,-1,-1,-1,5,1
KR_6762975716,420,0,18,9,2,2,4,2,2,4,2,1,3,2,-3,2,5,0,1,1,0,2,28,2,7,9,-3,0,0,1,0,0,-1,6,1
KR_6637211058,420,2,23,-3,5,1,2,1,2,3,1,4,5,1,-1,0,1,-1,0,1,0,-6,-6,-4,8,4,4,0,3,-1,1,1,1,2,1
KR_6734703541,420,0,-22,-56,2,-1,1,2,-1,2,3,3,5,2,0,4,4,1,1,0,0,1,-1,0,4,4,2,0,2,-1,1,1,1,4,1
KR_6703605604,440,-2,-12,-19,-8,0,1,1,1,3,2,1,2,1,-4,2,6,-6,0,6,0,-9,-2,3,6,9,2,0,0,-1,1,-1,-1,6,1
KR_6757457546,420,1,49,40,6,2,2,0,4,4,0,2,2,0,0,1,1,-2,0,2,0,10,20,6,0,6,1,0,1,-1,1,1,1,4,1
KR_6764685261,420,2,26,19,9,-2,1,3,-1,4,5,5,5,0,5,8,3,2,2,0,0,1,-4,-5,6,1,3,0,0,0,-1,-1,-1,0,1
KR_6753567905,440,3,47,23,8,-1,2,3,-1,1,2,-1,0,1,6,7,1,5,5,0,1,12,3,0,9,9,2,0,2,1,1,1,1,3,1
KR_6765472951,420,3,22,20,8,2,3,1,2,6,4,-2,0,2,3,5,2,3,3,0,0,9,2,4,2,6,1,0,1,-1,1,1,-1,4,1
KR_6749306999,420,-3,-30,0,-4,-1,2,3,-1,2,3,-4,1,5,0,0,0,2,2,0,-1,-3,9,-2,5,3,2,0,-1,0,-1,-1,-1,0,1
KR_6610602985,420,1,-7,34,-6,-2,2,4,-3,1,4,1,1,0,-1,2,3,-1,1,2,0,-2,-4,-4,7,3,1,0,0,0,-1,0,-1,0,1
KR_6575944296,420,1,-5,0,2,-1,1,2,-2,3,5,1,3,2,3,5,2,1,2,1,0,6,-45,-1,5,4,15,0,0,-1,1,1,-1,2,1
KR_6621213299,420,4,39,20,6,2,4,2,1,4,3,-1,1,2,2,2,0,2,2,0,0,5,7,-4,7,3,3,0,0,1,-1,1,1,5,1
KR_6757012791,420,1,80,4,7,-1,0,1,2,4,2,3,4,1,1,2,1,2,2,0,0,6,-1,-1,4,3,3,0,1,1,1,1,-1,4,1
KR_6647178866,440,3,46,12,5,0,1,1,5,6,1,1,5,4,0,3,3,-1,2,3,1,2,-23,7,4,11,-4,0,0,1,-1,-1,1,5,1
KR_6717574142,420,0,19,24,0,0,2,2,-1,1,2,0,1,1,-1,3,4,2,3,1,0,-7,-5,-4,6,2,0,0,0,1,-1,0,1,6,1
KR_6716997815,420,2,-12,17,6,-1,0,1,9,10,1,-2,3,5,-1,0,1,1,1,0,0,12,-2,-2,8,6,1,0,0,1,1,1,-1,2,1
KR_6713896757,420,4,105,8,14,6,6,0,0,4,4,1,3,2,6,6,0,1,1,0,1,10,31,3,4,7,3,0,1,1,1,1,1,3,1
KR_6704021397,420,-3,-17,8,-2,-3,0,3,2,4,2,-3,2,5,1,2,1,1,2,1,0,0,-46,-1,8,7,9,0,1,1,1,-1,-1,3,1
KR_6757505767,440,3,7,0,4,-3,0,3,8,9,1,4,5,1,-5,2,7,0,0,0,0,6,140,5,1,6,-2,0,1,1,1,1,-1,5,1
KR_6681555632,440,1,21,0,4,3,4,1,-1,1,2,1,3,2,2,3,1,-1,0,1,1,1,-5,3,2,5,1,0,0,-1,1,0,-1,2,1
KR_6761052048,440,3,33,36,0,4,5,1,-6,0,6,3,5,2,-1,2,3,0,1,1,0,-3,22,-2,4,2,-2,0,1,1,1,1,1,1,1
KR_6705166572,420,6,86,2,5,-2,1,3,0,1,1,1,3,2,2,3,1,4,4,0,0,8,-26,-2,7,5,4,0,3,1,1,1,-1,2,1
KR_6761886503,420,-3,-1,-28,4,-2,3,5,0,1,1,5,5,0,1,1,0,0,0,0,0,6,9,3,2,5,-4,0,1,1,1,1,-1,5,1
KR_6640105505,420,-1,-30,22,5,-2,0,2,-1,2,3,5,5,0,5,6,1,-2,0,2,0,10,0,2,3,5,3,0,1,1,-1,1,-1,1,1
KR_6739151443,420,-3,-38,-5,-13,3,8,5,1,4,3,-5,4,9,-9,0,9,-3,1,4,-2,-21,-69,-3,5,2,-6,0,-3,-1,-1,-1,-1,3,1
KR_6745133370,420,-2,1,9,-4,0,3,3,2,3,1,0,1,1,-5,1,6,-1,1,2,1,-9,-11,3,3,6,2,0,1,-1,1,1,1,1,1
KR_6722832635,420,2,35,0,7,6,7,1,-1,5,6,2,3,1,0,1,1,0,1,1,0,6,-2,-2,6,4,0,0,1,-1,1,1,1,1,1
KR_6760678271,440,2,-13,16,6,0,1,1,6,6,0,1,2,1,-2,5,7,1,2,1,1,8,3,0,5,5,-1,0,0,0,1,0,1,0,1
KR_6751552600,420,1,-12,4,-3,-2,0,2,-4,2,6,-1,0,1,3,4,1,1,1,0,0,-3,4,0,5,5,0,0,0,1,-1,0,1,4,1
KR_6619690880,420,5,51,-24,8,1,1,0,-2,2,4,3,4,1,4,5,1,2,2,0,0,6,-5,-5,7,2,0,0,2,1,-1,1,1,2,1
KR_6760772831,420,2,31,-16,4,-4,1,5,-1,1,2,9,9,0,1,6,5,-1,1,2,0,5,-14,2,4,6,4,0,-1,1,1,-1,1,6,1
KR_6766512097,420,1,52,-27,3,4,4,0,-5,3,8,4,4,0,0,4,4,0,1,1,0,5,-441,0,5,5,1,0,-1,-1,1,-1,-1,5,1
KR_6644494022,420,3,-10,31,6,0,2,2,3,5,2,0,2,2,2,2,0,1,2,1,0,15,12,3,7,10,-3,0,2,1,1,1,1,1,1
KR_6745282014,420,3,-12,6,10,1,3,2,3,5,2,8,10,2,-2,3,5,0,0,0,0,4,-6,-4,8,4,-3,0,1,-1,1,1,1,2,1
KR_6734466835,420,1,45,-32,-2,4,5,1,-3,1,4,-1,2,3,1,2,1,-3,1,4,1,-9,-3,-4,9,5,3,0,1,-1,1,1,1,3,1
KR_6700626919,420,6,137,38,5,4,4,0,-2,3,5,0,3,3,4,7,3,-1,2,3,-1,1,-4,-3,7,4,1,0,2,-1,1,1,-1,1,1
KR_6661024474,420,1,-8,-6,5,0,3,3,-1,2,3,1,2,1,6,6,0,-1,0,1,0,9,-2,-2,7,5,0,0,2,-1,1,1,1,5,1
KR_6750069112,420,1,-36,37,6,-1,1,2,2,3,1,1,3,2,3,4,1,1,1,0,0,9,2,2,3,5,-3,0,0,1,-1,-1,1,6,1
KR_6650689429,420,0,10,5,-4,0,3,3,-2,2,4,3,3,0,-5,1,6,0,2,2,1,0,127,-5,9,4,0,0,-1,1,-1,-1,1,3,1
KR_6748955803,420,7,68,36,11,1,3,2,2,5,3,1,3,2,0,3,3,7,9,2,0,2,-75,4,4,8,-1,0,2,1,1,1,1,1,1
KR_6676751673,420,8,75,14,16,4,5,1,3,3,0,3,3,0,7,7,0,-1,1,2,0,19,1,-2,7,5,4,0,1,1,-1,1,1,6,1
KR_6442885723,420,2,-27,17,3,0,0,0,-2,0,2,-5,2,7,11,11,0,-1,1,2,-1,3,-38,1,6,7,8,0,-1,-1,-1,-1,-1,1,1
KR_6766199933,420,-1,-13,-10,0,0,2,2,3,4,1,2,2,0,-6,0,6,1,1,0,1,-4,1,-6,7,1,-3,0,0,-1,1,0,1,6,1
KR_6746787726,420,3,125,13,3,2,3,1,1,4,3,-1,1,2,-1,4,5,2,2,0,0,4,-1,-1,4,3,0,0,0,0,1,1,1,0,1
KR_6754883874,420,3,11,23,3,3,3,0,3,3,0,0,1,1,-2,2,4,-1,0,1,0,4,-4,3,2,5,3,0,1,1,-1,1,-1,4,1
KR_6758622337,420,1,43,13,-1,2,3,1,-5,0,5,3,7,4,-1,1,2,0,1,1,0,-7,13,-3,8,5,-1,0,0,-1,-1,1,1,4,1
KR_6766367443,440,2,109,22,7,3,4,1,0,1,1,2,4,2,0,0,0,2,3,1,0,6,4,-2,5,3,-3,0,2,1,1,1,1,6,1
KR_6679814618,420,7,115,27,7,4,4,0,1,2,1,0,2,2,6,7,1,-4,1,5,0,3,-2,1,4,5,-2,0,1,0,1,1,-1,0,1
KR_6749938986,420,0,-27,11,2,5,5,0,-8,1,9,3,4,1,-2,1,3,4,5,1,-2,-7,-14,-1,5,4,-4,0,0,-1,-1,1,-1,1,1
KR_6760067938,420,3,14,28,7,2,4,2,-1,2,3,2,3,1,3,3,0,1,2,1,0,10,-3,-1,5,4,-1,0,0,1,1,1,1,3,1
KR_6723806699,420,3,44,16,5,0,1,1,-1,2,3,2,3,1,3,4,1,1,4,3,1,8,-70,-3,5,2,-18,0,1,1,1,1,1,2,1
KR_6664452119,420,-1,-34,-20,-4,-5,0,5,0,1,1,1,2,1,0,5,5,0,2,2,0,1,-6,-3,7,4,3,0,0,-1,-1,-1,1,4,1
KR_6695495061,420,8,113,40,16,9,10,1,0,3,3,1,4,3,6,7,1,0,1,1,0,11,-118,1,3,4,-3,0,2,1,1,1,1,6,1
KR_6752179705,420,0,-27,6,2,1,1,0,1,3,2,1,4,3,2,3,1,-3,0,3,0,6,-6,-6,10,4,6,0,0,-1,0,0,1,2,1
KR_6740268953,420,0,-21,21,-3,2,3,1,-2,2,4,0,3,3,-1,2,3,-2,0,2,0,-4,-117,-4,5,1,-2,0,-1,-1,1,-1,-1,1,1
KR_6766101467,420,1,58,-15,4,3,7,4,3,3,0,-2,0,2,4,4,0,-4,2,6,-1,7,5,-2,6,4,1,0,0,1,-1,1,1,1,1
KR_6732351399,440,2,32,28,1,-1,2,3,7,7,0,-3,3,6,1,3,2,-3,0,3,0,5,-2,2,1,3,-1,0,1,1,1,1,-1,1,1
KR_6753434484,420,2,-76,8,4,2,2,0,-2,2,4,3,5,2,-1,3,4,2,3,1,1,1,1,0,4,4,-1,0,0,-1,-1,1,1,6,1
KR_6766581226,420,-1,8,18,1,1,3,2,-2,3,5,2,4,2,-2,0,2,2,2,0,0,-3,-4,1,2,3,-1,0,1,1,1,1,1,5,1
KR_6765166010,420,1,4,-19,6,2,3,1,-2,0,2,2,3,1,5,6,1,-1,0,1,1,8,46,2,6,8,-1,0,0,-1,-1,1,1,5,1
KR_6655217570,420,2,26,-8,3,-8,3,11,1,3,2,4,4,0,6,6,0,0,0,0,1,11,1,2,4,6,2,0,-1,1,-1,-1,1,4,1
KR_6710167714,420,-5,-52,-11,-4,-1,1,2,2,2,0,-5,2,7,0,0,0,0,0,0,0,0,-13,-4,8,4,2,0,0,0,-1,0,1,0,1
KR_6762641113,440,2,63,26,6,1,2,1,1,2,1,2,6,4,3,6,3,-1,2,3,0,1,9,3,1,4,-1,0,1,-1,1,1,1,3,1
KR_6659355105,420,0,5,-2,9,1,1,0,1,2,1,4,5,1,1,2,1,2,2,0,0,12,5,1,4,5,7,0,0,1,0,0,1,6,1
KR_6755393829,420,-1,-10,28,7,3,3,0,2,3,1,0,1,1,1,6,5,1,1,0,0,2,2,-2,5,3,5,0,1,0,-1,1,1,0,1
KR_6739015732,420,1,56,-27,3,2,3,1,1,3,2,1,1,0,1,2,1,-2,0,2,0,1,-4,-2,9,7,-3,0,1,-1,1,1,-1,1,1
KR_6678817810,420,5,152,-16,11,7,7,0,0,3,3,1,4,3,4,6,2,-1,1,2,1,6,6,1,6,7,3,0,3,1,-1,1,1,2,1
KR_6734377754,440,-3,-44,-72,4,2,4,2,1,2,1,0,1,1,-2,1,3,3,6,3,0,13,0,4,1,5,5,0,-1,0,-1,-1,-1,0,1
KR_6745095852,420,4,101,-15,5,-1,3,4,1,5,4,1,4,3,4,4,0,0,1,1,0,4,-33,-6,7,1,3,0,1,0,-1,1,1,0,1
KR_6656449238,420,3,96,-14,7,3,3,0,2,3,1,3,5,2,0,1,1,-1,1,2,1,7,-4,0,7,7,5,0,0,1,1,0,1,4,1
KR_6689753866,420,0,1,29,2,-1,0,1,0,1,1,-1,2,3,2,2,0,2,2,0,1,0,-16,-2,5,3,4,0,0,1,1,0,1,3,1
KR_6745508143,420,3,-4,23,4,0,2,2,1,3,2,0,2,2,3,4,1,0,0,0,0,11,1,0,5,5,8,0,0,1,-1,1,-1,5,1
KR_6765611246,420,1,32,4,3,0,0,0,3,4,1,4,5,1,-4,2,6,0,1,1,2,5,-5,-5,8,3,-5,0,-2,0,1,-1,1,0,1
KR_6653675646,420,-3,-85,-9,-6,-4,1,5,-3,0,3,8,9,1,-3,1,4,-4,0,4,0,-2,-377,-3,5,2,2,0,0,-1,1,-1,-1,1,1
KR_6765096560,420,9,119,40,3,-2,1,3,4,4,0,-2,0,2,3,3,0,0,0,0,1,-1,10,2,2,4,2,0,3,1,1,1,1,1,1
KR_6686631770,420,2,49,-24,3,3,3,0,1,4,3,-1,1,2,0,2,2,0,0,0,-1,-5,281,2,5,7,-3,0,1,0,1,1,-1,0,1
KR_6765436037,420,5,92,20,8,3,3,0,2,4,2,4,4,0,-1,0,1,0,1,1,2,10,-63,3,6,9,-1,0,3,1,1,1,1,4,1
KR_6670010727,420,0,-1,7,-1,-3,2,5,2,5,3,-1,1,2,0,2,2,1,2,1,0,1,28,2,3,5,1,0,1,1,-1,1,1,3,1
KR_6763049373,440,1,48,21,0,2,3,1,-2,3,5,1,1,0,-1,1,2,0,0,0,0,-3,-8,-4,6,2,-4,0,0,1,0,0,1,4,1
KR_6750592724,420,1,-19,2,2,-2,0,2,2,3,1,3,5,2,-1,1,2,0,3,3,0,7,-5,-2,7,5,5,0,0,1,1,0,-1,5,1
KR_6751310122,420,3,42,-3,9,-2,0,2,3,3,0,0,4,4,8,8,0,0,1,1,0,12,-3,-7,9,2,3,0,1,0,-1,1,-1,0,1
KR_6704453517,420,3,-12,20,3,3,5,2,-1,3,4,2,4,2,-1,4,5,0,0,0,-1,-2,32,3,4,7,-5,0,2,1,1,1,-1,4,1
KR_6756108359,420,-2,-2,0,1,-3,1,4,1,3,2,-1,3,4,5,6,1,-1,0,1,0,4,-5,-2,4,2,5,0,0,-1,0,-1,1,1,1
KR_6765644421,420,3,14,-6,11,3,5,2,1,3,2,2,3,1,4,6,2,1,2,1,0,17,-6,-1,6,5,8,0,1,0,-1,1,-1,0,1
KR_6766245408,420,-1,11,-12,6,-2,1,3,0,2,2,3,4,1,5,5,0,0,1,1,1,10,12,4,2,6,-3,0,1,-1,1,1,1,2,1
KR_6737316540,420,1,10,28,0,-2,0,2,0,2,2,1,2,1,2,3,1,-1,1,2,0,-1,-110,-2,6,4,-4,0,0,-1,-1,0,1,3,1
KR_6764945385,420,1,41,-10,5,4,4,0,2,4,2,0,2,2,1,4,3,-2,0,2,1,5,102,1,2,3,3,0,0,-1,1,1,1,6,1
KR_6646890640,420,0,-23,8,4,1,2,1,3,3,0,4,4,0,0,2,2,-4,0,4,0,7,34,-3,6,3,-2,0,-1,-1,-1,-1,1,4,1
KR_6753197190,420,3,-30,-8,8,-5,2,7,3,4,1,2,6,4,5,7,2,3,3,0,0,13,397,2,1,3,-1,0,2,1,1,1,-1,5,1
KR_6761473583,420,-1,26,8,-5,1,1,0,-3,2,5,0,1,1,-6,1,7,3,5,2,0,-18,-12,-2,6,4,5,0,-1,-1,-1,-1,1,5,1
KR_6760506426,420,-1,-18,12,-1,2,4,2,0,3,3,-1,3,4,-3,2,5,1,2,1,-1,-8,22,0,5,5,-1,0,0,1,1,0,1,4,1
KR_6753685187,420,-1,42,-12,0,4,4,0,-3,4,7,2,4,2,-1,1,2,-2,1,3,0,-6,-16,1,7,8,0,0,1,0,-1,1,1,0,1
KR_6760686717,440,-2,2,1,-2,2,2,0,3,5,2,2,3,1,-6,1,7,-3,0,3,0,1,20,-2,5,3,-5,0,0,1,-1,0,-1,3,1
KR_6758048401,440,3,64,-8,6,-1,3,4,1,3,2,1,3,2,6,7,1,-1,0,1,0,10,39,2,3,5,-28,0,1,1,-1,1,1,5,1
KR_6738037128,420,-1,-9,-45,-3,-5,1,6,0,3,3,-1,2,3,1,5,4,2,2,0,-2,-1,-6,-4,6,2,1,0,-1,-1,-1,-1,-1,6,1
KR_6764824702,420,0,-6,18,3,-2,0,2,0,2,2,1,1,0,4,7,3,0,0,0,0,8,-3,-3,6,3,4,0,0,1,1,1,-1,2,1
KR_6748717652,440,0,7,-4,-4,3,3,0,-6,3,9,2,3,1,-2,4,6,-1,0,1,0,0,8,1,3,4,-2,0,1,-1,1,1,1,3,1
KR_6762569161,420,3,100,-24,8,4,5,1,1,2,1,2,3,1,2,5,3,-1,1,2,0,6,-23,2,2,4,2,0,1,-1,1,1,-1,3,1
KR_6688610189,420,3,81,-17,13,1,3,2,5,6,1,4,5,1,4,5,1,-1,1,2,0,17,-104,-3,7,4,3,0,0,-1,-1,1,1,4,1
KR_6765568204,420,4,80,-10,14,2,6,4,-2,0,2,7,7,0,10,10,0,-3,1,4,0,1,-2,4,1,5,3,0,1,0,-1,1,1,0,1
KR_6756442260,420,1,59,12,5,2,2,0,3,6,3,2,6,4,-1,2,3,-1,1,2,0,-5,-1,-2,6,4,4,0,-1,1,0,-1,-1,3,1
KR_6766144719,420,2,62,0,4,10,10,0,-6,0,6,1,2,1,-3,4,7,2,5,3,0,-18,3,4,4,8,1,0,1,-1,-1,-1,1,3,1
KR_6753297533,420,2,-30,25,7,6,7,1,-2,4,6,1,2,1,3,4,1,-1,1,2,0,9,-12,-3,10,7,7,0,1,1,1,1,-1,2,1
KR_6532683824,420,-3,46,-16,-5,-3,2,5,0,4,4,-1,1,2,-2,1,3,1,1,0,0,-12,6,4,3,7,0,0,0,-1,1,0,-1,5,1
KR_6738385349,440,1,32,-19,1,1,2,1,-3,1,4,-2,2,4,4,5,1,1,1,0,0,-2,-7,-4,5,1,3,0,-2,-1,-1,-1,1,6,1
KR_6761738803,440,2,64,5,6,1,3,2,2,3,1,2,4,2,0,4,4,1,2,1,0,0,-10,-1,4,3,1,0,2,1,1,1,1,2,1
KR_6732512856,420,1,-44,-33,2,-5,1,6,4,5,1,-1,5,6,4,4,0,0,0,0,-1,7,-24,2,4,6,-2,0,0,-1,-1,-1,-1,5,1
KR_6765905408,420,1,12,-5,-1,-1,3,4,-1,1,2,-2,4,6,2,2,0,1,1,0,0,-4,2,1,6,7,3,0,0,1,1,0,1,1,1
KR_6745429655,420,4,103,-16,8,3,3,0,-2,1,3,3,4,1,4,7,3,0,0,0,0,4,-12,0,4,4,3,0,1,1,-1,1,1,4,1
KR_6675947159,420,2,-31,-19,7,0,1,1,2,4,2,5,7,2,0,0,0,0,1,1,1,9,8,2,4,6,-5,0,0,1,-1,0,1,3,1
KR_6742424474,420,-1,47,16,-5,-3,0,3,1,2,1,0,1,1,-2,2,4,-1,1,2,0,-7,-97,3,3,6,5,0,1,1,1,1,-1,1,1
KR_6656418853,420,1,23,-8,1,1,3,2,1,4,3,5,5,0,-3,2,5,-3,0,3,-1,-2,-5,-5,9,4,-1,0,1,1,-1,-1,-1,3,1
KR_6744004460,420,6,99,-11,17,2,3,1,5,7,2,1,3,2,5,8,3,4,4,0,1,15,2,5,3,8,-2,0,0,1,-1,-1,1,5,1
KR_6505748931,420,6,117,-20,12,4,4,0,4,5,1,2,3,1,1,2,1,1,1,0,0,10,-149,1,4,5,5,0,2,1,1,1,1,1,1
KR_6726070299,440,3,119,20,9,0,0,0,0,3,3,1,1,0,8,8,0,0,2,2,0,10,8,-1,1,0,0,0,0,1,-1,1,1,6,1
KR_6764356136,420,3,58,12,8,6,6,0,2,3,1,2,7,5,-2,1,3,0,0,0,-1,3,9,4,5,9,0,0,0,1,0,0,-1,2,1
KR_6765345627,420,2,54,8,7,1,2,1,9,11,2,1,2,1,-3,1,4,-1,0,1,0,5,1,-1,7,6,3,0,1,-1,1,1,-1,4,1
KR_6729219310,420,4,86,10,4,0,1,1,4,4,0,2,3,1,-1,0,1,-1,1,2,0,0,15,1,8,9,1,0,1,1,1,1,-1,3,1
KR_6743376020,420,0,31,12,2,0,2,2,-1,2,3,6,7,1,-6,6,12,3,3,0,0,-1,-2,-3,10,7,4,0,0,-1,1,-1,-1,5,1
KR_6759548550,440,1,120,-24,7,0,0,0,5,5,0,1,1,0,0,1,1,1,3,2,0,5,185,4,1,5,4,0,0,1,1,0,1,6,1
KR_6740157004,420,4,-19,15,7,0,1,1,8,9,1,0,1,1,-1,1,2,0,1,1,0,4,-1,0,3,3,0,0,0,-1,1,1,1,3,1
KR_6756110871,420,1,59,15,5,-1,1,2,2,4,2,2,3,1,1,3,2,1,2,1,0,2,-3,-1,7,6,4,0,1,1,1,1,-1,1,1
KR_6709099534,420,2,22,28,-4,-4,2,6,2,4,2,3,5,2,-4,1,5,-1,0,1,-1,-3,8,1,5,6,-5,0,-1,1,-1,-1,-1,5,1
KR_6765119917,420,1,-58,7,2,2,2,0,2,3,1,0,2,2,-2,1,3,0,2,2,0,-1,-8,-1,7,6,2,0,0,1,-1,-1,1,2,1
KR_6752155925,420,5,25,22,20,4,4,0,3,4,1,5,7,2,7,8,1,1,2,1,2,17,95,4,2,6,1,0,2,1,1,1,1,6,1
KR_6764584407,440,0,-82,-2,1,-3,2,5,0,3,3,0,2,2,4,5,1,0,0,0,0,5,-6,3,2,5,0,0,-1,1,-1,-1,-1,5,1
KR_6749119788,420,3,51,3,7,2,2,0,3,5,2,4,4,0,-2,1,3,0,1,1,0,9,-46,2,2,4,1,0,2,1,-1,1,1,3,1
KR_6761696948,420,3,26,6,12,-2,1,3,1,4,3,4,4,0,4,4,0,5,5,0,0,15,-113,0,5,5,5,0,1,-1,0,1,1,2,1
KR_6759641415,420,-2,-8,-24,-9,-1,4,5,-8,0,8,0,3,3,-1,0,1,1,1,0,0,-19,-18,1,4,5,6,0,-1,-1,-1,-1,1,5,1
KR_6759313476,420,0,-17,-28,-4,1,3,2,2,3,1,2,4,2,-8,2,10,-1,0,1,0,-7,-1,-3,6,3,4,0,1,-1,1,1,-1,2,1
KR_6720180725,440,1,-29,1,12,-1,1,2,4,5,1,3,3,0,5,6,1,1,3,2,0,16,-21,1,5,6,3,0,1,-1,1,-1,1,3,1
KR_6413542449,420,1,-4,2,2,1,1,0,2,5,3,-2,2,4,0,2,2,1,2,1,0,2,-99,0,4,4,-1,0,1,-1,1,1,-1,3,1
KR_6758582385,420,-1,-9,-17,-3,-3,1,4,4,4,0,-2,2,4,-2,2,4,0,0,0,0,-1,-171,-4,8,4,6,0,1,-1,1,1,-1,3,1
KR_6666154143,420,3,75,39,5,1,3,2,1,3,2,1,4,3,2,3,1,0,0,0,0,4,4,-1,7,6,3,0,1,-1,1,1,1,5,1
KR_6757676805,420,0,15,29,1,5,5,0,-3,1,4,-1,1,2,2,4,2,-2,0,2,0,0,-101,4,3,7,3,0,0,1,1,1,-1,6,1
KR_6747508854,420,1,-97,12,5,1,2,1,3,5,2,-1,1,2,1,4,3,1,2,1,0,11,8,-2,7,5,-3,0,0,1,-1,0,-1,4,1
KR_6633211939,420,3,59,48,4,3,4,1,-4,1,5,0,2,2,6,6,0,-1,1,2,0,0,1,0,6,6,3,0,2,1,-1,1,1,2,1
KR_6696902266,420,0,-6,1,5,1,2,1,0,0,0,-3,1,4,6,6,0,1,2,1,0,0,-120,1,5,6,3,0,0,1,-1,0,1,3,1
KR_6753646292,420,2,44,-18,3,2,3,1,-4,2,6,0,1,1,5,5,0,0,2,2,1,9,57,-4,5,1,-20,0,2,1,-1,1,1,3,1
KR_6760222656,420,-4,-18,-7,-6,-5,1,6,-2,0,2,2,5,3,-1,3,4,0,2,2,0,0,1,2,3,5,1,0,0,-1,-1,-1,-1,1,1
KR_6628832744,420,3,41,-4,-1,-4,0,4,-3,0,3,4,4,0,3,5,2,-1,0,1,0,-6,7,1,5,6,5,0,1,-1,-1,1,-1,3,1
KR_6766383744,420,1,10,-40,5,0,1,1,0,2,2,3,4,1,2,2,0,0,0,0,0,6,-82,-3,6,3,-2,0,-1,-1,1,-1,1,6,1
KR_6763617470,420,0,4,16,-5,-1,0,1,-1,1,2,4,5,1,-7,1,8,0,0,0,0,-8,-6,-5,8,3,12,0,0,1,-1,0,1,2,1
KR_6619895433,420,2,-16,-27,-2,2,5,3,-1,3,4,0,5,5,-3,5,8,0,2,2,-2,4,-6,2,7,9,1,0,0,-1,1,1,-1,3,1
KR_6745141239,420,4,56,23,2,0,2,2,1,2,1,3,4,1,-3,1,4,1,2,1,-3,-3,-5,1,5,6,-1,0,0,1,0,0,-1,6,1
KR_6758822883,420,2,20,12,7,0,3,3,1,6,5,0,3,3,2,4,2,4,4,0,0,4,-11,5,6,11,-4,0,1,1,1,1,1,2,1
KR_6632566179,420,3,14,28,9,-1,0,1,4,4,0,1,3,2,4,5,1,1,1,0,0,11,-15,-3,9,6,-1,0,1,1,1,1,1,1,1
KR_6743198672,420,1,24,14,4,-1,3,4,1,5,4,1,2,1,2,3,1,1,4,3,0,5,-1,-3,6,3,1,0,1,1,-1,1,1,2,1
KR_6760275311,420,1,-7,12,7,3,3,0,-2,4,6,1,3,2,6,8,2,-1,1,2,2,7,9,-2,6,4,2,0,-1,-1,1,-1,1,5,1
KR_6667796230,420,2,15,-10,3,-1,1,2,4,4,0,4,4,0,0,0,0,-4,1,5,0,8,11,0,2,2,1,0,1,1,1,1,1,6,1
KR_6698646500,420,2,40,4,1,3,3,0,2,5,3,-2,2,4,-1,3,4,-1,1,2,0,0,5,4,3,7,-3,0,0,1,1,0,-1,3,1
KR_6734663796,420,4,77,43,8,-1,0,1,4,6,2,0,2,2,5,6,1,0,1,1,0,1,28,-2,6,4,-18,0,0,1,1,1,1,1,1
KR_6761479922,440,1,-36,-3,1,1,2,1,-2,2,4,1,4,3,0,2,2,1,2,1,-1,-6,4,3,6,9,2,0,-1,1,1,-1,-1,1,1
KR_6646767386,420,0,9,34,-7,-5,0,5,9,9,0,-13,0,13,3,4,1,-1,0,1,0,0,13,8,4,12,-6,0,0,0,-1,0,-1,0,1
KR_6729191847,420,0,47,-36,2,1,3,2,2,3,1,-3,0,3,2,2,0,0,0,0,0,2,17,1,3,4,2,0,1,1,1,1,1,3,1
KR_6634168697,420,4,32,20,5,4,5,1,1,4,3,2,3,1,-1,0,1,-1,0,1,0,3,-1,-1,4,3,-3,0,1,1,1,1,-1,3,1
KR_6722224077,420,6,92,20,9,5,6,1,6,7,1,-1,1,2,0,5,5,-1,1,2,0,4,6,2,3,5,0,0,1,-1,1,1,1,2,1
KR_6747409456,440,2,-4,-3,4,2,2,0,3,4,1,-1,4,5,-3,0,3,3,3,0,-1,4,95,-3,9,6,7,0,-1,-1,1,-1,-1,2,1
KR_6679621872,420,5,16,5,8,6,7,1,2,4,2,1,2,1,0,1,1,-1,0,1,0,4,1,4,1,5,-1,0,1,1,-1,1,1,1,1
KR_6759463686,420,1,0,-11,13,3,5,2,1,3,2,-2,2,4,10,13,3,1,2,1,3,25,-1,1,5,6,0,0,1,1,-1,1,1,4,1
KR_6684635125,420,0,-18,40,2,0,2,2,-3,2,5,5,8,3,1,3,2,-1,0,1,0,0,2,-3,7,4,3,0,0,1,-1,0,1,1,1
KR_6727902254,420,6,44,28,13,1,2,1,8,8,0,3,3,0,1,5,4,0,0,0,0,14,10,4,2,6,0,0,1,1,1,1,1,6,1
KR_6728496276,420,7,63,13,13,3,3,0,5,5,0,2,5,3,2,3,1,1,1,0,0,13,-3,3,4,7,9,0,2,1,1,1,-1,3,1
KR_6766507408,420,2,-13,-24,7,-2,0,2,10,11,1,1,4,3,-2,2,4,0,0,0,0,16,12,-6,9,3,1,0,1,-1,1,1,-1,2,1
KR_6761404658,420,-1,-34,-12,-6,-4,0,4,2,6,4,-2,1,3,-3,2,5,1,1,0,0,-9,36,-1,6,5,-2,0,0,-1,1,1,-1,5,1
KR_6764666628,420,-1,11,-8,6,2,4,2,9,9,0,-1,0,1,-3,2,5,-1,0,1,0,0,49,-4,6,2,-17,0,0,-1,1,1,-1,6,1
KR_6750223551,420,-1,46,14,0,3,3,0,3,3,0,-3,2,5,-2,3,5,-1,1,2,-3,-3,9,-2,5,3,4,0,1,-1,1,1,-1,5,1
KR_6762750267,420,1,87,-9,8,1,2,1,1,4,3,3,4,1,2,2,0,1,2,1,0,8,-41,-1,3,2,2,0,0,-1,-1,0,1,6,1
KR_6642269073,420,1,5,8,5,-1,0,1,3,4,1,3,5,2,1,3,2,-1,0,1,1,9,27,0,6,6,-2,0,1,1,1,1,1,2,1
KR_6731148457,420,2,2,-15,9,-6,0,6,2,3,1,10,12,2,3,6,3,0,1,1,0,-3,2,-3,7,4,3,0,1,1,-1,-1,-1,1,1
KR_6747023850,420,2,53,37,8,0,2,2,7,8,1,0,3,3,2,5,3,-1,1,2,0,12,8,2,6,8,3,0,1,1,-1,1,1,2,1
KR_6765706768,440,0,32,-18,6,2,2,0,6,6,0,0,2,2,0,2,2,-2,1,3,0,6,-13,4,4,8,-3,0,0,1,1,1,1,1,1
KR_6674262054,420,-2,-64,-11,3,-2,2,4,0,1,1,3,4,1,2,5,3,0,0,0,1,10,201,3,3,6,-1,0,0,-1,-1,0,1,2,1
KR_6751505537,440,3,85,-16,13,4,4,0,3,5,2,-1,1,2,4,8,4,3,4,1,-2,6,-5,1,1,2,1,0,2,1,0,1,-1,3,1
KR_6733092685,420,-2,-4,-7,-5,-1,0,1,-3,1,4,0,1,1,-2,1,3,1,2,1,0,-4,-4,0,5,5,-9,0,0,1,-1,-1,1,4,1
KR_6716750462,420,1,15,-12,3,0,2,2,-2,1,3,1,3,2,2,3,1,2,2,0,0,7,-23,1,7,8,6,0,1,-1,1,1,1,4,1
KR_6509165247,420,1,80,28,0,2,2,0,-3,1,4,5,8,3,-3,1,4,-1,0,1,-1,-8,4,-2,7,5,7,0,1,1,1,1,1,5,1
KR_6757000241,420,-1,37,8,-2,1,1,0,-1,1,2,0,3,3,-4,0,4,2,2,0,0,-6,9,-2,5,3,5,0,2,0,1,1,-1,0,1
KR_6729799974,420,6,71,20,8,0,1,1,2,4,2,1,4,3,7,9,2,-2,0,2,1,14,-17,2,3,5,-4,0,1,1,1,1,1,1,1
KR_6728952933,420,1,-48,15,2,0,3,3,2,3,1,1,4,3,1,2,1,-2,2,4,0,4,-10,0,4,4,4,0,0,1,-1,0,1,4,1
KR_6669910249,420,4,21,14,10,2,4,2,1,2,1,5,8,3,3,5,2,-1,2,3,0,7,3,-1,3,2,-2,0,2,1,1,1,1,4,1
KR_6749889849,420,1,24,-12,6,-1,2,3,3,4,1,0,2,2,3,4,1,1,1,0,0,13,-2,-3,4,1,3,0,2,1,1,1,-1,3,1
KR_6764056463,420,2,36,4,6,2,4,2,-3,5,8,5,5,0,1,5,4,1,2,1,0,12,-7,-1,4,3,2,0,0,-1,0,0,1,6,1
KR_6685305188,420,-2,-22,-22,2,3,3,0,-1,3,4,-1,1,2,2,3,1,-1,1,2,0,-4,108,-3,8,5,-2,0,1,-1,1,1,-1,3,1
KR_6647275928,420,3,-13,19,5,-1,1,2,2,8,6,3,5,2,1,2,1,0,1,1,0,12,-3,1,3,4,3,0,1,1,1,1,1,3,1
KR_6758984776,420,-2,-10,16,-2,-4,1,5,2,3,1,-2,0,2,0,3,3,2,2,0,0,9,10,3,2,5,-3,0,0,1,-1,0,1,1,1
KR_6703666058,420,2,7,40,3,-2,1,3,4,5,1,0,2,2,1,4,3,0,1,1,0,2,-68,2,3,5,17,0,0,1,1,1,1,2,1
KR_6729617078,420,-2,43,-26,-8,0,2,2,-1,2,3,-1,2,3,-6,1,7,0,1,1,0,-9,8,3,4,7,-2,0,-1,1,-1,1,-1,6,1
KR_6759902736,440,-3,0,-15,-8,-2,0,2,-5,1,6,3,3,0,-2,1,3,-2,0,2,0,-6,-7,0,7,7,0,0,0,-1,1,-1,-1,2,1
KR_6759424716,420,4,19,-8,9,6,6,0,0,0,0,0,1,1,3,5,2,0,1,1,1,13,16,0,4,4,1,0,1,0,-1,1,1,0,1
KR_6758736320,420,4,-7,52,4,1,4,3,3,5,2,2,4,2,0,5,5,-2,0,2,0,8,2,1,5,6,0,0,-1,1,-1,-1,1,6,1
KR_6745251859,420,2,34,12,6,0,0,0,-1,4,5,1,1,0,2,6,4,4,4,0,0,9,-2,5,2,7,-3,0,0,1,-1,0,1,5,1
KR_6762288155,420,0,57,18,-1,-5,1,6,6,7,1,2,2,0,-5,0,5,1,4,3,0,2,-9,-4,7,3,-1,0,-1,1,-1,-1,1,5,1
KR_6760935073,420,-1,-18,-23,-1,0,1,1,3,7,4,1,4,3,-5,1,6,0,1,1,-1,-3,0,-4,8,4,6,0,0,-1,0,0,-1,1,1
KR_6599508220,420,4,29,30,10,4,5,1,6,6,0,4,4,0,-4,1,5,0,2,2,0,9,-6,-3,6,3,-1,0,1,1,1,1,1,5,1
KR_6764603511,420,4,-12,4,9,-2,2,4,1,2,1,6,6,0,6,12,6,-2,0,2,2,16,153,2,3,5,-1,0,-1,-1,-1,-1,1,1,1
KR_6751781328,420,0,4,0,-5,-6,0,6,-1,2,3,1,2,1,1,4,3,0,2,2,0,-2,123,1,4,5,-1,0,1,1,-1,-1,-1,2,1
KR_6737615587,420,4,108,7,9,5,5,0,5,7,2,4,6,2,0,4,4,-5,0,5,1,9,7,-3,8,5,6,0,2,1,1,1,1,2,1
KR_6764163771,420,1,-36,-19,4,5,5,0,-1,3,4,-1,2,3,1,3,2,0,1,1,-2,1,-4,0,6,6,3,0,0,-1,1,-1,-1,1,1
KR_6652574283,420,-1,66,-8,-4,-2,0,2,-5,1,6,-1,1,2,5,6,1,-1,0,1,0,-5,-3,-1,3,2,0,0,0,1,-1,-1,1,2,1
KR_6761599296,440,1,9,8,5,-3,0,3,0,4,4,6,7,1,5,6,1,-3,0,3,0,4,8,3,3,6,4,0,2,1,1,1,1,5,1
KR_6711880040,420,4,85,-28,12,4,4,0,1,3,2,-1,2,3,6,8,2,2,2,0,1,13,-5,0,5,5,3,0,1,1,-1,1,1,2,1
KR_6728109254,440,0,-10,-2,4,1,3,2,2,3,1,-1,2,3,0,3,3,2,2,0,0,7,-7,3,3,6,2,0,-1,1,1,-1,-1,3,1
KR_6759040732,420,3,51,31,8,-3,1,4,1,2,1,3,4,1,4,6,2,3,5,2,0,3,-1,4,5,9,-2,0,0,-1,1,1,1,3,1
KR_6754519115,420,-1,67,12,0,2,3,1,-3,0,3,4,5,1,-2,1,3,-1,1,2,0,1,6,4,4,8,1,0,0,1,1,0,1,4,1
KR_6746007114,420,3,13,20,6,3,4,1,0,3,3,4,4,0,-1,3,4,0,2,2,0,5,3,-1,7,6,-6,0,0,1,-1,0,-1,4,1
KR_6704243210,420,4,53,10,9,2,3,1,1,3,2,4,4,0,1,4,3,1,3,2,0,10,56,4,2,6,3,0,1,1,1,1,-1,6,1
KR_6744552016,420,2,-11,12,9,0,2,2,-1,3,4,2,3,1,7,9,2,1,1,0,0,7,-6,3,7,10,7,0,1,-1,1,1,1,3,1
KR_6764656434,440,10,141,37,30,0,1,1,10,11,1,6,7,1,8,8,0,6,7,1,3,33,1,0,4,4,-2,0,2,0,0,1,1,0,1
KR_6688435560,420,2,2,-17,8,-3,1,4,2,7,5,1,4,3,5,5,0,3,3,0,-1,25,-1,2,5,7,-2,0,1,-1,-1,-1,-1,4,1
KR_6744025965,420,-1,-33,-22,2,0,0,0,3,3,0,-1,1,2,0,0,0,0,0,0,0,4,-5,0,7,7,-1,0,-2,-1,-1,-1,1,2,1
KR_6751944629,420,7,88,57,10,7,8,1,-2,3,5,5,6,1,0,2,2,0,0,0,-1,10,-21,-5,8,3,1,0,0,-1,1,0,-1,4,1
KR_6763383729,420,4,10,-17,9,2,4,2,1,1,0,3,4,1,3,4,1,0,0,0,1,10,-3,-1,7,6,6,0,0,1,0,0,-1,3,1
KR_6711681644,420,0,13,-36,6,-2,0,2,1,2,1,1,2,1,4,4,0,2,3,1,0,14,12,6,3,9,-4,0,-1,1,-1,-1,1,6,1
KR_6701640869,420,3,1,4,7,1,1,0,4,6,2,2,3,1,-2,0,2,2,2,0,0,10,6,5,2,7,1,0,0,-1,1,1,1,2,1
KR_6764512476,420,-1,-15,-16,-4,-1,1,2,4,4,0,-4,2,6,-2,4,6,-1,0,1,-1,-2,110,2,4,6,-1,0,0,-1,-1,0,-1,1,1
KR_6766507125,420,0,8,-8,3,4,5,1,0,3,3,-1,1,2,-1,0,1,1,1,0,0,4,47,0,5,5,-20,0,1,1,1,1,1,3,1
KR_6578796418,420,0,-7,0,-1,4,4,0,-3,3,6,2,2,0,-1,1,2,-3,0,3,0,-6,-6,-3,4,1,0,0,-1,1,-1,-1,-1,1,1
KR_6765716730,420,-1,28,-24,1,0,1,1,4,4,0,-1,4,5,-1,1,2,-1,3,4,-1,0,-13,3,3,6,0,0,0,0,0,1,-1,0,1
KR_6675748948,420,-4,-29,-6,-6,-5,1,6,3,5,2,-3,1,4,-1,0,1,0,0,0,0,-6,2,2,6,8,4,0,0,1,1,0,-1,5,1
KR_6741735063,420,-3,8,-20,-4,-5,0,5,-4,1,5,0,0,0,5,8,3,0,0,0,0,-3,-1,3,5,8,0,0,0,0,0,1,1,0,1
KR_6760162405,420,1,27,-16,9,7,8,1,-2,2,4,0,1,1,2,3,1,2,2,0,0,5,-9,-3,5,2,3,0,1,1,1,1,1,4,1
KR_6663451595,420,4,18,2,6,0,2,2,4,5,1,2,2,0,1,2,1,-1,0,1,0,8,4,5,5,10,-4,0,1,-1,1,1,1,2,1
KR_6617958563,420,3,38,40,2,2,3,1,3,6,3,-3,2,5,0,0,0,0,0,0,0,-2,-4,0,4,4,-2,0,0,1,1,0,-1,3,1
KR_6748784948,420,1,-13,-5,6,6,6,0,0,0,0,0,2,2,-1,2,3,1,2,1,0,5,0,1,4,5,0,0,0,-1,1,1,-1,1,1
KR_6749562111,420,0,11,-12,1,1,2,1,4,4,0,-3,2,5,-1,1,2,0,0,0,0,-4,57,3,4,7,-29,0,2,-1,1,1,1,3,1
KR_6741923635,440,1,8,27,2,-4,1,5,3,6,3,1,3,2,-1,4,5,3,3,0,0,5,-3,-1,3,2,1,0,0,0,1,1,1,0,1
KR_6759030638,420,1,38,20,0,3,4,1,-6,2,8,1,4,3,4,10,6,-2,0,2,0,6,-5,-3,6,3,3,0,1,1,-1,1,-1,5,1
KR_6687215990,420,7,130,35,6,6,6,0,1,3,2,0,2,2,-2,1,3,1,1,0,-1,0,293,3,4,7,-4,0,2,1,1,1,-1,3,1
KR_6676710763,420,5,44,52,8,7,7,0,0,1,1,3,3,0,-1,1,2,-1,0,1,0,1,18,-3,6,3,-3,0,1,1,1,1,1,4,1
KR_6669871419,420,4,64,4,9,3,3,0,-1,2,3,7,7,0,1,2,1,-1,1,2,0,2,6,-4,6,2,-1,0,2,1,-1,1,1,4,1
KR_6749298959,420,3,-7,10,6,3,5,2,6,7,1,1,1,0,-4,1,5,0,0,0,0,12,-3,5,4,9,5,0,1,1,1,1,-1,5,1
KR_6755452757,420,3,55,4,-2,-3,2,5,0,2,2,-1,1,2,0,5,5,2,2,0,0,1,30,-2,5,3,4,0,-1,-1,-1,-1,-1,2,1
KR_6747486097,440,2,2,0,4,-7,1,8,1,3,2,6,6,0,2,3,1,2,3,1,0,8,49,-1,4,3,-12,0,0,0,0,1,-1,0,1
KR_6731917827,440,4,110,28,14,10,10,0,5,6,1,4,5,1,-6,2,8,1,3,2,1,1,-21,-3,4,1,0,0,2,1,-1,1,1,5,1
KR_6766413316,420,1,85,-39,9,9,9,0,-3,4,7,0,1,1,0,1,1,3,3,0,0,3,-31,5,3,8,4,0,2,-1,1,1,1,5,1
KR_6700554023,420,6,90,23,13,0,0,0,9,9,0,2,7,5,0,3,3,2,4,2,1,4,-8,3,4,7,4,0,3,1,1,1,1,3,1
KR_6762987896,420,2,41,22,7,2,3,1,-1,3,4,2,3,1,4,4,0,0,3,3,0,5,1,-2,7,5,-1,0,2,1,1,1,1,1,1
KR_6654516985,420,5,64,27,10,-1,4,5,7,8,1,3,3,0,1,2,1,0,2,2,1,16,41,-1,7,6,1,0,3,0,1,1,1,0,1
KR_6055772663,420,2,-3,48,5,-2,3,5,2,5,3,8,9,1,-1,2,3,-2,0,2,1,1,-9,-2,5,3,3,0,1,1,-1,1,1,2,1
KR_6717574922,420,2,50,20,4,3,3,0,-1,0,1,0,3,3,0,1,1,2,2,0,0,1,2,2,6,8,-1,0,1,-1,1,1,1,5,1
KR_6766098119,420,1,-35,27,0,3,5,2,2,3,1,1,2,1,-5,1,6,-1,2,3,0,0,-9,0,7,7,1,0,0,1,1,-1,-1,2,1
KR_6635821860,420,5,1,5,14,2,5,3,7,8,1,4,5,1,0,2,2,1,1,0,0,19,1,0,5,5,1,0,0,1,0,0,1,5,1
KR_6737359012,420,1,48,20,1,-3,0,3,-2,4,6,0,3,3,8,8,0,-2,1,3,1,4,8,4,3,7,-1,0,0,0,1,1,1,0,1
KR_6723107877,420,4,24,8,2,-1,2,3,5,9,4,3,5,2,-5,1,6,0,1,1,0,3,-3,6,3,9,2,0,1,-1,1,1,-1,4,1
KR_6665966268,420,-1,11,17,0,4,4,0,0,0,0,1,2,1,-4,1,5,-1,0,1,0,-5,46,7,2,9,-39,0,2,-1,1,-1,-1,5,1
KR_6707356933,420,2,-10,-1,9,0,2,2,2,2,0,-1,3,4,6,8,2,2,6,4,0,9,4,1,5,6,1,0,1,1,1,1,-1,2,1
KR_6737505866,420,0,-9,-16,9,2,4,2,8,8,0,-2,4,6,4,7,3,-3,2,5,3,12,11,3,3,6,-3,0,0,-1,-1,1,1,4,1
KR_6739365671,420,4,92,-12,11,0,2,2,0,4,4,4,8,4,4,5,1,3,5,2,1,5,203,-1,3,2,-1,0,0,1,-1,1,1,5,1
KR_6696579390,420,1,38,48,-1,0,2,2,0,2,2,3,5,2,-4,3,7,0,0,0,0,-4,8,4,5,9,-1,0,0,1,1,-1,1,1,1
KR_6654357621,420,-2,-40,-8,-5,-4,0,4,-1,4,5,-3,3,6,2,4,2,1,1,0,0,2,-10,-4,8,4,0,0,-2,1,-1,-1,1,1,1
KR_6737840490,420,4,77,13,10,3,3,0,-1,2,3,-1,0,1,7,9,2,2,2,0,0,12,3,2,1,3,0,0,1,1,1,1,1,4,1
KR_6752524125,420,4,16,20,9,-1,0,1,-1,1,2,0,3,3,8,9,1,3,4,1,1,7,12,5,1,6,-6,0,1,0,1,1,1,0,1
KR_6758945168,420,4,79,-8,3,1,2,1,1,3,2,2,2,0,-2,2,4,1,2,1,0,4,68,3,3,6,-28,0,0,-1,1,1,-1,1,1
KR_6650768042,420,-3,-8,14,-2,-2,0,2,0,4,4,1,3,2,-1,2,3,0,0,0,0,-3,-99,4,4,8,-2,0,-1,1,-1,-1,1,5,1
KR_6765573197,440,-2,12,21,-5,1,4,3,0,1,1,0,1,1,-4,0,4,-2,0,2,1,-6,-3,-4,7,3,5,0,-1,-1,-1,-1,1,2,1
KR_6685830382,420,4,29,40,6,1,2,1,-2,2,4,2,3,1,3,3,0,2,3,1,0,7,1,2,6,8,8,0,1,1,-1,1,1,6,1
KR_6737377744,420,-1,-45,60,0,-2,2,4,1,1,0,6,6,0,-6,0,6,1,3,2,0,4,9,-2,5,3,2,0,-1,1,1,-1,-1,5,1
KR_6759695347,420,2,55,-22,12,1,3,2,3,5,2,4,4,0,1,4,3,3,3,0,1,6,-2,0,5,5,5,0,2,1,-1,1,1,1,1
KR_6764310037,440,10,156,60,22,-1,1,2,5,5,0,3,3,0,12,13,1,3,4,1,0,12,16,2,0,2,1,0,4,1,1,1,1,4,1
KR_6735138305,420,-4,-30,-1,-6,-4,0,4,0,3,3,-2,1,3,1,6,5,-1,0,1,0,-3,1,3,4,7,-3,0,0,0,1,-1,-1,0,1
KR_6729049650,420,0,10,-8,8,5,5,0,0,2,2,2,6,4,4,4,0,-3,0,3,0,10,-2,-1,5,4,-1,0,1,1,1,1,-1,5,1
KR_6765646872,420,3,55,-1,11,-2,0,2,5,7,2,3,3,0,4,5,1,1,2,1,2,19,-23,-4,7,3,4,0,0,1,-1,1,1,4,1
KR_6652543904,420,2,-6,13,8,1,2,1,-1,3,4,1,2,1,2,2,0,5,6,1,4,17,129,1,5,6,3,0,1,1,-1,1,1,4,1
KR_6760243509,420,6,15,1,17,4,6,2,4,4,0,4,4,0,6,7,1,-1,1,2,-1,14,223,9,1,10,-1,0,1,-1,1,1,-1,2,1
KR_6763157015,420,0,-33,-3,5,-1,2,3,-2,3,5,7,7,0,-4,2,6,5,5,0,0,8,-2,-1,7,6,5,0,1,1,1,1,1,2,1
KR_6685136430,440,2,96,4,-1,3,4,1,1,3,2,2,3,1,-5,0,5,-2,0,2,0,-5,12,3,4,7,-5,0,0,1,1,1,-1,6,1
KR_6654462995,420,-7,-61,-4,-7,0,3,3,-2,1,3,-4,1,5,0,1,1,-1,0,1,0,-6,-114,1,5,6,-6,0,-2,-1,-1,-1,1,6,1
KR_6736876466,420,6,80,54,15,7,7,0,-2,0,2,-3,2,5,14,16,2,-1,0,1,2,16,1,3,7,10,3,0,2,-1,1,1,1,2,1
KR_6730546638,420,3,30,-4,9,3,4,1,8,9,1,1,5,4,-3,0,3,0,1,1,0,9,165,1,6,7,10,0,2,1,1,1,1,5,1
KR_6718780828,420,5,14,44,18,1,4,3,8,9,1,5,5,0,4,6,2,0,2,2,1,10,-9,-4,6,2,5,0,2,1,1,1,1,4,1
KR_6728496305,440,4,-29,47,9,-2,4,6,5,5,0,3,4,1,6,7,1,-3,0,3,0,18,-1,2,3,5,0,0,-1,1,1,-1,-1,2,1
KR_6761780276,440,9,78,24,18,-1,1,2,2,3,1,12,12,0,0,4,4,5,5,0,0,12,-1,6,4,10,6,0,1,1,-1,1,1,6,1
KR_6760982809,420,-2,-11,5,3,0,2,2,0,2,2,0,1,1,0,2,2,3,4,1,1,2,34,1,4,5,-4,0,1,1,-1,1,1,5,1
KR_6758089895,420,0,39,-12,3,1,2,1,-2,1,3,0,2,2,2,3,1,2,2,0,1,2,1,0,6,6,1,0,0,1,-1,0,1,4,1
KR_6722263999,440,9,93,67,15,-2,0,2,2,6,4,10,10,0,2,3,1,3,3,0,0,0,-30,-1,4,3,23,0,0,1,-1,1,1,1,1
KR_6759929624,420,5,84,16,7,2,4,2,2,2,0,0,0,0,2,6,4,1,4,3,0,0,4,-3,6,3,2,0,1,-1,0,1,-1,3,1
KR_6535942612,420,3,44,24,6,4,5,1,1,4,3,1,5,4,3,4,1,-3,0,3,0,-3,-4,2,2,4,1,0,3,1,1,1,-1,2,1
KR_6743405994,420,1,20,36,5,0,2,2,0,2,2,1,2,1,2,2,0,2,2,0,0,8,-20,-1,4,3,2,0,0,1,-1,1,-1,5,1
KR_6511158511,420,6,80,16,10,3,4,1,-3,0,3,-1,1,2,9,9,0,2,2,0,1,10,2,-5,9,4,4,0,1,1,1,1,1,5,1
KR_6761648250,420,5,80,17,12,-1,3,4,2,3,1,5,7,2,5,6,1,1,1,0,0,10,-10,-4,6,2,0,0,1,1,1,1,1,4,1
KR_6706903341,420,3,3,42,1,4,4,0,-1,3,4,2,4,2,-5,2,7,1,2,1,2,1,1,0,3,3,-2,0,1,1,1,1,1,6,1
KR_6765828816,420,1,23,15,1,2,6,4,0,1,1,-1,1,2,0,2,2,0,0,0,0,-2,-14,1,4,5,-2,0,1,-1,1,1,-1,4,1
KR_6716199276,420,2,-21,5,7,0,1,1,6,6,0,2,2,0,1,3,2,-2,0,2,1,9,2,3,5,8,-1,0,0,0,1,0,1,0,1
KR_6753474285,420,3,86,19,5,-3,1,4,1,2,1,1,3,2,5,6,1,1,1,0,0,10,-11,-6,9,3,2,0,2,0,1,1,1,0,1
KR_6732892663,420,1,32,12,5,0,1,1,2,5,3,0,3,3,3,4,1,0,0,0,0,8,21,3,3,6,5,0,1,1,1,1,1,6,1
KR_6763542973,420,5,50,12,6,0,1,1,6,9,3,0,1,1,1,3,2,-1,1,2,-2,0,8,4,2,6,3,0,0,1,1,1,-1,3,1
KR_6694667319,420,6,12,32,15,-1,1,2,7,7,0,2,4,2,5,6,1,2,2,0,0,17,289,3,5,8,2,0,1,1,1,1,1,5,1
KR_6631143240,420,1,-16,-30,1,0,3,3,0,4,4,-1,2,3,3,4,1,-1,0,1,0,7,10,0,5,5,4,0,1,-1,0,1,-1,5,1
KR_6747437787,420,4,53,14,16,2,3,1,2,3,1,6,6,0,3,8,5,3,3,0,0,15,-30,-1,7,6,27,0,1,-1,1,1,1,3,1
KR_6737456911,420,3,2,-23,2,0,0,0,0,3,3,2,4,2,-2,3,5,2,4,2,0,3,-17,0,3,3,5,0,1,1,1,1,-1,2,1
KR_6746293054,420,0,-47,22,4,0,1,1,3,6,3,2,4,2,0,2,2,-1,0,1,0,5,26,-2,7,5,6,0,0,1,1,0,1,2,1
KR_6764178595,420,1,78,-12,4,1,2,1,2,3,1,-1,2,3,3,4,1,-1,0,1,0,2,-141,2,4,6,21,0,1,1,1,1,1,1,1
KR_6737560068,420,2,71,-6,4,1,2,1,-3,4,7,6,7,1,-3,0,3,3,4,1,0,0,7,4,6,10,0,0,1,1,1,1,1,4,1
KR_6763405117,440,-2,-30,16,-7,1,2,1,-4,0,4,-6,1,7,1,3,2,1,2,1,0,1,-1,-4,6,2,-2,0,-2,-1,-1,-1,-1,6,1
KR_6647208901,420,1,7,-20,5,2,2,0,-1,2,3,-3,1,4,3,5,2,4,4,0,-1,6,2,4,3,7,2,0,-1,1,-1,-1,-1,2,1
KR_6763938678,420,2,38,38,6,-3,0,3,3,4,1,-1,3,4,6,6,0,1,1,0,3,24,-153,5,0,5,1,0,0,1,0,0,1,2,1
KR_6765666072,420,-2,-98,-14,2,0,1,1,1,2,1,4,5,1,-3,1,4,0,0,0,-2,0,13,6,1,7,-2,0,-2,-1,-1,-1,-1,3,1
KR_6761488689,420,2,1,-16,6,2,2,0,0,2,2,3,3,0,1,2,1,0,3,3,0,4,1,3,5,8,2,0,0,0,-1,0,1,0,1
KR_6752802877,420,4,10,-4,6,0,1,1,-1,1,2,3,5,2,3,4,1,1,1,0,0,4,8,-1,5,4,-1,0,0,-1,0,0,1,3,1
KR_6736374145,420,1,-3,-16,3,2,2,0,0,4,4,2,5,3,-1,0,1,0,0,0,0,1,3,-1,8,7,9,0,0,-1,-1,0,1,1,1
KR_6763697687,440,7,188,57,23,-4,3,7,6,8,2,15,16,1,8,9,1,-2,0,2,5,8,-1,3,2,5,2,0,3,1,1,1,1,5,1
KR_6716251407,420,1,45,20,6,-4,0,4,-2,4,6,6,7,1,3,6,3,3,3,0,0,5,-1,-2,5,3,4,0,-1,1,-1,-1,1,4,1
KR_6722443800,420,-1,5,-8,-2,4,4,0,-1,0,1,-1,1,2,-5,0,5,1,1,0,-1,-6,6,2,3,5,-1,0,1,1,1,1,-1,2,1
KR_6750341801,420,-2,-46,-8,-2,3,3,0,0,2,2,-1,1,2,-3,2,5,-1,0,1,0,2,-9,-2,6,4,0,0,-1,-1,1,-1,-1,2,1
KR_6733009097,420,5,30,32,9,1,3,2,5,6,1,1,1,0,1,3,2,1,1,0,0,13,-47,0,6,6,17,0,0,1,-1,-1,1,5,1
KR_6748182337,440,1,65,20,0,0,2,2,-2,4,6,0,4,4,3,3,0,-1,0,1,0,-2,7,2,1,3,1,0,1,0,1,1,1,0,1
KR_6757619548,420,5,67,24,9,3,6,3,-1,3,4,1,1,0,5,6,1,1,1,0,0,4,-3,-1,8,7,4,0,1,0,1,1,-1,0,1
KR_6693913271,420,2,7,0,0,2,4,2,2,4,2,-3,1,4,0,2,2,-1,0,1,0,-3,2,-2,6,4,0,0,0,-1,-1,0,-1,6,1
KR_6708377025,420,-3,-18,-12,-6,-5,0,5,-2,0,2,1,5,4,0,4,4,0,0,0,0,-7,25,4,3,7,-1,0,0,1,1,0,1,5,1
KR_6716753406,420,2,44,21,3,1,1,0,0,3,3,2,5,3,1,2,1,-1,2,3,0,-6,6,1,4,5,2,0,0,-1,1,0,-1,5,1
KR_6678123830,420,3,57,56,6,3,3,0,2,3,1,-1,3,4,2,3,1,0,1,1,0,-2,-3,1,6,7,0,0,1,-1,1,1,1,1,1
KR_6760530433,420,5,104,-13,15,3,3,0,4,4,0,4,5,1,5,6,1,-1,0,1,0,18,26,-4,9,5,3,0,2,1,1,1,1,4,1
KR_6685030366,420,-3,-12,-16,-6,2,2,0,-2,2,4,-1,1,2,-2,1,3,-3,0,3,0,-12,-13,0,4,4,0,0,-1,-1,1,-1,1,3,1
KR_6762721784,420,0,-15,-27,2,3,3,0,1,7,6,0,5,5,-2,3,5,0,0,0,0,-4,12,7,2,9,0,0,2,0,1,1,1,0,1
KR_6758798181,420,1,-29,-16,-7,1,3,2,-5,1,6,2,6,4,-2,5,7,-3,2,5,0,-18,46,3,3,6,-8,0,-1,-1,-1,1,-1,6,1
KR_6651626341,420,5,54,12,14,1,1,0,4,4,0,10,11,1,-5,3,8,4,4,0,0,10,-5,-1,4,3,3,0,2,1,1,1,-1,4,1
KR_6723177544,420,0,7,24,2,-1,0,1,2,3,1,1,5,4,2,4,2,-2,1,3,0,-5,6,4,2,6,0,0,1,1,0,1,1,4,1
KR_6766019879,420,1,-9,-28,9,-2,0,2,4,6,2,5,7,2,3,5,2,-1,0,1,0,7,1,-1,7,6,2,0,2,0,1,1,-1,0,1
KR_6704071095,420,5,71,44,9,6,7,1,3,7,4,1,2,1,-1,1,2,0,2,2,0,-1,3,0,6,6,0,0,1,1,1,1,-1,6,1
KR_6597813594,420,-1,17,15,1,-3,0,3,3,5,2,3,4,1,1,5,4,-3,0,3,0,6,10,-1,6,5,2,0,1,-1,1,1,1,6,1
KR_6764032281,420,0,12,8,2,-2,2,4,-1,2,3,0,1,1,3,5,2,2,3,1,0,2,10,2,7,9,1,0,0,-1,1,1,1,3,1
KR_6654204235,420,3,0,28,6,5,5,0,-3,1,4,3,3,0,0,3,3,1,2,1,0,7,8,-1,5,4,0,0,0,-1,0,1,1,2,1
KR_6726698290,420,0,-30,-20,1,0,0,0,-1,2,3,3,6,3,0,2,2,-1,1,2,1,3,1,0,6,6,2,0,0,1,-1,0,1,2,1
KR_6748483303,420,0,-43,-8,2,1,4,3,1,5,4,0,6,6,1,3,2,-1,0,1,0,15,9,0,5,5,4,0,0,1,1,0,1,3,1
KR_6765648475,420,1,56,32,4,0,1,1,-1,3,4,4,6,2,1,3,2,0,1,1,0,-2,3,-3,7,4,0,0,0,1,-1,1,-1,6,1
KR_6759308076,420,4,0,60,6,-1,1,2,1,1,0,3,5,2,1,2,1,2,2,0,1,2,39,3,2,5,-6,0,1,1,1,1,1,3,1
KR_6631013526,420,1,63,8,4,-1,1,2,2,5,3,0,2,2,1,4,3,2,3,1,-1,-8,2,3,3,6,-6,0,1,-1,1,1,-1,3,1
KR_6747990435,420,2,-21,11,3,1,2,1,-2,3,5,-1,1,2,4,6,2,1,1,0,0,3,1,-2,7,5,-4,0,0,-1,-1,0,-1,3,1
KR_6760310514,420,-2,-36,8,0,1,1,0,2,3,1,-3,2,5,-2,1,3,2,2,0,0,3,-28,3,1,4,1,0,0,1,1,0,1,4,1
KR_6761917549,420,3,24,-32,16,2,4,2,5,5,0,-2,0,2,10,11,1,1,1,0,0,17,11,3,2,5,-2,0,2,-1,1,1,1,2,1
KR_6755940630,420,1,15,-28,5,2,3,1,0,4,4,1,2,1,4,4,0,-2,0,2,0,7,1,1,5,6,0,0,0,-1,-1,1,-1,3,1
KR_6734447083,440,-2,-14,-39,-5,0,4,4,-4,0,4,-5,0,5,5,6,1,-1,0,1,0,10,3,1,5,6,-3,0,-2,1,-1,-1,-1,3,1
KR_6719919626,420,-2,-24,-20,-5,0,2,2,2,5,3,-5,2,7,-1,0,1,-1,0,1,0,0,9,1,4,5,-3,0,0,-1,1,0,1,4,1
KR_6744522543,420,3,20,24,5,3,4,1,-3,1,4,2,5,3,-3,2,5,6,7,1,-1,5,2,-2,6,4,-3,0,1,1,1,1,-1,4,1
KR_6762692749,420,8,32,4,9,0,2,2,-2,1,3,0,3,3,6,7,1,5,5,0,-1,12,-32,1,4,5,4,0,2,1,1,1,-1,3,1
KR_6762010181,440,5,83,69,8,-1,0,1,6,6,0,4,4,0,0,1,1,-1,1,2,0,8,20,5,2,7,-3,0,0,0,1,0,1,0,1
KR_6725427465,420,10,128,36,16,6,6,0,1,2,1,5,6,1,3,4,1,1,1,0,0,7,10,5,1,6,-2,0,2,1,1,1,1,2,1
KR_6688977458,420,-1,1,-26,6,-2,1,3,4,5,1,-2,1,3,4,6,2,2,2,0,0,13,-3,-2,10,8,-2,0,0,1,-1,1,1,6,1
KR_6743185331,440,5,56,36,10,3,3,0,5,8,3,0,1,1,3,4,1,-1,3,4,0,8,-9,1,4,5,2,0,1,1,1,1,1,4,1
KR_6758431334,420,4,-10,21,8,0,4,4,5,6,1,1,3,2,2,2,0,0,0,0,0,12,18,1,2,3,-1,0,0,1,0,0,1,2,1
KR_6764545438,420,1,52,9,2,-2,2,4,0,1,1,2,5,3,1,1,0,1,1,0,0,0,-1,0,6,6,2,0,1,-1,-1,1,1,1,1
KR_6718264043,420,9,153,28,19,7,8,1,6,10,4,5,5,0,-1,2,3,2,2,0,2,7,290,10,2,12,4,0,2,1,1,1,-1,1,1
KR_6755531231,420,3,73,0,4,1,3,2,-1,2,3,4,8,4,1,4,3,-1,0,1,0,3,-9,-3,6,3,4,0,1,1,1,1,1,4,1
KR_6738736278,420,-4,2,-32,-1,-1,3,4,0,5,5,-3,2,5,2,3,1,1,2,1,0,2,-7,3,3,6,0,0,1,-1,1,1,1,4,1
KR_6743637502,420,7,71,24,9,3,4,1,6,6,0,1,5,4,-2,1,3,1,2,1,0,6,5,1,2,3,4,0,0,-1,1,0,-1,5,1
KR_6670257104,420,2,-37,29,4,1,2,1,4,7,3,1,6,5,1,3,2,-3,0,3,-1,12,2,-2,6,4,-2,0,0,1,1,-1,-1,4,1
KR_6620012372,420,5,51,37,4,-4,2,6,6,12,6,3,4,1,0,2,2,-1,2,3,-1,9,-6,-3,9,6,6,0,0,0,1,1,-1,0,1
KR_6749124754,420,-2,-74,-16,-1,-6,1,7,1,5,4,0,2,2,3,5,2,1,1,0,0,9,281,4,3,7,-2,0,-2,-1,0,-1,-1,3,1
KR_6745587857,420,-2,-12,13,0,-4,1,5,-7,1,8,5,6,1,8,12,4,-2,1,3,0,0,1,4,2,6,-3,0,2,1,1,-1,-1,6,1
KR_6729318551,420,0,-46,8,0,0,1,1,4,6,2,0,2,2,-2,3,5,-2,1,3,0,2,4,-2,9,7,-3,0,0,-1,-1,0,1,1,1
KR_6717407038,420,-1,-26,-7,-8,1,1,0,-7,2,9,-2,0,2,-4,1,5,4,4,0,0,-14,-200,-1,5,4,0,0,0,-1,1,-1,-1,4,1
KR_6727472877,420,9,164,8,21,4,6,2,2,3,1,5,5,0,9,10,1,1,3,2,0,13,-32,1,8,9,0,0,3,1,-1,1,1,3,1
KR_6756968304,420,-2,6,-8,1,2,3,1,-2,0,2,2,3,1,-2,2,4,1,3,2,0,5,-21,-3,8,5,8,0,0,1,1,1,-1,1,1
KR_6748379542,420,3,60,-4,7,2,2,0,-2,1,3,2,5,3,3,5,2,2,2,0,0,5,-20,2,7,9,-4,0,0,-1,-1,0,1,5,1
KR_6679694557,420,-2,-6,0,-5,-1,0,1,0,3,3,-4,0,4,2,3,1,-2,2,4,0,-4,7,-2,5,3,1,0,-1,1,-1,-1,-1,3,1
KR_6667826152,420,1,1,-8,-5,1,3,2,-2,0,2,-1,2,3,-2,0,2,-1,0,1,0,-5,-5,-4,5,1,-3,0,0,0,-1,-1,-1,0,1
KR_6660524418,440,3,60,23,9,1,6,5,0,2,2,2,4,2,4,5,1,2,3,1,0,5,8,3,2,5,1,0,0,1,0,1,-1,4,1
KR_6690275857,420,3,36,9,3,-1,1,2,2,5,3,3,4,1,-2,0,2,1,1,0,0,4,1,0,4,4,4,0,1,1,0,1,1,5,1
KR_6751430117,420,2,35,-4,7,1,2,1,-3,1,4,7,7,0,1,2,1,1,1,0,0,1,0,3,0,3,5,0,2,1,1,1,1,4,1
KR_6762425759,420,3,36,-8,13,4,4,0,-3,2,5,3,3,0,7,9,2,2,3,1,2,19,-5,-3,5,2,2,0,0,-1,1,-1,1,2,1
KR_6749378788,420,3,64,-16,9,5,5,0,0,5,5,1,2,1,1,1,0,2,2,0,0,5,12,3,4,7,-7,0,3,1,1,1,1,6,1
KR_6655720866,420,5,130,-20,15,5,6,1,4,6,2,5,7,2,1,5,4,0,0,0,3,19,251,1,2,3,2,0,1,1,1,1,1,5,1
KR_6751113730,420,2,39,16,9,-1,1,2,5,8,3,5,5,0,-1,1,2,1,1,0,-1,14,29,-4,7,3,-2,0,1,1,1,1,-1,3,1
KR_6704834685,420,1,0,7,2,0,3,3,4,5,1,1,3,2,0,0,0,-3,0,3,0,3,-9,3,2,5,2,0,-1,1,1,-1,1,1,1
KR_6562005816,420,2,29,36,-4,-2,1,3,3,8,5,1,2,1,-7,0,7,1,3,2,2,-2,4,3,6,9,-8,0,1,1,1,1,1,6,1
KR_6699693948,420,1,19,11,2,1,3,2,5,5,0,-5,1,6,0,4,4,1,2,1,0,6,-1,5,4,9,-4,0,0,-1,-1,0,-1,6,1
KR_6655692748,420,1,-23,11,6,0,3,3,4,5,1,-2,2,4,4,5,1,0,1,1,0,8,-55,-3,7,4,21,0,0,-1,0,0,-1,6,1
KR_6723844015,420,3,15,1,8,-2,2,4,2,3,1,5,6,1,3,3,0,0,0,0,0,16,7,-5,8,3,4,0,0,1,1,0,1,3,1
KR_6270410551,420,5,68,22,12,0,2,2,5,7,2,1,2,1,4,5,1,2,3,1,0,8,2,0,5,5,4,0,2,1,1,1,1,1,1
KR_6757146007,420,-1,-13,6,-8,7,8,1,0,2,2,-4,0,4,-8,2,10,-3,0,3,0,-12,4,0,6,6,-7,0,-1,0,-1,-1,1,0,1
KR_6628006340,420,2,-3,-20,1,0,3,3,-1,0,1,-1,1,2,3,9,6,0,0,0,-1,-5,-2,-4,10,6,1,0,0,1,-1,0,-1,3,1
KR_6659031805,420,4,69,16,8,5,5,0,-1,1,2,4,5,1,0,1,1,0,0,0,0,7,20,2,3,5,1,0,1,1,1,1,1,3,1
KR_6754505139,420,3,18,12,1,-1,2,3,2,5,3,2,3,1,1,3,2,-3,0,3,0,7,73,0,5,5,-18,0,0,1,-1,0,-1,1,1
KR_6684100059,420,3,64,40,6,3,4,1,-5,0,5,2,5,3,5,6,1,1,3,2,0,4,6,2,1,3,-2,0,2,1,-1,1,1,6,1
KR_6698045680,420,4,4,32,6,-2,1,3,2,5,3,3,4,1,-1,1,2,4,4,0,0,1,58,4,3,7,-23,0,1,1,1,1,-1,3,1
KR_6692633185,420,2,74,0,11,0,2,2,7,8,1,3,4,1,-1,2,3,2,2,0,0,9,3,0,2,2,0,0,2,1,-1,-1,1,3,1
KR_6746471273,420,2,3,24,6,2,6,4,0,3,3,4,5,1,2,4,2,-2,0,2,0,3,-9,2,6,8,3,0,-1,-1,-1,-1,1,3,1
KR_6678960547,420,0,91,-1,3,3,5,2,2,5,3,-1,5,6,-1,2,3,0,1,1,1,-3,-2,0,2,2,2,0,0,1,0,1,1,2,1
KR_6763012013,440,-1,-23,-20,-1,-1,3,4,-1,1,2,2,3,1,-1,2,3,0,0,0,0,6,5,5,1,6,-3,0,0,1,-1,0,-1,5,1
KR_6707067232,420,8,118,3,14,0,1,1,2,3,1,2,5,3,9,9,0,1,1,0,0,10,4,-1,3,2,1,0,2,-1,-1,1,1,1,1
KR_6750112976,440,3,74,32,6,1,4,3,-1,2,3,2,5,3,1,1,0,3,6,3,0,-1,-1,-1,4,3,2,0,2,1,-1,1,1,5,1
KR_6764849847,420,1,10,12,6,-4,1,5,4,5,1,0,0,0,5,5,0,1,1,0,3,8,18,1,4,5,0,0,1,1,-1,1,1,2,1
KR_6765553436,420,4,26,16,9,5,5,0,3,3,0,1,4,3,1,4,3,-1,1,2,1,1,-7,3,4,7,-1,0,0,1,-1,1,1,4,1
KR_6685215180,420,7,28,22,16,6,7,1,6,9,3,1,1,0,1,3,2,2,2,0,1,8,8,3,3,6,1,0,2,1,1,1,1,1,1
KR_6442838965,420,4,67,11,6,2,5,3,2,5,3,2,2,0,0,1,1,0,0,0,0,6,-7,0,7,7,3,0,1,-1,0,1,-1,1,1
KR_6695579165,420,-1,-31,27,0,-1,1,2,3,5,2,-2,5,7,-1,1,2,1,1,0,1,4,-13,-2,6,4,5,0,-2,-1,1,1,1,3,1
KR_6766179754,420,3,105,-16,11,4,4,0,-1,2,3,2,3,1,4,5,1,2,2,0,1,10,-2,-1,4,3,5,0,2,1,-1,1,1,5,1
KR_6729137271,420,-1,-29,30,-16,-4,4,8,-4,0,4,-2,2,4,-3,1,4,-3,0,3,0,-15,-13,-2,8,6,1,0,0,-1,1,-1,1,5,1
KR_6753220481,420,5,40,57,6,3,3,0,0,3,3,0,2,2,2,4,2,1,2,1,0,3,159,4,6,10,4,0,2,-1,1,1,1,2,1
KR_6766560948,440,4,139,20,14,10,11,1,2,2,0,-1,2,3,4,6,2,-1,1,2,0,5,-41,1,1,2,1,0,1,-1,1,1,1,2,1
KR_6686566552,420,-1,-30,28,-2,-1,1,2,2,5,3,-1,2,3,-2,4,6,0,0,0,1,-2,2,1,5,6,-1,0,0,1,1,-1,-1,4,1
KR_6703328996,420,-2,-12,-9,1,0,2,2,-2,1,3,2,6,4,-1,0,1,2,5,3,0,0,13,-3,4,1,-4,0,1,1,1,1,1,6,1
KR_6725866005,420,0,14,-16,5,-1,0,1,4,10,6,-1,1,2,2,3,1,1,2,1,0,17,8,3,4,7,0,0,0,-1,0,0,1,6,1
KR_6759089055,420,0,25,24,-2,2,7,5,0,2,2,-2,0,2,-2,2,4,0,1,1,0,-3,-13,-3,5,2,5,0,0,0,-1,1,-1,0,1
KR_6531570987,420,1,1,16,8,-3,0,3,2,2,0,1,4,3,5,8,3,3,3,0,2,15,7,7,2,9,-3,0,1,1,-1,1,1,1,1
KR_6753814890,420,-1,-4,24,-6,2,2,0,-2,1,3,1,4,3,-10,1,11,3,3,0,0,-10,-193,-4,6,2,-4,0,0,1,0,1,-1,6,1
KR_6692434620,420,0,47,-12,-6,-2,1,3,3,4,1,2,2,0,-4,0,4,-5,3,8,-1,-7,6,5,2,7,0,0,-1,-1,-1,-1,-1,1,1
KR_6603079712,420,1,46,-8,11,-1,2,3,0,2,2,1,6,5,1,1,0,10,12,2,3,14,-6,0,5,5,3,0,2,1,1,1,1,3,1
KR_6633888525,420,2,31,8,-2,-1,1,2,1,4,3,1,2,1,0,3,3,-3,0,3,0,-6,1,5,3,8,0,0,-1,1,-1,-1,-1,6,1
KR_6751183190,420,3,57,-4,1,2,5,3,-2,1,3,2,4,2,-1,1,2,0,0,0,-2,-6,-1,-2,5,3,1,1,3,-1,1,1,-1,5,1
KR_6760857867,420,3,3,-7,8,5,7,2,5,6,1,-2,3,5,-2,1,3,2,3,1,-1,4,-2,4,3,7,3,0,2,1,1,1,-1,5,1
KR_6665715486,420,3,85,-22,11,2,3,1,-1,1,2,0,2,2,8,8,0,2,3,1,1,7,3,2,3,5,-3,0,1,1,-1,1,1,3,1
KR_6526181235,420,-1,2,16,4,0,1,1,1,5,4,-4,0,4,5,7,2,2,2,0,0,2,0,5,5,10,0,0,1,1,1,1,1,1,1
KR_6626374919,420,0,43,25,8,-1,4,5,2,4,2,-4,1,5,3,3,0,8,9,1,0,6,-24,-2,7,5,1,0,1,1,-1,1,1,4,1
KR_6712152982,420,-1,-2,8,0,2,2,0,-1,1,2,-2,2,4,1,1,0,0,2,2,0,-2,0,0,6,6,-3,0,0,-1,1,0,-1,3,1
KR_6684817686,440,-2,-38,-3,-3,3,3,0,-3,4,7,-3,2,5,0,2,2,0,1,1,0,1,-2,1,2,3,-1,0,-1,0,0,-1,-1,0,1
KR_6757493599,420,-2,-43,-13,-1,1,2,1,1,4,3,0,2,2,-3,3,6,0,0,0,-1,-4,199,0,2,2,-3,0,-2,-1,-1,-1,-1,6,1
KR_6632082928,420,3,-11,60,9,-1,1,2,1,4,3,0,2,2,8,9,1,1,1,0,0,14,0,-1,2,1,1,0,0,1,1,0,1,5,1
KR_6619614172,420,2,31,-8,3,0,2,2,-1,1,2,-2,1,3,3,6,3,3,3,0,1,8,4,-2,7,5,2,0,0,1,-1,1,1,2,1
KR_6752092894,420,1,-28,-44,1,-6,1,7,6,6,0,3,4,1,-1,3,4,-1,0,1,-1,8,9,-1,6,5,-1,0,0,-1,1,-1,-1,2,1
KR_6711571284,420,0,-17,28,-3,-2,2,4,0,3,3,-1,3,4,2,3,1,-2,0,2,2,-7,58,-2,7,5,-6,0,-1,-1,1,-1,1,6,1
KR_6763100058,420,5,98,-7,6,5,5,0,-1,1,2,1,3,2,1,2,1,0,1,1,0,-1,3,-3,10,7,8,0,0,1,-1,1,1,5,1
KR_6729090488,420,3,37,20,12,-2,1,3,10,10,0,6,6,0,2,2,0,-4,0,4,0,11,1,2,2,4,0,0,2,1,1,1,1,4,1
KR_6740577462,420,1,6,-7,-4,2,3,1,-1,4,5,-4,1,5,0,2,2,-1,0,1,0,-4,74,-1,4,3,-1,0,1,-1,1,-1,1,1,1
KR_6764043377,420,3,74,28,2,-3,0,3,-2,3,5,0,2,2,7,8,1,0,0,0,0,4,-23,-3,5,2,6,0,1,1,0,1,-1,4,1
KR_6729621349,420,2,18,22,11,1,3,2,-2,2,4,3,5,2,6,9,3,3,5,2,1,8,-48,3,1,4,17,0,1,-1,1,1,1,6,1
KR_6735822386,420,-3,15,3,0,-4,0,4,0,2,2,5,7,2,2,7,5,-3,0,3,0,-4,-33,-1,5,4,2,0,1,1,1,1,1,5,1
KR_6753525894,420,-2,-66,26,-8,0,2,2,-1,2,3,-2,2,4,-6,1,7,1,1,0,0,-15,-4,-1,8,7,-2,0,-1,-1,1,1,-1,2,1
KR_6733804135,420,0,64,-8,9,1,2,1,0,5,5,2,3,1,2,7,5,4,4,0,2,6,5,0,3,3,12,0,1,1,-1,1,1,3,1
KR_6759392766,420,-2,-80,2,-5,-6,0,6,1,2,1,-2,0,2,2,4,2,0,2,2,0,-3,-1,6,8,14,-5,0,-1,-1,1,-1,1,3,1
KR_6686367896,420,-1,-9,16,-6,-3,1,4,-1,2,3,2,3,1,-3,1,4,-1,3,4,0,-5,-164,0,6,6,3,0,-2,1,-1,-1,-1,3,1
KR_6729348520,440,2,-7,-12,-5,-4,2,6,-2,3,5,-4,1,5,4,6,2,1,2,1,-2,-12,10,1,3,4,-2,0,1,0,-1,1,-1,0,1
KR_6724787669,420,-1,-2,7,-1,-1,1,2,-5,0,5,-2,2,4,8,10,2,-1,0,1,0,4,4,0,5,5,-3,0,0,1,-1,-1,-1,3,1
KR_6722447857,440,4,53,9,4,1,3,2,0,1,1,7,8,1,-3,2,5,-1,0,1,1,13,-3,-6,10,4,5,0,1,1,-1,-1,1,2,1
KR_6705487292,420,1,55,-13,4,0,3,3,3,5,2,1,2,1,2,3,1,-2,0,2,0,8,21,4,5,9,-16,0,0,1,0,0,-1,6,1
KR_6766040549,420,5,116,-2,9,4,5,1,5,6,1,-1,3,4,0,2,2,1,1,0,0,8,3,-1,6,5,3,0,0,1,0,1,1,6,1
KR_6761305892,420,3,44,25,8,0,1,1,2,3,1,3,3,0,3,6,3,0,1,1,0,6,2,1,3,4,1,0,0,1,-1,0,1,1,1
KR_6765203171,420,3,-5,1,3,-1,0,1,2,2,0,-5,1,6,0,3,3,7,7,0,0,9,26,-4,11,7,-1,0,1,-1,1,1,-1,5,1
KR_6764423238,440,6,91,20,13,5,5,0,3,5,2,2,4,2,4,4,0,-1,0,1,0,12,5,1,4,5,4,0,1,1,1,1,1,2,1
KR_6669632335,420,2,35,-7,8,6,7,1,3,6,3,-1,1,2,1,3,2,-1,1,2,0,2,4,0,6,6,3,0,0,-1,-1,0,-1,3,1
KR_6510710113,420,0,6,0,4,1,3,2,1,5,4,4,4,0,-1,2,3,-1,0,1,0,-1,-4,0,7,7,1,0,1,1,-1,-1,-1,6,1
KR_6652315359,420,-1,40,-13,3,-2,0,2,-1,4,5,4,6,2,0,2,2,2,2,0,1,2,0,2,3,5,3,0,0,1,-1,0,-1,2,1
KR_6617609740,420,-2,-14,-23,1,7,8,1,0,8,8,-6,0,6,2,7,5,-2,0,2,-2,1,-1,0,6,6,-1,0,0,1,1,0,-1,2,1
KR_6509949734,420,0,-27,12,-2,0,1,1,1,4,3,-1,1,2,-4,2,6,2,2,0,1,5,-12,2,4,6,1,0,2,1,1,1,1,4,1
KR_6630810861,420,-1,-15,4,-6,2,3,1,-4,0,4,-4,2,6,-1,4,5,1,1,0,0,-5,17,4,2,6,-11,0,-1,-1,1,-1,1,5,1
KR_6760730492,420,4,58,8,6,3,4,1,1,1,0,2,5,3,0,1,1,0,0,0,0,7,-13,2,4,6,1,0,2,1,1,1,1,1,1
KR_6764859003,420,1,55,-4,-1,-4,1,5,-6,2,8,3,5,2,5,6,1,1,1,0,1,-1,2,-2,9,7,3,0,0,1,-1,1,1,3,1
KR_6735768931,420,1,-115,24,-1,0,2,2,5,8,3,-2,2,4,-3,1,4,-1,0,1,-1,-1,6,-2,5,3,-6,0,0,1,1,-1,-1,4,1
KR_6763256264,420,2,64,-19,6,7,8,1,2,5,3,2,4,2,-6,0,6,1,2,1,0,-3,-24,6,2,8,1,0,1,0,-1,1,1,0,1
KR_6761564365,420,1,25,4,3,5,5,0,-2,2,4,0,1,1,-1,3,4,1,1,0,0,3,-4,0,6,6,3,0,1,1,-1,1,1,6,1
KR_6652591353,420,5,16,45,15,-2,1,3,3,4,1,4,6,2,10,10,0,0,0,0,0,19,12,5,2,7,-1,0,3,1,1,1,1,5,1
KR_6732347270,420,2,47,-40,3,2,2,0,-1,2,3,0,1,1,3,3,0,-1,0,1,0,7,-3,0,5,5,0,0,0,-1,-1,0,1,5,1
KR_6665229765,420,2,23,0,2,0,2,2,7,10,3,-2,0,2,-3,1,4,0,2,2,-1,-5,-7,4,5,9,4,0,1,-1,1,1,-1,1,1
KR_6634764022,440,0,81,20,-4,1,2,1,1,1,0,-2,0,2,-3,1,4,-1,1,2,0,-7,4,3,4,7,-2,0,0,1,0,0,-1,3,1
KR_6701057211,420,-1,-30,0,0,0,1,1,0,4,4,4,6,2,-2,2,4,-2,0,2,1,-3,15,-4,5,1,-5,0,1,1,1,1,1,6,1
KR_6757436778,420,1,49,-20,0,1,2,1,-2,0,2,-2,0,2,3,3,0,0,1,1,0,-1,16,-2,6,4,-2,0,0,-1,1,0,1,6,1
KR_6726618314,420,-2,-15,-28,-10,2,3,1,2,6,4,-5,1,6,-7,1,8,-2,0,2,0,-8,-4,-6,8,2,3,0,0,-1,1,0,-1,3,1
KR_6509661752,420,1,-1,-21,-1,0,2,2,0,1,1,-1,2,3,0,3,3,0,1,1,0,3,3,0,4,4,0,0,0,-1,-1,0,-1,2,1
KR_6744356544,420,0,34,32,-7,-6,0,6,2,6,4,1,5,4,-4,2,6,0,0,0,0,-9,3,-7,8,1,2,0,-1,1,1,-1,-1,3,1
KR_6765677631,440,3,33,41,7,5,5,0,4,6,2,-1,0,1,-1,3,4,0,1,1,0,4,-7,0,3,3,2,0,1,1,1,1,1,3,1
KR_6764765357,420,5,19,-8,9,-4,1,5,0,1,1,3,3,0,5,9,4,5,5,0,0,10,11,0,3,3,-2,0,0,1,1,1,-1,1,1
KR_6749411248,420,4,49,-7,3,-6,0,6,1,2,1,2,3,1,6,10,4,0,1,1,0,10,3,0,8,8,1,0,2,1,-1,-1,-1,6,1
KR_6739683993,420,-3,-76,-43,4,1,2,1,-1,2,3,0,2,2,2,2,0,2,2,0,0,6,-38,2,2,4,6,0,-1,-1,1,-1,1,5,1
KR_6742241154,440,-4,3,-23,-10,4,4,0,-1,0,1,-4,0,4,-8,1,9,-1,1,2,0,-11,0,-1,6,5,-9,0,1,-1,1,1,-1,2,1
KR_6756340253,420,0,-12,22,-2,0,2,2,1,4,3,7,7,0,-6,0,6,-4,0,4,-1,-4,8,-3,4,1,-2,0,1,1,1,1,-1,5,1
KR_6756112735,420,5,18,28,12,1,2,1,0,4,4,7,7,0,4,4,0,0,0,0,0,8,-3,1,4,5,-4,0,1,1,1,1,1,2,1
KR_6741454955,420,4,-10,19,8,-1,1,2,2,3,1,2,3,1,0,1,1,5,6,1,0,8,1,1,4,5,2,0,1,0,-1,1,-1,0,1
KR_6760252922,420,-3,-28,-12,-4,0,1,1,4,6,2,0,1,1,-6,1,7,-2,0,2,0,0,-395,1,4,5,-2,0,0,-1,-1,-1,-1,4,1
KR_6762787474,420,-1,24,24,-2,-4,0,4,-1,1,2,-3,1,4,6,7,1,0,1,1,2,-1,-43,1,4,5,1,0,1,1,1,1,1,4,1
KR_6762070711,420,3,-60,16,7,0,3,3,-3,0,3,4,6,2,4,6,2,2,4,2,0,3,2,2,5,7,2,0,1,0,1,1,1,0,1
KR_6712471497,420,2,15,15,2,-2,1,3,1,2,1,0,4,4,2,2,0,1,2,1,0,-2,2,-1,6,5,1,0,0,1,-1,0,1,1,1
KR_6679602450,420,2,45,-20,7,1,1,0,8,8,0,-3,0,3,0,4,4,1,1,0,0,9,13,3,4,7,-2,0,0,1,0,0,1,5,1
KR_6736892475,420,3,45,-12,14,1,3,2,3,3,0,3,9,6,5,7,2,2,3,1,0,12,10,7,5,12,-1,0,1,1,0,1,1,1,1
KR_6760459571,420,0,6,0,2,-3,3,6,6,7,1,-2,2,4,2,4,2,-1,0,1,1,8,-1,0,7,7,5,0,1,1,1,1,1,2,1
KR_6763942267,420,5,61,17,13,1,4,3,6,7,1,2,3,1,4,5,1,0,0,0,0,6,35,-3,7,4,-2,0,0,1,1,1,-1,5,1
KR_6718325631,420,0,22,12,1,-3,2,5,6,7,1,-1,1,2,0,1,1,-1,0,1,-1,0,-4,-4,8,4,0,0,0,-1,1,-1,-1,6,1
KR_6764737320,420,2,28,25,1,3,3,0,-1,3,4,0,1,1,-1,4,5,0,1,1,0,2,71,6,2,8,-2,0,2,1,1,1,1,2,1
KR_6735468107,440,5,51,48,20,4,10,6,4,4,0,6,7,1,4,7,3,2,4,2,1,18,9,4,0,4,-1,0,2,1,1,1,-1,3,1
KR_6763812125,420,-4,-43,2,-6,1,1,0,1,4,3,-4,0,4,-1,3,4,-3,2,5,2,2,-45,-2,3,1,39,0,0,0,-1,0,1,0,1
KR_6749813922,420,-1,6,18,1,0,3,3,-4,0,4,3,4,1,3,3,0,-1,1,2,0,2,-31,4,1,5,3,0,-1,1,-1,-1,1,3,1
KR_6716716150,420,4,45,7,14,1,2,1,2,2,0,5,7,2,3,4,1,3,3,0,1,24,22,3,4,7,3,0,1,1,1,1,1,2,1
KR_6667770483,420,1,34,-3,-2,2,3,1,3,6,3,2,4,2,-5,2,7,-4,0,4,0,-7,-5,-3,5,2,-1,0,-1,0,-1,-1,-1,0,1
KR_6748648610,420,-1,-2,6,-7,-3,0,3,-2,2,4,-2,1,3,1,1,0,-1,0,1,0,-6,-8,-1,7,6,5,0,0,0,0,0,-1,0,1
KR_6600983742,420,-2,5,-9,-4,1,1,0,-2,3,5,-2,3,5,0,2,2,-1,0,1,0,-14,-1,1,5,6,2,0,0,-1,-1,0,1,3,1
KR_6751556001,420,5,159,-8,10,0,3,3,-2,3,5,2,5,3,9,10,1,1,1,0,0,16,-3,-3,6,3,6,0,2,1,1,1,1,1,1
KR_6722155810,440,5,3,-7,8,1,2,1,5,5,0,-1,2,3,5,6,1,-2,3,5,-1,7,1,-3,6,3,3,0,1,1,1,1,-1,4,1
KR_6629458468,420,0,7,21,-1,2,3,1,-3,1,4,3,5,2,-2,5,7,-1,0,1,-1,-1,-35,2,2,4,1,0,1,1,1,1,-1,3,1
KR_6690697997,420,-2,-36,-12,7,-2,1,3,2,4,2,1,3,2,4,6,2,2,2,0,1,11,-14,2,3,5,2,0,-1,1,-1,1,1,3,1
KR_6765424523,420,2,35,28,6,-1,1,2,5,5,0,2,3,1,-2,0,2,2,3,1,0,9,26,0,7,7,-9,0,2,-1,1,1,-1,5,1
KR_6644682669,420,0,13,-4,2,-1,1,2,-2,1,3,1,4,3,4,5,1,0,1,1,0,5,8,0,6,6,0,0,0,0,1,0,1,0,1
KR_6731264464,420,3,-29,8,3,1,1,0,1,2,1,0,1,1,0,1,1,1,1,0,0,6,6,-2,9,7,1,0,0,1,-1,0,-1,1,1
KR_6763194471,440,-3,-20,-39,-8,-5,1,6,2,5,3,1,3,2,0,2,2,-6,0,6,0,-3,-56,-8,10,2,13,0,-1,-1,1,1,1,2,1
KR_6761691214,440,1,1,24,0,0,1,1,0,4,4,0,5,5,2,5,3,-2,2,4,0,-2,4,2,3,5,0,0,-1,-1,0,1,1,4,1
KR_6763827997,420,1,41,-18,5,-2,0,2,4,5,1,2,6,4,0,2,2,1,3,2,0,4,12,3,3,6,-10,0,2,1,1,1,1,3,1
KR_6729337875,420,5,-21,32,9,2,4,2,7,7,0,0,1,1,1,1,0,-1,0,1,0,5,13,-1,4,3,1,0,2,1,1,1,1,4,1
KR_6743916313,420,1,-27,2,17,2,5,3,1,2,1,8,8,0,3,5,2,3,3,0,0,24,-37,3,4,7,25,0,0,1,1,-1,1,2,1
KR_6697709591,440,2,87,6,0,-1,2,3,-2,3,5,0,2,2,4,4,0,-1,0,1,0,2,-3,-1,4,3,3,0,0,1,-1,0,-1,1,1
KR_6596730599,420,0,-54,-1,6,-3,1,4,3,8,5,0,3,3,3,4,1,3,6,3,1,9,-5,-2,5,3,2,0,1,1,1,1,1,4,1
KR_6658603329,440,1,-9,-2,5,3,4,1,-4,1,5,4,5,1,1,9,8,1,2,1,3,8,26,1,6,7,-2,0,-1,-1,1,1,1,5,1
KR_6706422174,420,0,-7,-23,-2,-1,1,2,-3,3,6,-1,2,3,4,6,2,-1,0,1,-1,6,16,-6,10,4,-29,0,0,-1,1,0,-1,6,1
KR_6764819851,420,2,29,15,5,2,2,0,0,3,3,-1,0,1,2,4,2,2,2,0,0,5,0,2,6,8,5,0,0,1,1,0,1,1,1
KR_6698508163,440,3,-24,-4,4,0,2,2,1,3,2,2,3,1,1,1,0,0,2,2,0,5,-1,-1,5,4,-2,0,2,-1,1,1,-1,4,1
KR_6636413828,420,2,25,4,3,-1,1,2,-1,2,3,0,3,3,5,7,2,0,1,1,1,4,7,1,6,7,-1,0,-1,1,-1,-1,1,4,1
KR_6666531465,420,0,23,36,3,1,3,2,-1,3,4,-1,2,3,2,3,1,2,3,1,2,0,-11,-2,9,7,-1,0,0,-1,1,0,1,4,1
KR_6759168507,420,-2,35,-20,-1,-1,1,2,0,4,4,2,2,0,-3,0,3,1,1,0,0,-2,9,4,3,7,-5,0,0,1,0,1,1,1,1
KR_6730011920,420,9,99,44,15,3,3,0,0,5,5,3,4,1,9,10,1,0,0,0,1,18,14,2,4,6,2,0,1,1,1,1,1,4,1
KR_6762947123,420,4,28,44,3,2,3,1,-3,1,4,2,3,1,-3,3,6,5,5,0,2,7,21,1,4,5,-3,0,1,1,1,1,1,3,1
KR_6751534030,420,0,-4,0,-2,-3,0,3,-2,3,5,2,2,0,1,1,0,0,0,0,0,0,-9,-1,7,6,5,0,0,1,-1,0,1,2,1
KR_6755394855,420,0,38,14,5,1,1,0,3,5,2,4,7,3,-1,4,5,-2,2,4,0,5,0,-1,5,4,1,0,1,1,-1,-1,1,6,1
KR_6755111654,440,-2,55,-19,-6,0,0,0,1,2,1,3,5,2,-8,1,9,-2,2,4,0,-4,6,1,1,2,-3,0,0,1,-1,0,-1,1,1
KR_6762295119,420,-2,6,-31,-5,-1,1,2,-4,0,4,0,1,1,1,3,2,-1,0,1,0,-2,-125,1,8,9,-4,0,0,1,-1,0,-1,5,1
KR_6646569064,420,-1,7,-19,-3,0,3,3,2,2,0,-1,0,1,-3,0,3,-1,1,2,0,-4,-6,1,6,7,-1,0,-1,1,-1,-1,-1,5,1
KR_6743965186,420,3,-11,22,6,-2,0,2,1,2,1,6,9,3,1,4,3,0,1,1,-1,6,-25,-2,4,2,5,0,0,1,1,1,-1,6,1
KR_6765427451,420,0,40,-36,4,1,2,1,1,3,2,0,2,2,2,4,2,0,2,2,0,5,4,1,6,7,0,0,0,-1,-1,0,1,3,1
KR_6738773280,420,4,91,17,4,3,3,0,1,1,0,2,2,0,-2,4,6,0,2,2,0,6,5,7,4,11,2,0,3,1,1,1,1,2,1
KR_6708785536,420,-1,9,-8,-8,-2,0,2,-6,1,7,-1,2,3,0,1,1,1,2,1,0,-9,17,-2,6,4,-4,0,1,1,1,1,-1,2,1
KR_6742398207,420,-3,68,-1,-6,5,5,0,2,3,1,-6,3,9,-6,1,7,-1,1,2,1,-9,-1,1,7,8,4,0,0,-1,-1,1,1,4,1
KR_6619255724,420,2,19,20,10,-2,0,2,5,5,0,3,3,0,4,5,1,0,2,2,2,12,8,6,4,10,7,0,4,1,1,1,1,2,1
KR_6760234682,420,8,124,8,13,3,5,2,1,2,1,4,6,2,4,4,0,1,2,1,0,13,122,0,6,6,5,0,5,1,1,1,1,2,1
KR_6755231970,420,5,79,0,5,3,3,0,-1,3,4,2,3,1,1,2,1,0,1,1,0,2,-4,-3,7,4,6,0,0,0,-1,0,-1,0,1
KR_6755601160,420,1,42,16,1,3,4,1,0,1,1,-6,2,8,4,5,1,0,0,0,0,1,5,2,3,5,-2,0,1,1,1,1,1,1,1
KR_6736634711,420,1,-4,-5,3,3,3,0,-2,4,6,1,2,1,0,2,2,1,6,5,0,-6,3,-1,6,5,-6,0,1,-1,1,1,1,2,1
KR_6752691172,420,1,15,-9,3,-4,2,6,8,9,1,-1,1,2,0,3,3,0,0,0,0,8,-2,-3,4,1,1,0,0,0,-1,0,1,0,1
KR_6728342341,440,5,122,21,12,2,3,1,2,4,2,4,5,1,3,3,0,1,1,0,1,19,-109,4,1,5,1,0,0,1,1,0,1,6,1
KR_6750483539,420,0,-9,-4,1,-1,0,1,2,5,3,-1,2,3,1,4,3,0,2,2,0,5,43,2,3,5,-4,0,0,1,-1,1,1,4,1
KR_6654371992,420,2,59,3,6,1,3,2,3,3,0,1,2,1,1,3,2,0,0,0,0,8,-29,-6,10,4,4,0,1,1,-1,1,1,6,1
KR_6726617917,420,-2,-41,-9,-4,6,7,1,0,2,2,0,3,3,-9,3,12,-1,1,2,-1,-4,-25,1,3,4,0,0,-1,1,-1,-1,1,4,1
KR_6760988155,420,-3,-50,-16,-3,6,6,0,-2,1,3,-2,2,4,-3,0,3,-2,0,2,0,-5,-64,1,4,5,19,0,0,-1,1,0,1,1,1
KR_6726597251,420,3,58,32,7,6,6,0,1,4,3,2,2,0,-1,2,3,-1,0,1,0,-4,-21,4,3,7,3,1,4,1,1,1,1,6,1
KR_6763454950,420,3,63,15,3,-3,0,3,2,3,1,-3,1,4,3,4,1,4,6,2,0,3,10,0,6,6,10,0,1,1,-1,1,-1,6,1
KR_6749240549,420,0,11,0,4,0,1,1,1,3,2,2,5,3,-3,2,5,4,4,0,0,11,-7,-4,5,1,8,0,1,1,1,1,-1,2,1
KR_6629626662,420,1,11,2,4,2,3,1,-5,0,5,4,5,1,1,2,1,2,2,0,0,2,2,0,7,7,3,0,1,1,1,1,1,1,1
KR_6762146703,420,-3,-45,4,-9,-1,3,4,-3,1,4,-1,3,4,-5,0,5,1,1,0,0,-8,3,3,6,9,2,0,-1,-1,-1,-1,-1,4,1
KR_6732661114,420,2,84,16,3,1,1,0,2,4,2,-1,0,1,0,2,2,1,2,1,2,4,57,0,6,6,-5,0,0,1,1,1,1,3,1
KR_6724799979,420,-2,-24,-11,3,3,3,0,1,2,1,-1,2,3,0,4,4,0,0,0,-1,1,12,5,2,7,-2,0,0,1,1,0,-1,5,1
KR_6766128134,420,1,3,22,4,-2,1,3,6,6,0,1,2,1,-3,0,3,2,2,0,0,2,35,-6,7,1,-17,0,0,1,1,1,1,2,1
KR_6756915401,420,0,-58,0,-1,1,1,0,2,3,1,4,5,1,-7,0,7,-1,0,1,-2,-5,9,3,3,6,0,0,-1,1,-1,-1,-1,2,1
KR_6762962060,420,3,3,-11,9,0,3,3,-1,3,4,4,4,0,7,9,2,-1,3,4,1,5,0,2,4,6,1,0,1,1,1,1,1,3,1
KR_6761434019,420,2,-22,24,2,4,4,0,0,1,1,-6,2,8,-2,2,4,6,7,1,1,8,238,1,5,6,0,0,1,1,1,-1,1,5,1
KR_6752962223,420,-2,-8,-14,-2,-1,1,2,-4,1,5,3,4,1,0,1,1,0,1,1,0,7,-259,-4,7,3,-19,0,0,0,-1,0,1,0,1
KR_6706618227,420,2,31,13,5,2,4,2,-1,3,4,0,3,3,-1,4,5,5,5,0,0,9,-1,-4,8,4,6,0,0,-1,1,1,-1,1,1
KR_6632798479,420,-2,-28,-8,-9,-8,3,11,-1,1,2,-2,0,2,2,2,0,0,0,0,0,0,-23,1,2,3,0,0,1,1,1,-1,1,2,1
KR_6763960966,420,2,18,-16,7,2,2,0,1,4,3,0,2,2,7,9,2,-3,0,3,0,10,0,0,6,6,0,0,1,1,-1,1,1,6,1
KR_6757907493,420,4,50,16,11,3,4,1,-1,3,4,5,6,1,5,7,2,-1,0,1,0,8,8,4,6,10,-1,0,2,0,1,1,1,0,1
KR_6750415943,420,3,13,20,6,0,2,2,6,6,0,-1,1,2,1,3,2,0,0,0,-1,0,-3,2,3,5,-2,0,1,1,1,1,-1,6,1
KR_6743165206,420,1,6,24,2,0,1,1,2,3,1,-1,2,3,2,4,2,-1,0,1,0,6,5,-1,4,3,4,0,0,-1,1,1,1,6,1
KR_6761353213,420,2,48,-40,6,2,4,2,-3,1,4,0,3,3,2,4,2,5,6,1,0,6,-1,-4,8,4,0,0,1,1,-1,1,1,2,1
KR_6764901219,440,0,4,-21,2,0,4,4,-2,2,4,3,3,0,-1,3,4,2,3,1,0,-9,1,-1,3,2,2,0,0,1,-1,1,1,6,1
KR_6751347806,420,4,-3,51,5,1,3,2,0,2,2,2,4,2,2,5,3,0,1,1,0,3,-6,-1,7,6,-2,0,0,1,-1,0,-1,5,1
KR_6670119643,420,0,24,16,6,1,2,1,7,9,2,0,3,3,-2,2,4,0,1,1,0,4,0,0,5,5,0,0,1,1,1,1,-1,2,1
KR_6750327799,420,1,34,24,-2,2,3,1,-2,6,8,1,3,2,-2,5,7,-1,1,2,1,-4,1,0,4,4,-1,0,0,-1,1,1,1,6,1
KR_6765283095,420,4,-1,16,4,2,3,1,3,3,0,1,1,0,-3,1,4,1,4,3,0,0,0,0,7,7,2,0,0,1,0,0,-1,2,1
KR_6760196125,420,4,49,13,13,3,4,1,6,6,0,3,4,1,1,5,4,0,1,1,2,19,5,5,2,7,-4,0,1,1,1,1,1,5,1
KR_6741565864,420,2,69,-5,6,4,4,0,-1,2,3,-4,1,5,2,4,2,5,6,1,0,3,-21,3,4,7,4,0,2,-1,1,1,1,1,1
KR_6665808300,420,0,46,0,5,3,6,3,-2,1,3,4,4,0,1,3,2,-1,0,1,-1,-4,1,6,3,9,10,0,0,1,1,1,-1,2,1
KR_6734440924,420,-1,-42,-8,3,1,3,2,2,3,1,1,2,1,1,2,1,-2,0,2,0,3,-47,-3,6,3,16,0,0,-1,1,1,1,6,1
KR_6742307906,420,2,34,28,-8,2,4,2,0,3,3,-9,0,9,-2,4,6,1,1,0,-2,-14,-23,1,4,5,-4,0,2,1,-1,1,-1,1,1
KR_6765493560,420,5,97,9,9,2,2,0,0,3,3,1,5,4,4,5,1,2,2,0,0,4,12,2,2,4,1,0,3,1,1,1,1,5,1
KR_6758846047,420,5,36,23,3,1,4,3,1,3,2,3,3,0,-2,2,4,0,0,0,0,0,76,1,6,7,0,0,1,1,1,1,1,1,1
KR_6763948364,420,2,-21,0,-2,2,2,0,1,3,2,-5,2,7,-1,6,7,1,1,0,-2,2,-15,0,4,4,6,0,0,-1,1,0,-1,3,1
KR_6748763653,440,5,46,12,12,2,2,0,1,1,0,2,5,3,7,9,2,0,2,2,1,6,12,5,0,5,-1,0,2,1,-1,1,1,2,1
KR_6754524099,440,-5,-73,-40,-4,-1,1,2,-4,0,4,3,4,1,-5,1,6,3,3,0,1,-1,324,-3,4,1,-3,0,-1,1,-1,-1,1,1,1
KR_6649438530,420,2,66,-16,10,2,2,0,4,5,1,2,3,1,3,3,0,-1,0,1,0,6,-34,5,5,10,1,0,2,-1,-1,1,1,1,1
KR_6731486478,420,3,42,0,6,0,2,2,0,4,4,-1,2,3,6,6,0,1,3,2,1,4,4,-2,7,5,0,0,2,1,-1,1,1,6,1
KR_6762903747,440,4,91,56,9,9,9,0,3,4,1,2,4,2,-5,0,5,0,3,3,1,-4,1,-2,7,5,1,0,1,0,0,1,1,0,1
KR_6686461484,440,0,13,-15,-1,-1,1,2,1,3,2,0,5,5,-1,3,4,0,1,1,0,1,11,0,4,4,4,0,1,0,1,1,-1,0,1
KR_6686325774,420,-3,-50,-16,-6,0,2,2,-2,4,6,-4,0,4,1,2,1,-1,0,1,0,-11,-40,1,4,5,4,0,-2,1,-1,-1,-1,3,1
KR_6756178545,420,4,42,32,14,0,1,1,7,10,3,2,4,2,4,5,1,1,1,0,1,7,13,0,4,4,0,0,2,1,-1,1,1,2,1
KR_6490517942,420,0,50,-1,3,-2,1,3,0,3,3,1,3,2,4,4,0,0,1,1,0,8,-10,6,2,8,-4,0,0,1,-1,0,-1,6,1
KR_6738291503,440,0,88,11,-1,2,3,1,0,1,1,-1,3,4,-1,0,1,-1,1,2,0,-2,-27,-2,3,1,2,0,2,1,-1,1,-1,3,1
KR_6763483908,420,-1,85,-3,-1,3,3,0,-5,0,5,4,5,1,-2,1,3,-1,0,1,0,-6,-11,0,5,5,2,0,0,-1,1,-1,1,6,1
KR_6750400324,420,7,131,24,18,1,5,4,-3,2,5,6,6,0,11,11,0,3,3,0,1,11,10,1,2,3,2,1,3,0,-1,1,1,0,1
KR_6766544971,420,0,39,44,1,6,6,0,-5,0,5,1,1,0,-1,0,1,0,0,0,-1,3,-6,5,4,9,-1,0,1,-1,-1,1,-1,2,1
KR_6691363165,420,5,68,11,13,7,9,2,7,8,1,1,1,0,-1,2,3,-1,0,1,0,6,45,2,2,4,-1,0,2,1,1,1,1,3,1
KR_6763000274,420,1,25,-55,3,2,4,2,-1,4,5,1,2,1,1,2,1,0,1,1,1,-2,-93,-1,5,4,1,0,0,1,-1,0,1,3,1
KR_6679000846,420,3,65,40,5,2,2,0,0,3,3,1,3,2,0,3,3,2,2,0,0,2,12,1,6,7,-1,0,0,-1,1,1,1,1,1
KR_6763011399,420,3,-31,16,0,-1,1,2,1,3,2,0,5,5,-1,6,7,1,3,2,1,-2,50,6,0,6,-2,0,0,0,1,1,1,0,1
KR_6764213087,420,5,123,16,7,0,2,2,1,2,1,-1,0,1,7,8,1,0,2,2,0,12,13,4,3,7,-2,0,1,1,-1,1,-1,6,1
KR_6753106130,420,-3,-11,-28,-4,-8,0,8,1,1,0,1,2,1,2,7,5,0,4,4,0,-4,40,-2,7,5,-5,0,-1,-1,-1,-1,-1,4,1
KR_6760032772,420,-1,10,-5,2,-2,2,4,0,0,0,5,5,0,0,4,4,-1,0,1,0,6,-7,-1,7,6,3,0,-1,1,-1,-1,1,6,1
KR_6741020183,420,0,18,-6,-2,1,5,4,3,5,2,-3,1,4,-3,3,6,0,0,0,-1,-15,1,0,4,4,0,0,-1,1,1,-1,-1,5,1
KR_6750181137,440,2,8,4,10,3,4,1,1,5,4,1,5,4,-1,4,5,6,6,0,2,12,4,1,4,5,-5,0,2,1,0,-1,1,4,1
KR_6750960995,420,4,38,-8,3,1,2,1,2,2,0,1,2,1,-1,2,3,0,0,0,0,-1,-107,-3,5,2,4,0,-2,1,1,-1,-1,1,1
KR_6670314190,420,1,34,32,1,2,2,0,2,2,0,1,3,2,-3,1,4,-1,0,1,0,-7,-47,3,2,5,-1,0,0,1,1,1,1,3,1
KR_6726437963,420,2,36,32,8,-1,4,5,4,4,0,-2,0,2,6,6,0,1,1,0,1,12,21,2,4,6,-11,0,0,1,-1,1,1,4,1
KR_6757107169,420,-2,-69,9,2,0,2,2,4,5,1,-1,2,3,-2,0,2,1,1,0,1,5,8,4,4,8,-7,0,0,1,1,0,1,1,1
KR_6765116995,420,-1,59,0,-4,-1,3,4,-2,5,7,2,6,4,-2,1,3,-1,0,1,0,0,31,-2,5,3,-20,0,1,-1,0,1,1,4,1
KR_6729912361,420,1,16,-4,3,3,3,0,5,6,1,-5,2,7,-3,3,6,3,3,0,0,8,29,0,4,4,3,0,0,1,1,-1,1,2,1
KR_6717270980,420,3,-57,-19,1,0,2,2,2,3,1,4,5,1,-2,3,5,-3,0,3,-2,7,2,-2,6,4,4,0,0,1,-1,0,-1,5,1
KR_6631549941,420,2,-89,-11,3,1,1,0,-1,2,3,1,2,1,5,5,0,-3,2,5,0,6,114,0,7,7,0,0,-2,1,-1,-1,1,1,1
KR_6646441187,420,1,3,27,5,-3,1,4,0,5,5,1,1,0,5,5,0,2,2,0,0,6,7,-1,7,6,3,0,1,1,1,1,1,5,1
KR_6611973456,420,1,35,-25,4,2,2,0,1,5,4,0,2,2,0,1,1,1,1,0,0,4,0,4,7,11,-1,0,-1,-1,-1,-1,1,1,1
KR_6747156070,420,1,-3,12,1,3,3,0,-2,1,3,-2,2,4,0,3,3,2,4,2,0,0,0,2,5,7,3,0,0,1,-1,0,-1,2,1
KR_6739119212,420,4,77,34,7,3,3,0,5,5,0,-1,2,3,1,2,1,-1,0,1,0,1,25,4,4,8,7,0,1,1,-1,1,1,1,1
KR_6746406662,420,3,37,16,6,0,1,1,4,7,3,-2,1,3,5,6,1,-1,0,1,0,8,2,2,4,6,-1,0,0,1,-1,0,1,4,1
KR_6750485834,440,-2,23,19,3,0,1,1,4,5,1,2,2,0,-3,1,4,0,1,1,0,8,10,0,7,7,-1,0,0,1,1,1,1,1,1
KR_6683184731,420,0,-1,8,-2,-1,2,3,3,4,1,2,3,1,-3,3,6,-3,0,3,-1,5,-45,2,4,6,2,0,0,0,1,0,-1,0,1
KR_6695964582,420,1,6,-12,3,-3,1,4,1,2,1,3,4,1,2,5,3,0,0,0,-1,6,1,-1,6,5,1,0,-1,1,-1,-1,-1,1,1
KR_6735240759,420,1,10,-24,1,-4,0,4,1,2,1,3,3,0,-1,0,1,2,2,0,0,9,-10,4,8,12,2,0,1,-1,1,1,-1,6,1
KR_6754463790,420,2,42,21,6,0,1,1,2,2,0,4,5,1,1,3,2,-1,2,3,0,1,-5,-5,7,2,7,0,1,1,1,1,-1,4,1
KR_6718524449,420,1,13,-54,5,0,2,2,0,3,3,1,2,1,2,6,4,2,3,1,0,5,-46,2,4,6,17,0,0,-1,1,0,-1,6,1
KR_6726362081,420,-1,-40,-1,1,-4,1,5,-1,3,4,4,6,2,1,5,4,1,2,1,0,3,-11,-3,6,3,1,0,1,1,-1,1,-1,1,1
KR_6744154588,440,-1,-49,7,2,-5,0,5,-1,1,2,3,4,1,1,3,2,4,4,0,0,4,151,0,4,4,7,0,-2,1,-1,-1,-1,4,1
KR_6654010548,420,3,61,-6,3,4,4,0,-5,1,6,7,7,0,-3,0,3,0,0,0,0,7,0,3,7,10,-2,0,1,-1,-1,1,1,4,1
KR_6717232199,420,3,-2,32,7,-1,1,2,5,7,2,2,4,2,0,1,1,1,1,0,0,15,10,3,3,6,3,0,1,1,1,1,-1,3,1
KR_6755581016,420,3,-42,4,7,1,2,1,-3,1,4,1,2,1,3,3,0,5,5,0,0,10,-12,-2,7,5,6,0,0,-1,1,0,-1,1,1
KR_6766166977,420,1,-1,36,8,4,5,1,-2,3,5,3,3,0,3,3,0,0,0,0,0,11,-182,2,3,5,0,0,1,1,1,1,-1,3,1
KR_6697791080,440,2,53,2,6,1,1,0,0,4,4,-2,3,5,7,7,0,0,2,2,0,9,-3,-3,5,2,7,0,1,-1,-1,1,-1,6,1
KR_6734533190,420,2,27,-16,6,3,3,0,6,7,1,2,3,1,-3,3,6,-2,0,2,1,10,2,2,5,7,2,0,0,1,1,0,1,2,1
KR_6651246670,420,2,32,18,3,-3,1,4,-3,3,6,6,6,0,3,4,1,0,2,2,0,4,5,-3,5,2,1,0,0,1,0,-1,1,5,1
KR_6756980181,440,1,-7,15,-2,1,4,3,-2,0,2,0,2,2,0,1,1,-1,0,1,0,-8,8,-4,7,3,2,0,-1,-1,1,1,-1,3,1
KR_6759952656,440,1,-8,28,9,3,5,2,6,7,1,1,3,2,0,0,0,-1,2,3,2,13,-3,4,3,7,-3,0,0,0,0,0,1,0,1
KR_6726047314,420,4,-7,13,5,0,2,2,3,4,1,-2,0,2,4,6,2,0,1,1,0,5,-54,0,5,5,25,0,2,1,-1,1,1,4,1
KR_6698317078,420,0,-10,23,2,1,3,2,0,0,0,0,2,2,0,4,4,1,1,0,0,7,3,-3,5,2,0,0,0,1,1,1,1,5,1
KR_6686418787,440,3,61,12,2,2,5,3,2,3,1,3,4,1,-2,4,6,-3,1,4,0,1,8,0,4,4,0,0,1,-1,1,1,-1,1,1
KR_6748312299,420,1,-17,24,8,3,5,2,0,1,1,5,6,1,0,3,3,0,1,1,0,11,9,2,4,6,2,0,1,1,-1,-1,-1,4,1
KR_6744766659,420,3,-29,2,4,-4,1,5,4,6,2,5,8,3,0,3,3,-1,0,1,0,4,-8,-2,4,2,2,0,0,-1,-1,-1,-1,4,1
KR_6700954083,420,0,-64,12,0,-2,1,3,0,3,3,2,6,4,0,4,4,0,0,0,-1,0,-9,0,3,3,1,0,0,-1,1,0,-1,3,1
KR_6763480583,440,-3,-78,36,1,-4,1,5,3,5,2,0,1,1,2,3,1,0,1,1,0,7,-7,4,3,7,-5,0,-1,-1,-1,-1,-1,2,1
KR_6716558738,420,3,25,32,4,8,9,1,-4,3,7,3,5,2,0,2,2,-3,0,3,-1,-3,243,-2,7,5,4,0,3,0,1,1,1,0,1
KR_6740582340,440,4,39,24,9,2,2,0,-2,3,5,5,5,0,3,4,1,1,2,1,0,3,-101,3,4,7,8,0,1,1,1,1,1,4,1
KR_6756843327,420,2,68,-32,1,2,2,0,-1,2,3,-1,1,2,0,2,2,1,1,0,0,-3,2,4,4,8,0,0,0,-1,1,0,1,6,1
KR_6756506676,420,5,19,14,8,2,2,0,0,3,3,0,0,0,7,7,0,-1,0,1,0,8,-9,2,4,6,-1,0,0,1,-1,0,1,4,1
KR_6762772694,420,0,14,16,3,2,5,3,1,2,1,0,2,2,-1,1,2,1,1,0,0,3,-6,1,4,5,3,0,0,-1,1,1,1,2,1
KR_6740600564,440,3,29,13,4,1,2,1,1,4,3,-1,5,6,5,6,1,-2,2,4,0,6,7,-2,7,5,-1,0,-1,0,0,-1,-1,0,1
KR_6720621759,440,6,21,20,17,6,7,1,4,6,2,-1,1,2,1,7,6,7,8,1,-2,7,53,-4,4,0,6,0,5,1,1,1,-1,4,1
KR_6757748448,420,-2,-41,9,0,2,4,2,0,3,3,-1,5,6,1,3,2,-2,0,2,0,-2,13,-3,6,3,0,0,-1,1,1,1,-1,5,1
KR_6760332970,420,1,-14,4,2,5,6,1,2,4,2,-2,0,2,0,2,2,-3,1,4,0,-3,-3,-5,6,1,3,0,1,1,-1,1,-1,6,1
KR_6762450569,420,2,7,-24,4,3,3,0,0,2,2,3,6,3,-2,0,2,0,0,0,0,-5,-10,4,3,7,-2,0,1,1,1,1,1,4,1
KR_6728565903,420,2,-12,18,6,4,5,1,2,4,2,4,5,1,-1,2,3,-3,0,3,2,4,65,-2,6,4,0,0,1,1,1,1,1,6,1
KR_6635676589,420,2,43,-9,8,1,1,0,0,2,2,2,3,1,4,4,0,1,2,1,0,13,105,-2,7,5,6,0,1,1,1,1,1,6,1
KR_6734934852,420,-1,16,-4,2,2,3,1,0,2,2,-1,1,2,0,4,4,1,1,0,0,4,-27,0,4,4,2,0,0,1,1,1,-1,5,1
KR_6762419911,420,3,64,5,4,0,2,2,0,4,4,2,3,1,0,2,2,2,2,0,0,3,117,-2,8,6,0,0,0,-1,-1,0,-1,6,1
KR_6748634391,440,1,-43,5,-1,-3,2,5,3,5,2,-6,0,6,6,7,1,-1,1,2,0,10,9,-6,10,4,1,0,1,0,1,1,1,0,1
KR_6758165911,420,-1,-34,-16,7,-1,1,2,5,7,2,2,5,3,1,4,3,0,0,0,0,17,-8,4,4,8,4,0,-1,1,0,-1,1,6,1
KR_6756408246,420,0,16,30,0,5,5,0,0,0,0,-4,2,6,-2,1,3,1,1,0,0,2,-21,-2,4,2,6,0,-1,-1,1,-1,-1,1,1
KR_6716646489,420,3,-2,-1,11,-4,1,5,6,8,2,0,1,1,6,7,1,3,3,0,1,15,11,0,5,5,3,0,-1,1,1,-1,1,2,1
KR_6632118729,420,6,145,-1,17,-1,1,2,1,1,0,7,7,0,5,6,1,5,6,1,3,23,10,5,2,7,1,0,3,-1,1,1,1,3,1
KR_6760383744,420,-1,73,-12,-3,3,3,0,4,4,0,-5,1,6,-1,1,2,-4,2,6,0,-3,12,4,1,5,-2,0,1,-1,-1,1,1,5,1
KR_6764702524,420,4,46,28,7,4,6,2,3,6,3,1,1,0,-2,0,2,1,1,0,0,3,11,-1,10,9,4,0,0,1,-1,1,1,1,1
KR_6755527940,420,1,37,4,3,0,1,1,0,2,2,4,4,0,1,2,1,-2,0,2,0,0,-1,-3,5,2,4,0,1,-1,1,1,1,5,1
KR_6761164744,420,4,40,-1,8,1,1,0,7,8,1,0,1,1,0,4,4,0,0,0,0,7,4,1,5,6,-2,0,0,-1,1,1,1,3,1
KR_6652455455,420,2,-26,-5,7,-1,1,2,4,6,2,2,2,0,1,3,2,1,1,0,0,11,-45,4,4,8,33,0,-1,1,-1,-1,-1,2,1
KR_6719612914,420,3,-62,9,13,3,5,2,1,1,0,9,10,1,0,1,1,0,0,0,0,12,-23,4,1,5,24,0,1,1,1,1,1,6,1
KR_6739745948,420,5,108,6,13,2,4,2,0,2,2,4,4,0,8,10,2,-1,0,1,0,8,53,5,2,7,-13,0,3,1,-1,1,-1,4,1
KR_6685840637,420,3,31,8,4,0,3,3,1,1,0,-6,1,7,8,8,0,1,1,0,0,4,113,1,2,3,-2,0,3,1,1,1,1,5,1
KR_6759844132,420,-1,29,-11,-4,-3,0,3,-1,3,4,-1,1,2,4,5,1,-3,2,5,0,-1,-5,-3,6,3,1,0,2,1,1,1,-1,6,1
KR_6756725386,420,-1,-51,11,2,1,2,1,3,3,0,0,2,2,-5,2,7,3,3,0,-1,-1,5,7,1,8,3,0,0,-1,0,0,-1,4,1
KR_6765316936,420,2,51,28,1,1,3,2,0,1,1,-2,2,4,0,1,1,2,2,0,0,-4,7,2,6,8,2,0,1,1,1,1,-1,5,1
KR_6760498463,420,-1,-8,18,1,0,1,1,-1,0,1,0,2,2,1,5,4,1,1,0,0,1,-7,-1,7,6,-2,0,-1,1,1,-1,1,6,1
KR_6739151527,420,0,63,5,-8,2,2,0,-6,1,7,-1,0,1,-3,4,7,0,1,1,1,-8,0,2,5,7,-1,0,0,-1,1,0,1,4,1
KR_6763617672,420,6,13,28,25,8,9,1,7,7,0,7,7,0,3,5,2,0,1,1,1,17,-1,3,3,6,2,0,1,1,1,1,1,4,1
KR_6718172181,420,0,56,-15,-6,5,7,2,-6,0,6,-2,2,4,-2,4,6,-1,0,1,0,-11,-2,-3,6,3,-4,0,1,-1,-1,1,1,2,1
KR_6747959500,420,2,27,-12,8,2,5,3,1,2,1,2,2,0,0,3,3,3,3,0,1,5,19,0,3,3,-1,0,1,-1,1,1,1,1,1
KR_6682147112,420,2,-5,-8,-4,-3,1,4,2,5,3,-5,3,8,2,5,3,0,2,2,0,-4,2,1,5,6,-1,0,0,-1,1,-1,-1,3,1
KR_6764442347,440,-1,-47,-9,4,-2,1,3,1,2,1,2,3,1,3,5,2,0,0,0,0,7,8,2,4,6,2,0,0,1,-1,-1,1,2,1
KR_6760842973,420,5,99,-20,11,7,7,0,2,4,2,0,1,1,3,4,1,-1,0,1,0,7,-31,1,3,4,2,0,3,1,-1,1,-1,2,1
KR_6761857450,440,-1,-18,-5,-3,3,3,0,1,4,3,-2,0,2,-2,3,5,-3,0,3,0,3,3,-4,8,4,0,0,0,1,1,0,1,6,1
KR_6726586024,420,5,8,25,13,4,5,1,2,4,2,3,3,0,6,7,1,-2,0,2,2,21,-4,2,5,7,6,0,0,1,1,1,1,4,1
KR_6656697657,420,-2,20,-20,-3,-2,1,3,-1,2,3,0,2,2,3,3,0,-3,1,4,0,-3,-3,3,4,7,-2,0,0,1,1,1,-1,3,1
KR_6765603433,420,3,45,-8,7,4,4,0,2,6,4,0,0,0,1,2,1,0,3,3,0,5,5,3,3,6,2,0,-1,1,-1,1,-1,3,1
KR_6622736977,420,0,-43,-10,4,-1,1,2,0,1,1,1,2,1,4,5,1,0,1,1,0,2,31,1,3,4,0,0,-1,1,1,-1,-1,3,1
KR_6712088200,420,0,48,-56,15,-1,1,2,6,6,0,1,2,1,7,8,1,2,2,0,2,27,4,-3,5,2,6,0,0,1,-1,1,1,3,1
KR_6761263114,420,0,14,13,1,0,3,3,-5,1,6,5,6,1,-3,4,7,4,4,0,0,1,3,-3,4,1,-1,0,1,-1,-1,1,-1,2,1
KR_6641570229,440,9,108,36,20,2,3,1,4,5,1,4,5,1,5,5,0,5,7,2,0,24,39,5,1,6,3,0,2,1,1,1,1,6,1
KR_6621388668,420,0,44,-7,1,2,2,0,-1,2,3,-4,2,6,1,2,1,3,3,0,0,-2,1,1,3,4,0,0,1,1,1,1,-1,2,1
KR_6688886316,420,1,32,0,7,2,4,2,-1,2,3,3,3,0,2,3,1,1,1,0,1,2,-23,-1,5,4,2,0,1,1,1,1,1,1,1
KR_6756120173,420,2,-25,-4,9,3,4,1,2,3,1,3,4,1,0,2,2,1,3,2,0,8,24,-2,7,5,1,0,0,1,-1,1,1,5,1
KR_6656962011,420,1,-18,28,-3,4,4,0,0,1,1,0,2,2,-5,2,7,-2,0,2,0,-7,29,1,4,5,-1,0,1,-1,1,1,-1,4,1
KR_6640185921,420,0,-34,-20,1,-1,0,1,2,3,1,0,2,2,1,2,1,-1,1,2,0,5,-22,1,3,4,-2,0,1,1,-1,1,-1,6,1
KR_6747111539,420,4,12,23,8,2,4,2,7,8,1,2,4,2,-2,2,4,-1,0,1,0,13,17,1,4,5,1,0,1,1,1,1,1,5,1
KR_6740604412,420,4,64,0,9,-2,0,2,3,5,2,3,3,0,6,6,0,-1,0,1,0,15,-9,1,2,3,0,0,1,1,0,1,1,2,1
KR_6740906250,420,2,9,8,4,-3,1,4,-2,0,2,6,7,1,5,5,0,-2,0,2,1,8,10,-1,5,4,-2,0,1,1,-1,1,1,4,1
KR_6706913349,420,4,26,34,-2,2,4,2,-3,0,3,-2,3,5,1,6,5,0,0,0,0,-10,-46,3,3,6,14,0,-1,1,-1,-1,-1,4,1
KR_6749880917,420,1,-5,51,1,-2,0,2,1,2,1,0,3,3,2,3,1,0,3,3,0,-3,8,5,4,9,-4,0,2,1,1,1,1,1,1
KR_6706611154,420,0,38,3,2,3,4,1,0,2,2,1,4,3,-2,4,6,0,2,2,0,1,-11,0,3,3,-1,0,0,1,-1,1,1,4,1
KR_6628654567,420,6,125,7,8,3,4,1,2,3,1,-1,0,1,5,6,1,-1,0,1,0,13,17,-1,6,5,-1,0,1,1,-1,1,1,6,1
KR_6713537147,420,5,76,27,2,1,3,2,1,4,3,1,2,1,0,4,4,-1,1,2,-1,-7,-128,1,6,7,0,0,1,1,1,1,-1,5,1
KR_6757862898,420,1,-2,13,7,-1,0,1,3,5,2,5,6,1,-2,1,3,2,2,0,0,11,73,3,6,9,0,0,1,1,1,1,1,6,1
KR_6722371743,420,1,82,0,1,3,4,1,-1,3,4,-3,0,3,1,4,3,1,1,0,1,4,5,3,4,7,-4,0,1,1,1,1,-1,6,1
KR_6756316046,420,1,39,1,1,3,4,1,-1,2,3,1,1,0,-1,3,4,-1,0,1,0,3,19,2,2,4,7,0,0,1,-1,0,1,6,1
KR_6761524978,420,1,34,7,2,-2,2,4,0,2,2,1,4,3,3,4,1,0,1,1,0,-6,3,0,4,4,-3,0,1,0,1,1,-1,0,1
KR_6761807106,420,-2,-19,-40,-1,-4,2,6,1,1,0,3,5,2,-1,4,5,0,1,1,2,2,-31,1,5,6,21,0,-1,-1,1,-1,1,4,1
KR_6682768608,420,3,37,8,6,6,7,1,0,4,4,-1,0,1,3,3,0,-2,1,3,1,3,7,1,3,4,-2,0,1,1,-1,1,1,6,1
KR_6759530781,420,3,19,4,4,0,2,2,-5,1,6,2,2,0,6,6,0,1,2,1,0,8,-6,-2,4,2,6,0,1,1,1,1,-1,4,1
KR_6686586845,420,4,36,26,3,0,1,1,0,4,4,5,8,3,-3,0,3,1,4,3,0,-3,-12,2,4,6,-1,0,2,1,1,1,1,1,1
KR_6732378777,420,1,37,-25,1,1,1,0,0,2,2,0,3,3,-1,0,1,1,2,1,0,5,-3,1,5,6,3,0,0,-1,1,0,-1,6,1
KR_6764137407,420,2,-59,-8,0,0,1,1,-2,2,4,3,4,1,-1,0,1,0,1,1,0,-4,-112,2,3,5,0,0,-1,-1,1,-1,-1,3,1
KR_6055759321,420,2,73,-2,7,1,1,0,1,2,1,3,5,2,0,1,1,2,2,0,0,8,8,3,5,8,2,0,3,1,1,1,1,5,1
KR_6736991571,420,1,10,28,1,-3,1,4,4,8,4,1,2,1,-4,5,9,3,3,0,0,6,-1,2,4,6,0,0,1,0,0,1,-1,0,1
KR_6488760856,440,-3,27,-21,-3,2,4,2,-6,0,6,-1,1,2,2,3,1,0,0,0,0,-5,-30,1,3,4,0,0,0,-1,1,1,1,2,1
KR_6720955245,420,3,15,-6,4,4,4,0,-1,0,1,-1,2,3,0,1,1,2,2,0,0,1,32,-1,5,4,4,0,0,-1,-1,0,1,5,1
KR_6761079811,420,0,-27,19,-7,0,1,1,1,4,3,-1,2,3,-6,2,8,-1,1,2,0,-13,-9,-1,6,5,0,0,-2,1,-1,-1,1,6,1
KR_6747007008,420,-2,26,-32,-2,-3,1,4,5,8,3,-1,1,2,-3,1,4,0,0,0,0,1,-3,-4,7,3,3,0,1,0,1,1,-1,0,1
KR_6739248664,420,1,-16,19,6,-2,1,3,1,2,1,4,4,0,2,4,2,1,2,1,0,6,-36,2,3,5,16,0,0,1,1,0,1,1,1
KR_6759843756,420,-2,-29,-14,-8,0,1,1,-2,2,4,-1,1,2,-4,1,5,-1,0,1,0,-8,-7,2,4,6,-1,0,1,-1,1,1,1,3,1
KR_6752767520,420,1,-20,-8,1,-3,1,4,1,1,0,0,4,4,1,2,1,2,2,0,0,7,-34,5,5,10,19,0,0,-1,1,-1,-1,5,1
KR_6752752179,420,4,51,-6,15,5,6,1,1,3,2,2,4,2,7,10,3,0,0,0,0,21,195,0,6,6,2,0,1,1,1,1,-1,1,1
KR_6762115215,420,0,0,0,-5,-2,0,2,-6,2,8,0,3,3,1,1,0,2,3,1,-1,-8,161,-4,10,6,-26,0,0,-1,1,1,-1,2,1
KR_6760215656,420,2,66,4,5,0,3,3,7,8,1,-2,0,2,0,2,2,0,2,2,0,4,-12,-1,7,6,5,0,0,1,1,0,1,1,1
KR_6756375743,420,-2,-41,21,-5,-1,3,4,0,2,2,0,1,1,-1,0,1,-3,0,3,-1,0,9,-3,5,2,-1,0,0,1,1,-1,-1,1,1
KR_6764849899,420,-3,-30,-19,-2,-3,0,3,0,2,2,-1,1,2,1,5,4,1,1,0,0,10,-8,-1,7,6,1,0,0,-1,-1,0,1,2,1
KR_6674820678,420,4,80,-3,13,2,3,1,2,5,3,4,4,0,3,5,2,2,3,1,-1,7,0,1,4,5,4,0,0,0,1,1,-1,0,1
KR_6729349728,420,-2,-15,-8,-2,1,2,1,-3,1,4,-2,0,2,2,4,2,0,1,1,0,-6,-50,-2,6,4,20,0,-2,1,-1,-1,-1,5,1
KR_6763794916,420,2,21,24,1,-2,1,3,5,6,1,-1,0,1,-1,2,3,0,1,1,0,6,-7,0,5,5,1,0,0,-1,1,0,-1,4,1
KR_6718415768,440,6,104,33,11,4,4,0,3,4,1,-1,1,2,4,4,0,1,6,5,0,3,-100,5,2,7,-3,0,4,1,1,1,1,1,1
KR_6741675052,440,0,4,0,0,-1,0,1,-3,0,3,2,3,1,1,3,2,1,1,0,0,6,-29,-1,4,3,0,0,0,1,-1,0,-1,2,1
KR_6765180351,420,2,9,-25,3,1,3,2,4,5,1,1,3,2,0,3,3,-3,2,5,0,5,-9,-3,5,2,1,0,0,1,-1,1,1,4,1
KR_6744518771,420,2,6,3,1,2,5,3,2,4,2,-1,1,2,0,3,3,-2,0,2,0,1,94,0,5,5,0,0,1,1,1,1,1,2,1
KR_6749194298,420,0,-28,6,-1,0,0,0,-3,1,4,1,1,0,-2,1,3,3,3,0,0,1,1,-1,6,5,5,0,1,-1,-1,1,-1,3,1
KR_6634872871,420,-1,19,7,-1,5,5,0,1,5,4,-2,5,7,-4,0,4,-1,0,1,0,-6,-336,5,6,11,-2,0,0,-1,1,1,1,5,1
KR_6762354018,420,4,-31,-4,8,1,2,1,2,3,1,3,3,0,0,1,1,2,2,0,0,3,-1,-2,6,4,1,0,0,-1,1,0,1,1,1
KR_6744289953,440,-1,-7,-39,-8,3,5,2,-2,4,6,0,1,1,-2,1,3,-7,2,9,0,-4,-3,0,4,4,2,0,-1,1,1,-1,-1,1,1
KR_6671835270,420,5,54,0,15,4,4,0,2,6,4,7,7,0,3,5,2,-1,2,3,0,13,-1,-1,2,1,2,0,3,-1,1,1,1,4,1
KR_6720668209,440,-2,-34,-5,1,0,2,2,-2,3,5,-3,1,4,6,7,1,0,1,1,0,-2,8,0,4,4,0,0,0,-1,1,0,-1,1,1
KR_6764285578,420,1,13,-24,9,2,2,0,4,5,1,1,1,0,1,6,5,1,3,2,0,8,-14,7,4,11,0,0,0,-1,1,0,-1,1,1
KR_6686790635,420,1,2,9,1,2,3,1,-2,0,2,0,1,1,3,6,3,-2,0,2,0,0,6,3,6,9,-2,0,1,1,1,1,-1,5,1
KR_6757115849,440,8,47,32,23,2,3,1,4,6,2,5,6,1,8,10,2,4,4,0,1,25,24,2,6,8,-3,0,3,1,1,1,1,2,1
KR_6762254567,420,3,29,14,7,5,7,2,3,4,1,4,5,1,-4,1,5,-1,0,1,-1,-2,5,1,5,6,-6,0,1,-1,0,-1,-1,1,1
KR_6732744361,420,1,8,-8,2,-1,1,2,-3,2,5,1,2,1,2,3,1,3,4,1,0,7,3,-1,5,4,0,0,0,-1,-1,-1,-1,6,1
KR_6655335382,440,6,27,12,8,1,1,0,-2,3,5,6,6,0,1,3,2,2,3,1,0,10,-222,1,3,4,2,0,2,1,1,1,-1,1,1
KR_6635427441,420,-1,-52,-8,-7,-2,3,5,-7,1,8,-2,3,5,0,2,2,4,6,2,0,-2,-9,-1,6,5,3,0,-2,1,-1,-1,-1,2,1
KR_6765826832,420,-2,6,-11,-5,-3,1,4,-2,0,2,2,2,0,-4,1,5,2,2,0,0,-6,7,3,5,8,-3,0,0,1,1,1,1,5,1
KR_6750616615,420,4,-14,-2,1,1,2,1,1,2,1,-4,2,6,4,7,3,-1,1,2,0,3,-5,-4,6,2,-1,0,-2,-1,-1,-1,-1,6,1
KR_6762173947,420,0,8,12,4,-4,1,5,4,4,0,1,2,1,3,3,0,0,1,1,0,14,-1,-4,5,1,5,0,0,-1,1,0,1,4,1
KR_6036576603,420,0,20,6,5,1,3,2,3,9,6,-1,1,2,0,0,0,2,2,0,0,4,29,1,5,6,3,0,1,1,1,1,1,4,1
KR_6751183343,440,0,45,-2,3,2,2,0,-3,1,4,1,1,0,-1,2,3,4,5,1,0,1,7,3,2,5,-1,0,1,1,1,1,1,2,1
KR_6723773748,420,2,48,14,3,4,4,0,-1,2,3,0,3,3,-1,2,3,1,1,0,2,-4,2,-4,8,4,1,0,0,-1,0,0,1,5,1
KR_6757800128,420,1,20,-16,6,0,1,1,-2,0,2,4,4,0,1,5,4,3,4,1,0,10,2,-1,6,5,-1,0,0,1,1,1,1,1,1
KR_6656375168,420,-1,-45,-4,1,2,5,3,1,2,1,2,3,1,-3,1,4,-1,1,2,0,5,3,4,5,9,-1,0,0,1,1,0,-1,3,1
KR_6678849259,420,7,63,20,16,-1,1,2,4,4,0,3,4,1,8,8,0,2,2,0,0,20,1,4,1,5,3,0,3,1,1,1,1,2,1
KR_6749353387,420,-1,-18,-19,-7,2,2,0,-8,3,11,-3,1,4,3,8,5,-1,3,4,0,-13,-5,-7,10,3,5,0,-1,-1,-1,-1,-1,4,1
KR_6666632172,420,3,25,6,9,3,3,0,1,2,1,1,1,0,1,2,1,3,3,0,0,7,9,7,2,9,1,0,1,-1,1,1,1,5,1
KR_6630833190,420,3,11,10,4,0,1,1,-1,2,3,2,2,0,2,2,0,1,3,2,0,4,7,1,3,4,-2,0,1,1,-1,1,1,1,1
KR_6732518014,440,6,54,36,17,0,1,1,6,8,2,2,4,2,9,10,1,0,1,1,3,20,5,-2,4,2,1,0,2,-1,1,1,1,2,1
KR_6764493493,420,0,8,36,1,-5,2,7,6,7,1,0,1,1,-3,1,4,3,3,0,1,5,33,-4,5,1,4,0,2,-1,1,1,1,4,1
KR_6760352613,420,-1,-23,24,-2,3,3,0,-1,1,2,-2,0,2,1,1,0,-3,0,3,0,-5,-400,2,4,6,4,0,-1,1,1,-1,-1,3,1
KR_6761481964,420,3,55,16,12,-2,0,2,2,4,2,4,6,2,9,9,0,-1,0,1,2,12,-97,7,4,11,6,0,0,1,1,1,1,3,1
KR_6760786098,420,1,-14,36,3,-1,1,2,4,5,1,-1,1,2,1,4,3,0,2,2,-1,7,-126,-2,6,4,-5,0,0,1,-1,0,-1,2,1
KR_6716462711,420,1,-53,37,6,8,8,0,-1,1,2,0,1,1,-2,2,4,1,1,0,0,-2,-100,3,2,5,1,0,-1,1,1,1,-1,2,1
KR_6758229582,440,5,17,0,14,2,4,2,2,2,0,1,1,0,7,9,2,2,2,0,0,19,3,6,3,9,1,0,2,0,1,1,1,0,1
KR_6643977620,420,2,35,17,-4,2,2,0,-3,1,4,-5,1,6,2,5,3,0,2,2,1,-7,25,2,3,5,-4,0,2,-1,1,1,1,5,1
KR_6724870933,420,0,19,-12,-2,0,0,0,0,4,4,-8,1,9,5,6,1,1,2,1,0,2,0,-2,7,5,0,0,1,-1,-1,1,1,6,1
KR_6765234989,420,-2,1,-11,-1,-2,0,2,0,2,2,-6,0,6,5,7,2,2,2,0,0,6,2,0,6,6,4,0,0,-1,1,-1,-1,1,1
KR_6736551612,420,4,37,-23,10,-1,2,3,3,4,1,5,5,0,3,4,1,0,2,2,0,12,3,1,3,4,2,0,0,1,-1,0,1,5,1
KR_6760458733,420,1,17,-1,6,0,1,1,4,6,2,-1,1,2,4,5,1,-1,0,1,0,11,30,0,5,5,1,0,0,1,1,0,-1,4,1
KR_6704467625,440,0,4,-11,0,-6,1,7,3,4,1,1,1,0,3,5,2,-1,2,3,0,-3,-11,-6,8,2,6,0,1,-1,0,1,1,3,1
KR_6764309587,420,4,41,-17,15,3,3,0,11,12,1,-4,1,5,3,5,2,2,3,1,0,14,-9,3,6,9,4,0,3,0,1,1,-1,0,1
KR_6747562988,420,2,-55,10,7,-3,0,3,1,7,6,5,5,0,3,3,0,1,1,0,0,8,20,-2,9,7,1,0,0,1,-1,-1,-1,4,1
KR_6682019410,420,-2,4,-7,-9,-1,2,3,-2,3,5,-2,2,4,-4,0,4,0,0,0,-1,-12,-3,2,3,5,5,0,0,-1,1,1,-1,4,1
KR_6731324380,420,2,17,-8,3,-1,2,3,5,6,1,0,1,1,1,2,1,-2,3,5,-1,10,-8,0,3,3,3,0,1,0,1,1,-1,0,1
KR_6635699515,420,2,43,1,1,1,1,0,-2,2,4,-1,0,1,2,2,0,1,3,2,0,-2,-149,-3,8,5,3,0,1,1,-1,1,1,4,1
KR_6759802132,420,-1,1,-12,0,0,0,0,-2,2,4,3,6,3,-1,0,1,0,0,0,0,-2,3,-1,5,4,0,0,0,1,-1,0,1,2,1
KR_6735921678,420,1,26,-26,6,0,1,1,3,7,4,1,2,1,3,5,2,-1,2,3,0,11,2,3,4,7,2,0,0,1,1,0,1,2,1
KR_6629264597,420,-3,-52,0,-15,-11,0,11,-3,0,3,2,4,2,-1,3,4,-2,1,3,0,-12,49,4,4,8,-13,0,0,1,-1,-1,-1,6,1
KR_6726117193,420,3,48,-13,12,2,2,0,0,2,2,5,6,1,3,5,2,2,2,0,0,23,8,-2,7,5,-5,0,1,-1,1,1,1,4,1
KR_6764660812,420,4,12,14,3,3,3,0,0,3,3,2,4,2,0,3,3,-2,1,3,0,-2,0,-1,6,5,-2,0,0,-1,1,1,1,5,1
KR_6704371539,420,4,78,-17,7,-1,3,4,-1,3,4,10,10,0,1,4,3,-2,0,2,1,4,-112,-1,5,4,2,0,1,1,1,-1,1,2,1
KR_6757911067,420,1,10,1,0,0,2,2,-1,2,3,0,5,5,1,1,0,0,0,0,0,-2,0,-3,6,3,0,0,0,-1,1,0,-1,6,1
KR_6765984317,420,-1,13,17,-4,0,5,5,-2,2,4,-1,1,2,0,3,3,-1,0,1,1,1,-2,-6,9,3,-3,0,1,-1,0,1,1,3,1
KR_6762225899,420,2,64,9,2,5,6,1,-2,1,3,-3,1,4,5,7,2,-3,0,3,-1,-4,-4,-4,10,6,-3,0,0,-1,1,-1,-1,5,1
KR_6758138508,420,4,46,-5,10,3,3,0,5,6,1,-2,3,5,7,7,0,-3,0,3,0,14,3,-4,6,2,0,0,3,1,1,1,1,4,1
KR_6747842920,420,-2,3,2,-11,-3,2,5,-3,1,4,-5,0,5,2,3,1,-2,0,2,0,-4,11,-1,9,8,-2,0,1,-1,1,1,1,3,1
KR_6635668643,420,3,104,-10,13,2,3,1,6,7,1,-1,3,4,7,7,0,-1,0,1,0,27,-127,2,4,6,1,0,1,0,-1,1,1,0,1
KR_6766231184,420,3,-34,-4,5,1,3,2,6,8,2,-1,2,3,1,2,1,-2,0,2,0,5,19,-2,8,6,-8,0,0,-1,-1,0,-1,5,1
KR_6756607555,420,3,49,21,6,1,2,1,3,5,2,1,4,3,1,2,1,0,0,0,0,4,1,-2,7,5,4,0,1,1,1,1,-1,4,1
KR_6740066647,420,3,93,40,3,1,1,0,0,1,1,7,7,0,0,2,2,-5,0,5,1,2,3,-1,5,4,-3,0,0,1,1,1,1,6,1
KR_6733131288,420,-1,-41,24,-1,0,1,1,-1,3,4,-1,0,1,2,3,1,-1,1,2,0,1,-101,-1,7,6,-3,0,0,-1,-1,0,-1,1,1
KR_6753999858,440,-2,-6,-3,-6,-5,0,5,1,5,4,0,1,1,-2,2,4,0,0,0,2,1,-3,-6,8,2,-2,0,-1,-1,1,-1,1,3,1
KR_6713526187,420,0,8,-3,1,-2,0,2,1,3,2,1,2,1,0,1,1,1,2,1,0,2,8,3,4,7,2,0,1,-1,-1,1,1,3,1
KR_6660837256,420,0,35,-2,6,8,8,0,-2,3,5,4,5,1,-3,0,3,-1,2,3,0,-11,-13,-1,4,3,4,0,1,-1,1,1,-1,6,1
KR_6627902558,440,4,88,-1,4,2,4,2,-5,0,5,3,4,1,2,2,0,2,5,3,0,1,-2,0,4,4,-5,0,1,-1,1,1,-1,4,1
KR_6701596603,420,3,116,20,4,4,6,2,3,7,4,2,4,2,-4,5,9,-1,1,2,1,-7,0,-3,6,3,3,0,1,-1,-1,1,1,6,1
KR_6764968130,420,3,62,0,6,6,6,0,-4,1,5,2,3,1,2,3,1,0,0,0,0,3,9,2,3,5,1,0,1,1,1,1,1,5,1
KR_6740486562,420,3,-27,36,4,1,3,2,1,2,1,5,6,1,-2,1,3,-1,0,1,1,2,4,0,5,5,1,0,1,1,-1,1,1,4,1
KR_6762403528,420,5,51,29,3,4,5,1,1,2,1,1,2,1,-2,0,2,-1,0,1,0,0,0,-3,7,4,0,0,0,1,-1,1,-1,5,1
KR_6709156271,420,2,-35,35,1,-3,1,4,3,8,5,-1,1,2,1,3,2,1,1,0,0,5,4,-2,9,7,1,0,1,1,1,1,1,6,1
KR_6749878391,420,4,21,23,12,1,4,3,-1,0,1,1,6,5,9,9,0,2,2,0,0,25,16,-1,4,3,1,0,1,1,-1,1,-1,3,1
KR_6695332233,420,-1,13,23,-4,-1,0,1,1,4,3,0,2,2,1,1,0,-5,0,5,0,-4,-15,1,4,5,4,0,-1,1,-1,-1,-1,6,1
KR_6761558913,420,2,-43,-20,6,-3,0,3,3,4,1,4,5,1,3,4,1,-1,0,1,0,4,-173,-1,4,3,-1,0,0,1,-1,0,1,3,1
KR_6738013913,440,1,11,-38,8,0,5,5,-1,2,3,0,0,0,9,9,0,0,0,0,2,17,5,2,3,5,3,0,-1,1,-1,-1,1,4,1
KR_6759825706,440,1,-59,-8,0,-1,3,4,-3,1,4,6,8,2,-2,2,4,0,1,1,0,12,1,-6,10,4,3,0,-1,-1,0,-1,-1,2,1
KR_6762513538,420,5,57,-3,18,8,9,1,6,10,4,1,3,2,2,4,2,1,2,1,1,25,2,8,2,10,-2,0,1,1,1,1,1,3,1
KR_6688505163,420,0,-46,-1,5,1,1,0,3,4,1,-2,1,3,3,3,0,0,2,2,1,10,28,2,4,6,3,0,1,1,1,1,1,5,1
KR_6760331867,420,1,19,39,8,2,2,0,-2,1,3,6,7,1,2,5,3,0,1,1,0,7,-5,1,2,3,0,0,0,1,-1,-1,-1,1,1
KR_6745674092,420,1,4,-29,4,-1,1,2,5,6,1,0,2,2,1,6,5,-1,0,1,0,3,-2,0,6,6,-3,0,0,1,1,0,-1,5,1
KR_6752636268,420,3,37,2,6,3,4,1,4,8,4,-4,2,6,3,4,1,0,0,0,0,9,-5,2,2,4,-3,0,0,-1,1,1,1,1,1
KR_6750615540,440,-1,-1,5,4,-1,1,2,-5,2,7,3,3,0,6,7,1,1,4,3,1,12,-6,-5,9,4,6,0,1,1,1,1,1,5,1
KR_6729744152,440,0,9,19,-2,-1,1,2,-1,0,1,0,4,4,0,1,1,0,3,3,1,4,-360,-5,9,4,12,0,0,-1,-1,0,1,6,1
KR_6488777659,440,0,24,20,1,6,6,0,-6,0,6,-2,1,3,5,5,0,-2,1,3,0,0,13,6,2,8,-2,0,0,-1,-1,1,1,5,1
KR_6759304362,420,-2,-2,-8,4,1,4,3,2,4,2,-5,1,6,7,8,1,-1,1,2,1,14,-5,-1,5,4,0,0,-2,-1,-1,-1,1,5,1
KR_6731580826,440,2,13,-16,7,1,1,0,3,3,0,2,2,0,0,1,1,1,1,0,0,9,17,5,1,6,1,0,0,0,-1,1,1,0,1
KR_6660659326,440,-2,-18,-20,-7,2,2,0,-1,1,2,-3,1,4,-3,0,3,-2,0,2,0,-9,-135,0,6,6,-1,0,0,0,-1,-1,-1,0,1
KR_6690932853,420,3,60,24,7,0,0,0,4,5,1,2,5,3,0,0,0,1,1,0,0,2,-1,-2,5,3,3,0,1,1,-1,1,1,4,1
KR_6760660009,420,-2,-38,-8,-1,-1,0,1,3,5,2,0,4,4,-4,3,7,1,1,0,0,5,-103,2,5,7,2,0,1,-1,1,-1,1,6,1
KR_6741179840,440,3,5,31,4,2,2,0,-3,3,6,2,2,0,3,4,1,0,1,1,0,-1,10,3,4,7,-2,0,0,1,-1,1,1,4,1
KR_6734822777,420,2,52,0,5,2,3,1,2,4,2,0,1,1,1,3,2,0,0,0,0,4,117,0,6,6,0,0,-1,0,1,-1,-1,0,1
KR_6692276338,420,-1,0,-10,2,-2,1,3,1,2,1,4,6,2,-1,3,4,0,1,1,0,-6,26,-5,6,1,2,0,0,-1,-1,0,-1,6,1
KR_6658461434,420,-1,-16,17,-4,-2,1,3,0,3,3,-2,2,4,-1,3,4,1,1,0,1,-2,2,-7,9,2,-1,0,1,-1,1,1,1,3,1
KR_6753593461,440,8,123,55,14,4,6,2,2,2,0,0,0,0,2,4,2,6,7,1,0,10,-36,-1,6,5,19,0,2,0,1,1,1,0,1
KR_6747898628,420,3,58,36,7,2,4,2,4,5,1,-1,2,3,1,2,1,1,1,0,1,4,2,1,4,5,2,0,0,1,1,0,1,5,1
KR_6766199404,420,1,9,8,-7,3,4,1,-6,0,6,0,0,0,-1,2,3,-3,0,3,-1,-18,12,-2,5,3,-26,0,1,0,1,1,-1,0,1
KR_6766093394,420,1,46,0,0,-5,1,6,-1,2,3,0,1,1,6,8,2,0,0,0,0,-2,49,3,4,7,-17,0,-1,1,-1,-1,1,3,1
KR_6758834628,440,0,13,0,6,1,2,1,2,4,2,-5,0,5,8,10,2,0,1,1,1,14,301,-2,4,2,3,0,0,1,1,1,1,6,1
KR_6747834602,420,2,-52,33,5,-3,1,4,4,6,2,-1,2,3,0,3,3,5,6,1,2,2,-8,-4,7,3,3,0,0,1,1,0,1,1,1
KR_6764917281,420,1,9,11,2,1,1,0,1,3,2,2,3,1,-5,1,6,3,4,1,0,6,-1,4,3,7,-2,0,0,-1,1,1,-1,5,1
KR_6683955978,420,4,53,36,8,3,4,1,0,4,4,2,4,2,4,4,0,-1,0,1,-1,-3,3,3,2,5,-4,0,2,1,-1,1,-1,3,1
KR_6749657260,420,4,-11,47,0,-2,1,3,0,3,3,6,7,1,-7,1,8,3,4,1,0,1,-31,-4,6,2,7,0,-1,-1,-1,-1,1,3,1
KR_6699080431,420,4,61,22,7,2,3,1,2,4,2,-2,0,2,4,4,0,1,2,1,0,5,-9,4,1,5,1,0,1,1,1,1,-1,6,1
KR_6740501198,440,5,29,46,7,9,9,0,0,4,4,0,2,2,-2,4,6,0,0,0,1,10,8,3,4,7,0,0,0,1,0,1,1,5,1
KR_6734380167,440,1,13,-20,11,1,4,3,5,7,2,0,1,1,1,5,4,4,4,0,-1,7,5,0,6,6,-3,0,0,-1,0,0,1,5,1
KR_6690926890,440,1,4,4,1,0,1,1,2,7,5,3,3,0,-4,1,5,0,0,0,0,2,37,2,3,5,-6,0,1,1,-1,1,1,6,1
KR_6761578658,420,-4,-24,0,-5,-2,1,3,-4,1,5,2,4,2,0,3,3,-1,0,1,0,-8,-3,-3,7,4,15,0,0,-1,1,-1,1,2,1
KR_6728680514,440,2,30,-4,10,0,0,0,4,4,0,-3,3,6,6,7,1,3,5,2,0,11,276,2,1,3,3,0,0,1,0,1,1,1,1
KR_6752292933,420,1,3,-22,-1,0,1,1,-3,0,3,-1,0,1,4,10,6,-1,0,1,0,5,72,3,4,7,-4,0,-1,1,-1,-1,1,5,1
KR_6750441984,420,9,104,38,22,5,5,0,12,13,1,5,7,2,2,3,1,-2,1,3,1,32,27,-1,3,2,3,0,4,0,1,1,1,0,1
KR_6762416875,420,6,104,19,11,9,9,0,1,4,3,0,3,3,0,7,7,1,4,3,0,3,-21,-2,5,3,4,0,2,-1,1,1,-1,3,1
KR_6562480504,420,4,-22,4,10,-1,0,1,6,6,0,4,6,2,0,2,2,1,1,0,0,18,3,5,2,7,0,0,-1,1,-1,-1,-1,4,1
KR_6736879736,420,2,-24,16,8,3,4,1,1,3,2,2,2,0,3,3,0,-1,0,1,0,6,-39,-1,4,3,23,0,0,1,-1,0,1,4,1
KR_6696781724,420,4,1,23,12,0,0,0,4,7,3,3,4,1,4,4,0,1,3,2,0,12,-1,1,6,7,-2,0,0,1,0,0,-1,5,1
KR_6732417327,440,1,0,15,5,-2,0,2,2,3,1,7,8,1,-2,1,3,0,0,0,0,3,2,3,2,5,1,0,0,1,0,1,1,1,1
KR_6746652549,440,3,38,28,-1,0,2,2,-4,2,6,2,3,1,2,6,4,-1,0,1,1,-9,-8,-7,9,2,7,0,0,1,0,1,1,4,1
KR_6752368195,420,2,19,-1,-1,1,1,0,5,5,0,0,1,1,-3,1,4,-4,0,4,0,-2,24,-7,9,2,-15,0,2,-1,-1,1,-1,5,1
KR_6729760192,420,-2,-2,1,-1,1,3,2,-3,2,5,1,1,0,-1,2,3,1,1,0,0,-5,11,2,5,7,-3,0,1,1,1,1,1,2,1
KR_6646746687,420,2,101,-12,4,-2,0,2,2,6,4,0,2,2,4,5,1,0,0,0,0,0,8,3,4,7,1,0,2,-1,1,1,1,3,1
KR_6686679620,420,-1,25,-17,-1,0,2,2,-3,0,3,-3,1,4,3,4,1,2,2,0,0,-1,-149,-1,4,3,3,0,1,-1,-1,1,-1,1,1
KR_6761794598,420,5,120,8,12,4,5,1,1,4,3,2,5,3,6,7,1,-1,2,3,0,4,-10,3,4,7,1,0,2,0,0,1,1,0,1
KR_6703799878,420,2,23,-14,7,4,7,3,0,1,1,0,2,2,2,3,1,1,1,0,0,4,-12,-1,4,3,0,0,1,1,1,1,1,3,1
KR_6718752608,420,3,71,16,7,0,2,2,2,3,1,3,5,2,2,3,1,0,0,0,0,5,375,0,4,4,4,0,2,1,1,1,1,4,1
KR_6754409676,440,1,71,40,9,0,5,5,3,3,0,0,3,3,1,4,3,5,5,0,0,11,-49,-3,6,3,15,0,0,1,-1,0,-1,2,1
KR_6706845200,420,-3,36,2,-8,-2,0,2,-1,2,3,-2,0,2,-5,1,6,2,3,1,0,0,46,-2,6,4,-14,0,1,-1,1,1,-1,6,1
KR_6763751686,420,1,93,-6,-8,0,2,2,-3,4,7,-1,4,5,-4,3,7,0,0,0,0,-9,108,-2,6,4,-4,0,-1,-1,-1,-1,-1,5,1
KR_6654452757,420,2,-38,-14,10,0,1,1,10,10,0,-2,2,4,-1,2,3,3,3,0,0,15,23,3,5,8,-2,0,0,1,-1,-1,1,1,1
KR_6760385400,420,2,34,3,4,2,7,5,2,3,1,0,0,0,-1,2,3,1,3,2,0,4,9,1,9,10,-1,0,1,1,-1,1,1,6,1
KR_6763923785,420,0,7,0,3,1,3,2,1,3,2,2,2,0,-1,2,3,0,0,0,0,3,3,3,5,8,5,0,0,1,-1,0,1,1,1
KR_6717905236,420,5,128,-4,9,0,1,1,-1,4,5,1,4,3,4,4,0,5,5,0,0,14,-10,-3,7,4,7,0,2,1,-1,1,1,5,1
KR_6688306685,440,0,1,8,0,0,6,6,-5,2,7,1,1,0,4,7,3,0,0,0,-1,1,10,0,6,6,0,0,1,1,-1,-1,1,6,1
KR_6741467231,420,0,-56,20,-1,-2,3,5,0,4,4,-2,3,5,-1,4,5,4,5,1,1,0,14,0,3,3,-1,0,0,-1,-1,-1,-1,6,1
KR_6752335240,420,-1,-28,0,3,-2,0,2,1,5,4,1,3,2,1,2,1,2,2,0,0,2,-10,-4,8,4,5,0,0,1,-1,-1,-1,6,1
KR_6749343835,420,0,1,-22,0,-2,0,2,0,3,3,0,3,3,1,7,6,1,1,0,0,2,4,0,3,3,1,0,2,1,-1,1,1,6,1
KR_6691003798,420,-1,11,11,-7,-2,1,3,1,5,4,-4,1,5,-2,3,5,0,2,2,1,-1,4,-1,4,3,0,0,1,1,1,1,1,5,1
KR_6738646506,440,0,-31,30,-3,0,1,1,3,3,0,-4,1,5,-2,1,3,0,0,0,0,-5,-204,-2,6,4,-2,0,-1,1,1,-1,-1,3,1
KR_6715602816,420,3,67,12,-1,-6,1,7,0,3,3,1,1,0,2,2,0,2,3,1,0,2,-8,1,1,2,3,0,-1,1,1,-1,-1,6,1
KR_6685358883,420,3,31,-3,7,1,1,0,4,5,1,1,7,6,2,4,2,-1,1,2,0,-3,6,8,1,9,-1,0,1,1,-1,1,-1,3,1
KR_6511030847,420,3,29,8,8,1,3,2,-1,1,2,-1,1,2,8,9,1,1,1,0,0,9,3,2,7,9,1,0,-1,1,-1,1,-1,3,1
KR_6765144696,420,1,71,-4,-1,-3,0,3,2,3,1,0,3,3,0,2,2,0,1,1,0,0,1,2,5,7,5,0,1,0,-1,1,-1,0,1
KR_6551104769,420,0,-11,-4,7,-1,1,2,3,4,1,-1,2,3,9,9,0,-3,0,3,0,10,3,5,1,6,-3,0,1,1,1,-1,1,6,1
KR_6763181193,440,2,-59,-16,0,4,4,0,-1,2,3,-1,1,2,0,1,1,-2,0,2,0,-4,-4,3,4,7,2,0,0,1,-1,0,1,4,1
KR_6683891480,420,4,104,17,13,4,4,0,-1,2,3,4,4,0,10,11,1,-4,1,5,0,9,5,-2,6,4,3,0,0,1,-1,1,-1,1,1
KR_6650393811,420,-1,-6,-3,1,1,2,1,-3,3,6,3,4,1,-3,1,4,3,3,0,2,4,-23,0,5,5,7,0,0,1,1,1,1,1,1
KR_6678187641,420,2,-18,24,-1,-1,2,3,1,2,1,1,2,1,-2,0,2,0,2,2,0,2,-19,0,6,6,-7,0,0,1,-1,-1,-1,5,1
KR_6756598955,440,-3,13,3,-14,-2,3,5,-4,0,4,-5,0,5,-2,3,5,-1,0,1,0,-13,-2,-2,4,2,-3,0,0,0,1,1,-1,0,1
KR_6759250833,420,-1,-39,-1,0,3,4,1,-2,4,6,1,3,2,0,2,2,-2,2,4,0,-10,-13,1,4,5,-1,0,1,1,1,-1,1,5,1
KR_6724997009,420,6,63,18,11,-2,1,3,5,8,3,4,4,0,3,4,1,1,4,3,1,8,4,-1,6,5,1,0,1,1,-1,1,1,6,1
KR_6505859412,420,3,25,-11,6,4,5,1,2,3,1,2,3,1,-1,3,4,-1,2,3,0,5,-7,0,10,10,5,0,0,-1,1,-1,-1,3,1
KR_6765070667,420,3,66,16,7,5,5,0,0,4,4,-1,5,6,3,4,1,0,1,1,0,9,-1,-2,4,2,3,0,2,1,1,1,1,3,1
KR_6762280914,420,2,9,14,0,1,2,1,-3,4,7,1,3,2,1,2,1,0,0,0,0,1,-11,4,3,7,4,0,0,1,-1,0,-1,1,1
KR_6652682441,420,3,9,0,4,3,3,0,4,6,2,5,6,1,-9,1,10,1,2,1,0,0,-1,-2,6,4,0,0,1,0,1,1,-1,0,1
KR_6759719986,420,4,61,0,13,2,3,1,-1,3,4,4,4,0,4,6,2,4,4,0,0,10,7,0,6,6,-2,0,1,1,-1,1,1,6,1
KR_6696245884,420,4,57,0,7,2,2,0,3,4,1,1,1,0,1,4,3,0,0,0,0,2,-4,-4,8,4,4,0,0,1,-1,0,1,2,1
KR_6756153041,420,4,31,20,7,5,6,1,3,4,1,4,5,1,-4,1,5,-1,0,1,0,0,7,1,3,4,-3,0,2,-1,1,1,1,6,1
KR_6683477826,420,1,-22,-22,7,5,6,1,-1,1,2,-3,1,4,4,5,1,2,3,1,0,12,15,1,6,7,-1,0,0,1,-1,1,1,3,1
