matchId,queueId,Diff_LV,Diff_CS,Diff_jglCS,Diff-K,Diff-K-top,K-WIN-top,K-LOSE-top,Diff-K-jug,K-WIN-jug,K-LOSE-jug,Diff-K-mid,K-WIN-mid,K-LOSE-mid,Diff-K-ad,K-WIN-ad,K-LOSE-ad,Diff-K-sup,K-WIN-sup,K-LOSE-sup,invadeKill,Diff-A,Diff_WARDplaced,Diff-ControlWARDplaced,LOSE_controlWARDPlaced,WIN_controlWARDPlaced,Diff_WARDkill,Diff_Inhibitor,Diff_TOWERkill,Diff_FirstDRAGON,Diff_FirstHERALD,Diff_Firsttower,Diff_FirstBLOOD,dragonType,result
KR_6763223052,440,0,-27,40,0,2,4,2,-1,3,4,-1,1,2,-3,3,6,3,4,1,0,3,1,-1,4,3,-2,0,0,-1,1,-1,-1,3,1
KR_6763758113,420,3,8,32,6,2,3,1,3,3,0,2,3,1,-2,2,4,1,3,2,0,1,0,-5,5,0,-1,0,0,-1,-1,0,1,5,1
KR_6726632713,420,3,88,-27,10,4,4,0,6,8,2,-3,1,4,2,4,2,1,2,1,0,8,3,2,2,4,3,0,2,-1,1,1,1,6,1
KR_6726817558,440,3,36,23,0,2,3,1,-6,1,7,1,2,1,0,6,6,3,4,1,1,-5,0,-2,5,3,-2,0,1,-1,0,1,1,5,1
KR_6750452809,420,2,66,-2,2,0,0,0,1,2,1,-3,1,4,2,4,2,2,2,0,0,5,49,2,3,5,-26,0,0,1,0,1,1,5,1
KR_6758544420,420,4,2,24,13,1,1,0,-2,2,4,9,9,0,2,6,4,3,3,0,-1,14,0,3,2,5,0,0,0,0,1,0,-1,0,1
KR_6755306063,420,0,24,0,0,1,2,1,-4,0,4,1,5,4,2,4,2,0,1,1,0,-1,-41,-2,5,3,22,0,0,0,0,0,1,0,1
KR_6632772822,420,0,46,-28,3,1,5,4,-3,0,3,1,3,2,3,5,2,1,3,2,0,-1,15,2,4,6,-2,0,0,-1,-1,1,1,1,1
KR_6620519272,420,-3,9,28,0,0,6,6,-3,2,5,0,2,2,1,3,2,2,2,0,2,-7,-3,1,3,4,-2,0,1,-1,1,1,1,4,1
KR_6565363136,420,1,34,8,-3,0,2,2,1,4,3,2,3,1,-7,0,7,1,1,0,-1,-9,2,2,1,3,-3,0,-1,-1,-1,-1,-1,5,1
KR_6748688099,420,2,20,-3,6,2,2,0,1,3,2,0,1,1,1,3,2,2,2,0,-1,3,26,0,6,6,2,0,0,1,-1,0,-1,6,1
KR_6732335317,420,0,-34,3,1,-1,0,1,0,5,5,-1,0,1,2,2,0,1,1,0,0,6,-13,1,1,2,0,0,0,1,1,0,-1,4,1
KR_6739063897,420,1,-10,4,2,-2,1,3,2,4,2,3,5,2,-2,1,3,1,1,0,0,11,53,-4,5,1,-1,0,0,1,-1,-1,1,4,1
KR_6754197195,420,4,3,-4,7,-1,1,2,5,6,1,-2,2,4,1,3,2,4,4,0,0,7,12,0,5,5,3,0,0,1,0,0,-1,1,1
KR_6579916424,420,1,27,-24,-6,-8,0,8,-1,4,5,3,5,2,0,3,3,0,1,1,-1,-2,-15,-3,6,3,-2,0,-1,-1,-1,-1,-1,4,1
KR_6738453333,420,2,-20,-3,3,-5,2,7,0,0,0,5,6,1,1,3,2,2,2,0,0,0,0,0,2,2,2,0,1,1,1,1,-1,4,1
KR_6761395132,420,4,49,32,3,-1,0,1,2,4,2,1,1,0,1,2,1,0,1,1,0,1,-13,-3,6,3,6,0,1,1,0,1,1,1,1
KR_6743616393,420,4,65,12,10,-1,0,1,1,1,0,3,6,3,3,3,0,4,4,0,0,14,8,6,3,9,2,0,2,1,1,1,1,5,1
KR_6613103318,420,4,66,24,3,2,5,3,-4,2,6,5,6,1,-1,2,3,1,1,0,0,-1,5,-1,7,6,3,0,0,1,-1,0,1,5,1
KR_6733619900,420,3,26,-3,13,2,3,1,5,5,0,3,3,0,3,3,0,0,0,0,0,13,17,5,1,6,2,0,1,1,1,1,1,2,1
KR_6759397181,420,0,34,-16,-3,2,2,0,1,3,2,0,3,3,-4,3,7,-2,0,2,0,-14,-12,1,4,5,0,0,-1,1,-1,-1,1,4,1
KR_6758283360,420,3,-46,14,12,2,2,0,1,2,1,5,5,0,3,3,0,1,1,0,2,13,15,-3,5,2,0,0,-1,1,-1,-1,1,3,1
KR_6668765635,420,7,154,-4,6,3,3,0,1,2,1,2,2,0,0,1,1,0,0,0,0,2,8,0,3,3,-2,0,2,1,-1,1,1,4,1
KR_6733288879,440,5,116,15,17,0,1,1,4,4,0,3,5,2,11,13,2,-1,0,1,0,23,25,5,2,7,3,0,1,-1,1,1,1,3,1
KR_6756892755,420,1,20,8,2,0,2,2,2,4,2,0,2,2,-1,5,6,1,1,0,0,-2,3,2,3,5,1,0,-1,0,-1,-1,1,0,1
KR_6700571106,420,3,45,36,8,0,1,1,-1,1,2,9,10,1,0,4,4,0,1,1,-2,1,10,3,3,6,1,0,1,1,-1,1,-1,6,1
KR_6701436763,420,0,37,25,-1,-2,0,2,7,8,1,-2,0,2,-3,2,5,-1,0,1,0,-6,-1,-1,3,2,5,0,1,1,-1,1,1,3,1
KR_6689370502,420,3,30,32,6,3,3,0,3,4,1,-3,1,4,2,8,6,1,2,1,2,8,18,2,4,6,-3,0,0,1,-1,-1,1,2,1
KR_6717194005,420,0,55,-20,1,-1,0,1,-3,0,3,-1,2,3,3,4,1,3,4,1,0,7,1,2,3,5,1,0,2,-1,0,1,-1,5,1
KR_6458180474,420,-1,0,5,3,-1,2,3,5,6,1,-1,4,5,1,1,0,-1,0,1,0,4,-186,-1,4,3,-2,0,0,-1,-1,0,1,1,1
KR_6672249784,420,-1,-10,0,-4,0,0,0,-2,4,6,0,2,2,-1,1,2,-1,0,1,0,-7,37,4,1,5,-31,0,0,-1,-1,0,-1,5,1
KR_6607673998,420,1,-56,22,-4,-3,0,3,-1,3,4,2,3,1,-2,1,3,0,2,2,0,2,13,1,5,6,2,0,0,1,1,-1,-1,2,1
KR_6762532882,420,1,22,-5,4,-2,3,5,0,4,4,-1,2,3,5,8,3,2,3,1,3,11,-4,-2,6,4,3,0,1,-1,-1,1,1,6,1
KR_6756745203,420,10,40,43,22,9,9,0,2,5,3,3,4,1,7,7,0,1,1,0,0,14,-1,0,6,6,4,0,3,1,1,1,1,5,1
KR_6692540933,420,2,63,-8,-2,2,3,1,3,6,3,1,2,1,-4,1,5,-4,2,6,-1,-1,6,2,5,7,-2,0,1,1,1,1,-1,4,1
KR_6729026502,420,-3,-66,12,-3,-4,0,4,2,4,2,5,7,2,-3,2,5,-3,0,3,-1,1,0,0,3,3,-2,0,0,0,1,0,-1,0,1
KR_6726697985,420,1,45,8,-3,1,1,0,-1,1,2,2,3,1,-2,2,4,-3,0,3,0,-3,-5,-4,11,7,5,0,1,1,-1,1,-1,2,1
KR_6707571122,420,0,-5,24,2,3,3,0,-4,1,5,2,3,1,2,3,1,-1,1,2,0,-6,312,-4,8,4,7,0,1,1,1,1,1,5,1
KR_6712781787,420,-2,-33,-47,-1,1,1,0,-1,1,2,-2,0,2,1,2,1,0,0,0,0,0,16,2,2,4,2,0,0,-1,1,0,-1,2,1
KR_6662717113,420,3,59,5,9,2,3,1,5,6,1,1,2,1,1,2,1,0,1,1,2,5,34,-1,5,4,0,0,1,1,1,1,1,4,1
KR_6763798798,420,-1,11,8,-1,2,2,0,2,2,0,-4,0,4,0,3,3,-1,2,3,0,-1,-23,-1,5,4,0,0,1,-1,1,1,-1,3,1
KR_6760458464,420,-4,5,40,-7,-1,3,4,-3,1,4,-2,1,3,-1,1,2,0,0,0,0,-6,8,-5,5,0,-1,0,-1,0,1,-1,-1,0,1
KR_6760376259,420,2,68,-2,2,1,3,2,-4,1,5,6,7,1,-4,1,5,3,3,0,-3,-8,-10,-4,5,1,-2,0,0,1,1,0,-1,6,1
KR_6697615315,420,-2,29,12,2,-4,0,4,4,4,0,0,1,1,1,4,3,1,2,1,0,8,262,-1,5,4,0,0,0,1,0,0,-1,1,1
KR_6733782366,420,2,-9,24,4,1,2,1,6,6,0,4,4,0,-4,1,5,-3,1,4,0,3,0,3,2,5,-5,0,0,1,1,0,-1,5,1
KR_6757903161,440,-2,-12,-1,-2,2,2,0,1,4,3,2,5,3,-1,4,5,-6,1,7,0,-9,-1,-2,5,3,2,0,-1,1,1,-1,-1,3,1
KR_6673431240,420,4,5,16,7,1,2,1,1,4,3,-1,2,3,3,3,0,3,3,0,0,6,2,2,1,3,-2,0,0,1,0,0,-1,6,1
KR_6632063946,420,4,84,-10,3,1,4,3,3,4,1,-1,2,3,-1,0,1,1,2,1,0,0,15,-2,5,3,-1,0,0,0,1,1,-1,0,1
KR_6757423390,420,0,25,29,1,2,2,0,-1,1,2,-1,1,2,2,5,3,-1,0,1,2,7,-7,4,3,7,-1,0,0,1,-1,0,-1,2,1
KR_6660902924,440,-1,52,6,-3,1,1,0,-1,1,2,0,1,1,-3,1,4,0,1,1,0,-1,-8,-4,7,3,0,0,-1,1,0,-1,1,4,1
KR_6760795300,440,1,68,12,0,-3,1,4,1,1,0,-1,1,2,2,2,0,1,3,2,0,-4,4,2,3,5,1,0,1,-1,1,1,-1,1,1
KR_6749127299,440,1,37,-1,1,3,4,1,2,2,0,-12,0,12,5,5,0,3,4,1,0,-3,3,-3,5,2,-3,0,0,1,-1,1,-1,4,1
KR_6741356821,420,4,31,37,12,3,5,2,3,6,3,5,6,1,1,2,1,0,1,1,0,8,-3,-1,3,2,3,0,3,1,1,1,-1,3,1
KR_6763708742,420,1,78,27,-1,7,10,3,-2,3,5,0,4,4,-8,1,9,2,2,0,1,-2,-1,1,8,9,2,0,0,1,1,1,1,3,1
KR_6728162490,420,3,1,32,8,4,5,1,2,6,4,1,2,1,0,1,1,1,2,1,0,6,-13,-1,5,4,0,0,1,0,1,1,1,0,1
KR_6689945635,420,0,48,-49,1,0,2,2,1,5,4,-2,1,3,-2,1,3,4,4,0,0,5,33,0,3,3,-3,0,0,-1,1,1,-1,6,1
KR_6625931133,420,2,25,44,5,0,1,1,0,1,1,-2,1,3,6,6,0,1,2,1,0,10,-3,-2,4,2,3,0,0,-1,1,1,1,5,1
KR_6674364925,420,4,48,36,9,5,5,0,2,2,0,2,3,1,-1,4,5,1,1,0,0,-2,-48,1,2,3,21,0,1,1,1,-1,-1,4,1
KR_6720258814,420,3,34,-5,0,5,7,2,4,6,2,-1,0,1,-6,0,6,-2,1,3,0,-8,0,-6,9,3,0,0,0,-1,1,0,1,6,1
KR_6761142960,420,0,-6,-33,2,-2,2,4,1,1,0,-1,0,1,3,4,1,1,2,1,0,6,0,3,1,4,1,0,-1,1,-1,-1,-1,1,1
KR_6747119445,420,-1,3,-36,3,-1,0,1,1,1,0,1,2,1,1,1,0,1,1,0,0,2,-4,-3,5,2,1,0,0,1,-1,0,1,1,1
KR_6703743156,420,6,15,0,11,2,2,0,1,4,3,2,6,4,6,6,0,0,1,1,-1,13,1,0,4,4,2,0,0,1,-1,0,-1,2,1
KR_6729010142,440,4,-19,-6,7,2,2,0,7,7,0,-4,0,4,0,1,1,2,2,0,0,3,-5,-2,7,5,1,0,0,-1,-1,1,1,1,1
KR_6657243705,420,2,28,-23,5,-1,2,3,1,4,3,3,4,1,-2,4,6,4,4,0,1,7,9,2,4,6,2,0,-1,1,0,-1,1,1,1
KR_6752383145,420,5,-2,32,11,1,1,0,6,6,0,1,2,1,2,2,0,1,2,1,0,14,33,1,4,5,2,0,1,1,1,1,-1,1,1
KR_6712299127,420,-1,23,21,5,-1,1,2,7,9,2,3,5,2,-5,2,7,1,2,1,0,4,2,6,3,9,0,0,0,1,1,0,-1,3,1
KR_6709083543,420,7,35,8,17,2,3,1,6,6,0,-1,1,2,9,10,1,1,2,1,1,20,-15,-3,10,7,8,0,2,1,1,1,1,1,1
KR_6750185770,440,1,61,11,2,1,3,2,0,3,3,-1,3,4,2,4,2,0,0,0,1,0,-57,-2,6,4,0,0,0,0,0,0,1,0,1
KR_6755837130,420,2,-13,-4,5,2,2,0,1,2,1,0,3,3,1,1,0,1,2,1,0,4,8,7,0,7,-1,0,3,1,1,1,-1,4,1
KR_6752240731,420,3,1,-14,12,2,2,0,4,4,0,2,5,3,4,5,1,0,1,1,0,10,20,4,2,6,1,0,1,1,-1,1,1,2,1
KR_6714256973,420,7,40,76,5,1,3,2,2,2,0,6,6,0,-4,0,4,0,2,2,1,2,-15,-2,6,4,1,0,2,1,1,1,1,5,1
KR_6654629687,420,-1,2,4,4,-6,0,6,6,6,0,1,3,2,3,3,0,0,0,0,0,8,24,2,2,4,6,0,0,1,-1,0,1,5,1
KR_6647104987,420,0,5,0,0,2,4,2,-1,2,3,0,1,1,-1,3,4,0,1,1,0,4,-5,-2,4,2,0,0,1,-1,1,1,-1,4,1
KR_6739324012,440,-3,-11,-28,-7,-1,1,2,-3,0,3,-2,0,2,3,5,2,-4,1,5,0,-2,28,4,3,7,-5,0,0,1,-1,0,1,5,1
KR_6742373975,420,2,68,5,8,3,3,0,1,4,3,3,3,0,1,3,2,0,1,1,0,8,0,2,4,6,2,0,0,1,-1,0,1,1,1
KR_6725916804,420,4,48,28,1,1,3,2,0,3,3,0,4,4,-1,2,3,1,2,1,0,-7,13,2,3,5,-2,0,0,1,-1,1,-1,3,1
KR_6737230432,420,6,-4,24,8,-1,2,3,0,3,3,2,4,2,4,4,0,3,3,0,0,10,-42,4,2,6,17,0,1,-1,1,1,1,5,1
KR_6728519635,420,0,31,0,1,1,2,1,0,1,1,0,4,4,1,1,0,-1,0,1,0,7,18,1,5,6,-1,0,0,-1,1,0,-1,6,1
KR_6714940544,420,-1,-5,-22,6,1,4,3,-1,2,3,-1,6,7,3,5,2,4,6,2,1,7,15,-2,8,6,3,0,1,-1,1,1,1,6,1
KR_6758147745,420,1,81,8,2,2,4,2,0,0,0,-1,2,3,2,5,3,-1,0,1,0,-5,-12,-3,7,4,6,0,0,1,1,0,1,6,1
KR_6530946837,420,-2,-52,4,-4,0,2,2,0,1,1,0,1,1,-2,1,3,-2,1,3,0,-7,-3,1,5,6,4,0,0,1,-1,0,1,1,1
KR_6706580305,440,-3,-48,-12,-4,-5,0,5,-3,2,5,6,8,2,-2,0,2,0,0,0,0,-1,2,3,1,4,1,0,0,1,1,1,-1,4,1
KR_6712035549,420,4,65,-24,15,2,2,0,-1,2,3,5,6,1,5,5,0,4,6,2,0,16,0,0,3,3,-2,0,0,1,-1,0,1,4,1
KR_6752798419,420,0,-1,20,-1,-2,1,3,8,8,0,-6,1,7,-3,1,4,2,2,0,1,-4,-8,-1,5,4,3,0,-1,1,-1,-1,1,6,1
KR_6681569840,420,-3,-19,17,-1,0,1,1,-1,5,6,0,1,1,-1,1,2,1,1,0,0,-2,-4,-3,5,2,0,0,-1,1,-1,-1,-1,4,1
KR_6736671224,440,-1,-31,-1,-2,-2,1,3,5,8,3,2,3,1,-7,0,7,0,1,1,0,-6,12,3,5,8,0,0,-2,-1,-1,-1,-1,6,1
KR_6716071155,420,5,66,0,15,6,7,1,1,2,1,3,3,0,5,6,1,0,0,0,0,12,-2,3,3,6,1,0,1,1,1,1,1,5,1
KR_6754259347,420,5,41,39,10,2,5,3,-1,2,3,2,4,2,5,5,0,2,3,1,0,13,-4,-3,7,4,8,0,0,1,-1,-1,1,1,1
KR_6620474670,420,5,98,20,8,6,6,0,4,6,2,3,3,0,-3,2,5,-2,0,2,0,8,30,4,1,5,2,0,1,1,1,1,-1,3,1
KR_6758521015,420,1,4,-16,7,0,2,2,-1,1,2,-4,1,5,8,9,1,4,4,0,1,11,9,7,1,8,-2,0,0,1,1,0,1,3,1
KR_6757143276,440,0,-19,16,4,-1,0,1,-5,0,5,-1,3,4,2,2,0,9,10,1,0,9,-9,3,6,9,-1,0,0,1,-1,0,-1,1,1
KR_6764790483,420,1,49,0,7,0,3,3,5,5,0,-3,0,3,2,4,2,3,3,0,0,9,-12,-4,8,4,3,0,1,0,-1,1,-1,0,1
KR_6744425055,420,-1,47,-4,2,1,2,1,2,3,1,4,5,1,0,2,2,-5,3,8,0,-2,8,2,1,3,0,0,0,1,-1,1,-1,4,1
KR_6763600334,420,3,116,-16,4,4,5,1,-1,0,1,-1,1,2,3,4,1,-1,0,1,0,3,-6,-1,3,2,2,0,0,1,0,1,1,4,1
KR_6761657701,440,-2,-78,2,-1,3,3,0,3,4,1,4,6,2,-6,0,6,-5,1,6,0,6,-8,4,2,6,-2,0,0,1,-1,-1,1,1,1
KR_6739980828,420,0,-46,-41,2,0,3,3,-3,3,6,4,6,2,5,8,3,-4,4,8,-2,-6,7,1,4,5,3,0,0,1,1,1,-1,5,1
KR_6756465303,420,6,49,48,12,4,4,0,1,3,2,2,3,1,3,7,4,2,3,1,0,8,5,-7,8,1,0,0,-1,-1,0,-1,1,2,1
KR_6663235204,440,1,110,12,-3,-4,1,5,-1,3,4,3,5,2,-1,4,5,0,1,1,0,-5,-1,0,3,3,3,0,0,0,-1,-1,1,0,1
KR_6616650061,420,1,88,4,5,2,4,2,3,5,2,3,6,3,-1,4,5,-2,0,2,0,1,4,4,2,6,-4,0,0,-1,0,0,1,1,1
KR_6728313082,420,-2,-6,32,-5,1,2,1,-1,1,2,-6,0,6,-1,4,5,2,3,1,-1,-7,5,1,7,8,-3,0,0,-1,-1,-1,-1,4,1
KR_6759100902,420,0,55,11,-5,0,3,3,0,1,1,0,1,1,-5,2,7,0,1,1,0,-17,-2,-2,5,3,4,0,1,-1,1,1,-1,2,1
KR_6672538413,420,4,50,51,11,3,3,0,3,5,2,8,8,0,-5,0,5,2,3,1,1,-3,-106,6,3,9,0,0,1,1,1,1,1,4,1
KR_6739474936,420,2,-1,8,0,-2,2,4,-3,2,5,0,4,4,4,4,0,1,1,0,0,2,5,0,6,6,-3,0,1,1,0,1,-1,2,1
KR_6763393686,420,2,3,20,7,2,2,0,3,4,1,1,2,1,-2,0,2,3,3,0,0,9,12,-4,8,4,2,0,0,1,1,1,1,1,1
KR_6733690232,420,-2,3,-16,6,2,3,1,-1,1,2,-4,0,4,2,4,2,7,7,0,0,6,-4,5,0,5,4,0,2,1,1,1,1,5,1
KR_6740328173,420,3,38,12,0,1,1,0,-2,5,7,2,4,2,0,1,1,-1,1,2,0,-3,5,-2,4,2,5,0,1,-1,1,1,1,1,1
KR_6742944088,420,2,-20,8,12,1,2,1,5,6,1,5,7,2,-1,2,3,2,2,0,3,12,6,6,1,7,-4,0,0,0,1,0,1,0,1
KR_6669282062,420,0,74,4,7,2,4,2,0,5,5,2,5,3,3,3,0,0,0,0,0,5,3,-3,7,4,-2,0,0,1,0,0,1,6,1
KR_6763234692,420,2,-41,-2,7,1,2,1,4,6,2,1,3,2,1,3,2,0,1,1,0,13,1,2,1,3,2,0,-1,1,-1,-1,-1,4,1
KR_6758426110,440,4,29,-9,4,-4,0,4,4,5,1,9,9,0,-7,3,10,2,2,0,0,-2,-4,1,4,5,2,0,3,1,-1,1,1,6,1
KR_6638099479,420,4,15,24,11,1,1,0,5,8,3,0,1,1,2,4,2,3,6,3,0,11,202,3,4,7,-2,0,0,1,1,0,1,5,1
KR_6758082786,440,-2,56,-14,-8,-11,2,13,-1,1,2,4,4,0,1,3,2,-1,0,1,-1,-4,44,5,1,6,1,0,2,1,1,1,-1,6,1
KR_6701996819,420,2,10,1,3,1,2,1,0,3,3,5,5,0,-2,2,4,-1,2,3,0,1,-3,-2,6,4,1,0,2,1,-1,1,-1,1,1
KR_6728052381,440,0,49,32,0,1,2,1,3,4,1,2,4,2,0,5,5,-6,0,6,0,-3,-7,-2,6,4,-3,0,1,-1,1,1,-1,3,1
KR_6763027250,420,-1,13,17,-3,3,5,2,-3,4,7,-5,2,7,-2,2,4,4,4,0,0,-10,4,1,3,4,3,0,0,1,1,1,-1,2,1
KR_6651783032,420,2,39,-4,4,0,2,2,2,5,3,2,5,3,0,4,4,0,1,1,-1,2,-26,-3,3,0,4,0,0,-1,-1,0,-1,1,1
KR_6763583262,420,3,57,8,6,2,3,1,3,4,1,3,4,1,4,8,4,-6,1,7,-1,0,7,4,1,5,1,0,-3,1,0,-1,-1,1,1
KR_6743559695,420,-1,31,4,3,-1,1,2,1,4,3,-3,0,3,5,5,0,1,2,1,0,7,-9,1,3,4,1,0,0,1,-1,-1,1,4,1
KR_6699011105,420,4,39,39,4,1,1,0,-3,1,4,2,3,1,2,2,0,2,2,0,0,4,0,2,0,2,1,0,0,1,-1,1,-1,4,1
KR_6643252911,420,3,20,-20,13,1,3,2,1,2,1,-4,0,4,12,12,0,3,4,1,0,14,-6,-2,7,5,0,0,1,-1,-1,1,1,2,1
KR_6708997439,420,3,-15,19,4,-5,2,7,3,7,4,0,0,0,6,8,2,0,0,0,0,5,70,-1,7,6,-1,0,0,1,-1,-1,-1,5,1
KR_6574277847,420,5,41,-8,10,0,1,1,5,6,1,4,5,1,1,2,1,0,0,0,0,13,-46,0,7,7,18,0,1,1,1,1,1,4,1
KR_6742706993,420,0,-51,0,-1,-2,0,2,4,6,2,2,3,1,-3,1,4,-2,0,2,0,-2,-47,2,2,4,11,0,0,0,1,1,-1,0,1
KR_6707334760,420,-3,-18,12,-5,-4,0,4,2,3,1,-1,4,5,-4,4,8,2,3,1,0,-3,5,4,0,4,-2,0,0,1,1,1,1,4,1
KR_6738315105,420,4,72,-18,10,4,4,0,-2,2,4,4,4,0,1,3,2,3,5,2,0,1,-44,2,4,6,33,0,-1,-1,-1,-1,1,3,1
KR_6762957788,420,-4,-22,-36,-9,0,1,1,-3,2,5,-5,0,5,0,2,2,-1,0,1,0,-3,10,-2,3,1,2,0,-1,-1,-1,-1,-1,6,1
KR_6678642255,420,0,-8,24,5,-1,2,3,2,3,1,4,5,1,0,2,2,0,0,0,0,4,28,3,3,6,-5,0,1,1,-1,1,-1,6,1
KR_6612229611,420,3,81,3,7,5,5,0,0,3,3,1,4,3,2,3,1,-1,0,1,1,1,12,3,2,5,1,0,2,1,1,1,1,6,1
KR_6763227363,440,4,26,20,2,2,2,0,-1,1,2,0,2,2,0,0,0,1,3,2,0,-1,2,0,7,7,-1,0,0,-1,1,1,1,4,1
KR_6697583617,420,0,60,11,-5,1,2,1,-1,1,2,-1,0,1,-6,5,11,2,2,0,0,-9,24,0,8,8,2,0,0,1,0,-1,1,2,1
KR_6648452920,420,4,98,16,13,3,3,0,6,9,3,3,3,0,1,2,1,0,0,0,0,7,2,3,4,7,-1,0,3,1,1,1,1,6,1
KR_6756040868,420,6,79,24,16,6,8,2,2,4,2,4,6,2,3,3,0,1,2,1,2,15,9,9,4,13,1,0,2,1,0,1,1,1,1
KR_6758132496,420,0,19,16,3,1,2,1,2,3,1,2,2,0,-2,2,4,0,1,1,0,6,-9,-1,5,4,0,0,0,1,1,1,1,5,1
KR_6657530283,420,2,6,32,-4,0,2,2,1,6,5,-1,1,2,-1,2,3,-3,1,4,-1,-8,5,-8,9,1,4,0,1,1,-1,-1,-1,5,1
KR_6722816065,440,6,45,20,8,1,1,0,7,7,0,0,1,1,1,9,8,-1,3,4,-2,4,6,0,6,6,0,0,1,1,-1,1,1,3,1
KR_6753468515,420,1,-14,4,-1,1,3,2,3,4,1,-6,0,6,-1,1,2,2,3,1,-1,-5,-2,2,4,6,-4,0,-1,1,-1,-1,-1,3,1
KR_6611762686,420,1,104,-23,5,1,4,3,3,5,2,-2,2,4,0,1,1,3,3,0,0,7,-177,0,4,4,-3,0,1,1,-1,1,-1,1,1
KR_6738851980,420,1,-49,9,0,0,3,3,1,1,0,-4,0,4,0,4,4,3,3,0,0,-1,-11,5,4,9,-8,0,-1,0,-1,-1,-1,0,1
KR_6745222844,420,4,42,20,7,1,1,0,2,3,1,3,4,1,2,4,2,-1,0,1,0,10,71,2,4,6,1,0,0,0,1,0,1,0,1
KR_6753735950,440,-1,71,-8,-2,-1,2,3,-1,1,2,-4,2,6,1,4,3,3,4,1,0,0,-4,0,3,3,4,0,1,1,0,1,1,1,1
KR_6731528442,420,1,23,16,7,2,3,1,1,2,1,-4,0,4,5,6,1,3,3,0,0,6,-33,-1,2,1,20,0,0,1,0,0,1,3,1
KR_6633892714,420,0,34,-8,0,-1,0,1,3,5,2,3,3,0,-5,1,6,0,1,1,0,0,-9,2,5,7,2,0,0,-1,1,0,-1,3,1
KR_6581995653,420,2,-30,64,6,1,2,1,2,2,0,2,2,0,1,2,1,0,0,0,0,5,-152,1,0,1,4,0,0,0,1,0,-1,0,1
KR_6564067201,420,-1,-59,-2,1,0,3,3,-4,0,4,5,5,0,0,3,3,0,0,0,-1,11,-10,-4,9,5,5,0,-1,1,1,-1,-1,1,1
KR_6673324990,420,-1,-2,15,-5,0,2,2,3,3,0,1,3,2,-9,0,9,0,1,1,-1,-8,-6,-2,6,4,5,0,-1,-1,1,-1,-1,1,1
KR_6752774287,440,6,22,31,18,5,6,1,1,4,3,0,3,3,7,7,0,5,5,0,1,17,-5,6,3,9,2,0,1,0,-1,1,1,0,1
KR_6736598144,420,6,51,66,8,-2,0,2,6,7,1,4,6,2,1,1,0,-1,0,1,0,10,-2,2,1,3,2,0,2,1,1,1,1,6,1
KR_6763238937,420,2,14,0,0,-3,0,3,2,4,2,2,5,3,3,3,0,-4,0,4,0,4,6,-2,7,5,-1,0,0,1,-1,-1,-1,4,1
KR_6760801968,420,6,-5,111,9,1,3,2,5,5,0,-1,1,2,2,3,1,2,4,2,2,15,1,2,2,4,3,0,2,1,1,1,1,4,1
KR_6760457722,420,4,62,8,5,5,7,2,0,1,1,-1,5,6,1,5,4,0,0,0,1,8,1,-8,9,1,4,0,0,1,1,0,1,2,1
KR_6755127718,420,-3,-14,-23,-4,-1,1,2,-4,0,4,-1,5,6,3,6,3,-1,1,2,0,-8,-9,-2,6,4,1,0,1,-1,1,1,1,5,1
KR_6702716716,420,-2,-23,8,-2,0,2,2,3,5,2,-5,2,7,0,2,2,0,0,0,0,-3,0,4,4,8,-3,0,0,1,-1,0,1,2,1
KR_6729244078,420,0,-72,-7,0,-2,0,2,0,5,5,-1,3,4,3,3,0,0,1,1,0,10,8,3,0,3,-1,0,-1,-1,0,-1,1,2,1
KR_6670498796,420,-1,12,-16,5,5,6,1,-1,2,3,-1,1,2,0,4,4,2,3,1,0,2,-4,1,3,4,-1,0,1,0,-1,1,1,0,1
KR_6739824575,420,3,33,28,7,-2,1,3,4,4,0,-3,2,5,7,8,1,1,3,2,0,9,3,2,4,6,1,0,1,1,1,1,-1,4,1
KR_6711900768,420,-1,12,-40,-4,3,3,0,2,3,1,-5,4,9,-4,3,7,0,1,1,0,-2,240,-5,5,0,3,0,-1,-1,-1,-1,-1,2,1
KR_6700082974,420,1,-12,-1,2,1,1,0,1,4,3,0,2,2,0,3,3,0,1,1,0,0,3,3,7,10,-5,0,1,1,1,1,-1,6,1
KR_6752536329,440,-1,51,-23,6,2,3,1,1,1,0,3,3,0,0,0,0,0,1,1,0,7,15,3,3,6,1,0,0,-1,1,0,1,2,1
KR_6744033052,420,2,95,18,9,3,3,0,1,2,1,0,0,0,1,2,1,4,4,0,0,8,3,0,5,5,-3,0,0,1,1,0,1,1,1
KR_6648382153,420,3,81,11,8,1,1,0,6,7,1,-2,3,5,2,4,2,1,1,0,0,8,-4,0,5,5,-1,0,1,1,1,1,1,3,1
KR_6720529482,440,-1,95,5,2,1,2,1,3,7,4,1,2,1,-1,1,2,-2,0,2,0,0,24,-1,3,2,5,0,0,0,0,1,1,0,1
KR_6744592210,420,2,42,16,-3,-3,0,3,-2,4,6,-1,0,1,2,4,2,1,2,1,0,1,-7,-3,9,6,-4,0,1,1,-1,1,-1,1,1
KR_6725559778,420,1,30,-9,2,2,3,1,-3,2,5,-2,0,2,4,4,0,1,2,1,1,1,-5,2,2,4,1,0,1,1,0,1,1,4,1
KR_6762722134,420,3,75,-8,12,3,3,0,-2,2,4,6,6,0,4,4,0,1,2,1,0,12,10,2,3,5,-3,0,2,1,0,1,-1,1,1
KR_6700247694,420,-1,-49,-6,-2,0,1,1,1,3,2,-4,0,4,1,4,3,0,0,0,0,0,-17,0,4,4,5,0,0,-1,-1,0,-1,4,1
KR_6680317078,440,3,-66,16,6,1,3,2,4,5,1,0,2,2,0,1,1,1,2,1,1,9,8,2,3,5,0,0,1,-1,1,1,1,1,1
KR_6741743127,440,1,52,25,7,2,3,1,1,3,2,-1,2,3,2,4,2,3,3,0,1,6,33,-4,8,4,4,0,1,1,-1,1,1,2,1
KR_6752496371,420,3,-19,20,3,2,2,0,2,4,2,1,3,2,-2,0,2,0,0,0,0,0,-307,-1,3,2,3,0,0,1,1,1,-1,1,1
KR_6741553966,440,2,12,12,6,2,3,1,2,2,0,0,4,4,-2,1,3,4,5,1,0,12,1,-1,5,4,1,0,1,1,-1,1,-1,1,1
KR_6764106722,420,5,45,41,10,-2,1,3,1,3,2,2,7,5,7,8,1,2,3,1,-1,14,-4,-1,3,2,-1,0,1,1,1,1,-1,6,1
KR_6643183852,420,2,-58,7,0,-3,0,3,2,4,2,2,5,3,-2,0,2,1,2,1,0,0,0,0,3,3,0,0,0,1,-1,0,-1,3,1
KR_6616783614,420,2,68,-19,3,0,1,1,-2,0,2,3,4,1,1,2,1,1,1,0,0,-1,10,1,2,3,-1,0,1,1,1,1,1,4,1
KR_6720867123,420,5,-14,73,16,1,1,0,9,9,0,2,2,0,3,5,2,1,1,0,1,17,-39,-3,5,2,19,0,1,1,1,1,-1,6,1
KR_6729028408,440,7,114,57,17,4,5,1,4,4,0,2,3,1,7,11,4,0,1,1,0,17,5,6,2,8,-1,0,3,1,1,1,1,3,1
KR_6635023756,420,5,48,59,13,4,4,0,2,5,3,4,6,2,2,4,2,1,2,1,0,0,-7,-6,8,2,4,0,-1,1,1,1,1,5,1
KR_6760459902,420,-1,-6,0,2,-2,1,3,1,4,3,0,3,3,5,5,0,-2,0,2,0,7,-5,2,3,5,1,0,2,-1,1,1,1,1,1
KR_6761043603,420,2,-19,6,3,0,1,1,3,3,0,2,3,1,-1,2,3,-1,0,1,0,-2,3,1,3,4,-1,0,1,1,-1,1,-1,5,1
KR_6764493261,420,-1,28,-15,-5,-1,0,1,-2,4,6,1,3,2,-4,2,6,1,1,0,2,-8,142,-2,9,7,0,0,1,-1,-1,1,1,6,1
KR_6752127287,420,0,-26,4,4,1,2,1,0,3,3,1,6,5,2,3,1,0,0,0,0,2,4,4,4,8,-3,0,0,1,-1,0,-1,3,1
KR_6670418441,420,2,28,-23,4,-2,1,3,3,3,0,-2,1,3,4,7,3,1,2,1,0,6,7,-1,5,4,0,0,1,1,-1,1,-1,4,1
KR_6763610210,420,4,29,16,6,2,2,0,6,6,0,5,5,0,-7,3,10,0,1,1,0,8,-6,-2,3,1,4,0,1,-1,1,1,1,2,1
KR_6764226853,420,4,51,16,9,-1,0,1,-1,1,2,4,4,0,6,7,1,1,1,0,0,8,-2,0,4,4,0,0,0,1,-1,0,1,5,1
KR_6731579569,420,4,24,8,6,-3,1,4,1,1,0,-1,2,3,9,10,1,0,0,0,0,13,12,2,3,5,-1,0,4,1,1,1,-1,6,1
KR_6742284406,420,6,78,52,20,1,4,3,2,3,1,8,8,0,8,9,1,1,1,0,1,14,1,-2,4,2,2,0,1,1,1,1,1,5,1
KR_6676996157,420,3,77,13,9,0,1,1,3,4,1,0,2,2,4,4,0,2,3,1,0,13,6,4,2,6,2,0,0,1,-1,0,1,4,1
KR_6760821476,440,-2,-79,8,-6,-1,0,1,0,0,0,1,2,1,-5,1,6,-1,0,1,0,-4,2,-2,6,4,-2,0,0,0,1,0,-1,0,1
KR_6466727611,420,2,47,8,12,3,3,0,0,2,2,2,2,0,3,4,1,4,6,2,1,12,0,-1,6,5,3,0,1,1,1,1,1,1,1
KR_6760341092,420,4,27,10,12,2,3,1,4,5,1,1,1,0,6,9,3,-1,3,4,0,7,7,4,1,5,1,0,0,1,1,1,1,2,1
KR_6594185416,420,0,40,1,4,0,2,2,0,0,0,4,7,3,-1,2,3,1,1,0,0,8,1,7,2,9,0,0,-1,1,0,1,-1,5,1
KR_6010175656,420,1,6,-13,3,3,3,0,0,2,2,1,3,2,-2,2,4,1,2,1,1,1,33,3,10,13,-10,0,1,1,1,1,1,1,1
KR_6749154332,420,3,30,11,0,1,1,0,0,2,2,-2,1,3,-1,3,4,2,2,0,0,-8,10,0,4,4,-1,0,0,1,-1,-1,-1,2,1
KR_6641189581,420,0,-15,0,7,-4,0,4,0,0,0,3,4,1,7,8,1,1,2,1,0,10,-24,0,7,7,0,0,-1,1,-1,-1,1,5,1
KR_6763008612,420,0,-26,3,4,-1,1,2,3,6,3,2,3,1,0,1,1,0,0,0,0,8,-2,0,5,5,6,0,0,-1,1,0,-1,4,1
KR_6681932411,420,2,-2,8,6,0,1,1,6,6,0,2,4,2,-5,3,8,3,6,3,-1,11,37,1,4,5,-27,0,1,-1,1,1,-1,1,1
KR_6625109869,420,7,80,8,17,5,5,0,1,3,2,3,5,2,6,6,0,2,3,1,0,15,-25,-1,5,4,1,0,1,1,1,1,1,1,1
KR_6763567942,420,1,4,1,0,-1,2,3,2,2,0,-2,3,5,0,4,4,1,3,2,0,12,4,4,3,7,2,0,0,-1,1,0,1,3,1
KR_6692170898,420,3,-15,13,1,3,4,1,4,4,0,0,3,3,-3,2,5,-3,0,3,0,0,-2,-3,6,3,0,0,0,0,1,1,1,0,1
KR_6679386600,420,-4,-40,3,-2,0,1,1,-4,1,5,3,4,1,1,3,2,-2,0,2,0,-2,3,2,3,5,-5,0,-1,0,0,-1,1,0,1
KR_6750030098,420,1,2,0,-2,-6,1,7,-1,0,1,0,4,4,4,6,2,1,1,0,0,6,19,-2,5,3,0,0,-1,-1,-1,-1,-1,2,1
KR_6741032926,420,4,38,35,8,4,4,0,0,2,2,9,9,0,-3,2,5,-2,1,3,0,0,-15,-1,4,3,3,0,2,1,-1,1,1,2,1
KR_6756971415,420,-1,-28,-8,-10,-2,1,3,-3,1,4,-2,1,3,-4,0,4,1,1,0,0,-12,152,0,4,4,-2,0,0,-1,-1,-1,-1,1,1
KR_6764495663,440,5,40,23,7,0,5,5,1,2,1,2,4,2,2,2,0,2,2,0,0,6,9,-2,8,6,3,0,0,-1,1,1,-1,6,1
KR_6741750248,420,2,60,3,4,2,3,1,1,2,1,4,4,0,-2,1,3,-1,0,1,0,2,11,2,4,6,0,0,-2,-1,1,1,1,1,1
KR_6458235494,420,-2,-22,-28,-4,-4,0,4,-4,2,6,1,2,1,-1,0,1,4,4,0,0,2,-4,5,3,8,3,0,0,1,1,0,1,6,1
KR_6762573794,420,-1,68,13,1,1,4,3,-1,1,2,-1,2,3,5,10,5,-3,0,3,2,2,2,1,4,5,0,0,0,1,1,1,-1,3,1
KR_6754044030,420,0,43,6,1,2,3,1,-1,1,2,2,5,3,2,3,1,-4,0,4,0,5,-12,-3,4,1,3,0,1,-1,-1,1,1,5,1
KR_6624773638,420,4,98,24,5,1,1,0,0,2,2,4,4,0,-1,0,1,1,1,0,0,2,-10,0,3,3,2,0,1,-1,1,1,1,4,1
KR_6759493898,420,0,-13,-4,1,1,2,1,3,4,1,-2,1,3,1,1,0,-2,0,2,0,-1,-102,2,5,7,0,0,-1,1,-1,-1,-1,6,1
KR_6653913630,420,2,16,-3,5,5,7,2,-3,5,8,0,2,2,4,7,3,-1,2,3,0,4,265,-8,9,1,7,0,1,1,1,1,1,3,1
KR_6697124609,420,2,56,-8,7,0,1,1,-1,1,2,3,5,2,2,4,2,3,3,0,0,8,4,3,3,6,-5,0,2,1,0,1,1,2,1
KR_6761685283,420,2,-23,18,1,3,4,1,-4,2,6,2,2,0,0,3,3,0,1,1,-2,5,-34,-2,6,4,28,0,1,1,-1,1,-1,6,1
KR_6750097705,420,-2,-10,-23,0,3,5,2,-1,4,5,-3,1,4,0,4,4,1,2,1,0,8,-2,-2,4,2,4,0,0,1,-1,0,-1,5,1
KR_6601561367,420,3,-50,11,3,-1,1,2,-4,2,6,9,9,0,-3,3,6,2,2,0,0,6,1,-2,4,2,-3,0,0,1,-1,-1,1,2,1
KR_6763597855,440,1,31,-16,-1,-2,0,2,0,2,2,1,2,1,4,4,0,-4,0,4,0,-3,63,0,3,3,6,0,1,1,1,1,-1,3,1
KR_6759598682,440,-3,15,3,-5,-3,1,4,0,3,3,1,4,3,-3,1,4,0,0,0,0,-8,1,4,1,5,-2,0,-2,1,-1,-1,1,6,1
KR_6728301696,420,0,29,9,-4,-2,1,3,-3,1,4,-1,3,4,-1,4,5,3,3,0,0,-2,2,1,6,7,-3,0,-1,1,-1,-1,-1,3,1
KR_6742925706,420,3,7,4,7,1,2,1,4,7,3,3,4,1,0,2,2,-1,0,1,0,3,6,2,5,7,1,0,0,0,0,0,-1,0,1
KR_6764067024,420,3,18,16,4,0,3,3,-1,1,2,-2,2,4,4,7,3,3,3,0,0,-1,-4,-4,9,5,0,0,0,1,-1,1,1,4,1
KR_6742952362,420,0,18,-22,9,-2,3,5,4,4,0,4,5,1,4,4,0,-1,0,1,0,9,2,0,4,4,5,0,-1,1,-1,-1,1,5,1
KR_6753208830,420,5,28,0,8,2,3,1,1,2,1,-4,0,4,8,8,0,1,3,2,0,15,17,1,5,6,5,0,1,-1,-1,1,1,4,1
KR_6738044521,420,2,53,14,11,9,9,0,1,4,3,3,5,2,0,3,3,-2,0,2,-1,5,35,3,5,8,2,0,0,0,1,1,-1,0,1
KR_6593929184,420,1,87,-13,4,-4,0,4,3,3,0,1,1,0,4,7,3,0,2,2,1,6,-7,1,4,5,4,0,-1,1,-1,1,1,6,1
KR_6751118254,440,5,76,-19,7,3,4,1,0,4,4,2,3,1,5,7,2,-3,5,8,0,-1,-1,-2,4,2,2,0,3,0,0,1,1,0,1
KR_6748108130,420,4,63,3,4,1,5,4,0,2,2,3,3,0,2,3,1,-2,1,3,2,7,5,2,6,8,1,0,2,-1,1,1,1,6,1
KR_6763588635,420,0,-14,8,-1,0,1,1,2,2,0,-1,2,3,-1,1,2,-1,0,1,0,1,7,-2,3,1,0,0,0,-1,1,0,-1,1,1
KR_6741660610,420,-3,-97,0,-1,-1,2,3,2,4,2,-3,2,5,1,1,0,0,0,0,0,6,15,-1,6,5,-1,0,-1,-1,1,-1,1,4,1
KR_6731730876,420,3,60,24,1,-3,1,4,3,4,1,3,4,1,-2,2,4,0,1,1,-1,-4,-23,-1,3,2,1,0,1,1,1,1,-1,1,1
KR_6549284451,420,0,19,4,-3,3,4,1,1,3,2,2,3,1,-7,2,9,-2,2,4,2,-4,-16,4,3,7,-5,0,-3,1,1,-1,1,3,1
KR_6763598181,420,2,34,29,10,-1,1,2,4,5,1,2,2,0,5,5,0,0,1,1,1,14,-1,5,2,7,1,0,1,1,1,1,1,1,1
KR_6714992319,420,3,-29,44,7,-1,2,3,2,4,2,6,7,1,-1,3,4,1,1,0,1,3,8,3,4,7,-4,0,1,1,1,1,1,3,1
KR_6703816151,420,1,-12,-13,7,-1,0,1,1,3,2,-1,0,1,6,9,3,2,5,3,1,15,0,0,6,6,0,0,0,1,-1,-1,1,5,1
KR_6586778783,420,-2,65,-15,6,0,2,2,-1,1,2,1,2,1,1,2,1,5,7,2,0,6,-30,3,1,4,4,0,2,1,1,1,1,4,1
KR_6749985500,420,3,31,21,9,3,5,2,4,5,1,3,6,3,-1,1,2,0,1,1,0,9,18,2,1,3,-4,0,1,1,0,1,1,4,1
KR_6756131136,420,1,-16,-9,1,2,2,0,3,3,0,-1,3,4,0,0,0,-3,0,3,0,1,12,1,4,5,-3,0,0,-1,-1,0,1,5,1
KR_6740929587,420,-3,-18,10,0,-1,1,2,-1,2,3,5,6,1,-2,3,5,-1,0,1,0,3,-4,2,3,5,-2,0,1,1,1,1,1,2,1
KR_6763513425,420,5,45,21,-1,0,1,1,1,3,2,-1,2,3,-4,2,6,3,4,1,-1,-9,-1,-2,7,5,4,0,1,0,0,1,-1,0,1
KR_6710774303,420,1,115,-7,4,0,2,2,-1,1,2,3,4,1,0,0,0,2,2,0,0,7,-8,3,3,6,1,0,1,-1,-1,1,1,4,1
KR_6744383455,420,8,101,28,15,0,0,0,2,3,1,10,10,0,2,3,1,1,2,1,0,14,354,-4,6,2,-23,0,2,1,1,1,1,4,1
KR_6762368992,420,-1,55,22,-7,-6,2,8,1,1,0,3,3,0,-3,4,7,-2,0,2,0,-4,1,-1,6,5,-1,0,0,-1,-1,-1,1,6,1
KR_6688085877,420,5,19,16,8,-2,1,3,3,5,2,0,1,1,0,1,1,7,7,0,0,14,4,1,6,7,7,0,0,1,-1,0,-1,6,1
KR_6647466360,420,1,-101,22,3,1,2,1,3,6,3,0,2,2,-4,4,8,3,4,1,-1,1,4,-2,7,5,-4,0,-1,1,1,-1,-1,3,1
KR_6762791673,420,2,37,21,5,-5,1,6,4,4,0,0,2,2,6,6,0,0,0,0,0,13,29,2,2,4,0,0,2,1,1,1,1,2,1
KR_6626247838,420,5,112,8,8,2,3,1,2,3,1,6,6,0,-1,1,2,-1,1,2,0,4,10,1,2,3,1,0,1,1,-1,1,-1,2,1
KR_6759579859,420,-3,14,-28,-5,-2,0,2,1,3,2,-3,0,3,-2,4,6,1,2,1,0,-9,-10,-3,6,3,3,0,0,-1,1,0,1,2,1
KR_6698918508,420,2,-19,-21,8,2,2,0,2,2,0,-2,2,4,5,6,1,1,1,0,0,15,121,2,3,5,-2,0,2,0,1,1,1,0,1
KR_6660067573,420,4,40,17,5,3,5,2,2,2,0,-1,3,4,0,0,0,1,1,0,0,3,-8,-2,5,3,3,0,1,1,1,1,-1,4,1
KR_6735146709,440,3,25,-4,14,-3,0,3,5,6,1,1,5,4,10,12,2,1,4,3,0,15,152,-2,3,1,2,0,1,0,1,1,-1,0,1
KR_6751475909,440,0,-22,-1,2,0,3,3,1,2,1,-1,1,2,3,3,0,-1,0,1,0,7,38,-3,7,4,-18,0,0,-1,0,0,1,4,1
KR_6740694769,420,-2,58,-1,-5,2,2,0,-2,2,4,0,3,3,-5,1,6,0,0,0,0,-4,390,0,3,3,2,0,0,1,-1,0,-1,4,1
KR_6705861037,420,2,54,-20,1,5,7,2,-2,5,7,-1,1,2,-2,1,3,1,1,0,0,-2,323,0,3,3,1,0,2,-1,1,1,1,6,1
KR_6760347953,420,0,15,-20,6,2,2,0,-2,1,3,-2,1,3,8,10,2,0,1,1,1,11,-14,1,5,6,1,0,-1,1,-1,-1,1,6,1
KR_6754028132,440,5,-17,18,8,2,2,0,5,6,1,-2,0,2,4,4,0,-1,0,1,0,9,-44,-4,8,4,20,0,0,1,1,0,1,2,1
KR_6707451948,440,-3,-16,-20,-1,2,2,0,0,1,1,-2,2,4,0,1,1,-1,0,1,0,2,-12,0,4,4,4,0,0,-1,-1,0,1,4,1
KR_6736542882,440,-3,9,-20,-6,-3,2,5,-4,2,6,0,1,1,-1,2,3,2,2,0,0,-4,6,-2,4,2,3,0,0,1,-1,0,-1,2,1
KR_6740255661,440,1,15,12,5,2,4,2,3,4,1,0,3,3,0,2,2,0,1,1,0,4,-34,1,5,6,31,0,1,1,-1,1,1,1,1
KR_6708422245,420,0,82,-4,1,-3,0,3,3,5,2,0,1,1,1,3,2,0,0,0,0,6,0,-1,5,4,-2,0,0,-1,-1,0,1,1,1
KR_6764707970,420,-1,18,4,-1,-1,2,3,-1,2,3,-3,0,3,7,8,1,-3,0,3,0,2,7,3,6,9,-4,0,0,1,1,1,1,6,1
KR_6726947349,440,1,-57,4,2,-2,0,2,0,0,0,-2,2,4,1,3,2,5,6,1,0,10,-17,-5,9,4,2,0,-1,1,-1,-1,-1,4,1
KR_6698551985,420,1,78,15,5,1,4,3,-1,2,3,1,1,0,3,4,1,1,1,0,1,6,4,2,3,5,-2,0,0,0,1,0,1,0,1
KR_6716196046,420,3,-53,37,5,2,2,0,3,3,0,-1,1,2,0,2,2,1,2,1,0,7,-7,-4,7,3,0,0,-1,1,-1,-1,-1,2,1
KR_6763752607,420,3,162,1,9,2,2,0,0,2,2,4,4,0,-2,2,4,5,6,1,0,3,-3,7,2,9,0,0,2,1,-1,1,1,4,1
KR_6750487710,420,0,-13,-12,2,-2,0,2,2,3,1,1,3,2,2,5,3,-1,2,3,0,5,7,-4,7,3,1,0,-1,1,-1,-1,-1,5,1
KR_6643126462,420,-2,-47,8,-4,-4,0,4,2,3,1,-1,0,1,-1,3,4,0,0,0,-1,-4,-13,0,4,4,2,0,-1,-1,-1,-1,-1,5,1
KR_6658779630,420,2,-6,-1,7,0,1,1,1,3,2,2,5,3,9,12,3,-5,0,5,0,4,48,2,5,7,-3,0,2,1,-1,1,1,6,1
KR_6731383694,420,-4,12,-5,-7,2,3,1,-3,3,6,0,3,3,-3,1,4,-3,0,3,0,-10,-1,3,2,5,-1,0,-1,0,-1,-1,-1,0,1
KR_6756445268,420,-2,-57,-24,-3,-1,2,3,-1,1,2,3,3,0,-4,4,8,0,4,4,0,-4,-4,-4,7,3,0,0,-1,-1,1,-1,-1,5,1
KR_6688488334,420,3,48,-24,8,3,3,0,-2,1,3,2,2,0,5,5,0,0,1,1,0,6,-6,0,7,7,8,0,1,-1,1,1,1,6,1
KR_6761559799,440,1,24,28,4,-1,2,3,4,4,0,-1,1,2,2,5,3,0,1,1,1,11,2,0,4,4,-1,0,0,1,0,-1,1,5,1
KR_6761007358,420,3,49,20,6,1,4,3,4,5,1,-2,1,3,3,3,0,0,1,1,0,11,-109,0,4,4,2,0,1,0,0,1,-1,0,1
KR_6730031971,420,1,49,-23,1,0,0,0,4,6,2,-1,3,4,-1,2,3,-1,0,1,0,2,-4,2,6,8,2,0,-1,1,-1,-1,-1,2,1
KR_6708899399,420,1,17,10,4,-2,1,3,1,6,5,1,2,1,3,4,1,1,1,0,-1,2,-2,5,4,9,0,0,1,-1,1,1,-1,1,1
KR_6628479467,420,-1,-48,16,5,-1,0,1,-1,0,1,2,4,2,1,1,0,4,4,0,0,7,-6,-1,5,4,-4,0,0,1,1,0,1,3,1
KR_6752963833,420,2,-28,21,3,3,4,1,-1,2,3,1,3,2,-3,1,4,3,3,0,-1,-5,7,-5,9,4,0,0,0,1,0,0,-1,5,1
KR_6732404504,440,4,-28,24,1,4,4,0,1,2,1,0,1,1,-3,0,3,-1,1,2,0,2,13,-2,5,3,1,0,1,0,1,1,-1,0,1
KR_6729157637,420,1,8,1,0,0,3,3,-3,0,3,-1,0,1,0,1,1,4,4,0,-1,-3,4,1,2,3,-3,0,0,-1,1,0,-1,6,1
KR_6644212322,420,1,-10,44,1,-4,1,5,7,10,3,2,2,0,-4,0,4,0,0,0,0,-4,-1,1,6,7,0,0,2,-1,1,-1,-1,3,1
KR_6762998465,420,3,-2,28,4,-3,2,5,4,4,0,-3,1,4,5,6,1,1,2,1,-1,0,-10,-1,3,2,-3,0,0,1,0,0,-1,4,1
KR_6714590217,420,2,19,12,6,0,3,3,3,3,0,1,2,1,2,3,1,0,0,0,0,9,-4,1,5,6,-2,0,1,-1,1,1,1,1,1
KR_6716183843,440,1,4,4,1,4,4,0,-3,2,5,1,1,0,4,8,4,-5,1,6,0,5,11,-4,6,2,2,0,0,-1,0,0,-1,2,1
KR_6736043381,420,0,-14,33,2,-1,2,3,3,5,2,-2,2,4,0,1,1,2,2,0,0,4,1,3,2,5,-1,0,2,1,1,1,1,2,1
KR_6001085816,420,2,5,24,2,2,3,1,-2,0,2,3,3,0,-3,1,4,2,3,1,0,-4,-3,-5,8,3,0,0,0,1,-1,0,1,4,1
KR_6660232578,420,1,-13,-14,-1,2,3,1,-1,3,4,-2,1,3,0,0,0,0,0,0,0,-4,-7,-3,6,3,-4,0,-1,-1,-1,-1,-1,1,1
KR_6759783003,420,5,-2,-7,9,1,1,0,4,6,2,3,5,2,3,4,1,-2,0,2,0,13,-358,0,3,3,0,0,0,1,-1,0,1,2,1
KR_6722428400,420,-3,-22,7,-7,-5,0,5,-1,1,2,3,4,1,-2,0,2,-2,0,2,0,-5,4,-1,6,5,0,0,0,1,-1,1,-1,2,1
KR_6733871163,440,1,16,-20,2,0,1,1,2,4,2,1,2,1,-3,1,4,2,3,1,1,4,363,4,0,4,-1,0,0,-1,0,1,1,3,1
KR_6624763175,420,3,-48,0,4,-4,1,5,2,5,3,0,2,2,7,8,1,-1,0,1,-1,7,-7,2,6,8,-2,0,-2,1,-1,-1,-1,4,1
KR_6762572445,440,2,-7,13,6,6,7,1,-4,1,5,2,3,1,3,4,1,-1,0,1,0,2,6,5,4,9,-4,0,1,1,1,1,1,6,1
KR_6740499412,420,-1,-21,20,-3,-1,3,4,-2,0,2,2,4,2,-2,1,3,0,3,3,0,-6,37,2,3,5,2,0,1,-1,1,1,-1,5,1
KR_6633121364,420,-1,-41,-44,-4,0,1,1,3,5,2,0,2,2,-6,1,7,-1,0,1,0,-4,-28,-1,4,3,-1,0,0,-1,1,0,-1,2,1
KR_6757667951,420,-5,31,-96,-11,-5,0,5,-6,1,7,-1,3,4,3,4,1,-2,0,2,-1,-10,218,-7,9,2,0,0,-1,-1,-1,-1,-1,1,1
KR_6619089119,420,-1,6,4,1,-5,1,6,0,1,1,7,10,3,1,3,2,-2,0,2,-1,12,13,-3,6,3,4,0,-1,-1,-1,-1,-1,5,1
KR_6714323034,420,1,-16,-21,0,1,3,2,0,2,2,-2,0,2,1,2,1,0,0,0,0,3,19,0,5,5,0,0,1,-1,1,1,-1,2,1
KR_6665785464,420,5,94,25,7,1,5,4,0,2,2,6,6,0,1,2,1,-1,0,1,1,10,17,-2,3,1,0,0,2,1,-1,-1,1,3,1
KR_6759739139,440,5,21,65,10,3,4,1,4,8,4,6,6,0,1,4,3,-4,1,5,2,10,3,1,1,2,2,0,2,1,1,1,1,2,1
KR_6691867448,420,4,53,44,9,-3,2,5,5,5,0,2,6,4,5,5,0,0,3,3,1,11,4,1,3,4,4,0,2,1,1,1,1,2,1
KR_6718928632,420,12,93,95,15,2,5,3,5,5,0,3,3,0,0,4,4,5,7,2,1,10,10,2,3,5,3,0,4,1,1,1,1,3,1
KR_6668944287,420,1,71,-8,-2,-1,0,1,-1,2,3,0,1,1,1,3,2,-1,0,1,0,-4,-5,0,4,4,2,0,0,-1,0,0,-1,3,1
KR_6729573307,420,-1,-109,-20,-1,0,1,1,-5,1,6,4,6,2,1,1,0,-1,0,1,0,-2,-6,-4,5,1,5,0,-1,-1,0,-1,-1,2,1
KR_6598075312,420,1,7,10,1,1,2,1,2,8,6,-3,1,4,3,5,2,-2,0,2,0,1,281,2,5,7,2,0,0,1,-1,0,-1,5,1
KR_6658732125,420,7,90,19,13,3,3,0,7,7,0,0,1,1,3,4,1,0,0,0,0,9,27,1,5,6,5,0,2,1,1,1,1,1,1
KR_6735245250,420,-1,42,-12,4,2,4,2,-2,2,4,2,5,3,1,4,3,1,2,1,0,-9,-11,-3,8,5,6,0,2,0,-1,1,-1,0,1
KR_6763234782,420,1,63,-8,3,3,4,1,-1,1,2,5,6,1,-4,1,5,0,0,0,0,-6,25,1,4,5,-11,0,0,-1,0,0,-1,4,1
KR_6760213798,420,2,40,-7,0,-2,0,2,6,6,0,-2,1,3,0,4,4,-2,1,3,0,3,-10,-1,4,3,7,0,0,1,-1,0,-1,4,1
KR_6728245908,420,10,76,92,21,3,3,0,1,1,0,4,4,0,15,15,0,-2,0,2,0,18,1,1,2,3,1,0,1,1,1,1,1,4,1
KR_6755810252,420,2,10,-4,-1,1,3,2,5,8,3,-1,2,3,-1,3,4,-5,1,6,-1,4,-5,-5,6,1,5,0,-1,0,1,-1,-1,0,1
KR_6731351601,420,4,-51,13,14,1,2,1,10,11,1,0,3,3,3,6,3,0,1,1,0,23,0,2,5,7,2,0,2,1,1,1,-1,2,1
KR_6646353352,420,0,-57,-13,3,1,2,1,-5,1,6,0,2,2,6,7,1,1,1,0,0,0,-5,-2,4,2,3,0,-1,0,-1,-1,-1,0,1
KR_6762067960,420,-3,-7,-16,-1,-1,1,2,-3,3,6,-3,0,3,3,7,4,3,4,1,0,-4,-4,-2,6,4,2,0,0,-1,1,0,1,3,1
KR_6662878012,420,-3,-7,-23,0,1,4,3,1,4,3,1,3,2,-1,2,3,-2,2,4,0,-2,-9,8,2,10,4,0,-1,1,1,-1,-1,4,1
KR_6714608742,420,-1,14,0,3,-4,3,7,-3,1,4,3,4,1,4,5,1,3,4,1,0,-5,-6,-6,8,2,9,0,1,0,-1,1,1,0,1
KR_6749090898,420,0,28,-16,3,-1,1,2,-4,3,7,4,5,1,4,8,4,0,0,0,0,-3,-114,5,3,8,1,0,-1,1,-1,-1,-1,5,1
KR_6736544434,420,4,100,8,11,1,3,2,5,6,1,-1,3,4,3,3,0,3,4,1,0,5,5,1,3,4,2,0,1,1,1,1,1,4,1
KR_6739255164,420,2,50,-2,4,2,3,1,4,7,3,2,4,2,-5,0,5,1,3,2,1,-7,-27,1,4,5,-3,0,3,-1,-1,1,1,5,1
KR_6685004176,440,2,55,12,-1,-2,1,3,-4,2,6,-3,3,6,5,5,0,3,3,0,0,-5,-23,-2,3,1,1,0,0,-1,1,1,1,1,1
KR_6764561075,420,0,-43,-12,7,1,1,0,3,3,0,4,6,2,0,2,2,-1,1,2,0,16,-3,1,4,5,4,0,-1,1,-1,-1,1,3,1
KR_6718637004,420,-1,14,-4,6,1,2,1,0,7,7,1,3,2,3,6,3,1,2,1,0,13,-1,-2,6,4,3,0,1,1,1,1,1,6,1
KR_6643359310,420,2,-33,-20,7,4,4,0,4,5,1,0,2,2,-1,0,1,0,1,1,0,5,4,-2,8,6,-2,0,0,-1,-1,0,-1,1,1
KR_6693300625,440,2,114,-5,12,3,3,0,0,2,2,3,4,1,6,6,0,0,1,1,-1,3,10,3,2,5,-1,0,1,-1,-1,1,-1,4,1
KR_6763193161,420,0,62,8,2,4,5,1,-2,0,2,1,2,1,-1,1,2,0,2,2,0,-4,-108,2,3,5,0,0,1,0,-1,1,1,0,1
KR_6667210216,420,0,-14,15,3,-1,1,2,2,2,0,0,1,1,-2,1,3,4,4,0,0,8,38,4,4,8,-2,0,0,1,1,1,-1,1,1
KR_6637056151,420,3,22,16,3,4,4,0,-1,5,6,6,7,1,-6,1,7,0,0,0,-1,-7,13,5,5,10,-1,0,0,-1,-1,0,-1,2,1
KR_6764481979,440,2,-17,24,1,-3,0,3,3,7,4,-2,2,4,3,4,1,0,3,3,0,-7,-1,1,3,4,-1,0,0,0,1,-1,-1,0,1
KR_6763427185,420,3,10,-8,12,-1,0,1,6,6,0,5,7,2,1,1,0,1,2,1,0,14,-7,2,3,5,-4,0,0,1,1,0,1,5,1
KR_6640110419,420,0,66,20,2,2,3,1,4,7,3,-2,1,3,-2,2,4,0,3,3,1,1,1,-7,8,1,-2,0,1,-1,1,1,1,2,1
KR_6763909785,420,5,119,20,-2,-1,0,1,0,4,4,-5,1,6,4,4,0,0,0,0,0,1,14,5,1,6,2,0,1,-1,-1,1,1,2,1
KR_6763446623,440,1,-11,14,5,-2,0,2,-4,0,4,4,4,0,5,5,0,2,3,1,0,5,29,1,3,4,2,0,1,-1,0,1,1,2,1
KR_6698760694,420,2,63,8,3,4,5,1,1,3,2,2,2,0,-2,3,5,-2,1,3,0,3,29,0,5,5,-18,0,0,-1,-1,1,-1,4,1
KR_6762427556,420,2,6,9,13,5,5,0,3,5,2,-2,0,2,8,11,3,-1,0,1,0,11,-4,0,2,2,-2,0,-1,-1,1,1,-1,3,1
KR_6651995371,420,4,79,8,5,0,1,1,0,2,2,0,2,2,5,5,0,0,0,0,0,-1,-6,-5,6,1,1,0,0,1,-1,0,-1,1,1
KR_6738844996,420,-1,-35,8,-2,-2,0,2,4,4,0,-2,1,3,-1,0,1,-1,2,3,0,-3,-11,5,5,10,-2,0,0,-1,1,0,1,1,1
KR_6747851766,420,5,71,28,8,5,6,1,-1,2,3,2,4,2,1,3,2,1,2,1,0,3,-4,2,4,6,4,0,0,1,1,1,1,4,1
KR_6649358412,420,3,38,10,3,-1,1,2,-5,3,8,4,4,0,5,5,0,0,1,1,0,-4,0,-3,6,3,0,0,0,-1,-1,-1,-1,6,1
KR_6646470205,420,3,48,-19,11,1,1,0,-1,3,4,1,1,0,7,7,0,3,3,0,0,10,-6,-2,6,4,5,0,1,1,-1,1,-1,2,1
KR_6759625529,420,-1,0,-47,0,-6,0,6,1,1,0,0,1,1,1,5,4,4,4,0,3,14,14,-3,7,4,-1,0,1,1,0,1,1,5,1
KR_6719027232,420,4,55,8,0,3,5,2,2,4,2,2,4,2,-4,2,6,-3,0,3,0,-9,22,4,3,7,-2,0,-1,-1,1,-1,-1,6,1
KR_6764573539,420,0,-5,43,4,-2,0,2,4,4,0,2,7,5,1,2,1,-1,0,1,0,-1,10,-1,5,4,0,0,0,1,-1,-1,-1,3,1
KR_6751913058,440,6,20,60,9,-1,1,2,9,9,0,-1,2,3,-3,7,10,5,5,0,0,5,-34,-3,4,1,27,0,2,1,1,1,-1,3,1
KR_6576881525,420,0,64,2,2,-1,1,2,-3,1,4,4,4,0,4,6,2,-2,0,2,0,-3,-10,1,5,6,1,0,-1,-1,-1,-1,-1,2,1
KR_6746697096,440,1,58,20,7,3,3,0,0,3,3,3,4,1,2,6,4,-1,4,5,1,13,4,2,3,5,-1,0,1,0,1,1,-1,0,1
KR_6672603490,420,2,113,-12,-3,3,3,0,-1,3,4,-1,0,1,-2,4,6,-2,1,3,-1,-7,-15,1,2,3,7,0,1,1,-1,1,-1,2,1
KR_6649327716,420,8,25,46,16,3,4,1,4,4,0,9,9,0,-1,1,2,1,4,3,1,14,30,2,4,6,3,0,2,1,1,1,1,2,1
KR_6738767460,420,-1,-32,8,-3,-1,1,2,-1,2,3,3,6,3,-2,2,4,-2,2,4,1,-6,-20,-3,6,3,-5,0,1,1,1,1,1,6,1
KR_6729836804,420,5,79,16,12,0,2,2,4,5,1,5,6,1,4,4,0,-1,0,1,0,7,21,-4,7,3,5,0,2,1,1,1,-1,6,1
KR_6698527752,420,1,-7,16,5,1,3,2,5,7,2,1,1,0,-4,1,5,2,2,0,0,8,25,-8,11,3,2,0,0,1,-1,0,1,1,1
KR_6699097879,440,1,-11,19,-5,0,2,2,0,2,2,-9,0,9,1,2,1,3,3,0,0,-7,17,0,4,4,-2,0,0,1,1,0,-1,5,1
KR_6752448199,420,0,-43,32,11,0,2,2,-1,2,3,3,4,1,6,6,0,3,4,1,1,19,6,2,3,5,2,0,1,1,1,1,1,5,1
KR_6705789760,420,4,89,6,2,3,4,1,3,4,1,-4,0,4,1,1,0,-1,1,2,0,4,10,-5,9,4,2,0,1,1,-1,1,-1,4,1
KR_6763756960,420,3,104,31,-1,2,3,1,2,4,2,0,1,1,-2,0,2,-3,0,3,0,-4,-38,0,4,4,21,0,0,1,0,0,-1,6,1
KR_6755765635,420,1,-3,4,-1,2,6,4,2,5,3,3,5,2,0,1,1,-8,0,8,-1,-6,10,0,5,5,6,0,0,1,-1,1,-1,1,1
KR_6757887322,420,4,4,12,8,-1,4,5,0,1,1,0,3,3,6,6,0,3,3,0,0,23,-12,1,4,5,1,0,1,1,1,1,-1,4,1
KR_6714390737,420,-1,-56,-4,0,0,2,2,5,7,2,-6,0,6,-1,2,3,2,2,0,1,-4,55,-2,5,3,9,0,-3,1,-1,-1,1,4,1
KR_6751361530,440,0,70,14,-1,-3,1,4,2,6,4,2,4,2,-1,2,3,-1,2,3,0,-6,9,5,2,7,3,0,0,1,-1,-1,1,2,1
KR_6753831946,420,-3,-56,-8,-3,-7,0,7,-1,0,1,1,2,1,2,3,1,2,2,0,0,2,192,1,3,4,-4,0,-1,1,-1,-1,-1,6,1
KR_6757090356,440,5,4,48,15,2,2,0,5,5,0,0,1,1,6,7,1,2,2,0,0,16,9,6,2,8,0,0,0,0,1,1,1,0,1
KR_6743212385,440,1,29,20,6,2,3,1,2,3,1,2,4,2,0,0,0,0,4,4,-1,7,-4,1,2,3,3,0,0,1,-1,0,-1,1,1
KR_6741056454,420,-1,-26,21,2,-3,0,3,3,3,0,-3,0,3,5,7,2,0,1,1,-1,3,2,1,2,3,2,0,-1,1,-1,-1,-1,3,1
KR_6763377233,420,7,60,-3,15,-1,4,5,1,2,1,1,3,2,13,14,1,1,1,0,0,20,2,3,2,5,2,0,2,1,1,1,1,5,1
KR_6735741572,420,2,-4,15,0,-1,1,2,2,3,1,5,5,0,-6,0,6,0,0,0,0,-1,15,-2,8,6,2,0,0,-1,1,0,-1,6,1
KR_6735520432,420,2,20,40,7,2,2,0,1,3,2,2,4,2,2,4,2,0,4,4,0,5,-1,-5,6,1,0,0,1,1,1,1,1,3,1
KR_6751655012,420,2,81,6,5,-2,0,2,-1,1,2,6,9,3,1,2,1,1,1,0,1,1,3,0,2,2,3,0,3,1,-1,1,1,5,1
KR_6679629691,420,-3,17,-28,0,1,1,0,-3,0,3,-4,2,6,2,3,1,4,5,1,1,-1,-43,3,4,7,20,0,-1,-1,-1,-1,1,1,1
KR_6753654773,420,3,77,12,14,4,5,1,2,2,0,7,8,1,2,4,2,-1,0,1,0,6,-25,6,2,8,4,0,2,1,1,1,1,1,1
KR_6758946518,420,0,-2,4,-11,-1,2,3,1,4,3,-4,2,6,-4,1,5,-3,0,3,0,-10,8,5,1,6,-3,0,0,-1,1,0,-1,5,1
KR_6671151458,420,3,-24,18,12,3,5,2,4,7,3,2,5,3,1,2,1,2,2,0,0,10,7,0,3,3,0,0,-1,1,0,1,1,6,1
KR_6756659959,440,-2,-11,27,-8,-5,0,5,-6,1,7,0,2,2,0,3,3,3,3,0,0,-7,-11,0,9,9,16,0,-1,1,-1,-1,-1,5,1
KR_6701798512,420,2,12,20,9,1,2,1,-2,2,4,0,4,4,8,8,0,2,2,0,1,2,-13,0,5,5,-2,0,0,1,0,1,1,6,1
KR_6703106865,420,2,13,39,4,-7,0,7,-1,1,2,1,2,1,6,6,0,5,6,1,-1,10,12,-1,4,3,1,0,1,1,1,-1,-1,4,1
KR_6654613270,420,2,-18,6,0,1,1,0,0,2,2,-1,1,2,0,2,2,0,1,1,0,-3,51,-3,8,5,4,0,1,-1,-1,1,1,1,1
KR_6197058818,420,-2,52,-10,-3,-3,2,5,0,1,1,-2,0,2,2,4,2,0,1,1,0,-8,-20,-3,9,6,6,0,0,-1,1,0,-1,3,1
KR_6672731868,420,7,52,31,11,0,3,3,5,5,0,3,4,1,4,5,1,-1,0,1,0,12,4,2,3,5,2,0,1,1,1,1,1,6,1
KR_6744602946,420,2,7,-3,5,1,2,1,5,7,2,-3,4,7,3,6,3,-1,1,2,0,9,23,2,5,7,8,0,-2,1,-1,-1,-1,6,1
KR_6650905924,420,6,162,35,12,7,7,0,1,4,3,0,2,2,3,3,0,1,1,0,1,12,6,3,3,6,2,0,1,1,1,1,1,2,1
KR_6763051170,420,1,1,7,-4,3,4,1,1,3,2,-5,0,5,-5,1,6,2,3,1,-2,-11,-37,-4,8,4,2,0,-1,1,1,-1,-1,4,1
KR_6757101602,420,3,93,-16,3,3,3,0,4,4,0,0,3,3,-5,2,7,1,3,2,0,-3,0,-1,5,4,1,0,0,0,0,0,1,0,1
KR_6704761722,420,5,96,32,10,3,8,5,2,3,1,8,8,0,-3,1,4,0,0,0,1,9,-3,-3,5,2,1,0,1,1,1,1,1,5,1
KR_6756155569,420,0,49,-26,-4,-1,1,2,-1,3,4,-1,1,2,3,3,0,-4,0,4,1,-5,13,1,3,4,1,0,0,-1,1,1,1,3,1
KR_6698497041,420,4,74,-29,20,6,7,1,4,5,1,-3,1,4,11,12,1,2,2,0,1,27,-5,2,4,6,0,0,2,1,1,1,1,6,1
KR_6762251926,420,2,-42,-14,9,0,5,5,3,3,0,3,4,1,3,3,0,0,0,0,0,12,-4,0,4,4,2,0,2,1,1,1,-1,1,1
KR_6763957990,420,0,-17,8,1,4,5,1,2,2,0,-2,1,3,-1,0,1,-2,0,2,0,5,-4,0,4,4,4,0,-1,-1,1,-1,1,1,1
KR_6622696636,420,0,-6,24,3,2,2,0,1,4,3,2,2,0,0,3,3,-2,3,5,1,10,-303,-2,7,5,2,0,-1,1,-1,-1,1,3,1
KR_6763633061,420,0,13,-7,0,-1,2,3,-2,1,3,-1,2,3,2,3,1,2,2,0,1,1,12,4,2,6,-8,0,2,1,1,1,1,2,1
KR_6704600391,420,2,-68,27,8,1,1,0,5,7,2,1,4,3,0,1,1,1,1,0,0,5,-6,-5,7,2,3,0,0,1,1,1,1,2,1
KR_6761152301,420,1,23,3,6,1,5,4,1,1,0,1,4,3,4,5,1,-1,1,2,1,5,0,2,4,6,-1,0,0,-1,1,-1,1,3,1
KR_6690827286,420,-2,3,4,2,1,2,1,2,3,1,1,2,1,0,1,1,-2,0,2,0,-4,133,1,5,6,-1,0,2,1,1,1,1,3,1
KR_6724462358,420,4,201,-19,8,5,6,1,5,7,2,0,2,2,1,3,2,-3,0,3,0,0,-19,2,3,5,2,0,2,1,-1,1,1,5,1
KR_6692068953,420,1,45,8,2,2,3,1,4,6,2,1,1,0,-7,1,8,2,3,1,1,2,35,4,3,7,-17,0,0,-1,1,1,1,2,1
KR_6684257037,420,4,27,2,5,-2,5,7,4,5,1,0,1,1,2,6,4,1,1,0,0,12,6,-1,4,3,1,0,1,-1,-1,-1,1,5,1
KR_6674298885,420,8,97,23,14,3,5,2,4,6,2,0,2,2,7,7,0,0,1,1,1,7,-2,1,3,4,6,0,2,1,1,1,1,3,1
KR_6761772736,420,1,41,-22,10,1,3,2,0,3,3,3,4,1,5,7,2,1,1,0,2,15,-6,3,4,7,9,0,-1,1,1,1,1,6,1
KR_6745708690,420,-4,-90,-29,-1,-2,1,3,4,6,2,-4,1,5,0,2,2,1,1,0,-1,7,158,-2,6,4,1,0,0,-1,1,0,-1,1,1
KR_6743371447,420,2,69,0,2,-1,0,1,2,4,2,0,3,3,1,2,1,0,0,0,-1,-3,36,-2,6,4,-14,0,2,-1,1,1,-1,6,1
KR_6752401495,420,5,13,23,14,3,3,0,2,2,0,3,6,3,4,4,0,2,2,0,0,19,-2,6,0,6,2,0,3,1,1,1,1,6,1
KR_6722589715,440,1,73,14,6,-1,0,1,-3,1,4,1,3,2,7,9,2,2,2,0,1,5,9,4,1,5,1,0,0,1,1,1,1,4,1
KR_6746178241,420,-1,11,29,-6,1,2,1,3,5,2,0,3,3,-4,2,6,-6,1,7,1,-8,11,6,2,8,-3,0,-1,1,-1,-1,1,1,1
KR_6763835057,420,-1,16,34,5,-1,1,2,3,5,2,-1,1,2,3,3,0,1,1,0,2,4,-140,-4,7,3,3,0,0,1,-1,0,1,3,1
KR_6757124498,440,0,15,-35,2,-9,3,12,3,3,0,1,1,0,3,4,1,4,5,1,0,-6,3,-3,9,6,5,0,1,-1,1,1,-1,1,1
KR_6740986505,420,1,-28,-4,3,1,4,3,-4,2,6,2,2,0,4,4,0,0,1,1,0,8,3,1,1,2,1,0,0,1,0,1,1,5,1
KR_6717446643,420,0,-54,-12,6,2,4,2,-1,3,4,3,3,0,1,4,3,1,2,1,0,2,281,4,4,8,-3,0,1,1,1,-1,1,1,1
KR_6759540575,420,4,26,24,1,1,2,1,-7,0,7,8,8,0,-1,1,2,0,0,0,0,-4,14,2,1,3,1,0,0,1,-1,0,-1,5,1
KR_6749714461,440,3,58,-2,21,6,6,0,2,4,2,2,4,2,10,13,3,1,2,1,0,11,7,-1,4,3,0,0,3,1,-1,1,1,1,1
KR_6751543914,440,2,45,29,8,1,2,1,0,1,1,1,1,0,0,3,3,6,7,1,0,16,-142,-3,9,6,3,0,0,1,1,1,-1,5,1
KR_6756932798,420,2,-27,20,4,4,7,3,2,3,1,0,1,1,-2,1,3,0,2,2,0,4,104,5,3,8,-2,0,1,-1,1,1,1,4,1
KR_6763307561,420,-1,-16,-28,-3,3,4,1,0,2,2,0,0,0,-5,1,6,-1,0,1,0,-2,389,-3,7,4,0,0,2,-1,1,1,1,1,1
KR_6655697110,420,0,1,4,6,0,1,1,-2,2,4,0,0,0,9,10,1,-1,2,3,-1,2,0,-1,6,5,-6,0,1,-1,1,1,-1,1,1
KR_6620546995,420,1,56,-3,5,1,3,2,-1,3,4,0,3,3,0,2,2,5,5,0,1,8,42,-1,6,5,-10,0,0,1,-1,0,1,2,1
KR_6764475876,420,5,105,48,14,1,3,2,4,4,0,2,2,0,8,8,0,-1,0,1,0,5,2,1,6,7,5,0,0,1,1,0,1,4,1
KR_6746380947,420,3,43,10,11,1,5,4,3,6,3,-1,2,3,7,8,1,1,1,0,0,10,6,-2,4,2,-2,0,3,1,-1,1,1,5,1
KR_6681831304,420,-4,-60,36,-6,-6,1,7,-3,0,3,-1,0,1,3,4,1,1,2,1,0,-6,37,-4,8,4,0,0,-1,1,-1,-1,1,4,1
KR_6724417415,420,2,37,4,3,6,6,0,-3,2,5,-2,0,2,0,0,0,2,5,3,0,3,7,-2,6,4,0,0,0,1,-1,0,1,4,1
KR_6764674683,440,2,42,13,1,-1,0,1,0,1,1,0,0,0,2,5,3,0,1,1,0,2,-22,-2,5,3,5,0,0,-1,1,1,-1,2,1
KR_6759987540,420,3,55,8,2,3,4,1,-1,1,2,0,0,0,-1,2,3,1,2,1,0,-4,-10,1,4,5,-1,0,1,1,-1,1,-1,3,1
KR_6764508296,420,2,60,4,7,3,3,0,-2,1,3,1,2,1,5,6,1,0,2,2,-1,2,1,0,7,7,-1,0,0,-1,1,0,-1,6,1
KR_6675679825,420,1,29,-13,6,0,1,1,-2,3,5,2,2,0,6,7,1,0,0,0,1,6,-4,2,2,4,-3,0,1,1,0,1,1,4,1
KR_6761588814,420,2,21,4,2,-1,1,2,3,3,0,3,3,0,-1,1,2,-2,0,2,0,2,0,2,2,4,-3,0,0,-1,1,0,-1,4,1
KR_6665628809,420,5,53,-7,13,1,3,2,2,6,4,6,6,0,-1,2,3,5,6,1,0,9,118,4,3,7,1,0,2,-1,1,1,-1,3,1
KR_6683375633,420,-2,-5,-36,-2,-3,0,3,1,3,2,1,2,1,-1,1,2,0,0,0,0,2,-12,1,5,6,-1,0,1,-1,0,1,-1,4,1
KR_6759477252,420,0,26,4,5,0,2,2,0,1,1,6,7,1,-3,3,6,2,2,0,2,4,48,3,1,4,-4,0,1,1,1,1,1,3,1
KR_6733191881,420,1,0,0,4,0,2,2,0,3,3,-1,0,1,-1,6,7,6,8,2,0,11,-28,-2,6,4,0,0,1,1,-1,1,1,6,1
KR_6722136970,420,1,23,0,5,2,5,3,3,3,0,-1,1,2,2,4,2,-1,1,2,2,9,-4,1,3,4,1,0,0,1,-1,0,1,2,1
KR_6745568776,420,2,8,-2,4,7,7,0,3,4,1,-7,1,8,1,2,1,0,0,0,-1,0,-20,1,3,4,0,0,0,-1,1,0,-1,5,1
KR_6718911577,420,5,16,-8,12,2,3,1,1,3,2,1,2,1,8,9,1,0,2,2,0,10,35,3,2,5,2,0,0,1,1,1,1,1,1
KR_6649031978,420,-1,-1,30,-5,-2,1,3,-2,1,3,2,3,1,-6,2,8,3,3,0,0,-4,7,2,4,6,-2,0,0,1,1,1,1,6,1
KR_6757444458,420,2,53,-21,2,3,5,2,-5,1,6,0,0,0,4,6,2,0,0,0,0,0,1,5,3,8,-2,0,2,1,-1,1,-1,4,1
KR_6644398793,420,-1,-8,-19,-5,3,3,0,-2,1,3,-1,2,3,-6,1,7,1,1,0,0,-4,-1,-1,5,4,-7,0,0,0,-1,0,-1,0,1
KR_6760171595,420,4,38,-12,5,4,5,1,-2,0,2,-1,0,1,3,5,2,1,1,0,0,1,7,5,1,6,2,0,0,-1,-1,0,-1,6,1
KR_6741456901,420,-1,29,-4,-3,-4,0,4,4,6,2,1,1,0,-4,1,5,0,1,1,0,-3,12,4,2,6,-4,0,-1,1,1,1,-1,2,1
KR_6700154555,420,3,14,12,7,-1,0,1,0,2,2,3,3,0,2,6,4,3,4,1,0,10,5,-1,6,5,2,0,0,-1,-1,0,1,5,1
KR_6738001295,420,2,117,5,-3,-2,1,3,0,5,5,-2,4,6,0,1,1,1,1,0,0,3,-38,4,1,5,-2,0,1,1,-1,1,1,1,1
KR_6760573565,420,2,-16,-4,2,3,3,0,-1,2,3,-1,3,4,1,4,3,0,0,0,0,-1,2,-1,5,4,-1,0,-1,1,-1,-1,1,5,1
KR_6759351062,420,1,37,34,6,5,6,1,0,6,6,6,6,0,-3,4,7,-2,1,3,2,-2,2,1,3,4,2,0,2,1,1,1,1,1,1
KR_6762902946,420,-2,-22,-9,-6,-2,0,2,-1,1,2,-3,2,5,2,3,1,-2,0,2,0,0,18,8,4,12,-6,0,1,1,1,1,1,1,1
KR_6717468711,420,1,28,3,0,1,4,3,6,7,1,-2,1,3,-6,0,6,1,2,1,0,-4,5,3,3,6,-1,0,0,1,-1,0,-1,1,1
KR_6747817140,420,2,-10,31,12,-1,2,3,5,9,4,2,4,2,6,6,0,0,1,1,0,4,-5,0,4,4,0,0,0,0,-1,0,1,0,1
KR_6756615693,420,4,38,16,12,-1,1,2,6,6,0,6,9,3,2,5,3,-1,0,1,-1,4,-2,0,3,3,0,0,1,-1,1,1,-1,5,1
KR_6734133033,420,4,69,6,6,3,5,2,-2,3,5,1,4,3,2,5,3,2,3,1,0,6,-2,-4,8,4,0,0,0,-1,-1,-1,-1,2,1
KR_6648772699,420,4,57,28,7,-2,0,2,1,3,2,0,3,3,5,5,0,3,3,0,0,9,413,4,1,5,0,0,2,1,-1,1,1,4,1
KR_6758542858,420,1,45,-7,6,2,3,1,-1,1,2,4,6,2,0,1,1,1,3,2,0,2,-10,1,3,4,-1,0,2,1,1,1,1,1,1
KR_6762246999,420,0,19,-5,0,0,1,1,-3,2,5,2,5,3,2,2,0,-1,0,1,0,-6,-129,4,4,8,0,0,0,-1,-1,0,-1,6,1
KR_6753858204,420,2,63,-69,7,2,2,0,-3,2,5,7,10,3,-1,1,2,2,3,1,0,4,-8,2,2,4,-1,0,2,1,1,1,1,3,1
KR_6732641255,440,-5,-62,-11,-10,-3,1,4,-6,1,7,3,4,1,-3,0,3,-1,0,1,0,-6,-184,-3,6,3,5,0,-2,-1,1,-1,-1,5,1
KR_6714331448,420,1,90,1,4,0,1,1,5,6,1,0,1,1,-1,1,2,0,0,0,0,12,2,4,5,9,-1,0,0,1,-1,0,-1,5,1
KR_6745598333,420,-5,-115,16,-11,-1,1,2,-1,1,2,-4,1,5,-6,1,7,1,2,1,0,-5,5,0,3,3,0,0,0,-1,0,0,-1,2,1
KR_6727855630,420,4,100,19,14,1,2,1,2,4,2,1,1,0,9,11,2,1,1,0,0,8,3,-1,1,0,2,0,0,1,1,0,1,5,1
KR_6763565230,440,5,32,32,9,2,3,1,4,4,0,3,5,2,0,2,2,0,3,3,0,4,7,4,4,8,-6,0,0,-1,0,0,1,2,1
KR_6732529397,420,4,91,16,4,0,1,1,2,5,3,1,2,1,3,5,2,-2,1,3,0,3,-33,3,5,8,2,0,0,1,1,1,-1,1,1
KR_6647986348,420,2,22,4,0,2,2,0,2,3,1,-5,0,5,0,2,2,1,1,0,0,3,-78,0,6,6,-2,0,0,0,1,0,1,0,1
KR_6739538170,420,-3,57,12,1,-3,1,4,0,3,3,-3,1,4,5,5,0,2,2,0,0,11,-3,-4,9,5,8,0,0,1,-1,-1,1,4,1
KR_6759840071,420,0,19,-21,3,5,6,1,5,9,4,-3,2,5,-4,4,8,0,1,1,0,2,3,1,5,6,1,0,-2,1,-1,-1,-1,6,1
KR_6695354403,420,0,-30,12,4,-2,0,2,1,3,2,3,4,1,1,2,1,1,1,0,-1,6,47,0,4,4,-22,0,1,1,-1,1,-1,1,1
KR_6737260766,420,1,44,33,-5,0,1,1,-9,1,10,0,1,1,3,3,0,1,1,0,0,-7,-3,2,2,4,1,0,1,1,1,1,1,5,1
KR_6753285349,420,2,12,-4,5,3,6,3,0,4,4,-1,4,5,2,3,1,1,1,0,0,4,15,3,3,6,2,0,0,1,1,1,-1,4,1
KR_6689458068,420,2,-86,13,12,1,3,2,5,6,1,-1,1,2,6,8,2,1,1,0,1,17,25,5,5,10,0,0,1,1,-1,-1,1,3,1
KR_6745801802,420,1,72,29,3,5,5,0,-1,5,6,1,2,1,0,2,2,-2,2,4,2,-5,4,4,1,5,3,0,2,0,1,1,1,0,1
KR_6601634709,420,1,8,12,5,0,1,1,0,2,2,2,4,2,3,3,0,0,0,0,0,4,-2,2,3,5,0,0,0,1,-1,0,-1,2,1
KR_6745544385,420,1,-41,12,0,3,4,1,0,1,1,0,3,3,-1,0,1,-2,0,2,0,-2,55,-2,3,1,-24,0,-3,1,-1,-1,-1,4,1
KR_6746532410,420,-1,6,4,2,0,1,1,-5,1,6,-2,1,3,8,9,1,1,1,0,0,0,-7,0,2,2,1,0,2,-1,1,1,1,5,1
KR_6660998134,420,-1,33,-10,-5,-1,0,1,-3,4,7,0,4,4,-1,2,3,0,0,0,0,-1,-8,-5,7,2,3,0,1,-1,-1,1,1,2,1
KR_6763290751,420,0,-58,-27,7,1,1,0,4,6,2,-3,2,5,4,4,0,1,2,1,0,10,21,1,7,8,-5,0,0,1,-1,0,1,4,1
KR_6755512278,420,1,-18,8,1,-5,0,5,7,8,1,2,3,1,-3,3,6,0,0,0,-1,4,6,-1,5,4,-3,0,0,1,1,0,-1,3,1
KR_6727179305,420,0,-72,-16,0,-2,1,3,3,4,1,0,4,4,-3,2,5,2,2,0,0,-1,-3,-3,6,3,0,0,-1,1,-1,-1,1,4,1
KR_6712850078,420,5,70,-9,13,1,2,1,4,6,2,5,6,1,3,4,1,0,1,1,0,9,111,7,2,9,0,0,1,0,1,1,1,0,1
KR_6695066405,420,6,45,1,11,3,4,1,4,4,0,1,2,1,3,3,0,0,1,1,0,9,4,3,2,5,1,0,2,1,1,1,-1,2,1
KR_6720092614,420,4,22,7,12,3,3,0,4,7,3,2,4,2,3,3,0,0,3,3,0,13,-8,6,3,9,3,0,1,-1,-1,1,-1,5,1
KR_6729125213,420,5,110,-32,7,3,4,1,4,8,4,3,6,3,0,3,3,-3,1,4,-2,8,50,-2,6,4,-27,0,1,1,-1,1,1,1,1
KR_6762591257,420,2,-29,15,5,-4,1,5,0,2,2,4,4,0,4,4,0,1,1,0,0,8,-7,-1,4,3,5,0,0,1,1,-1,1,2,1
KR_6671171873,420,4,119,11,7,0,1,1,0,3,3,0,1,1,5,5,0,2,2,0,0,9,50,4,3,7,-22,0,1,1,1,1,1,3,1
KR_6762140611,420,1,-16,24,1,-4,1,5,-2,3,5,3,4,1,4,8,4,0,0,0,0,5,-33,0,4,4,-2,0,0,1,1,1,-1,5,1
KR_6485984986,420,3,123,-16,8,2,2,0,2,2,0,1,2,1,3,5,2,0,0,0,0,7,4,-2,5,3,2,0,1,1,-1,1,1,3,1
KR_6736048875,420,-2,-5,1,-2,-2,0,2,1,3,2,2,4,2,-4,0,4,1,1,0,0,2,-17,1,2,3,1,0,-1,-1,1,-1,-1,4,1
KR_6760544240,420,-2,20,-23,-3,5,5,0,0,2,2,-1,1,2,-3,2,5,-4,0,4,0,-5,0,4,2,6,-3,0,0,-1,0,0,-1,1,1
KR_6754201638,420,1,17,-17,0,2,2,0,-1,2,3,1,2,1,-2,3,5,0,1,1,0,-3,118,-2,5,3,6,0,0,1,-1,1,1,1,1
KR_6763964521,440,11,146,87,16,4,7,3,0,1,1,9,9,0,0,0,0,3,3,0,1,14,5,5,0,5,-1,0,4,1,1,1,1,3,1
KR_6652324683,420,5,103,0,10,1,2,1,6,8,2,1,3,2,2,4,2,0,0,0,0,15,-179,-1,3,2,-1,0,2,-1,1,1,-1,4,1
KR_6758871179,420,1,-85,29,10,3,3,0,4,6,2,-1,0,1,2,3,1,2,4,2,0,8,-6,2,3,5,-2,0,0,-1,1,0,-1,2,1
KR_6530022815,420,5,23,43,6,2,2,0,-3,0,3,6,7,1,0,1,1,1,2,1,1,3,37,-2,4,2,1,0,1,0,1,1,1,0,1
KR_6760584613,420,4,-20,-6,14,2,2,0,0,3,3,3,6,3,9,10,1,0,3,3,1,13,-10,7,1,8,2,0,1,1,-1,1,1,4,1
KR_6662232908,420,3,69,20,1,4,4,0,-3,1,4,0,0,0,2,6,4,-2,0,2,-1,-8,-13,-2,5,3,-1,0,1,1,-1,1,-1,3,1
KR_6406122605,420,-2,80,-8,2,7,7,0,-4,1,5,0,1,1,-4,2,6,3,3,0,1,0,15,3,2,5,-4,0,2,1,1,1,1,3,1
KR_6696517201,420,-4,-34,-12,-8,-2,3,5,-2,3,5,-2,4,6,-1,1,2,-1,1,2,0,-8,9,4,4,8,-1,0,0,-1,1,1,-1,3,1
KR_6759459306,440,2,-44,0,4,-2,0,2,0,2,2,4,6,2,2,6,4,0,2,2,-1,0,10,1,3,4,-3,0,0,-1,1,1,-1,5,1
KR_6763492721,440,3,40,-8,8,0,3,3,3,6,3,2,3,1,2,4,2,1,5,4,0,12,10,4,1,5,-16,0,0,1,-1,1,-1,1,1
KR_6753420770,420,2,44,0,5,1,2,1,0,0,0,-3,1,4,3,3,0,4,4,0,0,1,-70,1,6,7,-2,0,0,1,-1,0,1,3,1
KR_6637606577,420,4,19,-19,5,3,3,0,-3,0,3,2,4,2,3,3,0,0,0,0,0,4,23,-2,6,4,4,0,1,-1,1,1,1,6,1
KR_5533032584,420,3,57,7,9,0,1,1,-1,6,7,3,5,2,6,6,0,1,2,1,0,18,9,1,6,7,3,0,2,-1,1,1,1,3,1
KR_6544981674,420,2,3,-10,-2,4,5,1,-1,3,4,-3,0,3,-2,2,4,0,0,0,0,-9,18,-3,7,4,0,0,-1,1,-1,-1,-1,5,1
KR_6762907304,440,7,45,18,11,0,2,2,2,3,1,6,7,1,1,9,8,2,3,1,0,10,9,4,0,4,-5,0,1,1,-1,1,-1,4,1
KR_6728081429,420,3,-5,20,5,3,5,2,0,1,1,0,2,2,1,2,1,1,1,0,0,3,7,4,5,9,1,0,0,1,1,0,1,6,1
KR_6752824907,440,3,6,34,-1,3,4,1,1,3,2,-2,1,3,-2,0,2,-1,1,2,0,-4,-1,-1,7,6,8,0,0,1,1,0,1,6,1
KR_6756608755,420,-3,-46,-17,4,-6,1,7,0,2,2,4,6,2,5,5,0,1,1,0,0,10,0,1,2,3,2,0,-2,1,-1,-1,-1,4,1
KR_6682758524,420,6,52,39,7,2,3,1,3,5,2,1,3,2,3,7,4,-2,0,2,1,10,-178,9,1,10,-7,0,0,1,-1,0,1,4,1
KR_6698938312,420,-1,0,16,-6,3,3,0,-5,2,7,0,1,1,-1,4,5,-3,0,3,0,-13,9,-1,6,5,0,0,1,-1,1,1,-1,4,1
KR_6698529229,420,1,-34,21,8,-1,0,1,2,4,2,5,5,0,-1,3,4,3,4,1,0,8,80,5,5,10,4,0,0,1,1,1,1,6,1
KR_6751955386,420,0,30,-24,2,2,3,1,1,6,5,2,3,1,-2,0,2,-1,1,2,0,0,-32,-3,5,2,7,0,1,1,-1,1,1,4,1
KR_6690892436,420,9,115,12,17,4,5,1,2,2,0,7,8,1,3,3,0,1,1,0,0,9,2,2,9,11,1,0,1,1,1,1,1,6,1
KR_6594494939,420,1,33,24,6,0,1,1,6,7,1,2,3,1,-2,0,2,0,0,0,0,7,0,2,2,4,-3,0,1,-1,1,1,1,2,1
KR_6723103403,440,3,14,9,8,0,5,5,-1,3,4,1,1,0,7,7,0,1,1,0,0,8,1,2,1,3,0,0,1,0,-1,1,-1,0,1
KR_6737853674,420,3,44,16,2,5,5,0,1,2,1,-6,1,7,1,2,1,1,2,1,0,7,-225,2,1,3,-2,0,2,1,-1,1,-1,2,1
KR_6746282440,420,0,10,-11,0,-1,3,4,3,4,1,-2,0,2,2,4,2,-2,1,3,1,-2,7,-1,3,2,4,0,1,1,-1,1,1,1,1
KR_6755615222,420,0,-53,24,0,3,3,0,3,7,4,-4,1,5,-2,1,3,0,0,0,0,4,-84,2,4,6,-1,0,-1,1,1,-1,1,2,1
KR_6718713694,420,-3,30,-7,0,2,3,1,-1,1,2,-2,2,4,3,3,0,-2,0,2,0,3,4,3,2,5,-1,0,0,0,1,1,-1,0,1
KR_6741422364,420,1,67,4,8,4,5,1,-1,4,5,3,4,1,2,8,6,0,1,1,-1,1,31,0,3,3,1,0,1,-1,1,1,-1,6,1
KR_6691001802,420,1,28,-5,4,0,3,3,0,3,3,1,3,2,3,6,3,0,1,1,0,2,-5,0,5,5,-1,0,0,1,1,1,-1,4,1
KR_6754736482,420,1,75,9,0,2,3,1,2,4,2,1,2,1,-5,1,6,0,1,1,0,-6,-208,-5,6,1,1,0,0,-1,1,-1,-1,6,1
KR_6692389602,440,3,39,3,4,-1,1,2,-3,1,4,2,3,1,6,6,0,0,0,0,1,5,191,-2,5,3,2,0,1,1,1,1,1,4,1
KR_6762846606,420,2,-4,-19,9,-1,1,2,-6,3,9,9,9,0,6,6,0,1,1,0,0,3,7,1,2,3,-2,0,0,-1,-1,-1,-1,1,1
KR_6757419758,420,-2,-7,8,-4,-6,0,6,4,4,0,2,3,1,-4,2,6,0,5,5,0,2,-2,4,2,6,-2,0,-1,1,-1,-1,1,5,1
KR_6745350097,420,3,62,28,6,9,9,0,2,3,1,-2,2,4,-2,0,2,-1,1,2,-1,5,-11,6,1,7,6,0,1,1,1,1,-1,6,1
KR_6665613034,420,4,106,17,7,0,0,0,4,6,2,-5,2,7,7,8,1,1,3,2,0,11,-27,-3,5,2,5,0,3,1,1,1,1,3,1
KR_6741381660,420,1,14,18,1,-1,2,3,3,5,2,1,2,1,3,4,1,-5,0,5,0,8,-3,-2,5,3,0,0,0,1,-1,-1,1,4,1
KR_6654496731,420,1,31,28,-4,2,3,1,-2,2,4,1,1,0,-4,1,5,-1,0,1,0,-9,3,-3,7,4,-5,0,0,-1,1,1,-1,4,1
KR_6743897880,420,1,-34,0,13,1,3,2,8,9,1,1,3,2,1,1,0,2,2,0,0,6,4,-2,8,6,-4,0,0,-1,-1,0,1,2,1
KR_6706521986,420,2,11,-16,5,1,2,1,0,3,3,-2,1,3,4,4,0,2,2,0,0,10,70,6,1,7,-3,0,0,1,1,1,-1,3,1
KR_6735561914,420,7,65,52,12,0,4,4,6,6,0,-2,1,3,7,11,4,1,3,2,0,1,-1,-1,2,1,5,0,3,1,1,1,1,5,1
KR_6761209097,420,-2,-36,-24,-5,-3,0,3,-5,1,6,0,2,2,2,4,2,1,1,0,0,-2,99,-7,10,3,4,0,0,1,-1,0,-1,4,1
KR_6727265106,420,1,32,-20,5,4,6,2,3,6,3,1,1,0,-2,1,3,-1,0,1,-1,1,3,4,3,7,-1,0,1,1,1,1,-1,6,1
KR_6475927149,420,2,73,-2,6,4,5,1,2,6,4,-4,2,6,0,3,3,4,4,0,1,8,-18,2,2,4,-1,0,2,-1,1,1,1,5,1
KR_6746338109,420,8,99,4,13,6,6,0,1,3,2,0,1,1,2,3,1,4,4,0,1,7,-202,3,2,5,-29,0,4,1,1,1,1,2,1
KR_6747479641,440,4,32,28,15,6,6,0,5,9,4,3,3,0,0,6,6,1,1,0,-1,5,1,-2,2,0,3,0,0,1,1,1,-1,6,1
KR_6600777877,420,-4,-66,1,-2,-1,0,1,0,3,3,-1,2,3,-1,3,4,1,1,0,0,4,-1,-1,4,3,1,0,1,1,1,1,-1,5,1
KR_6758927583,420,-2,106,7,1,1,2,1,2,3,1,3,4,1,-3,0,3,-2,0,2,1,-1,-9,-2,3,1,2,0,0,-1,1,0,1,2,1
KR_6698994145,420,6,48,-17,15,0,2,2,4,4,0,4,4,0,7,7,0,0,2,2,0,20,0,4,4,8,2,0,2,-1,1,1,1,3,1
KR_6730808469,420,1,64,19,-4,-5,1,6,2,4,2,-2,4,6,1,3,2,0,1,1,0,-3,18,0,3,3,0,0,0,0,0,1,-1,0,1
KR_6722839566,440,3,-21,-8,7,-3,1,4,1,3,2,0,6,6,8,8,0,1,1,0,0,11,2,0,3,3,3,0,1,1,1,1,1,2,1
KR_6398103785,420,-2,-25,42,-4,6,7,1,-3,3,6,-3,3,6,-3,0,3,-1,1,2,0,-11,1,1,7,8,-1,0,-1,-1,1,-1,1,4,1
KR_6762353123,420,0,-11,-16,1,1,2,1,0,2,2,-2,0,2,0,1,1,2,2,0,0,4,-3,2,3,5,0,0,0,0,-1,0,1,0,1
KR_6752726470,420,5,17,27,9,5,5,0,0,3,3,3,3,0,2,3,1,-1,0,1,0,5,-24,-1,5,4,1,0,1,1,0,1,1,6,1
KR_6658612758,420,3,35,14,3,1,1,0,0,2,2,1,2,1,4,5,1,-3,0,3,0,5,5,2,3,5,-1,0,1,-1,1,1,1,5,1
KR_6754804605,440,4,38,4,8,-1,1,2,0,3,3,6,7,1,3,4,1,0,1,1,-1,1,-5,2,1,3,1,0,2,1,1,1,-1,3,1
KR_6741763248,420,1,85,7,1,5,6,1,-1,2,3,-9,1,10,3,3,0,3,4,1,0,4,-5,-1,4,3,-1,0,1,-1,-1,1,-1,6,1
KR_6760539140,440,0,-21,8,2,3,3,0,-4,1,5,-1,0,1,3,3,0,1,1,0,0,-2,4,1,3,4,-2,0,0,-1,1,0,1,4,1
KR_6763429913,420,-1,25,-20,-2,-1,1,2,-1,2,3,0,0,0,-1,1,2,1,1,0,0,-6,-14,1,1,2,2,0,0,-1,1,-1,1,3,1
KR_6758889755,420,0,10,1,3,6,7,1,0,2,2,-5,4,9,-2,1,3,4,6,2,0,-1,6,4,3,7,0,0,2,1,1,1,1,2,1
KR_6705886176,420,4,89,35,7,5,10,5,2,3,1,5,9,4,-4,0,4,-1,0,1,0,0,0,8,3,11,3,0,2,-1,1,1,1,5,1
KR_6721765164,440,5,105,-20,14,2,2,0,4,4,0,3,3,0,4,6,2,1,1,0,0,18,4,3,1,4,0,0,0,-1,0,1,1,3,1
KR_6758490990,420,2,35,12,4,2,4,2,4,8,4,3,4,1,-4,1,5,-1,0,1,0,-5,-7,-1,3,2,4,0,2,1,1,1,1,5,1
KR_6688921881,420,5,139,42,8,-2,3,5,-3,5,8,4,4,0,7,7,0,2,3,1,0,10,9,-2,3,1,-2,0,1,1,1,1,-1,2,1
KR_6695888479,420,1,54,20,1,-3,1,4,-1,0,1,5,7,2,1,2,1,-1,0,1,1,3,113,2,4,6,4,0,1,-1,1,1,1,3,1
KR_6630615010,420,-1,44,20,-3,4,4,0,-1,2,3,3,4,1,-6,2,8,-3,1,4,0,-19,272,-4,5,1,-2,0,1,-1,1,1,1,2,1
KR_6761709361,440,3,21,19,15,4,4,0,1,3,2,4,5,1,6,7,1,0,0,0,0,13,8,5,2,7,-1,0,1,1,1,1,1,5,1
KR_6762098421,420,1,26,12,1,4,6,2,-3,0,3,2,3,1,-1,1,2,-1,0,1,0,-4,-58,-1,8,7,36,0,2,-1,1,1,1,2,1
KR_6758125955,420,-1,-75,3,-1,-3,4,7,2,2,0,1,4,3,0,3,3,-1,0,1,0,7,1,-3,7,4,0,0,-1,1,-1,-1,-1,2,1
KR_6760430808,420,1,0,0,1,1,2,1,-2,0,2,-3,0,3,5,6,1,0,1,1,0,2,13,1,2,3,-6,0,1,-1,1,1,-1,4,1
KR_6683601617,420,0,67,0,1,3,4,1,0,4,4,-2,1,3,-1,0,1,1,1,0,0,2,1,1,2,3,0,0,0,1,1,0,-1,3,1
KR_6742966246,420,0,-70,25,-1,1,3,2,0,6,6,0,1,1,-3,1,4,1,1,0,0,-2,46,-3,5,2,1,0,0,-1,1,1,1,6,1
KR_6615503268,420,6,124,-9,16,5,7,2,5,5,0,4,4,0,0,3,3,2,2,0,0,9,-57,3,3,6,2,1,4,1,-1,1,1,5,1
KR_6725943880,420,6,11,21,10,5,5,0,0,2,2,1,2,1,4,5,1,0,0,0,0,11,-8,-1,4,3,4,0,3,1,1,1,1,4,1
KR_6761982817,420,3,7,1,6,-1,1,2,0,2,2,3,7,4,2,6,4,2,2,0,-1,3,28,-4,8,4,-5,0,1,0,0,1,-1,0,1
KR_6736371614,420,2,48,36,3,0,2,2,1,4,3,2,3,1,0,1,1,0,1,1,1,2,-1,-4,6,2,3,0,2,1,-1,1,1,4,1
KR_6747397523,420,4,30,14,11,5,6,1,2,4,2,2,3,1,3,4,1,-1,2,3,0,6,2,-1,2,1,2,0,2,0,1,1,1,0,1
KR_6763044650,440,3,1,-4,9,4,4,0,-1,2,3,6,6,0,-1,2,3,1,3,2,1,3,1,1,5,6,2,0,1,0,1,1,1,0,1
KR_6762405616,420,1,0,-13,10,2,3,1,3,3,0,-2,1,3,4,4,0,3,3,0,0,12,-3,2,4,6,5,0,2,1,0,1,1,3,1
KR_6738233499,440,7,94,44,13,3,3,0,7,10,3,-2,3,5,5,11,6,0,0,0,-1,12,-97,4,2,6,7,0,2,1,1,1,-1,5,1
KR_6728504710,420,5,41,-8,11,-4,2,6,3,4,1,9,10,1,2,3,1,1,2,1,0,13,48,-5,7,2,-24,0,-1,1,-1,-1,-1,4,1
KR_6641153552,420,2,-23,-21,10,6,6,0,1,3,2,-2,2,4,5,5,0,0,0,0,0,17,-30,1,2,3,3,0,1,1,0,1,-1,5,1
KR_6751940531,420,3,19,49,6,-2,0,2,2,3,1,6,6,0,0,2,2,0,0,0,1,2,5,1,4,5,3,0,2,1,1,1,1,3,1
KR_6709851668,420,8,92,43,17,0,2,2,5,7,2,3,3,0,10,10,0,-1,1,2,2,20,1,-1,4,3,-1,0,2,1,0,1,1,2,1
KR_6757640065,440,-1,14,-12,-3,2,2,0,0,0,0,-13,0,13,7,8,1,1,1,0,1,2,-15,-1,2,1,2,0,0,0,0,-1,1,0,1
KR_6759635655,420,6,90,26,10,2,4,2,2,4,2,4,4,0,3,3,0,-1,0,1,1,17,9,-1,4,3,-3,0,2,1,1,1,1,4,1
KR_6737196746,420,1,23,4,3,0,1,1,-1,3,4,5,5,0,-2,1,3,1,1,0,0,-3,27,-1,7,6,-8,0,1,1,-1,1,1,6,1
KR_6747078560,420,0,-69,-8,1,0,3,3,0,4,4,2,3,1,-2,1,3,1,4,3,0,-1,0,-1,3,2,0,0,0,-1,0,0,1,4,1
KR_6764556115,440,3,40,7,11,-1,3,4,2,3,1,-1,2,3,9,9,0,2,2,0,3,17,24,8,0,8,1,0,3,-1,1,1,1,3,1
KR_6714305061,420,-1,-65,-4,1,-5,0,5,3,4,1,3,5,2,0,2,2,0,0,0,0,5,3,3,3,6,-2,0,0,1,1,0,-1,6,1
KR_6759618663,440,4,5,21,13,1,3,2,7,7,0,1,3,2,0,2,2,4,4,0,0,16,-170,1,5,6,0,0,0,1,0,0,1,4,1
KR_6658894914,420,2,-23,-16,7,-2,2,4,4,6,2,0,2,2,3,4,1,2,2,0,0,5,19,2,3,5,-2,0,-1,1,-1,-1,-1,5,1
KR_6650679326,420,4,7,-5,7,0,2,2,-2,4,6,3,4,1,3,4,1,3,3,0,0,4,0,-2,6,4,-1,0,-1,-1,1,-1,1,5,1
KR_6750108839,420,0,51,-25,-1,-1,2,3,1,5,4,1,2,1,-3,1,4,1,3,2,0,2,-12,0,3,3,0,0,2,-1,1,1,1,6,1
KR_6742002083,420,3,65,-4,10,1,1,0,7,8,1,2,2,0,1,3,2,-1,1,2,0,7,-1,-4,6,2,1,0,0,1,-1,1,1,5,1
KR_6743174734,420,3,27,24,4,2,4,2,5,9,4,0,3,3,-2,2,4,-1,5,6,0,4,4,0,2,2,0,0,2,-1,1,1,1,4,1
KR_6744837405,420,2,-14,8,3,1,3,2,2,2,0,-1,0,1,1,3,2,0,2,2,0,5,-31,1,6,7,1,0,0,-1,1,0,-1,3,1
KR_6699747415,420,4,18,24,10,-2,3,5,5,7,2,0,3,3,2,2,0,5,6,1,0,13,35,1,3,4,-1,0,1,1,0,1,1,2,1
KR_6706751652,440,2,25,20,8,2,3,1,2,4,2,6,6,0,-2,3,5,0,0,0,0,5,-3,-2,4,2,3,0,0,1,-1,0,1,3,1
KR_6689825271,420,1,13,10,4,-3,0,3,5,6,1,5,6,1,-1,4,5,-2,0,2,1,-4,0,0,3,3,-1,0,1,-1,1,1,1,4,1
KR_6760820864,420,2,13,-4,9,2,4,2,1,3,2,1,4,3,6,7,1,-1,3,4,1,15,6,0,3,3,-2,0,1,0,1,1,1,0,1
KR_6566815737,420,1,31,24,1,-5,1,6,4,5,1,-2,2,4,0,1,1,4,4,0,1,9,23,1,3,4,3,0,0,1,-1,0,1,3,1
KR_6738399083,440,0,-7,0,4,1,2,1,-1,1,2,3,4,1,0,3,3,1,2,1,0,9,3,-3,8,5,5,0,0,-1,1,0,1,4,1
KR_6719270275,440,2,-13,-7,6,3,4,1,4,4,0,-1,1,2,0,2,2,0,2,2,0,9,-2,-1,5,4,5,0,1,0,1,1,1,0,1
KR_6698283928,420,0,81,-2,-2,1,2,1,-1,2,3,4,5,1,2,7,5,-8,0,8,-1,-11,-8,-5,8,3,3,0,1,-1,-1,1,-1,1,1
KR_6762638342,420,2,-64,-19,16,-2,0,2,2,4,2,5,5,0,8,10,2,3,6,3,0,7,64,1,2,3,3,0,0,1,1,1,1,4,1
KR_6752871949,420,6,90,32,12,3,3,0,7,9,2,5,10,5,-3,0,3,0,1,1,1,8,-10,1,4,5,-1,0,1,1,1,1,1,1,1
KR_6680124795,420,1,-59,28,4,0,0,0,5,8,3,2,2,0,-1,1,2,-2,0,2,1,12,-4,2,7,9,1,0,-1,1,-1,-1,1,3,1
KR_6763516692,440,3,17,4,12,1,3,2,2,4,2,6,7,1,3,5,2,0,3,3,0,6,2,2,3,5,-3,0,1,-1,1,1,1,5,1
KR_6648119370,420,-2,-43,8,-3,-2,1,3,-4,1,5,1,1,0,4,5,1,-2,0,2,0,-3,35,1,5,6,5,0,1,1,1,1,-1,1,1
KR_6760995135,420,4,1,20,15,4,4,0,8,8,0,5,6,1,-2,4,6,0,0,0,0,12,4,2,4,6,0,0,-1,1,1,-1,1,2,1
KR_6723772226,440,2,34,24,0,2,3,1,3,6,3,-1,1,2,-3,2,5,-1,0,1,0,2,4,2,3,5,-3,0,0,1,0,0,-1,2,1
KR_6659742952,420,1,30,7,0,2,4,2,-1,3,4,0,0,0,-1,1,2,0,1,1,0,-2,2,0,3,3,0,0,0,1,-1,0,1,5,1
KR_6730345324,420,6,87,29,14,5,5,0,3,4,1,-1,1,2,4,9,5,3,3,0,0,7,41,-3,5,2,-11,0,4,1,-1,1,1,3,1
KR_6690463429,420,4,70,-32,11,1,1,0,0,4,4,3,3,0,6,6,0,1,1,0,0,15,-107,-2,5,3,2,0,1,1,1,1,-1,4,1
KR_6650958601,420,0,-8,7,-5,2,4,2,-3,2,5,0,1,1,-4,2,6,0,2,2,0,-6,-5,-3,6,3,-1,0,0,-1,-1,1,1,1,1
KR_6762239420,420,4,-56,30,6,0,1,1,3,4,1,-1,1,2,2,3,1,2,2,0,0,6,20,-1,2,1,-1,0,0,1,0,1,1,5,1
KR_6701529282,440,1,1,16,4,-2,0,2,0,7,7,3,3,0,-1,4,5,4,5,1,0,4,-5,1,4,5,-2,0,0,1,1,0,1,3,1
KR_6752591407,420,-1,18,9,0,0,2,2,1,2,1,0,0,0,-1,4,5,0,2,2,0,-5,15,2,5,7,-6,0,-1,1,-1,-1,1,4,1
KR_6760118526,420,2,56,1,12,3,7,4,4,6,2,1,4,3,6,8,2,-2,3,5,1,16,8,1,3,4,5,0,0,1,-1,1,1,1,1
KR_6635468309,420,2,-55,27,4,1,2,1,-6,1,7,5,5,0,4,5,1,0,0,0,1,10,0,-4,8,4,0,0,-1,-1,-1,-1,1,6,1
KR_6757305014,420,2,66,30,2,-1,2,3,2,4,2,1,1,0,2,5,3,-2,1,3,-1,0,125,1,2,3,-3,0,0,-1,-1,1,-1,4,1
KR_6761857890,420,0,-37,81,-4,-2,1,3,-1,2,3,1,2,1,1,5,4,-3,0,3,0,0,0,1,5,6,5,0,1,0,0,1,-1,0,1
KR_6756470585,420,0,-7,14,6,-3,0,3,-2,2,4,3,3,0,1,1,0,7,7,0,1,5,-6,-2,6,4,1,0,0,1,-1,1,1,4,1
KR_6658038780,420,0,27,43,-4,-4,1,5,8,9,1,-3,0,3,-3,0,3,-2,2,4,0,-5,14,1,3,4,-8,0,-1,1,-1,-1,-1,1,1
KR_6764082500,440,3,32,21,9,-1,2,3,1,1,0,1,2,1,5,6,1,3,3,0,0,12,43,5,3,8,-20,0,2,1,1,1,1,5,1
KR_6674727163,420,0,13,19,0,4,4,0,3,4,1,-1,2,3,-4,1,5,-2,1,3,0,-5,-4,-3,6,3,4,0,0,1,1,1,-1,2,1
KR_6685857850,420,3,45,41,4,3,3,0,0,5,5,-1,5,6,2,4,2,0,1,1,0,3,16,-4,7,3,3,0,0,-1,-1,-1,-1,1,1
KR_6756309893,420,-1,20,16,-12,-1,3,4,-1,1,2,-3,1,4,-8,1,9,1,3,2,1,-13,26,-2,5,3,-22,0,-1,1,-1,-1,1,4,1
KR_6655786235,420,1,-17,19,3,1,2,1,-2,2,4,1,1,0,1,1,0,2,2,0,1,6,-2,4,6,10,-3,0,1,-1,0,1,1,5,1
KR_6746715061,420,3,67,7,8,3,4,1,1,4,3,2,3,1,1,1,0,1,1,0,0,2,9,1,5,6,3,0,1,1,-1,1,1,3,1
KR_6763605436,420,0,-35,-42,7,2,2,0,0,2,2,4,4,0,1,4,3,0,1,1,0,9,-8,-3,6,3,2,0,0,-1,-1,0,1,3,1
KR_6749576153,420,2,86,0,2,-2,0,2,2,3,1,-2,0,2,3,3,0,1,2,1,0,7,0,1,1,2,0,0,0,1,-1,0,1,6,1
KR_6706509464,420,0,13,4,-2,4,4,0,3,4,1,-3,0,3,-4,0,4,-2,0,2,0,-10,5,0,4,4,-2,0,-1,1,-1,-1,-1,4,1
KR_6647989730,420,0,-30,32,-3,0,3,3,3,4,1,-1,0,1,-3,1,4,-2,0,2,-1,-7,-40,-2,6,4,-4,0,0,1,-1,0,-1,6,1
KR_6763302334,440,2,-20,-15,4,4,4,0,0,0,0,1,4,3,1,1,0,-2,0,2,1,7,20,4,5,9,1,0,0,-1,1,1,1,6,1
KR_6684907579,420,0,-3,-13,0,4,5,1,1,3,2,-4,1,5,2,5,3,-3,0,3,-1,-3,-10,-3,6,3,3,0,-1,1,-1,-1,-1,5,1
KR_6763634676,420,3,23,4,6,-3,0,3,0,2,2,5,5,0,0,1,1,4,4,0,0,12,7,4,0,4,1,0,2,1,1,1,-1,2,1
KR_6762100735,440,1,-68,-4,9,-1,1,2,2,3,1,1,2,1,5,5,0,2,3,1,0,7,2,0,2,2,-3,0,1,0,1,1,1,0,1
KR_6762985410,420,1,18,20,0,-1,3,4,-1,1,2,1,2,1,2,3,1,-1,0,1,0,2,-41,0,5,5,6,0,0,0,0,0,-1,0,1
KR_6733198781,420,6,87,7,11,4,4,0,-4,0,4,-1,2,3,8,10,2,4,4,0,0,13,13,1,2,3,4,0,1,1,0,1,-1,5,1
KR_6722625062,420,2,33,-3,5,1,3,2,2,4,2,-1,0,1,3,3,0,0,0,0,0,7,287,-2,5,3,19,0,1,-1,1,1,-1,5,1
KR_6747900707,420,0,6,-8,-3,1,1,0,0,4,4,5,5,0,-5,0,5,-4,0,4,0,-9,-14,-7,8,1,3,0,0,1,1,1,-1,3,1
KR_6725121783,440,0,-12,-6,1,-2,2,4,-4,2,6,2,2,0,7,7,0,-2,1,3,0,7,-15,3,3,6,-2,0,-1,1,-1,-1,1,2,1
KR_6763342004,420,1,23,8,4,5,6,1,-3,0,3,2,2,0,2,4,2,-2,0,2,0,-5,-4,-3,7,4,-3,0,1,1,-1,1,-1,1,1
KR_6758071161,420,3,-13,15,3,5,5,0,2,5,3,-3,2,5,2,2,0,-3,0,3,0,1,-2,-6,7,1,3,0,0,1,-1,1,1,3,1
KR_6719077147,420,7,162,35,15,0,2,2,2,4,2,7,9,2,7,8,1,-1,1,2,0,13,36,-1,5,4,3,0,1,1,-1,1,1,4,1
KR_6698608048,420,1,-42,3,-2,5,5,0,1,1,0,2,2,0,-9,3,12,-1,0,1,0,-7,-325,4,4,8,3,0,-3,1,-1,-1,-1,3,1
KR_6752166145,420,3,4,10,4,4,5,1,3,3,0,-1,0,1,0,2,2,-2,0,2,0,3,-15,3,2,5,-3,0,0,-1,1,1,-1,1,1
KR_6764392159,420,5,82,4,14,5,7,2,5,5,0,2,5,3,2,3,1,0,0,0,2,14,-16,0,4,4,5,0,1,1,1,1,1,2,1
KR_6764362739,440,0,-18,20,10,2,6,4,1,1,0,7,7,0,-2,2,4,2,2,0,0,8,13,4,0,4,-3,0,0,1,1,-1,1,3,1
KR_6763926615,420,1,65,-30,5,0,2,2,3,4,1,2,6,4,2,4,2,-2,1,3,0,14,10,2,5,7,3,0,1,-1,-1,1,-1,2,1
KR_6754319409,420,6,63,20,15,8,8,0,4,5,1,3,4,1,2,7,5,-2,1,3,0,6,1,5,0,5,3,0,3,1,1,1,1,4,1
KR_6761607506,420,-3,-53,-16,-6,-2,1,3,2,5,3,0,0,0,-4,2,6,-2,1,3,0,-4,-4,-1,7,6,1,0,-1,1,-1,-1,1,3,1
KR_6763775342,420,3,56,28,6,4,4,0,5,5,0,-2,3,5,-2,0,2,1,1,0,0,2,-3,-4,6,2,-1,0,0,1,1,1,1,4,1
KR_6414962066,420,2,24,20,-2,1,4,3,-2,2,4,-1,2,3,-1,2,3,1,4,3,0,0,-8,-3,6,3,4,0,0,-1,-1,0,-1,3,1
KR_6735245611,420,7,36,-16,13,1,3,2,6,9,3,0,4,4,3,4,1,3,4,1,1,10,14,2,5,7,-3,0,3,1,1,1,1,6,1
KR_6726832041,420,0,46,24,-1,2,3,1,1,1,0,0,1,1,-3,0,3,-1,1,2,0,-4,-1,-1,2,1,-1,0,0,-1,1,1,-1,3,1
KR_6756372558,440,4,-24,-1,9,3,7,4,5,6,1,1,3,2,2,3,1,-2,2,4,0,5,-10,-3,4,1,-1,0,1,-1,1,1,1,3,1
KR_6752320052,420,1,48,-4,-5,0,1,1,-3,0,3,-5,0,5,3,3,0,0,2,2,0,-6,-6,-2,5,3,0,0,0,1,-1,-1,-1,4,1
KR_6763112335,420,2,25,31,1,2,2,0,-4,3,7,-1,1,2,2,4,2,2,2,0,0,8,-321,6,2,8,1,0,0,1,-1,1,1,1,1
KR_6730808933,420,5,46,9,5,1,2,1,3,6,3,-3,1,4,7,8,1,-3,0,3,0,4,9,4,3,7,0,0,1,1,-1,1,1,6,1
KR_6758894619,420,0,-18,-12,2,-2,0,2,0,2,2,0,5,5,4,8,4,0,1,1,0,10,5,1,3,4,0,0,0,-1,1,1,-1,1,1
KR_6762383300,420,4,-44,5,7,0,2,2,5,6,1,0,2,2,0,4,4,2,3,1,0,7,-15,3,1,4,0,0,1,-1,1,1,-1,1,1
KR_6755792559,420,0,-18,0,4,-3,0,3,-2,5,7,2,3,1,8,11,3,-1,0,1,0,3,24,0,6,6,-3,0,-1,-1,1,-1,1,4,1
KR_6620881806,420,4,47,-8,12,4,4,0,7,8,1,-2,2,4,0,3,3,3,3,0,0,14,19,1,4,5,0,0,-1,1,-1,-1,-1,5,1
KR_6764479737,420,0,5,5,-4,1,1,0,-5,2,7,0,1,1,1,4,3,-1,2,3,1,-6,-19,2,2,4,-4,0,0,-1,1,0,1,5,1
KR_6735338472,420,-3,-54,-12,-10,-4,0,4,0,2,2,3,3,0,-8,2,10,-1,0,1,0,-7,6,1,2,3,-2,0,-2,-1,-1,-1,-1,2,1
KR_6755694716,440,7,42,56,9,4,5,1,-2,1,3,3,5,2,4,5,1,0,2,2,0,7,-1,7,3,10,-3,0,1,1,1,1,1,1,1
KR_6734271351,440,2,66,15,3,1,2,1,-4,0,4,1,1,0,4,6,2,1,1,0,0,-4,10,0,3,3,-3,0,0,1,0,0,1,4,1
KR_6638492322,420,2,41,-3,4,-1,1,2,-2,2,4,3,6,3,4,4,0,0,1,1,0,1,-5,4,2,6,-2,0,0,1,-1,-1,-1,3,1
KR_6760146970,420,2,-68,8,4,3,3,0,1,3,2,0,3,3,-4,2,6,4,4,0,0,3,-1,1,6,7,0,0,-1,1,0,-1,1,5,1
KR_6709607496,440,6,64,41,11,6,7,1,2,4,2,1,2,1,2,3,1,0,0,0,0,4,3,3,3,6,0,1,3,0,1,1,1,0,1
KR_6749051370,440,1,-26,-4,6,2,3,1,0,1,1,2,4,2,1,2,1,1,2,1,2,8,4,2,3,5,-3,0,0,-1,1,0,1,3,1
KR_6744236634,420,-1,-4,2,-5,2,3,1,-4,1,5,-2,0,2,-1,2,3,0,2,2,0,-7,113,-4,6,2,1,0,1,-1,1,1,1,4,1
KR_6740564887,420,1,1,-4,4,2,3,1,4,5,1,0,3,3,-4,3,7,2,3,1,0,2,-23,-5,10,5,5,0,1,1,0,1,1,3,1
KR_6735208444,420,2,55,9,4,-2,1,3,0,2,2,-2,1,3,6,9,3,2,3,1,0,4,5,-2,4,2,-2,0,0,-1,1,1,1,5,1
KR_6753692534,420,3,7,34,6,-1,1,2,0,2,2,7,10,3,-1,0,1,1,2,1,0,4,7,1,3,4,-2,0,3,1,1,1,1,6,1
KR_6596832852,420,3,-14,12,2,2,3,1,5,8,3,-1,1,2,-2,1,3,-2,0,2,-1,-1,1,-3,5,2,-1,0,3,-1,1,1,-1,3,1
KR_6746868167,420,1,-42,-17,7,3,3,0,1,3,2,-3,0,3,6,6,0,0,0,0,0,7,-4,1,4,5,4,0,1,-1,1,1,1,3,1
KR_6748193143,420,3,-16,24,6,2,4,2,3,3,0,1,2,1,-2,0,2,2,3,1,0,5,-1,-1,5,4,-3,0,0,0,1,-1,1,0,1
KR_6740164316,420,3,28,8,0,1,2,1,3,4,1,-2,0,2,-3,0,3,1,2,1,0,2,121,1,4,5,-2,0,0,1,1,0,-1,1,1
KR_6698425403,420,6,119,48,9,2,3,1,0,6,6,6,7,1,0,5,5,1,1,0,2,8,-6,-6,10,4,6,0,2,1,1,1,1,3,1
KR_6760665363,440,-1,-3,6,1,1,1,0,-4,1,5,1,1,0,-3,1,4,6,6,0,0,3,5,-3,6,3,-4,0,1,-1,-1,-1,1,5,1
KR_6695720645,420,-1,26,31,1,-1,1,2,0,2,2,-3,4,7,2,2,0,3,5,2,0,4,50,-2,6,4,-35,0,0,1,0,0,1,6,1
KR_6739073788,420,2,-26,24,5,-2,0,2,-3,5,8,4,5,1,5,5,0,1,1,0,0,7,6,-1,5,4,8,0,1,1,0,1,1,5,1
KR_6574513389,420,-1,-22,7,-4,-2,2,4,-3,2,5,1,1,0,-3,1,4,3,3,0,0,-3,-1,0,6,6,0,0,0,-1,0,-1,-1,1,1
KR_6660121388,420,1,80,-1,1,0,0,0,-6,1,7,1,3,2,6,7,1,0,0,0,0,2,-20,-1,5,4,4,0,2,1,-1,1,-1,3,1
KR_6680210809,420,0,25,-52,1,-2,0,2,-5,4,9,-1,1,2,7,9,2,2,2,0,-1,8,3,-7,11,4,2,0,3,-1,1,1,-1,2,1
KR_6764233317,420,0,-71,-28,2,3,4,1,3,4,1,1,1,0,-4,0,4,-1,0,1,0,0,-2,-1,6,5,2,0,-1,0,1,-1,-1,0,1
KR_6745700054,420,3,26,4,9,-3,0,3,0,2,2,11,11,0,-1,1,2,2,3,1,1,12,-2,3,4,7,-4,0,0,1,-1,-1,1,6,1
KR_6751489280,420,1,13,20,-1,-5,0,5,3,3,0,-1,0,1,1,2,1,1,2,1,0,4,-28,-5,6,1,2,0,0,0,-1,-1,1,0,1
KR_6705747865,420,3,22,8,4,-1,2,3,-1,0,1,3,4,1,3,3,0,0,0,0,-1,1,3,4,2,6,2,0,2,1,1,1,-1,1,1
KR_6762285084,420,1,81,-21,1,1,1,0,-1,3,4,2,2,0,-1,2,3,0,1,1,0,0,-30,1,5,6,2,0,0,-1,1,0,1,4,1
KR_6756168547,420,0,3,-22,-11,-1,2,3,-3,3,6,-1,1,2,-6,3,9,0,2,2,0,-9,-5,-6,6,0,-2,0,0,-1,0,0,-1,3,1
KR_6619709394,420,0,33,-16,5,-4,0,4,0,2,2,2,4,2,6,7,1,1,2,1,-1,9,12,5,4,9,-1,0,0,1,0,0,-1,6,1
KR_6741635141,420,1,25,8,1,0,0,0,-4,2,6,1,1,0,3,4,1,1,1,0,0,0,3,4,2,6,0,0,1,1,1,1,1,1,1
KR_6739901431,420,5,102,13,8,-5,1,6,4,6,2,3,3,0,2,4,2,4,5,1,3,11,0,-3,7,4,0,0,3,-1,1,1,1,5,1
KR_6744425439,420,4,31,18,1,-4,1,5,1,2,1,0,1,1,4,6,2,0,3,3,1,3,-2,4,4,8,-3,0,1,1,-1,1,1,5,1
KR_6672613811,420,4,18,56,2,0,3,3,8,9,1,-2,3,5,-2,1,3,-2,1,3,0,-12,17,-4,5,1,-2,0,1,0,1,1,1,0,1
KR_6742055451,440,0,103,20,-3,6,6,0,-3,1,4,0,2,2,-4,3,7,-2,2,4,0,-7,-9,-2,3,1,2,0,0,1,0,-1,-1,6,1
KR_6652835316,420,4,39,4,10,3,3,0,4,5,1,1,1,0,1,3,2,1,1,0,0,6,17,-1,6,5,0,0,0,-1,1,1,1,2,1
KR_6761831465,440,5,85,33,19,4,5,1,4,4,0,0,6,6,10,14,4,1,1,0,3,19,-3,4,1,5,6,0,3,1,1,1,1,5,1
KR_6688768403,420,2,-34,32,2,1,1,0,1,4,3,-5,7,12,2,3,1,3,4,1,0,7,-8,2,4,6,21,0,0,-1,1,1,1,6,1
KR_6729032374,440,3,42,30,6,1,1,0,-2,2,4,1,5,4,-1,3,4,7,8,1,3,18,-5,-6,7,1,5,0,1,1,-1,1,1,6,1
KR_6761482460,420,0,27,4,2,7,7,0,-5,2,7,0,4,4,1,2,1,-1,0,1,1,-7,20,2,1,3,2,0,1,1,0,1,1,4,1
KR_6760207109,420,2,20,24,4,2,3,1,4,6,2,0,3,3,-1,1,2,-1,0,1,0,2,0,-2,6,4,1,0,1,1,1,1,1,6,1
KR_6733307004,440,3,46,-9,13,-2,1,3,2,4,2,4,6,2,3,6,3,6,8,2,0,8,-2,0,3,3,2,0,0,0,-1,0,-1,0,1
KR_6739799893,420,1,-46,-19,7,4,6,2,0,3,3,3,4,1,-1,2,3,1,3,2,-1,8,-30,-5,8,3,9,0,-1,-1,-1,-1,-1,2,1
KR_6763112985,420,4,25,-16,7,4,5,1,-2,0,2,1,5,4,3,3,0,1,2,1,1,6,2,4,5,9,-4,0,1,1,1,1,1,2,1
KR_6739243961,420,-1,-10,-8,1,2,3,1,-1,1,2,-3,2,5,3,6,3,0,3,3,0,4,5,0,3,3,-2,0,1,1,1,1,-1,2,1
KR_6755474264,420,2,71,17,8,0,2,2,2,5,3,1,1,0,6,7,1,-1,1,2,1,8,-6,2,1,3,1,0,0,0,1,1,-1,0,1
KR_6728078343,420,1,-20,5,4,-1,2,3,-1,2,3,1,1,0,5,7,2,0,1,1,0,8,-1,0,5,5,3,0,-1,0,-1,-1,1,0,1
KR_6706161152,420,2,3,-4,7,-1,1,2,3,3,0,-1,3,4,1,2,1,5,5,0,0,5,9,3,2,5,-2,0,1,1,-1,1,-1,6,1
KR_6763227268,420,-3,-26,-28,-2,-5,0,5,3,3,0,-1,0,1,1,1,0,0,0,0,0,-1,3,-2,7,5,0,0,0,-1,-1,0,1,4,1
KR_6683581297,440,6,129,26,11,-2,1,3,2,5,3,5,8,3,4,5,1,2,3,1,3,12,-5,-5,7,2,2,0,0,1,1,1,1,2,1
KR_6763534633,420,-1,33,-20,-3,-3,1,4,-3,1,4,-1,2,3,4,6,2,0,1,1,0,-7,8,-1,8,7,-2,0,0,-1,1,1,1,3,1
KR_6694794386,420,-4,-69,-20,0,-2,1,3,2,3,1,0,3,3,1,3,2,-1,1,2,0,0,6,-2,4,2,2,0,0,1,1,0,1,4,1
KR_6639369046,420,1,64,24,2,2,2,0,2,8,6,0,1,1,-2,1,3,0,0,0,0,-6,65,2,4,6,-2,0,1,-1,-1,1,1,5,1
KR_6752218922,420,4,82,19,8,0,4,4,-2,2,4,3,3,0,4,5,1,3,3,0,0,7,1,4,2,6,3,0,2,1,1,1,1,4,1
KR_6704107937,420,3,87,13,5,7,7,0,-1,3,4,0,2,2,-2,4,6,1,2,1,0,-9,-7,-2,5,3,1,0,2,1,1,1,-1,3,1
KR_6763541958,420,5,44,0,4,3,4,1,0,1,1,-1,4,5,1,3,2,1,2,1,-1,7,56,2,4,6,2,0,0,-1,1,1,-1,4,1
KR_6758967267,440,5,-14,13,16,6,6,0,-2,3,5,1,3,2,10,10,0,1,2,1,0,11,-1,1,2,3,2,0,1,1,1,1,-1,2,1
KR_6762496647,420,0,23,-56,0,7,7,0,-4,0,4,-3,2,5,0,1,1,0,0,0,0,4,8,3,3,6,-4,0,1,1,-1,1,1,6,1
KR_6761105721,420,1,40,12,2,-1,1,2,0,3,3,4,4,0,-1,2,3,0,1,1,1,6,12,-1,9,8,3,0,0,1,-1,0,1,6,1
KR_6653179789,420,-2,12,-4,1,1,2,1,2,2,0,-3,1,4,2,2,0,-1,0,1,0,6,-22,4,1,5,2,0,1,1,1,1,1,4,1
KR_6357082756,420,0,6,4,2,0,1,1,0,5,5,-1,1,2,3,3,0,0,0,0,0,8,0,0,0,0,13,0,0,1,-1,0,-1,3,1
KR_6761716139,420,1,3,7,6,9,10,1,1,4,3,1,2,1,-6,2,8,1,2,1,-1,1,4,2,4,6,1,0,1,1,1,1,-1,2,1
KR_6749216060,420,3,117,4,-1,-1,2,3,0,5,5,-1,1,2,2,2,0,-1,0,1,0,0,2,-1,4,3,1,0,0,1,0,0,-1,4,1
KR_6603758924,420,5,71,-30,10,3,3,0,1,1,0,-1,3,4,5,7,2,2,3,1,0,16,-148,4,2,6,1,0,-1,1,-1,-1,1,2,1
KR_6762368982,420,-2,-19,12,-5,-1,3,4,1,4,3,-3,1,4,-2,0,2,0,0,0,0,-8,12,3,4,7,0,0,0,-1,1,0,-1,5,1
KR_6757064737,420,-1,18,32,8,0,2,2,2,4,2,2,2,0,5,7,2,-1,4,5,1,12,-2,3,1,4,0,0,0,1,0,0,1,3,1
KR_6710279339,420,5,94,4,9,4,4,0,3,3,0,2,2,0,3,5,2,-3,0,3,0,6,0,0,5,5,5,0,1,0,1,1,1,0,1
KR_6740615898,420,0,23,12,3,-2,2,4,1,6,5,-1,4,5,0,3,3,5,6,1,0,5,5,1,3,4,-2,0,1,-1,-1,1,1,1,1
KR_6414475037,420,6,84,25,18,7,7,0,-1,0,1,4,5,1,7,7,0,1,1,0,0,12,12,-2,2,0,0,0,3,1,0,1,1,4,1
KR_6720134990,420,1,4,18,1,2,3,1,-1,2,3,-1,2,3,2,4,2,-1,1,2,0,-1,20,-1,2,1,3,0,0,1,1,-1,1,1,1
KR_6759545047,420,0,-19,13,1,-2,0,2,0,1,1,5,5,0,-1,0,1,-1,0,1,0,6,-1,-3,8,5,2,0,-1,-1,1,-1,1,6,1
KR_6756539208,420,1,-60,22,4,1,2,1,-1,1,2,-2,3,5,4,8,4,2,3,1,0,-8,1,-1,4,3,-4,0,0,-1,1,0,-1,5,1
KR_6749563264,420,7,61,10,13,-1,1,2,4,4,0,3,3,0,5,6,1,2,2,0,0,11,9,3,3,6,-5,0,1,-1,1,1,1,4,1
KR_6713966568,420,4,119,17,5,-2,0,2,4,4,0,3,5,2,1,2,1,-1,0,1,0,1,-26,-1,4,3,8,0,1,1,0,1,1,2,1
KR_6747489906,440,-3,-23,10,0,-6,0,6,2,4,2,5,7,2,-2,3,5,1,1,0,0,1,45,-1,4,3,-19,0,0,1,0,0,-1,1,1
KR_6639406463,420,4,77,-10,3,2,4,2,0,3,3,-1,0,1,1,2,1,1,3,2,0,1,4,2,5,7,3,0,1,1,0,1,1,6,1
KR_6648345959,420,3,10,12,2,-1,2,3,-1,2,3,1,2,1,3,4,1,0,1,1,0,5,8,5,2,7,-2,0,0,1,-1,0,1,2,1
KR_6665272254,420,1,-25,-1,-2,-2,0,2,-2,1,3,0,2,2,1,2,1,1,1,0,0,4,-6,-3,7,4,-4,0,0,-1,-1,-1,-1,3,1
KR_6746069738,420,1,6,8,4,1,1,0,7,8,1,2,4,2,-3,0,3,-3,1,4,0,8,3,0,6,6,-5,0,-1,1,-1,-1,-1,2,1
KR_6671639942,420,-1,45,6,2,-2,2,4,1,4,3,-2,1,3,3,4,1,2,2,0,0,3,-205,-1,3,2,-14,0,0,-1,1,1,1,4,1
KR_6757964879,420,1,-4,0,1,0,1,1,-2,1,3,2,3,1,5,8,3,-4,0,4,0,-10,-6,-2,6,4,2,0,0,1,1,1,1,3,1
KR_6758377065,420,1,35,27,1,1,3,2,-2,1,3,2,5,3,0,7,7,0,0,0,0,-4,-2,-1,4,3,3,0,0,-1,1,1,-1,4,1
KR_6728945022,440,2,28,16,3,2,2,0,-1,3,4,1,2,1,-1,2,3,2,6,4,0,3,-1,3,3,6,-1,0,0,-1,1,0,1,2,1
KR_6752293653,420,-1,9,20,7,0,2,2,4,5,1,3,4,1,2,6,4,-2,0,2,0,13,1,3,2,5,-1,0,-1,1,-1,-1,1,3,1
KR_6760482815,420,2,24,0,5,1,3,2,4,4,0,2,3,1,3,6,3,-5,2,7,0,8,-5,-1,5,4,9,0,0,-1,1,-1,1,1,1
KR_6731186315,420,1,29,36,0,2,2,0,2,4,2,1,1,0,-4,2,6,-1,0,1,0,2,119,6,3,9,-2,0,0,1,1,1,1,6,1
KR_6666429759,420,1,6,-11,4,1,5,4,-3,0,3,3,7,4,2,4,2,1,1,0,0,12,4,0,8,8,-3,0,-1,1,-1,-1,1,1,1
KR_6754430823,420,5,32,-19,9,-1,2,3,0,1,1,8,8,0,4,5,1,-2,1,3,0,3,8,3,4,7,3,0,1,1,1,1,1,5,1
KR_6763697824,420,2,2,24,7,0,2,2,0,1,1,3,5,2,2,3,1,2,4,2,0,13,-54,-6,10,4,36,0,2,-1,1,1,1,6,1
KR_6761160994,420,1,36,6,12,1,2,1,4,4,0,3,6,3,3,3,0,1,1,0,1,14,0,-2,5,3,2,0,0,-1,1,0,1,4,1
KR_6688313050,420,-2,61,-23,-4,-4,0,4,-1,3,4,-1,2,3,2,2,0,0,2,2,1,-9,-178,1,5,6,-11,0,0,1,-1,-1,1,1,1
KR_6522325443,420,5,80,44,12,2,3,1,0,2,2,2,3,1,6,8,2,2,2,0,0,13,-9,-2,2,0,-1,0,2,1,1,1,1,3,1
KR_6757623018,420,-3,-25,-72,-8,1,5,4,0,2,2,-5,1,6,-2,1,3,-2,0,2,0,-6,4,2,0,2,-2,0,0,-1,-1,1,1,5,1
KR_6728711748,440,1,-29,17,-1,3,4,1,4,5,1,0,1,1,-4,0,4,-4,1,5,0,1,-12,-1,4,3,3,0,0,1,0,-1,-1,5,1
KR_6761575753,420,4,34,32,1,1,3,2,0,2,2,-3,0,3,6,7,1,-3,0,3,0,1,-321,-1,2,1,1,0,2,1,1,1,-1,6,1
KR_6438739965,420,2,59,15,7,0,2,2,4,5,1,-1,0,1,2,3,1,2,2,0,0,10,308,0,4,4,2,0,0,1,1,-1,1,6,1
KR_6677246400,420,9,141,59,21,5,5,0,2,4,2,4,6,2,2,3,1,8,9,1,0,16,47,1,4,5,-22,0,3,1,1,1,1,5,1
KR_6765015287,420,0,80,-4,-3,2,2,0,-4,0,4,1,1,0,-4,0,4,2,2,0,0,-5,4,1,3,4,-8,0,1,1,1,1,1,4,1
KR_6757824748,420,4,64,8,-1,1,2,1,-1,1,2,-2,2,4,0,4,4,1,2,1,0,-6,5,-3,8,5,3,0,0,1,-1,0,1,3,1
KR_6756912242,420,-3,-38,-8,-15,-2,1,3,-6,0,6,-3,2,5,-2,2,4,-2,2,4,0,-18,4,-6,7,1,0,0,-1,-1,0,-1,-1,2,1
KR_6724934182,420,1,57,-12,5,-3,1,4,0,2,2,3,4,1,-1,1,2,6,7,1,0,5,47,1,3,4,-28,0,1,-1,1,1,1,1,1
KR_6755411246,420,2,1,-5,7,3,6,3,-2,2,4,5,6,1,2,4,2,-1,1,2,0,11,-12,6,2,8,0,0,3,1,1,1,1,1,1
KR_6764373256,420,-1,33,-20,1,3,4,1,-3,0,3,-1,1,2,2,4,2,0,1,1,0,0,0,-3,5,2,-2,0,1,1,-1,1,1,1,1
KR_6763482680,440,4,78,53,7,1,3,2,2,6,4,0,2,2,1,5,4,3,6,3,0,4,3,2,1,3,0,0,0,0,0,1,1,0,1
KR_6747408112,420,5,31,12,4,-3,2,5,2,3,1,1,1,0,5,7,2,-1,1,2,0,4,7,-2,4,2,-1,0,1,1,1,1,-1,4,1
KR_6739803995,420,0,-82,33,5,3,3,0,4,7,3,0,1,1,0,3,3,-2,0,2,0,6,6,1,6,7,-2,0,-1,1,-1,-1,-1,4,1
KR_6622583110,420,-1,30,5,3,-2,1,3,1,3,2,2,4,2,2,3,1,0,3,3,0,0,-3,0,3,3,1,0,0,1,-1,0,1,5,1
KR_6714037227,420,2,28,25,6,-1,0,1,4,7,3,3,4,1,-1,0,1,1,1,0,0,2,29,0,6,6,-2,0,0,1,-1,1,1,6,1
KR_6763359066,440,3,31,8,7,1,3,2,1,4,3,4,5,1,0,1,1,1,3,2,0,12,2,2,1,3,-2,0,0,1,0,0,-1,5,1
KR_6748539469,420,1,47,5,-2,0,1,1,-5,1,6,1,3,2,2,5,3,0,0,0,0,3,-5,-4,10,6,0,0,1,-1,1,1,-1,6,1
KR_6734991528,420,4,13,12,11,1,2,1,-1,0,1,9,9,0,2,3,1,0,1,1,0,10,-110,0,4,4,2,0,1,-1,1,1,1,4,1
KR_6662063872,420,3,-54,17,4,1,1,0,4,5,1,1,2,1,-2,0,2,0,0,0,0,7,101,0,2,2,2,0,0,0,1,1,1,0,1
KR_6763339233,420,-1,57,24,1,0,0,0,-1,2,3,0,0,0,3,5,2,-1,0,1,0,2,2,3,3,6,-3,0,0,-1,1,0,-1,1,1
KR_6763319448,420,-1,2,8,2,2,2,0,2,3,1,-2,0,2,-1,1,2,1,6,5,0,6,-2,-1,4,3,19,0,0,1,0,0,-1,4,1
KR_6692160281,420,6,46,28,8,-1,2,3,4,4,0,5,6,1,1,2,1,-1,3,4,0,8,8,2,2,4,4,0,-1,1,-1,-1,1,3,1
KR_6758060499,420,1,-25,28,6,3,4,1,0,2,2,-1,1,2,4,4,0,0,1,1,0,2,6,0,6,6,0,0,0,0,1,1,1,0,1
KR_6721857980,440,0,-39,-4,-8,-2,1,3,-5,1,6,1,2,1,-1,2,3,-1,2,3,0,-1,255,2,3,5,-4,0,0,-1,-1,-1,-1,4,1
KR_6741839440,420,4,87,24,13,-1,1,2,8,10,2,2,3,1,4,5,1,0,1,1,0,19,-18,3,4,7,-1,0,2,1,1,1,1,5,1
KR_6764686976,420,-1,-56,0,-2,3,3,0,-6,1,7,2,3,1,-2,2,4,1,1,0,0,-7,-3,6,3,9,-1,0,0,-1,-1,0,-1,3,1
KR_6728825516,440,-1,-54,3,0,-1,1,2,0,6,6,2,2,0,3,5,2,-4,1,5,0,11,2,3,1,4,-1,0,0,1,1,-1,-1,2,1
KR_6760859213,420,2,-8,4,9,1,2,1,-1,3,4,8,8,0,1,2,1,0,1,1,0,3,8,2,2,4,-3,0,1,1,1,1,1,5,1
KR_6764378706,420,3,-37,17,6,0,2,2,6,8,2,4,4,0,-4,4,8,0,1,1,-1,1,1,0,6,6,3,0,2,-1,1,1,-1,3,1
KR_6673520220,420,3,22,56,0,1,3,2,-1,3,4,-3,0,3,1,2,1,2,3,1,1,-1,1,2,4,6,3,0,2,0,1,1,1,0,1
KR_6757160549,420,0,5,-7,2,-2,2,4,1,4,3,2,4,2,0,4,4,1,2,1,1,6,-77,0,4,4,21,0,-1,1,-1,-1,1,5,1
KR_6747416212,420,-1,-23,1,1,0,1,1,0,1,1,-3,2,5,7,9,2,-3,0,3,0,13,2,-2,6,4,1,0,-1,-1,-1,-1,-1,6,1
KR_6689180594,420,3,36,24,-3,1,4,3,-1,2,3,0,4,4,-3,1,4,0,3,3,0,-6,-9,-4,8,4,4,0,0,1,-1,-1,-1,2,1
KR_6671796064,420,2,73,-11,7,-1,1,2,2,5,3,4,4,0,2,4,2,0,0,0,0,7,-1,0,4,4,2,0,0,0,0,0,1,0,1
KR_6746378338,420,4,102,-16,11,-1,2,3,1,1,0,0,0,0,6,6,0,5,7,2,0,16,-1,-6,8,2,3,0,2,1,-1,1,1,2,1
KR_6752034750,420,3,47,32,0,-2,1,3,5,5,0,-1,0,1,-3,1,4,1,2,1,0,-4,-6,-8,8,0,-1,0,0,1,1,0,1,4,1
KR_6676815313,440,1,-43,38,4,-1,0,1,1,2,1,2,4,2,4,8,4,-2,0,2,0,4,26,0,5,5,-21,0,1,1,1,1,1,2,1
KR_6742159022,420,3,105,16,1,0,1,1,-2,0,2,-4,2,6,6,6,0,1,1,0,0,1,3,0,3,3,4,0,0,1,-1,-1,1,4,1
KR_6740160229,420,1,39,-23,6,0,0,0,2,3,1,-1,3,4,3,4,1,2,2,0,0,1,-7,1,4,5,3,0,1,1,0,1,1,3,1
KR_6519319546,420,0,69,-5,3,4,5,1,0,2,2,-1,2,3,1,5,4,-1,0,1,0,10,7,6,2,8,-2,0,-1,-1,-1,-1,1,2,1
KR_6695088695,420,0,63,13,1,-1,0,1,-1,1,2,2,2,0,0,2,2,1,1,0,0,1,1,5,2,7,-1,0,0,1,-1,0,1,4,1
KR_6681149415,420,2,-20,-12,3,0,2,2,0,1,1,1,3,2,1,1,0,1,2,1,0,3,-5,-1,9,8,2,0,0,-1,-1,0,1,1,1
KR_6737584905,420,-5,-91,-4,-11,-1,2,3,-1,2,3,-5,0,5,-1,5,6,-3,0,3,-1,-6,-231,1,1,2,-1,0,-1,1,-1,-1,-1,6,1
KR_6747509493,420,9,110,57,17,2,2,0,2,4,2,9,11,2,4,7,3,0,0,0,0,24,-111,-1,5,4,6,0,2,1,-1,1,1,5,1
KR_6740950158,420,1,80,-32,13,1,3,2,3,5,2,8,9,1,3,5,2,-2,0,2,2,11,-226,4,2,6,-4,0,1,1,-1,1,1,1,1
KR_6759982583,420,2,53,16,-1,-2,0,2,0,1,1,-5,0,5,4,6,2,2,2,0,0,3,-39,5,3,8,5,0,-1,1,-1,-1,1,4,1
KR_6667716720,420,-1,-49,-8,5,-3,0,3,0,2,2,2,4,2,3,3,0,3,4,1,0,11,-107,-3,10,7,3,0,0,0,1,0,-1,0,1
KR_6744664702,420,1,-29,8,-1,-1,1,2,1,4,3,-2,0,2,0,3,3,1,2,1,0,0,-90,-8,15,7,-1,0,0,-1,1,0,-1,2,1
KR_6731405339,420,5,113,13,13,-1,1,2,3,3,0,1,2,1,6,6,0,4,4,0,0,12,456,3,1,4,3,0,0,1,-1,-1,1,3,1
KR_6634101168,420,1,39,8,2,0,1,1,0,4,4,-2,2,4,2,4,2,2,2,0,0,2,144,2,3,5,2,0,1,1,1,1,1,1,1
KR_6753726939,420,1,2,68,-1,-2,0,2,4,4,0,2,3,1,-4,1,5,-1,1,2,1,-3,-217,-2,4,2,0,0,0,1,-1,1,1,5,1
KR_6659949276,420,2,-14,16,2,4,5,1,0,2,2,3,4,1,-5,1,6,0,0,0,-1,-2,-2,-1,5,4,6,0,2,1,1,1,-1,4,1
KR_6741276252,440,3,-14,16,11,0,2,2,1,3,2,2,5,3,6,8,2,2,2,0,-1,7,4,3,0,3,0,0,1,-1,1,1,-1,2,1
KR_6724702779,440,0,59,65,4,0,1,1,2,3,1,0,3,3,2,2,0,0,1,1,0,13,-7,-1,4,3,1,0,2,1,1,1,-1,1,1
KR_6733593618,420,1,-7,24,2,-2,0,2,1,2,1,-1,2,3,2,3,1,2,2,0,0,0,-7,1,2,3,0,0,1,1,1,1,1,4,1
KR_6759408185,420,5,104,-10,10,-1,0,1,4,5,1,3,4,1,1,2,1,3,3,0,0,10,198,1,3,4,-1,0,1,-1,1,1,1,6,1
KR_6713280674,420,2,19,-28,2,3,3,0,-1,2,3,-1,1,2,2,6,4,-1,0,1,-2,4,-2,3,6,9,1,0,1,-1,1,-1,-1,4,1
KR_6742855957,420,2,21,16,9,0,2,2,2,4,2,4,5,1,3,3,0,0,0,0,0,12,8,6,3,9,1,0,1,1,1,1,1,1,1
KR_6764936411,440,4,98,-8,8,2,2,0,1,4,3,2,2,0,0,3,3,3,4,1,0,9,-8,-5,8,3,4,0,1,1,1,1,-1,1,1
KR_6634794220,420,3,47,14,5,-2,0,2,3,3,0,2,2,0,1,2,1,1,2,1,0,4,-6,-2,6,4,0,0,0,1,1,1,1,1,1
KR_6734894434,420,1,-2,4,0,-2,1,3,3,4,1,0,3,3,-3,2,5,2,2,0,0,0,111,6,3,9,1,0,0,1,1,0,-1,1,1
KR_6662601505,420,1,-33,-14,3,-2,2,4,1,1,0,3,6,3,0,2,2,1,1,0,0,3,-2,-1,6,5,4,0,-1,0,0,-1,-1,0,1
KR_6683015632,420,1,0,-8,-3,1,1,0,0,2,2,1,2,1,-3,1,4,-2,1,3,0,-2,-128,-6,7,1,2,0,0,-1,1,-1,-1,1,1
KR_6704872371,420,-3,-31,-20,-1,0,1,1,3,4,1,-4,0,4,-1,3,4,1,2,1,-1,-2,-5,-4,6,2,-4,0,-2,-1,-1,-1,-1,4,1
KR_6695045601,420,5,96,-4,7,2,3,1,1,1,0,2,4,2,0,0,0,2,2,0,-1,9,119,4,2,6,3,0,2,1,1,1,-1,4,1
KR_6738387830,420,5,80,0,10,0,2,2,0,1,1,0,1,1,6,7,1,4,5,1,0,9,41,0,5,5,2,0,1,1,1,1,1,3,1
KR_6661814915,440,1,17,-24,6,-3,2,5,2,3,1,3,6,3,-1,6,7,5,7,2,-1,9,5,2,4,6,4,0,2,1,-1,1,-1,2,1
KR_6668271422,420,3,32,-8,4,2,2,0,-9,0,9,7,11,4,3,3,0,1,1,0,0,-1,-141,1,4,5,-3,0,2,1,1,1,1,3,1
KR_6731516964,420,3,-29,4,12,3,3,0,4,5,1,2,2,0,1,6,5,2,2,0,0,12,-8,4,3,7,1,0,0,1,0,0,1,3,1
KR_6668829839,420,-4,-52,-17,-5,4,5,1,-2,1,3,1,2,1,-8,0,8,0,0,0,0,-11,275,0,3,3,-2,0,-2,-1,-1,-1,1,3,1
KR_6612227687,420,-1,-11,4,-1,-1,0,1,5,7,2,0,1,1,-6,1,7,1,2,1,0,-1,-1,-1,3,2,-1,0,-1,1,-1,-1,1,3,1
KR_6757063434,440,0,-43,17,5,-5,1,6,14,14,0,1,3,2,-3,0,3,-2,0,2,0,1,3,-2,7,5,-4,0,-1,1,1,1,1,4,1
KR_6644032423,420,0,-17,28,4,-1,2,3,0,3,3,-1,3,4,4,6,2,2,2,0,0,11,13,-2,7,5,-2,0,0,1,1,1,-1,2,1
KR_6733968537,420,2,26,9,-1,-2,0,2,0,2,2,1,4,3,-2,3,5,2,4,2,0,-11,10,1,2,3,-3,0,2,1,1,1,-1,2,1
KR_6741458988,420,4,28,-11,13,2,2,0,3,5,2,1,2,1,6,8,2,1,1,0,0,8,-3,-8,10,2,6,0,2,-1,1,1,1,2,1
KR_6720101859,420,3,11,16,1,3,3,0,-2,1,3,0,1,1,1,1,0,-1,1,2,0,-3,124,-1,3,2,0,0,0,1,-1,0,-1,6,1
KR_6612447490,420,-2,64,-28,-6,-2,1,3,-1,0,1,-3,0,3,0,2,2,0,1,1,1,-2,9,1,2,3,0,0,-1,-1,-1,-1,1,6,1
KR_6718095195,420,4,52,4,1,0,2,2,-3,3,6,2,4,2,2,3,1,0,1,1,0,-1,-38,-5,7,2,14,0,1,1,1,1,1,4,1
KR_6756627619,420,3,-16,7,1,2,3,1,7,8,1,0,5,5,-7,1,8,-1,0,1,-2,6,-4,-1,4,3,-3,0,-1,1,-1,-1,-1,1,1
KR_6752286635,420,3,60,22,5,5,7,2,0,0,0,-3,2,5,1,4,3,2,2,0,0,6,3,4,1,5,3,0,2,1,1,1,1,4,1
KR_6761632636,420,0,32,4,0,-1,2,3,-1,0,1,-2,0,2,2,6,4,2,3,1,-1,4,12,-1,8,7,3,0,1,-1,0,1,-1,1,1
KR_6736059742,420,2,85,24,7,0,1,1,5,7,2,1,4,3,3,4,1,-2,1,3,1,6,-131,5,1,6,-6,0,1,1,1,1,1,1,1
KR_6652856831,420,1,-15,29,7,2,2,0,1,4,3,3,5,2,1,1,0,0,0,0,0,3,-3,0,3,3,-2,0,1,1,1,1,1,2,1
KR_6676715678,440,4,104,43,9,-1,1,2,7,8,1,3,3,0,0,2,2,0,1,1,-1,2,5,-1,7,6,3,0,1,1,0,1,-1,5,1
KR_6764384910,420,4,81,28,11,2,3,1,8,9,1,0,4,4,2,5,3,-1,0,1,0,1,23,-1,7,6,5,0,0,1,-1,-1,-1,5,1
KR_6694403133,420,2,-3,-8,4,-1,1,2,5,6,1,1,4,3,1,3,2,-2,1,3,0,3,-1,2,3,5,-1,0,0,-1,1,-1,-1,6,1
KR_6762827650,440,1,35,24,-1,-4,1,5,0,5,5,1,2,1,0,0,0,2,2,0,0,-1,0,1,3,4,0,0,1,-1,1,1,-1,5,1
KR_6730734847,420,-2,11,-4,-5,-5,2,7,-1,0,1,4,5,1,-2,1,3,-1,0,1,0,-5,5,2,6,8,1,0,1,1,1,-1,1,3,1
KR_6728443559,420,-1,-7,-29,-2,-2,2,4,0,6,6,-1,1,2,1,4,3,0,1,1,0,0,96,6,3,9,-1,0,-1,1,-1,-1,1,2,1
KR_6735257502,420,0,-6,-8,2,3,3,0,0,5,5,-1,0,1,-3,2,5,3,3,0,0,3,8,1,7,8,-1,0,0,-1,1,0,1,5,1
KR_6735319387,420,1,52,-4,4,-1,1,2,1,5,4,-2,0,2,2,4,2,4,4,0,0,5,51,-3,6,3,0,0,1,1,-1,1,-1,3,1
KR_6732635181,420,4,43,-5,11,3,3,0,1,1,0,-1,1,2,2,4,2,6,7,1,0,5,4,0,2,2,-3,0,0,-1,-1,1,1,6,1
KR_6763564621,420,-2,-20,-9,-3,-3,0,3,-2,2,4,-2,1,3,2,5,3,2,2,0,0,1,-9,5,2,7,0,0,0,-1,1,0,1,5,1
KR_6697053137,420,1,27,0,-6,-3,1,4,1,5,4,-2,1,3,-1,2,3,-1,0,1,0,-10,16,-3,6,3,-20,0,-1,-1,-1,-1,-1,2,1
KR_6757039651,420,3,82,19,6,1,2,1,4,4,0,1,5,4,2,4,2,-2,1,3,0,8,2,2,3,5,1,0,0,1,1,1,1,6,1
KR_6752231731,420,-2,-5,-10,-4,0,2,2,-2,1,3,-5,2,7,2,3,1,1,1,0,-1,-2,-1,-1,6,5,-2,0,0,-1,1,0,-1,4,1
KR_6625888616,420,5,42,16,11,3,5,2,-2,3,5,5,5,0,2,7,5,3,3,0,1,5,222,-3,8,5,4,0,1,1,1,1,1,1,1
KR_6745320248,420,0,-10,-15,5,0,2,2,1,2,1,4,5,1,1,2,1,-1,1,2,0,6,-9,-1,7,6,4,0,0,-1,0,0,1,1,1
KR_6755364460,420,1,36,-9,1,0,1,1,0,2,2,0,2,2,-2,1,3,3,3,0,0,2,-3,-2,6,4,-5,0,0,-1,1,-1,1,1,1
KR_6725805326,420,1,-14,-7,2,1,2,1,1,4,3,1,3,2,-2,2,4,1,1,0,-1,-4,-7,5,3,8,-2,0,0,1,1,0,-1,6,1
KR_6749307524,420,1,0,20,5,4,4,0,-3,0,3,7,8,1,-1,1,2,-2,0,2,0,0,6,0,8,8,3,0,0,1,1,-1,1,3,1
KR_6695149139,420,4,56,12,4,4,5,1,-1,4,5,0,1,1,0,2,2,1,1,0,0,-6,-8,-2,3,1,1,0,1,1,-1,1,-1,1,1
KR_6692150101,420,0,-15,-8,-2,0,2,2,-2,2,4,2,4,2,-2,2,4,0,4,4,1,-6,235,-3,4,1,-2,0,-1,-1,-1,-1,1,1,1
KR_6746467011,420,1,-9,24,6,-1,3,4,-1,1,2,-2,1,3,7,7,0,3,3,0,0,7,-6,1,2,3,-1,0,1,-1,-1,-1,-1,6,1
KR_6758561775,440,4,51,8,11,4,4,0,7,10,3,3,5,2,-2,0,2,-1,0,1,0,7,-41,2,1,3,28,0,1,-1,1,1,1,1,1
KR_6761653922,420,-3,-53,-7,-4,-5,2,7,0,4,4,2,3,1,0,3,3,-1,0,1,0,2,-55,1,5,6,-4,0,-1,1,-1,-1,1,3,1
KR_6736531095,420,3,75,15,9,1,3,2,0,5,5,2,3,1,5,5,0,1,1,0,3,13,-3,2,3,5,4,0,2,-1,1,1,1,2,1
KR_6718002317,440,2,71,16,6,2,4,2,0,3,3,7,8,1,-3,2,5,0,1,1,1,14,-4,2,2,4,1,0,1,1,-1,-1,1,4,1
KR_6745617244,420,0,-57,8,-6,0,3,3,-2,1,3,-2,3,5,0,1,1,-2,3,5,0,-1,-1,1,2,3,1,0,-2,0,0,-1,1,0,1
KR_6675381342,420,2,1,8,6,-2,1,3,8,8,0,-2,1,3,2,4,2,0,1,1,-1,11,2,1,5,6,1,0,0,1,-1,-1,-1,6,1
KR_6758841506,420,4,51,0,11,5,5,0,0,3,3,3,3,0,3,3,0,0,0,0,0,11,-2,-2,5,3,3,0,2,1,1,1,-1,6,1
KR_6737882353,420,3,6,-26,9,0,2,2,5,9,4,-2,3,5,6,10,4,0,0,0,-2,5,-10,2,3,5,2,0,0,0,1,1,-1,0,1
KR_6395267860,420,4,96,9,11,0,2,2,5,6,1,-1,1,2,4,6,2,3,3,0,0,12,10,3,1,4,0,0,1,1,1,1,-1,5,1
KR_6762755203,420,3,65,12,4,1,3,2,-1,2,3,6,7,1,-2,0,2,0,0,0,0,-8,-2,-1,4,3,3,0,2,1,1,1,1,1,1
KR_6700531053,420,-2,15,10,-8,-3,3,6,0,4,4,-4,2,6,-1,1,2,0,0,0,-2,-9,14,6,3,9,-1,0,0,0,0,0,-1,0,1
KR_6747340600,420,9,48,25,14,0,0,0,4,8,4,6,6,0,2,3,1,2,3,1,0,18,82,4,3,7,0,0,1,-1,-1,1,-1,2,1
KR_6695012671,420,6,72,0,14,2,2,0,-1,2,3,3,4,1,10,10,0,0,1,1,0,14,2,-1,4,3,1,0,0,1,1,1,1,5,1
KR_6758234003,420,2,14,24,-2,-3,1,4,0,2,2,-3,0,3,3,6,3,1,2,1,0,-3,0,1,4,5,2,0,2,1,1,1,1,6,1
KR_6737266790,420,1,32,-33,4,5,5,0,-2,2,4,0,1,1,1,2,1,0,0,0,0,1,-6,-2,5,3,-1,0,0,1,1,1,1,3,1
KR_6709565856,440,0,-10,-16,1,-4,0,4,-1,1,2,2,6,4,3,3,0,1,2,1,0,7,0,1,6,7,-1,0,1,1,-1,1,1,1,1
KR_6732098210,420,2,23,3,0,1,1,0,2,2,0,5,6,1,-7,2,9,-1,0,1,0,2,-1,0,4,4,-1,0,0,1,0,1,1,3,1
KR_6691847105,420,3,117,-12,6,1,1,0,-3,2,5,4,5,1,3,9,6,1,1,0,0,1,33,-2,9,7,-1,0,1,1,-1,1,1,1,1
KR_6758157092,420,1,26,0,4,4,4,0,3,3,0,0,3,3,-2,2,4,-1,0,1,0,-4,-1,1,6,7,2,0,-1,1,-1,-1,-1,3,1
KR_6729656544,420,1,21,-16,5,1,2,1,-2,3,5,-1,0,1,6,6,0,1,2,1,0,12,105,3,2,5,0,0,0,0,0,1,1,0,1
KR_6763323999,420,1,21,-4,1,0,1,1,1,5,4,-1,4,5,3,3,0,-2,1,3,1,-4,-83,1,3,4,-1,0,0,-1,1,1,1,1,1
KR_6674488568,420,2,27,-1,12,2,4,2,3,5,2,0,0,0,2,4,2,5,5,0,0,8,-2,-1,7,6,5,0,0,1,1,1,1,6,1
KR_6743170105,420,-1,-85,-26,1,3,3,0,-4,2,6,1,1,0,0,4,4,1,2,1,-1,0,10,0,5,5,2,0,0,1,-1,-1,-1,4,1
KR_6727645049,420,0,17,3,8,5,8,3,6,8,2,-3,1,4,1,5,4,-1,0,1,0,-2,-113,5,0,5,1,0,2,1,1,1,1,1,1
KR_6754934596,420,6,82,36,9,2,4,2,1,2,1,1,2,1,5,8,3,0,1,1,0,-1,-15,4,1,5,-1,0,0,1,-1,0,1,5,1
KR_6763880257,420,-1,-57,7,5,3,5,2,-3,2,5,0,1,1,4,5,1,1,1,0,0,3,-5,0,3,3,4,0,2,0,1,1,1,0,1
KR_6743171836,440,-3,-108,-32,-6,0,1,1,-2,1,3,1,4,3,-2,2,4,-3,0,3,-2,-6,-8,-4,7,3,9,0,0,-1,1,-1,-1,1,1
KR_6753932333,420,4,-17,19,9,3,3,0,-2,2,4,3,4,1,3,3,0,2,2,0,0,4,-1,1,3,4,-1,0,1,0,1,1,1,0,1
KR_6619227865,420,2,70,-4,4,-2,4,6,0,1,1,4,5,1,1,6,5,1,1,0,-1,-4,56,1,2,3,2,0,2,1,1,1,-1,6,1
KR_6684210022,420,3,23,-24,4,3,3,0,-4,0,4,4,4,0,3,4,1,-2,0,2,0,-2,11,4,2,6,-3,0,0,-1,-1,1,1,2,1
KR_6668934300,420,1,11,20,7,3,5,2,0,2,2,5,7,2,-1,1,2,0,0,0,0,5,139,5,2,7,-7,0,1,0,1,1,-1,0,1
KR_6763494238,440,0,43,11,3,-1,2,3,1,1,0,1,3,2,3,3,0,-1,2,3,0,3,-2,5,0,5,3,0,1,1,1,1,1,6,1
KR_6743778232,440,-2,-68,29,-5,-1,3,4,2,4,2,-1,2,3,-4,1,5,-1,2,3,-2,-7,8,-2,4,2,-1,0,0,1,1,-1,1,2,1
KR_6647563924,420,5,19,29,10,9,9,0,2,4,2,4,4,0,-3,0,3,-2,0,2,0,2,3,3,1,4,-2,0,3,1,1,1,1,4,1
KR_6731063981,420,6,85,39,9,-2,1,3,6,8,2,5,6,1,2,3,1,-2,0,2,1,9,41,3,2,5,-1,0,2,1,1,1,1,5,1
KR_6751909995,420,3,-5,1,0,4,4,0,0,2,2,-3,0,3,-1,1,2,0,0,0,0,-2,-52,0,6,6,1,0,0,-1,0,0,-1,4,1
KR_6761003377,420,5,73,32,10,5,7,2,2,4,2,4,7,3,-1,2,3,0,1,1,2,6,-5,-2,6,4,4,0,1,0,1,1,1,0,1
KR_6601251734,420,1,32,8,5,1,1,0,4,9,5,0,2,2,-2,0,2,2,2,0,0,-3,5,2,2,4,3,0,3,1,1,1,1,5,1
KR_6761949916,420,0,12,-2,5,-2,1,3,-1,0,1,1,8,7,7,10,3,0,0,0,0,1,-21,-1,4,3,-1,0,0,1,1,1,1,2,1
KR_6762551252,420,5,45,61,9,2,3,1,8,8,0,-3,1,4,0,3,3,2,5,3,0,10,33,2,5,7,-2,0,2,1,1,1,-1,2,1
KR_6725802903,420,4,11,29,8,0,1,1,1,3,2,4,5,1,2,5,3,1,1,0,0,7,-4,2,3,5,6,0,0,1,-1,0,-1,2,1
KR_6744204180,420,1,-9,12,5,1,1,0,-2,2,4,4,5,1,2,3,1,0,1,1,0,-7,-3,1,7,8,-1,0,1,1,1,1,1,6,1
KR_6756621274,420,1,28,2,-1,0,3,3,-2,2,4,-1,2,3,3,4,1,-1,1,2,0,-5,-12,1,4,5,-2,0,-1,0,-1,-1,-1,0,1
KR_6763478647,420,0,-11,-12,2,-2,1,3,1,3,2,2,3,1,0,4,4,1,3,2,0,1,-145,-2,6,4,5,0,-1,0,-1,-1,1,0,1
KR_6749091938,420,0,27,4,-2,2,2,0,-2,1,3,0,2,2,1,3,2,-3,0,3,0,-7,0,2,4,6,3,0,0,1,-1,0,1,6,1
KR_6758941326,420,2,59,16,7,4,5,1,0,5,5,0,1,1,1,3,2,2,3,1,0,5,0,1,4,5,4,0,0,1,-1,1,1,2,1
KR_6636111769,420,-1,13,0,-9,1,2,1,-1,5,6,-5,2,7,-2,1,3,-2,2,4,0,-22,-386,0,2,2,0,0,0,1,-1,-1,-1,4,1
KR_6696011633,420,1,-18,-4,7,-5,1,6,3,4,1,8,9,1,0,0,0,1,1,0,0,8,-169,0,3,3,1,0,2,0,0,-1,-1,0,1
KR_6723042374,440,0,13,6,1,1,2,1,1,2,1,-2,2,4,1,1,0,0,0,0,0,3,3,0,2,2,1,0,0,1,1,0,-1,4,1
KR_6680272455,440,9,81,43,14,4,7,3,3,4,1,-1,2,3,5,6,1,3,3,0,-1,12,4,-2,4,2,3,0,4,-1,1,1,-1,2,1
KR_6714952469,420,1,-16,-12,14,0,0,0,4,4,0,2,4,2,6,7,1,2,2,0,0,13,62,1,2,3,1,0,-2,-1,-1,-1,1,3,1
KR_6726612687,420,3,77,12,5,0,3,3,-2,2,4,2,2,0,4,6,2,1,2,1,1,1,4,6,3,9,0,0,2,1,1,1,1,1,1
KR_6741978896,440,1,55,-7,8,-2,2,4,1,2,1,1,3,2,7,7,0,1,1,0,0,14,25,-1,6,5,0,0,0,-1,1,-1,1,4,1
KR_6650587190,420,-1,-28,-8,2,0,2,2,5,8,3,-2,1,3,0,4,4,-1,2,3,1,-6,-3,3,2,5,-2,0,0,-1,0,0,1,5,1
KR_6762867329,440,3,47,16,9,3,4,1,3,3,0,1,2,1,0,0,0,2,2,0,0,10,34,-5,9,4,-1,0,2,-1,1,1,1,1,1
KR_6738036969,420,0,60,-10,1,4,4,0,3,4,1,-1,4,5,-1,2,3,-4,0,4,1,-7,-14,1,4,5,5,0,1,-1,1,1,1,4,1
KR_6731391284,420,3,44,17,14,-2,0,2,5,7,2,2,2,0,6,6,0,3,3,0,0,13,19,2,5,7,-3,0,1,1,1,1,1,3,1
KR_6762225350,420,4,69,20,13,1,2,1,1,3,2,5,11,6,5,6,1,1,1,0,0,14,8,6,6,12,2,0,2,0,1,1,1,0,1
KR_6739127051,420,0,2,23,6,-4,1,5,2,4,2,4,5,1,4,4,0,0,0,0,0,12,21,2,3,5,0,0,0,1,-1,1,1,5,1
KR_6749432551,420,0,-19,-4,-1,-2,2,4,-2,1,3,-1,1,2,2,3,1,2,3,1,0,2,-20,-4,7,3,1,0,1,-1,1,1,1,1,1
KR_6652455646,420,2,18,-1,2,1,2,1,-2,2,4,-1,2,3,1,4,3,3,5,2,0,2,10,2,0,2,-2,0,0,-1,1,-1,-1,1,1
KR_6739175524,420,1,-47,24,2,-3,0,3,4,4,0,0,2,2,1,4,3,0,1,1,0,5,-113,1,3,4,1,0,0,-1,1,0,1,2,1
KR_6691923716,420,3,87,18,9,-3,1,4,4,5,1,1,4,3,8,8,0,-1,1,2,1,10,13,0,3,3,2,0,2,1,1,1,1,6,1
KR_6763569747,420,1,-8,-1,-1,0,1,1,-2,1,3,-5,3,8,4,5,1,2,4,2,0,-2,60,-2,5,3,-20,0,0,0,-1,0,1,0,1
KR_6756802110,440,-2,-40,-36,1,-3,0,3,1,2,1,0,2,2,3,3,0,0,0,0,0,7,60,0,4,4,-4,0,-1,-1,0,-1,1,1,1
KR_6739247528,420,5,31,26,12,2,2,0,6,6,0,1,4,3,2,2,0,1,3,2,1,17,-2,-4,6,2,0,0,1,1,1,1,1,3,1
KR_6756682155,420,1,43,14,0,4,5,1,-2,2,4,-3,1,4,1,1,0,0,0,0,1,-3,19,3,5,8,5,0,1,-1,1,1,1,5,1
KR_6705686505,420,1,44,4,0,4,6,2,-3,3,6,-3,2,5,2,5,3,0,0,0,1,5,-12,-8,11,3,1,0,0,-1,-1,-1,1,6,1
KR_6742163548,420,4,31,24,10,5,5,0,-3,2,5,3,4,1,5,6,1,0,0,0,0,9,-35,-7,8,1,4,0,2,0,1,1,1,0,1
KR_6713512523,420,4,27,3,4,0,2,2,-3,3,6,1,3,2,6,6,0,0,0,0,0,5,42,1,4,5,-10,0,1,0,1,1,1,0,1
KR_6749282291,420,2,89,-24,8,0,1,1,2,3,1,1,2,1,5,5,0,0,1,1,0,7,140,2,4,6,-1,0,0,-1,-1,0,1,3,1
KR_6644646909,420,2,-24,22,6,0,2,2,6,7,1,5,6,1,-2,0,2,-3,1,4,-2,3,-5,6,1,7,1,0,-1,1,1,-1,-1,3,1
KR_6644109518,420,1,60,-17,1,0,2,2,4,5,1,-1,4,5,-4,1,5,2,2,0,0,-2,0,-5,6,1,0,0,2,1,-1,1,1,5,1
KR_6716007919,440,-2,23,21,-6,-2,1,3,3,4,1,-2,1,3,-3,0,3,-2,2,4,0,-3,-200,-6,8,2,4,0,-1,0,0,-1,-1,0,1
KR_6756769394,420,0,-107,12,4,2,6,4,-1,1,2,1,5,4,2,2,0,0,0,0,0,18,-14,1,4,5,2,0,-2,1,1,-1,-1,5,1
KR_6739354260,420,1,22,0,3,3,3,0,1,6,5,3,5,2,-6,1,7,2,5,3,0,-4,-29,-1,5,4,-1,0,1,-1,1,1,-1,1,1
KR_6726475784,420,4,-22,21,10,2,2,0,2,4,2,6,6,0,-2,0,2,2,2,0,1,14,-51,0,4,4,0,0,0,1,1,1,1,5,1
KR_6749442993,420,3,43,44,8,1,3,2,2,4,2,1,5,4,3,3,0,1,2,1,0,1,7,1,2,3,-2,0,1,1,1,1,-1,5,1
KR_6734165058,440,4,-4,16,10,-6,0,6,2,3,1,2,3,1,11,11,0,1,1,0,0,11,1,0,4,4,-1,0,2,1,-1,1,1,5,1
KR_6724965551,420,6,23,28,16,0,0,0,3,6,3,6,9,3,4,5,1,3,3,0,0,17,-2,-3,6,3,-1,0,1,1,-1,1,-1,5,1
KR_6746310487,420,4,36,-4,11,0,3,3,4,5,1,0,0,0,6,7,1,1,1,0,1,16,12,3,4,7,-1,0,2,1,1,1,1,1,1
KR_6626163613,420,-1,-31,-21,0,-2,0,2,3,4,1,-1,3,4,2,3,1,-2,0,2,0,-5,-9,-4,8,4,0,0,-1,0,-1,-1,1,0,1
KR_6762999709,420,7,97,54,18,4,4,0,2,4,2,7,8,1,4,8,4,1,3,2,0,13,1,0,3,3,1,0,1,1,-1,1,1,5,1
KR_6732101225,420,5,36,35,9,2,2,0,-2,1,3,7,8,1,2,2,0,0,0,0,0,5,1,0,4,4,1,0,1,-1,1,1,1,2,1
KR_6752641130,420,3,69,0,4,3,3,0,1,2,1,-2,0,2,2,4,2,0,0,0,0,5,-54,1,3,4,-2,0,1,-1,1,1,1,2,1
KR_6752912050,420,1,118,22,5,0,1,1,-1,3,4,2,5,3,1,4,3,3,4,1,2,4,133,-4,7,3,-2,0,1,1,-1,1,1,2,1
KR_6713216018,420,3,40,11,6,3,3,0,2,6,4,0,1,1,0,2,2,1,1,0,0,-3,2,-1,5,4,1,0,0,1,1,1,1,3,1
KR_6722360661,420,0,42,24,0,1,5,4,-3,2,5,-2,0,2,5,5,0,-1,0,1,1,-11,39,-1,6,5,-16,0,1,1,1,1,-1,1,1
KR_6759115165,420,4,35,23,11,-3,1,4,4,5,1,2,5,3,4,6,2,4,6,2,0,11,-2,-5,6,1,1,0,2,1,1,1,1,2,1
KR_6673451929,420,0,25,4,-2,1,4,3,0,3,3,-1,1,2,-1,3,4,-1,1,2,0,1,-6,1,6,7,-3,0,-1,-1,-1,-1,-1,5,1
KR_6748015116,420,2,20,16,10,2,2,0,4,4,0,0,1,1,1,2,1,3,3,0,0,19,16,3,4,7,4,0,0,1,1,0,1,3,1
KR_6695807242,420,2,20,0,5,1,3,2,5,6,1,-1,2,3,0,1,1,0,2,2,1,7,-5,0,3,3,-1,0,0,1,-1,-1,1,3,1
KR_6709222228,420,5,48,-43,9,3,4,1,2,4,2,-2,1,3,5,9,4,1,1,0,3,10,2,7,2,9,6,0,0,1,-1,1,1,5,1
KR_6758675518,420,5,74,45,12,5,6,1,2,3,1,2,4,2,0,0,0,3,3,0,0,4,21,1,3,4,-2,0,1,1,1,1,1,4,1
KR_6684936635,420,0,25,8,8,0,3,3,-1,3,4,7,7,0,2,4,2,0,1,1,0,5,4,0,4,4,-4,0,0,1,-1,0,1,6,1
KR_6698870478,420,-1,-3,16,-8,1,4,3,-1,1,2,-2,0,2,-3,2,5,-3,1,4,0,-5,16,0,4,4,-2,0,1,0,-1,1,1,0,1
KR_6751464397,420,1,-31,16,6,-1,0,1,7,7,0,-1,1,2,1,2,1,0,1,1,0,12,-129,-3,4,1,0,0,-1,1,0,-1,1,2,1
KR_6620229434,440,1,13,-8,-6,4,7,3,-1,1,2,-3,2,5,-5,2,7,-1,2,3,-1,-12,-5,0,1,1,1,0,1,0,0,1,-1,0,1
KR_6764938717,420,-1,38,-32,4,1,5,4,-1,0,1,-1,1,2,4,5,1,1,1,0,0,1,3,-3,6,3,3,0,0,-1,1,1,-1,4,1
KR_6762877583,440,3,58,0,9,1,2,1,1,3,2,1,3,2,8,8,0,-2,0,2,0,7,8,-3,3,0,0,0,0,0,0,1,-1,0,1
KR_6764895590,420,-1,9,17,4,-2,1,3,5,6,1,4,5,1,-2,1,3,-1,0,1,0,6,41,-1,3,2,-26,0,-1,1,-1,-1,1,5,1
KR_6706351226,420,0,-19,3,3,-1,0,1,2,4,2,-5,1,6,0,3,3,7,7,0,2,3,-44,-1,7,6,33,0,1,-1,1,1,1,5,1
KR_6751058155,420,2,37,0,7,1,1,0,-2,0,2,3,3,0,4,4,0,1,3,2,0,4,-45,2,1,3,1,0,2,1,1,1,1,1,1
KR_6663100982,420,-1,14,-44,-1,-2,0,2,-2,2,4,0,5,5,5,5,0,-2,0,2,0,-1,2,3,3,6,2,0,0,1,-1,0,1,6,1
KR_6632026532,420,7,108,18,19,2,4,2,2,2,0,2,3,1,12,13,1,1,1,0,0,17,-4,1,3,4,1,0,4,1,1,1,1,1,1
KR_6756928190,420,1,72,-26,10,3,3,0,9,10,1,0,2,2,-2,1,3,0,1,1,0,3,-10,-5,6,1,8,0,1,-1,1,1,-1,5,1
KR_6760057426,420,1,74,-24,3,-3,0,3,0,1,1,-3,1,4,7,8,1,2,2,0,1,0,2,4,4,8,2,0,1,-1,-1,1,1,2,1
KR_6758278621,420,3,10,-2,4,0,0,0,0,1,1,1,2,1,4,8,4,-1,1,2,0,8,3,1,4,5,-1,0,0,1,-1,0,-1,6,1
KR_6721294991,420,-2,-40,-23,-1,-1,2,3,4,5,1,-2,4,6,-1,0,1,-1,1,2,0,7,-1,3,4,7,5,0,0,0,0,0,1,0,1
KR_6759985001,420,-2,-37,15,-1,-3,0,3,2,3,1,-1,0,1,1,6,5,0,0,0,-1,7,28,0,4,4,2,0,-1,1,-1,-1,-1,3,1
KR_6715621327,420,5,40,28,9,-1,1,2,0,3,3,4,4,0,3,6,3,3,6,3,-1,2,-4,-6,11,5,4,0,3,1,1,1,-1,3,1
KR_6762541463,420,1,12,4,2,2,3,1,3,4,1,-1,0,1,-1,5,6,-1,0,1,1,3,0,0,6,6,-1,0,0,1,1,0,1,4,1
KR_6737953659,420,3,59,-4,6,-2,1,3,4,5,1,2,4,2,0,3,3,2,2,0,0,2,4,-3,6,3,1,0,0,-1,1,0,1,1,1
KR_6764479576,420,-4,10,-6,-11,0,3,3,-2,1,3,-3,2,5,-4,2,6,-2,2,4,-1,-30,278,0,3,3,1,0,1,1,1,1,-1,6,1
KR_6757601684,440,3,8,31,-2,-3,1,4,-5,0,5,4,7,3,1,1,0,1,2,1,0,-7,-1,-2,2,0,1,0,-1,1,1,-1,1,3,1
KR_6640421318,420,-1,-126,-4,4,0,2,2,5,6,1,1,1,0,-1,2,3,-1,2,3,0,12,1,1,4,5,0,0,0,-1,1,0,1,1,1
KR_6678080439,420,2,-47,30,4,1,3,2,3,4,1,1,2,1,-2,0,2,1,1,0,-1,1,-5,-5,10,5,0,0,-1,1,-1,-1,-1,6,1
KR_6750974167,440,1,26,17,-5,0,3,3,1,2,1,-2,0,2,-2,6,8,-2,0,2,0,-5,-23,-4,7,3,2,0,0,-1,1,0,-1,3,1
KR_6756139363,420,3,28,18,1,-3,2,5,3,7,4,1,5,4,-1,5,6,1,1,0,1,-3,-2,4,6,10,5,0,2,-1,-1,1,1,4,1
KR_6737565500,420,1,-17,-12,-1,-1,0,1,-1,4,5,-1,2,3,2,3,1,0,1,1,0,2,-5,1,7,8,8,0,0,-1,1,1,-1,6,1
KR_6712006955,420,2,32,-12,9,-2,0,2,3,5,2,0,1,1,8,9,1,0,0,0,1,18,9,6,2,8,-1,0,0,1,-1,0,1,1,1
KR_6725869488,420,6,40,20,5,2,5,3,0,2,2,3,3,0,1,2,1,-1,1,2,0,1,-5,1,4,5,3,0,-1,-1,-1,-1,-1,4,1
KR_6763064406,440,2,31,-11,7,1,1,0,6,9,3,-2,1,3,1,1,0,1,1,0,0,7,-68,4,3,7,1,0,1,-1,1,1,1,6,1
KR_6693386994,440,1,4,-35,2,0,3,3,-1,2,3,0,1,1,4,8,4,-1,0,1,0,2,-2,1,3,4,1,0,0,1,-1,0,-1,4,1
KR_6755148808,420,0,26,-20,-5,0,2,2,-1,3,4,-3,1,4,0,2,2,-1,1,2,0,-8,-8,-1,5,4,0,0,-1,-1,1,-1,1,2,1
KR_6739501444,420,4,123,-6,7,6,7,1,2,2,0,-4,2,6,0,3,3,3,5,2,0,6,2,2,4,6,4,0,1,1,1,1,1,4,1
KR_6761271844,420,-2,-11,-16,1,-1,0,1,1,2,1,0,3,3,1,2,1,0,0,0,0,3,10,3,5,8,1,0,1,1,-1,1,1,3,1
KR_6751036696,440,1,89,4,4,2,3,1,-8,3,11,3,4,1,10,10,0,-3,0,3,0,-4,-2,0,3,3,0,0,1,-1,1,1,1,2,1
KR_6756718076,420,0,44,-20,12,6,7,1,3,4,1,2,3,1,4,8,4,-3,0,3,1,6,3,7,3,10,-3,0,2,-1,1,1,1,3,1
KR_6759823276,420,5,61,36,15,7,7,0,7,8,1,2,3,1,-2,3,5,1,2,1,0,11,-20,6,2,8,4,0,0,1,1,1,-1,1,1
KR_6511426959,420,0,32,24,6,0,1,1,4,4,0,0,7,7,3,4,1,-1,1,2,1,14,5,-4,7,3,2,0,2,1,1,1,1,4,1
KR_6735819755,420,0,1,-4,2,0,2,2,0,2,2,5,6,1,-3,5,8,0,0,0,0,7,-14,0,2,2,-1,0,0,-1,1,-1,1,5,1
KR_6690655524,420,3,100,30,4,-1,2,3,1,4,3,3,3,0,1,1,0,0,1,1,0,-2,-6,0,4,4,0,0,1,1,1,1,-1,3,1
KR_6759832125,440,1,32,28,-1,-2,0,2,1,4,3,-3,1,4,0,4,4,3,3,0,0,7,13,3,1,4,-2,0,2,-1,0,1,-1,6,1
KR_6754156304,440,3,-3,47,3,4,5,1,-1,4,5,-1,1,2,1,5,4,0,0,0,-1,3,-1,-1,1,0,1,0,1,0,1,1,-1,0,1
KR_6577469288,420,1,26,4,4,-1,0,1,-1,0,1,0,1,1,6,8,2,0,0,0,0,8,23,2,3,5,3,0,1,0,0,1,-1,0,1
KR_6691572136,420,4,-11,6,10,5,5,0,5,7,2,3,6,3,-5,3,8,2,3,1,0,3,-5,2,2,4,2,0,2,1,1,1,1,5,1
KR_6720747128,420,2,15,-4,1,2,2,0,-1,3,4,2,2,0,-4,4,8,2,2,0,0,10,-104,3,0,3,20,0,1,1,-1,1,-1,5,1
KR_6741480786,420,4,10,48,7,6,6,0,4,6,2,-1,3,4,-3,2,5,1,2,1,0,0,39,1,6,7,-4,0,1,-1,1,1,-1,1,1
KR_6587832167,440,4,40,3,15,-1,0,1,1,2,1,0,1,1,13,14,1,2,2,0,1,23,5,-1,4,3,-3,0,2,1,-1,-1,1,6,1
KR_6757188729,420,4,32,43,9,-2,1,3,0,1,1,8,9,1,4,5,1,-1,1,2,0,7,-13,1,0,1,0,0,1,1,-1,1,-1,1,1
KR_6725767912,420,3,150,-19,6,2,2,0,-3,2,5,3,4,1,2,4,2,2,3,1,0,4,13,3,2,5,0,0,1,-1,1,1,-1,5,1
KR_6684737139,420,6,125,4,8,2,2,0,5,6,1,0,4,4,3,3,0,-2,0,2,0,4,-10,6,0,6,4,0,2,1,1,1,1,4,1
KR_6754940621,420,7,112,4,15,4,5,1,11,13,2,0,1,1,-2,3,5,2,3,1,0,11,11,-1,6,5,1,0,2,-1,1,1,-1,3,1
KR_6740214684,440,1,17,-12,5,6,8,2,-2,1,3,1,1,0,0,2,2,0,3,3,0,0,1,1,4,5,2,0,0,1,1,1,1,6,1
KR_6744440970,420,4,42,7,6,0,3,3,0,1,1,3,5,2,3,3,0,0,0,0,1,11,7,-1,5,4,-5,0,1,-1,1,1,1,3,1
KR_6757701673,440,4,68,44,9,-9,1,10,-1,3,4,8,8,0,7,7,0,4,4,0,-1,0,71,-3,6,3,7,0,3,1,1,1,-1,5,1
KR_6671090543,420,2,51,4,5,1,1,0,4,6,2,2,4,2,1,4,3,-3,0,3,-1,-4,20,6,1,7,-5,0,1,-1,1,1,-1,5,1
KR_6764874451,420,3,31,16,13,0,1,1,1,1,0,6,6,0,6,9,3,0,1,1,0,11,13,6,2,8,-1,0,0,0,1,1,-1,0,1
KR_6718980902,420,1,55,4,0,-2,0,2,-1,1,2,5,6,1,0,2,2,-2,2,4,0,-4,2,1,6,7,0,0,0,-1,-1,0,1,2,1
KR_6723346033,420,7,30,28,15,7,7,0,2,2,0,6,8,2,-1,1,2,1,1,0,0,10,-38,1,4,5,27,0,0,1,1,0,1,5,1
KR_6748155396,420,1,42,4,5,1,3,2,1,2,1,2,2,0,2,2,0,-1,0,1,0,10,-14,-2,5,3,2,0,0,-1,-1,0,1,6,1
KR_6643058007,420,4,52,34,4,2,4,2,1,3,2,2,5,3,-3,1,4,2,2,0,0,-2,-39,4,2,6,24,0,1,-1,-1,1,-1,2,1
KR_6745207502,440,3,21,13,7,0,3,3,5,6,1,1,4,3,3,5,2,-2,0,2,-1,2,-135,-1,6,5,-3,0,1,1,-1,1,-1,1,1
KR_6756159070,420,1,3,4,10,-1,2,3,6,7,1,5,7,2,-5,2,7,5,6,1,0,12,24,6,0,6,0,0,-2,1,-1,-1,1,2,1
KR_6668375706,420,2,26,20,0,-2,3,5,2,5,3,1,3,2,0,5,5,-1,0,1,1,4,251,2,6,8,2,0,-1,1,1,1,1,1,1
KR_6447703832,420,-2,-8,-10,-4,1,2,1,-3,1,4,4,4,0,-4,1,5,-2,1,3,1,-8,-23,1,7,8,1,0,1,-1,1,1,1,4,1
KR_6760548326,420,5,42,4,10,8,8,0,0,1,1,-1,0,1,3,3,0,0,0,0,0,4,22,2,4,6,2,0,1,1,1,1,1,5,1
KR_6713918837,420,4,14,32,3,1,2,1,-1,2,3,0,2,2,2,3,1,1,2,1,0,-2,-1,-3,8,5,3,0,1,1,1,1,1,1,1
KR_6647087569,420,0,64,-5,5,1,1,0,-3,0,3,1,4,3,3,6,3,3,4,1,0,2,45,3,2,5,-25,0,2,-1,-1,1,1,4,1
KR_6722276113,420,2,2,4,0,2,2,0,-4,0,4,1,3,2,1,3,2,0,0,0,0,-4,-10,-6,7,1,3,0,0,1,1,0,1,4,1
KR_6668349585,420,0,24,-35,-8,-8,1,9,-1,4,5,0,2,2,2,4,2,-1,0,1,0,-3,-1,0,3,3,0,0,0,-1,0,0,-1,4,1
KR_6736262890,440,-4,-27,4,-17,1,2,1,-10,1,11,-4,2,6,-4,3,7,0,2,2,-1,-16,-3,-5,6,1,3,0,0,-1,-1,-1,-1,1,1
KR_6600839919,420,4,37,-26,19,4,5,1,3,4,1,8,10,2,5,6,1,-1,0,1,0,26,7,2,1,3,4,0,4,1,1,1,-1,6,1
KR_6754221017,420,-3,-50,1,-5,-2,0,2,1,2,1,-4,1,5,-2,4,6,2,2,0,0,-3,110,0,5,5,0,0,1,1,1,1,1,4,1
KR_6762961681,420,0,-16,6,1,0,1,1,-1,1,2,-1,0,1,-2,0,2,5,5,0,0,-2,295,5,1,6,0,0,0,0,-1,0,1,0,1
KR_6715131128,420,0,-29,-27,-2,3,4,1,1,2,1,-2,1,3,-1,3,4,-3,0,3,0,-3,-14,0,4,4,-2,0,1,1,1,1,1,5,1
KR_6735621172,420,2,3,0,-1,-2,0,2,-2,0,2,2,7,5,0,2,2,1,2,1,0,-1,-22,-3,3,0,-1,0,1,1,-1,1,1,1,1
KR_6710820887,420,2,6,8,3,1,2,1,2,4,2,-1,0,1,3,6,3,-2,0,2,-1,8,-198,4,3,7,3,0,1,-1,1,-1,-1,2,1
KR_6736863706,420,4,72,3,7,-5,0,5,-1,5,6,5,6,1,5,5,0,3,4,1,0,13,-29,0,4,4,15,0,2,-1,1,1,1,2,1
KR_6684447761,420,0,29,4,-3,-1,2,3,0,1,1,0,2,2,-4,1,5,2,2,0,1,-7,32,-4,4,0,3,0,0,-1,0,0,1,1,1
KR_6591393991,420,0,49,19,0,6,6,0,-2,3,5,0,3,3,-3,2,5,-1,1,2,-1,-7,-24,2,4,6,-3,0,3,1,1,1,-1,4,1
KR_6643214055,420,-1,-9,35,-6,-1,3,4,-4,1,5,5,7,2,-3,0,3,-3,0,3,0,-13,-113,-1,7,6,3,0,1,1,1,-1,1,5,1
KR_6734224467,440,0,44,-30,5,3,5,2,1,2,1,1,4,3,0,2,2,0,1,1,0,10,18,-1,7,6,-2,0,0,1,1,-1,1,1,1
KR_6753896090,420,2,-2,16,5,2,3,1,-1,3,4,1,1,0,1,1,0,2,2,0,0,1,59,0,4,4,2,0,1,0,1,1,1,0,1
KR_6675631100,420,-2,38,0,-5,-2,0,2,-2,2,4,3,4,1,-4,1,5,0,1,1,0,-6,12,3,2,5,-2,0,1,-1,1,1,1,3,1
KR_6756491530,420,1,-6,16,6,-2,0,2,5,6,1,1,3,2,-1,2,3,3,4,1,0,8,144,1,4,5,-5,0,1,-1,0,1,1,4,1
KR_6726543735,420,2,1,19,9,-3,0,3,0,1,1,4,4,0,4,7,3,4,4,0,0,11,-2,-3,5,2,4,0,0,1,-1,1,1,5,1
KR_6730143819,420,0,22,-3,-8,0,4,4,-5,2,7,1,1,0,-4,2,6,0,1,1,0,-19,10,5,1,6,-5,0,1,-1,1,1,-1,6,1
KR_6746081075,420,-5,-37,-14,-14,1,2,1,-1,1,2,-9,1,10,-4,4,8,-1,0,1,0,0,176,-3,6,3,-15,0,-2,-1,-1,-1,-1,2,1
KR_6466680944,420,2,-54,43,4,0,0,0,4,7,3,2,4,2,-1,3,4,-1,0,1,0,3,36,1,2,3,2,0,1,1,1,1,-1,5,1
KR_6676319169,420,3,59,-8,10,2,3,1,4,6,2,5,5,0,-2,3,5,1,1,0,1,17,275,6,0,6,-5,0,3,1,1,1,-1,4,1
KR_6764299496,440,5,53,36,11,1,3,2,2,3,1,8,10,2,-1,2,3,1,3,2,0,-6,4,5,1,6,-1,0,2,1,1,1,1,5,1
KR_6197052788,420,3,28,5,10,0,2,2,2,3,1,1,1,0,4,4,0,3,3,0,0,14,13,6,3,9,4,0,2,1,1,1,1,1,1
KR_6739111947,420,-3,-11,0,-6,3,5,2,-3,1,4,0,1,1,-4,3,7,-2,1,3,0,-10,-7,1,7,8,-10,0,0,1,-1,-1,-1,5,1
KR_6764898063,440,4,25,8,4,-3,1,4,-1,4,5,2,2,0,9,11,2,-3,2,5,0,5,-5,4,2,6,-3,0,0,0,1,1,1,0,1
KR_6733278284,420,1,26,-4,0,0,2,2,-1,2,3,0,1,1,1,5,4,0,1,1,0,0,0,-4,6,2,2,0,0,-1,1,0,-1,4,1
KR_6716113483,440,-3,-23,-15,0,-3,1,4,-1,2,3,0,0,0,1,1,0,3,4,1,0,0,9,5,4,9,-2,0,0,1,1,0,1,2,1
KR_6761948662,420,3,3,6,6,0,1,1,0,5,5,2,3,1,4,6,2,0,1,1,0,11,18,-5,8,3,5,0,0,1,1,0,-1,6,1
KR_6760407394,420,4,15,20,4,3,4,1,-3,1,4,2,4,2,2,3,1,0,1,1,0,2,4,-2,5,3,2,0,0,1,-1,0,1,2,1
KR_6658777257,420,-2,-49,0,1,0,3,3,1,5,4,8,10,2,-7,1,8,-1,1,2,1,-1,-7,-4,9,5,6,0,-1,-1,1,-1,1,6,1
KR_6731826622,420,2,54,8,6,-1,1,2,0,5,5,1,3,2,3,7,4,3,5,2,0,1,12,-2,3,1,0,0,2,1,-1,1,-1,2,1
KR_6759579430,440,3,20,8,8,-3,0,3,3,3,0,2,3,1,4,5,1,2,4,2,0,10,379,-5,7,2,13,0,0,1,1,1,1,2,1
KR_6648246420,420,-1,-23,-20,-5,2,5,3,1,2,1,-2,2,4,-7,0,7,1,2,1,0,4,-9,3,6,9,2,0,-1,1,1,-1,1,2,1
KR_6743915620,440,4,51,16,8,1,2,1,0,1,1,5,6,1,-2,4,6,4,5,1,0,-6,5,-1,3,2,1,0,0,1,1,-1,-1,3,1
KR_6759673520,420,-1,-5,-9,-1,0,1,1,-3,1,4,-1,1,2,2,3,1,1,2,1,0,-6,8,2,1,3,1,0,0,-1,1,1,-1,6,1
KR_6756104578,420,3,57,-24,6,-2,1,3,2,4,2,3,3,0,2,3,1,1,3,2,0,9,0,-2,5,3,0,0,0,-1,1,0,1,3,1
KR_6763052586,420,1,4,19,5,0,1,1,-1,2,3,6,6,0,1,2,1,-1,3,4,0,3,-12,-1,4,3,0,0,1,1,1,1,1,1,1
KR_6759958976,420,6,74,44,16,3,4,1,5,5,0,-1,0,1,7,7,0,2,2,0,0,16,14,5,1,6,1,0,3,1,1,1,1,3,1
KR_6715980072,420,9,48,62,15,2,2,0,3,5,2,5,7,2,3,4,1,2,2,0,0,11,-153,3,2,5,2,0,2,1,1,1,1,3,1
KR_6759655917,440,3,40,28,6,2,3,1,-2,2,4,11,12,1,-2,2,4,-3,2,5,0,-3,-5,2,3,5,0,0,2,1,-1,1,1,4,1
KR_6620118252,420,0,48,-3,2,1,5,4,-1,1,2,0,1,1,4,5,1,-2,2,4,1,0,136,-1,4,3,-3,0,0,1,1,1,1,3,1
KR_6743676146,440,5,45,21,11,1,2,1,2,4,2,5,5,0,2,4,2,1,1,0,1,7,212,-2,6,4,2,0,2,1,1,1,1,4,1
KR_6445317747,420,-1,-16,16,2,1,1,0,-2,4,6,-4,0,4,7,9,2,0,0,0,1,2,-1,3,6,9,2,0,0,-1,1,0,1,3,1
KR_6733930342,420,6,-4,20,15,1,3,2,4,6,2,2,3,1,7,9,2,1,3,2,0,17,-1,2,5,7,3,0,3,-1,1,1,-1,5,1
KR_6646164130,420,4,39,-3,6,3,3,0,0,2,2,-1,1,2,1,3,2,3,3,0,-1,2,5,0,5,5,0,0,3,1,1,1,-1,5,1
KR_6754376829,420,2,56,4,13,1,1,0,-5,3,8,10,10,0,6,6,0,1,2,1,1,19,8,4,1,5,1,0,1,1,0,1,1,1,1
KR_6693139555,420,7,67,12,12,1,1,0,4,5,1,1,3,2,5,6,1,1,3,2,0,10,1,-2,5,3,3,0,1,1,1,1,-1,6,1
KR_6763199032,420,1,31,-32,4,1,4,3,0,2,2,2,3,1,1,1,0,0,0,0,0,8,-112,0,1,1,1,0,1,-1,1,1,1,1,1
KR_6764456433,420,2,47,-28,2,2,4,2,-2,1,3,4,4,0,-1,1,2,-1,0,1,0,4,-10,1,5,6,1,0,2,0,1,1,-1,0,1
KR_6763361567,420,4,43,12,9,7,7,0,-1,0,1,2,3,1,4,6,2,-3,0,3,1,5,0,3,3,6,4,0,1,1,1,1,1,4,1
KR_6756305047,420,4,112,31,9,-1,1,2,3,3,0,4,4,0,3,6,3,0,1,1,0,9,-7,2,2,4,1,0,1,1,-1,1,-1,6,1
KR_6730241827,420,3,21,35,2,4,5,1,-2,3,5,-3,1,4,2,2,0,1,1,0,0,-1,-6,-2,6,4,4,0,1,-1,1,1,1,1,1
KR_6730006886,420,-2,-12,-1,-8,-4,0,4,1,2,1,-2,2,4,-2,2,4,-1,0,1,0,-4,-13,-1,4,3,-2,0,0,-1,-1,0,-1,3,1
KR_6726535116,420,2,29,8,1,5,6,1,0,4,4,-1,1,2,-4,0,4,1,4,3,0,7,-179,-4,5,1,4,0,0,-1,1,1,-1,2,1
KR_6733960544,420,-2,-24,-10,-4,0,1,1,-2,2,4,-2,2,4,0,1,1,0,2,2,-1,1,-12,-1,4,3,3,0,-1,-1,-1,-1,-1,2,1
KR_6761802569,420,3,28,4,4,1,1,0,0,1,1,4,4,0,-3,1,4,2,2,0,0,2,32,-1,5,4,5,0,1,0,1,1,-1,0,1
KR_6662621680,420,3,62,5,-3,3,3,0,-3,1,4,-5,2,7,3,5,2,-1,0,1,0,0,95,2,2,4,2,0,1,1,0,1,1,5,1
KR_6691240758,420,4,65,-42,13,5,5,0,4,5,1,3,5,2,-1,1,2,2,2,0,0,7,-25,-2,4,2,1,0,1,-1,-1,1,1,6,1
KR_6738984140,420,3,33,20,4,-1,1,2,7,8,1,-3,2,5,-1,2,3,2,2,0,0,15,4,-3,6,3,4,0,1,1,1,1,-1,5,1
KR_6727062976,420,6,102,14,12,4,4,0,1,4,3,5,6,1,-1,2,3,3,3,0,1,16,-3,-5,6,1,1,0,2,1,-1,1,1,2,1
KR_6663472332,420,0,55,-4,6,-3,2,5,1,6,5,-3,2,5,7,8,1,4,5,1,0,11,0,-5,6,1,5,0,2,-1,1,1,1,6,1
KR_6760987400,420,1,46,21,0,-2,2,4,0,1,1,-1,0,1,3,3,0,0,1,1,0,0,-3,-2,6,4,-1,0,0,1,-1,0,1,2,1
KR_6763439531,440,1,44,67,4,-1,1,2,3,6,3,-3,1,4,5,5,0,0,0,0,0,6,2,3,2,5,2,0,0,1,1,0,1,3,1
KR_6718777043,420,8,76,36,-5,-2,1,3,-2,0,2,0,2,2,-1,0,1,0,0,0,-1,-3,19,0,2,2,-1,0,1,1,-1,1,-1,4,1
KR_6763555631,440,-3,-59,0,-4,-3,1,4,0,0,0,0,0,0,-1,0,1,0,1,1,0,-2,2,3,4,7,-5,0,-2,0,1,-1,-1,0,1
KR_6753728276,420,4,20,4,15,1,3,2,1,1,0,8,8,0,2,2,0,3,3,0,0,20,0,2,1,3,2,0,0,1,0,1,1,5,1
KR_6757038924,420,1,53,4,7,-1,1,2,2,5,3,3,3,0,2,4,2,1,1,0,0,11,0,1,5,6,-3,0,2,1,0,1,1,6,1
KR_6761723766,440,-1,-46,0,-10,-3,0,3,-5,0,5,4,6,2,-6,0,6,0,0,0,0,-6,-4,0,7,7,-3,0,0,0,1,0,-1,0,1
KR_6752080987,420,-1,28,-20,-1,2,2,0,0,1,1,-1,1,2,-4,3,7,2,4,2,0,0,1,6,1,7,0,0,0,1,-1,0,1,2,1
KR_6729502033,420,-1,-60,-23,1,-3,1,4,0,5,5,0,2,2,2,6,4,2,3,1,0,9,0,-1,4,3,3,0,0,1,-1,0,-1,3,1
KR_6707625085,420,1,-13,-4,6,1,4,3,0,2,2,4,7,3,2,4,2,-1,0,1,0,2,-4,3,8,11,1,0,0,-1,1,1,1,6,1
KR_6762844229,440,3,12,-12,7,-1,0,1,9,10,1,4,6,2,-2,2,4,-3,0,3,0,13,-45,7,0,7,35,0,2,1,-1,1,1,1,1
KR_6746294501,420,1,86,-8,-3,-2,1,3,1,4,3,-1,1,2,-1,1,2,0,0,0,0,-5,381,1,2,3,4,0,2,1,-1,1,-1,3,1
KR_6662837543,420,-1,-9,2,9,-1,3,4,-1,1,2,10,10,0,1,4,3,0,0,0,0,5,-7,3,6,9,-1,0,-1,1,0,-1,1,6,1
KR_6689296106,420,2,4,-8,4,0,1,1,5,5,0,1,2,1,-1,2,3,-1,2,3,0,3,110,1,1,2,-2,0,0,-1,1,-1,-1,3,1
KR_6706656440,420,3,26,-8,0,3,3,0,-3,4,7,-4,0,4,3,6,3,1,1,0,0,-8,9,1,3,4,1,0,0,-1,-1,1,1,2,1
KR_6751197248,440,2,15,-13,10,0,2,2,-2,1,3,5,6,1,8,9,1,-1,0,1,0,3,-9,0,6,6,1,0,2,-1,-1,1,1,4,1
KR_6740835325,420,-1,-32,27,-4,-3,0,3,-2,0,2,4,6,2,-2,2,4,-1,0,1,0,-7,2,-3,5,2,0,0,0,-1,1,0,-1,4,1
KR_6693571109,420,4,18,-8,10,4,4,0,5,6,1,1,2,1,0,1,1,0,1,1,0,7,0,-1,3,2,3,0,1,-1,1,1,1,1,1
KR_6458129416,420,-4,-1,-28,-5,-2,0,2,-3,2,5,-6,3,9,5,6,1,1,1,0,-1,-6,-7,-1,4,3,6,0,1,-1,-1,1,-1,5,1
KR_6752781207,420,-2,30,-16,-8,0,1,1,0,1,1,-5,0,5,-3,1,4,0,0,0,0,-7,-26,-1,4,3,0,0,0,0,-1,0,-1,0,1
KR_6671903036,420,3,8,43,15,0,3,3,3,5,2,3,6,3,3,7,4,6,6,0,3,18,0,0,2,2,4,0,0,1,1,1,1,1,1
KR_6720736429,420,0,29,9,1,-3,2,5,-1,0,1,2,2,0,3,3,0,0,0,0,-1,0,-204,2,4,6,-3,0,1,1,-1,1,-1,4,1
KR_6757961978,420,4,38,13,-4,2,2,0,-1,3,4,-1,2,3,-6,1,7,2,3,1,0,-6,3,-1,5,4,-1,0,0,1,0,0,-1,4,1
KR_6650245479,420,0,-21,8,1,-3,1,4,-3,1,4,2,2,0,4,4,0,1,1,0,0,6,-9,-4,8,4,3,0,0,1,1,0,-1,6,1
KR_6718024990,440,-3,14,0,-4,-4,2,6,3,4,1,2,5,3,-5,0,5,0,1,1,-1,-10,-49,-3,6,3,16,0,-1,-1,0,-1,-1,3,1
KR_6723215945,420,3,55,12,0,5,6,1,-3,0,3,1,1,0,-2,0,2,-1,0,1,0,2,8,-4,6,2,1,0,2,-1,1,1,-1,3,1
KR_6758606065,420,2,71,-12,11,1,2,1,2,2,0,-1,1,2,9,9,0,0,0,0,0,11,3,4,2,6,4,0,1,1,0,1,1,2,1
KR_6725100052,420,2,6,27,5,5,5,0,0,4,4,-5,0,5,6,7,1,-1,1,2,0,5,-5,1,3,4,1,0,1,1,-1,1,1,4,1
KR_6625383374,420,3,126,32,4,4,4,0,-3,1,4,-5,3,8,5,5,0,3,3,0,0,0,-10,-2,3,1,9,0,1,1,0,1,1,1,1
KR_6751672829,420,-1,-14,8,4,0,1,1,2,4,2,0,3,3,2,5,3,0,2,2,0,4,6,6,4,10,0,0,0,1,1,0,1,6,1
KR_6649444308,420,-1,-56,-32,0,0,1,1,3,3,0,3,3,0,-6,0,6,0,1,1,0,-5,6,-2,5,3,0,0,1,-1,1,1,-1,1,1
KR_6605994804,420,4,50,36,8,3,4,1,4,4,0,-3,0,3,3,4,1,1,1,0,0,11,26,2,4,6,1,0,2,1,1,1,1,3,1
KR_6689539254,420,1,75,10,-2,0,2,2,1,2,1,-2,2,4,-1,1,2,0,3,3,0,0,13,0,2,2,-5,0,1,1,-1,1,-1,3,1
KR_6762461641,420,-1,-61,-40,3,1,4,3,0,1,1,2,4,2,0,4,4,0,2,2,-1,0,167,2,4,6,-2,0,-3,-1,-1,-1,-1,2,1
KR_6761806677,420,1,-36,-12,10,4,4,0,0,2,2,3,5,2,5,8,3,-2,0,2,0,3,-25,3,2,5,7,0,0,0,0,-1,1,0,1
KR_6761640866,420,2,48,63,6,1,2,1,3,8,5,-1,2,3,3,5,2,0,2,2,0,2,-15,-4,5,1,1,0,2,1,1,1,-1,4,1
KR_6697537006,420,-1,25,-32,0,-2,2,4,-1,3,4,1,1,0,2,2,0,0,2,2,-1,4,-340,5,3,8,-2,0,1,-1,1,1,-1,4,1
KR_6751296275,440,0,-76,32,-7,1,2,1,0,1,1,-3,0,3,-4,0,4,-1,2,3,0,-8,42,1,5,6,-29,0,1,1,1,1,-1,4,1
KR_6748509756,420,5,19,40,1,-1,1,2,-1,1,2,1,5,4,1,1,0,1,1,0,0,3,9,1,7,8,0,0,0,1,0,0,-1,5,1
KR_6762602522,420,0,-1,-9,5,-1,1,2,0,5,5,2,2,0,2,3,1,2,2,0,0,4,-174,0,3,3,2,0,1,1,-1,1,-1,1,1
KR_6716905488,420,4,32,28,9,0,1,1,3,4,1,-2,0,2,8,12,4,0,1,1,0,12,-31,1,2,3,15,0,0,1,1,1,-1,2,1
KR_6709496461,420,2,17,-5,3,4,4,0,-4,1,5,1,2,1,2,4,2,0,0,0,0,0,-3,3,2,5,-4,0,0,1,1,1,-1,6,1
KR_6748700557,420,1,35,43,2,4,4,0,-1,0,1,2,5,3,-2,1,3,-1,2,3,0,1,-2,4,4,8,-4,0,1,1,-1,-1,1,5,1
KR_6762327265,420,1,-14,20,2,4,4,0,1,2,1,-1,3,4,-1,0,1,-1,0,1,0,0,-2,-1,3,2,5,0,0,1,1,1,1,3,1
KR_6618169979,420,2,39,-24,2,1,1,0,-2,1,3,1,4,3,2,3,1,0,1,1,0,4,-5,1,4,5,4,0,0,-1,1,1,-1,6,1
KR_6754436823,420,0,-23,24,-1,0,0,0,3,4,1,0,1,1,-3,1,4,-1,1,2,0,-5,-28,4,3,7,2,0,0,-1,1,0,1,6,1
KR_6764934295,420,-1,9,4,-3,-5,2,7,-3,1,4,-2,0,2,5,8,3,2,2,0,-1,0,6,-2,6,4,-2,0,0,1,-1,-1,-1,5,1
KR_6735702039,420,1,84,8,3,1,1,0,-1,0,1,-1,1,2,3,5,2,1,1,0,0,4,-8,2,5,7,5,0,0,-1,1,0,1,2,1
KR_6764001608,440,0,50,-12,-4,1,4,3,0,3,3,-3,2,5,-1,2,3,-1,2,3,0,-2,10,-1,5,4,1,0,1,1,1,1,1,5,1
KR_6749923053,420,1,86,-28,6,-4,0,4,-2,1,3,2,5,3,7,7,0,3,6,3,0,5,1,3,1,4,2,0,2,1,1,1,1,5,1
KR_6720204049,420,1,43,23,1,4,4,0,0,1,1,4,6,2,-5,1,6,-2,0,2,0,-6,-13,-3,6,3,6,0,1,1,1,1,-1,2,1
KR_6620147129,440,-1,-33,27,2,-6,2,8,1,2,1,-2,0,2,7,7,0,2,2,0,0,6,3,1,2,3,1,0,1,1,-1,1,-1,5,1
KR_6711800292,420,3,32,17,6,-1,4,5,1,3,2,3,5,2,0,4,4,3,6,3,-1,12,6,-1,4,3,6,0,0,-1,1,0,-1,5,1
KR_6758520946,420,1,31,1,0,-3,0,3,-1,3,4,0,1,1,1,1,0,3,3,0,0,2,-3,5,3,8,-1,0,2,1,1,1,1,4,1
KR_6749575327,420,6,28,13,17,-3,0,3,10,10,0,8,8,0,2,2,0,0,0,0,0,21,1,-1,6,5,-4,0,0,0,-1,1,1,0,1
KR_6717229893,420,1,-6,0,5,3,4,1,5,6,1,0,2,2,-3,1,4,0,2,2,0,4,-8,-2,5,3,1,0,0,1,1,0,1,2,1
KR_6659839604,440,3,-13,20,5,1,2,1,0,2,2,2,2,0,0,3,3,2,2,0,0,-2,6,3,3,6,-4,0,0,-1,1,0,-1,6,1
KR_6662931190,420,4,28,0,6,0,4,4,6,8,2,-1,1,2,-1,1,2,2,3,1,-2,1,0,3,4,7,2,0,1,1,1,1,-1,3,1
KR_6196056743,420,-1,-74,30,3,0,2,2,-1,2,3,1,2,1,4,4,0,-1,0,1,0,6,-94,7,3,10,-3,0,0,1,1,1,1,3,1
KR_6447402147,420,6,-68,48,13,1,1,0,7,9,2,2,5,3,2,3,1,1,1,0,0,15,-34,2,3,5,20,0,0,1,-1,0,-1,5,1
KR_6462584454,420,3,-18,-16,6,3,5,2,2,5,3,-1,0,1,2,3,1,0,1,1,0,4,3,2,4,6,4,0,1,1,1,1,1,4,1
KR_6603624353,420,1,-29,2,4,-2,1,3,6,7,1,5,7,2,-3,1,4,-2,0,2,0,2,-6,1,5,6,4,0,-1,1,-1,-1,1,5,1
KR_6754386760,420,3,106,35,11,3,3,0,3,5,2,4,6,2,0,4,4,1,1,0,0,10,0,5,1,6,0,0,1,0,1,1,1,0,1
KR_6764117899,420,1,15,24,2,-1,1,2,7,8,1,1,1,0,-5,0,5,0,0,0,0,-2,-7,-4,8,4,4,0,0,1,1,0,1,1,1
KR_6745776196,440,6,83,24,10,6,6,0,1,3,2,1,3,2,2,4,2,0,3,3,0,3,-3,5,4,9,0,0,2,1,-1,1,1,2,1
KR_6530297112,420,0,13,2,-2,-1,2,3,-1,4,5,-2,2,4,2,4,2,0,0,0,-1,-4,4,3,6,9,-3,0,-1,-1,1,-1,-1,2,1
KR_6669402704,420,0,0,24,5,0,4,4,-1,8,9,2,2,0,2,6,4,2,2,0,0,15,4,0,6,6,0,0,0,-1,1,-1,-1,5,1
KR_6756629853,420,4,35,27,-4,0,1,1,1,4,3,0,3,3,-2,4,6,-3,0,3,0,-4,257,-2,3,1,-2,0,4,1,-1,1,-1,4,1
KR_6689918318,420,1,-8,1,0,1,1,0,-1,5,6,3,3,0,-3,3,6,0,2,2,-2,-5,-14,-4,7,3,1,0,1,1,1,1,-1,2,1
KR_6758776620,420,0,-87,52,1,-1,2,3,0,3,3,-2,0,2,1,6,5,3,3,0,0,8,26,7,3,10,-1,0,-2,1,1,-1,-1,5,1
KR_6761024076,420,-2,-47,0,2,-2,0,2,1,3,2,-4,0,4,3,6,3,4,5,1,-1,7,5,-4,7,3,3,0,0,-1,1,0,-1,1,1
KR_6714158145,420,2,-13,40,2,3,3,0,1,4,3,-2,3,5,-2,0,2,2,3,1,0,-19,2,0,4,4,-4,0,0,0,-1,0,-1,0,1
KR_6700541235,420,2,73,11,9,0,3,3,3,3,0,11,13,2,3,5,2,-8,1,9,0,11,14,7,0,7,2,0,1,0,-1,1,1,0,1
KR_6698934031,420,2,74,8,7,5,5,0,3,4,1,-1,1,2,-1,1,2,1,3,2,0,5,50,4,3,7,-25,0,3,1,1,1,1,5,1
KR_6764328975,440,1,1,-9,-1,3,8,5,-1,0,1,-8,0,8,1,1,0,4,4,0,0,0,6,1,4,5,-3,0,0,1,1,1,-1,2,1
KR_6681494538,420,3,81,-9,0,2,3,1,-3,0,3,-1,1,2,1,3,2,1,3,2,-1,-10,32,5,1,6,-17,0,1,-1,1,1,-1,1,1
KR_6763381420,420,3,44,2,6,1,1,0,0,2,2,3,3,0,-1,5,6,3,3,0,-1,5,3,-2,7,5,2,0,0,-1,1,1,-1,3,1
KR_6762181878,420,2,18,4,-3,2,5,3,-6,0,6,-2,0,2,3,5,2,0,0,0,0,-12,-4,1,4,5,1,0,-1,-1,-1,-1,-1,2,1
KR_6692459198,420,3,50,48,-1,-1,4,5,1,4,3,0,1,1,-4,2,6,3,6,3,1,-1,-24,-3,8,5,4,0,3,1,1,1,1,5,1
KR_6756768223,420,2,-12,23,5,-1,1,2,8,8,0,1,1,0,-2,2,4,-1,1,2,0,5,0,-4,6,2,26,0,0,1,-1,-1,1,5,1
KR_6739988755,420,-4,32,-50,-6,-1,2,3,-3,1,4,3,4,1,-3,2,5,-2,0,2,0,-2,-4,1,4,5,-4,0,-1,0,1,-1,-1,0,1
KR_6757659342,440,-3,-39,-4,-7,2,2,0,-1,1,2,0,2,2,0,3,3,-8,0,8,-1,-5,0,-2,4,2,0,0,-1,-1,1,-1,1,2,1
KR_6749419697,420,5,32,32,14,1,4,3,3,5,2,4,5,1,7,7,0,-1,3,4,0,13,-9,-3,5,2,4,0,0,1,1,0,1,5,1
KR_6743152520,440,-2,15,5,2,1,3,2,2,3,1,4,5,1,0,2,2,-5,3,8,-1,-8,5,0,3,3,1,0,1,-1,1,1,-1,2,1
KR_6763238424,420,3,13,-5,5,2,5,3,3,3,0,-4,0,4,4,4,0,0,0,0,0,6,11,3,2,5,2,0,2,1,1,1,1,5,1
KR_6730062769,420,7,44,20,7,4,5,1,1,1,0,3,3,0,2,5,3,-3,0,3,-1,1,0,4,3,7,3,0,3,1,1,1,-1,3,1
KR_6763964925,420,3,70,0,3,-2,1,3,1,1,0,5,6,1,-2,2,4,1,3,2,0,-4,3,0,7,7,-8,0,1,1,-1,-1,-1,1,1
KR_6649912275,420,0,-31,16,-1,2,3,1,-1,6,7,4,6,2,-3,1,4,-3,0,3,-1,-12,1,0,5,5,0,0,0,1,1,0,-1,3,1
KR_6738591878,420,1,8,2,1,0,0,0,1,3,2,1,3,2,-2,2,4,1,3,2,-1,3,26,3,2,5,5,0,0,0,0,0,-1,0,1
KR_6690980436,420,-1,-95,-28,-3,-5,0,5,0,3,3,0,2,2,1,1,0,1,2,1,-1,-4,16,0,5,5,-2,0,0,-1,1,-1,-1,3,1
KR_6196862330,420,5,58,33,10,3,3,0,-1,2,3,2,2,0,5,5,0,1,1,0,0,9,2,2,4,6,-2,0,1,1,-1,1,1,1,1
KR_6758438827,440,2,30,8,3,-1,1,2,-3,4,7,-1,1,2,7,8,1,1,1,0,0,2,15,5,2,7,-6,0,1,1,1,1,1,1,1
KR_6751278122,420,0,12,12,4,5,5,0,-2,0,2,-1,1,2,2,2,0,0,0,0,0,-2,1,3,4,7,7,0,0,1,1,0,1,1,1
KR_6743345430,420,3,21,8,1,3,4,1,1,6,5,-2,3,5,-3,2,5,2,2,0,0,4,-6,-5,8,3,6,0,1,-1,1,1,-1,4,1
KR_6749270977,420,-1,38,-12,1,-2,2,4,0,3,3,1,2,1,3,4,1,-1,0,1,0,1,-7,-1,3,2,2,0,0,1,1,1,1,1,1
KR_6701314269,420,4,33,16,6,-3,2,5,0,1,1,3,3,0,7,7,0,-1,1,2,-1,11,-245,2,3,5,4,0,1,1,-1,1,-1,5,1
KR_6740957782,420,-2,-25,6,-5,0,1,1,-1,1,2,1,1,0,-3,1,4,-2,1,3,-1,-8,0,0,5,5,2,0,0,-1,1,-1,-1,6,1
KR_6706661887,440,0,8,-8,1,-4,0,4,-2,2,4,3,6,3,3,4,1,1,2,1,-1,5,4,-2,6,4,2,0,0,1,-1,1,-1,1,1
KR_6763098483,420,4,62,15,6,1,3,2,0,2,2,3,6,3,2,3,1,0,2,2,0,4,114,4,0,4,1,0,2,1,1,1,-1,5,1
KR_6715159686,420,1,9,16,6,2,2,0,4,4,0,-1,1,2,0,3,3,1,1,0,1,8,10,2,4,6,0,0,1,1,1,1,1,2,1
KR_6762311397,420,6,92,40,11,5,7,2,1,2,1,1,4,3,2,3,1,2,3,1,-2,-2,6,2,4,6,-1,0,4,1,-1,1,-1,1,1
KR_6672291840,420,3,97,32,6,2,3,1,1,2,1,1,1,0,3,4,1,-1,0,1,0,6,8,4,2,6,-1,0,1,1,1,1,1,1,1
KR_6761530973,420,3,21,4,8,-2,0,2,3,6,3,-1,5,6,9,10,1,-1,0,1,0,8,3,1,7,8,0,0,0,-1,1,1,1,6,1
KR_6517680688,420,2,9,4,-1,0,1,1,0,1,1,1,3,2,-1,0,1,-1,0,1,0,-4,-30,-1,4,3,-3,0,0,1,1,0,-1,5,1
KR_6757103633,440,3,8,18,5,-2,1,3,3,3,0,0,1,1,4,6,2,0,1,1,0,2,19,-1,7,6,-3,0,0,-1,1,0,1,6,1
KR_6745123797,440,0,23,-8,1,-3,1,4,3,3,0,-2,2,4,0,1,1,3,3,0,0,9,9,1,3,4,2,0,0,1,-1,0,1,2,1
KR_6759315972,440,-2,20,-5,1,1,2,1,0,2,2,0,3,3,3,6,3,-3,0,3,1,-5,-18,1,7,8,1,0,0,-1,1,1,1,2,1
KR_6609067969,420,3,27,8,12,-1,1,2,1,2,1,7,10,3,5,6,1,0,1,1,1,17,223,2,1,3,1,0,3,1,1,1,1,2,1
KR_6748797610,420,-2,11,-12,-3,2,3,1,-1,4,5,-1,4,5,-4,1,5,1,2,1,-1,-16,9,0,3,3,-6,0,0,-1,0,0,-1,1,1
KR_6761865874,420,1,-23,5,-1,5,6,1,-2,4,6,-2,0,2,-3,2,5,1,2,1,0,-3,-10,0,3,3,-4,0,-2,1,-1,-1,1,1,1
KR_6684321839,420,-1,-44,12,-6,0,0,0,0,1,1,-3,0,3,-2,2,4,-1,1,2,1,-12,-9,-4,5,1,-1,0,0,-1,1,-1,1,6,1
KR_6760493832,420,3,8,-1,9,0,0,0,5,6,1,4,6,2,0,4,4,0,1,1,0,11,144,-2,5,3,5,0,0,1,1,0,1,5,1
KR_6740506827,420,3,62,7,10,1,3,2,7,7,0,1,3,2,3,7,4,-2,0,2,0,9,2,0,2,2,4,0,1,-1,-1,1,1,2,1
KR_6754754414,420,3,31,38,4,1,5,4,3,6,3,0,1,1,2,2,0,-2,2,4,0,3,135,2,4,6,3,0,1,1,1,1,-1,6,1
KR_6697856451,420,2,47,14,6,-1,4,5,-1,3,4,5,5,0,1,3,2,2,3,1,0,9,1,0,6,6,0,0,2,1,0,1,-1,2,1
KR_6743858719,420,-1,-45,28,-6,1,1,0,2,4,2,-1,1,2,-7,0,7,-1,2,3,0,0,7,3,4,7,-6,0,-1,-1,1,-1,-1,1,1
KR_6761871587,420,1,-17,0,6,-2,1,3,1,1,0,7,8,1,0,2,2,0,0,0,0,5,7,-1,6,5,4,0,0,1,1,0,1,5,1
KR_6740450176,420,-1,-6,-4,-3,1,1,0,0,3,3,3,6,3,-5,2,7,-2,0,2,-1,-7,-2,1,2,3,0,0,0,1,1,1,-1,1,1
KR_6720794898,420,-2,-37,-16,-7,-3,1,4,-3,2,5,-3,3,6,3,8,5,-1,0,1,0,4,-16,-1,4,3,3,0,-1,1,-1,-1,-1,4,1
KR_6740617247,420,7,112,8,14,1,2,1,7,7,0,-3,1,4,6,9,3,3,3,0,0,13,-4,6,1,7,0,0,2,0,1,1,1,0,1
KR_6753911343,420,3,32,20,11,2,2,0,1,1,0,0,3,3,7,7,0,1,2,1,0,17,-9,-1,4,3,4,0,0,1,1,1,1,5,1
KR_6735665835,420,3,-1,16,5,-3,2,5,0,1,1,-1,1,2,8,8,0,1,2,1,0,8,-20,3,6,9,2,0,0,1,1,0,-1,3,1
KR_6728777124,420,-1,34,0,-1,0,2,2,0,3,3,-1,1,2,0,4,4,0,0,0,1,0,-14,-3,7,4,3,0,0,0,-1,1,1,0,1
KR_6763853312,440,5,78,28,9,-6,0,6,5,7,2,6,6,0,3,3,0,1,1,0,0,10,-5,-1,3,2,3,0,2,1,1,1,-1,5,1
KR_6741695102,420,3,2,33,3,-2,0,2,4,5,1,2,3,1,-1,2,3,0,0,0,0,9,121,0,4,4,1,0,0,1,-1,0,1,2,1
KR_6747445750,420,3,-5,-8,2,0,3,3,-2,2,4,2,4,2,2,5,3,0,1,1,0,0,-15,5,5,10,-1,0,1,1,-1,1,-1,5,1
KR_6763163075,420,4,79,20,1,2,2,0,0,0,0,-2,0,2,0,2,2,1,1,0,0,2,-2,-3,5,2,0,0,0,0,1,0,-1,0,1
KR_6721907619,420,0,-14,-2,6,-7,0,7,1,2,1,1,3,2,7,10,3,4,4,0,0,16,6,1,5,6,-1,0,1,1,-1,-1,1,2,1
KR_6691799333,420,-3,-6,-46,0,-7,1,8,1,3,2,2,3,1,2,4,2,2,2,0,0,7,-2,-2,4,2,1,0,0,-1,-1,-1,1,5,1
KR_6715383746,420,4,77,-20,9,1,1,0,4,6,2,2,5,3,-1,2,3,3,3,0,1,11,-1,6,3,9,-3,0,0,-1,0,0,1,5,1
KR_6760950371,420,3,-41,-4,5,2,4,2,-5,2,7,7,7,0,-4,3,7,5,6,1,-2,-1,329,-1,6,5,1,0,1,1,1,1,-1,5,1
KR_6710519750,440,2,89,44,7,0,2,2,3,3,0,2,4,2,3,3,0,-1,0,1,1,11,-5,-2,6,4,-4,0,0,1,1,1,1,5,1
KR_6761510637,420,3,90,-28,8,0,3,3,2,4,2,3,5,2,2,2,0,1,2,1,0,5,-6,7,3,10,1,0,1,1,1,1,1,6,1
KR_6699602800,420,0,33,5,1,4,4,0,-1,5,6,-1,0,1,-1,2,3,0,0,0,0,-1,-146,-4,8,4,-5,0,0,-1,0,1,-1,5,1
KR_6747960784,420,3,9,7,3,3,4,1,-2,2,4,2,4,2,0,4,4,0,0,0,0,-8,0,0,4,4,-1,0,1,1,-1,1,1,5,1
KR_6714128306,420,-3,-5,-12,-4,0,0,0,3,5,2,2,3,1,-8,2,10,-1,3,4,0,-4,1,-1,2,1,-1,0,0,-1,1,1,-1,3,1
KR_6689786369,420,-1,20,0,-3,-2,1,3,-1,1,2,-3,3,6,3,4,1,0,0,0,0,-4,50,2,4,6,-18,0,3,1,1,1,-1,2,1
KR_6675219595,420,1,27,0,-3,-3,1,4,-2,0,2,0,1,1,2,4,2,0,2,2,0,-6,-9,-4,5,1,-3,0,-1,-1,-1,-1,1,2,1
KR_6732260453,420,0,-62,4,-1,-2,2,4,4,7,3,-2,0,2,-1,3,4,0,5,5,0,7,-4,1,3,4,1,0,-2,1,-1,-1,1,5,1
KR_6686483051,420,1,-14,10,1,4,6,2,-1,0,1,4,7,3,-5,2,7,-1,0,1,-1,-9,15,-1,6,5,-2,0,0,1,0,1,-1,6,1
KR_6761482535,420,2,-2,30,4,-3,3,6,2,3,1,2,4,2,1,4,3,2,2,0,0,4,-9,-4,6,2,3,0,0,-1,-1,-1,1,2,1
KR_6757162441,420,-3,50,6,4,0,3,3,-3,1,4,3,3,0,4,6,2,0,2,2,0,-3,41,4,1,5,-5,0,0,-1,1,1,-1,2,1
KR_6620199302,420,5,81,7,10,0,1,1,1,1,0,1,1,0,6,10,4,2,2,0,0,11,-6,1,6,7,2,0,1,-1,1,1,1,5,1
KR_6444731519,420,-1,5,-11,-7,-6,1,7,-1,1,2,2,2,0,-3,3,6,1,1,0,0,-4,7,3,3,6,-6,0,-2,0,0,-1,-1,0,1
KR_6653434115,420,-1,-63,-23,2,0,3,3,-1,3,4,5,7,2,-3,4,7,1,2,1,0,-2,117,-2,4,2,-1,0,-1,1,-1,-1,1,6,1
KR_6626784977,420,2,86,-1,2,1,3,2,-2,0,2,1,3,2,3,4,1,-1,1,2,0,-2,4,4,3,7,-3,0,1,1,-1,1,1,5,1
KR_6752651876,420,8,61,22,24,2,3,1,6,8,2,7,9,2,7,9,2,2,2,0,4,29,11,-1,4,3,-1,0,1,1,1,1,1,4,1
KR_6751024966,420,9,97,46,16,0,3,3,4,7,3,6,7,1,6,6,0,0,3,3,0,11,10,3,1,4,4,0,4,1,1,1,1,4,1
KR_6656042689,440,6,68,15,14,0,2,2,1,1,0,5,10,5,2,2,0,6,7,1,1,15,1,6,4,10,-1,0,0,1,1,1,1,1,1
KR_6742392026,440,-1,-19,24,-7,-1,1,2,-1,0,1,1,2,1,-2,3,5,-4,0,4,0,-9,-15,-2,6,4,-4,0,1,-1,1,1,-1,5,1
KR_6763144732,420,2,-3,23,2,3,4,1,-2,0,2,3,3,0,-2,0,2,0,0,0,1,-3,-16,1,4,5,-5,0,-1,0,1,-1,1,0,1
KR_6748433846,420,0,-78,20,0,0,2,2,1,2,1,4,4,0,-2,2,4,-3,0,3,0,-3,0,-1,4,3,-1,0,-2,-1,1,-1,-1,6,1
KR_6763948201,420,4,-12,-9,9,-1,0,1,4,6,2,1,1,0,5,5,0,0,0,0,0,12,-8,3,2,5,-1,0,2,-1,1,1,1,6,1
KR_6566887930,420,0,-87,-8,4,1,1,0,1,1,0,2,3,1,1,3,2,-1,0,1,0,3,-2,3,4,7,0,0,0,1,1,0,1,3,1
KR_6670710648,420,-2,10,-11,3,0,4,4,-2,2,4,0,1,1,4,5,1,1,1,0,0,1,-1,6,1,7,-2,0,0,1,-1,0,1,3,1
KR_6634031509,420,0,1,-1,-2,-2,1,3,1,3,2,-1,3,4,1,3,2,-1,0,1,-2,0,13,2,6,8,1,0,0,1,1,0,-1,1,1
KR_6734001165,420,1,-13,4,-1,-1,1,2,-1,3,4,1,5,4,1,6,5,-1,0,1,2,2,1,0,8,8,3,0,0,-1,1,1,1,1,1
KR_6757681257,420,3,-56,30,3,3,3,0,-1,3,4,-3,1,4,4,4,0,0,1,1,0,0,98,-4,6,2,31,0,1,-1,1,1,1,6,1
KR_6676025465,420,1,2,5,0,5,5,0,-1,3,4,3,5,2,-4,1,5,-3,0,3,-1,-8,8,1,4,5,-3,0,2,-1,1,1,-1,5,1
KR_6752235443,420,3,75,28,12,2,5,3,2,6,4,9,9,0,1,6,5,-2,0,2,-1,1,-3,1,2,3,2,0,3,1,1,1,-1,2,1
KR_6641752280,420,2,19,-11,7,1,1,0,-2,2,4,4,6,2,2,2,0,2,7,5,0,7,0,-1,5,4,0,0,0,1,-1,0,1,1,1
KR_6373477054,440,2,78,52,-1,3,3,0,-5,3,8,6,6,0,-5,4,9,0,1,1,1,-17,0,0,0,0,1,0,2,1,1,1,1,3,1
KR_6762397514,420,3,25,19,6,2,6,4,2,4,2,-1,3,4,0,4,4,3,4,1,3,9,328,1,5,6,2,0,0,1,1,1,1,1,1
KR_6633238886,420,3,113,49,2,-2,0,2,2,3,1,5,5,0,-3,4,7,0,2,2,0,-2,2,-1,3,2,0,0,1,0,1,1,1,0,1
KR_6620126261,420,2,24,8,-1,4,4,0,-7,3,10,-1,1,2,4,6,2,-1,0,1,-1,-5,-11,-5,6,1,1,0,1,-1,1,1,-1,2,1
KR_6694390223,420,5,-25,9,7,0,2,2,3,6,3,0,1,1,5,5,0,-1,0,1,0,6,4,-1,6,5,5,0,2,1,-1,1,1,2,1
KR_6661207282,420,3,5,4,-4,-1,1,2,-2,3,5,-1,2,3,-3,0,3,3,6,3,0,-7,20,3,3,6,-6,0,0,1,-1,0,-1,5,1
KR_6719169033,420,2,30,20,3,0,2,2,1,3,2,-3,0,3,4,5,1,1,1,0,0,-1,8,-2,7,5,-1,0,1,0,-1,1,1,0,1
KR_6661258875,420,0,-20,31,-3,-1,3,4,0,2,2,-1,1,2,-1,2,3,0,0,0,0,-2,108,-7,11,4,0,0,1,1,-1,1,-1,4,1
KR_6736447925,420,4,41,44,11,0,0,0,8,8,0,4,5,1,-2,3,5,1,1,0,0,10,-213,-4,6,2,23,0,1,1,1,1,1,5,1
KR_6759404007,420,3,78,20,9,3,3,0,1,1,0,-3,2,5,5,8,3,3,3,0,0,15,4,2,4,6,1,0,3,1,1,1,1,5,1
KR_6749350439,420,-6,-28,-16,-16,-1,3,4,-3,0,3,1,3,2,-10,0,10,-3,0,3,0,-15,-24,-2,6,4,-4,0,-2,-1,-1,-1,-1,4,1
KR_6347648344,420,1,26,12,6,3,3,0,0,3,3,0,1,1,1,4,3,2,2,0,0,6,-2,2,6,8,1,0,1,1,1,1,1,5,1
KR_6719474252,420,-2,-16,19,-6,1,1,0,-6,1,7,-5,1,6,8,10,2,-4,0,4,0,-6,-22,-3,6,3,-2,0,0,-1,-1,-1,1,1,1
KR_6721227832,420,0,50,-3,7,3,3,0,7,10,3,-5,4,9,2,5,3,0,0,0,0,7,-12,-4,8,4,0,0,1,-1,1,1,1,6,1
KR_6650153364,440,1,31,5,7,3,3,0,-2,2,4,0,4,4,3,4,1,3,4,1,1,9,-11,0,5,5,18,0,0,1,-1,-1,1,5,1
KR_6733877515,420,-1,-79,3,-3,-2,0,2,-1,3,4,1,5,4,-1,2,3,0,0,0,0,1,-18,0,5,5,-1,0,0,1,1,0,-1,2,1
KR_6749463122,420,5,119,-25,9,3,3,0,5,8,3,-1,0,1,3,3,0,-1,0,1,0,7,6,0,2,2,1,0,0,1,1,1,1,3,1
KR_6488544425,440,0,-90,11,2,2,5,3,-5,4,9,1,4,3,2,5,3,2,4,2,-4,-3,4,4,7,11,-3,0,-3,-1,-1,-1,-1,4,1
KR_6730807322,420,3,33,18,12,3,4,1,4,4,0,0,2,2,5,6,1,0,1,1,3,21,-43,1,3,4,2,0,1,1,1,-1,1,3,1
KR_6757145832,420,3,24,16,10,0,0,0,3,5,2,1,2,1,5,8,3,1,1,0,1,16,4,3,1,4,0,0,1,0,-1,1,1,0,1
KR_6751295766,440,3,-4,1,1,-2,1,3,0,0,0,0,2,2,-1,2,3,4,5,1,0,-3,3,3,3,6,1,0,-1,1,-1,1,-1,4,1
KR_6494842982,420,6,93,-24,21,1,1,0,12,13,1,0,3,3,6,6,0,2,2,0,3,30,76,2,3,5,2,0,2,-1,1,1,1,5,1
KR_6732128050,420,-2,-24,-16,2,-3,0,3,0,3,3,2,3,1,3,3,0,0,1,1,0,0,0,5,1,6,2,0,-1,-1,1,-1,1,3,1
KR_6711015533,420,1,11,10,4,-3,1,4,0,2,2,4,6,2,3,3,0,0,0,0,0,3,34,-3,5,2,-24,0,1,1,0,1,-1,2,1
KR_6736740784,420,1,16,27,-2,-2,0,2,2,5,3,-1,2,3,-1,2,3,0,0,0,0,-3,-13,-5,8,3,-2,0,0,-1,0,0,-1,3,1
KR_6762535800,420,-1,-59,25,2,-2,2,4,0,3,3,2,3,1,2,4,2,0,1,1,0,1,50,1,6,7,-20,0,0,-1,1,0,1,1,1
KR_6492132115,420,1,49,-16,-3,1,2,1,-2,1,3,-3,0,3,0,7,7,1,2,1,0,-3,7,4,3,7,-4,0,0,0,1,1,-1,0,1
KR_6755055477,420,2,46,7,-2,2,5,3,-3,1,4,-2,1,3,0,1,1,1,1,0,0,-1,-142,1,2,3,-7,0,0,1,-1,1,1,3,1
KR_6721233518,420,1,30,18,0,1,1,0,-3,4,7,3,4,1,1,3,2,-2,1,3,0,-2,-10,-4,7,3,4,0,0,-1,-1,0,1,5,1
KR_6764293623,420,1,45,24,-1,3,4,1,0,5,5,-1,2,3,-3,1,4,0,1,1,0,-5,-2,-4,8,4,2,0,1,1,1,1,1,2,1
KR_6735940949,420,-4,-79,-28,-5,1,3,2,-1,2,3,-5,1,6,0,0,0,0,1,1,0,-2,2,1,5,6,1,0,-1,-1,-1,-1,-1,2,1
KR_6339119470,440,2,-10,-23,8,2,3,1,1,5,4,2,2,0,3,4,1,0,2,2,0,11,8,-1,6,5,2,0,0,-1,1,0,-1,4,1
KR_6759683377,420,2,-42,-13,-4,-2,2,4,1,3,2,2,2,0,-4,2,6,-1,0,1,-1,4,-7,3,3,6,-2,0,1,-1,1,-1,-1,4,1
KR_6446969733,420,5,30,12,8,4,4,0,1,1,0,0,2,2,0,2,2,3,3,0,0,3,10,1,5,6,0,0,0,-1,1,0,1,2,1
KR_6709646158,420,-2,-36,8,1,2,2,0,3,5,2,-4,1,5,0,3,3,0,0,0,0,2,-2,2,3,5,3,0,0,-1,1,0,1,3,1
KR_6756073358,420,2,51,24,7,0,3,3,5,7,2,3,3,0,-2,2,4,1,2,1,0,-2,5,1,4,5,0,0,2,0,1,1,-1,0,1
KR_6700934176,420,3,8,4,2,-1,2,3,2,2,0,0,3,3,1,1,0,0,2,2,0,5,30,4,4,8,1,0,1,-1,1,1,-1,5,1
KR_6744444344,420,2,-45,40,-1,0,1,1,0,0,0,5,6,1,-5,1,6,-1,2,3,0,-6,-5,-1,8,7,1,0,0,-1,1,0,-1,4,1
KR_6756541159,420,4,-20,47,9,2,2,0,10,10,0,2,4,2,-5,1,6,0,2,2,0,-1,10,0,5,5,1,0,0,1,1,1,1,3,1
KR_6591619855,420,-1,16,-12,-7,0,2,2,-4,0,4,0,3,3,0,3,3,-3,0,3,0,-8,-1,-3,4,1,1,0,0,-1,0,0,-1,2,1
KR_6447903718,420,4,70,-11,12,2,4,2,-3,4,7,4,4,0,3,5,2,6,6,0,1,10,1,-1,5,4,2,0,1,1,0,1,1,5,1
KR_6760429901,420,2,-42,-8,1,1,3,2,5,5,0,4,4,0,-9,0,9,0,3,3,0,-12,-3,4,0,4,-4,0,0,-1,1,-1,1,3,1
KR_6762460663,420,2,49,12,-1,1,1,0,1,3,2,-1,3,4,-3,3,6,1,1,0,-2,-4,3,1,6,7,-7,0,0,1,-1,0,-1,4,1
KR_6700201067,420,3,71,4,6,3,4,1,2,3,1,2,3,1,1,3,2,-2,0,2,0,5,6,2,2,4,-1,0,3,-1,1,1,1,3,1
KR_6661784939,420,-1,-50,7,-2,0,0,0,-3,6,9,-1,3,4,4,5,1,-2,2,4,-1,-10,3,3,7,10,-6,0,0,1,1,-1,-1,5,1
KR_6761989352,420,6,102,36,12,5,6,1,-1,2,3,5,6,1,2,4,2,1,2,1,1,4,52,-1,3,2,-21,0,1,0,0,1,1,0,1
KR_6682020974,420,4,70,-16,12,8,9,1,4,4,0,3,5,2,-1,2,3,-2,1,3,0,5,6,-1,5,4,1,0,3,1,1,1,1,3,1
KR_6667310322,420,0,39,-4,2,3,4,1,0,0,0,-1,2,3,0,0,0,0,0,0,1,3,-252,-2,5,3,1,0,0,-1,1,1,1,4,1
KR_6761575041,420,-2,13,-4,-4,0,0,0,0,2,2,-1,1,2,-2,3,5,-1,0,1,1,-12,12,0,7,7,-6,0,1,-1,1,1,1,4,1
KR_6757021596,420,1,61,-16,1,1,5,4,-3,1,4,-2,1,3,4,7,3,1,1,0,0,3,-173,-6,9,3,-2,0,1,1,-1,1,-1,3,1
KR_6584954146,440,4,-6,3,2,1,1,0,5,5,0,-3,1,4,-3,3,6,2,2,0,0,5,2,0,2,2,0,0,0,-1,1,-1,1,4,1
KR_6759925981,420,2,53,-3,3,3,4,1,-1,1,2,3,3,0,-1,2,3,-1,0,1,0,-4,-8,0,6,6,2,0,0,1,1,1,1,5,1
KR_6649497110,420,-2,-88,53,7,7,8,1,2,2,0,-1,4,5,-1,2,3,0,1,1,-1,-1,-14,-2,3,1,2,0,-1,0,1,1,-1,0,1
KR_6762052346,420,3,11,4,14,7,8,1,2,3,1,3,5,2,2,4,2,0,0,0,1,7,9,6,0,6,2,0,2,-1,1,1,1,1,1
KR_6761690715,420,6,40,15,10,7,8,1,0,2,2,1,3,2,0,1,1,2,2,0,0,9,-6,-1,4,3,2,0,0,0,-1,0,-1,0,1
KR_6702935263,420,1,-10,15,0,-2,2,4,6,7,1,-1,1,2,-1,1,2,-2,0,2,0,1,41,2,7,9,0,0,1,1,-1,1,-1,6,1
KR_6649312254,420,-3,-14,9,-6,-3,1,4,0,0,0,-3,2,5,0,2,2,0,0,0,0,-9,12,1,3,4,2,0,0,-1,-1,0,1,4,1
KR_6303252341,420,0,18,-4,-1,2,6,4,0,7,7,1,2,1,0,0,0,-4,0,4,0,-4,56,0,1,1,-14,0,1,1,0,1,-1,3,1
KR_5681894694,420,2,37,48,2,-3,1,4,3,3,0,-2,3,5,3,4,1,1,2,1,0,7,-2,0,3,3,3,0,4,-1,1,1,-1,5,1
KR_6665519571,420,0,-18,-11,2,-1,0,1,1,4,3,3,4,1,-3,0,3,2,2,0,0,0,-4,-4,7,3,2,0,0,0,-1,0,1,0,1
KR_6726584856,420,6,114,15,14,-1,1,2,3,6,3,4,5,1,9,9,0,-1,0,1,0,9,-14,-1,4,3,4,0,3,1,1,1,-1,1,1
KR_6758489141,420,6,98,11,18,5,5,0,1,2,1,9,9,0,3,7,4,0,2,2,0,14,-23,-3,8,5,4,0,4,1,1,1,-1,2,1
KR_6760252611,440,-1,0,-16,2,-5,0,5,-1,3,4,2,3,1,5,5,0,1,1,0,0,0,3,2,3,5,-1,0,0,1,1,0,1,5,1
KR_6661682894,420,0,56,-27,-1,1,2,1,-2,1,3,-1,0,1,2,3,1,-1,0,1,0,-3,-41,-2,7,5,3,0,1,1,-1,1,-1,4,1
KR_6674135080,420,4,96,-16,9,3,3,0,2,6,4,2,2,0,1,3,2,1,2,1,0,15,21,1,4,5,3,0,2,1,-1,1,1,4,1
KR_6657381831,420,6,-21,11,13,7,8,1,1,3,2,4,5,1,2,3,1,-1,0,1,0,6,-2,-3,5,2,4,0,0,1,1,1,1,4,1
KR_6584874351,440,4,-9,17,11,2,3,1,-1,2,3,2,3,1,5,6,1,3,5,2,1,7,1,-4,8,4,6,0,0,1,-1,0,1,1,1
KR_6761011646,420,-3,80,-20,0,1,3,2,-1,2,3,2,2,0,1,2,1,-3,0,3,0,-6,-7,-2,6,4,2,0,1,-1,1,1,1,4,1
KR_6692358554,420,1,-48,4,3,-1,2,3,2,3,1,-1,0,1,2,3,1,1,2,1,0,3,-36,-5,9,4,4,0,1,-1,0,1,-1,4,1
KR_6703677320,420,-1,3,-8,-2,-2,3,5,0,4,4,2,4,2,-3,2,5,1,2,1,0,2,-8,0,7,7,5,0,0,-1,0,0,1,4,1
KR_6733174265,440,4,107,48,4,3,3,0,-1,2,3,-1,5,6,2,2,0,1,1,0,1,-7,-8,-6,8,2,-1,0,2,1,1,1,1,5,1
KR_6675074171,420,1,16,-20,4,3,3,0,2,4,2,2,5,3,-3,2,5,0,1,1,0,-1,4,2,3,5,1,0,0,1,1,1,1,1,1
KR_6741806414,420,3,30,39,13,1,2,1,7,10,3,5,6,1,-1,6,7,1,3,2,4,12,2,-1,4,3,3,0,2,1,1,1,1,6,1
KR_6760665242,440,2,38,10,11,6,7,1,1,3,2,3,3,0,2,5,3,-1,1,2,0,10,12,-1,5,4,-4,0,0,1,1,1,1,1,1
KR_6755345602,420,3,83,-8,9,2,4,2,1,2,1,-2,0,2,7,7,0,1,1,0,0,9,164,3,2,5,2,0,0,1,1,0,1,3,1
KR_6714908556,440,0,-38,16,-4,3,3,0,5,9,4,-4,1,5,-6,2,8,-2,1,3,0,-13,-27,1,4,5,-1,0,1,-1,1,1,-1,3,1
KR_6730115598,420,0,-24,-4,7,5,5,0,7,8,1,0,2,2,-1,0,1,-4,2,6,0,6,-20,2,0,2,9,0,-1,-1,-1,-1,1,3,1
KR_6729986476,420,1,21,-4,10,2,2,0,8,10,2,1,2,1,0,1,1,-1,4,5,0,18,-13,-3,4,1,0,0,-1,0,-1,-1,1,0,1
KR_6760551657,420,1,30,4,4,4,4,0,1,4,3,2,3,1,-2,2,4,-1,0,1,0,2,8,-4,9,5,2,0,1,-1,1,1,1,4,1
KR_6557810475,420,-2,38,4,0,-1,2,3,5,8,3,3,5,2,-5,0,5,-2,0,2,0,5,20,2,3,5,-1,0,0,1,1,0,-1,6,1
KR_6623347001,420,4,95,24,9,-3,0,3,3,4,1,5,5,0,4,8,4,0,0,0,0,10,-11,6,2,8,2,0,1,1,1,1,-1,1,1
KR_6763712512,420,-2,2,-12,-7,2,2,0,-2,0,2,-4,2,6,-4,2,6,1,1,0,0,1,-21,-2,5,3,1,0,1,-1,0,1,-1,1,1
KR_6760597170,420,1,40,16,-4,2,3,1,-1,2,3,-3,1,4,1,5,4,-3,2,5,0,-6,-5,-1,4,3,6,0,-1,1,1,-1,-1,5,1
KR_6681359610,420,-2,45,-9,-1,0,3,3,-2,2,4,0,3,3,1,1,0,0,1,1,0,-4,11,1,4,5,-1,0,0,-1,-1,-1,1,1,1
KR_6674184421,420,-2,9,-13,-1,-2,0,2,3,3,0,-3,0,3,2,5,3,-1,3,4,0,7,7,9,2,11,-4,0,0,-1,-1,0,-1,6,1
KR_6742486526,420,4,19,38,9,-1,1,2,1,3,2,4,4,0,3,5,2,2,2,0,1,17,-1,0,3,3,-1,0,3,1,1,1,1,5,1
KR_6576896318,420,-5,-117,-12,-6,-1,3,4,-6,1,7,-1,4,5,3,4,1,-1,1,2,0,1,-107,-3,5,2,0,0,-2,1,1,-1,-1,6,1
KR_6758815546,420,10,6,120,18,6,8,2,6,7,1,3,3,0,0,2,2,3,5,2,0,10,4,5,2,7,1,0,3,1,1,1,1,2,1
KR_6758884303,420,2,-49,27,5,2,3,1,-1,0,1,-5,1,6,7,7,0,2,2,0,1,4,-2,-1,5,4,2,0,2,-1,1,1,1,3,1
KR_6730122820,420,2,18,12,8,-1,1,2,-4,1,5,3,5,2,7,7,0,3,4,1,0,11,4,4,1,5,3,0,0,1,-1,1,1,4,1
KR_6705931064,420,2,24,-9,7,6,6,0,9,9,0,-6,1,7,-1,1,2,-1,3,4,0,4,-5,3,2,5,-2,0,0,-1,1,1,-1,3,1
KR_6638329347,440,4,104,44,7,7,9,2,-7,1,8,4,4,0,4,6,2,-1,1,2,0,-7,1,2,5,7,-1,0,1,1,1,1,1,3,1
KR_6711319970,420,6,112,16,15,8,8,0,5,6,1,2,3,1,1,5,4,-1,2,3,0,7,7,2,1,3,1,0,4,1,1,1,1,1,1
KR_6757417844,420,1,-12,24,4,-3,1,4,4,4,0,1,4,3,2,2,0,0,0,0,1,2,-4,0,5,5,4,0,0,1,-1,-1,1,5,1
KR_6534976599,440,4,-13,30,9,1,3,2,0,1,1,-1,2,3,7,8,1,2,2,0,0,19,-62,-1,6,5,0,0,0,-1,1,1,-1,6,1
KR_6716444926,440,3,-46,8,8,2,5,3,0,1,1,1,2,1,3,4,1,2,2,0,0,10,7,-2,3,1,0,0,0,1,0,0,1,5,1
KR_6725824599,420,1,72,12,-9,1,1,0,-1,6,7,-7,0,7,0,3,3,-2,1,3,0,-10,-15,-1,4,3,-2,0,1,-1,1,1,-1,1,1
KR_6729047654,420,5,65,19,13,-2,0,2,5,5,0,5,8,3,4,6,2,1,2,1,0,16,5,-1,7,6,3,0,1,0,1,1,-1,0,1
KR_6763635140,420,2,20,2,9,0,2,2,-1,2,3,4,6,2,6,9,3,0,1,1,-1,9,5,7,4,11,-4,0,1,1,1,1,-1,3,1
KR_6636153150,420,2,111,16,4,3,3,0,2,8,6,0,2,2,0,2,2,-1,0,1,2,2,1,-2,6,4,0,0,0,1,1,0,1,5,1
KR_6762213511,420,1,-20,-8,6,0,2,2,-2,1,3,8,9,1,0,2,2,0,1,1,-1,3,365,-2,5,3,3,0,1,0,1,1,-1,0,1
KR_6502334495,420,5,69,16,7,1,4,3,1,2,1,8,8,0,-3,1,4,0,0,0,0,5,44,3,2,5,-17,0,0,1,0,0,-1,1,1
KR_6737952030,420,3,27,32,10,3,3,0,0,1,1,6,7,1,2,5,3,-1,0,1,0,4,-8,0,5,5,1,0,1,1,1,1,1,4,1
KR_6663571148,420,-1,24,4,-2,3,4,1,2,4,2,-2,2,4,-3,0,3,-2,1,3,0,-5,-24,-1,4,3,3,0,1,1,-1,1,-1,5,1
KR_6725543563,420,2,31,-4,9,1,3,2,1,2,1,2,2,0,3,4,1,2,2,0,0,10,178,-2,5,3,4,0,0,1,1,0,1,1,1
KR_6727480718,420,-1,-20,8,7,1,2,1,3,7,4,1,3,2,0,4,4,2,3,1,0,8,30,1,4,5,2,0,1,0,1,1,1,0,1
KR_6751967171,440,1,81,-12,-3,1,3,2,-4,1,5,-1,5,6,1,3,2,0,0,0,-1,-4,4,2,4,6,-15,0,0,0,-1,0,-1,0,1
KR_6717493752,420,4,83,-16,10,2,3,1,3,4,1,-1,2,3,5,5,0,1,1,0,0,14,5,0,4,4,-4,0,1,1,1,1,1,3,1
KR_6754307769,440,8,55,8,12,5,5,0,1,2,1,5,6,1,-1,7,8,2,4,2,1,8,-23,2,3,5,25,0,3,1,1,1,1,5,1
KR_6752554840,420,1,28,-8,2,-4,0,4,-1,1,2,0,2,2,6,6,0,1,1,0,0,8,-1,3,1,4,1,0,0,-1,1,1,-1,3,1
KR_6730223445,420,-2,-57,-4,-1,-1,2,3,0,4,4,-3,0,3,2,7,5,1,2,1,0,1,3,-1,6,5,0,0,-1,1,1,-1,1,5,1
KR_6633138639,420,1,36,9,3,-1,3,4,2,2,0,0,2,2,2,2,0,0,0,0,0,6,-20,2,4,6,2,0,-1,1,-1,-1,-1,2,1
KR_6654185396,420,0,38,-9,0,-3,1,4,1,4,3,-1,1,2,1,2,1,2,2,0,0,5,1,5,3,8,-1,0,-1,1,-1,-1,-1,6,1
KR_6755832156,420,4,19,30,11,-1,0,1,2,4,2,2,5,3,8,8,0,0,0,0,0,10,4,4,4,8,0,0,2,1,1,1,1,2,1
KR_6629704003,420,6,60,8,11,4,5,1,8,11,3,-3,2,5,1,2,1,1,3,2,1,11,-4,4,1,5,3,0,2,1,1,1,1,1,1
KR_6762454688,420,1,20,29,2,3,4,1,1,3,2,-2,3,5,-2,1,3,2,2,0,0,1,-11,-3,4,1,1,0,0,1,1,1,1,1,1
KR_6599581930,420,2,24,16,20,1,3,2,5,7,2,-2,2,4,11,13,2,5,5,0,1,34,2,1,3,4,0,0,1,1,0,1,1,2,1
KR_6736607343,440,4,43,14,7,1,1,0,3,3,0,5,7,2,0,2,2,-2,1,3,1,4,-25,0,4,4,-1,0,1,1,1,1,1,6,1
KR_6703558304,420,2,21,32,2,2,3,1,1,3,2,-1,3,4,1,2,1,-1,1,2,0,4,18,-3,6,3,-2,0,-1,1,-1,-1,-1,5,1
KR_6649411753,420,2,18,-7,9,3,3,0,-2,1,3,0,1,1,7,9,2,1,2,1,0,1,-10,-2,6,4,4,0,1,1,1,1,-1,1,1
KR_6741311192,420,3,19,9,11,0,0,0,1,1,0,0,3,3,8,9,1,2,2,0,0,17,24,2,2,4,7,0,1,1,1,1,1,6,1
KR_6733798656,420,4,89,0,2,3,4,1,-3,0,3,1,3,2,0,2,2,1,1,0,0,-2,2,-2,4,2,0,0,1,1,1,1,1,3,1
KR_6723196641,420,5,55,25,4,3,6,3,1,3,2,2,3,1,1,3,2,-3,1,4,0,-6,-13,1,4,5,-3,0,0,-1,1,0,1,1,1
KR_6601137856,420,8,24,28,13,3,3,0,4,4,0,6,8,2,-1,4,5,1,2,1,0,0,-1,-1,3,2,0,0,1,1,1,1,1,1,1
KR_6506249421,420,-1,-22,3,3,-3,1,4,5,6,1,-3,1,4,1,3,2,3,3,0,1,10,-394,-1,7,6,2,0,0,1,0,0,1,3,1
KR_6757947186,420,4,104,12,25,2,2,0,0,2,2,6,10,4,14,16,2,3,5,2,2,40,6,3,0,3,1,0,1,1,1,1,1,5,1
KR_6759039136,440,0,67,-13,3,0,3,3,-1,4,5,-3,3,6,9,10,1,-2,1,3,2,8,12,9,1,10,-8,0,0,-1,1,0,-1,5,1
KR_6591965072,420,0,30,30,2,-2,0,2,1,5,4,0,2,2,3,5,2,0,3,3,0,4,-8,-2,5,3,2,0,0,1,0,0,-1,5,1
KR_6724357775,440,0,-1,8,2,3,3,0,1,2,1,0,2,2,-2,0,2,0,0,0,1,2,-7,4,3,7,-2,0,0,1,-1,0,1,1,1
KR_6759113147,420,3,16,12,0,0,4,4,2,2,0,1,1,0,-2,0,2,-1,2,3,-1,3,-22,0,4,4,4,0,-1,1,-1,-1,-1,3,1
KR_6749637834,420,-3,-27,-4,0,0,1,1,0,3,3,-1,2,3,0,6,6,1,1,0,0,7,7,5,0,5,0,0,-1,-1,1,-1,-1,3,1
KR_6763243417,420,1,47,4,7,0,2,2,0,4,4,2,3,1,2,5,3,3,3,0,0,7,9,1,3,4,3,0,2,-1,1,1,-1,1,1
KR_6339174171,440,-1,64,5,-3,5,6,1,0,2,2,-3,0,3,0,2,2,-5,0,5,-1,-3,-3,1,5,6,-4,0,0,1,0,1,-1,1,1
KR_6727449041,420,-1,23,-16,-8,-1,3,4,-6,0,6,0,2,2,-2,2,4,1,1,0,0,-11,-3,6,3,9,0,0,0,-1,0,-1,1,5,1
KR_6633954460,420,1,-11,-40,0,1,1,0,2,5,3,3,5,2,-1,2,3,-5,0,5,0,-3,4,3,4,7,-1,0,-1,1,-1,-1,1,3,1
KR_6764432686,440,4,113,24,5,4,4,0,2,2,0,-1,1,2,-2,1,3,2,2,0,2,6,-42,-1,4,3,26,0,0,0,0,-1,1,0,1
KR_6759011866,420,6,82,8,9,1,3,2,-1,0,1,3,4,1,5,9,4,1,2,1,0,6,14,1,4,5,-1,0,2,-1,-1,1,1,5,1
KR_6734391550,420,-3,-32,8,-7,-3,1,4,1,1,0,0,4,4,-5,2,7,0,3,3,0,-6,-8,-3,5,2,3,0,0,-1,1,0,-1,2,1
KR_6586808988,420,3,21,0,5,2,2,0,2,5,3,0,2,2,1,5,4,0,0,0,1,4,-15,2,6,8,2,0,2,1,1,1,1,6,1
KR_6763734310,420,1,-2,8,2,-1,2,3,6,6,0,-1,1,2,0,0,0,-2,1,3,0,-1,-322,1,4,5,0,0,0,-1,1,1,-1,2,1
KR_6674091599,420,3,19,16,5,3,4,1,2,4,2,2,4,2,1,1,0,-3,1,4,1,8,-3,-1,3,2,5,0,1,1,1,1,1,6,1
KR_6740561679,420,5,20,32,8,2,3,1,0,2,2,3,4,1,3,7,4,0,2,2,1,6,20,6,4,10,-4,0,1,1,1,1,-1,4,1
KR_6760703194,420,0,57,13,-2,-2,1,3,-1,1,2,1,3,2,-1,1,2,1,1,0,0,-1,-5,-3,5,2,1,0,-1,-1,-1,-1,-1,5,1
KR_6685775574,420,-3,-40,-33,-1,-2,1,3,-1,3,4,0,3,3,0,1,1,2,2,0,0,4,-97,4,5,9,-2,0,0,1,-1,-1,-1,3,1
KR_6735401883,420,3,100,17,11,1,2,1,7,7,0,1,1,0,4,6,2,-2,1,3,0,5,191,3,2,5,-2,0,1,1,-1,1,1,1,1
KR_6751765149,420,1,-10,-8,-5,0,3,3,3,5,2,1,4,3,-6,1,7,-3,1,4,1,-5,-23,1,6,7,-1,0,-1,-1,-1,-1,1,1,1
KR_6633116277,420,1,15,-5,3,-7,1,8,3,5,2,0,2,2,9,10,1,-2,2,4,0,-1,-10,-4,8,4,-3,0,0,1,-1,-1,1,4,1
KR_6763231625,440,1,80,14,3,3,5,2,-2,2,4,0,3,3,3,6,3,-1,0,1,0,-1,-4,-4,7,3,1,0,1,1,0,1,1,6,1
KR_6681996736,440,0,-94,16,-1,-2,2,4,5,5,0,2,2,0,-5,2,7,-1,3,4,0,2,1,3,4,7,-1,0,-1,1,0,-1,-1,4,1
KR_6738946146,420,0,20,-44,-2,0,0,0,4,5,1,-1,1,2,-3,2,5,-2,0,2,0,-1,73,-3,5,2,-3,0,0,1,1,1,1,1,1
KR_6665588875,420,-1,-12,-52,3,8,8,0,5,9,4,-7,0,7,-1,2,3,-2,5,7,1,0,17,2,5,7,4,0,-1,1,-1,-1,1,3,1
KR_6699513545,420,5,45,33,9,0,1,1,4,6,2,1,3,2,3,4,1,1,2,1,0,9,-1,-3,7,4,-1,0,0,1,1,1,1,4,1
KR_6636013928,420,2,35,-9,11,-2,2,4,4,6,2,3,4,1,4,8,4,2,2,0,-1,17,2,1,2,3,1,0,1,-1,1,1,-1,2,1
KR_6759473096,420,2,-38,-2,5,-1,3,4,6,9,3,1,1,0,-3,1,4,2,2,0,0,4,7,5,1,6,-4,0,-1,-1,-1,-1,-1,6,1
KR_6669637650,420,2,38,21,12,0,1,1,1,3,2,5,5,0,6,7,1,0,1,1,0,10,53,2,4,6,-30,0,1,1,1,1,1,1,1
KR_6658385237,420,2,66,-8,0,-3,2,5,-3,2,5,1,2,1,5,7,2,0,2,2,0,-1,26,0,4,4,-22,0,0,-1,-1,1,1,5,1
KR_6629742529,420,1,85,-9,2,0,3,3,-2,0,2,-1,1,2,3,4,1,2,2,0,0,2,-7,-3,5,2,4,0,1,1,0,1,1,1,1
KR_6667772412,420,2,29,8,6,1,1,0,7,7,0,0,5,5,0,1,1,-2,0,2,0,11,11,7,2,9,-3,0,0,1,1,0,-1,2,1
KR_6739914099,420,-2,26,8,-2,1,4,3,-1,3,4,1,3,2,-2,1,3,-1,0,1,-1,-5,-9,-3,6,3,4,0,-1,1,-1,-1,-1,2,1
KR_6683595928,420,3,53,-23,2,2,4,2,2,3,1,6,7,1,-9,0,9,1,2,1,0,-4,170,-1,11,10,1,0,2,-1,-1,1,-1,4,1
KR_6508350509,420,0,-17,0,-3,0,0,0,0,0,0,4,4,0,-5,2,7,-2,0,2,-1,-3,-87,0,4,4,0,0,0,-1,1,-1,-1,5,1
KR_6747698683,420,1,-16,15,-1,3,4,1,-4,1,5,2,6,4,-1,0,1,-1,0,1,0,-8,-10,4,4,8,3,0,0,1,-1,0,1,5,1
KR_6716263719,440,-1,43,4,-2,1,5,4,-1,1,2,0,2,2,-4,1,5,2,3,1,0,-2,-18,3,5,8,2,0,0,-1,-1,0,1,4,1
KR_6749092126,420,2,33,10,9,-1,3,4,4,9,5,5,6,1,2,4,2,-1,0,1,0,15,41,5,2,7,-4,0,0,1,1,1,1,4,1
KR_6667747512,420,2,-59,15,4,3,3,0,3,3,0,0,0,0,-2,0,2,0,0,0,0,1,122,2,4,6,-3,0,1,0,1,1,1,0,1
KR_6730763532,420,3,25,32,9,-1,4,5,7,8,1,2,5,3,1,2,1,0,1,1,1,10,13,-2,5,3,-3,0,2,-1,1,1,-1,6,1
KR_6035625026,420,0,22,-22,1,0,1,1,0,4,4,2,3,1,-2,2,4,1,2,1,0,-2,28,-1,5,4,-4,0,0,-1,1,1,1,4,1
KR_6749601942,420,1,76,1,1,3,4,1,3,4,1,-1,1,2,-6,1,7,2,2,0,0,-3,-6,-7,15,8,2,0,2,-1,-1,1,-1,5,1
KR_6758352513,420,4,29,28,7,2,2,0,3,4,1,3,3,0,-2,2,4,1,1,0,0,11,3,2,4,6,0,0,0,1,1,0,1,6,1
KR_6597387966,420,0,11,-17,4,-2,1,3,2,5,3,4,6,2,2,2,0,-2,0,2,0,3,-220,1,5,6,5,0,0,-1,-1,0,1,4,1
KR_6762327901,420,0,4,-4,1,4,5,1,-2,1,3,1,1,0,-1,3,4,-1,0,1,0,4,-5,-1,4,3,0,0,1,1,-1,1,-1,5,1
KR_6758490356,420,1,1,8,-3,1,3,2,-4,0,4,0,3,3,-1,4,5,1,1,0,0,-4,3,-4,9,5,1,0,0,-1,1,0,-1,6,1
KR_6758071334,440,0,86,11,1,0,1,1,2,3,1,-2,0,2,-1,1,2,2,5,3,0,0,5,-1,2,1,-3,0,1,0,1,1,-1,0,1
KR_6420062638,420,4,60,-24,4,0,1,1,-1,2,3,2,4,2,3,3,0,0,0,0,0,-3,-34,-1,7,6,7,0,1,0,1,1,1,0,1
KR_6718791445,440,-1,41,4,1,0,0,0,0,4,4,-1,0,1,1,5,4,1,2,1,0,4,-257,2,3,5,1,0,-1,1,0,-1,-1,6,1
KR_6748405067,420,1,-72,16,-3,3,3,0,0,3,3,-7,1,8,1,2,1,0,1,1,1,-5,-109,0,4,4,-8,0,0,1,1,-1,1,3,1
KR_6686517581,420,2,45,24,8,2,2,0,2,3,1,5,9,4,0,4,4,-1,2,3,1,3,3,2,4,6,2,0,0,1,1,1,1,1,1
KR_6725238409,420,-2,-47,4,-1,2,3,1,1,6,5,-3,0,3,0,2,2,-1,0,1,0,6,10,-1,5,4,0,0,0,1,1,1,-1,6,1
KR_6761571859,420,-2,-40,0,1,-2,1,3,-5,2,7,2,3,1,6,7,1,0,0,0,0,7,20,1,3,4,2,0,-1,1,0,1,1,6,1
KR_6758389907,420,0,111,-17,0,1,4,3,-2,2,4,0,2,2,0,5,5,1,1,0,0,1,281,-5,7,2,3,0,0,1,1,0,1,5,1
KR_6729451741,420,1,-2,33,-3,-3,1,4,0,2,2,1,2,1,-1,3,4,0,2,2,0,0,6,2,3,5,-1,0,0,1,-1,0,1,6,1
KR_6759693988,440,-1,24,4,0,0,0,0,-1,1,2,4,5,1,-2,0,2,-1,0,1,0,-4,6,4,3,7,-6,0,0,-1,1,0,1,5,1
KR_6742169981,440,4,19,-17,12,2,2,0,4,4,0,1,2,1,3,3,0,2,2,0,0,12,-13,3,6,9,0,0,0,1,1,1,1,2,1
KR_6754216687,420,2,-17,8,2,1,2,1,3,3,0,-3,2,5,2,6,4,-1,2,3,0,10,-22,0,4,4,1,0,0,1,1,0,1,3,1
KR_6757119552,420,4,73,20,10,4,7,3,-1,3,4,4,5,1,3,3,0,0,0,0,0,3,-2,3,2,5,-1,0,1,1,1,1,1,5,1
KR_6728332075,440,1,49,8,5,-2,1,3,3,5,2,2,2,0,0,4,4,2,2,0,1,8,41,5,2,7,-25,0,0,-1,1,0,1,3,1
KR_6755766696,420,1,104,4,-3,1,2,1,-2,3,5,-3,1,4,0,5,5,1,2,1,0,-5,34,1,5,6,-15,0,0,-1,-1,1,1,3,1
KR_6751963379,420,0,27,-4,4,3,4,1,-2,2,4,5,8,3,-2,3,5,0,2,2,0,-5,-23,-2,8,6,3,0,3,1,-1,1,-1,3,1
KR_6546351176,420,7,104,65,11,0,2,2,1,2,1,2,4,2,7,9,2,1,1,0,0,10,-6,4,4,8,-1,0,2,1,-1,1,-1,5,1
KR_6510858677,420,0,12,24,-4,-2,2,4,1,3,2,1,3,2,0,3,3,-4,2,6,0,0,30,4,0,4,-4,0,0,-1,1,1,1,5,1
KR_6761719983,420,3,-34,-22,5,0,0,0,1,4,3,-2,2,4,5,6,1,1,2,1,0,17,-1,0,2,2,0,0,0,-1,-1,0,-1,5,1
KR_6753118238,440,0,-25,0,6,6,6,0,3,5,2,1,3,2,-4,0,4,0,0,0,0,1,-7,0,5,5,-1,0,1,-1,1,1,1,3,1
KR_6758187556,420,1,52,0,4,0,1,1,1,2,1,0,2,2,3,4,1,0,0,0,0,3,22,0,6,6,6,0,1,1,1,1,1,5,1
KR_6615416183,420,-3,-17,-8,-9,-3,2,5,1,4,3,0,1,1,-4,2,6,-3,1,4,0,-6,-6,0,4,4,-1,0,-1,-1,-1,-1,-1,5,1
KR_6512440272,420,2,21,16,4,1,3,2,5,6,1,2,3,1,-2,4,6,-2,2,4,0,3,-10,-2,4,2,7,0,1,1,1,1,1,2,1
KR_6738874917,420,2,20,-16,4,0,2,2,5,6,1,2,4,2,-3,0,3,0,0,0,1,2,-6,-5,6,1,0,0,1,1,-1,1,1,6,1
KR_6747857223,420,0,14,6,-5,0,0,0,-2,3,5,0,4,4,-2,1,3,-1,1,2,-1,-13,3,0,4,4,0,0,0,0,-1,1,-1,0,1
KR_6757451319,420,8,60,49,19,3,5,2,1,3,2,6,7,1,6,9,3,3,4,1,0,9,0,4,3,7,5,0,1,1,1,1,1,1,1
KR_6760831686,420,1,4,-13,8,2,3,1,4,6,2,-2,0,2,2,5,3,2,2,0,0,8,-11,-1,4,3,4,0,1,-1,1,1,-1,6,1
KR_6717690683,420,3,-28,-4,8,-1,2,3,3,4,1,5,6,1,2,2,0,-1,1,2,0,11,1,-5,8,3,3,0,1,-1,1,1,-1,4,1
KR_6757392757,420,1,25,7,-1,1,2,1,1,4,3,1,4,3,-4,1,5,0,1,1,0,-2,-6,3,3,6,2,0,0,-1,-1,0,-1,2,1
KR_6652919829,420,-1,-48,-1,-1,1,2,1,-3,3,6,1,1,0,0,2,2,0,2,2,0,1,12,0,6,6,1,0,0,1,-1,-1,-1,1,1
KR_6732483521,420,-1,-14,-11,0,1,2,1,-5,1,6,4,4,0,-4,0,4,4,6,2,0,-4,-4,0,4,4,-1,0,-1,-1,-1,-1,-1,1,1
KR_6632701009,440,4,44,-4,6,0,2,2,0,2,2,5,5,0,1,1,0,0,2,2,0,1,-4,-2,5,3,0,0,2,1,0,1,1,4,1
KR_6592198110,420,3,82,9,11,-1,0,1,5,7,2,0,0,0,5,6,1,2,2,0,0,16,10,5,3,8,-2,0,1,1,1,1,1,2,1
KR_6746392512,420,0,-48,4,-1,-3,1,4,-1,1,2,4,6,2,1,4,3,-2,1,3,-1,0,-24,-3,5,2,-4,0,0,1,1,0,-1,2,1
KR_6700378403,420,-2,-31,-17,0,1,3,2,3,4,1,0,1,1,-6,1,7,2,4,2,-1,3,24,3,6,9,-8,0,1,-1,1,1,-1,4,1
KR_6403891783,420,4,65,13,12,3,3,0,1,1,0,-1,2,3,8,8,0,1,1,0,0,18,23,2,4,6,0,0,1,1,-1,1,1,5,1
KR_6762565933,420,0,-54,14,2,2,4,2,4,6,2,-2,0,2,1,3,2,-3,0,3,0,5,31,3,3,6,-1,0,0,1,1,0,-1,4,1
KR_6274751251,420,-2,20,-4,-3,-1,1,2,1,2,1,0,2,2,-1,3,4,-2,2,4,1,3,-7,0,5,5,0,0,1,0,-1,1,1,0,1
KR_6490958993,420,2,-3,-8,2,1,3,2,0,4,4,2,6,4,-2,2,4,1,1,0,0,1,-2,2,3,5,-4,0,1,1,1,1,-1,1,1
KR_6675485652,420,-4,6,-16,-10,-1,2,3,-1,1,2,-5,0,5,0,0,0,-3,0,3,0,-6,-1,-3,5,2,-2,0,0,1,-1,-1,1,1,1
KR_6653119804,420,-1,3,-49,1,-2,1,3,0,2,2,-1,2,3,1,3,2,3,3,0,0,8,36,-1,3,2,-1,0,0,1,-1,-1,1,4,1
KR_6757691336,420,4,-21,17,9,2,4,2,0,0,0,4,9,5,1,4,3,2,2,0,0,7,10,3,6,9,0,0,-1,0,1,-1,1,0,1
KR_6746290970,420,7,122,-4,6,3,3,0,1,4,3,-2,2,4,2,2,0,2,2,0,0,8,-1,3,5,8,3,0,2,1,1,1,1,1,1
KR_6649453929,420,2,2,16,4,-1,0,1,-1,1,2,1,3,2,4,7,3,1,2,1,0,6,-6,-5,8,3,0,0,0,-1,1,0,1,2,1
KR_6728036684,440,2,55,0,-3,0,1,1,0,2,2,1,2,1,-1,3,4,-3,0,3,-1,-6,3,-3,8,5,-1,0,0,-1,1,0,-1,6,1
KR_6729752619,420,1,63,-9,7,4,4,0,-2,0,2,-1,0,1,5,6,1,1,1,0,0,2,8,3,3,6,-2,0,0,-1,-1,1,1,4,1
KR_6733706348,420,0,14,4,-3,-2,0,2,1,1,0,2,5,3,-4,1,5,0,0,0,0,-5,9,-1,5,4,-3,0,0,0,1,0,-1,0,1
KR_6760827214,420,2,12,8,5,3,4,1,0,2,2,3,4,1,0,1,1,-1,0,1,0,6,12,-1,9,8,-5,0,0,-1,1,1,1,3,1
KR_6744588202,420,3,1,-24,7,1,1,0,0,2,2,5,6,1,2,5,3,-1,1,2,0,3,-1,-1,5,4,2,0,1,-1,0,1,-1,2,1
KR_6761431898,420,-2,36,-11,-6,4,5,1,-3,1,4,-1,0,1,-6,1,7,0,1,1,0,-12,8,5,3,8,-4,0,0,-1,1,1,-1,4,1
KR_6751807096,420,7,26,44,15,-1,0,1,5,7,2,5,6,1,3,5,2,3,3,0,0,15,5,3,2,5,0,0,2,1,1,1,1,5,1
KR_6700197680,420,4,22,43,11,3,4,1,7,8,1,2,4,2,0,1,1,-1,0,1,0,9,-10,-5,8,3,4,0,0,1,-1,0,1,3,1
KR_6664551828,420,3,5,5,5,-2,0,2,3,4,1,1,5,4,3,4,1,0,0,0,0,4,141,0,7,7,-2,0,1,-1,1,1,1,2,1
KR_6738064258,440,3,17,14,7,1,2,1,0,4,4,2,2,0,6,6,0,-2,0,2,0,2,5,3,2,5,0,0,1,1,0,1,1,1,1
KR_6692980157,420,1,32,8,0,5,6,1,2,2,0,-5,0,5,-1,1,2,-1,3,4,0,-5,2,-2,5,3,-1,0,1,1,0,1,-1,1,1
KR_6742243589,420,3,106,19,7,7,7,0,0,3,3,6,7,1,-3,0,3,-3,0,3,0,6,-381,0,4,4,-20,0,0,-1,1,1,1,2,1
KR_6725049642,420,4,13,40,8,2,3,1,-3,1,4,1,2,1,3,3,0,5,5,0,0,-1,3,2,3,5,-1,0,1,0,-1,1,1,0,1
KR_6573875294,420,3,18,22,5,1,4,3,0,2,2,0,1,1,0,2,2,4,5,1,0,-2,9,5,4,9,-4,0,0,1,-1,0,-1,4,1
KR_6760349691,420,1,-33,-16,5,0,2,2,-3,1,4,4,5,1,3,3,0,1,1,0,0,4,15,2,3,5,1,0,1,1,-1,1,-1,5,1
KR_6762661416,420,-2,23,-21,2,0,2,2,1,5,4,-8,0,8,9,10,1,0,1,1,3,10,4,1,3,4,2,0,1,-1,-1,1,1,6,1
KR_6545755184,420,-2,-11,-2,4,2,2,0,1,4,3,3,4,1,-3,0,3,1,4,3,0,5,5,5,1,6,-5,0,0,-1,1,-1,1,1,1
KR_6631787045,420,-2,-60,-20,-3,-4,0,4,0,1,1,-1,2,3,2,2,0,0,2,2,0,-2,-4,0,4,4,-2,0,0,-1,-1,0,-1,5,1
KR_6639209574,440,5,4,20,6,0,1,1,0,1,1,4,4,0,-1,2,3,3,3,0,0,4,-2,0,2,2,0,0,1,1,1,1,1,6,1
KR_6704328976,420,-4,20,-5,-4,-2,1,3,0,4,4,1,4,3,-1,0,1,-2,0,2,-1,-7,-33,-2,5,3,30,0,1,0,0,1,-1,0,1
KR_6633302629,420,3,-1,-8,2,1,1,0,1,3,2,2,3,1,-2,0,2,0,0,0,0,1,8,-2,5,3,-3,0,0,1,-1,0,-1,1,1
KR_6764568489,420,-1,19,-4,3,0,1,1,2,4,2,4,8,4,-4,2,6,1,1,0,0,0,-5,-2,3,1,1,0,-1,1,-1,-1,-1,5,1
KR_6694479755,440,-2,-22,1,-7,-2,0,2,-3,2,5,-6,1,7,4,4,0,0,0,0,-1,-5,3,-1,4,3,-2,0,0,-1,-1,-1,-1,2,1
KR_5832013866,420,3,2,8,5,2,3,1,5,7,2,-2,0,2,-3,4,7,3,3,0,1,2,-10,0,4,4,2,0,0,-1,0,1,1,1,1
KR_6736571101,440,2,-43,-4,-1,-1,3,4,3,5,2,2,4,2,-4,1,5,-1,1,2,2,0,-4,1,1,2,-5,0,1,1,-1,1,1,6,1
KR_6669600411,420,2,26,-28,5,-1,4,5,1,3,2,1,4,3,2,2,0,2,2,0,0,6,-117,0,2,2,3,0,0,1,-1,-1,-1,1,1
KR_6764132588,420,-1,27,-12,-4,-1,1,2,-4,2,6,-1,1,2,3,5,2,-1,1,2,0,1,-24,-3,7,4,8,0,0,1,-1,-1,-1,2,1
KR_6739731343,420,3,116,-4,6,-1,1,2,0,1,1,7,7,0,0,3,3,0,1,1,0,2,-15,0,3,3,4,0,2,1,-1,1,1,6,1
KR_6763481891,420,1,-40,8,2,-2,1,3,1,5,4,4,6,2,0,2,2,-1,3,4,0,6,4,3,2,5,1,0,-1,1,-1,-1,-1,5,1
KR_6745894468,420,0,37,28,2,1,1,0,0,2,2,5,7,2,-4,1,5,0,0,0,1,-1,-9,-2,6,4,-2,0,1,1,0,1,1,4,1
KR_6721754251,420,3,89,23,2,3,4,1,0,3,3,0,3,3,2,2,0,-3,0,3,1,0,3,-1,2,1,0,0,2,1,-1,1,1,1,1
KR_6719598119,420,1,2,19,2,-2,1,3,2,5,3,3,5,2,0,3,3,-1,0,1,2,10,48,5,1,6,-27,0,0,1,1,0,1,4,1
KR_6663927085,420,0,-13,0,2,2,3,1,2,5,3,0,4,4,-2,1,3,0,1,1,0,3,-124,-2,4,2,-1,0,-1,-1,-1,-1,1,2,1
KR_6746236040,440,2,39,-24,4,2,4,2,2,2,0,0,3,3,0,2,2,0,0,0,-1,1,-8,0,4,4,-2,0,0,0,1,0,-1,0,1
KR_6570672713,420,3,48,21,13,2,2,0,8,9,1,-2,4,6,4,6,2,1,1,0,1,19,32,-5,9,4,6,0,3,-1,-1,1,1,3,1
KR_6740372699,440,-1,33,-21,-2,0,1,1,0,2,2,-1,1,2,-2,2,4,1,1,0,0,6,-146,-6,8,2,3,0,-1,-1,-1,-1,1,3,1
KR_6741866024,420,3,18,9,6,4,4,0,-6,0,6,3,3,0,4,6,2,1,1,0,0,6,-4,2,3,5,2,0,1,-1,1,1,1,3,1
KR_6676460778,440,1,48,-8,4,3,4,1,1,3,2,3,3,0,0,0,0,-3,0,3,0,1,3,3,2,5,-1,0,0,0,-1,0,1,0,1
KR_6750220049,420,2,23,24,1,1,3,2,-3,4,7,3,4,1,0,4,4,0,0,0,0,-1,-2,0,3,3,-2,0,2,-1,1,1,-1,6,1
KR_6591798996,420,-2,47,35,2,-1,1,2,1,2,1,1,4,3,1,1,0,0,1,1,0,3,9,3,3,6,0,0,0,1,-1,1,1,1,1
KR_6759269085,420,0,-33,-20,0,-1,1,2,-5,1,6,-3,3,6,7,7,0,2,2,0,0,6,-32,-5,8,3,2,0,0,-1,-1,0,-1,5,1
KR_6744666595,420,2,88,8,3,2,4,2,-1,1,2,0,4,4,1,3,2,1,1,0,-1,-3,-184,5,3,8,4,0,0,1,-1,1,-1,1,1
KR_6582472200,420,7,54,20,16,2,3,1,8,10,2,2,2,0,4,5,1,0,2,2,2,18,1,1,5,6,-4,0,2,1,1,1,1,1,1
KR_6602844729,420,-2,-26,-5,5,3,4,1,-2,0,2,5,5,0,-1,4,5,0,4,4,2,4,1,3,3,6,-3,0,1,-1,1,1,1,5,1
KR_6538231507,420,2,23,11,3,4,4,0,-1,0,1,3,5,2,-2,0,2,-1,0,1,0,-5,10,-6,7,1,-5,0,0,-1,1,1,1,2,1
KR_6570606198,420,5,75,40,9,4,6,2,0,3,3,5,5,0,2,4,2,-2,0,2,0,8,-218,-2,5,3,3,0,1,1,1,1,1,5,1
KR_6762222821,420,3,69,-8,2,-1,0,1,2,4,2,-2,0,2,1,3,2,2,3,1,0,4,6,2,2,4,-2,0,1,-1,1,1,1,2,1
KR_6638158727,420,1,62,16,7,-3,1,4,2,4,2,-2,2,4,7,7,0,3,3,0,1,9,6,2,4,6,3,0,0,-1,1,0,1,2,1
KR_6752546967,420,2,18,24,3,2,4,2,0,2,2,-1,4,5,0,2,2,2,4,2,0,3,5,4,3,7,4,0,1,1,-1,-1,1,6,1
KR_6761541394,420,0,-3,-5,6,0,3,3,9,9,0,-1,0,1,-1,0,1,-1,0,1,0,8,39,-2,6,4,-14,0,-1,-1,-1,-1,1,6,1
KR_6763937299,420,5,13,-1,8,1,1,0,2,2,0,0,1,1,3,5,2,2,3,1,1,12,-120,-2,6,4,7,0,-1,1,-1,-1,1,1,1
KR_6700814981,420,5,35,31,11,2,4,2,2,6,4,1,3,2,6,6,0,0,0,0,0,7,-28,3,4,7,19,0,3,0,1,1,1,0,1
KR_6663711534,420,2,67,-2,8,3,3,0,2,3,1,1,3,2,2,4,2,0,1,1,0,4,4,4,3,7,4,0,1,-1,1,1,1,5,1
KR_6759450594,420,-1,0,-34,4,-2,2,4,1,3,2,-1,3,4,6,12,6,0,1,1,2,11,-5,3,5,8,4,0,1,0,1,1,1,0,1
KR_6733643810,420,1,53,19,2,2,2,0,2,3,1,-1,2,3,-2,5,7,1,2,1,0,10,-345,3,3,6,2,0,0,-1,-1,-1,1,3,1
KR_6633334198,420,-2,-45,0,-10,-1,0,1,3,9,6,-4,2,6,-7,1,8,-1,1,2,0,-17,-13,1,6,7,2,0,-1,1,0,-1,-1,4,1
KR_6741558873,420,-1,-4,-4,-7,0,1,1,-4,2,6,-3,0,3,1,2,1,-1,5,6,0,-5,-1,-2,6,4,-2,0,-1,-1,-1,-1,-1,3,1
KR_6721532073,420,3,94,-12,12,4,5,1,3,3,0,1,4,3,0,3,3,4,6,2,0,2,8,2,4,6,6,0,1,-1,1,1,1,1,1
KR_6738900420,420,1,12,-8,-4,-4,3,7,-2,0,2,2,4,2,-2,2,4,2,4,2,0,1,56,-4,5,1,-12,0,-1,-1,-1,-1,-1,5,1
KR_6751443533,440,0,13,-6,-1,5,6,1,4,6,2,-3,2,5,-3,0,3,-4,1,5,-2,-3,-7,-2,5,3,2,0,1,-1,0,1,-1,6,1
KR_6761565903,420,4,10,32,5,0,0,0,-2,1,3,-1,0,1,6,9,3,2,4,2,1,2,10,3,3,6,-2,0,1,1,-1,1,1,6,1
KR_6762076869,420,0,-46,9,-6,-1,0,1,-1,1,2,2,5,3,-3,3,6,-3,0,3,0,-18,0,-1,4,3,-4,0,-1,-1,-1,-1,-1,4,1
KR_6597462854,420,2,-46,0,2,-2,0,2,-3,1,4,1,1,0,-1,2,3,7,7,0,0,4,1,-1,4,3,2,0,-1,1,1,-1,1,1,1
KR_6713694333,420,0,-15,20,-3,-5,1,6,1,3,2,1,3,2,0,2,2,0,1,1,0,-4,0,-4,7,3,-1,0,-1,1,0,-1,-1,6,1
KR_6560426697,440,6,110,23,14,2,3,1,-2,0,2,6,6,0,5,7,2,3,6,3,0,16,-18,4,2,6,-3,0,3,1,1,1,1,2,1
KR_6616900182,420,-1,22,10,1,2,3,1,3,3,0,0,3,3,-3,1,4,-1,0,1,1,4,2,5,3,8,-5,0,-2,1,-1,-1,1,3,1
KR_6748014012,420,6,12,24,12,1,3,2,6,8,2,6,6,0,-4,0,4,3,5,2,0,8,38,1,2,3,-4,0,0,0,0,-1,-1,0,1
KR_6759775715,420,-2,22,-4,-7,-4,1,5,1,5,4,-5,1,6,-3,1,4,4,5,1,0,-7,5,-2,3,1,0,0,0,-1,-1,-1,-1,6,1
KR_6760471348,420,1,-12,4,2,5,6,1,3,7,4,-1,1,2,-7,0,7,2,2,0,-1,-8,3,0,2,2,0,0,0,0,0,1,-1,0,1
KR_6760281018,420,6,31,6,17,5,6,1,2,2,0,12,13,1,-1,0,1,-1,0,1,0,15,33,1,2,3,5,0,0,-1,1,1,1,5,1
KR_6761642997,420,5,97,20,7,2,2,0,-2,5,7,2,5,3,4,5,1,1,1,0,0,0,4,1,1,2,3,0,2,1,0,1,1,3,1
KR_6760302317,420,7,129,17,7,0,2,2,4,4,0,4,5,1,1,5,4,-2,2,4,-1,6,28,1,1,2,0,0,3,1,1,1,-1,1,1
KR_6753604463,420,8,131,25,17,8,9,1,1,2,1,4,5,1,2,5,3,2,2,0,0,1,-21,5,2,7,-2,0,4,1,1,1,1,3,1
KR_6602413619,420,3,-1,24,6,0,2,2,4,7,3,0,1,1,0,2,2,2,3,1,0,10,-4,0,5,5,4,0,0,-1,1,0,1,5,1
KR_6758377934,420,4,47,20,14,0,2,2,5,6,1,0,2,2,5,5,0,4,4,0,1,7,6,-2,6,4,2,0,1,1,1,1,1,5,1
KR_6750876084,420,4,-2,32,12,6,7,1,0,2,2,-1,1,2,7,11,4,0,1,1,0,10,5,1,3,4,-5,0,1,1,1,1,1,4,1
KR_6667630379,420,4,81,29,4,-2,2,4,0,0,0,3,6,3,4,5,1,-1,0,1,0,3,19,2,2,4,-24,0,0,0,1,1,1,0,1
KR_6580997557,440,5,17,12,8,4,5,1,1,7,6,2,2,0,0,3,3,1,3,2,0,1,-17,3,5,8,2,0,1,-1,1,1,1,6,1
KR_6747092945,420,0,22,-16,-6,1,2,1,-1,1,2,-1,1,2,-4,1,5,-1,0,1,0,-13,38,0,5,5,2,0,1,-1,1,1,-1,3,1
KR_6736710866,420,3,36,40,7,2,2,0,4,4,0,1,2,1,0,1,1,0,0,0,0,8,1,1,5,6,-1,0,0,1,1,1,1,5,1
KR_6733451805,440,1,15,-43,4,-1,2,3,1,5,4,1,2,1,3,5,2,0,1,1,1,10,-151,2,2,4,0,0,-1,-1,-1,-1,1,5,1
KR_6745067052,420,-4,-23,-23,-10,-1,1,2,0,1,1,0,2,2,-4,0,4,-5,0,5,-1,-10,-6,5,4,9,-1,0,0,-1,1,1,-1,2,1
KR_6679913113,420,2,-16,4,-2,0,0,0,2,4,2,1,3,2,-1,1,2,-4,1,5,0,2,38,-5,7,2,-17,0,0,-1,-1,0,-1,3,1
KR_6601054888,420,1,6,-4,3,2,4,2,1,2,1,-1,1,2,2,4,2,-1,0,1,0,4,-17,0,5,5,0,0,2,-1,1,1,1,4,1
KR_6582804672,420,4,89,0,3,2,3,1,0,2,2,-2,3,5,3,6,3,0,1,1,-1,-7,11,7,2,9,-6,0,2,1,1,1,1,1,1
KR_6681203170,420,1,-65,-13,8,1,2,1,2,2,0,4,6,2,2,7,5,-1,1,2,1,14,4,-4,9,5,-2,0,1,-1,1,1,1,3,1
KR_6764226268,420,-2,-70,-22,6,1,1,0,6,6,0,1,2,1,-1,1,2,-1,0,1,0,12,-359,-1,5,4,0,0,-1,1,-1,-1,1,3,1
KR_6404813243,420,3,42,4,2,-2,0,2,-2,5,7,4,4,0,3,3,0,-1,0,1,0,3,-8,0,5,5,8,0,0,1,-1,-1,-1,1,1
KR_6764594580,420,1,-13,-4,7,-1,1,2,-1,2,3,5,6,1,5,7,2,-1,0,1,-1,7,-406,-3,7,4,3,0,1,-1,-1,1,-1,4,1
KR_6216585571,420,-2,3,13,-3,0,1,1,0,4,4,-1,3,4,0,2,2,-2,0,2,0,-2,-8,-5,7,2,1,0,2,1,1,1,1,2,1
KR_6512646733,420,-2,-7,4,1,-5,1,6,2,4,2,-2,2,4,3,4,1,3,5,2,0,5,-6,2,7,9,1,0,0,0,-1,0,-1,0,1
KR_6759808441,420,-1,14,8,1,0,2,2,6,8,2,0,5,5,-1,3,4,-4,0,4,0,2,37,-2,3,1,-20,0,0,-1,1,1,-1,4,1
KR_6672670321,420,-2,-5,30,-5,-3,0,3,1,4,3,3,4,1,-2,2,4,-4,1,5,0,-6,-10,-4,9,5,6,0,0,1,1,0,1,2,1
KR_6715918460,420,2,44,-12,3,0,1,1,-2,1,3,4,5,1,4,5,1,-3,2,5,0,-6,8,3,5,8,2,0,0,0,0,0,1,0,1
KR_6708591147,420,-1,3,-4,-4,-4,0,4,0,1,1,2,2,0,-1,2,3,-1,0,1,-1,-5,34,-2,6,4,2,0,-1,1,-1,-1,-1,5,1
KR_6761511898,420,-2,13,-4,-6,0,4,4,1,4,3,-1,0,1,-6,1,7,0,2,2,0,-9,23,3,3,6,2,0,0,0,-1,-1,-1,0,1
KR_6760680124,440,3,11,-5,6,-1,2,3,-1,2,3,3,6,3,3,5,2,2,3,1,0,3,0,0,3,3,2,0,0,1,1,0,1,6,1
KR_6658085868,420,1,15,36,1,-1,1,2,1,4,3,2,4,2,0,3,3,-1,0,1,0,6,-37,1,3,4,22,0,0,1,-1,0,-1,1,1
KR_6760481217,420,2,27,-20,-1,-2,0,2,-2,3,5,-1,0,1,3,6,3,1,3,2,-1,2,-3,0,7,7,6,0,0,1,-1,1,-1,2,1
KR_6708264165,420,0,-15,9,6,4,4,0,-5,1,6,-3,3,6,5,7,2,5,6,1,0,-8,-46,-6,11,5,9,0,1,0,1,1,-1,0,1
KR_6762647480,420,0,-31,9,1,3,4,1,0,4,4,0,2,2,-2,2,4,0,1,1,1,-5,-39,1,2,3,-6,0,0,1,1,0,1,6,1
KR_6696489704,420,1,35,-5,2,6,6,0,-2,4,6,-2,4,6,0,1,1,0,0,0,0,2,92,1,3,4,0,0,2,1,-1,1,1,1,1
KR_6571838838,420,3,18,-24,8,5,7,2,-3,3,6,2,2,0,5,6,1,-1,1,2,0,15,1,-2,8,6,6,0,1,0,-1,1,-1,0,1
KR_6716516679,420,8,118,65,16,1,3,2,2,2,0,0,3,3,10,10,0,3,4,1,0,13,0,-1,4,3,7,0,3,1,1,1,1,3,1
KR_6667497114,420,7,78,12,17,1,2,1,-2,0,2,9,9,0,8,8,0,1,2,1,0,10,6,-1,3,2,2,0,1,1,0,1,1,3,1
KR_6742094567,420,1,27,0,2,3,3,0,2,4,2,1,2,1,-4,0,4,0,1,1,0,-3,5,1,4,5,-3,0,1,-1,1,1,1,2,1
KR_6668838530,420,4,58,13,5,0,2,2,-1,2,3,2,6,4,5,6,1,-1,1,2,1,9,-181,0,6,6,0,0,0,1,-1,1,1,6,1
KR_6735990405,420,-2,-49,16,-1,-2,1,3,-4,1,5,0,2,2,6,9,3,-1,2,3,0,-6,-48,-2,4,2,7,0,0,1,-1,1,1,4,1
KR_5682300064,420,2,-19,4,2,-1,0,1,3,5,2,1,3,2,0,1,1,-1,2,3,0,6,-6,-4,9,5,1,0,0,-1,-1,0,-1,5,1
KR_6744723943,420,0,-48,12,6,-1,3,4,2,3,1,1,3,2,2,4,2,2,2,0,0,10,15,-1,7,6,5,0,0,1,-1,0,-1,3,1
KR_6759790388,420,2,86,28,2,1,1,0,-1,3,4,1,2,1,1,2,1,0,3,3,0,-5,-6,5,2,7,5,0,0,1,1,1,1,2,1
KR_6754781262,420,-1,-1,3,1,-2,0,2,0,3,3,-1,2,3,3,4,1,1,2,1,0,3,35,3,3,6,0,0,0,-1,1,0,1,6,1
KR_6749532434,420,0,3,16,5,1,4,3,2,2,0,-2,0,2,2,5,3,2,2,0,0,8,163,1,3,4,-4,0,1,1,-1,1,1,6,1
KR_6689692503,420,-3,-77,2,-3,-1,2,3,0,2,2,-2,0,2,-2,2,4,2,4,2,0,-4,-23,-4,6,2,2,0,0,1,1,1,1,6,1
KR_6586753017,420,3,50,0,11,-1,2,3,1,3,2,0,3,3,10,13,3,1,1,0,0,9,0,-3,10,7,3,0,2,1,-1,1,-1,6,1
KR_6755217420,420,0,-7,28,2,0,1,1,-1,3,4,6,6,0,-3,1,4,0,1,1,0,-4,6,-1,6,5,-4,0,1,1,1,1,1,4,1
KR_6730508856,420,5,2,52,8,1,2,1,1,4,3,0,1,1,7,7,0,-1,0,1,-1,15,-1,0,3,3,-1,0,1,1,1,1,-1,1,1
KR_6745447077,420,3,52,12,-1,-1,0,1,1,4,3,1,3,2,-2,1,3,0,0,0,-1,-6,152,-4,9,5,5,0,0,1,-1,0,-1,1,1
KR_6714731605,420,-2,27,40,-2,-1,1,2,-2,3,5,3,5,2,-2,4,6,0,1,1,0,-2,29,2,3,5,-12,0,0,-1,1,-1,1,1,1
KR_6633550229,420,3,24,19,2,1,5,4,2,4,2,1,2,1,3,5,2,-5,2,7,0,5,-3,-3,7,4,2,0,2,0,0,1,-1,0,1
KR_6738839391,420,5,28,12,9,5,6,1,2,2,0,2,5,3,0,3,3,0,1,1,0,7,2,1,4,5,2,0,2,1,1,1,-1,6,1
KR_6708644203,420,-1,-30,28,0,-4,0,4,-2,6,8,2,3,1,7,7,0,-3,0,3,1,16,-1,-8,12,4,6,0,1,1,-1,1,1,4,1
KR_6714553825,420,3,-49,116,5,-2,0,2,3,3,0,3,4,1,1,2,1,0,2,2,0,6,9,-1,2,1,1,0,1,1,1,1,1,1,1
KR_6763556563,420,-2,19,-16,-3,2,3,1,-2,3,5,-2,4,6,1,3,2,-2,1,3,0,2,6,-2,4,2,4,0,-1,1,-1,-1,1,6,1
KR_6758115837,420,-1,-25,0,-6,2,2,0,1,2,1,-2,0,2,-4,2,6,-3,0,3,-1,-14,-5,-3,8,5,2,0,0,-1,-1,0,-1,6,1
KR_6739050560,420,-4,-18,-21,-6,1,3,2,0,3,3,-2,3,5,0,3,3,-5,0,5,-1,-7,-1,-4,7,3,1,0,-1,-1,1,-1,-1,1,1
KR_6604364789,420,2,33,-42,3,1,2,1,1,4,3,1,3,2,1,3,2,-1,1,2,0,5,9,1,2,3,-6,0,-1,-1,1,-1,-1,5,1
KR_6695417252,420,4,-23,43,9,1,1,0,4,5,1,1,4,3,2,4,2,1,1,0,3,11,-17,0,3,3,4,0,-1,1,1,1,1,6,1
KR_6645200029,420,7,60,11,2,1,2,1,1,4,3,0,4,4,0,1,1,0,1,1,0,-4,-9,-5,7,2,5,0,1,-1,1,1,-1,6,1
KR_6752973146,420,2,34,11,6,-1,2,3,8,8,0,0,2,2,-1,1,2,0,3,3,2,3,-9,-4,7,3,5,0,-1,-1,-1,1,1,6,1
KR_6739573836,420,1,40,29,-4,0,1,1,1,4,3,0,3,3,-4,0,4,-1,0,1,0,-7,-115,-1,2,1,-3,0,-1,-1,1,-1,1,5,1
KR_6747124458,420,3,-3,20,9,1,1,0,6,7,1,1,2,1,2,3,1,-1,0,1,1,13,-5,0,2,2,2,0,1,0,1,1,1,0,1
KR_6705733843,420,1,1,-16,7,2,3,1,3,3,0,0,2,2,-3,1,4,5,6,1,0,11,-2,-2,7,5,-3,0,2,-1,1,1,1,1,1
KR_6756134355,420,2,41,-26,3,0,3,3,1,1,0,2,6,4,-2,0,2,2,2,0,0,4,-4,0,4,4,5,0,1,1,0,1,1,3,1
KR_6751273155,420,2,33,0,2,1,1,0,-1,0,1,2,3,1,-2,0,2,2,2,0,0,2,132,-3,7,4,-1,0,1,-1,1,1,1,6,1
KR_6660217516,440,-1,-58,-22,0,-2,0,2,-3,0,3,4,5,1,1,2,1,0,0,0,1,8,-3,4,1,5,0,0,0,1,1,0,1,4,1
KR_6686177181,420,6,16,20,9,2,5,3,1,1,0,3,3,0,-1,0,1,4,4,0,0,8,-402,2,4,6,14,0,2,-1,-1,1,1,5,1
KR_6656421547,420,4,99,-20,17,0,1,1,13,15,2,-2,2,4,6,6,0,0,1,1,0,15,2,1,4,5,-2,0,2,1,1,1,1,3,1
KR_6741183860,420,2,62,-10,8,0,2,2,1,2,1,5,5,0,3,4,1,-1,0,1,0,1,2,2,4,6,1,0,1,1,1,1,1,1,1
KR_6726995600,440,2,38,12,2,1,4,3,3,7,4,-6,2,8,3,4,1,1,2,1,-3,-1,25,1,4,5,-6,0,-1,1,-1,1,-1,2,1
KR_6729927956,420,3,50,0,10,2,3,1,4,4,0,2,3,1,2,7,5,0,0,0,0,4,6,-3,6,3,1,0,1,-1,-1,1,-1,1,1
KR_6761095065,420,1,-10,37,-1,-5,0,5,0,3,3,2,3,1,2,5,3,0,0,0,0,-5,0,3,4,7,1,0,0,1,1,-1,1,5,1
KR_6744033365,420,4,10,16,6,0,1,1,1,2,1,3,8,5,0,1,1,2,2,0,0,10,25,2,1,3,-1,0,1,-1,-1,1,1,3,1
KR_6759990816,420,3,79,-8,1,0,1,1,-1,2,3,7,7,0,-4,0,4,-1,1,2,0,0,-20,0,4,4,2,0,0,1,-1,0,-1,3,1
KR_6733744942,440,4,16,8,13,10,10,0,-2,3,5,1,3,2,4,5,1,0,2,2,2,17,0,1,3,4,-2,0,0,-1,1,1,1,1,1
KR_6719926281,420,3,44,37,5,2,3,1,1,1,0,1,3,2,0,3,3,1,2,1,0,1,18,-3,6,3,-2,0,2,1,1,1,1,1,1
KR_6636381788,420,4,38,24,-1,-1,3,4,2,3,1,-4,0,4,3,3,0,-1,0,1,0,-3,-7,-3,7,4,3,0,0,0,-1,-1,-1,0,1
KR_6757383925,420,2,-18,-4,8,6,6,0,3,4,1,1,2,1,-2,3,5,0,0,0,1,5,7,-3,5,2,0,0,1,-1,1,1,1,6,1
KR_6632630101,420,-2,-62,30,-9,-7,0,7,2,6,4,1,1,0,-3,3,6,-2,0,2,-1,-15,0,-5,10,5,-3,0,0,-1,-1,1,-1,2,1
KR_6743235272,420,-2,-48,-13,-1,1,4,3,-1,1,2,-1,3,4,1,2,1,-1,0,1,-1,-6,-310,4,3,7,-5,0,0,0,1,-1,-1,0,1
KR_6674577556,420,4,17,3,1,1,1,0,1,4,3,2,2,0,-1,0,1,-2,0,2,0,-2,-10,-6,12,6,6,0,0,1,1,1,1,2,1
KR_6733605403,440,2,40,0,5,3,3,0,0,3,3,-1,3,4,4,6,2,-1,1,2,0,4,2,3,2,5,-4,0,0,1,-1,0,1,2,1
KR_6676385762,420,2,14,-6,11,5,5,0,3,5,2,0,1,1,1,6,5,2,2,0,0,6,-188,1,8,9,4,0,0,1,1,0,1,3,1
KR_6746300193,420,1,-30,15,6,0,4,4,-1,2,3,0,1,1,3,4,1,4,4,0,0,15,7,4,5,9,-1,0,-1,-1,-1,-1,-1,2,1
KR_6715455236,420,2,51,14,2,0,2,2,2,4,2,-2,0,2,0,0,0,2,3,1,0,7,2,3,3,6,-2,0,2,-1,1,1,1,5,1
KR_6761890460,420,3,-74,-17,-1,1,3,2,-2,2,4,2,4,2,-2,5,7,0,1,1,0,-5,-6,-4,6,2,3,0,0,0,-1,-1,-1,0,1
KR_6653283548,420,2,21,13,6,1,1,0,1,7,6,0,1,1,3,5,2,1,3,2,0,3,2,4,5,9,0,0,0,-1,0,0,-1,4,1
KR_6661237806,420,-2,-77,12,-4,-4,0,4,-1,2,3,-2,1,3,1,2,1,2,2,0,0,-3,10,1,7,8,-5,0,0,0,-1,1,-1,0,1
KR_6167808495,420,0,9,12,-2,-2,2,4,0,4,4,0,3,3,-1,2,3,1,1,0,0,-3,-8,-3,6,3,1,0,-1,-1,0,-1,-1,5,1
KR_6756822471,420,3,-41,16,-3,-1,1,2,-1,2,3,0,3,3,-1,1,2,0,3,3,0,-8,-3,1,5,6,-1,0,0,1,-1,-1,1,3,1
KR_6706944039,440,3,-6,20,11,6,6,0,-1,2,3,-2,0,2,6,7,1,2,2,0,-1,7,3,-4,9,5,-1,0,2,-1,1,1,-1,2,1
KR_6751978357,420,3,43,2,9,-1,0,1,3,4,1,-1,1,2,4,4,0,4,4,0,0,17,12,5,1,6,1,0,1,1,1,1,1,3,1
KR_6752638690,420,2,51,20,6,2,3,1,7,8,1,0,1,1,-2,2,4,-1,0,1,0,11,-39,2,6,8,23,0,2,1,1,1,1,6,1
KR_6411333630,420,2,92,24,5,-1,1,2,-3,1,4,1,5,4,6,9,3,2,2,0,0,9,15,4,5,9,5,0,1,1,0,1,1,1,1
KR_6763060121,420,2,36,23,9,-2,0,2,2,3,1,4,4,0,1,3,2,4,4,0,0,12,-4,-4,7,3,5,0,2,1,1,1,1,5,1
KR_6759635821,420,2,27,-23,8,4,5,1,0,1,1,0,0,0,3,5,2,1,2,1,0,-1,6,4,3,7,-5,0,1,-1,0,1,1,4,1
KR_6622201434,420,0,-12,-7,4,2,2,0,0,1,1,5,7,2,-5,3,8,2,2,0,0,6,1,2,4,6,-2,0,-1,1,1,-1,1,3,1
KR_6761957872,420,2,-7,2,3,-2,0,2,0,3,3,-1,0,1,4,6,2,2,2,0,0,5,-502,-3,8,5,4,0,0,1,-1,0,1,3,1
KR_6697158158,420,1,65,21,-4,1,2,1,0,3,3,-3,1,4,-1,1,2,-1,0,1,-1,-9,28,-1,5,4,-1,0,0,-1,1,0,-1,5,1
KR_6729863345,420,4,-14,17,10,3,3,0,3,5,2,3,3,0,3,4,1,-2,1,3,0,0,4,-3,6,3,-1,0,2,-1,1,1,-1,5,1
KR_6318835192,420,7,37,24,18,4,7,3,3,5,2,2,3,1,8,9,1,1,1,0,0,8,26,3,0,3,1,0,2,0,1,1,-1,0,1
KR_6662832716,420,3,70,32,4,0,1,1,-1,1,2,3,3,0,3,3,0,-1,0,1,0,1,-1,-3,9,6,1,0,0,-1,1,1,1,1,1
KR_6681433013,420,-2,-57,19,2,-1,2,3,-3,1,4,8,11,3,0,3,3,-2,1,3,-1,5,0,0,3,3,2,0,-1,-1,-1,1,-1,3,1
KR_6545559365,420,1,15,3,2,-1,1,2,3,4,1,3,3,0,-4,3,7,1,1,0,0,0,16,2,3,5,-1,0,1,0,1,1,-1,0,1
KR_6737807893,420,0,6,7,0,2,3,1,-3,1,4,4,5,1,0,4,4,-3,1,4,0,3,-21,-1,4,3,23,0,-2,1,-1,-1,-1,3,1
KR_6763131435,440,-1,4,12,-4,0,0,0,-2,0,2,-2,3,5,0,2,2,0,2,2,0,-7,0,1,6,7,4,0,0,1,1,0,-1,5,1
KR_6747865384,420,0,-32,-1,3,3,3,0,0,0,0,1,1,0,-2,0,2,1,2,1,0,4,-1,-2,6,4,0,0,0,-1,1,0,1,4,1
KR_6216426075,420,1,78,-4,3,-1,1,2,-1,5,6,1,2,1,3,4,1,1,2,1,0,3,14,-1,8,7,2,0,2,0,1,1,1,0,1
KR_6669442797,420,5,67,5,12,1,2,1,3,5,2,1,4,3,7,7,0,0,1,1,0,11,11,3,2,5,-1,0,2,1,1,1,1,4,1
KR_6639893106,420,0,22,12,3,5,7,2,-1,3,4,-2,0,2,1,2,1,0,0,0,0,0,1,0,5,5,-1,0,1,-1,1,1,1,3,1
KR_6761681741,420,4,13,12,9,0,2,2,4,4,0,8,12,4,-3,5,8,0,2,2,0,8,-10,-1,7,6,3,0,2,-1,1,1,1,4,1
KR_6761803803,440,3,73,2,4,0,0,0,-1,6,7,4,5,1,-1,2,3,2,2,0,0,-1,10,6,4,10,4,0,2,-1,1,1,1,1,1
KR_6760673136,420,0,-18,4,-1,-3,2,5,1,2,1,0,2,2,0,0,0,1,2,1,0,1,22,1,5,6,1,0,1,1,1,1,-1,1,1
KR_6749343661,420,0,8,4,-1,-5,0,5,-3,1,4,1,4,3,6,7,1,0,0,0,0,-2,7,3,1,4,-2,0,1,1,-1,1,1,5,1
KR_6747358610,420,3,-38,16,12,-1,0,1,7,9,2,2,3,1,2,5,3,2,4,2,0,18,32,2,3,5,2,0,1,1,-1,1,1,1,1
KR_6754583604,420,-1,-15,4,-5,-1,1,2,2,2,0,-3,4,7,-4,0,4,1,5,4,-1,-2,38,2,1,3,-16,0,0,-1,-1,-1,-1,1,1
KR_6734767949,440,-3,-59,-16,-5,-5,2,7,0,4,4,0,2,2,2,2,0,-2,1,3,-1,2,-15,0,5,5,1,0,1,1,-1,-1,-1,1,1
KR_6692193668,420,0,29,14,-4,-5,0,5,0,3,3,-1,1,2,1,2,1,1,1,0,0,5,-14,-2,5,3,-1,0,2,1,1,-1,1,3,1
KR_6764754002,420,6,74,28,11,2,3,1,2,4,2,1,3,2,6,6,0,0,1,1,1,11,50,1,2,3,0,0,0,1,-1,1,1,4,1
KR_6758835335,420,5,2,44,9,0,2,2,0,2,2,7,8,1,1,1,0,1,2,1,0,11,3,6,0,6,2,0,1,1,1,1,1,3,1
KR_6546828839,420,4,12,-7,14,5,5,0,4,6,2,3,3,0,2,3,1,0,1,1,0,12,-1,-3,8,5,-3,0,0,1,1,0,1,1,1
KR_6669220750,440,1,-2,17,4,0,2,2,0,1,1,2,2,0,2,2,0,0,0,0,0,4,-6,-2,5,3,7,0,0,1,-1,-1,1,5,1
KR_6727008082,420,6,73,5,14,5,5,0,6,7,1,3,4,1,0,5,5,0,1,1,-1,10,18,5,3,8,-1,0,1,1,-1,1,-1,4,1
KR_6756850446,420,1,8,4,10,-1,1,2,5,6,1,2,4,2,2,5,3,2,2,0,0,12,-6,0,6,6,1,0,0,1,-1,0,-1,6,1
KR_6433919407,420,-1,15,0,-2,3,3,0,-1,1,2,-4,0,4,-1,2,3,1,2,1,0,-4,0,-5,9,4,0,0,0,1,-1,0,-1,1,1
KR_6341832361,420,-4,-33,-2,-7,1,1,0,1,6,5,0,3,3,-7,0,7,-2,1,3,0,-14,2,1,2,3,-2,0,1,-1,1,-1,1,5,1
KR_6724974466,420,0,-24,24,6,0,3,3,2,2,0,0,3,3,3,7,4,1,1,0,0,2,-120,2,3,5,3,0,0,-1,-1,0,1,3,1
KR_6759520276,420,0,23,-17,2,-2,0,2,1,2,1,1,3,2,-1,6,7,3,4,1,0,6,133,3,4,7,1,0,1,-1,-1,1,-1,5,1
KR_6764187474,420,2,5,8,7,-3,1,4,4,4,0,3,5,2,2,2,0,1,1,0,0,14,34,0,3,3,-16,0,1,1,1,1,1,3,1
KR_6557065777,420,4,21,-4,10,0,2,2,7,9,2,1,1,0,3,5,2,-1,1,2,1,13,10,1,5,6,3,0,1,-1,1,1,1,4,1
KR_6754649229,420,-1,-6,-16,-4,-2,0,2,0,1,1,2,3,1,-4,2,6,0,0,0,0,-2,-4,-1,5,4,3,0,-2,0,-1,-1,1,0,1
KR_6664274108,420,6,91,23,9,-2,2,4,6,7,1,1,3,2,3,4,1,1,2,1,0,11,2,4,1,5,2,0,2,1,1,1,1,3,1
KR_6759748064,420,0,1,20,3,8,8,0,-2,0,2,-2,1,3,0,2,2,-1,1,2,0,0,1,-2,5,3,-1,0,-1,1,-1,-1,1,1,1
KR_6666976387,420,2,-36,-16,18,-2,2,4,9,9,0,1,1,0,5,8,3,5,6,1,0,21,71,1,3,4,0,0,-1,-1,1,1,-1,2,1
KR_6574826894,420,6,91,30,14,3,4,1,0,5,5,5,7,2,3,4,1,3,3,0,0,14,-37,-3,6,3,22,0,2,1,1,1,-1,6,1
KR_6704914101,420,-1,44,5,-1,-1,1,2,2,5,3,0,1,1,-3,4,7,1,3,2,0,-4,174,1,5,6,3,0,2,-1,1,1,1,2,1
KR_6670341469,420,1,-57,-25,1,-2,1,3,5,7,2,-1,3,4,1,1,0,-2,0,2,0,6,-8,0,6,6,3,0,0,0,-1,0,-1,0,1
KR_6666642943,420,-3,7,20,-2,-4,0,4,2,4,2,-1,3,4,2,5,3,-1,0,1,-2,-6,1,3,7,10,0,0,0,1,1,0,-1,3,1
KR_6741366209,420,2,82,20,11,4,4,0,6,9,3,3,3,0,-4,1,5,2,2,0,0,10,6,1,6,7,2,0,1,-1,1,1,1,5,1
KR_6681042425,420,2,-8,23,2,-2,2,4,1,3,2,1,1,0,2,3,1,0,2,2,0,2,-12,0,4,4,4,0,1,1,-1,-1,-1,3,1
KR_6739741244,440,-2,13,-23,-7,-3,0,3,0,4,4,0,5,5,-4,5,9,0,0,0,0,-1,5,0,2,2,-4,0,-2,1,-1,-1,-1,3,1
KR_6747429966,440,-1,-32,-10,7,-1,1,2,1,1,0,1,1,0,5,5,0,1,2,1,0,8,-100,3,3,6,0,0,0,-1,1,-1,1,2,1
KR_6623045022,420,6,78,24,9,-2,0,2,2,3,1,1,1,0,3,4,1,5,5,0,0,10,-50,-8,10,2,27,0,1,-1,0,1,-1,3,1
KR_6749259773,440,4,70,22,8,1,2,1,3,4,1,-1,0,1,4,4,0,1,2,1,0,10,1,-5,10,5,6,0,0,1,0,1,1,1,1
KR_6725075739,420,3,21,1,7,1,1,0,-4,1,5,2,3,1,7,7,0,1,2,1,-1,6,1,2,3,5,2,0,2,1,1,1,-1,5,1
KR_6364970373,420,2,27,-7,4,3,4,1,1,4,3,-2,1,3,0,3,3,2,3,1,0,4,0,0,0,0,2,0,0,-1,1,1,-1,5,1
KR_6726076070,420,6,14,39,12,2,3,1,3,4,1,1,3,2,6,6,0,0,1,1,0,4,-93,1,3,4,-1,0,0,0,0,0,1,0,1
KR_6730699277,420,-4,-6,8,-4,-1,0,1,-7,3,10,-2,1,3,6,6,0,0,2,2,0,0,-30,5,1,6,-2,0,-1,1,-1,-1,1,5,1
KR_6762528163,420,-4,-8,-44,-4,0,2,2,-3,1,4,-1,1,2,3,6,3,-3,1,4,1,3,12,2,4,6,-3,0,1,1,1,1,1,4,1
KR_6759626314,440,3,67,12,4,1,3,2,3,3,0,1,1,0,0,2,2,-1,1,2,-2,3,5,1,4,5,4,0,2,1,1,1,-1,5,1
KR_6616893035,420,2,-12,8,6,-3,0,3,-1,1,2,8,10,2,4,4,0,-2,1,3,0,5,-10,-4,6,2,6,0,1,1,1,1,-1,2,1
KR_6680001055,420,2,49,23,-4,-2,1,3,-4,2,6,0,1,1,4,8,4,-2,0,2,0,-10,-23,4,4,8,-6,0,-1,1,-1,-1,1,5,1
KR_6667498136,420,4,75,12,7,5,5,0,0,4,4,2,2,0,-1,5,6,1,2,1,0,8,-19,4,3,7,16,0,1,0,1,1,1,0,1
KR_6748246086,420,1,51,17,-3,4,4,0,-1,0,1,-1,2,3,-5,0,5,0,0,0,0,-8,9,1,6,7,-2,0,1,-1,1,1,1,3,1
KR_6667081709,420,-2,-10,-8,-5,-5,2,7,2,4,2,0,4,4,0,2,2,-2,1,3,-1,-3,-1,1,9,10,-2,0,-3,-1,-1,-1,-1,2,1
KR_6756793706,420,2,59,8,-3,-1,1,2,0,2,2,3,6,3,-4,3,7,-1,2,3,-1,-4,-27,-11,12,1,6,0,0,1,1,0,-1,6,1
KR_6742061950,420,1,2,-3,8,0,3,3,-1,0,1,3,4,1,6,8,2,0,2,2,0,14,-101,-2,7,5,3,0,1,1,1,1,-1,4,1
KR_6731602697,420,6,39,23,14,4,4,0,4,4,0,4,5,1,-3,0,3,5,5,0,0,10,-128,-2,7,5,-3,0,1,1,1,1,1,6,1
KR_6720143689,420,4,66,29,5,1,2,1,4,6,2,1,4,3,2,4,2,-3,1,4,1,6,-33,7,2,9,0,0,-1,-1,-1,-1,1,6,1
KR_6730949531,420,1,43,2,1,-6,0,6,-5,2,7,-2,1,3,8,9,1,6,6,0,-1,5,-4,-5,6,1,7,0,3,-1,1,1,-1,6,1
KR_6761811885,420,2,77,-14,4,-2,0,2,1,2,1,2,2,0,2,3,1,1,1,0,0,7,0,1,3,4,6,0,1,1,0,1,1,3,1
KR_6711483655,420,1,68,-28,-5,2,3,1,0,5,5,-3,4,7,-2,1,3,-2,1,3,0,-5,-46,0,4,4,3,0,2,0,-1,1,-1,0,1
KR_6761655090,420,2,5,22,-2,-2,1,3,-5,0,5,0,1,1,3,6,3,2,4,2,-1,-7,-1,-4,7,3,9,0,2,-1,1,1,-1,6,1
KR_6759768922,420,1,22,15,-2,-2,1,3,-1,2,3,-2,2,4,4,5,1,-1,0,1,0,0,8,1,4,5,1,0,0,1,1,1,-1,1,1
KR_6135422943,440,4,42,12,5,5,6,1,1,2,1,7,7,0,-4,1,5,-4,0,4,0,3,-226,-1,4,3,4,0,0,1,1,-1,-1,5,1
KR_6759815771,420,4,42,-16,6,-1,3,4,3,6,3,1,1,0,2,3,1,1,2,1,-1,7,16,1,5,6,3,0,0,-1,-1,1,-1,3,1
KR_6730926995,420,3,9,5,7,-1,2,3,0,2,2,1,2,1,7,8,1,0,1,1,0,7,4,-2,9,7,-4,0,1,1,-1,1,1,6,1
KR_6274992598,420,0,-30,-8,1,1,1,0,3,7,4,3,4,1,-3,2,5,-3,1,4,-1,-3,-3,-3,8,5,0,0,1,-1,1,1,-1,1,1
KR_6751937539,420,2,36,20,6,2,3,1,1,3,2,0,3,3,2,3,1,1,1,0,0,8,1,0,3,3,2,0,0,-1,-1,0,-1,3,1
KR_6740912812,420,1,-6,-20,0,4,7,3,2,2,0,-3,1,4,-3,1,4,0,1,1,0,-2,-26,3,4,7,6,0,0,1,1,-1,-1,6,1
KR_6745623689,420,2,37,-5,-6,4,4,0,-1,0,1,0,2,2,-6,0,6,-3,0,3,0,-6,-4,-4,5,1,2,0,2,0,1,1,1,0,1
KR_6748320334,420,4,112,-16,12,0,3,3,4,8,4,8,9,1,1,1,0,-1,0,1,1,15,41,-1,3,2,-12,0,3,1,-1,1,1,4,1
KR_6605743239,420,3,-22,26,3,1,2,1,1,2,1,2,5,3,1,4,3,-2,0,2,0,3,2,-7,9,2,-3,0,-1,-1,1,1,-1,2,1
KR_6668186762,420,2,24,40,3,4,7,3,1,3,2,-4,0,4,5,6,1,-3,0,3,0,0,34,-2,7,5,-1,0,2,1,1,1,-1,3,1
KR_6764073877,420,8,107,34,17,3,4,1,5,5,0,4,5,1,-1,2,3,6,6,0,1,12,11,4,0,4,4,0,2,0,1,1,1,0,1
KR_6752173005,420,3,66,8,2,5,5,0,-2,0,2,3,3,0,-3,1,4,-1,0,1,0,-3,0,0,5,5,3,0,0,-1,1,0,1,5,1
KR_6680285274,420,1,92,-8,6,4,5,1,0,3,3,1,4,3,0,2,2,1,1,0,0,3,-1,3,3,6,-1,0,0,1,0,0,1,4,1
KR_6701214321,420,1,-20,18,6,-4,0,4,1,2,1,1,1,0,1,4,3,7,7,0,0,1,2,2,2,4,-2,0,0,1,1,-1,1,1,1
KR_6626358623,420,-3,8,24,1,6,8,2,1,3,2,-1,1,2,-1,1,2,-4,0,4,1,-1,-14,-3,6,3,3,0,1,1,-1,1,1,4,1
KR_6566331940,420,1,-32,9,-6,-1,1,2,1,3,2,-3,1,4,-1,4,5,-2,1,3,-1,-1,-6,4,4,8,1,0,0,-1,1,0,-1,2,1
KR_6751076588,440,1,77,4,5,5,6,1,-2,1,3,0,1,1,-2,0,2,4,4,0,0,-2,-1,3,5,8,2,0,1,1,1,1,1,4,1
KR_6760971194,420,-1,6,12,4,-1,0,1,0,1,1,0,3,3,4,6,2,1,2,1,-1,6,25,1,0,1,0,0,1,-1,1,1,-1,4,1
KR_6615718521,420,1,-12,-16,3,-1,0,1,5,6,1,3,6,3,0,3,3,-4,1,5,0,7,-3,4,4,8,3,0,0,1,-1,-1,1,5,1
KR_6712794673,420,2,68,-18,4,-1,0,1,1,6,5,-2,1,3,6,12,6,0,0,0,-2,2,10,-6,8,2,-1,0,1,1,-1,1,-1,3,1
KR_6604244012,420,1,-14,1,1,1,2,1,-1,2,3,0,1,1,1,2,1,0,0,0,0,1,-113,-3,4,1,1,0,0,-1,1,0,-1,2,1
KR_6711223629,420,0,-39,29,-1,-5,0,5,1,1,0,4,4,0,-2,3,5,1,1,0,0,10,-1,-3,3,0,4,0,-1,-1,-1,-1,-1,2,1
KR_6704833589,420,0,-10,28,0,3,3,0,1,4,3,-4,3,7,0,1,1,0,0,0,0,-9,5,2,1,3,-3,0,0,1,1,0,1,4,1
KR_6741093141,420,5,-19,18,19,1,5,4,5,6,1,4,4,0,6,8,2,3,4,1,3,21,-65,-3,5,2,-14,0,1,1,1,1,1,1,1
KR_6754062398,420,3,68,39,12,2,3,1,2,3,1,4,5,1,3,5,2,1,1,0,1,6,129,5,2,7,4,0,3,1,1,1,1,6,1
KR_6750031664,420,-1,22,8,-2,-3,0,3,0,2,2,-2,6,8,2,2,0,1,4,3,0,-2,-1,-1,6,5,2,0,1,-1,1,1,1,5,1
KR_6667242907,420,-1,-47,-17,-3,-1,0,1,-1,2,3,-2,1,3,1,2,1,0,1,1,0,2,1,1,2,3,-6,0,-2,-1,-1,-1,-1,6,1
KR_6738855675,420,2,68,36,6,4,4,0,-1,5,6,-1,3,4,6,6,0,-2,0,2,0,10,7,6,3,9,-4,0,0,1,-1,1,1,1,1
KR_6747493089,420,1,25,1,14,1,2,1,8,9,1,1,3,2,2,5,3,2,3,1,1,20,6,4,3,7,-7,0,0,0,1,0,1,0,1
KR_6671877892,420,2,42,24,8,0,2,2,3,3,0,4,5,1,3,7,4,-2,0,2,0,3,101,-2,5,3,5,0,1,1,-1,1,1,1,1
KR_6618651901,420,2,43,-13,1,-2,3,5,1,6,5,-2,0,2,5,8,3,-1,0,1,0,2,4,-1,7,6,-3,0,1,-1,1,1,1,3,1
KR_6694538637,420,1,3,15,2,0,1,1,1,3,2,1,1,0,-3,1,4,3,4,1,0,3,12,-4,6,2,4,0,-1,1,-1,-1,1,2,1
KR_6654966059,420,-3,4,-2,-3,1,4,3,1,2,1,-2,1,3,0,2,2,-3,1,4,3,4,-10,5,4,9,4,0,-1,-1,-1,-1,1,2,1
KR_6756998024,420,1,27,4,4,0,1,1,2,4,2,3,6,3,-3,1,4,2,2,0,0,-1,-2,-1,6,5,-3,0,0,1,1,1,1,6,1
KR_6692983989,420,1,11,32,5,0,1,1,-1,2,3,7,8,1,-5,2,7,4,5,1,0,6,15,2,3,5,-2,0,1,1,1,1,1,6,1
KR_6758727156,420,2,59,16,1,3,3,0,0,4,4,1,5,4,-6,2,8,3,3,0,0,-1,2,1,3,4,2,0,1,-1,-1,1,1,2,1
KR_6759262009,440,-2,-44,-29,-8,-2,1,3,-2,0,2,0,5,5,-4,0,4,0,1,1,0,-9,-44,0,3,3,-1,0,1,-1,0,1,-1,6,1
KR_6691242599,420,-1,-6,7,0,-2,1,3,6,10,4,-1,4,5,-1,0,1,-2,1,3,0,4,-6,-5,8,3,0,0,0,1,1,-1,-1,3,1
KR_6744540007,420,1,30,-1,-5,-2,0,2,-6,0,6,4,4,0,-2,0,2,1,1,0,0,-10,-7,0,4,4,1,0,1,1,0,1,-1,4,1
KR_6678803172,420,-2,-5,-8,0,1,3,2,3,3,0,2,2,0,-1,2,3,-5,1,6,2,4,0,1,5,6,-1,0,1,1,1,1,1,4,1
KR_6467586040,420,0,19,0,3,0,2,2,1,4,3,0,2,2,3,4,1,-1,1,2,0,1,10,4,3,7,-4,0,3,-1,1,1,1,3,1
KR_6740438943,420,0,33,2,1,-4,1,5,0,3,3,2,3,1,3,5,2,0,3,3,0,6,-299,1,4,5,-4,0,0,-1,-1,0,1,4,1
KR_6763291682,420,0,-10,-9,9,-3,0,3,1,1,0,5,7,2,-1,2,3,7,8,1,1,10,13,0,4,4,0,0,1,1,1,1,1,6,1
KR_6739545857,440,1,11,1,7,4,5,1,4,5,1,-1,2,3,1,2,1,-1,0,1,0,0,0,2,5,7,-2,0,1,1,1,-1,1,6,1
KR_6764479898,420,-3,-19,-5,-3,-5,2,7,-1,2,3,-2,0,2,5,7,2,0,3,3,0,-2,-13,-8,9,1,1,0,-2,-1,-1,-1,-1,5,1
KR_6751689747,420,-1,40,-3,-2,1,1,0,3,5,2,-4,1,5,0,3,3,-2,2,4,-1,2,-1,4,3,7,-2,0,0,0,-1,0,-1,0,1
KR_6619874893,420,4,-29,16,8,2,3,1,0,3,3,3,4,1,3,4,1,0,0,0,0,6,2,-4,7,3,2,0,0,1,0,0,1,1,1
KR_6706623671,420,0,4,-26,8,0,0,0,-2,2,4,5,6,1,3,4,1,2,3,1,2,5,8,5,3,8,4,0,2,1,1,1,1,6,1
KR_6661843705,420,2,-62,0,0,1,1,0,2,5,3,-2,3,5,-1,1,2,0,1,1,0,9,-2,-3,6,3,3,0,-1,1,1,-1,-1,3,1
KR_6756892125,420,0,10,0,1,5,6,1,0,3,3,-1,1,2,-7,0,7,4,4,0,0,6,3,-1,1,0,-1,0,0,-1,0,0,1,6,1
KR_6706884549,440,3,96,4,10,1,4,3,2,4,2,3,6,3,3,4,1,1,4,3,1,10,-5,-1,3,2,2,0,2,-1,1,1,1,2,1
KR_6028384855,420,0,77,0,1,-6,1,7,0,1,1,3,3,0,4,7,3,0,1,1,1,9,20,3,3,6,-6,0,0,1,1,1,1,4,1
KR_6639078533,420,2,-7,19,2,1,3,2,3,5,2,-1,3,4,0,2,2,-1,1,2,0,-1,5,-1,4,3,-3,0,2,1,1,1,1,6,1
KR_6757645785,420,0,-13,-35,3,-2,0,2,-2,3,5,7,8,1,-2,3,5,2,2,0,0,7,-49,2,5,7,3,0,-1,-1,-1,-1,1,3,1
KR_6761348367,420,1,71,18,3,0,2,2,3,3,0,-3,1,4,2,4,2,1,1,0,0,6,25,1,1,2,-17,0,1,-1,-1,1,1,6,1
KR_6757825209,420,3,32,44,5,5,6,1,0,3,3,1,1,0,-3,1,4,2,2,0,0,2,7,1,3,4,-3,0,1,1,1,-1,1,5,1
KR_6755284330,440,5,27,23,4,-2,2,4,9,12,3,2,4,2,-5,1,6,0,0,0,0,8,-13,-2,9,7,3,0,0,-1,-1,-1,1,2,1
KR_6699977037,420,2,24,3,10,3,4,1,-1,3,4,3,3,0,5,6,1,0,1,1,0,4,25,1,5,6,2,0,1,1,0,1,1,1,1
KR_6658330025,420,-1,19,0,7,-3,4,7,5,7,2,1,3,2,5,6,1,-1,0,1,0,10,-21,1,3,4,3,0,-1,1,-1,1,1,6,1
KR_6743030504,420,1,39,-16,2,2,2,0,-1,3,4,3,4,1,0,3,3,-2,0,2,-1,-6,-34,-1,6,5,14,0,0,1,-1,0,-1,4,1
KR_6587460529,420,1,15,-15,7,0,2,2,2,4,2,2,4,2,-2,3,5,5,6,1,1,10,45,3,2,5,-15,0,0,1,-1,0,1,1,1
KR_6755830809,420,5,18,30,4,0,2,2,6,7,1,-2,1,3,0,4,4,0,0,0,0,4,-4,1,5,6,5,0,2,1,1,1,1,4,1
KR_6631073872,420,4,54,28,1,-3,1,4,2,2,0,-4,0,4,2,3,1,4,6,2,0,5,0,-1,4,3,6,0,-1,1,-1,-1,1,1,1
KR_6764756549,420,1,7,-16,4,-1,3,4,4,5,1,-1,1,2,2,3,1,0,1,1,0,6,-100,-1,5,4,1,0,1,-1,1,1,-1,5,1
KR_6664789225,420,4,101,0,12,3,4,1,5,7,2,6,6,0,-1,5,6,-1,2,3,0,5,-65,-3,6,3,23,0,1,1,-1,1,1,3,1
KR_6710272134,420,0,-13,-24,7,1,4,3,4,6,2,1,2,1,1,6,5,0,0,0,0,8,3,2,2,4,-1,0,0,1,-1,1,-1,2,1
KR_6696865201,420,2,55,-35,11,8,8,0,0,3,3,0,1,1,1,2,1,2,2,0,0,6,161,-1,4,3,-2,0,4,0,1,1,1,0,1
KR_6730133060,440,-3,-59,-5,-10,-5,0,5,-3,0,3,-1,4,5,0,2,2,-1,2,3,0,-6,8,-6,9,3,1,0,-1,0,-1,-1,-1,0,1
KR_6681148688,420,-1,53,-4,-2,4,4,0,-1,7,8,-6,2,8,1,1,0,0,0,0,0,9,120,0,7,7,1,0,0,1,1,1,-1,3,1
KR_6690294802,420,4,99,11,4,0,2,2,1,5,4,3,7,4,1,2,1,-1,0,1,0,4,-14,-5,7,2,9,0,1,1,0,1,1,5,1
KR_6694450974,420,0,39,4,0,2,2,0,1,2,1,2,4,2,-5,1,6,0,0,0,0,-8,-8,-3,9,6,5,0,0,1,1,1,1,5,1
KR_6714321998,440,-2,-34,-23,-11,-1,1,2,-11,0,11,0,1,1,0,1,1,1,2,1,0,-17,-4,1,3,4,-1,0,0,1,0,0,-1,6,1
KR_6762654979,440,1,-16,-27,3,3,3,0,2,3,1,1,2,1,-1,1,2,-2,1,3,0,9,31,2,1,3,-5,0,0,0,0,0,-1,0,1
KR_6764107801,420,0,-40,-27,-4,0,1,1,2,3,1,0,2,2,-5,2,7,-1,0,1,0,-2,-6,-1,3,2,-2,0,0,-1,-1,0,-1,3,1
KR_6577121397,420,2,49,34,0,0,1,1,3,4,1,0,1,1,-5,2,7,2,2,0,1,2,48,7,1,8,-20,0,1,0,1,1,1,0,1
KR_6716739806,420,2,23,-15,11,-1,0,1,3,4,1,2,2,0,8,10,2,-1,1,2,1,11,11,1,2,3,0,0,1,1,1,1,1,5,1
KR_6566439663,420,4,24,1,13,5,5,0,2,5,3,6,6,0,0,4,4,0,3,3,0,5,-3,8,0,8,1,0,0,-1,0,1,1,3,1
KR_6755800189,420,-2,-64,8,-4,-2,0,2,-2,2,4,-2,1,3,0,8,8,2,3,1,0,3,3,-4,6,2,-2,0,-2,-1,-1,-1,-1,3,1
KR_6636208103,420,4,13,12,3,1,2,1,-2,2,4,3,4,1,2,3,1,-1,0,1,0,6,50,-2,6,4,-2,0,1,-1,1,1,1,6,1
KR_6744991450,440,4,31,-16,6,4,4,0,0,3,3,2,5,3,1,1,0,-1,1,2,0,3,2,0,4,4,2,0,0,-1,1,1,-1,5,1
KR_6731144392,420,4,40,22,7,1,2,1,1,2,1,2,2,0,3,4,1,0,0,0,0,9,-4,-1,5,4,-2,0,0,1,0,0,1,1,1
KR_6664695787,420,-1,13,-40,1,0,2,2,3,6,3,0,1,1,-1,2,3,-1,0,1,0,5,-1,1,3,4,0,0,0,-1,-1,0,-1,6,1
KR_6743752466,420,6,7,9,23,1,2,1,9,9,0,2,2,0,9,9,0,2,2,0,0,29,2,0,5,5,-5,0,0,1,-1,0,1,3,1
KR_6739189644,420,-3,-21,-4,2,1,2,1,0,3,3,-1,1,2,1,3,2,1,2,1,1,5,390,0,4,4,2,0,0,1,1,0,1,4,1
KR_6644119661,420,1,21,8,-1,-1,1,2,0,4,4,0,2,2,0,0,0,0,0,0,0,-2,-5,4,3,7,3,0,0,-1,0,1,-1,6,1
KR_6756014977,420,-1,-45,-24,4,0,3,3,0,1,1,1,2,1,3,4,1,0,0,0,0,6,-7,3,1,4,2,0,1,1,1,1,1,3,1
KR_6724791574,420,2,4,4,8,1,1,0,4,5,1,1,3,2,3,4,1,-1,0,1,0,6,5,1,3,4,0,0,0,1,0,1,1,5,1
KR_6727845044,420,1,27,8,4,-1,1,2,5,5,0,0,3,3,1,2,1,-1,0,1,1,10,10,0,2,2,-5,0,1,1,1,1,1,6,1
KR_6703745244,420,-5,-31,-12,-4,-5,0,5,-3,1,4,0,0,0,5,5,0,-1,1,2,2,0,8,6,0,6,-1,0,0,1,1,-1,1,4,1
KR_6748782238,420,1,50,26,0,-2,3,5,0,4,4,3,4,1,0,2,2,-1,2,3,0,0,-1,2,3,5,-6,0,0,-1,1,-1,-1,6,1
KR_6760822036,420,2,8,4,0,4,6,2,-5,2,7,-2,2,4,0,2,2,3,4,1,0,0,8,3,5,8,-3,0,1,-1,1,1,-1,3,1
KR_6369684424,420,0,73,24,-1,0,3,3,-3,1,4,-1,4,5,3,4,1,0,1,1,0,1,0,0,0,0,3,0,0,1,1,0,1,5,1
KR_6666402576,420,6,91,32,15,1,1,0,0,1,1,6,6,0,5,9,4,3,4,1,0,22,-126,5,4,9,8,0,2,1,1,1,-1,4,1
KR_6691657418,420,4,28,18,9,-3,2,5,1,1,0,1,2,1,11,14,3,-1,0,1,1,18,11,3,4,7,0,0,0,1,0,1,1,4,1
KR_6662957716,420,-1,2,30,-10,1,2,1,-6,1,7,4,4,0,-7,0,7,-2,0,2,-1,-15,-4,0,6,6,-2,0,0,0,1,-1,-1,0,1
KR_6758504910,420,3,23,-20,10,2,2,0,3,3,0,2,3,1,2,4,2,1,2,1,0,12,12,1,4,5,0,0,0,1,-1,1,1,3,1
KR_6758391685,420,2,77,-32,4,2,2,0,-1,2,3,3,5,2,0,3,3,0,1,1,-2,-3,-36,-1,4,3,-1,0,0,1,1,0,-1,3,1
KR_6640927021,420,-2,-22,0,4,-2,1,3,1,3,2,-1,1,2,4,8,4,2,2,0,-1,9,-2,-1,5,4,0,0,0,1,-1,1,-1,3,1
KR_6750829610,420,2,17,-24,5,3,5,2,1,5,4,3,3,0,-1,2,3,-1,0,1,0,1,-4,-1,4,3,3,0,0,-1,0,0,1,4,1
KR_6733327162,420,3,63,20,8,-2,2,4,3,6,3,3,3,0,2,4,2,2,3,1,0,9,10,5,0,5,-1,0,0,1,1,1,-1,3,1
KR_6596090440,420,-2,-15,39,-4,-1,1,2,-1,3,4,2,4,2,-2,2,4,-2,0,2,0,0,-3,-10,15,5,6,0,1,-1,1,1,1,3,1
KR_6758418743,420,4,34,-3,4,3,6,3,3,4,1,0,3,3,-2,1,3,0,1,1,1,3,8,-2,11,9,-7,0,0,-1,-1,0,1,6,1
KR_6756864758,420,-1,-43,8,0,1,4,3,1,2,1,-4,0,4,2,4,2,0,1,1,0,4,0,2,3,5,-1,0,0,-1,1,0,1,4,1
KR_6735720426,420,1,71,-48,5,-1,0,1,1,4,3,-2,1,3,7,7,0,0,0,0,0,8,-215,-3,5,2,-1,0,2,-1,-1,1,1,3,1
KR_6760542169,420,6,70,16,13,6,7,1,-2,0,2,2,3,1,6,7,1,1,2,1,0,7,-4,-7,9,2,0,0,1,1,1,1,1,5,1
KR_6689729948,420,5,144,7,8,4,5,1,1,1,0,2,5,3,-1,2,3,2,2,0,1,11,-8,4,5,9,6,0,4,1,1,1,1,4,1
KR_6660123364,420,-1,-30,-28,1,0,1,1,-2,3,5,0,2,2,2,6,4,1,1,0,0,1,-7,-5,8,3,5,0,0,-1,1,0,1,2,1
KR_6722531835,420,1,37,-16,3,-1,2,3,-7,0,7,5,6,1,4,8,4,2,2,0,-1,-3,6,-3,6,3,1,0,0,-1,-1,1,-1,2,1
KR_6518587559,420,-1,27,4,-2,-1,0,1,3,3,0,6,7,1,-4,1,5,-6,0,6,1,-4,-4,1,3,4,2,0,-1,1,-1,1,1,4,1
KR_6731234713,420,-3,-23,-4,-2,0,2,2,1,3,2,-3,0,3,-1,1,2,1,2,1,0,-1,298,6,3,9,-3,0,0,1,1,-1,1,6,1
KR_6750184643,420,-5,-72,-28,-15,4,4,0,1,2,1,-13,0,13,-1,2,3,-6,1,7,-1,-9,-5,1,4,5,0,0,-1,-1,0,-1,-1,2,1
KR_6740724394,420,0,53,-16,-7,2,2,0,-2,0,2,1,3,2,-1,1,2,-7,0,7,-1,-9,33,-1,4,3,-6,0,0,-1,0,0,-1,5,1
KR_6758874247,420,-2,-16,-20,3,5,6,1,0,6,6,-3,2,5,0,2,2,1,1,0,0,7,6,0,4,4,1,0,2,1,-1,1,1,6,1
KR_6760639128,420,-1,15,-24,-1,-1,1,2,4,4,0,-1,2,3,-4,2,6,1,4,3,2,1,-2,-2,5,3,-2,0,0,-1,0,0,1,1,1
KR_6762199110,420,2,27,32,0,-3,4,7,1,3,2,1,3,2,3,3,0,-2,3,5,0,0,4,4,2,6,2,0,2,1,-1,1,-1,5,1
KR_6706193328,420,5,24,14,4,-1,2,3,-1,4,5,0,1,1,1,2,1,5,6,1,0,2,5,-5,10,5,-2,0,2,1,1,1,1,4,1
KR_6720416421,420,2,54,18,7,4,4,0,-1,2,3,-5,0,5,5,6,1,4,5,1,0,3,4,0,2,2,1,0,0,-1,-1,1,-1,6,1
KR_6713180249,420,-1,-60,7,1,-3,1,4,0,4,4,3,3,0,1,1,0,0,2,2,0,6,18,-3,5,2,-1,0,-1,1,1,-1,1,4,1
KR_6680370174,440,4,-1,13,6,1,4,3,5,11,6,2,2,0,2,2,0,-4,1,5,0,7,12,-3,4,1,-3,0,0,1,-1,1,-1,4,1
KR_6733206347,420,0,-16,3,-5,-2,2,4,2,3,1,-2,0,2,-1,2,3,-2,0,2,0,-5,-5,-2,5,3,0,0,0,1,-1,0,-1,5,1
KR_6688904938,420,6,67,17,10,3,3,0,3,3,0,0,1,1,5,7,2,-1,0,1,0,6,116,0,7,7,4,0,1,1,1,1,-1,6,1
KR_6689030885,420,4,127,23,5,3,3,0,3,5,2,-4,3,7,5,5,0,-2,0,2,1,0,1,2,1,3,0,0,3,-1,1,1,1,5,1
KR_6689237588,420,-1,-6,-1,1,1,3,2,-3,1,4,0,2,2,3,4,1,0,0,0,1,1,9,0,6,6,4,0,0,-1,1,1,1,6,1
KR_6755670315,420,2,41,8,6,2,2,0,0,4,4,1,2,1,4,5,1,-1,3,4,0,4,-25,3,5,8,4,0,1,0,1,1,1,0,1
KR_6691218730,420,1,42,-13,4,5,7,2,-2,1,3,-2,3,5,4,8,4,-1,0,1,0,-6,8,2,5,7,0,0,1,-1,1,1,1,5,1
KR_6650351223,440,0,-2,16,-3,-2,1,3,3,3,0,1,1,0,-5,1,6,0,0,0,0,-5,-3,-8,9,1,0,0,1,-1,1,1,-1,6,1
KR_6750132896,420,3,49,-4,9,0,5,5,1,3,2,3,3,0,5,7,2,0,0,0,0,10,-34,-1,3,2,16,0,1,1,0,1,1,4,1
KR_6658001270,420,4,22,40,12,5,5,0,0,3,3,4,4,0,0,1,1,3,3,0,0,12,8,2,4,6,-1,0,1,1,1,1,1,4,1
KR_6649702223,420,0,-26,37,-2,4,5,1,1,2,1,1,1,0,-7,0,7,-1,1,2,1,-7,-3,-1,6,5,3,0,1,1,1,1,1,3,1
KR_6679157905,440,0,56,13,-4,1,3,2,3,5,2,-1,3,4,-7,0,7,0,1,1,0,-9,-70,-1,7,6,1,0,0,-1,0,0,-1,5,1
KR_6749172932,420,0,22,29,0,-2,1,3,2,3,1,2,4,2,0,1,1,-2,0,2,1,5,195,1,3,4,1,0,0,1,1,0,1,4,1
KR_6756567947,420,1,-2,17,11,5,6,1,2,2,0,3,4,1,1,5,4,0,1,1,1,10,-5,4,1,5,3,0,2,1,1,1,1,3,1
KR_6710120534,440,3,44,28,3,2,2,0,2,3,1,2,2,0,-3,0,3,0,0,0,0,1,0,-2,8,6,3,0,0,1,0,0,1,6,1
KR_6687973714,420,-3,-32,-4,-3,0,2,2,0,2,2,-3,1,4,1,4,3,-1,2,3,0,-7,1,1,3,4,-7,0,-1,1,-1,-1,-1,3,1
KR_6763020719,420,-2,-29,-12,-7,-2,0,2,-1,2,3,-2,1,3,-3,4,7,1,1,0,0,-2,9,-1,4,3,0,0,-2,-1,-1,-1,1,6,1
KR_6691793352,420,1,-18,-2,2,-2,1,3,1,4,3,-1,2,3,4,5,1,0,1,1,1,0,50,4,3,7,-2,0,0,1,-1,-1,1,4,1
KR_6749316638,420,2,49,2,8,-4,0,4,5,6,1,3,5,2,3,4,1,1,2,1,0,10,14,-2,6,4,4,0,1,0,1,1,1,0,1
KR_6744669738,420,2,-61,31,11,1,2,1,0,2,2,-1,2,3,6,6,0,5,6,1,0,15,9,4,3,7,-3,0,0,1,1,0,-1,4,1
KR_6729947111,420,5,35,20,4,0,3,3,2,5,3,2,2,0,1,2,1,-1,0,1,0,3,0,-1,5,4,3,0,1,1,1,1,-1,6,1
KR_6741348759,440,7,81,27,10,4,5,1,3,4,1,0,2,2,4,4,0,-1,2,3,0,4,1,6,1,7,2,0,1,0,1,1,1,0,1
KR_6745478509,420,2,-54,16,6,5,7,2,-1,1,2,1,2,1,-2,0,2,3,3,0,0,9,15,-2,4,2,2,0,1,1,1,1,1,5,1
KR_6606229534,420,-1,-18,-39,1,-2,2,4,1,3,2,0,1,1,1,3,2,1,1,0,1,4,12,1,2,3,2,0,0,1,-1,0,1,5,1
KR_6724745091,420,-1,-52,4,-1,-1,2,3,-1,2,3,4,6,2,0,1,1,-3,0,3,0,1,39,1,6,7,-14,0,0,1,1,-1,1,2,1
KR_6576954340,440,3,49,12,1,3,3,0,-2,1,3,2,2,0,-1,1,2,-1,0,1,1,-5,-9,-1,4,3,4,0,1,1,1,1,1,2,1
KR_6750968038,420,2,50,16,0,1,1,0,2,3,1,2,3,1,-4,3,7,-1,0,1,0,1,-4,-4,9,5,5,0,0,1,1,0,-1,6,1
KR_6741883341,420,8,88,33,14,2,4,2,-1,5,6,5,5,0,6,8,2,2,2,0,-1,11,8,-2,2,0,2,0,2,1,1,1,-1,6,1
KR_6751734624,420,3,108,61,11,-3,3,6,1,2,1,3,5,2,8,8,0,2,3,1,1,9,33,4,0,4,-1,0,2,1,1,1,1,3,1
KR_6762482631,420,2,23,8,9,3,4,1,2,2,0,2,4,2,0,1,1,2,2,0,0,12,-1,-2,6,4,2,0,1,1,-1,1,1,2,1
KR_6735204678,420,5,57,20,4,2,4,2,-2,1,3,2,3,1,2,4,2,0,1,1,0,2,-2,-1,6,5,-7,0,1,1,-1,1,1,5,1
KR_6494378113,420,0,29,34,-1,-4,1,5,2,4,2,-3,1,4,2,2,0,2,2,0,0,6,-9,0,7,7,-1,0,-1,1,1,1,-1,6,1
KR_6663760526,420,1,19,4,3,4,4,0,-5,1,6,0,5,5,2,5,3,2,3,1,0,3,2,8,1,9,3,0,0,1,-1,0,1,5,1
KR_6747148552,420,1,48,5,3,3,3,0,-4,1,5,1,3,2,3,4,1,0,0,0,0,2,259,0,6,6,0,0,0,1,1,0,1,5,1
KR_6708778560,420,0,0,-8,2,-2,0,2,0,5,5,3,4,1,0,4,4,1,2,1,0,2,-7,-1,6,5,3,0,0,-1,-1,0,-1,3,1
KR_6748333589,420,0,0,-11,3,-3,4,7,2,4,2,-1,2,3,1,6,5,4,4,0,0,6,20,1,1,2,-1,0,-1,1,-1,-1,-1,5,1
KR_6688537630,420,2,76,-2,3,1,2,1,-1,1,2,2,3,1,1,4,3,0,0,0,0,0,-22,0,5,5,-3,0,1,1,-1,-1,1,4,1
KR_6549306020,420,1,-45,6,4,0,1,1,-3,3,6,-1,5,6,2,4,2,6,6,0,0,14,29,0,4,4,3,0,0,1,1,1,-1,6,1
KR_6752502483,440,1,-42,3,-2,-2,0,2,0,2,2,1,1,0,-2,0,2,1,2,1,0,-4,15,0,4,4,-2,0,-1,1,-1,-1,-1,3,1
KR_6681132334,420,-3,-22,-8,0,2,3,1,-1,1,2,-1,2,3,1,3,2,-1,1,2,0,-6,2,5,3,8,-2,0,0,1,1,1,1,4,1
KR_6494384660,420,5,88,3,15,4,4,0,3,5,2,2,4,2,3,3,0,3,3,0,0,13,-9,4,4,8,3,0,3,1,1,1,1,2,1
KR_6730132948,440,2,47,-8,0,-1,4,5,-2,2,4,0,1,1,5,5,0,-2,0,2,0,10,4,-3,8,5,4,0,-1,1,-1,-1,1,4,1
KR_6733757443,420,1,-21,43,2,-5,1,6,4,5,1,0,4,4,3,5,2,0,0,0,1,14,-8,3,4,7,2,0,0,1,0,0,1,5,1
KR_6704255035,420,0,-60,-7,2,-1,3,4,1,4,3,1,3,2,-1,2,3,2,2,0,0,4,46,1,2,3,-2,0,0,1,0,0,-1,1,1
KR_6761318302,420,1,3,24,4,0,0,0,-4,1,5,2,2,0,4,5,1,2,2,0,0,7,-10,0,5,5,1,0,-1,1,-1,-1,-1,2,1
KR_6753815370,440,3,3,6,5,1,3,2,1,4,3,1,3,2,0,5,5,2,3,1,0,8,-7,-8,12,4,4,0,0,0,0,1,1,0,1
KR_6724489132,420,1,51,-6,6,1,3,2,2,5,3,-2,3,5,5,5,0,0,0,0,0,5,2,0,3,3,-2,0,1,1,1,1,1,2,1
KR_6764000624,420,-2,25,37,-2,-4,3,7,2,3,1,8,9,1,-6,1,7,-2,0,2,0,-5,38,2,3,5,-7,0,-1,1,0,-1,-1,4,1
KR_6758287829,420,0,37,-28,3,1,3,2,1,2,1,2,2,0,1,4,3,-2,1,3,0,7,-19,-1,5,4,2,0,0,1,-1,-1,1,4,1
KR_6705524861,420,1,38,-12,3,-2,0,2,-1,4,5,1,2,1,4,4,0,1,1,0,0,6,20,-2,5,3,5,0,0,1,-1,1,-1,3,1
KR_6590288736,420,1,87,18,1,-1,0,1,-4,1,5,1,2,1,4,5,1,1,3,2,0,-4,4,1,5,6,2,0,0,1,-1,-1,1,5,1
KR_6646591611,420,2,38,4,-7,-1,2,3,-2,3,5,-2,1,3,-1,3,4,-1,2,3,-3,-5,17,-3,9,6,-1,0,0,1,-1,0,-1,6,1
KR_6729107980,420,2,-42,36,-1,3,5,2,2,8,6,2,4,2,-6,2,8,-2,1,3,0,-2,8,2,1,3,0,0,0,-1,1,-1,-1,3,1
KR_6685344045,420,2,-4,39,3,1,1,0,-1,0,1,-1,2,3,2,3,1,2,2,0,0,4,141,4,3,7,1,0,2,1,1,1,1,3,1
KR_6758443991,420,4,115,0,5,2,6,4,2,4,2,-1,1,2,1,2,1,1,1,0,0,3,-269,1,4,5,6,0,1,1,-1,1,-1,2,1
KR_6571251050,420,-3,-5,-8,-3,1,3,2,2,4,2,-3,4,7,-4,0,4,1,3,2,0,-2,1,4,4,8,5,0,-1,-1,-1,1,1,1,1
KR_6730044779,440,-1,-56,-1,0,1,1,0,1,4,3,-1,2,3,1,7,6,-2,0,2,0,3,4,0,6,6,-3,0,0,1,-1,0,-1,5,1
KR_6762519102,420,0,-21,7,1,1,1,0,3,4,1,-1,1,2,-3,3,6,1,2,1,-1,1,-4,-2,3,1,2,0,-1,1,-1,-1,-1,5,1
KR_6717033669,420,-1,-21,-8,-5,-2,0,2,-2,1,3,-2,0,2,0,4,4,1,2,1,0,-2,-2,1,3,4,-5,0,-1,1,-1,-1,1,1,1
KR_6664445524,420,0,54,20,-1,-1,2,3,-2,0,2,3,4,1,1,2,1,-2,0,2,0,-6,6,8,4,12,-2,0,-1,-1,0,-1,-1,1,1
KR_6568152147,420,2,-9,-11,4,-2,1,3,1,2,1,3,5,2,2,4,2,0,0,0,0,9,-53,-3,5,2,35,0,-1,-1,1,-1,1,4,1
KR_6749406944,420,-4,6,-11,-9,4,5,1,-4,0,4,-1,3,4,-6,0,6,-2,1,3,0,-10,9,-3,4,1,-1,0,-1,1,1,-1,1,5,1
KR_6395620768,420,2,38,0,10,2,2,0,0,1,1,7,7,0,2,4,2,-1,1,2,0,3,-3,3,3,6,6,0,3,1,1,1,1,2,1
KR_6664515938,420,1,26,-8,4,0,1,1,2,2,0,-3,1,4,3,4,1,2,2,0,-1,4,-27,-3,4,1,1,0,1,0,1,1,-1,0,1
KR_6112347269,420,1,30,6,9,4,5,1,1,5,4,5,7,2,-1,2,3,0,0,0,1,0,13,-2,6,4,-2,0,1,0,1,1,1,0,1
KR_6625457695,420,2,64,-19,12,1,3,2,0,1,1,2,3,1,3,5,2,6,7,1,0,10,-3,2,3,5,5,0,1,1,1,1,1,5,1
KR_6672368017,420,-1,-9,21,6,0,2,2,6,6,0,-1,3,4,0,3,3,1,2,1,3,13,8,6,3,9,-3,0,2,-1,1,1,1,6,1
KR_6729126967,420,2,-1,35,14,6,6,0,6,10,4,0,2,2,1,5,4,1,2,1,0,10,6,7,2,9,-6,0,1,1,-1,1,1,4,1
KR_6741171048,440,-1,26,16,9,1,1,0,3,3,0,1,3,2,4,7,3,0,0,0,0,7,0,-1,7,6,6,0,0,1,1,1,1,4,1
KR_6720565141,420,0,36,3,-5,4,4,0,-2,1,3,-8,0,8,0,4,4,1,1,0,1,-7,2,-2,5,3,-1,0,1,-1,1,1,1,2,1
KR_6742076132,420,-2,-17,32,-4,0,1,1,-1,2,3,-2,1,3,3,6,3,-4,1,5,0,-8,-216,3,2,5,3,0,0,-1,1,0,-1,1,1
KR_6624166973,420,1,-2,44,-3,-1,1,2,0,2,2,-1,0,1,3,5,2,-4,0,4,0,-1,4,-2,2,0,1,0,0,1,-1,0,-1,4,1
KR_6735934206,420,-1,45,5,2,-1,2,3,-2,1,3,3,5,2,2,3,1,0,0,0,0,3,7,-5,6,1,0,0,0,-1,-1,0,1,4,1
KR_6761645716,420,-3,-43,28,-11,2,3,1,-4,2,6,-3,2,5,-5,1,6,-1,2,3,0,-13,-325,-3,4,1,-4,0,0,1,1,1,-1,5,1
KR_6601517706,420,4,40,15,12,5,5,0,2,3,1,3,3,0,4,8,4,-2,1,3,0,6,11,-5,9,4,3,0,2,-1,1,1,-1,2,1
KR_6737573240,420,2,43,-13,11,3,5,2,2,5,3,3,5,2,3,3,0,0,1,1,0,11,6,-2,5,3,-2,0,1,1,-1,1,1,5,1
KR_6739557455,420,4,130,56,7,3,4,1,2,3,1,4,4,0,0,2,2,-2,0,2,0,5,-1,4,3,7,1,0,1,1,1,1,1,1,1
KR_6749318458,440,-1,8,-32,4,0,2,2,4,5,1,0,1,1,1,2,1,-1,0,1,0,2,-16,-2,5,3,3,0,2,-1,1,-1,-1,5,1
KR_6762523684,440,1,-61,8,-5,1,1,0,1,4,3,-5,0,5,-4,1,5,2,3,1,0,3,-3,3,3,6,2,0,-4,1,-1,-1,-1,1,1
KR_6669832396,420,9,69,12,10,4,4,0,1,4,3,2,3,1,0,1,1,3,4,1,0,10,-20,-5,9,4,21,0,1,1,-1,1,-1,2,1
KR_6740221005,420,4,20,-16,11,3,4,1,3,3,0,0,1,1,3,4,1,2,2,0,0,15,-68,1,5,6,29,0,0,1,0,-1,1,2,1
KR_6763576331,440,4,3,-10,9,5,5,0,-1,1,2,-1,1,2,2,3,1,4,6,2,0,6,-4,-3,4,1,4,0,1,0,0,1,-1,0,1
KR_6737442174,420,8,87,20,18,6,6,0,3,6,3,2,2,0,7,8,1,0,2,2,0,9,19,-2,9,7,-3,0,2,1,1,1,-1,2,1
KR_6662472421,420,5,93,12,13,1,1,0,3,4,1,6,6,0,2,3,1,1,2,1,0,14,-2,1,5,6,5,0,3,1,1,1,1,2,1
KR_6744272062,420,2,28,4,5,2,3,1,1,2,1,3,3,0,-1,2,3,0,1,1,0,-1,0,-1,4,3,1,0,0,1,1,1,-1,6,1
KR_6686719629,420,0,-4,16,1,0,3,3,-1,1,2,-1,3,4,3,3,0,0,0,0,0,4,15,3,6,9,0,0,0,1,-1,1,1,3,1
KR_6720222312,420,5,106,8,1,1,3,2,1,3,2,0,2,2,-2,3,5,1,4,3,0,-6,8,-4,7,3,3,0,1,1,1,1,1,5,1
KR_6752970199,440,0,28,13,-1,-3,4,7,0,1,1,-1,1,2,3,8,5,0,0,0,1,-10,-1,1,4,5,-2,0,0,1,-1,0,1,2,1
KR_6473540903,420,1,-10,17,2,4,5,1,0,3,3,-4,1,5,2,3,1,0,0,0,0,4,17,3,2,5,0,0,1,1,1,1,-1,5,1
KR_6738849059,420,8,61,20,19,4,7,3,7,7,0,3,4,1,5,6,1,0,0,0,0,14,1,1,3,4,1,0,1,1,1,1,-1,4,1
KR_6761982125,420,-2,11,8,9,4,5,1,-3,1,4,-2,0,2,1,1,0,9,9,0,0,1,-3,1,1,2,-1,0,0,-1,-1,-1,1,6,1
KR_6500314066,420,1,23,-20,1,0,1,1,-1,3,4,-1,2,3,-1,4,5,4,4,0,0,-2,5,2,3,5,3,0,1,-1,1,1,1,2,1
KR_6714845814,420,2,60,3,6,5,7,2,-6,1,7,4,6,2,-1,1,2,4,4,0,0,-7,-8,4,3,7,0,0,1,1,1,1,1,4,1
KR_6689483073,420,2,19,34,6,-2,1,3,1,2,1,6,8,2,1,2,1,0,0,0,0,8,-1,3,2,5,-3,0,0,1,0,0,-1,6,1
KR_6748558265,420,1,25,28,-5,0,0,0,3,5,2,-6,2,8,0,3,3,-2,1,3,-1,-5,-131,-1,8,7,-4,0,1,-1,1,1,-1,4,1
KR_6732013484,420,3,7,12,10,0,2,2,-1,4,5,0,1,1,8,10,2,3,3,0,3,25,9,4,3,7,-5,0,2,-1,0,1,1,2,1
KR_6746197376,420,4,31,32,7,4,5,1,5,5,0,2,4,2,-2,1,3,-2,1,3,0,4,21,-3,8,5,5,0,0,0,1,1,-1,0,1
KR_6691357440,420,2,-46,24,7,-1,2,3,5,5,0,-1,0,1,3,5,2,1,1,0,0,15,13,-2,8,6,-6,0,-1,1,1,-1,1,3,1
KR_6608848530,420,3,48,-7,5,8,8,0,-1,3,4,0,0,0,-3,1,4,1,1,0,1,-4,18,2,6,8,-2,0,4,-1,1,1,1,3,1
KR_6745414677,420,0,-10,-8,-1,1,4,3,1,1,0,-8,1,9,7,8,1,-2,0,2,-3,2,218,-6,9,3,6,0,0,-1,-1,-1,-1,5,1
KR_6726120079,420,1,31,0,0,4,6,2,-3,1,4,0,2,2,0,3,3,-1,0,1,0,-2,14,1,3,4,0,0,1,1,1,1,-1,4,1
KR_6755614889,420,2,66,-12,4,3,4,1,-1,0,1,1,2,1,-3,1,4,4,4,0,0,-3,-7,-3,6,3,3,0,1,1,1,1,1,3,1
KR_6757774198,420,9,47,36,6,2,4,2,1,5,4,8,9,1,-3,3,6,-2,2,4,-3,-4,1,0,6,6,2,0,1,1,-1,1,-1,5,1
KR_6763309136,440,2,81,20,4,5,8,3,-3,1,4,-1,0,1,3,4,1,0,0,0,0,1,-5,-5,9,4,3,0,1,-1,1,1,1,3,1
KR_6755989689,420,5,69,12,10,5,5,0,-2,1,3,1,3,2,6,7,1,0,0,0,0,2,-6,1,7,8,1,0,1,-1,1,1,1,6,1
KR_6737787288,420,2,45,-27,2,2,2,0,-2,1,3,2,5,3,0,1,1,0,2,2,0,0,-300,4,0,4,14,0,1,1,-1,1,1,2,1
KR_6729222014,420,4,96,37,6,3,7,4,4,6,2,-2,2,4,1,4,3,0,1,1,0,6,73,1,4,5,-5,0,3,-1,1,1,1,4,1
KR_6678725758,420,3,-6,0,7,-3,0,3,0,0,0,6,6,0,6,7,1,-2,0,2,0,13,8,5,3,8,1,0,0,1,-1,0,1,4,1
KR_6759530431,440,3,23,29,12,3,3,0,2,2,0,2,3,1,7,12,5,-2,0,2,2,25,0,-1,3,2,-1,0,0,1,1,1,1,4,1
KR_6748274864,420,-2,25,-12,0,1,4,3,-1,2,3,1,2,1,-1,3,4,0,1,1,1,3,-25,3,3,6,0,0,0,0,0,0,1,0,1
KR_6644686877,440,2,23,1,14,2,2,0,1,3,2,2,2,0,9,9,0,0,1,1,0,16,9,2,4,6,-2,0,2,1,1,1,1,3,1
KR_6628098338,420,2,20,-12,3,-1,3,4,5,9,4,2,2,0,-3,1,4,0,0,0,0,1,265,-1,6,5,1,0,1,1,1,1,1,4,1
KR_6669826483,420,1,24,-24,4,-1,3,4,9,9,0,3,8,5,-5,1,6,-2,0,2,1,7,-8,-1,5,4,3,0,0,-1,1,1,1,1,1
KR_6591732716,420,-4,-33,-12,-3,0,0,0,0,2,2,2,3,1,1,3,2,-6,0,6,-1,-6,-6,3,5,8,0,0,0,-1,-1,0,-1,6,1
KR_6746186398,440,3,70,12,4,5,7,2,0,1,1,-2,6,8,-1,3,4,2,2,0,0,5,-4,-3,7,4,-2,0,1,1,1,1,1,5,1
KR_6732180032,420,4,48,11,6,3,4,1,4,6,2,1,2,1,-2,0,2,0,0,0,0,10,249,-1,4,3,-2,0,3,1,1,1,-1,6,1
KR_6749352320,420,5,64,40,8,1,2,1,2,4,2,2,3,1,3,3,0,0,1,1,0,14,6,3,2,5,0,0,1,1,1,1,1,5,1
KR_6761551757,420,-1,-16,-10,-2,0,0,0,1,5,4,2,4,2,-1,1,2,-4,0,4,0,3,22,-1,4,3,0,0,-1,1,-1,-1,1,4,1
KR_6750167366,420,1,14,-16,0,-1,0,1,0,3,3,0,2,2,1,4,3,0,0,0,-1,0,293,-6,10,4,1,0,0,1,-1,-1,-1,6,1
KR_6704817395,420,-4,-36,-8,-4,-4,0,4,0,2,2,0,1,1,-1,2,3,1,1,0,0,-6,-7,-5,8,3,5,0,-2,-1,-1,-1,-1,2,1
KR_6729309163,420,4,46,24,13,1,3,2,0,4,4,1,1,0,8,8,0,3,4,1,1,15,-6,2,3,5,-1,0,0,1,1,1,1,5,1
KR_6741909274,420,1,5,40,1,3,4,1,2,2,0,-3,0,3,-1,3,4,0,0,0,0,0,-3,-3,4,1,-1,0,0,-1,-1,-1,1,4,1
KR_6714009130,420,3,-74,23,6,2,3,1,3,5,2,3,5,2,0,2,2,-2,0,2,0,-1,108,-3,6,3,1,0,2,1,1,1,1,2,1
KR_6629285461,420,1,50,-46,7,5,7,2,-6,1,7,3,4,1,4,9,5,1,2,1,-1,0,4,0,4,4,3,0,-1,-1,1,1,1,5,1
KR_6664642327,420,1,43,-16,2,4,4,0,1,3,2,-4,0,4,2,3,1,-1,1,2,0,3,4,-1,5,4,-1,0,1,-1,-1,1,-1,2,1
KR_6623917732,420,3,81,36,10,0,3,3,3,4,1,2,2,0,4,8,4,1,2,1,1,2,8,-1,7,6,3,0,1,1,1,1,1,4,1
KR_6713173078,420,4,6,-4,6,3,4,1,0,5,5,2,6,4,1,1,0,0,1,1,0,3,2,-6,10,4,0,0,0,0,-1,0,1,0,1
KR_6687024224,420,3,52,29,4,-5,0,5,0,2,2,7,7,0,1,3,2,1,1,0,0,8,18,0,5,5,1,0,2,1,1,1,1,1,1
KR_6754381412,420,2,7,0,0,5,6,1,0,1,1,-1,2,3,-3,0,3,-1,0,1,0,-2,-101,0,2,2,-2,0,-2,1,-1,-1,1,2,1
KR_6762436233,420,1,-43,12,0,-2,0,2,2,3,1,-1,2,3,-1,2,3,2,4,2,-1,1,-17,-4,6,2,1,0,-1,1,-1,-1,-1,6,1
KR_6731622059,420,5,60,22,8,4,4,0,2,5,3,6,6,0,-4,2,6,0,1,1,0,4,-1,2,2,4,4,0,1,1,1,1,1,3,1
KR_6286939714,440,4,44,13,3,2,4,2,1,4,3,0,2,2,-4,1,5,4,4,0,0,-3,2,-5,7,2,5,0,1,1,0,1,-1,4,1
KR_6699148823,420,2,31,17,0,1,2,1,1,2,1,3,4,1,-4,0,4,-1,1,2,0,-5,11,0,4,4,0,0,3,-1,-1,1,1,3,1
KR_6748490389,420,1,9,28,4,-1,1,2,2,4,2,2,2,0,4,6,2,-3,2,5,0,2,22,-1,3,2,1,0,1,-1,-1,1,-1,5,1
KR_6695547978,420,-3,11,24,-4,-2,2,4,-1,1,2,1,4,3,-2,1,3,0,3,3,0,-8,-32,1,3,4,21,0,1,1,1,1,1,2,1
KR_6738678164,420,7,89,56,9,8,9,1,4,10,6,1,1,0,-3,2,5,-1,3,4,-1,-4,4,-4,7,3,3,0,2,1,1,1,-1,4,1
KR_6661503030,420,-1,50,-3,-2,2,3,1,-3,2,5,-3,1,4,2,4,2,0,0,0,0,1,10,1,1,2,2,0,0,1,1,1,-1,3,1
KR_6724542973,420,4,-19,20,0,3,4,1,-4,1,5,1,4,3,1,1,0,-1,1,2,0,2,24,-2,4,2,-2,0,-1,1,0,-1,-1,3,1
KR_6686427199,420,2,50,10,8,3,5,2,2,5,3,-1,1,2,4,4,0,0,1,1,0,11,5,0,4,4,-4,0,0,1,-1,1,1,3,1
KR_6656455033,420,4,-6,8,9,3,4,1,1,4,3,3,4,1,3,5,2,-1,3,4,0,10,3,0,5,5,3,0,1,1,-1,1,-1,4,1
KR_6536827042,440,-4,-23,-2,-9,-3,1,4,-3,1,4,0,0,0,1,4,3,-4,1,5,0,-4,22,2,3,5,1,0,-3,1,-1,-1,-1,5,1
KR_6734791186,420,0,55,4,0,4,4,0,-2,4,6,-1,1,2,-2,0,2,1,1,0,0,0,-24,1,5,6,6,0,2,-1,1,1,1,1,1
KR_6702675794,420,6,105,28,18,2,3,1,5,8,3,5,6,1,3,3,0,3,5,2,1,10,-42,2,3,5,10,0,5,1,1,1,1,6,1
KR_6741861722,420,-1,-59,-6,-1,-2,0,2,3,3,0,1,3,2,-5,1,6,2,3,1,1,0,-5,-6,6,0,1,0,1,1,1,1,-1,2,1
KR_6738680205,420,1,12,-36,3,0,2,2,3,3,0,-1,0,1,2,3,1,-1,3,4,0,-1,-5,0,3,3,3,0,0,1,-1,-1,-1,4,1
KR_6737096379,420,4,-34,10,8,0,3,3,-1,2,3,4,4,0,4,4,0,1,1,0,0,7,2,1,4,5,0,0,1,1,1,-1,1,6,1
KR_6695235003,420,2,15,33,0,2,2,0,2,3,1,-4,2,6,0,5,5,0,1,1,1,8,4,-3,4,1,6,0,1,1,0,1,1,5,1
KR_6539674449,420,3,33,17,6,3,5,2,-3,1,4,1,3,2,5,6,1,0,3,3,0,1,0,-1,4,3,1,0,0,-1,1,1,1,1,1
KR_6754300634,420,9,102,25,13,0,1,1,3,5,2,3,4,1,10,11,1,-3,0,3,-1,12,3,-1,6,5,3,0,1,1,-1,1,-1,1,1
KR_6726037895,420,2,-34,16,-3,-4,2,6,-1,2,3,1,2,1,-1,2,3,2,2,0,0,6,-285,-4,5,1,25,0,0,1,-1,-1,-1,2,1
KR_6714548052,420,1,34,23,8,-2,0,2,3,4,1,2,3,1,1,2,1,4,6,2,0,12,-26,3,4,7,1,0,1,1,1,1,1,4,1
KR_6709163333,420,0,57,-21,-2,-1,1,2,2,5,3,-3,0,3,0,2,2,0,1,1,0,1,-122,-1,7,6,-3,0,1,1,-1,1,-1,5,1
KR_6492050868,420,0,5,19,-3,-2,0,2,-3,1,4,4,4,0,-4,0,4,2,2,0,0,-3,6,4,2,6,1,0,1,1,1,1,1,5,1
KR_6764344469,420,0,59,16,1,1,3,2,0,4,4,1,7,6,0,3,3,-1,0,1,0,-7,7,4,1,5,-1,0,1,1,1,1,1,2,1
KR_6644624661,420,3,26,-14,2,0,3,3,-3,2,5,-2,1,3,3,6,3,4,4,0,0,4,-7,3,3,6,1,0,0,1,-1,1,-1,1,1
KR_6748373731,420,7,84,47,14,2,3,1,-1,3,4,5,9,4,8,8,0,0,0,0,0,0,0,-2,6,4,1,0,1,1,1,1,1,1,1
KR_6744505665,420,-1,17,7,-6,1,3,2,0,1,1,-2,2,4,-3,1,4,-2,0,2,-1,-11,0,-4,8,4,1,0,0,-1,0,1,-1,6,1
KR_6754445876,420,2,44,-13,5,2,3,1,3,5,2,2,4,2,0,3,3,-2,0,2,1,9,-19,2,5,7,3,0,0,-1,-1,0,1,6,1
KR_6629370840,420,1,39,22,-1,5,7,2,2,2,0,2,3,1,-12,1,13,2,3,1,0,-8,19,-1,5,4,2,0,-1,1,-1,-1,1,4,1
KR_6723978985,420,3,20,14,-3,2,2,0,-1,3,4,0,2,2,-2,3,5,-2,1,3,1,-2,-3,-1,8,7,-3,0,-1,1,-1,-1,1,6,1
KR_6743966821,420,3,5,-12,10,3,4,1,-1,0,1,4,5,1,2,4,2,2,2,0,0,17,6,1,7,8,2,0,2,1,-1,1,-1,1,1
KR_6737176651,420,2,7,4,5,0,4,4,0,1,1,0,2,2,4,5,1,1,1,0,0,12,42,0,2,2,-14,0,1,-1,1,1,1,4,1
KR_6624474194,420,0,12,-6,-1,6,7,1,-5,1,6,-1,2,3,-3,1,4,2,3,1,0,-7,4,-1,3,2,-4,0,0,-1,1,-1,-1,4,1
KR_6696551267,420,-2,-70,-26,-7,-2,1,3,-6,0,6,1,3,2,-2,1,3,2,4,2,0,-4,-104,0,3,3,2,0,-1,-1,-1,-1,-1,3,1
KR_6764442564,420,1,26,27,7,3,4,1,1,5,4,2,7,5,0,1,1,1,2,1,-1,3,14,-1,5,4,-1,0,-2,0,-1,1,-1,0,1
KR_6724309705,420,1,68,-12,-1,-1,2,3,-3,1,4,1,1,0,1,2,1,1,1,0,0,1,7,0,4,4,-1,0,1,0,-1,1,-1,0,1
KR_6399065257,420,1,-21,14,5,-1,2,3,0,3,3,5,6,1,0,3,3,1,4,3,0,6,1,-1,4,3,2,0,0,1,1,0,1,6,1
KR_6762820819,420,6,96,1,14,3,4,1,5,7,2,0,1,1,5,6,1,1,3,2,0,14,12,-2,9,7,9,0,1,-1,1,1,1,5,1
KR_6709073820,420,-1,-84,-34,6,-2,0,2,0,6,6,-1,1,2,6,8,2,3,3,0,0,11,-1,1,5,6,5,0,-1,1,1,-1,1,5,1
KR_6730197662,440,4,30,-1,7,2,3,1,2,4,2,5,8,3,3,4,1,-5,1,6,0,1,-6,-2,7,5,3,0,0,-1,1,1,-1,2,1
KR_6573626063,420,1,9,-11,6,3,3,0,2,4,2,-2,0,2,3,4,1,0,1,1,0,6,-1,4,6,10,1,0,0,1,-1,0,1,3,1
KR_6746312405,420,3,51,12,8,5,6,1,-2,2,4,3,4,1,0,0,0,2,2,0,0,5,-251,5,2,7,-7,0,0,1,-1,1,1,6,1
KR_6752210710,420,2,22,6,8,-1,1,2,5,7,2,-1,2,3,4,4,0,1,2,1,0,9,7,1,3,4,-3,0,0,1,-1,0,1,3,1
KR_6752742716,420,3,14,4,9,0,1,1,-2,3,5,5,8,3,4,4,0,2,2,0,0,13,-243,2,3,5,2,0,2,1,1,1,1,3,1
KR_6657354875,440,1,86,7,-3,0,3,3,-1,1,2,1,3,2,-2,1,3,-1,2,3,-1,-13,-9,-2,3,1,2,0,1,1,1,1,-1,5,1
KR_6749435131,420,-2,-8,0,-9,0,1,1,0,3,3,-2,1,3,-5,2,7,-2,0,2,1,-11,-2,-4,5,1,-3,0,0,-1,-1,0,1,4,1
KR_6759972729,440,4,64,2,1,2,2,0,-3,1,4,0,2,2,1,2,1,1,1,0,-2,0,-27,1,2,3,-7,0,-1,1,-1,-1,-1,6,1
KR_6684882147,420,4,67,19,8,3,6,3,-1,1,2,4,6,2,0,6,6,2,2,0,0,0,-118,-1,2,1,1,0,1,-1,1,1,1,3,1
KR_6538296281,420,1,-26,-1,-2,-1,0,1,-1,0,1,-4,3,7,5,9,4,-1,0,1,0,2,-31,1,4,5,-1,0,-1,1,-1,-1,-1,5,1
KR_6732118368,420,4,86,-17,8,0,4,4,4,5,1,2,3,1,1,5,4,1,2,1,-1,12,2,-5,6,1,1,0,1,1,1,1,-1,4,1
KR_6655268097,420,-2,-81,-34,-1,5,6,1,-1,3,4,-3,0,3,-3,4,7,1,2,1,0,12,5,5,1,6,-3,0,0,0,0,-1,-1,0,1
KR_6738545439,420,1,-10,44,0,-1,1,2,0,2,2,1,3,2,-2,3,5,2,4,2,0,-5,3,1,3,4,4,0,1,-1,0,1,1,6,1
KR_6762359627,420,0,-35,8,0,-3,0,3,1,4,3,1,4,3,0,0,0,1,1,0,0,1,5,2,3,5,-3,0,0,1,1,-1,-1,5,1
KR_6494740628,420,1,76,-16,8,-1,0,1,5,6,1,0,0,0,4,5,1,0,1,1,0,13,58,1,5,6,-2,0,1,-1,-1,1,1,2,1
KR_6753275331,420,1,-49,-12,10,2,4,2,2,2,0,6,9,3,-1,0,1,1,2,1,0,5,16,-2,3,1,6,0,0,-1,1,0,1,2,1
KR_6578483852,420,0,23,-17,-4,3,5,2,-5,2,7,1,4,3,-2,1,3,-1,1,2,0,-8,2,-1,10,9,2,0,1,-1,-1,1,1,6,1
KR_6750992564,420,4,111,32,8,2,2,0,1,3,2,1,4,3,4,5,1,0,2,2,0,7,34,5,1,6,-23,0,1,1,1,1,1,2,1
KR_6473478439,420,2,2,8,4,0,0,0,-1,0,1,2,4,2,2,2,0,1,1,0,0,7,-10,4,2,6,-3,0,1,1,1,1,1,4,1
KR_6763116390,420,-3,-12,-4,-9,-2,0,2,3,3,0,-4,7,11,-1,1,2,-5,0,5,0,-9,-4,-3,5,2,-2,0,0,-1,1,-1,-1,2,1
KR_6749360928,440,6,26,-12,17,4,4,0,1,1,0,7,7,0,3,4,1,2,2,0,1,20,5,5,0,5,-3,0,0,1,-1,0,1,5,1
KR_6715002785,440,3,14,12,7,-1,0,1,1,5,4,4,4,0,1,1,0,2,2,0,0,7,-19,-2,4,2,2,0,0,1,-1,-1,1,3,1
KR_6682620532,420,5,94,8,3,1,4,3,-3,0,3,0,2,2,5,5,0,0,1,1,0,3,2,-1,4,3,2,0,2,1,-1,1,-1,5,1
KR_6719002400,420,0,-21,-1,3,2,3,1,0,3,3,1,5,4,-2,2,4,2,2,0,0,3,0,-1,5,4,2,0,2,1,1,1,-1,5,1
KR_6764052702,420,3,44,18,3,-2,2,4,0,3,3,7,7,0,-1,0,1,-1,1,2,1,-2,250,-2,6,4,1,0,0,1,1,-1,1,2,1
KR_6739649165,440,5,16,9,12,4,4,0,7,9,2,5,6,1,-2,0,2,-2,2,4,0,1,21,-1,3,2,1,0,1,1,1,1,1,4,1
KR_6471289139,420,-2,-48,10,0,-2,0,2,7,7,0,-3,1,4,-2,2,4,0,1,1,0,3,-6,-4,6,2,5,0,1,1,-1,1,1,1,1
KR_6750963524,420,6,129,44,11,0,0,0,6,6,0,0,2,2,1,1,0,4,4,0,0,17,19,3,0,3,0,0,1,1,1,1,-1,2,1
KR_6455491884,420,5,22,44,3,2,4,2,4,7,3,-5,2,7,4,5,1,-2,2,4,1,1,0,-1,5,4,4,0,1,1,1,1,1,2,1
KR_6752520295,420,-2,-32,-19,-9,2,3,1,-2,0,2,-3,3,6,-2,1,3,-4,0,4,0,-14,-32,-5,9,4,2,0,0,-1,0,-1,-1,4,1
KR_6752066316,420,3,-5,33,-1,2,3,1,-3,1,4,0,0,0,0,3,3,0,1,1,0,-5,2,2,7,9,0,0,0,0,-1,0,1,0,1
KR_6738569713,420,2,66,28,3,2,2,0,-3,4,7,2,2,0,0,2,2,2,2,0,0,2,533,1,3,4,-1,0,0,1,-1,1,1,6,1
KR_6747985758,420,6,67,43,9,3,4,1,3,5,2,0,4,4,1,3,2,2,2,0,0,2,-8,-5,7,2,3,0,2,1,1,1,-1,3,1
KR_6678538760,420,3,40,23,8,0,1,1,7,8,1,2,3,1,-2,3,5,1,2,1,0,5,-29,3,3,6,-1,0,0,1,1,0,1,6,1
KR_6763584672,420,9,81,56,23,5,5,0,2,3,1,13,13,0,2,3,1,1,1,0,0,14,282,5,2,7,1,0,4,1,1,1,1,2,1
KR_6608183849,420,4,-6,-12,8,1,2,1,-2,2,4,6,7,1,2,4,2,1,1,0,0,5,2,3,6,9,-1,0,0,1,-1,-1,-1,2,1
KR_6754906128,420,0,-17,8,-2,1,6,5,0,1,1,-1,1,2,-2,0,2,0,2,2,0,-1,-29,-2,5,3,-5,0,1,-1,1,1,-1,1,1
KR_6755185566,420,3,33,-1,7,5,5,0,-3,1,4,2,2,0,4,6,2,-1,0,1,0,0,6,2,3,5,2,0,0,1,1,0,1,6,1
KR_6609973242,420,2,11,13,3,-1,2,3,-4,1,5,-1,1,2,8,8,0,1,1,0,0,12,22,1,4,5,1,0,2,1,1,1,-1,1,1
KR_6742179684,420,4,120,4,6,3,4,1,1,5,4,1,4,3,3,5,2,-2,0,2,0,5,0,2,2,4,1,0,3,1,1,1,-1,3,1
KR_6674707133,420,4,5,28,13,8,8,0,4,6,2,4,5,1,-3,4,7,0,2,2,1,6,9,0,4,4,1,0,0,-1,1,1,1,4,1
KR_6619048644,420,4,21,12,11,5,5,0,0,2,2,3,3,0,1,1,0,2,2,0,0,8,1,-4,8,4,-2,0,1,0,0,1,-1,0,1
KR_6661490178,420,2,-3,23,10,1,2,1,4,6,2,6,7,1,-1,1,2,0,0,0,0,10,-167,-1,5,4,2,0,0,-1,1,0,1,3,1
KR_6506313122,420,2,41,-24,8,1,2,1,-2,1,3,8,8,0,1,4,3,0,0,0,0,6,-15,-5,8,3,3,0,0,1,-1,0,1,6,1
KR_6582879767,420,2,14,-20,9,1,2,1,-1,2,3,3,3,0,3,3,0,3,3,0,0,16,7,2,5,7,1,0,2,1,-1,1,-1,3,1
KR_6654045045,420,0,55,-12,3,0,1,1,4,8,4,-1,0,1,2,4,2,-2,0,2,1,6,-21,-1,5,4,0,0,0,1,-1,-1,1,1,1
KR_6570458233,420,2,69,10,7,1,1,0,0,3,3,3,3,0,2,3,1,1,1,0,0,8,5,0,6,6,1,0,1,1,1,1,1,5,1
KR_6764690739,420,1,-30,23,7,-3,1,4,5,8,3,2,4,2,1,5,4,2,3,1,2,0,-4,-1,3,2,0,0,0,1,1,-1,1,2,1
KR_6761566692,420,1,21,0,-1,2,2,0,-1,3,4,1,4,3,-3,3,6,0,3,3,0,-6,11,0,5,5,1,0,0,-1,1,1,-1,1,1
KR_6683981561,420,-1,29,20,0,-1,4,5,0,3,3,-1,1,2,3,3,0,-1,0,1,0,2,9,1,1,2,1,0,1,1,0,1,1,4,1
KR_6761719880,420,2,10,-3,16,1,3,2,3,6,3,10,10,0,1,3,2,1,2,1,0,16,29,0,4,4,-1,0,0,1,1,1,1,5,1
KR_6658241830,420,0,7,1,0,-1,2,3,1,3,2,-1,0,1,2,5,3,-1,1,2,0,2,-20,-2,6,4,-5,0,-1,1,1,-1,1,5,1
KR_6708250825,420,-2,-21,-3,-2,1,2,1,-1,3,4,2,6,4,-4,2,6,0,0,0,0,0,1,5,1,6,-3,0,2,-1,1,1,-1,2,1
KR_6750271819,420,-1,48,-15,-4,2,4,2,-1,2,3,0,2,2,1,3,2,-6,1,7,0,-6,0,0,2,2,2,0,1,-1,1,1,-1,1,1
KR_6715997736,420,3,-9,29,7,0,2,2,2,2,0,4,4,0,1,3,2,0,0,0,0,3,46,-1,9,8,-31,0,0,1,-1,0,1,3,1
KR_6757783323,420,2,35,28,2,1,3,2,0,2,2,1,2,1,-5,1,6,5,6,1,0,4,56,3,2,5,-17,0,1,1,1,1,1,3,1
KR_6759318833,420,-1,55,-5,0,0,0,0,1,2,1,2,4,2,-3,1,4,0,1,1,0,-4,-2,5,1,6,-4,0,0,1,1,0,1,2,1
KR_6762576335,420,0,32,8,2,2,3,1,2,5,3,4,4,0,-5,2,7,-1,1,2,0,-2,-212,0,8,8,-3,0,0,0,-1,-1,1,0,1
KR_6710112718,420,1,72,-15,5,1,3,2,1,3,2,4,7,3,-2,0,2,1,3,2,0,1,-1,2,4,6,-3,0,4,1,1,1,1,1,1
KR_6756160992,420,0,29,12,5,-4,2,6,2,3,1,3,6,3,2,5,3,2,3,1,0,1,6,0,3,3,-5,0,2,1,1,1,1,2,1
KR_6759914495,440,1,4,-9,-5,2,3,1,1,1,0,0,2,2,-4,2,6,-4,0,4,0,-9,-4,-3,6,3,1,0,-1,-1,1,-1,-1,6,1
KR_6740802931,420,4,45,-13,8,1,2,1,3,4,1,3,6,3,1,2,1,0,2,2,0,11,44,2,3,5,-1,0,0,1,0,1,1,2,1
KR_6619485589,440,2,-18,-5,5,5,6,1,-1,2,3,-4,2,6,3,5,2,2,4,2,0,3,1,-1,5,4,4,0,2,-1,1,1,1,2,1
KR_6695616414,420,1,26,-4,6,1,1,0,1,5,4,-3,4,7,3,4,1,4,5,1,0,13,-5,-6,6,0,-3,0,1,1,-1,1,-1,6,1
KR_6112362628,420,3,28,22,4,-2,1,3,2,5,3,2,5,3,2,2,0,0,1,1,0,0,-16,-2,5,3,-1,0,0,-1,-1,0,-1,5,1
KR_6702934881,420,-1,34,-43,0,3,3,0,-1,1,2,1,3,2,-3,1,4,0,1,1,0,-2,-4,0,4,4,3,0,2,0,1,1,1,0,1
KR_6738712025,420,5,69,12,13,4,5,1,-5,0,5,3,3,0,6,6,0,5,5,0,-1,7,11,0,2,2,0,0,1,1,-1,1,-1,1,1
KR_6733232702,420,3,-9,32,9,-1,0,1,4,5,1,2,5,3,3,5,2,1,1,0,2,9,-109,1,4,5,-4,0,1,1,1,1,1,6,1
KR_6745155502,420,1,1,-8,5,-2,0,2,3,7,4,-2,0,2,5,6,1,1,3,2,0,10,-127,-1,8,7,-5,0,1,0,1,1,1,0,1
KR_6545715797,420,3,65,8,5,4,5,1,2,7,5,0,4,4,-2,1,3,1,1,0,-2,-2,3,1,2,3,4,0,2,1,1,1,-1,3,1
KR_6674184080,420,-1,24,-24,1,3,3,0,-1,3,4,1,2,1,-2,2,4,0,1,1,0,3,6,4,5,9,-4,0,0,-1,-1,-1,-1,1,1
KR_6651222863,420,-1,-9,-22,10,-2,0,2,7,8,1,-2,1,3,6,7,1,1,1,0,0,20,7,2,4,6,1,0,0,1,1,1,-1,3,1
KR_6764327605,420,-1,25,28,3,2,3,1,1,4,3,-1,1,2,1,5,4,0,1,1,0,4,1,-2,4,2,0,0,0,1,-1,0,1,1,1
KR_6754313545,420,4,-22,29,12,1,3,2,6,8,2,2,3,1,3,3,0,0,1,1,0,12,-301,0,4,4,0,0,1,1,-1,1,1,2,1
KR_6761862752,420,4,33,28,5,5,6,1,-1,2,3,6,8,2,-4,0,4,-1,2,3,0,-1,-20,1,4,5,2,0,1,-1,1,1,-1,1,1
KR_6764038599,420,-1,-21,-25,7,0,0,0,1,3,2,-2,1,3,5,5,0,3,5,2,1,8,4,-2,4,2,7,0,1,1,-1,1,1,4,1
KR_6718156256,440,5,62,8,13,1,1,0,0,2,2,4,5,1,5,5,0,3,5,2,1,10,1,-1,4,3,0,0,0,0,-1,0,-1,0,1
KR_6713663324,420,-1,73,-8,-1,-5,1,6,-2,0,2,1,3,2,4,5,1,1,2,1,0,8,-2,2,3,5,-1,0,-1,1,-1,-1,1,2,1
KR_6736398815,420,2,50,16,4,-1,3,4,3,4,1,2,3,1,-1,3,4,1,2,1,0,0,14,-2,6,4,2,0,0,1,-1,0,1,5,1
KR_6761801239,420,3,71,-12,-2,3,4,1,-2,1,3,-5,0,5,1,1,0,1,2,1,0,-6,12,1,3,4,-4,0,1,-1,1,1,1,5,1
KR_6664061674,420,4,35,56,14,3,4,1,1,2,1,4,6,2,2,6,4,4,5,1,3,12,5,-2,3,1,1,0,1,1,1,1,1,5,1
KR_6761371997,420,3,62,0,1,-1,3,4,1,3,2,0,3,3,1,4,3,0,0,0,0,-1,0,2,4,6,-1,0,0,0,-1,1,-1,0,1
KR_6669075967,420,-2,55,-8,1,-6,0,6,2,3,1,5,5,0,1,6,5,-1,0,1,1,0,35,1,5,6,-5,0,1,-1,-1,-1,1,3,1
KR_6723118141,440,4,103,42,9,3,3,0,2,6,4,5,5,0,-1,3,4,0,0,0,0,-2,13,-2,6,4,1,0,3,1,-1,1,-1,3,1
KR_6751285592,420,0,-14,3,8,-1,1,2,1,1,0,6,7,1,3,4,1,-1,0,1,0,6,-5,1,6,7,6,0,-1,0,1,-1,1,0,1
KR_6235240365,420,1,73,-24,-2,3,3,0,-10,1,11,2,3,1,3,5,2,0,1,1,1,-5,-261,-2,4,2,0,0,1,1,1,1,1,1,1
KR_6703310559,420,5,75,15,12,0,2,2,1,3,2,-1,2,3,8,9,1,4,4,0,1,10,-8,-3,5,2,3,0,1,1,1,1,1,6,1
KR_6752484560,420,1,-9,-12,4,-6,1,7,6,7,1,4,5,1,0,0,0,0,0,0,0,5,-5,0,2,2,-1,0,-1,-1,0,-1,1,1,1
KR_6760451259,420,6,33,31,8,4,4,0,2,5,3,1,3,2,1,4,3,0,0,0,1,-3,3,6,4,10,2,0,2,1,-1,1,1,4,1
KR_6760756644,420,-2,-5,16,-1,-3,1,4,1,3,2,2,5,3,-1,4,5,0,0,0,-2,-8,15,3,5,8,-1,0,0,1,1,1,-1,2,1
KR_6734019484,420,1,-17,4,-2,-1,2,3,-1,1,2,0,4,4,-1,4,5,1,1,0,0,-10,368,-4,5,1,3,0,-1,-1,1,1,1,1,1
KR_6760964492,420,1,36,28,1,0,2,2,0,2,2,-1,2,3,1,2,1,1,1,0,0,2,-19,-2,8,6,2,0,0,1,-1,0,1,5,1
KR_6591845750,420,0,29,-2,-3,-2,0,2,-1,1,2,-3,1,4,3,3,0,0,1,1,0,0,-6,-2,5,3,0,0,0,1,0,0,-1,2,1
KR_6699544311,420,1,17,-30,1,3,4,1,-6,0,6,4,5,1,0,3,3,0,0,0,0,0,1,5,4,9,2,0,0,0,1,0,-1,0,1
KR_6740415381,420,3,-5,22,13,0,2,2,7,8,1,4,5,1,2,3,1,0,1,1,0,12,2,2,2,4,-2,0,0,1,0,0,1,5,1
KR_6731114082,420,0,-90,44,-7,2,2,0,-7,0,7,-4,0,4,3,5,2,-1,0,1,0,-9,-17,0,5,5,-6,0,0,-1,1,1,-1,3,1
KR_6740126705,420,1,11,-43,6,1,2,1,-4,4,8,1,1,0,8,8,0,0,1,1,0,5,0,3,3,6,-2,0,0,-1,1,-1,1,3,1
KR_6679360985,440,4,20,33,12,2,2,0,1,2,1,-1,1,2,8,8,0,2,3,1,0,11,9,3,2,5,-1,0,1,1,1,1,1,1,1
KR_6729292142,420,4,30,8,8,5,6,1,4,7,3,2,4,2,-1,1,2,-2,0,2,0,6,2,5,3,8,-3,0,1,1,-1,1,1,2,1
KR_6592776336,420,3,27,12,6,1,3,2,4,5,1,2,2,0,0,1,1,-1,0,1,0,7,-218,4,2,6,5,0,0,1,-1,0,1,4,1
KR_6753337443,420,1,74,-24,14,0,2,2,4,5,1,1,1,0,6,8,2,3,3,0,0,10,2,-1,4,3,0,0,2,1,1,1,1,5,1
KR_6741269627,420,1,14,-18,1,1,2,1,3,6,3,0,2,2,-3,4,7,0,1,1,0,2,1,0,4,4,1,0,0,0,1,-1,1,0,1
KR_6695115838,420,4,37,23,13,4,7,3,6,6,0,-1,2,3,4,6,2,0,2,2,0,8,277,3,1,4,0,0,1,1,1,1,1,4,1
KR_6703011180,420,4,-15,13,6,1,3,2,0,4,4,5,8,3,-2,2,4,2,2,0,-2,10,-5,-4,8,4,-1,0,0,1,-1,0,-1,1,1
KR_6587838273,420,3,23,-7,4,2,2,0,0,3,3,-1,2,3,3,8,5,0,0,0,0,6,-28,-1,6,5,15,0,0,-1,-1,0,1,1,1
KR_6752270441,420,-1,-60,-12,-2,-5,2,7,6,6,0,-6,1,7,4,7,3,-1,0,1,0,2,-167,0,3,3,22,0,-1,1,1,-1,1,5,1
KR_6756617966,420,3,8,16,7,1,3,2,0,1,1,2,3,1,4,4,0,0,1,1,0,0,0,-1,6,5,1,0,-1,1,-1,-1,1,2,1
KR_6425201898,420,3,92,0,5,-2,1,3,-1,3,4,0,2,2,7,8,1,1,3,2,1,7,-208,0,6,6,0,0,1,1,-1,1,1,2,1
KR_6645707033,440,2,111,13,6,0,0,0,0,0,0,1,1,0,3,10,7,2,3,1,0,11,12,-7,8,1,-1,0,2,1,0,1,-1,5,1
KR_6710218294,420,2,-11,0,1,2,3,1,5,8,3,-5,0,5,-1,4,5,0,0,0,0,8,4,0,5,5,0,0,1,1,1,1,1,1,1
KR_6762045741,420,2,52,29,2,-5,0,5,3,4,1,3,3,0,-4,0,4,5,5,0,0,-4,0,2,2,4,6,0,1,1,-1,-1,1,4,1
KR_6730054064,420,1,-20,15,6,0,1,1,3,3,0,1,3,2,3,6,3,-1,0,1,0,9,-34,3,4,7,3,0,-1,1,1,-1,-1,4,1
KR_6760570456,440,0,10,0,-4,4,4,0,1,2,1,-4,0,4,-5,0,5,0,1,1,0,-6,-11,-2,7,5,-4,0,1,-1,1,1,1,5,1
KR_6740402998,420,0,21,24,3,0,1,1,1,2,1,-2,0,2,3,6,3,1,1,0,0,4,-19,2,2,4,-2,0,1,1,0,1,1,2,1
KR_6724387651,420,7,56,44,9,4,5,1,2,4,2,2,5,3,0,2,2,1,2,1,0,5,-1,4,1,5,-1,0,1,1,1,1,1,3,1
KR_6471763252,420,4,29,37,12,2,2,0,4,4,0,1,2,1,3,5,2,2,3,1,1,17,5,0,6,6,3,0,3,1,1,1,1,6,1
KR_6663972838,420,0,41,-42,-2,0,1,1,0,4,4,2,5,3,-2,5,7,-2,0,2,0,7,5,2,3,5,-1,0,0,-1,-1,-1,1,5,1
KR_6751539320,420,4,67,4,11,4,6,2,0,2,2,4,5,1,2,3,1,1,1,0,0,7,0,2,3,5,-1,0,0,1,-1,1,-1,3,1
KR_6741478889,440,3,10,0,11,0,1,1,3,3,0,8,8,0,0,1,1,0,0,0,0,16,-7,-2,7,5,3,0,0,1,-1,0,1,5,1
KR_6759179889,420,0,29,9,0,-1,2,3,0,2,2,3,3,0,-2,5,7,0,0,0,-1,0,-5,-4,5,1,3,0,-1,-1,-1,-1,-1,4,1
KR_6751198700,420,1,15,4,2,0,2,2,1,3,2,2,4,2,-1,4,5,0,2,2,0,-3,-27,1,4,5,2,0,0,1,-1,0,-1,5,1
KR_6579825579,420,11,78,46,16,-3,1,4,2,3,1,0,3,3,14,14,0,3,3,0,2,22,-4,-1,9,8,6,0,3,-1,-1,1,1,2,1
KR_6728452802,420,4,72,-16,-1,3,3,0,2,4,2,-2,2,4,1,3,2,-5,0,5,0,-1,32,-1,6,5,-30,0,-1,1,-1,1,-1,6,1
KR_6633245126,420,1,115,-4,3,1,2,1,-1,2,3,0,2,2,1,7,6,2,3,1,2,11,27,3,5,8,-28,0,2,1,1,1,1,3,1
KR_6738263182,420,4,15,16,4,0,0,0,1,5,4,4,4,0,-1,2,3,0,0,0,0,6,4,4,1,5,0,0,0,-1,1,0,-1,1,1
KR_6752647024,420,1,-7,15,10,2,4,2,0,0,0,6,7,1,2,3,1,0,1,1,1,8,-4,-3,8,5,7,0,0,1,1,0,1,5,1
KR_6725800135,420,6,30,4,13,1,3,2,5,5,0,2,3,1,5,5,0,0,0,0,0,16,-53,-1,4,3,20,0,2,1,-1,1,1,1,1
KR_6302118526,420,0,-21,33,-3,0,1,1,-2,1,3,-2,3,5,0,3,3,1,1,0,0,-7,-8,-5,9,4,2,0,0,1,-1,-1,1,5,1
KR_6153626368,420,-2,3,39,0,-3,3,6,1,5,4,-1,1,2,2,5,3,1,1,0,0,6,-7,-1,8,7,4,0,0,1,-1,-1,1,1,1
KR_6531413150,420,1,-43,20,3,-4,1,5,3,3,0,2,3,1,2,4,2,0,0,0,0,6,-5,0,4,4,-5,0,0,1,-1,0,-1,6,1
KR_6738336874,420,3,12,-12,11,0,1,1,1,5,4,4,5,1,4,7,3,2,2,0,0,9,-22,0,4,4,1,0,1,1,-1,1,1,6,1
KR_6722355979,420,2,-32,10,6,1,2,1,5,7,2,1,3,2,2,7,5,-3,0,3,0,4,8,3,3,6,-7,0,1,1,1,1,-1,3,1
KR_6741812698,420,-1,34,-16,-2,-2,0,2,-1,3,4,3,5,2,0,3,3,-2,0,2,0,-7,0,4,4,8,-3,0,0,1,1,1,1,6,1
KR_6722189974,420,0,-8,-11,-8,-3,2,5,5,8,3,-1,3,4,-7,3,10,-2,0,2,0,-3,-2,2,5,7,2,0,0,0,0,-1,-1,0,1
KR_6743866482,420,2,37,8,2,-2,3,5,-1,5,6,5,10,5,-1,1,2,1,1,0,-1,-2,127,1,5,6,1,0,0,1,0,1,-1,5,1
KR_6699890034,420,5,44,24,13,-1,3,4,3,3,0,10,10,0,0,2,2,1,1,0,0,5,10,4,1,5,-3,0,1,1,1,1,1,5,1
KR_6764709445,420,6,94,27,16,3,4,1,6,7,1,-2,1,3,6,7,1,3,4,1,3,11,10,5,2,7,-1,0,3,-1,1,1,1,3,1
KR_6748356122,420,3,83,22,4,1,1,0,0,2,2,1,4,3,2,4,2,0,0,0,0,0,-20,-1,8,7,10,0,2,1,1,1,-1,4,1
KR_6747425753,420,3,12,28,8,4,5,1,-2,4,6,2,3,1,4,6,2,0,2,2,0,2,-8,1,4,5,0,0,1,-1,1,1,1,1,1
KR_6763531901,420,1,29,24,10,0,0,0,-2,2,4,5,5,0,3,5,2,4,4,0,0,12,130,-3,7,4,0,0,0,1,1,0,1,6,1
KR_6763713874,420,0,11,16,-4,-4,0,4,2,7,5,1,4,3,-3,1,4,0,2,2,0,-13,0,2,4,6,-4,0,2,-1,1,1,-1,5,1
KR_6494196419,420,0,-54,12,4,0,1,1,1,4,3,-3,2,5,6,6,0,0,1,1,0,11,9,6,2,8,-6,0,1,1,1,1,1,2,1
KR_6723641032,440,2,27,8,8,6,7,1,-4,2,6,-1,0,1,7,7,0,0,0,0,-1,13,33,1,4,5,6,0,2,-1,1,1,-1,3,1
KR_6654700670,420,-1,35,4,2,2,4,2,5,6,1,2,2,0,-5,0,5,-2,2,4,0,1,-2,2,4,6,1,0,-1,1,-1,-1,1,3,1
KR_6292813191,420,0,9,6,0,2,2,0,2,6,4,-1,2,3,-2,5,7,-1,0,1,1,2,-133,-3,4,1,0,0,-1,1,0,-1,1,2,1
KR_6734640225,420,3,122,12,4,1,2,1,0,2,2,2,5,3,2,5,3,-1,1,2,1,6,-22,-5,7,2,4,0,2,-1,1,1,1,2,1
KR_6760565064,420,6,39,65,4,-1,2,3,3,4,1,4,4,0,-3,0,3,1,3,2,0,-3,2,3,2,5,0,0,1,1,-1,1,-1,4,1
KR_6674031576,420,1,72,-2,7,5,5,0,0,2,2,6,8,2,-3,2,5,-1,0,1,0,5,-10,0,4,4,4,0,1,-1,1,1,-1,4,1
KR_6753790708,420,1,40,9,9,-5,0,5,4,4,0,8,8,0,7,7,0,-5,0,5,0,5,4,2,1,3,0,0,3,0,1,1,1,0,1
KR_6418297517,420,2,57,-32,1,-2,1,3,-1,2,3,1,2,1,3,3,0,0,2,2,-1,0,7,-6,11,5,-20,0,0,1,-1,0,-1,6,1
KR_6724676153,420,1,1,12,8,4,4,0,-2,2,4,2,3,1,1,4,3,3,3,0,1,9,3,0,7,7,-1,0,0,1,1,0,1,3,1
KR_6453796095,420,-4,37,-52,-8,0,0,0,-4,0,4,4,4,0,-8,0,8,0,0,0,0,-11,-20,0,2,2,-2,0,1,-1,1,1,-1,6,1
KR_6700867106,420,0,4,0,0,-3,0,3,3,5,2,4,4,0,-4,3,7,0,0,0,0,1,4,4,2,6,-3,0,-1,1,-1,-1,1,4,1
KR_6753974360,420,-1,-33,-10,-10,1,1,0,1,3,2,-3,3,6,-7,2,9,-2,0,2,0,-6,13,0,4,4,-3,0,0,1,0,0,-1,4,1
KR_6689682086,420,1,0,28,5,-2,0,2,1,3,2,0,2,2,3,5,2,3,3,0,0,9,-3,0,5,5,5,0,0,1,1,1,1,4,1
KR_6672752477,420,1,17,-24,9,3,4,1,4,5,1,-1,3,4,3,3,0,0,1,1,0,12,11,7,0,7,-1,0,1,1,-1,1,-1,5,1
KR_6742928716,420,-2,-44,-31,-2,-3,1,4,0,5,5,0,1,1,0,1,1,1,1,0,0,8,-17,5,4,9,1,0,0,1,-1,-1,-1,5,1
KR_6763267029,420,1,114,-29,6,1,7,6,3,4,1,1,3,2,-1,0,1,2,3,1,0,11,-11,-3,5,2,-1,0,2,-1,1,1,1,3,1
KR_6751373340,440,2,10,-4,8,0,2,2,5,5,0,1,2,1,1,3,2,1,1,0,1,14,7,4,5,9,-3,0,0,1,-1,0,1,2,1
KR_6678122600,440,8,103,23,13,1,3,2,1,3,2,-2,2,4,12,14,2,1,1,0,0,6,-18,-3,5,2,4,0,1,1,0,1,1,3,1
KR_6719476482,420,1,23,36,0,0,1,1,0,1,1,-2,0,2,2,3,1,0,0,0,0,1,19,-1,5,4,1,0,0,-1,-1,-1,-1,1,1
KR_6700765282,420,4,31,16,7,3,3,0,1,4,3,3,4,1,0,1,1,0,2,2,0,0,5,-2,5,3,-3,0,0,1,1,0,1,6,1
KR_6572973827,420,4,109,9,10,4,5,1,5,7,2,2,3,1,-1,2,3,0,2,2,0,7,-1,1,6,7,-2,0,2,1,1,1,1,5,1
KR_6737764393,420,1,45,8,-2,9,10,1,-4,1,5,-2,3,5,-2,0,2,-3,0,3,-1,-10,-13,-3,5,2,-2,0,-2,-1,1,1,1,6,1
KR_6750706601,420,-3,28,-48,3,1,3,2,1,1,0,-2,1,3,-1,3,4,4,5,1,0,4,-34,0,4,4,2,0,0,1,1,1,1,1,1
KR_6713467641,420,0,-27,43,-2,1,2,1,-2,7,9,-1,1,2,-3,2,5,3,3,0,0,-3,-3,-1,6,5,0,0,0,-1,1,0,-1,5,1
KR_6691293829,420,6,97,27,19,3,4,1,8,8,0,4,4,0,4,7,3,0,2,2,0,14,-181,4,2,6,0,0,4,1,1,1,-1,2,1
KR_6675217725,420,2,-17,-13,7,2,2,0,-1,1,2,-3,3,6,7,8,1,2,2,0,0,9,2,-3,6,3,3,0,1,1,-1,-1,1,6,1
KR_6651494109,420,1,44,2,7,-2,0,2,1,2,1,3,4,1,3,5,2,2,2,0,1,8,26,-1,6,5,4,0,1,1,-1,1,1,2,1
KR_6761739638,420,2,59,16,5,1,1,0,0,1,1,3,4,1,1,3,2,0,0,0,0,2,-6,-6,10,4,1,0,2,1,1,1,1,1,1
KR_6608411663,420,6,85,-7,11,5,5,0,-1,3,4,2,4,2,2,6,4,3,7,4,0,5,1,3,6,9,0,0,2,1,1,1,-1,3,1
KR_6667784847,420,1,6,-24,5,2,3,1,-1,2,3,-1,1,2,4,4,0,1,1,0,0,10,-2,1,3,4,2,0,0,1,-1,-1,1,2,1
KR_6684534220,420,5,24,32,13,1,2,1,5,5,0,4,6,2,-1,1,2,4,5,1,0,11,8,2,3,5,1,0,0,1,-1,1,1,4,1
KR_6603928260,420,1,-2,11,-1,-1,0,1,-1,5,6,-3,2,5,3,5,2,1,1,0,0,1,34,1,3,4,0,0,0,0,1,0,1,0,1
KR_6666352661,420,4,49,20,11,2,4,2,2,2,0,4,5,1,3,3,0,0,1,1,0,10,8,2,3,5,1,0,2,-1,1,1,1,6,1
KR_6762410493,420,5,-54,5,3,-2,0,2,5,9,4,-1,5,6,2,3,1,-1,0,1,0,12,27,0,5,5,3,0,1,-1,-1,-1,-1,1,1
KR_6570739298,420,5,9,35,11,-1,4,5,1,5,4,2,2,0,10,12,2,-1,0,1,0,10,23,-3,6,3,-2,0,-1,-1,-1,-1,-1,6,1
KR_6700786774,420,2,65,-20,-8,1,6,5,-3,2,5,-6,1,7,0,0,0,0,1,1,0,-10,-122,-2,4,2,1,0,1,1,0,1,-1,3,1
KR_6744248581,420,-2,44,-16,-1,2,2,0,-11,0,11,-4,1,5,5,5,0,7,7,0,1,2,-31,-5,10,5,2,0,1,1,0,1,1,2,1
KR_6759942773,440,1,49,-19,1,4,6,2,-4,0,4,2,5,3,1,7,6,-2,1,3,1,-3,38,-4,6,2,3,0,2,-1,1,1,1,3,1
KR_6759459050,420,-1,-14,-16,-5,-1,0,1,-1,2,3,-2,2,4,2,5,3,-3,2,5,-2,-7,-1,-1,6,5,-4,0,0,-1,-1,0,-1,2,1
KR_6759797028,420,4,-47,-12,15,2,4,2,6,8,2,1,2,1,0,3,3,6,6,0,1,12,-19,-4,7,3,3,0,2,1,1,1,1,3,1
KR_6686623865,420,-4,-29,-8,-8,0,0,0,-2,4,6,-1,1,2,-5,1,6,0,2,2,0,-12,117,-3,5,2,2,0,-1,1,1,-1,-1,4,1
KR_6744904805,420,2,28,-21,9,-1,0,1,0,0,0,2,3,1,5,6,1,3,4,1,0,18,155,-1,4,3,1,0,2,1,1,1,1,5,1
KR_6756841580,420,-1,-62,-8,3,2,2,0,-3,1,4,2,4,2,2,4,2,0,3,3,1,3,-6,0,4,4,2,0,0,-1,1,0,1,3,1
KR_6715892692,420,2,21,7,4,1,4,3,-1,5,6,7,7,0,-7,0,7,4,4,0,0,-2,-118,-3,7,4,1,0,1,1,1,1,1,3,1
KR_6763312652,440,2,-12,-4,4,4,4,0,1,5,4,0,1,1,-1,3,4,0,1,1,0,-1,13,0,4,4,-3,0,-1,-1,-1,-1,-1,1,1
KR_6764288099,420,1,-11,15,0,-1,1,2,-2,2,4,1,1,0,2,2,0,0,2,2,0,-2,-2,-5,11,6,-1,0,1,1,1,1,1,4,1
KR_6630288007,420,2,51,-55,11,2,4,2,4,8,4,6,6,0,0,2,2,-1,4,5,1,11,18,5,7,12,6,0,2,-1,-1,1,1,2,1
KR_6753080942,420,1,5,52,4,1,2,1,-1,4,5,3,6,3,0,3,3,1,2,1,0,3,2,1,4,5,-1,0,1,1,1,1,1,3,1
KR_6711864972,420,-1,9,-4,0,3,3,0,-5,1,6,2,3,1,-1,1,2,1,4,3,-1,-5,7,-1,4,3,2,0,0,1,1,1,-1,3,1
KR_6743117468,420,5,99,-20,14,2,2,0,0,3,3,9,10,1,5,8,3,-2,1,3,0,10,10,0,6,6,-2,0,0,0,0,1,-1,0,1
KR_6764373935,420,-2,63,4,1,0,1,1,-2,3,5,1,4,3,3,5,2,-1,0,1,0,5,-181,2,1,3,0,0,1,-1,-1,1,1,2,1
KR_6604864754,420,-2,-54,-20,0,1,1,0,-6,0,6,5,6,1,-1,2,3,1,1,0,0,2,0,2,4,6,2,0,0,0,1,-1,1,0,1
KR_6725718806,420,-1,32,25,1,-4,1,5,5,6,1,0,0,0,0,2,2,0,2,2,0,2,108,-1,4,3,2,0,0,1,-1,-1,-1,6,1
KR_6730369339,440,5,87,20,14,4,5,1,0,2,2,5,8,3,3,4,1,2,2,0,0,8,115,2,2,4,1,0,0,1,0,1,1,6,1
KR_6734212426,420,2,18,-19,4,5,5,0,-3,1,4,-3,0,3,4,4,0,1,1,0,0,10,1,3,6,9,5,0,1,1,1,1,1,2,1
KR_6741182682,440,6,62,24,13,-4,1,5,2,4,2,4,6,2,10,10,0,1,1,0,0,17,0,-4,5,1,3,0,1,1,1,1,-1,5,1
KR_6749026053,420,0,-40,-8,4,4,6,2,0,1,1,-1,0,1,2,4,2,-1,1,2,-1,4,1,-1,5,4,-3,0,-1,1,1,1,-1,4,1
KR_6690384916,420,2,27,10,0,1,1,0,5,7,2,-5,1,6,0,1,1,-1,1,2,0,3,-3,1,3,4,0,0,0,0,-1,1,-1,0,1
KR_6730931963,420,5,111,11,12,6,9,3,-1,2,3,4,4,0,2,3,1,1,1,0,-1,1,-103,2,3,5,-3,0,3,1,-1,1,-1,4,1
KR_6755363014,420,5,40,4,20,-3,0,3,3,6,3,12,13,1,7,7,0,1,1,0,0,20,-234,3,1,4,1,0,1,1,1,1,1,2,1
KR_6762522780,420,5,79,20,6,7,9,2,-1,0,1,-3,4,7,0,3,3,3,3,0,0,7,7,0,3,3,1,0,0,1,-1,1,1,3,1
KR_6729043059,420,-1,-43,13,1,0,1,1,1,2,1,1,3,2,-1,3,4,0,2,2,0,2,2,-7,11,4,3,0,0,1,1,1,-1,1,1
KR_6750615124,420,1,22,-36,2,2,3,1,-3,0,3,3,3,0,1,1,0,-1,0,1,0,0,-24,0,5,5,1,0,0,-1,-1,0,1,3,1
KR_6733609269,420,8,117,25,19,4,4,0,4,6,2,4,7,3,0,2,2,7,7,0,-1,13,5,1,4,5,5,0,2,1,1,1,-1,3,1
KR_6619418057,420,-1,-22,17,2,9,9,0,0,3,3,1,3,2,-4,0,4,-4,1,5,1,-6,-18,1,4,5,-2,0,2,-1,1,1,1,4,1
KR_6725779396,420,0,-2,16,3,1,2,1,2,5,3,-1,0,1,-1,1,2,2,6,4,0,7,-488,0,4,4,1,0,-2,-1,1,-1,1,6,1
KR_6761193456,420,1,-10,24,-7,-3,1,4,-1,2,3,-2,2,4,1,3,2,-2,0,2,0,-5,193,4,3,7,-4,0,1,1,-1,1,-1,2,1
KR_6697942701,420,3,13,-15,3,5,6,1,-1,1,2,1,2,1,0,0,0,-2,0,2,0,-1,-10,0,6,6,-2,0,0,1,1,-1,1,2,1
KR_6569022420,420,3,49,-4,7,4,4,0,2,5,3,0,2,2,1,2,1,0,0,0,1,6,-8,-3,9,6,5,0,1,1,1,1,1,3,1
KR_6759728046,420,1,24,-23,4,1,1,0,-3,1,4,1,3,2,4,5,1,1,4,3,0,2,6,3,4,7,-1,0,2,0,1,1,1,0,1
KR_6686512740,420,0,82,0,-2,2,3,1,-1,1,2,1,5,4,-3,1,4,-1,0,1,0,-4,-21,-8,11,3,-5,0,0,1,-1,-1,1,2,1
KR_6725360272,420,5,54,-1,7,2,2,0,5,8,3,2,3,1,-2,2,4,0,2,2,0,7,-6,-1,6,5,7,0,0,-1,-1,1,-1,5,1
KR_6763539592,440,1,37,-33,6,0,2,2,0,0,0,3,3,0,3,3,0,0,0,0,0,5,5,2,6,8,0,0,1,1,0,1,1,4,1
KR_6592709485,420,1,46,4,3,-2,1,3,-1,4,5,2,2,0,2,3,1,2,2,0,0,9,11,4,3,7,-2,0,0,1,-1,0,1,1,1
KR_6715724136,420,1,-23,-10,1,6,7,1,0,1,1,-6,0,6,1,4,3,0,1,1,0,-1,4,-1,5,4,-1,0,0,-1,1,-1,-1,6,1
KR_6669495555,420,-5,10,-13,-6,2,4,2,-4,1,5,2,2,0,-4,2,6,-2,0,2,-2,-12,16,-1,5,4,-8,0,-1,-1,1,-1,-1,4,1
KR_6657989020,420,3,40,-8,4,0,2,2,-1,3,4,6,8,2,0,1,1,-1,0,1,0,2,14,-1,5,4,0,0,2,1,1,1,1,4,1
KR_6756286694,420,3,15,-13,5,-4,2,6,0,2,2,1,2,1,8,8,0,0,1,1,0,11,-6,6,1,7,4,0,0,1,0,0,1,1,1
KR_6757365718,420,1,37,-8,2,1,3,2,2,3,1,1,2,1,0,2,2,-2,0,2,0,-4,-2,0,4,4,-3,0,1,-1,1,1,-1,1,1
KR_6683515627,420,4,64,42,11,0,3,3,-1,4,5,3,3,0,6,6,0,3,3,0,0,9,43,5,4,9,-8,0,3,-1,1,1,-1,2,1
KR_6601265483,420,0,12,-16,-5,2,3,1,1,4,3,-3,2,5,-3,0,3,-2,0,2,0,-8,-8,-1,8,7,6,0,1,-1,1,1,-1,1,1
KR_6754098835,420,1,-8,15,2,-2,2,4,2,2,0,-5,2,7,5,7,2,2,3,1,0,6,-3,4,6,10,0,0,0,1,0,1,1,2,1
KR_6454884255,420,2,-19,20,2,-1,0,1,4,5,1,-1,1,2,-1,0,1,1,1,0,0,1,-8,0,5,5,0,0,0,1,-1,0,-1,3,1
KR_6724761039,420,2,63,14,6,2,3,1,2,3,1,-1,2,3,3,3,0,0,1,1,0,3,24,4,3,7,3,0,2,1,1,1,-1,2,1
KR_6665267162,420,2,28,-10,3,4,4,0,-2,2,4,-1,1,2,1,3,2,1,2,1,1,-2,118,7,1,8,-1,0,1,1,1,1,1,4,1
KR_6673684199,420,-1,10,-16,1,-2,1,3,-1,4,5,-2,0,2,4,4,0,2,2,0,0,6,-28,0,4,4,0,0,0,1,-1,0,1,1,1
KR_6762606238,420,2,32,-8,9,-1,2,3,4,4,0,0,1,1,6,8,2,0,0,0,0,16,-37,0,2,2,16,0,1,-1,-1,1,1,6,1
KR_6625993569,420,4,113,-37,4,-1,4,5,2,3,1,3,7,4,2,3,1,-2,3,5,0,-2,2,4,2,6,1,0,3,1,1,1,1,5,1
KR_6747678246,420,4,76,0,10,2,6,4,7,8,1,1,1,0,0,3,3,0,0,0,0,5,10,5,3,8,0,0,1,1,1,1,1,6,1
KR_6733529053,420,-4,27,-19,-15,0,0,0,-9,0,9,-4,2,6,-1,0,1,-1,1,2,0,-27,-9,2,3,5,-22,0,0,-1,1,0,-1,5,1
KR_6644268106,420,5,31,45,3,1,3,2,-1,4,5,4,4,0,-3,3,6,2,2,0,0,-1,20,-1,4,3,5,0,1,-1,-1,1,1,2,1
KR_6728430471,440,2,22,-33,5,-1,3,4,-1,1,2,2,2,0,3,4,1,2,2,0,0,2,9,3,4,7,2,0,0,1,-1,-1,-1,2,1
KR_6728181886,420,1,-33,-16,8,-3,1,4,8,9,1,4,6,2,0,2,2,-1,1,2,0,14,-3,4,2,6,2,0,1,1,1,1,-1,1,1
KR_6637936400,420,1,-3,-33,1,1,4,3,-2,1,3,3,4,1,-2,0,2,1,1,0,-1,0,-9,-1,6,5,-5,0,0,1,0,0,-1,6,1
KR_6622810025,420,3,-40,53,3,0,2,2,1,4,3,6,7,1,-3,3,6,-1,1,2,-1,-3,-201,0,3,3,2,0,1,1,1,1,-1,1,1
KR_6712268820,420,0,3,8,0,2,3,1,1,4,3,-5,1,6,1,1,0,1,1,0,0,7,22,-3,5,2,1,0,-1,-1,0,-1,-1,3,1
KR_6749833217,420,2,44,0,6,0,1,1,-3,2,5,2,6,4,6,7,1,1,1,0,1,2,-32,1,3,4,1,0,0,1,-1,1,1,3,1
KR_6720463232,420,3,32,11,4,1,2,1,-1,1,2,1,1,0,4,4,0,-1,0,1,1,8,-7,-6,6,0,4,0,-1,1,-1,-1,1,4,1
KR_6756987696,420,3,54,9,1,3,4,1,1,2,1,1,3,2,-4,2,6,0,1,1,-1,-2,51,-2,5,3,-20,0,2,1,1,1,-1,1,1
KR_6704692522,420,2,-20,28,2,0,0,0,0,2,2,2,4,2,1,2,1,-1,1,2,0,6,2,1,4,5,-5,0,1,1,1,1,1,4,1
KR_6757015120,420,4,43,16,3,1,2,1,3,5,2,0,1,1,-2,6,8,1,1,0,0,4,2,1,2,3,0,0,0,1,-1,1,1,1,1
KR_6754337735,420,2,78,31,-2,1,3,2,-1,3,4,1,4,3,-2,0,2,-1,0,1,-1,-8,-4,-5,11,6,3,0,1,-1,1,1,-1,5,1
KR_6729822838,420,1,10,8,3,-2,1,3,4,4,0,-3,0,3,3,3,0,1,1,0,0,7,32,9,2,11,-2,0,1,1,-1,-1,-1,1,1
KR_6722634342,420,5,84,32,-1,2,3,1,-3,2,5,5,5,0,-2,3,5,-3,0,3,-1,-10,-56,-2,6,4,2,0,0,1,-1,-1,-1,2,1
KR_6614861783,420,1,19,-8,-5,-2,1,3,-1,4,5,3,6,3,-3,0,3,-2,0,2,0,-8,6,5,3,8,0,0,1,-1,-1,-1,-1,3,1
KR_6512322866,420,-3,-20,-12,-7,0,0,0,-1,1,2,-1,2,3,-6,0,6,1,1,0,0,-8,-9,-2,6,4,-1,0,-1,-1,-1,-1,-1,3,1
KR_6628836719,420,0,25,28,-7,3,3,0,-1,0,1,1,3,2,-6,0,6,-4,2,6,0,-16,-6,-4,5,1,-1,0,2,-1,1,1,1,6,1
KR_6731439015,420,4,5,28,8,-1,1,2,5,6,1,-1,0,1,3,4,1,2,2,0,0,13,32,0,5,5,-4,0,1,-1,1,1,1,5,1
KR_6708839824,420,3,52,3,7,1,1,0,5,11,6,-4,1,5,7,8,1,-2,0,2,0,0,5,1,4,5,2,0,2,-1,-1,1,1,5,1
KR_6759687172,420,4,-2,27,8,1,2,1,0,2,2,3,3,0,3,4,1,1,1,0,1,7,-47,2,3,5,39,0,-1,0,-1,-1,1,0,1
KR_6730307698,420,3,29,2,10,3,3,0,4,4,0,4,6,2,-2,2,4,1,2,1,0,15,0,2,3,5,4,0,1,-1,1,1,1,4,1
KR_6753260404,440,0,-18,-4,1,-1,4,5,1,2,1,0,1,1,1,1,0,0,3,3,0,-1,-20,-2,9,7,-3,0,0,1,-1,-1,1,3,1
KR_6724280310,420,2,62,-15,8,3,3,0,1,2,1,5,5,0,-1,1,2,0,2,2,0,11,-8,-3,9,6,3,0,1,1,0,1,-1,5,1
KR_6731856373,420,3,83,-24,13,1,2,1,0,4,4,3,4,1,9,9,0,0,2,2,0,8,2,-2,5,3,1,0,1,0,-1,1,1,0,1
KR_6661932186,420,1,-20,-31,5,3,4,1,-3,2,5,0,1,1,2,4,2,3,3,0,0,13,-7,-4,5,1,1,0,0,1,-1,-1,1,4,1
KR_6761660951,420,0,-42,-3,6,1,1,0,2,6,4,0,2,2,-2,3,5,5,5,0,0,9,-62,-2,4,2,37,0,0,1,-1,0,1,5,1
KR_6654915711,420,1,31,-17,6,1,2,1,3,4,1,-3,1,4,4,4,0,1,1,0,0,2,-2,2,6,8,6,0,0,1,-1,0,1,2,1
KR_6685930251,420,4,66,-16,8,-5,0,5,4,5,1,6,6,0,2,2,0,1,1,0,0,8,0,-3,4,1,0,0,0,-1,-1,1,-1,1,1
KR_6705599898,420,4,14,56,5,5,5,0,1,3,2,1,1,0,-1,1,2,-1,3,4,0,2,-5,-2,5,3,2,0,0,1,-1,0,1,4,1
KR_6761991057,420,0,22,13,0,0,0,0,2,4,2,-1,1,2,-1,1,2,0,1,1,0,0,0,-1,7,6,5,0,0,0,1,0,1,0,1
KR_6696596085,420,2,112,20,6,5,7,2,-1,4,5,4,5,1,-2,1,3,0,0,0,0,-4,11,3,1,4,2,0,1,1,1,1,-1,3,1
KR_6764014690,420,4,61,20,12,5,7,2,6,8,2,2,2,0,-1,1,2,0,1,1,0,8,4,4,4,8,2,0,1,1,1,1,1,6,1
KR_6761630498,420,1,24,19,1,-1,1,2,-3,1,4,4,5,1,0,3,3,1,1,0,0,3,6,1,4,5,4,0,0,0,0,0,-1,0,1
KR_6675452047,420,2,-48,48,2,-2,0,2,-2,2,4,0,1,1,5,5,0,1,3,2,0,1,8,4,4,8,-2,0,0,1,1,1,1,5,1
KR_6719732327,420,3,9,-13,5,2,2,0,1,4,3,1,4,3,0,1,1,1,1,0,0,10,-115,1,4,5,1,0,0,0,1,1,-1,0,1
KR_6751046547,420,1,4,-32,2,-2,4,6,-2,5,7,1,4,3,4,4,0,1,5,4,0,0,29,4,1,5,-5,0,0,1,-1,-1,1,4,1
KR_6697357564,440,-1,91,-28,0,3,3,0,0,3,3,-2,0,2,2,2,0,-3,1,4,0,7,-1,4,4,8,2,0,-1,0,-1,-1,1,0,1
KR_6724466853,420,-3,37,-39,0,2,2,0,0,3,3,-3,1,4,0,7,7,1,2,1,1,-4,174,-5,6,1,3,0,0,1,-1,0,1,2,1
KR_6606183022,420,5,18,20,8,3,5,2,-1,3,4,6,8,2,-1,2,3,1,1,0,0,8,-5,1,6,7,4,0,1,-1,1,1,1,1,1
KR_6731478374,440,-2,-37,24,1,-1,1,2,1,2,1,1,3,2,1,1,0,-1,1,2,0,-1,-2,2,1,3,-1,0,0,1,1,0,1,1,1
KR_6720192260,420,6,90,-13,17,4,5,1,0,3,3,6,6,0,7,8,1,0,0,0,0,13,-2,0,3,3,0,0,1,-1,1,1,1,1,1
KR_6522050234,420,0,44,8,3,1,1,0,-2,4,6,8,8,0,-3,0,3,-1,3,4,0,0,-4,4,5,9,0,0,-1,-1,1,-1,1,6,1
KR_6764684969,420,3,43,-16,2,3,4,1,1,2,1,-2,0,2,0,6,6,0,0,0,0,0,-7,1,3,4,-5,0,0,1,0,0,1,6,1
KR_6722446767,420,4,53,-8,12,1,3,2,2,3,1,7,7,0,3,3,0,-1,1,2,0,8,2,2,3,5,5,0,1,1,-1,1,-1,4,1
KR_6639288189,420,1,110,-5,8,5,5,0,3,4,1,0,2,2,0,1,1,0,1,1,0,0,116,5,2,7,-1,0,2,1,1,1,1,1,1
KR_6710141561,420,3,12,12,8,0,1,1,4,5,1,1,3,2,2,6,4,1,2,1,0,3,-9,-1,5,4,1,0,1,1,1,1,-1,2,1
KR_6649417313,420,0,-7,-3,-2,0,1,1,-5,1,6,3,4,1,0,1,1,0,0,0,0,-5,-8,-4,5,1,0,0,0,-1,0,0,-1,2,1
KR_6680069538,420,6,97,15,17,4,6,2,6,7,1,0,2,2,6,6,0,1,1,0,0,15,94,3,2,5,13,0,1,1,-1,1,1,5,1
KR_6764430182,420,1,-10,24,7,-3,1,4,1,5,4,5,6,1,3,3,0,1,1,0,0,11,-17,-5,7,2,0,0,0,1,-1,0,1,5,1
KR_6753059072,420,2,69,-4,0,-1,0,1,-1,1,2,4,4,0,0,2,2,-2,0,2,0,0,-290,0,7,7,2,0,0,1,1,-1,-1,4,1
KR_6715339695,420,0,27,13,-3,-3,1,4,-1,0,1,8,9,1,-6,0,6,-1,1,2,0,0,4,-2,6,4,0,0,0,-1,-1,0,-1,3,1
KR_6672418492,420,4,41,0,9,1,1,0,2,2,0,1,2,1,3,3,0,2,2,0,0,10,8,1,4,5,-3,0,1,1,-1,1,1,5,1
KR_6737240241,420,0,-51,-35,4,4,5,1,0,1,1,2,3,1,2,3,1,-4,1,5,0,3,12,11,0,11,-2,0,1,1,0,1,1,1,1
KR_6754112493,420,1,-36,22,-1,-2,2,4,4,5,1,-2,0,2,1,3,2,-2,0,2,0,-2,54,0,6,6,-8,0,0,0,-1,1,-1,0,1
KR_6660183765,420,2,29,12,3,-2,2,4,2,3,1,3,3,0,1,4,3,-1,0,1,0,2,-45,0,5,5,23,0,-1,-1,1,-1,-1,1,1
KR_6655937818,440,0,50,-16,-3,0,4,4,1,2,1,-1,0,1,-2,6,8,-1,5,6,-1,-17,-1,1,6,7,4,0,-1,1,-1,-1,-1,2,1
KR_6741522621,440,4,-2,2,8,-1,0,1,3,5,2,6,6,0,0,3,3,0,2,2,1,12,2,0,3,3,3,0,0,-1,1,1,1,2,1
KR_6761328862,420,-2,-24,8,-6,-3,0,3,-3,1,4,0,4,4,-2,0,2,2,2,0,0,-6,2,4,3,7,-2,0,0,-1,-1,1,-1,5,1
KR_6737998919,420,1,-1,4,10,-4,0,4,10,11,1,1,2,1,3,3,0,0,1,1,0,11,7,0,3,3,-1,0,0,-1,1,0,1,2,1
KR_6760192250,420,1,-30,8,8,0,0,0,0,1,1,6,6,0,2,3,1,0,0,0,1,19,72,5,1,6,-3,0,0,-1,0,1,1,6,1
KR_6740473707,420,3,54,12,6,1,3,2,-1,1,2,2,2,0,4,4,0,0,1,1,0,8,-19,4,3,7,3,0,0,1,-1,1,1,1,1
KR_6745627996,420,3,-2,-14,6,2,2,0,-1,1,2,5,5,0,-5,5,10,5,6,1,0,10,-5,-2,8,6,-4,0,0,1,-1,-1,-1,4,1
KR_6759997675,420,-3,-53,-21,-1,-2,1,3,2,2,0,0,2,2,0,1,1,-1,0,1,0,1,9,5,3,8,1,0,0,1,0,0,-1,5,1
KR_6756087123,420,1,65,48,1,-4,0,4,4,6,2,-1,3,4,4,5,1,-2,1,3,1,15,-343,3,5,8,1,0,0,1,1,1,1,3,1
KR_6748775272,440,1,-5,-5,3,0,1,1,-4,0,4,6,7,1,2,4,2,-1,0,1,0,5,13,1,6,7,-6,0,-1,0,-1,-1,1,0,1
KR_6604839153,420,7,145,27,14,0,4,4,4,4,0,7,7,0,4,8,4,-1,1,2,0,7,-7,-3,6,3,5,0,4,1,-1,1,1,5,1
KR_6674717070,420,-1,32,12,4,-1,0,1,0,3,3,1,1,0,2,2,0,2,3,1,0,6,-5,-2,4,2,2,0,0,-1,1,0,1,1,1
KR_6660404515,420,3,25,24,9,3,5,2,3,7,4,3,3,0,0,5,5,0,1,1,1,11,7,0,4,4,2,0,2,1,1,1,1,5,1
KR_6724541623,420,6,-13,60,4,3,3,0,2,2,0,-6,1,7,4,10,6,1,1,0,1,8,-5,-1,2,1,-4,0,2,1,1,1,1,3,1
KR_6679645811,440,8,106,36,11,1,1,0,2,4,2,5,8,3,1,2,1,2,3,1,1,11,9,0,3,3,2,0,2,1,1,1,1,4,1
KR_6634174404,420,0,-2,-2,1,3,3,0,0,3,3,0,1,1,-2,1,3,0,0,0,0,-4,-20,0,4,4,2,0,0,-1,1,0,-1,2,1
KR_6664594813,420,7,107,33,7,3,3,0,5,8,3,3,4,1,-4,2,6,0,1,1,0,8,44,-2,5,3,-19,0,1,1,-1,1,-1,4,1
KR_6751135820,420,1,21,0,4,0,1,1,-1,4,5,0,1,1,4,5,1,1,1,0,0,10,0,2,2,4,-1,0,0,1,1,1,-1,3,1
KR_6737934552,420,1,53,-14,1,-2,2,4,1,2,1,1,2,1,4,4,0,-3,0,3,0,-2,7,2,1,3,-1,0,2,1,-1,1,1,4,1
KR_6760028892,420,9,177,-4,20,2,2,0,3,4,1,8,8,0,7,9,2,0,0,0,1,13,42,2,0,2,-17,0,4,-1,1,1,1,1,1
KR_6738438249,420,-2,-18,26,0,-2,3,5,3,4,1,-3,0,3,3,6,3,-1,0,1,0,0,-64,1,2,3,22,0,1,1,-1,-1,1,4,1
KR_6681302284,420,-1,-29,4,-2,-1,0,1,1,4,3,0,5,5,1,3,2,-3,0,3,0,2,-9,-3,4,1,2,0,0,1,1,0,1,1,1
KR_6733434220,420,4,20,-8,8,4,4,0,0,4,4,1,1,0,3,4,1,0,1,1,0,9,43,7,0,7,-10,0,1,1,1,1,1,5,1
KR_6723008739,440,0,53,20,-5,0,2,2,1,6,5,-5,1,6,-2,1,3,1,2,1,0,-13,45,-4,6,2,0,0,0,0,1,1,-1,0,1
KR_6732189857,420,2,47,-24,2,0,1,1,3,5,2,5,5,0,-5,3,8,-1,0,1,0,-9,6,-6,7,1,-1,0,-1,-1,0,1,1,4,1
KR_6760356655,440,10,59,61,16,1,2,1,3,3,0,5,6,1,3,6,3,4,5,1,0,16,10,-1,3,2,1,0,2,1,1,1,1,2,1
KR_6720331405,420,-1,-22,-24,0,-1,4,5,0,1,1,-1,2,3,1,4,3,1,2,1,0,0,-5,-1,2,1,2,0,1,0,1,-1,1,0,1
KR_6707527296,420,4,-17,38,7,0,0,0,2,4,2,4,4,0,1,5,4,0,0,0,0,5,-9,-3,7,4,0,0,1,1,-1,1,-1,2,1
KR_6688483046,440,4,20,36,6,5,5,0,-1,0,1,2,2,0,0,4,4,0,0,0,0,2,3,-1,4,3,-1,0,1,1,1,1,-1,2,1
KR_6758524858,420,1,-93,28,1,0,1,1,0,2,2,2,2,0,-1,0,1,0,0,0,0,4,44,3,1,4,-28,0,0,1,1,-1,1,2,1
KR_6292940988,420,4,57,-7,16,1,1,0,8,9,1,4,6,2,1,3,2,2,3,1,0,25,9,2,1,3,1,1,4,1,1,1,1,5,1
KR_6673551276,420,3,12,-12,2,-1,2,3,2,3,1,2,3,1,-2,1,3,1,1,0,2,6,-25,0,6,6,3,0,0,-1,-1,0,1,2,1
KR_6657230917,420,-2,68,-2,-3,0,1,1,-4,0,4,2,2,0,0,3,3,-1,1,2,0,-8,3,3,6,9,3,0,-1,1,-1,-1,1,2,1
KR_6495712477,420,2,89,24,3,-1,0,1,6,7,1,4,4,0,-7,3,10,1,3,2,1,-3,-60,1,3,4,1,0,2,1,1,1,1,3,1
KR_6708338729,420,5,94,-9,13,3,4,1,5,5,0,-1,2,3,1,2,1,5,5,0,1,19,0,6,1,7,4,0,2,1,1,1,1,1,1
KR_6728763204,420,0,-51,-32,10,2,2,0,-4,1,5,4,4,0,8,8,0,0,1,1,2,16,-32,-1,5,4,23,0,-1,1,1,1,1,3,1
KR_6711240189,420,-3,-84,-20,-9,-3,1,4,-4,1,5,1,2,1,-1,5,6,-2,1,3,0,-8,10,-4,7,3,-1,0,-1,1,-1,-1,-1,1,1
KR_6715830011,420,1,6,-1,0,2,3,1,-2,4,6,3,4,1,1,4,3,-4,1,5,0,0,-119,2,4,6,-3,0,-1,-1,-1,-1,-1,2,1
KR_6739621343,440,0,-30,12,-1,0,1,1,3,7,4,0,2,2,-5,2,7,1,2,1,-1,-5,356,0,4,4,-1,0,0,0,1,1,-1,0,1
KR_6733752062,420,-1,-36,2,0,0,0,0,-3,1,4,1,6,5,2,3,1,0,1,1,0,2,-6,-5,8,3,4,0,0,-1,-1,0,-1,1,1
KR_6736968489,420,7,56,36,6,1,2,1,0,3,3,1,1,0,2,4,2,2,2,0,0,5,-112,2,1,3,2,0,1,1,-1,1,1,1,1
KR_6729385120,420,3,14,6,3,3,4,1,2,4,2,1,4,3,-3,1,4,0,1,1,0,4,0,0,4,4,8,0,1,1,-1,1,-1,1,1
KR_6672797415,420,2,65,31,8,2,3,1,2,3,1,1,3,2,4,4,0,-1,0,1,0,7,-11,1,2,3,-2,0,1,1,1,1,1,5,1
KR_6596744506,420,2,46,0,4,0,1,1,2,4,2,-3,0,3,3,4,1,2,3,1,0,4,0,-5,9,4,1,0,0,1,-1,0,1,1,1
KR_6663022403,420,1,-39,4,7,9,10,1,0,3,3,1,3,2,-4,0,4,1,1,0,0,5,346,-6,8,2,-3,0,1,-1,1,1,1,4,1
KR_6717266584,420,-2,-24,16,2,1,3,2,1,5,4,-2,2,4,4,6,2,-2,1,3,2,-2,-289,3,4,7,-3,0,0,-1,-1,0,1,3,1
KR_6661514806,420,3,67,27,6,-2,5,7,-2,3,5,2,3,1,7,7,0,1,2,1,-1,23,11,1,5,6,2,0,1,1,1,-1,-1,5,1
KR_6753029475,440,-2,-32,-42,-3,-3,2,5,1,3,2,0,2,2,2,5,3,-3,3,6,-1,0,8,-4,6,2,3,0,-1,-1,1,-1,-1,1,1
KR_6626281428,420,-3,46,-29,-5,1,2,1,-4,3,7,-1,2,3,1,4,3,-2,0,2,0,-8,-79,-5,5,0,2,0,0,-1,-1,1,-1,6,1
KR_6759887532,420,1,80,1,-1,-4,1,5,1,5,4,2,5,3,0,3,3,0,1,1,0,-4,-30,-8,13,5,-2,0,-2,-1,-1,-1,1,1,1
KR_6762523482,420,3,-54,6,11,-1,1,2,5,5,0,-3,1,4,3,7,4,7,8,1,0,8,-10,5,3,8,15,0,2,1,1,1,1,3,1
KR_6734084976,420,3,11,-2,9,-1,0,1,2,2,0,3,3,0,3,3,0,2,2,0,0,12,4,2,4,6,0,0,3,1,1,1,1,5,1
KR_6704455031,440,2,96,28,0,-3,1,4,3,4,1,0,0,0,0,2,2,0,1,1,-2,-3,-9,-2,5,3,4,0,0,1,-1,0,-1,3,1
KR_6549396817,420,-1,54,3,-6,-2,2,4,0,3,3,-2,0,2,-2,0,2,0,0,0,0,-10,-6,-6,8,2,1,0,-1,1,-1,-1,-1,4,1
KR_6714586596,420,-3,-39,-9,-8,3,4,1,-5,0,5,-3,3,6,-2,4,6,-1,0,1,1,-7,3,5,1,6,-4,0,-1,-1,1,-1,1,4,1
KR_6760394519,420,4,63,8,12,3,3,0,-2,1,3,5,6,1,5,5,0,1,3,2,0,9,-13,3,2,5,10,0,0,1,-1,1,1,6,1
KR_6760971045,420,6,41,6,11,-1,3,4,2,3,1,5,5,0,3,5,2,2,2,0,0,15,-7,-2,7,5,0,0,3,1,1,1,1,2,1
KR_6723674245,420,4,62,20,4,3,3,0,-2,4,6,2,3,1,2,3,1,-1,0,1,0,3,-6,0,5,5,6,0,2,1,1,1,-1,2,1
KR_6675647295,420,1,-69,-12,7,0,1,1,1,2,1,5,7,2,1,4,3,0,1,1,0,6,11,6,3,9,1,0,0,1,0,0,1,5,1
KR_6639946094,420,1,33,18,5,8,8,0,0,2,2,2,7,5,-1,2,3,-4,0,4,0,8,17,4,3,7,5,0,1,0,1,1,1,0,1
KR_6716044139,420,4,84,28,3,1,5,4,-2,3,5,3,5,2,1,2,1,0,1,1,1,-7,-21,-2,4,2,5,0,1,1,1,1,1,2,1
KR_6734728683,440,5,34,16,5,2,3,1,2,4,2,-3,0,3,3,3,0,1,1,0,0,4,27,1,6,7,1,0,0,1,-1,1,-1,4,1
KR_6667866804,420,2,18,7,2,0,1,1,0,1,1,1,3,2,-1,0,1,2,2,0,0,2,110,0,5,5,-1,0,0,1,0,1,1,2,1
KR_6671884191,420,5,178,-13,7,3,5,2,-2,3,5,2,2,0,1,3,2,3,4,1,0,6,-13,0,5,5,3,0,2,-1,1,1,1,5,1
KR_6754449181,420,-1,-67,-16,4,-1,1,2,2,2,0,-1,1,2,1,2,1,3,4,1,0,7,85,4,3,7,-2,0,0,0,1,-1,1,0,1
KR_6731168046,420,3,11,24,5,4,5,1,0,2,2,-1,1,2,-1,0,1,3,3,0,0,1,2,1,4,5,2,0,0,-1,1,1,1,6,1
KR_6712238074,420,0,-43,-8,4,6,7,1,-2,1,3,-1,2,3,-3,3,6,4,4,0,0,3,2,4,1,5,-4,0,0,1,-1,1,1,1,1
KR_6668837091,420,3,46,19,-2,1,3,2,-5,0,5,1,3,2,3,6,3,-2,0,2,0,-6,-6,1,6,7,3,0,1,-1,1,1,-1,1,1
KR_6471120424,420,6,99,33,12,-2,0,2,5,6,1,-1,1,2,6,6,0,4,4,0,0,11,13,1,3,4,-1,0,4,1,1,1,1,3,1
KR_6733597726,440,2,12,16,2,-4,2,6,2,2,0,-2,2,4,0,1,1,6,7,1,0,13,8,2,3,5,1,0,1,0,-1,-1,1,0,1
KR_6724709861,420,-5,-61,6,-10,0,4,4,-2,3,5,-3,1,4,-3,3,6,-2,1,3,0,-2,1,3,3,6,-3,0,-1,-1,1,-1,1,5,1
KR_6764147237,420,-2,-29,-12,-2,0,2,2,-3,3,6,-2,1,3,2,3,1,1,1,0,0,4,-8,0,4,4,1,0,-1,1,-1,-1,-1,2,1
KR_6743396188,420,3,23,-25,2,-2,1,3,4,7,3,0,5,5,2,5,3,-2,0,2,1,6,132,0,7,7,3,0,2,1,-1,1,1,6,1
KR_6710186428,420,3,25,11,5,4,4,0,-1,4,5,4,8,4,-1,1,2,-1,1,2,-1,3,-122,-1,4,3,3,0,1,-1,-1,1,-1,4,1
KR_6749203077,420,-3,-6,-20,-3,0,1,1,2,4,2,-2,2,4,-5,2,7,2,2,0,-1,-1,-2,0,4,4,0,0,0,-1,-1,0,-1,5,1
KR_6736025110,420,10,164,20,19,5,7,2,3,7,4,9,10,1,1,4,3,1,2,1,0,12,21,1,5,6,4,0,2,-1,-1,1,1,6,1
KR_6760883776,420,0,21,-1,3,2,3,1,0,2,2,1,4,3,0,3,3,0,1,1,0,-2,-10,-4,4,0,2,0,0,1,-1,1,1,1,1
KR_6741973048,440,3,33,14,7,0,3,3,3,5,2,2,3,1,-2,1,3,4,7,3,0,8,44,1,3,4,-21,0,0,-1,-1,1,1,3,1
KR_6745290328,420,2,24,14,5,0,2,2,2,7,5,2,4,2,2,2,0,-1,2,3,0,4,25,3,3,6,0,0,2,1,1,1,1,3,1
KR_6705869023,420,0,37,-39,-1,1,2,1,0,2,2,0,3,3,1,2,1,-3,1,4,0,-2,15,-5,8,3,1,0,0,-1,-1,0,1,2,1
KR_6737720973,420,2,-12,5,4,-1,0,1,-1,2,3,4,6,2,2,4,2,0,1,1,0,0,75,0,4,4,3,0,1,1,1,1,1,6,1
KR_6670266725,420,6,79,21,8,0,2,2,5,5,0,0,5,5,3,5,2,0,0,0,0,3,-2,-1,4,3,4,0,2,1,1,1,1,6,1
KR_6669259231,440,0,25,-5,6,1,1,0,-1,2,3,1,1,0,3,3,0,2,3,1,0,13,9,3,2,5,-2,0,1,1,0,1,1,4,1
KR_6757591387,420,1,7,-47,5,2,3,1,-1,6,7,6,9,3,3,5,2,-5,0,5,0,8,42,1,3,4,-20,0,0,0,0,1,1,0,1
KR_6730889547,420,7,39,16,11,4,4,0,1,2,1,-1,2,3,7,7,0,0,0,0,0,13,-7,4,1,5,1,0,1,0,1,1,-1,0,1
KR_6715094849,420,-1,-34,-9,-1,-3,1,4,3,4,1,-1,1,2,0,2,2,0,1,1,0,0,-9,4,3,7,4,0,2,-1,1,1,1,1,1
KR_6710396414,420,6,63,28,11,3,3,0,1,2,1,1,3,2,2,3,1,4,4,0,3,8,35,3,5,8,-2,0,2,1,1,1,1,2,1
KR_6748423555,420,-1,-8,-2,1,1,3,2,2,3,1,0,3,3,0,2,2,-2,0,2,1,-10,11,-2,7,5,-6,0,0,0,1,0,1,0,1
KR_6707505392,420,4,66,-12,6,0,2,2,2,4,2,1,3,2,2,3,1,1,1,0,0,5,12,8,2,10,-3,0,1,-1,-1,1,1,4,1
KR_6708197231,420,2,1,-2,7,-1,2,3,4,6,2,3,3,0,1,1,0,0,1,1,0,7,-20,-1,4,3,6,0,-1,1,-1,-1,1,2,1
KR_6730799434,440,1,-37,16,0,2,5,3,0,4,4,-1,2,3,-2,0,2,1,1,0,0,-2,9,1,4,5,-4,0,0,1,1,-1,1,2,1
KR_6701358458,440,3,14,39,10,0,2,2,2,4,2,5,5,0,1,2,1,2,3,1,0,9,10,-1,7,6,0,0,-1,1,-1,-1,-1,5,1
KR_6749240285,420,1,-21,-16,2,-2,1,3,-2,0,2,-2,0,2,7,10,3,1,2,1,0,2,4,2,6,8,2,0,1,1,-1,1,1,1,1
KR_6586523522,420,3,60,18,3,0,1,1,0,2,2,-3,3,6,6,7,1,0,1,1,0,6,53,-4,6,2,-3,0,0,1,-1,0,-1,5,1
KR_6652884604,420,3,113,-17,11,7,8,1,5,6,1,1,3,2,0,2,2,-2,1,3,1,8,1,0,4,4,0,0,1,1,-1,1,1,3,1
KR_6753893915,420,-4,-99,-20,-2,-3,1,4,2,3,1,-2,2,4,1,1,0,0,0,0,0,1,4,5,1,6,-1,0,0,-1,0,-1,1,4,1
KR_6729260568,420,4,27,15,7,-5,0,5,8,8,0,3,5,2,1,1,0,0,0,0,0,6,8,4,2,6,0,0,3,1,-1,1,1,1,1
KR_6700822361,420,0,-20,-16,8,1,1,0,3,5,2,2,3,1,0,1,1,2,2,0,0,12,-47,-1,3,2,26,0,0,1,1,-1,-1,6,1
KR_6685241123,420,0,-22,-33,2,1,2,1,0,3,3,-1,2,3,2,8,6,0,3,3,0,4,12,0,4,4,-5,0,0,-1,1,1,-1,2,1
KR_6759154463,420,-2,-22,-36,-10,-2,4,6,-1,0,1,-5,1,6,-1,3,4,-1,0,1,0,-12,0,-1,6,5,-4,0,0,-1,-1,0,1,1,1
KR_6707413806,420,0,35,-4,-1,2,2,0,-1,0,1,0,2,2,-1,0,1,-1,0,1,0,-6,11,6,1,7,5,0,0,1,1,0,1,5,1
KR_6669099268,420,-3,-12,-4,-2,0,0,0,1,3,2,-3,1,4,1,6,5,-1,1,2,0,-2,-2,-3,6,3,0,0,-1,1,-1,-1,1,5,1
KR_6759706011,420,3,-27,40,5,0,1,1,3,4,1,-4,2,6,2,4,2,4,4,0,0,9,-125,-3,5,2,3,0,-1,1,0,1,1,4,1
KR_6678159087,420,-1,42,-35,-6,3,4,1,-7,0,7,4,6,2,-3,0,3,-3,0,3,-3,-9,3,1,4,5,2,0,2,0,-1,1,-1,0,1
KR_6756250006,420,4,26,28,9,2,2,0,3,5,2,0,1,1,3,4,1,1,1,0,0,6,38,-3,6,3,-2,0,1,1,1,1,-1,5,1
KR_6752539111,420,0,29,-15,-3,-4,0,4,-1,2,3,5,5,0,-3,1,4,0,1,1,0,-6,-1,-3,7,4,-1,0,1,-1,1,1,-1,6,1
KR_6707348695,420,3,66,-18,4,1,3,2,2,4,2,0,2,2,1,3,2,0,0,0,0,4,4,0,5,5,2,0,3,1,-1,1,1,4,1
KR_6648882198,420,2,93,34,4,0,1,1,1,1,0,3,3,0,0,0,0,0,0,0,0,4,4,1,1,2,3,0,2,1,1,1,1,4,1
KR_6693979674,420,1,65,5,6,-2,0,2,4,6,2,2,3,1,2,3,1,0,0,0,0,7,10,-2,6,4,6,0,0,1,0,0,1,1,1
KR_6572920392,420,-3,-92,-18,1,-2,1,3,3,7,4,3,4,1,-1,2,3,-2,1,3,-2,-3,73,3,5,8,1,0,0,1,1,0,-1,1,1
KR_6680040484,420,4,54,28,8,2,3,1,0,3,3,5,6,1,0,4,4,1,1,0,0,0,118,-3,6,3,-2,0,1,0,1,1,1,0,1
KR_6710396343,420,3,5,4,4,-1,0,1,4,5,1,-1,2,3,1,5,4,1,2,1,0,7,-15,-1,4,3,2,0,0,-1,-1,1,-1,4,1
KR_6666805644,420,1,-43,19,5,0,3,3,4,4,0,-2,2,4,3,4,1,0,2,2,0,10,0,-2,5,3,-4,0,-1,1,-1,-1,-1,3,1
KR_6761667036,420,-1,-48,28,0,-2,2,4,-2,3,5,1,2,1,3,3,0,0,1,1,0,5,5,1,1,2,-1,0,-1,-1,-1,-1,-1,2,1
KR_6707535760,420,0,-49,12,3,0,3,3,1,1,0,-2,1,3,4,5,1,0,0,0,0,11,119,2,5,7,4,0,0,1,0,0,-1,5,1
KR_6753473359,420,5,95,5,15,8,8,0,-2,2,4,9,10,1,0,1,1,0,0,0,0,6,37,1,2,3,0,0,1,-1,1,1,1,4,1
KR_6756820385,420,4,45,36,4,0,0,0,1,3,2,-3,0,3,3,4,1,3,5,2,0,2,-112,-1,6,5,3,0,0,0,0,0,1,0,1
KR_6742864876,420,5,110,-5,7,8,8,0,1,1,0,-1,0,1,-3,0,3,2,2,0,0,1,-276,0,2,2,-1,0,1,1,1,1,1,2,1
KR_6741648160,420,0,40,14,-1,2,3,1,-5,4,9,1,4,3,2,4,2,-1,0,1,0,-3,4,-3,4,1,2,0,1,1,1,1,1,1,1
KR_6689655461,440,9,112,24,20,3,3,0,3,3,0,2,4,2,8,9,1,4,5,1,1,20,3,4,2,6,0,0,2,1,-1,1,1,3,1
KR_6593813135,420,-1,10,0,4,2,2,0,-2,2,4,2,2,0,1,3,2,1,1,0,0,2,8,1,3,4,-1,0,0,-1,1,1,-1,2,1
KR_6141237487,440,3,37,19,12,2,6,4,2,5,3,1,3,2,6,7,1,1,3,2,2,13,7,7,1,8,1,0,1,0,0,1,1,0,1
KR_6762677228,420,5,27,23,5,2,3,1,5,6,1,-3,2,5,0,1,1,1,1,0,0,5,0,3,1,4,0,0,1,1,-1,1,-1,4,1
KR_6762737704,420,5,104,9,5,7,8,1,-1,0,1,6,6,0,-3,0,3,-4,1,5,0,-2,13,0,6,6,-7,0,3,1,1,1,1,6,1
KR_6721113336,420,0,33,8,0,2,4,2,-1,1,2,-3,2,5,2,4,2,0,1,1,0,2,15,3,3,6,-6,0,1,-1,1,1,1,2,1
KR_6704097514,420,5,34,12,21,9,10,1,3,6,3,1,2,1,5,5,0,3,3,0,3,27,13,4,1,5,1,0,2,1,-1,1,1,6,1
KR_6690182009,420,5,67,4,12,3,4,1,3,8,5,5,5,0,0,3,3,1,2,1,0,9,-7,2,3,5,6,0,2,1,1,1,1,3,1
KR_6759669997,420,-1,-40,-2,5,2,2,0,3,4,1,-1,1,2,2,6,4,-1,0,1,0,2,-1,1,6,7,5,0,0,-1,1,0,1,5,1
KR_6744145155,420,3,53,16,4,2,3,1,0,2,2,6,9,3,-4,1,5,0,0,0,0,2,10,1,6,7,-3,0,1,-1,1,1,1,3,1
KR_6755005313,420,3,83,4,7,3,3,0,4,5,1,-3,0,3,0,6,6,3,5,2,0,2,-176,1,3,4,-2,0,0,1,0,0,-1,1,1
KR_6612026840,420,3,-2,8,5,-2,1,3,5,5,0,1,1,0,2,5,3,-1,0,1,0,2,7,2,5,7,2,0,3,1,-1,1,-1,4,1
KR_6715994260,420,1,-7,11,10,0,4,4,-1,4,5,7,7,0,3,5,2,1,2,1,1,21,12,1,2,3,-3,0,-2,1,-1,-1,1,3,1
KR_6619365675,420,4,111,-1,8,4,4,0,2,4,2,-1,1,2,2,5,3,1,1,0,0,11,5,3,4,7,2,0,2,1,1,1,1,6,1
KR_6675545967,420,3,58,8,4,2,3,1,2,2,0,2,4,2,-2,2,4,0,1,1,0,8,-27,1,6,7,9,0,1,1,1,1,-1,5,1
KR_6510826612,420,5,39,10,6,-1,0,1,1,4,3,3,4,1,3,3,0,0,0,0,0,6,16,3,5,8,2,0,1,1,-1,1,1,6,1
KR_6725981109,420,2,-14,20,3,0,6,6,6,8,2,4,5,1,-5,0,5,-2,0,2,1,7,-4,5,2,7,5,0,-1,1,1,-1,-1,4,1
KR_6667357116,440,-3,-52,-16,-8,-2,1,3,-3,3,6,0,3,3,1,3,2,-4,0,4,0,-9,-32,0,4,4,-2,0,-1,-1,1,-1,-1,1,1
KR_6738638560,420,1,-21,-2,3,1,4,3,0,2,2,-2,2,4,4,4,0,0,1,1,-1,-3,-19,3,4,7,-4,0,-1,1,1,-1,-1,6,1
KR_6729086563,420,2,50,15,8,2,3,1,0,1,1,-1,1,2,4,5,1,3,3,0,0,6,-1,0,4,4,2,0,1,1,-1,1,-1,5,1
KR_6711496855,420,2,53,7,12,1,2,1,4,7,3,1,2,1,7,9,2,-1,0,1,0,10,-73,-1,7,6,13,0,1,1,1,1,1,6,1
KR_6488299352,420,0,17,0,3,1,5,4,3,6,3,-1,2,3,1,2,1,-1,0,1,0,2,2,1,4,5,-3,0,0,-1,1,0,1,5,1
KR_6762739100,420,2,31,-28,16,4,4,0,4,10,6,3,5,2,4,4,0,1,1,0,0,15,7,3,1,4,-2,0,1,1,-1,1,1,5,1
KR_6545314929,420,5,39,-28,8,1,3,2,3,9,6,3,4,1,0,4,4,1,1,0,-3,5,-10,-1,7,6,-2,0,0,1,-1,0,-1,2,1
KR_6760343505,420,0,8,-11,4,1,2,1,0,3,3,1,2,1,2,5,3,0,1,1,0,5,1,5,1,6,1,0,1,1,1,1,1,3,1
KR_5681091762,420,1,35,4,4,1,1,0,5,6,1,0,1,1,-2,1,3,0,1,1,0,6,14,6,4,10,-6,0,-1,1,-1,-1,-1,5,1
KR_6680017715,420,2,19,8,6,0,1,1,2,4,2,2,3,1,1,2,1,1,1,0,0,9,-114,0,4,4,0,0,-2,0,-1,-1,1,0,1
KR_6748413936,420,3,50,-3,6,-2,2,4,0,4,4,6,11,5,-1,3,4,3,3,0,-1,-11,3,5,2,7,1,0,2,0,1,1,-1,0,1
KR_6762316066,420,3,85,8,1,0,2,2,1,2,1,2,3,1,-1,5,6,-1,3,4,0,-7,5,-2,5,3,-1,0,0,1,-1,0,-1,6,1
KR_6757659345,420,8,119,4,24,7,8,1,5,5,0,3,4,1,9,9,0,0,2,2,0,24,4,4,1,5,1,0,3,1,1,1,1,5,1
KR_6755691102,420,4,51,9,9,2,3,1,2,4,2,2,3,1,2,4,2,1,1,0,0,7,1,-3,6,3,5,0,0,1,1,1,1,3,1
KR_6715139168,420,4,106,12,0,0,1,1,1,1,0,-6,2,8,4,4,0,1,2,1,0,0,9,0,4,4,1,0,1,-1,-1,1,-1,3,1
KR_6731171164,440,5,99,32,19,1,3,2,7,8,1,1,2,1,9,10,1,1,6,5,2,15,83,-1,3,2,8,0,2,-1,0,1,1,2,1
KR_6459111095,420,-1,-44,4,-6,3,5,2,-1,3,4,-5,0,5,1,2,1,-4,1,5,0,-6,3,-3,4,1,0,0,-1,1,-1,-1,1,2,1
KR_6556359195,420,3,46,28,5,8,8,0,2,4,2,-1,2,3,-2,5,7,-2,1,3,1,-3,259,-3,7,4,-9,0,1,1,-1,1,1,5,1
KR_6751999244,420,0,-29,-1,1,1,2,1,2,2,0,7,7,0,-3,0,3,-6,0,6,0,-3,0,-3,7,4,1,0,0,0,1,1,-1,0,1
KR_6752151214,440,1,-9,-1,4,-3,0,3,7,8,1,0,1,1,2,3,1,-2,0,2,-1,6,-3,-3,7,4,0,0,-1,-1,-1,-1,-1,5,1
KR_6736583134,420,0,63,-8,6,0,2,2,-3,1,4,-1,4,5,7,10,3,3,4,1,1,5,1,-3,5,2,2,0,1,1,-1,-1,1,3,1
KR_6665200357,420,0,-5,-13,3,-1,1,2,8,9,1,-1,1,2,-2,0,2,-1,0,1,0,2,5,5,5,10,2,0,1,1,1,1,1,1,1
KR_6759273185,420,4,-6,6,9,2,2,0,5,6,1,1,3,2,-1,1,2,2,4,2,0,17,3,-2,7,5,-2,0,1,1,1,1,1,1,1
KR_6648225681,420,-3,12,0,-17,-5,0,5,-4,6,10,1,2,1,-9,5,14,0,0,0,-2,-20,-7,-4,7,3,-1,0,-1,0,1,-1,-1,0,1
KR_6751230570,420,3,55,28,1,6,6,0,-1,3,4,-2,3,5,-2,2,4,0,1,1,-2,0,-5,-1,4,3,2,0,1,-1,1,1,-1,3,1
KR_6731969323,420,-3,-33,-20,-8,-6,0,6,-3,0,3,2,6,4,-1,2,3,0,2,2,0,-4,-3,5,1,6,0,0,0,-1,1,0,1,4,1
KR_6562328228,420,1,19,-26,0,1,1,0,1,4,3,-1,0,1,-1,1,2,0,1,1,0,-1,-20,-1,5,4,4,0,2,1,-1,1,1,5,1
KR_6708282069,420,0,60,0,-1,1,1,0,1,3,2,-5,2,7,4,5,1,-2,1,3,0,3,1,0,5,5,-2,0,0,-1,1,1,1,5,1
KR_6563512700,420,2,72,14,0,-1,0,1,4,5,1,-1,4,5,-2,0,2,0,1,1,0,-6,15,1,4,5,-1,0,1,1,-1,1,-1,6,1
KR_6743283690,420,-6,-26,-10,-10,-1,2,3,-2,1,3,-3,0,3,-3,0,3,-1,1,2,0,-8,2,-4,8,4,6,0,-1,0,-1,-1,-1,0,1
KR_6733982529,420,-1,-5,19,-3,2,3,1,-9,1,10,1,4,3,0,1,1,3,3,0,1,-2,-226,3,5,8,1,0,1,-1,1,1,1,4,1
KR_6650264730,440,3,10,7,9,0,1,1,2,5,3,6,7,1,2,3,1,-1,0,1,0,6,47,1,6,7,-19,0,1,1,-1,1,1,5,1
KR_6728536865,420,1,63,8,-1,-3,3,6,-1,2,3,1,2,1,4,5,1,-2,0,2,1,-3,-12,-4,5,1,0,0,0,-1,1,0,1,3,1
KR_6731178718,420,4,22,36,5,1,5,4,2,5,3,1,2,1,2,2,0,-1,1,2,0,2,-5,3,3,6,3,0,-1,1,-1,-1,-1,1,1
KR_6749328871,420,-2,-26,-30,-1,-6,0,6,4,5,1,1,4,3,2,4,2,-2,1,3,1,6,-3,1,3,4,3,0,0,0,-1,-1,1,0,1
KR_6737827026,440,-1,-44,34,-1,-5,0,5,6,6,0,-5,0,5,-1,2,3,4,4,0,1,6,-11,-2,4,2,-3,0,0,0,1,-1,1,0,1
KR_6749623498,420,3,64,34,8,2,2,0,2,2,0,2,4,2,1,1,0,1,1,0,1,12,4,-1,4,3,4,0,2,1,0,1,1,3,1
KR_6731406329,420,0,3,-7,-2,0,1,1,1,3,2,-1,2,3,1,1,0,-3,0,3,0,-3,19,3,5,8,0,0,1,1,1,1,-1,1,1
KR_6664621947,420,-1,39,1,2,1,1,0,2,2,0,1,3,2,-1,2,3,-1,1,2,0,-3,-27,-4,6,2,19,0,0,1,1,0,1,2,1
KR_6668243166,420,-1,20,16,-5,1,3,2,-1,0,1,0,0,0,-3,0,3,-2,0,2,0,-9,-60,0,3,3,-3,0,1,-1,1,1,-1,6,1
KR_6761372543,420,0,33,-3,8,1,3,2,5,5,0,3,4,1,0,1,1,-1,1,2,0,7,-40,3,2,5,18,0,0,-1,1,0,1,4,1
KR_6629574828,420,5,126,20,7,8,8,0,1,6,5,-5,2,7,2,4,2,1,2,1,0,0,-33,3,2,5,23,0,3,-1,1,1,1,4,1
KR_6695512343,420,-2,-2,5,-3,1,3,2,4,7,3,-3,2,5,0,2,2,-5,1,6,0,1,-4,2,4,6,-2,0,0,-1,1,0,-1,2,1
KR_6732803083,420,3,42,-17,8,4,5,1,0,4,4,2,6,4,1,3,2,1,2,1,1,4,-4,3,1,4,0,0,2,1,1,1,1,1,1
KR_6740736726,440,2,49,23,-1,-1,0,1,1,3,2,3,3,0,-2,0,2,-2,1,3,0,1,-93,3,3,6,-4,0,0,-1,1,0,1,3,1
KR_6612802268,440,3,-54,5,3,-1,0,1,0,3,3,0,0,0,4,6,2,0,0,0,-2,3,4,-2,4,2,-3,0,0,-1,-1,-1,-1,6,1
KR_6675910323,420,7,145,28,8,1,2,1,4,7,3,2,3,1,0,0,0,1,1,0,0,1,-3,-3,7,4,2,0,2,-1,1,1,1,6,1
KR_6720500729,420,0,-31,-15,4,-5,0,5,4,5,1,2,4,2,4,7,3,-1,0,1,0,10,-10,1,2,3,2,0,0,1,-1,-1,-1,2,1
KR_6672021728,420,5,88,11,8,3,4,1,5,7,2,0,1,1,0,3,3,0,0,0,0,9,1,-2,7,5,-4,0,2,1,-1,1,-1,6,1
KR_6657129181,420,-2,-33,-8,-2,-1,0,1,1,3,2,0,4,4,-6,1,7,4,4,0,-1,-1,12,-2,5,3,0,0,-1,-1,1,-1,-1,1,1
KR_6566989645,420,1,-52,-45,5,4,5,1,5,6,1,-2,1,3,0,3,3,-2,1,3,0,7,232,-1,7,6,4,0,0,1,-1,-1,1,6,1
KR_6736841161,420,-1,-10,-34,4,2,4,2,-1,4,5,-1,4,5,4,4,0,0,0,0,0,-3,10,1,2,3,-2,0,2,1,1,1,1,5,1
KR_6675595342,420,5,25,34,5,-1,0,1,6,10,4,1,3,2,-1,3,4,0,0,0,0,1,2,1,3,4,-2,0,1,1,1,1,1,1,1
KR_6663674921,420,0,2,24,4,0,0,0,2,2,0,2,2,0,-1,1,2,1,2,1,0,5,8,0,4,4,2,0,1,0,1,1,-1,0,1
KR_6764296182,420,5,127,1,6,2,3,1,4,6,2,-1,2,3,-1,1,2,2,4,2,0,3,-3,-2,6,4,-1,0,1,1,1,1,1,6,1
KR_6658015645,420,-1,-22,9,-2,-5,1,6,-3,0,3,5,8,3,1,4,3,0,0,0,0,5,2,1,3,4,-2,0,-1,1,-1,-1,-1,1,1
KR_6707405062,420,6,63,26,8,2,3,1,-1,2,3,6,6,0,1,2,1,0,0,0,0,2,26,1,2,3,-6,0,1,1,-1,1,1,2,1
KR_6751921938,420,-2,26,-2,-6,8,8,0,-6,1,7,-4,4,8,-4,0,4,0,0,0,0,-19,-30,-3,5,2,6,0,2,-1,1,1,-1,4,1
KR_6761925548,420,0,-36,-16,-10,3,4,1,-6,1,7,-3,2,5,0,6,6,-4,0,4,-2,-13,8,2,6,8,-2,0,0,-1,1,0,-1,3,1
KR_6756282885,420,4,33,-8,6,6,7,1,-2,1,3,0,4,4,-1,4,5,3,3,0,0,9,-7,-5,8,3,6,0,1,-1,1,1,1,6,1
KR_6641693893,420,4,82,16,8,3,5,2,2,5,3,2,2,0,-2,3,5,3,3,0,0,7,1,1,4,5,1,0,1,1,1,1,-1,1,1
KR_6755845665,440,1,23,12,-3,1,2,1,-1,3,4,-3,2,5,-3,3,6,3,5,2,0,-8,-5,-1,7,6,0,0,0,1,0,-1,-1,4,1
KR_6745159512,420,-1,-4,12,-2,-3,1,4,1,3,2,0,2,2,-1,2,3,1,1,0,1,-4,-90,0,5,5,-2,0,0,-1,1,0,1,1,1
KR_6607937120,420,6,42,16,7,2,3,1,2,3,1,-3,1,4,5,5,0,1,1,0,0,6,1,-3,7,4,1,0,0,1,1,1,1,5,1
KR_6739556330,440,-1,-18,5,2,0,4,4,-2,3,5,4,6,2,1,2,1,-1,0,1,0,8,-9,3,5,8,-3,0,0,0,1,0,-1,0,1
KR_6729915595,420,2,54,-10,3,-2,1,3,4,4,0,-1,1,2,1,7,6,1,2,1,1,4,15,-1,6,5,0,0,1,-1,1,1,1,2,1
KR_6746079117,440,1,-34,-12,11,2,4,2,-1,3,4,2,2,0,4,5,1,4,5,1,2,15,8,3,4,7,-5,0,2,1,1,1,1,6,1
KR_6720227161,420,6,47,64,12,3,4,1,4,5,1,8,8,0,-2,2,4,-1,1,2,0,1,210,1,3,4,0,0,1,0,-1,1,1,0,1
KR_6642460203,420,-2,-27,-16,-4,1,1,0,-2,4,6,-3,2,5,1,1,0,-1,1,2,0,-6,-10,-4,8,4,5,0,0,1,1,0,-1,1,1
KR_6743289944,420,2,-43,9,3,3,5,2,-1,0,1,-1,1,2,3,3,0,-1,0,1,1,5,-2,-1,5,4,-4,0,0,1,-1,0,1,4,1
KR_6756125195,440,1,107,-3,6,-1,1,2,-1,3,4,-3,1,4,8,11,3,3,5,2,1,7,0,1,1,2,2,0,2,1,1,1,1,1,1
KR_6703983315,440,2,-14,18,2,0,2,2,1,4,3,2,3,1,-4,3,7,3,6,3,0,2,-1,0,5,5,3,0,0,-1,-1,0,1,6,1
KR_6699235846,440,1,43,16,6,0,0,0,3,9,6,-2,1,3,6,6,0,-1,1,2,0,13,22,1,5,6,-2,0,2,1,-1,1,1,4,1
KR_6758752620,420,-1,-28,-42,5,1,2,1,2,3,1,-1,2,3,2,6,4,1,1,0,0,13,7,-2,6,4,1,0,0,-1,-1,1,1,4,1
KR_6761457963,420,1,43,-11,1,1,3,2,0,3,3,-2,1,3,2,4,2,0,1,1,-1,4,-126,-1,7,6,-1,0,0,-1,1,0,-1,1,1
KR_6740775851,420,4,110,18,6,5,5,0,1,2,1,-6,0,6,3,4,1,3,4,1,0,4,243,-2,4,2,-5,0,1,1,0,1,1,5,1
KR_6740799482,440,1,29,-35,5,-4,0,4,1,4,3,4,4,0,4,4,0,0,0,0,0,9,-9,1,2,3,-2,0,0,1,0,0,1,6,1
KR_6650700251,420,-3,35,-23,-2,1,3,2,-1,2,3,2,4,2,-4,0,4,0,0,0,0,-3,-37,-1,5,4,20,0,0,-1,0,1,1,4,1
KR_6749784907,420,3,38,-18,9,6,6,0,-1,3,4,-1,1,2,5,7,2,0,1,1,0,1,-4,3,3,6,0,0,2,-1,1,1,1,5,1
KR_6748893336,420,3,11,0,6,7,8,1,1,2,1,0,2,2,-1,0,1,-1,1,2,0,5,1,-1,4,3,-2,0,0,-1,1,0,1,3,1
KR_6655603498,420,0,-21,-24,3,-1,2,3,2,4,2,1,4,3,-1,2,3,2,2,0,1,3,-196,3,2,5,0,0,-1,-1,-1,-1,1,3,1
KR_6764626941,420,1,-1,42,7,1,1,0,2,4,2,-1,2,3,4,6,2,1,2,1,0,5,-111,-1,4,3,4,0,3,1,1,1,1,4,1
KR_6759790652,420,1,-34,3,-3,0,4,4,1,3,2,0,3,3,-3,0,3,-1,0,1,0,-5,12,2,6,8,2,0,0,1,-1,1,1,1,1
KR_6725955181,440,1,27,-4,7,2,4,2,0,2,2,0,3,3,8,11,3,-3,1,4,0,-5,2,-1,6,5,0,0,0,1,-1,1,1,1,1
KR_6761163165,420,0,83,-24,-2,-1,3,4,1,4,3,0,3,3,-1,2,3,-1,1,2,0,-4,-41,-1,5,4,1,0,1,-1,-1,-1,1,3,1
KR_6365007081,420,3,88,-28,4,1,2,1,-1,1,2,-1,1,2,8,9,1,-3,1,4,0,0,0,0,0,0,0,0,2,-1,1,1,1,4,1
KR_6542886438,420,2,14,-20,7,4,5,1,0,1,1,2,7,5,0,3,3,1,4,3,0,15,2,0,6,6,3,0,2,1,-1,1,1,5,1
KR_6761674833,440,4,37,15,16,-2,1,3,3,4,1,-2,1,3,14,14,0,3,4,1,0,19,128,-1,4,3,-1,0,0,0,0,1,1,0,1
KR_6696350770,420,-2,-38,12,-3,-1,1,2,3,4,1,-7,2,9,3,3,0,-1,1,2,-1,3,6,-2,5,3,0,0,-2,1,1,-1,-1,1,1
KR_6730204993,420,2,19,31,5,4,4,0,0,3,3,0,2,2,3,4,1,-2,0,2,1,1,3,2,4,6,1,0,0,1,1,1,1,3,1
KR_6753675175,420,2,57,25,3,-2,0,2,4,4,0,-1,3,4,1,3,2,1,3,2,0,2,-6,-7,10,3,3,0,1,1,1,1,1,3,1
KR_6763463480,420,0,13,3,4,-2,1,3,6,7,1,-1,0,1,1,6,5,0,1,1,0,5,-1,-1,3,2,-1,0,0,-1,-1,0,1,5,1
KR_6737762312,420,3,33,1,10,2,3,1,4,5,1,0,0,0,3,3,0,1,1,0,0,11,-29,-9,11,2,7,0,1,-1,1,1,1,2,1
KR_6624506332,420,1,57,25,2,3,4,1,2,5,3,-4,0,4,2,2,0,-1,0,1,0,1,-27,3,4,7,-4,0,2,-1,1,1,-1,2,1
KR_6699738807,420,5,106,8,19,1,2,1,6,9,3,3,6,3,7,7,0,2,2,0,0,22,6,5,3,8,-7,0,1,1,1,1,1,5,1
KR_6662932320,420,1,-21,6,5,3,3,0,0,4,4,3,6,3,0,6,6,-1,0,1,0,-3,18,0,4,4,0,0,0,1,1,0,1,2,1
KR_6570945522,440,-2,-38,-19,-9,-4,1,5,-1,2,3,-2,2,4,0,1,1,-2,0,2,1,-10,1,2,4,6,-10,0,-3,-1,-1,-1,1,5,1
KR_6754480977,420,4,17,-4,11,3,3,0,0,0,0,1,2,1,3,4,1,4,4,0,0,10,-1,4,4,8,5,0,2,1,-1,1,1,1,1
KR_6572658608,420,0,-11,-5,-7,-1,1,2,7,9,2,-6,0,6,-5,1,6,-2,0,2,0,-16,-150,5,6,11,-10,0,1,-1,1,-1,1,6,1
KR_6764715882,440,-1,-98,1,-5,-8,1,9,4,5,1,0,0,0,-1,1,2,0,0,0,0,7,-8,-4,5,1,1,0,-2,-1,-1,-1,-1,5,1
KR_6679495530,420,2,13,7,7,3,3,0,4,5,1,3,4,1,-2,0,2,-1,0,1,0,10,1,0,6,6,4,0,1,-1,1,1,1,4,1
KR_6698473705,420,1,-28,10,5,5,7,2,6,8,2,-4,1,5,-2,1,3,0,0,0,0,3,-49,-1,4,3,18,0,0,-1,1,1,1,4,1
KR_6726205880,420,2,61,-4,3,3,5,2,3,5,2,-1,0,1,-1,1,2,-1,1,2,0,5,12,-4,6,2,-3,0,0,1,1,1,1,6,1
KR_6746677604,420,9,120,30,18,4,4,0,3,3,0,-2,1,3,3,3,0,10,10,0,0,17,-16,0,2,2,4,0,1,1,1,1,1,6,1
KR_6753292518,440,-1,15,1,8,1,2,1,-1,3,4,0,2,2,8,13,5,0,0,0,0,14,14,1,6,7,2,0,1,1,1,1,1,4,1
KR_6742971344,420,5,26,-8,8,-1,2,3,1,4,3,8,9,1,0,3,3,0,1,1,0,7,216,2,3,5,-6,0,3,1,1,1,-1,4,1
KR_6660277521,440,1,10,-12,0,2,2,0,0,1,1,-6,0,6,2,2,0,2,2,0,0,-4,3,-4,7,3,-1,0,0,-1,-1,-1,1,5,1
KR_6745665182,420,2,26,7,8,3,5,2,0,3,3,0,2,2,5,5,0,0,1,1,1,3,6,0,1,1,0,0,2,1,1,1,1,4,1
KR_6759615998,420,-2,37,-32,-9,0,0,0,-3,0,3,-4,0,4,-1,0,1,-1,1,2,0,-17,1,3,4,7,-2,0,0,-1,1,1,-1,3,1
KR_6759056817,420,3,11,-8,3,-1,2,3,2,3,1,2,4,2,3,4,1,-3,2,5,0,7,0,2,2,4,3,0,-1,1,-1,-1,1,3,1
KR_6759552899,420,5,100,24,8,2,2,0,2,3,1,5,6,1,-1,2,3,0,0,0,1,2,1,-3,5,2,0,0,1,1,1,1,1,5,1
KR_6716395785,440,2,-28,1,6,2,5,3,0,2,2,2,3,1,0,1,1,2,3,1,0,0,4,0,1,1,-3,0,3,1,1,1,1,1,1
KR_6752900265,420,2,-33,-2,4,0,0,0,6,6,0,2,3,1,-3,1,4,-1,0,1,0,4,1,3,4,7,0,0,-1,1,-1,-1,1,2,1
KR_6760500441,420,0,19,0,-4,0,1,1,0,0,0,5,6,1,-5,0,5,-4,2,6,0,-1,-7,-2,4,2,0,0,0,0,-1,-1,-1,0,1
KR_6727011467,440,3,90,20,12,5,9,4,4,6,2,-1,3,4,3,5,2,1,1,0,0,5,7,-1,4,3,-1,0,2,1,1,1,-1,2,1
KR_6629063871,420,0,76,16,-5,0,1,1,-3,2,5,1,1,0,-3,1,4,0,0,0,0,-15,6,-8,10,2,3,0,0,1,1,0,1,4,1
KR_6739803558,420,-1,5,-4,3,2,2,0,-4,3,7,2,3,1,0,4,4,3,3,0,2,-3,-14,2,3,5,-3,0,1,1,-1,1,-1,2,1
KR_6738933819,420,2,2,32,-1,2,2,0,-5,2,7,1,2,1,1,1,0,0,0,0,0,-5,7,4,3,7,0,0,1,1,1,1,-1,2,1
KR_6752957464,420,3,56,20,8,-3,1,4,5,7,2,6,9,3,1,4,3,-1,0,1,0,3,8,5,2,7,-1,0,1,1,-1,1,1,4,1
KR_6763489416,420,1,84,0,5,-1,1,2,0,2,2,2,4,2,4,4,0,0,0,0,0,0,-25,1,4,5,2,0,2,1,-1,1,1,2,1
KR_6761102684,420,3,-55,22,5,-1,1,2,1,2,1,0,3,3,2,5,3,3,3,0,0,3,0,-3,5,2,0,0,2,0,1,1,1,0,1
KR_6755486094,420,0,42,26,0,-3,0,3,3,5,2,2,5,3,-2,3,5,0,1,1,0,-1,-102,-1,7,6,2,0,-1,-1,-1,-1,1,3,1
KR_6749648599,420,3,97,24,6,3,7,4,2,4,2,0,2,2,0,3,3,1,1,0,0,0,-105,2,2,4,3,0,1,1,1,1,1,5,1
KR_6655069433,420,-2,-30,-3,3,-4,0,4,1,2,1,6,7,1,3,7,4,-3,0,3,-2,4,1,4,3,7,1,0,0,1,1,1,-1,4,1
KR_6736545126,420,4,59,20,13,4,7,3,5,7,2,6,6,0,1,5,4,-3,1,4,2,7,7,5,2,7,-5,0,1,1,1,1,1,1,1
KR_6694622078,420,0,34,-26,3,-5,1,6,2,3,1,3,3,0,4,7,3,-1,1,2,0,14,-8,1,5,6,0,0,0,1,-1,1,1,6,1
KR_6665951913,420,1,26,28,1,1,2,1,3,3,0,3,6,3,-6,0,6,0,0,0,0,-5,7,3,3,6,-1,0,1,-1,1,1,-1,5,1
KR_6764562702,420,3,-6,-12,4,6,6,0,-2,1,3,-3,0,3,-1,3,4,4,5,1,0,-4,-13,0,7,7,0,0,1,0,-1,1,-1,0,1
KR_6669977171,420,2,116,23,12,4,4,0,1,3,2,7,7,0,1,3,2,-1,0,1,0,2,-12,4,4,8,3,0,2,1,1,1,1,6,1
KR_6434156932,420,4,-2,-4,3,-2,0,2,3,5,2,-1,1,2,1,1,0,2,3,1,0,4,3,0,5,5,0,0,0,-1,-1,0,-1,4,1
KR_6731408836,420,-1,-19,-1,-8,1,3,2,-4,3,7,-9,1,10,2,4,2,2,2,0,0,-8,1,-1,6,5,0,0,-2,1,1,-1,-1,5,1
KR_6681290274,420,-2,20,-1,1,-1,1,2,-1,2,3,-2,1,3,4,8,4,1,1,0,0,3,5,-4,12,8,-1,0,1,1,-1,1,1,2,1
KR_6659939811,440,0,-32,14,5,-3,0,3,-1,2,3,5,8,3,5,5,0,-1,0,1,0,-2,19,8,1,9,-4,0,1,1,0,1,1,2,1
KR_6633216840,420,-2,27,-36,-1,0,1,1,-1,1,2,-1,2,3,2,4,2,-1,1,2,0,3,102,3,5,8,1,0,-1,-1,-1,-1,-1,3,1
KR_6667168006,420,-1,-8,16,0,1,3,2,-1,3,4,-2,1,3,2,5,3,0,0,0,0,-3,-5,-1,6,5,2,0,0,1,1,0,1,4,1
KR_6728622438,420,-3,-94,2,-3,-2,0,2,-3,2,5,-2,2,4,2,2,0,2,2,0,0,2,9,-2,5,3,-1,0,0,1,1,-1,1,3,1
KR_6761285872,420,4,66,8,18,3,5,2,5,7,2,2,2,0,8,9,1,0,2,2,0,12,8,2,4,6,-2,0,0,1,0,1,1,3,1
KR_6763484546,420,3,42,14,11,2,3,1,1,2,1,3,4,1,2,4,2,3,4,1,0,9,5,3,5,8,1,0,0,-1,0,0,-1,6,1
KR_6732989365,420,4,41,-20,4,-3,0,3,5,9,4,0,3,3,2,4,2,0,2,2,-1,8,3,-4,9,5,0,0,0,-1,-1,1,-1,6,1
KR_6661640100,420,-7,-45,-64,-2,2,3,1,-3,0,3,4,5,1,-3,0,3,-2,2,4,0,-9,2,-2,7,5,1,0,1,-1,1,1,-1,1,1
KR_6708447111,420,-1,25,-6,3,0,2,2,3,4,1,0,4,4,1,1,0,-1,0,1,0,6,-3,1,2,3,-2,0,0,1,-1,0,1,2,1
KR_6688479236,420,1,-36,24,-1,4,6,2,0,2,2,-2,0,2,-1,2,3,-2,1,3,0,-3,10,5,2,7,-5,0,0,0,0,1,-1,0,1
KR_6761499231,420,0,0,11,0,4,6,2,-1,0,1,-4,1,5,0,1,1,1,1,0,1,1,5,-4,7,3,1,0,2,-1,-1,-1,1,3,1
KR_6733226511,420,3,56,31,8,5,5,0,4,6,2,1,1,0,-2,0,2,0,1,1,0,5,5,-3,7,4,3,0,1,-1,1,1,1,1,1
KR_6764454910,420,5,31,27,3,1,3,2,1,1,0,1,2,1,-1,0,1,1,1,0,0,0,12,0,4,4,-3,0,2,1,1,1,-1,6,1
KR_6702504719,420,-4,-4,-41,-8,0,1,1,-6,1,7,5,6,1,-6,1,7,-1,1,2,-1,-18,0,5,4,9,2,0,0,1,1,1,-1,2,1
KR_6745608084,420,-1,-28,11,3,-1,1,2,-2,0,2,-1,3,4,4,5,1,3,4,1,1,5,-32,6,2,8,29,0,0,1,-1,0,1,6,1
KR_6706334501,420,3,30,28,5,0,0,0,5,6,1,3,7,4,-2,1,3,-1,1,2,1,4,-5,-1,3,2,2,0,-1,1,-1,-1,1,2,1
KR_6561406376,420,3,33,16,-1,-3,0,3,6,6,0,1,4,3,-7,0,7,2,2,0,0,-6,7,4,7,11,-6,0,0,1,1,0,1,3,1
KR_6746799098,420,-6,-55,-17,-2,0,1,1,-1,2,3,-2,0,2,0,3,3,1,2,1,-1,-2,15,2,2,4,-3,0,0,0,-1,0,-1,0,1
KR_6303935204,420,0,-15,16,7,6,7,1,-2,1,3,-1,1,2,0,3,3,4,4,0,1,1,-4,3,2,5,1,0,1,-1,0,1,1,1,1
KR_6619660131,420,-3,6,-28,-3,2,3,1,-3,2,5,-3,2,5,0,3,3,1,1,0,0,-3,-9,-6,7,1,1,0,1,-1,1,1,-1,2,1
KR_6627005781,420,4,38,8,7,4,4,0,1,3,2,2,3,1,1,1,0,-1,0,1,1,8,-32,-2,6,4,14,0,1,-1,1,1,1,3,1
KR_6593686283,420,1,-13,0,11,1,2,1,-1,3,4,4,4,0,6,7,1,1,1,0,0,10,20,1,4,5,5,0,0,1,0,0,1,2,1
KR_6697571801,420,4,118,-7,11,-1,2,3,1,3,2,3,5,2,1,4,3,7,7,0,0,7,8,1,4,5,0,0,1,1,1,1,-1,5,1
KR_6635827641,420,2,14,-11,9,2,2,0,3,7,4,0,2,2,2,3,1,2,3,1,1,7,1,3,4,7,-3,0,1,1,1,1,1,2,1
KR_6693339081,420,-1,-11,-10,-1,2,3,1,-2,0,2,-3,1,4,2,7,5,0,1,1,0,-5,69,1,3,4,-21,0,1,-1,-1,1,-1,1,1
KR_6592860149,420,-1,0,-16,-2,-1,1,2,-4,1,5,4,4,0,1,3,2,-2,0,2,0,-3,-41,1,2,3,1,0,-1,-1,1,-1,-1,6,1
KR_6732264868,420,9,71,12,21,4,4,0,6,6,0,3,4,1,4,4,0,4,4,0,0,18,6,1,5,6,5,0,1,1,1,1,-1,4,1
KR_6678581305,420,-2,27,16,-6,-2,2,4,-4,1,5,2,3,1,-2,2,4,0,0,0,1,-9,-2,1,4,5,-1,0,-1,1,-1,-1,1,4,1
KR_6590334158,420,1,-5,9,6,-3,0,3,7,9,2,3,4,1,-2,1,3,1,1,0,0,7,-1,2,1,3,2,0,1,1,1,1,-1,2,1
KR_6726117750,440,-2,-32,2,-2,-2,1,3,-1,0,1,0,3,3,1,2,1,0,1,1,1,0,-120,1,7,8,-3,0,-1,1,-1,-1,1,5,1
KR_6746894929,420,-3,-31,-8,1,-2,1,3,1,3,2,1,2,1,0,4,4,1,2,1,2,4,-3,-2,7,5,1,0,0,1,1,0,1,4,1
KR_6681215692,420,5,43,-4,14,1,2,1,0,1,1,2,5,3,7,8,1,4,7,3,1,17,45,2,3,5,-12,0,1,1,-1,1,1,2,1
KR_6729294233,420,0,-15,-44,6,1,3,2,-4,1,5,1,1,0,7,7,0,1,3,2,0,8,-11,3,3,6,-1,0,0,-1,-1,-1,-1,1,1
KR_6698486799,420,6,88,24,8,4,4,0,0,2,2,3,3,0,-2,1,3,3,3,0,0,11,32,1,4,5,-1,0,2,0,1,1,1,0,1
