matchId,queueId,Diff_LV,Diff_CS,Diff_jglCS,Diff-K,Diff-K-top,K-WIN-top,K-LOSE-top,Diff-K-jug,K-WIN-jug,K-LOSE-jug,Diff-K-mid,K-WIN-mid,K-LOSE-mid,Diff-K-ad,K-WIN-ad,K-LOSE-ad,Diff-K-sup,K-WIN-sup,K-LOSE-sup,invadeKill,Diff-A,Diff_WARDplaced,Diff-ControlWARDplaced,LOSE_controlWARDPlaced,WIN_controlWARDPlaced,Diff_WARDkill,Diff_Inhibitor,Diff_TOWERkill,Diff_FirstDRAGON,Diff_FirstHERALD,Diff_Firsttower,Diff_FirstBLOOD,dragonType,result
KR_6762175317,420,-2,-7,48,-9,-1,2,1,-4,5,1,-6,7,1,0,1,1,2,1,3,0,-3,-8,1,-1,0,0,0,0,-1,-1,0,-1,3,-1
KR_6734045376,420,-6,-39,-25,-12,-5,5,0,-5,7,2,-3,7,4,3,1,4,-2,3,1,0,-8,-7,0,-4,4,1,0,-1,1,-1,-1,-1,6,-1
KR_6753652615,420,-8,-86,-44,-16,-1,1,0,-2,4,2,-6,7,1,-5,5,0,-2,2,0,0,-13,-5,-2,-3,5,-4,0,-3,-1,-1,-1,-1,1,-1
KR_6748003081,420,-1,-24,-16,3,0,2,2,-2,3,1,1,1,2,1,4,5,3,3,6,-1,7,-3,-5,-4,9,4,0,1,-1,1,1,-1,1,-1
KR_6752692309,420,-1,-24,33,-7,1,1,2,2,1,3,-4,6,2,-3,4,1,-3,3,0,0,-14,1,1,-6,5,-1,0,0,1,0,0,-1,2,-1
KR_6750312874,420,-1,-52,-15,-1,0,2,2,-2,2,0,-2,4,2,4,0,4,-1,1,0,0,5,-11,-3,-1,4,0,0,-1,-1,0,-1,-1,3,-1
KR_6629363219,420,1,-29,-28,1,2,1,3,-2,3,1,0,4,4,1,2,3,0,2,2,-1,2,-3,-5,-3,8,-3,0,-2,-1,-1,-1,-1,3,-1
KR_6730420384,440,0,-97,20,-4,0,1,1,3,0,3,-4,7,3,-3,3,0,0,0,0,0,-3,-2,1,-5,4,-1,0,0,-1,1,0,1,4,-1
KR_6760293708,420,2,-11,4,9,5,0,5,5,2,7,-1,4,3,1,2,3,-1,3,2,0,1,-5,1,-3,2,1,0,0,1,1,1,1,6,-1
KR_6761434250,420,-7,-158,-20,-17,-9,11,2,1,0,1,-2,5,3,-3,3,0,-4,4,0,0,-15,-5,-1,0,1,0,0,-2,-1,-1,-1,-1,1,-1
KR_6700009336,440,-6,-83,-20,-13,-1,3,2,2,0,2,-9,9,0,-3,4,1,-2,2,0,1,-10,-34,-1,-4,5,21,0,-2,-1,-1,-1,1,3,-1
KR_6751180190,420,-4,-55,-23,-8,-2,4,2,1,1,2,-2,3,1,-4,4,0,-1,1,0,0,-3,-129,1,-4,3,1,0,-1,-1,1,-1,-1,5,-1
KR_6741336196,420,-5,-124,-52,-9,0,1,1,-2,2,0,-6,8,2,6,0,6,-7,8,1,-1,0,27,0,-2,2,0,0,-2,-1,0,-1,-1,6,-1
KR_6667533405,420,0,44,0,0,3,1,4,0,1,1,-3,3,0,0,3,3,0,1,1,0,-7,-7,-1,-2,3,0,0,0,-1,1,1,-1,2,-1
KR_6693402882,420,-3,-47,23,-6,-1,4,3,-2,3,1,-4,5,1,1,1,2,0,1,1,0,-5,-470,-4,-2,6,6,0,-1,-1,-1,-1,1,3,-1
KR_6757971713,420,-2,9,-36,-4,-6,7,1,4,0,4,1,2,3,-4,7,3,1,1,2,0,0,-97,-3,0,3,-1,0,-1,1,-1,-1,1,6,-1
KR_6723892869,420,-4,-32,-20,-13,-1,3,2,-6,6,0,-7,8,1,0,3,3,1,1,2,-2,-17,-1,2,-6,4,-2,0,-1,-1,-1,-1,-1,3,-1
KR_6679343588,420,-4,-24,-16,-7,-3,4,1,0,3,3,-1,2,1,-2,8,6,-1,4,3,0,-7,-17,0,-2,2,-2,0,-1,1,-1,-1,-1,1,-1
KR_6612302290,420,-1,37,53,-3,-6,6,0,4,1,5,0,2,2,-1,3,2,0,0,0,1,1,-12,-2,-3,5,1,0,1,-1,-1,1,1,5,-1
KR_6678417458,440,0,59,-35,0,0,1,1,-2,5,3,-3,6,3,6,1,7,-1,2,1,-1,9,5,-3,-1,4,1,0,0,-1,-1,1,-1,2,-1
KR_6744086223,420,-1,10,-7,1,2,0,2,-4,4,0,-1,2,1,-1,2,1,5,2,7,0,5,-62,-4,-5,9,-4,0,0,-1,1,0,-1,1,-1
KR_6760609609,420,-5,-104,-4,-8,0,0,0,1,3,4,0,4,4,-5,5,0,-4,4,0,0,-11,-355,-6,-3,9,2,0,-2,-1,-1,-1,-1,4,-1
KR_6632669051,420,-3,-36,-35,1,-2,4,2,-2,4,2,3,0,3,2,0,2,0,1,1,0,5,2,2,-5,3,0,0,0,1,-1,0,1,2,-1
KR_6628653088,420,0,-18,-4,-1,1,0,1,-1,4,3,-2,7,5,3,0,3,-2,2,0,2,9,33,2,-4,2,-30,0,-1,1,-1,-1,1,5,-1
KR_6702297347,420,-2,8,9,-12,-3,4,1,-1,2,1,-3,3,0,-3,4,1,-2,3,1,0,-9,-21,-2,-1,3,1,0,1,-1,-1,1,1,3,-1
KR_6375865177,420,1,25,16,8,4,1,5,0,2,2,2,0,2,0,1,1,2,0,2,1,7,0,0,0,0,2,0,0,-1,1,-1,1,2,-1
KR_6750100779,420,3,45,-12,6,0,2,2,3,3,6,-1,5,4,3,5,8,1,1,2,1,12,-15,-3,-4,7,0,0,0,1,-1,1,-1,3,-1
KR_6658606685,420,-3,4,-12,-9,0,2,2,-8,12,4,1,0,1,-1,3,2,-1,2,1,-1,-11,-7,-2,-6,8,5,0,-1,1,1,-1,-1,6,-1
KR_6755579858,420,2,-7,33,1,1,0,1,-5,5,0,-1,2,1,5,1,6,1,1,2,0,2,-231,1,-6,5,2,0,0,0,-1,0,-1,0,-1
KR_6678884311,420,-5,-28,-40,-8,-2,2,0,-6,6,0,1,1,2,-1,1,0,0,0,0,0,-6,3,2,-4,2,-5,0,0,-1,1,0,-1,1,-1
KR_6755646982,420,-1,-25,12,-6,-1,2,1,-3,4,1,4,1,5,-5,6,1,-1,5,4,0,-12,-29,-1,-1,2,-1,0,-1,-1,-1,-1,-1,5,-1
KR_6663436976,420,2,9,0,5,-2,2,0,6,2,8,-2,5,3,2,3,5,1,0,1,0,12,-89,0,-4,4,-2,0,2,-1,-1,1,1,1,-1
KR_6734550440,420,-6,22,8,-18,0,1,1,-4,6,2,-3,4,1,-9,9,0,-2,2,0,-1,-31,-4,0,-4,4,-3,0,0,0,1,-1,-1,0,-1
KR_6759373549,420,-1,-30,-28,9,1,0,1,-2,4,2,-4,8,4,9,1,10,5,1,6,0,15,3,8,-11,3,-3,0,0,-1,-1,0,1,4,-1
KR_6724699742,420,-1,-90,-21,-1,0,0,0,3,0,3,-2,4,2,-2,2,0,0,3,3,0,5,-8,1,-8,7,1,0,-2,-1,-1,-1,-1,6,-1
KR_6758410186,440,-1,13,8,-16,-1,2,1,-3,3,0,2,0,2,-13,13,0,-1,1,0,0,-18,-7,-1,-4,5,1,0,0,-1,1,-1,-1,3,-1
KR_6750174628,420,-9,-122,-20,-19,-6,7,1,2,0,2,-6,7,1,-10,11,1,1,1,2,-2,-19,3,0,-2,2,-1,0,-3,-1,1,-1,-1,1,-1
KR_6739535763,420,-3,-69,-27,-4,-4,5,1,-3,5,2,-3,3,0,5,2,7,1,0,1,-2,6,-25,3,-7,4,-1,0,0,-1,-1,0,-1,3,-1
KR_6726299552,420,-6,-128,-48,-16,-4,5,1,-4,6,2,-6,6,0,-3,8,5,1,0,1,0,-10,2,1,-2,1,2,0,-2,-1,-1,-1,-1,1,-1
KR_6618334458,420,0,-21,-4,-3,3,0,3,-5,5,0,2,0,2,0,3,3,-3,4,1,-1,-4,-5,2,-6,4,1,0,-1,1,0,-1,-1,4,-1
KR_6715118996,420,-6,-33,7,-5,-3,3,0,-1,2,1,-1,3,2,0,1,1,0,0,0,0,-5,7,3,-6,3,-4,0,0,1,1,-1,-1,2,-1
KR_6750845368,420,-3,-54,-8,-3,0,0,0,-1,1,0,2,0,2,-3,5,2,-1,2,1,0,-5,-15,-2,-3,5,2,0,0,-1,1,0,-1,6,-1
KR_6760470920,420,0,-40,19,2,3,1,4,-4,4,0,4,2,6,1,1,2,-2,2,0,0,1,17,1,-2,1,-3,0,-1,0,1,-1,1,0,-1
KR_6705514945,420,2,80,4,11,2,1,3,0,5,5,-1,4,3,8,0,8,2,0,2,0,23,5,-2,-2,4,3,0,1,-1,-1,1,1,3,-1
KR_6753480537,420,-5,-66,-20,-14,-2,2,0,-2,3,1,-6,7,1,-6,9,3,2,0,2,0,-6,-2,-8,-2,10,3,0,-1,-1,0,-1,-1,6,-1
KR_6691027210,420,-1,-50,12,-3,-8,9,1,4,2,6,0,0,0,0,2,2,1,1,2,0,-1,24,1,-3,2,0,0,-1,-1,1,-1,-1,3,-1
KR_6750364033,420,-2,-31,12,-12,-5,6,1,-3,4,1,-2,4,2,-1,2,1,-1,2,1,0,-9,4,4,-4,0,-3,0,-2,-1,-1,-1,-1,3,-1
KR_6753456137,420,-3,-10,-12,-7,3,1,4,-7,8,1,1,2,3,-5,6,1,1,1,2,0,-6,48,-4,-1,5,-20,0,0,0,1,1,1,0,-1
KR_6632715647,420,3,-13,-30,7,0,2,2,2,2,4,-1,4,3,0,3,3,6,0,6,0,11,3,4,-5,1,3,0,1,1,-1,1,-1,5,-1
KR_6633307736,420,2,-32,-8,6,1,1,2,2,1,3,2,3,5,0,3,3,1,0,1,0,7,1,3,-4,1,1,0,1,-1,1,1,1,2,-1
KR_6714399565,420,-1,23,-14,-3,5,0,5,-3,5,2,-4,4,0,-1,2,1,0,0,0,0,-4,-2,3,-4,1,-1,0,1,-1,1,1,1,5,-1
KR_6509032803,420,-2,51,-35,-4,4,1,5,-3,5,2,-4,6,2,-1,2,1,0,0,0,0,-7,-12,-7,-1,8,5,0,2,1,-1,1,-1,1,-1
KR_6734162901,420,-3,-76,-4,-6,-2,2,0,1,1,2,-1,3,2,-2,2,0,-2,2,0,0,0,0,0,-3,3,-2,0,-1,-1,1,-1,-1,3,-1
KR_6762464127,420,-2,29,14,-4,-1,1,0,-1,2,1,2,2,4,-2,3,1,-2,2,0,0,-4,316,-2,-2,4,3,0,0,1,1,0,1,2,-1
KR_6726509854,420,3,42,12,5,-2,4,2,5,1,6,0,4,4,2,3,5,0,1,1,-1,7,4,5,-8,3,0,0,1,1,-1,1,-1,5,-1
KR_6727342969,420,0,-15,-16,1,-2,4,2,4,1,5,4,0,4,-4,4,0,-1,1,0,0,2,8,2,-6,4,3,0,0,-1,-1,-1,1,3,-1
KR_6747130692,420,4,47,42,5,-1,1,0,3,1,4,1,3,4,0,2,2,2,1,3,0,11,20,4,-8,4,-12,0,1,1,1,1,1,6,-1
KR_6731530788,440,-2,-25,4,2,-1,3,2,0,3,3,2,2,4,0,2,2,1,2,3,0,2,-7,-1,-2,3,2,0,0,1,1,-1,-1,6,-1
KR_6753372225,420,-5,-30,-44,-5,-1,2,1,1,5,6,0,2,2,-4,4,0,-1,1,0,0,-7,10,6,-9,3,-4,0,-1,-1,-1,-1,1,3,-1
KR_6751721406,420,-1,-94,4,3,-1,3,2,2,3,5,1,3,4,1,2,3,0,0,0,0,14,-41,3,-4,1,10,0,-2,-1,0,-1,1,3,-1
KR_6721235255,420,1,36,-11,3,-4,5,1,4,1,5,5,0,5,-2,8,6,0,1,1,0,3,4,1,-9,8,-2,0,0,1,-1,-1,1,6,-1
KR_6761198118,420,-1,-82,-4,-4,-2,2,0,0,2,2,0,3,3,-1,2,1,-1,2,1,0,-4,-4,0,-2,2,-5,0,-2,0,-1,-1,1,0,-1
KR_6754731726,420,-3,-44,-43,-8,0,2,2,-2,2,0,-4,5,1,-2,3,1,0,0,0,1,-1,-148,2,-3,1,0,0,-1,-1,-1,-1,1,2,-1
KR_6762733862,420,-2,-15,-32,-7,2,1,3,-1,3,2,-1,4,3,-3,8,5,-4,5,1,0,-3,30,0,-4,4,-13,0,-2,-1,-1,-1,1,1,-1
KR_6734442754,440,-1,28,-56,-5,-6,6,0,3,3,6,-2,3,1,0,6,6,0,2,2,1,2,345,-2,-3,5,1,0,0,0,-1,0,1,0,-1
KR_6570040558,420,-2,-20,-10,-5,-2,2,0,-1,2,1,3,0,3,-5,7,2,0,1,1,0,-8,-2,0,-4,4,-2,0,0,-1,1,0,-1,3,-1
KR_6754719123,420,-5,-8,-23,1,-2,2,0,0,2,2,3,3,6,-1,4,3,1,1,2,0,-5,3,1,-3,2,2,0,-2,1,-1,-1,1,1,-1
KR_6275455904,420,-5,-84,-16,-8,-7,8,1,-3,4,1,4,0,4,0,5,5,-2,2,0,-1,-2,0,1,-4,3,-4,0,-1,-1,-1,-1,-1,1,-1
KR_6675871949,420,-4,-51,-17,-8,-1,1,0,0,2,2,0,1,1,-7,8,1,0,1,1,0,-10,27,0,-6,6,-1,0,-2,-1,-1,-1,-1,6,-1
KR_6756413288,420,0,-54,-12,3,-1,1,0,-1,7,6,2,0,2,2,0,2,1,0,1,0,6,186,3,-4,1,-2,0,0,1,1,-1,1,4,-1
KR_6743349889,420,-5,-88,-13,-7,0,1,1,0,3,3,-1,2,1,-5,5,0,-1,1,0,0,-9,-7,-7,0,7,3,0,-1,-1,-1,-1,-1,4,-1
KR_6744761875,420,3,20,3,5,1,0,1,2,1,3,4,0,4,-2,6,4,0,0,0,0,1,16,8,-8,0,0,0,0,1,1,0,1,6,-1
KR_6643693569,420,0,-33,-2,0,-1,2,1,-2,4,2,-1,1,0,4,3,7,0,2,2,0,1,13,-2,0,2,1,0,-1,-1,-1,-1,-1,2,-1
KR_6760464429,420,-4,-82,-31,-9,0,1,1,1,3,4,-7,8,1,-1,2,1,-2,5,3,-1,-11,-13,-3,-3,6,-1,0,0,-1,-1,-1,-1,3,-1
KR_6722368794,420,-9,-93,-24,-19,-5,6,1,4,2,6,-9,10,1,-3,4,1,-6,6,0,-1,-7,13,-1,-4,5,-2,0,-1,-1,-1,-1,-1,2,-1
KR_6727703412,420,0,18,4,-4,-2,4,2,1,3,4,-1,2,1,0,1,1,-2,3,1,0,0,353,-5,-3,8,-4,0,-1,-1,-1,-1,-1,1,-1
KR_6697329723,420,2,-10,4,2,0,2,2,1,2,3,0,0,0,2,0,2,-1,3,2,0,3,8,-2,-5,7,7,0,0,-1,-1,0,-1,1,-1
KR_6695313844,420,0,12,14,1,6,2,8,2,1,3,1,1,2,-2,5,3,-6,7,1,0,-9,-7,-2,-4,6,-5,0,-1,1,-1,1,1,3,-1
KR_6763784270,420,0,3,24,-2,4,1,5,-1,2,1,-1,2,1,-3,4,1,-1,3,2,0,-6,-167,3,-5,2,0,0,1,1,-1,1,1,6,-1
KR_6695176294,420,-2,-15,-4,5,2,0,2,3,0,3,1,2,3,0,1,1,-1,2,1,0,11,-28,3,-6,3,3,0,0,1,-1,0,1,2,-1
KR_6675613627,420,-4,-28,10,-10,1,0,1,-3,4,1,4,1,5,-10,12,2,-2,4,2,1,-12,223,1,-8,7,-1,0,0,1,-1,-1,-1,5,-1
KR_6751415948,420,-1,-15,5,-7,3,2,5,-2,4,2,-3,5,2,-6,6,0,1,1,2,0,-11,24,-2,-2,4,-2,0,0,-1,-1,0,1,1,-1
KR_6650900404,420,1,20,-16,2,2,0,2,2,0,2,3,1,4,-3,3,0,-2,2,0,0,-1,-7,2,-4,2,-1,0,0,-1,1,-1,1,4,-1
KR_6715832011,420,1,38,-5,-3,1,3,4,-3,3,0,0,2,2,-1,1,0,0,0,0,0,-6,4,-2,-4,6,-5,0,0,-1,0,1,1,6,-1
KR_6209056087,420,-4,-31,-39,-14,0,2,2,-4,5,1,-5,5,0,-5,7,2,0,0,0,0,-17,-226,1,-7,6,-5,0,0,-1,1,-1,1,3,-1
KR_6760898800,420,-1,8,12,-9,-2,3,1,1,1,2,-4,4,0,-3,4,1,-1,2,1,0,-6,118,-5,-2,7,1,0,0,-1,1,0,-1,6,-1
KR_6697912799,420,-2,-43,19,-2,0,0,0,4,2,6,-3,3,0,-2,2,0,-1,1,0,0,-6,85,-4,0,4,3,0,0,-1,-1,0,-1,1,-1
KR_6762895533,420,-4,-91,-25,-13,-1,2,1,-3,3,0,-2,2,0,0,4,4,-7,7,0,-2,-15,-199,-2,-4,6,-1,0,0,-1,-1,0,-1,6,-1
KR_6759600840,420,1,21,-12,7,3,0,3,3,0,3,0,1,1,0,2,2,1,2,3,0,6,8,5,-6,1,-1,0,1,1,1,1,1,5,-1
KR_6741743691,420,-3,-26,-15,-3,-3,3,0,-3,4,1,1,2,3,2,0,2,0,0,0,0,-3,31,-3,-2,5,1,0,0,-1,0,0,1,4,-1
KR_6733996117,420,-2,-42,-4,-10,1,2,3,-2,3,1,-2,3,1,-6,7,1,-1,1,0,0,-9,-39,-4,-1,5,0,0,-1,-1,-1,-1,-1,4,-1
KR_6735880101,420,-1,-70,15,-3,-4,5,1,1,2,3,4,0,4,-3,6,3,-1,4,3,0,-1,111,3,-6,3,-3,0,1,1,1,1,-1,5,-1
KR_6686520595,420,-3,75,-28,-11,0,3,3,-6,7,1,-2,2,0,0,2,2,-3,5,2,0,-8,-2,-4,-4,8,-1,0,-1,-1,-1,-1,1,5,-1
KR_6734673931,420,0,52,0,-2,3,1,4,-4,5,1,0,2,2,-2,2,0,1,1,2,0,-6,-1,-1,-3,4,2,0,1,1,1,1,1,5,-1
KR_6753369120,420,4,47,-7,-1,-1,2,1,-3,7,4,0,1,1,5,0,5,-2,2,0,0,1,-1,1,-2,1,-3,0,0,-1,-1,-1,-1,4,-1
KR_6665947028,420,-6,-57,-28,-8,1,2,3,-2,4,2,-6,9,3,-3,4,1,2,1,3,-2,-5,-28,1,-4,3,1,0,-3,-1,1,-1,-1,2,-1
KR_6675643092,420,-4,-69,0,-9,2,0,2,-6,8,2,0,3,3,-3,3,0,-2,2,0,1,-4,-1,0,-6,6,-1,0,-1,1,-1,-1,1,4,-1
KR_6743552593,420,1,-31,-16,5,0,1,1,0,1,1,2,2,4,3,0,3,0,0,0,0,6,-1,2,-8,6,-2,0,0,1,1,0,1,1,-1
KR_6661008872,420,-3,-41,-36,0,-3,3,0,-3,4,1,-1,3,2,7,1,8,0,1,1,0,-1,6,0,-6,6,-1,0,0,-1,1,0,-1,4,-1
KR_6743173977,420,-1,8,0,-4,-1,2,1,-4,6,2,1,2,3,0,2,2,0,4,4,0,-4,-5,5,-7,2,4,0,-2,1,-1,-1,-1,3,-1
KR_6750224161,420,-2,-11,9,-9,-1,4,3,-4,5,1,-1,2,1,0,4,4,-3,4,1,0,-7,31,4,-6,2,-4,0,-1,1,-1,-1,-1,4,-1
KR_6686485320,420,-6,-105,-12,-10,-3,4,1,3,3,6,-8,9,1,-3,3,0,1,1,2,-2,-5,3,4,-6,2,-11,0,-2,1,-1,-1,-1,5,-1
KR_6762236314,420,1,-1,9,5,1,2,3,4,5,9,1,1,2,-3,5,2,2,0,2,0,11,-247,-5,-2,7,0,0,0,-1,-1,-1,1,1,-1
KR_6715962697,420,1,-15,3,2,-1,2,1,1,1,2,-1,4,3,4,1,5,-1,3,2,0,4,160,1,-3,2,-1,0,1,-1,-1,1,-1,2,-1
KR_6756351358,420,-9,-75,-40,-22,-5,7,2,-6,6,0,-8,10,2,-1,3,2,-2,5,3,0,-8,9,-1,0,1,-2,0,-3,-1,-1,-1,-1,2,-1
KR_6594984052,420,-10,-91,-45,-32,-2,2,0,-3,5,2,-7,9,2,-12,12,0,-8,9,1,-3,-27,-8,0,-2,2,-1,0,-4,-1,-1,-1,-1,1,-1
KR_6743726008,440,1,-9,-4,2,1,0,1,-2,3,1,0,2,2,3,1,4,0,2,2,0,4,1,-1,0,1,0,0,0,1,1,0,-1,3,-1
KR_6641286275,420,-6,-34,-20,-11,-1,1,0,-1,2,1,-4,4,0,-4,4,0,-1,1,0,0,-9,2,-1,-1,2,-3,0,-1,-1,0,-1,-1,6,-1
KR_6761427628,420,1,29,11,-5,1,0,1,0,3,3,-3,4,1,-2,2,0,-1,3,2,0,-3,10,5,-7,2,-8,0,1,1,1,1,-1,4,-1
KR_6744642923,420,1,-48,58,1,3,0,3,-2,6,4,-2,4,2,2,3,5,0,0,0,0,-1,40,-1,-3,4,-1,0,0,-1,-1,-1,1,6,-1
KR_6732707690,420,-1,-34,-1,-2,-1,4,3,-4,8,4,2,1,3,1,0,1,0,0,0,0,3,-4,2,-8,6,4,0,0,-1,0,-1,1,1,-1
KR_6755532889,440,2,31,4,5,-2,3,1,8,0,8,2,1,3,-2,3,1,-1,1,0,0,4,25,5,-5,0,-7,0,0,-1,1,1,1,4,-1
KR_6671383939,420,0,44,-25,-1,1,1,2,-1,1,0,3,1,4,-2,2,0,-2,2,0,0,2,-4,0,-3,3,1,0,0,1,-1,0,1,5,-1
KR_6670268547,420,0,-46,-25,4,2,1,3,0,2,2,3,3,6,-1,3,2,0,1,1,0,8,-5,2,-5,3,-1,0,-1,1,1,-1,-1,3,-1
KR_6673560559,420,1,17,40,-1,-2,4,2,-2,2,0,0,1,1,3,2,5,0,1,1,1,1,-86,2,-3,1,2,0,0,0,0,0,1,0,-1
KR_6698915884,420,-2,16,-28,0,1,1,2,0,2,2,-2,4,2,2,0,2,-1,1,0,0,3,0,0,-5,5,1,0,-2,1,-1,-1,-1,6,-1
KR_6747420580,420,-3,-60,16,-6,-1,2,1,-1,4,3,-4,4,0,-3,4,1,3,0,3,0,-2,-8,-1,-2,3,2,0,0,-1,1,0,-1,2,-1
KR_6761666457,420,-3,-25,19,-7,0,1,1,-3,3,0,3,1,4,-6,6,0,-1,1,0,0,-9,8,4,-7,3,-2,0,-1,0,-1,-1,-1,0,-1
KR_6734730822,420,2,41,-12,3,7,0,7,-3,4,1,1,2,3,0,1,1,-2,3,1,-2,-9,13,1,-5,4,-7,0,0,1,1,1,-1,4,-1
KR_6671221544,420,-5,-28,-18,-7,-1,3,2,-2,3,1,-6,7,1,2,1,3,0,3,3,1,-5,-2,-3,-2,5,-3,0,-1,1,-1,-1,1,2,-1
KR_6677142007,420,0,31,-20,-2,1,1,2,-3,6,3,-1,3,2,2,2,4,-1,3,2,0,-1,0,1,-4,3,0,0,1,1,-1,1,1,5,-1
KR_6764677573,420,0,27,0,0,-3,3,0,4,1,5,-6,7,1,5,0,5,0,1,1,0,3,21,-7,0,7,-2,0,0,1,-1,0,1,4,-1
KR_6623030679,440,-3,-77,-11,-8,-1,2,1,-7,7,0,-3,5,2,3,1,4,0,3,3,0,-8,12,3,-4,1,-5,0,-1,0,0,-1,-1,0,-1
KR_6748714126,420,-2,-31,-40,2,1,2,3,-2,5,3,5,1,6,2,2,4,-4,5,1,1,6,8,1,-3,2,-5,0,1,1,-1,1,1,3,-1
KR_6695877370,420,0,-37,-23,-6,5,0,5,1,0,1,-3,3,0,-7,7,0,-2,4,2,0,-5,9,3,-6,3,-4,0,-1,-1,-1,-1,-1,6,-1
KR_6762277368,420,0,-2,-12,-3,-2,6,4,-3,4,1,1,4,5,-1,5,4,2,0,2,-1,-1,12,3,-5,2,-2,0,0,-1,1,0,-1,2,-1
KR_6717853772,420,-4,-44,4,-13,-4,6,2,-5,7,2,1,2,3,-7,8,1,2,0,2,-1,-16,13,-3,-2,5,2,0,-4,1,-1,-1,-1,3,-1
KR_6762443314,420,0,22,4,1,0,0,0,1,2,3,3,1,4,-1,5,4,-2,3,1,0,1,-57,-2,-2,4,1,0,0,0,-1,1,1,0,-1
KR_6749806366,420,0,-9,1,6,-1,2,1,4,2,6,0,2,2,3,1,4,0,1,1,1,4,3,2,-5,3,4,0,0,1,0,0,1,5,-1
KR_6760540311,420,-1,-24,32,-2,3,1,4,-1,2,1,-4,5,1,-2,4,2,2,0,2,0,-7,-14,-1,-4,5,-1,0,0,1,1,0,1,5,-1
KR_6761923493,420,-1,-46,3,3,-2,3,1,3,1,4,1,1,2,0,1,1,1,1,2,0,7,11,0,-2,2,-3,0,-1,1,-1,-1,-1,2,-1
KR_6727142415,420,-5,-76,-4,-11,-6,7,1,-3,3,0,-2,4,2,1,3,4,-1,2,1,1,-6,-1,0,-1,1,-1,0,-2,0,-1,-1,1,0,-1
KR_6752644385,420,-4,-1,-16,-10,-4,4,0,-1,3,2,3,2,5,-7,9,2,-1,1,0,0,-5,-17,-3,-3,6,6,0,-1,-1,1,-1,-1,1,-1
KR_6728296306,420,-4,6,-9,-9,1,0,1,-6,7,1,-3,6,3,-1,3,2,0,2,2,0,-14,1,-5,-1,6,-1,0,0,-1,1,0,1,1,-1
KR_6724416321,420,4,15,-24,9,0,1,1,6,2,8,2,1,3,1,3,4,0,0,0,-1,14,-17,1,-4,3,3,0,0,1,-1,0,-1,6,-1
KR_6762695293,420,2,-52,-19,1,-3,4,1,-3,4,1,-1,3,2,5,4,9,3,2,5,1,6,-42,0,-1,1,16,0,-2,-1,-1,-1,1,5,-1
KR_6757184105,420,-3,-55,-1,-13,2,0,2,-6,8,2,0,3,3,-8,8,0,-1,1,0,0,-13,-4,-4,-1,5,-4,0,-3,-1,-1,-1,-1,2,-1
KR_6686251046,420,3,-24,-6,2,-1,4,3,3,3,6,0,4,4,1,2,3,-1,2,1,0,2,-8,1,-3,2,1,0,-1,-1,1,-1,-1,1,-1
KR_6750883607,420,-4,-64,11,-11,1,1,2,-4,4,0,-4,8,4,-8,9,1,4,1,5,0,-16,41,-2,0,2,-20,-1,-2,1,-1,-1,-1,4,-1
KR_6726613804,420,-3,-73,-8,-6,-3,3,0,2,1,3,0,2,2,-2,3,1,-3,3,0,-2,-10,-13,-1,-6,7,-5,0,0,-1,-1,0,-1,4,-1
KR_6739731499,420,-3,-15,14,-11,-3,3,0,-2,4,2,-7,8,1,0,1,1,1,0,1,0,-9,-1,5,-7,2,-1,0,0,1,0,0,1,5,-1
KR_6698795486,420,-3,35,7,-10,4,0,4,2,1,3,-2,3,1,-12,14,2,-2,3,1,0,-12,-8,-7,-1,8,-1,0,2,-1,-1,-1,-1,1,-1
KR_6743975436,420,-8,-111,0,-14,-4,4,0,3,2,5,-4,6,2,-5,5,0,-4,4,0,0,-20,174,-3,-4,7,-1,0,-2,1,-1,-1,-1,4,-1
KR_6759263122,420,1,-21,-15,5,0,5,5,0,3,3,1,0,1,5,0,5,-1,2,1,1,4,40,6,-6,0,3,0,0,1,1,1,1,6,-1
KR_6762507721,420,-2,59,10,-5,2,1,3,-2,2,0,0,0,0,-1,2,1,-4,4,0,0,-10,0,0,-3,3,2,0,-1,-1,-1,-1,1,6,-1
KR_6753337542,420,-3,-49,9,-6,-1,4,3,-4,6,2,-2,3,1,-1,1,0,2,0,2,0,-4,39,-1,-4,5,-2,0,0,0,-1,-1,-1,0,-1
KR_6737096611,420,-1,39,-8,-2,2,1,3,-4,9,5,1,2,3,-3,8,5,2,1,3,0,-7,3,-2,-6,8,0,0,-1,0,-1,-1,1,0,-1
KR_6717180639,420,-4,-84,-31,-6,1,4,5,-5,6,1,-2,2,0,0,3,3,0,1,1,1,-7,9,-2,-7,9,-4,0,-4,-1,-1,-1,1,6,-1
KR_6729709365,420,-4,-45,8,-14,-8,9,1,0,3,3,-3,3,0,0,1,1,-3,3,0,-1,-15,-222,1,-3,2,-4,0,-1,1,-1,-1,1,5,-1
KR_6759708240,420,-2,-26,-14,-9,1,0,1,-5,5,0,-5,5,0,1,0,1,-1,1,0,0,-2,-454,0,-1,1,-1,0,-3,-1,-1,-1,-1,5,-1
KR_6585675265,420,-4,-75,-3,-4,-2,3,1,1,1,2,-1,3,2,-2,2,0,0,1,1,0,-8,4,3,-7,4,-2,0,-1,0,1,1,-1,0,-1
KR_6764535579,420,1,-93,-2,0,-3,4,1,0,0,0,-1,3,2,3,2,5,1,1,2,0,7,-42,-3,-2,5,26,0,-3,-1,-1,-1,1,1,-1
KR_6754779406,420,-3,-39,-19,-8,-5,5,0,0,2,2,3,1,4,-3,5,2,-3,3,0,-2,-10,-140,-1,-4,5,-1,0,0,-1,1,1,-1,1,-1
KR_6712005617,420,-6,-40,-22,-13,1,2,3,-5,5,0,-4,6,2,-4,7,3,-1,3,2,0,-23,-4,2,-5,3,-3,0,-3,-1,-1,-1,1,1,-1
KR_6760577619,420,-3,-78,-4,1,1,2,3,0,1,1,-2,2,0,0,1,1,2,0,2,-1,4,19,-2,-2,4,-2,0,-1,-1,0,-1,-1,3,-1
KR_6699600319,420,3,34,44,3,2,1,3,-1,4,3,1,1,2,0,3,3,1,1,2,0,-3,-55,3,-7,4,1,0,1,-1,1,1,1,3,-1
KR_6626682492,420,0,-82,-5,-3,0,0,0,1,2,3,-5,7,2,1,2,3,0,1,1,0,-5,-2,3,-7,4,4,0,-2,-1,-1,-1,-1,2,-1
KR_6762157747,420,-1,-52,15,-9,-4,5,1,1,0,1,-1,2,1,-1,3,2,-4,4,0,0,-13,80,0,-5,5,-1,0,-1,0,1,-1,-1,0,-1
KR_6628514284,420,0,41,-16,-5,-3,3,0,5,1,6,-2,5,3,-6,6,0,1,1,2,0,-7,-22,1,-5,4,6,0,-1,-1,-1,-1,-1,5,-1
KR_6758162033,420,1,2,24,-5,2,1,3,-1,2,1,1,2,3,-7,9,2,0,2,2,-2,-10,9,2,-2,0,-3,0,0,1,0,-1,-1,2,-1
KR_6757412743,420,5,19,35,6,0,2,2,2,3,5,1,2,3,-1,3,2,4,0,4,0,15,-238,1,-5,4,-8,0,1,-1,1,1,-1,3,-1
KR_6398681310,420,-2,74,4,1,3,0,3,-4,6,2,2,1,3,-1,3,2,1,1,2,0,-4,4,-1,-5,6,0,0,1,-1,-1,1,1,6,-1
KR_6605776396,420,-1,9,-12,-1,-4,4,0,6,1,7,2,0,2,-4,4,0,-1,1,0,0,0,1,2,-5,3,3,0,0,-1,-1,0,-1,1,-1
KR_6761709848,420,-2,-48,-2,-5,2,0,2,-2,2,0,-1,3,2,-4,6,2,0,0,0,0,-8,-3,2,-6,4,-4,0,-1,0,0,-1,-1,0,-1
KR_6751428877,420,-4,-17,7,-13,-1,1,0,-8,11,3,-3,4,1,1,1,2,-2,7,5,-1,-15,-3,-4,-5,9,-2,0,0,0,-1,-1,-1,0,-1
KR_6745843590,420,5,-1,98,9,-2,2,0,3,0,3,5,3,8,4,0,4,-1,1,0,0,5,0,0,-2,2,-1,0,1,1,-1,1,1,6,-1
KR_6737623346,420,-7,-70,-48,-14,-4,5,1,-7,8,1,0,1,1,-5,6,1,2,1,3,1,-11,1,0,-1,1,0,0,-2,-1,-1,-1,1,4,-1
KR_6761698926,420,-2,3,-4,0,5,1,6,0,1,1,0,2,2,1,1,2,-6,6,0,0,2,-2,2,-3,1,-3,0,1,-1,-1,1,1,2,-1
KR_6607973710,420,0,-21,-4,3,0,1,1,-1,3,2,0,2,2,1,0,1,3,0,3,0,9,6,5,-9,4,-1,0,0,-1,1,0,1,6,-1
KR_6705696652,420,0,-5,2,-3,-3,3,0,1,1,2,-2,3,1,2,0,2,-1,1,0,0,-1,11,1,-3,2,-4,0,0,1,-1,-1,-1,1,-1
KR_6757343933,420,1,-28,31,-5,3,2,5,-3,4,1,-3,4,1,-3,8,5,1,2,3,0,-4,349,3,-8,5,2,0,-1,-1,1,-1,-1,5,-1
KR_6733652097,420,0,14,32,-4,0,0,0,-6,7,1,2,1,3,-1,2,1,1,2,3,0,-6,-22,-2,-3,5,0,0,-2,1,-1,-1,-1,2,-1
KR_6745989881,420,1,-8,5,0,1,2,3,-3,3,0,5,0,5,-3,4,1,0,0,0,0,-6,-241,3,-6,3,-4,0,0,1,-1,0,1,1,-1
KR_6678379971,440,-4,-124,4,-11,-3,4,1,-2,3,1,-3,3,0,1,4,5,-4,6,2,0,-5,9,-1,-1,2,-4,0,-1,-1,-1,-1,-1,6,-1
KR_6693965087,420,-6,-33,-26,-16,-2,3,1,-6,6,0,-3,5,2,-4,5,1,-1,2,1,0,-13,-44,1,-4,3,25,0,-2,-1,1,-1,-1,5,-1
KR_6637169258,420,-4,-34,16,-8,5,1,6,-3,4,1,-6,7,1,-4,5,1,0,2,2,0,-13,2,-1,0,1,-3,0,0,-1,-1,0,-1,1,-1
KR_6764567986,420,1,3,0,4,1,0,1,5,0,5,-1,4,3,-1,3,2,0,1,1,1,7,37,2,-3,1,-18,0,-1,0,-1,-1,1,0,-1
KR_6712448354,420,-2,-73,11,-7,-6,6,0,4,0,4,-1,4,3,-2,3,1,-2,3,1,0,0,9,1,-5,4,-1,0,0,-1,-1,-1,-1,1,-1
KR_6731516497,420,-1,-41,13,3,0,3,3,-2,4,2,0,4,4,2,4,6,3,2,5,1,14,4,1,-2,1,-1,0,0,1,-1,0,1,3,-1
KR_6751990347,420,-2,-26,4,3,-4,4,0,4,1,5,2,0,2,0,4,4,1,0,1,0,8,5,7,-8,1,-5,0,-2,-1,-1,-1,-1,4,-1
KR_6752058233,420,-4,-16,-17,-7,-1,2,1,-5,6,1,-1,1,0,1,1,2,-1,1,0,0,-4,-2,3,-5,2,-6,0,-1,-1,-1,-1,-1,3,-1
KR_6636929771,420,-4,-102,12,-10,-2,2,0,-2,5,3,2,2,4,-6,7,1,-2,2,0,0,-6,1,-2,-3,5,-2,0,-1,-1,-1,-1,-1,6,-1
KR_6732856498,420,-2,-61,4,-2,3,1,4,1,4,5,-1,3,2,-4,5,1,-1,3,2,0,-5,86,-2,-4,6,3,0,-1,1,-1,-1,1,3,-1
KR_6747278551,440,-5,-134,-17,-15,-2,4,2,3,1,4,-1,4,3,-10,12,2,-5,5,0,0,-12,-6,-2,0,2,-2,0,-1,1,1,-1,-1,3,-1
KR_6726321224,420,3,-34,-21,3,-1,2,1,2,1,3,1,1,2,3,0,3,-2,2,0,0,8,3,2,-5,3,1,0,-1,-1,-1,-1,-1,4,-1
KR_6724722143,420,-2,-75,9,-8,0,1,1,0,2,2,-3,7,4,-5,5,0,0,1,1,1,-6,-5,2,-4,2,-3,0,-1,1,1,-1,1,6,-1
KR_6761265886,420,-1,-27,-12,-1,0,3,3,0,1,1,-1,1,0,0,1,1,0,1,1,0,-2,-6,1,-6,5,9,0,0,1,1,0,-1,5,-1
KR_6732512254,420,-3,-84,-20,-8,-4,6,2,2,1,3,0,4,4,-4,7,3,-2,2,0,0,-1,3,-2,-2,4,3,0,-1,-1,-1,-1,1,3,-1
KR_6721423404,420,-2,55,4,-9,-3,4,1,-5,7,2,5,3,8,-2,3,1,-4,4,0,0,-17,0,1,-4,3,-5,0,-2,-1,-1,-1,-1,2,-1
KR_6760788463,420,-4,-95,18,-9,-2,3,1,1,4,5,-6,7,1,-2,4,2,0,1,1,0,-2,-1,0,-3,3,-1,0,-1,-1,1,-1,-1,3,-1
KR_6693351723,420,-2,-67,-34,-4,-2,3,1,-2,6,4,0,1,1,2,2,4,-2,3,1,0,-1,-12,-4,-2,6,-1,0,-1,0,-1,-1,-1,0,-1
KR_6737103117,420,-6,-11,-31,-12,-3,3,0,-2,5,3,-5,6,1,0,2,2,-2,2,0,0,-16,4,3,-5,2,-5,0,-1,-1,-1,-1,1,6,-1
KR_6758910593,420,-1,-40,17,-8,-4,5,1,-1,5,4,2,1,3,-2,4,2,-3,3,0,0,-5,94,1,-4,3,2,0,0,1,1,0,-1,3,-1
KR_6751693010,420,-5,-43,-27,-4,-1,2,1,-4,5,1,-1,2,1,0,2,2,2,0,2,0,-1,5,-1,-3,4,-3,0,-1,-1,0,-1,-1,2,-1
KR_6661112358,420,0,17,0,-3,-4,7,3,0,3,3,2,0,2,1,1,2,-2,3,1,0,3,-11,0,-2,2,0,0,0,1,1,1,1,2,-1
KR_6751602628,420,-1,-9,-10,2,-1,2,1,-1,2,1,1,1,2,3,0,3,0,0,0,0,2,-5,-1,-2,3,3,0,0,1,1,0,-1,2,-1
KR_6701703533,420,3,14,13,7,-3,3,0,2,0,2,7,1,8,1,3,4,0,0,0,0,7,2,4,-5,1,-1,0,2,1,0,1,1,6,-1
KR_6649112577,420,-1,22,3,-10,-6,6,0,2,2,4,0,1,1,-7,8,1,1,0,1,0,-8,37,1,-6,5,-22,0,-1,-1,-1,-1,-1,6,-1
KR_6551503084,420,-2,-38,-16,-8,0,0,0,2,0,2,-2,3,1,-6,6,0,-2,2,0,0,-11,150,-1,-4,5,5,0,0,-1,-1,0,-1,6,-1
KR_6685607649,420,-2,-24,2,-4,-3,6,3,-2,3,1,-1,4,3,0,3,3,2,0,2,-1,-7,-1,2,-5,3,-7,0,-1,1,-1,-1,-1,1,-1
KR_6761110937,420,-2,-37,16,0,1,2,3,1,3,4,0,1,1,-3,5,2,1,0,1,1,4,-10,-1,-7,8,-1,0,0,-1,1,0,1,5,-1
KR_6742353776,420,1,82,27,0,6,0,6,0,1,1,-5,5,0,1,2,3,-2,4,2,0,-10,0,-1,-4,5,2,0,2,1,1,1,-1,3,-1
KR_6762512414,440,0,27,-12,0,-1,3,2,2,2,4,0,5,5,1,1,2,-2,4,2,-1,5,39,-2,-1,3,-20,0,0,-1,-1,0,-1,2,-1
KR_6711181701,440,0,-27,28,-8,-2,6,4,4,1,5,-2,4,2,-7,8,1,-1,2,1,-1,-2,-3,2,-4,2,-1,0,-1,1,1,-1,-1,5,-1
KR_6761377336,420,1,22,0,10,1,2,3,2,5,7,1,3,4,5,0,5,1,1,2,0,19,2,-1,-4,5,1,0,1,1,-1,1,-1,4,-1
KR_6618640343,420,1,90,0,2,2,0,2,-1,1,0,9,0,9,-4,5,1,-4,4,0,0,-7,-14,1,-3,2,-1,0,3,1,1,1,1,3,-1
KR_6763311787,420,-1,25,-1,-8,1,0,1,-3,3,0,-5,5,0,-1,1,0,0,0,0,0,-8,-13,-1,-2,3,3,0,0,-1,1,0,-1,3,-1
KR_6690343832,420,1,70,-4,3,0,1,1,0,2,2,7,1,8,-2,4,2,-2,2,0,0,-14,11,1,-3,2,-1,0,1,-1,0,1,-1,3,-1
KR_6744516794,420,-1,17,-8,3,-3,4,1,-1,4,3,3,1,4,3,0,3,1,0,1,0,3,12,5,-8,3,2,0,-1,1,-1,-1,-1,4,-1
KR_6728656523,440,-2,-76,-1,-7,0,0,0,-1,3,2,-1,2,1,-8,9,1,3,1,4,0,2,116,7,-8,1,-6,0,0,-1,0,0,-1,5,-1
KR_6756045789,440,1,56,-8,3,0,2,2,0,3,3,4,0,4,-1,4,3,0,1,1,0,-2,5,0,-2,2,-3,0,1,0,-1,1,-1,0,-1
KR_6689959576,420,2,4,20,-7,-2,2,0,0,2,2,-3,3,0,-3,5,2,1,4,5,0,-14,4,0,-6,6,-5,0,-1,-1,-1,-1,1,5,-1
KR_6730723907,440,-1,-5,16,2,1,2,3,-1,4,3,1,2,3,0,3,3,1,0,1,0,-2,4,-2,-3,5,-2,0,0,1,-1,0,1,4,-1
KR_6739040101,420,-1,-34,-4,-6,-1,6,5,-2,4,2,-3,4,1,0,5,5,0,0,0,0,0,3,-3,-2,5,7,0,1,-1,1,1,-1,4,-1
KR_6754334049,420,-2,20,20,-11,-4,4,0,-2,2,0,3,1,4,-7,7,0,-1,1,0,0,-15,39,-2,-1,3,-36,0,0,-1,-1,-1,1,1,-1
KR_6762125681,440,-5,-56,17,-14,-1,2,1,0,1,1,-7,8,1,1,1,2,-7,8,1,0,-7,-6,1,-3,2,1,0,-2,-1,-1,-1,-1,2,-1
KR_6745680712,420,-4,-100,9,-6,-4,4,0,0,2,2,-3,6,3,-1,4,3,2,0,2,0,7,-180,-1,-2,3,-4,0,-2,0,-1,-1,-1,0,-1
KR_6762565275,420,2,-24,20,8,0,1,1,6,0,6,7,0,7,-3,5,2,-2,4,2,3,14,6,-1,-2,3,4,0,1,1,1,1,1,4,-1
KR_6743174723,420,-7,10,-36,-18,-10,10,0,-2,4,2,-1,2,1,-5,8,3,0,1,1,-1,-14,-7,-6,-3,9,-1,0,-1,1,-1,-1,-1,4,-1
KR_6682443039,420,-3,-11,20,-12,-3,6,3,-6,9,3,-4,6,2,-1,4,3,2,0,2,-1,-7,-9,2,-7,5,-1,0,-1,1,-1,-1,-1,3,-1
KR_6530576266,420,2,-59,-3,2,-1,1,0,2,0,2,2,2,4,-2,2,0,1,0,1,0,1,-24,-3,-3,6,-2,0,-1,1,-1,-1,1,1,-1
KR_6685591154,420,0,97,-8,-4,1,1,2,-5,7,2,-4,5,1,4,0,4,0,0,0,0,-2,-6,-6,-3,9,0,0,1,1,1,1,-1,2,-1
KR_6742871910,420,-1,23,-11,-4,-2,2,0,2,4,6,-6,6,0,0,1,1,2,0,2,0,-1,7,-1,-4,5,3,0,0,-1,-1,0,-1,5,-1
KR_6763685156,420,-2,-67,16,0,-2,4,2,7,3,10,-1,4,3,-3,3,0,-1,1,0,0,6,-10,-4,-3,7,0,0,0,1,0,-1,-1,5,-1
KR_6507704738,420,-2,-11,-16,-3,1,2,3,3,1,4,-4,5,1,0,1,1,-3,5,2,0,-3,1,-3,-2,5,-6,0,-1,-1,-1,-1,-1,1,-1
KR_6760971194,420,1,-6,-12,-4,1,0,1,0,1,1,0,3,3,-4,6,2,-1,2,1,1,-6,-25,-1,0,1,0,0,-1,1,-1,-1,1,4,-1
KR_6749150601,440,-2,-9,-28,-1,4,1,5,-5,5,0,1,0,1,-2,3,1,1,3,4,-1,-7,-43,1,-5,4,0,0,0,0,0,0,-1,0,-1
KR_6759123506,440,1,16,-13,-1,0,2,2,1,2,3,1,3,4,2,3,5,-5,7,2,0,5,-21,-2,-2,4,0,0,0,-1,-1,1,-1,2,-1
KR_6701635865,420,-2,-5,-28,-3,0,3,3,0,1,1,-1,3,2,-3,5,2,1,1,2,0,-4,4,2,-4,2,3,0,1,-1,1,1,1,2,-1
KR_6657244203,420,-1,18,4,4,-3,3,0,0,3,3,2,0,2,4,1,5,1,0,1,1,6,8,-2,-3,5,1,0,-1,1,-1,-1,1,2,-1
KR_6743437837,420,-2,-65,8,-6,-1,2,1,-1,2,1,-5,6,1,2,1,3,-1,1,0,0,-9,119,-1,-2,3,2,0,-1,-1,1,-1,1,3,-1
KR_6698668595,420,0,-23,-10,-5,-1,2,1,-1,3,2,-6,7,1,3,0,3,0,1,1,0,-6,-15,-5,0,5,-1,0,-1,0,-1,-1,1,0,-1
KR_6626790381,420,-3,-13,1,-9,-3,3,0,-5,8,3,-4,5,1,1,3,4,2,0,2,-2,-8,-4,-2,-5,7,2,0,0,0,1,0,-1,0,-1
KR_6627173151,420,1,94,36,3,2,0,2,-5,8,3,1,2,3,-1,3,2,6,1,7,-1,-2,-7,-5,0,5,0,0,1,1,1,1,-1,1,-1
KR_6722305989,420,-2,46,6,-4,5,2,7,-2,2,0,2,0,2,-3,4,1,-6,7,1,1,-8,122,3,-4,1,-1,0,-2,-1,1,1,1,6,-1
KR_6650874292,420,0,26,-12,-4,-1,3,2,-2,2,0,4,3,7,-3,4,1,-2,4,2,0,-3,-10,-2,-2,4,6,0,-1,0,-1,1,1,0,-1
KR_6638486492,440,0,21,-10,-2,0,2,2,0,4,4,-1,1,0,2,4,6,-3,5,2,2,3,90,0,-5,5,0,0,0,-1,1,0,1,3,-1
KR_6620597741,420,-5,-31,-20,-3,2,0,2,0,1,1,0,1,1,-3,3,0,-2,3,1,-1,0,-14,5,-6,1,-2,0,-1,-1,1,-1,-1,1,-1
KR_6714987256,420,-4,21,3,-7,3,2,5,-4,5,1,3,0,3,-6,8,2,-3,5,2,1,-10,9,0,-3,3,1,0,0,-1,1,0,1,3,-1
KR_6675605828,440,3,122,8,5,0,1,1,5,1,6,-7,9,2,6,0,6,1,0,1,2,4,-4,0,-2,2,2,0,1,-1,0,1,1,1,-1
KR_6764740835,420,-3,-15,-20,-10,-3,4,1,-1,1,0,-8,8,0,0,1,1,2,0,2,1,-2,5,3,-5,2,-1,0,0,0,0,0,1,0,-1
KR_6763383549,420,0,-35,7,-4,-2,2,0,0,4,4,4,2,6,-3,4,1,-3,3,0,-1,-11,1,-2,-2,4,2,0,-1,-1,1,-1,-1,1,-1
KR_6757363906,420,0,29,-8,-1,1,0,1,-1,4,3,-4,4,0,3,0,3,0,2,2,0,7,2,2,-3,1,1,0,-1,1,-1,-1,-1,5,-1
KR_6757566461,440,4,43,8,5,0,1,1,1,1,2,-3,4,1,3,2,5,4,2,6,2,9,3,0,0,0,3,0,0,-1,-1,1,1,1,-1
KR_6758240288,420,3,31,24,0,0,1,1,-1,3,2,-5,5,0,5,3,8,1,1,2,0,4,81,2,-6,4,-37,0,0,-1,1,1,-1,3,-1
KR_6756275683,420,2,-13,8,6,-1,2,1,1,1,2,-2,6,4,6,0,6,2,1,3,0,10,1,-2,-5,7,-4,0,0,-1,-1,-1,-1,6,-1
KR_6620947475,420,-2,-7,-4,-2,1,2,3,-1,9,8,3,0,3,-6,7,1,1,2,3,0,3,-5,2,-4,2,1,0,-1,1,-1,-1,-1,5,-1
KR_6708435315,420,-1,59,-16,-9,-2,2,0,-6,7,1,2,1,3,-3,5,2,0,1,1,0,-11,-65,-3,-2,5,7,0,0,-1,-1,0,-1,6,-1
KR_6547964996,420,-1,52,-6,2,2,1,3,-4,5,1,1,4,5,3,1,4,0,0,0,0,-1,-14,-4,-1,5,0,0,0,-1,0,-1,1,3,-1
KR_6706172913,420,-6,-9,-28,-9,1,3,4,-4,4,0,-3,4,1,-1,2,1,-2,2,0,0,-14,6,1,-1,0,-2,0,0,-1,-1,-1,1,3,-1
KR_6759546262,420,-1,-61,-13,5,3,1,4,-1,3,2,-4,6,2,2,0,2,5,0,5,1,12,11,3,-3,0,2,0,-1,-1,1,-1,1,1,-1
KR_6733181842,420,-4,1,-4,-5,-3,4,1,2,1,3,0,1,1,3,2,5,-7,8,1,1,-1,-7,1,-4,3,3,0,-1,1,-1,-1,1,1,-1
KR_6735981016,420,-3,-69,7,-4,-4,6,2,-1,4,3,4,2,6,-4,4,0,1,0,1,0,0,8,4,-7,3,-3,0,-1,-1,1,-1,1,3,-1
KR_6727715906,440,3,77,22,3,-2,2,0,2,0,2,2,1,3,0,2,2,1,1,2,-1,-1,-209,2,-7,5,-6,0,0,0,0,0,-1,0,-1
KR_6750979392,420,0,-23,8,-1,2,0,2,0,2,2,-3,4,1,0,2,2,0,0,0,0,-6,5,2,-9,7,-4,0,-1,1,-1,-1,1,3,-1
KR_6516357035,420,2,37,4,2,4,0,4,-4,4,0,1,2,3,1,2,3,0,1,1,0,-1,-11,-2,-2,4,-1,1,2,-1,1,1,1,3,-1
KR_6749040524,420,-4,-37,-25,-18,-4,5,1,-9,10,1,1,2,3,-3,7,4,-3,3,0,-1,-17,-1,-1,-3,4,-1,0,-3,-1,-1,-1,-1,1,-1
KR_6764205594,420,-5,-39,-24,-9,-7,7,0,-2,3,1,0,2,2,-1,2,1,1,0,1,0,-4,-5,-2,-3,5,0,0,-2,-1,1,-1,1,4,-1
KR_6624910273,440,-1,32,-22,0,3,0,3,1,5,6,-4,5,1,2,0,2,-2,2,0,1,2,-122,-3,-1,4,1,0,-1,-1,0,-1,1,3,-1
KR_6654099602,420,-3,-31,-32,-7,-3,4,1,1,5,6,-2,5,3,-1,2,1,-2,2,0,0,-2,8,7,-8,1,-3,0,0,1,0,-1,-1,6,-1
KR_6760898505,420,-1,0,24,-6,-2,5,3,-3,3,0,-2,4,2,1,1,2,0,1,1,0,-5,-3,-3,-2,5,3,0,-1,0,-1,-1,1,0,-1
KR_6608201717,420,-2,-3,-4,3,4,0,4,2,3,5,-2,3,1,1,1,2,-2,3,1,0,5,1,4,-7,3,0,0,-1,-1,1,1,1,4,-1
KR_6755321084,420,-1,-88,8,0,2,0,2,-3,4,1,0,1,1,0,3,3,1,0,1,0,0,0,3,-4,1,0,0,1,-1,1,1,-1,1,-1
KR_6515813723,420,-1,-10,19,-10,-1,2,1,-2,2,0,-6,7,1,1,1,2,-2,3,1,0,-10,4,-2,-1,3,2,0,0,1,-1,1,-1,2,-1
KR_6734103311,420,0,14,12,-1,-2,3,1,-3,5,2,1,1,2,2,2,4,1,0,1,0,-1,6,2,-5,3,-1,0,0,1,0,1,1,6,-1
KR_6669236444,420,-4,-42,-20,-6,-1,3,2,1,0,1,-4,7,3,-1,3,2,-1,1,0,0,-2,-9,1,-1,0,-1,0,-2,1,0,-1,1,1,-1
KR_6601372599,420,-1,-55,-16,-3,1,2,3,4,4,8,-6,7,1,-2,3,1,0,1,1,0,-1,-23,0,-5,5,-3,0,-2,-1,-1,-1,-1,1,-1
KR_6627505823,440,-2,8,4,-7,-1,2,1,-5,7,2,2,0,2,1,1,2,-4,4,0,0,-7,-17,4,-10,6,0,0,0,-1,1,0,-1,3,-1
KR_6693824001,420,-1,17,-14,-7,1,1,2,-5,5,0,3,0,3,-4,5,1,-2,2,0,-1,-16,55,-5,-1,6,-19,0,-1,-1,1,-1,-1,3,-1
KR_6762082211,420,-1,29,-17,-3,-3,4,1,-4,5,1,-1,3,2,6,1,7,-1,1,0,0,-5,-2,-2,-3,5,1,0,-2,-1,-1,-1,1,4,-1
KR_6761257905,420,-4,-88,-31,-4,1,1,2,-1,2,1,-4,5,1,1,0,1,-1,1,0,0,-1,-9,-4,-1,5,-4,0,-2,1,-1,-1,-1,1,-1
KR_6670295249,420,-2,-10,-20,2,0,2,2,0,1,1,-2,3,1,1,2,3,3,0,3,0,2,-2,1,-5,4,-2,0,0,1,0,-1,-1,6,-1
KR_6694553891,420,-2,-5,0,2,-3,3,0,-2,3,1,2,0,2,6,1,7,-1,1,0,0,9,-110,0,-5,5,-3,0,0,1,-1,-1,-1,5,-1
KR_6624399967,420,0,-17,-10,5,3,1,4,-1,2,1,2,1,3,1,2,3,0,0,0,1,1,-270,2,-4,2,-2,0,0,1,-1,0,1,4,-1
KR_6703244705,420,-2,-21,-12,-6,-3,4,1,1,1,2,-1,1,0,-4,5,1,1,1,2,0,-4,43,0,-4,4,-13,0,-1,-1,1,-1,1,4,-1
KR_6759254575,420,0,-21,-4,-2,-1,4,3,0,3,3,-4,6,2,4,1,5,-1,2,1,0,4,20,2,-3,1,0,0,2,-1,-1,1,1,3,-1
KR_6723655771,420,-2,-71,-16,-5,-1,1,0,2,0,2,-5,7,2,-2,3,1,1,0,1,0,1,10,3,-6,3,-2,0,-1,-1,-1,-1,-1,3,-1
KR_6720611461,420,-3,-65,0,-4,-3,4,1,-2,6,4,0,2,2,2,3,5,-1,1,0,0,-4,-447,2,-2,0,-3,0,-2,1,-1,-1,1,4,-1
KR_6732815416,420,-1,-51,-33,-1,-1,1,0,0,3,3,1,0,1,-1,1,0,0,2,2,0,2,4,-1,-2,3,1,0,0,1,-1,0,-1,1,-1
KR_6764135572,420,2,-97,0,5,-1,3,2,1,4,5,0,1,1,2,4,6,3,0,3,0,11,-19,2,-6,4,6,0,1,-1,1,1,1,5,-1
KR_6638789792,420,-5,-87,-16,-8,-2,2,0,0,1,1,-5,5,0,-1,2,1,0,2,2,0,-3,10,2,-6,4,-8,0,-1,-1,-1,-1,-1,4,-1
KR_6650786504,420,-1,-16,24,-5,0,1,1,0,4,4,-1,1,0,-3,3,0,-1,1,0,0,-7,-44,0,-1,1,23,0,-1,-1,1,-1,-1,6,-1
KR_6597417239,420,-1,-11,8,7,-5,7,2,4,1,5,4,2,6,4,0,4,0,1,1,0,20,3,2,-6,4,3,0,0,1,-1,-1,-1,1,-1
KR_6739328001,420,0,-8,20,0,1,1,2,-1,2,1,0,3,3,2,1,3,-2,4,2,0,-3,-12,3,-5,2,2,0,1,1,-1,1,1,1,-1
KR_6415502587,420,0,24,32,-7,3,1,4,0,1,1,-4,5,1,-5,5,0,-1,2,1,-1,-14,5,7,-8,1,0,0,-2,1,-1,-1,-1,6,-1
KR_6754896719,420,-5,-115,3,-9,2,0,2,-9,9,0,-4,5,1,4,1,5,-2,4,2,0,-9,-17,-6,-4,10,3,0,-3,1,-1,-1,-1,2,-1
KR_6395882070,420,0,-2,-4,4,-2,4,2,3,0,3,2,0,2,1,0,1,0,1,1,-1,1,13,0,-4,4,-4,0,0,1,-1,0,-1,4,-1
KR_6741848248,420,-5,-35,-25,-8,1,1,2,-2,2,0,-8,8,0,1,1,2,0,0,0,0,-12,1,-1,-3,4,-3,0,-3,-1,-1,-1,-1,2,-1
KR_6762350064,420,0,33,3,-5,2,2,4,-1,2,1,-4,6,2,-2,4,2,0,1,1,0,-10,3,0,-5,5,-5,0,0,1,-1,-1,-1,2,-1
KR_6637474250,420,-4,-37,8,-1,-3,3,0,0,1,1,1,2,3,2,1,3,-1,2,1,0,2,7,5,-8,3,0,0,-3,1,-1,-1,-1,6,-1
KR_6760306640,420,0,-18,9,3,2,2,4,1,1,2,2,2,4,-2,2,0,0,0,0,1,5,3,0,-5,5,0,0,0,-1,-1,0,1,1,-1
KR_6750357810,420,0,12,-24,-1,-3,4,1,0,2,2,0,2,2,2,4,6,0,0,0,0,-2,-40,-2,-4,6,33,0,0,0,-1,0,1,0,-1
KR_6634553589,420,-1,-34,-12,0,-1,3,2,-1,3,2,1,0,1,1,1,2,0,1,1,0,1,0,-3,-2,5,-3,0,-1,-1,1,-1,1,1,-1
KR_6649209662,420,-1,40,4,-2,2,0,2,-6,7,1,-1,3,2,1,0,1,2,0,2,0,2,112,-2,-2,4,4,0,-1,-1,-1,-1,-1,2,-1
KR_6740782409,420,-1,-47,11,-1,0,4,4,3,1,4,-5,5,0,1,2,3,0,0,0,0,-2,18,0,-5,5,-1,0,0,1,-1,0,1,6,-1
KR_6749735589,440,-1,-18,-28,1,-2,4,2,-3,5,2,4,1,5,2,2,4,0,1,1,1,-2,6,-5,-4,9,-3,0,0,-1,-1,-1,1,1,-1
KR_6618875305,420,-3,35,0,-15,-1,1,0,-5,6,1,-8,8,0,-1,2,1,0,2,2,0,-15,6,-1,-3,4,2,0,0,-1,0,0,-1,6,-1
KR_6299959263,440,7,30,22,8,8,2,10,4,0,4,-7,10,3,0,0,0,3,1,4,-1,1,-10,0,-3,3,5,0,1,1,0,-1,-1,4,-1
KR_6761596271,420,-2,-74,-41,-2,-2,4,2,1,1,2,-3,7,4,1,0,1,1,2,3,0,2,4,-2,-5,7,-6,0,0,-1,1,0,1,2,-1
KR_6763039809,420,1,26,6,-2,2,0,2,-2,5,3,-3,3,0,2,2,4,-1,1,0,-2,-2,272,4,-7,3,1,0,1,1,1,1,-1,5,-1
KR_6744406084,420,0,-29,-4,0,-1,2,1,-1,6,5,-2,2,0,3,0,3,1,1,2,0,6,6,2,-5,3,1,0,-1,1,1,-1,-1,6,-1
KR_6752588229,420,1,17,8,6,-3,3,0,1,1,2,4,0,4,4,1,5,0,0,0,0,10,-204,4,-6,2,0,0,2,1,1,1,1,5,-1
KR_6655908317,420,-3,-45,12,-18,-1,3,2,0,3,3,1,4,5,-15,15,0,-3,3,0,-1,-19,-9,0,-4,4,1,0,-1,-1,0,-1,-1,5,-1
KR_6596005501,420,-6,-79,-29,-11,0,2,2,-5,6,1,1,3,4,-6,6,0,-1,1,0,1,-13,0,4,-5,1,-1,0,-2,-1,-1,-1,1,2,-1
KR_6735466022,420,-1,-100,-12,-2,-3,5,2,-1,1,0,1,1,2,0,5,5,1,1,2,0,-2,6,2,-6,4,-4,0,0,-1,1,1,-1,3,-1
KR_6751018263,440,-3,-63,0,-5,-4,6,2,-3,4,1,-1,4,3,1,1,2,2,0,2,0,-6,2,2,-6,4,-1,0,-1,1,0,-1,-1,4,-1
KR_6759128946,420,0,-3,-8,3,-2,3,1,2,0,2,3,0,3,2,2,4,-2,2,0,0,-2,1,4,-5,1,-4,0,0,0,0,0,-1,0,-1
KR_6659130093,440,1,34,-16,3,8,0,8,0,1,1,-2,4,2,-3,4,1,0,1,1,0,0,-5,-1,-1,2,2,0,-1,-1,1,-1,1,3,-1
KR_6764603974,420,-3,-63,8,-1,4,0,4,-4,4,0,-4,4,0,2,3,5,1,1,2,0,3,-31,2,-9,7,-4,0,-1,-1,-1,-1,-1,6,-1
KR_6662219206,420,-2,15,-10,-4,5,0,5,0,1,1,-6,7,1,-3,3,0,0,1,1,0,-5,-111,-1,-3,4,2,0,-1,-1,-1,-1,1,3,-1
KR_6761405212,420,0,-119,-20,11,1,1,2,9,0,9,0,2,2,1,3,4,0,2,2,0,16,-154,-1,-4,5,0,0,0,1,-1,-1,1,4,-1
KR_6759079340,420,-7,-94,-36,-8,-4,5,1,1,1,2,-3,6,3,-3,5,2,1,0,1,1,-4,24,-2,-5,7,-6,0,-2,-1,-1,-1,1,1,-1
KR_6637844769,420,0,37,4,0,-3,3,0,-1,1,0,6,0,6,-2,2,0,0,0,0,0,1,-7,-3,-3,6,5,0,-1,1,-1,-1,1,6,-1
KR_6757191692,420,-1,-91,8,-10,-6,6,0,-1,2,1,-1,3,2,-1,3,2,-1,2,1,-1,-5,62,2,-6,4,-16,0,-1,-1,-1,-1,-1,5,-1
KR_6724975778,420,0,-25,-20,1,-1,2,1,-1,3,2,2,1,3,-2,4,2,3,0,3,0,3,41,2,-6,4,-2,0,0,-1,0,0,-1,4,-1
KR_6757402511,420,-7,-75,-22,-19,-3,4,1,-1,2,1,-2,4,2,-11,12,1,-2,3,1,0,-17,-176,-1,-1,2,-2,0,-2,-1,1,-1,-1,3,-1
KR_6748943938,420,-4,-76,8,-11,2,1,3,-3,6,3,-1,1,0,-7,8,1,-2,4,2,0,-11,9,-4,-1,5,-3,0,-1,0,0,-1,-1,0,-1
KR_6663952836,420,-4,-32,16,0,-2,2,0,-1,5,4,1,0,1,2,0,2,0,0,0,0,-1,22,6,-11,5,-2,0,0,1,1,0,1,4,-1
KR_6760512503,440,-5,-45,24,-14,-9,9,0,1,4,5,0,1,1,-6,6,0,0,1,1,-1,1,5,1,-4,3,1,0,-2,0,-1,-1,-1,0,-1
KR_6735710041,420,0,55,18,4,-4,6,2,4,2,6,0,3,3,6,0,6,-2,3,1,-1,2,-3,-1,-6,7,3,0,-1,1,-1,-1,-1,6,-1
KR_6755511395,420,-5,-3,-41,-12,0,3,3,-7,7,0,-1,1,0,-4,8,4,0,1,1,-1,-12,-5,-4,-1,5,1,0,-1,-1,-1,-1,-1,3,-1
KR_6737276721,420,-4,-51,12,-6,1,1,2,0,1,1,-5,5,0,-1,2,1,-1,1,0,0,-8,4,-4,-2,6,-5,0,0,1,1,-1,1,2,-1
KR_6710004736,420,-6,-68,-15,-13,-2,5,3,0,2,2,-6,7,1,-2,4,2,-3,4,1,1,-10,12,2,-2,0,0,0,-1,1,-1,-1,1,6,-1
KR_6757165896,420,-5,-42,10,-4,-3,3,0,1,0,1,6,0,6,-8,8,0,0,0,0,0,-4,1,-1,-2,3,2,0,-2,-1,1,-1,-1,4,-1
KR_6748875544,420,-2,-54,-4,-5,-1,5,4,-2,4,2,-3,4,1,2,2,4,-1,1,0,0,-1,-23,-2,-2,4,0,0,-2,-1,-1,-1,-1,3,-1
KR_6690832583,420,-1,-21,-12,-8,-3,5,2,-2,2,0,-2,5,3,-1,1,0,0,0,0,0,-3,17,5,-9,4,-1,0,0,1,-1,0,-1,6,-1
KR_6757354571,420,-5,-76,0,-9,-7,8,1,4,1,5,-3,5,2,-3,3,0,0,1,1,0,-9,1,-2,-3,5,-2,0,-1,-1,-1,-1,-1,2,-1
KR_6747516321,420,3,47,4,4,2,1,3,0,3,3,1,0,1,1,0,1,0,0,0,0,1,-40,-2,-2,4,25,0,0,0,-1,0,1,0,-1
KR_6738408728,420,-3,-79,-36,-2,9,2,11,-1,4,3,-2,6,4,-6,8,2,-2,2,0,0,-6,39,-2,-3,5,-3,0,-2,-1,1,-1,1,3,-1
KR_6672946902,420,-6,-58,-7,-10,-3,4,1,-2,3,1,4,0,4,-11,11,0,2,0,2,0,-12,-42,-1,-3,4,-5,0,-2,-1,0,-1,-1,2,-1
KR_6756389304,420,0,-39,-16,0,1,0,1,-4,4,0,3,2,5,-1,1,0,1,0,1,0,-2,14,1,-3,2,-6,0,0,1,0,0,1,4,-1
KR_6599043724,420,-6,-21,-5,-7,0,1,1,2,2,4,-3,4,1,-6,8,2,0,0,0,0,-6,-2,-5,-2,7,-1,0,-3,0,-1,-1,1,0,-1
KR_6756838671,440,-2,24,30,-9,-1,2,1,-1,4,3,-3,4,1,-4,6,2,0,0,0,-1,-10,7,1,-3,2,-4,0,0,1,1,0,-1,5,-1
KR_6744210490,420,-5,-53,0,-10,-1,1,0,0,3,3,-6,8,2,-1,6,5,-2,4,2,-1,-8,-5,1,-2,1,-4,0,-1,0,-1,-1,-1,0,-1
KR_6720993112,420,-4,-2,-16,-13,1,1,2,-7,8,1,-5,5,0,-1,2,1,-1,1,0,0,-9,2,1,-7,6,4,0,0,0,1,1,-1,0,-1
KR_6648928580,420,-1,-54,0,-9,-2,6,4,-3,3,0,0,2,2,-4,4,0,0,2,2,1,-5,-294,1,-3,2,6,0,-2,-1,-1,-1,1,1,-1
KR_6753304073,420,5,92,0,9,5,1,6,0,0,0,1,4,5,0,3,3,3,0,3,1,3,14,4,-6,2,2,0,0,0,0,0,1,0,-1
KR_6701484880,420,1,39,0,4,2,1,3,0,5,5,2,1,3,-2,5,3,2,0,2,0,-8,1,1,-5,4,3,0,3,-1,1,1,1,4,-1
KR_6727904442,420,1,6,-7,0,0,2,2,-8,10,2,5,1,6,2,3,5,1,1,2,2,-9,-18,-5,-3,8,3,0,0,-1,-1,1,1,5,-1
KR_6689807127,420,-7,-59,-4,-10,0,0,0,-4,5,1,-1,4,3,-6,6,0,1,1,2,0,-5,25,1,-5,4,-6,0,-1,-1,-1,-1,-1,1,-1
KR_6724644040,440,0,-27,-23,9,0,1,1,1,6,7,2,0,2,2,3,5,4,0,4,0,18,-1,2,-5,3,2,0,1,0,1,1,1,0,-1
KR_6721284197,420,1,-20,21,-2,-4,5,1,0,4,4,1,1,2,2,0,2,-1,1,0,0,-2,13,0,-4,4,-3,0,-1,1,1,-1,1,4,-1
KR_6599904288,420,2,6,-24,1,-1,1,0,1,1,2,2,3,5,-1,5,4,0,0,0,1,2,-6,-3,-2,5,1,0,0,1,0,1,1,4,-1
KR_6762311691,420,-1,-21,10,-9,-2,5,3,-1,3,2,-5,7,2,-1,2,1,0,2,2,1,-5,-26,0,-1,1,0,0,-1,0,0,-1,1,0,-1
KR_6748661296,440,-6,-92,4,-15,-5,5,0,-6,9,3,-5,7,2,0,2,2,1,0,1,0,-4,17,3,-5,2,-4,0,0,0,0,-1,-1,0,-1
KR_6702606989,420,4,89,-8,3,8,0,8,-4,5,1,-1,3,2,0,2,2,0,1,1,0,-8,19,3,-4,1,0,0,2,-1,-1,1,1,1,-1
KR_6754769828,420,0,-10,10,2,-4,6,2,5,0,5,1,2,3,2,3,5,-2,2,0,0,6,-57,2,-9,7,15,0,-1,-1,0,-1,-1,5,-1
KR_6682650268,420,-3,-79,0,-1,0,1,1,2,1,3,-9,9,0,4,1,5,2,0,2,0,2,300,-4,-1,5,2,0,0,1,1,0,-1,3,-1
KR_6758045565,420,0,-57,36,-3,3,1,4,-4,4,0,0,3,3,-4,5,1,2,1,3,1,-12,7,2,-4,2,-2,0,-1,1,-1,-1,1,3,-1
KR_6756914638,420,4,54,16,7,-2,3,1,4,0,4,1,3,4,1,4,5,3,0,3,0,1,23,-5,-5,10,1,0,0,1,-1,-1,1,3,-1
KR_6658289450,420,1,-69,13,5,-3,3,0,5,0,5,3,1,4,1,0,1,-1,2,1,0,10,6,-1,-5,6,0,0,-1,0,1,-1,-1,0,-1
KR_6209098513,420,0,-46,-6,1,-1,3,2,0,2,2,-2,3,1,4,1,5,0,0,0,0,4,-10,3,-9,6,-2,0,0,-1,0,0,-1,1,-1
KR_6662641596,420,-3,-93,-6,-7,-3,3,0,1,3,4,-5,5,0,1,1,2,-1,2,1,0,-1,-124,10,-13,3,-5,0,0,1,1,0,-1,2,-1
KR_6685339163,420,-2,36,-12,-7,0,3,3,-3,6,3,-3,4,1,2,5,7,-3,3,0,-1,-10,-2,-6,0,6,3,0,-2,-1,-1,-1,-1,4,-1
KR_6738713363,420,-3,-16,8,-4,-3,5,2,-2,3,1,4,1,5,-1,2,1,-2,3,1,0,-1,-78,2,-4,2,-14,0,0,1,0,0,-1,5,-1
KR_6719284574,420,-2,-47,22,-4,-7,8,1,4,0,4,0,1,1,-1,3,2,0,0,0,1,2,-3,-3,-4,7,2,0,0,-1,1,1,1,5,-1
KR_6763507501,420,-1,16,7,2,3,1,4,1,1,2,-4,5,1,1,1,2,1,0,1,0,2,-29,1,-5,4,13,0,-1,1,-1,-1,1,6,-1
KR_6753527551,420,1,-49,40,-3,0,1,1,-3,5,2,-2,3,1,0,2,2,2,0,2,0,-5,291,1,-2,1,-1,0,0,1,-1,0,-1,3,-1
KR_6762942285,420,2,16,-19,5,2,1,3,2,0,2,2,2,4,2,0,2,-3,4,1,0,5,3,6,-7,1,-4,0,-1,1,-1,-1,-1,1,-1
KR_6757018372,420,0,2,-13,7,0,4,4,6,2,8,-2,4,2,1,5,6,2,0,2,2,8,26,2,-6,4,4,0,0,-1,1,0,1,3,-1
KR_6747534673,420,-2,-56,-16,-7,-3,5,2,-2,4,2,-4,4,0,1,2,3,1,1,2,0,-2,14,0,-3,3,-1,0,-2,1,-1,-1,-1,1,-1
KR_6350148735,420,-4,-132,5,-9,-3,4,1,1,2,3,-1,1,0,-6,11,5,0,2,2,-1,-12,1,-1,-8,9,5,0,1,-1,1,1,-1,6,-1
KR_6720093101,420,-2,3,-10,-5,-4,6,2,2,0,2,-1,5,4,-4,4,0,2,0,2,0,-5,-17,-2,-4,6,-1,0,-1,1,-1,-1,1,5,-1
KR_6673010293,420,-9,-110,-25,-26,-3,3,0,-10,12,2,-3,5,2,-8,8,0,-2,2,0,-1,-23,-2,-4,-4,8,4,0,-2,-1,-1,-1,-1,3,-1
KR_6760777796,420,-2,-29,-9,-7,0,2,2,0,2,2,-6,7,1,-1,3,2,0,1,1,0,-6,36,3,-5,2,-19,0,0,-1,1,1,1,5,-1
KR_6764208368,420,0,4,-22,-6,-2,3,1,0,0,0,-1,3,2,-3,3,0,0,1,1,0,-7,3,0,-4,4,-3,0,0,0,-1,0,-1,0,-1
KR_6612388028,420,-1,-48,-4,-8,-5,5,0,-3,5,2,3,2,5,-2,4,2,-1,1,0,0,-4,6,-4,-2,6,-6,0,-1,1,-1,-1,1,6,-1
KR_6698713055,420,-6,-87,-3,-17,-1,3,2,-4,7,3,-2,3,1,-11,11,0,1,0,1,-1,-12,0,1,-4,3,0,0,-3,-1,-1,-1,-1,3,-1
KR_6755637455,420,-3,-46,0,-9,-3,6,3,1,2,3,-5,5,0,-1,3,2,-1,2,1,0,-11,-2,0,-4,4,-1,0,-2,-1,1,-1,-1,1,-1
KR_6761859193,420,0,-51,20,-3,-4,4,0,1,2,3,2,1,3,3,2,5,-5,5,0,0,1,1,4,-5,1,2,0,1,1,1,1,-1,3,-1
KR_6747017561,440,1,11,-3,-3,1,2,3,1,2,3,-3,3,0,-2,3,1,0,0,0,0,-3,6,-1,-2,3,0,0,-1,-1,-1,-1,-1,4,-1
KR_6659877609,420,-3,-86,20,-2,2,1,3,-2,4,2,-1,2,1,-1,2,1,0,2,2,0,-5,-21,0,-5,5,1,0,0,-1,0,0,-1,5,-1
KR_6742320058,420,-5,8,-20,-13,0,2,2,-9,10,1,3,1,4,-6,7,1,-1,2,1,0,-17,-1,1,-3,2,-3,0,-1,-1,-1,-1,-1,2,-1
KR_6732268765,420,-5,-56,-26,-5,1,1,2,2,3,5,-7,8,1,0,0,0,-1,1,0,0,3,-7,-1,-5,6,-2,0,-3,-1,-1,-1,-1,1,-1
KR_6759013559,420,-4,-88,26,-6,-6,7,1,2,2,4,-3,7,4,6,3,9,-5,5,0,0,-6,244,3,-4,1,1,0,-1,-1,-1,-1,1,5,-1
KR_6734767119,420,1,-13,-4,3,4,1,5,0,1,1,4,0,4,-4,4,0,-1,3,2,0,0,1,-2,-1,3,-2,0,1,-1,0,1,1,3,-1
KR_6722933077,420,-3,-22,-24,-3,-3,3,0,-2,5,3,-3,6,3,3,1,4,2,0,2,0,-4,6,-1,-5,6,0,0,-1,1,-1,-1,1,2,-1
KR_6763541472,420,-1,-59,8,-1,0,2,2,2,1,3,-4,7,3,3,0,3,-2,2,0,1,11,8,-3,-1,4,1,0,-1,0,-1,-1,1,0,-1
KR_6703879830,420,3,9,4,6,6,2,8,4,1,5,4,2,6,-5,8,3,-3,4,1,1,-3,3,4,-5,1,1,0,-1,-1,0,-1,-1,2,-1
KR_6746820347,420,2,32,-3,10,2,1,3,1,1,2,0,0,0,6,1,7,1,0,1,1,7,-14,-4,-2,6,2,0,0,1,-1,0,1,1,-1
KR_6706333687,420,-3,-40,-43,-5,-5,6,1,0,2,2,-1,4,3,0,3,3,1,0,1,2,-3,0,-4,-2,6,-3,0,-2,-1,-1,-1,1,3,-1
KR_6764158584,420,-3,-11,0,-6,-2,3,1,0,2,2,-2,2,0,-1,1,0,-1,1,0,0,-1,-3,-2,-3,5,2,0,0,1,-1,-1,1,3,-1
KR_6624387562,420,-2,-68,-21,-1,2,1,3,2,1,3,-1,2,1,-1,4,3,-3,3,0,0,0,2,4,-7,3,-10,0,-1,-1,1,-1,-1,6,-1
KR_6651828657,420,0,30,-2,-5,2,0,2,-6,7,1,0,2,2,0,1,1,-1,1,0,0,-6,-23,-4,-2,6,2,0,0,-1,1,-1,-1,2,-1
KR_6531383174,420,-3,-12,-4,-3,-4,4,0,0,2,2,1,1,2,1,2,3,-1,2,1,0,-2,21,-3,-3,6,0,0,0,1,1,-1,-1,2,-1
KR_6724937858,420,-6,-37,-28,-12,-1,5,4,-2,3,1,-3,4,1,-1,4,3,-5,5,0,0,-8,-7,3,-5,2,-1,0,-1,-1,0,-1,1,3,-1
KR_6727990492,420,-1,7,7,-3,-1,1,0,4,6,10,0,3,3,-6,6,0,0,0,0,0,-10,-9,4,-5,1,-2,0,0,1,1,0,-1,4,-1
KR_6761195924,440,1,-15,19,-1,0,1,1,-1,1,0,-1,3,2,-1,1,0,2,1,3,-2,-5,0,4,-5,1,-2,0,0,0,0,0,-1,0,-1
KR_6636528193,420,-1,14,-40,3,-1,1,0,1,2,3,-1,4,3,1,2,3,3,1,4,0,-1,6,1,-4,3,-3,0,1,0,0,1,1,0,-1
KR_6687808181,420,-4,-80,0,-4,-2,5,3,-2,4,2,1,2,3,-2,3,1,1,2,3,0,0,24,0,-4,4,2,0,2,1,0,1,-1,6,-1
KR_6729474856,420,1,-82,-20,3,-1,3,2,0,0,0,-2,2,0,3,1,4,3,1,4,0,4,15,0,-4,4,0,0,0,1,-1,1,1,5,-1
KR_6634914222,420,0,-9,24,-2,2,0,2,-2,4,2,-1,2,1,-2,4,2,1,1,2,0,-5,446,-2,-3,5,2,0,0,-1,-1,0,1,3,-1
KR_6707837914,420,-1,-49,2,-7,-2,4,2,-3,4,1,1,1,2,-3,3,0,0,1,1,0,-14,-10,-3,-4,7,0,0,1,-1,-1,1,-1,1,-1
KR_6729391285,420,1,7,4,5,4,0,4,4,3,7,1,3,4,-5,6,1,1,0,1,0,2,-3,-1,-2,3,-2,0,0,-1,1,1,-1,3,-1
KR_6760803055,440,-1,16,24,-8,-9,9,0,1,2,3,0,3,3,-2,5,3,2,0,2,-1,-2,-9,-3,-5,8,5,0,-1,-1,-1,-1,-1,4,-1
KR_6679839283,420,-3,12,-18,1,-2,3,1,-2,3,1,1,3,4,4,0,4,0,1,1,0,4,33,1,-2,1,-25,0,0,1,-1,-1,1,4,-1
KR_6677387604,420,-3,-40,-8,-8,0,3,3,-5,7,2,0,3,3,-2,3,1,-1,1,0,-1,-6,3,-4,-4,8,1,0,-1,-1,-1,-1,-1,2,-1
KR_6762060363,420,-5,-136,29,-14,-2,4,2,-5,6,1,1,2,3,-2,4,2,-6,6,0,-1,-3,-34,-6,-1,7,7,0,-1,0,-1,-1,1,0,-1
KR_6746192347,420,4,45,27,0,-4,4,0,3,0,3,3,2,5,-2,2,0,0,0,0,0,-7,-111,-3,-1,4,-17,0,1,1,1,1,1,3,-1
KR_6760644412,420,-2,-56,0,-11,-3,3,0,0,1,1,-1,3,2,-7,7,0,0,0,0,0,-11,9,-3,-2,5,0,0,-2,-1,-1,-1,1,2,-1
KR_6668514847,420,-2,-104,12,-4,-2,3,1,4,2,6,-1,5,4,-7,9,2,2,1,3,-1,1,161,-5,0,5,27,0,0,-1,1,-1,-1,6,-1
KR_6739125244,420,-5,-36,-8,-14,-2,3,1,0,2,2,-8,10,2,-3,7,4,-1,3,2,-1,-5,-11,-1,-4,5,-1,0,0,-1,1,0,-1,1,-1
KR_6697602921,420,-3,-6,3,-12,-7,7,0,0,2,2,1,2,3,-3,4,1,-3,3,0,-1,-10,-64,-4,-2,6,-3,0,0,-1,1,-1,-1,4,-1
KR_6763899864,420,1,28,-16,1,3,2,5,2,1,3,0,4,4,-5,7,2,1,0,1,0,6,22,-2,-4,6,-1,0,0,0,0,0,1,0,-1
KR_6730693625,420,-1,-26,-4,-1,0,1,1,0,4,4,-2,3,1,1,3,4,0,1,1,0,-2,-1,1,-5,4,1,0,-1,-1,1,-1,-1,6,-1
KR_6654040078,420,-2,-32,21,3,-3,4,1,1,1,2,6,0,6,2,0,2,-3,3,0,0,-1,-270,-2,-4,6,-2,0,0,-1,-1,-1,1,1,-1
KR_6741801100,420,1,-20,16,-1,-1,2,1,1,1,2,-2,4,2,3,1,4,-2,2,0,0,1,-10,-2,-2,4,2,0,-1,1,-1,-1,-1,6,-1
KR_6758540906,440,0,-44,-1,-1,-2,4,2,1,2,3,-2,8,6,-1,3,2,3,1,4,1,15,62,-1,-4,5,5,0,0,0,1,0,1,0,-1
KR_6724861419,420,-3,3,-12,-8,-4,5,1,-2,2,0,0,3,3,1,4,5,-3,3,0,0,-6,-1,4,-6,2,-4,0,1,-1,1,1,1,6,-1
KR_6715301471,420,-3,-83,-4,-5,0,0,0,-1,5,4,-1,3,2,-2,5,3,-1,1,0,0,-5,15,-1,-1,2,3,0,0,1,1,-1,-1,3,-1
KR_6649723714,420,-2,-33,-20,-5,-2,3,1,2,2,4,-2,4,2,-4,5,1,1,1,2,-1,-7,-7,-4,-2,6,3,0,-1,-1,1,-1,-1,6,-1
KR_6678625468,420,0,-55,-23,-2,-6,6,0,5,1,6,2,0,2,-4,5,1,1,0,1,0,6,-3,-3,-2,5,3,0,-1,1,-1,-1,1,6,-1
KR_6750115351,420,-2,-19,-22,-3,4,1,5,-3,4,1,-2,5,3,-3,3,0,1,1,2,0,-5,2,1,-4,3,-4,0,-1,0,-1,-1,1,0,-1
KR_6680138760,420,2,50,12,5,1,0,1,2,1,3,2,2,4,3,2,5,-3,3,0,-1,3,-13,-2,-5,7,5,0,1,0,-1,1,-1,0,-1
KR_6764153605,420,-4,-34,-40,-12,-1,3,2,-4,6,2,0,4,4,-7,10,3,0,1,1,-1,-10,-1,-2,-1,3,3,0,0,-1,-1,-1,-1,6,-1
KR_6588117050,440,1,21,-1,-3,1,1,2,-5,5,0,2,1,3,3,3,6,-4,11,7,0,-10,-26,-3,-5,8,37,0,-1,-1,-1,-1,1,2,-1
KR_6734730562,420,-5,-65,-28,-8,-2,2,0,-9,11,2,-1,3,2,2,1,3,2,1,3,0,0,-33,-1,-3,4,15,0,-2,-1,-1,-1,-1,1,-1
KR_6740167934,420,-5,-42,-44,3,-1,2,1,-2,3,1,-4,5,1,6,0,6,4,0,4,0,4,-38,-1,-3,4,0,0,-1,1,-1,-1,1,6,-1
KR_6759032484,420,-2,6,0,-5,-2,2,0,0,2,2,1,3,4,-2,3,1,-2,4,2,0,-7,-1,1,-4,3,-3,0,0,1,0,0,-1,1,-1
KR_6759934410,440,0,-14,-8,4,-2,2,0,-3,4,1,1,1,2,5,4,9,3,1,4,0,12,-5,1,-4,3,5,0,0,-1,0,0,1,4,-1
KR_6723831744,420,-4,-77,-40,-6,-8,8,0,1,4,5,4,1,5,-3,3,0,0,1,1,-1,0,-4,-3,-1,4,1,0,-1,-1,0,-1,-1,3,-1
KR_6758365165,420,0,2,-23,5,-3,5,2,2,2,4,6,0,6,-2,3,1,2,0,2,0,8,0,2,-3,1,-2,0,0,1,-1,1,-1,4,-1
KR_6760093902,420,-2,41,4,-6,-1,3,2,0,4,4,-2,2,0,-5,6,1,2,0,2,0,-4,-57,1,-5,4,1,0,-1,-1,-1,-1,-1,2,-1
KR_6712362752,420,2,-54,18,9,1,1,2,3,2,5,-1,2,1,3,3,6,3,0,3,0,16,7,3,-4,1,-3,0,-2,1,-1,-1,1,3,-1
KR_6671194360,420,-3,27,-18,-8,0,1,1,-3,7,4,0,2,2,-7,8,1,2,1,3,0,-6,26,-2,-5,7,-12,0,0,-1,-1,-1,-1,2,-1
KR_6752707087,420,0,-26,17,-6,-4,4,0,2,0,2,3,1,4,-3,3,0,-4,4,0,1,-9,10,0,-3,3,-1,0,-1,1,-1,-1,1,2,-1
KR_6748643877,420,-1,17,-28,-2,-2,3,1,2,4,6,0,1,1,-2,3,1,0,0,0,0,-2,1,1,-4,3,1,0,1,-1,1,1,-1,1,-1
KR_6757407015,420,0,0,64,-2,2,3,5,-2,3,1,-1,4,3,-1,2,1,0,1,1,0,-2,-42,0,-2,2,12,0,-1,-1,-1,-1,-1,6,-1
KR_6651183000,420,0,2,-17,6,0,3,3,0,5,5,2,1,3,3,1,4,1,0,1,-2,0,4,-2,-8,10,5,0,0,1,1,1,-1,1,-1
KR_6728388334,420,-6,-71,-15,-8,-6,6,0,-3,5,2,3,0,3,0,3,3,-2,3,1,-1,-15,-1,2,-3,1,-1,0,0,-1,1,-1,-1,3,-1
KR_6678273484,440,-6,-47,-29,-14,-10,13,3,-3,3,0,-2,6,4,2,1,3,-1,1,0,0,1,2,1,-5,4,-1,0,-2,0,0,-1,-1,0,-1
KR_6725173212,420,-6,-80,-33,-11,-6,6,0,2,1,3,-4,4,0,-1,2,1,-2,2,0,0,-11,-7,0,-4,4,-1,0,0,-1,-1,0,1,4,-1
KR_6705735790,440,-1,-18,-9,0,-2,3,1,-2,3,1,-2,4,2,1,0,1,5,1,6,0,10,0,1,-5,4,0,0,-1,0,0,-1,-1,0,-1
KR_6710443783,420,-3,-26,5,-7,3,0,3,-1,2,1,-7,8,1,-5,5,0,3,1,4,0,-8,-3,0,-2,2,0,0,1,-1,1,1,-1,5,-1
KR_6763225851,420,3,33,28,13,5,0,5,8,3,11,-1,4,3,0,2,2,1,2,3,0,6,21,2,-4,2,-3,0,1,1,1,-1,1,1,-1
KR_6757425037,420,0,-7,-4,-11,0,2,2,-2,2,0,-6,7,1,0,3,3,-3,3,0,0,-2,-215,-3,-2,5,1,0,-1,-1,-1,-1,-1,3,-1
KR_6682195084,420,-5,39,-2,-7,-3,4,1,-4,5,1,0,3,3,0,5,5,0,3,3,0,-6,0,6,-8,2,-2,0,1,-1,-1,1,1,4,-1
KR_6669567819,420,0,9,4,1,-1,2,1,4,0,4,-1,3,2,1,0,1,-2,2,0,0,0,32,6,-8,2,-2,0,0,1,1,0,-1,4,-1
KR_6652224117,420,-3,0,-12,-10,0,2,2,-5,5,0,-3,3,0,3,1,4,-5,5,0,0,-13,-187,-3,-3,6,-17,0,1,1,1,1,-1,1,-1
KR_6483000873,420,-1,-18,13,-1,-3,3,0,0,3,3,-2,2,0,4,4,8,0,4,4,0,4,-3,-2,-1,3,0,0,1,1,-1,1,1,2,-1
KR_6761739993,420,2,-2,16,0,-7,7,0,2,3,5,4,0,4,-3,5,2,4,0,4,-1,-3,-11,-1,-2,3,-1,0,-1,1,0,-1,-1,4,-1
KR_6760301277,420,-4,-62,0,-7,-1,4,3,0,3,3,-2,4,2,-4,6,2,0,1,1,0,-13,268,-2,-2,4,-3,0,0,-1,-1,0,1,4,-1
KR_6669098265,420,-3,1,-13,-12,-3,3,0,-8,8,0,0,3,3,-2,3,1,1,0,1,0,-6,100,1,-4,3,-2,0,0,-1,-1,0,-1,1,-1
KR_6760059573,420,-2,-49,-8,-4,-1,1,0,0,2,2,-6,6,0,2,2,4,1,0,1,0,1,4,2,-4,2,-1,0,-1,-1,-1,-1,-1,1,-1
KR_6515760631,420,-7,-138,-3,-12,-2,4,2,-1,3,2,-2,2,0,-1,2,1,-6,6,0,0,-13,303,-2,-1,3,2,-1,-3,-1,-1,-1,-1,3,-1
KR_6759786820,420,-1,1,-7,1,0,4,4,-7,7,0,6,1,7,2,2,4,0,2,2,0,0,24,2,-2,0,0,0,2,-1,0,1,1,1,-1
KR_6750424939,420,-4,-101,31,-7,-3,3,0,3,4,7,2,0,2,-7,7,0,-2,3,1,0,-5,-9,-1,-3,4,3,0,-2,1,-1,-1,-1,3,-1
KR_6636609351,420,0,11,9,-6,0,3,3,-4,4,0,-1,3,2,-2,4,2,1,3,4,-1,-6,4,1,-3,2,-1,0,1,-1,1,1,-1,4,-1
KR_6750042859,420,-1,-36,2,0,0,1,1,-2,4,2,0,3,3,3,5,8,-1,2,1,0,1,2,5,-5,0,0,0,0,-1,1,-1,-1,6,-1
KR_6754985970,420,-1,55,30,1,1,1,2,0,4,4,1,3,4,0,3,3,-1,3,2,1,-2,-5,-2,-1,3,-1,0,0,1,1,0,1,4,-1
KR_6743687789,420,-3,-94,-23,-15,-2,2,0,-1,5,4,-5,5,0,-7,8,1,0,2,2,0,-7,47,3,-6,3,-25,0,-1,-1,1,-1,-1,3,-1
KR_6751853353,420,-1,-86,26,-2,0,2,2,0,2,2,0,4,4,-1,2,1,-1,1,0,-1,-2,17,2,-4,2,-6,0,0,1,0,1,-1,2,-1
KR_6663498291,420,2,-1,16,8,2,0,2,3,1,4,3,3,6,0,1,1,0,1,1,0,6,1,2,-4,2,-5,0,0,1,1,1,1,4,-1
KR_6693755531,420,-2,-57,-24,-1,-3,4,1,0,1,1,-2,4,2,5,0,5,-1,2,1,0,-6,-11,-1,-5,6,7,0,0,-1,1,-1,1,6,-1
KR_6764042820,420,1,2,20,2,0,1,1,-2,3,1,0,1,1,2,2,4,2,1,3,0,3,2,3,-6,3,-2,0,0,-1,1,0,1,5,-1
KR_6764786155,420,-2,-75,10,-8,-3,4,1,-3,6,3,-1,2,1,0,2,2,-1,1,0,0,-3,4,0,-4,4,-1,0,-1,1,-1,-1,-1,4,-1
KR_6752673139,440,-3,-84,7,-11,1,0,1,-3,5,2,-6,6,0,0,2,2,-3,3,0,0,-17,-10,-5,-1,6,0,0,-1,-1,-1,-1,-1,1,-1
KR_6757015966,420,-3,-16,33,-5,0,0,0,-3,3,0,-2,5,3,-2,3,1,2,0,2,0,-5,5,-1,0,1,2,0,-1,1,-1,-1,-1,2,-1
KR_6731109499,420,-3,-68,8,-7,-3,3,0,1,2,3,1,3,4,-3,6,3,-3,3,0,0,-5,0,0,-3,3,3,0,-1,1,-1,-1,-1,1,-1
KR_6755121738,420,-4,-44,-16,-16,1,2,3,-3,3,0,-4,4,0,-8,8,0,-2,5,3,-3,-25,-6,-5,-1,6,3,0,0,-1,-1,-1,-1,2,-1
KR_6696835320,420,4,58,42,7,-2,3,1,-1,3,2,7,0,7,1,1,2,2,1,3,0,5,4,0,-2,2,0,0,2,1,1,1,1,4,-1
KR_6745574801,420,-6,-34,-7,-18,0,1,1,-7,7,0,-4,4,0,-5,6,1,-2,3,1,0,-17,-14,-4,0,4,0,0,1,1,1,1,-1,3,-1
KR_6760036452,420,-1,3,32,3,-2,3,1,4,1,5,1,1,2,2,1,3,-2,2,0,0,6,2,3,-7,4,-4,0,0,1,-1,-1,-1,1,-1
KR_6690928326,420,0,-1,-18,-2,1,1,2,-2,6,4,1,3,4,-3,4,1,1,0,1,0,3,-3,-1,-6,7,0,0,0,0,-1,-1,1,0,-1
KR_6762966725,440,1,-19,-9,3,3,1,4,0,1,1,-2,7,5,-1,1,0,3,2,5,1,2,-13,-3,-1,4,2,0,0,0,0,0,1,0,-1
KR_6763826751,420,4,2,24,5,4,2,6,-4,6,2,5,1,6,-3,5,2,3,1,4,0,-3,5,3,-7,4,5,0,1,1,-1,1,1,1,-1
KR_6752183300,420,-2,-9,4,-8,-2,3,1,0,3,3,-4,7,3,0,1,1,-2,2,0,0,1,61,2,-4,2,3,0,-1,-1,0,1,-1,6,-1
KR_6736035879,420,-5,-75,-28,-15,-6,7,1,3,2,5,-10,15,5,-1,2,1,-1,1,0,-1,-7,1,4,-5,1,-2,0,-3,-1,-1,-1,-1,2,-1
KR_6734833851,420,0,0,0,-4,0,0,0,0,2,2,-1,2,1,-1,2,1,-2,2,0,0,-8,-35,1,-5,4,0,0,1,1,1,1,-1,5,-1
KR_6708818384,420,2,15,20,5,0,1,1,1,3,4,1,2,3,0,2,2,3,2,5,0,11,1,-3,-5,8,-5,0,0,-1,1,0,1,6,-1
KR_6655081872,420,-2,16,8,-7,-1,1,0,-2,3,1,4,0,4,-7,7,0,-1,2,1,0,-7,32,0,-2,2,-22,0,-1,-1,-1,-1,-1,2,-1
KR_6728311668,440,2,51,4,7,1,1,2,3,0,3,5,2,7,0,0,0,-2,2,0,0,-2,6,3,-6,3,1,0,0,-1,1,0,1,1,-1
KR_6652482852,420,-9,-59,-14,-16,0,3,3,-4,5,1,-7,8,1,-1,1,0,-4,5,1,0,-12,-9,0,-2,2,2,0,-1,-1,-1,-1,-1,6,-1
KR_6749704762,420,-2,9,-3,-9,-1,3,2,-2,3,1,3,2,5,-4,6,2,-5,5,0,0,-8,-43,1,-4,3,-3,0,-1,1,-1,-1,1,2,-1
KR_6685934033,420,-2,45,-16,-6,0,2,2,-5,8,3,-3,4,1,3,2,5,-1,1,0,0,-10,-5,2,-4,2,-2,0,-2,-1,-1,-1,-1,4,-1
KR_6750452809,420,-2,-66,2,-2,0,0,0,-1,2,1,3,1,4,-2,4,2,-2,2,0,0,-5,-49,-2,-3,5,26,0,0,-1,0,-1,-1,5,-1
KR_6715346110,420,-1,-86,-33,5,-4,5,1,2,3,5,-2,4,2,3,0,3,6,0,6,-1,7,-11,-1,-4,5,2,0,-1,1,-1,-1,-1,5,-1
KR_6641045184,420,-8,-41,-39,-13,-1,2,1,-4,4,0,-8,10,2,-1,5,4,1,0,1,0,-4,7,2,-4,2,-4,0,-2,-1,0,-1,-1,1,-1
KR_6744913844,420,2,24,4,9,2,0,2,2,2,4,1,0,1,-1,1,0,5,0,5,0,9,-12,-2,-3,5,5,0,0,-1,-1,0,1,4,-1
KR_6720322906,420,-1,3,16,0,4,0,4,-4,6,2,-2,4,2,1,0,1,1,1,2,0,-2,-6,-1,-4,5,1,0,0,-1,1,1,-1,4,-1
KR_6762861075,420,-1,-12,12,-9,3,1,4,-2,2,0,-5,5,0,-2,4,2,-3,3,0,0,-10,4,-3,-1,4,-1,0,0,-1,-1,0,-1,6,-1
KR_6761231169,420,-6,-44,-13,-13,-2,2,0,-3,4,1,-2,3,1,-6,7,1,0,1,1,1,-11,-2,-4,-3,7,-5,0,-1,-1,-1,-1,1,1,-1
KR_6757529610,420,-10,-188,-64,-7,-3,3,0,0,0,0,-1,2,1,-2,2,0,-1,1,0,0,-3,-1,0,-1,1,-3,0,-3,0,-1,-1,-1,0,-1
KR_6732088853,440,-3,-24,8,-6,-4,4,0,-1,1,0,5,1,6,-3,3,0,-3,4,1,0,-8,-124,2,-4,2,1,0,-1,-1,0,-1,-1,2,-1
KR_6728163029,420,4,28,16,2,-1,1,0,1,1,2,0,2,2,1,2,3,1,1,2,0,2,2,3,-7,4,-1,0,0,1,-1,0,1,3,-1
KR_6759816020,420,4,14,46,4,3,1,4,0,5,5,5,1,6,-2,4,2,-2,2,0,-1,-7,-3,-3,-5,8,-7,0,1,-1,-1,1,-1,6,-1
KR_6726516107,420,-3,-62,-28,-5,-5,6,1,2,1,3,-6,6,0,3,2,5,1,0,1,1,2,1,3,-5,2,0,0,-2,1,-1,-1,1,4,-1
KR_6758919122,420,-1,20,20,-5,1,1,2,-1,1,0,-4,8,4,-1,3,2,0,0,0,0,-11,-112,1,-4,3,-4,0,-1,-1,-1,-1,-1,2,-1
KR_6754285805,420,-5,-134,-40,-9,-3,5,2,1,0,1,0,1,1,-4,6,2,-3,5,2,-1,-1,4,1,-4,3,0,0,0,-1,0,-1,-1,2,-1
KR_6729219388,420,-1,-41,-12,-7,-5,5,0,-2,4,2,0,2,2,1,4,5,-1,2,1,1,2,354,-2,-4,6,2,0,1,-1,-1,1,1,2,-1
KR_6714599044,420,-6,-101,-17,-10,-1,3,2,0,1,1,-4,4,0,-2,2,0,-3,3,0,0,-6,3,5,-7,2,-6,0,-2,-1,1,-1,1,3,-1
KR_6760244112,420,-4,-19,-31,4,1,1,2,0,3,3,-3,4,1,4,2,6,2,1,3,-1,9,9,4,-5,1,-2,0,-1,-1,-1,-1,-1,6,-1
KR_6761457837,420,-9,-56,-23,-17,-2,2,0,0,3,3,-3,5,2,-7,8,1,-5,5,0,-1,-24,-501,0,-1,1,-10,0,-3,-1,-1,-1,-1,1,-1
KR_6646806879,440,3,64,-15,7,6,2,8,-1,7,6,-2,5,3,4,2,6,0,2,2,0,5,-517,-1,-3,4,2,0,1,1,1,1,1,3,-1
KR_6679477207,420,0,13,-6,-5,0,4,4,-2,3,1,-2,3,1,-1,3,2,0,1,1,0,-8,-116,-1,-3,4,4,0,0,-1,-1,0,-1,5,-1
KR_6694197431,440,-2,-66,0,-10,-4,4,0,2,1,3,-7,9,2,-1,8,7,0,3,3,0,-6,-5,-3,-2,5,0,0,-1,-1,-1,-1,1,1,-1
KR_6626532161,420,0,-24,-8,-3,1,1,2,1,2,3,-5,6,1,1,3,4,-1,1,0,0,-7,-179,5,-6,1,-3,0,-1,-1,-1,-1,-1,5,-1
KR_6749269000,440,-2,-94,5,-7,5,0,5,-11,13,2,-3,3,0,1,2,3,1,0,1,0,-8,-6,-4,-2,6,-3,0,0,1,0,1,-1,5,-1
KR_6753068353,420,-7,-43,-80,-9,4,1,5,-6,6,0,-8,8,0,1,0,1,0,1,1,0,-10,-12,-2,-1,3,-1,0,-1,-1,-1,1,1,6,-1
KR_6757841413,420,-1,-42,8,2,1,0,1,4,0,4,2,2,4,-2,5,3,-3,4,1,-2,-4,5,3,-7,4,-5,0,0,-1,1,0,-1,5,-1
KR_6748953290,420,-1,5,8,-6,-3,3,0,1,1,2,0,4,4,-3,3,0,-1,1,0,0,-6,-1,-2,-2,4,0,0,0,-1,1,0,-1,4,-1
KR_6743729979,420,-1,-63,29,-4,-2,2,0,-2,3,1,2,3,5,-2,2,0,0,0,0,0,-9,-30,-8,-1,9,2,0,1,-1,1,1,1,1,-1
KR_6345247127,420,0,-29,-15,8,4,0,4,4,4,8,1,2,3,-1,2,1,0,0,0,0,5,-20,3,-7,4,2,0,1,-1,0,1,-1,4,-1
KR_6649397601,420,-5,-31,0,-14,-7,7,0,1,3,4,2,3,5,-6,8,2,-4,4,0,0,-13,-303,-3,0,3,-2,0,-2,-1,0,-1,-1,1,-1
KR_6760820625,420,-6,-112,-27,-18,-4,5,1,1,0,1,-4,4,0,-7,7,0,-4,5,1,-1,-17,-12,0,-1,1,-2,0,-3,0,1,-1,-1,0,-1
KR_6764535873,420,-1,-14,-3,-4,2,0,2,-3,3,0,3,2,5,-3,4,1,-3,4,1,0,-6,-14,1,-2,1,1,0,0,-1,-1,-1,-1,1,-1
KR_6752809463,440,1,49,8,-2,2,1,3,3,2,5,-2,3,1,-3,4,1,-2,5,3,0,-6,-1,-1,-3,4,2,0,-1,-1,-1,-1,-1,3,-1
KR_6644210861,420,1,38,-2,-6,-5,5,0,-4,4,0,-1,2,1,1,0,1,3,2,5,0,-10,1,-1,-4,5,-2,0,1,1,0,1,-1,5,-1
KR_6660009508,420,-2,-8,-20,-6,0,2,2,-2,3,1,1,0,1,0,2,2,-5,5,0,0,-7,-40,-1,-5,6,27,0,0,1,-1,0,1,5,-1
KR_6704045281,420,-4,-10,-35,-5,1,3,4,-2,3,1,1,6,7,-2,3,1,-3,3,0,0,-2,13,2,-8,6,-1,0,-1,-1,-1,-1,-1,6,-1
KR_6736616416,420,-2,-49,-28,1,0,3,3,0,3,3,0,4,4,0,2,2,1,0,1,0,-4,3,3,-7,4,-5,0,1,1,1,-1,-1,2,-1
KR_6706987887,420,-5,-50,-30,-16,2,1,3,-6,6,0,-8,10,2,-1,2,1,-3,3,0,1,-13,-39,-2,-5,7,22,0,-1,1,1,-1,1,5,-1
KR_6705555504,420,3,-18,20,7,-2,4,2,0,5,5,0,3,3,5,3,8,4,1,5,2,19,2,0,-2,2,-3,0,1,-1,-1,1,-1,5,-1
KR_6693445569,420,0,-2,20,-4,2,0,2,-1,4,3,-2,5,3,-1,5,4,-2,2,0,0,-9,-4,-1,-5,6,-2,0,1,1,1,1,-1,3,-1
KR_6699854931,420,2,123,-8,-4,1,0,1,-2,5,3,-1,4,3,-2,2,0,0,1,1,0,-5,1,-2,-5,7,0,0,0,-1,1,0,-1,6,-1
KR_6746137995,420,-4,-86,-12,-4,-5,5,0,3,1,4,0,3,3,-2,4,2,0,3,3,0,1,10,3,-4,1,-6,0,-1,-1,-1,-1,-1,6,-1
KR_6732955779,420,2,19,7,-3,3,1,4,2,2,4,-3,4,1,-6,6,0,1,0,1,0,-9,118,-1,-4,5,-7,0,1,-1,1,1,1,2,-1
KR_6724121091,420,-5,-87,-12,-5,-3,5,2,-5,7,2,2,4,6,5,0,5,-4,4,0,0,3,40,-1,-5,6,-24,0,-2,0,-1,-1,-1,0,-1
KR_6724736898,420,0,29,21,-8,0,0,0,0,0,0,-2,4,2,-3,4,1,-3,4,1,0,-10,-4,0,-4,4,1,0,0,1,-1,1,1,4,-1
KR_6763630087,420,-4,-31,-16,-10,-3,3,0,-1,3,2,2,0,2,-4,5,1,-4,4,0,0,-17,11,-2,-3,5,0,0,-2,-1,-1,-1,1,2,-1
KR_6741291677,420,-6,-83,-8,-14,-6,6,0,-4,5,1,3,2,5,-3,3,0,-4,4,0,-1,-13,0,-4,-3,7,5,0,-1,1,1,-1,-1,5,-1
KR_6702352846,420,-1,41,5,-4,0,2,2,-4,7,3,-2,5,3,2,0,2,0,0,0,-1,-6,-14,1,-4,3,-4,0,1,1,0,1,-1,3,-1
KR_6673019933,420,2,-7,-15,6,1,0,1,6,0,6,0,3,3,-2,3,1,1,1,2,0,4,6,1,-5,4,-2,0,0,1,1,0,1,4,-1
KR_6744916711,420,-2,-6,-11,-7,0,3,3,-1,3,2,-1,2,1,-3,3,0,-2,2,0,0,-3,60,1,-4,3,-24,0,0,-1,-1,-1,-1,4,-1
KR_6746972362,420,-2,-51,20,-7,-6,6,0,-1,3,2,2,1,3,-2,2,0,0,1,1,0,-6,184,-3,0,3,1,0,-2,-1,-1,-1,-1,5,-1
KR_6742510368,420,0,-23,15,-6,2,1,3,3,2,5,-4,6,2,-6,7,1,-1,2,1,1,-4,3,4,-10,6,2,0,-1,1,-1,-1,1,4,-1
KR_6710048486,420,1,10,-4,6,-3,5,2,1,2,3,5,2,7,1,2,3,2,0,2,0,6,-95,0,-4,4,-3,0,0,1,-1,1,1,5,-1
KR_6458490261,420,0,-30,8,4,0,1,1,-1,5,4,4,1,5,0,1,1,1,0,1,1,2,5,1,-8,7,0,0,0,1,1,1,1,2,-1
KR_6754595883,420,-5,-142,-16,-4,-4,5,1,3,0,3,0,4,4,-3,7,4,0,1,1,0,3,-27,6,-9,3,3,0,-1,1,-1,-1,-1,6,-1
KR_6764023739,420,0,2,24,3,4,0,4,-3,6,3,2,1,3,3,0,3,-3,5,2,0,2,122,1,-4,3,-4,0,1,1,-1,1,1,4,-1
KR_6634694928,420,-4,-20,-24,-8,-1,2,1,1,4,5,-2,4,2,-5,11,6,-1,3,2,0,-9,-8,0,-4,4,0,0,0,-1,-1,1,1,5,-1
KR_6728567630,420,2,-24,28,3,1,1,2,0,1,1,3,1,4,0,1,1,-1,4,3,0,1,0,2,-3,1,2,0,-1,1,-1,-1,-1,6,-1
KR_6714540017,420,0,44,9,5,4,0,4,-2,4,2,0,3,3,1,3,4,2,1,3,0,3,2,-1,-5,6,4,0,2,1,1,1,1,3,-1
KR_6733125854,440,-3,-102,-18,-13,2,2,4,-5,5,0,-1,2,1,-6,7,1,-3,3,0,0,-13,-28,0,-4,4,-1,0,-1,-1,-1,-1,-1,2,-1
KR_6714474542,420,-1,-30,-10,-1,-1,1,0,0,2,2,2,1,3,-2,5,3,0,0,0,0,1,2,0,-4,4,1,0,-2,-1,-1,-1,-1,6,-1
KR_6747530201,420,-6,-94,-18,-12,0,0,0,-4,4,0,-3,5,2,-3,3,0,-2,2,0,0,-17,-7,-6,-2,8,-4,0,-2,-1,-1,-1,1,1,-1
KR_6685816798,420,-2,-47,-8,-2,-3,5,2,-2,3,1,-2,4,2,6,0,6,-1,1,0,0,2,1,5,-7,2,-2,0,0,-1,1,0,1,4,-1
KR_6731688065,420,-3,-46,-18,-7,0,2,2,-5,5,0,-3,3,0,0,2,2,1,0,1,0,-6,-71,-4,-2,6,1,0,0,-1,-1,0,1,6,-1
KR_6733751070,420,-1,-74,41,-6,5,2,7,0,3,3,-7,10,3,-3,6,3,-1,2,1,-2,-9,-8,-3,-2,5,0,0,-2,1,-1,-1,-1,4,-1
KR_6745505018,420,-3,-37,-29,-7,0,0,0,-1,2,1,-7,7,0,-1,3,2,2,0,2,0,-9,-5,0,-4,4,2,0,0,-1,-1,-1,-1,6,-1
KR_6642929577,420,-2,-56,2,-5,-4,5,1,-1,1,0,-4,4,0,4,2,6,0,1,1,0,1,13,-2,-1,3,0,0,-2,0,0,-1,1,0,-1
KR_6745795567,420,-2,-71,-3,-6,0,1,1,1,2,3,-11,12,1,4,1,5,0,0,0,0,-2,-3,0,-4,4,1,0,-1,-1,0,-1,-1,1,-1
KR_6581340372,420,-4,-82,-11,-3,-4,4,0,-1,2,1,-1,3,2,1,3,4,2,0,2,1,1,17,2,-4,2,-28,0,-2,0,-1,-1,1,0,-1
KR_6717866083,420,3,39,5,3,-4,4,0,-3,5,2,5,0,5,3,2,5,2,1,3,1,2,-2,-3,-2,5,3,0,-1,-1,-1,-1,1,1,-1
KR_6727740687,420,0,-32,-4,-1,-6,6,0,-2,4,2,3,3,6,1,3,4,3,0,3,-1,-3,-3,-2,-2,4,1,0,-1,1,0,-1,-1,4,-1
KR_6743350184,440,-9,-51,-53,-19,-4,7,3,-7,9,2,-4,4,0,2,2,4,-6,7,1,-1,-14,8,-1,-3,4,-3,0,0,-1,-1,-1,-1,5,-1
KR_6729169276,420,-5,-37,-14,-14,-3,3,0,-8,9,1,-4,4,0,0,2,2,1,1,2,0,-13,1,0,-3,3,2,0,-1,-1,1,-1,-1,1,-1
KR_6724347148,420,-6,-142,9,-16,-5,5,0,-5,9,4,-3,5,2,-2,7,5,-1,1,0,-1,-11,-36,-4,-3,7,3,0,-3,1,-1,-1,-1,3,-1
KR_6675556196,420,-3,-22,-20,-9,0,2,2,-2,2,0,-2,2,0,0,5,5,-5,5,0,0,-12,10,2,-4,2,1,0,0,-1,-1,0,1,6,-1
KR_6616895908,420,1,19,0,-1,0,1,1,1,2,3,-2,2,0,-1,2,1,1,0,1,0,3,0,-3,-1,4,0,0,0,1,-1,0,1,4,-1
KR_6743789785,420,2,-2,5,1,-1,4,3,1,1,2,1,1,2,0,4,4,0,0,0,1,0,8,-2,-4,6,6,0,1,-1,-1,-1,1,2,-1
KR_6728588857,420,1,-12,16,4,-1,2,1,4,0,4,3,4,7,-5,5,0,3,0,3,0,2,-353,5,-9,4,-7,0,0,-1,1,0,1,6,-1
KR_6667920029,420,-1,-8,-3,-1,5,0,5,0,2,2,-7,7,0,1,4,5,0,0,0,1,0,-9,-2,-5,7,3,0,0,-1,-1,-1,1,3,-1
KR_6746225142,420,1,27,5,3,3,1,4,1,0,1,-2,7,5,0,4,4,1,1,2,0,1,-147,-1,-1,2,-20,0,0,1,1,1,-1,3,-1
KR_6750386180,420,-2,2,-7,-5,-4,5,1,-4,4,0,3,1,4,0,0,0,0,0,0,0,-8,-21,1,-4,3,1,0,0,-1,-1,-1,1,2,-1
KR_6739263941,420,-10,-113,-16,-17,-1,2,1,-3,5,2,-14,15,1,1,5,6,0,0,0,0,-6,7,-2,-1,3,-1,0,-3,-1,-1,-1,-1,5,-1
KR_6670447794,420,-1,19,-12,-8,-4,8,4,7,2,9,-4,7,3,-3,4,1,-4,6,2,2,-14,-7,-2,-2,4,0,0,0,-1,-1,-1,1,3,-1
KR_6726961187,440,-3,-63,28,-6,-2,3,1,-1,4,3,4,2,6,-4,6,2,-3,5,2,0,-9,-15,0,-4,4,-3,0,0,-1,1,1,1,6,-1
KR_6755672299,420,-4,-64,-20,-10,4,0,4,-4,5,1,-4,5,1,-1,2,1,-5,5,0,0,-10,-131,-3,-2,5,2,0,-2,-1,-1,-1,-1,6,-1
KR_6763649364,420,3,64,39,1,1,0,1,-2,2,0,3,0,3,-2,4,2,1,0,1,0,-2,48,3,-4,1,-5,0,1,1,1,1,-1,4,-1
KR_6633598886,420,-5,-75,-36,-6,0,1,1,-2,4,2,2,1,3,-3,5,2,-3,3,0,0,-3,-113,0,-5,5,-1,0,-2,-1,-1,-1,-1,3,-1
KR_6750735683,420,0,22,19,2,2,0,2,-5,6,1,5,1,6,0,2,2,0,0,0,0,-5,14,-1,-3,4,-2,0,0,1,-1,1,-1,2,-1
KR_6761344951,420,-5,-92,-28,-9,-8,9,1,1,1,2,-1,2,1,-1,2,1,0,0,0,0,0,391,3,-7,4,-3,0,-2,1,1,-1,-1,2,-1
KR_6726678532,420,-3,6,-5,-5,-3,4,1,3,2,5,-2,4,2,-2,2,0,-1,2,1,0,-8,-7,1,-3,2,3,0,-1,-1,1,-1,-1,2,-1
KR_6665956556,420,-2,30,-16,0,2,0,2,4,2,6,-7,8,1,1,1,2,0,0,0,0,-2,2,5,-6,1,5,0,0,1,0,0,-1,6,-1
KR_6756817031,420,0,-35,28,3,6,0,6,1,3,4,-3,5,2,-3,3,0,2,2,4,0,9,91,3,-7,4,9,0,0,1,0,0,1,4,-1
KR_6689123001,420,0,87,4,-2,2,1,3,-3,6,3,-1,2,1,0,1,1,0,2,2,0,-3,219,-3,-3,6,14,0,1,-1,-1,1,1,1,-1
KR_6747391490,440,-3,-44,12,-8,-2,5,3,3,2,5,0,5,5,-5,7,2,-4,6,2,0,-4,5,-6,-2,8,6,0,-3,1,-1,-1,1,2,-1
KR_6710538955,420,-6,-69,-13,-10,-4,5,1,-2,2,0,-2,3,1,1,2,3,-3,3,0,0,-8,-21,2,-7,5,-8,0,-1,-1,1,-1,-1,2,-1
KR_6688876451,420,-1,61,-12,-4,-1,1,0,-1,5,4,-3,4,1,1,2,3,0,0,0,0,-4,-9,-2,-3,5,6,0,0,-1,1,0,1,4,-1
KR_6746779800,420,-2,-30,-4,0,0,2,2,3,1,4,-4,8,4,4,0,4,-3,3,0,1,4,57,0,-4,4,-8,0,0,-1,-1,1,1,6,-1
KR_6730107789,440,-1,-38,-14,0,-1,4,3,1,3,4,-2,4,2,2,3,5,0,1,1,-1,1,6,0,-1,1,-1,0,-1,1,-1,-1,-1,4,-1
KR_6689339025,420,-1,-98,-6,-7,-3,4,1,1,3,4,-7,7,0,1,0,1,1,0,1,-1,-5,-3,-4,-1,5,-3,0,-1,-1,1,-1,-1,5,-1
KR_6723163207,420,-3,-67,22,-2,0,1,1,-2,3,1,-2,4,2,2,0,2,0,0,0,0,-6,-142,-2,-2,4,-2,0,-1,-1,1,-1,1,4,-1
KR_6670314818,420,-7,-77,1,-20,-3,4,1,-7,8,1,0,2,2,-6,7,1,-4,5,1,-4,-25,-1,-1,-2,3,-2,0,-2,-1,0,-1,1,2,-1
KR_6745234134,420,-1,22,13,-2,-1,2,1,1,5,6,-1,3,2,-1,1,0,0,1,1,-1,-10,-11,-1,-5,6,-3,0,1,0,-1,1,-1,0,-1
KR_6665962765,420,-1,-30,0,-1,-6,6,0,0,3,3,-3,3,0,7,0,7,1,0,1,0,5,1,-2,-5,7,-2,0,0,1,-1,0,-1,1,-1
KR_6726539310,420,-2,-28,-12,-7,-1,2,1,0,2,2,0,1,1,-4,4,0,-2,2,0,0,-2,-11,-3,-3,6,1,0,-1,-1,-1,-1,-1,2,-1
KR_6758295431,420,3,-34,0,4,-3,3,0,2,2,4,5,1,6,0,3,3,0,2,2,-1,4,-117,2,-5,3,2,0,0,0,-1,0,-1,0,-1
KR_6752501987,420,1,29,-3,2,3,0,3,0,2,2,4,0,4,-5,6,1,0,0,0,0,-1,-7,-3,-4,7,0,0,1,-1,-1,1,1,5,-1
KR_6755447867,420,-4,-30,-38,-8,1,1,2,-3,3,0,-1,1,0,-3,5,2,-2,3,1,-1,-6,-3,2,-4,2,-8,0,-2,-1,-1,-1,-1,2,-1
KR_6710303940,420,-1,36,-8,-1,-2,4,2,-1,1,0,2,0,2,2,0,2,-2,3,1,0,-2,0,-2,0,2,2,0,0,1,-1,-1,1,3,-1
KR_6690883342,420,-5,-10,20,-10,-1,2,1,-2,3,1,-4,5,1,-1,4,3,-2,2,0,0,-8,-30,5,-9,4,16,0,-1,1,1,-1,-1,6,-1
KR_6755481947,420,-3,-63,20,-4,-2,2,0,-2,4,2,1,3,4,-3,6,3,2,2,4,0,-5,2,0,-3,3,-2,0,0,-1,0,0,1,3,-1
KR_6734340800,440,0,24,-16,6,4,1,5,-2,4,2,-1,1,0,3,6,9,2,2,4,0,4,244,3,-5,2,1,0,0,1,1,1,1,1,-1
KR_6702989500,420,-3,-13,0,-14,-6,7,1,-7,8,1,-1,1,0,0,2,2,0,4,4,0,-11,325,-8,0,8,-1,0,-1,-1,-1,-1,-1,3,-1
KR_6745619471,440,0,-27,-3,-2,-1,1,0,-3,4,1,4,1,5,-1,2,1,-1,1,0,0,0,3,-2,-2,4,-2,0,-1,-1,-1,-1,1,4,-1
KR_6580939254,420,-3,-15,-18,-2,-2,5,3,1,2,3,-4,6,2,3,2,5,0,1,1,1,4,17,4,-5,1,0,0,1,1,0,1,1,4,-1
KR_6702699581,420,-1,-68,-31,-7,-4,5,1,-2,3,1,-1,4,3,1,1,2,-1,1,0,0,-4,-27,-2,-4,6,4,0,0,0,-1,-1,1,0,-1
KR_6756803116,420,-5,-59,-32,-9,0,2,2,-1,3,2,2,0,2,-8,9,1,-2,2,0,0,-10,-12,-4,-2,6,-1,0,-1,-1,-1,-1,-1,2,-1
KR_6676063646,440,1,13,-16,5,-2,4,2,0,1,1,2,3,5,5,1,6,0,1,1,0,9,1,-1,-2,3,3,0,0,1,-1,-1,-1,1,-1
KR_6751671329,420,-2,23,20,-13,-3,4,1,-3,3,0,0,0,0,-4,4,0,-3,3,0,-1,-16,-119,-1,-3,4,-2,0,-1,-1,-1,-1,-1,6,-1
KR_6755614885,440,0,10,10,-7,1,1,2,2,3,5,-2,3,1,-4,7,3,-4,5,1,-1,0,8,-1,-4,5,1,0,-1,1,-1,-1,-1,1,-1
KR_6764009334,420,-4,-60,28,-2,3,2,5,-2,4,2,-4,4,0,1,1,2,0,2,2,-1,-5,4,3,-9,6,0,0,-1,-1,-1,-1,-1,5,-1
KR_6728124986,420,-6,-51,-30,-8,1,0,1,-3,4,1,-6,6,0,-1,1,0,1,0,1,0,2,7,1,-5,4,-3,0,-2,-1,-1,-1,1,4,-1
KR_6641018387,420,-6,-33,-19,-19,-2,3,1,-7,7,0,-7,10,3,-3,3,0,0,0,0,-2,-13,-238,4,-6,2,2,0,-3,-1,-1,-1,-1,4,-1
KR_6756330380,420,-1,3,5,2,4,0,4,-5,6,1,-2,4,2,2,4,6,3,0,3,0,2,0,8,-10,2,-3,0,1,-1,1,1,1,1,-1
KR_6722460509,420,0,0,4,-6,-4,4,0,-4,6,2,4,1,5,0,4,4,-2,2,0,-1,-7,6,1,-3,2,-8,0,-1,1,1,-1,-1,3,-1
KR_6757829609,420,-6,-76,-10,-11,1,1,2,2,1,3,-5,7,2,-5,7,2,-4,4,0,0,-8,-12,0,-2,2,-2,0,-2,-1,-1,-1,-1,6,-1
KR_6660956769,420,2,-24,29,8,0,2,2,3,1,4,6,0,6,1,3,4,-2,4,2,0,-1,13,6,-9,3,0,0,0,1,1,1,-1,6,-1
KR_6664634783,420,-2,-62,24,-5,-2,4,2,-2,5,3,1,0,1,-2,3,1,0,0,0,0,-5,-26,0,-2,2,-2,0,0,-1,-1,0,-1,6,-1
KR_6688140376,420,-4,-41,4,-11,0,4,4,-2,2,0,-5,6,1,-3,4,1,-1,1,0,0,-7,-12,-5,-1,6,-1,0,-1,1,1,-1,-1,1,-1
KR_6698427035,420,1,57,7,-3,1,1,2,-1,2,1,-1,4,3,0,3,3,-2,2,0,-1,-8,43,0,-6,6,-25,0,1,-1,1,1,-1,5,-1
KR_6754250008,420,3,43,30,8,-1,1,0,9,3,12,6,1,7,-7,8,1,1,1,2,0,6,21,-3,-2,5,5,0,0,-1,1,1,1,6,-1
KR_6762766439,420,1,-13,4,-4,-6,6,0,3,1,4,-4,4,0,3,5,8,0,0,0,-3,-6,-5,4,-7,3,0,0,-1,-1,-1,-1,-1,6,-1
KR_6734782270,420,-1,3,24,-6,-5,5,0,-1,3,2,1,3,4,-2,3,1,1,4,5,0,-7,-3,2,-5,3,4,0,-1,1,1,-1,1,5,-1
KR_6758798726,420,-2,-61,-25,-4,-3,3,0,-5,8,3,2,1,3,0,3,3,2,2,4,-1,-2,104,0,-2,2,-1,0,-1,-1,1,-1,-1,2,-1
KR_6713575253,440,-3,-38,40,-5,-1,3,2,-5,6,1,-3,4,1,5,3,8,-1,2,1,1,-1,-3,3,-5,2,1,0,0,1,-1,-1,1,1,-1
KR_6745530030,420,-2,-42,-44,-7,-4,5,1,-5,7,2,-1,2,1,3,3,6,0,1,1,-1,-7,15,-4,-3,7,-1,0,0,0,-1,-1,-1,0,-1
KR_6764202752,420,0,57,14,-2,-4,4,0,-1,4,3,3,5,8,0,4,4,0,1,1,0,-11,-4,-3,0,3,-1,0,0,-1,-1,1,-1,1,-1
KR_6670648926,420,-4,-1,-16,-10,0,2,2,-2,3,1,-3,5,2,-1,2,1,-4,4,0,0,-16,-6,3,-6,3,-3,0,-1,-1,-1,-1,-1,6,-1
KR_6653034204,420,-3,-48,-4,-10,-1,3,2,-1,2,1,-1,1,0,-6,7,1,-1,1,0,0,-14,-8,-4,-3,7,2,0,-2,-1,0,-1,-1,5,-1
KR_6746683347,420,-3,-49,-22,-2,-3,4,1,-1,1,0,4,2,6,0,5,5,-2,3,1,0,6,253,-1,-2,3,-1,0,-1,-1,-1,-1,-1,4,-1
KR_6694878225,420,-8,-146,-8,-12,-5,5,0,-3,5,2,-3,3,0,-1,3,2,0,1,1,0,-6,-9,2,-3,1,-4,0,-4,0,1,-1,-1,0,-1
KR_6762694451,420,-3,33,-24,-9,0,2,2,-3,6,3,-1,1,0,-2,2,0,-3,3,0,0,-9,-8,1,-4,3,-1,0,-1,-1,-1,-1,-1,1,-1
KR_6762077175,420,-2,-11,-24,-6,1,2,3,-3,6,3,-6,7,1,1,1,2,1,0,1,0,-8,6,0,-5,5,-2,0,-1,-1,-1,-1,1,2,-1
KR_6716459288,420,-1,-4,11,-7,2,1,3,-3,6,3,-1,4,3,-5,9,4,0,0,0,0,-14,2,1,-4,3,0,0,-1,1,-1,-1,-1,5,-1
KR_6687904655,420,-1,-79,0,-1,1,3,4,2,0,2,0,2,2,-2,3,1,-2,2,0,0,-2,-21,3,-5,2,-3,0,-2,-1,-1,-1,-1,2,-1
KR_6612751537,420,-2,-106,35,4,-2,4,2,2,2,4,-2,2,0,5,1,6,1,1,2,0,6,5,-1,-1,2,0,0,-1,1,-1,-1,1,2,-1
KR_6743036570,420,3,40,52,4,13,0,13,0,3,3,-3,3,0,-2,4,2,-4,4,0,0,-12,-217,0,-3,3,0,0,1,-1,1,1,1,2,-1
KR_6752757559,420,1,62,15,-3,6,2,8,-2,3,1,-2,4,2,-1,1,0,-4,4,0,0,-18,6,6,-7,1,-6,0,2,1,-1,1,1,4,-1
KR_6759345710,420,-2,-6,-16,-2,-5,6,1,-1,1,0,0,0,0,4,0,4,0,1,1,0,4,-2,2,-3,1,3,0,0,-1,-1,-1,-1,1,-1
KR_6691826285,420,1,65,-16,3,-3,4,1,3,1,4,3,1,4,-1,2,1,1,1,2,0,-7,32,2,-6,4,-14,0,1,1,-1,1,-1,2,-1
KR_6638251089,420,-4,-21,2,-6,-4,4,0,2,1,3,-3,6,3,-2,2,0,1,0,1,0,2,-13,-4,0,4,0,0,-1,-1,-1,-1,-1,3,-1
KR_6732372909,420,3,17,-8,5,2,0,2,-1,2,1,-3,5,2,6,3,9,1,1,2,0,-2,13,0,-3,3,6,0,0,1,-1,1,-1,6,-1
KR_6760980151,420,0,-38,4,3,-4,4,0,0,1,1,4,2,6,2,1,3,1,1,2,0,3,19,4,-6,2,-4,0,-1,1,0,-1,1,3,-1
KR_6763668690,420,-2,-63,7,-13,0,2,2,1,0,1,-1,5,4,-12,12,0,-1,1,0,0,-8,-3,-1,-1,2,2,0,-1,-1,-1,-1,-1,3,-1
KR_6759036285,420,-7,-67,-80,-8,2,0,2,-4,4,0,0,1,1,-5,6,1,-1,1,0,0,-7,-57,1,-5,4,-35,0,-3,-1,-1,-1,-1,5,-1
KR_6551535910,420,-5,-42,-39,-4,-5,6,1,3,1,4,-1,2,1,1,1,2,-2,2,0,0,-1,-7,0,-4,4,0,0,0,1,-1,-1,-1,5,-1
KR_6479361886,420,2,8,12,-4,3,2,5,3,1,4,-1,3,2,-8,10,2,-1,1,0,0,-10,12,9,-10,1,0,0,-1,0,-1,-1,-1,0,-1
KR_6735475779,420,1,40,4,2,0,3,3,-4,4,0,7,0,7,-1,1,0,0,0,0,1,-3,37,-4,-1,5,-2,0,0,-1,-1,1,1,3,-1
KR_6760226035,420,1,-32,14,1,2,0,2,3,1,4,1,3,4,-4,5,1,-1,2,1,0,6,-3,1,-6,5,3,0,0,-1,-1,1,1,4,-1
KR_6659197020,440,-1,-125,48,-2,0,1,1,0,4,4,-1,3,2,1,3,4,-2,6,4,0,5,36,4,-7,3,5,0,-2,1,0,-1,1,6,-1
KR_6749302902,420,1,15,29,-9,1,4,5,-5,5,0,-2,3,1,-4,7,3,1,0,1,0,-18,4,-1,-3,4,-2,0,1,-1,-1,-1,-1,4,-1
KR_6326770681,420,0,-10,-13,-3,-3,5,2,1,2,3,0,2,2,-1,2,1,0,2,2,0,-2,6,1,-5,4,-4,0,0,0,1,0,-1,0,-1
KR_6550978868,420,2,-40,16,-4,1,1,2,-2,3,1,2,2,4,-6,6,0,1,0,1,0,-9,206,-4,-4,8,-7,0,0,1,-1,0,-1,1,-1
KR_6695555838,440,0,71,-1,-2,-3,3,0,-4,5,1,1,0,1,3,2,5,1,0,1,0,0,29,2,-5,3,-16,0,1,1,-1,1,1,5,-1
KR_6722375110,420,-1,-20,0,-3,-1,1,0,-9,11,2,1,0,1,4,0,4,2,1,3,0,-1,106,-1,-3,4,1,0,0,-1,1,0,1,5,-1
KR_6670806365,420,-3,-41,-14,-8,-3,4,1,-5,6,1,0,2,2,0,3,3,0,1,1,0,-3,6,2,-4,2,0,0,1,-1,0,1,-1,3,-1
KR_6582300758,420,1,-24,-7,4,2,1,3,-1,2,1,3,5,8,0,3,3,0,1,1,0,1,-89,-1,-4,5,-1,0,0,0,-1,0,1,0,-1
KR_6757986538,420,3,50,-6,6,2,0,2,2,0,2,-5,6,1,6,1,7,1,1,2,0,5,-22,2,-4,2,-1,0,0,1,-1,-1,1,2,-1
KR_6759259954,420,1,19,-4,5,5,0,5,-3,4,1,0,3,3,2,4,6,1,1,2,0,5,-120,0,-4,4,-2,0,1,-1,1,1,1,3,-1
KR_6762307228,420,0,-29,-8,-4,-3,3,0,6,0,6,-4,5,1,0,3,3,-3,3,0,0,1,-10,-6,-2,8,3,0,-1,1,1,-1,-1,4,-1
KR_6626699684,420,4,47,30,5,-2,5,3,4,1,5,0,2,2,0,3,3,3,1,4,0,3,7,2,-5,3,-2,0,-1,1,-1,-1,1,3,-1
KR_6715644628,420,2,11,16,4,-4,4,0,3,0,3,0,4,4,6,1,7,-1,3,2,0,5,11,2,-3,1,-4,0,2,1,1,1,1,2,-1
KR_6696335218,420,-5,-35,-16,-11,-6,6,0,-4,6,2,1,4,5,-2,2,0,0,0,0,-1,-4,-3,1,-7,6,2,0,-3,1,-1,-1,-1,2,-1
KR_6764376012,420,0,2,-12,3,1,2,3,-1,3,2,1,2,3,1,1,2,1,2,3,0,3,-17,-1,-4,5,3,0,-1,-1,1,-1,1,3,-1
KR_6732371254,420,-3,-57,-32,0,-3,5,2,1,4,5,-4,5,1,5,1,6,1,0,1,0,8,6,2,-4,2,0,0,-1,-1,-1,-1,1,4,-1
KR_6761463061,440,-1,29,-13,-6,-1,2,1,-3,5,2,-2,6,4,0,0,0,0,1,1,0,-4,5,2,-2,0,-3,0,1,1,0,1,1,5,-1
KR_6744649054,420,-4,-46,13,-5,-1,1,0,-2,3,1,3,1,4,-3,3,0,-2,2,0,0,-1,-44,0,-3,3,7,0,0,1,1,0,-1,4,-1
KR_6746709609,420,-4,-43,8,-13,-1,3,2,-4,4,0,-3,3,0,-5,6,1,0,1,1,-2,-13,-3,3,-5,2,-3,0,-2,-1,-1,-1,-1,5,-1
KR_6699209689,420,3,63,10,5,3,2,5,2,1,3,-2,4,2,2,2,4,0,0,0,0,4,22,-1,-4,5,-22,0,0,1,0,0,1,3,-1
KR_6729788799,440,3,14,4,5,-1,2,1,2,0,2,1,1,2,1,4,5,2,0,2,0,-6,-19,1,-4,3,5,0,0,1,-1,-1,1,6,-1
KR_6498509151,420,-3,-3,8,-10,1,1,2,1,2,3,-3,4,1,-9,10,1,0,0,0,0,-13,-5,0,-4,4,-2,0,1,-1,1,1,1,4,-1
KR_6759574189,420,-1,-4,-40,-4,-3,7,4,0,1,1,2,4,6,-2,3,1,-1,1,0,0,-8,-123,-4,-4,8,-3,0,0,1,-1,-1,1,5,-1
KR_6716022023,420,-1,-12,-22,1,-1,1,0,0,3,3,2,0,2,5,1,6,-5,5,0,0,5,-2,2,-5,3,-1,0,0,0,-1,0,-1,0,-1
KR_6672176749,420,0,47,24,-9,0,1,1,0,3,3,0,3,3,-7,7,0,-2,3,1,0,-9,28,4,-4,0,-26,0,0,0,0,0,-1,0,-1
KR_6753369141,420,-2,-39,-12,-7,1,0,1,-1,2,1,-4,5,1,2,2,4,-5,5,0,0,-5,-5,-1,-3,4,-5,0,-1,-1,1,-1,1,2,-1
KR_6697341314,420,1,5,13,-3,4,0,4,1,4,5,-2,2,0,-7,8,1,1,2,3,0,-7,152,8,-10,2,-7,0,0,1,1,1,1,3,-1
KR_6711862886,420,-1,36,-8,-4,1,2,3,0,3,3,2,1,3,-6,8,2,-1,1,0,1,-3,4,0,-2,2,-4,0,1,-1,1,-1,1,2,-1
KR_6732792251,420,2,-29,-4,-1,-5,5,0,-2,3,1,4,3,7,2,0,2,0,0,0,0,5,4,-2,-4,6,-2,0,-1,-1,1,-1,1,5,-1
KR_6731746072,420,0,-21,15,-5,1,6,7,-2,2,0,3,2,5,-6,6,0,-1,1,0,-4,-12,3,-3,-2,5,1,0,-2,-1,0,-1,-1,1,-1
KR_6726324178,420,1,-24,11,-4,-2,2,0,0,3,3,0,1,1,0,2,2,-2,2,0,0,-5,0,0,-1,1,-1,0,0,1,-1,-1,-1,2,-1
KR_6760210182,420,2,-19,-8,3,-8,8,0,3,2,5,1,5,6,6,0,6,1,0,1,0,12,-261,-4,-2,6,-1,0,0,-1,0,-1,-1,1,-1
KR_6655695661,420,-1,-15,4,-7,0,0,0,-1,6,5,-1,1,0,-3,4,1,-2,2,0,0,-7,-111,2,-7,5,-3,0,0,1,1,0,-1,5,-1
KR_6720798229,420,-2,-49,-4,-5,0,3,3,1,5,6,0,1,1,-7,8,1,1,0,1,0,-8,232,4,-7,3,-1,0,-1,1,-1,-1,1,1,-1
KR_6653140539,420,0,-13,12,-3,1,1,2,-4,5,1,1,1,2,1,3,4,-2,3,1,0,-5,-5,-1,-3,4,5,0,0,-1,0,0,-1,6,-1
KR_6752018227,420,-4,-57,-16,-7,2,2,4,-2,3,1,-5,8,3,-2,3,1,0,1,1,0,2,-15,0,-2,2,-2,0,-1,-1,-1,-1,-1,2,-1
KR_6394432493,420,0,45,8,1,1,2,3,0,1,1,4,2,6,-2,4,2,-2,3,1,0,-5,-2,-2,-2,4,1,0,0,1,1,0,-1,6,-1
KR_6763425306,420,-3,-51,-32,-5,-1,1,0,0,3,3,-4,4,0,0,2,2,0,2,2,0,-1,2,1,-7,6,-2,0,0,-1,-1,0,-1,6,-1
KR_6749340910,420,-1,-9,-1,-1,3,0,3,-3,5,2,3,2,5,-3,3,0,-1,2,1,0,-2,-125,1,-3,2,-3,0,0,-1,1,0,-1,1,-1
KR_6762855168,420,-3,13,-7,-10,-6,7,1,-6,7,1,4,0,4,-2,4,2,0,2,2,0,-8,-5,-2,-4,6,1,0,2,1,1,1,-1,1,-1
KR_6751885916,420,-1,71,-24,-2,-2,2,0,-1,3,2,-1,4,3,2,2,4,0,1,1,0,0,-16,0,-4,4,0,0,1,-1,1,1,1,1,-1
KR_6669730330,440,-2,-2,-4,-12,-4,8,4,-1,2,1,-5,7,2,0,3,3,-2,2,0,-1,-18,-8,-5,-1,6,0,0,0,0,-1,0,-1,0,-1
KR_6754581954,420,-1,-12,-28,-3,-5,6,1,2,1,3,0,3,3,-3,4,1,3,1,4,0,-1,-10,-3,0,3,2,0,-1,0,1,-1,1,0,-1
KR_6754340444,420,-1,-4,4,-10,-3,4,1,-3,3,0,-5,5,0,1,2,3,0,1,1,0,-15,-1,-2,-2,4,-1,0,0,1,-1,-1,-1,5,-1
KR_6731443030,420,0,-18,-4,1,1,1,2,4,4,8,-1,3,2,0,3,3,-3,3,0,0,5,-113,-2,-5,7,0,0,0,-1,1,0,-1,5,-1
KR_6762834448,420,0,36,-12,0,-3,4,1,2,0,2,5,1,6,-2,2,0,-2,3,1,0,-4,108,0,-5,5,8,0,0,1,-1,0,1,2,-1
KR_6760912035,420,-5,-31,-12,-19,-8,8,0,-2,2,0,-2,2,0,-4,5,1,-3,3,0,0,-10,0,1,-1,0,3,0,-2,-1,-1,-1,-1,6,-1
KR_6762748128,420,-1,4,-32,-3,-4,4,0,-1,4,3,-1,2,1,4,2,6,-1,1,0,0,0,27,1,-2,1,2,0,1,-1,1,1,1,1,-1
KR_6699635702,420,-7,-53,-30,-11,-4,4,0,-1,2,1,-4,4,0,-1,1,0,-1,1,0,0,-6,-19,5,-8,3,-1,0,-2,-1,1,-1,-1,2,-1
KR_6696406542,420,-5,-70,-39,-12,-1,3,2,-7,7,0,-2,3,1,-1,1,0,-1,3,2,0,-9,-21,0,-6,6,-7,0,-2,-1,1,1,-1,4,-1
KR_6763795455,440,-3,12,21,-12,-4,5,1,0,5,5,-5,7,2,-2,6,4,-1,1,0,0,-8,18,-10,-1,11,-1,0,0,-1,-1,0,-1,6,-1
KR_6763026622,420,-2,-39,24,-8,-2,4,2,2,0,2,-5,8,3,-3,3,0,0,0,0,0,-13,15,3,-4,1,-2,0,0,-1,1,0,1,4,-1
KR_6649203413,420,3,69,3,-2,-3,3,0,-1,6,5,1,0,1,0,2,2,1,0,1,0,1,219,1,-2,1,3,0,1,1,-1,1,-1,6,-1
KR_6638024860,420,-4,-30,-8,-5,-2,4,2,-3,3,0,1,1,2,-2,3,1,1,1,2,0,-4,0,0,-2,2,-1,0,-2,-1,-1,-1,-1,5,-1
KR_6652431608,440,2,-50,8,3,2,1,3,-1,6,5,-4,4,0,4,1,5,2,0,2,0,4,23,-1,-2,3,-3,0,0,1,0,0,-1,3,-1
KR_6759569487,440,-3,-17,-20,-13,-4,4,0,-5,5,0,1,1,2,1,4,5,-6,7,1,1,-14,4,1,-4,3,-2,0,-1,-1,-1,-1,1,1,-1
KR_6742515783,420,0,-30,-28,-1,1,1,2,-3,5,2,-1,2,1,0,1,1,2,1,3,-1,-6,-2,-5,-1,6,4,0,0,1,-1,0,-1,6,-1
KR_6728473122,420,-1,-20,-11,-4,3,0,3,0,1,1,-1,2,1,-5,8,3,-1,1,0,0,-7,4,1,-9,8,-7,0,1,-1,1,1,-1,1,-1
KR_6756868690,420,-2,-50,5,-5,-4,5,1,-3,6,3,-2,3,1,2,0,2,2,0,2,0,1,-14,-6,-1,7,4,0,0,1,1,0,-1,4,-1
KR_6679178630,420,-10,-188,-68,-19,-1,5,4,-1,2,1,-4,4,0,-14,15,1,1,0,1,-2,-25,-9,-2,-3,5,-1,0,-3,-1,-1,-1,-1,1,-1
KR_6741016384,420,-4,-74,20,-12,-2,3,1,2,2,4,-2,2,0,-10,11,1,0,0,0,0,-11,-8,0,-5,5,3,0,0,1,1,-1,-1,5,-1
KR_6654479771,420,-4,-26,37,-8,-1,3,2,-4,6,2,-5,5,0,2,2,4,0,2,2,-1,-5,-8,-1,-3,4,-3,0,-1,0,0,-1,1,0,-1
KR_6663645924,420,1,33,14,-4,0,1,1,-3,6,3,-3,3,0,1,4,5,1,2,3,-1,-5,28,-1,-3,4,-1,0,0,-1,1,0,1,3,-1
KR_6726282233,420,-4,-115,-20,-11,-8,8,0,1,0,1,2,0,2,-4,4,0,-2,2,0,0,-4,-27,-1,-3,4,0,0,0,-1,1,-1,-1,2,-1
KR_6750588829,420,1,10,-15,5,3,0,3,2,4,6,1,2,3,-1,2,1,0,2,2,0,3,-386,0,-4,4,-1,0,1,1,-1,1,-1,6,-1
KR_6713305315,420,-4,-70,-20,-5,2,1,3,-1,3,2,-4,7,3,-2,4,2,0,0,0,0,-1,19,-2,-5,7,2,0,0,-1,1,0,-1,4,-1
KR_6750064394,420,-5,-30,-44,-9,-1,2,1,-7,7,0,-1,1,0,-1,1,0,1,0,1,-1,-4,21,1,-3,2,1,0,0,-1,-1,0,-1,1,-1
KR_6708850314,420,-2,25,27,-5,-2,2,0,2,1,3,0,0,0,-5,7,2,0,0,0,0,-7,101,0,-6,6,1,0,-1,-1,1,-1,-1,4,-1
KR_6670441591,420,-1,-20,-4,-7,4,1,5,-1,4,3,-6,9,3,-4,4,0,0,0,0,0,-9,-7,-6,-1,7,-1,0,-1,-1,0,-1,1,1,-1
KR_6726982199,420,-5,-72,3,-10,-11,12,1,0,1,1,-2,3,1,3,1,4,0,0,0,0,1,-5,-3,-2,5,2,0,-1,1,1,-1,-1,5,-1
KR_6728112844,420,-2,-47,12,-2,2,2,4,-2,2,0,1,4,5,-2,4,2,-1,1,0,3,-1,8,-2,-3,5,1,0,0,1,-1,0,1,1,-1
KR_6743265527,440,0,-13,-8,1,2,1,3,1,1,2,-2,4,2,1,0,1,-1,2,1,0,2,-12,4,-5,1,0,0,-1,1,-1,-1,1,4,-1
KR_6756465391,420,-1,5,4,-7,1,0,1,-2,3,1,-1,4,3,-2,2,0,-3,5,2,0,-13,-7,-3,-3,6,0,0,0,1,1,0,-1,1,-1
KR_6729365774,420,0,75,11,-1,-2,3,1,-3,4,1,2,2,4,2,1,3,0,1,1,0,-1,-2,-1,-3,4,-4,0,1,-1,0,1,1,3,-1
KR_6623260331,420,0,-22,-4,-6,0,1,1,1,2,3,-5,6,1,1,1,2,-3,3,0,0,-2,3,3,-5,2,1,0,-1,1,-1,-1,1,3,-1
KR_6746809033,420,-5,-84,-33,-7,2,0,2,-6,7,1,2,2,4,-2,3,1,-3,4,1,-1,1,-6,-2,-2,4,-1,0,-1,0,-1,-1,-1,0,-1
KR_6764592325,440,-3,-60,-4,-5,-6,6,0,1,2,3,3,2,5,-4,9,5,1,1,2,-1,-2,42,-2,-4,6,-16,0,-1,0,1,-1,-1,0,-1
KR_6685029591,420,-3,-57,-15,-10,-4,4,0,-1,3,2,1,2,3,-5,6,1,-1,1,0,0,-8,-10,-3,-1,4,2,0,1,-1,1,1,-1,2,-1
KR_6716763962,420,1,4,24,1,-1,5,4,0,2,2,4,1,5,-2,2,0,0,0,0,0,2,6,1,-3,2,-1,0,1,0,0,1,-1,0,-1
KR_6737424658,420,-4,-24,-28,-7,1,0,1,0,2,2,-7,8,1,0,1,1,-1,3,2,0,-2,37,-1,-4,5,-22,0,-1,-1,-1,-1,-1,5,-1
KR_6742291773,420,2,-4,20,4,5,0,5,2,3,5,-1,3,2,-2,4,2,0,2,2,1,4,1,-2,-2,4,-3,0,1,-1,0,-1,1,4,-1
KR_6625457965,420,-3,69,-20,-1,-1,1,0,-4,7,3,4,1,5,0,1,1,0,1,1,0,-4,-40,-1,-4,5,22,0,0,1,-1,-1,-1,3,-1
KR_6725932913,420,-2,11,8,-8,-3,4,1,-3,3,0,-4,4,0,1,3,4,1,0,1,0,-2,12,1,-5,4,-7,0,-1,1,-1,-1,-1,3,-1
KR_6752536020,420,-4,-3,-3,-10,-5,5,0,-1,5,4,-3,5,2,0,2,2,-1,2,1,0,-6,-18,-2,-3,5,2,0,-1,1,-1,-1,-1,6,-1
KR_6721402316,440,0,-5,28,-3,-6,6,0,3,1,4,0,0,0,1,2,3,-1,2,1,0,6,0,0,-3,3,4,0,0,1,-1,-1,-1,2,-1
KR_6719608043,420,1,-16,-24,5,0,0,0,-1,4,3,-2,4,2,4,1,5,4,0,4,0,3,20,4,-8,4,3,0,0,-1,1,0,1,6,-1
KR_6728789548,440,1,35,8,2,2,1,3,-1,5,4,-1,1,0,1,1,2,1,1,2,0,1,15,2,-2,0,-5,0,0,0,1,0,1,0,-1
KR_6191972573,420,-4,-45,-7,-16,-1,2,1,-7,8,1,4,0,4,-9,9,0,-3,3,0,-1,-18,-25,-3,-8,11,-2,0,-2,1,0,-1,-1,1,-1
KR_6749718612,420,-3,-104,-12,-4,-1,2,1,1,2,3,-2,3,1,-2,2,0,0,3,3,0,2,16,1,-3,2,1,0,-1,-1,0,-1,1,4,-1
KR_6753882197,420,-1,-49,-16,-6,-1,4,3,1,2,3,-3,5,2,-4,4,0,1,0,1,-2,-12,-7,3,-4,1,-3,0,0,0,0,0,-1,0,-1
KR_6714589154,420,-1,32,13,-6,-1,4,3,-1,2,1,-1,2,1,-2,2,0,-1,1,0,0,-11,-192,2,-3,1,-3,0,0,1,-1,1,1,3,-1
KR_6694868141,420,2,9,-12,5,0,3,3,-1,3,2,2,0,2,1,2,3,3,1,4,-1,7,0,1,-4,3,-2,0,-1,1,1,-1,-1,1,-1
KR_6746149139,420,-5,-1,0,-7,0,0,0,-4,4,0,-9,9,0,5,2,7,1,0,1,0,-6,-5,1,-4,3,3,0,0,1,-1,0,-1,3,-1
KR_6731425647,420,-3,-10,-33,-3,-1,4,3,1,2,3,0,3,3,-2,4,2,-1,2,1,0,-4,3,0,-4,4,-1,0,-1,-1,-1,-1,1,6,-1
KR_6657204235,420,1,-49,44,1,-1,1,0,0,2,2,0,1,1,5,1,6,-3,5,2,-1,1,-22,0,-2,2,0,0,0,-1,-1,0,-1,5,-1
KR_6745665427,440,2,44,10,2,1,3,4,2,1,3,0,5,5,3,0,3,-4,5,1,0,-3,-3,3,-6,3,-1,0,0,0,-1,0,1,0,-1
KR_6614493131,420,-5,-60,-4,-18,-9,9,0,-1,4,3,-1,4,3,-4,5,1,-3,4,1,-3,-18,432,0,-4,4,3,0,-1,1,1,-1,-1,6,-1
KR_6760447271,420,3,-26,15,-1,6,2,8,-3,6,3,0,4,4,-6,8,2,2,0,2,-1,0,-5,0,-4,4,2,0,-2,0,-1,-1,-1,0,-1
KR_6724056824,420,1,24,4,-2,4,0,4,-2,4,2,-3,3,0,-1,2,1,0,0,0,0,-8,-4,-3,-4,7,-1,0,3,-1,1,1,1,3,-1
KR_6611211877,420,-1,-20,-20,-4,2,2,4,4,1,5,-6,6,0,-4,4,0,0,0,0,1,2,-2,-1,-5,6,2,0,0,-1,1,1,1,3,-1
KR_6764165991,420,-8,-100,-64,-9,1,1,2,-4,4,0,-4,5,1,-3,5,2,1,1,2,0,-12,-15,1,-3,2,-3,0,-1,-1,-1,-1,-1,2,-1
KR_6751945845,420,0,30,-24,-1,1,1,2,-2,2,0,1,1,2,0,5,5,-1,2,1,0,-9,-127,0,-4,4,-2,0,1,-1,0,1,-1,3,-1
KR_6594897157,420,-3,-37,-22,-1,-3,3,0,0,3,3,1,1,2,0,4,4,1,0,1,0,5,4,1,-7,6,-2,0,0,1,-1,-1,1,4,-1
KR_6764692213,440,1,35,4,3,-6,10,4,4,2,6,-2,2,0,7,1,8,0,1,1,-1,-2,347,-3,0,3,-1,0,-1,-1,1,-1,-1,5,-1
KR_6726563841,420,-1,-42,20,-2,2,1,3,-3,6,3,-4,5,1,2,2,4,1,1,2,0,-2,2,2,-8,6,-1,0,-1,0,0,1,-1,0,-1
KR_6685221289,420,-4,-33,-8,-12,-6,6,0,1,1,2,-3,9,6,-3,5,2,-1,1,0,0,-11,16,-3,-2,5,3,0,-2,1,-1,-1,-1,1,-1
KR_6754029421,420,-4,-126,-14,-9,1,1,2,-1,5,4,-3,3,0,-3,4,1,-3,3,0,0,-9,-123,3,-4,1,1,0,-2,-1,-1,-1,-1,2,-1
KR_6735599529,420,3,73,36,3,-2,4,2,3,0,3,3,4,7,-2,4,2,1,0,1,0,2,24,2,-5,3,-5,0,0,1,1,0,1,4,-1
KR_6733723737,440,-4,-13,-16,-13,-3,3,0,3,0,3,-9,11,2,-4,5,1,0,1,1,0,-17,4,-5,-3,8,-1,0,-2,-1,-1,-1,-1,1,-1
KR_6739622905,420,-6,-124,-8,-8,-3,3,0,-1,4,3,0,0,0,-2,3,1,-2,3,1,0,-6,4,1,-6,5,0,0,-1,-1,0,-1,1,6,-1
KR_6707433119,420,0,-29,-4,-6,0,1,1,1,7,8,-3,5,2,-4,7,3,0,1,1,-3,-8,218,-1,-5,6,2,0,0,-1,-1,-1,-1,4,-1
KR_6638487071,420,2,90,-8,3,3,2,5,-3,3,0,5,1,6,-3,3,0,1,0,1,1,4,-15,-5,0,5,3,0,1,1,-1,1,1,5,-1
KR_6762669168,420,-1,-58,-27,-5,0,4,4,-5,7,2,1,2,3,-2,3,1,1,0,1,0,1,-3,1,-4,3,4,0,0,-1,-1,-1,-1,5,-1
KR_6739752416,440,-2,33,-12,0,4,1,5,-4,6,2,-1,1,0,-1,2,1,2,0,2,0,-3,-5,0,-3,3,-1,0,0,-1,0,0,-1,1,-1
KR_6716376236,440,2,34,-18,4,-1,2,1,1,1,2,1,4,5,3,1,4,0,1,1,-1,7,5,2,-6,4,-8,0,-1,-1,-1,-1,-1,6,-1
KR_6635850024,420,1,-24,-27,9,-7,7,0,0,2,2,7,1,8,6,0,6,3,0,3,0,0,5,1,-4,3,5,0,2,1,-1,1,1,2,-1
KR_6715637646,420,-1,21,-1,-5,2,2,4,4,3,7,-5,6,1,-2,3,1,-4,4,0,-1,-4,6,-6,-3,9,-7,0,1,1,0,1,-1,3,-1
KR_6706124714,420,0,5,-51,5,0,1,1,3,4,7,0,1,1,2,9,11,0,0,0,1,12,-3,3,-7,4,-3,0,1,-1,-1,-1,1,1,-1
KR_6751807407,420,-5,-47,-6,-7,-1,2,1,2,0,2,-6,7,1,-2,3,1,0,1,1,0,-6,3,3,-6,3,-1,0,-1,-1,1,-1,-1,1,-1
KR_6616057731,420,-5,-19,-6,-9,-3,3,0,-1,2,1,-1,3,2,-1,5,4,-3,4,1,-1,-11,-12,0,-1,1,0,0,-1,-1,-1,-1,-1,2,-1
KR_6754913971,420,-1,10,-8,-14,-1,2,1,-7,8,1,2,1,3,-6,7,1,-2,2,0,0,-23,12,4,-7,3,-3,0,0,-1,-1,-1,-1,4,-1
KR_6679259604,420,-3,6,-32,3,1,0,1,-3,5,2,1,0,1,2,2,4,2,1,3,0,5,0,-1,-1,2,2,0,-1,-1,-1,-1,1,4,-1
KR_6761892108,420,5,23,25,15,5,0,5,3,2,5,4,1,5,2,4,6,1,1,2,0,7,10,4,-7,3,-5,0,1,-1,1,1,1,1,-1
KR_6725232952,420,-1,-38,13,-2,-1,1,0,-3,6,3,-1,2,1,0,3,3,3,0,3,0,-4,13,-2,-3,5,-1,0,-1,0,0,-1,1,0,-1
KR_6670382382,420,-4,-18,-26,-11,-1,2,1,-5,8,3,-3,3,0,-1,3,2,-1,5,4,0,-14,-206,-5,-1,6,3,0,0,-1,1,1,-1,5,-1
KR_6717119136,420,0,-22,24,-4,-1,3,2,-2,4,2,1,3,4,-1,1,0,-1,1,0,-1,-9,-184,0,-2,2,-4,0,-1,0,-1,-1,-1,0,-1
KR_6761089872,420,-1,-62,-36,-2,0,2,2,2,3,5,-1,3,2,-3,3,0,0,2,2,0,2,41,1,-5,4,-29,0,0,-1,0,0,1,4,-1
KR_6505565668,420,3,57,33,7,2,0,2,0,0,0,3,2,5,2,2,4,0,0,0,0,7,-8,-6,-1,7,5,0,2,-1,1,1,1,4,-1
KR_6759951460,420,0,-29,-27,-4,-1,1,0,-4,4,0,1,2,3,1,2,3,-1,2,1,-1,-5,0,2,-3,1,1,0,1,-1,1,1,-1,2,-1
KR_6760806553,420,0,70,-31,-1,1,1,2,-8,8,0,-1,4,3,3,4,7,4,0,4,0,2,9,2,-3,1,-1,0,1,-1,1,1,-1,4,-1
KR_6717373901,420,-2,-101,-14,-5,-2,2,0,-4,6,2,6,0,6,-4,6,2,-1,2,1,0,5,-6,-3,-3,6,-1,0,-3,-1,-1,-1,-1,3,-1
KR_6641206539,420,-2,-8,-49,-1,0,2,2,-3,8,5,3,2,5,-6,8,2,5,1,6,-2,3,7,2,-4,2,0,0,-1,0,-1,-1,-1,0,-1
KR_6732275422,420,1,6,-12,1,3,0,3,2,0,2,1,2,3,-5,5,0,0,2,2,0,-4,3,3,-5,2,-3,0,-1,-1,1,-1,-1,4,-1
KR_6763105974,440,0,17,-5,-2,-1,1,0,1,3,4,-1,5,4,0,2,2,-1,3,2,0,0,379,-1,-4,5,-6,0,0,-1,0,0,-1,5,-1
KR_6627353584,420,-1,-104,-28,3,-2,2,0,3,1,4,5,1,6,-3,4,1,0,1,1,1,5,-1,0,-3,3,-1,0,0,1,1,-1,1,4,-1
KR_6720934948,420,1,0,12,5,-4,4,0,9,1,10,-2,3,1,1,2,3,1,1,2,0,14,-22,3,-6,3,-6,0,-2,0,-1,-1,-1,0,-1
KR_6628993500,420,0,75,-3,1,2,2,4,3,4,7,-3,6,3,2,1,3,-3,4,1,1,2,43,3,-5,2,-25,0,0,-1,0,0,1,3,-1
KR_6606110215,420,0,-50,-4,1,0,0,0,-5,8,3,4,2,6,1,1,2,1,0,1,0,3,11,-2,-4,6,-2,0,1,-1,1,1,1,6,-1
KR_6625081350,420,-1,-2,5,1,2,1,3,2,0,2,-2,5,3,-1,3,2,0,0,0,0,-3,-2,-1,-2,3,-1,0,0,-1,-1,1,1,2,-1
KR_6762088111,420,0,60,-4,-1,-1,3,2,0,0,0,1,0,1,0,4,4,-1,3,2,0,-7,-13,-1,-2,3,0,0,1,1,1,1,1,5,-1
KR_6703514778,420,4,107,0,7,0,1,1,2,3,5,1,3,4,4,2,6,0,4,4,0,9,17,-3,-2,5,-1,0,0,1,-1,1,-1,5,-1
KR_6761043356,420,-3,-55,8,-1,4,1,5,-4,6,2,-1,3,2,0,2,2,0,0,0,0,-4,23,1,-6,5,-3,0,-2,-1,0,-1,1,4,-1
KR_6762502059,420,1,-33,17,5,0,0,0,0,1,1,3,4,7,-1,2,1,3,0,3,1,4,-5,-1,-3,4,3,0,1,0,0,-1,1,0,-1
KR_6657864793,420,0,69,8,-7,-1,1,0,-2,4,2,-2,2,0,-3,3,0,1,0,1,0,-11,-4,-4,-3,7,4,0,1,1,-1,1,-1,5,-1
KR_6749847490,420,-5,-24,-15,-17,-3,5,2,1,0,1,-8,9,1,-6,7,1,-1,3,2,0,-11,-26,-2,-4,6,3,0,-2,-1,-1,-1,-1,5,-1
KR_6751848425,420,-3,-97,2,-3,-4,4,0,3,2,5,-2,3,1,-1,3,2,1,3,4,-1,6,8,3,-5,2,-1,0,-1,1,-1,-1,-1,6,-1
KR_6699958914,420,-7,-124,-43,-20,-2,2,0,-4,4,0,-8,11,3,-6,6,0,0,1,1,0,-16,-13,-2,0,2,2,0,-3,1,-1,-1,-1,6,-1
KR_6627337205,420,-1,-53,12,-3,3,0,3,-1,2,1,-1,2,1,-3,5,2,-1,2,1,0,-5,150,2,-5,3,-2,0,1,-1,1,1,-1,3,-1
KR_6729161900,420,-8,-79,-25,-12,-1,2,1,-1,2,1,-6,7,1,-4,4,0,0,2,2,0,-15,-119,0,-4,4,1,0,-1,-1,-1,-1,1,2,-1
KR_6746263190,420,-4,-93,-19,-8,1,1,2,-3,3,0,-6,6,0,1,1,2,-1,1,0,0,-4,-7,-1,-3,4,0,0,-1,-1,1,-1,-1,4,-1
KR_6675425445,420,-4,-56,2,-7,-3,4,1,2,3,5,-1,1,0,-3,3,0,-2,2,0,0,-5,-10,-5,-2,7,5,0,-1,-1,1,-1,-1,4,-1
KR_6756029724,420,-4,-23,-38,-8,-2,4,2,-1,3,2,-7,8,1,1,2,3,1,0,1,0,-1,-3,1,-6,5,-1,0,1,1,1,1,1,3,-1
KR_6761394995,440,-5,-66,8,-13,-2,2,0,-3,5,2,-1,1,0,-4,8,4,-3,3,0,0,-19,-11,-8,0,8,-7,0,0,1,1,-1,-1,2,-1
KR_5856614806,420,1,1,0,11,0,4,4,0,7,7,5,1,6,6,1,7,0,2,2,0,22,-39,2,-4,2,20,0,-1,-1,0,-1,1,2,-1
KR_6750301287,420,-5,-132,10,-13,0,1,1,2,1,3,-1,2,1,-10,10,0,-4,4,0,0,-13,1,2,-3,1,-1,0,-3,-1,-1,-1,-1,4,-1
KR_6633441960,420,-1,27,-36,-5,4,0,4,-3,5,2,-3,4,1,-4,8,4,1,0,1,1,-11,-22,-4,-3,7,-2,0,0,-1,0,-1,1,1,-1
KR_6717031153,420,0,-32,-19,1,2,2,4,-6,6,0,1,1,2,2,2,4,2,0,2,-1,2,4,-1,-4,5,2,0,0,1,0,0,-1,3,-1
KR_6751271235,420,-1,28,8,-8,3,1,4,-5,6,1,-2,4,2,-2,2,0,-2,2,0,0,-14,-16,2,-5,3,-1,0,2,-1,1,1,1,3,-1
KR_6733887557,420,-5,-71,-12,-7,-3,4,1,-3,5,2,-3,5,2,0,3,3,2,1,3,1,4,-10,-3,0,3,0,0,-3,-1,-1,-1,1,4,-1
KR_6711517401,420,-4,-26,-40,-5,2,0,2,-2,2,0,-1,6,5,-3,4,1,-1,1,0,0,0,-1,1,-4,3,-1,0,-1,-1,0,-1,1,5,-1
KR_6411467538,420,-1,-29,8,-5,0,1,1,-2,2,0,-1,2,1,0,1,1,-2,3,1,-1,-10,-7,-3,-3,6,8,0,0,-1,-1,-1,-1,3,-1
KR_6415462252,420,-2,22,-26,-2,0,1,1,-4,6,2,2,1,3,0,2,2,0,0,0,0,-2,0,1,-6,5,-8,0,0,-1,1,0,1,2,-1
KR_6749214629,420,3,50,8,3,-4,5,1,-3,4,1,5,0,5,2,1,3,3,1,4,0,3,-2,-1,-5,6,6,0,-1,1,-1,-1,1,2,-1
KR_6761707069,440,0,-108,-17,-2,0,2,2,-3,3,0,-1,3,2,1,3,4,1,0,1,0,5,0,-3,-1,4,1,0,0,-1,-1,0,-1,4,-1
KR_6652730702,420,-5,46,0,-11,-2,2,0,-1,2,1,-3,5,2,-6,8,2,1,1,2,0,-10,90,-1,-5,6,3,0,0,1,1,1,-1,5,-1
KR_6756603634,420,-4,0,-8,-10,0,1,1,-2,4,2,-4,7,3,-1,2,1,-3,3,0,1,-9,-9,-2,-2,4,4,0,0,-1,-1,1,1,4,-1
KR_6759253048,440,-2,-29,4,-3,1,4,5,2,2,4,-2,4,2,-5,6,1,1,1,2,0,5,5,-3,-2,5,0,0,0,1,0,0,1,4,-1
KR_6756637041,420,1,-31,32,0,-5,5,0,5,1,6,-1,4,3,-3,5,2,4,0,4,-1,6,18,-2,-3,5,0,0,1,1,1,1,-1,5,-1
KR_6682446982,420,-2,-86,-1,-4,-3,4,1,0,0,0,-1,2,1,1,2,3,-1,1,0,0,-2,3,-6,-2,8,-3,0,-1,-1,1,-1,-1,1,-1
KR_6763932325,420,4,51,4,12,2,1,3,6,1,7,-2,3,1,5,4,9,1,2,3,0,10,4,5,-5,0,0,0,3,1,1,1,-1,2,-1
KR_6718779498,420,-4,-99,-9,-8,-5,5,0,-5,6,1,1,3,4,1,2,3,0,1,1,0,-8,-49,-1,-2,3,1,0,-1,-1,0,-1,-1,4,-1
KR_6751519131,420,-2,-67,-19,6,1,1,2,1,3,4,-1,1,0,3,3,6,2,1,3,-1,6,13,6,-9,3,1,0,-2,1,-1,-1,-1,5,-1
KR_6386230586,420,0,-5,9,-1,-1,2,1,0,1,1,-3,3,0,4,1,5,-1,2,1,0,-2,18,-1,-6,7,1,0,0,-1,-1,0,-1,3,-1
KR_6755257227,420,1,17,8,1,-1,1,0,2,2,4,-2,2,0,3,1,4,-1,3,2,1,6,160,3,-6,3,0,0,1,1,-1,1,1,4,-1
KR_6733034701,420,-2,-34,1,-3,-1,5,4,-1,4,3,0,2,2,-1,6,5,0,1,1,-1,-4,430,-3,-2,5,-2,0,-2,1,-1,-1,1,5,-1
KR_6700279137,420,-2,-21,-6,-5,0,0,0,0,3,3,-2,3,1,-3,5,2,0,3,3,0,-3,-17,1,-4,3,3,0,0,0,1,0,-1,0,-1
KR_6674205217,420,0,-74,16,3,3,1,4,-1,3,2,4,2,6,0,3,3,-3,5,2,0,2,-31,8,-8,0,16,0,0,0,1,0,1,0,-1
KR_6730795799,420,3,11,1,14,1,1,2,2,3,5,4,1,5,6,1,7,1,0,1,0,21,0,2,-6,4,5,0,0,1,-1,1,1,1,-1
KR_6516196358,420,-2,-3,-19,-9,-3,3,0,-3,4,1,3,1,4,-5,6,1,-1,1,0,0,-4,39,-5,-4,9,-24,0,0,0,-1,0,-1,0,-1
KR_6748332269,420,-2,-10,46,-10,-8,8,0,-1,1,0,4,1,5,-4,5,1,-1,1,0,0,-3,26,-3,-3,6,-2,0,-1,0,0,-1,-1,0,-1
KR_6707348580,420,-5,-82,-59,-8,-8,9,1,0,4,4,2,0,2,0,2,2,-2,3,1,0,6,-2,1,-4,3,0,0,-2,-1,-1,-1,-1,2,-1
KR_6756579178,420,-1,26,28,-2,-5,7,2,-1,2,1,2,0,2,1,0,1,1,0,1,0,-1,55,3,-6,3,-17,0,-1,1,-1,-1,-1,2,-1
KR_6644790385,420,0,47,-12,-3,-7,7,0,-1,2,1,-2,2,0,6,1,7,1,0,1,0,0,4,-5,-7,12,-3,0,1,1,-1,1,1,2,-1
KR_6761499553,420,-1,31,-12,-7,-4,7,3,0,1,1,-4,4,0,1,3,4,0,1,1,-1,-4,0,-3,-1,4,-1,0,0,0,0,0,-1,0,-1
KR_6731617008,420,2,-43,-3,1,-2,3,1,-3,3,0,4,2,6,1,1,2,1,1,2,0,3,-127,0,-3,3,4,0,-1,1,-1,-1,-1,6,-1
KR_6684083607,440,-3,3,-11,-3,1,2,3,-5,8,3,1,2,3,0,4,4,0,2,2,0,2,-2,-3,-5,8,-2,0,0,-1,0,-1,-1,3,-1
KR_6737593808,420,-4,12,-16,-12,-5,6,1,-3,3,0,3,0,3,-3,5,2,-4,4,0,0,-11,-1,-2,-2,4,0,0,0,-1,0,0,1,4,-1
KR_6763847352,420,-3,-63,-16,-2,-3,7,4,0,0,0,2,3,5,-1,2,1,0,1,1,0,3,3,-2,-5,7,1,0,-1,-1,-1,-1,1,3,-1
KR_6738943556,440,-4,-75,-36,-10,0,2,2,-6,7,1,-1,4,3,-2,5,3,-1,1,0,0,-5,11,-1,-3,4,-4,0,-1,-1,1,-1,-1,3,-1
KR_6758187957,420,3,19,8,4,1,1,2,3,3,6,-1,1,0,0,3,3,1,0,1,0,-2,-53,3,-5,2,29,0,-1,-1,-1,-1,-1,2,-1
KR_6707049225,420,4,79,-13,11,0,2,2,4,2,6,1,1,2,3,1,4,3,0,3,0,13,-11,2,-3,1,-2,0,0,0,-1,1,1,0,-1
KR_6638582023,440,0,43,-8,0,0,1,1,0,1,1,-2,4,2,-1,3,2,3,0,3,0,-1,-40,-1,-3,4,5,0,0,1,-1,0,-1,5,-1
KR_6652431962,420,-3,-48,11,-12,2,1,3,-3,5,2,-5,7,2,-6,8,2,0,2,2,0,-13,-9,-1,-3,4,2,0,-2,-1,1,-1,1,2,-1
KR_6743047627,440,-4,9,-8,-7,0,2,2,-4,5,1,-1,3,2,-1,1,0,-1,2,1,0,-7,4,0,-4,4,-6,0,0,-1,-1,-1,1,2,-1
KR_6612002921,420,-3,2,-18,-13,-2,2,0,-4,5,1,-2,4,2,-3,3,0,-2,2,0,0,-12,-7,3,-5,2,0,0,-2,-1,-1,-1,-1,2,-1
KR_6755137524,420,-1,-38,10,-6,-6,7,1,-2,5,3,1,2,3,2,3,5,-1,2,1,1,-7,10,1,-5,4,-2,0,-1,1,-1,-1,1,5,-1
KR_6741793395,420,-1,15,-4,-7,1,1,2,2,1,3,-3,4,1,-5,6,1,-2,2,0,0,-16,1,0,-6,6,-1,0,0,0,-1,1,1,0,-1
KR_6760786369,420,-4,11,-23,-10,-2,2,0,-2,3,1,-6,6,0,1,1,2,-1,3,2,-1,-6,2,-3,-4,7,-1,0,0,1,-1,0,-1,1,-1
KR_6695208764,440,-4,-114,-4,-5,-2,4,2,-1,4,3,0,2,2,-2,2,0,0,0,0,-1,-6,-283,1,-3,2,2,0,0,-1,1,0,-1,1,-1
KR_6762990507,420,0,27,8,2,-2,2,0,9,2,11,4,2,6,-3,3,0,-6,6,0,0,8,23,4,-7,3,1,0,-1,1,-1,-1,-1,3,-1
KR_6696946535,420,-2,-60,7,5,2,0,2,4,1,5,0,5,5,2,5,7,-3,3,0,0,7,11,6,-7,1,-5,0,0,-1,1,1,1,1,-1
KR_6653951697,420,-5,-77,0,-17,0,5,5,-4,6,2,-6,6,0,-6,7,1,-1,1,0,0,-20,-29,-3,-4,7,-6,0,-2,1,1,-1,-1,5,-1
KR_6724970952,420,2,72,19,-4,-4,4,0,0,3,3,-2,3,1,3,0,3,-1,1,0,0,3,-6,-2,-3,5,2,0,-1,1,-1,-1,-1,3,-1
KR_6694932831,420,-1,-15,-7,-1,0,5,5,-4,4,0,-3,6,3,5,4,9,1,0,1,-2,-6,5,3,-7,4,-2,0,1,-1,0,1,-1,1,-1
KR_6739587646,440,1,-9,-15,-5,2,1,3,-4,6,2,-1,2,1,-4,4,0,2,3,5,0,-2,10,-5,-1,6,0,0,-1,0,-1,1,-1,0,-1
KR_6752792109,420,-2,-66,12,-5,-3,4,1,0,1,1,2,1,3,-2,4,2,-2,4,2,0,-7,12,-3,-3,6,0,0,-1,-1,1,-1,1,6,-1
KR_6759777309,420,1,59,9,1,-5,7,2,-2,4,2,3,3,6,1,1,2,4,0,4,0,3,5,2,-3,1,2,0,2,1,1,1,1,1,-1
KR_6745673181,420,3,-8,8,5,1,1,2,0,4,4,-1,3,2,3,1,4,2,0,2,1,10,24,1,-5,4,3,0,0,1,-1,1,1,2,-1
KR_6761752348,420,-4,-21,-48,-6,1,1,2,0,2,2,0,1,1,-7,8,1,0,0,0,0,-1,7,3,-4,1,-1,0,0,-1,1,0,-1,4,-1
KR_6763433914,440,-2,-45,-10,3,-1,3,2,4,1,5,1,3,4,-2,4,2,1,1,2,-1,6,-1,-2,-3,5,5,0,-2,-1,0,-1,-1,2,-1
KR_6675465059,420,-3,-14,-6,-2,2,1,3,-2,3,1,1,1,2,-5,6,1,2,0,2,0,-3,5,1,-6,5,0,0,0,-1,1,1,-1,4,-1
KR_6681632648,440,1,22,-4,4,-2,5,3,0,2,2,3,0,3,3,0,3,0,1,1,0,6,5,-1,-5,6,5,0,0,1,-1,-1,1,5,-1
KR_6764654454,420,-1,17,4,-6,0,0,0,-1,2,1,1,1,2,-3,4,1,-3,3,0,-1,-10,38,4,-7,3,-5,0,0,1,-1,0,-1,6,-1
KR_6611834744,420,0,-2,-24,-1,3,0,3,1,0,1,-4,6,2,-2,2,0,1,1,2,0,-1,-5,-3,-3,6,3,0,0,1,-1,-1,-1,6,-1
KR_6520906255,420,-2,-31,32,-5,-2,3,1,-2,3,1,-3,4,1,2,1,3,0,1,1,0,-9,208,-7,-2,9,-5,0,-1,-1,1,-1,-1,5,-1
KR_6594965791,440,-1,-15,11,5,-1,6,5,4,0,4,-1,2,1,2,1,3,1,3,4,1,2,-1,0,-4,4,0,0,0,1,1,1,1,2,-1
KR_6742199238,420,-2,4,0,-10,0,1,1,0,2,2,-12,13,1,0,5,5,2,1,3,0,-5,-1,4,-7,3,1,0,1,-1,1,-1,-1,6,-1
KR_6551008376,420,-5,-24,-36,-14,-2,3,1,-2,4,2,-2,4,2,-2,5,3,-6,7,1,-2,-15,-241,2,-5,3,0,0,-1,-1,0,-1,-1,6,-1
KR_6630646370,420,-5,-67,-1,-13,-3,4,1,-1,1,0,-1,2,1,-5,6,1,-3,3,0,0,-8,-3,-1,-4,5,0,0,-1,-1,-1,-1,1,6,-1
KR_6695806662,420,-1,8,4,-6,-3,4,1,-8,8,0,3,2,5,1,0,1,1,1,2,0,-3,-23,0,-3,3,2,0,-1,1,1,-1,1,1,-1
KR_6711403737,420,2,66,-28,8,1,1,2,0,3,3,5,1,6,2,0,2,0,0,0,0,6,12,3,-4,1,2,0,1,-1,1,1,-1,3,-1
KR_6745621623,420,-2,-52,-17,-5,-5,7,2,-2,3,1,4,3,7,-1,4,3,-1,3,2,-3,-4,-2,1,-5,4,6,0,-2,-1,-1,-1,1,2,-1
KR_6725711318,420,0,7,-24,3,-3,6,3,-2,4,2,3,0,3,5,2,7,0,0,0,1,9,4,-2,-5,7,-2,0,1,1,-1,-1,1,6,-1
KR_6645404813,420,-3,-57,16,-15,-4,5,1,-3,5,2,-4,5,1,-5,7,2,1,0,1,0,-13,-120,-2,-1,3,0,0,-1,-1,-1,-1,1,6,-1
KR_6703201333,420,-2,-32,20,-6,-3,4,1,-2,3,1,-3,6,3,0,3,3,2,0,2,0,-3,290,-1,-3,4,4,0,0,1,1,0,-1,1,-1
KR_6632057847,420,-2,-28,9,-7,-1,4,3,-2,5,3,-1,2,1,-4,5,1,1,2,3,0,-5,-41,-3,-2,5,11,0,-1,-1,1,-1,-1,3,-1
KR_6658468103,420,-1,-8,0,-3,-4,6,2,-3,4,1,7,0,7,0,1,1,-3,4,1,0,-8,-1,-4,-2,6,-1,0,0,-1,-1,-1,-1,3,-1
KR_6651978056,420,-1,1,-4,-7,2,1,3,2,2,4,-4,7,3,-5,6,1,-2,2,0,1,-10,7,6,-7,1,-5,0,0,-1,0,-1,1,3,-1
KR_6640846630,420,0,79,-21,-10,1,0,1,-2,4,2,-3,6,3,-3,5,2,-3,3,0,0,-20,22,2,-4,2,0,0,-1,-1,-1,-1,1,3,-1
KR_6704995594,420,-2,-76,27,-3,-2,3,1,0,2,2,0,2,2,-1,1,0,0,0,0,0,0,-12,0,-4,4,-2,0,-1,-1,1,-1,1,1,-1
KR_6749118206,420,-1,-88,16,-3,-4,4,0,0,1,1,1,0,1,-2,2,0,2,0,2,-1,-3,3,-2,-2,4,1,0,-1,1,0,-1,-1,2,-1
KR_6743248179,420,1,-10,33,-5,2,1,3,-4,6,2,-2,4,2,0,2,2,-1,2,1,0,-13,-296,1,-5,4,-3,0,1,-1,1,1,1,4,-1
KR_6764493329,420,-5,-101,8,-13,-4,4,0,-1,4,3,-3,4,1,-6,6,0,1,2,3,0,-12,-10,-4,-2,6,1,0,-3,-1,-1,-1,-1,6,-1
KR_6660371656,420,5,35,38,8,-1,2,1,4,1,5,-1,3,2,4,2,6,2,0,2,0,4,4,2,-5,3,0,0,0,1,-1,1,-1,5,-1
KR_6746095732,420,2,-20,25,-2,3,1,4,6,2,8,-4,4,0,-7,7,0,0,1,1,0,-7,18,-1,-7,8,-3,0,0,1,0,0,-1,4,-1
KR_6750695160,420,1,-26,-20,-2,0,1,1,-2,2,0,1,1,2,0,2,2,-1,2,1,0,-6,7,1,-5,4,-5,0,-1,-1,-1,-1,-1,6,-1
KR_6631368936,420,3,44,-13,5,-1,2,1,1,2,3,4,2,6,-2,3,1,3,1,4,0,2,3,-4,-5,9,2,0,-1,-1,-1,-1,1,3,-1
KR_6738342263,420,-4,-56,4,-5,-1,1,0,4,0,4,-3,4,1,-2,2,0,-3,3,0,0,3,-129,-1,-7,8,-3,0,-1,1,-1,-1,-1,5,-1
KR_6762874390,420,-3,10,16,-9,1,2,3,-2,3,1,-2,3,1,-3,3,0,-3,3,0,0,-3,-195,0,-2,2,2,0,-1,1,-1,-1,1,3,-1
KR_6749938868,420,1,64,-20,0,-4,7,3,-2,4,2,0,3,3,3,2,5,3,2,5,-1,-1,0,-1,-4,5,-4,0,-1,-1,0,-1,-1,6,-1
KR_6744869596,420,-4,-57,-15,-3,-1,3,2,6,3,9,-7,7,0,-2,2,0,1,2,3,0,8,-2,-1,-8,9,3,0,-1,0,1,-1,1,0,-1
KR_6631308526,420,-6,-47,-14,-3,-1,2,1,-5,7,2,-1,3,2,5,1,6,-1,1,0,-2,2,-261,4,-6,2,-9,0,-2,-1,0,-1,-1,4,-1
KR_6759769147,440,0,34,-8,-2,-2,2,0,3,3,6,2,0,2,-2,4,2,-3,3,0,0,0,28,4,-6,2,-21,0,1,0,1,1,-1,0,-1
KR_6749468962,420,0,-28,-32,-1,-2,4,2,-3,3,0,3,2,5,1,1,2,0,0,0,-1,-3,13,3,-7,4,-4,0,-1,0,0,-1,-1,0,-1
KR_6600487467,420,-2,-51,12,-3,6,0,6,5,1,6,-15,16,1,0,3,3,1,1,2,0,7,-124,0,-3,3,-1,0,0,-1,1,1,1,5,-1
KR_6753363862,420,-3,-65,8,-6,2,5,7,-2,4,2,4,1,5,-5,5,0,-5,6,1,0,-4,124,-2,-3,5,-1,0,-2,-1,0,-1,1,2,-1
KR_6673802773,420,-3,-30,14,-6,1,1,2,-1,3,2,1,2,3,-5,6,1,-2,2,0,0,-7,-6,1,-6,5,1,0,0,1,-1,-1,-1,3,-1
KR_6709239951,420,-3,-35,-31,-2,-3,3,0,4,3,7,-1,3,2,-1,3,2,-1,1,0,2,3,-28,-3,-2,5,0,0,0,-1,-1,0,1,2,-1
KR_6760868352,440,-1,-19,-3,-5,0,1,1,-4,5,1,-4,6,2,3,0,3,0,1,1,0,0,-7,-6,-5,11,-3,0,-2,-1,-1,-1,-1,4,-1
KR_6687940682,420,-2,-8,-20,0,1,3,4,-2,7,5,0,3,3,0,4,4,1,2,3,0,3,297,0,-3,3,0,0,-2,-1,1,-1,-1,2,-1
KR_6714094919,420,-2,-39,-8,-5,1,2,3,1,3,4,0,1,1,-5,5,0,-2,2,0,0,-9,-8,0,-5,5,6,0,-1,-1,1,-1,-1,6,-1
KR_6730713833,440,-2,-43,-4,3,-3,3,0,3,1,4,0,3,3,1,2,3,2,2,4,-1,3,196,-4,-1,5,-2,0,-2,1,1,-1,-1,4,-1
KR_6709882543,420,-3,-9,8,-1,-5,6,1,-1,4,3,7,0,7,-2,2,0,0,0,0,0,-6,-8,-6,-1,7,1,0,1,0,1,-1,1,0,-1
KR_6762227723,420,-6,-56,-24,-16,-6,6,0,-1,1,0,-7,7,0,-3,4,1,1,0,1,0,-6,-2,-4,-1,5,3,0,-4,-1,-1,-1,-1,4,-1
KR_6598983021,420,-1,-49,-23,-5,-2,5,3,-3,6,3,5,1,6,-4,5,1,-1,3,2,0,-1,-2,-3,-1,4,0,0,0,-1,0,-1,-1,6,-1
KR_6725028683,420,1,59,13,2,3,0,3,0,3,3,-1,3,2,-2,3,1,2,2,4,0,-1,-225,-1,-2,3,0,0,-1,1,0,-1,-1,4,-1
KR_6734884627,420,-2,-38,30,-5,1,1,2,0,0,0,-1,1,0,-3,3,0,-2,3,1,0,-7,-5,-1,-3,4,0,0,0,1,-1,-1,-1,1,-1
KR_6710393675,420,-8,-74,7,-6,-5,5,0,-2,4,2,1,2,3,-1,6,5,1,0,1,0,-2,3,-1,-3,4,2,0,-2,1,-1,-1,1,4,-1
KR_6719714095,440,-5,-18,-29,-4,-4,4,0,-4,4,0,2,4,6,-4,5,1,6,0,6,0,-1,-99,0,-2,2,1,0,0,0,0,0,-1,0,-1
KR_6719699257,440,-1,85,12,0,1,3,4,-6,6,0,-3,7,4,1,0,1,7,0,7,0,0,-23,-1,-2,3,5,0,0,0,-1,1,1,0,-1
KR_6756947101,440,-1,39,-20,0,-3,3,0,2,0,2,-1,4,3,6,0,6,-4,4,0,0,2,-3,-3,-2,5,-2,0,-1,-1,-1,-1,-1,1,-1
KR_6759430063,440,-1,-25,8,3,0,2,2,4,1,5,3,0,3,-3,6,3,-1,2,1,0,3,-6,-4,-3,7,5,0,0,1,-1,-1,1,6,-1
KR_6763508898,420,-4,13,-4,-11,2,2,4,-2,3,1,-5,6,1,-8,11,3,2,0,2,0,-10,0,6,-7,1,-4,0,0,1,1,-1,1,5,-1
KR_6346677702,420,-5,0,5,-14,-3,3,0,-4,4,0,-1,5,4,-1,4,3,-5,6,1,0,-19,8,3,-4,1,1,0,0,-1,-1,0,-1,2,-1
KR_6721909796,420,-3,-8,-35,-7,-1,1,0,-4,4,0,-1,1,0,-3,5,2,2,1,3,0,-10,-105,-5,-1,6,-2,0,0,1,-1,0,-1,6,-1
KR_6705077670,420,-4,-53,-19,-10,-3,4,1,-5,7,2,0,1,1,-3,4,1,1,0,1,1,-8,-343,0,-1,1,2,0,1,-1,1,1,1,5,-1
KR_6761126742,420,-3,-2,1,-5,-3,3,0,0,2,2,2,4,6,-2,2,0,-2,2,0,0,-4,4,4,-5,1,3,0,-2,-1,1,-1,1,2,-1
KR_6748043668,420,1,9,-8,4,0,2,2,6,0,6,-4,5,1,2,2,4,0,1,1,0,10,207,1,-6,5,-3,0,0,1,-1,-1,-1,2,-1
KR_6729683035,420,-3,-42,-59,-6,-2,2,0,-1,1,0,-3,3,0,0,2,2,0,0,0,0,-5,69,1,-5,4,0,0,-3,-1,-1,-1,-1,1,-1
KR_6751931653,420,-2,25,-25,0,-1,1,0,-5,5,0,3,3,6,-2,8,6,5,0,5,0,10,8,-8,-1,9,1,0,-1,-1,-1,1,1,3,-1
KR_6761535470,420,-4,-76,4,-9,1,0,1,0,1,1,-2,4,2,-6,6,0,-2,2,0,-4,-20,5,-1,-3,4,-6,0,0,-1,-1,-1,-1,6,-1
KR_6607961310,420,-2,-53,-28,-3,-3,3,0,3,2,5,-1,3,2,-2,6,4,0,4,4,0,-2,-10,-2,-5,7,-2,0,-2,-1,-1,-1,-1,6,-1
KR_6752565609,440,1,-87,-20,5,1,4,5,1,0,1,2,0,2,-2,4,2,3,1,4,0,6,4,3,-6,3,-2,0,-1,1,-1,-1,-1,6,-1
KR_6615690807,440,2,10,-9,3,4,0,4,-4,4,0,-1,4,3,2,1,3,2,0,2,2,3,-9,2,-2,0,-2,0,0,0,1,0,1,0,-1
KR_6761790369,420,3,40,12,0,2,0,2,-4,4,0,3,2,5,-1,2,1,0,0,0,0,-8,1,3,-6,3,-1,0,0,1,-1,-1,-1,3,-1
KR_6757030514,420,0,15,37,-6,-2,3,1,0,2,2,-4,4,0,2,4,6,-2,3,1,0,-6,18,-1,-4,5,-5,0,0,-1,0,0,1,2,-1
KR_6647222876,440,-3,-28,9,-3,2,1,3,-1,2,1,-5,6,1,-1,4,3,2,0,2,0,0,3,0,-2,2,0,0,-1,-1,1,-1,1,2,-1
KR_6725721643,420,-5,-52,-27,-6,-2,4,2,-7,7,0,1,2,3,1,2,3,1,1,2,0,-6,267,-5,-2,7,4,0,-1,-1,-1,-1,-1,1,-1
KR_6754087641,420,-6,-91,-36,-10,2,0,2,-2,4,2,-8,8,0,-2,2,0,0,1,1,0,-5,-45,2,-4,2,17,0,-2,-1,0,-1,-1,4,-1
KR_6729185535,420,-5,-124,-5,-15,-2,2,0,-5,9,4,-5,5,0,1,1,2,-4,6,2,0,-10,-151,4,-7,3,-6,0,-2,-1,-1,-1,-1,4,-1
KR_6756358971,420,2,79,31,4,-2,2,0,7,1,8,0,2,2,0,3,3,-1,2,1,0,6,-2,2,-4,2,-2,0,1,-1,1,1,1,2,-1
KR_6634115971,420,-2,-23,-11,-10,-1,3,2,0,1,1,-8,10,2,-1,3,2,0,1,1,-2,-4,-171,-4,-1,5,5,0,0,-1,-1,0,-1,6,-1
KR_6730397380,420,-6,-50,-8,-14,-10,10,0,3,0,3,-1,5,4,-3,5,2,-3,3,0,0,-12,1,1,-5,4,-2,0,-3,-1,-1,-1,-1,3,-1
KR_6500337828,420,-5,-98,-2,-7,-3,3,0,-4,4,0,0,2,2,0,0,0,0,2,2,0,-3,-1,-3,-1,4,0,0,-2,-1,-1,-1,1,5,-1
KR_6706389465,420,-2,-12,-8,-8,-3,6,3,-2,4,2,0,2,2,-3,7,4,0,0,0,0,-14,-196,1,-4,3,-3,0,0,-1,-1,-1,1,6,-1
KR_6678849880,440,-5,-83,-8,-9,-8,8,0,1,3,4,-3,3,0,2,0,2,-1,3,2,0,-5,3,3,-6,3,-1,0,-1,-1,-1,-1,1,6,-1
KR_6744752276,420,-3,13,-34,-7,4,0,4,-6,7,1,-2,2,0,-2,5,3,-1,2,1,-1,-7,-12,-7,-2,9,3,0,-2,-1,-1,-1,1,3,-1
KR_6724247454,420,0,22,-14,-3,2,1,3,0,2,2,-2,3,1,-2,6,4,-1,3,2,0,-6,-7,3,-6,3,-2,0,-1,-1,-1,-1,-1,6,-1
KR_6730763959,420,-1,-70,-9,-3,2,1,3,0,3,3,-3,3,0,-3,6,3,1,1,2,2,-8,-42,-3,-6,9,19,0,-1,1,-1,-1,1,6,-1
KR_6762589456,420,3,51,20,4,1,0,1,-2,4,2,2,3,5,3,2,5,0,0,0,0,1,11,-1,-3,4,3,0,1,-1,1,1,1,5,-1
KR_6394566211,420,-4,-47,-8,-7,0,0,0,-4,5,1,-2,2,0,0,4,4,-1,2,1,0,-5,125,4,-7,3,-3,0,-3,1,-1,-1,-1,5,-1
KR_6622021580,420,-2,-12,15,-3,-3,3,0,1,1,2,1,0,1,0,6,6,-2,3,1,0,1,18,1,-2,1,3,0,-1,0,-1,-1,1,0,-1
KR_6715598588,420,-1,-9,-16,-2,-2,2,0,0,3,3,1,2,3,-1,2,1,0,1,1,0,2,7,6,-7,1,-1,0,0,0,-1,0,1,0,-1
KR_6759283802,420,-2,-75,-4,-5,-1,1,0,-1,2,1,1,0,1,-5,5,0,1,0,1,-1,-10,4,3,-4,1,1,0,0,0,0,0,-1,0,-1
KR_6704344331,420,4,38,41,5,1,2,3,-7,9,2,1,2,3,4,1,5,6,2,8,0,3,92,2,-4,2,-2,0,1,-1,-1,1,1,1,-1
KR_6695245038,420,-2,7,-12,2,3,1,4,-2,4,2,-1,3,2,2,0,2,0,1,1,1,-5,92,-1,-5,6,1,0,0,-1,1,0,1,1,-1
KR_6716269271,420,-5,-21,-4,-13,-3,4,1,-4,6,2,-2,3,1,0,1,1,-4,4,0,0,-13,15,1,-5,4,-3,0,-2,-1,-1,-1,-1,5,-1
KR_6757580454,420,3,43,24,0,-3,6,3,2,2,4,-1,1,0,3,0,3,-1,3,2,0,-2,-5,0,-5,5,4,0,1,1,1,1,1,2,-1
KR_6740953413,420,-1,-133,28,2,-1,3,2,3,3,6,-1,1,0,1,1,2,0,0,0,1,9,-1,4,-7,3,1,0,0,1,-1,0,1,6,-1
KR_6758913614,420,1,-30,0,-1,1,0,1,0,1,1,2,1,3,-3,3,0,-1,2,1,0,-1,-2,-3,-1,4,1,0,0,-1,0,0,-1,4,-1
KR_6750449893,420,-5,-31,-21,-7,3,0,3,0,1,1,-1,1,0,-8,8,0,-1,1,0,0,-12,-5,1,-4,3,-4,0,0,0,1,-1,-1,0,-1
KR_6745733806,420,2,27,44,3,-2,2,0,-1,2,1,1,3,4,6,0,6,-1,1,0,0,1,35,0,-6,6,-28,0,0,1,0,0,-1,1,-1
KR_6719392487,420,-2,27,-8,-5,3,0,3,-2,3,1,-3,3,0,-1,4,3,-2,3,1,1,-11,-2,0,-4,4,-3,0,-1,-1,1,1,1,5,-1
KR_6136660314,420,-5,-139,24,-16,-2,2,0,-7,8,1,-4,5,1,-5,6,1,2,1,3,0,-11,-28,-6,-2,8,35,0,-1,-1,-1,-1,1,3,-1
KR_6634059754,420,1,-5,-4,-3,1,2,3,0,2,2,0,0,0,-3,3,0,-1,1,0,0,-7,10,-2,-2,4,2,0,-1,-1,1,-1,-1,2,-1
KR_6724702625,440,-3,-57,-44,-11,-10,12,2,4,2,6,0,1,1,-4,6,2,-1,1,0,-1,-12,-3,-2,-2,4,1,0,-2,1,-1,-1,-1,6,-1
KR_6748214597,420,-1,-2,0,2,-6,6,0,2,2,4,3,1,4,3,2,5,0,0,0,0,1,391,1,-3,2,0,0,-1,1,-1,-1,-1,3,-1
KR_6693118465,420,-7,-79,3,-11,0,1,1,-1,3,2,-1,1,0,-8,10,2,-1,1,0,1,-12,-1,3,-3,0,0,0,-2,-1,0,-1,1,5,-1
KR_6676193725,440,-2,-52,-16,-2,-5,7,2,4,0,4,3,1,4,-1,2,1,-3,3,0,0,0,-3,2,-3,1,0,0,0,0,-1,0,-1,0,-1
KR_6756404942,420,-1,-32,20,4,-2,2,0,3,3,6,1,1,2,2,1,3,0,2,2,0,4,11,6,-6,0,-3,0,-1,-1,-1,-1,1,1,-1
KR_6761575946,420,0,7,8,4,2,2,4,0,5,5,4,0,4,-1,1,0,-1,1,0,0,3,-124,2,-6,4,0,0,1,-1,0,1,1,2,-1
KR_6739081511,420,-4,-58,-16,-13,-5,5,0,-2,4,2,-3,4,1,-1,3,2,-2,5,3,0,-7,5,-1,-2,3,-1,0,-1,-1,-1,-1,1,5,-1
KR_6747054816,420,1,23,-1,2,-1,2,1,-3,4,1,-3,4,1,7,0,7,2,0,2,0,2,21,-2,-3,5,-5,0,0,0,1,0,1,0,-1
KR_6760368104,420,-1,-84,-16,8,-2,4,2,0,5,5,4,0,4,6,1,7,0,2,2,0,2,-6,-1,-5,6,1,0,0,-1,-1,-1,1,2,-1
KR_6722363088,420,-5,-123,-16,-16,-1,2,1,-5,7,2,-6,7,1,-4,6,2,0,1,1,0,-14,2,-2,-3,5,-2,0,-2,1,-1,-1,-1,3,-1
KR_6466062110,440,0,4,-20,-3,4,1,5,-2,3,1,1,2,3,-5,6,1,-1,3,2,0,-8,-6,0,0,0,-1,0,0,-1,1,0,-1,3,-1
KR_6721364792,420,-7,-43,-32,-12,-1,1,0,3,5,8,-12,12,0,1,1,2,-3,4,1,-1,-2,11,-3,-2,5,2,0,0,0,0,-1,-1,0,-1
KR_6728847440,420,3,55,28,5,3,0,3,0,3,3,2,2,4,-1,4,3,1,2,3,0,6,26,-5,-2,7,1,0,-1,-1,-1,-1,-1,4,-1
KR_6732453764,420,-2,-60,-10,-7,-1,4,3,0,2,2,-1,2,1,-4,4,0,-1,1,0,0,-8,35,1,-4,3,-16,0,-1,-1,-1,-1,-1,4,-1
KR_6763430370,420,-2,-18,-32,-3,1,1,2,-4,5,1,7,0,7,-6,7,1,-1,1,0,-1,-5,-13,-3,-5,8,2,0,-2,-1,-1,-1,-1,1,-1
KR_6730680800,440,-8,-73,-25,-15,-6,7,1,-5,5,0,0,0,0,-3,3,0,-1,1,0,0,-15,-6,-3,-3,6,-7,0,-1,-1,1,-1,-1,5,-1
KR_6689479301,420,-5,-22,-16,-13,0,1,1,-1,2,1,-5,5,0,-3,3,0,-4,4,0,0,-14,-81,2,-6,4,-28,0,-1,-1,1,-1,-1,2,-1
KR_6694554819,420,4,-37,1,-1,3,0,3,-9,10,1,2,1,3,2,2,4,1,1,2,-1,-3,-9,-3,-3,6,0,0,0,1,-1,-1,-1,2,-1
KR_6762380344,420,-3,-19,-7,-9,-1,1,0,1,3,4,-3,6,3,-5,7,2,-1,2,1,-1,-9,0,0,-4,4,-3,0,0,-1,1,1,-1,1,-1
KR_6646845545,420,1,-3,-30,-4,0,2,2,0,1,1,-3,6,3,1,2,3,-2,4,2,0,0,-2,0,-3,3,3,0,-1,-1,-1,-1,-1,1,-1
KR_6763752403,420,-4,-30,-20,-9,-3,4,1,0,2,2,-1,2,1,-6,11,5,1,0,1,0,-21,-70,4,-7,3,8,0,-2,1,-1,-1,1,1,-1
KR_6678176357,420,-4,-83,-4,-10,1,2,3,1,0,1,-4,4,0,-7,8,1,-1,2,1,0,-12,-2,1,-4,3,-1,0,0,-1,-1,0,-1,4,-1
KR_6734235882,420,-2,56,-20,-2,-2,2,0,4,1,5,-3,4,1,-1,2,1,0,0,0,0,0,5,0,-2,2,-3,0,0,1,0,0,1,4,-1
KR_6710139668,440,1,13,-4,0,-3,3,0,1,3,4,0,1,1,0,4,4,2,0,2,-1,-8,-9,-2,-1,3,3,0,0,-1,1,0,-1,6,-1
KR_6751279172,420,-3,-5,-43,-7,-2,2,0,0,1,1,2,1,3,-8,9,1,1,1,2,0,-5,1,-3,-3,6,1,0,-2,0,-1,-1,-1,0,-1
KR_6757090024,420,-1,10,0,-5,1,1,2,-4,7,3,-4,6,2,2,2,4,0,2,2,0,-4,3,3,-7,4,2,0,0,1,1,1,-1,5,-1
KR_6687938574,420,0,-11,29,-4,-3,3,0,0,2,2,2,2,4,-4,6,2,1,0,1,0,-7,-1,2,-6,4,-1,0,-1,-1,-1,-1,-1,4,-1
KR_6701507079,440,0,-80,-43,5,4,0,4,2,0,2,-3,6,3,1,2,3,1,1,2,0,7,-7,-4,0,4,1,0,-1,-1,1,-1,-1,3,-1
KR_6751382686,420,0,-38,35,1,2,3,5,0,5,5,4,4,8,-5,5,0,0,0,0,1,5,-4,0,-4,4,2,0,-1,1,-1,-1,1,2,-1
KR_6726599595,440,-3,-67,29,-7,-2,3,1,-3,6,3,1,0,1,-1,4,3,-2,4,2,0,-4,14,-4,-3,7,1,0,-1,1,-1,-1,-1,6,-1
KR_6725547572,420,1,-33,-16,-1,2,2,4,0,2,2,1,1,2,-3,3,0,-1,1,0,0,-4,54,3,-5,2,-15,0,0,1,-1,0,1,3,-1
KR_6762383474,420,3,36,-12,1,2,1,3,-1,1,0,3,1,4,-4,8,4,1,1,2,0,1,-15,6,-7,1,4,0,-1,1,-1,-1,1,6,-1
KR_6705882722,420,1,16,3,2,4,0,4,-4,5,1,0,1,1,2,0,2,0,0,0,0,-4,-3,0,-3,3,-2,0,0,1,-1,0,1,3,-1
KR_6708604362,440,-2,-42,-30,0,1,0,1,2,2,4,-2,3,1,4,0,4,-5,6,1,0,7,23,4,-6,2,0,0,-1,-1,0,-1,1,2,-1
KR_6764573601,420,1,56,-16,-3,-2,4,2,1,1,2,-1,2,1,-1,1,0,0,1,1,0,-5,0,2,-6,4,7,0,1,1,1,1,-1,1,-1
KR_6685784034,420,1,30,12,6,0,1,1,-3,4,1,2,4,6,3,1,4,4,0,4,1,2,-5,-3,-3,6,28,0,1,0,-1,1,1,0,-1
KR_6747231952,440,-1,-19,-21,-3,-3,3,0,-2,2,0,-8,8,0,8,0,8,2,0,2,0,7,4,1,-4,3,2,0,0,1,-1,-1,1,3,-1
KR_6692051094,420,-10,-58,-24,-5,-4,4,0,-1,1,0,1,1,2,0,2,2,-1,2,1,1,-2,6,1,-5,4,-2,0,-2,1,-1,-1,1,5,-1
KR_6685469406,420,1,-29,16,-7,1,2,3,0,1,1,-9,10,1,0,2,2,1,0,1,0,1,-5,0,-3,3,1,0,-1,1,-1,-1,-1,1,-1
KR_6732559026,420,-2,-1,-20,2,2,2,4,-4,4,0,-4,7,3,4,1,5,4,0,4,1,7,66,1,-4,3,-16,0,1,1,-1,-1,1,4,-1
KR_6679950211,420,-2,-97,-12,-4,-2,2,0,0,1,1,3,4,7,-1,4,3,-4,4,0,0,-12,33,2,-5,3,3,0,-1,-1,0,-1,-1,2,-1
KR_6717643682,420,-2,-31,-17,-6,-2,2,0,-3,3,0,-1,2,1,4,1,5,-4,4,0,0,-2,-2,3,-5,2,-1,0,0,1,0,0,-1,4,-1
KR_6501442610,420,-7,-95,0,-7,1,0,1,-5,6,1,-1,3,2,-2,2,0,0,0,0,0,-12,-37,-6,-3,9,11,0,-3,-1,-1,-1,-1,5,-1
KR_6701326719,420,-6,-42,-36,-12,2,0,2,-1,4,3,-3,4,1,-5,5,0,-5,5,0,-3,-20,-358,-2,-2,4,1,0,-1,-1,0,-1,-1,5,-1
KR_6757651333,440,-1,-41,28,-7,-5,6,1,1,1,2,2,1,3,-4,8,4,-1,3,2,0,-10,-6,1,-3,2,1,0,0,1,-1,-1,-1,2,-1
KR_6737639992,420,-1,-48,-8,1,1,0,1,1,2,3,-2,3,1,4,0,4,-3,3,0,0,-4,-28,4,-6,2,-3,0,0,1,0,0,-1,5,-1
KR_6719528813,420,4,32,47,6,-2,4,2,-2,6,4,6,1,7,3,2,5,1,2,3,0,7,6,-3,-3,6,1,0,1,0,0,1,-1,0,-1
KR_6759423080,420,2,27,-5,9,1,1,2,1,1,2,1,3,4,6,1,7,0,0,0,0,9,-109,0,-6,6,1,0,0,-1,1,0,1,5,-1
KR_6764295546,420,-7,-140,-92,-10,-7,7,0,-2,5,3,-1,1,0,0,2,2,0,3,3,-1,-8,-2,0,-2,2,0,0,-1,-1,-1,-1,-1,3,-1
KR_6747165699,420,3,35,-21,-3,2,0,2,-3,3,0,-5,6,1,2,2,4,1,3,4,-1,6,-5,-3,-2,5,4,0,0,1,-1,-1,-1,1,-1
KR_6652717030,420,-4,-46,4,-8,0,1,1,0,5,5,-7,9,2,-2,2,0,1,1,2,0,1,-119,-2,-1,3,5,0,-2,0,-1,-1,-1,0,-1
KR_6736762604,440,-2,-70,0,0,-2,3,1,-3,4,1,3,3,6,2,0,2,0,1,1,0,-2,1,-2,-3,5,-5,0,-2,-1,-1,-1,1,3,-1
KR_6750763239,420,-3,-27,-8,-4,-4,4,0,-4,4,0,2,0,2,4,2,6,-2,4,2,0,-6,18,-1,-4,5,-6,0,-1,-1,1,-1,1,2,-1
KR_6764412480,420,3,96,-9,6,4,1,5,-1,3,2,0,4,4,-1,3,2,4,0,4,1,1,3,0,-5,5,0,0,2,-1,1,1,1,3,-1
KR_6586625461,440,-4,-117,-10,-11,-2,4,2,-4,6,2,-1,6,5,1,1,2,-5,7,2,-1,-12,-2,-3,0,3,1,0,0,-1,1,-1,-1,6,-1
KR_6750472372,420,1,33,20,1,-1,2,1,2,0,2,-2,3,1,4,1,5,-2,3,1,-1,4,1,-1,-4,5,0,0,0,1,0,-1,-1,5,-1
KR_6737606854,420,-6,-78,-27,-15,-2,2,0,-8,9,1,-3,6,3,-3,5,2,1,2,3,-2,-13,9,-1,-3,4,-4,0,-2,-1,-1,-1,-1,3,-1
KR_6758574010,440,-3,-67,-4,2,-4,6,2,3,1,4,3,0,3,1,2,3,-1,2,1,0,10,-8,0,-6,6,1,0,-2,-1,-1,-1,-1,4,-1
KR_6665918138,420,-4,-21,-4,-1,3,1,4,2,1,3,-4,6,2,0,1,1,-2,4,2,1,1,11,0,-3,3,-3,0,-1,-1,-1,-1,1,6,-1
KR_6699280539,420,0,-6,-37,-1,3,1,4,0,3,3,-2,5,3,-2,6,4,0,1,1,0,2,0,-1,-5,6,3,0,0,-1,-1,1,-1,2,-1
KR_6755289924,420,-1,25,-8,-4,1,2,3,-3,3,0,6,0,6,-5,5,0,-3,3,0,0,0,-24,-9,-1,10,5,0,0,1,1,0,1,6,-1
KR_6744370151,420,-1,-5,12,-1,-3,4,1,0,6,6,0,1,1,1,0,1,1,0,1,0,7,-9,-2,-2,4,5,0,-1,0,-1,1,1,0,-1
KR_6706437115,420,-4,-31,-32,-2,-1,2,1,-3,3,0,1,1,2,0,0,0,1,0,1,0,0,-4,-3,-4,7,-1,0,-1,-1,-1,-1,-1,4,-1
KR_6743127457,440,-5,-103,-28,-9,-1,3,2,-1,6,5,-6,6,0,-1,2,1,0,2,2,0,-3,-2,-2,0,2,0,0,-3,-1,0,-1,-1,3,-1
KR_6655304903,420,2,27,-4,2,-1,5,4,4,2,6,1,3,4,1,3,4,-3,3,0,0,4,4,4,-6,2,1,0,0,0,-1,0,1,0,-1
KR_6707128592,420,-1,-36,-26,3,1,1,2,3,3,6,-3,5,2,3,2,5,-1,2,1,0,13,-1,4,-5,1,-3,0,-2,-1,0,-1,-1,5,-1
KR_6733237571,420,-4,34,-4,-6,2,1,3,1,4,5,-9,10,1,0,0,0,0,0,0,1,-7,-18,-1,-2,3,-2,0,-2,-1,-1,-1,1,2,-1
KR_6691862657,420,-5,-48,-34,-9,-3,4,1,-4,6,2,-4,5,1,2,0,2,0,0,0,0,-2,-2,3,-6,3,-2,0,-2,1,-1,-1,-1,2,-1
KR_6751669452,420,-3,-63,8,-7,-1,3,2,4,1,5,-6,8,2,-2,4,2,-2,3,1,-1,-5,-167,1,-4,3,-2,0,0,1,1,-1,1,1,-1
KR_6755616767,440,-3,-89,-40,-6,0,2,2,-1,2,1,0,1,1,-2,5,3,-3,3,0,0,-8,-2,-4,-1,5,2,0,0,-1,-1,-1,1,5,-1
KR_6746174042,420,0,-73,21,-1,-2,3,1,2,1,3,-4,5,1,1,0,1,2,0,2,0,1,5,-2,-2,4,-1,0,0,1,-1,-1,1,5,-1
KR_6674400202,420,-1,30,-8,-1,3,0,3,0,4,4,-3,4,1,-2,4,2,1,0,1,-1,1,5,4,-9,5,-4,0,0,-1,-1,0,1,6,-1
KR_6744576940,420,1,35,-12,1,-4,4,0,7,0,7,0,0,0,0,0,0,-2,2,0,0,5,2,-1,-1,2,1,0,-1,-1,-1,-1,1,1,-1
KR_6754706177,420,-4,-24,-8,-13,-3,4,1,-2,3,1,-1,1,0,-8,10,2,1,1,2,-2,-8,-258,-2,0,2,-1,0,-3,-1,-1,-1,-1,2,-1
KR_6755349399,440,-1,-8,-15,2,-2,3,1,-1,1,0,-1,4,3,1,1,2,5,2,7,1,0,6,3,-4,1,1,0,1,1,1,1,1,3,-1
KR_6739317362,420,0,8,28,-2,0,1,1,0,1,1,2,2,4,-5,6,1,1,0,1,0,1,36,-3,-1,4,-22,0,0,-1,0,1,-1,3,-1
KR_6641963580,420,-2,-62,-3,-5,-1,1,0,-5,5,0,-2,2,0,3,0,3,0,2,2,0,-3,-1,0,-8,8,7,0,0,0,0,0,1,0,-1
KR_6737027904,420,0,-15,-1,0,4,0,4,2,0,2,1,1,2,-5,6,1,-2,3,1,-1,3,-18,-3,0,3,0,0,-1,1,-1,-1,-1,5,-1
KR_6761815975,420,-1,-6,12,-7,-4,6,2,0,2,2,-1,1,0,-2,4,2,0,2,2,0,-1,0,-1,-6,7,-3,0,0,-1,-1,0,1,4,-1
KR_6717428350,420,0,-10,-12,3,1,2,3,2,0,2,-3,5,2,0,2,2,3,1,4,0,2,-5,1,-3,2,1,0,-1,-1,-1,-1,1,1,-1
KR_6699937158,420,-3,-63,-28,-6,1,1,2,-3,4,1,-1,1,0,-4,6,2,1,1,2,0,-5,-5,-5,-5,10,-2,0,-1,-1,-1,-1,-1,4,-1
KR_6763251721,420,-3,-56,0,-7,-1,2,1,-2,5,3,0,2,2,-5,12,7,1,1,2,0,-2,4,4,-5,1,2,0,-1,-1,-1,-1,-1,4,-1
KR_6742806930,420,-4,-93,-4,-3,2,2,4,2,3,5,-4,5,1,-3,4,1,0,2,2,0,2,13,7,-11,4,-4,0,-2,0,-1,-1,-1,0,-1
KR_6764758681,420,1,22,32,-3,-4,4,0,-2,2,0,1,0,1,0,3,3,2,1,3,0,1,-293,1,-3,2,2,0,0,0,0,0,-1,0,-1
KR_6758001743,420,3,-36,24,1,4,1,5,0,2,2,-7,7,0,4,1,5,0,0,0,0,6,1,-3,-6,9,-1,0,1,1,-1,-1,-1,5,-1
KR_6760331814,420,1,-2,-36,-3,-7,7,0,-3,3,0,0,2,2,4,0,4,3,2,5,-1,1,2,1,-2,1,2,0,0,0,0,0,-1,0,-1
KR_6620337143,420,-2,-50,-10,0,-5,6,1,1,2,3,1,2,3,3,5,8,0,1,1,0,4,-4,0,-2,2,1,0,0,-1,1,1,-1,3,-1
KR_6659826882,420,-3,2,-15,-5,1,1,2,-6,8,2,3,1,4,0,0,0,-3,3,0,0,-7,5,1,-4,3,-3,0,-1,-1,1,-1,1,5,-1
KR_6747475981,420,-2,-32,-7,-3,-1,2,1,0,3,3,0,1,1,-3,6,3,1,0,1,0,3,-3,-1,-3,4,-2,0,0,1,1,0,1,2,-1
KR_6760698724,440,1,51,-16,-2,0,1,1,-2,5,3,3,1,4,-3,4,1,0,1,1,0,-4,0,2,-4,2,0,0,0,-1,0,0,-1,6,-1
KR_6710490926,420,0,21,-11,1,-2,2,0,3,2,5,0,3,3,1,0,1,-1,2,1,0,1,135,7,-8,1,-4,0,1,0,0,1,1,0,-1
KR_6764706273,420,-4,-48,13,-7,0,2,2,3,1,4,-5,5,0,-5,5,0,0,0,0,0,-9,-9,-3,-1,4,-3,0,-1,-1,0,-1,1,3,-1
KR_6744822252,420,-1,-17,8,-6,2,0,2,-2,5,3,-1,4,3,-2,5,3,-3,4,1,0,-10,-8,-2,-8,10,1,0,-1,-1,1,-1,-1,2,-1
KR_6758828150,420,-2,-25,-12,-3,-4,7,3,-3,5,2,0,2,2,4,1,5,0,1,1,0,5,-24,-1,-7,8,1,0,-1,0,0,-1,1,0,-1
KR_6681441858,420,2,81,0,3,2,1,3,-2,5,3,0,2,2,0,2,2,3,1,4,0,1,-2,3,-6,3,2,0,0,1,-1,0,1,6,-1
KR_6763386385,440,0,-20,-12,8,1,3,4,3,1,4,2,4,6,1,2,3,1,1,2,1,13,-7,-3,0,3,1,0,-1,0,1,-1,1,0,-1
KR_6721631921,420,-3,-85,-13,-5,-2,3,1,-3,5,2,-5,8,3,6,2,8,-1,2,1,1,3,181,0,-4,4,-1,0,-3,1,-1,-1,1,5,-1
KR_6586578068,440,3,-3,8,7,6,0,6,0,2,2,-2,3,1,1,4,5,2,0,2,0,5,6,4,-5,1,-2,0,2,1,0,1,1,6,-1
KR_6734535590,420,0,-22,20,-3,1,1,2,-3,4,1,5,1,6,-6,9,3,0,0,0,0,-6,8,2,-4,2,-6,0,0,1,-1,0,-1,3,-1
KR_6644303706,420,0,34,-8,1,-2,3,1,2,0,2,-1,2,1,2,1,3,0,0,0,0,5,3,-4,-1,5,2,0,0,-1,-1,0,1,6,-1
KR_6693153466,420,-1,23,-16,-1,4,2,6,-1,3,2,-3,4,1,-1,3,2,0,1,1,-1,-2,-14,-1,-3,4,2,0,-3,1,-1,-1,-1,2,-1
KR_6706016290,420,1,71,-28,-1,2,0,2,1,2,3,-1,2,1,-2,2,0,-1,2,1,0,-6,0,-1,-3,4,0,0,0,0,0,0,-1,0,-1
KR_6729383669,420,-7,-63,-37,-14,-1,2,1,-4,5,1,-3,4,1,-4,4,0,-2,2,0,-1,-16,15,1,-3,2,-1,0,-2,-1,-1,-1,-1,1,-1
KR_6610059918,420,-1,-14,-8,0,2,2,4,0,2,2,-3,3,0,2,1,3,-1,1,0,0,3,-21,1,-6,5,0,0,0,-1,-1,0,-1,3,-1
KR_6747486570,420,-2,-36,-4,-6,5,0,5,1,2,3,-9,12,3,-5,5,0,2,0,2,1,-20,5,-1,-1,2,1,0,0,-1,-1,-1,1,4,-1
KR_6751938578,420,-2,2,4,-3,0,1,1,-1,2,1,-4,4,0,-1,3,2,3,1,4,0,-2,-287,4,-5,1,2,0,1,1,1,1,-1,6,-1
KR_6687891749,420,-1,-31,22,-3,-2,2,0,5,2,7,0,2,2,-2,2,0,-4,4,0,0,5,-5,-2,-3,5,3,0,0,1,-1,0,-1,2,-1
KR_6759851835,440,3,72,33,-1,-1,4,3,-1,5,4,5,2,7,0,2,2,-4,4,0,-1,-3,6,0,0,0,0,0,-1,-1,0,1,-1,4,-1
KR_6753138598,440,-1,63,1,-9,-1,4,3,2,1,3,-3,3,0,-3,3,0,-4,4,0,0,-6,-2,-3,-2,5,-4,0,-1,-1,-1,-1,1,1,-1
KR_6732479321,420,1,59,4,7,2,2,4,1,4,5,2,0,2,2,0,2,0,1,1,0,5,4,0,-6,6,0,0,1,1,-1,1,1,5,-1
KR_6715036050,420,0,-17,-27,1,-1,1,0,0,0,0,0,3,3,1,1,2,1,1,2,0,4,31,-3,0,3,-12,0,0,-1,1,0,1,4,-1
KR_6673452550,420,-1,29,-16,-3,1,2,3,2,2,4,-4,5,1,1,0,1,-3,4,1,0,2,392,3,-6,3,-2,0,0,-1,1,1,1,6,-1
KR_6663549606,420,0,44,-4,-2,1,0,1,-3,4,1,0,2,2,2,2,4,-2,2,0,0,-6,49,1,-5,4,-36,0,1,1,1,1,-1,2,-1
KR_6744739015,420,0,10,-27,4,0,4,4,-4,7,3,2,2,4,4,2,6,2,2,4,0,6,-5,4,-5,1,0,0,0,1,1,1,-1,2,-1
KR_6705756677,420,0,4,-38,3,1,0,1,-4,7,3,-2,2,0,10,1,11,-2,2,0,0,2,6,-1,-2,3,1,0,0,1,-1,1,-1,2,-1
KR_6690895258,420,-3,-80,-8,-5,-5,7,2,3,3,6,-1,5,4,-2,3,1,0,1,1,1,7,1,0,-5,5,0,0,-3,1,-1,-1,1,5,-1
KR_6717504680,420,2,-33,13,-2,0,1,1,2,2,4,2,3,5,-4,4,0,-2,2,0,0,-5,-9,1,-4,3,-2,0,0,-1,1,-1,-1,4,-1
KR_6731723826,420,3,-4,16,3,1,1,2,1,3,4,3,3,6,-3,5,2,1,0,1,0,-4,3,3,-3,0,0,0,0,0,1,0,-1,0,-1
KR_6684835691,420,-8,-125,-12,-21,-6,6,0,-1,2,1,-6,8,2,-4,5,1,-4,5,1,0,-12,5,3,-5,2,-7,0,-3,-1,-1,-1,-1,1,-1
KR_6601475572,420,-2,-59,-7,1,-1,1,0,2,0,2,-5,5,0,4,3,7,1,0,1,0,12,1,0,-5,5,2,0,0,1,-1,0,-1,4,-1
KR_6692989020,420,4,-4,-7,1,-2,5,3,3,0,3,3,0,3,-3,5,2,0,2,2,0,1,13,3,-7,4,1,0,-1,-1,-1,-1,-1,2,-1
KR_6670253169,420,0,-11,12,-3,2,0,2,-3,5,2,-2,6,4,1,1,2,-1,1,0,2,6,-14,1,-6,5,1,0,0,1,-1,1,1,6,-1
KR_6618230052,420,-4,-64,-12,-6,-2,3,1,-2,4,2,0,0,0,-1,2,1,-1,1,0,0,-7,0,-1,-2,3,2,0,-1,1,1,-1,-1,5,-1
KR_6655939448,420,0,26,-20,-3,1,3,4,-2,3,1,-2,4,2,-1,4,3,1,0,1,0,-2,0,0,-2,2,1,0,0,-1,0,0,-1,1,-1
KR_6732330750,440,-3,-102,-29,-2,11,0,11,-4,4,0,-1,2,1,-4,5,1,-4,5,1,-1,-4,3,1,-4,3,-1,0,0,-1,1,-1,-1,5,-1
KR_6694546512,420,-1,29,6,-8,2,4,6,-5,5,0,-1,2,1,-2,5,3,-2,3,1,-1,-8,12,4,-5,1,-3,0,-2,-1,-1,-1,-1,3,-1
KR_6755740658,420,0,-19,-38,3,1,0,1,-1,3,2,1,4,5,2,2,4,0,0,0,0,2,-72,3,-7,4,-5,0,-1,1,-1,-1,1,6,-1
KR_5811360811,420,-3,-22,-15,-5,0,1,1,-4,6,2,-3,5,2,-3,4,1,5,1,6,0,0,-61,3,-8,5,-2,0,-2,-1,1,-1,1,5,-1
KR_6756753987,420,-7,-123,-28,-16,0,1,1,-2,2,0,-5,6,1,-8,8,0,-1,2,1,-2,-28,-9,0,-3,3,-1,0,-2,-1,-1,-1,-1,6,-1
KR_6672382844,420,5,-10,41,3,0,3,3,-5,7,2,3,1,4,4,5,9,1,0,1,0,-7,2,2,-5,3,1,0,0,0,1,0,-1,0,-1
KR_6760506668,420,0,-23,-7,6,-1,2,1,-4,5,1,-2,6,4,11,0,11,2,0,2,0,1,12,3,-5,2,-3,0,1,1,-1,1,1,4,-1
KR_6757897660,420,1,25,-12,1,0,1,1,-2,3,1,3,1,4,3,3,6,-3,4,1,2,6,9,2,-2,0,1,0,0,1,1,1,1,5,-1
KR_6727719582,420,-1,33,-12,2,3,0,3,0,1,1,-1,3,2,4,3,7,-4,4,0,1,2,14,1,-4,3,1,0,0,1,1,-1,1,4,-1
KR_6743543861,440,2,62,31,6,0,1,1,2,0,2,-2,3,1,6,1,7,0,0,0,0,7,4,2,-3,1,0,0,0,-1,1,0,1,6,-1
KR_6626614868,420,-1,-17,-34,2,-3,3,0,0,5,5,-1,3,2,5,0,5,1,0,1,0,10,-2,3,-3,0,0,0,-1,-1,-1,-1,-1,2,-1
KR_6648426262,420,-5,4,-13,-6,0,2,2,-4,4,0,-5,5,0,3,3,6,0,1,1,0,-7,10,-1,-3,4,0,0,1,-1,1,1,1,2,-1
KR_6750552456,420,-4,-45,16,-9,-2,5,3,-1,4,3,0,3,3,0,2,2,-6,6,0,0,-5,-9,0,-3,3,2,0,-1,0,1,-1,-1,0,-1
KR_6756651141,420,1,-27,-8,5,2,1,3,-1,3,2,1,3,4,3,0,3,0,0,0,0,9,81,-1,-4,5,2,0,-1,-1,1,-1,1,1,-1
KR_6617826778,420,-1,34,-4,-3,4,0,4,-1,2,1,-4,5,1,-2,4,2,0,0,0,0,1,-7,-5,-2,7,0,0,0,1,-1,0,-1,3,-1
KR_6734624717,420,-2,-14,-14,-11,-6,6,0,-1,4,3,-1,3,2,-4,4,0,1,0,1,0,-8,1,-2,-3,5,1,0,0,1,-1,0,-1,6,-1
KR_6685431397,420,-3,-37,-32,-9,-1,2,1,-1,2,1,-4,5,1,-2,3,1,-1,1,0,0,-11,7,-1,-3,4,-6,0,-1,-1,-1,-1,-1,2,-1
KR_6507769460,420,-1,34,0,-2,4,0,4,-2,3,1,1,3,4,-4,5,1,-1,1,0,0,0,-4,-2,-1,3,5,0,1,-1,1,1,1,6,-1
KR_6662548993,420,1,-17,-5,4,1,0,1,1,1,2,-1,2,1,3,0,3,0,1,1,0,2,2,3,-5,2,-2,0,0,1,-1,-1,-1,4,-1
KR_6607809992,420,0,-10,0,-4,0,2,2,0,0,0,-2,2,0,1,2,3,-3,4,1,0,-4,-8,-3,-4,7,1,0,-1,-1,1,-1,-1,2,-1
KR_6660047581,420,-3,-50,1,-11,1,4,5,-6,7,1,-1,1,0,-5,7,2,0,0,0,-1,-17,342,3,-5,2,-5,0,0,0,1,1,-1,0,-1
KR_6619685385,420,-7,-112,-23,-11,-1,1,0,-2,3,1,-5,6,1,-2,3,1,-1,1,0,0,-17,-203,0,-5,5,0,0,-1,-1,-1,-1,-1,1,-1
KR_6763532761,420,-1,-63,20,-4,1,0,1,0,3,3,-1,3,2,-5,5,0,1,3,4,0,-3,202,0,-2,2,3,0,-1,1,0,-1,-1,3,-1
KR_6707416750,420,-3,-37,-24,-5,-2,2,0,-1,4,3,-6,7,1,1,1,2,3,1,4,0,-2,-12,-3,-2,5,-3,0,0,-1,1,0,1,5,-1
KR_6730759178,420,-2,8,-22,4,3,1,4,-1,3,2,3,1,4,-2,3,1,1,0,1,0,7,12,4,-8,4,-1,0,0,1,1,0,-1,1,-1
KR_6655365116,420,3,46,8,2,2,0,2,2,1,3,-5,6,1,4,1,5,-1,1,0,0,7,5,-3,-4,7,-2,0,0,-1,-1,0,1,2,-1
KR_6763493007,420,-1,12,16,-9,2,1,3,-4,5,1,-3,4,1,-3,4,1,-1,2,1,0,-9,-8,3,-5,2,-2,0,0,-1,0,0,-1,3,-1
KR_6735806953,420,1,34,4,-3,4,0,4,-4,6,2,-2,3,1,1,0,1,-2,4,2,0,-1,-8,-3,-5,8,-3,0,0,-1,-1,1,-1,3,-1
KR_6733267470,420,-6,-107,-32,-6,-2,3,1,-2,2,0,-1,5,4,0,3,3,-1,2,1,0,-7,-4,0,-2,2,0,0,-4,0,-1,-1,1,0,-1
KR_6508321786,420,0,-13,27,-6,5,1,6,-5,5,0,-2,3,1,-4,5,1,0,2,2,0,-11,-220,2,-5,3,-3,0,0,-1,1,-1,1,3,-1
KR_6759331958,420,3,39,30,11,0,1,1,2,2,4,5,4,9,3,1,4,1,0,1,0,2,-214,2,-4,2,1,0,1,1,1,1,-1,3,-1
KR_6709226117,420,-2,-58,-23,-6,3,0,3,-1,2,1,-1,4,3,-7,7,0,0,0,0,0,-3,95,-3,0,3,3,0,-5,-1,-1,-1,-1,6,-1
KR_6707278713,420,-7,-149,-31,-13,-4,4,0,2,2,4,-3,3,0,-4,5,1,-4,5,1,0,-7,-17,-1,-1,2,4,0,-2,-1,-1,-1,-1,4,-1
KR_6732909739,420,-6,-133,6,-12,-4,6,2,1,0,1,-2,5,3,-6,6,0,-1,1,0,0,-13,-280,3,-7,4,-4,0,-3,-1,1,-1,-1,3,-1
KR_6696026907,420,-2,8,-41,-5,1,1,2,-3,4,1,-2,2,0,-2,2,0,1,2,3,0,-7,-4,-7,-1,8,-1,0,1,-1,1,1,1,3,-1
KR_6569912770,420,-3,-124,-32,-10,2,2,4,0,3,3,-4,4,0,-7,9,2,-1,3,2,-1,-9,-4,-10,-1,11,0,0,-2,-1,-1,-1,-1,6,-1
KR_6731080369,420,-3,-3,-4,-6,0,1,1,-3,3,0,0,1,1,-2,4,2,-1,1,0,0,-7,-6,-4,-2,6,2,0,0,-1,-1,0,1,2,-1
KR_6733721836,420,-3,-65,-35,-7,-3,4,1,-2,5,3,1,3,4,-3,5,2,0,0,0,0,-7,-15,0,-3,3,-2,0,0,-1,-1,0,-1,6,-1
KR_6571838426,420,-2,14,12,-6,-3,4,1,-3,4,1,2,2,4,-1,3,2,-1,1,0,0,-7,1,-4,-2,6,-3,0,0,-1,-1,0,1,6,-1
KR_6756522183,420,2,85,4,2,3,1,4,-3,5,2,2,2,4,0,2,2,0,1,1,-1,-2,8,2,-5,3,-4,0,0,0,0,0,-1,0,-1
KR_6705673350,420,-3,-20,25,-2,-4,5,1,3,1,4,-5,6,1,2,1,3,2,0,2,-1,-3,16,-1,-1,2,-14,0,0,-1,1,-1,-1,3,-1
KR_6758026531,420,-2,18,-14,-2,1,1,2,-1,2,1,0,4,4,-1,4,3,-1,2,1,1,-8,2,-1,-4,5,1,0,1,1,1,1,1,1,-1
KR_6762383400,420,0,-8,4,-1,-2,2,0,3,1,4,-2,3,1,-1,5,4,1,0,1,0,-1,8,-1,-1,2,-3,0,0,0,0,0,-1,0,-1
KR_6721606754,420,-5,-83,-16,-12,0,1,1,1,2,3,-6,7,1,-1,2,1,-6,6,0,0,-6,2,0,-5,5,-1,0,0,1,1,-1,-1,4,-1
KR_6758997971,420,-3,-80,-12,-1,2,0,2,-2,4,2,0,1,1,1,0,1,-2,2,0,0,-3,-16,2,-3,1,0,0,0,-1,1,0,-1,4,-1
KR_6654211139,420,2,29,29,5,5,0,5,0,1,1,6,0,6,-5,6,1,-1,3,2,0,-3,-40,-1,-4,5,23,0,1,1,1,1,-1,2,-1
KR_6702355679,420,0,-27,13,-10,-2,3,1,-4,6,2,-1,2,1,-4,6,2,1,1,2,0,-10,23,2,-6,4,-17,0,-1,1,-1,-1,-1,3,-1
KR_6667595662,440,-1,-8,-19,-4,0,2,2,0,6,6,-5,6,1,0,1,1,1,4,5,0,-2,1,1,-8,7,3,0,0,1,-1,-1,-1,5,-1
KR_6743027267,420,-3,-56,-12,-13,-2,5,3,-6,7,1,-1,2,1,-2,6,4,-2,3,1,0,-19,101,2,-7,5,3,0,-1,-1,-1,-1,1,4,-1
KR_6660054197,420,1,-8,-10,2,0,1,1,0,0,0,1,1,2,0,1,1,1,0,1,0,6,6,1,-4,3,3,0,0,1,-1,0,-1,6,-1
KR_6720841025,420,-2,-26,-8,-3,-1,2,1,-4,6,2,3,1,4,-2,2,0,1,0,1,0,0,-16,-1,-5,6,3,0,0,-1,1,0,-1,5,-1
KR_6650383315,420,-2,-49,-4,-4,-3,4,1,1,1,2,1,1,2,3,2,5,-6,6,0,1,-1,7,4,-7,3,2,0,-1,-1,-1,1,1,4,-1
KR_6758307370,420,-2,-59,16,-4,3,0,3,-1,1,0,-4,4,0,0,0,0,-2,3,1,0,-2,43,-4,0,4,-22,0,1,0,1,1,-1,0,-1
KR_6661070108,420,3,102,-24,9,3,1,4,0,2,2,-1,3,2,6,1,7,1,1,2,1,7,-7,-4,-1,5,-1,0,2,-1,0,1,1,6,-1
KR_6724630979,420,1,9,44,-2,-2,2,0,-2,3,1,1,0,1,2,2,4,-1,2,1,0,-1,2,-2,-1,3,-3,0,0,-1,0,1,1,1,-1
KR_6676010437,440,-4,-22,-16,-10,1,3,4,-1,2,1,3,2,5,-6,6,0,-7,8,1,0,-14,-17,6,-6,0,-4,0,-2,-1,0,-1,-1,4,-1
KR_6751251753,420,2,42,12,9,-2,5,3,1,1,2,4,0,4,6,4,10,0,0,0,1,7,-7,-1,-3,4,-1,0,0,1,1,1,1,3,-1
KR_6739046254,420,0,-4,41,7,0,0,0,4,2,6,2,3,5,-1,1,0,2,0,2,1,12,25,1,-4,3,0,0,1,-1,0,1,1,4,-1
KR_6723816166,420,-5,0,3,-13,-1,1,0,-9,9,0,2,1,3,-3,4,1,-2,2,0,0,-13,-1,-3,-1,4,0,0,-1,-1,1,-1,-1,5,-1
KR_6719685597,420,0,-10,10,-3,-1,3,2,1,0,1,5,1,6,-5,5,0,-3,4,1,-1,-9,0,1,-4,3,-4,0,-1,-1,-1,-1,-1,1,-1
KR_6745244921,420,0,-32,9,-9,2,2,4,0,1,1,2,0,2,-11,11,0,-2,2,0,-1,-10,-31,-3,-3,6,12,0,-1,-1,1,-1,-1,1,-1
KR_6693512266,420,-3,-54,-5,-4,-5,7,2,-3,4,1,1,2,3,2,2,4,1,0,1,0,-6,-12,-2,-4,6,-3,0,-4,1,-1,-1,-1,3,-1
KR_6647148893,420,-2,-65,-23,-2,0,1,1,-1,6,5,-2,2,0,2,2,4,-1,3,2,-2,-2,-38,-4,-4,8,35,0,-1,-1,1,1,-1,5,-1
KR_6758974899,420,-2,-34,3,-2,-4,5,1,2,0,2,0,1,1,1,1,2,-1,1,0,2,1,12,-1,-5,6,1,0,0,-1,1,0,1,2,-1
KR_6646786187,440,-2,10,-8,-7,-1,2,1,-1,2,1,-6,6,0,0,3,3,1,3,4,0,-4,9,-2,-3,5,1,0,0,0,1,0,1,0,-1
KR_6694695845,420,-2,-36,0,-9,-4,5,1,-3,5,2,-1,3,2,1,2,3,-2,4,2,-1,-12,-4,-1,-3,4,-1,0,1,1,1,1,-1,1,-1
KR_6764462473,420,1,-20,0,-1,1,1,2,0,3,3,-6,7,1,2,3,5,2,0,2,0,-3,10,-1,-4,5,-8,0,1,-1,0,1,-1,5,-1
KR_6745813096,420,-4,-43,-15,-13,0,1,1,-1,1,0,-8,8,0,-3,4,1,-1,2,1,-1,-13,-107,1,-5,4,-3,0,0,-1,-1,0,-1,4,-1
KR_6750555971,420,1,-6,10,-2,-8,10,2,3,0,3,1,0,1,3,2,5,-1,2,1,0,3,-7,-2,-2,4,1,0,-1,-1,-1,-1,-1,6,-1
KR_6738104447,420,-3,-37,-7,-5,5,1,6,-5,5,0,1,1,2,-3,3,0,-3,3,0,0,-13,7,-3,-3,6,4,0,1,-1,1,1,1,4,-1
KR_6727512252,420,-4,-43,-2,-11,-2,2,0,-10,11,1,-3,4,1,3,0,3,1,0,1,0,-9,0,-1,-4,5,-4,0,-1,0,-1,-1,1,0,-1
KR_5870469771,420,-3,-22,-13,-2,2,0,2,2,0,2,-4,5,1,0,2,2,-2,2,0,0,1,-13,4,-10,6,0,0,-2,1,1,-1,-1,2,-1
KR_6760245641,420,2,-46,4,9,2,1,3,5,1,6,-3,5,2,3,1,4,2,0,2,0,8,4,-4,-3,7,0,0,0,0,1,1,-1,0,-1
KR_6735773029,420,-1,-89,-14,-4,2,2,4,-5,5,0,3,0,3,-5,7,2,1,1,2,0,0,7,1,-4,3,-2,0,-1,-1,-1,-1,-1,5,-1
KR_6737624070,420,-6,-110,-9,-15,-2,2,0,-4,5,1,1,5,6,-9,11,2,-1,2,1,1,-15,-13,-9,0,9,3,0,-3,-1,-1,-1,1,3,-1
KR_6750828664,440,1,100,22,-1,1,0,1,2,2,4,-2,4,2,-2,2,0,0,1,1,0,-8,-7,0,-5,5,-1,0,0,1,1,1,1,4,-1
KR_6743093830,420,-5,-99,11,-10,-3,5,2,-2,4,2,-4,5,1,1,1,2,-2,3,1,0,-7,9,-2,-3,5,-1,0,-2,-1,-1,-1,-1,3,-1
KR_6758395317,420,0,4,-23,2,-2,4,2,2,1,3,4,1,5,-2,4,2,0,2,2,0,0,-9,-1,-3,4,0,0,-1,-1,-1,-1,-1,1,-1
KR_6723263044,420,-4,19,-47,-8,0,0,0,-4,4,0,-1,2,1,-1,1,0,-2,4,2,0,-7,32,0,-4,4,-26,0,0,-1,-1,1,1,1,-1
KR_6691966258,420,-3,-62,7,-9,-3,6,3,-6,7,1,1,2,3,0,2,2,-1,1,0,0,-4,-7,-1,-1,2,-1,0,-1,1,-1,-1,-1,2,-1
KR_6757144531,420,-5,-33,4,-9,1,1,2,2,3,5,-1,3,2,-7,9,2,-4,4,0,0,-15,4,-1,-6,7,-8,0,0,-1,-1,0,-1,5,-1
KR_6729753957,420,-3,14,-15,-5,1,1,2,-2,3,1,-1,3,2,-4,4,0,1,0,1,1,-7,2,2,-3,1,-2,0,0,-1,-1,0,1,4,-1
KR_6721535513,420,1,26,16,3,-2,4,2,-2,5,3,3,0,3,-1,1,0,5,0,5,1,2,41,0,-3,3,-13,0,1,1,-1,1,1,2,-1
KR_6722205732,420,-1,21,-20,-3,3,1,4,-4,6,2,-3,5,2,0,1,1,1,2,3,0,1,-22,3,-4,1,-1,0,0,0,-1,-1,-1,0,-1
KR_6681852180,420,0,1,-12,-2,-2,5,3,1,2,3,2,2,4,-2,3,1,-1,2,1,0,-3,139,-5,-2,7,-10,0,1,-1,1,-1,-1,4,-1
KR_6742023253,420,1,57,4,4,-1,3,2,6,1,7,1,0,1,4,1,5,-6,7,1,0,0,0,1,-2,1,3,0,1,-1,1,1,1,2,-1
KR_6661336955,420,-2,-59,-22,0,-2,4,2,0,2,2,1,1,2,0,2,2,1,3,4,1,-2,-6,-3,-3,6,-1,0,-2,-1,-1,-1,1,6,-1
KR_6696173686,420,-1,-12,4,1,-1,2,1,6,1,7,0,2,2,-2,3,1,-2,3,1,0,1,-2,3,-3,0,-4,0,0,-1,-1,0,1,3,-1
KR_6748930168,420,-1,-63,0,3,-2,2,0,5,0,5,-1,4,3,2,3,5,-1,1,0,0,10,0,0,-6,6,0,0,1,1,1,1,1,1,-1
KR_6710239836,420,-5,-17,-35,-5,0,0,0,-4,6,2,1,0,1,-2,3,1,0,0,0,0,0,0,2,-6,4,2,0,0,-1,-1,0,-1,4,-1
KR_6758843275,420,-1,-1,-4,-3,4,1,5,0,1,1,-2,5,3,-4,6,2,-1,1,0,-1,-9,-4,2,-7,5,1,0,0,-1,-1,0,-1,3,-1
KR_6758463017,440,-7,-69,-31,-16,-2,2,0,3,3,6,-10,14,4,-4,8,4,-3,4,1,0,-9,3,3,-6,3,-1,0,-1,-1,-1,-1,1,2,-1
KR_6733279151,420,-1,-69,-6,-7,0,4,4,-5,5,0,-5,9,4,5,0,5,-2,4,2,-1,-14,-251,0,-6,6,-1,0,-1,-1,-1,-1,-1,6,-1
KR_6735355148,420,1,11,1,8,-3,4,1,1,3,4,3,2,5,4,0,4,3,0,3,0,7,-5,0,-3,3,4,0,1,1,1,1,-1,4,-1
KR_6702387929,420,3,-4,12,12,-4,4,0,0,2,2,2,0,2,7,3,10,7,1,8,0,13,6,-4,-2,6,2,0,0,1,0,1,1,5,-1
KR_6762658284,420,0,-86,16,-3,-2,4,2,5,1,6,2,2,4,-7,8,1,-1,3,2,0,-2,-7,3,-4,1,-1,0,-1,0,1,-1,-1,0,-1
KR_6744161037,420,2,26,-16,-1,-1,3,2,0,2,2,-2,4,2,2,1,3,0,0,0,0,-2,8,3,-5,2,1,0,0,1,1,1,-1,1,-1
KR_6415534031,420,-6,-87,-24,-7,1,1,2,-1,1,0,2,0,2,-8,8,0,-1,1,0,0,-8,19,-3,-7,10,-5,0,0,-1,1,-1,-1,1,-1
KR_6756963425,420,-3,12,-28,-1,0,0,0,-3,3,0,-3,5,2,5,2,7,0,1,1,-1,8,-3,-3,-2,5,-1,0,2,-1,-1,1,-1,6,-1
KR_6702230043,420,-1,-51,16,-9,-4,4,0,1,2,3,0,3,3,-5,6,1,-1,1,0,0,-6,-13,1,-2,1,-1,0,0,-1,1,-1,-1,1,-1
KR_6507822695,420,-2,11,16,-2,0,2,2,-2,3,1,2,3,5,-3,6,3,1,1,2,0,-7,3,0,-5,5,1,0,0,1,1,0,-1,3,-1
KR_6520987923,420,-4,-84,-20,-5,-3,4,1,0,2,2,2,5,7,0,1,1,-4,4,0,-2,-7,0,2,-3,1,2,0,-2,-1,-1,-1,-1,3,-1
KR_6750727712,440,-1,-21,-20,-6,-1,2,1,2,0,2,-4,5,1,1,0,1,-4,6,2,0,-3,-1,-2,-1,3,2,0,0,-1,0,-1,1,6,-1
KR_6721437931,420,-3,2,-36,-11,0,0,0,0,1,1,-8,9,1,-2,2,0,-1,3,2,0,-7,-8,-2,-6,8,3,0,1,-1,-1,1,-1,6,-1
KR_6724370743,420,4,58,20,8,3,1,4,0,3,3,3,2,5,3,2,5,-1,2,1,0,4,-2,4,-7,3,-1,0,0,-1,1,1,-1,2,-1
KR_6744720325,420,4,99,8,8,0,1,1,-1,1,0,6,2,8,1,2,3,2,1,3,0,3,-4,-2,-5,7,6,0,0,1,1,1,1,4,-1
KR_6756821267,420,2,49,-24,5,4,0,4,1,2,3,-5,5,0,4,1,5,1,1,2,0,6,-12,-2,-6,8,2,0,1,0,-1,1,1,0,-1
KR_6717790291,420,-6,-94,-20,-13,-2,3,1,-5,7,2,-8,11,3,1,1,2,1,0,1,1,-6,7,0,-3,3,3,0,-1,1,-1,-1,1,6,-1
KR_6732685567,440,-4,-55,0,-9,-2,2,0,-2,3,1,1,1,2,-5,5,0,-1,2,1,0,-7,7,-1,-3,4,-6,0,-2,1,-1,-1,-1,5,-1
KR_6727807689,420,1,46,1,0,-3,9,6,2,2,4,1,2,3,2,1,3,-2,3,1,0,4,3,2,-4,2,-2,0,2,-1,0,1,1,4,-1
KR_6682324177,420,-4,-10,-47,-7,1,1,2,-1,3,2,-4,5,1,-2,7,5,-1,2,1,0,-2,-3,5,-6,1,0,0,-1,1,-1,-1,-1,5,-1
KR_6699953632,420,-2,-31,8,-9,-2,3,1,1,2,3,-4,6,2,-4,6,2,0,2,2,-2,-14,3,3,-4,1,-1,0,0,-1,-1,-1,1,2,-1
KR_6758626314,420,-2,-24,-32,1,3,1,4,-1,2,1,-6,6,0,6,0,6,-1,1,0,0,6,-373,-2,-1,3,2,0,0,1,-1,0,1,4,-1
KR_6688344469,420,-3,-28,8,-5,1,1,2,0,3,3,0,1,1,-6,6,0,0,1,1,0,-8,23,4,-10,6,-7,0,-1,1,-1,-1,1,4,-1
KR_6751171919,420,-3,-3,-16,-12,-5,5,0,0,2,2,-4,4,0,0,1,1,-3,4,1,0,-5,14,5,-7,2,-6,0,0,-1,0,0,-1,3,-1
KR_6736045577,420,0,10,-34,-2,-1,1,0,0,1,1,0,3,3,-2,3,1,1,0,1,0,0,-159,-1,-4,5,-2,0,-1,-1,-1,-1,1,4,-1
KR_6618788930,420,-4,-25,-15,-3,-1,2,1,1,2,3,-4,4,0,-3,3,0,4,0,4,1,-1,-4,0,-2,2,-2,0,-1,-1,-1,-1,1,6,-1
KR_6735100810,420,-1,-63,28,-2,-2,3,1,1,4,5,2,0,2,-3,6,3,0,0,0,0,-2,0,2,-3,1,-1,0,-1,-1,-1,-1,1,6,-1
KR_6498444390,420,0,-64,14,-7,-1,2,1,0,0,0,-3,4,1,-4,4,0,1,0,1,-1,-9,0,1,-5,4,5,0,0,1,1,0,-1,3,-1
KR_6763185021,440,-2,30,-6,-4,-1,1,0,-1,4,3,1,2,3,-4,8,4,1,0,1,-2,-9,1,1,-5,4,2,0,0,1,-1,-1,-1,6,-1
KR_6646269341,420,-2,-50,-19,-4,0,2,2,0,1,1,0,1,1,-5,8,3,1,1,2,0,-5,1,2,-3,1,-2,0,-3,-1,1,-1,1,2,-1
KR_6497029523,420,-1,-8,28,-1,3,4,7,-1,2,1,1,0,1,-2,3,1,-2,2,0,0,-4,0,-1,-7,8,-5,0,0,-1,1,1,1,2,-1
KR_6687757267,420,3,57,-8,12,-4,5,1,4,2,6,5,0,5,6,1,7,1,2,3,1,10,8,8,-11,3,-2,0,1,-1,-1,-1,1,3,-1
KR_6758950877,420,-7,-51,-38,-10,-5,7,2,-5,6,1,-3,3,0,1,0,1,2,0,2,0,-4,-14,-3,-2,5,1,0,-2,-1,-1,-1,-1,1,-1
KR_6758417767,420,-2,-32,-5,-8,-3,5,2,5,1,6,-9,11,2,1,1,2,-2,2,0,0,-4,4,1,-6,5,-2,0,-2,-1,-1,-1,-1,3,-1
KR_6754749030,420,3,18,-25,0,1,0,1,2,1,3,0,1,1,-2,4,2,-1,2,1,0,-1,2,-1,-6,7,-1,0,0,-1,0,0,-1,6,-1
KR_6729573127,420,2,-42,8,5,-1,4,3,0,2,2,4,0,4,1,2,3,1,0,1,2,15,16,1,-6,5,-3,0,0,0,-1,0,1,0,-1
KR_6757506021,420,-1,-69,-1,-7,-8,8,0,-5,5,0,0,2,2,4,2,6,2,1,3,3,-1,-31,4,-7,3,-1,0,1,-1,-1,-1,-1,5,-1
KR_6760633399,420,3,56,1,6,-3,3,0,1,3,4,2,3,5,5,1,6,1,0,1,0,9,8,2,-3,1,-1,0,1,1,0,1,-1,6,-1
KR_6592177535,420,-4,-47,-30,-7,-2,3,1,0,3,3,-1,2,1,-4,4,0,0,0,0,0,-4,120,0,-4,4,-4,0,0,-1,0,-1,-1,1,-1
KR_6654477188,420,-5,-10,8,-2,-1,1,0,-3,7,4,1,3,4,3,0,3,-2,2,0,0,-4,-16,-1,-2,3,0,0,0,-1,1,1,-1,5,-1
KR_6734581561,420,0,-42,-24,1,1,3,4,-2,4,2,2,0,2,0,1,1,0,1,1,0,3,14,-1,-5,6,2,0,1,-1,1,1,1,2,-1
KR_6738426081,440,1,-18,-8,1,-3,4,1,1,0,1,4,2,6,0,1,1,-1,3,2,0,8,-7,-8,-3,11,3,0,0,1,-1,0,-1,1,-1
KR_6712608475,420,-1,0,32,-8,2,2,4,1,3,4,-5,6,1,-6,8,2,0,0,0,0,-10,-3,-3,-3,6,-1,0,0,-1,1,1,-1,2,-1
KR_5857977056,420,-6,-108,-62,-15,0,3,3,-6,6,0,-2,2,0,-5,5,0,-2,2,0,-1,-21,-8,-1,-4,5,1,0,-2,-1,-1,-1,-1,3,-1
KR_6636557687,420,0,-82,8,5,1,1,2,0,2,2,2,1,3,4,2,6,-2,2,0,0,4,3,1,-2,1,1,0,0,1,-1,0,1,6,-1
KR_6734319792,420,-5,-77,-21,-6,-2,3,1,-4,4,0,3,1,4,-1,5,4,-2,3,1,0,-1,19,0,-5,5,-2,0,-1,1,1,-1,1,5,-1
KR_6710586084,420,1,19,4,2,1,1,2,4,2,6,0,3,3,0,2,2,-3,4,1,1,0,-3,-7,-3,10,2,0,-1,-1,1,-1,1,5,-1
KR_6725616220,420,1,-59,8,1,1,3,4,2,1,3,-4,5,1,0,0,0,2,0,2,0,7,31,2,-5,3,-6,0,-1,0,0,-1,-1,0,-1
KR_6759775950,420,0,-52,12,10,3,3,6,2,2,4,0,2,2,1,0,1,4,0,4,0,6,-32,2,-5,3,20,0,-1,1,-1,-1,1,6,-1
KR_6749291634,420,0,22,-20,6,-1,1,0,1,1,2,14,2,16,-1,3,2,-7,7,0,-1,-3,2,1,-4,3,-2,0,1,1,1,1,-1,1,-1
KR_6725363253,420,-3,-90,-12,-14,-7,8,1,2,2,4,-4,8,4,-1,3,2,-4,5,1,0,0,1,-1,-2,3,-5,0,-3,-1,-1,-1,-1,1,-1
KR_6759308558,420,1,15,0,0,4,1,5,-2,2,0,-3,3,0,2,0,2,-1,1,0,0,-1,10,-1,-4,5,-1,0,1,-1,0,1,1,6,-1
KR_6759875853,440,-3,-18,-8,-6,-3,4,1,3,2,5,-1,4,3,-3,4,1,-2,3,1,0,-3,-2,-3,-3,6,1,0,0,-1,1,0,1,1,-1
KR_6763646011,420,1,12,-32,4,-3,3,0,3,0,3,-3,3,0,4,1,5,3,0,3,0,6,16,-3,-3,6,-2,0,0,1,0,0,-1,3,-1
KR_6551066035,420,-1,-49,19,-6,0,0,0,-5,7,2,0,1,1,-1,4,3,0,0,0,-2,-11,4,3,-5,2,-2,0,0,1,1,0,-1,5,-1
KR_6749978845,420,-4,-36,-38,-9,-2,2,0,-6,10,4,-7,8,1,6,0,6,0,2,2,0,3,10,-4,-3,7,-1,0,-2,-1,-1,-1,1,1,-1
KR_6758297588,440,-2,-53,-11,-2,4,0,4,1,1,2,0,2,2,-5,6,1,-2,2,0,0,-7,-7,-2,-4,6,3,0,-1,-1,0,-1,-1,1,-1
KR_6762349676,420,-2,16,-7,-4,1,1,2,-2,2,0,-1,3,2,0,1,1,-2,2,0,0,-5,1,-3,-2,5,1,0,0,-1,1,0,-1,5,-1
KR_6622122035,420,0,13,8,1,4,0,4,1,3,4,-1,3,2,-4,5,1,1,0,1,0,-6,14,-1,-4,5,2,0,0,1,1,1,-1,3,-1
KR_6752099671,420,-4,12,-20,-7,-5,5,0,0,4,4,-1,3,2,2,3,5,-3,3,0,0,1,-1,-4,-1,5,0,0,-2,-1,-1,-1,1,5,-1
KR_6752114956,420,-1,-8,3,6,-1,1,0,5,2,7,-1,3,2,5,3,8,-2,3,1,1,11,14,-3,-4,7,2,0,1,1,1,1,1,2,-1
KR_6759247663,420,-6,-92,-15,-25,-1,4,3,-4,4,0,-7,8,1,-3,5,2,-10,11,1,0,-24,36,0,-3,3,-3,0,-1,-1,1,-1,-1,4,-1
KR_6764471962,420,3,-10,-27,6,0,2,2,4,0,4,2,2,4,-2,4,2,2,1,3,0,7,-307,3,-6,3,-2,0,0,1,-1,-1,1,3,-1
KR_6734680529,420,0,16,26,-3,2,3,5,1,2,3,-6,6,0,-1,3,2,1,0,1,0,-2,13,-1,-3,4,1,0,2,-1,1,1,1,2,-1
KR_6705188815,420,-1,-26,0,-1,-1,4,3,-4,8,4,-1,3,2,4,3,7,1,0,1,1,0,41,3,-8,5,-19,0,0,-1,-1,-1,1,1,-1
KR_6754771232,420,-2,-24,-11,-2,1,2,3,-2,4,2,-3,7,4,1,3,4,1,2,3,0,0,2,-4,-3,7,2,0,0,-1,-1,-1,1,5,-1
KR_6762080540,420,-1,-7,5,-8,-1,4,3,-1,1,0,-4,5,1,-1,3,2,-1,1,0,0,-5,19,-1,-2,3,1,0,0,-1,0,0,1,6,-1
KR_6687379923,420,0,-8,24,0,-1,3,2,4,1,5,2,3,5,-4,6,2,-1,2,1,0,-7,1,4,-6,2,-1,0,1,-1,1,-1,-1,6,-1
KR_6748622641,420,1,31,-20,-4,3,1,4,-2,3,1,-3,6,3,0,1,1,-2,2,0,0,-8,80,1,-5,4,3,0,1,1,1,1,-1,3,-1
KR_6717235092,420,-6,-30,-5,-8,2,2,4,-6,7,1,-1,4,3,-2,2,0,-1,2,1,0,-5,8,2,-8,6,-2,0,0,1,-1,-1,-1,6,-1
KR_6761120727,420,-3,50,-4,-3,2,1,3,-4,8,4,-1,2,1,2,1,3,-2,2,0,1,5,-102,-1,-2,3,1,0,-1,0,-1,-1,1,0,-1
KR_6752921484,440,1,51,0,1,0,2,2,1,1,2,2,2,4,-2,3,1,0,0,0,0,-6,-132,8,-8,0,-5,0,1,-1,1,1,1,3,-1
KR_6759844504,420,0,-51,-12,-6,-4,8,4,2,0,2,-2,4,2,-6,7,1,4,1,5,0,-4,-50,-4,-1,5,24,0,-2,0,-1,-1,-1,0,-1
KR_6752327764,420,0,48,4,-1,4,0,4,3,3,6,0,2,2,-3,4,1,-5,5,0,0,-6,6,1,-5,4,-2,0,-1,1,1,-1,1,1,-1
KR_6626981431,420,3,-45,-36,4,2,1,3,0,1,1,2,1,3,1,2,3,-1,1,0,0,8,-15,1,-7,6,-3,0,1,-1,-1,1,-1,5,-1
KR_6650808021,420,1,-44,-26,0,-2,4,2,6,0,6,-2,6,4,-2,2,0,0,0,0,0,2,-2,-4,-1,5,4,0,0,-1,0,0,-1,6,-1
KR_6758633762,420,-1,-50,-32,-4,2,0,2,0,3,3,-4,6,2,-1,3,2,-1,1,0,0,1,-1,0,-2,2,-2,0,-1,-1,0,-1,-1,5,-1
KR_6731805521,420,0,68,32,-2,3,1,4,1,0,1,-1,2,1,-4,5,1,-1,1,0,0,-6,-134,-2,-2,4,-3,0,1,0,0,1,-1,0,-1
KR_6715234666,420,3,-16,24,0,1,1,2,-3,8,5,3,0,3,-1,2,1,0,0,0,-2,-2,5,3,-9,6,-2,0,0,0,1,0,-1,0,-1
KR_6678786555,420,2,16,-22,-3,2,2,4,1,0,1,-2,5,3,-5,5,0,1,0,1,1,-7,-6,1,-8,7,-1,0,-1,1,-1,-1,1,6,-1
KR_6711726188,420,-4,13,-11,-9,0,3,3,-7,7,0,-1,1,0,-3,4,1,2,1,3,1,-11,3,-1,-5,6,6,0,0,-1,1,-1,1,5,-1
KR_6593251239,440,0,-52,32,-3,5,0,5,-5,6,1,0,4,4,-1,3,2,-2,2,0,-1,-2,-9,3,-7,4,-2,0,-1,-1,1,-1,-1,5,-1
KR_6726506852,420,-1,-23,0,6,1,2,3,3,0,3,1,1,2,-1,4,3,2,0,2,1,7,6,-2,-4,6,3,0,-1,1,-1,-1,1,3,-1
KR_6760348298,420,-1,18,0,-4,0,0,0,-3,4,1,-1,4,3,1,2,3,-1,2,1,0,-3,-1,2,-5,3,5,0,0,-1,0,0,-1,3,-1
KR_6663514540,420,0,70,28,-2,1,2,3,-1,2,1,4,2,6,-1,4,3,-5,5,0,2,9,-10,0,-5,5,-1,0,0,-1,1,0,1,2,-1
KR_6761704632,440,-2,15,22,-8,1,3,4,2,3,5,-5,8,3,-5,7,2,-1,1,0,0,1,6,0,-1,1,1,0,-1,1,-1,1,-1,6,-1
KR_6395653403,420,0,-5,-8,-2,0,0,0,3,2,5,2,3,5,-8,10,2,1,1,2,0,-4,-10,-2,-2,4,-5,0,-1,0,-1,-1,1,0,-1
KR_6703401471,420,-1,-30,-8,-7,-8,9,1,0,2,2,1,3,4,-1,3,2,1,0,1,1,4,-176,-4,-2,6,5,0,-1,1,-1,-1,1,2,-1
KR_6726353554,420,-1,-13,18,-1,0,0,0,0,4,4,2,2,4,-2,6,4,-1,2,1,2,-4,139,-4,-4,8,1,0,0,-1,1,0,1,1,-1
KR_6650778315,420,-2,-87,-34,-3,2,1,3,3,2,5,-4,4,0,-4,6,2,0,1,1,0,-5,34,1,-2,1,2,0,-2,-1,-1,-1,-1,3,-1
KR_6746773659,420,2,53,-16,-1,-2,3,1,0,2,2,1,0,1,2,1,3,-2,2,0,0,-10,-54,5,-5,0,3,0,0,-1,1,1,-1,2,-1
KR_6727483564,420,-1,-38,8,-1,-4,4,0,0,3,3,-2,5,3,4,2,6,1,1,2,-1,0,-4,-1,-2,3,-2,0,-1,-1,1,-1,-1,5,-1
KR_6700051669,420,-4,-36,-24,-13,-5,6,1,0,1,1,0,0,0,-6,6,0,-2,2,0,0,-10,-8,-5,-2,7,3,0,-2,-1,0,-1,-1,2,-1
KR_6758148874,420,-5,-103,-43,-12,-5,5,0,-4,6,2,-5,5,0,1,1,2,1,2,3,0,-1,8,0,-2,2,-2,0,-2,-1,-1,-1,-1,4,-1
KR_6750485483,420,-7,-94,-24,-16,-6,6,0,-7,8,1,1,1,2,-6,6,0,2,1,3,-1,-17,-6,-4,-4,8,2,0,-2,1,-1,-1,-1,4,-1
KR_6637916883,420,-6,-75,-12,-16,-3,4,1,-2,4,2,0,1,1,-12,12,0,1,0,1,0,-14,1,1,-4,3,-5,0,-2,-1,-1,-1,-1,4,-1
KR_6674620486,420,1,90,-9,-3,0,1,1,-2,3,1,1,5,6,-1,3,2,-1,1,0,1,-10,423,-3,-2,5,1,0,1,1,-1,1,1,1,-1
KR_6652643955,420,-3,-54,-11,-6,-2,2,0,0,5,5,-1,3,2,-2,4,2,-1,3,2,0,-4,-128,-1,-4,5,0,0,-1,1,-1,-1,1,2,-1
KR_6742502895,420,-1,-34,-4,4,-1,5,4,4,3,7,-2,5,3,1,2,3,2,1,3,0,0,1,-1,-4,5,3,0,0,-1,1,-1,-1,5,-1
KR_6673703747,420,1,7,1,2,-4,5,1,3,3,6,1,2,3,4,2,6,-2,2,0,1,-4,16,-1,-5,6,3,0,2,-1,1,1,1,4,-1
KR_6683317168,420,2,-6,36,4,-3,4,1,2,0,2,-1,3,2,6,3,9,0,2,2,0,8,-13,1,-2,1,6,0,0,-1,1,0,1,3,-1
KR_6625140589,420,-2,4,-23,-5,0,1,1,-3,5,2,1,0,1,-3,4,1,0,2,2,0,-2,1,4,-8,4,-1,0,0,-1,1,0,-1,5,-1
KR_6724435518,420,-3,-65,16,-9,-4,6,2,0,1,1,-5,6,1,0,1,1,0,0,0,0,-10,4,-5,-1,6,4,0,-1,1,0,-1,-1,5,-1
KR_6762985996,440,-1,-48,-25,-3,1,4,5,-7,10,3,0,4,4,1,4,5,2,2,4,0,0,-16,-2,-3,5,-1,0,-1,1,-1,-1,1,3,-1
KR_6749289909,420,1,-19,8,2,-1,4,3,1,6,7,0,0,0,1,2,3,1,2,3,0,5,234,0,-3,3,2,0,1,-1,1,1,1,6,-1
KR_6652744768,420,-6,-86,-29,-13,-4,4,0,-3,5,2,-1,3,2,-5,5,0,0,0,0,0,-10,-41,-2,-1,3,1,0,-3,-1,-1,-1,-1,6,-1
KR_6355412275,420,-3,-64,8,-5,1,1,2,-1,2,1,-6,6,0,1,1,2,0,0,0,0,-1,0,0,0,0,2,0,1,-1,1,1,1,2,-1
KR_6754038192,420,-1,53,-1,-9,1,3,4,-2,4,2,-6,8,2,-1,4,3,-1,1,0,0,-11,24,-1,0,1,-7,0,-1,0,-1,-1,1,0,-1
KR_6732201346,420,0,-51,12,4,1,1,2,5,1,6,-1,6,5,-2,3,1,1,1,2,0,0,5,-1,-4,5,1,0,0,0,1,0,1,0,-1
KR_5822731232,420,1,-40,32,-6,0,2,2,6,0,6,-12,13,1,0,2,2,0,1,1,0,-10,-7,-2,-1,3,1,-1,-6,-1,-1,-1,-1,2,-1
KR_6747250711,420,2,26,-4,-1,-6,6,0,1,1,2,3,4,7,2,0,2,-1,2,1,0,1,-3,-2,-4,6,2,0,1,1,-1,1,1,1,-1
KR_6672720735,420,-4,-25,-7,-6,0,1,1,-3,6,3,-1,2,1,-1,4,3,-1,2,1,1,-4,-9,-4,-2,6,-4,0,-1,0,0,-1,1,0,-1
KR_6682970165,420,-2,-25,-26,-1,0,0,0,-1,4,3,0,1,1,-2,3,1,2,1,3,0,-3,4,1,-4,3,-2,0,0,1,-1,-1,-1,6,-1
KR_6761205359,420,-2,11,-16,-1,-3,3,0,0,1,1,-2,4,2,5,0,5,-1,1,0,2,6,-81,3,-6,3,-4,0,-1,0,-1,-1,1,0,-1
KR_6696479747,420,-3,27,-17,-1,0,1,1,1,3,4,-3,6,3,1,3,4,0,0,0,-2,2,10,1,-5,4,4,0,0,-1,1,-1,-1,6,-1
KR_6726771153,440,-4,9,16,-13,2,0,2,-4,4,0,-6,8,2,-1,1,0,-4,5,1,0,-17,0,-2,-2,4,-1,0,-1,1,-1,-1,-1,5,-1
KR_6714904943,420,-5,-38,-44,-10,1,2,3,-3,4,1,-7,7,0,-2,5,3,1,0,1,0,-8,4,1,-4,3,1,0,-2,-1,-1,-1,1,3,-1
KR_6717992995,420,-5,-46,8,-5,-2,4,2,2,2,4,-2,3,1,-7,7,0,4,0,4,0,-2,-10,-5,-1,6,3,0,0,1,-1,0,1,4,-1
KR_6763648079,420,1,-18,4,-2,-1,2,1,4,0,4,2,2,4,-7,9,2,0,1,1,0,-11,-5,0,-3,3,3,0,0,-1,0,0,-1,1,-1
KR_6748088493,420,-2,-30,0,-1,-1,2,1,-4,4,0,0,1,1,3,1,4,1,0,1,0,-2,-45,4,-7,3,-5,0,0,1,1,0,1,4,-1
KR_6644678890,420,1,-18,-4,-1,-3,4,1,0,2,2,-3,3,0,2,2,4,3,0,3,0,4,19,1,-3,2,-1,0,-1,1,-1,-1,1,2,-1
KR_6718361379,420,-1,-31,-16,-4,-1,1,0,1,1,2,-1,1,0,-1,4,3,-2,2,0,0,-1,40,-2,-6,8,-14,0,0,1,1,0,-1,1,-1
KR_6731247701,420,-2,-15,0,-6,-2,3,1,-3,3,0,-3,5,2,2,2,4,0,1,1,0,0,40,0,-5,5,-15,0,-1,0,-1,-1,-1,0,-1
KR_6760076607,420,2,50,20,1,3,0,3,-6,6,0,-1,2,1,4,0,4,1,2,3,0,-5,21,2,-7,5,-5,0,1,-1,1,1,1,6,-1
KR_6496730615,440,1,44,-3,14,-1,3,2,1,4,5,2,2,4,11,1,12,1,4,5,1,20,0,3,-5,2,0,0,2,1,-1,1,1,3,-1
KR_6696503793,440,3,31,-22,2,-1,5,4,1,1,2,-3,4,1,2,3,5,3,1,4,0,1,36,-2,-4,6,-7,0,1,1,-1,1,-1,6,-1
KR_6723103026,420,-1,-18,0,-6,-1,2,1,3,2,5,-1,3,2,-4,4,0,-3,4,1,0,-8,-3,3,-6,3,-1,0,0,-1,1,-1,-1,3,-1
KR_6749724550,420,-5,-82,-12,-13,-2,3,1,-1,4,3,0,3,3,-9,9,0,-1,2,1,0,-10,2,1,-5,4,-5,0,-1,0,0,-1,1,0,-1
KR_6636479046,420,-3,-7,4,-5,-2,3,1,3,0,3,0,3,3,-7,7,0,1,1,2,0,-4,10,6,-7,1,-2,0,0,-1,1,1,1,4,-1
KR_6760350164,420,1,-23,8,2,7,0,7,0,5,5,-3,4,1,0,6,6,-2,2,0,1,6,101,3,-4,1,-1,0,2,-1,1,1,1,5,-1
KR_6740837286,420,2,-51,21,3,-1,3,2,2,1,3,-2,3,1,2,4,6,2,0,2,0,2,-7,-2,0,2,3,0,0,-1,1,0,1,6,-1
KR_6742259906,420,1,0,16,5,6,0,6,3,1,4,-3,6,3,1,0,1,-2,2,0,0,-2,-82,4,-8,4,-4,0,1,-1,1,1,-1,1,-1
KR_6675521144,420,-5,-50,-46,-9,-6,6,0,0,0,0,-10,12,2,3,1,4,4,0,4,-1,5,-5,0,-4,4,-1,0,-1,1,-1,-1,-1,1,-1
KR_6705103788,420,-8,-78,13,-15,-3,5,2,1,1,2,-5,5,0,-6,6,0,-2,4,2,0,-7,1,-4,-2,6,-2,0,0,-1,1,-1,-1,2,-1
KR_6752706206,420,-1,-90,20,-1,1,1,2,3,0,3,-3,3,0,-1,1,0,-1,1,0,0,-3,25,0,-5,5,1,0,0,0,0,-1,1,0,-1
KR_6346729542,420,2,52,35,-2,-5,5,0,1,3,4,0,1,1,1,1,2,1,1,2,-1,1,-19,-3,-4,7,6,0,0,-1,0,0,1,3,-1
KR_6735093155,420,-1,-48,-16,0,-1,3,2,0,6,6,-1,2,1,0,2,2,2,2,4,0,8,-1,-3,-3,6,3,0,1,1,0,1,1,6,-1
KR_6762158661,420,-1,3,1,3,5,0,5,-5,6,1,2,2,4,1,0,1,0,1,1,0,4,13,-4,-2,6,-1,0,-1,-1,-1,-1,1,1,-1
KR_6757617942,420,-3,-82,-30,-6,1,3,4,-2,3,1,-1,3,2,-2,2,0,-2,3,1,0,-11,-8,0,-5,5,0,0,-2,-1,-1,-1,-1,6,-1
KR_6755129304,420,-2,32,32,-13,0,0,0,-7,8,1,-2,4,2,0,1,1,-4,4,0,0,-16,-6,0,-3,3,-3,0,0,0,1,0,-1,0,-1
KR_6572110013,420,-1,68,-8,-2,4,1,5,-1,3,2,-1,1,0,-4,4,0,0,0,0,0,-7,4,-5,-2,7,5,0,0,-1,0,1,1,5,-1
KR_6693247050,420,-3,-13,7,-6,0,0,0,0,2,2,-1,4,3,0,3,3,-5,5,0,0,-6,11,-1,-2,3,-1,0,0,1,1,-1,-1,5,-1
KR_6728162065,420,2,-2,-28,1,1,0,1,3,2,5,0,2,2,-3,4,1,0,0,0,0,0,1,2,-6,4,4,0,1,1,1,1,1,6,-1
KR_6598345726,420,2,64,4,4,-3,3,0,2,2,4,0,2,2,0,2,2,5,0,5,0,6,-3,-4,-1,5,5,0,0,1,-1,0,1,2,-1
KR_6697344281,420,-2,-40,-34,8,1,4,5,-2,3,1,9,2,11,-1,4,3,1,0,1,0,7,-52,-4,-3,7,17,0,0,0,1,1,1,0,-1
KR_6675659621,420,2,-62,-11,5,5,0,5,1,1,2,-6,7,1,3,3,6,2,1,3,1,12,-2,3,-5,2,-3,0,1,-1,0,1,1,2,-1
KR_6741903813,440,1,-23,16,2,-1,3,2,-7,8,1,5,0,5,1,1,2,4,0,4,0,3,-12,1,-4,3,3,0,-1,1,-1,-1,-1,6,-1
KR_6600385117,420,-2,-30,-8,-2,2,1,3,2,1,3,4,2,6,-7,10,3,-3,5,2,1,-1,4,-1,-4,5,-2,0,-1,1,-1,-1,1,1,-1
KR_6754830706,420,-3,-13,-4,-1,-2,3,1,0,2,2,3,2,5,-2,4,2,0,2,2,0,3,10,10,-10,0,-1,0,0,-1,1,0,1,2,-1
KR_6690243033,420,1,23,12,-2,2,1,3,-5,8,3,7,1,8,-7,8,1,1,1,2,0,-1,6,0,-2,2,-2,0,-1,1,-1,-1,-1,4,-1
KR_6760700555,440,-3,-42,-19,-10,-3,4,1,-4,7,3,-3,3,0,0,5,5,0,0,0,-1,-10,-203,-4,-2,6,-23,0,1,-1,1,-1,-1,1,-1
KR_6716156594,420,-6,-52,-22,-18,0,4,4,-9,10,1,-5,5,0,-1,2,1,-3,3,0,-2,-26,3,1,-3,2,-1,0,-1,1,1,-1,-1,2,-1
KR_6596280314,420,-3,-7,4,-3,-2,3,1,0,3,3,-3,4,1,1,3,4,1,0,1,0,-4,3,2,-5,3,-5,0,0,-1,-1,0,1,6,-1
KR_6728442620,420,-5,-18,-43,-1,-4,6,2,-1,2,1,-1,4,3,3,1,4,2,0,2,0,4,-6,5,-8,3,1,0,-2,0,0,-1,-1,0,-1
KR_6762353530,420,3,15,-1,3,10,1,11,0,1,1,-1,2,1,-6,7,1,0,1,1,0,-8,-18,1,-4,3,6,0,0,-1,1,1,-1,1,-1
KR_6751092491,420,-6,-65,-39,-9,-3,4,1,-3,5,2,-4,6,2,1,2,3,0,2,2,0,-5,-10,-7,0,7,3,0,-1,-1,0,-1,1,1,-1
KR_6731448526,420,-1,-38,20,-9,-4,5,1,-3,4,1,-1,1,0,-1,2,1,0,1,1,0,-5,43,6,-7,1,-12,0,0,1,-1,0,-1,2,-1
KR_6724395335,420,-4,-93,5,-13,-1,1,0,-2,3,1,-4,4,0,-4,4,0,-2,2,0,0,-13,11,-5,-1,6,2,0,-2,0,-1,-1,1,0,-1
KR_6712683240,420,1,22,-12,0,2,0,2,-6,7,1,-2,6,4,6,0,6,0,2,2,0,-5,-2,-4,-3,7,2,0,0,-1,1,-1,-1,2,-1
KR_6753904882,420,3,18,52,1,0,1,1,-1,4,3,2,1,3,0,3,3,0,1,1,-1,-4,18,-3,-2,5,2,0,1,1,1,1,-1,1,-1
KR_6619805936,420,1,-16,42,-2,-3,3,0,0,1,1,2,2,4,-2,7,5,1,1,2,0,-1,10,0,-7,7,-1,0,-1,0,-1,-1,1,0,-1
KR_6751462337,420,-4,-74,33,-8,-1,3,2,-6,7,1,1,0,1,2,1,3,-4,6,2,0,-11,-1,-3,-3,6,0,0,-1,1,0,-1,-1,6,-1
KR_6731689929,420,-1,-32,4,-6,-2,2,0,3,1,4,-5,5,0,-1,2,1,-1,1,0,0,-4,-23,-2,-4,6,-2,0,0,-1,1,0,1,2,-1
KR_6756933293,420,-3,19,16,-3,-2,3,1,5,0,5,0,1,1,-3,3,0,-3,3,0,1,4,21,1,-4,3,3,0,0,-1,1,0,1,2,-1
KR_6763489427,440,-3,-63,-28,-2,0,1,1,-2,2,0,1,0,1,-2,3,1,1,1,2,0,1,1,-1,-1,2,-3,0,0,-1,-1,0,-1,1,-1
KR_6748534493,420,-7,-63,-16,-5,-1,3,2,-4,4,0,-1,1,0,3,1,4,-2,2,0,0,-7,-5,-5,-2,7,1,0,-2,-1,-1,-1,1,1,-1
KR_6763415645,420,-3,-42,-3,-3,-3,3,0,-2,4,2,3,0,3,0,1,1,-1,4,3,0,-1,-13,-3,-3,6,2,0,-3,-1,1,-1,1,6,-1
KR_6662491316,440,2,67,17,3,4,1,5,-2,6,4,0,3,3,2,1,3,-1,1,0,0,7,-1,-1,-5,6,4,0,1,1,-1,1,-1,6,-1
KR_6620121470,420,2,2,-11,-1,-1,1,0,0,2,2,2,3,5,-2,3,1,0,1,1,0,-2,3,1,-2,1,0,0,0,-1,1,0,1,1,-1
KR_6756553927,420,2,10,4,4,4,2,6,3,0,3,-5,7,2,-2,11,9,4,0,4,1,-2,6,-3,-5,8,-3,0,1,0,1,1,1,0,-1
KR_6685756260,420,-2,-23,18,-4,-2,2,0,1,0,1,-6,6,0,3,0,3,0,1,1,0,-1,42,-1,-3,4,-31,0,0,1,-1,0,1,2,-1
KR_6750341776,420,-2,-54,-12,-4,-1,3,2,-5,7,2,5,1,6,-5,8,3,2,2,4,-3,-11,-2,0,-4,4,-2,0,-1,-1,-1,1,-1,3,-1
KR_6749871603,420,-2,-32,-16,8,2,1,3,-1,4,3,5,1,6,3,0,3,-1,1,0,1,6,-45,2,-3,1,11,0,0,-1,1,-1,1,5,-1
KR_6751921424,420,-1,-82,-8,-3,-5,5,0,2,1,3,3,1,4,3,0,3,-6,6,0,0,6,-2,-4,-2,6,3,0,0,-1,-1,-1,-1,2,-1
KR_6731781726,420,0,-120,-8,1,-2,3,1,-6,8,2,5,4,9,2,2,4,2,1,3,-1,10,-37,4,-5,1,13,0,-3,1,-1,-1,-1,6,-1
KR_6749586123,420,-2,-43,5,-12,0,4,4,-4,7,3,-4,5,1,-3,3,0,-1,2,1,0,-10,0,1,-5,4,-1,0,-2,-1,-1,-1,1,1,-1
KR_6633397337,420,0,2,-4,2,2,0,2,4,1,5,-3,3,0,-3,3,0,2,2,4,0,3,-2,1,-3,2,-2,0,1,-1,1,1,-1,5,-1
KR_6671949286,420,0,40,-21,1,3,2,5,2,1,3,-2,3,1,0,5,5,-2,4,2,0,3,8,1,-3,2,3,0,1,-1,-1,1,1,5,-1
KR_6750868521,420,-2,-43,-37,0,0,1,1,0,1,1,-3,3,0,3,1,4,0,1,1,0,-1,-2,-4,-1,5,2,0,0,1,-1,-1,1,1,-1
KR_6649209521,420,-2,-53,-13,-8,1,1,2,-5,7,2,-1,4,3,-2,4,2,-1,1,0,0,-6,4,2,-8,6,-3,0,0,-1,0,0,-1,4,-1
KR_6553315657,420,-1,-44,31,-3,0,0,0,-2,2,0,-2,3,1,0,3,3,1,0,1,0,-2,5,7,-9,2,-5,0,-2,-1,1,-1,-1,6,-1
KR_6761332944,420,-2,-40,-48,2,-2,4,2,0,2,2,0,3,3,-3,6,3,7,0,7,3,12,11,3,-4,1,0,0,1,1,-1,1,1,6,-1
KR_6696476253,440,-2,-20,-12,0,-2,3,1,-1,2,1,1,0,1,2,2,4,0,1,1,0,6,-9,-3,-1,4,3,0,0,-1,-1,-1,-1,5,-1
KR_6741999276,420,3,-47,25,8,-4,4,0,0,1,1,7,0,7,2,3,5,3,0,3,0,9,-4,-5,-1,6,3,0,0,1,-1,-1,-1,2,-1
KR_6746889600,420,-2,-21,35,-7,1,2,3,-1,4,3,-2,2,0,-4,5,1,-1,2,1,0,-15,-2,-4,-1,5,0,0,0,1,-1,-1,-1,1,-1
KR_6710139320,420,-3,13,-7,-10,4,0,4,0,1,1,-11,12,1,-1,6,5,-2,2,0,0,-12,-4,-5,-2,7,1,0,0,-1,1,0,-1,3,-1
KR_6759000269,420,4,14,11,7,0,3,3,4,0,4,0,2,2,1,2,3,2,0,2,0,6,488,1,-4,3,-1,0,1,1,1,1,1,6,-1
KR_6480404721,420,-2,7,3,-10,-3,3,0,-8,8,0,3,3,6,0,2,2,-2,3,1,0,-7,18,-2,-2,4,-18,0,-2,-1,-1,-1,1,2,-1
KR_6758348367,420,-1,-5,-16,0,-3,3,0,-2,2,0,-3,3,0,7,0,7,1,1,2,0,3,-1,1,-6,5,0,0,0,1,-1,-1,-1,5,-1
KR_6694467977,440,-5,-66,-37,-7,-5,6,1,2,2,4,1,1,2,-6,7,1,1,1,2,0,-4,3,0,-2,2,-1,0,0,-1,-1,0,-1,4,-1
KR_6762975216,420,-1,3,-27,-4,-3,4,1,0,1,1,-1,2,1,0,0,0,0,0,0,0,-3,4,2,-3,1,0,0,-1,0,0,-1,-1,0,-1
KR_6762140920,420,-3,-20,14,0,11,0,11,-6,9,3,-5,5,0,0,4,4,0,1,1,0,-6,2,0,-4,4,0,0,-1,-1,1,1,-1,6,-1
KR_6760230204,420,0,23,4,5,2,3,5,-1,2,1,1,2,3,0,2,2,3,0,3,1,4,272,0,-4,4,-3,0,1,-1,1,1,1,4,-1
KR_6715280550,420,0,-21,11,-2,-1,2,1,-4,4,0,1,1,2,1,4,5,1,2,3,-1,-4,103,-3,-3,6,5,0,0,-1,-1,0,-1,1,-1
KR_6762031129,420,-2,7,-36,-8,-6,7,1,0,3,3,-1,1,0,-2,3,1,1,0,1,0,-10,-2,1,-7,6,0,0,1,1,1,1,-1,3,-1
KR_6745903370,420,-2,-82,13,-7,-2,3,1,-2,3,1,-2,3,1,0,2,2,-1,1,0,0,-7,-9,0,-6,6,3,0,-1,-1,-1,-1,1,6,-1
KR_6747171563,420,2,11,18,5,-3,6,3,4,1,5,1,0,1,1,1,2,2,0,2,2,10,23,-7,-2,9,0,0,0,0,1,0,1,0,-1
KR_6729362584,420,0,-18,4,-4,2,0,2,-5,6,1,1,1,2,0,6,6,-2,2,0,-1,-8,1,-5,-1,6,2,0,-1,-1,-1,-1,1,4,-1
KR_6751150478,420,-3,-40,1,-14,-5,5,0,-3,3,0,0,3,3,-3,4,1,-3,3,0,-4,-18,-11,-3,-1,4,2,0,-2,-1,-1,-1,-1,1,-1
KR_6740585864,420,2,28,22,1,1,2,3,2,3,5,-1,2,1,-4,6,2,3,0,3,0,-1,9,-1,-4,5,-5,0,1,-1,0,1,1,5,-1
KR_6724958760,420,-1,-31,-24,1,2,4,6,3,1,4,0,1,1,-3,3,0,-1,1,0,0,-2,-3,-1,-2,3,0,0,0,-1,1,-1,-1,5,-1
KR_6761013070,420,-3,-56,-12,-1,-2,2,0,0,2,2,-3,4,1,4,1,5,0,0,0,0,9,13,2,-7,5,-2,0,0,-1,1,0,-1,4,-1
KR_6646495657,420,-4,-12,-14,-2,-2,3,1,0,3,3,-1,5,4,-5,6,1,6,1,7,0,2,-6,2,-6,4,-3,0,-1,0,1,-1,1,0,-1
KR_6723072999,420,-7,-65,-19,-10,-3,5,2,-5,6,1,2,2,4,-3,5,2,-1,2,1,0,-11,-29,-1,-4,5,-1,0,-3,-1,-1,-1,-1,1,-1
KR_6736243733,420,3,59,4,4,0,1,1,0,6,6,2,1,3,2,2,4,0,0,0,0,5,4,0,-3,3,2,0,0,1,-1,0,-1,3,-1
KR_6749032236,420,-1,-17,3,-2,-2,3,1,-2,2,0,-2,4,2,-1,1,0,5,0,5,0,-1,7,-2,-1,3,3,0,-1,1,1,-1,-1,5,-1
KR_6684770110,420,-1,15,-23,1,3,2,5,0,0,0,-1,4,3,-1,7,6,0,1,1,0,-3,162,0,-1,1,-1,0,0,-1,-1,-1,-1,5,-1
KR_6761787336,440,1,62,16,0,4,2,6,3,0,3,-7,8,1,1,1,2,-1,1,0,0,-5,-31,0,-3,3,3,0,1,0,-1,1,-1,0,-1
KR_6586120011,420,0,24,32,-1,-2,5,3,0,2,2,3,0,3,-3,5,2,1,0,1,3,1,6,1,-5,4,1,0,0,1,1,0,1,4,-1
KR_6648179256,420,0,27,4,-2,4,1,5,-2,3,1,1,0,1,-3,7,4,-2,2,0,0,-4,4,2,-6,4,4,0,-1,-1,-1,-1,1,2,-1
KR_6603855560,420,-3,-56,2,-3,-2,3,1,3,1,4,-4,5,1,-1,4,3,1,0,1,0,-1,4,0,-3,3,3,0,0,1,-1,0,-1,3,-1
KR_6721812353,420,-3,-90,-5,-6,1,4,5,1,2,3,2,0,2,-9,9,0,-1,2,1,-1,2,-4,1,-6,5,1,0,-2,1,-1,-1,-1,3,-1
KR_6696886146,420,-8,-96,-36,-15,-2,3,1,-3,4,1,-2,3,1,-5,6,1,-3,3,0,0,-12,-17,-3,-3,6,-3,0,-2,-1,-1,-1,-1,5,-1
KR_6631237561,420,-3,1,-44,-8,1,1,2,-5,6,1,0,1,1,-2,5,3,-2,3,1,-2,-14,-14,0,-4,4,-3,0,-1,-1,-1,-1,-1,2,-1
KR_6745605023,420,-5,-33,-17,-7,0,0,0,-4,4,0,3,2,5,-3,7,4,-3,3,0,0,-7,1,2,-5,3,-1,0,0,0,0,-1,-1,0,-1
KR_6757771475,420,-3,-15,-20,-1,1,0,1,2,2,4,-4,5,1,0,3,3,0,2,2,0,-3,0,0,-5,5,-3,0,-1,-1,0,-1,1,6,-1
KR_6756470668,420,-1,-30,0,2,0,1,1,3,0,3,-3,5,2,2,3,5,0,0,0,0,-1,0,0,-4,4,-7,0,-1,0,-1,-1,1,0,-1
KR_6743233342,420,-5,-143,-24,-10,-5,6,1,-2,3,1,-1,3,2,-2,3,1,0,1,1,-1,-3,-2,5,-7,2,0,0,-2,1,-1,-1,-1,2,-1
KR_6550948132,420,-1,6,-25,-6,2,0,2,-3,4,1,-7,7,0,1,2,3,1,0,1,0,-10,-3,-2,-2,4,1,0,-1,-1,-1,-1,-1,2,-1
KR_6729764603,420,-7,-85,-4,-13,-7,7,0,-4,6,2,1,3,4,-1,3,2,-2,2,0,0,-12,3,1,-5,4,-2,0,-1,-1,-1,-1,-1,5,-1
KR_6746298456,420,-5,-52,-2,-13,-4,5,1,2,1,3,-1,2,1,-6,8,2,-4,4,0,0,-11,3,1,-6,5,1,0,-2,1,-1,-1,-1,5,-1
KR_6763391455,440,-1,-12,20,-1,1,1,2,5,2,7,3,1,4,-10,11,1,0,1,1,0,0,-1,4,-5,1,-2,0,-2,1,0,-1,1,1,-1
KR_6552083044,420,1,69,10,-1,0,1,1,-1,3,2,-1,2,1,4,0,4,-3,3,0,1,3,-10,-3,-4,7,4,0,-2,-1,-1,-1,1,6,-1
KR_6754912914,420,1,29,4,2,4,0,4,3,2,5,-4,5,1,-1,1,0,0,2,2,0,4,27,0,-4,4,-5,0,0,-1,1,1,1,3,-1
KR_6761828820,420,-1,41,4,-5,-1,3,2,0,2,2,-5,5,0,-1,2,1,2,0,2,0,-5,-17,-1,-4,5,-1,0,-1,1,0,-1,1,3,-1
KR_6741813951,420,-2,-43,5,-5,-1,3,2,-2,3,1,2,0,2,-4,7,3,0,1,1,1,-11,-2,1,-3,2,-2,0,-1,-1,1,-1,1,5,-1
KR_6761291189,420,0,-120,3,-2,-2,3,1,1,1,2,1,1,2,-1,2,1,-1,1,0,0,3,-1,-3,-3,6,1,0,-2,1,1,-1,-1,3,-1
KR_6675489049,440,0,83,12,-3,2,2,4,0,2,2,0,4,4,-3,5,2,-2,2,0,1,-5,3,-1,-5,6,-2,0,1,1,1,1,1,1,-1
KR_6684751603,420,1,74,17,3,6,2,8,4,0,4,-2,2,0,-5,6,1,0,1,1,0,-2,2,1,-6,5,-2,0,0,-1,1,1,1,5,-1
KR_6734234685,440,3,-39,16,5,-1,2,1,2,0,2,1,1,2,5,0,5,-2,3,1,0,4,-1,-1,-3,4,-1,0,-1,-1,0,-1,1,5,-1
KR_6762695247,420,-5,-129,-11,-12,-4,6,2,-1,2,1,0,2,2,-8,9,1,1,0,1,0,-1,2,-1,-3,4,-4,0,-3,-1,1,-1,-1,5,-1
KR_6741018689,420,-2,37,-24,-10,-3,3,0,-6,6,0,0,0,0,-1,3,2,0,1,1,0,-16,-6,-4,-1,5,0,0,0,-1,1,0,-1,3,-1
KR_6626528072,420,-10,-137,-21,-24,-5,6,1,-9,10,1,-2,3,1,-3,3,0,-5,6,1,0,-16,4,3,-4,1,-4,0,-4,-1,-1,-1,-1,6,-1
KR_6761211312,420,-1,-7,3,-4,2,2,4,-1,2,1,-4,4,0,-3,4,1,2,1,3,0,-8,-392,4,-7,3,-1,0,1,-1,1,1,-1,2,-1
KR_6754137387,420,-4,-76,0,-13,-1,2,1,-8,12,4,-1,4,3,-3,3,0,0,0,0,0,-19,-14,0,-4,4,0,0,-1,0,0,-1,1,0,-1
KR_6735379605,420,3,-44,5,3,-2,4,2,3,1,4,3,1,4,1,1,2,-2,2,0,0,4,-4,-1,-6,7,0,0,0,1,-1,0,1,6,-1
KR_6754752439,420,1,-1,-17,-3,-2,3,1,-2,4,2,0,0,0,2,5,7,-1,1,0,1,-2,-2,4,-5,1,-2,0,-1,1,0,-1,1,3,-1
KR_6762615444,420,-3,-42,-37,-2,-5,6,1,0,0,0,3,3,6,-1,5,4,1,1,2,0,8,269,-4,-1,5,2,0,-1,-1,1,-1,-1,5,-1
KR_6762658933,420,-4,-22,-21,-1,-3,4,1,0,3,3,1,1,2,1,0,1,0,1,1,0,1,5,-2,-1,3,2,0,0,-1,1,0,1,4,-1
KR_6615620526,440,-2,-76,-4,1,3,0,3,-1,1,0,0,3,3,0,2,2,-1,1,0,0,-1,14,1,-4,3,-4,0,0,1,0,0,1,6,-1
KR_6734710833,420,-2,53,25,-2,-4,5,1,1,3,4,1,1,2,-1,1,0,1,0,1,0,2,4,1,-5,4,-6,0,-1,1,0,-1,-1,2,-1
KR_6760279856,420,-6,-37,-30,-12,0,1,1,-2,3,1,-3,6,3,-9,10,1,2,0,2,0,-8,307,-1,-1,2,-3,0,-1,1,-1,-1,-1,6,-1
KR_6655156429,420,1,-13,-10,10,-2,2,0,4,2,6,0,5,5,6,1,7,2,0,2,0,15,-5,3,-6,3,5,0,-2,1,-1,-1,1,3,-1
KR_6699984140,420,0,-4,12,-3,-2,2,0,1,2,3,0,3,3,-2,5,3,0,0,0,0,-2,0,-5,0,5,-1,0,1,-1,1,1,-1,5,-1
KR_6759183011,420,-3,-79,-4,1,-3,3,0,0,3,3,5,1,6,-1,3,2,0,1,1,0,2,18,2,-5,3,-1,0,-2,0,-1,-1,1,0,-1
KR_6724283336,420,-4,-11,-16,-14,-5,6,1,-5,5,0,1,0,1,-4,4,0,-1,2,1,0,-12,18,1,-5,4,-4,0,-1,1,-1,-1,-1,5,-1
KR_6761625641,420,-1,10,-4,0,5,0,5,-5,7,2,0,1,1,0,0,0,0,0,0,0,-1,-5,1,-5,4,2,0,-1,1,-1,-1,1,3,-1
KR_6696856816,420,1,22,13,0,0,3,3,3,1,4,3,1,4,-3,4,1,-3,3,0,0,-6,378,-4,-4,8,-4,0,-1,1,-1,-1,1,3,-1
KR_6717005592,440,-3,-76,-16,-7,-3,6,3,-1,2,1,1,3,4,-3,3,0,-1,1,0,0,-3,-1,1,-2,1,-3,0,-2,1,-1,-1,-1,2,-1
KR_6764668235,420,-3,-41,15,-7,3,1,4,-3,6,3,0,2,2,-7,8,1,0,0,0,0,-9,38,-3,-4,7,-8,0,0,1,1,-1,-1,5,-1
KR_6762018395,420,-3,-105,-8,-5,-1,2,1,-1,2,1,-1,3,2,0,2,2,-2,2,0,0,-5,-5,-1,-5,6,2,0,0,-1,1,0,-1,6,-1
KR_6759363347,420,0,-76,12,-3,-2,2,0,4,3,7,-3,4,1,-2,2,0,0,0,0,0,2,292,0,-8,8,1,0,-1,0,1,-1,1,0,-1
KR_6633639357,420,-1,-54,12,-3,-1,2,1,0,4,4,-3,5,2,3,1,4,-2,2,0,0,4,-5,-4,-3,7,-2,0,-1,-1,-1,-1,-1,6,-1
KR_6743796984,440,-3,13,-1,-11,-3,5,2,-3,4,1,2,4,6,-4,4,0,-3,4,1,-1,-15,2,0,-2,2,0,0,0,0,-1,-1,-1,0,-1
KR_6677630164,420,-1,43,-8,-1,-1,1,0,-1,1,0,4,2,6,0,1,1,-3,5,2,0,-4,-2,0,-2,2,5,0,0,-1,1,1,1,4,-1
KR_6764042345,420,-2,-32,1,-6,-7,8,1,3,1,4,-6,6,0,3,2,5,1,0,1,-1,6,-7,0,-3,3,3,0,0,0,0,-1,1,0,-1
KR_6636749865,420,-2,-30,30,-11,0,1,1,-2,5,3,-2,3,1,-4,6,2,-3,4,1,0,-11,15,4,-10,6,-6,0,-1,-1,-1,-1,-1,5,-1
KR_6724354444,420,-5,-54,-2,-13,-2,2,0,-1,1,0,-6,10,4,-2,4,2,-2,7,5,0,-15,-22,-1,-3,4,5,0,-1,0,-1,-1,1,0,-1
KR_6746804031,420,-1,-26,-19,-2,3,0,3,3,1,4,-10,10,0,2,1,3,0,2,2,1,0,174,3,-5,2,-1,0,-1,-1,-1,-1,1,6,-1
KR_6763547398,420,-2,16,8,-3,1,2,3,0,4,4,-5,5,0,2,3,5,-1,4,3,1,-3,-16,-1,-2,3,0,0,0,1,-1,1,1,4,-1
KR_6755585645,420,-3,-50,5,1,-3,5,2,2,0,2,-1,4,3,3,1,4,0,0,0,0,11,-10,-4,0,4,-1,0,-1,-1,0,-1,-1,3,-1
KR_6759944433,440,-4,-20,-18,-1,-2,2,0,-6,6,0,1,5,6,2,3,5,4,2,6,-1,4,45,-1,-5,6,-21,0,0,-1,-1,1,-1,4,-1
KR_6750124381,420,-2,0,-51,-2,0,1,1,-1,2,1,-1,1,0,0,3,3,0,0,0,0,-6,-11,2,-4,2,4,0,0,-1,-1,0,1,1,-1
KR_6726595011,420,-4,-66,1,-14,-7,7,0,0,2,2,-3,3,0,-4,6,2,0,1,1,0,-2,-343,6,-8,2,-20,0,-2,-1,-1,-1,-1,2,-1
KR_6723430838,440,-6,-43,-4,-10,-1,3,2,0,3,3,-4,5,1,-1,6,5,-4,4,0,0,-4,-8,-9,-1,10,-2,0,-1,1,0,-1,1,4,-1
KR_6724809822,420,-1,-49,-7,-3,-3,4,1,1,2,3,1,2,3,-2,2,0,0,0,0,-1,-3,9,2,-5,3,-2,0,-1,1,-1,-1,-1,1,-1
KR_6751928522,420,0,7,8,-6,-3,3,0,0,3,3,0,6,6,-1,6,5,-2,3,1,0,-4,1,-2,-3,5,-3,0,1,0,1,1,-1,0,-1
KR_6754501167,420,0,15,2,4,0,0,0,-1,1,0,4,1,5,0,4,4,1,0,1,0,4,-9,-3,-2,5,1,0,1,1,-1,1,1,6,-1
KR_6760859004,420,1,-12,-12,0,-2,4,2,1,1,2,-5,6,1,5,0,5,1,0,1,-1,6,2,4,-7,3,3,0,1,1,-1,1,-1,4,-1
KR_6762455585,420,2,64,7,2,2,1,3,-2,7,5,3,2,5,3,1,4,-4,4,0,0,-4,12,2,-5,3,-2,0,0,1,-1,0,-1,6,-1
KR_6748750727,420,-2,-49,8,2,0,2,2,-3,3,0,-1,2,1,5,0,5,1,1,2,0,2,-7,-5,0,5,0,0,0,1,-1,-1,-1,4,-1
KR_6685420371,420,2,14,20,5,-1,2,1,3,1,4,-1,3,2,3,3,6,1,0,1,0,4,-3,-1,-2,3,-2,0,2,-1,0,1,1,4,-1
KR_6759565030,420,-6,-89,-20,-5,-3,5,2,-1,2,1,0,1,1,-1,2,1,0,1,1,0,-3,10,0,-2,2,-2,0,-1,-1,-1,-1,1,3,-1
KR_6763454786,420,-3,-57,-3,-7,-1,1,0,2,2,4,-3,3,0,-4,4,0,-1,2,1,0,-3,23,1,-4,3,2,0,0,1,0,0,1,3,-1
KR_6757063109,420,-2,-44,15,-7,0,2,2,-7,9,2,-1,6,5,-1,3,2,2,0,2,0,2,270,0,-5,5,1,0,-1,-1,-1,-1,1,3,-1
KR_6742444454,420,-3,-39,-7,-5,-1,2,1,-3,4,1,3,1,4,-3,5,2,-1,2,1,-1,0,-12,1,-4,3,0,0,-1,1,-1,-1,-1,6,-1
KR_6627075921,420,-1,-11,-3,-2,-1,2,1,-3,5,2,3,0,3,-1,2,1,0,1,1,0,-3,-44,2,-7,5,5,0,-1,1,0,-1,-1,3,-1
KR_6752487510,420,-6,-67,-24,-9,-1,1,0,0,3,3,-4,4,0,-3,4,1,-1,1,0,0,0,-13,1,-5,4,-4,0,0,-1,0,0,-1,4,-1
KR_6716341236,420,2,-26,-2,7,2,0,2,2,2,4,4,2,6,-3,4,1,2,0,2,0,3,-6,-2,-2,4,-8,0,1,-1,1,1,1,4,-1
KR_6638068649,420,-3,-81,-24,-2,-4,4,0,0,0,0,3,2,5,0,1,1,-1,1,0,1,0,3,0,-3,3,0,0,-1,1,-1,-1,1,5,-1
KR_6741039647,420,0,23,-8,-3,-1,3,2,-3,5,2,-3,5,2,1,4,5,3,0,3,0,-1,6,-1,-2,3,-5,0,-1,-1,-1,-1,1,4,-1
KR_6737404003,420,-4,-54,13,-10,0,2,2,0,3,3,-6,8,2,-5,6,1,1,0,1,-1,-5,40,-4,-2,6,-36,0,0,-1,1,-1,-1,2,-1
KR_6747984425,420,-6,-95,-8,-11,-5,5,0,-3,3,0,-3,3,0,2,3,5,-2,2,0,0,-7,-11,-9,-2,11,-4,0,-2,1,-1,-1,1,3,-1
KR_6754285341,420,0,-56,-8,1,-2,6,4,-2,2,0,-1,1,0,5,2,7,1,0,1,0,5,33,3,-4,1,-11,0,-2,1,-1,-1,-1,2,-1
KR_6661773959,420,-3,22,-21,-9,-1,2,1,-3,5,2,0,2,2,-2,6,4,-3,3,0,-1,-17,-3,1,-4,3,-4,0,-1,1,1,-1,-1,6,-1
KR_6741203501,420,3,47,-9,4,0,3,3,4,0,4,0,5,5,0,5,5,0,0,0,1,9,3,1,-3,2,0,0,0,-1,-1,0,1,3,-1
KR_6752510217,420,2,22,8,2,1,1,2,-1,2,1,3,2,5,-2,3,1,1,1,2,0,2,-25,3,-5,2,5,0,0,0,-1,0,-1,0,-1
KR_6750379209,420,-3,-18,-44,-4,-2,5,3,4,0,4,-1,3,2,-6,7,1,1,0,1,0,4,-14,-3,-1,4,1,0,-1,1,-1,-1,-1,2,-1
KR_6720115220,420,4,40,12,0,0,2,2,2,2,4,0,0,0,-5,6,1,3,3,6,0,-3,1,-1,-2,3,0,0,1,-1,1,-1,-1,2,-1
KR_6762287367,420,0,10,-20,6,3,2,5,-3,4,1,-1,3,2,7,1,8,0,2,2,0,1,5,3,-6,3,-5,0,1,0,-1,1,-1,0,-1
KR_6318522881,440,-2,-2,1,1,-6,6,0,5,1,6,-2,4,2,3,2,5,1,1,2,1,2,2,0,-6,6,-2,0,-2,-1,-1,-1,1,1,-1
KR_6760731818,420,-1,6,-8,-7,3,0,3,-5,6,1,0,4,4,-6,7,1,1,0,1,0,-10,-3,-2,-2,4,-2,0,1,-1,1,1,1,3,-1
KR_6673876576,420,-8,-114,-33,-14,-5,5,0,-4,8,4,-2,4,2,0,2,2,-3,3,0,0,-12,-15,5,-8,3,0,0,-3,-1,-1,-1,-1,1,-1
KR_6757836278,420,-2,-90,-8,-5,-3,4,1,-1,4,3,-2,3,1,2,3,5,-1,1,0,0,-10,28,-7,-4,11,-4,0,0,-1,-1,-1,-1,5,-1
KR_6761393093,420,0,80,9,-3,0,0,0,-3,4,1,5,1,6,-1,2,1,-4,5,1,0,1,-14,0,-1,1,-1,0,0,-1,-1,1,1,4,-1
KR_6731196364,420,0,-14,-4,-2,-2,4,2,3,1,4,-4,4,0,0,1,1,1,0,1,0,3,11,1,-4,3,-6,0,1,1,1,1,-1,4,-1
KR_6744550730,420,-1,-64,17,-7,-1,1,0,0,2,2,-2,3,1,-6,7,1,2,0,2,0,-12,16,-4,-1,5,-5,0,0,1,0,0,1,5,-1
KR_6680040734,420,-6,-133,-4,-12,-2,4,2,-2,4,2,-4,4,0,0,2,2,-4,4,0,0,-9,-5,0,-9,9,-1,0,-1,0,1,-1,-1,0,-1
KR_6731364690,420,-8,-68,-52,-10,-6,6,0,-1,2,1,4,2,6,-2,3,1,-5,5,0,0,-1,-467,1,-3,2,2,0,-1,-1,1,-1,1,3,-1
KR_6759020825,420,0,-1,-5,-2,-1,1,0,0,2,2,2,2,4,-3,5,2,0,3,3,0,-3,-1,-2,-5,7,-4,0,-1,-1,1,-1,1,2,-1
KR_6753414777,420,-4,-59,-28,-20,-4,7,3,-4,4,0,-2,2,0,-10,10,0,0,2,2,-1,-11,2,0,-1,1,-5,0,-1,1,1,-1,-1,4,-1
KR_6633926324,420,-2,10,-36,1,0,3,3,-5,5,0,6,0,6,3,0,3,-3,3,0,-1,-8,-41,3,-4,1,21,0,-1,1,-1,-1,-1,1,-1
KR_6757669700,420,-1,-36,8,-5,1,1,2,-2,2,0,-1,3,2,-2,2,0,-1,1,0,-1,-7,2,-3,-4,7,1,0,-1,1,1,-1,-1,1,-1
KR_6735837819,420,-5,-123,-16,-8,-1,1,0,0,2,2,-4,4,0,-3,4,1,0,1,1,-1,-8,-14,-4,-2,6,-3,0,0,-1,-1,-1,-1,1,-1
KR_6716368995,420,-1,-2,-12,-1,2,0,2,-3,5,2,-3,6,3,0,3,3,3,1,4,0,5,-11,0,-7,7,-1,0,0,-1,-1,-1,1,1,-1
KR_6760516687,420,-5,-87,4,-1,-3,3,0,-1,1,0,2,1,3,-2,3,1,3,0,3,0,-1,-3,3,-6,3,-2,0,0,-1,0,-1,-1,6,-1
KR_6689403399,440,0,36,0,-7,-1,4,3,-2,4,2,-2,2,0,0,3,3,-2,3,1,-1,-9,-56,1,-4,3,-23,0,1,-1,1,1,-1,5,-1
KR_6742824403,420,-1,-25,-24,0,-2,4,2,-1,3,2,1,0,1,1,0,1,1,0,1,-1,3,44,4,-4,0,1,0,0,0,-1,0,-1,0,-1
KR_6717303745,420,4,10,32,8,6,1,7,0,2,2,5,0,5,-4,7,3,1,0,1,0,4,214,2,-2,0,1,0,0,1,-1,-1,1,4,-1
KR_6678351508,440,-3,-24,-12,-3,-2,2,0,-1,2,1,0,1,1,0,5,5,0,1,1,0,-4,-3,-6,0,6,3,0,0,1,-1,-1,-1,1,-1
KR_6763200032,420,1,-59,-4,4,1,3,4,1,0,1,3,1,4,-1,2,1,0,0,0,0,4,9,-2,-5,7,-5,0,0,-1,1,0,1,6,-1
KR_6695390694,420,3,35,-11,6,3,2,5,0,3,3,4,1,5,-1,4,3,0,2,2,-1,-3,46,5,-7,2,-26,0,1,0,1,1,1,0,-1
KR_6628862288,420,1,-34,20,3,4,1,5,1,1,2,-1,1,0,0,0,0,-1,1,0,0,0,0,6,-6,0,2,0,0,1,1,0,1,1,-1
KR_6608036965,420,-1,3,0,-6,-3,3,0,-9,12,3,7,1,8,2,2,4,-3,3,0,0,1,9,0,-5,5,-1,0,0,-1,-1,0,-1,1,-1
KR_6758910296,420,0,-24,40,-2,0,1,1,-7,8,1,2,4,6,-1,4,3,4,0,4,1,-4,2,-1,-2,3,-6,0,0,1,1,0,1,2,-1
KR_6715284155,420,-5,-53,15,-4,7,1,8,-2,4,2,-7,7,0,-2,6,4,0,0,0,0,4,-8,0,-5,5,0,0,0,1,1,1,-1,3,-1
KR_6762116671,420,0,-59,3,-4,3,0,3,0,1,1,-2,2,0,-3,5,2,-2,2,0,0,-3,1,3,-6,3,-2,0,-1,-1,-1,-1,1,6,-1
KR_6761580552,420,-2,10,-8,-10,1,3,4,-8,8,0,-1,3,2,-2,3,1,0,1,1,-1,-19,1,1,-2,1,-1,0,1,-1,1,1,-1,3,-1
KR_6752732157,440,-3,-48,-20,-11,1,4,5,2,3,5,-5,5,0,-10,10,0,1,0,1,0,-16,-250,-2,-3,5,-1,0,-2,1,-1,-1,-1,1,-1
KR_6628779758,420,-5,-23,-13,-10,-1,2,1,-7,8,1,-1,6,5,-1,2,1,0,1,1,0,-15,-1,-1,-3,4,0,0,0,1,-1,-1,1,1,-1
KR_6716663864,420,-3,0,-16,-13,-1,5,4,-2,5,3,-4,4,0,-6,10,4,0,0,0,0,-13,42,1,-2,1,-19,0,-2,-1,-1,-1,1,1,-1
KR_6762512088,420,-5,1,-6,-8,0,3,3,0,1,1,-4,4,0,-1,5,4,-3,3,0,0,-9,12,1,-4,3,0,0,0,-1,0,1,1,4,-1
KR_6313987353,420,-2,-57,-8,-4,-4,5,1,2,1,3,0,2,2,-1,3,2,-1,2,1,0,-1,47,6,-9,3,-27,0,-1,1,0,-1,1,6,-1
KR_6715019120,420,-1,9,-20,0,2,1,3,-3,4,1,0,1,1,0,1,1,1,0,1,1,0,-20,-5,-2,7,5,0,0,-1,-1,-1,1,1,-1
KR_6649476955,420,-1,-22,14,8,3,0,3,-3,4,1,3,0,3,3,0,3,2,1,3,0,6,0,-1,-2,3,-3,0,0,1,1,0,1,2,-1
KR_6759080244,420,2,-4,15,-3,3,0,3,2,1,3,-4,5,1,3,2,5,-7,7,0,0,-1,-4,1,-2,1,-1,0,0,-1,1,0,-1,4,-1
KR_6764084189,420,-6,27,-1,-7,0,2,2,0,4,4,-1,4,3,-2,3,1,-4,6,2,0,-8,-10,3,-9,6,0,0,0,1,-1,0,-1,6,-1
KR_6756597016,420,2,-35,28,5,-1,1,0,0,2,2,1,2,3,4,0,4,1,0,1,0,7,6,-1,-2,3,1,0,-1,-1,-1,-1,-1,1,-1
KR_6758865174,420,-1,-28,-4,-9,2,2,4,-6,8,2,0,2,2,-4,4,0,-1,2,1,-1,-14,-2,-4,-1,5,-3,0,-1,-1,-1,-1,-1,5,-1
KR_6667458031,440,-3,-101,-51,-1,1,2,3,1,0,1,-2,2,0,-1,6,5,0,2,2,0,-2,-10,0,-2,2,-2,0,-2,-1,0,-1,-1,5,-1
KR_6697300220,420,-1,-17,-16,-5,-3,4,1,2,1,3,-1,1,0,-3,6,3,0,0,0,1,2,-8,4,-7,3,-5,0,-1,-1,-1,-1,1,4,-1
KR_6694394704,420,1,92,-1,3,3,0,3,-3,6,3,0,1,1,0,2,2,3,1,4,0,1,0,0,-5,5,-2,0,-1,-1,-1,-1,1,4,-1
KR_6595043559,420,0,41,11,3,2,3,5,-1,3,2,0,3,3,3,2,5,-1,2,1,0,7,9,0,-4,4,1,0,1,-1,-1,1,-1,6,-1
KR_6741890768,420,0,-67,0,1,2,1,3,-7,8,1,2,2,4,-2,2,0,6,2,8,0,-4,-4,-3,-2,5,1,0,0,-1,1,-1,-1,4,-1
KR_6742489830,420,-3,-82,-4,-11,0,1,1,-6,8,2,-2,5,3,-3,4,1,0,1,1,1,-10,-4,-2,-1,3,-1,0,-3,0,-1,-1,1,0,-1
KR_6743203633,420,-1,-21,-16,2,-2,3,1,1,2,3,3,0,3,-3,7,4,3,0,3,-2,-1,-71,-1,-2,3,-1,0,0,-1,0,0,-1,2,-1
KR_6497207077,420,0,-13,9,1,-2,4,2,-2,5,3,1,1,2,4,1,5,0,0,0,-1,0,-8,-6,-3,9,5,0,-1,1,0,1,-1,6,-1
KR_6719096608,420,-3,-78,-39,-4,-2,3,1,-8,8,0,2,1,3,-1,3,2,5,1,6,-1,0,-1,1,-6,5,2,0,-1,-1,-1,-1,-1,5,-1
KR_6754950835,420,-6,16,-25,-9,-1,2,1,-8,8,0,-3,4,1,2,1,3,1,1,2,0,-4,-6,-1,-4,5,-4,0,0,1,-1,-1,1,4,-1
KR_6749486110,440,-3,-28,-18,-7,2,2,4,1,1,2,-4,7,3,-3,6,3,-3,4,1,0,-1,0,2,-6,4,1,0,0,-1,-1,-1,1,4,-1
KR_6756845421,420,0,-15,-4,-7,-1,3,2,4,1,5,-3,3,0,-5,5,0,-2,2,0,0,-10,-124,-3,-2,5,1,0,1,1,-1,1,-1,5,-1
KR_6757401362,420,1,42,-16,-8,0,1,1,-2,4,2,-3,5,2,-2,7,5,-1,3,2,0,-9,-14,2,-5,3,-4,0,0,-1,-1,0,-1,6,-1
KR_6752602478,420,-6,-41,17,-15,-3,4,1,-3,5,2,-2,4,2,-9,12,3,2,1,3,0,-13,5,-1,-5,6,-2,0,-2,-1,-1,-1,-1,3,-1
KR_6710557583,420,-5,-19,-30,-12,-6,7,1,-4,5,1,-5,6,1,-1,3,2,4,1,5,0,-5,-1,3,-4,1,-1,0,-2,-1,-1,-1,1,1,-1
KR_6706373239,420,1,-32,4,5,-3,3,0,1,2,3,0,1,1,6,1,7,1,0,1,0,11,8,7,-7,0,-1,0,-1,1,-1,-1,-1,5,-1
KR_6760004294,420,-2,-64,9,-8,-2,2,0,-4,4,0,-2,2,0,-2,2,0,2,0,2,0,-12,11,-3,-3,6,-2,-1,-5,1,-1,-1,1,5,-1
KR_6715232451,420,0,46,-16,-1,4,1,5,-4,5,1,0,3,3,0,1,1,-1,3,2,1,-11,7,1,-4,3,2,0,-2,-1,-1,-1,-1,1,-1
KR_6744652487,420,-5,-64,4,-10,-2,2,0,2,0,2,-7,8,1,-3,3,0,0,0,0,0,-12,-1,0,-5,5,-2,0,-1,-1,1,-1,-1,4,-1
KR_6759547064,420,-1,-53,12,-5,0,0,0,2,0,2,-3,3,0,-3,5,2,-1,2,1,-2,-5,34,2,-5,3,-2,0,-1,-1,-1,-1,-1,2,-1
KR_6684004665,440,-6,-62,0,-9,-2,3,1,-3,3,0,-2,3,1,-1,3,2,-1,1,0,0,-11,2,1,-5,4,0,0,-2,0,0,-1,-1,0,-1
KR_6558167803,440,4,38,8,7,0,3,3,11,0,11,4,2,6,-3,7,4,-5,6,1,0,-6,3,0,-2,2,-2,0,1,-1,1,1,1,2,-1
KR_6758183926,420,-1,-46,6,2,0,1,1,0,1,1,6,2,8,-3,3,0,-1,3,2,0,2,10,0,-2,2,3,0,0,-1,1,-1,-1,2,-1
KR_6755073028,420,-2,-2,-12,-7,0,0,0,1,1,2,-4,5,1,-3,3,0,-1,2,1,0,-6,-5,2,-6,4,-1,0,-1,1,-1,-1,1,3,-1
KR_6739319215,420,2,27,31,1,3,0,3,2,1,3,1,1,2,-3,3,0,-2,3,1,0,-4,1,4,-6,2,-1,0,0,-1,1,0,-1,6,-1
KR_6759708159,420,0,-56,2,0,0,2,2,-7,9,2,6,3,9,2,1,3,-1,1,0,2,4,-47,-2,-3,5,21,0,0,-1,1,-1,1,4,-1
KR_6722030585,420,2,5,10,3,2,1,3,-4,5,1,5,0,5,0,1,1,0,1,1,0,-7,-237,1,-4,3,0,0,1,1,1,1,1,2,-1
KR_6690844062,420,-2,64,-28,1,2,3,5,3,0,3,3,2,5,-7,9,2,0,0,0,-1,0,-9,-2,-4,6,3,0,-2,-1,-1,-1,-1,6,-1
KR_6743121308,420,-3,-81,-19,2,-2,2,0,3,3,6,-2,2,0,2,2,4,1,1,2,0,8,-6,-1,-3,4,-1,0,-3,0,-1,-1,1,0,-1
KR_6763131246,420,3,51,29,0,3,0,3,1,1,2,3,1,4,-7,7,0,0,0,0,0,-10,20,-3,-4,7,-4,0,1,-1,1,1,1,5,-1
KR_6731560729,420,-1,-19,-21,1,-2,6,4,-1,3,2,-4,5,1,4,5,9,4,0,4,0,6,10,5,-8,3,0,0,-2,-1,-1,-1,-1,1,-1
KR_6733630445,420,-1,-16,-20,-6,1,1,2,-2,4,2,-2,2,0,0,3,3,-3,3,0,0,-16,-30,-3,-4,7,12,0,0,-1,-1,0,1,5,-1
KR_6759407863,420,-4,-56,22,-10,-2,3,1,1,2,3,3,0,3,-5,6,1,-7,7,0,0,-8,20,1,-6,5,-2,0,0,-1,1,0,-1,2,-1
KR_6655426191,420,-5,-37,4,-4,1,1,2,1,3,4,-3,4,1,-1,1,0,-2,3,1,0,-3,-7,0,-6,6,-5,0,-3,-1,-1,-1,1,6,-1
KR_6742089765,440,-2,-9,8,-4,-6,7,1,0,3,3,3,1,4,-1,2,1,0,0,0,-1,3,-2,2,-6,4,1,0,0,1,-1,0,-1,5,-1
KR_6764731811,420,-5,10,-80,-3,1,3,4,0,1,1,1,3,4,-4,5,1,-1,1,0,0,-5,1,3,-5,2,-6,0,-1,-1,-1,-1,-1,3,-1
KR_6743885315,420,-2,-67,-12,-1,-6,7,1,2,2,4,2,0,2,0,1,1,1,0,1,0,9,-7,-2,-1,3,3,0,-1,-1,-1,-1,-1,6,-1
KR_6764614678,420,-4,-67,4,-7,-3,4,1,-2,5,3,-4,4,0,1,3,4,1,0,1,-1,-2,5,1,-4,3,-5,0,-1,1,0,-1,-1,6,-1
KR_6764008765,420,1,41,-20,0,0,1,1,1,2,3,0,3,3,-1,2,1,0,0,0,0,-2,-4,-3,-3,6,4,0,0,0,1,0,-1,0,-1
KR_6707031824,440,-5,59,-20,-12,-2,2,0,-10,10,0,-1,1,0,1,3,4,0,0,0,0,-12,-13,0,0,0,1,0,-2,-1,-1,-1,-1,3,-1
KR_6714746935,420,-1,-17,-7,-5,0,2,2,-1,1,0,-3,4,1,-2,2,0,1,0,1,0,-15,0,2,-5,3,-3,0,0,-1,1,1,-1,2,-1
KR_6758171186,420,-2,-66,-11,0,1,2,3,0,5,5,2,1,3,-2,4,2,-1,1,0,0,0,22,1,-2,1,-4,0,-1,-1,0,-1,1,5,-1
KR_6738012817,420,0,89,-32,7,-2,3,1,3,3,6,0,1,1,5,0,5,1,0,1,0,8,-4,-2,-3,5,7,0,-1,-1,-1,-1,1,2,-1
KR_6754147469,420,2,74,16,-2,0,3,3,-3,3,0,0,5,5,4,0,4,-3,3,0,1,-2,335,-7,0,7,1,0,0,1,1,0,1,4,-1
KR_6759245108,420,2,13,-5,3,0,2,2,-1,5,4,4,1,5,2,0,2,-2,3,1,0,4,4,-2,-4,6,2,0,0,0,-1,0,1,0,-1
KR_6744872369,420,-8,-55,-4,-11,-4,4,0,1,0,1,-2,2,0,-6,7,1,0,1,1,1,-10,11,8,-10,2,-1,0,-1,1,1,-1,1,1,-1
KR_6749222295,420,-1,-17,0,-2,4,0,4,1,3,4,-5,5,0,-2,3,1,0,0,0,0,2,0,1,-4,3,-3,0,-1,-1,1,-1,1,4,-1
KR_6632811918,420,-6,-56,-23,-5,0,2,2,0,1,1,-5,5,0,0,2,2,0,2,2,0,-2,-38,2,-9,7,24,0,-2,-1,-1,-1,1,2,-1
KR_6678954902,420,2,-5,-20,1,-1,2,1,2,2,4,1,3,4,0,2,2,-1,1,0,0,2,25,1,-6,5,-4,0,-1,-1,-1,-1,-1,5,-1
KR_6737686306,420,-3,-66,-16,2,-2,2,0,0,1,1,8,2,10,-3,4,1,-1,2,1,0,-5,1,4,-6,2,-3,0,0,0,-1,0,1,0,-1
KR_6747718494,420,-4,15,-9,-6,0,2,2,-4,4,0,0,3,3,-1,1,0,-1,2,1,0,-5,-12,2,-5,3,4,0,-1,1,1,-1,1,2,-1
KR_6762078161,420,-5,-30,-32,-15,1,1,2,0,2,2,-13,14,1,-1,2,1,-2,2,0,0,-10,-29,-5,-1,6,-2,0,-1,-1,1,-1,-1,2,-1
KR_6594907125,420,-4,-55,-20,-12,0,2,2,-2,4,2,0,1,1,-1,3,2,-9,9,0,0,-9,-123,0,-3,3,-16,0,-3,-1,-1,-1,-1,5,-1
KR_6750733927,420,-1,-57,24,-2,-2,2,0,3,3,6,4,1,5,-6,6,0,-1,1,0,0,-3,-5,1,-6,5,1,0,-2,1,-1,-1,-1,5,-1
KR_6763939385,440,-3,-1,0,-3,-1,1,0,-2,3,1,4,2,6,-2,4,2,-2,4,2,0,-3,-42,3,-5,2,-1,0,0,1,-1,0,-1,5,-1
KR_6734658533,420,-3,-55,-4,-8,1,1,2,-4,7,3,0,3,3,-5,5,0,0,0,0,0,-5,8,1,-6,5,-1,0,-2,-1,0,-1,-1,6,-1
KR_6716271580,440,-1,-52,-3,2,-3,3,0,0,4,4,3,1,4,2,0,2,0,2,2,0,4,-27,4,-4,0,13,0,1,-1,1,1,-1,5,-1
KR_6717204266,420,-7,-92,-7,-20,2,3,5,-5,5,0,-4,8,4,-11,12,1,-2,3,1,0,-26,1,2,-6,4,-3,0,-2,-1,-1,-1,-1,5,-1
KR_6551462636,420,-5,-2,-13,-12,1,3,4,-2,4,2,-9,10,1,-3,3,0,1,0,1,0,-14,-2,-1,-4,5,-4,0,-2,-1,-1,-1,1,2,-1
KR_6740327880,420,-2,5,-41,1,0,0,0,0,2,2,-4,4,0,3,1,4,2,0,2,3,11,-4,-4,-2,6,5,0,-1,1,0,-1,1,4,-1
KR_6751109577,440,-6,-72,-20,-12,-2,3,1,0,2,2,-3,6,3,-7,10,3,0,0,0,0,-10,42,3,-7,4,-29,0,0,-1,1,-1,1,4,-1
KR_6719358690,420,-1,-39,-1,2,5,0,5,1,2,3,-7,7,0,-2,3,1,5,0,5,0,0,1,5,-6,1,0,0,1,1,1,1,1,3,-1
KR_6737590057,420,-7,-132,-13,-1,3,1,4,3,2,5,1,2,3,-8,8,0,0,2,2,-1,-10,190,-1,-1,2,-1,0,-3,-1,-1,-1,-1,2,-1
KR_6750125889,420,-4,-13,0,-7,-1,4,3,2,0,2,-6,8,2,-3,4,1,1,1,2,0,-3,-13,-1,-3,4,0,0,-1,-1,1,-1,-1,3,-1
KR_6644492535,420,0,-49,-38,2,2,1,3,3,2,5,-2,5,3,3,0,3,-4,6,2,0,-3,-5,2,-4,2,2,0,1,-1,1,1,1,3,-1
KR_6749040576,440,1,-72,-24,5,0,1,1,1,0,1,3,1,4,1,1,2,0,2,2,0,3,0,2,-7,5,-4,0,-1,-1,0,-1,1,3,-1
KR_6719118717,420,4,41,-16,3,4,0,4,-2,3,1,-5,5,0,4,1,5,2,0,2,0,2,8,2,-5,3,3,0,-1,1,-1,-1,-1,6,-1
KR_6753178384,420,-5,-72,-44,-6,-5,7,2,-1,1,0,0,1,1,-1,3,2,1,0,1,0,3,-6,3,-5,2,0,0,-1,-1,-1,-1,-1,4,-1
KR_6628122947,420,-2,31,-11,-5,-3,3,0,0,2,2,-2,3,1,2,2,4,-2,3,1,2,3,8,1,-5,4,-2,0,0,-1,1,1,1,4,-1
KR_6715914004,420,-4,-66,0,-8,-5,7,2,0,1,1,5,0,5,-6,6,0,-2,2,0,1,-2,42,-5,-2,7,-2,0,-4,-1,-1,-1,1,5,-1
KR_6764010895,420,-1,63,36,-5,1,0,1,1,1,2,-1,4,3,-8,11,3,2,1,3,0,-6,3,0,-5,5,0,0,0,0,1,1,-1,0,-1
KR_6682346151,420,-1,28,-16,0,3,1,4,1,1,2,-5,5,0,1,2,3,0,5,5,0,-7,15,0,0,0,0,0,1,-1,1,1,-1,1,-1
KR_6754955374,420,-8,-23,-36,-18,0,2,2,-8,8,0,-5,6,1,-4,4,0,-1,1,0,-1,-24,-2,-4,0,4,1,0,-2,-1,-1,-1,-1,2,-1
KR_6644434107,420,-3,-19,-11,-10,-5,6,1,0,6,6,-1,1,0,-4,7,3,0,2,2,0,-5,-6,-1,-2,3,3,0,-1,-1,0,-1,-1,5,-1
KR_6705486379,420,-1,-47,12,-8,1,2,3,-7,9,2,1,1,2,-2,3,1,-1,1,0,0,-4,-8,0,-5,5,-2,0,0,1,1,-1,-1,2,-1
KR_6682613010,420,-1,-61,-4,0,0,2,2,-2,3,1,2,1,3,1,2,3,-1,1,0,0,6,237,-2,-1,3,2,0,0,1,-1,0,1,4,-1
KR_6756914331,420,1,32,-8,-3,2,1,3,-2,3,1,0,2,2,-4,6,2,1,0,1,0,-10,1,3,-4,1,-3,0,1,0,1,1,1,0,-1
KR_6758485657,420,0,-84,-24,-4,3,0,3,-4,5,1,-1,3,2,-6,7,1,4,0,4,0,-4,-5,2,-4,2,-2,0,-1,-1,1,1,-1,5,-1
KR_6756739436,420,1,-9,28,-15,-3,3,0,-7,8,1,3,1,4,-6,7,1,-2,2,0,-2,-13,-5,-6,-1,7,-1,0,1,-1,1,1,-1,6,-1
KR_6759446726,420,-2,-72,-17,-1,-1,1,0,-5,6,1,-1,2,1,1,0,1,5,0,5,0,5,-127,-1,-3,4,2,0,-1,0,-1,-1,1,0,-1
KR_6763080197,420,-4,-93,-12,-13,-1,2,1,-3,3,0,-8,8,0,-2,5,3,1,4,5,-2,-12,-5,-2,-2,4,-3,0,-2,-1,-1,-1,-1,1,-1
KR_6669921193,420,-3,-60,1,-2,-3,3,0,-1,6,5,1,1,2,-1,5,4,2,1,3,0,3,11,-1,-4,5,0,0,1,1,1,1,-1,3,-1
KR_6655314241,420,-2,-18,-3,-7,2,0,2,-1,1,0,3,1,4,-2,2,0,-9,9,0,0,-22,-25,-5,-2,7,3,0,-2,-1,1,-1,1,6,-1
KR_6567135384,420,-1,-26,-4,-2,-2,2,0,0,2,2,2,0,2,1,0,1,-3,3,0,0,1,2,-1,-4,5,6,0,0,0,-1,0,1,0,-1
KR_6705571191,420,-5,-50,-35,-9,-3,4,1,0,3,3,-2,7,5,-4,5,1,0,1,1,-1,-3,-7,1,-4,3,6,0,0,-1,-1,0,-1,6,-1
KR_6762271695,420,0,-43,-12,0,4,1,5,0,2,2,0,2,2,-5,7,2,1,1,2,1,-3,-1,0,-6,6,2,0,0,-1,0,1,1,1,-1
KR_6753967712,420,-4,-31,-20,-2,1,1,2,0,1,1,-2,4,2,-1,4,3,0,1,1,0,5,-5,-1,-6,7,2,0,1,0,1,1,1,0,-1
KR_6636527932,420,-1,-56,-7,-4,-1,4,3,2,1,3,-1,3,2,-3,6,3,-1,1,0,-1,-3,5,1,-2,1,0,0,0,-1,1,1,-1,5,-1
KR_6695421920,420,-2,3,-15,-10,2,1,3,-3,4,1,-2,5,3,-4,6,2,-3,5,2,-1,-7,274,-1,-2,3,1,0,-1,-1,-1,-1,-1,1,-1
KR_6745933642,420,-2,-9,20,0,-2,2,0,3,1,4,-4,5,1,0,2,2,3,2,5,0,0,1,1,-2,1,-4,0,0,1,1,0,1,1,-1
KR_6650725415,420,1,71,-8,-1,2,2,4,0,2,2,0,1,1,-5,9,4,2,1,3,-1,-6,14,0,-2,2,2,0,-2,-1,-1,1,-1,5,-1
KR_6748095819,420,-1,-72,-37,-1,2,0,2,1,0,1,1,0,1,-2,4,2,-3,3,0,0,0,-2,-4,-2,6,-1,0,0,-1,-1,-1,-1,2,-1
KR_6763235822,420,-5,-14,4,-8,-5,6,1,0,2,2,-6,6,0,-1,3,2,4,2,6,0,-7,0,2,-5,3,1,0,-1,-1,-1,-1,-1,1,-1
KR_6530649641,420,1,29,40,-6,-2,3,1,-6,7,1,0,2,2,-1,2,1,3,1,4,-1,-7,-15,-4,-1,5,1,0,0,-1,1,1,-1,3,-1
KR_6678794913,420,-4,-55,4,-5,2,0,2,0,1,1,-3,6,3,-3,4,1,-1,1,0,0,-3,-2,-5,-3,8,-2,0,0,-1,1,-1,-1,1,-1
KR_6458427861,420,-2,34,-29,-5,2,3,5,3,2,5,-1,3,2,-6,7,1,-3,4,1,-1,-7,2,2,-6,4,-1,0,0,1,-1,-1,-1,1,-1
KR_6672924691,420,-10,-129,-68,-14,-8,8,0,0,2,2,-2,5,3,-4,5,1,0,2,2,0,2,-14,-2,-1,3,-1,-1,-6,-1,0,-1,-1,3,-1
KR_6730818684,420,-2,-8,9,-8,1,1,2,-1,3,2,0,1,1,-9,9,0,1,0,1,-1,-13,-11,-1,-3,4,0,0,-2,-1,1,-1,-1,2,-1
KR_6698048014,420,-1,29,-3,-1,-5,7,2,3,1,4,-1,1,0,1,3,4,1,1,2,1,5,-6,-1,-3,4,1,0,0,1,-1,-1,1,1,-1
KR_6728310848,420,-6,-74,-43,-7,-3,4,1,0,3,3,-6,6,0,2,3,5,0,1,1,1,6,-7,-4,0,4,0,0,-2,-1,0,-1,1,4,-1
KR_6762545679,420,6,1,24,14,2,0,2,0,1,1,3,0,3,10,1,11,-1,1,0,2,19,3,-1,-5,6,-2,0,1,1,-1,1,1,2,-1
KR_6500297655,420,2,-52,20,4,0,2,2,1,2,3,0,3,3,1,2,3,2,0,2,0,5,-6,-3,-1,4,-1,0,-2,-1,-1,-1,-1,3,-1
KR_6755696472,420,-2,-9,-18,-2,2,1,3,0,1,1,2,0,2,-4,6,2,-2,2,0,0,-5,-9,-5,-3,8,2,0,0,-1,-1,0,-1,5,-1
KR_6684963139,420,1,-21,20,-3,0,5,5,-1,6,5,-2,2,0,-1,2,1,1,2,3,0,0,1,-2,-5,7,-5,0,-1,1,0,-1,-1,2,-1
KR_6762293152,420,-1,-72,-12,1,0,2,2,0,6,6,1,0,1,0,1,1,0,0,0,0,3,-17,0,-6,6,4,0,-1,0,-1,-1,-1,0,-1
KR_6705033903,420,-1,-41,8,-4,-7,7,0,5,2,7,1,1,2,0,1,1,-3,4,1,0,4,3,0,-4,4,-3,0,1,-1,1,1,-1,2,-1
KR_6757361734,420,-8,-36,-64,-2,-1,2,1,0,1,1,0,2,2,0,2,2,-1,2,1,1,6,7,0,-2,2,-2,0,-3,-1,-1,1,1,2,-1
KR_6761671154,420,-4,14,7,-8,1,2,3,-1,1,0,-6,6,0,-4,7,3,2,1,3,0,-10,-3,-4,-1,5,1,0,2,-1,1,1,1,4,-1
KR_6752762617,420,-3,51,24,-3,4,0,4,-3,4,1,0,2,2,-7,7,0,3,0,3,0,-3,8,7,-9,2,-4,0,-2,-1,1,-1,1,1,-1
KR_6756491702,420,-3,-39,-20,-4,-3,4,1,2,1,3,-4,5,1,4,0,4,-3,4,1,0,-2,-3,-2,-2,4,3,0,-1,-1,0,-1,1,3,-1
KR_6760401321,420,1,-8,-4,5,1,2,3,1,3,4,-1,3,2,2,3,5,2,0,2,0,15,7,0,-4,4,4,0,0,-1,1,0,1,3,-1
KR_6702924780,420,-5,-77,31,-15,-3,4,1,-4,5,1,-6,6,0,-5,6,1,3,0,3,-1,-17,4,1,-6,5,-3,0,-1,-1,1,-1,-1,3,-1
KR_6698935423,420,-3,4,22,-5,1,1,2,2,1,3,-3,4,1,-1,4,3,-4,4,0,0,-1,4,-5,-2,7,-4,0,0,-1,1,-1,1,5,-1
KR_6726298498,420,-3,-26,16,-9,-7,9,2,1,3,4,-1,2,1,-4,5,1,2,3,5,0,-6,-10,-3,-1,4,4,0,1,-1,-1,1,1,1,-1
KR_6739960673,420,-2,-24,-4,-5,-5,6,1,-4,5,1,-1,1,0,4,0,4,1,0,1,0,-3,-3,-4,-1,5,-2,0,-1,-1,-1,-1,1,3,-1
KR_6760706043,420,-5,-44,-7,-1,1,3,4,-1,1,0,-4,5,1,1,2,3,2,0,2,0,1,0,-2,-3,5,-3,0,0,1,0,0,1,3,-1
KR_6762501062,420,-2,30,-12,-9,-3,3,0,-2,2,0,-2,3,1,-1,2,1,-1,2,1,-1,-11,1,4,-5,1,0,0,0,-1,-1,0,-1,1,-1
KR_6762226711,420,-1,-3,-16,-7,4,1,5,-1,2,1,-7,8,1,0,3,3,-3,3,0,0,-1,-39,-2,0,2,15,0,-1,-1,0,-1,-1,6,-1
KR_6759060649,420,-2,-48,-23,2,-7,8,1,3,4,7,6,2,8,1,2,3,-1,1,0,0,0,1,2,-4,2,2,0,-2,1,-1,-1,-1,1,-1
KR_6648627396,420,-4,-1,-13,-12,-4,4,0,-2,4,2,-5,5,0,-1,1,0,0,1,1,0,-9,-3,0,-2,2,3,0,-1,1,-1,-1,-1,6,-1
KR_6764749685,440,2,13,29,2,2,1,3,0,0,0,-3,5,2,3,2,5,0,0,0,0,3,8,-3,-3,6,5,0,0,0,-1,-1,1,0,-1
KR_6569346351,420,-1,-82,-14,-4,1,3,4,1,2,3,-1,3,2,-3,5,2,-2,2,0,-1,-7,2,0,-4,4,-6,0,-1,-1,-1,-1,-1,2,-1
KR_6764332011,440,-2,-66,-33,-11,-1,3,2,3,1,4,0,3,3,-11,12,1,-2,4,2,-2,-6,5,-2,-2,4,-3,0,0,-1,-1,-1,-1,5,-1
KR_6693329096,420,-1,-58,-24,5,-1,1,0,5,0,5,0,2,2,1,2,3,0,0,0,0,1,-12,2,-6,4,-1,0,1,0,1,1,1,0,-1
KR_6734336912,420,2,80,21,1,-5,5,0,3,1,4,6,1,7,-2,2,0,-1,1,0,1,-1,37,4,-6,2,-1,0,0,-1,-1,0,1,6,-1
KR_6618395790,420,0,-25,-28,3,1,2,3,-1,5,4,4,2,6,-3,5,2,2,1,3,0,-3,1,-2,-4,6,-1,0,1,-1,-1,1,1,5,-1
KR_6752614100,420,0,-15,-4,3,-1,1,0,4,1,5,5,3,8,-4,4,0,-1,3,2,0,5,10,4,-4,0,0,0,0,-1,-1,0,1,5,-1
KR_6763908375,420,-3,7,-25,-4,-3,3,0,-6,6,0,3,0,3,3,2,5,-1,2,1,0,4,-60,-1,-5,6,23,0,0,1,1,0,-1,1,-1
KR_6755134104,420,-4,-48,-24,2,4,0,4,0,1,1,-1,1,0,-5,9,4,4,0,4,-1,3,71,-1,-2,3,-1,0,0,-1,-1,0,-1,6,-1
KR_6649031233,420,-1,-74,0,-7,0,1,1,-4,5,1,-1,1,0,-2,2,0,0,4,4,0,-8,37,-1,-4,5,-13,0,0,1,-1,0,-1,3,-1
KR_6762275225,440,0,2,-48,6,-2,3,1,2,0,2,4,0,4,4,3,7,-2,2,0,0,6,-12,-2,-3,5,-1,0,-1,1,-1,-1,1,5,-1
KR_6756490321,420,-3,-50,-34,-8,-6,8,2,-3,4,1,0,2,2,0,4,4,1,0,1,0,-3,38,-5,-1,6,-19,0,0,1,1,1,1,4,-1
KR_6757898689,420,0,-19,-7,-4,-3,3,0,-2,3,1,-1,3,2,0,2,2,2,0,2,0,2,6,-2,-1,3,-6,0,0,-1,1,0,1,6,-1
KR_6621834529,420,-4,-73,-33,-11,2,1,3,-3,4,1,-10,13,3,-4,5,1,4,0,4,-4,-18,3,0,-5,5,5,0,-1,-1,-1,-1,-1,3,-1
KR_6625320999,420,-3,-45,4,-2,1,1,2,-1,3,2,-2,5,3,0,3,3,0,0,0,1,-4,-2,3,-8,5,-3,0,-1,-1,1,-1,1,6,-1
KR_6750869646,420,1,-2,32,0,-3,6,3,-1,2,1,0,2,2,3,3,6,1,1,2,0,-3,10,9,-10,1,3,0,-1,1,-1,-1,1,3,-1
KR_6745605155,420,-2,-15,-24,2,-4,7,3,-1,2,1,-5,6,1,9,3,12,3,1,4,1,8,-114,0,-1,1,1,0,0,1,1,1,-1,2,-1
KR_6741101370,420,-5,-19,-43,-7,-2,2,0,-2,2,0,0,4,4,-2,3,1,-1,2,1,0,-9,-2,-1,-1,2,1,0,-1,-1,1,-1,-1,2,-1
KR_6745997477,420,0,-60,15,2,0,3,3,-2,5,3,-3,4,1,3,2,5,4,0,4,2,3,-2,-3,-4,7,-3,0,0,-1,1,0,1,6,-1
KR_6713541584,440,-2,23,-18,-9,1,1,2,-5,8,3,-1,1,0,-3,5,2,-1,1,0,0,-7,-3,-3,-4,7,1,0,-2,-1,-1,-1,-1,2,-1
KR_6753766469,420,-3,15,-36,-5,-2,3,1,2,4,6,-3,5,2,-2,2,0,0,0,0,0,1,-3,-3,-2,5,0,0,0,1,-1,1,-1,3,-1
KR_6732149463,420,-8,-38,-28,-15,-1,2,1,-5,5,0,0,1,1,-7,7,0,-2,2,0,0,-17,8,-3,-2,5,-3,0,-2,1,-1,-1,1,5,-1
KR_6653843282,440,-1,-43,23,-2,0,2,2,-6,6,0,4,1,5,-3,8,5,3,1,4,0,0,0,-2,-4,6,3,0,0,-1,1,1,-1,2,-1
KR_6638589797,420,-4,-130,-12,-15,-1,3,2,-5,5,0,-4,7,3,-9,11,2,4,0,4,0,-7,-7,-3,-3,6,0,0,-3,-1,-1,-1,-1,5,-1
KR_6764134169,420,-1,-25,-15,-7,2,0,2,-3,4,1,-1,1,0,-3,5,2,-2,2,0,-1,-11,-3,-4,-4,8,3,0,-1,1,-1,-1,-1,2,-1
KR_6669378306,420,-2,-10,-36,-1,5,0,5,-1,2,1,0,6,6,-5,5,0,0,1,1,-1,5,-5,4,-7,3,1,0,-2,-1,1,-1,-1,1,-1
KR_6764357561,420,-3,-60,-26,-7,-4,5,1,1,0,1,-6,6,0,3,3,6,-1,2,1,-1,-2,-3,0,-3,3,2,0,-2,-1,1,-1,1,6,-1
KR_6716617619,420,-3,-107,30,-9,-4,4,0,0,1,1,-6,6,0,1,2,3,0,0,0,0,-7,133,3,-5,2,-2,0,-1,-1,1,-1,-1,4,-1
KR_6738476050,420,0,-5,19,2,2,0,2,1,1,2,0,7,7,1,2,3,-2,2,0,0,-2,11,0,-5,5,-3,0,0,1,1,0,-1,6,-1
KR_6738923473,420,-2,-10,4,-2,-1,2,1,-1,4,3,0,0,0,-1,1,0,1,0,1,0,1,41,1,-4,3,2,0,0,1,-1,0,-1,6,-1
KR_6757722337,420,-5,-71,-12,-6,-3,6,3,0,1,1,1,2,3,-4,6,2,0,1,1,0,-1,-24,0,-4,4,-4,0,-1,-1,-1,-1,1,4,-1
KR_6675750091,420,0,19,7,-1,0,1,1,3,2,5,-3,4,1,-2,5,3,1,0,1,0,0,55,-3,-2,5,-17,0,0,-1,1,0,-1,3,-1
KR_6760899515,420,-1,-58,-8,-5,2,3,5,-4,4,0,-1,1,0,-2,2,0,0,0,0,-3,-8,-7,-5,-1,6,2,0,-1,-1,0,-1,-1,5,-1
KR_6698877559,420,2,-65,16,-2,-3,4,1,-4,4,0,4,2,6,1,3,4,0,0,0,0,-6,38,0,-4,4,-3,0,-2,-1,-1,-1,-1,3,-1
KR_6735215194,420,-1,-54,-6,0,5,0,5,-4,5,1,-2,2,0,0,2,2,1,1,2,0,-9,-5,0,-3,3,-1,0,0,1,-1,1,1,3,-1
KR_6697261137,420,-1,-20,-8,3,3,3,6,-4,7,3,3,1,4,0,2,2,1,1,2,2,2,-6,-1,-2,3,0,0,0,1,1,-1,1,6,-1
KR_6695623841,420,-1,-42,0,-2,-2,3,1,-4,5,1,0,1,1,0,2,2,4,0,4,0,3,-3,-1,-3,4,-3,0,0,-1,-1,-1,1,5,-1
KR_6694234646,420,0,85,-8,5,-1,3,2,0,3,3,1,3,4,5,2,7,0,1,1,1,4,287,7,-9,2,-2,0,2,1,-1,1,1,6,-1
KR_6678165260,420,1,-10,44,1,-4,4,0,-2,3,1,0,3,3,6,1,7,1,1,2,0,8,11,-1,-3,4,-2,0,0,1,-1,1,-1,5,-1
KR_6723775509,440,-2,10,-12,-13,2,2,4,-3,4,1,-4,4,0,-2,2,0,-6,6,0,-1,-19,3,2,-4,2,1,0,-1,-1,-1,-1,-1,5,-1
KR_6724655072,420,-1,-64,-11,1,0,1,1,2,1,3,-1,2,1,0,3,3,0,1,1,0,-1,-30,1,-3,2,-1,0,0,-1,-1,0,1,6,-1
KR_6755864326,420,2,-54,8,1,3,1,4,-3,6,3,2,2,4,5,2,7,-6,7,1,-1,-4,166,1,-5,4,-2,0,2,-1,1,1,-1,5,-1
KR_6708649339,440,3,18,-8,6,0,2,2,-3,4,1,3,2,5,6,1,7,0,0,0,0,3,8,2,-2,0,-4,0,0,1,0,0,-1,5,-1
KR_6739201963,420,1,-22,20,-6,0,1,1,-2,3,1,0,2,2,-3,3,0,-1,2,1,0,-6,-137,1,-3,2,-2,0,-1,-1,-1,-1,-1,2,-1
KR_6736191776,420,1,20,18,0,2,1,3,-2,3,1,-5,7,2,5,0,5,0,1,1,-1,-2,5,0,-1,1,0,0,0,1,-1,1,-1,6,-1
KR_6725062701,420,2,-23,39,-1,2,1,3,3,1,4,-3,8,5,-2,3,1,-1,1,0,0,-4,-7,0,-4,4,-4,0,-1,0,0,-1,1,0,-1
KR_6719263780,420,2,-6,-2,-3,0,1,1,3,2,5,-2,3,1,-3,5,2,-1,1,0,-1,-8,15,-4,-3,7,7,0,-1,-1,-1,-1,-1,6,-1
KR_6751930645,420,2,55,27,1,0,3,3,0,1,1,7,0,7,-3,3,0,-3,4,1,0,-4,3,-3,-2,5,-3,0,1,-1,-1,1,1,3,-1
KR_6659156707,420,-2,58,-12,-7,1,1,2,-2,3,1,-2,4,2,-4,5,1,0,1,1,0,-13,2,-4,-1,5,3,0,-1,-1,-1,-1,1,4,-1
KR_6715406455,420,-2,-44,29,-10,-3,3,0,2,1,3,-6,9,3,-1,1,0,-2,3,1,0,-1,2,-2,-1,3,-3,0,-1,1,1,-1,-1,6,-1
KR_6636703451,420,-4,-44,8,-13,-4,5,1,-3,3,0,0,3,3,-6,9,3,0,2,2,0,-12,4,3,-3,0,-1,0,0,0,0,0,1,0,-1
KR_6693709319,420,-6,-107,-27,-7,3,1,4,-5,6,1,-5,5,0,-1,3,2,1,1,2,-1,-4,-116,2,-3,1,-3,0,-1,-1,1,-1,-1,5,-1
KR_6757658586,420,0,31,1,-8,4,0,4,0,1,1,-6,7,1,-1,3,2,-5,5,0,0,-20,11,-3,-4,7,-3,0,-1,-1,1,-1,-1,3,-1
KR_6749991558,420,1,80,-4,-5,2,0,2,-5,5,0,0,3,3,-1,3,2,-1,1,0,0,-8,-140,-3,-2,5,6,0,1,-1,-1,1,-1,1,-1
KR_6763998401,420,-3,20,27,-10,-2,2,0,-3,3,0,0,2,2,-4,6,2,-1,1,0,0,-15,211,2,-4,2,0,0,0,-1,1,1,1,2,-1
KR_6690094444,420,-5,-70,-39,-2,1,2,3,0,3,3,-2,5,3,-3,4,1,2,1,3,0,8,8,6,-9,3,-4,0,-1,1,-1,-1,-1,1,-1
KR_6737470450,420,1,70,-4,2,-1,4,3,1,2,3,3,0,3,2,3,5,-3,3,0,0,-8,12,1,-5,4,-4,0,0,-1,0,0,1,3,-1
KR_6751535720,420,-2,-25,-19,-8,-7,7,0,3,3,6,0,1,1,-2,8,6,-2,3,1,0,0,44,-3,-1,4,-19,0,0,1,-1,0,-1,3,-1
KR_6730842939,420,-1,52,-8,2,1,2,3,2,2,4,0,0,0,-2,6,4,1,1,2,1,4,0,6,-10,4,2,0,1,1,1,-1,1,2,-1
KR_6704329476,420,-7,-84,-33,-14,-3,4,1,-1,2,1,0,0,0,-2,2,0,-8,8,0,0,-12,-31,0,-4,4,8,0,-3,-1,-1,-1,-1,2,-1
KR_6721707895,420,0,31,8,-1,2,0,2,-2,2,0,-6,6,0,5,2,7,0,1,1,1,-6,-121,-1,-2,3,-3,0,0,-1,-1,0,1,2,-1
KR_6686642392,440,-5,-75,-15,-16,-7,8,1,-3,7,4,-2,7,5,-6,7,1,2,2,4,-1,-12,-1,2,-2,0,-3,0,-1,0,1,-1,-1,0,-1
KR_6757191528,420,0,-47,-28,1,3,2,5,-5,6,1,3,1,4,1,5,6,-1,1,0,2,15,-380,0,-3,3,2,0,-1,-1,-1,-1,1,3,-1
KR_6595924736,420,0,-20,-8,5,-1,5,4,-5,5,0,10,0,10,-1,3,2,2,0,2,0,11,-4,-8,-1,9,-1,0,1,1,-1,1,1,2,-1
KR_6762131860,420,1,-68,-8,7,7,0,7,1,2,3,1,4,5,0,2,2,-2,3,1,-1,2,0,-1,-2,3,3,0,-1,0,-1,-1,-1,0,-1
KR_6625818078,420,0,64,-19,-6,3,2,5,-3,7,4,3,0,3,-7,7,0,-2,2,0,0,0,-7,-2,-4,6,-3,0,-2,1,-1,-1,-1,1,-1
KR_6725805253,420,-6,17,-40,-9,-1,2,1,-5,6,1,0,3,3,-4,11,7,1,0,1,1,-14,0,-2,-2,4,-1,0,-1,1,-1,-1,1,6,-1
KR_6703104698,420,1,-8,-6,8,1,2,3,1,3,4,2,2,4,3,1,4,1,2,3,0,6,-5,-1,-5,6,6,0,1,1,1,1,1,1,-1
KR_6600452934,420,-2,-24,12,-10,1,1,2,-2,5,3,1,1,2,-6,8,2,-4,4,0,2,-12,-3,0,-3,3,-3,0,-1,1,-1,-1,1,1,-1
KR_6669138856,420,-3,-18,-3,-1,2,6,8,1,1,2,-1,2,1,-3,4,1,0,1,1,0,4,-7,1,-3,2,2,0,-1,1,0,-1,-1,5,-1
KR_6588155940,440,-3,32,-2,-6,1,1,2,6,2,8,-2,5,3,-9,11,2,-2,2,0,2,-4,3,0,-3,3,-1,0,-1,1,0,-1,-1,6,-1
KR_6756709253,420,-5,-34,-4,-9,-1,3,2,-2,5,3,-1,4,3,-2,4,2,-3,3,0,0,-10,-9,0,-2,2,-2,0,0,1,-1,-1,1,3,-1
KR_6760905118,440,0,-15,24,-4,-4,7,3,-1,1,0,6,1,7,-5,6,1,0,0,0,1,4,-147,-1,-6,7,-1,0,1,1,1,1,1,1,-1
KR_6757917882,420,-2,-23,-12,0,2,0,2,-1,1,0,1,2,3,-1,4,3,-1,1,0,1,0,-7,7,-8,1,-4,0,-2,-1,-1,-1,1,1,-1
KR_6652230213,420,-4,-89,16,-7,-8,8,0,3,2,5,0,2,2,1,1,2,-3,6,3,0,4,25,0,-3,3,1,0,-2,-1,1,-1,-1,2,-1
KR_6686286062,420,0,18,-5,-2,2,1,3,-1,3,2,-5,6,1,1,1,2,1,0,1,0,4,-13,1,-2,1,-1,0,0,1,1,1,1,5,-1
KR_6734472427,420,-3,-71,-1,-10,-3,4,1,-1,1,0,-2,6,4,-3,3,0,-1,1,0,0,-7,236,-2,-4,6,0,0,-2,-1,1,-1,1,1,-1
KR_6718794101,420,-1,1,4,-3,2,0,2,-1,4,3,-3,3,0,0,6,6,-1,2,1,0,2,3,-2,-3,5,3,0,0,1,1,0,1,3,-1
KR_6611757407,420,-4,-93,-12,-5,-2,3,1,-5,5,0,2,1,3,2,2,4,-2,2,0,0,-6,2,0,-4,4,-4,0,-1,-1,1,-1,1,3,-1
KR_6760838247,420,-6,-107,-14,-4,1,2,3,-2,3,1,-2,4,2,-3,4,1,2,0,2,1,2,0,-2,-3,5,-1,0,0,-1,-1,0,1,1,-1
KR_6732897114,420,-3,-23,-8,-6,-1,1,0,1,3,4,-6,8,2,0,0,0,0,2,2,0,2,75,0,-2,2,0,0,-1,-1,-1,-1,-1,4,-1
KR_6762548892,420,-1,-39,-2,-9,2,2,4,1,2,3,-5,5,0,-2,2,0,-5,6,1,-2,-11,-13,-1,-3,4,1,0,0,-1,1,-1,-1,6,-1
KR_6762057347,420,-1,-37,4,-6,0,0,0,3,1,4,-3,6,3,-5,5,0,-1,2,1,0,-3,-11,-8,-1,9,9,0,-1,-1,-1,-1,1,4,-1
KR_6606248420,420,-1,-56,-8,1,-1,2,1,7,2,9,2,2,4,-7,9,2,0,1,1,0,-5,-8,0,-4,4,6,0,-2,-1,-1,-1,1,1,-1
KR_6702114865,420,-5,-37,3,-13,-4,6,2,-1,4,3,1,2,3,-5,5,0,-4,4,0,0,-17,-1,4,-5,1,-5,0,-2,1,1,-1,1,2,-1
KR_6715918263,420,-2,-50,-13,-4,0,1,1,-3,6,3,3,0,3,-5,7,2,1,0,1,0,-7,5,2,-3,1,-3,0,0,-1,-1,0,-1,2,-1
KR_6751721917,420,3,-19,4,8,-1,1,0,3,1,4,2,0,2,0,4,4,4,1,5,1,5,0,0,-2,2,3,0,1,1,1,1,1,2,-1
KR_6762086208,420,0,-16,8,0,-2,3,1,0,1,1,-4,4,0,6,0,6,0,1,1,0,5,0,5,-7,2,-3,0,1,1,0,1,-1,2,-1
KR_6718816647,420,-2,-27,-36,-4,-4,5,1,0,2,2,0,2,2,0,2,2,0,1,1,0,-12,19,0,-2,2,-4,0,-1,-1,0,-1,-1,4,-1
KR_6747498905,440,-3,-40,21,-9,-3,6,3,-4,6,2,-4,5,1,0,2,2,2,1,3,-1,-10,-35,-1,-3,4,-1,0,-1,-1,-1,-1,-1,4,-1
KR_6752416515,420,1,23,-22,-1,-1,3,2,0,2,2,2,6,8,-4,7,3,2,0,2,0,5,8,5,-9,4,0,0,0,0,0,0,-1,0,-1
KR_6760195258,420,-3,-114,-16,1,-1,1,0,0,1,1,-1,4,3,3,2,5,0,0,0,3,12,-24,4,-4,0,-4,0,-1,0,-1,-1,1,0,-1
KR_6726689095,420,0,-37,0,-5,-2,2,0,-1,4,3,0,2,2,-1,4,3,-1,2,1,0,3,-1,-3,-3,6,-4,0,-1,0,-1,-1,-1,0,-1
KR_6735478503,440,1,43,-4,-3,0,1,1,4,3,7,-2,6,4,-3,3,0,-2,2,0,0,-5,5,0,-2,2,1,0,0,1,1,0,-1,1,-1
KR_6637405156,420,-1,-54,8,-3,1,1,2,-2,3,1,2,2,4,-2,2,0,-2,4,2,0,-3,106,1,-6,5,-4,0,0,0,1,0,1,0,-1
KR_6727626887,420,3,36,36,5,3,1,4,-1,1,0,2,1,3,-1,1,0,2,0,2,0,5,5,0,-2,2,-2,0,2,1,1,1,1,4,-1
KR_6736365459,420,-4,-87,-17,-6,1,1,2,1,2,3,-4,5,1,-5,6,1,1,1,2,0,-9,19,5,-7,2,-1,0,-2,-1,-1,-1,1,1,-1
KR_6749441555,420,0,-28,19,6,-1,3,2,1,1,2,7,1,8,-1,4,3,0,0,0,0,6,-201,-2,-1,3,0,0,-1,1,-1,-1,-1,4,-1
KR_6742982262,420,-1,-31,8,-1,-4,5,1,1,1,2,1,2,3,0,1,1,1,2,3,0,-2,-32,3,-7,4,19,0,0,0,-1,0,-1,0,-1
KR_6745311669,420,-4,-93,-55,-9,-7,8,1,-1,4,3,-4,5,1,-1,3,2,4,0,4,0,-1,4,0,-6,6,-3,0,-4,-1,-1,-1,-1,2,-1
KR_6704699243,420,2,-33,12,-4,2,4,6,2,2,4,-4,5,1,-3,3,0,-1,2,1,0,-1,41,0,-3,3,-8,0,0,-1,1,-1,-1,6,-1
KR_6657450324,440,0,-2,8,1,2,0,2,1,2,3,-2,2,0,2,1,3,-2,2,0,-1,3,37,-1,-2,3,-21,0,1,1,0,1,-1,2,-1
KR_6764114912,420,-3,-54,8,-10,-2,3,1,2,0,2,-5,9,4,-9,10,1,4,0,4,0,-8,-18,-2,-3,5,-1,0,-2,-1,-1,-1,-1,2,-1
KR_6736225180,420,-2,-50,-40,-7,-3,5,2,-4,5,1,1,1,2,-1,4,3,0,2,2,-1,-4,-4,0,-4,4,1,0,-2,0,-1,-1,-1,0,-1
KR_6641610221,420,-3,-27,-5,-5,-3,4,1,-1,4,3,-1,3,2,2,2,4,-2,2,0,0,-4,18,6,-7,1,-4,0,0,-1,1,0,1,2,-1
KR_6757178641,420,-3,-48,-11,0,0,1,1,1,3,4,-3,4,1,1,4,5,1,0,1,0,5,-1,-2,-3,5,-3,0,0,-1,0,0,-1,5,-1
KR_6650843797,420,-1,13,-2,-3,1,1,2,-2,2,0,-1,1,0,4,3,7,-5,5,0,-1,-5,154,2,-4,2,0,0,1,-1,-1,1,-1,3,-1
KR_6627166093,420,-3,-29,-27,-5,-3,3,0,-1,2,1,-3,5,2,1,2,3,1,2,3,-1,1,-5,-3,-2,5,-1,0,0,-1,1,0,-1,4,-1
KR_6619987600,420,-2,-34,6,-10,0,2,2,-1,4,3,-4,6,2,-5,8,3,0,0,0,0,-4,-1,-1,-3,4,1,0,0,1,-1,-1,-1,3,-1
KR_6737370700,420,-1,-2,-11,3,0,1,1,-2,3,1,0,1,1,-1,2,1,6,0,6,0,3,4,1,-5,4,0,0,1,1,1,1,1,2,-1
KR_6705567034,420,0,16,-8,4,2,0,2,4,3,7,0,1,1,0,2,2,-2,3,1,0,4,2,4,-7,3,-3,0,1,-1,1,1,-1,2,-1
KR_6754638698,420,0,-19,-24,2,-4,5,1,0,2,2,0,2,2,4,2,6,2,2,4,-1,3,23,4,-7,3,-3,0,-1,1,-1,-1,-1,1,-1
KR_6734840920,420,-4,-33,-8,-3,0,1,1,-1,4,3,-2,2,0,-1,4,3,1,0,1,0,0,15,-6,-4,10,4,0,-1,-1,-1,-1,-1,2,-1
KR_6764165763,420,-4,-45,-20,-4,0,1,1,2,0,2,-1,2,1,-4,4,0,-1,1,0,0,-4,-14,5,-8,3,2,0,-2,-1,-1,-1,-1,4,-1
KR_6621046958,420,0,57,-7,-2,0,2,2,-2,4,2,4,2,6,-5,9,4,1,0,1,0,-3,-6,-1,-5,6,-1,0,0,-1,1,0,1,2,-1
KR_6650360212,420,-3,-27,3,-6,-1,2,1,-3,4,1,3,0,3,-2,3,1,-3,6,3,0,0,0,-3,0,3,0,0,-1,-1,-1,-1,1,1,-1
KR_6743831009,420,-3,47,-37,-14,-4,5,1,-8,9,1,-4,6,2,-1,7,6,3,1,4,1,-9,6,0,-4,4,-1,0,0,-1,-1,-1,-1,3,-1
KR_6664500073,420,-1,-51,-34,-2,-1,2,1,0,3,3,2,0,2,-3,6,3,0,1,1,1,0,-332,0,-3,3,-4,0,-1,-1,1,-1,1,4,-1
KR_6592910817,420,2,-15,0,2,0,1,1,2,1,3,-2,3,1,2,1,3,0,1,1,0,2,4,0,-3,3,-4,0,0,1,0,-1,-1,2,-1
KR_6754320488,420,-5,-42,-29,-6,-2,3,1,-2,4,2,-1,4,3,-2,6,4,1,0,1,2,-1,2,-2,-3,5,0,0,0,1,-1,-1,1,3,-1
KR_6692444975,420,-1,-43,-20,-5,-2,2,0,-4,6,2,0,3,3,0,5,5,1,3,4,0,0,4,-4,-3,7,-3,0,-1,-1,-1,-1,-1,5,-1
KR_6704548138,420,-5,-23,-2,-8,-6,7,1,-3,5,2,0,3,3,1,3,4,0,2,2,2,3,0,-2,-2,4,-4,0,-1,-1,0,-1,1,2,-1
KR_6758177746,420,-1,-13,-17,-3,-4,4,0,3,0,3,-1,1,0,-3,5,2,2,1,3,0,-1,4,-1,-4,5,3,0,1,1,-1,1,-1,1,-1
KR_6740951071,420,-3,-13,-12,-4,1,0,1,-4,5,1,0,2,2,-3,6,3,2,0,2,0,-6,6,-3,-3,6,-2,0,-1,-1,-1,-1,-1,2,-1
KR_6761294270,420,0,-15,9,2,-2,3,1,3,1,4,-4,7,3,5,1,6,0,1,1,0,5,13,0,-2,2,-1,0,0,-1,0,0,1,1,-1
KR_6703385819,420,0,-85,-12,-1,3,0,3,0,2,2,-1,4,3,-2,5,3,-1,2,1,0,-3,-9,2,-6,4,0,0,0,1,1,-1,1,4,-1
KR_6606051087,420,-4,-83,-2,-6,-3,3,0,2,1,3,-5,6,1,2,2,4,-2,2,0,1,3,-5,-1,-3,4,1,0,-1,1,1,-1,1,3,-1
KR_6726431586,420,-3,-59,-6,-8,-2,2,0,-4,5,1,1,2,3,-5,8,3,2,0,2,0,-5,3,2,-5,3,-1,0,-1,1,0,-1,-1,6,-1
KR_6760911386,420,2,-33,4,0,-3,3,0,2,2,4,4,1,5,1,4,5,-4,6,2,0,-3,5,8,-9,1,-7,0,0,1,-1,0,-1,5,-1
KR_6729358188,420,1,42,-20,0,0,4,4,-2,2,0,2,1,3,1,3,4,-1,2,1,0,-4,-3,0,-2,2,3,0,2,1,-1,1,1,5,-1
KR_6757166591,420,-3,-19,-8,-13,0,1,1,-5,5,0,-7,7,0,-2,3,1,1,1,2,0,-15,7,3,-6,3,-3,0,-1,-1,-1,-1,-1,1,-1
KR_6750500615,440,-4,-9,-21,-11,-4,4,0,2,0,2,2,3,5,-8,9,1,-3,3,0,0,-5,-23,-1,-3,4,-2,0,0,-1,-1,0,-1,5,-1
KR_6716427792,440,-3,-16,-6,-7,-4,7,3,-1,2,1,1,3,4,-1,6,5,-2,2,0,0,-9,2,1,-3,2,3,0,0,1,-1,-1,1,5,-1
KR_6711377367,420,-3,0,-24,-11,-1,2,1,-2,4,2,1,2,3,-5,5,0,-4,4,0,-1,-13,2,2,-5,3,-1,0,0,-1,1,-1,-1,4,-1
KR_6690218555,420,1,-23,4,5,-2,5,3,2,1,3,3,1,4,-1,1,0,3,1,4,0,10,3,0,-4,4,4,0,-1,-1,-1,-1,-1,5,-1
KR_6759466431,420,-5,-69,-48,-4,-4,5,1,-5,6,1,2,2,4,2,3,5,1,1,2,-1,-7,-43,2,-4,2,25,0,-1,-1,-1,-1,-1,1,-1
KR_6761329848,420,-2,-28,-1,-3,-2,2,0,3,0,3,1,1,2,-4,6,2,-1,1,0,0,-1,-4,-1,-2,3,2,0,-1,-1,1,-1,1,6,-1
KR_6760677741,420,2,-27,15,1,-3,3,0,0,0,0,0,1,1,1,0,1,3,0,3,0,1,-5,0,-6,6,6,0,0,1,0,0,-1,4,-1
KR_6729601702,440,-5,-71,-20,-9,-7,9,2,0,0,0,0,1,1,-2,8,6,0,2,2,0,-3,23,-4,-5,9,-5,-1,-3,1,-1,-1,-1,4,-1
KR_6761004916,420,2,21,16,7,0,2,2,3,1,4,-1,4,3,5,3,8,0,3,3,0,4,448,-1,-1,2,1,0,0,1,1,0,1,6,-1
KR_6729975613,420,-3,61,0,-10,-1,3,2,-6,6,0,-2,4,2,-1,3,2,0,1,1,0,-12,34,-2,-3,5,-5,0,0,-1,-1,-1,-1,5,-1
KR_6760931856,420,-1,-23,-45,-4,0,5,5,-4,6,2,3,2,5,-3,7,4,0,2,2,1,-4,-8,-7,-3,10,-1,0,0,1,1,1,-1,3,-1
KR_6757857470,420,-3,-49,-12,-6,1,2,3,-2,2,0,-2,3,1,-1,3,2,-2,2,0,0,-10,93,-1,-2,3,4,0,1,-1,0,1,-1,3,-1
KR_6753202795,420,1,-44,4,10,0,2,2,-2,4,2,5,1,6,6,1,7,1,0,1,1,10,2,1,-3,2,1,0,0,-1,1,0,1,4,-1
KR_6756783981,420,-1,-33,54,-8,-2,3,1,1,4,5,2,1,3,-7,7,0,-2,3,1,0,-1,-5,-1,-5,6,0,0,0,-1,1,0,1,6,-1
KR_6732071905,420,2,-44,-3,-4,-3,3,0,-4,6,2,0,2,2,4,1,5,-1,1,0,-1,-6,-5,-2,-3,5,-2,0,-1,-1,-1,-1,-1,5,-1
KR_6763560724,420,-2,-62,-16,-14,-13,13,0,1,2,3,-4,6,2,1,4,5,1,1,2,-3,-4,-1,1,-3,2,-1,0,0,-1,1,-1,-1,4,-1
KR_6763577381,420,-1,25,-4,-4,-1,2,1,0,3,3,2,0,2,-7,7,0,2,0,2,0,-7,-5,2,-4,2,-2,0,-1,0,1,-1,-1,0,-1
KR_6743063732,440,-5,-37,-40,-8,-2,2,0,0,3,3,0,2,2,-4,5,1,-2,3,1,0,-7,5,4,-7,3,0,0,0,-1,-1,0,-1,1,-1
KR_6723822710,440,1,13,12,-3,-7,7,0,-4,4,0,9,0,9,2,3,5,-3,3,0,-2,-7,2,-2,-5,7,3,0,0,1,-1,0,-1,5,-1
KR_6631225288,420,-3,20,-12,-5,-1,2,1,1,4,5,-2,3,1,-3,3,0,0,3,3,2,-6,3,2,-8,6,-6,0,-1,-1,-1,-1,1,4,-1
KR_6735928162,420,1,-41,-4,4,-4,4,0,2,0,2,0,2,2,3,1,4,3,1,4,0,14,-50,0,-5,5,30,0,1,1,-1,1,1,2,-1
KR_6757383140,420,0,12,-8,-2,0,0,0,0,2,2,0,2,2,-2,2,0,0,0,0,0,-2,2,0,-5,5,-1,0,-1,1,-1,-1,1,2,-1
KR_6761498000,420,3,34,28,-3,-3,7,4,1,3,4,1,0,1,-1,3,2,-1,1,0,0,-1,1,3,-7,4,3,0,1,-1,1,1,-1,5,-1
KR_6647271350,420,0,-58,4,-1,-2,3,1,2,6,8,-3,4,1,2,2,4,0,2,2,3,3,-16,0,-6,6,0,0,-1,0,-1,-1,1,0,-1
KR_6758529946,420,-1,30,-28,2,-4,6,2,0,0,0,4,1,5,3,2,5,-1,1,0,0,1,-105,2,-5,3,3,0,-1,-1,-1,-1,1,1,-1
KR_6726245258,420,-1,50,0,-4,2,0,2,-3,6,3,3,3,6,-2,3,1,-4,5,1,0,-10,-5,0,-1,1,-6,0,0,-1,-1,0,-1,6,-1
KR_6696271647,420,3,1,28,3,7,0,7,1,1,2,-3,3,0,-2,4,2,0,0,0,0,-3,-172,0,-1,1,0,0,1,-1,1,1,-1,3,-1
KR_6755390408,420,-1,30,-4,-3,1,3,4,-7,9,2,-1,1,0,3,1,4,1,1,2,0,-10,12,-2,-2,4,-1,0,2,-1,1,-1,1,3,-1
KR_6736919304,420,-4,-79,-4,-5,-1,2,1,3,2,5,-4,4,0,-3,6,3,0,0,0,0,-10,-39,0,-3,3,12,0,-2,-1,1,-1,1,5,-1
KR_6745896622,420,-3,-65,16,-10,0,2,2,-1,2,1,1,1,2,-5,5,0,-5,5,0,0,-6,6,-2,-3,5,-4,0,-2,-1,-1,-1,1,3,-1
KR_6744234860,420,-4,-36,-28,-11,-1,1,0,0,5,5,-8,9,1,-4,5,1,2,0,2,-1,-5,-19,-3,-5,8,-4,0,0,-1,-1,-1,-1,3,-1
KR_6729016690,420,1,-40,20,11,-2,3,1,2,2,4,4,0,4,2,1,3,5,0,5,3,17,22,-1,-3,4,-6,0,0,1,-1,0,1,1,-1
KR_6732024490,420,-6,-60,-20,-15,4,1,5,-3,7,4,-10,10,0,-2,4,2,-4,4,0,0,-11,-6,3,-4,1,1,0,-2,1,-1,-1,-1,4,-1
KR_5736886718,420,-5,-60,1,-9,-3,3,0,-5,9,4,3,1,4,-1,3,2,-3,3,0,-1,-8,-1,-2,-4,6,-8,0,-2,-1,-1,-1,-1,4,-1
KR_6764397160,420,-4,-14,-20,-6,-1,3,2,-1,2,1,0,0,0,-5,6,1,1,1,2,0,-6,4,-1,-2,3,-5,0,-1,-1,1,-1,-1,6,-1
KR_6737776823,420,-3,-60,-20,-7,-2,3,1,-4,4,0,2,1,3,0,0,0,-3,4,1,0,-3,112,-5,-2,7,-4,0,0,-1,-1,-1,-1,1,-1
KR_6719525981,440,0,28,-32,2,4,0,4,0,2,2,3,0,3,-4,6,2,-1,1,0,0,0,37,0,-5,5,-14,0,0,-1,1,1,1,3,-1
KR_6624943750,420,0,-12,15,4,2,1,3,4,2,6,2,1,3,-7,10,3,3,1,4,0,6,11,-2,-4,6,1,0,-1,1,1,-1,1,3,-1
KR_6760378755,420,-5,-89,0,-11,1,1,2,-2,3,1,2,2,4,-6,6,0,-6,6,0,0,-9,6,1,-4,3,-2,0,-1,1,1,-1,-1,6,-1
KR_6705797416,420,-1,-28,-25,2,-5,6,1,-2,2,0,1,3,4,4,2,6,4,2,6,0,3,1,0,-1,1,0,0,1,1,1,1,1,2,-1
KR_6375790440,420,-5,-10,-16,-5,0,2,2,-1,5,4,-4,5,1,1,2,3,-1,1,0,0,-9,0,0,0,0,2,0,0,-1,1,0,1,5,-1
KR_6757807694,420,7,47,32,13,5,1,6,4,1,5,2,2,4,3,0,3,-1,1,0,0,18,0,4,-6,2,1,0,1,1,1,1,-1,1,-1
KR_6761765001,420,-1,-16,-48,-1,-1,3,2,-1,2,1,1,5,6,0,2,2,0,0,0,-1,3,43,-1,-4,5,-18,0,-1,-1,0,-1,-1,5,-1
KR_6762765944,420,-6,-93,-43,-5,0,1,1,2,0,2,-4,4,0,-2,2,0,-1,1,0,0,-3,-3,0,-5,5,-2,0,0,-1,-1,-1,-1,1,-1
KR_6642264679,420,-3,-105,-16,-8,-8,8,0,-1,3,2,-3,4,1,0,2,2,4,0,4,0,4,-167,-6,-1,7,-3,0,-2,-1,-1,-1,-1,5,-1
KR_6618836458,420,0,-38,-1,-4,3,1,4,-2,3,1,-1,2,1,-3,3,0,-1,1,0,0,-6,11,3,-5,2,-1,0,0,-1,1,0,-1,6,-1
KR_6720201436,420,-3,-52,-18,-3,-2,2,0,2,1,3,-2,2,0,0,2,2,-1,2,1,0,-4,392,0,-3,3,-5,0,-2,-1,-1,-1,-1,3,-1
KR_6756103531,420,-3,-87,36,-6,-2,2,0,-1,3,2,-3,3,0,-1,1,0,1,0,1,0,-3,-3,-1,-3,4,-5,0,-1,-1,-1,-1,1,5,-1
KR_6505647656,420,-1,-100,-7,-2,-1,2,1,-2,2,0,-1,1,0,1,0,1,1,1,2,0,-4,0,1,-5,4,-7,0,0,-1,1,0,1,5,-1
KR_6599968144,420,0,-17,-21,0,2,3,5,-3,6,3,-4,6,2,3,2,5,2,1,3,0,2,3,-1,-2,3,0,0,1,1,1,1,1,6,-1
KR_6612054822,420,-3,-72,-24,-9,-1,2,1,-1,2,1,-2,3,1,-3,5,2,-2,2,0,0,-12,2,5,-8,3,0,0,0,-1,1,0,-1,4,-1
KR_6652179844,420,-7,-107,-28,-19,-3,3,0,-2,2,0,-8,9,1,-2,6,4,-4,6,2,-1,-12,-11,-3,-4,7,0,0,-2,-1,-1,-1,-1,1,-1
KR_6733428826,420,-1,25,28,-10,-7,7,0,-1,2,1,1,1,2,-4,4,0,1,0,1,0,-10,-11,0,-2,2,1,0,0,1,0,-1,-1,4,-1
KR_6717514909,420,-5,-45,-30,-13,-5,6,1,-4,7,3,0,4,4,-3,4,1,-1,1,0,1,-1,3,-3,-2,5,2,0,-2,-1,1,-1,1,3,-1
KR_6660028879,420,-4,-59,7,-11,0,0,0,-2,4,2,-8,9,1,-1,3,2,0,1,1,0,-10,-7,-5,-1,6,4,0,1,-1,0,1,-1,1,-1
KR_6723124325,420,-1,31,0,0,0,0,0,2,2,4,3,0,3,-4,4,0,-1,1,0,0,-1,-3,2,-4,2,0,0,0,-1,-1,0,-1,6,-1
KR_6730810430,440,-3,-54,-8,-4,-5,5,0,0,1,1,-4,8,4,4,1,5,1,1,2,0,6,1,-2,-4,6,0,0,0,-1,0,-1,1,2,-1
KR_6764362660,420,2,-21,4,5,1,4,5,1,0,1,6,2,8,-1,2,1,-2,2,0,0,3,-3,1,-4,3,0,0,-1,1,1,-1,1,3,-1
KR_6721339113,420,-1,8,3,-6,0,1,1,-3,5,2,-2,3,1,-2,2,0,1,3,4,1,-4,30,-2,-5,7,-23,0,0,1,-1,-1,1,6,-1
KR_6746932519,420,-4,-83,-21,-13,-2,4,2,-2,4,2,-4,7,3,-5,7,2,0,3,3,-1,-2,-17,-4,0,4,-1,0,0,-1,-1,-1,-1,6,-1
KR_6758853215,420,-1,-5,-2,1,-2,2,0,2,4,6,-1,2,1,-1,4,3,3,0,3,0,-4,6,1,-4,3,1,0,0,-1,1,1,-1,3,-1
KR_6761075147,420,1,14,-20,4,-1,1,0,0,4,4,5,2,7,0,1,1,0,2,2,0,12,209,1,-4,3,2,0,0,-1,-1,1,1,1,-1
KR_6668762978,420,-6,-59,-20,-11,-1,2,1,-3,5,2,-2,4,2,-4,4,0,-1,1,0,0,-14,-5,1,-5,4,2,0,0,-1,-1,-1,-1,5,-1
KR_6764303569,420,3,3,28,0,0,0,0,-2,2,0,4,0,4,-1,3,2,-1,2,1,0,-1,157,1,-4,3,-5,0,1,-1,1,1,-1,5,-1
KR_6714893718,420,-1,12,-11,-4,0,2,2,0,2,2,-6,6,0,4,1,5,-2,2,0,1,-10,-4,-5,-5,10,1,0,1,-1,1,1,1,4,-1
KR_6659069995,420,2,51,0,3,0,0,0,0,3,3,-2,4,2,3,0,3,2,0,2,1,4,-136,1,-4,3,4,0,-1,-1,-1,-1,1,1,-1
KR_6756743076,420,-3,-4,4,-2,-2,3,1,4,0,4,-3,4,1,-2,6,4,1,3,4,0,0,-8,-1,-1,2,0,0,-2,-1,1,1,-1,1,-1
KR_6758957440,420,2,18,3,5,-3,5,2,4,2,6,-4,5,1,3,1,4,5,1,6,0,14,1,-2,-5,7,-1,0,-1,-1,1,-1,-1,5,-1
KR_6743221610,420,0,-12,-16,-6,1,1,2,-2,3,1,0,3,3,-6,7,1,1,0,1,0,-4,-387,-4,-2,6,-1,0,-1,-1,-1,-1,-1,1,-1
KR_6764671060,440,-7,-73,-64,-11,-2,3,1,0,0,0,-2,5,3,-5,5,0,-2,2,0,0,-2,31,1,-2,1,-3,0,0,0,0,0,-1,0,-1
KR_6662892935,420,-8,-128,-36,-11,-2,4,2,-4,6,2,0,3,3,-4,7,3,-1,2,1,0,-1,1,0,0,0,0,0,-4,-1,-1,-1,-1,2,-1
KR_6729739852,420,0,-71,-26,1,3,1,4,2,0,2,-1,2,1,-3,3,0,0,1,1,0,0,113,6,-9,3,-7,0,-1,1,-1,-1,-1,5,-1
KR_6397588570,420,-3,22,-25,-4,-1,3,2,-4,6,2,0,2,2,1,2,3,0,0,0,0,-2,10,5,-7,2,-3,0,0,1,1,0,1,2,-1
KR_6763109839,420,3,34,32,0,-2,4,2,2,0,2,5,2,7,-4,4,0,-1,1,0,0,-5,-222,-1,-2,3,2,0,-3,1,-1,-1,1,5,-1
KR_6657691292,420,0,45,30,-3,3,1,4,-4,5,1,-1,4,3,-3,5,2,2,0,2,0,-2,-220,1,-2,1,-2,0,-1,1,1,1,1,6,-1
KR_6746304160,420,0,7,8,-3,4,0,4,-3,5,2,1,0,1,-2,5,3,-3,3,0,0,-2,-1,-1,-2,3,-2,0,0,0,-1,1,1,0,-1
KR_6724510755,420,-3,-41,-36,-2,0,0,0,-2,4,2,-2,3,1,1,0,1,1,0,1,0,2,102,0,-4,4,1,0,-1,1,-1,-1,-1,3,-1
KR_6760122657,420,-3,-47,11,-5,-2,4,2,0,2,2,-4,5,1,3,1,4,-2,2,0,0,-2,-3,-4,-2,6,1,0,-1,-1,-1,-1,1,5,-1
KR_6761492786,440,-3,-11,8,-8,-2,3,1,-1,1,0,1,1,2,-6,7,1,0,1,1,0,-6,-65,-3,-3,6,-2,0,-1,0,0,-1,-1,0,-1
KR_6731374219,420,3,-31,12,6,-2,3,1,2,1,3,5,3,8,0,4,4,1,1,2,0,9,13,-2,-1,3,2,0,1,1,1,-1,1,4,-1
KR_6732610572,420,-1,-38,-16,-8,0,2,2,-4,7,3,-1,6,5,-2,3,1,-1,1,0,0,-8,-2,-2,-3,5,2,0,-1,-1,-1,-1,-1,5,-1
KR_6762468115,420,-1,-3,-8,-8,-3,3,0,-1,3,2,0,0,0,-4,5,1,0,2,2,0,-4,-3,-9,-1,10,6,0,-1,0,0,-1,-1,0,-1
KR_6734391602,420,-3,-59,-22,2,2,1,3,0,2,2,-2,2,0,2,1,3,0,1,1,-1,7,-34,0,-1,1,14,0,-3,-1,-1,-1,-1,2,-1
KR_6649722582,420,-5,-30,-31,-5,0,1,1,-3,3,0,0,1,1,-1,1,0,-1,1,0,0,-5,-3,1,-4,3,-3,0,-1,-1,-1,-1,1,1,-1
KR_6762275039,420,-1,-20,0,-6,0,2,2,-2,4,2,-3,3,0,2,1,3,-3,5,2,0,-7,-5,2,-5,3,-1,0,0,-1,0,-1,-1,4,-1
KR_6751829425,420,-5,-94,-2,-11,-9,10,1,-1,1,0,-1,5,4,-1,3,2,1,1,2,1,0,11,4,-10,6,-4,0,-1,-1,1,-1,1,4,-1
KR_6178388214,420,-4,-73,32,-10,-7,8,1,-1,4,3,0,1,1,-3,6,3,1,0,1,0,-4,-13,-2,-1,3,2,0,-2,1,-1,-1,-1,5,-1
KR_6756462150,420,-4,29,-21,-12,4,1,5,-5,5,0,-6,6,0,-5,5,0,0,0,0,0,-16,-4,-4,-5,9,2,0,1,-1,1,-1,1,5,-1
KR_6744821246,420,-3,-21,-50,-4,-4,5,1,1,3,4,5,0,5,-1,3,2,-5,8,3,0,-6,-8,-2,-5,7,4,0,-1,-1,-1,-1,-1,4,-1
KR_6723009913,420,-2,45,-41,4,1,2,3,4,2,6,-2,2,0,2,3,5,-1,2,1,2,12,1,6,-8,2,0,0,1,1,-1,1,1,4,-1
KR_6655903215,440,-2,-31,16,1,1,1,2,-2,5,3,5,0,5,0,0,0,-3,3,0,0,3,3,3,-9,6,-4,0,0,-1,1,0,-1,5,-1
KR_6752669275,420,0,-39,-52,0,-5,7,2,0,2,2,3,5,8,1,2,3,1,1,2,0,13,8,-2,-2,4,3,0,1,0,-1,1,-1,0,-1
KR_6738926120,420,2,-29,-32,4,0,2,2,1,1,2,2,2,4,1,3,4,0,1,1,1,5,7,-2,-2,4,1,0,3,1,1,1,1,6,-1
KR_6759220060,420,0,-14,8,-5,2,1,3,-2,2,0,2,2,4,-6,7,1,-1,1,0,0,-5,0,-3,-1,4,0,0,0,1,1,0,1,2,-1
KR_6616448270,420,-1,-16,4,-1,0,0,0,1,1,2,3,0,3,-5,6,1,0,0,0,0,-7,0,-1,-2,3,0,0,-1,-1,-1,-1,1,2,-1
KR_6740428658,420,-6,-108,-16,-8,3,0,3,-3,3,0,-2,4,2,-6,7,1,0,1,1,0,-15,7,2,-6,4,-4,0,0,-1,0,0,1,3,-1
KR_6684655654,420,1,-19,-11,-2,-2,2,0,2,2,4,0,1,1,-2,4,2,0,0,0,0,-1,-107,5,-5,0,-2,0,0,1,1,0,-1,2,-1
KR_6764535976,420,-4,-42,16,-10,1,1,2,-1,3,2,-5,8,3,-2,4,2,-3,3,0,0,-13,18,0,-4,4,3,0,-1,1,-1,-1,-1,2,-1
KR_6762898224,420,2,-10,14,-2,1,1,2,-1,3,2,0,1,1,-1,3,2,-1,1,0,0,-7,-30,-3,-3,6,-2,0,-2,1,-1,-1,1,3,-1
KR_6740392802,420,-7,-59,-37,-12,0,2,2,-2,4,2,-4,6,2,-3,4,1,-3,3,0,0,-11,-39,-1,-5,6,10,0,-1,-1,-1,-1,-1,1,-1
KR_6611802001,420,-1,-22,4,-4,0,1,1,-2,3,1,2,0,2,-3,5,2,-1,1,0,0,-6,-44,-2,-3,5,32,0,2,-1,1,1,-1,2,-1
KR_6754846504,420,1,-42,1,-3,-1,1,0,0,4,4,-5,7,2,0,3,3,3,0,3,1,6,2,1,-3,2,2,0,-2,-1,-1,-1,1,3,-1
KR_6761839055,420,3,-23,4,5,4,1,5,3,1,4,1,0,1,2,3,5,-5,7,2,0,-5,-6,-1,-1,2,-1,0,0,1,1,1,1,3,-1
KR_6647290937,420,5,52,26,8,6,0,6,1,1,2,0,5,5,1,4,5,0,1,1,0,0,8,0,-5,5,2,0,2,1,1,1,-1,6,-1
KR_6705364037,420,2,-119,-1,8,5,0,5,4,2,6,-1,5,4,0,1,1,0,0,0,-1,1,-39,0,-4,4,14,0,1,1,1,1,-1,3,-1
KR_6741867543,420,-2,-5,-12,2,-2,3,1,-2,4,2,3,0,3,1,2,3,2,0,2,0,-1,-7,-6,-5,11,4,0,1,-1,1,1,-1,1,-1
KR_6697559520,420,1,-24,-1,1,4,0,4,2,2,4,-4,5,1,-1,1,0,0,0,0,0,0,39,0,-7,7,0,0,-2,1,-1,-1,1,1,-1
KR_6670364496,420,-4,-99,15,-8,1,1,2,1,2,3,-6,8,2,1,1,2,-5,5,0,0,-6,2,6,-8,2,0,0,-3,-1,-1,-1,-1,5,-1
KR_6760387270,420,-2,-52,-16,-5,0,0,0,-1,1,0,-1,3,2,0,1,1,-3,4,1,0,-7,1,-4,-2,6,4,0,-1,-1,-1,-1,-1,1,-1
KR_6706299801,420,2,48,34,3,5,0,5,-4,4,0,2,4,6,2,3,5,-2,3,1,0,0,-1,3,-6,3,-1,0,-1,-1,-1,-1,1,6,-1
KR_6758380971,440,-5,-57,-51,-16,-1,2,1,2,0,2,-7,8,1,-7,8,1,-3,3,0,0,-10,-8,-1,-3,4,1,0,-2,-1,1,-1,-1,2,-1
KR_6764200119,420,-3,-16,-16,-4,0,0,0,-1,2,1,-3,3,0,0,0,0,0,0,0,0,-3,-6,0,-2,2,3,0,-1,-1,-1,-1,1,5,-1
KR_6756425113,420,-1,-1,-12,-5,1,1,2,2,1,3,-8,9,1,2,2,4,-2,2,0,0,3,-26,0,-5,5,5,0,-1,-1,1,-1,-1,1,-1
KR_6751951389,420,-2,-48,10,-8,-5,5,0,-1,1,0,-3,4,1,0,2,2,1,1,2,0,-3,-7,0,-5,5,2,0,-2,-1,-1,-1,1,1,-1
KR_6673927659,420,-2,-57,16,-11,-4,4,0,-1,1,0,-4,6,2,-1,3,2,-1,2,1,-1,-2,-9,-8,-2,10,2,0,-2,0,-1,-1,-1,0,-1
KR_6701645713,420,-6,-45,-31,-14,-1,2,1,4,0,4,-5,6,1,-6,7,1,-6,7,1,0,-6,0,-1,-2,3,-1,0,-2,-1,1,-1,-1,1,-1
KR_6762617159,420,0,0,-8,11,1,0,1,1,2,3,3,1,4,6,0,6,0,1,1,0,15,-11,-2,-4,6,0,0,0,1,-1,0,1,6,-1
KR_6580341193,420,0,41,4,-2,1,2,3,3,2,5,-1,4,3,-1,6,5,-4,5,1,-1,-7,4,1,-6,5,1,0,1,-1,-1,1,-1,4,-1
KR_6756659984,420,-6,-135,-40,-11,-1,4,3,1,1,2,-4,5,1,-8,9,1,1,0,1,-1,-7,-49,-4,-1,5,19,0,-3,-1,0,-1,-1,1,-1
KR_6626994929,420,0,54,-1,-2,1,0,1,-1,5,4,-2,4,2,-1,4,3,1,0,1,0,-4,-125,-5,-4,9,4,0,0,0,1,0,-1,0,-1
KR_6714494199,420,1,-63,8,1,4,1,5,1,1,2,-2,3,1,-2,2,0,0,1,1,0,-3,-1,1,-3,2,-2,0,0,-1,1,0,-1,5,-1
KR_6675267026,420,-2,-13,-12,2,0,1,1,-1,2,1,7,0,7,-3,3,0,-1,1,0,0,-3,13,-4,-3,7,3,0,0,-1,1,0,1,5,-1
KR_6736014059,420,0,16,-12,-5,1,0,1,1,1,2,-3,3,0,-5,6,1,1,0,1,0,-5,41,1,-5,4,-37,0,1,-1,1,1,-1,2,-1
KR_6751826558,420,-5,-114,-1,-14,-2,4,2,-5,7,2,0,2,2,-4,6,2,-3,4,1,0,-25,-266,-2,-4,6,-1,0,-1,-1,1,-1,-1,2,-1
KR_6762526950,420,-1,-63,16,-3,4,2,6,0,2,2,-4,5,1,-2,2,0,-1,1,0,1,-6,1,-3,-1,4,0,0,2,-1,1,1,1,6,-1
KR_6730188404,420,0,-18,4,3,-3,3,0,1,2,3,0,1,1,1,0,1,4,0,4,1,5,17,0,-4,4,-3,0,1,1,-1,1,1,5,-1
KR_6749640937,420,-1,44,31,2,-3,3,0,-3,4,1,10,2,12,-2,3,1,0,2,2,0,-3,0,3,-5,2,1,0,-1,1,-1,-1,1,5,-1
KR_6761871947,440,-5,-68,-18,-16,-4,4,0,-1,4,3,-7,7,0,-4,8,4,0,1,1,0,-13,-2,0,-4,4,-4,0,-3,-1,-1,-1,-1,5,-1
KR_6715909872,420,1,0,21,-7,1,0,1,-2,4,2,-5,6,1,-1,3,2,0,0,0,0,-9,-28,2,-8,6,10,0,-1,-1,-1,-1,-1,1,-1
KR_6702365264,420,-3,-113,20,-7,-3,4,1,-1,2,1,0,5,5,-1,3,2,-2,2,0,2,2,-2,1,-6,5,-3,0,-1,-1,1,-1,1,3,-1
KR_6743503693,420,3,-17,28,6,3,1,4,2,1,3,-1,6,5,1,3,4,1,1,2,0,0,-2,-3,0,3,-2,0,0,-1,-1,0,-1,6,-1
KR_6762168918,420,0,-38,20,1,0,1,1,4,0,4,1,2,3,-1,1,0,-3,3,0,0,1,0,-1,-1,2,2,0,-1,0,-1,-1,-1,0,-1
KR_6697742747,420,1,-55,14,8,2,0,2,3,2,5,1,1,2,4,1,5,-2,3,1,0,7,0,-1,-5,6,0,0,-1,1,1,-1,1,4,-1
KR_6721745963,420,0,-7,-12,-3,1,0,1,0,1,1,-1,2,1,0,4,4,-3,3,0,0,-7,-3,3,-8,5,0,0,-1,-1,-1,-1,-1,4,-1
KR_6666811628,420,-3,-63,-17,-2,1,0,1,1,1,2,0,1,1,-2,2,0,-2,2,0,0,-2,-8,-4,-2,6,-1,0,-1,-1,1,-1,-1,1,-1
KR_6695201445,420,0,0,8,2,0,1,1,0,3,3,2,2,4,-1,4,3,1,1,2,0,3,-1,2,-6,4,-2,0,0,-1,0,0,1,2,-1
KR_6666218122,420,-1,-25,20,1,-1,1,0,-2,4,2,1,1,2,1,2,3,2,0,2,-2,-7,-4,-1,-3,4,1,0,0,-1,1,0,-1,2,-1
KR_6601331578,420,-6,-69,-14,-16,-2,2,0,-3,4,1,-5,5,0,3,2,5,-9,9,0,0,-15,-6,-3,-4,7,-6,0,-1,-1,1,-1,-1,6,-1
KR_6723737155,420,1,-34,-1,1,1,1,2,3,3,6,-1,2,1,-3,5,2,1,3,4,0,-1,-8,2,-3,1,-2,0,0,-1,1,1,1,6,-1
KR_6717457657,420,-2,-145,-20,0,-4,4,0,4,2,6,4,1,5,-1,2,1,-3,3,0,0,-2,1,-3,0,3,-1,0,-2,-1,1,-1,-1,1,-1
KR_6758211865,420,-3,-32,8,-6,-4,5,1,-2,3,1,-1,1,0,0,2,2,1,0,1,0,-9,9,0,-5,5,-2,0,-1,1,0,-1,1,5,-1
KR_6733538422,420,-2,-42,-64,-3,1,2,3,-3,4,1,0,0,0,0,2,2,-1,1,0,0,0,18,-1,-3,4,-5,0,-1,-1,-1,-1,1,5,-1
KR_6759438839,420,-1,-22,20,-10,-1,2,1,0,1,1,2,6,8,-6,10,4,-5,5,0,-2,-11,-34,-2,-2,4,20,0,-2,0,1,-1,-1,0,-1
KR_6702713179,420,-5,-3,-28,-9,-3,4,1,-2,4,2,3,1,4,-4,4,0,-3,3,0,0,-10,10,-1,-4,5,-4,0,-1,-1,1,-1,1,2,-1
KR_6650003729,420,3,-41,32,0,2,2,4,1,2,3,1,1,2,-3,5,2,-1,1,0,0,-1,7,5,-7,2,-4,0,1,-1,1,1,-1,4,-1
KR_6755063225,420,3,10,40,4,-3,4,1,7,3,10,1,3,4,-2,3,1,1,0,1,0,4,9,3,-6,3,-3,0,0,1,0,0,-1,4,-1
KR_6759403509,420,-1,-79,17,0,-1,2,1,2,1,3,0,6,6,1,1,2,-2,2,0,0,-6,-6,-2,-4,6,-6,0,-1,1,-1,-1,1,2,-1
KR_6744620231,420,-1,-24,-22,-3,-5,5,0,0,0,0,-3,5,2,3,0,3,2,0,2,0,-4,-14,-3,-4,7,5,0,-3,-1,-1,-1,1,4,-1
KR_6725091127,420,-1,-5,-10,-2,1,0,1,-3,4,1,1,2,3,-1,1,0,0,0,0,0,-9,-13,-10,-1,11,1,0,0,-1,1,0,1,2,-1
KR_6763050141,420,-2,-50,4,0,3,1,4,2,1,3,-4,6,2,1,0,1,-2,2,0,0,-1,-378,1,-2,1,-3,0,-1,-1,1,-1,1,4,-1
KR_6479440339,420,1,19,24,5,1,3,4,1,3,4,-3,6,3,4,2,6,2,0,2,0,-4,1,-4,-1,5,-1,0,2,-1,-1,1,1,3,-1
KR_6621808416,420,0,17,-5,2,2,0,2,2,3,5,4,0,4,-4,4,0,-2,3,1,0,2,-2,1,-5,4,-1,0,0,-1,-1,0,1,6,-1
KR_6672529164,420,0,-40,-2,-2,0,0,0,1,2,3,1,1,2,-4,5,1,0,0,0,0,-2,-7,2,-4,2,2,0,-1,1,1,-1,-1,3,-1
KR_6749707522,420,0,13,-42,2,1,2,3,-1,1,0,-1,3,2,1,0,1,2,1,3,0,6,4,3,-3,0,-1,0,1,-1,0,1,-1,6,-1
KR_6763513517,420,-5,-67,4,-9,-3,4,1,-2,3,1,-2,4,2,-1,5,4,-1,1,0,0,-7,-1,1,-3,2,-2,0,-1,-1,1,-1,-1,3,-1
KR_6760547604,420,1,40,9,-5,1,0,1,-3,4,1,3,0,3,-3,4,1,-3,4,1,1,-5,13,-5,-1,6,-3,0,-2,-1,-1,-1,1,5,-1
KR_6738596258,420,-3,-107,11,-9,-5,6,1,0,3,3,1,2,3,-6,9,3,1,0,1,-1,-12,5,-3,-3,6,-5,0,-3,-1,0,-1,-1,2,-1
KR_6698640791,420,0,31,44,-1,4,0,4,-2,3,1,-2,3,1,0,3,3,-1,1,0,0,-8,-2,1,-1,0,0,0,0,0,1,0,-1,0,-1
KR_6721225168,420,0,-81,1,0,-1,3,2,-1,3,2,0,3,3,0,4,4,2,1,3,0,5,-57,0,-5,5,7,0,-1,-1,-1,-1,1,3,-1
KR_6399624661,420,-2,-97,15,-1,-1,1,0,-2,3,1,3,2,5,-1,3,2,0,1,1,0,-1,-7,1,-6,5,-2,0,0,-1,1,0,-1,4,-1
KR_6708091651,440,-3,-5,-8,-2,-3,3,0,0,1,1,-3,4,1,4,1,5,0,2,2,0,-1,-40,1,-4,3,27,0,0,1,0,0,-1,3,-1
KR_6734647268,420,0,33,11,-4,-4,4,0,-2,3,1,0,1,1,1,3,4,1,1,2,0,-6,3,2,-6,4,-1,0,1,1,1,1,1,5,-1
KR_6670769214,420,-1,-1,13,-2,0,2,2,-4,7,3,2,2,4,0,0,0,0,2,2,-1,-1,-371,-1,-3,4,0,0,0,1,1,1,-1,1,-1
KR_6723915407,420,0,-45,15,2,-1,3,2,-3,6,3,3,0,3,3,0,3,0,1,1,0,-1,21,-3,-2,5,-7,0,0,-1,1,-1,-1,4,-1
KR_6695483109,440,-2,16,-20,-1,0,1,1,-9,10,1,7,1,8,0,2,2,1,2,3,-1,-5,5,4,-6,2,0,0,0,-1,1,0,-1,3,-1
KR_6676998606,420,-2,-57,-24,-3,0,0,0,0,3,3,-5,7,2,2,4,6,0,1,1,1,-6,-144,-1,-1,2,1,0,0,0,-1,-1,1,0,-1
KR_6709897220,420,0,3,-1,0,-3,4,1,2,1,3,-3,3,0,3,1,4,1,0,1,0,2,302,-1,-2,3,3,0,0,1,-1,1,-1,2,-1
KR_6608774578,420,2,64,16,5,-1,2,1,-1,4,3,-2,2,0,6,1,7,3,0,3,0,10,-3,0,-3,3,4,0,1,1,-1,1,1,4,-1
KR_6762410600,420,2,39,40,1,2,0,2,4,5,9,-6,6,0,1,3,4,0,1,1,0,0,7,-1,-2,3,-1,0,1,0,0,1,-1,0,-1
KR_6762791605,420,1,-38,30,4,1,1,2,1,1,2,0,1,1,2,5,7,0,1,1,0,0,1,4,-6,2,-5,0,0,0,1,0,1,0,-1
KR_6695090635,420,1,-19,-9,-4,-4,4,0,4,0,4,-2,4,2,-3,4,1,1,0,1,-1,4,40,0,-3,3,0,0,-1,0,0,-1,-1,0,-1
KR_6708015645,420,-3,-27,-10,-2,3,0,3,-10,14,4,-2,3,1,5,2,7,2,0,2,0,-4,-7,-2,-3,5,4,0,-2,-1,-1,-1,1,2,-1
KR_6530312604,420,-4,-58,-30,1,-1,2,1,-1,1,0,1,2,3,-2,2,0,4,2,6,0,4,16,-4,-1,5,-9,0,-2,1,-1,-1,1,2,-1
KR_6687773527,420,-4,-75,0,-9,-3,3,0,-2,2,0,-1,2,1,-3,3,0,0,1,1,0,-12,-1,-2,-3,5,-2,0,-1,-1,-1,-1,-1,1,-1
KR_6723977742,420,2,41,-21,-4,6,1,7,-9,11,2,2,1,3,-3,5,2,0,0,0,-1,-15,7,6,-10,4,-2,0,0,-1,1,1,-1,2,-1
KR_6754000538,420,4,26,8,3,1,2,3,1,2,3,2,1,3,0,3,3,-1,1,0,-1,-2,23,1,-5,4,-5,0,0,1,0,1,-1,1,-1
KR_6724070374,420,-3,6,-12,-7,1,0,1,-4,5,1,-2,2,0,-2,5,3,0,0,0,0,-9,73,0,-4,4,-7,0,0,-1,1,0,-1,1,-1
KR_6754653233,420,-1,-2,12,1,1,1,2,0,4,4,2,1,3,-1,2,1,-1,1,0,0,2,-5,-3,-4,7,0,0,0,1,1,0,1,4,-1
KR_6716548487,440,-2,-40,-20,-5,-6,6,0,-3,6,3,4,2,6,-1,3,2,1,1,2,-1,-2,46,7,-8,1,-23,0,-1,-1,-1,-1,-1,2,-1
KR_6680104048,420,-1,11,28,2,-3,4,1,-1,3,2,3,0,3,2,2,4,1,1,2,2,6,-7,-2,-1,3,2,0,0,0,-1,-1,1,0,-1
KR_6759675442,420,-1,32,-4,-4,1,1,2,-1,1,0,-5,5,0,4,0,4,-3,4,1,0,-5,47,0,-2,2,-26,0,-1,-1,-1,-1,1,6,-1
KR_6744614763,420,-1,-147,-28,-3,3,1,4,1,2,3,-2,5,3,-6,6,0,1,1,2,0,-5,-361,2,-5,3,-5,0,-2,-1,1,-1,-1,1,-1
KR_6682406563,420,-4,-19,-36,-12,0,3,3,-3,3,0,1,2,3,-5,6,1,-5,5,0,0,-10,193,-1,-2,3,-1,0,0,-1,1,-1,1,4,-1
KR_6741362483,420,0,14,4,-5,-1,3,2,1,4,5,-2,4,2,-2,3,1,-1,2,1,1,-8,-37,1,-5,4,16,0,-1,1,1,-1,1,5,-1
KR_6636654698,420,-1,-63,-31,-2,-3,3,0,-1,4,3,1,0,1,-2,5,3,3,0,3,1,2,130,-2,-4,6,-3,0,0,-1,-1,0,1,6,-1
KR_6492707343,420,0,27,32,4,0,2,2,-1,3,2,3,1,4,3,1,4,-1,5,4,1,3,-6,-2,-4,6,-1,0,1,1,-1,1,1,1,-1
KR_6647523943,420,-3,-16,23,-5,-2,2,0,0,2,2,0,3,3,-3,4,1,0,0,0,-1,-11,3,0,-6,6,-6,0,-1,-1,-1,-1,-1,2,-1
KR_6759728388,420,-1,-59,5,-5,-3,4,1,-1,4,3,0,1,1,0,2,2,-1,1,0,0,-4,8,-1,-2,3,0,0,-1,-1,0,-1,1,3,-1
KR_6753807712,420,-5,-87,0,-15,-1,2,1,1,1,2,-6,6,0,-8,10,2,-1,2,1,0,-14,-8,-5,-1,6,-2,0,-4,-1,-1,-1,-1,4,-1
KR_6483208139,420,-3,-39,-5,-7,-3,4,1,-5,6,1,0,0,0,-3,4,1,4,1,5,0,-2,98,0,-3,3,-2,0,-2,1,-1,-1,1,6,-1
KR_6696214254,420,-1,-35,1,-11,-1,4,3,-5,5,0,-3,3,0,0,1,1,-2,2,0,0,-8,36,-2,-3,5,-13,0,0,0,0,0,-1,0,-1
KR_5826501684,420,0,2,-8,7,-3,5,2,8,0,8,0,2,2,1,1,2,1,0,1,0,4,-8,-2,-4,6,7,0,1,1,1,1,1,2,-1
KR_6655426332,420,7,79,36,14,0,2,2,3,1,4,4,2,6,8,1,9,-1,1,0,2,19,1,3,-6,3,-2,0,4,1,1,1,1,4,-1
KR_6694326896,420,4,-9,23,2,1,2,3,0,1,1,-3,3,0,3,1,4,1,1,2,1,8,-1,1,-4,3,0,0,1,-1,1,1,1,4,-1
KR_6732523439,420,-1,-12,-23,0,-1,3,2,0,2,2,2,0,2,0,1,1,-1,2,1,0,-1,-3,-3,-1,4,-2,0,-1,-1,-1,-1,-1,2,-1
KR_6751789926,420,0,22,-23,5,2,2,4,2,1,3,2,3,5,1,3,4,-2,2,0,0,8,1,3,-5,2,-1,0,-1,-1,-1,-1,-1,3,-1
KR_6742174195,420,1,72,-4,-1,2,3,5,-3,8,5,1,1,2,-2,3,1,1,0,1,0,-4,12,5,-7,2,-7,0,0,-1,1,0,1,1,-1
KR_6511738070,420,3,107,60,8,-2,2,0,0,6,6,2,0,2,7,4,11,1,0,1,0,6,-7,0,-6,6,-1,0,0,0,1,0,1,0,-1
KR_6763290896,420,-4,-75,23,-14,-5,7,2,-1,4,3,-6,6,0,-2,3,1,0,0,0,0,-8,5,5,-7,2,0,0,-1,-1,1,-1,-1,5,-1
KR_6740730413,420,-7,-104,-44,-15,-5,5,0,-2,3,1,-2,3,1,-4,4,0,-2,2,0,0,-10,-34,-5,-1,6,5,0,-2,-1,-1,-1,-1,6,-1
KR_6511714271,420,-3,-62,-11,-2,0,1,1,-6,7,1,1,1,2,3,0,3,0,0,0,0,-1,13,0,-5,5,-2,0,-1,1,-1,-1,1,2,-1
KR_6752674888,440,-6,-91,-37,-18,-1,4,3,-6,6,0,-8,11,3,-1,3,2,-2,4,2,0,-10,-7,-1,-2,3,-2,0,-3,-1,-1,-1,1,3,-1
KR_6757971823,420,2,-50,8,1,2,1,3,3,0,3,-2,4,2,0,2,2,-2,3,1,-1,-2,-2,-1,-3,4,-1,0,0,-1,1,0,-1,3,-1
KR_6681763008,420,2,38,-8,1,6,1,7,-2,2,0,-2,4,2,-2,3,1,1,1,2,0,0,4,0,-4,4,-1,0,0,-1,1,0,1,2,-1
KR_6750858110,420,-1,-55,-4,2,0,1,1,2,2,4,1,1,2,1,6,7,-2,2,0,0,4,18,-1,-1,2,0,0,-1,1,-1,-1,-1,4,-1
KR_6745552458,420,-4,-44,5,-16,-3,5,2,0,2,2,0,1,1,-11,12,1,-2,3,1,0,-12,28,0,-4,4,-12,0,-1,1,1,-1,-1,3,-1
KR_6761486677,440,-4,-25,-1,-8,-2,3,1,-1,2,1,-2,2,0,-2,5,3,-1,2,1,0,-1,2,-1,-4,5,-1,0,-1,1,-1,-1,1,4,-1
KR_6761611135,420,3,102,20,4,0,2,2,2,3,5,-4,6,2,1,2,3,5,3,8,0,-7,6,-2,-1,3,4,0,1,1,-1,1,-1,2,-1
KR_6714950696,420,1,-12,-4,1,3,1,4,1,2,3,3,2,5,-6,7,1,0,2,2,1,-1,8,0,-3,3,-3,0,1,-1,-1,-1,1,1,-1
KR_6754236336,420,-5,-101,-36,-13,-2,3,1,-2,2,0,-5,6,1,-2,3,1,-2,3,1,-1,-7,-5,-3,0,3,-2,0,-4,-1,-1,-1,-1,1,-1
KR_6619295024,420,-3,-52,-32,-8,-3,4,1,-2,3,1,-1,2,1,-3,4,1,1,1,2,0,-9,-32,-4,-2,6,26,0,0,-1,0,-1,1,1,-1
KR_6750244617,420,-1,-13,-20,-2,2,2,4,-3,4,1,1,1,2,-2,3,1,0,0,0,0,-4,42,-3,-2,5,-23,0,-1,-1,0,-1,-1,6,-1
KR_6655465873,420,1,-8,19,4,3,0,3,-2,3,1,1,3,4,0,4,4,2,0,2,0,4,11,2,-4,2,1,0,0,0,1,0,1,0,-1
KR_6762278002,420,-3,-51,17,1,2,0,2,-2,7,5,0,2,2,1,2,3,0,0,0,0,0,1,1,-4,3,4,0,0,1,-1,0,1,3,-1
KR_6758120492,420,-3,7,-12,-9,-3,4,1,3,3,6,-1,1,0,-2,3,1,-6,6,0,0,-8,5,1,-7,6,0,0,-1,1,1,-1,1,6,-1
KR_6731643122,420,-1,-51,8,0,5,0,5,-1,3,2,-4,4,0,0,3,3,0,0,0,1,2,9,-4,-2,6,6,0,-2,1,-1,-1,-1,3,-1
KR_6757291159,440,-6,-129,-7,-15,-1,1,0,-5,6,1,1,0,1,-4,5,1,-6,6,0,0,-12,-11,-2,-1,3,-1,0,-1,0,-1,-1,-1,0,-1
KR_6636459281,420,-3,-21,-26,-10,-5,5,0,2,1,3,0,4,4,-7,7,0,0,0,0,1,-2,4,1,-5,4,-4,0,-2,1,-1,-1,1,4,-1
KR_6678527491,440,-3,-83,8,-3,-2,3,1,4,0,4,-1,6,5,-5,7,2,1,0,1,0,-3,-21,-5,0,5,-4,0,0,-1,1,0,-1,4,-1
KR_6740751458,420,0,-2,12,1,-1,3,2,-3,4,1,3,1,4,2,0,2,0,2,2,0,1,9,0,-2,2,0,0,1,1,1,1,1,6,-1
KR_6728388102,420,-1,14,-30,-7,0,1,1,-4,5,1,0,3,3,-4,7,3,1,0,1,-1,-16,-46,-2,-3,5,35,0,1,-1,-1,-1,-1,5,-1
KR_6670749917,420,1,-11,24,0,-3,3,0,2,3,5,0,1,1,1,2,3,0,0,0,0,5,1,1,-7,6,1,0,0,-1,-1,0,-1,4,-1
KR_6669359958,420,-7,-74,-9,-13,0,0,0,-5,5,0,-3,3,0,-5,9,4,0,1,1,0,-12,-11,-1,-4,5,2,0,-2,-1,1,-1,-1,6,-1
KR_6756521833,420,-2,-36,-3,-12,1,1,2,-4,7,3,-4,5,1,-3,7,4,-2,3,1,0,-10,101,5,-7,2,-1,0,-1,-1,-1,-1,-1,6,-1
KR_6633620591,420,-1,3,8,1,4,1,5,1,3,4,-1,3,2,-2,3,1,-1,1,0,0,-4,-115,3,-6,3,-2,0,1,1,1,1,1,2,-1
KR_6681109768,420,-6,-81,-24,-25,-1,1,0,-5,5,0,-3,3,0,-7,8,1,-9,9,0,0,-27,-13,-3,-2,5,-3,0,-2,-1,-1,-1,-1,3,-1
KR_6706649886,420,0,37,-30,-2,10,1,11,-3,3,0,1,1,2,-5,6,1,-5,5,0,-1,-11,1,1,-3,2,-1,0,0,-1,-1,1,1,2,-1
KR_6748694315,420,1,-23,8,-2,1,2,3,-3,4,1,-2,3,1,-1,2,1,3,1,4,0,2,-14,-8,0,8,7,0,0,-1,1,1,-1,6,-1
KR_6757895233,420,2,42,30,-2,2,1,3,5,0,5,-4,5,1,-2,4,2,-3,3,0,0,-5,-17,-1,-2,3,1,0,0,1,0,-1,-1,1,-1
KR_6752160316,420,2,115,7,8,10,0,10,-2,3,1,3,2,5,-2,7,5,-1,2,1,2,2,-5,-1,0,1,0,1,3,1,1,1,1,4,-1
KR_6728738618,420,-4,-60,-1,-11,-8,8,0,3,0,3,-2,4,2,-4,5,1,0,0,0,0,-5,-10,-2,-4,6,3,0,-2,0,0,-1,-1,0,-1
KR_6299888911,440,-2,-47,28,-4,-4,4,0,0,2,2,0,3,3,0,2,2,0,0,0,0,-2,18,2,-5,3,-4,0,-2,-1,-1,-1,-1,1,-1
KR_6762895494,420,-3,73,-65,-5,2,2,4,-6,8,2,-5,6,1,5,2,7,-1,2,1,-1,-7,18,-1,-1,2,3,0,0,-1,-1,-1,-1,4,-1
KR_6743103333,440,-2,46,8,-6,1,0,1,-5,5,0,0,2,2,-1,4,3,-1,1,0,0,-12,8,0,-2,2,-2,0,0,-1,1,0,-1,5,-1
KR_6719800717,440,0,20,4,-4,1,3,4,-5,5,0,1,1,2,-1,1,0,0,1,1,0,-7,37,3,-6,3,-9,0,1,-1,1,1,-1,4,-1
KR_6621708409,420,-5,-94,-24,-8,-2,6,4,-1,2,1,-4,4,0,1,1,2,-2,2,0,1,-5,2,-1,-2,3,-2,0,-1,-1,-1,-1,1,1,-1
KR_6727196569,420,-5,29,-36,-1,-2,2,0,-1,3,2,-3,5,2,4,0,4,1,0,1,0,6,5,0,-3,3,4,0,1,1,1,1,1,4,-1
KR_6623445408,420,-2,-25,-1,1,1,1,2,-2,4,2,1,1,2,-1,4,3,2,0,2,0,-4,-33,11,-14,3,16,0,0,-1,1,0,-1,5,-1
KR_6731583929,420,1,-76,-9,-5,2,2,4,1,3,4,-4,5,1,-3,4,1,-1,2,1,0,-6,-3,0,-2,2,-4,0,-2,1,-1,-1,1,4,-1
KR_6745034265,420,-8,-96,-28,-15,0,3,3,-2,2,0,-6,7,1,-5,5,0,-2,3,1,0,-4,-9,-4,-1,5,0,0,-3,-1,-1,-1,-1,1,-1
KR_6647399383,440,-3,-82,-9,-8,3,1,4,-5,6,1,-2,5,3,-2,6,4,-2,3,1,0,-3,15,-5,0,5,2,0,0,0,0,0,1,0,-1
KR_6759055652,420,0,2,3,2,3,0,3,-1,4,3,1,1,2,-1,2,1,0,0,0,0,-1,408,0,-2,2,1,0,0,1,1,1,1,2,-1
KR_6732844391,420,-5,20,7,-12,-5,6,1,-1,4,3,0,3,3,-5,6,1,-1,2,1,0,-5,3,-2,-2,4,3,0,-2,0,-1,-1,-1,0,-1
KR_6742753723,420,-3,-60,-1,-8,0,1,1,2,0,2,-6,9,3,1,1,2,-5,5,0,0,2,9,0,-3,3,-2,0,-2,1,-1,-1,1,1,-1
KR_6679764003,420,-2,-93,-13,-8,3,1,4,-1,1,0,-7,7,0,-3,4,1,0,1,1,-1,-5,-17,-6,0,6,5,0,0,-1,1,0,-1,2,-1
KR_6749915221,420,-1,-13,-16,-6,0,3,3,-1,6,5,-6,8,2,1,2,3,0,2,2,0,2,5,-2,-2,4,1,0,0,1,-1,0,-1,2,-1
KR_6686750476,420,-2,-24,-5,2,0,1,1,0,1,1,2,2,4,-1,6,5,1,0,1,0,2,7,2,-6,4,-4,0,0,-1,0,0,1,3,-1
KR_6619847631,420,-1,48,2,-9,0,1,1,-1,2,1,-4,5,1,-3,5,2,-1,1,0,0,-8,-9,-3,-3,6,5,0,-1,0,-1,-1,-1,0,-1
KR_6742873203,420,0,-63,-16,2,-1,1,0,4,1,5,0,2,2,-2,4,2,1,0,1,0,5,247,6,-7,1,-6,0,0,1,-1,0,1,5,-1
KR_6693625356,420,-3,-34,-12,-13,-8,8,0,0,1,1,-2,2,0,-2,3,1,-1,2,1,0,-11,-12,-5,-2,7,0,0,-3,-1,-1,-1,-1,4,-1
KR_6178455835,420,-1,-37,29,-6,-1,2,1,-5,5,0,0,3,3,0,1,1,0,0,0,0,-1,0,-1,-3,4,0,0,-1,1,-1,-1,-1,2,-1
KR_6732816832,420,-2,-19,4,-5,2,1,3,-4,6,2,-3,4,1,0,3,3,0,4,4,0,-6,5,1,-7,6,-7,0,-1,-1,0,-1,1,6,-1
KR_6634666247,420,-1,-29,-9,-4,2,0,2,0,1,1,-3,8,5,-4,4,0,1,0,1,0,-12,10,5,-5,0,0,0,0,-1,1,0,-1,6,-1
KR_6679072576,420,-3,7,-28,-11,-5,5,0,-2,5,3,-1,4,3,-3,3,0,0,0,0,-1,-5,447,4,-7,3,0,0,-1,-1,1,-1,-1,6,-1
KR_6752614862,420,-1,-25,8,-7,-1,3,2,-1,2,1,-2,3,1,-2,3,1,-1,1,0,0,-9,12,-4,0,4,-2,0,0,-1,-1,0,-1,6,-1
KR_6698529146,420,0,-8,0,-4,-4,4,0,-3,5,2,1,3,4,1,2,3,1,0,1,0,0,-9,3,-7,4,-3,0,1,-1,-1,1,1,5,-1
KR_6758275349,440,1,-9,32,-8,0,2,2,-6,7,1,0,3,3,3,3,6,-5,5,0,0,-17,-13,-5,-2,7,3,0,1,1,-1,1,1,2,-1
KR_6759552218,420,0,-30,-4,2,-2,3,1,4,2,6,1,1,2,-1,2,1,0,2,2,0,1,4,1,-5,4,4,0,0,1,-1,0,-1,4,-1
KR_6732257120,420,1,3,12,6,3,1,4,-3,6,3,1,3,4,6,2,8,-1,1,0,1,1,6,2,-4,2,1,0,1,1,0,1,1,2,-1
KR_6764423459,420,3,-34,24,7,-2,3,1,3,0,3,1,0,1,3,5,8,2,0,2,1,5,-10,-1,-3,4,0,0,-1,0,-1,1,1,0,-1
KR_6743074865,420,-4,-63,16,-3,-2,2,0,-3,5,2,1,1,2,0,3,3,1,1,2,0,0,3,3,-8,5,2,0,0,1,-1,0,1,2,-1
KR_6751128110,420,1,9,16,-2,-1,3,2,0,1,1,1,3,4,2,3,5,-4,5,1,0,-1,-23,-2,-4,6,11,0,0,1,-1,0,-1,6,-1
KR_6721115696,420,0,-66,24,1,-2,2,0,2,1,3,2,1,3,-1,2,1,0,0,0,0,0,7,0,-6,6,0,0,0,-1,1,0,1,1,-1
KR_6742707995,420,-6,-37,-38,-19,-8,8,0,-3,4,1,-2,3,1,-7,7,0,1,0,1,0,-12,5,-1,-5,6,-5,0,-3,-1,-1,-1,-1,2,-1
KR_6701696485,420,-2,-41,2,-2,-2,3,1,2,2,4,-1,3,2,1,1,2,-2,2,0,0,-2,-5,1,-6,5,-1,0,0,0,0,-1,-1,0,-1
KR_6755074047,420,-8,-110,12,-15,1,3,4,-2,2,0,-5,5,0,-3,4,1,-6,8,2,-1,-12,189,1,-4,3,16,0,-3,-1,-1,-1,-1,6,-1
KR_6686268422,420,-2,-13,-8,-7,0,2,2,-8,8,0,1,1,2,1,0,1,-1,4,3,-1,-12,4,4,-6,2,-1,0,-1,-1,-1,-1,-1,1,-1
KR_6761420926,420,-1,-27,-36,0,0,2,2,0,1,1,-3,6,3,3,1,4,0,0,0,-1,-1,2,0,-7,7,-3,0,0,-1,-1,0,-1,3,-1
KR_6701262555,420,-2,-33,6,-3,0,1,1,-3,6,3,1,0,1,0,1,1,-1,1,0,0,-5,3,-1,-2,3,-1,0,-2,1,-1,-1,1,3,-1
KR_6756611937,420,0,59,-24,-6,2,2,4,1,2,3,-3,5,2,-2,3,1,-4,4,0,-1,-4,-12,1,-6,5,2,0,-1,-1,-1,-1,-1,6,-1
KR_6761756486,420,-1,-90,28,2,-4,6,2,5,5,10,1,2,3,1,2,3,-1,2,1,2,16,-375,2,-3,1,27,0,-3,-1,-1,-1,1,6,-1
KR_6666911500,420,-3,-42,-10,-10,-4,6,2,0,3,3,1,1,2,-5,5,0,-2,3,1,-1,-8,58,1,-4,3,-12,0,0,1,-1,1,-1,6,-1
KR_6648476989,420,-2,-13,-8,-10,1,1,2,-2,4,2,-2,3,1,-3,4,1,-4,4,0,0,-11,-318,0,-4,4,-3,0,0,-1,1,0,-1,3,-1
KR_6649909113,420,-2,-90,-28,-5,-3,4,1,4,1,5,0,3,3,-4,5,1,-2,3,1,-1,1,3,0,-3,3,-1,0,-1,-1,-1,-1,-1,4,-1
KR_6754176859,420,2,-24,-64,7,2,0,2,2,0,2,5,1,6,-1,4,3,-1,1,0,0,1,-2,-1,-5,6,0,0,0,-1,1,0,-1,2,-1
KR_6731274210,420,0,-23,21,-7,0,3,3,-1,2,1,-3,3,0,-5,8,3,2,1,3,0,-14,-2,1,-4,3,4,0,0,0,1,1,1,0,-1
KR_6637075790,440,-4,-64,8,-12,-3,3,0,-5,6,1,0,4,4,-3,3,0,-1,1,0,0,-14,-7,0,-2,2,-1,0,-3,-1,-1,-1,1,5,-1
KR_6693747706,420,-1,-43,-20,5,1,0,1,3,0,3,3,1,4,1,2,3,-3,3,0,0,6,-5,-4,-4,8,0,0,0,-1,-1,0,1,6,-1
KR_6500224004,420,-4,-7,-12,-11,-1,1,0,0,5,5,-3,4,1,-2,2,0,-5,6,1,0,-17,1,5,-7,2,0,0,-1,-1,-1,-1,-1,4,-1
KR_6751872419,420,-1,-15,-39,-8,1,0,1,-1,2,1,-6,9,3,-1,2,1,-1,1,0,0,-3,-20,-2,-1,3,3,0,-1,-1,1,-1,-1,1,-1
KR_6759339756,420,-3,6,8,-9,-6,6,0,-2,5,3,-1,2,1,-1,2,1,1,1,2,0,-13,-10,1,-2,1,-4,0,0,-1,0,-1,-1,6,-1
KR_6762679990,420,0,35,0,1,3,0,3,4,2,6,-3,5,2,-2,2,0,-1,1,0,0,-2,294,0,-3,3,-2,0,0,-1,1,0,-1,6,-1
KR_6670535267,420,-4,-67,8,-8,-3,4,1,-2,2,0,2,2,4,-4,4,0,-1,2,1,0,-9,-222,3,-4,1,-4,0,-3,0,-1,-1,-1,0,-1
KR_6458585839,420,-2,27,0,-9,-2,2,0,0,3,3,-4,5,1,-1,3,2,-2,3,1,0,-15,43,-1,-4,5,-1,0,0,-1,1,0,1,1,-1
KR_6754032524,420,4,35,41,3,1,3,4,4,1,5,-5,7,2,5,1,6,-2,2,0,0,-2,9,-1,-4,5,2,0,2,1,1,1,1,6,-1
KR_6763704005,440,-2,-62,-8,-6,-3,3,0,1,2,3,1,0,1,-5,6,1,0,1,1,0,-8,-3,2,-6,4,-3,0,-1,-1,-1,-1,-1,2,-1
KR_6737316424,420,-3,-47,-8,-10,-2,2,0,-4,5,1,-2,3,1,-2,3,1,0,1,1,0,-8,0,1,-6,5,-2,0,-1,-1,0,-1,-1,6,-1
KR_6762623921,420,1,19,0,3,1,0,1,0,1,1,0,2,2,1,1,2,1,2,3,0,6,-326,0,-1,1,3,0,0,-1,1,-1,1,1,-1
KR_6686423196,420,2,5,-12,3,0,1,1,2,0,2,0,2,2,-3,4,1,4,0,4,1,1,7,2,-4,2,1,0,-1,1,1,-1,1,3,-1
KR_6691239393,420,0,18,-37,-1,5,0,5,-1,2,1,-2,3,1,-3,7,4,0,1,1,0,-7,-6,-1,-3,4,-2,0,-1,-1,-1,1,-1,3,-1
KR_6669013757,420,-3,18,-60,-12,1,2,3,1,2,3,-4,8,4,-1,2,1,-9,13,4,-1,-5,5,4,-6,2,-1,0,0,0,-1,1,1,0,-1
KR_6636691359,420,-3,-79,-16,-6,0,2,2,0,4,4,-1,4,3,-4,6,2,-1,1,0,0,-12,-5,0,-4,4,-4,0,-1,1,-1,-1,1,5,-1
KR_6699948987,420,0,63,4,-5,-1,2,1,0,2,2,-4,5,1,-1,3,2,1,2,3,0,-11,0,0,-3,3,-2,0,1,-1,-1,1,-1,4,-1
KR_6762676397,420,-2,-78,-72,3,-1,2,1,4,1,5,3,1,4,-1,3,2,-2,3,1,0,4,-25,2,-5,3,-2,0,0,0,1,0,-1,0,-1
KR_6690471469,420,-2,-31,16,-16,-3,4,1,0,2,2,-3,6,3,-5,6,1,-5,6,1,0,-9,-15,2,-5,3,-2,0,-1,1,-1,-1,-1,3,-1
KR_6731926590,420,-3,-74,20,-12,-3,3,0,2,3,5,-4,4,0,-1,4,3,-6,6,0,0,-16,-5,-1,-2,3,-3,0,0,0,0,0,1,0,-1
KR_6661218179,440,-3,12,4,-8,-2,2,0,2,0,2,-3,5,2,-4,8,4,-1,1,0,0,-3,0,-1,-6,7,1,0,0,0,-1,-1,-1,0,-1
KR_6757955243,420,-5,-108,-4,-11,-2,2,0,-2,4,2,1,1,2,-9,10,1,1,0,1,0,-14,13,2,-6,4,-10,0,0,-1,1,0,1,4,-1
KR_6752756925,440,1,22,-21,6,1,3,4,0,2,2,1,1,2,2,0,2,2,0,2,0,6,-26,-6,0,6,1,0,2,0,-1,1,1,0,-1
KR_6709003743,420,-1,-54,-8,-2,-1,2,1,7,0,7,-7,8,1,-2,5,3,1,0,1,0,5,22,-1,-5,6,-7,0,-2,-1,1,-1,1,3,-1
KR_6757095784,420,-4,-63,12,-10,2,0,2,0,1,1,-1,3,2,-9,11,2,-2,2,0,-1,-18,-104,-3,-4,7,-2,0,-3,0,-1,-1,-1,0,-1
KR_6695734279,420,-4,-40,-4,-10,-2,3,1,-1,2,1,-3,3,0,-3,3,0,-1,1,0,-1,-11,0,-8,-2,10,-3,0,0,-1,1,-1,-1,6,-1
KR_6746987089,440,1,-37,-20,-3,-1,4,3,-3,5,2,-1,3,2,2,1,3,0,0,0,0,0,-3,-3,-4,7,7,0,-1,-1,1,-1,-1,4,-1
KR_6752365241,420,0,-29,-50,-10,-5,5,0,2,2,4,-7,7,0,2,5,7,-2,2,0,0,0,-2,-8,-1,9,-1,0,-1,-1,-1,-1,-1,4,-1
KR_6713285887,420,-3,-37,-19,-3,-5,6,1,1,0,1,-1,3,2,2,1,3,0,1,1,0,1,7,5,-8,3,-2,0,-1,1,-1,-1,1,4,-1
KR_6759858020,440,-4,-45,-19,-15,0,1,1,-14,16,2,0,1,1,-3,3,0,2,1,3,0,-19,-11,-2,-5,7,-5,0,-2,-1,-1,-1,-1,6,-1
KR_6759660593,440,1,69,24,3,1,2,3,0,1,1,0,3,3,3,2,5,-1,1,0,0,1,26,-2,-3,5,1,0,0,-1,1,1,1,3,-1
KR_6727875690,420,0,-7,0,3,4,1,5,3,2,5,-2,2,0,-1,1,0,-1,1,0,0,6,2,0,-5,5,-3,0,0,-1,-1,0,1,5,-1
KR_6739894710,420,1,29,-8,0,4,1,5,-4,8,4,0,1,1,-2,2,0,2,0,2,0,-1,6,3,-5,2,1,0,2,-1,-1,-1,-1,3,-1
KR_6623859516,420,-1,-29,0,-11,-4,4,0,3,1,4,0,2,2,-9,9,0,-1,2,1,0,-9,6,1,-4,3,-1,0,-1,1,-1,-1,1,5,-1
KR_6730032252,440,-6,-101,-67,-8,0,3,3,-3,4,1,-7,8,1,1,1,2,1,0,1,0,-6,3,1,-2,1,0,0,-2,-1,0,-1,1,1,-1
KR_6660474926,420,-3,6,0,-6,-3,4,1,-2,3,1,0,3,3,-1,1,0,0,0,0,0,-3,5,5,-9,4,2,0,0,-1,-1,0,1,2,-1
KR_6753383164,420,-1,9,-33,1,-1,3,2,-1,4,3,-3,5,2,7,1,8,-1,3,2,0,1,-21,2,-3,1,0,0,-1,-1,1,-1,1,6,-1
KR_6751515750,420,-2,-44,3,-13,-4,7,3,-5,8,3,-4,5,1,-1,2,1,1,0,1,0,-4,-1,0,-3,3,-2,0,-2,-1,-1,-1,-1,4,-1
KR_5858010514,420,-1,12,-4,-3,-1,4,3,0,0,0,3,2,5,-4,4,0,-1,1,0,0,-10,5,0,-7,7,-3,0,-1,-1,1,-1,1,1,-1
KR_6755984557,420,2,28,24,7,0,2,2,2,1,3,4,1,5,3,2,5,-2,2,0,0,-1,-7,-2,-2,4,3,0,1,1,1,1,-1,3,-1
KR_6717060813,420,-3,-19,17,-4,5,2,7,-1,1,0,-1,5,4,-3,6,3,-4,5,1,1,-11,14,4,-8,4,-7,0,1,1,-1,1,-1,3,-1
KR_6746200906,420,-1,-38,-28,-10,-2,3,1,-5,5,0,-4,6,2,1,2,3,0,0,0,0,-8,1,-3,-3,6,-2,0,0,-1,-1,0,-1,4,-1
KR_6726510307,420,-4,-38,13,-9,-2,5,3,3,4,7,-6,6,0,-2,2,0,-2,2,0,0,-5,9,1,-3,2,-5,0,0,1,1,1,1,2,-1
KR_6736303643,420,-1,10,25,-7,0,0,0,2,3,5,1,3,4,-5,7,2,-5,5,0,0,-6,-34,0,-1,1,0,0,1,-1,-1,1,-1,4,-1
KR_6612755935,440,-1,18,-4,1,0,1,1,-2,6,4,2,2,4,1,3,4,0,0,0,0,-14,-81,7,-9,2,-1,0,0,0,0,-1,1,0,-1
KR_6761236377,420,0,-25,16,-10,1,3,4,-2,4,2,-2,2,0,-5,5,0,-2,3,1,-1,-10,-5,-1,-1,2,0,0,-2,-1,-1,-1,-1,4,-1
KR_6654864751,420,0,-45,12,1,1,2,3,3,1,4,2,0,2,-5,7,2,0,2,2,1,1,-5,4,-5,1,1,0,-1,-1,-1,-1,1,5,-1
KR_6752376422,420,-1,-27,-2,6,-3,3,0,-3,6,3,6,1,7,8,1,9,-2,7,5,1,8,-182,5,-5,0,-2,0,-2,1,1,-1,1,6,-1
KR_6548115303,420,-3,-34,-32,-12,-1,2,1,-2,3,1,-2,4,2,-8,9,1,1,0,1,-1,-5,-6,-3,0,3,-1,0,-1,0,-1,-1,-1,0,-1
KR_6759255989,420,-1,27,-8,-5,0,1,1,0,3,3,-1,2,1,-3,3,0,-1,1,0,0,-4,-3,-1,-2,3,1,0,1,-1,1,1,-1,6,-1
KR_6605903613,420,-1,-6,-10,-4,1,1,2,3,2,5,-2,5,3,-6,7,1,0,1,1,0,-4,-231,-1,-5,6,1,0,2,-1,1,1,-1,3,-1
KR_6743184955,420,-7,-99,-44,-13,-2,4,2,-1,5,4,1,1,2,-9,11,2,-2,3,1,0,-12,-39,1,-5,4,4,0,-2,-1,1,-1,-1,1,-1
KR_6749800213,420,-3,24,-13,0,-1,2,1,-2,3,1,9,2,11,-5,5,0,-1,3,2,0,0,2,-2,-3,5,-1,0,-1,1,1,-1,1,6,-1
KR_6757798229,420,-1,0,-2,-1,-3,5,2,1,1,2,4,2,6,-1,3,2,-2,3,1,0,-9,-2,-2,-2,4,1,0,0,-1,1,1,1,3,-1
KR_6686822054,420,-2,-103,-16,0,0,3,3,-1,4,3,-2,2,0,1,5,6,2,0,2,0,5,-22,4,-7,3,1,0,0,-1,1,0,1,1,-1
KR_6756548221,420,1,-6,12,-2,1,2,3,0,1,1,0,1,1,-2,4,2,-1,1,0,2,-7,9,-1,-5,6,1,0,0,1,1,1,1,3,-1
KR_6646798028,420,-3,-63,-5,0,-1,2,1,1,1,2,1,1,2,-1,2,1,0,1,1,0,-1,-42,-3,-3,6,23,0,0,1,-1,0,1,2,-1
KR_6395584291,420,2,110,-24,-1,1,2,3,-1,5,4,2,1,3,0,2,2,-3,3,0,0,5,1,-1,-4,5,-1,0,1,1,1,1,-1,4,-1
KR_6696357364,420,1,3,0,-2,-2,2,0,2,1,3,0,3,3,-1,1,0,-1,1,0,0,0,-2,-3,-3,6,2,0,0,-1,-1,0,1,5,-1
KR_6666853826,420,-2,-69,8,-10,3,0,3,-2,4,2,-9,10,1,0,2,2,-2,2,0,0,-9,-6,1,-2,1,-2,0,-2,0,0,-1,-1,0,-1
KR_6731715609,420,-3,-19,-8,-4,-3,3,0,1,5,6,2,3,5,-3,5,2,-1,1,0,0,-2,-1,-1,-4,5,-2,0,0,1,-1,-1,-1,1,-1
KR_6759186823,420,-1,-5,8,-3,-1,3,2,3,1,4,1,0,1,-6,6,0,0,1,1,0,-6,-7,-1,-4,5,1,0,0,1,1,1,-1,4,-1
KR_6737416311,420,-3,-48,-10,-2,1,2,3,-3,4,1,4,1,5,-2,4,2,-2,2,0,0,-8,-117,-2,-1,3,1,0,-1,-1,0,-1,1,5,-1
KR_6753319365,420,-9,-167,-12,-24,-5,6,1,-3,3,0,-2,5,3,-10,10,0,-4,4,0,0,-13,-7,-3,0,3,2,0,-3,-1,-1,-1,-1,4,-1
KR_6759244769,420,0,41,20,2,-1,2,1,5,0,5,1,0,1,-4,8,4,1,0,1,0,1,28,4,-5,1,1,0,-1,1,1,-1,-1,2,-1
KR_6724859880,420,0,-16,8,7,2,1,3,4,0,4,-2,4,2,3,1,4,0,0,0,0,6,317,3,-5,2,1,0,1,-1,1,1,1,4,-1
KR_6762797499,420,0,27,3,-2,4,0,4,-2,2,0,-4,7,3,1,0,1,-1,3,2,0,1,-11,1,-5,4,-1,0,0,1,1,0,-1,1,-1
KR_6759378440,420,0,-28,15,-7,0,3,3,-3,7,4,2,1,3,-3,7,4,-3,5,2,-1,-3,-13,-2,-5,7,-3,0,-2,-1,-1,-1,-1,1,-1
KR_6731469396,420,-4,-98,-54,-11,-1,2,1,-1,3,2,-7,7,0,-3,4,1,1,0,1,-1,-4,-19,-2,-2,4,2,0,-2,-1,-1,-1,-1,3,-1
KR_6760046710,420,-3,-71,3,-9,3,0,3,-7,7,0,-1,2,1,-4,8,4,0,0,0,0,-14,-19,-3,-3,6,-2,0,0,-1,-1,0,1,4,-1
KR_6752495865,420,3,-8,-4,11,4,1,5,1,2,3,1,3,4,1,1,2,4,1,5,0,7,1,-3,0,3,0,1,3,1,1,1,1,3,-1
KR_6643099230,420,1,69,-8,7,3,0,3,0,2,2,4,1,5,0,4,4,0,1,1,-1,7,-314,5,-7,2,1,0,1,-1,-1,1,-1,1,-1
KR_6759676576,420,-1,-28,14,-1,1,2,3,-2,3,1,6,2,8,-4,10,6,-2,2,0,0,-2,-7,0,-4,4,4,0,0,-1,1,-1,-1,4,-1
KR_6674315104,420,-1,-19,26,0,-3,3,0,4,2,6,2,1,3,-3,5,2,0,1,1,0,4,4,0,-4,4,0,0,0,-1,1,0,-1,1,-1
KR_6681257628,440,-6,-21,-37,-16,-2,3,1,-5,9,4,-1,3,2,-7,7,0,-1,1,0,0,-11,0,-1,-3,4,4,0,-5,-1,-1,-1,-1,4,-1
KR_6741925518,420,-2,-19,-20,-6,-5,6,1,2,1,3,-5,6,1,3,1,4,-1,3,2,1,2,8,0,-3,3,2,0,-2,1,-1,-1,1,5,-1
KR_6721555909,420,-4,-8,12,-12,-4,4,0,-3,5,2,0,0,0,-5,5,0,0,0,0,0,-9,-13,-2,-2,4,0,0,-3,-1,-1,-1,1,3,-1
KR_6732322401,420,4,80,48,7,0,2,2,0,6,6,-1,2,1,3,3,6,5,1,6,0,2,10,1,-2,1,-4,0,3,-1,1,1,1,2,-1
KR_6670386836,420,0,-93,5,-2,0,0,0,1,1,2,-4,4,0,-1,4,3,2,0,2,0,-6,18,-5,-2,7,-5,0,0,-1,1,0,-1,1,-1
KR_6669285291,420,-2,3,8,-10,-2,2,0,-6,7,1,0,0,0,-1,2,1,-1,1,0,0,-8,37,2,-4,2,-22,0,0,-1,1,0,-1,4,-1
KR_6661046886,420,-4,-79,-36,-4,-5,6,1,4,1,5,-2,3,1,-2,4,2,1,0,1,0,9,6,2,-6,4,1,0,-2,-1,-1,-1,1,1,-1
KR_6496936178,420,-3,-16,18,-9,2,3,5,-5,6,1,0,2,2,-5,5,0,-1,2,1,0,-9,6,0,0,0,1,0,-1,1,0,-1,-1,1,-1
KR_6662794622,440,-2,-17,-24,-5,-5,8,3,2,4,6,-1,2,1,1,1,2,-2,3,1,0,-8,-1,-1,-6,7,-2,0,-2,-1,-1,-1,1,1,-1
KR_6717370443,420,-2,85,10,-10,-5,6,1,-4,6,2,2,0,2,-1,1,0,-2,2,0,0,-13,-1,2,-4,2,-2,0,1,1,-1,1,-1,5,-1
KR_6755087744,420,2,35,6,4,1,0,1,-3,3,0,-2,3,1,4,4,8,4,3,7,2,4,3,-1,-3,4,0,0,1,1,1,1,1,1,-1
KR_6705464010,420,2,24,4,-3,3,0,3,-4,7,3,-2,3,1,1,1,2,-1,2,1,0,-2,3,2,-5,3,0,0,0,-1,1,1,1,1,-1
KR_6762478222,420,-5,-42,24,-12,-2,3,1,0,1,1,-3,4,1,-6,6,0,-1,1,0,0,-12,-10,-7,-2,9,0,0,-2,-1,-1,-1,-1,5,-1
KR_6756681705,420,1,20,24,1,2,1,3,1,1,2,-4,5,1,1,0,1,1,0,1,0,-10,-14,-5,-5,10,0,0,0,-1,1,0,1,1,-1
KR_6642901194,420,-4,-42,8,-1,-4,6,2,-1,4,3,1,2,3,2,3,5,1,1,2,1,-1,1,1,-2,1,2,0,-1,-1,1,-1,1,1,-1
KR_6733454771,420,2,46,-32,6,2,1,3,4,0,4,3,3,6,-4,4,0,1,0,1,0,6,1,-2,-2,4,1,0,0,-1,1,-1,-1,6,-1
KR_6169950145,420,3,110,-11,2,2,0,2,-4,5,1,2,0,2,0,3,3,2,0,2,0,0,1,-3,-6,9,1,0,1,1,-1,1,-1,4,-1
KR_6757594315,420,-2,-55,-13,-7,-1,2,1,1,2,3,-3,4,1,-2,4,2,-2,3,1,-1,-6,9,3,-5,2,0,0,-1,1,-1,-1,1,4,-1
KR_6749365852,420,-5,5,-3,-3,-4,4,0,3,2,5,-1,5,4,-1,5,4,0,0,0,2,7,7,3,-6,3,4,0,0,1,-1,-1,1,6,-1
KR_6731295498,420,-2,-60,21,0,1,1,2,1,0,1,-1,2,1,-1,3,2,0,1,1,0,-1,5,4,-5,1,-1,0,-1,1,-1,-1,1,3,-1
KR_6623371008,420,1,-24,12,-3,1,1,2,1,4,5,2,0,2,-3,4,1,-4,4,0,-1,3,4,-2,-2,4,-2,0,0,-1,1,1,-1,5,-1
KR_6736563645,420,0,19,-5,-8,0,1,1,-3,3,0,-3,3,0,0,0,0,-2,3,1,0,-11,23,-2,-2,4,-15,0,0,1,-1,0,-1,5,-1
KR_6650976753,420,-6,-118,-26,-8,4,1,5,0,1,1,-5,5,0,-4,4,0,-3,4,1,0,-4,-3,-2,-3,5,-3,0,-1,-1,-1,1,-1,5,-1
KR_6754919358,420,-6,-124,-31,-16,-3,4,1,0,3,3,-5,6,1,-5,8,3,-3,3,0,-1,-16,-31,2,-5,3,20,0,-3,-1,-1,-1,-1,6,-1
KR_6760849527,420,-1,9,-6,-8,0,2,2,-9,9,0,3,4,7,-2,2,0,0,1,1,-1,-14,16,1,-3,2,-2,0,0,-1,-1,0,-1,2,-1
KR_6760414263,420,-2,-57,-29,-6,-4,6,2,-2,4,2,-2,5,3,-1,1,0,3,0,3,0,-1,7,1,-4,3,-3,0,0,1,-1,-1,-1,1,-1
KR_6595126350,420,-2,-40,-12,-4,0,2,2,0,4,4,-3,6,3,-1,2,1,0,0,0,0,0,9,4,-8,4,3,0,0,-1,1,0,-1,6,-1
KR_6758815875,440,-1,32,-4,4,0,1,1,-3,7,4,3,2,5,4,4,8,0,2,2,1,5,-108,3,-4,1,-1,0,1,0,1,1,1,0,-1
KR_6759252779,420,3,13,14,3,-2,3,1,4,2,6,1,3,4,0,0,0,0,2,2,0,2,1,4,-5,1,0,0,1,-1,-1,1,-1,4,-1
KR_6652753865,420,1,-5,-16,5,0,2,2,2,0,2,1,1,2,0,2,2,2,1,3,0,9,-12,-1,-1,2,0,0,0,1,1,0,1,1,-1
KR_6617538296,420,0,-38,12,0,4,1,5,0,1,1,-2,3,1,-2,5,3,0,0,0,0,0,0,-2,-2,4,0,0,1,-1,1,1,1,5,-1
KR_6762182588,440,-1,-11,-9,-1,2,0,2,-1,2,1,-3,4,1,1,0,1,0,0,0,0,-4,10,2,-4,2,-3,0,1,0,1,1,-1,0,-1
KR_6682690813,420,-3,31,-13,-8,-3,4,1,0,4,4,-1,1,0,-2,5,3,-2,2,0,0,0,13,0,-2,2,0,0,1,-1,1,1,1,3,-1
KR_6594943245,420,-5,-110,-15,-7,-8,9,1,3,0,3,-2,3,1,0,2,2,0,2,2,-1,3,3,1,-5,4,-2,0,-2,0,0,-1,-1,0,-1
KR_6737612082,420,-3,-31,17,-4,-1,5,4,0,3,3,-3,3,0,2,0,2,-2,3,1,0,-2,35,1,-3,2,0,0,-1,1,0,-1,-1,5,-1
KR_6741039121,420,-1,5,-8,-2,-1,4,3,-2,3,1,1,0,1,-1,4,3,1,2,3,-1,0,12,-2,-3,5,3,0,0,0,1,0,-1,0,-1
KR_6763701434,420,1,-3,0,-1,6,0,6,1,1,2,0,3,3,-7,8,1,-1,2,1,0,-2,1,-2,-2,4,-2,0,1,0,1,-1,-1,0,-1
KR_6701241327,420,-7,-36,24,-17,-8,9,1,-2,5,3,-3,4,1,-4,4,0,0,1,1,0,-9,-14,-4,-1,5,-1,0,-2,-1,-1,-1,-1,3,-1
KR_6762276772,420,-1,53,17,1,-2,3,1,1,3,4,6,0,6,-4,6,2,0,1,1,0,-1,5,1,-3,2,-3,0,0,1,-1,1,1,6,-1
KR_6735949128,420,-3,26,12,-7,0,0,0,-6,10,4,-1,2,1,-1,5,4,1,1,2,0,-9,2,1,-5,4,1,0,1,-1,1,1,-1,6,-1
KR_6657302036,420,-3,5,-2,-2,-2,4,2,1,2,3,0,2,2,-4,5,1,3,0,3,0,1,16,-1,-4,5,1,0,0,1,-1,-1,1,3,-1
KR_6669402040,420,3,12,-13,6,6,0,6,1,3,4,3,2,5,-4,7,3,0,0,0,0,-7,4,0,-3,3,-2,0,0,-1,-1,1,1,3,-1
KR_6764513695,420,-3,-34,1,-4,-2,3,1,2,3,5,-1,4,3,-1,3,2,-2,2,0,0,1,141,3,-4,1,-5,0,-1,0,-1,-1,-1,0,-1
KR_6760351664,420,-4,-92,-12,-9,-1,2,1,2,0,2,-2,4,2,-3,4,1,-5,6,1,0,0,53,2,-4,2,-6,0,-2,-1,0,-1,-1,4,-1
KR_6587343129,420,4,63,-6,7,0,2,2,0,2,2,3,3,6,2,0,2,2,0,2,0,5,36,0,-5,5,-14,0,1,-1,1,1,-1,6,-1
KR_6758077538,420,-2,-22,-24,-12,-8,8,0,-4,5,1,3,2,5,-1,1,0,-2,3,1,0,-8,-371,-2,-2,4,-2,0,-1,1,-1,-1,-1,5,-1
KR_6642109531,420,-4,-8,0,-7,2,1,3,-3,3,0,-3,5,2,-2,2,0,-1,1,0,0,-10,-106,1,-3,2,-4,0,-1,0,-1,-1,1,0,-1
KR_6728656738,420,-2,-119,-11,-3,2,2,4,-2,3,1,-6,6,0,1,2,3,2,1,3,0,0,-6,1,-2,1,-2,0,0,0,1,-1,-1,0,-1
KR_6749161960,420,-3,-42,-11,-3,-2,3,1,1,1,2,1,4,5,-2,4,2,-1,1,0,0,1,4,0,-4,4,1,0,-1,-1,1,1,1,2,-1
KR_6763519338,420,-1,-36,-27,1,-3,4,1,-1,1,0,1,0,1,4,0,4,0,5,5,0,8,5,1,-3,2,-2,0,-1,1,-1,-1,-1,5,-1
KR_6178479709,420,1,-58,-29,4,0,0,0,0,2,2,3,0,3,0,2,2,1,0,1,0,6,-4,2,-10,8,-3,0,-1,-1,-1,-1,-1,4,-1
KR_6714979045,420,-1,-71,-9,-5,-6,6,0,0,1,1,-3,4,1,2,1,3,2,0,2,0,1,-89,-2,-3,5,-4,0,-3,1,-1,-1,-1,1,-1
KR_6644810223,420,-1,45,-42,2,-1,1,0,-2,5,3,2,0,2,3,0,3,0,1,1,0,0,4,3,-4,1,-1,0,0,-1,-1,0,1,6,-1
KR_6647870658,420,2,32,20,6,0,1,1,3,0,3,-1,2,1,2,0,2,2,0,2,0,9,-6,-3,-4,7,1,0,0,-1,-1,0,-1,5,-1
KR_6558122258,440,-1,-32,-12,8,-1,7,6,-2,2,0,0,2,2,5,0,5,6,0,6,0,9,-70,1,-2,1,31,0,-1,1,1,-1,1,6,-1
KR_6685492127,420,1,-44,4,-4,1,2,3,0,3,3,-3,3,0,-3,4,1,1,1,2,0,-5,3,0,-6,6,-4,0,1,-1,1,-1,-1,6,-1
KR_6762688045,420,-4,20,0,-7,-9,10,1,-1,2,1,3,2,5,0,1,1,0,4,4,0,-6,3,0,-5,5,-3,0,0,1,-1,0,1,1,-1
KR_6725434564,420,1,90,-8,1,-1,3,2,-3,4,1,1,2,3,3,1,4,1,0,1,0,2,14,7,-7,0,1,0,1,1,1,1,1,4,-1
KR_6754602618,420,2,7,-21,3,-2,3,1,-1,5,4,-1,1,0,4,3,7,3,0,3,0,8,-15,5,-7,2,-6,0,0,-1,-1,-1,1,1,-1
KR_6750446041,440,-2,46,-16,-5,1,2,3,-1,1,0,-6,7,1,-2,2,0,3,1,4,0,-10,-17,5,-9,4,4,0,-1,-1,-1,-1,1,5,-1
KR_6728672616,440,-1,-22,-5,-2,1,1,2,-5,5,0,2,0,2,-1,5,4,1,0,1,0,1,-5,-2,-4,6,1,0,0,1,1,0,-1,1,-1
KR_6761493237,420,-2,50,-22,-1,0,2,2,1,2,3,-1,1,0,-1,5,4,0,3,3,0,-1,3,4,-5,1,0,0,0,-1,0,0,-1,4,-1
KR_6759172310,420,-1,-25,1,-4,-2,3,1,0,3,3,-2,3,1,4,1,5,-4,5,1,0,2,6,-1,-5,6,-3,0,-1,0,1,-1,-1,0,-1
KR_6705348007,420,-6,-86,-25,-12,-4,5,1,-1,4,3,-6,7,1,-2,4,2,1,2,3,-1,-9,0,1,-3,2,-1,0,-1,0,0,-1,-1,0,-1
KR_6701117510,440,-2,-147,-30,-3,-3,4,1,-1,4,3,-2,2,0,5,1,6,-2,4,2,0,-2,159,0,-1,1,16,0,-1,-1,1,1,1,3,-1
KR_6754958328,420,-5,-50,0,-11,-3,5,2,0,2,2,0,1,1,-4,6,2,-4,5,1,0,-12,-225,-5,-1,6,-1,0,1,1,-1,1,-1,1,-1
KR_6764562886,420,1,22,11,2,-2,6,4,2,1,3,-1,6,5,2,1,3,1,1,2,1,3,285,0,-5,5,1,0,0,1,-1,0,1,3,-1
KR_6741633487,420,-2,-39,19,-7,-2,2,0,0,3,3,-6,7,1,4,0,4,-3,5,2,-1,-3,15,2,-7,5,-1,0,0,1,0,0,1,6,-1
KR_6755244570,420,1,-15,-20,1,0,2,2,1,2,3,0,1,1,1,4,5,-1,1,0,0,-4,-4,0,-4,4,-1,0,0,-1,-1,0,1,6,-1
KR_6742982198,420,1,28,-1,5,3,0,3,3,2,5,-1,4,3,0,3,3,0,1,1,2,3,4,-5,-1,6,2,0,1,1,-1,1,1,6,-1
KR_6696175273,420,-1,-32,-25,-10,-2,6,4,-1,2,1,0,4,4,-5,5,0,-2,2,0,-4,-19,-4,-3,-6,9,-6,0,-1,-1,-1,-1,-1,6,-1
KR_6703434057,420,-7,-83,-44,-17,-1,5,4,-3,5,2,-6,6,0,-5,6,1,-2,2,0,0,-12,-113,-4,-3,7,-4,0,0,-1,-1,-1,1,4,-1
KR_6753396850,420,-1,-45,-28,-4,-1,2,1,0,4,4,-4,4,0,0,2,2,1,0,1,0,1,-5,1,-4,3,-5,0,0,-1,1,0,1,6,-1
KR_6757587685,420,2,38,2,-6,3,2,5,-2,5,3,-2,3,1,-1,3,2,-4,4,0,0,-26,10,5,-10,5,-10,0,1,-1,-1,1,1,4,-1
KR_6696990137,420,-5,-72,4,-14,-7,7,0,0,2,2,-5,7,2,-1,3,2,-1,1,0,-2,-11,-11,1,-4,3,-1,0,0,-1,1,0,-1,3,-1
KR_6733236375,420,-4,-35,-16,-7,-1,3,2,-2,5,3,-4,5,1,2,3,5,-2,3,1,0,-2,-7,-3,-4,7,1,0,0,-1,0,0,-1,5,-1
KR_6763204393,420,-3,-28,-37,-9,-4,5,1,-1,3,2,-2,2,0,-2,3,1,0,1,1,0,-7,10,-3,-3,6,4,0,-2,-1,-1,-1,-1,4,-1
KR_6695029079,420,-2,-33,-12,3,-1,1,0,-1,2,1,-2,2,0,8,0,8,-1,1,0,1,3,7,0,-3,3,-3,0,1,0,-1,1,1,0,-1
KR_6760673799,420,-3,-43,-5,0,1,0,1,0,4,4,-2,3,1,1,3,4,0,0,0,0,2,-8,3,-6,3,0,0,0,-1,-1,0,-1,2,-1
KR_6740824594,420,-1,22,22,-5,3,0,3,-1,3,2,-6,6,0,-2,3,1,1,0,1,0,-4,5,5,-7,2,-2,0,0,-1,-1,0,-1,2,-1
KR_6733785255,420,0,-67,29,-5,-3,5,2,5,0,5,-2,4,2,-5,5,0,0,0,0,0,-1,1,2,-4,2,-6,0,-2,-1,1,-1,-1,6,-1
KR_6762234889,420,-2,-45,-8,-8,-5,6,1,1,1,2,-5,9,4,1,1,2,0,0,0,0,2,-20,1,-3,2,0,0,-2,1,-1,-1,-1,4,-1
KR_6756459111,420,0,33,8,3,4,1,5,-2,5,3,1,0,1,-1,2,1,1,1,2,0,-4,30,5,-9,4,-4,0,0,-1,1,1,1,3,-1
KR_6757116094,420,-1,-10,24,0,6,0,6,0,0,0,-3,4,1,-2,2,0,-1,2,1,0,-6,-5,1,-4,3,-4,0,0,1,1,1,1,3,-1
KR_6759790851,420,-1,-97,24,2,-1,3,2,3,2,5,-4,4,0,1,1,2,3,1,4,0,9,-5,-2,-3,5,8,0,0,1,-1,0,1,2,-1
KR_6732635585,420,-1,-22,31,-7,-3,3,0,2,2,4,-3,4,1,-4,6,2,1,1,2,-2,-18,-8,-2,-1,3,-3,0,-1,-1,1,-1,-1,5,-1
KR_6757930025,420,-4,10,-20,-12,1,0,1,-5,5,0,-3,4,1,-4,4,0,-1,1,0,0,-9,-18,-2,-5,7,-1,0,-1,-1,-1,-1,-1,3,-1
KR_6748175947,420,-2,-7,4,-1,-4,7,3,-1,2,1,-1,1,0,5,1,6,0,0,0,-1,2,-187,-1,-4,5,3,0,1,-1,-1,1,-1,1,-1
KR_6664577614,420,-2,-35,-8,-7,1,0,1,-3,4,1,-6,7,1,1,0,1,0,1,1,-1,0,-10,-1,-3,4,-2,0,-1,-1,1,-1,-1,1,-1
KR_6736972582,420,-2,-37,-16,-5,3,0,3,-5,7,2,1,3,4,-3,5,2,-1,1,0,0,-8,-16,-1,-6,7,0,0,0,-1,1,0,-1,5,-1
KR_6350115064,420,-3,-58,-5,-4,-4,4,0,-2,3,1,-3,3,0,7,1,8,-2,2,0,0,1,-521,2,-7,5,-3,0,-1,-1,0,-1,1,1,-1
KR_6689446181,420,-1,9,1,-12,2,0,2,-2,5,3,-5,5,0,-4,4,0,-3,4,1,-1,-23,-8,-3,-3,6,-1,0,-1,-1,1,-1,-1,3,-1
KR_6761039612,420,0,-38,-3,3,-2,3,1,5,1,6,-6,8,2,6,2,8,0,0,0,0,23,23,2,-5,3,-4,0,-1,1,-1,-1,-1,1,-1
KR_6614834400,420,-2,-79,13,-7,-2,3,1,-2,2,0,-2,4,2,-1,1,0,0,0,0,0,-14,-8,-1,-3,4,-1,0,-1,-1,1,-1,-1,1,-1
KR_6673474613,420,-8,-97,-24,-21,-2,3,1,-2,3,1,-2,3,1,-14,14,0,-1,1,0,0,-24,-7,-6,-3,9,-1,0,-3,-1,1,-1,-1,6,-1
KR_6694799469,420,-4,-13,-14,-4,1,0,1,0,1,1,-4,5,1,-1,4,3,0,1,1,0,-7,4,-1,-2,3,-2,0,0,-1,0,0,-1,4,-1
KR_6733407544,420,0,33,1,-3,0,0,0,3,0,3,-4,4,0,-1,4,3,-1,2,1,0,-5,5,-3,-2,5,-1,0,1,-1,0,1,1,5,-1
KR_6757689883,420,0,-32,34,-4,-2,2,0,4,0,4,-2,4,2,-1,3,2,-3,4,1,0,-5,-14,-2,-2,4,-1,0,1,-1,1,1,-1,5,-1
KR_6690823202,420,-5,-87,-24,-7,0,1,1,-2,4,2,0,2,2,-3,4,1,-2,3,1,0,-5,-4,4,-9,5,-4,0,-3,-1,-1,-1,-1,4,-1
KR_6657942321,420,0,-10,8,-4,-3,5,2,2,1,3,-1,3,2,-1,3,2,-1,1,0,0,-2,7,3,-4,1,-1,0,0,0,1,0,-1,0,-1
KR_6757184042,420,-1,-16,28,-3,2,1,3,0,1,1,-4,6,2,-1,1,0,0,0,0,0,-5,-12,-3,-1,4,2,0,-1,-1,-1,-1,1,4,-1
KR_6749442153,420,-1,-14,-4,5,5,2,7,1,1,2,-2,6,4,2,2,4,-1,1,0,-1,3,326,2,-3,1,-3,0,0,1,1,1,1,2,-1
KR_6729981339,440,1,-45,0,3,-4,4,0,3,2,5,8,0,8,-9,13,4,5,1,6,0,4,-4,0,-1,1,2,0,2,1,-1,-1,1,6,-1
KR_6757374721,420,-3,-91,-20,-4,4,1,5,-4,4,0,-3,3,0,-3,5,2,2,1,3,0,-5,-183,1,-2,1,0,0,0,-1,-1,-1,-1,1,-1
KR_6750716465,420,-1,-20,-12,-9,-6,7,1,-1,4,3,-1,2,1,-2,4,2,1,1,2,-1,-4,22,-1,-3,4,-4,0,-2,1,1,-1,-1,4,-1
KR_6749595826,420,-1,-3,0,-2,2,0,2,2,3,5,-4,4,0,-2,2,0,0,1,1,0,-3,-8,2,-7,5,-2,0,1,-1,1,1,-1,2,-1
KR_6700007753,420,-4,-82,-1,-11,0,0,0,-2,5,3,-4,5,1,-2,2,0,-3,4,1,0,-9,-8,-1,-3,4,-1,0,-1,-1,-1,-1,-1,5,-1
KR_6726327504,440,-3,-77,0,-10,-5,6,1,1,3,4,-2,3,1,-3,4,1,-1,1,0,-1,-8,-45,-1,-6,7,11,0,0,-1,1,-1,-1,1,-1
KR_6733205824,420,-2,-7,29,-4,-1,1,0,1,3,4,-4,5,1,1,1,2,-1,1,0,0,-1,0,-6,0,6,4,0,-1,1,-1,-1,-1,6,-1
KR_6746736920,420,-7,-139,-53,-11,0,0,0,-7,8,1,-2,3,1,-2,5,3,0,0,0,0,-9,9,2,-6,4,-3,0,-2,-1,1,-1,-1,3,-1
KR_6751992206,420,-5,-69,-40,-7,-5,5,0,-1,1,0,-4,4,0,0,3,3,3,1,4,0,-1,-299,-6,-4,10,2,0,-3,-1,-1,-1,1,1,-1
KR_6689444800,420,0,-15,28,0,1,3,4,4,3,7,-2,4,2,-1,2,1,-2,4,2,0,-3,2,-3,-1,4,2,0,0,-1,-1,1,1,3,-1
KR_6762349812,420,-2,-20,-29,-4,-1,3,2,0,2,2,1,2,3,-4,4,0,0,1,1,0,-1,16,-4,-5,9,-3,0,1,-1,1,1,1,6,-1
KR_6743081666,420,-9,-57,-13,-22,-1,4,3,-3,5,2,-9,10,1,-4,5,1,-5,6,1,0,-14,-158,-1,-2,3,-2,0,-3,-1,-1,-1,-1,6,-1
KR_6728724328,440,-3,38,-7,-12,-4,4,0,-3,3,0,-1,1,0,0,3,3,-4,5,1,0,-12,-11,-7,-2,9,0,0,-1,1,-1,-1,-1,1,-1
KR_6721080526,420,0,31,-8,-1,3,0,3,-1,2,1,1,1,2,-2,5,3,-2,2,0,0,-3,-246,2,-4,2,-1,0,0,-1,-1,-1,1,1,-1
KR_6743642200,420,2,51,30,-2,-3,3,0,-3,5,2,4,1,5,-1,1,0,1,3,4,0,-10,-1,-4,-3,7,3,0,1,-1,-1,-1,1,3,-1
KR_6628599697,420,2,22,-12,0,3,1,4,0,1,1,-1,5,4,-1,4,3,-1,1,0,0,2,191,1,-4,3,0,0,0,1,1,1,-1,5,-1
KR_6689202470,420,-2,-43,-16,-2,0,1,1,1,0,1,-1,2,1,-2,4,2,0,1,1,-1,-6,13,1,-7,6,-8,0,0,-1,0,0,-1,5,-1
KR_6752734142,420,-3,-14,-24,-5,1,1,2,-2,4,2,-2,3,1,0,1,1,-2,2,0,0,-2,-9,-2,-6,8,-2,0,0,-1,-1,0,-1,1,-1
KR_6751983073,420,-2,36,-28,3,-6,6,0,-2,2,0,4,0,4,6,0,6,1,0,1,0,2,-2,4,-5,1,2,0,-1,1,-1,-1,1,2,-1
KR_6552180520,420,-2,-58,-32,-8,0,0,0,-2,2,0,-1,1,0,-2,3,1,-3,3,0,0,-7,-3,2,-5,3,-4,0,-1,1,-1,-1,-1,1,-1
KR_6593275538,440,1,56,-2,-4,-2,2,0,-1,1,0,2,1,3,2,6,8,-5,10,5,0,-6,-378,2,-7,5,-1,0,0,-1,1,1,1,5,-1
KR_6760802141,420,-2,-36,0,0,4,2,6,3,1,4,1,3,4,-8,12,4,0,2,2,0,-6,-2,-1,-8,9,-2,0,0,1,0,0,1,2,-1
KR_6692671233,420,-3,-69,-4,-8,0,3,3,-2,3,1,1,2,3,-1,1,0,-6,8,2,0,-3,39,-3,-1,4,-21,0,0,-1,1,0,-1,1,-1
KR_6695254670,440,4,46,23,0,-3,4,1,1,1,2,-1,4,3,2,0,2,1,1,2,0,3,160,2,-3,1,14,0,0,-1,0,0,-1,4,-1
KR_6750225726,440,-1,26,-20,-5,-2,3,1,-2,3,1,3,0,3,-4,5,1,0,3,3,0,-7,-8,0,-4,4,1,0,0,-1,0,0,-1,1,-1
KR_6724694636,420,0,6,-38,7,2,1,3,3,2,5,-4,4,0,5,1,6,1,1,2,0,6,6,-2,-1,3,1,0,2,0,0,1,-1,0,-1
KR_6646468682,420,-2,15,-8,-12,0,2,2,0,2,2,-6,7,1,-4,5,1,-2,3,1,0,-8,-241,3,-6,3,15,0,-1,1,-1,-1,-1,3,-1
KR_6735180169,420,-7,-37,-60,-10,-1,1,0,0,6,6,-1,2,1,-5,5,0,-3,3,0,-1,-5,-124,0,-4,4,-1,0,0,-1,-1,-1,1,1,-1
KR_6708297738,420,-3,-15,-9,-4,2,2,4,-4,4,0,0,2,2,-1,1,0,-1,1,0,0,-14,-3,-2,-3,5,-5,0,-1,1,-1,1,-1,6,-1
KR_6652290823,420,0,12,-12,-3,0,1,1,5,1,6,-1,1,0,-6,7,1,-1,2,1,-1,-3,3,-1,-5,6,-1,0,-1,-1,0,-1,-1,2,-1
KR_6753499883,420,0,-34,-11,8,0,3,3,0,3,3,-3,3,0,10,2,12,1,3,4,2,12,-189,-2,0,2,-3,0,2,-1,1,1,1,5,-1
KR_6636342030,420,-8,-91,-36,-12,-1,4,3,0,1,1,-9,15,6,2,2,4,-4,5,1,0,-8,275,-4,-1,5,-2,0,-2,-1,-1,-1,-1,2,-1
KR_6678200517,420,0,-53,-9,1,2,1,3,1,1,2,-2,3,1,0,1,1,0,2,2,0,3,-7,3,-8,5,-3,0,0,-1,1,-1,-1,3,-1
KR_6733727395,420,-2,-66,-40,0,1,1,2,-2,4,2,2,0,2,0,2,2,-1,1,0,0,-1,-37,4,-5,1,31,0,-1,-1,-1,-1,1,6,-1
KR_6668467362,420,-2,4,30,-8,2,1,3,0,1,1,2,1,3,-6,8,2,-6,6,0,0,-8,33,4,-6,2,-24,0,-1,1,-1,1,-1,1,-1
KR_6705744120,440,-1,-55,-15,0,2,0,2,0,2,2,-2,2,0,0,2,2,0,3,3,0,-3,1,4,-6,2,-4,0,-2,1,-1,-1,1,6,-1
KR_6746310487,420,-4,-36,4,-11,0,3,3,-4,5,1,0,0,0,-6,7,1,-1,1,0,-1,-16,-12,-3,-4,7,1,0,-2,-1,-1,-1,-1,1,-1
KR_6749994757,420,-1,-71,-48,4,7,0,7,0,0,0,4,1,5,-6,7,1,-1,2,1,0,5,-6,-7,0,7,3,0,0,-1,0,-1,-1,4,-1
KR_6652325361,420,0,-23,40,1,1,0,1,2,2,4,2,0,2,-3,3,0,-1,1,0,0,-2,-2,0,-5,5,1,0,0,-1,0,0,-1,3,-1
KR_6679206306,420,0,40,-7,-2,-1,2,1,0,3,3,-2,3,1,3,4,7,-2,3,1,0,-1,-100,2,-9,7,-4,0,1,-1,-1,1,1,4,-1
KR_6645532946,420,-4,0,-15,-3,-2,3,1,0,1,1,-3,8,5,2,3,5,0,4,4,1,-1,5,0,-2,2,3,0,-1,-1,-1,-1,1,6,-1
KR_6627832672,420,-1,-16,-21,2,3,0,3,4,3,7,0,2,2,-5,7,2,0,0,0,0,3,1,0,-4,4,-2,0,0,-1,1,-1,1,4,-1
KR_6761099500,420,0,36,-10,-1,2,0,2,0,0,0,-2,3,1,0,1,1,-1,4,3,0,0,-12,5,-9,4,-3,0,0,-1,-1,0,-1,1,-1
KR_6763787993,420,-2,2,-16,-10,-3,3,0,-3,3,0,-1,5,4,-2,3,1,-1,2,1,-1,-4,96,-1,-3,4,0,0,0,1,-1,0,-1,1,-1
KR_6758291005,420,-2,-25,20,-2,-3,4,1,1,2,3,-2,6,4,3,0,3,-1,3,2,2,2,-10,-2,-2,4,0,0,0,-1,-1,-1,1,4,-1
KR_6757772412,420,-3,32,-4,-5,-1,1,0,1,1,2,-4,6,2,1,4,5,-2,2,0,0,-10,14,1,-4,3,1,0,1,-1,1,1,1,1,-1
KR_6764069130,420,-4,-9,-15,-7,0,2,2,-1,2,1,-3,6,3,-4,5,1,1,0,1,0,-10,-243,-3,-4,7,-1,0,1,-1,-1,-1,1,2,-1
KR_6698441915,420,3,46,28,2,3,0,3,-1,3,2,3,0,3,-1,2,1,-2,2,0,0,-3,6,3,-5,2,2,0,1,-1,1,1,-1,2,-1
KR_6622978610,440,0,-28,-10,4,1,2,3,3,2,5,5,0,5,-6,7,1,1,0,1,0,4,7,1,-6,5,-3,0,0,1,-1,-1,-1,2,-1
KR_6764262348,420,-6,-69,0,-12,0,1,1,-1,5,4,-10,11,1,-2,2,0,1,1,2,0,-10,-3,1,-3,2,-2,0,-1,-1,-1,-1,-1,5,-1
KR_6760223985,420,-1,78,-29,2,-2,2,0,1,3,4,0,1,1,3,5,8,0,1,1,1,-1,8,1,-4,3,-1,0,1,1,-1,1,1,4,-1
KR_6746446980,420,-3,-133,3,-2,-3,4,1,-2,3,1,0,2,2,-1,1,0,4,1,5,0,4,-26,-5,-1,6,1,0,-2,-1,-1,-1,1,2,-1
KR_6679124534,420,0,-13,20,-2,1,1,2,1,2,3,-6,8,2,2,0,2,0,0,0,0,-4,-15,-3,-4,7,-3,0,-1,-1,0,-1,-1,5,-1
KR_6727691853,420,-3,-60,-24,-10,-3,5,2,-4,4,0,-4,5,1,1,5,6,0,0,0,0,-1,-11,1,-2,1,-4,0,-3,1,-1,-1,-1,6,-1
KR_6749462475,420,1,8,44,-1,2,0,2,0,3,3,-1,4,3,-2,2,0,0,2,2,0,-8,180,-5,-1,6,1,0,3,-1,1,1,1,2,-1
KR_6743482730,420,-1,4,-23,-5,-2,4,2,-5,5,0,-2,3,1,2,3,5,2,0,2,0,-7,-14,-2,-4,6,-2,0,-1,-1,-1,-1,-1,6,-1
KR_6654112369,420,-4,-71,-28,-6,5,1,6,-2,4,2,-2,3,1,-6,7,1,-1,3,2,0,-9,-5,7,-9,2,-1,0,-2,-1,0,-1,1,4,-1
KR_6647432139,420,-5,-82,-31,-3,2,1,3,-1,1,0,-2,2,0,-1,1,0,-1,1,0,0,-3,-6,1,-5,4,-1,0,-1,-1,-1,-1,-1,3,-1
KR_6737505207,420,-2,-50,0,-3,-4,4,0,3,0,3,-1,3,2,-2,3,1,1,0,1,0,-2,27,4,-6,2,-6,0,0,1,-1,0,1,3,-1
KR_6669502725,420,-1,-60,33,0,0,1,1,0,5,5,0,2,2,1,2,3,-1,2,1,0,4,-2,0,-5,5,5,0,-1,1,-1,-1,-1,5,-1
KR_6745987146,420,-1,14,-2,-4,2,1,3,-2,2,0,-3,4,1,-1,5,4,0,0,0,-1,-4,162,0,-7,7,-4,0,0,-1,-1,-1,-1,3,-1
KR_6691889994,420,-1,-1,-2,-11,3,0,3,-2,4,2,-2,3,1,-8,9,1,-2,2,0,0,-14,0,-3,0,3,-1,0,0,-1,1,-1,-1,2,-1
KR_6740888854,420,1,39,-11,5,2,1,3,-1,4,3,-4,6,2,5,1,6,3,0,3,0,1,-4,-2,-2,4,2,0,1,0,1,1,1,0,-1
KR_6742207679,420,-6,-104,-20,-12,-1,5,4,3,1,4,-4,4,0,-7,10,3,-3,3,0,0,-2,-1,-1,-3,4,1,0,0,0,1,1,-1,0,-1
KR_6755761714,420,-3,12,-18,-4,0,1,1,1,3,4,-2,2,0,-6,6,0,3,1,4,0,-4,-4,-3,-5,8,-3,0,-1,-1,1,-1,1,6,-1
KR_6757334712,420,-4,-70,0,-12,-3,5,2,-3,4,1,-2,3,1,-6,6,0,2,0,2,0,-17,-58,-2,-3,5,24,0,-2,1,-1,-1,1,2,-1
KR_6752135558,420,-1,-45,-13,-4,-1,1,0,0,2,2,0,5,5,-3,3,0,0,2,2,-1,-5,5,-2,-1,3,2,0,0,-1,1,1,-1,2,-1
KR_6739694504,420,-4,-28,-4,-4,-4,4,0,2,0,2,-2,2,0,-1,1,0,1,0,1,-1,-1,49,-3,-1,4,5,0,0,0,-1,-1,-1,0,-1
KR_6726155590,440,0,-43,27,2,5,0,5,-5,6,1,-3,4,1,3,1,4,2,0,2,0,6,3,1,-2,1,-1,0,-1,1,1,-1,1,4,-1
KR_6761370911,420,0,51,0,-1,-1,1,0,0,1,1,-4,7,3,3,0,3,1,2,3,0,-4,-10,-1,0,1,0,0,0,-1,1,0,1,6,-1
KR_6762281951,420,5,97,8,6,5,3,8,0,2,2,-4,5,1,4,0,4,1,1,2,0,4,205,4,-5,1,14,0,1,1,0,1,1,6,-1
KR_6759026321,420,-2,27,10,-4,0,1,1,0,2,2,-2,3,1,-1,3,2,-1,1,0,0,-5,-13,0,-5,5,3,0,1,1,1,1,1,5,-1
KR_6761311298,420,3,22,0,6,3,0,3,6,1,7,-6,8,2,2,0,2,1,0,1,0,12,-7,-1,-4,5,5,0,0,1,1,0,-1,2,-1
KR_6754787810,420,-2,-109,-14,-8,0,1,1,-3,5,2,-2,4,2,-2,3,1,-1,2,1,0,0,-165,-5,-1,6,14,0,-2,-1,-1,-1,-1,5,-1
KR_6758904842,440,-2,35,-10,-2,0,2,2,-6,6,0,-2,3,1,8,3,11,-2,3,1,0,-4,3,-2,-4,6,1,0,1,1,-1,1,1,1,-1
KR_6754665034,420,-3,-92,-35,0,-4,4,0,1,0,1,3,1,4,0,3,3,0,0,0,0,1,33,2,-3,1,-2,0,0,1,0,-1,-1,6,-1
KR_6764707545,420,2,-11,-4,3,0,1,1,-6,6,0,3,0,3,8,1,9,-2,2,0,0,2,10,-4,-3,7,-5,0,0,1,-1,1,1,6,-1
KR_6760735107,420,-6,-42,12,-12,-1,1,0,-1,6,5,-5,6,1,-1,4,3,-4,4,0,0,-1,-11,-4,0,4,1,0,-3,-1,-1,-1,1,3,-1
KR_6649701834,420,-3,-43,24,-6,2,2,4,-1,3,2,-4,4,0,0,3,3,-3,4,1,0,-7,10,1,-5,4,-1,0,-2,-1,-1,-1,-1,6,-1
KR_6619651922,420,-1,33,-19,-2,2,2,4,-3,5,2,-1,2,1,-1,3,2,1,0,1,0,-4,-2,0,-5,5,1,0,0,0,-1,1,-1,0,-1
KR_6734705512,420,-3,-2,-8,-6,2,0,2,-8,9,1,0,1,1,0,1,1,0,1,1,1,-7,-104,0,-2,2,1,0,-1,1,-1,-1,1,3,-1
KR_6477479795,420,-1,1,-24,1,1,2,3,-2,4,2,0,3,3,0,3,3,2,2,4,0,-1,-6,-3,0,3,-4,0,0,-1,1,-1,1,6,-1
KR_6761098373,420,-3,-21,-12,-4,-2,4,2,0,4,4,-7,8,1,5,0,5,0,1,1,0,10,-2,-4,0,4,2,0,-1,-1,-1,-1,1,3,-1
KR_6762241143,420,-4,-76,40,-16,-7,7,0,-1,2,1,-6,8,2,-2,5,3,0,1,1,-1,-11,12,1,-3,2,0,0,0,-1,1,-1,-1,5,-1
KR_6660297028,420,-1,-51,23,-6,3,2,5,0,2,2,-1,1,0,-7,9,2,-1,2,1,-1,-7,-24,-4,-5,9,6,0,-1,0,-1,-1,-1,0,-1
KR_6764306442,420,-2,22,0,-4,-2,4,2,-3,3,0,-1,2,1,0,3,3,2,0,2,0,-2,7,4,-6,2,2,0,0,0,0,-1,1,0,-1
KR_6760754461,420,-5,-15,-24,-9,-7,7,0,0,2,2,-2,3,1,-1,3,2,1,1,2,-1,-3,-4,1,-4,3,0,0,0,0,-1,-1,-1,0,-1
KR_6597360544,420,-4,-31,0,-8,-5,6,1,-5,6,1,5,2,7,-3,5,2,0,1,1,0,-1,104,-2,-6,8,1,0,-3,0,-1,-1,-1,0,-1
KR_6743553382,420,1,-3,7,8,1,1,2,2,2,4,1,4,5,0,5,5,4,1,5,1,4,-32,3,-5,2,16,0,0,1,1,0,1,5,-1
KR_6646154013,420,-1,36,-10,-2,1,1,2,-2,3,1,-2,2,0,2,3,5,-1,5,4,0,-1,10,0,-4,4,1,0,-1,-1,1,-1,1,5,-1
KR_6758069501,420,-5,-18,-24,-15,-2,3,1,-9,10,1,0,3,3,-6,6,0,2,1,3,0,-16,61,1,-4,3,-2,0,-1,-1,-1,-1,-1,2,-1
KR_6735776305,420,-3,-65,5,-12,1,1,2,-8,10,2,-2,3,1,-2,4,2,-1,2,1,0,-20,-9,-4,-3,7,1,0,-2,-1,1,-1,1,4,-1
KR_6749009397,420,-2,20,-5,-5,-4,4,0,-4,4,0,1,2,3,2,2,4,0,1,1,0,-4,18,-2,-2,4,4,0,0,-1,-1,-1,1,1,-1
KR_6685133106,420,-3,-52,-56,-12,-5,5,0,-5,7,2,-1,3,2,0,3,3,-1,2,1,0,-7,-52,-2,-5,7,18,0,-2,-1,-1,-1,-1,5,-1
KR_6752736652,420,-2,-58,11,-8,0,1,1,-3,6,3,-2,3,1,0,4,4,-3,4,1,0,-11,-14,1,-3,2,0,0,1,-1,1,1,1,6,-1
KR_6745432794,420,-2,-46,14,-2,-2,4,2,0,4,4,-3,3,0,5,1,6,-2,3,1,0,1,91,0,-3,3,5,0,0,0,1,-1,-1,0,-1
KR_6652289613,420,4,26,-8,7,1,2,3,3,1,4,0,2,2,4,1,5,-1,1,0,0,12,-6,-1,-3,4,4,0,0,-1,0,1,-1,3,-1
KR_6732584693,420,0,-29,7,-2,2,0,2,-1,5,4,5,0,5,-2,8,6,-6,7,1,0,3,3,-3,-3,6,1,0,-1,-1,-1,-1,-1,3,-1
KR_6715109101,420,-2,-58,-61,-10,-1,2,1,0,1,1,-3,5,2,-5,6,1,-1,2,1,-1,-8,6,3,-7,4,-7,0,-3,-1,-1,-1,-1,3,-1
KR_6759590671,440,0,-33,-4,-3,-4,4,0,1,3,4,0,0,0,1,1,2,-1,1,0,0,2,-11,0,-6,6,2,0,0,-1,1,0,-1,5,-1
KR_6716206562,420,-6,-26,-27,-8,0,1,1,0,3,3,-6,7,1,0,1,1,-2,2,0,0,-8,-112,-2,-3,5,1,0,0,1,-1,0,-1,3,-1
KR_6742986096,420,-5,-86,-73,-10,-2,4,2,-3,4,1,-4,4,0,-1,1,0,0,1,1,0,-12,49,-2,-3,5,-3,0,-3,-1,-1,-1,1,4,-1
KR_6761415246,420,-1,-35,-3,-1,2,1,3,-3,4,1,-2,2,0,0,1,1,2,1,3,0,-1,-9,-1,-1,2,2,0,-2,-1,-1,-1,1,4,-1
KR_6720085532,420,-5,-62,-51,-7,-2,2,0,-5,6,1,1,4,5,-2,4,2,1,0,1,0,-12,112,-4,-4,8,7,0,-2,0,-1,-1,-1,0,-1
KR_6746677596,440,0,-26,-31,4,1,2,3,2,3,5,3,0,3,-2,2,0,0,0,0,0,3,51,0,-3,3,0,0,0,-1,1,-1,1,4,-1
KR_6761190648,420,-2,-14,-5,-8,-2,5,3,0,2,2,-9,10,1,2,1,3,1,0,1,0,-8,342,2,-5,3,-1,0,0,-1,1,0,1,3,-1
KR_6694844201,420,-3,-147,-27,-5,-1,4,3,-3,6,3,-4,5,1,2,2,4,1,1,2,0,-2,-2,1,-5,4,-3,0,-2,0,1,-1,-1,0,-1
KR_6710204727,420,-1,-9,9,-7,1,2,3,-2,5,3,-5,6,1,2,0,2,-3,3,0,0,-4,-4,2,-5,3,0,0,-1,1,-1,-1,1,3,-1
KR_6754567671,420,2,-9,-16,2,0,1,1,7,1,8,-4,5,1,-2,3,1,1,0,1,0,13,-4,1,-5,4,2,0,-1,1,-1,-1,-1,1,-1
KR_6696381201,420,-2,-49,-15,-3,2,1,3,-1,2,1,-2,4,2,-3,4,1,1,1,2,0,-1,5,-3,-1,4,4,0,-1,1,1,-1,-1,6,-1
KR_6679027958,420,2,41,-24,5,0,2,2,2,3,5,1,2,3,2,2,4,0,0,0,2,15,6,-4,-3,7,-2,0,1,-1,1,1,1,6,-1
KR_6652235800,420,-2,-47,-24,-6,1,1,2,1,3,4,-4,5,1,-1,2,1,-3,4,1,-1,-5,-25,-1,-4,5,4,0,-1,-1,1,-1,-1,5,-1
KR_6515955778,420,-9,-149,-56,-19,-2,2,0,-4,4,0,-3,3,0,-9,13,4,-1,2,1,0,-11,7,2,-3,1,0,0,-3,-1,-1,-1,-1,6,-1
KR_6764802446,420,0,-125,-9,-7,-6,8,2,3,0,3,-1,5,4,-3,3,0,0,2,2,0,-7,19,2,-7,5,-1,0,-1,-1,-1,-1,1,3,-1
KR_6634962999,420,-1,-5,-20,-2,3,0,3,1,2,3,-1,6,5,-2,4,2,-3,4,1,1,-2,-2,-2,-4,6,3,0,-1,1,1,-1,1,6,-1
KR_6754073720,420,-3,-100,-8,-4,-7,7,0,6,0,6,-3,6,3,-1,6,5,1,3,4,0,0,-6,1,-2,1,2,0,-1,-1,-1,-1,-1,3,-1
KR_6753321781,420,0,47,32,-5,0,3,3,-4,5,1,-2,3,1,2,2,4,-1,1,0,0,-10,23,-2,-3,5,-23,0,2,1,1,1,-1,6,-1
KR_6755454666,420,-1,-53,-4,-4,-6,6,0,-1,2,1,3,0,3,0,0,0,0,1,1,0,-6,1,3,-5,2,0,0,-1,-1,1,-1,1,4,-1
KR_6760624476,440,-1,-22,6,-6,2,0,2,-2,2,0,-4,4,0,-2,3,1,0,0,0,0,-11,9,-3,-3,6,0,0,1,-1,1,1,-1,6,-1
KR_6637306821,420,-3,-14,12,-6,0,1,1,1,2,3,-2,5,3,-2,3,1,-3,4,1,1,-11,1,1,-8,7,0,0,-1,-1,1,-1,1,5,-1
KR_6718532110,440,-4,-15,-40,-4,2,1,3,-2,5,3,2,2,4,-2,2,0,-4,4,0,1,-7,11,6,-7,1,-9,0,0,-1,1,-1,1,2,-1
KR_6739139519,420,1,-32,8,-4,-4,5,1,-1,4,3,1,3,4,-1,2,1,1,1,2,0,1,-18,0,-3,3,5,0,-1,0,-1,-1,-1,0,-1
KR_6733580596,420,-2,53,-6,-4,-1,2,1,-3,4,1,1,2,3,-1,3,2,0,0,0,0,-7,-3,1,-5,4,-1,0,1,-1,0,1,-1,2,-1
KR_6758977407,440,-3,-124,-29,-4,-9,9,0,6,1,7,-1,4,3,0,1,1,0,2,2,0,12,-552,3,-4,1,1,0,-3,1,-1,-1,-1,6,-1
KR_6753051644,420,-3,-24,-5,-11,0,1,1,-7,8,1,-1,8,7,-5,5,0,2,0,2,1,-1,-2,-2,-4,6,2,0,-2,-1,1,-1,1,6,-1
KR_6760592049,420,-4,-48,-12,-3,-2,4,2,0,2,2,-2,3,1,0,2,2,1,0,1,0,-1,9,-2,-2,4,-3,0,-2,1,-1,-1,-1,3,-1
KR_6760370922,420,-2,-61,-16,-7,-5,5,0,0,4,4,0,3,3,-4,7,3,2,2,4,-2,-2,11,-2,-3,5,3,0,-1,-1,-1,-1,-1,4,-1
KR_6644858418,420,-6,-43,-40,-13,-2,2,0,-2,3,1,-5,5,0,-1,1,0,-3,3,0,-1,-7,-51,-4,-2,6,19,0,-1,-1,1,-1,-1,2,-1
KR_5811315055,420,-5,-30,-11,-11,-4,4,0,-4,4,0,-3,4,1,2,1,3,-2,2,0,-1,-1,-234,-3,-1,4,1,-1,-6,1,-1,-1,-1,5,-1
KR_6634053524,420,-4,-43,-27,-5,-2,2,0,-3,4,1,1,2,3,-3,6,3,2,0,2,0,-9,-11,-4,-6,10,-2,0,0,0,0,0,1,0,-1
KR_6740744644,420,-3,7,-16,-6,1,1,2,-5,5,0,-1,4,3,0,2,2,-1,3,2,-2,-10,-275,1,-5,4,3,0,0,0,-1,-1,-1,0,-1
KR_6755216280,420,-3,35,-8,-9,-2,2,0,-2,4,2,2,1,3,-3,5,2,-4,7,3,0,-14,-9,2,-6,4,1,0,-2,0,-1,-1,-1,0,-1
KR_6637872943,420,1,-19,0,6,1,1,2,-1,2,1,5,1,6,0,1,1,1,0,1,0,0,178,0,-5,5,3,0,0,1,-1,0,-1,5,-1
KR_6756720048,420,2,34,8,1,6,2,8,-1,3,2,2,1,3,-5,6,1,-1,1,0,0,-6,0,-1,-4,5,1,0,1,-1,1,-1,1,6,-1
KR_6755623568,420,-2,-107,8,2,-3,3,0,3,0,3,3,3,6,-1,1,0,0,0,0,0,8,-16,1,-3,2,-1,0,0,-1,1,-1,1,1,-1
KR_6726740466,420,-2,-23,-11,-2,0,2,2,0,5,5,-2,4,2,0,4,4,0,3,3,0,-1,0,-2,-2,4,1,0,-1,1,1,-1,1,4,-1
KR_6684052110,420,-6,-39,1,-14,-3,3,0,-1,6,5,2,2,4,-6,7,1,-6,7,1,0,-11,-3,-1,-2,3,-3,0,-3,-1,-1,-1,-1,5,-1
KR_6759344519,420,-4,-66,-6,-7,1,2,3,-2,4,2,1,3,4,-4,5,1,-3,3,0,0,-8,59,-4,-2,6,-1,0,0,-1,-1,-1,1,3,-1
KR_6674426018,420,1,18,-28,-2,4,0,4,-6,8,2,0,2,2,0,2,2,0,1,1,-1,-8,-30,-2,0,2,-1,0,0,-1,1,-1,-1,3,-1
KR_6697541886,420,-2,4,-28,-12,0,0,0,-3,4,1,2,2,4,-3,5,2,-8,8,0,0,-6,42,4,-6,2,-38,0,0,-1,1,0,-1,6,-1
KR_6600562650,420,-3,-70,29,-11,1,1,2,-2,7,5,-4,5,1,-3,5,2,-3,5,2,-1,-16,-9,0,-3,3,6,0,-1,1,-1,-1,-1,6,-1
KR_6589709373,420,-1,-37,5,-5,-4,4,0,0,1,1,3,0,3,-5,6,1,1,0,1,0,-5,23,-3,-1,4,-7,0,-1,-1,-1,-1,-1,3,-1
KR_6696365768,420,-7,-113,-16,-17,-3,4,1,-10,11,1,0,2,2,-3,6,3,-1,3,2,1,-8,3,0,-3,3,-4,0,0,1,-1,-1,1,2,-1
KR_6749338355,440,-2,-53,-4,-6,-6,8,2,-2,2,0,-1,1,0,-2,2,0,5,3,8,-1,-9,-107,1,-6,5,-3,0,0,-1,-1,-1,-1,4,-1
KR_6764626117,420,0,4,1,1,-4,5,1,0,3,3,1,0,1,1,4,5,3,2,5,-1,2,-16,-1,-2,3,1,0,1,1,-1,1,-1,1,-1
KR_6758004837,420,1,-16,86,-4,4,0,4,-2,5,3,-7,7,0,-1,2,1,2,2,4,0,-7,-116,-3,-2,5,-3,0,0,1,1,0,1,1,-1
KR_6698797557,420,-4,-91,-24,-8,-8,9,1,1,3,4,0,1,1,-4,5,1,3,0,3,0,-4,19,2,-5,3,0,0,-2,-1,-1,-1,-1,5,-1
KR_6723226972,420,-1,-10,4,-5,-3,4,1,6,1,7,-4,4,0,-5,6,1,1,1,2,-1,0,-187,0,-4,4,-3,0,0,-1,0,0,-1,3,-1
KR_6698350912,420,2,-18,3,0,1,2,3,-4,6,2,0,3,3,1,2,3,2,0,2,-1,-1,1,3,-5,2,3,0,0,0,-1,0,-1,0,-1
KR_6758081637,420,-5,-119,-34,-10,2,1,3,-4,6,2,2,1,3,-5,7,2,-5,6,1,0,-5,7,2,-6,4,-8,0,0,-1,1,-1,-1,3,-1
KR_6761233732,420,3,61,17,5,0,4,4,-1,3,2,4,2,6,5,2,7,-3,4,1,1,5,6,0,-3,3,-3,0,-1,-1,-1,-1,1,2,-1
KR_6670553638,420,-3,-44,-24,-9,2,1,3,1,5,6,-1,2,1,-10,12,2,-1,1,0,-3,-21,-28,-4,-4,8,2,0,-1,-1,0,-1,-1,5,-1
KR_6757668830,420,0,4,-7,-8,4,3,7,-4,9,5,-3,3,0,-3,4,1,-2,2,0,-2,-3,52,2,-3,1,-23,0,0,-1,1,-1,-1,6,-1
KR_6708793234,440,-5,-44,-43,-11,-2,3,1,-2,3,1,0,1,1,-9,11,2,2,1,3,0,-11,-92,-1,-7,8,-19,0,-4,-1,0,-1,-1,6,-1
KR_6682454538,420,-1,55,12,1,-1,3,2,-2,4,2,-1,1,0,6,1,7,-1,2,1,0,0,-8,-3,-4,7,-1,0,1,0,1,1,1,0,-1
KR_6694383371,420,2,39,37,-4,1,3,4,1,1,2,-7,8,1,0,1,1,1,1,2,-1,-2,-4,-2,-1,3,-2,0,-1,1,1,1,-1,2,-1
KR_6760459241,420,-7,-92,-35,-10,0,1,1,2,3,5,-3,8,5,-7,8,1,-2,3,1,0,-7,-23,-2,-2,4,0,0,-1,-1,1,-1,-1,3,-1
KR_6678097528,420,-2,-48,4,-13,2,1,3,-3,6,3,-3,4,1,-5,5,0,-4,4,0,0,-17,-7,0,-6,6,6,0,-1,-1,-1,-1,-1,5,-1
KR_6638538036,420,1,33,15,9,0,3,3,9,2,11,-1,1,0,1,2,3,0,0,0,1,3,-8,2,-4,2,-1,0,0,1,1,0,1,2,-1
KR_6752483668,420,-1,10,4,-4,-2,3,1,-1,5,4,4,2,6,-5,5,0,0,0,0,0,-10,8,5,-7,2,0,0,0,-1,1,1,1,6,-1
KR_6619799185,420,-5,-41,-16,-11,-4,6,2,3,0,3,-3,5,2,-8,9,1,1,0,1,-1,-15,19,-3,-4,7,3,0,-2,-1,1,-1,-1,6,-1
KR_6761891186,420,0,-67,19,1,-6,7,1,1,1,2,2,1,3,2,2,4,2,1,3,0,1,-5,-2,0,2,0,0,-1,1,-1,-1,-1,5,-1
KR_6690226604,420,-4,-46,24,-4,-1,4,3,0,2,2,2,0,2,-4,5,1,-1,1,0,2,-3,-7,1,-6,5,-4,0,0,0,1,0,1,0,-1
KR_6745712099,420,-2,28,-7,-2,-2,5,3,-1,1,0,-1,2,1,1,2,3,1,2,3,0,-4,-21,-2,-4,6,1,0,-1,-1,-1,1,1,3,-1
KR_6704620228,420,2,61,32,-6,1,0,1,-5,6,1,0,1,1,-2,2,0,0,0,0,0,-11,-5,-2,-4,6,4,0,0,1,1,0,-1,4,-1
KR_6743659599,420,0,-13,-1,1,0,2,2,0,2,2,1,2,3,0,1,1,0,0,0,0,-1,-1,-3,-1,4,-1,0,0,-1,-1,-1,-1,6,-1
KR_5870406719,420,-5,23,-9,-5,0,2,2,0,0,0,-8,8,0,5,2,7,-2,2,0,1,-10,4,-1,-4,5,-6,0,-1,-1,-1,1,1,2,-1
KR_6608224406,420,-4,-62,-8,-12,-3,3,0,-1,5,4,-3,5,2,-2,5,3,-3,4,1,1,-3,9,5,-8,3,-3,0,-1,1,0,-1,1,5,-1
KR_6723358926,420,1,27,-31,5,0,3,3,0,2,2,1,1,2,3,1,4,1,2,3,1,10,7,3,-5,2,-6,0,-1,1,-1,-1,1,2,-1
KR_6498003831,420,-4,-47,-28,-7,-6,6,0,0,2,2,-2,3,1,2,1,3,-1,1,0,0,-4,-4,-3,-1,4,1,0,-2,-1,-1,-1,-1,4,-1
KR_6758620156,420,-1,-16,-16,-5,0,5,5,0,1,1,2,2,4,-5,6,1,-2,2,0,0,-9,-23,-3,-1,4,1,0,-3,-1,1,-1,-1,3,-1
KR_6658585601,420,-1,-30,-14,1,-4,5,1,1,1,2,4,2,6,0,2,2,0,0,0,0,8,4,-2,-4,6,0,0,-1,-1,0,-1,-1,3,-1
KR_6761118871,420,-3,-95,-16,-2,3,0,3,-2,6,4,-4,5,1,0,3,3,1,0,1,0,5,-282,-1,-2,3,0,0,0,-1,-1,-1,-1,4,-1
KR_6744856851,420,-2,4,4,-6,-1,1,0,-2,4,2,0,4,4,0,2,2,-3,3,0,0,0,-1,0,-2,2,1,0,-1,1,0,-1,-1,3,-1
KR_6758860811,440,2,50,11,0,2,1,3,-2,6,4,-1,1,0,2,0,2,-1,2,1,0,1,-30,-2,-3,5,9,0,0,0,-1,0,1,0,-1
KR_6698748844,420,-2,33,-12,-5,-1,4,3,0,0,0,-3,4,1,-1,2,1,0,3,3,0,-7,32,0,-6,6,-25,0,1,1,0,1,-1,4,-1
KR_6757244007,420,0,7,4,1,-2,3,1,0,3,3,0,0,0,2,2,4,1,0,1,0,2,-3,3,-5,2,0,0,0,1,-1,1,-1,1,-1
KR_6738999764,420,-3,-23,-39,-9,1,2,3,-1,3,2,-10,10,0,1,1,2,0,0,0,0,-6,-4,0,-3,3,-1,0,-1,0,-1,-1,-1,0,-1
KR_6763163705,440,-1,-35,21,-2,-3,4,1,1,1,2,1,1,2,-3,6,3,2,0,2,0,1,13,-2,-4,6,-3,0,-1,1,0,-1,-1,1,-1
KR_6750647657,420,-1,-10,-16,-6,5,0,5,0,3,3,-2,3,1,-5,7,2,-4,5,1,0,-4,5,-1,-3,4,-2,0,-1,-1,-1,-1,-1,1,-1
KR_6692395123,420,2,48,0,3,-2,2,0,1,1,2,-2,3,1,3,3,6,3,0,3,0,0,8,-1,-3,4,1,0,1,-1,1,1,-1,3,-1
KR_6740318968,440,2,-29,-28,2,2,0,2,3,2,5,-2,3,1,0,2,2,-1,1,0,0,0,-1,6,-9,3,-2,0,0,-1,-1,0,-1,6,-1
KR_6729734759,440,-3,30,-5,-7,3,1,4,-7,9,2,-2,4,2,-2,3,1,1,0,1,0,-7,-18,-3,-3,6,0,0,2,-1,0,1,1,2,-1
KR_6764149538,420,0,-4,-28,5,2,0,2,-1,4,3,-3,4,1,6,1,7,1,1,2,0,7,3,1,-5,4,4,0,1,-1,1,1,1,4,-1
KR_6675993891,420,-5,6,-13,-7,0,1,1,-3,3,0,-2,4,2,-2,3,1,0,0,0,-1,-15,166,0,-4,4,0,0,0,-1,0,1,-1,2,-1
KR_6754043418,420,-2,-4,-52,3,0,1,1,-4,5,1,1,2,3,2,3,5,4,0,4,2,12,129,0,-6,6,0,0,0,0,1,1,1,0,-1
KR_6719461929,420,0,-47,-24,3,-3,4,1,0,2,2,3,1,4,1,3,4,2,0,2,0,5,9,8,-9,1,-2,0,1,-1,-1,-1,1,5,-1
KR_6762359489,420,-1,43,8,-8,-2,4,2,0,2,2,1,3,4,-6,6,0,-1,2,1,0,-9,-18,-6,-1,7,5,0,0,0,1,0,-1,0,-1
KR_6694626570,420,-1,-33,-4,-3,-4,4,0,-3,4,1,1,1,2,1,2,3,2,0,2,0,-7,-3,-1,-3,4,0,0,0,0,-1,0,1,0,-1
KR_6695271437,420,-6,-28,-48,-18,-6,6,0,-1,1,0,-8,8,0,-3,4,1,0,0,0,0,-18,-1,-4,0,4,-11,0,-1,-1,-1,-1,-1,2,-1
KR_6751168672,440,-2,-93,-8,-9,-6,6,0,0,2,2,-1,2,1,-2,4,2,0,1,1,0,-4,-3,1,-3,2,6,0,-1,-1,-1,-1,-1,1,-1
KR_6734239407,420,2,23,15,5,5,1,6,1,3,4,0,3,3,-1,2,1,0,1,1,1,6,-1,2,-4,2,0,0,1,1,-1,-1,-1,1,-1
KR_6734807465,420,-2,-80,-24,1,2,1,3,-3,6,3,1,2,3,0,1,1,1,3,4,0,4,-117,-3,-2,5,3,0,-1,-1,0,-1,-1,5,-1
KR_6711220949,440,0,-52,12,5,4,1,5,0,9,9,-1,2,1,2,1,3,0,0,0,0,7,-5,-1,-3,4,-1,0,0,0,-1,-1,-1,0,-1
KR_6654525989,420,-2,10,12,-5,-2,2,0,-4,4,0,1,2,3,-1,2,1,1,1,2,0,-4,-3,1,-5,4,-3,0,-1,-1,0,-1,-1,3,-1
KR_6692538288,420,-2,-19,21,0,0,2,2,2,1,3,-1,3,2,-1,4,3,0,0,0,0,-2,-43,-2,-4,6,25,0,0,-1,-1,-1,1,6,-1
KR_6736055598,420,-1,-46,20,-4,-1,1,0,-1,4,3,-4,4,0,0,3,3,2,0,2,-1,2,13,-6,-1,7,-5,0,-1,1,1,-1,-1,6,-1
KR_6740462940,420,-3,21,-16,-6,0,2,2,5,0,5,0,2,2,-10,10,0,-1,1,0,-1,-6,-7,-2,-3,5,-2,0,0,-1,0,0,-1,2,-1
KR_6740986431,440,-5,-57,-36,-9,1,1,2,-4,4,0,2,1,3,-9,9,0,1,1,2,0,-12,-3,-2,-2,4,1,0,0,-1,-1,-1,-1,3,-1
KR_6664467344,420,-3,-56,2,-2,1,0,1,-5,5,0,3,1,4,-1,1,0,0,1,1,0,0,-8,2,-3,1,-1,0,0,0,-1,0,1,0,-1
KR_6720876974,440,-3,-41,-14,-10,0,1,1,0,4,4,-8,9,1,0,2,2,-2,2,0,0,-12,20,-1,-1,2,-20,0,-1,1,-1,-1,-1,5,-1
KR_6757713716,420,1,-86,39,1,-5,6,1,4,1,5,1,4,5,-1,2,1,2,2,4,1,13,-63,-1,-6,7,22,0,-2,1,0,-1,1,4,-1
KR_6763438810,420,0,27,-32,-2,0,1,1,1,0,1,0,2,2,-2,4,2,-1,1,0,0,0,26,7,-8,1,-5,0,1,-1,1,1,1,3,-1
KR_6735476444,420,-2,9,-3,-7,0,1,1,-2,4,2,-2,4,2,-1,3,2,-2,4,2,0,-2,-119,-2,-1,3,-5,0,-1,-1,-1,-1,1,2,-1
KR_6764535914,420,-3,-76,-10,-9,-3,3,0,-2,3,1,-1,6,5,-1,5,4,-2,2,0,0,-8,14,3,-4,1,1,0,-1,0,0,-1,-1,0,-1
KR_6758437755,440,-2,0,-7,-5,3,0,3,0,4,4,2,0,2,-3,5,2,-7,8,1,1,-12,4,0,-4,4,-1,0,-1,1,-1,-1,-1,5,-1
KR_6729336235,420,-2,-7,-25,-10,0,3,3,-2,2,0,-4,5,1,-3,6,3,-1,1,0,0,-6,-4,0,-5,5,-8,0,-1,-1,-1,-1,1,5,-1
KR_6758964984,420,-1,-1,-9,-6,2,2,4,-1,1,0,-3,3,0,-3,3,0,-1,1,0,0,-5,2,-1,0,1,-1,0,-1,-1,-1,-1,-1,5,-1
KR_6163508788,420,-1,-27,-11,-7,1,1,2,-6,7,1,0,2,2,-2,2,0,0,0,0,0,-8,-56,2,-5,3,-3,0,0,-1,-1,0,-1,4,-1
KR_6739028262,420,-3,-7,-13,-5,1,2,3,-2,4,2,-6,7,1,5,1,6,-3,3,0,2,2,-10,-6,-5,11,-1,0,0,1,0,0,1,4,-1
KR_6601544746,420,1,32,8,-2,2,1,3,-6,8,2,-4,6,2,6,0,6,0,0,0,-1,-2,-6,-3,-5,8,-1,0,0,-1,-1,1,-1,5,-1
KR_6742476332,420,-3,-19,-8,-10,1,0,1,-1,2,1,-5,7,2,-4,5,1,-1,1,0,0,-8,17,1,-3,2,-1,0,0,1,-1,0,1,2,-1
KR_6750911205,420,-5,-72,-8,-9,-2,4,2,-3,3,0,-6,7,1,1,3,4,1,1,2,0,-4,-14,1,-2,1,1,0,-1,-1,-1,-1,-1,4,-1
KR_6723279146,420,-2,-39,-2,-6,1,1,2,-2,4,2,2,2,4,-3,5,2,-4,6,2,0,-3,3,0,-5,5,-4,0,-2,1,-1,-1,-1,1,-1
KR_6657847809,420,-2,-61,-23,-4,-3,3,0,-1,5,4,1,0,1,-1,3,2,0,0,0,0,3,300,-1,-4,5,6,0,-1,1,-1,-1,1,1,-1
KR_6690742716,420,-6,-51,-4,-12,-3,5,2,-1,5,4,-1,2,1,-2,3,1,-5,7,2,-2,-14,2,-1,-1,2,-2,0,-1,1,-1,-1,-1,4,-1
KR_6730677262,420,-5,-61,12,-14,-3,4,1,-1,3,2,-3,3,0,-4,4,0,-3,3,0,0,-9,-9,-3,-3,6,-6,0,-3,-1,-1,-1,-1,3,-1
KR_6749660319,420,1,-46,1,2,1,0,1,2,2,4,-2,3,1,1,1,2,0,0,0,0,7,30,1,-2,1,-4,0,1,1,1,1,1,3,-1
KR_6750058405,420,-2,1,-4,-12,-2,3,1,-6,8,2,-3,3,0,2,3,5,-3,3,0,0,-15,-4,2,-5,3,-2,0,0,-1,-1,0,-1,5,-1
KR_6763467280,420,0,-38,12,-5,-1,2,1,1,2,3,-3,4,1,-1,1,0,-1,3,2,0,-2,-6,3,-3,0,0,0,1,1,1,1,-1,5,-1
KR_6759991704,440,-4,-20,-48,-7,-3,4,1,1,2,3,1,4,5,-3,7,4,-3,3,0,1,-1,11,5,-8,3,-5,0,-1,-1,-1,-1,1,2,-1
KR_6698925985,420,1,-59,-12,-3,1,1,2,2,1,3,-2,4,2,-1,3,2,-3,3,0,0,2,1,-1,-3,4,-1,0,0,1,-1,-1,-1,2,-1
KR_6616355519,420,1,-53,-4,7,3,1,4,2,0,2,-1,2,1,2,1,3,1,1,2,0,11,-2,-1,-4,5,0,0,-1,1,-1,-1,1,1,-1
KR_6755697952,420,-1,-25,-24,0,1,0,1,-1,3,2,-1,4,3,-1,2,1,2,0,2,1,5,-133,-4,-3,7,-1,0,0,0,-1,0,1,0,-1
KR_6762891236,420,-2,38,-20,-11,2,1,3,-5,5,0,-7,7,0,0,3,3,-1,2,1,0,-11,-17,-3,-2,5,0,0,0,0,-1,-1,1,0,-1
KR_6708274222,440,3,46,4,7,0,0,0,0,3,3,2,2,4,2,3,5,3,1,4,0,5,7,2,-4,2,-1,0,2,1,1,1,1,5,-1
KR_6751836507,420,2,25,24,3,-2,4,2,0,2,2,3,1,4,3,2,5,-1,2,1,0,-1,367,-1,-1,2,1,0,-1,1,0,1,-1,6,-1
KR_6692228289,440,2,24,-4,3,3,2,5,6,0,6,0,2,2,-5,9,4,-1,1,0,-1,-7,-2,-1,-4,5,3,0,0,-1,1,-1,-1,3,-1
KR_6732549629,420,-3,-38,-14,-1,-4,6,2,-2,4,2,0,4,4,2,5,7,3,0,3,1,1,1,2,-4,2,4,0,-1,1,-1,-1,1,3,-1
KR_6734745806,420,-4,-32,-12,-18,-3,3,0,0,6,6,-6,6,0,-5,5,0,-4,6,2,-2,-22,-5,-5,0,5,2,0,0,-1,1,0,-1,2,-1
KR_6752874310,420,-3,-2,20,0,3,0,3,2,1,3,-2,3,1,-1,2,1,-2,3,1,0,-6,-2,-3,-7,10,-7,0,-1,1,0,-1,1,5,-1
KR_6759887748,420,-2,-45,0,-5,-2,3,1,-1,3,2,0,2,2,-1,3,2,-1,2,1,0,-5,4,0,-2,2,0,0,-2,-1,-1,-1,1,4,-1
KR_6743070416,440,-1,-15,-6,-6,-1,2,1,-1,3,2,-1,2,1,-3,4,1,0,0,0,0,-8,3,-1,-2,3,-2,0,-2,-1,1,-1,-1,2,-1
KR_6753633303,420,-2,-70,7,-6,-1,2,1,0,2,2,-2,4,2,-3,5,2,0,1,1,0,-6,3,2,-4,2,3,0,-3,-1,1,-1,1,4,-1
KR_6720120796,420,-2,13,-8,-6,-2,4,2,0,1,1,-2,3,1,-2,4,2,0,1,1,0,-1,-2,0,-4,4,2,0,-1,-1,-1,-1,-1,1,-1
KR_6731381363,420,-4,-101,-23,-8,0,2,2,-1,4,3,-7,7,0,-2,4,2,2,0,2,0,-8,-3,-5,-2,7,-2,0,-2,-1,-1,-1,-1,5,-1
KR_6736512232,420,-3,-7,-14,-10,0,1,1,-4,6,2,-2,2,0,-4,4,0,0,1,1,0,-20,-9,-3,-4,7,-2,0,-1,-1,-1,-1,-1,4,-1
KR_6754623820,420,-5,-11,0,-13,0,1,1,-5,7,2,2,2,4,-10,10,0,0,1,1,0,-17,-9,-9,-2,11,-2,0,-1,-1,1,-1,1,1,-1
KR_6567838891,420,-1,-57,24,-6,0,3,3,-1,4,3,-5,5,0,-2,5,3,2,3,5,0,-3,-13,-4,-5,9,0,0,-2,1,0,-1,-1,4,-1
KR_6762713060,420,-3,-39,-44,-9,1,4,5,-3,4,1,0,2,2,-7,7,0,0,1,1,-1,-16,-2,-2,0,2,-2,0,0,1,-1,-1,-1,4,-1
KR_6759341159,420,6,108,22,10,1,2,3,6,0,6,-1,4,3,5,0,5,-1,1,0,0,0,230,-2,-2,4,3,0,1,1,1,1,-1,5,-1
KR_6764622147,440,-4,-22,-8,-5,2,1,3,-1,2,1,-3,5,2,-4,4,0,1,1,2,3,5,2,0,-5,5,3,0,-2,0,0,-1,1,0,-1
KR_6719276735,420,-2,40,-43,-1,0,1,1,-1,2,1,0,2,2,1,2,3,-1,2,1,0,-2,-6,-2,-4,6,3,0,0,-1,-1,0,-1,2,-1
KR_6757872133,440,-5,-71,12,-16,0,2,2,-4,6,2,1,2,3,-14,15,1,1,2,3,0,-22,24,-3,-1,4,-22,0,-3,0,1,-1,-1,0,-1
KR_6761661627,420,-6,-98,-28,-13,-3,3,0,-4,6,2,0,3,3,-5,6,1,-1,2,1,0,-10,-16,-2,-4,6,-2,0,-2,-1,-1,-1,1,5,-1
KR_6755523050,420,-1,25,-15,-1,0,3,3,2,0,2,-2,3,1,2,1,3,-3,3,0,-1,3,-1,-4,-4,8,1,0,-1,1,-1,-1,-1,3,-1
KR_6715620760,420,-1,1,-4,-9,2,0,2,-3,6,3,-8,9,1,1,5,6,-1,1,0,0,-2,-26,-1,-4,5,3,0,0,-1,-1,-1,1,1,-1
KR_6759348298,420,-9,-82,-108,-16,-1,1,0,-9,10,1,-7,8,1,1,2,3,0,2,2,0,-10,-2,3,-6,3,-9,0,-3,-1,-1,-1,-1,2,-1
KR_6744026894,420,-4,-73,-44,-5,-6,6,0,-1,2,1,0,4,4,2,1,3,0,2,2,0,4,-4,-2,-3,5,2,0,-3,1,-1,-1,-1,6,-1
KR_6760901415,420,-3,19,-14,-3,2,1,3,-1,3,2,1,3,4,-3,5,2,-2,2,0,0,-5,-18,5,-7,2,0,0,0,-1,0,-1,1,5,-1
KR_6738014583,420,0,2,-14,-4,0,0,0,-2,5,3,-2,2,0,0,1,1,0,1,1,0,-4,4,-1,-4,5,-1,0,0,0,0,0,-1,0,-1
KR_6650135093,420,-8,-23,-8,-17,-9,9,0,-4,5,1,-1,3,2,-3,3,0,0,1,1,-1,-10,2,1,-2,1,-1,0,-1,-1,-1,-1,-1,2,-1
KR_5830064874,420,0,-20,28,-7,3,1,4,-4,5,1,-7,9,2,0,2,2,1,1,2,0,-8,3,-5,-3,8,-8,0,0,-1,-1,-1,1,4,-1
KR_6757994498,420,2,29,34,1,0,1,1,-3,3,0,1,1,2,2,1,3,1,0,1,0,0,29,0,-1,1,0,0,1,0,1,1,1,0,-1
KR_6721397901,420,-5,-83,-4,-12,-1,2,1,-1,2,1,-1,4,3,-6,7,1,-3,4,1,0,-8,-10,-3,-2,5,2,0,-2,-1,1,-1,-1,5,-1
KR_6725713212,420,-2,-109,-3,-4,1,2,3,1,2,3,0,3,3,-5,6,1,-1,1,0,2,2,-22,0,-5,5,0,0,-1,-1,1,-1,1,2,-1
KR_6731173588,420,-2,-9,-31,-2,0,0,0,-2,6,4,-4,4,0,10,0,10,-6,8,2,0,4,38,1,-3,2,3,0,-1,-1,1,-1,-1,1,-1
KR_6679329466,420,-4,-80,-7,-11,-1,1,0,1,0,1,-3,4,1,-6,6,0,-2,2,0,0,-9,-7,-4,-1,5,-4,0,-1,-1,-1,-1,-1,1,-1
KR_6573492963,420,2,20,20,3,1,1,2,-8,9,1,3,1,4,5,0,5,2,2,4,1,-1,7,0,-2,2,0,0,1,-1,1,1,1,2,-1
KR_6759303615,420,-4,-72,-7,-12,-1,2,1,-10,10,0,1,0,1,-3,7,4,1,1,2,0,-6,88,0,-4,4,-1,0,0,-1,-1,-1,-1,2,-1
KR_6750363834,440,4,60,-4,11,0,3,3,2,3,5,3,1,4,1,0,1,5,1,6,0,13,0,-2,-1,3,6,0,1,-1,-1,1,1,3,-1
KR_6655811120,440,-1,-88,3,2,5,1,6,-2,4,2,1,3,4,0,0,0,-2,2,0,-1,6,-8,-2,-2,4,1,0,-1,1,1,-1,-1,6,-1
KR_6394294828,420,3,-35,9,4,-2,4,2,10,2,12,2,0,2,-2,2,0,-4,4,0,0,7,2,5,-9,4,1,0,1,1,1,1,-1,2,-1
KR_6633868312,420,-2,-32,-7,-2,-1,2,1,4,2,6,-2,4,2,-3,4,1,0,0,0,1,1,4,-2,0,2,1,0,0,1,0,0,1,1,-1
KR_6665045219,420,0,-13,35,3,0,1,1,-3,4,1,1,0,1,5,0,5,0,0,0,0,5,-14,-5,-5,10,7,0,1,1,-1,-1,1,1,-1
KR_6644690640,420,2,1,15,7,3,3,6,-8,9,1,8,0,8,2,1,3,2,0,2,1,3,4,-1,-1,2,-5,0,1,-1,1,1,1,5,-1
KR_6762134507,420,1,-40,12,-4,-4,5,1,1,1,2,-1,4,3,-2,3,1,2,0,2,0,1,20,-1,-1,2,-1,0,1,-1,-1,1,1,3,-1
KR_6745692789,440,-5,12,-12,-4,-2,3,1,4,3,7,-2,4,2,-2,4,2,-2,2,0,0,-5,-5,3,-4,1,1,0,-1,-1,0,-1,1,3,-1
KR_6755071279,420,-3,30,-9,-7,-4,4,0,0,3,3,0,1,1,-2,4,2,-1,3,2,0,-8,-27,1,-3,2,0,0,0,1,0,0,-1,5,-1
KR_6764073296,420,-1,33,4,-3,0,3,3,0,2,2,-1,4,3,-1,2,1,-1,1,0,0,-4,0,0,-3,3,-1,0,0,-1,0,0,1,5,-1
KR_6726255273,420,0,32,-8,3,1,1,2,4,0,4,3,0,3,-4,8,4,-1,2,1,0,7,-302,-2,-2,4,2,0,0,-1,-1,0,1,4,-1
KR_6761888109,420,-2,8,-28,-4,0,1,1,-3,4,1,-1,2,1,3,2,5,-3,3,0,0,-9,18,1,-4,3,-3,0,-1,-1,-1,-1,-1,5,-1
KR_6616383381,420,-2,-19,-8,-2,-5,6,1,2,1,3,-1,2,1,2,2,4,0,0,0,0,-4,-1,-2,-1,3,-2,0,-2,0,-1,-1,1,0,-1
KR_6737729738,420,-4,-82,0,-10,0,0,0,1,4,5,-3,4,1,-10,11,1,2,0,2,0,-7,0,-1,-2,3,2,0,-1,-1,1,-1,1,2,-1
KR_6740259267,420,1,-9,-16,0,0,3,3,1,0,1,0,1,1,-2,4,2,1,2,3,0,1,105,-1,-5,6,-2,0,0,-1,1,-1,1,6,-1
KR_6761240280,420,0,-45,-24,-6,5,2,7,0,2,2,-6,8,2,-5,5,0,0,1,1,1,0,28,1,-5,4,-4,0,-2,-1,-1,-1,1,2,-1
KR_6709795969,420,2,-30,-20,8,-1,4,3,1,1,2,0,3,3,6,0,6,2,0,2,0,10,-25,6,-9,3,-2,0,0,1,-1,-1,1,2,-1
KR_6601254829,420,-4,-37,-35,-12,-1,3,2,0,3,3,-7,7,0,-4,4,0,0,0,0,0,-3,-3,1,-4,3,2,0,-1,-1,-1,-1,-1,4,-1
KR_6763508481,420,-1,-31,21,0,0,1,1,5,0,5,-1,2,1,-2,4,2,-2,4,2,1,3,13,5,-9,4,-3,0,0,0,1,0,1,0,-1
KR_6604024520,420,-3,-50,-19,0,-5,5,0,5,1,6,2,4,6,-3,6,3,1,1,2,0,9,3,2,-4,2,0,0,0,1,0,-1,-1,4,-1
KR_6761306318,420,-6,-56,-20,-4,-2,5,3,3,0,3,-1,1,0,-3,3,0,-1,1,0,0,-2,7,-1,-2,3,-5,0,0,-1,1,-1,1,4,-1
KR_6689347780,420,-5,-43,-23,-13,-3,4,1,-6,7,1,-1,3,2,0,0,0,-3,4,1,0,-12,-3,-2,-4,6,-2,0,-2,-1,1,-1,-1,5,-1
KR_6693834779,440,-7,-64,-8,-11,-4,5,1,-7,7,0,-1,2,1,3,2,5,-2,3,1,0,-9,3,-5,0,5,4,0,0,1,1,0,-1,6,-1
KR_6715062501,420,-1,-7,-18,3,0,1,1,-2,2,0,0,3,3,2,1,3,3,1,4,0,7,-6,-2,-2,4,-1,0,0,1,-1,-1,1,3,-1
KR_6663690203,420,0,-18,-25,-1,-1,3,2,-2,4,2,-2,5,3,2,1,3,2,1,3,0,3,8,-2,-7,9,-1,0,-1,-1,-1,-1,1,5,-1
KR_6742119718,420,-2,-32,-36,-2,2,1,3,-2,3,1,-2,2,0,1,2,3,-1,1,0,0,4,4,-2,-2,4,3,0,-1,-1,-1,-1,-1,6,-1
KR_6736583546,420,-3,-71,12,-3,-1,1,0,-2,4,2,-1,2,1,-1,1,0,2,0,2,0,-5,11,4,-7,3,0,0,0,1,-1,-1,-1,4,-1
KR_6760090907,420,-3,-59,0,-4,0,1,1,-2,3,1,0,2,2,-2,3,1,0,0,0,0,-2,-9,-2,-1,3,-3,0,-1,-1,0,-1,-1,5,-1
KR_6667047702,420,-3,25,-35,-1,-2,2,0,-2,2,0,1,3,4,-1,3,2,3,0,3,0,2,0,-2,-5,7,4,0,0,-1,-1,0,1,6,-1
KR_6698813910,420,-2,-30,-12,-6,0,2,2,2,1,3,-1,1,0,-5,5,0,-2,2,0,0,-2,-18,3,-5,2,2,0,0,-1,-1,-1,-1,6,-1
KR_6760200859,420,0,10,-12,-2,-1,3,2,-1,1,0,1,6,7,1,4,5,-2,2,0,0,-8,115,-5,-1,6,2,0,0,1,1,0,-1,2,-1
KR_6722885700,420,-5,-65,-20,-4,1,1,2,-2,2,0,0,2,2,-3,5,2,0,1,1,1,-1,-1,4,-8,4,-3,0,0,-1,-1,-1,1,2,-1
KR_6756457455,420,-1,-35,-4,-6,-2,3,1,-2,5,3,-3,5,2,2,1,3,-1,2,1,1,-5,20,2,-4,2,-5,0,-1,-1,1,-1,1,2,-1
KR_6739578566,420,0,-30,-4,3,-2,2,0,-1,4,3,2,0,2,2,6,8,2,0,2,0,7,105,1,-8,7,-4,0,0,0,0,0,1,0,-1
KR_6721383682,420,0,-4,-19,-6,0,1,1,-1,3,2,-5,5,0,-2,4,2,2,0,2,-1,-5,1,-1,-4,5,-1,0,0,-1,1,0,-1,4,-1
KR_6762053859,420,0,-6,27,-2,-2,3,1,-1,3,2,6,0,6,-3,4,1,-2,3,1,0,-3,3,-4,-3,7,1,0,1,0,1,1,-1,0,-1
KR_6700063826,440,0,0,16,-10,-1,1,0,-5,5,0,-2,3,1,-3,5,2,1,0,1,0,-13,-1,2,-6,4,1,0,0,-1,1,0,-1,3,-1
KR_6672785365,420,-4,-26,-10,-10,-1,3,2,-5,6,1,-1,1,0,-2,4,2,-1,1,0,-2,-14,9,0,-5,5,0,0,-2,-1,-1,-1,-1,5,-1
KR_6750264489,420,-2,5,9,-4,1,0,1,-2,2,0,-1,2,1,-3,3,0,1,0,1,-1,-12,-111,-2,-3,5,-5,0,0,1,1,-1,-1,4,-1
KR_6749645411,420,0,-38,-21,1,1,2,3,-3,3,0,4,1,5,-1,3,2,0,1,1,-1,0,-19,-8,-1,9,3,0,0,1,1,-1,-1,1,-1
KR_6625392623,420,1,-49,11,1,0,0,0,4,0,4,-3,4,1,-1,2,1,1,1,2,0,3,-1,5,-9,4,-2,0,0,0,0,1,-1,0,-1
KR_6726489789,420,-7,-116,-8,-13,-4,6,2,2,2,4,-5,5,0,-2,2,0,-4,5,1,0,-15,2,2,-6,4,-7,0,-3,-1,1,-1,-1,2,-1
KR_6724166829,420,4,87,15,5,-1,2,1,-1,3,2,-2,3,1,10,0,10,-1,2,1,2,7,1,-2,0,2,1,0,-1,0,-1,1,1,0,-1
KR_6759314404,420,-2,-44,-22,-3,0,3,3,0,5,5,3,2,5,-5,6,1,-1,2,1,-1,-11,33,0,-4,4,-15,0,-1,1,-1,-1,-1,1,-1
KR_6761503245,420,-2,-104,-8,-4,-2,2,0,-3,4,1,4,1,5,0,3,3,-3,3,0,0,-10,2,0,-5,5,-3,0,0,1,-1,-1,1,2,-1
KR_6744736369,420,1,-52,-12,8,-2,5,3,1,4,5,7,2,9,0,3,3,2,1,3,0,13,1,5,-8,3,3,0,-2,1,1,-1,-1,5,-1
KR_6716167439,420,-2,-31,-12,-11,0,2,2,-2,4,2,-2,3,1,-8,9,1,1,1,2,-1,-15,-9,-5,-1,6,5,0,-1,-1,-1,-1,-1,2,-1
KR_6685252364,420,1,36,16,-2,-3,3,0,3,1,4,-1,3,2,-2,5,3,1,0,1,0,0,3,0,-1,1,0,0,1,1,0,1,1,6,-1
KR_6673799084,440,-1,-80,-22,-3,-1,4,3,0,1,1,2,1,3,-4,4,0,0,1,1,-1,-11,-9,-4,-3,7,-2,0,-1,-1,0,-1,-1,6,-1
KR_6744372925,420,-5,-104,-8,-11,-2,4,2,2,1,3,-6,7,1,-3,5,2,-2,2,0,0,-6,123,3,-5,2,0,0,-3,0,1,-1,-1,0,-1
KR_6744799947,420,-3,33,-1,-9,-5,5,0,-5,7,2,-3,5,2,3,4,7,1,0,1,0,-7,7,1,-6,5,2,0,-2,1,-1,-1,1,5,-1
KR_6672781542,420,-2,-79,-14,-3,0,0,0,2,5,7,-2,3,1,-3,4,1,0,1,1,0,-3,1,-4,-5,9,-3,0,-2,1,-1,-1,-1,5,-1
KR_6750552374,420,-2,16,-16,-3,-2,2,0,-3,6,3,4,0,4,-2,3,1,0,1,1,0,0,45,1,-3,2,1,0,0,0,-1,0,-1,0,-1
KR_6763602251,420,-3,-100,20,-9,1,0,1,-2,4,2,-6,6,0,-1,4,3,-1,1,0,0,-16,2,1,-5,4,-2,0,-1,-1,1,-1,1,4,-1
KR_6665984754,420,-3,11,-9,-11,-1,3,2,-2,3,1,-6,6,0,-2,4,2,0,0,0,1,-2,6,-4,-3,7,-4,0,-1,-1,-1,-1,1,3,-1
KR_6740960413,440,-2,-26,-4,-12,0,2,2,-5,6,1,-3,3,0,-2,3,1,-2,2,0,-2,-22,27,-2,-1,3,1,0,-1,-1,1,-1,-1,2,-1
KR_6731821500,420,-2,-146,-26,-1,-4,5,1,1,1,2,6,4,10,-2,3,1,-2,2,0,-1,-4,-20,4,-7,3,2,0,-1,-1,-1,-1,1,3,-1
KR_6664366096,420,-1,-36,-10,2,-3,3,0,1,1,2,2,2,4,1,1,2,1,3,4,0,6,8,-2,-3,5,4,0,0,-1,-1,-1,1,5,-1
KR_6762142971,420,-3,47,-19,-1,0,2,2,2,1,3,-4,4,0,2,3,5,-1,1,0,0,0,1,-2,-3,5,0,0,0,-1,-1,0,1,4,-1
KR_6726580738,440,-3,-30,-32,-9,1,0,1,2,1,3,-1,2,1,-7,7,0,-4,4,0,0,-9,88,1,-2,1,-2,0,-1,-1,-1,-1,-1,6,-1
KR_6761331683,420,-12,-112,-21,-18,-5,6,1,-2,4,2,-11,12,1,1,0,1,-1,2,1,0,-15,19,-3,-1,4,-32,0,-3,-1,-1,-1,-1,3,-1
KR_6757952077,420,1,-57,28,-2,1,2,3,-5,6,1,1,1,2,-1,2,1,2,0,2,-1,-5,18,-1,-2,3,-2,0,-1,1,-1,-1,-1,6,-1
KR_6697685768,420,-1,28,-13,-1,1,0,1,0,4,4,0,3,3,1,2,3,-3,3,0,0,-1,7,5,-7,2,-1,0,0,-1,1,-1,1,4,-1
KR_6729656062,420,-2,4,-20,-1,-2,2,0,-2,4,2,-2,3,1,4,1,5,1,0,1,0,3,1,1,-4,3,2,0,-1,1,1,-1,1,4,-1
KR_6739252707,420,0,-27,0,-3,-2,3,1,-2,2,0,-3,3,0,4,0,4,0,0,0,0,-3,4,-3,-3,6,-2,0,-1,1,-1,-1,1,3,-1
KR_6702934948,420,-3,4,-26,-13,-1,3,2,-3,6,3,-5,5,0,-3,5,2,-1,1,0,0,-8,17,-7,-4,11,-12,0,-2,1,-1,-1,-1,4,-1
KR_6755002584,420,-3,-44,-12,-5,1,1,2,1,1,2,-5,5,0,-1,2,1,-1,1,0,1,-4,-16,1,-3,2,1,0,0,-1,0,0,1,6,-1
KR_6724724922,440,1,59,-28,2,-1,2,1,0,1,1,4,2,6,-1,3,2,0,1,1,0,3,-3,-1,-4,5,2,0,0,1,-1,0,1,3,-1
KR_6760923037,420,1,-79,-4,6,-1,2,1,1,1,2,2,2,4,3,1,4,1,2,3,0,16,5,-1,-3,4,-1,0,0,1,0,0,-1,5,-1
KR_6673234270,420,-3,-101,-12,-3,0,4,4,-3,5,2,-3,8,5,4,4,8,-1,1,0,-1,3,148,2,-3,1,0,0,0,-1,-1,-1,-1,2,-1
KR_6763445804,420,-1,-27,-16,-9,-3,4,1,1,0,1,-6,6,0,-1,3,2,0,6,6,-1,-7,-366,-3,-1,4,1,0,1,-1,1,-1,-1,3,-1
KR_6695645584,440,2,21,-28,10,-3,4,1,-2,2,0,5,0,5,6,0,6,4,0,4,0,14,10,4,-8,4,-3,0,0,1,-1,-1,1,5,-1
KR_6503486981,420,-6,-96,-8,-2,1,1,2,-2,2,0,2,0,2,-3,3,0,0,1,1,0,-5,-11,-6,-1,7,-1,0,-3,-1,-1,-1,1,6,-1
KR_6628986197,420,-1,-53,10,2,1,1,2,-2,3,1,3,0,3,-2,3,1,2,0,2,0,4,10,0,-3,3,1,0,-1,-1,-1,-1,1,6,-1
KR_6737195547,420,-7,-75,-25,-11,-1,2,1,-3,5,2,1,1,2,-9,10,1,1,0,1,1,-10,1,-1,-1,2,1,0,-3,-1,-1,-1,1,2,-1
KR_6763602552,440,-5,-36,-65,-4,1,2,3,-1,4,3,-1,2,1,0,3,3,-3,3,0,0,-1,1,4,-10,6,-2,0,-1,1,-1,-1,-1,4,-1
KR_6762627639,420,-4,-14,16,-8,-1,2,1,-1,2,1,-4,4,0,-3,4,1,1,0,1,0,-8,293,-2,-3,5,-2,0,-1,1,-1,-1,-1,4,-1
KR_6657333147,420,0,-1,-4,-1,-2,3,1,3,2,5,0,6,6,1,3,4,-3,4,1,-1,2,31,2,-4,2,-20,0,-1,0,-1,-1,-1,0,-1
KR_6637788561,420,0,-12,0,2,-2,3,1,2,1,3,-1,4,3,2,1,3,1,0,1,0,8,3,0,-4,4,2,0,0,0,1,-1,-1,0,-1
KR_6623941945,420,-4,-48,8,-15,-5,6,1,-7,9,2,-1,5,4,-1,4,3,-1,2,1,0,-5,6,3,-5,2,-3,0,-2,1,-1,-1,-1,1,-1
KR_6738599179,420,-5,-82,-28,-9,-3,4,1,-2,3,1,0,2,2,-4,4,0,0,0,0,-1,-11,-4,-1,-4,5,-5,0,-2,-1,-1,-1,-1,6,-1
KR_6728362119,420,-5,-104,-8,-8,-7,7,0,-4,4,0,1,1,2,1,1,2,1,0,1,0,-3,-13,-7,-1,8,3,0,-1,1,-1,-1,-1,2,-1
KR_6743455298,420,-2,44,-7,-1,1,2,3,-10,13,3,6,1,7,2,3,5,0,3,3,0,0,-9,-1,-5,6,-4,0,1,0,1,1,1,0,-1
KR_6760707312,420,-3,-19,7,-7,0,2,2,-2,4,2,-1,3,2,-4,4,0,0,0,0,0,-8,-81,0,-2,2,20,0,0,-1,-1,-1,1,1,-1
KR_6757138577,440,-7,-68,0,-24,1,0,1,-12,12,0,-2,2,0,-1,5,4,-10,10,0,-1,-12,0,0,-7,7,0,0,-1,-1,-1,-1,-1,3,-1
KR_6759993153,440,-4,-41,-32,-11,2,0,2,0,0,0,-4,7,3,-10,10,0,1,0,1,0,-4,-317,0,-3,3,-4,0,-1,-1,-1,-1,-1,2,-1
KR_6759400536,420,3,-5,8,0,3,0,3,3,1,4,-2,4,2,-1,3,2,-3,4,1,0,-5,-124,2,-5,3,0,0,0,-1,-1,0,-1,2,-1
KR_6697185871,420,0,-23,-4,1,-3,4,1,5,0,5,3,0,3,-2,3,1,-2,3,1,0,0,6,4,-5,1,0,0,-1,1,1,-1,1,6,-1
KR_6756550581,420,-4,-27,-16,-6,-3,5,2,-1,4,3,0,3,3,0,2,2,-2,3,1,0,-8,5,-2,-1,3,-2,0,-2,-1,-1,-1,1,1,-1
KR_6746705077,420,-5,-21,8,-9,2,1,3,-2,3,1,-6,6,0,-2,4,2,-1,1,0,0,-6,116,-4,-3,7,-3,0,-2,-1,1,-1,-1,1,-1
KR_6763206286,420,1,-37,-22,-1,2,1,3,1,4,5,-3,3,0,0,2,2,-1,1,0,0,-4,-7,-2,-5,7,2,0,0,0,0,0,1,0,-1
KR_6762853703,420,-1,0,-4,-4,-5,7,2,0,6,6,2,2,4,-1,2,1,0,0,0,-1,-3,-350,4,-4,0,1,0,-1,1,1,-1,-1,1,-1
KR_6652087211,420,0,66,-8,1,0,3,3,2,2,4,4,0,4,-2,3,1,-3,3,0,0,-1,-4,3,-7,4,5,0,0,-1,-1,0,-1,2,-1
KR_6672288583,420,-1,62,-17,-9,1,0,1,-2,5,3,1,1,2,-8,10,2,-1,1,0,0,-12,-4,-4,-3,7,4,0,-1,1,0,-1,1,4,-1
KR_6738390802,440,3,46,13,3,2,0,2,1,2,3,-4,7,3,3,2,5,1,2,3,-1,-7,-10,1,-1,0,-1,0,2,-1,1,1,-1,3,-1
KR_6726132151,440,-2,-57,-2,-9,-2,5,3,-4,4,0,0,3,3,-2,3,1,-1,2,1,0,0,-8,-4,0,4,-1,0,-1,-1,0,-1,1,5,-1
KR_6650123379,420,-1,-93,-20,3,1,2,3,1,3,4,0,3,3,1,1,2,0,1,1,0,10,-2,-1,-3,4,3,0,-1,-1,-1,-1,-1,3,-1
KR_6746925955,420,1,2,8,17,-1,2,1,-1,3,2,8,0,8,10,0,10,1,0,1,0,21,-44,3,-6,3,31,0,0,1,-1,-1,1,3,-1
KR_6761659391,420,-3,-34,-27,-8,-9,9,0,-4,4,0,-3,3,0,8,0,8,0,0,0,0,9,-258,-3,-1,4,0,0,-1,0,0,-1,1,0,-1
KR_6679224979,420,-2,-115,9,-7,0,1,1,-2,5,3,-6,7,1,-1,3,2,2,0,2,-1,-10,11,2,-5,3,-1,0,-1,-1,0,-1,-1,5,-1
KR_6698723811,420,-2,-8,-20,-5,2,1,3,-1,2,1,-2,4,2,-3,6,3,-1,1,0,0,-13,-3,-2,-6,8,1,0,0,-1,1,0,1,6,-1
KR_6726463028,420,-2,-33,-27,-2,3,1,4,-3,3,0,0,2,2,-2,3,1,0,0,0,-1,-5,0,3,-7,4,-5,0,1,-1,-1,1,-1,5,-1
KR_6756772722,440,1,-18,-6,0,-5,6,1,3,1,4,0,0,0,8,4,12,-6,6,0,-1,-4,-10,-3,-1,4,0,0,1,1,-1,-1,-1,1,-1
KR_6655349789,420,0,29,-12,0,2,0,2,-1,6,5,1,2,3,-1,4,3,-1,2,1,0,-3,-13,-3,-5,8,2,0,0,-1,-1,0,1,1,-1
KR_6737443449,420,1,50,3,4,1,2,3,-2,4,2,-1,2,1,3,5,8,3,1,4,0,4,-35,3,-7,4,26,0,1,1,-1,-1,1,1,-1
KR_6761874559,440,-3,-63,-4,-1,-1,2,1,0,1,1,-3,5,2,3,2,5,0,0,0,1,3,1,0,-3,3,-1,0,-1,1,1,-1,1,5,-1
KR_6747222145,420,-2,-43,4,-7,-1,2,1,5,0,5,-6,6,0,-4,4,0,-1,1,0,0,-2,11,-6,-1,7,-5,0,-1,-1,0,-1,1,2,-1
KR_6759049399,440,-2,-54,-28,-2,2,1,3,3,0,3,-1,2,1,-4,6,2,-2,3,1,0,-6,0,-3,-2,5,0,0,-1,1,1,-1,1,4,-1
KR_6697304940,420,-1,32,-12,-6,-3,4,1,1,3,4,-2,2,0,-3,4,1,1,1,2,0,-6,-12,-3,-3,6,1,0,-1,0,-1,-1,-1,0,-1
KR_6737391607,420,0,-61,0,-5,-1,1,0,2,1,3,2,1,3,-6,7,1,-2,2,0,0,-8,1,0,-4,4,-1,0,-1,-1,1,-1,-1,4,-1
KR_6693633071,420,4,-18,28,0,1,2,3,0,2,2,4,1,5,-3,4,1,-2,2,0,0,-6,-13,0,-4,4,0,0,0,1,1,0,-1,6,-1
KR_6760244499,420,-6,-123,-21,-14,-1,4,3,-1,3,2,-5,5,0,-7,8,1,0,1,1,-1,-13,4,0,-6,6,-4,0,-3,-1,-1,-1,-1,2,-1
KR_6679109259,420,2,-39,-8,8,2,0,2,0,1,1,8,0,8,-2,6,4,0,0,0,0,1,6,-3,-6,9,-2,0,1,-1,1,1,1,5,-1
KR_6747877160,420,-1,-79,8,-4,-1,3,2,-1,2,1,-2,3,1,1,1,2,-1,3,2,0,-1,-114,-1,-2,3,-1,0,-2,-1,-1,-1,1,4,-1
KR_6762094698,420,-1,-1,-4,-2,0,1,1,-1,1,0,-1,1,0,-1,2,1,1,0,1,0,2,-46,0,-3,3,36,0,-1,1,0,-1,1,4,-1
KR_6762194757,420,0,-19,6,2,6,3,9,1,0,1,0,2,2,-5,5,0,0,0,0,0,-5,-8,1,-5,4,3,0,0,-1,-1,1,1,1,-1
KR_6726381505,440,-4,-59,-16,-8,1,1,2,1,2,3,-2,3,1,-5,5,0,-3,3,0,0,-6,11,1,-5,4,-7,0,0,-1,0,0,1,2,-1
KR_6682541544,420,-1,-4,35,0,1,2,3,-1,3,2,-1,1,0,1,1,2,0,3,3,0,2,-103,-2,-4,6,-1,0,1,-1,-1,1,1,1,-1
KR_6635944727,420,-1,-48,-4,-2,2,0,2,1,3,4,-7,7,0,1,3,4,1,0,1,1,7,-30,0,-4,4,19,0,0,-1,1,-1,1,1,-1
KR_6715139254,420,1,46,11,2,2,3,5,-2,4,2,2,1,3,0,2,2,0,2,2,0,1,-18,-5,-1,6,-1,0,-1,1,0,-1,-1,4,-1
KR_6741648785,420,-4,-83,8,-16,-2,2,0,-2,5,3,-2,3,1,-6,11,5,-4,4,0,0,-19,3,-3,-2,5,-3,0,-1,-1,-1,-1,-1,6,-1
KR_6729822275,420,-2,-17,-25,-1,-2,2,0,-4,6,2,3,0,3,3,1,4,-1,1,0,0,2,-9,-1,-7,8,2,0,-1,-1,-1,-1,-1,2,-1
KR_6683625391,420,0,25,7,-4,-1,2,1,0,2,2,0,1,1,0,3,3,-3,5,2,0,-3,-7,-6,0,6,3,0,-1,0,-1,-1,1,0,-1
KR_6711910446,420,-6,-121,-91,-7,-6,6,0,-1,3,2,1,1,2,-2,3,1,1,1,2,0,-2,0,2,-3,1,-3,0,-3,-1,-1,-1,1,1,-1
KR_6655872165,420,-8,-93,-33,-23,-11,11,0,-2,4,2,-4,4,0,0,1,1,-6,6,0,0,-9,4,-1,-1,2,0,0,-2,-1,0,-1,-1,1,-1
KR_6721595174,420,-4,-146,51,-7,-3,3,0,-3,4,1,2,0,2,-2,4,2,-1,1,0,0,-11,-20,-4,-2,6,-2,0,-1,1,-1,-1,-1,6,-1
KR_6725179479,420,-3,14,-25,-11,-2,3,1,-3,5,2,-5,5,0,0,1,1,-1,3,2,0,-5,337,2,-4,2,-2,0,-1,-1,1,-1,-1,6,-1
KR_6581541533,420,-1,-23,-20,-10,-7,8,1,-7,8,1,2,2,4,4,0,4,-2,2,0,-1,-7,-238,-3,-3,6,0,0,-1,-1,1,-1,-1,3,-1
KR_6737048179,420,1,-16,16,1,-1,2,1,-2,3,1,0,1,1,-1,1,0,5,0,5,0,2,0,-4,-2,6,-7,0,1,-1,1,1,-1,1,-1
KR_6756882892,420,-1,42,-28,-8,-4,5,1,-3,4,1,-1,2,1,-2,3,1,2,0,2,-2,-7,-6,-2,-2,4,-1,0,0,1,-1,0,-1,5,-1
KR_6623210077,420,-4,-83,-12,-3,-1,2,1,4,0,4,4,1,5,-9,9,0,-1,1,0,0,-9,16,-2,-1,3,-8,0,-1,-1,1,-1,1,5,-1
KR_6721656261,420,-8,-58,-96,-10,-1,1,0,-6,6,0,-6,6,0,0,1,1,3,1,4,-1,-5,-5,-4,0,4,1,0,-4,-1,-1,-1,-1,4,-1
KR_6745560654,420,-1,-48,20,-5,3,1,4,-2,2,0,-5,6,1,-1,2,1,0,1,1,0,-6,4,6,-8,2,-2,0,0,1,1,-1,1,5,-1
KR_6762700447,420,4,16,16,9,2,0,2,-2,3,1,3,2,5,4,0,4,2,0,2,0,4,-5,-6,-2,8,1,0,2,-1,1,1,1,5,-1
KR_6715546465,420,1,-10,-8,-3,-1,2,1,-4,7,3,-2,2,0,6,0,6,-2,2,0,-1,-1,5,-1,-4,5,-4,0,0,-1,-1,0,-1,4,-1
KR_6609181176,420,1,-1,-2,-2,0,0,0,-1,1,0,-3,3,0,2,1,3,0,0,0,0,-1,2,-3,-2,5,-3,0,0,0,0,0,1,0,-1
KR_5822596505,420,0,-18,38,3,-2,3,1,6,1,7,1,1,2,-2,4,2,0,3,3,0,4,12,5,-8,3,-5,0,-1,0,0,-1,1,0,-1
KR_6756892731,420,-3,-113,-19,-5,-1,2,1,-1,3,2,-4,4,0,0,4,4,1,0,1,0,-1,-3,1,-4,3,0,0,0,-1,-1,0,-1,5,-1
KR_6657567100,420,3,105,8,6,2,1,3,-1,2,1,-3,4,1,5,2,7,3,0,3,0,7,-36,3,-7,4,5,0,0,0,-1,0,-1,0,-1
KR_6713639267,420,-4,-25,-20,-16,-2,4,2,0,1,1,-6,6,0,-7,8,1,-1,3,2,1,-8,-6,-5,0,5,0,0,-3,0,-1,-1,1,0,-1
KR_6752856467,420,4,-10,4,4,4,2,6,3,2,5,-2,3,1,-2,3,1,1,1,2,0,4,124,-3,-1,4,0,0,1,1,1,1,1,5,-1
KR_6760372368,420,-1,-57,25,1,-2,4,2,3,2,5,0,1,1,2,1,3,-2,2,0,0,4,-109,-3,-4,7,-1,0,0,-1,-1,0,-1,4,-1
KR_6727792356,420,-2,-61,-37,-5,-2,4,2,2,2,4,-3,7,4,-1,1,0,-1,1,0,0,0,-1,-3,-5,8,-2,0,-2,-1,-1,-1,1,3,-1
KR_6760858511,420,-2,-66,-8,-7,-4,5,1,-1,2,1,4,1,5,-6,10,4,0,1,1,0,-17,-9,-2,-3,5,-3,0,-1,1,-1,-1,1,1,-1
KR_6759084754,420,-2,6,-28,-4,-5,5,0,1,1,2,0,1,1,0,1,1,0,0,0,0,0,-2,-1,-5,6,4,0,-1,-1,1,-1,1,2,-1
KR_6762118358,420,-2,50,-28,-2,1,2,3,-1,2,1,-6,6,0,1,1,2,3,0,3,0,1,12,0,-4,4,-2,0,0,-1,1,-1,1,5,-1
KR_6761906001,440,-3,-55,-20,-13,2,1,3,-11,12,1,-1,1,0,0,2,2,-3,4,1,-1,-17,-23,1,-5,4,5,0,-2,0,-1,-1,-1,0,-1
KR_6738408854,420,-2,-5,-40,-1,-1,2,1,2,1,3,1,2,3,-4,5,1,1,1,2,0,4,-16,2,-5,3,-3,0,-1,0,-1,-1,-1,0,-1
KR_6726395258,420,-2,13,-20,-7,-1,3,2,-4,6,2,-4,4,0,3,0,3,-1,2,1,0,-7,-9,-3,-3,6,-3,0,-1,1,-1,-1,-1,1,-1
KR_6763871551,420,-5,-54,-31,-16,0,0,0,-1,3,2,-2,2,0,-10,12,2,-3,3,0,0,-14,-47,-1,-4,5,0,0,0,-1,-1,-1,-1,2,-1
KR_6760745914,420,1,3,16,-4,3,2,5,-1,2,1,2,2,4,-7,9,2,-1,1,0,0,-12,5,3,-8,5,1,0,-1,-1,-1,-1,1,1,-1
KR_6651900134,420,1,-35,-7,-3,3,0,3,0,3,3,-3,4,1,-2,4,2,-1,1,0,0,-1,2,-2,-8,10,-1,0,-1,-1,-1,-1,-1,6,-1
KR_6762462128,420,0,-37,-4,2,1,2,3,-2,2,0,1,1,2,1,0,1,1,1,2,0,1,2,3,-5,2,2,0,0,0,-1,0,1,0,-1
KR_6727331901,420,-1,-31,-17,3,0,4,4,1,1,2,0,1,1,0,5,5,2,0,2,0,1,4,0,-4,4,-2,0,1,-1,1,1,1,4,-1
KR_6646898047,420,0,1,-8,5,2,0,2,2,1,3,-1,3,2,1,0,1,1,0,1,0,7,0,-3,-2,5,-2,0,0,0,0,0,1,0,-1
KR_6764618915,420,-1,59,-5,-7,2,2,4,-3,5,2,-3,6,3,-2,4,2,-1,1,0,0,-10,0,6,-9,3,-3,0,-1,-1,-1,-1,1,4,-1
KR_6723496900,420,-5,-17,-24,-8,-1,2,1,-3,4,1,4,1,5,-5,5,0,-3,3,0,0,-9,3,-1,-1,2,3,0,-1,0,0,-1,1,0,-1
KR_6742364880,420,-4,-77,-9,-4,-3,3,0,8,0,8,-3,4,1,-2,5,3,-4,7,3,0,-5,-1,-1,-4,5,-1,0,-1,-1,1,-1,1,3,-1
KR_6759853858,420,0,-69,-5,2,1,1,2,-1,3,2,0,1,1,1,0,1,1,1,2,0,4,14,4,-7,3,1,0,0,1,0,0,-1,2,-1
KR_6696294103,440,-2,7,-42,-2,0,0,0,2,0,2,1,1,2,-5,6,1,0,0,0,0,-2,-6,-5,-1,6,-3,0,0,-1,-1,0,1,5,-1
KR_6743953164,420,-2,-15,-23,-9,-2,3,1,0,0,0,-3,5,2,-4,8,4,0,1,1,0,-12,-5,4,-8,4,-6,0,-3,-1,-1,-1,-1,1,-1
KR_6705630896,420,-3,-44,-20,-9,-1,3,2,-2,4,2,-2,2,0,0,4,4,-4,5,1,0,-9,-15,-9,0,9,1,0,-1,-1,-1,-1,-1,3,-1
KR_6597641980,420,-3,-61,-3,-4,-4,4,0,5,0,5,4,2,6,-6,6,0,-3,4,1,0,-2,187,2,-3,1,1,0,-3,-1,-1,-1,1,4,-1
KR_6764129726,420,-8,-85,-40,-16,-8,10,2,0,3,3,-6,8,2,3,1,4,-5,5,0,0,-5,-4,-2,-1,3,1,0,-2,1,-1,-1,-1,4,-1
KR_6617488107,420,0,24,-4,2,2,1,3,-4,6,2,0,1,1,2,1,3,2,0,2,0,0,1,-1,-7,8,2,0,1,-1,-1,1,1,2,-1
KR_6761568406,440,0,-38,12,4,1,4,5,1,1,2,4,1,5,-1,2,1,-1,2,1,1,3,-6,-2,-1,3,1,0,1,1,1,1,1,4,-1
KR_6752720731,420,-1,1,-32,-5,0,1,1,-4,5,1,1,2,3,-2,2,0,0,1,1,-1,-9,-35,-3,-4,7,-3,0,0,-1,-1,0,-1,3,-1
KR_6764040903,420,-4,-97,0,-6,2,2,4,-2,4,2,0,0,0,-6,7,1,0,1,1,1,-4,4,9,-9,0,-5,0,0,-1,1,-1,1,3,-1
KR_6689237465,420,1,13,-36,7,2,2,4,3,4,7,1,2,3,-1,6,5,2,0,2,1,12,24,2,-4,2,-3,0,1,-1,-1,1,1,3,-1
KR_6764546667,440,-2,52,32,-10,3,1,4,-1,2,1,-4,6,2,-4,6,2,-4,4,0,0,-12,-26,-4,-5,9,1,0,0,-1,1,0,-1,3,-1
KR_6715009428,420,0,-7,-7,1,-4,4,0,-3,3,0,5,1,6,2,1,3,1,0,1,0,-5,4,0,-6,6,-1,0,0,0,-1,0,1,0,-1
KR_6600238706,420,-2,-80,-20,-1,0,3,3,-1,1,0,-3,6,3,4,3,7,-1,2,1,0,8,-2,0,0,0,2,0,-3,-1,-1,-1,-1,5,-1
KR_6727926542,420,-3,-104,39,-5,-1,1,0,5,1,6,-5,5,0,-2,3,1,-2,3,1,0,-4,-27,-1,-2,3,1,0,-2,-1,-1,-1,-1,4,-1
KR_6740310965,440,-1,-68,5,3,-2,2,0,0,1,1,-4,5,1,8,0,8,1,3,4,0,-4,-2,-1,-2,3,1,0,-1,-1,1,-1,1,3,-1
KR_6737710178,420,4,0,8,6,2,0,2,0,3,3,5,1,6,-1,4,3,0,1,1,0,10,-158,-6,-1,7,-1,0,1,-1,1,1,1,1,-1
KR_6761737157,420,-4,-45,-20,-8,-4,5,1,0,5,5,-3,4,1,0,2,2,-1,4,3,0,-1,360,0,-5,5,0,0,-1,-1,1,-1,-1,6,-1
KR_6724975720,420,2,1,-8,8,6,1,7,-5,7,2,3,2,5,3,1,4,1,0,1,0,7,3,3,-4,1,-2,0,2,1,1,1,-1,3,-1
KR_6673369500,420,5,53,40,8,1,0,1,0,5,5,2,3,5,4,3,7,1,2,3,1,4,-13,0,-5,5,7,0,1,0,1,1,-1,0,-1
KR_6658674450,420,-3,3,-8,-5,-10,10,0,4,1,5,2,0,2,1,2,3,-2,2,0,0,-4,56,5,-7,2,-14,0,-1,-1,1,-1,-1,4,-1
KR_6760337074,420,1,9,9,3,1,0,1,3,3,6,-1,1,0,-3,6,3,3,1,4,0,9,13,4,-6,2,0,0,0,-1,1,-1,-1,2,-1
KR_6712642281,440,-8,-130,14,-18,-3,3,0,-1,3,2,-10,10,0,-1,4,3,-3,3,0,0,-14,6,0,-3,3,-4,0,-3,1,-1,-1,1,3,-1
KR_6755091381,420,-2,-48,5,-2,0,0,0,4,1,5,-2,4,2,-4,6,2,0,0,0,0,2,-8,1,-4,3,-1,0,0,0,-1,-1,1,0,-1
KR_6758390339,420,4,44,53,5,-4,4,0,-1,3,2,1,2,3,7,2,9,2,2,4,0,13,7,3,-6,3,6,0,1,1,1,1,1,2,-1
KR_6753897007,420,-2,-12,-8,-5,3,0,3,3,0,3,-8,8,0,0,7,7,-3,3,0,1,-1,-3,5,-8,3,-4,0,0,-1,1,1,1,4,-1
KR_6763262480,440,-2,-121,8,-6,-4,5,1,2,0,2,-3,3,0,0,1,1,-1,3,2,0,-4,2,-1,-3,4,-5,0,-1,1,-1,-1,-1,4,-1
KR_6299859264,440,-4,-23,20,-11,-4,5,1,-2,4,2,-4,5,1,-1,5,4,0,1,1,1,-9,8,5,-7,2,-4,0,-2,0,0,-1,1,0,-1
KR_6681683478,420,-3,-8,-13,-5,4,2,6,-2,2,0,-5,5,0,-1,1,0,-1,2,1,0,-6,-6,-3,-4,7,1,0,-1,-1,0,-1,-1,3,-1
KR_6725486712,420,-1,-56,-8,-1,8,0,8,-4,4,0,2,2,4,-5,8,3,-2,3,1,-1,2,-15,-3,-2,5,3,0,0,-1,1,1,-1,2,-1
KR_6692435841,440,-3,-58,20,-10,-2,2,0,2,0,2,-1,1,0,-8,8,0,-1,3,2,-1,-7,-230,-3,-3,6,35,0,-1,-1,-1,-1,-1,2,-1
KR_6763492784,420,-2,-69,-27,-2,-2,3,1,3,2,5,-4,5,1,2,0,2,-1,1,0,0,2,17,-2,-1,3,-2,0,-1,1,-1,-1,1,2,-1
KR_6696234958,420,-1,-66,-28,0,-1,1,0,0,2,2,5,0,5,-1,2,1,-3,4,1,-1,3,95,3,-4,1,-3,0,-1,-1,-1,-1,-1,1,-1
KR_6729030448,420,0,-11,16,-3,-1,1,0,-4,7,3,2,1,3,1,3,4,-1,1,0,0,0,16,1,-6,5,-1,0,0,1,1,0,-1,5,-1
KR_6732153711,420,0,-45,8,-3,-2,2,0,-2,3,1,-4,6,2,2,1,3,3,0,3,0,-5,2,-1,-3,4,-1,0,-1,-1,-1,-1,-1,4,-1
KR_6666918448,420,0,-17,-20,-2,2,1,3,0,2,2,-3,4,1,0,1,1,-1,2,1,1,4,-3,0,-4,4,-1,0,0,-1,0,0,1,5,-1
KR_6742788672,420,0,-26,-24,4,-6,7,1,1,0,1,-2,4,2,5,0,5,6,1,7,0,8,-7,3,-8,5,7,0,0,1,-1,-1,-1,3,-1
KR_6647023046,420,-4,-39,-8,-8,-6,6,0,1,3,4,0,1,1,-4,5,1,1,0,1,0,-12,12,0,-4,4,-3,0,-1,1,-1,-1,-1,6,-1
KR_6647882226,420,-1,-10,-28,-5,-3,5,2,0,1,1,-2,2,0,0,1,1,0,1,1,-1,-2,-25,-4,-2,6,2,0,-1,-1,-1,-1,-1,1,-1
KR_6682906756,420,-4,-2,-32,-13,-1,3,2,-7,9,2,-1,1,0,-2,4,2,-2,2,0,-1,-13,4,3,-6,3,-4,0,-1,-1,-1,-1,-1,2,-1
KR_6600603218,420,-3,-25,-13,-4,-1,1,0,-6,7,1,0,2,2,1,3,4,2,1,3,0,-5,6,3,-5,2,1,0,0,1,0,0,-1,5,-1
KR_6744610977,420,1,-27,0,-2,-2,2,0,0,4,4,0,1,1,0,1,1,0,0,0,0,1,10,4,-5,1,-1,0,1,1,1,1,-1,1,-1
KR_6682758232,420,1,8,20,0,3,0,3,-4,6,2,3,0,3,-2,3,1,0,2,2,0,-8,1,-3,-2,5,4,0,0,0,1,-1,-1,0,-1
KR_6636370441,420,0,-56,15,-5,-1,3,2,-2,4,2,-3,5,2,-1,1,0,2,2,4,0,-1,23,0,-3,3,-3,0,0,1,-1,-1,1,1,-1
KR_6633983393,420,0,-7,-20,2,-5,5,0,-2,5,3,4,1,5,6,1,7,-1,2,1,0,-1,21,-1,-4,5,0,0,0,1,-1,-1,-1,1,-1
KR_6753034330,420,-1,19,-2,-6,4,0,4,1,1,2,-4,5,1,-8,9,1,1,1,2,0,-10,-4,1,-4,3,-2,0,-1,-1,1,-1,-1,3,-1
KR_6722522588,420,-3,-27,-21,-7,0,1,1,-3,5,2,0,3,3,-1,1,0,-3,3,0,0,-8,-2,-2,-5,7,1,0,-1,-1,-1,-1,1,4,-1
KR_6678763857,440,-2,-58,-5,-2,0,1,1,-4,4,0,0,4,4,2,2,4,0,1,1,0,-7,44,-1,-5,6,-2,0,0,-1,0,0,-1,2,-1
KR_6636035723,420,-7,-98,-10,-13,-3,4,1,-6,9,3,-2,3,1,-2,3,1,0,2,2,0,-10,-18,-4,-3,7,-5,0,-2,1,-1,-1,-1,2,-1
KR_6733748325,420,1,-1,-16,2,1,1,2,-1,4,3,1,2,3,1,3,4,0,0,0,0,1,26,0,-4,4,-29,0,-1,-1,-1,-1,1,3,-1
KR_6748017549,420,-5,2,-14,-12,-3,4,1,-2,4,2,-4,4,0,-2,6,4,-1,1,0,0,-5,191,1,-5,4,-3,0,0,-1,-1,-1,1,2,-1
KR_6756403033,420,-2,-22,-8,-5,0,1,1,0,2,2,-3,4,1,-4,6,2,2,0,2,0,-5,265,1,-4,3,-3,0,-1,-1,-1,-1,-1,3,-1
KR_6761156598,420,-3,-41,7,-10,-6,6,0,-6,8,2,4,1,5,-1,2,1,-1,1,0,0,-6,-70,-1,-6,7,4,0,-1,-1,-1,-1,-1,2,-1
KR_6747260551,420,-5,-64,-28,-5,2,1,3,-2,3,1,1,1,2,-6,6,0,0,1,1,1,-9,4,2,-5,3,-2,0,0,1,1,0,1,1,-1
KR_6744770644,420,-1,-31,-12,0,-5,6,1,0,1,1,1,5,6,2,2,4,2,1,3,0,1,-2,0,-4,4,-1,0,-1,1,-1,-1,1,6,-1
KR_6664037395,440,-3,-33,-28,-10,-5,7,2,1,2,3,-5,7,2,-2,2,0,1,2,3,0,-1,0,-2,-3,5,6,0,-2,0,-1,-1,-1,0,-1
KR_6744143231,420,-3,-69,43,-13,7,0,7,-5,6,1,-2,4,2,-9,10,1,-4,6,2,-1,-24,-1,-4,-2,6,-2,0,1,1,-1,1,-1,5,-1
KR_6725631684,420,-7,-77,-35,-10,-4,5,1,2,1,3,-3,4,1,-3,5,2,-2,3,1,0,-9,-10,-1,-4,5,-2,0,-1,1,1,-1,-1,5,-1
KR_6763064951,420,0,-20,-24,1,-2,4,2,-1,3,2,4,2,6,-2,2,0,2,1,3,0,0,-5,0,-2,2,-2,0,0,1,0,-1,1,6,-1
KR_6299799545,440,-2,2,7,0,-4,4,0,-1,4,3,2,0,2,3,3,6,0,1,1,0,9,6,0,-3,3,-3,0,-1,1,0,-1,-1,5,-1
KR_6636254893,420,0,49,-9,-1,-1,1,0,0,2,2,-1,2,1,0,0,0,1,0,1,0,2,6,5,-5,0,-1,0,0,1,1,0,-1,4,-1
KR_6747363686,420,-3,-26,-8,-11,-2,3,1,4,1,5,-8,8,0,-2,5,3,-3,3,0,-1,-14,3,-3,-1,4,-4,0,0,-1,-1,0,-1,1,-1
KR_6654411821,420,-2,-16,-22,-11,0,1,1,-2,2,0,-6,9,3,-2,2,0,-1,1,0,0,-11,-288,-2,-5,7,-1,0,0,1,0,-1,-1,1,-1
KR_6681464726,420,0,34,26,0,2,2,4,2,2,4,1,0,1,-5,6,1,0,1,1,0,-2,-3,0,-3,3,4,0,0,1,-1,0,1,3,-1
KR_6685542005,420,-1,-20,20,-3,2,0,2,-1,2,1,-1,2,1,-2,2,0,-1,3,2,0,-5,19,3,-5,2,0,0,0,-1,1,0,-1,6,-1
KR_6749952904,420,-1,-15,-6,0,1,0,1,-4,4,0,2,1,3,0,0,0,1,0,1,0,-4,-8,-2,-1,3,2,0,-1,1,-1,-1,-1,1,-1
KR_6755837594,420,-1,-46,8,-6,-1,1,0,0,3,3,-3,7,4,-3,3,0,1,0,1,0,-1,-210,-9,0,9,-21,0,-1,-1,-1,-1,-1,1,-1
KR_6762138112,420,-1,2,0,-6,-7,8,1,-1,1,0,0,2,2,0,1,1,2,1,3,0,1,-5,-2,-1,3,1,0,-2,1,-1,-1,-1,4,-1
KR_6708848240,440,0,-4,-8,-5,-3,4,1,-1,3,2,-1,1,0,1,2,3,-1,2,1,0,-3,-5,-2,-4,6,-2,0,0,1,0,0,-1,6,-1
KR_6761995262,420,-3,-23,-38,-10,-1,1,0,-3,4,1,-2,4,2,-3,3,0,-1,2,1,0,-13,-22,-4,-2,6,3,0,1,1,-1,1,-1,2,-1
KR_6762716640,420,0,-22,4,-3,1,1,2,-2,6,4,0,5,5,-2,4,2,0,0,0,0,-4,1,-4,-2,6,-2,0,0,1,-1,-1,1,6,-1
KR_6760488781,420,-3,-82,22,-10,2,2,4,-5,7,2,-4,4,0,-4,7,3,1,1,2,0,-1,-194,0,-2,2,-4,0,-2,0,-1,-1,-1,0,-1
KR_6557644567,440,-2,-109,-8,-12,-5,5,0,-3,3,0,-4,4,0,-1,4,3,1,1,2,-2,-11,-1,-4,-1,5,1,0,-3,-1,1,-1,-1,1,-1
KR_6685669836,420,0,-11,-4,-3,-2,2,0,0,2,2,1,1,2,-4,4,0,2,0,2,0,-9,14,6,-8,2,-2,0,0,1,-1,0,1,6,-1
KR_6756709625,420,-1,-1,5,-2,4,1,5,-3,4,1,-2,4,2,-1,7,6,0,2,2,0,-9,4,1,-6,5,0,0,-1,-1,-1,1,1,6,-1
KR_6750631776,420,3,107,-14,6,1,1,2,0,1,1,-3,4,1,3,1,4,5,0,5,0,0,45,3,-5,2,-37,0,2,0,0,1,1,0,-1
KR_6698529229,420,-1,34,-21,-8,1,0,1,-2,4,2,-5,5,0,1,3,4,-3,4,1,0,-8,-80,-5,-5,10,-4,0,0,-1,-1,-1,-1,6,-1
KR_6728452708,420,-4,-36,-20,-5,1,1,2,-2,4,2,-2,3,1,-2,4,2,0,1,1,0,-3,-11,-2,-2,4,-1,0,0,-1,1,0,1,2,-1
KR_6701378809,420,-3,-16,8,-9,-5,5,0,1,1,2,-4,4,0,-4,5,1,3,0,3,0,-4,374,1,-3,2,-1,0,0,1,1,-1,-1,2,-1
KR_6762776230,420,-3,-96,-3,-9,-4,4,0,0,1,1,1,1,2,-1,1,0,-5,5,0,1,-5,8,0,-5,5,1,0,-2,1,-1,-1,1,4,-1
KR_6542013854,420,-2,-28,8,-1,1,0,1,-1,3,2,-6,7,1,5,0,5,0,1,1,0,-5,1,1,-9,8,-4,0,0,1,-1,0,-1,4,-1
KR_6759559025,420,-2,12,-4,-2,-2,3,1,0,4,4,-1,3,2,1,0,1,0,0,0,0,-4,6,0,-5,5,3,0,-1,1,-1,-1,-1,3,-1
KR_6761020869,440,2,8,-4,0,2,2,4,0,1,1,-2,5,3,1,1,2,-1,1,0,0,-1,-13,-5,-3,8,3,0,0,-1,-1,0,-1,4,-1
KR_6712987156,420,1,63,-32,3,2,1,3,-4,4,0,-3,4,1,7,1,8,1,1,2,-1,0,-26,3,-5,2,-1,0,0,-1,-1,0,-1,2,-1
KR_6752055614,420,-6,-98,-13,-10,-2,2,0,-6,6,0,-1,1,0,-2,4,2,1,1,2,0,-7,-347,0,-4,4,-3,0,-2,-1,-1,-1,-1,2,-1
KR_6721852472,420,-5,-95,-12,-7,1,1,2,1,2,3,-2,3,1,-4,4,0,-3,3,0,-1,-10,-161,3,-6,3,-2,0,-3,1,1,-1,-1,2,-1
KR_6411389963,420,-2,-29,-16,1,1,1,2,-1,4,3,-6,7,1,8,0,8,-1,1,0,0,6,-33,-2,-2,4,7,0,0,-1,-1,0,-1,6,-1
KR_6679337296,420,3,28,-4,4,3,0,3,-3,4,1,3,1,4,1,1,2,0,1,1,1,-1,-11,2,-6,4,1,0,2,-1,-1,1,1,4,-1
KR_6747519226,420,-3,-49,-10,-3,-8,8,0,-1,3,2,1,1,2,3,1,4,2,0,2,0,3,1,1,-6,5,0,0,-2,1,-1,-1,1,3,-1
KR_6763081822,420,-3,-82,-12,-9,-10,10,0,4,0,4,-2,3,1,-1,1,0,0,0,0,0,-3,-117,2,-4,2,-4,0,-1,-1,-1,-1,-1,6,-1
KR_6758933249,420,-3,-86,-47,-9,-6,7,1,-4,6,2,-3,5,2,2,4,6,2,1,3,-1,-4,25,0,-2,2,-2,0,-1,1,-1,-1,-1,6,-1
KR_6761543165,420,0,-4,28,-4,1,2,3,0,2,2,0,2,2,-3,3,0,-2,2,0,-1,-12,-30,-5,0,5,-4,0,0,0,1,0,-1,0,-1
KR_6757643493,420,-6,-63,-8,-15,-2,3,1,1,1,2,-9,9,0,-5,6,1,0,0,0,-1,-18,-44,0,-3,3,20,0,-1,-1,-1,-1,-1,3,-1
KR_6648892093,420,-1,-4,-8,-1,2,1,3,-2,4,2,1,4,5,-2,2,0,0,0,0,0,-8,3,2,-6,4,4,0,1,1,1,1,1,5,-1
KR_6709162465,420,-3,-11,-9,-2,-1,2,1,-1,1,0,0,5,5,1,1,2,-1,2,1,1,1,-6,0,-2,2,1,0,0,-1,1,1,1,3,-1
KR_6764680467,420,-1,-45,-20,-2,0,1,1,-1,3,2,4,1,5,-4,6,2,-1,1,0,0,-3,-4,-3,-3,6,2,0,1,1,1,1,-1,3,-1
KR_6727467249,420,0,-66,16,-3,-2,3,1,-4,6,2,3,1,4,0,0,0,0,0,0,0,-3,-2,-2,-2,4,2,0,0,-1,-1,0,-1,5,-1
KR_6734231132,420,0,-3,-9,-10,-3,3,0,-4,6,2,-1,4,3,-4,6,2,2,1,3,0,-7,0,3,-4,1,-1,0,-1,-1,-1,-1,-1,2,-1
KR_6760782022,420,-1,-13,-20,-5,-2,3,1,-2,2,0,-1,3,2,3,1,4,-3,4,1,0,2,-10,-5,-2,7,-1,0,-2,-1,-1,-1,-1,6,-1
KR_6755775604,420,-1,18,-28,4,1,0,1,-2,6,4,1,2,3,5,1,6,-1,1,0,1,10,-2,6,-6,0,2,0,2,-1,1,1,1,3,-1
KR_6745561332,420,-2,-61,-37,-4,-8,8,0,1,0,1,2,0,2,2,2,4,-1,6,5,-1,7,1,0,-3,3,0,0,-2,0,0,-1,-1,0,-1
KR_6708423214,420,3,-14,44,7,-2,4,2,8,0,8,-1,2,1,-4,5,1,6,0,6,0,2,-17,-4,-2,6,5,0,1,-1,1,1,-1,5,-1
KR_6688278268,420,1,40,0,-6,-2,3,1,1,2,3,-2,3,1,-3,3,0,0,0,0,-2,-12,3,-1,-4,5,1,0,-1,1,-1,-1,-1,2,-1
KR_6754637230,420,-3,-88,-2,-6,0,3,3,2,1,3,-3,4,1,0,1,1,-5,5,0,-1,-12,-10,-1,-4,5,0,0,-1,1,-1,-1,-1,3,-1
KR_6750252110,420,1,65,-12,-2,2,0,2,-7,8,1,-2,4,2,3,0,3,2,0,2,0,-4,-4,-5,-2,7,3,0,2,1,-1,1,1,1,-1
KR_6755437510,420,-1,29,9,0,-1,1,0,4,0,4,-1,1,0,-2,2,0,0,0,0,0,1,1,-1,-4,5,-1,0,0,0,0,0,-1,0,-1
KR_6638283725,420,0,-19,12,-2,-1,2,1,1,3,4,3,0,3,-4,4,0,-1,1,0,0,-4,-4,2,-7,5,-1,0,0,1,1,0,-1,2,-1
KR_6648581149,420,-3,-54,8,-9,3,1,4,2,2,4,-2,3,1,-13,15,2,1,0,1,-1,0,-114,5,-7,2,0,0,-2,1,-1,-1,-1,2,-1
KR_6759424631,420,1,7,-15,-3,-2,3,1,-3,4,1,-3,4,1,3,0,3,2,0,2,0,1,4,-2,-1,3,-2,0,0,0,0,1,-1,0,-1
KR_6757760199,420,1,14,-16,-3,2,1,3,0,1,1,-5,7,2,1,0,1,-1,2,1,0,-3,-7,-3,-1,4,2,0,0,-1,0,-1,-1,6,-1
KR_6536150105,420,-2,-60,-14,-4,-5,5,0,1,5,6,1,3,4,-4,6,2,3,0,3,0,-3,27,2,-8,6,-5,0,-1,-1,1,-1,-1,2,-1
KR_6757916915,420,1,-64,15,-3,-1,3,2,-4,4,0,0,2,2,2,0,2,0,0,0,0,-2,-4,-1,-3,4,-4,0,0,0,1,0,-1,0,-1
KR_6746468500,420,-2,0,16,-11,-6,8,2,3,0,3,-1,2,1,-6,7,1,-1,1,0,0,-12,2,-3,-6,9,2,0,-1,0,-1,-1,-1,0,-1
KR_6715735185,420,-3,-34,-16,-3,2,0,2,1,2,3,-6,7,1,0,0,0,0,0,0,0,-10,6,1,-5,4,-1,0,0,-1,-1,-1,1,2,-1
KR_6742216791,420,-1,-32,-12,-7,-3,5,2,0,3,3,2,0,2,-5,7,2,-1,1,0,-1,-6,26,2,-8,6,2,0,0,-1,1,0,-1,5,-1
KR_6625111840,420,-3,-113,-10,-1,-2,2,0,0,2,2,3,3,6,-4,6,2,2,4,6,1,2,-23,-3,-1,4,1,0,-2,-1,0,-1,1,5,-1
KR_6744380595,420,-5,-21,9,-22,-1,2,1,-3,3,0,-11,12,1,-5,6,1,-2,2,0,0,-10,-20,-1,-4,5,-3,0,1,-1,1,-1,-1,2,-1
KR_6710236169,420,-2,-12,20,-9,-2,3,1,-5,6,1,2,1,3,1,1,2,-5,5,0,0,-12,-10,-3,-5,8,-1,0,0,-1,-1,-1,-1,3,-1
KR_6754671366,420,0,-49,20,1,1,2,3,0,4,4,2,1,3,-1,1,0,-1,2,1,0,4,5,-2,-4,6,1,0,-2,-1,1,-1,1,1,-1
KR_6636776379,420,-1,-41,-4,2,2,0,2,0,4,4,2,2,4,-2,2,0,0,1,1,0,1,4,-5,-1,6,3,0,1,-1,1,1,-1,5,-1
KR_6719396982,420,2,1,8,7,5,0,5,7,0,7,2,0,2,-5,8,3,-2,2,0,-1,4,-6,2,-5,3,2,0,1,1,-1,1,-1,2,-1
KR_6603669954,420,3,56,16,1,0,2,2,1,0,1,0,1,1,-2,3,1,2,1,3,0,1,5,-1,-4,5,3,0,1,-1,1,1,-1,3,-1
KR_6662511783,440,-1,-23,12,-2,0,0,0,1,0,1,-1,3,2,-5,6,1,3,0,3,0,-2,-3,1,-4,3,-3,0,0,-1,0,0,-1,3,-1
KR_6762424892,420,-2,-6,-24,-1,-2,3,1,-1,2,1,-4,6,2,5,0,5,1,2,3,0,2,9,3,-3,0,1,0,0,1,1,0,1,3,-1
KR_6761577333,420,-1,-23,-4,3,-1,1,0,-2,2,0,4,1,5,4,3,7,-2,3,1,1,6,23,-2,-4,6,3,0,0,0,0,1,1,0,-1
KR_6738883075,420,4,-5,25,6,-1,2,1,3,1,4,0,3,3,3,2,5,1,1,2,0,10,-47,-2,-5,7,16,0,0,1,1,1,-1,3,-1
KR_6759095717,420,-2,-56,-8,-4,0,1,1,3,1,4,-1,3,2,-6,8,2,0,1,1,0,-2,0,-4,-2,6,2,0,-1,1,-1,-1,-1,2,-1
KR_6690116495,420,-4,-99,-36,-7,-3,3,0,-3,4,1,0,2,2,-3,5,2,2,1,3,0,-5,-119,3,-5,2,-1,0,-2,-1,-1,-1,1,2,-1
KR_6735261990,420,0,41,-23,-2,1,0,1,-3,4,1,4,1,5,-2,4,2,-2,5,3,0,-12,0,1,-6,5,-1,0,-1,1,0,-1,-1,6,-1
KR_6735640941,420,-9,-149,-70,-6,-4,4,0,0,5,5,0,0,0,-1,5,4,-1,1,0,0,0,-2,1,-7,6,-3,0,-2,-1,-1,-1,-1,5,-1
KR_6760739002,420,-1,-108,21,1,-1,3,2,3,1,4,1,2,3,-1,4,3,-1,1,0,0,10,-5,4,-7,3,-9,0,0,0,1,0,-1,0,-1
KR_6458447568,420,0,-89,5,-7,1,2,3,2,2,4,-4,5,1,-3,6,3,-3,4,1,0,-6,-20,-2,-3,5,-2,0,-1,-1,-1,-1,-1,5,-1
KR_6761226182,420,-3,-106,8,-4,-2,4,2,2,1,3,0,3,3,-3,4,1,-1,2,1,0,-6,-6,-2,-4,6,0,0,-1,1,-1,-1,-1,3,-1
KR_6755852882,420,-2,-92,-24,-8,-3,3,0,-5,6,1,-4,5,1,3,0,3,1,1,2,0,-6,-57,-3,-4,7,20,0,-2,-1,-1,-1,-1,6,-1
KR_6723362781,420,-8,-127,-1,-12,-3,3,0,4,0,4,-11,11,0,-2,2,0,0,1,1,0,-3,3,1,-3,2,-5,0,-2,-1,-1,-1,-1,1,-1
KR_6757553475,420,-3,-13,-4,-7,2,1,3,-1,2,1,-5,6,1,-3,3,0,0,1,1,0,-11,-6,-4,-1,5,-1,0,0,-1,1,0,-1,1,-1
KR_6644748971,420,-2,-40,12,-10,-2,2,0,-1,1,0,-2,4,2,-5,5,0,0,0,0,0,-12,-3,-4,-3,7,-4,0,0,1,0,0,-1,3,-1
KR_6755622928,420,-5,-47,-5,-9,-3,3,0,1,1,2,-5,6,1,-3,3,0,1,1,2,0,-9,-5,0,-2,2,0,0,-2,-1,-1,-1,-1,4,-1
KR_6729694037,420,-4,-103,-6,-15,0,1,1,1,2,3,-10,10,0,-7,8,1,1,1,2,-2,-12,0,0,-2,2,0,0,-2,-1,0,-1,-1,6,-1
KR_6717947090,440,-1,-58,-16,-3,-1,3,2,-1,8,7,0,4,4,-1,3,2,0,3,3,-4,-18,-7,1,-4,3,3,0,-1,1,-1,-1,-1,1,-1
KR_6761264551,420,-1,-42,10,1,-1,3,2,0,0,0,-1,1,0,1,1,2,2,0,2,-1,2,6,0,-2,2,2,0,-1,1,-1,-1,-1,1,-1
KR_6755219432,420,2,10,43,-3,0,1,1,-2,3,1,-4,4,0,5,1,6,-2,3,1,0,1,-1,-1,-8,9,6,0,-1,1,-1,-1,1,5,-1
KR_6637268493,420,-4,-123,-16,-7,-3,3,0,-2,3,1,0,2,2,-3,4,1,1,0,1,-1,-9,-30,-2,-3,5,-3,0,0,-1,0,0,-1,3,-1
KR_6697145329,420,0,-32,-8,4,0,1,1,3,4,7,1,3,4,1,3,4,-1,1,0,3,3,-6,-7,-4,11,4,0,0,-1,-1,0,1,4,-1
KR_6673672022,420,-2,-83,-44,-3,0,2,2,-2,2,0,-1,3,2,0,0,0,0,0,0,0,-1,-1,1,-4,3,-1,0,-3,-1,-1,-1,1,2,-1
KR_6727179674,420,3,-11,-24,15,3,2,5,1,3,4,4,1,5,3,0,3,4,1,5,2,17,-9,-1,-1,2,0,0,0,-1,1,0,1,6,-1
KR_6764164220,420,-1,12,-16,-2,1,3,4,-2,8,6,1,2,3,0,2,2,-2,5,3,0,5,10,4,-7,3,0,0,1,1,1,1,-1,3,-1
KR_6760387348,420,0,-80,40,0,-1,2,1,-2,3,1,3,0,3,-1,2,1,1,0,1,0,1,4,0,-7,7,-4,0,-1,-1,1,-1,-1,4,-1
KR_6724944123,420,-5,-65,-36,-12,2,0,2,1,1,2,-11,11,0,-1,2,1,-3,3,0,0,-15,-3,0,-2,2,-2,0,-2,-1,-1,-1,-1,3,-1
KR_6730677827,420,0,54,-6,7,1,3,4,-1,3,2,3,1,4,2,3,5,2,0,2,0,10,45,4,-5,1,-8,0,1,-1,0,1,1,3,-1
KR_6732601173,420,3,-5,20,5,4,1,5,7,0,7,-1,2,1,-5,6,1,0,1,1,0,0,-27,1,-4,3,2,0,0,-1,-1,1,-1,6,-1
KR_6763549568,420,-5,-112,0,-13,-6,8,2,-3,4,1,0,1,1,-6,7,1,2,0,2,0,-8,1,2,-5,3,4,0,-1,1,1,-1,-1,6,-1
KR_6761211569,420,-4,-117,-19,-18,-5,5,0,2,0,2,0,1,1,-11,11,0,-4,4,0,0,-18,123,-2,-1,3,-3,0,-1,-1,0,-1,-1,5,-1
KR_6645981837,420,-2,-33,0,-6,-2,4,2,1,1,2,-5,5,0,-2,2,0,2,3,5,-1,-5,-17,-2,-3,5,-2,0,0,1,-1,0,-1,2,-1
KR_6750767285,440,3,30,0,6,-2,3,1,3,0,3,3,0,3,-1,6,5,3,0,3,0,6,4,0,-6,6,3,0,2,-1,1,1,-1,6,-1
KR_6621933690,420,1,-5,-4,-4,-2,2,0,-3,6,3,0,0,0,2,1,3,-1,1,0,-3,-1,-150,-4,-1,5,-1,0,-2,-1,-1,-1,-1,4,-1
KR_6761043269,420,-2,-22,-2,-4,-3,3,0,-2,4,2,2,2,4,-1,2,1,0,2,2,0,-2,-320,1,-2,1,0,0,0,-1,-1,-1,-1,2,-1
KR_6717586890,420,-3,23,-47,-2,0,0,0,-1,5,4,-4,4,0,6,3,9,-3,4,1,1,-6,-6,0,-6,6,8,0,0,-1,1,0,1,3,-1
KR_6646359398,420,-4,-50,-40,-6,1,1,2,-3,6,3,-2,4,2,-3,3,0,1,0,1,0,0,0,-2,-3,5,1,0,-1,-1,1,-1,1,4,-1
KR_6754977871,420,-5,-59,-13,-12,0,1,1,-3,5,2,-7,8,1,-1,1,0,-1,2,1,0,-8,4,4,-6,2,-7,0,-1,-1,-1,-1,-1,1,-1
KR_6664025349,420,0,45,-43,-2,-2,4,2,-5,8,3,-1,1,0,5,0,5,1,0,1,0,-1,18,2,-6,4,-7,0,0,1,-1,0,1,4,-1
KR_6761833175,420,0,-72,4,5,3,1,4,-1,2,1,1,0,1,1,6,7,1,0,1,1,1,-4,-1,-2,3,3,0,0,-1,1,0,1,1,-1
KR_6658359307,420,1,15,10,-3,2,2,4,-1,3,2,-2,2,0,1,3,4,-3,3,0,0,-1,4,0,-5,5,-6,0,2,1,1,1,-1,6,-1
KR_6667379194,440,-1,68,-26,-5,0,0,0,-4,5,1,-3,5,2,-1,4,3,3,1,4,0,-9,8,-1,-1,2,1,0,0,1,-1,0,1,5,-1
KR_6743824090,420,-3,-72,32,-8,-3,4,1,0,1,1,-1,4,3,-4,8,4,0,0,0,-1,-8,0,-5,-1,6,-4,0,0,-1,-1,-1,-1,4,-1
KR_6669412833,420,-2,-70,-8,-5,0,2,2,2,0,2,0,2,2,-5,6,1,-2,3,1,0,-1,-131,-3,-3,6,-3,0,-1,-1,-1,-1,1,5,-1
KR_6761035737,440,0,11,13,-6,-1,2,1,-2,3,1,1,3,4,-4,6,2,0,2,2,-1,0,30,-6,-3,9,-30,0,1,-1,0,1,-1,2,-1
KR_6739255727,420,3,28,-4,9,3,1,4,4,1,5,0,2,2,-2,5,3,4,1,5,1,7,-6,1,-4,3,-1,0,2,1,1,1,1,3,-1
KR_6635183529,420,-4,-41,-4,-11,-1,2,1,-3,3,0,-3,3,0,0,3,3,-4,4,0,0,-13,-98,-2,-3,5,-1,0,-1,-1,1,-1,-1,1,-1
KR_6761921949,420,3,55,-4,2,-1,2,1,-1,2,1,-2,4,2,4,0,4,2,0,2,0,6,-1,-1,-3,4,1,0,1,-1,-1,1,1,6,-1
KR_6756320762,420,-2,-50,-2,-13,3,1,4,-7,10,3,0,0,0,-9,9,0,0,1,1,0,-13,-67,1,-3,2,-35,0,-1,-1,0,-1,-1,1,-1
KR_6762404884,420,5,27,38,12,2,2,4,3,4,7,-1,2,1,8,1,9,0,2,2,1,7,7,6,-7,1,0,0,0,1,1,-1,1,2,-1
KR_6616520787,420,0,31,-8,5,2,1,3,-5,5,0,0,1,1,2,2,4,6,0,6,0,5,-8,-4,-2,6,6,0,0,1,-1,0,1,2,-1
KR_6678118998,420,6,86,11,8,-1,2,1,0,2,2,0,3,3,6,1,7,3,0,3,0,9,8,4,-4,0,0,0,1,1,-1,1,1,5,-1
KR_6743023555,420,-3,-60,-28,-2,-4,4,0,1,2,3,-3,6,3,2,4,6,2,0,2,0,7,-63,-3,0,3,2,0,-2,-1,-1,-1,-1,1,-1
KR_6750236422,420,-1,-40,-12,-6,-1,2,1,0,4,4,-6,7,1,0,1,1,1,3,4,0,-8,-69,-2,-2,4,-5,0,1,1,-1,1,-1,4,-1
KR_6617551661,420,2,39,-4,3,1,1,2,9,1,10,-2,2,0,-1,3,2,-4,4,0,0,5,0,1,-6,5,1,0,1,1,1,1,-1,1,-1
KR_6705158966,420,-1,-34,15,-4,2,1,3,-3,4,1,-4,5,1,1,1,2,0,1,1,0,-6,-6,-2,-3,5,3,0,0,1,-1,0,1,6,-1
KR_6744766383,420,2,40,37,7,-1,3,2,6,0,6,7,1,8,-7,9,2,2,0,2,4,14,11,-2,-1,3,1,0,1,0,1,1,1,0,-1
KR_6704184221,420,-3,-91,-3,-3,-2,5,3,-1,3,2,-1,4,3,1,4,5,0,2,2,0,0,1,1,-4,3,1,0,-2,-1,-1,-1,-1,5,-1
KR_6682688722,420,-5,-103,-21,-12,-5,5,0,3,3,6,-2,5,3,-3,3,0,-5,5,0,0,-6,0,4,-6,2,-1,0,-4,0,-1,-1,-1,0,-1
KR_6656878945,420,-1,-9,4,-9,-1,3,2,-2,4,2,-6,6,0,-1,3,2,1,0,1,0,-7,-21,-4,-1,5,1,0,-1,-1,1,-1,-1,5,-1
KR_6397635712,420,2,67,25,1,4,1,5,0,3,3,-5,6,1,2,3,5,0,0,0,0,-7,-125,-1,-3,4,0,0,2,-1,1,1,-1,1,-1
KR_6743521590,420,-1,54,-59,-8,0,3,3,-1,3,2,-4,4,0,-8,9,1,5,1,6,0,-6,4,4,-5,1,-3,0,-1,0,-1,-1,-1,0,-1
KR_6649285124,420,-2,10,-16,2,-3,4,1,3,2,5,2,2,4,1,2,3,-1,2,1,0,4,-19,3,-5,2,2,0,-1,-1,-1,-1,1,5,-1
KR_6647473741,420,-2,-29,-1,-9,2,1,3,-2,5,3,-2,2,0,-4,8,4,-3,3,0,0,-8,-3,2,-4,2,-3,0,-1,1,0,-1,1,4,-1
KR_5822554086,420,-6,-51,-1,-10,-1,1,0,-3,5,2,-6,7,1,1,1,2,-1,1,0,0,-9,-67,-4,-2,6,1,0,-2,-1,0,-1,-1,1,-1
KR_6722272547,420,3,11,0,11,1,2,3,0,1,1,-2,5,3,11,0,11,1,1,2,0,4,192,-7,-1,8,3,0,2,-1,1,1,1,2,-1
KR_6759272821,420,1,39,27,2,0,1,1,-1,5,4,1,2,3,1,1,2,1,1,2,0,7,-11,-1,-3,4,4,0,0,-1,-1,1,1,4,-1
KR_6756480581,420,-6,-97,-68,-12,0,0,0,0,1,1,-5,6,1,-5,6,1,-2,3,1,-1,-11,-49,-5,-1,6,28,0,-2,-1,-1,-1,-1,2,-1
KR_6760015889,420,0,38,-26,4,2,0,2,0,1,1,4,0,4,-2,5,3,0,1,1,0,4,15,3,-4,1,-5,0,1,-1,1,1,-1,4,-1
KR_6660359650,420,-2,-60,-3,-1,-1,4,3,2,2,4,1,1,2,-3,4,1,0,1,1,-1,0,-2,7,-7,0,-2,0,-1,1,-1,-1,-1,5,-1
KR_6759452788,420,-1,-23,-11,-2,-5,6,1,3,5,8,-1,2,1,1,3,4,0,1,1,0,-11,3,4,-6,2,4,0,-1,1,1,-1,1,4,-1
KR_6757981136,420,1,67,-4,3,3,1,4,1,0,1,0,3,3,0,1,1,-1,3,2,-1,-4,0,2,-4,2,-2,0,2,0,0,1,-1,0,-1
KR_6732879100,420,-2,-88,-32,-4,-2,3,1,1,2,3,6,0,6,-9,11,2,0,0,0,0,-2,4,2,-6,4,-7,0,-1,-1,-1,-1,1,6,-1
KR_6744368095,420,2,-17,-3,3,-1,2,1,3,0,3,2,0,2,-2,2,0,1,1,2,0,-2,3,-2,-1,3,1,0,0,1,-1,-1,-1,3,-1
KR_6749250156,420,-3,-7,-18,-4,-3,5,2,0,3,3,0,3,3,-1,5,4,0,2,2,0,-3,10,-1,-2,3,0,0,-2,-1,-1,-1,-1,5,-1
KR_6761007866,420,-1,-6,11,-7,5,0,5,-1,3,2,0,0,0,-10,12,2,-1,1,0,0,-14,-5,-2,-4,6,-4,0,-1,-1,-1,-1,-1,1,-1
KR_6619730513,420,-5,7,1,-10,0,0,0,-2,2,0,-2,6,4,-4,9,5,-2,3,1,0,-8,-19,-5,-4,9,4,0,0,-1,-1,-1,-1,2,-1
KR_6754573050,420,-4,-32,-1,-15,-5,8,3,-2,5,3,0,2,2,-7,7,0,-1,2,1,0,-13,3,-3,-1,4,-2,0,-1,-1,-1,-1,-1,4,-1
KR_6764169596,420,1,-47,40,-5,-3,3,0,1,4,5,0,2,2,-5,7,2,2,0,2,0,-8,11,0,-4,4,-5,0,-1,-1,1,-1,-1,5,-1
KR_6718155911,420,-2,0,-24,-10,2,2,4,-1,4,3,-4,4,0,-4,4,0,-3,5,2,0,-9,-23,6,-8,2,2,0,-1,-1,1,-1,-1,4,-1
KR_6646840621,440,0,-52,-29,4,-3,4,1,-3,4,1,12,3,15,1,3,4,-3,3,0,0,6,-2,1,-2,1,-1,0,0,-1,-1,0,-1,4,-1
KR_6608670341,420,-8,-113,-48,-6,-1,3,2,0,3,3,-6,7,1,0,2,2,1,0,1,0,5,7,0,-1,1,-3,0,0,-1,-1,-1,1,3,-1
KR_6646949857,420,-3,-43,-8,-9,0,0,0,0,2,2,-2,3,1,-6,6,0,-1,2,1,0,-14,-5,2,-6,4,1,0,-1,-1,1,-1,-1,5,-1
KR_6729229103,420,2,45,4,5,0,1,1,2,3,5,0,1,1,2,1,3,1,1,2,0,10,-3,-1,-2,3,1,0,-1,1,-1,-1,-1,1,-1
KR_6729215353,420,0,-43,1,-2,-3,4,1,2,2,4,-1,3,2,1,4,5,-1,2,1,0,0,5,1,-2,1,-2,0,0,1,-1,0,-1,1,-1
KR_6581356464,420,0,105,-35,-5,-5,6,1,2,2,4,-1,4,3,0,0,0,-1,1,0,0,-5,-224,-4,-2,6,0,0,2,-1,-1,1,1,5,-1
KR_6732972719,420,1,8,-16,-2,-4,4,0,1,0,1,4,0,4,-2,2,0,-1,2,1,0,-1,-7,1,-2,1,0,0,0,-1,-1,0,-1,5,-1
KR_6757593775,420,-1,-44,-17,-11,-6,7,1,2,0,2,-2,4,2,-5,5,0,0,1,1,0,-3,-36,2,-2,0,8,0,-1,0,0,-1,-1,0,-1
KR_6663483440,420,-2,-5,20,-6,-2,3,1,-4,5,1,-2,2,0,0,2,2,2,0,2,0,-13,3,-2,-4,6,-2,0,0,-1,-1,-1,-1,5,-1
KR_6761780107,420,-3,-93,15,-7,0,1,1,1,4,5,-1,3,2,-5,5,0,-2,2,0,0,-9,0,-6,-1,7,-3,0,0,1,0,0,-1,4,-1
KR_6687841104,420,-1,11,-6,0,2,0,2,2,0,2,-2,4,2,-2,5,3,0,1,1,0,-8,7,-1,-3,4,2,0,1,0,1,1,-1,0,-1
KR_6751546254,420,-2,-16,12,-10,0,1,1,-3,3,0,1,1,2,-7,9,2,-1,2,1,0,-14,-116,-4,-2,6,-30,0,-1,1,0,-1,-1,1,-1
KR_6731237876,420,-6,-68,-16,-15,1,1,2,-7,8,1,-3,3,0,-3,4,1,-3,4,1,0,-8,3,-3,-2,5,-2,0,-1,-1,-1,-1,-1,3,-1
KR_6734468624,420,0,-9,0,1,-1,1,0,-3,5,2,1,2,3,1,1,2,3,1,4,0,0,-3,0,-5,5,2,0,0,-1,1,0,1,5,-1
KR_6720808125,420,2,-62,52,1,1,3,4,1,2,3,1,2,3,-3,4,1,1,2,3,0,-4,-1,-3,-5,8,0,0,-1,1,1,-1,1,4,-1
KR_6706786596,420,-2,2,-8,-6,-6,7,1,2,3,5,1,1,2,-1,4,3,-2,3,1,0,-4,-15,-1,-5,6,-2,0,-2,-1,0,-1,-1,6,-1
KR_6735788517,420,-1,25,8,-9,-1,1,0,1,1,2,-2,3,1,-3,5,2,-4,4,0,0,-10,-7,-5,-1,6,1,0,-1,1,1,-1,1,3,-1
KR_6509126011,420,-2,-55,-30,-4,1,0,1,-5,5,0,-2,2,0,3,2,5,-1,1,0,0,-1,21,2,-4,2,-5,0,0,0,-1,0,1,0,-1
KR_6632979169,420,-2,-24,-20,-4,-4,4,0,0,4,4,-5,5,0,4,0,4,1,1,2,-2,-4,4,1,-4,3,-2,0,-1,-1,-1,-1,-1,1,-1
KR_6716474182,440,-7,-85,-40,-16,-2,2,0,-8,10,2,-6,6,0,0,6,6,0,2,2,-3,-12,1,-3,-5,8,1,0,0,1,-1,0,-1,3,-1
KR_6655204908,420,-1,34,-13,-6,0,2,2,-3,4,1,-1,2,1,-2,5,3,0,2,2,0,-4,34,0,-4,4,-21,0,0,-1,-1,0,1,1,-1
KR_6713359481,420,3,53,15,5,3,1,4,1,1,2,4,0,4,-2,2,0,-1,1,0,0,-1,34,5,-7,2,0,0,2,-1,1,1,1,6,-1
KR_6679250281,420,1,-60,21,3,4,2,6,2,2,4,1,3,4,-3,3,0,-1,1,0,0,5,12,4,-5,1,-3,0,0,0,1,-1,-1,0,-1
KR_6720778800,440,-2,-179,-8,0,0,0,0,-3,4,1,7,1,8,-5,5,0,1,1,2,0,2,-15,0,-2,2,2,0,0,0,-1,-1,-1,0,-1
KR_6718242021,420,-5,-92,24,-6,-2,2,0,0,1,1,0,4,4,-1,5,4,-3,5,2,1,-7,1,-3,-2,5,-1,0,-1,-1,0,-1,1,1,-1
KR_6742456693,420,2,52,40,-1,1,1,2,-2,6,4,3,2,5,-2,2,0,-1,1,0,0,-7,-3,2,-2,0,-2,0,1,1,-1,1,1,6,-1
KR_6722836905,420,-3,-87,0,-1,0,2,2,4,1,5,-4,6,2,1,0,1,-2,3,1,0,7,-37,1,-5,4,28,0,-2,-1,-1,-1,-1,1,-1
KR_6675463925,420,2,-7,-4,5,3,2,5,1,2,3,2,1,3,1,0,1,-2,3,1,1,6,5,2,-6,4,-1,0,0,-1,1,1,1,2,-1
KR_6694410599,420,0,-12,20,-2,0,2,2,-7,8,1,4,1,5,0,2,2,1,0,1,0,-3,-1,-4,-3,7,0,0,0,1,1,-1,-1,6,-1
KR_6731934896,420,-7,-82,-52,-12,-7,7,0,0,5,5,-1,5,4,-2,3,1,-2,2,0,0,-7,3,0,-5,5,-1,0,-1,-1,-1,-1,1,5,-1
KR_6743249712,420,-3,-45,-36,-6,0,0,0,-1,1,0,0,2,2,-6,7,1,1,2,3,0,-5,18,2,-5,3,4,0,0,1,-1,-1,1,1,-1
KR_6762410924,420,-7,-110,-14,-26,-4,4,0,-7,7,0,-3,4,1,-7,8,1,-5,5,0,0,-23,-34,-4,-1,5,-1,0,-5,-1,-1,-1,-1,2,-1
KR_6696313360,420,-4,0,-17,-6,-2,3,1,-4,6,2,-1,4,3,1,0,1,0,0,0,-1,-9,-20,-5,-2,7,-2,0,0,-1,-1,0,-1,1,-1
KR_6745705180,420,-5,-28,-18,-7,2,3,5,2,4,6,-10,10,0,0,1,1,-1,2,1,1,-1,-1,0,-3,3,-1,0,-1,-1,1,-1,1,5,-1
KR_6653833833,420,-1,15,-14,1,1,1,2,-2,4,2,7,0,7,-6,8,2,1,0,1,0,-2,0,-3,0,3,-2,0,0,-1,1,-1,-1,6,-1
KR_6720868210,420,-2,43,-22,-10,-1,2,1,-6,7,1,1,2,3,-3,3,0,-1,2,1,0,-19,-22,-2,-4,6,1,0,-1,-1,-1,-1,1,1,-1
KR_6734611611,420,-2,-43,17,-6,3,3,6,-3,4,1,1,3,4,-6,6,0,-1,2,1,-2,-17,-8,-1,-2,3,-4,0,-1,-1,1,-1,-1,6,-1
KR_6733070606,420,0,-56,-24,6,-2,2,0,4,1,5,5,1,6,1,1,2,-2,2,0,0,12,-2,0,-3,3,4,0,-1,-1,-1,-1,1,3,-1
KR_6757467151,420,-1,-4,-4,-5,0,2,2,-1,3,2,3,1,4,-5,7,2,-2,2,0,0,-5,-6,3,-9,6,-3,0,-1,-1,-1,-1,1,4,-1
KR_6750220496,440,-1,-93,3,-7,-2,3,1,0,2,2,-1,6,5,-2,5,3,-2,3,1,1,2,0,0,-6,6,-4,0,0,0,1,0,1,0,-1
KR_6752413251,420,2,-46,-5,-3,3,1,4,-4,4,0,1,1,2,-2,3,1,-1,2,1,-1,-6,-8,0,-2,2,0,0,-2,-1,1,-1,-1,4,-1
KR_6550906756,420,1,-56,-31,-1,-3,4,1,-1,3,2,-3,7,4,3,3,6,3,3,6,0,-6,-9,-2,-2,4,0,0,0,0,-1,-1,-1,0,-1
KR_6736727182,440,-4,-55,-18,-9,3,1,4,-5,6,1,1,2,3,0,2,2,-8,8,0,0,-8,-3,3,-5,2,0,0,-2,-1,-1,-1,1,4,-1
KR_6719560707,420,-6,-90,-8,-6,-4,4,0,3,1,4,-3,3,0,-3,6,3,1,1,2,0,-3,2,2,-3,1,-3,0,-2,1,-1,-1,1,6,-1
KR_6689462494,420,-1,-48,-15,0,0,3,3,1,1,2,1,0,1,-2,4,2,0,0,0,0,2,-2,-3,-2,5,3,0,1,-1,1,1,1,5,-1
KR_6759130514,420,2,-27,20,4,2,1,3,0,1,1,0,6,6,0,0,0,2,2,4,0,2,17,0,-4,4,-1,0,0,-1,1,1,1,2,-1
KR_6756926812,420,-4,-97,4,-7,-2,4,2,-2,6,4,1,2,3,-1,7,6,-3,5,2,0,-4,26,-2,-2,4,5,0,-1,-1,-1,-1,1,2,-1
KR_6727861315,420,-2,8,11,-8,3,1,4,-6,6,0,-4,5,1,-2,3,1,1,0,1,0,-13,-12,-3,-2,5,0,0,0,0,1,1,-1,0,-1
KR_6718364220,420,-2,18,-4,-2,1,1,2,-1,3,2,-2,6,4,0,3,3,0,0,0,0,4,1,1,-3,2,1,0,0,-1,-1,0,1,6,-1
KR_6763361532,420,-2,-76,-2,0,-3,7,4,7,0,7,-3,10,7,-1,3,2,0,2,2,-1,-5,-7,3,-7,4,1,0,-1,1,-1,-1,-1,5,-1
KR_6734765598,420,-3,-63,6,-6,-3,4,1,-5,10,5,5,1,6,-2,6,4,-1,2,1,0,-2,16,3,-7,4,-2,0,-2,-1,-1,-1,1,5,-1
KR_6762431614,420,2,-5,-4,-5,-1,1,0,-1,2,1,1,1,2,0,1,1,-4,5,1,-1,-7,1,2,-4,2,0,0,0,1,1,0,-1,6,-1
KR_6759587691,440,-2,1,8,-14,0,1,1,-5,5,0,-2,4,2,-5,9,4,-2,3,1,0,-25,-18,-1,-3,4,-5,0,-1,-1,-1,-1,1,1,-1
KR_6711752703,440,-4,-49,-4,-9,0,2,2,-12,12,0,1,1,2,2,0,2,0,2,2,0,-10,-4,-3,-1,4,0,0,-1,-1,-1,-1,-1,4,-1
KR_6758695050,420,-2,-65,-31,-9,1,0,1,-4,9,5,-4,5,1,0,3,3,-2,3,1,0,-12,2,1,-3,2,2,0,0,-1,-1,-1,-1,6,-1
KR_6729504465,420,2,-56,7,8,-1,4,3,0,2,2,8,2,10,3,1,4,-2,2,0,0,11,6,4,-7,3,3,0,-1,0,-1,-1,1,0,-1
KR_6732676009,420,-1,-50,0,2,-1,1,0,0,1,1,4,2,6,0,1,1,-1,7,6,0,-4,11,-4,-3,7,0,0,0,1,0,0,1,5,-1
KR_6750293831,420,-2,-68,12,-5,0,2,2,-8,10,2,-1,2,1,0,5,5,4,0,4,0,-8,-5,-4,-4,8,-1,0,-1,0,1,-1,-1,0,-1
KR_6748176934,420,2,-13,4,-3,-2,4,2,0,5,5,0,1,1,-3,4,1,2,1,3,0,0,114,2,-4,2,-2,0,-1,1,-1,-1,-1,5,-1
KR_6669156322,420,-3,-41,8,-12,-3,4,1,-1,5,4,-4,4,0,-3,3,0,-1,3,2,0,-10,100,-1,-6,7,-1,0,-2,1,-1,-1,-1,6,-1
KR_6659206600,440,-2,-46,23,-3,-2,5,3,-1,6,5,1,0,1,-1,1,0,0,3,3,0,-5,-5,-2,-5,7,-3,0,1,1,1,1,-1,5,-1
KR_6748190861,420,-2,-39,12,-8,-6,6,0,4,1,5,-1,2,1,-3,4,1,-2,2,0,0,-3,0,4,-8,4,-1,0,0,-1,-1,0,-1,2,-1
KR_6647431269,440,-2,-39,8,-1,-7,8,1,0,2,2,2,0,2,4,1,5,0,1,1,0,5,4,4,-4,0,3,0,-1,1,-1,-1,1,2,-1
KR_6746178552,420,-2,-18,-24,-5,0,3,3,-2,4,2,-4,4,0,1,0,1,0,0,0,0,-2,7,-2,-4,6,2,0,-2,-1,-1,-1,-1,6,-1
KR_6763685903,420,2,54,-36,4,2,0,2,1,1,2,1,1,2,2,2,4,-2,2,0,0,5,-6,1,-4,3,4,0,2,0,1,1,1,0,-1
KR_6748492877,420,-3,-4,8,-7,-1,4,3,2,0,2,1,2,3,-9,9,0,0,1,1,0,-11,-2,-3,-2,5,0,0,0,-1,-1,0,1,3,-1
KR_6735568339,420,-2,-43,-28,-6,2,2,4,3,3,6,0,1,1,-11,13,2,0,3,3,0,-2,31,4,-6,2,-1,0,0,-1,1,0,-1,5,-1
KR_6650551613,420,-3,-45,-20,-3,-4,4,0,1,3,4,1,1,2,-2,2,0,1,0,1,0,-2,109,1,-5,4,3,0,-2,-1,1,-1,1,5,-1
KR_6762817550,420,-2,-14,-5,-2,4,1,5,-7,7,0,3,2,5,-3,5,2,1,2,3,0,2,-2,2,-4,2,0,0,0,-1,1,0,1,5,-1
KR_6745909621,420,-2,-22,-24,-11,2,1,3,-3,4,1,0,3,3,-8,8,0,-2,3,1,-1,-14,0,5,-6,1,-7,0,-3,1,-1,-1,-1,6,-1
KR_6667703904,420,4,16,16,3,2,1,3,1,0,1,2,4,6,-2,4,2,0,2,2,0,4,10,2,-4,2,0,0,-1,-1,-1,-1,1,4,-1
KR_6757617069,420,-1,-50,11,-3,-1,1,0,1,1,2,-4,5,1,0,1,1,1,0,1,0,1,22,-2,-4,6,-5,0,1,-1,1,1,-1,3,-1
KR_6754086172,440,-2,13,-7,9,-1,1,0,4,1,5,-1,3,2,8,1,9,-1,1,0,0,19,0,-1,-4,5,3,0,0,1,-1,0,1,1,-1
KR_6752246136,420,-5,-71,-36,-9,-4,5,1,0,2,2,-6,7,1,0,1,1,1,1,2,-1,-6,-2,0,-2,2,2,0,-2,-1,-1,-1,-1,4,-1
KR_6734025310,420,0,-13,-15,-6,-1,3,2,-11,11,0,-3,3,0,7,2,9,2,1,3,-3,-5,-1,0,-3,3,2,0,-2,-1,-1,-1,1,6,-1
KR_6750008098,420,1,0,0,-2,0,3,3,1,1,2,-6,7,1,2,2,4,1,2,3,0,5,1,1,-3,2,-1,0,-1,-1,1,-1,-1,2,-1
KR_6645132292,420,2,100,0,-1,0,6,6,0,0,0,1,2,3,-3,3,0,1,1,2,0,-10,2,1,-5,4,1,0,1,1,1,1,1,1,-1
KR_6761775509,420,-2,-74,20,-9,-4,4,0,3,1,4,0,3,3,-2,3,1,-6,6,0,0,-8,-10,-2,-6,8,3,0,0,-1,1,0,-1,1,-1
KR_6762966854,420,-2,-50,4,-7,-11,12,1,0,2,2,4,0,4,-1,1,0,1,2,3,0,-2,-21,2,-3,1,-1,0,-1,-1,0,-1,-1,4,-1
KR_6759733887,420,0,32,-4,3,3,0,3,-2,4,2,-1,3,2,2,2,4,1,0,1,0,-1,4,2,-6,4,-2,0,0,1,1,0,1,4,-1
KR_6730551019,440,-5,-88,-3,-17,-3,4,1,-2,5,3,-3,4,1,-12,13,1,3,0,3,-2,-18,2,-4,-3,7,1,0,-1,-1,-1,-1,-1,2,-1
KR_6530512753,420,-4,35,-12,-11,0,1,1,-5,7,2,-2,4,2,-2,2,0,-2,3,1,0,-17,-17,-1,-4,5,0,0,0,-1,-1,-1,-1,6,-1
KR_6739592921,420,-1,-22,-21,-2,-5,6,1,-1,3,2,2,0,2,3,3,6,-1,1,0,0,4,-4,1,-5,4,0,0,-1,-1,-1,-1,1,4,-1
KR_6679199954,420,-7,-93,-15,-13,0,2,2,-7,7,0,-3,5,2,0,2,2,-3,3,0,0,-17,11,4,-6,2,-8,0,-2,-1,-1,-1,-1,1,-1
KR_6731443987,420,0,73,8,3,-1,1,0,3,1,4,-3,3,0,3,2,5,1,0,1,0,6,0,-5,-3,8,5,0,0,-1,-1,1,-1,5,-1
KR_6751992381,420,0,-23,-1,0,-1,3,2,1,5,6,3,4,7,-3,5,2,0,0,0,0,-1,-38,0,-2,2,3,0,0,-1,1,0,-1,4,-1
KR_6761396646,440,-3,9,-8,-1,2,2,4,2,1,3,-2,4,2,3,0,3,-6,7,1,0,-5,-7,-4,-1,5,3,0,-1,1,-1,-1,-1,5,-1
KR_6611172376,420,0,13,22,-2,1,1,2,0,3,3,-3,6,3,-2,2,0,2,0,2,0,-3,3,0,-5,5,0,0,0,0,1,0,-1,0,-1
KR_6350049049,420,0,-36,-53,0,-3,4,1,1,5,6,0,3,3,2,4,6,0,0,0,-1,-5,-32,-2,-2,4,4,0,0,-1,-1,-1,-1,6,-1
KR_6693848770,420,-2,-13,-18,-5,-3,4,1,1,6,7,2,0,2,-3,6,3,-2,2,0,0,0,137,0,-2,2,0,0,-1,1,1,-1,-1,4,-1
KR_6763973771,420,1,26,15,0,3,0,3,2,5,7,-9,13,4,-1,2,1,5,1,6,0,5,-30,2,-4,2,29,0,-1,0,1,-1,-1,0,-1
KR_6764538501,420,-4,-75,-6,-6,1,0,1,1,1,2,-6,10,4,-2,4,2,0,0,0,1,0,-20,-4,-4,8,2,0,-1,-1,-1,-1,1,5,-1
KR_6721670141,420,-1,-82,-16,-1,-2,2,0,1,4,5,-3,5,2,3,4,7,0,0,0,0,-1,37,0,-4,4,-24,0,-1,1,0,1,1,6,-1
KR_6729838709,420,2,-22,36,5,2,0,2,2,4,6,3,1,4,-3,4,1,1,0,1,-1,5,-293,-1,-2,3,1,0,0,1,0,0,-1,6,-1
KR_6644540542,420,-4,-54,-40,-6,-5,5,0,1,2,3,-2,3,1,-2,3,1,2,0,2,0,0,41,-1,-5,6,-18,0,-2,-1,1,-1,-1,2,-1
KR_6762633853,420,0,15,16,1,1,1,2,2,2,4,-4,5,1,3,6,9,-1,1,0,1,3,-3,4,-4,0,0,0,0,1,-1,0,1,5,-1
KR_6690958680,420,-2,-81,-11,-12,-1,4,3,-1,1,0,-2,5,3,-5,5,0,-3,3,0,-1,-11,2,2,-3,1,-4,0,-1,1,-1,-1,-1,2,-1
KR_6733653247,440,-4,-25,-4,-5,-4,5,1,1,1,2,1,1,2,-3,5,2,0,0,0,1,-7,186,2,-3,1,-3,0,0,1,0,0,1,2,-1
KR_6689708041,420,-4,-48,13,-9,-2,3,1,2,1,3,-2,2,0,-5,5,0,-2,2,0,0,-12,243,3,-7,4,-3,0,0,-1,1,-1,-1,2,-1
KR_6744142348,420,-4,-67,-4,-2,3,1,4,-1,3,2,-2,2,0,-3,4,1,1,0,1,0,-3,10,5,-8,3,-4,0,-1,0,1,-1,-1,0,-1
KR_6640065996,420,-6,-32,-32,-10,-2,3,1,-4,4,0,-4,4,0,-1,5,4,1,1,2,-1,-10,11,-4,-6,10,-1,0,-2,-1,-1,-1,-1,2,-1
KR_6747184007,440,1,-78,34,-3,-2,2,0,0,3,3,-5,5,0,4,5,9,0,1,1,0,2,6,0,-2,2,0,0,1,0,0,1,-1,0,-1
KR_6729563435,440,-3,-78,-28,-7,-4,6,2,1,2,3,-4,5,1,0,5,5,0,0,0,0,1,-16,0,-3,3,-4,0,-1,-1,-1,-1,-1,1,-1
KR_6641297949,420,-6,-101,-21,-6,-2,2,0,0,2,2,-4,4,0,-4,6,2,4,1,5,0,2,-12,0,-4,4,1,0,-1,-1,1,-1,-1,1,-1
KR_6701621256,420,-3,-10,-17,-5,5,0,5,-5,6,1,-1,4,3,-4,6,2,0,2,2,0,-8,4,4,-5,1,-2,0,-2,0,-1,-1,-1,0,-1
KR_6757108360,420,-1,22,-22,-1,1,0,1,1,3,4,0,5,5,-3,5,2,0,4,4,0,-9,-36,2,-5,3,18,0,-1,-1,1,-1,-1,2,-1
KR_6719509434,440,-3,-50,-16,-1,-1,1,0,2,1,3,-3,4,1,2,2,4,-1,1,0,0,3,0,2,-5,3,-4,0,0,1,1,-1,1,2,-1
KR_6725163228,420,-1,-24,12,1,1,1,2,0,1,1,-4,5,1,4,1,5,0,2,2,0,-1,12,0,-7,7,1,0,0,-1,0,0,1,2,-1
KR_6658689532,420,-4,-53,1,-1,-6,7,1,5,0,5,1,2,3,0,1,1,-1,2,1,0,5,4,3,-9,6,-1,0,-2,-1,1,-1,-1,6,-1
KR_6634775498,420,4,31,36,11,1,1,2,4,2,6,3,0,3,2,2,4,1,1,2,0,11,-313,5,-6,1,-4,0,-1,1,-1,-1,-1,5,-1
KR_6733087283,420,-6,-74,-40,-8,-4,4,0,-3,4,1,0,4,4,0,1,1,-1,1,0,-1,-2,-7,0,-3,3,-2,0,0,0,0,0,-1,0,-1
KR_6728153711,440,-5,-74,-17,-8,-2,3,1,-4,6,2,0,4,4,-3,3,0,1,0,1,0,-6,-31,-3,-1,4,-1,0,0,-1,0,0,1,3,-1
KR_6707488622,420,-2,-104,-2,-5,-3,7,4,2,0,2,-1,2,1,-2,3,1,-1,1,0,-1,0,2,0,-4,4,-3,0,-2,-1,-1,-1,-1,1,-1
KR_6744043313,420,-4,-68,-27,-8,-1,2,1,-3,5,2,3,0,3,-6,6,0,-1,4,3,-1,-2,-2,6,-9,3,-3,0,-3,-1,1,-1,-1,4,-1
KR_6713313175,420,3,23,-19,9,0,3,3,5,1,6,1,3,4,1,1,2,2,0,2,2,15,-132,2,-8,6,21,0,1,-1,-1,1,1,2,-1
KR_6738691030,420,-6,-123,-31,-10,1,1,2,-2,3,1,-6,6,0,-2,3,1,-1,1,0,0,-7,20,-5,-2,7,-20,0,-2,0,-1,-1,-1,0,-1
KR_6703263649,420,4,42,47,7,1,0,1,3,1,4,2,1,3,1,1,2,0,0,0,1,9,-4,2,-4,2,2,0,1,1,-1,1,1,4,-1
KR_6552301055,420,1,6,-17,3,3,0,3,-1,3,2,-2,3,1,2,0,2,1,0,1,0,1,2,0,-4,4,1,0,0,0,1,0,-1,0,-1
KR_6764442218,420,0,9,-4,3,2,0,2,2,3,5,-2,2,0,-2,3,1,3,0,3,0,-1,223,5,-5,0,-4,0,1,0,-1,1,1,0,-1
KR_6707981451,420,0,-18,39,-2,-4,4,0,2,4,6,2,3,5,-6,7,1,4,1,5,0,-5,5,3,-3,0,-3,0,-2,1,-1,-1,1,3,-1
KR_6759882357,420,-3,-81,3,-10,-3,5,2,-2,2,0,-4,6,2,0,4,4,-1,2,1,-1,-11,31,-2,0,2,-2,0,-1,-1,-1,-1,-1,5,-1
KR_6743450278,420,-3,-57,8,-5,2,0,2,2,1,3,0,1,1,-8,8,0,-1,1,0,0,-2,0,4,-7,3,-1,0,-1,1,1,-1,-1,3,-1
KR_6750285212,420,2,-56,62,-4,-1,2,1,0,0,0,2,0,2,-2,2,0,-3,3,0,0,-5,-2,-4,-1,5,-1,0,0,-1,1,-1,-1,2,-1
KR_6735123876,420,-1,-8,3,-1,1,0,1,0,2,2,-3,8,5,2,0,2,-1,2,1,0,-3,232,-2,-1,3,1,0,0,-1,0,0,1,1,-1
KR_6642006963,420,-1,-36,-39,-7,0,1,1,1,4,5,-6,6,0,-1,4,3,-1,1,0,0,-5,-3,-4,-2,6,3,0,1,1,-1,1,1,3,-1
KR_6702396284,420,-2,-12,-4,-9,1,1,2,-5,5,0,-1,2,1,-3,4,1,-1,1,0,-1,-10,2,-3,-2,5,2,0,1,1,1,1,-1,2,-1
KR_6747142742,420,-3,-25,40,-4,-4,6,2,6,2,8,-1,2,1,-4,6,2,-1,3,2,1,-3,-27,0,0,0,3,0,-3,1,-1,-1,1,3,-1
KR_6618961214,420,-3,-18,8,-10,-1,1,0,-1,5,4,-3,3,0,-4,6,2,-1,1,0,0,-5,181,-3,-5,8,2,0,-1,1,-1,-1,1,4,-1
KR_6757564176,420,0,-20,0,1,0,1,1,4,2,6,-1,2,1,-4,5,1,2,0,2,0,1,-92,-4,-2,6,-1,0,1,0,1,1,1,0,-1
KR_6657912149,420,-8,-107,10,1,-3,4,1,-1,3,2,1,0,1,3,1,4,1,0,1,0,1,4,0,-3,3,1,0,-2,-1,1,-1,-1,1,-1
KR_6749431429,420,-4,-76,-26,-9,-2,4,2,-6,7,1,0,1,1,2,0,2,-3,3,0,0,-11,-6,-1,-6,7,0,0,-2,-1,1,-1,-1,6,-1
KR_6636754012,420,-1,-18,-27,-8,1,0,1,-3,3,0,-3,3,0,-2,2,0,-1,1,0,0,-8,-6,0,-3,3,-4,0,-1,-1,-1,-1,-1,5,-1
KR_6759469275,440,-1,-26,-4,-5,3,1,4,-4,6,2,0,0,0,-5,6,1,1,0,1,0,-3,-10,1,-3,2,-1,0,-1,-1,-1,-1,1,4,-1
KR_6649638655,420,-7,-75,-16,-10,-5,5,0,-3,4,1,-3,7,4,1,1,2,0,0,0,0,-8,-38,2,-6,4,2,0,-2,-1,-1,-1,1,5,-1
KR_6632308996,420,-5,-104,-12,-9,-1,2,1,-8,9,1,1,4,5,-1,6,5,0,2,2,0,-2,-8,0,-1,1,-1,0,-3,1,-1,-1,1,1,-1
KR_6739633850,440,3,99,-4,6,3,1,4,-3,4,1,1,5,6,5,1,6,0,6,6,0,-1,-9,0,-3,3,2,0,1,1,0,1,-1,6,-1
KR_6597204447,420,-3,18,-19,-5,3,1,4,-1,3,2,-2,3,1,-4,4,0,-1,1,0,0,-8,-213,-2,-1,3,-2,0,-1,-1,1,1,-1,4,-1
KR_6612179357,420,-2,-51,21,-7,-1,2,1,-5,6,1,0,1,1,-3,4,1,2,0,2,0,-8,256,2,-6,4,-1,0,-1,1,-1,-1,-1,2,-1
KR_6670625347,420,1,44,-3,-2,-2,5,3,0,2,2,1,1,2,2,2,4,-3,4,1,1,-2,-14,0,-2,2,0,0,0,-1,-1,0,1,5,-1
KR_6673467990,420,0,3,10,-2,0,0,0,0,3,3,-8,8,0,3,5,8,3,1,4,0,10,-3,2,-3,1,-2,0,-1,1,-1,-1,-1,3,-1
KR_6754201434,420,-1,45,-8,-1,3,0,3,-2,4,2,0,5,5,-1,4,3,-1,1,0,1,-5,5,3,-4,1,-3,0,-1,-1,-1,-1,1,3,-1
KR_6737958518,420,-2,21,-20,-3,-3,3,0,0,2,2,0,0,0,2,3,5,-2,2,0,1,0,6,0,-7,7,-2,0,0,1,-1,-1,1,1,-1
KR_6724794706,420,-1,-35,56,-5,0,2,2,-2,5,3,-1,3,2,-2,2,0,0,0,0,0,-12,-8,0,-6,6,-6,0,0,1,1,0,-1,1,-1
KR_6746721951,420,-1,-16,-2,1,-4,4,0,-1,3,2,8,2,10,-3,4,1,1,1,2,0,-1,-5,2,-5,3,0,0,0,-1,1,0,1,4,-1
KR_6749683605,420,-5,0,-16,-14,-1,2,1,0,3,3,-1,4,3,-12,12,0,0,2,2,0,-12,-2,2,-4,2,-1,0,-1,-1,0,-1,-1,4,-1
KR_6753875076,420,-1,0,-32,5,2,2,4,4,1,5,0,4,4,-3,3,0,2,1,3,1,0,3,2,-4,2,0,0,0,-1,1,1,1,2,-1
KR_6580452716,420,-2,-8,23,-8,0,1,1,-8,11,3,-4,6,2,1,1,2,3,1,4,1,-7,-151,-4,-3,7,0,0,-2,1,-1,-1,1,6,-1
KR_6652331963,420,-3,-99,-44,0,-1,1,0,0,4,4,-1,2,1,2,0,2,0,3,3,0,2,-9,-4,0,4,6,0,-1,-1,-1,-1,-1,5,-1
KR_6675356593,420,-3,54,8,-12,0,1,1,2,2,4,3,3,6,-11,12,1,-6,6,0,0,-16,405,-5,-1,6,2,0,1,-1,1,1,1,4,-1
KR_6749484858,420,-3,-50,-8,-8,-2,3,1,-1,3,2,-1,2,1,-2,2,0,-2,2,0,0,-8,-2,0,-3,3,0,0,-2,-1,-1,-1,-1,1,-1
KR_6760664291,420,5,66,28,9,10,0,10,1,2,3,-2,3,1,0,2,2,0,0,0,0,-2,-37,1,-5,4,5,0,1,1,0,1,1,5,-1
KR_6762584190,420,1,-5,-4,2,3,1,4,-1,5,4,-1,1,0,2,0,2,-1,1,0,0,6,-1,0,-4,4,2,0,1,-1,1,1,-1,1,-1
KR_6719765328,420,-4,-38,-8,-9,2,1,3,0,3,3,-7,8,1,-1,4,3,-3,3,0,0,-9,-21,-4,-3,7,-1,0,-1,1,1,-1,-1,5,-1
KR_6747993378,420,-3,-56,-19,-12,0,2,2,-3,3,0,-7,9,2,-2,2,0,0,0,0,0,-12,-113,-4,-3,7,-3,0,-3,-1,-1,-1,-1,3,-1
KR_6644563158,420,0,-4,-38,1,2,0,2,-1,3,2,0,1,1,-1,2,1,1,0,1,0,-1,-28,-2,-1,3,-2,0,-2,-1,1,-1,1,2,-1
KR_6757898488,420,-4,-28,0,-7,-4,5,1,1,4,5,1,1,2,-7,8,1,2,0,2,0,-4,-6,3,-6,3,1,0,-1,1,-1,-1,-1,4,-1
KR_6732566548,420,-3,-43,-10,-11,-1,2,1,-2,2,0,-5,6,1,-2,3,1,-1,1,0,0,-12,6,-5,-3,8,-1,0,-1,-1,-1,-1,-1,2,-1
KR_6649735526,420,-4,11,8,-5,-3,3,0,-1,2,1,-2,3,1,3,2,5,-2,2,0,0,-2,-39,2,-6,4,0,0,-1,-1,1,-1,-1,3,-1
KR_6715047376,420,-8,-37,-42,-14,-4,6,2,-8,9,1,3,0,3,-3,3,0,-2,2,0,0,-15,-1,1,-6,5,-1,0,0,-1,1,0,-1,6,-1
KR_6743015547,420,-2,-42,-10,-7,-7,7,0,1,4,5,-4,4,0,1,2,3,2,1,3,0,5,150,-1,-6,7,-19,0,-3,1,-1,-1,-1,1,-1
KR_6619346314,420,1,-68,-44,8,4,0,4,4,1,5,2,3,5,-4,5,1,2,0,2,1,6,5,3,-5,2,-5,0,0,1,-1,0,1,1,-1
KR_6742526512,420,0,7,5,8,3,2,5,2,3,5,-1,3,2,2,2,4,2,2,4,0,11,40,2,-4,2,-13,0,0,-1,1,1,-1,1,-1
KR_6735845768,420,-4,-69,-16,-6,-3,4,1,0,3,3,-2,3,1,-2,3,1,1,0,1,0,0,-4,0,-5,5,1,0,-2,-1,-1,-1,-1,1,-1
KR_6749490239,420,1,16,-16,-6,0,1,1,-3,8,5,-6,6,0,1,2,3,2,0,2,0,-3,51,-2,-3,5,-25,0,-1,0,-1,-1,-1,0,-1
KR_6742492316,420,0,11,-3,-1,0,0,0,-4,6,2,4,0,4,-4,4,0,3,2,5,0,-3,-10,-2,-4,6,-1,0,0,0,0,0,1,0,-1
KR_6751950349,420,4,64,-4,-7,-1,1,0,-2,4,2,-2,4,2,-1,3,2,-1,1,0,0,-6,34,-1,-2,3,-16,0,1,-1,1,1,-1,4,-1
KR_6757026063,420,1,70,-20,0,1,1,2,-4,4,0,4,3,7,0,0,0,-1,1,0,0,0,10,1,-4,3,2,0,2,1,-1,1,1,2,-1
KR_6732214318,420,1,76,-30,3,1,2,3,-1,1,0,1,1,2,1,3,4,1,1,2,0,2,-4,1,-4,3,1,0,1,-1,1,1,1,5,-1
KR_6705464491,420,-1,-45,-23,-7,-4,4,0,-2,4,2,-1,4,3,-2,3,1,2,2,4,0,-4,5,-4,-4,8,1,0,-1,-1,1,-1,-1,2,-1
KR_6712593900,440,-2,-13,20,-17,1,0,1,2,3,5,-9,11,2,-4,7,3,-7,8,1,-2,-18,-5,-2,-2,4,1,0,-3,1,-1,-1,1,1,-1
KR_6749438755,420,-3,-52,-48,-5,4,0,4,-5,5,0,-5,7,2,5,0,5,-4,5,1,0,-2,-2,1,-4,3,-6,0,-1,0,-1,-1,-1,0,-1
KR_6614867684,420,-2,-16,-5,-11,-1,1,0,-4,4,0,-3,4,1,-3,5,2,0,0,0,0,-10,-151,-2,-3,5,15,0,-1,-1,1,-1,1,3,-1
KR_6704783886,420,-1,-61,-19,-2,-6,6,0,0,1,1,1,0,1,-3,4,1,6,0,6,0,5,25,2,-5,3,-15,0,-1,-1,0,-1,-1,3,-1
KR_6759279598,420,-1,16,55,-10,-1,4,3,0,1,1,-2,4,2,-4,6,2,-3,3,0,0,-14,-3,-5,-5,10,1,0,-2,1,-1,-1,1,4,-1
KR_6747095301,420,-1,-13,12,8,-3,4,1,0,2,2,7,4,11,2,0,2,2,0,2,1,6,-14,4,-6,2,-1,0,0,1,1,-1,1,2,-1
KR_6749699321,420,-3,-35,-6,-16,-4,5,1,-3,5,2,0,3,3,-5,7,2,-4,4,0,-2,-14,-4,-3,-1,4,2,0,-1,-1,-1,-1,-1,5,-1
KR_6569874182,420,-1,-2,5,-8,2,2,4,-3,4,1,-3,5,2,-5,6,1,1,0,1,-1,-8,5,-1,-2,3,1,0,-1,1,0,1,-1,6,-1
KR_6759457785,440,3,17,-15,3,-2,4,2,2,1,3,-4,6,2,5,0,5,2,0,2,0,7,2,-3,-2,5,2,0,1,0,0,1,1,0,-1
KR_6625408491,420,-1,-39,-8,-1,3,3,6,1,3,4,-1,2,1,-3,6,3,-1,1,0,0,5,-10,0,-5,5,-1,0,0,-1,1,1,1,1,-1
KR_6739296588,440,-3,-15,-36,-8,-3,4,1,0,4,4,-4,5,1,0,3,3,-1,2,1,-1,-6,-10,-7,-1,8,1,0,0,-1,1,1,-1,5,-1
KR_6740159560,420,-1,-42,-18,1,2,2,4,-1,1,0,-2,3,1,4,0,4,-2,2,0,0,-4,-4,0,-6,6,-2,0,1,-1,1,1,1,6,-1
KR_6681565549,420,2,12,23,2,-1,1,0,2,3,5,3,0,3,0,4,4,-2,2,0,0,2,-37,6,-8,2,20,0,-1,1,0,-1,-1,3,-1
KR_6689451340,420,0,-66,3,3,3,2,5,2,2,4,-3,6,3,2,2,4,-1,2,1,-1,6,301,0,-2,2,1,0,-1,-1,-1,-1,-1,5,-1
KR_6759931856,420,-1,22,-16,5,-2,2,0,7,2,9,-4,6,2,1,5,6,3,2,5,0,5,13,2,-5,3,1,0,0,1,-1,0,-1,2,-1
KR_6715834576,440,1,72,20,2,-1,1,0,-4,4,0,6,0,6,0,1,1,1,1,2,0,-1,-244,-1,-1,2,-2,0,1,1,0,1,1,6,-1
KR_6759646595,420,-2,-90,-12,-2,-5,6,1,2,1,3,3,1,4,-3,4,1,1,1,2,0,2,1,1,-3,2,2,0,-2,-1,0,-1,-1,1,-1
KR_6722489119,420,2,20,-8,-1,4,0,4,-2,2,0,2,1,3,-5,6,1,0,0,0,0,-7,7,-2,-3,5,-2,0,1,0,1,1,-1,0,-1
KR_6714286523,420,-10,-119,-40,-17,3,0,3,-4,4,0,-3,4,1,-13,15,2,0,1,1,0,-18,359,-2,-4,6,1,0,-3,1,1,-1,-1,2,-1
KR_6760274619,420,0,-10,24,-9,-6,6,0,4,1,5,-8,10,2,1,2,3,0,0,0,-5,-9,30,-2,-3,5,-1,0,-1,-1,1,-1,-1,3,-1
KR_6751693668,420,1,-3,-32,3,-4,5,1,2,1,3,4,3,7,4,3,7,-3,3,0,-1,-5,-6,1,-4,3,-1,0,-2,1,-1,-1,-1,2,-1
KR_6669678073,440,1,50,4,7,2,1,3,1,3,4,-4,5,1,-1,4,3,9,1,10,3,11,-7,-3,-3,6,4,0,0,1,0,0,1,5,-1
KR_6608096481,420,2,12,2,2,-4,4,0,0,1,1,5,1,6,1,1,2,0,0,0,0,2,-2,-1,-3,4,5,0,0,1,1,0,1,4,-1
KR_6719572427,440,1,-82,56,6,-3,5,2,1,0,1,-3,6,3,10,2,12,1,2,3,0,9,-9,-1,-1,2,1,0,-1,1,-1,1,1,2,-1
KR_6548055393,420,-3,-80,-4,4,-4,6,2,4,0,4,6,0,6,1,1,2,-3,4,1,0,9,229,1,-5,4,-6,0,0,-1,1,-1,1,1,-1
KR_6169893196,420,2,-25,-32,1,0,1,1,-2,4,2,-2,2,0,2,0,2,3,0,3,0,12,-13,-1,-2,3,5,0,-1,-1,-1,-1,1,1,-1
KR_6731676714,420,-7,-78,-44,-20,-6,6,0,-5,5,0,-9,9,0,-2,4,2,2,0,2,0,-15,-39,-4,-2,6,16,0,-3,-1,-1,-1,-1,4,-1
KR_6763021275,420,-1,-18,-8,-3,-1,2,1,1,1,2,-7,8,1,5,1,6,-1,3,2,0,-1,6,1,-8,7,-2,0,0,1,-1,-1,-1,2,-1
KR_6755081926,440,-1,70,-10,-3,2,0,2,-1,2,1,-4,5,1,5,0,5,-5,6,1,1,2,3,0,-4,4,-20,0,1,-1,-1,1,1,5,-1
KR_6744693513,420,-2,0,-48,-4,-1,2,1,-1,2,1,1,3,4,-3,3,0,0,1,1,0,-3,-13,-2,-2,4,1,0,1,-1,-1,1,1,2,-1
KR_6705612359,440,1,-9,-44,2,-2,3,1,-1,4,3,3,0,3,1,2,3,1,3,4,0,11,-3,-3,-5,8,-1,0,0,0,0,0,-1,0,-1
KR_6752780936,420,0,-3,24,-6,1,0,1,-1,1,0,-3,3,0,-2,3,1,-1,1,0,0,-5,1,1,-5,4,-1,0,-1,-1,0,-1,-1,3,-1
KR_6762393787,420,-1,10,8,-4,-1,1,0,-1,3,2,1,3,4,-3,4,1,0,0,0,0,-6,7,2,-3,1,-4,0,0,-1,1,0,-1,5,-1
KR_6689146362,420,0,-6,33,-5,1,1,2,-2,3,1,4,3,7,-4,5,1,-4,5,1,0,-8,0,-3,-2,5,0,0,0,-1,1,-1,-1,6,-1
KR_6721574217,420,-1,-12,4,-1,2,0,2,-1,3,2,1,0,1,-2,4,2,-1,1,0,0,-3,36,2,-4,2,-19,0,-1,-1,1,-1,1,4,-1
KR_6690801359,420,-1,-6,11,-1,-5,5,0,3,1,4,4,0,4,0,4,4,-3,3,0,0,1,-2,-2,-4,6,2,0,0,-1,-1,1,1,3,-1
KR_6674351551,420,-5,-159,4,-12,-6,6,0,4,1,5,-3,3,0,-2,4,2,-5,5,0,0,-4,-10,-7,-1,8,2,0,-3,0,-1,-1,-1,0,-1
KR_6727000116,420,1,-2,-16,-1,1,1,2,-3,3,0,0,0,0,0,0,0,1,1,2,0,-2,2,3,-6,3,-2,0,0,1,1,0,1,4,-1
KR_6727068541,420,0,-21,-17,4,-7,7,0,2,0,2,-1,3,2,10,2,12,0,0,0,1,18,-291,3,-4,1,-2,0,0,0,-1,1,1,0,-1
KR_6644137233,420,0,28,-4,-3,-2,3,1,-1,2,1,-1,3,2,-4,5,1,5,0,5,0,-4,-2,1,-5,4,1,0,1,1,-1,1,-1,6,-1
KR_6740666697,420,-4,-164,3,-9,-1,1,0,-2,2,0,-2,4,2,-5,7,2,1,1,2,0,-2,69,1,-3,2,-4,0,-1,-1,-1,-1,-1,4,-1
KR_6679786776,420,-1,27,13,-1,0,3,3,2,2,4,-6,7,1,-1,5,4,4,0,4,0,3,10,6,-7,1,-6,0,0,1,-1,0,1,2,-1
KR_6763341544,420,0,-148,-6,-4,-4,4,0,-2,3,1,-1,4,3,0,3,3,3,1,4,0,1,-39,2,-7,5,20,0,-1,-1,-1,-1,-1,1,-1
KR_6721933015,420,-2,-53,-36,-7,-4,4,0,-1,3,2,-4,6,2,0,2,2,2,0,2,0,-6,73,1,-4,3,-2,0,-1,-1,-1,-1,-1,6,-1
KR_6762454367,420,-3,-55,-12,-3,1,3,4,2,2,4,-5,5,0,-1,2,1,0,0,0,-1,-2,2,0,-4,4,2,0,1,1,1,1,-1,3,-1
KR_6703038661,420,-2,4,-26,2,1,1,2,2,1,3,2,2,4,-2,3,1,-1,1,0,0,5,-8,-3,-2,5,2,0,0,-1,-1,-1,1,1,-1
KR_6754795902,420,-4,-48,-26,-4,0,1,1,1,1,2,-1,2,1,-4,5,1,0,2,2,0,-6,2,-2,-3,5,-3,0,-1,-1,0,-1,1,5,-1
KR_6616140859,420,2,-4,-12,-3,0,3,3,-2,3,1,-2,2,0,-1,4,3,2,0,2,-1,-6,-1,0,-5,5,-2,0,0,-1,1,0,1,6,-1
KR_6735162877,420,-1,-10,-20,-2,2,1,3,-3,7,4,-3,3,0,1,3,4,1,0,1,0,2,-4,-1,-4,5,0,0,1,-1,1,1,-1,1,-1
KR_6667296001,440,-2,-43,-12,-6,0,3,3,-1,1,0,-6,7,1,-2,3,1,3,1,4,-1,0,-9,0,-4,4,4,0,-1,1,-1,-1,-1,2,-1
KR_6679217086,420,0,-3,-36,-2,-2,3,1,0,3,3,4,1,5,-2,3,1,-2,2,0,0,3,-45,-1,-2,3,22,0,0,-1,1,1,-1,2,-1
KR_6739670382,420,-5,-59,-28,-12,-7,7,0,-2,4,2,-1,4,3,1,4,5,-3,4,1,0,0,18,-2,-7,9,-2,0,0,1,0,-1,-1,6,-1
KR_6672714381,420,-10,-105,-83,-12,3,1,4,-3,4,1,-8,10,2,-1,2,1,-3,3,0,0,-6,3,0,-5,5,-2,0,-3,-1,1,-1,-1,6,-1
KR_6620392462,420,0,23,-12,1,0,1,1,3,2,5,-4,4,0,1,0,1,1,2,3,0,2,8,-4,-4,8,3,0,1,1,-1,1,-1,3,-1
KR_6726840429,420,-3,-38,0,-5,-2,4,2,-2,2,0,0,0,0,0,4,4,-1,1,0,0,-6,-16,2,-5,3,14,0,-1,1,-1,-1,-1,3,-1
KR_6716547114,440,-3,38,-27,-9,-1,5,4,-1,4,3,0,1,1,-7,8,1,0,2,2,0,-11,47,2,-5,3,-31,0,-1,1,-1,-1,-1,2,-1
KR_6746725580,420,-6,-49,-27,-5,-2,5,3,0,4,4,-1,1,0,-1,4,3,-1,2,1,0,-2,5,3,-5,2,-2,0,-2,-1,-1,-1,-1,1,-1
KR_6758959034,420,0,-1,7,4,-3,4,1,2,2,4,-1,1,0,3,0,3,3,0,3,0,11,7,1,-5,4,-5,0,0,-1,1,1,1,1,-1
KR_6628726272,420,-3,-27,-3,-7,0,1,1,0,3,3,2,0,2,-7,7,0,-2,3,1,0,-4,-21,5,-5,0,-2,0,-1,1,-1,-1,-1,4,-1
KR_6747944114,420,-4,-67,-34,-5,-1,3,2,-4,7,3,-1,1,0,0,5,5,1,1,2,0,-1,24,2,-6,4,-3,0,0,-1,1,-1,1,2,-1
KR_6754269447,420,-6,-75,-36,-9,-3,3,0,-2,6,4,-7,7,0,1,0,1,2,0,2,0,-1,-45,-2,-3,5,1,0,-1,-1,-1,-1,1,3,-1
KR_6763810438,420,-4,-67,20,-7,-6,6,0,2,1,3,1,0,1,1,1,2,-5,6,1,0,-2,165,4,-6,2,-4,0,-1,1,-1,-1,1,5,-1
KR_6762821180,420,1,37,-36,7,3,1,4,-1,5,4,4,3,7,-1,3,2,2,0,2,0,4,186,1,-4,3,0,0,0,1,1,0,1,1,-1
KR_6641735453,420,-2,-44,-12,2,3,1,4,0,1,1,-1,3,2,1,0,1,-1,1,0,0,3,-10,3,-7,4,-1,0,0,1,0,0,1,3,-1
KR_6695513943,420,-2,-26,2,-7,-5,6,1,-1,4,3,2,1,3,-3,5,2,0,3,3,0,-2,-3,1,-4,3,-3,0,-2,-1,1,-1,-1,4,-1
KR_6698621721,420,-2,-49,-7,-5,1,2,3,-6,9,3,0,1,1,-2,3,1,2,0,2,0,-4,-159,3,-7,4,2,0,1,0,1,-1,1,0,-1
KR_6635227015,440,-4,-17,-58,-13,6,1,7,-3,5,2,-2,2,0,-10,10,0,-4,5,1,-2,-23,2,-2,-2,4,-4,0,0,-1,-1,-1,-1,6,-1
KR_6761574509,420,-2,-36,-4,-1,1,5,6,0,2,2,-5,7,2,3,1,4,0,1,1,0,6,180,-2,-1,3,-2,0,0,-1,0,0,1,1,-1
KR_6733838495,420,-2,-76,-44,-9,2,1,3,-3,4,1,-4,8,4,-4,5,1,0,2,2,0,-14,-7,-6,-3,9,4,0,-1,1,0,-1,-1,4,-1
KR_6761049565,420,-2,-33,0,2,-3,3,0,4,1,5,-3,3,0,2,2,4,2,0,2,0,13,0,-2,-3,5,-3,0,0,1,0,0,-1,3,-1
KR_6729380666,420,0,-43,0,-7,0,2,2,-1,3,2,0,3,3,-4,5,1,-2,4,2,0,-9,-14,1,-5,4,-2,0,-1,-1,-1,-1,1,1,-1
KR_6715723374,420,-4,-4,-28,-13,-2,2,0,-3,3,0,-4,7,3,-2,4,2,-2,4,2,-1,-11,503,-1,-3,4,1,0,0,-1,-1,-1,-1,6,-1
KR_6394632441,420,-1,-22,4,-1,1,0,1,2,1,3,-2,3,1,-2,2,0,0,1,1,0,-1,-2,0,-7,7,-3,0,-1,0,1,-1,-1,0,-1
KR_6721666924,420,0,-41,7,-3,-3,4,1,4,2,6,-3,3,0,-2,2,0,1,0,1,0,3,11,-5,-1,6,0,0,0,-1,-1,-1,1,6,-1
KR_6733158333,420,-1,-50,19,4,0,2,2,0,1,1,3,1,4,3,1,4,-2,2,0,0,3,-4,-3,-2,5,-4,0,-1,-1,1,-1,1,6,-1
KR_6679917910,420,-4,-102,15,-4,1,0,1,2,0,2,2,1,3,-7,7,0,-2,3,1,-1,-4,57,-1,-5,6,-2,0,0,-1,1,-1,-1,4,-1
KR_6694584626,420,-2,-27,-5,3,-2,3,1,-1,2,1,0,4,4,1,2,3,5,0,5,0,7,6,-1,-1,2,-1,0,1,1,1,1,1,6,-1
KR_6732755014,420,-3,-1,-28,2,-4,4,0,1,3,4,0,2,2,3,1,4,2,1,3,0,6,-4,-4,-1,5,1,0,0,-1,-1,0,1,2,-1
KR_6620993845,420,-4,-35,11,-11,0,3,3,-1,2,1,-7,8,1,-3,3,0,0,1,1,0,-6,-11,-5,-2,7,6,0,-1,-1,1,-1,-1,4,-1
KR_6687012469,420,-2,18,-20,-5,0,1,1,2,0,2,0,3,3,-5,5,0,-2,3,1,0,0,3,1,-5,4,0,0,-2,1,-1,-1,-1,6,-1
KR_6756975578,420,-3,-16,-16,-5,-1,3,2,-1,1,0,-4,6,2,0,2,2,1,0,1,0,0,-3,-3,-1,4,0,0,1,-1,1,1,1,6,-1
KR_6749384396,420,1,18,3,-5,3,0,3,4,1,5,-9,9,0,-1,4,3,-2,2,0,0,2,-10,-2,-4,6,-1,0,0,-1,1,-1,-1,2,-1
KR_6722965035,420,-4,-3,-12,-9,-2,3,1,-2,5,3,-2,3,1,-1,2,1,-2,2,0,0,-9,-8,-4,-2,6,3,0,0,1,-1,-1,-1,1,-1
KR_6596913124,420,-5,-15,-12,-12,-2,2,0,-3,5,2,-2,3,1,-3,4,1,-2,2,0,-1,-14,50,0,-4,4,-34,0,-1,-1,1,-1,-1,2,-1
KR_6711152834,440,-8,-98,-40,-21,-6,9,3,-7,10,3,-5,6,1,-6,8,2,3,0,3,0,-11,-21,-1,-4,5,3,0,-2,0,-1,-1,1,0,-1
KR_6627785705,440,-3,-73,20,-4,0,1,1,-2,5,3,-4,4,0,1,4,5,1,0,1,0,-1,3,0,-4,4,-2,0,0,1,-1,-1,-1,3,-1
KR_6721792536,420,-4,-27,12,-5,0,1,1,0,2,2,-3,4,1,-4,5,1,2,0,2,0,-13,-7,2,-5,3,-3,0,0,-1,-1,0,-1,6,-1
KR_6750842574,440,-2,-20,18,-5,4,1,5,-1,2,1,-4,4,0,-1,4,3,-3,4,1,0,-7,1,2,-4,2,-2,0,-1,1,1,-1,-1,6,-1
KR_6511647340,420,-6,-81,-37,-6,-1,3,2,-5,5,0,-3,5,2,2,0,2,1,1,2,-1,-8,18,0,-2,2,-4,0,-1,-1,0,-1,-1,1,-1
KR_6670592066,420,-2,-11,-8,-4,1,0,1,0,2,2,-3,3,0,-2,2,0,0,0,0,0,-8,-24,-3,-1,4,1,0,-1,-1,-1,-1,1,3,-1
KR_5870452292,420,0,-41,11,-6,1,3,4,1,3,4,-3,5,2,-2,3,1,-3,3,0,0,-9,-6,0,-2,2,-3,0,-1,-1,1,-1,1,4,-1
KR_6666977301,420,-3,-14,0,2,0,2,2,-7,8,1,4,4,8,-1,3,2,6,0,6,0,7,8,2,-2,0,0,0,-1,1,-1,-1,-1,6,-1
KR_6655327149,420,-9,-79,-68,-14,0,1,1,-6,6,0,-9,9,0,4,1,5,-3,3,0,2,-10,-361,-1,-1,2,4,0,-1,-1,-1,-1,1,6,-1
KR_6716639938,420,0,-39,-4,-1,-2,2,0,3,2,5,-2,4,2,0,1,1,0,0,0,0,0,186,2,-7,5,-1,0,-1,1,1,1,1,2,-1
KR_6701079469,420,-4,-60,-33,-17,-6,6,0,-6,7,1,1,0,1,-5,5,0,-1,1,0,-2,-15,-5,-5,0,5,-1,0,-1,0,-1,-1,-1,0,-1
KR_6670366572,420,-1,5,4,2,-1,3,2,-4,7,3,1,2,3,4,3,7,2,0,2,1,1,-2,0,-3,3,0,0,-1,1,-1,-1,1,2,-1
KR_6717386213,420,4,6,-12,9,1,1,2,3,3,6,0,2,2,5,2,7,0,0,0,-2,8,103,1,-4,3,2,0,0,-1,-1,-1,-1,5,-1
KR_6728638450,420,-2,3,-4,-13,-4,5,1,-1,3,2,-1,2,1,-8,9,1,1,0,1,0,-13,-174,-6,-1,7,-3,0,-1,-1,0,-1,-1,6,-1
KR_6625904070,420,-3,-80,-12,-1,-4,4,0,3,1,4,0,3,3,1,1,2,-1,1,0,1,0,-4,-6,-2,8,0,0,0,-1,-1,-1,1,3,-1
KR_6760922577,420,-2,-57,8,-10,-3,3,0,-1,3,2,5,1,6,-6,7,1,-5,5,0,0,-19,-6,-1,-2,3,0,0,-1,0,-1,-1,-1,0,-1
KR_6696549543,440,-6,-67,-16,-12,2,0,2,-6,6,0,-2,6,4,-1,2,1,-5,5,0,0,-10,3,-1,-5,6,-3,0,-1,1,1,-1,1,3,-1
KR_6741247644,420,-3,-90,3,-8,1,1,2,-1,3,2,-4,10,6,-3,4,1,-1,2,1,-2,2,3,3,-6,3,-1,0,-1,1,0,-1,-1,5,-1
KR_6761046836,420,0,21,-12,-1,0,3,3,1,1,2,-2,2,0,0,1,1,0,0,0,0,-1,-12,2,-3,1,0,0,0,0,-1,0,1,0,-1
KR_6742268593,420,-3,-55,-24,-4,3,0,3,-2,2,0,-3,3,0,0,5,5,-2,5,3,0,-6,4,-1,-3,4,-2,0,-3,1,-1,-1,-1,4,-1
KR_6760669244,420,0,42,24,-1,3,1,4,2,0,2,-1,1,0,-5,5,0,0,2,2,0,1,-1,-1,-4,5,4,0,1,-1,1,1,-1,4,-1
KR_6637134599,440,-1,60,-8,-11,1,0,1,-2,4,2,-1,3,2,-7,7,0,-2,2,0,0,-13,93,3,-5,2,0,0,-1,-1,0,-1,1,1,-1
KR_6686696516,420,-4,31,-8,-5,-3,4,1,-3,3,0,-5,6,1,5,1,6,1,2,3,-1,-2,30,1,-6,5,-5,0,-1,1,-1,-1,-1,5,-1
KR_6640897592,420,-7,-61,8,-11,-4,6,2,-6,7,1,-1,1,0,0,3,3,0,1,1,0,-13,-3,3,-7,4,-8,0,-3,0,-1,-1,1,0,-1
KR_6754934395,420,-1,-24,-4,-1,-4,4,0,-1,7,6,0,2,2,1,2,3,3,0,3,0,3,13,-7,-2,9,-2,0,1,-1,-1,-1,1,3,-1
KR_6759334971,420,0,-37,12,-2,-2,2,0,-1,2,1,-2,6,4,2,0,2,1,0,1,0,0,-9,-2,-4,6,-6,0,-1,-1,0,-1,1,1,-1
KR_6763674876,440,-1,1,-8,-7,-1,4,3,-3,8,5,-2,2,0,0,2,2,-1,1,0,0,-7,3,-2,-3,5,3,0,-1,-1,-1,-1,-1,1,-1
KR_6753336306,420,0,10,-8,-1,1,1,2,-2,2,0,-1,2,1,-1,3,2,2,0,2,0,-7,6,2,-6,4,-4,0,0,1,-1,0,1,6,-1
KR_6734864647,420,-4,-16,-16,0,-1,2,1,0,1,1,0,4,4,1,5,6,0,1,1,0,-9,-11,-2,-4,6,-3,0,-2,0,-1,-1,1,0,-1
KR_6762229114,420,0,15,16,-6,2,2,4,0,2,2,-1,2,1,-7,8,1,0,1,1,0,-8,3,-4,0,4,-3,0,-2,-1,-1,-1,1,2,-1
KR_6653799906,420,2,-38,19,7,1,2,3,1,3,4,4,1,5,-2,5,3,3,0,3,0,11,0,-2,-5,7,3,0,0,0,1,0,1,0,-1
KR_6622955073,440,-7,-191,-36,-13,-2,3,1,-1,2,1,-1,3,2,-7,11,4,-2,2,0,1,-8,300,-4,-1,5,27,0,-3,-1,-1,-1,1,4,-1
KR_6763290694,420,-2,-17,0,-7,0,2,2,1,1,2,-1,1,0,-7,9,2,0,1,1,0,-8,11,-1,-3,4,-4,0,0,1,1,0,-1,3,-1
KR_6709576353,420,0,19,-10,1,3,0,3,-1,2,1,-4,6,2,3,1,4,0,1,1,0,-1,0,-3,-2,5,0,0,0,1,0,-1,1,3,-1
KR_6726389692,420,0,-14,-18,5,1,2,3,-5,6,1,3,2,5,4,1,5,2,0,2,-1,9,-1,0,-4,4,-2,0,-1,-1,-1,-1,-1,2,-1
KR_6759106551,420,2,13,-20,-2,1,1,2,-1,1,0,-2,6,4,1,2,3,-1,1,0,-1,0,-11,-8,0,8,5,0,0,-1,1,0,-1,5,-1
KR_6734169593,420,2,-21,4,7,0,3,3,2,0,2,0,3,3,0,3,3,5,0,5,0,10,2,-3,-6,9,0,0,0,1,1,1,1,4,-1
KR_6553390363,420,1,-11,3,1,-1,2,1,0,3,3,2,0,2,-1,1,0,1,0,1,0,-2,2,3,-5,2,-8,0,1,1,1,1,1,5,-1
KR_6760861717,420,-6,-44,-16,-9,-1,2,1,-3,3,0,3,1,4,-9,11,2,1,1,2,0,-8,-27,-2,-2,4,-3,0,-2,-1,1,-1,1,4,-1
KR_6760548359,440,-1,-3,18,-9,-3,6,3,-3,3,0,-3,4,1,-1,5,4,1,2,3,1,-1,-202,2,-5,3,0,0,0,-1,1,0,1,1,-1
KR_6700141833,440,0,-50,8,0,1,0,1,2,0,2,0,2,2,-1,4,3,-2,3,1,0,-3,3,2,-7,5,-3,0,-1,-1,0,-1,1,1,-1
KR_6614307821,420,-2,-47,2,-8,0,1,1,-1,1,0,0,3,3,-7,11,4,0,0,0,0,-7,-5,4,-5,1,-3,0,-1,1,0,-1,-1,1,-1
KR_6759414950,420,-7,-51,35,-18,-5,7,2,-6,7,1,-1,2,1,-4,6,2,-2,2,0,-1,-18,6,2,-5,3,-5,0,-1,-1,1,-1,-1,2,-1
KR_6750870312,420,1,43,-12,2,1,2,3,-1,2,1,0,1,1,1,2,3,1,2,3,0,-4,-2,2,-3,1,2,0,0,1,-1,-1,-1,4,-1
KR_6743384484,420,0,-33,16,-1,-4,5,1,7,1,8,-1,3,2,-2,3,1,-1,1,0,0,5,4,-1,-5,6,-4,0,0,-1,-1,0,1,3,-1
KR_6764630235,420,-1,-72,4,1,0,2,2,1,1,2,1,1,2,-1,4,3,0,1,1,-1,4,9,0,-3,3,-3,0,0,1,0,-1,-1,1,-1
KR_6760957944,440,1,-41,7,-1,-1,1,0,2,1,3,-4,5,1,0,1,1,2,1,3,0,2,121,5,-9,4,-3,0,0,-1,1,-1,-1,1,-1
KR_6733684014,420,2,7,10,0,0,2,2,2,1,3,4,0,4,-3,3,0,-3,3,0,0,-2,12,-2,-2,4,-3,0,0,-1,-1,1,1,1,-1
KR_6743173330,420,-2,-8,8,-6,0,2,2,-2,2,0,-5,8,3,2,1,3,-1,2,1,-1,-10,-35,-7,0,7,1,0,-1,-1,-1,-1,-1,4,-1
KR_6754786295,440,0,-44,12,3,-3,6,3,0,0,0,0,4,4,5,1,6,1,4,5,1,1,6,2,-2,0,-2,0,1,-1,1,1,1,5,-1
KR_6761004285,420,-4,-2,16,-4,-3,4,1,0,2,2,1,2,3,-2,4,2,0,1,1,0,-6,-6,2,-3,1,1,0,1,1,1,1,1,6,-1
KR_6730869556,420,-3,-3,-4,-14,-2,2,0,3,3,6,-8,8,0,-4,7,3,-3,3,0,-1,-18,231,-2,-1,3,-1,0,-3,-1,1,-1,-1,6,-1
KR_6643916696,440,1,41,28,-7,1,0,1,-2,5,3,-2,4,2,-2,3,1,-2,2,0,1,-10,0,1,-5,4,-2,0,1,-1,1,1,1,2,-1
KR_6727706388,420,0,38,2,-1,1,2,3,-6,6,0,0,7,7,1,3,4,3,0,3,-1,2,-2,-1,-3,4,4,0,1,1,-1,-1,-1,6,-1
KR_6397566289,420,-3,-84,-12,-10,-2,2,0,2,1,3,-1,5,4,0,1,1,-9,10,1,-1,-11,11,3,-4,1,0,0,-1,-1,-1,-1,-1,1,-1
KR_6755104050,420,-3,-26,-4,-11,1,0,1,-2,2,0,-5,7,2,-1,4,3,-4,4,0,0,-18,-17,3,-5,2,18,0,-1,0,0,-1,-1,0,-1
KR_6761057578,420,-3,-53,8,-8,2,0,2,-3,3,0,-2,3,1,-4,5,1,-1,2,1,0,-11,110,-3,-2,5,-2,0,0,0,0,0,-1,0,-1
KR_6746257719,420,-3,-78,-4,-12,-1,4,3,-2,4,2,-1,3,2,-4,6,2,-4,5,1,0,-7,-14,2,-4,2,-4,0,-1,1,-1,-1,-1,6,-1
KR_6665246865,420,-3,0,-1,-5,0,1,1,-3,6,3,2,1,3,-2,2,0,-2,2,0,0,-6,6,-1,-1,2,3,0,0,0,0,-1,1,0,-1
KR_6751371494,420,-2,-84,-11,1,0,4,4,1,0,1,2,3,5,-1,2,1,-1,1,0,0,7,-51,-1,-1,2,12,0,-3,1,-1,-1,-1,2,-1
KR_6639985620,420,0,-22,9,5,5,0,5,1,1,2,-2,5,3,0,2,2,1,1,2,0,4,12,-1,-4,5,-2,0,1,1,1,1,1,6,-1
KR_6626934669,420,-6,-91,-55,-12,-3,3,0,-4,5,1,-5,6,1,1,7,8,-1,1,0,0,-6,-2,0,-5,5,-4,0,-3,-1,-1,-1,1,1,-1
KR_6731038939,420,-6,2,-15,-13,-2,2,0,-8,9,1,-3,5,2,-2,3,1,2,2,4,-1,-11,9,-2,-4,6,0,0,0,-1,-1,-1,1,4,-1
KR_6714411417,420,-7,-34,-34,-9,1,2,3,-2,3,1,-2,8,6,-6,7,1,0,2,2,0,2,155,0,-4,4,1,0,-1,-1,-1,-1,-1,1,-1
KR_6732155295,420,-2,-75,1,-4,-1,2,1,3,0,3,-1,3,2,-5,7,2,0,1,1,1,-6,-1,-5,-3,8,-4,0,0,0,-1,0,1,0,-1
KR_6752189529,420,-2,12,-47,-4,3,2,5,-3,8,5,-1,5,4,-3,3,0,0,1,1,0,-3,-5,-1,-4,5,3,0,-1,-1,-1,-1,-1,6,-1
KR_6746099932,420,-3,-53,8,-2,-5,5,0,5,1,6,0,1,1,1,3,4,-3,5,2,-1,-3,-2,2,-7,5,0,0,-2,-1,-1,-1,-1,1,-1
KR_6739209623,420,3,13,-23,4,2,1,3,1,2,3,6,0,6,-6,8,2,1,1,2,0,-1,16,0,-5,5,-1,0,0,-1,0,1,1,5,-1
KR_6757853243,420,5,31,17,12,0,3,3,1,2,3,3,3,6,8,1,9,0,0,0,2,18,1,4,-6,2,3,0,1,-1,-1,1,1,5,-1
KR_6729397960,420,1,-21,-16,-2,0,1,1,3,4,7,-8,8,0,2,2,4,1,3,4,0,-4,-182,-2,-3,5,-6,0,-1,-1,-1,-1,-1,1,-1
KR_6763428427,420,-7,-128,-9,-20,1,1,2,-5,7,2,-13,14,1,-5,5,0,2,0,2,-1,-6,-1,1,-3,2,-1,0,-3,-1,-1,-1,-1,6,-1
KR_6762205252,420,1,-44,15,3,-3,7,4,1,1,2,3,1,4,0,4,4,2,0,2,-1,1,12,7,-10,3,-3,0,-1,0,-1,-1,-1,0,-1
KR_6764135521,420,0,-12,11,5,0,1,1,5,1,6,0,2,2,1,2,3,-1,2,1,0,1,-279,-2,-3,5,1,0,-1,1,1,-1,1,6,-1
KR_6636820289,420,-1,-23,-22,-3,-2,4,2,2,2,4,-2,4,2,1,6,7,-2,2,0,1,-3,-21,-1,-4,5,3,0,0,0,-1,1,-1,0,-1
KR_6761299117,420,1,4,31,1,0,1,1,2,1,3,-1,4,3,0,2,2,0,3,3,1,-7,2,-5,-1,6,2,0,0,0,-1,1,1,0,-1
KR_6762219846,420,-1,-24,-16,-10,-6,8,2,-1,4,3,-5,5,0,1,2,3,1,0,1,0,-1,8,0,-3,3,1,0,1,-1,-1,1,-1,5,-1
KR_6740798329,420,-4,-39,-7,0,5,1,6,2,4,6,-5,8,3,-2,6,4,0,1,1,-2,3,-8,2,-3,1,1,0,-1,1,0,-1,1,2,-1
KR_6735163739,420,-1,30,-26,-4,-1,2,1,-1,2,1,-5,7,2,1,2,3,2,1,3,0,0,7,2,-4,2,3,0,-2,1,-1,-1,1,3,-1
KR_6650843047,420,-2,-72,-26,-7,-1,3,2,-2,3,1,-1,2,1,-4,8,4,1,1,2,0,-4,-1,2,-5,3,-3,0,0,-1,1,-1,1,5,-1
KR_6763627902,420,-4,-77,24,-7,-1,2,1,1,1,2,1,1,2,-9,11,2,1,1,2,0,-13,-32,0,-4,4,16,0,0,1,1,-1,-1,2,-1
KR_6669716059,420,1,83,-4,-3,5,1,6,-3,3,0,0,2,2,-2,3,1,-3,3,0,0,-8,-2,-1,-3,4,1,0,0,1,0,0,-1,1,-1
KR_6757075169,420,2,-15,12,4,-4,5,1,-1,4,3,5,0,5,4,3,7,0,2,2,0,10,13,4,-6,2,2,0,0,0,0,-1,-1,0,-1
KR_6605893659,420,-2,-58,-28,1,4,0,4,-6,9,3,6,2,8,-3,6,3,0,0,0,0,-2,-6,1,-4,3,2,0,-1,-1,-1,-1,1,4,-1
KR_6722100431,420,3,41,16,11,2,0,2,-1,1,0,2,1,3,7,3,10,1,0,1,0,13,-126,2,-3,1,0,0,1,0,1,1,1,0,-1
KR_6698862705,420,0,97,-16,-7,0,0,0,-2,4,2,-3,4,1,-1,1,0,-1,5,4,0,0,-1,0,-3,3,0,0,0,-1,0,0,1,1,-1
KR_6614916467,420,2,-51,44,1,0,1,1,0,3,3,3,1,4,-6,6,0,4,1,5,0,-8,4,5,-7,2,-3,0,0,-1,1,-1,1,3,-1
KR_6660521820,420,-1,5,-56,-2,-1,1,0,1,2,3,-3,4,1,0,6,6,1,0,1,0,-1,-3,-1,-1,2,2,0,0,1,-1,0,-1,4,-1
KR_6726216295,420,-1,7,7,2,0,0,0,-1,4,3,0,1,1,1,2,3,2,2,4,-1,-3,106,-1,-5,6,-4,0,0,1,-1,1,-1,4,-1
KR_6710138459,440,1,62,-13,0,2,1,3,-2,2,0,2,0,2,-2,3,1,0,0,0,0,-6,7,-2,-2,4,2,0,0,-1,1,0,1,3,-1
KR_6727515203,420,3,32,-28,1,1,2,3,1,0,1,1,3,4,-1,3,2,-1,1,0,0,-2,0,-4,-1,5,0,0,-1,0,-1,-1,1,0,-1
KR_6740230931,440,-4,-127,-4,-10,-5,6,1,1,4,5,-3,4,1,-3,11,8,0,1,1,-2,-7,6,2,-7,5,1,0,-3,1,1,-1,-1,3,-1
KR_6733317663,420,-3,1,-20,-4,-2,2,0,1,0,1,-4,4,0,4,1,5,-3,3,0,0,3,2,0,-4,4,-1,0,1,-1,0,1,-1,4,-1
KR_6662586568,440,2,-6,8,-1,0,0,0,-1,3,2,-4,5,1,5,1,6,-1,2,1,-1,0,-2,-1,-6,7,3,0,-1,-1,-1,-1,-1,3,-1
KR_6685274001,420,0,29,-12,-3,-4,4,0,0,4,4,0,2,2,1,4,5,0,1,1,0,2,9,2,-9,7,3,0,-1,1,-1,-1,1,3,-1
KR_6747004167,420,1,-41,-14,-2,-6,6,0,2,0,2,-2,3,1,-1,2,1,5,0,5,0,0,154,-4,-4,8,0,0,0,1,-1,-1,-1,3,-1
KR_6741766452,420,-3,-40,-26,-2,3,0,3,-3,4,1,-1,2,1,-1,2,1,0,3,3,0,-3,183,2,-6,4,-6,0,0,-1,1,-1,1,1,-1
KR_6756728563,420,-1,-85,6,-2,0,3,3,0,2,2,4,0,4,-6,8,2,0,1,1,0,1,-50,-3,-2,5,24,0,-1,1,-1,-1,1,6,-1
KR_6734167668,420,-6,-140,-46,-14,-5,5,0,-8,8,0,-2,6,4,1,2,3,0,3,3,0,-10,-7,-1,0,1,2,0,-4,0,0,-1,-1,0,-1
KR_6735671903,420,0,28,-30,2,-3,3,0,4,2,6,0,0,0,0,1,1,1,0,1,-1,1,27,1,-5,4,1,0,0,-1,1,0,-1,2,-1
KR_6760429844,420,-1,-8,8,1,0,0,0,-2,2,0,7,1,8,-2,6,4,-2,3,1,0,-1,-4,-3,-3,6,1,0,0,-1,1,1,-1,4,-1
KR_6725270027,420,0,-8,-52,-3,-4,5,1,6,2,8,1,1,2,-1,2,1,-5,5,0,-1,-2,4,0,-5,5,-3,0,-1,1,-1,-1,-1,5,-1
KR_6737721053,440,-5,-65,-8,-6,0,3,3,-3,3,0,-3,4,1,0,2,2,0,0,0,1,-6,-4,0,-1,1,0,0,-1,-1,0,-1,1,4,-1
KR_6637951328,420,1,-12,32,-4,-5,5,0,2,3,5,-2,2,0,1,3,4,0,1,1,0,2,-2,1,-2,1,1,0,0,1,1,0,1,1,-1
KR_6647395186,420,-6,-94,-3,-19,-2,5,3,-2,2,0,-7,7,0,-3,3,0,-5,6,1,0,-16,-7,-2,-2,4,-1,0,-2,1,-1,-1,-1,6,-1
KR_6619808679,420,-1,-35,12,-5,1,1,2,-1,6,5,0,2,2,-5,5,0,0,0,0,0,-6,-15,-2,-3,5,-2,0,0,1,-1,-1,1,4,-1
KR_6751047052,420,-3,28,-14,-11,-2,3,1,-5,6,1,0,2,2,-3,6,3,-1,1,0,0,-6,9,-2,-1,3,1,0,0,0,-1,-1,-1,0,-1
KR_6649818665,420,-1,-13,-7,-8,0,2,2,-3,3,0,-4,6,2,1,4,5,-2,5,3,-2,0,-36,0,-2,2,2,0,0,1,-1,0,-1,3,-1
KR_6764380913,440,0,22,-25,5,4,1,5,2,2,4,0,6,6,-3,8,5,2,2,4,0,-2,-3,-3,-3,6,-1,0,2,1,1,1,1,4,-1
KR_6744916107,420,-6,-34,-52,-12,2,0,2,-2,2,0,-2,2,0,-9,9,0,-1,1,0,0,-19,-8,0,-3,3,-6,0,-2,-1,-1,-1,-1,2,-1
KR_6729301743,420,2,73,-23,-1,-2,4,2,-1,2,1,2,0,2,0,2,2,0,0,0,1,-2,-7,-2,-3,5,4,0,1,-1,1,1,1,1,-1
KR_6734269608,420,0,-46,30,-2,3,0,3,-2,2,0,2,0,2,-3,3,0,-2,2,0,0,-7,-29,-3,0,3,-1,0,0,1,-1,0,1,1,-1
KR_6720154983,420,0,13,-16,0,1,1,2,-4,5,1,4,1,5,-2,4,2,1,0,1,0,0,-10,5,-6,1,3,0,0,-1,1,0,1,4,-1
KR_6763363032,420,2,6,-20,6,0,1,1,0,3,3,-1,2,1,5,2,7,2,1,3,-1,1,139,-1,-2,3,-1,0,1,1,-1,1,-1,5,-1
KR_6654346582,420,-6,-93,-24,-14,-5,5,0,1,1,2,-4,6,2,-6,6,0,0,0,0,0,-6,6,-6,0,6,-2,0,-2,-1,1,-1,-1,4,-1
KR_6736532842,420,-2,-13,-2,-6,2,2,4,-3,5,2,-3,5,2,-2,4,2,0,1,1,-1,-11,12,-2,-3,5,3,0,1,-1,1,1,-1,6,-1
KR_6761201076,420,-1,3,24,-1,1,2,3,6,0,6,0,2,2,-6,7,1,-2,2,0,0,-3,6,4,-7,3,-7,0,-1,1,-1,-1,-1,3,-1
KR_6697266230,420,-5,-110,-30,-10,-5,7,2,1,2,3,-5,5,0,1,3,4,-2,2,0,0,-1,-6,0,-3,3,1,0,0,1,0,-1,-1,4,-1
KR_6729163669,420,3,87,0,4,1,1,2,-1,4,3,1,0,1,2,1,3,1,1,2,1,2,-13,3,-3,0,0,0,1,-1,1,1,1,5,-1
KR_6757083773,420,-3,8,-28,-8,4,2,6,-5,5,0,-2,4,2,-5,6,1,0,3,3,0,-11,1,1,-8,7,3,0,-1,-1,-1,-1,1,3,-1
KR_6763495880,420,-6,-52,5,-13,0,0,0,0,3,3,-7,8,1,-3,5,2,-3,3,0,0,-15,340,-4,-1,5,4,0,-1,-1,0,-1,-1,1,-1
KR_6744722807,420,-4,-29,10,-11,-7,7,0,-3,3,0,4,0,4,-4,4,0,-1,1,0,0,-4,-13,2,-5,3,1,0,-1,1,-1,-1,-1,3,-1
KR_6750850622,420,0,-31,41,0,0,0,0,-2,3,1,2,1,3,-9,9,0,9,3,12,-1,0,-108,1,-5,4,3,0,-1,-1,1,-1,-1,4,-1
KR_6732448480,420,-3,-22,-17,2,0,1,1,1,2,3,-4,4,0,3,1,4,2,0,2,0,-1,12,1,-3,2,0,0,0,1,1,0,1,3,-1
KR_6756531710,420,-5,-78,-43,-7,-2,3,1,0,1,1,-1,3,2,-2,4,2,-2,2,0,0,-2,2,1,-2,1,3,0,-3,-1,-1,-1,-1,5,-1
KR_6670861152,420,-5,-18,-4,-7,1,1,2,-4,5,1,-2,5,3,-1,3,2,-1,2,1,2,-2,-5,0,-6,6,-5,0,0,-1,1,0,1,1,-1
KR_6732084648,420,3,70,35,-1,2,1,3,-5,6,1,3,3,6,-2,5,3,1,1,2,-1,-13,114,-1,-2,3,2,0,1,-1,1,1,-1,2,-1
KR_6761220040,420,0,-21,-36,2,1,1,2,2,1,3,-2,3,1,0,3,3,1,0,1,0,3,11,0,-5,5,0,0,1,-1,1,1,1,1,-1
KR_6762730424,420,0,26,-8,0,1,2,3,-3,3,0,4,2,6,0,5,5,-2,6,4,-1,-5,-10,0,-3,3,1,0,-1,-1,1,-1,1,2,-1
KR_6762621659,420,-3,-17,16,-6,0,0,0,-10,11,1,2,2,4,0,1,1,2,0,2,0,-3,2,-2,-2,4,-1,0,0,0,0,0,1,0,-1
KR_6743943981,420,-1,16,-16,0,-2,2,0,-5,7,2,6,1,7,1,1,2,0,1,1,0,-10,4,1,-7,6,-5,0,0,1,-1,1,1,1,-1
KR_6714638202,420,-4,-29,0,-7,-7,9,2,-1,5,4,0,2,2,1,3,4,0,1,1,1,-1,5,1,-7,6,0,0,-1,1,-1,-1,1,6,-1
KR_6761286692,440,4,57,-12,6,-1,2,1,0,1,1,2,1,3,6,1,7,-1,2,1,0,7,7,0,-4,4,0,0,1,-1,1,1,1,3,-1
KR_6641184575,420,-2,-28,-13,-10,-1,2,1,-6,7,1,-1,4,3,-1,3,2,-1,1,0,-1,-7,45,1,-4,3,-19,0,0,-1,1,-1,-1,3,-1
KR_6684829040,420,-3,-54,-4,-6,2,1,3,0,3,3,-6,8,2,-1,1,0,-1,1,0,-1,-11,270,-1,-4,5,-4,0,-2,1,1,-1,-1,4,-1
KR_6758559111,440,1,14,-9,-5,1,2,3,2,4,6,-2,2,0,-5,6,1,-1,2,1,0,-1,0,1,-7,6,0,0,-1,1,-1,-1,-1,5,-1
KR_6650946597,420,-1,-31,28,-6,-4,4,0,0,5,5,-1,2,1,-1,3,2,0,2,2,0,-10,-6,-1,-1,2,-4,0,0,0,-1,0,-1,0,-1
KR_6721865141,420,-2,-12,13,-1,-3,4,1,-2,5,3,3,1,4,0,0,0,1,1,2,0,0,0,-2,-3,5,-3,0,-1,1,1,-1,-1,6,-1
KR_6659648461,420,-3,30,8,-7,-1,1,0,-6,9,3,-2,2,0,0,3,3,2,1,3,0,-6,-4,-1,-5,6,1,0,-2,-1,-1,-1,-1,6,-1
KR_6746793225,420,-1,16,-32,-5,-5,5,0,1,4,5,3,1,4,-3,4,1,-1,1,0,0,-8,-1,3,-6,3,0,0,2,1,1,1,-1,6,-1
KR_6762077981,420,-2,-36,-12,1,3,0,3,-1,3,2,-3,6,3,2,6,8,0,1,1,0,-1,-14,-1,-5,6,-1,0,0,-1,-1,-1,-1,1,-1
KR_6676967264,420,-5,-53,-10,-9,-2,3,1,0,4,4,-3,4,1,-2,6,4,-2,2,0,0,-2,-14,3,-4,1,0,0,0,1,-1,0,-1,1,-1
KR_6710413003,420,-4,-25,0,-7,0,1,1,-5,7,2,0,2,2,-1,1,0,-1,2,1,1,-6,-6,0,-3,3,-2,0,-2,1,1,-1,1,5,-1
KR_6752361982,420,0,-73,-20,3,0,2,2,1,2,3,0,3,3,2,0,2,0,1,1,0,7,-24,2,-4,2,26,0,-1,-1,-1,-1,1,4,-1
KR_6738543074,440,-3,14,-12,-14,2,1,3,0,2,2,-4,8,4,-8,8,0,-4,4,0,-1,-19,9,5,-10,5,0,0,-2,-1,-1,-1,-1,3,-1
KR_6669759077,420,-3,-34,20,-4,-3,3,0,2,4,6,-3,6,3,1,2,3,-1,3,2,0,-6,2,-1,-2,3,0,0,-2,1,-1,-1,-1,3,-1
KR_6761027441,420,-2,-86,12,-8,-1,3,2,-3,5,2,2,2,4,-5,5,0,-1,1,0,0,-7,-5,0,-3,3,2,0,0,-1,1,-1,-1,2,-1
KR_6652329245,420,3,-32,33,2,0,0,0,1,4,5,1,2,3,0,1,1,0,0,0,0,2,11,-2,-5,7,-2,0,0,1,-1,0,-1,2,-1
KR_6661789629,440,-3,-68,-32,-9,-5,5,0,-1,1,0,-1,4,3,-1,4,3,-1,3,2,0,-2,-12,-1,-1,2,3,0,-2,-1,-1,-1,1,4,-1
KR_6754992960,420,0,-24,3,3,0,1,1,3,2,5,2,4,6,0,3,3,-2,3,1,0,8,5,1,-3,2,-1,0,-1,-1,1,-1,1,5,-1
KR_6762721425,420,-4,-26,12,-7,-2,3,1,4,0,4,-3,4,1,-4,4,0,-2,3,1,0,-2,-6,1,-4,3,-3,0,0,0,1,0,-1,0,-1
KR_6731304764,420,-5,-32,-24,-6,-1,3,2,-5,5,0,6,0,6,-4,5,1,-2,2,0,0,-4,1,2,-2,0,-2,0,0,-1,-1,0,1,2,-1
KR_6763093888,420,-6,-81,12,-4,1,0,1,-3,4,1,-2,4,2,1,0,1,-1,1,0,0,-10,29,5,-6,1,0,0,0,-1,1,0,-1,1,-1
KR_6651473862,420,-2,-24,13,-5,0,2,2,0,2,2,-2,4,2,-3,4,1,0,0,0,-1,-4,-131,-3,-4,7,3,0,-1,-1,0,-1,-1,4,-1
KR_6759472127,440,0,34,-10,-5,3,0,3,-6,6,0,0,1,1,-2,2,0,0,1,1,0,-3,-4,0,-4,4,-1,0,-1,-1,-1,-1,-1,1,-1
KR_6649877442,420,1,-27,-24,1,2,0,2,0,2,2,2,2,4,-2,3,1,-1,3,2,0,-1,15,-2,-2,4,-3,0,0,1,-1,0,-1,2,-1
KR_6739268618,420,2,-6,1,-10,1,2,3,-2,3,1,0,0,0,-8,8,0,-1,2,1,0,-20,-11,-3,-2,5,4,0,0,-1,1,-1,-1,5,-1
KR_6724099542,420,0,-2,-14,-6,1,1,2,-1,2,1,2,1,3,-7,7,0,-1,1,0,0,-9,-7,1,-6,5,-2,0,-1,0,1,-1,1,0,-1
KR_6759979437,420,-1,-10,11,-6,1,2,3,0,1,1,-6,6,0,-3,5,2,2,1,3,0,-1,25,-2,-2,4,0,0,0,1,0,-1,1,1,-1
KR_6754318251,420,-1,22,21,1,-3,3,0,2,3,5,-3,4,1,5,0,5,0,0,0,0,1,-9,-2,-4,6,-5,0,-1,1,-1,-1,1,2,-1
KR_6744083567,420,-4,-50,-43,-15,-4,4,0,-7,7,0,0,3,3,-2,3,1,-2,3,1,-1,-10,35,-4,-1,5,-18,0,-3,-1,-1,-1,-1,5,-1
KR_6749321970,440,-1,-13,3,-6,2,0,2,0,1,1,-5,5,0,-6,7,1,3,0,3,0,-9,-3,-1,-4,5,-3,0,2,1,-1,1,-1,4,-1
KR_6572184038,420,-6,-82,-30,-22,-2,4,2,-7,9,2,-4,5,1,-5,6,1,-4,4,0,0,-24,301,0,-3,3,-3,0,-2,1,-1,-1,-1,1,-1
KR_6762382101,440,-5,-64,-60,-14,-3,5,2,-6,9,3,-1,1,0,-5,7,2,1,1,2,0,-11,-1,0,0,0,-2,0,-2,-1,1,-1,-1,6,-1
KR_6761133987,420,-8,-125,-37,-8,-2,2,0,-2,4,2,0,2,2,-3,3,0,-1,1,0,0,-10,-25,-8,0,8,2,0,-4,-1,-1,-1,-1,6,-1
KR_6655262162,420,1,-41,-8,-1,1,1,2,4,2,6,-1,5,4,1,3,4,-6,8,2,1,4,-32,-1,-7,8,19,0,0,1,-1,-1,1,2,-1
KR_6761112231,420,-3,-92,-24,-8,-1,4,3,-8,9,1,0,2,2,1,1,2,0,0,0,0,2,-1,3,-7,4,2,0,-1,-1,-1,-1,1,5,-1
KR_6694300482,440,-3,-100,25,4,2,2,4,3,3,6,-1,3,2,0,3,3,0,0,0,2,13,2,-1,-5,6,0,0,-1,1,-1,-1,1,3,-1
KR_6733672090,420,-2,0,-4,-6,-3,3,0,-3,3,0,-2,2,0,5,2,7,-3,3,0,0,-7,-39,-3,-4,7,20,0,-1,-1,-1,-1,1,3,-1
KR_6750799622,420,-3,14,-20,-4,0,2,2,-2,3,1,-2,3,1,0,2,2,0,1,1,0,-4,-1,3,-5,2,-5,0,-1,1,-1,-1,-1,3,-1
KR_6645585705,420,-2,-41,4,-8,-7,7,0,2,2,4,-2,2,0,-2,5,3,1,0,1,-1,-4,15,0,-3,3,-2,0,-2,1,1,-1,-1,1,-1
KR_5822394112,420,0,-32,1,2,-1,3,2,-1,4,3,-1,4,3,4,0,4,1,0,1,0,8,-1,3,-8,5,1,0,-2,-1,-1,-1,1,3,-1
KR_6745894876,420,-1,39,8,-2,0,1,1,0,3,3,1,1,2,-3,5,2,0,0,0,0,-10,7,0,-4,4,0,0,0,0,-1,0,-1,0,-1
KR_6722633530,420,-3,-64,-36,-11,-6,7,1,-1,2,1,-3,3,0,-2,3,1,1,0,1,0,-4,13,-1,-3,4,0,0,-1,-1,-1,-1,1,2,-1
KR_6722700438,420,-1,33,0,-1,-4,5,1,1,2,3,1,1,2,2,1,3,-1,1,0,0,5,31,-1,-5,6,-15,0,0,1,1,0,-1,5,-1
KR_6761302150,420,-2,-8,-8,-4,-2,3,1,1,2,3,1,0,1,0,1,1,-4,4,0,0,-2,7,2,-4,2,-4,0,0,-1,1,0,-1,4,-1
KR_6759897741,420,-6,-3,7,-12,-1,1,0,-3,4,1,-5,7,2,-2,3,1,-1,1,0,0,-7,-11,-1,-1,2,-1,0,-2,-1,-1,-1,-1,5,-1
KR_6716128426,420,2,13,-10,-1,1,0,1,3,4,7,-1,2,1,-5,6,1,1,0,1,0,-6,2,-1,-2,3,3,0,1,-1,1,1,-1,3,-1
KR_6760577718,420,1,-9,33,2,2,2,4,-2,5,3,-3,4,1,1,2,3,4,0,4,0,4,0,0,-4,4,-1,0,0,-1,1,0,-1,2,-1
KR_6721162403,420,3,63,-35,7,-2,4,2,2,1,3,-1,4,3,5,1,6,3,0,3,1,14,-4,0,-2,2,-3,0,0,-1,0,0,1,6,-1
KR_6752239451,420,0,14,-4,-12,-3,4,1,-3,4,1,-1,2,1,-2,4,2,-3,6,3,-1,-14,-48,-6,-1,7,19,0,0,1,1,0,-1,3,-1
KR_6763661397,440,1,33,10,-3,0,0,0,-4,4,0,0,3,3,-1,2,1,2,0,2,0,-5,-11,1,-4,3,-1,0,0,1,-1,-1,-1,3,-1
KR_6662956809,420,-1,-47,12,-4,-2,2,0,1,3,4,-2,5,3,2,2,4,-3,4,1,0,0,-8,-1,-5,6,-1,0,-3,0,-1,-1,-1,0,-1
KR_6659154852,420,-3,-84,4,-6,-5,5,0,-4,6,2,-1,3,2,2,2,4,2,0,2,0,-2,-260,-1,-4,5,0,0,-1,-1,-1,-1,-1,2,-1
KR_6652812055,420,4,83,20,9,3,0,3,1,0,1,3,1,4,-1,2,1,3,0,3,1,5,45,-1,-2,3,-27,0,1,1,1,1,1,6,-1
KR_6597301739,420,0,5,5,1,-1,1,0,0,3,3,0,3,3,0,0,0,2,0,2,0,-3,16,2,-5,3,-1,0,0,-1,-1,0,1,1,-1
KR_6733691945,420,1,-11,32,6,0,3,3,0,2,2,-3,3,0,9,0,9,0,1,1,0,10,5,-1,-4,5,2,0,-2,1,-1,-1,1,2,-1
KR_6743455066,420,0,22,-24,0,5,0,5,-2,2,0,0,1,1,-1,2,1,-2,2,0,0,-3,3,0,-4,4,1,0,0,-1,1,1,1,5,-1
KR_6651839768,420,-2,-99,-1,-7,-1,5,4,-7,7,0,1,0,1,1,1,2,-1,2,1,0,-8,-5,-4,-1,5,0,0,-1,-1,-1,-1,-1,6,-1
KR_6750470058,420,-8,-166,-29,-15,-9,9,0,-7,11,4,1,2,3,0,3,3,0,1,1,0,-15,4,-2,-2,4,-3,0,-2,1,-1,-1,-1,2,-1
KR_6748341965,420,-1,-31,-32,0,-1,1,0,-1,3,2,1,1,2,0,4,4,1,1,2,0,7,-20,-3,0,3,0,0,-1,1,-1,-1,-1,4,-1
KR_6754911982,420,-1,-76,-24,1,-2,4,2,6,1,7,1,0,1,-2,3,1,-2,4,2,0,4,299,3,-4,1,2,0,0,-1,1,-1,1,2,-1
KR_6610557759,420,2,42,-4,3,2,1,3,-1,2,1,4,3,7,-1,3,2,-1,2,1,-1,-5,-11,-7,-2,9,3,0,1,-1,0,1,-1,5,-1
KR_6749815427,420,-1,-50,-12,5,-3,3,0,5,1,6,1,0,1,2,1,3,0,0,0,0,11,19,3,-4,1,-3,0,-3,1,-1,-1,1,5,-1
KR_6749684470,420,-4,-74,24,-3,-1,3,2,-3,3,0,0,1,1,0,5,5,1,0,1,0,-9,-35,0,-3,3,1,0,0,1,1,-1,1,1,-1
KR_6701560793,440,-3,63,-34,-9,-5,6,1,-1,2,1,-6,9,3,2,1,3,1,1,2,0,-6,-5,-3,-4,7,3,0,-2,-1,-1,-1,1,5,-1
KR_6687372293,420,-1,-47,12,-7,-5,7,2,-4,4,0,4,1,5,-3,5,2,1,0,1,-2,-6,-2,-2,-4,6,0,0,-1,1,0,-1,1,2,-1
KR_6741418745,420,2,30,20,8,0,3,3,9,0,9,0,0,0,2,1,3,-3,3,0,0,8,9,3,-4,1,0,0,0,1,-1,0,1,1,-1
KR_6621984776,420,0,21,-3,0,-8,8,0,3,1,4,3,1,4,0,1,1,2,1,3,1,8,-117,1,-5,4,-4,0,0,1,0,-1,1,2,-1
KR_6760696360,420,-6,-12,32,-19,-7,7,0,-1,1,0,-2,4,2,-9,9,0,0,1,1,0,-18,4,0,-3,3,-1,0,0,-1,1,-1,-1,4,-1
KR_6764712695,440,-1,-42,-20,-4,2,2,4,-2,4,2,1,0,1,-4,6,2,-1,1,0,0,-11,-17,-5,-1,6,1,0,0,0,0,0,-1,0,-1
KR_6394386403,420,-3,0,-28,-2,0,2,2,-5,7,2,1,2,3,0,4,4,2,0,2,0,2,5,0,-5,5,-7,0,-2,1,-1,-1,1,5,-1
KR_6762286030,420,0,98,-13,2,5,0,5,-1,1,0,-6,10,4,4,1,5,0,1,1,0,-5,-29,-3,-3,6,1,0,3,1,1,1,1,1,-1
KR_6759322218,420,2,-6,7,-6,3,2,5,-2,5,3,-1,2,1,-6,6,0,0,0,0,0,-7,-19,0,-6,6,0,0,0,1,-1,0,-1,2,-1
KR_6751782779,420,-3,-23,-24,2,-2,3,1,-1,4,3,0,3,3,5,0,5,0,1,1,0,0,2,1,-7,6,0,0,-1,1,-1,-1,-1,1,-1
KR_6759449611,420,-1,61,6,-6,4,0,4,0,4,4,-4,4,0,-4,6,2,-2,2,0,-1,-13,31,2,-2,0,-19,0,0,-1,1,1,-1,2,-1
KR_6756648557,420,-1,-76,-4,-6,-1,3,2,-4,4,0,1,1,2,-1,3,2,-1,1,0,0,-15,16,-1,-4,5,-3,0,-1,-1,1,-1,-1,5,-1
KR_6753340103,420,0,54,-16,4,-1,1,0,1,2,3,1,1,2,3,0,3,0,0,0,1,8,24,0,-7,7,-4,0,0,1,1,0,1,1,-1
KR_6760958005,420,2,-46,60,7,-4,4,0,0,3,3,4,0,4,6,1,7,1,1,2,2,7,-5,0,-1,1,-2,0,-1,1,-1,-1,1,1,-1
KR_6750813842,420,4,-56,24,5,1,3,4,3,0,3,1,0,1,0,2,2,0,0,0,0,2,2,-1,-4,5,1,0,-1,1,-1,-1,1,1,-1
KR_6724918257,420,-4,-29,-1,-14,0,3,3,-2,3,1,-9,12,3,-4,7,3,1,1,2,-2,-21,-5,-2,-3,5,-2,0,-1,1,-1,-1,-1,5,-1
KR_6645177864,420,1,38,-20,2,2,2,4,-1,2,1,0,0,0,0,1,1,1,0,1,0,-2,-4,-4,-4,8,-1,0,2,-1,1,1,1,4,-1
KR_6667823121,440,-1,-74,-14,-11,-4,4,0,-3,3,0,3,1,4,-2,3,1,-5,7,2,-2,-16,-36,-6,-1,7,0,0,-3,-1,-1,-1,-1,5,-1
KR_6729775343,420,-11,-112,-37,-20,-5,8,3,-3,3,0,-4,5,1,-6,8,2,-2,3,1,0,-11,45,1,-3,2,-21,0,-3,-1,-1,-1,-1,2,-1
KR_6716277868,420,-4,-41,-40,-19,0,1,1,-6,9,3,-7,8,1,-4,5,1,-2,2,0,-3,-19,2,0,-3,3,-1,0,-2,-1,-1,-1,-1,1,-1
KR_6696230217,420,-1,-85,-8,-2,-6,6,0,2,3,5,0,3,3,2,8,10,0,0,0,0,-3,8,5,-7,2,-5,0,-2,-1,-1,-1,1,4,-1
KR_6640043959,420,-2,-78,-20,-8,-2,3,1,-2,3,1,5,1,6,-8,9,1,-1,2,1,-1,-6,42,-3,-5,8,6,0,-1,-1,-1,-1,-1,1,-1
KR_6763970654,420,0,56,17,-2,1,2,3,3,3,6,-6,7,1,0,1,1,0,0,0,1,-8,-1,1,-3,2,2,0,-1,0,-1,-1,1,0,-1
KR_6759005862,420,-2,-95,29,-4,-2,4,2,-2,3,1,-1,3,2,2,1,3,-1,1,0,0,2,12,-3,0,3,2,0,-1,-1,-1,-1,-1,1,-1
KR_6730455031,440,2,12,-11,-3,-1,1,0,3,2,5,0,4,4,-1,2,1,-4,6,2,1,1,71,3,-6,3,-2,0,1,-1,1,1,1,4,-1
KR_6744708828,420,-4,-32,8,-10,-1,2,1,-4,4,0,-1,2,1,-2,2,0,-2,2,0,0,-10,9,2,-3,1,-1,0,-1,1,-1,-1,1,6,-1
KR_6762445281,420,1,28,32,-6,1,1,2,-3,5,2,3,1,4,-5,5,0,-2,2,0,0,-14,-5,0,-3,3,4,0,0,-1,1,0,1,4,-1
KR_6614477367,420,-3,-67,-60,-2,1,2,3,-1,1,0,-2,3,1,0,1,1,0,0,0,-1,0,-7,-2,-3,5,-3,0,-2,-1,-1,-1,-1,4,-1
KR_6761661123,420,-2,-14,-8,-6,-6,7,1,-2,2,0,1,2,3,1,4,5,0,2,2,1,-6,0,2,-6,4,-1,0,1,0,1,1,1,0,-1
KR_6714075121,420,-2,-26,-29,-3,0,2,2,-3,3,0,-1,1,0,0,2,2,1,0,1,0,-2,-9,-3,-4,7,-4,0,0,0,1,1,-1,0,-1
KR_6705305133,420,-1,-15,-20,4,5,2,7,-3,10,7,0,3,3,1,0,1,1,1,2,0,7,-14,3,-5,2,-5,0,0,-1,0,0,1,5,-1
KR_6757770488,420,-2,-54,1,3,-2,2,0,-4,6,2,2,1,3,5,3,8,2,2,4,2,9,2,7,-9,2,-3,0,0,1,-1,-1,1,6,-1
KR_6669202250,420,-5,-37,-44,-9,0,0,0,2,0,2,-5,7,2,-3,3,0,-3,3,0,0,-5,10,5,-5,0,-5,0,-1,-1,-1,-1,-1,1,-1
KR_6760641765,420,-1,-31,5,-7,-2,4,2,1,2,3,-1,3,2,-4,5,1,-1,1,0,0,-7,3,1,-4,3,1,0,-1,1,-1,-1,1,1,-1
KR_6764592835,440,-5,-80,-24,-10,-6,6,0,1,1,2,-2,3,1,-2,3,1,-1,2,1,0,-4,-10,1,-5,4,1,0,-1,-1,-1,-1,-1,3,-1
KR_6655819002,420,-5,-96,12,-6,-3,4,1,-5,6,1,-2,4,2,3,0,3,1,1,2,0,-3,18,0,-5,5,-1,0,-2,1,-1,-1,-1,6,-1
KR_6698316082,420,-2,23,-16,2,-1,1,0,-1,2,1,4,0,4,-3,4,1,3,1,4,0,-4,-2,0,-1,1,3,0,1,1,-1,1,1,3,-1
KR_6757779733,420,1,35,-2,-3,-1,1,0,1,0,1,-4,6,2,1,4,5,0,0,0,0,4,2,2,-6,4,-2,0,1,-1,0,1,-1,4,-1
KR_6750191249,440,1,-6,-6,2,2,0,2,1,3,4,2,0,2,-2,2,0,-1,4,3,0,-3,-1,0,-3,3,0,0,0,-1,0,0,-1,4,-1
KR_6761370601,420,0,-87,25,3,-2,4,2,2,1,3,5,3,8,-3,6,3,1,1,2,-2,2,8,0,-3,3,-1,0,0,-1,1,0,-1,2,-1
KR_6749036533,420,-4,-51,-9,-7,-6,6,0,5,4,9,-4,4,0,-1,5,4,-1,1,0,-1,7,9,2,-5,3,-1,0,0,1,-1,1,-1,2,-1
KR_6696270252,420,3,9,1,6,4,0,4,1,2,3,3,0,3,-2,2,0,0,0,0,0,4,7,4,-7,3,-6,0,0,1,-1,0,1,2,-1
KR_6666861859,420,-2,13,4,-4,-1,1,0,-2,3,1,1,0,1,-1,3,2,-1,1,0,0,-4,33,-4,-1,5,-13,0,0,0,0,0,1,0,-1
KR_5857874849,420,-1,19,-12,-4,0,0,0,4,0,4,-2,3,1,-6,8,2,0,2,2,0,-6,6,-2,-2,4,-1,0,-1,-1,-1,-1,-1,5,-1
KR_6624079819,420,2,69,6,-3,1,1,2,0,2,2,-5,9,4,-2,5,3,3,0,3,0,2,4,1,-3,2,-1,0,1,1,-1,1,-1,5,-1
KR_6707988988,420,-1,8,-1,7,4,0,4,0,3,3,1,1,2,1,1,2,1,0,1,0,4,21,1,-4,3,-19,0,0,-1,-1,0,1,1,-1
KR_6763448480,420,-2,6,2,-12,0,0,0,3,1,4,3,1,4,-17,17,0,-1,1,0,0,-11,15,-3,-3,6,0,0,-1,-1,-1,-1,-1,6,-1
KR_6718275783,420,2,11,16,-1,0,0,0,0,1,1,3,0,3,-1,2,1,-3,5,2,0,-3,10,2,-4,2,-6,0,-2,1,-1,-1,1,1,-1
KR_6760638633,420,-1,-33,12,-2,-1,2,1,-2,2,0,-1,2,1,1,4,5,1,0,1,0,0,-49,0,-4,4,26,0,0,-1,-1,0,1,3,-1
KR_6693742005,420,1,19,8,3,-3,3,0,1,0,1,0,1,1,0,4,4,5,0,5,1,5,47,4,-6,2,-19,0,2,-1,1,1,1,1,-1
KR_6759687812,440,2,-13,15,3,4,0,4,2,0,2,-1,2,1,-2,6,4,0,1,1,0,-1,-164,-2,-7,9,-4,0,0,1,1,0,1,5,-1
KR_6616476831,420,0,-58,-7,-3,-3,4,1,3,3,6,2,3,5,-3,6,3,-2,2,0,-1,-9,151,-2,-2,4,-19,0,0,0,1,1,-1,0,-1
KR_6760848065,420,-6,-70,-4,-12,-4,5,1,-4,4,0,-2,3,1,-1,1,0,-1,2,1,0,-8,-9,4,-5,1,-1,0,-1,-1,-1,-1,-1,4,-1
KR_6750796350,420,-3,-28,32,-5,-3,4,1,0,2,2,1,4,5,-3,5,2,0,0,0,0,-7,-2,-1,-1,2,-2,0,0,-1,1,-1,-1,5,-1
KR_6625078429,420,-4,10,-24,-11,-4,5,1,-3,4,1,-3,5,2,-1,2,1,0,0,0,0,-9,-13,-5,-1,6,-1,0,0,-1,-1,-1,-1,4,-1
KR_6655862524,420,-2,-97,0,-6,-2,2,0,-1,3,2,-2,2,0,-2,3,1,1,0,1,0,-4,-2,-4,-4,8,-1,0,-1,-1,1,-1,-1,4,-1
KR_6726911669,420,-1,-50,26,5,-2,3,1,1,3,4,1,3,4,2,1,3,3,0,3,0,2,3,0,-5,5,5,0,-1,1,-1,1,1,1,-1
KR_6726616207,420,-2,-28,-10,-9,-3,4,1,-4,7,3,2,3,5,-1,1,0,-3,3,0,0,-18,0,3,-4,1,-3,0,0,1,-1,0,1,3,-1
KR_6718440289,420,-4,-20,-17,-7,-4,5,1,-1,3,2,-2,3,1,-3,4,1,3,0,3,0,3,-10,-6,-1,7,4,0,-1,0,-1,-1,-1,0,-1
KR_6731161158,420,-2,-11,-5,-5,-2,2,0,-1,4,3,0,5,5,0,1,1,-2,2,0,-1,-3,-202,-2,-2,4,0,0,0,-1,1,0,-1,6,-1
KR_6761686952,420,-2,10,-12,2,2,2,4,-6,7,1,2,1,3,3,1,4,1,0,1,0,0,69,2,-3,1,0,0,0,1,0,0,1,6,-1
KR_6625395563,420,-9,-163,-40,-14,1,0,1,-3,3,0,-9,9,0,-5,8,3,2,1,3,0,-4,0,1,-4,3,-4,0,-3,-1,-1,-1,1,6,-1
KR_6755989763,420,1,21,-8,8,-5,6,1,-1,1,0,9,1,10,5,2,7,0,2,2,1,14,19,2,-3,1,-1,0,0,-1,-1,1,1,6,-1
KR_6659251964,440,2,86,-12,-6,3,2,5,1,0,1,-9,10,1,3,0,3,-4,6,2,0,-4,2,3,-3,0,0,0,0,0,-1,-1,-1,0,-1
KR_6763319591,420,-2,-4,-16,-9,0,2,2,-2,4,2,4,1,5,-11,11,0,0,1,1,-1,-14,-54,3,-6,3,-3,0,-1,1,0,-1,-1,1,-1
KR_6639133488,420,-4,-34,-26,-4,0,1,1,-2,2,0,-1,3,2,-2,5,3,1,1,2,0,-1,-6,5,-7,2,-5,0,-3,-1,-1,-1,1,1,-1
KR_6762186634,420,-2,26,-24,-4,3,0,3,-7,7,0,-1,6,5,-2,2,0,3,0,3,-1,-7,5,-3,-3,6,0,0,1,-1,1,1,-1,3,-1
KR_6763949329,420,-2,-42,17,-1,-1,3,2,2,3,5,0,2,2,-1,3,2,-1,2,1,0,-3,-26,9,-11,2,-2,0,0,-1,-1,-1,1,1,-1
KR_6736984028,420,-2,-110,-8,-10,-1,1,0,-3,5,2,0,6,6,-6,7,1,0,1,1,0,-10,-4,0,-2,2,-1,0,-1,-1,-1,-1,-1,6,-1
KR_6731504842,420,1,-31,-12,2,1,3,4,1,3,4,3,1,4,-2,5,3,-1,1,0,0,-4,2,-4,-4,8,0,0,0,-1,-1,1,1,2,-1
KR_6763708478,440,-3,-15,-24,-7,0,0,0,1,2,3,-1,6,5,-2,3,1,-5,7,2,0,-8,-24,0,-3,3,2,0,0,0,1,0,1,0,-1
KR_6745841472,420,1,-42,-17,-5,-10,11,1,-2,6,4,4,2,6,2,1,3,1,2,3,1,-1,220,0,-5,5,-5,0,1,-1,-1,-1,1,2,-1
KR_6763445185,420,-1,-14,0,-7,1,1,2,-4,4,0,-4,4,0,1,3,4,-1,1,0,1,-12,-6,-6,-3,9,0,0,0,0,0,0,1,0,-1
KR_6747049877,420,-5,-69,-4,-5,-6,7,1,0,7,7,-4,4,0,5,1,6,0,0,0,0,5,22,4,-6,2,-2,0,-2,-1,1,-1,-1,2,-1
KR_6732750664,440,-2,-108,12,-9,0,1,1,0,1,1,-2,5,3,-6,6,0,-1,3,2,0,-7,7,-2,-3,5,0,0,-2,-1,-1,-1,1,5,-1
KR_6672889589,420,-5,-106,24,-9,-5,5,0,1,2,3,-5,5,0,0,4,4,0,1,1,0,0,286,-3,-1,4,1,0,-1,0,1,-1,-1,0,-1
KR_6731608921,440,-2,-21,-24,1,-3,5,2,-3,7,4,2,2,4,2,1,3,3,0,3,0,0,349,-1,-1,2,3,0,-1,1,1,-1,1,1,-1
KR_6716175179,420,-4,-56,-12,-9,-3,4,1,-2,4,2,1,2,3,-3,4,1,-2,2,0,0,-9,4,0,-4,4,-3,0,-2,-1,-1,-1,-1,5,-1
KR_6725399184,420,-5,-43,-19,-12,-1,2,1,-2,5,3,-6,7,1,-2,4,2,-1,1,0,2,-1,194,-4,-1,5,-1,0,-2,-1,-1,-1,1,1,-1
KR_6665835725,420,-1,-49,22,2,-1,2,1,1,1,2,4,0,4,-2,3,1,0,0,0,0,1,-6,-4,-3,7,1,0,0,1,-1,-1,1,6,-1
KR_6629146595,420,-3,-20,-22,-3,0,2,2,1,0,1,-3,3,0,-1,3,2,0,1,1,0,-2,1,1,-4,3,-3,0,0,-1,1,0,-1,1,-1
KR_6750290555,420,3,-3,16,6,-1,3,2,4,3,7,4,0,4,3,2,5,-4,4,0,0,-4,2,0,-3,3,-3,0,0,1,1,0,-1,3,-1
KR_6639862132,420,-3,-52,16,-10,-1,1,0,0,0,0,-7,7,0,-1,4,3,-1,2,1,-1,-6,7,-4,-1,5,1,0,-1,0,-1,-1,-1,0,-1
KR_6754679466,420,-5,-9,-56,-12,-5,7,2,-7,7,0,-2,3,1,2,0,2,0,0,0,0,3,-10,-1,-6,7,-1,0,0,-1,-1,-1,-1,6,-1
KR_6550873894,420,-1,-33,-11,-6,2,3,5,0,3,3,0,2,2,-1,3,2,-7,7,0,-2,-4,-1,1,-5,4,-2,0,0,1,1,0,-1,5,-1
KR_6747108272,420,-5,-23,-10,-6,-2,3,1,2,2,4,-5,5,0,-1,2,1,0,0,0,0,2,2,-2,-3,5,-2,0,-2,0,-1,-1,-1,0,-1
KR_6715195197,420,-2,-14,0,-7,3,1,4,-1,1,0,-9,9,0,-1,2,1,1,1,2,0,-8,27,0,-4,4,2,0,0,-1,1,0,-1,2,-1
KR_6678156129,420,-3,-34,4,-7,1,3,4,1,2,3,-5,6,1,0,1,1,-4,4,0,0,1,5,-2,-4,6,-1,0,-1,-1,1,1,-1,3,-1
KR_6740524635,420,-2,-62,-8,-11,-1,1,0,-4,6,2,-4,4,0,-3,6,3,1,2,3,0,-9,10,-4,0,4,0,0,1,-1,-1,1,-1,6,-1
KR_6745899604,420,-6,-35,4,-17,-6,8,2,-2,3,1,0,1,1,-9,9,0,0,0,0,0,-11,-3,-1,-2,3,-2,0,-2,-1,0,-1,-1,4,-1
KR_6751774053,420,0,-17,9,-8,0,1,1,0,2,2,-1,2,1,-5,5,0,-2,2,0,0,-10,-2,2,-4,2,2,0,1,-1,1,1,-1,3,-1
KR_6760450570,440,-2,-71,-20,-7,-2,3,1,-1,2,1,-5,5,0,2,1,3,-1,1,0,0,-1,17,-4,-3,7,2,0,-2,-1,-1,-1,-1,4,-1
KR_6764244643,420,4,20,-1,6,0,3,3,6,2,8,2,3,5,0,2,2,-2,2,0,-1,7,29,4,-9,5,-1,0,0,-1,1,0,-1,3,-1
KR_6624031765,420,1,-36,-4,3,0,1,1,3,1,4,-1,6,5,0,0,0,1,0,1,0,3,1,-2,-3,5,0,0,1,1,1,1,1,4,-1
KR_6755762771,420,-2,-55,24,-9,0,0,0,2,1,3,-9,10,1,-1,6,5,-1,2,1,-2,-18,3,-1,-2,3,-3,0,0,1,-1,0,-1,5,-1
KR_6733175580,420,-3,3,16,-10,-1,3,2,4,0,4,-8,8,0,-2,2,0,-3,4,1,0,-5,-17,-1,-2,3,0,0,-2,0,-1,-1,1,0,-1
KR_6665768880,420,-1,-19,-4,4,-2,6,4,8,1,9,-3,4,1,-1,5,4,2,1,3,4,17,-115,2,-6,4,-2,0,-1,1,-1,-1,1,6,-1
KR_6764250538,420,-3,-68,27,-2,-2,2,0,-4,4,0,0,1,1,2,1,3,2,0,2,0,-5,5,2,-5,3,-6,0,-2,1,-1,-1,1,4,-1
KR_6764437942,420,-3,-4,-8,-6,-4,6,2,-5,5,0,7,0,7,2,1,3,-6,7,1,-1,-4,-250,-1,-3,4,-3,0,2,-1,1,1,-1,3,-1
KR_6668816861,420,0,-33,10,2,-1,4,3,1,2,3,5,2,7,-2,2,0,-1,1,0,0,5,-99,0,-7,7,4,0,-1,0,-1,-1,-1,0,-1
KR_6739787780,420,1,-7,12,3,-1,3,2,3,1,4,1,2,3,0,2,2,0,1,1,0,4,14,1,-5,4,3,0,1,1,1,1,1,3,-1
KR_6690205241,420,-3,-51,20,-4,-2,4,2,-4,5,1,3,0,3,-1,1,0,0,0,0,0,-6,-477,0,-2,2,18,0,-1,1,-1,-1,1,1,-1
KR_6730961883,420,-2,49,-16,-4,0,4,4,-2,4,2,-2,3,1,0,1,1,0,1,1,-1,-11,-32,-1,-2,3,-2,0,0,-1,1,-1,-1,5,-1
KR_6633839502,420,3,-80,28,0,4,1,5,-1,4,3,0,3,3,-1,2,1,-2,2,0,0,-3,122,4,-6,2,-3,0,0,-1,0,0,-1,1,-1
KR_6758974729,440,-6,6,-26,-12,0,2,2,-5,5,0,-5,5,0,-3,5,2,1,0,1,0,-10,-4,-1,-3,4,-2,0,-1,-1,0,-1,-1,1,-1
KR_6647264465,440,-5,-100,-12,-9,-1,2,1,-5,7,2,0,1,1,-1,5,4,-2,3,1,0,-11,-7,-5,0,5,-7,0,-2,-1,0,-1,1,6,-1
KR_6634125104,420,2,14,35,1,-1,2,1,-3,3,0,-1,2,1,1,0,1,5,0,5,0,-1,-16,-1,-3,4,0,0,0,-1,1,0,1,4,-1
KR_6732110279,420,0,-17,0,4,-2,2,0,-5,5,0,6,0,6,0,4,4,5,1,6,1,0,-5,-1,-3,4,0,0,0,-1,-1,1,-1,4,-1
KR_6707364267,420,-3,7,-6,-8,1,0,1,-1,2,1,-6,8,2,0,0,0,-2,2,0,0,-3,4,-2,-4,6,1,0,-1,-1,1,-1,1,4,-1
KR_6761709965,420,-2,99,-20,-4,-2,3,1,-2,2,0,2,0,2,0,4,4,-2,4,2,0,-1,-97,-1,-2,3,-1,0,0,1,1,-1,-1,6,-1
KR_6732367613,420,-1,46,-24,-3,1,1,2,2,2,4,-3,3,0,-4,5,1,1,1,2,0,-1,2,1,-4,3,-4,0,1,0,1,1,1,0,-1
KR_6760189935,420,-3,-57,-4,-6,2,1,3,-1,2,1,-2,4,2,-4,4,0,-1,2,1,0,-8,-7,0,-3,3,2,0,0,-1,1,0,1,5,-1
KR_6760703640,420,-6,-64,-8,-12,-2,3,1,-2,3,1,-8,11,3,0,0,0,0,0,0,0,-10,3,-2,0,2,0,0,-2,0,-1,-1,-1,0,-1
KR_6739612693,420,-2,32,28,-3,-1,1,0,0,3,3,3,0,3,-6,7,1,1,0,1,0,-5,8,4,-7,3,1,0,1,1,1,1,1,5,-1
KR_6760149252,420,-4,-31,-20,-7,2,2,4,-1,2,1,-3,5,2,-4,5,1,-1,2,1,-2,-9,-9,1,-7,6,1,0,-2,-1,-1,-1,-1,1,-1
KR_6755034804,420,4,11,24,0,-4,5,1,-5,5,0,10,0,10,1,2,3,-2,2,0,0,-3,-135,-2,-3,5,5,0,-2,-1,0,-1,1,3,-1
KR_6729431004,420,0,-17,-23,-7,-2,4,2,-2,5,3,1,3,4,-5,5,0,1,1,2,0,-3,-1,2,-4,2,-1,0,0,0,-1,0,-1,0,-1
KR_6711776221,420,0,-26,-20,-2,0,2,2,1,0,1,-1,2,1,-3,6,3,1,2,3,0,-3,19,1,-4,3,-1,0,0,-1,1,0,1,6,-1
KR_6666419448,420,-1,21,-41,-4,0,1,1,-2,2,0,1,0,1,-1,2,1,-2,2,0,0,-4,3,1,-6,5,-2,0,0,-1,-1,0,-1,6,-1
KR_6764474938,440,-1,-22,-40,-1,0,1,1,6,0,6,2,2,4,-5,5,0,-4,5,1,1,2,-2,-3,-3,6,4,0,1,-1,-1,1,1,5,-1
KR_6726885265,420,1,4,-3,-4,2,1,3,-3,3,0,0,1,1,-2,5,3,-1,1,0,0,-8,-76,-3,-4,7,-1,0,-1,-1,-1,-1,-1,5,-1
KR_6730076838,420,1,-68,39,0,1,1,2,2,0,2,-2,2,0,0,2,2,-1,3,2,0,-8,-10,1,-4,3,0,0,0,-1,1,0,1,2,-1
KR_6733364827,420,0,30,-44,1,5,0,5,-2,6,4,1,3,4,-2,2,0,-1,2,1,0,-4,-2,1,-5,4,-6,0,-1,-1,0,-1,-1,5,-1
KR_6729650171,440,-5,-35,-14,-12,-2,2,0,-1,3,2,-4,4,0,-2,3,1,-3,4,1,0,-11,-185,-2,-3,5,-4,0,-2,-1,-1,-1,-1,3,-1
KR_6415545762,420,0,-32,32,-3,-2,2,0,3,0,3,-4,5,1,0,0,0,0,0,0,0,1,-2,-3,-5,8,2,0,-1,1,0,-1,-1,2,-1
KR_6706918524,420,2,15,-8,6,0,3,3,0,1,1,3,1,4,4,1,5,-1,3,2,0,5,-73,-1,-5,6,22,0,-1,1,1,1,-1,2,-1
KR_6672695348,440,0,6,20,-6,0,1,1,-2,2,0,-1,4,3,-3,4,1,0,0,0,0,-5,7,0,-5,5,2,0,1,-1,1,1,-1,3,-1
KR_6757055598,420,-3,22,-12,-4,-1,5,4,0,4,4,-1,4,3,0,3,3,-2,2,0,1,0,-6,-4,-1,5,1,0,-2,-1,-1,-1,1,5,-1
KR_6720764347,420,-1,3,5,-3,-1,2,1,3,3,6,-2,4,2,-2,2,0,-1,1,0,0,2,-235,-4,-2,6,0,0,-1,-1,-1,-1,-1,3,-1
KR_6703482104,420,-1,1,0,-13,-3,3,0,-4,4,0,0,2,2,-7,8,1,1,3,4,-2,-18,2,-2,-4,6,-1,0,0,1,1,1,-1,6,-1
KR_6647064955,420,-1,16,16,-3,-3,4,1,1,7,8,1,1,2,-3,7,4,1,1,2,1,5,4,-2,-3,5,3,0,1,1,1,1,1,6,-1
KR_6715531137,420,1,73,-4,-2,2,0,2,-2,4,2,-4,5,1,0,0,0,2,1,3,0,0,12,-1,-4,5,6,0,0,-1,-1,1,1,1,-1
KR_6750083034,420,-1,-33,18,-10,1,2,3,2,0,2,-2,4,2,-6,9,3,-5,5,0,0,-7,3,-2,-2,4,-1,0,0,1,1,-1,-1,1,-1
KR_6662153287,420,0,33,-16,4,-1,1,0,2,2,4,2,0,2,3,0,3,-2,2,0,1,6,-6,-1,-3,4,3,0,0,-1,1,0,1,5,-1
KR_6669893250,420,-2,-20,-20,-3,4,0,4,-1,2,1,-1,3,2,-5,6,1,0,1,1,0,-6,-6,-2,-3,5,-2,0,0,-1,-1,-1,-1,1,-1
KR_6688206520,420,0,-32,7,3,0,1,1,2,5,7,1,2,3,0,1,1,0,1,1,0,6,3,1,-5,4,0,0,0,-1,-1,0,1,2,-1
KR_6752079111,420,-2,-30,-11,-10,-3,4,1,-1,3,2,-1,4,3,-5,5,0,0,1,1,-1,-2,25,-3,-4,7,-6,0,-1,-1,-1,-1,-1,3,-1
KR_6689404423,420,-7,-92,-8,-19,-8,8,0,-6,6,0,2,0,2,-6,6,0,-1,2,1,0,-13,-216,3,-5,2,-4,0,-3,-1,1,-1,-1,6,-1
KR_6749112381,440,-2,-60,15,-7,2,3,5,-3,6,3,-1,3,2,-5,8,3,0,1,1,0,-5,8,-1,-5,6,-2,0,-1,1,-1,-1,1,2,-1
KR_6756819675,420,0,-81,30,-4,-2,2,0,-4,5,1,5,0,5,-3,8,5,0,0,0,0,-2,-104,2,-6,4,-2,0,-1,1,-1,-1,-1,3,-1
KR_6749195392,420,-1,-57,-6,-5,3,0,3,-4,4,0,-1,3,2,-3,3,0,0,1,1,-2,-11,-3,-2,-4,6,-4,0,-1,-1,-1,-1,-1,4,-1
KR_6684896732,420,-7,-148,-12,-21,-9,9,0,-3,4,1,-6,6,0,0,2,2,-3,4,1,0,-8,-9,-3,-2,5,-1,0,-6,0,-1,-1,-1,0,-1
KR_5811403943,420,0,28,-4,-1,6,0,6,1,2,3,-5,6,1,-4,8,4,1,3,4,0,-2,-169,-5,-2,7,-1,0,-1,-1,0,-1,-1,5,-1
KR_6763655435,420,2,73,-26,1,4,0,4,-3,4,1,1,1,2,-1,3,2,0,0,0,0,-4,2,-1,-6,7,0,0,1,-1,1,1,1,3,-1
KR_6758485405,440,-1,-13,-22,0,2,0,2,-1,1,0,-4,5,1,-2,4,2,5,0,5,0,-1,-11,-2,-3,5,-2,0,0,-1,0,0,-1,2,-1
KR_6620581427,420,-5,-12,-28,-11,-2,3,1,0,2,2,-7,9,2,-2,3,1,0,5,5,1,-10,-2,-1,-4,5,2,0,-1,-1,-1,-1,1,4,-1
KR_6759289778,420,-8,-97,-32,-16,-4,4,0,-9,9,0,-3,3,0,0,2,2,0,1,1,0,-10,-9,1,-4,3,-3,0,-2,-1,-1,-1,-1,4,-1
KR_6762129329,420,-2,-99,-12,-10,2,2,4,1,2,3,-7,7,0,-4,6,2,-2,2,0,0,-5,-3,-5,-1,6,-3,0,0,-1,1,-1,1,5,-1
KR_6620222151,420,-2,-39,0,-6,0,1,1,-4,4,0,0,1,1,-1,5,4,-1,4,3,0,-5,-10,-6,-3,9,4,0,0,-1,-1,0,1,6,-1
KR_6743754948,420,-2,-10,-4,-5,-4,4,0,0,2,2,-6,7,1,4,2,6,1,1,2,1,-2,9,-6,0,6,2,0,-1,-1,-1,-1,1,2,-1
KR_6761910935,420,-9,-61,-10,-19,-2,3,1,-9,10,1,-2,2,0,-6,8,2,0,3,3,0,-16,-11,-6,-2,8,1,0,-1,-1,0,-1,-1,1,-1
KR_6752846517,420,-2,-76,36,-5,-3,4,1,3,1,4,-1,3,2,-3,6,3,-1,2,1,0,-1,3,-7,-1,8,-7,0,0,1,-1,0,-1,2,-1
KR_6726020998,420,-2,-52,-25,-8,-2,6,4,0,3,3,1,0,1,-5,5,0,-2,2,0,-1,-8,5,0,-6,6,0,0,-1,-1,-1,-1,-1,1,-1
KR_6738503159,420,0,-30,24,3,-3,3,0,3,0,3,2,3,5,1,3,4,0,2,2,1,7,107,4,-5,1,-5,0,-1,0,-1,1,1,0,-1
KR_6399785538,420,1,-53,28,-1,2,1,3,-5,6,1,1,1,2,-2,4,2,3,0,3,-1,-6,-10,-3,-4,7,1,0,0,-1,1,0,-1,2,-1
KR_6735144633,420,-3,-27,-4,-10,2,1,3,-1,1,0,-9,9,0,1,0,1,-3,3,0,0,-10,-17,3,-4,1,0,0,0,1,0,0,-1,6,-1
KR_6740704282,440,-7,-82,-4,-7,-4,4,0,1,0,1,0,1,1,-5,8,3,1,1,2,0,-13,-3,1,-5,4,-1,0,-2,1,-1,-1,-1,1,-1
KR_6741573093,420,-4,-73,-16,-5,0,4,4,0,3,3,-2,4,2,-2,4,2,-1,1,0,0,-8,39,0,-6,6,-9,0,1,-1,-1,1,1,1,-1
KR_6753173900,420,-1,-32,8,-1,-4,4,0,5,3,8,-4,8,4,3,0,3,-1,1,0,0,0,-29,1,-4,3,-3,0,0,0,1,0,1,0,-1
KR_6689512443,420,-2,3,0,-1,-2,3,1,-1,1,0,-3,3,0,-1,2,1,6,0,6,0,-2,1,1,-5,4,-1,0,0,-1,1,1,-1,3,-1
KR_6662152349,420,-3,-46,8,-9,-5,6,1,2,0,2,0,1,1,-6,8,2,0,1,1,0,-2,-4,2,-6,4,-4,0,-1,0,0,-1,-1,0,-1
KR_6714621090,420,-3,-26,0,-2,-1,3,2,1,2,3,-3,4,1,0,1,1,1,0,1,0,6,23,2,-5,3,-7,0,0,-1,1,0,1,5,-1
KR_6756383642,420,-2,40,8,-9,0,5,5,-8,9,1,-5,5,0,3,0,3,1,0,1,1,-4,3,2,-3,1,5,0,0,1,-1,1,1,6,-1
KR_6727564929,420,-3,2,-74,-1,-1,2,1,-1,2,1,-2,3,1,3,0,3,0,1,1,0,4,2,2,-3,1,-5,0,0,-1,-1,0,-1,2,-1
KR_6763476295,420,-4,-48,-12,-11,1,2,3,-5,5,0,-8,9,1,-2,2,0,3,0,3,0,-6,-26,-4,-2,6,0,0,-2,-1,-1,-1,-1,4,-1
KR_6763081137,440,-2,-48,12,-6,2,1,3,-2,2,0,3,1,4,-7,7,0,-2,2,0,0,-4,-11,-3,-3,6,-2,0,0,1,-1,-1,1,5,-1
KR_6742860289,420,0,-19,-14,-2,0,3,3,3,2,5,-3,5,2,0,3,3,-2,3,1,0,-5,-25,1,-4,3,-2,0,-1,-1,-1,-1,-1,2,-1
KR_6731633686,420,-3,-31,-12,-13,-6,6,0,5,1,6,1,1,2,-8,10,2,-5,5,0,-1,-9,-2,3,-3,0,-5,0,-1,-1,-1,-1,-1,2,-1
KR_6715066727,420,-5,-36,12,-15,-1,1,0,-2,3,1,0,0,0,-8,8,0,-4,4,0,0,-20,315,-1,-2,3,-2,0,-2,1,-1,-1,-1,4,-1
KR_6594995339,420,-4,-66,-16,-11,0,1,1,-2,3,1,-3,3,0,-8,9,1,2,0,2,-1,-11,-48,-6,-3,9,19,0,-1,1,-1,-1,-1,5,-1
KR_6762098686,420,-3,5,-24,-7,-1,3,2,-1,5,4,-4,4,0,-2,4,2,1,0,1,0,3,26,3,-5,2,3,0,0,1,1,0,-1,6,-1
KR_6745828198,420,0,-18,0,-1,0,2,2,-3,4,1,-2,3,1,0,3,3,4,1,5,0,0,-4,-2,-4,6,2,0,0,0,-1,0,-1,0,-1
KR_6723138466,420,0,4,-6,-3,-2,2,0,-2,2,0,0,4,4,1,0,1,0,3,3,0,-1,-107,-3,-4,7,5,0,0,0,1,0,-1,0,-1
KR_6600383986,420,-2,-100,-22,-9,-1,4,3,1,2,3,-4,7,3,-4,5,1,-1,1,0,-2,-10,-23,-4,-3,7,3,0,-2,-1,-1,-1,-1,1,-1
KR_6744688445,420,-4,-34,-24,-15,-3,3,0,-7,7,0,-6,6,0,0,0,0,1,2,3,0,-8,-7,-3,-1,4,0,0,0,1,-1,-1,-1,1,-1
KR_6752329923,420,2,28,8,4,0,1,1,0,3,3,4,2,6,1,1,2,-1,1,0,0,-1,21,0,-2,2,-3,0,0,0,1,1,1,0,-1
KR_6684014370,420,-1,20,28,-7,-4,6,2,-1,2,1,0,3,3,0,2,2,-2,5,3,0,-8,-9,-3,-2,5,0,0,0,-1,1,1,-1,5,-1
KR_6763113159,420,-1,19,-47,-2,2,1,3,-1,2,1,-4,6,2,1,3,4,0,1,1,1,8,-6,2,-6,4,0,0,1,-1,1,1,1,6,-1
KR_6760338090,420,-1,-46,-20,5,-3,4,1,6,0,6,2,1,3,-3,3,0,3,0,3,0,14,133,-2,-2,4,-2,0,0,1,-1,0,1,3,-1
KR_6758812951,420,1,-2,-28,8,4,0,4,-2,4,2,1,2,3,2,3,5,3,0,3,0,6,3,-1,-4,5,1,0,0,-1,0,1,-1,5,-1
KR_6713065519,420,-3,-42,-6,-12,-1,2,1,-4,5,1,-7,8,1,-1,1,0,1,0,1,0,-6,27,1,-5,4,-8,0,1,-1,1,1,-1,5,-1
KR_6751782347,420,-4,-59,21,-10,2,3,5,-1,1,0,-7,8,1,-6,7,1,2,0,2,0,-14,-2,-1,-4,5,-4,0,0,-1,-1,-1,-1,2,-1
KR_6740816449,420,-2,-31,-16,-5,-2,4,2,-5,6,1,-2,3,1,4,1,5,0,4,4,-1,0,-26,2,-3,1,-1,0,-1,-1,-1,1,-1,5,-1
KR_6634875140,440,-5,-46,-3,-15,-1,3,2,-7,8,1,-4,4,0,-1,2,1,-2,3,1,0,-18,-4,-1,-5,6,-4,0,-2,-1,-1,-1,1,6,-1
KR_6678317668,440,-4,-22,-5,-16,-2,2,0,-7,8,1,-3,5,2,-6,6,0,2,0,2,0,-10,17,-1,-2,3,-2,0,-1,0,-1,-1,-1,0,-1
KR_6759168317,440,3,20,1,3,4,2,6,2,1,3,-1,4,3,4,2,6,-6,6,0,-2,-3,-39,2,-7,5,21,0,0,-1,1,0,1,4,-1
KR_6681720864,420,1,46,28,-6,-1,1,0,1,1,2,0,3,3,-5,6,1,-1,2,1,0,-8,-7,2,-3,1,-2,0,-1,-1,-1,-1,-1,5,-1
KR_6706509294,420,-3,-80,-9,-6,-4,4,0,-5,6,1,4,0,4,-2,4,2,1,1,2,0,-3,-2,-5,-3,8,2,0,-1,1,-1,1,-1,4,-1
KR_6636842673,420,0,49,-16,-1,2,1,3,-5,8,3,-2,3,1,-1,3,2,5,1,6,0,-10,10,6,-7,1,-3,0,1,-1,0,1,1,1,-1
KR_6761479117,440,-2,-80,-25,0,-1,3,2,1,5,6,-2,2,0,5,0,5,-3,5,2,0,-3,23,7,-9,2,-5,0,0,1,0,1,1,1,-1
KR_6621884991,420,-1,10,1,-5,-4,5,1,-3,4,1,5,0,5,-5,6,1,2,3,5,0,-12,-8,-5,-2,7,3,0,0,-1,0,-1,1,4,-1
KR_6742708194,420,-2,-72,8,-11,-4,5,1,-3,3,0,-7,9,2,3,0,3,0,1,1,0,-4,-4,0,-5,5,-1,0,-2,1,-1,-1,-1,3,-1
KR_6763571158,440,-10,-107,-20,-10,-8,10,2,-1,7,6,0,0,0,0,5,5,-1,1,0,-2,-1,3,-1,-2,3,1,0,-1,-1,-1,-1,-1,2,-1
KR_6622180782,420,1,11,8,0,-3,3,0,-2,5,3,3,1,4,1,1,2,1,2,3,0,2,-8,5,-7,2,1,0,0,1,1,0,1,3,-1
KR_6726331587,420,-5,-30,-28,-16,-7,7,0,-3,6,3,-1,2,1,-1,4,3,-4,5,1,0,-16,-6,-2,0,2,2,0,-2,-1,-1,-1,1,1,-1
KR_6726269042,440,-6,-53,-14,-5,1,1,2,5,3,8,-3,7,4,-5,7,2,-3,3,0,0,-9,-187,-1,-1,2,-1,0,0,-1,1,1,-1,3,-1
KR_6758790957,420,-1,-30,24,-1,1,0,1,0,3,3,0,1,1,-4,5,1,2,1,3,0,-3,-1,-2,-1,3,2,0,0,0,0,0,-1,0,-1
KR_6704700232,420,1,-5,48,-1,-3,4,1,-2,5,3,1,2,3,1,1,2,2,1,3,0,-1,103,3,-6,3,-5,0,0,1,0,0,-1,1,-1
KR_6741227610,420,0,-31,-15,-2,-2,3,1,2,1,3,-3,5,2,1,0,1,0,3,3,1,1,-5,-10,-2,12,-5,0,0,1,-1,0,1,5,-1
KR_6756083667,420,-2,45,-10,-9,-2,2,0,-2,3,1,-5,8,3,1,3,4,-1,2,1,0,-3,1,1,-2,1,-2,0,-1,-1,-1,-1,-1,1,-1
KR_6750438242,440,-4,-105,-8,-9,-4,5,1,1,3,4,1,0,1,-6,7,1,-1,3,2,-1,-10,-13,-3,-1,4,1,0,-3,-1,-1,-1,-1,4,-1
KR_6759450826,420,0,2,-28,0,-1,2,1,0,2,2,-1,4,3,1,1,2,1,1,2,0,-1,-3,1,-6,5,-4,0,-1,1,-1,-1,1,5,-1
KR_6752681276,420,-2,31,5,-8,0,2,2,-5,7,2,-6,6,0,1,2,3,2,1,3,0,-6,-122,-6,-3,9,1,0,-2,1,-1,-1,-1,1,-1
KR_6756316268,420,-2,15,-11,2,-2,2,0,0,3,3,0,3,3,-1,4,3,5,1,6,1,1,-1,-2,-3,5,1,0,0,0,-1,0,1,0,-1
KR_6521016905,420,-2,-42,-18,-7,2,1,3,-3,4,1,-1,3,2,-5,5,0,0,0,0,0,-7,-97,-4,-3,7,-5,0,-3,-1,-1,-1,-1,1,-1
KR_6763813613,420,-3,13,20,-10,0,0,0,-6,7,1,3,2,5,-6,6,0,-1,1,0,-1,-18,-7,-1,-2,3,0,0,0,-1,1,0,-1,5,-1
KR_6757563192,420,1,0,-10,0,-1,2,1,2,0,2,1,1,2,-1,2,1,-1,1,0,0,1,57,2,-6,4,-14,0,1,-1,1,1,-1,2,-1
KR_6693290977,420,-1,5,-1,-5,-2,6,4,-3,3,0,-2,4,2,1,2,3,1,2,3,-1,-4,-4,-3,-3,6,1,0,1,-1,-1,1,-1,6,-1
KR_6684099140,420,-10,-131,-12,-34,-6,7,1,-3,4,1,-10,10,0,-11,11,0,-4,4,0,-1,-42,1,-1,-1,2,-3,-1,-7,-1,-1,-1,-1,4,-1
KR_6660240926,420,-3,-6,0,-8,-3,3,0,2,2,4,-5,5,0,-1,1,0,-1,1,0,0,-8,19,3,-7,4,-3,0,0,-1,1,-1,1,5,-1
KR_6727305850,420,-7,-17,-7,-15,1,3,4,-4,5,1,-4,5,1,-4,4,0,-4,5,1,0,-7,1,-1,-2,3,-1,0,-2,-1,-1,-1,-1,1,-1
KR_6733800121,420,2,27,12,-4,2,2,4,-5,7,2,-1,2,1,1,2,3,-1,1,0,1,-5,-4,-5,-2,7,2,0,-1,1,-1,1,1,6,-1
KR_6760971132,420,-5,-82,-39,-5,-4,4,0,1,2,3,0,2,2,-2,3,1,0,0,0,-1,-1,2,2,-4,2,0,0,-2,-1,-1,-1,-1,4,-1
KR_6730031544,440,1,53,20,-6,1,1,2,3,0,3,-6,6,0,-2,3,1,-2,3,1,-1,-9,-55,-1,-1,2,0,0,0,-1,-1,1,-1,5,-1
KR_6734857255,420,3,39,-13,7,1,2,3,0,1,1,2,2,4,2,2,4,2,0,2,0,12,-27,-2,-1,3,3,0,1,0,1,1,-1,0,-1
KR_6659983418,420,-3,-28,-6,-5,-3,3,0,0,3,3,-5,6,1,5,1,6,-2,2,0,0,-2,-6,2,-4,2,1,0,-1,-1,-1,-1,-1,6,-1
KR_6729188987,420,-1,20,-4,2,5,2,7,-1,5,4,-1,3,2,-1,2,1,0,2,2,0,-2,-131,0,-4,4,1,0,0,1,1,0,-1,6,-1
KR_6690820940,420,-8,-95,-10,-17,-7,7,0,-2,4,2,0,2,2,-2,5,3,-6,6,0,1,-12,-6,-1,-4,5,-2,0,-2,-1,-1,-1,1,2,-1
KR_6760172591,420,-4,-83,8,-12,-1,4,3,-3,5,2,-3,5,2,-7,7,0,2,0,2,0,-13,103,1,-5,4,1,0,-2,-1,-1,-1,-1,1,-1
KR_6755324836,420,2,47,-15,-2,-1,2,1,-6,7,1,4,0,4,2,0,2,-1,1,0,0,-8,18,-1,-3,4,4,0,1,-1,1,1,1,3,-1
KR_6733367761,440,1,25,67,-1,-4,5,1,-1,6,5,3,4,7,2,2,4,-1,1,0,2,-2,-28,0,-3,3,1,0,0,-1,1,0,1,6,-1
KR_6679104468,420,-4,-84,-12,-1,-2,2,0,1,0,1,1,0,1,1,4,5,-2,2,0,0,2,2,2,-8,6,-4,0,0,-1,-1,0,1,4,-1
KR_6724475649,420,-4,-37,15,-10,0,2,2,-2,3,1,-4,4,0,-3,4,1,-1,2,1,1,-4,21,-2,-3,5,1,0,0,1,-1,-1,1,6,-1
KR_6742726892,420,-1,-72,8,1,0,5,5,0,4,4,0,3,3,1,1,2,0,1,1,0,2,1,-1,-2,3,-2,0,0,1,-1,-1,-1,4,-1
KR_6731590488,420,0,-25,-59,4,-1,4,3,0,2,2,5,4,9,0,0,0,0,0,0,-1,1,6,5,-6,1,-4,0,-1,0,-1,-1,-1,0,-1
KR_6763764025,420,0,-2,12,-10,-7,7,0,-2,3,1,1,2,3,-4,5,1,2,1,3,0,-9,13,5,-6,1,-9,0,-1,-1,1,-1,-1,5,-1
KR_6758651273,420,-1,-47,-12,1,6,1,7,-3,4,1,0,2,2,-5,5,0,3,0,3,0,-2,-378,-1,-1,2,2,0,-1,-1,-1,-1,-1,2,-1
KR_6677298370,420,-3,-14,28,-10,-4,4,0,0,2,2,-1,2,1,-4,4,0,-1,1,0,0,-11,-6,1,-3,2,5,0,0,1,-1,0,-1,2,-1
KR_6622655820,440,-1,-38,-28,-4,2,1,3,-1,5,4,-4,4,0,0,2,2,-1,2,1,0,-6,3,-4,-1,5,0,0,1,-1,-1,-1,-1,3,-1
KR_6745853108,420,0,6,26,-3,3,0,3,1,1,2,-5,6,1,-1,5,4,-1,1,0,2,-9,1,-4,-3,7,0,0,0,-1,0,0,1,6,-1
KR_6677029043,420,-3,-86,-19,-6,1,0,1,-1,2,1,-5,6,1,0,1,1,-1,1,0,0,-1,1,1,-5,4,-2,0,0,-1,1,0,-1,5,-1
KR_6739000774,420,-2,-57,-9,-3,-1,1,0,-2,5,3,4,1,5,-4,5,1,0,0,0,0,-6,35,0,-3,3,-22,0,0,0,0,0,-1,0,-1
KR_6761062240,420,-2,-6,-16,-1,0,2,2,-4,6,2,-1,2,1,4,1,5,0,0,0,2,2,2,-5,-1,6,3,0,0,-1,-1,-1,1,1,-1
KR_6748355495,420,1,38,-24,4,0,0,0,-1,5,4,3,2,5,3,2,5,-1,1,0,2,0,8,-2,-1,3,-3,0,0,1,-1,1,1,3,-1
KR_6713005053,420,-3,21,-12,-7,6,0,6,-3,5,2,-1,3,2,-5,6,1,-4,4,0,0,-9,24,1,-5,4,0,0,0,1,1,0,-1,3,-1
KR_6600282961,420,-4,-4,-8,-7,0,2,2,-5,6,1,3,3,6,-3,5,2,-2,3,1,0,-5,-12,1,-4,3,-1,0,-1,0,0,-1,-1,0,-1
KR_6727302607,420,-1,-56,-8,0,1,2,3,1,3,4,-1,3,2,1,4,5,-2,2,0,0,1,-3,-1,-4,5,2,0,0,1,-1,-1,1,6,-1
KR_6764128683,420,-4,-18,-16,-8,0,2,2,0,3,3,-1,3,2,-3,6,3,-4,5,1,0,-13,-115,1,-5,4,-1,0,0,-1,1,0,1,4,-1
KR_6345353622,420,-9,-83,-23,-19,-2,3,1,-5,5,0,-7,8,1,-3,5,2,-2,2,0,0,-14,-6,-2,-3,5,-1,0,0,-1,-1,-1,-1,2,-1
KR_6763333129,440,-3,-32,-5,-7,-4,5,1,-4,4,0,-2,2,0,4,1,5,-1,2,1,1,-4,-9,-7,-2,9,3,0,-1,1,1,-1,1,5,-1
KR_6729766923,440,0,-60,16,-5,1,1,2,-1,3,2,3,0,3,-4,5,1,-4,6,2,-2,-9,2,1,-3,2,-1,0,-1,-1,0,-1,-1,3,-1
KR_6760568984,420,2,-10,17,11,3,2,5,2,4,6,1,0,1,5,3,8,0,0,0,0,10,7,4,-7,3,-1,0,0,1,-1,1,-1,3,-1
KR_6516098103,420,-2,-6,8,-7,-1,4,3,-1,4,3,0,3,3,-1,4,3,-4,5,1,0,-1,78,2,-5,3,-6,0,-1,1,-1,-1,-1,6,-1
KR_6665858436,420,-2,-65,3,-3,-2,5,3,-1,2,1,5,0,5,-5,8,3,0,1,1,1,-2,-209,-6,0,6,18,0,0,1,-1,1,1,2,-1
KR_6761417133,420,-5,-85,-17,-9,-4,6,2,0,1,1,-1,1,0,-2,3,1,-2,2,0,-2,-4,-6,-2,-5,7,-2,0,0,-1,-1,0,-1,1,-1
KR_6313917615,420,1,-19,-16,0,-4,4,0,0,2,2,1,2,3,4,3,7,-1,3,2,0,-5,1,2,-6,4,1,0,0,1,-1,-1,-1,2,-1
KR_6642063158,420,-3,-26,17,-9,2,0,2,1,1,2,-2,3,1,-8,8,0,-2,3,1,0,-10,-10,-3,-1,4,1,0,-2,-1,0,-1,-1,2,-1
KR_6738358578,440,0,-17,8,-4,1,2,3,2,2,4,-9,9,0,0,3,3,2,0,2,0,-2,26,5,-8,3,-4,0,0,1,-1,1,-1,4,-1
KR_6636659233,420,1,33,20,-3,1,0,1,-5,7,2,1,2,3,0,2,2,0,1,1,0,-11,-26,-3,-3,6,0,0,0,1,1,1,1,1,-1
KR_6731683093,420,-6,-125,-16,-12,-2,3,1,2,2,4,-4,6,2,-4,4,0,-4,5,1,0,-8,-220,1,-5,4,-3,0,-2,-1,-1,-1,-1,3,-1
KR_6694197486,420,0,51,-3,-8,0,0,0,-7,8,1,1,1,2,1,4,5,-3,3,0,-1,-9,6,1,-4,3,-5,0,0,-1,-1,0,-1,4,-1
KR_6697306115,420,-5,-116,-17,-19,-3,5,2,-4,6,2,-7,10,3,-1,5,4,-4,4,0,-2,-22,5,0,-6,6,-2,0,-2,1,1,-1,-1,3,-1
KR_6666480481,420,-1,0,30,-5,0,2,2,1,0,1,-8,8,0,1,3,4,1,1,2,0,0,13,6,-7,1,-4,0,0,0,1,-1,-1,0,-1
KR_6762769036,420,-4,-38,-23,-16,-6,7,1,1,2,3,-2,3,1,-9,10,1,0,0,0,0,-12,-3,-5,-2,7,3,0,-2,1,-1,-1,-1,3,-1
KR_6691283116,420,0,13,-31,-8,-1,2,1,0,2,2,0,1,1,-7,8,1,0,1,1,0,-12,2,1,-2,1,0,0,0,-1,-1,0,-1,4,-1
KR_6733925198,420,0,-20,8,-1,1,2,3,2,1,3,0,0,0,-4,5,1,0,0,0,0,0,110,-2,-4,6,-2,0,0,0,-1,0,-1,0,-1
KR_6711256174,420,-1,20,-31,-3,0,1,1,-2,6,4,1,2,3,-1,3,2,-1,3,2,0,-3,-40,1,-3,2,17,0,-2,-1,-1,-1,-1,1,-1
KR_6732149271,420,-3,-82,-3,-3,1,2,3,0,2,2,0,2,2,-7,8,1,3,1,4,0,-2,-3,3,-4,1,0,0,-3,-1,-1,-1,-1,4,-1
KR_6751101468,440,-5,-6,6,-14,-7,8,1,-1,4,3,-2,3,1,0,1,1,-4,5,1,0,-12,193,1,-3,2,-1,0,-1,-1,-1,-1,-1,4,-1
KR_6750319318,420,-4,-53,0,-6,-1,3,2,-5,6,1,3,1,4,-2,2,0,-1,1,0,0,-7,4,2,-6,4,3,0,-2,0,1,-1,-1,0,-1
KR_6745500233,420,1,2,1,-7,0,0,0,-9,9,0,1,1,2,1,0,1,0,0,0,0,-7,21,3,-6,3,-1,0,0,-1,1,0,-1,2,-1
KR_6761986907,420,-3,9,8,-8,2,0,2,-3,4,1,-4,4,0,0,4,4,-3,3,0,0,-11,6,2,-5,3,-2,0,1,-1,-1,1,-1,3,-1
KR_6673264409,420,-1,-66,-8,-8,-2,2,0,-1,3,2,-1,2,1,-3,6,3,-1,2,1,0,-8,23,-3,-2,5,-1,0,-1,-1,-1,-1,1,1,-1
KR_6753396934,420,-1,6,0,1,-5,5,0,6,0,6,0,1,1,1,4,5,-1,1,0,3,10,1,5,-6,1,1,0,0,0,1,-1,1,0,-1
KR_6659115506,440,-3,-2,-6,-4,0,0,0,1,1,2,-3,4,1,1,3,4,-3,4,1,0,1,-160,6,-7,1,-1,0,-1,1,1,-1,1,5,-1
KR_6739847078,420,-2,-41,-21,-4,1,2,3,-4,5,1,-2,2,0,4,1,5,-3,3,0,0,-2,4,2,-7,5,-4,0,0,-1,1,0,-1,4,-1
KR_6745729700,420,-3,-84,-4,-7,-2,4,2,3,1,4,-4,4,0,1,4,5,-5,5,0,0,-8,0,3,-4,1,-2,0,1,-1,1,1,-1,3,-1
KR_6764310528,420,-5,-68,-11,-8,-7,8,1,-9,10,1,1,1,2,6,2,8,1,2,3,0,5,-17,0,-3,3,3,0,0,1,-1,-1,-1,2,-1
KR_6738649615,420,-4,-55,-26,-4,-4,4,0,1,2,3,1,1,2,-3,3,0,1,0,1,0,3,-27,-3,-3,6,3,0,-2,1,-1,-1,-1,6,-1
KR_6764577551,420,-1,-112,6,2,1,1,2,0,2,2,-2,5,3,4,1,5,-1,2,1,0,-4,-15,-4,-4,8,3,0,0,1,1,1,-1,6,-1
KR_6762410054,420,-2,24,0,-1,-1,2,1,-7,7,0,4,0,4,3,1,4,0,0,0,0,-3,-13,2,-7,5,1,0,0,-1,0,0,1,1,-1
KR_6753518671,420,0,7,-28,2,2,0,2,2,1,3,1,3,4,0,0,0,-3,3,0,0,-3,0,3,-6,3,-3,0,0,0,-1,1,1,0,-1
KR_6660633021,420,-3,-51,-24,-9,-1,2,1,-5,6,1,-2,3,1,-1,4,3,0,3,3,0,-7,-1,-2,-1,3,-2,0,-1,-1,0,-1,1,6,-1
KR_6719484065,420,-4,-7,-20,-9,3,1,4,-1,3,2,-9,9,0,1,4,5,-3,3,0,-1,-8,25,4,-7,3,0,0,-1,-1,1,-1,-1,1,-1
KR_6764304386,420,-3,27,-10,-5,-3,8,5,-2,3,1,0,1,1,0,2,2,0,1,1,0,-2,4,-6,-2,8,4,0,0,-1,-1,-1,1,6,-1
KR_6674288463,420,-5,-82,-24,-6,0,2,2,0,4,4,-5,5,0,0,5,5,-1,2,1,0,-11,228,-11,-1,12,-3,0,-2,-1,-1,-1,-1,6,-1
KR_6669298608,420,2,-21,48,3,1,1,2,5,1,6,2,1,3,-6,7,1,1,1,2,0,-1,-22,3,-4,1,5,0,0,0,-1,0,1,0,-1
KR_6756829828,420,-4,-30,-39,-13,0,2,2,-6,9,3,-6,8,2,-2,5,3,1,0,1,2,0,-31,-2,-2,4,-1,0,-1,1,1,-1,1,6,-1
KR_6751321886,420,-4,-146,33,-13,1,1,2,-3,3,0,-4,4,0,-5,5,0,-2,2,0,-4,-27,-5,-2,-1,3,0,0,-3,-1,-1,-1,-1,3,-1
KR_6719334766,420,-1,19,-19,-5,-1,2,1,-1,1,0,2,8,10,-4,5,1,-1,2,1,0,-12,0,0,-3,3,3,0,0,-1,-1,0,-1,1,-1
KR_6646818460,420,0,13,-23,2,5,0,5,4,3,7,-4,6,2,-3,3,0,0,2,2,0,1,-19,-2,0,2,2,0,1,0,0,-1,1,0,-1
KR_6732632868,420,-1,-12,7,4,-2,3,1,0,3,3,1,1,2,7,0,7,-2,4,2,1,6,71,2,-6,4,-1,0,-2,-1,-1,-1,1,6,-1
KR_6482943010,420,-2,-10,-14,-3,3,1,4,-3,5,2,-2,3,1,-1,4,3,0,1,1,0,-7,5,0,-3,3,1,0,0,-1,0,1,1,5,-1
KR_6586657533,440,0,2,-4,-10,2,0,2,-3,5,2,2,3,5,-13,15,2,2,1,3,-1,-7,-7,-3,-2,5,1,0,1,-1,1,-1,-1,4,-1
KR_6603633679,420,-5,-68,-12,-14,-4,4,0,-6,6,0,-2,3,1,-2,5,3,0,0,0,0,-17,-1,-3,-2,5,-3,0,-2,-1,1,-1,-1,3,-1
KR_6608491085,420,1,-10,34,-3,0,1,1,2,0,2,-1,1,0,-1,3,2,-3,3,0,0,-1,-121,4,-7,3,-2,0,0,1,1,0,1,6,-1
KR_6703937324,420,0,-50,9,-2,2,0,2,-1,1,0,1,2,3,-3,3,0,-1,2,1,0,-7,177,0,-3,3,-3,0,-2,-1,-1,-1,-1,4,-1
KR_6656772073,420,-2,-46,-18,0,1,4,5,-3,5,2,4,1,5,-2,3,1,0,0,0,1,-5,19,0,-3,3,-1,0,-1,1,1,-1,1,2,-1
KR_6734971003,420,0,-22,12,0,1,3,4,2,2,4,0,1,1,-5,7,2,2,0,2,0,-6,-3,-3,-3,6,2,0,-1,1,-1,-1,-1,1,-1
KR_6749946116,420,-4,-21,-12,-3,0,1,1,-5,6,1,0,0,0,3,4,7,-1,1,0,0,-3,35,-4,-3,7,3,0,0,0,1,0,1,0,-1
KR_6736278406,420,3,29,28,6,-4,5,1,3,2,5,2,4,6,4,0,4,1,0,1,0,12,4,3,-5,2,2,0,0,1,-1,1,-1,1,-1
KR_6754549771,420,-2,15,5,-8,-4,4,0,0,2,2,0,1,1,-3,7,4,-1,2,1,0,-7,-4,-2,-5,7,-4,0,0,0,1,1,-1,0,-1
KR_6749843136,420,-2,-114,-28,-4,-3,5,2,3,0,3,-2,2,0,-2,3,1,0,1,1,0,-3,-16,2,-6,4,0,0,-2,1,-1,-1,-1,5,-1
KR_6763330221,420,-1,22,-13,-19,2,0,2,-7,7,0,-3,5,2,-10,10,0,-1,2,1,0,-19,2,0,-8,8,-2,0,-2,-1,-1,-1,-1,2,-1
KR_6737358493,420,1,-12,24,-1,4,0,4,-3,4,1,2,0,2,-3,3,0,-1,3,2,0,-10,-3,2,-5,3,-1,0,-1,1,1,1,1,1,-1
KR_6749254528,440,-3,-43,16,-5,-1,5,4,1,1,2,1,1,2,0,2,2,-6,7,1,0,-4,1,4,-5,1,-2,0,-2,1,1,-1,1,1,-1
KR_6763713591,420,-3,16,-36,-5,0,2,2,-1,2,1,0,4,4,-5,6,1,1,0,1,0,0,5,-3,-1,4,-4,0,0,-1,1,0,1,3,-1
KR_6694078351,440,-3,-20,-7,-15,-2,3,1,-3,5,2,-6,6,0,-4,5,1,0,0,0,0,-18,7,0,-5,5,-6,0,0,-1,1,-1,-1,3,-1
KR_6713314772,420,-2,23,-47,-3,0,2,2,0,2,2,0,0,0,0,1,1,-3,5,2,0,2,-2,-4,-1,5,-1,0,0,-1,-1,1,-1,1,-1
KR_6757179630,420,0,22,-23,-4,-1,1,0,0,2,2,2,0,2,-6,8,2,1,2,3,0,-8,-129,-1,-1,2,3,0,2,1,1,1,-1,4,-1
KR_6721304555,440,1,-12,6,6,0,2,2,1,5,6,-1,2,1,4,2,6,2,1,3,0,14,6,-2,-2,4,4,0,-2,-1,-1,-1,-1,2,-1
KR_6764144024,420,3,-31,20,2,0,2,2,2,2,4,3,3,6,-2,4,2,-1,2,1,0,0,6,-3,-3,6,2,0,-1,1,-1,-1,1,5,-1
KR_6709239510,420,-4,22,-42,-4,-3,3,0,1,2,3,0,1,1,1,2,3,-3,3,0,0,-2,59,3,-5,2,-32,0,0,-1,1,0,1,2,-1
KR_6636774219,420,1,38,4,-2,-1,2,1,-9,9,0,5,3,8,3,0,3,0,1,1,0,-13,-3,-6,-1,7,-1,0,0,1,-1,0,-1,1,-1
KR_6760449429,420,1,66,10,-4,-2,5,3,1,2,3,0,1,1,-2,2,0,-1,2,1,0,-4,-62,0,-1,1,0,0,0,-1,1,-1,-1,1,-1
KR_6762382744,420,1,8,-1,3,0,1,1,0,7,7,2,2,4,0,1,1,1,0,1,0,0,-1,1,-3,2,1,0,0,1,1,0,1,4,-1
KR_6681145372,420,-4,-61,-20,-5,-5,6,1,-4,6,2,-3,3,0,7,3,10,0,0,0,0,1,-2,-1,-5,6,2,0,-1,-1,-1,-1,1,4,-1
KR_6511679214,420,-3,-27,-13,-1,0,1,1,-1,5,4,2,2,4,-2,3,1,0,1,1,0,-1,86,2,-8,6,3,0,1,1,1,1,1,3,-1
KR_6762391246,420,-7,-114,-15,-9,-1,3,2,-2,4,2,-3,7,4,-2,4,2,-1,3,2,-1,-9,-13,-4,0,4,-2,0,-2,0,-1,-1,-1,0,-1
KR_6552254132,420,-5,-122,5,-12,-3,4,1,-1,4,3,-1,1,0,-4,5,1,-3,3,0,-1,-11,-25,0,-3,3,11,0,0,-1,1,-1,-1,5,-1
KR_6708390351,420,-3,-59,6,-7,1,1,2,-2,4,2,-1,2,1,-4,5,1,-1,4,3,0,-5,-180,-2,-2,4,0,0,1,-1,1,1,-1,6,-1
KR_6705155036,420,-3,-15,32,-10,-7,8,1,-4,7,3,-3,3,0,-1,3,2,5,0,5,0,-5,-10,-1,-3,4,-2,0,0,-1,-1,0,-1,2,-1
KR_6623089455,440,-1,-86,-22,1,-5,6,1,0,1,1,7,1,8,-1,2,1,0,1,1,0,-1,-5,-2,-3,5,0,0,0,-1,1,-1,-1,5,-1
KR_6758787281,420,-5,-78,-8,-1,1,4,5,-1,3,2,1,0,1,0,4,4,-2,2,0,0,0,-1,-1,-4,5,-2,0,0,-1,-1,-1,-1,3,-1
KR_6728206685,420,-4,-30,8,-10,0,1,1,0,1,1,-3,6,3,-2,2,0,-5,6,1,0,-8,2,-3,-4,7,3,0,-2,-1,1,-1,-1,3,-1
KR_6658533790,420,-4,16,27,-7,-2,2,0,-3,3,0,-2,4,2,-2,3,1,2,0,2,0,-10,-3,0,-5,5,-3,0,-1,-1,-1,-1,-1,4,-1
KR_6757749497,420,2,36,20,3,1,0,1,1,0,1,2,1,3,-1,2,1,0,0,0,0,0,29,0,-5,5,4,0,0,0,-1,0,1,0,-1
KR_6759094380,420,4,43,32,-2,-2,6,4,2,1,3,-4,4,0,1,0,1,1,0,1,-1,0,-13,0,-5,5,3,0,1,-1,1,1,-1,2,-1
KR_6679141947,420,-5,-88,-17,-9,-6,7,1,-1,2,1,0,4,4,0,2,2,-2,2,0,0,0,5,-4,-1,5,1,0,-1,-1,-1,-1,1,4,-1
KR_6647679356,420,-2,52,-28,-4,-2,3,1,-4,5,1,0,1,1,4,2,6,-2,2,0,-1,1,5,3,-5,2,1,0,1,-1,1,1,-1,2,-1
KR_6728734277,440,-3,-1,0,-2,-2,2,0,-1,4,3,0,3,3,1,3,4,0,3,3,0,10,2,3,-7,4,0,0,0,-1,-1,0,1,4,-1
KR_6758664511,420,-3,-47,-12,-8,-2,3,1,-3,5,2,-2,4,2,-2,4,2,1,2,3,-1,-10,-30,-5,0,5,0,0,0,-1,-1,-1,-1,6,-1
KR_6663576320,420,-5,-21,2,-3,-3,3,0,-6,6,0,5,1,6,3,4,7,-2,6,4,2,-5,0,-3,-2,5,1,0,0,1,-1,0,1,1,-1
KR_6707970078,420,-4,-63,-1,-7,-1,1,0,-1,3,2,-2,2,0,-2,3,1,-1,2,1,0,-5,-5,-1,-4,5,-1,0,-1,-1,-1,-1,1,3,-1
KR_6689680924,420,-3,-75,-13,-5,0,0,0,-1,3,2,2,1,3,-4,5,1,-2,2,0,0,-1,1,1,-4,3,0,0,-1,0,1,-1,-1,0,-1
KR_6453694207,420,1,8,4,3,-5,6,1,-2,4,2,0,1,1,8,3,11,2,0,2,1,8,2,-2,-2,4,1,0,0,1,1,1,1,5,-1
KR_6756387176,420,-6,-32,5,-12,-1,3,2,-4,5,1,1,2,3,-5,7,2,-3,3,0,1,-12,-28,-2,0,2,-1,0,0,-1,1,-1,1,4,-1
KR_6657675718,420,-1,20,5,5,4,1,5,1,2,3,0,3,3,-2,3,1,2,1,3,0,-3,9,2,-6,4,2,0,0,-1,0,-1,-1,6,-1
KR_6755440611,440,1,-21,0,-1,4,0,4,0,0,0,-2,3,1,-4,4,0,1,0,1,0,-4,0,-1,-1,2,0,0,0,-1,-1,0,-1,2,-1
KR_6760673774,420,-2,-110,3,-1,-2,2,0,3,2,5,2,1,3,-4,5,1,0,0,0,2,5,5,2,-5,3,-2,0,0,-1,-1,0,1,6,-1
KR_6704616272,420,-1,-18,-8,-1,-2,7,5,2,1,3,1,1,2,-1,3,2,-1,1,0,0,0,-5,-3,0,3,-2,0,1,-1,-1,1,-1,6,-1
KR_6757885436,420,-2,-73,0,-7,2,1,3,-2,3,1,-5,7,2,-4,4,0,2,1,3,-1,-8,-1,-3,-1,4,-5,0,0,-1,-1,-1,-1,4,-1
KR_6686610446,420,0,-39,20,-3,-4,4,0,3,1,4,2,2,4,0,2,2,-4,5,1,0,-4,125,0,-2,2,2,0,-2,-1,1,-1,-1,4,-1
KR_6678563924,420,-1,-179,28,-1,0,1,1,5,1,6,-1,2,1,-3,4,1,-2,3,1,0,1,-8,-3,-1,4,-5,0,0,1,0,-1,-1,5,-1
KR_6652168547,420,-9,-100,-36,-16,0,1,1,-10,12,2,-6,6,0,1,3,4,-1,1,0,0,-15,10,-2,-3,5,1,0,-4,0,-1,-1,-1,0,-1
KR_6635127702,440,3,34,-4,6,3,3,6,3,1,4,1,1,2,0,1,1,-1,1,0,0,5,0,1,-3,2,2,0,-1,-1,-1,-1,1,3,-1
KR_6732359185,440,1,92,16,2,1,3,4,2,4,6,0,4,4,3,1,4,-4,5,1,0,-4,1,-1,-2,3,3,0,0,1,-1,1,1,5,-1
KR_6667940776,420,-6,-53,-55,-13,0,0,0,2,1,3,-5,5,0,-7,8,1,-3,3,0,0,-6,59,3,-6,3,-6,0,0,-1,-1,-1,-1,3,-1
KR_6756670382,420,3,2,43,4,1,1,2,1,3,4,-1,2,1,7,0,7,-4,5,1,-1,7,-233,-2,-2,4,4,0,1,1,1,1,-1,3,-1
KR_6761377974,440,0,-52,-20,0,-4,5,1,-1,4,3,-2,2,0,5,5,10,2,1,3,-3,3,127,6,-7,1,1,0,2,1,-1,1,-1,6,-1
KR_6717411869,420,-3,-69,-17,-8,-2,4,2,0,4,4,-3,4,1,0,4,4,-3,3,0,-2,-7,-7,2,-6,4,-8,0,-2,-1,-1,-1,-1,2,-1
KR_6748165387,420,-3,-41,-14,-9,-2,2,0,-1,3,2,-1,1,0,-5,6,1,0,2,2,0,-10,-16,-10,-2,12,5,0,-2,1,-1,-1,1,5,-1
KR_6733255276,420,-5,-24,14,-11,-1,3,2,-7,7,0,-2,2,0,-3,6,3,2,0,2,0,-12,1,-3,-2,5,2,0,-3,-1,-1,-1,1,3,-1
KR_6642908982,420,2,-9,20,2,4,1,5,-2,2,0,1,2,3,-1,5,4,0,2,2,0,-3,-16,-2,-2,4,3,0,1,1,1,1,1,4,-1
KR_6726371448,420,-4,-36,-4,-5,-2,4,2,4,0,4,-7,9,2,-1,1,0,1,1,2,0,-2,3,0,-4,4,-1,0,-2,-1,1,-1,1,5,-1
KR_6764443218,420,0,-54,0,6,0,1,1,-1,2,1,6,0,6,1,2,3,0,0,0,0,7,3,-3,0,3,-6,0,-1,-1,0,-1,-1,3,-1
KR_6759663375,420,1,-19,-21,2,1,0,1,3,5,8,0,3,3,-2,6,4,0,1,1,0,4,0,0,-3,3,-2,0,0,-1,0,0,-1,2,-1
KR_6755858153,420,-2,51,-28,-12,-1,2,1,-1,2,1,-7,7,0,-2,2,0,-1,5,4,0,-17,34,3,-4,1,-17,0,1,-1,-1,1,1,6,-1
KR_6759167525,420,0,4,28,2,-2,7,5,-1,3,2,4,1,5,0,0,0,1,0,1,0,1,-228,-1,-3,4,4,0,0,0,0,0,-1,0,-1
KR_6759640744,440,-5,-40,0,-8,-2,2,0,-2,4,2,1,0,1,2,0,2,-7,9,2,0,-15,1,-1,-3,4,-2,0,-1,1,1,-1,1,5,-1
KR_6751495972,420,-2,-53,-9,-1,-1,3,2,-1,3,2,1,4,5,-1,4,3,1,0,1,1,-1,3,0,-5,5,-8,0,-2,1,-1,-1,1,1,-1
KR_6750185538,420,-3,-79,-26,-7,0,0,0,1,4,5,-6,7,1,-1,9,8,-1,2,1,-3,-8,-20,3,-4,1,-4,0,-1,1,1,-1,1,2,-1
KR_6760361717,420,-1,-30,-7,-2,-5,6,1,1,2,3,-2,5,3,0,4,4,4,4,8,0,1,11,-1,-1,2,-3,0,0,1,-1,1,1,1,-1
KR_6757597035,420,-1,-38,-13,-3,0,3,3,0,4,4,-4,4,0,-2,4,2,3,1,4,-1,-4,-1,1,-6,5,-1,0,0,1,-1,-1,1,6,-1
KR_6685334623,420,1,-19,24,3,1,0,1,0,2,2,0,1,1,0,4,4,2,0,2,0,4,179,2,-5,3,-4,0,0,0,1,1,1,0,-1
KR_6727277836,440,1,77,-3,6,-1,2,1,-4,6,2,5,0,5,3,1,4,3,0,3,0,4,-13,-1,-5,6,5,0,0,-1,-1,-1,-1,4,-1
KR_6669468106,420,-7,-110,-68,-14,-1,2,1,-5,8,3,-7,7,0,-2,2,0,1,1,2,0,-7,-3,-1,-4,5,2,0,-1,-1,0,-1,1,5,-1
KR_6755832033,420,-1,-4,20,-4,0,1,1,2,1,3,-1,2,1,-2,8,6,-3,4,1,1,-3,10,2,-3,1,-4,0,-1,-1,1,-1,1,1,-1
KR_6743887976,420,-6,-36,-9,-10,-3,4,1,-2,4,2,-2,2,0,-2,4,2,-1,2,1,0,-6,-11,-2,-3,5,4,0,0,-1,-1,0,1,5,-1
KR_6722431831,420,-5,-3,4,-8,-4,4,0,-2,4,2,1,3,4,-2,4,2,-1,2,1,0,-11,-121,-4,-1,5,-1,0,0,1,1,1,1,6,-1
KR_6694413281,440,-3,-43,12,-9,-6,6,0,-2,4,2,2,0,2,1,1,2,-4,5,1,0,-14,3,-1,-1,2,1,0,0,-1,1,-1,-1,5,-1
KR_6694397355,420,2,35,25,-1,3,1,4,-7,8,1,3,1,4,1,1,2,-1,4,3,0,-5,-2,-2,-4,6,0,0,0,-1,1,1,-1,2,-1
KR_6742446366,420,2,31,-2,3,0,0,0,1,2,3,0,0,0,1,2,3,1,0,1,0,7,-5,0,-5,5,2,0,0,-1,-1,1,1,6,-1
KR_6747184614,440,-1,-52,8,2,-2,2,0,-2,3,1,1,1,2,3,2,5,2,2,4,0,-3,-6,-3,-2,5,2,0,0,-1,1,-1,-1,1,-1
KR_6751929752,420,1,55,11,-3,-6,6,0,0,2,2,1,1,2,3,2,5,-1,1,0,0,-5,-4,0,-2,2,5,0,0,-1,1,-1,1,5,-1
KR_6716086623,420,-3,-6,13,-10,0,2,2,-2,3,1,-5,7,2,-2,4,2,-1,2,1,1,2,3,1,-1,0,-1,0,0,-1,0,0,1,4,-1
KR_6754128655,420,0,-26,23,-3,5,0,5,-2,6,4,1,0,1,-9,12,3,2,0,2,1,-6,-7,-3,-1,4,4,0,0,-1,1,1,1,5,-1
KR_6718891006,420,-2,-44,-8,-3,-4,4,0,3,0,3,1,0,1,-3,3,0,0,0,0,0,1,2,5,-7,2,-4,0,-1,1,-1,-1,-1,4,-1
KR_6734831171,420,-2,-26,-11,0,-4,4,0,-3,4,1,-4,7,3,10,0,10,1,0,1,0,8,13,4,-7,3,-4,0,2,1,1,1,1,2,-1
KR_6601415244,420,-3,-34,-51,-3,1,3,4,-2,5,3,-2,3,1,1,1,2,-1,1,0,0,-3,-8,-2,-5,7,-2,0,-1,-1,1,-1,1,1,-1
KR_6762227034,420,0,-37,14,-2,-3,6,3,-1,1,0,1,0,1,-2,2,0,3,0,3,-1,1,0,-7,0,7,0,0,0,1,-1,-1,-1,4,-1
KR_6761400425,420,0,40,8,1,-1,2,1,0,2,2,-1,2,1,2,2,4,1,0,1,1,7,3,-1,-1,2,0,0,1,-1,-1,1,1,6,-1
KR_6708325143,440,-2,36,-4,-3,0,1,1,-2,5,3,-1,4,3,2,1,3,-2,2,0,0,-3,-186,-2,-3,5,3,0,0,-1,1,-1,-1,3,-1
KR_6620584626,420,-3,17,-12,-3,-2,4,2,-3,4,1,-1,4,3,1,1,2,2,0,2,0,-6,-5,0,-4,4,7,0,-1,-1,-1,-1,-1,3,-1
KR_6749091531,420,0,-37,-1,-5,-1,3,2,-1,2,1,-6,7,1,2,0,2,1,1,2,0,-5,-1,5,-5,0,-3,0,0,-1,-1,0,-1,2,-1
KR_6763992224,440,-1,65,8,-8,1,1,2,-7,8,1,-1,2,1,-2,4,2,1,1,2,0,-10,19,-1,-2,3,-23,0,0,1,1,1,-1,5,-1
KR_6744090380,420,1,-3,-8,-1,1,1,2,1,1,2,-1,2,1,-5,7,2,3,3,6,0,3,5,6,-9,3,1,0,-1,-1,1,-1,1,5,-1
KR_6399708491,420,4,79,0,13,3,1,4,0,2,2,6,2,8,3,2,5,1,0,1,0,14,0,4,-7,3,-2,0,0,1,0,1,-1,1,-1
KR_6761221374,420,0,10,4,-1,0,2,2,-1,3,2,5,0,5,-1,3,2,-4,5,1,0,11,-12,-1,-4,5,6,0,0,-1,1,-1,-1,6,-1
KR_6658334255,420,-1,36,-21,2,-6,7,1,2,0,2,0,0,0,3,2,5,3,0,3,0,9,9,3,-7,4,-5,0,0,-1,0,0,1,5,-1
KR_6759262686,420,-4,11,-1,-12,-6,7,1,-1,3,2,1,3,4,1,2,3,-7,7,0,0,-9,-1,5,-7,2,1,0,-1,-1,0,-1,1,2,-1
KR_6628852893,420,-6,-73,-20,-10,-2,2,0,1,0,1,-10,10,0,1,3,4,0,0,0,0,-2,-2,3,-5,2,-4,0,0,-1,0,0,-1,1,-1
KR_6700170551,420,-3,-94,4,-6,-7,8,1,1,3,4,-1,2,1,1,1,2,0,0,0,0,-5,-280,2,-5,3,3,0,0,0,-1,-1,-1,0,-1
KR_6649567628,420,0,-32,-21,4,-2,3,1,3,1,4,4,0,4,-1,1,0,0,2,2,0,2,-1,0,-3,3,-2,0,0,1,-1,0,1,2,-1
KR_6713374448,420,1,-2,6,-5,2,0,2,0,0,0,-2,3,1,-6,8,2,1,1,2,-1,-6,-123,3,-7,4,-1,0,0,-1,-1,0,-1,2,-1
KR_6747439972,420,-3,26,-23,1,-2,2,0,-1,1,0,1,2,3,0,2,2,3,1,4,0,-1,-6,0,-3,3,1,0,-1,1,1,-1,1,1,-1
KR_6763999643,420,-5,-105,-15,-2,-3,5,2,0,1,1,-2,4,2,4,1,5,-1,2,1,0,5,-43,3,-5,2,22,0,-1,1,1,-1,1,6,-1
KR_6629236593,420,3,58,-20,5,3,0,3,0,2,2,0,2,2,-1,2,1,3,0,3,0,7,-3,-1,-3,4,6,0,1,1,0,1,1,5,-1
KR_6756579493,420,-3,-31,-19,-4,-3,4,1,-4,7,3,-2,3,1,5,0,5,0,0,0,0,7,-3,-5,-3,8,0,0,-1,-1,-1,-1,-1,5,-1
KR_6625935711,420,0,-23,8,-3,3,1,4,0,2,2,-3,3,0,-1,5,4,-2,3,1,0,-3,6,2,-6,4,-4,0,0,-1,1,0,-1,5,-1
KR_6711997613,420,-5,-19,-21,-7,-2,3,1,-2,7,5,-5,6,1,1,4,5,1,0,1,3,2,290,-2,-3,5,0,0,-2,-1,-1,-1,-1,4,-1
KR_6719743567,440,1,-51,-24,8,-2,3,1,2,2,4,3,0,3,5,0,5,0,1,1,0,13,0,-4,-4,8,-1,0,1,1,-1,-1,-1,4,-1
KR_6645130853,420,-3,28,12,-4,-1,2,1,-4,4,0,0,0,0,1,2,3,0,1,1,1,-2,-296,0,-2,2,-1,0,0,-1,-1,0,1,5,-1
KR_6644921525,420,-4,-50,-18,-11,-3,4,1,-9,10,1,2,0,2,0,0,0,-1,1,0,1,-3,-154,2,-7,5,-1,0,0,1,-1,0,1,5,-1
KR_6762180908,420,2,-83,102,-7,-5,6,1,-3,4,1,2,3,5,-1,2,1,0,2,2,0,-3,-4,-4,-3,7,1,0,-1,1,1,-1,-1,5,-1
KR_6754025604,420,4,106,26,0,6,0,6,1,0,1,0,4,4,-1,5,4,-6,6,0,-3,-11,417,-1,-4,5,-1,0,3,1,1,1,-1,3,-1
KR_6513950599,420,-5,-89,3,-15,-2,2,0,-2,3,1,-8,8,0,-2,2,0,-1,1,0,0,-9,-42,-5,-3,8,-2,0,-1,0,1,-1,-1,0,-1
KR_6761491781,420,0,32,20,0,-1,3,2,1,1,2,1,1,2,-3,5,2,2,1,3,0,2,-2,0,-3,3,1,0,0,1,0,1,1,2,-1
KR_6722944357,420,-2,-2,20,-6,0,2,2,-2,3,1,2,5,7,-7,7,0,1,1,2,0,-12,13,5,-7,2,-6,0,-1,-1,1,-1,1,5,-1
KR_6742776293,420,-5,-12,-4,-6,-3,5,2,-4,4,0,2,1,3,0,2,2,-1,1,0,0,-3,-9,-1,-3,4,-2,0,0,1,-1,0,-1,4,-1
KR_6750315744,440,0,-72,-12,-1,-3,3,0,2,2,4,-1,3,2,-3,7,4,4,0,4,0,2,0,0,-3,3,2,0,0,1,1,-1,1,6,-1
KR_6758580943,440,0,-41,-15,2,0,3,3,4,1,5,0,0,0,-2,3,1,0,3,3,0,0,7,-5,-2,7,3,0,0,1,-1,0,-1,4,-1
KR_6617443525,420,-4,-13,-17,-5,3,1,4,-3,4,1,0,4,4,-5,6,1,0,1,1,1,-8,13,6,-7,1,0,0,0,-1,0,-1,1,3,-1
KR_6678710718,420,-5,-96,-36,-11,-1,2,1,0,4,4,1,2,3,-7,8,1,-4,4,0,-1,-17,-3,1,-7,6,-4,0,-2,-1,-1,-1,-1,1,-1
KR_6757155449,420,-4,-82,-4,-8,-4,5,1,-5,6,1,0,2,2,1,2,3,0,0,0,-1,-6,-6,-2,-3,5,1,0,-2,1,-1,-1,-1,2,-1
KR_6703589779,420,-3,28,-31,-4,-1,1,0,-1,3,2,-2,5,3,0,1,1,0,1,1,0,-7,-4,0,-5,5,-4,0,-1,-1,-1,-1,-1,2,-1
KR_6728083072,420,-3,-6,-47,-9,1,1,2,-9,9,0,-4,5,1,1,2,3,2,0,2,0,-4,0,2,-4,2,-2,0,-1,0,-1,-1,-1,0,-1
KR_6746910438,420,-4,-70,-8,-8,-1,2,1,1,2,3,-7,8,1,-1,3,2,0,1,1,0,0,-4,-1,-2,3,-1,0,1,1,-1,1,-1,6,-1
KR_6399521923,420,-4,-74,-30,-5,0,0,0,-4,9,5,-2,3,1,1,1,2,0,0,0,1,6,8,0,-6,6,3,0,-2,1,-1,-1,1,5,-1
KR_6706457152,420,-2,-82,6,-10,-1,2,1,-3,5,2,0,0,0,-6,6,0,0,0,0,0,-8,2,2,-6,4,-3,0,-1,-1,-1,-1,-1,3,-1
KR_6753395106,420,-7,-142,-17,-12,-4,6,2,-3,6,3,-3,5,2,0,1,1,-2,3,1,0,-4,8,1,-8,7,-7,0,-1,0,-1,-1,-1,0,-1
KR_6763085213,440,-5,-105,-20,-11,-2,4,2,-3,6,3,-5,5,0,5,1,6,-6,8,2,-2,-4,25,-1,-2,3,-1,0,-3,-1,-1,-1,-1,1,-1
KR_6723269367,420,-2,29,-44,-4,0,0,0,-3,5,2,2,0,2,-1,5,4,-2,2,0,1,0,-123,4,-7,3,-5,0,1,1,1,1,1,2,-1
KR_6724943059,420,-3,0,-34,-8,-2,4,2,-3,4,1,-3,5,2,-1,4,3,1,0,1,0,-3,22,0,-1,1,0,0,0,-1,-1,-1,1,5,-1
KR_6761524613,420,-2,-14,-44,-8,0,0,0,1,0,1,-4,5,1,-7,8,1,2,0,2,-1,-8,49,-1,-4,5,-4,0,0,-1,0,0,-1,1,-1
KR_6759122582,420,-1,50,4,-4,0,1,1,-5,5,0,2,2,4,0,4,4,-1,2,1,0,-1,4,-2,-1,3,3,0,0,0,0,0,1,0,-1
KR_6661212655,420,-2,-46,-28,-6,0,1,1,-1,2,1,1,3,4,-3,5,2,-3,3,0,0,-4,2,-6,-5,11,7,0,-1,-1,-1,-1,-1,3,-1
KR_6651008949,420,1,-5,36,0,0,1,1,-2,3,1,3,1,4,1,4,5,-2,3,1,0,2,0,2,-5,3,-4,0,0,-1,1,0,-1,4,-1
KR_6757404806,420,-2,-65,20,-7,0,2,2,-7,9,2,3,2,5,-2,3,1,-1,2,1,-1,-15,0,-4,-2,6,-2,0,1,1,1,1,-1,6,-1
KR_6603777241,420,2,6,-24,1,1,4,5,0,3,3,1,0,1,-3,4,1,2,1,3,0,7,56,-3,-2,5,-2,0,0,-1,1,1,1,5,-1
KR_6761377363,420,0,41,23,-7,-3,4,1,-4,5,1,-1,1,0,0,1,1,1,0,1,0,-2,3,0,-1,1,1,0,-1,-1,-1,-1,-1,5,-1
KR_6694753412,420,1,72,-8,-1,2,0,2,0,3,3,-5,6,1,4,2,6,-2,2,0,1,-4,-15,0,-3,3,2,0,2,1,1,1,1,6,-1
KR_6759510273,420,-1,-29,-12,-3,-3,3,0,0,1,1,0,6,6,-2,4,2,2,1,3,0,-8,35,2,-8,6,-4,0,-1,1,-1,-1,1,3,-1
KR_6661012494,420,-2,-70,20,-9,-1,1,0,-2,4,2,-4,4,0,-1,2,1,-1,2,1,0,-10,-2,1,-6,5,5,0,0,-1,1,0,-1,1,-1
KR_6759030596,420,-2,-93,-12,-4,1,1,2,5,0,5,-2,5,3,-3,3,0,-5,6,1,0,-2,5,-2,-5,7,0,0,0,0,1,-1,1,0,-1
KR_6733956398,420,1,74,-1,2,-1,4,3,-3,5,2,0,3,3,4,2,6,2,1,3,1,7,-9,-5,-5,10,6,0,1,1,-1,1,1,4,-1
KR_6749146124,420,-3,-47,-24,1,-5,7,2,-1,4,3,4,0,4,2,1,3,1,3,4,0,2,2,0,-1,1,-4,0,-1,-1,-1,-1,-1,1,-1
KR_6734988493,420,-2,-76,-21,-2,2,1,3,-2,2,0,3,2,5,-4,4,0,-1,2,1,-1,-9,-2,3,-6,3,-1,0,-1,0,0,-1,-1,0,-1
KR_6652378587,420,-1,-113,4,-8,-2,4,2,-2,4,2,3,3,6,-6,6,0,-1,1,0,0,-1,-1,-1,-1,2,1,0,-2,-1,-1,-1,1,5,-1
KR_6748494440,420,-2,-54,20,-8,-2,3,1,-5,8,3,-1,4,3,1,2,3,-1,2,1,0,-5,-3,0,-2,2,-2,0,0,1,1,0,-1,1,-1
KR_6603693402,420,-2,8,-24,-6,-1,1,0,-2,4,2,-1,2,1,-2,2,0,0,0,0,-1,-7,65,0,-5,5,-6,0,0,-1,-1,0,-1,4,-1
KR_6737604652,420,0,-21,16,6,6,1,7,-2,4,2,0,2,2,1,2,3,1,2,3,1,3,-15,-2,-2,4,-3,0,0,1,0,0,1,1,-1
KR_6729005177,420,1,30,-28,2,7,0,7,-3,5,2,2,2,4,-3,4,1,-1,1,0,1,-10,-7,1,-5,4,13,0,0,-1,1,0,1,4,-1
KR_6760646948,420,-2,16,-4,-8,-4,4,0,1,0,1,-2,4,2,-4,6,2,1,2,3,0,-2,46,8,-9,1,-22,0,-1,1,-1,-1,1,1,-1
KR_6759703265,420,0,11,-20,0,-3,4,1,3,1,4,1,3,4,-1,5,4,0,0,0,0,3,23,-1,-3,4,-17,0,0,-1,1,0,1,6,-1
KR_6730852911,420,-3,-56,-28,-2,0,2,2,2,1,3,-3,5,2,-2,2,0,1,0,1,0,-4,-1,3,-5,2,-5,0,0,1,1,0,-1,1,-1
KR_6693345797,420,-4,-47,-25,-5,2,1,3,-6,7,1,2,0,2,1,1,2,-4,4,0,1,-2,61,-3,-2,5,2,0,-1,-1,-1,-1,1,5,-1
KR_6723816978,420,-2,-66,-14,-6,-4,4,0,0,4,4,0,1,1,-2,7,5,0,1,1,-1,-7,4,6,-11,5,-5,0,-1,-1,-1,-1,-1,4,-1
KR_6603740871,420,-4,-30,-15,-8,0,1,1,-4,7,3,1,2,3,-5,5,0,0,1,1,-1,-15,-9,0,-2,2,-4,0,0,-1,1,-1,-1,5,-1
KR_6655919510,420,0,-22,-14,1,-3,3,0,-8,12,4,7,0,7,-2,3,1,7,0,7,0,6,-3,0,-5,5,-2,0,-1,1,-1,-1,1,3,-1
KR_6761596465,420,0,-77,16,-1,3,0,3,1,1,2,-2,4,2,-5,7,2,2,1,3,0,1,-1,1,-3,2,-2,0,-2,-1,1,-1,1,3,-1
KR_6743414448,420,-3,-18,-30,-1,-3,4,1,-2,4,2,6,1,7,-2,3,1,0,3,3,-1,-1,-5,-1,-2,3,3,0,-2,1,1,-1,-1,6,-1
KR_6754684236,420,-4,-9,-13,-5,-1,3,2,1,0,1,-5,5,0,1,1,2,-1,1,0,0,-2,16,0,-3,3,3,0,0,0,-1,0,-1,0,-1
KR_6723183453,420,-4,-13,-41,-6,2,1,3,-7,9,2,-3,5,2,1,2,3,1,2,3,0,-15,-6,-5,-3,8,0,0,-2,-1,1,-1,1,1,-1
KR_6763569182,420,-1,-69,-5,2,3,0,3,-2,2,0,2,1,3,2,2,4,-3,5,2,0,0,41,3,-6,3,-14,0,0,1,1,0,1,6,-1
KR_6757748685,420,-2,-9,-17,-6,-2,5,3,-2,6,4,1,1,2,-3,3,0,0,2,2,0,-4,-7,-6,-3,9,-1,0,-1,1,-1,-1,-1,2,-1
KR_6737643627,420,1,-28,0,5,0,2,2,1,4,5,1,1,2,5,0,5,-2,3,1,0,5,-3,3,-6,3,1,0,1,1,1,1,1,1,-1
KR_6213120675,420,-1,-14,0,-7,1,0,1,1,1,2,-1,4,3,-5,5,0,-3,3,0,0,-10,-3,-2,-1,3,0,0,-2,-1,-1,-1,1,4,-1
KR_6497677444,420,-1,-28,8,2,-1,2,1,0,1,1,2,2,4,-4,4,0,5,0,5,0,3,27,-4,-3,7,-1,0,-1,1,-1,-1,1,2,-1
KR_6731970925,420,-9,-113,-72,7,-3,3,0,-2,4,2,0,2,2,11,0,11,1,0,1,0,11,-9,-3,-1,4,2,0,-2,-1,-1,-1,-1,1,-1
KR_6672965837,420,-3,-22,-20,-2,-1,1,0,2,2,4,-1,3,2,-1,2,1,-1,2,1,0,-6,-13,-2,-4,6,0,0,-1,-1,-1,-1,1,4,-1
KR_6647438603,420,-7,-98,-24,-8,-6,7,1,-1,4,3,-2,4,2,2,0,2,-1,2,1,0,0,7,5,-8,3,-7,0,-2,-1,1,-1,-1,4,-1
KR_6678467904,440,3,-4,8,6,0,0,0,-2,2,0,1,2,3,3,0,3,4,2,6,0,14,-13,1,-2,1,-3,0,-1,-1,-1,-1,-1,5,-1
KR_6745847961,420,-1,-27,8,-3,0,1,1,1,2,3,-3,4,1,-1,3,2,0,2,2,0,-2,3,4,-7,3,-2,0,0,1,1,0,1,5,-1
KR_6759727393,440,-1,-24,-3,-3,-1,6,5,3,1,4,-4,5,1,1,2,3,-2,2,0,-1,-2,-270,-1,-2,3,0,0,-4,-1,-1,-1,-1,6,-1
KR_6753176079,420,1,-29,-3,0,-5,5,0,3,1,4,2,1,3,-2,6,4,2,0,2,0,5,21,-5,-4,9,-5,0,0,-1,1,-1,-1,2,-1
KR_6291839774,440,2,27,12,-2,0,0,0,-1,6,5,-1,2,1,-2,3,1,2,1,3,-1,-7,-4,-3,-3,6,6,0,-1,0,0,-1,-1,0,-1
KR_6724618496,440,0,-14,-12,2,6,0,6,-4,4,0,-3,4,1,2,0,2,1,1,2,0,-1,6,2,-6,4,-2,0,0,0,0,0,1,0,-1
KR_6756725045,420,-3,-59,-4,-4,3,0,3,-3,3,0,-8,9,1,3,2,5,1,1,2,1,-1,0,-3,-3,6,-3,0,-1,1,-1,-1,1,1,-1
KR_6746035939,420,-1,-49,-20,1,-1,4,3,-1,3,2,4,1,5,2,1,3,-3,4,1,-1,1,15,0,-3,3,-6,0,0,-1,-1,-1,-1,1,-1
KR_6679881038,420,-1,-54,-20,-2,-1,1,0,2,4,6,-1,4,3,-2,3,1,0,0,0,0,0,24,-4,-3,7,3,0,-1,-1,-1,-1,-1,4,-1
KR_6672574880,420,0,-36,10,1,-1,3,2,2,0,2,-2,6,4,2,2,4,0,1,1,0,1,6,-2,-3,5,-1,0,0,-1,1,0,1,2,-1
KR_6727201311,420,2,55,4,0,1,2,3,-3,4,1,-3,3,0,4,1,5,1,0,1,1,2,-196,3,-8,5,-2,0,0,1,-1,-1,1,1,-1
KR_6734454315,420,-6,-64,-3,-16,-2,2,0,-5,6,1,0,1,1,-7,7,0,-2,3,1,0,-17,0,-2,-4,6,-3,0,-2,0,0,-1,-1,0,-1
KR_6763427558,420,-6,0,-21,-10,1,2,3,2,1,3,0,3,3,-10,10,0,-3,3,0,-1,-9,-20,-2,-3,5,-1,0,-3,-1,-1,-1,-1,5,-1
KR_6646345395,420,-3,6,-24,-7,0,1,1,-1,4,3,-2,2,0,-2,4,2,-2,2,0,0,-9,-124,1,-2,1,-2,0,0,-1,-1,0,-1,2,-1
KR_6734817864,420,0,-78,28,-4,1,0,1,-3,8,5,-1,3,2,0,1,1,-1,1,0,0,-6,-44,-2,-3,5,-1,0,-1,1,-1,-1,-1,6,-1
KR_6708502617,420,1,17,8,-4,0,1,1,0,3,3,0,3,3,-5,7,2,1,0,1,0,-6,-6,0,-5,5,1,0,-1,0,0,-1,1,0,-1
KR_6496786685,440,0,-35,8,2,4,2,6,-2,3,1,-4,4,0,3,1,4,1,3,4,1,5,38,-4,-3,7,-22,0,-1,-1,0,-1,1,3,-1
KR_6743745436,420,-1,-56,-3,-6,6,1,7,-2,3,1,-4,4,0,-6,7,1,0,0,0,1,-12,-49,1,-8,7,18,0,-1,-1,1,-1,1,3,-1
KR_6750009295,420,0,-7,40,-1,-2,2,0,3,1,4,-5,5,0,3,1,4,0,0,0,0,7,3,1,-6,5,2,0,0,-1,-1,0,1,4,-1
KR_6739138247,420,0,5,-27,-1,-3,3,0,4,0,4,-2,3,1,2,0,2,-2,3,1,0,3,6,1,-2,1,0,0,0,-1,-1,0,-1,5,-1
KR_6728133589,420,-4,-40,-20,-7,-4,5,1,4,1,5,2,2,4,-8,8,0,-1,1,0,0,-7,-1,-1,-2,3,2,0,0,0,-1,0,-1,0,-1
KR_6649828078,420,-2,-48,-41,-6,-7,7,0,2,1,3,-1,3,2,1,2,3,-1,2,1,0,-4,12,7,-11,4,-5,0,-2,1,-1,-1,-1,4,-1
KR_6759835771,440,-1,45,-20,-10,0,2,2,2,0,2,-1,1,0,-6,6,0,-5,5,0,-1,-11,-161,-1,-5,6,-1,0,0,-1,-1,0,-1,5,-1
KR_6764084625,420,-4,-8,25,2,-4,4,0,-1,6,5,0,2,2,6,0,6,1,0,1,0,6,4,7,-8,1,-5,0,-1,-1,0,-1,1,6,-1
KR_6752177872,420,0,-19,0,-2,1,0,1,-2,3,1,4,0,4,-4,4,0,-1,2,1,0,-3,14,2,-4,2,0,0,0,-1,1,-1,-1,4,-1
KR_6741313257,420,-7,-16,0,-11,-6,8,2,-2,2,0,1,2,3,-4,6,2,0,2,2,0,-10,220,-3,-2,5,-4,0,-1,-1,-1,-1,-1,4,-1
KR_6763879930,420,-2,-13,-19,1,-1,1,0,-3,4,1,3,1,4,-1,6,5,3,1,4,0,8,0,2,-5,3,2,0,-2,1,-1,-1,1,4,-1
KR_6698746826,420,-2,34,-4,-3,1,0,1,-1,3,2,3,0,3,-5,6,1,-1,1,0,0,-9,6,-1,-4,5,-3,0,0,-1,-1,0,-1,4,-1
KR_6716060556,420,2,-25,-12,3,1,1,2,2,1,3,2,2,4,0,4,4,-2,2,0,-3,-11,6,1,-5,4,-2,0,-1,-1,1,-1,-1,1,-1
KR_6747570309,420,0,-19,48,0,-1,1,0,-1,2,1,2,0,2,-1,5,4,1,0,1,0,0,9,0,-5,5,-2,0,2,0,1,1,1,0,-1
KR_6724597321,420,4,-20,40,1,3,0,3,-2,6,4,2,1,3,-3,6,3,1,1,2,0,0,-3,-3,-3,6,2,0,2,-1,1,1,-1,2,-1
KR_6589648231,420,-3,-68,8,-7,7,1,8,-5,7,2,-5,5,0,-4,4,0,0,0,0,0,-9,-16,-3,-3,6,-5,0,-2,1,-1,-1,-1,6,-1
KR_6655937826,420,0,-37,8,5,1,2,3,1,2,3,1,2,3,1,1,2,1,0,1,1,7,63,-2,-3,5,-1,0,0,1,1,0,1,5,-1
KR_6758350556,420,1,16,-30,2,0,4,4,2,1,3,3,1,4,-2,3,1,-1,3,2,0,7,-20,0,-2,2,1,0,1,0,0,1,-1,0,-1
KR_6703556930,420,-6,-90,-16,-8,1,1,2,-10,13,3,-1,3,2,2,4,6,0,2,2,4,-3,2,-2,-4,6,-8,0,-1,-1,0,-1,-1,5,-1
KR_6706908075,420,1,-7,0,-5,-1,1,0,1,0,1,-5,5,0,0,2,2,0,0,0,0,-3,100,-4,-2,6,1,0,0,-1,-1,0,-1,4,-1
KR_6753526178,420,3,22,76,-2,1,2,3,3,0,3,-5,6,1,1,0,1,-2,2,0,-1,-8,49,0,-5,5,-18,0,-1,1,1,-1,-1,2,-1
KR_6649884014,420,-3,49,-28,0,-2,2,0,2,0,2,4,3,7,-3,4,1,-1,1,0,0,1,4,-2,-3,5,3,0,0,0,1,1,1,0,-1
KR_6697012202,440,-2,-38,5,-9,-3,9,6,1,2,3,-6,6,0,-3,8,5,2,1,3,0,-9,15,-2,0,2,1,0,0,-1,1,-1,-1,1,-1
KR_6757529226,420,3,51,32,0,-4,4,0,-2,3,1,0,4,4,1,1,2,5,0,5,1,4,1,-1,-2,3,-1,0,1,-1,1,1,1,1,-1
KR_6212371337,440,2,44,-9,6,-3,3,0,1,1,2,0,6,6,0,2,2,8,0,8,0,-2,-3,4,-8,4,2,0,2,-1,1,1,1,5,-1
KR_6696919635,420,-5,-39,2,-11,-5,6,1,-7,8,1,0,2,2,-1,6,5,2,0,2,0,-15,-292,2,-3,1,-3,0,-3,1,-1,-1,-1,3,-1
KR_6721183745,420,-3,-4,5,-6,-1,1,0,-5,5,0,-2,2,0,-1,1,0,3,0,3,0,-5,7,2,-7,5,0,0,-1,1,0,-1,-1,5,-1
KR_6705126548,420,-2,-45,-4,-4,-2,3,1,-1,7,6,-2,2,0,1,2,3,0,2,2,0,-11,-25,-1,-3,4,0,0,-1,1,-1,-1,1,4,-1
KR_6754371726,420,-1,16,16,-6,-4,5,1,-1,1,0,1,3,4,1,3,4,-3,3,0,0,-6,-35,-6,0,6,1,0,0,1,-1,0,-1,3,-1
KR_6589554486,420,2,21,-5,3,0,1,1,2,1,3,-3,4,1,3,1,4,1,0,1,0,6,-12,-5,-3,8,7,0,0,-1,0,0,1,1,-1
KR_6733771048,420,1,12,-16,3,1,2,3,3,3,6,-2,2,0,1,5,6,0,0,0,-1,6,-14,0,-4,4,2,0,0,0,1,1,-1,0,-1
KR_6760390014,420,0,-15,-16,0,-4,6,2,1,4,5,3,2,5,1,4,5,-1,2,1,0,-1,-4,-4,-2,6,1,0,0,-1,-1,0,-1,6,-1
KR_6757465348,420,1,49,8,7,0,2,2,5,0,5,-2,4,2,4,2,6,0,0,0,0,21,252,1,-3,2,17,0,0,-1,-1,-1,-1,4,-1
KR_6644864439,420,-3,-22,-22,-3,3,2,5,-1,3,2,-5,6,1,0,1,1,0,0,0,0,-2,-277,-1,-4,5,4,0,-2,-1,-1,-1,1,1,-1
KR_6721718122,420,2,-16,-4,-2,1,0,1,1,1,2,1,2,3,-4,5,1,-1,2,1,0,-1,-13,-3,-2,5,-1,0,1,-1,1,1,-1,2,-1
KR_6759405397,420,-6,-83,-12,-16,-1,5,4,-6,6,0,-4,4,0,-5,5,0,0,2,2,-1,-11,-4,2,-4,2,0,0,-1,-1,-1,-1,-1,5,-1
KR_6759519932,420,3,40,-15,2,0,0,0,0,1,1,4,1,5,-2,3,1,0,0,0,-2,-5,-7,1,-3,2,2,0,1,0,1,1,-1,0,-1
KR_6618131016,420,-2,-29,-2,-4,0,1,1,-3,3,0,0,3,3,1,2,3,-2,2,0,0,-2,-10,0,-4,4,2,0,0,-1,-1,-1,1,4,-1
KR_6630709998,420,0,-11,-37,0,-3,5,2,-2,3,1,6,0,6,1,3,4,-2,2,0,0,-4,-2,0,-4,4,1,0,-1,-1,-1,-1,-1,3,-1
KR_6724806459,440,-3,-52,0,-18,-6,6,0,-6,8,2,1,2,3,-8,10,2,1,0,1,0,-14,0,-1,-2,3,0,0,-2,1,-1,-1,-1,1,-1
KR_6597285351,420,1,-45,12,-1,0,1,1,0,2,2,1,1,2,-1,2,1,-1,1,0,1,5,1,2,-7,5,-7,0,0,1,-1,1,1,3,-1
KR_6752826271,440,0,-42,2,4,2,2,4,1,2,3,0,2,2,1,3,4,0,1,1,0,13,0,0,-3,3,-3,0,-1,-1,-1,-1,-1,3,-1
KR_6550981173,420,-4,-117,-11,-5,1,1,2,1,2,3,-1,4,3,-2,2,0,-4,4,0,0,0,-4,-1,-2,3,-3,0,-1,-1,-1,-1,-1,6,-1
KR_6620563803,420,0,-21,24,1,0,1,1,-3,3,0,0,1,1,3,2,5,1,0,1,0,-1,-221,1,-8,7,3,0,0,1,0,0,1,3,-1
KR_6617420658,420,-2,-49,0,-3,-2,3,1,-3,7,4,-1,2,1,2,1,3,1,0,1,0,1,8,0,-3,3,0,0,-1,1,1,-1,-1,4,-1
KR_6762114589,420,-1,-1,12,1,0,3,3,3,2,5,-2,2,0,-1,6,5,1,0,1,0,5,-2,-1,-3,4,2,0,1,-1,1,-1,1,1,-1
KR_6755520303,420,-1,13,-27,-7,-4,4,0,0,3,3,-5,9,4,3,0,3,-1,2,1,0,-7,43,1,-3,2,0,0,0,1,-1,1,-1,3,-1
KR_6730933907,420,-2,6,13,-2,-4,4,0,1,3,4,-1,4,3,2,0,2,0,0,0,0,2,7,-3,-5,8,2,0,-1,1,-1,-1,-1,4,-1
KR_6679297538,420,-2,-1,14,-5,-2,5,3,-1,5,4,0,2,2,-1,2,1,-1,2,1,0,-2,0,-6,-4,10,1,0,0,-1,1,-1,-1,3,-1
KR_6701475240,440,-3,-28,15,-3,-1,3,2,0,1,1,-3,5,2,1,2,3,0,1,1,0,-7,0,-1,-3,4,-4,0,0,1,0,-1,1,6,-1
KR_6674692443,420,0,-30,-8,-1,-3,4,1,-2,3,1,1,1,2,4,3,7,-1,1,0,0,-1,4,1,-5,4,0,0,1,-1,1,1,1,6,-1
KR_6758289514,420,2,37,0,9,2,0,2,2,0,2,1,1,2,4,2,6,0,1,1,0,5,2,3,-7,4,4,0,1,0,1,1,1,0,-1
KR_6747568479,420,-2,-25,16,-12,-4,4,0,-2,3,1,1,0,1,-8,8,0,1,3,4,-2,-16,14,-6,-1,7,-2,0,-1,1,-1,-1,-1,2,-1
KR_6761625983,420,1,84,-5,4,5,0,5,1,1,2,4,4,8,-3,5,2,-3,4,1,1,1,-135,0,-3,3,0,0,3,1,1,1,1,1,-1
KR_6733604166,420,-1,20,-24,-4,3,0,3,-4,4,0,1,1,2,-2,3,1,-2,2,0,0,-4,-115,0,-3,3,-5,0,0,-1,1,-1,-1,6,-1
KR_6764127489,420,-1,-92,-4,-8,-1,4,3,0,2,2,3,2,5,-8,8,0,-2,2,0,0,-10,-7,-2,-6,8,-2,0,-1,-1,-1,-1,-1,2,-1
KR_6757126803,420,-5,-108,-15,-13,-5,5,0,3,2,5,-2,2,0,-7,7,0,-2,3,1,0,-2,-33,3,-7,4,0,0,-1,1,1,-1,-1,5,-1
KR_6715331790,420,0,-10,-12,6,1,2,3,-3,4,1,3,1,4,2,2,4,3,0,3,0,7,-31,2,-5,3,20,0,1,1,-1,-1,1,5,-1
KR_6752462700,420,-7,-58,-15,-15,-6,7,1,-4,5,1,-1,1,0,-2,3,1,-2,4,2,0,-10,-6,-2,-2,4,3,0,0,-1,1,-1,-1,4,-1
KR_6756586654,420,4,1,44,2,-3,7,4,2,0,2,4,1,5,-2,9,7,1,0,1,-1,4,-3,-6,-3,9,6,0,1,1,-1,1,-1,6,-1
KR_6654524369,420,-7,-103,-28,-17,-4,4,0,-3,7,4,-2,2,0,-5,6,1,-3,3,0,0,-18,-27,-1,-2,3,4,0,-2,-1,-1,-1,1,4,-1
KR_6760736996,420,-2,-52,-1,0,2,0,2,-2,4,2,1,2,3,0,2,2,-1,3,2,1,-4,17,0,-3,3,-6,0,0,0,-1,0,1,0,-1
KR_6618085064,420,-1,18,-1,-4,4,0,4,-6,7,1,-3,3,0,2,4,6,-1,1,0,0,-4,25,1,-4,3,-2,0,-1,-1,1,1,1,2,-1
KR_6751056483,440,1,-65,-24,5,-1,1,0,1,0,1,0,2,2,2,0,2,3,0,3,1,4,79,3,-7,4,-5,0,0,1,0,0,1,1,-1
KR_6723763015,420,0,-36,19,-3,-3,3,0,0,2,2,0,4,4,0,3,3,0,0,0,0,-1,-7,-4,-2,6,0,0,0,0,-1,0,-1,0,-1
KR_6700094473,420,0,-41,-18,2,-4,4,0,1,5,6,9,1,10,0,0,0,-4,4,0,0,1,3,-3,-2,5,1,0,-1,1,-1,-1,-1,4,-1
KR_6759179762,420,4,86,-10,2,4,0,4,-2,4,2,4,1,5,-3,3,0,-1,2,1,0,3,-13,4,-8,4,5,0,2,-1,1,1,-1,6,-1
KR_6582241128,420,-1,-77,3,-6,-3,3,0,0,4,4,-4,5,1,5,1,6,-4,4,0,0,-4,0,-2,-3,5,1,0,-2,-1,-1,-1,-1,4,-1
KR_6761190507,420,-2,-47,9,-5,-4,5,1,0,2,2,-8,9,1,2,2,4,5,0,5,-3,-17,-2,0,-5,5,0,0,-1,-1,-1,-1,-1,2,-1
KR_6675926116,440,-1,-46,-12,-1,4,1,5,1,3,4,1,2,3,-3,4,1,-4,4,0,0,-10,-3,3,-6,3,-3,0,-2,1,-1,-1,-1,3,-1
KR_6728595014,440,-1,-80,-12,-1,2,4,6,0,3,3,2,1,3,-1,1,0,-4,4,0,0,8,-24,1,-4,3,3,0,-2,1,-1,-1,-1,5,-1
KR_6644884677,420,0,11,4,2,0,2,2,-1,4,3,6,0,6,-2,3,1,-1,1,0,0,-2,-9,-3,-2,5,-3,0,-1,-1,1,-1,1,3,-1
KR_6737374868,420,-5,46,-56,-4,-1,3,2,-2,2,0,1,2,3,-3,4,1,1,0,1,0,-8,-260,1,-2,1,-5,0,0,-1,-1,1,-1,6,-1
KR_6742362010,420,-4,-56,20,-10,0,2,2,-5,5,0,-2,2,0,-2,3,1,-1,2,1,0,-14,-538,-4,-1,5,2,0,0,-1,1,0,-1,6,-1
KR_6760240270,420,3,17,4,8,-2,3,1,2,1,3,2,3,5,2,4,6,4,2,6,0,5,236,4,-8,4,1,0,0,1,-1,-1,1,5,-1
KR_6729249846,420,0,45,12,1,1,0,1,1,3,4,-2,2,0,3,0,3,-2,5,3,0,8,2,4,-6,2,0,0,0,1,1,-1,-1,6,-1
KR_6748529438,420,-2,24,20,-9,1,2,3,0,4,4,-5,5,0,-3,3,0,-2,4,2,1,-2,0,3,-4,1,0,0,1,-1,0,1,1,4,-1
KR_6691771415,420,-4,-41,-20,-6,-7,9,2,-5,5,0,3,1,4,3,1,4,0,3,3,-1,-3,-8,-2,-1,3,6,0,-1,-1,-1,-1,-1,1,-1
KR_6706508354,420,-1,-15,-10,-4,-1,3,2,-5,7,2,1,0,1,-1,1,0,2,2,4,0,-9,-179,-3,0,3,-2,0,-1,-1,-1,-1,-1,6,-1
KR_6763919952,420,0,1,0,3,-2,3,1,0,2,2,3,1,4,2,3,5,0,1,1,0,2,0,4,-7,3,-2,0,1,1,-1,1,1,1,-1
KR_6741563954,420,-3,6,-48,-6,-1,3,2,-2,3,1,1,1,2,1,3,4,-5,6,1,-1,-11,-2,-1,0,1,2,0,-2,-1,-1,-1,1,4,-1
KR_6695752212,420,-4,-62,-27,-9,-1,2,1,2,1,3,-5,6,1,-6,7,1,1,1,2,0,-8,-15,-6,0,6,1,0,-2,-1,1,-1,1,6,-1
KR_6649638564,420,1,31,-8,1,0,0,0,-2,2,0,2,2,4,0,0,0,1,0,1,0,-3,6,3,-5,2,0,0,0,-1,1,0,1,4,-1
KR_6730910616,420,-1,11,-16,-2,-2,4,2,3,3,6,-3,7,4,-1,3,2,1,1,2,0,-7,-5,-2,-4,6,0,0,-1,-1,1,-1,-1,3,-1
KR_6760789303,420,-4,-22,36,-6,-1,3,2,-4,6,2,-2,5,3,2,2,4,-1,1,0,0,-9,-94,-1,-5,6,-1,0,0,1,-1,0,-1,4,-1
KR_6530468229,420,-1,-45,3,-2,1,2,3,-1,4,3,-2,4,2,-1,2,1,1,1,2,0,-5,-3,-2,-3,5,1,0,0,1,-1,-1,-1,4,-1
KR_6748968059,440,-2,-45,-20,5,-3,7,4,2,2,4,2,0,2,-1,4,3,5,2,7,-3,-11,2,3,-9,6,6,0,0,-1,1,-1,-1,3,-1
KR_6738498280,440,1,58,8,2,0,4,4,6,2,8,-2,3,1,-2,5,3,0,1,1,0,5,40,3,-4,1,-8,0,1,0,-1,1,-1,0,-1
KR_6681108225,420,-1,10,0,-2,1,1,2,-2,3,1,6,0,6,-6,6,0,-1,2,1,0,-3,-5,-6,-3,9,-2,0,-1,-1,1,-1,-1,1,-1
KR_6711080872,420,0,-48,24,7,-2,3,1,6,0,6,0,1,1,5,1,6,-2,3,1,0,19,0,0,-3,3,0,0,1,0,1,1,1,0,-1
KR_6753289026,420,-4,9,-12,-12,-3,3,0,0,2,2,-5,6,1,-2,5,3,-2,2,0,0,-6,-8,3,-8,5,0,0,-1,-1,-1,-1,1,4,-1
KR_6670481911,420,0,-18,-20,-3,0,1,1,-4,4,0,3,1,4,-2,3,1,0,0,0,0,-5,278,-3,-2,5,2,0,0,-1,1,0,-1,1,-1
KR_6715990894,420,0,9,-2,-4,0,2,2,-3,6,3,-1,4,3,-1,2,1,1,0,1,0,-6,19,4,-6,2,-2,0,1,-1,1,1,1,3,-1
KR_6759584891,420,-4,-70,-12,-11,-1,3,2,0,2,2,-3,4,1,-7,8,1,0,1,1,-2,-15,44,-2,-1,3,-14,0,-1,-1,-1,-1,-1,3,-1
KR_6616613800,420,-5,-74,-4,-12,-6,6,0,-7,8,1,2,3,5,-2,5,3,1,1,2,0,-11,3,-3,-1,4,-1,0,-1,-1,-1,-1,1,3,-1
KR_6698987058,420,2,13,-9,4,5,0,5,-2,4,2,5,2,7,-3,3,0,-1,1,0,1,-4,-8,4,-8,4,0,0,2,1,1,1,1,4,-1
KR_6743764778,420,4,16,19,1,0,2,2,2,3,5,6,0,6,-7,8,1,0,0,0,0,-7,-42,3,-7,4,15,0,1,-1,1,1,1,6,-1
KR_6758181604,420,0,-33,-16,3,-1,1,0,0,2,2,7,1,8,-2,4,2,-1,1,0,0,0,-11,-2,-3,5,4,0,-1,-1,0,-1,1,2,-1
KR_6688906499,420,-2,0,-7,-3,1,0,1,2,1,3,-2,3,1,-2,4,2,-2,4,2,0,-1,-1,0,-6,6,1,0,-1,-1,-1,-1,-1,2,-1
KR_6743293252,440,-3,2,-24,-6,-1,2,1,-2,6,4,0,5,5,-1,4,3,-2,3,1,1,-6,3,0,-2,2,1,0,0,-1,0,0,1,4,-1
KR_6748924006,420,-2,-21,7,-5,-3,4,1,0,1,1,-1,4,3,-1,3,2,0,0,0,0,-3,2,5,-8,3,3,0,-2,-1,-1,-1,-1,4,-1
KR_6744495485,420,-1,-32,-1,-2,1,0,1,0,2,2,-1,1,0,-3,3,0,1,0,1,0,-2,-14,-5,0,5,3,0,1,-1,1,1,1,1,-1
KR_6760966704,420,1,-8,-4,-1,-1,2,1,4,0,4,-4,5,1,-2,3,1,2,0,2,0,2,-8,-2,-3,5,0,0,0,-1,0,0,1,1,-1
KR_6754461003,420,-3,-68,-19,-3,-3,3,0,1,2,3,4,2,6,-5,5,0,0,0,0,0,-1,-8,0,-3,3,3,0,-1,0,0,-1,1,0,-1
KR_6608393284,420,1,35,23,-1,-2,3,1,3,1,4,2,2,4,-3,4,1,-1,2,1,0,-6,-1,-1,-6,7,-1,0,2,-1,1,1,1,3,-1
KR_6627412158,420,-3,10,24,-8,-1,1,0,-4,6,2,0,2,2,-2,4,2,-1,1,0,1,-9,-14,-1,-7,8,-4,0,1,-1,1,-1,1,4,-1
KR_6762956669,420,0,-22,32,-2,2,0,2,5,1,6,-2,4,2,-4,6,2,-3,5,2,0,7,3,-4,0,4,3,0,0,1,-1,0,-1,1,-1
KR_6758976403,420,3,-31,-12,5,-1,2,1,1,5,6,-2,4,2,6,0,6,1,1,2,0,9,14,1,-3,2,0,0,0,-1,0,-1,-1,4,-1
KR_6755211741,420,2,43,4,9,5,0,5,0,2,2,1,3,4,4,0,4,-1,1,0,0,-1,2,-3,-4,7,4,0,1,-1,1,1,1,3,-1
KR_6695944337,420,-3,2,0,0,0,1,1,-2,3,1,-2,3,1,4,0,4,0,1,1,0,5,-7,-2,-3,5,1,0,-1,1,-1,-1,1,6,-1
KR_6685912960,420,-1,-46,-8,-1,-1,2,1,3,1,4,-7,7,0,-2,3,1,6,0,6,0,6,0,0,-3,3,-2,0,-1,1,-1,-1,-1,2,-1
KR_6720140270,420,-4,-23,4,-4,-1,3,2,-1,1,0,-3,4,1,-2,5,3,3,0,3,0,-6,-209,4,-8,4,-1,0,-1,1,-1,-1,1,3,-1
KR_6398663796,420,-4,-11,3,-9,-5,5,0,-5,6,1,0,1,1,1,1,2,0,1,1,0,-3,7,2,-6,4,-2,0,-1,-1,-1,-1,1,2,-1
KR_6348468772,420,-3,-61,16,-11,-12,12,0,0,2,2,1,1,2,0,3,3,0,0,0,-1,-3,-3,-2,-1,3,-2,0,-1,-1,0,-1,-1,5,-1
KR_6756165744,420,1,-86,32,4,0,1,1,2,0,2,1,1,2,-1,4,3,2,4,6,1,9,-13,-5,-2,7,1,0,-2,1,-1,-1,1,1,-1
KR_6603976746,420,-3,-44,-4,0,-2,2,0,1,0,1,0,3,3,2,2,4,-1,4,3,0,-7,5,4,-6,2,-6,0,-1,1,1,-1,1,3,-1
KR_6655746631,420,0,-75,-8,-1,-2,4,2,-1,3,2,0,1,1,1,5,6,1,0,1,0,2,2,-4,-1,5,2,0,0,-1,-1,-1,-1,5,-1
KR_6758074020,420,-3,-11,0,-9,-3,4,1,-4,4,0,-2,5,3,1,3,4,-1,1,0,-1,-13,321,-2,-3,5,-3,0,0,-1,-1,1,-1,3,-1
KR_6637996195,420,-1,-89,-2,0,0,2,2,4,1,5,-3,6,3,0,3,3,-1,1,0,1,6,192,-4,-1,5,1,0,-1,0,-1,-1,1,0,-1
KR_6761050583,440,0,52,31,-5,-3,3,0,-3,3,0,2,2,4,0,1,1,-1,1,0,0,0,-23,-4,-3,7,-24,0,0,1,1,0,-1,1,-1
KR_6764676753,420,1,-21,4,2,-2,4,2,0,3,3,2,0,2,2,0,2,0,0,0,0,9,137,0,-5,5,4,0,0,-1,-1,-1,-1,5,-1
KR_6763663257,420,-1,12,23,-3,1,1,2,-2,3,1,-2,4,2,0,0,0,0,0,0,0,-5,-18,0,-5,5,-4,0,0,-1,-1,0,-1,5,-1
KR_6743353887,420,-3,-77,-25,0,1,2,3,-3,3,0,0,2,2,0,1,1,2,0,2,-1,-2,12,4,-7,3,-8,0,0,-1,0,0,-1,1,-1
KR_6762111802,420,3,-10,-8,6,0,3,3,-1,5,4,2,2,4,2,1,3,3,2,5,0,5,-436,1,-2,1,5,0,-1,-1,-1,-1,1,3,-1
KR_6730680977,420,1,-47,-20,4,-1,2,1,2,1,3,-1,2,1,5,1,6,-1,1,0,0,5,-6,4,-7,3,-1,0,0,-1,-1,-1,-1,2,-1
KR_6533321554,420,-3,-67,11,-5,1,0,1,-7,8,1,1,1,2,1,1,2,-1,1,0,0,-5,-7,-2,-4,6,-7,0,0,-1,1,0,-1,3,-1
KR_6628775282,420,-1,-102,4,-4,-2,3,1,-2,3,1,0,1,1,-2,5,3,2,1,3,0,-4,2,-3,-3,6,4,0,0,1,0,-1,-1,6,-1
KR_6756964966,420,-1,-38,-8,-6,1,1,2,-2,3,1,-4,4,0,-1,3,2,0,3,3,0,-9,-31,-4,-2,6,6,0,1,-1,-1,1,-1,3,-1
KR_6727378381,420,-4,-110,-16,-10,0,1,1,-1,1,0,-2,4,2,-6,7,1,-1,2,1,0,-4,-8,-3,0,3,0,0,-3,-1,-1,-1,-1,4,-1
KR_6633624149,420,-3,-119,-12,-10,-6,7,1,-2,3,1,1,6,7,-3,7,4,0,1,1,-2,-17,-15,-3,-2,5,-1,0,-1,-1,-1,-1,-1,1,-1
KR_6709933925,420,-1,4,-13,1,0,2,2,-1,3,2,0,3,3,1,1,2,1,0,1,0,2,2,6,-7,1,-3,0,-1,-1,-1,-1,1,1,-1
KR_6745194584,420,2,34,-2,-4,1,2,3,-2,3,1,-5,7,2,3,2,5,-1,2,1,-2,-11,-21,-2,0,2,0,0,0,0,1,1,-1,0,-1
KR_6743366766,420,-3,-25,-44,-3,-6,8,2,0,1,1,-2,3,1,5,1,6,0,1,1,0,7,-2,1,-5,4,0,0,-1,0,-1,-1,-1,0,-1
KR_6756971916,420,-3,-49,0,-2,2,2,4,0,1,1,-2,3,1,-3,5,2,1,1,2,0,0,-25,-1,-2,3,0,0,1,-1,1,1,1,6,-1
KR_6669253763,420,-2,-64,6,-3,-1,2,1,0,2,2,-2,3,1,-3,5,2,3,2,5,0,-2,93,1,-6,5,-1,0,0,-1,1,-1,-1,1,-1
KR_6759496998,420,-2,-71,-1,-5,-3,3,0,-1,2,1,0,1,1,-3,3,0,2,1,3,0,-5,20,0,-4,4,-1,0,0,0,1,-1,-1,0,-1
KR_6733221803,420,-4,-78,-36,-10,-3,4,1,4,1,5,-3,4,1,-4,10,6,-4,4,0,-1,-2,31,-3,-1,4,-12,0,0,-1,-1,-1,-1,6,-1
KR_6752933547,420,-2,10,-48,-12,0,2,2,-5,5,0,2,1,3,-10,11,1,1,1,2,-2,-19,79,-5,0,5,1,0,-1,-1,-1,-1,-1,1,-1
KR_6724609908,420,-3,-32,12,-11,4,1,5,-7,7,0,1,1,2,-6,6,0,-3,3,0,0,-20,-104,1,-4,3,1,0,-1,0,1,-1,-1,0,-1
KR_6760468586,420,-2,52,-16,-1,-2,2,0,-3,8,5,7,0,7,-2,3,1,-1,1,0,0,-2,37,3,-5,2,1,0,0,-1,1,1,-1,4,-1
KR_6734780702,420,0,9,4,5,-2,2,0,3,6,9,2,0,2,1,0,1,1,0,1,0,5,-4,-1,-3,4,-1,0,0,1,-1,1,1,5,-1
KR_6761229893,420,-4,-51,7,-15,-8,8,0,-1,3,2,-1,1,0,-4,5,1,-1,3,2,0,-11,-4,-5,0,5,2,0,-2,-1,-1,-1,-1,5,-1
KR_6689906362,420,-3,7,-27,-5,1,0,1,-2,2,0,-4,5,1,1,1,2,-1,1,0,0,-4,7,5,-7,2,1,0,0,-1,-1,0,-1,3,-1
KR_6743753200,420,-4,16,-29,-4,3,2,5,-6,8,2,2,1,3,-1,2,1,-2,3,1,3,-5,-6,1,-9,8,1,0,0,-1,1,1,1,4,-1
KR_6596203495,420,2,-12,40,-3,1,2,3,-1,2,1,-1,3,2,0,3,3,-2,2,0,0,1,-111,-1,-2,3,-2,0,0,-1,-1,-1,-1,3,-1
KR_6727410133,420,-4,-26,17,-7,0,2,2,-3,5,2,-2,6,4,-2,2,0,0,0,0,0,-6,2,0,-6,6,-6,0,-2,-1,-1,-1,-1,6,-1
KR_6674296290,420,-4,1,-24,-6,-2,2,0,-4,8,4,-5,6,1,3,0,3,2,0,2,0,-5,-11,1,-4,3,-3,0,-1,-1,1,-1,-1,5,-1
KR_6752085214,420,3,-25,19,7,1,0,1,1,1,2,8,0,8,-3,3,0,0,0,0,0,2,24,3,-4,1,0,0,1,-1,1,-1,1,3,-1
KR_6709964139,420,-1,9,0,-5,-2,4,2,-2,3,1,1,1,2,0,3,3,-2,3,1,0,-4,-8,-7,-3,10,2,0,0,-1,1,0,1,4,-1
KR_6743346506,440,1,59,8,-2,3,2,5,0,1,1,-9,11,2,7,0,7,-3,5,2,0,4,18,2,-2,0,-2,0,1,-1,0,-1,1,6,-1
KR_6649769840,420,-3,-46,-26,-10,-4,5,1,-2,4,2,-2,6,4,-1,3,2,-1,3,2,0,-11,-2,-4,-3,7,1,0,-1,-1,-1,-1,1,6,-1
KR_6747905154,420,-1,-41,13,-1,-1,2,1,1,2,3,-1,4,3,-4,7,3,4,0,4,0,0,-97,3,-5,2,-5,0,-1,1,-1,-1,-1,6,-1
KR_6696114025,420,-3,-65,1,-8,3,0,3,-1,1,0,-5,6,1,-5,6,1,0,1,1,0,-12,12,-2,-4,6,0,0,-1,-1,-1,-1,-1,1,-1
KR_6694328625,420,-5,-74,-40,-10,0,3,3,-4,6,2,-5,5,0,-1,2,1,0,0,0,0,-5,2,-4,-3,7,1,0,-2,-1,0,-1,-1,1,-1
KR_6756776320,420,1,9,23,1,-1,3,2,3,0,3,1,2,3,0,4,4,-2,6,4,0,3,-19,0,-5,5,4,0,0,1,0,0,1,5,-1
KR_6757813238,420,-3,-42,-3,-8,-3,3,0,-1,4,3,0,1,1,-4,6,2,0,3,3,0,-5,6,-1,-6,7,-8,0,1,1,-1,-1,-1,1,-1
KR_6748497116,420,3,95,-4,11,2,1,3,6,3,9,-1,2,1,2,1,3,2,0,2,0,13,9,4,-6,2,0,0,2,1,1,1,1,3,-1
KR_6676061310,420,4,54,8,10,2,1,3,1,3,4,3,2,5,3,0,3,1,0,1,0,7,-111,-2,-5,7,1,0,1,-1,1,1,-1,1,-1
KR_6720549959,420,2,18,2,8,-1,6,5,4,1,5,0,3,3,5,2,7,0,0,0,0,8,-351,0,-3,3,1,0,1,-1,-1,1,-1,1,-1
KR_6746751173,420,2,11,-5,-1,1,1,2,-5,9,4,-1,2,1,3,1,4,1,0,1,0,-7,-25,4,-6,2,15,0,1,-1,1,1,-1,6,-1
KR_6715171261,420,-1,-70,-12,2,1,1,2,-2,2,0,0,1,1,1,3,4,2,1,3,0,4,17,2,-6,4,5,0,0,0,-1,0,-1,0,-1
KR_6749261868,420,-3,-15,-24,-6,-6,7,1,1,3,4,-3,5,2,1,0,1,1,0,1,1,-4,2,1,-2,1,-1,0,-1,-1,1,-1,1,1,-1
KR_6723468244,420,-1,-50,-4,-4,-4,5,1,3,0,3,-4,4,0,0,1,1,1,1,2,0,1,-1,2,-3,1,-1,0,-2,-1,-1,-1,-1,1,-1
KR_6728254602,420,-1,-3,-13,-5,-2,2,0,-1,2,1,-5,7,2,4,0,4,-1,2,1,0,-1,-80,-4,-3,7,-1,0,0,-1,-1,-1,-1,1,-1
KR_6695405668,420,1,64,1,2,-1,2,1,1,4,5,-1,2,1,2,0,2,1,1,2,0,1,10,-4,-2,6,-1,0,1,1,-1,1,1,4,-1
KR_6656316241,420,-1,-72,-12,-1,-1,2,1,-4,4,0,1,4,5,3,2,5,0,1,1,0,8,-13,0,-3,3,-5,0,-1,1,-1,-1,1,4,-1
KR_6759243483,420,-1,-29,-16,-2,0,2,2,-1,1,0,1,4,5,-5,5,0,3,1,4,0,-2,-46,-1,0,1,21,0,-2,-1,-1,-1,-1,3,-1
KR_6760208569,420,-1,-121,-20,0,-1,1,0,3,0,3,2,2,4,-3,3,0,-1,1,0,0,4,19,3,-7,4,-1,0,-1,-1,-1,-1,1,2,-1
KR_6727059673,420,-4,-57,-7,-7,0,0,0,-2,3,1,-1,4,3,-1,2,1,-3,3,0,0,-10,93,-3,-4,7,1,0,0,1,1,0,-1,5,-1
KR_6743618623,420,-6,-97,-72,-1,-3,4,1,1,0,1,5,2,7,-2,2,0,-2,2,0,0,0,3,1,-5,4,3,0,-1,1,-1,-1,1,3,-1
KR_6756827198,440,-2,-14,-16,-3,2,2,4,0,1,1,-4,4,0,0,6,6,-1,1,0,0,-4,-13,-3,-3,6,5,0,0,0,-1,0,-1,0,-1
KR_6600509953,420,-3,-28,-24,-9,-1,2,1,-4,6,2,-5,6,1,3,1,4,-2,2,0,0,-2,22,6,-7,1,-2,0,0,-1,1,0,-1,2,-1
KR_6757534458,420,0,-29,8,-2,-3,3,0,-3,4,1,1,1,2,4,0,4,-1,2,1,1,2,4,-3,-4,7,0,0,-1,0,-1,-1,1,0,-1
KR_6762546291,420,-3,-38,0,-10,0,1,1,-5,6,1,-1,3,2,-3,3,0,-1,2,1,0,-11,-6,-1,-2,3,1,0,-1,-1,-1,-1,-1,4,-1
KR_6672630164,420,0,65,-16,-1,-2,4,2,2,2,4,1,1,2,1,2,3,-3,3,0,0,-3,-6,-1,-3,4,4,0,0,-1,1,0,1,2,-1
KR_6758372465,440,-4,-74,4,-3,3,1,4,3,0,3,-6,6,0,-1,3,2,-2,2,0,0,1,5,0,-1,1,0,0,0,-1,1,1,-1,3,-1
KR_6661850411,420,2,66,8,2,-1,1,0,1,2,3,-3,4,1,3,2,5,2,0,2,1,0,-3,4,-7,3,0,0,1,1,-1,1,1,2,-1
KR_6760005168,420,0,12,-8,4,1,0,1,-1,3,2,0,1,1,3,1,4,1,0,1,0,9,9,0,-11,11,-3,0,0,1,-1,0,1,3,-1
KR_6764344094,420,-3,-76,14,2,0,1,1,3,3,6,0,1,1,0,3,3,-1,1,0,0,2,178,-3,-1,4,6,0,0,1,-1,-1,1,1,-1
KR_6735409819,420,3,-42,33,6,-1,1,0,3,0,3,5,1,6,-1,3,2,0,2,2,0,1,3,5,-7,2,5,0,1,-1,1,1,-1,4,-1
KR_6190367467,420,2,29,-11,6,0,0,0,-1,7,6,0,2,2,3,1,4,4,0,4,0,7,224,1,-4,3,4,0,1,-1,0,1,1,4,-1
KR_6602034219,420,2,24,4,-2,2,1,3,-2,4,2,-1,2,1,-1,1,0,0,1,1,0,4,3,-6,-2,8,0,0,0,1,-1,0,-1,1,-1
KR_6735787725,440,0,29,-28,-1,1,1,2,3,2,5,-1,2,1,-3,3,0,-1,3,2,0,-5,-2,1,-6,5,-2,0,-1,0,-1,-1,1,0,-1
KR_6729388147,420,2,-7,-20,3,0,1,1,1,0,1,2,2,4,2,2,4,-2,2,0,0,7,147,-1,-3,4,1,0,1,-1,-1,-1,1,3,-1
KR_6498413653,420,-5,-52,-22,-15,-4,4,0,-5,6,1,0,2,2,-3,7,4,-3,4,1,2,-11,-291,0,-6,6,-1,0,-3,-1,-1,-1,1,4,-1
KR_6724396678,420,-1,-16,24,-3,4,1,5,1,0,1,-4,5,1,-1,2,1,-3,4,1,0,-4,1,-3,-4,7,-4,0,-1,-1,1,1,1,1,-1
KR_6748506144,420,-4,-52,-7,-5,5,1,6,-3,5,2,-2,3,1,-5,7,2,0,0,0,2,-8,8,5,-11,6,-5,0,-2,0,-1,-1,-1,0,-1
KR_6747089475,420,-2,17,29,-9,0,1,1,-5,8,3,-1,1,0,-2,4,2,-1,3,2,0,-10,-274,-4,-1,5,-4,0,0,-1,-1,1,1,1,-1
KR_6733262888,420,0,-82,8,4,-2,3,1,-1,4,3,3,0,3,3,4,7,1,0,1,-1,12,-43,4,-8,4,1,0,1,-1,1,1,-1,1,-1
KR_6657349732,420,-4,-98,-6,-5,-4,7,3,-1,2,1,-3,4,1,4,1,5,-1,1,0,0,-3,-2,3,-5,2,0,0,0,-1,1,1,-1,4,-1
KR_6743283556,420,0,-30,13,-4,1,0,1,-2,9,7,-1,3,2,-4,5,1,2,1,3,1,-6,1,-3,-3,6,6,0,0,-1,-1,-1,1,1,-1
KR_6732458206,420,-2,-26,-39,2,-4,4,0,-2,2,0,2,0,2,5,1,6,1,3,4,0,1,-12,0,-2,2,0,0,0,1,0,-1,-1,4,-1
KR_6703481525,420,3,42,-44,9,-1,3,2,6,0,6,5,2,7,-2,2,0,1,1,2,0,8,0,0,-2,2,1,0,0,1,0,1,-1,4,-1
KR_6762234841,420,-1,-91,-4,-4,-1,3,2,-2,5,3,2,0,2,-1,2,1,-2,2,0,0,-4,9,0,-6,6,-6,0,-2,1,1,-1,-1,4,-1
KR_6652945116,420,-2,-28,2,-6,-6,6,0,-2,4,2,1,1,2,3,2,5,-2,4,2,0,-3,-2,1,-6,5,2,0,0,1,1,0,-1,4,-1
KR_6698462297,420,3,22,4,2,2,1,3,1,0,1,-2,3,1,-2,4,2,3,0,3,0,-3,1,2,-7,5,-3,0,1,0,1,1,-1,0,-1
KR_6672118082,420,-2,0,-20,-5,0,1,1,-2,3,1,-2,4,2,1,3,4,-2,3,1,0,-4,1,-3,-2,5,1,0,-1,1,-1,-1,-1,2,-1
KR_6673525858,420,-3,20,-52,-2,4,0,4,-6,8,2,-1,1,0,2,3,5,-1,1,0,0,-6,-6,-4,-2,6,2,0,0,-1,-1,-1,1,3,-1
KR_6633836100,420,-1,-47,27,-7,-1,1,0,2,0,2,-2,3,1,-7,9,2,1,0,1,0,-5,-4,-2,-3,5,-5,0,0,-1,0,-1,-1,5,-1
KR_6746824456,420,-6,-123,0,-7,0,5,5,-2,4,2,-4,5,1,0,4,4,-1,1,0,1,-1,-206,1,-2,1,-1,0,-2,1,1,-1,1,2,-1
KR_6701187361,420,-1,-2,14,-3,1,1,2,0,2,2,4,0,4,-7,9,2,-1,1,0,-1,-5,-1,0,-5,5,1,0,1,-1,1,1,-1,2,-1
KR_6749879760,440,-6,-101,1,-11,-1,3,2,-7,8,1,1,0,1,-2,5,3,-2,3,1,0,-12,4,3,-4,1,-4,0,-2,0,0,-1,1,0,-1
KR_6703325705,420,-3,-5,-6,-5,-2,3,1,-2,5,3,-2,3,1,-1,5,4,2,0,2,0,-2,43,-4,-7,11,-22,0,1,-1,1,1,1,5,-1
KR_6752576909,420,-2,16,-35,-8,3,2,5,-1,2,1,-6,6,0,0,5,5,-4,4,0,0,-12,0,0,-2,2,-1,0,-1,-1,-1,-1,1,6,-1
KR_6693399375,420,-1,33,-10,0,3,1,4,1,1,2,-1,4,3,-1,6,5,-2,2,0,0,-10,-124,5,-9,4,-3,0,1,-1,-1,-1,1,2,-1
KR_6670675798,420,0,-10,-2,1,-2,3,1,-4,5,1,4,0,4,2,2,4,1,0,1,0,4,1,2,-5,3,1,0,0,-1,1,0,-1,4,-1
KR_6661091123,440,-3,-18,-47,-3,2,2,4,-2,2,0,-5,7,2,1,2,3,1,1,2,0,1,-15,5,-6,1,-4,0,1,0,0,1,1,0,-1
KR_6591956398,420,-2,-15,5,-13,0,0,0,-5,7,2,-1,2,1,-3,5,2,-4,4,0,-3,-22,9,0,-2,2,-1,0,0,1,-1,0,-1,5,-1
KR_6595067677,420,-1,37,-7,-6,-4,4,0,-1,5,4,1,1,2,-1,3,2,-1,2,1,-2,-6,5,-6,-1,7,2,0,0,0,-1,0,-1,0,-1
KR_6638101331,420,0,51,-36,-2,1,0,1,-2,3,1,2,3,5,-2,5,3,-1,3,2,0,-10,10,6,-10,4,1,0,1,1,1,1,1,6,-1
KR_6714697669,420,-1,49,-10,-3,-1,2,1,4,1,5,0,2,2,-6,7,1,0,1,1,0,-7,-7,-4,0,4,-2,0,0,-1,-1,0,-1,5,-1
KR_6763236775,440,1,-82,24,0,-1,2,1,4,0,4,4,2,6,-8,9,1,1,0,1,0,1,18,2,-5,3,0,0,-1,-1,1,1,-1,4,-1
KR_6739088810,420,-7,-128,-14,-11,-3,5,2,-3,4,1,-6,6,0,4,0,4,-3,3,0,0,-11,-7,0,-1,1,0,0,-3,-1,-1,-1,-1,2,-1
KR_6601359835,420,0,33,12,1,2,1,3,-2,5,3,-1,3,2,3,0,3,-1,2,1,0,1,-17,3,-6,3,6,0,1,1,-1,1,1,5,-1
KR_6678215646,420,-2,-27,12,-1,0,1,1,-1,4,3,-1,2,1,-1,5,4,2,0,2,0,-1,-8,-3,-2,5,0,0,0,0,-1,-1,1,0,-1
KR_6726222028,440,-3,-42,-4,-7,-2,3,1,-1,3,2,-3,3,0,0,1,1,-1,4,3,0,-5,-6,1,-2,1,-3,0,0,1,-1,0,1,2,-1
KR_6759727387,420,-4,-42,-3,-11,0,2,2,-3,4,1,-7,8,1,0,4,4,-1,1,0,0,-12,7,1,-6,5,-1,0,0,1,-1,0,1,1,-1
KR_6482875835,420,0,-45,26,-4,-1,1,0,-1,2,1,-7,7,0,1,0,1,4,1,5,0,2,34,-3,-1,4,-1,0,-1,-1,1,-1,-1,1,-1
KR_6704967518,420,-4,-86,8,-3,2,1,3,-3,5,2,0,2,2,0,1,1,-2,2,0,0,-8,32,1,-4,3,-1,0,-2,1,-1,-1,-1,5,-1
KR_6275408462,420,-1,-53,-16,-2,-1,1,0,-4,5,1,-2,2,0,4,2,6,1,3,4,0,1,2,-2,0,2,1,0,1,1,-1,1,1,3,-1
KR_6722176591,420,-2,-7,-29,-10,0,2,2,-9,10,1,4,2,6,-3,3,0,-2,2,0,-3,-8,9,-1,-4,5,0,0,0,1,-1,0,-1,5,-1
KR_6729701847,440,-3,-42,24,-6,4,0,4,-6,7,1,-1,1,0,-2,4,2,-1,2,1,0,-4,51,4,-7,3,0,0,1,-1,1,1,-1,5,-1
KR_6758587299,420,1,66,6,0,-3,3,0,-1,2,1,3,4,7,-1,2,1,2,0,2,0,-5,289,-1,-4,5,7,0,0,1,1,0,1,5,-1
KR_6763639218,440,-1,29,12,9,-7,7,0,1,2,3,8,1,9,8,3,11,-1,4,3,2,5,7,-1,-5,6,-4,0,0,-1,-1,0,1,5,-1
KR_6686657519,420,-2,-44,-3,-8,-2,2,0,-3,6,3,-3,4,1,-1,1,0,1,0,1,-1,0,-5,-6,0,6,0,0,-1,-1,-1,-1,-1,2,-1
KR_6743661980,420,0,61,19,-1,-4,4,0,0,3,3,1,1,2,-1,3,2,3,0,3,0,2,7,-4,-2,6,1,0,0,1,-1,0,-1,2,-1
KR_6762953703,420,-4,-152,-34,-11,-4,4,0,-1,3,2,-1,1,0,-2,3,1,-3,3,0,0,-11,1,2,-5,3,0,0,-1,-1,1,-1,-1,5,-1
KR_6752772139,420,-4,-63,-19,-3,-5,7,2,3,1,4,0,1,1,1,2,3,-2,2,0,-1,-4,-14,2,-3,1,-2,0,-2,0,-1,-1,-1,0,-1
KR_6731644714,420,-3,-79,9,-9,-5,5,0,-2,4,2,-1,3,2,-1,4,3,0,1,1,0,-3,12,-3,-4,7,2,0,-1,-1,-1,-1,1,2,-1
KR_6761193073,420,-1,-21,-10,0,2,0,2,3,2,5,-2,4,2,-3,7,4,0,2,2,0,-2,0,1,-4,3,-2,0,-1,-1,1,-1,-1,3,-1
KR_6750218971,420,-1,19,-12,-1,3,0,3,1,3,4,-4,4,0,2,1,3,-3,3,0,0,-2,12,1,-5,4,2,0,-1,-1,1,-1,-1,5,-1
KR_6666098954,420,-5,-14,-13,-7,-4,6,2,-1,3,2,-3,3,0,0,0,0,1,0,1,0,-1,-7,-5,-1,6,0,0,-3,-1,-1,-1,-1,4,-1
KR_6748055844,420,0,1,10,-6,1,2,3,-3,5,2,0,1,1,-2,3,1,-2,2,0,0,-5,-5,-1,-4,5,1,0,2,-1,1,1,-1,1,-1
KR_6762476941,420,2,24,-24,5,5,1,6,4,2,6,-4,5,1,2,3,5,-2,2,0,0,2,-20,6,-8,2,2,0,1,0,1,1,-1,0,-1
KR_6750986006,420,-2,-82,-28,-1,1,2,3,-2,3,1,0,4,4,0,1,1,0,0,0,0,-2,1,2,-4,2,1,0,-1,0,-1,-1,-1,0,-1
KR_6685870263,420,-3,-9,-11,-6,-3,4,1,1,0,1,-2,3,1,-1,2,1,-1,1,0,0,-9,8,-2,-2,4,-1,0,0,-1,0,0,-1,2,-1
KR_6753359301,420,-1,16,-20,-3,-3,4,1,-4,8,4,5,1,6,4,0,4,-5,6,1,-1,-6,3,4,-6,2,-4,0,0,-1,1,0,-1,4,-1
KR_6747058312,440,0,-30,-10,4,-1,2,1,3,0,3,2,1,3,-1,1,0,1,1,2,0,4,-5,0,-3,3,5,0,0,0,1,-1,1,0,-1
KR_6745874755,420,-1,-54,-19,-4,-2,3,1,4,2,6,0,3,3,-4,6,2,-2,3,1,0,6,400,2,-3,1,0,0,-2,1,1,-1,-1,1,-1
KR_6708749117,420,-1,-17,-12,-2,2,1,3,-3,6,3,2,1,3,0,2,2,-3,4,1,0,-5,12,9,-11,2,-3,0,-1,-1,-1,-1,-1,5,-1
KR_6642186842,420,-4,-41,-3,-6,-1,2,1,-3,5,2,0,3,3,-3,6,3,1,0,1,0,-6,-3,-3,-2,5,0,0,-1,-1,1,-1,-1,1,-1
KR_6726203335,420,0,-33,13,-1,0,0,0,1,5,6,-2,4,2,1,2,3,-1,1,0,-1,-2,68,-2,0,2,-1,0,-1,1,-1,-1,-1,5,-1
KR_6752013348,420,-2,-12,-16,-3,4,0,4,-4,5,1,0,1,1,-2,4,2,-1,1,0,0,-4,4,3,-6,3,-1,0,0,-1,1,0,1,5,-1
KR_6730933971,420,-3,-50,0,-9,0,1,1,3,0,3,-11,12,1,-1,1,0,0,1,1,0,-4,2,-2,-3,5,1,0,-1,1,-1,-1,-1,6,-1
KR_6750379823,420,-4,-29,-28,-7,2,2,4,-1,1,0,-4,6,2,1,2,3,-5,6,1,0,-5,-8,-2,0,2,0,0,-1,-1,-1,-1,-1,5,-1
KR_6744279046,420,-3,28,-2,-6,2,0,2,0,2,2,-3,5,2,-6,7,1,1,0,1,1,-8,-17,2,-10,8,-4,0,-1,-1,-1,-1,1,4,-1
KR_6628883056,420,-5,-32,12,-6,0,2,2,2,1,3,-2,6,4,-2,5,3,-4,4,0,0,-3,4,8,-12,4,4,0,0,1,1,0,1,6,-1
KR_6730464966,440,1,-14,-11,2,4,3,7,-5,6,1,1,2,3,3,1,4,-1,2,1,0,8,-8,-5,-1,6,4,0,0,0,-1,-1,-1,0,-1
KR_6747447583,440,0,-29,-13,0,1,2,3,7,1,8,-3,4,1,-2,2,0,-3,5,2,-1,5,0,0,-6,6,-5,0,-2,-1,-1,-1,-1,1,-1
KR_6690179093,420,-9,-48,-38,-20,2,0,2,-4,4,0,-9,9,0,-6,9,3,-3,3,0,-1,-15,-161,-6,-2,8,-1,0,-3,-1,-1,-1,-1,5,-1
KR_6731243849,420,-2,71,8,-3,4,0,4,-10,14,4,4,1,5,1,1,2,-2,3,1,-2,-22,-16,-5,-3,8,-2,0,2,-1,1,1,-1,3,-1
KR_6763677649,420,0,-36,0,-1,4,2,6,-4,5,1,1,4,5,-2,3,1,0,2,2,0,-5,-5,2,-7,5,2,0,-1,1,-1,-1,-1,3,-1
KR_6682566492,420,0,-46,4,-2,1,1,2,1,2,3,-4,5,1,0,4,4,0,0,0,0,-4,0,-4,-4,8,6,0,0,1,1,-1,-1,5,-1
KR_6681559604,420,-3,-37,-12,-2,-2,2,0,-1,5,4,-2,5,3,2,1,3,1,0,1,2,3,-173,-2,-1,3,-1,0,-2,1,-1,-1,1,5,-1
KR_6756415240,420,-1,-40,-16,5,3,1,4,2,2,4,6,1,7,-7,7,0,1,0,1,1,0,3,2,-7,5,-2,0,0,-1,1,1,1,3,-1
KR_6754824197,420,-3,8,-4,-6,-2,2,0,2,1,3,-1,1,0,-4,5,1,-1,1,0,0,-9,2,3,-6,3,-3,0,-1,-1,-1,-1,-1,4,-1
KR_6752772023,420,1,1,-8,-3,1,2,3,4,4,8,-2,4,2,-4,5,1,-2,2,0,0,-4,264,-2,-1,3,0,0,0,-1,1,0,1,6,-1
KR_6762293409,420,1,-18,12,3,0,1,1,3,1,4,-1,5,4,2,1,3,-1,3,2,0,8,4,2,-6,4,-1,0,-1,-1,1,-1,1,4,-1
KR_6516131954,420,-1,-35,12,-5,3,0,3,-4,4,0,-2,3,1,-2,3,1,0,0,0,0,-8,-1,0,-4,4,-2,0,0,-1,1,-1,1,4,-1
KR_6750275892,420,-1,11,-8,-2,2,3,5,-5,7,2,1,2,3,-1,4,3,1,1,2,0,-6,12,-3,-2,5,1,0,0,-1,-1,0,-1,2,-1
KR_6711790172,420,-3,42,-12,-9,0,2,2,-8,9,1,-6,6,0,4,0,4,1,1,2,0,-9,22,-1,-8,9,0,0,0,-1,-1,-1,1,5,-1
KR_6750127759,420,-5,-34,0,-9,-1,3,2,-1,2,1,-2,5,3,-4,6,2,-1,3,2,0,-10,-2,2,-3,1,4,0,-1,-1,1,-1,-1,3,-1
KR_6728782816,420,-1,12,-20,2,-1,2,1,-3,5,2,-6,6,0,8,0,8,4,1,5,0,9,12,-4,-2,6,1,0,0,-1,1,0,1,1,-1
KR_6714481399,420,0,-2,28,-4,-2,3,1,0,4,4,0,2,2,-1,2,1,-1,2,1,0,0,-1,-2,0,2,0,0,1,1,-1,1,-1,2,-1
KR_6626888953,420,-1,-26,-3,-3,-4,5,1,3,2,5,-1,3,2,-2,5,3,1,1,2,0,-1,-6,1,-3,2,-3,0,0,-1,-1,0,-1,1,-1
KR_6682602539,420,1,10,-4,3,1,1,2,-4,8,4,4,1,5,1,2,3,1,0,1,0,-4,-12,0,-3,3,4,0,1,1,-1,1,1,2,-1
KR_6764087483,420,0,52,-23,-4,1,3,4,1,4,5,-1,1,0,-2,3,1,-3,3,0,0,-10,-5,-1,-3,4,5,0,1,1,-1,1,1,1,-1
KR_6727614405,420,-2,6,-14,0,1,0,1,-2,2,0,-1,2,1,1,1,2,1,0,1,0,-4,-13,6,-7,1,-1,0,0,-1,1,0,1,5,-1
KR_6761329081,420,-4,-16,-28,-1,-3,3,0,-3,6,3,4,1,5,4,1,5,-3,4,1,0,-3,30,1,-1,0,0,0,-2,-1,-1,-1,1,1,-1
KR_6703371402,420,1,-10,23,-7,0,1,1,-5,5,0,-4,4,0,2,2,4,0,0,0,-1,-12,10,-1,-2,3,-2,0,1,-1,1,1,-1,3,-1
KR_6671159749,420,-1,73,-14,-6,4,1,5,-1,2,1,-4,5,1,-5,9,4,0,1,1,0,-8,3,-1,-2,3,3,0,0,-1,-1,0,-1,1,-1
KR_6729525617,420,-4,-61,-13,-11,-3,4,1,-3,6,3,-3,4,1,-6,8,2,4,1,5,0,-12,-19,-1,-1,2,5,0,0,-1,1,-1,-1,5,-1
KR_6715577718,420,0,-73,25,5,1,2,3,-2,5,3,0,1,1,6,2,8,0,2,2,0,6,0,0,-2,2,-1,0,-2,1,-1,-1,-1,1,-1
KR_6739179618,420,-1,-45,-28,0,-1,1,0,1,1,2,0,1,1,4,1,5,-4,5,1,0,-2,1,-2,-5,7,-3,0,0,1,0,0,-1,3,-1
KR_6676901912,420,0,56,-16,0,1,1,2,-2,3,1,2,2,4,-2,2,0,1,2,3,0,-1,-2,-5,-3,8,-6,0,0,-1,1,0,1,3,-1
KR_6756548954,420,-3,-35,-28,-9,-3,3,0,-4,5,1,-7,8,1,7,2,9,-2,2,0,0,-6,-12,-6,-1,7,4,0,-1,1,0,-1,-1,5,-1
KR_6755852139,420,-1,-26,8,-5,2,1,3,-2,2,0,-2,3,1,-1,2,1,-2,3,1,0,-9,152,0,-3,3,1,0,-1,-1,1,-1,-1,3,-1
KR_6732863903,420,0,-43,20,-1,3,0,3,3,1,4,-2,4,2,-4,4,0,-1,1,0,0,-3,-2,1,-6,5,-2,0,0,-1,-1,-1,1,6,-1
KR_6738975765,420,-3,18,-12,-7,-6,6,0,-3,4,1,-2,3,1,2,0,2,2,0,2,0,-3,2,-1,-4,5,1,0,0,-1,-1,0,-1,6,-1
KR_6690907510,420,0,11,-29,-1,0,2,2,1,0,1,1,4,5,-1,2,1,-2,3,1,0,4,-19,-4,-4,8,4,0,-1,-1,-1,-1,-1,6,-1
KR_6745767767,420,-1,43,-12,-3,-2,7,5,0,4,4,0,1,1,-2,6,4,1,0,1,0,3,-2,0,-2,2,1,0,1,-1,1,1,-1,1,-1
KR_6725390554,420,-1,-53,-8,0,1,3,4,-2,5,3,3,0,3,-4,4,0,2,1,3,1,1,8,1,-3,2,-3,0,-1,1,1,-1,1,6,-1
KR_6588165600,420,-1,-29,-28,0,0,1,1,1,0,1,-2,5,3,1,1,2,0,1,1,0,-1,-20,1,-3,2,-2,0,0,-1,-1,0,-1,4,-1
KR_6743211911,420,-1,-41,47,-3,-1,1,0,0,4,4,0,1,1,-3,5,2,1,0,1,0,-7,450,3,-9,6,-4,0,1,1,-1,1,-1,1,-1
KR_6748693714,420,0,10,17,-1,-1,3,2,-1,6,5,4,1,5,-1,2,1,-2,3,1,0,-3,3,-1,-6,7,-3,0,0,-1,-1,0,-1,6,-1
KR_6657237232,420,1,30,42,-2,-3,3,0,0,2,2,0,3,3,2,0,2,-1,2,1,0,-4,14,-1,-2,3,-2,0,0,1,-1,-1,1,3,-1
KR_6756361668,420,-3,-78,-16,-8,1,1,2,-6,6,0,1,1,2,-2,2,0,-2,3,1,0,-12,2,-2,-4,6,-6,0,0,-1,-1,0,-1,5,-1
KR_6676677693,420,-1,-16,9,-6,-3,3,0,-3,3,0,3,1,4,-2,3,1,-1,2,1,0,-10,-2,-3,-2,5,3,0,1,-1,-1,1,-1,1,-1
KR_6764747125,420,-2,-68,-17,1,2,0,2,0,3,3,-2,2,0,-1,5,4,2,2,4,2,9,-14,3,-6,3,0,0,-1,-1,-1,-1,1,2,-1
KR_6759314865,420,-2,-21,-8,4,-1,2,1,3,1,4,-3,6,3,1,1,2,4,0,4,0,11,-6,2,-5,3,8,0,0,1,-1,0,1,5,-1
KR_6745646242,420,-1,-89,16,-5,-4,7,3,1,0,1,0,2,2,-2,2,0,0,0,0,0,2,-1,-1,-1,2,0,0,1,-1,-1,1,-1,3,-1
KR_6730374838,420,2,-7,18,-1,-4,4,0,4,1,5,6,1,7,-7,8,1,0,0,0,1,-14,8,10,-13,3,-1,0,0,-1,1,1,1,3,-1
KR_6599283335,420,-2,-89,-13,-8,-1,3,2,-1,3,2,-3,4,1,-2,5,3,-1,2,1,0,-5,13,-1,-2,3,-1,0,-2,-1,-1,-1,-1,5,-1
KR_6648627814,420,-5,-29,-18,-1,1,3,4,-1,3,2,0,1,1,-2,5,3,1,2,3,-1,-2,-468,0,-3,3,0,0,-2,-1,-1,-1,-1,6,-1
KR_6726559726,420,-4,-62,-12,-10,-3,3,0,-1,5,4,0,2,2,-6,7,1,0,1,1,-2,-3,-24,-3,-5,8,9,0,-1,-1,-1,-1,-1,1,-1
KR_6687992669,420,-4,-73,24,-8,-5,5,0,2,3,5,4,1,5,0,0,0,-9,10,1,0,-2,-9,-1,-4,5,-6,0,0,-1,-1,-1,1,1,-1
KR_6674382577,420,0,-61,19,-7,0,3,3,1,2,3,-4,8,4,-2,3,1,-2,2,0,-1,-6,-7,1,-3,2,1,0,-2,-1,-1,-1,-1,6,-1
KR_6745618159,420,-1,-39,-12,-5,2,2,4,2,1,3,0,1,1,-4,4,0,-5,5,0,0,-3,6,-4,-4,8,4,0,-1,-1,-1,-1,-1,4,-1
KR_6695656606,420,0,-2,-8,-5,0,1,1,0,2,2,-3,6,3,-2,3,1,0,2,2,0,-8,0,3,-5,2,-3,0,-1,-1,1,-1,-1,5,-1
KR_6742341719,420,4,-19,44,2,-1,2,1,1,2,3,5,0,5,-3,7,4,0,0,0,0,10,-8,-5,-2,7,3,0,0,-1,-1,0,-1,4,-1
KR_6743740598,440,-3,-25,-26,-10,2,1,3,-12,13,1,1,2,3,-1,5,4,0,3,3,-4,-12,-9,-4,-2,6,0,0,-1,1,0,-1,-1,5,-1
KR_6742407979,420,-5,-65,-44,-15,1,3,4,-2,3,1,-13,13,0,3,2,5,-4,4,0,0,-10,-6,4,-5,1,-3,0,-1,-1,1,-1,-1,6,-1
KR_6763160643,420,-2,-48,-8,-6,1,0,1,-3,3,0,3,1,4,-7,8,1,0,0,0,0,-3,5,-3,-2,5,0,0,-1,1,-1,-1,-1,2,-1
KR_6719741681,440,-2,-23,-24,-3,-2,3,1,2,2,4,2,0,2,-3,5,2,-2,3,1,0,1,8,-1,-5,6,-1,0,0,1,-1,0,-1,3,-1
KR_6699997755,420,1,62,-24,3,3,1,4,-1,4,3,1,0,1,0,1,1,0,0,0,0,1,6,1,-5,4,2,0,1,-1,1,1,-1,4,-1
KR_6758436651,420,-1,96,-8,-10,-1,1,0,-3,3,0,1,1,2,-6,7,1,-1,1,0,0,-21,2,3,-6,3,-1,0,0,-1,1,1,-1,5,-1
KR_6735875690,420,-2,-13,28,-13,-2,3,1,-2,5,3,-4,5,1,-2,5,3,-3,4,1,0,-10,10,-1,-5,6,-3,0,-1,-1,1,-1,-1,6,-1
KR_6679004823,440,-2,-2,-20,-7,-6,6,0,1,1,2,-4,5,1,3,5,8,-1,2,1,0,-3,-1,2,-4,2,-1,0,-2,-1,-1,-1,1,1,-1
KR_6720161690,420,-2,-1,-32,1,-1,2,1,-4,4,0,-4,6,2,8,0,8,2,1,3,1,16,0,-2,-3,5,0,0,0,1,-1,-1,1,5,-1
KR_6679756702,420,-1,-31,-13,-1,1,0,1,0,3,3,-4,5,1,3,3,6,-1,1,0,-2,-4,2,0,-4,4,-2,0,0,-1,-1,0,-1,5,-1
KR_6585858152,420,1,9,-3,-2,-1,2,1,-1,2,1,2,4,6,-2,3,1,0,0,0,0,-1,3,2,-5,3,1,0,0,1,-1,0,1,2,-1
KR_6682363313,420,0,-24,-7,-6,-2,3,1,0,3,3,-2,5,3,-1,4,3,-1,2,1,0,-1,8,-9,-2,11,-2,0,-1,1,-1,-1,-1,2,-1
KR_6663740578,420,-4,-54,0,-11,-10,10,0,1,2,3,-1,1,0,-1,3,2,0,0,0,0,-1,-3,0,-3,3,-3,0,0,1,-1,-1,-1,5,-1
KR_6662674691,440,1,27,32,-2,-1,2,1,5,0,5,-4,5,1,-2,7,5,0,0,0,0,-8,-2,-2,-4,6,0,0,0,-1,0,0,1,2,-1
KR_6749546735,420,-1,-22,19,0,0,0,0,1,2,3,-4,6,2,1,1,2,2,0,2,1,9,-3,-2,-3,5,1,0,0,1,1,-1,1,3,-1
KR_6385147711,420,2,10,32,5,0,1,1,-2,4,2,5,2,7,0,4,4,2,1,3,0,5,-12,-5,-3,8,3,0,2,1,-1,1,-1,5,-1
KR_6727791139,420,-2,-32,-20,-3,-3,3,0,-2,5,3,-3,3,0,3,2,5,2,2,4,0,4,-1,-1,-2,3,-2,0,0,0,0,0,1,0,-1
KR_6760647466,440,0,-34,44,-4,0,0,0,-1,2,1,-6,6,0,3,2,5,0,1,1,0,-2,-416,-1,0,1,0,0,0,-1,1,1,-1,5,-1
KR_6740126819,420,-5,-67,0,-9,0,2,2,-2,3,1,-3,3,0,-3,3,0,-1,1,0,0,-14,9,4,-6,2,-10,0,-2,-1,-1,-1,-1,5,-1
KR_6672589334,420,-2,-74,-5,-6,-5,6,1,0,3,3,-4,5,1,3,1,4,0,3,3,0,-16,-16,3,-7,4,3,0,-1,1,-1,-1,1,2,-1
KR_6725460193,420,-3,-21,-1,-4,4,2,6,-1,1,0,-6,8,2,-1,3,2,0,1,1,-1,-4,-24,-1,-3,4,-1,0,-1,1,-1,-1,-1,1,-1
KR_6761072351,420,-3,-62,-30,-4,0,1,1,0,1,1,-2,3,1,-1,4,3,-1,1,0,0,-6,-2,0,-4,4,0,0,-1,-1,-1,-1,-1,1,-1
KR_6758079684,420,2,-15,-14,7,4,2,6,5,0,5,3,3,6,-3,3,0,-2,2,0,1,0,-1,0,-3,3,-2,0,1,1,1,1,1,6,-1
KR_6680085538,420,-3,-39,-28,-7,0,0,0,-4,5,1,1,1,2,-2,2,0,-2,2,0,0,-15,5,2,-5,3,-2,0,0,-1,1,0,1,6,-1
KR_6663978340,420,-7,-64,-13,-14,-2,3,1,-6,7,1,0,1,1,-8,8,0,2,0,2,0,-13,7,-3,0,3,1,0,-2,-1,-1,-1,-1,5,-1
KR_6745487624,420,-5,-10,-13,-9,-3,6,3,-4,6,2,-3,5,2,2,0,2,-1,2,1,0,-7,2,-4,-2,6,7,0,-3,-1,-1,-1,-1,5,-1
KR_6665456256,420,-3,-43,4,-4,-1,1,0,1,1,2,-3,7,4,0,1,1,-1,1,0,0,-3,-7,0,-3,3,3,0,0,0,0,0,1,0,-1
KR_6223572271,440,-1,-86,-1,-5,0,0,0,-2,3,1,1,2,3,-7,7,0,3,1,4,-1,-3,-8,-6,-1,7,2,0,0,1,-1,0,-1,2,-1
KR_6622901234,440,-3,-17,-8,-6,-1,5,4,-4,5,1,4,0,4,-5,5,0,0,1,1,0,-9,4,1,-7,6,-5,0,-1,0,1,-1,1,0,-1
KR_6634937221,440,1,-41,20,1,1,0,1,1,2,3,-2,3,1,4,1,5,-3,3,0,0,7,-35,-2,-4,6,4,0,0,-1,0,0,1,5,-1
KR_6761621709,440,0,-41,9,-1,-1,5,4,6,1,7,-4,5,1,1,4,5,-3,3,0,-1,2,-2,1,-3,2,0,0,-1,-1,-1,-1,-1,6,-1
KR_6756492366,420,2,7,16,0,-2,3,1,-3,3,0,6,1,7,1,2,3,-2,2,0,0,-6,0,-4,0,4,4,0,0,-1,-1,0,-1,6,-1
KR_6676143395,440,-3,-31,-12,-5,2,1,3,-6,7,1,-3,6,3,2,1,3,0,0,0,0,-9,-5,1,-4,3,-3,0,0,1,-1,-1,-1,3,-1
KR_6752294501,420,0,-49,-5,-5,1,2,3,4,1,5,-3,3,0,-5,6,1,-2,3,1,0,-11,240,-3,-1,4,-3,0,0,-1,1,1,-1,2,-1
KR_6677071176,420,2,43,-28,3,0,2,2,-2,4,2,1,2,3,3,1,4,1,1,2,0,6,7,-4,-4,8,4,0,1,0,-1,1,-1,0,-1
KR_6724482581,420,-5,-98,7,-10,-4,5,1,-4,4,0,0,1,1,-2,2,0,0,1,1,0,-6,-262,-5,-2,7,4,0,-2,1,-1,-1,-1,1,-1
KR_6754037003,420,-3,-26,4,-5,3,0,3,-1,2,1,-3,4,1,-3,5,2,-1,1,0,0,-6,6,4,-8,4,-1,0,-1,-1,-1,-1,1,2,-1
KR_6569976486,420,-3,-26,-16,-6,1,2,3,-1,5,4,-3,4,1,-2,5,3,-1,2,1,0,-13,11,-1,-5,6,-4,0,-1,-1,1,-1,1,5,-1
KR_6647599498,420,-1,-69,-12,0,1,0,1,2,1,3,0,3,3,-3,7,4,0,1,1,0,4,-42,0,-5,5,15,0,0,-1,1,-1,-1,5,-1
KR_6730337080,440,0,-9,5,0,-2,5,3,5,0,5,-4,4,0,0,5,5,1,0,1,1,4,27,-2,-3,5,-6,0,0,-1,-1,0,1,6,-1
KR_6740718867,440,2,18,17,3,0,4,4,-1,4,3,6,1,7,-2,5,3,0,2,2,1,-1,-11,-2,-4,6,4,0,-1,0,0,-1,1,0,-1
KR_5856607547,420,-3,-16,13,-7,-4,4,0,1,2,3,-1,3,2,-4,5,1,1,0,1,0,-7,0,2,-6,4,-1,0,-1,-1,-1,-1,-1,5,-1
KR_6761053172,420,2,-21,12,10,1,3,4,-3,3,0,3,0,3,4,0,4,5,0,5,0,6,10,3,-4,1,1,0,0,1,-1,-1,-1,2,-1
KR_6719091092,420,1,-16,1,3,0,0,0,2,0,2,2,1,3,-4,5,1,3,0,3,1,2,-20,-3,-1,4,0,0,0,1,-1,1,1,5,-1
KR_6738405674,440,-2,-15,-4,2,-1,2,1,4,2,6,3,1,4,-3,5,2,-1,2,1,1,11,-28,0,-3,3,17,0,1,1,1,1,1,4,-1
KR_6760620372,420,0,5,9,-1,3,0,3,1,2,3,-1,2,1,-6,7,1,2,1,3,0,-2,-19,-5,-4,9,4,0,0,1,-1,0,1,5,-1
KR_6751880228,420,-2,-44,13,-4,-2,2,0,-1,4,3,-3,3,0,1,3,4,1,1,2,0,1,-6,0,-3,3,2,0,0,0,0,0,-1,0,-1
KR_6734417828,440,0,23,41,0,0,3,3,1,2,3,2,0,2,-3,4,1,0,1,1,0,-5,-1,0,-3,3,2,0,2,-1,1,1,1,3,-1
KR_6741266228,420,-5,-54,-28,-5,-6,7,1,3,3,6,2,4,6,0,4,4,-4,4,0,0,-7,-35,-6,-2,8,23,0,-1,-1,-1,-1,1,1,-1
KR_6764582053,440,-3,-95,8,1,0,0,0,3,3,6,-1,5,4,0,1,1,-1,3,2,0,-5,-30,-2,-3,5,1,0,-1,-1,1,-1,1,2,-1
KR_6729492269,420,-5,-84,-21,-16,-3,3,0,0,3,3,-9,10,1,-5,5,0,1,0,1,0,-4,-3,0,-2,2,-1,0,-3,1,-1,-1,-1,2,-1
KR_6715069213,420,0,-76,8,0,3,0,3,-2,3,1,2,2,4,2,0,2,-5,5,0,0,3,37,0,-6,6,-17,0,-1,1,-1,-1,-1,2,-1
KR_6694491596,420,-4,-94,6,-12,-7,7,0,0,2,2,-2,3,1,-1,2,1,-2,4,2,0,-13,6,-3,-3,6,-1,0,-1,-1,-1,-1,-1,2,-1
KR_6690157812,420,0,-4,10,-4,1,3,4,1,1,2,-3,3,0,-2,3,1,-1,1,0,0,-5,2,3,-5,2,-6,0,-1,0,1,-1,1,0,-1
KR_6762926113,420,-1,-7,11,-5,-1,2,1,4,0,4,-6,7,1,-2,3,1,0,0,0,0,-3,-3,-4,-4,8,2,0,1,1,-1,-1,-1,2,-1
KR_5736961281,420,-3,6,1,-3,-1,1,0,0,1,1,3,1,4,-4,5,1,-1,2,1,1,-8,1,-3,-4,7,-4,0,1,1,-1,-1,1,2,-1
KR_6670017193,420,0,-5,-24,-4,1,0,1,5,0,5,1,1,2,-10,10,0,-1,2,1,0,-7,-3,-2,-7,9,-1,0,-1,-1,-1,-1,-1,2,-1
KR_6679881627,420,2,29,4,1,2,0,2,-1,1,0,2,1,3,-1,1,0,-1,1,0,0,-1,-5,2,-7,5,0,0,1,-1,1,-1,1,3,-1
KR_6675401028,420,2,4,-5,4,-3,4,1,1,1,2,2,2,4,4,1,5,0,2,2,0,8,8,2,-10,8,1,0,1,-1,-1,1,-1,5,-1
KR_6749744447,420,-2,-42,8,-2,-4,4,0,0,2,2,2,2,4,0,3,3,0,0,0,0,4,56,-3,-4,7,-23,0,-1,1,0,-1,-1,1,-1
KR_6712019847,420,-8,-148,-2,-15,-3,4,1,-3,4,1,-5,5,0,0,1,1,-4,6,2,-1,-12,0,0,-2,2,1,0,-1,-1,1,-1,-1,3,-1
KR_6700557250,420,0,-81,21,-3,-1,3,2,5,1,6,-2,3,1,-5,7,2,0,1,1,0,1,9,5,-11,6,-4,0,-1,1,1,-1,-1,3,-1
KR_6705702296,440,-5,-51,-34,-21,-3,4,1,-1,3,2,-1,1,0,-7,9,2,-9,11,2,0,-9,6,-4,-2,6,-6,0,-1,1,0,-1,-1,1,-1
KR_6675423130,420,-1,-13,20,-6,-1,3,2,1,1,2,-3,4,1,-4,7,3,1,1,2,2,2,-107,5,-9,4,-4,0,0,1,1,-1,1,5,-1
KR_6761639298,420,2,2,32,1,2,0,2,4,1,5,-4,6,2,-4,4,0,3,2,5,0,0,-123,-3,-3,6,4,0,0,1,0,0,1,3,-1
KR_6754261817,420,2,66,4,4,2,1,3,0,1,1,-2,3,1,4,3,7,0,1,1,0,2,-1,1,-4,3,3,0,0,1,-1,1,1,2,-1
KR_6746832696,420,-2,36,-4,2,-2,2,0,1,3,4,-1,2,1,3,2,5,1,0,1,0,4,-142,-1,-5,6,-2,0,-2,1,1,-1,1,6,-1
KR_6191911746,420,-5,-16,-29,-7,2,0,2,-2,4,2,-3,3,0,-3,5,2,-1,1,0,0,-5,14,1,-8,7,-6,0,0,1,-1,-1,-1,3,-1
KR_6662805952,420,2,37,8,0,8,0,8,-5,9,4,-2,2,0,-2,2,0,1,2,3,0,-5,3,-2,-6,8,-3,0,1,1,1,1,-1,2,-1
KR_6616992533,420,-6,-75,-16,-12,-7,7,0,-1,1,0,1,2,3,-2,4,2,-3,3,0,0,-1,-6,5,-10,5,-1,0,-1,0,-1,-1,-1,0,-1
KR_6724880187,420,-4,-128,24,-1,0,4,4,1,4,5,-3,4,1,1,4,5,0,1,1,-1,11,13,1,-4,3,-1,0,-3,1,-1,-1,-1,6,-1
KR_6759355345,420,-1,-37,7,2,1,1,2,2,2,4,-3,4,1,1,3,4,1,1,2,0,5,5,2,-7,5,-4,0,-1,0,-1,-1,1,0,-1
KR_6733565161,420,0,-46,-15,-5,-2,4,2,5,1,6,-3,4,1,-1,1,0,-4,4,0,0,0,37,-2,-1,3,-25,0,0,-1,-1,1,-1,4,-1
KR_6761942860,420,-5,-44,5,1,7,0,7,-2,3,1,-2,4,2,-3,3,0,1,0,1,0,-5,2,-2,0,2,-3,0,1,1,1,1,-1,2,-1
KR_6740580141,420,-1,-51,-12,-7,-2,2,0,-1,10,9,1,0,1,-4,6,2,-1,3,2,-1,-12,-4,0,-4,4,-2,0,-1,-1,1,-1,-1,5,-1
KR_6678932319,440,-6,-96,-48,-6,-2,3,1,3,1,4,-6,7,1,0,0,0,-1,1,0,0,7,21,1,-3,2,-5,0,-2,-1,0,-1,-1,4,-1
KR_6760400553,440,-1,-14,0,-13,-5,5,0,-2,3,1,-4,6,2,0,2,2,-2,2,0,0,-11,-205,-3,-1,4,1,0,-1,1,-1,-1,-1,6,-1
KR_6748527935,420,0,20,-5,-1,0,2,2,-3,5,2,-3,4,1,3,1,4,2,1,3,0,1,-1,2,-7,5,-3,0,0,-1,1,0,1,2,-1
KR_6763218473,420,0,-31,-17,3,5,1,6,-2,3,1,1,3,4,0,1,1,-1,1,0,0,5,2,3,-5,2,-2,0,1,-1,1,1,-1,1,-1
KR_6665736134,420,2,18,20,2,1,1,2,0,2,2,-1,2,1,2,2,4,0,0,0,0,1,9,1,-4,3,-2,0,2,0,1,1,1,0,-1
KR_6761098431,420,-6,-27,-15,-15,-2,2,0,-3,4,1,-1,2,1,-8,8,0,-1,1,0,0,-17,-10,-7,-2,9,5,0,0,-1,-1,-1,1,4,-1
KR_6695066135,420,-3,-76,-16,-10,-9,9,0,1,1,2,0,2,2,-3,4,1,1,0,1,0,-9,-16,4,-6,2,1,0,-1,1,1,-1,-1,1,-1
KR_6764370647,420,1,28,16,-5,-1,1,0,-2,4,2,-1,3,2,-1,5,4,0,2,2,0,-12,-110,-5,-1,6,-3,0,0,-1,0,0,1,6,-1
KR_6673719448,420,1,59,20,3,-2,7,5,-5,5,0,2,3,5,7,1,8,1,0,1,0,11,3,-1,-4,5,8,0,0,-1,-1,1,-1,4,-1
KR_6690993013,420,-2,-51,0,-6,-2,3,1,1,2,3,4,2,6,-7,7,0,-2,2,0,0,-11,-7,1,-4,3,2,0,0,-1,1,0,-1,6,-1
KR_6763281430,420,2,-10,39,1,-2,2,0,-2,4,2,1,1,2,4,0,4,0,0,0,0,8,8,-1,-4,5,-1,0,1,-1,-1,1,-1,3,-1
KR_6733710952,420,-1,20,-8,-3,2,2,4,0,3,3,-3,3,0,-1,3,2,-1,1,0,0,-6,-14,-3,0,3,1,0,2,-1,1,1,-1,6,-1
KR_6689516105,420,-3,-87,-10,-5,-2,2,0,2,5,7,-1,3,2,3,2,5,-7,7,0,0,-2,8,1,-5,4,-5,0,0,-1,1,0,1,4,-1
KR_6750173651,420,-3,-141,-4,-12,-6,6,0,1,3,4,0,0,0,-7,7,0,0,0,0,-1,-10,-17,-2,-1,3,1,0,-3,-1,-1,-1,-1,4,-1
KR_6755431386,420,-3,42,-27,-6,-2,4,2,1,1,2,-1,2,1,-3,6,3,-1,2,1,0,-14,371,-1,-1,2,-2,0,0,1,1,0,-1,5,-1
KR_6757688762,420,-1,49,-34,-8,5,1,6,-4,4,0,-1,3,2,-7,8,1,-1,1,0,-1,-11,0,3,-6,3,-4,0,0,-1,1,1,-1,5,-1
KR_6746115651,420,-1,-57,8,-3,0,1,1,2,0,2,-8,8,0,2,0,2,1,0,1,0,3,7,1,-4,3,-2,0,-2,-1,0,-1,-1,4,-1
KR_6746767890,420,-1,-51,-36,0,-2,6,4,3,0,3,-4,6,2,2,2,4,1,0,1,0,11,-29,-1,-4,5,12,0,0,0,1,-1,-1,0,-1
KR_6748039069,420,0,28,-28,0,-2,2,0,9,0,9,-2,2,0,-6,8,2,1,0,1,-1,5,30,5,-7,2,-18,0,-1,-1,-1,-1,-1,2,-1
KR_6751091205,420,-3,-20,-8,-16,0,2,2,-3,3,0,-2,5,3,-7,8,1,-4,6,2,-2,-14,-9,-2,-2,4,-1,0,-2,-1,1,-1,1,2,-1
KR_6597426504,420,-1,1,31,2,0,4,4,0,2,2,5,1,6,-3,3,0,0,0,0,0,-1,10,2,-5,3,-4,0,0,-1,0,0,1,3,-1
KR_6711657526,420,-4,-5,-20,-9,-4,5,1,-3,6,3,0,3,3,1,2,3,-3,3,0,0,-18,-2,-2,-3,5,2,0,0,-1,1,-1,-1,6,-1
KR_6740058295,420,-8,-83,-42,-22,-3,3,0,-6,9,3,-3,5,2,-10,10,0,0,2,2,0,-15,-190,-8,-1,9,0,0,-4,0,-1,-1,-1,0,-1
KR_6670248669,420,-5,-70,-28,-11,-4,6,2,-1,1,0,-5,7,2,0,2,2,-1,1,0,0,-11,-8,-8,0,8,1,0,-2,-1,-1,-1,-1,2,-1
KR_6727383180,420,-4,-77,-32,-3,0,1,1,-1,2,1,1,1,2,-1,3,2,-2,3,1,0,-2,-13,-4,-2,6,-3,0,-1,1,-1,-1,1,1,-1
KR_6760770972,420,-1,-62,20,-4,0,1,1,1,2,3,-1,3,2,-5,9,4,1,3,4,1,-10,-14,-6,0,6,-3,0,0,-1,1,-1,1,5,-1
KR_6737045093,420,-4,-59,3,-7,-2,3,1,0,5,5,-5,6,1,1,7,8,-1,4,3,0,-10,-2,-2,-2,4,-1,0,0,1,1,0,-1,5,-1
KR_6633477414,420,0,44,4,-3,-1,2,1,-1,2,1,-1,7,6,0,1,1,0,3,3,0,-7,3,-10,-1,11,4,0,0,-1,-1,1,1,5,-1
KR_6687277181,420,-3,-11,-4,-10,-3,4,1,-1,4,3,-6,6,0,-1,1,0,1,1,2,0,-10,19,-5,-2,7,2,0,1,-1,1,1,1,1,-1
KR_6745693046,420,-1,-12,4,0,3,3,6,0,5,5,0,2,2,-3,3,0,0,1,1,0,-5,-54,1,-5,4,13,0,1,-1,1,1,-1,1,-1
KR_6690076949,420,0,-17,-12,1,-2,2,0,-2,3,1,2,2,4,1,3,4,2,0,2,0,5,22,2,-5,3,1,0,0,-1,1,1,1,6,-1
KR_6730639886,440,-2,-11,-12,-5,-1,3,2,-1,3,2,2,2,4,-4,5,1,-1,2,1,0,-7,-15,1,-4,3,2,0,0,1,1,0,-1,4,-1
KR_6401308000,440,-1,-14,-13,3,1,0,1,1,1,2,0,3,3,2,2,4,-1,1,0,0,4,-16,-1,-4,5,0,0,0,-1,1,0,1,1,-1
KR_6704953633,420,0,-1,-14,0,0,7,7,2,0,2,-2,2,0,1,2,3,-1,2,1,0,0,-19,-2,-4,6,2,0,-1,-1,-1,1,-1,5,-1
KR_6458631939,420,-4,-29,-32,-7,1,1,2,-3,4,1,-5,5,0,-2,2,0,2,0,2,0,-9,-29,2,-4,2,-2,0,0,-1,1,-1,-1,1,-1
KR_6688624418,440,1,-3,-33,3,3,1,4,-1,6,5,3,4,7,-1,3,2,-1,1,0,0,-3,-41,5,-7,2,23,0,1,-1,1,1,-1,3,-1
KR_6665607955,440,-1,-25,18,-7,0,1,1,-1,4,3,2,0,2,-6,10,4,-2,2,0,0,-21,-67,-1,-5,6,0,0,1,1,1,1,1,4,-1
KR_6764685135,420,-5,0,-36,-10,-2,3,1,-3,3,0,-1,1,0,-4,6,2,0,2,2,0,-11,34,-1,-2,3,-22,0,1,0,-1,1,-1,0,-1
KR_6690230672,420,-4,28,-22,-5,-2,3,1,-1,3,2,-5,5,0,1,0,1,2,0,2,0,1,5,0,-3,3,0,0,1,-1,-1,1,-1,6,-1
KR_6724446467,440,0,-6,10,-4,-4,4,0,-5,7,2,0,1,1,2,3,5,3,0,3,0,-2,0,-2,-1,3,1,0,-1,0,-1,-1,1,0,-1
KR_6753806276,420,-2,-87,25,3,2,2,4,5,0,5,-1,2,1,-2,4,2,-1,2,1,0,7,-10,3,-8,5,2,0,1,-1,1,1,1,5,-1
KR_6730562521,440,1,28,-4,1,2,1,3,-3,7,4,-1,3,2,0,1,1,3,0,3,0,-2,3,5,-7,2,3,0,-1,-1,1,-1,-1,1,-1
KR_6754468145,420,0,-1,-5,-2,-1,3,2,-3,4,1,1,0,1,2,3,5,-1,3,2,0,-4,49,2,-4,2,-32,0,2,0,0,1,1,0,-1
KR_6748818661,420,-2,37,2,-5,0,2,2,3,3,6,-4,6,2,-6,6,0,2,0,2,0,-7,-2,1,-3,2,-3,0,2,-1,1,1,-1,4,-1
KR_6727040451,420,2,49,-40,6,-1,1,0,0,2,2,-1,2,1,10,0,10,-2,2,0,0,10,6,4,-7,3,2,0,1,-1,-1,1,1,4,-1
KR_6715680219,420,-3,-104,-21,-1,-1,2,1,-3,4,1,-5,8,3,6,1,7,2,1,3,0,4,-180,1,-3,2,-3,0,-1,1,-1,-1,-1,1,-1
KR_6757465462,420,-3,12,4,-5,-4,5,1,-2,2,0,2,0,2,0,3,3,-1,2,1,0,-4,-25,-2,0,2,2,0,0,-1,-1,-1,1,4,-1
KR_6557608902,440,-3,-89,-18,-14,-4,4,0,0,1,1,-3,3,0,-11,11,0,4,2,6,0,-6,-19,-9,-2,11,0,0,-1,0,-1,-1,-1,0,-1
KR_6731595129,420,0,3,-9,0,-4,4,0,7,1,8,-6,8,2,1,2,3,2,1,3,1,4,7,-3,-3,6,-27,0,0,1,1,0,1,5,-1
KR_6674009507,420,0,70,16,-3,1,1,2,-3,4,1,0,3,3,-1,2,1,0,0,0,-1,-6,270,0,-4,4,1,0,1,-1,0,1,-1,1,-1
KR_6673204023,420,-4,-44,-48,-2,0,3,3,-1,3,2,4,2,6,-5,7,2,0,0,0,0,3,9,1,-3,2,-2,0,0,-1,-1,-1,-1,5,-1
KR_6761655231,440,-2,13,-35,-5,-1,1,0,-3,5,2,3,1,4,-3,4,1,-1,1,0,0,-3,1,7,-10,3,-4,0,-1,-1,-1,-1,-1,5,-1
KR_6759003671,440,-4,-110,-5,-9,-4,5,1,2,2,4,-4,4,0,0,1,1,-3,3,0,-1,-4,-8,-1,-1,2,0,0,-1,-1,1,-1,-1,1,-1
KR_6638852763,420,1,-61,41,-1,-2,3,1,-4,5,1,4,0,4,1,0,1,0,0,0,0,-6,0,0,-6,6,1,0,-1,1,-1,-1,1,2,-1
KR_6749341814,420,0,-91,-24,-1,0,1,1,0,2,2,3,2,5,-3,3,0,-1,1,0,0,-3,-10,-2,-4,6,-1,0,-2,0,0,-1,-1,0,-1
KR_6705606486,420,-5,-32,-11,-11,-7,7,0,1,4,5,0,2,2,-4,6,2,-1,2,1,0,-14,34,-2,-2,4,-16,0,-2,-1,-1,-1,-1,2,-1
KR_6626977314,420,2,-2,30,0,3,0,3,3,2,5,-5,5,0,-1,4,3,0,0,0,0,0,-10,-5,-1,6,-2,0,1,-1,1,1,-1,6,-1
KR_6546499754,420,-1,-66,5,-4,-4,5,1,-1,4,3,0,2,2,-1,2,1,2,0,2,0,1,4,3,-6,3,-1,0,0,-1,-1,-1,1,1,-1
KR_6395782204,420,2,34,-28,-1,1,0,1,-6,9,3,4,1,5,3,0,3,-3,3,0,0,7,-89,-1,-5,6,-3,0,1,-1,-1,1,-1,3,-1
KR_6742527888,420,-5,-36,-40,-14,0,2,2,-6,6,0,-5,7,2,-3,5,2,0,1,1,0,-11,-13,1,-4,3,-1,0,0,-1,-1,-1,-1,3,-1
KR_6746567646,420,0,-29,8,0,0,3,3,-1,2,1,3,0,3,-2,4,2,0,0,0,0,2,-53,-4,-4,8,25,0,-1,1,-1,-1,-1,3,-1
KR_6701800658,420,-3,-60,2,-6,1,1,2,1,0,1,-2,3,1,-4,5,1,-2,2,0,0,-3,-257,-1,-4,5,-4,0,-5,-1,-1,-1,-1,1,-1
KR_6567934740,420,-5,-92,-25,-10,-4,5,1,-8,10,2,-3,5,2,5,5,10,0,2,2,1,-8,42,-2,-4,6,-17,0,-1,-1,-1,-1,-1,5,-1
KR_6758325101,420,-2,48,-32,-5,-3,4,1,0,4,4,-1,2,1,-1,6,5,0,0,0,0,-3,3,-2,-7,9,0,0,-1,-1,-1,-1,-1,1,-1
KR_6634986846,420,-1,3,-4,-16,0,1,1,-2,4,2,-3,6,3,-10,14,4,-1,1,0,-2,-19,2,-2,-3,5,-1,0,-2,-1,0,-1,-1,5,-1
KR_6721323173,420,1,-7,-32,6,0,6,6,-2,4,2,6,3,9,3,1,4,-1,3,2,2,2,15,5,-7,2,-5,0,1,1,1,1,1,2,-1
KR_6712667702,440,-5,-49,4,-6,-3,5,2,-2,3,1,-2,4,2,-4,6,2,5,1,6,1,-5,-2,-3,-1,4,-1,0,-2,-1,-1,-1,1,3,-1
KR_6749013741,440,-1,-63,-20,-4,-2,4,2,-5,8,3,1,1,2,2,2,4,0,3,3,0,-4,-9,3,-9,6,-3,0,0,-1,1,-1,1,4,-1
KR_5811250814,420,0,-27,-40,4,0,1,1,5,0,5,-3,8,5,3,0,3,-1,2,1,0,9,-41,6,-7,1,23,0,-1,1,-1,-1,-1,2,-1
KR_6739444489,420,2,10,1,1,-1,3,2,3,0,3,3,1,4,-7,8,1,3,1,4,0,-3,5,1,-5,4,-4,0,0,-1,-1,0,-1,4,-1
KR_6645646430,420,-3,-3,-10,-5,-5,5,0,0,2,2,-2,4,2,0,1,1,2,0,2,0,-6,-5,-1,-5,6,7,0,0,-1,1,-1,-1,4,-1
KR_6759443645,420,-2,-27,-10,-4,-2,4,2,-2,2,0,-3,3,0,3,1,4,0,0,0,0,-5,39,0,-4,4,0,0,-1,-1,-1,-1,-1,1,-1
KR_6684131614,420,-4,-51,-25,2,4,1,5,4,1,5,-3,5,2,0,2,2,-3,4,1,3,12,-2,-4,0,4,1,0,-1,-1,-1,-1,1,5,-1
KR_6751896248,420,-5,-66,-40,-7,0,1,1,-4,4,0,0,0,0,-3,5,2,0,2,2,0,-9,-400,0,-3,3,-1,0,-1,-1,0,-1,-1,4,-1
KR_5822389498,420,1,-73,-10,10,-2,3,1,2,0,2,1,3,4,2,1,3,7,1,8,2,16,-1,3,-3,0,0,0,-1,1,-1,-1,1,3,-1
KR_6760464127,420,-7,-77,-4,-12,-1,2,1,-1,1,0,-7,7,0,-1,4,3,-2,3,1,0,-6,16,5,-8,3,-5,0,-3,-1,-1,-1,-1,4,-1
KR_6750166942,420,3,61,28,3,2,0,2,0,1,1,2,4,6,0,2,2,-1,2,1,-1,1,4,3,-10,7,-6,0,1,1,-1,-1,-1,1,-1
KR_6508357784,420,-4,-142,-11,-5,2,0,2,-1,2,1,-1,3,2,-5,5,0,0,0,0,0,-7,-3,-2,0,2,0,0,-2,-1,0,-1,1,2,-1
KR_6763870678,420,-2,-48,-37,-3,-2,3,1,6,0,6,3,1,4,-3,8,5,-7,7,0,-1,-10,0,-1,-4,5,-3,0,-1,-1,-1,-1,-1,2,-1
KR_6743340768,420,-5,-38,-40,-13,-1,1,0,-4,5,1,-1,2,1,-7,8,1,0,1,1,0,-9,4,5,-7,2,1,0,0,-1,1,0,-1,6,-1
KR_6748577049,420,-6,-77,7,-18,-1,1,0,-2,3,1,-7,9,2,-2,4,2,-6,7,1,0,-15,3,-2,-4,6,-1,0,-1,1,1,-1,-1,6,-1
KR_6733309066,420,-2,-62,16,-4,0,1,1,-3,7,4,2,1,3,-3,4,1,0,1,1,-1,-9,4,-4,-5,9,0,0,-1,1,0,-1,-1,2,-1
KR_6725768254,420,-6,-53,4,-10,2,3,5,-4,5,1,-2,4,2,-8,8,0,2,0,2,0,-9,-2,-1,-2,3,-3,0,-1,0,-1,-1,-1,0,-1
KR_6734440625,420,3,37,42,3,-1,2,1,1,1,2,-3,4,1,4,1,5,2,1,3,0,3,-25,9,-12,3,-1,0,1,1,1,1,1,6,-1
KR_6648542643,420,-1,-34,16,-9,-3,3,0,1,2,3,-2,2,0,-6,6,0,1,1,2,0,-6,1,-4,-3,7,0,0,1,-1,1,1,1,1,-1
KR_6748706197,440,-5,-61,-16,-7,-2,2,0,-1,3,2,-4,4,0,0,3,3,0,0,0,0,3,2,2,-3,1,2,0,-1,-1,0,-1,-1,6,-1
KR_6736175318,420,3,46,28,5,0,1,1,-3,5,2,2,1,3,6,1,7,0,1,1,0,5,40,-1,-5,6,0,0,1,1,-1,1,1,3,-1
KR_6751145126,420,-3,-55,4,-1,2,0,2,-3,5,2,0,2,2,0,1,1,0,0,0,0,-2,-19,-1,-5,6,-1,0,-1,0,1,-1,1,0,-1
KR_6745779316,420,-2,-48,-6,-9,-6,6,0,-4,4,0,-1,4,3,1,0,1,1,0,1,0,-7,-21,-7,-1,8,2,0,-2,0,-1,-1,-1,0,-1
KR_6733465486,420,-4,-71,23,-12,-3,3,0,1,3,4,-9,9,0,-1,4,3,0,2,2,1,-11,-5,2,-4,2,-4,0,0,-1,1,-1,1,4,-1
KR_6726190133,440,4,6,3,4,-3,4,1,4,1,5,2,0,2,1,2,3,0,2,2,0,4,1,-5,0,5,2,0,0,0,-1,0,-1,0,-1
KR_6734874411,420,-1,-3,-7,-8,0,3,3,-2,5,3,1,1,2,-7,11,4,0,3,3,-3,-12,-1,3,-4,1,-6,0,0,1,-1,-1,1,3,-1
KR_6750745912,440,0,30,-11,-3,2,1,3,-3,4,1,-3,3,0,1,0,1,0,0,0,0,-5,-40,1,-5,4,6,0,0,1,-1,0,-1,1,-1
KR_6692092479,440,0,-26,21,1,2,1,3,-3,5,2,2,5,7,-4,4,0,4,1,5,1,-8,-9,1,-4,3,2,0,1,-1,1,1,1,4,-1
KR_6754228046,420,1,53,16,-1,1,2,3,1,2,3,-3,5,2,1,0,1,-1,1,0,-1,0,26,-2,-3,5,-13,0,0,-1,-1,0,-1,3,-1
KR_6679029894,420,-3,-51,-4,1,-4,4,0,1,1,2,0,1,1,3,5,8,1,0,1,0,4,8,1,-5,4,1,0,0,1,1,0,1,6,-1
KR_6725473788,420,-1,-6,3,-5,1,2,3,0,2,2,-1,2,1,-3,4,1,-2,3,1,-1,-9,11,4,-6,2,-5,0,-1,0,1,-1,-1,0,-1
KR_6617088805,420,4,55,8,-2,2,0,2,0,1,1,0,5,5,0,3,3,-4,4,0,1,-5,-2,3,-5,2,-2,0,-1,-1,-1,-1,1,1,-1
KR_6758612905,440,2,15,36,3,1,0,1,5,0,5,2,3,5,-5,6,1,0,2,2,0,3,7,-1,-6,7,1,0,-2,-1,0,-1,1,6,-1
KR_6588244633,420,-3,-29,-27,-6,1,0,1,3,1,4,-9,9,0,-2,2,0,1,0,1,0,-8,-13,2,-5,3,-7,0,-1,-1,-1,-1,1,6,-1
KR_6597369588,420,1,-30,-2,-3,1,2,3,2,1,3,-6,7,1,3,6,9,-3,3,0,0,-1,0,-3,-1,4,1,0,0,-1,1,1,-1,2,-1
KR_6652025954,420,-3,-60,-20,-8,-1,1,0,1,2,3,-2,4,2,-4,5,1,-2,2,0,0,-8,-1,0,-3,3,-2,0,0,-1,1,0,-1,3,-1
KR_6685885343,420,0,-7,-12,-1,-1,1,0,-2,4,2,-2,3,1,1,3,4,3,0,3,0,2,-6,-7,0,7,3,0,0,-1,-1,1,1,4,-1
KR_6740662057,440,4,-10,20,3,1,1,2,-2,6,4,2,1,3,0,2,2,2,0,2,1,5,-2,-4,-3,7,0,0,1,1,1,1,1,3,-1
KR_6710959386,420,-4,-60,-43,-12,0,2,2,-4,5,1,0,1,1,-7,7,0,-1,2,1,0,-9,1,-1,-2,3,0,0,-2,-1,-1,-1,-1,6,-1
KR_6676931714,420,-5,25,-52,-10,-7,8,1,-3,4,1,1,0,1,-2,3,1,1,2,3,0,-8,1,5,-6,1,-3,0,-1,1,-1,-1,-1,2,-1
KR_6659083732,420,-2,-46,-8,-7,-3,5,2,2,2,4,-2,3,1,-5,7,2,1,2,3,0,-1,-2,-3,-1,4,1,0,0,-1,-1,-1,-1,3,-1
KR_6714641493,420,0,56,-10,1,3,1,4,-2,2,0,2,3,5,-2,6,4,0,0,0,0,-5,4,-5,-2,7,1,0,0,1,1,0,-1,5,-1
KR_6716758936,420,-5,-116,16,-8,-5,6,1,0,4,4,-1,2,1,-1,2,1,-1,1,0,2,-7,-15,-3,-4,7,-3,0,-5,-1,-1,-1,1,1,-1
KR_6722300116,440,-2,-14,-8,-5,3,0,3,-4,5,1,-2,3,1,-1,1,0,-1,2,1,-1,-4,6,3,-5,2,-7,0,0,1,0,0,-1,6,-1
KR_6749219360,420,-3,-47,4,-4,-4,5,1,-4,4,0,3,1,4,1,2,3,0,0,0,0,4,-255,-7,-3,10,-6,0,-2,-1,-1,-1,-1,5,-1
KR_6759371786,420,-4,-41,34,-3,-3,3,0,2,0,2,6,2,8,-5,6,1,-3,3,0,0,-11,-17,0,-3,3,-1,0,0,-1,-1,0,-1,1,-1
KR_6760401071,420,-1,-32,11,-4,-2,3,1,3,1,4,-3,3,0,-5,10,5,3,0,3,-1,11,0,-2,-2,4,-3,0,-1,-1,1,-1,-1,3,-1
KR_6745170235,420,-2,0,20,-8,-6,6,0,0,3,3,-1,2,1,1,1,2,-2,3,1,0,-4,-3,-3,0,3,2,0,-1,0,-1,-1,-1,0,-1
KR_6743120539,420,-5,-30,4,-11,-4,4,0,-1,2,1,-2,2,0,-3,4,1,-1,1,0,0,-7,0,-1,-2,3,-3,0,0,1,1,0,-1,4,-1
KR_6747302718,420,0,-46,19,-4,-7,7,0,5,3,8,-4,5,1,2,0,2,0,0,0,-1,-2,-3,-5,-4,9,1,0,-2,1,-1,-1,-1,3,-1
KR_6727983217,420,-1,-14,-4,-5,-1,2,1,-5,6,1,1,2,3,1,4,5,-1,2,1,-1,-5,-132,-3,-4,7,0,0,0,1,1,0,-1,4,-1
KR_6671452924,420,2,-38,-16,9,4,0,4,0,2,2,3,1,4,2,1,3,0,1,1,0,9,5,-1,-2,3,-3,0,-1,-1,-1,-1,-1,3,-1
KR_6732334811,420,-1,-24,4,-6,2,1,3,1,0,1,-5,6,1,-3,3,0,-1,1,0,0,-3,-4,-5,-2,7,4,0,0,-1,-1,1,-1,2,-1
KR_6764443215,420,-5,-56,-12,-12,-1,2,1,2,0,2,-5,5,0,-5,5,0,-3,3,0,-1,-13,3,-4,-3,7,-2,0,-2,0,-1,-1,-1,0,-1
KR_6758615056,420,-3,-40,4,-2,-1,1,0,2,1,3,-3,3,0,-1,3,2,1,1,2,0,-6,241,0,-5,5,-2,0,-1,-1,1,-1,-1,1,-1
KR_6672497841,420,-5,-120,-40,-11,-5,5,0,0,1,1,-3,4,1,-2,3,1,-1,2,1,0,-5,1,-3,-2,5,0,0,-2,-1,-1,-1,-1,4,-1
KR_6762930985,420,-4,-54,6,-9,-3,6,3,-3,6,3,-9,10,1,10,0,10,-4,5,1,-1,-7,-6,-1,-4,5,-4,0,-3,-1,-1,-1,-1,5,-1
KR_6749096637,420,-1,-14,-22,-3,1,2,3,-4,4,0,5,3,8,-6,8,2,1,0,1,1,-3,30,2,-3,1,-20,0,1,-1,1,1,1,1,-1
KR_6757820127,420,-1,-106,-14,1,2,1,3,-1,5,4,-2,3,1,3,1,4,-1,2,1,0,3,2,-2,-4,6,-1,0,-1,1,0,-1,-1,1,-1
KR_6750938361,440,-3,-96,-48,1,1,0,1,4,1,5,0,2,2,-3,4,1,-1,2,1,-1,-1,-2,-3,-2,5,2,0,0,-1,-1,-1,-1,2,-1
KR_6727710456,440,-6,-65,-20,-12,2,1,3,-2,2,0,-6,8,2,-1,1,0,-5,6,1,0,-10,-23,0,-4,4,0,0,0,-1,-1,-1,1,1,-1
KR_6749153563,420,-7,-108,-4,-13,-1,1,0,-2,3,1,-3,4,1,-6,6,0,-1,1,0,0,-12,10,0,-3,3,-2,0,-3,-1,-1,-1,-1,5,-1
KR_6675919976,420,-1,-21,25,-4,-7,7,0,-1,3,2,-2,3,1,5,1,6,1,0,1,1,2,-134,6,-9,3,4,0,-1,1,-1,-1,1,2,-1
KR_6650030159,420,-3,-77,0,-14,-3,4,1,-3,5,2,0,3,3,-6,7,1,-2,2,0,-1,-15,3,7,-7,0,-1,0,-2,-1,-1,-1,-1,1,-1
KR_6724288072,420,-1,34,-31,-3,-4,6,2,-2,6,4,2,0,2,0,1,1,1,1,2,1,-3,5,1,-6,5,-3,0,0,-1,-1,0,1,3,-1
KR_6758267520,420,-1,-33,1,-4,0,0,0,-6,7,1,2,1,3,0,5,5,0,3,3,0,-3,-1,-6,-1,7,4,0,0,-1,-1,0,1,3,-1
KR_6621873229,420,-6,2,-12,-20,0,2,2,-4,4,0,-3,3,0,-10,10,0,-3,5,2,0,-21,22,2,-4,2,-2,0,-2,-1,1,-1,-1,3,-1
KR_6537757838,420,2,-6,40,3,-1,2,1,0,4,4,0,2,2,2,3,5,2,0,2,0,2,-21,-1,-2,3,0,0,1,1,1,1,1,5,-1
KR_6729703535,420,-1,-12,39,-9,-1,3,2,-3,3,0,-2,5,3,-2,3,1,-1,3,2,0,-14,-5,-6,-3,9,2,0,-2,-1,-1,-1,-1,6,-1
KR_6647723927,420,-2,-37,-21,-9,-1,3,2,-1,4,3,1,2,3,-4,6,2,-4,5,1,0,-11,-2,-2,-4,6,-2,0,-1,-1,-1,-1,1,6,-1
KR_6723678124,420,-1,-35,2,-7,-1,2,1,0,1,1,1,0,1,-8,10,2,1,1,2,0,-8,-9,-7,-3,10,5,0,0,-1,-1,0,-1,2,-1
KR_6748299138,440,-3,-45,0,-3,2,1,3,-4,7,3,-4,7,3,0,4,4,3,0,3,0,2,7,7,-7,0,-5,0,1,0,1,1,-1,0,-1
KR_6669065219,420,-6,-29,-8,-14,-2,5,3,2,2,4,-8,9,1,-3,4,1,-3,4,1,-1,-11,-3,-4,-1,5,-4,0,-3,-1,-1,-1,-1,4,-1
KR_6762703935,420,-3,-100,-12,-14,1,1,2,-6,7,1,-1,2,1,-4,7,3,-4,4,0,0,-18,68,0,-2,2,-2,0,-1,-1,-1,-1,-1,2,-1
KR_6761475895,420,-4,-85,-25,-5,-2,2,0,6,2,8,-2,3,1,-8,9,1,1,2,3,0,-7,-11,-4,0,4,3,0,-2,1,1,-1,1,4,-1
KR_6647795897,420,-4,-37,-16,-6,-1,1,0,-2,4,2,1,1,2,-1,6,5,-3,3,0,0,-7,-27,0,-7,7,-2,0,-2,0,-1,-1,1,0,-1
KR_6742330277,440,-3,-54,-16,-11,0,1,1,-1,2,1,-8,9,1,-2,2,0,0,0,0,0,-8,-14,0,-5,5,3,0,0,-1,-1,0,-1,3,-1
KR_6662367928,420,2,19,-16,5,0,0,0,-2,3,1,2,0,2,6,0,6,-1,2,1,0,11,-1,4,-6,2,-6,0,1,-1,-1,1,-1,6,-1
KR_6743101280,420,-3,-69,-9,-4,1,2,3,1,2,3,2,1,3,-7,7,0,-1,1,0,0,-8,84,-2,-3,5,-4,0,-1,-1,-1,-1,-1,6,-1
KR_6745471382,420,-4,-67,-16,-2,-1,2,1,-7,7,0,0,2,2,4,0,4,2,0,2,0,6,10,7,-9,2,-4,0,0,-1,1,-1,-1,6,-1
KR_6728544268,420,-4,-13,-12,-18,0,0,0,-6,7,1,-1,1,0,-10,11,1,-1,1,0,0,-24,5,-5,-2,7,6,0,0,-1,0,-1,-1,2,-1
KR_6735544148,420,-6,-83,4,-11,-2,3,1,-3,3,0,-3,4,1,-3,4,1,0,0,0,1,-9,-40,1,-4,3,12,0,-2,-1,1,-1,1,5,-1
KR_6752820340,420,2,2,24,1,2,2,4,-1,3,2,-1,3,2,1,1,2,0,0,0,0,-1,-57,0,-1,1,-4,0,2,1,1,1,1,6,-1
KR_6751476217,420,-6,-36,-20,-17,-4,4,0,-2,4,2,-9,9,0,-1,4,3,-1,2,1,1,-10,-8,-3,-1,4,-1,0,-1,-1,0,-1,1,1,-1
KR_6758781478,420,-3,-13,29,-5,-4,4,0,1,1,2,-3,3,0,1,3,4,0,0,0,0,-2,190,-3,-4,7,1,0,0,0,0,0,1,0,-1
KR_6667742943,420,-1,-19,-48,-3,0,0,0,0,2,2,2,2,4,-6,7,1,1,0,1,0,-2,230,-1,-4,5,6,0,-1,-1,-1,-1,-1,6,-1
KR_6598435671,420,0,-63,-20,-3,-5,5,0,3,0,3,-4,7,3,1,2,3,2,0,2,1,-1,-20,0,-3,3,-1,0,-2,-1,-1,-1,1,2,-1
KR_6755367656,420,-6,-90,-29,-4,-2,6,4,0,3,3,1,0,1,-1,4,3,-2,3,1,0,4,-1,2,-4,2,-3,0,-2,0,-1,-1,1,0,-1
KR_6723636005,420,-6,-27,-1,-15,-3,3,0,-1,3,2,-3,4,1,-3,4,1,-5,5,0,1,-15,312,3,-5,2,-5,0,-3,-1,-1,-1,1,5,-1
KR_6756725054,420,-5,-44,-12,-9,1,2,3,-5,6,1,-3,3,0,-1,3,2,-1,1,0,0,-6,-5,-2,-2,4,-2,0,-3,-1,-1,-1,1,5,-1
KR_6741493705,420,-5,-117,28,-7,-5,5,0,2,0,2,-3,4,1,-1,2,1,0,0,0,0,-3,-7,-1,-3,4,0,0,-1,1,1,-1,-1,4,-1
KR_6762565848,420,-3,-50,-16,-6,-4,4,0,-1,2,1,-3,5,2,-1,2,1,3,1,4,-1,-3,40,0,-4,4,-21,0,0,-1,-1,-1,-1,4,-1
KR_6600651006,420,3,61,20,4,-2,2,0,4,2,6,2,3,5,-1,3,2,1,0,1,0,4,-2,-2,-5,7,0,0,1,1,1,1,1,3,-1
KR_6746165856,420,-4,-80,-9,-7,-6,7,1,-1,3,2,-1,3,2,2,0,2,-1,1,0,0,0,-1,0,-3,3,-3,0,-2,-1,-1,-1,-1,6,-1
KR_6348792473,420,-3,-40,12,-11,-2,4,2,-2,2,0,-1,3,2,-6,6,0,0,0,0,0,-3,4,-2,-3,5,-4,0,-2,-1,-1,-1,-1,4,-1
KR_6673803661,420,1,35,-7,3,1,0,1,-4,5,1,4,2,6,1,1,2,1,2,3,0,-9,-34,4,-7,3,0,0,1,0,0,1,-1,0,-1
KR_6709851668,420,-8,-92,-43,-17,0,2,2,-5,7,2,-3,3,0,-10,10,0,1,1,2,-2,-20,-1,1,-4,3,1,0,-2,-1,0,-1,-1,2,-1
KR_6719481408,420,2,27,1,2,2,0,2,1,1,2,3,2,5,-4,5,1,0,3,3,0,0,-2,6,-7,1,-1,0,0,-1,1,0,-1,3,-1
KR_6664157867,420,-3,-79,-12,0,-2,5,3,-4,4,0,-4,5,1,5,2,7,5,2,7,0,4,1,-6,-4,10,-4,0,-2,1,-1,-1,-1,4,-1
KR_6513812100,420,2,-52,-12,5,-1,2,1,1,4,5,2,0,2,2,2,4,1,1,2,0,9,8,0,-6,6,0,0,-2,-1,-1,-1,1,4,-1
KR_6749361907,420,-3,-9,-23,-1,1,1,2,-1,2,1,-2,5,3,2,1,3,-1,2,1,0,1,-9,0,-3,3,-1,0,1,-1,1,1,-1,5,-1
KR_6691962936,420,1,18,3,-3,-3,4,1,-2,8,6,2,4,6,0,2,2,0,2,2,-1,-3,-31,5,-8,3,22,0,0,-1,-1,1,-1,6,-1
KR_6709107419,420,-2,-83,-18,0,-1,1,0,1,1,2,-2,3,1,-2,3,1,4,0,4,0,5,-15,-2,-2,4,4,0,0,-1,1,0,-1,6,-1
KR_6718471228,420,4,73,36,3,7,1,8,3,0,3,0,0,0,-4,4,0,-3,4,1,0,-5,-252,2,-5,3,3,0,2,-1,1,1,1,1,-1
KR_6761910984,440,-4,-73,-11,-14,-1,2,1,0,1,1,2,2,4,-14,16,2,-1,2,1,-1,-27,27,-6,-4,10,-23,0,-1,0,1,-1,-1,0,-1
KR_6754399465,420,0,16,-32,5,1,1,2,2,1,3,2,2,4,1,0,1,-1,1,0,0,3,3,-1,-4,5,1,0,0,-1,1,0,1,1,-1
KR_6681511883,420,0,24,-8,-1,2,2,4,1,1,2,-1,3,2,-1,4,3,-2,2,0,0,-9,25,-3,-1,4,1,0,0,-1,1,-1,1,6,-1
KR_6693414001,420,-4,16,-40,-11,-2,2,0,-7,7,0,-2,4,2,-1,1,0,1,0,1,0,-6,-131,1,-3,2,0,0,-1,1,-1,-1,1,4,-1
KR_6762520061,420,-2,42,6,1,0,2,2,-1,2,1,-3,5,2,5,1,6,0,1,1,0,4,-17,7,-9,2,-1,0,0,-1,-1,0,1,5,-1
KR_6567980877,420,-1,10,20,2,0,1,1,3,2,5,1,2,3,-1,6,5,-1,3,2,0,-4,2,4,-7,3,0,0,0,-1,0,1,1,2,-1
KR_6736420179,420,-4,-98,-11,-11,-2,2,0,2,3,5,-8,8,0,-2,2,0,-1,2,1,0,-8,-3,-3,-2,5,-1,0,-3,1,-1,-1,-1,2,-1
KR_6754700167,420,-8,-113,-18,-14,-2,2,0,0,1,1,-6,7,1,-5,8,3,-1,3,2,0,-8,8,1,-4,3,-3,0,-3,1,-1,-1,-1,3,-1
KR_6659962053,420,-1,-35,-4,-7,-1,2,1,-2,4,2,-1,5,4,-4,4,0,1,0,1,-1,-8,-3,4,-7,3,-3,0,0,-1,1,0,-1,6,-1
KR_6658753115,420,-2,2,15,-4,1,0,1,-3,7,4,0,2,2,-1,1,0,-1,1,0,0,-9,-11,-4,-2,6,2,0,1,-1,1,1,-1,5,-1
KR_6721240014,420,-1,0,0,1,2,0,2,0,2,2,-3,5,2,2,2,4,0,0,0,-1,6,5,2,-4,2,0,0,0,1,-1,0,-1,1,-1
KR_6681213299,440,-4,-57,33,-12,0,3,3,-1,2,1,-1,2,1,-7,7,0,-3,3,0,0,-8,-6,-1,-2,3,-1,0,-3,0,-1,-1,-1,0,-1
KR_6728059028,420,-3,-49,14,-6,-3,5,2,-3,4,1,-3,4,1,-1,4,3,4,0,4,-1,-4,163,1,-3,2,-3,0,0,1,0,0,-1,2,-1
KR_6758331844,440,-3,-25,-20,-12,-3,4,1,-3,4,1,-2,4,2,-3,5,2,-1,1,0,0,-10,2,-1,-2,3,-5,0,0,-1,-1,-1,-1,5,-1
KR_6654270683,420,-1,-20,22,-8,-3,4,1,-4,7,3,4,1,5,-4,8,4,-1,2,1,-2,-7,-7,0,-3,3,2,0,0,-1,1,0,1,2,-1
KR_6500164182,420,-3,-66,-7,-7,-3,4,1,0,1,1,-3,4,1,-1,1,0,0,3,3,0,-3,11,8,-10,2,-5,0,-2,-1,-1,-1,-1,5,-1
KR_6748266894,440,3,44,-8,6,4,2,6,-3,4,1,-5,7,2,5,2,7,5,0,5,-1,-5,-17,2,-3,1,-1,0,1,-1,1,1,-1,6,-1
KR_6681631111,420,0,2,20,-6,-1,2,1,3,1,4,-2,4,2,-3,5,2,-3,3,0,0,-6,0,3,-5,2,0,0,1,-1,-1,1,1,3,-1
KR_6764705080,420,-4,-34,-8,-12,3,1,4,-2,2,0,1,1,2,-12,13,1,-2,2,0,0,-13,-3,3,-3,0,0,0,-1,-1,-1,-1,-1,5,-1
KR_6617053782,420,-1,-37,24,-4,2,1,3,1,0,1,-4,5,1,-2,4,2,-1,1,0,0,0,-4,1,-4,3,-8,0,0,-1,1,-1,-1,2,-1
KR_6729078005,420,3,14,3,1,1,1,2,-4,7,3,2,1,3,2,1,3,0,1,1,0,-1,-38,1,-5,4,-15,0,1,1,-1,1,1,2,-1
KR_6711614253,420,-2,-46,-20,-5,0,0,0,-1,5,4,-5,7,2,-2,2,0,3,0,3,1,2,-2,1,-4,3,-1,0,0,1,-1,0,1,2,-1
KR_6725166116,420,3,-36,-13,10,-2,2,0,2,2,4,4,1,5,3,2,5,3,0,3,0,2,375,-2,-1,3,0,0,0,-1,-1,0,1,6,-1
KR_6716707955,420,1,14,-8,7,-2,2,0,-1,1,0,-1,4,3,10,1,11,1,1,2,0,4,-6,5,-7,2,-1,0,1,1,1,1,-1,5,-1
KR_6664377889,420,-1,-79,12,-6,1,1,2,1,0,1,-1,4,3,-7,7,0,0,0,0,-1,-13,3,-2,0,2,-1,0,1,-1,0,1,-1,6,-1
KR_6760729482,440,0,-34,31,-4,6,0,6,-7,11,4,-2,4,2,0,1,1,-1,1,0,0,-11,5,3,-7,4,-4,0,-1,1,1,1,1,2,-1
KR_6702129737,420,2,5,-20,3,4,0,4,-2,3,1,4,0,4,-3,3,0,0,0,0,0,0,174,3,-5,2,7,0,0,-1,1,0,-1,5,-1
KR_6645240535,420,-1,-2,-12,-1,4,0,4,0,1,1,-6,6,0,1,0,1,0,0,0,0,3,-1,-3,-3,6,-3,0,0,-1,1,1,-1,6,-1
KR_6764473429,420,-4,-70,-2,-7,-4,4,0,1,0,1,1,0,1,-4,4,0,-1,1,0,0,-5,-1,-2,-3,5,-1,0,-2,-1,-1,-1,-1,3,-1
KR_6751917925,420,-3,-49,5,-5,-2,3,1,-1,2,1,-4,5,1,-3,4,1,5,1,6,0,-3,1,1,-6,5,-2,0,0,1,0,-1,1,3,-1
KR_6747819788,420,0,26,-12,-9,-1,2,1,-1,2,1,0,0,0,-7,11,4,0,0,0,-2,-9,102,-2,-2,4,-1,0,1,-1,-1,-1,-1,1,-1
KR_6741231298,440,4,22,0,9,-2,7,5,1,0,1,-1,5,4,6,1,7,5,2,7,1,23,-15,0,-1,1,-1,0,1,1,-1,1,1,3,-1
KR_6762488128,420,-4,-14,8,-13,-4,6,2,-4,4,0,-3,3,0,-1,5,4,-1,1,0,0,-10,9,-3,-1,4,-2,0,-1,-1,-1,-1,1,5,-1
KR_6729270736,420,0,3,4,4,1,2,3,2,0,2,0,5,5,-4,5,1,5,1,6,0,1,8,0,-2,2,-1,0,1,-1,1,-1,1,5,-1
KR_6745969436,420,-3,-14,-2,-6,0,1,1,1,4,5,-8,9,1,1,6,7,0,4,4,0,-3,1,2,-4,2,-5,0,-1,1,1,-1,-1,1,-1
KR_6672746986,440,-1,-71,-1,4,0,3,3,1,2,3,0,2,2,1,1,2,2,0,2,0,1,-3,-1,-2,3,3,0,-1,1,0,-1,1,6,-1
KR_6744388932,420,-8,-164,-10,-16,-5,8,3,1,0,1,-4,4,0,-7,7,0,-1,1,0,0,-15,-6,-4,0,4,-1,0,-3,-1,1,-1,-1,1,-1
KR_6546718596,440,-3,-10,-19,-2,1,0,1,4,6,10,-3,5,2,0,4,4,-4,5,1,1,5,-3,5,-5,0,-1,0,0,1,-1,0,1,4,-1
KR_6758617865,420,-3,-17,0,-9,0,1,1,3,2,5,-10,12,2,-1,4,3,-1,2,1,0,-3,0,-2,-1,3,-1,0,0,-1,1,0,-1,4,-1
KR_6752653730,420,1,11,-34,8,2,2,4,3,0,3,5,1,6,-5,8,3,3,2,5,1,9,6,-2,-1,3,0,0,1,-1,1,1,1,5,-1
KR_6754376164,420,0,29,13,1,2,1,3,2,1,3,2,2,4,-5,6,1,0,0,0,0,1,308,4,-4,0,-3,0,0,1,1,0,1,6,-1
KR_6656049032,420,1,-30,-8,-1,-1,3,2,0,1,1,-4,7,3,1,1,2,3,0,3,0,-10,-2,-2,-3,5,-1,0,1,-1,1,1,-1,5,-1
KR_6576830829,420,1,-3,-8,1,-3,3,0,0,4,4,1,2,3,3,1,4,0,2,2,0,1,-221,0,-2,2,0,0,0,1,1,-1,1,4,-1
KR_6626845896,420,-2,-3,0,-3,-3,3,0,3,1,4,0,2,2,-3,7,4,0,0,0,0,-6,4,0,-3,3,0,0,0,0,0,-1,-1,0,-1
KR_6513878290,420,-1,-64,-28,2,0,1,1,1,4,5,4,3,7,-1,6,5,-2,2,0,0,-3,-9,4,-5,1,-3,0,-1,1,-1,-1,-1,1,-1
KR_6712032534,420,-8,-143,3,-18,-2,6,4,-3,3,0,-9,10,1,-5,7,2,1,2,3,0,-24,1,-2,-4,6,-2,0,-1,-1,0,-1,1,6,-1
KR_6750565205,420,-2,87,-4,-3,-3,3,0,1,0,1,0,0,0,0,2,2,-1,1,0,1,0,-57,0,-3,3,-3,0,0,-1,-1,0,1,2,-1
KR_6622065459,420,-2,-38,-36,1,1,1,2,2,2,4,-2,4,2,-3,5,2,3,0,3,0,5,55,5,-9,4,-1,0,0,-1,-1,0,-1,4,-1
KR_6716456891,440,-4,-46,-14,1,-1,3,2,5,0,5,0,1,1,-1,1,0,-2,6,4,0,3,-6,0,-3,3,-1,0,0,-1,0,0,1,5,-1
KR_6734975014,420,0,-71,12,1,-3,4,1,3,2,5,3,0,3,-1,2,1,-1,1,0,0,3,-44,4,-6,2,20,0,-2,-1,-1,-1,1,2,-1
KR_6458467207,420,-3,-41,-8,-7,-2,4,2,-1,5,4,-1,2,1,-4,6,2,1,0,1,0,-6,19,-1,-2,3,2,0,-1,1,1,-1,-1,2,-1
KR_6652534350,440,1,12,2,1,3,1,4,-2,4,2,2,2,4,-3,5,2,1,1,2,0,4,-3,3,-5,2,3,0,0,1,0,0,1,5,-1
KR_6729614975,420,-4,-59,1,-16,2,3,5,-1,2,1,-7,7,0,-10,10,0,0,1,1,-1,-16,-4,-2,-1,3,-4,0,-2,-1,1,-1,-1,6,-1
KR_6717236811,420,-3,-64,-5,-9,-2,2,0,0,4,4,-5,5,0,-2,2,0,0,1,1,0,-7,4,-1,-1,2,-1,0,-1,-1,0,-1,-1,5,-1
KR_6756522243,420,0,2,45,-7,-1,1,0,-2,3,1,2,5,7,-6,6,0,0,1,1,0,-11,3,-4,-4,8,-1,0,-2,-1,1,-1,-1,4,-1
KR_6697502564,420,-3,-71,-31,-4,0,0,0,1,2,3,0,5,5,-4,4,0,-1,1,0,-1,-5,-21,-3,-1,4,-4,0,0,-1,-1,-1,-1,3,-1
KR_6718218296,420,0,-90,22,2,3,2,5,1,0,1,-1,2,1,-2,3,1,1,0,1,1,4,-9,-3,-5,8,-2,0,0,-1,0,-1,1,2,-1
KR_6649976949,420,4,-1,-4,6,-2,2,0,3,4,7,0,1,1,3,0,3,2,0,2,0,4,-10,-2,-2,4,5,0,1,1,-1,1,1,3,-1
KR_6741298256,420,-4,-28,0,-5,-3,5,2,-2,2,0,6,1,7,-3,4,1,-3,3,0,1,-6,-2,3,-5,2,-3,0,-2,1,-1,-1,1,3,-1
KR_6734817198,440,1,-45,-8,0,-1,2,1,4,2,6,-1,4,3,0,2,2,-2,3,1,0,0,-48,-6,-3,9,19,0,-1,-1,1,-1,-1,4,-1
KR_6762347134,420,-3,-21,12,-8,-3,3,0,-3,4,1,1,2,3,-4,5,1,1,0,1,-2,-12,-2,-3,-6,9,-3,0,0,1,0,0,-1,1,-1
KR_6628780200,420,-2,11,14,-6,0,1,1,-4,6,2,-1,1,0,-1,4,3,0,0,0,0,-17,2,-2,-4,6,-2,0,0,-1,1,0,-1,2,-1
KR_6758319988,420,-2,-95,52,-4,-1,2,1,4,2,6,-1,2,1,-4,5,1,-2,3,1,0,0,-9,-3,-1,4,-2,0,-3,1,-1,-1,-1,6,-1
KR_6760917527,420,-2,47,0,-5,-1,1,0,-1,6,5,0,1,1,-1,5,4,-2,2,0,-2,-11,28,-3,-2,5,-28,0,-2,1,-1,-1,-1,5,-1
KR_6729951721,440,-1,31,-20,-5,1,1,2,-3,5,2,1,0,1,-1,2,1,-3,5,2,0,-2,52,-5,-1,6,-27,0,-1,-1,-1,-1,-1,2,-1
KR_6755758211,420,2,54,28,0,-2,2,0,2,0,2,6,0,6,-6,6,0,0,1,1,0,1,-144,2,-9,7,3,0,0,1,1,0,1,6,-1
KR_6733593163,420,-5,-90,-30,-11,-1,3,2,-1,2,1,-9,9,0,-1,6,5,1,0,1,0,-10,-10,1,-4,3,-1,0,-3,-1,-1,-1,-1,5,-1
KR_6724557333,420,-1,-10,11,-4,4,1,5,-2,3,1,-4,6,2,-1,2,1,-1,2,1,0,2,2,-1,-4,5,-2,0,-2,-1,-1,-1,-1,2,-1
KR_6746934470,420,-2,-89,16,-12,-3,5,2,-4,6,2,-3,3,0,-1,1,0,-1,1,0,0,-15,-327,-4,0,4,-3,0,-1,-1,0,-1,-1,4,-1
KR_6756564802,420,0,-36,-8,-1,0,4,4,-1,3,2,-1,4,3,0,1,1,1,1,2,-1,-5,6,-1,-3,4,-3,0,0,0,1,-1,-1,0,-1
KR_6705085517,420,-2,7,-8,-3,0,4,4,0,2,2,-2,7,5,-1,1,0,0,0,0,0,-7,-2,5,-8,3,-2,0,-2,1,-1,-1,-1,1,-1
KR_6764114048,420,-6,-117,-8,-6,-1,2,1,-4,5,1,2,4,6,-3,3,0,0,0,0,-1,-9,-19,2,-6,4,-1,0,-3,-1,0,-1,-1,4,-1
KR_6727313709,420,-4,-39,-4,-8,-2,4,2,-1,1,0,-2,4,2,-2,2,0,-1,1,0,0,-12,0,-8,-1,9,-3,0,-1,-1,-1,-1,1,5,-1
KR_6760979605,440,2,63,11,5,1,0,1,1,2,3,1,1,2,1,2,3,1,1,2,0,0,-122,-7,-5,12,10,0,2,1,-1,1,1,3,-1
KR_6635230183,420,-1,-2,4,3,1,2,3,-1,2,1,5,0,5,-4,5,1,2,1,3,0,1,-21,1,-5,4,-3,0,0,-1,1,1,1,5,-1
KR_6750755596,420,-2,32,-25,-7,-2,2,0,-5,5,0,1,3,4,3,2,5,-4,6,2,0,-4,55,0,-3,3,-16,0,0,1,-1,1,1,4,-1
KR_6744253734,420,0,-23,31,0,1,1,2,1,4,5,-2,2,0,1,0,1,-1,1,0,1,4,-5,-3,-5,8,3,0,1,1,-1,1,1,2,-1
KR_6626653106,420,1,-35,28,3,1,0,1,2,1,3,1,2,3,0,3,3,-1,1,0,0,6,175,2,-7,5,-1,0,0,1,1,0,-1,5,-1
KR_6727372984,420,-2,-22,-8,-2,1,1,2,2,3,5,-5,5,0,-1,4,3,1,0,1,0,-2,105,5,-6,1,0,0,-1,-1,-1,-1,1,3,-1
KR_6711302930,420,3,-29,7,3,3,1,4,3,0,3,-1,3,2,-1,2,1,-1,1,0,0,0,-50,1,-4,3,3,0,1,1,0,1,-1,3,-1
KR_6758605674,420,2,12,52,-6,-3,3,0,-5,7,2,-1,3,2,-1,3,2,4,0,4,-1,-4,-5,-7,-3,10,-2,0,0,-1,0,0,1,2,-1
KR_6724927819,420,-5,-37,21,-18,-12,13,1,-2,3,1,-2,3,1,-1,8,7,-1,2,1,-5,-32,-7,-1,-3,4,2,0,-2,-1,-1,-1,-1,2,-1
KR_6739895969,420,-6,-120,-55,-10,-1,2,1,-8,8,0,0,1,1,-1,4,3,0,0,0,-1,-13,7,3,-5,2,-2,0,-2,0,-1,-1,1,0,-1
KR_6664438819,420,-3,18,-20,-11,-9,9,0,-2,4,2,-1,1,0,1,0,1,0,0,0,0,1,-235,-7,-2,9,-2,-1,-3,-1,-1,-1,-1,4,-1
KR_6725574600,420,2,-38,-24,3,0,2,2,-1,2,1,5,2,7,0,4,4,-1,1,0,0,4,2,-2,-5,7,3,0,0,1,-1,0,1,3,-1
KR_6745601694,440,-1,-26,-18,-4,0,2,2,0,3,3,-2,2,0,0,1,1,-2,3,1,0,-7,-7,0,-2,2,-2,0,0,-1,1,1,-1,4,-1
KR_6752250232,420,0,40,4,6,2,2,4,-4,4,0,4,1,5,2,3,5,2,0,2,1,7,-4,0,0,0,3,0,2,1,1,1,1,3,-1
KR_6762570386,420,1,11,8,2,6,0,6,1,1,2,-3,5,2,-2,2,0,0,0,0,0,2,2,-3,-1,4,1,0,-1,1,-1,-1,1,3,-1
KR_6684029527,440,-3,-57,-15,-2,0,1,1,2,0,2,-1,2,1,-3,7,4,0,1,1,1,-6,11,-3,-2,5,1,0,-1,0,0,-1,1,0,-1
KR_6644802611,420,0,-6,-3,-4,-1,1,0,-6,6,0,-1,6,5,1,1,2,3,2,5,0,-7,-7,0,0,0,0,0,0,-1,1,-1,1,6,-1
KR_6696215960,440,0,41,-4,-4,0,0,0,-4,5,1,-4,4,0,4,2,6,0,0,0,0,-9,1,0,-2,2,0,0,1,0,-1,1,-1,0,-1
KR_6651958190,420,-1,38,-8,-9,1,2,3,-3,5,2,-1,2,1,-7,9,2,1,2,3,0,-2,-1,3,-5,2,-7,0,0,-1,-1,0,-1,3,-1
KR_6724369770,420,-4,-103,11,-9,-5,5,0,1,1,2,1,0,1,-2,4,2,-4,4,0,0,-10,-40,1,-2,1,24,0,-1,1,1,-1,-1,1,-1
KR_6719530301,420,2,115,15,-2,-4,4,0,-5,6,1,5,3,8,2,0,2,0,2,2,0,-7,8,-2,-4,6,-1,0,0,1,-1,1,1,3,-1
KR_6646444469,420,-8,-86,-63,-19,-4,5,1,-7,8,1,-7,9,2,0,3,3,-1,2,1,-2,-6,115,-5,-2,7,-1,0,-1,1,0,-1,-1,1,-1
KR_6696857491,420,-5,-105,8,-17,-2,3,1,-4,5,1,-4,4,0,-3,4,1,-4,4,0,0,-14,-4,-1,-5,6,-5,0,0,0,-1,-1,-1,0,-1
KR_6757638228,420,-1,-64,20,-9,-5,7,2,2,1,3,-8,8,0,4,1,5,-2,2,0,0,-5,-4,-2,-2,4,0,0,-2,-1,1,-1,-1,3,-1
KR_6746896116,420,-5,-49,-15,-10,-1,3,2,-3,3,0,0,2,2,-3,4,1,-3,4,1,0,-5,-8,-2,-3,5,-3,0,-2,-1,-1,-1,-1,5,-1
KR_6690188157,420,1,-50,40,-2,1,1,2,-1,9,8,-4,4,0,1,2,3,1,1,2,2,1,-2,-5,-2,7,-1,0,-1,1,1,-1,-1,2,-1
KR_6742235124,420,-5,-102,-8,-14,-2,3,1,-3,4,1,-2,3,1,-5,6,1,-2,2,0,-1,-11,18,-1,-1,2,0,0,-2,-1,1,-1,-1,6,-1
KR_6625725266,420,-1,-108,-31,5,-1,2,1,0,1,1,4,0,4,1,1,2,1,0,1,0,3,-1,1,-5,4,1,0,1,-1,1,1,1,3,-1
KR_6749925925,420,1,38,-13,6,3,0,3,5,1,6,1,1,2,-4,6,2,1,0,1,0,5,5,3,-5,2,-2,0,1,0,1,1,-1,0,-1
KR_6716662600,420,-2,41,-18,-7,-1,4,3,-2,3,1,-3,4,1,0,5,5,-1,4,3,2,-11,1,-2,-2,4,0,0,1,0,0,1,1,0,-1
KR_6715564377,420,-1,16,-15,-5,2,0,2,-5,7,2,-2,2,0,0,3,3,0,1,1,0,-6,42,4,-7,3,-1,0,0,0,-1,0,-1,0,-1
KR_6732040877,420,0,-72,-7,-7,2,1,3,-5,6,1,-3,3,0,0,3,3,-1,4,3,0,-14,-4,-1,-4,5,-2,0,0,-1,1,-1,1,2,-1
KR_6762285660,420,-4,-58,0,-7,-4,4,0,-5,5,0,-1,2,1,2,4,6,1,1,2,0,-7,4,3,-4,1,-5,0,0,-1,0,-1,-1,1,-1
KR_6764211056,420,0,-12,-20,-2,3,0,3,5,3,8,-5,5,0,0,4,4,-5,6,1,0,2,8,8,-9,1,-1,0,0,-1,1,-1,1,3,-1
KR_6763321271,420,0,3,4,-2,-3,5,2,2,1,3,2,1,3,-3,3,0,0,1,1,-3,-10,10,6,-7,1,-1,0,-2,-1,1,-1,-1,3,-1
KR_6746174408,420,-1,35,-16,-3,4,0,4,1,1,2,-8,8,0,0,2,2,0,2,2,0,-7,8,2,-4,2,1,0,1,-1,-1,1,-1,2,-1
KR_6758084025,420,1,-32,32,-1,-2,2,0,1,3,4,2,2,4,-2,4,2,0,0,0,0,-4,-108,4,-5,1,0,0,-2,1,-1,-1,1,2,-1
KR_6731380214,420,-2,-82,-12,-8,-2,3,1,-4,7,3,2,1,3,-4,5,1,0,0,0,0,0,-6,-3,-2,5,-3,0,-2,-1,-1,-1,-1,3,-1
KR_6601285962,420,-3,-98,8,-9,-3,3,0,0,5,5,-1,2,1,-4,6,2,-1,3,2,0,-8,-39,-6,-2,8,30,0,-1,-1,-1,-1,-1,5,-1
KR_6694106369,440,0,28,2,-4,-1,4,3,-6,7,1,0,2,2,3,1,4,0,0,0,0,-1,1,2,-5,3,1,0,1,0,1,1,-1,0,-1
KR_6762544883,420,-2,-15,-2,-7,1,0,1,-5,7,2,2,3,5,-4,5,1,-1,1,0,0,-5,11,-2,-3,5,-2,0,0,-1,1,1,1,4,-1
KR_6751029287,420,-3,-1,-22,-7,1,1,2,-1,4,3,-1,2,1,-4,4,0,-2,2,0,0,-5,55,-2,-3,5,1,0,0,-1,0,0,1,3,-1
KR_6750135394,420,-9,-90,-24,-15,-4,4,0,-3,4,1,-3,4,1,-5,5,0,0,3,3,0,-8,2,2,-5,3,-5,0,-2,-1,-1,-1,-1,5,-1
KR_6745723810,440,-2,-82,-6,-3,-2,2,0,0,3,3,-4,4,0,4,3,7,-1,2,1,0,0,-3,5,-7,2,2,0,0,0,0,1,1,0,-1
KR_6695555831,420,-4,14,-26,-9,-4,4,0,-4,7,3,-3,5,2,1,0,1,1,1,2,0,-5,-19,4,-7,3,2,0,-2,-1,-1,-1,-1,4,-1
KR_6706350243,440,0,23,-39,-1,1,0,1,-8,8,0,-1,4,3,4,1,5,3,2,5,-1,-2,-5,-3,-4,7,4,0,0,-1,-1,0,-1,6,-1
KR_6757476274,420,-1,-45,-43,-1,4,2,6,-1,2,1,2,0,2,-3,8,5,-3,3,0,1,2,-2,-5,-3,8,-2,0,-1,1,-1,-1,1,6,-1
KR_6751707520,420,-2,-15,13,-6,-5,6,1,2,2,4,0,1,1,-5,7,2,2,2,4,-1,-12,-4,3,-6,3,-4,0,-1,1,1,-1,-1,5,-1
KR_6731404544,420,-3,-78,-16,-6,-1,2,1,-3,5,2,0,3,3,0,0,0,-2,2,0,0,-11,6,2,-4,2,-4,0,-1,-1,0,-1,-1,3,-1
KR_6672689705,420,-5,-37,-36,-13,0,3,3,-2,2,0,-5,7,2,-2,3,1,-4,4,0,0,-9,-30,3,-5,2,11,0,0,0,1,0,-1,0,-1
KR_6749382498,420,-5,-83,-28,-13,-10,13,3,-2,4,2,-1,2,1,-1,5,4,1,1,2,0,-4,-162,-6,-1,7,0,0,-2,0,-1,-1,-1,0,-1
KR_6738896303,420,-1,6,24,-5,2,0,2,-2,5,3,1,2,3,-6,7,1,0,1,1,0,-5,6,0,-7,7,-6,0,0,-1,1,-1,1,2,-1
KR_6727426557,420,-1,-5,3,1,2,0,2,2,1,3,5,2,7,-8,9,1,0,0,0,0,-3,14,9,-10,1,-5,0,-1,-1,1,-1,-1,4,-1
KR_6740681819,440,1,-21,28,1,-2,3,1,1,1,2,2,0,2,2,3,5,-2,3,1,0,-5,-9,-2,-5,7,-4,0,0,0,1,1,-1,0,-1
KR_6654244764,420,1,51,-8,1,0,3,3,5,0,5,2,0,2,-4,7,3,-2,2,0,1,0,33,0,-3,3,3,0,2,1,1,1,1,3,-1
KR_6641062279,420,-2,-11,-13,-7,-3,3,0,-6,6,0,-1,5,4,1,4,5,2,1,3,0,0,-1,1,-5,4,0,0,-1,1,-1,-1,1,1,-1
KR_6665305619,420,-1,-36,-4,-3,-3,3,0,-4,4,0,2,5,7,1,1,2,1,1,2,0,-5,10,0,-1,1,-2,0,0,-1,-1,0,-1,1,-1
KR_6649160158,420,-1,-62,-30,5,4,1,5,-1,1,0,3,1,4,0,0,0,-1,1,0,1,3,-53,-2,-2,4,28,0,-1,-1,-1,-1,1,3,-1
KR_6670637958,420,-4,6,-18,-6,-1,3,2,-3,4,1,-2,2,0,-2,6,4,2,1,3,-1,-12,-1,2,-7,5,-5,0,-1,0,1,-1,-1,0,-1
KR_6732413609,440,-1,-58,5,5,-1,2,1,-1,2,1,3,0,3,1,1,2,3,0,3,0,4,2,1,-4,3,2,0,0,0,1,0,1,0,-1
KR_6689210008,420,-7,-69,-78,-17,-1,3,2,-4,5,1,-7,7,0,-5,6,1,0,2,2,0,-15,-30,-3,-1,4,-3,0,-1,0,-1,-1,1,0,-1
KR_6750175350,420,-1,-94,24,-4,-6,7,1,0,2,2,1,1,2,-2,5,3,3,0,3,0,-5,-4,-3,-1,4,2,0,0,1,0,-1,-1,3,-1
KR_6731886335,420,-1,34,35,-2,-1,1,0,0,4,4,4,2,6,-3,5,2,-2,5,3,-1,-7,-10,1,-3,2,-2,0,1,1,1,1,-1,5,-1
KR_6727095458,420,1,108,17,6,1,0,1,5,2,7,7,0,7,-3,5,2,-4,4,0,2,8,2,-2,-3,5,5,0,0,0,-1,0,1,0,-1
KR_6758212753,420,0,2,-12,-6,-5,6,1,1,2,3,0,1,1,0,4,4,-2,3,1,-2,-5,13,0,-2,2,-1,0,0,1,1,1,-1,5,-1
KR_6678972768,420,-1,-35,-14,-9,0,2,2,-4,5,1,-2,3,1,-4,4,0,1,0,1,0,-14,12,-2,-4,6,2,0,0,-1,-1,-1,-1,5,-1
KR_6628702501,420,1,37,25,6,-1,3,2,4,0,4,-1,2,1,3,1,4,1,2,3,0,6,-4,-1,-1,2,2,0,1,-1,1,1,1,2,-1
KR_6724556547,420,-1,-53,4,-6,0,2,2,1,1,2,1,2,3,-7,9,2,-1,1,0,0,-8,-28,-4,-3,7,-4,0,0,-1,1,0,-1,6,-1
KR_6682431038,420,-5,-90,0,-6,1,2,3,0,1,1,-7,7,0,1,1,2,-1,2,1,0,-5,-4,1,-2,1,-1,0,-2,0,1,-1,-1,0,-1
KR_6636241765,420,-2,-8,11,4,2,1,3,-5,5,0,2,1,3,-1,2,1,6,0,6,1,7,37,3,-4,1,0,0,0,0,0,0,1,0,-1
KR_6755520513,420,-2,30,4,-4,1,1,2,2,3,5,0,2,2,-7,7,0,0,0,0,0,-5,24,1,-4,3,1,0,1,-1,1,1,-1,1,-1
KR_6762310507,420,-2,-33,4,-4,1,2,3,3,2,5,-4,5,1,-4,4,0,0,1,1,1,-1,-15,-6,-1,7,0,0,1,1,1,1,1,5,-1
KR_6679289172,420,-3,-8,-28,-3,-2,3,1,-2,4,2,-2,2,0,5,1,6,-2,2,0,0,2,-98,-3,-3,6,5,0,0,-1,1,1,1,2,-1
KR_6763629739,420,0,-10,-8,-2,-4,4,0,-1,2,1,-1,1,0,2,1,3,2,0,2,0,-2,130,3,-4,1,-2,0,0,-1,1,0,1,2,-1
KR_6601328897,420,-2,-52,-8,-8,-2,4,2,0,3,3,-1,2,1,-4,6,2,-1,2,1,0,-12,10,1,-3,2,2,0,0,1,-1,0,-1,1,-1
KR_6664690221,420,-2,-24,1,-6,-1,1,0,-2,2,0,1,2,3,-1,1,0,-3,3,0,0,-8,37,-2,-2,4,-5,0,0,1,1,0,-1,1,-1
KR_6761915397,440,-5,-40,-4,-11,-1,4,3,3,2,5,-11,12,1,0,4,4,-2,2,0,0,-4,-16,-4,-1,5,1,0,-1,-1,-1,-1,-1,3,-1
KR_6703969619,420,-3,-70,-3,-11,2,0,2,-3,5,2,-5,5,0,-2,3,1,-3,3,0,-1,-16,2,-5,0,5,-3,0,-3,-1,-1,-1,-1,1,-1
KR_6738450763,420,-2,-36,-22,-2,2,0,2,0,4,4,0,1,1,-4,5,1,0,1,1,-1,-7,6,-4,-3,7,0,0,-1,-1,-1,-1,-1,3,-1
KR_6743648735,420,-3,20,-24,-9,-2,2,0,-4,6,2,-7,7,0,1,2,3,3,0,3,0,-3,49,2,-8,6,-25,0,0,-1,-1,0,-1,3,-1
KR_6756002980,420,-2,-93,-28,-11,-3,3,0,0,1,1,-1,2,1,-8,8,0,1,0,1,-1,-7,-15,-2,-1,3,5,0,-3,-1,-1,-1,-1,2,-1
KR_6746235602,420,-2,-26,8,-10,0,1,1,0,5,5,-6,6,0,-1,4,3,-3,3,0,0,-8,-6,-3,-2,5,-2,0,0,1,0,0,-1,2,-1
KR_6723893182,420,1,48,-1,0,-1,1,0,2,2,4,1,2,3,-2,5,3,0,1,1,1,2,-2,1,-3,2,-2,0,0,-1,-1,0,1,3,-1
KR_6761776328,440,-5,-1,-13,-11,-11,11,0,-2,4,2,-2,3,1,1,3,4,3,1,4,0,-2,-19,0,-2,2,-2,0,0,-1,-1,-1,1,4,-1
KR_6746913504,420,-3,-29,0,-4,0,2,2,0,1,1,-1,3,2,-4,6,2,1,0,1,0,-7,3,0,-4,4,0,0,-3,1,-1,-1,1,3,-1
KR_6752498126,420,-8,-96,-24,-23,-2,4,2,-1,4,3,-6,7,1,-16,16,0,2,0,2,-2,-16,72,-3,-4,7,-12,0,-4,-1,-1,-1,-1,4,-1
KR_6763434569,420,-1,-17,13,-6,0,1,1,-2,4,2,-2,2,0,-1,2,1,-1,2,1,0,-9,6,1,-4,3,0,0,0,0,0,-1,-1,0,-1
KR_6763481870,420,-1,-36,-8,-4,-4,7,3,-3,4,1,2,1,3,0,4,4,1,1,2,0,-2,2,-1,-5,6,2,0,0,1,-1,0,-1,2,-1
KR_6715770729,420,1,-64,-4,4,-1,3,2,-1,2,1,5,4,9,0,2,2,1,0,1,0,15,-4,1,-8,7,-1,0,0,1,1,0,1,1,-1
KR_6704587836,420,-5,-83,0,-12,-5,7,2,1,3,4,4,0,4,-9,9,0,-3,3,0,-1,-14,76,1,-8,7,-2,0,0,-1,1,-1,-1,5,-1
KR_6658828561,420,-1,19,-20,5,0,1,1,3,2,5,2,3,5,1,3,4,-1,2,1,0,6,-8,2,-4,2,-3,0,-1,1,0,-1,-1,3,-1
KR_6688380173,420,-1,-33,4,0,-2,3,1,1,2,3,1,1,2,0,1,1,0,1,1,0,0,-7,-1,-4,5,3,0,0,-1,1,0,1,2,-1
KR_6740766882,420,0,17,-31,7,0,3,3,1,0,1,2,3,5,4,1,5,0,0,0,0,10,37,-2,-2,4,4,0,0,1,-1,-1,1,3,-1
KR_6759198334,420,1,-20,-3,-1,-2,3,1,2,0,2,2,2,4,0,4,4,-3,4,1,-1,-5,3,3,-5,2,2,0,0,0,1,0,-1,0,-1
KR_6751883141,420,1,59,29,5,5,0,5,1,2,3,2,1,3,-1,3,2,-2,2,0,0,-3,2,-3,-3,6,1,0,2,-1,1,1,-1,4,-1
KR_6715504597,420,-5,-88,16,-13,-6,6,0,-4,5,1,0,2,2,-3,7,4,0,2,2,0,-8,-353,2,-3,1,-1,0,-4,-1,-1,-1,-1,4,-1
KR_6748895846,420,-3,19,8,-10,0,1,1,-3,5,2,-2,4,2,-3,4,1,-2,3,1,0,-15,27,-3,-3,6,-2,0,-1,-1,-1,-1,-1,6,-1
KR_6637221652,420,-2,3,10,-10,-1,3,2,1,0,1,-3,4,1,-8,8,0,1,0,1,0,-11,20,2,-7,5,3,0,-1,1,0,-1,-1,4,-1
KR_6696091840,420,-1,-73,-17,-3,1,2,3,0,0,0,0,2,2,-5,5,0,1,0,1,0,-7,-3,-4,0,4,-1,0,0,-1,-1,-1,-1,6,-1
KR_6620293893,420,-2,-20,13,2,-5,5,0,-2,4,2,4,0,4,5,2,7,0,1,1,0,-3,-16,-1,-6,7,7,0,-1,1,-1,-1,1,3,-1
KR_6693999572,420,-1,-15,-15,1,3,0,3,0,6,6,-2,5,3,-1,1,0,1,0,1,0,2,-8,-6,-2,8,0,0,0,0,-1,0,1,0,-1
KR_6751685492,420,-1,-10,-20,-2,-2,4,2,-3,3,0,0,2,2,-2,7,5,5,0,5,0,-8,-4,1,-4,3,0,0,0,-1,0,-1,1,2,-1
KR_6652717645,420,-2,44,5,-1,0,0,0,-1,5,4,1,1,2,-1,4,3,0,2,2,0,-9,-9,-4,0,4,1,0,-1,1,-1,-1,1,5,-1
KR_6762328399,420,1,-38,-4,6,-3,5,2,6,0,6,4,2,6,-1,1,0,0,0,0,-2,5,0,-1,-3,4,-4,0,1,1,1,-1,-1,1,-1
KR_6647777378,420,2,43,36,1,-4,4,0,4,0,4,3,1,4,-6,8,2,4,1,5,0,3,-7,-5,-4,9,0,0,0,1,-1,0,-1,5,-1
KR_6640426596,420,-1,-3,-8,1,0,0,0,0,3,3,1,2,3,-1,5,4,1,0,1,0,0,9,7,-11,4,1,0,0,1,-1,0,1,6,-1
KR_6730269647,440,-5,-126,-4,-18,-3,3,0,0,2,2,-6,6,0,-10,11,1,1,1,2,0,-11,-197,-1,-1,2,-1,0,-3,-1,1,-1,1,3,-1
KR_6762448205,440,-3,-39,-23,-3,-6,7,1,0,6,6,1,2,3,2,2,4,0,1,1,1,3,1,0,-2,2,3,0,-1,-1,-1,-1,1,5,-1
KR_6723009448,420,-3,20,-30,-9,0,1,1,-4,5,1,0,5,5,-3,5,2,-2,2,0,0,-13,-7,-2,-3,5,-3,0,1,1,1,1,-1,5,-1
KR_6715449324,420,-2,13,-4,-5,2,2,4,1,2,3,-3,5,2,-4,4,0,-1,3,2,0,-1,13,1,-5,4,-4,0,-3,-1,-1,-1,-1,1,-1
KR_6741118113,420,0,-8,6,-6,-7,7,0,2,0,2,-2,4,2,3,2,5,-2,3,1,-1,-1,20,4,-5,1,0,0,1,1,1,-1,-1,5,-1
KR_6585632497,420,0,25,-35,1,0,2,2,3,2,5,0,3,3,0,4,4,-2,2,0,0,4,16,-3,-1,4,-2,0,-1,-1,0,-1,-1,3,-1
KR_6497126961,420,-2,-82,7,-5,-6,6,0,2,0,2,0,3,3,-1,4,3,0,0,0,0,2,-1,2,-4,2,1,0,0,0,1,1,-1,0,-1
KR_6726071232,420,2,7,11,-4,2,0,2,-3,3,0,-1,2,1,-1,5,4,-1,1,0,0,-5,6,0,-2,2,0,0,0,0,-1,0,-1,0,-1
KR_6762215912,420,3,10,8,4,1,2,3,3,1,4,1,3,4,0,1,1,-1,2,1,0,7,4,0,-1,1,-1,0,-1,-1,1,-1,1,2,-1
KR_6697408196,420,6,28,24,4,-2,3,1,2,0,2,0,2,2,0,3,3,4,0,4,0,4,3,-1,-3,4,3,0,1,-1,1,1,-1,3,-1
KR_6619739021,420,-1,-15,7,-4,-1,4,3,-1,4,3,-6,8,2,5,0,5,-1,1,0,0,-7,1,0,-4,4,-2,0,-2,1,-1,-1,-1,6,-1
KR_6738275490,420,-4,-43,-12,-9,0,1,1,0,2,2,-9,9,0,1,2,3,-1,1,0,0,-9,-8,-4,-3,7,-3,0,-1,-1,-1,-1,-1,3,-1
KR_6726812239,440,-3,-50,4,-5,-3,3,0,-1,4,3,-1,1,0,-1,3,2,1,0,1,0,-3,-15,-7,-4,11,2,0,0,-1,0,0,-1,3,-1
KR_6747186132,420,-4,-75,-15,-8,-2,2,0,0,1,1,-3,5,2,-1,1,0,-2,2,0,-1,-11,163,2,-6,4,-6,0,-1,-1,-1,-1,-1,3,-1
KR_6754070948,420,-5,-43,-4,-15,-4,4,0,3,1,4,-4,5,1,-10,12,2,0,1,1,0,-18,-10,-7,0,7,0,0,-1,0,1,-1,-1,0,-1
KR_6654352161,420,-3,16,0,-4,0,0,0,-1,3,2,0,3,3,-3,3,0,0,0,0,0,-7,59,-2,-3,5,4,0,-1,-1,0,-1,-1,1,-1
KR_6716488824,440,-4,-88,-44,-9,0,3,3,0,5,5,-5,6,1,-1,5,4,-3,3,0,-1,3,-10,-3,-2,5,-2,0,0,-1,-1,-1,-1,6,-1
KR_6685643830,420,-3,-126,-1,-1,0,1,1,2,2,4,2,3,5,-5,5,0,0,1,1,-1,-3,9,2,-4,2,0,0,-1,-1,1,-1,-1,6,-1
KR_6750358769,420,-1,-44,15,-2,-3,4,1,0,3,3,2,2,4,0,1,1,-1,2,1,0,1,75,-3,-3,6,-2,0,-1,-1,1,-1,-1,4,-1
KR_6700053439,420,-2,-83,-28,-9,-2,3,1,-2,2,0,1,2,3,-6,8,2,0,1,1,0,-11,1,-1,-2,3,-5,0,-1,0,0,-1,-1,0,-1
KR_6761344083,440,-4,-84,-9,-7,1,3,4,2,1,3,-1,2,1,-6,6,0,-3,6,3,-1,-10,-11,-3,-3,6,0,0,-2,-1,-1,-1,-1,5,-1
KR_6750725326,420,-5,-82,-48,-10,-4,5,1,5,0,5,-2,5,3,-9,10,1,0,0,0,0,-9,-16,-3,-4,7,-5,0,-1,-1,-1,-1,-1,6,-1
KR_6742742617,420,0,-19,-8,-1,3,3,6,-2,4,2,0,4,4,-3,5,2,1,2,3,1,-10,0,-7,-4,11,-1,0,-1,-1,1,-1,-1,5,-1
KR_6761794622,420,-5,-71,-40,-11,-3,6,3,0,2,2,-3,5,2,-3,4,1,-2,2,0,0,-13,-2,-2,-1,3,0,0,-1,-1,0,-1,1,6,-1
KR_6755023335,420,0,-20,-28,-2,-3,3,0,3,2,5,-2,2,0,0,6,6,0,2,2,0,2,-184,-4,-3,7,2,0,0,0,0,0,-1,0,-1
KR_6757811459,420,-3,-43,0,-6,-4,7,3,2,0,2,-4,6,2,2,2,4,-2,3,1,0,3,4,4,-6,2,-3,0,-2,1,1,-1,-1,3,-1
KR_6740555196,420,-4,-10,-1,-15,2,1,3,-5,6,1,-5,5,0,-1,4,3,-6,6,0,-2,-20,3,2,-8,6,-8,0,0,1,0,0,-1,5,-1
KR_6742006279,440,0,-81,-20,-2,-5,6,1,0,4,4,-5,7,2,0,2,2,8,0,8,0,4,-1,0,-5,5,5,0,1,0,0,1,-1,0,-1
KR_6751156009,420,3,21,17,-3,-3,4,1,1,1,2,-3,4,1,3,0,3,-1,2,1,0,-8,-19,-4,-2,6,4,0,-1,1,-1,-1,1,1,-1
KR_6704865011,420,4,74,-1,6,3,1,4,-2,3,1,2,2,4,2,0,2,1,2,3,0,3,5,1,-3,2,-2,0,2,1,-1,1,-1,6,-1
KR_6753065824,420,-1,-49,16,-1,1,0,1,-1,3,2,-2,4,2,-3,5,2,4,0,4,0,4,8,-2,-2,4,0,0,-1,0,-1,-1,-1,0,-1
KR_6706695018,420,4,6,47,5,-1,4,3,3,1,4,-1,3,2,4,1,5,0,0,0,0,10,3,4,-8,4,0,0,1,1,1,1,-1,3,-1
KR_6703581369,420,1,-81,12,0,-1,1,0,4,0,4,2,1,3,-4,4,0,-1,1,0,0,-3,53,4,-6,2,-9,0,0,-1,-1,-1,1,6,-1
KR_6664242215,420,2,27,12,9,2,2,4,8,0,8,2,1,3,-2,3,1,-1,2,1,0,7,-13,0,-5,5,4,0,0,1,-1,0,-1,6,-1
KR_6732069903,420,-3,-87,-5,-10,1,2,3,-1,3,2,-1,4,3,-9,10,1,0,1,1,-1,-12,119,0,-2,2,-6,0,-1,1,1,-1,-1,2,-1
KR_6726247364,440,-2,-26,-24,-3,1,0,1,-2,4,2,0,4,4,1,1,2,-3,3,0,0,0,-2,1,-5,4,-1,0,-1,-1,1,-1,-1,5,-1
KR_6749557460,420,-6,51,-72,-7,-3,3,0,-4,5,1,4,1,5,-6,6,0,2,0,2,1,0,8,-2,-5,7,5,0,0,-1,-1,1,1,3,-1
KR_6755150526,420,-3,-34,-20,-4,0,2,2,-8,10,2,4,1,5,-1,5,4,1,0,1,0,-6,7,1,-8,7,-2,0,0,0,0,0,1,0,-1
KR_6628823813,420,-2,76,-16,0,2,0,2,-4,5,1,0,1,1,1,0,1,1,0,1,0,0,-13,3,-6,3,4,0,0,1,-1,0,1,4,-1
KR_6752758327,440,-3,-3,-36,-7,-2,4,2,-4,6,2,1,2,3,-1,2,1,-1,1,0,0,-10,-8,-1,-2,3,0,0,0,1,-1,-1,-1,1,-1
KR_6733533280,420,1,-36,12,1,2,3,5,-3,4,1,4,0,4,-1,2,1,-1,1,0,0,3,-19,1,-3,2,0,0,-2,-1,1,-1,-1,1,-1
KR_6761292721,420,-1,13,12,-6,-3,4,1,1,2,3,2,1,3,-6,6,0,0,0,0,-1,-14,-10,1,-4,3,0,0,-2,-1,-1,-1,-1,1,-1
KR_6717026879,420,2,-2,8,5,-1,4,3,3,1,4,2,2,4,-1,2,1,2,0,2,0,16,-2,-2,-1,3,4,0,0,1,-1,-1,-1,3,-1
KR_6725694311,420,-2,-42,-19,-3,2,1,3,-2,4,2,-2,2,0,3,0,3,-4,5,1,0,-4,-1,2,-7,5,-2,0,1,-1,1,1,-1,4,-1
KR_6757544485,420,1,81,3,-2,2,1,3,0,2,2,1,1,2,-3,7,4,-2,2,0,0,-10,-7,0,-3,3,1,0,-1,-1,-1,-1,-1,4,-1
KR_6708690086,420,-2,-22,-18,-6,1,2,3,1,6,7,-3,6,3,-3,5,2,-2,2,0,-1,-10,3,1,-5,4,-1,0,0,-1,-1,1,-1,1,-1
KR_6740668536,440,-5,-91,-56,-3,1,1,2,-3,4,1,-4,4,0,1,1,2,2,1,3,0,-1,13,0,-4,4,1,0,-1,1,0,-1,-1,2,-1
KR_6760905759,440,-5,-3,-2,-14,-1,5,4,-5,8,3,2,2,4,-8,8,0,-2,2,0,0,-19,0,1,-4,3,-3,0,-2,0,0,-1,1,0,-1
KR_6739952388,420,-2,4,2,0,2,1,3,-5,7,2,2,1,3,0,2,2,1,1,2,0,2,1,-2,-3,5,1,0,-1,-1,-1,-1,-1,3,-1
KR_6670889597,420,-1,-40,-28,0,0,2,2,-3,6,3,6,0,6,-2,4,2,-1,1,0,0,7,-11,-2,-4,6,-1,0,0,1,-1,-1,1,1,-1
KR_6745810477,420,0,-10,-16,0,-3,4,1,1,1,2,3,1,4,0,3,3,-1,1,0,0,1,3,2,-3,1,-4,0,-1,1,1,-1,-1,6,-1
KR_6757267847,420,-4,-2,8,-10,0,1,1,-3,3,0,-2,2,0,-4,6,2,-1,1,0,0,-13,2,5,-9,4,-4,0,0,-1,1,0,1,3,-1
KR_6724114984,420,-1,-3,13,0,-4,4,0,1,5,6,-2,2,0,3,3,6,2,2,4,1,2,-1,-6,-3,9,5,0,0,0,-1,0,1,0,-1
KR_6732922803,420,0,-26,4,7,3,2,5,-1,3,2,6,2,8,0,2,2,-1,1,0,1,-1,-2,-2,-4,6,3,0,0,1,1,-1,1,2,-1
KR_6726894079,420,0,6,-11,6,5,0,5,0,2,2,-4,5,1,3,2,5,2,2,4,0,9,11,-4,-1,5,5,0,1,-1,1,1,1,2,-1
KR_6762096633,420,-5,-78,-8,-13,-1,3,2,-4,4,0,-4,5,1,-3,3,0,-1,3,2,0,-9,0,-1,-6,7,-1,0,0,-1,1,1,-1,2,-1
KR_6761742865,420,-2,35,-7,4,4,1,5,-2,3,1,-6,6,0,7,0,7,1,1,2,1,0,-120,-2,-1,3,-2,0,-1,-1,-1,-1,1,6,-1
KR_6752820886,420,-4,-105,-16,-13,1,2,3,-1,2,1,-8,10,2,-3,3,0,-2,2,0,-1,-11,-354,-1,-2,3,0,0,-3,-1,-1,-1,-1,4,-1
KR_6732932450,420,-4,-34,-1,-6,1,2,3,-2,3,1,-2,2,0,-1,4,3,-2,2,0,1,-5,-44,-2,-5,7,12,0,0,-1,1,0,1,2,-1
KR_6647558997,420,-2,8,-4,-3,0,1,1,2,0,2,-2,2,0,-2,2,0,-1,1,0,-1,-5,-39,-1,-2,3,31,0,-1,-1,-1,-1,-1,6,-1
KR_6661654092,420,2,22,4,2,3,2,5,-3,5,2,4,1,5,-2,4,2,0,1,1,0,-12,-32,2,-3,1,29,0,-1,-1,-1,-1,1,1,-1
KR_6657325175,420,0,-11,15,-2,-2,3,1,1,1,2,0,3,3,-1,1,0,0,1,1,0,-6,-3,2,-7,5,3,0,1,1,1,1,-1,1,-1
KR_6669666859,420,3,26,32,-3,2,1,3,2,2,4,1,3,4,-5,7,2,-3,4,1,0,-13,-5,-4,-4,8,-5,0,3,-1,1,1,-1,6,-1
KR_6672534052,420,0,-62,-16,2,1,3,4,-1,3,2,0,2,2,2,0,2,0,3,3,0,1,-11,4,-9,5,0,0,-1,1,-1,-1,-1,4,-1
KR_6743584559,420,1,18,-6,0,0,2,2,-4,5,1,2,4,6,3,1,4,-1,2,1,0,-3,32,-1,-1,2,-12,0,0,1,1,1,1,3,-1
KR_6752001809,420,-3,19,-19,-2,0,3,3,5,1,6,-1,3,2,-5,6,1,-1,1,0,0,-6,15,-1,-5,6,0,0,0,-1,1,1,1,4,-1
KR_6745911736,420,-1,-78,-35,2,0,1,1,0,1,1,1,0,1,1,2,3,0,3,3,0,5,5,4,-6,2,-3,0,0,1,1,0,1,1,-1
KR_6629806439,420,0,-9,37,-1,1,0,1,0,1,1,1,2,3,-2,3,1,-1,1,0,0,-10,0,-1,-3,4,-2,0,-1,-1,-1,-1,1,4,-1
KR_6738274111,440,-3,-83,-11,-4,-3,4,1,-1,1,0,-1,3,2,-2,3,1,3,0,3,1,3,11,-1,-7,8,-3,0,-1,-1,0,-1,1,3,-1
KR_6708652595,420,1,48,8,3,1,3,4,-4,4,0,4,1,5,1,0,1,1,0,1,0,0,3,-2,-4,6,-2,0,1,-1,-1,1,-1,1,-1
KR_5856626427,420,-4,-76,-50,-9,-2,3,1,-4,6,2,0,4,4,0,2,2,-3,5,2,0,0,-5,0,-6,6,-3,0,-2,-1,-1,-1,-1,3,-1
KR_6731526854,420,-3,-34,20,-8,-6,6,0,-3,6,3,-4,7,3,1,3,4,4,1,5,0,0,-39,-4,-1,5,1,0,1,1,-1,1,1,6,-1
KR_6742001796,420,-1,-43,-5,0,1,1,2,0,2,2,0,2,2,0,3,3,-1,4,3,-2,-5,-6,-7,-1,8,3,0,0,-1,1,0,-1,4,-1
KR_6734650767,440,-7,-104,-24,-15,-3,4,1,-5,6,1,-6,7,1,-2,5,3,1,0,1,-1,-16,-4,-1,-3,4,-7,0,1,0,1,-1,-1,0,-1
KR_6734751211,440,-2,-9,-27,5,5,0,5,3,3,6,-1,1,0,-2,5,3,0,1,1,0,4,2,3,-6,3,1,0,-1,-1,1,-1,-1,4,-1
KR_6514005017,420,-3,-42,-16,-3,-2,4,2,1,1,2,-4,4,0,-1,2,1,3,1,4,0,-3,108,0,-5,5,-5,0,-1,-1,-1,1,1,2,-1
KR_6685628593,420,-3,4,-24,-8,-6,6,0,-3,5,2,4,0,4,-2,4,2,-1,1,0,0,-10,-13,-2,-3,5,1,0,-1,-1,-1,-1,-1,6,-1
KR_6743115227,420,1,-6,-8,1,2,2,4,5,0,5,1,1,2,-7,9,2,0,0,0,0,-9,-7,-4,-4,8,-1,0,0,-1,1,1,1,2,-1
KR_6673780903,420,-2,-5,13,-10,3,1,4,-2,3,1,0,1,1,-9,11,2,-2,4,2,0,-11,-10,-5,-2,7,0,0,-2,1,1,-1,-1,1,-1
KR_6763951745,420,1,39,0,-1,3,3,6,-4,5,1,4,0,4,-3,4,1,-1,1,0,0,1,-6,-2,-4,6,2,0,-2,1,-1,-1,-1,2,-1
KR_6608730018,420,4,55,-4,6,1,1,2,4,0,4,-2,7,5,2,0,2,1,0,1,1,2,238,3,-5,2,1,0,0,1,-1,0,1,1,-1
KR_6362084315,420,-2,12,-40,-9,-2,4,2,1,5,6,0,2,2,-9,9,0,1,0,1,-1,-16,0,0,0,0,-3,0,-1,-1,-1,-1,-1,3,-1
KR_6631770422,420,1,-69,4,0,2,2,4,0,2,2,-2,3,1,-1,7,6,1,1,2,-1,-6,-4,1,-5,4,-5,0,-1,1,-1,-1,-1,3,-1
KR_6599810861,420,-4,-23,-35,-1,-4,4,0,-1,3,2,0,3,3,5,5,10,-1,1,0,0,4,6,1,-4,3,2,0,0,0,-1,0,1,0,-1
KR_6764050989,420,-2,6,16,-6,-3,4,1,-1,3,2,1,1,2,-4,5,1,1,2,3,-1,-6,2,2,-6,4,-5,0,0,1,-1,0,-1,1,-1
KR_6734642857,420,-6,-96,-40,-6,-2,3,1,-1,2,1,-3,4,1,-2,2,0,2,0,2,1,-5,-21,2,-4,2,5,0,-1,0,-1,-1,1,0,-1
KR_6688156451,420,0,36,-13,-4,0,1,1,-4,5,1,-3,3,0,6,0,6,-3,3,0,0,-5,8,3,-6,3,-2,0,0,-1,-1,0,-1,5,-1
KR_6730734169,420,-1,-48,0,-4,1,2,3,-4,6,2,0,1,1,-1,2,1,0,1,1,0,-7,-13,-2,-3,5,2,0,-1,1,-1,-1,-1,2,-1
KR_6759193320,420,-2,-57,-4,-5,1,0,1,0,1,1,-7,7,0,0,1,1,1,0,1,0,-5,5,-3,-1,4,-4,0,0,-1,1,0,1,3,-1
KR_6742132988,420,-1,-30,-5,-4,-2,3,1,-4,4,0,2,2,4,1,4,5,-1,3,2,1,-3,-62,-6,-1,7,2,0,0,-1,-1,0,1,1,-1
KR_6747331112,420,-4,-6,-6,-6,0,2,2,-9,9,0,6,0,6,-1,2,1,-2,2,0,0,-10,18,2,-5,3,-2,0,-1,-1,-1,-1,1,1,-1
KR_6762809651,420,0,69,-4,0,0,2,2,0,2,2,-1,5,4,2,2,4,-1,2,1,0,3,6,2,-6,4,-4,0,1,-1,-1,1,-1,6,-1
KR_6668607188,420,-3,-28,-5,-11,-1,1,0,0,4,4,-3,3,0,-8,9,1,1,1,2,0,-9,123,2,-9,7,0,0,0,-1,-1,-1,1,3,-1
KR_6761994523,420,-1,-17,-4,-5,1,0,1,-1,3,2,-6,6,0,4,4,8,-3,3,0,0,-10,-7,-1,-1,2,-4,0,1,-1,1,1,-1,1,-1
KR_6672234279,420,0,6,4,2,0,5,5,4,0,4,-4,7,3,3,0,3,-1,2,1,0,5,8,-3,0,3,-2,0,-2,0,-1,-1,-1,0,-1
KR_6749254863,420,-1,-41,-4,-2,-2,2,0,0,1,1,-2,3,1,2,2,4,0,0,0,0,-1,-37,4,-7,3,20,0,-1,-1,-1,-1,-1,5,-1
KR_6657833737,420,-9,-147,-32,-11,-4,4,0,4,1,5,-10,10,0,-2,2,0,1,0,1,1,-1,9,4,-5,1,-3,0,-4,-1,-1,-1,1,4,-1
KR_6761615975,420,-4,-54,-51,-7,-1,7,6,-2,3,1,1,0,1,-5,5,0,0,2,2,0,-7,3,-2,-2,4,-3,0,0,-1,1,0,1,2,-1
KR_6727114848,420,-7,-44,-44,-10,-2,2,0,0,4,4,-4,4,0,-2,3,1,-2,3,1,0,-13,-1,-2,-2,4,-2,0,-3,-1,-1,-1,1,5,-1
KR_6760694821,420,1,-7,-12,5,6,0,6,0,0,0,-2,5,3,0,2,2,1,1,2,-1,5,12,0,-3,3,3,0,0,-1,-1,1,-1,5,-1
KR_6757532160,440,-1,-28,15,-1,-3,3,0,3,1,4,-2,6,4,-3,3,0,4,1,5,-1,-5,-8,6,-6,0,1,0,-2,0,0,-1,-1,0,-1
KR_6762193124,420,3,-21,8,-5,-1,1,0,3,1,4,-5,5,0,-1,1,0,-1,3,2,0,-6,6,-6,-2,8,-3,0,0,1,1,1,-1,4,-1
KR_6714036282,420,-3,-42,-27,-7,-1,1,0,-1,6,5,-1,3,2,-3,5,2,-1,1,0,0,-7,3,4,-8,4,-5,0,-2,-1,0,-1,-1,1,-1
KR_6733784476,420,-3,44,-16,-14,-2,3,1,4,1,5,-8,9,1,-6,6,0,-2,2,0,0,-19,-241,-1,-1,2,-1,0,-2,-1,-1,-1,-1,1,-1
KR_6757958210,420,-1,19,-18,-6,3,3,6,-10,11,1,-1,2,1,1,0,1,1,1,2,1,1,7,-2,-2,4,2,0,1,-1,-1,1,1,4,-1
KR_6745816587,420,-5,-21,-35,-8,1,0,1,-6,8,2,-1,2,1,1,5,6,-3,4,1,0,-7,-89,0,-4,4,-5,0,-2,-1,-1,-1,-1,2,-1
KR_6749636014,420,0,25,32,-5,0,0,0,-4,5,1,-2,5,3,0,2,2,1,2,3,0,-9,6,-2,-2,4,2,0,0,-1,1,1,1,3,-1
KR_6712921883,420,-4,-82,-16,-9,-2,2,0,-3,4,1,-2,2,0,-1,3,2,-1,3,2,0,-11,-10,4,-5,1,-1,0,-1,-1,0,-1,1,1,-1
KR_6743327437,420,-3,-46,-23,-5,-1,3,2,-2,3,1,-2,4,2,-1,2,1,1,0,1,0,-1,-283,-6,0,6,8,0,-2,-1,-1,-1,-1,5,-1
KR_6742287830,420,-1,-24,-40,5,-3,4,1,0,2,2,1,2,3,8,0,8,-1,3,2,0,13,-6,2,-4,2,4,0,0,0,-1,0,-1,0,-1
KR_5868088182,420,2,17,-8,-5,-2,4,2,3,3,6,-1,3,2,-3,5,2,-2,3,1,0,-9,11,7,-10,3,-4,0,1,1,0,1,-1,5,-1
KR_6752671872,420,-2,25,-39,-7,-2,3,1,-5,5,0,1,2,3,-1,3,2,0,0,0,0,-3,-392,0,-3,3,0,0,0,1,-1,0,1,5,-1
KR_6595171033,420,1,26,4,6,2,2,4,-3,4,1,3,1,4,2,4,6,2,0,2,2,11,-1,-4,-4,8,-2,0,1,-1,-1,1,1,3,-1
KR_6742725958,420,-1,-52,13,-7,2,2,4,0,1,1,0,4,4,-5,7,2,-4,4,0,-1,-17,2,-1,-2,3,-1,0,-1,-1,1,-1,-1,5,-1
KR_6660716983,420,-1,-38,-3,-2,1,1,2,3,1,4,-2,5,3,-5,6,1,1,0,1,-1,-3,5,0,-3,3,-3,0,0,-1,1,0,-1,5,-1
KR_6587908037,420,-1,-107,-4,-1,-2,5,3,5,1,6,-1,2,1,-3,3,0,0,0,0,0,4,-347,1,-4,3,-21,0,-2,-1,1,-1,-1,2,-1
KR_6751543451,420,-6,-107,-24,-10,0,0,0,0,0,0,-7,8,1,-1,1,0,-2,2,0,0,-6,145,-2,-3,5,-2,0,-2,-1,-1,-1,-1,5,-1
KR_6616554367,420,1,1,-12,1,-1,2,1,1,1,2,-1,2,1,1,0,1,1,2,3,0,4,9,5,-6,1,-3,0,-1,-1,-1,-1,-1,5,-1
KR_6744664367,420,2,-13,16,-1,-1,3,2,0,2,2,0,1,1,1,0,1,-1,2,1,0,2,8,-1,-4,5,2,0,-1,1,0,-1,-1,6,-1
KR_6763611853,440,3,1,4,2,5,0,5,2,1,3,-7,7,0,-1,4,3,3,0,3,0,9,8,2,-4,2,1,0,-1,0,1,-1,1,0,-1
KR_6762602074,420,2,20,0,0,-3,5,2,1,2,3,1,2,3,3,0,3,-2,4,2,-1,4,1,0,-4,4,-1,0,0,-1,-1,0,-1,3,-1
KR_6675452085,420,-5,-51,-16,-7,-4,5,1,-5,8,3,-1,2,1,2,0,2,1,1,2,0,1,3,1,-4,3,-5,0,-3,-1,-1,-1,-1,2,-1
KR_6749670436,420,1,8,-43,-4,2,0,2,-3,3,0,-3,6,3,0,1,1,0,1,1,0,-1,2,0,-2,2,-1,0,-1,0,-1,-1,-1,0,-1
KR_6751782324,420,4,65,18,-1,3,0,3,-2,6,4,-3,3,0,-2,4,2,3,1,4,0,-8,-219,0,-2,2,-30,0,1,-1,1,1,1,3,-1
KR_6669488077,420,-4,-2,-4,-8,-2,3,1,-1,6,5,-1,2,1,-3,5,2,-1,3,2,0,-6,2,3,-5,2,0,0,0,-1,0,-1,-1,1,-1
KR_6599335643,420,-1,-44,11,-2,-1,2,1,3,3,6,-1,4,3,1,0,1,-4,4,0,0,0,-5,-1,-2,3,2,0,-1,1,1,-1,-1,3,-1
KR_6763891020,420,-4,2,0,-6,-3,3,0,0,1,1,-3,3,0,0,0,0,0,1,1,0,-6,22,4,-6,2,-3,0,-2,0,1,-1,-1,0,-1
KR_6695105102,420,0,62,-32,-3,5,0,5,-3,5,2,0,4,4,-1,1,0,-4,5,1,0,-2,-2,-2,-1,3,-4,0,0,-1,-1,-1,-1,1,-1
KR_6762635242,420,-1,-34,15,-5,-5,5,0,-1,3,2,0,0,0,1,3,4,0,1,1,-1,-1,-349,-1,-1,2,0,0,-4,-1,-1,-1,-1,1,-1
KR_6695835232,420,0,8,47,-2,4,0,4,-1,4,3,-3,3,0,-1,3,2,-1,2,1,0,3,23,1,-5,4,-3,0,-1,1,0,-1,-1,2,-1
KR_6729684723,420,1,18,10,3,-1,3,2,-1,5,4,3,1,4,1,1,2,1,0,1,1,5,6,-3,-1,4,0,0,1,1,1,1,1,2,-1
KR_6678275437,420,-1,-12,-12,-2,3,0,3,-1,2,1,4,2,6,-8,8,0,0,0,0,0,-3,-28,-2,-3,5,17,0,1,-1,-1,-1,-1,1,-1
KR_6763330516,420,-2,-31,-3,-5,1,2,3,-3,6,3,-1,5,4,1,1,2,-3,5,2,0,-2,-8,-3,-4,7,1,0,0,-1,-1,0,1,5,-1
KR_6761838065,420,-2,-10,3,-5,1,0,1,-2,2,0,-3,5,2,0,4,4,-1,1,0,0,-3,-5,1,-3,2,1,0,0,-1,1,1,-1,1,-1
KR_6719219897,420,-2,-7,-35,-11,-2,4,2,-4,5,1,-1,1,0,-4,6,2,0,1,1,0,-10,-12,2,-5,3,2,0,-1,-1,0,-1,-1,2,-1
KR_6718515895,420,0,23,35,-3,1,0,1,-2,4,2,0,3,3,-2,2,0,0,0,0,0,-6,-1,0,-6,6,-4,0,0,-1,1,0,-1,6,-1
KR_6760095312,420,-2,-72,-24,-3,0,1,1,1,1,2,0,2,2,0,4,4,-4,4,0,0,-1,-4,-2,-3,5,0,0,-1,-1,-1,-1,-1,2,-1
KR_6688276934,420,-3,-65,6,-3,-2,2,0,0,3,3,-4,5,1,2,3,5,1,1,2,0,-8,-3,3,-6,3,2,0,0,-1,1,-1,1,5,-1
KR_6716726674,420,-4,-4,10,-10,-1,5,4,-3,4,1,-3,3,0,-2,6,4,-1,1,0,0,-11,-19,-2,-4,6,-2,0,-1,-1,0,-1,-1,2,-1
KR_6633460139,420,-1,0,20,-5,0,0,0,1,2,3,-4,4,0,-1,1,0,-1,1,0,-1,-4,-10,-4,-2,6,0,0,0,-1,0,1,-1,1,-1
KR_6731522101,420,-5,-13,-15,-10,0,0,0,1,2,3,-4,5,1,-3,4,1,-4,5,1,0,-8,-21,-4,-3,7,0,0,0,-1,1,-1,-1,6,-1
KR_6645902889,420,0,12,-7,-4,6,1,7,-1,3,2,-5,7,2,-5,7,2,1,3,4,-2,-6,3,3,-5,2,-5,0,0,-1,1,1,1,5,-1
KR_6650755180,420,-3,2,4,-9,-2,3,1,-2,3,1,1,2,3,-8,10,2,2,0,2,0,-12,-3,7,-7,0,1,0,-1,1,-1,-1,1,6,-1
KR_6693571381,420,-1,-36,16,-11,-1,2,1,0,1,1,-7,9,2,-2,3,1,-1,1,0,0,-8,-8,-1,-1,2,1,0,-2,-1,-1,-1,-1,2,-1
KR_6695739109,420,2,59,28,2,4,0,4,3,0,3,-3,3,0,0,2,2,-2,2,0,0,9,236,-4,-3,7,-3,0,-1,1,-1,-1,1,1,-1
KR_6674661313,420,-2,5,5,-3,1,1,2,-1,2,1,-3,6,3,-1,6,5,1,0,1,1,2,-7,1,-3,2,3,0,-2,1,-1,-1,1,5,-1
KR_6750061687,420,-3,-48,-7,-2,5,1,6,4,1,5,1,4,5,-13,13,0,1,0,1,0,2,-200,3,-3,0,-1,0,0,-1,1,-1,1,2,-1
KR_6754905943,420,-1,-30,12,-1,1,1,2,-4,8,4,1,0,1,2,1,3,-1,1,0,0,2,3,-2,-3,5,-1,0,-1,1,-1,-1,-1,1,-1
KR_6762176158,420,0,-57,-20,5,-2,2,0,1,2,3,9,0,9,-2,2,0,-1,2,1,0,2,1,1,-5,4,2,0,0,1,-1,-1,-1,6,-1
KR_6741898836,420,-4,-24,-16,-9,-3,3,0,-1,3,2,1,3,4,-3,8,5,-3,3,0,0,0,-6,2,-6,4,-5,0,1,-1,1,1,1,4,-1
KR_6748608908,420,-2,-28,27,-4,0,1,1,1,4,5,0,2,2,-4,5,1,-1,1,0,0,3,-1,1,-3,2,2,0,0,0,1,1,1,0,-1
KR_6551019781,420,-1,-47,6,3,-5,5,0,-4,5,1,6,0,6,5,1,6,1,2,3,-1,9,-6,-1,-5,6,1,0,1,1,1,1,-1,2,-1
KR_6655359259,420,2,49,17,4,3,0,3,-3,6,3,-1,1,0,2,1,3,3,0,3,0,2,-174,-5,-2,7,1,0,1,-1,-1,1,1,3,-1
KR_6758466877,440,-3,-23,-7,-12,3,1,4,-1,6,5,-1,4,3,-9,9,0,-4,4,0,0,-15,2,1,-7,6,-4,0,0,1,-1,-1,-1,1,-1
KR_6671860925,420,2,14,-5,5,2,0,2,2,1,3,1,2,3,0,4,4,0,0,0,0,8,10,3,-5,2,-1,0,0,1,0,0,-1,4,-1
KR_6756362650,440,1,90,8,-8,-2,2,0,0,3,3,1,3,4,-2,5,3,-5,5,0,-1,-14,-1,-2,-2,4,1,0,0,0,1,1,-1,0,-1
KR_6720836720,440,-3,-191,-27,-8,0,2,2,3,2,5,-1,2,1,-9,9,0,-1,1,0,0,-9,-24,-2,0,2,2,0,0,-1,1,-1,1,6,-1
KR_6735895300,420,0,-7,15,-6,0,0,0,0,2,2,-1,2,1,-3,4,1,-2,2,0,0,-8,-27,-4,-4,8,3,0,1,-1,1,1,-1,2,-1
KR_6762559017,420,3,46,3,2,-2,3,1,-1,4,3,2,0,2,3,0,3,0,0,0,0,2,-151,-4,-1,5,2,0,1,1,-1,1,1,4,-1
KR_6703235047,420,-3,-62,24,-7,-5,6,1,0,2,2,1,2,3,-1,3,2,-2,2,0,0,-6,-218,3,-3,0,0,0,-1,1,-1,-1,-1,6,-1
KR_6758008695,420,-1,-40,17,-7,-1,3,2,-3,5,2,-2,5,3,-1,3,2,0,1,1,0,-11,-12,-1,-5,6,-2,0,0,-1,-1,-1,-1,6,-1
KR_6750219274,420,-1,-32,-12,-2,2,0,2,-4,6,2,-1,3,2,0,1,1,1,0,1,-1,-1,-6,3,-5,2,1,0,-1,1,-1,-1,-1,3,-1
KR_6738759033,420,1,49,15,-3,0,4,4,4,1,5,-3,5,2,-6,7,1,2,2,4,1,6,-20,0,-3,3,2,0,-1,1,1,-1,1,6,-1
KR_6644022437,420,0,-37,17,-3,0,1,1,2,0,2,-6,7,1,2,1,3,-1,3,2,0,-1,17,-1,-2,3,1,0,0,-1,1,0,1,5,-1
KR_6712490193,420,1,-26,13,-3,4,1,5,1,3,4,-2,2,0,-4,4,0,-2,2,0,0,-10,13,-1,-5,6,-2,0,0,-1,1,-1,-1,2,-1
KR_6730229069,440,-3,-104,11,-11,1,0,1,-3,4,1,-7,13,6,-3,3,0,1,0,1,0,-7,5,-2,-1,3,1,0,0,0,0,-1,-1,0,-1
KR_6754592057,420,-2,-63,13,-8,-3,4,1,-2,6,4,-1,4,3,-2,2,0,0,0,0,0,-4,13,4,-9,5,-5,0,0,1,-1,0,-1,1,-1
KR_6700066402,420,-4,-4,5,-11,-3,3,0,-1,3,2,2,5,7,-9,9,0,0,0,0,0,-16,-6,-4,-2,6,-2,0,0,-1,-1,-1,1,4,-1
KR_6761151775,420,-4,14,7,-7,0,0,0,0,1,1,-6,7,1,-3,6,3,2,0,2,1,-10,2,-2,-3,5,-5,0,-1,1,-1,-1,1,1,-1
KR_6635086114,420,-2,-35,14,-12,-3,4,1,-1,3,2,-9,10,1,0,0,0,1,0,1,0,-2,-7,-3,-1,4,4,0,-3,1,-1,-1,-1,2,-1
KR_6621900340,420,-3,-80,-4,-10,-2,2,0,0,5,5,-6,7,1,-5,5,0,3,1,4,0,-13,-196,1,-5,4,-2,0,0,-1,-1,0,-1,2,-1
KR_6694423153,420,-1,-62,13,2,2,0,2,3,2,5,1,1,2,-4,4,0,0,1,1,-1,8,-8,0,-5,5,-3,0,0,-1,-1,-1,-1,6,-1
KR_6662765338,440,-2,11,0,-7,-2,2,0,-4,5,1,6,0,6,-6,6,0,-1,3,2,0,-17,-4,-1,-5,6,4,0,-1,-1,-1,-1,-1,4,-1
KR_6660065997,420,0,-27,4,3,2,1,3,5,4,9,-1,3,2,-2,3,1,-1,2,1,0,1,-44,-2,-2,4,29,0,-1,1,-1,-1,-1,2,-1
KR_6715029929,420,-4,8,-1,-3,1,4,5,1,1,2,-4,6,2,1,1,2,-2,3,1,1,4,-7,-2,-2,4,2,0,-1,-1,-1,-1,1,2,-1
KR_6747143241,440,2,-5,41,1,-4,4,0,1,1,2,0,0,0,7,1,8,-3,4,1,0,2,-167,-5,-2,7,5,0,-1,-1,0,-1,1,2,-1
KR_6738215308,420,1,11,-26,7,-3,4,1,2,2,4,1,1,2,6,0,6,1,0,1,0,7,-100,-5,-2,7,2,0,-1,-1,-1,-1,1,5,-1
KR_6739870392,420,1,4,13,0,-2,3,1,-1,1,0,5,1,6,1,2,3,-3,4,1,0,1,-8,-5,-2,7,-1,0,0,-1,1,0,-1,6,-1
KR_6645486287,420,-2,-33,-29,0,0,3,3,-4,6,2,-1,2,1,2,2,4,3,0,3,0,1,4,5,-5,0,0,0,1,-1,-1,1,1,6,-1
KR_6762364746,420,0,6,4,-4,-3,3,0,-1,1,0,2,1,3,-4,6,2,2,1,3,0,-4,7,-7,-1,8,3,0,0,-1,1,-1,-1,4,-1
KR_6758321663,420,-2,-23,-18,-8,-1,2,1,-1,2,1,-5,5,0,0,3,3,-1,3,2,0,-6,-14,1,-5,4,2,0,0,-1,-1,0,-1,2,-1
KR_6509085774,420,-3,-46,-10,-5,-2,2,0,-2,4,2,-1,2,1,1,1,2,-1,1,0,0,-4,10,1,-6,5,-6,0,-1,-1,-1,-1,1,6,-1
KR_6751502093,420,-1,-7,9,-8,-2,3,1,-3,5,2,-4,6,2,1,1,2,0,1,1,0,-13,-13,-4,-3,7,1,0,0,-1,1,0,-1,3,-1
KR_6706580259,420,-1,7,-4,-5,-4,5,1,2,3,5,-1,4,3,-2,3,1,0,1,1,0,-7,-3,-4,-1,5,1,0,-1,-1,1,-1,-1,2,-1
KR_6742972121,420,-2,-2,-24,-4,-3,4,1,1,1,2,-5,6,1,-1,5,4,4,0,4,1,3,-6,-1,-3,4,0,0,0,-1,1,-1,-1,4,-1
KR_6713514368,440,0,-52,24,-3,3,1,4,-1,1,0,0,1,1,-4,7,3,-1,3,2,0,-1,-11,-3,-2,5,-5,0,-1,-1,-1,-1,-1,2,-1
KR_6733716416,420,3,128,-4,10,4,1,5,1,1,2,1,2,3,4,0,4,0,0,0,2,13,-7,2,-5,3,3,0,1,1,1,1,1,6,-1
KR_6761213516,420,-2,-27,-4,-4,0,1,1,0,2,2,3,2,5,-6,7,1,-1,1,0,0,-8,34,-2,-3,5,-26,0,0,-1,-1,0,1,3,-1
KR_5827099021,420,2,-19,24,0,0,1,1,-5,6,1,2,1,3,2,2,4,1,0,1,0,-2,-9,-1,-4,5,-2,0,1,1,0,1,-1,2,-1
KR_6747954518,420,-2,-67,-8,-4,3,0,3,-6,6,0,0,1,1,0,0,0,-1,1,0,0,-6,50,-4,-2,6,-32,0,-1,-1,-1,-1,-1,6,-1
KR_6640275355,420,0,-23,8,-2,2,1,3,0,4,4,2,2,4,-7,7,0,1,0,1,0,-7,-1,2,-3,1,-5,0,0,-1,0,0,-1,4,-1
KR_6299938339,440,-6,-66,-23,-11,-2,4,2,-1,3,2,-13,14,1,5,0,5,0,0,0,0,-3,-2,0,-2,2,-4,0,-3,1,-1,-1,-1,6,-1
KR_6550959158,420,1,-37,37,1,-1,2,1,0,6,6,-1,3,2,3,5,8,0,2,2,0,-3,-215,3,-7,4,-8,0,0,-1,-1,-1,1,3,-1
KR_6764239618,420,-5,-63,-48,-9,-2,2,0,0,0,0,0,4,4,-5,5,0,-2,6,4,0,2,9,4,-6,2,-5,0,0,1,-1,1,-1,2,-1
KR_6757591360,420,-3,-28,-12,0,2,0,2,0,2,2,-3,5,2,1,3,4,0,0,0,0,-2,-11,3,-7,4,-1,0,-1,-1,1,-1,1,3,-1
KR_6647348991,440,-2,-15,-16,-2,3,0,3,-3,5,2,2,1,3,-1,3,2,-3,5,2,-1,-3,-10,3,-5,2,1,0,1,-1,-1,1,-1,2,-1
KR_6745989282,420,-4,-21,-20,-8,-2,3,1,2,0,2,-2,2,0,-4,7,3,-2,2,0,0,-2,-3,0,-6,6,4,0,0,-1,0,0,-1,4,-1
KR_6477463295,420,3,45,17,0,0,1,1,0,3,3,0,1,1,3,0,3,-3,3,0,0,-1,-113,1,-5,4,-1,0,0,-1,-1,0,-1,5,-1
KR_6674554767,420,-7,-111,-8,-8,-2,2,0,0,4,4,-4,5,1,-2,4,2,0,1,1,0,-1,-112,1,-2,1,-1,0,-3,-1,-1,-1,-1,2,-1
KR_6714972857,420,-2,-80,-36,-2,-1,3,2,2,1,3,0,2,2,0,2,2,-3,4,1,0,1,-22,0,-4,4,-6,0,-1,-1,-1,-1,1,1,-1
KR_6663462401,420,3,-12,8,0,-4,5,1,1,0,1,4,1,5,-1,3,2,0,1,1,0,4,-5,-3,0,3,2,0,0,1,-1,0,-1,2,-1
KR_6656839612,420,1,13,-52,10,3,1,4,1,1,2,3,1,4,0,2,2,3,0,3,0,8,-4,1,-3,2,4,0,0,1,-1,-1,1,5,-1
KR_6647588452,420,-1,-66,4,-1,4,1,5,2,3,5,-2,3,1,-1,4,3,-4,4,0,1,-4,-9,-1,-6,7,-3,0,-2,1,1,-1,1,6,-1
KR_6757880711,420,-1,-40,19,-5,3,0,3,1,1,2,0,1,1,-5,7,2,-4,5,1,0,-8,21,3,-4,1,-5,0,-1,-1,-1,-1,-1,5,-1
KR_6656294253,420,-4,-13,-40,-10,0,2,2,-5,6,1,-1,1,0,-2,4,2,-2,2,0,0,-3,-1,-1,-3,4,2,0,0,-1,1,0,-1,2,-1
KR_6731346110,420,4,71,11,2,3,1,4,0,1,1,1,3,4,0,3,3,-2,3,1,0,-4,-9,0,-5,5,1,0,0,1,-1,0,-1,2,-1
KR_6744519966,420,-3,-71,4,-1,1,1,2,-5,7,2,0,3,3,3,1,4,0,1,1,0,9,-35,-2,0,2,34,0,-2,-1,0,-1,-1,4,-1
KR_6751894732,420,-4,9,-9,-11,-5,5,0,5,4,9,-5,6,1,-6,6,0,0,1,1,0,-5,-5,-3,-6,9,-3,0,-1,-1,-1,-1,1,2,-1
KR_6762359662,420,-2,-37,-24,3,-3,4,1,0,4,4,-1,3,2,9,0,9,-2,2,0,2,8,-8,3,-7,4,3,0,-1,1,1,-1,1,4,-1
KR_6652846453,420,-4,-25,-4,-5,-4,5,1,-2,2,0,-4,6,2,5,1,6,0,1,1,1,5,2,2,-3,1,-2,0,-1,-1,-1,-1,1,1,-1
KR_6760115278,420,-4,-13,-16,-10,0,3,3,0,2,2,-11,15,4,0,1,1,1,3,4,1,-6,-3,-3,0,3,1,0,0,-1,1,1,1,3,-1
KR_6751892171,420,-2,26,8,-1,1,1,2,-2,3,1,1,3,4,-1,4,3,0,1,1,1,2,-14,-1,-4,5,-5,0,0,1,1,0,1,4,-1
KR_6637331016,420,-2,31,-16,-5,1,1,2,2,0,2,-1,2,1,-6,6,0,-1,1,0,0,-10,-7,3,-7,4,1,0,-1,-1,-1,-1,-1,2,-1
KR_6695173237,440,0,-64,22,-3,2,2,4,-3,5,2,-7,7,0,4,2,6,1,0,1,0,-7,5,1,-4,3,-1,0,1,-1,1,1,1,3,-1
KR_6755288575,440,-6,-61,20,-13,-1,4,3,-6,8,2,-2,4,2,-2,3,1,-2,4,2,0,-9,2,-6,-3,9,7,0,-2,-1,-1,-1,-1,4,-1
KR_6761373498,420,0,-9,21,-3,3,0,3,-9,10,1,-1,3,2,0,2,2,4,1,5,0,-11,3,0,-2,2,2,0,-2,1,-1,-1,-1,5,-1
KR_6719621956,440,-3,37,8,-8,3,1,4,-3,4,1,-1,3,2,0,4,4,-7,7,0,0,-8,-37,-5,-2,7,18,0,0,-1,-1,-1,1,6,-1
KR_6690679407,420,-2,16,7,-6,0,2,2,-1,1,0,-2,4,2,-3,3,0,0,0,0,0,-8,-11,-2,-5,7,1,0,0,1,-1,0,-1,2,-1
KR_6741688679,420,3,8,-29,1,-2,2,0,0,1,1,7,0,7,-1,2,1,-3,4,1,0,-3,1,-2,-1,3,1,0,0,-1,-1,0,-1,2,-1
KR_6636608637,420,1,79,8,3,5,0,5,-2,4,2,-3,3,0,4,3,7,-1,1,0,0,-5,5,3,-3,0,-1,0,2,0,1,1,1,0,-1
KR_6758004988,420,-1,41,-12,3,0,1,1,-2,4,2,1,1,2,2,1,3,2,0,2,0,1,-6,-2,-4,6,3,0,0,-1,-1,0,1,4,-1
KR_6754876680,420,0,5,-28,-4,-2,3,1,-2,3,1,2,2,4,1,1,2,-3,3,0,0,-3,-7,-6,0,6,1,0,0,-1,0,-1,-1,4,-1
KR_6694021445,440,-1,43,-26,-5,2,1,3,0,3,3,-1,3,2,-4,4,0,-2,3,1,-1,-3,-1,1,-3,2,-1,0,-1,1,-1,-1,-1,1,-1
KR_6637086299,420,-3,-27,-5,-10,-4,6,2,-2,6,4,-2,5,3,-1,2,1,-1,2,1,-1,-9,0,1,-4,3,4,0,-2,-1,-1,-1,-1,6,-1
KR_6719430132,440,-2,-58,-13,-7,-2,2,0,-5,6,1,1,3,4,-1,3,2,0,1,1,0,-7,-9,-4,-2,6,2,0,0,-1,0,1,1,3,-1
KR_6758714060,420,0,-30,-16,-2,-1,4,3,1,1,2,-3,5,2,0,4,4,1,1,2,2,8,-3,-3,-3,6,2,0,-2,0,-1,-1,1,0,-1
KR_6734412240,420,4,47,-4,2,0,1,1,5,5,10,-1,1,0,-1,1,0,-1,1,0,0,2,-336,-1,-2,3,2,0,0,-1,-1,1,-1,3,-1
KR_6744809836,420,-5,-31,-1,-6,-2,2,0,2,1,3,3,0,3,-8,8,0,-1,1,0,0,-8,-2,4,-6,2,0,0,-1,-1,0,-1,1,6,-1
KR_6758117095,420,-1,-57,28,-7,-3,3,0,-3,3,0,0,2,2,-1,3,2,0,0,0,-2,-7,-4,-1,-1,2,-4,0,-2,-1,1,-1,-1,5,-1
KR_6752104577,420,-3,42,-7,-10,1,2,3,-1,2,1,2,2,4,-10,13,3,-2,3,1,1,-11,10,5,-6,1,-3,0,-1,-1,-1,-1,-1,2,-1
KR_6709257273,420,-7,-129,-44,-19,-10,12,2,0,1,1,-6,7,1,-4,7,3,1,0,1,-3,-11,-11,-1,-2,3,-2,0,-3,-1,-1,-1,-1,1,-1
KR_6668908793,420,-2,1,-20,-6,-1,2,1,-7,8,1,-1,3,2,2,1,3,1,0,1,0,-4,7,3,-7,4,3,0,0,0,-1,0,1,0,-1
KR_6748149162,420,-5,-54,-44,-8,0,1,1,2,0,2,-1,2,1,-6,6,0,-3,5,2,0,-5,-9,-1,-4,5,-4,0,0,-1,1,-1,-1,2,-1
KR_6729349810,420,-5,-102,-24,-16,-5,6,1,-3,3,0,-4,5,1,-2,2,0,-2,2,0,0,-8,7,-2,0,2,-2,0,-1,0,-1,-1,-1,0,-1
KR_6744903516,420,0,35,0,3,2,1,3,4,1,5,0,0,0,0,0,0,-3,3,0,0,3,-3,1,-4,3,-2,0,0,-1,1,0,1,5,-1
KR_6762305261,420,-1,15,-22,-6,1,2,3,2,2,4,-1,2,1,-7,7,0,-1,1,0,0,-2,1,-3,-2,5,0,0,0,1,-1,1,-1,6,-1
KR_6752950787,420,-2,12,-8,-9,-2,2,0,-9,10,1,-1,3,2,2,1,3,1,0,1,0,-5,0,5,-8,3,-2,0,0,-1,1,0,-1,5,-1
KR_6722889577,420,0,19,-32,-1,-1,1,0,-1,4,3,4,0,4,4,1,5,-7,12,5,0,1,103,3,-3,0,-2,0,1,1,1,1,-1,3,-1
KR_6655997661,420,0,15,-19,-3,2,0,2,-3,3,0,-1,5,4,-1,4,3,0,1,1,0,-5,143,-1,-2,3,2,0,1,-1,1,1,-1,5,-1
KR_6716391880,420,-3,-2,-2,-4,0,3,3,-3,4,1,-1,4,3,-1,4,3,1,0,1,0,-6,-80,0,-4,4,1,0,0,1,0,-1,1,3,-1
KR_6702097610,420,-2,0,4,-1,1,2,3,1,1,2,-7,8,1,2,0,2,2,1,3,0,-3,26,0,-6,6,0,0,-1,1,-1,-1,1,2,-1
KR_6749326961,420,2,63,20,3,-2,2,0,0,3,3,-3,6,3,8,1,9,0,2,2,1,7,-2,0,-1,1,1,0,0,-1,1,1,1,4,-1
KR_6661704781,420,-3,-75,0,-6,0,1,1,4,2,6,-6,8,2,-3,3,0,-1,1,0,-1,-9,-2,0,-2,2,-1,0,-2,-1,0,-1,-1,1,-1
KR_6758244648,420,0,-95,16,-5,4,0,4,0,1,1,-4,4,0,-4,4,0,-1,1,0,0,-9,11,-6,-1,7,-4,0,-1,1,1,-1,-1,1,-1
KR_6603834255,420,-3,-96,-25,-4,-1,2,1,-1,2,1,-2,3,1,0,1,1,0,0,0,0,-3,-14,-4,-3,7,4,0,-2,-1,1,-1,1,1,-1
KR_6748603273,420,1,-74,14,3,-2,3,1,5,1,6,1,1,2,-1,2,1,0,0,0,0,4,-1,-1,-3,4,5,0,0,1,-1,-1,-1,1,-1
KR_6753883297,420,-4,-5,31,-12,-1,3,2,0,3,3,-1,3,2,-8,8,0,-2,4,2,0,-13,62,-1,-2,3,-1,0,-1,1,1,-1,-1,2,-1
KR_6720099483,420,-3,-58,15,-7,-2,2,0,-3,5,2,0,3,3,-2,4,2,0,0,0,-1,-11,-10,-3,-2,5,-3,0,-1,0,1,-1,-1,0,-1
KR_6684515456,420,-3,-66,-15,-1,-5,6,1,1,1,2,2,0,2,1,4,5,0,1,1,0,3,13,3,-7,4,-5,0,-1,-1,1,-1,-1,6,-1
KR_6756478249,420,0,11,-16,-3,8,0,8,-2,3,1,-5,6,1,-3,5,2,-1,1,0,-2,-9,-2,-2,-2,4,-2,0,0,-1,-1,-1,-1,2,-1
KR_6649750811,420,-6,-115,-53,-13,-3,3,0,2,1,3,-10,13,3,-2,3,1,0,1,1,-1,-12,-8,7,-10,3,1,0,-3,-1,-1,-1,-1,5,-1
KR_6719385892,420,1,1,24,2,0,1,1,4,1,5,-3,3,0,-1,7,6,2,0,2,1,2,28,-3,-2,5,1,0,1,0,1,1,-1,0,-1
KR_6727167011,420,-6,-102,-22,-14,-11,11,0,1,2,3,-2,3,1,1,2,3,-3,3,0,0,-2,-294,-1,-2,3,-1,0,-4,-1,-1,-1,-1,6,-1
KR_6751913538,420,1,-31,9,-6,-4,4,0,0,2,2,2,0,2,-3,6,3,-1,2,1,0,-6,-176,0,-3,3,0,0,1,-1,1,1,-1,4,-1
KR_6616917368,420,-1,11,-8,-2,0,0,0,-1,2,1,1,1,2,-3,6,3,1,0,1,-1,-3,-153,-1,-2,3,-2,0,0,-1,-1,-1,-1,6,-1
KR_6717387607,420,-1,-48,0,-4,-4,5,1,5,1,6,0,1,1,-5,5,0,0,0,0,0,4,-37,-1,-1,2,9,0,-1,-1,1,-1,-1,3,-1
KR_6756069457,420,-5,-82,-42,-10,1,0,1,-1,1,0,-5,8,3,-3,3,0,-2,3,1,0,-5,-6,-2,-4,6,-4,0,-3,-1,-1,-1,-1,4,-1
KR_6694478695,420,0,-37,-8,3,-2,3,1,-1,5,4,3,0,3,4,2,6,-1,1,0,0,13,-126,2,-6,4,2,0,0,-1,-1,-1,-1,2,-1
KR_6628662766,420,-4,-81,-14,-7,2,1,3,-4,5,1,-6,7,1,1,1,2,0,1,1,0,-13,2,0,-4,4,-3,0,0,-1,-1,-1,-1,5,-1
KR_6655943562,420,1,3,-28,4,-1,1,0,1,2,3,1,1,2,3,1,4,0,2,2,0,6,18,-1,-5,6,-2,0,1,1,-1,1,-1,4,-1
KR_6608587725,420,-1,20,-37,6,3,1,4,4,0,4,0,3,3,0,4,4,-1,1,0,0,7,5,2,-7,5,-2,0,0,-1,-1,0,1,2,-1
KR_6754430435,420,0,8,-12,-3,-1,1,0,3,1,4,-1,3,2,-1,5,4,-3,3,0,0,-3,-117,-2,-4,6,0,0,1,1,-1,1,1,4,-1
KR_6761487450,420,1,7,-27,3,-2,2,0,-4,4,0,4,1,5,1,2,3,4,0,4,0,5,12,-7,-1,8,-1,0,0,-1,1,0,1,2,-1
KR_6719228273,420,-1,18,12,-4,-1,2,1,-2,4,2,2,1,3,-1,2,1,-2,2,0,0,-3,16,3,-5,2,0,0,0,-1,1,0,1,3,-1
KR_6748029574,420,-2,-68,-28,-6,-8,8,0,-2,5,3,-1,4,3,6,1,7,-1,1,0,-1,3,-141,-1,-5,6,2,0,-1,-1,-1,-1,-1,3,-1
KR_6762760037,420,-3,-145,-9,-8,-11,11,0,5,0,5,2,2,4,-3,3,0,-1,1,0,-1,1,3,5,-9,4,-1,0,0,-1,1,-1,-1,4,-1
KR_6696901216,420,-4,-28,-42,-6,-5,5,0,-1,3,2,2,2,4,-2,6,4,0,0,0,0,-5,0,0,-3,3,1,0,-2,1,-1,-1,1,1,-1
KR_6752455794,440,0,32,-20,-3,-2,4,2,1,0,1,1,1,2,1,4,5,-4,6,2,0,-4,1,1,-4,3,1,0,-1,-1,-1,-1,-1,1,-1
KR_6662863734,420,3,66,-4,7,-4,4,0,8,0,8,-4,4,0,5,1,6,2,0,2,0,10,-4,-4,-3,7,4,0,2,-1,0,1,1,4,-1
KR_6724173182,420,-2,-42,24,-10,-1,2,1,0,1,1,-8,8,0,-2,2,0,1,1,2,0,-7,-2,-2,-3,5,-2,0,-1,-1,0,-1,-1,1,-1
KR_6673554992,420,-6,2,-2,-14,2,0,2,-5,6,1,-5,6,1,0,1,1,-6,8,2,0,-16,-20,-4,-1,5,-1,0,0,0,-1,-1,-1,0,-1
KR_6762320617,420,-7,-40,-10,-13,-4,4,0,-5,9,4,-5,5,0,3,2,5,-2,3,1,0,-5,-1,-4,-1,5,-3,0,0,-1,1,1,-1,2,-1
KR_6754297683,420,-2,-33,-33,-12,-1,2,1,-1,2,1,-4,8,4,-3,5,2,-3,4,1,0,-8,10,-6,0,6,-1,0,-1,1,-1,-1,-1,2,-1
KR_6717289871,420,0,16,10,0,5,0,5,-2,2,0,-1,1,0,-1,1,0,-1,1,0,0,-8,-6,-7,-1,8,2,0,0,-1,-1,0,1,3,-1
KR_6746370612,420,-3,-96,-22,-8,-3,3,0,-1,3,2,-2,5,3,-1,2,1,-1,2,1,0,-1,-262,-1,-4,5,0,0,-2,-1,-1,-1,-1,4,-1
KR_6597449575,420,-5,-63,-18,-4,3,0,3,-4,6,2,3,0,3,-6,6,0,0,1,1,0,-8,11,1,-5,4,-1,0,-1,-1,-1,-1,1,5,-1
KR_6649782752,420,2,40,-28,5,1,0,1,1,0,1,1,1,2,2,0,2,0,0,0,0,5,6,5,-7,2,3,0,0,-1,1,0,1,5,-1
KR_6740526216,420,0,-27,1,-9,0,4,4,-3,9,6,-2,3,1,-2,3,1,-2,2,0,0,-2,6,1,-3,2,-2,0,-1,0,-1,-1,-1,0,-1
KR_6592301465,420,-2,-25,-3,-3,0,2,2,1,3,4,-2,2,0,-2,5,3,0,2,2,0,-2,-10,-1,-5,6,0,0,1,-1,1,1,-1,1,-1
KR_6672709142,420,0,0,9,-1,0,1,1,1,2,3,1,2,3,-2,3,1,-1,2,1,0,1,-172,-4,-1,5,0,0,0,-1,-1,0,-1,2,-1
KR_6752545627,420,-1,6,16,-1,1,2,3,0,3,3,3,0,3,-5,7,2,0,0,0,0,-6,-26,-3,0,3,-3,0,0,0,-1,-1,-1,0,-1
KR_6758029543,420,-6,42,-46,-2,2,0,2,1,1,2,-4,6,2,0,4,4,-1,1,0,0,-3,51,5,-5,0,-22,0,-2,-1,-1,-1,-1,6,-1
KR_6715382516,420,-4,-103,-24,-1,1,2,3,-3,3,0,-1,4,3,2,2,4,0,0,0,0,8,4,5,-7,2,0,0,-2,-1,0,-1,1,2,-1
KR_6675509378,420,-1,-27,-9,-9,-1,1,0,-1,3,2,0,3,3,-7,7,0,0,1,1,0,-11,-32,-3,-2,5,5,0,0,1,-1,0,-1,4,-1
KR_6707254023,420,0,-52,-16,-5,-2,3,1,-2,5,3,1,1,2,-2,3,1,0,1,1,-1,-3,-5,-3,-2,5,-2,0,-1,-1,-1,-1,-1,4,-1
KR_6737098763,420,-1,44,4,-6,4,0,4,-8,9,1,-2,4,2,0,0,0,0,0,0,0,-10,-6,1,-5,4,-2,0,1,1,-1,1,1,5,-1
KR_6762283447,420,2,-82,6,1,1,1,2,-2,2,0,3,3,6,-2,7,5,1,0,1,0,-3,-16,0,-5,5,2,0,0,0,-1,0,-1,0,-1
KR_6734600229,420,4,1,20,14,-3,5,2,8,1,9,0,3,3,4,0,4,5,0,5,0,19,-373,-1,-2,3,-1,0,1,0,1,1,-1,0,-1
KR_6618454859,420,-2,-143,-12,0,-7,7,0,1,1,2,3,0,3,1,4,5,2,0,2,0,7,32,0,-3,3,1,0,-1,1,1,-1,-1,6,-1
KR_6727248600,420,-3,10,-34,2,-3,3,0,-3,6,3,2,2,4,-1,2,1,7,1,8,0,11,-5,-6,-2,8,6,0,0,1,-1,-1,1,3,-1
KR_6751200539,420,-4,-83,32,-15,0,2,2,-5,5,0,-3,5,2,-7,8,1,0,0,0,0,-9,2,-2,-2,4,2,0,1,1,1,1,-1,2,-1
KR_6588205478,420,1,-28,4,-6,1,2,3,-1,5,4,-1,5,4,-4,6,2,-1,1,0,0,1,12,-3,-5,8,-4,0,-1,-1,-1,-1,1,3,-1
KR_6731055834,420,-2,-70,4,-7,-1,1,0,-3,4,1,-4,5,1,1,2,3,0,0,0,0,-5,38,1,-7,6,-31,0,-1,-1,-1,-1,-1,4,-1
KR_6706835666,420,-2,-24,3,-4,0,0,0,0,3,3,-3,4,1,-1,2,1,0,1,1,0,-6,41,2,-4,2,-36,0,-1,-1,-1,-1,-1,6,-1
KR_6756325650,420,-2,-50,-20,-9,-2,3,1,0,0,0,-5,5,0,-2,4,2,0,0,0,0,-6,2,0,-2,2,-5,0,-3,0,-1,-1,-1,0,-1
KR_6601346396,420,-1,-42,32,5,-7,7,0,1,3,4,-3,4,1,11,1,12,3,0,3,2,10,1,3,-7,4,0,0,0,-1,1,1,1,3,-1
KR_6642965231,420,-4,-130,-36,-3,-2,6,4,0,1,1,2,0,2,-2,2,0,-1,1,0,0,4,-1,1,-2,1,-2,0,-1,0,-1,-1,1,0,-1
KR_6761338300,420,3,9,7,8,2,0,2,4,2,6,4,1,5,0,2,2,-2,3,1,0,6,-1,4,-4,0,2,0,-1,0,0,-1,-1,0,-1
KR_6750415145,420,0,-12,-4,2,2,2,4,0,3,3,1,1,2,-2,2,0,1,1,2,0,-1,5,-2,-3,5,2,0,0,1,-1,0,1,1,-1
KR_6729445953,420,-10,-63,-15,-5,-2,3,1,0,3,3,-1,4,3,-2,2,0,0,1,1,-1,-8,-8,-2,-1,3,-3,0,-1,-1,-1,-1,-1,1,-1
KR_6746862589,420,-1,-32,-7,-6,0,3,3,-8,9,1,-1,2,1,3,1,4,0,0,0,0,-2,118,-2,-4,6,1,0,0,-1,1,0,-1,4,-1
KR_6617907120,420,1,14,32,3,-2,5,3,-4,5,1,4,1,5,1,0,1,4,0,4,1,0,2,1,-6,5,-5,0,0,1,-1,1,1,2,-1
KR_6569373474,420,0,-20,-4,-1,0,3,3,-1,6,5,3,1,4,-4,6,2,1,1,2,0,0,13,5,-10,5,-1,0,-1,1,0,-1,-1,6,-1
KR_6657295246,420,0,-28,-28,-6,3,0,3,-6,7,1,1,3,4,-1,6,5,-3,3,0,0,-4,-1,-9,-2,11,1,0,-1,-1,-1,-1,-1,1,-1
KR_6760303897,420,-2,-27,-24,-6,0,2,2,3,0,3,-5,5,0,0,2,2,-4,5,1,-1,-1,29,-5,-2,7,3,0,-2,-1,-1,-1,-1,2,-1
KR_6671263247,420,-3,-56,-4,-12,-2,2,0,-2,3,1,-1,2,1,-6,6,0,-1,1,0,0,-10,-29,2,-6,4,0,0,-2,-1,-1,-1,-1,3,-1
KR_6692480942,420,-3,-28,16,-7,-3,4,1,-4,7,3,-1,2,1,1,2,3,0,0,0,0,-6,-11,-1,-2,3,-1,0,0,1,-1,0,1,2,-1
KR_6751707190,420,-2,7,-23,-5,0,4,4,0,2,2,1,5,6,-2,2,0,-4,5,1,0,-14,-18,0,-3,3,-2,0,-1,-1,-1,-1,-1,4,-1
KR_6732431177,420,-1,49,-24,-6,-1,2,1,-3,4,1,1,1,2,-3,5,2,0,4,4,0,-7,1,-4,-1,5,-4,0,1,0,1,1,-1,0,-1
KR_6756281688,420,4,26,27,13,0,0,0,3,2,5,6,1,7,3,4,7,1,0,1,0,15,-4,4,-4,0,2,0,0,1,1,1,1,3,-1
KR_6665299288,420,0,-28,20,-6,-2,2,0,-2,3,1,-2,2,0,-1,2,1,1,0,1,0,-3,8,-3,-2,5,0,0,1,0,-1,1,-1,0,-1
KR_6750932245,420,0,-12,16,7,-1,3,2,1,1,2,7,2,9,2,3,5,-2,2,0,0,5,2,1,-4,3,1,0,0,1,-1,-1,1,3,-1
KR_6761723975,440,-2,7,-24,-8,2,0,2,-3,3,0,-4,5,1,-1,2,1,-2,2,0,0,-3,-13,-8,-4,12,-1,0,1,1,-1,1,1,4,-1
KR_6752380890,420,-5,-62,-32,-15,-1,2,1,-3,5,2,-6,6,0,-7,8,1,2,2,4,0,-7,-49,-11,-1,12,20,0,-1,-1,-1,-1,-1,2,-1
KR_6690882179,420,-2,-18,-16,-1,-1,3,2,4,3,7,-5,5,0,1,1,2,0,1,1,0,0,-32,2,-3,1,14,0,2,1,-1,1,-1,4,-1
KR_6635027621,440,-3,-30,0,-2,-1,6,5,1,1,2,1,1,2,-1,3,2,-2,2,0,0,-2,8,1,-3,2,-1,0,-1,0,0,-1,-1,0,-1
KR_6757025229,420,-2,-66,-36,-2,0,0,0,-1,1,0,-1,4,3,0,4,4,0,0,0,0,-1,38,-2,-2,4,1,0,0,0,1,-1,-1,0,-1
KR_6686838901,420,-3,13,-16,-4,-3,3,0,0,4,4,2,4,6,-3,5,2,0,0,0,0,-5,3,-4,-1,5,-2,0,0,1,1,0,-1,3,-1
KR_6655984526,420,0,65,-28,-3,2,2,4,-4,4,0,1,0,1,-1,4,3,-1,1,0,0,-8,2,-1,-3,4,0,0,0,1,-1,-1,1,4,-1
KR_6716408605,440,-7,-127,-36,-16,-12,14,2,1,1,2,-8,9,1,-1,1,0,4,1,5,-1,-9,-5,-2,-3,5,-4,0,-2,-1,0,-1,-1,1,-1
KR_6636725213,420,-3,-2,-12,-11,-10,10,0,2,1,3,-8,9,1,3,2,5,2,1,3,-1,-2,262,-2,-5,7,1,-1,-2,1,-1,-1,-1,6,-1
KR_6743209758,440,0,-39,12,-6,2,1,3,0,2,2,-2,4,2,-4,5,1,-2,3,1,0,-6,-7,1,-5,4,-2,0,1,1,-1,1,1,4,-1
KR_6740651438,420,-7,-98,4,-5,-4,5,1,4,0,4,0,4,4,-1,6,5,-4,4,0,-3,-5,-311,2,-4,2,1,0,0,-1,0,-1,-1,2,-1
KR_6726029636,420,1,16,-4,-1,-2,2,0,-4,6,2,1,2,3,-2,6,4,6,2,8,1,1,29,-1,-6,7,4,0,0,-1,0,0,1,6,-1
KR_6733609677,420,-2,-105,-12,-5,-1,4,3,3,0,3,-2,6,4,-2,4,2,-3,3,0,0,-8,-1,-5,-4,9,-4,0,-2,-1,-1,-1,1,1,-1
KR_6757813316,420,-1,-114,-8,-3,-7,8,1,-2,3,1,4,0,4,1,3,4,1,4,5,0,2,-13,0,-6,6,3,0,-1,1,0,-1,-1,6,-1
KR_6733790392,420,-4,-41,3,-7,-3,5,2,-6,8,2,-3,4,1,4,0,4,1,0,1,0,-7,-1,-3,-5,8,-2,0,-1,-1,1,-1,1,5,-1
KR_6748241469,420,-1,-11,-4,-5,-5,6,1,-4,6,2,-6,7,1,6,0,6,4,0,4,0,-1,-7,-3,-1,4,-1,0,1,-1,1,1,-1,5,-1
KR_6672647725,420,-3,8,-41,-11,-1,2,1,-4,4,0,-4,4,0,-1,4,3,-1,1,0,-2,-9,-5,1,-3,2,-2,0,-1,-1,-1,-1,-1,3,-1
KR_6750679650,420,-1,-3,-9,-4,-2,3,1,-2,5,3,-2,2,0,3,0,3,-1,1,0,0,-3,-10,-8,0,8,-2,0,0,-1,-1,0,-1,4,-1
KR_6621767033,420,-3,-41,-28,-8,2,0,2,-1,2,1,-4,4,0,-4,5,1,-1,1,0,0,-6,-2,-3,-2,5,-2,0,0,-1,1,0,-1,1,-1
KR_6706706213,420,1,-7,-4,0,-3,4,1,3,1,4,1,5,6,-2,2,0,1,0,1,0,-2,10,0,-2,2,2,0,0,-1,1,0,-1,1,-1
KR_6677638897,420,0,-11,8,1,2,2,4,-3,3,0,1,4,5,1,1,2,0,2,2,0,-4,-56,-2,-4,6,-1,0,1,-1,1,1,-1,5,-1
KR_6739449803,420,-1,76,-9,-4,-3,3,0,-1,3,2,-1,1,0,2,1,3,-1,1,0,0,-3,-18,-3,-1,4,0,0,1,-1,-1,1,1,4,-1
KR_6679963404,420,-2,64,-5,-3,2,0,2,0,2,2,3,1,4,-5,7,2,-3,4,1,0,-9,2,2,-3,1,-5,0,0,-1,1,1,1,3,-1
KR_6691297962,420,-1,-74,31,-2,2,1,3,4,1,5,-4,5,1,-4,4,0,0,1,1,0,-8,-254,3,-6,3,-1,0,-1,-1,1,-1,-1,3,-1
KR_6674491891,420,-2,-32,-8,-3,3,0,3,2,1,3,-5,6,1,-3,4,1,0,0,0,0,-10,-11,1,-7,6,-2,0,0,0,1,0,1,0,-1
KR_6734631340,440,-7,-146,-48,-8,-5,7,2,-3,3,0,0,2,2,0,0,0,0,0,0,0,-4,-3,-6,-2,8,-4,0,-1,-1,-1,-1,-1,1,-1
KR_6760341417,420,1,44,0,1,5,0,5,2,1,3,-4,7,3,-1,4,3,-1,1,0,0,6,-16,-3,-6,9,-5,0,0,-1,-1,1,1,3,-1
KR_6740391924,440,-1,-30,-8,1,3,3,6,-1,3,2,0,1,1,-1,1,0,0,0,0,0,-4,15,4,-4,0,-9,0,0,-1,1,0,1,6,-1
KR_6760503339,440,-4,-25,-44,-6,-4,5,1,-3,3,0,-1,5,4,0,1,1,2,0,2,0,-5,-4,0,-2,2,-5,0,-1,-1,-1,-1,-1,6,-1
KR_6606184808,420,-3,-75,-13,2,0,2,2,2,6,8,0,3,3,0,2,2,0,2,2,-1,-7,-18,-3,-2,5,-2,0,-1,0,-1,-1,-1,0,-1
KR_6687793841,420,-4,-70,-12,-8,1,1,2,-3,4,1,1,2,3,-7,10,3,0,2,2,0,-8,35,-2,-1,3,-32,0,-2,-1,-1,-1,1,4,-1
KR_6710931293,420,-4,15,-25,-11,-6,6,0,-4,5,1,1,2,3,-2,7,5,0,0,0,-1,-5,21,3,-7,4,2,0,-1,0,-1,-1,-1,0,-1
KR_6669781440,420,-5,1,7,-12,2,0,2,-2,5,3,-7,7,0,-1,4,3,-4,6,2,0,-10,-9,4,-8,4,-1,0,-2,-1,1,-1,-1,4,-1
KR_6751003541,420,5,101,-3,8,3,0,3,0,1,1,5,3,8,-2,8,6,2,0,2,0,1,-15,-13,-1,14,4,0,3,-1,1,1,1,4,-1
KR_6628813516,420,-4,-57,-12,-6,-1,1,0,1,4,5,-3,5,2,-2,3,1,-1,1,0,0,2,3,-4,-3,7,-1,0,-2,-1,-1,-1,-1,1,-1
KR_6759647079,440,1,114,3,-2,0,0,0,-1,4,3,0,2,2,-1,2,1,0,0,0,0,-1,-10,-4,-2,6,2,0,1,-1,1,1,1,5,-1
KR_6705211860,420,-2,26,-16,-6,-1,1,0,-2,2,0,-5,6,1,2,1,3,0,3,3,0,-7,-2,-7,-1,8,0,0,-1,-1,1,-1,1,4,-1
KR_6761917793,420,-2,-19,-20,-3,-2,3,1,1,1,2,-5,5,0,2,2,4,1,4,5,0,0,104,-1,-6,7,3,0,-1,-1,-1,-1,-1,1,-1
KR_6726621645,420,-5,-65,-27,-6,-6,6,0,0,4,4,1,2,3,-1,2,1,0,0,0,0,-8,32,1,-7,6,-14,0,-2,1,0,-1,-1,1,-1
KR_6761847067,440,-4,-50,-4,-4,-4,5,1,-3,3,0,-1,3,2,2,5,7,2,0,2,0,1,2,4,-7,3,7,0,0,1,-1,0,-1,6,-1
KR_6759185071,420,-4,-41,12,-6,0,2,2,-5,7,2,0,2,2,0,1,1,-1,1,0,0,-6,-5,-3,-8,11,3,0,-1,1,-1,-1,-1,2,-1
KR_6653884979,420,-2,-3,11,-2,-1,2,1,2,2,4,-2,5,3,-1,4,3,0,0,0,0,2,11,-2,-4,6,7,0,-2,-1,-1,-1,-1,3,-1
KR_6734075844,420,0,27,-12,1,-1,1,0,-1,4,3,2,1,3,2,2,4,-1,1,0,1,3,17,-5,-5,10,0,0,0,-1,1,0,1,5,-1
KR_6715630364,420,-3,-58,-11,-5,2,1,3,-1,2,1,-3,3,0,-3,5,2,0,1,1,0,2,-123,-5,-3,8,3,0,-1,0,1,-1,-1,0,-1
KR_6760937502,420,-2,-7,4,-14,-4,6,2,-4,4,0,-6,7,1,-1,2,1,1,0,1,0,-6,218,-1,-2,3,-1,0,0,-1,1,-1,-1,4,-1
KR_6659950888,420,-1,5,-4,-5,1,1,2,1,2,3,-5,7,2,-2,3,1,0,1,1,0,-1,-15,-3,-2,5,0,0,-1,0,-1,-1,-1,0,-1
KR_6528536628,420,0,-66,19,4,1,1,2,-3,3,0,3,2,5,2,2,4,1,0,1,0,3,109,1,-3,2,2,0,0,-1,1,1,-1,3,-1
KR_6717502037,420,0,-23,8,-4,1,2,3,-6,8,2,0,1,1,3,1,4,-2,3,1,1,6,-2,1,-3,2,1,0,0,1,-1,0,1,4,-1
KR_6331545835,420,2,-14,24,3,-5,6,1,7,0,7,-1,2,1,1,3,4,1,0,1,0,4,9,-1,-2,3,1,0,1,1,-1,1,-1,6,-1
KR_6737534948,420,-6,-145,-21,-8,-2,4,2,2,2,4,-1,4,3,-6,6,0,-1,2,1,0,-3,-334,-5,-4,9,17,0,-2,-1,-1,-1,1,5,-1
KR_6705816265,440,-2,-60,-14,0,0,1,1,6,1,7,2,2,4,-6,9,3,-2,2,0,0,4,-5,2,-3,1,5,0,-1,0,1,-1,1,0,-1
KR_6753336950,420,0,-70,12,-3,3,0,3,2,1,3,-6,6,0,2,2,4,-4,4,0,-1,-9,-4,3,-5,2,-2,0,0,-1,-1,0,-1,4,-1
KR_6683009458,440,-3,3,8,-9,6,1,7,-4,5,1,-2,5,3,-8,9,1,-1,2,1,-2,-15,3,1,-3,2,-2,0,0,-1,1,0,-1,1,-1
KR_6649795360,420,1,-4,18,-3,-1,2,1,0,3,3,1,4,5,-1,2,1,-2,2,0,0,-5,34,2,-4,2,-3,0,0,-1,1,0,-1,4,-1
KR_6756474201,420,-2,77,32,-2,1,0,1,-2,2,0,3,0,3,-3,3,0,-1,1,0,0,-7,-55,-3,-3,6,-3,0,1,-1,1,1,1,5,-1
KR_6750088245,420,-2,-68,-58,-4,0,1,1,2,4,6,-1,2,1,-5,7,2,0,1,1,0,-2,105,-1,-6,7,1,0,-2,-1,-1,-1,-1,4,-1
KR_6748361741,420,-2,-56,-32,-12,2,0,2,0,2,2,-7,8,1,-5,8,3,-2,2,0,0,-9,4,3,-5,2,-6,0,-1,-1,-1,-1,-1,1,-1
KR_6762342264,420,-3,-72,-16,-12,-2,3,1,-1,1,0,-4,5,1,0,3,3,-5,5,0,1,-16,8,-2,-3,5,1,0,-1,1,1,-1,1,6,-1
KR_6652047600,420,1,18,5,-5,3,0,3,-3,5,2,-1,4,3,-2,2,0,-2,2,0,0,-13,-10,-4,-3,7,1,0,1,-1,1,1,1,2,-1
KR_6753559171,420,4,13,16,4,-1,3,2,1,1,2,2,1,3,1,5,6,1,1,2,0,3,0,-1,-4,5,2,0,1,0,-1,1,1,0,-1
KR_6757442808,420,-2,-119,-28,-7,-4,4,0,0,3,3,-3,4,1,0,3,3,0,2,2,0,3,-1,-5,-1,6,-2,0,-2,-1,-1,-1,1,6,-1
KR_6750346114,420,-4,-48,-15,-15,0,1,1,-3,3,0,3,1,4,-10,10,0,-5,5,0,0,-18,38,-1,0,1,-13,0,-1,0,0,-1,-1,0,-1
KR_6658768071,420,-7,-105,-19,-14,-4,4,0,-4,6,2,-5,7,2,-2,6,4,1,0,1,0,-15,4,-3,-1,4,2,0,-1,-1,1,-1,-1,6,-1
KR_6593195678,440,1,82,-2,-1,-1,1,0,3,2,5,4,1,5,-8,11,3,1,0,1,1,-6,-11,4,-5,1,-1,0,1,0,1,-1,-1,0,-1
KR_6500193036,420,-2,11,-32,-5,2,0,2,-1,3,2,-1,3,2,0,2,2,-5,6,1,0,-4,-10,-1,-4,5,-1,0,0,-1,1,0,-1,4,-1
KR_6757946962,420,0,48,-16,-4,-2,3,1,1,0,1,1,1,2,-3,3,0,-1,1,0,0,-5,0,-1,-3,4,4,0,0,-1,-1,0,-1,4,-1
KR_6733172000,420,-2,-82,-24,-7,-4,5,1,-4,5,1,3,0,3,-1,3,2,-1,1,0,0,-7,-119,0,-5,5,-4,0,-3,-1,-1,-1,1,4,-1
KR_6731964914,420,-3,-7,-4,-8,-6,7,1,0,1,1,0,2,2,1,0,1,-3,3,0,0,-10,2,-1,-4,5,-2,0,-2,-1,-1,-1,-1,3,-1
KR_6753242087,420,-6,-71,-20,-7,-4,5,1,-4,5,1,-8,9,1,9,2,11,0,1,1,0,0,-1,3,-6,3,2,0,-2,1,-1,-1,1,5,-1
KR_6674405605,420,-3,-35,-24,-2,0,4,4,1,2,3,-2,2,0,-1,7,6,0,0,0,0,7,2,2,-7,5,1,0,-1,1,-1,-1,-1,6,-1
KR_6749946778,420,-1,-25,-16,-1,1,3,4,-2,2,0,5,0,5,-2,2,0,-3,3,0,0,1,42,3,-5,2,-17,0,0,0,-1,0,1,0,-1
KR_6654573031,420,-1,38,1,-11,4,0,4,-4,5,1,-2,6,4,-6,7,1,-3,3,0,0,-19,16,0,-6,6,-1,0,0,-1,-1,1,-1,6,-1
KR_6718793475,420,-3,7,0,-5,1,1,2,1,3,4,2,1,3,-6,7,1,-3,3,0,0,-6,2,-1,-1,2,0,0,1,-1,1,1,1,3,-1
KR_6644744068,420,-8,-127,-8,-13,-1,2,1,-2,2,0,0,3,3,-9,12,3,-1,3,2,0,-11,-4,2,-5,3,-1,0,-5,-1,-1,-1,-1,1,-1
KR_6750955038,420,-6,-45,4,-19,-6,6,0,-2,3,1,-4,6,2,-5,5,0,-2,3,1,-1,-15,-9,-4,-2,6,-3,0,-1,1,0,-1,-1,3,-1
KR_6760254316,420,0,30,0,6,2,1,3,2,4,6,2,0,2,0,3,3,0,4,4,1,10,22,2,-5,3,2,0,0,0,1,0,1,0,-1
KR_6761878182,420,1,16,10,4,2,1,3,7,0,7,-4,5,1,-2,5,3,1,0,1,0,8,0,1,-4,3,6,0,2,1,0,1,-1,3,-1
KR_6704780927,420,1,-7,16,-3,-3,3,0,-1,3,2,3,0,3,0,5,5,-2,2,0,0,-1,-7,1,-2,1,3,0,1,1,1,1,-1,5,-1
KR_6685521348,420,0,-30,-41,2,-1,1,0,4,1,5,-2,4,2,1,1,2,0,0,0,-1,5,-57,-4,-2,6,2,0,-1,-1,-1,-1,-1,6,-1
KR_6649682951,420,-1,-8,-8,0,-2,4,2,2,1,3,-2,2,0,0,2,2,2,1,3,0,-4,-1,0,-5,5,2,0,0,1,-1,-1,-1,3,-1
KR_6693193537,420,0,-19,-14,-6,-1,1,0,-11,12,1,-3,3,0,9,1,10,0,1,1,0,-3,-3,1,-5,4,-1,0,0,-1,-1,0,-1,2,-1
KR_6693287518,420,-3,-49,2,-5,-1,2,1,3,3,6,-2,3,1,-3,5,2,-2,3,1,0,-7,-7,-2,-6,8,0,0,-1,-1,1,-1,1,3,-1
KR_6717531445,420,1,-30,50,-4,-2,3,1,-2,2,0,-5,5,0,2,0,2,3,1,4,0,-3,17,-2,-4,6,0,0,0,0,-1,1,1,0,-1
KR_6631445366,420,-2,66,-60,-5,-3,3,0,1,1,2,-4,4,0,1,2,3,0,1,1,0,-5,8,2,-6,4,0,0,1,-1,0,1,-1,5,-1
KR_6739705338,440,-6,-92,-36,-10,2,1,3,5,2,7,-3,4,1,-11,11,0,-3,3,0,-3,-15,-7,0,-3,3,-1,0,-2,-1,1,-1,-1,4,-1
KR_6761019026,420,0,14,-20,3,3,1,4,-3,3,0,1,6,7,4,1,5,-2,2,0,0,2,-4,-2,-2,4,1,0,0,-1,-1,0,-1,3,-1
KR_6676203925,420,-5,-120,-4,-8,1,0,1,-1,2,1,-9,11,2,0,2,2,1,1,2,0,-2,-17,0,-4,4,1,0,0,-1,1,-1,-1,5,-1
KR_6709400010,420,-1,-49,-16,-5,0,2,2,0,2,2,0,1,1,-2,3,1,-3,4,1,0,-3,-2,-1,-4,5,-3,0,0,-1,1,-1,-1,2,-1
KR_6715463283,420,0,27,17,9,-1,2,1,0,1,1,4,0,4,2,1,3,4,0,4,0,10,-5,3,-4,1,4,0,1,1,1,1,1,5,-1
KR_6759495290,420,0,104,13,-3,2,2,4,-3,5,2,-5,6,1,3,2,5,0,0,0,0,-15,4,3,-3,0,-1,0,3,1,-1,1,1,2,-1
KR_6615853373,420,0,-20,-8,-1,0,2,2,-4,5,1,2,1,3,1,2,3,0,1,1,0,5,24,4,-7,3,0,0,0,-1,1,1,-1,1,-1
KR_6734325751,440,-3,-57,0,0,-1,4,3,2,3,5,0,2,2,1,0,1,-2,2,0,-1,8,5,4,-6,2,-3,0,-1,1,1,-1,-1,4,-1
KR_6763502399,420,-4,-21,-1,-6,-2,3,1,1,4,5,-8,9,1,1,3,4,2,1,3,0,1,258,2,-4,2,1,0,-1,1,1,-1,-1,3,-1
KR_6670545281,420,-5,-59,-9,-8,0,0,0,-1,4,3,-2,4,2,-4,5,1,-1,2,1,0,-16,-2,-1,-2,3,2,0,0,-1,1,0,-1,4,-1
KR_6745558273,420,-2,-112,24,-1,-1,3,2,-3,3,0,4,0,4,-1,1,0,0,0,0,0,3,-13,2,-3,1,-1,0,-3,1,1,-1,-1,6,-1
KR_6699895884,420,4,84,20,14,6,1,7,1,2,3,1,2,3,5,5,10,1,0,1,1,9,7,1,-2,1,-10,0,2,0,0,1,1,0,-1
KR_6748287541,420,-2,-24,-12,0,3,0,3,-3,3,0,3,0,3,-4,6,2,1,0,1,0,-7,-26,2,-7,5,1,0,0,0,1,-1,-1,0,-1
KR_6747682702,440,-2,26,17,-8,-5,5,0,1,2,3,-1,2,1,1,1,2,-4,5,1,-1,-6,-338,-2,-3,5,1,0,-1,1,-1,-1,-1,6,-1
KR_6314038481,420,-3,-33,26,-2,-3,4,1,2,1,3,4,0,4,-4,5,1,-1,5,4,0,2,-9,-5,0,5,1,0,-1,0,1,-1,1,0,-1
KR_6752523777,440,-5,-135,-28,-12,1,4,5,-2,3,1,-1,3,2,-7,7,0,-3,5,2,0,-9,1,1,-2,1,-1,0,-1,-1,0,-1,1,1,-1
KR_6656930246,420,-3,-69,-18,-2,-4,5,1,-4,7,3,2,4,6,2,2,4,2,0,2,1,7,9,-2,-2,4,-4,0,0,-1,-1,-1,1,1,-1
KR_6737417001,420,-1,-9,12,0,-2,3,1,0,3,3,6,0,6,1,1,2,-5,5,0,0,-4,5,-3,-3,6,0,0,0,1,1,0,-1,5,-1
KR_6577111852,420,-1,-52,7,-3,-3,3,0,3,2,5,-7,10,3,5,0,5,-1,3,2,0,-1,7,3,-6,3,-4,0,-1,-1,0,-1,-1,5,-1
KR_6733804851,420,-1,-41,-12,-3,1,3,4,3,1,4,-4,4,0,-2,4,2,-1,2,1,0,-1,68,1,-3,2,-18,0,-2,1,-1,-1,1,2,-1
KR_6695315979,420,0,11,3,-5,-2,5,3,-1,3,2,-3,3,0,3,2,5,-2,3,1,0,-2,4,0,-5,5,5,0,-1,0,-1,-1,-1,0,-1
KR_6747765572,420,-1,-44,-29,4,-3,3,0,-1,5,4,2,2,4,6,2,8,0,1,1,1,5,-2,-2,-4,6,-5,0,-1,-1,-1,-1,1,4,-1
KR_6483115844,420,-1,-50,-1,-9,0,1,1,0,2,2,-9,10,1,-3,6,3,3,0,3,0,1,-4,1,-3,2,2,0,-1,-1,-1,-1,-1,5,-1
KR_6597684477,420,-3,-34,-16,-1,-5,7,2,-2,3,1,8,1,9,0,3,3,-2,2,0,-1,-2,-282,2,-3,1,-1,0,-1,-1,1,-1,-1,6,-1
KR_6745448613,420,0,9,4,-1,4,1,5,3,1,4,-5,5,0,-6,8,2,3,5,8,-1,-5,-3,2,-6,4,0,0,-1,-1,1,-1,-1,4,-1
KR_6701130115,420,-5,-126,-12,-5,-4,4,0,1,2,3,-1,2,1,-1,2,1,0,1,1,0,-4,-4,-3,-5,8,-2,0,-3,-1,1,-1,1,1,-1
KR_6761505378,420,1,47,-20,-3,-3,4,1,4,3,7,-6,6,0,0,3,3,2,2,4,-1,-5,-14,-3,-1,4,4,0,0,-1,0,0,-1,1,-1
KR_6759728938,420,0,-6,20,-3,1,3,4,2,2,4,-3,4,1,-4,5,1,1,1,2,0,-4,-28,-5,-3,8,-1,0,1,0,1,1,-1,0,-1
KR_6750374939,440,-1,26,0,2,-1,3,2,-1,3,2,1,1,2,3,2,5,0,1,1,0,3,-149,3,-7,4,1,0,2,1,-1,1,-1,3,-1
KR_6756476755,420,-3,-41,-16,-7,1,0,1,-5,8,3,-4,5,1,1,0,1,0,0,0,0,-12,-5,-3,-2,5,-4,0,-1,-1,-1,-1,1,4,-1
KR_6763187737,420,-1,-34,-1,-1,-3,3,0,-2,3,1,-2,5,3,5,0,5,1,0,1,0,-2,-12,-8,-3,11,3,0,0,-1,-1,1,-1,6,-1
KR_6729150307,420,-2,30,-8,-10,-3,4,1,-2,4,2,-3,4,1,-2,2,0,0,0,0,0,-10,-8,-1,-3,4,3,0,0,-1,1,1,-1,4,-1
KR_6738425562,420,2,18,-20,5,-3,4,1,7,3,10,1,4,5,-1,2,1,1,0,1,0,0,-14,-1,-3,4,2,0,1,-1,1,1,-1,4,-1
KR_6761312730,420,-6,-36,-10,-11,-2,3,1,-3,4,1,-5,6,1,0,2,2,-1,1,0,0,-8,-3,2,-4,2,0,0,-1,-1,-1,-1,-1,1,-1
KR_6681649488,420,-3,-52,14,-6,-7,8,1,-3,6,3,1,2,3,2,3,5,1,0,1,-1,-2,132,4,-6,2,-1,0,-1,1,1,1,-1,6,-1
KR_6721271242,420,2,60,32,7,4,1,5,-1,4,3,1,0,1,1,1,2,2,1,3,0,4,5,-1,-4,5,-1,0,1,0,-1,1,-1,0,-1
KR_6663034505,420,-1,30,-5,1,0,1,1,-1,2,1,2,0,2,1,6,7,-1,1,0,0,-1,-26,1,-3,2,3,0,0,0,1,0,1,0,-1
KR_6761311104,420,1,-24,-12,-1,-2,4,2,1,0,1,0,2,2,0,1,1,0,1,1,0,-4,4,-2,-6,8,-1,0,0,-1,-1,0,-1,6,-1
KR_6750221894,420,-1,-30,-24,-6,-4,5,1,2,2,4,0,2,2,-5,5,0,1,2,3,0,-4,22,-10,0,10,0,0,-2,-1,-1,-1,-1,3,-1
KR_6754050283,420,2,12,-31,8,5,2,7,0,5,5,1,3,4,-1,7,6,3,1,4,0,-4,34,5,-7,2,-1,0,0,-1,0,1,1,2,-1
KR_6759602190,420,-5,-14,-8,-8,0,2,2,1,1,2,-2,4,2,-4,6,2,-3,4,1,0,-8,5,-3,-1,4,1,0,0,-1,1,-1,1,6,-1
KR_6663613694,420,-2,34,-40,-9,0,0,0,-3,7,4,-3,7,4,-5,6,1,2,1,3,0,-14,-15,-4,-3,7,1,0,0,-1,1,1,-1,6,-1
KR_6746200642,420,-5,-61,-41,-12,1,1,2,-4,6,2,-3,5,2,-2,4,2,-4,4,0,-1,-9,-14,-1,-3,4,1,0,-4,-1,-1,-1,-1,6,-1
KR_6756235231,420,5,26,6,9,3,1,4,4,2,6,3,1,4,-2,2,0,1,1,2,0,12,106,-1,0,1,4,0,0,-1,0,0,1,2,-1
KR_6665286976,420,-4,-67,-16,-8,-2,4,2,-2,5,3,1,2,3,-4,7,3,-1,1,0,-2,-16,-5,-1,-4,5,0,0,-1,-1,0,-1,-1,6,-1
KR_6724222634,420,-3,-126,-7,-1,-1,2,1,3,1,4,2,2,4,-5,7,2,0,1,1,-1,-2,-64,5,-9,4,1,0,-1,1,-1,-1,-1,3,-1
KR_6756980750,420,2,79,30,0,3,0,3,1,2,3,0,4,4,-3,6,3,-1,3,2,0,-13,8,-3,-2,5,2,0,0,1,0,-1,1,2,-1
KR_6762906952,440,-6,-102,0,-13,-4,4,0,-6,6,0,-2,4,2,3,2,5,-4,4,0,-2,-8,-2,1,-3,2,-2,0,-2,-1,1,-1,-1,6,-1
KR_6734455516,420,0,10,-16,-1,1,1,2,-7,9,2,3,2,5,2,1,3,0,3,3,0,0,4,1,-5,4,-1,0,0,1,1,-1,1,1,-1
KR_6714409985,420,-7,-103,-20,-17,-1,3,2,-4,7,3,-4,6,2,-4,4,0,-4,4,0,0,-19,-568,1,-2,1,9,0,-2,-1,-1,-1,-1,3,-1
KR_6762242152,420,1,56,12,0,3,0,3,-1,8,7,3,2,5,-4,8,4,-1,1,0,0,5,-3,0,-3,3,1,0,3,1,1,1,-1,6,-1
KR_6749111458,420,-1,-14,12,-3,-3,4,1,0,2,2,-2,2,0,3,2,5,-1,1,0,0,1,-14,2,-6,4,-2,0,-1,0,-1,-1,-1,0,-1
KR_6683427722,420,1,51,-13,-7,-2,3,1,0,3,3,1,1,2,-6,6,0,0,2,2,0,-8,-28,1,-3,2,-2,0,-1,-1,1,-1,-1,3,-1
KR_6760551121,420,-3,-43,-21,-8,-2,4,2,-2,3,1,-1,4,3,-2,6,4,-1,2,1,0,-7,1,4,-6,2,-2,0,0,-1,-1,-1,-1,3,-1
KR_6731125468,420,0,18,-27,-11,-4,4,0,-2,4,2,5,3,8,-9,10,1,-1,1,0,0,-14,2,-5,-1,6,0,0,-2,-1,-1,-1,1,4,-1
KR_6674673967,420,-3,-23,-35,-6,0,3,3,-7,8,1,0,4,4,1,0,1,0,0,0,0,-6,1,4,-7,3,1,0,0,-1,1,0,-1,4,-1
KR_6657357675,440,-1,-87,4,2,-3,3,0,0,2,2,1,2,3,3,3,6,1,0,1,1,4,-6,-6,-2,8,7,0,1,1,-1,-1,1,1,-1
KR_6743408068,420,-2,-14,39,-1,-3,5,2,-2,4,2,4,0,4,-1,3,2,1,3,4,0,-3,-29,-3,-3,6,2,0,1,1,1,1,1,3,-1
KR_6723550049,420,1,-34,19,-9,-1,2,1,1,2,3,-4,4,0,-6,7,1,1,2,3,-2,-4,-12,-3,-2,5,5,0,1,1,-1,-1,-1,4,-1
KR_6733742217,420,-1,-23,-8,0,-1,1,0,1,2,3,-6,7,1,5,1,6,1,0,1,0,3,-17,0,-5,5,42,0,0,1,-1,-1,-1,5,-1
KR_6744979779,420,-1,-15,20,-3,1,1,2,0,1,1,-2,5,3,-1,1,0,-1,1,0,0,-1,-9,0,-3,3,-1,0,-1,-1,-1,-1,1,1,-1
KR_6715826457,420,0,-30,3,0,2,1,3,-1,1,0,-1,3,2,1,5,6,-1,1,0,0,1,-12,-2,-4,6,5,0,1,1,-1,1,-1,6,-1
KR_6758537108,440,-2,-23,-8,-6,0,3,3,-4,4,0,0,2,2,-4,5,1,2,0,2,-2,-10,-4,-2,-4,6,-1,0,-1,-1,-1,-1,-1,5,-1
KR_6715863249,420,-6,-67,-35,-19,-1,2,1,-8,9,1,-5,6,1,-3,4,1,-2,2,0,-1,-13,31,-3,-1,4,-2,0,-2,-1,-1,-1,-1,2,-1
KR_6699300356,420,-1,-32,-43,-2,1,3,4,-2,4,2,2,2,4,-1,4,3,-2,2,0,0,1,104,0,-2,2,2,0,0,0,1,-1,-1,0,-1
KR_6582166372,420,-4,-76,-7,-9,-2,3,1,-2,2,0,-3,5,2,-3,3,0,1,1,2,0,-7,-23,-3,-3,6,2,0,-1,1,-1,-1,-1,6,-1
KR_6755816545,420,-1,13,32,1,-1,2,1,4,1,5,0,6,6,-2,5,3,0,4,4,0,-10,104,-2,0,2,-4,0,-1,0,0,-1,1,0,-1
KR_6665250370,420,-2,2,-43,-1,0,2,2,0,3,3,1,2,3,-2,3,1,0,1,1,0,2,-2,-3,-3,6,-2,0,0,-1,-1,0,-1,2,-1
KR_6642904473,420,-5,-94,8,-5,-2,4,2,-5,5,0,0,4,4,1,1,2,1,0,1,0,-3,31,3,-6,3,3,0,-2,1,1,-1,-1,4,-1
KR_6757164163,420,-3,-93,16,-4,-1,2,1,5,0,5,4,0,4,-10,10,0,-2,2,0,-1,-3,17,1,-5,4,0,0,-2,-1,1,-1,-1,6,-1
KR_6690082484,420,-3,-7,33,-4,2,0,2,-3,3,0,-6,8,2,3,0,3,0,4,4,1,2,-154,0,-4,4,-2,0,0,1,1,-1,1,5,-1
KR_6649883802,420,1,-27,20,9,1,1,2,4,3,7,1,1,2,3,2,5,0,1,1,1,5,-14,-1,-3,4,-1,0,0,-1,-1,0,1,5,-1
KR_6587563178,420,-1,-74,15,-4,-1,2,1,-1,4,3,-4,6,2,3,3,6,-1,1,0,1,5,4,2,-7,5,-1,0,0,1,-1,-1,1,2,-1
KR_6737495494,420,-2,-59,-14,-4,-3,3,0,-2,3,1,3,0,3,2,1,3,-4,4,0,0,-5,25,-2,-2,4,2,0,0,-1,1,0,-1,4,-1
KR_6701471662,420,-5,-93,-12,-8,-5,5,0,-1,3,2,1,1,2,-2,5,3,-1,2,1,1,-5,2,2,-6,4,0,0,-1,1,-1,-1,1,1,-1
KR_6763384316,420,2,78,-18,3,-2,2,0,0,0,0,-3,4,1,10,1,11,-2,4,2,0,4,-3,-10,-2,12,3,0,1,1,-1,1,1,1,-1
KR_6658436666,420,-3,49,-28,-8,0,1,1,-2,5,3,-3,5,2,-4,5,1,1,1,2,0,-13,1,0,-3,3,2,0,0,1,-1,0,1,2,-1
KR_6738312826,420,-6,-21,-24,-7,0,4,4,-1,3,2,-3,3,0,0,4,4,-3,3,0,1,-4,-14,4,-7,3,-2,0,0,-1,-1,-1,1,4,-1
KR_6675669479,420,-3,-35,-21,-11,-2,2,0,-1,4,3,-1,3,2,-2,3,1,-5,5,0,0,-9,3,-1,-3,4,0,0,-1,-1,-1,-1,1,6,-1
KR_6665189847,440,-8,-144,-36,-12,-5,5,0,-1,1,0,-3,5,2,-3,5,2,0,2,2,0,-8,304,-3,-2,5,-1,0,-1,-1,-1,-1,-1,2,-1
KR_6756808297,420,-1,2,-20,-9,1,1,2,-2,3,1,0,2,2,-4,4,0,-4,4,0,0,-5,-2,-5,0,5,1,0,-1,-1,1,-1,-1,6,-1
KR_6698576628,420,-5,-82,-48,-6,-6,7,1,3,1,4,-3,5,2,0,0,0,0,0,0,0,3,15,-3,-2,5,0,0,-1,-1,-1,-1,-1,3,-1
KR_6672985501,420,0,65,-18,-5,3,1,4,-2,4,2,-2,4,2,-4,6,2,0,1,1,0,-7,-31,1,-4,3,0,0,0,-1,-1,0,1,6,-1
KR_6755555400,420,-1,5,-21,0,1,1,2,1,1,2,2,1,3,-3,4,1,-1,3,2,0,-2,-277,1,-3,2,1,0,-1,1,-1,-1,1,3,-1
KR_6759819152,420,-2,-74,3,2,-3,3,0,-1,3,2,5,1,6,2,1,3,-1,1,0,2,3,-2,0,-4,4,-2,0,-3,1,-1,-1,1,1,-1
KR_6742988587,440,-1,-60,8,-4,0,2,2,-4,6,2,-2,3,1,1,2,3,1,1,2,0,-4,2,-2,-6,8,-6,0,-1,1,-1,-1,1,5,-1
KR_6750211206,420,-7,-59,-27,-15,-4,4,0,-9,9,0,-3,4,1,1,3,4,0,2,2,0,-15,-7,-3,-1,4,-4,0,-2,-1,-1,-1,-1,1,-1
KR_6758931855,440,0,0,-4,-4,-1,1,0,1,4,5,-1,1,0,-3,6,3,0,1,1,0,-2,3,-2,-3,5,-3,0,-1,-1,-1,-1,1,6,-1
KR_6760527602,420,2,-35,-2,0,-3,3,0,1,4,5,2,2,4,5,1,6,-5,6,1,0,1,10,1,-6,5,-4,0,-1,1,-1,-1,1,2,-1
KR_6755430067,420,2,-91,-3,2,0,1,1,-1,4,3,3,1,4,-2,3,1,2,0,2,-1,-2,15,-2,-6,8,0,0,0,-1,0,0,-1,4,-1
KR_6633323606,420,-2,-53,-20,-4,-1,2,1,-5,6,1,1,2,3,0,4,4,1,0,1,0,-6,-129,-2,-5,7,1,0,0,-1,-1,0,1,6,-1
KR_6763789349,440,-8,-108,-46,-14,-1,2,1,0,2,2,-4,5,1,-8,8,0,-1,2,1,0,-6,-15,-1,-4,5,0,0,-1,-1,1,-1,-1,6,-1
KR_6762358110,420,1,17,-23,7,2,1,3,9,1,10,0,1,1,-1,2,1,-3,5,2,1,4,10,-1,-1,2,0,0,1,-1,1,1,1,4,-1
KR_6709162959,420,-4,-28,0,-5,-1,3,2,-3,4,1,2,1,3,-3,3,0,0,1,1,0,-9,-11,-3,-1,4,-4,0,-1,1,-1,-1,-1,6,-1
KR_6757687883,420,-2,-79,-33,3,-2,4,2,0,0,0,-1,1,0,6,0,6,0,0,0,0,10,2,-1,-3,4,-2,0,0,1,-1,-1,-1,2,-1
KR_6754020344,420,-5,-69,-29,-13,-6,6,0,4,1,5,-3,4,1,-6,7,1,-2,2,0,0,-4,39,1,-2,1,-14,0,-3,-1,-1,-1,-1,3,-1
KR_6762235154,420,4,14,40,7,3,0,3,-3,4,1,4,0,4,4,2,6,-1,2,1,0,2,9,4,-8,4,6,0,0,0,1,0,1,0,-1
KR_6751039741,440,-4,-44,-40,-8,-3,3,0,0,4,4,-1,4,3,-1,2,1,-3,4,1,0,-2,-17,1,-4,3,-4,0,-1,-1,-1,-1,1,4,-1
KR_6750990815,420,-5,-12,-57,-9,0,2,2,-6,6,0,-7,7,0,3,1,4,1,0,1,0,-2,10,3,-3,0,0,0,-1,-1,-1,-1,-1,6,-1
KR_6669546497,420,-5,-88,-11,-17,-2,3,1,-3,6,3,-6,8,2,-6,7,1,0,0,0,0,-10,-8,-3,-4,7,-1,0,-2,-1,-1,-1,-1,3,-1
KR_6712014686,420,0,78,28,0,3,3,6,-5,7,2,1,0,1,1,2,3,0,0,0,0,-4,11,2,-6,4,-5,0,0,1,-1,-1,1,3,-1
KR_6689548451,420,0,-23,13,0,-1,2,1,2,1,3,-3,4,1,0,1,1,2,3,5,0,0,-7,1,-6,5,-3,0,0,1,-1,0,1,3,-1
KR_6724527876,440,3,50,-20,15,2,0,2,0,2,2,1,1,2,9,0,9,3,0,3,0,13,4,2,-5,3,0,0,0,1,1,0,1,2,-1
KR_6761039213,420,0,-4,-20,-1,2,1,3,2,2,4,-4,5,1,0,1,1,-1,1,0,0,-1,9,2,-4,2,3,0,0,-1,0,0,-1,3,-1
KR_6730758699,420,-2,-14,-4,-3,0,0,0,-7,8,1,3,2,5,0,0,0,1,0,1,0,-8,-10,3,-5,2,3,0,0,1,0,0,1,1,-1
KR_6613998705,420,2,27,-13,4,4,1,5,-1,5,4,6,0,6,-2,4,2,-3,4,1,0,1,17,3,-3,0,0,0,1,1,-1,1,-1,6,-1
KR_6743128388,440,-1,13,-7,-6,4,0,4,0,2,2,-9,9,0,-4,4,0,3,0,3,0,-3,-14,1,-5,4,2,0,0,1,0,1,-1,2,-1
KR_6755113370,420,4,-21,-4,-5,1,2,3,-1,2,1,4,0,4,-8,8,0,-1,1,0,0,-10,14,0,-2,2,2,0,-1,1,1,1,-1,4,-1
KR_6725420877,420,-1,-36,-25,0,-4,6,2,2,2,4,2,2,4,1,3,4,-1,1,0,0,2,-13,2,-4,2,6,0,0,1,-1,1,1,6,-1
KR_6713405028,420,-10,-120,-25,-11,-4,4,0,-4,5,1,-2,2,0,0,2,2,-1,2,1,0,-6,-15,1,-5,4,3,0,-2,-1,-1,-1,1,1,-1
KR_6653078005,420,-2,-41,-32,-2,-1,1,0,-3,5,2,-1,4,3,3,0,3,0,0,0,0,1,-112,-3,-5,8,3,0,0,-1,0,1,1,4,-1
KR_6741073319,420,-4,-37,-8,-3,-2,3,1,-4,5,1,2,0,2,0,4,4,1,1,2,-1,0,9,1,-7,6,-4,0,-1,-1,-1,-1,1,4,-1
KR_6752644376,420,-3,-6,41,-17,1,1,2,-14,14,0,2,0,2,-6,6,0,0,1,1,1,-16,-10,-4,-2,6,3,0,-3,-1,1,-1,1,2,-1
KR_6552374833,420,-2,-50,15,-5,-3,5,2,4,0,4,-2,2,0,-2,2,0,-2,2,0,0,2,12,0,-7,7,-5,0,-2,-1,-1,-1,-1,2,-1
KR_6704094387,420,1,-5,3,2,1,1,2,-2,3,1,4,1,5,-4,5,1,3,1,4,-1,2,-17,-4,-2,6,1,0,-1,1,-1,-1,-1,5,-1
KR_6763341611,420,-1,-6,-20,-4,0,0,0,-1,1,0,-2,2,0,-1,1,0,0,0,0,0,-3,56,-1,-3,4,0,0,0,-1,1,1,-1,6,-1
KR_6731661148,420,-4,-25,-32,-7,-2,4,2,-2,3,1,-3,5,2,0,3,3,0,1,1,0,0,-28,-1,0,1,3,0,-1,0,-1,-1,-1,0,-1
KR_6764202905,420,-1,6,23,-6,0,3,3,3,2,5,-3,7,4,-2,6,4,-4,5,1,0,-16,-6,5,-10,5,-7,0,0,-1,0,-1,-1,2,-1
KR_6751852899,420,-4,-35,-8,-5,-1,1,0,-2,2,0,0,2,2,-2,6,4,0,0,0,0,-4,18,-2,-4,6,-3,0,0,-1,1,0,1,1,-1
KR_6762687834,420,-4,-95,-14,-2,-6,8,2,-2,4,2,2,2,4,2,4,6,2,2,4,0,9,-1,1,-4,3,1,0,-2,1,-1,-1,-1,4,-1
KR_6728568028,420,-1,-12,-31,2,0,3,3,3,1,4,1,0,1,-2,2,0,0,0,0,0,0,-2,-2,-5,7,4,0,0,-1,0,0,1,3,-1
KR_6722363778,440,2,-6,4,9,4,1,5,6,0,6,-5,8,3,0,1,1,4,1,5,0,11,258,0,-1,1,1,0,0,0,0,1,-1,0,-1
KR_6709744115,420,-2,-101,5,-5,3,0,3,2,0,2,1,1,2,-9,9,0,-2,2,0,-1,-9,-7,-1,-2,3,-2,0,-1,-1,1,-1,-1,1,-1
KR_6753338841,420,0,12,9,-5,-5,5,0,-3,5,2,2,1,3,2,1,3,-1,2,1,0,2,1,1,-3,2,-4,0,0,-1,0,0,-1,6,-1
KR_6764088735,420,0,-7,10,5,8,0,8,-1,2,1,-3,4,1,-1,1,0,2,0,2,0,4,5,4,-5,1,0,0,0,-1,1,1,1,1,-1
KR_6761380902,420,5,29,25,9,-2,3,1,0,2,2,6,1,7,4,1,5,1,2,3,1,17,-3,1,-4,3,2,0,1,-1,-1,1,1,3,-1
KR_6691881041,420,-2,-59,-8,3,-4,6,2,-1,2,1,3,1,4,5,1,6,0,1,1,1,7,0,4,-8,4,-3,0,-1,1,-1,-1,1,5,-1
KR_6693936381,440,0,34,10,-1,0,1,1,-5,6,1,1,5,6,4,2,6,-1,1,0,-1,-5,-36,-1,-3,4,2,0,0,-1,1,0,-1,6,-1
KR_6604060504,420,1,50,-9,6,-1,2,1,-2,5,3,2,1,3,3,0,3,4,1,5,0,13,7,3,-4,1,1,0,0,1,-1,0,1,6,-1
KR_6656837507,420,0,-19,-5,0,-1,1,0,1,0,1,-6,8,2,8,2,10,-2,2,0,1,9,9,0,-3,3,-1,0,0,-1,-1,1,1,5,-1
KR_6760200928,420,0,-43,12,1,-1,2,1,2,0,2,-1,2,1,2,1,3,-1,3,2,0,-1,2,2,-6,4,1,0,0,1,1,0,-1,2,-1
KR_6762477607,420,0,-120,-24,0,2,1,3,2,2,4,-6,6,0,3,0,3,-1,2,1,0,8,159,1,-5,4,15,0,-2,-1,0,-1,1,6,-1
KR_6753267726,420,0,43,5,-3,-1,3,2,0,2,2,-1,5,4,-3,4,1,2,0,2,0,-5,11,0,-6,6,-7,0,0,-1,-1,-1,-1,3,-1
KR_6760664259,420,-2,-39,12,-8,-1,2,1,-2,3,1,-2,2,0,-1,3,2,-2,4,2,-1,-5,-4,-2,-4,6,2,0,0,1,0,-1,-1,5,-1
KR_6647317820,420,-9,-83,-24,-16,0,2,2,-3,4,1,-3,3,0,-6,7,1,-4,4,0,0,-12,-6,-6,-1,7,0,0,-1,-1,-1,-1,-1,4,-1
KR_6757095896,420,-3,-19,0,-11,-4,4,0,-2,6,4,-1,3,2,-9,10,1,5,0,5,-1,-5,7,-3,-4,7,-5,0,-2,-1,-1,-1,-1,5,-1
KR_6761070637,420,-1,18,8,-4,-2,4,2,-2,2,0,0,4,4,0,0,0,0,0,0,0,-2,5,-2,-1,3,0,0,-2,-1,-1,-1,1,2,-1
KR_6762617301,420,0,-29,-9,-4,-1,3,2,-1,1,0,-2,3,1,-2,5,3,2,0,2,0,-4,20,0,-2,2,-6,0,-3,-1,-1,-1,-1,6,-1
KR_6719186157,420,-2,10,0,-9,0,4,4,1,1,2,-5,5,0,-2,2,0,-3,3,0,-1,-7,13,0,-2,2,-1,0,0,-1,1,1,-1,6,-1
KR_6756856347,420,-2,-10,0,5,-1,3,2,0,1,1,1,3,4,2,0,2,3,0,3,0,4,-11,4,-6,2,-1,0,-1,-1,1,-1,1,3,-1
KR_6762403010,420,-1,-24,21,-7,-5,5,0,-2,5,3,1,4,5,-1,4,3,0,1,1,0,-4,23,3,-4,1,3,0,-2,-1,1,-1,-1,2,-1
KR_6763222055,420,-1,1,8,-8,0,5,5,-3,4,1,0,4,4,-4,5,1,-1,1,0,0,-10,54,1,-3,2,-20,0,-1,1,1,-1,-1,6,-1
KR_6734545062,420,-7,-45,-43,-12,3,0,3,-5,6,1,-4,4,0,-6,7,1,0,1,1,0,-6,112,3,-6,3,-4,0,0,-1,-1,-1,-1,2,-1
KR_6670206431,420,-6,-79,-13,-10,-1,3,2,5,0,5,-6,7,1,-8,9,1,0,2,2,0,-10,2,-2,-1,3,-1,0,-1,1,1,-1,-1,4,-1
KR_6760258732,420,0,6,0,0,1,1,2,-3,5,2,-1,2,1,2,2,4,1,1,2,1,-2,5,-3,-1,4,-1,0,-1,-1,-1,-1,1,5,-1
KR_6730833155,420,-4,-2,-41,-5,-1,4,3,0,1,1,-1,3,2,-3,6,3,0,5,5,0,-5,-4,-3,-1,4,-1,0,0,1,-1,-1,1,2,-1
KR_6731599034,420,0,-71,19,-7,0,1,1,-1,5,4,-1,4,3,-5,7,2,0,1,1,0,-4,0,1,-6,5,-4,0,-1,-1,-1,-1,1,3,-1
KR_6726560387,420,-2,-35,2,-9,0,0,0,0,2,2,-4,4,0,-5,5,0,0,0,0,0,-12,-11,-2,0,2,0,0,-1,-1,0,-1,-1,6,-1
KR_6738713880,420,-1,7,-12,0,-1,2,1,-1,5,4,2,1,3,-1,2,1,1,0,1,0,6,4,2,-3,1,-2,0,0,1,1,0,1,4,-1
KR_6689296679,420,-2,-5,4,-3,-2,4,2,0,3,3,3,0,3,-4,4,0,0,0,0,1,-6,3,-3,-2,5,5,0,1,1,-1,1,1,6,-1
KR_6758121646,420,-2,42,-11,-7,-1,2,1,1,0,1,-1,1,0,-4,4,0,-2,2,0,0,-4,-7,-9,0,9,2,0,0,1,-1,0,-1,6,-1
KR_6654008596,420,0,-97,4,1,-1,4,3,2,1,3,-1,1,0,1,0,1,0,1,1,0,10,-36,0,-4,4,0,0,0,-1,-1,-1,1,3,-1
KR_6757034023,420,1,-57,-20,-3,-3,4,1,3,1,4,1,2,3,-3,4,1,-1,2,1,0,1,1,2,-4,2,1,0,-1,-1,1,1,-1,1,-1
KR_6762648841,420,-2,-38,4,-7,-3,8,5,3,1,4,0,2,2,-2,10,8,-5,6,1,-1,-12,-4,2,-4,2,-3,0,-2,1,1,-1,-1,5,-1
KR_6625159902,420,1,23,-16,1,0,1,1,0,1,1,-1,5,4,1,1,2,1,0,1,0,3,-3,3,-6,3,1,0,0,1,-1,0,1,2,-1
KR_6760512049,420,1,5,12,4,4,1,5,0,2,2,2,1,3,-1,3,2,-1,1,0,1,0,-10,0,-4,4,-4,0,0,1,-1,0,1,3,-1
KR_6726454618,420,-2,-2,-14,2,-2,2,0,2,2,4,-2,6,4,3,1,4,1,2,3,0,4,-8,-1,-2,3,0,0,-1,-1,0,-1,1,5,-1
KR_6764773394,420,-1,-26,-8,-2,3,2,5,-2,6,4,0,0,0,1,0,1,-4,4,0,0,-2,-8,0,-4,4,-4,0,-2,-1,1,-1,1,3,-1
KR_6728690184,420,0,-103,-4,-4,-1,2,1,3,2,5,-2,4,2,1,0,1,-5,5,0,0,-2,259,3,-6,3,-4,0,-1,0,-1,-1,-1,0,-1
KR_6492744334,420,-3,-23,-4,-12,0,1,1,0,1,1,-5,6,1,-4,4,0,-3,3,0,0,-18,-5,0,-3,3,1,0,-1,0,1,-1,-1,0,-1
KR_6755366992,420,-3,-52,-12,-9,-1,5,4,1,2,3,-1,3,2,-5,7,2,-3,5,2,-1,-9,-6,-6,-1,7,2,0,-1,1,0,-1,-1,1,-1
KR_6740944304,420,0,7,-5,1,-1,2,1,0,4,4,0,2,2,2,1,3,0,0,0,-1,6,7,-1,-1,2,1,0,0,-1,-1,0,-1,5,-1
KR_6731207063,420,1,11,6,-3,-4,6,2,-2,4,2,1,0,1,1,1,2,1,0,1,3,0,14,5,-6,1,-2,0,-1,-1,-1,-1,1,3,-1
KR_6661428405,420,-2,-27,-31,-5,-2,2,0,-4,7,3,1,3,4,0,2,2,0,1,1,0,-3,23,6,-7,1,-8,0,-1,-1,0,-1,1,6,-1
KR_6690150177,420,-1,-55,23,-13,-8,9,1,-2,3,1,1,2,3,-1,2,1,-3,6,3,-2,-17,34,2,-3,1,1,0,1,0,1,1,-1,0,-1
KR_6761207298,420,1,63,-28,1,1,1,2,4,0,4,-2,5,3,0,2,2,-2,2,0,0,10,-3,1,-3,2,-4,0,1,-1,-1,1,-1,5,-1
KR_6726728269,420,-1,-30,-1,-5,-4,6,2,-3,5,2,-1,7,6,4,1,5,-1,2,1,-1,0,-43,-3,-3,6,-2,0,0,0,-1,-1,-1,0,-1
KR_6557584495,440,-5,-102,-17,-10,0,3,3,-3,6,3,-1,4,3,-5,8,3,-1,3,2,-1,-7,-9,-2,-2,4,1,0,-1,-1,-1,-1,-1,4,-1
KR_6746274289,420,-5,-20,-4,-2,-4,4,0,-4,4,0,2,3,5,5,0,5,-1,1,0,0,3,-423,-1,-5,6,0,0,-1,-1,0,-1,-1,6,-1
KR_6746427914,420,-3,3,12,-6,-5,6,1,-4,4,0,-1,3,2,4,1,5,0,3,3,0,-6,8,2,-6,4,-3,0,-1,-1,1,-1,1,2,-1
KR_6762498189,420,-1,-5,-9,-8,-2,2,0,-1,1,0,2,1,3,-4,8,4,-3,4,1,0,-15,-26,4,-5,1,0,0,-2,0,-1,-1,-1,0,-1
KR_6655647863,420,-7,-110,-40,-19,-1,1,0,-5,6,1,-8,9,1,-7,9,2,2,1,3,0,-11,-2,-2,-3,5,-4,0,-1,-1,1,-1,-1,2,-1
KR_6752081063,420,-4,35,-40,-4,1,2,3,-3,5,2,-2,5,3,0,2,2,0,1,1,0,-8,305,-2,-1,3,-2,0,0,-1,-1,0,1,2,-1
KR_6702850429,420,-1,12,4,-6,-2,2,0,-2,4,2,-1,5,4,-1,7,6,0,2,2,0,-8,5,-3,0,3,1,0,-1,-1,-1,1,1,5,-1
KR_6706737399,420,-2,-71,-5,0,-1,1,0,-1,5,4,1,3,4,2,4,6,-1,2,1,0,3,-299,3,-6,3,-17,0,-1,-1,-1,-1,-1,3,-1
KR_6705655517,420,-2,14,-16,-11,1,1,2,-2,3,1,1,3,4,-7,9,2,-4,4,0,0,-18,-1,0,-4,4,2,0,-2,-1,1,-1,1,3,-1
KR_6762121715,420,7,130,66,14,4,4,8,4,1,5,4,0,4,5,4,9,-3,3,0,2,-4,-25,5,-7,2,-1,0,5,1,1,1,-1,4,-1
KR_6628930707,420,-3,-36,0,-7,2,1,3,-1,2,1,-5,5,0,-4,5,1,1,1,2,1,-4,-5,-2,-2,4,5,0,0,-1,1,-1,1,6,-1
KR_6749433930,420,-1,-70,1,-1,0,2,2,-2,4,2,4,1,5,-2,2,0,-1,1,0,0,0,-271,-1,-3,4,-4,0,0,-1,0,0,1,2,-1
KR_6757428417,420,-2,-51,-10,-8,3,0,3,1,3,4,-6,6,0,-3,4,1,-3,3,0,-1,-8,68,-2,-3,5,-3,0,-2,-1,1,-1,-1,1,-1
KR_6758172544,420,-4,-55,-12,-7,-4,4,0,0,2,2,-2,3,1,-3,4,1,2,0,2,-1,0,-1,-4,-2,6,-2,0,0,-1,-1,0,-1,1,-1
KR_6755730676,420,-5,-53,-3,-4,-2,4,2,-1,2,1,-3,4,1,0,4,4,2,0,2,1,-5,-1,0,-2,2,2,0,-1,1,1,-1,1,4,-1
KR_6748420787,420,-1,-62,-4,-6,0,2,2,1,1,2,3,1,4,-7,8,1,-3,5,2,1,-14,-1,4,-6,2,1,0,-2,1,-1,-1,1,1,-1
KR_6640350833,420,-3,21,-24,-5,0,2,2,2,1,3,-3,4,1,-2,5,3,-2,3,1,0,-8,11,-2,0,2,0,0,1,-1,-1,1,1,5,-1
KR_6762006321,420,-2,-48,10,-6,-5,7,2,2,1,3,-1,4,3,-3,4,1,1,1,2,0,0,-43,1,-4,3,13,0,-1,1,-1,-1,-1,6,-1
KR_6613470965,420,-3,45,-1,-7,3,2,5,-6,7,1,-2,2,0,-3,5,2,1,2,3,0,-8,-14,4,-7,3,-4,0,0,-1,-1,-1,1,6,-1
KR_6757903922,420,-3,-107,15,-8,-7,7,0,-2,6,4,-1,2,1,3,4,7,-1,3,2,0,-1,39,0,-2,2,-19,0,-1,-1,-1,-1,-1,3,-1
KR_5830150322,420,-5,-79,5,-7,-7,7,0,2,4,6,-6,7,1,1,1,2,3,1,4,0,-7,15,0,-4,4,-4,0,-2,1,0,-1,-1,3,-1
KR_6724444680,420,-2,-97,12,-9,-3,3,0,0,2,2,-2,3,1,-8,9,1,4,1,5,0,-6,-29,-2,-3,5,3,0,-1,-1,1,-1,-1,5,-1
KR_6760461697,420,-2,8,-28,-6,4,0,4,-4,4,0,-8,9,1,-2,4,2,4,1,5,1,7,4,-5,-3,8,0,0,-1,0,-1,-1,1,0,-1
KR_6648860820,420,-3,-111,6,-4,-3,3,0,0,2,2,1,2,3,1,1,2,-3,3,0,0,-6,11,-2,0,2,-3,0,0,1,1,-1,1,5,-1
KR_6682326824,420,-4,-33,-17,-6,-1,2,1,5,1,6,-11,11,0,-2,3,1,3,0,3,0,-2,15,0,-3,3,0,0,1,0,1,1,1,0,-1
KR_6760283824,420,-2,-85,-14,-10,0,2,2,0,1,1,-3,4,1,-10,12,2,3,0,3,0,-6,-12,-6,-2,8,3,0,0,1,1,-1,1,4,-1
KR_6750137474,420,0,20,8,0,-1,5,4,1,2,3,-2,7,5,2,1,3,0,0,0,1,5,31,3,-6,3,-20,0,1,1,1,1,-1,3,-1
KR_6756813671,420,-4,40,-8,-8,-1,2,1,-3,4,1,-2,4,2,-1,2,1,-1,1,0,-1,-11,-5,0,-3,3,-2,0,-1,-1,-1,-1,-1,1,-1
KR_6745937195,420,2,57,20,4,2,1,3,-6,6,0,3,2,5,4,1,5,1,0,1,0,2,5,-1,-3,4,0,0,2,-1,1,1,1,5,-1
KR_6692620422,420,-5,-18,-4,-8,0,1,1,-3,3,0,-4,4,0,1,2,3,-2,5,3,0,-4,242,-1,-3,4,-2,0,-1,-1,0,-1,-1,1,-1
KR_6718500327,420,-5,-63,-11,-6,0,0,0,-3,4,1,0,0,0,-2,2,0,-1,2,1,0,-10,40,4,-7,3,-25,0,0,1,1,0,-1,3,-1
KR_6648367879,420,-8,-75,-34,-15,-2,3,1,-4,4,0,-1,1,0,-7,7,0,-1,1,0,0,-11,3,-2,-4,6,-5,0,-3,-1,-1,-1,-1,5,-1
KR_6754533732,420,1,-32,16,6,-4,5,1,6,2,8,6,0,6,1,0,1,-3,4,1,0,8,8,4,-7,3,-5,0,0,-1,1,1,1,6,-1
KR_6763681038,420,2,71,-3,4,1,2,3,2,2,4,5,0,5,-3,4,1,-1,1,0,0,1,20,0,-4,4,4,0,1,-1,1,1,-1,6,-1
KR_6758347841,420,0,17,20,-2,-1,1,0,0,0,0,-4,9,5,2,2,4,1,1,2,0,-2,23,-3,-2,5,3,0,1,0,1,1,-1,0,-1
KR_6763570260,420,0,-20,-36,-6,4,0,4,1,2,3,2,1,3,-6,9,3,-7,7,0,0,-12,-7,-5,-3,8,2,0,0,-1,-1,-1,-1,6,-1
KR_6756340212,420,-4,-110,-52,-12,-2,2,0,-2,3,1,-7,7,0,-4,5,1,3,0,3,0,-4,-2,-3,-2,5,1,0,0,-1,-1,0,-1,4,-1
KR_6515894687,420,-1,-1,28,2,-2,3,1,-6,8,2,5,0,5,0,3,3,5,0,5,0,-1,-9,1,-4,3,0,0,0,1,-1,0,1,3,-1
KR_6759516780,420,-2,-20,-12,-7,-4,4,0,-3,4,1,-1,2,1,0,0,0,1,1,2,0,-15,14,1,-7,6,-2,0,0,-1,-1,0,-1,6,-1
KR_6737023829,420,2,27,-16,3,0,3,3,-1,2,1,2,2,4,0,2,2,2,2,4,0,-4,17,1,-6,5,-2,0,0,-1,-1,0,1,4,-1
KR_6612224518,420,-4,-85,-8,-6,1,1,2,0,3,3,-1,3,2,-6,7,1,0,2,2,0,-8,0,5,-8,3,-5,0,-1,-1,1,-1,-1,2,-1
KR_6758603086,420,-2,14,-10,-5,-4,5,1,-5,6,1,-4,6,2,1,2,3,7,0,7,-1,1,-6,-7,0,7,3,0,0,0,-1,1,-1,0,-1
KR_6763657518,420,-1,25,32,-6,-3,3,0,1,1,2,2,1,3,-5,6,1,-1,1,0,0,-5,0,-1,-3,4,0,0,0,1,1,0,-1,3,-1
KR_6740498709,420,-4,-54,-15,-14,-2,3,1,3,2,5,-4,4,0,-11,13,2,0,1,1,0,-6,-2,0,-4,4,1,0,0,-1,0,-1,1,2,-1
KR_6736035001,420,-2,-37,-11,-9,0,2,2,0,3,3,-4,8,4,-6,9,3,1,0,1,0,-1,-8,-3,-4,7,-3,0,-1,1,-1,-1,1,1,-1
KR_6764155747,420,-1,-22,-43,4,2,1,3,1,5,6,6,2,8,-3,5,2,-2,2,0,0,2,-278,2,-5,3,1,0,-1,-1,-1,1,1,4,-1
KR_6746050090,420,-1,9,7,-1,3,0,3,1,3,4,-1,2,1,-4,6,2,0,1,1,0,-9,22,6,-9,3,-3,0,0,1,1,0,1,4,-1
KR_6619657266,420,-2,25,11,-2,-1,2,1,-3,4,1,1,1,2,1,2,3,0,2,2,0,0,9,-1,-4,5,-4,0,0,1,1,0,1,2,-1
KR_6740058705,420,-4,-31,12,-2,-4,5,1,0,1,1,-1,1,0,3,2,5,0,2,2,-1,5,-2,1,-3,2,-4,0,-1,1,-1,-1,-1,6,-1
KR_6735881684,420,3,18,5,3,2,2,4,5,0,5,1,0,1,-6,8,2,1,0,1,-1,-2,-13,2,-4,2,0,0,0,0,0,0,-1,0,-1
KR_6745394954,420,-9,-73,-36,-20,-2,3,1,-4,5,1,-3,3,0,-1,4,3,-10,10,0,-1,-15,-46,1,-5,4,19,0,-3,0,-1,-1,-1,0,-1
KR_6731529935,420,-4,-119,-26,-3,0,2,2,-1,2,1,-2,4,2,0,2,2,0,1,1,0,7,-5,-3,-2,5,-1,0,-3,1,-1,-1,-1,1,-1
KR_6758183352,420,-2,-16,35,-8,-1,2,1,0,1,1,-1,3,2,-6,8,2,0,0,0,0,-8,0,4,-8,4,-5,0,0,0,0,0,-1,0,-1
KR_6747099146,420,0,-13,-29,-1,2,4,6,0,4,4,-2,3,1,-1,2,1,0,0,0,0,2,-4,-1,-5,6,0,0,0,-1,1,0,-1,2,-1
KR_6687150874,420,-3,-123,12,-4,-3,4,1,-1,2,1,1,3,4,-1,2,1,0,0,0,0,-6,-4,2,-4,2,-4,0,0,1,1,-1,1,6,-1
KR_6709100406,420,2,-17,8,4,6,1,7,-6,7,1,2,1,3,0,4,4,2,1,3,0,-7,0,1,-6,5,1,0,2,-1,1,1,-1,6,-1
KR_6758111891,420,-1,-37,-7,-4,3,1,4,-1,1,0,-3,5,2,-1,1,0,-2,2,0,0,-1,-7,0,-4,4,-1,0,0,-1,1,-1,-1,1,-1
KR_6697839228,420,-2,-27,20,-2,-3,4,1,2,3,5,-2,4,2,0,3,3,1,4,5,0,7,0,-2,-2,4,4,0,0,1,1,1,1,2,-1
KR_6762005389,420,0,82,10,1,3,2,5,1,2,3,-3,5,2,0,1,1,0,0,0,0,-5,10,3,-6,3,-1,0,1,1,-1,1,1,2,-1
KR_6750401700,420,-4,-41,-20,-9,0,0,0,-4,7,3,-4,4,0,-1,1,0,0,1,1,0,-8,-1,-2,-3,5,-2,0,0,0,-1,1,1,0,-1
KR_6759758733,440,4,58,20,0,0,2,2,-1,6,5,2,1,3,-2,5,3,1,1,2,0,1,23,3,-7,4,-2,0,0,-1,-1,-1,-1,1,-1
KR_6742068113,420,1,14,-21,3,3,1,4,-2,3,1,0,2,2,1,2,3,1,0,1,0,8,-7,0,-7,7,-4,0,0,-1,1,0,-1,4,-1
KR_6169747575,420,-2,-60,8,-10,-1,2,1,-3,4,1,-1,3,2,-2,3,1,-3,5,2,0,-9,13,2,-4,2,-5,0,-2,-1,0,-1,1,1,-1
KR_6599034238,420,-3,-78,8,-11,1,0,1,-4,4,0,-8,8,0,-1,9,8,1,1,2,-1,-1,25,-3,-4,7,2,0,-2,1,1,-1,-1,2,-1
KR_6732279743,440,-3,-69,-35,-6,-2,3,1,-2,2,0,-1,2,1,-1,2,1,0,0,0,0,-5,1,-1,-3,4,0,0,0,-1,0,0,-1,2,-1
KR_6752646673,420,-5,-109,-4,-15,2,0,2,-1,2,1,-3,3,0,-12,13,1,-1,1,0,0,-18,7,-2,-5,7,-4,0,-2,-1,-1,-1,-1,2,-1
KR_6746043555,420,-2,-34,16,-6,-3,3,0,-5,6,1,2,1,3,0,1,1,0,1,1,0,-9,131,-1,-3,4,-2,0,0,0,1,0,-1,0,-1
KR_6743130333,440,-5,-68,-72,-12,2,0,2,-2,3,1,-3,3,0,-3,3,0,-6,6,0,0,-8,-29,-1,-4,5,0,0,-1,-1,1,-1,-1,4,-1
KR_6722228189,440,0,12,-10,-3,-3,8,5,-2,2,0,7,2,9,-4,8,4,-1,2,1,-1,-3,31,1,-3,2,-17,0,-2,-1,-1,-1,-1,6,-1
KR_6753259607,420,-7,-102,-16,-10,2,1,3,-4,7,3,-7,7,0,-2,4,2,1,0,1,0,-9,-2,3,-5,2,-1,0,-1,-1,0,-1,-1,4,-1
KR_6699784634,420,-2,14,21,-3,-3,5,2,0,1,1,2,4,6,3,4,7,-5,5,0,0,-18,1,-2,-3,5,1,0,-1,1,-1,1,1,3,-1
KR_6750141169,420,-3,-80,-20,-6,-3,5,2,1,1,2,0,0,0,-3,4,1,-1,4,3,0,1,-23,4,-7,3,21,0,-1,1,-1,-1,1,3,-1
KR_6645635014,420,-5,-90,-7,-15,3,1,4,-2,4,2,-9,9,0,-5,7,2,-2,2,0,0,-8,-9,-2,-3,5,3,0,0,-1,-1,-1,-1,1,-1
KR_6726677123,420,0,-4,-24,6,-3,3,0,3,2,5,1,0,1,6,0,6,-1,1,0,0,11,-35,9,-9,0,8,0,-2,1,-1,-1,-1,4,-1
KR_6764538401,420,0,-6,-12,9,3,2,5,6,0,6,-1,7,6,0,5,5,1,0,1,0,15,-34,4,-5,1,19,0,0,-1,1,0,1,3,-1
KR_6755155461,420,3,61,24,-2,1,1,2,3,1,4,-8,10,2,2,1,3,0,0,0,0,-5,101,-1,0,1,0,0,2,-1,1,1,-1,3,-1
KR_6744732353,420,-9,-111,-88,-19,-2,3,1,-10,11,1,-6,8,2,-2,4,2,1,0,1,0,-9,-1,-2,-3,5,1,0,0,-1,-1,-1,-1,2,-1
KR_6754193768,420,-3,-98,8,-2,-3,3,0,-1,2,1,-4,5,1,5,2,7,1,0,1,0,2,-6,-2,-2,4,-1,0,-1,1,0,-1,1,6,-1
KR_6760871810,420,-3,-56,-29,-7,-3,5,2,1,2,3,3,1,4,-6,6,0,-2,3,1,0,-5,-7,3,-4,1,-6,0,-2,-1,-1,-1,1,6,-1
KR_6695577793,420,3,35,-12,-2,0,2,2,-1,4,3,4,2,6,-2,2,0,-3,3,0,0,-4,-4,0,-2,2,0,0,-1,-1,0,-1,-1,2,-1
KR_6729435797,420,-1,54,-28,-2,-3,4,1,-5,5,0,1,2,3,2,1,3,3,0,3,0,5,-8,-3,-3,6,1,0,-1,-1,-1,-1,1,4,-1
KR_6750635760,420,-4,-43,7,-9,-4,6,2,1,5,6,-2,3,1,-1,3,2,-3,4,1,-3,-9,-5,-4,-3,7,0,0,-2,1,-1,-1,-1,6,-1
KR_6711291492,440,0,33,1,-5,1,1,2,-1,6,5,-6,6,0,1,3,4,0,0,0,-1,-13,2,0,-4,4,-2,0,-1,-1,-1,-1,-1,2,-1
KR_6757872954,420,1,10,0,3,-3,3,0,-1,1,0,3,0,3,3,0,3,1,0,1,0,3,3,0,-3,3,-1,0,0,1,-1,0,-1,3,-1
KR_6624002457,420,-5,-166,-44,-14,-1,2,1,-2,2,0,-5,5,0,-3,4,1,-3,4,1,-2,-11,-3,-1,0,1,13,0,-4,-1,-1,-1,-1,1,-1
KR_6672632236,420,-3,37,-26,0,1,1,2,-2,4,2,-1,3,2,3,1,4,-1,3,2,0,-2,38,1,-3,2,-1,0,0,1,1,0,1,5,-1
KR_6754228568,420,-2,-54,14,-5,-1,1,0,-1,2,1,2,1,3,-5,5,0,0,0,0,0,-10,-8,0,-6,6,1,0,-2,-1,0,-1,-1,3,-1
KR_6501465579,420,-3,-103,-7,-9,-7,8,1,0,0,0,-1,1,0,1,2,3,-2,4,2,0,-4,10,5,-9,4,0,0,-3,1,-1,-1,-1,3,-1
KR_6648047538,420,-2,-84,1,-4,-1,2,1,3,4,7,0,3,3,-5,6,1,-1,3,2,0,-3,-1,-1,-4,5,1,0,0,1,1,-1,1,1,-1
KR_6670359143,420,-4,-53,-27,-8,-2,2,0,-4,4,0,-4,5,1,1,1,2,1,2,3,0,-5,-7,-4,-3,7,1,0,-1,-1,-1,-1,1,2,-1
KR_6728500296,420,0,61,17,2,1,0,1,-4,4,0,1,5,6,6,2,8,-2,3,1,1,1,6,0,-3,3,0,0,0,1,-1,0,1,6,-1
KR_6738087242,420,3,103,-28,11,4,1,5,4,0,4,6,0,6,-5,9,4,2,0,2,0,6,-5,-3,-4,7,-2,0,0,0,1,1,-1,0,-1
KR_6678880402,420,2,-31,16,2,0,2,2,-1,2,1,4,1,5,2,0,2,-3,3,0,0,-2,-152,-1,-3,4,17,0,0,-1,1,-1,-1,3,-1
KR_6672719407,420,2,-2,-11,-1,-1,2,1,1,0,1,-1,1,0,0,2,2,0,1,1,0,0,-1,2,-9,7,2,0,0,1,1,1,-1,5,-1
KR_6747760812,440,-3,-15,-40,-10,3,2,5,-5,5,0,-3,5,2,-3,6,3,-2,3,1,-1,-11,2,-4,-2,6,2,0,0,-1,1,1,-1,3,-1
KR_6585601414,420,-2,-23,20,2,-3,4,1,3,2,5,-1,3,2,0,3,3,3,1,4,0,7,4,-1,-3,4,1,0,-1,-1,1,-1,-1,5,-1
KR_6762561634,420,-2,-56,-16,-5,4,0,4,-5,6,1,0,4,4,-1,1,0,-3,3,0,-1,-6,-184,0,-5,5,-1,0,0,-1,-1,0,-1,2,-1
KR_6764642732,420,-4,55,-32,-13,1,1,2,-5,6,1,-1,2,1,-6,8,2,-2,2,0,0,-10,5,-2,-2,4,-2,0,1,-1,1,1,-1,3,-1
KR_6712027392,420,-6,17,-31,-12,-3,3,0,0,1,1,-4,6,2,-2,3,1,-3,3,0,0,-6,4,1,-6,5,1,0,1,-1,1,1,1,6,-1
KR_6753096849,420,2,31,8,-2,3,0,3,-8,9,1,-1,1,0,3,4,7,1,2,3,0,-5,-25,-2,-4,6,9,0,0,-1,-1,0,1,6,-1
KR_6727577435,420,0,67,-40,0,1,1,2,-1,3,2,-1,3,2,0,2,2,1,1,2,0,1,-4,-1,-5,6,3,0,1,-1,0,1,-1,5,-1
KR_6761908564,420,-8,-33,-40,-1,-2,2,0,1,3,4,3,1,4,-3,4,1,0,2,2,1,-7,-1,6,-7,1,0,0,0,-1,1,-1,1,4,-1
KR_6737137599,420,-2,5,5,-7,-4,4,0,-2,5,3,-1,3,2,0,0,0,0,1,1,0,-6,-5,1,-4,3,0,0,-1,1,-1,-1,-1,5,-1
KR_6718440325,420,-5,-120,-24,-10,-3,4,1,-7,8,1,-3,3,0,2,1,3,1,0,1,0,-13,5,-3,-4,7,-1,0,-1,-1,-1,-1,1,2,-1
KR_6754215411,420,0,-40,6,0,-2,2,0,0,2,2,0,5,5,2,1,3,0,2,2,0,5,2,-1,-2,3,-1,0,-1,-1,1,-1,1,1,-1
KR_6732483597,420,1,-1,3,5,2,0,2,-2,5,3,2,0,2,4,0,4,-1,1,0,0,1,4,0,-6,6,2,0,1,1,-1,1,1,1,-1
KR_6739932903,420,-6,-81,-39,-7,-4,4,0,-2,3,1,-2,2,0,-1,2,1,2,0,2,0,-2,-106,-2,-5,7,-2,0,-1,-1,1,-1,1,4,-1
KR_6619595481,420,-6,-114,-20,-15,-3,3,0,-1,2,1,-8,10,2,-3,5,2,0,1,1,0,-15,7,-2,-1,3,-2,0,-2,-1,1,-1,-1,1,-1
KR_6220710317,420,-1,-44,0,3,-2,3,1,8,1,9,-4,5,1,1,3,4,0,2,2,1,19,3,2,-6,4,4,0,0,1,0,0,1,4,-1
KR_6763373182,420,-6,-109,8,-7,-3,3,0,1,4,5,-3,4,1,-1,3,2,-1,2,1,0,-5,-14,0,-6,6,0,0,0,1,-1,-1,-1,1,-1
KR_6567886353,420,1,-15,16,-2,-1,3,2,2,1,3,4,2,6,-6,7,1,-1,1,0,0,1,-6,-3,-4,7,-2,0,0,0,0,1,-1,0,-1
KR_6757967948,420,-1,-16,7,0,-5,6,1,2,2,4,-1,3,2,3,2,5,1,1,2,-1,2,-278,-4,-3,7,3,0,0,-1,1,0,-1,1,-1
KR_6762720979,420,0,-42,-3,-1,2,0,2,-1,1,0,-2,3,1,-1,1,0,1,0,1,1,5,-18,2,-4,2,-1,0,0,0,0,0,1,0,-1
KR_6692892475,420,-4,-132,41,-8,2,1,3,0,4,4,-5,7,2,-4,5,1,-1,1,0,0,-9,-220,0,-5,5,1,0,-2,-1,1,-1,-1,3,-1
KR_6675216804,420,-6,-17,-41,-5,-10,10,0,2,1,3,2,0,2,1,2,3,0,1,1,1,5,-3,4,-5,1,0,0,-1,-1,-1,-1,1,1,-1
KR_6725657498,420,-5,-57,-48,-7,3,1,4,1,2,3,-4,5,1,-7,9,2,0,0,0,0,-8,-7,-2,-5,7,1,0,-2,1,-1,-1,-1,2,-1
KR_6696411779,420,-3,-72,-44,-5,0,1,1,1,0,1,1,1,2,-5,6,1,-2,3,1,0,-7,-7,1,-3,2,-2,0,-1,-1,-1,-1,1,1,-1
KR_6622007740,420,-1,9,-3,-5,1,4,5,-1,4,3,-2,2,0,-1,2,1,-2,2,0,0,-4,1,-1,-3,4,0,0,-1,1,1,-1,1,2,-1
KR_6635251383,420,0,-46,0,0,0,1,1,-1,4,3,-1,5,4,1,1,2,1,1,2,0,5,14,-2,-2,4,-2,0,-1,1,-1,-1,-1,1,-1
KR_6637257512,440,-3,-85,-39,-7,-2,4,2,-1,1,0,-3,5,2,-3,4,1,2,1,3,-1,1,-24,0,-1,1,0,0,-2,-1,-1,-1,-1,5,-1
KR_6673016034,420,-4,-36,-3,-1,-1,2,1,-2,3,1,3,2,5,1,0,1,-2,2,0,0,-3,-5,-3,-1,4,-4,0,-1,0,-1,-1,1,0,-1
KR_6725001692,420,-5,-16,-11,-8,-3,4,1,-3,4,1,0,2,2,-3,7,4,1,0,1,0,-7,-6,-1,-3,4,0,0,-1,-1,0,-1,-1,2,-1
KR_6708343499,420,3,6,68,4,-4,5,1,4,2,6,-2,2,0,6,3,9,0,2,2,-1,1,-2,2,-5,3,1,0,0,1,-1,0,-1,5,-1
KR_6744547077,420,2,18,9,-3,1,1,2,-3,3,0,0,0,0,0,3,3,-1,1,0,0,-5,19,2,-5,3,0,0,0,-1,1,0,-1,4,-1
KR_5826462748,420,-5,-121,-22,-9,0,2,2,-7,10,3,-2,3,1,0,2,2,0,1,1,-1,-8,23,-2,-5,7,3,0,-1,-1,1,-1,-1,5,-1
KR_6762489694,420,0,19,-24,1,2,0,2,-2,4,2,-2,4,2,3,3,6,0,0,0,0,1,5,1,-4,3,0,0,0,-1,0,0,1,6,-1
KR_6743721430,420,-6,-76,-36,-14,-8,8,0,-5,5,0,-3,3,0,0,2,2,2,0,2,0,-6,-19,3,-4,1,-2,0,-1,-1,-1,-1,-1,2,-1
KR_6759164592,420,-2,-62,8,-3,-1,3,2,-1,4,3,5,0,5,-4,6,2,-2,3,1,-1,-6,0,0,-3,3,-1,0,-2,0,1,-1,1,0,-1
KR_6752660040,420,0,-28,10,-6,0,1,1,-4,6,2,-2,5,3,1,1,2,-1,3,2,0,-6,-5,1,-6,5,0,0,-2,1,1,-1,1,2,-1
KR_6665241120,440,2,-20,-10,7,3,0,3,4,4,8,5,1,6,-4,5,1,-1,2,1,1,4,-16,1,-4,3,-1,0,0,1,1,1,-1,6,-1
KR_6762540959,420,-4,-42,-3,-2,-2,3,1,-3,3,0,-2,4,2,6,3,9,-1,2,1,0,-7,-8,-3,-2,5,-2,0,-2,0,0,-1,-1,0,-1
KR_6648161874,420,-5,-63,-53,-5,-2,3,1,-1,2,1,-1,4,3,-4,5,1,3,0,3,0,2,-125,-3,-2,5,1,0,-2,-1,-1,-1,-1,5,-1
KR_6673792094,420,3,35,22,10,-5,5,0,4,2,6,0,0,0,11,1,12,0,1,1,0,5,-1,6,-6,0,2,0,1,-1,-1,1,1,2,-1
KR_6729420036,420,-5,-42,-32,-5,-1,4,3,4,0,4,-5,7,2,-3,4,1,0,0,0,0,2,6,1,-3,2,-5,0,1,0,1,1,1,0,-1
KR_5830080700,420,1,-9,3,-4,3,1,4,-3,7,4,1,0,1,-3,5,2,-2,3,1,0,-2,13,2,-8,6,1,0,-1,-1,-1,-1,-1,4,-1
KR_6734788986,420,-3,-81,-26,-2,-2,4,2,2,1,3,-4,5,1,1,2,3,1,1,2,0,3,2,6,-8,2,-3,0,0,-1,1,1,-1,4,-1
KR_6736673784,420,-11,-92,-55,-19,0,0,0,-7,8,1,-3,3,0,-10,11,1,1,1,2,0,-22,-35,-3,-1,4,-2,0,-5,-1,-1,-1,-1,6,-1
KR_6742939376,420,-5,0,-24,-17,-7,8,1,-6,8,2,1,1,2,-2,3,1,-3,3,0,0,-6,2,1,-4,3,-3,0,-3,-1,-1,-1,-1,3,-1
KR_6725795223,420,-2,-55,-32,2,1,4,5,1,1,2,-2,5,3,2,7,9,0,1,1,2,11,2,3,-7,4,-4,0,0,-1,1,-1,-1,6,-1
KR_6748198883,420,-1,2,0,-1,0,3,3,-3,6,3,3,0,3,0,2,2,-1,2,1,0,-5,-223,-1,0,1,1,0,0,-1,1,0,-1,5,-1
KR_6643536253,420,-2,-6,-18,-3,-1,1,0,0,4,4,2,2,4,-4,5,1,0,3,3,-1,1,-2,3,-3,0,-2,0,-1,1,0,-1,-1,3,-1
KR_6727654805,420,-4,-99,-21,-7,-2,4,2,-4,7,3,0,1,1,-2,3,1,1,0,1,0,-1,-4,0,-5,5,2,0,0,-1,-1,0,-1,6,-1
KR_6743830207,420,0,0,8,-2,-3,3,0,2,1,3,-2,6,4,1,2,3,0,1,1,-1,-10,-4,-5,-2,7,1,0,0,-1,1,-1,-1,3,-1
KR_6558087436,440,-7,-85,-49,-13,-3,6,3,-5,5,0,-10,10,0,4,0,4,1,1,2,0,-4,-1,3,-4,1,1,0,-2,-1,-1,-1,-1,2,-1
KR_6733323679,420,-1,18,1,-12,-1,1,0,-5,7,2,-8,11,3,2,0,2,0,1,1,0,0,-29,-2,-3,5,28,0,-2,-1,-1,-1,-1,4,-1
KR_6706244721,420,-2,-91,20,-7,1,2,3,1,2,3,-1,3,2,-3,5,2,-5,6,1,0,-6,3,-3,-3,6,-5,0,-1,1,-1,-1,-1,1,-1
KR_6749640315,420,-1,-46,-44,-1,-3,3,0,-1,4,3,1,2,3,2,2,4,0,1,1,0,4,14,-1,-2,3,1,0,1,-1,1,1,-1,6,-1
KR_6748179519,420,-5,-73,-38,-8,-7,8,1,3,0,3,-1,3,2,-1,2,1,-2,2,0,-2,-7,50,-4,-2,6,-7,0,-2,-1,-1,-1,-1,6,-1
KR_6751756617,420,-2,-56,-31,-10,1,4,5,-10,12,2,1,1,2,-1,2,1,-1,1,0,1,0,-37,3,-9,6,23,0,-2,0,-1,-1,-1,0,-1
KR_6498343777,420,-2,0,0,-11,-7,7,0,2,3,5,-2,4,2,-1,3,2,-3,3,0,0,-4,4,-1,-3,4,-1,0,-1,-1,0,-1,-1,4,-1
KR_6736469041,420,2,29,10,1,1,1,2,2,2,4,-1,3,2,1,5,6,-2,3,1,-1,7,-8,-1,-7,8,2,0,0,0,0,0,-1,0,-1
KR_6757675667,420,0,-15,8,-3,-1,5,4,-3,3,0,3,0,3,-3,4,1,1,0,1,0,-6,5,-1,-3,4,4,0,-1,-1,1,-1,-1,6,-1
KR_6625620356,420,-3,-61,-23,-5,0,1,1,3,0,3,-4,4,0,-3,4,1,-1,1,0,0,-5,19,2,-5,3,-7,0,-1,-1,1,-1,-1,1,-1
KR_6666150092,420,-1,30,4,-5,-2,5,3,-3,4,1,-2,3,1,3,1,4,-1,1,0,0,-3,-235,0,-4,4,1,0,0,-1,1,0,-1,5,-1
KR_6621719170,420,-1,-1,21,-7,-1,2,1,1,1,2,-4,6,2,-4,4,0,1,1,2,0,-6,4,-3,-5,8,4,0,0,1,1,0,-1,5,-1
KR_6697635198,420,-4,-131,-1,-13,3,1,4,2,0,2,-9,9,0,-6,9,3,-3,4,1,-1,-7,-27,-3,-3,6,0,0,-3,1,-1,-1,-1,2,-1
KR_6663883096,420,-2,-44,15,-1,1,3,4,2,0,2,0,2,2,-4,4,0,0,1,1,-1,-5,12,-2,-6,8,2,0,0,-1,1,-1,-1,3,-1
KR_6666027438,420,3,41,29,4,3,0,3,5,0,5,-2,4,2,-4,4,0,2,1,3,0,-1,-30,-3,-3,6,18,0,1,0,1,1,1,0,-1
KR_6758996764,420,-2,-117,24,-1,-3,4,1,0,4,4,-2,5,3,0,4,4,4,0,4,0,6,3,1,-5,4,-2,0,-1,-1,1,-1,-1,3,-1
KR_6763612892,420,-2,10,-4,-3,2,0,2,-3,5,2,2,0,2,-5,6,1,1,0,1,1,-13,-14,-4,-1,5,0,0,-1,0,0,-1,1,0,-1
KR_6761804307,420,0,-5,-8,-3,6,0,6,-1,4,3,-4,6,2,-4,5,1,0,2,2,0,-1,-14,-5,-1,6,-2,0,0,-1,1,0,1,1,-1
KR_6516038619,420,-3,-62,-31,-11,2,0,2,-3,4,1,3,2,5,-9,10,1,-4,4,0,0,-16,-3,2,-6,4,-1,0,-2,-1,-1,-1,-1,5,-1
KR_6726504397,440,6,55,67,15,3,2,5,1,3,4,2,2,4,2,7,9,7,0,7,4,6,-5,2,-5,3,4,0,2,1,1,1,1,3,-1
KR_6762723894,420,-2,-24,-32,-1,-2,5,3,4,0,4,-3,4,1,-1,5,4,1,0,1,0,0,-3,3,-6,3,0,0,0,1,-1,0,-1,2,-1
KR_6762661454,420,-3,-105,1,-5,-5,5,0,0,0,0,2,2,4,0,3,3,-2,3,1,0,2,-2,-1,-3,4,2,0,-1,1,0,-1,-1,2,-1
KR_6739595233,420,3,49,32,8,4,2,6,1,3,4,3,0,3,-3,7,4,3,1,4,-1,4,-3,-3,-2,5,0,0,3,1,1,1,-1,2,-1
KR_6745920595,420,-5,-117,19,-17,-2,4,2,-3,5,2,-9,11,2,-4,6,2,1,2,3,-2,-13,33,2,-3,1,-18,0,0,-1,1,0,-1,6,-1
KR_6546678395,440,-4,-75,-8,-11,-3,3,0,1,3,4,2,1,3,-5,6,1,-6,6,0,0,-15,-20,-4,-2,6,2,0,-3,-1,-1,-1,-1,4,-1
KR_6752283313,420,-3,-79,-11,2,1,1,2,0,3,3,2,4,6,0,1,1,-1,1,0,0,-2,-4,-2,-4,6,2,0,-1,0,0,-1,-1,0,-1
KR_6665261086,420,-1,-15,-20,-2,0,2,2,-2,2,0,-1,3,2,1,0,1,0,2,2,0,-5,2,0,-3,3,0,0,0,-1,-1,0,1,6,-1
KR_6756967841,420,2,16,0,4,-1,3,2,-1,3,2,1,2,3,-2,4,2,7,0,7,0,4,-1,-1,-4,5,0,0,-1,-1,0,-1,1,6,-1
KR_6717766455,420,1,66,8,4,0,2,2,2,1,3,1,1,2,0,5,5,1,1,2,0,4,-8,-1,-1,2,0,0,2,1,0,1,1,4,-1
KR_6753564119,420,-4,34,-24,-12,1,2,3,-2,2,0,-2,2,0,-9,9,0,0,1,1,0,-16,-355,5,-7,2,2,0,-1,-1,1,-1,-1,4,-1
KR_6745581704,420,0,-11,-20,-4,-3,3,0,0,3,3,2,3,5,-3,5,2,0,0,0,0,0,-24,-1,-1,2,-2,0,0,-1,-1,0,-1,4,-1
KR_6655758816,440,-7,-127,4,-17,-2,3,1,-3,4,1,-2,2,0,-7,9,2,-3,4,1,-1,-25,-6,-2,-3,5,2,0,-5,1,0,-1,-1,3,-1
KR_6761131730,420,-2,-14,0,-3,3,0,3,-3,5,2,-1,2,1,-2,3,1,0,2,2,0,-3,4,-2,-3,5,-4,0,0,1,0,0,-1,1,-1
KR_6684477953,420,-1,-45,16,0,0,4,4,4,1,5,-5,5,0,2,2,4,-1,1,0,0,4,-2,3,-9,6,1,0,-1,1,-1,-1,1,2,-1
KR_6728211361,420,-2,-95,-11,-10,-3,3,0,-4,5,1,-1,6,5,-1,5,4,-1,3,2,-1,-5,0,0,-4,4,1,0,-2,1,1,-1,-1,3,-1
KR_6763587812,440,-4,-83,0,-14,-6,6,0,4,2,6,-6,8,2,-3,4,1,-3,4,1,1,-13,6,1,-5,4,0,0,-1,-1,-1,-1,1,3,-1
KR_6757825327,420,-3,-51,-38,-2,-3,4,1,0,4,4,0,4,4,1,3,4,0,0,0,0,6,-9,-2,-1,3,1,0,-1,-1,-1,-1,-1,5,-1
KR_6761147572,420,2,39,21,9,5,1,6,3,3,6,-2,6,4,7,1,8,-4,4,0,0,4,0,3,-6,3,1,0,1,1,-1,1,1,3,-1
KR_6745601650,420,1,-44,-25,5,1,1,2,2,0,2,2,2,4,1,3,4,-1,1,0,0,3,-4,-2,-5,7,1,0,1,-1,1,-1,-1,5,-1
KR_6730105227,420,-2,-20,-12,-2,4,1,5,-2,5,3,-6,9,3,3,2,5,-1,1,0,-1,-4,1,-1,-6,7,0,0,0,1,-1,0,-1,5,-1
KR_6759151878,420,-1,-32,-31,-5,-4,4,0,-1,5,4,1,2,3,-2,3,1,1,0,1,-1,0,7,2,-5,3,-2,0,0,-1,0,-1,-1,1,-1
KR_6754357845,420,-3,16,-8,-8,-1,4,3,-1,6,5,0,4,4,-6,6,0,0,0,0,-2,-16,8,-1,-6,7,2,0,0,0,0,-1,1,0,-1
KR_6681781860,420,1,-7,-16,3,-5,8,3,5,0,5,6,0,6,-1,1,0,-2,2,0,0,-1,-20,1,-4,3,0,0,-1,-1,-1,-1,-1,2,-1
KR_6749554235,420,0,-8,16,-5,0,1,1,0,4,4,-4,4,0,0,5,5,-1,1,0,0,-2,0,-4,-2,6,1,0,0,-1,1,0,1,4,-1
KR_6715888163,420,-1,-12,-12,2,2,2,4,4,3,7,0,2,2,-3,6,3,-1,1,0,2,0,9,2,-3,1,-2,0,0,-1,0,0,1,4,-1
KR_6715519468,420,-7,-69,-32,-15,-3,3,0,-7,8,1,-3,4,1,-1,1,0,-1,1,0,0,-13,-8,-1,-5,6,2,0,0,-1,0,-1,-1,2,-1
KR_6743242221,420,2,58,28,1,-1,1,0,0,5,5,2,2,4,-3,4,1,3,0,3,0,-2,-3,-4,-3,7,6,0,1,-1,-1,1,1,5,-1
KR_6758609301,420,-5,-53,-9,-13,-5,7,2,-1,3,2,-1,4,3,-6,7,1,0,0,0,1,-10,-4,-6,-1,7,-1,0,-2,1,-1,-1,1,2,-1
KR_6750696158,440,2,76,-11,-1,4,0,4,-5,7,2,-3,4,1,3,2,5,0,1,1,0,0,0,0,-3,3,0,0,0,-1,1,1,1,5,-1
KR_6715519625,420,-1,-38,4,2,-4,4,0,-1,1,0,2,1,3,2,0,2,3,0,3,0,5,8,4,-6,2,-5,0,1,1,1,1,1,5,-1
KR_6753150160,420,-3,-17,-10,-10,-4,5,1,-7,9,2,1,1,2,-3,5,2,3,0,3,0,-2,46,2,-5,3,-20,0,0,0,-1,-1,-1,0,-1
KR_6753895772,420,2,38,-16,-1,-1,4,3,-1,3,2,1,0,1,-1,2,1,1,1,2,0,-3,-8,1,-4,3,0,0,0,-1,1,0,-1,2,-1
KR_6733368026,420,-4,-53,-24,-12,-2,3,1,-6,9,3,0,3,3,-2,3,1,-2,2,0,0,-3,21,-1,-2,3,-29,0,0,1,-1,0,1,1,-1
KR_6658989629,420,0,-15,12,-3,-1,3,2,0,2,2,-2,3,1,2,2,4,-2,2,0,0,-6,2,-1,-2,3,-1,0,-1,-1,1,1,-1,6,-1
KR_6677244094,420,0,20,-32,0,0,0,0,-1,2,1,1,2,3,0,5,5,0,0,0,0,-1,-8,0,-3,3,6,0,0,-1,-1,0,-1,2,-1
KR_6694882715,420,-5,-114,-24,-9,-4,5,1,-3,6,3,-3,3,0,2,1,3,-1,2,1,0,-1,-3,-4,-1,5,-1,0,-1,-1,-1,-1,1,3,-1
KR_6702153764,420,-1,46,24,0,-1,5,4,0,1,1,-1,1,0,1,5,6,1,0,1,0,-3,-7,-1,-3,4,1,0,-1,1,-1,-1,-1,4,-1
KR_6737375655,420,-4,-59,-37,-9,-2,3,1,-1,3,2,-2,4,2,-3,4,1,-1,1,0,1,-9,9,0,-4,4,-2,0,0,-1,1,0,1,1,-1
KR_6682606102,420,0,34,13,-3,-1,3,2,2,3,5,-1,3,2,0,2,2,-3,3,0,0,-2,20,-1,-1,2,0,0,0,-1,1,1,-1,3,-1
KR_6663067626,420,1,35,-52,-4,1,4,5,1,3,4,-6,7,1,-2,3,1,2,0,2,-1,-2,-323,-3,0,3,0,0,0,-1,-1,1,-1,5,-1
KR_6722356955,420,2,1,6,2,0,2,2,2,2,4,2,5,7,-2,3,1,0,4,4,0,3,2,0,-4,4,0,0,0,1,-1,0,-1,6,-1
KR_6750596026,440,-1,-37,11,-7,-3,4,1,0,1,1,1,3,4,-6,7,1,1,0,1,0,-2,19,-2,-5,7,1,0,-2,-1,-1,-1,-1,1,-1
KR_6690594366,420,1,38,16,-4,-2,2,0,4,1,5,-3,6,3,-3,3,0,0,1,1,0,-5,-1,0,-1,1,0,0,0,-1,-1,0,-1,2,-1
KR_6726091836,420,1,16,-11,5,-5,6,1,10,1,11,4,0,4,-1,3,2,-3,3,0,0,9,9,2,-5,3,-4,0,-1,-1,-1,-1,1,6,-1
KR_6664191016,420,2,-11,12,-1,4,0,4,0,2,2,-2,3,1,-3,7,4,0,1,1,0,-7,9,1,-4,3,0,0,1,1,1,1,1,4,-1
KR_6658267584,420,-3,-72,-12,-6,2,3,5,-2,5,3,-1,5,4,-3,6,3,-2,4,2,-1,-2,-3,1,-4,3,-4,0,1,-1,0,1,-1,3,-1
KR_6763442304,420,-3,-23,-8,-6,5,0,5,-5,6,1,-8,8,0,1,4,5,1,1,2,0,-15,-13,-8,-4,12,2,0,-1,1,-1,-1,1,2,-1
KR_6699804014,420,1,-93,56,-7,-3,3,0,-3,6,3,-4,4,0,2,1,3,1,1,2,0,-5,-11,0,-3,3,3,0,-1,-1,1,-1,1,6,-1
KR_6741654480,420,-1,8,-37,1,-2,2,0,3,3,6,-5,6,1,1,1,2,4,2,6,0,3,-8,-2,-6,8,6,0,-1,-1,-1,-1,-1,5,-1
KR_6739108128,420,-2,-3,-28,-1,0,1,1,3,0,3,2,2,4,-2,3,1,-4,5,1,0,1,-6,2,-6,4,3,0,-2,-1,-1,-1,-1,5,-1
KR_6758343710,420,2,26,-3,3,-2,3,1,2,1,3,-3,4,1,6,0,6,0,0,0,0,10,10,-4,-2,6,-2,0,1,-1,1,1,-1,3,-1
KR_6676888149,420,2,23,12,4,-1,1,0,2,5,7,-6,7,1,6,1,7,3,1,4,0,17,-5,2,-4,2,-1,0,1,1,1,1,1,3,-1
KR_6757919949,420,0,13,31,-7,1,2,3,-1,2,1,-4,7,3,0,1,1,-3,4,1,0,-8,-8,1,-5,4,-3,0,2,-1,1,1,-1,4,-1
KR_6695788377,420,2,21,16,3,0,3,3,-4,6,2,1,1,2,3,0,3,3,0,3,0,9,-7,-2,-8,10,5,0,0,1,1,1,1,1,-1
KR_6762201672,420,-6,-120,-20,-8,-4,5,1,-5,5,0,-1,2,1,0,4,4,2,0,2,-1,6,53,4,-5,1,-17,0,-2,-1,0,-1,-1,1,-1
