matchId,queueId,Diff_LV,Diff_CS,Diff_jglCS,Diff-K,Diff-K-top,K-WIN-top,K-LOSE-top,Diff-K-jug,K-WIN-jug,K-LOSE-jug,Diff-K-mid,K-WIN-mid,K-LOSE-mid,Diff-K-ad,K-WIN-ad,K-LOSE-ad,Diff-K-sup,K-WIN-sup,K-LOSE-sup,invadeKill,Diff-A,Diff_WARDplaced,Diff-ControlWARDplaced,LOSE_controlWARDPlaced,WIN_controlWARDPlaced,Diff_WARDkill,Diff_Inhibitor,Diff_TOWERkill,Diff_FirstDRAGON,Diff_FirstHERALD,Diff_Firsttower,Diff_FirstBLOOD,dragonType,result
KR_6670850377,420,-1,22,-5,-1,1,0,1,1,1,2,-2,2,0,0,0,0,-1,1,0,0,-1,0,-1,-4,5,-2,0,0,1,-1,0,1,4,-1
KR_6762744310,420,3,12,22,0,2,0,2,7,1,8,-2,5,3,-3,4,1,-4,6,2,0,1,3,3,-3,0,-3,0,-1,1,-1,-1,-1,1,-1
KR_6645614199,420,-5,19,-25,-12,-1,1,0,-3,5,2,0,0,0,-7,7,0,-1,3,2,0,-12,-5,-1,-3,4,0,0,0,-1,1,0,-1,1,-1
KR_6761670750,420,-5,-23,-30,-14,-3,3,0,-4,6,2,-3,6,3,-3,4,1,-1,1,0,-1,-11,1,-1,-3,4,-5,0,0,-1,-1,-1,-1,4,-1
KR_6761645748,440,0,-29,-4,3,-3,4,1,3,0,3,1,0,1,0,2,2,2,1,3,0,5,3,2,-5,3,1,0,-1,1,0,-1,1,2,-1
KR_6752102790,420,-2,63,-12,-5,1,1,2,-2,4,2,-2,2,0,-3,8,5,1,0,1,0,-5,-10,-3,-4,7,-3,0,-1,1,-1,-1,1,1,-1
KR_6754308147,420,-4,-8,0,-4,-2,4,2,-4,6,2,1,0,1,2,2,4,-1,1,0,0,-3,-181,-3,-2,5,-1,0,-1,-1,-1,-1,-1,3,-1
KR_6360122688,420,-4,-62,-12,-7,-1,4,3,1,0,1,-6,8,2,0,1,1,-1,2,1,0,-1,0,0,0,0,-5,0,-1,1,1,-1,-1,6,-1
KR_6634667378,420,-3,5,-15,0,1,1,2,1,3,4,1,0,1,-5,7,2,2,3,5,2,1,-41,-1,0,1,22,0,-2,-1,1,-1,1,2,-1
KR_6760957380,440,-2,12,8,-11,1,2,3,-1,2,1,0,1,1,-6,7,1,-5,6,1,0,-7,-9,-2,-1,3,-1,0,-1,-1,0,-1,-1,6,-1
KR_6717721699,420,4,10,14,5,0,2,2,6,2,8,0,3,3,-1,3,2,0,1,1,0,-3,-39,-2,-2,4,20,0,1,-1,1,1,1,2,-1
KR_6750746649,420,-1,-9,-16,-4,0,3,3,0,2,2,3,2,5,-7,10,3,0,0,0,0,0,-5,-1,-1,2,12,0,-1,0,1,-1,-1,0,-1
KR_6625414197,420,-4,-99,12,-12,-1,3,2,0,2,2,-10,12,2,-4,5,1,3,0,3,-1,-9,-3,0,-4,4,-4,0,0,-1,0,-1,-1,2,-1
KR_6743118177,420,2,65,22,-3,2,1,3,3,0,3,-5,6,1,0,2,2,-3,3,0,0,1,-315,2,-3,1,-2,0,1,1,1,1,-1,1,-1
KR_6759246035,420,0,-34,-4,-4,-1,2,1,-6,7,1,2,2,4,1,4,5,0,2,2,0,0,-7,-3,-1,4,-1,0,-2,0,-1,-1,-1,0,-1
KR_6229808563,420,-3,-22,-24,-3,5,1,6,-6,11,5,3,1,4,-6,6,0,1,0,1,2,0,3,0,-4,4,-1,0,0,0,1,1,-1,0,-1
KR_6733764292,440,-1,-89,0,1,-1,2,1,-1,2,1,-1,1,0,6,0,6,-2,2,0,0,3,-17,0,-2,2,2,0,0,-1,1,1,-1,5,-1
KR_6655042656,420,-2,-72,0,0,1,0,1,3,3,6,-1,1,0,0,2,2,-3,3,0,0,-6,-37,0,-3,3,23,0,0,-1,-1,-1,1,4,-1
KR_6753904172,420,-2,-100,8,-1,-1,1,0,0,1,1,-1,2,1,0,3,3,1,0,1,1,1,-4,-2,0,2,0,0,-1,-1,1,-1,1,5,-1
KR_6742377969,420,1,31,-24,1,-1,3,2,-1,3,2,-1,1,0,6,0,6,-2,6,4,0,0,-12,-1,-2,3,4,0,1,1,1,1,-1,2,-1
KR_6760414062,420,-1,41,9,-8,4,0,4,-6,8,2,-1,3,2,1,1,2,-6,6,0,0,-16,-1,2,-4,2,0,0,-1,-1,-1,-1,1,4,-1
KR_6608869681,420,-3,-64,12,-6,-1,4,3,3,0,3,-2,5,3,-2,2,0,-4,5,1,0,-12,-4,-2,-3,5,0,0,-3,-1,-1,-1,-1,5,-1
KR_6747682477,420,-11,-27,-91,-20,-2,2,0,-4,4,0,-3,3,0,-9,11,2,-2,3,1,-1,-21,-21,-4,-3,7,0,0,-3,-1,-1,-1,-1,6,-1
KR_6741233366,420,-2,-7,-15,-3,1,2,3,1,0,1,0,4,4,0,1,1,-5,5,0,0,1,-90,2,-7,5,-35,0,0,-1,0,0,1,5,-1
KR_6761707728,420,-6,-79,-32,-20,-4,4,0,-4,4,0,1,1,2,-12,12,0,-1,3,2,-2,-17,-159,1,-5,4,-19,0,-1,0,0,-1,-1,0,-1
KR_6717374937,420,-2,45,-18,-7,0,1,1,-4,6,2,-2,2,0,0,3,3,-1,2,1,0,-14,-6,3,-8,5,2,0,1,0,1,1,-1,0,-1
KR_6718163428,440,-2,-72,-20,-2,-1,4,3,-2,5,3,3,0,3,-2,4,2,0,0,0,0,1,63,1,-3,2,17,0,-2,-1,-1,-1,-1,2,-1
KR_5665701766,420,-1,-43,-16,-4,-2,2,0,7,2,9,-3,4,1,-4,4,0,-2,2,0,0,-3,-323,-3,-2,5,1,0,0,-1,1,-1,-1,1,-1
KR_6607589249,420,-3,-72,44,-5,0,0,0,-2,2,0,4,4,8,-1,2,1,-6,7,1,0,-3,24,0,-4,4,-2,0,-1,0,0,-1,1,0,-1
KR_6731591710,440,-5,-129,14,-13,-1,2,1,0,1,1,-5,6,1,-2,3,1,-5,5,0,0,-14,5,-1,0,1,-2,0,-3,0,-1,-1,-1,0,-1
KR_6708602935,440,-4,-8,-12,-3,-1,3,2,0,3,3,1,0,1,-1,2,1,-2,2,0,0,-9,-5,0,-6,6,2,0,0,-1,1,0,-1,5,-1
KR_6728526147,420,2,9,0,-2,-1,1,0,4,1,5,-3,4,1,-1,2,1,-1,1,0,0,1,105,5,-6,1,-2,0,2,-1,1,1,1,6,-1
KR_6761980392,420,2,79,-10,2,2,2,4,3,1,4,-7,12,5,4,2,6,0,0,0,0,3,146,-6,0,6,4,0,0,1,1,0,1,6,-1
KR_6692089048,420,1,-3,-35,3,8,2,10,0,3,3,-1,4,3,-2,4,2,-2,2,0,-1,-1,305,-2,-3,5,2,0,1,-1,1,1,-1,6,-1
KR_6651165544,420,-1,-22,12,-1,-6,6,0,-1,2,1,3,0,3,0,2,2,3,1,4,0,-2,5,0,-7,7,2,0,1,1,-1,1,1,3,-1
KR_6720977667,440,-2,-66,8,-8,0,2,2,-6,6,0,-1,3,2,-1,1,0,0,1,1,0,-11,55,-2,-1,3,1,0,-1,-1,1,-1,1,3,-1
KR_6724720319,420,-1,-56,12,-1,-4,4,0,0,1,1,-1,6,5,5,1,6,-1,2,1,-1,1,-81,-4,-2,6,3,0,-1,1,-1,-1,-1,1,-1
KR_6760025373,420,-4,-90,-36,-7,-1,3,2,1,4,5,-3,9,6,-2,7,5,-2,3,1,0,-13,-53,-2,-4,6,6,0,-2,-1,-1,-1,1,5,-1
KR_6763197183,420,-1,22,-16,-1,1,1,2,-1,4,3,3,0,3,-4,5,1,0,2,2,0,-9,-23,-1,-3,4,6,0,-1,-1,-1,-1,-1,3,-1
KR_6622089772,420,1,-1,-12,2,-3,5,2,0,1,1,2,1,3,3,0,3,0,1,1,0,5,6,1,-4,3,-1,0,-2,-1,0,-1,-1,3,-1
KR_6751200866,420,-4,-84,-19,-3,2,3,5,-1,3,2,-1,2,1,-3,4,1,0,0,0,-1,-8,2,-2,-2,4,-2,0,0,-1,1,0,-1,5,-1
KR_6753718506,420,-1,22,17,-3,1,2,3,-1,1,0,-5,6,1,-2,5,3,4,1,5,-1,-7,-3,-5,0,5,2,0,0,0,-1,1,-1,0,-1
KR_6760229918,420,-2,61,-4,-2,-1,3,2,-3,3,0,1,5,6,1,2,3,0,0,0,0,-4,-3,-1,-5,6,3,0,0,-1,-1,1,-1,3,-1
KR_5533018689,420,-11,-107,-29,-24,-2,3,1,-1,1,0,-9,11,2,-9,9,0,-3,3,0,0,-17,-6,-1,-1,2,0,0,-4,-1,-1,-1,-1,1,-1
KR_6758841983,420,-2,-32,0,0,-3,4,1,0,5,5,1,3,4,2,2,4,0,0,0,0,-3,-4,1,-4,3,2,0,1,-1,1,1,1,2,-1
KR_6615572391,420,-1,-46,13,-3,-2,3,1,-1,3,2,5,0,5,-1,9,8,-4,4,0,-2,0,2,1,-5,4,-4,0,-1,-1,-1,-1,-1,4,-1
KR_6739740434,420,-2,-6,-16,1,0,1,1,1,1,2,-1,3,2,1,1,2,0,0,0,0,-2,-1,3,-4,1,-1,0,1,-1,1,1,1,5,-1
KR_6711871562,420,0,29,14,0,2,1,3,-3,5,2,0,2,2,1,1,2,0,0,0,0,-2,-265,2,-3,1,1,0,0,0,0,0,-1,0,-1
KR_6626441800,420,2,-23,21,5,7,1,8,-5,6,1,-1,5,4,2,0,2,2,0,2,0,-2,19,2,-5,3,-2,0,0,0,0,1,1,0,-1
KR_6659730029,420,-4,-62,-18,-4,-7,7,0,-1,2,1,1,1,2,2,5,7,1,2,3,-2,-4,-8,1,-4,3,2,0,0,1,-1,-1,-1,5,-1
KR_6685755912,420,1,-21,4,-1,-4,5,1,0,3,3,5,2,7,-2,3,1,0,1,1,1,-2,11,1,-3,2,-4,0,0,-1,-1,1,1,6,-1
KR_6763571432,440,1,-30,86,2,4,1,5,1,4,5,0,1,1,-4,10,6,1,0,1,1,12,0,-1,-2,3,2,0,0,1,1,1,1,1,-1
KR_6618998575,420,0,7,16,1,1,0,1,1,2,3,-1,7,6,0,1,1,0,0,0,0,2,-5,3,-4,1,-2,0,0,-1,1,0,1,1,-1
KR_6680522464,420,-5,-64,-19,-8,-3,5,2,1,2,3,-3,3,0,-2,5,3,-1,1,0,0,-5,5,3,-8,5,-2,0,-2,-1,1,-1,1,3,-1
KR_6659793499,420,-1,-12,-5,-9,-2,3,1,-1,3,2,-6,6,0,-2,5,3,2,1,3,-1,-18,10,-1,-1,2,-4,0,-2,-1,-1,-1,-1,3,-1
KR_6749428288,420,0,15,-1,2,2,1,3,3,1,4,-9,10,1,5,0,5,1,1,2,0,1,-8,-5,-3,8,-2,0,0,-1,1,1,1,6,-1
KR_6735845976,420,-2,-58,-35,0,0,2,2,3,3,6,-5,7,2,1,2,3,1,1,2,0,10,113,3,-5,2,-1,0,0,1,1,0,1,4,-1
KR_6656931352,420,-2,-10,-5,-7,-1,1,0,0,2,2,-4,4,0,-1,1,0,-1,1,0,0,-9,4,-2,-2,4,-5,0,-1,0,-1,-1,-1,0,-1
KR_6648586950,420,0,31,-7,1,2,1,3,-1,2,1,-7,8,1,4,1,5,3,1,4,0,2,1,1,-2,1,2,0,-1,-1,-1,1,-1,1,-1
KR_6757586031,420,4,-59,8,9,2,1,3,-3,4,1,7,0,7,3,1,4,0,0,0,1,13,15,-1,-1,2,2,0,1,1,-1,1,1,5,-1
KR_6586733083,420,3,27,-21,-3,1,2,3,0,2,2,-1,3,2,-1,1,0,-2,3,1,0,-9,2,0,-3,3,-2,0,-1,-1,-1,-1,-1,2,-1
KR_6758210888,440,3,108,28,7,7,0,7,0,3,3,5,3,8,-3,9,6,-2,2,0,2,3,-146,0,-3,3,1,0,2,1,-1,1,1,5,-1
KR_6704240227,420,-2,-105,-14,-11,2,2,4,1,4,5,-6,8,2,-6,6,0,-2,2,0,-1,-10,-18,0,0,0,-1,0,-2,1,-1,-1,-1,5,-1
KR_6633587525,420,1,59,24,7,-1,4,3,2,1,3,5,1,6,-2,3,1,3,1,4,0,3,12,0,-2,2,-1,0,0,0,-1,-1,1,0,-1
KR_6751561330,420,-1,-82,-3,-14,-8,9,1,-3,5,2,-5,6,1,3,3,6,-1,2,1,-2,-7,-2,0,-1,1,-1,0,-2,0,1,-1,-1,0,-1
KR_6725013139,440,-7,-101,18,-21,-5,5,0,-1,2,1,-4,4,0,-5,7,2,-6,6,0,0,-18,-7,-3,-5,8,-5,0,-2,-1,-1,-1,-1,4,-1
KR_6683931922,420,0,-100,-23,-1,0,3,3,-4,5,1,-2,4,2,5,1,6,0,2,2,0,0,16,1,-2,1,1,0,-1,-1,-1,-1,-1,2,-1
KR_6713091499,420,-3,-46,-20,-9,0,1,1,1,2,3,-6,6,0,-2,3,1,-2,2,0,0,-9,4,5,-6,1,-4,0,0,-1,-1,-1,1,5,-1
KR_6683486327,420,-5,-114,13,-13,-5,5,0,-7,7,0,-1,3,2,-1,3,2,1,0,1,0,-14,4,1,-3,2,-2,0,-3,-1,1,-1,-1,2,-1
KR_6758020552,420,-3,-127,24,-10,-6,6,0,-1,4,3,1,1,2,-4,4,0,0,0,0,0,-5,-11,-4,-1,5,-3,0,-2,-1,-1,-1,-1,5,-1
KR_6693922311,420,-2,31,-41,-1,-2,2,0,0,2,2,1,1,2,-1,5,4,1,1,2,0,5,6,3,-7,4,1,0,0,-1,1,0,-1,4,-1
KR_6617495872,420,-3,7,-11,-1,-2,3,1,-2,4,2,-4,5,1,6,1,7,1,0,1,1,2,-4,-5,-3,8,3,0,1,-1,1,-1,1,6,-1
KR_6754445170,440,-2,9,-8,1,5,0,5,-7,8,1,3,1,4,-1,4,3,1,5,6,0,9,9,1,-6,5,-6,0,0,1,-1,-1,1,2,-1
KR_6760761972,420,0,-9,-32,-2,-1,4,3,0,3,3,2,1,3,0,5,5,-3,3,0,0,4,-28,1,-7,6,0,0,0,1,0,1,1,3,-1
KR_6643668216,420,0,-8,-3,4,2,0,2,5,3,8,-4,6,2,1,1,2,0,1,1,0,8,-6,-6,0,6,3,0,0,-1,1,0,-1,2,-1
KR_6614447035,420,2,-19,20,4,0,0,0,3,2,5,0,2,2,3,3,6,-2,3,1,0,0,-73,-6,0,6,5,0,1,-1,1,-1,-1,5,-1
KR_6725736959,420,0,-10,-20,5,-4,4,0,3,3,6,2,1,3,0,1,1,4,1,5,0,13,-9,-4,-4,8,6,0,0,-1,-1,-1,-1,2,-1
KR_6412745937,420,-2,-77,-51,-8,-4,4,0,-1,2,1,-4,5,1,-1,2,1,2,0,2,0,-4,-4,2,-6,4,-3,0,-3,0,-1,-1,-1,0,-1
KR_6761129984,420,-1,18,0,-3,0,1,1,-4,5,1,3,0,3,-2,4,2,0,0,0,0,-6,-7,-1,-1,2,0,0,0,1,1,0,1,4,-1
KR_6762574733,420,2,37,-8,7,-2,4,2,-1,5,4,2,2,4,6,5,11,2,1,3,0,2,-126,6,-6,0,-3,0,-1,-1,-1,-1,1,6,-1
KR_6746144415,420,-4,-63,-84,-2,-2,3,1,2,0,2,0,2,2,2,3,5,-4,5,1,0,0,12,0,-4,4,-5,0,-2,-1,-1,-1,1,2,-1
KR_6739630563,420,4,5,-34,7,-2,4,2,2,1,3,4,2,6,3,3,6,0,0,0,1,6,12,1,-4,3,-2,0,1,0,0,1,1,0,-1
KR_6748104224,420,-2,-27,-16,-6,1,1,2,-2,3,1,1,3,4,-5,5,0,-1,2,1,0,-8,-203,7,-8,1,-3,0,-2,-1,1,-1,1,6,-1
KR_6750122378,440,-3,-56,-28,-4,-4,5,1,1,1,2,2,0,2,-2,3,1,-1,1,0,0,-6,-1,-2,-1,3,4,0,0,-1,-1,0,1,1,-1
KR_6763609952,420,-3,-14,-12,-6,-1,3,2,-3,5,2,0,2,2,-3,3,0,1,0,1,0,-5,2,-2,-2,4,3,0,-1,-1,0,-1,-1,4,-1
KR_6663259115,420,-4,-35,-14,-6,-1,1,0,1,1,2,-2,3,1,-3,4,1,-1,1,0,-1,-4,-5,-3,-3,6,-1,0,-2,0,1,-1,-1,0,-1
KR_6724752572,420,-3,-59,0,-1,-1,3,2,-2,2,0,5,1,6,-1,3,2,-2,4,2,0,-5,7,1,-6,5,-3,0,0,-1,0,0,1,5,-1
KR_6661447324,420,3,30,6,2,-7,7,0,3,0,3,1,1,2,4,1,5,1,0,1,0,7,-106,3,-5,2,-1,0,0,-1,-1,0,-1,2,-1
KR_6761130366,420,-2,-78,0,-3,2,1,3,-3,4,1,4,1,5,-4,5,1,-2,2,0,0,-5,-9,7,-8,1,-2,0,-2,-1,1,-1,1,1,-1
KR_6753017277,420,-2,-12,-3,-2,3,1,4,0,2,2,1,4,5,-2,2,0,-4,4,0,0,-7,0,1,-3,2,-4,0,1,0,1,1,-1,0,-1
KR_6641430044,420,-3,25,-4,-1,2,2,4,0,2,2,-3,6,3,0,2,2,0,2,2,1,-2,3,2,-5,3,-8,0,-1,1,-1,-1,1,5,-1
KR_6760791051,420,-6,-107,-54,-13,-6,7,1,-1,2,1,-4,7,3,-1,2,1,-1,1,0,0,-5,-5,-2,0,2,0,0,-2,-1,-1,-1,-1,2,-1
KR_6761786102,420,-4,-39,-36,-8,1,0,1,-1,3,2,0,5,5,-7,8,1,-1,2,1,0,-6,3,2,-2,0,-2,0,0,-1,1,-1,-1,3,-1
KR_6615632457,420,2,43,-3,5,-3,3,0,2,2,4,2,0,2,4,0,4,0,0,0,0,8,6,-3,-3,6,1,0,0,1,-1,-1,1,2,-1
KR_6761720154,420,-1,24,-25,-2,1,1,2,-2,4,2,1,1,2,0,3,3,-2,2,0,0,-5,0,-1,-4,5,-1,0,0,-1,1,0,-1,5,-1
KR_6759485752,420,2,-58,16,-3,-1,2,1,-1,1,0,1,2,3,-2,3,1,0,0,0,0,-4,10,-4,-2,6,5,0,-1,1,0,-1,-1,3,-1
KR_6761910740,420,-3,-16,7,-7,1,2,3,0,2,2,-6,7,1,-3,8,5,1,2,3,0,-6,-10,0,-4,4,0,0,0,0,-1,0,-1,0,-1
KR_6631777096,420,-3,-46,-16,-2,0,2,2,-2,4,2,2,0,2,-2,4,2,0,1,1,0,-1,-2,-1,-3,4,-3,0,-1,-1,-1,-1,1,1,-1
KR_6630596836,420,-2,-45,-27,-6,0,4,4,-2,4,2,-1,4,3,-1,2,1,-2,2,0,0,-3,90,4,-9,5,-2,0,0,0,-1,1,-1,0,-1
KR_6718727482,420,2,57,28,4,3,1,4,2,0,2,3,1,4,-5,8,3,1,1,2,0,5,-40,2,-4,2,0,0,1,-1,1,1,1,6,-1
KR_6588285222,420,3,51,36,2,-1,4,3,0,3,3,4,3,7,1,1,2,-2,2,0,0,-3,199,-1,-3,4,2,0,-1,0,-1,-1,1,0,-1
KR_6745974606,420,-3,-69,-5,-16,-1,3,2,0,2,2,-4,4,0,-8,9,1,-3,3,0,-2,-12,-15,-4,-1,5,2,0,-1,1,-1,-1,-1,2,-1
KR_6739199219,440,0,35,-19,-1,-2,4,2,-1,4,3,2,0,2,-4,6,2,4,0,4,0,1,-5,-1,-2,3,2,0,0,-1,-1,-1,1,4,-1
KR_6591397368,420,-2,8,-7,-5,-1,2,1,-1,2,1,0,1,1,-3,3,0,0,2,2,0,-4,43,-2,-1,3,-28,0,0,-1,1,0,1,2,-1
KR_6697831421,420,-2,-88,-41,1,-1,2,1,4,0,4,1,2,3,-1,1,0,-2,2,0,0,2,3,-3,-1,4,-4,0,-1,-1,-1,-1,1,5,-1
KR_6706154218,420,-2,47,24,-3,2,1,3,-2,2,0,-3,5,2,4,1,5,-4,4,0,0,-2,-132,-1,-4,5,1,0,-2,-1,-1,-1,-1,2,-1
KR_6751933940,420,5,80,4,12,-1,1,0,5,2,7,0,0,0,6,1,7,2,0,2,0,3,-12,0,-1,1,0,0,1,0,-1,1,-1,0,-1
KR_6747661760,440,-4,-9,-16,-6,4,2,6,-1,1,0,-9,9,0,0,2,2,0,0,0,0,-15,-22,1,-5,4,4,0,0,-1,0,0,1,3,-1
KR_5539391269,420,-3,-56,-14,-5,-3,4,1,7,1,8,1,2,3,-4,6,2,-6,8,2,-1,-2,5,3,-5,2,-5,0,-2,-1,-1,-1,-1,4,-1
KR_6642627999,420,-3,-4,-24,-4,-1,2,1,1,2,3,-2,3,1,-2,4,2,0,1,1,0,-2,12,-1,-2,3,-3,0,0,-1,1,0,-1,1,-1
KR_6730612265,420,-1,0,-12,-4,2,1,3,-1,5,4,-3,5,2,-2,3,1,0,1,1,0,-13,-14,3,-6,3,-2,0,0,1,0,0,-1,6,-1
KR_6633152364,420,-2,-20,-4,-6,0,2,2,-3,5,2,0,3,3,-4,5,1,1,0,1,0,-9,349,-1,-3,4,-3,0,-1,-1,1,-1,-1,1,-1
KR_6730901048,420,-4,-85,-24,-8,-1,2,1,4,0,4,-4,6,2,-4,5,1,-3,5,2,-1,-8,13,1,-3,2,-3,0,-1,-1,-1,-1,-1,4,-1
KR_6723997834,420,-1,76,-32,-1,6,0,6,-5,7,2,-1,5,4,-2,2,0,1,0,1,0,-1,9,-2,-2,4,1,0,2,0,-1,1,1,0,-1
KR_6758021116,420,3,32,-8,1,3,0,3,-2,2,0,-2,4,2,0,4,4,2,1,3,2,2,-6,0,-3,3,-2,0,0,-1,-1,-1,1,2,-1
KR_6737085680,420,-1,47,15,-9,-3,5,2,-2,2,0,-4,5,1,-1,1,0,1,3,4,0,-12,-7,-1,-4,5,-2,0,-1,1,-1,-1,-1,4,-1
KR_6707829653,420,-3,-117,12,-8,-3,3,0,0,3,3,-7,7,0,4,1,5,-2,2,0,0,-2,20,-4,-3,7,0,0,0,0,0,-1,-1,0,-1
KR_6736857654,420,-5,-85,1,-10,0,0,0,-1,1,0,-5,6,1,-3,3,0,-1,1,0,0,-9,0,1,-5,4,-1,0,0,-1,1,0,-1,6,-1
KR_6752630748,420,-3,-26,12,-16,-2,2,0,-8,8,0,-2,3,1,-3,6,3,-1,1,0,0,-19,-8,-7,-3,10,4,0,-2,1,-1,-1,-1,4,-1
KR_6701312218,420,-1,27,-44,-2,2,0,2,2,0,2,-3,4,1,2,1,3,-5,7,2,0,2,-52,-4,-2,6,30,0,-1,-1,-1,-1,-1,3,-1
KR_6761285204,420,0,16,-4,2,4,0,4,0,1,1,-4,6,2,3,3,6,-1,1,0,0,-1,-157,3,-3,0,0,0,1,-1,0,1,1,5,-1
KR_6757043358,440,-3,36,12,-5,-3,4,1,2,3,5,2,1,3,-6,8,2,0,1,1,1,-6,7,1,-2,1,0,0,0,1,-1,1,1,4,-1
KR_6759810391,440,-4,-101,-14,-2,-3,4,1,3,1,4,-3,4,1,0,3,3,1,1,2,-1,-3,-3,1,-3,2,-2,0,0,1,1,0,-1,6,-1
KR_6721018134,420,-4,1,-8,-8,3,0,3,-3,3,0,-4,6,2,-4,4,0,0,0,0,0,-14,-13,-2,-2,4,-2,0,-1,1,-1,-1,-1,6,-1
KR_6732751067,440,-2,-82,-5,-6,0,0,0,-6,8,2,-7,8,1,5,1,6,2,0,2,-1,-2,-12,-2,-2,4,2,0,-1,1,-1,-1,-1,1,-1
KR_6273616379,420,-1,-5,28,-5,-3,4,1,2,1,3,3,0,3,-6,6,0,-1,1,0,0,-2,1,1,-7,6,3,0,-1,-1,1,-1,-1,6,-1
KR_6756726578,440,-3,-37,-12,-7,-4,5,1,2,1,3,-2,2,0,-3,3,0,0,0,0,0,-4,3,4,-8,4,-1,0,0,0,-1,0,-1,0,-1
KR_6389672466,420,1,-12,28,-4,0,0,0,2,3,5,-5,6,1,-1,1,0,0,1,1,0,-4,13,-3,-1,4,-1,0,0,0,-1,0,1,0,-1
KR_6762930156,420,0,-5,4,-2,-4,5,1,2,2,4,1,1,2,0,1,1,-1,1,0,0,-1,-23,0,-3,3,4,0,0,1,-1,-1,-1,5,-1
KR_6688408314,420,-2,-23,19,-7,0,3,3,0,4,4,-4,5,1,-1,4,3,-2,2,0,0,-10,208,2,-4,2,0,0,0,-1,0,0,-1,4,-1
KR_6581665106,420,-4,-50,-32,-5,1,0,1,-5,8,3,-1,4,3,0,4,4,0,0,0,0,1,-1,2,-5,3,-2,0,0,-1,-1,-1,-1,2,-1
KR_6760751610,420,2,48,6,1,-1,3,2,-3,3,0,1,1,2,4,3,7,0,1,1,0,-3,-5,5,-6,1,-4,0,0,-1,1,1,1,6,-1
KR_6750657606,420,-2,-5,4,-3,2,3,5,1,0,1,2,7,9,-2,4,2,-6,7,1,-1,-2,-47,-1,-2,3,17,0,0,-1,-1,1,-1,5,-1
KR_6713256114,420,-1,13,-12,-5,2,0,2,-9,9,0,0,2,2,1,4,5,1,0,1,0,-11,6,-1,-2,3,-9,0,0,0,-1,0,-1,0,-1
KR_6675007985,420,-4,-36,0,0,0,3,3,1,1,2,3,0,3,-3,4,1,-1,2,1,1,1,-6,1,-1,0,1,0,-1,1,-1,-1,1,3,-1
KR_6758128912,440,4,-50,-12,9,-1,1,0,1,2,3,2,2,4,3,2,5,4,1,5,0,7,1,4,-4,0,1,0,1,1,0,1,1,6,-1
KR_6719544917,420,2,4,16,5,6,1,7,1,1,2,-2,2,0,0,2,2,0,2,2,0,2,16,2,-8,6,-5,0,2,-1,1,1,1,4,-1
KR_6616125608,420,2,63,9,3,1,1,2,0,4,4,-2,4,2,1,1,2,3,1,4,0,3,-9,2,-6,4,-2,0,1,0,1,1,1,0,-1
KR_6626907476,420,-2,-39,28,-5,-2,3,1,-3,6,3,-4,4,0,4,1,5,0,1,1,0,-1,2,-1,-7,8,-8,0,-1,-1,1,-1,1,5,-1
KR_6708910866,420,-2,-118,11,-9,-4,6,2,2,1,3,-1,5,4,-5,8,3,-1,2,1,-1,-9,2,0,-5,5,2,-1,-3,1,-1,-1,-1,5,-1
KR_6761291501,420,-2,-34,-40,-9,-6,7,1,0,2,2,-5,5,0,1,0,1,1,0,1,0,0,-8,-5,-1,6,1,0,-1,0,-1,1,-1,0,-1
KR_6717783230,420,3,49,28,6,4,1,5,0,0,0,4,5,9,-2,3,1,0,2,2,0,-2,53,-1,0,1,-18,0,2,-1,1,1,-1,3,-1
KR_6700502249,420,0,13,-15,2,6,1,7,-1,5,4,0,0,0,-3,4,1,0,2,2,-1,0,-11,-2,-4,6,1,0,-1,-1,-1,-1,-1,4,-1
KR_6250882767,420,-6,-54,-27,-12,1,1,2,-10,11,1,-3,6,3,2,3,5,-2,3,1,0,-18,217,-1,-4,5,4,0,0,-1,0,0,1,6,-1
KR_6761988662,420,-2,-4,-16,2,-1,3,2,-4,5,1,-1,2,1,7,0,7,1,0,1,0,9,133,-4,-2,6,4,0,2,1,1,1,1,2,-1
KR_6728217965,420,-5,-2,-40,-16,1,1,2,-6,6,0,-8,8,0,-1,1,0,-2,2,0,0,-9,-11,-5,-1,6,2,0,-1,1,-1,-1,1,3,-1
KR_6691042322,440,1,-15,-24,1,-1,2,1,-1,4,3,1,1,2,1,0,1,1,0,1,0,-4,0,1,-3,2,0,0,0,-1,-1,0,1,5,-1
KR_6644780922,420,-3,-28,8,-8,-3,3,0,-1,3,2,-1,3,2,-1,4,3,-2,2,0,0,-2,-7,-2,-1,3,-3,0,0,-1,1,-1,-1,3,-1
KR_6604061983,420,-5,-75,-14,-11,-3,5,2,-3,5,2,-6,6,0,-1,1,0,2,0,2,0,-7,-6,-1,-5,6,2,0,-1,-1,0,-1,-1,5,-1
KR_6763076315,420,2,-30,-1,6,3,3,6,1,4,5,1,1,2,-2,2,0,3,1,4,0,7,-6,1,-1,0,0,0,-1,-1,-1,-1,1,2,-1
KR_6729055285,420,-1,-52,25,0,3,5,8,0,1,1,-5,6,1,-1,1,0,3,1,4,0,3,5,1,-3,2,-2,0,-1,0,1,-1,-1,0,-1
KR_6632508481,440,-1,-73,-15,-6,-1,1,0,-1,2,1,-4,6,2,1,2,3,-1,4,3,0,-8,-14,5,-6,1,3,0,-2,0,1,-1,-1,0,-1
KR_6722840943,440,-3,-71,4,-10,-5,6,1,-1,2,1,3,2,5,-5,7,2,-2,3,1,-1,-12,-1,-2,-3,5,-1,0,-2,-1,1,-1,-1,6,-1
KR_6650889939,420,-2,11,10,-9,-2,4,2,-4,4,0,-2,4,2,-1,2,1,0,0,0,0,-7,0,-6,0,6,3,0,-1,0,0,-1,1,0,-1
KR_6760284655,420,-1,-4,-3,-2,2,1,3,-4,4,0,-3,3,0,0,3,3,3,0,3,-1,1,1,0,-4,4,1,0,0,-1,-1,-1,-1,3,-1
KR_6763392113,440,-3,-17,0,-9,1,0,1,-5,5,0,-8,8,0,6,0,6,-3,4,1,0,-13,-41,-4,0,4,23,0,-2,-1,-1,-1,-1,6,-1
KR_6747497177,420,-4,29,8,-5,-4,4,0,-1,2,1,3,3,6,0,2,2,-3,4,1,0,-2,-103,1,-4,3,-1,0,0,1,1,0,-1,5,-1
KR_6761069925,420,-3,15,-28,-3,1,1,2,-4,5,1,-6,6,0,6,2,8,0,0,0,1,0,0,-6,-1,7,4,0,-1,0,-1,-1,1,0,-1
KR_6641574489,420,-2,-54,-7,-1,-4,5,1,-2,5,3,1,3,4,4,2,6,0,0,0,1,3,-1,0,-6,6,-4,0,0,0,0,-1,1,0,-1
KR_6719445304,420,-4,65,-3,-11,-2,2,0,1,3,4,-3,4,1,-4,6,2,-3,5,2,-3,-18,227,-2,-2,4,3,0,0,1,1,0,-1,6,-1
KR_6747348917,420,-2,-68,4,-2,-4,5,1,-5,7,2,5,0,5,2,1,3,0,1,1,0,0,-8,-2,-5,7,-2,0,-1,1,1,-1,1,3,-1
KR_6720013753,420,0,49,-28,5,1,1,2,0,2,2,-1,4,3,2,2,4,3,0,3,0,3,-6,3,-6,3,-2,0,1,0,1,1,1,0,-1
KR_6662575531,420,-3,-50,-32,-7,1,1,2,-3,5,2,-1,2,1,-3,5,2,-1,1,0,0,-5,6,2,-4,2,-6,0,-2,-1,-1,-1,-1,5,-1
KR_6663150120,420,-1,31,-17,-2,1,0,1,-2,2,0,2,1,3,-1,7,6,-2,3,1,1,-2,2,-2,-5,7,5,0,2,0,-1,1,1,0,-1
KR_6670989256,420,2,3,30,0,-1,2,1,-2,4,2,1,0,1,1,0,1,1,0,1,0,-1,-1,-6,-2,8,-1,0,0,0,1,1,1,0,-1
KR_6743400298,440,-4,-30,3,-11,-4,5,1,0,0,0,-1,1,0,-5,5,0,-1,1,0,0,-14,-11,-4,0,4,1,0,-3,-1,-1,-1,-1,2,-1
KR_6729477828,440,-2,-28,-16,0,0,0,0,-2,3,1,1,4,5,0,3,3,1,0,1,-2,0,-7,-1,-5,6,-2,0,-1,-1,-1,-1,-1,4,-1
KR_6669426670,420,8,17,60,7,3,0,3,5,0,5,0,1,1,-1,2,1,0,0,0,0,10,6,1,-3,2,0,0,2,-1,-1,1,1,5,-1
KR_6757011670,420,-1,-42,-24,-4,2,1,3,-3,5,2,3,2,5,-3,5,2,-3,3,0,0,-1,-5,-2,-2,4,-5,0,0,-1,-1,0,1,5,-1
KR_6760402720,420,2,54,-16,-5,-2,4,2,0,3,3,0,3,3,-2,6,4,-1,1,0,0,-3,-3,1,-4,3,-2,0,0,1,1,1,-1,4,-1
KR_6579711711,440,-4,-15,-5,-6,-2,3,1,0,3,3,2,2,4,-6,9,3,0,0,0,0,-7,5,2,-5,3,-6,0,-1,0,1,-1,1,0,-1
KR_6752486234,420,-3,-23,-32,-8,-7,7,0,-1,4,3,-3,5,2,3,3,6,0,1,1,-1,11,21,2,-5,3,-3,0,-2,-1,-1,-1,-1,5,-1
KR_6729972778,420,-7,-36,-15,-15,-5,5,0,-8,8,0,0,2,2,-2,3,1,0,0,0,0,-17,0,2,-5,3,-2,0,-3,-1,-1,-1,-1,1,-1
KR_6747700311,420,0,27,4,1,1,0,1,2,1,3,0,0,0,-1,2,1,-1,1,0,0,2,2,3,-3,0,-4,0,0,-1,1,-1,-1,1,-1
KR_6753863356,420,-4,-79,-20,-9,-9,9,0,-1,1,0,0,2,2,0,1,1,1,0,1,0,-3,-33,1,-3,2,1,0,0,1,-1,-1,-1,2,-1
KR_6725894274,420,-1,30,20,-3,2,2,4,-5,6,1,2,2,4,-1,3,2,-1,1,0,0,-10,-4,2,-4,2,2,0,0,-1,1,0,1,6,-1
KR_6760343755,420,-1,-48,12,2,-2,2,0,7,1,8,-1,2,1,-2,6,4,0,1,1,-1,2,-5,0,-3,3,-1,0,-2,1,1,-1,-1,6,-1
KR_6695702606,420,-8,-84,-21,-12,-2,2,0,-2,4,2,1,1,2,-10,11,1,1,2,3,0,-18,-57,-1,-3,4,1,0,-3,1,-1,-1,-1,4,-1
KR_6653045814,420,-5,-16,0,-8,-3,3,0,1,3,4,0,0,0,-4,5,1,-2,2,0,1,-2,4,6,-8,2,-1,0,0,-1,-1,0,1,5,-1
KR_6727155720,420,0,51,-20,-1,-1,1,0,0,4,4,-2,3,1,0,2,2,2,2,4,0,-5,-15,5,-6,1,0,0,1,-1,1,1,-1,2,-1
KR_6759953313,420,-3,-34,0,-3,0,2,2,-2,4,2,-5,7,2,5,3,8,-1,1,0,0,-11,-43,-2,-3,5,17,0,-1,1,-1,-1,-1,6,-1
KR_6656687343,420,0,-34,-22,-2,-1,2,1,-2,7,5,2,1,3,-1,3,2,0,2,2,0,-5,51,3,-5,2,-2,0,0,1,1,0,1,1,-1
KR_6751843642,420,0,13,-5,-5,3,1,4,-3,3,0,-1,2,1,-3,4,1,-1,2,1,1,-5,49,-4,-1,5,-21,0,1,-1,1,1,1,3,-1
KR_6530583267,420,-5,-118,-10,-12,-7,8,1,1,1,2,0,3,3,-5,6,1,-1,2,1,0,-7,355,1,-5,4,-3,0,-3,-1,-1,-1,-1,1,-1
KR_6662109980,440,2,-29,20,-2,-3,4,1,-4,4,0,0,3,3,4,3,7,1,1,2,-1,3,-35,0,-1,1,-1,0,-1,0,-1,-1,-1,0,-1
KR_6759234355,420,-4,-2,-13,-8,1,1,2,-1,4,3,0,4,4,-3,4,1,-5,5,0,-1,0,32,0,-3,3,-3,0,-1,1,-1,-1,-1,4,-1
KR_6642423236,420,-4,-88,14,-4,-1,1,0,1,1,2,1,1,2,-2,2,0,-3,3,0,0,-4,6,8,-9,1,-6,0,0,0,1,-1,-1,0,-1
KR_6760393719,420,-3,-17,-8,4,-3,4,1,2,2,4,4,1,5,1,1,2,0,0,0,-1,2,47,-5,-1,6,-25,0,0,-1,0,-1,-1,6,-1
KR_6761055918,420,-5,-37,-32,-9,-1,1,0,1,5,6,-3,5,2,-7,7,0,1,1,2,-1,-11,1,1,-4,3,0,0,-1,0,-1,-1,-1,0,-1
KR_6742832568,420,-2,-40,-16,-7,1,0,1,-5,8,3,6,0,6,-9,11,2,0,1,1,0,-11,-4,-2,0,2,0,0,0,-1,1,-1,1,6,-1
KR_6636468087,440,-6,-44,13,-3,-5,5,0,1,2,3,1,0,1,3,2,5,-3,3,0,0,5,-3,-4,-1,5,2,0,-1,-1,1,-1,1,1,-1
KR_6763180081,420,2,5,-12,1,1,3,4,-1,5,4,1,0,1,0,2,2,0,0,0,0,-1,-8,-1,-3,4,-2,0,0,1,1,0,1,5,-1
KR_6703455904,420,-4,-13,-15,-7,0,2,2,-2,6,4,-1,2,1,-4,5,1,0,0,0,0,-11,-6,-2,-4,6,3,0,-1,-1,-1,-1,1,1,-1
KR_6490525344,420,-2,56,18,-1,1,0,1,1,2,3,-1,1,0,-1,2,1,-1,1,0,0,-2,-194,0,-2,2,2,0,0,1,-1,0,1,4,-1
KR_6741713447,420,-8,-101,-52,-22,-8,8,0,-7,8,1,1,2,3,-6,6,0,-2,2,0,-2,-17,1,-2,-3,5,-2,0,-3,-1,-1,-1,-1,4,-1
KR_6762422600,420,-4,-86,-24,-10,-3,3,0,3,2,5,-7,9,2,-1,1,0,-2,5,3,0,-5,5,3,-5,2,-2,0,-2,-1,-1,-1,-1,1,-1
KR_6756871154,420,-2,-64,-44,1,1,0,1,0,6,6,0,0,0,-1,4,3,1,1,2,0,-3,-6,-3,-2,5,-2,0,-1,-1,-1,-1,1,5,-1
KR_6753897292,420,-7,-27,-12,-16,-3,3,0,-2,5,3,-11,12,1,-1,1,0,1,0,1,0,-10,-3,0,-4,4,1,0,-2,1,-1,-1,1,2,-1
KR_6725500425,420,-5,-88,-24,-16,1,0,1,-5,5,0,-8,8,0,-4,4,0,0,0,0,0,-18,-4,-4,-1,5,-3,0,-1,-1,-1,-1,1,2,-1
KR_6718427168,420,-5,-8,-29,-10,-1,2,1,0,2,2,-2,4,2,-5,5,0,-2,4,2,0,-3,-7,-5,-1,6,0,0,-2,-1,-1,-1,-1,5,-1
KR_6657291194,420,4,30,12,4,1,1,2,1,2,3,2,1,3,-1,2,1,1,0,1,0,-1,-3,-1,-5,6,0,0,0,-1,-1,0,1,6,-1
KR_6691620495,420,-4,-64,-17,-11,-4,4,0,-1,2,1,1,0,1,-4,6,2,-3,3,0,0,-10,9,3,-5,2,0,0,-1,1,-1,-1,-1,3,-1
KR_6679489268,420,0,22,-8,1,-2,2,0,0,1,1,3,3,6,0,3,3,0,1,1,0,3,7,0,-4,4,1,0,0,-1,-1,0,-1,1,-1
KR_6754339864,420,-1,87,-4,0,1,0,1,2,3,5,2,1,3,-4,4,0,-1,1,0,0,-4,-6,-1,-2,3,1,0,0,-1,-1,0,1,5,-1
KR_6592611549,420,1,-68,-12,4,2,0,2,1,2,3,4,0,4,-3,5,2,0,2,2,0,4,92,0,-4,4,1,0,0,-1,1,1,-1,1,-1
KR_6412896790,420,-1,0,-10,-2,-3,4,1,0,5,5,-4,4,0,0,3,3,5,0,5,0,4,-6,-3,-3,6,0,0,1,1,1,1,1,2,-1
KR_6763955842,420,-1,12,-4,1,1,0,1,0,2,2,1,3,4,-2,4,2,1,0,1,0,-3,9,5,-8,3,-5,0,-1,0,-1,-1,1,0,-1
KR_6736188009,420,2,63,-1,6,3,1,4,1,0,1,-2,4,2,3,3,6,1,2,3,0,2,6,-1,-4,5,1,0,-1,1,-1,1,-1,3,-1
KR_6743908438,440,-1,-26,-4,-8,2,2,4,0,0,0,-4,7,3,-1,2,1,-5,5,0,0,-8,-6,-9,0,9,2,0,0,1,-1,0,-1,5,-1
KR_6704010754,420,2,33,-10,0,0,2,2,-3,5,2,5,2,7,-1,2,1,-1,3,2,0,-10,3,1,-5,4,-1,0,0,1,-1,1,-1,4,-1
KR_6652988788,420,-3,-69,-40,-1,0,1,1,-2,3,1,1,2,3,-2,3,1,2,1,3,0,0,-7,0,-2,2,0,0,-2,-1,1,-1,-1,1,-1
KR_6636166954,440,-1,-11,16,2,-2,3,1,3,1,4,4,0,4,-2,3,1,-1,2,1,0,-4,9,-1,-6,7,-1,0,1,-1,1,1,-1,4,-1
KR_6360155068,420,-3,-95,-5,-1,4,0,4,3,2,5,0,4,4,-8,8,0,0,0,0,2,3,0,0,0,0,-3,0,-1,-1,1,-1,1,3,-1
KR_6753848755,420,-2,-72,0,1,0,2,2,1,4,5,-1,2,1,2,2,4,-1,2,1,0,11,-1,3,-6,3,-3,0,0,-1,1,0,-1,4,-1
KR_6579633733,440,1,3,-20,3,-1,3,2,0,0,0,-2,2,0,3,0,3,3,0,3,0,-1,-8,-6,-1,7,-1,0,-1,-1,-1,-1,1,3,-1
KR_6727833178,420,0,-33,0,-2,0,3,3,0,3,3,2,3,5,-1,1,0,-3,3,0,0,-7,-29,4,-5,1,4,0,0,1,-1,-1,1,5,-1
KR_6758795032,420,-1,-4,1,2,0,2,2,3,0,3,-2,2,0,-2,2,0,3,0,3,-2,3,9,0,-4,4,0,0,1,-1,0,1,-1,5,-1
KR_6734354947,420,0,-15,7,5,4,0,4,-3,3,0,-2,3,1,3,1,4,3,0,3,0,7,6,-2,0,2,1,0,0,1,0,1,1,6,-1
KR_6748502793,440,-4,-26,0,-16,-8,8,0,5,3,8,-3,6,3,-9,11,2,-1,1,0,-1,-17,-3,0,-1,1,0,0,-1,-1,1,-1,-1,5,-1
KR_6668533493,420,-2,-72,-16,-7,-3,5,2,-5,6,1,1,2,3,3,2,5,-3,4,1,0,-17,2,1,-4,3,3,0,0,1,1,0,-1,4,-1
KR_6761877724,440,-1,-72,8,-6,-2,2,0,1,5,6,-1,3,2,-3,4,1,-1,1,0,1,-10,2,0,-6,6,-9,0,0,-1,0,0,1,5,-1
KR_6732385491,420,0,-58,13,0,3,2,5,1,3,4,1,2,3,-5,5,0,0,0,0,0,-6,7,4,-6,2,-3,0,-2,-1,1,-1,-1,1,-1
KR_6603302408,420,3,26,-24,10,0,1,1,0,1,1,6,1,7,1,1,2,3,1,4,-1,12,5,4,-6,2,-6,0,1,-1,1,1,-1,6,-1
KR_6660893188,420,-3,-59,-4,-2,-4,6,2,2,1,3,-3,3,0,3,0,3,0,1,1,0,2,-2,-1,-2,3,-4,0,-1,-1,1,-1,-1,2,-1
KR_6723076446,420,-3,-53,-20,-4,-3,3,0,3,0,3,3,1,4,-4,6,2,-3,3,0,0,-2,36,5,-7,2,-6,0,-1,0,1,-1,1,0,-1
KR_6648946873,420,0,-4,-12,6,5,1,6,-1,2,1,0,1,1,3,2,5,-1,2,1,0,4,5,2,-4,2,-2,0,1,1,1,1,1,6,-1
KR_6739026837,420,0,-22,24,-3,2,3,5,5,2,7,-4,5,1,-3,3,0,-3,3,0,0,6,-128,-2,-1,3,-1,0,-1,-1,-1,-1,-1,4,-1
KR_6741775149,420,5,56,4,-2,-1,2,1,-3,3,0,4,2,6,1,2,3,-3,4,1,0,-10,4,-2,-1,3,-1,0,0,0,-1,0,-1,0,-1
KR_6751361834,420,1,4,-9,6,-4,4,0,-1,3,2,3,0,3,3,2,5,5,0,5,2,19,4,5,-9,4,-6,0,0,1,0,0,1,3,-1
KR_6735647079,420,-11,-120,-68,-11,-2,2,0,-3,3,0,-2,2,0,-4,4,0,0,0,0,-2,-10,-9,0,-1,1,-1,0,-2,-1,0,-1,-1,5,-1
KR_6686515516,440,-7,-85,-36,-19,-2,5,3,-10,10,0,-4,4,0,-2,2,0,-1,4,3,0,-25,1,0,-2,2,0,0,-1,-1,-1,-1,-1,2,-1
KR_6602813410,420,0,-50,6,-5,-4,6,2,-3,7,4,4,2,6,-1,5,4,-1,1,0,-2,-14,-4,0,-6,6,2,0,-1,0,1,-1,-1,0,-1
KR_6623992523,420,-2,-37,-20,-3,3,1,4,0,2,2,-5,5,0,-2,2,0,1,1,2,0,0,-8,1,-5,4,-2,0,1,-1,1,1,1,4,-1
KR_6749619932,440,-5,-100,-32,-12,-3,3,0,-1,1,0,-1,2,1,0,2,2,-7,7,0,0,-9,4,-1,-3,4,-1,0,-1,-1,0,-1,-1,4,-1
KR_6718642129,420,3,65,12,8,4,2,6,0,3,3,1,3,4,4,2,6,-1,1,0,0,-3,-135,-1,-4,5,0,0,0,-1,-1,1,1,2,-1
KR_6579600149,440,-7,-35,-8,-14,-1,4,3,-12,12,0,0,2,2,-1,3,2,0,1,1,0,-13,362,1,-6,5,-2,0,-1,-1,-1,-1,-1,3,-1
KR_6699058802,420,4,13,-8,10,2,2,4,-2,2,0,6,1,7,2,0,2,2,1,3,0,-3,-33,2,-6,4,22,0,1,-1,1,1,-1,5,-1
KR_6753346228,420,0,-57,13,-9,-2,4,2,-5,6,1,0,2,2,0,0,0,-2,3,1,-1,-15,-1,-1,-3,4,1,0,0,1,-1,-1,-1,4,-1
KR_6656632497,420,-7,-100,-60,-16,-4,6,2,0,0,0,-5,5,0,-5,6,1,-2,2,0,0,-8,19,8,-9,1,-10,0,-1,-1,-1,-1,1,1,-1
KR_6758318699,420,-1,46,-28,-10,-3,5,2,-3,4,1,0,1,1,-1,3,2,-3,5,2,0,-13,-4,0,-2,2,-1,0,0,-1,-1,0,-1,3,-1
KR_6711694181,420,0,22,-43,6,3,0,3,4,0,4,-2,3,1,2,3,5,-1,1,0,0,3,-4,2,-5,3,1,0,0,-1,1,1,1,5,-1
KR_6644153931,420,1,60,34,-2,-5,5,0,3,3,6,1,1,2,0,3,3,-1,4,3,0,4,-91,2,-6,4,-1,0,1,1,-1,1,1,2,-1
KR_5905982839,420,-6,-66,-22,-8,4,3,7,-2,5,3,-3,4,1,-6,7,1,-1,1,0,0,-12,-3,0,-2,2,-2,0,-1,-1,1,1,1,3,-1
KR_6740353625,420,1,-7,16,-8,-5,5,0,-3,4,1,3,2,5,-1,5,4,-2,3,1,0,-5,25,2,-4,2,-2,0,-2,1,-1,-1,-1,6,-1
KR_6759388542,420,2,-55,40,5,3,1,4,4,1,5,0,3,3,-2,2,0,0,1,1,0,-1,-12,4,-5,1,4,0,0,1,1,0,-1,6,-1
KR_6747397643,440,1,62,-17,2,3,0,3,5,0,5,1,0,1,-5,8,3,-2,2,0,0,2,44,3,-3,0,-28,0,2,-1,1,1,-1,3,-1
KR_6751979834,420,-10,-56,-78,-25,-6,6,0,-4,5,1,-9,9,0,-6,7,1,0,1,1,0,-13,1,-1,0,1,-1,0,-1,-1,-1,-1,-1,5,-1
KR_6625642436,420,0,24,29,-1,5,2,7,5,2,7,-3,4,1,-4,7,3,-4,4,0,2,0,3,3,-9,6,4,0,0,1,-1,1,1,5,-1
KR_6602994651,420,-1,-3,8,-5,-3,3,0,1,1,2,0,0,0,0,2,2,-3,5,2,0,-1,6,3,-3,0,1,0,0,1,-1,0,-1,1,-1
KR_6750738386,440,-2,-43,-8,-9,-4,4,0,-3,3,0,-2,3,1,-1,2,1,1,1,2,1,-8,-46,1,-5,4,17,0,-1,-1,0,-1,1,4,-1
KR_6613966046,420,-1,55,15,0,2,2,4,1,1,2,-3,4,1,1,3,4,-1,1,0,0,-12,-11,-3,-2,5,0,0,1,1,1,1,-1,5,-1
KR_6753174029,440,1,-80,-4,-2,-3,6,3,-6,7,1,1,2,3,3,0,3,3,0,3,0,-1,-1,-1,-3,4,-3,0,-2,-1,-1,-1,-1,3,-1
KR_6752277848,420,-3,-45,-38,-3,1,1,2,-4,5,1,1,0,1,1,2,3,-2,4,2,0,-3,-88,4,-5,1,-5,0,0,1,1,1,1,1,-1
KR_6040071842,420,-3,-7,-33,-8,1,1,2,-5,7,2,0,1,1,-5,5,0,1,0,1,0,-9,236,4,-7,3,-5,0,-1,-1,1,-1,-1,2,-1
KR_6701267298,420,-1,4,0,-2,-2,2,0,-1,3,2,3,3,6,-1,2,1,-1,2,1,-1,1,-42,2,-3,1,22,0,-1,-1,-1,-1,-1,6,-1
KR_6636609680,420,-2,-86,8,-10,-3,3,0,-1,2,1,-4,5,1,-6,7,1,4,1,5,0,-1,-41,-5,-2,7,33,0,0,1,-1,-1,-1,4,-1
KR_6735484709,420,-4,-63,-8,-15,-3,4,1,-4,5,1,-4,4,0,-4,7,3,0,0,0,0,-19,0,0,-3,3,-2,0,-2,-1,-1,-1,-1,6,-1
KR_6122387052,440,-1,49,-30,-7,-2,2,0,-1,3,2,1,3,4,-4,4,0,-1,1,0,0,-2,-44,2,-2,0,17,0,-4,-1,-1,-1,-1,3,-1
KR_6746142206,420,0,-42,21,-4,-4,5,1,1,0,1,1,1,2,-2,5,3,0,0,0,0,5,2,-1,-5,6,-4,0,0,0,1,-1,1,0,-1
KR_6762719908,420,-2,-8,8,-4,0,4,4,-1,2,1,-3,3,0,1,0,1,-1,2,1,0,-4,-34,1,-3,2,-2,0,0,-1,-1,0,1,3,-1
KR_6762981711,420,0,1,-19,-2,-1,1,0,3,2,5,-8,11,3,4,1,5,0,3,3,0,-5,-44,2,-8,6,20,0,0,-1,1,1,1,5,-1
KR_6731507295,440,-1,-91,5,2,0,2,2,4,2,6,2,1,3,-2,2,0,-2,2,0,0,-3,-5,-4,-2,6,0,0,0,1,1,0,1,2,-1
KR_6762379102,420,-1,27,-28,-3,-2,2,0,1,5,6,0,2,2,2,0,2,-4,6,2,0,3,-2,0,-1,1,-2,0,0,0,-1,0,1,0,-1
KR_6636757754,420,0,22,-20,-3,6,1,7,-3,4,1,1,1,2,-6,7,1,-1,2,1,1,-12,-9,-2,-1,3,1,0,-1,1,-1,1,1,2,-1
KR_6669063251,420,1,42,-12,-2,2,0,2,-1,4,3,-2,2,0,2,3,5,-3,4,1,0,-7,204,0,-5,5,-3,0,1,-1,1,1,-1,2,-1
KR_6758954832,420,-1,-40,16,-5,0,0,0,-2,4,2,0,2,2,-2,3,1,-1,2,1,0,-8,6,-5,-2,7,0,0,0,-1,0,1,1,4,-1
KR_6761230053,420,3,89,-32,5,4,2,6,1,1,2,0,1,1,1,2,3,-1,3,2,1,6,-16,1,-2,1,-1,0,1,-1,1,1,1,5,-1
KR_6678701880,420,-2,43,-27,-7,-2,3,1,4,1,5,0,2,2,-5,8,3,-4,4,0,-2,-9,26,1,-6,5,-3,0,-1,0,0,-1,-1,0,-1
KR_6711907347,420,-4,-60,-16,-15,-2,3,1,1,1,2,-1,2,1,-11,11,0,-2,2,0,0,-10,-253,3,-5,2,2,0,-2,-1,0,-1,-1,4,-1
KR_6609567802,420,0,-8,0,1,-6,6,0,-1,5,4,4,0,4,4,0,4,0,1,1,0,9,-5,2,-3,1,-1,0,-2,-1,-1,-1,1,2,-1
KR_6731095421,420,-2,-107,0,-4,-3,5,2,2,2,4,-4,9,5,1,0,1,0,1,1,0,5,-1,-1,-5,6,2,0,0,1,1,-1,-1,2,-1
KR_6647880100,420,0,6,24,0,1,1,2,-1,1,0,-3,3,0,3,1,4,0,0,0,0,-2,30,1,-6,5,-25,0,0,1,1,0,1,2,-1
KR_6605323565,440,-4,28,-5,-16,-3,3,0,-5,6,1,2,2,4,-4,5,1,-6,7,1,-1,-14,21,2,-6,4,-2,0,0,0,-1,0,-1,0,-1
KR_6750999996,420,-4,-6,-11,-10,0,3,3,-4,6,2,-2,3,1,-3,5,2,-1,1,0,-1,-11,-146,-2,-5,7,0,0,-1,-1,-1,-1,-1,2,-1
KR_6748738150,420,-3,-21,-41,-4,-1,3,2,1,2,3,-3,4,1,-3,3,0,2,1,3,1,1,-5,0,-3,3,3,0,-1,0,-1,-1,-1,0,-1
KR_6661713246,420,1,20,1,-2,2,1,3,-3,4,1,-3,5,2,-2,4,2,4,0,4,0,-13,1,-2,-2,4,-2,0,1,-1,1,1,-1,2,-1
KR_6648272092,440,-2,-35,-48,-4,0,2,2,-4,4,0,3,2,5,-2,3,1,-1,2,1,-1,-8,4,-3,-1,4,1,0,0,-1,-1,0,-1,4,-1
KR_6732454471,420,0,7,35,3,2,0,2,-3,3,0,1,2,3,0,3,3,3,0,3,0,5,-105,3,-4,1,-1,0,0,1,-1,0,1,1,-1
KR_6740650759,420,-2,69,-4,-2,1,2,3,-6,7,1,0,0,0,3,1,4,0,0,0,0,0,12,1,-4,3,-4,0,1,-1,1,1,1,2,-1
KR_6732906156,420,-7,-133,-22,-20,-7,8,1,0,2,2,-3,5,2,-9,11,2,-1,2,1,0,-7,-8,1,-5,4,-4,-1,-5,-1,-1,-1,-1,5,-1
KR_6444467062,420,-1,78,-44,1,0,1,1,-1,1,0,3,1,4,0,2,2,-1,1,0,0,1,21,0,-3,3,-4,0,1,1,1,1,-1,1,-1
KR_6489614470,420,1,72,-23,5,4,0,4,1,3,4,1,2,3,0,1,1,-1,3,2,0,3,-10,1,-3,2,1,0,1,-1,0,1,1,2,-1
KR_6760008174,420,-1,-39,13,-5,-1,2,1,1,0,1,-4,6,2,-1,1,0,0,1,1,0,-1,6,-1,0,1,-1,0,-1,0,-1,-1,-1,0,-1
KR_6596383554,420,-3,-44,-8,-4,-3,4,1,0,2,2,-1,2,1,-1,4,3,1,1,2,0,2,-9,0,-4,4,3,0,-2,-1,-1,-1,-1,3,-1
KR_6756783185,420,-5,-92,-27,-8,-1,3,2,-1,4,3,-2,3,1,-3,4,1,-1,2,1,-1,-3,-1,-3,-2,5,-2,0,-3,1,-1,-1,-1,5,-1
KR_6763028086,420,-2,9,-19,6,-5,5,0,3,2,5,3,1,4,3,1,4,2,1,3,0,14,-1,1,-3,2,-6,0,0,-1,0,0,1,1,-1
KR_6737079674,420,1,12,-16,1,4,1,5,-2,2,0,2,0,2,-1,1,0,-2,4,2,0,-1,-14,-2,-1,3,-2,0,0,-1,-1,1,1,4,-1
KR_6743951902,420,-3,-43,25,-7,2,1,3,-7,9,2,-2,6,4,1,4,5,-1,1,0,-1,2,-134,-1,0,1,-2,0,-1,1,-1,-1,-1,2,-1
KR_6699632724,420,-3,-91,-22,-8,-1,3,2,0,2,2,-1,3,2,-5,5,0,-1,2,1,-1,-9,22,-1,-3,4,0,0,-1,-1,-1,-1,-1,1,-1
KR_6659589278,420,-4,-74,-11,-7,1,3,4,-1,2,1,-3,3,0,-1,4,3,-3,5,2,-2,-6,41,2,-5,3,-28,0,-1,-1,1,-1,-1,5,-1
KR_6635833288,420,-1,-20,-6,-6,0,1,1,-7,8,1,2,0,2,0,2,2,-1,1,0,0,-8,31,-4,-1,5,4,0,-1,-1,1,-1,-1,5,-1
KR_6696972404,420,0,-15,0,-1,2,2,4,-1,3,2,-3,3,0,-2,3,1,3,0,3,0,-5,4,-1,-4,5,5,0,0,1,0,0,-1,4,-1
KR_6732026939,440,-3,31,5,-3,2,4,6,-2,2,0,-3,3,0,0,2,2,0,0,0,-1,-5,0,-2,-3,5,-2,0,0,-1,1,0,-1,2,-1
KR_6751982862,440,-5,42,-68,-1,0,0,0,5,2,7,-5,6,1,-4,8,4,3,1,4,1,12,106,2,-3,1,1,0,2,0,0,1,1,0,-1
KR_6758745670,420,-2,-37,-23,-6,-2,2,0,2,4,6,-3,5,2,-3,4,1,0,0,0,0,-3,-11,0,-4,4,-1,0,0,-1,1,0,-1,3,-1
KR_6739359900,420,1,19,4,-1,4,1,5,-3,4,1,-3,3,0,1,1,2,0,1,1,0,-1,2,-1,-2,3,2,0,0,-1,1,0,-1,5,-1
KR_6751324763,420,-4,-39,16,-8,-1,4,3,-10,10,0,4,1,5,-2,5,3,1,1,2,0,-15,-12,-8,-1,9,7,0,1,-1,1,1,-1,5,-1
KR_6633125256,420,1,33,16,-1,-1,2,1,-1,3,2,-3,4,1,2,1,3,2,0,2,0,4,0,-4,-1,5,-3,0,0,1,1,0,-1,3,-1
KR_6648934855,420,3,70,20,0,-1,2,1,3,0,3,4,0,4,-5,6,1,-1,3,2,0,-6,9,2,-6,4,4,0,2,0,1,1,-1,0,-1
KR_6743026219,420,0,-37,3,6,0,3,3,0,1,1,3,2,5,3,2,5,0,2,2,-1,7,-1,-3,-3,6,0,0,-1,1,-1,-1,-1,6,-1
KR_6744944325,420,-6,-20,-16,-7,2,4,6,-5,8,3,-1,3,2,-4,5,1,1,1,2,1,-9,-5,2,-8,6,-5,0,1,-1,1,-1,1,4,-1
KR_6762696879,420,-5,-44,4,-9,-5,8,3,0,1,1,-4,4,0,0,0,0,0,2,2,0,-3,-98,-1,0,1,-2,0,0,-1,-1,-1,-1,3,-1
KR_6762370428,420,0,-23,-9,-4,0,1,1,-2,4,2,0,3,3,-3,4,1,1,1,2,0,0,-72,-3,-1,4,18,0,0,-1,-1,0,-1,4,-1
KR_6718557360,420,-5,-77,0,-9,0,0,0,1,7,8,-4,7,3,-6,6,0,0,1,1,0,-8,-5,0,-6,6,5,0,0,1,1,-1,1,2,-1
KR_6675795238,420,-6,-50,8,-10,3,1,4,-2,3,1,-5,6,1,-4,7,3,-2,3,1,0,-16,-6,-3,-1,4,0,0,-2,1,-1,-1,-1,5,-1
KR_6761036131,420,3,-6,68,5,0,0,0,1,1,2,2,1,3,1,3,4,1,0,1,0,3,-6,6,-8,2,-1,0,0,1,1,0,-1,3,-1
KR_6759412855,420,-1,-10,-33,-4,2,3,5,-1,3,2,-3,6,3,-2,2,0,0,3,3,-1,-4,-1,-2,0,2,-2,0,0,1,1,1,-1,4,-1
KR_6749511475,420,-5,-92,-13,-8,-1,3,2,4,3,7,-5,7,2,-5,6,1,-1,2,1,0,-1,9,1,-4,3,-1,0,-2,-1,-1,-1,-1,6,-1
KR_6759233643,420,-1,-60,32,-9,-3,4,1,0,2,2,-1,2,1,-4,6,2,-1,2,1,0,-5,4,1,-6,5,-4,0,-1,-1,-1,-1,-1,6,-1
KR_6659753404,420,-3,-51,16,-10,-2,2,0,-2,4,2,-6,7,1,0,2,2,0,2,2,1,-7,-28,0,-3,3,12,0,-3,1,-1,-1,1,1,-1
KR_6755334845,420,-2,-83,-12,-2,-2,3,1,2,0,2,-2,4,2,0,1,1,0,1,1,1,6,-2,1,-3,2,0,0,0,-1,1,0,1,5,-1
KR_6682732335,420,-5,-74,-8,-5,4,0,4,0,1,1,-5,5,0,-3,4,1,-1,1,0,0,-2,-154,1,-1,0,-2,0,0,-1,1,-1,-1,2,-1
KR_6744102131,420,-3,-29,-8,-6,1,2,3,-5,5,0,-1,4,3,-2,3,1,1,1,2,-1,-3,-307,3,-6,3,-3,0,0,-1,-1,1,-1,1,-1
KR_6749612618,440,-4,-59,28,-7,-1,1,0,-5,5,0,3,1,4,-4,5,1,0,0,0,0,-10,182,-5,-3,8,2,0,0,0,1,1,1,0,-1
KR_6752716708,420,-1,-84,8,2,-1,3,2,2,0,2,-3,4,1,3,2,5,1,1,2,0,5,4,-5,-1,6,0,0,-1,-1,1,-1,-1,3,-1
KR_6725917079,420,-2,-67,-19,-5,1,2,3,-3,4,1,1,1,2,-1,2,1,-3,4,1,0,-8,-11,-4,-2,6,-2,0,-1,-1,-1,-1,-1,2,-1
KR_6757095958,420,-6,-81,-41,-10,0,1,1,-5,6,1,-7,8,1,1,2,3,1,0,1,0,-10,-25,-2,-2,4,-1,0,-3,0,-1,-1,-1,0,-1
KR_6720319360,420,-2,-69,20,-15,-4,4,0,-2,3,1,-6,6,0,-2,2,0,-1,1,0,0,-13,-9,-5,0,5,0,0,-2,1,0,-1,-1,3,-1
KR_6736684636,420,3,75,22,4,3,2,5,1,1,2,0,2,2,0,2,2,0,0,0,0,3,1,-2,-4,6,-1,0,1,1,1,1,1,1,-1
KR_6698465462,420,-3,-39,0,-8,-1,2,1,-1,1,0,-3,7,4,-2,2,0,-1,2,1,0,-13,-2,1,-4,3,0,0,-1,0,-1,-1,-1,0,-1
KR_6743171496,420,-3,-66,6,-4,1,1,2,-4,6,2,2,1,3,-3,3,0,0,0,0,-1,-12,-5,-1,-4,5,1,0,0,-1,1,-1,-1,3,-1
KR_6732623200,420,-4,-16,-4,-4,2,0,2,-1,5,4,-3,5,2,-2,5,3,0,0,0,-1,-6,3,-3,-2,5,-2,0,0,-1,-1,0,-1,3,-1
KR_6631411194,420,-2,-46,6,-1,-2,3,1,6,2,8,-4,5,1,-2,3,1,1,1,2,0,6,-49,0,-3,3,14,0,0,1,-1,-1,1,1,-1
KR_6760723972,440,-5,-7,-14,-22,0,2,2,-5,6,1,-2,2,0,-13,17,4,-2,2,0,0,-22,-99,0,-1,1,-3,0,-2,0,-1,-1,-1,0,-1
KR_6736914163,420,-1,15,-23,-4,0,0,0,-2,3,1,-4,8,4,1,2,3,1,0,1,-1,0,-170,-4,-2,6,3,0,-1,-1,-1,-1,-1,2,-1
KR_6600062891,420,3,31,-7,9,-1,1,0,2,4,6,0,1,1,7,0,7,1,0,1,0,15,-6,-6,-2,8,1,0,0,1,1,0,1,4,-1
KR_6760830661,440,-5,-2,-12,-10,-1,1,0,0,2,2,-5,6,1,-2,3,1,-2,2,0,0,-5,-15,-4,-3,7,2,0,0,-1,-1,0,-1,3,-1
KR_6736024868,420,1,-26,32,2,-1,3,2,3,2,5,-1,6,5,2,2,4,-1,2,1,0,1,209,-1,-4,5,-1,0,0,1,-1,-1,1,3,-1
KR_6707480458,420,-2,29,11,0,3,0,3,0,1,1,-4,4,0,2,1,3,-1,1,0,0,-3,-3,-2,-2,4,0,0,0,-1,-1,0,1,5,-1
KR_6674014389,420,-2,-47,-35,2,-2,2,0,1,4,5,-2,4,2,3,2,5,2,1,3,0,9,0,-1,-1,2,-4,0,0,-1,-1,-1,-1,4,-1
KR_6613226881,420,-5,-84,-4,-14,-3,3,0,2,1,3,-3,4,1,-1,5,4,-9,10,1,0,-8,6,1,-2,1,-2,0,-1,1,-1,-1,-1,6,-1
KR_6753930862,420,3,-115,52,-3,-3,3,0,2,2,4,-2,4,2,-2,4,2,2,0,2,1,3,2,0,-2,2,3,0,0,-1,1,0,1,4,-1
KR_6707177847,420,-5,-47,-15,-12,-1,1,0,-5,5,0,-1,1,0,-5,5,0,0,0,0,0,-13,-7,-5,-1,6,0,0,-1,-1,1,-1,1,3,-1
KR_6600941207,420,0,-7,4,0,1,2,3,0,4,4,-1,2,1,-2,2,0,2,0,2,0,-8,-14,0,-6,6,-1,0,1,-1,1,1,-1,2,-1
KR_6755102539,420,-1,-57,-19,-3,-1,1,0,6,2,8,0,0,0,-7,10,3,-1,2,1,-1,-1,0,-3,-4,7,3,0,0,1,-1,0,-1,5,-1
KR_6724026551,420,-3,-17,-36,-2,2,0,2,-4,6,2,1,2,3,-1,2,1,0,0,0,0,-12,234,-1,-3,4,-4,0,1,-1,1,1,1,6,-1
KR_6694471362,420,-2,-18,8,-10,-5,6,1,0,2,2,-4,5,1,-1,1,0,0,0,0,0,-2,11,-1,-1,2,0,0,-2,1,-1,-1,-1,6,-1
KR_6668115727,420,-3,-30,12,0,0,2,2,0,2,2,0,2,2,2,0,2,-2,4,2,0,0,1,-3,0,3,-2,0,-1,1,-1,-1,-1,1,-1
KR_6751542320,420,-1,-2,12,-7,1,2,3,-3,5,2,-1,1,0,-5,6,1,1,2,3,0,-2,-54,-3,-1,4,-3,0,0,-1,-1,1,-1,4,-1
KR_6666534392,420,-1,-14,-32,0,1,0,1,-1,6,5,1,2,3,-4,5,1,3,2,5,-2,0,-2,5,-8,3,-4,0,0,1,-1,-1,-1,5,-1
KR_6757059611,420,3,7,0,8,1,2,3,4,1,5,2,2,4,0,2,2,1,2,3,0,12,3,0,-3,3,-4,0,1,0,-1,1,1,0,-1
KR_6695199886,440,1,13,-19,6,-1,3,2,-1,3,2,7,0,7,0,2,2,1,0,1,0,14,-211,-2,-2,4,2,0,0,1,-1,1,1,5,-1
KR_6321599827,420,-2,-11,-6,-4,-1,1,0,0,2,2,-6,7,1,2,1,3,1,0,1,0,5,131,0,-3,3,2,0,0,1,1,0,1,5,-1
KR_6718521681,420,1,8,13,1,2,1,3,0,4,4,1,3,4,-3,6,3,1,0,1,0,-5,0,2,-3,1,3,0,0,-1,-1,-1,1,6,-1
KR_6743593781,420,-3,89,-16,-2,1,0,1,-4,6,2,1,1,2,-1,3,2,1,2,3,0,-5,30,2,-7,5,-7,0,1,1,1,1,1,5,-1
KR_6741773369,420,-1,-1,16,0,-1,2,1,-1,1,0,-4,4,0,2,0,2,4,0,4,0,3,-2,-3,-3,6,2,0,0,1,-1,0,-1,5,-1
KR_6760459395,420,5,102,4,16,2,1,3,2,3,5,9,0,9,3,0,3,0,0,0,0,10,20,3,-5,2,3,0,2,1,0,1,1,1,-1
KR_6725851790,420,-1,-24,-20,-1,-6,7,1,3,3,6,-3,3,0,1,1,2,4,1,5,-1,6,286,-2,-4,6,6,0,-1,-1,1,-1,-1,6,-1
KR_6692620072,420,-3,33,-19,-7,-2,2,0,-4,10,6,3,3,6,-5,6,1,1,1,2,0,-6,-2,2,-3,1,-3,0,0,-1,-1,-1,-1,2,-1
KR_6762044381,420,-3,-47,-15,-1,-4,5,1,0,2,2,0,4,4,2,0,2,1,0,1,0,-4,-129,-6,-1,7,0,0,-1,-1,-1,-1,1,5,-1
KR_6748536753,420,-3,-10,-4,-8,-5,7,2,-2,2,0,0,1,1,-1,4,3,0,1,1,0,-3,3,-1,-3,4,-2,0,-2,-1,0,-1,-1,1,-1
KR_6762762765,420,-2,13,-16,-1,1,4,5,2,1,3,-6,6,0,0,2,2,2,0,2,0,6,11,-1,-2,3,-3,0,1,0,1,1,1,0,-1
KR_6002878140,420,2,29,3,0,-1,4,3,-5,6,1,2,3,5,2,0,2,2,0,2,0,2,3,1,-5,4,3,0,3,1,1,1,1,3,-1
KR_6636112272,440,-5,-65,1,-4,-2,4,2,2,1,3,-2,4,2,-5,6,1,3,0,3,0,3,125,-1,-5,6,-3,0,-2,1,-1,-1,1,5,-1
KR_6699261975,420,1,62,-16,0,3,0,3,2,0,2,4,1,5,-9,9,0,0,0,0,0,-4,-34,0,-6,6,21,0,1,-1,0,1,1,4,-1
KR_6716161853,420,-4,-14,-12,-7,2,0,2,-4,4,0,-4,5,1,5,3,8,-6,6,0,0,-11,12,4,-4,0,-2,0,-2,-1,-1,-1,-1,3,-1
KR_6290493412,420,-5,-23,32,-11,0,2,2,-1,4,3,-5,7,2,-4,6,2,-1,1,0,0,-8,-1,-1,-3,4,-1,0,1,1,-1,1,-1,3,-1
KR_6730301350,440,-3,-3,-1,-5,0,3,3,-2,3,1,0,4,4,0,3,3,-3,4,1,0,-4,-4,-5,0,5,4,0,0,1,1,1,-1,1,-1
KR_6715906947,420,-8,-4,10,-9,-4,4,0,-3,4,1,-2,3,1,0,2,2,0,1,1,0,-9,7,1,-2,1,0,0,-1,-1,-1,-1,-1,2,-1
KR_6738950999,420,0,3,2,-1,-2,2,0,1,0,1,-3,5,2,4,0,4,-1,1,0,0,-3,7,-1,-1,2,-1,0,-1,1,-1,-1,-1,4,-1
KR_6762652960,420,-1,-32,10,2,-1,1,0,-1,2,1,1,1,2,0,3,3,3,0,3,1,1,8,4,-5,1,-4,0,0,1,1,0,1,4,-1
KR_6739599104,420,3,78,-4,1,-1,1,0,2,2,4,2,1,3,-1,2,1,-1,1,0,0,3,-29,1,-7,6,2,0,-1,1,-1,-1,1,4,-1
KR_6751803687,420,0,-11,-32,-6,1,0,1,-1,3,2,-5,6,1,-2,5,3,1,1,2,0,-10,106,1,-2,1,-1,0,1,-1,1,1,-1,4,-1
KR_6764078355,420,-2,-21,29,-10,-1,1,0,-7,7,0,-5,5,0,1,2,3,2,0,2,0,-8,-5,2,-6,4,-2,0,0,-1,1,0,-1,2,-1
KR_6719436697,420,0,26,-10,1,2,0,2,-4,6,2,6,1,7,0,3,3,-3,3,0,0,-3,2,1,-2,1,-5,0,2,1,1,1,-1,5,-1
KR_6753307345,420,-2,-37,3,-9,-2,4,2,1,2,3,-1,5,4,-8,8,0,1,0,1,0,-15,17,1,-5,4,1,0,-2,-1,-1,-1,-1,4,-1
KR_6662547725,440,1,44,-20,4,-1,3,2,3,1,4,2,2,4,0,3,3,0,0,0,0,3,12,7,-9,2,-2,0,0,-1,0,0,1,1,-1
KR_6757368889,440,-6,19,-36,-12,-1,3,2,-4,4,0,-1,4,3,-6,7,1,0,0,0,0,-16,-15,-2,-2,4,1,0,-1,-1,-1,-1,1,5,-1
KR_6702991987,420,-5,-64,0,-7,-1,2,1,-3,5,2,0,3,3,-4,4,0,1,1,2,-1,-4,-4,-5,-4,9,2,0,-2,1,-1,-1,-1,6,-1
KR_6671591567,440,4,48,-20,14,4,0,4,8,1,9,-3,5,2,5,2,7,0,1,1,0,20,6,4,-6,2,1,0,0,1,-1,1,1,2,-1
KR_6200049298,420,-3,-23,-17,-15,-3,3,0,-6,9,3,-4,4,0,1,2,3,-3,3,0,0,-18,209,2,-7,5,-5,0,-1,-1,-1,-1,1,4,-1
KR_6751156320,420,-2,27,-24,-6,0,1,1,-5,6,1,0,0,0,2,0,2,-3,4,1,0,-5,11,5,-6,1,4,0,2,0,1,1,-1,0,-1
KR_6633201170,420,-1,12,52,-4,1,1,2,-4,5,1,-3,4,1,0,1,1,2,0,2,0,-5,-1,-3,-3,6,-1,0,0,1,1,0,1,6,-1
KR_6758196544,420,-2,-45,-8,4,1,1,2,-4,7,3,0,2,2,4,3,7,3,0,3,1,2,-5,0,-3,3,-1,0,0,-1,1,0,1,1,-1
KR_6753429187,440,1,5,-12,1,2,1,3,1,2,3,-2,3,1,0,3,3,0,2,2,0,3,-7,0,-6,6,-10,0,0,-1,1,0,-1,2,-1
KR_6740004916,420,2,61,23,7,1,0,1,-3,6,3,2,3,5,7,3,10,0,0,0,-2,3,-2,-2,-2,4,1,0,1,1,0,1,-1,4,-1
KR_6761026727,420,-2,-49,-30,-3,0,1,1,1,2,3,0,3,3,-3,7,4,-1,2,1,-1,-5,-1,0,-1,1,-2,0,-1,1,-1,-1,-1,4,-1
KR_6682292781,420,-3,-64,-20,-4,-6,7,1,0,1,1,-4,4,0,3,1,4,3,1,4,1,4,1,3,-4,1,-2,0,-2,-1,-1,-1,1,1,-1
KR_6494765896,420,-2,-23,12,-6,-2,4,2,-2,8,6,-3,3,0,-2,4,2,3,0,3,0,-9,-29,-1,-1,2,2,0,-1,-1,-1,-1,-1,6,-1
KR_6695274247,420,-4,-14,3,-8,-1,3,2,-2,4,2,0,2,2,-4,6,2,-1,2,1,0,-3,-16,0,-1,1,-1,0,-3,-1,-1,-1,1,4,-1
KR_6758138356,420,-4,-18,-17,-6,-3,4,1,-1,3,2,-3,4,1,1,1,2,0,1,1,0,-7,15,-3,-3,6,-2,0,-1,-1,1,1,1,6,-1
KR_6610205873,420,2,-4,20,6,1,0,1,0,3,3,-1,1,0,3,2,5,3,1,4,0,10,9,2,-4,2,0,0,0,1,1,1,-1,4,-1
KR_6636771489,420,-5,-103,-50,-9,-7,7,0,2,1,3,-1,1,0,-2,3,1,-1,2,1,0,-2,9,-4,-2,6,0,0,-2,-1,-1,-1,1,1,-1
KR_6739073325,420,-6,-64,-52,-7,-1,4,3,-3,3,0,-2,2,0,-1,4,3,0,0,0,0,-12,-9,-3,0,3,1,0,-3,-1,-1,-1,-1,2,-1
KR_6671770935,420,3,5,4,11,1,2,3,2,0,2,1,2,3,4,1,5,3,0,3,0,12,-2,-2,-3,5,2,0,0,1,1,1,1,3,-1
KR_6760684106,440,2,24,-3,6,1,1,2,0,2,2,0,3,3,4,1,5,1,1,2,0,10,34,-1,-4,5,-16,0,0,0,-1,1,1,0,-1
KR_6759415376,420,0,22,4,1,-2,4,2,-1,1,0,1,0,1,2,0,2,1,0,1,0,-2,-19,-2,-2,4,3,0,0,1,-1,0,-1,1,-1
KR_6666506912,420,-4,-78,-28,-10,-1,1,0,-1,2,1,-4,4,0,0,4,4,-4,4,0,-4,-13,15,1,-3,2,-3,0,0,1,0,-1,-1,2,-1
KR_6639926050,420,1,-7,0,8,3,1,4,-5,8,3,3,2,5,6,1,7,1,1,2,0,21,13,-1,-1,2,1,0,-2,1,-1,-1,-1,5,-1
KR_6613721168,440,-5,-95,-29,-5,0,0,0,-4,4,0,-2,4,2,1,2,3,0,1,1,0,-2,-2,4,-6,2,-2,0,0,-1,1,0,1,4,-1
KR_6727850434,420,-4,-66,8,-7,-1,2,1,-6,7,1,1,3,4,-2,4,2,1,1,2,0,-4,2,-1,-1,2,2,0,-1,-1,-1,-1,1,3,-1
KR_6759241087,440,-4,-98,20,-19,-4,7,3,3,1,4,-2,4,2,-13,14,1,-3,3,0,-1,-13,1,-5,0,5,-1,0,-1,-1,1,-1,-1,1,-1
KR_6761538521,420,-4,-62,13,-16,-2,3,1,3,0,3,-14,15,1,-4,4,0,1,1,2,0,-17,-1,1,-3,2,1,0,-2,1,1,-1,-1,2,-1
KR_6656578389,420,-3,-34,-27,-9,-1,2,1,-6,8,2,-1,1,0,0,0,0,-1,1,0,0,-5,-4,-1,-4,5,-6,0,-2,-1,-1,-1,-1,3,-1
KR_6709514722,440,1,46,15,-2,1,1,2,-1,5,4,2,1,3,0,1,1,-4,5,1,0,-3,-6,-5,-2,7,1,0,-1,1,0,-1,-1,6,-1
KR_6731437725,420,-3,16,0,-7,0,2,2,-1,2,1,2,1,3,-4,4,0,-4,4,0,1,-6,-20,0,-1,1,-2,0,0,-1,0,0,1,2,-1
KR_6763122855,420,-2,-28,15,-4,1,0,1,1,5,6,0,3,3,-3,3,0,-3,5,2,0,-3,-11,6,-7,1,-1,0,-1,1,-1,-1,-1,1,-1
KR_6674539782,420,-6,-111,-24,-15,-4,5,1,-3,6,3,-4,6,2,-1,2,1,-3,6,3,0,-12,-3,6,-8,2,-2,0,-3,-1,-1,-1,1,4,-1
KR_6527250536,420,-4,-70,-26,-8,-1,2,1,-6,6,0,3,0,3,-3,4,1,-1,1,0,0,-11,-4,1,-3,2,-1,0,-1,-1,-1,-1,1,1,-1
KR_6743337690,420,5,33,6,9,1,1,2,5,3,8,5,1,6,-2,3,1,0,0,0,0,12,-8,-2,-2,4,-6,0,2,1,1,1,1,5,-1
KR_6762184205,420,-5,-78,-28,-5,-5,6,1,0,2,2,2,1,3,-4,9,5,2,2,4,0,3,14,-1,-2,3,-1,0,-1,0,-1,-1,-1,0,-1
KR_6731688018,420,1,-11,0,3,4,0,4,-2,2,0,1,2,3,0,2,2,0,0,0,0,3,-4,1,-3,2,1,0,1,-1,1,1,1,3,-1
KR_6638128395,420,-8,-55,-29,-13,-3,5,2,0,1,1,-7,8,1,-2,3,1,-1,3,2,0,-6,2,1,-3,2,-1,0,-1,-1,0,-1,-1,1,-1
KR_6730799998,420,0,8,-4,-7,1,1,2,-2,5,3,-4,5,1,-2,2,0,0,0,0,0,-6,25,-3,-1,4,0,0,-1,-1,0,-1,-1,6,-1
KR_6688894416,420,-4,-137,-39,-4,-4,4,0,1,4,5,0,3,3,0,1,1,-1,1,0,-1,2,5,0,-3,3,-1,0,-1,-1,1,-1,-1,3,-1
KR_6714792778,440,-4,-27,-7,-7,-6,7,1,-4,4,0,2,0,2,1,1,2,0,1,1,-2,-19,-6,-4,-3,7,-3,0,0,-1,0,0,-1,4,-1
KR_6712494585,420,-2,-44,-16,-1,0,3,3,-3,4,1,3,1,4,-4,5,1,3,0,3,0,-4,3,0,-4,4,-4,0,-1,-1,1,-1,1,3,-1
KR_6751828023,420,-2,19,-12,-7,3,0,3,3,2,5,2,2,4,-14,18,4,-1,2,1,1,-16,15,-3,-1,4,3,0,0,1,1,1,1,6,-1
KR_6734232650,420,-1,-19,28,-2,-3,4,1,4,1,5,1,0,1,-4,5,1,0,1,1,1,-1,-3,-2,-3,5,2,0,-1,-1,-1,-1,1,6,-1
KR_6759761595,420,-3,-52,-3,-9,0,2,2,-6,6,0,-1,4,3,0,1,1,-2,2,0,0,-8,127,-5,-1,6,2,0,-3,-1,-1,-1,1,5,-1
KR_6762878377,420,1,-13,4,-10,-1,1,0,2,4,6,-7,7,0,-3,4,1,-1,2,1,0,-13,363,-1,-2,3,1,0,0,1,1,1,-1,2,-1
KR_6759278722,440,-5,-78,-17,-12,-3,4,1,3,1,4,-4,4,0,-5,5,0,-3,3,0,0,-18,-6,-4,0,4,0,0,-1,-1,0,-1,1,1,-1
KR_6698942223,420,-1,9,0,-6,3,1,4,-5,5,0,1,1,2,0,0,0,-5,5,0,-1,-6,53,-1,0,1,-22,0,0,-1,-1,1,-1,6,-1
KR_6749468979,420,-2,2,-16,-9,-2,4,2,-4,5,1,-5,6,1,0,2,2,2,0,2,-1,-6,7,-1,-3,4,-1,0,-1,0,0,-1,-1,0,-1
KR_6754893703,440,-4,-59,-7,-10,-3,4,1,-5,5,0,-3,5,2,0,2,2,1,1,2,0,-7,4,-3,0,3,-3,0,0,-1,-1,-1,-1,6,-1
KR_6758125548,420,-3,-52,-14,-6,-7,7,0,0,3,3,-2,3,1,4,2,6,-1,1,0,-2,3,-9,0,0,0,1,-1,-4,-1,-1,-1,-1,5,-1
KR_6755802308,420,-5,-29,-34,-12,3,2,5,-5,5,0,-6,7,1,-1,4,3,-3,4,1,0,-11,5,-2,-4,6,-7,0,-3,0,-1,-1,-1,0,-1
KR_6705676436,440,4,100,-29,8,-2,5,3,0,2,2,4,1,5,2,0,2,4,0,4,1,9,4,-2,-4,6,3,0,0,-1,1,1,1,1,-1
KR_6711709914,420,-1,-58,0,4,-2,3,1,-2,4,2,5,3,8,0,2,2,3,1,4,-1,2,5,5,-7,2,-7,0,-2,0,1,-1,-1,0,-1
KR_6735951390,420,-4,-82,8,-13,-4,5,1,1,2,3,0,1,1,-8,8,0,-2,2,0,0,-11,6,0,-6,6,-6,0,-2,-1,-1,-1,-1,6,-1
KR_6731605715,420,0,6,-2,1,4,0,4,1,5,6,-2,4,2,-4,4,0,2,0,2,0,-4,-505,0,-5,5,-1,0,0,-1,-1,1,1,3,-1
KR_6755581208,420,-5,-49,-4,-13,-2,2,0,-1,4,3,-8,8,0,-2,2,0,0,0,0,0,-17,-9,-4,-1,5,2,0,0,0,-1,0,-1,0,-1
KR_6760865356,420,0,-83,3,1,0,2,2,0,4,4,1,3,4,-2,5,3,2,1,3,0,-5,363,-3,-2,5,2,0,1,1,1,1,1,4,-1
KR_6725937682,420,1,8,9,7,3,2,5,4,2,6,0,2,2,-1,7,6,1,1,2,0,5,-129,-1,-6,7,3,0,0,1,1,1,-1,6,-1
KR_6764253950,420,-1,-12,-16,4,-1,1,0,0,5,5,-1,1,0,5,1,6,1,2,3,1,2,-123,-3,-2,5,-2,0,0,0,0,1,1,0,-1
KR_6756403153,440,-3,-50,28,-14,-1,2,1,-3,5,2,-3,6,3,-5,7,2,-2,2,0,0,-12,-19,-3,-2,5,1,0,-1,-1,-1,-1,-1,5,-1
KR_6673188262,420,-1,-66,-12,3,0,1,1,5,0,5,2,2,4,-4,6,2,0,0,0,0,1,7,1,-5,4,-6,0,0,1,-1,0,1,4,-1
KR_6624996335,420,-4,-110,68,-6,-2,2,0,0,1,1,-4,4,0,0,2,2,0,2,2,0,-2,-5,1,-4,3,-1,0,-1,1,1,-1,1,6,-1
KR_6612231320,420,-1,-24,-2,-5,-1,4,3,2,1,3,-1,4,3,-4,5,1,-1,2,1,0,-8,18,0,-2,2,2,0,1,-1,1,1,-1,3,-1
KR_6601409203,420,-2,-32,9,-2,2,0,2,4,1,5,-5,6,1,0,3,3,-3,3,0,0,0,5,2,-6,4,-1,0,-1,1,-1,-1,-1,6,-1
KR_6641998053,420,1,-59,10,2,2,0,2,0,2,2,1,1,2,1,1,2,-2,2,0,0,-1,8,-1,-1,2,0,0,0,1,-1,0,-1,6,-1
KR_6722145562,420,-4,5,-28,-13,-3,3,0,1,1,2,-2,3,1,-7,7,0,-2,2,0,0,-7,193,0,-4,4,4,0,-1,-1,-1,-1,-1,2,-1
KR_6758251982,420,2,3,12,-1,-1,3,2,1,0,1,-2,2,0,2,1,3,-1,1,0,0,2,-3,-2,-2,4,-1,0,1,-1,0,1,-1,2,-1
KR_6752632536,420,1,2,-9,-3,-7,8,1,1,2,3,1,1,2,1,6,7,1,1,2,0,0,0,-1,-5,6,-9,0,-2,-1,1,-1,1,4,-1
KR_6034295494,420,-4,-2,36,-9,-3,4,1,-5,8,3,0,2,2,0,2,2,-1,1,0,0,-18,15,0,-3,3,0,0,-1,-1,1,1,1,5,-1
KR_6757907518,440,-2,12,-16,3,5,2,7,0,2,2,4,0,4,-5,5,0,-1,1,0,1,-4,-4,2,-2,0,-1,0,2,0,0,1,1,0,-1
KR_6707569442,420,1,-51,-13,3,-1,1,0,3,0,3,3,1,4,0,3,3,-2,3,1,0,7,-14,3,-4,1,1,0,0,-1,1,0,-1,6,-1
KR_6606272592,420,2,93,38,-3,1,0,1,3,1,4,0,2,2,-5,7,2,-2,2,0,0,-10,29,-1,-7,8,-19,0,-1,1,1,-1,-1,1,-1
KR_6736400838,420,-3,-51,13,-8,1,2,3,-8,10,2,-1,2,1,0,1,1,0,3,3,1,-14,-9,-4,-2,6,0,0,-1,1,-1,-1,1,4,-1
KR_6725237880,440,-2,-75,-18,-8,-1,2,1,3,2,5,-6,6,0,-5,6,1,1,0,1,0,-5,-285,-2,-2,4,-1,0,0,1,1,-1,-1,4,-1
KR_5665497401,420,-4,-33,-7,-14,-4,4,0,-6,6,0,-4,7,3,-1,2,1,1,1,2,0,-15,-1,-2,-4,6,-5,0,-2,-1,-1,-1,1,2,-1
KR_6725754472,420,-6,12,20,-13,-3,4,1,-4,5,1,-5,7,2,-1,2,1,0,1,1,0,-8,-5,-3,-3,6,-1,0,-3,-1,-1,-1,-1,3,-1
KR_6726002964,420,-2,-80,16,-2,1,1,2,0,2,2,-2,6,4,-1,2,1,0,2,2,0,-1,3,-4,-1,5,-2,0,-2,-1,-1,-1,1,5,-1
KR_6743130646,420,-2,-8,-36,-1,-2,4,2,1,1,2,0,5,5,0,3,3,0,2,2,-1,-2,-1,1,-2,1,0,0,1,0,0,1,-1,0,-1
KR_6745024579,420,-2,-63,-20,-8,1,1,2,-3,6,3,-2,3,1,-5,8,3,1,1,2,0,1,123,2,-4,2,-2,0,-1,1,0,-1,-1,3,-1
KR_6673182129,420,0,-22,-16,-4,-2,4,2,-2,4,2,-2,2,0,1,1,2,1,1,2,0,-10,-7,-3,-3,6,6,0,0,1,-1,-1,1,4,-1
KR_6694657933,420,-4,-78,-24,-14,-2,5,3,1,2,3,-4,4,0,-4,5,1,-5,5,0,0,2,-3,3,-5,2,-1,0,-3,-1,0,-1,-1,5,-1
KR_6627714887,420,-2,-34,-46,0,-3,3,0,0,3,3,0,3,3,6,1,7,-3,4,1,0,-4,-3,-5,-4,9,0,0,-2,1,-1,-1,1,6,-1
KR_6649104254,420,-1,-87,8,-5,1,2,3,-3,4,1,-2,3,1,-1,3,2,0,0,0,0,-2,-4,-4,0,4,1,0,-3,-1,-1,-1,-1,3,-1
KR_6758845758,420,-2,-26,-20,-2,-4,6,2,-2,3,1,3,2,5,3,1,4,-2,3,1,-1,-2,10,2,-4,2,-1,0,-1,0,0,-1,-1,0,-1
KR_6700004033,420,-3,45,-23,-5,0,6,6,-5,7,2,1,3,4,1,0,1,-2,2,0,0,-8,2,-2,-1,3,2,0,0,-1,1,0,1,1,-1
KR_6699728218,420,1,8,-39,5,6,2,8,0,1,1,3,0,3,-3,3,0,-1,1,0,0,2,-8,-5,-1,6,1,0,0,1,0,-1,1,6,-1
KR_6729496175,420,2,38,32,6,5,2,7,0,1,1,-1,4,3,0,3,3,2,1,3,0,0,-28,0,-4,4,2,0,1,-1,1,1,1,6,-1
KR_6628087657,420,3,22,19,2,-3,4,1,3,1,4,1,1,2,3,0,3,-2,5,3,1,2,15,2,-4,2,-2,0,0,0,0,0,1,0,-1
KR_6719147086,420,-2,-41,2,-3,-2,2,0,1,3,4,-1,5,4,0,2,2,-1,1,0,0,-1,-5,-1,-1,2,1,0,-2,1,-1,-1,-1,6,-1
KR_6759003775,440,1,-39,23,0,2,1,3,8,0,8,1,0,1,-10,12,2,-1,4,3,-2,-7,-11,-6,-2,8,1,0,-2,-1,-1,-1,-1,2,-1
KR_6751054998,420,-4,-21,-38,-6,0,2,2,-2,2,0,-3,3,0,-1,3,2,0,0,0,0,0,-5,1,-2,1,-1,0,-1,1,1,-1,1,5,-1
KR_6758200131,420,-3,10,8,-6,-2,5,3,0,1,1,-3,5,2,0,1,1,-1,1,0,0,-1,-21,2,-4,2,-1,0,0,1,-1,0,-1,5,-1
KR_6749730507,420,-1,-14,24,-2,-3,3,0,0,2,2,-1,5,4,2,0,2,0,0,0,0,6,0,1,-3,2,-1,0,-1,-1,-1,-1,-1,2,-1
KR_6646100036,420,-1,-63,-20,-4,-1,4,3,1,1,2,0,0,0,-2,2,0,-2,2,0,0,-3,-111,-2,-1,3,2,0,-1,-1,1,-1,-1,2,-1
KR_6763594363,440,-5,30,-28,-6,3,2,5,0,0,0,-1,1,0,-7,8,1,-1,1,0,0,-2,-10,0,-5,5,0,0,0,-1,-1,0,1,1,-1
KR_6694989245,420,-1,21,-8,-4,1,0,1,-2,4,2,-6,7,1,3,0,3,0,2,2,0,-11,1,-3,-1,4,3,0,0,1,1,0,1,3,-1
KR_6693205616,420,-2,44,-59,-3,2,1,3,-1,1,0,-5,6,1,0,1,1,1,0,1,0,-1,2,-6,-2,8,-2,0,1,1,-1,1,-1,1,-1
KR_6692602705,420,-4,15,-18,-9,1,2,3,1,0,1,-5,8,3,-2,5,3,-4,5,1,0,0,10,0,-6,6,2,0,0,-1,0,0,-1,4,-1
KR_6758060844,420,-2,-40,-4,-6,3,0,3,-6,9,3,1,4,5,-1,4,3,-3,3,0,2,1,4,0,-5,5,3,0,-1,-1,0,-1,1,6,-1
KR_6758308821,440,-2,21,-13,-2,2,1,3,1,1,2,0,0,0,-3,5,2,-2,3,1,0,-7,-2,-1,0,1,-2,0,-1,-1,-1,-1,1,4,-1
KR_6640440275,420,-2,-28,16,-7,1,2,3,-2,2,0,-5,8,3,1,3,4,-2,4,2,0,-6,-247,0,-1,1,-1,0,-1,-1,1,-1,-1,1,-1
KR_6762635774,420,0,34,20,1,0,3,3,0,0,0,0,1,1,1,1,2,0,0,0,0,-1,4,0,-3,3,2,0,0,0,-1,0,1,0,-1
KR_6629359277,420,-3,-14,-8,-10,-2,2,0,-5,7,2,-2,2,0,-2,4,2,1,1,2,0,-5,-19,-3,-2,5,3,0,-2,1,-1,-1,1,3,-1
KR_6727355619,420,-2,-31,-17,-3,2,2,4,-10,15,5,2,2,4,5,4,9,-2,2,0,-2,-12,-13,-1,-3,4,1,0,-2,1,-1,-1,-1,6,-1
KR_6661360114,420,-5,7,-12,-25,-10,10,0,-1,1,0,-5,7,2,-8,9,1,-1,2,1,-1,-17,3,-2,0,2,1,0,-1,1,-1,-1,-1,6,-1
KR_6638551675,420,-1,68,-8,-4,4,1,5,-3,4,1,2,1,3,-5,6,1,-2,2,0,0,-12,319,-2,-2,4,0,0,0,1,1,1,1,4,-1
KR_6707198743,420,-6,-117,-4,-6,-4,4,0,-2,5,3,3,1,4,-1,1,0,-2,4,2,0,-10,-4,-1,-3,4,-3,0,-1,1,-1,-1,-1,6,-1
KR_6759662808,440,-3,-24,-5,-16,0,0,0,-2,4,2,-3,4,1,-9,11,2,-2,4,2,0,-20,-17,-5,-2,7,-1,0,-2,-1,1,-1,-1,1,-1
KR_6747138847,440,0,44,-4,0,1,0,1,0,6,6,-4,5,1,3,0,3,0,0,0,0,2,0,-1,-2,3,3,0,2,1,-1,1,1,1,-1
KR_6762617485,420,-1,19,2,5,0,5,5,1,0,1,-3,8,5,7,0,7,0,0,0,4,22,8,3,-5,2,-5,0,-2,1,0,-1,1,1,-1
KR_6632977827,420,-1,-44,16,-2,-4,6,2,-2,2,0,6,0,6,-1,2,1,-1,1,0,0,-3,11,-1,-3,4,-3,0,-1,1,-1,-1,1,5,-1
KR_5825434893,420,1,-77,-20,7,0,2,2,0,2,2,2,2,4,0,1,1,5,1,6,0,8,0,-3,-2,5,-4,0,-1,-1,-1,-1,1,2,-1
KR_6763196675,420,-6,-74,-10,-18,-4,4,0,-2,4,2,-6,6,0,-6,7,1,0,1,1,0,-12,11,-4,-2,6,-11,0,0,1,1,-1,-1,3,-1
KR_6725637083,420,-7,-108,18,-16,0,2,2,-1,3,2,-2,4,2,-12,15,3,-1,1,0,0,-12,-7,-2,-4,6,-2,0,-2,1,-1,-1,-1,6,-1
KR_6662951918,420,3,6,24,9,0,0,0,7,4,11,-2,4,2,5,0,5,-1,1,0,0,5,-1,-1,-3,4,3,0,-1,1,1,-1,1,3,-1
KR_6717072544,420,-1,16,8,-2,4,0,4,-3,6,3,-1,1,0,-1,3,2,-1,1,0,0,-11,2,2,-3,1,0,0,0,-1,0,1,1,4,-1
KR_6763337779,420,1,-24,-24,2,1,3,4,-2,4,2,0,0,0,1,2,3,2,1,3,0,4,6,-1,-5,6,3,0,-1,0,-1,-1,-1,0,-1
KR_6727495706,420,-2,-62,-28,-6,-6,6,0,3,3,6,-1,3,2,-2,4,2,0,1,1,0,3,19,7,-9,2,-1,0,-1,1,-1,-1,-1,1,-1
KR_6612330386,420,1,-19,52,1,-3,3,0,-2,3,1,6,3,9,2,4,6,-2,2,0,-3,-3,5,-2,-2,4,1,0,1,-1,0,1,-1,4,-1
KR_6764634315,420,1,-21,-4,-2,-7,9,2,2,0,2,0,1,1,3,2,5,0,1,1,0,1,-9,-4,-2,6,-1,0,-2,-1,-1,-1,-1,3,-1
KR_6714259132,420,-4,-34,-21,-8,0,0,0,-2,5,3,-2,3,1,-3,5,2,-1,2,1,0,-8,-6,-3,-1,4,0,0,-1,-1,-1,-1,-1,5,-1
KR_6652540243,420,-1,-2,-17,-4,-5,6,1,0,5,5,-3,4,1,1,4,5,3,0,3,0,-1,-1,-2,-6,8,1,0,0,-1,0,0,-1,4,-1
KR_6762059728,420,-1,-13,-12,-1,1,3,4,0,2,2,1,2,3,-6,6,0,3,1,4,0,-1,-305,0,-3,3,1,0,0,-1,-1,0,1,2,-1
KR_6683422790,420,-4,-56,8,-9,-2,2,0,-4,7,3,-5,6,1,1,3,4,1,0,1,-1,-6,0,1,-5,4,0,0,-2,-1,-1,-1,-1,1,-1
KR_6750676556,420,-1,-44,30,-1,-3,4,1,4,0,4,0,1,1,-2,4,2,0,2,2,0,-1,6,3,-3,0,-7,0,1,-1,-1,1,1,1,-1
KR_6763915638,420,-3,-86,-44,-13,-3,5,2,-4,4,0,-6,7,1,1,0,1,-1,1,0,0,0,-3,-3,0,3,-2,0,-2,-1,1,-1,-1,6,-1
KR_6666197586,440,-8,-32,-24,-16,-5,6,1,-3,4,1,2,0,2,-8,8,0,-2,2,0,0,-13,106,-3,-2,5,-4,0,-3,-1,-1,-1,-1,5,-1
KR_6714987146,420,2,-38,-4,8,-1,1,0,2,1,3,1,4,5,6,0,6,0,1,1,1,16,7,1,-2,1,1,0,0,-1,-1,1,1,5,-1
KR_6743142108,420,-1,36,13,-2,4,0,4,-1,2,1,-2,6,4,1,2,3,-4,4,0,0,-11,13,3,-3,0,-4,0,1,-1,1,1,1,1,-1
KR_6758378852,440,-3,-84,-3,-11,0,2,2,-1,5,4,1,1,2,-7,9,2,-4,4,0,0,-16,-58,-3,-1,4,-3,0,-3,-1,-1,-1,1,3,-1
KR_5701686769,420,-1,-36,16,-4,-3,3,0,-3,4,1,-1,2,1,1,3,4,2,0,2,0,-5,-5,2,-3,1,0,0,0,1,1,0,-1,1,-1
KR_6744677169,420,-6,-66,-56,-9,-1,3,2,-3,4,1,2,2,4,-5,7,2,-2,2,0,0,-7,17,5,-7,2,3,0,-3,-1,-1,-1,1,3,-1
KR_6764474356,420,0,57,-32,-2,0,1,1,-2,3,1,-2,5,3,1,2,3,1,1,2,0,-3,-2,-2,-1,3,-1,0,1,-1,-1,1,1,1,-1
KR_5675070076,420,-1,38,31,-3,-2,3,1,-1,2,1,0,3,3,1,3,4,-1,4,3,0,-10,-1,2,-5,3,3,0,1,0,1,1,-1,0,-1
KR_6714205377,420,-3,-29,-4,-9,3,0,3,-1,4,3,-3,4,1,-8,8,0,0,1,1,0,-15,15,0,-3,3,-2,0,0,-1,1,1,-1,2,-1
KR_6733494073,420,-1,13,-21,-4,2,0,2,-4,5,1,-2,4,2,1,1,2,-1,2,1,-1,-8,-20,2,-4,2,-6,0,0,-1,-1,0,-1,1,-1
KR_6389249455,420,-5,-51,-48,-6,-3,3,0,0,3,3,0,2,2,-2,3,1,-1,1,0,0,-3,-72,-5,-1,6,21,0,-1,-1,-1,-1,-1,5,-1
KR_6743632841,440,0,27,11,2,1,2,3,1,2,3,2,2,4,-4,5,1,2,0,2,0,5,3,0,-4,4,-2,0,0,1,-1,0,1,4,-1
KR_6695800213,420,-1,56,0,-7,1,0,1,1,1,2,-6,7,1,0,1,1,-3,4,1,0,-2,-230,-1,0,1,-3,0,0,0,0,0,-1,0,-1
KR_6758717005,440,-9,-129,-32,-22,-5,5,0,0,2,2,-13,14,1,-3,5,2,-1,3,2,-1,-12,-43,0,-2,2,7,0,-2,0,0,-1,-1,0,-1
KR_6695620104,420,-1,-4,-12,-6,-2,3,1,0,1,1,-3,6,3,-2,3,1,1,0,1,0,-7,2,-1,-5,6,6,0,0,1,1,0,1,6,-1
KR_6754049503,420,1,36,4,4,2,1,3,5,1,6,-2,2,0,-1,2,1,0,0,0,0,2,-5,2,-5,3,-4,0,0,0,0,0,1,0,-1
KR_6756416357,420,3,-42,20,5,-2,3,1,8,0,8,-3,3,0,1,1,2,1,0,1,1,11,2,7,-9,2,-4,0,1,1,1,1,1,4,-1
KR_6622387262,420,2,-40,20,7,2,2,4,2,4,6,3,0,3,-1,2,1,1,0,1,0,4,-295,1,-3,2,0,0,0,0,1,0,-1,0,-1
KR_6680259720,420,0,-29,4,0,3,4,7,0,3,3,6,1,7,-6,7,1,-3,3,0,-2,-3,24,-1,-5,6,2,0,1,-1,-1,-1,-1,2,-1
KR_6751767649,420,-2,-12,8,2,-1,1,0,1,1,2,2,2,4,0,2,2,0,4,4,0,5,-32,3,-4,1,12,0,0,1,1,-1,1,2,-1
KR_6700451494,420,-1,21,-24,-3,-2,3,1,0,0,0,4,3,7,0,3,3,-5,5,0,0,1,63,4,-7,3,4,0,1,1,1,1,-1,3,-1
KR_6722288661,420,0,12,32,-3,-4,4,0,1,1,2,1,3,4,0,3,3,-1,2,1,-1,-5,4,-1,-3,4,3,0,0,-1,0,0,-1,1,-1
KR_6719079310,420,1,65,4,-5,1,0,1,0,3,3,-3,4,1,-1,3,2,-2,2,0,0,-2,27,3,-4,1,-26,0,0,-1,1,0,-1,5,-1
KR_6698441165,420,4,67,-12,8,1,2,3,5,0,5,2,0,2,-1,2,1,1,0,1,0,5,9,-1,-3,4,-1,0,3,1,1,1,1,6,-1
KR_6745005772,420,-2,-53,11,0,-3,4,1,1,4,5,0,2,2,3,1,4,-1,2,1,0,5,-211,-1,-3,4,1,0,-1,-1,-1,-1,1,5,-1
KR_6723427876,420,-6,-57,-20,-13,0,1,1,-2,2,0,-5,7,2,-1,2,1,-5,6,1,0,-6,-8,2,-2,0,1,0,-1,-1,0,-1,-1,2,-1
KR_6490445098,420,-3,5,-4,-8,0,1,1,-4,5,1,0,3,3,-1,2,1,-3,3,0,0,-10,-326,1,-2,1,-2,0,-1,-1,1,-1,1,4,-1
KR_6630661005,420,-2,-77,-7,1,-1,1,0,5,0,5,-2,2,0,0,1,1,-1,1,0,0,-2,-115,2,-4,2,2,0,0,-1,-1,0,1,6,-1
KR_6683409987,420,-2,-43,-10,-2,-1,2,1,-1,4,3,4,2,6,-1,5,4,-3,3,0,-1,9,-4,-2,-4,6,0,0,0,1,-1,-1,-1,1,-1
KR_6699014490,420,0,-21,20,3,1,2,3,-1,3,2,0,4,4,1,2,3,2,0,2,0,1,-1,-4,-1,5,1,0,-2,-1,1,-1,-1,2,-1
KR_6753810799,420,-3,-76,-28,-12,-6,7,1,-2,4,2,-6,6,0,3,1,4,-1,1,0,0,1,-7,1,-3,2,-1,0,-2,1,-1,-1,-1,5,-1
KR_6760952002,420,-3,-18,-3,-7,-2,3,1,1,3,4,-3,6,3,-3,4,1,0,1,1,0,2,15,6,-9,3,1,0,1,1,0,1,1,5,-1
KR_6738520951,420,1,-24,0,1,1,1,2,-2,2,0,-2,5,3,3,2,5,1,1,2,0,0,-2,2,-6,4,0,0,0,0,-1,0,-1,0,-1
KR_6761060709,440,-4,-67,-16,-5,2,3,5,5,1,6,1,1,2,-10,10,0,-3,4,1,0,-4,-17,-1,0,1,2,0,-1,-1,-1,-1,1,6,-1
KR_6633568377,420,-4,-2,-3,-6,3,4,7,-4,5,1,-2,3,1,-2,4,2,-1,2,1,1,-11,9,2,-5,3,-2,0,0,-1,-1,-1,1,5,-1
KR_6652193099,420,-1,-9,15,-7,3,2,5,-2,2,0,-3,6,3,-2,2,0,-3,3,0,1,-18,-7,3,-4,1,3,0,0,-1,1,-1,1,6,-1
KR_6656267357,420,-4,-76,-48,-7,0,3,3,-3,5,2,-4,5,1,-1,6,5,1,1,2,0,0,2,-2,-2,4,-1,0,0,-1,0,0,-1,1,-1
KR_6752041747,420,1,77,52,2,0,1,1,-6,6,0,1,2,3,6,3,9,1,2,3,1,2,0,4,-4,0,-2,0,1,1,1,1,1,5,-1
KR_6691525890,420,0,4,-60,1,4,0,4,-2,3,1,-4,6,2,1,0,1,2,0,2,0,1,15,2,-5,3,-2,0,2,0,1,1,1,0,-1
KR_6759475308,420,-1,33,-35,-7,2,3,5,-4,6,2,-2,6,4,-5,6,1,2,0,2,0,-8,22,1,-5,4,2,0,0,-1,-1,-1,-1,1,-1
KR_6758128756,420,0,0,8,3,4,1,5,-2,3,1,3,1,4,-2,4,2,0,2,2,0,2,115,-3,-2,5,-1,0,0,-1,0,0,-1,6,-1
KR_6756388655,420,-3,-86,2,-4,1,0,1,2,1,3,-2,3,1,-3,3,0,-2,2,0,0,1,-9,-4,-1,5,-1,0,-1,-1,-1,-1,-1,1,-1
KR_6711821986,420,1,-6,-5,5,4,0,4,0,1,1,5,0,5,-5,6,1,1,1,2,0,-1,-148,-3,-3,6,-1,0,1,0,1,1,-1,0,-1
KR_6651349588,420,-2,-58,-4,-10,-4,4,0,-3,4,1,-1,3,2,-3,9,6,1,0,1,0,-13,-388,0,-4,4,-2,0,-3,-1,-1,-1,-1,4,-1
KR_6744224886,420,2,23,8,1,-5,5,0,-1,3,2,3,1,4,4,0,4,0,2,2,0,2,-4,-4,-2,6,3,0,-1,0,-1,1,1,0,-1
KR_6731938815,420,0,-45,-16,4,0,4,4,2,3,5,4,0,4,-2,3,1,0,3,3,0,4,-20,6,-7,1,2,0,0,1,1,-1,-1,6,-1
KR_6757092886,440,1,-104,4,4,-2,2,0,1,2,3,4,2,6,0,3,3,1,0,1,0,0,44,1,-2,1,-1,0,0,-1,1,0,-1,3,-1
KR_6761205003,420,0,31,36,-3,-1,4,3,-2,3,1,1,2,3,-1,3,2,0,1,1,0,-6,2,-2,-1,3,-3,0,0,1,1,-1,1,3,-1
KR_6678699625,420,-3,-22,-26,-6,0,1,1,-3,4,1,-3,3,0,-1,3,2,1,0,1,0,-7,4,-2,-2,4,-3,0,-1,1,-1,-1,-1,1,-1
KR_6741495583,420,-2,-50,0,-6,-1,1,0,-1,5,4,-3,4,1,0,2,2,-1,4,3,0,-4,-7,-2,-1,3,0,0,-1,-1,1,-1,-1,1,-1
KR_6588104429,420,1,-53,-12,-1,-5,7,2,3,1,4,-1,4,3,2,2,4,0,0,0,1,11,8,-4,-1,5,3,0,-3,-1,-1,-1,1,6,-1
KR_6742750777,440,-3,-104,-14,-5,-1,3,2,-2,3,1,-3,4,1,0,3,3,1,0,1,0,-7,17,-3,0,3,2,0,0,-1,-1,-1,1,6,-1
KR_6729672895,440,-2,-4,14,-1,0,3,3,2,3,5,0,3,3,-6,8,2,3,1,4,2,-3,-11,1,-3,2,2,0,-1,-1,-1,-1,1,3,-1
KR_6714944436,420,-1,-2,-39,5,6,1,7,2,2,4,-7,9,2,3,1,4,1,0,1,1,6,-6,2,-4,2,1,0,-2,-1,-1,-1,1,2,-1
KR_6706762190,420,-4,-37,-29,-15,3,0,3,0,2,2,-1,5,4,-15,17,2,-2,2,0,0,-14,-6,-3,-5,8,-1,0,-1,-1,1,-1,-1,3,-1
KR_6760947957,420,-3,-10,-21,1,-2,3,1,-1,1,0,1,3,4,3,1,4,0,2,2,0,6,-46,2,-7,5,-2,0,-1,-1,1,-1,1,4,-1
KR_6527489151,420,-5,-106,23,-16,-3,3,0,0,1,1,-4,6,2,-5,5,0,-4,4,0,0,-15,51,-2,-4,6,-4,0,0,-1,1,-1,-1,3,-1
KR_6764112258,420,-1,-22,-24,-4,1,2,3,2,2,4,-1,2,1,-6,6,0,0,0,0,0,-5,10,-4,-4,8,0,0,-1,1,-1,-1,-1,6,-1
KR_6656598510,440,-2,-11,-24,-6,3,0,3,-6,6,0,-1,5,4,0,4,4,-2,4,2,0,-3,-1,-2,-1,3,0,0,0,-1,-1,-1,1,5,-1
KR_6648457980,420,-1,80,-18,1,0,1,1,-5,7,2,4,0,4,2,0,2,0,1,1,0,-4,-15,0,-5,5,3,0,0,0,-1,0,1,0,-1
KR_6759477851,420,-4,-81,0,-3,-4,5,1,0,2,2,-1,2,1,2,0,2,0,3,3,0,5,-9,2,-3,1,3,0,-1,1,-1,-1,1,4,-1
KR_6704809369,420,1,42,-12,-8,3,1,4,-1,2,1,5,1,6,-6,7,1,-9,10,1,-1,-12,37,-1,-2,3,-20,0,0,-1,1,-1,-1,3,-1
KR_6670700265,420,-3,-25,13,0,2,1,3,-5,8,3,1,0,1,-1,3,2,3,0,3,1,1,8,3,-8,5,-6,0,-2,1,-1,-1,1,5,-1
KR_6763901166,420,-4,-25,25,-16,-4,5,1,4,0,4,-5,6,1,-8,10,2,-3,4,1,0,-15,20,-2,-2,4,-4,0,-1,0,-1,-1,1,0,-1
KR_6727351544,420,1,7,14,-2,4,1,5,-3,4,1,-1,1,0,-2,6,4,0,2,2,-1,-8,2,-2,-3,5,-2,0,0,1,0,0,-1,4,-1
KR_6700725396,420,-4,-87,-10,-9,-5,5,0,-2,3,1,-2,2,0,-1,1,0,1,2,3,0,-9,4,-1,-2,3,-1,0,-1,1,-1,-1,-1,4,-1
KR_6706969319,420,-4,-20,-13,-18,-5,6,1,-1,3,2,-1,3,2,-6,7,1,-5,6,1,0,-20,353,2,-3,1,-27,0,-3,1,-1,-1,1,2,-1
KR_6647181401,420,-4,-79,-37,-4,1,2,3,1,0,1,-3,4,1,-6,9,3,3,0,3,0,1,-6,1,-9,8,-1,0,-1,-1,-1,-1,-1,2,-1
KR_6752349521,420,0,-104,-16,-6,-2,3,1,-3,4,1,-3,4,1,0,5,5,2,2,4,0,-3,-117,-1,-1,2,0,0,0,1,0,0,-1,4,-1
KR_6736605544,420,0,-54,-12,2,2,0,2,2,1,3,-2,3,1,-1,2,1,1,0,1,1,5,2,2,-3,1,-2,0,0,-1,1,0,1,1,-1
KR_6487319023,420,-5,-20,-32,-5,-1,2,1,0,0,0,-5,6,1,1,2,3,0,1,1,0,-2,11,1,-5,4,-5,0,-2,0,1,-1,-1,0,-1
KR_6716761169,420,-3,-37,-36,-3,1,0,1,-5,5,0,-2,2,0,4,0,4,-1,1,0,0,-3,-7,-4,-2,6,6,0,-1,-1,-1,-1,1,4,-1
KR_6762074788,420,1,-15,3,-7,-4,5,1,0,3,3,-1,4,3,-3,4,1,1,2,3,0,3,4,-2,-2,4,3,0,1,1,1,1,1,3,-1
KR_6683559696,420,-6,-101,-32,-16,-9,9,0,1,2,3,-6,9,3,-1,4,3,-1,1,0,-1,0,-7,1,-2,1,-1,0,-4,-1,-1,-1,-1,1,-1
KR_6726917624,420,-9,-120,-49,-18,-5,6,1,-12,12,0,1,2,3,-1,4,3,-1,1,0,0,-7,-33,-5,-1,6,-3,0,-1,-1,-1,-1,-1,2,-1
KR_6380221952,420,-3,-44,-19,-11,3,1,4,-8,8,0,0,3,3,-3,4,1,-3,5,2,0,-13,-139,1,-8,7,-6,0,-1,1,-1,-1,1,4,-1
KR_6751237148,420,-2,10,-8,-3,3,1,4,3,2,5,-8,12,4,-1,2,1,0,1,1,0,-8,4,0,-2,2,-1,0,0,-1,1,0,-1,6,-1
KR_6738959028,420,-6,-61,-39,-8,-1,3,2,-3,4,1,-3,3,0,1,1,2,-2,3,1,0,-8,-9,-4,0,4,0,0,0,0,1,1,1,0,-1
KR_6728739015,420,-1,-3,-4,-4,-5,7,2,2,3,5,0,0,0,-2,3,1,1,0,1,0,2,-244,4,-5,1,-2,0,-1,1,0,-1,-1,3,-1
KR_6710025455,420,3,85,-2,7,2,3,5,-2,4,2,4,1,5,3,5,8,0,1,1,-2,0,2,2,-6,4,0,0,2,-1,1,1,-1,6,-1
KR_6745484068,420,-5,-98,-4,-8,-2,4,2,-6,8,2,-2,2,0,0,1,1,2,0,2,0,1,4,4,-7,3,-1,0,-3,-1,0,-1,-1,4,-1
KR_6615988753,420,-10,-46,-51,-30,-1,1,0,-22,22,0,-3,4,1,-2,2,0,-2,4,2,0,-24,-29,-5,-1,6,2,0,-4,-1,-1,-1,-1,2,-1
KR_6659727106,420,-2,-16,3,-3,1,1,2,1,4,5,2,0,2,-5,6,1,-2,3,1,0,0,-5,3,-3,0,-1,0,-2,1,-1,-1,-1,6,-1
KR_6725787446,420,0,-16,-27,4,7,0,7,-1,5,4,2,0,2,-3,4,1,-1,2,1,0,4,3,5,-7,2,2,0,2,-1,1,1,1,5,-1
KR_6763125373,420,-4,-115,-4,-8,-2,3,1,-4,6,2,0,3,3,-2,3,1,0,2,2,0,-8,258,1,-2,1,-1,0,-1,1,1,-1,-1,2,-1
KR_6730382143,420,0,-43,8,-1,3,0,3,-3,4,1,3,1,4,-4,6,2,0,1,1,-2,-5,-20,-9,0,9,-2,0,0,1,-1,-1,-1,4,-1
KR_6730313898,420,1,80,0,-3,2,1,3,-1,6,5,1,1,2,-3,3,0,-2,2,0,1,-14,44,0,-3,3,-18,0,0,-1,1,0,1,2,-1
KR_6695173733,420,2,-21,-12,0,2,0,2,-4,5,1,6,2,8,0,0,0,-4,4,0,0,-1,326,-5,-1,6,1,0,0,1,1,0,-1,4,-1
KR_6737649982,440,-1,48,-34,-3,5,1,6,2,4,6,-3,4,1,-5,7,2,-2,2,0,-1,-7,-6,-8,-1,9,3,0,1,-1,1,-1,-1,1,-1
KR_6763055297,440,-8,-55,-72,-25,-7,10,3,-4,5,1,-3,4,1,-8,10,2,-3,3,0,-3,-31,0,0,-2,2,-2,0,-2,-1,-1,-1,-1,2,-1
KR_6730912718,420,-8,-172,-28,-21,-10,10,0,-2,3,1,0,2,2,-7,9,2,-2,2,0,0,-11,-18,-7,-1,8,0,0,-3,-1,-1,-1,-1,4,-1
KR_6682537717,420,-4,-122,-1,-17,1,2,3,-6,7,1,-1,3,2,-8,8,0,-3,3,0,-1,-21,-8,0,-4,4,-3,0,-2,1,-1,-1,-1,5,-1
KR_6686617024,420,-5,-36,-33,5,3,0,3,3,1,4,-5,5,0,2,0,2,2,0,2,0,3,-6,-3,-2,5,-2,0,-1,-1,-1,-1,-1,1,-1
KR_6763865545,420,0,-59,36,-4,-1,2,1,-1,1,0,4,3,7,-5,5,0,-1,2,1,-1,-6,43,4,-5,1,0,0,-2,-1,1,-1,-1,1,-1
KR_6641060034,420,-5,-117,-20,-6,-1,2,1,0,1,1,-2,2,0,-3,4,1,0,1,1,0,-1,-6,-7,-1,8,1,0,0,-1,-1,0,-1,3,-1
KR_6670943129,420,-9,-121,-14,-16,-4,5,1,0,4,4,-6,7,1,-5,7,2,-1,1,0,0,-10,-2,1,-3,2,1,0,-2,-1,-1,-1,-1,3,-1
KR_6609834478,420,-2,-28,-8,-2,-3,5,2,-1,1,0,-4,4,0,6,1,7,0,0,0,0,7,-3,4,-9,5,1,0,-1,1,-1,-1,-1,3,-1
KR_6762238065,420,-1,-50,-4,-2,-5,6,1,1,0,1,2,2,4,-2,2,0,2,0,2,0,5,3,0,-2,2,2,0,0,0,-1,-1,1,0,-1
KR_6648635341,420,-3,4,7,-2,4,1,5,-2,4,2,-2,5,3,-2,6,4,0,2,2,0,-8,-33,0,-3,3,-1,0,1,1,1,1,1,1,-1
KR_6758218919,420,0,-94,-21,2,-1,2,1,2,1,3,0,4,4,0,4,4,1,1,2,0,1,-5,-3,0,3,0,0,0,-1,1,-1,1,2,-1
KR_6659767468,420,0,58,-36,-9,2,1,3,-5,6,1,-6,7,1,0,3,3,0,1,1,0,-9,-2,-2,-3,5,0,0,-2,-1,-1,-1,-1,1,-1
KR_6750776451,440,0,-11,0,-7,0,1,1,-4,5,1,-1,3,2,0,4,4,-2,2,0,-1,-8,-1,-1,-1,2,-1,0,-1,0,1,-1,-1,0,-1
KR_6290017204,420,1,34,8,0,2,2,4,-1,1,0,-3,5,2,1,6,7,1,0,1,0,5,-177,-1,-4,5,-5,0,0,-1,0,-1,1,4,-1
KR_6759797396,420,3,72,4,7,5,0,5,1,2,3,1,4,5,1,3,4,-1,1,0,2,8,-8,-5,-2,7,2,0,0,-1,0,0,1,6,-1
KR_6627381209,420,-3,3,17,-9,-5,7,2,-1,3,2,-2,3,1,1,3,4,-2,4,2,0,-17,-24,0,-4,4,0,0,-2,1,-1,-1,1,4,-1
KR_6561207112,420,-1,35,-68,0,-2,2,0,-2,3,1,2,2,4,3,1,4,-1,4,3,0,-3,7,0,-4,4,0,0,0,-1,-1,1,1,2,-1
KR_6756808744,420,-6,-42,-43,-13,-5,5,0,-7,9,2,-3,4,1,1,1,2,1,0,1,0,-5,-21,-5,0,5,2,0,0,-1,0,1,1,6,-1
KR_6760438475,420,0,-68,-12,-1,-4,6,2,0,2,2,-2,4,2,6,0,6,-1,2,1,0,7,3,1,-3,2,-5,0,0,0,1,1,1,0,-1
KR_6658366955,440,-1,-34,-9,-7,-2,3,1,2,1,3,1,3,4,-2,2,0,-6,7,1,0,-13,-8,-1,-2,3,-4,0,0,0,0,0,1,0,-1
KR_6757888330,420,2,20,-19,3,4,0,4,0,1,1,-1,2,1,-1,4,3,1,0,1,-1,-9,8,3,-7,4,0,0,1,-1,1,1,-1,1,-1
KR_6760359557,440,-6,-65,-28,-6,-3,5,2,1,0,1,-2,4,2,-1,3,2,-1,1,0,0,-6,-105,1,-6,5,-5,0,0,-1,0,0,-1,5,-1
KR_6760238961,420,-1,-47,-4,-2,-2,2,0,1,2,3,0,2,2,-2,3,1,1,0,1,0,5,12,0,-3,3,-3,0,-1,-1,1,-1,1,3,-1
KR_6627828869,420,1,54,-20,-6,2,2,4,-1,3,2,-7,7,0,-1,1,0,1,3,4,0,-8,276,-1,-2,3,-1,0,-1,-1,-1,-1,1,3,-1
KR_6663191927,420,0,52,-12,3,3,0,3,-2,3,1,-4,5,1,1,1,2,5,0,5,1,8,-3,-5,-1,6,0,0,0,1,1,-1,1,5,-1
KR_6685946880,420,-2,-17,-8,-7,1,2,3,-6,6,0,-1,2,1,-1,1,0,0,0,0,0,-8,-3,1,-4,3,-4,0,-1,1,-1,-1,-1,6,-1
KR_6638151232,420,-4,-87,-35,-10,-1,2,1,1,2,3,-6,8,2,-5,9,4,1,0,1,-1,-21,9,2,-4,2,-2,0,-1,-1,1,-1,-1,5,-1
KR_6685351794,420,2,19,-24,7,4,1,5,3,2,5,0,3,3,1,3,4,-1,1,0,1,2,-8,2,-3,1,-1,0,1,-1,1,1,1,5,-1
KR_6737896466,420,0,34,-16,-4,2,1,3,-3,4,1,-1,3,2,-1,4,3,-1,2,1,0,-3,-2,2,-4,2,1,0,0,-1,1,0,-1,5,-1
KR_6195886626,420,-1,52,-21,-1,0,3,3,-1,5,4,-4,4,0,5,0,5,-1,2,1,-1,-3,0,1,-5,4,4,0,1,-1,-1,1,-1,1,-1
KR_6751860448,420,-2,-31,-16,-9,-4,4,0,-5,6,1,3,1,4,-5,6,1,2,0,2,0,-12,-38,-4,-2,6,-1,0,-1,-1,1,-1,-1,1,-1
KR_6705590716,420,-1,28,-16,-6,0,3,3,-3,4,1,1,1,2,-2,2,0,-2,2,0,0,-8,-20,1,-6,5,1,0,1,1,-1,1,1,6,-1
KR_6739215143,440,-1,42,16,-8,-1,1,0,0,2,2,-7,7,0,-4,4,0,4,0,4,0,-15,-3,2,-3,1,1,0,0,1,-1,0,-1,2,-1
KR_6755720007,420,-2,-34,12,-1,0,1,1,-2,2,0,0,3,3,4,1,5,-3,5,2,1,3,26,-1,-1,2,-36,0,-1,-1,-1,-1,1,6,-1
KR_6380370631,420,-1,-35,8,-1,-1,3,2,-1,3,2,-4,4,0,5,1,6,0,1,1,0,0,12,2,-4,2,0,0,0,1,1,1,1,5,-1
KR_6683383492,420,4,84,4,3,-3,3,0,0,2,2,3,3,6,4,2,6,-1,2,1,0,6,11,1,-2,1,-2,0,1,1,1,1,-1,4,-1
KR_6743051724,420,-3,-70,7,-7,-4,4,0,-4,6,2,2,2,4,-1,2,1,0,0,0,0,-2,1,0,-6,6,1,0,-1,-1,1,-1,-1,4,-1
KR_6512128822,420,-2,-18,-2,2,0,4,4,-1,3,2,1,1,2,1,1,2,1,0,1,0,3,-2,1,-4,3,0,0,-2,1,1,-1,-1,1,-1
KR_6725571789,420,-1,20,-8,-6,1,0,1,-1,2,1,-4,5,1,-1,3,2,-1,1,0,0,-4,-1,2,-5,3,1,0,-1,-1,1,-1,-1,5,-1
KR_6726592618,440,2,-40,8,-2,0,1,1,-2,4,2,-2,4,2,2,1,3,0,1,1,0,-3,2,-3,-2,5,0,0,0,-1,1,0,-1,5,-1
KR_6659826320,420,-2,29,-23,-10,-1,3,2,1,0,1,3,1,4,-13,13,0,0,0,0,0,-15,3,0,-4,4,1,0,2,1,1,1,-1,4,-1
KR_6724161183,420,-2,-62,-16,-3,-2,2,0,-4,5,1,2,2,4,-1,3,2,2,0,2,0,-3,-20,-1,-3,4,5,0,0,1,-1,-1,-1,6,-1
KR_6724997573,420,-2,-20,8,2,-1,4,3,2,1,3,2,5,7,0,2,2,-1,1,0,0,4,0,-1,-1,2,2,0,0,1,1,1,1,3,-1
KR_6751399062,420,1,-4,13,1,0,1,1,1,1,2,-2,3,1,0,4,4,2,0,2,0,8,-6,-2,-6,8,1,0,-1,-1,-1,-1,1,2,-1
KR_6752449781,420,-2,-50,-24,-3,1,1,2,1,2,3,0,1,1,-4,5,1,-1,1,0,0,-3,4,1,-2,1,2,0,0,-1,1,0,-1,6,-1
KR_6604301995,420,-3,-59,-20,-10,-2,4,2,1,3,4,-2,5,3,-8,9,1,1,0,1,-1,-6,-10,-2,-1,3,2,0,0,1,-1,-1,-1,6,-1
KR_6586672806,420,0,-18,-1,1,-3,3,0,-1,5,4,2,1,3,1,0,1,2,0,2,1,-2,3,-2,-3,5,0,0,0,-1,0,0,1,4,-1
KR_6588613694,420,-3,-42,-24,-17,-8,9,1,-3,4,1,-2,2,0,-5,8,3,1,1,2,-1,-12,19,-5,0,5,-3,0,-3,-1,-1,-1,-1,5,-1
KR_6752025635,420,5,63,24,10,-3,3,0,4,0,4,5,2,7,2,1,3,2,0,2,0,3,39,0,-1,1,-24,0,1,-1,0,1,-1,4,-1
KR_6764446682,440,-5,42,-41,-13,-3,3,0,-3,3,0,-1,3,2,-3,6,3,-3,4,1,0,-15,5,-1,-4,5,-2,0,0,-1,1,0,-1,4,-1
KR_6748964932,440,1,63,4,4,8,0,8,-5,5,0,2,0,2,0,0,0,-1,2,1,0,0,176,0,-4,4,-1,0,1,-1,1,1,1,5,-1
KR_6741267850,420,1,-64,24,1,4,1,5,1,3,4,0,0,0,-3,5,2,-1,3,2,0,-3,2,-2,-2,4,2,0,1,-1,0,1,-1,2,-1
KR_6744583678,420,1,17,-4,-3,-1,1,0,1,3,4,-4,6,2,0,1,1,1,0,1,0,2,-16,2,-6,4,1,0,0,-1,1,0,-1,3,-1
KR_6685476432,420,-2,-33,4,-1,3,2,5,2,1,3,-1,2,1,-4,5,1,-1,1,0,1,-3,-9,-5,-1,6,-1,0,1,0,1,1,1,0,-1
KR_6632957662,440,0,7,-21,3,1,0,1,-5,7,2,-3,5,2,6,0,6,4,1,5,0,5,11,-3,-1,4,-1,0,-1,-1,1,-1,1,1,-1
KR_6716562281,420,0,36,-20,1,-1,2,1,-1,1,0,-3,3,0,5,2,7,1,0,1,0,5,24,4,-7,3,1,0,0,-1,-1,0,1,4,-1
KR_6649058536,420,-8,-57,-51,-14,-3,3,0,-6,7,1,-2,5,3,1,2,3,-4,4,0,0,-13,4,5,-6,1,0,0,-2,-1,1,-1,1,5,-1
KR_6744786975,420,-3,-91,-12,-3,-2,4,2,-4,5,1,2,0,2,-2,3,1,3,1,4,0,0,1,0,-4,4,-4,0,-1,-1,-1,-1,1,1,-1
KR_6674513621,420,-3,-5,-20,-4,1,1,2,-3,6,3,0,4,4,-1,2,1,-1,2,1,-2,-12,-5,0,-2,2,-2,0,0,0,1,0,-1,0,-1
KR_6627818647,420,0,-8,-3,0,2,0,2,1,1,2,-3,4,1,0,0,0,0,0,0,0,-4,-203,-1,-1,2,-2,0,-1,-1,-1,-1,1,3,-1
KR_6391812796,420,0,8,16,3,-1,3,2,3,2,5,-1,3,2,3,0,3,-1,1,0,0,4,22,3,-8,5,1,0,0,-1,1,0,-1,1,-1
KR_6748096477,420,-1,32,8,-5,-3,3,0,-1,2,1,-1,1,0,0,0,0,0,0,0,0,-3,20,-2,-3,5,-1,0,0,-1,0,0,-1,2,-1
KR_6725846833,420,-1,27,24,-3,2,0,2,-4,6,2,0,3,3,0,1,1,-1,1,0,0,1,301,-1,-3,4,1,0,1,1,-1,1,1,2,-1
KR_6753496591,440,-1,-88,-16,3,3,2,5,2,3,5,2,2,4,1,0,1,-5,5,0,0,-3,-55,0,-3,3,29,0,0,-1,0,0,1,4,-1
KR_6713650666,420,-2,-71,-13,-4,-1,2,1,-2,3,1,-6,7,1,3,4,7,2,0,2,0,1,-12,0,-4,4,-1,0,-1,1,-1,-1,-1,1,-1
KR_6727114662,420,3,44,16,6,3,0,3,-1,1,0,4,1,5,-1,2,1,1,0,1,0,3,24,1,-3,2,-21,0,1,-1,1,1,1,2,-1
KR_6731344141,420,-3,-145,-24,-6,0,3,3,-3,4,1,0,2,2,-1,3,2,-2,2,0,0,-8,-3,-4,-2,6,3,0,-5,-1,-1,-1,-1,5,-1
KR_6697796168,420,-1,43,0,-12,-2,2,0,-6,7,1,-6,6,0,0,2,2,2,2,4,0,-11,20,-4,-2,6,-2,0,0,-1,1,0,-1,2,-1
KR_6379005769,420,-2,-48,8,-2,2,1,3,0,1,1,-2,3,1,-4,6,2,2,0,2,0,-5,27,-2,-2,4,2,0,0,1,1,0,-1,6,-1
KR_6642934075,420,-1,-33,0,-6,4,0,4,0,2,2,-6,6,0,-3,4,1,-1,1,0,0,-6,-179,0,-2,2,-2,0,0,1,1,0,1,3,-1
KR_6446708950,420,-1,37,15,-2,0,1,1,0,1,1,2,1,3,0,4,4,-4,4,0,0,-1,5,1,-3,2,-1,0,0,-1,0,0,1,4,-1
KR_6733604299,420,-1,-41,8,-7,-3,3,0,3,3,6,-4,5,1,-7,8,1,4,0,4,0,-9,215,-2,-3,5,-6,0,0,0,-1,-1,-1,0,-1
KR_6677127300,420,-1,-85,14,-5,3,1,4,-3,3,0,2,5,7,-5,8,3,-2,2,0,0,-13,-7,-1,-3,4,-3,0,0,-1,-1,-1,-1,6,-1
KR_6674608949,420,-3,-60,-4,-6,-1,3,2,2,2,4,-4,4,0,-2,3,1,-1,1,0,0,0,-22,-3,-3,6,0,0,-2,0,-1,-1,-1,0,-1
KR_6749037730,440,-3,-17,-4,-13,-10,10,0,1,0,1,1,0,1,-5,5,0,0,2,2,0,-14,36,2,-5,3,-35,0,1,1,-1,1,-1,4,-1
KR_6610376270,420,1,-26,-8,4,0,1,1,7,0,7,-3,3,0,-3,4,1,3,0,3,0,6,43,3,-8,5,-12,0,0,-1,1,0,1,4,-1
KR_6759715949,420,-1,-18,-33,-1,5,0,5,-2,4,2,0,4,4,-3,6,3,-1,2,1,0,-10,-15,-1,-4,5,1,0,0,1,1,1,-1,4,-1
KR_6737620499,420,-5,-35,-18,-10,-4,4,0,-1,2,1,-4,4,0,2,4,6,-3,4,1,0,-6,1,0,-1,1,-2,0,-1,-1,0,-1,1,1,-1
KR_6727096330,420,-3,-82,24,-9,-3,4,1,2,0,2,-6,8,2,-2,2,0,0,0,0,0,-9,-8,4,-5,1,2,0,-1,1,1,-1,-1,2,-1
KR_6759068964,420,-1,-10,-8,-9,-1,2,1,2,3,5,-4,5,1,-4,5,1,-2,4,2,-1,-1,183,3,-5,2,5,0,0,1,0,-1,-1,6,-1
KR_6637784292,420,-2,-40,-32,1,-1,1,0,3,2,5,0,4,4,-1,2,1,0,0,0,0,0,14,2,-4,2,2,0,0,-1,1,0,1,1,-1
KR_6674911370,420,-1,-21,-13,4,0,2,2,-1,3,2,4,0,4,-1,3,2,2,0,2,0,4,1,1,-3,2,-3,0,-1,-1,1,-1,1,3,-1
KR_6739665798,420,-3,-99,-36,-7,-5,5,0,0,4,4,0,1,1,-2,5,3,0,2,2,0,-1,40,3,-5,2,-23,0,-1,0,0,-1,-1,0,-1
KR_6746191817,420,-1,-15,-28,-2,0,1,1,-3,4,1,2,2,4,-1,4,3,0,0,0,-1,-5,2,3,-5,2,-3,0,-1,-1,-1,-1,-1,4,-1
KR_6705184955,420,-1,-42,0,-2,2,1,3,5,2,7,-1,1,0,-4,5,1,-4,5,1,0,-4,-2,-3,-1,4,2,0,-2,-1,-1,-1,1,1,-1
KR_6739043077,420,-4,12,17,2,3,2,5,3,0,3,0,2,2,4,1,5,-8,10,2,2,-3,-3,2,-2,0,-2,0,-1,1,1,-1,1,2,-1
KR_6744769064,420,-7,-93,-27,-11,-6,6,0,-2,5,3,-5,5,0,1,3,4,1,0,1,-1,-13,-2,-1,-1,2,-1,0,-2,-1,-1,-1,-1,4,-1
KR_6631548251,440,-2,-1,0,-6,-1,3,2,-2,3,1,-3,3,0,-1,2,1,1,1,2,0,-4,-14,-1,0,1,-1,0,-1,1,-1,-1,1,4,-1
KR_6610171475,420,-4,-17,-10,-6,-3,3,0,-4,7,3,0,3,3,1,2,3,0,0,0,0,-1,0,-6,-4,10,-1,0,-1,-1,-1,-1,-1,6,-1
KR_6538344841,420,0,64,-20,-3,3,1,4,-5,5,0,-1,4,3,0,2,2,0,2,2,0,-7,7,0,-8,8,-1,0,0,-1,-1,0,1,2,-1
KR_6722807680,440,-5,19,-8,-5,-3,3,0,-7,8,1,-1,3,2,3,1,4,3,0,3,0,-5,73,2,-3,1,-14,0,1,-1,-1,1,-1,4,-1
KR_6633450170,440,0,-30,-32,-2,4,1,5,-1,3,2,2,2,4,-3,4,1,-4,4,0,1,-7,263,-5,-2,7,-6,0,-1,-1,-1,-1,1,1,-1
KR_6700081126,420,-4,-22,12,-1,0,1,1,0,2,2,-1,2,1,-1,2,1,1,1,2,1,-3,6,0,-4,4,2,0,0,-1,1,-1,1,3,-1
KR_6624501725,420,-3,-55,44,-2,-5,8,3,3,2,5,-4,6,2,1,5,6,3,0,3,0,-1,10,0,-2,2,1,0,-2,1,-1,-1,-1,3,-1
KR_6729033493,420,-2,29,-20,-7,2,0,2,0,1,1,-2,2,0,-8,8,0,1,0,1,0,-5,36,0,-4,4,-26,0,0,0,-1,1,-1,0,-1
KR_6388356918,420,0,-106,6,-5,-1,2,1,-6,10,4,0,4,4,3,1,4,-1,1,0,0,-5,-5,2,-7,5,4,0,-1,1,1,-1,-1,6,-1
KR_6755509392,420,-4,-41,-21,-16,-4,4,0,-3,4,1,-4,7,3,-4,4,0,-1,1,0,-2,-18,-10,-2,-1,3,2,0,-1,-1,-1,-1,-1,2,-1
KR_6753802615,420,-1,-61,11,-1,4,0,4,-2,8,6,-3,5,2,0,3,3,0,3,3,-1,1,-7,0,-3,3,3,0,-2,-1,-1,-1,-1,2,-1
KR_6741291762,440,3,79,-20,8,2,1,3,-2,3,1,-2,4,2,10,0,10,0,0,0,0,7,-6,0,-4,4,-4,0,2,1,1,1,1,6,-1
KR_6749801499,420,-3,-16,56,-13,1,1,2,-2,3,1,-1,4,3,-10,10,0,-1,2,1,0,-14,8,2,-3,1,-2,0,-1,1,0,-1,1,5,-1
KR_6761676858,440,-1,-49,0,-4,-1,2,1,1,0,1,-8,8,0,2,4,6,2,1,3,0,-7,-5,0,-5,5,-3,0,-1,0,0,-1,1,0,-1
KR_6747354148,420,3,47,40,4,4,1,5,-2,4,2,3,4,7,-2,5,3,1,2,3,0,-4,-49,2,-2,0,15,0,0,-1,-1,1,-1,2,-1
KR_6617553209,420,-6,-54,-8,-9,-3,4,1,-2,5,3,-3,4,1,-1,4,3,0,3,3,0,-8,-4,5,-11,6,-3,0,-2,1,-1,-1,-1,2,-1
KR_6699552096,420,-4,-75,-24,-10,-11,11,0,4,1,5,0,3,3,0,4,4,-3,3,0,0,4,-5,3,-7,4,0,0,-3,-1,-1,-1,1,2,-1
KR_6679084016,440,-3,-41,-16,-4,4,1,5,-2,2,0,-2,3,1,-1,1,0,-3,4,1,0,-5,33,2,-5,3,-1,0,0,1,-1,0,1,6,-1
KR_6743036774,420,-2,-65,-12,-8,-1,4,3,1,2,3,-2,4,2,-5,6,1,-1,3,2,-2,-6,271,-4,0,4,2,0,-1,1,-1,-1,-1,5,-1
KR_6670644306,440,3,28,28,6,-1,1,0,5,0,5,2,1,3,-2,5,3,2,1,3,0,8,-1,-4,-1,5,4,0,2,1,0,1,1,5,-1
KR_6740955108,420,-4,-19,-16,-7,-1,4,3,-1,3,2,1,2,3,-4,8,4,-2,3,1,-2,-9,3,1,-3,2,-2,0,-2,1,0,-1,-1,5,-1
KR_6673715322,420,1,-69,4,3,-3,3,0,-2,3,1,0,1,1,6,1,7,2,0,2,0,9,-2,-3,-1,4,-1,0,-1,1,0,-1,-1,4,-1
KR_6740143539,420,-1,-16,29,-1,1,0,1,-2,5,3,0,3,3,-1,3,2,1,0,1,1,1,4,-1,-2,3,4,0,0,0,1,0,1,0,-1
KR_6712086842,420,0,19,-1,-2,-4,4,0,1,1,2,1,1,2,1,2,3,-1,1,0,0,-1,2,-1,-5,6,-2,0,0,1,-1,0,-1,4,-1
KR_6683403920,420,-3,-26,24,-15,0,2,2,-3,3,0,-4,5,1,-5,5,0,-3,3,0,-1,-25,134,0,-4,4,0,0,-2,-1,-1,-1,-1,2,-1
KR_6659990739,420,-6,-24,8,-10,-5,5,0,0,1,1,-4,4,0,0,3,3,-1,2,1,0,-11,-6,-2,-4,6,4,0,1,1,-1,1,1,4,-1
KR_6703108995,440,0,76,-9,0,-1,3,2,4,2,6,1,3,4,-2,3,1,-2,2,0,0,-6,-2,-1,-2,3,0,0,0,0,-1,-1,-1,0,-1
KR_6737068179,440,0,13,21,-2,-4,4,0,5,0,5,-1,2,1,-1,1,0,-1,2,1,0,-9,0,-5,-2,7,4,0,1,-1,-1,1,-1,1,-1
KR_6606644324,420,0,-5,39,-5,1,1,2,1,0,1,0,3,3,-6,8,2,-1,1,0,2,-13,-1,4,-6,2,0,0,1,-1,1,1,1,3,-1
KR_6587502156,420,-2,39,-22,-6,1,1,2,-1,4,3,-12,12,0,4,0,4,2,1,3,0,-5,-18,1,-4,3,5,0,0,-1,1,1,1,5,-1
KR_6682107500,420,0,-70,-1,-9,0,3,3,2,1,3,-2,5,3,-7,9,2,-2,3,1,0,-2,-4,0,-1,1,0,0,-2,1,1,-1,-1,6,-1
KR_6752809380,420,-4,-42,-4,-6,-2,2,0,-2,2,0,-6,6,0,0,2,2,4,0,4,0,1,-18,-2,-3,5,-1,0,-1,0,0,-1,-1,0,-1
KR_6660434056,420,0,-25,3,3,1,0,1,4,3,7,1,0,1,-3,3,0,0,0,0,0,-2,-14,-2,0,2,-1,0,1,-1,1,1,1,4,-1
KR_6680579394,420,-2,13,0,-4,-1,2,1,-7,7,0,1,1,2,3,6,9,0,1,1,0,-4,12,-4,-4,8,-1,0,-1,-1,-1,-1,1,5,-1
KR_6753138039,420,-2,-13,-39,-5,-3,3,0,-4,5,1,2,1,3,1,1,2,-1,1,0,0,-3,11,-1,-1,2,0,0,-1,-1,-1,-1,-1,1,-1
KR_6750309920,420,1,-43,24,-1,0,1,1,3,1,4,-2,2,0,-1,4,3,-1,2,1,0,2,-5,-2,-1,3,0,0,0,-1,-1,-1,-1,5,-1
KR_6763277801,440,1,30,16,-4,-3,4,1,2,3,5,2,3,5,-3,3,0,-2,2,0,0,5,1,-3,-2,5,-4,0,0,1,1,0,-1,5,-1
KR_6748709608,420,-3,-96,-20,-8,0,1,1,-4,5,1,2,2,4,-6,6,0,0,0,0,-1,-9,-21,-2,-2,4,8,0,-2,-1,-1,-1,-1,2,-1
KR_6762294584,420,-4,-70,0,-9,-1,3,2,2,1,3,5,0,5,-12,13,1,-3,3,0,1,-1,236,-3,-3,6,-1,0,-2,-1,1,-1,1,2,-1
KR_6755218162,420,0,-70,-11,-1,-3,4,1,-1,1,0,-2,5,3,4,2,6,1,0,1,0,1,15,0,-10,10,-3,0,-1,-1,-1,-1,-1,6,-1
KR_6627931670,440,3,-50,12,3,2,4,6,-1,5,4,4,2,6,0,0,0,-2,4,2,1,13,3,3,-5,2,-2,0,-1,-1,1,-1,1,3,-1
KR_6746825773,420,-4,-96,-21,-8,-1,1,0,0,1,1,-1,3,2,-5,6,1,-1,2,1,0,-5,-40,1,-5,4,-2,0,-1,-1,1,-1,1,4,-1
KR_6651661504,440,-1,-63,-5,-5,5,0,5,-1,2,1,0,2,2,-5,6,1,-4,4,0,0,-12,-7,-7,-1,8,-2,0,-2,-1,1,-1,-1,4,-1
KR_6615604354,420,-3,-7,3,-7,1,0,1,-4,7,3,-3,5,2,-1,3,2,0,0,0,1,-8,222,-3,-1,4,1,0,0,0,1,0,1,0,-1
KR_6726835693,420,-6,-121,-11,-2,-2,3,1,2,2,4,0,1,1,0,2,2,-2,4,2,0,7,7,-1,-2,3,0,0,-2,-1,-1,-1,-1,3,-1
KR_6749165700,420,-1,21,12,-9,-2,3,1,0,1,1,-5,6,1,-3,3,0,1,0,1,-3,-14,1,0,-4,4,0,0,0,-1,0,0,-1,4,-1
KR_6736919599,420,-1,-35,-28,-1,-8,8,0,-1,3,2,5,0,5,2,1,3,1,1,2,0,6,23,2,-6,4,0,0,-3,1,-1,-1,1,2,-1
KR_6722506433,420,-2,-8,12,-7,5,0,5,0,2,2,-1,4,3,-9,11,2,-2,2,0,0,-6,-18,-8,0,8,0,0,0,-1,-1,-1,1,6,-1
KR_6734904042,440,2,11,20,3,-2,2,0,-1,2,1,-1,2,1,3,0,3,4,0,4,0,5,-3,-1,-2,3,2,0,0,1,1,0,1,1,-1
KR_6752411648,420,-3,42,-15,-6,-1,1,0,-4,6,2,-7,10,3,3,1,4,3,1,4,0,-2,21,2,-3,1,-12,0,-1,0,0,-1,-1,0,-1
KR_6711017682,440,-6,-128,4,-13,-2,4,2,-4,6,2,-4,6,2,1,3,4,-4,5,1,0,-11,46,-1,-2,3,17,0,-1,-1,0,-1,-1,6,-1
KR_6731904985,440,2,-11,26,-1,-3,5,2,1,3,4,2,1,3,3,1,4,-4,4,0,0,-1,1,7,-7,0,0,0,0,1,-1,0,-1,1,-1
KR_6701931943,420,1,35,-36,4,1,5,6,2,3,5,1,3,4,2,1,3,-2,2,0,1,0,15,-1,0,1,-2,0,0,1,-1,1,1,2,-1
KR_6737006453,420,0,51,41,-8,-1,2,1,-7,9,2,1,1,2,0,0,0,-1,1,0,0,-12,-15,-3,-2,5,-2,0,0,-1,1,-1,-1,3,-1
KR_6725397789,420,-6,-60,-12,-14,-7,7,0,-4,5,1,-2,2,0,3,2,5,-4,5,1,0,-12,-6,-4,-2,6,0,0,-1,-1,-1,-1,-1,6,-1
KR_6753103487,420,1,-27,20,-4,-3,4,1,-2,2,0,-2,2,0,2,1,3,1,0,1,0,-2,2,2,-2,0,1,0,-1,0,-1,-1,-1,0,-1
KR_6759490504,420,-5,-65,-19,2,-7,7,0,-1,3,2,2,3,5,6,2,8,2,0,2,0,-2,-1,-2,-4,6,-1,0,1,-1,-1,-1,-1,2,-1
KR_6707102890,420,1,103,-20,2,4,0,4,-1,2,1,1,0,1,-4,5,1,2,0,2,0,-1,-1,-1,-2,3,1,0,1,-1,1,1,1,5,-1
KR_6724850757,420,-2,-50,12,-5,-4,4,0,-1,2,1,1,2,3,-1,6,5,0,0,0,0,8,-13,-5,-1,6,2,0,-1,1,-1,-1,1,2,-1
KR_6757639617,440,-2,-57,11,-3,-2,3,1,1,1,2,-2,4,2,1,0,1,-1,3,2,0,3,-6,-5,0,5,0,0,-2,-1,-1,-1,-1,1,-1
KR_6752705570,440,-3,-50,-28,-14,0,3,3,0,1,1,-5,7,2,-8,9,1,-1,1,0,0,-12,20,0,-2,2,0,0,-1,1,-1,-1,-1,5,-1
KR_6759602128,420,0,-15,-12,6,-1,3,2,2,1,3,-3,3,0,4,2,6,4,1,5,0,11,2,2,-7,5,2,0,0,-1,1,0,1,5,-1
KR_6752596365,440,-1,52,-33,2,5,0,5,-2,3,1,2,2,4,-4,7,3,1,2,3,-1,-6,11,4,-7,3,1,0,-1,-1,0,-1,-1,2,-1
KR_6755974018,440,0,-30,-27,3,1,2,3,6,0,6,0,4,4,-4,7,3,0,0,0,0,4,17,3,-6,3,0,0,-1,1,-1,-1,-1,6,-1
KR_6751012041,420,0,83,20,2,5,1,6,-3,3,0,1,1,2,-2,4,2,1,2,3,0,-3,8,1,-4,3,1,0,0,1,-1,0,1,4,-1
KR_6752341975,420,-2,34,-1,-10,-2,2,0,0,3,3,2,0,2,-8,10,2,-2,3,1,-1,-8,1,1,-8,7,2,0,0,-1,1,-1,-1,2,-1
KR_6759171696,420,0,10,8,-6,-4,6,2,-2,3,1,-1,4,3,2,2,4,-1,1,0,0,-3,-287,2,-3,1,2,0,1,0,-1,1,-1,0,-1
KR_6639106999,420,-2,27,-42,-7,1,0,1,-4,6,2,-4,5,1,0,1,1,0,1,1,0,-6,27,-3,-1,4,-16,0,-1,1,0,-1,1,3,-1
KR_6759881951,440,-1,-3,8,-6,-1,1,0,-2,2,0,1,2,3,-2,3,1,-2,2,0,0,-5,-28,0,-5,5,-6,0,0,-1,0,0,1,6,-1
KR_6739907881,420,0,35,8,-1,-2,4,2,2,3,5,4,1,5,-6,8,2,1,1,2,1,6,-38,0,-2,2,0,0,2,1,1,1,-1,1,-1
KR_6568035982,420,1,40,-8,6,-3,3,0,7,0,7,-2,4,2,3,2,5,1,0,1,0,3,6,3,-5,2,0,0,1,1,-1,1,1,5,-1
KR_6739342943,420,2,52,20,3,1,1,2,1,10,11,1,1,2,1,2,3,-1,2,1,2,4,-14,1,-2,1,2,0,1,1,1,1,1,2,-1
KR_6744138117,420,1,-30,29,-3,-1,1,0,-2,6,4,-3,3,0,1,2,3,2,2,4,2,-5,-17,-3,-4,7,-3,0,-1,1,-1,-1,1,1,-1
KR_6752531806,420,0,-10,-36,4,6,0,6,-1,2,1,-1,3,2,-1,1,0,1,1,2,0,7,-11,-2,0,2,0,0,1,0,-1,1,1,0,-1
KR_6760520497,440,-1,22,-7,-3,1,2,3,0,0,0,2,0,2,-3,3,0,-3,3,0,0,-3,8,-2,-3,5,-2,0,0,0,1,0,-1,0,-1
KR_6660660517,420,-5,-56,-8,-5,-1,2,1,3,2,5,-5,6,1,1,2,3,-3,3,0,0,1,-17,0,-1,1,-1,0,-3,-1,-1,-1,-1,1,-1
KR_6710524413,420,-5,-61,-52,-10,-6,7,1,-1,4,3,-3,4,1,1,1,2,-1,1,0,0,-6,-116,4,-5,1,-2,0,-2,0,-1,-1,1,0,-1
KR_6758907699,420,0,63,8,0,3,0,3,1,2,3,1,0,1,-5,6,1,0,0,0,0,-3,-126,-4,-4,8,-33,0,0,1,1,1,-1,4,-1
KR_6608608813,420,-2,-22,-30,-2,-7,8,1,0,3,3,-1,2,1,2,2,4,4,1,5,-2,5,-1,-3,-2,5,2,0,0,1,1,-1,-1,5,-1
KR_6727977135,420,-4,-168,-2,-8,-1,1,0,-1,2,1,-2,5,3,-3,7,4,-1,2,1,-1,-3,-109,0,-6,6,-1,0,0,-1,-1,-1,-1,4,-1
KR_6639550115,420,1,74,35,-1,-1,2,1,-1,2,1,3,3,6,-2,2,0,0,2,2,0,-6,28,1,-5,4,-3,0,0,-1,-1,1,1,2,-1
KR_6761448435,420,-5,-103,-32,-13,-6,8,2,5,0,5,-8,8,0,-2,3,1,-2,3,1,-2,-6,403,-2,-4,6,-20,0,-1,-1,-1,-1,-1,4,-1
KR_6729736856,420,1,-25,20,5,1,3,4,2,3,5,5,0,5,0,2,2,-3,4,1,0,1,10,0,-1,1,-8,0,0,1,-1,0,1,1,-1
KR_6751326834,440,1,-10,32,0,3,2,5,1,1,2,1,0,1,-1,1,0,-4,4,0,0,-3,0,0,-5,5,1,0,0,1,1,0,1,4,-1
KR_6701980875,420,-1,-47,4,-3,-1,2,1,3,0,3,-1,5,4,2,5,7,-6,7,1,0,-5,3,2,-3,1,-2,0,0,-1,-1,0,-1,3,-1
KR_6654417193,440,-10,-99,-56,-17,-4,5,1,-4,6,2,-2,4,2,-5,5,0,-2,2,0,0,-11,-1,-1,-5,6,1,0,-3,-1,-1,-1,-1,6,-1
KR_6557595426,420,-1,35,-36,2,5,0,5,-1,1,0,-2,3,1,3,1,4,-3,3,0,0,-1,-1,2,-3,1,0,0,0,-1,0,0,-1,1,-1
KR_6668676601,420,-1,29,-15,-5,2,0,2,-1,4,3,-2,2,0,-1,3,2,-3,7,4,0,-10,234,-3,-5,8,-3,0,-1,-1,-1,-1,-1,1,-1
KR_6601250184,420,0,-19,20,-2,1,2,3,3,3,6,-2,2,0,-6,7,1,2,1,3,0,1,1,-2,0,2,1,0,0,-1,0,0,-1,2,-1
KR_6760347460,420,-4,-85,-7,-14,-2,2,0,0,1,1,-5,5,0,-5,6,1,-2,2,0,-3,-21,-12,-4,-5,9,4,0,-2,-1,1,-1,-1,5,-1
KR_6763662136,420,-2,-3,-7,-8,0,4,4,-6,8,2,-2,2,0,-1,1,0,1,1,2,0,-17,-9,-1,-6,7,5,0,-1,-1,-1,-1,-1,4,-1
KR_6647889545,440,1,17,-16,-5,-2,2,0,3,0,3,2,1,3,1,0,1,-9,11,2,-2,-7,-28,4,-4,0,-2,0,0,1,1,0,-1,1,-1
KR_6681402614,420,-1,-19,-3,-3,1,1,2,-1,2,1,-1,2,1,-1,2,1,-1,1,0,0,-10,28,-3,-1,4,-26,0,-2,-1,0,-1,-1,2,-1
KR_6674942467,440,2,7,-4,5,-1,1,0,1,0,1,2,0,2,1,0,1,2,0,2,0,4,-7,1,-1,0,1,0,0,-1,1,0,-1,5,-1
KR_6729701818,420,0,-40,0,0,3,2,5,0,5,5,0,3,3,-4,4,0,1,0,1,0,-7,84,-1,-5,6,3,0,-3,-1,-1,-1,-1,2,-1
KR_6617415252,440,2,-60,-37,2,1,0,1,3,1,4,-2,2,0,2,0,2,-2,2,0,0,1,-22,-5,-2,7,1,0,0,-1,-1,-1,-1,3,-1
KR_6699176028,420,-7,-94,-4,-17,-5,5,0,-3,4,1,-4,4,0,-4,5,1,-1,1,0,0,-11,8,1,-1,0,-6,0,-4,1,-1,-1,-1,2,-1
KR_6722374838,420,-3,-50,-26,-4,-2,5,3,-3,5,2,-1,3,2,0,3,3,2,0,2,0,4,-5,4,-4,0,3,0,-1,-1,1,-1,1,3,-1
KR_6716690647,420,-4,-91,-48,-10,2,1,3,-3,4,1,-2,5,3,-6,7,1,-1,1,0,0,-3,3,2,-6,4,-2,0,-1,-1,1,1,-1,2,-1
KR_6740834253,420,2,-38,-12,6,-2,3,1,5,0,5,0,4,4,4,0,4,-1,1,0,0,8,4,-1,-2,3,-2,0,1,-1,1,1,1,2,-1
KR_6629849921,440,-1,-76,-20,4,3,0,3,-5,5,0,-3,4,1,5,0,5,4,0,4,0,6,3,0,-2,2,-1,0,0,0,0,0,1,0,-1
KR_6744920661,420,-4,-60,-52,1,-8,9,1,0,3,3,6,0,6,3,1,4,0,0,0,-1,-1,0,-2,-2,4,1,0,-2,0,-1,-1,-1,0,-1
KR_6733711964,420,-2,-16,-52,-2,2,4,6,-4,6,2,0,4,4,1,2,3,-1,1,0,-2,0,-53,-1,-1,2,20,0,0,-1,1,1,-1,2,-1
KR_6516357840,420,-2,5,-23,-4,-6,6,0,7,0,7,1,1,2,-4,5,1,-2,3,1,0,2,4,2,-7,5,-1,0,-1,-1,1,-1,1,2,-1
KR_6762936296,420,-5,25,-40,-5,-1,2,1,-3,4,1,1,4,5,-5,7,2,3,0,3,0,-6,-16,-1,-3,4,0,0,2,-1,1,1,-1,5,-1
KR_6764714032,420,0,-27,20,2,-3,5,2,0,2,2,7,0,7,-2,3,1,0,0,0,0,2,9,3,-5,2,-3,0,-1,-1,1,-1,-1,6,-1
KR_6632232949,420,-1,-51,18,-1,-3,5,2,3,2,5,-2,3,1,1,2,3,0,0,0,-1,-2,-11,1,-5,4,-1,0,2,-1,1,1,-1,6,-1
KR_6670180403,420,-4,-21,-6,-16,-5,7,2,-1,2,1,-2,2,0,-3,3,0,-5,5,0,0,-13,-2,0,-3,3,-4,0,-1,-1,-1,-1,-1,6,-1
KR_6756700273,420,0,-58,12,5,0,2,2,1,0,1,0,2,2,3,0,3,1,0,1,0,6,-40,-1,-2,3,22,0,-1,1,-1,-1,1,3,-1
KR_6040417893,420,-1,13,24,1,5,3,8,1,0,1,4,1,5,-5,7,2,-4,5,1,-1,-5,-5,2,-3,1,-1,0,1,-1,-1,1,-1,3,-1
KR_6683843906,420,-4,-80,-26,-13,-1,2,1,-2,3,1,-7,7,0,-2,2,0,-1,4,3,0,-15,5,-4,-5,9,-4,0,-3,-1,-1,-1,1,4,-1
KR_6720665333,420,-3,-5,17,-4,0,2,2,-2,4,2,0,3,3,-1,2,1,-1,3,2,0,-11,-8,-6,-2,8,6,0,-1,0,-1,-1,1,0,-1
KR_6625756021,440,-2,7,-49,-8,-2,4,2,3,1,4,-3,3,0,-5,5,0,-1,1,0,0,-6,-34,-3,-5,8,-1,0,0,-1,0,0,1,5,-1
KR_6716505849,420,-2,19,-39,-11,0,3,3,-4,6,2,-2,2,0,-5,7,2,0,0,0,-1,-8,11,1,-3,2,-1,0,0,1,-1,0,-1,3,-1
KR_6484643562,420,0,11,14,4,-3,4,1,2,3,5,-1,1,0,4,2,6,2,1,3,0,7,-20,2,-3,1,2,0,0,-1,-1,0,1,2,-1
KR_6761381090,420,-1,54,8,-3,4,1,5,3,3,6,-8,10,2,-2,4,2,0,0,0,-1,4,238,-6,-2,8,4,0,1,-1,1,1,-1,2,-1
KR_6760360218,420,1,-9,8,-5,-4,4,0,-2,4,2,2,3,5,-1,2,1,0,1,1,0,1,-3,-1,-7,8,0,0,-1,-1,-1,-1,-1,3,-1
KR_6746126084,440,0,52,16,-7,0,1,1,0,2,2,-2,5,3,-6,6,0,1,2,3,0,-10,2,-4,0,4,3,0,0,-1,1,0,-1,1,-1
KR_6702918949,420,-2,-37,-4,0,1,1,2,-1,4,3,0,2,2,0,3,3,0,2,2,0,1,-331,1,-4,3,4,0,0,-1,1,0,-1,2,-1
KR_6763952476,420,-5,-18,-28,-7,-8,8,0,0,2,2,3,2,5,-2,2,0,0,0,0,0,1,-5,-2,-1,3,-2,0,-4,-1,-1,-1,-1,1,-1
KR_6710375091,420,2,90,0,-1,3,2,5,-4,5,1,-1,2,1,1,1,2,0,0,0,0,-3,2,-3,-2,5,0,0,0,1,0,1,-1,6,-1
KR_6605978720,420,0,-4,-32,-4,0,1,1,-3,4,1,-3,4,1,2,3,5,0,0,0,0,-7,-41,2,-5,3,18,0,0,1,-1,-1,1,1,-1
KR_6743444079,420,-5,-12,-30,-10,-6,6,0,-5,5,0,2,5,7,-1,4,3,0,1,1,0,-6,-5,-2,-6,8,-2,0,0,-1,-1,-1,-1,4,-1
KR_6632280553,420,-2,-25,11,-8,0,2,2,3,2,5,-2,5,3,-4,7,3,-5,5,0,0,2,0,4,-5,1,1,0,-1,1,0,-1,1,1,-1
KR_6740671230,420,-1,-3,-1,-4,-1,4,3,0,4,4,-3,4,1,-1,3,2,1,0,1,0,-1,3,-1,-2,3,-3,0,-1,1,-1,-1,-1,1,-1
KR_6628274466,420,-2,-8,-4,-7,-3,4,1,1,1,2,-1,4,3,-1,2,1,-3,4,1,0,-3,3,-2,-1,3,0,0,0,-1,-1,-1,-1,5,-1
KR_6689156643,420,-3,22,0,-6,-2,3,1,-3,3,0,0,1,1,-3,6,3,2,0,2,0,-5,-1,3,-5,2,4,0,-1,-1,0,-1,-1,6,-1
KR_6742785450,440,-2,-50,8,-6,2,0,2,-2,4,2,-10,10,0,1,4,5,3,0,3,0,1,6,-6,0,6,0,0,1,-1,-1,1,-1,1,-1
KR_6749222935,440,-5,-97,-36,-9,-5,6,1,0,5,5,1,4,5,-3,4,1,-2,6,4,-1,-8,13,5,-7,2,-5,0,-1,1,-1,-1,-1,1,-1
KR_6741669157,420,1,87,-1,1,1,4,5,-2,4,2,4,0,4,-2,4,2,0,3,3,3,-11,-38,0,-3,3,3,0,2,1,1,1,1,1,-1
KR_6679464326,420,-1,25,-18,-2,0,2,2,1,1,2,1,3,4,-3,4,1,-1,1,0,0,-3,-3,-5,-1,6,0,0,0,-1,-1,0,-1,3,-1
KR_6592536913,420,1,62,2,-2,-1,3,2,2,2,4,2,2,4,-5,6,1,0,0,0,0,-5,52,0,-2,2,-25,0,1,-1,1,1,1,5,-1
KR_6685601940,420,-6,-85,-16,-4,-4,5,1,2,0,2,-2,4,2,-1,1,0,1,0,1,0,-1,-1,-1,-5,6,-3,0,-1,1,-1,-1,-1,4,-1
KR_6758096741,420,0,26,44,-10,-2,4,2,-1,2,1,0,1,1,-6,7,1,-1,1,0,0,-13,0,1,-4,3,-1,0,-1,0,0,1,-1,0,-1
KR_6699148274,420,-8,-86,-15,-14,-3,3,0,-9,9,0,2,0,2,1,0,1,-5,5,0,-2,-15,-24,-1,-2,3,0,0,-2,1,-1,-1,-1,6,-1
KR_6688921249,420,-3,-64,-65,-10,-2,3,1,2,0,2,-1,2,1,-4,4,0,-5,8,3,0,-4,-2,-1,-6,7,-6,0,0,-1,1,0,-1,6,-1
KR_6747291654,420,-7,-106,-37,-12,-1,2,1,-2,3,1,-2,4,2,-5,9,4,-2,2,0,-1,-12,-10,1,-3,2,1,0,-2,-1,-1,-1,-1,5,-1
KR_6757244192,420,-3,27,-16,-2,2,2,4,-3,4,1,-2,6,4,3,0,3,-2,3,1,0,2,31,-1,-3,4,1,0,0,1,-1,-1,1,3,-1
KR_6683734786,420,-2,-77,-1,0,-2,2,0,-1,4,3,3,1,4,1,1,2,-1,1,0,0,-1,4,6,-8,2,-5,0,0,0,0,0,1,0,-1
KR_6750460697,440,2,-28,3,-5,-2,3,1,-2,2,0,5,0,5,-4,4,0,-2,3,1,0,-11,-7,0,-3,3,-3,0,-1,-1,0,-1,-1,2,-1
KR_6731318878,440,-3,-68,4,-5,1,3,4,1,1,2,-4,4,0,-2,3,1,-1,1,0,0,-5,9,1,-3,2,-2,0,-1,-1,0,-1,1,2,-1
KR_6197741697,420,0,28,-13,0,4,1,5,-5,8,3,-4,4,0,3,3,6,2,0,2,0,-2,-12,-5,-3,8,1,0,2,1,-1,-1,1,4,-1
KR_6615873782,420,-3,-61,-28,-3,0,3,3,-3,6,3,-4,6,2,0,1,1,4,0,4,0,-3,2,-6,0,6,-2,0,1,0,0,1,1,0,-1
KR_6701997641,420,-2,-13,12,-6,-7,7,0,1,3,4,0,2,2,2,5,7,-2,2,0,0,12,-3,-1,-3,4,1,0,0,1,-1,-1,-1,6,-1
KR_6759067627,440,-5,-41,-42,-3,4,1,5,-3,5,2,-2,6,4,1,2,3,-3,5,2,0,-3,18,4,-5,1,-3,0,0,1,-1,1,1,1,-1
KR_6750259494,420,-4,-45,-2,-1,-5,8,3,3,0,3,-5,5,0,5,2,7,1,0,1,0,12,7,2,-5,3,-1,0,0,1,-1,-1,1,6,-1
KR_6762987519,420,-2,-41,-20,-2,-5,5,0,1,2,3,5,0,5,-4,4,0,1,0,1,0,0,6,5,-7,2,4,0,0,-1,0,0,1,3,-1
KR_6763117943,420,-3,-44,-8,-3,-1,2,1,-3,4,1,1,0,1,3,2,5,-3,7,4,0,3,-15,-2,-2,4,2,0,0,-1,1,0,1,6,-1
KR_6661278479,420,2,-23,4,3,-9,9,0,0,1,1,4,0,4,8,0,8,0,1,1,-1,11,8,-2,-5,7,-3,0,0,-1,0,1,-1,1,-1
KR_6758251827,420,1,45,20,3,0,0,0,0,1,1,0,3,3,2,3,5,1,0,1,0,7,-22,0,-5,5,4,0,1,1,0,1,-1,4,-1
KR_6581808724,420,-8,-67,-46,-15,-1,2,1,-3,4,1,-6,7,1,-4,4,0,-1,2,1,0,-9,1,-2,-3,5,0,0,-2,-1,-1,-1,-1,5,-1
KR_6746167191,420,-3,-68,-8,-9,-3,5,2,-3,5,2,-5,8,3,1,1,2,1,1,2,-2,-9,88,-2,0,2,1,0,-1,-1,1,1,-1,6,-1
KR_6751360056,420,1,25,17,7,3,0,3,-1,2,1,2,2,4,-2,3,1,5,1,6,0,5,-1,0,-4,4,2,0,0,-1,0,1,1,1,-1
KR_6622574494,420,3,57,12,4,5,2,7,1,2,3,-4,4,0,2,1,3,0,1,1,0,-8,2,-4,-1,5,-3,0,-1,-1,1,-1,1,1,-1
KR_6684417132,420,2,-11,-16,3,-2,2,0,1,2,3,2,0,2,2,0,2,0,1,1,0,9,-210,2,-4,2,3,0,1,-1,1,1,1,5,-1
KR_6759951504,420,-1,-37,12,-3,1,3,4,-2,2,0,0,4,4,-1,1,0,-1,3,2,-1,-7,-7,0,-3,3,-2,0,0,-1,1,1,-1,5,-1
KR_6762265295,420,-3,-4,-28,-12,3,0,3,-2,2,0,-4,5,1,-4,4,0,-5,5,0,0,-15,-9,2,-2,0,-1,0,0,-1,1,0,-1,2,-1
KR_6641497291,420,-1,28,-12,-9,-1,1,0,-3,5,2,-6,6,0,2,2,4,-1,5,4,1,-9,8,0,-6,6,-3,0,0,0,0,0,1,0,-1
KR_6761511034,420,-4,-53,-50,-9,-3,3,0,2,0,2,-6,7,1,-4,7,3,2,0,2,0,-3,-2,-4,-2,6,-2,0,0,1,0,0,1,5,-1
KR_6683869402,420,-7,-14,-60,-7,4,2,6,-1,1,0,-3,4,1,-5,5,0,-2,3,1,0,-9,10,5,-6,1,-1,0,0,1,-1,1,1,1,-1
KR_6680504753,420,2,18,18,3,-2,3,1,3,0,3,9,1,10,-7,7,0,0,1,1,0,1,8,1,-5,4,3,0,2,1,1,1,1,5,-1
KR_6756102548,440,-5,-44,-32,-9,-3,3,0,-4,5,1,1,6,7,-5,6,1,2,1,3,-1,-12,-3,4,-7,3,-2,0,-2,-1,1,-1,-1,1,-1
KR_6638387903,440,-2,22,11,-7,0,2,2,-1,2,1,-2,2,0,-3,3,0,-1,1,0,0,-10,2,5,-8,3,-3,0,-1,-1,-1,-1,1,4,-1
KR_6692737379,420,-2,-53,4,-5,-1,3,2,2,2,4,-5,6,1,-1,2,1,0,1,1,-1,-2,-19,2,-2,0,4,0,0,-1,-1,-1,-1,6,-1
KR_6751469822,420,0,7,4,-4,-1,4,3,2,0,2,-4,4,0,-1,1,0,0,0,0,0,-6,-1,-2,-1,3,3,0,-1,1,-1,-1,-1,4,-1
KR_6763626779,420,-2,-34,-24,-3,-5,8,3,4,3,7,1,0,1,4,2,6,-7,7,0,0,1,98,-1,-5,6,-1,0,0,0,-1,1,-1,0,-1
KR_6681157499,420,-4,-59,-16,-5,-5,5,0,0,3,3,-1,3,2,1,3,4,0,0,0,0,8,-2,1,-4,3,-2,0,-1,-1,0,-1,-1,6,-1
KR_6752935013,420,-2,-42,0,-8,-3,5,2,-2,2,0,-2,2,0,-1,4,3,0,1,1,0,-11,385,-2,-3,5,-5,0,0,-1,-1,0,-1,5,-1
KR_6501594143,420,-3,-2,8,-1,2,2,4,-2,2,0,-3,5,2,1,3,4,1,1,2,0,-7,-1,-2,-3,5,1,0,0,0,-1,-1,1,0,-1
KR_6725609806,440,-9,-91,-36,-18,-1,2,1,-3,3,0,-3,5,2,-5,8,3,-6,7,1,0,-21,-17,4,-8,4,-1,0,-1,-1,-1,-1,1,2,-1
KR_6699845129,420,-2,-42,-8,-12,-4,5,1,-1,5,4,-6,7,1,-2,3,1,1,1,2,0,-3,-10,-4,-2,6,0,0,1,-1,-1,-1,-1,5,-1
KR_6679479815,420,-8,-96,-16,-13,0,1,1,-4,4,0,-3,3,0,-3,4,1,-3,3,0,0,-14,182,-1,-2,3,0,0,-1,-1,0,-1,-1,5,-1
KR_6757838903,420,-1,-39,-12,-6,-3,3,0,0,5,5,-3,5,2,-1,3,2,1,2,3,-1,-5,-42,-1,-2,3,19,0,-1,-1,1,-1,-1,4,-1
KR_6749022350,440,-1,-28,-16,-1,2,1,3,-3,5,2,-2,3,1,2,0,2,0,0,0,0,5,2,0,-5,5,-4,0,0,0,-1,0,1,0,-1
KR_6724702730,420,-5,-137,-20,-13,1,0,1,-8,8,0,-6,6,0,0,5,5,0,1,1,-1,-20,-26,-4,-1,5,-1,0,-1,0,0,-1,-1,0,-1
KR_6695793451,420,2,-13,-23,1,0,1,1,-1,2,1,1,1,2,4,1,5,-3,3,0,0,4,-44,-5,-4,9,1,0,-1,-1,1,-1,-1,6,-1
KR_6718701284,420,1,60,13,5,-1,1,0,1,1,2,10,0,10,-1,6,5,-4,7,3,-1,-2,223,5,-11,6,-3,0,1,-1,1,1,-1,2,-1
KR_6610535800,420,-1,-44,-10,-2,-1,2,1,0,3,3,4,0,4,-4,7,3,-1,1,0,-1,1,-34,0,-4,4,1,0,0,1,-1,0,-1,1,-1
KR_5886598424,420,-3,-50,-4,-5,-1,1,0,-3,4,1,0,1,1,-1,3,2,0,0,0,0,-4,-2,0,-5,5,-4,0,-1,1,0,-1,-1,2,-1
KR_6696223633,420,-3,-82,32,-8,0,1,1,4,1,5,-4,4,0,-6,6,0,-2,2,0,0,-10,4,-2,-2,4,1,0,-2,1,-1,-1,1,6,-1
KR_5664357781,420,-8,-66,-50,-14,1,1,2,-10,11,1,-6,6,0,-1,2,1,2,0,2,0,-7,1,0,-5,5,-5,0,-1,1,-1,-1,-1,3,-1
KR_6762136980,440,-1,-72,-24,-6,0,2,2,-1,5,4,-5,9,4,-1,2,1,1,1,2,0,-7,-7,0,-1,1,-1,0,-1,0,-1,-1,1,0,-1
KR_6743022152,420,0,-14,-44,-11,-1,3,2,-2,2,0,3,3,6,-9,9,0,-2,3,1,0,-11,-9,-5,-1,6,-4,0,-1,-1,-1,-1,-1,3,-1
KR_6757654451,420,-3,-69,16,-10,-7,8,1,1,1,2,-1,2,1,-4,7,3,1,3,4,0,-12,32,1,-5,4,-2,0,-2,-1,0,-1,-1,2,-1
KR_6723705335,440,1,-9,44,2,-2,4,2,6,2,8,-2,2,0,-1,1,0,1,1,2,2,-3,-3,2,-5,3,1,0,0,0,1,0,1,0,-1
KR_6743963046,420,0,-15,24,-8,-4,4,0,0,0,0,1,1,2,-6,8,2,1,0,1,-1,-11,0,-1,-5,6,-2,0,-2,1,1,-1,-1,6,-1
KR_6758156958,440,3,-13,0,8,1,4,5,5,3,8,1,0,1,1,0,1,0,1,1,0,10,0,-1,-2,3,7,0,1,0,1,1,1,0,-1
KR_6696151800,440,-4,-57,-32,-4,-1,2,1,-1,2,1,0,2,2,-2,4,2,0,0,0,0,-10,-26,-1,-3,4,1,0,0,-1,1,1,-1,4,-1
KR_6655703483,440,-2,-43,36,-10,-2,2,0,-4,8,4,-6,6,0,2,1,3,0,2,2,0,-3,107,0,-4,4,0,0,0,1,1,0,-1,4,-1
KR_6743360070,420,0,28,-7,1,1,1,2,1,3,4,0,3,3,1,3,4,-2,3,1,0,-3,-1,-4,-4,8,1,0,0,-1,1,0,-1,4,-1
KR_6635088043,440,-3,-52,23,-7,3,0,3,0,1,1,-2,3,1,3,3,6,-11,11,0,-1,-6,2,5,-7,2,-1,0,0,0,1,1,-1,0,-1
KR_6756495363,420,0,-13,12,1,1,0,1,1,2,3,-2,3,1,1,3,4,0,1,1,0,-5,7,-3,-3,6,0,0,0,0,0,0,-1,0,-1
KR_6465443104,420,-1,30,12,2,-2,3,1,1,2,3,1,2,3,1,2,3,1,2,3,0,1,-120,-1,-5,6,-2,0,1,1,-1,1,1,6,-1
KR_6696310988,420,-1,22,-21,2,1,3,4,1,0,1,1,2,3,-1,2,1,0,0,0,0,3,-3,1,-3,2,1,0,1,1,0,1,-1,2,-1
KR_6745998050,420,1,14,8,2,0,2,2,4,1,5,-3,5,2,1,1,2,0,1,1,1,-1,-13,5,-7,2,-2,0,1,-1,-1,1,1,6,-1
KR_6620362116,420,-5,-40,-12,-4,1,2,3,2,0,2,-4,5,1,-2,4,2,-1,3,2,1,-1,4,3,-5,2,-6,0,1,-1,1,1,1,1,-1
KR_6764180008,440,-3,-121,41,-2,1,3,4,-1,4,3,2,3,5,-8,8,0,4,1,5,0,-12,-22,1,-5,4,4,0,0,1,0,0,-1,6,-1
KR_6195877643,420,-1,-40,-19,-1,-3,5,2,2,2,4,0,2,2,0,1,1,0,1,1,0,11,-2,3,-6,3,0,0,-2,0,-1,-1,-1,0,-1
KR_6686538571,440,-1,-68,13,-11,-5,5,0,-5,9,4,0,4,4,-2,4,2,1,0,1,-1,-13,1,-1,-3,4,1,0,-2,0,1,-1,-1,0,-1
KR_6760409923,420,-3,-51,4,-6,0,1,1,4,0,4,-5,8,3,-2,2,0,-3,3,0,-1,-4,-25,0,-2,2,-2,0,-2,0,0,-1,-1,0,-1
KR_6726877277,420,1,38,-8,-2,-1,2,1,-1,2,1,-1,1,0,1,4,5,0,0,0,0,-4,-4,-2,-4,6,-1,0,-1,0,-1,-1,1,0,-1
KR_6727661906,420,-1,-84,-8,-4,-1,2,1,1,3,4,-2,7,5,-1,4,3,-1,1,0,-1,-2,-34,6,-10,4,27,0,-1,0,-1,-1,-1,0,-1
KR_6688945089,420,-2,-83,-25,-2,0,2,2,0,7,7,0,1,1,-1,5,4,-1,3,2,3,4,-3,0,-6,6,-1,0,-1,-1,-1,-1,1,5,-1
KR_6666490890,420,3,57,20,7,0,1,1,1,0,1,2,2,4,4,2,6,0,1,1,0,-1,0,-2,-2,4,2,0,0,1,0,0,1,3,-1
KR_6755371710,420,-1,-34,39,5,0,2,2,4,4,8,-4,4,0,5,3,8,0,1,1,2,7,-7,2,-4,2,3,0,3,0,1,1,1,0,-1
KR_6684000605,420,0,-17,-8,2,-1,3,2,0,1,1,3,0,3,0,0,0,0,0,0,0,0,-28,1,-3,2,-1,0,1,1,-1,1,1,6,-1
KR_6736352144,420,-5,25,-23,-9,-2,2,0,-4,6,2,0,1,1,-1,3,2,-2,3,1,0,-7,-4,1,-6,5,8,0,-2,-1,-1,-1,-1,6,-1
KR_6649512473,420,0,32,-20,0,2,1,3,-5,6,1,-2,3,1,5,1,6,0,1,1,0,-1,26,3,-5,2,1,0,1,-1,-1,1,1,1,-1
KR_6704097351,420,-3,-45,20,-3,-1,3,2,1,0,1,-6,6,0,1,2,3,2,0,2,0,-4,-8,-1,-2,3,-4,0,-2,1,-1,-1,1,6,-1
KR_6732731506,420,-1,-78,-33,-5,-1,1,0,1,2,3,-2,4,2,-5,8,3,2,0,2,0,-4,3,6,-9,3,-3,0,-1,-1,-1,-1,1,3,-1
KR_6600782979,420,-1,-4,13,-2,0,3,3,-1,1,0,-5,5,0,1,0,1,3,2,5,1,4,-4,1,-5,4,-4,0,0,-1,-1,-1,1,5,-1
KR_6763405353,420,2,28,7,4,3,0,3,2,0,2,2,2,4,-2,4,2,-1,1,0,0,-2,4,-1,-6,7,2,0,0,-1,1,0,1,4,-1
KR_6624588329,420,0,-18,24,5,-3,3,0,3,0,3,4,0,4,0,3,3,1,1,2,0,7,156,-2,-1,3,2,0,0,1,-1,0,-1,1,-1
KR_6752001055,420,4,57,14,-1,0,2,2,0,1,1,1,1,2,-3,6,3,1,1,2,0,2,28,-3,-3,6,-15,0,-1,1,-1,-1,-1,6,-1
KR_6612619083,420,0,19,-29,0,-2,3,1,0,3,3,0,1,1,0,3,3,2,0,2,0,3,71,0,-7,7,-3,0,0,-1,-1,0,1,4,-1
KR_6753758734,420,-3,-51,-16,-3,-4,5,1,1,0,1,-2,4,2,1,1,2,1,1,2,0,1,0,-1,-4,5,1,0,-2,1,0,-1,1,3,-1
KR_6725400040,420,-3,-44,-32,-10,1,4,5,-4,5,1,-9,10,1,1,2,3,1,0,1,0,-2,-441,-3,-2,5,-2,0,0,-1,-1,0,1,4,-1
KR_6610291178,420,-1,60,-15,-4,2,1,3,-3,5,2,1,0,1,-4,5,1,0,1,1,0,-10,4,3,-5,2,-4,0,0,-1,-1,-1,-1,2,-1
KR_6707328464,440,-2,-45,-24,-3,3,1,4,0,3,3,0,2,2,-5,6,1,-1,3,2,0,2,3,4,-5,1,4,0,0,-1,-1,-1,1,5,-1
KR_6725793024,420,-1,1,3,-6,2,1,3,-2,6,4,0,0,0,-6,6,0,0,0,0,0,-11,-10,-2,-4,6,2,0,-1,-1,1,-1,1,5,-1
KR_6740199673,420,-2,-14,-17,-2,-3,4,1,1,2,3,3,0,3,-1,2,1,-2,2,0,0,-1,8,-1,-2,3,2,0,0,1,-1,0,1,4,-1
KR_6603241509,420,-1,-33,-18,-1,-2,2,0,-1,2,1,-3,6,3,4,0,4,1,1,2,0,4,-3,-2,-3,5,-2,0,0,0,-1,0,1,0,-1
KR_6750196026,440,-2,-3,-4,-2,4,1,5,0,0,0,-2,5,3,-3,4,1,-1,2,1,1,-4,9,-3,-1,4,1,0,0,-1,-1,-1,1,1,-1
KR_6733973450,440,2,47,-4,4,-2,2,0,-1,5,4,5,0,5,-1,2,1,3,0,3,0,6,-1,1,-7,6,2,0,2,1,-1,1,1,2,-1
KR_6742850882,440,2,42,-30,5,4,1,5,-2,4,2,2,1,3,2,3,5,-1,1,0,0,-2,0,0,-5,5,0,0,0,-1,-1,1,-1,6,-1
KR_6741040412,420,-4,-29,-4,-9,0,1,1,-2,3,1,-3,4,1,-3,4,1,-1,2,1,0,-14,-4,1,-4,3,-1,0,-1,-1,1,-1,-1,4,-1
KR_6622198219,420,-9,-97,-16,-17,-4,6,2,0,1,1,1,3,4,-12,14,2,-2,2,0,0,-20,31,-1,-4,5,-11,0,-2,-1,1,-1,-1,5,-1
KR_6737013646,420,-1,-13,-16,-9,1,0,1,-8,9,1,-1,3,2,1,1,2,-2,3,1,0,-7,-192,1,-4,3,-2,0,0,-1,0,0,1,1,-1
KR_6626942915,420,-2,-72,-8,-6,-5,5,0,-2,4,2,-2,3,1,4,1,5,-1,2,1,0,-1,57,2,-5,3,-4,0,-2,1,-1,-1,-1,4,-1
KR_6762042649,420,5,33,17,6,2,1,3,0,1,1,3,2,5,1,1,2,0,0,0,0,1,29,-2,-2,4,0,0,2,1,1,1,1,2,-1
KR_6710470059,440,1,5,8,1,3,0,3,1,4,5,-3,4,1,0,0,0,0,0,0,0,-6,-1,-2,0,2,0,0,0,-1,-1,0,1,6,-1
KR_6759149321,420,0,-85,8,1,2,1,3,2,1,3,7,0,7,-4,4,0,-6,6,0,0,-1,-1,-2,-1,3,3,0,-1,-1,-1,-1,-1,6,-1
KR_6764665956,440,-2,-41,12,-12,-4,5,1,-2,2,0,-1,1,0,1,0,1,-6,6,0,0,-16,16,0,-5,5,-4,0,0,1,-1,-1,1,2,-1
KR_6746253161,440,-5,-84,12,-12,-1,2,1,0,3,3,2,1,3,-11,12,1,-2,3,1,0,-18,19,1,-3,2,1,0,-2,-1,-1,-1,1,5,-1
KR_6745129821,420,-3,-73,17,-8,-3,5,2,-2,2,0,7,1,8,-9,9,0,-1,2,1,0,-14,27,-3,-1,4,1,0,-1,1,1,-1,1,4,-1
KR_6529519005,420,-2,-4,29,-11,-1,1,0,-4,6,2,2,0,2,-10,10,0,2,0,2,0,-13,0,-3,-3,6,-3,0,-2,1,-1,-1,-1,1,-1
KR_6731894340,440,-2,14,-34,-6,0,2,2,-5,5,0,-1,2,1,1,0,1,-1,1,0,0,-3,9,0,-1,1,1,0,0,1,-1,-1,-1,6,-1
KR_6677826656,420,-4,-32,-77,-10,1,3,4,-6,7,1,-1,2,1,-4,5,1,0,1,1,-1,-14,-31,5,-9,4,2,0,-2,1,1,-1,-1,6,-1
KR_6695073240,420,-1,32,-56,-3,2,1,3,-6,6,0,0,1,1,0,4,4,1,0,1,0,-4,-19,-8,-3,11,4,0,-1,-1,1,-1,1,5,-1
KR_6629585244,420,0,18,-5,-4,-1,1,0,-3,5,2,-1,4,3,-2,6,4,3,0,3,-1,-8,0,-4,-5,9,5,0,0,-1,1,0,-1,4,-1
KR_6745727337,420,-4,-38,16,-11,-2,4,2,-1,1,0,0,2,2,-2,2,0,-6,6,0,0,-4,-2,-1,-5,6,-2,0,-1,1,0,-1,-1,2,-1
KR_6750009487,420,-3,-31,-7,-11,-2,3,1,-1,1,0,-3,5,2,1,1,2,-6,6,0,0,-9,17,-2,-2,4,2,0,-1,0,-1,-1,-1,0,-1
KR_6761210225,420,0,-12,-4,-6,4,2,6,-3,6,3,1,0,1,-7,8,1,-1,2,1,0,-7,-39,-3,-5,8,2,0,-2,-1,-1,-1,1,5,-1
KR_6723195798,420,-3,-18,-56,-8,-4,4,0,-2,4,2,-2,6,4,2,2,4,-2,3,1,0,-16,-4,1,-9,8,1,0,0,-1,-1,0,1,3,-1
KR_6757589517,420,0,-15,8,1,1,2,3,5,4,9,-4,4,0,2,3,5,-3,4,1,0,4,0,0,-3,3,2,0,-1,0,0,-1,-1,0,-1
KR_6380169697,420,-5,-87,-28,-3,-4,5,1,4,0,4,-2,4,2,-1,1,0,0,1,1,0,-3,31,0,-2,2,0,0,-2,-1,1,-1,-1,4,-1
KR_6678923287,440,-1,-17,-31,-6,3,1,4,-1,2,1,-4,5,1,-7,8,1,3,2,5,1,-5,6,1,-4,3,-4,0,-3,1,-1,-1,1,3,-1
KR_6670270208,420,3,59,-14,5,-1,2,1,3,3,6,4,0,4,-1,1,0,0,2,2,0,5,-5,1,-4,3,3,0,1,-1,1,1,-1,6,-1
KR_6681609591,420,-6,-86,0,-13,-2,3,1,-3,4,1,-9,9,0,3,4,7,-2,2,0,-1,-9,-5,0,-3,3,-3,0,-4,-1,1,-1,-1,6,-1
KR_6708260681,420,-3,-42,-20,-5,-3,5,2,-3,4,1,-2,4,2,2,2,4,1,1,2,0,-3,-20,1,-4,3,2,0,-1,1,-1,-1,1,5,-1
KR_6070995644,420,-5,-22,3,-8,-2,2,0,-6,6,0,1,2,3,0,2,2,-1,1,0,0,-14,3,-4,0,4,-4,0,-1,-1,0,-1,1,4,-1
KR_6733112708,420,3,17,-4,6,-1,5,4,2,2,4,3,1,4,2,1,3,0,1,1,-2,-7,-3,-1,-5,6,0,0,0,-1,-1,0,-1,2,-1
KR_6751291592,420,1,16,-1,-7,-4,4,0,-2,3,1,-3,5,2,3,3,6,-1,3,2,0,-2,481,0,-1,1,2,0,0,0,0,0,-1,0,-1
KR_6104896268,420,-4,-19,8,-8,3,1,4,-4,10,6,-1,2,1,-2,3,1,-4,5,1,0,-8,17,1,-3,2,2,0,-1,1,-1,-1,-1,4,-1
KR_6754833479,440,0,-36,61,-8,2,1,3,4,0,4,1,1,2,-2,3,1,-13,14,1,-1,-17,-11,0,0,0,0,0,0,0,0,0,-1,0,-1
KR_6725584893,420,0,-31,-13,2,3,0,3,-2,3,1,3,3,6,-1,2,1,-1,1,0,0,-5,9,1,-2,1,-1,0,-1,1,-1,-1,1,6,-1
KR_6654208999,440,0,-7,6,-8,0,2,2,-8,9,1,3,1,4,-3,5,2,0,1,1,0,-9,17,-2,-1,3,1,0,0,-1,-1,-1,-1,2,-1
KR_6734913651,440,-6,-70,11,4,0,0,0,-4,6,2,1,1,2,5,2,7,2,0,2,0,5,-6,0,-4,4,1,0,-2,-1,0,-1,-1,1,-1
KR_6579576180,420,-3,-48,-25,-8,-3,3,0,-8,10,2,3,2,5,0,5,5,0,0,0,-1,3,-8,-6,-3,9,-3,0,-2,-1,-1,-1,-1,6,-1
KR_6611563026,420,1,11,0,7,-2,2,0,3,2,5,7,0,7,1,1,2,-2,2,0,1,8,-1,-3,-2,5,2,0,2,-1,1,1,1,5,-1
KR_6764452328,420,-3,-42,-8,-9,-1,1,0,-4,6,2,-1,1,0,-6,8,2,3,0,3,-1,-5,95,6,-7,1,-3,0,-1,-1,1,-1,-1,2,-1
KR_6655689199,420,1,-48,-12,-2,-1,1,0,-6,6,0,6,2,8,-1,2,1,0,0,0,1,-2,55,-4,-2,6,-3,0,-1,0,-1,-1,1,0,-1
KR_6626310982,420,-1,-37,-28,-8,4,1,5,-5,6,1,1,2,3,-8,8,0,0,1,1,0,-17,7,0,-4,4,0,0,0,1,-1,0,-1,6,-1
KR_6732631282,420,1,-63,-28,7,1,1,2,5,0,5,1,2,3,1,2,3,-1,1,0,0,7,20,-2,-3,5,-6,0,-1,-1,-1,-1,-1,5,-1
KR_6762213690,420,-3,-74,18,-4,-5,5,0,-1,1,0,-2,2,0,2,3,5,2,2,4,-2,-1,7,3,-5,2,1,0,0,-1,-1,1,-1,4,-1
KR_6719048520,440,-5,-141,-32,-13,1,1,2,2,3,5,-10,10,0,-3,6,3,-3,3,0,0,-9,23,-1,-4,5,-1,0,-3,-1,-1,-1,-1,6,-1
KR_6764245739,440,5,66,16,0,3,0,3,-2,5,3,-3,4,1,2,3,5,0,2,2,-2,-11,-5,-4,-3,7,1,0,0,-1,1,0,-1,5,-1
KR_6699284947,420,3,-34,98,-3,1,0,1,0,0,0,-1,2,1,0,1,1,-3,3,0,0,-3,3,-1,-3,4,-1,0,0,1,1,0,1,4,-1
KR_6760626301,420,2,8,-20,1,1,0,1,0,3,3,-4,6,2,2,0,2,2,0,2,0,6,-32,-1,-3,4,1,0,0,1,-1,0,1,5,-1
KR_6764239711,440,2,-15,6,4,2,0,2,0,4,4,6,5,11,-5,5,0,1,0,1,3,6,416,2,-5,3,-2,0,1,-1,-1,1,1,4,-1
KR_6700470266,420,1,-65,7,5,6,0,6,3,3,6,-1,1,0,0,1,1,-3,3,0,1,3,177,0,-3,3,1,0,-1,-1,-1,-1,1,6,-1
KR_6660671674,420,-1,-65,4,-2,-4,6,2,1,2,3,2,1,3,-3,7,4,2,1,3,0,12,19,7,-8,1,-7,0,-3,1,1,-1,1,2,-1
KR_6726580921,440,-4,-61,0,-4,-5,6,1,-1,1,0,1,2,3,1,2,3,0,2,2,0,0,0,3,-7,4,-2,0,-2,0,-1,-1,1,0,-1
KR_6758263568,420,-5,-31,0,-15,-1,2,1,-3,4,1,-4,5,1,-7,7,0,0,1,1,0,-16,-23,2,-6,4,1,0,0,0,0,0,-1,0,-1
KR_6557671935,420,-1,34,-24,-2,-4,5,1,-1,4,3,6,0,6,0,1,1,-3,3,0,0,-2,26,-1,-1,2,0,0,1,1,-1,1,-1,3,-1
KR_6668908687,420,-5,-66,-8,-8,-3,4,1,-3,7,4,-2,3,1,1,1,2,-1,2,1,0,-1,225,3,-7,4,-4,0,-1,1,-1,-1,1,2,-1
KR_6759352873,420,-3,-46,-3,-3,-3,5,2,4,3,7,-4,5,1,-1,3,2,1,0,1,1,1,28,3,-4,1,-5,0,-1,0,1,-1,1,0,-1
KR_6727399298,420,1,25,0,0,1,0,1,1,2,3,-3,5,2,0,2,2,1,0,1,0,1,-34,-1,-1,2,0,0,0,1,-1,-1,-1,4,-1
KR_6704822340,420,-4,-157,-27,-5,-4,4,0,2,2,4,-1,1,0,-2,3,1,0,0,0,0,3,-1,-1,-1,2,-5,0,-2,-1,-1,-1,-1,4,-1
KR_6763088070,420,2,54,-6,2,1,2,3,-4,7,3,-2,4,2,7,1,8,0,0,0,0,0,-4,-3,-2,5,-3,0,-1,1,-1,-1,-1,5,-1
KR_6681970341,420,-4,-86,-48,-15,-1,2,1,-1,3,2,0,1,1,-11,14,3,-2,2,0,0,-13,88,-3,0,3,3,0,-1,-1,1,-1,1,4,-1
KR_6726708355,440,1,-13,-20,3,2,0,2,0,0,0,1,0,1,-2,5,3,2,1,3,0,1,-11,-6,-3,9,0,0,0,-1,0,0,-1,5,-1
KR_6730043484,420,-4,-49,-10,-4,-1,2,1,1,3,4,2,1,3,-2,5,3,-4,5,1,0,-2,-22,-2,-2,4,-1,0,0,-1,-1,-1,1,3,-1
KR_6731978199,440,-5,-23,-18,-9,-3,6,3,-2,4,2,3,0,3,-8,8,0,1,0,1,2,-2,5,3,-5,2,-6,0,-1,1,-1,-1,1,3,-1
KR_6656664534,440,-4,-9,6,-10,-4,4,0,-3,3,0,-5,5,0,2,2,4,0,1,1,0,-12,-6,0,-3,3,3,0,-1,-1,-1,-1,-1,4,-1
KR_6495341311,420,-1,31,-11,0,1,1,2,-3,6,3,0,1,1,3,0,3,-1,1,0,0,6,1,-2,-6,8,4,0,1,-1,-1,1,-1,3,-1
KR_6759713465,440,-3,-33,0,-9,2,1,3,0,2,2,-8,9,1,-4,5,1,1,1,2,0,-5,7,2,-2,0,0,0,0,0,0,-1,-1,0,-1
KR_6662898851,420,-2,15,12,-2,-2,3,1,1,2,3,0,1,1,-1,5,4,0,0,0,0,0,-13,3,-8,5,0,0,0,1,1,0,1,6,-1
KR_6762618143,440,0,-40,-6,-6,2,2,4,0,4,4,-5,5,0,-4,7,3,1,0,1,0,-6,-2,-1,-1,2,0,0,0,1,0,0,1,4,-1
KR_6751231217,420,-3,-88,12,-2,-2,2,0,3,1,4,-4,4,0,2,1,3,-1,2,1,-1,3,-50,-2,-2,4,39,0,-3,1,-1,-1,-1,2,-1
KR_6753008733,440,-9,-158,-36,-12,-3,4,1,-5,5,0,-2,2,0,2,1,3,-4,4,0,0,-5,8,2,-3,1,-3,0,-2,-1,-1,-1,-1,2,-1
KR_6758696292,420,-2,23,4,-8,3,0,3,-2,3,1,-3,5,2,-3,6,3,-3,5,2,0,-10,2,-4,-1,5,-1,0,-2,1,-1,-1,1,3,-1
KR_6625366174,420,-3,-53,-31,-11,0,3,3,-1,6,5,-5,5,0,-5,5,0,0,0,0,0,-11,1,-1,-4,5,-2,0,-2,-1,1,-1,-1,4,-1
KR_6649732800,420,0,-73,-13,-2,0,2,2,-1,2,1,0,0,0,-2,4,2,1,1,2,0,1,-4,2,-5,3,-4,0,-1,-1,1,-1,1,3,-1
KR_6621300804,440,0,8,8,-1,-6,6,0,3,1,4,-3,7,4,5,1,6,0,0,0,0,-4,-5,1,-2,1,0,0,-1,1,-1,-1,-1,3,-1
KR_6632390608,420,-2,-25,-8,-6,0,1,1,0,1,1,-6,9,3,0,0,0,0,0,0,0,-1,-5,0,-3,3,5,0,-1,-1,1,-1,-1,1,-1
KR_6731594146,420,-2,-69,8,-13,-5,5,0,1,2,3,-2,4,2,-4,5,1,-3,3,0,-1,-10,8,2,-2,0,-2,0,-2,0,-1,-1,-1,0,-1
KR_6757258820,420,0,-35,-4,1,-2,4,2,0,0,0,0,1,1,2,0,2,1,1,2,0,4,-8,-4,-2,6,4,0,0,1,1,0,-1,5,-1
KR_6501739609,420,-5,-66,-4,-12,-7,9,2,-2,5,3,3,1,4,-4,4,0,-2,2,0,0,-9,-3,-2,-4,6,4,0,-2,-1,1,-1,1,5,-1
KR_6264151330,420,-3,56,-12,-3,4,1,5,0,5,5,-4,4,0,-2,2,0,-1,1,0,0,-21,-5,-1,-4,5,4,0,-1,1,-1,-1,-1,1,-1
KR_6758106510,420,-4,-91,-21,-5,-2,4,2,0,2,2,0,0,0,-3,3,0,0,2,2,0,-4,36,-1,0,1,-21,0,-1,-1,-1,-1,-1,5,-1
KR_6731613205,440,1,-31,4,-3,-4,6,2,2,1,3,1,2,3,0,1,1,-2,2,0,0,-1,45,-3,-1,4,-15,0,0,0,-1,1,-1,0,-1
KR_6660658609,420,1,2,11,12,2,2,4,4,1,5,-3,5,2,5,0,5,4,2,6,1,17,-444,2,-4,2,2,0,0,-1,-1,0,1,1,-1
KR_6751155172,420,-2,-36,-16,-9,0,0,0,-4,4,0,0,3,3,-2,4,2,-3,4,1,-1,-10,13,-5,-1,6,2,0,0,-1,0,0,-1,4,-1
KR_6731192887,420,-3,-23,6,-7,3,1,4,1,2,3,-2,3,1,-7,9,2,-2,2,0,0,-11,-4,1,-2,1,-2,0,1,1,1,1,1,6,-1
KR_6761257624,420,-4,-42,3,-12,-3,4,1,-2,5,3,-2,4,2,-7,8,1,2,2,4,0,-13,-20,-4,-1,5,0,0,-1,1,-1,-1,-1,4,-1
KR_6763678974,420,4,70,-24,6,4,0,4,-1,3,2,4,0,4,-2,4,2,1,0,1,0,-3,10,-3,-4,7,4,0,0,1,-1,0,-1,2,-1
KR_6724025768,440,2,63,23,-2,-1,1,0,-2,2,0,0,0,0,-2,3,1,3,0,3,0,-7,0,1,-4,3,0,0,0,0,1,0,-1,0,-1
KR_6753921354,420,-5,-30,-21,-17,-2,3,1,-10,10,0,1,0,1,-6,7,1,0,2,2,0,-20,-30,-3,-6,9,2,0,-1,-1,-1,-1,-1,1,-1
KR_6763164074,420,1,5,28,0,0,0,0,0,0,0,0,0,0,-2,3,1,2,0,2,0,2,19,0,-7,7,-1,0,0,0,0,0,1,0,-1
KR_6760634862,420,2,-3,-16,4,4,0,4,-2,5,3,3,1,4,-1,4,3,0,1,1,2,2,-11,-4,-1,5,1,0,-1,-1,1,-1,1,5,-1
KR_6733819549,420,-1,-11,16,-8,-1,4,3,-3,4,1,-3,3,0,-1,1,0,0,3,3,-1,-10,6,-2,-3,5,-2,0,0,-1,1,-1,-1,3,-1
KR_6718654728,420,-3,-69,-1,-7,0,2,2,0,1,1,-2,2,0,-7,8,1,2,1,3,0,-7,38,-2,-1,3,-25,0,-3,-1,-1,-1,-1,2,-1
KR_6763518219,420,-8,-135,-20,-25,-1,1,0,-5,6,1,-11,12,1,-8,10,2,0,0,0,0,-18,-49,-3,-2,5,12,0,-2,-1,-1,-1,-1,1,-1
KR_6723683916,420,-2,56,0,-4,2,1,3,-5,6,1,-2,2,0,3,1,4,-2,2,0,1,-3,-9,-4,0,4,-2,0,0,-1,0,0,1,2,-1
KR_6650919713,420,-5,-43,-48,-3,-5,7,2,2,1,3,-2,4,2,2,1,3,0,1,1,0,3,-6,-1,-2,3,2,0,-1,1,-1,-1,-1,6,-1
KR_6733280520,420,-6,-121,-76,-13,3,0,3,-1,2,1,0,1,1,-6,7,1,-9,9,0,0,-5,-320,6,-6,0,-7,0,-2,0,1,-1,-1,0,-1
KR_6714703076,440,-4,-19,-4,-6,-2,2,0,2,0,2,-6,6,0,1,4,5,-1,1,0,0,0,71,2,-4,2,1,0,0,-1,1,-1,1,6,-1
KR_6660236868,420,-1,-65,-12,-3,-6,7,1,1,1,2,-2,2,0,4,0,4,0,1,1,0,-2,144,-1,-6,7,-4,0,-2,-1,-1,-1,-1,1,-1
KR_6762758320,420,-1,15,-4,-3,0,3,3,3,3,6,-3,4,1,3,2,5,-6,6,0,0,-3,13,6,-7,1,0,0,1,1,0,1,-1,3,-1
KR_6692435079,440,-2,22,12,-7,-2,2,0,-4,4,0,-2,5,3,0,0,0,1,1,2,0,-1,-3,1,-2,1,-3,0,0,1,0,0,-1,2,-1
KR_6715704806,440,0,-10,8,2,2,1,3,-5,5,0,4,2,6,-1,6,5,2,1,3,0,0,24,3,-7,4,0,0,-1,-1,-1,-1,-1,5,-1
KR_6741257211,420,2,33,40,2,0,2,2,5,0,5,6,2,8,-6,7,1,-3,3,0,0,-3,-3,1,-2,1,3,0,1,1,1,1,-1,3,-1
KR_6628801162,440,-2,-26,-8,-4,-3,3,0,-4,6,2,2,2,4,1,2,3,0,1,1,0,-12,-5,-2,-2,4,-2,0,-1,0,0,-1,1,0,-1
KR_6639599152,440,-2,-11,-28,-6,1,2,3,0,4,4,-3,4,1,-3,4,1,-1,1,0,0,-13,204,3,-6,3,-34,0,1,-1,1,1,-1,2,-1
KR_6264051719,420,-4,-53,-40,-5,-2,2,0,-1,3,2,0,1,1,-2,2,0,0,1,1,0,0,10,-1,-4,5,-7,0,-1,0,1,-1,1,0,-1
KR_6759749091,440,-1,-23,-14,-3,-5,5,0,3,1,4,-3,4,1,1,2,3,1,2,3,0,3,-23,1,-6,5,-3,0,0,0,-1,-1,-1,0,-1
KR_6715565214,420,0,96,21,-2,0,1,1,-7,7,0,5,1,6,0,2,2,0,2,2,1,-7,14,5,-9,4,-3,0,1,0,0,1,1,0,-1
KR_6715500587,420,-3,8,24,-6,-2,2,0,-2,3,1,4,1,5,-5,5,0,-1,1,0,-1,-8,18,1,-4,3,-4,0,-1,1,1,-1,-1,5,-1
KR_6725797541,420,2,6,0,2,2,1,3,1,5,6,1,0,1,-2,4,2,0,1,1,0,1,12,0,-3,3,0,0,0,-1,1,0,1,1,-1
KR_6761081608,420,2,9,21,6,1,2,3,4,0,4,3,1,4,-1,1,0,-1,2,1,0,5,4,2,-3,1,2,0,0,1,1,0,-1,3,-1
KR_6750804591,420,-5,-38,-40,-5,-2,3,1,0,2,2,1,1,2,-4,5,1,0,3,3,1,-6,-26,-4,-1,5,2,0,-3,-1,-1,-1,1,4,-1
KR_6587545909,420,-2,26,0,-5,-7,8,1,0,3,3,5,0,5,-2,3,1,-1,2,1,0,-2,0,0,-5,5,1,0,-1,1,-1,-1,-1,4,-1
KR_6671927518,420,-3,-77,-20,-2,-2,3,1,4,2,6,-2,5,3,-2,3,1,0,1,1,0,4,108,4,-10,6,4,0,-1,-1,-1,-1,1,6,-1
KR_6748013669,420,-2,-24,-16,-7,-6,7,1,2,3,5,2,1,3,0,2,2,-5,7,2,0,0,23,5,-6,1,-3,0,-1,-1,-1,-1,-1,3,-1
KR_6607097261,420,-3,-88,8,-5,1,0,1,3,0,3,-4,6,2,-1,2,1,-4,4,0,0,-9,-23,-2,-1,3,-1,0,-1,-1,-1,-1,1,1,-1
KR_6756787972,420,-2,-57,-20,-9,-2,3,1,0,5,5,-1,3,2,-3,4,1,-3,4,1,0,-4,22,-2,-2,4,-9,0,0,1,-1,-1,-1,6,-1
KR_6605777568,420,-4,-42,6,-14,-7,8,1,-4,4,0,-2,3,1,-1,3,2,0,2,2,-1,-5,-12,-1,-2,3,0,0,-3,-1,-1,-1,-1,3,-1
KR_6649196861,420,-5,-89,-8,-12,-3,3,0,-4,8,4,-2,3,1,-4,6,2,1,0,1,-2,-15,1,-4,-1,5,-2,0,1,-1,1,-1,-1,2,-1
KR_6628088004,420,-2,-35,-7,-6,0,2,2,6,2,8,-2,2,0,-7,9,2,-3,3,0,0,-2,4,-1,-2,3,-5,0,1,-1,1,1,-1,4,-1
KR_6759625446,440,-3,-27,-12,-9,0,0,0,-3,4,1,2,1,3,-6,6,0,-2,2,0,0,-10,3,0,-4,4,1,0,-1,0,1,-1,-1,0,-1
KR_6755663725,420,1,-22,16,4,1,0,1,1,1,2,2,1,3,-2,3,1,2,0,2,1,4,-10,-3,-1,4,-1,0,0,1,1,0,1,1,-1
KR_6669154720,420,0,22,-21,1,2,0,2,4,0,4,-1,1,0,-3,5,2,-1,1,0,2,2,13,4,-7,3,-1,0,-1,1,1,-1,1,3,-1
KR_6752110523,420,-3,3,-20,-6,-6,7,1,0,3,3,2,3,5,-1,4,3,-1,1,0,-1,-3,-1,3,-8,5,-1,0,-1,1,1,-1,-1,2,-1
KR_6743585203,440,-1,-17,48,-7,0,2,2,0,2,2,-1,2,1,-4,5,1,-2,2,0,0,-6,1,2,-3,1,0,0,-1,1,-1,-1,1,6,-1
KR_6360174795,420,3,57,20,4,2,2,4,1,4,5,1,2,3,1,3,4,-1,1,0,-1,-5,0,0,0,0,5,0,0,1,1,1,-1,3,-1
KR_6703752898,420,1,45,-4,-3,1,2,3,-2,6,4,-1,3,2,0,2,2,-1,1,0,0,-4,12,-4,-1,5,-1,0,0,1,0,-1,-1,2,-1
KR_6757789907,420,4,9,-5,8,1,0,1,-2,3,1,7,1,8,3,1,4,-1,1,0,0,1,9,1,-4,3,-2,0,0,-1,1,0,1,5,-1
KR_6634165720,420,-1,-27,9,-5,1,2,3,-3,4,1,-2,4,2,1,0,1,-2,2,0,0,-3,-3,-5,0,5,-1,0,-1,1,-1,-1,-1,3,-1
KR_6750662020,420,-5,-23,-61,-13,-2,5,3,-10,12,2,-2,3,1,2,3,5,-1,2,1,0,-6,-4,-4,-2,6,-7,0,1,-1,1,1,1,3,-1
KR_6682506117,440,-3,-22,0,-10,0,2,2,-5,5,0,-2,2,0,-7,7,0,4,1,5,1,-9,-2,-4,0,4,-1,0,-1,1,0,-1,1,1,-1
KR_6740759791,420,-3,-14,-28,-3,0,3,3,4,0,4,0,3,3,-3,3,0,-4,4,0,1,-2,-11,-1,-3,4,4,0,1,1,1,1,1,6,-1
KR_6758159750,420,-4,-46,-6,-9,-3,4,1,-1,4,3,-4,4,0,-1,2,1,0,0,0,1,-13,-52,-4,-1,5,21,0,0,-1,0,-1,1,5,-1
KR_6758325076,420,2,5,8,1,5,2,7,-1,3,2,-4,4,0,0,1,1,1,0,1,0,-1,21,5,-8,3,-9,0,2,-1,-1,1,1,3,-1
KR_6709922708,440,-3,-73,-36,-4,-3,4,1,-3,3,0,-3,6,3,2,2,4,3,2,5,0,6,-1,2,-6,4,1,0,-1,-1,-1,-1,-1,6,-1
KR_6625717064,420,-5,-39,4,-12,-2,3,1,-7,7,0,1,1,2,0,4,4,-4,5,1,0,-8,2,-4,-2,6,1,0,-2,1,1,-1,-1,4,-1
KR_6668984452,440,-3,-65,-12,-2,2,1,3,0,5,5,0,3,3,-6,7,1,2,0,2,0,-3,-111,1,-5,4,-3,0,-1,-1,-1,-1,-1,1,-1
KR_6761145311,440,5,-9,16,6,2,2,4,3,1,4,-2,4,2,2,3,5,1,2,3,-1,8,-41,1,-3,2,26,0,0,1,-1,0,1,5,-1
KR_6655764255,420,-4,-115,6,-13,-4,5,1,-6,7,1,1,4,5,-5,5,0,1,0,1,0,-10,-24,-3,-2,5,-1,0,-1,-1,1,-1,-1,4,-1
KR_6291019670,420,2,-5,-16,1,-1,2,1,-1,1,0,1,0,1,-1,2,1,3,0,3,0,2,3,2,-5,3,3,0,0,-1,1,1,-1,4,-1
KR_6593661982,420,-2,7,-17,-4,-2,2,0,2,2,4,-3,5,2,-1,3,2,0,0,0,0,-12,-233,2,-3,1,-4,0,1,-1,0,1,-1,3,-1
KR_6651129327,420,-1,-100,19,-5,-2,4,2,-1,5,4,0,2,2,-2,4,2,0,0,0,-1,-2,-5,0,-6,6,0,0,-2,1,-1,-1,-1,5,-1
KR_6620127298,420,-3,-28,-12,-7,0,1,1,-2,3,1,1,1,2,-2,2,0,-4,7,3,-1,-10,-2,-2,-3,5,-6,0,-1,-1,-1,-1,-1,6,-1
KR_6716499441,420,-2,-68,44,-9,1,0,1,-4,6,2,-6,7,1,-2,3,1,2,0,2,0,-17,12,-2,-2,4,-1,0,1,-1,1,1,-1,4,-1
KR_6762822560,420,-3,-109,7,-4,-2,3,1,7,0,7,-4,4,0,-5,6,1,0,0,0,0,-7,292,2,-4,2,-1,0,-2,1,-1,-1,-1,1,-1
KR_6699471247,440,2,32,48,2,0,0,0,0,6,6,-2,3,1,5,0,5,-1,1,0,0,5,108,-6,-2,8,3,0,0,-1,-1,0,1,2,-1
KR_6501061796,420,2,69,-14,1,5,1,6,5,1,6,-6,8,2,-3,3,0,0,1,1,3,8,-12,-5,-2,7,3,0,0,-1,1,1,1,1,-1
KR_6761641036,420,-4,-89,-16,-14,-3,6,3,0,1,1,-5,8,3,0,1,1,-6,6,0,-1,-18,-5,5,-5,0,-4,0,0,-1,1,0,-1,4,-1
KR_6609786019,420,-4,-90,-14,-7,1,1,2,-1,1,0,4,2,6,-9,9,0,-2,3,1,0,-2,2,2,-3,1,2,0,-1,-1,0,-1,-1,5,-1
KR_6389385536,420,-8,-58,-23,-11,-6,6,0,1,3,4,-2,3,1,-4,5,1,0,1,1,1,-3,-9,-4,0,4,1,0,-2,-1,1,-1,1,6,-1
KR_6695176062,420,-3,10,-5,-5,-1,1,0,-1,2,1,3,0,3,-7,8,1,1,1,2,-2,-13,8,1,-5,4,0,0,0,-1,-1,-1,-1,1,-1
KR_6616227471,420,0,49,-36,-2,0,2,2,-2,5,3,1,0,1,2,2,4,-3,4,1,-1,-2,-4,1,-9,8,0,0,0,1,1,0,-1,1,-1
KR_6736785097,420,-2,9,-10,-5,0,1,1,0,3,3,-1,4,3,-3,4,1,-1,2,1,0,-3,128,-1,-2,3,-1,0,0,-1,-1,-1,1,4,-1
KR_6760446434,440,-1,-21,-9,3,2,0,2,-2,4,2,-3,4,1,1,3,4,5,3,8,-2,-3,-5,0,-5,5,-5,0,1,1,-1,1,1,3,-1
KR_6764067589,420,0,-9,-4,-8,0,0,0,-1,2,1,-2,4,2,-5,5,0,0,0,0,-1,-8,2,-1,-4,5,2,0,0,1,-1,-1,-1,6,-1
KR_6625634686,420,-1,5,8,-1,7,2,9,-3,4,1,-3,4,1,-1,1,0,-1,1,0,-1,-10,-8,-5,-4,9,0,0,1,-1,-1,1,-1,1,-1
KR_6761634109,420,-1,0,40,-9,0,0,0,-1,3,2,1,4,5,-6,9,3,-3,4,1,0,-17,1,3,-7,4,-4,0,1,1,1,1,-1,4,-1
KR_6695538989,420,2,-34,-9,-2,3,0,3,1,4,5,-4,5,1,-3,4,1,1,0,1,0,0,47,-5,0,5,22,0,0,-1,-1,0,1,4,-1
KR_6663347459,440,-2,-15,8,-5,-5,5,0,2,2,4,3,0,3,-4,5,1,-1,1,0,-1,-9,8,2,-5,3,-1,0,2,0,1,1,-1,0,-1
KR_6641899315,420,-1,-59,4,-5,-2,4,2,1,1,2,2,0,2,0,1,1,-6,6,0,1,1,-207,2,-3,1,-2,0,1,-1,1,1,1,6,-1
KR_6759927496,420,-1,-26,-16,3,3,0,3,1,1,2,-1,3,2,-2,5,3,2,1,3,-1,4,-7,-3,-2,5,0,0,0,-1,-1,0,-1,1,-1
KR_6731528682,440,0,25,32,0,1,1,2,-1,1,0,1,1,2,-2,3,1,1,2,3,0,-10,2,-1,-2,3,-3,0,-1,-1,-1,-1,1,1,-1
KR_6751182998,420,-10,-117,-17,-16,0,0,0,-8,8,0,-5,5,0,-1,3,2,-2,2,0,0,-8,-90,-3,0,3,1,0,-2,-1,0,-1,-1,6,-1
KR_6762315565,420,-2,-57,16,-10,-4,5,1,0,2,2,0,2,2,-5,5,0,-1,2,1,0,-9,-16,-2,-4,6,6,0,0,-1,1,-1,-1,2,-1
KR_6622555317,440,2,49,33,7,4,3,7,1,2,3,0,4,4,1,2,3,1,4,5,0,2,-124,-6,0,6,2,0,0,-1,-1,1,1,1,-1
KR_6721092536,420,0,-73,-12,-7,-5,6,1,-1,2,1,-1,2,1,-1,2,1,1,2,3,-1,-3,2,2,-4,2,-2,0,0,1,-1,-1,-1,2,-1
KR_6740293225,440,2,-59,20,8,-2,2,0,6,0,6,-1,2,1,1,0,1,4,0,4,0,8,7,8,-12,4,-2,0,1,1,1,1,1,3,-1
KR_6753104471,440,2,9,9,9,5,3,8,1,1,2,0,1,1,1,1,2,2,0,2,-1,13,-6,5,-7,2,2,0,1,1,-1,-1,-1,1,-1
KR_6671907089,420,-4,-129,-20,-6,-4,4,0,4,1,5,-3,5,2,-5,6,1,2,0,2,0,-2,0,-3,-3,6,-4,0,-1,-1,-1,-1,-1,1,-1
KR_6723777042,420,0,14,-12,0,1,1,2,-3,4,1,-2,6,4,5,0,5,-1,1,0,0,-4,298,0,-2,2,-16,0,1,-1,-1,-1,1,4,-1
KR_6746841429,420,-2,-54,32,-12,-7,9,2,1,1,2,1,2,3,-4,4,0,-3,4,1,-1,-7,5,-4,0,4,-2,0,-1,-1,0,-1,-1,1,-1
KR_6723430389,420,1,14,-41,11,2,0,2,2,1,3,5,1,6,1,4,5,1,1,2,0,16,-1,2,-2,0,-1,0,0,-1,-1,1,-1,1,-1
KR_6733819340,420,-4,38,-5,-10,2,2,4,-6,6,0,-2,5,3,-1,3,2,-3,3,0,0,-10,-2,4,-6,2,-3,0,1,-1,0,-1,1,3,-1
KR_6738036596,440,-4,-40,16,-6,1,0,1,-4,8,4,2,0,2,-5,6,1,0,1,1,-1,-12,14,-1,-3,4,2,0,0,1,-1,0,-1,5,-1
KR_6723043547,420,-4,-68,-6,-11,-5,5,0,-2,2,0,-5,6,1,0,1,1,1,0,1,0,-5,-6,-1,-6,7,1,0,-1,-1,0,-1,-1,4,-1
KR_6711221593,420,0,-13,12,4,12,0,12,-6,6,0,-1,2,1,0,1,1,-1,1,0,1,-3,-12,-1,-3,4,1,0,0,1,1,1,1,6,-1
KR_6686583684,440,1,-47,-4,-1,1,3,4,3,0,3,-1,6,5,-2,5,3,-2,3,1,-1,2,4,-6,-1,7,0,0,-1,1,-1,-1,-1,3,-1
KR_6670528727,420,-3,21,-8,-10,-3,4,1,-1,3,2,-3,3,0,-3,4,1,0,0,0,0,-19,-5,-1,-3,4,-2,0,0,1,-1,0,-1,1,-1
KR_6740381083,420,-4,-70,-10,-10,-3,4,1,-6,6,0,-2,3,1,0,2,2,1,1,2,0,-11,-20,-1,-4,5,-3,0,-2,-1,-1,-1,-1,5,-1
KR_6756833776,420,1,-22,2,6,-1,2,1,3,2,5,1,3,4,3,1,4,0,1,1,0,11,-66,4,-7,3,22,0,-1,-1,1,1,1,5,-1
KR_6757078142,440,-3,-101,-20,-4,-1,3,2,-3,5,2,0,4,4,0,5,5,0,1,1,0,-3,6,2,-5,3,-2,0,-1,-1,0,-1,1,4,-1
KR_6504971524,420,-4,-65,-14,-6,-2,3,1,0,2,2,2,0,2,-2,3,1,-4,4,0,0,-9,-39,3,-5,2,17,0,0,-1,0,1,1,4,-1
KR_6760231065,420,-8,-88,-40,-17,-1,2,1,-4,4,0,-6,7,1,-6,7,1,0,1,1,0,-9,-11,-5,-1,6,-3,0,-3,-1,-1,-1,-1,3,-1
KR_6694265414,420,-5,15,-11,-21,-6,7,1,-4,6,2,-1,3,2,-10,10,0,0,1,1,-2,-12,-4,0,-1,1,-1,0,-2,0,-1,-1,-1,0,-1
KR_6694174404,420,-1,-48,-14,-3,2,1,3,0,2,2,-3,3,0,-5,7,2,3,0,3,0,-5,-9,-1,-5,6,-2,0,-2,-1,1,-1,-1,3,-1
KR_6758209297,420,-3,-40,-5,-12,0,4,4,-1,4,3,-5,5,0,-6,6,0,0,1,1,-2,-13,0,-2,-3,5,-4,0,-1,-1,1,-1,-1,6,-1
KR_6734158738,420,-3,24,16,-5,-1,3,2,-1,5,4,0,0,0,-2,6,4,-1,4,3,0,-4,-1,0,-5,5,4,0,-2,-1,-1,-1,1,5,-1
KR_6623374488,420,-5,-86,-4,-21,-4,4,0,-5,5,0,-5,6,1,-6,6,0,-1,2,1,0,-24,-2,-3,-2,5,-3,0,-1,-1,-1,-1,-1,5,-1
KR_6636019193,420,3,0,-21,1,0,1,1,2,2,4,2,0,2,-3,4,1,0,1,1,0,-1,4,0,-1,1,3,0,1,-1,1,1,-1,4,-1
KR_6741273452,420,-5,-84,-14,-6,-5,6,1,-1,2,1,1,2,3,-1,3,2,0,1,1,0,-7,-1,-2,-3,5,3,0,0,1,0,-1,-1,3,-1
KR_6198607105,420,-6,-110,-15,-13,-1,2,1,-7,10,3,-3,8,5,-3,4,1,1,0,1,-1,-4,-10,-6,-1,7,1,0,-2,0,-1,-1,-1,0,-1
KR_6761473440,440,-2,-15,8,-5,-8,8,0,1,0,1,6,1,7,-5,5,0,1,1,2,0,-10,3,-3,-1,4,4,0,1,1,1,-1,-1,5,-1
KR_6724396131,420,-4,32,-25,-7,-5,5,0,-4,8,4,1,1,2,3,1,4,-2,3,1,1,1,-37,-3,-4,7,1,0,0,1,-1,-1,1,6,-1
KR_6750530607,420,-4,-35,-20,-7,-1,2,1,1,2,3,-1,2,1,-5,7,2,-1,2,1,0,-6,4,5,-6,1,2,0,-1,-1,1,-1,-1,4,-1
KR_6701013375,420,-1,-8,16,2,0,1,1,4,1,5,1,1,2,-1,1,0,-2,3,1,0,1,-8,-2,-1,3,-1,0,0,-1,0,0,-1,3,-1
KR_6694050470,420,-6,-82,0,-16,0,1,1,0,0,0,-7,8,1,-6,6,0,-3,4,1,0,-16,-2,-5,0,5,-5,0,-3,-1,-1,-1,-1,3,-1
KR_6759557420,420,-2,3,23,-9,-3,3,0,-2,4,2,-2,2,0,0,0,0,-2,2,0,0,-5,9,-3,-2,5,4,0,1,1,1,1,-1,5,-1
KR_6624827576,420,-2,-42,2,0,2,0,2,-6,7,1,3,1,4,4,1,5,-3,3,0,0,-4,5,0,-2,2,2,0,0,-1,-1,1,-1,2,-1
KR_6753749780,420,0,-1,-1,2,2,2,4,-4,5,1,3,3,6,0,4,4,1,1,2,1,3,11,-4,-1,5,-2,0,0,-1,-1,1,1,4,-1
KR_6646043921,420,-1,1,3,-2,-1,3,2,0,4,4,0,2,2,-3,4,1,2,0,2,-1,-1,-10,-3,-3,6,2,0,0,1,-1,0,-1,6,-1
KR_6717867278,420,0,-59,4,0,-5,5,0,4,3,7,-2,4,2,4,0,4,-1,1,0,0,6,6,6,-7,1,0,0,0,1,-1,0,-1,4,-1
KR_6717821276,420,1,-21,-40,-2,0,3,3,0,1,1,-3,5,2,2,3,5,-1,4,3,0,-2,-5,-2,-2,4,2,0,1,-1,-1,1,-1,1,-1
KR_6751942586,440,-3,25,-36,-8,0,3,3,-4,5,1,0,5,5,-3,5,2,-1,1,0,0,-5,-11,3,-4,1,-3,0,-1,-1,1,-1,-1,2,-1
KR_6700693562,420,-2,-8,-12,-6,-7,7,0,3,2,5,3,1,4,-3,4,1,-2,2,0,1,4,26,2,-2,0,1,0,-1,-1,-1,-1,1,3,-1
KR_6735567729,420,-2,-77,0,-4,1,0,1,-1,3,2,-1,1,0,-3,4,1,0,0,0,0,-9,-27,-6,-1,7,-1,0,-1,1,1,-1,-1,1,-1
KR_6753210019,440,0,8,-8,-4,-4,6,2,0,2,2,-2,4,2,2,1,3,0,0,0,0,-4,0,-4,-2,6,6,0,1,-1,0,1,1,5,-1
KR_6734276890,420,-5,-24,-104,-5,-5,7,2,-2,2,0,5,0,5,-2,4,2,-1,1,0,0,-1,-9,-7,-2,9,-1,0,-1,0,-1,-1,1,0,-1
KR_6756480489,420,-2,18,-33,-3,-1,2,1,2,1,3,-5,6,1,0,1,1,1,0,1,0,-2,-24,0,-2,2,-6,0,-2,1,-1,-1,-1,6,-1
KR_6758655990,440,-4,-90,-40,-11,-9,12,3,-9,9,0,0,2,2,4,2,6,3,0,3,-1,-26,-27,-3,0,3,0,0,-2,1,0,-1,-1,1,-1
KR_6672134669,420,-2,-49,-8,-1,0,1,1,1,1,2,-1,2,1,1,1,2,-2,4,2,0,3,-88,0,-4,4,1,0,-1,-1,1,-1,1,3,-1
KR_6705452831,420,0,-24,16,4,0,2,2,-3,5,2,1,1,2,2,3,5,4,1,5,1,11,1,1,-5,4,1,0,1,0,0,1,1,0,-1
KR_6758773032,440,-10,-74,-23,-26,1,1,2,-7,14,7,-4,4,0,-18,18,0,2,1,3,0,-26,14,0,-2,2,-2,0,-2,-1,-1,-1,-1,6,-1
KR_6745853207,420,-1,-43,18,-15,-1,4,3,-8,8,0,-4,6,2,-1,5,4,-1,1,0,-1,-18,-1,0,-4,4,-2,0,0,-1,-1,-1,-1,5,-1
KR_6745805909,420,-4,-39,-2,-14,-1,3,2,-13,15,2,1,2,3,-2,2,0,1,2,3,0,-10,-13,0,-4,4,-3,0,-3,1,-1,-1,1,2,-1
KR_6720635526,440,-3,-64,-32,-1,-1,1,0,5,2,7,3,1,4,-7,7,0,-1,2,1,0,1,-16,0,-2,2,-6,0,-1,-1,0,-1,-1,1,-1
KR_6763701069,420,-3,2,0,-3,-1,1,0,-5,6,1,-3,4,1,4,3,7,2,0,2,0,-1,-2,-2,-3,5,4,0,-1,0,-1,1,1,0,-1
KR_6759308838,420,3,14,9,-5,2,1,3,-3,6,3,-1,2,1,-4,4,0,1,0,1,0,-2,0,0,-3,3,1,0,0,-1,1,0,1,5,-1
KR_6759657619,420,-4,-15,19,-14,-1,4,3,-10,11,1,-4,4,0,3,2,5,-2,2,0,-1,-15,8,-4,-2,6,-2,0,-1,-1,1,-1,-1,3,-1
KR_6609898114,420,-6,-44,-10,-12,6,3,9,-1,2,1,-7,7,0,-7,9,2,-3,3,0,-1,-16,-21,-5,-1,6,-2,0,-1,-1,0,-1,-1,6,-1
KR_6719114127,420,0,-39,28,0,-5,5,0,3,0,3,2,2,4,-1,8,7,1,0,1,1,-2,-17,7,-8,1,0,0,0,1,1,0,1,6,-1
KR_6762931729,420,-1,21,-39,-2,1,2,3,-3,4,1,0,4,4,0,2,2,0,3,3,-1,-4,-5,-5,-2,7,-1,0,0,0,0,0,-1,0,-1
KR_6704166991,440,-3,-23,-16,-8,-2,3,1,3,2,5,-6,7,1,-1,2,1,-2,2,0,-1,-3,-112,-3,-1,4,0,0,0,-1,1,0,-1,5,-1
KR_6754114946,420,2,-9,0,3,2,0,2,-5,5,0,2,0,2,0,2,2,4,0,4,0,2,-23,4,-5,1,2,0,2,1,1,1,-1,6,-1
KR_6493208297,420,-4,-48,-15,-11,-8,8,0,2,5,7,-3,3,0,1,1,2,-3,3,0,0,-11,-4,2,-3,1,-2,0,-1,-1,1,-1,-1,5,-1
KR_6707375962,420,-1,-16,-9,3,-1,1,0,-2,3,1,-1,3,2,7,1,8,0,2,2,0,4,-13,-5,-1,6,2,0,-1,1,-1,-1,-1,4,-1
KR_6505024411,440,0,80,-20,5,3,1,4,-2,4,2,0,3,3,3,0,3,1,2,3,-1,3,3,-2,-1,3,1,0,0,0,0,1,-1,0,-1
KR_6760502009,420,-3,-102,-17,-3,-1,1,0,-2,7,5,-3,3,0,4,1,5,-1,4,3,-3,-8,-315,-4,-3,7,1,0,-1,-1,-1,-1,-1,5,-1
KR_6759064219,420,-2,-15,-37,-10,1,1,2,-2,5,3,-3,4,1,-3,3,0,-3,3,0,0,-4,-487,0,-3,3,2,0,-1,-1,-1,-1,-1,5,-1
KR_6761467632,420,-2,-16,-15,-10,-2,3,1,-7,8,1,-2,4,2,0,1,1,1,0,1,0,-4,-7,5,-7,2,2,0,-1,0,-1,-1,-1,0,-1
KR_6761774409,420,-3,-17,-11,-9,3,0,3,-2,4,2,-1,1,0,-9,11,2,0,0,0,0,-14,0,4,-6,2,2,0,-1,-1,-1,-1,1,4,-1
KR_6708233251,420,-5,-65,24,-11,0,1,1,-3,5,2,-2,4,2,-7,11,4,1,1,2,-1,-12,5,-3,-5,8,1,0,-1,-1,0,-1,-1,2,-1
KR_6641656251,420,-4,-90,-7,-9,-3,4,1,-6,9,3,3,2,5,-2,2,0,-1,1,0,0,-7,8,4,-4,0,2,0,-1,-1,-1,-1,-1,2,-1
KR_6725325141,420,-3,50,-28,-5,2,0,2,-5,7,2,0,2,2,-1,3,2,-1,1,0,-1,-9,-34,-1,-4,5,1,0,0,-1,-1,-1,-1,6,-1
KR_6756987595,420,3,53,8,5,1,2,3,3,2,5,0,0,0,0,2,2,1,0,1,0,4,-6,2,-3,1,-1,0,1,-1,1,1,1,4,-1
KR_6762220145,420,-7,-22,4,-17,3,1,4,0,2,2,-6,7,1,-13,13,0,-1,1,0,1,-18,-10,-6,-1,7,1,0,-1,-1,1,-1,1,4,-1
KR_6703491871,420,-1,1,-4,6,-3,3,0,4,3,7,2,0,2,4,2,6,-1,1,0,-1,7,-11,-1,-3,4,1,0,-1,1,1,-1,-1,4,-1
KR_6761503234,420,1,-72,17,7,2,0,2,2,3,5,4,0,4,1,5,6,-2,2,0,-1,10,-273,-2,-3,5,-1,0,-1,1,1,-1,-1,6,-1
KR_6758160045,420,0,50,-32,5,1,1,2,1,3,4,2,1,3,1,2,3,0,1,1,1,6,-9,-1,-4,5,1,0,1,1,1,1,1,1,-1
KR_6754447977,420,0,-44,-16,-9,1,0,1,-4,5,1,-2,4,2,-2,2,0,-2,3,1,0,-10,3,-3,-3,6,-3,0,-2,-1,-1,-1,-1,4,-1
KR_6762261183,420,-2,-35,-34,-3,-3,3,0,-5,8,3,0,3,3,3,2,5,2,0,2,-1,-4,-3,3,-9,6,-2,0,-1,-1,-1,-1,1,5,-1
KR_6763151375,420,1,13,-2,-2,0,0,0,0,1,1,-1,3,2,0,2,2,-1,3,2,0,-5,3,-1,-1,2,2,0,0,-1,1,0,-1,1,-1
KR_6761109565,420,-2,-52,12,0,-4,4,0,0,1,1,5,0,5,0,1,1,-1,2,1,-1,3,6,-1,-1,2,-3,0,0,1,-1,1,-1,2,-1
KR_6760033551,420,-2,-15,-25,-1,3,0,3,-1,2,1,-3,4,1,1,1,2,-1,1,0,0,3,-11,-5,-2,7,-1,0,-1,0,0,-1,-1,0,-1
KR_6747575151,420,-4,-20,8,-8,0,2,2,-3,6,3,-4,5,1,-2,5,3,1,0,1,0,-8,195,-1,-5,6,-3,0,-1,0,-1,-1,1,0,-1
KR_6040285403,420,1,22,46,1,0,3,3,1,3,4,3,0,3,-2,2,0,-1,2,1,0,-2,7,0,-6,6,-1,0,0,1,1,-1,1,1,-1
KR_6561205791,420,-4,51,-32,-10,-2,2,0,0,1,1,-1,2,1,-2,6,4,-5,5,0,0,-2,6,0,-4,4,2,0,0,-1,-1,0,1,4,-1
KR_6656444374,420,-7,-24,24,-13,-6,6,0,2,1,3,-4,5,1,-2,3,1,-3,4,1,-1,-5,1,2,-3,1,-3,0,-3,1,-1,-1,-1,6,-1
KR_6682631115,420,-1,-42,18,-5,1,0,1,2,0,2,-7,7,0,1,2,3,-2,2,0,0,-5,-112,0,-4,4,-1,0,-1,-1,-1,-1,-1,6,-1
KR_6633660356,420,0,0,-22,0,-3,3,0,4,0,4,-7,8,1,5,2,7,1,0,1,-1,-2,-4,1,-6,5,2,0,-1,-1,-1,-1,-1,6,-1
KR_6679761134,420,-1,-27,3,-6,0,1,1,-4,5,1,2,1,3,-2,5,3,-2,3,1,0,-8,-155,5,-8,3,-3,0,0,-1,-1,0,1,5,-1
KR_6698739890,420,4,81,24,17,-1,1,0,7,3,10,0,5,5,11,1,12,0,2,2,1,12,-56,-1,-3,4,15,0,2,1,1,1,1,4,-1
KR_6756280263,440,-7,-95,-28,-6,-5,6,1,-3,4,1,2,4,6,-2,4,2,2,0,2,-1,-3,9,2,-3,1,-2,0,-2,-1,1,-1,-1,4,-1
KR_6455018156,420,-4,-85,-31,-7,-2,2,0,0,2,2,-7,8,1,-1,1,0,3,1,4,0,6,-12,-2,-1,3,3,0,-2,0,-1,-1,-1,0,-1
KR_6635483096,420,-1,-8,-28,-4,-2,4,2,-2,3,1,2,1,3,-1,4,3,-1,3,2,0,3,5,-2,-1,3,1,0,1,-1,-1,-1,-1,6,-1
KR_6600095902,420,-5,-73,-21,-8,-2,2,0,2,1,3,-7,7,0,4,0,4,-5,5,0,0,-2,-5,0,-7,7,1,0,0,-1,0,-1,-1,2,-1
KR_6758116750,420,-2,-80,-21,-5,-1,2,1,1,3,4,-1,3,2,-4,6,2,0,0,0,0,-5,-3,-2,-4,6,-4,0,-2,-1,-1,-1,-1,1,-1
KR_6661625926,420,-5,-35,-36,-3,-5,5,0,4,2,6,0,4,4,-3,4,1,1,0,1,1,1,-16,1,-5,4,1,0,-3,-1,-1,-1,1,4,-1
KR_6656558647,440,-7,-66,12,-6,-4,4,0,-1,1,0,-4,4,0,1,2,3,2,0,2,0,3,47,4,-5,1,-28,0,-1,-1,1,-1,-1,3,-1
KR_6717118578,420,0,29,-32,-2,-1,3,2,3,1,4,-1,2,1,-3,4,1,0,2,2,0,-1,23,3,-4,1,-1,0,-1,-1,-1,-1,-1,6,-1
KR_6753952392,420,-1,-82,10,-6,0,1,1,-2,2,0,-1,3,2,-3,5,2,0,1,1,0,-12,0,-2,-1,3,-3,0,-2,1,1,-1,-1,5,-1
KR_5825757957,420,1,31,-3,4,-3,3,0,-1,4,3,10,1,11,-2,2,0,0,0,0,0,1,108,3,-6,3,-1,0,2,1,1,1,1,1,-1
KR_6762167890,420,0,-56,-16,5,-5,5,0,4,2,6,-2,6,4,6,4,10,2,1,3,3,21,1,0,-1,1,3,0,-1,0,-1,-1,1,0,-1
KR_6754804708,420,-1,-93,-16,0,-1,1,0,-1,5,4,4,3,7,-1,1,0,-1,2,1,-1,3,-39,0,-1,1,40,0,-1,-1,0,-1,-1,6,-1
KR_6760764834,420,2,-50,12,-2,4,0,4,-6,9,3,0,4,4,3,3,6,-3,3,0,0,-9,-9,1,-5,4,0,0,-1,1,0,-1,-1,4,-1
KR_6759945507,420,4,40,0,-2,1,1,2,-4,4,0,1,4,5,3,4,7,-3,3,0,-1,-5,-218,2,-4,2,-1,0,0,-1,1,0,-1,6,-1
KR_6655626660,440,-2,14,4,-5,0,3,3,-1,1,0,0,0,0,-2,3,1,-2,5,3,0,-8,-39,-6,-2,8,21,0,0,-1,-1,0,-1,6,-1
KR_6648678573,420,0,52,-8,-3,1,0,1,-3,4,1,4,1,5,-5,8,3,0,2,2,0,-13,6,-2,-2,4,-1,0,0,1,-1,1,1,5,-1
KR_6748707071,420,0,47,7,3,4,0,4,0,3,3,1,1,2,-2,3,1,0,1,1,0,-2,-27,2,-5,3,23,0,0,1,0,0,1,4,-1
KR_6582136170,420,-1,53,-18,-10,3,0,3,-2,3,1,-4,5,1,-7,8,1,0,1,1,0,-12,20,-5,-1,6,-1,0,2,-1,1,1,-1,4,-1
KR_6649263064,420,-3,37,-24,1,-2,3,1,4,1,5,0,3,3,-1,2,1,0,2,2,0,9,0,2,-5,3,-3,0,-1,-1,1,-1,-1,2,-1
KR_6764630707,420,-2,-113,6,-4,-1,2,1,-2,2,0,-1,2,1,0,1,1,0,0,0,0,-3,3,-1,-5,6,-5,0,0,-1,1,0,1,2,-1
KR_6705791551,420,-1,1,-12,-2,-3,4,1,-3,6,3,2,0,2,1,2,3,1,2,3,0,6,274,2,-5,3,2,0,-1,-1,-1,-1,-1,1,-1
KR_6634236812,420,0,-17,20,-9,0,2,2,3,2,5,1,2,3,-13,17,4,0,3,3,0,-3,-7,-1,-5,6,-2,0,-3,-1,-1,-1,-1,3,-1
KR_6759174847,440,-2,6,-3,-8,-1,4,3,1,2,3,0,3,3,-10,13,3,2,1,3,0,-5,11,3,-4,1,1,0,-1,1,-1,-1,1,2,-1
KR_6758735371,440,-5,66,-12,-14,-3,3,0,-1,5,4,-2,3,1,-9,14,5,1,1,2,-1,-16,-6,-3,-3,6,1,0,0,-1,0,-1,-1,2,-1
KR_6711795065,420,-2,-36,-38,-2,-2,3,1,1,4,5,0,3,3,-3,6,3,2,0,2,0,9,0,2,-4,2,-2,0,-3,-1,-1,-1,1,5,-1
KR_6393478102,420,-3,22,-30,-6,4,0,4,-1,2,1,-6,6,0,-2,3,1,-1,2,1,0,-3,-4,-2,-3,5,0,0,1,0,0,1,-1,0,-1
KR_6622598778,420,1,45,32,-4,-2,3,1,0,4,4,-1,2,1,-1,1,0,0,0,0,0,0,-360,-1,-1,2,-3,0,0,-1,-1,0,1,1,-1
KR_6749743734,440,0,-41,4,-1,2,0,2,-3,5,2,-6,6,0,2,1,3,4,0,4,0,1,-17,-4,-4,8,-2,0,0,-1,1,0,1,5,-1
KR_6700510332,420,-2,-28,-8,-4,1,1,2,-3,5,2,1,1,2,-1,3,2,-2,3,1,0,-9,-18,-1,-4,5,2,0,1,-1,-1,1,-1,4,-1
KR_6764512484,420,-2,36,-27,0,-2,3,1,2,2,4,1,2,3,0,3,3,-1,1,0,0,5,3,5,-6,1,1,0,0,-1,-1,-1,-1,5,-1
KR_6760627895,440,-3,7,-7,-5,-3,4,1,5,1,6,1,2,3,-3,5,2,-5,5,0,1,-1,293,-1,-2,3,6,0,-1,0,-1,-1,1,0,-1
KR_6764118566,420,-1,51,20,-1,4,0,4,-2,2,0,4,1,5,-7,9,2,0,2,2,0,-12,187,-1,0,1,0,0,3,1,1,1,-1,6,-1
KR_6660050095,420,2,54,-21,13,6,1,7,-2,3,1,5,1,6,3,0,3,1,1,2,0,15,-29,-1,-5,6,6,0,0,0,0,1,1,0,-1
KR_6607825340,420,1,-22,16,3,-2,3,1,6,2,8,-3,5,2,3,3,6,-1,1,0,0,5,44,0,-5,5,2,0,-1,1,-1,-1,-1,5,-1
KR_6753806702,420,-2,-46,-24,-7,0,2,2,1,0,1,-8,8,0,-1,6,5,1,0,1,-2,0,4,-1,-4,5,-2,0,-2,0,1,-1,1,0,-1
KR_6599931941,420,-8,-101,-24,-14,-2,3,1,-5,5,0,-6,6,0,0,2,2,-1,1,0,0,-17,-195,0,-5,5,-11,0,-2,1,1,-1,1,3,-1
KR_6759555768,420,-7,-102,-12,-13,-4,5,1,-4,5,1,-4,4,0,-1,8,7,0,2,2,0,-5,-4,2,-3,1,-3,0,-3,1,-1,-1,-1,6,-1
KR_6635867487,420,-1,-51,36,0,1,0,1,0,2,2,0,1,1,-2,4,2,1,2,3,0,-3,111,1,-4,3,0,0,0,1,1,0,-1,2,-1
KR_6678332536,420,1,-9,-8,9,-1,1,0,4,3,7,2,1,3,3,1,4,1,1,2,0,10,-121,-5,-2,7,1,0,0,1,-1,0,1,4,-1
KR_6750570837,420,-1,34,-4,-2,-1,1,0,-1,4,3,2,4,6,-2,7,5,0,2,2,1,-6,175,-5,0,5,-2,0,0,0,0,0,1,0,-1
KR_6764210805,420,-1,20,-20,-4,3,1,4,-6,7,1,-1,5,4,0,3,3,0,2,2,-1,-4,-3,1,-1,0,1,0,0,1,-1,1,-1,1,-1
KR_6714845887,420,2,-1,42,3,-3,3,0,7,0,7,2,1,3,-2,2,0,-1,2,1,0,0,39,2,-3,1,-3,0,1,1,0,-1,1,3,-1
KR_6761948490,420,-3,-71,-4,-1,-4,4,0,5,0,5,3,1,4,-2,3,1,-3,4,1,1,7,259,3,-6,3,-1,0,-3,1,-1,-1,1,6,-1
KR_6761721793,420,0,13,1,-3,-2,4,2,2,3,5,-3,5,2,-2,3,1,2,0,2,0,-5,3,-2,-1,3,0,0,0,-1,1,0,-1,2,-1
KR_6717298034,420,2,-17,-5,7,2,1,3,5,2,7,-8,9,1,8,0,8,0,0,0,-2,12,13,-2,0,2,1,0,2,-1,1,1,-1,3,-1
KR_6617668185,440,-7,-89,-50,-6,0,1,1,-1,3,2,-2,3,1,-3,3,0,0,0,0,0,-8,-22,-1,-5,6,5,0,-1,-1,1,-1,1,1,-1
KR_6743002463,420,-3,-6,-4,-9,0,1,1,-6,6,0,-3,4,1,1,2,3,-1,1,0,0,-6,-43,-1,-2,3,25,0,-1,0,-1,-1,-1,0,-1
KR_6764469055,420,1,1,32,-2,-3,4,1,4,1,5,-5,5,0,1,3,4,1,0,1,0,4,11,-3,-5,8,-4,0,0,-1,1,0,-1,3,-1
KR_6758271388,440,-1,-4,-4,-4,0,1,1,3,2,5,-1,3,2,1,0,1,-7,7,0,0,-1,2,3,-4,1,0,0,0,0,1,0,-1,0,-1
KR_6683957232,420,-3,-17,-12,1,-3,3,0,-1,3,2,0,1,1,3,3,6,2,0,2,1,7,-14,4,-4,0,-2,0,0,-1,-1,-1,1,5,-1
KR_6741073151,420,2,34,8,3,8,0,8,4,2,6,-1,3,2,-5,6,1,-3,3,0,0,-4,7,1,-1,0,2,0,1,1,-1,1,1,6,-1
KR_6762170385,420,1,-41,-11,-3,1,1,2,-1,3,2,-2,4,2,0,1,1,-1,1,0,0,-8,-12,2,-7,5,0,0,0,1,1,0,1,4,-1
KR_6762724166,420,-6,-81,-20,-16,-9,10,1,-3,3,0,-4,4,0,2,3,5,-2,3,1,0,-13,-9,-1,-1,2,-2,0,-1,-1,1,-1,-1,5,-1
KR_6754043893,420,4,67,36,6,1,0,1,-1,2,1,1,1,2,4,2,6,1,0,1,0,1,-41,-4,-2,6,7,0,2,-1,0,1,1,6,-1
KR_6649581667,420,-1,22,-8,-6,2,2,4,0,3,3,-8,10,2,0,4,4,0,0,0,0,-7,-154,-2,-4,6,2,0,0,-1,0,1,-1,4,-1
KR_6627724882,420,0,-32,8,0,-2,4,2,2,1,3,-7,9,2,4,1,5,3,0,3,0,6,1,-1,-2,3,-4,0,0,1,1,0,-1,3,-1
KR_6393529183,420,-5,-73,-8,-3,-5,5,0,3,2,5,2,5,7,-4,5,1,1,1,2,0,-2,9,1,-6,5,-1,0,-1,-1,1,-1,-1,6,-1
KR_6738172317,420,-1,-42,-41,-5,3,0,3,-4,4,0,-3,3,0,0,2,2,-1,1,0,0,-6,1,3,-5,2,-1,0,0,1,1,-1,-1,5,-1
KR_6603591009,440,-1,89,-25,-2,1,2,3,2,2,4,-1,1,0,-2,3,1,-2,2,0,0,-3,5,3,-5,2,-2,0,-1,-1,0,-1,1,3,-1
KR_5674992277,420,0,-26,-12,2,-2,4,2,3,3,6,-1,2,1,3,1,4,-1,2,1,0,6,8,3,-7,4,-3,0,1,1,1,1,1,6,-1
KR_6608855508,420,0,-78,-28,3,-2,2,0,3,2,5,-2,3,1,-2,2,0,6,1,7,0,10,-40,1,-4,3,33,0,0,-1,1,1,1,2,-1
KR_6759684608,420,-1,-41,4,-6,-7,7,0,1,2,3,2,2,4,-2,2,0,0,1,1,0,-7,-2,2,-4,2,0,0,1,-1,1,-1,-1,4,-1
KR_6763510923,440,-4,5,-24,-7,-2,3,1,-2,2,0,-4,5,1,4,0,4,-3,4,1,0,-2,21,-2,-3,5,3,0,-1,0,-1,-1,1,0,-1
KR_6659534433,420,-5,0,-12,-12,-2,5,3,-1,2,1,-6,7,1,-1,2,1,-2,4,2,0,-14,-20,-2,-2,4,-2,0,0,1,0,0,1,5,-1
KR_6739150272,440,-3,-45,5,-7,-2,3,1,-2,3,1,2,2,4,-4,4,0,-1,2,1,0,-8,-386,3,-5,2,-2,0,-2,-1,0,-1,-1,3,-1
KR_6693710475,440,-5,-21,6,-8,-4,5,1,-4,4,0,1,2,3,-5,6,1,4,0,4,0,-7,-11,-1,-5,6,-1,0,-2,1,-1,-1,1,4,-1
KR_6714278484,420,-4,-81,-20,-8,-3,3,0,-1,2,1,-3,4,1,-1,4,3,0,1,1,0,-3,-16,-2,-1,3,1,0,-1,-1,1,-1,-1,1,-1
KR_6698483008,420,-2,-44,9,-2,-10,10,0,1,1,2,0,6,6,7,1,8,0,2,2,0,5,-8,1,-5,4,0,0,0,-1,1,1,1,6,-1
KR_6686725461,420,-4,-142,8,-8,-6,7,1,7,5,12,-4,5,1,-2,3,1,-3,4,1,0,3,2,3,-3,0,-3,0,-2,-1,1,-1,-1,6,-1
KR_6755409567,420,-1,26,11,-7,-4,8,4,-7,8,1,2,3,5,2,3,5,0,0,0,-1,-11,-210,2,-6,4,1,0,0,-1,1,0,-1,4,-1
KR_6660575943,420,-2,-37,-10,-4,-3,3,0,-3,3,0,0,1,1,0,4,4,2,0,2,0,-8,11,-3,-6,9,3,0,0,1,1,0,-1,3,-1
KR_6759029487,420,0,19,3,-5,2,2,4,-1,1,0,-6,7,1,-1,3,2,1,1,2,0,-3,-11,1,-5,4,-7,0,1,1,0,1,1,5,-1
KR_6593553877,420,0,37,16,0,3,1,4,3,2,5,-5,6,1,1,4,5,-2,2,0,1,-2,-2,0,-3,3,4,0,0,1,0,0,1,2,-1
KR_6760967186,420,-2,-12,-2,-12,-1,4,3,1,2,3,-1,3,2,-11,15,4,0,2,2,-1,-2,4,2,-4,2,0,0,-1,-1,0,-1,-1,2,-1
KR_6737477733,420,-2,26,-18,-3,0,3,3,0,1,1,-6,7,1,0,0,0,3,0,3,0,1,4,-1,-1,2,-2,0,0,-1,-1,-1,1,4,-1
KR_6696141815,420,-3,-54,-36,-3,0,2,2,-2,4,2,1,2,3,0,2,2,-2,3,1,0,-5,-4,-2,-2,4,1,0,-1,-1,-1,-1,-1,5,-1
KR_6763239164,420,-4,-80,-8,-4,-3,4,1,1,1,2,-4,6,2,0,3,3,2,0,2,0,1,-51,2,-4,2,22,0,0,-1,-1,0,-1,4,-1
KR_6762535498,420,-2,0,-9,0,4,0,4,-2,3,1,0,0,0,-1,2,1,-1,1,0,0,0,-41,1,-3,2,21,0,0,-1,-1,-1,1,5,-1
KR_6703577201,420,-3,-69,12,-8,0,1,1,-3,4,1,1,2,3,-3,4,1,-3,3,0,0,-7,15,-5,-2,7,0,0,0,-1,1,0,1,5,-1
KR_6746797281,420,0,-18,-8,1,2,0,2,2,0,2,4,0,4,-7,9,2,0,0,0,0,2,17,-1,-4,5,-1,0,0,-1,-1,1,1,6,-1
KR_6629088151,420,-5,-81,-24,-7,-3,4,1,-1,2,1,-3,5,2,-2,3,1,2,2,4,0,-3,4,-2,-4,6,-2,0,-2,-1,1,-1,1,4,-1
KR_6764527595,420,-1,-24,-32,-1,-1,2,1,-4,5,1,-1,2,1,7,3,10,-2,2,0,0,6,-45,1,-5,4,3,0,0,-1,1,-1,-1,3,-1
KR_6759526601,420,-2,2,-24,-11,1,1,2,-2,3,1,-1,3,2,-6,6,0,-3,3,0,0,-15,-7,-1,-2,3,1,0,-3,-1,-1,-1,-1,4,-1
KR_6617545259,420,4,-3,0,11,1,1,2,2,1,3,5,1,6,3,0,3,0,1,1,0,9,-3,0,-4,4,1,0,0,-1,-1,-1,-1,3,-1
KR_6710430135,420,2,-13,36,1,-2,2,0,-3,4,1,4,0,4,2,4,6,0,0,0,0,2,28,-1,-3,4,-4,0,-1,-1,-1,-1,-1,4,-1
KR_6722776917,420,-2,1,-11,1,-3,3,0,7,0,7,-4,4,0,-1,3,2,2,0,2,0,3,-2,-3,0,3,0,0,-2,1,-1,-1,-1,3,-1
KR_6761593214,420,-2,23,8,-6,1,1,2,-9,11,2,-2,2,0,2,1,3,2,0,2,0,-11,8,3,-5,2,-3,0,1,-1,1,1,-1,3,-1
KR_6763395086,440,1,-9,-24,-1,-2,3,1,-1,3,2,-4,7,3,5,1,6,1,1,2,0,12,-4,-2,-1,3,1,0,-1,1,-1,-1,-1,6,-1
KR_6598566359,420,-2,-93,16,-12,-1,6,5,-3,5,2,-11,12,1,1,2,3,2,0,2,-2,-8,-2,4,-4,0,1,0,-2,1,1,-1,-1,3,-1
KR_6624758897,420,-1,-35,4,-1,-1,1,0,0,3,3,-4,4,0,5,0,5,-1,1,0,0,2,5,-2,-2,4,-6,0,0,-1,1,-1,-1,5,-1
KR_6731431729,420,-3,-89,-39,-5,-1,1,0,-3,7,4,-3,3,0,2,1,3,0,0,0,0,-4,32,2,-5,3,-2,0,1,1,-1,1,-1,2,-1
KR_6759080513,420,2,24,12,3,0,1,1,4,2,6,3,1,4,-3,3,0,-1,1,0,0,2,-6,3,-5,2,0,0,0,1,1,1,-1,3,-1
KR_6685343249,420,0,-36,28,0,0,0,0,1,1,2,-1,2,1,1,1,2,-1,1,0,1,4,0,-2,-4,6,2,0,0,1,0,0,1,5,-1
KR_6660021537,440,-4,-76,15,-10,-4,5,1,0,4,4,-2,2,0,-4,5,1,0,0,0,-2,-16,-1,-4,-2,6,1,0,-1,-1,1,-1,1,5,-1
KR_6695308687,420,-2,40,-8,-3,6,0,6,-5,6,1,-2,2,0,-3,3,0,1,1,2,-1,-4,12,4,-8,4,-2,0,0,1,-1,-1,-1,2,-1
KR_6609798679,420,-3,-22,-28,-8,-5,5,0,-2,2,0,0,2,2,-1,2,1,0,1,1,0,-7,46,-2,-4,6,0,0,-1,-1,0,-1,-1,6,-1
KR_6634232444,420,-5,-90,-16,-12,-4,4,0,-4,5,1,-4,5,1,1,1,2,-1,1,0,0,-11,11,0,-3,3,1,0,-1,1,-1,-1,1,5,-1
KR_6753028197,420,-4,-7,-4,-17,-1,2,1,1,0,1,-1,4,3,-13,13,0,-3,3,0,0,-16,-2,-3,-6,9,-4,0,-1,-1,-1,-1,-1,4,-1
KR_6761554674,420,-1,43,12,-3,0,1,1,-6,7,1,-2,2,0,3,3,6,2,2,4,0,-2,17,-3,-4,7,2,0,1,1,0,1,-1,2,-1
KR_6707937981,420,-3,-17,0,-4,-6,6,0,3,0,3,-1,1,0,1,0,1,-1,2,1,0,2,-1,-2,-2,4,0,0,-1,1,1,-1,-1,3,-1
KR_6611989684,420,-3,-89,-40,-8,-2,3,1,-1,2,1,-1,1,0,-3,6,3,-1,2,1,-2,-7,102,-3,-1,4,2,0,0,-1,-1,0,-1,1,-1
KR_6758197826,420,-1,-124,6,4,0,3,3,1,2,3,-1,4,3,3,2,5,1,1,2,0,5,53,-2,-1,3,2,0,-1,0,1,-1,-1,0,-1
KR_6686559782,420,-4,-35,-45,-8,2,0,2,-5,5,0,-4,5,1,-1,2,1,0,1,1,0,-4,-11,-1,-1,2,-2,0,-1,-1,-1,-1,-1,2,-1
KR_6753037085,440,0,29,8,3,2,1,3,3,2,5,0,2,2,2,1,3,-4,6,2,2,7,-1,-3,-3,6,8,0,0,1,-1,0,1,2,-1
KR_6728175480,420,-3,-26,-1,-6,-4,5,1,0,0,0,-1,6,5,0,3,3,-1,1,0,0,-8,-115,0,-2,2,-9,0,0,-1,0,0,-1,3,-1
KR_6723070113,420,-7,-91,12,-5,-3,4,1,-3,4,1,0,2,2,-3,3,0,4,2,6,0,-8,-2,-1,-2,3,-2,0,-3,-1,1,-1,-1,4,-1
KR_6525849793,420,0,-28,6,2,-3,3,0,-1,2,1,8,0,8,1,6,7,-3,3,0,0,2,-6,-3,0,3,-1,0,0,1,-1,-1,1,4,-1
KR_6763363588,420,-1,-11,-12,-7,-3,4,1,4,1,5,0,1,1,-7,8,1,-1,1,0,-1,-7,6,-1,-5,6,-2,0,-1,-1,-1,-1,-1,5,-1
KR_6732644766,420,-3,27,-17,-8,-10,11,1,0,2,2,0,3,3,1,2,3,1,1,2,-1,-20,-8,1,-3,2,0,0,-4,1,-1,-1,-1,3,-1
KR_6663155608,420,-1,5,-8,7,1,4,5,-1,3,2,5,3,8,0,4,4,2,2,4,0,-2,2,-2,-4,6,0,0,0,1,-1,-1,1,2,-1
KR_6695748693,420,-3,-8,10,-7,0,2,2,-4,7,3,-5,5,0,2,1,3,0,0,0,1,-5,-6,1,-7,6,3,0,0,-1,1,0,1,3,-1
KR_6762869233,420,-1,-37,-15,-7,-3,3,0,-1,3,2,-1,3,2,0,0,0,-2,2,0,0,-5,9,1,-4,3,0,0,-1,-1,-1,-1,-1,2,-1
KR_6729707670,420,0,-59,8,-5,-2,2,0,-5,5,0,1,1,2,-6,7,1,7,3,10,0,-3,-1,2,-2,0,2,0,0,0,-1,0,-1,0,-1
KR_6724222078,420,2,34,5,6,1,1,2,-3,6,3,-1,2,1,4,1,5,5,0,5,0,3,409,-5,0,5,-1,0,1,1,-1,1,-1,1,-1
KR_6691311711,420,-5,17,-1,-7,0,1,1,-5,7,2,-1,2,1,-1,2,1,0,0,0,0,-8,-197,-1,-3,4,-3,0,0,1,-1,0,1,1,-1
KR_6660168381,420,-2,-78,8,-8,0,1,1,-7,7,0,0,2,2,1,1,2,-2,4,2,0,-6,-21,-3,-3,6,-1,0,-1,1,-1,-1,-1,3,-1
KR_6686262343,440,2,64,8,-2,-1,4,3,-3,5,2,1,4,5,1,3,4,0,0,0,0,-6,-13,-3,-4,7,-24,0,0,0,-1,0,1,0,-1
KR_6695652130,440,-2,-9,4,-18,1,2,3,-5,6,1,-7,8,1,-4,5,1,-3,4,1,-1,-14,-6,-1,-4,5,-1,0,0,-1,-1,1,-1,5,-1
KR_6714409900,420,-5,-100,-20,-5,-3,5,2,-1,2,1,-4,8,4,3,0,3,0,2,2,1,-1,-51,-3,-3,6,24,0,-3,-1,-1,-1,1,4,-1
KR_6599711246,420,-3,-23,-28,-10,5,0,5,-3,4,1,-5,7,2,-7,9,2,0,0,0,0,-6,-315,-3,-1,4,-1,0,-3,-1,-1,-1,-1,2,-1
KR_6728380107,420,-6,-67,-43,-4,-2,2,0,1,1,2,0,2,2,-2,2,0,-1,1,0,0,-6,0,0,-4,4,-4,0,-1,-1,0,-1,1,3,-1
KR_6761888899,440,-1,59,8,0,7,0,7,-7,10,3,0,1,1,-1,3,2,1,0,1,0,-6,-20,-3,0,3,0,0,1,-1,1,1,1,4,-1
KR_6503965245,440,-3,21,8,-6,-1,3,2,-2,4,2,-3,5,2,-3,5,2,3,1,4,0,-3,3,0,-2,2,1,0,0,0,1,1,1,0,-1
KR_6726854877,440,0,-78,8,-7,0,0,0,1,2,3,-1,5,4,1,1,2,-8,8,0,1,-7,2,2,-6,4,-2,0,0,-1,1,-1,1,4,-1
KR_6764602699,420,-1,26,0,-1,1,4,5,2,1,3,-2,2,0,-1,3,2,-1,2,1,0,0,9,1,-5,4,-2,0,0,-1,0,0,-1,2,-1
KR_6606901939,420,-1,2,21,-9,1,3,4,-9,9,0,1,1,2,-2,4,2,0,1,1,0,-13,-6,6,-11,5,-3,0,0,1,1,0,1,5,-1
KR_6764543300,440,0,21,28,-2,-2,2,0,0,0,0,-1,2,1,1,1,2,0,0,0,-1,-4,-1,0,-6,6,1,0,1,0,1,1,-1,0,-1
KR_6742063389,440,-4,65,-4,-5,-4,4,0,0,4,4,2,2,4,-3,4,1,0,0,0,-1,-4,7,3,-6,3,-7,0,-1,1,-1,-1,-1,1,-1
KR_6603251795,420,-4,-19,-32,-6,-1,2,1,-2,4,2,-2,3,1,0,2,2,-1,3,2,0,1,3,1,-4,3,-3,0,-2,0,-1,-1,-1,0,-1
KR_6752995073,420,3,34,-22,5,1,0,1,2,1,3,0,3,3,0,5,5,2,0,2,0,-4,-7,-3,-2,5,0,0,1,0,-1,-1,1,0,-1
KR_6754513441,420,-8,-116,-9,-16,-2,3,1,-12,12,0,-1,3,2,-2,4,2,1,1,2,0,-13,-2,-2,-3,5,17,0,-1,-1,0,-1,-1,6,-1
KR_6729343213,420,-3,-36,8,-5,-1,1,0,1,1,2,-7,8,1,0,2,2,2,0,2,0,3,2,-2,-2,4,-1,0,0,-1,1,1,-1,2,-1
KR_6725895204,420,-3,-24,-4,-7,0,0,0,-1,2,1,-2,3,1,0,1,1,-4,4,0,0,-4,-3,-2,-2,4,-1,0,-1,1,-1,-1,-1,3,-1
KR_6709100364,420,-1,21,8,1,0,4,4,2,2,4,-2,2,0,1,0,1,0,0,0,-1,-2,12,1,-3,2,1,0,1,0,1,1,-1,0,-1
KR_6642212280,420,-4,-62,-32,-5,4,0,4,0,1,1,-2,4,2,-6,6,0,-1,2,1,0,-3,110,0,-3,3,-2,0,-2,-1,-1,-1,-1,6,-1
KR_6012599153,440,0,36,-18,2,5,1,6,-2,2,0,1,2,3,-2,6,4,0,0,0,0,-1,2,-2,-2,4,0,0,1,1,1,1,-1,4,-1
KR_6721418696,440,-2,83,8,-2,-2,3,1,0,3,3,0,2,2,1,0,1,-1,2,1,0,-1,5,-3,-2,5,2,0,0,0,-1,0,1,0,-1
KR_6628436465,420,-5,-7,4,-2,-2,3,1,-4,6,2,2,0,2,-2,2,0,4,0,4,1,0,-6,1,-4,3,1,0,0,1,1,1,1,2,-1
KR_6695406849,420,-6,-112,-26,-18,-5,5,0,-1,1,0,-7,8,1,-4,6,2,-1,3,2,1,-12,-10,0,-3,3,-1,0,-4,-1,-1,-1,1,4,-1
KR_6757035164,420,-1,24,40,-3,1,0,1,1,1,2,-4,4,0,-2,5,3,1,0,1,0,-4,-40,2,-3,1,34,0,0,1,-1,0,-1,2,-1
KR_6700825970,420,1,31,-12,4,4,1,5,4,1,5,1,0,1,-5,7,2,0,0,0,-1,5,-1,2,-4,2,-1,0,1,1,-1,1,-1,1,-1
KR_6760673546,420,0,49,-11,-7,0,1,1,-10,11,1,-1,3,2,0,0,0,4,1,5,0,-4,-39,-4,-3,7,35,0,-1,0,-1,-1,1,0,-1
KR_6730006551,420,-6,-70,-24,-12,-1,1,0,2,2,4,-2,3,1,-8,9,1,-3,3,0,0,-13,43,1,-2,1,1,0,-2,1,-1,-1,1,2,-1
KR_6669046532,420,-4,-48,-21,-4,-2,2,0,1,2,3,-2,4,2,0,1,1,-1,1,0,0,3,-81,7,-8,1,-4,0,-1,-1,-1,-1,1,4,-1
KR_6749289389,420,-3,-74,-20,-7,2,2,4,-3,4,1,-1,4,3,-6,7,1,1,0,1,0,-5,-43,-1,-3,4,22,0,-2,-1,-1,-1,-1,1,-1
KR_6012695107,440,-1,-83,15,-2,-1,3,2,1,5,6,1,0,1,-1,2,1,-2,5,3,0,-6,-10,0,-1,1,-1,0,0,-1,0,-1,-1,2,-1
KR_6762210340,420,-3,-19,-5,-7,2,1,3,-3,5,2,-6,8,2,0,2,2,0,0,0,-2,-6,-14,-4,-3,7,-3,0,0,-1,1,0,-1,5,-1
KR_6745715697,420,-4,37,-63,-10,2,1,3,-2,3,1,-12,13,1,0,1,1,2,1,3,1,-6,34,-1,-2,3,-2,0,1,1,-1,1,1,5,-1
KR_6722750548,420,-4,-67,15,-11,-6,8,2,0,2,2,-4,7,3,0,2,2,-1,4,3,0,-6,-11,1,-2,1,3,0,-2,-1,1,-1,-1,6,-1
KR_6616315841,420,4,3,28,18,8,1,9,4,1,5,2,3,5,1,1,2,3,3,6,1,11,2,2,-4,2,3,0,0,1,1,1,1,5,-1
KR_6201378114,420,-2,-84,2,-5,-2,6,4,-4,4,0,1,1,2,-3,4,1,3,0,3,-1,-3,9,0,-2,2,1,0,-1,-1,-1,-1,-1,2,-1
KR_6737571082,420,-7,-145,-5,-25,-4,6,2,-2,2,0,-3,3,0,-16,17,1,0,0,0,0,-20,-11,-5,-1,6,-1,0,-4,1,-1,-1,-1,5,-1
KR_6665513420,420,-1,58,-19,-5,2,0,2,-1,2,1,0,1,1,-4,4,0,-2,2,0,1,-2,-2,1,-2,1,-2,0,-1,-1,1,-1,1,2,-1
KR_6668853799,420,-4,-64,-24,-3,-3,3,0,1,3,4,3,3,6,-3,5,2,-1,2,1,0,-2,7,-1,-1,2,-3,0,-1,-1,1,-1,1,4,-1
KR_6699177334,420,2,-22,-8,0,-2,3,1,-3,6,3,-1,3,2,6,0,6,0,0,0,0,2,5,1,-3,2,-2,0,1,-1,1,-1,-1,2,-1
KR_6710383562,420,-3,-53,-12,-10,-1,1,0,-2,5,3,-6,6,0,-1,5,4,0,0,0,-2,-11,206,2,-5,3,1,0,-1,-1,-1,-1,-1,3,-1
KR_6736455914,420,-5,-116,13,-11,-2,2,0,-5,5,0,-4,6,2,4,3,7,-4,4,0,-1,-8,-5,2,-4,2,-4,0,-1,-1,-1,-1,1,4,-1
KR_6758968869,420,-4,-26,0,-9,-6,6,0,0,1,1,0,0,0,-4,4,0,1,0,1,0,-6,-4,-1,-3,4,-2,0,-1,-1,-1,-1,-1,4,-1
KR_6736003596,420,-9,-135,-12,-20,-3,4,1,-2,2,0,-7,7,0,-6,7,1,-2,2,0,0,-20,2,-1,-4,5,-2,0,-4,0,-1,-1,-1,0,-1
KR_6760978448,420,-1,-1,-4,2,2,2,4,-5,8,3,1,1,2,4,0,4,0,2,2,0,-2,8,1,-2,1,2,0,1,1,1,1,1,4,-1
KR_6699801558,420,0,18,-24,-8,-1,2,1,-4,8,4,-4,5,1,1,2,3,0,3,3,-1,-2,-62,3,-7,4,-5,0,-1,-1,0,-1,-1,4,-1
KR_6732698457,420,-4,-112,0,-6,-2,5,3,-2,3,1,0,3,3,-1,1,0,-1,1,0,0,-6,-12,-1,-2,3,-4,0,-1,1,-1,-1,-1,1,-1
KR_6719871912,420,0,46,-4,0,5,0,5,-3,4,1,-2,2,0,0,2,2,0,1,1,0,-2,16,-4,-3,7,5,0,1,1,-1,1,1,6,-1
KR_6728631971,420,0,13,12,-2,-4,4,0,3,2,5,-1,2,1,1,2,3,-1,1,0,1,4,35,0,-3,3,1,0,1,1,-1,1,1,1,-1
KR_6741429840,420,-2,-86,4,2,0,0,0,2,2,4,5,2,7,-3,5,2,-2,3,1,0,2,-16,4,-7,3,-4,0,-1,-1,1,-1,1,4,-1
KR_6763949293,420,0,63,-44,2,1,5,6,3,0,3,0,2,2,-2,2,0,0,0,0,0,1,4,1,-4,3,3,0,1,1,-1,1,1,6,-1
KR_6080589318,420,-2,16,6,2,6,0,6,-3,5,2,-3,4,1,2,1,3,0,0,0,0,-7,-10,-4,-4,8,2,0,1,-1,0,1,1,1,-1
KR_6759292888,420,-2,-21,12,0,-2,2,0,-4,6,2,-2,3,1,8,0,8,0,1,1,0,7,-386,-3,-1,4,-1,0,0,-1,-1,0,1,4,-1
KR_6747975801,420,0,17,12,1,1,1,2,-1,2,1,3,1,4,-2,2,0,0,0,0,0,-2,2,0,-4,4,-3,0,0,-1,0,0,-1,1,-1
KR_6752257625,420,-1,-34,-19,-1,-1,1,0,2,0,2,1,2,3,-6,9,3,3,2,5,1,0,5,2,-4,2,-1,0,-1,-1,1,-1,1,3,-1
KR_6670960915,420,-2,-12,13,-6,-8,8,0,0,4,4,-2,4,2,3,1,4,1,0,1,2,2,410,2,-4,2,1,0,-1,1,1,-1,1,1,-1
KR_6663190156,420,-6,-61,-20,-18,-6,6,0,2,1,3,-1,3,2,-8,9,1,-5,5,0,1,-4,-5,2,-5,3,-1,0,-3,-1,-1,-1,1,2,-1
KR_6705955286,420,2,55,12,-2,-1,3,2,3,0,3,2,2,4,-4,5,1,-2,3,1,-1,2,25,0,-1,1,3,0,1,-1,-1,1,-1,2,-1
KR_6720850103,420,2,18,31,5,7,2,9,1,3,4,0,1,1,-4,6,2,1,1,2,-1,2,5,-1,-2,3,-2,0,3,1,1,1,-1,2,-1
KR_6290135984,420,-4,-112,-16,-11,0,1,1,-2,2,0,2,4,6,-10,11,1,-1,2,1,-2,-10,26,1,-3,2,-2,0,-1,0,-1,-1,-1,0,-1
KR_6422761005,440,1,8,4,-5,-4,4,0,-1,4,3,2,1,3,3,1,4,-5,6,1,1,-4,12,-1,-5,6,-3,0,-1,-1,1,-1,1,6,-1
KR_6763483444,420,-1,22,-52,2,1,1,2,3,4,7,2,0,2,-2,2,0,-2,2,0,1,3,10,5,-5,0,1,0,0,-1,-1,1,1,5,-1
KR_6724830793,420,-1,-65,-18,-3,-1,2,1,1,0,1,-1,2,1,0,3,3,-2,2,0,0,-1,-5,-1,-4,5,-1,0,0,-1,1,0,-1,4,-1
KR_6670848104,420,-3,-56,-42,-3,0,2,2,-3,3,0,1,1,2,0,2,2,-1,1,0,0,-3,0,-5,-2,7,0,0,-1,-1,-1,-1,1,5,-1
KR_6752215180,420,-5,-40,4,-8,3,2,5,0,2,2,-5,6,1,-4,6,2,-2,2,0,0,0,-321,-1,-2,3,-4,0,-2,-1,-1,-1,1,2,-1
KR_6764221037,420,1,101,-33,3,3,1,4,2,1,3,-2,4,2,2,2,4,-2,6,4,0,1,81,4,-5,1,-28,0,0,1,-1,1,1,6,-1
KR_6380285209,420,-3,-38,5,-7,1,0,1,1,3,4,-6,8,2,-3,3,0,0,2,2,-1,-1,-6,2,-6,4,-1,0,0,0,-1,0,-1,0,-1
KR_6617647751,420,5,67,-8,14,5,0,5,-2,6,4,3,0,3,1,2,3,7,1,8,1,7,1,2,-5,3,-3,0,1,1,1,1,1,1,-1
KR_6715673468,420,-2,-12,-16,3,0,1,1,0,4,4,2,1,3,5,0,5,-4,5,1,0,7,4,-1,-4,5,-1,0,0,1,0,0,1,2,-1
KR_6730065632,420,1,-26,-25,3,2,3,5,-2,4,2,3,0,3,-1,5,4,1,2,3,0,-4,-107,-5,0,5,3,0,2,-1,1,1,1,1,-1
KR_6760627621,420,-3,-68,-8,-7,-2,2,0,2,2,4,-6,7,1,0,2,2,-1,2,1,0,-3,-6,-4,-1,5,1,0,0,-1,0,0,1,5,-1
KR_6763382984,420,-3,-129,33,1,-2,6,4,-3,7,4,3,1,4,2,1,3,1,0,1,0,7,118,3,-6,3,-3,0,0,1,0,-1,1,1,-1
KR_6650746656,420,-1,-39,12,-7,2,0,2,-1,2,1,0,2,2,-5,5,0,-3,3,0,0,-9,32,-3,-3,6,-2,0,-1,1,-1,-1,-1,2,-1
KR_6382618920,420,-1,-74,49,1,-3,3,0,4,1,5,0,3,3,0,0,0,0,0,0,2,5,2,0,0,0,0,0,0,1,1,0,1,4,-1
KR_6758358810,420,-3,-90,6,-9,-4,4,0,-5,7,2,1,1,2,0,1,1,-1,2,1,-1,-8,141,-1,-3,4,-5,0,-3,1,-1,-1,-1,2,-1
KR_6726524094,440,-3,-28,-27,-10,-2,2,0,0,3,3,-2,2,0,-7,12,5,1,0,1,-1,-19,18,-3,-3,6,-1,0,-1,-1,0,-1,-1,4,-1
KR_6748699560,420,-2,-32,16,-10,1,1,2,0,3,3,0,1,1,-6,7,1,-5,6,1,1,-6,-8,0,-4,4,-5,0,-1,0,-1,-1,1,0,-1
KR_5665733549,420,-4,-161,-20,-5,-3,3,0,0,2,2,-6,8,2,7,0,7,-3,3,0,1,5,-4,-3,0,3,-2,0,-1,1,-1,-1,-1,2,-1
KR_6639439764,420,0,25,12,3,-3,4,1,4,2,6,2,1,3,2,1,3,-2,3,1,0,5,281,2,-3,1,2,0,1,1,1,1,-1,1,-1
KR_6743028097,420,-1,-34,0,0,-3,3,0,4,0,4,2,1,3,-1,3,2,-2,2,0,0,5,5,-3,-3,6,-8,0,-1,-1,-1,-1,-1,5,-1
KR_6755653352,420,-5,-9,-32,-19,-4,4,0,-1,2,1,-7,7,0,-3,4,1,-4,4,0,0,-17,-56,-1,-2,3,24,0,-2,1,-1,-1,1,2,-1
KR_6761682756,420,-4,0,-20,-7,-1,1,0,-4,4,0,1,2,3,-3,5,2,0,2,2,0,-1,112,1,-2,1,1,0,-2,1,1,-1,-1,3,-1
KR_6760588490,440,-1,-82,4,-6,0,2,2,3,1,4,-2,2,0,-5,7,2,-2,3,1,-1,-10,241,-1,-1,2,-5,0,-1,1,1,-1,-1,6,-1
KR_6615855209,420,-2,-25,-55,0,2,2,4,0,3,3,-1,3,2,-3,4,1,2,1,3,0,0,1,3,-6,3,-2,0,0,-1,0,0,1,1,-1
KR_6758768854,420,-1,36,40,0,-1,2,1,-2,2,0,0,1,1,3,1,4,0,2,2,0,-3,7,2,-5,3,-2,0,-1,0,-1,-1,1,0,-1
KR_6759284839,420,-1,-65,8,-8,2,0,2,-2,4,2,0,2,2,-7,7,0,-1,2,1,0,-7,-138,-3,-2,5,0,0,-1,1,-1,-1,-1,4,-1
KR_6760813990,420,-1,-68,-39,-6,0,1,1,3,3,6,0,2,2,-9,11,2,0,2,2,-1,3,-4,0,0,0,3,0,0,-1,1,-1,-1,3,-1
KR_6722527515,420,-3,-11,42,-14,0,1,1,-2,5,3,-5,8,3,-7,8,1,0,2,2,-3,-22,4,-3,-5,8,-3,0,-2,1,-1,-1,-1,1,-1
KR_6713885972,420,-1,-20,-20,-1,-1,2,1,1,3,4,-6,6,0,4,1,5,1,0,1,0,6,8,-4,-4,8,-1,0,0,0,0,0,-1,0,-1
KR_6759691818,420,-5,-51,-12,-19,-2,4,2,-1,2,1,-8,9,1,-4,4,0,-4,4,0,0,-23,-8,-3,-3,6,-4,0,0,-1,0,0,-1,6,-1
KR_6706082536,420,4,1,28,6,3,0,3,1,0,1,0,2,2,-3,3,0,5,4,9,0,5,-5,-4,-2,6,0,0,0,1,-1,1,-1,3,-1
KR_6706429858,420,2,96,20,-2,2,0,2,-5,6,1,0,1,1,1,1,2,0,0,0,0,-3,13,-1,-4,5,-5,0,0,-1,-1,0,-1,4,-1
KR_6355410903,420,0,4,-35,-6,-2,3,1,-6,8,2,0,1,1,-1,4,3,3,0,3,0,-9,0,0,0,0,0,0,0,-1,1,0,1,6,-1
KR_6749398814,420,0,17,0,0,-4,5,1,0,1,1,6,3,9,-2,3,1,0,3,3,-1,-2,14,-1,-3,4,-2,0,-3,0,-1,-1,-1,0,-1
KR_6639089138,440,-3,-13,-28,0,-1,5,4,1,1,2,0,1,1,-2,5,3,2,1,3,0,-1,-17,-3,-1,4,3,0,0,-1,-1,0,-1,3,-1
KR_6756899447,420,1,5,-13,3,5,1,6,1,1,2,2,4,6,-4,4,0,-1,1,0,0,-2,-111,-3,-2,5,2,0,1,1,1,-1,-1,1,-1
KR_6627996851,420,-2,-39,-13,-5,-1,4,3,1,1,2,-5,5,0,0,1,1,0,1,1,0,-1,1,-2,-2,4,-4,0,-1,-1,-1,-1,-1,1,-1
KR_6729484473,420,0,6,-21,0,1,3,4,-1,3,2,1,2,3,1,1,2,-2,3,1,1,8,-13,-1,-5,6,4,0,0,-1,-1,0,1,1,-1
KR_6760880800,440,-1,-3,7,-3,4,0,4,0,1,1,-5,5,0,0,3,3,-2,4,2,-1,-1,0,2,-2,0,1,0,0,1,-1,0,-1,6,-1
KR_6752859947,420,1,19,8,-3,1,4,5,2,1,3,-5,5,0,-2,4,2,1,1,2,2,5,-67,-1,-3,4,4,0,0,-1,1,1,1,5,-1
KR_6758165838,440,-4,-62,-5,-10,1,0,1,-1,4,3,-5,6,1,-6,6,0,1,0,1,0,-7,-19,-3,-2,5,4,0,-2,1,1,-1,-1,6,-1
KR_6755055406,420,4,66,-20,11,2,0,2,5,1,6,2,2,4,1,4,5,1,0,1,0,12,15,2,-9,7,4,0,1,1,1,1,1,5,-1
KR_6651313421,420,-4,-43,12,-11,-5,5,0,-1,4,3,0,3,3,-6,6,0,1,2,3,1,-14,-39,1,-6,5,-2,0,-2,-1,0,-1,1,5,-1
KR_6759041837,440,-3,-27,1,-4,0,2,2,0,1,1,3,1,4,-8,10,2,1,1,2,0,-8,2,0,-7,7,-6,0,0,-1,1,0,1,3,-1
KR_6742802887,420,-4,-12,-36,-5,1,1,2,-2,3,1,-3,3,0,-2,4,2,1,0,1,0,-2,308,-2,-1,3,-3,0,-1,-1,-1,-1,1,1,-1
KR_6707045790,420,-3,-82,5,-10,-5,6,1,-1,2,1,-2,4,2,-1,1,0,-1,1,0,0,-6,-122,-4,-1,5,-2,0,-2,-1,-1,-1,-1,6,-1
KR_6702181715,420,-3,-61,4,-3,-3,3,0,-1,3,2,0,4,4,2,0,2,-1,1,0,0,1,0,0,-1,1,0,0,-1,-1,-1,-1,1,3,-1
KR_6733040322,420,-4,-38,-42,-4,0,3,3,-6,7,1,-1,1,0,3,0,3,0,0,0,0,-7,31,-2,-1,3,-30,0,-1,1,-1,1,-1,6,-1
KR_6626813712,440,-4,-121,-9,-6,-9,12,3,2,0,2,-3,4,1,-2,9,7,6,0,6,0,6,-10,-3,-2,5,1,0,-2,1,-1,-1,1,4,-1
KR_6708652977,420,-2,-30,0,-5,-3,4,1,0,0,0,3,0,3,-4,6,2,-1,4,3,0,-4,-34,-4,-4,8,10,0,0,-1,-1,1,1,1,-1
KR_6758931336,420,1,-84,-8,5,-2,2,0,2,1,3,-1,2,1,5,0,5,1,0,1,0,12,-53,-1,-4,5,26,0,-1,1,-1,-1,1,3,-1
KR_6705437392,420,-5,-1,-32,-16,-8,11,3,-2,4,2,0,3,3,-3,3,0,-3,3,0,-1,-14,-10,-1,-2,3,1,0,-3,-1,0,-1,-1,1,-1
KR_6731690049,420,2,59,-16,1,-3,4,1,-3,4,1,1,1,2,7,1,8,-1,1,0,0,3,-55,-1,-3,4,27,0,1,-1,-1,1,-1,4,-1
KR_6723669485,420,-3,-33,-8,-3,1,1,2,-3,5,2,4,4,8,-3,4,1,-2,3,1,0,1,11,-1,-1,2,-1,0,-1,-1,-1,-1,1,5,-1
KR_6662776833,420,0,40,-20,-3,0,0,0,1,2,3,-2,5,3,-1,3,2,-1,1,0,1,-5,18,-4,-3,7,-4,0,0,-1,-1,0,1,2,-1
KR_6724396861,420,-1,-68,-2,-6,-7,7,0,-1,4,3,-3,4,1,5,0,5,0,0,0,0,0,0,0,-3,3,2,0,-2,-1,-1,-1,-1,6,-1
KR_6758959582,420,-2,-15,-40,3,-1,2,1,1,2,3,-1,1,0,5,1,6,-1,2,1,0,1,-50,0,-6,6,28,0,-1,-1,-1,-1,1,5,-1
KR_6699777079,420,-2,-61,-8,-5,-6,6,0,-1,2,1,5,0,5,-4,5,1,1,1,2,-1,-8,-1,-4,-4,8,0,0,-1,1,-1,1,1,3,-1
KR_6753794895,420,-4,-39,-2,-10,-1,1,0,-5,6,1,-3,6,3,-2,6,4,1,2,3,0,-18,2,2,-3,1,-3,0,-1,-1,-1,-1,-1,1,-1
KR_6638054159,420,-2,-95,-9,-2,1,2,3,-1,4,3,1,2,3,-4,5,1,1,2,3,0,-2,-9,-2,-4,6,2,0,0,-1,-1,0,-1,2,-1
KR_6605373744,440,-1,-35,4,-7,6,1,7,-3,4,1,-2,4,2,-2,3,1,-6,7,1,0,-16,-5,-5,0,5,5,0,-2,-1,-1,-1,-1,1,-1
KR_6752093658,420,-3,-7,-26,-8,-3,3,0,-5,6,1,2,0,2,-1,5,4,-1,3,2,0,-9,-102,-3,-4,7,-2,0,0,0,1,0,1,0,-1
KR_6709986025,440,-1,-62,0,-6,2,0,2,0,3,3,-1,3,2,-6,8,2,-1,2,1,0,-4,2,-2,-4,6,1,0,0,-1,-1,0,-1,3,-1
KR_6711445922,420,-4,-13,-3,-16,-3,3,0,-3,5,2,-1,2,1,-8,10,2,-1,1,0,0,-11,-5,-4,-4,8,-4,0,-1,-1,0,-1,-1,6,-1
KR_6739074384,420,1,-16,0,12,-2,3,1,6,3,9,1,1,2,5,1,6,2,2,4,0,16,14,-7,-1,8,2,0,1,-1,-1,1,1,2,-1
KR_6737839120,420,0,-8,-13,-6,-6,6,0,-1,1,0,0,2,2,1,0,1,0,0,0,0,-2,244,0,-2,2,-1,0,-1,1,-1,-1,-1,5,-1
KR_6759853254,420,2,27,29,0,0,2,2,5,2,7,-6,7,1,0,3,3,1,1,2,0,1,-1,1,-3,2,0,0,0,-1,-1,1,-1,2,-1
KR_6760698644,420,0,0,-15,-2,1,0,1,-7,9,2,0,1,1,4,2,6,0,1,1,0,2,2,0,-2,2,2,0,0,-1,1,0,-1,4,-1
KR_6753763849,420,-4,-66,20,-8,-3,3,0,-3,3,0,0,1,1,-2,7,5,0,1,1,0,-4,-28,1,-5,4,0,0,0,-1,-1,0,1,4,-1
KR_6760276658,440,2,-92,-8,3,5,0,5,3,2,5,-1,4,3,-2,2,0,-2,2,0,0,3,10,-2,0,2,4,0,-3,-1,-1,-1,-1,6,-1
KR_6761959972,420,-2,-71,-28,-8,1,0,1,-1,2,1,-2,3,1,-3,4,1,-3,5,2,0,-9,-8,-2,-3,5,-2,0,0,-1,-1,0,-1,4,-1
KR_6736269251,420,-2,-21,-16,-8,0,1,1,-3,3,0,0,2,2,-6,6,0,1,0,1,0,-8,-2,-3,-2,5,1,0,1,-1,-1,1,-1,5,-1
KR_6734991610,420,4,32,24,7,1,2,3,1,2,3,1,2,3,3,0,3,1,1,2,0,6,14,0,-4,4,0,0,1,-1,1,1,-1,5,-1
KR_6669267893,420,0,43,13,-1,-2,3,1,-2,5,3,3,2,5,0,1,1,0,0,0,0,-6,-116,0,-8,8,-2,0,-1,-1,-1,-1,1,6,-1
KR_6760677451,440,-1,41,-35,1,4,0,4,-5,5,0,-4,5,1,4,1,5,2,1,3,0,-2,-4,0,-5,5,2,0,0,1,1,-1,-1,3,-1
KR_6649024616,420,1,14,-8,2,1,0,1,-1,2,1,3,0,3,1,1,2,-2,2,0,0,1,5,2,-5,3,0,0,0,1,1,0,-1,2,-1
KR_6758976859,420,-3,-84,-8,-8,-1,3,2,-5,7,2,-2,3,1,-2,6,4,2,3,5,-2,-4,0,-1,-1,2,-1,0,0,0,1,0,-1,0,-1
KR_6754854578,420,2,11,-24,3,2,1,3,1,1,2,0,4,4,-1,2,1,1,1,2,0,-1,8,0,-3,3,3,0,-1,0,-1,-1,1,0,-1
KR_6735935472,420,-3,-93,28,-4,-4,5,1,-4,4,0,-1,2,1,2,5,7,3,3,6,0,-8,16,0,-6,6,-2,0,-2,1,1,-1,-1,4,-1
KR_6699993690,420,2,3,-12,8,-2,2,0,2,3,5,1,0,1,3,0,3,4,0,4,0,13,308,2,-3,1,-1,0,1,0,1,1,-1,0,-1
KR_6742480534,420,-4,-48,-24,-8,1,0,1,5,0,5,-3,3,0,-4,5,1,-7,7,0,0,-1,5,2,-2,0,-1,0,1,0,1,-1,-1,0,-1
KR_6692393365,420,2,15,6,5,-2,2,0,-2,3,1,2,0,2,7,0,7,0,1,1,0,1,-10,-2,-3,5,2,0,1,1,-1,-1,1,1,-1
KR_6730511196,420,-3,-61,-18,-7,2,2,4,-2,3,1,-5,5,0,-3,4,1,1,0,1,0,-5,-22,0,-5,5,5,0,-1,-1,1,-1,-1,6,-1
KR_6649381725,420,-4,-82,14,-4,-2,3,1,-2,5,3,-1,1,0,-1,3,2,2,0,2,0,-1,7,0,-4,4,-5,0,-1,1,1,-1,-1,6,-1
KR_6718524819,420,-1,28,5,-2,0,3,3,1,1,2,-2,6,4,-2,4,2,1,0,1,0,-8,-10,-2,-3,5,6,0,0,1,-1,0,1,2,-1
KR_6763408348,440,-1,-13,16,-5,6,0,6,-1,3,2,-7,7,0,-4,7,3,1,0,1,0,-2,20,3,-6,3,-7,0,2,-1,1,1,1,4,-1
KR_6717101657,420,-3,-18,5,-5,1,0,1,-4,4,0,-3,5,2,1,1,2,0,1,1,-1,-8,-44,-2,-4,6,29,0,0,1,1,0,-1,4,-1
KR_6705731647,420,-3,-52,-35,-7,-3,4,1,-3,9,6,-2,3,1,-2,4,2,3,1,4,-1,-6,324,-5,0,5,4,0,-1,-1,-1,-1,-1,4,-1
KR_6694621965,420,-6,-66,-28,-5,0,3,3,-4,5,1,-1,2,1,-1,1,0,1,1,2,1,-4,-2,4,-6,2,-2,0,-1,-1,0,-1,1,3,-1
KR_6721045424,420,3,-10,50,-5,1,0,1,0,2,2,-4,5,1,-1,3,2,-1,1,0,0,-3,0,-2,-2,4,0,0,0,-1,-1,0,-1,2,-1
KR_5664172431,420,-5,-128,-50,-6,0,2,2,6,7,13,-6,6,0,-4,5,1,-2,3,1,0,5,-2,2,-8,6,1,0,-3,-1,-1,-1,-1,5,-1
KR_6715447863,420,-8,-80,-55,-10,-2,3,1,-10,10,0,-2,3,1,5,1,6,-1,1,0,0,-6,-13,-2,-2,4,2,0,-2,-1,-1,-1,-1,1,-1
KR_6727900111,420,-1,26,-3,-4,1,1,2,-1,2,1,-2,5,3,0,1,1,-2,3,1,0,-2,-16,-2,-3,5,1,0,0,1,0,1,-1,6,-1
KR_6745954900,420,-3,-25,-32,-12,-4,4,0,0,4,4,-1,2,1,-4,6,2,-3,3,0,0,-9,-23,-2,-1,3,0,0,0,0,-1,0,-1,0,-1
KR_6759361963,440,-2,-38,4,1,-1,2,1,-3,6,3,5,1,6,0,6,6,0,1,1,3,1,-6,-2,-3,5,-4,0,1,0,-1,1,1,0,-1
KR_6755613301,440,-1,-29,-12,-5,-6,7,1,-3,3,0,1,2,3,3,0,3,0,0,0,0,2,-2,4,-8,4,-4,0,-1,-1,1,-1,-1,2,-1
KR_6762360471,420,-3,-78,6,-6,0,7,7,5,0,5,-4,4,0,-4,5,1,-3,3,0,0,0,-1,2,-4,2,-1,0,0,1,0,-1,1,4,-1
KR_6724086897,440,-8,-69,-42,-9,-6,7,1,1,1,2,-4,5,1,0,3,3,0,0,0,-1,-9,-1,0,-4,4,-8,0,0,1,-1,-1,-1,3,-1
KR_6719532150,420,-6,-107,-28,-18,-9,10,1,-3,5,2,-2,2,0,-4,4,0,0,1,1,0,-8,4,-3,-2,5,-2,0,-3,-1,-1,-1,1,6,-1
KR_6728104384,420,-3,-46,28,-9,2,0,2,-3,4,1,-6,6,0,-2,2,0,0,0,0,0,-3,-6,3,-4,1,1,0,-1,-1,1,-1,-1,2,-1
KR_6744027090,440,-3,-59,-6,-3,2,1,3,-2,3,1,0,3,3,3,1,4,-6,7,1,1,-1,1,1,-8,7,-3,0,0,-1,-1,0,1,4,-1
KR_6753154514,420,-2,-1,-36,0,-1,2,1,-3,4,1,0,2,2,2,2,4,2,0,2,0,4,-2,-3,-3,6,-2,0,1,0,-1,1,1,0,-1
KR_6735591755,420,-4,-115,12,-6,-5,7,2,-3,4,1,-1,2,1,0,0,0,3,1,4,0,6,-6,-1,-2,3,-1,0,-1,-1,0,-1,1,3,-1
KR_6756063926,420,2,-18,36,8,4,0,4,0,4,4,-1,3,2,4,0,4,1,0,1,1,4,-1,-2,-4,6,-4,0,0,1,-1,0,1,6,-1
KR_6688948221,420,0,-42,-21,-5,-2,2,0,-1,3,2,0,1,1,1,1,2,-3,3,0,0,-1,5,3,-6,3,-3,0,0,-1,0,0,-1,2,-1
KR_5797738680,420,1,-51,17,-4,3,0,3,2,4,6,2,0,2,-10,13,3,-1,3,2,0,0,3,-1,-6,7,1,0,1,1,1,1,-1,5,-1
KR_6763201202,440,0,41,0,-1,2,0,2,-2,3,1,2,0,2,-2,2,0,-1,1,0,0,-8,20,-1,-4,5,1,0,0,1,0,-1,1,4,-1
KR_6686053463,420,-2,-90,7,-3,-2,3,1,-1,2,1,0,1,1,1,1,2,-1,1,0,-1,3,44,4,-6,2,-7,0,-1,-1,-1,-1,-1,1,-1
KR_6763099662,420,5,23,34,8,5,0,5,-2,2,0,6,1,7,0,1,1,-1,1,0,0,0,-14,-3,-1,4,-3,0,1,-1,0,1,-1,2,-1
KR_6663502755,420,-3,-34,16,-6,-3,5,2,2,2,4,-4,6,2,0,1,1,-1,1,0,-1,-2,-14,-4,0,4,1,0,-1,1,-1,-1,-1,5,-1
KR_6759293334,420,0,57,-42,2,4,0,4,-2,2,0,-2,4,2,3,3,6,-1,1,0,1,-2,25,-1,-3,4,-3,0,0,-1,-1,1,1,6,-1
KR_6663079724,420,-5,-76,-28,0,1,1,2,-1,3,2,-1,2,1,-2,2,0,3,0,3,0,-5,6,-1,-4,5,0,0,0,-1,1,0,1,3,-1
KR_6762740013,420,-3,-5,-24,1,-1,2,1,2,2,4,-4,4,0,2,0,2,2,0,2,0,8,16,1,-3,2,-1,0,-2,1,-1,-1,-1,5,-1
KR_6731371646,440,2,123,-28,2,-1,1,0,-7,7,0,4,3,7,4,2,6,2,0,2,0,-1,3,-1,-1,2,3,0,1,-1,1,1,1,6,-1
KR_6652008339,420,-6,-73,-24,-16,-1,2,1,-5,6,1,-9,10,1,-3,3,0,2,1,3,0,-17,1,-1,-3,4,-2,0,-2,1,1,-1,-1,2,-1
KR_6593602523,420,-3,-18,-12,-4,-1,1,0,4,1,5,0,2,2,-4,6,2,-3,5,2,0,-1,-5,-2,-2,4,2,0,0,1,-1,-1,-1,4,-1
KR_6735806751,440,0,-81,16,-5,-6,6,0,3,2,5,-3,6,3,1,3,4,0,0,0,-1,-3,13,-3,-3,6,-1,0,-1,1,-1,-1,-1,2,-1
KR_6752397762,440,-3,35,-18,-7,0,2,2,-2,4,2,0,0,0,-3,6,3,-2,2,0,0,-10,-33,-2,-5,7,4,0,-1,-1,-1,-1,1,5,-1
KR_6761140827,420,-2,-23,-27,-1,1,2,3,-2,3,1,0,2,2,2,2,4,-2,2,0,0,1,-7,1,-4,3,1,0,0,1,-1,0,1,4,-1
KR_6722300985,420,-3,-40,-35,-6,-1,4,3,1,1,2,-7,8,1,-2,3,1,3,0,3,0,0,-41,0,-4,4,3,0,-1,-1,0,-1,-1,2,-1
KR_6720020975,420,-3,-30,-12,-10,0,3,3,-4,8,4,-3,3,0,-3,4,1,0,0,0,0,-10,-12,-3,-6,9,-6,0,-1,0,1,-1,1,0,-1
KR_6634116755,420,-5,-114,5,-15,-1,2,1,-4,4,0,-2,4,2,-7,7,0,-1,1,0,0,-13,6,0,-3,3,-1,0,-1,1,1,-1,-1,5,-1
KR_6759835631,440,-2,-70,28,-8,-2,2,0,4,2,6,-3,4,1,-4,4,0,-3,3,0,0,-5,-27,0,-6,6,3,0,-1,-1,1,-1,-1,5,-1
KR_6750921148,420,-3,-26,-18,-3,2,0,2,-3,3,0,0,2,2,-2,3,1,0,0,0,0,-3,-4,6,-8,2,-1,0,-1,1,1,-1,1,4,-1
KR_6684242363,440,2,65,4,2,4,2,6,3,1,4,-3,4,1,-1,4,3,-1,1,0,0,0,-3,1,-6,5,-1,0,0,0,-1,0,-1,0,-1
KR_6619812853,420,-3,-42,-12,-2,0,2,2,-5,5,0,2,0,2,2,0,2,-1,1,0,0,-2,-4,-1,-5,6,0,0,0,-1,0,0,-1,2,-1
KR_6744614283,420,1,-15,8,4,3,1,4,4,0,4,0,3,3,-3,4,1,0,0,0,0,2,0,-4,-4,8,0,0,1,-1,1,1,-1,5,-1
KR_6680621637,420,0,50,0,-7,1,2,3,-3,3,0,-4,7,3,2,5,7,-3,4,1,1,-2,-1,-2,-5,7,2,0,0,1,-1,-1,1,6,-1
KR_6663484018,420,1,-43,-20,4,0,4,4,1,0,1,4,1,5,1,2,3,-2,3,1,1,12,-5,2,-4,2,1,0,0,1,-1,-1,1,3,-1
KR_6724860151,420,-1,-42,-16,3,-2,4,2,-1,3,2,4,0,4,1,0,1,1,0,1,0,4,-18,1,-6,5,1,0,0,1,-1,0,-1,5,-1
KR_6759189427,420,-1,-77,20,-8,-2,3,1,-6,9,3,-1,1,0,1,1,2,0,0,0,0,-9,6,-2,-1,3,0,0,-2,-1,-1,-1,-1,2,-1
KR_6760741207,420,-2,-97,-1,-3,-3,4,1,0,1,1,1,2,3,1,0,1,-2,2,0,-2,0,39,-1,-2,3,4,0,0,1,-1,0,-1,1,-1
KR_6732648732,420,0,-50,24,2,-1,3,2,1,2,3,-5,7,2,4,1,5,3,0,3,0,15,-11,2,-4,2,1,0,-2,-1,-1,-1,-1,5,-1
KR_6737177565,420,-6,-58,-31,-15,-6,6,0,-3,4,1,2,0,2,-4,4,0,-4,4,0,0,-18,0,-1,-4,5,-5,0,-1,-1,-1,-1,-1,4,-1
KR_6760242665,440,0,-105,0,1,6,0,6,-1,4,3,0,3,3,-2,2,0,-2,2,0,0,-2,-1,1,-5,4,-1,0,-1,-1,1,-1,1,3,-1
KR_6761761299,420,0,-14,4,3,3,1,4,3,0,3,-1,3,2,-2,2,0,0,2,2,0,1,-9,5,-5,0,1,0,0,1,1,0,1,2,-1
KR_6733443869,420,-5,-31,-32,-9,0,1,1,-1,3,2,-4,5,1,-3,3,0,-1,2,1,-1,-3,-7,-2,-2,4,-4,0,0,-1,-1,0,-1,5,-1
KR_6714622469,440,1,-14,8,2,2,0,2,2,1,3,4,2,6,-3,4,1,-3,3,0,1,3,-186,1,-4,3,-1,0,1,1,-1,1,1,4,-1
KR_6760752800,440,-6,-61,-20,-9,-2,4,2,1,0,1,-3,6,3,-2,4,2,-3,3,0,-1,-15,0,-4,0,4,-1,0,0,-1,1,-1,-1,4,-1
KR_6622416685,440,2,38,4,-2,-6,10,4,1,4,5,0,1,1,2,0,2,1,1,2,1,5,0,0,-1,1,-1,0,-1,-1,-1,-1,1,4,-1
KR_6715927039,440,-5,-37,-14,-19,-1,4,3,-10,10,0,-11,12,1,1,1,2,2,0,2,0,-11,23,-8,-1,9,5,0,-4,-1,-1,-1,-1,4,-1
KR_6722609908,420,2,-14,11,0,4,1,5,4,4,8,-6,6,0,-1,4,3,-1,2,1,2,0,21,4,-5,1,-4,0,1,1,0,1,-1,6,-1
KR_6742975517,420,-2,-19,0,0,-3,3,0,2,1,3,0,4,4,2,2,4,-1,3,2,0,3,-4,1,-3,2,-1,0,0,-1,1,1,1,2,-1
KR_6681204080,420,-1,-85,-24,2,1,1,2,6,0,6,0,2,2,-6,7,1,1,0,1,1,6,-2,3,-5,2,0,0,-1,1,1,-1,1,2,-1
KR_6762733065,420,-7,-31,-52,-23,-2,3,1,-3,4,1,-5,5,0,-12,13,1,-1,1,0,0,-22,-8,-3,-1,4,-3,0,-2,-1,1,-1,-1,1,-1
KR_6763461920,420,-3,-18,-24,-6,-3,3,0,-5,6,1,-2,2,0,3,0,3,1,0,1,0,-9,-5,-2,-4,6,0,0,0,-1,1,-1,-1,1,-1
KR_6605068251,420,-2,8,-24,-8,-1,1,0,-6,8,2,-2,5,3,2,1,3,-1,2,1,0,-12,-14,1,-7,6,-4,0,0,-1,1,0,1,3,-1
KR_6733519412,420,-4,-33,0,-6,-4,6,2,-2,5,3,-1,1,0,1,1,2,0,0,0,0,0,-5,-4,-2,6,2,0,-2,1,-1,-1,-1,2,-1
KR_6715327118,420,1,-73,4,3,-2,3,1,-1,1,0,7,1,8,-1,6,5,0,1,1,0,2,-7,-4,-2,6,2,0,0,1,-1,0,1,1,-1
KR_6567785780,420,-5,-106,-51,-8,1,5,6,-3,7,4,-9,13,4,2,1,3,1,2,3,-1,0,220,1,-4,3,-2,0,-2,0,-1,-1,-1,0,-1
KR_6760911513,420,-1,-51,-17,5,0,1,1,2,1,3,3,2,5,0,0,0,0,0,0,0,4,12,0,0,0,-1,0,0,-1,1,-1,1,3,-1
KR_6740799842,420,0,16,-8,-3,-1,1,0,-5,5,0,2,3,5,0,5,5,1,2,3,0,-7,-13,-4,-1,5,1,0,1,-1,1,1,1,5,-1
KR_6759000977,420,3,44,44,4,-2,3,1,0,4,4,2,0,2,1,4,5,3,1,4,0,6,6,1,-3,2,-3,0,1,-1,0,1,-1,5,-1
KR_6763926914,420,-2,-39,-9,-4,-1,1,0,2,0,2,-3,3,0,0,4,4,-2,2,0,0,-4,2,1,-3,2,-4,0,0,0,-1,1,-1,0,-1
KR_6723474585,420,-2,-20,-7,-8,-2,3,1,-11,11,0,-3,4,1,4,0,4,4,0,4,-2,-6,43,-1,-1,2,-15,0,1,1,0,1,-1,4,-1
KR_6763059362,440,1,-2,-16,4,0,0,0,2,3,5,1,3,4,5,1,6,-4,6,2,0,-3,-1,-2,-3,5,-1,0,-1,-1,-1,-1,1,4,-1
KR_6669407763,420,-4,-7,8,-18,-1,2,1,-3,3,0,-4,7,3,-5,5,0,-5,5,0,0,-19,1,0,-2,2,0,0,0,-1,-1,0,-1,3,-1
KR_6756745507,420,-1,-13,-4,-5,-1,2,1,0,1,1,1,1,2,-5,5,0,0,0,0,0,-7,12,1,-6,5,-1,0,0,-1,-1,0,1,3,-1
KR_6763050754,420,-2,-21,-16,-8,3,0,3,-4,6,2,-6,8,2,2,2,4,-3,5,2,-2,-13,0,0,-5,5,-2,0,0,-1,1,0,1,6,-1
KR_6730079156,420,2,12,8,4,0,2,2,4,0,4,1,0,1,-3,4,1,2,1,3,0,5,20,2,-2,0,-1,0,-1,-1,-1,-1,-1,3,-1
KR_6632533005,420,-1,23,-29,-2,0,3,3,2,3,5,-2,6,4,0,2,2,-2,4,2,0,6,3,-5,-1,6,-1,0,0,-1,1,1,-1,1,-1
KR_6760842518,420,-3,-36,-4,-2,-2,3,1,-2,5,3,4,0,4,-1,3,2,-1,2,1,0,-3,176,-2,-2,4,2,0,0,-1,1,0,1,6,-1
KR_6661006839,420,1,-47,4,-2,-1,2,1,3,4,7,4,1,5,-5,6,1,-3,3,0,-1,-1,32,2,-6,4,-2,0,0,1,0,-1,-1,4,-1
KR_6746356652,420,0,66,-52,0,2,0,2,-4,5,1,1,0,1,-1,1,0,2,0,2,-1,-1,-5,2,-2,0,2,0,1,1,-1,1,1,4,-1
KR_6707581365,420,0,-20,-6,3,3,0,3,-2,3,1,-2,3,1,3,1,4,1,0,1,0,0,-136,-3,-4,7,-4,0,1,-1,1,1,1,5,-1
KR_6648542592,420,2,-15,11,2,3,0,3,1,1,2,-1,3,2,-2,2,0,1,0,1,0,-1,-1,-1,-1,2,0,0,0,-1,-1,0,-1,3,-1
KR_6755595044,420,-3,-14,-28,-8,0,0,0,-7,7,0,0,1,1,1,1,2,-2,2,0,0,-10,-4,-2,-1,3,1,0,-1,-1,-1,-1,-1,3,-1
KR_6681334191,420,3,24,-8,9,2,3,5,3,3,6,1,1,2,-3,5,2,6,0,6,-1,4,1,1,-3,2,-3,0,1,0,1,1,-1,0,-1
KR_6678992014,440,1,-16,-9,3,1,2,3,0,3,3,-1,2,1,3,1,4,0,0,0,1,0,2,-5,-1,6,5,0,0,-1,1,0,1,6,-1
KR_6757610367,420,4,18,9,8,3,1,4,2,2,4,5,2,7,-2,4,2,0,0,0,0,6,-7,-5,-1,6,1,0,0,-1,-1,0,-1,3,-1
KR_6702012294,420,-3,22,-44,-2,-2,3,1,-4,8,4,2,0,2,3,0,3,-1,1,0,0,2,-12,2,-5,3,2,0,0,-1,-1,0,1,4,-1
KR_6733656914,420,-3,-4,-3,-9,1,0,1,-4,5,1,-3,4,1,-4,5,1,1,0,1,-2,-10,1,3,-3,0,0,0,0,-1,-1,0,-1,6,-1
KR_6744489437,440,-3,-24,-31,-3,2,2,4,-5,8,3,-1,5,4,1,0,1,0,1,1,0,0,-7,-3,-2,5,1,0,-2,1,-1,-1,-1,3,-1
KR_6762772881,420,2,82,-24,3,5,0,5,-1,2,1,-4,5,1,2,1,3,1,0,1,-1,-1,-6,1,-4,3,2,0,0,-1,-1,1,-1,2,-1
KR_6682032267,420,-5,-91,35,-10,-2,3,1,-8,10,2,1,2,3,0,2,2,-1,3,2,1,2,14,-3,-1,4,-2,0,-1,-1,0,-1,1,3,-1
KR_6756545769,420,0,-13,24,0,3,0,3,2,6,8,-6,8,2,4,1,5,-3,4,1,0,-1,2,3,-4,1,-3,0,2,-1,1,1,1,6,-1
KR_6716691584,420,-3,-66,-4,-6,-2,2,0,3,1,4,-1,5,4,-6,7,1,0,1,1,0,-7,-6,1,-5,4,-2,0,-1,0,-1,-1,-1,0,-1
KR_6727962771,440,-1,-80,4,-4,-2,2,0,2,0,2,2,0,2,-6,7,1,0,1,1,0,-1,10,-4,0,4,-4,0,-2,-1,1,-1,-1,2,-1
KR_6686073093,420,2,-62,0,10,1,0,1,-1,4,3,11,0,11,-1,6,5,0,2,2,0,6,-5,3,-5,2,1,0,0,-1,-1,-1,1,1,-1
KR_6750131898,420,-1,-32,16,-1,2,0,2,-3,4,1,2,0,2,-2,4,2,0,3,3,1,1,120,-5,-1,6,1,0,-1,0,0,-1,1,0,-1
KR_6751798238,420,-3,-11,-4,-5,-4,5,1,1,1,2,2,0,2,-2,4,2,-2,3,1,0,0,-17,0,-5,5,-4,0,-2,-1,1,-1,1,1,-1
KR_6625346251,420,-6,-115,33,-12,2,0,2,-3,3,0,-2,3,1,-6,7,1,-3,3,0,-1,-17,9,-1,-3,4,-1,0,-3,0,-1,-1,-1,0,-1
KR_6705988853,420,-3,-6,-17,-15,-1,2,1,-4,4,0,-3,4,1,-6,7,1,-1,4,3,-1,-24,35,-3,-3,6,-15,0,0,-1,-1,-1,-1,4,-1
KR_6751124234,420,2,-36,72,-3,-1,2,1,0,3,3,-1,3,2,-1,2,1,0,0,0,0,-1,-1,-3,0,3,-2,0,0,1,1,0,-1,2,-1
KR_6732850300,420,1,36,-8,-1,0,2,2,-1,3,2,2,0,2,-2,2,0,0,0,0,0,-4,-3,0,-5,5,2,0,0,-1,1,1,1,5,-1
KR_6528947195,440,-4,6,-6,-8,-1,2,1,-3,5,2,3,2,5,-5,6,1,-2,2,0,0,-11,5,2,-7,5,-3,0,-2,1,-1,-1,-1,1,-1
KR_6753844717,420,-1,-7,-4,-3,-2,3,1,-5,5,0,3,3,6,1,0,1,0,0,0,0,-7,2,-3,-1,4,1,0,-1,-1,-1,-1,-1,1,-1
KR_6679508499,420,1,21,-4,-1,1,1,2,-4,4,0,2,2,4,1,5,6,-1,2,1,0,-3,36,4,-7,3,-18,0,-1,-1,-1,-1,-1,3,-1
KR_6742059027,420,-4,-55,-24,-7,-3,4,1,3,1,4,-4,4,0,-1,3,2,-2,2,0,0,-2,-8,-3,-3,6,-3,0,0,1,-1,-1,-1,2,-1
KR_6763347097,420,-4,-58,13,-8,-4,6,2,-2,4,2,0,1,1,-1,1,0,-1,1,0,0,-5,-472,3,-4,1,-4,0,-1,-1,-1,-1,1,5,-1
KR_6671023354,420,-2,-17,14,-6,5,0,5,-4,5,1,1,2,3,-7,7,0,-1,2,1,0,-12,-15,4,-5,1,3,0,0,-1,1,1,-1,2,-1
KR_6723826062,440,3,48,27,11,3,1,4,3,2,5,1,1,2,6,1,7,-2,4,2,-1,7,-4,0,-4,4,2,0,0,1,-1,-1,-1,5,-1
KR_6763548262,420,1,-1,32,-9,3,0,3,-7,7,0,-7,7,0,0,1,1,2,0,2,0,-8,-3,-4,-1,5,3,0,-2,-1,-1,-1,-1,3,-1
KR_6707387450,440,-4,-75,1,-9,-6,7,1,3,0,3,-5,6,1,-1,3,2,0,1,1,2,-11,-2,-2,-4,6,-3,0,-2,-1,1,-1,1,6,-1
KR_6743918973,440,-9,-53,-104,-9,-6,7,1,-4,7,3,1,4,5,1,1,2,-1,2,1,0,3,10,4,-6,2,-3,0,-2,0,0,-1,1,0,-1
KR_6694793996,420,-4,-11,-23,-12,-1,3,2,-6,7,1,2,2,4,-5,5,0,-2,3,1,0,-13,-6,2,-5,3,-2,0,-3,-1,1,-1,-1,1,-1
KR_6626762324,420,-3,-99,-24,-6,1,1,2,3,0,3,-3,5,2,-3,3,0,-4,5,1,0,-4,-4,0,-2,2,-2,0,0,-1,1,-1,-1,3,-1
KR_6751597171,420,0,-84,11,-4,-2,8,6,1,1,2,-2,4,2,2,1,3,-3,3,0,-2,-10,1,2,-2,0,4,0,-1,1,1,-1,-1,3,-1
KR_6624657970,420,-6,-147,-11,-13,-3,3,0,-4,5,1,-5,5,0,-1,1,0,0,0,0,-1,-14,-9,-3,-1,4,-1,0,-2,-1,1,-1,-1,6,-1
KR_6758267832,440,-7,-112,-3,-12,-8,9,1,3,3,6,-3,5,2,1,1,2,-5,5,0,0,-3,4,0,-2,2,3,0,-2,0,-1,-1,-1,0,-1
KR_6742125828,420,-1,19,0,-3,-2,2,0,-1,4,3,2,3,5,-1,2,1,-1,1,0,0,-12,102,1,-4,3,-23,0,2,1,-1,1,1,1,-1
KR_6613345081,420,-4,-69,8,-6,0,1,1,-1,4,3,-1,1,0,0,4,4,-4,4,0,0,-1,-537,-1,-3,4,-2,0,-1,1,-1,-1,-1,2,-1
KR_6689177518,420,-5,-36,-38,-11,-9,9,0,-1,1,0,3,0,3,-2,4,2,-2,2,0,0,-5,-11,-5,-3,8,0,0,-1,-1,0,-1,1,1,-1
KR_6758901484,420,-5,-80,-8,-9,-5,7,2,-1,2,1,-5,7,2,0,2,2,2,0,2,0,-4,7,4,-4,0,-3,0,-4,-1,-1,-1,-1,4,-1
KR_6680306208,420,-1,-70,0,-1,-1,1,0,1,2,3,2,3,5,1,7,8,-4,6,2,2,3,41,-1,-4,5,-25,0,0,1,1,-1,1,5,-1
KR_6726199212,420,-2,-4,0,-2,2,2,4,1,2,3,-3,3,0,-3,4,1,1,0,1,0,3,-5,-3,0,3,-1,0,-2,0,-1,-1,1,0,-1
KR_6760667137,420,1,15,-26,6,3,0,3,-3,5,2,3,0,3,0,2,2,3,2,5,0,-1,3,-3,-2,5,0,0,0,0,-1,-1,1,0,-1
KR_6719867569,420,-3,-10,-5,-5,-1,1,0,3,2,5,-3,6,3,1,2,3,-5,6,1,0,-4,1,0,-1,1,2,0,-1,-1,-1,-1,-1,5,-1
KR_6729572159,420,-1,-29,-4,-2,-2,3,1,0,1,1,-1,1,0,2,1,3,-1,1,0,0,0,-1,-1,-3,4,1,0,0,-1,-1,0,1,5,-1
KR_6622519814,420,0,-13,15,1,-1,1,0,4,1,5,-4,5,1,0,3,3,2,0,2,0,2,-157,0,-4,4,-2,0,-1,1,0,-1,1,5,-1
KR_6753057610,420,-2,-36,-51,-6,3,0,3,1,1,2,-6,6,0,-3,3,0,-1,1,0,0,-6,-24,1,-5,4,5,0,0,-1,1,0,-1,3,-1
KR_6702669976,420,-4,-41,-24,-15,-2,6,4,-4,6,2,2,0,2,-8,9,1,-3,3,0,0,-17,-2,0,-5,5,-2,0,-3,-1,-1,-1,-1,5,-1
KR_6645956969,420,-3,-47,-52,-6,-4,4,0,-1,6,5,-3,5,2,1,1,2,1,0,1,0,-4,4,-3,-1,4,-3,0,0,0,-1,0,-1,0,-1
KR_6748411808,420,-1,62,-16,0,-1,2,1,3,1,4,-3,7,4,-2,4,2,3,0,3,0,2,-115,0,-2,2,1,0,1,-1,1,1,-1,2,-1
KR_6722410277,420,-1,-7,-5,1,1,1,2,0,0,0,0,1,1,2,3,5,-2,2,0,0,4,-3,1,-4,3,-5,0,0,0,-1,0,1,0,-1
KR_6737041795,420,-8,-38,-25,-9,-1,2,1,-1,3,2,-3,8,5,-4,6,2,0,2,2,4,-5,14,1,-6,5,-2,0,-1,-1,-1,-1,1,3,-1
KR_6611553152,420,-5,-104,-24,-8,1,0,1,-1,3,2,-2,2,0,-5,7,2,-1,3,2,0,-9,6,-1,-7,8,-4,0,-1,-1,-1,-1,-1,4,-1
KR_6607066401,420,-2,23,0,-5,-2,2,0,2,2,4,-2,2,0,1,3,4,-4,4,0,0,-9,-8,-3,0,3,0,0,2,1,1,1,-1,3,-1
KR_6689226859,420,-3,-60,12,-9,-2,3,1,-2,4,2,2,3,5,-8,9,1,1,0,1,0,-16,-43,-5,-1,6,29,0,-2,-1,1,-1,1,1,-1
KR_6749077971,420,-1,-11,39,-9,1,0,1,2,1,3,-1,3,2,-9,9,0,-2,2,0,0,-10,-23,-4,0,4,5,0,-1,0,-1,-1,-1,0,-1
KR_6753453493,440,-1,-40,-44,-6,0,1,1,4,3,7,-1,2,1,-4,5,1,-5,5,0,0,-4,11,4,-5,1,-1,0,-1,-1,-1,1,-1,6,-1
KR_6697807328,420,0,10,-17,1,0,2,2,-1,1,0,4,1,5,0,0,0,-2,3,1,0,-1,-5,2,-7,5,0,0,2,1,1,1,-1,5,-1
KR_6713815769,440,1,23,0,14,1,0,1,3,0,3,1,1,2,6,2,8,3,3,6,0,22,-10,1,-2,1,-2,0,1,0,-1,-1,1,0,-1
KR_6715878237,420,0,-29,8,4,-1,1,0,4,3,7,-3,6,3,7,1,8,-3,4,1,0,2,6,0,-2,2,1,0,0,1,1,0,1,6,-1
KR_6763988993,440,5,36,13,11,2,0,2,2,4,6,0,2,2,5,1,6,2,1,3,1,18,19,2,-6,4,2,0,1,1,1,1,1,3,-1
KR_6694925711,420,-3,-57,8,-7,-1,2,1,1,0,1,-1,1,0,-4,5,1,-2,3,1,0,-8,-9,-2,-2,4,-1,0,-2,-1,0,-1,1,6,-1
KR_6720717777,420,-6,-12,-22,-12,0,2,2,1,1,2,-4,4,0,-7,7,0,-2,4,2,0,-16,13,-4,-3,7,1,0,0,-1,1,-1,-1,4,-1
KR_6698510904,420,1,-1,-8,2,6,5,11,-1,3,2,-2,4,2,-1,4,3,0,2,2,0,-6,-120,6,-8,2,-4,0,2,0,1,1,-1,0,-1
KR_6615979547,420,-11,-49,-41,-26,-5,6,1,-6,7,1,-13,15,2,-4,6,2,2,0,2,0,-18,2,-3,-3,6,-3,0,-4,-1,-1,-1,1,3,-1
KR_6748048499,420,-1,-1,29,0,3,0,3,5,1,6,-2,2,0,-5,8,3,-1,2,1,0,4,-42,1,-4,3,20,0,0,0,1,1,1,0,-1
KR_6749650317,420,1,-9,14,-8,-4,4,0,-1,5,4,0,2,2,-6,7,1,3,1,4,-1,-5,-304,0,-4,4,2,0,0,1,1,0,-1,4,-1
KR_6722707374,420,1,77,-8,3,5,2,7,-1,1,0,1,1,2,-2,6,4,0,1,1,0,-6,18,8,-10,2,2,0,1,0,1,1,1,0,-1
KR_6577605199,420,-3,-22,-18,-3,1,3,4,-1,3,2,-2,3,1,-2,2,0,1,2,3,1,-3,3,2,-5,3,3,0,0,-1,-1,0,1,2,-1
KR_6706227779,440,-1,-44,-11,0,-2,5,3,-2,3,1,-3,5,2,3,1,4,4,0,4,0,4,-34,-3,-2,5,5,0,0,1,-1,-1,1,5,-1
KR_6740356590,440,-4,-9,-21,-6,-3,4,1,3,0,3,-3,3,0,-3,3,0,0,0,0,0,-5,12,3,-8,5,-11,0,-1,1,-1,-1,-1,3,-1
KR_6736847035,420,-5,-28,-10,-5,-4,4,0,-3,3,0,1,6,7,2,4,6,-1,1,0,-2,5,0,-1,-5,6,-1,0,-1,-1,-1,-1,-1,4,-1
KR_6729553741,440,-1,-27,9,-2,-3,5,2,-6,7,1,3,3,6,5,4,9,-1,2,1,4,-1,-159,0,-4,4,-4,0,1,1,-1,-1,1,5,-1
KR_6758858624,440,-2,-32,8,-4,1,2,3,0,2,2,-5,7,2,0,4,4,0,1,1,1,-9,-14,-5,0,5,2,0,-2,-1,-1,-1,1,1,-1
KR_6728257323,420,-4,-53,-32,-8,0,1,1,-5,6,1,-1,6,5,-1,3,2,-1,2,1,0,-6,-28,1,-7,6,2,0,-1,-1,1,-1,-1,6,-1
KR_6714257377,420,-3,-22,-12,-7,-3,4,1,6,1,7,-4,5,1,-5,5,0,-1,1,0,0,-10,-12,-1,-4,5,0,0,-3,-1,-1,-1,1,6,-1
KR_6748040021,420,-1,-26,13,7,-2,2,0,-3,4,1,3,0,3,7,0,7,2,1,3,0,8,0,2,-4,2,0,0,0,1,-1,0,1,6,-1
KR_6696059819,440,-5,-94,4,-11,-1,1,0,3,6,9,-3,4,1,-4,5,1,-6,6,0,0,-13,-3,-2,-2,4,1,0,-1,1,1,-1,-1,3,-1
KR_6747883174,420,-1,-22,1,-4,2,0,2,-2,2,0,1,2,3,-2,3,1,-3,3,0,0,-7,-126,1,-3,2,-1,0,0,-1,1,0,-1,6,-1
KR_6748421717,420,-4,-105,0,-3,-3,4,1,-2,3,1,0,2,2,2,0,2,0,0,0,0,0,-43,0,-4,4,13,0,-1,1,-1,-1,1,4,-1
KR_6714750272,440,-3,3,1,-8,-5,6,1,-1,2,1,-1,1,0,0,3,3,-1,4,3,-1,-16,21,-2,-6,8,-26,0,0,-1,0,0,-1,5,-1
KR_6751942024,420,-2,-60,-12,-9,1,1,2,-6,7,1,-1,1,0,-3,4,1,0,0,0,0,-12,189,5,-5,0,-3,0,0,-1,1,0,1,4,-1
KR_6681720338,420,-5,-85,2,-6,-3,3,0,-1,4,3,2,2,4,0,0,0,-4,5,1,0,-6,-35,-2,-2,4,1,0,-3,1,-1,-1,1,2,-1
KR_6750473889,420,-2,-22,-9,-7,0,1,1,2,2,4,-1,2,1,-8,8,0,0,0,0,0,-5,-196,-4,-1,5,1,0,-1,1,-1,-1,1,6,-1
KR_6725831540,420,-2,25,-6,1,5,0,5,2,0,2,2,0,2,-7,7,0,-1,2,1,1,-3,3,-1,-2,3,0,0,1,-1,1,1,1,1,-1
KR_6623404527,440,0,31,8,2,-3,3,0,1,2,3,1,1,2,-5,5,0,8,1,9,1,2,-1,-5,-1,6,4,0,0,0,-1,1,1,0,-1
KR_6753600847,420,1,1,-3,2,0,1,1,-2,3,1,1,3,4,2,0,2,1,0,1,0,0,-7,0,-4,4,-1,0,0,1,-1,-1,1,3,-1
KR_6743463605,420,-3,-44,-31,-8,-3,4,1,-2,3,1,0,2,2,-3,5,2,0,1,1,0,-2,4,0,-2,2,-2,0,-1,-1,-1,-1,-1,4,-1
KR_6727739157,420,0,-28,13,-5,-2,3,1,-2,2,0,3,0,3,-5,7,2,1,0,1,0,-5,-5,-1,-2,3,0,0,-2,-1,-1,-1,-1,3,-1
KR_6721784138,420,-5,17,5,-16,-2,2,0,-3,7,4,-2,4,2,-4,9,5,-5,6,1,0,-20,4,2,-4,2,-2,0,0,1,0,-1,-1,6,-1
KR_6740773220,420,0,-67,-11,-3,3,0,3,-2,3,1,-4,6,2,-1,2,1,1,2,3,0,-5,231,-2,-1,3,4,0,-1,-1,1,-1,-1,5,-1
KR_6751856264,420,2,5,-7,1,-2,3,1,-2,4,2,3,0,3,-1,6,5,3,0,3,0,-1,0,1,-5,4,-1,0,0,0,0,-1,1,0,-1
KR_6763997108,420,-1,-37,28,-2,0,1,1,-1,3,2,1,3,4,0,0,0,-2,3,1,0,-1,282,1,-3,2,0,0,0,-1,-1,0,-1,2,-1
KR_6720936794,420,-2,-61,-20,0,2,0,2,-1,3,2,2,1,3,-2,2,0,-1,1,0,0,-1,-2,3,-5,2,-4,0,-1,1,-1,-1,-1,1,-1
KR_6747329382,440,1,-44,-8,1,-1,5,4,3,1,4,0,2,2,0,1,1,-1,2,1,0,-1,-7,-3,-1,4,-2,0,-1,1,-1,-1,1,6,-1
KR_6620400046,420,-7,-158,13,-18,0,1,1,2,1,3,-7,7,0,-5,6,1,-8,9,1,-1,-17,16,0,-2,2,0,0,-2,0,-1,-1,-1,0,-1
KR_6686784247,420,0,9,-20,2,2,0,2,3,1,4,-3,4,1,0,0,0,0,0,0,0,-1,-2,-3,-5,8,-1,0,1,-1,1,1,1,1,-1
KR_6758654717,440,1,-31,4,7,0,3,3,5,3,8,5,3,8,-3,5,2,0,1,1,0,2,-5,-2,-1,3,-4,0,0,0,1,1,1,0,-1
KR_6699156719,420,-6,-149,-44,-20,-4,6,2,-5,6,1,-3,4,1,-5,6,1,-3,3,0,0,-8,3,0,-2,2,-2,0,-4,-1,-1,-1,-1,2,-1
KR_6760433925,420,1,34,32,-2,-2,3,1,0,1,1,-2,3,1,1,1,2,1,0,1,0,-4,-3,-2,-3,5,2,0,0,0,-1,0,1,0,-1
KR_6196068827,420,-5,-41,-15,-11,3,2,5,-3,4,1,-5,7,2,-5,6,1,-1,1,0,0,-13,-49,-1,-5,6,-4,0,-3,-1,-1,-1,1,4,-1
KR_6597152582,420,1,21,30,0,0,2,2,0,2,2,0,1,1,2,1,3,-2,3,1,0,0,-137,3,-4,1,-2,0,0,1,1,1,1,4,-1
KR_6759908183,420,-1,-63,20,-6,-6,6,0,-2,5,3,-1,2,1,2,1,3,1,1,2,0,2,-8,-5,-3,8,2,0,-1,-1,0,-1,1,2,-1
KR_6693354267,420,1,79,-20,2,1,1,2,-1,5,4,1,2,3,3,0,3,-2,2,0,1,4,5,-2,-3,5,-2,0,1,-1,-1,1,1,2,-1
KR_6731497862,420,-2,-73,-24,-1,1,2,3,-3,3,0,-2,2,0,3,2,5,0,2,2,1,-2,-1,-1,0,1,-2,0,-1,-1,1,-1,1,2,-1
KR_6732890446,420,2,77,-4,3,6,1,7,2,3,5,-2,5,3,-3,5,2,0,2,2,0,-1,1,0,-3,3,2,0,2,-1,1,1,1,2,-1
KR_6529099220,420,-6,-73,0,-9,-3,5,2,3,1,4,-3,3,0,-4,6,2,-2,2,0,-1,-13,11,-5,-6,11,1,0,-1,1,1,1,-1,5,-1
KR_6659676393,420,0,-24,-5,4,1,1,2,1,1,2,0,4,4,3,1,4,-1,1,0,1,8,2,1,-4,3,0,0,1,-1,1,1,1,1,-1
KR_6752055434,440,-2,-33,20,-8,0,1,1,-3,3,0,-1,3,2,-2,2,0,-2,2,0,0,-11,15,4,-6,2,-5,0,0,0,0,0,-1,0,-1
KR_6764023834,420,-1,-56,-2,3,-3,3,0,-1,1,0,3,0,3,4,0,4,0,2,2,0,5,0,3,-5,2,1,0,0,0,0,0,1,0,-1
KR_6663437724,420,-8,-6,-104,-17,-8,10,2,-4,5,1,4,2,6,-9,9,0,0,3,3,0,-16,0,0,0,0,-3,0,-3,-1,0,-1,-1,2,-1
KR_6749921101,440,-3,-36,-35,1,3,0,3,4,2,6,-5,5,0,-1,2,1,0,0,0,0,-1,10,1,-4,3,-2,0,0,-1,-1,0,1,1,-1
KR_6672233247,440,-2,-50,8,-4,0,0,0,0,1,1,-2,3,1,-2,2,0,0,0,0,0,-4,-4,-1,-9,10,0,0,-1,1,-1,-1,-1,1,-1
KR_6673278097,440,-6,-47,3,-15,-5,5,0,-9,11,2,0,2,2,-1,2,1,0,0,0,0,-10,4,1,-3,2,0,0,-2,1,-1,-1,-1,5,-1
KR_6686102690,420,-5,-147,-4,-5,-4,4,0,0,1,1,3,1,4,-3,4,1,-1,2,1,0,4,-2,2,-7,5,3,0,-2,1,-1,-1,-1,5,-1
KR_6764304615,420,-3,10,18,-13,-3,4,1,-1,3,2,-3,5,2,-3,5,2,-3,3,0,0,-12,-2,-1,-1,2,0,0,-1,1,-1,-1,-1,6,-1
KR_6729292256,420,-4,-68,15,-5,2,1,3,-1,4,3,1,4,5,-6,10,4,-1,1,0,0,-15,-10,-2,-3,5,4,0,-1,0,1,-1,-1,0,-1
KR_6762138680,420,0,61,12,3,3,1,4,0,1,1,0,2,2,1,2,3,-1,1,0,0,-2,10,2,-3,1,-3,0,0,-1,0,0,-1,3,-1
KR_6726493401,440,3,12,4,6,-3,5,2,2,2,4,4,1,5,1,1,2,2,0,2,0,9,-6,-4,-1,5,0,0,1,-1,0,1,1,5,-1
KR_6589375411,420,-1,-11,-7,-4,-2,2,0,-1,6,5,1,3,4,-2,3,1,0,2,2,0,-4,1,-1,-4,5,0,0,-1,-1,-1,-1,-1,1,-1
KR_6671404066,420,-1,16,-13,-4,-1,1,0,4,2,6,-5,6,1,-1,2,1,-1,2,1,-1,-4,-15,2,-7,5,1,0,0,-1,-1,0,-1,2,-1
KR_6753552448,420,-5,-80,-20,-12,-4,4,0,-6,7,1,-4,7,3,4,0,4,-2,2,0,0,4,8,6,-8,2,-1,0,0,-1,-1,0,-1,3,-1
KR_6685881904,420,1,-13,-4,6,-4,5,1,-2,5,3,5,0,5,6,0,6,1,0,1,0,18,45,-1,-4,5,-19,0,1,1,1,1,-1,3,-1
KR_6758785652,440,-1,-52,12,-4,0,2,2,-2,6,4,1,1,2,-4,7,3,1,0,1,-1,-8,-203,0,-1,1,-1,0,-1,1,-1,-1,-1,6,-1
KR_6626869057,440,2,13,9,3,-2,2,0,4,5,9,3,1,4,2,0,2,-4,4,0,1,4,0,1,-7,6,-2,0,1,-1,1,1,1,2,-1
KR_6195960939,420,-2,11,-39,-8,1,3,4,-8,8,0,2,2,4,2,3,5,-5,7,2,0,-13,-11,0,-2,2,-4,0,0,-1,-1,-1,1,3,-1
KR_6692771982,420,0,42,-12,2,4,1,5,5,1,6,-2,2,0,0,2,2,-5,5,0,1,1,26,-3,0,3,1,0,1,-1,-1,1,1,6,-1
KR_6519114928,420,-6,-127,-80,-8,-6,6,0,-5,5,0,-1,1,0,4,0,4,0,2,2,-2,2,-5,-3,-1,4,4,0,-1,0,-1,-1,-1,0,-1
KR_6607714635,420,-1,4,11,-4,1,1,2,3,3,6,-2,3,1,-6,7,1,0,2,2,0,-7,21,-2,-5,7,-2,0,-1,-1,1,1,-1,4,-1
KR_6726777454,440,-4,-71,-40,-8,1,0,1,0,1,1,-8,9,1,1,1,2,-2,3,1,0,-7,4,-6,-3,9,-5,0,0,-1,0,-1,-1,3,-1
KR_6676697089,420,-4,-71,-12,-9,-2,3,1,1,2,3,-3,5,2,-3,7,4,-2,2,0,0,-7,-7,1,-6,5,2,0,0,-1,1,0,1,6,-1
KR_6649583375,420,-2,-33,-16,-4,0,1,1,-4,4,0,3,1,4,-3,3,0,0,0,0,0,-2,-2,-1,-5,6,-4,0,0,-1,1,1,-1,2,-1
KR_6635522411,420,0,84,-14,0,-1,3,2,-2,3,1,0,2,2,1,2,3,2,0,2,0,0,-9,-2,-1,3,3,0,1,-1,0,1,1,2,-1
KR_6661046607,420,0,-7,-13,5,-2,3,1,1,0,1,5,0,5,1,5,6,0,0,0,0,1,-2,4,-7,3,2,0,0,-1,0,0,1,5,-1
KR_6325975607,420,-2,-61,-12,-8,-3,5,2,-2,4,2,-5,8,3,1,5,6,1,1,2,-2,-3,4,1,-5,4,-3,0,-2,1,-1,-1,-1,5,-1
KR_6741525135,420,2,-12,48,6,2,4,6,3,2,5,2,2,4,-1,3,2,0,2,2,0,0,6,3,-4,1,3,0,0,-1,1,-1,1,3,-1
KR_6689066571,420,-1,-15,-57,0,-3,4,1,-3,3,0,-1,5,4,3,0,3,4,0,4,0,1,24,-1,-2,3,-5,0,0,1,-1,0,1,1,-1
KR_6699017161,420,-4,-23,-36,-6,-7,7,0,-2,3,1,3,1,4,0,0,0,0,0,0,0,-8,136,1,-3,2,2,0,0,1,1,-1,1,6,-1
KR_6759057479,420,0,55,-16,4,-1,2,1,0,1,1,4,2,6,2,2,4,-1,1,0,1,-4,275,4,-6,2,-1,0,1,1,-1,1,1,1,-1
KR_6600006253,420,2,-34,12,3,0,2,2,-1,2,1,3,1,4,1,0,1,0,0,0,0,5,1,-1,-3,4,1,0,0,0,-1,0,1,0,-1
KR_6761624385,420,2,25,19,5,1,1,2,5,5,10,3,0,3,-4,4,0,0,0,0,0,2,-18,0,-1,1,1,0,0,-1,-1,-1,-1,2,-1
KR_6714830282,440,-2,-32,-13,-1,4,1,5,-4,5,1,1,1,2,-2,3,1,0,2,2,0,1,8,5,-10,5,3,0,-1,0,-1,-1,-1,0,-1
KR_6762993998,420,0,-31,4,9,0,0,0,3,2,5,2,3,5,4,1,5,0,1,1,1,14,5,-2,-4,6,1,0,0,1,1,0,1,3,-1
KR_6677127072,420,3,44,0,10,0,1,1,-1,3,2,3,3,6,7,3,10,1,3,4,0,6,0,-4,-3,7,2,0,0,-1,1,1,-1,2,-1
KR_6750777979,420,-1,-34,0,1,1,0,1,-1,2,1,0,4,4,1,1,2,0,0,0,0,-3,1,4,-6,2,-1,0,0,-1,0,0,-1,1,-1
KR_6709491959,440,-1,-31,-14,-5,-1,2,1,3,3,6,1,3,4,-7,8,1,-1,3,2,1,-5,7,6,-11,5,-5,0,0,0,1,1,1,0,-1
KR_6731853392,440,-4,-62,-25,-6,1,2,3,-2,2,0,2,0,2,-5,5,0,-2,2,0,0,-8,-11,-7,0,7,1,0,-1,-1,-1,-1,-1,2,-1
KR_6639995855,440,-2,-23,-16,-5,0,0,0,0,2,2,1,1,2,-5,5,0,-1,4,3,0,-8,3,-2,-2,4,-5,0,0,0,1,0,-1,0,-1
KR_6764543034,420,-1,-36,-24,-5,0,1,1,0,3,3,-2,4,2,-2,3,1,-1,1,0,0,-7,29,2,-3,1,-6,0,-1,1,-1,-1,-1,3,-1
KR_6725856485,420,-1,7,-20,-1,-5,5,0,-3,4,1,3,1,4,0,4,4,4,1,5,0,-4,0,-3,-4,7,-8,0,1,-1,0,1,-1,2,-1
KR_6642074158,420,0,4,-5,4,5,0,5,0,0,0,1,2,3,-2,4,2,0,2,2,0,-1,-24,1,-4,3,13,0,0,1,-1,-1,1,1,-1
KR_6672547357,420,-2,-114,-5,-7,-1,2,1,-2,3,1,-4,4,0,-1,2,1,1,0,1,0,-3,-273,-1,-4,5,-2,0,-1,-1,-1,-1,-1,1,-1
KR_6676945606,420,-1,-44,-4,-4,-3,4,1,0,2,2,1,2,3,-1,4,3,-1,3,2,1,2,2,0,-5,5,-2,0,0,-1,-1,0,1,6,-1
KR_6686086668,420,-1,52,-7,-3,-1,2,1,1,2,3,-5,7,2,2,1,3,0,1,1,-1,-6,9,-2,0,2,0,0,1,1,-1,1,-1,6,-1
KR_6752926619,440,0,20,-16,3,3,1,4,-3,4,1,3,1,4,1,3,4,-1,1,0,0,-3,9,-4,-1,5,4,0,1,0,-1,1,-1,0,-1
KR_6711833113,420,-1,-37,31,-6,-1,1,0,-1,3,2,1,2,3,-4,4,0,-1,2,1,0,-9,-2,-3,-1,4,-2,0,0,0,0,-1,1,0,-1
KR_6763116224,420,-1,4,4,-2,-2,3,1,-1,3,2,1,4,5,0,1,1,0,1,1,0,0,-14,-1,-4,5,0,0,1,1,1,1,1,4,-1
KR_6557568186,420,2,25,0,3,4,2,6,-1,4,3,2,1,3,-1,2,1,-1,2,1,0,-4,-3,-2,-3,5,2,0,1,1,1,1,1,3,-1
KR_6701954144,420,-1,25,1,-5,5,1,6,-4,6,2,-6,8,2,-4,7,3,4,3,7,0,0,0,-4,-2,6,2,0,0,-1,-1,-1,1,1,-1
KR_6757634008,420,-1,-29,-32,0,1,3,4,1,0,1,5,0,5,-8,10,2,1,0,1,0,0,-143,0,-2,2,-2,0,0,-1,1,1,1,1,-1
KR_6760330032,420,-3,-106,13,-7,-1,2,1,-2,3,1,-1,1,0,-1,1,0,-2,2,0,0,-8,-23,-1,-2,3,-4,0,-5,-1,0,-1,-1,6,-1
KR_6685997300,420,-3,0,5,-1,-3,3,0,-1,2,1,2,2,4,2,4,6,-1,4,3,0,1,-1,-1,-5,6,-1,0,-1,1,-1,-1,-1,2,-1
KR_6761122536,420,3,27,10,9,1,1,2,-2,4,2,3,1,4,7,0,7,0,2,2,1,8,206,1,-4,3,6,0,0,1,-1,-1,1,5,-1
KR_6737482344,420,-3,30,-13,-3,-3,3,0,-4,6,2,1,2,3,1,2,3,2,0,2,3,9,-15,-3,-1,4,-2,0,-1,-1,-1,-1,1,4,-1
KR_6756505224,420,4,62,-24,2,-1,5,4,-3,7,4,6,0,6,1,1,2,-1,3,2,0,0,-2,-2,-1,3,2,0,2,-1,0,1,-1,1,-1
KR_6761231027,440,0,-3,-8,0,-1,2,1,1,1,2,0,1,1,0,1,1,0,1,1,0,4,-2,1,-5,4,2,0,-1,-1,-1,-1,1,1,-1
KR_6750880972,420,3,16,8,4,2,0,2,0,2,2,-1,2,1,3,1,4,0,0,0,0,3,3,1,-4,3,1,0,1,1,-1,1,-1,6,-1
KR_6481373852,420,-1,-85,-13,-2,1,0,1,0,5,5,-1,2,1,-1,3,2,-1,1,0,0,-10,1,0,-5,5,-1,0,-1,-1,-1,-1,-1,2,-1
KR_6631535195,420,-2,-1,-20,-6,-3,4,1,-2,5,3,-1,3,2,-2,4,2,2,0,2,0,-7,4,0,-3,3,-2,0,-1,-1,-1,-1,1,6,-1
KR_6733519005,420,-3,7,-13,-4,-1,3,2,0,5,5,-2,4,2,-2,2,0,1,2,3,0,-2,320,-2,-1,3,-1,0,0,-1,1,-1,1,3,-1
KR_6757335709,440,-1,34,-13,0,6,0,6,1,1,2,-1,2,1,-4,4,0,-2,2,0,0,-8,272,3,-4,1,-4,0,-2,-1,-1,-1,1,3,-1
KR_6758002933,420,-2,-77,-28,-8,-3,3,0,-1,1,0,-4,5,1,0,1,1,0,0,0,0,-4,1,0,-2,2,-1,0,-1,0,0,-1,1,0,-1
KR_6760871697,420,-2,14,-32,-10,2,0,2,-3,4,1,-5,5,0,-3,3,0,-1,1,0,0,-8,6,2,-3,1,0,0,1,-1,1,1,-1,3,-1
KR_6741151459,440,-2,-36,-12,5,1,2,3,4,0,4,-3,5,2,3,1,4,0,0,0,0,5,-6,0,0,0,-1,0,1,0,1,1,1,0,-1
KR_6764252333,420,2,-29,44,-3,-1,2,1,2,1,3,2,0,2,-7,7,0,1,3,4,-1,-2,-7,-4,-3,7,-1,0,-1,1,-1,-1,-1,1,-1
KR_5551477174,420,-7,-144,-44,-12,1,1,2,-5,6,1,-2,4,2,-7,7,0,1,0,1,0,-9,16,0,-3,3,-4,0,-1,-1,1,-1,-1,3,-1
KR_6741270048,420,-3,35,-4,-3,3,1,4,0,3,3,-2,2,0,-5,6,1,1,0,1,1,-5,11,1,-3,2,2,0,0,0,1,0,1,0,-1
KR_6745289766,420,-1,21,-8,-6,-3,5,2,-4,4,0,2,1,3,-2,3,1,1,0,1,0,-1,-3,-5,-3,8,7,0,0,-1,0,0,-1,6,-1
KR_6733602809,420,-1,16,-24,-5,0,2,2,-7,8,1,-3,4,1,4,1,5,1,1,2,0,-2,5,0,-3,3,3,0,-2,1,-1,-1,-1,1,-1
KR_6670921157,420,0,-38,33,-3,-1,3,2,0,0,0,-2,2,0,1,1,2,-1,1,0,-1,-2,-402,0,-3,3,-5,0,-1,1,-1,-1,-1,6,-1
KR_6714942300,420,-7,-37,-52,-7,2,1,3,-1,2,1,-6,6,0,-5,8,3,3,1,4,0,-11,-1,-4,-2,6,0,0,-1,-1,-1,-1,1,3,-1
KR_6701929961,420,-7,2,-61,-11,-3,4,1,-8,8,0,6,1,7,-3,4,1,-3,3,0,0,-14,1,-4,-4,8,-2,0,-1,1,-1,-1,-1,3,-1
KR_6625557506,420,-3,-28,-11,2,-3,4,1,4,1,5,1,2,3,-1,3,2,1,0,1,0,2,9,2,-4,2,0,0,-1,0,0,-1,-1,0,-1
KR_6627935691,420,0,8,-7,7,1,3,4,-1,3,2,1,2,3,7,1,8,-1,3,2,1,15,-8,6,-9,3,4,0,0,-1,-1,-1,1,4,-1
KR_6722841199,420,-1,11,24,-10,-8,9,1,3,1,4,-1,2,1,1,4,5,-5,5,0,0,3,-122,2,-6,4,1,0,0,1,-1,-1,-1,4,-1
KR_6747603084,420,-1,45,-8,3,0,1,1,4,2,6,7,0,7,-2,3,1,-6,7,1,0,2,0,3,-6,3,0,0,0,-1,1,0,-1,5,-1
KR_6501772811,420,1,-44,14,0,4,1,5,-4,4,0,-2,3,1,-2,5,3,4,0,4,0,-2,-8,-2,-4,6,-2,0,0,-1,1,1,-1,2,-1
KR_6716183905,420,-7,-62,-20,-18,0,2,2,-6,9,3,-6,8,2,-11,11,0,5,1,6,-2,-28,-7,2,-4,2,-6,-1,-4,1,-1,-1,-1,2,-1
KR_6721571826,420,-8,-138,4,-18,-3,3,0,-4,4,0,-6,7,1,-4,7,3,-1,2,1,0,-8,-3,-5,0,5,-3,0,-2,-1,-1,-1,-1,6,-1
KR_6762983684,420,-1,35,-11,-3,1,0,1,-3,5,2,-1,3,2,2,1,3,-2,3,1,0,0,-15,0,-3,3,4,0,-1,-1,1,-1,-1,4,-1
KR_6695123834,420,-6,-90,-1,-16,-3,3,0,-5,5,0,-1,1,0,-6,7,1,-1,1,0,-1,-15,-154,3,-5,2,2,0,-1,1,-1,-1,-1,4,-1
KR_6736969970,420,-1,-16,19,4,5,0,5,0,3,3,-1,8,7,2,1,3,-2,2,0,0,-3,1,-2,-5,7,-5,0,1,-1,1,1,1,1,-1
KR_6626272060,420,-7,-31,-17,-15,-5,7,2,-3,5,2,-5,5,0,1,1,2,-3,3,0,0,-5,1,0,-4,4,0,0,-1,-1,-1,-1,-1,6,-1
KR_6703561933,420,-5,-29,-26,-9,2,0,2,-3,4,1,-1,1,0,-1,5,4,-6,8,2,1,-11,-3,2,-6,4,3,0,0,-1,1,-1,1,1,-1
KR_6754725454,440,-2,-64,12,-5,-3,4,1,0,1,1,-1,3,2,0,2,2,-1,1,0,0,-4,-14,-4,-2,6,-4,0,0,1,0,0,-1,1,-1
KR_6755153351,420,1,-36,20,8,3,0,3,5,0,5,-2,2,0,0,3,3,2,1,3,0,9,125,-2,-3,5,0,0,1,1,1,1,1,2,-1
KR_6751882978,420,1,-93,6,3,1,0,1,-3,6,3,3,4,7,2,0,2,0,1,1,0,6,-2,-5,-1,6,2,0,-1,1,-1,-1,-1,2,-1
KR_6593645633,420,-1,-15,22,-7,6,0,6,1,1,2,-1,6,5,-12,16,4,-1,1,0,0,-17,6,-2,-3,5,-3,0,0,-1,1,-1,1,4,-1
KR_6730208006,420,-2,-42,-32,-2,2,1,3,-6,6,0,-3,3,0,0,3,3,5,0,5,0,-2,-20,-2,-3,5,1,0,0,1,-1,0,1,3,-1
KR_6759614467,420,-2,-36,8,-6,-4,4,0,-1,1,0,1,1,2,-1,3,2,-1,1,0,0,-2,41,1,-3,2,-3,0,0,1,-1,-1,-1,2,-1
KR_6736288913,420,1,84,19,-6,7,0,7,-4,7,3,-8,10,2,-1,4,3,0,3,3,-1,-15,9,5,-5,0,-7,0,1,-1,0,1,1,2,-1
KR_6752028016,420,1,-86,-38,-1,-1,3,2,0,1,1,0,2,2,-2,3,1,2,1,3,0,5,-12,0,-2,2,5,0,-2,0,-1,-1,-1,0,-1
KR_6749227985,420,-1,-59,-20,-4,0,0,0,-1,2,1,-1,2,1,-3,3,0,1,0,1,0,0,5,2,-4,2,0,0,-1,1,-1,-1,-1,4,-1
KR_6662111941,420,-2,31,12,-8,-1,1,0,-5,6,1,-5,5,0,2,1,3,1,0,1,0,-6,-6,-4,-2,6,3,0,0,1,-1,1,-1,3,-1
KR_6723066576,420,-7,-89,-22,-9,-3,3,0,1,2,3,-4,6,2,-3,3,0,0,0,0,0,-8,-35,3,-6,3,21,0,-2,1,-1,-1,-1,6,-1
KR_6609865922,420,-4,-63,-4,-10,-2,2,0,-6,6,0,-4,4,0,0,2,2,2,0,2,0,-5,10,-2,-3,5,-5,0,-1,-1,0,-1,-1,4,-1
KR_6750605064,420,-2,-72,2,-12,-2,5,3,-2,3,1,-3,7,4,-3,7,4,-2,2,0,-1,-5,-15,-2,-4,6,2,0,0,0,1,0,-1,0,-1
KR_6636401857,420,1,-39,4,2,-1,1,0,3,0,3,-1,6,5,2,2,4,-1,1,0,0,9,-87,1,-4,3,0,0,0,0,0,-1,-1,0,-1
KR_6662757652,420,-3,-30,-25,-8,0,1,1,-9,9,0,2,2,4,-1,2,1,0,2,2,-1,-9,10,0,-6,6,-1,0,0,-1,-1,0,-1,6,-1
KR_6759067298,420,-2,-97,3,-9,-2,2,0,-1,1,0,-5,5,0,-2,2,0,1,1,2,0,-7,-5,-1,-6,7,-3,0,0,0,0,0,-1,0,-1
KR_6758868385,420,-2,-39,-8,-2,2,1,3,-3,4,1,-2,3,1,0,2,2,1,0,1,2,3,5,1,-6,5,-3,0,-1,-1,1,-1,1,2,-1
KR_6761451542,440,1,57,-4,-13,1,4,5,-2,2,0,-4,7,3,-7,7,0,-1,4,3,0,-14,6,-2,-2,4,2,0,0,0,1,1,-1,0,-1
KR_6711880082,420,2,92,23,3,1,1,2,-4,4,0,5,1,6,-2,4,2,3,0,3,0,-11,-117,-1,-1,2,-1,0,2,1,1,1,1,2,-1
KR_6614725753,420,6,144,-8,-1,4,0,4,-3,4,1,-5,6,1,2,0,2,1,0,1,0,-6,-196,-1,-1,2,3,0,1,-1,-1,1,1,3,-1
KR_6750476942,420,-3,-57,-20,-13,-5,5,0,-4,5,1,-3,4,1,-1,3,2,0,0,0,-4,-17,4,2,-4,2,0,0,-2,-1,-1,-1,-1,4,-1
KR_6581491074,420,-5,-65,-1,-7,-4,6,2,1,2,3,0,0,0,0,2,2,-4,4,0,0,1,-368,-3,-4,7,-23,0,-1,-1,1,-1,-1,4,-1
KR_6705829988,420,-1,-14,0,-10,-4,4,0,-3,4,1,3,2,5,-3,7,4,-3,3,0,-2,-7,-117,2,-5,3,0,0,-1,0,-1,1,-1,0,-1
KR_6691468828,420,-2,-54,4,-3,-1,1,0,0,2,2,3,0,3,-9,10,1,4,1,5,1,1,4,0,-4,4,1,0,-2,1,1,-1,1,3,-1
KR_6740097722,420,-2,5,10,-2,-2,3,1,0,4,4,-2,3,1,0,2,2,2,1,3,0,1,147,-2,-5,7,3,0,-1,-1,-1,-1,1,4,-1
KR_6644826300,420,-5,-29,-50,-10,-1,3,2,-2,2,0,-5,6,1,-2,5,3,0,0,0,0,-4,-138,-1,0,1,0,0,-2,-1,-1,-1,-1,4,-1
KR_6704979221,420,-5,-55,-11,-13,-6,8,2,-2,5,3,-2,4,2,-3,5,2,0,2,2,-1,-7,225,0,-2,2,2,0,-2,-1,1,-1,-1,1,-1
KR_6743555308,420,-7,-144,-28,-12,-4,5,1,0,3,3,-2,2,0,-6,7,1,0,2,2,-1,-14,-17,-1,-2,3,2,0,-2,-1,1,-1,-1,5,-1
KR_6756121355,420,-3,20,-4,-7,2,2,4,-2,2,0,-5,7,2,1,2,3,-3,3,0,0,-15,-5,-1,-8,9,0,0,1,-1,1,1,1,6,-1
KR_6745391503,420,3,5,12,10,0,3,3,3,0,3,0,0,0,8,0,8,-1,2,1,0,11,302,-1,-2,3,-1,0,1,1,1,1,1,6,-1
KR_6679593852,420,-4,-16,-20,-8,1,0,1,-3,4,1,0,1,1,-2,8,6,-4,4,0,0,-5,-1,2,-5,3,1,0,-1,-1,1,-1,-1,2,-1
KR_6758513475,420,-1,-19,-17,1,3,0,3,2,2,4,-2,3,1,2,0,2,-4,4,0,0,-4,20,-4,-2,6,2,0,0,-1,1,0,-1,1,-1
KR_6748077687,420,-3,-17,-23,-4,-1,2,1,-3,4,1,0,5,5,1,2,3,-1,1,0,0,0,1,-2,-3,5,0,0,1,-1,1,1,1,6,-1
KR_6732484970,420,-4,-10,0,-10,-5,5,0,1,3,4,-2,3,1,-3,4,1,-1,1,0,0,-6,-25,-6,0,6,1,0,-1,0,0,-1,-1,0,-1
KR_6741078368,440,-1,-6,-11,-5,4,1,5,4,2,6,-2,3,1,-6,7,1,-5,5,0,0,-8,2,2,-4,2,2,0,1,1,-1,1,-1,6,-1
KR_6752884884,420,-5,-19,-28,7,1,1,2,8,0,8,-2,3,1,2,3,5,-2,3,1,0,7,4,3,-4,1,-1,0,-1,0,-1,-1,1,0,-1
KR_6760877267,420,-2,-66,-8,-6,-3,3,0,-3,5,2,3,2,5,-1,2,1,-2,2,0,0,-2,-103,-2,-1,3,-19,0,0,1,0,-1,-1,4,-1
KR_6743001534,420,-6,-37,-25,-13,-1,1,0,-6,9,3,3,1,4,-6,8,2,-3,3,0,1,-7,-8,-2,-2,4,2,0,-1,-1,-1,-1,1,6,-1
KR_6635705273,420,-1,-52,-32,-6,-5,6,1,-3,4,1,3,0,3,0,1,1,-1,1,0,0,-2,5,3,-6,3,-1,0,0,-1,1,0,-1,2,-1
KR_6761125976,420,0,-45,-16,-4,1,1,2,-2,2,0,-4,7,3,1,2,3,0,1,1,0,1,2,0,-3,3,-2,0,0,1,1,-1,1,5,-1
KR_6734115291,420,1,45,-20,1,2,0,2,-2,4,2,0,2,2,1,0,1,0,2,2,0,-1,-4,1,-4,3,4,0,0,1,-1,0,1,3,-1
KR_6635757118,420,-3,-85,-10,-12,-1,2,1,-6,6,0,2,0,2,-7,8,1,0,1,1,0,-13,5,-3,-2,5,1,0,0,-1,-1,-1,1,5,-1
KR_6751430388,420,-4,47,-24,-9,-3,3,0,-3,4,1,-2,2,0,-1,3,2,0,1,1,0,-11,2,3,-5,2,-2,0,-2,-1,-1,-1,-1,3,-1
KR_6756574341,420,-2,-101,-2,-6,-3,3,0,0,3,3,-2,3,1,-2,2,0,1,1,2,0,1,-2,-1,-3,4,-1,0,-1,1,-1,-1,-1,4,-1
KR_6683930700,420,-2,-65,-7,-3,-4,6,2,1,1,2,2,1,3,-3,5,2,1,1,2,0,-3,2,4,-7,3,-4,0,0,-1,-1,0,-1,2,-1
KR_6710337055,420,-3,-28,-4,-8,0,2,2,-1,2,1,1,0,1,-7,7,0,-1,1,0,-3,-9,-1,-1,-5,6,4,0,-2,-1,0,-1,-1,1,-1
KR_6756292928,420,-2,-17,-15,-4,2,0,2,0,2,2,-2,4,2,-3,4,1,-1,1,0,0,-2,-11,-2,-2,4,5,0,-2,-1,-1,-1,-1,4,-1
KR_6751125689,440,-1,9,-11,0,-2,3,1,0,2,2,0,0,0,-3,4,1,5,2,7,0,5,-133,-1,0,1,0,0,-1,-1,-1,-1,1,2,-1
KR_6651452348,420,-2,-123,14,-5,-4,4,0,0,1,1,-1,2,1,-1,2,1,1,0,1,0,-3,-1,-4,-4,8,1,0,0,-1,0,0,-1,6,-1
KR_6736482772,420,0,38,0,-3,-2,3,1,0,2,2,4,1,5,-5,7,2,0,1,1,0,-4,3,-1,-1,2,-2,0,0,1,-1,-1,1,3,-1
KR_6707004846,420,2,-38,19,3,-1,1,0,0,0,0,-1,2,1,6,1,7,-1,3,2,0,2,-97,-2,-4,6,2,0,-1,1,1,-1,1,3,-1
KR_6753889470,420,0,-40,0,0,-3,4,1,-1,3,2,-1,3,2,2,1,3,3,1,4,1,3,-7,-2,-8,10,0,0,0,-1,-1,0,1,1,-1
KR_6752342406,420,-2,-33,-4,1,-1,2,1,-5,5,0,1,1,2,6,1,7,0,1,1,0,2,-10,0,-6,6,0,0,-1,1,1,-1,1,6,-1
KR_6728049447,420,-3,-82,4,-7,-1,3,2,-3,7,4,0,1,1,-1,2,1,-2,2,0,-1,1,-119,4,-5,1,-5,0,-1,0,0,-1,-1,0,-1
KR_6754996187,420,-1,30,-24,-4,3,1,4,0,3,3,1,2,3,-5,6,1,-3,5,2,-1,-5,3,4,-5,1,-4,0,-1,0,-1,-1,-1,0,-1
KR_6759821425,420,-2,-83,4,-9,0,2,2,-1,3,2,-1,3,2,-8,9,1,1,0,1,0,-9,-10,-7,-1,8,1,0,0,-1,1,-1,-1,2,-1
KR_6609604257,420,-2,-34,24,-8,-6,7,1,7,3,10,-1,2,1,-6,6,0,-2,2,0,0,-8,-25,1,-6,5,3,0,-1,-1,-1,-1,-1,3,-1
KR_6668984970,420,0,28,19,6,4,0,4,6,0,6,-2,2,0,1,2,3,-3,4,1,0,7,-19,0,-4,4,3,0,0,0,-1,1,1,0,-1
KR_6732927642,420,-5,-64,-20,-10,-2,3,1,-3,4,1,0,1,1,-1,3,2,-4,4,0,-1,-12,-4,2,-4,2,-4,0,-1,-1,1,-1,-1,5,-1
KR_6742027733,440,1,16,36,-6,-3,4,1,-3,3,0,1,1,2,0,2,2,-1,1,0,0,-7,101,-2,-2,4,0,0,-1,-1,-1,-1,-1,3,-1
KR_6762845340,420,0,-45,-16,-10,-9,9,0,4,3,7,-2,2,0,-3,7,4,0,1,1,-1,-5,-37,2,-5,3,12,0,-1,-1,0,-1,-1,4,-1
KR_6760996555,440,0,-26,20,5,-2,2,0,-2,4,2,0,3,3,7,0,7,2,1,3,0,4,4,7,-9,2,2,0,0,1,0,0,1,6,-1
KR_6724125276,420,0,-20,22,-2,1,1,2,-1,3,2,1,4,5,-2,6,4,-1,2,1,-2,-2,11,7,-8,1,-6,0,0,-1,1,1,-1,4,-1
KR_6656288047,420,-2,1,0,-1,-2,3,1,1,0,1,-3,4,1,2,2,4,1,0,1,0,3,13,6,-8,2,-8,0,0,0,1,1,-1,0,-1
KR_6756053817,420,0,12,-32,-4,-2,3,1,-7,7,0,3,1,4,1,2,3,1,2,3,0,-1,40,1,-6,5,-27,0,0,-1,1,0,-1,4,-1
KR_6696060466,420,1,-53,25,-8,-4,4,0,-4,5,1,1,2,3,-1,5,4,0,2,2,0,-3,-3,0,-4,4,1,0,-1,-1,-1,-1,1,4,-1
KR_6600804620,420,-2,50,-8,-5,2,2,4,-1,5,4,0,2,2,-5,7,2,-1,2,1,-1,-5,2,-2,-2,4,3,0,0,-1,1,0,-1,2,-1
KR_6760917163,420,-3,35,-48,-3,0,1,1,1,3,4,-2,5,3,-1,3,2,-1,1,0,0,-4,-26,0,-5,5,19,0,1,1,1,1,1,6,-1
KR_6723908794,420,0,12,-34,0,2,1,3,4,2,6,-3,4,1,-2,5,3,-1,3,2,0,-1,-5,-2,-3,5,1,0,1,1,0,1,-1,5,-1
KR_6761916725,420,-5,-41,-21,-9,-2,3,1,-5,7,2,3,3,6,-2,2,0,-3,3,0,-1,-14,1,-2,-4,6,-2,0,-1,-1,1,-1,-1,3,-1
KR_6400504151,420,-6,-50,-16,-9,-2,2,0,-4,5,1,-4,4,0,-1,1,0,2,1,3,0,-4,-17,-2,-6,8,3,0,0,-1,-1,-1,-1,4,-1
KR_6752724903,420,-4,-43,-32,-4,2,1,3,0,4,4,-2,2,0,-4,6,2,0,1,1,0,0,-6,0,-3,3,1,0,-3,-1,-1,-1,-1,4,-1
KR_6685062277,420,-2,-27,-16,-2,1,1,2,0,3,3,-2,3,1,-1,3,2,0,1,1,0,-6,-5,-1,-3,4,-4,0,-1,-1,-1,-1,-1,2,-1
KR_6598621451,420,-1,-29,36,-2,-1,3,2,1,2,3,-3,5,2,4,5,9,-3,5,2,-2,-1,14,4,-4,0,-1,0,0,-1,1,1,-1,2,-1
KR_6752460264,420,-5,71,4,-6,-1,1,0,-3,4,1,2,2,4,-4,5,1,0,3,3,0,-11,5,1,-2,1,-2,0,1,0,1,1,-1,0,-1
KR_6675827077,420,-5,48,0,-14,-3,4,1,-7,10,3,-3,3,0,-1,1,0,0,0,0,0,-9,-3,3,-6,3,-2,0,0,1,-1,0,-1,1,-1
KR_6568310725,440,-3,-30,-40,4,1,0,1,-5,7,2,3,1,4,1,1,2,4,1,5,0,1,-13,2,-3,1,-2,0,-1,-1,0,-1,1,3,-1
KR_6749692119,420,-3,27,-32,-8,-3,4,1,-2,8,6,-2,3,1,3,2,5,-4,4,0,0,-7,-13,-9,-1,10,3,0,-1,-1,1,-1,-1,4,-1
KR_6762480707,420,0,59,15,-8,1,2,3,-2,2,0,2,2,4,-5,7,2,-4,5,1,0,-3,37,1,-2,1,-14,0,-1,-1,-1,-1,1,3,-1
KR_6759321373,420,-1,46,7,2,-3,5,2,-1,3,2,-5,7,2,11,2,13,0,0,0,0,3,-6,-7,0,7,3,0,-1,-1,-1,1,1,2,-1
KR_6610648725,420,3,-54,28,5,1,1,2,0,4,4,1,1,2,3,2,5,0,1,1,0,4,33,4,-7,3,1,0,-1,-1,1,1,1,5,-1
KR_6758036118,440,-2,-31,-12,-5,-2,4,2,1,2,3,-1,2,1,-1,5,4,-2,3,1,0,-7,-5,-2,-5,7,-3,0,0,1,-1,0,1,5,-1
KR_6761376778,420,0,-32,14,0,-3,3,0,3,1,4,-3,3,0,1,3,4,2,1,3,0,-2,399,-1,-2,3,3,0,-1,1,1,-1,1,2,-1
KR_6764114586,420,-2,34,-32,-1,1,1,2,0,3,3,-4,7,3,2,0,2,0,0,0,0,4,-4,1,-6,5,-8,0,0,0,0,0,1,0,-1
KR_6504412999,420,1,60,-20,-4,5,0,5,-5,6,1,-1,3,2,-3,4,1,0,0,0,0,-7,-2,-7,-1,8,1,0,2,1,1,1,-1,4,-1
KR_6763297495,420,-5,-48,-17,-4,-4,4,0,1,1,2,-3,4,1,4,0,4,-2,2,0,0,1,36,-1,-4,5,-32,0,-2,1,-1,-1,-1,2,-1
KR_6659638203,420,-5,-122,-36,-26,-8,9,1,-12,14,2,-3,3,0,-4,5,1,1,0,1,-2,-25,458,-5,0,5,-1,0,-4,0,-1,-1,-1,0,-1
KR_6661861420,420,2,82,2,6,6,0,6,-3,4,1,3,1,4,2,3,5,-2,3,1,0,-4,-7,-1,-3,4,-3,0,0,1,1,1,1,5,-1
KR_6664661398,420,-6,-108,-44,-9,-6,6,0,3,1,4,-3,4,1,-3,6,3,0,2,2,0,-2,56,-3,-2,5,19,0,-1,1,0,-1,1,5,-1
KR_6725909044,420,-3,-45,30,-4,0,2,2,0,8,8,-4,6,2,0,2,2,0,2,2,0,2,-2,0,-3,3,-1,0,-2,-1,-1,-1,1,2,-1
KR_6730679596,440,-5,-62,-12,-10,-4,4,0,-1,3,2,1,1,2,-6,8,2,0,0,0,0,-12,249,-2,-3,5,20,0,-3,-1,-1,-1,-1,1,-1
KR_6606240134,420,-5,-64,-4,-7,-6,6,0,6,2,8,-1,3,2,-1,2,1,-5,6,1,0,-10,6,4,-5,1,2,0,-1,0,-1,-1,-1,0,-1
KR_6723124068,420,-2,18,-15,-7,-4,4,0,-3,4,1,-1,1,0,2,2,4,-1,2,1,0,-3,7,6,-8,2,-5,0,0,0,-1,0,-1,0,-1
KR_6731282475,420,2,-31,14,7,4,0,4,0,1,1,4,6,10,-3,3,0,2,1,3,0,0,-13,-4,0,4,-1,0,1,1,1,1,1,3,-1
KR_6636506414,440,-6,-34,-12,-20,-1,3,2,-8,9,1,0,0,0,-10,11,1,-1,2,1,0,-21,-2,-4,-4,8,0,0,-4,-1,-1,-1,-1,1,-1
KR_6750244101,420,-1,-33,-3,-2,1,1,2,1,1,2,1,2,3,-4,4,0,-1,1,0,0,-2,5,-10,0,10,-5,0,-1,-1,0,-1,-1,4,-1
KR_6674032042,420,1,22,-12,1,2,1,3,1,1,2,6,0,6,-5,5,0,-3,3,0,0,0,26,5,-5,0,-5,0,0,0,-1,-1,-1,0,-1
KR_6762390278,420,-4,-42,-38,-14,-1,3,2,-5,5,0,-5,5,0,-2,5,3,-1,1,0,0,-13,0,3,-6,3,0,0,-1,-1,1,-1,1,5,-1
KR_6759470551,420,-1,9,25,-5,3,2,5,-2,2,0,-2,3,1,-3,3,0,-1,3,2,0,-12,7,0,-4,4,0,0,0,-1,1,-1,1,2,-1
KR_6752999838,420,1,-17,-20,6,4,0,4,1,3,4,-5,5,0,2,1,3,4,0,4,0,6,-4,3,-6,3,1,0,1,0,-1,1,1,0,-1
KR_6763288130,440,-8,-113,-32,-15,1,4,5,-2,3,1,-8,8,0,-4,7,3,-2,3,1,-1,-12,14,-2,-2,4,3,0,-1,-1,0,-1,1,5,-1
KR_6722490253,420,-5,-124,-24,-17,-1,1,0,-1,1,0,-7,7,0,-6,6,0,-2,2,0,0,-11,-3,3,-6,3,-2,0,-2,-1,-1,-1,-1,6,-1
KR_6719148159,420,-3,-87,0,-4,-3,4,1,2,3,5,2,0,2,-4,4,0,-1,3,2,0,0,-2,-1,-3,4,-2,0,-2,1,1,-1,-1,4,-1
KR_6758112942,440,-5,-93,-17,-13,-6,6,0,5,1,6,-8,9,1,-1,3,2,-3,3,0,0,-7,1,2,-5,3,-7,0,-1,-1,-1,-1,-1,1,-1
KR_6698332015,420,-4,-67,8,-13,1,1,2,-9,9,0,-2,4,2,-3,3,0,0,1,1,0,-12,-2,-3,-1,4,-1,0,-1,-1,1,-1,1,1,-1
KR_6762568959,420,-2,-71,-16,-4,3,1,4,-3,3,0,-3,3,0,-2,4,2,1,1,2,0,-4,-40,-3,-4,7,-2,0,0,1,1,0,-1,6,-1
KR_6733321559,420,-6,-82,9,-15,-9,9,0,-5,7,2,0,3,3,1,7,8,-2,2,0,-1,-12,-3,-2,-4,6,1,0,-1,-1,-1,-1,1,1,-1
KR_6726033296,420,1,10,-19,2,-1,2,1,-2,4,2,1,3,4,2,2,4,2,0,2,0,-2,-1,4,-5,1,0,0,0,0,0,0,-1,0,-1
KR_6751277215,420,-1,6,11,1,2,1,3,-3,6,3,3,1,4,-1,1,0,0,0,0,0,-3,-12,2,-5,3,-4,0,0,-1,1,0,1,2,-1
KR_6732580368,420,-3,-30,-21,-2,-3,3,0,0,4,4,1,0,1,1,3,4,-1,3,2,0,-9,-1,0,-3,3,-5,0,-1,-1,-1,-1,-1,5,-1
KR_6633569856,420,-1,-22,-12,1,3,1,4,0,2,2,0,1,1,-1,2,1,-1,1,0,0,0,-1,-2,-2,4,-1,0,0,-1,-1,0,1,6,-1
KR_6732769577,420,-2,-19,-5,-3,1,0,1,-1,2,1,1,0,1,-1,3,2,-3,3,0,0,-4,-11,4,-8,4,1,0,-1,1,-1,-1,-1,6,-1
KR_6722613554,420,1,29,-3,1,-2,3,1,0,5,5,-2,5,3,5,0,5,0,1,1,0,7,-3,0,-5,5,-1,0,-1,-1,-1,-1,-1,6,-1
KR_6501700471,420,1,-35,25,3,2,4,6,5,2,7,-6,7,1,2,3,5,0,2,2,-1,3,3,-3,-1,4,-1,0,-2,0,0,-1,-1,0,-1
KR_6762611980,420,0,-36,4,-4,0,0,0,1,1,2,1,0,1,-1,4,3,-5,6,1,0,-4,-1,-2,-1,3,2,0,0,1,1,1,-1,5,-1
KR_6686304112,440,0,51,-12,-3,-1,1,0,-3,5,2,0,0,0,0,3,3,1,0,1,0,-5,-4,4,-9,5,6,0,0,1,1,0,1,2,-1
KR_6762960504,420,-2,-31,19,-6,-1,2,1,2,3,5,0,0,0,-5,7,2,-2,3,1,0,-6,295,1,-1,0,0,0,0,-1,1,0,1,1,-1
KR_6645861173,420,-1,-48,-4,-3,1,0,1,0,1,1,1,1,2,-5,5,0,0,0,0,0,-6,34,-2,-4,6,-7,0,0,1,-1,0,-1,4,-1
KR_6761664953,420,-1,-5,-27,-3,2,1,3,-3,3,0,-2,2,0,0,0,0,0,0,0,0,1,25,2,-4,2,-2,0,0,0,-1,0,-1,0,-1
KR_6757883753,420,0,8,3,0,8,0,8,-5,7,2,-1,4,3,-1,3,2,-1,1,0,1,0,-3,-5,-3,8,2,0,-1,-1,1,-1,1,4,-1
KR_6705026781,420,-5,-33,-12,-12,-5,5,0,-1,5,4,-2,3,1,-3,4,1,-1,1,0,0,-15,6,1,-1,0,-3,0,-1,1,-1,-1,-1,6,-1
KR_6760647271,420,-2,-27,-16,0,-2,3,1,-2,5,3,0,3,3,4,3,7,0,1,1,0,3,-2,-1,-1,2,3,0,-1,0,-1,-1,1,0,-1
KR_6763605748,420,-4,-60,-38,-11,-1,3,2,-2,2,0,-5,6,1,-4,4,0,1,1,2,-2,-10,-438,1,-2,1,-3,0,-2,-1,0,-1,-1,3,-1
KR_6762568298,420,-2,-49,-7,-1,-4,4,0,2,3,5,11,0,11,-2,5,3,-8,8,0,-1,-1,-4,2,-4,2,0,0,0,1,-1,0,-1,4,-1
KR_6750136773,440,-2,-32,-30,-6,-1,2,1,-1,2,1,-2,4,2,-2,3,1,0,2,2,0,-10,-2,2,-4,2,-1,0,0,-1,-1,-1,-1,4,-1
KR_6688480624,420,-5,-59,8,-10,0,2,2,-2,2,0,-4,4,0,-2,2,0,-2,4,2,-2,-11,-9,0,-2,2,-5,0,-1,-1,1,-1,-1,3,-1
KR_6684098218,420,-4,-57,4,-10,-5,5,0,0,3,3,-1,2,1,-3,6,3,-1,2,1,1,-6,4,3,-4,1,1,0,-1,-1,-1,-1,1,1,-1
KR_6743699979,440,5,105,-20,5,0,2,2,-3,3,0,4,1,5,0,2,2,4,0,4,0,4,23,-3,-2,5,-1,0,0,0,-1,1,1,0,-1
KR_6733677315,420,0,-84,-3,0,-4,4,0,4,1,5,1,3,4,1,0,1,-2,2,0,0,5,-2,1,-2,1,4,0,-2,0,-1,-1,-1,0,-1
KR_6746858411,420,-3,-112,-4,-7,3,0,3,-7,8,1,0,5,5,-3,3,0,0,2,2,1,-12,-8,-2,-2,4,-2,0,-1,-1,-1,-1,1,1,-1
KR_6723793305,420,1,-52,20,5,2,1,3,0,3,3,2,0,2,-1,4,3,2,0,2,-1,4,123,-1,-5,6,1,0,0,0,1,0,-1,0,-1
KR_6762743713,420,1,-32,-1,3,-2,3,1,1,3,4,-1,4,3,1,1,2,4,1,5,0,7,-3,-2,-3,5,2,0,0,-1,1,0,-1,4,-1
KR_6707054417,420,-4,-26,8,-7,-3,4,1,0,5,5,-3,3,0,0,2,2,-1,1,0,0,-5,1,6,-8,2,-3,0,0,1,-1,-1,-1,6,-1
KR_6752864621,420,0,22,-12,-1,3,1,4,0,1,1,-6,7,1,0,5,5,2,1,3,-1,0,-8,-2,-4,6,-4,0,0,-1,-1,-1,-1,3,-1
KR_6764541859,440,-1,-86,20,-1,-5,5,0,1,4,5,4,0,4,-1,2,1,0,0,0,0,6,15,6,-9,3,-8,0,0,1,-1,-1,-1,1,-1
KR_6763473717,420,1,26,15,-2,-1,2,1,-2,3,1,-2,3,1,2,0,2,1,0,1,0,2,4,-2,0,2,1,0,1,-1,1,1,-1,3,-1
KR_6759091461,440,-2,7,-12,-4,1,0,1,-2,5,3,0,1,1,-4,6,2,1,1,2,-1,-7,9,2,-4,2,0,0,0,0,1,-1,-1,0,-1
KR_6756954058,420,4,2,24,9,-2,2,0,4,1,5,3,3,6,3,2,5,1,0,1,0,7,-319,2,-4,2,0,0,0,1,0,1,1,3,-1
KR_6388375102,420,-4,2,-63,-7,1,1,2,-1,5,4,-9,9,0,1,1,2,1,0,1,-1,1,133,-1,-2,3,-29,0,-1,1,-1,-1,-1,2,-1
KR_6763901496,420,0,12,15,-4,-4,5,1,-3,5,2,4,3,7,0,2,2,-1,2,1,0,-4,4,-1,-2,3,-2,0,0,-1,-1,0,1,5,-1
KR_6743454820,440,-3,-86,0,-3,0,1,1,-4,4,0,2,2,4,-1,5,4,0,1,1,0,-10,8,1,-2,1,-4,0,0,-1,1,0,1,4,-1
KR_6742762831,420,-3,-60,32,-4,-3,3,0,-3,4,1,-3,4,1,4,2,6,1,0,1,0,-5,4,0,-3,3,0,0,-1,1,1,-1,-1,2,-1
KR_6639664882,420,0,-48,10,5,4,0,4,0,3,3,-1,4,3,2,1,3,0,0,0,0,-1,190,-3,0,3,0,0,1,-1,0,1,1,4,-1
KR_6763601296,420,-1,-53,4,-7,-1,1,0,1,4,5,-1,5,4,-5,10,5,-1,1,0,-2,-19,-8,-2,-5,7,-6,0,-2,1,-1,-1,-1,5,-1
KR_6389328871,420,-3,-94,-4,-3,1,2,3,-1,2,1,2,2,4,-4,4,0,-1,1,0,0,-3,-10,0,-5,5,-6,0,0,-1,1,0,-1,1,-1
KR_6196015326,420,-5,-102,-24,-11,3,2,5,-3,5,2,-5,5,0,-4,4,0,-2,3,1,-1,-9,-45,-6,-4,10,0,0,-1,-1,-1,-1,-1,1,-1
KR_6752169301,420,-5,-60,-32,-11,-2,2,0,-2,3,1,-3,4,1,-3,5,2,-1,2,1,0,-8,2,0,-5,5,-1,0,0,-1,-1,-1,-1,1,-1
KR_6662993162,420,3,44,19,0,-1,2,1,-1,1,0,-4,5,1,4,1,5,2,0,2,0,2,53,-3,-1,4,-24,0,1,0,1,1,1,0,-1
KR_6628985112,420,2,32,-12,6,4,0,4,-1,3,2,0,1,1,0,4,4,3,1,4,0,0,-15,2,-5,3,-1,0,0,0,-1,0,1,0,-1
KR_6761212438,420,0,-47,14,5,0,1,1,2,1,3,0,2,2,3,4,7,0,1,1,0,1,3,0,-2,2,1,0,0,1,-1,0,-1,3,-1
KR_6667469049,420,0,35,-3,1,-1,1,0,-2,3,1,-1,4,3,4,0,4,1,1,2,0,1,6,0,-3,3,-1,0,1,1,-1,1,-1,2,-1
KR_6738524409,420,-2,-10,12,-5,2,0,2,-1,4,3,-4,5,1,-1,1,0,-1,2,1,-1,-5,-18,-2,-2,4,4,0,-1,1,1,-1,-1,4,-1
KR_6747334889,420,0,-30,52,0,2,0,2,-1,1,0,0,1,1,0,1,1,-1,2,1,0,-2,-19,2,-3,1,22,0,0,1,1,0,1,1,-1
KR_6760303014,440,-3,-56,-28,-5,-3,3,0,3,1,4,-7,9,2,0,2,2,2,0,2,-1,-6,2,3,-7,4,-2,0,0,-1,1,0,-1,6,-1
KR_6742245168,420,1,27,0,4,3,0,3,-6,9,3,4,3,7,2,2,4,1,0,1,0,1,-3,2,-4,2,-1,0,-1,1,-1,-1,1,2,-1
KR_6698065032,420,-1,-22,8,-3,-3,3,0,-3,4,1,3,1,4,-2,4,2,2,1,3,-1,-3,127,-1,-5,6,-1,0,-1,-1,1,-1,-1,3,-1
KR_6635411729,420,-6,8,-16,-7,-2,2,0,2,0,2,-1,3,2,-4,6,2,-2,4,2,0,-5,-1,5,-7,2,-5,0,-2,-1,-1,-1,-1,3,-1
KR_6719066700,420,-1,-7,-29,-3,0,3,3,1,1,2,-6,7,1,-1,2,1,3,0,3,-1,1,11,2,-5,3,-1,0,-1,1,-1,-1,-1,2,-1
KR_6754126980,420,-1,-6,45,0,4,0,4,0,2,2,-4,5,1,1,0,1,-1,1,0,0,6,11,-3,-2,5,2,0,2,-1,1,1,1,6,-1
KR_6730854460,420,-7,-60,-24,-11,-7,8,1,-2,2,0,-2,3,1,1,2,3,-1,3,2,-1,-4,-286,3,-4,1,5,0,-2,-1,-1,-1,-1,3,-1
KR_6699771282,420,-3,75,-7,-3,2,1,3,-3,3,0,3,0,3,-3,4,1,-2,2,0,0,-8,-35,4,-9,5,29,0,0,1,1,1,-1,1,-1
KR_6763545890,420,-5,-105,16,-19,1,0,1,-2,7,5,-7,7,0,-8,10,2,-3,4,1,0,-17,-5,-4,-1,5,-4,0,-3,-1,-1,-1,-1,6,-1
KR_6753792694,420,2,4,8,10,8,1,9,-1,1,0,-3,3,0,2,6,8,4,0,4,3,16,5,4,-6,2,2,0,0,1,1,0,1,2,-1
KR_6622563281,420,-3,-57,8,-10,-1,2,1,1,0,1,-11,12,1,1,0,1,0,0,0,0,-6,2,2,-6,4,-3,0,0,1,-1,-1,-1,4,-1
KR_6751317283,420,-3,-6,12,-5,2,0,2,-2,5,3,1,1,2,-5,6,1,-1,3,2,0,-10,-246,-1,-2,3,0,0,0,1,-1,0,-1,5,-1
KR_6761274580,420,-5,-112,-18,-14,-8,8,0,2,0,2,-5,7,2,0,2,2,-3,3,0,-1,-8,-106,-3,-1,4,-4,0,-1,0,-1,-1,-1,0,-1
KR_6758731654,420,-3,-43,9,-10,-2,3,1,-5,5,0,2,2,4,-3,3,0,-2,2,0,0,-13,4,0,-2,2,3,0,0,-1,1,0,1,6,-1
KR_6665379788,420,4,35,20,0,0,3,3,5,2,7,-2,4,2,0,6,6,-3,5,2,0,-7,-4,-2,-1,3,0,0,0,0,-1,0,-1,0,-1
KR_6759070391,420,0,-56,-13,2,1,1,2,-1,4,3,4,3,7,-3,4,1,1,2,3,0,1,-137,-1,-4,5,-1,0,1,1,1,1,-1,2,-1
KR_6666446848,420,-1,-32,0,1,-1,1,0,4,2,6,-2,2,0,-1,1,0,1,0,1,0,5,-5,2,-4,2,3,0,0,0,0,0,-1,0,-1
KR_6762315568,420,-2,-10,18,-7,-3,3,0,-2,2,0,0,1,1,3,4,7,-5,5,0,-1,-9,319,-3,0,3,5,0,2,-1,1,1,-1,2,-1
KR_6760702913,420,-2,-37,-36,4,-2,3,1,1,3,4,-1,3,2,5,1,6,1,0,1,0,5,-1,-2,-3,5,5,0,0,-1,-1,-1,1,2,-1
KR_6750595405,420,-3,-53,-11,-7,-7,7,0,2,1,3,-3,4,1,3,0,3,-2,2,0,0,3,3,0,-6,6,2,0,1,-1,1,-1,1,2,-1
KR_6753127180,440,1,39,3,9,2,0,2,5,1,6,-1,3,2,3,1,4,0,2,2,0,8,4,-2,-1,3,5,0,1,1,1,1,1,1,-1
KR_6762204803,420,-4,-15,-24,0,-1,3,2,-8,12,4,5,1,6,1,5,6,3,2,5,1,5,4,2,-3,1,-1,0,-1,-1,-1,-1,1,3,-1
KR_6760271915,420,-2,10,-4,-6,-1,2,1,1,2,3,-1,3,2,-5,5,0,0,1,1,0,-5,-4,-1,-2,3,0,0,0,0,0,0,-1,0,-1
KR_6721280243,420,-1,-67,-39,-2,0,3,3,-3,6,3,0,3,3,2,0,2,-1,1,0,0,5,2,0,-3,3,-1,0,-1,-1,-1,-1,-1,5,-1
KR_6762193527,440,2,33,-1,8,3,0,3,3,0,3,0,3,3,2,4,6,0,5,5,0,6,2,4,-4,0,-1,0,0,1,-1,1,1,4,-1
KR_6724166720,420,-6,-48,-12,-13,-5,5,0,0,2,2,-4,5,1,-3,4,1,-1,4,3,0,-10,-8,-1,-2,3,-4,0,-1,-1,-1,-1,-1,1,-1
KR_6725253194,440,-7,-183,-4,-18,-1,4,3,-5,6,1,-6,6,0,-6,8,2,0,3,3,-2,-8,12,0,-4,4,-1,0,-1,-1,-1,-1,-1,1,-1
KR_6654955275,420,-2,-125,0,-7,-2,3,1,-1,5,4,1,0,1,-2,3,1,-3,5,2,0,-4,-180,0,-5,5,0,0,-1,1,-1,-1,-1,1,-1
KR_6626436847,440,-3,2,-36,-7,-3,5,2,-4,5,1,-3,4,1,4,0,4,-1,3,2,0,-1,-1,1,-5,4,2,0,-1,0,-1,-1,-1,0,-1
KR_6650963052,420,0,14,-1,-2,2,1,3,-2,4,2,2,0,2,-3,3,0,-1,1,0,0,-3,-6,4,-6,2,0,0,1,-1,1,1,1,5,-1
KR_6604935879,420,0,9,-36,-4,-2,2,0,-1,2,1,-2,2,0,2,2,4,-1,3,2,0,-5,-7,-1,-5,6,-1,0,1,-1,1,1,-1,1,-1
KR_6725520084,420,-1,50,12,1,0,2,2,0,3,3,0,4,4,2,2,4,-1,2,1,0,2,-8,2,-2,0,-2,0,-1,-1,0,-1,-1,1,-1
KR_6699428766,440,-1,-4,-29,-7,0,1,1,-5,6,1,-1,4,3,1,1,2,-2,7,5,0,-7,-36,2,-5,3,10,0,-1,1,1,-1,-1,6,-1
KR_6752330714,420,-4,-37,-20,-8,0,2,2,-1,2,1,-1,2,1,-2,4,2,-4,4,0,-1,-11,-30,-2,-3,5,5,0,-1,0,1,-1,-1,0,-1
KR_6636412547,420,0,-4,-24,-9,-2,3,1,-3,4,1,-4,4,0,-1,7,6,1,0,1,-1,-11,-7,-1,-4,5,-2,0,-1,-1,-1,-1,-1,6,-1
KR_6527943453,420,0,9,5,0,0,3,3,-1,3,2,3,0,3,-1,3,2,-1,1,0,0,-3,-4,2,-2,0,0,0,-1,-1,1,-1,-1,3,-1
KR_6764745358,440,3,11,-36,8,-2,5,3,0,3,3,1,3,4,3,3,6,6,0,6,0,10,9,1,-3,2,0,0,1,-1,1,1,-1,1,-1
KR_6607547889,420,-2,-17,-16,-7,-1,2,1,1,3,4,1,1,2,-2,2,0,-6,8,2,-1,-9,-1,-2,-4,6,-4,0,-2,-1,1,-1,-1,5,-1
KR_6616100334,440,-2,-2,-8,-4,-1,2,1,-2,3,1,1,1,2,-3,5,2,1,1,2,0,-5,-6,-3,-2,5,-3,0,-2,-1,-1,-1,-1,5,-1
KR_6670352152,440,-1,-23,-16,5,-1,4,3,0,0,0,0,3,3,4,0,4,2,0,2,0,13,-91,0,-3,3,3,0,-1,1,0,-1,-1,3,-1
KR_6746114223,420,-7,-87,-33,-17,-4,5,1,-6,7,1,-3,3,0,-4,7,3,0,2,2,0,-10,-265,6,-9,3,-1,0,-2,-1,-1,-1,-1,3,-1
KR_6757321828,420,2,58,-8,-1,3,1,4,-3,5,2,0,4,4,0,5,5,-1,3,2,0,-6,5,-4,-2,6,-1,0,2,1,1,1,-1,5,-1
KR_6744908302,440,-6,-94,12,-20,0,1,1,-1,3,2,-6,8,2,-9,10,1,-4,4,0,0,-25,13,-4,-1,5,0,0,-1,-1,-1,-1,-1,5,-1
KR_6722376301,420,0,-69,-17,-8,1,3,4,-2,3,1,-6,7,1,0,1,1,-1,1,0,-1,-8,-12,-2,-4,6,-1,0,-2,-1,1,-1,-1,4,-1
KR_6741851620,420,4,3,16,1,1,0,1,2,0,2,-1,2,1,1,3,4,-2,2,0,0,0,34,-4,-3,7,-5,0,0,-1,0,0,1,2,-1
KR_6720821721,440,-2,17,0,-3,-2,2,0,-1,2,1,0,1,1,1,0,1,-1,2,1,0,-3,-50,-1,-4,5,-6,0,0,-1,-1,0,1,3,-1
KR_6588165918,420,1,16,-25,8,2,2,4,4,0,4,5,2,7,-1,2,1,-2,2,0,0,7,22,-3,-2,5,0,0,1,-1,0,1,1,3,-1
KR_5935586251,420,-4,44,24,-11,1,1,2,-4,5,1,-2,3,1,-2,3,1,-4,4,0,0,-23,2,-1,-3,4,0,0,-2,-1,-1,-1,1,5,-1
KR_6750384619,420,-2,-13,-36,-2,4,1,5,-1,2,1,0,2,2,-5,6,1,0,0,0,0,-7,0,-1,-3,4,-1,0,0,0,0,0,-1,0,-1
KR_6764449177,420,-1,13,-10,-1,0,2,2,-4,7,3,1,1,2,2,2,4,0,1,1,0,-4,0,-2,-2,4,1,0,-1,-1,-1,-1,1,5,-1
KR_6705674744,420,1,-12,12,2,-2,3,1,0,2,2,2,1,3,3,1,4,-1,3,2,0,5,-1,1,-3,2,-2,0,-1,-1,1,-1,1,6,-1
KR_6760730881,420,2,-64,40,11,-3,5,2,4,3,7,6,1,7,0,6,6,4,0,4,0,12,23,1,-3,2,-2,0,0,0,1,1,1,0,-1
KR_6755390398,420,-2,-17,4,-12,-1,2,1,-1,2,1,0,3,3,-5,6,1,-5,8,3,0,-13,-10,-2,0,2,0,0,-1,-1,-1,-1,1,1,-1
KR_6750667623,420,-4,-112,15,-7,0,2,2,-4,5,1,2,2,4,-5,5,0,0,0,0,0,-9,14,1,-5,4,-1,0,0,-1,0,0,1,1,-1
KR_6735975879,420,-2,-14,19,-7,1,2,3,2,2,4,-6,12,6,-3,6,3,-1,1,0,0,-7,2,-3,-3,6,3,0,0,1,-1,0,1,5,-1
KR_6725437593,420,-4,11,-26,-10,1,4,5,-8,10,2,1,0,1,0,2,2,-4,5,1,0,2,-1,-2,-2,4,2,0,-1,-1,0,-1,-1,6,-1
KR_6703570996,420,1,-49,-23,1,1,2,3,0,3,3,3,3,6,-3,3,0,0,0,0,0,-1,-21,0,-2,2,1,0,0,0,1,-1,-1,0,-1
KR_6695297728,420,-2,-69,0,-10,-9,9,0,6,0,6,2,2,4,-6,10,4,-3,4,1,-3,0,21,-2,-4,6,-3,0,-2,-1,-1,-1,-1,3,-1
KR_6619120632,420,5,77,32,8,-1,2,1,1,3,4,7,0,7,2,0,2,-1,1,0,0,2,3,-1,-2,3,-4,0,0,0,0,1,1,0,-1
KR_6610867541,420,-5,-26,17,-13,-2,3,1,-8,8,0,-2,2,0,0,2,2,-1,1,0,0,-19,-74,2,-6,4,-4,0,-1,-1,-1,-1,1,2,-1
KR_6725269582,440,-2,-25,-19,6,6,1,7,-1,3,2,-5,5,0,3,2,5,3,1,4,0,-3,-44,-5,-3,8,20,0,1,-1,1,-1,1,3,-1
KR_6764490408,440,-3,25,-12,-8,-2,2,0,-3,3,0,-2,3,1,-1,2,1,0,0,0,1,-8,-20,-1,-5,6,1,0,0,1,-1,0,1,1,-1
KR_6762549433,420,0,-28,4,-4,-4,7,3,0,3,3,-3,4,1,3,0,3,0,0,0,0,-2,5,1,-1,0,-2,0,-1,0,0,-1,-1,0,-1
KR_6661900478,420,1,-17,-6,3,-1,4,3,-1,1,0,3,2,5,0,1,1,2,0,2,-1,7,40,-3,-2,5,-2,0,1,1,1,1,-1,2,-1
KR_6685729807,420,0,-13,20,-4,1,1,2,-1,2,1,-7,7,0,2,0,2,1,1,2,0,-3,4,2,-4,2,1,0,0,-1,-1,0,1,3,-1
KR_6730048482,420,1,-37,16,2,-1,1,0,0,3,3,0,3,3,4,4,8,-1,2,1,-1,5,-2,1,-5,4,-2,0,-2,1,0,-1,-1,2,-1
KR_6714772351,420,-2,-35,1,-3,-5,5,0,1,4,5,0,5,5,1,1,2,0,0,0,0,1,306,1,-4,3,-1,0,-1,1,0,-1,-1,3,-1
KR_6759319452,420,-4,-110,-12,-9,-5,6,1,3,1,4,-6,8,2,-2,4,2,1,0,1,0,8,10,4,-5,1,0,0,-1,1,-1,-1,-1,4,-1
KR_6736044446,420,-2,-29,-28,-3,2,1,3,-5,7,2,-4,4,0,3,0,3,1,3,4,0,-10,-236,-3,0,3,-4,0,0,-1,1,0,1,4,-1
KR_6592416788,420,-3,-1,-28,-7,-4,4,0,-2,3,1,2,1,3,-5,6,1,2,0,2,0,-4,10,3,-6,3,-2,0,-1,-1,-1,-1,-1,4,-1
KR_6665460510,420,-2,-75,-66,-3,2,1,3,0,4,4,1,1,2,-5,7,2,-1,3,2,0,-7,-4,-1,0,1,-3,0,-1,-1,-1,-1,-1,6,-1
KR_6617367466,440,-3,15,-18,-8,-2,2,0,-3,5,2,-2,4,2,-1,3,2,0,0,0,0,-12,-1,-7,-1,8,-7,0,0,-1,-1,-1,-1,5,-1
KR_6704156315,420,-4,13,-30,-7,-3,3,0,1,3,4,-7,8,1,3,6,9,-1,1,0,0,-2,-2,0,-2,2,-2,0,-1,-1,-1,-1,-1,6,-1
KR_6763325500,420,-4,-35,16,-6,-2,5,3,-1,3,2,-2,3,1,-1,3,2,0,0,0,-1,-9,385,1,-2,1,1,0,0,1,-1,-1,-1,3,-1
KR_6610081536,420,-2,-29,-7,-8,-9,10,1,-3,3,0,-1,2,1,3,1,4,2,2,4,0,0,-8,-2,-3,5,2,0,0,-1,-1,-1,1,1,-1
KR_6763257567,420,1,45,12,-8,3,0,3,-6,6,0,-4,4,0,2,1,3,-3,3,0,0,-11,-3,-5,-2,7,4,0,0,-1,-1,0,1,4,-1
KR_6700290732,420,-3,-119,-12,-5,-6,6,0,-1,4,3,6,0,6,-2,3,1,-2,4,2,1,-3,-6,-2,-2,4,-1,0,-1,1,1,-1,1,2,-1
KR_6750315050,440,-3,-59,-9,-8,-3,5,2,-2,6,4,-5,9,4,2,2,4,0,1,1,-1,1,-24,1,-5,4,5,0,-4,1,-1,-1,-1,3,-1
KR_6698645227,420,1,-18,8,1,-2,3,1,2,2,4,2,3,5,0,2,2,-1,3,2,0,3,-108,-1,-2,3,5,0,0,-1,-1,1,1,4,-1
KR_6729398283,420,-2,-12,-12,-2,1,1,2,2,2,4,-2,3,1,-4,5,1,1,0,1,0,-8,-4,1,-2,1,0,0,0,1,0,-1,1,4,-1
KR_6654994283,420,2,40,29,5,1,1,2,2,2,4,-3,3,0,2,0,2,3,0,3,0,3,-1,0,-4,4,-5,0,0,1,1,0,1,6,-1
KR_6750920140,420,-5,-21,-45,-3,2,1,3,1,0,1,-8,8,0,-1,2,1,3,0,3,1,0,-5,-1,-3,4,2,0,-1,-1,-1,-1,1,4,-1
KR_6747312269,420,-1,-2,-18,3,-2,2,0,-1,3,2,12,0,12,-2,7,5,-4,4,0,0,4,30,-2,-4,6,-1,0,1,1,-1,1,1,5,-1
KR_6660772275,440,-2,11,-8,-3,-4,4,0,1,1,2,-2,3,1,2,6,8,0,0,0,0,-7,-3,2,-4,2,2,0,-1,-1,-1,-1,1,1,-1
KR_6763200430,440,-3,-10,-40,-14,-6,6,0,-6,6,0,-1,1,0,-4,6,2,3,2,5,0,-15,6,1,-4,3,2,0,0,-1,0,0,-1,1,-1
KR_6699757086,420,-2,-56,-12,-7,-5,7,2,-1,2,1,0,4,4,-2,3,1,1,0,1,1,5,0,-1,-2,3,2,0,-2,1,-1,-1,1,3,-1
KR_6686689044,420,-4,-26,-40,-9,0,1,1,0,0,0,-2,4,2,-7,9,2,0,1,1,0,-6,-7,-1,-4,5,-4,0,0,-1,-1,-1,-1,2,-1
KR_6753342022,420,-1,-53,-23,-6,1,1,2,0,1,1,-8,8,0,-1,4,3,2,0,2,0,-3,-111,-2,-1,3,4,0,-1,-1,1,-1,-1,1,-1
KR_6756717852,420,3,14,4,15,6,0,6,0,3,3,2,2,4,5,0,5,2,0,2,1,15,-6,1,-4,3,-5,0,1,-1,-1,1,1,3,-1
KR_6630230818,420,0,-46,-8,-5,-1,2,1,-3,3,0,1,2,3,-3,7,4,1,1,2,-1,-7,0,-2,-1,3,-1,0,-2,-1,-1,-1,-1,4,-1
KR_6759591197,420,1,28,-20,2,-3,6,3,3,1,4,0,2,2,1,1,2,1,0,1,0,6,4,2,-2,0,0,0,0,-1,0,0,-1,1,-1
KR_6731779330,440,3,89,-23,2,-2,3,1,-2,3,1,-3,6,3,2,3,5,7,2,9,-1,4,8,1,-2,1,2,0,0,0,0,1,-1,0,-1
KR_6747237402,420,2,56,10,2,0,2,2,2,3,5,0,1,1,0,1,1,0,1,1,0,-3,9,-3,-1,4,-4,0,1,0,0,1,-1,0,-1
KR_6761144837,420,-3,-39,-35,-9,-2,3,1,-4,5,1,-2,2,0,-1,3,2,0,0,0,0,-4,12,5,-5,0,-1,0,0,1,1,0,-1,5,-1
KR_6759291920,420,3,0,14,8,4,1,5,-2,2,0,1,1,2,3,1,4,2,1,3,0,2,275,3,-5,2,-1,0,1,1,1,1,1,4,-1
KR_6756109347,420,-4,-65,-9,-5,-2,3,1,0,1,1,-1,1,0,-2,4,2,0,1,1,0,-1,-64,-3,-1,4,38,0,0,-1,-1,0,-1,2,-1
KR_6760959822,420,-4,-112,4,-11,-1,3,2,-3,3,0,-2,3,1,-5,7,2,0,0,0,-2,-13,5,-5,0,5,3,0,-1,-1,-1,-1,-1,6,-1
KR_6694575126,420,0,-80,-9,-3,1,0,1,-1,3,2,-1,3,2,0,2,2,-2,3,1,0,-3,5,2,-7,5,0,0,0,-1,-1,0,-1,6,-1
KR_6689719517,420,-5,-45,-27,-9,-3,4,1,-1,6,5,0,3,3,-4,5,1,-1,1,0,0,0,-5,-3,-1,4,0,0,-3,-1,1,-1,-1,1,-1
KR_6758178426,420,-3,12,-28,1,-1,1,0,-1,3,2,2,2,4,5,1,6,-4,4,0,1,0,6,1,-4,3,-2,0,1,1,-1,1,1,1,-1
KR_6764267409,420,-1,-1,-12,3,1,1,2,0,3,3,1,2,3,1,4,5,0,2,2,1,10,-2,0,-2,2,-3,0,0,1,0,-1,1,2,-1
KR_6716100899,420,-3,-6,-20,-3,-4,4,0,2,1,3,0,3,3,2,2,4,-3,3,0,0,0,-30,-1,-2,3,1,0,-3,1,-1,-1,-1,2,-1
KR_6762394003,420,-2,16,-36,-3,-1,1,0,-1,5,4,2,0,2,-1,4,3,-2,2,0,0,1,-386,3,-5,2,4,0,-1,0,-1,-1,-1,0,-1
KR_6726184488,440,-1,-44,-24,-3,0,0,0,1,0,1,-5,6,1,2,1,3,-1,2,1,0,-9,-1,-1,-3,4,-3,0,-1,-1,-1,-1,1,6,-1
KR_6605276358,440,1,-7,-28,-3,-4,5,1,-6,8,2,3,0,3,1,2,3,3,0,3,0,-5,1,2,-7,5,-2,0,1,1,-1,1,1,6,-1
KR_6659721699,420,-1,13,-8,4,-1,1,0,-1,4,3,-5,5,0,10,0,10,1,2,3,0,-1,4,-1,-3,4,-1,0,0,1,-1,1,1,5,-1
KR_6633292895,420,-1,5,-8,-1,-1,2,1,0,1,1,2,1,3,0,1,1,-2,2,0,0,-3,-6,0,-4,4,2,0,0,0,-1,0,-1,0,-1
KR_6749503872,420,-1,-67,-18,-1,2,1,3,-3,3,0,1,2,3,-1,2,1,0,0,0,0,-2,-21,0,-1,1,1,0,-1,-1,-1,-1,1,5,-1
KR_6759263600,420,-3,-83,-48,1,-1,2,1,-1,4,3,1,3,4,0,4,4,2,0,2,0,-3,142,-2,-4,6,-1,0,1,-1,1,-1,-1,3,-1
KR_6739027719,440,2,142,1,-2,-3,5,2,1,1,2,-7,7,0,4,0,4,3,0,3,1,-1,-4,-3,-4,7,6,0,2,-1,1,1,1,1,-1
KR_6761464241,420,-1,21,-20,3,2,0,2,0,1,1,-1,2,1,1,2,3,1,0,1,0,4,-153,-1,-5,6,-3,0,0,1,-1,0,1,2,-1
KR_6694026291,420,-4,-61,-4,-3,-2,2,0,-1,4,3,0,2,2,0,1,1,0,0,0,0,-1,15,0,-5,5,-4,0,0,1,-1,-1,1,5,-1
KR_6612526921,420,2,-41,-13,4,3,2,5,6,3,9,-2,4,2,-3,3,0,0,0,0,0,-1,-9,3,-6,3,0,0,0,-1,1,1,-1,3,-1
KR_6654885127,420,-2,-41,-16,0,-3,4,1,5,2,7,-3,5,2,-1,3,2,2,1,3,-1,6,1,-1,-1,2,1,0,1,1,-1,1,-1,6,-1
KR_6747328013,420,0,66,22,0,-2,5,3,0,2,2,-1,1,0,2,1,3,1,0,1,0,0,7,-5,0,5,2,0,2,1,-1,1,1,3,-1
KR_6196075550,420,-3,48,-32,-3,1,1,2,-1,4,3,-1,1,0,-3,4,1,1,0,1,-1,-5,320,-1,-4,5,-15,0,2,1,1,1,-1,4,-1
KR_6721791328,420,-1,4,-8,-3,-2,3,1,-3,5,2,4,2,6,0,0,0,-2,2,0,0,3,-101,1,-3,2,2,0,-1,-1,-1,-1,1,3,-1
KR_6761664360,420,0,-106,-43,3,0,0,0,-2,5,3,0,2,2,-1,2,1,6,0,6,0,5,245,0,-1,1,30,0,0,0,-1,0,1,0,-1
KR_6756288248,420,-7,-67,-34,-9,-3,3,0,-6,6,0,5,3,8,-5,7,2,0,2,2,0,-11,-8,-3,-2,5,-1,0,0,-1,0,-1,1,4,-1
KR_6690175967,420,-2,18,-4,-10,-2,2,0,-11,13,2,2,0,2,1,2,3,0,1,1,1,-9,-6,1,-5,4,-2,0,-1,0,-1,-1,1,0,-1
KR_6751723728,420,-2,-19,-28,-4,4,1,5,0,4,4,-5,8,3,-2,2,0,-1,3,2,1,-8,3,5,-8,3,-3,0,0,-1,1,-1,1,4,-1
KR_6673273709,420,0,-38,2,1,-2,2,0,0,3,3,1,1,2,3,0,3,-1,3,2,0,5,7,1,-6,5,0,0,0,-1,1,0,-1,2,-1
KR_6762689053,440,-1,-39,-12,5,3,2,5,0,2,2,0,1,1,-5,6,1,7,1,8,1,4,-13,5,-6,1,-3,0,0,1,-1,-1,1,2,-1
KR_6660668346,420,-1,-8,2,-3,1,0,1,-5,7,2,1,1,2,0,0,0,0,0,0,0,-6,88,2,-4,2,-2,0,0,0,1,-1,1,0,-1
KR_6759388170,420,-3,18,-12,-8,-2,3,1,1,2,3,1,1,2,-5,6,1,-3,3,0,0,-7,-9,-5,0,5,6,0,-1,-1,-1,-1,-1,2,-1
KR_6713150580,420,-2,-62,-12,-3,1,1,2,5,3,8,-3,5,2,-3,3,0,-3,3,0,0,6,2,4,-12,8,-4,0,0,0,-1,-1,-1,0,-1
KR_6699719684,420,2,27,0,4,4,2,6,1,1,2,-5,5,0,1,2,3,3,0,3,0,8,9,1,-4,3,1,0,0,0,0,0,1,0,-1
KR_6755032011,420,-5,-20,6,-19,-5,7,2,-6,6,0,-2,3,1,-2,2,0,-4,4,0,-2,-20,-10,-2,-3,5,1,0,0,-1,0,-1,-1,2,-1
KR_6759344364,420,-5,-90,-12,-6,1,0,1,1,0,1,1,1,2,-8,10,2,-1,3,2,0,-9,-9,2,-3,1,-1,0,-2,-1,1,-1,-1,1,-1
KR_6499186674,420,-1,-6,-4,-9,-2,3,1,3,2,5,-6,6,0,-3,3,0,-1,1,0,0,-17,-1,-1,-3,4,-1,0,0,-1,1,1,1,1,-1
KR_5664290580,420,2,6,-16,6,2,2,4,-1,3,2,5,4,9,-3,4,1,3,3,6,0,7,-115,0,-4,4,0,0,1,1,1,1,-1,6,-1
KR_6720805769,420,-3,-26,-7,-3,-1,4,3,-4,5,1,-6,7,1,6,0,6,2,1,3,0,-2,-1,-1,-4,5,-1,0,0,-1,-1,-1,-1,5,-1
KR_6675020631,420,3,-20,33,9,0,1,1,-1,5,4,-2,3,1,9,0,9,3,0,3,0,3,-2,-1,-3,4,2,0,1,1,-1,-1,1,6,-1
KR_6759034494,420,0,-14,-24,-2,6,0,6,2,1,3,-3,4,1,-6,7,1,-1,2,1,1,-10,-6,-1,-3,4,-2,0,-1,-1,-1,-1,1,4,-1
KR_6705222663,420,-1,0,15,-1,1,2,3,1,1,2,0,1,1,-1,6,5,-2,2,0,0,0,0,0,-3,3,-1,0,0,1,1,-1,1,6,-1
KR_6760032217,420,1,-29,48,-1,4,1,5,-1,4,3,-4,4,0,-2,2,0,2,0,2,-1,-8,-118,-3,-7,10,1,0,1,0,-1,1,-1,0,-1
KR_6732277236,420,1,-61,8,2,-1,3,2,3,1,4,1,1,2,0,1,1,-1,1,0,0,10,0,2,-4,2,0,0,0,1,1,-1,-1,3,-1
KR_6752459428,420,-1,-32,4,7,5,2,7,5,1,6,-3,5,2,0,4,4,0,2,2,1,5,-54,0,-5,5,20,0,0,-1,1,-1,1,2,-1
KR_6718798176,420,2,-23,20,-2,0,3,3,-3,6,3,-3,4,1,1,2,3,3,1,4,0,3,4,1,-4,3,-3,0,1,1,-1,1,1,1,-1
KR_6730418350,420,-4,0,-4,-9,3,1,4,3,0,3,-8,8,0,-3,4,1,-4,4,0,0,-12,-7,-3,-1,4,2,0,-2,-1,1,-1,1,2,-1
KR_6755008030,420,-3,-74,24,-8,0,2,2,-5,7,2,-1,1,0,-1,3,2,-1,3,2,0,-3,-5,3,-5,2,0,0,-3,-1,-1,-1,1,1,-1
KR_6649662200,420,1,40,4,1,2,3,5,-2,3,1,1,0,1,1,3,4,-1,1,0,0,-2,34,0,-6,6,-26,0,-1,-1,1,1,1,6,-1
KR_6693298422,420,-2,-57,-32,-1,0,3,3,1,3,4,2,0,2,-2,5,3,-2,3,1,0,-8,-6,5,-6,1,-2,0,-2,-1,-1,-1,1,6,-1
KR_6712541382,420,-1,-7,-11,2,-4,4,0,7,1,8,-1,4,3,2,0,2,-2,4,2,0,3,4,2,-6,4,-4,0,-1,0,-1,-1,-1,0,-1
KR_6752902415,420,1,16,1,6,-1,2,1,1,7,8,2,0,2,2,2,4,2,0,2,0,11,9,6,-7,1,1,0,-1,1,0,-1,1,2,-1
KR_6755073991,420,0,-21,8,-14,-1,1,0,-3,3,0,-6,8,2,-1,3,2,-3,4,1,0,-18,-4,-4,-2,6,-2,0,0,-1,-1,-1,-1,6,-1
KR_6747944852,420,-4,-54,13,-7,-1,5,4,-3,3,0,-1,2,1,-2,2,0,0,0,0,-1,2,-3,2,-7,5,-1,0,-1,1,1,-1,-1,2,-1
KR_6757865542,420,-2,-8,-16,-10,-1,1,0,0,1,1,-3,4,1,-2,4,2,-4,4,0,0,-8,-3,3,-7,4,-5,0,0,-1,-1,0,1,2,-1
KR_6702923923,420,-4,-83,-20,-7,-5,5,0,2,3,5,0,3,3,-3,3,0,-1,1,0,1,-5,-33,-2,-2,4,-7,0,-1,-1,-1,-1,1,6,-1
KR_6712596516,420,-6,-101,-8,-13,2,1,3,-3,4,1,-6,6,0,-6,10,4,0,0,0,-1,-10,-34,1,-3,2,16,0,-6,0,-1,-1,-1,0,-1
KR_6718594723,420,-5,-162,-83,-8,-1,4,3,-3,3,0,5,0,5,-5,5,0,-4,4,0,-1,-4,-8,-1,-3,4,0,0,-3,-1,0,-1,-1,6,-1
KR_6667132169,420,-4,-39,-30,-9,-1,3,2,-5,6,1,-5,6,1,1,3,4,1,1,2,-1,-11,-8,-4,-2,6,5,0,0,-1,-1,-1,-1,4,-1
KR_6697745060,420,-7,-81,-20,-13,-4,4,0,-5,5,0,-2,3,1,-1,2,1,-1,4,3,0,-7,25,2,-4,2,-8,0,-1,-1,-1,-1,-1,4,-1
KR_6754818827,420,-5,-81,-13,-8,1,2,3,-3,6,3,-4,4,0,0,6,6,-2,4,2,0,-17,20,1,-3,2,-31,0,-1,1,0,-1,1,2,-1
KR_6646321318,420,6,112,31,13,3,1,4,6,1,7,-1,2,1,1,5,6,4,0,4,-2,-2,4,3,-3,0,2,0,3,1,1,1,-1,5,-1
KR_6388606379,420,-10,-72,-62,-13,0,1,1,-1,1,0,-5,6,1,-1,4,3,-6,6,0,0,-17,-113,-4,-1,5,-2,0,-5,-1,-1,-1,-1,2,-1
KR_6504268769,420,1,-28,-8,1,1,2,3,-6,6,0,0,1,1,5,1,6,1,3,4,0,-3,17,1,-5,4,-3,0,-2,1,-1,-1,-1,3,-1
KR_6711311528,420,-2,29,-31,-1,1,2,3,0,3,3,0,0,0,0,3,3,-2,3,1,1,-5,233,0,-3,3,-1,0,0,0,1,1,1,0,-1
KR_6694548339,420,-5,-77,-1,-8,-4,6,2,-1,1,0,-1,3,2,0,0,0,-2,2,0,1,-4,-4,-1,-4,5,-1,0,-2,-1,1,-1,1,6,-1
KR_6701259079,420,2,6,6,6,1,1,2,2,2,4,-1,7,6,4,1,5,0,0,0,0,2,347,0,-2,2,1,0,1,-1,1,1,-1,5,-1
KR_6750741153,420,-6,-24,-36,-11,0,1,1,0,1,1,-6,7,1,-4,5,1,-1,2,1,0,-3,-16,1,-2,1,-2,0,-3,-1,-1,-1,-1,4,-1
KR_6749538836,420,2,-74,-12,6,1,2,3,1,3,4,4,2,6,-1,1,0,1,0,1,0,-5,8,2,-3,1,0,0,-1,1,-1,-1,-1,4,-1
KR_6758092452,420,2,-2,-8,3,-1,2,1,0,4,4,0,2,2,6,1,7,-2,5,3,1,3,-5,-2,-3,5,4,0,-1,1,-1,-1,1,5,-1
KR_6723850392,440,-6,-117,-55,-18,-6,6,0,-9,9,0,1,3,4,-5,6,1,1,0,1,0,-6,-14,-2,0,2,1,0,-4,-1,-1,-1,-1,5,-1
KR_6741451188,420,-4,-14,19,-5,1,3,4,-4,6,2,2,1,3,-5,5,0,1,1,2,1,-15,-296,0,-3,3,0,0,-2,-1,-1,-1,1,6,-1
KR_6760704553,420,0,24,-20,-7,0,3,3,0,2,2,-2,3,1,-9,11,2,4,1,5,-1,-4,2,0,-1,1,-2,0,1,-1,1,1,-1,1,-1
KR_6759888114,440,-9,-59,-32,-18,-9,9,0,-4,8,4,-1,2,1,-1,2,1,-3,5,2,0,-7,-9,0,-2,2,2,0,-4,-1,-1,-1,-1,1,-1
KR_5551478691,420,-2,-92,-28,-3,0,1,1,0,1,1,0,2,2,-3,3,0,0,2,2,0,-1,3,-2,-1,3,-4,0,-1,1,-1,-1,-1,2,-1
KR_6541785362,420,-4,-18,-28,-13,-2,4,2,-4,4,0,-4,6,2,0,2,2,-3,3,0,0,-8,4,-3,-4,7,0,0,-1,-1,1,-1,-1,3,-1
KR_6764210363,420,-2,-17,16,-3,-2,5,3,2,1,3,0,1,1,-2,3,1,-1,1,0,0,-9,28,2,-5,3,-2,0,0,-1,0,-1,-1,3,-1
KR_6735433103,420,-6,-105,-4,-15,-3,4,1,-11,13,2,0,4,4,1,3,4,-2,2,0,-1,-8,-37,2,-4,2,23,0,-5,1,-1,-1,-1,2,-1
KR_6686547457,420,-2,43,4,-6,-2,3,1,-2,3,1,-1,5,4,1,0,1,-2,2,0,0,-10,-2,-2,-2,4,1,0,-1,-1,-1,-1,-1,2,-1
KR_6675494837,440,2,14,12,-1,-4,4,0,-2,4,2,1,2,3,-2,2,0,6,0,6,0,0,-14,-2,-4,6,6,0,0,-1,1,0,-1,1,-1
KR_6755494506,420,-1,-19,32,-3,1,1,2,-1,3,2,-2,5,3,-3,4,1,2,1,3,1,-1,-4,0,-4,4,0,0,-1,1,-1,-1,1,3,-1
KR_6668505857,420,-2,-14,-24,-6,2,1,3,-2,3,1,-4,6,2,-2,3,1,0,0,0,-2,-4,-9,-4,-3,7,1,0,0,0,0,1,-1,0,-1
KR_6759554800,420,2,-75,24,0,-1,3,2,3,0,3,1,0,1,-1,1,0,-2,4,2,0,1,1,-3,-3,6,0,0,0,1,-1,0,-1,1,-1
KR_6744012995,420,3,12,9,5,-5,6,1,1,1,2,1,2,3,8,0,8,0,1,1,0,11,-3,-4,0,4,2,0,-1,-1,-1,-1,-1,5,-1
KR_6490093927,440,3,-6,-16,3,6,0,6,0,5,5,-3,5,2,0,1,1,0,1,1,0,1,-39,0,-2,2,16,0,1,1,1,1,-1,6,-1
KR_6758952977,420,-1,-55,8,2,-6,6,0,2,1,3,2,1,3,1,1,2,3,1,4,0,10,-7,-3,-1,4,3,0,0,1,1,1,-1,5,-1
KR_6633384852,420,-5,-65,-8,-15,-2,2,0,-2,2,0,-9,9,0,-2,2,0,0,1,1,0,-8,-10,1,-1,0,0,0,-2,-1,-1,-1,-1,4,-1
KR_6698363980,420,-1,-25,-4,-4,-1,1,0,1,0,1,0,2,2,-1,4,3,-3,5,2,0,-4,14,3,-5,2,0,0,1,-1,1,1,-1,2,-1
KR_6751753406,420,-2,-69,-20,-4,1,1,2,2,2,4,-1,1,0,-4,7,3,-2,2,0,-1,-1,-43,2,-4,2,-1,0,-1,-1,-1,-1,-1,3,-1
KR_6667469839,420,1,3,-4,6,0,1,1,-2,4,2,5,1,6,-1,3,2,4,0,4,0,5,-222,0,-2,2,-2,0,0,-1,-1,0,1,2,-1
KR_6730731851,440,-3,-54,12,-13,2,1,3,-6,6,0,-1,2,1,-4,5,1,-4,4,0,0,-9,-28,-2,-3,5,25,0,0,-1,0,-1,-1,5,-1
KR_6713937765,420,-2,-17,36,-15,-4,4,0,-1,6,5,0,0,0,-5,7,2,-5,5,0,1,-10,-3,-1,-9,10,1,0,-1,1,0,-1,1,2,-1
KR_6760529887,420,-1,-81,7,-2,0,4,4,2,2,4,3,3,6,-4,4,0,-3,3,0,-1,1,11,-2,-2,4,1,0,-2,1,0,-1,-1,3,-1
KR_6658668510,420,-2,-84,-13,-7,-1,1,0,-1,2,1,-3,5,2,-2,3,1,0,0,0,1,1,2,-1,-4,5,5,0,0,1,0,0,1,6,-1
KR_6760804951,420,-2,22,-20,-1,-1,1,0,-1,2,1,0,2,2,1,1,2,0,1,1,0,-2,3,1,-2,1,-1,0,-1,-1,-1,-1,1,5,-1
KR_5823806590,420,-6,-74,-48,-7,-6,7,1,-3,4,1,-3,5,2,3,2,5,2,1,3,-1,-7,16,3,-5,2,-4,0,-2,1,1,-1,-1,1,-1
KR_6647723632,440,-2,13,-14,-3,0,0,0,2,3,5,0,1,1,-5,6,1,0,0,0,0,-8,-13,0,-6,6,0,0,0,-1,-1,0,-1,6,-1
KR_6755157115,420,1,-9,4,4,-1,1,0,3,1,4,1,4,5,-1,1,0,2,0,2,0,8,36,-3,-2,5,-10,0,0,-1,-1,0,-1,4,-1
KR_6633087113,440,2,27,-4,4,1,0,1,-1,8,7,1,2,3,4,1,5,-1,1,0,0,10,-12,4,-5,1,-1,0,0,1,-1,-1,1,1,-1
KR_6621272137,420,0,48,-13,-6,-7,7,0,-4,4,0,0,2,2,0,2,2,5,0,5,1,-5,6,0,-2,2,0,0,0,-1,-1,0,1,2,-1
KR_6742852589,420,-6,-138,-39,-16,-2,4,2,1,1,2,-4,4,0,-6,6,0,-5,5,0,0,-15,-16,-2,-1,3,-2,0,-1,0,1,-1,-1,0,-1
KR_6670207554,420,-8,-44,-24,-16,0,1,1,-7,8,1,-7,7,0,-2,4,2,0,2,2,0,-9,-3,-5,-2,7,1,0,-2,-1,-1,-1,-1,6,-1
KR_6740758589,420,1,35,8,2,6,1,7,-4,8,4,-1,3,2,0,2,2,1,0,1,0,-6,0,0,-3,3,1,0,1,-1,1,1,1,4,-1
KR_6529135284,420,-3,-85,-5,-9,-6,6,0,-3,4,1,-3,4,1,4,1,5,-1,3,2,-1,1,-7,-4,-1,5,-3,0,-1,-1,1,-1,1,1,-1
KR_6754360855,440,0,-9,9,6,6,2,8,2,2,4,2,4,6,-5,6,1,1,1,2,-1,7,12,0,-4,4,0,0,1,1,1,1,-1,1,-1
KR_6752941982,420,4,47,8,11,2,0,2,3,1,4,2,4,6,2,2,4,2,0,2,-1,9,0,-1,0,1,0,0,1,1,0,1,-1,6,-1
KR_6726328422,420,-2,13,-21,-6,-1,2,1,-2,4,2,2,2,4,-6,6,0,1,0,1,0,-13,-3,2,-4,2,-2,0,0,-1,1,1,-1,2,-1
KR_6748854202,420,-5,-37,7,-8,-1,1,0,0,2,2,-4,4,0,-4,4,0,1,2,3,-5,-14,-72,-3,-2,5,0,0,0,1,-1,-1,-1,2,-1
KR_6754478423,420,-1,60,-8,-12,2,0,2,-2,4,2,-4,4,0,-9,10,1,1,2,3,0,-11,15,1,-6,5,-2,0,0,-1,1,-1,-1,1,-1
KR_6719444912,420,0,-16,-15,-2,-2,2,0,-1,4,3,-1,4,3,0,2,2,2,1,3,0,-7,5,0,-2,2,-1,0,0,-1,0,0,1,3,-1
KR_6759254222,420,-1,-108,1,-7,-2,4,2,0,4,4,-2,3,1,-3,5,2,0,0,0,0,-4,30,-2,-2,4,-21,0,-2,-1,0,-1,-1,5,-1
KR_6756388912,420,-2,-56,6,-9,0,0,0,-2,3,1,-4,6,2,-2,6,4,-1,1,0,0,-3,-11,0,-4,4,0,0,-2,-1,1,-1,-1,6,-1
KR_6698412459,420,-5,-64,-43,-10,-8,9,1,-3,3,0,-1,2,1,1,5,6,1,1,2,0,-2,-2,-1,-3,4,3,-1,-4,-1,-1,-1,-1,2,-1
KR_6758873577,420,-5,-127,8,-6,2,0,2,2,1,3,1,1,2,-11,12,1,0,0,0,0,-7,-8,-3,-2,5,0,0,-1,-1,1,-1,-1,6,-1
KR_6731037331,420,0,-30,12,3,-1,2,1,2,3,5,-1,2,1,3,2,5,0,1,1,0,4,-3,0,-3,3,-4,0,0,1,-1,-1,-1,3,-1
KR_6593548789,420,-1,-11,9,0,-2,2,0,2,1,3,3,0,3,-2,4,2,-1,1,0,0,-3,17,-2,-2,4,-4,0,0,-1,1,0,1,6,-1
KR_6731891434,420,-5,-123,-20,-11,-1,1,0,-6,9,3,2,2,4,-3,5,2,-3,4,1,-2,-8,-23,0,-1,1,1,0,-1,-1,0,-1,-1,5,-1
KR_6746803334,420,-1,-22,-16,-3,0,2,2,-7,7,0,-4,5,1,4,1,5,4,0,4,1,-1,25,-1,-4,5,1,0,1,-1,1,1,1,1,-1
KR_6654920830,420,-4,2,28,-14,-2,2,0,-2,4,2,-8,8,0,-1,5,4,-1,1,0,0,-7,-7,-4,0,4,2,0,0,-1,-1,0,-1,3,-1
KR_6705976398,420,-8,-66,-20,-16,-6,7,1,-3,4,1,-9,9,0,3,1,4,-1,4,3,0,-7,-21,-1,-2,3,-1,0,-2,-1,-1,-1,-1,3,-1
KR_6752121054,420,0,-6,3,-5,1,0,1,-2,3,1,-4,7,3,1,1,2,-1,1,0,0,-15,-62,1,-4,3,-4,0,-1,0,-1,-1,1,0,-1
KR_6756171987,420,-1,-72,-27,-3,3,0,3,1,3,4,-6,6,0,-2,5,3,1,0,1,0,2,2,1,-3,2,1,0,-1,-1,0,-1,1,2,-1
KR_6730140983,420,-4,-26,-8,-3,-3,4,1,1,4,5,2,0,2,-2,4,2,-1,2,1,1,2,8,3,-5,2,0,0,0,0,-1,0,1,0,-1
KR_6635773183,420,-1,-26,-24,0,-3,3,0,4,0,4,0,1,1,-1,5,4,0,0,0,-1,0,-3,-2,-3,5,-3,0,0,-1,-1,0,-1,1,-1
KR_6762539541,440,3,-13,24,6,1,0,1,1,1,2,3,2,5,2,0,2,-1,1,0,0,2,2,-2,-3,5,0,0,0,-1,-1,0,1,3,-1
KR_6717495030,440,-1,-89,2,-1,1,0,1,2,1,3,1,0,1,-3,3,0,-2,2,0,0,1,-73,-2,-3,5,37,0,-1,0,-1,-1,-1,0,-1
KR_6670710813,420,-2,-87,-9,-6,0,4,4,-1,3,2,-1,2,1,-7,7,0,3,0,3,-2,-4,-2,-2,-3,5,-2,0,-1,-1,1,-1,-1,5,-1
KR_6661817893,420,0,-32,12,-3,-3,3,0,-1,2,1,2,1,3,-1,3,2,0,2,2,0,-5,7,-1,-5,6,3,0,2,1,1,1,-1,6,-1
KR_6753938597,420,-3,-58,-4,-5,0,1,1,-4,5,1,2,0,2,-2,3,1,-1,2,1,0,-6,148,3,-5,2,-5,0,0,-1,0,0,-1,1,-1
KR_6661863137,420,-3,-15,-7,-11,1,2,3,-5,6,1,-6,7,1,0,4,4,-1,2,1,0,-3,102,-2,-3,5,-10,0,0,-1,-1,-1,1,2,-1
KR_6734362214,420,-3,21,-4,-5,-1,1,0,-3,3,0,-2,2,0,1,2,3,0,0,0,0,-3,56,-2,-4,6,-17,0,0,-1,0,0,-1,5,-1
KR_6724218146,420,-3,-21,-29,-1,1,1,2,-1,3,2,-2,3,1,1,1,2,0,0,0,0,-4,-8,-3,-3,6,-3,0,0,-1,-1,-1,1,5,-1
KR_6761820536,420,-4,-48,-16,-6,-3,3,0,-4,5,1,-4,6,2,7,2,9,-2,2,0,0,0,0,0,-4,4,3,0,-2,0,-1,-1,1,0,-1
KR_6670951228,420,-9,-62,-28,-13,-6,6,0,-2,2,0,-3,6,3,-2,2,0,0,1,1,0,-11,-8,1,-4,3,2,0,-3,-1,-1,-1,-1,2,-1
KR_6727696945,420,-2,-14,-28,-3,-3,4,1,-1,3,2,2,1,3,-2,5,3,1,0,1,-1,3,11,-1,-5,6,6,0,0,1,-1,0,-1,6,-1
KR_6751650345,420,-3,-21,5,-7,1,0,1,-4,6,2,0,1,1,-2,4,2,-2,4,2,0,-8,89,3,-5,2,2,0,-1,-1,-1,-1,1,6,-1
KR_5664066690,420,-4,46,-27,-8,-1,2,1,-4,5,1,-8,9,1,3,1,4,2,0,2,0,-3,7,4,-6,2,-1,0,-1,-1,1,1,1,6,-1
KR_6732402847,420,-1,-32,-44,1,-2,2,0,5,1,6,0,2,2,-1,4,3,-1,2,1,1,-2,2,0,-3,3,-1,0,0,-1,-1,-1,1,3,-1
KR_6749758027,440,0,-10,-16,1,-1,3,2,0,6,6,2,2,4,-3,4,1,3,0,3,0,1,16,4,-6,2,-2,0,0,-1,0,0,-1,3,-1
KR_6737736851,420,-3,-76,-37,2,-2,2,0,-2,3,1,3,0,3,4,7,11,-1,1,0,-1,2,10,-1,-1,2,-1,0,-2,1,-1,-1,-1,2,-1
KR_6755749648,420,-2,-29,16,-9,-1,2,1,1,1,2,-1,2,1,-8,8,0,0,1,1,0,-14,-6,-2,-2,4,0,0,1,-1,1,1,-1,3,-1
KR_6718769801,420,-3,-43,16,-11,-4,4,0,-7,7,0,0,1,1,1,2,3,-1,1,0,0,-11,1,3,-5,2,-5,0,0,-1,-1,0,-1,6,-1
KR_6751112480,420,2,-8,7,-2,0,0,0,-1,4,3,-1,4,3,0,0,0,0,1,1,0,-7,1,1,-5,4,0,0,-1,0,0,1,-1,0,-1
KR_6732558557,420,-2,46,-36,-5,1,2,3,-3,3,0,-1,2,1,-2,2,0,0,0,0,0,-8,5,6,-8,2,-1,0,0,-1,1,0,-1,3,-1
KR_6738342436,420,-3,16,-23,-5,1,1,2,-1,1,0,0,5,5,-3,5,2,-2,2,0,0,-9,0,3,-4,1,-5,0,-1,1,-1,-1,1,5,-1
KR_6648675953,420,-2,-60,-24,-5,-2,2,0,-2,5,3,1,1,2,-1,3,2,-1,1,0,0,-8,-11,-1,-3,4,-6,0,0,-1,1,1,-1,1,-1
KR_6756633750,420,-3,-5,-32,-11,-2,3,1,4,1,5,-8,10,2,-5,5,0,0,2,2,0,-9,3,2,-5,3,-2,0,-2,0,1,-1,-1,0,-1
KR_6640558803,420,-5,-58,4,-5,2,0,2,0,4,4,-7,8,1,-2,3,1,2,1,3,0,-4,-22,0,-2,2,-3,0,-1,1,0,-1,-1,4,-1
KR_6727642176,420,-4,5,-20,-6,-8,8,0,3,0,3,-1,2,1,1,3,4,-1,2,1,0,2,-38,3,-4,1,1,0,-2,-1,0,-1,-1,5,-1
KR_6666357000,420,1,-18,34,1,0,1,1,-2,3,1,2,2,4,1,1,2,0,0,0,0,1,8,-1,-2,3,0,0,1,-1,1,1,1,5,-1
KR_6603191252,420,-4,0,4,-5,-1,3,2,-5,8,3,2,0,2,0,2,2,-1,1,0,0,-13,-4,-1,-5,6,-4,0,-1,1,-1,-1,1,1,-1
KR_6653701898,420,-2,4,-12,-7,-2,3,1,-2,5,3,-3,5,2,2,2,4,-2,3,1,0,-4,-9,-1,-1,2,1,0,-1,-1,1,-1,1,1,-1
KR_6756902666,420,-2,11,-11,-4,-6,7,1,5,1,6,-3,4,1,1,0,1,-1,2,1,1,4,-1,5,-6,1,0,0,-1,1,-1,-1,1,4,-1
KR_6756070247,420,-8,-129,-19,-21,-2,4,2,-3,6,3,-2,3,1,-9,11,2,-5,5,0,0,-19,85,-5,-2,7,0,0,-1,-1,1,-1,1,2,-1
KR_6760577043,420,1,93,-4,-2,1,1,2,-2,4,2,1,1,2,-2,4,2,0,1,1,0,-6,-253,5,-8,3,3,0,0,-1,0,0,1,2,-1
KR_6648227106,420,-2,31,7,-6,-1,1,0,-3,6,3,-1,2,1,-2,4,2,1,0,1,0,-4,14,1,-8,7,-4,0,-1,-1,-1,-1,1,1,-1
KR_6715782809,440,-7,-82,-25,-22,-3,5,2,-8,9,1,-2,2,0,-4,5,1,-5,6,1,-1,-15,-19,6,-9,3,-3,0,-1,1,0,-1,-1,4,-1
KR_6756211584,420,-4,-71,-29,-3,8,0,8,-6,6,0,1,3,4,-4,4,0,-2,2,0,0,-10,-30,-2,-1,3,1,0,-2,-1,0,-1,-1,2,-1
KR_6649843643,440,2,6,-16,6,-4,5,1,1,0,1,4,3,7,4,4,8,1,1,2,1,9,-7,-3,0,3,-1,0,-1,0,-1,1,1,0,-1
KR_6713601502,420,-2,16,-52,-1,-2,3,1,2,2,4,3,0,3,-2,7,5,-2,2,0,0,-5,3,1,-6,5,0,0,1,-1,1,1,-1,2,-1
KR_6722713122,440,-3,-74,-3,-1,0,2,2,1,2,3,0,4,4,-4,6,2,2,1,3,0,-1,-48,-1,-2,3,24,0,-3,1,-1,-1,-1,5,-1
KR_6609969494,420,1,-32,-4,4,3,1,4,0,3,3,1,1,2,1,1,2,-1,2,1,0,1,10,3,-7,4,-10,0,0,-1,1,1,1,2,-1
KR_6762508820,440,0,30,8,-7,-5,6,1,0,4,4,-3,6,3,1,1,2,0,1,1,0,-7,14,0,-3,3,-1,0,0,0,0,0,-1,0,-1
KR_6751917201,420,1,-2,36,0,3,1,4,-4,4,0,1,1,2,2,5,7,-2,2,0,1,-3,5,0,0,0,0,0,0,1,1,0,1,3,-1
KR_6760502747,440,0,-60,-4,-1,0,3,3,0,5,5,1,2,3,-5,5,0,3,0,3,-1,-5,46,4,-7,3,-5,0,0,-1,-1,0,-1,3,-1
KR_6642526717,420,0,-40,32,2,2,1,3,2,0,2,-4,4,0,-1,2,1,3,1,4,0,2,8,0,-3,3,0,0,-1,1,-1,-1,1,2,-1
KR_6706729796,420,-1,11,-16,-2,2,0,2,0,4,4,-2,3,1,-1,1,0,-1,1,0,0,-3,2,2,-2,0,0,0,0,-1,1,0,-1,5,-1
KR_6680329891,420,-7,-74,-75,-8,-3,3,0,-4,5,1,0,3,3,2,4,6,-3,5,2,0,-9,48,3,-5,2,-28,0,-1,-1,0,-1,1,6,-1
KR_6663078198,420,-1,-76,16,-7,-1,3,2,0,2,2,0,2,2,-8,9,1,2,0,2,0,-7,14,3,-6,3,-2,0,-1,-1,-1,-1,-1,6,-1
KR_6700636934,420,-3,-61,-34,-7,-10,10,0,0,1,1,1,1,2,4,3,7,-2,2,0,0,4,19,-2,-2,4,0,0,-1,1,0,-1,-1,4,-1
KR_6326043921,420,0,-58,2,-1,2,1,3,0,3,3,0,1,1,1,1,2,-4,6,2,0,-4,35,-2,-2,4,-9,0,-1,-1,-1,-1,-1,3,-1
KR_6637272896,420,-2,12,-16,-1,-1,3,2,6,0,6,-2,4,2,-3,3,0,-1,1,0,1,12,-1,1,-7,6,-3,0,1,-1,1,1,1,5,-1
KR_6643483316,420,1,-74,28,-1,0,0,0,-3,6,3,-1,4,3,2,0,2,1,1,2,0,-5,21,-3,-2,5,0,0,-1,-1,1,-1,-1,2,-1
KR_6761965242,420,-1,13,-33,2,-1,1,0,5,3,8,1,5,6,-2,4,2,-1,1,0,0,7,209,1,-4,3,-1,0,1,1,1,1,1,5,-1
KR_6363691478,420,-2,-9,-16,-6,1,0,1,-5,6,1,-1,3,2,-3,6,3,2,0,2,0,-3,0,0,0,0,-6,0,0,-1,-1,0,-1,2,-1
KR_6760156152,420,1,71,4,7,4,1,5,0,3,3,1,1,2,7,1,8,-5,5,0,0,12,2,-1,-3,4,3,0,1,1,-1,1,-1,3,-1
KR_6634663404,440,-1,-12,-48,0,-1,2,1,0,1,1,1,2,3,2,0,2,-2,5,3,0,-1,-109,2,-3,1,5,0,0,-1,-1,-1,1,6,-1
KR_6685418922,420,-3,-22,-7,-2,1,1,2,-2,4,2,-3,3,0,2,1,3,0,1,1,0,-4,13,2,-6,4,2,0,0,1,1,1,1,5,-1
KR_6716705967,420,-7,-58,-60,-3,-5,5,0,-3,4,1,4,1,5,-2,4,2,3,0,3,1,5,102,3,-6,3,0,0,0,-1,-1,-1,1,3,-1
KR_6625642112,440,0,-33,-26,1,0,2,2,-4,7,3,2,2,4,1,2,3,2,1,3,1,6,-2,0,-6,6,2,0,0,-1,1,0,1,4,-1
KR_6756084893,420,-1,-44,-12,1,-1,2,1,-1,2,1,4,0,4,-5,8,3,4,0,4,-1,4,-300,-2,-2,4,1,0,0,-1,1,0,-1,1,-1
KR_6761538736,420,-5,-62,-12,0,0,1,1,-1,2,1,-1,4,3,2,0,2,0,1,1,0,-1,-16,4,-5,1,-1,0,0,1,-1,0,-1,4,-1
KR_6721828581,420,0,59,-4,-3,1,1,2,-1,3,2,-2,3,1,1,0,1,-2,3,1,1,-4,317,0,-3,3,0,0,0,1,0,0,1,6,-1
KR_6723000025,420,2,-21,-30,4,5,1,6,2,2,4,-1,6,5,-2,6,4,0,2,2,0,2,-7,-2,-3,5,6,0,-1,0,0,-1,1,0,-1
KR_6505072171,440,-2,-83,-5,-6,2,1,3,6,3,9,-8,8,0,-4,4,0,-2,3,1,0,-10,11,-1,0,1,-1,0,0,-1,1,-1,-1,6,-1
KR_6735083971,440,-1,-26,28,0,-5,6,1,5,2,7,1,2,3,1,3,4,-2,2,0,2,4,3,-1,-1,2,1,0,0,1,1,-1,1,6,-1
KR_6661666318,420,2,42,19,2,-3,4,1,5,0,5,4,2,6,-7,7,0,3,1,4,1,1,1,4,-6,2,-3,0,-1,1,-1,-1,1,1,-1
KR_6591364269,420,-4,-70,-32,-2,-2,3,1,0,0,0,-3,5,2,1,1,2,2,0,2,0,0,-47,-2,-3,5,21,0,0,0,0,-1,1,0,-1
KR_6671882780,420,-4,-40,0,-12,1,2,3,-11,11,0,-3,3,0,1,3,4,0,0,0,0,-9,157,-3,-2,5,-1,0,0,1,1,0,-1,1,-1
KR_6632827735,420,-5,-59,-35,1,-1,2,1,5,1,6,2,2,4,-3,4,1,-2,2,0,0,1,-156,3,-5,2,0,0,1,1,1,1,1,2,-1
KR_6723169200,420,1,26,-20,8,4,1,5,-2,6,4,-3,5,2,8,4,12,1,0,1,0,3,-114,-3,-2,5,2,0,2,1,1,1,1,3,-1
KR_6754863930,420,3,-10,-12,9,2,0,2,1,1,2,0,4,4,5,2,7,1,0,1,-1,4,8,-1,-2,3,2,0,-1,1,-1,-1,-1,4,-1
KR_6761525368,420,2,-22,19,7,4,1,5,2,1,3,-5,7,2,7,1,8,-1,2,1,1,11,32,1,-4,3,-3,0,0,1,-1,1,1,6,-1
KR_6762782737,420,-4,-63,-16,-13,-1,1,0,-2,2,0,-11,15,4,1,3,4,0,3,3,0,-4,1,2,-3,1,0,0,-1,1,0,-1,-1,2,-1
KR_6665718856,420,-6,-35,11,-8,1,1,2,-4,5,1,-7,7,0,1,2,3,1,1,2,0,-5,6,1,-3,2,-2,0,-2,1,-1,-1,1,4,-1
KR_6681692275,420,-6,-44,-33,-5,-5,6,1,5,1,6,-1,2,1,-2,3,1,-2,2,0,0,-2,5,-2,-5,7,-5,0,-1,-1,-1,-1,-1,4,-1
KR_6751431126,420,-3,-62,-28,-3,1,0,1,-4,7,3,0,0,0,0,2,2,0,2,2,0,-3,-146,2,-5,3,0,0,-1,0,-1,-1,-1,0,-1
KR_6701985018,420,1,-8,52,5,1,1,2,-3,4,1,-1,4,3,7,1,8,1,1,2,1,5,14,-3,-3,6,3,0,0,1,1,0,1,6,-1
KR_6740241296,420,-1,-22,20,-1,-3,5,2,1,0,1,-3,3,0,3,1,4,1,1,2,0,5,-2,3,-3,0,-1,0,0,-1,1,0,1,6,-1
KR_6752953980,420,0,-14,-4,-4,0,1,1,0,3,3,-1,2,1,-2,2,0,-1,2,1,0,-3,2,-1,-2,3,0,0,0,-1,-1,0,-1,6,-1
KR_6617539326,440,0,58,19,2,0,0,0,1,2,3,0,3,3,4,0,4,-3,3,0,0,0,-14,0,-3,3,-2,0,0,1,-1,-1,-1,3,-1
KR_6749031779,440,-4,-55,-1,-12,-2,2,0,-1,4,3,-3,6,3,-2,3,1,-4,4,0,-2,-14,-22,-5,-3,8,4,0,-4,-1,-1,-1,-1,1,-1
KR_6700240278,420,0,63,-8,1,1,1,2,-2,5,3,-1,2,1,1,4,5,2,0,2,0,2,-1,0,-4,4,5,0,0,1,-1,0,1,6,-1
KR_6579684627,440,-1,-114,-11,-4,-4,4,0,2,1,3,4,0,4,-4,5,1,-2,4,2,0,-3,29,4,-4,0,-4,0,-3,1,1,-1,-1,2,-1
KR_6762480418,420,-1,-3,4,-5,0,0,0,-3,6,3,-1,2,1,-1,2,1,0,0,0,0,-5,7,-1,-2,3,3,0,0,0,0,1,1,0,-1
KR_6697916994,420,-7,-46,28,-10,-5,6,1,1,0,1,-7,7,0,1,0,1,0,0,0,-1,-7,-9,-4,-1,5,2,0,-2,1,-1,-1,-1,4,-1
KR_6759233963,440,-3,-6,12,-1,-5,5,0,7,1,8,0,2,2,-3,8,5,0,1,1,-1,5,-231,2,-3,1,-1,0,1,0,0,1,-1,0,-1
KR_6721038528,440,-1,32,-25,-5,-1,1,0,3,1,4,0,0,0,-5,6,1,-2,3,1,1,-3,-4,1,-3,2,-4,0,0,-1,0,-1,1,6,-1
KR_6633705474,420,0,-81,12,-9,3,0,3,2,0,2,-1,2,1,-11,12,1,-2,2,0,-1,-7,3,3,-3,0,-1,0,0,-1,1,-1,-1,6,-1
KR_6764226850,420,1,-64,8,2,4,1,5,2,0,2,-2,4,2,-3,3,0,1,0,1,0,3,1,4,-6,2,-1,0,-1,1,0,-1,1,2,-1
KR_6757911915,420,6,7,38,4,2,1,3,1,3,4,1,4,5,0,2,2,0,0,0,0,-4,-5,1,-3,2,-1,0,0,1,-1,1,-1,3,-1
KR_6737591245,420,-4,-95,-20,-6,-6,6,0,-1,5,4,-2,3,1,3,2,5,0,1,1,0,1,-47,-2,-1,3,17,-1,-4,1,-1,-1,-1,2,-1
KR_6600997638,420,-1,-84,32,-6,-6,6,0,0,2,2,0,2,2,-1,5,4,1,0,1,-2,-3,101,0,-5,5,3,0,-2,-1,-1,-1,-1,6,-1
KR_6656365887,420,0,-19,-32,-1,2,0,2,-2,3,1,2,1,3,0,2,2,-3,3,0,0,0,-12,0,-3,3,3,0,1,0,-1,1,-1,0,-1
KR_6739039250,420,-4,-67,-7,-14,-2,3,1,0,1,1,-7,8,1,-5,7,2,0,1,1,0,-15,-6,-3,-1,4,0,0,-1,-1,-1,-1,-1,6,-1
KR_6756809339,420,-7,-81,-20,-13,4,0,4,-8,8,0,-5,6,1,-3,3,0,-1,1,0,0,-12,-9,-3,-3,6,0,0,0,0,0,0,1,0,-1
KR_6702025396,420,2,30,5,-1,1,2,3,2,1,3,-3,6,3,1,3,4,-2,3,1,0,0,3,4,-4,0,1,0,-1,-1,0,-1,1,6,-1
KR_6203182962,420,1,-10,32,8,-6,7,1,2,3,5,9,0,9,3,1,4,0,1,1,0,0,9,4,-5,1,-3,0,2,0,1,1,1,0,-1
KR_6633685785,420,0,-4,1,5,1,0,1,4,1,5,-2,3,1,2,3,5,0,1,1,-1,6,-129,-1,-3,4,1,0,0,-1,1,0,-1,5,-1
KR_6724281572,420,0,44,-4,5,3,2,5,-3,5,2,3,1,4,4,1,5,-2,3,1,0,-1,9,7,-7,0,-3,0,1,-1,1,1,1,3,-1
KR_6718845117,420,-5,-76,-8,-9,-1,1,0,-1,1,0,-8,9,1,0,4,4,1,1,2,0,-7,331,-1,-2,3,-28,0,-1,-1,-1,-1,-1,4,-1
KR_6705594178,420,-8,-88,-24,-11,-4,4,0,0,1,1,-3,5,2,-2,2,0,-2,4,2,0,-8,-28,-4,-3,7,-2,0,-3,-1,-1,-1,-1,5,-1
KR_6760474993,420,0,-47,-28,7,-1,1,0,1,1,2,5,1,6,0,0,0,2,1,3,0,12,-1,1,-4,3,1,0,1,-1,-1,1,1,4,-1
KR_6633651559,420,-1,61,4,-1,-1,2,1,-3,5,2,0,2,2,2,2,4,1,0,1,1,-1,-65,-3,-1,4,4,0,0,0,-1,0,1,0,-1
KR_6646865333,420,0,16,-18,1,6,2,8,0,3,3,0,2,2,-5,6,1,0,2,2,2,-6,11,1,-2,1,-2,0,2,1,1,1,1,4,-1
KR_6723618163,420,-6,22,1,-19,-2,3,1,-7,8,1,-8,10,2,-1,3,2,-1,2,1,0,-19,357,1,-2,1,-4,0,-1,-1,-1,-1,1,5,-1
KR_6714204866,420,-2,1,-17,-3,-1,4,3,0,4,4,-3,6,3,-1,1,0,2,1,3,0,-2,96,0,-3,3,0,0,0,-1,1,0,-1,3,-1
KR_6700406678,420,0,-40,-8,0,1,1,2,-1,3,2,2,2,4,0,4,4,-2,4,2,0,3,-5,0,-4,4,1,0,0,0,0,0,1,0,-1
KR_6684048886,440,-1,18,-20,-5,1,1,2,0,1,1,-8,8,0,1,0,1,1,0,1,0,-2,-7,-3,-1,4,1,0,0,1,-1,1,1,2,-1
KR_6693305836,420,-1,-41,25,2,3,1,4,2,2,4,-4,7,3,1,6,7,0,3,3,0,-2,-10,0,-2,2,2,0,-1,-1,1,1,-1,6,-1
KR_6375021758,420,-5,101,8,-9,-3,3,0,-2,5,3,-2,3,1,0,1,1,-2,3,1,0,-10,0,0,0,0,4,0,0,1,-1,0,1,3,-1
KR_6665330511,420,0,-114,-24,3,3,1,4,2,2,4,-2,3,1,-4,4,0,4,0,4,1,7,-3,3,-6,3,-3,0,0,-1,0,-1,1,2,-1
KR_6763299636,420,-3,-37,-6,-3,-3,4,1,0,1,1,-1,4,3,3,3,6,-2,3,1,0,1,15,0,-6,6,-3,0,0,-1,-1,-1,-1,3,-1
KR_6722912491,440,-3,-76,0,-8,-1,1,0,1,0,1,-5,7,2,-3,4,1,0,0,0,0,-3,-3,2,-2,0,-3,0,-2,-1,-1,-1,-1,4,-1
KR_6760748825,440,-5,-17,5,-9,-3,5,2,3,1,4,-7,9,2,-2,4,2,0,0,0,0,0,-5,-2,-1,3,-4,0,-2,-1,-1,-1,-1,2,-1
KR_6764376950,420,3,25,-20,1,1,1,2,1,1,2,-3,3,0,1,2,3,1,0,1,0,-5,-5,1,-5,4,-3,0,0,-1,0,0,-1,2,-1
KR_6722833344,440,-1,8,31,-9,0,2,2,-1,4,3,1,1,2,-5,8,3,-4,4,0,0,-16,-23,2,-2,0,-1,0,-1,1,1,1,-1,3,-1
KR_6730931722,420,-4,-72,-13,-2,1,3,4,0,0,0,2,3,5,-3,6,3,-2,3,1,-1,7,-18,3,-4,1,-2,0,-2,-1,1,-1,-1,6,-1
KR_6762833486,420,-1,26,-29,0,0,1,1,-1,2,1,2,2,4,1,1,2,-2,3,1,0,-1,10,-1,-2,3,0,0,0,1,1,0,1,6,-1
KR_6666889806,420,-6,-22,2,-9,-1,2,1,-3,3,0,-1,1,0,-2,2,0,-2,3,1,0,-5,-9,-3,-3,6,-1,0,-1,-1,1,-1,-1,3,-1
KR_6657137078,440,2,120,-8,3,1,0,1,2,1,3,3,1,4,-1,1,0,-2,3,1,0,3,-6,-2,-4,6,-2,0,-1,-1,-1,-1,1,2,-1
KR_6731193253,420,1,26,-31,11,1,2,3,1,1,2,6,0,6,3,1,4,0,3,3,0,8,3,0,-1,1,1,0,0,-1,1,0,1,6,-1
KR_6636696575,420,-2,-62,-36,-1,0,3,3,-3,7,4,0,4,4,2,1,3,0,1,1,-1,3,-7,-1,-3,4,0,0,-1,1,-1,-1,-1,4,-1
KR_6754775280,440,-1,-33,-21,-3,-2,5,3,1,1,2,1,2,3,-4,5,1,1,1,2,0,0,306,1,-7,6,4,0,0,-1,-1,-1,-1,1,-1
KR_6709821459,440,-1,-9,-12,-7,1,2,3,-3,3,0,-5,6,1,-1,2,1,1,1,2,0,-6,-8,-2,-2,4,2,0,0,0,0,0,1,0,-1
KR_6675941047,420,1,26,-8,-7,2,2,4,-4,7,3,-3,5,2,-1,2,1,-1,2,1,0,-9,4,0,-4,4,1,0,2,1,1,1,1,1,-1
KR_6733529532,420,-2,-170,38,-4,-1,1,0,-3,4,1,-2,4,2,1,0,1,1,0,1,0,0,3,1,-4,3,-6,0,-2,1,1,-1,-1,6,-1
KR_6544052223,420,-4,1,-23,-11,1,3,4,-5,5,0,1,1,2,-4,4,0,-4,6,2,0,-14,-5,0,-2,2,-2,0,-2,-1,-1,-1,-1,3,-1
KR_6760342855,420,-1,-15,0,1,4,1,5,0,2,2,-1,2,1,-2,5,3,0,2,2,0,0,-44,1,-3,2,23,0,-1,1,1,-1,-1,4,-1
KR_6764311199,420,-5,-42,-13,-10,1,0,1,-10,10,0,-1,2,1,-1,2,1,1,1,2,0,-12,-133,-2,-2,4,-4,0,-1,-1,-1,-1,1,5,-1
KR_6760187337,440,4,10,16,0,1,0,1,2,1,3,-2,2,0,-1,1,0,0,1,1,0,-3,-4,-2,-3,5,0,0,-1,-1,1,-1,1,1,-1
KR_6694689764,420,2,42,5,6,0,1,1,3,0,3,-2,4,2,5,0,5,0,1,1,0,5,15,1,-2,1,1,0,-1,-1,-1,-1,-1,5,-1
KR_6730361713,440,-4,-62,-16,-18,-5,6,1,-3,6,3,-1,1,0,-8,10,2,-1,2,1,0,-12,-7,-1,-1,2,2,0,-4,1,0,-1,-1,3,-1
KR_6755551896,420,-2,-63,-8,-4,1,1,2,1,1,2,-2,2,0,-3,5,2,-1,3,2,0,-4,262,-2,-1,3,3,0,-2,0,-1,-1,1,0,-1
KR_6699924083,420,2,69,12,7,7,1,8,1,3,4,1,0,1,-3,5,2,1,0,1,1,1,2,2,-6,4,2,0,3,-1,1,1,1,2,-1
KR_6730141893,420,-4,-63,8,-7,-1,4,3,-2,2,0,-2,3,1,-1,1,0,-1,1,0,-1,-6,-4,-3,-1,4,-4,0,0,1,1,0,-1,4,-1
KR_6730320400,420,-1,18,-16,-4,1,2,3,3,0,3,-3,5,2,-5,7,2,0,0,0,0,-4,7,5,-9,4,0,0,0,-1,1,-1,-1,6,-1
KR_6603654774,440,-5,-55,-36,-8,2,2,4,-4,5,1,-2,4,2,-4,5,1,0,1,1,0,-8,2,-4,-2,6,-4,0,0,1,-1,-1,1,2,-1
KR_6639695101,420,0,63,-4,-5,0,2,2,-5,5,0,-2,3,1,0,5,5,2,0,2,0,-1,-24,-1,-4,5,-1,0,0,1,-1,0,-1,2,-1
KR_6632178673,420,0,-16,8,-7,-3,3,0,-1,3,2,-1,2,1,0,1,1,-2,3,1,-1,-6,-13,-7,-2,9,1,0,0,-1,-1,-1,-1,2,-1
KR_6763411054,440,-2,-50,-18,-10,-2,2,0,0,1,1,0,4,4,-6,7,1,-2,3,1,0,-7,-2,1,-5,4,1,0,0,-1,0,0,-1,4,-1
KR_6708605935,420,-4,-68,-16,-12,-7,7,0,-6,6,0,2,1,3,0,0,0,-1,1,0,0,-5,9,-2,-4,6,-2,0,0,-1,-1,-1,-1,5,-1
KR_6747840801,420,-3,-60,20,2,-2,3,1,-1,3,2,6,1,7,-3,3,0,2,0,2,1,2,-5,-4,-1,5,-6,0,1,-1,1,1,1,1,-1
KR_6761703881,440,-2,7,-8,0,0,1,1,2,2,4,-3,3,0,0,3,3,1,0,1,0,3,-9,5,-6,1,-4,0,0,0,-1,0,1,0,-1
KR_6604030315,420,0,-16,5,-3,-5,5,0,-3,4,1,-4,4,0,4,2,6,5,0,5,0,1,13,3,-3,0,-1,0,-1,1,-1,-1,-1,3,-1
KR_6741512379,420,-5,-50,-52,-10,-4,4,0,2,1,3,3,2,5,-7,7,0,-4,4,0,0,-7,-84,3,-5,2,-5,0,-1,-1,-1,-1,-1,2,-1
KR_6669646837,420,-6,-72,8,-13,0,3,3,-1,1,0,-14,14,0,2,2,4,0,0,0,0,-5,-44,0,-3,3,19,0,-3,1,-1,-1,-1,3,-1
KR_6712113838,420,-1,21,-30,-4,-4,4,0,2,0,2,-3,5,2,1,1,2,0,0,0,0,-2,7,4,-6,2,-4,0,0,-1,1,0,1,6,-1
KR_6379965688,420,-6,-2,8,-16,1,1,2,-6,9,3,-6,6,0,-5,8,3,0,1,1,0,-22,9,-2,-4,6,0,0,0,-1,1,0,-1,1,-1
KR_6457224029,440,-3,-22,-11,0,4,1,5,2,2,4,-3,3,0,-2,4,2,-1,2,1,2,-1,193,3,-4,1,-6,0,0,1,1,0,1,6,-1
KR_6739116682,420,-6,-82,-30,-4,-2,3,1,1,2,3,1,1,2,-4,7,3,0,0,0,0,-5,0,-2,-1,3,-3,0,0,-1,1,-1,1,2,-1
KR_6751445683,420,-2,31,8,-6,4,0,4,-3,5,2,0,0,0,-6,6,0,-1,1,0,-1,-13,-9,-1,-2,3,-2,0,0,1,0,0,-1,1,-1
KR_6634696494,420,-4,-55,-24,-11,-2,4,2,-5,5,0,-2,2,0,-2,2,0,0,0,0,0,-11,2,1,-3,2,-5,0,-1,-1,1,-1,1,4,-1
KR_6759855876,420,-2,-69,-16,0,-2,2,0,2,1,3,-1,3,2,0,2,2,1,2,3,0,6,-1,4,-5,1,0,0,0,-1,1,1,-1,2,-1
KR_6692040118,420,0,-27,14,-4,3,1,4,-6,8,2,0,0,0,-2,4,2,1,2,3,0,-5,-382,0,-1,1,-2,0,1,-1,1,-1,-1,6,-1
KR_6689329850,420,-2,-55,0,1,-1,2,1,0,4,4,-3,3,0,4,0,4,1,0,1,-1,1,-10,-1,-6,7,-4,0,-2,-1,-1,-1,-1,6,-1
KR_6739068124,420,-4,-34,-35,-10,-1,2,1,-1,6,5,-3,4,1,-3,4,1,-2,2,0,0,-5,21,-2,-1,3,-14,0,0,1,-1,-1,-1,1,-1
KR_6762495209,420,-1,-60,20,5,3,0,3,0,3,3,4,0,4,-2,3,1,0,2,2,0,-5,-15,1,-2,1,-3,0,-1,-1,1,-1,1,4,-1
KR_6635301416,420,-3,2,-20,-10,-2,3,1,-3,4,1,-3,5,2,-1,2,1,-1,1,0,0,-15,19,5,-5,0,-4,0,0,-1,1,0,-1,5,-1
KR_6660549694,420,1,71,20,2,-3,3,0,3,1,4,1,3,4,1,0,1,0,0,0,0,1,-10,-1,-4,5,2,0,0,1,-1,0,1,4,-1
KR_6725652188,440,0,21,0,-1,-3,3,0,6,3,9,-4,7,3,-4,4,0,4,1,5,1,0,3,2,-5,3,5,0,0,1,1,0,1,4,-1
KR_6715927531,420,0,-58,-16,-7,-1,3,2,-3,3,0,-3,5,2,0,2,2,0,1,1,-3,-3,8,-2,-3,5,-2,0,1,-1,1,1,-1,4,-1
KR_6763076600,420,-3,-70,11,-5,-1,1,0,0,1,1,-3,4,1,-1,1,0,0,1,1,-1,-4,-19,-5,0,5,5,0,-3,-1,1,-1,-1,3,-1
KR_6760306017,420,-1,33,4,-5,-2,2,0,-1,2,1,-1,2,1,-1,5,4,0,2,2,-1,-4,4,-2,-3,5,-3,0,0,-1,0,0,1,1,-1
KR_6692667483,420,0,17,-2,6,4,0,4,-2,3,1,0,2,2,3,2,5,1,0,1,0,6,3,1,-4,3,5,0,0,0,1,0,1,0,-1
KR_6754153921,420,2,-11,-5,3,1,1,2,-1,3,2,2,0,2,0,2,2,1,0,1,0,0,30,0,-1,1,-31,0,2,1,1,1,-1,1,-1
KR_6671544589,440,-4,-77,-20,-11,-3,4,1,-5,7,2,-2,3,1,-2,5,3,1,2,3,-1,-10,-6,-5,-6,11,2,0,-2,-1,-1,-1,1,6,-1
KR_6627771945,420,-4,-2,-15,-7,-1,2,1,-1,3,2,-5,6,1,0,2,2,0,0,0,-1,-2,-3,0,-4,4,-3,0,-2,-1,1,-1,-1,2,-1
KR_6643944641,420,-1,-83,8,-1,-3,3,0,1,4,5,3,3,6,-3,4,1,1,2,3,0,4,-2,-2,-2,4,-2,0,0,1,0,0,1,2,-1
KR_6758159961,420,0,38,-24,2,-2,2,0,3,0,3,7,0,7,-6,10,4,0,1,1,0,4,3,-1,-2,3,-2,0,0,0,-1,-1,-1,0,-1
KR_6762454981,420,-2,-5,-32,-7,-2,2,0,1,1,2,-2,4,2,-5,5,0,1,1,2,-1,-7,12,-3,-1,4,1,0,-1,-1,-1,-1,-1,2,-1
KR_6711263399,420,-4,-68,-16,-9,2,1,3,-4,7,3,-2,4,2,-4,4,0,-1,1,0,0,-14,-200,-3,-4,7,1,0,-1,1,-1,-1,-1,5,-1
KR_6729243511,420,-4,-74,-8,-14,0,3,3,1,1,2,-6,6,0,-8,8,0,-1,1,0,0,-13,-2,-2,-1,3,-3,0,-2,-1,-1,-1,-1,4,-1
KR_6736567420,420,0,20,-22,-2,-1,3,2,-5,6,1,4,0,4,-1,3,2,1,0,1,-1,-1,-5,0,-4,4,2,0,-1,1,-1,-1,-1,3,-1
KR_6741481171,420,-2,18,-36,-9,2,1,3,-8,10,2,-4,6,2,1,5,6,0,2,2,-2,-2,-1,1,-2,1,3,0,-2,-1,-1,-1,-1,2,-1
KR_6749998532,420,-3,-9,-32,1,4,1,5,-3,6,3,1,2,3,-5,11,6,4,0,4,-1,-1,3,6,-7,1,-2,0,-2,-1,1,1,-1,3,-1
KR_6757927063,420,1,18,12,1,1,1,2,-1,1,0,2,3,5,0,2,2,-1,1,0,1,3,-2,-4,-1,5,-2,0,-1,0,0,-1,1,0,-1
KR_6642692485,420,1,-44,-34,2,2,0,2,1,1,2,3,2,5,-4,5,1,0,3,3,-1,5,0,4,-4,0,-4,0,-1,-1,1,1,-1,6,-1
KR_6642306434,420,0,-21,-16,1,-2,2,0,0,5,5,-4,4,0,4,0,4,3,0,3,0,9,32,-2,-1,3,-29,0,0,-1,-1,-1,-1,3,-1
KR_6693377171,420,-8,-48,-30,-19,0,4,4,-5,5,0,-5,5,0,-5,7,2,-4,4,0,-2,-22,-2,5,-7,2,-3,0,0,-1,1,-1,-1,3,-1
KR_6743827333,420,-3,-11,-6,-12,-4,7,3,-8,8,0,0,2,2,1,3,4,-1,1,0,0,-16,-3,-4,-2,6,3,0,-2,-1,-1,-1,1,5,-1
KR_6764554993,420,-4,-50,-13,-10,-4,6,2,-2,2,0,4,1,5,-6,8,2,-2,4,2,-1,-12,3,-2,-1,3,1,0,-1,-1,-1,-1,-1,3,-1
KR_6751912438,420,0,12,36,-4,-2,2,0,1,0,1,-1,4,3,-2,5,3,0,1,1,0,-1,114,-2,-3,5,5,0,0,0,1,0,1,0,-1
KR_6762617771,420,3,57,8,3,4,2,6,2,0,2,-2,3,1,-2,4,2,1,1,2,0,1,1,0,-4,4,-4,0,0,1,-1,0,-1,6,-1
KR_6660011926,420,-2,1,-43,-1,1,2,3,-3,3,0,2,1,3,2,0,2,-3,3,0,0,-3,8,4,-4,0,0,0,0,1,-1,0,1,5,-1
KR_6717957739,420,-1,-78,-24,-2,-1,2,1,0,2,2,-2,3,1,2,1,3,-1,1,0,0,3,0,1,-3,2,0,0,0,-1,-1,0,-1,4,-1
KR_6731723297,420,-1,-21,20,-3,-3,5,2,0,2,2,-2,4,2,1,2,3,1,0,1,0,-1,420,1,-4,3,-2,0,-1,1,-1,-1,1,5,-1
KR_6657005419,420,1,-26,45,4,-3,3,0,7,0,7,-1,2,1,3,0,3,-2,2,0,0,3,41,3,-8,5,-15,0,0,0,0,0,-1,0,-1
KR_6689002507,420,-4,-56,-20,-14,0,2,2,0,2,2,-8,10,2,-4,5,1,-2,2,0,0,-16,-177,2,-3,1,-4,0,-3,1,1,-1,-1,6,-1
KR_6698907695,420,1,-48,21,0,-1,3,2,1,2,3,-2,3,1,2,3,5,0,1,1,-1,-1,-6,-3,-2,5,0,0,-1,1,1,-1,-1,6,-1
KR_6634419742,420,1,56,-24,2,3,1,4,1,2,3,2,1,3,-3,6,3,-1,1,0,1,6,2,3,-7,4,0,0,0,-1,-1,0,1,3,-1
KR_6287515033,420,0,-15,0,-5,0,1,1,1,2,3,-4,5,1,0,1,1,-2,3,1,0,-3,-111,3,-4,1,-3,0,0,-1,0,0,1,2,-1
KR_6719949296,440,-4,-70,-21,-13,-2,3,1,-1,2,1,4,1,5,-7,7,0,-7,8,1,0,-9,-11,-1,-1,2,1,0,-2,1,-1,-1,-1,2,-1
KR_6647961791,420,-1,56,27,-1,2,1,3,-5,5,0,1,0,1,0,2,2,1,0,1,1,-4,4,-3,-1,4,1,0,1,-1,1,1,1,3,-1
KR_6760443561,420,-3,-27,8,-4,2,2,4,-1,3,2,-3,3,0,-4,6,2,2,0,2,0,-7,-16,-5,-2,7,-1,0,0,0,1,-1,1,0,-1
KR_6728213467,420,-6,-42,-16,-5,-6,6,0,0,1,1,0,2,2,0,3,3,1,0,1,0,-1,-10,1,-4,3,3,0,1,1,1,1,-1,5,-1
KR_6764345857,440,-1,-25,-16,-2,1,2,3,0,0,0,0,1,1,-3,3,0,0,2,2,0,-5,-5,-1,-4,5,0,0,-1,1,-1,-1,-1,2,-1
KR_6731179608,420,-1,-77,-12,3,-2,2,0,2,0,2,4,1,5,-2,2,0,1,0,1,0,1,-6,-1,-2,3,0,0,0,1,0,0,-1,4,-1
KR_6719081627,440,3,-78,20,-1,0,0,0,4,1,5,-4,5,1,0,0,0,-1,1,0,0,6,6,-3,-2,5,3,0,-1,-1,-1,-1,-1,2,-1
KR_6740817987,420,-4,26,26,-5,1,0,1,-6,6,0,-1,3,2,2,1,3,-1,1,0,0,-9,224,1,-9,8,-9,0,0,-1,-1,0,1,5,-1
KR_6623444807,420,-3,-5,-4,-5,-2,2,0,-3,5,2,3,0,3,-2,2,0,-1,2,1,0,-12,35,0,-4,4,-22,0,1,-1,-1,1,1,6,-1
KR_6760609131,420,-3,-6,-16,-6,-1,3,2,-6,8,2,6,0,6,0,5,5,-5,6,1,0,-8,-206,2,-4,2,-1,0,0,0,-1,0,-1,0,-1
KR_6751440264,420,2,72,-19,0,2,2,4,-3,3,0,2,1,3,0,1,1,-1,1,0,0,-4,-149,4,-6,2,-1,0,1,1,0,1,-1,2,-1
KR_6685095657,440,0,-24,-16,-4,-3,5,2,-1,8,7,-1,2,1,1,2,3,0,1,1,0,1,-2,-3,0,3,-2,0,-1,-1,-1,-1,-1,6,-1
KR_6732258983,420,-3,-58,-10,-8,0,3,3,-4,5,1,-1,2,1,-1,2,1,-2,2,0,0,-3,-2,1,-5,4,0,0,-3,-1,1,-1,-1,3,-1
KR_6763578436,420,-2,-52,8,-2,-3,3,0,3,1,4,-3,3,0,2,2,4,-1,2,1,0,2,30,2,-6,4,2,0,-1,1,-1,-1,1,5,-1
KR_6757994547,420,-2,-32,-40,1,2,0,2,1,2,3,-4,6,2,1,2,3,1,0,1,0,-1,15,3,-8,5,-10,0,0,-1,1,0,1,6,-1
KR_6744451592,420,-4,-95,-3,-10,6,0,6,-10,10,0,-1,4,3,-2,2,0,-3,3,0,-2,-18,-31,2,-5,3,-5,0,1,1,1,1,-1,1,-1
KR_6760807891,440,-3,-39,-28,-4,3,0,3,-1,3,2,-4,5,1,3,3,6,-5,7,2,0,-2,-10,-4,-1,5,1,0,0,-1,-1,-1,1,6,-1
KR_6762955409,420,1,-35,92,-2,-3,4,1,2,2,4,-6,6,0,-3,4,1,8,0,8,-1,4,46,1,-2,1,-24,0,0,0,0,0,-1,0,-1
KR_6463168542,420,-4,-34,3,-15,-2,2,0,-6,8,2,-3,3,0,-5,6,1,1,3,4,1,-4,-45,-1,-2,3,-4,0,-1,-1,1,-1,1,1,-1
KR_6673827055,420,-3,-26,-5,-11,-2,4,2,-3,3,0,-1,1,0,-4,6,2,-1,2,1,0,-16,-45,-3,-3,6,24,0,-1,-1,1,-1,1,2,-1
KR_6709055675,420,-3,4,0,-7,-2,2,0,6,2,8,-4,4,0,-5,6,1,-2,2,0,0,-2,228,5,-7,2,-3,0,-1,1,0,-1,-1,6,-1
KR_6749364977,420,-2,-103,-30,-9,-3,4,1,1,0,1,-4,5,1,0,4,4,-3,3,0,0,-7,0,-2,-2,4,-3,0,-2,1,-1,-1,-1,3,-1
KR_6730005723,420,-4,-51,-3,-13,-8,8,0,-1,2,1,0,3,3,-3,4,1,-1,2,1,-1,-6,2,0,-2,2,1,0,-1,-1,-1,-1,-1,1,-1
KR_6747125120,420,1,11,33,-3,0,1,1,-1,3,2,-5,5,0,-2,3,1,5,1,6,0,2,171,-1,-3,4,4,0,-1,-1,1,-1,-1,3,-1
KR_6712735337,440,0,36,-4,2,-2,5,3,1,4,5,3,2,5,0,2,2,0,2,2,0,8,6,4,-5,1,1,0,0,-1,1,0,1,2,-1
KR_6750430525,420,-5,16,-16,-5,-5,7,2,-1,3,2,4,3,7,0,2,2,-3,3,0,-1,0,1,-3,-2,5,0,0,0,-1,1,0,-1,6,-1
KR_6624437745,420,0,89,26,-4,2,5,7,-4,6,2,0,1,1,-1,1,0,-1,1,0,0,-7,-3,-1,-3,4,-3,0,0,-1,-1,1,1,6,-1
KR_6704061457,420,-5,-101,-26,-4,0,1,1,1,4,5,2,2,4,-3,4,1,-4,4,0,0,-1,134,1,-3,2,-3,0,-1,-1,1,-1,-1,6,-1
KR_6593728247,420,-1,-31,-16,-5,0,3,3,0,3,3,-2,4,2,0,1,1,-3,3,0,0,-7,6,1,-4,3,-1,0,0,0,-1,0,1,0,-1
KR_6726617538,440,-4,-106,-17,-13,-3,3,0,0,2,2,-1,3,2,-7,9,2,-2,2,0,-3,-9,0,2,-4,2,-2,0,-1,-1,-1,-1,-1,5,-1
KR_6693850313,420,-3,-40,-34,-6,0,2,2,-2,4,2,-1,3,2,-4,6,2,1,0,1,-1,-10,-6,1,-3,2,-1,0,2,0,-1,-1,-1,0,-1
KR_6695966629,420,-2,-30,15,-17,-2,2,0,-5,5,0,-4,4,0,-6,8,2,0,1,1,0,-21,5,-1,-2,3,-1,0,0,-1,-1,0,-1,5,-1
KR_6760818866,440,-2,10,-23,-7,3,1,4,-4,4,0,-4,7,3,-1,4,3,-1,2,1,0,-13,-36,0,-2,2,-4,0,-1,-1,1,-1,1,2,-1
KR_6693186105,420,-5,-87,-2,-13,-2,2,0,-2,7,5,-1,1,0,-3,5,2,-5,5,0,-2,-13,-9,-5,0,5,-3,0,-1,-1,-1,-1,-1,2,-1
KR_6077544216,420,1,-41,-1,-4,-1,3,2,-5,6,1,2,2,4,-2,4,2,2,1,3,0,-6,4,-1,-5,6,-3,0,0,1,-1,-1,-1,2,-1
KR_6686478756,420,-4,-51,-24,-7,-1,1,0,-3,5,2,-3,3,0,-1,3,2,1,1,2,0,-4,-2,-1,-3,4,-1,0,-1,-1,-1,-1,1,2,-1
KR_6685521035,420,0,54,-8,-1,2,0,2,0,1,1,1,2,3,-2,2,0,-2,3,1,0,-4,-8,-4,0,4,2,0,-1,-1,-1,1,-1,3,-1
KR_6754269490,420,-2,11,-44,0,0,2,2,6,0,6,-2,2,0,-4,6,2,0,1,1,0,4,-4,-1,-4,5,2,0,0,-1,1,0,-1,6,-1
KR_6712119632,420,-1,-54,-12,-2,-4,6,2,3,1,4,-2,2,0,1,4,5,0,1,1,0,6,-7,0,-1,1,-1,0,-1,-1,1,-1,-1,3,-1
KR_6661378849,420,0,-37,20,1,-5,5,0,4,0,4,2,0,2,0,3,3,0,1,1,-1,3,15,-3,-2,5,-4,0,-2,-1,-1,-1,-1,6,-1
KR_6702016222,420,2,-4,-21,4,0,3,3,4,1,5,-3,7,4,5,2,7,-2,2,0,0,6,9,2,-2,0,-1,0,1,1,0,1,1,5,-1
KR_6744781120,420,-2,-25,4,-5,-2,2,0,1,3,4,-3,4,1,0,2,2,-1,1,0,0,1,-3,2,-6,4,-4,0,0,0,0,0,-1,0,-1
KR_6753717442,420,-1,-35,16,-2,-2,2,0,-1,2,1,2,1,3,1,3,4,-2,2,0,0,0,7,0,-3,3,1,0,1,1,1,1,-1,4,-1
KR_6719027436,420,-2,-28,-44,-6,-1,3,2,-3,4,1,0,3,3,-2,3,1,0,0,0,0,-2,-4,0,-2,2,1,0,-1,-1,1,-1,-1,5,-1
KR_6732651347,420,-1,9,-36,-6,1,2,3,-5,5,0,1,0,1,-2,4,2,-1,2,1,0,-2,-145,4,-6,2,1,0,-1,1,-1,-1,-1,2,-1
KR_6760589905,420,-2,-26,-15,-6,3,2,5,0,3,3,-8,12,4,-3,5,2,2,0,2,0,-4,1,-2,-1,3,1,0,-1,-1,-1,-1,1,6,-1
KR_6756639265,440,1,26,0,5,2,0,2,4,0,4,-1,1,0,-1,1,0,1,0,1,0,5,-10,0,-7,7,-1,0,0,-1,-1,1,1,4,-1
KR_6764310529,420,-3,-54,-12,-9,-2,7,5,-2,3,1,-4,6,2,0,1,1,-1,1,0,1,3,-169,-3,0,3,-1,0,-1,1,0,-1,1,4,-1
KR_6621387567,420,4,-29,8,7,-5,5,0,-4,6,2,2,5,7,11,2,13,3,0,3,1,15,9,-2,-2,4,1,0,-1,-1,-1,-1,1,1,-1
KR_6739107235,420,1,75,-24,3,1,0,1,-2,3,1,2,0,2,3,0,3,-1,1,0,0,2,13,-4,-1,5,3,0,0,0,1,0,-1,0,-1
KR_6751506843,420,-3,-26,-8,-13,-2,2,0,-7,7,0,2,0,2,-2,5,3,-4,5,1,0,-9,-235,-1,-3,4,0,0,0,-1,1,-1,-1,4,-1
KR_6764250839,420,-1,-35,-24,-2,-4,4,0,-3,4,1,2,1,3,-2,2,0,5,0,5,0,4,-40,-3,-1,4,17,0,-2,-1,-1,-1,1,4,-1
KR_6749316096,420,-4,-28,-24,-10,-3,3,0,-9,9,0,0,1,1,2,0,2,0,0,0,0,-11,-6,3,-5,2,-2,0,0,-1,-1,0,-1,3,-1
KR_6630640782,420,-2,-73,-2,0,-3,4,1,4,3,7,-1,4,3,-2,3,1,2,0,2,0,9,2,7,-9,2,-2,0,0,1,1,1,-1,1,-1
KR_6746172466,440,2,-25,4,0,6,3,9,-3,4,1,-1,3,2,-1,3,2,-1,1,0,-1,-11,5,-2,-1,3,-5,0,0,-1,-1,0,-1,5,-1
KR_6690304144,420,1,-19,0,-1,-1,2,1,1,0,1,-2,3,1,2,4,6,-1,2,1,0,0,-7,-1,-5,6,-3,0,0,-1,1,1,-1,1,-1
KR_6749249939,420,-6,-228,15,-17,-8,8,0,-1,3,2,-2,2,0,-5,5,0,-1,2,1,0,-12,59,1,-2,1,-1,0,-1,-1,-1,-1,-1,2,-1
KR_6737948681,420,1,-4,60,-2,1,1,2,5,0,5,0,2,2,-9,9,0,1,0,1,0,-1,49,4,-8,4,-20,0,0,-1,1,1,1,3,-1
KR_6659603812,420,-3,-87,-4,-20,-4,5,1,0,4,4,-5,6,1,-7,7,0,-4,9,5,-6,-25,-20,-1,-2,3,0,0,-2,1,-1,-1,-1,6,-1
KR_6742824299,420,2,-25,20,1,-1,1,0,2,2,4,5,1,6,-4,6,2,-1,2,1,-2,-2,-4,-5,-1,6,-5,0,-2,-1,-1,-1,-1,5,-1
KR_6757338516,440,-3,-61,1,-1,1,1,2,-1,4,3,0,2,2,-2,3,1,1,1,2,0,-3,-8,-1,-2,3,-2,0,0,-1,1,1,-1,2,-1
KR_6731897364,420,-7,-83,-17,-15,0,1,1,-3,3,0,-3,5,2,-5,5,0,-4,4,0,0,-8,12,-1,0,1,1,0,-2,-1,0,-1,-1,5,-1
KR_6700151633,420,-6,-126,1,-11,-7,7,0,6,1,7,0,1,1,-9,12,3,-1,2,1,0,-7,-1,-2,-4,6,-1,0,-1,1,-1,-1,-1,5,-1
KR_6760950798,420,2,71,23,1,-2,3,1,-2,5,3,2,1,3,3,0,3,0,0,0,0,2,11,-1,-2,3,1,0,0,0,-1,0,-1,0,-1
KR_6751769727,420,0,-71,-35,-4,-5,5,0,-2,7,5,-1,3,2,-1,5,4,5,2,7,-1,1,110,0,-7,7,2,0,0,1,-1,-1,1,1,-1
KR_6727796556,420,1,27,20,4,2,1,3,1,0,1,3,1,4,-2,3,1,0,0,0,0,0,-2,3,-5,2,3,0,0,1,0,0,-1,1,-1
KR_6759503227,420,-2,30,-16,-14,2,0,2,-8,9,1,-1,7,6,-7,9,2,0,0,0,0,-12,-4,-1,-3,4,-1,0,-1,1,0,1,-1,6,-1
KR_6731255187,420,0,20,32,-5,-1,2,1,2,1,3,1,0,1,-1,3,2,-6,7,1,0,-1,52,2,-4,2,-31,0,0,-1,1,1,1,3,-1
KR_6740608361,440,-1,-71,4,-11,0,2,2,-4,9,5,1,1,2,-9,10,1,1,1,2,-1,-12,3,3,-4,1,-4,0,-1,1,-1,-1,-1,3,-1
KR_6748768355,420,-1,-11,-4,-7,2,4,6,-1,1,0,-5,6,1,-5,5,0,2,1,3,0,-10,-4,-3,0,3,0,0,0,-1,-1,0,1,1,-1
KR_6763967669,420,0,-1,-10,-4,5,1,6,-2,3,1,-4,4,0,-5,5,0,2,0,2,0,-1,49,3,-3,0,-25,0,1,-1,0,1,-1,2,-1
KR_6694331688,420,-5,6,0,-3,-3,3,0,0,1,1,2,2,4,-2,3,1,0,1,1,0,2,-54,4,-8,4,-3,0,0,-1,1,0,1,2,-1
KR_6762442039,420,-4,-60,-12,-2,-3,4,1,2,2,4,-2,2,0,2,2,4,-1,3,2,0,2,8,2,-2,0,0,0,-1,-1,-1,-1,-1,6,-1
KR_6758938022,420,0,-6,-8,4,0,1,1,2,2,4,-1,3,2,5,1,6,-2,2,0,0,15,7,0,-2,2,-3,0,-1,1,-1,-1,1,5,-1
KR_6500938481,420,0,-4,-20,1,1,0,1,3,3,6,-6,6,0,4,0,4,-1,2,1,0,1,269,-4,-4,8,1,0,-1,-1,-1,-1,1,1,-1
KR_6759313620,420,-5,-25,-70,-8,1,2,3,-3,5,2,-3,5,2,-5,5,0,2,0,2,0,-10,1,1,-2,1,-1,0,-2,-1,-1,-1,1,5,-1
KR_6756337133,420,-2,6,-12,-2,0,2,2,6,2,8,-3,4,1,-4,6,2,-1,2,1,-1,4,229,-3,-2,5,24,0,0,-1,-1,0,-1,3,-1
KR_6750574672,420,-1,-19,4,-10,3,0,3,-1,1,0,-1,3,2,-11,13,2,0,0,0,-1,-15,-13,-3,-1,4,-6,0,-1,-1,-1,-1,-1,2,-1
KR_6673896425,420,-1,-17,12,-6,-4,6,2,-2,3,1,2,5,7,-1,3,2,-1,2,1,0,-1,-6,-2,-5,7,-1,0,0,1,1,0,-1,5,-1
KR_6762908040,420,-1,-26,-6,-4,3,0,3,-1,2,1,-3,5,2,-1,3,2,-2,3,1,0,-5,3,-3,-2,5,2,0,0,-1,1,0,-1,1,-1
KR_6681065113,440,-3,-22,-27,-6,-1,3,2,-5,8,3,0,2,2,2,1,3,-2,4,2,-1,-10,-16,-3,0,3,-2,0,0,-1,-1,-1,-1,2,-1
KR_6376381493,420,-3,-24,-25,-7,5,0,5,-2,2,0,-2,3,1,-6,6,0,-2,2,0,-1,-14,-55,-2,-2,4,20,0,-1,-1,-1,-1,-1,4,-1
KR_6762481646,420,-2,3,-17,-1,-4,5,1,0,1,1,3,2,5,-1,3,2,1,0,1,0,-1,1,1,-6,5,-1,0,-1,-1,0,-1,1,4,-1
KR_6751556298,420,-3,-58,30,-13,3,0,3,-3,3,0,-10,12,2,-5,5,0,2,1,3,0,-14,-2,-2,-2,4,0,0,-3,1,-1,-1,-1,1,-1
KR_6753998156,420,-1,12,28,-8,4,0,4,-2,3,1,-2,2,0,-6,8,2,-2,4,2,0,-9,-4,0,-3,3,-3,0,0,1,-1,1,1,4,-1
KR_6675852912,420,0,56,3,-2,-1,2,1,-2,4,2,0,2,2,2,3,5,-1,1,0,1,-11,-125,-1,-2,3,3,0,1,-1,-1,-1,1,5,-1
KR_6759015610,420,0,46,20,0,-2,3,1,1,1,2,2,0,2,-1,2,1,0,1,1,0,-1,-1,2,-5,3,1,0,0,-1,1,0,1,4,-1
KR_6758962260,420,-2,-102,7,-7,0,2,2,-5,7,2,2,2,4,-3,4,1,-1,3,2,-1,-5,1,5,-7,2,-3,0,-1,0,0,-1,-1,0,-1
KR_6733920335,440,-5,-53,-50,-13,-5,7,2,-3,3,0,-4,6,2,-1,2,1,0,0,0,-1,-9,10,-2,-2,4,-1,0,-1,-1,-1,-1,-1,3,-1
KR_6758417546,420,1,1,-16,2,-3,3,0,0,1,1,1,0,1,2,2,4,2,0,2,0,3,5,4,-7,3,0,0,1,1,0,1,1,6,-1
KR_6715837497,420,0,62,-8,-2,2,1,3,-5,5,0,1,4,5,0,1,1,0,0,0,0,-4,-4,-1,-4,5,2,0,0,1,0,0,1,3,-1
KR_6646244315,420,-3,-33,-12,-8,3,1,4,-1,2,1,-2,3,1,-7,7,0,-1,1,0,0,-15,-20,-3,-1,4,-1,0,0,-1,-1,-1,1,6,-1
KR_6353221209,420,-4,0,-49,-7,-2,2,0,-3,4,1,-7,8,1,5,0,5,0,0,0,0,2,0,0,0,0,-5,0,-1,-1,-1,-1,1,6,-1
KR_6203858405,420,0,-10,-24,2,-1,3,2,0,2,2,-2,4,2,1,4,5,4,1,5,0,9,192,-5,0,5,3,0,2,-1,1,1,-1,3,-1
KR_6763356527,420,1,-65,-17,0,1,2,3,0,3,3,-2,5,3,1,2,3,0,0,0,0,0,4,-2,-1,3,0,0,0,1,1,1,-1,2,-1
KR_6755448118,420,-2,-42,-15,-2,-1,3,2,-2,2,0,1,0,1,1,4,5,-1,1,0,0,-4,-388,-2,-1,3,0,0,0,-1,-1,0,-1,6,-1
KR_6671171797,420,-1,-30,-14,-6,5,1,6,-3,3,0,-1,3,2,-4,4,0,-3,3,0,0,-11,-4,4,-7,3,-5,0,-1,-1,-1,-1,-1,4,-1
KR_6671891706,420,-4,-76,-16,-13,1,2,3,-3,3,0,1,1,2,-11,11,0,-1,2,1,0,-14,-6,4,-8,4,-4,0,-1,-1,0,-1,1,4,-1
KR_6729587806,420,-2,-41,8,-17,-1,1,0,2,3,5,-9,9,0,-8,10,2,-1,2,1,-3,-12,-25,2,-3,1,0,0,-3,-1,-1,-1,-1,2,-1
KR_6763675157,420,-1,124,-10,3,2,1,3,-2,3,1,-1,2,1,4,3,7,0,1,1,0,-5,4,4,-8,4,4,0,-1,-1,-1,-1,-1,5,-1
KR_6709671606,420,0,-8,40,0,-1,3,2,6,1,7,-3,3,0,-1,3,2,-1,3,2,1,2,-4,-4,-2,6,2,0,0,-1,1,0,1,5,-1
KR_6761634214,420,-4,-81,-36,-9,-5,5,0,-4,5,1,2,1,3,-2,6,4,0,1,1,-1,-6,5,-1,-3,4,0,0,-1,-1,-1,-1,-1,4,-1
KR_6627399220,420,-2,-21,20,-8,-1,2,1,-5,5,0,-1,3,2,2,0,2,-3,3,0,0,-2,-340,-4,-2,6,0,0,-1,1,-1,-1,-1,2,-1
KR_6764164878,440,-1,7,-9,-8,0,3,3,-1,5,4,-3,5,2,-2,2,0,-2,2,0,0,-3,49,-1,-1,2,-11,0,0,0,0,0,-1,0,-1
KR_6726558744,440,-2,-59,8,-7,1,0,1,-2,4,2,2,2,4,-7,7,0,-1,3,2,0,-8,1,-1,-3,4,-4,0,0,1,1,0,-1,6,-1
KR_6717226461,420,3,73,15,-1,-3,3,0,-4,6,2,0,2,2,1,1,2,5,0,5,0,-5,0,-3,-4,7,-7,0,1,-1,-1,1,-1,3,-1
KR_6622019569,420,-1,-28,-3,-2,0,1,1,0,2,2,1,0,1,-2,4,2,-1,2,1,0,-2,19,1,-2,1,-1,0,0,-1,1,0,-1,6,-1
KR_6720894594,440,-1,-30,-3,-4,-1,3,2,3,1,4,-1,1,0,-6,6,0,1,0,1,0,-14,60,-5,-2,7,0,0,1,-1,1,1,-1,4,-1
KR_6507745948,420,-1,-75,0,-7,-1,1,0,-1,3,2,-2,3,1,0,1,1,-3,3,0,0,-10,-3,1,-2,1,-1,0,0,1,1,1,1,5,-1
KR_6700139135,420,0,24,1,-4,3,0,3,-11,11,0,1,0,1,4,0,4,-1,2,1,0,0,-15,-3,-2,5,4,0,0,1,-1,-1,-1,5,-1
KR_6732989283,420,-2,30,-10,1,-4,5,1,1,1,2,1,2,3,2,2,4,1,0,1,0,5,4,-1,-3,4,-1,0,-1,0,-1,-1,1,0,-1
KR_6701941026,420,-2,-33,-7,-4,-4,4,0,0,3,3,1,2,3,1,1,2,-2,3,1,0,-7,-14,0,-5,5,0,0,-1,1,-1,-1,1,2,-1
KR_6752229116,420,4,62,25,9,4,1,5,3,0,3,-2,4,2,5,0,5,-1,1,0,-1,13,-3,0,-1,1,1,0,0,1,-1,1,-1,4,-1
KR_6702978474,420,-5,-92,-1,-19,-11,11,0,-5,5,0,-2,6,4,0,0,0,-1,1,0,-1,-12,-1,-6,0,6,-5,0,-3,-1,-1,-1,-1,2,-1
KR_6700927065,420,-5,-83,-20,-1,0,0,0,0,2,2,-4,4,0,4,1,5,-1,1,0,0,-1,23,-1,-5,6,-8,0,0,0,1,0,1,0,-1
KR_6617084805,420,-1,-25,-8,-4,1,2,3,-1,2,1,-1,1,0,-1,2,1,-2,2,0,0,-13,-4,-4,-4,8,1,0,-1,-1,1,-1,1,6,-1
KR_6664365756,420,-2,-65,-15,-11,-2,4,2,-3,6,3,-8,8,0,0,3,3,2,0,2,1,-2,5,3,-6,3,-2,0,-4,-1,-1,-1,1,2,-1
KR_6709028154,420,-2,-38,-8,0,-1,1,0,1,1,2,-4,6,2,4,0,4,0,1,1,0,-2,-31,0,-3,3,15,0,0,-1,-1,0,1,5,-1
KR_6760827749,440,-7,-154,-4,-18,-7,8,1,3,0,3,-3,6,3,-11,13,2,0,2,2,0,-9,-1,0,-1,1,0,0,-1,-1,0,-1,-1,6,-1
KR_6763439372,440,-3,-77,-3,-3,1,1,2,-1,3,2,0,0,0,-4,5,1,1,1,2,0,-6,-4,-2,-1,3,-1,0,-1,0,-1,-1,1,0,-1
KR_6751565523,420,-2,-88,-1,-8,-1,2,1,2,2,4,1,2,3,-6,6,0,-4,5,1,0,-8,-10,1,-7,6,0,0,-1,1,1,-1,-1,3,-1
KR_6660495567,420,-1,-17,-28,-12,-4,4,0,1,2,3,-6,7,1,-4,5,1,1,1,2,-1,-11,-1,-4,0,4,1,0,-1,-1,-1,-1,-1,4,-1
KR_6196145660,420,0,-43,-1,-3,1,0,1,-3,7,4,-4,4,0,3,2,5,0,1,1,0,-4,19,2,-7,5,1,0,0,-1,-1,0,-1,1,-1
KR_6674108235,420,3,58,32,-10,3,0,3,-4,6,2,-7,8,1,-1,3,2,-1,1,0,0,-5,10,3,-3,0,0,0,0,-1,-1,1,-1,4,-1
KR_6600870391,420,-4,-38,-10,-8,0,0,0,-2,3,1,2,2,4,-3,7,4,-5,5,0,0,-9,-112,-4,-2,6,-2,0,0,-1,-1,-1,-1,4,-1
KR_6764691324,420,-2,-3,-42,-5,0,1,1,-1,1,0,-2,5,3,-2,3,1,0,2,2,0,-1,-2,-3,-6,9,-3,0,-2,0,-1,-1,-1,0,-1
KR_6717323011,420,-2,-13,0,-9,-3,3,0,2,1,3,1,1,2,-3,6,3,-6,6,0,0,-5,-12,-3,-1,4,7,0,-3,-1,-1,-1,1,1,-1
KR_6625914579,420,-2,-16,-46,-14,0,3,3,-3,3,0,0,1,1,-10,10,0,-1,1,0,-2,-18,2,0,-4,4,-3,0,1,-1,1,1,-1,3,-1
KR_6501872059,420,-3,-58,-10,-9,-2,4,2,-2,4,2,-5,5,0,0,0,0,0,2,2,0,-5,-7,-7,-2,9,0,0,-1,0,0,-1,1,0,-1
KR_6752948746,440,-4,-14,-8,-10,0,2,2,-2,4,2,-5,5,0,-4,5,1,1,1,2,-1,-11,4,-1,-5,6,-5,0,-1,1,1,-1,-1,6,-1
KR_6755170498,420,-5,-184,-8,-10,0,0,0,-3,4,1,-2,3,1,-4,6,2,-1,2,1,0,-2,2,0,-3,3,-4,0,0,-1,0,0,-1,1,-1
KR_6530720135,420,-3,-48,20,-8,-5,5,0,-3,5,2,0,1,1,0,4,4,0,0,0,0,2,2,3,-3,0,-1,0,0,-1,-1,-1,1,2,-1
KR_6671826657,420,-7,-116,-26,-15,-3,5,2,1,1,2,-6,6,0,-3,3,0,-4,4,0,0,-8,38,-2,-3,5,-13,0,-2,-1,-1,-1,-1,1,-1
KR_6750056010,420,-1,0,-8,0,2,1,3,1,1,2,0,2,2,0,3,3,-3,3,0,0,0,0,-2,-2,4,0,0,0,1,0,0,-1,5,-1
KR_6744869242,420,-1,-57,39,-4,-1,2,1,-2,4,2,0,1,1,-2,3,1,1,2,3,0,-10,-8,0,-4,4,2,0,0,0,1,0,1,0,-1
KR_6590362709,440,0,38,27,6,1,2,3,-2,3,1,1,3,4,7,3,10,-1,1,0,1,5,4,5,-5,0,3,0,2,1,1,1,1,3,-1
KR_6659515515,420,-4,1,-16,-12,0,2,2,-7,12,5,0,3,3,-2,3,1,-3,3,0,0,-6,15,-1,0,1,-1,0,0,-1,0,-1,-1,4,-1
KR_6639983243,440,2,2,-8,-2,-1,4,3,1,4,5,-1,3,2,-1,1,0,0,2,2,-1,1,-1,2,-2,0,-3,0,1,1,-1,1,-1,1,-1
KR_6763335824,440,1,30,8,-6,-1,1,0,-1,3,2,-2,4,2,-2,2,0,0,1,1,0,-7,2,-1,-3,4,2,0,0,0,1,0,1,0,-1
KR_6756990121,420,0,-6,-10,-2,2,2,4,-2,3,1,-2,2,0,0,1,1,0,2,2,-1,-3,10,-5,-2,7,7,0,-1,1,-1,-1,-1,5,-1
KR_6731796152,440,0,-27,-28,3,1,1,2,2,1,3,-1,5,4,0,4,4,1,0,1,0,13,-3,3,-3,0,2,0,-1,1,-1,-1,-1,2,-1
KR_6764397366,420,-1,-18,-8,-8,0,4,4,2,0,2,-1,4,3,-5,7,2,-4,4,0,0,-14,-6,1,-5,4,1,0,-1,-1,1,-1,1,6,-1
KR_6732944905,420,-1,-27,-50,-7,3,1,4,-5,7,2,-2,4,2,-1,2,1,-2,3,1,-1,-12,-4,-3,-2,5,1,0,0,-1,1,0,-1,4,-1
KR_6757917082,420,-2,-76,15,-2,-2,3,1,2,1,3,-2,2,0,0,2,2,0,1,1,0,2,4,0,-3,3,-1,0,-2,-1,-1,-1,-1,5,-1
KR_6678985531,440,2,-3,8,1,0,2,2,1,2,3,0,0,0,2,0,2,-2,2,0,0,2,4,-1,-3,4,-4,0,0,0,-1,0,-1,0,-1
KR_6747177226,420,-1,-16,-48,-3,-2,3,1,3,0,3,3,0,3,-7,8,1,0,3,3,0,-3,9,0,-5,5,0,0,-1,-1,1,-1,-1,6,-1
KR_6660807782,420,-3,23,16,-12,0,1,1,-2,2,0,-2,4,2,-7,8,1,-1,1,0,0,-14,-4,2,-5,3,1,0,-2,-1,1,-1,-1,5,-1
KR_6763412911,420,0,-21,-2,5,-1,3,2,1,1,2,1,0,1,4,2,6,0,1,1,0,8,23,1,-4,3,-2,0,1,-1,1,1,1,4,-1
KR_6753416178,440,-6,-95,-13,-18,-7,7,0,-3,7,4,-5,6,1,-2,3,1,-1,1,0,-3,-17,-9,-5,0,5,3,0,-4,-1,-1,-1,-1,3,-1
KR_6759759213,420,3,4,4,5,3,0,3,0,3,3,2,2,4,-3,4,1,3,0,3,0,1,119,-1,-4,5,1,0,2,-1,1,1,1,4,-1
KR_6623882924,440,-3,-18,4,-14,-5,5,0,-8,8,0,3,1,4,-1,1,0,-3,3,0,0,-8,-5,-8,0,8,3,0,-1,1,1,-1,-1,3,-1
KR_6690393740,420,-4,-32,-4,-7,3,0,3,-3,3,0,-2,3,1,-3,5,2,-2,2,0,0,-8,-2,-1,-2,3,-2,0,0,-1,1,1,-1,6,-1
KR_6629936530,440,0,-31,-35,3,-5,5,0,-1,2,1,2,3,5,3,2,5,4,0,4,0,4,1,3,-4,1,3,0,0,0,-1,-1,1,0,-1
KR_6722923358,420,0,47,2,-1,-3,4,1,-2,4,2,4,3,7,1,3,4,-1,2,1,1,-8,9,1,-5,4,4,0,1,-1,1,1,1,5,-1
KR_6763416401,420,-1,-29,12,-7,-5,6,1,0,1,1,-4,5,1,2,1,3,0,1,1,0,2,18,3,-5,2,-1,0,-1,-1,-1,-1,-1,1,-1
KR_6080438385,420,-4,-55,5,-9,-8,10,2,0,2,2,4,0,4,-4,4,0,-1,3,2,0,-3,174,0,-3,3,-3,0,-1,-1,1,1,-1,4,-1
KR_6670512600,420,0,-12,-4,-4,-3,3,0,1,1,2,-1,4,3,0,3,3,-1,1,0,0,1,-167,1,-8,7,7,0,-1,-1,-1,-1,-1,6,-1
KR_6718858333,420,2,81,6,-1,5,1,6,-1,4,3,1,2,3,-6,7,1,0,3,3,-1,-7,-13,-3,-1,4,3,0,0,-1,0,-1,-1,6,-1
KR_6616044044,420,2,52,32,-4,3,2,5,-2,3,1,-5,5,0,1,0,1,-1,3,2,0,-2,0,4,-8,4,5,0,0,-1,-1,0,-1,4,-1
KR_6759126906,440,0,66,-23,2,-2,3,1,-1,3,2,1,2,3,4,0,4,0,2,2,0,2,-333,3,-4,1,2,0,0,1,1,1,-1,4,-1
KR_6760004683,420,-3,25,-8,0,6,1,7,2,2,4,0,3,3,-6,8,2,-2,2,0,0,-11,-11,-2,-5,7,-2,0,0,-1,1,1,1,2,-1
KR_6755309851,420,-3,-32,-20,-9,0,1,1,0,3,3,-4,8,4,-4,5,1,-1,1,0,-1,-12,-11,-6,-2,8,3,0,-2,-1,-1,-1,-1,3,-1
KR_6708989909,420,-2,10,-9,-6,4,1,5,-1,3,2,-3,6,3,-2,3,1,-4,4,0,0,-10,-18,4,-6,2,-4,0,0,-1,1,1,-1,4,-1
KR_6661968693,420,-3,-75,28,-6,-3,3,0,2,1,3,-4,5,1,2,2,4,-3,3,0,0,3,-19,-3,-2,5,2,0,-1,1,-1,-1,-1,3,-1
KR_6698801609,420,-2,-24,-16,-5,-7,7,0,1,1,2,-2,2,0,1,2,3,2,0,2,0,8,-18,-1,-2,3,0,0,1,-1,1,1,1,2,-1
KR_6733282296,420,-3,-55,-34,-15,-1,1,0,-7,8,1,-1,5,4,-6,8,2,0,2,2,-1,-21,0,-1,0,1,-1,0,0,-1,-1,0,-1,2,-1
KR_6756061482,420,-3,-2,-4,-5,-5,6,1,-3,4,1,0,1,1,2,0,2,1,0,1,0,-1,-203,-2,-2,4,1,0,-2,-1,-1,-1,1,2,-1
KR_6493038198,420,1,-28,36,-6,-2,3,1,0,2,2,-2,3,1,-3,4,1,1,1,2,0,-11,-4,-5,-5,10,5,0,-1,-1,1,-1,-1,3,-1
KR_6760323769,440,1,-2,38,5,2,3,5,5,0,5,1,1,2,-1,4,3,-2,2,0,0,9,-47,-3,-1,4,-1,0,0,1,-1,0,-1,3,-1
KR_6761706841,420,-1,-25,-9,-5,4,1,5,-5,6,1,-2,3,1,-2,2,0,0,0,0,0,-8,-131,-1,-2,3,-1,0,-1,-1,1,-1,-1,2,-1
KR_6735057660,420,-2,22,-47,1,1,1,2,1,0,1,-6,6,0,6,0,6,-1,2,1,0,2,-10,0,-2,2,-4,0,0,-1,1,-1,-1,6,-1
KR_6752503705,420,-4,-14,-7,-4,-4,5,1,1,1,2,-1,1,0,-1,2,1,1,1,2,0,-1,26,-1,-2,3,-1,0,0,-1,-1,0,-1,1,-1
KR_6755286283,420,-2,-40,-21,2,-2,3,1,-4,4,0,0,1,1,7,0,7,1,1,2,-1,2,-5,-2,-5,7,1,0,0,-1,-1,0,-1,3,-1
KR_6735539901,420,-10,-169,-16,-15,-7,7,0,0,1,1,-1,1,0,-2,2,0,-5,5,0,0,-14,-2,-1,-1,2,0,0,-3,-1,0,-1,-1,4,-1
KR_6733582122,420,-1,1,28,-6,-7,7,0,3,1,4,1,1,2,-2,5,3,-1,2,1,1,3,29,2,-2,0,-16,0,-1,1,1,-1,-1,3,-1
KR_6764631329,420,-4,-95,13,-11,-5,6,1,-1,3,2,-1,2,1,-4,4,0,0,3,3,0,-5,-10,1,-3,2,1,0,-1,-1,-1,-1,-1,6,-1
KR_6762987405,420,3,35,-26,3,3,0,3,0,1,1,-4,4,0,5,1,6,-1,2,1,0,4,113,1,-5,4,1,0,1,-1,-1,1,1,4,-1
KR_6723601191,420,-1,-77,-7,-3,-1,2,1,-5,7,2,1,0,1,1,4,5,1,1,2,0,-1,16,0,-3,3,0,0,0,-1,-1,0,-1,5,-1
KR_6678837844,440,-7,-57,-28,-12,-5,5,0,-6,7,1,-1,2,1,-2,2,0,2,0,2,0,-5,111,0,-3,3,-1,0,0,-1,0,0,-1,5,-1
KR_6640976353,420,-1,41,-25,-3,-4,4,0,-3,4,1,3,1,4,1,2,3,0,0,0,0,2,5,1,-4,3,-7,0,0,-1,-1,0,-1,2,-1
KR_6655784182,420,-4,-12,-8,-5,-1,3,2,3,0,3,1,4,5,-7,9,2,-1,2,1,0,0,-6,3,-4,1,3,0,-1,-1,0,-1,1,4,-1
KR_6738452313,420,-3,-47,0,-7,-5,6,1,0,2,2,3,1,4,-4,6,2,-1,2,1,0,-3,42,-1,-8,9,-20,0,-4,-1,-1,-1,-1,4,-1
KR_6708780518,420,-7,-39,-51,-18,1,0,1,-9,10,1,-4,4,0,-3,3,0,-3,5,2,-1,-14,0,-2,-1,3,0,0,-1,0,-1,-1,-1,0,-1
KR_6463224485,420,-1,-95,-11,3,1,1,2,0,2,2,2,2,4,1,3,4,-1,3,2,0,7,-32,0,-5,5,18,0,0,-1,1,-1,1,3,-1
KR_6634739014,420,-4,-49,-30,-5,0,1,1,-1,1,0,-3,4,1,1,0,1,-2,2,0,0,-2,-1,7,-10,3,-3,0,0,1,1,0,1,2,-1
KR_6673358529,440,-3,-42,24,-10,-4,7,3,2,1,3,0,2,2,-6,6,0,-2,4,2,-1,-10,0,0,-4,4,1,0,1,-1,1,1,-1,1,-1
KR_6762644274,420,2,-1,-12,-1,6,1,7,-3,3,0,-4,4,0,2,1,3,-2,3,1,0,-4,-15,-3,-1,4,-1,0,1,0,-1,1,-1,0,-1
KR_6751892106,420,-2,-21,-14,-2,0,1,1,0,4,4,2,2,4,-4,6,2,0,0,0,0,0,-5,1,-4,3,2,0,0,0,1,1,-1,0,-1
KR_6635746155,420,1,-55,0,-1,1,0,1,1,3,4,-3,4,1,3,2,5,-3,3,0,0,-2,121,-2,-2,4,-7,0,0,-1,-1,0,-1,1,-1
KR_6759459354,420,0,-21,4,-2,3,1,4,1,2,3,-6,7,1,1,3,4,-1,1,0,0,2,-247,1,-3,2,0,0,0,1,0,1,1,6,-1
KR_6761600662,420,-2,-35,-4,-11,-3,4,1,1,1,2,-5,6,1,-1,5,4,-3,5,2,-1,-9,-344,-3,-2,5,1,0,0,-1,0,0,-1,5,-1
KR_6759715066,440,1,-63,4,-1,-1,4,3,2,3,5,-1,1,0,2,1,3,-3,3,0,-1,1,-2,-1,-6,7,1,0,0,0,-1,0,-1,0,-1
KR_6702745696,420,2,-3,-10,3,3,0,3,3,2,5,-1,4,3,-5,10,5,3,1,4,0,7,-17,0,-4,4,-1,0,0,1,-1,1,-1,3,-1
KR_6764014571,420,-3,-12,-20,-3,2,2,4,0,1,1,0,2,2,-4,5,1,-1,1,0,0,-5,-15,1,-4,3,-3,0,-1,1,-1,-1,-1,5,-1
KR_6692677810,420,-3,-48,-42,-1,1,1,2,1,3,4,-7,9,2,1,3,4,3,0,3,0,8,13,3,-5,2,0,0,-2,1,-1,-1,1,2,-1
KR_6764667249,420,-7,-34,-10,-14,-2,5,3,-4,4,0,-2,4,2,-4,5,1,-2,2,0,0,-14,43,-4,-2,6,-5,0,-2,-1,-1,-1,-1,3,-1
KR_6752097774,420,0,-47,18,-2,-1,2,1,0,3,3,2,1,3,-4,4,0,1,1,2,0,6,-14,-7,-1,8,2,0,0,0,1,0,-1,0,-1
KR_6745082013,420,-3,-18,6,-9,-2,3,1,2,2,4,-4,6,2,-6,7,1,1,0,1,0,-10,-4,-1,-1,2,2,0,-1,1,-1,-1,1,6,-1
KR_6728097263,420,0,-56,-39,6,1,1,2,1,1,2,3,2,5,-3,3,0,4,0,4,0,8,4,-2,-2,4,-3,0,0,1,1,-1,-1,1,-1
KR_6720536655,420,-1,-35,-16,5,-1,2,1,3,4,7,0,3,3,2,6,8,1,1,2,1,2,22,-5,-2,7,-3,0,0,0,1,0,1,0,-1
KR_6666152870,440,2,-16,11,3,-7,7,0,5,2,7,1,1,2,4,0,4,0,0,0,0,3,77,2,-6,4,-4,0,-1,-1,-1,-1,-1,3,-1
KR_6745682401,420,-1,8,4,-8,0,1,1,-1,2,1,-8,9,1,3,2,5,-2,2,0,0,-6,-2,-1,-3,4,-2,0,1,-1,-1,1,1,1,-1
KR_6557641680,420,-2,26,5,-3,5,1,6,-7,8,1,1,1,2,-1,1,0,-1,1,0,1,-3,309,-1,-3,4,3,0,0,1,1,0,1,5,-1
KR_6702025827,420,-4,-59,35,-10,1,2,3,-5,5,0,-4,5,1,-1,2,1,-1,2,1,0,-8,-33,-6,-1,7,37,0,0,0,0,1,-1,0,-1
KR_6701550911,420,0,-2,-20,-4,-2,2,0,0,2,2,1,2,3,-4,6,2,1,0,1,0,-8,3,-1,-3,4,-2,0,1,-1,1,1,-1,4,-1
KR_6635154936,440,-1,16,-18,1,1,0,1,-5,5,0,8,1,9,-3,4,1,0,1,1,0,1,253,-2,-2,4,-2,0,0,1,1,0,-1,1,-1
KR_6761457747,420,-2,-1,-20,-5,-2,4,2,-6,8,2,4,1,5,-1,1,0,0,0,0,1,-8,7,-2,-1,3,0,0,-1,-1,0,-1,1,2,-1
KR_6679722094,420,-3,-72,16,-5,-1,2,1,2,1,3,-7,7,0,1,2,3,0,2,2,1,1,17,4,-4,0,-2,0,-2,-1,1,-1,1,6,-1
KR_6707491635,420,1,63,-40,12,7,1,8,2,3,5,3,0,3,0,1,1,0,0,0,3,9,-51,1,-7,6,22,0,2,1,-1,1,1,3,-1
KR_6718747194,420,-4,-25,-22,-10,2,1,3,-3,4,1,-2,3,1,-4,5,1,-3,3,0,0,-13,1,1,-2,1,1,0,0,-1,1,0,-1,5,-1
KR_6671628076,420,1,34,-56,-2,0,1,1,-6,6,0,1,1,2,5,1,6,-2,3,1,-1,-1,1,2,-2,0,-1,0,-1,1,-1,-1,-1,5,-1
KR_6689683117,420,2,88,19,6,-7,8,1,5,0,5,4,3,7,1,0,1,3,2,5,0,2,13,3,-4,1,-3,0,3,-1,1,1,1,3,-1
KR_6623698797,420,-3,-17,-10,-3,-4,6,2,-1,3,2,-2,2,0,4,1,5,0,0,0,0,2,35,1,-5,4,-6,0,0,-1,0,0,1,4,-1
KR_6715772209,440,-2,-133,20,0,0,0,0,-2,4,2,5,2,7,-1,7,6,-2,2,0,0,-5,-39,-2,-4,6,18,0,-1,1,1,-1,-1,4,-1
KR_6744023937,420,0,35,4,-1,3,0,3,-4,5,1,2,4,6,-2,4,2,0,0,0,0,-3,-181,-5,-2,7,-3,0,1,-1,-1,1,-1,5,-1
KR_6738070635,420,-4,-52,-12,-4,-2,2,0,0,3,3,-2,3,1,-1,1,0,1,0,1,0,-3,2,-1,-6,7,-3,0,-1,1,-1,-1,-1,3,-1
KR_6750901058,420,-3,-3,-13,0,-2,3,1,0,1,1,7,2,9,-1,4,3,-4,5,1,0,5,-5,1,-3,2,5,0,-1,-1,-1,-1,1,3,-1
KR_6752169725,420,0,18,8,0,0,1,1,-4,7,3,2,1,3,2,2,4,0,0,0,1,-6,-17,3,-7,4,8,0,-1,1,1,-1,1,1,-1
KR_6693803434,420,-7,-53,-34,-7,3,2,5,-5,6,1,-1,2,1,-3,3,0,-1,2,1,0,-10,-4,1,-5,4,-8,0,-1,-1,-1,-1,-1,5,-1
KR_6760818249,420,-1,4,-2,-4,7,0,7,-9,9,0,3,2,5,-4,5,1,-1,1,0,0,-4,18,4,-6,2,2,0,0,-1,0,0,1,2,-1
KR_6763556342,440,2,-45,-25,7,-2,3,1,3,3,6,1,1,2,1,1,2,4,0,4,-1,10,22,4,-5,1,-3,0,-1,1,-1,-1,-1,3,-1
KR_6639735650,420,0,72,-43,5,2,1,3,1,2,3,0,1,1,5,0,5,-3,3,0,0,6,10,1,-2,1,1,0,0,0,1,0,1,0,-1
KR_6763418033,420,1,-36,-13,-2,-4,4,0,1,2,3,0,0,0,0,4,4,1,0,1,2,1,12,0,-3,3,1,0,-1,-1,-1,-1,1,6,-1
KR_6748232113,420,-4,-144,-11,-2,-3,4,1,0,2,2,-2,3,1,4,0,4,-1,1,0,-1,-1,-438,-1,-1,2,0,0,-1,-1,-1,-1,-1,1,-1
KR_6723094609,420,-3,-51,28,-5,-2,3,1,2,2,4,-1,4,3,-1,2,1,-3,3,0,1,4,-317,-1,-1,2,-38,0,-1,-1,-1,-1,1,6,-1
KR_6743693125,420,-7,-2,-68,-13,2,1,3,-5,6,1,-5,5,0,-5,7,2,0,1,1,-2,-20,-4,-1,-1,2,-1,0,-2,-1,-1,-1,-1,5,-1
KR_6721843788,420,-3,-32,-5,-6,0,1,1,-1,3,2,-3,4,1,-4,5,1,2,2,4,1,-8,-12,-2,-1,3,3,0,-1,1,-1,1,1,2,-1
KR_6721711114,420,0,10,-4,-4,2,2,4,-1,2,1,-6,7,1,-3,4,1,4,0,4,0,-10,-7,-1,-3,4,0,0,-1,-1,-1,-1,-1,2,-1
KR_6723000850,420,0,-29,27,-2,-3,3,0,-6,7,1,8,0,8,-1,2,1,0,0,0,0,-1,124,2,-5,3,-2,0,1,1,-1,1,1,1,-1
KR_6764134452,420,1,59,1,1,2,2,4,6,2,8,-4,8,4,-2,3,1,-1,1,0,0,-3,43,-1,-6,7,-20,0,0,-1,1,-1,-1,6,-1
KR_6712993811,420,-4,-71,-12,-7,-1,2,1,0,0,0,-1,1,0,-3,4,1,-2,2,0,0,-5,0,2,-5,3,1,0,-3,-1,-1,-1,-1,3,-1
KR_6744947064,440,2,51,-3,5,-2,3,1,0,2,2,0,0,0,8,0,8,-1,1,0,0,3,-2,3,-3,0,-1,0,0,0,0,-1,1,0,-1
KR_6734450616,420,1,-51,4,0,1,0,1,0,2,2,-2,3,1,-1,2,1,2,2,4,0,2,9,5,-5,0,-2,0,-1,-1,-1,-1,1,3,-1
KR_6757496363,440,-4,9,-26,-10,-3,3,0,0,2,2,-5,6,1,-1,2,1,-1,1,0,-1,-10,61,2,-3,1,-22,0,-1,0,-1,-1,-1,0,-1
KR_6763384743,420,-4,-83,-2,-5,-4,5,1,-4,6,2,-2,4,2,3,3,6,2,2,4,0,7,-3,-5,-1,6,-4,0,0,-1,1,-1,-1,3,-1
KR_6760764621,440,-5,-125,-19,-17,-4,4,0,-4,4,0,-4,4,0,-5,7,2,0,1,1,-1,-20,4,4,-6,2,-6,0,-2,-1,1,-1,-1,1,-1
KR_6683656700,440,1,-39,4,2,-5,5,0,-2,2,0,2,3,5,6,1,7,1,1,2,2,11,-3,1,-4,3,1,0,-1,0,0,-1,1,0,-1
KR_6661101647,420,-2,-42,-8,-4,-1,1,0,1,0,1,-1,2,1,0,3,3,-3,5,2,0,0,-2,0,-6,6,-3,0,-1,-1,0,-1,-1,2,-1
KR_6624624699,420,-2,-7,-11,-6,-2,2,0,0,2,2,0,2,2,-4,7,3,0,0,0,2,-3,450,-3,-1,4,-2,0,0,-1,-1,0,1,1,-1
KR_6758208721,420,1,25,16,0,8,1,9,-2,3,1,-4,4,0,-3,4,1,1,2,3,0,1,-21,-3,-3,6,-2,0,2,-1,1,1,1,3,-1
KR_6698860708,420,1,-20,20,0,-3,5,2,0,1,1,3,2,5,1,5,6,-1,3,2,-1,0,-2,-5,-1,6,-2,0,0,0,1,0,-1,0,-1
KR_6593796582,420,-2,-12,-14,-7,-1,4,3,3,0,3,-4,5,1,-3,3,0,-2,4,2,-2,-2,12,3,-6,3,1,0,0,-1,1,-1,-1,2,-1
KR_6720763983,420,-8,-126,-37,-13,-6,7,1,-3,4,1,2,0,2,-7,7,0,1,1,2,0,-8,4,-2,-2,4,-2,0,-3,-1,-1,-1,-1,3,-1
KR_6380040840,420,1,-3,-21,0,3,0,3,0,3,3,2,1,3,-3,4,1,-2,3,1,-1,8,186,5,-8,3,-3,0,-1,-1,0,-1,-1,2,-1
KR_6755368897,420,2,17,-4,1,0,0,0,-3,4,1,1,2,3,1,4,5,2,1,3,0,2,-30,-2,-5,7,25,0,0,1,-1,0,1,2,-1
KR_6587989821,420,-1,-20,3,3,2,1,3,-2,3,1,1,2,3,2,0,2,0,1,1,1,5,4,1,-4,3,-2,0,0,1,1,0,1,4,-1
KR_6663461261,420,-3,8,-19,-5,-1,3,2,-3,5,2,0,0,0,0,1,1,-1,2,1,0,-5,-2,2,-6,4,2,0,0,1,0,0,-1,1,-1
KR_6740660206,420,-3,-72,2,-9,-7,7,0,0,1,1,1,1,2,-3,4,1,0,2,2,-1,-9,-16,-1,-3,4,0,0,-2,0,-1,-1,-1,0,-1
KR_6635690600,420,-4,-66,8,-15,-4,4,0,-3,4,1,-1,2,1,-1,3,2,-6,6,0,-1,-12,3,-5,-3,8,1,0,-1,-1,1,-1,-1,1,-1
KR_6698206296,420,1,100,-35,4,2,2,4,0,2,2,7,1,8,-4,5,1,-1,2,1,0,2,-6,1,-2,1,4,0,0,0,0,-1,-1,0,-1
KR_6513903391,420,1,52,-12,8,2,0,2,-6,6,0,0,1,1,9,1,10,3,0,3,0,7,-6,2,-4,2,3,0,1,1,0,1,1,4,-1
KR_6760755002,420,2,49,16,-3,-3,3,0,-3,6,3,0,2,2,0,2,2,3,0,3,0,-1,1,-4,-2,6,3,0,-1,-1,-1,-1,-1,4,-1
KR_6622257826,420,-2,-25,-52,-1,-7,7,0,1,2,3,3,4,7,0,2,2,2,2,4,0,8,260,1,-4,3,-1,0,0,-1,-1,-1,-1,6,-1
KR_6742370537,420,-3,-50,5,3,-1,2,1,1,2,3,-2,3,1,3,4,7,2,1,3,1,4,1,1,-4,3,0,0,1,1,1,-1,1,5,-1
KR_6750527332,420,3,17,4,-3,-1,3,2,0,3,3,-1,2,1,-1,3,2,0,1,1,-1,-5,79,-1,-3,4,-23,0,0,1,-1,-1,-1,6,-1
KR_6716370907,420,-5,-48,15,-8,-1,2,1,0,1,1,-3,6,3,-2,2,0,-2,4,2,0,-1,-30,-2,-4,6,5,0,0,1,1,0,-1,5,-1
KR_6747044327,420,-1,3,-12,-9,1,1,2,-2,3,1,-2,4,2,-4,4,0,-2,3,1,0,-14,-2,-2,-2,4,2,0,0,-1,0,0,-1,4,-1
KR_6683773772,440,-2,18,12,-4,1,2,3,-1,2,1,0,5,5,-4,5,1,0,0,0,0,-4,-6,-2,-3,5,2,0,1,-1,1,1,1,1,-1
KR_6732015057,420,-1,13,11,7,-5,7,2,3,2,5,6,1,7,-1,3,2,4,0,4,0,13,1,-3,-4,7,0,0,0,-1,1,-1,1,5,-1
KR_6621662759,420,-3,6,-41,-3,0,1,1,2,1,3,-1,3,2,-1,4,3,-3,3,0,-1,1,-10,7,-8,1,-1,0,1,-1,-1,1,-1,1,-1
KR_6733665991,420,-6,-28,-32,-10,4,0,4,-1,1,0,-4,5,1,-8,8,0,-1,2,1,0,-15,-7,1,-4,3,-2,0,-2,-1,-1,-1,1,4,-1
KR_6713220549,420,0,-32,-34,1,2,1,3,-7,7,0,-1,5,4,-2,4,2,9,0,9,0,-9,4,1,-3,2,-1,0,0,-1,1,1,-1,2,-1
KR_6747324404,420,-7,-115,13,-22,-3,3,0,-8,8,0,-2,4,2,-5,5,0,-4,6,2,0,-21,10,2,-4,2,-4,0,-3,-1,-1,-1,-1,6,-1
KR_6617483580,440,-3,-42,-2,-7,1,2,3,-5,5,0,-1,3,2,-1,3,2,-1,1,0,0,-4,10,1,-9,8,-6,0,0,-1,-1,-1,1,2,-1
KR_6661002716,420,-3,15,4,-11,-2,3,1,2,1,3,-5,5,0,-3,5,2,-3,3,0,0,-16,-12,-2,-4,6,1,0,-1,1,1,-1,1,1,-1
KR_6755718973,420,1,-21,15,-2,0,1,1,-1,2,1,-2,3,1,1,1,2,0,1,1,0,-4,-5,4,-5,1,-1,0,0,1,-1,0,-1,1,-1
KR_6752183909,440,1,37,0,-6,2,0,2,-3,7,4,1,3,4,-6,10,4,0,1,1,0,-8,-11,-2,-6,8,2,0,0,-1,-1,0,1,3,-1
KR_6723145612,420,-4,35,-19,-9,1,0,1,-8,9,1,0,1,1,0,2,2,-2,2,0,-1,-7,-2,3,-5,2,1,0,-1,0,1,-1,-1,0,-1
KR_6726653451,440,0,-24,1,-2,1,1,2,-2,4,2,-4,4,0,6,0,6,-3,3,0,0,-1,5,-1,-5,6,0,0,0,1,-1,-1,-1,3,-1
KR_6732707468,420,-1,-24,0,1,0,2,2,5,1,6,1,0,1,-3,5,2,-2,3,1,0,-1,14,4,-6,2,-2,0,0,-1,1,-1,-1,1,-1
KR_6762938992,440,-2,-120,-12,-3,-5,6,1,1,2,3,0,1,1,-3,6,3,4,0,4,0,3,-14,-2,-2,4,3,0,-3,1,0,-1,-1,2,-1
KR_6714685349,420,-4,-28,-22,-12,-3,3,0,-9,11,2,-3,4,1,5,1,6,-2,5,3,-1,-3,-4,1,-4,3,-2,0,-1,-1,1,-1,-1,3,-1
KR_6376353518,420,-8,-131,-45,-6,-3,3,0,3,3,6,0,3,3,-4,4,0,-2,4,2,0,-4,-9,-2,-1,3,1,0,-1,-1,1,-1,-1,1,-1
KR_6707112795,420,-6,-34,-16,-3,-4,5,1,-1,1,0,2,3,5,1,3,4,-1,1,0,0,-1,5,-2,-2,4,1,0,-1,-1,-1,-1,-1,5,-1
KR_6763830483,420,-1,-33,-24,-3,0,1,1,1,0,1,-3,4,1,-4,7,3,3,0,3,0,-2,-347,1,-3,2,2,0,0,-1,0,0,-1,2,-1
KR_6733518283,420,0,-42,-56,2,-1,3,2,1,3,4,2,5,7,1,2,3,-1,1,0,0,-4,156,5,-6,1,10,0,-1,1,1,-1,-1,4,-1
KR_6749458471,420,0,-11,4,-7,-3,3,0,-1,2,1,-3,3,0,-2,3,1,2,0,2,0,-4,-13,-4,-3,7,0,0,0,-1,-1,0,-1,4,-1
KR_6490139124,440,-3,-36,3,-13,-1,2,1,-2,3,1,-2,4,2,-9,11,2,1,2,3,1,-20,-12,-1,-4,5,0,0,-1,-1,1,-1,1,2,-1
KR_6763200697,420,-1,-21,4,-4,2,1,3,-2,3,1,2,0,2,-5,5,0,-1,2,1,0,-6,20,-2,-3,5,-2,0,-1,-1,0,-1,1,4,-1
KR_6735441856,420,-1,-17,6,1,0,3,3,3,1,4,-1,4,3,0,6,6,-1,2,1,0,1,3,5,-5,0,2,0,0,1,-1,0,1,2,-1
KR_6659655658,420,-3,-80,-27,-5,-4,5,1,-2,3,1,0,4,4,-1,1,0,2,1,3,1,0,0,3,-3,0,-1,0,-1,-1,-1,-1,1,3,-1
KR_6755195846,420,-3,-135,-36,-2,-2,5,3,1,1,2,-1,4,3,0,3,3,0,1,1,0,3,-16,-7,-6,13,-4,0,-2,-1,1,-1,-1,1,-1
KR_6732615478,420,-1,63,-3,-6,-5,6,1,-5,6,1,2,1,3,0,2,2,2,0,2,0,-1,111,1,-4,3,-1,0,0,0,1,1,1,0,-1
KR_6707235577,420,-1,32,4,1,4,3,7,0,4,4,-6,6,0,1,4,5,2,1,3,0,1,0,-4,-1,5,2,0,1,1,-1,1,-1,5,-1
KR_6733566487,420,-3,14,-28,-10,1,2,3,-1,3,2,-1,2,1,-4,6,2,-5,5,0,0,-12,-7,-2,-1,3,-1,0,-2,-1,-1,-1,1,1,-1
KR_6655508796,420,1,66,20,0,4,0,4,-1,2,1,3,0,3,0,5,5,-6,8,2,0,-5,1,-6,0,6,2,0,0,0,-1,1,-1,0,-1
KR_6757715897,420,0,15,-15,2,-3,4,1,1,2,3,4,0,4,0,3,3,0,1,1,0,5,10,1,-5,4,-1,0,1,-1,1,1,1,6,-1
KR_6694070740,420,5,11,0,7,0,2,2,0,3,3,0,2,2,1,0,1,6,1,7,-1,3,-9,-2,-5,7,7,0,0,-1,-1,-1,-1,1,-1
KR_5934884244,420,-2,34,-21,-3,1,1,2,0,1,1,-1,5,4,-1,1,0,-2,2,0,0,-3,134,5,-6,1,0,0,1,0,0,1,1,0,-1
KR_6763116212,440,-1,-82,8,0,0,1,1,-5,6,1,3,2,5,1,0,1,1,1,2,0,6,16,3,-5,2,-2,0,0,1,0,0,-1,3,-1
KR_6733750384,420,0,-9,19,-2,1,1,2,2,1,3,-1,1,0,-4,4,0,0,0,0,-2,-9,-153,6,-9,3,-8,0,0,0,1,1,-1,0,-1
KR_6723172503,420,1,92,-28,-1,2,0,2,1,3,4,-3,3,0,-2,6,4,1,0,1,0,2,2,1,-5,4,-3,0,2,-1,1,1,-1,1,-1
KR_6763429077,420,-3,-98,-16,-9,-3,4,1,-2,2,0,4,2,6,-6,6,0,-2,2,0,0,-11,5,-3,-3,6,-6,0,-2,-1,-1,-1,-1,3,-1
KR_6752243143,420,-1,-27,11,-6,5,0,5,-7,8,1,-1,2,1,-4,5,1,1,1,2,0,-10,-2,2,-5,3,-1,0,0,-1,1,-1,1,3,-1
KR_6754461787,420,-5,-50,-16,-4,2,2,4,-5,8,3,1,1,2,-3,3,0,1,1,2,0,-1,-19,3,-8,5,1,0,-1,0,1,-1,1,0,-1
KR_6759800184,420,-7,-99,16,-17,-6,6,0,-3,4,1,-1,1,0,-3,3,0,-4,4,0,0,-8,1,2,-4,2,-1,0,-1,0,-1,-1,1,0,-1
KR_6751183425,420,3,-2,0,6,5,1,6,0,1,1,4,1,5,-3,3,0,0,1,1,0,3,1,2,-3,1,2,0,0,1,-1,0,-1,6,-1
KR_6668418256,440,0,-21,-16,4,4,1,5,1,2,3,-2,3,1,1,0,1,0,0,0,-1,-2,27,-1,-1,2,-3,0,0,0,1,0,-1,0,-1
KR_6707600463,420,-3,-94,4,-1,-3,3,0,-1,4,3,1,1,2,1,2,3,1,0,1,0,2,-6,1,-2,1,-1,0,-2,1,-1,-1,1,6,-1
KR_6737640450,420,-6,-12,3,-14,0,1,1,-2,4,2,-11,11,0,2,3,5,-3,3,0,1,-15,410,0,-1,1,1,0,0,-1,1,0,1,4,-1
KR_6756367300,420,-2,-1,-4,-6,-1,1,0,-1,2,1,-3,5,2,-1,1,0,0,0,0,-1,-6,-32,-2,-3,5,-3,0,-2,-1,-1,-1,-1,4,-1
KR_6541249325,420,-5,-57,0,-14,-3,4,1,-5,7,2,-4,4,0,-3,4,1,1,0,1,0,-16,-8,1,-6,5,-7,0,-1,-1,-1,-1,-1,1,-1
KR_6290438071,420,-3,-57,-30,-6,-5,5,0,-2,3,1,-1,4,3,0,2,2,2,0,2,0,-2,2,4,-6,2,-3,0,-1,1,-1,-1,1,6,-1
KR_6760263320,420,0,-11,-4,-3,2,0,2,-2,3,1,-3,4,1,1,1,2,-1,1,0,0,-3,1,-1,-2,3,-4,0,0,0,1,-1,-1,0,-1
KR_6751276400,420,0,-16,-2,-8,-2,2,0,-1,5,4,2,0,2,-3,5,2,-4,4,0,0,-9,5,5,-6,1,-3,0,0,-1,0,-1,-1,5,-1
KR_6733417948,420,-2,-60,-16,-10,-2,3,1,0,1,1,-6,6,0,1,2,3,-3,4,1,1,-4,2,1,-4,3,2,0,0,-1,0,-1,1,5,-1
KR_6759622882,420,-4,-91,-16,-11,-3,4,1,0,1,1,-7,7,0,-1,2,1,0,1,1,0,-5,-7,-4,0,4,-3,0,0,0,-1,0,-1,0,-1
KR_6590832210,440,-1,-92,-47,5,3,0,3,1,2,3,0,2,2,2,0,2,-1,1,0,1,6,4,3,-6,3,-1,0,0,1,-1,0,1,3,-1
KR_6760573281,420,-2,6,20,-5,-4,6,2,-2,2,0,0,1,1,2,5,7,-1,3,2,0,-9,-18,-10,-2,12,6,0,-1,1,-1,-1,-1,6,-1
KR_6753953564,420,-1,-49,0,2,1,1,2,-1,4,3,3,1,4,1,2,3,-2,2,0,0,-4,-13,-4,0,4,0,0,-1,-1,1,-1,-1,3,-1
KR_6760987293,420,-6,-107,0,-16,2,1,3,-4,6,2,-8,8,0,-4,5,1,-2,2,0,0,-12,3,-1,-5,6,-3,0,-3,-1,-1,-1,-1,4,-1
KR_6760051307,420,-1,-44,-4,-4,-1,1,0,3,1,4,-3,5,2,-3,4,1,0,0,0,0,-3,-11,1,-5,4,-5,0,-1,-1,-1,-1,-1,2,-1
KR_6760573742,420,-3,-87,0,-8,-4,5,1,1,3,4,0,2,2,-6,7,1,1,0,1,-1,-8,9,-3,-1,4,1,0,-1,-1,0,-1,-1,5,-1
KR_6635722418,420,-1,-33,-8,-5,-3,4,1,1,2,3,1,2,3,-2,3,1,-2,2,0,0,-2,2,-5,-1,6,3,0,0,-1,0,0,-1,5,-1
KR_6761848356,440,-2,-66,-4,-11,-1,2,1,-2,3,1,1,0,1,-5,6,1,-4,4,0,0,-15,-6,-3,-3,6,-3,0,0,-1,1,-1,-1,5,-1
KR_6683657732,420,-5,-30,-23,-9,-1,2,1,-5,5,0,0,2,2,-1,3,2,-2,3,1,0,-14,-16,0,-5,5,-5,0,-1,-1,-1,-1,1,4,-1
KR_6597091952,420,-3,-53,10,-2,0,2,2,-3,4,1,-1,2,1,0,2,2,2,0,2,0,-9,-9,-4,-2,6,0,0,-1,-1,-1,-1,-1,6,-1
KR_6635562460,420,5,53,28,13,2,1,3,6,2,8,5,0,5,-2,4,2,2,0,2,1,13,7,1,-5,4,-1,0,0,1,-1,0,1,3,-1
KR_6726512722,440,-4,-62,-4,-7,-5,6,1,-2,2,0,1,2,3,-1,5,4,0,0,0,0,-3,-8,-7,0,7,-3,0,-1,-1,1,-1,-1,6,-1
KR_6754502570,420,1,59,1,-5,-1,3,2,1,0,1,0,3,3,-4,4,0,-1,1,0,0,-3,55,0,-2,2,-17,0,0,-1,1,-1,-1,5,-1
KR_6728180177,420,-4,-42,-8,-10,-4,4,0,4,2,6,-1,1,0,-5,5,0,-4,4,0,-1,-6,-357,-1,-5,6,-5,0,-2,1,-1,-1,-1,6,-1
KR_6593756726,420,-9,-77,-35,-19,-8,9,1,-3,4,1,-3,5,2,-4,4,0,-1,1,0,0,-12,-10,0,-3,3,-2,0,-2,-1,-1,-1,-1,4,-1
KR_6680041349,420,-2,-13,0,1,-3,3,0,-4,4,0,1,1,2,6,0,6,1,0,1,0,3,-20,-3,-2,5,5,0,0,-1,-1,0,-1,4,-1
KR_6715829013,440,-2,-85,2,-1,1,1,2,3,1,4,-4,4,0,1,2,3,-2,6,4,0,6,10,8,-15,7,-2,0,0,0,0,-1,1,0,-1
KR_6287373381,420,-5,-48,-39,-14,-2,3,1,-3,7,4,-5,7,2,0,2,2,-4,4,0,0,-8,-97,0,-6,6,-2,0,0,-1,-1,-1,-1,4,-1
KR_6533930192,420,-8,-86,12,-11,-2,2,0,-2,3,1,-1,6,5,-5,5,0,-1,2,1,-1,-18,7,0,-1,1,-3,0,-2,1,-1,-1,-1,3,-1
KR_6751287377,420,1,19,-12,-1,-7,8,1,1,2,3,-1,3,2,4,0,4,2,1,3,-1,7,9,2,-8,6,1,0,1,1,-1,-1,-1,3,-1
KR_6711053495,420,-3,-75,-26,-8,1,3,4,-3,4,1,-2,2,0,-1,2,1,-3,3,0,-1,-6,-9,-2,-3,5,1,0,0,-1,1,0,-1,6,-1
KR_6605883193,420,0,23,-23,1,2,1,3,3,1,4,-3,6,3,-4,7,3,3,0,3,1,3,3,2,-5,3,4,0,1,-1,1,1,1,4,-1
KR_6654469294,440,-1,1,15,5,-1,1,0,-2,8,6,4,1,5,7,0,7,-3,4,1,2,4,-1,-2,-6,8,0,0,-1,1,1,-1,1,2,-1
KR_6713252891,420,-1,-27,-20,-2,-5,7,2,4,1,5,0,4,4,2,3,5,-3,5,2,0,1,269,7,-8,1,-3,0,-2,-1,-1,-1,-1,1,-1
KR_6764353680,420,1,-6,-16,4,3,0,3,0,1,1,0,3,3,-2,2,0,3,1,4,0,2,7,4,-7,3,-1,0,0,1,0,0,1,5,-1
KR_6699745598,420,-1,-20,24,-5,0,3,3,-3,6,3,2,2,4,-3,5,2,-1,3,2,0,-6,7,3,-5,2,-3,0,-1,-1,-1,-1,1,5,-1
KR_6760366411,420,-7,-96,-24,-15,-1,2,1,-3,3,0,-5,5,0,2,0,2,-8,8,0,0,-8,-25,-4,0,4,-3,0,-3,-1,-1,-1,1,3,-1
KR_6501643300,420,1,63,-32,1,-1,2,1,-3,6,3,1,2,3,4,6,10,0,2,2,-1,-6,-13,-5,-2,7,2,0,0,-1,-1,1,-1,3,-1
KR_6763508234,440,2,18,2,0,-1,1,0,2,0,2,-4,4,0,5,1,6,-2,2,0,-1,6,2,-3,-3,6,1,0,1,1,-1,1,-1,4,-1
KR_6698370245,420,4,36,29,-1,3,0,3,0,4,4,0,1,1,-2,5,3,-2,2,0,0,-9,35,-2,-1,3,-8,0,0,1,1,1,-1,6,-1
KR_6731284942,420,2,31,19,2,-5,8,3,2,0,2,2,4,6,2,0,2,1,0,1,0,-4,-17,1,-3,2,2,0,-1,-1,-1,1,1,4,-1
KR_6757305915,440,1,-43,20,-2,-6,10,4,3,1,4,1,1,2,1,5,6,-1,1,0,0,-1,-10,0,-4,4,-1,0,-2,1,-1,-1,-1,1,-1
KR_6760184438,420,0,-6,-38,0,-1,2,1,0,0,0,-2,4,2,0,3,3,3,1,4,-1,-3,-12,-6,-1,7,3,0,0,-1,-1,0,-1,2,-1
KR_6759036300,420,-5,-36,-4,-13,0,4,4,-3,5,2,-3,3,0,-4,5,1,-3,3,0,0,-14,38,3,-5,2,-17,0,0,-1,1,1,1,1,-1
KR_6652861859,440,-3,-156,-4,-4,-3,3,0,0,1,1,0,2,2,7,1,8,-8,8,0,0,2,-3,-1,-1,2,-2,0,0,1,-1,0,1,6,-1
KR_6695714899,420,-2,-58,-15,-6,1,1,2,-2,3,1,-5,6,1,0,3,3,0,1,1,-1,7,3,-1,-5,6,-1,0,-1,-1,0,-1,-1,1,-1
KR_6763978851,420,3,19,8,6,0,0,0,2,3,5,-4,6,2,3,1,4,5,0,5,0,4,-83,3,-6,3,2,0,0,1,-1,1,-1,3,-1
KR_6757011864,420,-1,-44,-68,-6,0,2,2,-2,2,0,0,4,4,-2,2,0,-2,4,2,-1,-5,-13,-3,-1,4,3,0,-1,-1,-1,-1,-1,2,-1
KR_6732792280,420,-6,-130,-10,-9,-1,4,3,-2,3,1,-3,4,1,-3,6,3,0,0,0,0,-7,-2,-2,-4,6,-2,0,0,1,1,-1,1,4,-1
KR_6695505022,420,0,-33,12,-4,-3,3,0,0,2,2,0,1,1,-5,6,1,4,1,5,0,-9,10,2,-3,1,-1,0,-1,-1,-1,-1,-1,2,-1
KR_6697933712,420,-4,-95,3,-8,-4,4,0,-5,5,0,-3,4,1,4,0,4,0,1,1,0,-4,1,1,-5,4,-5,0,-2,-1,-1,-1,-1,2,-1
KR_6752579581,420,-1,21,-28,-5,-3,3,0,0,2,2,0,1,1,0,1,1,-2,4,2,0,-7,0,5,-5,0,-2,0,0,-1,0,0,1,2,-1
KR_6650136554,420,0,-54,-4,0,-1,2,1,2,3,5,-1,3,2,1,3,4,-1,2,1,1,2,8,-5,-4,9,2,0,-1,-1,-1,-1,1,6,-1
KR_6589550906,420,-3,-44,-41,-5,6,1,7,-3,4,1,0,0,0,-8,9,1,0,1,1,0,-4,1,3,-7,4,0,0,0,-1,-1,1,-1,3,-1
KR_6619905822,420,-3,-60,0,-2,2,1,3,-4,5,1,-1,3,2,2,1,3,-1,1,0,0,-7,309,-2,-4,6,-1,0,-1,-1,0,-1,1,5,-1
KR_6761557209,420,1,-87,-1,-5,-1,2,1,1,2,3,-1,2,1,-4,4,0,0,1,1,-1,-5,2,-2,-2,4,-1,0,0,1,-1,-1,-1,1,-1
KR_6760797159,420,0,6,-3,-3,2,0,2,0,1,1,-7,8,1,1,2,3,1,0,1,0,1,-10,4,-6,2,1,0,0,0,1,-1,1,0,-1
KR_6697696047,420,-5,-10,12,-13,-3,4,1,-7,8,1,-2,3,1,-2,4,2,1,1,2,0,-12,251,0,-5,5,6,0,-1,-1,-1,-1,-1,1,-1
KR_6627479084,420,-3,-74,-24,-2,0,0,0,-3,4,1,2,0,2,-6,7,1,5,1,6,0,-5,229,-5,-4,9,-2,0,-2,-1,1,-1,-1,1,-1
KR_6519827762,420,-2,-58,-7,-3,-2,3,1,2,2,4,-3,4,1,-1,3,2,1,2,3,0,2,-11,0,-4,4,-5,0,-2,-1,1,-1,-1,6,-1
KR_6749358857,420,1,19,0,-8,0,1,1,-5,8,3,-2,3,1,-1,2,1,0,2,2,0,-2,0,-1,-5,6,6,0,1,-1,-1,1,1,6,-1
KR_6754527821,420,-2,-13,-40,0,3,0,3,0,0,0,-3,4,1,0,3,3,0,1,1,0,-2,-18,1,-3,2,11,0,0,-1,1,0,1,5,-1
KR_6751710622,420,-4,-26,-28,-5,0,3,3,-3,7,4,-5,8,3,3,0,3,0,1,1,0,-7,6,5,-7,2,1,0,0,-1,1,1,-1,5,-1
KR_6758976173,420,2,-42,-12,1,4,1,5,-4,4,0,-3,5,2,3,2,5,1,1,2,0,0,2,-4,-2,6,5,0,-1,1,-1,-1,1,2,-1
KR_6747904691,420,0,55,-8,-2,2,1,3,-3,5,2,2,0,2,-2,4,2,-1,2,1,0,-6,-322,2,-6,4,-4,0,0,-1,0,1,1,3,-1
KR_6733476241,420,0,-17,-8,-1,-1,3,2,2,1,3,1,1,2,-3,3,0,0,1,1,1,2,-9,-2,-5,7,0,0,-1,1,-1,-1,1,2,-1
KR_6733206509,420,-6,-83,-25,-12,-3,4,1,-2,5,3,-8,8,0,1,6,7,0,2,2,0,-7,-430,-3,-1,4,1,0,-2,-1,-1,-1,-1,6,-1
KR_6736178771,440,-3,9,16,-1,0,1,1,-1,3,2,-2,4,2,2,2,4,0,2,2,0,0,-9,-4,-1,5,0,0,0,1,-1,0,-1,4,-1
KR_6389812840,420,-4,4,-12,-10,0,0,0,-5,6,1,-1,2,1,-4,4,0,0,1,1,-2,-23,-31,1,-6,5,25,0,-1,-1,-1,-1,-1,6,-1
KR_6697430834,420,-1,45,-12,-4,-7,7,0,4,3,7,-6,6,0,4,0,4,1,1,2,0,3,-10,-2,-2,4,-1,0,2,1,-1,1,1,6,-1
KR_6670906700,420,-4,-51,-11,-10,1,0,1,-5,7,2,-2,3,1,-2,5,3,-2,2,0,-1,-12,-12,-1,-5,6,0,0,0,-1,1,-1,-1,2,-1
KR_6726306805,420,-2,-85,-31,-3,-2,4,2,-2,4,2,1,3,4,-2,2,0,2,1,3,0,3,-2,-2,0,2,1,0,1,1,-1,1,1,3,-1
KR_6759458597,420,-1,-50,5,-4,-1,4,3,-4,4,0,-3,5,2,2,4,6,2,0,2,0,-3,-3,-1,-3,4,2,0,-1,-1,0,-1,-1,6,-1
KR_6753530550,420,-1,-46,20,-4,-3,3,0,0,3,3,2,1,3,-2,2,0,-1,4,3,0,-1,25,-1,-4,5,4,0,-2,1,-1,-1,-1,1,-1
KR_6721850969,420,-1,-62,-1,-4,-1,2,1,-1,3,2,-1,2,1,0,4,4,-1,1,0,0,-2,-14,-1,-2,3,5,0,-1,-1,-1,-1,-1,3,-1
KR_6389426669,420,-4,-27,-20,-4,0,2,2,2,1,3,-3,5,2,-2,2,0,-1,3,2,0,2,-204,-6,0,6,-2,0,-1,-1,0,-1,-1,2,-1
KR_6719474048,420,0,8,4,-7,1,2,3,-3,3,0,0,1,1,-2,3,1,-3,3,0,0,-15,19,-2,-3,5,0,0,-1,1,-1,-1,-1,6,-1
KR_6723978081,420,-4,-36,-40,-14,-1,1,0,0,0,0,3,0,3,-14,17,3,-2,2,0,0,-7,-41,-6,-1,7,2,0,0,-1,-1,-1,-1,1,-1
KR_6723994670,420,-3,-28,-36,-8,-3,4,1,-2,2,0,-4,5,1,2,1,3,-1,2,1,-1,-5,7,-7,-2,9,0,0,-1,-1,0,1,-1,3,-1
KR_6304633536,420,-7,-76,-23,-20,-2,4,2,-5,6,1,-2,4,2,-5,6,1,-6,6,0,-1,-23,294,-4,0,4,1,0,-4,-1,-1,-1,-1,6,-1
KR_6692517725,420,-7,-92,-84,-10,-1,2,1,-8,8,0,-3,4,1,2,0,2,0,0,0,0,-5,-10,1,-6,5,0,0,-1,-1,-1,-1,1,1,-1
KR_6759467721,440,1,2,-5,3,4,2,6,-3,6,3,0,1,1,2,4,6,0,0,0,0,5,34,4,-5,1,-3,0,1,-1,1,1,1,1,-1
KR_6764230649,420,0,-15,44,-10,-3,4,1,-3,3,0,-2,5,3,-2,9,7,0,1,1,0,-11,120,-1,-3,4,-4,0,0,-1,1,0,-1,5,-1
KR_6727166211,420,-3,-57,-34,-7,-2,2,0,-3,4,1,4,1,5,-6,6,0,0,0,0,0,-5,62,-3,-2,5,-4,0,-2,-1,-1,-1,-1,2,-1
KR_6751756174,420,-2,-31,7,-5,-5,7,2,-3,4,1,-3,5,2,5,0,5,1,1,2,0,3,15,0,-1,1,1,0,-1,1,-1,1,1,2,-1
KR_6729620356,440,-4,-51,-43,-7,2,1,3,-2,6,4,-4,4,0,-3,3,0,0,0,0,0,-10,-1,-1,-1,2,1,0,-2,-1,-1,-1,-1,1,-1
KR_6738259655,420,-1,-6,-4,-14,3,1,4,-3,4,1,-2,2,0,-12,12,0,0,1,1,0,-22,-2,-1,-3,4,1,0,-1,-1,-1,-1,-1,5,-1
KR_6740426122,440,-4,-36,16,-3,2,0,2,-3,4,1,0,1,1,-2,2,0,0,0,0,0,-3,-48,-5,-3,8,0,0,-1,-1,-1,-1,-1,2,-1
KR_6539959580,420,-2,-18,20,0,-2,5,3,0,3,3,1,0,1,1,3,4,0,1,1,1,0,-11,3,-7,4,5,0,-1,-1,-1,-1,1,2,-1
KR_6757568067,420,-1,27,24,-5,-7,7,0,-1,4,3,-1,4,3,3,0,3,1,3,4,0,-3,3,1,-5,4,2,0,0,1,-1,-1,1,4,-1
KR_6730021282,440,-6,-118,-22,-15,-3,3,0,-2,3,1,-6,9,3,2,2,4,-6,8,2,0,-12,-2,0,0,0,-4,0,-2,0,-1,-1,-1,0,-1
KR_6683250793,420,-5,-97,-23,-14,-3,3,0,-1,2,1,-3,3,0,-5,5,0,-2,3,1,0,-7,-14,-4,0,4,-1,0,-2,-1,-1,-1,-1,6,-1
KR_6726760095,440,-3,-8,-22,-4,1,0,1,-5,5,0,4,1,5,-6,6,0,2,0,2,0,-10,22,-3,-3,6,-10,0,0,-1,1,0,1,3,-1
KR_6659570549,420,-1,12,-1,1,-3,5,2,5,2,7,3,0,3,0,1,1,-4,4,0,0,2,-53,0,-2,2,10,0,-1,1,-1,-1,1,2,-1
KR_6665739203,420,-9,-113,-13,-18,-9,9,0,-1,2,1,0,2,2,-4,5,1,-4,5,1,-1,-12,100,-1,-1,2,-1,0,-2,-1,0,-1,-1,5,-1
KR_6229758285,420,1,4,8,9,4,0,4,8,1,9,-2,6,4,0,1,1,-1,1,0,1,17,-404,5,-7,2,0,0,0,-1,1,0,1,5,-1
KR_6759986273,420,2,45,11,-4,0,1,1,1,2,3,-3,4,1,-2,3,1,0,4,4,-1,-6,2,3,-4,1,-2,0,0,1,1,1,-1,6,-1
KR_6679761060,420,-3,-47,-40,-3,-4,4,0,2,2,4,1,1,2,0,1,1,-2,3,1,0,3,-4,-3,-2,5,4,0,-1,-1,-1,-1,-1,1,-1
KR_6724699818,420,-1,-13,4,-1,-2,2,0,0,2,2,2,1,3,0,0,0,-1,2,1,0,-2,-199,0,-4,4,4,0,-2,1,-1,-1,-1,6,-1
KR_6737134078,440,-2,-28,-36,3,5,0,5,-2,4,2,2,0,2,0,0,0,-2,2,0,0,9,2,2,-8,6,1,0,0,-1,-1,0,-1,3,-1
KR_6762849833,420,-6,-108,-15,-10,-3,4,1,-4,5,1,-6,7,1,3,2,5,0,0,0,-1,-6,-5,4,-5,1,-3,0,-1,0,1,1,-1,0,-1
KR_6735859181,420,-4,-39,-22,-3,-1,3,2,-2,2,0,0,1,1,1,1,2,-1,1,0,0,-4,-18,-2,-1,3,0,0,0,-1,-1,0,1,4,-1
KR_6649932546,440,1,57,12,-4,1,2,3,-4,5,1,4,1,5,-6,7,1,1,1,2,-1,-15,2,-3,-1,4,1,0,1,-1,1,1,-1,5,-1
KR_6759138623,420,3,-43,9,5,-2,3,1,2,1,3,1,1,2,1,3,4,3,0,3,0,-2,-2,-2,-3,5,-3,0,-1,1,-1,-1,1,1,-1
KR_6747531354,420,2,15,16,2,0,1,1,0,3,3,-1,4,3,1,2,3,2,2,4,0,-1,3,2,-3,1,-2,0,0,-1,-1,0,-1,6,-1
KR_6679152497,440,-4,-163,-17,-9,-5,5,0,5,0,5,0,4,4,-5,6,1,-4,4,0,-1,-7,15,-1,-1,2,-3,0,-3,-1,1,-1,-1,2,-1
KR_6601848274,420,-3,-49,0,-8,-2,2,0,-1,3,2,1,2,3,-7,8,1,1,0,1,0,-1,-22,3,-4,1,-1,0,-2,-1,0,-1,-1,5,-1
KR_6764549031,420,-3,-49,44,-8,-3,4,1,-3,3,0,1,0,1,-4,4,0,1,1,2,0,-6,-61,0,-3,3,27,0,-2,-1,1,-1,-1,1,-1
KR_6740629351,420,-4,-44,-24,-11,-2,4,2,1,3,4,-6,8,2,-1,1,0,-3,3,0,0,-12,-8,-2,-2,4,2,0,-2,-1,1,-1,-1,6,-1
KR_6732100039,440,-1,-18,-36,-7,-2,3,1,-2,2,0,0,4,4,-2,4,2,-1,2,1,0,-1,4,0,-5,5,-1,0,-3,-1,-1,-1,-1,5,-1
KR_6713197505,420,-1,-36,2,-4,1,3,4,-3,4,1,-2,3,1,-1,2,1,1,2,3,0,1,-332,4,-6,2,-5,0,-2,0,-1,-1,-1,0,-1
KR_6743311518,440,3,-19,-5,2,-2,3,1,0,3,3,-1,2,1,3,1,4,2,1,3,0,5,119,0,-4,4,3,0,0,1,1,0,1,2,-1
KR_6763842566,420,1,-55,24,2,3,1,4,-4,6,2,0,0,0,2,1,3,1,1,2,0,2,-419,-6,-2,8,6,0,-1,1,-1,-1,1,2,-1
KR_6757024328,420,3,-44,11,9,1,1,2,0,1,1,-1,1,0,11,1,12,-2,3,1,0,12,-16,4,-5,1,-3,0,-1,-1,-1,-1,-1,1,-1
KR_6598506961,420,-1,-31,-13,-10,-5,6,1,-8,9,1,-5,7,2,3,3,6,5,0,5,0,2,22,-2,-5,7,-1,0,-3,1,-1,-1,-1,2,-1
KR_6743688770,420,4,133,-12,6,1,0,1,-3,7,4,6,3,9,3,3,6,-1,2,1,0,4,381,2,-2,0,0,0,1,1,-1,1,-1,3,-1
KR_6749542762,420,1,-13,-3,0,-6,9,3,6,0,6,-4,6,2,3,2,5,1,0,1,0,6,-8,-3,-1,4,1,0,-2,1,-1,-1,1,5,-1
KR_6759545734,420,-5,-52,-51,-7,-2,3,1,-5,6,1,3,2,5,-3,4,1,0,0,0,0,-6,-8,-4,-1,5,-3,0,-1,-1,0,-1,-1,5,-1
KR_6761902815,440,0,-18,-15,0,-3,5,2,0,2,2,-1,2,1,4,2,6,0,3,3,0,3,2,2,-5,3,0,0,1,-1,0,1,-1,5,-1
KR_6747299139,420,0,33,-16,4,-2,2,0,0,4,4,-4,8,4,2,2,4,8,1,9,1,6,-7,2,-4,2,2,0,0,-1,-1,1,1,2,-1
KR_6616614609,420,1,38,-6,0,2,0,2,-3,5,2,-2,2,0,3,4,7,0,1,1,0,2,13,3,-6,3,-3,0,0,0,0,1,1,0,-1
KR_6645756529,420,0,-9,4,-2,-2,4,2,2,1,3,1,1,2,-6,6,0,3,1,4,0,-5,8,-5,-1,6,1,0,1,-1,1,1,1,3,-1
KR_6731466804,420,-3,-106,-15,0,-2,2,0,1,1,2,1,1,2,1,0,1,-1,2,1,0,1,17,0,-3,3,-3,0,-1,-1,-1,-1,-1,6,-1
KR_6714173357,420,-2,-36,32,-5,-2,3,1,-3,4,1,1,4,5,-1,3,2,0,0,0,0,-4,2,2,-4,2,-2,0,0,1,-1,0,1,5,-1
KR_6504577403,420,-4,-90,-40,-10,-2,3,1,-2,2,0,-6,6,0,2,2,4,-2,4,2,-1,-8,-4,-1,-4,5,-1,0,-5,-1,-1,-1,-1,3,-1
KR_6759195739,420,3,-46,-28,8,1,0,1,8,2,10,-2,5,3,0,1,1,1,0,1,0,14,-144,-3,0,3,-2,0,-1,-1,0,-1,-1,2,-1
KR_6740106473,420,-1,-13,0,-4,0,2,2,0,2,2,-2,3,1,0,2,2,-2,3,1,0,-3,38,1,-4,3,4,0,1,1,1,1,1,4,-1
KR_6630799122,420,2,44,16,-2,3,2,5,1,1,2,-2,5,3,-3,3,0,-1,2,1,0,-8,-2,-4,0,4,-1,0,0,-1,0,0,1,3,-1
KR_6643608061,420,0,9,-27,1,0,2,2,3,2,5,-2,6,4,2,1,3,-2,4,2,0,0,15,-1,-4,5,6,0,3,1,0,1,-1,2,-1
KR_6683031460,420,5,5,20,3,3,1,4,0,2,2,-1,3,2,1,2,3,0,0,0,0,1,-12,0,-2,2,-2,0,0,-1,1,0,-1,1,-1
KR_6010923243,420,-5,-58,-2,-10,-6,7,1,-3,4,1,-1,2,1,1,1,2,-1,1,0,-1,-11,-6,1,-3,2,0,0,-3,1,1,-1,-1,5,-1
KR_6727582777,420,-2,-133,7,2,-2,2,0,5,0,5,-5,5,0,3,3,6,1,1,2,0,8,-4,0,-3,3,-2,0,-4,-1,-1,-1,1,5,-1
KR_6729031059,420,-3,-84,-12,1,-3,4,1,0,3,3,6,0,6,-3,4,1,1,0,1,0,2,-25,-3,0,3,2,0,-2,1,-1,-1,-1,4,-1
KR_6752522406,420,1,110,12,-5,-1,1,0,-2,3,1,-4,6,2,1,2,3,1,0,1,0,-9,-3,2,-3,1,-2,0,0,1,1,0,1,3,-1
KR_6749989774,420,-2,-6,-17,1,-2,2,0,1,4,5,2,3,5,0,4,4,0,2,2,-1,3,-1,-1,-3,4,0,0,2,-1,1,1,-1,4,-1
KR_6676232896,420,4,0,-13,8,3,1,4,-2,5,3,-1,2,1,6,0,6,2,0,2,0,9,10,5,-6,1,-4,0,1,-1,-1,1,1,3,-1
KR_6645368897,440,-1,-19,16,-4,-2,6,4,-2,2,0,1,2,3,0,1,1,-1,1,0,0,-9,-7,-7,-2,9,0,0,-1,1,-1,-1,-1,1,-1
KR_6731839937,440,1,46,17,-1,-3,4,1,-2,4,2,-3,4,1,6,1,7,1,0,1,0,3,1,2,-5,3,-2,0,1,1,1,1,-1,5,-1
KR_6607784688,420,-2,15,12,-8,0,4,4,4,1,5,-2,3,1,-10,11,1,0,0,0,-1,-11,-7,-3,-1,4,1,0,0,-1,1,-1,-1,1,-1
KR_6729639912,420,-4,4,-20,-15,-6,6,0,-3,5,2,-4,8,4,1,2,3,-3,3,0,0,-5,9,3,-4,1,-1,0,-1,-1,-1,-1,-1,3,-1
KR_6761976441,420,-4,-34,7,-4,3,1,4,-4,5,1,-2,2,0,-1,2,1,0,0,0,0,-3,1,-1,-2,3,0,0,0,1,1,-1,1,4,-1
KR_6723685208,420,-5,-46,-20,-14,-2,4,2,-2,2,0,-3,3,0,-6,7,1,-1,1,0,0,-19,18,-1,-2,3,-4,0,0,1,-1,-1,-1,4,-1
KR_6754389482,420,1,-26,-2,1,3,0,3,-1,2,1,-5,5,0,1,2,3,3,0,3,0,-1,86,-3,-2,5,2,0,0,-1,0,0,1,4,-1
KR_5686560976,420,-1,17,-20,5,0,0,0,1,2,3,6,0,6,-1,5,4,-1,4,3,0,-2,-3,-1,-6,7,-1,0,0,-1,-1,0,1,1,-1
KR_6738513927,420,-7,-48,-28,1,-4,4,0,1,1,2,2,2,4,1,1,2,1,2,3,0,2,-11,-2,-3,5,-2,0,-1,-1,-1,-1,1,5,-1
KR_6751528064,420,-2,-8,-13,-4,0,2,2,-4,7,3,-2,5,3,-1,4,3,3,2,5,0,-5,-36,-2,-3,5,3,0,-2,-1,-1,-1,1,5,-1
KR_6628052582,420,2,47,12,8,4,2,6,1,2,3,-3,4,1,4,1,5,2,2,4,3,7,-12,2,-4,2,1,0,2,-1,-1,1,1,1,-1
KR_6695116907,420,-4,-17,-16,-7,-1,3,2,-7,7,0,4,0,4,1,4,5,-4,4,0,0,-9,3,-4,-1,5,1,0,0,-1,-1,-1,1,3,-1
KR_6608494292,420,-1,-77,-19,-7,-5,5,0,1,2,3,2,1,3,-2,4,2,-3,3,0,0,-4,14,-3,-2,5,-5,0,0,-1,1,-1,-1,6,-1
KR_6741573648,420,-1,35,16,-1,0,2,2,1,1,2,0,3,3,-2,5,3,0,1,1,2,-7,257,-2,-1,3,2,0,0,0,1,0,1,0,-1
KR_6746558875,420,-1,22,0,-2,3,1,4,-10,11,1,1,3,4,3,4,7,1,1,2,1,-8,2,0,-4,4,0,0,1,1,-1,1,1,3,-1
KR_6743391049,420,0,-1,-4,0,-1,1,0,4,0,4,-1,1,0,1,3,4,-3,3,0,0,-3,6,-2,-1,3,3,0,0,-1,1,0,1,2,-1
KR_6751945329,420,1,-7,-7,0,-1,3,2,2,6,8,-6,7,1,2,2,4,3,0,3,0,-3,9,0,-2,2,0,0,0,-1,1,-1,-1,3,-1
KR_6764326699,420,-4,-102,-4,-12,-2,4,2,-5,6,1,-1,3,2,-4,5,1,0,1,1,0,-17,-2,-3,-1,4,-1,0,0,-1,-1,0,-1,1,-1
KR_6681530642,420,1,32,8,2,-2,2,0,1,2,3,8,1,9,-2,4,2,-3,3,0,0,-2,-4,1,-3,2,4,0,2,-1,0,1,1,4,-1
KR_6608537609,420,-2,-5,-20,-5,3,2,5,-6,8,2,-2,3,1,1,2,3,-1,2,1,0,-5,446,3,-8,5,0,0,0,-1,-1,0,-1,6,-1
KR_6758127419,420,3,31,2,6,4,0,4,1,2,3,2,1,3,-1,3,2,0,1,1,0,3,128,7,-9,2,-15,0,1,1,-1,1,-1,1,-1
KR_6637845618,420,-4,-18,-8,-10,-5,5,0,1,1,2,1,0,1,-1,1,0,-6,6,0,0,-7,2,-1,-2,3,-1,0,0,-1,-1,0,-1,6,-1
KR_6732821583,440,-3,-101,13,-10,-3,4,1,0,2,2,-2,3,1,-5,6,1,0,0,0,1,-5,123,-3,0,3,0,0,0,1,-1,-1,1,2,-1
KR_6724767644,420,-5,-133,1,-11,-6,6,0,1,2,3,-6,8,2,0,3,3,0,4,4,0,-2,-30,4,-5,1,-1,0,-3,1,-1,-1,-1,2,-1
KR_6609723208,420,1,31,8,-3,0,0,0,-7,7,0,-1,3,2,2,1,3,3,0,3,0,-5,26,1,-5,4,-22,0,1,1,1,1,1,2,-1
KR_6746192794,420,-3,-61,-8,-5,-4,5,1,1,2,3,0,3,3,-5,8,3,3,0,3,0,7,15,0,-8,8,-4,0,-1,1,1,-1,1,1,-1
KR_6388465653,420,1,-11,4,-3,0,4,4,-3,4,1,5,0,5,-2,4,2,-3,3,0,0,-3,-340,2,-5,3,-2,0,-1,-1,0,-1,-1,3,-1
KR_6708957706,420,-3,5,-16,-4,1,1,2,-5,6,1,0,0,0,1,1,2,-1,1,0,0,-2,36,3,-8,5,-30,0,1,-1,1,1,-1,2,-1
KR_6759856041,420,-1,-32,15,0,-2,4,2,2,1,3,1,5,6,-2,3,1,1,1,2,0,-3,4,3,-4,1,0,0,-2,0,1,-1,-1,0,-1
KR_6665795640,420,-2,-15,16,-2,1,0,1,0,2,2,-2,3,1,1,1,2,-2,4,2,0,-1,13,3,-7,4,-3,0,0,-1,1,-1,-1,6,-1
KR_6655843847,420,0,-2,8,6,4,2,6,0,3,3,-1,2,1,4,0,4,-1,3,2,1,2,92,0,-1,1,1,0,0,1,-1,0,1,6,-1
KR_6400692104,420,-4,-68,2,-11,-3,4,1,-1,1,0,-1,3,2,-4,4,0,-2,2,0,-2,-12,-4,-5,0,5,-2,0,-1,0,-1,-1,-1,0,-1
KR_6758681381,440,2,-101,20,4,1,3,4,3,2,5,-6,7,1,5,4,9,1,1,2,-1,5,-5,-1,-1,2,3,0,-2,0,0,-1,-1,0,-1
KR_6764027781,420,-3,-69,4,-1,4,0,4,2,1,3,-3,4,1,-4,5,1,0,2,2,0,-3,-28,0,-2,2,1,0,0,1,0,0,1,2,-1
KR_6764382794,420,-1,-28,3,-2,1,1,2,1,4,5,0,4,4,-3,5,2,-1,1,0,0,-1,2,1,-5,4,-2,0,-1,-1,-1,-1,1,6,-1
KR_6633292335,420,-5,-37,-24,-7,-2,3,1,-3,6,3,2,2,4,-4,5,1,0,0,0,0,-3,99,0,-4,4,-5,0,0,-1,0,-1,-1,4,-1
KR_6668071023,420,-1,10,-4,4,-1,2,1,-1,2,1,0,2,2,2,2,4,4,0,4,-1,4,-190,-1,-2,3,0,0,0,-1,-1,1,-1,2,-1
KR_6762665083,420,-4,-77,-8,-11,-1,1,0,-8,8,0,1,2,3,-1,3,2,-2,2,0,0,-12,281,2,-2,0,-1,0,-1,-1,-1,-1,1,1,-1
KR_6641031050,420,1,-27,8,-2,0,2,2,3,1,4,0,1,1,-3,6,3,-2,2,0,0,-2,-331,4,-4,0,-1,0,-1,-1,-1,-1,-1,4,-1
KR_6666099837,440,-3,24,-12,-9,-3,4,1,-4,4,0,1,0,1,1,3,4,-4,5,1,0,-13,131,-1,-5,6,-2,0,0,-1,-1,-1,-1,1,-1
KR_6720611037,440,-6,-40,-36,-17,-1,1,0,-11,12,1,-5,6,1,0,5,5,0,2,2,0,-13,10,-5,-1,6,3,0,0,-1,1,1,1,2,-1
KR_6716630753,420,0,3,-20,-4,-2,3,1,0,3,3,0,1,1,-2,5,3,0,2,2,0,0,-1,-1,-4,5,-2,0,0,0,1,-1,-1,0,-1
KR_6635771322,420,-5,-101,-36,-7,-2,3,1,-2,3,1,-1,1,0,-1,4,3,-1,2,1,0,-4,4,2,-2,0,1,0,-2,-1,1,-1,-1,6,-1
KR_6759862422,420,-1,29,-8,-3,4,2,6,-1,3,2,-5,6,1,-3,5,2,2,0,2,0,-3,19,-2,-2,4,-1,0,1,-1,-1,1,1,4,-1
KR_6760884666,440,1,30,-1,-3,-1,5,4,2,0,2,-1,5,4,-2,2,0,-1,1,0,-1,0,9,1,-4,3,-2,0,-1,-1,1,-1,-1,1,-1
KR_6754279270,420,-3,-38,24,-8,3,1,4,-4,5,1,-3,6,3,-2,3,1,-2,2,0,0,-13,0,-3,-2,5,-3,0,0,0,1,0,1,0,-1
KR_6750072636,420,-4,-83,7,-12,-8,8,0,-5,6,1,-1,2,1,2,2,4,0,1,1,1,-9,-4,-3,-1,4,-5,0,-2,-1,1,-1,-1,4,-1
KR_6751846355,420,-1,24,20,-6,-4,5,1,-4,6,2,1,1,2,1,2,3,0,0,0,0,-6,7,-2,-2,4,3,0,0,-1,1,1,-1,6,-1
KR_6745699833,420,-1,-44,36,-4,-5,7,2,0,2,2,-2,4,2,1,2,3,2,0,2,2,4,-3,1,-5,4,2,0,1,-1,-1,1,-1,2,-1
KR_6748348050,440,-3,-26,-21,-7,-4,4,0,2,1,3,-3,4,1,-2,3,1,0,1,1,-1,-5,-6,0,-8,8,-1,0,-1,-1,-1,-1,-1,3,-1
KR_6764500362,420,-2,78,-8,-2,3,0,3,-4,5,1,0,2,2,-1,4,3,0,0,0,0,-1,-144,-4,-5,9,1,0,1,-1,-1,1,1,2,-1
KR_6699854603,420,1,9,-20,5,0,1,1,2,2,4,3,2,5,0,4,4,0,4,4,0,2,-10,-1,-3,4,-2,0,1,-1,1,1,1,5,-1
KR_6750883163,440,2,24,8,5,1,2,3,-5,8,3,-2,3,1,10,0,10,1,0,1,1,6,23,-2,-3,5,-2,0,1,1,0,1,1,4,-1
KR_6671007583,420,-2,-58,-56,-1,1,1,2,0,0,0,-1,6,5,2,0,2,-3,3,0,0,-8,-9,-4,0,4,-1,0,0,0,1,0,-1,0,-1
KR_6689157761,420,-5,-18,-20,-10,-3,3,0,-5,6,1,-4,4,0,0,2,2,2,0,2,0,-10,-8,-2,-3,5,2,0,-1,-1,-1,-1,-1,5,-1
KR_6735096850,420,-4,-64,8,-10,1,0,1,-5,5,0,-4,7,3,-4,7,3,2,1,3,0,-12,-24,4,-8,4,-2,0,-2,-1,1,-1,-1,1,-1
KR_6367743233,420,0,-79,6,-3,-2,3,1,0,1,1,1,1,2,-4,6,2,2,0,2,0,-4,0,0,0,0,-3,0,0,0,1,0,-1,0,-1
KR_6598639371,420,1,26,-20,3,-1,2,1,1,3,4,2,2,4,0,1,1,1,0,1,0,4,21,-4,-2,6,2,0,1,0,1,1,-1,0,-1
KR_6758751035,420,-3,-37,-31,-8,-6,6,0,-2,4,2,0,2,2,0,2,2,0,0,0,0,-2,-8,1,-2,1,2,0,-2,-1,-1,-1,-1,5,-1
KR_6744640698,420,-3,-113,0,-11,-5,5,0,1,2,3,-3,4,1,-2,3,1,-2,2,0,0,-3,51,4,-6,2,-28,-1,-3,-1,-1,-1,-1,1,-1
KR_6729354376,420,0,-81,-12,-5,1,1,2,-1,1,0,-1,2,1,-1,5,4,-3,3,0,-1,-3,43,0,-2,2,1,0,0,-1,0,0,-1,6,-1
KR_6747442523,420,-3,3,-27,-3,0,1,1,0,3,3,-2,3,1,-3,5,2,2,0,2,0,1,-117,3,-4,1,2,0,0,1,1,0,-1,3,-1
KR_6763986240,420,-3,22,-7,-17,1,2,3,-2,5,3,-10,10,0,-4,4,0,-2,4,2,-1,-12,420,-1,-2,3,0,0,-1,0,-1,-1,-1,0,-1
KR_6742289979,420,-1,-41,12,-3,2,2,4,1,3,4,-2,2,0,0,1,1,-4,4,0,0,-6,55,1,-3,2,-14,0,1,0,1,1,-1,0,-1
KR_6632335742,440,-1,63,-4,3,1,0,1,3,1,4,-2,4,2,0,2,2,1,0,1,0,4,352,-3,-1,4,-1,0,0,1,-1,0,1,1,-1
KR_6752392684,420,-3,16,-28,0,1,2,3,2,1,3,0,1,1,-2,2,0,-1,2,1,0,-2,23,-5,-5,10,0,0,-1,-1,1,-1,1,6,-1
KR_6659872221,420,0,-43,-4,1,0,4,4,1,3,4,-2,2,0,2,1,3,0,2,2,0,14,3,2,-4,2,-3,0,-2,-1,-1,-1,-1,6,-1
KR_6739808862,420,-1,70,12,-3,-1,2,1,-4,4,0,-1,2,1,1,3,4,2,0,2,0,-2,8,-3,-2,5,-3,0,1,1,-1,1,-1,6,-1
KR_6752794966,440,-1,97,-8,-11,-1,3,2,-1,2,1,-3,5,2,-1,8,7,-5,6,1,1,-12,5,-3,-1,4,-1,0,0,-1,-1,-1,1,6,-1
KR_6757386272,420,-3,-107,-35,-2,2,1,3,-3,4,1,-2,2,0,0,2,2,1,1,2,0,-3,12,-4,-3,7,-1,0,0,-1,0,0,1,5,-1
KR_6737649833,420,-7,-20,-124,-10,0,1,1,-4,4,0,-3,6,3,-4,5,1,1,1,2,-2,-9,-231,2,-2,0,-1,0,0,-1,-1,-1,-1,4,-1
KR_6742307910,420,-1,-28,50,-10,1,1,2,-1,2,1,2,3,5,-11,12,1,-1,1,0,-1,-7,-3,-5,-3,8,3,0,0,-1,-1,-1,-1,6,-1
KR_6741006285,420,-9,-106,-71,-15,-3,3,0,-1,3,2,-10,12,2,0,3,3,-1,2,1,-2,-3,-37,1,-4,3,-2,0,-3,-1,-1,-1,-1,5,-1
KR_6716084636,420,-1,8,-13,-5,1,5,6,-6,6,0,-1,1,0,3,1,4,-2,2,0,0,1,8,-2,-2,4,5,0,2,-1,1,1,-1,5,-1
KR_6733719300,420,0,-32,0,-1,-1,2,1,-2,3,1,0,1,1,1,1,2,1,1,2,0,-1,20,0,-3,3,-5,0,0,-1,-1,0,-1,4,-1
KR_6195918411,420,1,-33,12,-1,-1,3,2,0,2,2,2,2,4,-2,2,0,0,0,0,0,3,-3,2,-8,6,2,0,-1,0,-1,-1,-1,0,-1
KR_6737174607,440,-4,-68,-30,-6,-1,2,1,1,1,2,-1,2,1,-2,4,2,-3,3,0,1,-4,0,3,-8,5,-1,0,-2,1,-1,-1,1,6,-1
KR_6646494425,420,-6,5,-24,-10,-2,2,0,-5,7,2,-2,4,2,2,0,2,-3,4,1,0,-11,2,3,-6,3,-1,0,0,-1,1,0,-1,4,-1
KR_6627443086,420,1,-6,-8,2,-2,4,2,-1,2,1,1,1,2,1,0,1,3,2,5,0,3,-6,-3,-4,7,2,0,-1,-1,-1,-1,1,6,-1
KR_6758064958,420,2,-52,0,-1,0,2,2,0,2,2,-1,5,4,3,0,3,-3,3,0,0,2,-9,1,-6,5,-1,0,0,0,-1,0,1,0,-1
KR_6763327522,440,-2,3,6,-3,3,0,3,5,1,6,0,1,1,-10,11,1,-1,2,1,-2,-7,160,0,-3,3,1,0,0,1,0,0,-1,2,-1
KR_6690932184,440,-1,-29,23,-3,0,2,2,2,2,4,-1,3,2,-5,5,0,1,0,1,-1,-7,33,-5,-1,6,-24,0,0,-1,1,1,-1,6,-1
KR_6635431758,420,-5,-25,-44,-9,3,0,3,-1,1,0,-11,14,3,2,2,4,-2,4,2,0,-3,0,-2,-1,3,-1,0,-3,-1,-1,-1,1,2,-1
KR_6752012919,420,-7,-54,6,-20,-9,9,0,-3,5,2,-4,4,0,-5,6,1,1,0,1,-1,-19,284,0,-3,3,-20,0,-2,-1,-1,-1,-1,4,-1
KR_6611684523,420,3,-22,28,5,4,1,5,0,1,1,0,2,2,1,3,4,0,1,1,0,0,4,1,-4,3,-3,0,1,1,1,1,1,2,-1
KR_6612700722,420,0,-34,-12,-5,-3,4,1,-3,4,1,1,2,3,2,1,3,-2,3,1,0,-5,3,4,-4,0,0,0,1,1,1,1,1,5,-1
KR_6648572508,440,1,-9,14,-1,-4,6,2,1,2,3,-1,6,5,1,4,5,2,1,3,0,3,2,2,-4,2,0,0,0,0,0,0,-1,0,-1
KR_6722608873,420,1,41,4,-2,1,1,2,2,3,5,-2,4,2,0,1,1,-3,7,4,0,4,13,5,-5,0,3,0,0,1,-1,0,-1,4,-1
KR_6721311499,420,-1,-37,-28,-4,-1,1,0,-2,5,3,-1,2,1,1,0,1,-1,1,0,0,-2,7,-1,-2,3,-5,0,0,1,1,1,-1,2,-1
KR_6745750684,420,-1,36,18,-11,0,1,1,-4,5,1,-1,3,2,-2,4,2,-4,7,3,2,-8,-2,-3,-1,4,-4,0,0,0,0,-1,1,0,-1
KR_6741146325,440,-5,-75,-16,-11,-4,5,1,-1,3,2,-2,7,5,-8,9,1,4,1,5,0,-6,-17,-4,-2,6,-2,0,-1,-1,-1,-1,-1,1,-1
KR_6200091535,420,0,-66,3,3,1,1,2,0,2,2,1,3,4,1,2,3,0,0,0,0,3,-6,-3,-2,5,0,0,-2,-1,-1,-1,1,4,-1
KR_6712041066,420,-3,-35,-18,1,-1,2,1,-6,8,2,1,1,2,2,3,5,5,1,6,0,15,-7,0,-4,4,-1,0,1,0,0,1,-1,0,-1
KR_6626869912,420,-2,38,-12,1,4,2,6,-2,2,0,4,0,4,-6,6,0,1,0,1,0,-8,-2,-2,-4,6,-1,0,0,1,0,1,1,6,-1
KR_6755536473,420,-4,-59,8,-10,-1,2,1,-1,2,1,-1,2,1,-8,8,0,1,1,2,0,-11,1,1,-3,2,-4,0,-1,-1,1,-1,1,6,-1
KR_6732472695,420,2,1,16,10,1,0,1,1,0,1,4,1,5,4,2,6,0,1,1,0,20,-3,0,-3,3,4,0,1,1,1,1,1,5,-1
KR_6737669765,420,-8,-107,-24,-12,-2,3,1,-6,8,2,-3,5,2,0,2,2,-1,2,1,-1,-10,40,-1,-2,3,-14,0,-1,-1,0,-1,-1,4,-1
KR_6696455857,420,-2,-22,-28,3,-1,3,2,0,4,4,-4,5,1,3,0,3,5,0,5,2,6,13,-7,-1,8,-2,0,0,0,-1,-1,1,0,-1
KR_6737450908,420,-3,-31,-7,-6,0,1,1,-5,8,3,0,0,0,2,1,3,-3,4,1,-1,-4,1,0,-5,5,-2,0,0,1,-1,0,-1,4,-1
KR_6762499179,420,-2,-5,16,-10,-1,2,1,-4,7,3,0,3,3,-1,2,1,-4,4,0,0,-6,-2,-4,-2,6,-3,0,-2,0,0,-1,-1,0,-1
KR_6685816695,420,-3,69,24,1,0,0,0,1,1,2,0,0,0,1,0,1,-1,3,2,0,-4,-43,-2,-2,4,5,0,1,-1,0,1,1,6,-1
KR_6747273700,420,-5,-12,-3,-14,0,2,2,-1,3,2,-7,9,2,-6,6,0,0,2,2,0,-11,1,-5,-1,6,-3,0,0,-1,-1,0,-1,4,-1
KR_6762552419,420,-1,-87,-2,0,2,0,2,1,4,5,-2,5,3,0,2,2,-1,1,0,0,7,-35,-1,-2,3,0,0,0,-1,-1,0,-1,3,-1
KR_6633149431,440,-4,-14,4,-9,-1,3,2,0,3,3,-4,4,0,0,2,2,-4,5,1,0,-7,-16,-4,-2,6,-1,0,-1,1,-1,-1,-1,6,-1
KR_6759998255,420,0,20,9,-3,-1,2,1,-5,5,0,2,3,5,-4,5,1,5,1,6,0,-2,-21,-2,0,2,1,0,-1,0,0,-1,-1,0,-1
KR_6762141372,420,-3,-71,-17,-7,-3,5,2,-3,3,0,1,2,3,-2,5,3,0,4,4,-1,0,11,2,-3,1,-1,0,-2,-1,-1,-1,-1,3,-1
KR_6746648349,420,-5,-110,20,-14,-1,1,0,1,0,1,-1,3,2,-4,4,0,-9,10,1,0,-10,-8,-5,0,5,1,0,-3,-1,-1,-1,-1,6,-1
KR_6696518263,420,5,152,40,12,6,2,8,-3,5,2,3,2,5,6,0,6,0,2,2,1,3,6,-1,-2,3,4,0,4,-1,0,1,1,3,-1
KR_6564530181,420,-2,-48,-3,1,1,2,3,2,2,4,-3,3,0,4,1,5,-3,3,0,0,5,2,2,-6,4,2,0,1,-1,1,1,1,6,-1
KR_6652082024,420,-1,44,-17,-5,-1,1,0,-4,4,0,0,1,1,1,2,3,-1,2,1,0,-4,2,1,-3,2,1,0,0,1,-1,0,-1,2,-1
KR_6737991467,440,-3,-58,-21,-6,2,1,3,0,1,1,-3,5,2,-4,7,3,-1,3,2,0,0,-120,-2,-2,4,-1,0,0,-1,-1,-1,1,4,-1
KR_6671497263,440,-3,-42,-14,-5,1,1,2,-6,6,0,-2,2,0,1,0,1,1,0,1,0,-1,5,-4,-4,8,-6,0,-2,-1,-1,-1,1,3,-1
KR_6658419273,440,-4,-12,-24,-12,-3,3,0,-4,5,1,-2,3,1,-2,2,0,-1,2,1,0,-12,0,0,-2,2,0,0,0,-1,-1,0,-1,3,-1
KR_6761397706,420,1,-10,-4,-2,0,1,1,-3,7,4,2,1,3,-4,7,3,3,1,4,0,-1,-1,2,-4,2,-3,0,0,0,-1,1,1,0,-1
KR_6698256619,420,0,-19,16,1,2,2,4,-5,8,3,3,0,3,-2,3,1,3,0,3,0,0,-3,-2,-3,5,3,0,0,1,-1,-1,-1,4,-1
KR_6620199164,420,2,-43,-23,4,2,1,3,3,2,5,-1,3,2,1,2,3,-1,5,4,0,4,-12,-1,-3,4,4,0,0,1,1,1,-1,3,-1
KR_6763316146,420,-1,21,-16,-2,-4,4,0,1,2,3,-1,4,3,1,4,5,1,2,3,0,-5,-246,4,-6,2,1,0,-2,1,-1,-1,1,4,-1
KR_6717543173,440,0,-99,15,-5,0,5,5,1,3,4,-7,7,0,0,5,5,1,1,2,0,-1,8,-1,-5,6,-8,0,-1,0,0,-1,1,0,-1
KR_6685157745,420,-1,-32,-4,-3,5,0,5,-2,3,1,-1,1,0,-2,5,3,-3,3,0,0,-5,4,3,-6,3,0,0,-2,-1,-1,-1,1,2,-1
KR_6619063552,420,-2,-4,-12,-9,2,1,3,-11,13,2,-1,1,0,-1,2,1,2,0,2,0,-8,-22,-2,-3,5,0,0,-1,1,-1,-1,1,3,-1
KR_6764228174,440,0,4,4,0,1,1,2,-2,3,1,2,2,4,-1,1,0,0,0,0,0,-3,-1,-3,-1,4,-2,0,0,0,0,0,1,0,-1
KR_6762942415,420,1,-48,-8,-3,-5,7,2,-3,5,2,4,3,7,-1,1,0,2,0,2,0,-2,116,3,-4,1,0,0,0,-1,-1,-1,1,6,-1
KR_6713184138,420,-4,-16,5,-11,-8,8,0,-2,7,5,-2,3,1,1,1,2,0,1,1,-1,-2,0,-2,-3,5,2,0,1,1,-1,-1,1,5,-1
KR_6752206658,420,-1,14,-8,0,3,0,3,-3,5,2,2,3,5,-1,3,2,-1,2,1,0,4,-3,0,-3,3,1,0,1,1,1,1,-1,4,-1
KR_6631663106,420,-5,4,-23,-11,-4,4,0,-1,3,2,-2,4,2,-7,8,1,3,1,4,-1,-11,-330,-3,-3,6,-4,0,-1,-1,-1,-1,1,5,-1
KR_6658731463,420,0,55,-4,-5,3,0,3,-2,4,2,-1,2,1,-3,3,0,-2,2,0,0,-5,-3,-1,-4,5,0,0,-1,-1,-1,-1,-1,3,-1
KR_6761419354,420,-1,-13,0,-1,-1,2,1,2,4,6,-2,3,1,-1,1,0,1,0,1,0,1,-32,-1,-3,4,2,0,1,1,1,1,1,5,-1
KR_6625853000,420,-4,3,-34,-5,-2,3,1,1,1,2,2,0,2,-3,5,2,-3,3,0,0,-6,-5,2,-3,1,2,0,-1,0,-1,-1,-1,0,-1
KR_6720773093,440,-4,-21,-40,-5,1,2,3,-2,3,1,-3,9,6,-1,2,1,0,3,3,1,-3,-3,-2,-2,4,-3,0,-1,-1,-1,-1,1,3,-1
KR_6762923166,420,3,-1,13,7,4,0,4,2,6,8,1,2,3,0,2,2,0,0,0,0,9,-4,1,-3,2,0,0,-1,-1,-1,-1,-1,4,-1
KR_6738745820,420,1,31,4,-3,0,2,2,4,1,5,-8,9,1,1,3,4,0,0,0,-1,6,212,-2,0,2,2,0,-1,-1,-1,-1,-1,5,-1
KR_6753870358,420,0,-22,-8,5,-1,1,0,-3,4,1,2,2,4,5,1,6,2,1,3,1,14,7,4,-4,0,-1,0,0,1,-1,-1,1,2,-1
KR_6241704768,420,-2,-10,-23,5,2,1,3,1,2,3,-5,6,1,6,2,8,1,0,1,0,10,4,1,-8,7,0,0,-1,-1,-1,-1,1,5,-1
KR_6740126415,420,-1,6,-10,1,2,1,3,-2,4,2,-1,2,1,0,3,3,2,0,2,0,4,-48,3,-6,3,-4,0,0,1,-1,-1,1,3,-1
KR_6709780810,440,0,-75,-28,1,-3,4,1,4,0,4,-3,7,4,4,1,5,-1,1,0,-1,8,4,1,-2,1,-2,0,-1,1,-1,-1,-1,5,-1
KR_6757621023,420,-1,7,4,-5,-2,3,1,-4,6,2,0,3,3,1,1,2,0,1,1,0,-4,116,4,-5,1,1,0,0,-1,1,0,1,4,-1
KR_6750547011,420,-2,0,16,-3,1,0,1,0,3,3,-3,3,0,1,2,3,-2,2,0,1,-1,-3,-3,-3,6,2,0,0,-1,0,0,1,2,-1
KR_6755780037,420,-2,-36,-12,-6,-2,3,1,3,2,5,-2,4,2,-3,4,1,-2,2,0,0,-5,2,-2,-1,3,1,0,0,-1,1,0,-1,5,-1
KR_6759253335,420,-5,3,-25,-9,-2,4,2,-5,5,0,-3,3,0,0,3,3,1,0,1,0,-10,1,-3,0,3,1,0,0,-1,-1,0,-1,6,-1
KR_6122445933,440,-8,-73,-94,-20,0,2,2,-1,3,2,-3,6,3,-13,15,2,-3,3,0,-1,-24,13,-8,-1,9,-3,0,-1,0,0,-1,-1,0,-1
KR_6504504353,420,-3,41,0,-4,2,0,2,-3,5,2,1,2,3,-1,2,1,-3,3,0,0,-7,8,0,-3,3,-2,0,1,-1,1,1,1,4,-1
KR_6750058016,440,-3,-29,-71,1,2,0,2,3,1,4,-6,7,1,2,2,4,0,0,0,0,8,-3,-1,-3,4,-1,0,-2,-1,-1,-1,1,4,-1
KR_6752337421,440,-1,-67,-28,-6,-2,3,1,2,1,3,-1,4,3,-5,6,1,0,0,0,0,0,-6,2,-8,6,-4,0,-1,-1,0,-1,-1,5,-1
KR_6761032219,420,-2,-54,12,0,2,1,3,0,2,2,2,1,3,-4,4,0,0,0,0,0,-3,31,0,-2,2,-2,0,0,1,0,0,1,4,-1
KR_6674435432,420,0,13,4,-7,0,1,1,-3,4,1,-2,2,0,-1,2,1,-1,1,0,0,-9,-4,-1,-3,4,4,0,0,1,1,0,-1,5,-1
KR_6731404970,420,-3,-52,-7,-6,-2,2,0,0,0,0,3,2,5,-5,7,2,-2,3,1,0,-10,-15,0,-3,3,-1,0,1,-1,1,1,1,6,-1
KR_6719312374,420,0,50,-25,2,2,1,3,-2,4,2,-1,6,5,5,0,5,-2,3,1,0,-2,-328,-3,0,3,1,0,0,-1,-1,-1,1,3,-1
KR_6757084335,420,-1,3,1,-13,3,1,4,-9,9,0,-3,4,1,-4,7,3,0,1,1,0,-25,3,3,-8,5,5,0,-2,-1,-1,-1,1,2,-1
KR_6710453018,420,2,17,24,6,4,0,4,-1,3,2,5,0,5,-2,2,0,0,2,2,0,5,33,0,-1,1,0,0,0,-1,1,1,1,5,-1
KR_6702009783,420,-6,-37,19,-13,0,5,5,-1,3,2,-6,6,0,-6,9,3,0,0,0,0,-13,23,-3,-4,7,-8,0,-3,-1,-1,-1,1,3,-1
KR_6636374242,440,1,-10,0,2,-1,4,3,0,5,5,7,0,7,-3,4,1,-1,1,0,0,-7,-19,0,-5,5,-5,0,0,1,-1,-1,1,4,-1
KR_6750843691,420,1,29,4,2,2,0,2,-1,4,3,0,1,1,2,3,5,-1,3,2,0,5,-5,0,-3,3,-2,0,0,0,1,0,1,0,-1
KR_6730512128,440,-2,-31,4,-7,-1,1,0,-1,3,2,0,2,2,-4,6,2,-1,2,1,0,-5,19,5,-7,2,-5,0,1,-1,1,1,-1,4,-1
KR_6751248827,440,1,8,-26,0,1,0,1,-3,3,0,-4,6,2,1,1,2,5,0,5,-1,-4,-3,2,-3,1,-1,0,1,1,1,1,-1,3,-1
KR_6625697080,440,-3,-121,8,-6,-3,5,2,-5,6,1,1,0,1,0,1,1,1,1,2,0,-4,-4,-1,-1,2,1,0,-1,1,-1,-1,-1,6,-1
KR_6739801471,440,-6,-70,-15,-11,-6,7,1,-4,4,0,-1,2,1,-1,5,4,1,0,1,0,-7,-9,2,-3,1,3,0,0,0,0,0,1,0,-1
KR_6760644890,420,2,60,-9,2,-1,2,1,4,2,6,0,1,1,-2,3,1,1,0,1,2,9,3,1,-3,2,5,0,0,1,1,0,1,6,-1
KR_6638653005,420,0,55,-27,-6,3,0,3,-1,2,1,-6,7,1,-1,1,0,-1,2,1,0,-12,1,-3,-1,4,3,0,0,0,-1,1,1,0,-1
KR_6759254302,420,-8,-77,-40,-13,-2,4,2,-6,6,0,2,3,5,-2,4,2,-5,5,0,-1,-13,-1,-2,-3,5,0,0,-1,-1,0,-1,-1,2,-1
KR_6747181393,420,-1,-95,-9,-2,-2,2,0,3,0,3,0,2,2,-4,4,0,1,0,1,0,1,-365,0,-6,6,-3,0,-1,1,-1,-1,-1,2,-1
KR_6738205228,420,-1,-54,-12,-1,4,2,6,-4,6,2,1,1,2,-3,4,1,1,0,1,0,-10,-5,1,-2,1,-2,0,0,1,1,1,1,5,-1
KR_6744964573,420,0,28,0,-3,-3,3,0,0,4,4,0,0,0,-5,7,2,5,1,6,-1,-5,-24,-4,-3,7,4,0,1,-1,-1,1,-1,1,-1
KR_6593611411,420,0,-30,-12,-5,-3,4,1,-3,7,4,1,2,3,-1,1,0,1,0,1,0,-5,-30,3,-6,3,4,0,-2,-1,1,-1,-1,3,-1
KR_6751941429,420,-3,-36,-8,-5,-5,5,0,-2,3,1,0,3,3,1,2,3,1,3,4,2,3,9,-4,-1,5,1,0,-1,1,-1,-1,1,1,-1
KR_6725216363,420,-3,-91,-21,-11,-12,12,0,2,2,4,-2,3,1,-1,2,1,2,2,4,0,2,4,0,-3,3,0,0,-3,0,-1,-1,-1,0,-1
KR_6686656295,420,-4,3,-20,-11,-1,1,0,-4,6,2,-2,4,2,-1,3,2,-3,3,0,0,-8,2,0,-3,3,-5,0,0,-1,-1,0,1,2,-1
KR_6628201615,420,1,41,0,-1,1,2,3,-3,5,2,1,2,3,-1,1,0,1,2,3,0,-2,-1,-2,0,2,-2,0,1,1,1,1,-1,6,-1
KR_6694183731,420,-7,-33,-120,-6,-1,2,1,-4,4,0,0,3,3,-1,2,1,0,3,3,0,-12,-4,1,-2,1,0,0,-1,-1,-1,-1,-1,6,-1
KR_6764260714,420,1,38,19,-7,1,0,1,-6,8,2,0,1,1,0,3,3,-2,2,0,-2,-13,-5,-5,-3,8,-1,0,1,-1,1,1,-1,1,-1
KR_6751726323,420,-4,-30,-92,-12,-5,5,0,-3,4,1,-1,5,4,-5,6,1,2,3,5,0,-6,16,-3,-2,5,-3,0,-1,-1,-1,-1,-1,4,-1
KR_6741342732,420,-2,-11,5,-4,-4,4,0,1,1,2,-1,3,2,1,3,4,-1,2,1,-2,-4,-2,-1,-4,5,2,0,-1,1,1,-1,-1,3,-1
KR_6732380775,420,-4,-91,-2,-10,-4,4,0,0,1,1,0,1,1,-5,6,1,-1,2,1,0,-13,2,1,-3,2,-2,0,-3,-1,-1,-1,-1,6,-1
KR_6760029124,420,0,-72,28,-5,1,1,2,-4,8,4,2,0,2,-2,4,2,-2,2,0,0,-3,2,0,-5,5,-4,0,-2,0,-1,-1,-1,0,-1
KR_5804946294,420,-4,-69,-17,-13,2,3,5,-6,7,1,-8,8,0,2,2,4,-3,4,1,-1,-24,-112,-5,-2,7,0,0,-3,-1,-1,-1,-1,4,-1
KR_6748064312,420,-3,-5,-16,-6,-2,3,1,-4,4,0,-2,3,1,0,3,3,2,0,2,0,-3,2,-4,-4,8,1,0,0,-1,-1,0,-1,4,-1
KR_6729991700,420,-1,-42,13,-10,2,1,3,-4,4,0,-9,9,0,-2,4,2,3,2,5,-1,-10,41,-6,0,6,-17,0,0,-1,-1,-1,-1,6,-1
KR_6682656012,420,-8,-84,-5,-18,-3,4,1,-3,4,1,-4,6,2,-8,10,2,0,2,2,0,-10,5,-1,-3,4,-1,0,-1,-1,0,-1,-1,2,-1
KR_6732208654,420,-3,-21,-13,-6,0,5,5,-2,3,1,-2,3,1,-2,3,1,0,1,1,0,-3,-119,4,-4,0,-2,0,-1,-1,0,-1,-1,5,-1
KR_6732876321,420,-1,6,-23,-8,-2,3,1,1,2,3,-5,5,0,0,4,4,-2,3,1,-1,-14,392,-5,-1,6,4,0,-1,-1,1,-1,-1,3,-1
KR_6759180155,440,-9,-83,-20,-24,-1,2,1,-2,5,3,-6,7,1,-11,12,1,-4,4,0,0,-23,-38,4,-6,2,12,0,-2,-1,1,-1,-1,1,-1
KR_6757531489,420,-1,51,25,-6,-1,3,2,-1,4,3,-3,5,2,1,0,1,-2,2,0,0,2,-17,1,-4,3,2,0,0,1,-1,-1,-1,1,-1
KR_6593701462,420,0,-52,-25,-3,2,1,3,3,1,4,-6,7,1,-4,6,2,2,1,3,0,-1,4,-2,-2,4,1,0,-1,-1,-1,-1,1,2,-1
KR_6625662584,420,-2,-29,-12,4,0,0,0,-4,6,2,2,1,3,4,4,8,2,2,4,0,4,-27,-1,-2,3,14,0,0,-1,1,1,-1,4,-1
KR_6763059732,420,2,-11,-31,0,-1,2,1,-2,4,2,4,1,5,-1,2,1,0,0,0,0,1,19,1,-2,1,-2,0,0,1,-1,0,-1,4,-1
KR_6693616912,420,-3,-56,5,-6,0,2,2,-1,3,2,-5,5,0,-1,2,1,1,1,2,0,-4,-7,-3,-4,7,-1,0,-1,-1,-1,-1,1,1,-1
KR_6748341842,420,-1,-9,28,-5,-2,3,1,5,1,6,-4,4,0,-3,4,1,-1,1,0,0,-2,-1,2,-5,3,5,0,0,1,1,0,-1,5,-1
KR_6752904065,440,-1,-18,8,5,-3,3,0,3,1,4,9,0,9,-4,5,1,0,0,0,0,4,3,-6,-1,7,3,0,0,-1,1,-1,1,3,-1
KR_6653674923,420,0,-5,-4,-2,2,1,3,0,2,2,1,1,2,-2,5,3,-3,3,0,0,-4,1,4,-5,1,0,0,0,-1,0,0,1,1,-1
KR_6686032050,420,1,22,-23,3,-3,3,0,0,2,2,1,1,2,4,1,5,1,0,1,0,6,10,-1,-3,4,3,0,-1,-1,-1,-1,1,2,-1
KR_6080562128,420,-6,-83,-6,-21,4,1,5,-8,9,1,2,1,3,-18,21,3,-1,2,1,0,-14,11,0,-2,2,-1,0,-2,0,0,1,-1,0,-1
KR_6716673508,420,-4,-46,-32,-4,-2,3,1,-5,5,0,1,5,6,0,1,1,2,0,2,1,-2,28,-1,-3,4,-2,0,0,-1,0,0,1,6,-1
KR_6648029179,420,2,71,3,5,1,1,2,0,2,2,0,2,2,2,0,2,2,2,4,0,4,8,-1,-2,3,-1,0,2,1,1,1,1,4,-1
KR_6623768506,420,-2,1,-34,-4,-2,2,0,5,2,7,-3,3,0,-2,5,3,-2,2,0,0,-4,0,4,-6,2,-4,0,-1,-1,1,-1,1,6,-1
KR_6688916380,420,1,-22,-9,0,2,0,2,-1,4,3,-3,5,2,2,0,2,0,2,2,0,-2,7,2,-3,1,-5,0,-1,1,0,-1,1,5,-1
KR_6755755753,420,-2,-46,12,-6,-2,4,2,-3,3,0,5,1,6,-5,7,2,-1,1,0,0,-7,1,0,-3,3,0,0,-1,1,1,-1,1,5,-1
KR_6649780996,420,1,-14,-20,-2,1,3,4,-5,5,0,0,3,3,1,2,3,1,0,1,0,1,-6,-2,-3,5,0,0,1,1,0,1,-1,6,-1
KR_6754957658,420,-4,-8,-28,-13,-2,3,1,-5,5,0,0,5,5,-4,7,3,-2,2,0,0,-8,-3,4,-6,2,1,0,-1,-1,-1,-1,-1,5,-1
KR_6703849148,440,-3,5,7,-5,-3,3,0,3,2,5,-1,4,3,-4,5,1,0,0,0,0,-3,-16,-2,-2,4,7,0,-2,1,-1,-1,-1,5,-1
KR_6729454407,420,-1,-12,24,-7,-4,6,2,0,0,0,-4,8,4,2,1,3,-1,2,1,-1,5,4,1,-2,1,1,0,-1,1,-1,-1,-1,5,-1
KR_6697849687,420,-5,-51,-10,-16,-3,3,0,-2,4,2,-4,5,1,1,0,1,-8,9,1,-2,-9,-13,0,-2,2,-2,0,-3,-1,-1,-1,-1,3,-1
KR_6762107806,420,0,-63,-20,-6,-4,5,1,5,0,5,-4,6,2,-3,5,2,0,1,1,0,-9,257,1,-2,1,-3,0,-1,1,1,-1,1,6,-1
KR_6761871598,440,-7,-112,-28,-14,-3,5,2,-3,4,1,-1,8,7,-7,8,1,0,0,0,-3,-10,6,2,-5,3,1,0,-1,0,1,-1,-1,0,-1
KR_6678327105,420,-7,-92,-1,-12,-3,4,1,-1,4,3,-3,4,1,-3,4,1,-2,2,0,0,-12,25,0,-3,3,-2,0,-1,-1,0,-1,-1,5,-1
KR_6761658611,420,-2,-45,-4,-7,-1,2,1,-2,3,1,-3,5,2,1,5,6,-2,3,1,1,-2,2,0,-2,2,-1,0,-1,-1,-1,-1,1,2,-1
KR_6731383803,420,-4,-30,-28,-7,6,0,6,-1,6,5,-2,2,0,-5,6,1,-5,7,2,0,-11,-31,1,-7,6,-4,0,-1,-1,-1,-1,-1,1,-1
KR_6684269236,420,3,-34,28,11,2,2,4,4,0,4,1,4,5,1,0,1,3,2,5,0,12,-46,5,-9,4,-11,0,1,-1,1,1,1,4,-1
KR_6388442210,420,-1,-46,5,5,2,1,3,0,2,2,1,0,1,1,2,3,1,0,1,0,2,-90,1,-4,3,1,0,1,-1,-1,1,1,2,-1
KR_6761247173,420,-3,-23,-25,-3,2,1,3,0,2,2,-3,5,2,-3,4,1,1,0,1,0,-6,8,4,-6,2,1,0,1,-1,1,1,-1,4,-1
KR_6197577645,420,0,12,-23,-1,-3,4,1,-2,2,0,2,0,2,4,1,5,-2,2,0,0,3,2,2,-6,4,-2,0,-2,-1,-1,-1,1,1,-1
KR_6694017847,420,-2,-117,-20,-1,0,0,0,-1,2,1,0,1,1,-1,4,3,1,2,3,-1,-3,8,1,-2,1,-10,0,0,-1,0,-1,-1,3,-1
KR_6694424377,420,-1,-59,8,-1,-2,4,2,2,0,2,-2,2,0,2,0,2,-1,1,0,0,1,-5,-1,-4,5,-1,0,0,1,0,-1,-1,4,-1
KR_6745656649,420,-4,-77,-7,-6,-1,3,2,-4,5,1,-1,6,5,-1,5,4,1,1,2,1,2,148,-2,-3,5,-2,0,0,-1,0,-1,1,2,-1
KR_6605181483,420,-1,18,-8,2,2,1,3,2,1,3,-6,6,0,4,0,4,0,0,0,0,6,3,3,-4,1,-3,0,0,-1,-1,-1,-1,4,-1
KR_6706348519,440,-5,-55,-12,-6,-1,1,0,4,1,5,-1,3,2,-6,7,1,-2,2,0,0,-10,221,2,-3,1,-1,0,-1,1,-1,-1,-1,6,-1
KR_6682540524,420,-4,-30,-6,-7,0,2,2,1,2,3,-4,10,6,-3,6,3,-1,2,1,0,-4,-6,2,-4,2,0,0,-1,-1,-1,-1,1,1,-1
KR_6739773598,420,-5,-121,-36,-4,-4,4,0,2,2,4,-2,2,0,1,2,3,-1,1,0,2,4,51,3,-8,5,-4,0,0,0,-1,-1,1,0,-1
KR_6661750846,420,-2,-50,3,-6,-3,3,0,-2,3,1,-1,5,4,-1,4,3,1,0,1,0,-4,12,0,-6,6,-4,0,1,0,1,1,-1,0,-1
KR_5665557748,420,1,37,0,-3,0,1,1,-4,6,2,1,6,7,0,2,2,0,0,0,0,-11,20,-9,-1,10,3,0,1,-1,1,1,-1,6,-1
KR_6761639819,420,-4,-56,-12,-10,1,4,5,0,2,2,0,3,3,-4,6,2,-7,8,1,0,-13,3,0,-1,1,0,0,-2,-1,-1,-1,-1,5,-1
KR_6739013028,420,1,15,-3,4,-4,6,2,3,0,3,8,2,10,-4,6,2,1,0,1,0,-5,8,-1,-1,2,-1,0,-1,1,-1,-1,1,5,-1
KR_6619298031,420,-5,-66,-27,-14,1,2,3,-5,6,1,-2,5,3,-7,7,0,-1,1,0,0,-12,306,-2,-6,8,4,0,-2,-1,-1,-1,-1,6,-1
KR_6650900186,420,-2,9,15,0,2,1,3,-2,7,5,-3,5,2,0,4,4,3,0,3,1,7,-1,5,-6,1,-1,0,0,1,-1,1,1,4,-1
KR_6734057918,420,-4,-106,-16,-8,-1,2,1,1,1,2,-2,4,2,-5,5,0,-1,1,0,-1,-8,-144,0,-4,4,1,0,-1,-1,1,-1,-1,2,-1
KR_6666918985,420,0,-30,16,3,-2,3,1,3,1,4,-2,3,1,4,0,4,0,1,1,1,7,-7,-1,-3,4,-1,0,0,-1,1,0,1,2,-1
KR_6706340389,420,1,-83,25,-5,3,1,4,1,0,1,-1,2,1,-5,5,0,-3,3,0,0,-7,-2,0,-2,2,-1,0,-3,1,-1,-1,-1,3,-1
KR_6755098964,420,2,-108,29,0,-2,2,0,-1,1,0,2,3,5,0,3,3,1,1,2,0,-2,3,-4,-3,7,-2,0,-1,-1,-1,-1,-1,5,-1
KR_6761592683,440,0,1,-24,2,1,0,1,0,2,2,0,3,3,1,3,4,0,1,1,0,3,-6,2,-5,3,-5,0,0,-1,0,0,1,6,-1
KR_6621767588,440,4,52,-8,9,2,0,2,8,1,9,-2,4,2,0,3,3,1,0,1,0,15,43,1,-4,3,-36,0,0,-1,1,-1,1,2,-1
KR_6726545574,420,-3,-92,-11,-7,-3,3,0,-3,3,0,-1,5,4,-1,1,0,1,0,1,0,-5,-33,2,-3,1,-3,0,-1,-1,1,-1,-1,6,-1
KR_6667560480,420,-3,-4,23,-2,1,2,3,3,0,3,-1,3,2,-3,7,4,-2,3,1,0,2,-37,-9,-1,10,3,0,-1,1,1,-1,1,5,-1
KR_6758907663,420,-7,-55,-4,-8,-2,4,2,2,0,2,-1,3,2,-3,3,0,-4,5,1,-1,-5,-24,-4,0,4,0,0,-2,0,0,-1,-1,0,-1
KR_6749140944,420,0,52,-3,4,-3,4,1,0,1,1,2,1,3,5,0,5,0,0,0,0,1,-7,0,-2,2,-3,0,0,-1,1,0,1,6,-1
KR_6761149576,440,1,43,8,8,-1,1,0,4,1,5,-1,2,1,4,1,5,2,0,2,1,5,8,-4,-1,5,4,0,-1,1,-1,-1,1,5,-1
KR_6722977092,420,-1,-75,4,1,-1,2,1,1,2,3,-1,1,0,1,1,2,1,1,2,0,-1,-1,-1,-1,2,2,0,-1,1,-1,-1,1,6,-1
KR_6707275913,420,-1,-53,-7,-3,-2,2,0,0,1,1,-4,5,1,2,1,3,1,0,1,0,0,-11,2,-3,1,-3,0,-1,0,-1,-1,-1,0,-1
KR_6732448823,420,-1,15,0,-6,3,1,4,-5,5,0,-2,2,0,-1,2,1,-1,1,0,0,-8,-6,5,-7,2,-7,0,0,-1,-1,0,1,6,-1
KR_6760975834,440,-1,40,-20,3,0,3,3,-2,2,0,1,2,3,3,0,3,1,1,2,0,7,5,-1,-4,5,-4,0,-1,0,0,-1,1,0,-1
KR_6716973084,420,-1,21,-12,-4,4,2,6,-5,6,1,3,0,3,-4,7,3,-2,2,0,1,-10,347,-2,-1,3,0,0,1,0,1,1,1,0,-1
KR_6717160573,420,0,32,24,-6,3,1,4,1,3,4,0,0,0,-6,9,3,-4,5,1,0,-5,0,-2,0,2,2,0,0,-1,0,1,-1,1,-1
KR_6642337155,420,0,17,11,-3,0,1,1,0,3,3,1,4,5,-3,3,0,-1,2,1,0,-3,0,3,-5,2,-1,0,-2,-1,-1,-1,1,4,-1
KR_6650871877,420,-3,36,-23,-6,3,1,4,0,3,3,-8,8,0,-2,3,1,1,1,2,1,-10,18,3,-4,1,-2,0,-1,-1,1,-1,1,2,-1
KR_6752375504,420,3,74,0,5,4,0,4,1,1,2,1,1,2,1,5,6,-2,2,0,0,3,-6,-4,-2,6,1,0,1,-1,-1,1,-1,4,-1
KR_6649048262,420,-6,-31,4,-15,-3,3,0,-6,7,1,-1,2,1,-7,8,1,2,0,2,0,-27,5,0,-4,4,-3,0,0,-1,1,-1,1,4,-1
KR_6763510751,420,-2,-11,20,-8,-1,5,4,-5,7,2,1,1,2,-2,4,2,-1,3,2,1,-6,-3,-4,-1,5,1,0,0,0,0,0,-1,0,-1
KR_6739160251,420,1,57,39,-3,-4,4,0,0,1,1,-1,3,2,3,1,4,-1,2,1,0,-1,-34,-3,-1,4,35,0,0,-1,1,1,-1,4,-1
KR_6758302979,440,0,72,40,2,3,0,3,-5,8,3,3,1,4,2,3,5,-1,1,0,0,-10,-7,-5,-2,7,6,0,-1,0,0,-1,1,0,-1
KR_6764694261,440,0,55,15,-4,0,1,1,-3,4,1,2,1,3,-3,3,0,0,0,0,0,-4,10,2,-5,3,-1,0,1,1,1,1,1,3,-1
KR_6734034043,420,-5,-86,-13,-13,-2,2,0,-3,5,2,-5,5,0,-4,4,0,1,1,2,0,-10,-19,-2,-3,5,1,0,-3,-1,-1,-1,-1,6,-1
KR_6743306423,440,-2,39,-18,3,2,1,3,-5,8,3,3,3,6,-2,7,5,5,0,5,0,-8,-31,0,-7,7,0,0,2,-1,1,1,-1,6,-1
KR_6273664996,420,5,2,8,7,3,0,3,-4,5,1,3,5,8,2,2,4,3,0,3,0,7,10,4,-6,2,1,0,0,1,1,1,-1,4,-1
KR_6749063704,420,2,-13,40,-5,3,1,4,2,4,6,-3,3,0,-6,8,2,-1,2,1,0,-16,1,4,-7,3,-3,0,0,0,1,1,-1,0,-1
KR_6751144724,420,1,-19,-16,8,-2,2,0,-2,3,1,4,1,5,9,2,11,-1,1,0,0,16,-11,-1,-3,4,3,0,0,0,-1,1,-1,0,-1
KR_6526866745,420,1,-11,-8,-1,4,2,6,-2,7,5,2,2,4,-4,6,2,-1,1,0,0,-2,-9,3,-4,1,-1,0,1,-1,-1,1,-1,1,-1
KR_6757364488,420,-3,-48,0,-3,-5,6,1,1,0,1,4,2,6,-2,2,0,-1,1,0,0,-6,-16,6,-6,0,0,0,-1,1,-1,-1,1,3,-1
KR_6760498699,420,2,-4,40,-8,3,0,3,2,0,2,-7,7,0,-5,7,2,-1,2,1,0,0,3,5,-5,0,-2,0,1,0,-1,1,-1,0,-1
KR_6760245043,420,-4,-51,-8,-11,-2,3,1,-4,4,0,-1,2,1,-4,4,0,0,0,0,0,-7,2,-2,-4,6,-7,0,-1,-1,0,-1,-1,2,-1
KR_6694799067,420,-5,-10,-28,-7,-4,5,1,1,1,2,3,0,3,-8,8,0,1,2,3,0,-7,1,3,-4,1,-5,0,-1,-1,0,1,-1,2,-1
KR_6731676860,440,-1,34,12,1,-3,3,0,-1,3,2,3,2,5,1,4,5,1,2,3,0,5,-3,-1,-1,2,0,0,1,0,0,1,-1,0,-1
KR_6736326902,420,-1,-50,18,-6,3,1,4,-1,2,1,-4,4,0,-3,3,0,-1,1,0,0,-5,4,7,-8,1,3,0,-2,-1,1,-1,1,1,-1
KR_6529094404,420,-4,-10,-50,-10,2,1,3,-9,9,0,1,1,2,-2,4,2,-2,2,0,0,-4,-6,-2,-3,5,-1,0,-1,-1,-1,-1,-1,3,-1
KR_6731627627,420,-3,0,-59,-10,0,2,2,-5,6,1,-4,6,2,0,0,0,-1,1,0,0,-4,114,1,-3,2,1,0,0,-1,0,1,-1,1,-1
KR_6700298840,420,-5,-102,8,-8,-4,5,1,4,1,5,-1,1,0,-1,3,2,-6,6,0,-1,-2,-50,3,-6,3,24,0,0,1,-1,-1,-1,3,-1
KR_6717211428,420,-2,13,-15,-6,2,1,3,-2,6,4,-4,6,2,-4,5,1,2,0,2,-1,-10,23,-1,-3,4,-3,0,0,0,-1,-1,-1,0,-1
KR_6608666510,420,-2,-46,0,2,-1,1,0,5,3,8,-1,3,2,-1,3,2,0,5,5,0,-2,16,1,-3,2,1,0,1,-1,1,-1,-1,1,-1
KR_6725690967,420,-1,21,-20,-9,-1,2,1,-3,3,0,0,3,3,-3,11,8,-2,2,0,0,-12,-10,-1,-1,2,2,0,0,-1,1,-1,1,3,-1
KR_6751345486,420,-1,-1,8,-8,-7,7,0,-3,4,1,-2,3,1,3,3,6,1,1,2,-1,-9,-3,0,-1,1,-2,0,1,-1,-1,1,1,5,-1
KR_6760684512,440,1,-14,-32,3,-5,5,0,-1,4,3,3,1,4,5,2,7,1,2,3,-3,5,-17,2,-8,6,-3,0,-1,-1,-1,-1,-1,5,-1
KR_6753803241,420,1,62,-4,4,2,2,4,5,0,5,0,2,2,-3,9,6,0,0,0,0,-2,-5,-2,-4,6,2,0,0,-1,1,0,-1,2,-1
KR_6757663671,440,1,42,15,-3,-4,6,2,-5,5,0,1,2,3,3,1,4,2,0,2,0,-9,0,-4,-3,7,0,0,0,-1,1,1,1,1,-1
KR_6759459253,420,-3,20,-20,-5,-3,3,0,-3,5,2,1,1,2,-2,2,0,2,0,2,0,0,-8,3,-6,3,-4,0,1,-1,0,1,-1,3,-1
KR_6610819455,420,-5,-44,-32,-11,-7,7,0,-1,5,4,-1,2,1,-4,4,0,2,1,3,0,-4,-27,0,-2,2,1,0,-1,1,-1,-1,-1,3,-1
KR_6696994760,420,-9,-97,-11,-18,-4,4,0,-5,5,0,-7,7,0,0,1,1,-2,2,0,0,-8,-387,-2,-1,3,-5,0,-2,-1,-1,-1,-1,1,-1
KR_6736552940,420,2,12,4,0,5,0,5,2,2,4,0,1,1,-2,5,3,-5,6,1,0,-7,22,-1,-3,4,1,0,0,-1,-1,-1,-1,4,-1
KR_6764522805,420,-1,15,20,0,3,0,3,0,0,0,-1,1,0,-1,1,0,-1,1,0,0,-1,-262,-5,-1,6,-8,0,0,-1,-1,0,1,5,-1
KR_6034381270,420,-1,-44,-17,0,2,0,2,4,1,5,-3,5,2,-4,7,3,1,1,2,-1,6,1,-3,0,3,7,0,1,1,1,1,-1,4,-1
KR_6660081448,420,3,49,22,3,0,0,0,-3,4,1,4,2,6,0,2,2,2,0,2,0,2,113,0,-7,7,3,0,0,0,1,0,-1,0,-1
KR_6695130783,440,0,-44,-4,1,-2,4,2,3,3,6,5,1,6,-2,2,0,-3,3,0,0,1,2,-1,-3,4,-1,0,0,0,-1,0,1,0,-1
KR_6745553560,420,-5,-43,-8,-8,-6,6,0,1,1,2,1,3,4,-2,4,2,-2,2,0,-1,-2,-7,-2,-2,4,-3,0,-2,-1,-1,-1,-1,6,-1
KR_6762403536,420,-3,3,-39,-5,-1,5,4,-2,2,0,-3,3,0,0,2,2,1,1,2,1,-2,16,-2,-1,3,1,0,1,0,-1,1,1,0,-1
KR_6748922462,420,-1,8,-13,-4,-2,3,1,-1,5,4,1,3,4,-1,4,3,-1,2,1,1,-2,26,0,-4,4,-2,0,0,1,1,-1,1,6,-1
KR_6720479207,420,-2,-65,18,-8,-3,3,0,-3,5,2,-4,6,2,1,0,1,1,0,1,0,-8,-7,1,-2,1,-3,0,-1,1,0,-1,-1,1,-1
KR_6754846101,420,-3,-114,8,0,-3,4,1,3,1,4,-4,6,2,-1,3,2,5,0,5,2,5,-82,3,-9,6,-3,0,-2,0,1,-1,1,0,-1
KR_5539276384,420,0,1,36,-3,-1,1,0,1,2,3,-4,4,0,1,3,4,0,1,1,1,-1,10,1,-6,5,1,0,0,1,0,-1,1,1,-1
KR_6671069455,420,-1,-79,16,-3,-1,3,2,1,0,1,3,0,3,-5,7,2,-1,1,0,0,-3,10,1,-2,1,-1,0,-1,-1,1,-1,-1,4,-1
KR_6536834908,420,-2,-19,-5,-1,-2,2,0,1,0,1,2,0,2,0,2,2,-2,3,1,0,0,0,-2,-3,5,-2,0,0,-1,-1,0,-1,5,-1
KR_6758268369,440,0,14,-8,-4,0,2,2,0,2,2,1,0,1,-4,5,1,-1,3,2,0,-4,8,-2,0,2,3,0,-1,-1,1,-1,-1,5,-1
KR_6671126818,420,-1,25,5,-14,-1,1,0,-2,3,1,-2,2,0,-9,10,1,0,1,1,-1,-14,-7,-4,-2,6,-2,0,-1,0,-1,-1,-1,0,-1
KR_6728128995,440,-1,-22,-13,0,5,2,7,1,1,2,-6,6,0,0,2,2,0,2,2,0,3,14,-4,-2,6,-6,0,0,0,0,1,-1,0,-1
KR_6660105293,440,2,16,25,0,2,0,2,-8,9,1,2,2,4,2,2,4,2,0,2,0,-4,0,0,-1,1,2,0,-1,1,-1,-1,-1,3,-1
KR_6513741762,420,-5,-31,8,-6,-3,5,2,1,3,4,-2,3,1,-1,1,0,-1,1,0,-1,-7,-3,-4,-1,5,1,0,-2,-1,1,-1,-1,4,-1
KR_6762182243,420,-2,-67,-4,-6,-2,6,4,1,2,3,-1,2,1,-1,1,0,-3,3,0,0,-8,6,0,-2,2,-4,0,-1,-1,1,1,-1,4,-1
KR_6692750810,420,-2,93,-23,-4,-6,6,0,1,3,4,4,1,5,-3,3,0,0,1,1,0,-7,3,1,-5,4,-3,0,0,1,-1,0,-1,3,-1
KR_6698730524,420,-6,-95,-40,-12,-4,4,0,-2,4,2,-4,6,2,-2,4,2,0,1,1,0,0,-2,0,-4,4,4,0,-1,-1,0,-1,-1,6,-1
KR_6748636660,420,-1,-28,-21,0,-2,2,0,-1,2,1,1,1,2,2,3,5,0,2,2,0,5,-29,2,-4,2,20,0,-2,-1,-1,-1,-1,4,-1
KR_6739155152,440,-1,-25,-63,3,-3,5,2,-2,3,1,4,1,5,2,0,2,2,0,2,0,7,-6,0,-5,5,-2,0,0,0,0,0,1,0,-1
KR_6400542268,420,-1,42,16,-9,-3,3,0,3,5,8,-4,6,2,-2,7,5,-3,4,1,0,-10,-9,0,-3,3,1,0,-2,-1,0,-1,-1,6,-1
KR_6728540910,420,-1,6,-30,2,2,1,3,3,1,4,-3,4,1,1,0,1,-1,1,0,0,4,-3,-2,-2,4,3,0,1,-1,1,1,-1,4,-1
KR_6735272924,420,-5,-35,52,-14,-1,1,0,-5,6,1,-2,4,2,-1,3,2,-5,6,1,0,-17,5,-3,-3,6,-3,0,0,-1,1,0,1,3,-1
KR_6592343497,420,-1,35,16,-3,3,0,3,2,2,4,-1,4,3,-2,4,2,-5,6,1,0,-7,-127,-2,-1,3,-12,0,1,-1,1,1,-1,3,-1
KR_6734119061,420,2,-57,-4,7,0,2,2,4,1,5,1,4,5,-1,1,0,3,1,4,0,3,9,2,-6,4,-1,0,2,0,1,1,1,0,-1
KR_6752930579,420,3,20,12,3,3,1,4,3,1,4,-2,4,2,-1,1,0,0,2,2,-1,2,24,6,-6,0,-4,0,1,1,0,1,-1,5,-1
KR_6762641409,420,-1,9,0,-3,-1,1,0,-4,5,1,5,1,6,-1,2,1,-2,3,1,-1,-3,-221,4,-7,3,-1,0,0,0,-1,0,-1,0,-1
KR_6762271275,420,-1,-45,12,2,-1,1,0,2,2,4,-1,2,1,0,4,4,2,2,4,0,-2,6,0,-5,5,-4,0,0,1,-1,0,-1,1,-1
KR_6762671117,440,-2,-17,-16,-8,-5,5,0,1,0,1,2,2,4,-4,5,1,-2,5,3,-1,-5,3,2,-5,3,-4,0,0,0,-1,0,-1,0,-1
KR_6735540832,420,-1,-36,26,0,-2,4,2,-4,4,0,3,0,3,0,1,1,3,0,3,-1,-1,-41,3,-4,1,-2,0,-1,0,-1,-1,-1,0,-1
KR_6747722489,440,1,44,11,0,2,2,4,-2,9,7,-1,2,1,1,1,2,0,0,0,0,-1,3,2,-5,3,1,0,0,1,-1,0,-1,1,-1
KR_6617688508,420,-2,-37,4,-2,-2,3,1,2,1,3,-3,3,0,-3,3,0,4,1,5,0,-1,-2,-1,-6,7,0,0,0,1,-1,0,1,1,-1
KR_6754921965,420,-1,22,-13,-5,0,1,1,0,1,1,-5,5,0,-1,4,3,1,3,4,0,-5,-2,3,-8,5,1,0,-1,1,-1,-1,-1,2,-1
KR_6745889441,440,-4,-33,12,-7,-1,2,1,-3,4,1,-4,4,0,3,1,4,-2,4,2,-1,-10,8,1,-3,2,0,0,0,-1,0,-1,-1,3,-1
KR_6680602524,420,-4,-19,-42,-11,6,0,6,-1,2,1,-8,8,0,-8,8,0,0,1,1,-1,-11,-2,-2,-3,5,-4,0,-1,1,-1,-1,-1,4,-1
KR_6761780009,420,-4,-97,-23,-5,0,1,1,0,2,2,1,2,3,-4,6,2,-2,4,2,1,1,-25,-3,-2,5,-1,0,-2,0,-1,-1,1,0,-1
KR_6764286376,420,2,46,-4,-2,-6,7,1,-1,2,1,2,1,3,3,1,4,0,0,0,0,-2,286,0,-4,4,4,0,1,0,-1,1,-1,0,-1
KR_6747769788,420,-4,24,24,-15,-5,5,0,-5,9,4,-2,3,1,1,1,2,-4,4,0,-2,-13,-289,-2,-1,3,-2,0,-2,-1,-1,-1,-1,5,-1
KR_6668957057,420,-5,-28,45,-6,-4,4,0,-2,5,3,-1,5,4,0,4,4,1,2,3,0,-15,27,-1,-5,6,-13,0,-1,-1,-1,-1,-1,3,-1
KR_6635355975,420,-1,-30,-5,-5,-3,5,2,-1,3,2,3,2,5,-2,5,3,-2,3,1,0,-9,279,3,-6,3,-8,0,1,-1,1,-1,-1,2,-1
KR_6746235030,420,1,0,0,0,3,0,3,-3,7,4,4,1,5,1,3,4,-5,6,1,0,-7,-24,3,-4,1,6,0,-1,1,-1,-1,1,3,-1
KR_6706004996,420,0,2,-32,-2,2,0,2,-2,6,4,1,0,1,-3,3,0,0,0,0,0,-4,-23,-4,-1,5,3,0,0,-1,-1,0,-1,6,-1
KR_6744462087,420,0,11,-4,0,2,0,2,0,1,1,-3,4,1,1,3,4,0,0,0,1,2,10,3,-5,2,-2,0,-1,-1,0,-1,1,4,-1
KR_6636471239,420,-7,-145,-8,-8,-4,5,1,3,0,3,-6,6,0,0,4,4,-1,1,0,0,-5,3,-1,0,1,0,0,-3,1,0,-1,-1,2,-1
KR_6752282609,420,-3,21,-13,-2,-2,3,1,-6,6,0,-2,7,5,7,4,11,1,3,4,1,-7,5,5,-8,3,-4,0,1,-1,-1,-1,1,2,-1
KR_6749643284,420,-2,-96,-15,-7,-4,6,2,-2,4,2,-3,3,0,0,2,2,2,0,2,1,0,27,-4,-4,8,0,0,0,1,0,0,1,3,-1
KR_6763243935,420,-5,-93,0,-16,-1,2,1,-3,3,0,-7,9,2,1,2,3,-6,6,0,0,-11,3,-3,-1,4,0,0,-1,-1,1,-1,-1,4,-1
KR_6753843766,420,-2,20,20,0,-1,4,3,4,0,4,-2,2,0,-1,3,2,0,0,0,0,1,-5,1,-6,5,8,0,0,1,0,0,-1,6,-1
KR_6751786096,420,-4,-63,-16,-5,-1,3,2,-1,1,0,-5,5,0,2,0,2,0,1,1,0,3,-1,1,-3,2,-4,0,0,1,1,0,-1,4,-1
KR_6763137369,420,0,18,13,-4,-3,3,0,1,4,5,-2,6,4,-2,3,1,2,0,2,-1,-10,-110,-5,-2,7,1,0,-1,1,-1,-1,-1,1,-1
KR_6761499901,420,-2,45,-40,-10,-7,8,1,-3,4,1,-6,8,2,2,0,2,4,1,5,0,-5,6,3,-3,0,-3,0,1,1,-1,1,-1,5,-1
KR_6761865831,420,0,-74,-3,2,-3,3,0,-1,3,2,3,3,6,1,3,4,2,0,2,0,3,110,4,-7,3,-3,0,0,-1,1,0,-1,2,-1
KR_6701333076,420,-3,11,1,-6,0,0,0,-4,5,1,-3,4,1,1,0,1,0,1,1,0,-4,135,1,-3,2,0,0,-1,-1,-1,-1,-1,4,-1
KR_6637981863,420,0,22,-32,0,-1,1,0,-7,7,0,3,0,3,4,0,4,1,1,2,0,-1,-1,-1,-1,2,2,0,0,1,-1,0,1,3,-1
KR_6699707519,420,2,41,-38,4,1,0,1,0,1,1,4,2,6,0,2,2,-1,3,2,0,-1,-2,3,-4,1,-4,0,-1,-1,-1,-1,-1,3,-1
KR_6762180879,420,0,-32,-29,4,0,2,2,-1,2,1,2,2,4,4,1,5,-1,1,0,0,6,43,1,-2,1,1,0,0,1,1,1,-1,2,-1
KR_6647791498,440,4,35,-4,2,2,3,5,3,2,5,2,1,3,-2,2,0,-3,3,0,0,-5,12,2,-4,2,-2,0,2,-1,1,1,1,6,-1
KR_6762905552,420,-3,-33,-28,-12,0,0,0,-6,8,2,-1,2,1,-3,4,1,-2,3,1,-1,-3,0,2,-4,2,1,0,-1,0,-1,-1,-1,0,-1
KR_6602959682,420,-2,-58,-12,-7,-2,2,0,-4,11,7,3,1,4,-5,6,1,1,0,1,0,2,1,-2,-5,7,-1,0,0,-1,-1,0,-1,5,-1
KR_6761625037,440,0,12,-32,-1,-2,6,4,-6,6,0,5,1,6,1,2,3,1,0,1,0,-2,-323,-1,-3,4,2,0,-1,-1,-1,-1,1,1,-1
KR_6755797145,420,-4,28,-20,-7,-3,5,2,-3,3,0,2,1,3,-4,8,4,1,1,2,0,-6,2,3,-4,1,0,0,-1,-1,1,-1,1,5,-1
KR_6709633238,420,-2,-13,18,-3,1,0,1,0,3,3,1,1,2,-2,4,2,-3,3,0,0,-10,-27,0,-5,5,11,0,-1,-1,1,-1,-1,4,-1
KR_6705776020,420,-1,14,-20,1,1,3,4,-2,5,3,-3,3,0,2,2,4,3,0,3,2,2,5,-2,-5,7,3,0,0,1,-1,-1,1,6,-1
KR_6722925980,440,-2,15,12,-2,5,0,5,-2,3,1,-1,1,0,0,6,6,-4,4,0,-1,-11,168,2,-7,5,4,0,1,-1,1,1,-1,4,-1
KR_6763264988,440,-4,-20,-64,-3,-1,1,0,1,4,5,-5,6,1,1,1,2,1,1,2,-1,-1,6,4,-7,3,-1,0,0,-1,1,0,-1,2,-1
KR_6592770789,420,0,-47,20,3,-2,4,2,6,2,8,4,2,6,-5,5,0,0,1,1,0,-2,-4,-2,-2,4,-1,0,0,0,1,0,-1,0,-1
KR_6627838109,420,-2,-19,0,-2,-2,2,0,3,1,4,2,1,3,-5,7,2,0,0,0,0,2,10,1,-5,4,-2,0,0,-1,1,0,1,5,-1
KR_6667025529,420,0,29,27,-1,2,0,2,0,1,1,-2,4,2,1,1,2,-2,2,0,0,2,-7,-2,-1,3,2,0,1,-1,-1,1,-1,2,-1
KR_6732372875,420,-1,-15,0,-3,-5,5,0,1,1,2,4,0,4,-3,4,1,0,1,1,0,1,-194,3,-4,1,-3,0,-1,0,0,-1,-1,0,-1
KR_6665352508,420,-2,-57,23,-2,-7,8,1,1,0,1,-2,5,3,6,0,6,0,1,1,0,7,-10,0,-3,3,-2,0,-1,1,-1,-1,1,1,-1
KR_6750427249,420,0,-26,32,-15,-2,4,2,-7,8,1,3,0,3,-5,7,2,-4,4,0,-1,-9,-1,-1,-3,4,-2,0,-1,1,0,-1,-1,5,-1
KR_6670963514,420,-1,-65,-18,-2,-2,3,1,-1,3,2,0,1,1,-1,4,3,2,0,2,0,0,113,0,-3,3,-3,0,0,-1,-1,0,1,2,-1
KR_6726543712,420,-2,-6,45,-10,-1,2,1,-3,6,3,-7,8,1,3,0,3,-2,2,0,0,-11,-54,-5,-1,6,-1,0,0,-1,0,0,1,1,-1
KR_6636345888,420,-6,-117,-36,-11,0,0,0,-3,4,1,5,2,7,-11,11,0,-2,3,1,0,-11,-214,4,-4,0,-1,0,-2,-1,-1,-1,-1,5,-1
KR_6600837424,420,1,17,35,1,1,1,2,-4,6,2,3,1,4,1,2,3,0,0,0,0,0,209,-2,-1,3,0,0,0,1,1,0,-1,2,-1
KR_6764398881,420,0,-74,-12,2,0,1,1,2,1,3,-2,5,3,-1,5,4,3,0,3,1,13,15,-4,-3,7,-1,0,-1,-1,-1,-1,1,6,-1
KR_6749360164,420,-3,-45,-12,-8,-1,3,2,-6,7,1,4,1,5,-3,3,0,-2,3,1,0,-7,-30,0,-2,2,26,0,-2,-1,0,-1,-1,3,-1
KR_6700484632,420,-1,12,-21,-10,-1,2,1,3,1,4,-1,3,2,-8,8,0,-3,5,2,0,-6,59,-1,-3,4,2,0,-1,0,-1,-1,-1,0,-1
KR_6760736249,420,-4,-108,7,-13,-1,4,3,1,2,3,-4,4,0,-9,11,2,0,1,1,-1,-20,1,1,-7,6,1,0,-2,1,-1,-1,-1,5,-1
KR_6686784297,420,-2,1,-29,1,-1,1,0,4,0,4,-2,4,2,0,0,0,0,0,0,0,7,-6,0,-5,5,-1,0,1,-1,1,1,1,5,-1
KR_6757583584,440,1,-142,20,0,2,1,3,0,2,2,-3,6,3,0,1,1,1,1,2,0,-2,26,-2,-1,3,-2,0,0,-1,0,0,-1,6,-1
KR_6660041616,420,-3,-78,12,-11,-3,5,2,-1,3,2,-3,5,2,-6,6,0,2,0,2,0,-15,2,1,-3,2,-5,0,0,-1,0,-1,1,2,-1
KR_6754953456,420,1,36,-26,-2,1,1,2,-2,3,1,1,4,5,0,2,2,-2,4,2,0,-2,-7,0,-2,2,1,0,0,-1,-1,0,-1,3,-1
KR_6693883551,420,-3,-4,-49,3,-1,7,6,0,1,1,0,1,1,6,2,8,-2,2,0,0,4,0,1,-2,1,3,0,0,-1,-1,-1,1,3,-1
KR_6762539103,420,0,-49,10,-4,-3,5,2,0,1,1,-1,3,2,-1,4,3,1,0,1,-1,-6,2,2,-2,0,-3,0,-1,-1,0,-1,-1,4,-1
KR_6759624958,420,-3,-77,16,-10,-1,3,2,2,1,3,-6,6,0,-5,5,0,0,0,0,0,-7,-38,1,-2,1,25,0,-2,-1,-1,-1,-1,1,-1
KR_6648652214,420,-2,-12,-5,-8,0,6,6,-4,4,0,-4,5,1,-2,2,0,2,1,3,1,-1,5,-3,-4,7,-2,0,-1,-1,-1,-1,1,2,-1
KR_6740068003,420,-4,-43,-36,-11,0,2,2,-5,6,1,0,5,5,-2,2,0,-4,4,0,0,-19,260,-4,-1,5,3,0,0,1,-1,0,1,6,-1
KR_6728539218,440,-3,12,8,0,0,1,1,1,2,3,1,3,4,-2,4,2,0,0,0,0,5,0,1,-5,4,3,0,-1,1,-1,-1,1,4,-1
KR_6761493043,420,-2,-10,-12,-4,-2,2,0,-2,2,0,3,0,3,-3,5,2,0,2,2,0,-2,1,0,-4,4,3,0,-1,-1,-1,-1,-1,1,-1
KR_6752422543,420,-4,-18,-28,-4,-2,3,1,2,0,2,-5,5,0,1,1,2,0,1,1,0,-2,-1,-2,-1,3,-6,0,-1,-1,1,-1,-1,1,-1
KR_6752641927,420,-2,-71,-9,-3,0,1,1,-1,2,1,-5,7,2,2,1,3,1,0,1,0,2,3,-1,-2,3,2,0,-1,1,-1,-1,-1,4,-1
KR_6638969350,420,1,16,6,-2,1,1,2,-3,4,1,-3,4,1,1,0,1,2,0,2,0,2,-337,0,-1,1,-1,0,-1,1,-1,-1,-1,1,-1
KR_6500995915,420,2,41,10,2,1,1,2,3,2,5,-2,3,1,-1,2,1,1,1,2,0,1,385,4,-5,1,-1,0,0,1,-1,0,1,3,-1
KR_6762396934,420,2,58,-24,2,2,1,3,-2,4,2,2,1,3,1,4,5,-1,2,1,0,1,-6,2,-6,4,0,0,0,1,0,0,1,2,-1
KR_6739083495,420,2,4,4,6,2,2,4,-4,4,0,4,0,4,5,2,7,-1,1,0,0,4,-44,-2,0,2,25,0,0,1,-1,0,-1,2,-1
KR_6619134854,420,-4,-28,30,-11,4,1,5,-2,6,4,-6,8,2,-4,4,0,-3,5,2,-1,-20,4,2,-5,3,-5,0,-2,-1,-1,-1,-1,4,-1
KR_6736228667,420,4,31,-28,8,4,0,4,1,0,1,-3,3,0,5,0,5,1,1,2,0,5,-6,3,-3,0,2,0,2,1,-1,1,1,5,-1
KR_6764435491,420,-1,34,-28,-4,1,6,7,-4,5,1,-4,5,1,2,0,2,1,0,1,1,-2,-2,-6,-2,8,0,0,-1,-1,-1,-1,1,1,-1
KR_6624557341,420,-3,-66,-32,-13,-6,7,1,-3,3,0,-1,2,1,-4,5,1,1,0,1,0,-15,103,-4,-2,6,3,0,-2,-1,-1,-1,-1,5,-1
KR_6695273204,420,-2,15,-16,0,-2,3,1,-5,5,0,6,0,6,1,0,1,0,0,0,1,-6,-2,-1,-1,2,1,0,1,1,1,1,1,6,-1
KR_6747914534,420,-1,-41,-16,-4,0,1,1,-1,2,1,-2,3,1,-1,1,0,0,1,1,0,2,1,0,-2,2,-4,0,-1,0,-1,-1,-1,0,-1
KR_6751007908,420,-1,39,20,-3,-1,2,1,-9,12,3,6,1,7,-1,3,2,2,0,2,1,-3,38,-4,-1,5,-26,0,0,0,0,0,1,0,-1
KR_6700468718,420,-1,-50,16,-8,-3,4,1,1,1,2,1,3,4,-3,3,0,-4,5,1,0,-5,156,-1,-4,5,0,0,0,1,0,0,-1,3,-1
KR_6722196210,420,-5,-64,2,-10,0,1,1,-1,2,1,-3,4,1,-5,6,1,-1,2,1,0,-12,-8,-3,-4,7,1,0,0,0,-1,-1,-1,0,-1
KR_6760585166,420,-3,-49,15,-4,-4,4,0,-3,5,2,-3,3,0,5,3,8,1,0,1,0,-6,-159,-3,-3,6,0,0,-3,-1,-1,-1,1,3,-1
KR_6699905272,420,1,35,8,-1,-2,2,0,1,1,2,0,0,0,1,4,5,-1,3,2,0,-2,-3,-3,-3,6,-1,0,0,1,-1,0,-1,5,-1
KR_6729387016,420,1,-45,3,1,-2,4,2,1,2,3,2,1,3,1,5,6,-1,4,3,0,-1,0,0,-3,3,5,0,0,1,1,0,1,4,-1
KR_6723523636,420,0,-61,4,-8,-1,2,1,-3,5,2,-4,6,2,2,3,5,-2,2,0,0,-5,-1,0,-3,3,2,0,-1,1,-1,-1,-1,4,-1
KR_6744997872,420,1,-26,13,0,-5,5,0,1,1,2,0,0,0,4,0,4,0,0,0,0,6,8,2,-5,3,-1,0,-2,1,-1,-1,1,1,-1
KR_5684729283,420,1,-6,-10,1,0,1,1,2,1,3,4,0,4,-6,6,0,1,1,2,0,4,3,2,-5,3,-1,0,-1,-1,-1,-1,1,6,-1
KR_6737944177,420,-1,-11,-21,-5,4,1,5,-4,5,1,-6,6,0,0,4,4,1,1,2,0,-4,-279,-4,-2,6,-3,0,-1,-1,1,-1,-1,1,-1
KR_6758012425,420,0,-10,-12,-2,1,0,1,0,0,0,-4,7,3,-2,2,0,3,0,3,-1,-2,7,-3,-3,6,-3,0,-1,-1,1,-1,-1,6,-1
KR_6748605932,420,-5,3,8,-12,-4,5,1,-3,4,1,-2,4,2,-1,5,4,-2,4,2,0,-11,-4,-4,-5,9,-6,0,-1,-1,0,-1,1,6,-1
KR_6763318641,420,-1,-36,22,-5,-2,3,1,-3,5,2,0,1,1,0,0,0,0,0,0,-1,2,-28,3,-4,1,15,0,0,1,-1,0,-1,5,-1
KR_6414110879,420,1,0,-10,-3,0,2,2,1,1,2,-3,5,2,1,5,6,-2,3,1,0,-3,26,0,-6,6,-6,0,0,-1,1,0,1,1,-1
KR_5675006272,420,-4,-21,8,-14,-3,6,3,-1,4,3,-2,3,1,-12,12,0,4,1,5,-2,-13,1,7,-9,2,4,0,-2,1,-1,-1,-1,1,-1
KR_6688963748,420,-3,4,-12,-14,4,2,6,-6,8,2,-8,9,1,-5,5,0,1,0,1,0,-12,-9,-2,-2,4,0,0,-2,-1,1,1,-1,5,-1
KR_6748833877,440,3,-32,-1,9,-3,4,1,1,0,1,2,3,5,6,0,6,3,0,3,0,13,17,-2,-2,4,2,0,-1,1,0,1,1,2,-1
KR_6613612520,420,-3,-7,-3,-3,0,1,1,-3,3,0,2,1,3,1,1,2,-3,3,0,0,-5,-6,1,-2,1,-1,0,1,-1,1,1,1,6,-1
KR_6734486861,420,-6,-111,-16,-10,-2,2,0,-1,2,1,-7,8,1,0,3,3,0,1,1,-1,1,44,3,-5,2,-21,0,-3,-1,-1,-1,-1,1,-1
KR_6752601803,420,1,-45,8,-1,4,0,4,3,2,5,-2,2,0,-4,7,3,-2,2,0,-1,-5,-33,0,-5,5,13,0,-1,-1,-1,-1,-1,6,-1
KR_6574844451,440,-2,-36,-8,-3,1,0,1,-1,2,1,-1,3,2,-2,3,1,0,0,0,0,-5,319,0,-6,6,-7,0,-1,1,-1,-1,-1,6,-1
KR_6758625302,420,-2,49,4,-9,-4,6,2,-4,6,2,-1,3,2,3,1,4,-3,3,0,0,-5,-2,-1,-1,2,2,0,-1,0,-1,-1,-1,0,-1
KR_6763330940,420,-1,-25,-24,2,0,2,2,-9,10,1,2,2,4,5,2,7,4,0,4,-2,1,-28,0,-4,4,6,0,0,1,0,1,1,6,-1
KR_6756228159,420,1,54,8,4,2,1,3,-1,3,2,0,5,5,1,1,2,2,0,2,0,2,20,0,-1,1,1,0,2,-1,1,1,1,5,-1
KR_6703144192,420,0,-64,20,-1,0,0,0,5,1,6,-3,4,1,-2,5,3,-1,1,0,0,4,-3,-3,-2,5,0,0,0,-1,1,-1,1,4,-1
KR_6656412381,420,-1,-66,24,-6,-2,3,1,-3,5,2,-1,2,1,0,2,2,0,0,0,1,-4,-1,-1,-2,3,1,0,0,0,1,-1,1,0,-1
KR_6760866461,440,1,-44,8,-4,-1,3,2,-3,4,1,-1,4,3,0,4,4,1,1,2,0,-1,-4,-3,-1,4,5,0,-2,0,-1,-1,-1,0,-1
KR_6743456624,420,-2,-6,-22,-3,2,1,3,-2,2,0,0,1,1,-1,1,0,-2,2,0,1,-2,9,-2,-2,4,2,0,1,-1,1,1,1,5,-1
KR_6656329289,420,-1,-46,-30,-5,-2,3,1,-5,6,1,1,2,3,2,1,3,-1,1,0,0,4,-2,-3,-2,5,-1,0,-1,-1,-1,-1,-1,2,-1
KR_6762009970,420,-2,-45,-12,-10,-2,2,0,0,2,2,3,0,3,-3,3,0,-8,8,0,1,-10,34,-5,-1,6,-21,0,-2,-1,1,-1,1,2,-1
KR_6740344370,420,-3,-35,20,-6,-5,5,0,-1,3,2,2,1,3,-1,1,0,-1,2,1,0,-1,-263,-1,0,1,0,0,1,0,0,1,1,0,-1
KR_6741912801,420,-1,32,-3,-7,2,2,4,-6,7,1,0,1,1,-4,4,0,1,1,2,-2,-13,-8,-4,-2,6,-1,0,1,0,0,1,-1,0,-1
KR_6145865341,440,-3,-21,-16,0,0,0,0,2,1,3,3,3,6,-3,7,4,-2,2,0,0,-2,-174,1,-3,2,1,0,-1,-1,0,-1,1,5,-1
KR_6747298093,420,-4,-94,3,-16,-1,1,0,0,4,4,-4,6,2,-4,6,2,-7,7,0,0,-17,0,1,-4,3,-2,0,-1,-1,-1,-1,-1,3,-1
KR_6762551356,420,-1,16,5,-7,1,0,1,-4,5,1,-5,6,1,-1,4,3,2,2,4,0,-12,0,-1,-2,3,-2,0,0,-1,1,-1,1,1,-1
KR_6756312076,420,-3,-22,-12,-10,1,0,1,0,5,5,-4,4,0,-7,8,1,0,0,0,0,-10,1,3,-5,2,-3,0,-2,-1,-1,-1,-1,3,-1
KR_6764091189,420,-4,-58,-42,-9,-3,4,1,1,1,2,-4,6,2,-2,3,1,-1,1,0,0,-2,-8,1,-1,0,1,0,-1,-1,-1,-1,1,4,-1
KR_6764505874,420,-7,-57,-32,-18,0,3,3,-5,5,0,-8,10,2,-3,3,0,-2,4,2,-1,-19,-3,-1,0,1,0,0,-2,-1,-1,-1,-1,1,-1
KR_6750736164,420,-3,-52,-8,-7,-2,4,2,-5,5,0,-5,5,0,6,2,8,-1,1,0,0,-8,-1,0,-3,3,2,0,1,1,-1,1,-1,1,-1
KR_6762698570,420,-2,31,-32,-11,-1,2,1,-7,8,1,-4,5,1,3,1,4,-2,3,1,-1,-6,-1,-5,-4,9,-4,0,-1,1,-1,-1,-1,2,-1
KR_6718457611,420,-2,87,-5,-5,6,1,7,-5,6,1,0,3,3,-6,6,0,0,1,1,0,-10,-3,-4,-2,6,-2,0,2,-1,1,1,1,4,-1
KR_6684575458,420,-4,-131,17,-3,0,2,2,1,1,2,-1,3,2,-3,4,1,0,0,0,0,-7,-2,-2,-3,5,0,0,0,-1,1,-1,-1,6,-1
KR_6634497219,420,-3,-107,-40,-6,-2,3,1,-2,2,0,-2,3,1,-1,1,0,1,2,3,-2,-6,12,-2,-2,4,-2,0,0,-1,0,0,-1,1,-1
KR_6732615126,420,1,-4,-12,6,0,1,1,1,0,1,2,3,5,4,0,4,-1,2,1,-1,8,8,5,-7,2,-2,0,1,0,0,1,-1,0,-1
KR_6703001195,420,-2,-66,-13,-6,-7,8,1,0,0,0,-2,3,1,0,1,1,3,1,4,-1,-5,-47,-3,-2,5,13,0,-2,-1,-1,-1,-1,3,-1
KR_6659270878,440,-2,-36,8,-2,-2,3,1,-4,6,2,-1,3,2,0,5,5,5,0,5,-1,2,13,-6,0,6,3,0,1,0,-1,-1,-1,0,-1
KR_6764731361,420,-4,-45,-16,-10,-2,3,1,0,3,3,-5,7,2,0,2,2,-3,4,1,0,4,43,-1,-3,4,-1,0,-1,-1,-1,-1,1,4,-1
KR_6717301807,420,-2,-34,-23,-1,-3,4,1,-4,11,7,9,0,9,0,3,3,-3,4,1,1,-4,197,4,-6,2,2,0,0,-1,-1,-1,1,5,-1
KR_6763285653,420,-4,-23,-28,0,0,1,1,-1,1,0,-1,1,0,1,0,1,1,0,1,0,2,50,1,-2,1,-32,0,1,0,-1,1,1,0,-1
KR_6729992451,420,-2,-51,4,0,-1,1,0,1,2,3,-1,4,3,1,1,2,0,1,1,0,-4,-11,2,-3,1,13,0,-1,-1,1,-1,1,5,-1
KR_6759204544,420,-1,-56,-4,-1,1,1,2,1,5,6,3,0,3,-6,6,0,0,0,0,0,1,2,0,-5,5,2,0,-1,1,-1,-1,-1,2,-1
KR_6638448612,440,0,-81,12,-4,1,1,2,-5,6,1,1,2,3,-2,2,0,1,1,2,0,-6,110,-3,-2,5,-1,0,0,-1,-1,0,-1,1,-1
KR_6647883252,420,-1,-48,24,-8,-6,6,0,0,0,0,-8,8,0,1,0,1,5,0,5,0,-2,0,-5,0,5,0,0,1,1,1,1,1,5,-1
KR_6744291938,420,0,-41,-16,9,-5,6,1,4,1,5,2,3,5,4,1,5,4,0,4,1,23,3,3,-4,1,-2,0,-2,1,-1,-1,1,3,-1
KR_6672290043,420,0,-22,7,4,-3,3,0,0,2,2,3,1,4,3,0,3,1,1,2,0,3,126,0,-2,2,-3,0,0,1,-1,1,1,1,-1
KR_6725723110,420,2,-2,-27,2,1,1,2,0,2,2,0,3,3,0,1,1,1,0,1,0,5,15,-3,-2,5,-2,0,1,1,1,1,1,3,-1
KR_6684625640,420,0,-41,-8,3,-2,3,1,4,0,4,3,1,4,-1,1,0,-1,1,0,0,4,-11,4,-8,4,-3,0,-2,-1,1,-1,1,2,-1
KR_6762169422,440,-3,-70,-32,-7,0,2,2,1,0,1,-3,6,3,-3,3,0,-2,5,3,0,-1,-140,-5,0,5,0,0,-2,0,-1,-1,-1,0,-1
KR_6659668900,420,-3,-16,-7,-4,0,2,2,-7,8,1,1,2,3,1,4,5,1,0,1,0,-5,17,3,-5,2,-2,0,-1,-1,1,-1,-1,5,-1
KR_6751384398,420,-4,-36,-41,-6,-5,5,0,-3,4,1,-1,1,0,3,2,5,0,1,1,0,-3,22,-1,-3,4,10,0,-1,1,-1,-1,-1,2,-1
KR_6620292331,420,2,-8,-13,1,-1,1,0,0,3,3,2,2,4,2,1,3,-2,2,0,0,3,-4,0,-5,5,0,0,0,1,-1,-1,-1,1,-1
KR_6734559936,440,-4,-19,-12,-6,-5,5,0,-2,5,3,-3,5,2,2,4,6,2,0,2,0,2,19,-1,-3,4,-3,0,-1,0,0,-1,1,0,-1
KR_6756573465,420,-3,45,15,-3,-2,2,0,1,1,2,-1,2,1,-2,4,2,1,0,1,0,0,5,-1,-3,4,-2,0,1,-1,1,1,-1,5,-1
KR_6619906466,420,1,52,33,0,4,0,4,-1,5,4,1,1,2,-4,4,0,0,2,2,-1,-4,-21,6,-7,1,0,0,0,0,0,-1,-1,0,-1
KR_6751160860,440,-3,-56,-28,-3,0,1,1,-1,3,2,0,1,1,-1,1,0,-1,1,0,0,-2,2,1,-5,4,-4,0,0,-1,-1,0,-1,2,-1
KR_6504946502,420,-5,-24,-24,-14,-4,4,0,-6,8,2,-1,5,4,-3,4,1,0,0,0,0,-11,294,-2,-2,4,-3,0,-2,1,-1,-1,-1,1,-1
KR_6697943714,420,-6,-137,-52,-10,0,1,1,-1,2,1,-1,1,0,-5,5,0,-3,3,0,0,-9,-4,-4,-3,7,0,0,-1,1,1,-1,-1,5,-1
KR_6600804935,420,-1,20,-8,-1,-3,3,0,4,4,8,0,1,1,-2,4,2,0,2,2,1,-3,14,4,-4,0,-2,0,0,-1,1,0,1,2,-1
KR_6732558744,420,-11,-128,-40,-22,-3,3,0,-3,4,1,-4,5,1,-6,8,2,-6,6,0,0,-17,-20,0,-1,1,1,0,-3,1,0,-1,-1,5,-1
KR_6742702904,420,1,35,-28,-2,1,0,1,-1,1,0,-2,3,1,-1,1,0,1,1,2,0,0,-42,2,-3,1,30,0,1,1,1,1,1,3,-1
KR_6630248349,420,-2,59,-28,-8,-5,8,3,-1,4,3,-3,3,0,1,1,2,0,2,2,0,-9,-7,-2,-2,4,3,0,-2,-1,-1,-1,-1,1,-1
KR_6756972056,420,0,11,15,0,1,2,3,1,1,2,0,4,4,-2,4,2,0,1,1,0,-6,8,-1,-1,2,-1,0,0,0,1,0,1,0,-1
KR_6632220477,420,2,8,-16,0,-1,2,1,1,2,3,-2,4,2,4,1,5,-2,3,1,0,-1,8,-2,-2,4,5,0,0,-1,1,0,1,3,-1
KR_6633753008,420,-2,6,-20,-3,2,0,2,0,4,4,3,0,3,-9,10,1,1,1,2,0,-9,-4,-4,0,4,2,0,-2,-1,-1,-1,-1,6,-1
KR_6662982597,420,-1,-22,3,-1,-1,2,1,4,0,4,-1,2,1,-3,4,1,0,3,3,0,1,-11,-1,-2,3,2,0,0,-1,1,0,-1,3,-1
KR_6701726935,420,-3,-30,-54,-4,1,3,4,-5,8,3,-4,5,1,1,2,3,3,0,3,0,1,-6,0,-5,5,3,0,-1,0,-1,-1,1,0,-1
KR_6749822650,420,1,-35,-4,2,6,0,6,2,0,2,-1,4,3,-4,4,0,-1,1,0,0,-3,-24,-2,0,2,1,0,-2,-1,1,-1,1,4,-1
KR_6694756130,420,-3,-27,-20,-2,-1,1,0,-5,7,2,2,1,3,2,2,4,0,0,0,0,2,-1,-1,-4,5,-3,0,-2,-1,-1,-1,1,2,-1
KR_6615991873,420,0,-90,18,-6,-1,2,1,-2,3,1,-3,6,3,1,1,2,-1,2,1,1,-3,0,-8,-5,13,-4,0,0,-1,-1,0,1,4,-1
KR_6760181042,420,-1,-20,0,6,1,1,2,6,1,7,-1,3,2,1,1,2,-1,1,0,0,6,253,0,-2,2,-2,0,0,1,1,0,1,5,-1
KR_6758539361,420,-2,-38,19,-9,-8,9,1,-1,2,1,2,1,3,-3,4,1,1,1,2,2,-6,2,-2,-4,6,1,0,1,1,1,1,1,1,-1
KR_6721762516,420,-3,-40,0,-3,1,1,2,1,1,2,-5,5,0,-1,2,1,1,1,2,0,-1,-27,-1,-2,3,13,0,-1,-1,-1,-1,1,1,-1
KR_6730619521,420,2,-9,36,6,3,0,3,-1,3,2,2,1,3,2,1,3,0,0,0,0,5,-8,-1,-4,5,-1,0,0,-1,-1,-1,1,4,-1
KR_6756663131,420,12,19,84,4,1,3,4,-2,6,4,6,0,6,0,2,2,-1,3,2,1,8,10,-2,0,2,-1,0,2,0,0,1,1,0,-1
KR_6762259915,420,0,4,-4,-3,4,1,5,-2,2,0,-4,4,0,-1,3,2,0,0,0,0,-3,-32,-4,-2,6,20,0,0,0,1,1,1,0,-1
KR_6720716181,420,-4,19,3,-16,-5,5,0,-1,3,2,-3,5,2,-5,7,2,-2,3,1,0,-13,-12,-7,-2,9,1,0,1,-1,-1,1,-1,4,-1
KR_6761119895,420,-3,-75,-41,-7,-2,3,1,-7,9,2,2,1,3,-2,6,4,2,1,3,0,-4,-1,-2,-1,3,-1,0,0,-1,0,-1,1,5,-1
KR_6728825482,420,-4,-132,-28,-3,1,1,2,1,5,6,0,1,1,-5,5,0,0,0,0,0,-3,-7,0,-2,2,-2,0,-1,-1,1,-1,-1,6,-1
KR_6743459007,420,-4,-104,4,-1,-1,1,0,4,0,4,0,3,3,-5,6,1,1,0,1,0,-4,4,-2,-3,5,0,0,-1,-1,0,-1,-1,1,-1
KR_6724827262,440,-3,40,4,3,-1,3,2,1,1,2,2,3,5,1,7,8,0,2,2,2,0,0,1,-2,1,0,0,3,-1,1,1,1,3,-1
KR_6536679843,420,1,-38,-6,1,-4,4,0,3,2,5,-4,5,1,5,0,5,1,1,2,0,5,3,3,-5,2,1,0,0,1,-1,0,-1,3,-1
KR_6725720468,420,-2,-47,-3,-3,-1,4,3,2,3,5,-2,6,4,-2,4,2,0,3,3,0,3,6,2,-7,5,-3,0,0,-1,0,0,-1,4,-1
KR_6758987626,420,-2,33,0,-1,0,1,1,-2,2,0,2,2,4,-1,4,3,0,2,2,0,-3,147,1,-4,3,-1,0,0,0,1,0,1,0,-1
KR_6758040439,420,-1,-92,-1,-1,-5,5,0,-1,5,4,-2,3,1,6,3,9,1,1,2,-1,1,36,1,-2,1,0,0,-3,-1,0,-1,-1,5,-1
KR_6684232566,420,-2,-19,-4,3,2,2,4,2,2,4,-1,1,0,1,1,2,-1,1,0,0,0,14,0,-3,3,-4,0,-1,-1,-1,-1,-1,5,-1
KR_6757678394,420,0,-68,-13,2,-1,6,5,2,0,2,1,3,4,0,0,0,0,1,1,0,1,-9,-3,0,3,3,0,-1,-1,0,-1,-1,6,-1
KR_6758316910,420,0,62,-20,-8,-3,4,1,-2,2,0,-5,6,1,2,1,3,0,1,1,0,-11,10,2,-6,4,0,0,0,1,-1,0,-1,3,-1
KR_6714655535,420,-1,16,26,1,3,2,5,-2,3,1,3,0,3,-7,7,0,4,1,5,0,-9,-7,-4,0,4,-1,0,-1,-1,-1,-1,1,5,-1
KR_6739006550,420,1,2,4,-3,7,0,7,1,1,2,-3,6,3,-4,4,0,-4,4,0,-1,-15,-7,-4,-1,5,-2,0,1,-1,1,-1,-1,1,-1
KR_6717127419,420,-1,-17,3,1,-2,2,0,-1,2,1,0,3,3,2,1,3,2,1,3,0,-1,6,4,-4,0,0,0,0,1,0,0,1,3,-1
KR_6629037772,420,-3,4,15,-7,-1,2,1,2,2,4,-3,3,0,-4,5,1,-1,1,0,0,-7,4,0,-2,2,-2,0,-1,1,-1,-1,-1,2,-1
KR_6756997249,420,-4,-49,-2,-13,-3,4,1,-3,3,0,-2,4,2,-4,5,1,-1,1,0,0,-10,0,0,-4,4,3,0,-1,1,-1,-1,-1,3,-1
KR_6747944926,420,-2,-130,-16,-4,-1,1,0,-1,1,0,-2,4,2,0,1,1,0,0,0,0,-3,87,1,-6,5,-9,0,-1,1,-1,-1,-1,5,-1
KR_6694904468,420,1,56,12,-2,5,0,5,-3,4,1,-5,5,0,-1,1,0,2,0,2,0,-10,-1,-1,-4,5,3,0,1,0,1,1,-1,0,-1
KR_6700443273,420,-1,14,-20,-2,0,1,1,-1,6,5,2,1,3,-2,3,1,-1,1,0,0,1,-109,1,-7,6,-1,0,0,1,0,0,-1,2,-1
KR_6630787368,420,-4,-109,13,-22,-6,6,0,-4,4,0,-2,5,3,-6,6,0,-4,4,0,-1,-22,-3,4,-9,5,-5,0,-2,-1,0,-1,-1,5,-1
KR_6733150443,420,1,27,12,-1,-4,4,0,-1,2,1,2,1,3,1,3,4,1,2,3,0,-9,194,-3,0,3,-5,0,0,0,0,0,1,0,-1
KR_6617502083,420,-5,-32,-9,-16,-6,6,0,-7,8,1,-4,4,0,0,2,2,1,2,3,-1,-19,-2,-6,-2,8,4,0,0,-1,-1,-1,-1,4,-1
KR_6761219961,420,-3,11,-24,-1,5,0,5,-2,3,1,-1,4,3,-3,4,1,0,0,0,1,-7,-1,0,-4,4,-2,0,0,-1,0,0,1,6,-1
KR_6662047049,420,-4,-72,-36,-8,-4,4,0,0,4,4,1,0,1,-5,6,1,0,0,0,0,-9,-5,-4,0,4,-3,0,-2,-1,-1,-1,-1,3,-1
KR_6749998388,440,-2,-107,-36,0,-5,7,2,2,0,2,5,2,7,0,2,2,-2,2,0,0,-1,11,6,-8,2,3,0,-3,-1,0,-1,1,3,-1
KR_6744649453,420,2,-29,25,-3,1,0,1,-1,4,3,0,3,3,-4,6,2,1,1,2,-1,-4,8,2,-6,4,-10,0,0,1,-1,0,-1,3,-1
KR_6752459441,420,3,102,2,2,2,0,2,0,4,4,-2,6,4,3,3,6,-1,1,0,-1,-3,358,-1,-2,3,2,0,0,1,-1,0,-1,5,-1
KR_6673858291,420,2,46,8,5,3,1,4,2,4,6,-1,1,0,1,1,2,0,1,1,0,-1,-12,-1,-2,3,-3,0,1,-1,1,1,-1,2,-1
KR_6532718717,420,-2,-3,-32,-8,-2,4,2,0,3,3,1,3,4,-6,8,2,-1,2,1,-2,-4,-5,0,-4,4,2,0,0,-1,0,-1,-1,3,-1
KR_6748739390,440,-3,-74,-17,-7,2,1,3,-1,2,1,-5,7,2,-6,6,0,3,2,5,-2,-4,-1,-3,-2,5,2,0,-1,0,-1,-1,1,0,-1
KR_6761520300,420,-3,-45,-20,1,-2,5,3,-1,4,3,0,1,1,0,3,3,4,1,5,-1,-1,1,1,-2,1,-3,0,-1,-1,-1,-1,-1,4,-1
KR_6736535098,420,-6,-53,-23,-15,-7,7,0,0,2,2,2,5,7,-7,7,0,-3,3,0,0,-14,-175,3,-6,3,0,0,-2,-1,-1,-1,-1,5,-1
KR_6744902493,420,-1,-40,4,-5,0,1,1,-2,3,1,-2,3,1,-2,2,0,1,0,1,0,-9,128,0,-1,1,4,0,0,1,1,0,1,4,-1
KR_6731776419,440,-5,-53,-68,-3,-1,1,0,-3,4,1,2,1,3,0,3,3,-1,1,0,-1,0,338,1,-3,2,0,0,0,-1,-1,0,-1,3,-1
KR_6758976447,420,-1,13,2,-3,3,0,3,-2,5,3,-5,7,2,0,4,4,1,1,2,0,2,-49,2,-5,3,18,0,-2,-1,-1,-1,-1,2,-1
KR_6756272664,440,-3,-10,-32,-2,2,1,3,3,0,3,-3,4,1,-4,4,0,0,4,4,0,-3,7,5,-5,0,-3,0,-1,-1,-1,-1,1,5,-1
KR_6760547604,420,1,40,9,-5,1,0,1,-3,4,1,3,0,3,-3,4,1,-3,4,1,1,-5,13,-5,-1,6,-3,0,-2,-1,-1,-1,1,5,-1
KR_6470267202,420,-2,-21,8,-5,-2,2,0,0,1,1,3,0,3,-4,5,1,-2,2,0,0,-8,-359,-2,-4,6,2,0,-2,-1,1,-1,-1,2,-1
KR_6619407570,420,-9,-112,-36,-14,1,1,2,-2,4,2,-10,10,0,-1,4,3,-2,3,1,-1,-15,-30,-2,-1,3,1,0,-5,-1,-1,-1,-1,5,-1
KR_6752012453,420,-5,-85,-24,-15,-3,3,0,-3,7,4,-9,10,1,-1,1,0,1,0,1,0,-15,25,-5,-4,9,-21,0,-1,-1,-1,-1,-1,5,-1
KR_6706303033,440,-2,-64,-12,-5,-8,8,0,6,0,6,-2,3,1,0,2,2,-1,3,2,0,5,-10,-2,-3,5,4,0,0,1,-1,-1,-1,1,-1
KR_6751803904,420,-6,-79,21,-11,2,0,2,-5,5,0,-4,6,2,-2,2,0,-2,2,0,0,-7,48,-4,0,4,2,0,-3,-1,-1,-1,-1,6,-1
KR_6708550513,420,-3,-26,-36,3,-3,3,0,-1,1,0,0,2,2,5,1,6,2,3,5,0,5,5,-2,-3,5,2,0,-1,1,-1,-1,1,1,-1
KR_6600168125,420,-2,-17,-4,0,0,0,0,-3,6,3,1,2,3,2,2,4,0,1,1,0,-3,-6,-5,-3,8,0,0,0,1,-1,-1,1,2,-1
KR_6760830120,420,-3,-61,-42,-6,-1,5,4,0,5,5,-1,3,2,-2,2,0,-2,2,0,0,0,5,1,-6,5,-1,0,0,-1,-1,-1,1,5,-1
KR_6758974301,420,-3,-29,-5,-5,0,2,2,-1,3,2,-1,4,3,0,2,2,-3,3,0,-1,-4,-1,0,-5,5,0,0,-2,-1,-1,-1,-1,3,-1
KR_6762440698,420,-1,-14,-16,-4,1,0,1,-1,1,0,-4,5,1,3,0,3,-3,4,1,0,-1,-5,-1,-1,2,-2,0,-1,-1,-1,-1,-1,3,-1
KR_6690258038,420,-2,16,-12,-11,-2,2,0,0,3,3,0,1,1,-6,7,1,-3,3,0,0,-3,50,-1,-4,5,-29,0,-2,-1,-1,-1,1,4,-1
KR_6759942616,420,2,92,0,-2,-1,1,0,1,0,1,0,1,1,-1,4,3,-1,1,0,0,-5,300,-3,-1,4,0,0,0,1,0,0,-1,5,-1
KR_6628185535,420,-4,3,-24,0,0,1,1,4,2,6,-8,9,1,5,0,5,-1,1,0,0,7,-4,2,-6,4,0,0,0,1,-1,-1,-1,4,-1
KR_6758208581,440,-3,-47,17,-2,-2,2,0,9,4,13,-6,8,2,-2,3,1,-1,2,1,1,11,9,5,-6,1,5,0,0,1,1,-1,1,4,-1
KR_6722992919,440,-1,-36,-3,-3,1,0,1,-7,7,0,1,2,3,-3,3,0,5,0,5,0,-6,-4,2,-6,4,1,0,0,1,-1,0,-1,2,-1
KR_6692839055,420,-1,44,8,-3,0,1,1,-2,5,3,0,1,1,-1,1,0,0,0,0,0,-6,5,4,-5,1,-2,0,0,-1,-1,0,-1,2,-1
KR_6670778636,420,-2,-40,-8,-2,-1,2,1,-4,7,3,1,2,3,1,0,1,1,0,1,0,3,48,0,-3,3,-17,0,0,-1,1,0,-1,4,-1
KR_6674318589,420,3,20,25,10,0,2,2,4,3,7,1,2,3,4,2,6,1,2,3,0,9,-23,3,-6,3,6,0,0,1,-1,-1,1,4,-1
KR_6763633277,420,-2,-6,-12,-6,-3,3,0,2,1,3,-8,9,1,2,3,5,1,1,2,0,1,-5,-5,-1,6,-3,0,-1,1,-1,-1,-1,4,-1
KR_6660837015,440,-5,-85,-16,-9,-1,2,1,0,0,0,-8,9,1,0,4,4,0,2,2,0,-4,1,3,-6,3,-3,0,0,-1,1,0,-1,5,-1
KR_6605005260,420,1,46,-4,-4,0,1,1,-6,7,1,3,0,3,-2,2,0,1,0,1,0,-6,-27,-5,-3,8,1,0,0,-1,-1,0,-1,4,-1
KR_6679686965,420,-3,-70,-49,-7,-1,1,0,-6,7,1,4,0,4,-3,4,1,-1,1,0,0,-7,2,-4,-1,5,1,0,-1,-1,0,-1,-1,5,-1
KR_6761852477,420,0,-44,-43,-2,-1,3,2,3,0,3,-1,2,1,-6,7,1,3,0,3,0,-1,-2,0,-3,3,-4,0,2,1,0,1,-1,1,-1
KR_6688954020,420,0,-26,14,1,-4,4,0,6,1,7,-2,5,3,0,3,3,1,1,2,0,-1,5,1,-2,1,1,0,-1,1,0,-1,1,4,-1
KR_6754837387,420,1,20,32,-4,-1,5,4,0,2,2,-1,2,1,-2,2,0,0,1,1,0,-8,-5,-3,0,3,4,0,0,-1,0,0,-1,2,-1
KR_6764050525,420,0,-6,-16,-1,-2,4,2,4,2,6,-3,5,2,0,2,2,0,1,1,0,9,6,7,-8,1,-3,0,0,1,1,0,1,2,-1
KR_6672390014,420,0,15,12,2,1,0,1,-4,7,3,1,3,4,5,1,6,-1,2,1,0,-3,0,-2,-2,4,-2,0,1,0,1,1,-1,0,-1
KR_6669070400,420,-3,-56,8,1,-1,1,0,3,1,4,3,3,6,-1,1,0,-3,4,1,1,0,3,2,-7,5,-3,0,-1,-1,-1,-1,1,4,-1
KR_6753986618,420,-3,-64,-57,-2,-1,1,0,-4,7,3,3,2,5,-1,6,5,1,1,2,1,-6,-307,-1,-5,6,-2,0,-2,-1,-1,-1,1,1,-1
KR_6756231680,420,0,-30,4,5,-3,5,2,-2,2,0,4,2,6,6,1,7,0,4,4,1,-3,-5,-3,-3,6,4,0,-1,1,1,-1,1,4,-1
KR_6639986126,420,-4,-47,3,-11,-4,4,0,-2,4,2,3,0,3,-5,6,1,-3,4,1,0,-8,-3,-4,-1,5,-1,0,-3,-1,-1,-1,-1,1,-1
KR_6756831941,420,-1,-40,0,-2,-2,2,0,-2,3,1,3,1,4,-1,3,2,0,1,1,0,-2,2,2,-6,4,0,0,-1,-1,-1,-1,-1,5,-1
KR_6080525556,420,-2,43,14,0,0,4,4,2,0,2,-6,7,1,0,5,5,4,0,4,0,2,-16,1,-3,2,-1,0,0,1,1,-1,-1,1,-1
KR_6689116844,420,-4,-87,4,-6,-1,1,0,-1,3,2,-3,5,2,-3,6,3,2,0,2,0,1,1,2,-5,3,-4,0,-1,0,0,-1,-1,0,-1
KR_6756125894,420,0,-78,6,3,8,3,11,0,5,5,5,1,6,-10,10,0,0,0,0,-2,-1,285,-4,0,4,2,0,0,0,1,-1,-1,0,-1
KR_6749493006,420,-3,-36,0,-10,2,1,3,-1,2,1,-4,8,4,-5,5,0,-2,2,0,0,-10,19,5,-6,1,-2,0,-3,-1,-1,-1,-1,4,-1
KR_6757885131,420,-3,-2,-8,-7,-2,2,0,-1,4,3,-3,3,0,0,1,1,-1,4,3,0,-2,-13,0,-2,2,5,0,-3,-1,-1,-1,-1,6,-1
KR_6659808385,420,-4,3,-19,-3,4,1,5,1,1,2,-3,4,1,-2,7,5,-3,3,0,-1,-5,8,2,-4,2,1,0,0,-1,1,-1,-1,1,-1
KR_6714707082,420,2,-11,28,4,1,0,1,0,7,7,3,0,3,-2,3,1,2,0,2,0,2,29,-1,-4,5,0,0,0,1,-1,0,1,6,-1
KR_6764617634,420,-1,29,-12,-2,0,1,1,2,0,2,1,4,5,-2,3,1,-3,4,1,0,-8,-1,7,-10,3,-4,0,0,-1,1,0,1,4,-1
KR_6662851532,420,-1,-8,-34,1,2,3,5,2,0,2,-3,3,0,1,1,2,-1,2,1,1,1,213,6,-9,3,-4,0,-3,0,-1,-1,1,0,-1
KR_6749925925,420,1,38,-13,6,3,0,3,5,1,6,1,1,2,-4,6,2,1,0,1,0,5,5,3,-5,2,-2,0,1,0,1,1,-1,0,-1
KR_6725759565,420,-4,-98,-5,-7,-4,4,0,-2,4,2,2,3,5,-2,6,4,-1,1,0,0,-4,2,-1,-1,2,0,0,-1,-1,-1,-1,-1,1,-1
KR_6591329314,420,-4,-104,-8,-8,-3,3,0,-6,8,2,-1,4,3,2,1,3,0,1,1,0,-1,-5,-3,-1,4,0,0,-2,-1,-1,-1,-1,3,-1
KR_6761049590,440,-4,-25,-21,-9,-1,2,1,1,0,1,-1,2,1,-4,4,0,-4,5,1,0,-6,376,-1,-1,2,-1,0,-1,0,1,-1,-1,0,-1
KR_6762382090,420,-2,-63,-21,-11,1,3,4,1,2,3,-5,5,0,-3,6,3,-5,5,0,-1,-5,162,-3,-1,4,-3,0,-1,-1,-1,-1,-1,6,-1
KR_6684854207,420,-2,13,18,-7,-1,3,2,1,2,3,-5,7,2,0,4,4,-2,6,4,0,-1,1,-1,0,1,1,0,-2,1,-1,-1,1,2,-1
KR_6762767733,420,0,-76,9,3,-3,3,0,4,0,4,5,0,5,-2,2,0,-1,1,0,0,2,-10,-4,-1,5,2,0,-2,-1,-1,-1,-1,2,-1
KR_6728378352,440,3,-51,20,6,2,0,2,0,0,0,0,0,0,2,0,2,2,2,4,0,12,4,2,-4,2,-1,0,0,1,-1,0,-1,3,-1
KR_6662613304,440,-2,-22,4,-8,-1,2,1,-2,4,2,2,3,5,-4,6,2,-3,4,1,-3,-14,-193,-4,-1,5,-2,0,0,-1,1,0,-1,5,-1
KR_6743835652,440,-2,-16,16,0,1,2,3,2,3,5,3,2,5,-4,6,2,-2,2,0,0,-13,0,-1,-3,4,-2,0,-1,0,1,-1,1,0,-1
KR_6761713323,420,-2,-49,-8,-4,-2,4,2,-2,6,4,2,0,2,0,3,3,-2,4,2,0,6,13,1,-7,6,5,0,-2,1,-1,-1,-1,5,-1
KR_6763657877,420,-4,-48,-20,-14,-4,4,0,-3,5,2,-4,7,3,-1,4,3,-2,2,0,0,-9,-16,-5,-2,7,0,0,-3,-1,-1,-1,-1,5,-1
KR_6742940614,420,-2,5,0,-7,1,1,2,-7,7,0,-2,5,3,3,1,4,-2,2,0,0,-14,-1,-3,-1,4,-2,0,0,-1,1,0,-1,6,-1
KR_6721685404,420,0,-85,-20,-3,1,1,2,1,1,2,2,2,4,-6,7,1,-1,2,1,0,6,0,0,-5,5,3,0,0,-1,1,0,-1,3,-1
KR_6721229494,420,-3,-51,-40,-7,-7,8,1,0,0,0,1,0,1,-2,2,0,1,1,2,0,0,-4,-3,-2,5,-1,0,-2,-1,-1,-1,-1,6,-1
KR_6721162470,420,-2,34,-19,1,3,1,4,-5,8,3,1,2,3,1,0,1,1,1,2,-2,-7,-18,2,-3,1,-1,0,2,1,1,1,-1,5,-1
KR_6752208756,420,0,-38,16,-5,-1,1,0,2,2,4,-2,2,0,-5,5,0,1,0,1,0,-4,8,3,-6,3,1,0,0,1,0,0,-1,2,-1
KR_6755445761,420,4,-21,16,0,0,3,3,-2,4,2,-1,2,1,4,2,6,-1,4,3,0,8,-2,1,-4,3,0,0,0,-1,1,1,-1,3,-1
KR_6726647533,440,1,16,10,2,3,0,3,-2,2,0,-4,5,1,-1,3,2,6,1,7,1,7,34,-2,-2,4,1,0,0,0,-1,1,1,0,-1
KR_6760638457,420,-2,-98,6,-6,2,1,3,-1,1,0,-2,7,5,-5,5,0,0,0,0,0,0,-123,1,-2,1,0,0,-1,-1,1,-1,-1,5,-1
KR_6761731305,440,2,21,-7,9,1,1,2,2,1,3,-3,3,0,5,3,8,4,0,4,1,10,-84,3,-3,0,-2,0,0,1,-1,1,1,3,-1
KR_6698579603,420,-2,5,36,-7,-5,6,1,1,1,2,1,4,5,-3,6,3,-1,1,0,0,-6,17,-5,-3,8,-3,0,0,-1,0,0,-1,1,-1
KR_6724847795,420,-2,11,-24,-13,-4,4,0,0,1,1,0,2,2,-7,8,1,-2,3,1,0,-8,-7,1,-4,3,1,0,0,-1,-1,0,-1,3,-1
KR_6732303407,420,-1,-29,16,-2,1,1,2,1,1,2,-2,2,0,-1,1,0,-1,1,0,0,-3,-7,-8,-1,9,-6,0,-2,-1,-1,-1,-1,2,-1
KR_6679424623,420,1,-19,-4,1,3,0,3,1,1,2,-4,6,2,1,0,1,0,1,1,0,2,-1,0,-2,2,-2,0,-1,-1,-1,-1,-1,3,-1
KR_6741874586,420,0,79,-2,1,5,0,5,-5,6,1,2,2,4,0,2,2,-1,1,0,0,-3,40,7,-8,1,-5,0,1,1,1,1,1,2,-1
KR_6645274561,420,-2,-56,24,-8,-4,4,0,-4,4,0,-5,6,1,5,0,5,0,0,0,0,-4,-107,-1,0,1,0,0,-1,-1,1,-1,-1,1,-1
KR_6736243961,420,1,5,-16,6,0,2,2,-2,3,1,6,2,8,1,1,2,1,3,4,0,2,6,4,-6,2,5,0,-1,1,-1,-1,-1,3,-1
KR_6748773681,440,-1,9,-12,1,4,2,6,1,3,4,1,1,2,-5,7,2,0,2,2,1,-3,-2,-1,-2,3,-1,0,-2,-1,0,-1,1,2,-1
KR_6759375790,420,-3,-100,-52,-7,1,1,2,-4,6,2,-3,3,0,-1,5,4,0,1,1,1,-1,-3,0,-4,4,0,0,-1,1,-1,-1,1,2,-1
KR_6738891562,420,-1,19,21,-2,2,1,3,-4,4,0,-3,4,1,0,4,4,3,0,3,0,-12,5,1,-3,2,-2,0,1,-1,1,-1,-1,3,-1
KR_6750780746,420,-3,-52,-1,-4,-1,3,2,1,1,2,-5,6,1,1,0,1,0,2,2,0,-7,0,4,-7,3,-3,0,-3,-1,-1,-1,1,4,-1
KR_6636410797,420,-4,-136,-8,-10,-4,5,1,6,0,6,-6,6,0,-7,7,0,1,1,2,-1,-3,5,3,-4,1,-4,0,-3,-1,0,-1,-1,1,-1
KR_6750368838,440,3,28,14,0,2,1,3,5,2,7,0,0,0,-6,8,2,-1,3,2,0,1,-2,-7,-1,8,1,0,-1,1,-1,-1,-1,5,-1
KR_6748433584,440,1,-1,20,-1,2,1,3,-1,5,4,3,0,3,-3,3,0,-2,2,0,0,0,-23,1,-7,6,27,0,1,1,1,1,-1,1,-1
KR_6752055931,420,0,4,-20,3,0,0,0,1,1,2,-4,6,2,3,0,3,3,2,5,0,7,-9,4,-8,4,14,0,0,1,-1,0,1,3,-1
KR_6756287192,420,2,0,-4,9,0,1,1,0,4,4,5,1,6,4,2,6,0,2,2,1,11,-1,-1,-3,4,-5,0,0,1,-1,0,1,2,-1
KR_6752081010,420,-2,-57,10,-5,-1,2,1,1,1,2,-3,4,1,-1,6,5,-1,1,0,0,3,-7,-2,-1,3,-1,0,1,0,-1,1,1,0,-1
KR_6699867922,420,0,-29,-23,1,1,1,2,-4,6,2,1,2,3,2,4,6,1,2,3,0,3,11,1,-3,2,-1,0,-1,1,-1,-1,-1,1,-1
KR_6539514362,440,-2,14,-27,-1,2,0,2,-3,4,1,1,2,3,-1,1,0,0,1,1,0,-3,157,-4,-2,6,-4,0,1,-1,0,1,1,5,-1
KR_6643100922,420,3,23,-4,8,1,1,2,4,2,6,-2,6,4,2,0,2,3,0,3,-1,4,-116,-1,-3,4,2,0,0,1,-1,0,-1,2,-1
KR_6750420434,420,-4,2,-36,-8,0,2,2,-9,9,0,2,1,3,1,2,3,-2,2,0,0,-7,45,3,-5,2,-29,0,0,1,-1,0,-1,3,-1
KR_6533960097,420,-2,-100,-28,-10,2,0,2,-3,4,1,1,2,3,-6,6,0,-4,5,1,-1,-10,-63,-2,-3,5,32,0,-2,-1,0,-1,-1,4,-1
KR_6755183246,420,1,42,8,-1,-5,8,3,2,1,3,-1,3,2,5,1,6,-2,2,0,0,-11,3,0,-3,3,-4,0,0,-1,-1,1,-1,4,-1
KR_6714789646,420,2,-18,32,3,1,0,1,2,2,4,3,0,3,-4,7,3,1,0,1,0,-1,-2,-1,-5,6,-1,0,0,1,1,1,1,6,-1
KR_6650180641,420,2,-24,8,6,0,1,1,0,4,4,1,5,6,4,2,6,1,1,2,0,2,2,-1,-3,4,1,0,2,1,1,1,1,6,-1
KR_6723734515,420,-3,-85,-21,-4,-2,3,1,-1,1,0,2,1,3,-1,3,2,-2,3,1,0,-3,-37,-1,-2,3,21,0,-2,0,-1,-1,-1,0,-1
KR_6655887468,420,-2,-28,-16,2,2,4,6,-1,3,2,7,0,7,-3,4,1,-3,3,0,1,-3,2,-3,-1,4,-6,0,0,-1,-1,-1,1,6,-1
KR_6579604994,440,-5,-156,-37,-2,1,1,2,-3,3,0,0,4,4,-3,4,1,3,0,3,0,9,-1,-1,-4,5,-1,0,-2,0,-1,-1,-1,0,-1
KR_6757032506,440,1,37,-16,2,1,1,2,-2,2,0,4,0,4,0,2,2,-1,1,0,0,-5,-35,5,-7,2,4,0,2,1,1,1,-1,6,-1
KR_6735950170,420,-2,27,6,-5,-1,2,1,0,1,1,-1,2,1,-1,2,1,-2,3,1,-1,-4,1,-2,-1,3,3,0,-1,-1,1,1,-1,4,-1
KR_6760736934,420,-2,-35,4,-6,-1,3,2,2,3,5,-2,2,0,-6,7,1,1,2,3,0,-2,-5,-4,0,4,-2,0,0,-1,-1,-1,-1,6,-1
KR_6752400945,420,0,-33,-4,-3,-1,4,3,2,2,4,0,2,2,-2,5,3,-2,3,1,-1,-5,7,1,-2,1,-5,0,-1,1,1,-1,-1,4,-1
KR_5610146481,420,0,-17,-7,-2,-1,2,1,4,3,7,-2,5,3,-1,6,5,-2,2,0,0,0,-3,-3,-3,6,5,0,0,1,-1,0,-1,1,-1
KR_6670839976,420,-1,20,16,-2,1,2,3,-5,8,3,0,2,2,2,3,5,0,1,1,0,-10,6,-1,-3,4,-4,0,0,1,1,-1,1,5,-1
KR_6739080885,440,2,37,-3,-5,0,3,3,1,1,2,1,2,3,-7,8,1,0,1,1,-1,-7,-5,-2,-3,5,0,0,0,-1,1,0,-1,5,-1
KR_6756507739,420,-4,-70,-31,-15,0,2,2,-12,12,0,4,0,4,-5,6,1,-2,3,1,0,-15,-1,0,-3,3,-1,0,-1,-1,0,-1,-1,3,-1
KR_6759709352,420,-2,-25,-16,-1,-1,3,2,3,2,5,2,1,3,-4,6,2,-1,2,1,0,1,290,1,-1,0,-2,0,0,1,1,0,-1,2,-1
KR_6677846599,420,0,32,-16,-2,2,0,2,-1,4,3,3,0,3,-4,6,2,-2,2,0,0,-6,-18,3,-6,3,-3,0,-1,-1,-1,-1,1,4,-1
KR_6627851792,420,-1,3,8,-7,1,0,1,-2,4,2,-2,4,2,-2,4,2,-2,6,4,0,-6,-3,-3,-2,5,0,0,0,-1,-1,0,1,2,-1
KR_6759477517,420,0,-37,-8,4,-4,5,1,1,0,1,3,1,4,3,2,5,1,1,2,1,0,-5,3,-4,1,3,0,0,-1,1,0,1,1,-1
KR_6764131645,420,-2,-5,-20,2,3,2,5,-1,4,3,0,4,4,1,1,2,-1,3,2,1,-7,-14,-1,-2,3,-1,0,0,1,1,1,1,5,-1
KR_6588230746,420,-2,-79,7,-3,0,1,1,3,4,7,-4,6,2,-2,3,1,0,3,3,-1,-3,3,0,-3,3,-4,0,-2,0,-1,-1,-1,0,-1
KR_6643105073,420,-3,-9,12,-5,-2,2,0,-5,5,0,0,2,2,2,1,3,0,0,0,0,-3,-4,1,-6,5,-7,0,-2,-1,-1,-1,1,4,-1
KR_6753099816,420,0,-4,4,-3,-1,1,0,6,2,8,-4,5,1,-2,2,0,-2,2,0,0,-6,12,-1,-4,5,-3,0,0,1,-1,0,1,4,-1
KR_6724485224,420,-4,-27,-24,-3,1,4,5,0,2,2,-2,5,3,0,3,3,-2,3,1,0,6,-7,3,-4,1,-3,0,-1,-1,0,1,1,4,-1
KR_6039272808,420,2,-18,-29,4,1,5,6,-2,3,1,-1,3,2,3,2,5,3,0,3,2,9,-6,1,-6,5,-1,0,0,-1,1,-1,1,5,-1
KR_6592229199,420,0,-42,-8,1,0,1,1,0,2,2,0,7,7,2,2,4,-1,2,1,1,8,16,2,-3,1,-2,0,0,0,1,0,1,0,-1
KR_6757335880,420,-2,10,-36,-8,1,1,2,0,4,4,-4,6,2,-2,3,1,-3,3,0,0,-5,131,3,-6,3,0,0,-1,-1,-1,-1,1,2,-1
KR_6760198485,420,-3,2,-8,-11,2,2,4,-1,3,2,-1,4,3,-10,11,1,-1,2,1,0,-18,-1,1,-4,3,-3,0,-2,-1,1,-1,-1,2,-1
KR_6751868730,420,-2,67,-27,2,4,0,4,-2,4,2,1,1,2,-1,2,1,0,3,3,0,-5,20,-4,-1,5,3,0,0,1,1,-1,-1,6,-1
KR_6602940939,420,-3,-1,-2,-6,3,3,6,-1,2,1,1,0,1,-7,7,0,-2,2,0,-1,-10,256,-1,-3,4,0,0,-2,-1,-1,-1,-1,1,-1
KR_6762486320,420,-1,23,-4,-2,5,0,5,-2,3,1,4,0,4,-4,5,1,-5,5,0,0,-7,-210,3,-4,1,-4,0,0,-1,-1,-1,-1,3,-1
KR_6695165937,420,-5,-36,7,-12,1,2,3,-3,4,1,-6,7,1,-6,8,2,2,1,3,0,-13,-5,-1,-1,2,-2,0,0,-1,-1,-1,-1,2,-1
KR_6696533292,420,-2,-71,-4,-5,-1,2,1,0,3,3,0,2,2,-5,6,1,1,0,1,0,-6,-540,2,-5,3,-1,0,0,0,-1,0,-1,0,-1
KR_6754228807,420,-2,52,4,-3,-1,1,0,1,2,3,-5,6,1,2,1,3,0,0,0,-1,-6,-10,1,-5,4,2,0,0,1,-1,0,-1,4,-1
KR_6723442834,420,-1,-4,7,0,-1,3,2,3,0,3,-2,2,0,0,2,2,0,0,0,0,1,30,-2,-3,5,-3,0,0,-1,-1,1,1,4,-1
KR_6733467549,420,-2,-52,8,-6,-1,2,1,-2,3,1,-2,4,2,-3,8,5,2,1,3,-3,-9,-133,-6,-2,8,-1,0,0,1,-1,0,-1,6,-1
KR_6678342263,420,-9,-31,-105,-10,-3,4,1,-6,10,4,1,3,4,1,4,5,-3,7,4,0,-8,-8,-3,0,3,0,0,-2,-1,-1,-1,1,1,-1
KR_6677558758,420,-2,-43,0,-7,-1,3,2,-1,2,1,-3,4,1,1,0,1,-3,3,0,0,-5,-7,0,-2,2,-2,0,-2,-1,-1,-1,-1,4,-1
KR_6732588850,420,-2,-26,-5,-7,-4,5,1,2,1,3,-2,5,3,-3,3,0,0,0,0,0,-3,-89,4,-7,3,-3,0,0,-1,1,1,-1,2,-1
KR_6634597272,420,4,-29,16,9,3,0,3,4,1,5,0,0,0,2,2,4,0,0,0,0,10,-181,0,-3,3,-1,0,0,1,1,0,1,6,-1
KR_6750657292,420,-3,-7,-16,-14,2,1,3,-4,5,1,-6,6,0,-5,6,1,-1,1,0,0,-21,9,6,-7,1,-2,0,-3,-1,-1,-1,-1,1,-1
KR_6746247890,420,5,77,9,12,1,1,2,1,0,1,1,0,1,10,0,10,-1,2,1,-1,12,-3,-2,-5,7,-3,0,0,-1,-1,0,-1,4,-1
KR_6753068534,420,-2,7,-29,4,3,2,5,1,4,5,-4,4,0,1,1,2,3,0,3,0,3,-12,0,-1,1,0,0,1,-1,1,1,-1,6,-1
KR_6761848325,420,-2,-53,44,1,2,1,3,1,1,2,-1,3,2,-1,5,4,0,1,1,0,0,-503,2,-3,1,0,0,-2,-1,-1,-1,1,6,-1
KR_6642289587,420,0,-47,-4,-4,-1,1,0,-4,5,1,-2,4,2,2,1,3,1,0,1,0,-6,6,2,-3,1,-1,0,0,-1,-1,-1,-1,2,-1
KR_6757583795,420,-4,-61,-37,-5,-2,5,3,1,1,2,-3,5,2,3,1,4,-4,4,0,0,1,-12,4,-6,2,-1,0,-2,-1,-1,-1,-1,5,-1
KR_6760429145,420,1,-27,-16,3,1,0,1,3,3,6,-5,5,0,3,1,4,1,0,1,0,12,3,1,-4,3,1,0,-1,1,-1,-1,-1,6,-1
KR_6733021800,420,0,86,-4,-3,3,1,4,0,2,2,0,2,2,-8,10,2,2,1,3,0,-5,1,-2,-2,4,1,0,0,-1,0,1,-1,5,-1
KR_6757744704,420,-2,28,-30,-3,-3,3,0,-6,7,1,4,1,5,2,2,4,0,1,1,0,-6,1,-1,-2,3,3,0,-1,-1,-1,-1,1,2,-1
KR_6742947176,420,-2,-29,41,-3,-6,6,0,3,1,4,1,2,3,0,1,1,-1,1,0,-1,-9,-41,-7,-1,8,2,0,0,-1,-1,0,-1,2,-1
KR_6674201226,420,-3,-6,13,-10,-2,4,2,-5,7,2,-2,3,1,0,1,1,-1,1,0,0,-2,-63,-1,-1,2,0,0,-1,-1,0,-1,-1,5,-1
KR_6742244893,420,1,-41,0,3,0,0,0,2,2,4,1,4,5,1,2,3,-1,1,0,0,3,2,1,-2,1,0,0,-1,-1,-1,-1,1,4,-1
KR_6761771359,420,-2,-71,-8,-8,-1,2,1,0,2,2,1,1,2,-6,6,0,-2,2,0,0,-2,10,2,-4,2,-2,0,-1,-1,-1,-1,-1,4,-1
KR_6679535421,420,2,-63,32,6,-5,5,0,7,1,8,2,2,4,2,2,4,0,1,1,0,9,4,4,-5,1,1,0,0,1,-1,0,-1,6,-1
KR_6682367805,420,-9,-172,-35,-2,-4,4,0,2,2,4,-2,2,0,1,4,5,1,2,3,-1,-1,4,0,-1,1,2,0,-3,1,-1,-1,-1,6,-1
KR_6758890925,440,-1,-14,-6,-6,-1,4,3,0,1,1,-7,7,0,2,2,4,0,1,1,0,3,6,1,-4,3,-1,0,0,-1,-1,0,-1,4,-1
KR_6748418216,420,-5,-93,5,-17,-1,1,0,-4,4,0,-6,6,0,-7,7,0,1,2,3,0,-14,-7,-1,-2,3,2,0,-3,-1,-1,-1,-1,6,-1
KR_6673185981,420,-6,-48,-21,-10,-6,7,1,3,1,4,-3,4,1,-1,5,4,-3,3,0,0,-8,-5,-2,-5,7,6,0,0,-1,1,-1,-1,1,-1
KR_6679060341,440,-1,20,12,0,2,1,3,-1,4,3,-3,4,1,2,3,5,0,1,1,0,-6,-4,-1,-2,3,1,0,1,-1,-1,1,-1,2,-1
KR_6758366722,420,-1,-54,-17,-6,4,0,4,1,3,4,-5,7,2,-6,8,2,0,1,1,-3,-4,110,4,-9,5,-3,0,-2,-1,0,-1,-1,1,-1
KR_6717530471,420,-2,10,0,-5,-4,5,1,-1,1,0,0,1,1,0,2,2,0,1,1,0,-7,368,-1,-5,6,-6,0,1,1,1,1,1,4,-1
KR_6730050387,440,-1,45,-23,7,-2,2,0,4,1,5,2,1,3,0,3,3,3,1,4,0,3,-1,3,-8,5,-2,0,1,0,1,1,1,0,-1
KR_6624672851,420,-1,-79,32,-2,-4,5,1,0,2,2,-1,1,0,4,3,7,-1,1,0,0,6,0,0,-5,5,1,0,0,1,1,1,-1,4,-1
KR_5679723534,420,-3,13,-52,-7,0,1,1,-6,8,2,-2,2,0,3,1,4,-2,3,1,1,-16,-65,-4,-1,5,1,0,0,-1,0,0,1,5,-1
KR_6690472820,420,-1,-16,16,-5,-1,3,2,-2,3,1,-1,3,2,-1,3,2,0,1,1,1,7,-4,2,-3,1,-3,0,0,1,0,0,1,2,-1
KR_6762123313,420,3,13,13,3,-6,8,2,0,1,1,7,1,8,1,0,1,1,1,2,1,-3,16,0,-2,2,3,0,0,-1,-1,0,1,4,-1
KR_6761198956,440,-1,77,-12,-2,3,0,3,-2,2,0,-1,4,3,-2,5,3,0,1,1,1,-7,328,3,-6,3,-5,0,0,-1,-1,0,1,4,-1
KR_6761408051,420,-5,-76,16,-5,-1,2,1,3,1,4,-8,8,0,0,0,0,1,0,1,0,1,-9,-4,-1,5,3,0,-3,-1,-1,-1,-1,6,-1
KR_6711632534,420,-1,-40,0,2,-3,3,0,3,2,5,2,2,4,-1,6,5,1,2,3,-1,1,-38,-4,-4,8,3,0,-2,1,-1,-1,-1,4,-1
KR_6764483177,420,0,-8,-4,-6,-1,2,1,-3,3,0,1,2,3,-3,6,3,0,1,1,0,-8,-5,-2,-2,4,-2,0,-1,-1,1,-1,1,6,-1
KR_6760525212,420,-2,24,-8,-4,0,2,2,0,3,3,-3,5,2,1,2,3,-2,3,1,0,-2,15,-3,-2,5,2,0,-1,-1,-1,-1,-1,5,-1
KR_6700796220,420,-7,-74,-32,-15,0,1,1,-2,3,1,-2,3,1,-11,16,5,0,1,1,-2,-21,-9,-2,0,2,-1,0,-1,-1,1,-1,-1,4,-1
KR_6624181427,420,-2,-9,-11,1,0,2,2,1,4,5,-1,1,0,1,3,4,0,1,1,1,5,193,-3,-2,5,24,0,-3,1,-1,-1,1,6,-1
KR_6502113407,420,-4,-31,-16,-8,0,2,2,-4,5,1,7,1,8,-10,10,0,-1,2,1,-1,-12,-1,0,-5,5,0,0,-2,-1,1,-1,-1,3,-1
KR_6740811862,420,0,10,-72,-6,2,1,3,-2,3,1,-8,9,1,1,3,4,1,2,3,-1,-1,20,0,-1,1,0,0,-2,-1,-1,-1,-1,2,-1
KR_6719013459,440,-3,-8,-39,-9,-2,3,1,-1,3,2,1,4,5,-5,6,1,-2,4,2,-1,-11,-2,-4,-1,5,0,0,-1,0,-1,-1,-1,0,-1
KR_6639860386,440,1,9,2,1,0,1,1,-1,4,3,-1,4,3,0,1,1,3,0,3,0,5,-5,-4,-3,7,6,0,0,0,-1,1,-1,0,-1
KR_6736762802,420,-2,-6,31,-4,3,3,6,-6,7,1,2,2,4,-2,3,1,-1,1,0,0,-17,-8,-3,-6,9,-2,0,0,-1,-1,-1,-1,2,-1
KR_6390881616,440,-2,-28,-7,0,-1,1,0,1,5,6,-1,2,1,3,4,7,-2,2,0,-1,4,39,2,-7,5,-15,0,1,-1,0,1,-1,6,-1
KR_6701964281,420,0,-43,-24,6,1,1,2,2,0,2,5,1,6,1,1,2,-3,3,0,1,7,-3,4,-7,3,0,0,0,0,1,1,1,0,-1
KR_6640156110,420,-2,-20,0,-4,0,2,2,0,0,0,-1,3,2,-3,4,1,0,1,1,1,3,13,1,-2,1,-1,0,-1,-1,1,-1,1,5,-1
KR_6634350249,420,-1,75,-29,4,4,0,4,1,4,5,0,2,2,-1,3,2,0,0,0,0,2,8,5,-6,1,-4,0,0,-1,-1,-1,1,2,-1
KR_6759023507,420,-3,-28,-36,-4,-7,7,0,0,1,1,-4,4,0,6,0,6,1,0,1,0,3,29,2,-6,4,-1,0,-1,-1,1,-1,-1,2,-1
KR_6701889858,420,-1,-27,-8,-2,-2,2,0,-1,3,2,0,2,2,2,1,3,-1,1,0,0,4,10,1,-2,1,-3,0,0,0,-1,0,-1,0,-1
KR_6764636142,440,-7,-70,-49,-10,0,1,1,0,0,0,-6,6,0,-3,4,1,-1,3,2,0,-3,33,0,-3,3,-4,0,-2,-1,-1,-1,-1,5,-1
KR_6610557235,420,-3,-30,-8,-9,-5,5,0,-3,5,2,-3,3,0,1,5,6,1,0,1,0,-8,-3,-1,-3,4,0,0,0,1,1,1,-1,2,-1
KR_6701335226,420,-4,16,-8,-15,-4,4,0,-1,2,1,-4,4,0,-2,4,2,-4,5,1,0,-16,2,-1,-3,4,3,0,-1,-1,-1,-1,-1,5,-1
KR_6643351146,420,2,53,-12,5,4,2,6,-1,4,3,0,1,1,1,0,1,1,0,1,0,5,-398,4,-4,0,1,0,1,-1,1,1,1,3,-1
KR_6761289834,420,0,-55,-10,2,-2,2,0,2,0,2,-6,7,1,7,2,9,1,0,1,0,10,207,0,-4,4,4,0,-2,1,-1,-1,1,5,-1
KR_6670649011,420,3,-10,-2,-1,2,2,4,2,1,3,-3,3,0,-1,2,1,-1,1,0,0,-5,30,5,-5,0,1,0,1,-1,1,1,-1,6,-1
KR_6662486684,440,1,-32,24,-1,0,3,3,1,1,2,-1,3,2,0,4,4,-1,1,0,4,7,1,4,-8,4,-3,0,-1,0,0,-1,1,0,-1
KR_6687411913,420,-2,21,10,3,1,3,4,1,1,2,0,3,3,0,1,1,1,1,2,0,4,-9,-1,-3,4,1,0,0,-1,-1,0,1,4,-1
KR_6742926079,440,0,23,-13,2,0,1,1,0,1,1,5,0,5,0,3,3,-3,3,0,2,6,-7,0,-3,3,2,0,-1,-1,0,-1,1,5,-1
KR_6740585226,440,1,17,12,2,0,4,4,-2,3,1,-1,4,3,4,5,9,1,1,2,0,6,-4,3,-6,3,2,0,0,-1,-1,-1,-1,4,-1
KR_6665035088,420,-4,-82,-30,-7,0,1,1,-4,4,0,-4,4,0,-1,5,4,2,0,2,-1,-9,37,-2,0,2,0,0,-1,-1,-1,-1,-1,6,-1
KR_6732494041,420,-4,-44,-10,1,0,2,2,-3,6,3,0,5,5,1,1,2,3,3,6,0,-2,98,1,-3,2,24,0,-1,-1,0,-1,-1,3,-1
KR_6682040532,420,-3,-12,-1,-6,-5,5,0,1,1,2,3,1,4,-3,4,1,-2,2,0,-1,-4,-2,-4,-1,5,1,0,-1,-1,-1,-1,-1,3,-1
KR_6737118120,420,-7,-29,-34,-9,2,1,3,-1,4,3,0,2,2,-9,9,0,-1,1,0,0,-14,7,8,-10,2,1,0,0,1,-1,1,1,5,-1
KR_6736349403,420,0,-3,-12,-6,0,2,2,-1,1,0,-3,6,3,0,1,1,-2,8,6,0,-11,-5,-3,-2,5,3,0,-1,-1,0,-1,1,4,-1
KR_6645735896,420,0,-42,12,-1,2,0,2,1,0,1,1,1,2,-2,3,1,-3,4,1,0,2,7,2,-4,2,-3,0,0,-1,1,0,-1,2,-1
KR_6649854323,420,2,67,-4,-1,1,2,3,-2,4,2,1,2,3,-1,5,4,0,0,0,0,-6,1,3,-7,4,-3,0,0,0,0,0,-1,0,-1
KR_6713088925,420,1,6,-8,4,0,3,3,0,0,0,0,0,0,1,4,5,3,1,4,0,5,0,-1,-2,3,-3,0,0,-1,1,1,-1,2,-1
KR_6763453691,420,-5,-100,-12,-7,-1,2,1,-1,3,2,-5,5,0,0,3,3,0,1,1,0,-4,0,-3,-3,6,-1,0,-2,-1,-1,-1,-1,6,-1
KR_6685999943,420,-6,-86,-8,-12,-5,5,0,2,3,5,-3,5,2,-5,6,1,-1,1,0,-2,-10,-12,-4,-2,6,-1,0,-1,-1,-1,-1,-1,6,-1
KR_6665365976,420,-7,-59,-16,-13,2,1,3,2,2,4,-12,12,0,-7,7,0,2,0,2,0,-16,-25,-1,-4,5,-1,-1,-3,-1,-1,-1,-1,6,-1
KR_6698080194,420,0,-51,51,-5,5,1,6,0,0,0,-2,3,1,-7,7,0,-1,4,3,-1,-5,-3,1,-3,2,0,0,0,-1,1,1,-1,2,-1
KR_6711544710,420,0,19,8,2,-1,1,0,4,0,4,3,2,5,-4,7,3,0,0,0,1,1,5,4,-6,2,1,0,0,1,-1,-1,1,4,-1
KR_6719426034,420,-2,-80,12,2,-5,5,0,2,1,3,-4,5,1,8,1,9,1,0,1,-1,9,-12,2,-6,4,-6,0,-1,1,-1,-1,-1,5,-1
KR_6196170900,420,0,-13,34,-2,-1,1,0,-6,9,3,2,0,2,4,1,5,-1,1,0,0,-8,-1,4,-5,1,-1,0,0,1,-1,1,1,2,-1
KR_6715390524,420,-1,-20,-8,1,2,2,4,-3,5,2,0,3,3,1,3,4,1,1,2,-4,-8,-28,6,-8,2,-5,0,0,0,1,0,-1,0,-1
KR_6727469139,420,0,-108,0,1,-1,1,0,4,1,5,-1,1,0,-2,4,2,1,0,1,0,4,0,1,-5,4,-3,0,0,-1,0,0,-1,1,-1
KR_6748571958,420,-1,0,-26,-1,0,1,1,-6,10,4,0,1,1,5,0,5,0,0,0,0,0,2,-2,-2,4,-1,0,1,1,1,1,1,5,-1
KR_6747576519,440,1,79,-23,-3,-1,2,1,-7,8,1,4,0,4,-1,2,1,2,2,4,0,-10,-17,-4,-2,6,-1,0,0,1,-1,0,1,5,-1
KR_6759374120,420,-2,-76,-12,-7,3,0,3,0,1,1,-2,3,1,-8,8,0,0,1,1,0,-10,167,3,-7,4,-1,0,-1,-1,0,-1,-1,4,-1
KR_6710245693,420,-3,-31,-32,0,4,1,5,0,2,2,1,2,3,-6,6,0,1,0,1,1,-4,-14,0,-3,3,2,0,-1,-1,1,-1,1,3,-1
KR_6619212364,420,-5,-75,-4,-19,-1,2,1,-6,6,0,-3,4,1,-5,9,4,-4,4,0,0,-13,107,-7,0,7,4,0,-3,-1,-1,-1,-1,5,-1
KR_6694324753,440,-5,-93,-5,-9,-6,6,0,2,2,4,-3,4,1,-3,5,2,1,0,1,0,-1,5,3,-5,2,-5,0,0,-1,-1,-1,-1,1,-1
KR_6755433407,420,-2,-110,-8,-3,-2,2,0,1,1,2,-2,3,1,0,1,1,0,0,0,0,0,-4,-2,-1,3,-2,0,-1,-1,-1,-1,-1,4,-1
KR_6645814994,420,-4,-88,-18,-15,-6,9,3,1,0,1,-4,4,0,-4,4,0,-2,3,1,0,-8,-158,1,-2,1,-1,0,-1,-1,-1,-1,-1,5,-1
KR_6761325930,420,-1,8,4,1,0,1,1,1,1,2,-2,7,5,4,1,5,-2,2,0,0,4,5,3,-7,4,-1,0,1,0,0,1,1,0,-1
KR_6764194068,420,-3,-30,-31,-4,-2,3,1,-1,3,2,-1,1,0,0,2,2,0,1,1,0,3,4,3,-3,0,-2,0,2,0,0,1,1,0,-1
KR_6726037802,420,0,-31,-12,4,0,3,3,4,0,4,0,3,3,-1,3,2,1,1,2,0,1,-109,-4,-2,6,-2,0,-1,1,-1,-1,-1,4,-1
KR_6760757635,440,-1,-6,-15,-1,2,3,5,-1,3,2,-2,2,0,0,1,1,0,1,1,0,4,-3,2,-6,4,-2,0,-1,1,-1,-1,-1,4,-1
KR_6737611354,420,-3,-17,-3,-3,-6,7,1,5,1,6,3,0,3,-3,5,2,-2,2,0,0,-6,3,0,-2,2,0,0,-1,-1,-1,-1,1,5,-1
KR_6652829691,440,1,38,31,7,6,0,6,2,2,4,2,1,3,-1,5,4,-2,4,2,0,-2,6,1,-1,0,0,0,1,1,1,1,-1,6,-1
KR_6750612289,420,-6,5,-42,-6,1,0,1,-2,2,0,-3,3,0,-1,4,3,-1,5,4,0,5,-28,4,-6,2,-3,0,0,0,-1,0,-1,0,-1
KR_6759026530,420,0,42,-3,-8,-1,2,1,1,4,5,-3,5,2,1,4,5,-6,6,0,-1,-5,-5,-1,-5,6,1,0,-1,0,-1,-1,-1,0,-1
KR_6764676819,420,0,2,24,-3,-2,2,0,1,1,2,1,0,1,-2,3,1,-1,1,0,0,-2,406,3,-4,1,4,0,-1,0,1,-1,-1,0,-1
KR_6700811503,420,-4,16,-28,-8,0,3,3,-3,5,2,-6,7,1,2,3,5,-1,1,0,0,-7,9,-3,-1,4,-1,0,0,-1,-1,-1,-1,4,-1
KR_6714782262,420,-1,23,-27,-5,0,2,2,-4,5,1,0,4,4,0,2,2,-1,1,0,0,-11,-3,-3,-1,4,1,0,1,0,-1,1,-1,0,-1
KR_6648483658,420,-6,-88,-32,-7,-1,3,2,-3,3,0,1,1,2,0,2,2,-4,5,1,0,0,12,-4,-4,8,-1,0,-2,0,-1,-1,1,0,-1
KR_6755143201,420,3,36,16,5,-1,1,0,0,1,1,0,1,1,4,0,4,2,0,2,0,6,13,0,-3,3,1,0,1,-1,1,1,1,2,-1
KR_5693769393,420,-2,-68,-20,-3,-3,5,2,7,0,7,-4,5,1,-2,3,1,-1,1,0,0,2,-11,-2,-2,4,-2,0,-1,-1,-1,-1,-1,6,-1
KR_6719221295,420,-3,-85,-9,-13,-2,3,1,-1,3,2,-2,2,0,-1,3,2,-7,7,0,0,-8,-8,-7,-1,8,1,0,-2,-1,-1,-1,-1,6,-1
KR_6722980345,440,-4,-43,-9,-4,-6,7,1,0,4,4,0,5,5,2,2,4,0,3,3,0,-1,-227,1,-5,4,-1,0,-1,-1,-1,-1,-1,2,-1
KR_6658381067,420,-2,-70,-11,1,4,0,4,-4,4,0,0,2,2,1,1,2,0,0,0,0,-4,-106,2,-5,3,-5,0,0,-1,-1,0,-1,1,-1
KR_6746192191,420,-4,68,-5,-9,-3,3,0,1,0,1,-7,8,1,1,2,3,-1,1,0,0,-10,-15,-1,-4,5,-8,0,0,1,-1,-1,-1,6,-1
KR_6636520444,420,0,-18,-20,-5,2,1,3,2,1,3,-3,6,3,-4,6,2,-2,3,1,-2,-8,-8,-3,-3,6,-3,0,-2,-1,-1,-1,-1,1,-1
KR_6742952132,420,-6,-90,-23,-15,-2,2,0,-1,1,0,-4,4,0,-5,5,0,-3,3,0,0,-13,-33,-4,0,4,1,-1,-4,1,-1,-1,-1,1,-1
KR_6754979332,420,-3,-17,17,-10,-5,5,0,-2,2,0,3,2,5,-2,4,2,-4,5,1,0,-8,-369,0,-2,2,-1,0,0,-1,1,1,1,3,-1
KR_6732834646,420,-3,10,-10,-8,-2,2,0,-2,4,2,3,3,6,-7,7,0,0,0,0,0,-15,-140,-4,-4,8,0,0,0,-1,-1,-1,1,2,-1
KR_6721631529,420,-7,-48,-34,-19,-4,5,1,-5,6,1,-2,3,1,-7,9,2,-1,2,1,0,-12,-14,-1,-6,7,1,0,-4,1,-1,-1,-1,1,-1
KR_6761539338,440,-2,6,21,-2,-1,2,1,3,0,3,-4,5,1,1,1,2,-1,2,1,0,0,-6,-3,-1,4,1,0,-1,-1,0,-1,-1,1,-1
KR_6758972182,440,-4,-54,11,-11,1,2,3,-3,5,2,4,0,4,-14,16,2,1,2,3,0,0,-1,-1,-4,5,-1,0,-1,1,1,-1,-1,1,-1
KR_6764013359,420,-5,-95,-5,-17,-5,5,0,-1,4,3,-3,4,1,-2,5,3,-6,6,0,-1,-15,-251,-2,-2,4,0,0,-2,-1,1,-1,-1,2,-1
KR_6683384273,440,-2,16,24,-7,0,0,0,-6,8,2,1,2,3,-3,4,1,1,0,1,0,-6,0,-1,-3,4,0,0,0,1,-1,0,-1,4,-1
KR_6655919730,420,-5,-22,-9,-11,1,2,3,-1,2,1,-4,6,2,-6,7,1,-1,1,0,0,-13,48,-3,0,3,-31,0,0,-1,1,1,-1,3,-1
KR_6759346456,420,-3,-59,11,8,1,0,1,7,2,9,-4,6,2,4,1,5,0,2,2,-1,5,11,3,-3,0,-3,0,0,1,1,-1,-1,4,-1
KR_6760792553,440,-2,-32,-8,-4,3,0,3,-1,1,0,-2,2,0,-3,3,0,-1,1,0,0,-8,5,3,-5,2,-1,0,0,-1,-1,0,1,3,-1
KR_6731706396,440,-1,-54,-15,0,2,0,2,-3,7,4,-1,3,2,0,2,2,2,1,3,0,-4,270,4,-8,4,-8,0,0,-1,1,0,-1,2,-1
KR_6609022818,420,0,-76,-12,-3,0,1,1,0,2,2,0,3,3,-3,3,0,0,1,1,-1,-2,3,0,-3,3,2,0,-1,-1,1,-1,-1,5,-1
KR_6704875220,420,-3,-69,-22,-10,-1,4,3,0,2,2,-2,4,2,-2,4,2,-5,7,2,0,-6,-321,1,-3,2,-22,0,-2,-1,-1,-1,-1,6,-1
KR_6626508788,420,-1,11,0,-6,0,2,2,-3,3,0,-3,4,1,-1,1,0,1,0,1,0,-3,-4,2,-4,2,0,0,0,-1,-1,0,-1,4,-1
KR_6683399114,420,-1,-27,-8,0,3,1,4,-1,4,3,-5,7,2,1,1,2,2,0,2,1,-3,2,1,-4,3,-4,0,0,-1,0,0,1,1,-1
KR_6636080097,420,-5,-98,8,-11,-2,2,0,-2,5,3,-4,6,2,-4,4,0,1,1,2,0,-4,14,6,-8,2,-5,0,0,0,1,0,-1,0,-1
KR_5701597751,420,-1,6,-32,-5,0,0,0,3,2,5,-2,5,3,-8,8,0,2,1,3,0,-1,7,0,-4,4,-1,0,-1,-1,0,-1,-1,1,-1
KR_6761879275,420,-5,16,-34,-7,-4,4,0,3,0,3,-4,5,1,1,2,3,-3,5,2,2,-7,2,2,-5,3,-1,0,0,-1,0,0,1,3,-1
KR_6507051783,420,-3,-19,-15,-6,2,1,3,-8,10,2,-1,5,4,2,3,5,-1,2,1,1,1,19,2,-4,2,0,0,-1,-1,-1,-1,1,3,-1
KR_6665927435,420,-2,-83,-20,-4,2,0,2,-2,3,1,-3,6,3,-2,2,0,1,0,1,0,-1,13,4,-5,1,3,0,1,1,1,1,-1,5,-1
KR_6622144242,420,-1,-33,4,0,-1,2,1,0,0,0,-1,2,1,2,0,2,0,0,0,0,0,185,1,-3,2,0,0,0,1,-1,0,1,6,-1
KR_6657026329,440,-1,16,7,2,0,0,0,-5,5,0,-2,2,0,4,2,6,5,1,6,0,5,-16,-2,-1,3,-1,0,1,-1,1,1,1,5,-1
KR_6742702356,420,2,68,-12,5,2,0,2,-5,5,0,6,0,6,3,1,4,-1,1,0,0,3,-32,1,-2,1,3,0,1,1,1,1,1,3,-1
KR_6495320747,420,0,-23,12,1,0,2,2,2,3,5,4,1,5,-5,5,0,0,1,1,-1,-3,49,-1,-1,2,-3,0,1,1,0,1,-1,3,-1
KR_6763586572,420,0,-25,7,2,-4,6,2,3,1,4,0,8,8,4,2,6,-1,2,1,1,4,-1,4,-5,1,-2,0,0,1,-1,1,1,3,-1
KR_6734930534,440,-5,-50,-26,-6,0,0,0,-4,5,1,1,0,1,-2,5,3,-1,1,0,0,-11,-30,3,-4,1,25,0,0,-1,-1,-1,-1,4,-1
KR_6716750150,420,-4,-42,-44,-2,-1,1,0,11,2,13,-3,5,2,-8,9,1,-1,1,0,0,2,-177,1,-3,2,-3,0,-2,-1,-1,-1,1,6,-1
KR_6763918819,420,2,-23,-12,0,3,1,4,3,0,3,-4,6,2,-2,4,2,0,0,0,0,-4,12,0,-4,4,2,0,0,0,0,1,-1,0,-1
KR_6723741968,440,-1,-45,-16,-1,-5,5,0,0,3,3,8,0,8,-3,6,3,-1,2,1,-1,-5,5,3,-3,0,-3,0,0,-1,1,-1,-1,6,-1
KR_6705300432,420,-6,-59,-44,-6,-4,4,0,2,2,4,0,1,1,-4,5,1,0,0,0,0,2,-8,-4,-1,5,0,0,-1,-1,-1,-1,-1,3,-1
KR_6422582938,440,-6,-38,-29,-18,-3,4,1,-6,8,2,-1,2,1,-5,5,0,-3,4,1,0,-18,-9,-2,-2,4,4,0,-1,-1,-1,-1,-1,1,-1
KR_6360105879,420,-5,-68,-18,-10,-4,4,0,-4,4,0,-1,2,1,1,1,2,-2,2,0,1,-6,0,0,0,0,-7,0,-1,-1,-1,-1,1,3,-1
KR_6736420336,420,-2,0,15,-12,2,0,2,2,1,3,-3,5,2,-7,9,2,-6,6,0,1,-5,-21,-4,-2,6,3,0,0,0,0,0,1,0,-1
KR_6743511151,420,-5,-124,-16,-8,-7,7,0,1,2,3,-4,8,4,3,2,5,-1,1,0,-1,8,-2,-2,-2,4,0,0,-3,-1,-1,-1,-1,5,-1
KR_6622623343,420,-2,-33,-4,5,-2,4,2,3,2,5,3,0,3,-2,8,6,3,0,3,1,10,0,2,-3,1,0,0,-1,0,0,-1,1,0,-1
KR_6763312410,420,-2,-2,20,-7,-3,3,0,-1,1,0,-1,1,0,-3,3,0,1,1,2,0,-10,-1,-2,-3,5,-5,0,0,-1,-1,0,-1,3,-1
KR_6701925624,420,-4,-83,7,-11,-6,6,0,0,0,0,-6,6,0,1,0,1,0,0,0,0,-6,0,-3,0,3,1,0,-2,-1,-1,-1,-1,2,-1
KR_6759304234,420,-7,-160,-30,-14,-3,4,1,4,0,4,-11,11,0,-2,4,2,-2,2,0,-1,-6,192,-2,-2,4,26,0,-2,-1,1,-1,-1,3,-1
KR_6624709333,420,-6,-141,-8,-3,-3,3,0,-3,4,1,2,1,3,-4,4,0,5,1,6,0,2,-5,-3,-2,5,-2,0,-1,-1,0,-1,-1,1,-1
KR_6670395955,420,-2,-37,-16,-3,-1,3,2,-2,3,1,-4,6,2,4,0,4,0,0,0,0,6,-163,1,-3,2,4,0,-1,0,-1,-1,-1,0,-1
KR_6747147071,420,-3,-45,0,-7,1,3,4,1,0,1,-4,7,3,-1,4,3,-4,4,0,0,-6,-4,0,-5,5,-1,0,-3,-1,-1,-1,-1,1,-1
KR_6763397081,420,2,18,4,-1,0,0,0,-1,2,1,-4,6,2,2,1,3,2,1,3,0,3,0,-2,-3,5,0,0,1,0,1,1,1,0,-1
KR_6761216957,420,-2,-8,-31,-1,1,1,2,-2,5,3,0,2,2,-1,2,1,1,2,3,0,-4,-2,-4,-3,7,3,0,0,1,-1,0,1,6,-1
KR_6741200954,420,-3,-28,-12,-10,0,2,2,1,2,3,-1,6,5,-8,8,0,-2,2,0,0,-2,15,0,-4,4,-28,0,0,-1,1,-1,-1,5,-1
KR_6719701585,420,-4,-74,-8,-6,-1,2,1,1,1,2,2,1,3,-3,3,0,-5,5,0,0,-3,-1,0,-1,1,-5,0,-2,1,-1,-1,1,3,-1
KR_6639629346,440,0,-37,-20,-2,5,0,5,-2,4,2,-1,3,2,-4,5,1,0,2,2,1,-4,-109,-1,-3,4,1,0,-1,-1,0,-1,1,2,-1
KR_6752418143,420,3,25,19,4,3,0,3,2,5,7,1,2,3,0,1,1,-2,4,2,0,-3,101,-3,0,3,16,0,1,1,1,1,-1,3,-1
KR_6727945165,440,-4,4,16,-11,-3,4,1,1,2,3,-5,5,0,-1,4,3,-3,4,1,1,-1,6,1,-4,3,1,0,-2,0,-1,-1,1,0,-1
KR_6724452896,420,3,-17,16,10,4,1,5,5,1,6,2,1,3,-1,3,2,0,1,1,-1,3,224,2,-5,3,3,0,0,1,1,0,-1,6,-1
KR_6660675217,440,-2,47,-5,-6,0,1,1,-3,5,2,0,2,2,-1,3,2,-2,2,0,0,-13,105,-1,0,1,3,0,0,-1,0,0,-1,2,-1
KR_6761554844,420,-2,15,16,1,4,1,5,-1,3,2,-3,4,1,2,1,3,-1,1,0,2,-10,-142,-1,-2,3,0,0,1,1,1,1,1,2,-1
KR_6759591824,440,-6,-39,8,-12,-3,4,1,1,1,2,-5,6,1,-7,8,1,2,2,4,0,-11,-18,0,-4,4,-3,0,-1,1,-1,-1,1,2,-1
KR_6715077750,420,-4,-32,-13,-10,0,1,1,-1,2,1,-6,6,0,-3,3,0,0,2,2,0,-9,-6,-2,-2,4,-4,0,-3,-1,-1,-1,-1,6,-1
KR_6728692921,420,-6,-34,-8,-16,1,0,1,-5,6,1,-1,3,2,-8,9,1,-3,3,0,-1,-21,-4,-3,-4,7,4,0,-2,-1,-1,-1,-1,6,-1
KR_6750362195,420,-3,-31,-12,-9,0,2,2,-3,4,1,-2,4,2,-5,5,0,1,0,1,1,-11,-66,2,-3,1,18,0,0,-1,1,-1,1,4,-1
KR_6760685607,440,-4,-61,5,-11,2,1,3,-3,4,1,-2,3,1,-9,9,0,1,0,1,-1,-11,-11,-5,0,5,4,0,-1,-1,0,-1,-1,5,-1
KR_6762807078,420,-1,29,12,-9,3,0,3,1,6,7,-6,6,0,-5,8,3,-2,2,0,1,-12,-315,-1,-4,5,6,0,0,1,-1,-1,1,6,-1
KR_6632112717,420,1,4,-36,5,3,1,4,-1,3,2,0,2,2,2,2,4,1,0,1,0,9,-5,0,-2,2,3,0,0,-1,0,0,-1,4,-1
KR_6702022437,420,-2,-59,-36,-9,2,0,2,2,2,4,-7,7,0,-2,5,3,-4,6,2,-4,-7,-5,1,-7,6,2,0,-3,-1,-1,-1,-1,4,-1
KR_6530782100,440,-3,-26,-20,0,3,1,4,4,1,5,1,3,4,-9,12,3,1,0,1,-1,-11,-7,-5,-2,7,1,0,-3,-1,-1,-1,-1,1,-1
KR_6694694938,420,-4,-88,-28,-2,-8,8,0,1,2,3,0,0,0,4,4,8,1,0,1,0,-7,9,1,-4,3,-1,0,-1,-1,0,-1,1,1,-1
KR_6707669495,420,-2,-72,-25,-6,-3,5,2,1,2,3,2,1,3,-6,7,1,0,1,1,0,-9,-2,-4,-1,5,1,0,-3,-1,-1,-1,-1,1,-1
KR_6695438837,420,1,32,8,6,1,0,1,-1,1,0,-1,7,6,1,5,6,6,0,6,1,9,-302,0,-4,4,-20,0,0,1,-1,0,1,3,-1
KR_6751255392,420,-1,-1,8,-2,0,2,2,0,0,0,0,2,2,1,1,2,-3,3,0,-1,-6,54,7,-8,1,-46,0,0,-1,1,1,-1,6,-1
KR_6759293685,420,-1,-66,24,-4,-1,1,0,0,3,3,-4,5,1,1,1,2,0,1,1,0,-2,15,1,-5,4,-1,0,0,-1,1,-1,-1,6,-1
KR_6750543467,420,-4,-86,-1,5,-1,4,3,-2,4,2,2,0,2,4,1,5,2,0,2,0,6,8,0,-1,1,-3,0,-2,1,-1,-1,-1,2,-1
KR_6763405041,420,-1,-20,0,9,2,0,2,-1,3,2,2,2,4,2,2,4,4,1,5,0,7,-3,1,-2,1,-2,0,1,1,1,1,-1,1,-1
KR_6389285173,420,-1,15,-8,3,-1,3,2,2,1,3,2,2,4,-1,4,3,1,2,3,0,10,192,0,-6,6,-3,0,0,1,-1,-1,1,6,-1
KR_6495243581,420,-1,-62,7,-8,-2,5,3,-1,3,2,3,1,4,-8,8,0,0,0,0,-1,-17,24,-1,-3,4,-5,0,0,-1,-1,1,-1,2,-1
KR_6705593273,420,-3,-42,4,-8,-1,3,2,1,1,2,-7,8,1,-2,3,1,1,0,1,0,-13,15,0,-2,2,-2,0,-2,-1,-1,-1,-1,4,-1
KR_6666406114,420,1,94,-24,2,1,2,3,1,2,3,3,0,3,-4,7,3,1,0,1,0,-3,2,2,-5,3,5,0,0,-1,0,0,-1,2,-1
KR_6659703660,420,0,-7,-25,3,4,0,4,-3,4,1,3,1,4,-3,4,1,2,0,2,0,-4,12,-2,-1,3,5,0,-1,1,-1,-1,-1,4,-1
KR_6754413285,420,0,11,9,-5,-2,2,0,1,0,1,-3,4,1,0,2,2,-1,2,1,0,-7,-6,-5,-4,9,0,0,0,-1,-1,0,-1,4,-1
KR_6707943892,420,-4,-92,-3,-14,0,2,2,-3,3,0,-8,8,0,-2,2,0,-1,1,0,0,-8,250,-3,-2,5,-2,0,-1,1,-1,-1,-1,1,-1
KR_6723103309,420,-1,17,-33,-4,0,1,1,-10,11,1,1,1,2,5,1,6,0,3,3,0,-4,-55,-9,0,9,3,0,0,-1,1,0,1,1,-1
KR_6760897184,420,-1,-29,-32,-8,-7,8,1,3,1,4,-3,4,1,1,1,2,-2,2,0,0,-5,-5,-3,-3,6,0,0,-1,0,-1,-1,1,0,-1
KR_6764442886,420,3,-42,17,-3,-1,1,0,-3,4,1,-3,5,2,4,1,5,0,0,0,0,2,7,4,-9,5,-4,0,-1,0,-1,-1,-1,0,-1
KR_6751212058,420,-1,-35,0,-2,1,2,3,1,1,2,0,0,0,-5,7,2,1,0,1,0,-7,5,4,-8,4,1,0,0,1,0,0,1,6,-1
KR_6653654088,440,-3,-37,-7,-13,-5,5,0,1,7,8,-2,3,1,-2,2,0,-5,5,0,0,-19,-17,-8,0,8,1,0,1,-1,1,-1,-1,5,-1
KR_6750318389,440,-6,-84,-40,-15,-11,12,1,0,2,2,2,2,4,-7,11,4,1,1,2,-1,-6,-3,-1,0,1,0,0,-2,-1,-1,-1,-1,1,-1
KR_6760462677,420,0,64,-17,1,-1,2,1,-7,10,3,3,1,4,5,1,6,1,1,2,0,-1,13,-2,-3,5,1,0,0,1,-1,0,1,5,-1
KR_6731122377,420,-1,3,-12,0,2,3,5,2,1,3,-2,4,2,-1,3,2,-1,1,0,-1,-7,0,2,-2,0,-1,0,0,0,0,0,-1,0,-1
KR_6722914729,420,-1,-57,-12,-7,-1,3,2,-4,6,2,-1,1,0,-1,3,2,0,0,0,-1,-5,108,-6,0,6,-1,0,-1,-1,-1,-1,-1,2,-1
KR_6729471615,420,0,-30,0,8,0,1,1,2,4,6,3,0,3,2,2,4,1,0,1,0,15,192,-2,0,2,1,0,0,-1,1,0,1,2,-1
KR_6755473557,420,0,1,0,-3,1,3,4,1,3,4,-2,4,2,-5,5,0,2,1,3,0,-6,0,-3,-1,4,2,0,-1,-1,-1,-1,-1,2,-1
KR_6622910358,420,-1,-11,4,-7,0,2,2,-2,4,2,1,2,3,-4,6,2,-2,2,0,-1,-10,269,1,-3,2,1,0,0,-1,-1,-1,-1,1,-1
KR_6685665482,440,-1,-13,13,-5,-2,3,1,1,3,4,1,4,5,-2,6,4,-3,3,0,1,4,5,1,-7,6,-3,0,-1,1,-1,-1,1,2,-1
KR_6732727680,420,2,36,10,4,-3,4,1,2,1,3,1,4,5,3,2,5,1,1,2,0,0,-20,1,-4,3,4,0,0,0,-1,0,1,0,-1
KR_6755682426,420,-3,-44,-11,-9,1,1,2,1,1,2,-10,13,3,1,0,1,-2,2,0,0,-9,-3,-2,-5,7,-2,0,-1,0,-1,-1,-1,0,-1
KR_6763467160,420,-4,-72,-19,-10,1,2,3,-2,3,1,-5,5,0,-2,4,2,-2,3,1,0,-10,-6,-2,-3,5,-4,0,-1,0,-1,-1,-1,0,-1
KR_6744263389,420,-4,0,-24,-4,-1,2,1,1,2,3,-2,2,0,0,1,1,-2,3,1,0,-1,-177,4,-8,4,1,0,-2,1,1,-1,-1,1,-1
KR_6722029692,420,-6,-42,-6,-13,0,1,1,-4,4,0,-5,6,1,-4,5,1,0,1,1,0,-6,-37,-2,-2,4,0,0,-2,-1,-1,-1,-1,2,-1
KR_6743295723,420,-3,4,-39,-8,-6,7,1,-1,2,1,1,3,4,0,5,5,-2,3,1,0,-7,-11,-4,-1,5,2,0,-2,-1,-1,-1,-1,1,-1
KR_6700958023,440,-6,-31,-11,-10,-3,5,2,-5,6,1,2,2,4,-5,8,3,1,1,2,1,-10,-2,2,-8,6,1,0,-2,-1,-1,-1,1,2,-1
KR_6750509626,420,-2,-8,-17,-5,0,0,0,-4,5,1,-3,5,2,3,0,3,-1,2,1,0,-2,-42,-1,-5,6,9,0,0,-1,-1,0,-1,1,-1
KR_6753743395,420,-1,-48,12,-1,-2,2,0,3,2,5,-3,9,6,1,5,6,0,1,1,0,0,287,3,-6,3,-4,0,1,1,-1,-1,1,1,-1
KR_6763119196,440,-3,-32,-4,-7,-1,3,2,0,5,5,1,3,4,-6,9,3,-1,4,3,-1,-11,15,3,-4,1,-1,0,-1,-1,0,-1,-1,1,-1
KR_6764324616,420,-3,-75,-28,-10,4,2,6,1,2,3,-2,4,2,-14,14,0,1,0,1,0,-2,-10,-1,-1,2,0,0,-2,-1,-1,-1,-1,6,-1
KR_6741342010,440,-1,15,-8,-6,1,1,2,-2,4,2,-1,2,1,-3,5,2,-1,1,0,0,-4,-220,-1,-2,3,-1,0,1,-1,1,1,-1,5,-1
KR_6762821102,420,-1,17,4,-2,1,0,1,0,4,4,-2,2,0,-2,4,2,1,1,2,0,0,10,1,-4,3,-1,0,0,-1,0,-1,-1,4,-1
KR_6750748327,420,-3,-5,1,-1,2,0,2,-1,1,0,-2,2,0,-2,4,2,2,0,2,0,1,14,6,-7,1,-3,0,1,1,-1,1,-1,2,-1
KR_6750221548,420,-5,-67,8,-14,-4,6,2,-3,6,3,-1,5,4,-6,8,2,0,1,1,0,-12,-20,-1,-5,6,-6,0,-2,-1,-1,-1,-1,2,-1
KR_6757943801,420,-1,19,1,-2,-2,3,1,-2,4,2,7,1,8,-5,7,2,0,1,1,0,4,-26,5,-5,0,0,0,0,-1,0,1,-1,3,-1
KR_6667549122,440,-2,-59,-32,-5,1,0,1,-4,5,1,2,1,3,-5,6,1,1,0,1,-1,-3,-36,0,-3,3,3,0,0,1,1,0,-1,6,-1
KR_6640206657,420,-2,-3,-28,-2,-3,3,0,1,4,5,0,1,1,0,2,2,0,1,1,0,-3,-9,-2,-3,5,4,0,0,-1,1,0,-1,2,-1
KR_6611630669,420,-4,29,-40,-10,0,2,2,-4,8,4,-4,5,1,-2,2,0,0,0,0,0,-7,0,3,-4,1,-4,0,0,1,1,0,-1,4,-1
KR_6756855478,420,-3,-53,-36,-6,0,1,1,-8,9,1,3,0,3,0,1,1,-1,1,0,0,-4,0,0,-2,2,1,0,0,-1,-1,0,-1,6,-1
KR_6621472403,440,4,-11,28,7,-3,4,1,4,1,5,2,0,2,-1,2,1,5,0,5,0,5,-4,2,-2,0,1,0,-1,0,0,-1,1,0,-1
KR_6681892894,440,-1,-3,-17,0,1,1,2,-2,4,2,-1,2,1,0,2,2,2,0,2,0,-1,-6,0,-2,2,-2,0,1,0,0,1,-1,0,-1
KR_6731667029,440,-5,-33,-5,-7,-1,1,0,1,7,8,-5,7,2,-3,5,2,1,0,1,1,-11,159,-3,-1,4,-1,0,-2,0,1,-1,1,0,-1
KR_6695218451,420,-3,-52,-5,-3,-3,4,1,1,2,3,-3,6,3,2,1,3,0,1,1,0,-3,-7,-3,0,3,3,0,-1,1,-1,-1,1,1,-1
KR_6625747740,420,5,62,8,7,1,1,2,7,0,7,0,2,2,-1,2,1,0,1,1,-1,8,38,1,-5,4,-19,0,0,1,1,1,-1,2,-1
KR_6763920477,420,-3,-41,-17,-7,0,1,1,1,1,2,1,4,5,-6,6,0,-3,3,0,0,-10,-8,4,-5,1,-2,0,0,-1,0,1,1,5,-1
KR_6729298692,420,-9,-119,-20,-24,-3,5,2,-4,5,1,-9,13,4,-7,7,0,-1,1,0,0,-14,-2,-6,-1,7,0,0,-4,1,-1,-1,-1,1,-1
KR_6695123087,420,-2,38,-8,-9,4,0,4,-8,8,0,-1,2,1,-3,8,5,-1,1,0,0,-8,-10,-2,-3,5,4,0,-2,-1,-1,-1,1,5,-1
KR_6745536135,420,-1,11,8,-4,-2,3,1,1,2,3,1,1,2,-4,5,1,0,0,0,0,-2,7,-2,-2,4,-1,0,0,-1,1,0,-1,3,-1
KR_6763195325,420,0,8,0,-6,-1,2,1,-3,3,0,0,2,2,-2,2,0,0,0,0,0,-7,4,0,-1,1,-3,0,-1,0,0,-1,-1,0,-1
KR_6723866157,420,1,11,0,8,-5,5,0,0,2,2,2,2,4,6,0,6,5,1,6,0,17,3,4,-6,2,1,0,0,1,0,0,-1,2,-1
KR_6692529291,440,-1,-33,-13,-1,1,0,1,-4,5,1,-1,8,7,1,2,3,2,2,4,0,-3,7,0,-2,2,0,0,-2,-1,-1,-1,1,6,-1
KR_6757697508,420,-1,7,-11,6,0,2,2,-2,2,0,4,1,5,5,5,10,-1,2,1,0,-6,5,-1,-2,3,2,0,0,1,1,1,1,2,-1
KR_6705500476,420,-3,-10,-31,-7,0,2,2,6,3,9,-7,7,0,-2,4,2,-4,6,2,-1,-4,-4,-5,-4,9,3,0,-2,-1,-1,-1,-1,3,-1
KR_6636405372,420,-1,-16,-20,-6,1,0,1,-5,6,1,0,1,1,-1,1,0,-1,1,0,0,-2,-53,4,-4,0,27,0,-1,0,-1,-1,1,0,-1
KR_6692647744,420,0,-20,-4,2,5,0,5,5,0,5,-8,8,0,-1,4,3,1,1,2,0,5,76,-1,-4,5,7,0,-3,1,-1,-1,-1,6,-1
KR_6733060014,420,-2,-24,-29,-2,-1,4,3,1,0,1,0,1,1,-1,1,0,-1,1,0,1,-1,-4,2,-5,3,2,0,0,1,1,-1,1,5,-1
KR_6740368540,420,0,-11,-9,-1,-2,2,0,1,0,1,1,2,3,0,0,0,-1,3,2,0,-1,6,4,-7,3,-3,0,0,1,-1,0,-1,2,-1
KR_6671420214,420,-4,-114,4,-15,-6,7,1,-4,5,1,-2,4,2,-2,4,2,-1,3,2,-1,-12,7,1,-2,1,-1,0,-3,0,-1,-1,-1,0,-1
KR_6761035442,420,-4,-52,18,-10,0,1,1,2,0,2,-2,3,1,-9,10,1,-1,1,0,0,-7,0,3,-5,2,-5,0,-3,-1,-1,-1,1,2,-1
KR_6752378022,420,-3,-53,1,-8,-2,3,1,-2,3,1,-1,3,2,-1,2,1,-2,4,2,0,-6,34,1,-2,1,-16,0,-1,-1,-1,-1,1,1,-1
KR_6624757340,420,-5,-99,-11,-8,-5,5,0,3,1,4,-6,7,1,0,1,1,0,2,2,0,1,-10,-2,-4,6,3,0,-2,-1,-1,-1,1,1,-1
KR_6671471358,420,-1,14,-1,-5,0,3,3,-1,2,1,3,3,6,-6,6,0,-1,1,0,0,4,-13,4,-7,3,-2,0,0,1,-1,-1,-1,1,-1
KR_6705975993,420,-1,-9,8,-6,0,0,0,1,4,5,0,3,3,-5,5,0,-2,2,0,0,-15,17,-1,-2,3,-1,0,-1,-1,-1,-1,-1,2,-1
KR_6763206009,420,-1,-28,2,-5,-1,2,1,-7,7,0,5,3,8,0,0,0,-2,4,2,0,-4,-9,-1,-1,2,-2,0,0,-1,0,0,-1,2,-1
KR_6632398152,440,2,-1,-20,6,-1,2,1,-3,4,1,5,2,7,4,0,4,1,2,3,0,1,-3,1,-5,4,5,0,0,1,-1,1,1,4,-1
KR_6750829130,420,-5,-8,-24,-18,-7,7,0,1,2,3,-7,10,3,-6,8,2,1,0,1,-1,-6,19,1,-3,2,-3,0,-1,0,-1,-1,-1,0,-1
KR_6665321647,420,-1,-4,7,0,0,0,0,2,3,5,2,1,3,-1,1,0,-3,3,0,0,0,-7,0,-5,5,0,0,-1,-1,-1,-1,-1,2,-1
KR_6682856510,440,1,38,-30,8,-2,4,2,2,2,4,2,1,3,3,0,3,3,2,5,0,4,2,0,-5,5,6,0,0,0,-1,0,1,0,-1
KR_6762984670,420,-1,-32,-20,-2,1,3,4,1,2,3,-4,5,1,1,3,4,-1,3,2,0,-2,-9,2,-3,1,5,0,0,0,1,0,-1,0,-1
KR_6682348564,420,-1,51,-12,-4,-3,5,2,-2,4,2,3,2,5,1,0,1,-3,3,0,0,1,44,1,-4,3,-7,0,-1,1,0,-1,-1,1,-1
KR_6654342560,440,1,-32,0,3,-1,4,3,3,0,3,2,1,3,0,1,1,-1,1,0,0,4,12,-1,-5,6,1,0,0,-1,0,0,1,6,-1
KR_6736170089,440,-1,-14,36,4,-3,4,1,-1,2,1,5,0,5,4,4,8,-1,1,0,0,1,45,-2,-3,5,-29,0,0,1,-1,-1,-1,4,-1
KR_6642594312,420,-4,-65,-27,-8,1,1,2,-3,8,5,6,1,7,-10,10,0,-2,2,0,-1,-20,-7,2,-5,3,1,0,-3,-1,-1,-1,-1,5,-1
KR_6511599990,420,-2,2,-28,-1,0,0,0,-6,9,3,2,2,4,1,4,5,2,1,3,-2,1,-26,4,-6,2,-2,0,-1,-1,-1,-1,-1,2,-1
KR_6748357786,420,4,20,28,11,2,1,3,1,1,2,7,1,8,1,0,1,0,0,0,0,5,136,1,-4,3,-2,0,1,1,-1,-1,1,2,-1
KR_6759723126,420,-2,-23,-44,1,3,1,4,-4,4,0,4,1,5,0,1,1,-2,3,1,-1,-1,36,-1,-1,2,-21,0,0,-1,-1,1,-1,2,-1
KR_6669093994,420,0,26,-16,-6,1,1,2,0,4,4,-3,3,0,-2,3,1,-2,4,2,0,-4,3,3,-4,1,1,0,0,-1,0,0,-1,4,-1
KR_6750756324,420,-2,-45,-32,-13,-2,2,0,1,1,2,-5,7,2,-7,8,1,0,0,0,-1,-14,-26,2,-6,4,-2,0,-1,-1,-1,-1,-1,1,-1
KR_6636533659,420,0,4,-8,-2,-3,3,0,-1,4,3,1,2,3,1,1,2,0,0,0,0,-2,-128,-1,-3,4,0,0,0,1,0,-1,-1,4,-1
KR_6753780803,420,-1,-40,32,1,-3,5,2,1,2,3,2,3,5,3,1,4,-2,2,0,0,4,230,-1,0,1,5,0,1,0,1,1,-1,0,-1
KR_6760244614,420,-2,-50,-36,-5,-3,5,2,-1,2,1,-1,2,1,-2,2,0,2,1,3,0,-1,0,5,-5,0,-5,0,0,-1,0,0,-1,1,-1
KR_6621387241,440,0,-68,-4,1,1,1,2,3,1,4,-2,3,1,-1,5,4,0,1,1,0,3,5,1,-5,4,1,0,0,1,1,0,1,4,-1
KR_6747890575,420,-1,-1,-32,0,0,3,3,-7,9,2,7,1,8,0,3,3,0,0,0,0,7,5,3,-3,0,-2,0,1,-1,1,1,1,5,-1
KR_6698674313,420,-2,-105,8,0,3,0,3,3,1,4,-4,5,1,0,7,7,-2,3,1,0,-5,-2,-3,0,3,2,0,-1,-1,-1,-1,-1,6,-1
KR_6758014746,420,1,84,1,7,1,5,6,0,3,3,6,0,6,2,1,3,-2,2,0,0,-4,-8,-2,-4,6,3,0,1,1,-1,1,1,3,-1
KR_6686634166,440,-3,-89,2,-8,-5,7,2,2,4,6,0,3,3,-1,3,2,-4,5,1,0,-6,-15,3,-5,2,-1,0,-2,-1,-1,-1,-1,1,-1
KR_6760404859,420,-1,-72,-10,-5,-7,8,1,2,0,2,1,1,2,-1,2,1,0,0,0,0,-3,40,2,-3,1,-21,0,0,1,-1,-1,-1,3,-1
KR_6738436925,420,0,-29,-12,4,-2,4,2,0,4,4,1,1,2,1,1,2,4,0,4,0,4,250,-1,-2,3,3,0,0,-1,0,0,1,6,-1
KR_6747474560,420,0,19,-8,3,2,3,5,1,1,2,1,2,3,0,4,4,-1,2,1,0,-3,-1,7,-10,3,2,0,0,1,1,1,-1,4,-1
KR_6761384990,420,1,0,19,-3,1,1,2,3,0,3,-5,8,3,-3,4,1,1,0,1,0,-6,-20,1,-3,2,2,0,1,-1,1,1,-1,2,-1
KR_6723778841,440,-2,2,-16,-7,3,2,5,-4,6,2,0,0,0,-1,2,1,-5,6,1,0,-8,3,2,-4,2,-2,0,0,-1,1,1,-1,2,-1
KR_6762319121,420,3,63,-17,3,5,0,5,-1,2,1,-5,6,1,5,1,6,-1,1,0,1,1,9,4,-5,1,0,0,2,0,-1,1,1,0,-1
KR_6745347967,420,-5,-1,-55,-9,3,1,4,-5,5,0,-1,5,4,-3,6,3,-3,4,1,1,-12,2,-2,-4,6,-1,0,-2,-1,1,-1,1,2,-1
KR_6723643970,440,-1,-15,17,-6,0,1,1,1,1,2,6,0,6,-7,9,2,-6,6,0,-1,-6,23,2,-3,1,-1,0,-1,1,-1,-1,-1,4,-1
KR_6670853309,420,3,57,5,4,2,0,2,4,0,4,2,3,5,-1,3,2,-3,3,0,-1,3,112,0,-6,6,5,0,0,1,-1,0,-1,4,-1
KR_6761038489,420,-4,-27,-20,-3,0,2,2,2,2,4,-6,9,3,0,4,4,1,0,1,0,-3,-2,5,-8,3,-9,0,-1,1,-1,-1,1,2,-1
KR_6754745256,440,-5,-101,-20,-12,-4,5,1,-1,5,4,-1,1,0,-4,6,2,-2,2,0,0,-3,-5,0,-2,2,0,0,-2,-1,1,-1,-1,4,-1
KR_6739177857,440,-2,-25,-8,-8,-1,3,2,-4,7,3,-1,2,1,0,2,2,-2,4,2,-1,-10,-26,-2,-3,5,0,0,-2,-1,-1,-1,1,1,-1
KR_6622466345,420,-10,-95,-28,-21,-6,6,0,-3,3,0,-4,4,0,-6,7,1,-2,2,0,0,-12,-4,0,-1,1,-1,0,-4,-1,-1,-1,-1,4,-1
KR_6630741316,420,2,-57,12,5,5,0,5,-2,5,3,3,0,3,-1,3,2,0,0,0,0,2,9,2,-5,3,-1,0,0,-1,-1,0,1,3,-1
KR_6290062917,420,1,-2,4,0,-7,8,1,0,1,1,1,2,3,3,4,7,3,2,5,2,7,-1,-3,-2,5,0,0,-1,1,1,-1,1,3,-1
KR_6655833107,420,-5,-44,-7,-12,-4,4,0,1,3,4,-7,7,0,-1,5,4,-1,1,0,1,-9,0,2,-7,5,-4,0,-2,-1,-1,-1,1,1,-1
KR_6750536933,420,-3,-37,-16,-5,-1,2,1,-4,5,1,-2,3,1,2,0,2,0,2,2,0,-8,0,-1,-3,4,0,0,0,-1,-1,0,-1,3,-1
KR_6606154440,420,-2,63,-5,1,-1,2,1,-2,2,0,5,0,5,2,0,2,-3,3,0,1,1,14,-2,-4,6,0,0,1,-1,-1,1,1,2,-1
KR_6718337285,420,-3,8,-20,-6,1,2,3,0,2,2,-4,5,1,-2,3,1,-1,2,1,0,-4,-116,-3,-3,6,0,0,0,-1,-1,0,-1,6,-1
KR_6704868847,420,0,-17,12,3,-3,3,0,-1,3,2,-1,2,1,6,0,6,2,1,3,1,12,2,3,-5,2,3,0,1,-1,1,1,1,6,-1
KR_6741587298,420,0,-51,-4,-7,3,2,5,-2,5,3,-6,6,0,-1,5,4,-1,1,0,0,-3,-144,0,-4,4,0,0,-1,-1,-1,-1,1,6,-1
KR_6763489733,420,-3,-69,-2,-9,0,2,2,-3,5,2,0,0,0,-6,7,1,0,1,1,0,-7,-4,-2,-3,5,-1,0,0,-1,-1,-1,-1,6,-1
KR_6727993037,420,0,22,-24,2,-2,7,5,-1,2,1,0,3,3,4,2,6,1,0,1,-2,-3,-1,2,-3,1,2,0,-1,-1,-1,-1,-1,2,-1
KR_6753012037,420,-3,-93,-20,-7,-4,4,0,2,1,3,0,1,1,-5,7,2,0,1,1,-1,-3,-81,-2,-1,3,3,0,-1,1,-1,-1,-1,1,-1
KR_6380119504,420,-8,-134,-5,-24,-2,3,1,-8,11,3,-7,7,0,-5,5,0,-2,3,1,-1,-16,-20,3,-7,4,1,0,-4,-1,1,-1,-1,5,-1
KR_6761689269,440,-2,21,-23,-4,1,1,2,0,3,3,1,0,1,-4,7,3,-2,4,2,0,-7,200,5,-7,2,-3,0,0,-1,0,0,1,1,-1
KR_6750184736,440,0,-10,0,0,0,2,2,-2,2,0,-4,5,1,7,0,7,-1,1,0,1,9,-5,0,-1,1,1,0,-1,1,-1,-1,1,3,-1
KR_6725953037,420,-7,-98,-8,-13,-4,5,1,-7,8,1,-1,2,1,2,2,4,-3,4,1,0,-15,-6,6,-6,0,-2,0,-2,-1,-1,-1,-1,4,-1
KR_6636819380,420,1,40,8,-3,1,0,1,-1,2,1,0,1,1,-3,4,1,0,3,3,0,-6,123,1,-3,2,1,0,0,-1,1,1,-1,3,-1
KR_6158882338,420,2,11,49,4,0,0,0,3,1,4,-4,6,2,3,1,4,2,1,3,-1,-1,22,-4,-6,10,0,0,0,1,-1,0,-1,1,-1
KR_6729942186,420,0,58,-11,-7,1,0,1,-1,2,1,-2,3,1,-2,7,5,-3,3,0,0,-12,-1,0,-2,2,-1,0,2,1,1,1,1,6,-1
KR_6601081660,420,-3,-17,-12,-10,1,1,2,-1,1,0,-3,4,1,-7,7,0,0,1,1,0,-14,37,-7,0,7,-13,0,-1,-1,-1,1,-1,3,-1
KR_6203315458,420,1,36,-11,1,0,2,2,5,0,5,-2,3,1,-2,2,0,0,0,0,-1,-2,-173,-2,-1,3,-3,0,1,-1,1,1,-1,2,-1
KR_6561320379,420,-1,-82,-4,-2,-2,3,1,-2,4,2,0,2,2,1,2,3,1,0,1,0,-4,-257,-2,-3,5,1,0,-1,-1,1,-1,1,3,-1
KR_6757291915,420,-2,-83,2,-3,-4,4,0,-2,3,1,5,1,6,-2,4,2,0,2,2,0,-1,10,-3,-4,7,-3,0,0,-1,-1,0,-1,3,-1
KR_6650044352,420,1,-43,-11,4,0,1,1,1,2,3,3,2,5,-1,4,3,1,1,2,0,1,11,7,-8,1,-10,0,-1,0,-1,-1,-1,0,-1
KR_6695116557,420,0,-3,11,1,1,1,2,0,2,2,0,2,2,-1,4,3,1,3,4,0,1,8,0,-3,3,0,0,0,-1,-1,0,-1,5,-1
KR_6736382175,420,-5,-67,-15,-2,-2,3,1,1,2,3,0,0,0,-2,3,1,1,1,2,0,-4,-18,1,-5,4,1,0,-1,-1,1,-1,1,4,-1
KR_6274568079,420,-1,-16,4,4,2,1,3,0,6,6,3,0,3,-1,1,0,0,0,0,0,3,-433,0,-1,1,-1,0,0,1,0,0,1,3,-1
KR_6615621457,420,0,-23,16,-4,2,2,4,0,0,0,-2,2,0,-3,5,2,-1,1,0,0,-7,-3,1,-5,4,4,0,-1,-1,0,-1,1,6,-1
KR_6732690899,420,-4,-11,-12,-3,1,0,1,-3,6,3,-1,3,2,2,1,3,-2,3,1,-1,-1,64,3,-5,2,-1,0,0,1,1,0,-1,4,-1
KR_6621970381,420,-4,-42,28,-8,-3,3,0,4,1,5,0,1,1,-9,11,2,0,1,1,0,-6,-13,-3,-2,5,-1,0,0,1,0,0,-1,3,-1
KR_6530532446,420,-2,-49,-27,-11,-7,7,0,-1,2,1,-4,6,2,-1,4,3,2,1,3,-1,3,6,3,-4,1,0,0,-1,0,0,-1,-1,0,-1
KR_6756986110,420,-2,11,20,-10,-4,6,2,4,0,4,-4,5,1,-7,9,2,1,0,1,0,-11,-7,-2,-6,8,3,0,-1,-1,1,-1,-1,3,-1
KR_6754115212,420,-1,-5,19,1,-4,4,0,2,2,4,2,1,3,0,0,0,1,0,1,0,6,-22,3,-4,1,-5,0,0,-1,1,0,1,5,-1
KR_6741476356,420,-3,-5,-8,-2,-2,3,1,-1,4,3,-3,4,1,2,0,2,2,0,2,2,6,-14,-4,-3,7,1,0,-1,-1,-1,-1,1,5,-1
KR_6751836826,420,-1,28,4,0,2,3,5,1,2,3,-2,4,2,-2,3,1,1,1,2,0,-8,-3,3,-4,1,-2,0,1,1,0,1,1,6,-1
KR_6754187542,420,-3,-14,-20,-9,0,1,1,-2,7,5,0,2,2,-4,5,1,-3,3,0,0,-10,5,2,-5,3,-3,0,0,-1,-1,-1,1,6,-1
KR_6681902453,420,-2,-19,-4,1,1,0,1,-2,4,2,3,3,6,0,1,1,-1,2,1,0,0,-3,1,-4,3,-1,0,0,-1,-1,-1,-1,4,-1
KR_6616212421,420,-2,-37,-28,-6,3,0,3,-2,3,1,5,0,5,-8,8,0,-4,4,0,-1,-11,-33,-6,0,6,17,0,1,0,1,-1,-1,0,-1
KR_6730423018,420,-5,-46,-32,-11,-1,3,2,-5,7,2,-2,3,1,-3,4,1,0,0,0,0,-15,-4,1,-3,2,0,0,1,-1,1,-1,-1,2,-1
KR_6624008256,420,-2,-3,4,-9,-2,3,1,-2,3,1,1,2,3,-5,5,0,-1,1,0,-1,-15,4,0,-4,4,-4,0,-2,-1,-1,-1,-1,6,-1
KR_6759498513,420,-6,-121,8,-18,-7,8,1,-1,1,0,-4,6,2,-4,4,0,-2,2,0,0,-11,2,0,-2,2,-2,0,-3,-1,-1,-1,-1,3,-1
KR_6761737457,420,-2,42,-12,-7,0,2,2,-6,8,2,1,0,1,2,1,3,-4,4,0,0,-12,-8,0,-2,2,-2,0,-1,-1,-1,-1,-1,1,-1
KR_6682381801,420,-2,-87,-27,-5,-2,3,1,1,3,4,-8,8,0,3,1,4,1,1,2,1,4,-18,1,-5,4,-3,0,-2,-1,1,-1,1,6,-1
KR_6700470905,420,-2,-30,-12,-3,1,0,1,-1,2,1,-3,4,1,0,1,1,0,0,0,0,-1,-17,2,-5,3,-2,0,0,-1,-1,0,-1,3,-1
KR_6729462706,420,-1,-17,-15,3,2,5,7,0,2,2,1,2,3,1,2,3,-1,4,3,2,2,167,-1,-2,3,5,0,0,-1,1,0,1,1,-1
KR_6727837151,420,-2,-3,-44,-6,4,0,4,-1,2,1,-7,7,0,-4,5,1,2,0,2,0,-4,47,-1,-3,4,-22,0,-2,-1,-1,-1,-1,1,-1
KR_6749977593,440,-1,-62,-12,-4,2,2,4,3,1,4,0,2,2,-10,11,1,1,0,1,0,-5,-9,-2,-2,4,4,0,0,-1,1,-1,1,5,-1
KR_6751327513,420,-1,-53,-32,1,0,1,1,-2,3,1,-1,3,2,2,1,3,2,0,2,0,-1,-31,-3,-3,6,0,0,0,1,-1,0,1,4,-1
KR_6648468401,420,-8,-127,-22,-18,-4,4,0,-3,4,1,-3,4,1,-8,9,1,0,2,2,0,-13,150,-5,-2,7,4,0,-2,-1,1,-1,-1,1,-1
KR_6669626201,420,-4,15,-20,-3,-1,1,0,2,1,3,-4,5,1,1,2,3,-1,1,0,0,-1,1,0,-1,1,1,0,-1,-1,-1,-1,1,1,-1
KR_6758273348,440,0,12,-33,-3,-1,5,4,1,3,4,-2,3,1,0,2,2,-1,3,2,1,0,42,0,-4,4,-17,0,-1,1,-1,-1,1,3,-1
KR_6568005143,420,-4,-43,-84,-8,-4,4,0,-4,4,0,0,5,5,-1,3,2,1,0,1,1,1,10,-1,-2,3,0,0,-2,-1,-1,-1,1,3,-1
KR_6755503372,420,0,-7,5,-12,3,2,5,-4,8,4,-2,4,2,-6,6,0,-3,5,2,0,-17,-11,-4,0,4,0,0,-1,-1,-1,-1,-1,2,-1
KR_6700047172,420,-2,12,-7,0,1,1,2,-2,5,3,0,1,1,2,0,2,-1,1,0,0,4,356,-1,-7,8,2,0,1,1,1,1,-1,2,-1
KR_6511654063,420,-2,-103,-9,-4,-2,3,1,3,4,7,-2,2,0,-3,5,2,0,1,1,-1,-4,-40,1,-6,5,25,0,0,-1,1,1,-1,5,-1
KR_6759003150,420,0,29,-9,4,0,2,2,2,2,4,-1,5,4,0,2,2,3,0,3,1,12,5,4,-6,2,0,0,0,1,-1,0,1,3,-1
KR_6606551870,420,-4,-56,-33,-6,0,1,1,-8,8,0,1,2,3,2,0,2,-1,1,0,0,-2,-51,-3,-1,4,26,0,-2,-1,1,-1,-1,4,-1
KR_6701904688,420,-3,13,-25,-11,-1,2,1,1,4,5,-1,4,3,-9,10,1,-1,3,2,-1,0,6,2,-4,2,-2,0,-1,-1,-1,-1,-1,4,-1
KR_6681820277,440,-5,-63,-12,-10,-1,2,1,-4,7,3,-3,4,1,-1,2,1,-1,2,1,-2,-8,17,0,-2,2,-2,0,-1,1,1,-1,-1,4,-1
KR_6645689007,420,-2,-47,-12,-4,0,1,1,-5,7,2,-2,3,1,2,2,4,1,1,2,0,-1,142,3,-6,3,2,0,0,-1,-1,-1,-1,5,-1
KR_6730163271,440,3,70,24,10,8,1,9,-1,3,2,-2,3,1,1,1,2,4,1,5,0,3,-14,-2,0,2,2,0,1,1,1,1,1,5,-1
KR_6735027635,420,-1,-3,-8,0,2,3,5,2,2,4,0,5,5,-5,6,1,1,3,4,0,-3,18,-3,0,3,-3,0,-1,-1,1,-1,1,6,-1
KR_6729901265,420,-2,6,-34,-6,-2,4,2,-1,6,5,0,4,4,0,4,4,-3,3,0,0,-5,4,4,-4,0,0,0,-1,-1,-1,-1,1,6,-1
KR_6654273846,440,0,-41,4,-10,2,1,3,-1,3,2,-5,6,1,-2,5,3,-4,5,1,0,-8,13,0,-3,3,-2,0,0,-1,-1,0,-1,1,-1
KR_6723014247,420,-2,-69,24,-11,-2,4,2,0,4,4,-4,6,2,-6,8,2,1,1,2,-1,-12,-4,-3,0,3,2,0,-2,1,-1,-1,-1,6,-1
KR_6670489038,420,3,-50,21,3,0,1,1,3,5,8,-3,5,2,4,0,4,-1,1,0,-1,9,23,2,-5,3,-1,0,-1,1,-1,-1,-1,5,-1
KR_6751368138,420,-2,-46,-4,-4,-5,6,1,-1,3,2,1,1,2,-1,2,1,2,0,2,0,-3,1,0,-2,2,1,0,-1,1,1,-1,-1,5,-1
KR_6718567847,420,2,15,20,3,2,2,4,1,1,2,5,0,5,-2,2,0,-3,4,1,0,1,-228,-5,-3,8,3,0,1,1,0,1,1,6,-1
KR_6703997301,420,-1,-1,0,-1,-4,6,2,-1,2,1,6,1,7,-1,3,2,-1,1,0,-1,0,182,-1,-1,2,2,0,-2,-1,-1,-1,-1,1,-1
KR_6608070514,420,-6,-18,0,-8,-1,2,1,-4,4,0,-5,6,1,2,2,4,0,1,1,0,-8,-35,1,-5,4,0,0,0,-1,-1,0,1,5,-1
KR_6735902245,420,1,19,4,-7,0,3,3,2,2,4,-1,3,2,-7,8,1,-1,1,0,1,-12,-19,-1,-7,8,-1,0,0,1,1,1,1,3,-1
KR_6610429441,420,2,16,9,7,3,2,5,3,1,4,-3,5,2,2,1,3,2,0,2,0,2,0,-3,-1,4,1,0,2,1,1,1,-1,2,-1
KR_6743724421,440,-1,2,-10,-1,0,2,2,2,2,4,-6,7,1,3,1,4,0,0,0,0,3,13,2,-2,0,2,0,0,-1,-1,-1,-1,5,-1
KR_5729822717,420,1,7,11,-2,-1,3,2,1,2,3,-2,2,0,-2,3,1,2,0,2,-1,-3,8,0,-3,3,3,0,0,1,1,0,-1,5,-1
KR_6688965728,420,-3,20,12,-8,-2,2,0,-3,4,1,-3,4,1,-1,2,1,1,1,2,0,-6,-18,-1,-3,4,-1,0,0,-1,1,1,-1,1,-1
KR_6716593602,420,1,40,4,1,0,2,2,0,2,2,-1,3,2,0,2,2,2,1,3,0,1,-501,-5,-1,6,5,0,0,-1,1,0,-1,5,-1
KR_6723688612,440,-1,-8,-24,0,2,1,3,-2,3,1,-4,4,0,3,1,4,1,0,1,0,-1,2,-4,0,4,-1,0,-1,0,-1,-1,1,0,-1
KR_6762907958,420,1,-30,12,-2,-2,2,0,0,0,0,4,2,6,-4,5,1,0,0,0,0,-6,6,6,-7,1,-6,0,0,1,-1,0,1,2,-1
KR_6730502889,420,1,59,-4,-2,0,2,2,0,4,4,2,1,3,-3,6,3,-1,3,2,-1,0,7,-1,-3,4,2,0,0,-1,1,1,-1,1,-1
KR_6672270143,420,-1,-21,-18,-3,-4,5,1,-1,3,2,3,2,5,-1,1,0,0,0,0,0,4,1,-2,-1,3,1,0,0,1,1,-1,-1,6,-1
KR_6726004252,420,2,-12,32,1,2,2,4,5,0,5,-4,4,0,-3,3,0,1,1,2,1,3,5,0,-3,3,-2,0,0,-1,1,0,1,4,-1
KR_6653688905,440,0,-44,40,0,-2,2,0,5,1,6,1,0,1,-2,5,3,-2,3,1,0,4,-5,1,-3,2,-5,0,0,0,0,-1,1,0,-1
KR_6645835859,420,-2,-68,33,-2,0,1,1,0,4,4,2,1,3,-5,6,1,1,2,3,-1,-1,-3,-5,-4,9,4,0,-1,1,1,-1,-1,6,-1
KR_6699680842,420,-7,-68,-40,-14,-7,7,0,-3,3,0,-4,5,1,2,0,2,-2,2,0,0,-3,-25,0,-2,2,-2,0,-3,-1,-1,-1,-1,2,-1
KR_6693749067,420,-6,-64,-13,-9,-5,5,0,2,3,5,1,4,5,-10,12,2,3,3,6,0,-3,-1,0,-6,6,-4,0,-2,-1,-1,-1,-1,4,-1
KR_6759802865,440,-2,-22,-31,2,3,1,4,-1,1,0,0,1,1,1,2,3,-1,2,1,0,10,39,2,-5,3,-23,0,-1,1,-1,-1,-1,5,-1
KR_6694654212,420,-2,-37,-30,-5,-2,5,3,0,2,2,-3,4,1,1,1,2,-1,2,1,0,0,3,6,-7,1,-3,0,-1,-1,-1,-1,-1,5,-1
KR_6694687118,420,1,9,21,-1,-1,2,1,-1,3,2,1,1,2,-2,3,1,2,2,4,0,1,2,1,-4,3,-7,0,0,-1,1,0,1,2,-1
KR_6731793029,420,0,-53,41,-1,4,2,6,2,2,4,-2,3,1,-5,7,2,0,2,2,-2,-5,-2,1,-1,0,-3,0,-1,1,-1,-1,-1,4,-1
KR_6599426856,420,-2,-41,29,-1,-1,3,2,6,1,7,-1,1,0,-4,5,1,-1,1,0,1,-4,-8,-6,-3,9,1,0,-2,1,0,-1,1,6,-1
KR_6738660281,420,0,-51,1,-3,-2,2,0,3,5,8,-1,3,2,-1,4,3,-2,2,0,0,-8,294,0,-2,2,-1,0,-1,-1,-1,-1,1,1,-1
KR_6658896017,420,2,-11,3,6,-1,1,0,-2,5,3,-2,2,0,6,2,8,5,0,5,1,8,5,2,-3,1,-1,0,-1,-1,-1,-1,1,3,-1
KR_6650927293,420,0,39,16,-3,1,1,2,4,2,6,-3,3,0,-3,4,1,-2,2,0,0,-6,-59,-5,-2,7,1,0,1,-1,1,1,1,6,-1
KR_6510156550,420,-3,-46,-33,-7,2,1,3,-5,6,1,0,3,3,-3,4,1,-1,1,0,0,-9,-13,2,-4,2,4,0,-2,1,0,-1,1,5,-1
KR_6602918007,420,2,-28,8,-4,-1,2,1,-4,6,2,1,2,3,0,3,3,0,3,3,0,-2,-6,-5,-2,7,-2,0,1,-1,-1,1,-1,5,-1
KR_6760949112,420,-1,4,8,2,0,2,2,1,2,3,-1,4,3,2,2,4,0,2,2,0,-3,5,-4,-1,5,-1,0,0,0,-1,0,1,0,-1
KR_6712141130,420,-2,2,-25,2,-4,4,0,0,0,0,3,0,3,1,0,1,2,0,2,0,7,130,0,-2,2,5,0,-1,0,-1,-1,1,0,-1
KR_6728515005,420,-2,-86,-4,2,-1,2,1,0,1,1,-5,5,0,6,1,7,2,0,2,1,13,6,3,-6,3,-3,0,-2,-1,-1,-1,1,4,-1
KR_6721601404,420,-2,-62,9,-3,-2,4,2,1,2,3,0,1,1,-2,2,0,0,0,0,0,-1,130,-2,-3,5,-5,0,0,-1,1,0,-1,4,-1
KR_6542902625,420,-3,-11,-13,-10,0,2,2,-4,5,1,-1,4,3,-1,6,5,-4,5,1,-1,-9,-10,-3,-5,8,-1,0,-1,1,-1,-1,-1,4,-1
KR_6196202331,420,-5,-82,16,-8,-1,2,1,-1,2,1,0,2,2,-6,8,2,0,0,0,1,1,-4,-3,-2,5,4,0,0,1,1,-1,1,5,-1
KR_6742885448,420,-4,-95,1,-6,-4,4,0,0,3,3,-3,3,0,0,2,2,1,1,2,1,-2,14,1,-4,3,1,0,-2,1,-1,-1,1,1,-1
KR_6753229030,420,1,62,7,-3,-4,4,0,3,3,6,-3,4,1,2,2,4,-1,1,0,-1,-4,-4,0,-6,6,2,0,0,-1,1,1,1,5,-1
KR_6759982332,420,-1,2,8,-7,-2,4,2,-7,8,1,1,2,3,0,1,1,1,2,3,0,-8,5,2,-4,2,-1,0,-1,1,-1,-1,1,3,-1
KR_6729973124,420,-1,6,-4,-2,0,1,1,1,2,3,0,4,4,-4,5,1,1,1,2,0,7,-45,5,-6,1,21,0,0,-1,1,1,-1,5,-1
KR_6762730765,420,2,57,-4,5,2,2,4,4,1,5,-2,5,3,2,3,5,-1,3,2,-1,2,-1,-2,0,2,4,0,1,-1,1,1,-1,4,-1
KR_6693461667,440,-4,-151,-6,-8,-3,3,0,0,0,0,-2,5,3,-3,3,0,0,2,2,0,-4,19,-4,-1,5,-2,0,-1,-1,1,-1,-1,3,-1
KR_6726882868,440,2,8,56,7,1,1,2,1,2,3,4,0,4,1,0,1,0,2,2,0,8,2,3,-10,7,2,0,0,-1,1,1,1,3,-1
KR_6693542759,420,-3,-35,-15,-11,-2,2,0,-1,4,3,-2,3,1,-1,1,0,-5,5,0,0,-6,3,2,-7,5,-4,0,0,-1,1,1,-1,4,-1
KR_5539406198,420,-6,-88,-15,-6,2,4,6,1,5,6,0,5,5,-4,5,1,-5,5,0,0,-16,1,7,-11,4,-2,0,-2,1,1,-1,1,1,-1
KR_6728734596,420,3,43,2,8,3,0,3,5,2,7,5,1,6,-1,2,1,-4,4,0,0,6,-42,6,-8,2,14,0,1,0,0,1,1,0,-1
KR_6661235461,420,-1,27,7,-7,-4,4,0,-4,5,1,-1,2,1,2,0,2,0,0,0,0,-3,0,-1,-5,6,0,0,-1,-1,-1,-1,1,6,-1
KR_6760723420,420,-1,-59,-5,-1,-1,2,1,2,3,5,-3,4,1,-2,2,0,3,3,6,0,-1,-114,0,-3,3,-1,0,0,-1,1,-1,-1,3,-1
KR_6748765133,420,-1,-69,-24,3,0,2,2,0,4,4,0,2,2,2,3,5,1,1,2,1,6,-4,-3,-4,7,-1,0,-1,0,-1,-1,1,0,-1
KR_6758338980,420,-5,-34,-29,-12,1,0,1,-4,5,1,-3,3,0,-4,6,2,-2,2,0,0,-8,2,-3,-1,4,-1,0,0,-1,1,1,-1,1,-1
KR_6713511938,420,-5,-43,12,-13,-5,5,0,-4,5,1,0,2,2,-1,2,1,-3,3,0,0,-6,-97,-2,-3,5,5,0,-1,1,-1,-1,-1,3,-1
KR_6717897139,420,-2,30,-7,-4,0,2,2,0,1,1,-1,2,1,-1,3,2,-2,2,0,0,-4,-195,1,-4,3,-3,0,-1,-1,-1,-1,1,2,-1
KR_6760591577,440,-4,-27,-8,-10,-3,7,4,-1,2,1,-3,3,0,-1,2,1,-2,2,0,0,-8,-10,-2,-1,3,2,0,0,0,0,-1,-1,0,-1
KR_6755235197,420,-5,-65,-6,-5,3,1,4,-4,6,2,-5,7,2,0,0,0,1,2,3,0,-5,-20,-2,0,2,1,0,-1,-1,-1,1,1,1,-1
KR_6695724299,420,0,23,-16,0,-3,4,1,-4,7,3,4,2,6,2,3,5,1,0,1,-2,-4,0,2,-4,2,-1,0,0,-1,1,1,-1,5,-1
KR_6731345737,420,-2,-38,-14,-1,-2,2,0,0,1,1,3,0,3,-3,4,1,1,1,2,0,-4,109,4,-5,1,1,0,-1,-1,1,-1,-1,5,-1
KR_6760916635,420,-1,29,-20,-7,1,1,2,4,1,5,-9,9,0,-1,1,0,-2,2,0,-2,-7,4,3,-3,0,0,0,0,-1,1,-1,-1,2,-1
KR_6753660139,420,3,59,40,7,2,0,2,3,2,5,0,5,5,-1,5,4,3,0,3,-2,5,-1,-1,-2,3,0,0,2,-1,1,1,-1,4,-1
KR_6733547299,420,-2,-43,27,-8,0,1,1,-6,7,1,-1,4,3,-1,1,0,0,2,2,0,-8,-16,1,-4,3,0,0,-1,1,-1,-1,-1,6,-1
KR_6750910961,420,-8,-40,13,-18,-3,3,0,-5,5,0,-8,8,0,-1,2,1,-1,1,0,0,-11,4,-4,-1,5,-4,0,-1,-1,-1,-1,-1,3,-1
KR_6724402325,420,0,59,-11,-7,-2,4,2,-4,5,1,-4,5,1,-1,3,2,4,0,4,0,-9,3,3,-4,1,-1,0,1,-1,-1,1,1,6,-1
KR_6648621652,440,0,-13,4,2,-3,4,1,1,4,5,2,2,4,1,4,5,1,0,1,0,3,-107,-2,-2,4,1,0,-1,-1,0,-1,-1,3,-1
KR_6753875498,420,-3,-3,3,-5,-2,3,1,-1,2,1,-1,2,1,-3,3,0,2,3,5,0,-2,-12,-2,-2,4,0,0,0,-1,1,0,-1,5,-1
KR_6735012207,420,-3,10,-24,-7,3,1,4,-2,5,3,-4,5,1,-3,3,0,-1,2,1,0,-10,0,-3,-4,7,-1,0,0,-1,0,0,1,2,-1
KR_6746246653,440,-5,-4,-35,-12,-4,5,1,-3,6,3,1,3,4,-6,10,4,0,2,2,-3,-4,-1,0,0,0,2,0,-2,1,-1,-1,-1,1,-1
KR_6753081198,420,3,6,8,4,-1,1,0,9,1,10,-2,2,0,-3,5,2,1,0,1,-1,2,-118,5,-8,3,-1,0,0,1,1,0,-1,6,-1
KR_6761406493,420,4,29,8,9,0,1,1,0,0,0,0,0,0,6,0,6,3,0,3,0,13,1,0,-4,4,2,0,0,1,-1,1,1,5,-1
KR_6662873676,420,-1,40,-12,-4,0,2,2,-4,5,1,-6,7,1,5,1,6,1,1,2,-1,-10,-20,-3,-3,6,4,0,0,1,0,0,-1,1,-1
KR_6649219847,420,-2,-25,2,-11,1,2,3,-2,3,1,-3,4,1,-3,5,2,-4,4,0,-1,-11,-9,-10,-1,11,5,0,-2,1,-1,-1,-1,5,-1
KR_6731925742,420,2,-29,0,4,4,0,4,2,3,5,0,2,2,-1,2,1,-1,1,0,0,-9,-1,-2,-2,4,-2,0,1,-1,1,1,1,6,-1
KR_6752768313,420,-2,-18,40,-4,0,2,2,0,4,4,-2,4,2,-3,4,1,1,0,1,0,0,305,-1,-2,3,2,0,-2,0,0,-1,-1,0,-1
KR_6707013939,420,-1,-86,12,0,2,0,2,-1,6,5,-2,4,2,1,4,5,0,0,0,-1,-4,27,-5,-2,7,4,0,-1,1,1,-1,-1,2,-1
KR_6662434423,440,-4,-67,-46,-7,-6,6,0,-1,2,1,-2,4,2,1,1,2,1,0,1,0,0,290,-2,-2,4,-3,0,-1,1,-1,-1,-1,4,-1
KR_6634798573,420,-7,-156,-29,-16,-3,3,0,-3,4,1,-4,5,1,0,0,0,-6,6,0,0,-12,-390,-3,-3,6,0,0,-3,-1,-1,-1,-1,5,-1
KR_6537832992,420,0,7,-38,2,1,1,2,0,3,3,-4,6,2,3,0,3,2,2,4,0,3,358,-1,-1,2,1,0,2,0,-1,1,1,0,-1
KR_6749349163,420,-2,-10,-16,-6,-5,7,2,-1,3,2,0,2,2,-2,4,2,2,1,3,-1,-4,-1,-5,-3,8,-4,0,0,-1,-1,0,-1,4,-1
KR_6744747027,420,-4,-68,-52,1,-3,4,1,-6,6,0,0,1,1,10,0,10,0,1,1,0,3,-36,0,-3,3,22,0,-2,1,-1,1,1,6,-1
KR_6648363583,440,0,53,12,-3,3,0,3,3,2,5,-5,5,0,-2,2,0,-2,2,0,-2,-6,-14,0,-2,2,-5,0,-1,-1,0,-1,-1,2,-1
KR_6743721084,440,1,-29,-15,1,-4,6,2,3,1,4,-2,4,2,1,2,3,3,2,5,0,2,-48,-1,-2,3,27,0,-2,-1,-1,-1,1,6,-1
KR_6745970689,420,-2,-5,-16,-5,-3,3,0,0,3,3,1,1,2,0,2,2,-3,3,0,0,-3,-1,2,-7,5,-3,0,0,0,-1,0,-1,0,-1
KR_6746231859,420,-3,4,12,-7,-2,2,0,-1,5,4,0,1,1,-3,3,0,-1,1,0,-1,-11,-6,1,-3,2,0,0,-1,-1,1,-1,-1,3,-1
KR_6530678732,440,-4,-66,-34,-11,0,1,1,-5,6,1,-1,3,2,-1,2,1,-4,4,0,0,-15,-3,-3,0,3,0,0,-3,-1,-1,-1,-1,2,-1
KR_6655539071,440,-8,-58,-52,-14,0,1,1,1,1,2,-5,8,3,-10,11,1,0,1,1,0,-7,18,1,-5,4,-2,0,-2,-1,-1,-1,-1,2,-1
KR_6748065714,420,-1,67,-17,4,7,0,7,7,1,8,-5,5,0,-3,4,1,-2,2,0,1,-1,4,-1,-4,5,-1,0,1,-1,1,1,1,4,-1
KR_6654853184,420,-9,-98,-68,-17,-3,4,1,0,1,1,-3,5,2,-9,10,1,-2,3,1,0,-13,-44,-2,-1,3,14,0,-2,-1,1,-1,1,5,-1
KR_6717619782,440,3,12,19,3,1,0,1,0,1,1,2,3,5,-2,3,1,2,0,2,0,3,-4,-6,-3,9,2,0,0,-1,1,0,1,3,-1
KR_6753852077,420,1,11,1,4,2,1,3,4,0,4,-4,4,0,2,2,4,0,2,2,1,2,11,3,-4,1,-3,0,-1,1,-1,-1,1,3,-1
KR_6749592427,440,0,29,5,0,0,0,0,-1,3,2,1,0,1,1,2,3,-1,2,1,0,-4,-17,1,-5,4,2,0,0,-1,-1,0,1,4,-1
KR_6726810490,440,0,-2,-23,1,1,0,1,-2,3,1,1,3,4,1,3,4,0,1,1,0,0,87,0,-6,6,29,0,-1,-1,-1,-1,-1,4,-1
KR_6752939747,420,0,20,-8,1,7,2,9,2,1,3,-5,6,1,-2,3,1,-1,1,0,-1,-3,-7,1,-4,3,-3,0,1,1,1,-1,-1,5,-1
KR_6721982517,440,-6,-18,-22,-15,-4,6,2,-1,3,2,-4,4,0,2,2,4,-8,8,0,-1,-16,13,1,-3,2,-2,0,-1,-1,0,-1,-1,2,-1
KR_6743050257,420,2,83,8,2,4,2,6,0,3,3,1,0,1,0,4,4,-3,5,2,-1,-6,1,1,-3,2,-3,0,0,1,1,1,-1,5,-1
KR_6751257455,420,2,-7,18,-2,0,1,1,-1,4,3,4,0,4,-3,4,1,-2,2,0,1,-6,-9,3,-8,5,-4,0,0,-1,1,-1,-1,3,-1
KR_5829264150,420,5,-30,21,5,0,1,1,2,5,7,-2,3,1,3,0,3,2,0,2,0,8,0,-1,-2,3,1,0,-3,1,1,-1,-1,4,-1
KR_6737148533,420,-4,-71,-4,-8,-3,4,1,-2,2,0,0,0,0,-2,2,0,-1,4,3,0,-6,-10,-1,-4,5,-4,0,-1,-1,-1,-1,-1,2,-1
KR_6479258447,440,0,3,2,-4,-2,2,0,1,6,7,-1,3,2,-1,5,4,-1,2,1,0,-2,-1,-9,-1,10,1,0,1,1,0,1,-1,6,-1
KR_6749044394,420,2,43,-19,-1,1,2,3,-1,6,5,-1,3,2,-2,3,1,2,0,2,0,1,9,1,-5,4,-2,0,-1,-1,0,-1,1,2,-1
KR_6533988607,420,1,-16,4,1,0,1,1,1,1,2,-1,4,3,1,2,3,0,0,0,0,4,142,4,-6,2,-1,0,1,1,1,1,-1,5,-1
KR_6599734692,420,-3,-65,11,-5,-9,9,0,2,1,3,1,3,4,2,0,2,-1,1,0,-1,-4,36,-2,-3,5,-13,0,-2,-1,-1,-1,-1,6,-1
KR_6718079778,440,-6,-33,-22,-7,-2,2,0,-3,4,1,1,1,2,-2,4,2,-1,1,0,0,-12,21,1,-3,2,-1,0,0,-1,1,-1,-1,3,-1
KR_6400602279,420,0,-43,-16,-2,-2,2,0,-1,2,1,6,0,6,-3,8,5,-2,2,0,1,-3,236,-1,-5,6,-3,0,0,-1,0,0,1,2,-1
KR_6762060232,420,-1,11,54,-13,-6,6,0,-1,4,3,1,2,3,-6,8,2,-1,1,0,0,-10,7,1,-4,3,0,0,0,-1,-1,-1,-1,4,-1
KR_6762275436,420,-3,28,-17,-4,-1,2,1,-1,3,2,-1,1,0,-2,2,0,1,0,1,0,-2,-5,1,-2,1,-2,0,0,1,0,0,-1,3,-1
KR_6708691548,420,-4,-89,39,-10,-3,3,0,-9,9,0,4,0,4,-2,4,2,0,2,2,0,0,-9,-4,0,4,-1,0,-1,-1,-1,-1,-1,1,-1
KR_6750932997,420,-3,-14,-11,-12,-2,2,0,-5,8,3,-9,11,2,4,2,6,0,1,1,0,-5,2,-4,-4,8,-5,0,-2,-1,0,-1,-1,2,-1
KR_6733153902,420,0,64,-22,-1,1,1,2,1,1,2,2,4,6,-1,1,0,-4,4,0,0,-4,-2,5,-5,0,-2,0,0,-1,1,0,1,3,-1
KR_6751979275,420,-6,-41,-28,-13,-5,6,1,0,3,3,-1,3,2,-3,10,7,-4,7,3,2,1,-9,1,-3,2,-1,0,-1,-1,1,-1,1,3,-1
KR_6757865589,420,-1,-39,-16,5,-4,4,0,5,0,5,6,1,7,0,4,4,-2,4,2,0,14,0,0,-2,2,0,0,-1,1,1,-1,1,6,-1
KR_6695255393,420,-5,-70,-32,-10,-1,4,3,0,2,2,0,1,1,-8,12,4,-1,2,1,1,-3,-2,-6,-1,7,0,0,-1,-1,-1,-1,1,3,-1
KR_6753403097,420,-1,-71,-21,-4,1,2,3,0,2,2,-3,3,0,0,2,2,-2,2,0,0,-8,5,-1,-5,6,-2,0,-1,-1,-1,-1,-1,6,-1
KR_6744943590,420,-4,-35,-37,-8,-1,2,1,-5,8,3,2,1,3,-3,4,1,-1,1,0,-1,-7,-64,3,-3,0,15,0,-1,0,-1,-1,-1,0,-1
KR_6760473739,440,-8,-111,-12,-20,-2,2,0,-2,2,0,0,5,5,-15,17,2,-1,2,1,0,-21,38,-1,-5,6,2,0,-2,-1,0,-1,-1,5,-1
KR_6705510996,420,-6,7,-74,-12,1,0,1,-2,2,0,-4,5,1,-6,6,0,-1,1,0,0,-13,-6,-2,-7,9,-2,0,-2,-1,-1,-1,1,2,-1
KR_6644233133,420,4,124,10,5,-1,1,0,0,3,3,-3,4,1,4,1,5,5,0,5,0,6,42,3,-6,3,-23,0,1,-1,1,1,-1,1,-1
KR_6759105818,420,-4,-95,-20,-10,-2,4,2,-5,5,0,0,4,4,-2,2,0,-1,2,1,1,-9,4,-1,-4,5,-3,0,-1,-1,-1,-1,1,3,-1
KR_6761227373,420,-1,-39,8,-10,-3,3,0,-5,5,0,-1,1,0,2,2,4,-3,4,1,0,-8,-12,-4,-3,7,2,0,-1,1,1,-1,-1,6,-1
KR_6669401146,420,-2,29,-33,-2,-3,3,0,-1,5,4,0,0,0,-1,3,2,3,0,3,0,0,7,2,-4,2,1,0,0,1,-1,-1,1,2,-1
KR_6703520543,420,-5,-76,4,-9,-2,3,1,0,1,1,-1,4,3,-2,6,4,-4,6,2,0,-7,23,-4,-4,8,-8,0,-1,0,-1,-1,1,0,-1
KR_6729475144,420,1,-1,1,0,3,0,3,-3,4,1,-2,3,1,1,3,4,1,1,2,0,-8,-4,1,-3,2,2,0,-1,0,1,-1,-1,0,-1
KR_6652319968,420,0,40,-4,-2,0,0,0,1,2,3,-2,6,4,-2,3,1,1,2,3,1,-1,-198,0,-2,2,-2,0,-1,-1,-1,-1,1,4,-1
KR_6623105106,420,-1,1,4,3,0,1,1,1,1,2,-1,2,1,3,2,5,0,0,0,0,8,-4,-1,-1,2,0,0,1,1,1,1,1,2,-1
KR_6711699141,420,-1,-22,-2,-7,-11,11,0,2,2,4,1,2,3,1,1,2,0,2,2,0,5,6,1,-4,3,-2,-1,-3,1,-1,-1,-1,3,-1
KR_6758243717,420,0,26,-20,1,-6,6,0,0,2,2,1,1,2,4,0,4,2,0,2,0,9,18,2,-3,1,-1,0,-2,-1,-1,-1,-1,5,-1
KR_6519056485,420,-4,-55,-8,0,2,0,2,4,0,4,-5,7,2,-2,3,1,1,0,1,0,-8,7,-1,-5,6,-5,0,-1,0,0,-1,-1,0,-1
KR_6715774138,420,-1,7,8,-2,-3,3,0,1,0,1,4,2,6,-4,5,1,0,0,0,0,0,-3,-1,-1,2,2,0,-2,-1,0,-1,-1,5,-1
KR_6728033132,420,-6,-113,-68,-6,-1,1,0,-1,4,3,2,2,4,-2,3,1,-4,5,1,0,-5,-4,2,-4,2,2,0,-1,-1,-1,-1,1,4,-1
KR_6761461401,420,-4,-46,-11,-14,-5,6,1,-4,5,1,-4,4,0,-1,1,0,0,0,0,0,-7,-116,3,-5,2,-4,0,-2,-1,-1,-1,-1,2,-1
KR_6630212517,420,-3,-62,-5,-1,0,2,2,3,0,3,-1,3,2,-1,5,4,-2,2,0,0,-4,2,4,-4,0,0,0,-2,0,1,-1,-1,0,-1
KR_6759779905,420,-1,39,-15,-5,4,2,6,0,0,0,-10,11,1,2,1,3,-1,1,0,1,-5,13,-3,-1,4,-3,0,1,1,-1,1,1,4,-1
KR_6735752830,440,-4,-120,0,-7,-3,3,0,-3,7,4,-2,4,2,0,1,1,1,1,2,-1,-13,-14,0,-9,9,-1,0,-1,-1,-1,-1,-1,5,-1
KR_6695319044,420,-4,-33,9,-11,0,1,1,-3,4,1,-2,2,0,-6,6,0,0,0,0,1,-13,-39,-6,-1,7,11,0,0,-1,1,0,1,2,-1
KR_6684478256,420,1,29,-19,5,-5,5,0,2,1,3,5,3,8,1,3,4,2,0,2,0,9,-40,-2,-2,4,22,0,0,1,1,1,1,6,-1
KR_6761608035,440,1,-57,23,5,0,2,2,1,0,1,4,2,6,-1,4,3,1,1,2,0,-3,-2,-2,-3,5,-2,0,-1,-1,-1,-1,-1,6,-1
KR_6759780474,420,0,-7,-10,3,0,1,1,3,3,6,0,0,0,1,0,1,-1,1,0,0,4,-42,-2,-2,4,24,0,-1,-1,-1,-1,1,6,-1
KR_6703766962,420,-3,-7,-16,-6,-2,4,2,-5,5,0,0,1,1,2,2,4,-1,3,2,0,-5,-43,1,-4,3,25,0,-1,-1,-1,-1,1,1,-1
KR_6755552361,420,0,-20,-21,-3,-1,4,3,0,0,0,1,1,2,-2,5,3,-1,1,0,-1,-11,4,-1,-4,5,-1,0,0,-1,-1,-1,-1,5,-1
KR_6744416672,420,-8,-98,-37,-3,-3,3,0,-5,6,1,-2,2,0,6,1,7,1,1,2,0,-3,9,-1,-3,4,-2,0,-1,-1,-1,-1,1,6,-1
KR_6756869905,420,-2,-20,-15,-2,0,3,3,-2,6,4,-3,3,0,2,0,2,1,1,2,0,-2,6,2,-2,0,0,0,0,0,1,1,1,0,-1
KR_6421540513,420,-7,-135,-27,-12,-2,2,0,1,2,3,-5,8,3,-6,9,3,0,1,1,0,-4,12,0,-3,3,-3,0,-1,-1,-1,-1,-1,5,-1
KR_6744752540,420,-1,-69,16,-9,-1,1,0,0,4,4,-1,2,1,-5,8,3,-2,3,1,-2,-14,7,0,-1,1,-1,0,-1,0,-1,-1,-1,0,-1
KR_6622305209,420,-4,-38,-7,-11,-5,6,1,-2,3,1,-3,4,1,-2,4,2,1,0,1,-1,-5,5,-5,-1,6,-3,0,-1,-1,-1,-1,-1,4,-1
KR_6754177939,420,0,-25,14,-6,-2,3,1,-2,4,2,4,1,5,-7,8,1,1,0,1,0,-11,-4,-8,0,8,4,0,0,-1,0,0,-1,1,-1
KR_6712221313,440,-2,-18,4,-3,0,2,2,1,1,2,2,3,5,-4,6,2,-2,2,0,0,-4,146,-2,-2,4,0,0,0,1,1,-1,-1,1,-1
KR_6744876265,420,-3,-44,-10,-5,1,1,2,-3,6,3,-1,2,1,-1,4,3,-1,1,0,0,1,2,0,-2,2,6,0,-1,0,-1,-1,-1,0,-1
KR_6750356719,420,1,49,20,-1,-2,3,1,6,1,7,-3,3,0,-1,2,1,-1,2,1,2,5,-12,3,-6,3,0,0,0,1,1,0,1,1,-1
KR_6747267468,420,-1,7,-8,-2,-3,5,2,-2,3,1,1,2,3,1,0,1,1,1,2,-1,-1,5,-3,-1,4,0,0,1,0,0,1,-1,0,-1
KR_6710372149,420,-2,-8,-6,-2,-1,2,1,0,3,3,-2,3,1,0,2,2,1,1,2,0,-8,-8,0,-3,3,2,0,1,1,-1,-1,1,2,-1
KR_6695111947,420,1,-5,-16,3,4,2,6,4,0,4,-1,2,1,-6,8,2,2,1,3,1,1,11,4,-6,2,-3,0,-1,0,1,-1,1,0,-1
KR_6637942516,420,0,-5,-6,6,5,2,7,0,2,2,-3,6,3,3,0,3,1,1,2,0,4,1,0,-2,2,0,0,1,1,0,1,1,4,-1
KR_6763223067,420,-2,-25,11,-6,4,2,6,0,1,1,-5,6,1,-4,4,0,-1,1,0,1,-6,3,0,-4,4,0,0,0,1,0,0,1,5,-1
KR_6671548655,420,2,2,42,-1,2,0,2,-2,3,1,0,0,0,-2,2,0,1,0,1,0,-5,-6,-1,-3,4,3,0,-1,-1,-1,-1,-1,6,-1
KR_6649105119,420,-8,-124,-36,-22,0,2,2,-10,12,2,-10,10,0,-3,6,3,1,0,1,-1,-12,-16,-1,-3,4,0,0,-3,-1,-1,-1,-1,1,-1
KR_6762514487,420,1,-57,28,0,4,2,6,2,0,2,4,0,4,-6,7,1,-4,5,1,-1,-7,13,4,-6,2,-6,0,-1,-1,1,-1,-1,5,-1
KR_6674353529,420,-1,-19,-28,0,-3,3,0,6,0,6,1,1,2,0,2,2,-4,4,0,0,1,3,5,-7,2,4,0,0,-1,1,0,1,4,-1
KR_6754262634,420,-1,-26,-16,-6,4,2,6,2,2,4,-7,7,0,-6,8,2,1,2,3,-2,-12,1,-1,-3,4,-2,0,0,-1,0,1,-1,6,-1
KR_6755327430,420,-1,27,-4,-9,0,3,3,-2,2,0,3,1,4,-10,10,0,0,0,0,-2,-10,7,1,-5,4,3,0,0,0,1,0,-1,0,-1
KR_6659610265,420,-4,-68,-34,-13,-4,4,0,-2,3,1,-2,3,1,-5,5,0,0,0,0,0,-17,-21,-5,-1,6,2,0,-1,-1,-1,-1,-1,3,-1
KR_6742885819,420,-1,-65,-8,-6,1,0,1,-3,3,0,-2,4,2,-3,6,3,1,0,1,0,-8,-2,2,-5,3,0,0,-1,-1,-1,-1,1,1,-1
KR_6753324370,420,2,-52,8,0,0,5,5,-1,3,2,0,2,2,3,1,4,-2,3,1,0,13,21,-2,-1,3,4,0,0,0,-1,-1,-1,0,-1
KR_6750724250,420,-5,10,-16,-7,-2,2,0,-2,3,1,-2,2,0,0,5,5,-1,3,2,-1,-11,5,1,-5,4,-3,0,0,-1,-1,0,-1,5,-1
KR_6763222934,420,-1,42,-24,-4,-1,2,1,-7,9,2,-1,3,2,3,1,4,2,4,6,-1,-7,5,2,-4,2,0,0,0,-1,-1,-1,-1,2,-1
KR_6763917939,420,2,-10,10,5,5,0,5,1,1,2,1,3,4,0,2,2,-2,3,1,0,11,-58,0,-4,4,-6,0,1,-1,0,1,1,5,-1
KR_6638290844,420,-2,-40,9,-6,1,3,4,0,3,3,-1,3,2,0,0,0,-6,6,0,-1,-8,3,0,-2,2,-1,0,-1,0,0,-1,-1,0,-1
KR_6758309821,420,2,25,9,1,0,0,0,-3,4,1,-2,5,3,4,0,4,2,0,2,0,3,11,-1,-1,2,2,0,0,1,1,1,1,2,-1
KR_6739670873,420,-5,-63,9,-6,-2,2,0,-5,9,4,2,2,4,0,1,1,-1,1,0,-1,-8,50,-3,-1,4,-22,0,-1,-1,-1,-1,-1,3,-1
KR_6752256836,420,-1,-103,-28,-9,-4,4,0,0,1,1,-1,2,1,-4,6,2,0,0,0,0,-7,12,0,-7,7,-5,0,-1,-1,-1,-1,-1,2,-1
KR_6739107451,420,0,-34,-3,-1,0,2,2,2,2,4,-1,1,0,-2,5,3,0,0,0,0,2,-32,0,-3,3,26,0,0,1,-1,-1,-1,4,-1
KR_6763655146,420,-3,-103,32,-7,0,1,1,-4,5,1,-3,3,0,0,1,1,0,0,0,0,-3,-261,-4,-2,6,-2,0,-3,-1,1,-1,-1,4,-1
KR_6678934156,440,-7,-165,-38,-17,-4,5,1,0,1,1,-4,4,0,-11,11,0,2,0,2,0,-11,-416,-1,-6,7,-2,0,-2,-1,0,-1,1,4,-1
KR_6699245633,420,2,22,28,0,0,3,3,-2,2,0,0,2,2,2,2,4,0,2,2,0,-3,-8,-6,-1,7,4,0,1,0,1,1,1,0,-1
KR_6530653151,420,-3,-39,-56,-1,-2,2,0,2,2,4,4,2,6,-3,3,0,-2,2,0,-1,8,13,0,-1,1,1,0,0,-1,-1,0,-1,2,-1
KR_6753169019,440,-5,-89,26,-14,-4,7,3,-4,5,1,0,1,1,-6,7,1,0,0,0,-2,-9,-6,-1,-1,2,-4,0,0,-1,1,0,-1,2,-1
KR_6760037585,420,2,-29,16,-4,3,2,5,-6,7,1,1,2,3,-2,4,2,0,0,0,-1,-7,-16,-7,0,7,-1,0,-2,1,-1,-1,-1,4,-1
KR_5693857738,420,-1,22,-2,1,-2,3,1,-2,4,2,1,0,1,2,2,4,2,0,2,0,4,-9,-1,-2,3,1,0,1,-1,-1,1,-1,2,-1
KR_6742719504,420,1,-39,24,-1,3,1,4,-6,8,2,-2,3,1,3,1,4,1,1,2,0,4,-48,5,-6,1,14,0,1,-1,1,1,1,5,-1
KR_6707357381,420,-3,24,-24,-5,1,0,1,-2,4,2,-5,7,2,1,1,2,0,1,1,0,-2,-12,-1,-5,6,1,0,0,-1,-1,0,-1,4,-1
KR_6733838993,440,-2,-32,-11,-4,0,1,1,-1,3,2,0,0,0,-1,7,6,-2,2,0,1,6,-3,0,-1,1,0,0,0,0,1,0,1,0,-1
KR_6603201540,420,-5,-78,-17,-8,-3,4,1,1,0,1,0,3,3,-7,7,0,1,0,1,-1,-5,-4,-5,0,5,0,0,-1,-1,0,-1,-1,2,-1
KR_6727394911,420,-2,-40,0,-3,-8,8,0,-1,2,1,0,0,0,6,3,9,0,2,2,-1,13,19,6,-7,1,-3,0,-1,-1,-1,-1,-1,6,-1
KR_5664495369,420,-1,16,-22,-9,2,2,4,-1,2,1,-4,6,2,-4,4,0,-2,3,1,0,-12,-3,1,-4,3,-3,0,0,1,-1,-1,-1,4,-1
KR_6759830930,440,-3,-28,-24,-5,-6,10,4,2,0,2,5,1,6,-7,9,2,1,1,2,4,0,-4,-1,-4,5,-7,0,-1,-1,-1,-1,1,5,-1
KR_6743349644,440,-3,-100,-8,-4,0,2,2,-2,2,0,-3,3,0,1,4,5,0,1,1,0,-1,12,3,-7,4,-8,0,-2,-1,1,1,-1,1,-1
KR_6754819107,440,-7,-29,-20,-16,-2,3,1,-6,9,3,1,2,3,-1,6,5,-8,8,0,0,-1,5,1,-1,0,-2,0,-2,0,-1,-1,-1,0,-1
KR_6701469782,420,0,-25,-28,-2,-6,8,2,-6,8,2,0,1,1,9,1,10,1,0,1,0,8,-50,-6,-1,7,20,0,0,1,-1,-1,1,3,-1
KR_6730734238,420,-5,-107,-38,-8,-5,5,0,-2,4,2,-1,2,1,0,0,0,0,0,0,0,2,1,-5,-1,6,-1,0,-1,0,-1,-1,-1,0,-1
KR_6694394851,440,-3,-67,8,-8,-2,3,1,-1,4,3,-4,5,1,-1,3,2,0,0,0,0,-6,5,0,-5,5,-2,0,0,-1,-1,-1,1,1,-1
KR_6752241369,440,-1,-43,8,-5,3,2,5,-1,2,1,-3,5,2,-4,4,0,0,0,0,0,-6,0,-4,-6,10,-1,0,0,1,0,0,1,4,-1
KR_6692745122,420,-3,-73,-11,1,-2,4,2,-2,4,2,4,3,7,-1,5,4,2,2,4,0,2,33,1,-5,4,-32,0,-1,1,1,-1,1,5,-1
KR_6734880548,440,-5,-95,8,-16,-3,4,1,0,0,0,-2,4,2,-8,10,2,-3,3,0,0,-15,-5,-1,-1,2,2,0,0,-1,0,-1,-1,4,-1
KR_6746311508,420,-6,-126,-28,-10,-2,4,2,-1,1,0,-6,6,0,-1,2,1,0,0,0,0,2,-34,-1,-1,2,0,0,-1,1,1,-1,-1,1,-1
KR_6712999953,420,-1,-53,-12,0,3,0,3,0,3,3,2,2,4,-4,5,1,-1,2,1,0,5,-23,2,-5,3,2,0,-1,-1,-1,-1,-1,1,-1
KR_6689168845,420,-2,-31,-16,-1,1,1,2,0,1,1,3,2,5,-5,7,2,0,0,0,0,-4,-4,1,-1,0,-1,0,-2,0,1,-1,1,0,-1
KR_6759986979,420,-1,-28,-21,1,0,3,3,0,4,4,5,3,8,-4,7,3,0,0,0,0,-3,1,2,-7,5,-2,0,-1,-1,1,-1,-1,1,-1
KR_6738099565,440,1,16,-12,1,-4,5,1,-1,1,0,2,3,5,5,1,6,-1,2,1,0,6,-2,0,-2,2,5,0,0,1,-1,1,1,1,-1
KR_6491592960,420,-7,-96,-34,-15,0,2,2,-5,6,1,-2,5,3,-7,10,3,-1,3,2,-1,-8,5,5,-10,5,-6,0,-3,-1,-1,-1,-1,1,-1
KR_6751117451,420,-2,-56,8,-6,2,0,2,0,1,1,1,1,2,-9,9,0,0,1,1,0,-9,6,2,-4,2,1,0,1,-1,-1,1,-1,2,-1
KR_6764524848,420,0,-28,8,-4,1,1,2,-1,1,0,0,4,4,-4,4,0,0,1,1,0,-10,0,4,-6,2,4,0,0,0,0,0,1,0,-1
KR_6651303959,420,1,-16,36,5,-2,3,1,7,2,9,3,3,6,0,4,4,-3,3,0,0,0,-4,2,-4,2,0,0,0,1,-1,-1,-1,5,-1
KR_6738581021,420,-3,-19,-44,1,-5,5,0,4,3,7,3,2,5,2,2,4,-3,3,0,1,5,-70,1,-7,6,8,0,0,-1,-1,-1,1,6,-1
KR_6731875260,440,-4,-35,-29,-11,0,1,1,-1,5,4,-7,7,0,-2,3,1,-1,3,2,-1,-10,4,2,-3,1,1,0,-2,-1,0,-1,1,3,-1
KR_6728232227,420,-2,3,5,1,-1,3,2,2,4,6,2,2,4,0,1,1,-2,5,3,1,-4,-199,0,-6,6,3,0,2,-1,1,1,1,4,-1
KR_6623015369,420,0,-18,12,-5,-2,3,1,-3,4,1,1,2,3,-1,3,2,0,2,2,-1,-3,3,-3,-3,6,1,0,-1,-1,-1,-1,-1,4,-1
KR_6758285732,440,1,-48,-15,3,1,0,1,6,0,6,3,1,4,-7,7,0,0,1,1,0,2,9,1,-3,2,-3,0,0,-1,0,0,1,3,-1
KR_6761116384,440,0,-14,-2,3,-2,2,0,2,2,4,-1,1,0,2,3,5,2,2,4,0,10,-422,2,-5,3,-4,0,1,1,-1,1,-1,5,-1
KR_6754759203,440,-1,11,9,-4,0,2,2,0,2,2,2,1,3,-5,7,2,-1,3,2,0,-9,-9,-5,-2,7,4,0,-1,1,0,-1,-1,5,-1
KR_6764305544,420,-1,43,0,0,1,2,3,-1,5,4,0,4,4,1,3,4,-1,2,1,-1,-4,-47,1,-3,2,-1,0,1,-1,1,1,1,6,-1
KR_6763482284,420,-1,-34,-9,2,0,3,3,-2,2,0,1,1,2,4,1,5,-1,2,1,0,2,10,3,-4,1,1,0,-1,0,-1,-1,1,0,-1
KR_6630278233,420,-1,-11,16,-1,-4,4,0,-3,3,0,1,0,1,4,2,6,1,2,3,0,1,9,2,-3,1,-2,0,0,1,-1,-1,1,5,-1
KR_6627359100,420,-8,-163,9,-11,-5,5,0,-2,3,1,0,1,1,-3,4,1,-1,1,0,0,-12,0,-2,-2,4,-6,0,-1,-1,1,-1,-1,6,-1
KR_6761323497,420,-5,-55,17,-9,-2,3,1,-3,6,3,-2,3,1,-2,3,1,0,1,1,0,-5,111,0,-4,4,-5,0,-1,-1,-1,-1,-1,1,-1
KR_6744795488,420,-3,-32,0,-4,0,2,2,0,2,2,-3,4,1,0,4,4,-1,1,0,0,-8,30,1,-5,4,-1,0,0,1,-1,0,1,6,-1
KR_6741530503,420,-4,-16,-5,-8,-3,5,2,-2,3,1,4,1,5,-6,9,3,-1,1,0,0,-10,2,-2,-2,4,1,0,0,-1,0,1,1,6,-1
KR_6758057535,420,0,-1,-8,2,3,0,3,-3,4,1,2,0,2,-4,4,0,4,1,5,0,-2,-137,-4,0,4,4,0,-1,0,-1,-1,1,0,-1
KR_6754445240,420,0,5,0,2,-2,4,2,-2,3,1,2,1,3,3,0,3,1,0,1,0,0,5,-1,-4,5,1,0,0,-1,1,0,-1,4,-1
KR_6764333303,420,-4,-3,-27,-8,-2,2,0,-2,3,1,0,0,0,-4,5,1,0,1,1,0,-12,9,0,-2,2,-4,0,-2,-1,-1,-1,-1,2,-1
KR_6040411439,420,-2,-50,-24,-5,-5,6,1,2,1,3,0,4,4,-1,2,1,-1,3,2,0,-6,1,3,-4,1,6,0,-2,-1,-1,-1,-1,1,-1
KR_6715850355,420,0,103,-35,6,4,2,6,0,4,4,0,3,3,0,2,2,2,3,5,0,-1,-34,3,-4,1,-4,0,1,-1,1,1,1,2,-1
KR_6750800769,420,-5,-25,-16,-10,-2,3,1,1,1,2,-5,6,1,-2,4,2,-2,2,0,0,-9,-3,-2,-4,6,-1,0,-2,-1,-1,-1,-1,4,-1
KR_6648517183,420,-5,-8,-28,-12,0,1,1,-1,3,2,-1,4,3,-5,5,0,-5,5,0,0,-13,12,-1,-3,4,-3,0,-1,1,1,-1,1,5,-1
KR_6002835441,420,4,-21,30,7,4,0,4,0,1,1,0,2,2,2,0,2,1,1,2,0,9,-1,3,-7,4,1,0,-1,1,0,-1,1,4,-1
KR_6756813952,420,1,-29,16,5,2,2,4,4,3,7,0,3,3,-1,1,0,0,0,0,-1,0,238,1,-3,2,0,0,0,1,1,-1,-1,6,-1
KR_6745987642,420,-5,-99,-21,-7,-2,4,2,1,6,7,-3,5,2,-3,7,4,0,1,1,-1,-1,-1,4,-4,0,-4,0,-1,-1,1,-1,-1,3,-1
KR_6635477390,420,0,-7,16,0,1,2,3,0,2,2,2,1,3,1,3,4,-4,5,1,0,1,9,4,-5,1,-2,0,0,1,-1,-1,-1,1,-1
KR_6759763539,420,4,38,12,7,1,0,1,1,2,3,3,1,4,4,2,6,-2,2,0,0,7,8,-1,-4,5,-1,0,2,0,1,1,-1,0,-1
KR_6591723147,420,3,11,36,3,1,2,3,2,0,2,2,0,2,-1,3,2,-1,2,1,0,0,39,3,-4,1,-20,0,2,-1,1,1,1,1,-1
KR_6690923051,420,-4,-17,-32,-4,2,1,3,-7,8,1,1,0,1,1,1,2,-1,3,2,0,-6,2,-3,-4,7,3,0,1,-1,-1,1,1,6,-1
KR_6680560010,420,-4,-13,12,-14,-3,3,0,-1,1,0,-4,4,0,-7,8,1,1,0,1,-1,-10,-2,-2,-4,6,-1,0,-2,-1,-1,-1,-1,6,-1
KR_6743208300,420,1,84,8,10,1,1,2,-2,4,2,7,1,8,-1,2,1,5,0,5,2,2,1,0,-3,3,0,0,0,-1,1,0,1,1,-1
KR_6650025363,420,-1,-21,0,0,2,0,2,-3,5,2,1,2,3,1,1,2,-1,1,0,0,-5,4,-1,-2,3,-1,0,1,-1,1,1,-1,4,-1
KR_6321556646,420,-1,-67,0,-2,4,0,4,-5,6,1,0,1,1,-2,3,1,1,0,1,0,-7,-39,-3,-3,6,1,0,-1,1,-1,-1,-1,3,-1
KR_6752822845,440,-4,-27,-32,-14,0,2,2,-8,8,0,-3,3,0,-2,3,1,-1,2,1,1,-15,1,3,-4,1,-3,0,-1,1,-1,-1,1,1,-1
KR_6705866371,420,1,51,-20,3,2,0,2,0,4,4,3,1,4,-2,3,1,0,1,1,-1,1,-2,-6,-1,7,0,0,2,1,1,1,-1,2,-1
KR_6751187264,420,4,66,23,5,0,3,3,0,2,2,7,2,9,-1,5,4,-1,4,3,0,-3,-4,-1,-2,3,3,0,0,1,1,1,1,6,-1
KR_6752559118,440,-4,-28,-4,-9,3,3,6,-3,4,1,-1,2,1,-6,7,1,-2,2,0,0,-15,-8,-1,-1,2,0,0,-2,-1,-1,-1,-1,3,-1
KR_6684831741,420,-4,-39,8,-14,-1,2,1,-5,5,0,-2,2,0,-5,5,0,-1,1,0,0,-19,141,-2,-2,4,-2,0,-1,-1,1,-1,-1,5,-1
KR_6195866548,420,-3,-19,3,-3,0,1,1,-1,4,3,1,2,3,-3,4,1,0,0,0,0,-2,6,5,-9,4,-3,0,1,1,1,1,1,1,-1
KR_6715249932,420,2,26,29,2,2,2,4,1,1,2,-3,4,1,1,0,1,1,0,1,0,3,5,3,-5,2,2,0,0,-1,1,0,-1,1,-1
KR_6689032555,420,3,-3,24,13,3,2,5,3,0,3,-4,6,2,6,0,6,5,0,5,-1,11,-4,-2,-1,3,4,0,2,1,-1,1,-1,6,-1
KR_6756915153,420,3,34,8,6,2,1,3,6,2,8,-3,5,2,1,3,4,0,0,0,0,4,0,0,-4,4,1,0,1,-1,1,1,1,4,-1
KR_6695621294,420,1,-2,20,3,-2,5,3,6,0,6,3,0,3,-4,5,1,0,1,1,-1,4,-238,1,-5,4,2,0,-2,1,-1,-1,-1,1,-1
KR_6761748270,420,-1,-52,-20,0,-1,2,1,4,3,7,0,1,1,-3,4,1,0,0,0,0,-2,-5,-3,-1,4,-4,0,0,0,-1,0,1,0,-1
KR_6752185502,420,0,20,-4,2,0,1,1,-3,5,2,0,4,4,4,2,6,1,2,3,2,5,-1,0,-4,4,-2,0,0,0,-1,1,1,0,-1
KR_6725772302,420,-4,-80,-4,-9,2,0,2,-2,2,0,-7,9,2,-1,2,1,-1,1,0,0,-13,231,3,-3,0,0,0,0,1,1,0,-1,1,-1
KR_6133590964,420,-3,48,-27,-5,-2,3,1,-4,5,1,1,1,2,-2,3,1,2,0,2,0,-2,-10,0,-2,2,2,0,-1,1,-1,-1,1,1,-1
KR_6694101019,420,2,-76,32,5,-7,8,1,3,2,5,1,1,2,3,0,3,5,0,5,1,14,-5,2,-5,3,0,0,-2,1,-1,-1,1,1,-1
KR_6752793576,420,-4,-54,-28,-8,0,1,1,-1,3,2,-3,3,0,-2,5,3,-2,2,0,0,-5,7,2,-5,3,0,0,0,-1,-1,0,-1,5,-1
KR_6763461707,440,-5,-98,-20,-11,-9,10,1,0,2,2,0,3,3,-6,7,1,4,0,4,-1,0,-89,-3,-1,4,-15,0,-3,-1,-1,-1,-1,6,-1
KR_6756647675,420,-2,-32,-25,-7,-5,5,0,-1,3,2,-1,5,4,-1,7,6,1,0,1,1,-11,-28,0,-2,2,2,0,0,-1,1,0,1,5,-1
KR_6728602607,420,0,-46,16,2,2,1,3,-2,2,0,4,2,6,-2,2,0,0,1,1,0,2,-410,-3,-2,5,-2,0,0,-1,1,0,-1,3,-1
KR_6706882013,420,-2,-1,-13,1,-3,3,0,-1,2,1,0,2,2,3,0,3,2,0,2,0,6,-278,-1,-7,8,-2,0,0,1,-1,0,1,6,-1
KR_6670985372,440,-2,61,-24,-4,1,3,4,-1,3,2,-4,5,1,-1,4,3,1,1,2,0,-6,3,-4,0,4,1,0,-2,-1,-1,-1,1,1,-1
KR_6704305018,420,0,-20,-44,-2,5,0,5,-3,5,2,-1,2,1,-2,2,0,-1,1,0,0,-6,28,-7,-1,8,-23,0,-1,-1,-1,-1,-1,3,-1
KR_6732446206,420,-4,-34,-19,-1,-1,3,2,2,1,3,1,3,4,-2,5,3,-1,1,0,2,2,58,-3,-4,7,-2,0,-1,-1,-1,-1,1,5,-1
KR_6762091506,420,-1,-6,-42,-8,3,1,4,2,2,4,-8,10,2,-1,3,2,-4,5,1,0,-1,-22,-2,-2,4,1,0,0,-1,0,0,-1,1,-1
KR_6718342743,440,-2,-29,-26,-6,0,1,1,-1,2,1,1,5,6,-2,2,0,-4,4,0,0,-10,-2,0,-4,4,2,0,-1,1,1,-1,-1,2,-1
KR_6753934353,420,-6,-90,-24,-15,-5,5,0,0,3,3,-10,12,2,-1,4,3,1,0,1,0,-11,-11,-3,-1,4,5,0,-2,1,0,-1,-1,4,-1
KR_6764682438,440,-3,-42,6,-9,-3,4,1,-2,4,2,-3,6,3,0,4,4,-1,1,0,0,-15,2,-5,0,5,0,0,-1,1,-1,-1,-1,4,-1
KR_6627344495,420,-1,-7,-11,-2,-2,5,3,1,1,2,1,3,4,0,4,4,-2,3,1,0,0,-10,-2,-5,7,0,0,-1,-1,-1,-1,-1,3,-1
KR_6695380217,420,5,-61,24,6,-3,3,0,4,0,4,2,0,2,1,4,5,2,0,2,0,7,-3,0,-4,4,0,0,1,1,-1,1,-1,1,-1
KR_6761850798,420,-2,-64,0,-4,-3,3,0,1,4,5,-2,4,2,-2,2,0,2,0,2,0,-6,10,-4,-4,8,4,0,0,-1,1,0,-1,1,-1
KR_6764565919,420,-7,-48,15,-14,-3,6,3,-1,4,3,0,2,2,-12,12,0,2,0,2,0,-14,20,3,-3,0,-1,0,-1,-1,-1,1,1,4,-1
KR_6651705835,420,-1,18,16,-5,-3,6,3,0,5,5,1,0,1,-2,4,2,-1,1,0,0,-13,1,3,-6,3,-5,0,-1,1,-1,-1,-1,6,-1
KR_6715714888,440,-3,-19,-42,-12,-2,5,3,-1,1,0,-6,6,0,1,3,4,-4,4,0,0,-14,49,-2,-2,4,-3,0,-1,-1,-1,-1,-1,6,-1
KR_6760385767,420,-2,27,-13,-5,0,3,3,-5,5,0,4,0,4,-3,5,2,-1,2,1,0,-10,-6,0,-3,3,4,0,-1,1,0,-1,1,3,-1
KR_6763931852,420,1,30,-4,2,-2,2,0,1,5,6,1,3,4,1,2,3,1,0,1,-1,-6,-20,-7,0,7,0,0,-1,1,-1,-1,-1,3,-1
KR_6721087822,420,-6,-131,-28,-18,-14,14,0,-3,4,1,-1,4,3,0,0,0,0,0,0,0,-11,-10,-1,0,1,1,0,-4,-1,-1,-1,-1,3,-1
KR_6605125431,420,1,19,6,4,1,0,1,2,0,2,-4,5,1,4,0,4,1,0,1,0,1,22,6,-10,4,-3,0,0,1,-1,0,-1,5,-1
KR_6730680432,420,-2,-93,-4,0,-4,4,0,2,0,2,3,4,7,-1,1,0,0,0,0,-1,0,-28,-2,-1,3,26,0,-1,-1,-1,-1,-1,4,-1
KR_6637748563,420,-1,-7,-36,2,-3,3,0,4,2,6,0,2,2,-1,4,3,2,0,2,0,7,129,3,-7,4,-5,0,-1,1,-1,-1,1,3,-1
KR_6744373620,420,-6,-92,-43,-19,-9,9,0,-3,5,2,-5,5,0,-3,5,2,1,2,3,0,-8,-10,-4,-3,7,0,0,-2,-1,0,-1,-1,3,-1
KR_6734026293,420,-2,-70,-8,0,-7,8,1,-5,7,2,1,1,2,5,0,5,6,0,6,2,14,4,1,-2,1,-2,0,0,1,0,0,1,6,-1
KR_6622465400,420,0,-16,-4,5,-2,2,0,4,1,5,1,1,2,-1,5,4,3,0,3,-1,12,120,-1,-4,5,-5,0,-1,-1,-1,-1,-1,1,-1
KR_6694214880,440,-4,-3,19,-9,1,3,4,-1,2,1,-1,3,2,-5,6,1,-3,3,0,0,-12,0,3,-7,4,-4,0,-2,-1,1,-1,1,1,-1
KR_6628969611,420,0,69,-12,6,-3,5,2,3,6,9,8,0,8,0,2,2,-2,2,0,-2,2,2,3,-4,1,-1,0,1,1,-1,1,-1,2,-1
KR_6630721320,420,-3,-108,8,-5,-2,3,1,6,3,9,-2,2,0,0,3,3,-7,7,0,0,-2,-24,-4,-2,6,2,0,-2,0,-1,-1,-1,0,-1
KR_6753140351,420,-8,-95,-40,-16,-2,2,0,-7,7,0,-7,7,0,1,3,4,-1,1,0,0,-17,12,2,-8,6,-14,0,0,-1,-1,-1,-1,4,-1
KR_6739734670,420,0,27,8,0,1,1,2,-1,2,1,0,2,2,2,3,5,-2,3,1,0,-5,12,0,-3,3,-3,0,0,-1,1,0,-1,1,-1
KR_6716404683,420,0,-22,18,4,2,1,3,0,4,4,4,1,5,-4,6,2,2,0,2,0,-1,-3,0,-4,4,3,0,1,0,-1,1,1,0,-1
KR_6755357510,420,-3,0,-33,-5,-5,9,4,-2,4,2,1,1,2,-2,3,1,3,1,4,0,1,0,-3,-1,4,-1,0,0,-1,-1,-1,1,3,-1
KR_6706669924,420,2,39,4,4,-1,1,0,1,4,5,2,3,5,-1,3,2,3,0,3,0,2,-5,3,-4,1,5,0,0,-1,1,0,1,3,-1
KR_6631270053,420,-1,-8,-17,-6,2,1,3,-1,5,4,-7,8,1,1,3,4,-1,1,0,0,-1,-57,-6,0,6,23,0,0,-1,1,0,1,2,-1
KR_6422628424,440,-3,-58,6,-11,-2,2,0,-3,4,1,-9,10,1,1,2,3,2,0,2,0,-3,-1,-1,-4,5,0,0,0,0,0,-1,1,0,-1
KR_6744552468,420,-1,18,-8,-1,-2,2,0,0,1,1,-1,2,1,2,0,2,0,2,2,0,-1,5,-3,-2,5,0,0,0,-1,0,0,1,4,-1
KR_6593523602,420,0,-33,-8,0,1,0,1,-4,5,1,2,0,2,1,2,3,0,0,0,0,3,-386,0,-3,3,-4,0,-2,-1,-1,-1,1,6,-1
KR_6761765764,440,-1,31,8,-1,0,2,2,-1,2,1,-1,3,2,0,4,4,1,0,1,0,-3,2,-2,-1,3,0,0,1,-1,1,1,1,3,-1
KR_6739626367,420,-1,7,-20,1,-2,4,2,-1,3,2,5,1,6,-1,5,4,0,1,1,0,5,-14,-3,-3,6,3,0,0,1,-1,1,1,1,-1
KR_6661498336,420,1,16,-8,8,2,2,4,5,1,6,2,0,2,-1,1,0,0,0,0,0,7,-4,-2,-2,4,-1,0,1,-1,1,1,1,6,-1
KR_5825114089,420,2,55,13,-3,-4,4,0,1,4,5,1,3,4,1,2,3,-2,2,0,0,-1,4,1,-3,2,0,0,1,1,-1,1,-1,5,-1
KR_6656293682,420,1,1,12,5,2,1,3,3,1,4,4,1,5,-2,2,0,-2,2,0,0,0,1,-3,-1,4,-4,0,1,-1,1,1,1,1,-1
KR_6722961342,420,2,-8,-4,9,-1,4,3,2,5,7,5,0,5,1,1,2,2,0,2,0,7,3,2,-5,3,2,0,-1,-1,1,1,-1,3,-1
KR_6695214061,420,1,0,27,3,2,1,3,2,1,3,4,0,4,-5,5,0,0,1,1,0,-3,239,1,-4,3,-2,0,-1,1,1,1,-1,2,-1
KR_6671611338,420,-2,-2,-4,-8,-1,1,0,-3,4,1,2,1,3,-3,5,2,-3,3,0,-2,-13,-6,1,-3,2,2,0,0,-1,1,1,-1,6,-1
KR_6759631254,420,-1,-26,-4,4,-1,1,0,12,2,14,-3,4,1,-2,4,2,-2,4,2,1,6,330,2,-5,3,0,0,0,1,-1,0,1,3,-1
KR_6753952467,420,0,-27,40,-7,-3,4,1,1,0,1,-2,5,3,0,1,1,-3,4,1,0,-8,-11,-1,-3,4,2,0,0,-1,1,0,-1,6,-1
KR_6755501019,420,2,10,27,-1,0,1,1,-4,4,0,2,4,6,0,2,2,1,1,2,0,1,8,4,-4,0,-3,0,0,1,1,0,-1,2,-1
KR_6104953917,420,-1,-33,-4,-3,1,1,2,-8,13,5,0,1,1,3,1,4,1,2,3,0,-6,-15,2,-6,4,-3,0,0,-1,-1,0,1,5,-1
KR_6764617531,420,0,3,24,-5,-5,6,1,-2,3,1,1,3,4,1,0,1,0,1,1,0,1,-2,-3,-2,5,3,0,-1,1,-1,-1,-1,5,-1
KR_6737700075,420,-3,-28,5,-9,-3,5,2,-2,4,2,-5,5,0,1,0,1,0,0,0,0,-1,231,0,-3,3,1,0,-1,1,-1,-1,-1,1,-1
KR_6720348075,420,-1,-27,-8,-6,-1,3,2,0,3,3,-5,5,0,1,1,2,-1,2,1,0,-5,8,-2,-1,3,1,0,-1,-1,1,-1,-1,4,-1
KR_6760333019,420,2,26,-4,10,3,0,3,4,2,6,2,2,4,-2,3,1,3,0,3,0,6,291,0,-1,1,1,0,0,1,1,0,1,5,-1
KR_6749195190,420,-4,10,7,-13,-7,11,4,-5,5,0,0,2,2,1,2,3,-2,2,0,0,-9,-40,3,-5,2,-1,0,-1,1,-1,-1,-1,5,-1
KR_6729501859,440,-1,-4,-11,-5,0,1,1,-5,5,0,-2,4,2,2,2,4,0,1,1,1,-2,14,-1,-4,5,-24,0,-1,0,0,-1,1,0,-1
KR_6640145497,420,-1,9,8,0,5,1,6,-4,5,1,-3,4,1,1,3,4,1,1,2,0,-1,-6,-5,-2,7,-2,0,-1,-1,1,-1,1,5,-1
KR_6757957989,420,3,25,28,4,0,2,2,4,1,5,0,4,4,2,1,3,-2,2,0,0,6,-2,-3,-2,5,-1,0,1,1,1,1,1,1,-1
KR_6683199124,420,-11,-141,-55,-23,-8,8,0,-4,4,0,-9,9,0,0,2,2,-2,2,0,0,-14,-3,-2,-1,3,-1,-1,-7,0,-1,-1,-1,0,-1
KR_6698543357,420,-4,-70,-3,-5,-3,3,0,3,2,5,-5,8,3,0,0,0,0,0,0,0,-6,3,-2,-1,3,0,0,-1,-1,-1,-1,-1,6,-1
KR_6730259104,420,-5,-72,-15,-5,0,0,0,2,2,4,-2,3,1,-2,6,4,-3,3,0,0,-8,-7,-1,-4,5,-2,0,-2,-1,1,-1,1,5,-1
KR_6719092889,420,-3,-3,-28,0,1,0,1,3,3,6,-5,5,0,0,3,3,1,1,2,-1,3,106,5,-7,2,4,0,-1,-1,-1,-1,-1,4,-1
KR_6750311850,420,-3,-43,-13,-7,0,1,1,1,3,4,-5,7,2,-2,3,1,-1,2,1,0,-14,0,0,-4,4,-3,0,-2,0,-1,-1,1,0,-1
KR_6685963346,420,-1,72,8,2,1,1,2,-1,1,0,-3,3,0,4,1,5,1,1,2,0,4,4,1,-4,3,-1,0,0,-1,1,0,-1,5,-1
KR_6756966788,420,-3,12,32,-8,-3,4,1,-2,3,1,-2,5,3,-1,1,0,0,0,0,0,-8,5,-1,-4,5,-1,0,-1,1,-1,-1,-1,5,-1
KR_6685737777,440,-6,-102,8,-14,-3,4,1,-3,3,0,-4,4,0,-2,4,2,-2,4,2,0,-10,7,0,-6,6,2,0,-1,-1,1,-1,-1,1,-1
KR_6725441658,420,2,61,43,4,0,1,1,1,3,4,-1,2,1,0,1,1,4,0,4,1,12,3,-1,-1,2,2,0,0,1,1,1,1,6,-1
KR_6685377921,420,1,36,-24,4,2,0,2,0,0,0,1,4,5,0,0,0,1,0,1,0,6,-2,-2,-1,3,0,0,0,1,-1,-1,1,4,-1
KR_6732025327,420,-5,-20,-71,-3,-1,3,2,-1,4,3,-1,4,3,-1,2,1,1,0,1,0,1,-23,-1,-4,5,4,0,-1,-1,-1,-1,-1,1,-1
KR_6759026709,440,-4,-75,-20,-10,-2,4,2,3,0,3,-1,4,3,-6,9,3,-4,6,2,0,-7,43,1,-7,6,-27,0,0,-1,-1,-1,-1,6,-1
KR_6753761539,420,-4,-14,-4,-19,2,0,2,-7,7,0,-4,4,0,-5,9,4,-5,6,1,0,-14,-1,2,-3,1,-4,0,-1,-1,-1,-1,-1,5,-1
KR_6634220493,420,-4,-56,-28,-6,1,0,1,-1,3,2,0,1,1,-5,7,2,-1,2,1,-1,-10,0,-2,-3,5,5,0,-1,-1,1,-1,-1,1,-1
KR_6742111562,420,-6,-59,-34,-12,-4,6,2,-4,4,0,1,1,2,-5,5,0,0,3,3,0,-5,21,-5,-2,7,2,0,-2,-1,0,-1,1,1,-1
KR_6757483769,420,-5,-94,-12,-13,-2,4,2,2,1,3,-5,5,0,-8,10,2,0,1,1,-1,-7,0,1,-2,1,-2,0,0,-1,-1,-1,-1,6,-1
KR_6756262871,420,-1,-20,-29,-3,1,0,1,2,0,2,-5,6,1,-1,2,1,0,0,0,0,-4,25,0,-3,3,-3,0,-1,-1,-1,-1,-1,4,-1
KR_6726832015,440,-2,22,-8,-3,-2,4,2,2,2,4,-3,4,1,0,2,2,0,0,0,0,-6,0,2,-6,4,0,0,1,-1,1,1,-1,1,-1
KR_6749284626,420,0,-10,-17,-5,2,0,2,0,1,1,-3,5,2,-4,5,1,0,2,2,0,1,18,-4,-1,5,1,0,1,0,-1,1,-1,0,-1
KR_6606963269,420,-5,12,20,-8,-3,5,2,-2,3,1,1,3,4,-4,4,0,0,1,1,0,-13,-2,-1,-2,3,0,0,0,-1,1,0,1,4,-1
KR_6624814040,420,-6,-116,-27,-7,-4,5,1,-3,4,1,-1,3,2,-1,4,3,2,0,2,0,0,3,0,-2,2,-2,0,-1,-1,1,-1,1,3,-1
KR_6714703459,440,-1,-32,2,-2,3,2,5,2,1,3,-3,4,1,-5,7,2,1,1,2,0,9,9,3,-11,8,1,0,-1,1,-1,-1,-1,1,-1
KR_6421434708,420,-1,-14,0,-3,0,1,1,5,1,6,-9,10,1,0,1,1,1,0,1,0,-4,10,4,-5,1,-1,0,0,1,-1,-1,-1,5,-1
KR_6744836042,420,-5,-106,-37,-21,-7,8,1,-4,5,1,-5,5,0,-2,4,2,-3,3,0,-4,-20,1,-3,-3,6,-4,0,-1,-1,-1,-1,-1,6,-1
KR_6727503064,420,2,-14,0,5,2,0,2,2,3,5,1,0,1,-2,4,2,2,2,4,0,2,413,0,-1,1,0,0,0,1,1,1,1,4,-1
KR_6631328660,420,-3,-10,-24,-4,1,1,2,1,2,3,-2,3,1,-4,8,4,0,0,0,1,-8,-1,1,-4,3,-4,0,-1,-1,-1,-1,1,2,-1
KR_6749687204,420,0,-10,-11,3,-6,6,0,-1,3,2,5,1,6,3,0,3,2,0,2,0,0,2,3,-3,0,1,0,0,-1,0,1,1,5,-1
KR_6741466538,420,0,23,7,0,-1,4,3,0,1,1,2,2,4,0,2,2,-1,2,1,0,-3,7,2,-6,4,-4,0,0,-1,-1,-1,1,3,-1
KR_6761543137,440,2,-7,4,5,3,1,4,2,2,4,-1,2,1,-3,3,0,4,1,5,0,9,14,-3,-1,4,-4,0,0,1,0,1,-1,3,-1
KR_6659958205,420,-4,-69,-24,-10,0,1,1,-1,7,6,-4,4,0,-1,3,2,-4,4,0,0,-6,30,4,-6,2,-3,0,-2,-1,0,-1,-1,3,-1
KR_6758036527,420,-2,22,-28,0,-1,2,1,1,3,4,2,2,4,-2,3,1,0,3,3,0,1,-17,-1,-3,4,3,0,0,-1,1,1,-1,2,-1
KR_6722799419,420,-3,-81,8,-7,3,2,5,0,1,1,-6,8,2,-5,6,1,1,1,2,1,-7,5,0,-5,5,-2,0,-2,-1,1,-1,1,5,-1
KR_6683360855,420,-2,-17,-20,-8,-9,9,0,-4,6,2,3,0,3,2,2,4,0,1,1,0,-1,-7,2,-6,4,2,0,-2,-1,-1,-1,-1,4,-1
KR_6711243954,420,-2,-12,3,-1,-4,4,0,-2,5,3,2,2,4,2,3,5,1,1,2,0,1,2,2,-5,3,-2,0,0,-1,-1,-1,-1,4,-1
KR_6738993359,420,-2,-49,10,-8,-3,6,3,-1,2,1,0,2,2,-1,4,3,-3,3,0,-1,-10,-399,-2,-3,5,-5,0,-1,-1,-1,-1,-1,1,-1
KR_6721827689,420,-4,-31,15,-14,-1,3,2,-5,5,0,-4,4,0,-3,4,1,-1,4,3,0,-16,106,-1,-4,5,-7,0,1,0,-1,1,-1,0,-1
KR_6623619129,420,-9,-103,-24,-16,-4,4,0,0,3,3,-2,3,1,-4,6,2,-6,6,0,0,-13,2,1,-3,2,-4,-1,-3,-1,-1,-1,-1,3,-1
KR_6760265392,420,0,-64,-24,-6,-5,5,0,3,1,4,1,0,1,-4,4,0,-1,1,0,0,-4,110,-3,-5,8,-28,0,-1,-1,1,-1,-1,1,-1
KR_6661751601,420,-5,-85,-24,-16,-3,6,3,-10,10,0,1,1,2,-3,6,3,-1,1,0,0,-13,-26,-2,-2,4,-5,0,0,-1,0,-1,-1,4,-1
KR_6648578463,420,0,-26,8,1,1,0,1,-1,2,1,1,0,1,-2,5,3,2,1,3,0,-3,-6,-3,-2,5,2,0,2,-1,1,1,1,2,-1
KR_6709059159,420,-5,-52,-20,-10,-2,2,0,-1,2,1,-1,1,0,-1,2,1,-5,5,0,0,-8,-31,-6,0,6,-4,0,0,-1,-1,-1,-1,3,-1
KR_6648495156,420,-2,-38,7,-6,-2,2,0,-1,2,1,-1,3,2,3,1,4,-5,5,0,0,-3,-139,2,-4,2,0,0,0,-1,-1,-1,1,5,-1
KR_6700674796,420,-7,-32,-26,-9,-3,4,1,2,2,4,-3,4,1,-3,4,1,-2,2,0,0,-7,-10,-4,-1,5,2,0,-2,1,-1,-1,-1,5,-1
KR_6759390648,420,0,2,44,-1,3,2,5,-3,5,2,-1,4,3,0,4,4,0,1,1,1,-6,0,-2,-4,6,2,0,0,1,0,0,1,6,-1
KR_6725709266,420,-6,-40,-6,-13,0,3,3,-4,7,3,-2,3,1,-6,6,0,-1,2,1,1,-7,-5,-7,0,7,-2,0,0,-1,0,0,1,1,-1
KR_6387237643,420,-7,-45,0,-12,-4,4,0,-6,7,1,-3,5,2,2,2,4,-1,1,0,0,-3,-111,1,-4,3,-6,0,-1,0,1,-1,-1,0,-1
KR_6634559385,420,-4,-1,-8,-8,3,0,3,-3,3,0,-4,6,2,-4,6,2,0,1,1,2,-5,10,1,-4,3,1,0,0,-1,1,-1,1,2,-1
KR_6725806001,420,-2,26,-46,1,1,3,4,2,1,3,0,4,4,-1,3,2,-1,2,1,0,-2,185,1,-6,5,-11,0,1,1,1,1,1,1,-1
KR_6733395366,420,3,-8,32,7,2,1,3,-1,6,5,0,1,1,5,2,7,1,1,2,0,3,-5,1,-2,1,-3,0,0,1,-1,0,-1,5,-1
KR_6617782435,420,1,-31,-16,8,0,1,1,-2,3,1,3,1,4,6,1,7,1,0,1,-1,6,292,3,-4,1,-3,0,0,-1,1,0,-1,5,-1
KR_6703041511,420,-2,22,-7,-5,-1,1,0,-1,2,1,-2,4,2,2,2,4,-3,4,1,-2,-10,-45,-1,-2,3,3,0,1,-1,1,1,-1,6,-1
KR_6711931033,420,0,13,11,0,1,1,2,-2,4,2,1,0,1,-1,1,0,1,0,1,0,-2,-30,0,-4,4,-1,0,-1,-1,1,-1,-1,6,-1
KR_6620260953,440,-5,-58,-24,-6,-3,5,2,-4,5,1,1,2,3,1,3,4,-1,2,1,0,-8,-18,8,-10,2,-6,0,-2,-1,-1,-1,1,4,-1
KR_6645972353,420,-1,-19,-31,0,1,0,1,-2,6,4,1,5,6,-4,5,1,4,0,4,-1,0,4,4,-4,0,1,0,0,-1,0,0,-1,5,-1
KR_6752129542,420,-2,-23,15,0,-3,3,0,6,1,7,-7,7,0,4,2,6,0,0,0,0,0,27,1,-3,2,-3,0,0,0,0,0,-1,0,-1
KR_6636116686,420,-1,-16,-20,-2,0,1,1,-4,5,1,0,1,1,1,1,2,1,0,1,0,-3,-167,-1,-3,4,4,0,0,-1,1,0,-1,1,-1
KR_6733598673,420,-3,-27,-5,-2,4,0,4,-1,4,3,-3,3,0,-1,3,2,-1,1,0,0,-2,-55,-4,-2,6,21,0,-1,-1,-1,-1,-1,5,-1
KR_6698847509,420,-4,-15,-42,-4,-1,3,2,-6,6,0,-2,4,2,-3,5,2,8,2,10,1,-4,1,-1,-1,2,-3,0,-2,1,-1,-1,1,2,-1
KR_6751572225,420,1,45,-16,2,0,2,2,-1,2,1,3,0,3,0,3,3,0,0,0,0,2,5,-1,-4,5,2,0,0,-1,1,0,1,6,-1
KR_6751076987,420,-5,-73,-36,-16,-3,3,0,-8,8,0,-3,3,0,0,1,1,-2,3,1,0,-8,1,-1,-2,3,-1,0,-1,-1,-1,-1,1,5,-1
KR_5858275584,420,-5,-24,11,-5,1,1,2,-2,3,1,6,1,7,-8,9,1,-2,3,1,0,-9,1,-1,-3,4,2,0,0,-1,1,-1,1,2,-1
KR_6758380545,420,-2,-11,-20,1,-1,2,1,-3,3,0,2,0,2,3,0,3,0,0,0,0,-4,-7,-5,-3,8,3,0,0,1,1,0,-1,4,-1
KR_6689031833,420,-5,-99,-28,-9,-6,6,0,-2,4,2,0,7,7,1,2,3,-2,2,0,2,-3,-6,0,-4,4,1,0,-3,-1,1,-1,-1,2,-1
KR_6695155669,420,1,-55,-24,2,1,2,3,2,2,4,-3,4,1,1,3,4,1,2,3,0,1,-6,-1,-1,2,1,0,-2,1,-1,-1,-1,3,-1
KR_6729947938,420,-7,-49,-81,-14,-4,5,1,-7,8,1,-3,3,0,1,0,1,-1,1,0,-1,-10,1,6,-7,1,-3,0,-1,-1,-1,-1,-1,2,-1
KR_6679573116,420,-1,49,-48,3,1,0,1,-1,2,1,3,2,5,1,1,2,-1,2,1,-1,3,0,2,-6,4,3,0,1,1,1,1,-1,4,-1
KR_6764245740,420,0,-55,10,-2,-1,2,1,4,2,6,-2,4,2,-1,3,2,-2,2,0,-1,0,3,-2,-1,3,2,0,-1,-1,1,-1,-1,5,-1
KR_6758675488,420,-1,-13,4,-13,-2,3,1,-1,2,1,0,1,1,-8,9,1,-2,3,1,0,-12,52,-2,-3,5,-3,0,-1,-1,-1,-1,-1,2,-1
KR_6502057488,420,-6,-76,8,-12,-6,6,0,-4,5,1,0,1,1,-1,3,2,-1,2,1,0,-7,10,-3,-4,7,-4,0,-2,-1,1,-1,1,6,-1
KR_6676112915,420,-1,-64,-32,-3,-4,4,0,2,1,3,-1,6,5,0,0,0,0,0,0,0,9,-2,0,-1,1,-3,0,-1,-1,-1,-1,-1,5,-1
KR_6711284239,420,-3,-107,-12,-14,1,0,1,-2,4,2,-2,3,1,-9,10,1,-2,2,0,0,-13,0,1,-2,1,0,0,-1,-1,1,-1,-1,4,-1
KR_6755257297,420,-5,-51,-31,-11,-1,2,1,-2,6,4,-3,4,1,-3,4,1,-2,2,0,0,-9,41,4,-5,1,-17,0,-2,-1,-1,-1,1,4,-1
KR_6726935413,420,-2,-42,0,-7,-1,1,0,-4,6,2,2,3,5,-3,3,0,-1,2,1,0,-5,10,4,-5,1,-4,0,0,-1,-1,0,-1,5,-1
KR_6711226294,420,-4,-50,-12,-8,-4,5,1,1,1,2,1,2,3,-5,7,2,-1,1,0,0,-6,-22,-4,-3,7,-4,0,-3,-1,-1,-1,-1,5,-1
KR_6695694098,440,0,54,-28,2,2,0,2,1,1,2,0,3,3,0,0,0,-1,7,6,1,0,-277,-4,-3,7,-3,0,1,0,-1,1,1,0,-1
KR_6759178059,420,-2,-41,-66,-2,0,1,1,-7,8,1,4,1,5,-2,4,2,3,0,3,0,-2,10,-2,-1,3,-2,0,1,1,-1,-1,-1,3,-1
KR_6630193497,420,-6,-45,-24,-20,-5,7,2,-3,5,2,-6,7,1,-3,5,2,-3,4,1,2,-18,-2,-3,-4,7,2,0,-1,-1,-1,-1,1,3,-1
KR_6757769619,420,-1,-18,16,-7,2,1,3,-1,2,1,-6,9,3,-2,4,2,0,1,1,0,3,2,-1,-4,5,1,0,-2,1,-1,-1,-1,5,-1
KR_6609973208,420,-4,-106,-24,-9,-3,3,0,-7,8,1,0,4,4,1,3,4,0,0,0,-2,-19,5,-4,0,4,-1,0,-3,-1,-1,-1,-1,2,-1
KR_6685666914,420,1,58,-32,4,2,2,4,-2,3,1,2,0,2,2,5,7,0,2,2,0,1,2,4,-10,6,-7,0,-1,1,-1,1,1,2,-1
KR_6750362719,440,2,9,1,6,-2,2,0,3,3,6,-1,4,3,1,4,5,5,0,5,3,5,-23,-3,-2,5,1,0,0,-1,-1,1,1,6,-1
KR_6763167629,420,-4,-18,-75,-9,-2,2,0,0,2,2,-9,10,1,-1,3,2,3,1,4,0,-12,52,0,-2,2,-27,0,-1,0,-1,-1,-1,0,-1
KR_6659950844,420,-8,-25,-19,-14,-7,9,2,1,0,1,-1,2,1,-6,6,0,-1,1,0,0,-7,-5,-1,0,1,-1,0,-2,-1,-1,-1,-1,3,-1
KR_6759663572,440,-4,-95,-20,-4,-1,2,1,-3,5,2,0,2,2,0,5,5,0,1,1,0,-2,-140,-5,-4,9,-5,0,-1,0,-1,-1,1,0,-1
KR_6737938961,420,-2,-58,-19,-5,-4,4,0,-4,5,1,0,1,1,2,0,2,1,0,1,0,-7,-19,1,-5,4,-3,0,-2,-1,-1,-1,-1,6,-1
KR_6741344709,420,-2,-21,12,-8,0,1,1,-1,3,2,-4,6,2,-1,2,1,-2,2,0,0,-5,129,3,-4,1,-5,0,0,-1,1,-1,1,4,-1
KR_6627271632,420,-1,-7,-12,-3,-1,2,1,-2,3,1,-2,3,1,2,2,4,0,1,1,0,5,-7,-1,-1,2,-1,0,0,-1,-1,0,1,2,-1
KR_6627041865,440,0,18,-3,0,-1,3,2,0,2,2,-1,2,1,0,2,2,2,0,2,-2,-2,-12,-3,-2,5,0,0,1,-1,-1,1,-1,1,-1
KR_6728871469,420,1,47,24,-3,0,1,1,2,0,2,0,2,2,-5,6,1,0,3,3,0,-10,-6,0,-5,5,6,0,1,1,-1,-1,-1,4,-1
KR_6636165434,420,-3,-95,-8,-6,1,0,1,0,1,1,0,0,0,1,2,3,-8,9,1,-1,-12,3,1,-3,2,0,0,-1,-1,1,-1,-1,6,-1
KR_6665330967,420,-3,-45,-27,-10,-3,3,0,-2,2,0,4,1,5,-7,7,0,-2,2,0,0,-7,92,0,-4,4,-2,0,0,-1,-1,0,-1,6,-1
KR_6649656364,420,-3,-34,20,-5,-1,4,3,1,3,4,1,2,3,-6,6,0,0,0,0,0,-2,-7,3,-4,1,-4,0,-1,-1,-1,-1,1,1,-1
KR_6751538183,420,-8,-76,-26,-18,-3,3,0,-1,2,1,-6,6,0,-8,8,0,0,0,0,0,-10,-2,0,0,0,-1,0,0,0,1,-1,-1,0,-1
KR_6672954752,440,-3,-69,3,-5,0,2,2,-2,2,0,0,1,1,0,1,1,-3,3,0,0,-3,-5,-2,0,2,-1,0,-1,-1,0,-1,-1,2,-1
KR_6744575598,420,-4,-86,12,-7,-2,2,0,0,3,3,-3,4,1,-1,2,1,-1,1,0,-1,-7,164,-5,-4,9,35,0,0,1,-1,-1,-1,1,-1
KR_6733832118,420,-1,14,-23,-1,0,2,2,0,2,2,1,4,5,-2,2,0,0,1,1,0,-3,-9,3,-7,4,-7,0,1,-1,-1,1,1,3,-1
KR_6593662108,420,-2,1,-11,1,0,4,4,2,1,3,0,1,1,-1,2,1,0,1,1,0,4,-3,0,-1,1,2,0,-1,-1,-1,1,1,2,-1
KR_6737034387,420,-1,2,-20,2,-4,4,0,0,1,1,-2,2,0,8,1,9,0,2,2,1,6,10,7,-8,1,-5,0,0,1,0,0,1,2,-1
KR_6692687825,420,-7,-76,-48,-13,-1,1,0,-2,2,0,-8,8,0,-1,1,0,-1,1,0,0,-7,-7,3,-7,4,-4,0,-2,-1,-1,-1,-1,3,-1
KR_6699931432,420,-5,-25,-20,-8,-3,3,0,-5,5,0,-1,1,0,2,1,3,-1,1,0,0,-6,10,3,-4,1,-6,0,-1,-1,1,-1,-1,4,-1
KR_6744325258,420,-3,44,-31,-12,3,0,3,-8,8,0,-3,5,2,-3,3,0,-1,1,0,-2,-19,-4,-5,-2,7,-2,0,-1,-1,-1,-1,-1,2,-1
KR_6757477343,440,-4,-61,-17,-16,-4,6,2,2,0,2,-8,8,0,-5,8,3,-1,1,0,0,-3,-25,-2,-2,4,-2,-2,-4,-1,-1,-1,-1,3,-1
KR_6739113574,440,-1,-48,-8,-11,-3,3,0,-1,4,3,-5,7,2,-3,5,2,1,0,1,0,-3,-26,8,-8,0,7,0,-1,-1,0,-1,1,4,-1
KR_6738944961,420,-4,-49,0,-3,-3,4,1,-1,3,2,-2,4,2,1,1,2,2,0,2,0,-3,-30,3,-7,4,-4,0,-1,-1,-1,-1,1,5,-1
KR_6670938945,440,0,44,5,-2,0,1,1,0,3,3,0,1,1,-2,5,3,0,3,3,0,-3,-91,2,-5,3,-1,0,0,1,-1,0,-1,5,-1
KR_6286983094,420,0,3,-8,-6,2,1,3,0,0,0,-5,6,1,-2,3,1,-1,1,0,0,-6,10,1,-4,3,-1,0,0,1,-1,-1,-1,5,-1
KR_6747972759,420,-3,-39,-62,-4,2,0,2,1,3,4,-5,7,2,1,2,3,-3,3,0,0,5,-17,2,-6,4,-4,0,-1,-1,-1,-1,-1,4,-1
KR_6716945972,420,-4,-21,-9,-7,-1,2,1,-5,6,1,5,0,5,-4,5,1,-2,2,0,0,-12,-1,-3,0,3,2,0,-1,1,1,1,1,2,-1
KR_6751036397,420,-5,-55,-11,-17,-3,3,0,-3,3,0,-4,9,5,-6,8,2,-1,2,1,0,-20,-4,-3,0,3,1,0,-3,1,-1,-1,1,1,-1
KR_6667174353,420,-2,-84,-27,-10,1,0,1,-4,4,0,-3,5,2,-4,8,4,0,3,3,1,-5,-14,4,-5,1,-7,0,0,-1,1,0,1,2,-1
KR_6763536325,440,-1,72,32,0,-4,5,1,2,3,5,0,3,3,1,1,2,1,0,1,0,-2,-33,-2,-1,3,0,0,0,0,1,0,-1,0,-1
KR_6749167760,420,2,27,-22,7,1,1,2,-4,4,0,4,1,5,6,0,6,0,0,0,0,1,11,1,-6,5,4,0,0,1,-1,0,1,5,-1
KR_6750792488,420,-2,-31,13,-13,-4,4,0,0,4,4,-3,6,3,-4,4,0,-2,3,1,0,-8,121,3,-6,3,-3,0,0,-1,0,0,-1,6,-1
KR_6759523558,420,-6,-110,-7,-12,-4,4,0,0,4,4,-2,4,2,-7,8,1,1,1,2,0,-7,-1,-3,-2,5,0,0,-3,-1,-1,-1,-1,4,-1
KR_6745939227,440,0,-83,20,2,-1,2,1,3,0,3,-1,2,1,0,1,1,1,2,3,0,-1,42,3,-7,4,-26,0,1,-1,1,1,1,5,-1
KR_6760549044,420,-2,-30,12,2,0,2,2,3,1,4,-1,3,2,-1,3,2,1,1,2,0,9,-4,4,-4,0,-1,0,0,1,0,0,-1,6,-1
KR_6764713568,420,-2,1,-35,-6,-2,4,2,-1,2,1,-2,2,0,-1,2,1,0,2,2,0,0,-9,-2,-1,3,3,0,0,-1,-1,0,1,2,-1
KR_5690180545,420,-7,-138,-34,-21,-9,9,0,-3,4,1,-4,5,1,-5,6,1,0,1,1,-2,-19,1,-3,-2,5,-4,0,-3,-1,-1,-1,-1,4,-1
KR_6568251465,440,-1,-60,-21,-6,0,2,2,1,5,6,-4,5,1,-4,6,2,1,0,1,-2,-4,3,-4,-1,5,0,0,-1,-1,0,-1,-1,6,-1
KR_6730488571,420,1,35,4,-2,-1,4,3,1,1,2,-2,4,2,1,1,2,-1,1,0,0,0,9,1,-2,1,-1,0,0,-1,1,1,-1,2,-1
KR_6198801091,420,0,-14,16,-5,1,3,4,-3,5,2,-4,4,0,0,0,0,1,0,1,-1,3,-1,3,-4,1,-1,0,1,-1,1,1,-1,4,-1
KR_6759356163,440,-7,-9,-55,-21,-1,2,1,-1,2,1,-12,12,0,-4,5,1,-3,4,1,0,-12,13,0,-1,1,-4,0,-1,-1,0,-1,-1,6,-1
KR_6762652864,420,-3,-78,-16,-6,-2,3,1,-1,1,0,-1,3,2,-2,4,2,0,1,1,0,-5,93,-6,-3,9,10,0,-1,-1,1,-1,-1,6,-1
KR_6670393764,420,-3,-56,4,-5,2,0,2,-2,2,0,-3,4,1,-2,7,5,0,1,1,-1,-13,-7,-2,-3,5,0,0,-1,1,1,-1,-1,2,-1
KR_6617757732,420,-2,17,-3,-5,-2,5,3,0,1,1,-3,5,2,2,1,3,-2,2,0,0,0,-12,0,-6,6,5,0,-1,0,-1,-1,-1,0,-1
KR_6717267848,420,-2,-86,-3,-7,-1,4,3,-1,4,3,-3,4,1,-3,7,4,1,4,5,0,-9,371,-3,-4,7,-2,0,-1,0,1,1,1,0,-1
KR_6743073953,420,-5,-32,-56,-12,-9,9,0,-4,7,3,7,3,10,-1,3,2,-5,5,0,-1,-14,-13,1,-3,2,-2,0,0,-1,-1,1,-1,5,-1
KR_6753052878,420,-3,-109,-12,-9,-12,13,1,-4,4,0,3,1,4,2,1,3,2,1,3,0,0,6,5,-5,0,1,0,-1,0,0,-1,-1,0,-1
KR_6700349688,420,3,-16,31,1,4,1,5,-2,2,0,-2,5,3,-1,5,4,2,0,2,0,-7,8,0,-2,2,0,0,1,-1,1,1,1,3,-1
KR_6601354258,420,-4,-65,7,-10,-2,2,0,-1,3,2,-6,7,1,2,3,5,-3,4,1,0,-7,0,0,-6,6,-3,0,-1,1,-1,-1,-1,5,-1
KR_6659777858,420,0,-57,21,-4,-7,7,0,3,1,4,0,1,1,-2,5,3,2,3,5,2,7,-276,4,-8,4,-1,0,-1,-1,1,1,1,2,-1
KR_6728544403,420,-1,9,6,-3,2,0,2,-3,3,0,1,3,4,0,4,4,-3,3,0,-1,-7,-35,0,-4,4,23,0,0,1,-1,0,-1,3,-1
KR_6763532450,420,1,31,16,-5,-5,6,1,-1,3,2,2,1,3,1,3,4,-2,3,1,0,-5,19,-3,0,3,-3,0,0,-1,-1,-1,-1,6,-1
KR_6659730514,420,-3,30,-8,0,2,1,3,4,0,4,-1,4,3,-4,5,1,-1,1,0,0,-2,1,0,-4,4,3,0,-1,-1,1,-1,1,4,-1
KR_6725943755,420,1,-8,0,1,-3,3,0,-2,2,0,7,0,7,-2,5,3,1,2,3,0,-2,2,2,-4,2,-1,0,0,-1,1,0,-1,4,-1
KR_6739619691,420,-4,-150,16,-4,-4,5,1,1,4,5,0,2,2,-3,3,0,2,1,3,1,-4,-4,0,-6,6,-3,0,-3,-1,1,-1,1,5,-1
KR_6759004350,420,-1,-49,13,-4,1,1,2,1,2,3,-5,9,4,-3,3,0,2,0,2,1,3,-1,1,-5,4,1,0,0,-1,-1,-1,1,4,-1
KR_6760106175,420,-2,-31,8,-6,-1,1,0,-4,7,3,-1,2,1,-1,2,1,1,0,1,0,-4,6,1,-4,3,-1,0,-2,1,-1,-1,-1,6,-1
KR_6600900319,420,-4,-16,-4,-7,-3,4,1,-2,5,3,2,1,3,-2,4,2,-2,3,1,0,-8,-20,-3,0,3,2,0,0,0,0,0,-1,0,-1
KR_6670154177,420,-3,-53,-2,-18,0,2,2,-3,3,0,-1,3,2,-9,9,0,-5,5,0,-2,-12,17,-1,-2,3,-10,0,-1,-1,-1,-1,-1,4,-1
KR_6764604165,420,-3,-38,-1,-10,-5,5,0,2,2,4,-7,7,0,0,1,1,0,0,0,0,-2,-119,0,-2,2,-3,0,-1,-1,-1,-1,-1,5,-1
KR_6749124664,440,4,70,26,10,2,0,2,1,1,2,4,3,7,2,2,4,1,1,2,1,5,-19,-3,-3,6,4,0,1,1,1,1,1,3,-1
KR_6661584090,420,-5,-89,-8,-9,-3,4,1,-1,2,1,-4,5,1,0,1,1,-1,1,0,0,-3,-2,-1,-4,5,0,0,-2,1,-1,1,-1,4,-1
KR_6757951189,420,6,121,28,3,5,1,6,-2,4,2,-1,2,1,0,3,3,1,1,2,0,-5,-7,-2,-1,3,1,0,2,-1,1,1,-1,5,-1
KR_6757394616,420,-2,-32,-12,-5,-4,5,1,-2,2,0,0,4,4,0,1,1,1,0,1,0,1,-20,1,-3,2,1,0,0,1,0,-1,1,4,-1
KR_6719519860,420,-2,-78,-24,2,0,2,2,0,4,4,0,1,1,-1,2,1,3,0,3,0,2,-7,-2,-4,6,-1,0,1,0,-1,-1,1,0,-1
KR_6679442499,420,0,19,4,-5,1,0,1,-7,7,0,0,2,2,0,3,3,1,0,1,1,-14,205,-7,0,7,4,0,1,1,-1,1,1,1,-1
KR_6716350820,420,0,0,0,8,5,0,5,0,4,4,1,2,3,1,0,1,1,1,2,0,3,3,-2,0,2,2,0,0,1,0,0,1,2,-1
KR_6732390585,440,4,25,0,5,4,2,6,-1,3,2,3,0,3,-2,4,2,1,2,3,1,7,-4,5,-6,1,0,0,0,1,-1,0,1,5,-1
KR_6728274778,420,-2,-92,-16,-2,-1,1,0,1,2,3,-3,3,0,2,0,2,-1,1,0,0,2,133,-5,-1,6,5,0,0,-1,1,0,1,6,-1
KR_6762634571,420,0,17,-4,7,2,1,3,3,0,3,2,1,3,0,2,2,0,0,0,0,9,-4,-2,-2,4,3,0,0,1,-1,-1,1,3,-1
KR_6610926790,420,-4,-97,-15,-4,-4,6,2,1,1,2,1,0,1,-2,4,2,0,0,0,1,-1,-4,-4,-2,6,0,0,-2,-1,1,-1,1,5,-1
KR_6723602590,440,-5,-150,32,-15,0,3,3,-1,2,1,-3,4,1,-12,12,0,1,1,2,0,-15,-45,-3,0,3,20,0,-4,-1,-1,-1,-1,4,-1
KR_6724947638,440,0,-46,-6,3,2,0,2,3,4,7,-1,3,2,-4,5,1,3,6,9,1,6,-24,4,-6,2,3,0,-1,1,0,-1,1,2,-1
KR_6741875127,420,0,57,0,-4,-5,7,2,1,2,3,0,1,1,-2,5,3,2,0,2,-1,-4,4,4,-8,4,-2,0,-1,1,0,-1,-1,1,-1
KR_6649449314,420,-2,44,-37,-6,2,0,2,3,3,6,-2,2,0,-9,9,0,0,2,2,-1,-10,-5,3,-7,4,0,0,-1,-1,-1,-1,-1,4,-1
KR_6386174143,420,-1,-39,-8,-4,-4,4,0,4,2,6,-1,2,1,-2,4,2,-1,2,1,-1,4,1,-1,-2,3,-3,0,-1,-1,-1,-1,-1,1,-1
KR_6757552474,420,-1,-33,32,-2,0,2,2,-2,2,0,2,1,3,-2,3,1,0,0,0,0,-4,-6,1,-2,1,1,0,-1,0,-1,-1,1,0,-1
KR_6758891846,420,2,-14,16,7,5,0,5,-2,6,4,2,0,2,0,5,5,2,0,2,0,5,-2,-1,-2,3,1,0,1,-1,1,1,-1,3,-1
KR_6754320962,420,-3,-60,-36,-1,0,1,1,-2,5,3,5,1,6,-2,6,4,-2,7,5,0,-3,-7,-3,-4,7,-2,0,-2,-1,-1,-1,1,5,-1
KR_6729330220,420,-5,-43,-29,-9,2,1,3,-4,4,0,0,2,2,-5,6,1,-2,2,0,0,-10,36,-1,-2,3,-16,0,0,-1,1,-1,1,5,-1
KR_6709165648,420,0,-58,16,-1,4,0,4,1,3,4,-3,4,1,-3,3,0,0,2,2,1,-2,-30,-3,-3,6,1,0,-1,-1,1,-1,1,6,-1
KR_6758108584,420,-5,-50,-32,-8,0,1,1,-7,8,1,0,2,2,-1,4,3,0,1,1,0,-17,-12,-1,-5,6,-4,0,0,0,1,0,1,0,-1
KR_6742446100,420,-3,18,-12,-7,-2,4,2,-2,5,3,0,3,3,-2,2,0,-1,1,0,0,-4,-6,1,-3,2,0,0,0,-1,-1,0,1,1,-1
KR_6758674954,440,-1,1,5,5,3,0,3,-4,4,0,2,7,9,5,0,5,-1,3,2,0,7,13,5,-5,0,-4,0,0,-1,0,-1,-1,5,-1
KR_6722256814,420,-3,-12,-16,-13,-1,1,0,-3,4,1,-2,3,1,-7,9,2,0,1,1,-1,-16,-23,-8,-3,11,4,0,-2,-1,-1,-1,-1,6,-1
KR_6757561165,420,3,7,-18,0,-1,4,3,0,3,3,-1,3,2,0,4,4,2,0,2,0,1,-3,-2,-3,5,6,0,0,-1,0,1,1,4,-1
KR_6763246399,420,-5,10,-12,-8,3,0,3,-6,8,2,2,2,4,-6,6,0,-1,3,2,1,-14,-5,-4,-3,7,-2,0,0,-1,1,-1,1,6,-1
KR_6671625222,440,-1,-38,-30,-6,-2,4,2,-2,5,3,-2,2,0,-2,5,3,2,1,3,-1,-3,-21,-3,-4,7,-1,0,0,-1,-1,0,-1,3,-1
KR_6622510748,440,-2,-57,0,-14,5,0,5,-9,11,2,-5,5,0,-3,5,2,-2,3,1,0,-9,-267,-3,-3,6,9,0,-1,1,-1,-1,1,4,-1
KR_6700147324,420,1,-27,43,6,5,0,5,0,4,4,1,1,2,-2,3,1,2,1,3,0,-1,3,6,-7,1,0,0,-1,-1,1,-1,1,6,-1
KR_6763190280,420,-2,15,-4,-5,-1,2,1,1,1,2,-4,5,1,1,1,2,-2,2,0,1,-4,-1,-1,-2,3,0,0,0,-1,-1,0,1,2,-1
KR_6762324459,420,-4,-127,-52,-4,1,1,2,0,1,1,-1,2,1,-1,2,1,-3,4,1,0,-2,0,5,-8,3,-3,0,-1,1,1,-1,1,5,-1
KR_6736655692,420,-1,-57,3,4,-2,2,0,4,1,5,3,2,5,-2,3,1,1,0,1,0,2,38,-1,-1,2,-32,0,-1,1,1,-1,1,6,-1
KR_6649339634,420,-4,-118,-24,-10,-6,8,2,-3,4,1,-1,2,1,1,0,1,-1,1,0,0,2,-46,-1,-1,2,22,0,-3,-1,1,-1,-1,6,-1
KR_6702049197,420,2,-22,17,4,4,4,8,-3,5,2,-1,1,0,3,3,6,1,1,2,1,5,-32,-3,-4,7,23,0,0,-1,-1,1,1,2,-1
KR_6752396851,420,-3,54,24,-11,-3,4,1,-8,9,1,0,2,2,-3,5,2,3,2,5,-1,-13,-10,-1,-2,3,-3,0,0,-1,1,0,-1,5,-1
KR_6382548474,420,-3,-19,-12,-6,-3,3,0,3,3,6,2,4,6,-8,9,1,0,0,0,0,-5,9,5,-6,1,-7,0,0,0,0,0,-1,0,-1
KR_6632899793,420,-1,11,-35,-6,-2,4,2,-6,6,0,0,1,1,2,1,3,0,0,0,0,-8,-7,-6,-1,7,4,0,-2,1,-1,-1,1,5,-1
KR_6667468711,420,0,23,7,-2,-2,3,1,0,1,1,-1,2,1,0,0,0,1,2,3,0,-2,8,5,-9,4,-4,0,0,1,-1,1,-1,4,-1
KR_6732468974,420,-2,-49,-3,-4,-2,3,1,-2,4,2,0,0,0,1,3,4,-1,1,0,-1,-5,-7,-5,-2,7,4,0,-2,1,-1,-1,-1,2,-1
KR_6722386443,420,-6,-98,-12,-14,-3,4,1,-7,8,1,-8,8,0,0,0,0,4,1,5,0,-8,-8,2,-5,3,0,0,-2,1,-1,-1,-1,1,-1
KR_6651396709,420,-2,-59,-12,-2,0,1,1,0,2,2,-1,5,4,-2,4,2,1,2,3,2,-4,-8,-1,-4,5,2,0,0,1,1,0,1,4,-1
KR_6704502754,420,-1,48,-28,3,2,1,3,1,2,3,4,0,4,-5,5,0,1,1,2,1,0,9,-2,-4,6,-3,0,0,-1,-1,0,1,2,-1
KR_6721362466,420,-4,-38,8,-9,-3,4,1,-3,4,1,0,2,2,-2,8,6,-1,2,1,-1,-8,1,3,-5,2,-3,0,1,1,1,1,-1,1,-1
KR_6728439982,420,0,-3,-7,-2,-1,7,6,-2,3,1,2,0,2,-1,3,2,0,0,0,0,0,-2,3,-5,2,1,0,-1,1,-1,-1,1,3,-1
KR_6525919853,420,-2,-21,-20,-8,0,2,2,-3,5,2,-2,4,2,-4,7,3,1,0,1,0,-8,-5,-1,-2,3,1,0,0,-1,1,1,1,5,-1
KR_6681773955,420,-4,-76,-15,-13,0,1,1,-5,5,0,-5,6,1,-1,4,3,-2,2,0,0,-11,19,-6,0,6,-20,0,0,-1,1,-1,-1,4,-1
KR_6732680158,440,-2,-62,11,-6,-2,3,1,-7,9,2,4,0,4,-2,2,0,1,0,1,0,-2,-37,-2,-4,6,0,0,0,-1,1,-1,-1,6,-1
KR_6710216077,440,-3,30,-20,-3,2,0,2,-5,5,0,1,0,1,0,0,0,-1,1,0,0,-3,15,-2,-2,4,-2,0,1,-1,1,1,-1,6,-1
KR_6728254319,440,-1,12,-1,-3,0,1,1,0,1,1,-2,3,1,-2,5,3,1,1,2,0,-4,7,2,-3,1,5,0,0,-1,-1,0,1,2,-1
KR_6635540075,420,-4,-9,-20,0,-4,4,0,-1,4,3,-2,3,1,7,0,7,0,1,1,0,0,8,2,-3,1,0,0,0,1,0,0,1,5,-1
KR_6625846695,420,-2,-3,12,-9,-2,4,2,1,1,2,-4,5,1,-4,5,1,0,1,1,0,-15,-101,1,-4,3,-2,0,-2,1,0,-1,-1,5,-1
KR_6706804458,420,-1,-34,0,0,-1,4,3,0,0,0,3,2,5,-2,2,0,0,0,0,0,2,-12,-5,-1,6,1,0,-1,-1,1,-1,-1,6,-1
KR_6724066182,420,2,-16,-2,4,-4,4,0,1,3,4,2,3,5,2,2,4,3,1,4,0,9,8,4,-6,2,-3,0,0,1,-1,-1,1,2,-1
KR_6730075355,440,1,-8,13,4,3,1,4,-1,2,1,1,3,4,1,1,2,0,0,0,0,-3,1,1,-3,2,3,0,0,1,-1,-1,1,2,-1
KR_6689204489,420,-10,-163,-42,-19,-6,7,1,-7,8,1,-1,4,3,-5,6,1,0,3,3,0,-12,-8,1,-3,2,2,0,-2,-1,-1,-1,-1,4,-1
KR_6672678475,440,0,-16,-12,-1,2,2,4,-2,3,1,1,1,2,0,2,2,-2,2,0,0,-7,-9,-4,-1,5,-2,0,1,0,0,1,1,0,-1
KR_6648628107,420,-1,86,0,3,1,1,2,1,2,3,2,0,2,1,3,4,-2,2,0,0,0,-6,-2,-7,9,2,0,0,1,-1,1,1,3,-1
KR_6759037447,420,-2,-21,0,-13,-6,6,0,-4,4,0,-1,1,0,2,3,5,-4,5,1,0,-9,-5,3,-5,2,1,0,-1,1,-1,-1,-1,2,-1
KR_6686647013,420,-1,1,22,-1,-2,5,3,3,1,4,3,2,5,-1,4,3,-4,5,1,-2,-4,311,-2,-4,6,0,0,1,-1,1,-1,-1,4,-1
KR_6726785302,440,-1,-28,-4,-7,-3,5,2,1,2,3,-5,9,4,0,1,1,0,2,2,0,-7,-5,-5,-4,9,-4,0,-1,-1,1,-1,-1,1,-1
KR_6640512938,420,-1,-45,-4,2,-1,3,2,1,2,3,-1,1,0,2,1,3,1,0,1,0,3,104,-4,-1,5,1,0,0,-1,1,0,-1,3,-1
KR_6633439930,420,-5,-115,-4,-15,-2,3,1,1,1,2,-7,8,1,-6,7,1,-1,1,0,0,-13,-2,-1,-3,4,-1,0,-2,-1,-1,-1,-1,2,-1
KR_6759024119,420,-1,17,23,-2,3,0,3,-1,1,0,2,4,6,0,2,2,-6,6,0,1,-9,2,4,-4,0,-1,0,-1,-1,-1,-1,1,3,-1
KR_6629815387,440,-10,-100,-27,-15,-2,2,0,-5,5,0,-3,4,1,-5,5,0,0,0,0,0,-15,-18,-1,-2,3,0,0,-1,-1,-1,-1,-1,5,-1
KR_6722691967,420,-1,-122,12,-1,1,1,2,0,1,1,-4,4,0,1,3,4,1,0,1,-1,-2,-2,2,-4,2,-1,0,0,1,-1,-1,-1,2,-1
KR_6589098647,420,-6,-121,-8,-11,1,0,1,0,1,1,-4,7,3,-8,8,0,0,0,0,0,-20,32,-4,0,4,-2,0,-3,0,-1,-1,-1,0,-1
KR_6612467737,420,-5,-35,8,-10,-4,5,1,-3,5,2,-2,3,1,-1,3,2,0,2,2,0,-3,-12,0,-4,4,-2,0,-1,-1,-1,-1,-1,6,-1
KR_6628156230,420,-3,-6,12,-2,2,2,4,-2,4,2,0,4,4,-3,4,1,1,1,2,0,-6,-23,-3,-5,8,25,0,-1,-1,0,-1,1,6,-1
KR_6741104374,420,0,21,-24,-2,-1,4,3,0,1,1,0,2,2,0,1,1,-1,1,0,0,-3,45,3,-4,1,-21,0,1,-1,1,1,-1,2,-1
KR_6754298287,420,-3,-69,24,3,4,0,4,3,0,3,-2,3,1,-2,3,1,0,0,0,1,3,-1,0,-3,3,-1,0,0,1,1,0,1,5,-1
KR_6605294036,420,-1,-25,-19,-3,-2,2,0,-4,4,0,1,2,3,1,1,2,1,3,4,0,0,-53,2,-6,4,0,0,1,-1,1,1,-1,5,-1
KR_6760272611,440,-2,-38,16,-2,-2,3,1,-2,7,5,3,2,5,-2,7,5,1,1,2,0,3,-9,-5,0,5,5,0,0,-1,0,0,1,5,-1
KR_6757561993,420,-4,18,16,-14,-2,2,0,-7,7,0,-2,2,0,1,2,3,-4,4,0,0,-16,19,-4,-4,8,2,0,0,1,1,0,-1,4,-1
KR_6750723637,420,-2,8,-16,-2,-1,2,1,-3,3,0,2,0,2,-4,8,4,4,1,5,0,-2,8,1,-5,4,2,0,0,-1,1,0,1,1,-1
KR_6703101133,420,-6,-124,-35,-19,-7,8,1,-3,5,2,-1,1,0,-7,7,0,-1,2,1,-1,-13,22,-1,-1,2,-1,0,0,-1,-1,-1,-1,3,-1
KR_6694061716,420,3,4,-4,5,0,4,4,2,1,3,1,2,3,2,1,3,0,2,2,0,3,23,6,-8,2,1,0,1,1,1,-1,-1,4,-1
KR_6717607287,420,1,11,8,1,-5,5,0,3,2,5,0,3,3,0,2,2,3,1,4,0,-3,-8,0,-4,4,5,0,-1,0,-1,-1,-1,0,-1
KR_6751108234,420,-7,-115,4,-16,1,1,2,-2,2,0,-8,8,0,-4,4,0,-3,4,1,-1,-9,8,0,-4,4,0,0,-1,0,0,-1,-1,0,-1
KR_6742295874,420,2,42,-11,-1,-1,3,2,5,2,7,-3,4,1,3,1,4,-5,6,1,0,1,22,0,-1,1,-1,0,1,0,-1,1,1,0,-1
KR_6635955575,420,0,-10,-16,4,1,1,2,5,1,6,-3,3,0,-1,5,4,2,1,3,0,5,6,0,-2,2,-3,0,0,0,-1,0,-1,0,-1
KR_6752130626,420,-2,-23,8,-14,0,0,0,-1,2,1,-2,5,3,-8,9,1,-3,3,0,-1,-16,-4,-5,0,5,-1,0,-2,-1,-1,-1,-1,5,-1
KR_6758917703,420,-1,16,2,-6,-1,2,1,1,3,4,-6,9,3,-4,5,1,4,0,4,0,-7,13,-2,-2,4,0,0,0,0,0,-1,1,0,-1
KR_5664309715,420,-3,-37,4,-7,0,1,1,3,2,5,-3,4,1,-6,7,1,-1,1,0,0,-3,12,-4,-2,6,1,0,0,-1,0,0,-1,1,-1
KR_6758652425,420,-2,-7,-48,-3,1,1,2,-7,7,0,0,0,0,4,1,5,-1,2,1,0,-1,-116,-6,0,6,-3,0,-1,-1,-1,-1,-1,6,-1
KR_6695386129,420,-4,-36,-16,-7,-2,2,0,-2,7,5,1,1,2,-2,3,1,-2,2,0,0,1,-142,-2,-2,4,0,0,-2,-1,-1,-1,-1,5,-1
KR_6644768903,420,-4,-79,-8,-12,0,2,2,-4,4,0,-3,4,1,-4,4,0,-1,1,0,-1,-10,11,-4,-1,5,1,0,-1,1,-1,-1,-1,5,-1
KR_6663326714,440,-3,-29,-4,-6,-3,4,1,-4,6,2,6,1,7,-1,7,6,-4,6,2,0,-7,6,-1,-2,3,-2,0,0,-1,1,0,1,6,-1
KR_6620027031,420,3,28,20,5,5,3,8,4,0,4,1,2,3,-2,2,0,-3,4,1,0,3,2,-2,-1,3,-1,0,2,-1,0,1,1,1,-1
KR_6749618305,420,-1,-96,-6,1,0,3,3,-1,4,3,1,1,2,-2,4,2,3,1,4,0,3,-17,0,-3,3,-3,0,0,1,-1,0,-1,2,-1
KR_6715242138,420,-2,-8,-19,-3,-2,3,1,-1,1,0,1,5,6,-2,4,2,1,0,1,0,-2,-2,0,-3,3,-1,0,0,1,0,0,1,5,-1
KR_6750651384,420,-6,-116,-4,-10,-4,7,3,2,1,3,-7,7,0,-3,9,6,2,1,3,-1,0,-5,0,-2,2,-1,0,-2,0,0,-1,-1,0,-1
KR_6695677136,420,0,-15,14,-9,-1,2,1,-3,6,3,0,4,4,-3,4,1,-2,3,1,0,-17,-3,-2,-3,5,0,0,-1,1,-1,-1,-1,5,-1
KR_6680469455,420,-3,-85,5,-5,-1,3,2,-1,3,2,1,3,4,-5,10,5,1,2,3,-2,-7,-33,-1,-3,4,1,0,-1,-1,-1,-1,-1,1,-1
KR_6635800585,420,-6,-28,-12,-15,0,1,1,-4,5,1,-4,4,0,-5,5,0,-2,2,0,0,-19,-151,0,-3,3,-2,0,-1,-1,-1,-1,-1,6,-1
KR_6695232462,420,-5,-93,-19,-6,0,3,3,-7,7,0,-1,6,5,3,2,5,-1,1,0,0,-2,-4,-2,-2,4,-2,0,-3,-1,-1,-1,1,3,-1
KR_6746071405,440,0,13,12,0,-2,3,1,0,0,0,-1,4,3,3,2,5,0,0,0,0,-3,-4,-1,-2,3,-1,0,-1,-1,-1,-1,-1,4,-1
KR_6757269212,440,-1,-24,-2,2,6,1,7,1,0,1,-2,3,1,-3,4,1,0,1,1,0,-6,1,-3,-2,5,-2,0,1,1,1,1,1,5,-1
KR_6742696399,420,-3,-2,-116,-2,-1,2,1,-2,7,5,-1,1,0,-1,3,2,3,0,3,0,5,4,1,-2,1,-3,0,-4,-1,-1,-1,-1,5,-1
KR_6748605476,420,-4,30,4,-14,-1,2,1,-8,9,1,-2,3,1,-4,4,0,1,0,1,0,-13,11,-3,-1,4,2,0,-2,1,-1,-1,1,3,-1
KR_6759524972,420,-2,-59,-8,-3,6,0,6,-1,1,0,-1,2,1,-2,3,1,-5,6,1,0,-6,-4,1,-4,3,2,0,0,1,-1,-1,-1,3,-1
KR_6759564298,420,-1,20,-8,4,3,1,4,3,1,4,-2,5,3,-1,1,0,1,1,2,-1,-5,-4,-1,-3,4,-2,0,1,1,1,1,-1,3,-1
KR_6608891001,420,0,-33,-10,4,1,0,1,4,1,5,3,1,4,-2,4,2,-2,2,0,0,2,-19,1,-5,4,0,0,-1,-1,1,1,-1,6,-1
KR_6676163815,420,-2,-21,-12,-8,-3,3,0,4,2,6,-3,5,2,-4,4,0,-2,4,2,0,-2,-14,2,-5,3,-1,0,-1,1,0,-1,-1,3,-1
KR_6751948096,420,-1,-25,8,-10,1,0,1,-5,8,3,0,1,1,-5,6,1,-1,1,0,0,-10,-37,-1,-5,6,1,0,0,-1,1,0,1,5,-1
KR_6668996466,420,-2,-60,-2,-4,-1,1,0,0,1,1,-5,7,2,3,3,6,-1,1,0,0,3,-6,0,-1,1,-1,0,-1,-1,1,-1,1,4,-1
KR_6762783754,420,-3,-72,-20,3,0,2,2,6,0,6,3,6,9,-5,7,2,-1,2,1,0,5,-48,-3,-3,6,12,0,-1,1,1,-1,1,6,-1
KR_6742794250,440,-4,-72,12,0,-3,5,2,-3,3,0,4,2,6,3,0,3,-1,3,2,0,-2,-7,-2,-2,4,-1,0,0,-1,1,-1,-1,1,-1
KR_6751361419,420,-1,-50,16,2,-2,3,1,3,1,4,0,5,5,1,2,3,0,2,2,0,8,-1,3,-6,3,-4,0,0,1,1,0,-1,6,-1
KR_6755274499,420,1,25,12,-6,-1,3,2,-2,3,1,1,1,2,-2,3,1,-2,2,0,0,-10,-8,-3,-1,4,5,0,-1,-1,-1,-1,-1,2,-1
KR_6741043335,420,-1,14,3,-10,0,2,2,-2,3,1,-3,8,5,-3,4,1,-2,2,0,-1,-8,35,2,-4,2,-20,0,0,1,-1,-1,-1,1,-1
KR_5729664667,420,0,1,-9,0,0,1,1,-4,7,3,1,3,4,2,3,5,1,0,1,0,-1,-7,-2,-4,6,0,0,0,1,1,0,-1,2,-1
KR_6366268032,420,-8,-6,4,-19,2,1,3,-9,9,0,-3,3,0,-9,9,0,0,1,1,0,-31,0,0,0,0,0,0,-2,1,1,-1,-1,4,-1
KR_6747571647,420,-5,-19,-3,-11,-1,2,1,1,2,3,-2,4,2,-8,8,0,-1,2,1,0,-9,-24,-2,-1,3,2,0,-1,-1,-1,-1,-1,3,-1
KR_6739060130,440,-4,-43,-4,-8,0,1,1,0,2,2,-8,9,1,0,2,2,0,0,0,0,-5,4,-2,-4,6,-7,0,-3,-1,-1,-1,-1,1,-1
KR_6741024010,420,-1,-62,-4,4,1,1,2,3,2,5,-3,3,0,1,2,3,2,0,2,0,3,-4,-1,-1,2,-1,0,0,-1,0,0,1,3,-1
KR_6711479467,420,-3,-110,-12,-4,0,2,2,-4,6,2,2,2,4,-2,3,1,0,0,0,-1,8,-1,1,-2,1,-5,0,-3,0,-1,-1,-1,0,-1
KR_6628226639,420,-4,-74,-16,-13,-2,3,1,-3,3,0,-7,8,1,2,1,3,-3,3,0,0,-13,105,-2,-1,3,-1,0,0,-1,0,-1,-1,1,-1
KR_6756510552,440,4,1,7,10,1,0,1,5,3,8,-1,3,2,1,0,1,4,0,4,0,9,11,3,-4,1,2,0,1,1,0,1,1,6,-1
KR_6755499750,420,-1,29,0,-9,-1,4,3,0,2,2,-9,9,0,0,2,2,1,0,1,0,-6,3,-1,-5,6,0,0,1,-1,-1,1,-1,1,-1
KR_6758330414,440,2,25,24,2,-1,1,0,2,1,3,0,1,1,-1,2,1,2,2,4,0,0,-354,2,-3,1,1,0,0,1,-1,0,-1,5,-1
KR_6633209780,420,-2,-50,-32,-3,-2,3,1,1,3,4,-4,4,0,4,3,7,-2,2,0,0,1,-12,0,-4,4,-2,0,-1,-1,-1,-1,1,3,-1
KR_6589666108,420,-5,-56,-28,-8,1,1,2,-8,8,0,0,3,3,-2,3,1,1,1,2,-2,-3,2,3,-5,2,-4,0,0,-1,0,0,-1,1,-1
KR_6700787349,420,-4,-41,-1,0,2,1,3,-1,5,4,0,3,3,0,2,2,-1,2,1,0,-7,9,3,-6,3,-1,0,-1,1,1,-1,-1,4,-1
KR_6617721596,420,-3,-24,-12,-8,-1,2,1,-1,3,2,-4,5,1,-1,3,2,-1,1,0,0,-7,0,6,-8,2,2,0,-1,1,0,-1,1,1,-1
KR_6750057274,420,-1,30,-23,-3,1,3,4,1,2,3,-5,6,1,0,3,3,0,7,7,-1,-6,-17,0,-3,3,5,0,0,1,-1,1,1,1,-1
KR_6754338196,420,1,36,-34,10,-2,2,0,0,2,2,7,1,8,3,1,4,2,0,2,0,7,-103,3,-3,0,-1,0,0,0,1,1,1,0,-1
KR_6606307811,420,0,-12,8,2,1,1,2,4,1,5,-2,2,0,-3,7,4,2,1,3,0,10,-8,0,-3,3,1,0,0,-1,1,0,-1,2,-1
KR_6611630567,420,-1,-77,-32,2,-2,4,2,4,0,4,2,1,3,-2,4,2,0,0,0,0,4,196,2,-3,1,-3,0,0,1,-1,0,1,4,-1
KR_6727758491,420,-1,-93,-42,-1,0,3,3,1,2,3,-1,3,2,0,1,1,-1,1,0,0,-2,-4,0,-3,3,-1,0,-2,-1,-1,-1,-1,3,-1
KR_6749335984,420,-3,-71,-20,-2,-2,3,1,-2,2,0,3,1,4,-1,1,0,0,0,0,0,-6,-5,0,-2,2,0,0,-3,-1,-1,-1,-1,5,-1
KR_6764738976,420,-3,-53,-4,-16,-1,3,2,-2,3,1,-2,3,1,-5,5,0,-6,6,0,-3,-18,-3,0,-2,2,-3,0,0,-1,-1,0,-1,4,-1
KR_6621316019,440,1,23,13,-4,1,4,5,1,2,3,-3,3,0,-2,3,1,-1,1,0,0,-8,3,-5,-3,8,-5,0,0,-1,0,0,-1,4,-1
KR_6596503857,420,0,-70,3,-4,2,1,3,-2,3,1,-2,3,1,-2,2,0,0,0,0,0,-6,13,-3,0,3,-1,0,0,-1,0,0,-1,6,-1
KR_6731838532,420,-10,-39,-63,-4,-5,5,0,-3,3,0,1,3,4,2,1,3,1,0,1,0,-1,25,1,-4,3,-2,0,-2,-1,-1,1,1,6,-1
KR_6761229638,420,1,17,20,3,3,0,3,0,4,4,0,1,1,-1,5,4,1,2,3,-1,-8,11,-4,-3,7,-1,0,1,1,1,1,-1,4,-1
KR_6363956154,420,-4,-20,-8,-3,-1,2,1,-2,2,0,3,0,3,-2,3,1,-1,1,0,1,-5,0,0,0,0,24,0,0,0,-1,0,1,0,-1
KR_6701957637,420,-3,-106,-17,-4,-4,5,1,-2,4,2,-3,3,0,4,2,6,1,1,2,-1,3,-24,-2,-4,6,2,0,-1,-1,1,-1,-1,2,-1
KR_6726409514,440,1,-28,20,4,-1,1,0,1,2,3,4,0,4,1,3,4,-1,2,1,0,10,5,6,-7,1,2,0,-1,1,0,-1,-1,3,-1
KR_6602878156,420,-10,-135,-37,-25,-7,7,0,-13,13,0,-5,6,1,-1,2,1,1,0,1,-1,-27,-9,-2,-2,4,-2,0,-4,-1,-1,-1,-1,2,-1
KR_6746427623,420,-1,56,-24,-6,0,0,0,-2,2,0,0,1,1,0,6,6,-4,4,0,1,-4,-12,-5,-1,6,3,0,0,0,1,0,1,0,-1
KR_6672908454,440,-1,-70,0,-6,1,0,1,-5,7,2,-1,1,0,-1,2,1,0,0,0,0,0,-1,0,-1,1,-3,0,-1,-1,-1,-1,-1,3,-1
KR_6732847707,420,0,-33,16,0,0,3,3,3,1,4,-1,4,3,-2,3,1,0,1,1,0,4,-5,0,-1,1,1,0,-1,0,0,-1,1,0,-1
KR_6753477803,440,-1,5,13,-6,-6,6,0,1,0,1,1,2,3,-2,2,0,0,0,0,0,-7,0,5,-6,1,1,0,-2,1,-1,-1,-1,5,-1
KR_6625572805,440,-2,-4,-24,-7,0,1,1,-6,7,1,0,3,3,0,4,4,-1,2,1,0,-11,6,5,-10,5,1,0,-1,-1,1,-1,1,1,-1
KR_6753581072,420,-1,-105,-17,-4,-2,3,1,-1,5,4,-2,4,2,-1,3,2,2,1,3,0,-2,15,3,-4,1,-3,0,-1,0,1,-1,-1,0,-1
KR_6676013936,420,0,-19,20,3,-1,4,3,2,2,4,4,1,5,-2,6,4,0,1,1,0,0,10,2,-3,1,-4,0,0,1,-1,-1,-1,3,-1
KR_6695345860,420,-1,-64,-4,-2,-1,2,1,2,3,5,-4,5,1,2,2,4,-1,2,1,0,-2,-3,2,-2,0,-3,0,0,-1,0,0,-1,1,-1
KR_6717738669,420,-2,-51,-34,-8,0,3,3,2,6,8,-9,9,0,-1,1,0,0,3,3,0,-2,2,-2,-2,4,0,0,-2,-1,1,-1,1,5,-1
KR_6715046507,420,-3,-12,-4,-7,-1,3,2,-1,2,1,2,1,3,-4,4,0,-3,4,1,0,-7,3,1,-7,6,-3,0,-1,1,-1,-1,-1,6,-1
KR_6744798402,420,-4,-96,12,-8,-2,5,3,-1,1,0,-1,4,3,-5,6,1,1,2,3,0,-5,-24,-3,-3,6,2,0,-1,0,-1,-1,-1,0,-1
KR_6728703508,440,0,-71,4,-2,-3,3,0,-1,4,3,0,2,2,1,3,4,1,0,1,0,0,36,-1,-2,3,-35,0,0,0,0,0,-1,0,-1
KR_6764492475,440,0,-139,11,-2,-4,5,1,2,0,2,1,2,3,-1,2,1,0,4,4,0,2,-28,-1,-3,4,-6,0,-3,-1,-1,-1,-1,6,-1
KR_6764689497,440,-3,-86,23,-6,4,4,8,-1,3,2,-2,2,0,-6,9,3,-1,2,1,0,-9,5,-1,-4,5,-6,0,-2,1,-1,-1,-1,3,-1
KR_6739013221,420,2,-50,17,-1,-4,5,1,-2,3,1,-5,5,0,8,0,8,2,1,3,0,9,-339,0,-4,4,2,0,0,1,-1,1,1,2,-1
KR_6715869612,420,1,0,-15,6,-2,2,0,3,4,7,0,3,3,2,0,2,3,1,4,0,7,-2,-4,0,4,4,0,-1,-1,-1,-1,-1,5,-1
KR_6762652492,440,1,-7,-20,-2,3,1,4,0,2,2,-3,4,1,-3,3,0,1,0,1,1,-2,4,-3,-2,5,2,0,-1,-1,1,-1,1,1,-1
KR_6002798270,420,-1,-31,14,-3,-3,5,2,0,4,4,2,1,3,-2,5,3,0,0,0,1,-2,-2,-1,-3,4,1,0,-1,0,0,-1,1,0,-1
KR_6694484103,420,-3,-62,5,-6,-5,5,0,3,2,5,2,0,2,-4,6,2,-2,3,1,0,-8,-2,-3,-1,4,-1,0,-1,-1,0,-1,-1,5,-1
KR_6760889275,420,-1,6,-8,-1,-3,4,1,0,1,1,4,0,4,1,1,2,-3,3,0,0,-10,8,0,-4,4,1,0,1,1,1,1,-1,3,-1
KR_6762740097,440,1,-82,7,1,2,0,2,0,2,2,-2,4,2,-2,5,3,3,1,4,0,6,-4,-5,-3,8,2,0,0,0,0,0,-1,0,-1
KR_6761363182,420,-5,-24,8,-4,-1,3,2,2,0,2,-3,3,0,-2,5,3,0,0,0,0,-3,31,6,-10,4,-7,0,-1,-1,1,-1,1,1,-1
KR_6688874279,420,-2,17,-15,-7,-1,3,2,-4,6,2,-1,6,5,-2,3,1,1,0,1,0,-14,0,0,-3,3,2,0,0,-1,1,1,-1,6,-1
KR_6705406216,420,-3,-4,-28,-9,0,2,2,-2,3,1,-5,7,2,-2,2,0,0,1,1,0,-3,0,-2,-3,5,-3,0,-1,1,0,-1,-1,2,-1
KR_6719257269,420,-5,-66,3,-5,3,1,4,1,3,4,-5,6,1,-4,4,0,0,0,0,0,-6,0,4,-7,3,0,0,-1,-1,1,-1,-1,2,-1
KR_6729293012,420,-2,10,-20,3,4,0,4,2,0,2,1,1,2,0,1,1,-4,4,0,0,0,5,2,-2,0,-2,0,1,1,1,1,1,6,-1
KR_6757447175,420,-3,-57,0,-1,-3,4,1,1,2,3,-1,2,1,2,1,3,0,1,1,0,5,-1,-2,-2,4,-1,0,-1,1,0,-1,-1,4,-1
KR_6732797155,420,-1,-13,-26,1,-4,4,0,0,0,0,1,1,2,3,0,3,1,0,1,0,-2,0,-2,-3,5,-2,0,0,-1,-1,0,1,4,-1
KR_6744361033,420,-5,-14,-59,-13,-3,4,1,-3,4,1,-4,6,2,-3,4,1,0,2,2,-1,-5,-10,-1,-1,2,-1,0,-2,-1,-1,-1,-1,4,-1
KR_6730724825,420,-5,-14,-28,-2,-3,4,1,2,2,4,0,1,1,0,1,1,-1,1,0,0,0,-1,1,-3,2,-1,0,-1,1,-1,-1,1,6,-1
KR_6762508033,420,1,-47,17,3,-1,1,0,0,2,2,2,1,3,2,2,4,0,0,0,0,7,1,4,-7,3,3,0,-1,1,0,-1,1,4,-1
KR_6733672146,440,-2,4,12,-3,-4,4,0,5,1,6,-4,5,1,0,1,1,0,0,0,0,-1,1,1,-5,4,-3,0,0,-1,1,0,-1,4,-1
KR_6723758474,420,0,-54,12,8,-2,2,0,3,5,8,3,0,3,3,2,5,1,0,1,2,16,-10,0,-1,1,0,0,-1,-1,-1,-1,1,3,-1
KR_6660764159,420,-3,-31,-28,-6,1,1,2,-2,2,0,0,0,0,-4,6,2,-1,2,1,0,-5,-4,0,-5,5,-1,0,0,0,0,0,-1,0,-1
KR_6713178751,420,0,29,-32,-4,-1,3,2,1,2,3,-2,2,0,1,1,2,-3,4,1,0,-8,271,-1,-2,3,0,0,1,0,-1,1,-1,0,-1
KR_6763393764,440,-1,-27,-16,-2,-2,3,1,-5,6,1,0,7,7,3,1,4,2,0,2,0,1,35,1,-6,5,-33,0,0,0,-1,1,-1,0,-1
KR_6663422970,420,-4,-115,-12,-5,-4,4,0,1,0,1,1,3,4,-4,4,0,1,0,1,0,4,-7,1,-3,2,-3,0,-1,-1,0,-1,-1,5,-1
KR_6504625355,420,1,-47,-24,8,-2,2,0,5,2,7,1,2,3,1,1,2,3,2,5,0,11,17,0,-6,6,0,0,0,-1,1,0,1,4,-1
KR_6714708153,420,-1,47,-40,1,-2,2,0,-1,3,2,-3,3,0,8,2,10,-1,2,1,0,4,-218,1,-2,1,2,0,1,1,-1,1,1,4,-1
KR_6746094315,420,0,-19,19,-6,-4,6,2,3,1,4,-1,1,0,-5,5,0,1,1,2,0,-3,-6,-4,-1,5,2,0,-2,1,-1,-1,-1,6,-1
KR_6670245869,440,-1,-54,24,6,0,4,4,3,2,5,-1,1,0,4,1,5,0,0,0,0,5,-6,0,-5,5,-1,0,0,1,1,-1,1,1,-1
KR_6754368510,420,0,-32,-9,-1,-5,6,1,0,1,1,2,3,5,1,2,3,1,1,2,0,2,-121,5,-6,1,-1,0,0,-1,1,0,1,3,-1
KR_6730083647,420,-7,-14,-44,-11,-5,6,1,1,0,1,-4,6,2,-3,3,0,0,0,0,0,-4,-1,-3,-2,5,1,0,-2,-1,0,-1,-1,5,-1
KR_6753116254,440,-2,-97,-16,-3,-6,6,0,0,2,2,2,0,2,0,0,0,1,2,3,0,0,4,7,-7,0,-2,0,-1,0,-1,-1,-1,0,-1
KR_6667389620,420,-7,-170,-14,-7,-6,6,0,2,1,3,-2,4,2,-3,4,1,2,0,2,-1,1,-5,0,-3,3,-1,0,-3,-1,1,-1,-1,5,-1
KR_6651224431,420,-1,-40,-24,2,1,0,1,1,2,3,4,1,5,-6,6,0,2,2,4,0,-1,-177,-2,-7,9,-4,0,0,1,1,1,1,1,-1
KR_6695218205,420,-6,-27,-11,-12,-3,3,0,1,3,4,0,4,4,-7,8,1,-3,3,0,-2,-21,31,-3,-3,6,-22,0,-1,-1,-1,-1,-1,2,-1
KR_6666371844,420,-4,-14,-24,0,-1,2,1,-2,6,4,2,1,3,4,1,5,-3,4,1,2,4,-6,-2,-4,6,2,0,1,0,-1,1,-1,0,-1
KR_6620833294,420,-3,14,-33,-8,0,0,0,-5,6,1,1,1,2,-4,6,2,0,2,2,0,-7,3,-1,-3,4,1,0,1,-1,-1,1,-1,6,-1
KR_6288700855,420,-4,-52,-20,-3,1,2,3,2,2,4,4,0,4,-7,7,0,-3,4,1,-1,-9,-5,-3,-3,6,-4,0,0,1,0,-1,-1,3,-1
KR_6735126368,440,-2,-24,-8,-4,1,0,1,-5,6,1,-5,6,1,5,1,6,0,1,1,1,-2,-2,0,-2,2,0,0,1,-1,1,1,1,4,-1
KR_6662152587,420,-1,46,-16,-4,-3,3,0,-2,6,4,0,1,1,2,4,6,-1,1,0,0,-5,1,1,-5,4,-2,0,0,-1,1,-1,1,4,-1
KR_6743235455,440,1,-65,-4,0,1,2,3,-5,5,0,-3,4,1,6,7,13,1,0,1,0,-8,-3,-2,-4,6,-2,0,-1,1,-1,-1,-1,5,-1
KR_6621368678,440,-2,2,-26,-5,1,2,3,0,2,2,-10,11,1,-3,4,1,7,2,9,0,-4,202,-2,0,2,2,0,0,-1,1,0,1,4,-1
KR_6711732729,420,-4,-16,8,-5,2,1,3,3,1,4,-2,2,0,-8,8,0,0,1,1,0,-5,-38,-2,-4,6,28,0,1,-1,-1,1,1,2,-1
KR_6679968320,440,-5,-45,-34,-8,-3,3,0,0,2,2,-7,7,0,3,1,4,-1,4,3,0,1,-8,0,-3,3,-4,0,-2,-1,0,-1,-1,3,-1
KR_6623254250,420,2,-6,-8,10,-2,3,1,5,1,6,3,1,4,5,1,6,-1,3,2,0,14,40,1,-4,3,-31,0,2,-1,-1,1,1,1,-1
KR_6761730056,420,-3,27,-8,1,0,2,2,1,3,4,-7,7,0,8,1,9,-1,1,0,0,10,-35,3,-6,3,23,0,1,-1,1,-1,-1,4,-1
KR_6665605458,420,0,-12,-17,-1,-2,2,0,2,1,3,-1,4,3,0,4,4,0,0,0,-1,-1,-20,1,-6,5,3,0,0,1,-1,0,-1,4,-1
KR_6742510404,420,-2,-23,4,0,-1,3,2,-2,2,0,0,3,3,2,1,3,1,0,1,1,-1,-4,0,-3,3,4,0,0,-1,-1,0,1,5,-1
KR_6762168925,420,-1,-74,2,-5,-1,2,1,-1,5,4,0,2,2,-4,5,1,1,1,2,-1,-9,-4,1,-3,2,1,0,0,-1,1,0,1,4,-1
KR_6195983369,420,-2,-23,7,-5,-1,3,2,0,3,3,1,0,1,-5,7,2,0,2,2,0,-2,4,1,-8,7,-5,0,-2,-1,-1,-1,-1,5,-1
KR_6762419275,420,-1,-103,10,-1,-5,5,0,2,1,3,1,1,2,2,0,2,-1,3,2,0,10,1,1,-4,3,1,0,-1,1,-1,-1,-1,4,-1
KR_6196243727,420,-3,-54,-2,-7,-5,5,0,-5,6,1,2,0,2,-1,5,4,2,0,2,0,-9,-11,-7,-2,9,-1,0,0,1,1,-1,-1,4,-1
KR_6719372009,420,1,61,-7,1,5,1,6,-2,6,4,-3,4,1,2,0,2,-1,1,0,0,3,-3,1,-2,1,-1,0,0,-1,1,-1,-1,4,-1
KR_6695896348,420,-2,13,4,-6,1,3,4,2,0,2,-6,7,1,-1,6,5,-2,2,0,1,-6,15,6,-7,1,1,0,1,-1,0,1,1,2,-1
KR_6755586332,420,-1,-42,8,-2,-4,6,2,1,0,1,-1,3,2,1,6,7,1,3,4,0,-5,-6,-1,0,1,1,0,-2,0,1,-1,-1,0,-1
KR_6760712815,420,-3,-22,-36,-7,-6,8,2,3,1,4,2,1,3,-5,7,2,-1,1,0,0,-6,-46,-5,0,5,-1,0,-2,0,1,-1,1,0,-1
KR_6722096927,420,-3,-102,-4,-5,0,0,0,3,0,3,-3,8,5,-5,6,1,0,2,2,0,3,-2,1,-3,2,-1,0,-1,1,-1,-1,-1,6,-1
KR_6758826388,440,0,31,16,1,-2,3,1,1,2,3,1,4,5,0,1,1,1,3,4,1,4,-9,-3,-2,5,-2,0,0,0,1,0,1,0,-1
KR_6649090398,420,-1,28,-28,0,-3,3,0,2,3,5,-2,2,0,2,2,4,1,0,1,0,2,-132,0,-7,7,-3,0,0,-1,-1,0,1,5,-1
KR_6757682114,420,1,-25,-10,5,1,2,3,4,1,5,0,4,4,-1,2,1,1,0,1,0,4,44,2,-7,5,-16,0,0,-1,1,0,1,3,-1
KR_6759573053,420,-4,-136,26,-9,-2,4,2,3,2,5,-2,4,2,-8,9,1,0,0,0,0,-9,-14,-5,-5,10,0,0,0,1,-1,0,-1,4,-1
KR_6761472065,420,-4,32,-15,-10,-5,6,1,0,3,3,-1,5,4,0,4,4,-4,6,2,0,-7,9,1,-3,2,-4,0,-2,0,-1,-1,-1,0,-1
KR_6751487744,420,1,37,8,-4,2,0,2,-6,8,2,-1,3,2,-1,3,2,2,1,3,0,-13,39,3,-6,3,-6,0,0,-1,-1,0,-1,3,-1
KR_6761432789,420,0,-62,7,-3,0,4,4,-2,4,2,0,4,4,0,1,1,-1,2,1,0,-2,250,-1,-2,3,-6,0,-1,1,1,1,-1,3,-1
KR_6648599817,420,-1,43,-21,-10,0,1,1,-1,2,1,-2,4,2,-4,4,0,-3,4,1,0,-9,4,0,-6,6,0,0,-1,-1,1,-1,-1,6,-1
KR_6763458338,420,-2,-35,12,0,-1,1,0,-1,4,3,1,3,4,2,2,4,-1,3,2,1,-3,-1,2,-5,3,-1,0,-1,-1,-1,-1,-1,3,-1
KR_6721528558,420,-2,-2,20,3,1,1,2,-3,3,0,0,2,2,3,0,3,2,2,4,0,-4,9,0,-3,3,-1,0,1,1,1,1,1,5,-1
KR_6751793872,440,-5,-115,-16,-9,0,2,2,-3,4,1,0,5,5,-5,9,4,-1,2,1,0,-4,27,1,-4,3,-1,0,-2,-1,1,-1,-1,1,-1
KR_6596384667,420,-4,-13,8,-10,-1,2,1,0,2,2,-4,5,1,-4,6,2,-1,1,0,-2,-11,-2,-1,-1,2,-1,0,0,-1,-1,0,-1,1,-1
KR_6718374975,440,0,-70,9,2,1,1,2,1,0,1,-2,2,0,5,3,8,-3,4,1,0,3,0,4,-8,4,-2,0,-1,1,1,-1,-1,6,-1
KR_6743112106,420,-12,-145,-56,-7,-2,4,2,-2,2,0,2,2,4,-2,2,0,-3,4,1,1,-10,-5,1,-2,1,-1,0,-5,0,-1,-1,1,0,-1
KR_6702271109,420,-2,-66,-24,-4,-1,2,1,0,1,1,2,1,3,-7,8,1,2,0,2,0,0,35,-1,-2,3,0,0,0,-1,-1,0,-1,6,-1
KR_6684829903,420,-1,-18,-4,2,1,2,3,-2,3,1,2,0,2,1,1,2,0,1,1,0,4,3,-1,-6,7,-1,0,-2,-1,-1,-1,-1,2,-1
KR_6695329341,420,-5,-87,-8,-10,-5,5,0,-2,4,2,-5,6,1,4,1,5,-2,2,0,0,-3,18,2,-4,2,-1,0,-1,0,1,-1,-1,0,-1
KR_6759759071,420,0,41,1,0,3,0,3,3,0,3,0,3,3,-5,6,1,-1,3,2,0,-2,2,3,-7,4,0,0,-2,1,0,-1,1,5,-1
KR_6749438657,420,-5,2,-19,-16,-6,8,2,-3,5,2,-5,6,1,5,2,7,-7,8,1,0,-11,-208,7,-9,2,-5,0,0,0,-1,-1,1,0,-1
KR_6615923012,420,-1,17,-24,2,1,1,2,0,1,1,-3,4,1,0,3,3,4,0,4,0,1,19,1,-4,3,5,0,0,-1,-1,0,1,2,-1
KR_6731262329,420,-5,-55,-48,-6,-2,4,2,-1,1,0,2,1,3,-4,4,0,-1,1,0,0,-6,2,-1,0,1,-2,0,-1,0,-1,-1,1,0,-1
KR_6762800282,420,0,-6,-12,1,1,2,3,1,4,5,3,1,4,-3,4,1,-1,1,0,0,1,-47,2,-6,4,19,0,-1,1,0,-1,-1,5,-1
KR_6678442128,420,-3,-51,21,-4,0,2,2,-2,3,1,-1,4,3,1,6,7,-2,3,1,0,-4,16,4,-6,2,-1,0,-1,0,0,-1,-1,0,-1
KR_6638020629,420,3,89,16,6,0,2,2,-3,5,2,6,0,6,1,3,4,2,3,5,0,-7,-1,-2,-2,4,2,0,1,1,1,1,1,4,-1
KR_6526831955,420,2,74,-3,14,3,2,5,5,0,5,-1,7,6,2,2,4,5,0,5,1,9,252,1,-1,0,2,0,2,-1,-1,1,1,4,-1
KR_6704404502,420,-1,-9,25,-8,-5,5,0,-1,2,1,0,3,3,-4,4,0,2,0,2,-1,-1,14,-2,-2,4,-2,0,-1,1,1,-1,-1,6,-1
KR_6764288292,420,-7,-83,6,-15,1,0,1,0,1,1,-5,5,0,-9,12,3,-2,3,1,0,-18,-30,-6,0,6,1,0,-3,-1,-1,-1,-1,5,-1
KR_6651045453,420,-1,9,-35,-5,0,3,3,3,1,4,-4,6,2,-3,5,2,-1,2,1,0,-3,21,4,-7,3,1,0,-1,0,-1,-1,-1,0,-1
KR_6646991226,420,-1,-25,14,1,-3,3,0,-3,3,0,3,1,4,0,2,2,4,1,5,0,-1,24,0,-7,7,3,0,-1,1,1,-1,-1,3,-1
KR_6693464862,440,-1,8,-7,-6,-1,3,2,-3,7,4,1,0,1,-3,5,2,0,0,0,0,-14,-2,0,-5,5,-3,0,1,-1,1,1,1,6,-1
KR_6733356098,420,-1,9,-39,-9,0,0,0,-8,8,0,-1,3,2,1,1,2,-1,1,0,0,-11,-56,-3,0,3,39,0,-3,-1,-1,-1,-1,2,-1
KR_6759140659,420,-4,-57,-28,-8,-1,2,1,0,2,2,3,1,4,-9,9,0,-1,1,0,0,-10,49,-2,-1,3,-13,0,0,0,-1,-1,-1,0,-1
KR_6758451161,420,-2,-23,-38,-2,1,4,5,5,1,6,-7,7,0,-3,3,0,2,0,2,0,2,-13,-4,-1,5,-1,0,0,-1,-1,-1,1,2,-1
KR_6759569637,420,-3,-53,0,-8,-4,4,0,1,0,1,-4,5,1,-5,5,0,4,0,4,0,2,1,-1,-3,4,-6,0,0,-1,1,0,-1,3,-1
KR_6670233216,420,-4,-3,-20,-4,-1,3,2,-7,7,0,1,1,2,1,2,3,2,0,2,0,-3,6,1,-7,6,1,0,-3,1,-1,-1,-1,4,-1
KR_6761012525,420,0,36,-24,-5,-1,2,1,-1,3,2,0,0,0,-2,3,1,-1,3,2,0,-7,-33,0,-3,3,-1,0,1,1,-1,1,-1,5,-1
KR_6695471406,420,-3,-81,4,-4,4,0,4,-3,3,0,-2,4,2,-1,1,0,-2,2,0,-1,-4,7,-3,-3,6,-2,0,0,-1,0,-1,-1,1,-1
KR_6622362312,440,0,-28,-3,-7,-3,5,2,-1,1,0,-5,5,0,2,2,4,0,0,0,-1,-4,210,-5,0,5,0,0,-1,-1,-1,-1,-1,2,-1
KR_6754197092,420,-3,-17,11,-6,2,0,2,-5,5,0,-5,5,0,1,0,1,1,0,1,1,-4,-156,0,-2,2,-1,0,0,-1,-1,0,1,5,-1
KR_6724941054,420,0,-51,1,-1,3,0,3,5,2,7,-2,4,2,-7,7,0,0,0,0,-1,-14,-209,0,-5,5,2,0,-2,-1,-1,-1,-1,4,-1
KR_6761488654,420,0,3,0,-4,-1,1,0,-2,2,0,1,3,4,-3,5,2,1,0,1,0,-8,-13,-5,-4,9,2,0,0,0,-1,0,-1,0,-1
KR_6655763641,440,2,31,-16,11,1,0,1,1,0,1,0,2,2,2,3,5,7,0,7,0,2,3,0,-4,4,2,0,0,1,1,0,1,3,-1
KR_6732491177,420,-1,1,9,-2,2,1,3,1,3,4,0,5,5,-2,2,0,-3,3,0,1,-3,1,-1,-5,6,-4,0,1,1,0,1,1,1,-1
KR_6761679383,440,-7,-31,-70,1,1,3,4,-3,3,0,2,2,4,1,1,2,0,0,0,0,0,13,2,-5,3,-1,0,-1,0,-1,-1,-1,0,-1
KR_6762468092,440,2,66,-16,11,5,1,6,1,2,3,4,2,6,1,1,2,0,0,0,0,7,9,1,-3,2,2,0,1,-1,0,1,1,6,-1
KR_6757062349,440,0,-79,4,1,0,1,1,2,1,3,-1,3,2,1,0,1,-1,3,2,0,9,-7,-2,0,2,1,0,0,-1,-1,0,-1,4,-1
KR_6722897401,420,3,-22,8,0,2,1,3,6,0,6,-8,8,0,0,2,2,0,1,1,0,3,-2,0,-2,2,-3,0,0,1,0,0,-1,1,-1
KR_6652820776,440,2,2,8,0,2,2,4,-4,8,4,-1,2,1,1,0,1,2,0,2,0,-5,2,4,-6,2,0,0,0,1,1,1,-1,5,-1
KR_6754728868,420,-3,-15,-28,-7,1,3,4,1,2,3,-3,4,1,-4,4,0,-2,2,0,0,-2,0,-3,-4,7,-3,0,1,-1,-1,-1,-1,6,-1
KR_6738921825,420,-1,-40,-4,-4,-2,2,0,1,0,1,2,1,3,-5,6,1,0,0,0,0,-2,-2,-1,-6,7,0,0,1,0,1,1,-1,0,-1
KR_6713421312,420,-1,16,-18,-2,-6,9,3,-1,3,2,1,1,2,2,3,5,2,0,2,0,-3,-5,-5,-1,6,2,0,-1,-1,-1,1,-1,5,-1
KR_6762637346,440,-2,-22,-27,-5,2,3,5,-5,5,0,2,0,2,-3,3,0,-1,2,1,0,-9,-3,-3,-2,5,-5,0,-1,-1,-1,-1,1,2,-1
KR_6731643119,420,-3,-53,-12,-7,-4,5,1,1,4,5,0,2,2,-1,1,0,-3,3,0,0,1,-15,-8,-1,9,0,0,-2,-1,-1,-1,-1,5,-1
KR_6715997032,420,-4,-54,28,-7,-3,4,1,-4,6,2,-3,4,1,2,0,2,1,0,1,0,-3,2,0,-3,3,-2,0,-1,-1,-1,-1,-1,5,-1
KR_6760122202,420,0,-63,-4,9,0,2,2,8,2,10,1,1,2,0,6,6,0,2,2,0,9,5,4,-7,3,-3,0,0,1,1,0,1,2,-1
KR_6763478601,420,-2,-60,15,-5,-2,3,1,-3,3,0,-2,2,0,-1,2,1,3,0,3,0,-4,-11,0,-4,4,-3,0,0,0,-1,0,1,0,-1
KR_6759897406,420,-3,-39,32,-11,1,1,2,-6,7,1,-4,5,1,-1,7,6,-1,1,0,1,-5,3,1,-4,3,0,0,-2,-1,0,-1,1,4,-1
KR_6736899360,420,3,25,19,3,-2,4,2,2,2,4,0,1,1,4,0,4,-1,1,0,0,5,12,-1,-4,5,-3,0,0,-1,1,0,-1,2,-1
KR_6734859909,440,0,23,8,-5,0,2,2,-4,4,0,4,0,4,-1,1,0,-4,4,0,-1,-15,5,0,-5,5,1,0,0,-1,1,-1,-1,1,-1
KR_6723791657,420,-2,-34,-8,0,-2,2,0,-6,6,0,0,1,1,7,0,7,1,1,2,0,2,-178,-1,-3,4,2,0,0,1,0,-1,1,1,-1
KR_6761313803,420,-3,41,-22,-7,3,0,3,-2,3,1,-4,6,2,-4,8,4,0,0,0,0,-13,-19,-1,-4,5,2,0,-1,1,-1,-1,-1,1,-1
KR_6379995902,420,0,-45,12,-2,-4,5,1,3,0,3,1,1,2,-4,7,3,2,1,3,1,-4,-1,0,-2,2,0,0,0,1,-1,0,1,5,-1
KR_6741109877,420,1,23,-2,4,0,1,1,1,1,2,-1,1,0,3,2,5,1,0,1,0,4,10,-4,-2,6,2,0,0,-1,1,1,1,3,-1
KR_6515928978,420,-5,-87,24,-8,-5,5,0,-1,3,2,3,0,3,-6,8,2,1,2,3,-1,-6,-21,-1,-1,2,-4,0,-1,-1,-1,-1,-1,5,-1
KR_6610774276,420,-1,-29,-7,-2,0,1,1,1,2,3,-1,2,1,-2,4,2,0,0,0,0,0,-39,-3,0,3,4,0,0,1,-1,0,-1,3,-1
KR_6689004613,420,-5,-105,-32,-12,-6,6,0,2,1,3,-5,5,0,-1,1,0,-2,4,2,0,-5,-1,-1,-5,6,-1,0,-3,0,0,-1,-1,0,-1
KR_6738238763,420,0,-27,-3,-6,2,1,3,-2,2,0,-1,3,2,-3,6,3,-2,4,2,0,-7,52,-4,-3,7,-22,0,0,-1,-1,0,-1,6,-1
KR_6658592741,420,-1,-32,-35,-6,-2,3,1,2,3,5,0,6,6,-5,7,2,-1,2,1,0,-11,3,-1,-4,5,-3,0,1,1,1,1,1,6,-1
KR_6751272650,420,-1,43,9,-2,3,1,4,2,2,4,2,5,7,-5,5,0,-4,4,0,0,-7,-8,0,-1,1,2,0,0,1,0,1,-1,1,-1
KR_6715461332,420,-2,-47,-12,-10,-4,5,1,-6,7,1,0,2,2,1,1,2,-1,1,0,0,-4,16,0,-3,3,-1,0,0,0,-1,-1,-1,0,-1
KR_6748384248,440,2,1,15,9,4,1,5,3,4,7,-2,4,2,1,4,5,3,1,4,2,-4,-6,-3,0,3,3,0,0,1,1,1,-1,5,-1
KR_6733676494,420,-7,-74,-36,-14,-3,5,2,-3,4,1,-3,4,1,-5,7,2,0,1,1,0,-18,-190,2,-4,2,-2,0,-2,-1,-1,-1,1,5,-1
KR_6747974709,420,-4,-26,-18,-11,-6,9,3,0,5,5,-3,4,1,-2,5,3,0,0,0,0,-13,0,6,-7,1,-2,0,0,-1,0,0,-1,6,-1
KR_6747043429,420,-3,1,-12,-7,-3,5,2,-3,4,1,1,2,3,-2,2,0,0,0,0,0,-10,0,1,-4,3,3,0,-1,1,1,-1,1,5,-1
KR_6760660633,420,2,55,-8,2,4,0,4,0,3,3,-1,3,2,1,1,2,-2,2,0,0,0,-9,3,-4,1,3,0,0,0,-1,0,-1,0,-1
KR_5729448132,420,0,-19,1,1,-2,3,1,5,0,5,1,1,2,-2,4,2,-1,1,0,0,0,201,-3,-3,6,5,0,0,-1,-1,0,-1,1,-1
KR_6758709272,420,2,-2,-8,5,-3,6,3,0,2,2,2,3,5,3,3,6,3,0,3,-1,5,4,-2,-1,3,0,0,0,0,-1,-1,-1,0,-1
KR_6670791712,420,-4,7,-45,-12,-1,2,1,-3,6,3,-6,8,2,-1,1,0,-1,1,0,0,-6,-13,-1,-3,4,1,0,-1,1,-1,-1,-1,6,-1
KR_6761833136,420,-1,-11,-41,0,2,2,4,5,0,5,1,1,2,-4,5,1,-4,5,1,0,3,270,4,-5,1,-1,0,-1,1,-1,-1,-1,3,-1
KR_6751401908,420,-2,30,-28,-3,-2,4,2,0,4,4,-7,8,1,3,1,4,3,0,3,0,7,249,-2,0,2,0,0,-1,1,-1,-1,1,5,-1
KR_6759176216,420,-3,-44,-13,0,-4,5,1,3,1,4,-2,4,2,2,2,4,1,3,4,0,9,-28,1,-4,3,0,0,0,-1,1,1,1,5,-1
KR_6762255090,420,-1,-60,1,1,-1,1,0,0,1,1,2,2,4,-2,5,3,2,0,2,0,-2,7,-2,-1,3,27,0,0,-1,-1,0,-1,6,-1
KR_6698423430,420,0,56,-16,-2,1,0,1,-7,8,1,-3,3,0,7,0,7,0,0,0,0,-3,19,0,-6,6,-1,0,0,1,-1,1,1,1,-1
KR_6755654443,420,-3,-92,-12,-7,0,1,1,-1,3,2,-2,7,5,-1,1,0,-3,3,0,0,-12,284,-3,-3,6,22,0,1,-1,1,1,-1,2,-1
KR_6749232832,420,-9,-108,-24,-18,-7,7,0,-3,4,1,-2,3,1,-6,8,2,0,1,1,0,-9,24,1,-4,3,-22,0,-3,-1,-1,-1,-1,3,-1
KR_6751594033,420,-8,-75,-32,-18,-6,7,1,-3,4,1,-3,4,1,-6,8,2,0,2,2,0,-11,-2,-2,-3,5,-1,0,-2,-1,-1,-1,1,1,-1
KR_6727722873,420,-5,-62,-28,-6,2,2,4,0,2,2,-7,7,0,-1,3,2,0,2,2,0,-2,-8,-1,-1,2,1,0,0,-1,0,1,-1,6,-1
KR_6726428893,420,3,66,-8,9,3,1,4,2,5,7,1,2,3,3,2,5,0,0,0,1,12,-364,1,-5,4,1,0,0,0,0,0,1,0,-1
KR_6673300263,440,0,24,-5,0,-3,3,0,-1,4,3,-4,6,2,7,2,9,1,2,3,0,2,-9,1,-3,2,3,0,1,1,1,1,-1,2,-1
KR_6665837748,420,0,-4,11,7,4,0,4,6,0,6,0,3,3,-3,3,0,0,1,1,0,1,37,3,-7,4,-1,0,0,-1,1,1,1,3,-1
KR_6619335845,420,-4,-35,8,-7,-3,3,0,-2,4,2,3,3,6,-2,4,2,-3,4,1,0,-3,7,3,-6,3,-5,0,-2,-1,0,-1,1,2,-1
KR_6672320734,440,-2,-58,-5,-9,6,0,6,-4,5,1,-3,3,0,-7,8,1,-1,2,1,-1,-16,6,5,-8,3,-7,0,-1,-1,1,-1,-1,5,-1
KR_6700979366,420,-4,-39,-25,-5,5,1,6,-2,2,0,-8,9,1,-1,4,3,1,1,2,-1,-1,-9,2,-5,3,0,0,1,-1,-1,1,-1,5,-1
KR_6755007556,420,-2,-50,14,-4,0,1,1,-4,7,3,0,3,3,-3,5,2,3,1,4,-1,-5,-167,0,-2,2,-1,0,-1,1,0,-1,-1,2,-1
KR_6694167429,420,-1,-60,-7,-3,-6,6,0,1,2,3,-1,3,2,0,2,2,3,0,3,0,5,-6,-3,-4,7,1,0,-2,1,1,-1,-1,2,-1
KR_6646489743,440,-4,-52,15,-7,-3,3,0,0,2,2,-4,4,0,0,0,0,0,0,0,0,-3,-4,0,-2,2,-4,0,-2,0,-1,-1,-1,0,-1
KR_6739784767,420,-1,-19,16,-5,1,1,2,-1,6,5,-1,3,2,-3,5,2,-1,1,0,0,-10,288,-4,-2,6,-1,0,0,-1,-1,0,-1,3,-1
KR_6723576470,420,-2,41,15,-3,1,1,2,-1,1,0,3,1,4,-6,9,3,0,2,2,1,-5,-25,-1,0,1,1,0,-1,-1,1,-1,1,2,-1
KR_6763028360,420,1,-1,-36,4,-4,7,3,2,2,4,5,2,7,0,5,5,1,0,1,-1,6,4,-1,0,1,-3,0,-1,-1,-1,-1,-1,3,-1
KR_6735907808,420,-3,-89,4,-10,-2,3,1,-2,3,1,-3,6,3,-5,6,1,2,0,2,0,-13,-9,-4,-2,6,-1,0,-2,-1,1,-1,-1,3,-1
KR_6623170092,440,-5,18,-6,-5,0,2,2,1,4,5,-3,5,2,0,0,0,-3,4,1,2,2,-142,2,-3,1,0,0,0,-1,1,-1,1,4,-1
KR_6713168512,420,-3,-21,-32,-12,3,2,5,-5,6,1,-4,4,0,-3,3,0,-3,4,1,0,-16,251,-7,-2,9,-2,0,1,-1,-1,1,-1,2,-1
KR_6609090079,420,-2,-46,-1,-6,-2,3,1,-2,4,2,1,6,7,0,3,3,-3,3,0,0,-3,-29,0,-4,4,2,0,0,0,0,0,-1,0,-1
KR_6730111107,420,-2,-28,-12,-8,1,1,2,0,1,1,-3,5,2,-5,6,1,-1,1,0,0,-9,-10,-2,-2,4,2,0,-2,-1,-1,-1,-1,3,-1
KR_6758354567,440,1,-41,4,-2,0,3,3,-2,6,4,1,1,2,-3,5,2,2,0,2,0,-7,47,1,-1,0,-19,0,0,-1,1,0,-1,4,-1
KR_6705782753,420,-4,-75,0,-3,2,1,3,-1,3,2,-6,8,2,1,1,2,1,1,2,0,-4,-3,-2,-1,3,1,0,-1,-1,-1,-1,-1,1,-1
KR_6617591533,440,-2,-62,4,-3,0,1,1,0,1,1,0,1,1,0,0,0,-3,3,0,0,-6,-21,-2,-2,4,5,0,-1,-1,1,-1,-1,5,-1
KR_6628389875,420,-4,-83,-14,-6,0,0,0,-1,8,7,-3,7,4,-1,4,3,-1,1,0,0,-3,-55,0,-3,3,16,0,-3,-1,-1,-1,-1,4,-1
KR_6731767694,420,-2,-91,-12,-12,-1,3,2,0,2,2,-3,5,2,-7,7,0,-1,2,1,0,-5,6,4,-8,4,-1,0,-1,-1,0,-1,-1,2,-1
KR_6711380812,420,-1,43,2,-8,-1,2,1,-2,3,1,-4,5,1,2,2,4,-3,6,3,-2,-6,41,-1,-3,4,-35,0,0,-1,-1,0,-1,1,-1
KR_6619975900,440,-9,-187,-46,-15,-3,4,1,-3,8,5,-6,6,0,-3,4,1,0,1,1,0,-8,-131,-4,-1,5,-1,0,-2,-1,-1,-1,-1,2,-1
KR_6700748824,420,-3,-20,2,-2,-2,4,2,3,1,4,-4,5,1,2,0,2,-1,3,2,0,4,-90,-3,-3,6,-3,0,0,1,-1,-1,-1,5,-1
KR_6752872099,420,1,-28,-32,-3,-1,2,1,2,1,3,-3,7,4,0,3,3,-1,1,0,-1,3,58,-2,-3,5,-37,0,0,1,-1,0,-1,2,-1
KR_6639931840,420,-3,-84,16,3,0,2,2,2,1,3,3,0,3,-2,3,1,0,0,0,1,3,-6,2,-5,3,-2,0,-1,0,0,-1,1,0,-1
KR_6747208794,420,-1,24,8,-4,-3,5,2,-2,4,2,0,3,3,1,1,2,0,0,0,0,-7,20,-3,-5,8,0,0,-1,1,-1,-1,1,6,-1
KR_6528664671,420,0,67,-4,0,0,0,0,-1,3,2,-3,4,1,3,1,4,1,1,2,0,1,-6,-7,0,7,2,0,2,1,1,1,1,1,-1
KR_6740157278,420,-5,-21,-8,-12,-2,2,0,1,2,3,0,4,4,-10,12,2,-1,1,0,0,-14,6,-1,-6,7,-3,0,-1,1,-1,-1,-1,2,-1
KR_6728779552,440,0,-15,18,-4,3,1,4,-1,3,2,-4,6,2,0,3,3,-2,2,0,0,-6,-15,2,-2,0,1,0,0,1,0,0,-1,5,-1
KR_6649141647,420,0,0,-12,5,-2,2,0,-2,6,4,1,1,2,7,2,9,1,2,3,0,3,26,1,-4,3,-24,0,-1,1,-1,-1,1,3,-1
KR_6756614105,420,-1,18,-16,-7,4,1,5,-3,3,0,-3,4,1,-4,4,0,-1,1,0,-1,-3,1,-2,-1,3,-3,0,-1,1,-1,-1,-1,4,-1
KR_6649001410,420,-4,28,-68,-8,0,3,3,-3,4,1,4,1,5,-7,8,1,-2,3,1,0,-8,-9,1,-4,3,-2,0,0,-1,-1,-1,-1,4,-1
KR_6750306351,420,1,39,4,5,0,2,2,1,3,4,-1,3,2,3,1,4,2,0,2,0,3,0,1,-4,3,0,0,0,-1,1,1,1,3,-1
KR_6748374589,420,-2,36,-1,-15,-1,4,3,-3,3,0,-4,4,0,-6,7,1,-1,3,2,-1,-18,-4,-4,-3,7,-2,0,-1,-1,-1,-1,-1,4,-1
KR_6752337073,420,-3,-102,-24,-4,-3,3,0,3,1,4,2,1,3,-1,3,2,-5,6,1,0,0,-127,0,-2,2,-3,0,-1,-1,-1,-1,1,2,-1
KR_6738008781,420,-4,-5,-52,-4,-4,5,1,-4,4,0,-2,5,3,5,0,5,1,1,2,0,-1,-6,-8,-2,10,1,0,-2,-1,-1,-1,-1,6,-1
KR_6596430905,420,-3,-45,-23,-10,0,0,0,-8,8,0,-1,4,3,-1,5,4,0,0,0,0,-7,2,-5,-3,8,-2,0,0,1,-1,0,-1,1,-1
KR_6740884902,420,1,-26,7,0,3,0,3,0,2,2,5,1,6,-7,10,3,-1,1,0,0,-8,-2,1,-4,3,0,0,-1,-1,1,-1,1,5,-1
KR_6622535672,420,-4,-23,-12,-14,-2,4,2,-2,3,1,-2,3,1,-6,6,0,-2,2,0,0,-10,-1,1,-5,4,-2,0,-2,1,1,-1,-1,2,-1
KR_6762334258,420,-1,-9,-12,-1,-1,4,3,0,1,1,-2,4,2,0,4,4,2,0,2,0,4,-1,-3,0,3,-2,0,0,-1,-1,0,-1,3,-1
KR_6760002282,420,-1,-9,29,-4,0,1,1,-2,2,0,-2,4,2,0,2,2,0,2,2,0,-7,71,-2,-3,5,18,0,-1,0,0,-1,-1,0,-1
KR_6762875756,420,-3,-91,-4,-14,-7,7,0,-4,4,0,-1,7,6,-2,3,1,0,0,0,0,-18,324,-1,-5,6,-3,0,-2,1,-1,-1,-1,4,-1
KR_6662643952,420,5,-24,66,2,1,1,2,0,1,1,7,1,8,-7,7,0,1,0,1,0,-1,0,0,-3,3,-1,0,-1,1,0,-1,-1,5,-1
KR_6620805659,420,-3,-22,-16,-5,2,0,2,-4,6,2,3,1,4,-6,6,0,0,1,1,0,-12,-1,0,-3,3,3,0,-1,-1,-1,-1,1,6,-1
KR_6758234861,420,-2,46,-53,-7,1,1,2,-1,3,2,-3,3,0,-7,7,0,3,1,4,0,-6,8,4,-4,0,-3,0,0,0,0,0,1,0,-1
KR_6711916697,420,-2,-3,-19,-4,-1,3,2,2,1,3,-4,6,2,0,2,2,-1,2,1,-1,-3,-52,0,-2,2,0,0,-1,-1,-1,-1,-1,3,-1
KR_6736215208,420,-1,-5,-5,-5,0,3,3,-3,4,1,2,0,2,-3,6,3,-1,1,0,0,-1,1,3,-6,3,-5,0,-1,1,-1,-1,-1,3,-1
KR_6761782275,420,-1,-60,7,2,-3,6,3,4,0,4,-6,7,1,5,1,6,2,0,2,0,9,-1,-3,-3,6,-1,0,-3,1,0,-1,-1,4,-1
KR_6721665397,420,-4,-91,-1,-6,1,1,2,-7,7,0,1,3,4,0,2,2,-1,2,1,0,0,-7,-1,-5,6,-1,0,-2,-1,-1,-1,-1,2,-1
KR_6757585824,420,1,23,27,3,-3,3,0,-2,3,1,0,2,2,8,3,11,0,0,0,0,2,16,4,-6,2,-1,0,2,1,0,1,1,3,-1
KR_6755045150,420,1,1,16,0,-1,3,2,-5,6,1,1,4,5,3,2,5,2,0,2,0,0,3,0,-3,3,4,0,1,1,1,1,1,5,-1
KR_6719913532,440,0,31,23,0,-1,2,1,0,3,3,-1,3,2,2,3,5,0,2,2,-1,-1,-13,-1,-2,3,-4,0,-1,0,-1,-1,-1,0,-1
KR_6754329230,420,-4,-73,-21,-7,4,0,4,-4,4,0,-9,9,0,3,2,5,-1,3,2,0,-6,4,-1,-4,5,-5,0,-1,-1,1,1,-1,3,-1
KR_6729523362,420,-6,-76,-8,-9,1,2,3,-3,3,0,-1,3,2,-6,6,0,0,1,1,0,-13,-3,-4,-2,6,4,0,0,-1,1,0,1,4,-1
KR_6684050873,420,-5,-44,-15,-13,1,1,2,-1,2,1,-9,9,0,0,0,0,-4,4,0,1,-9,19,-4,-2,6,-4,0,-1,-1,-1,-1,1,6,-1
KR_6708834243,420,2,104,-12,2,3,2,5,1,2,3,2,2,4,-2,4,2,-2,2,0,0,-1,2,-3,-1,4,-2,0,1,1,-1,1,-1,1,-1
KR_6462397777,420,-2,42,-24,1,3,1,4,-2,5,3,-1,1,0,-1,1,0,2,1,3,0,-1,20,5,-8,3,0,0,1,0,-1,1,1,0,-1
KR_6670404674,420,-1,-17,-12,0,1,0,1,-1,1,0,0,0,0,-1,1,0,1,0,1,0,-2,3,0,-3,3,-3,0,-1,-1,1,-1,1,2,-1
KR_6759111739,420,2,4,6,-1,0,2,2,-1,1,0,7,5,12,-5,5,0,-2,2,0,1,0,475,2,-3,1,-1,0,1,1,1,1,1,6,-1
KR_6753575319,420,2,16,-9,6,4,1,5,0,2,2,1,1,2,2,3,5,-1,2,1,3,8,0,-1,-4,5,6,0,1,-1,1,1,-1,2,-1
KR_6762917266,420,-4,-36,-64,-4,-4,6,2,1,3,4,0,4,4,-2,5,3,1,1,2,0,2,1,-1,-1,2,0,0,-2,-1,-1,-1,-1,3,-1
KR_6470342610,420,4,26,23,3,1,1,2,1,1,2,0,1,1,1,2,3,0,1,1,0,1,202,0,-6,6,1,0,-1,1,-1,-1,-1,3,-1
KR_6763873206,420,0,-50,-35,-2,-3,3,0,0,1,1,-1,4,3,1,1,2,1,1,2,0,2,-107,-1,-5,6,3,0,-1,0,0,-1,-1,0,-1
KR_6744614217,420,1,-5,-43,9,8,0,8,-4,6,2,1,1,2,3,1,4,1,1,2,1,8,7,0,-2,2,0,0,0,-1,-1,0,1,2,-1
KR_6764169719,420,0,-7,-17,1,0,2,2,0,1,1,-3,4,1,3,0,3,1,0,1,0,5,16,3,-8,5,1,0,-1,-1,1,-1,-1,3,-1
KR_6703560610,420,2,-6,5,3,-4,4,0,2,1,3,5,0,5,0,2,2,0,0,0,0,-2,-9,1,-4,3,6,0,0,0,0,1,1,0,-1
KR_6671583233,440,-4,-43,0,-12,-3,3,0,2,1,3,-8,8,0,-2,3,1,-1,1,0,1,-7,-339,3,-4,1,-3,0,0,-1,1,0,1,4,-1
KR_6665795287,420,1,-26,40,1,2,1,3,2,0,2,-1,1,0,0,4,4,-2,5,3,0,-5,-46,-1,-4,5,22,0,1,0,0,1,1,0,-1
KR_6711784810,420,-4,-17,-54,-16,-2,3,1,-2,5,3,0,3,3,-10,10,0,-2,2,0,0,-16,-4,-2,-5,7,-2,0,0,-1,-1,0,-1,6,-1
KR_6720762566,420,-4,-32,-46,-9,3,0,3,-6,7,1,-4,6,2,-4,4,0,2,0,2,0,-11,23,1,-1,0,3,0,0,-1,1,1,-1,3,-1
KR_6762714196,440,-5,-86,-8,-17,-5,6,1,-1,1,0,-4,7,3,-7,7,0,0,1,1,-2,-21,4,-5,-4,9,-1,0,-3,-1,0,-1,-1,4,-1
KR_6754345443,420,-3,45,1,-6,1,1,2,-7,8,1,-2,3,1,2,0,2,0,0,0,0,-2,-172,0,-5,5,7,0,1,-1,-1,1,-1,5,-1
KR_5824022115,420,-4,-25,7,-5,-1,3,2,6,3,9,-3,5,2,-5,10,5,-2,3,1,0,1,-166,-2,-2,4,-4,0,0,-1,0,-1,-1,4,-1
KR_6636472434,420,-5,-38,7,-10,-1,1,0,-6,7,1,-1,2,1,-2,4,2,0,1,1,0,-11,-4,-2,-2,4,-1,0,0,-1,1,0,-1,5,-1
KR_6698383090,440,-1,-45,8,-3,-3,3,0,-3,5,2,3,2,5,3,4,7,-3,4,1,-1,-9,25,0,-4,4,0,0,1,-1,1,1,-1,2,-1
KR_6617422537,420,-3,-15,-32,-1,1,1,2,-8,8,0,1,3,4,3,2,5,2,2,4,0,-7,48,-5,0,5,-2,0,1,1,1,1,1,5,-1
KR_6756359580,420,-1,-76,12,-2,-2,3,1,-2,6,4,3,0,3,-2,3,1,1,1,2,0,4,-214,2,-4,2,0,0,-1,-1,-1,-1,1,4,-1
KR_6662636638,440,-1,14,-20,-1,-1,1,0,3,0,3,-4,5,1,1,1,2,0,0,0,0,1,11,-2,-4,6,1,0,-1,-1,-1,1,1,1,-1
KR_6761451912,420,1,82,-29,2,2,2,4,2,1,3,-1,4,3,-1,4,3,0,0,0,0,5,-178,3,-4,1,-1,0,0,0,0,1,-1,0,-1
KR_6604887150,420,-3,-55,0,-5,-3,3,0,1,2,3,1,0,1,-3,3,0,-1,1,0,0,-4,-123,3,-4,1,0,0,0,1,1,0,-1,3,-1
KR_6718065947,420,-2,-43,-4,-3,1,1,2,-4,4,0,-1,3,2,3,5,8,-2,3,1,0,-6,-30,1,-2,1,20,0,-1,-1,-1,-1,1,2,-1
KR_6622393373,420,1,32,13,1,3,1,4,-1,2,1,-1,2,1,2,3,5,-2,2,0,1,4,6,1,-4,3,-5,0,0,0,1,0,1,0,-1
KR_6701994965,420,-2,3,-24,-6,-2,3,1,-4,4,0,-5,5,0,4,0,4,1,3,4,0,1,-4,-2,-2,4,0,0,-2,-1,0,-1,-1,4,-1
KR_6749705388,420,-4,-79,-27,-1,-2,5,3,-2,2,0,1,0,1,2,5,7,0,1,1,0,1,-56,2,-8,6,22,0,-2,1,-1,-1,1,3,-1
KR_6669718328,420,-1,13,0,1,1,1,2,0,1,1,-2,2,0,0,2,2,2,0,2,0,-2,1,1,-2,1,0,0,0,-1,1,1,1,1,-1
KR_6694563035,420,-1,26,0,2,0,0,0,6,4,10,-1,2,1,-2,2,0,-1,1,0,0,-4,22,0,-3,3,-3,0,-2,1,-1,-1,-1,5,-1
KR_6746515234,420,-1,-70,-4,-3,-2,3,1,2,2,4,1,2,3,-6,7,1,2,0,2,0,2,10,3,-7,4,-5,0,-1,-1,-1,-1,-1,5,-1
KR_6293413330,440,2,-33,24,0,-1,3,2,1,2,3,1,2,3,0,0,0,-1,1,0,0,4,-1,0,-2,2,0,0,0,1,1,1,-1,5,-1
KR_6666948298,420,1,-42,16,5,-1,2,1,1,2,3,2,1,3,2,0,2,1,0,1,0,7,41,-1,-3,4,-14,0,0,1,1,1,-1,3,-1
KR_6752009636,440,-3,-41,-5,-7,-7,8,1,6,1,7,-3,5,2,-2,5,3,-1,1,0,-1,3,-8,-1,-1,2,-5,0,-1,-1,1,-1,-1,1,-1
KR_6592289293,420,-3,-100,-15,-5,0,3,3,0,2,2,-8,11,3,3,0,3,0,0,0,0,-3,-2,-4,-1,5,-3,0,-1,-1,-1,-1,-1,4,-1
KR_6610928007,420,1,53,23,-2,3,0,3,-5,6,1,0,0,0,1,1,2,-1,2,1,1,2,24,0,-3,3,2,0,0,1,0,1,1,5,-1
KR_6747495153,420,0,-4,-20,3,-1,3,2,-1,5,4,2,2,4,1,3,4,2,0,2,0,7,-131,1,-1,0,0,0,1,1,1,1,1,1,-1
KR_6689281013,420,-2,-37,-26,-11,-2,3,1,-2,4,2,-3,4,1,0,2,2,-4,5,1,-1,-2,7,3,-6,3,2,0,-1,1,-1,-1,-1,6,-1
KR_6649152628,420,-2,-46,-2,-9,-2,2,0,1,0,1,-4,6,2,-1,3,2,-3,4,1,0,-13,5,-1,-2,3,2,0,-1,-1,1,-1,1,5,-1
KR_6760342397,420,1,4,-24,0,5,2,7,0,4,4,-3,3,0,0,1,1,-2,4,2,0,-6,286,3,-4,1,6,0,-1,1,0,-1,1,3,-1
KR_6763219681,420,0,-28,-19,-4,-3,5,2,-2,4,2,-2,4,2,5,1,6,-2,2,0,-1,1,118,2,-3,1,0,0,1,-1,-1,1,-1,5,-1
KR_6761863653,420,-5,-31,-67,-4,-4,4,0,-3,5,2,2,4,6,3,3,6,-2,2,0,0,-8,-6,-7,-1,8,7,0,-1,0,1,-1,-1,0,-1
KR_6693943879,420,-2,-29,0,5,3,2,5,-2,3,1,-1,4,3,3,2,5,2,0,2,-1,-2,-14,-5,-1,6,-1,0,0,-1,1,1,1,5,-1
KR_6743601216,420,-8,-145,-36,-14,-1,1,0,-1,5,4,-5,5,0,0,3,3,-7,7,0,1,-8,-18,1,-4,3,3,0,-2,-1,-1,-1,1,1,-1
KR_6705722777,420,-5,-100,-19,-12,-2,3,1,1,0,1,-10,12,2,-2,3,1,1,0,1,-1,-8,-6,-3,-4,7,1,0,-3,-1,-1,-1,-1,6,-1
KR_6501960127,420,-2,-62,-24,3,1,2,3,0,0,0,-3,5,2,4,1,5,1,1,2,1,6,-32,0,-2,2,3,0,1,1,1,1,1,2,-1
KR_6689755765,420,-1,44,-3,-5,6,1,7,-4,4,0,-1,1,0,-4,4,0,-2,2,0,0,-8,-9,2,-5,3,-3,0,1,0,-1,1,-1,0,-1
KR_6742821188,440,-3,-1,16,-2,-3,3,0,-1,1,0,2,2,4,1,3,4,-1,4,3,0,2,23,2,-4,2,-3,0,0,0,1,0,-1,0,-1
KR_6758218863,420,-2,-54,24,0,-1,2,1,7,1,8,1,0,1,-4,6,2,-3,4,1,1,1,6,0,-3,3,-3,0,-1,1,1,-1,1,6,-1
KR_6745819791,420,-3,-85,-31,-11,-7,7,0,-1,3,2,0,4,4,-2,6,4,-1,1,0,-1,-6,-9,0,-4,4,-3,0,-1,0,-1,-1,-1,0,-1
KR_6682801691,440,-3,-87,10,-10,-2,3,1,-11,14,3,1,2,3,1,1,2,1,1,2,0,1,-10,2,-2,0,-1,0,-2,0,1,-1,-1,0,-1
KR_6760660296,440,-2,24,1,-3,3,0,3,-3,5,2,-5,8,3,0,3,3,2,1,3,0,-10,5,-3,-3,6,3,0,0,-1,0,0,1,2,-1
KR_6758819696,420,5,75,1,10,0,2,2,3,3,6,2,4,6,6,1,7,-1,2,1,0,15,-2,1,-4,3,5,0,1,1,1,1,1,6,-1
KR_6748571713,420,-4,-10,-20,-13,3,0,3,1,2,3,-9,9,0,-8,9,1,0,3,3,-1,-15,287,-4,-2,6,1,0,0,-1,1,-1,-1,4,-1
KR_6723866638,440,2,-62,20,11,5,0,5,2,3,5,2,1,3,2,1,3,0,0,0,0,5,3,0,-1,1,3,0,0,1,0,0,1,2,-1
KR_6756254792,420,-5,-45,-37,-13,-4,5,1,-4,5,1,-4,5,1,1,1,2,-2,3,1,0,-15,272,0,-1,1,-1,0,-1,-1,-1,1,1,3,-1
KR_6180541808,440,-1,117,-8,-10,-2,2,0,-4,7,3,-1,2,1,-1,3,2,-2,2,0,0,-9,-57,-6,-2,8,5,0,1,-1,0,1,-1,4,-1
KR_6753904237,420,-2,-8,-5,0,2,0,2,1,2,3,3,0,3,-5,6,1,-1,1,0,1,-4,-3,2,-6,4,-3,0,0,-1,1,0,1,2,-1
KR_6733240209,420,0,-96,19,2,1,1,2,-1,3,2,4,2,6,1,2,3,-3,4,1,0,0,6,-1,-1,2,-2,0,-2,-1,1,-1,-1,3,-1
KR_6752273560,420,-5,10,-47,-15,-1,2,1,-9,13,4,0,4,4,2,1,3,-7,7,0,-1,-12,-28,-4,0,4,6,0,-1,0,0,-1,-1,0,-1
KR_6750224855,440,-3,-58,-6,-13,1,3,4,-4,4,0,-7,11,4,-2,3,1,-1,1,0,0,-10,-8,-3,0,3,1,0,-1,-1,0,-1,-1,1,-1
KR_6677225966,420,-1,-36,-23,-2,5,0,5,-2,3,1,-6,6,0,0,4,4,1,1,2,0,-6,-21,2,-7,5,0,0,-1,-1,0,-1,1,5,-1
KR_6727093248,420,-2,15,-12,-5,0,1,1,-4,5,1,1,1,2,0,3,3,-2,3,1,0,-5,-18,-1,-5,6,-4,0,-1,-1,0,-1,-1,1,-1
KR_6700842954,420,0,11,-13,5,4,0,4,-1,4,3,3,2,5,-2,5,3,1,2,3,0,14,-4,2,-5,3,-1,0,1,1,-1,1,-1,5,-1
KR_6757624057,420,-7,-89,-48,-15,-1,2,1,2,1,3,-10,14,4,-4,5,1,-2,2,0,-1,2,-11,0,-4,4,-1,0,-2,-1,-1,-1,-1,5,-1
KR_6731145479,420,0,41,-14,2,3,0,3,-1,3,2,0,4,4,0,4,4,0,0,0,-1,-3,4,0,-4,4,0,0,2,-1,1,1,-1,2,-1
KR_6629901466,440,-4,-85,-30,-2,-2,2,0,5,2,7,2,0,2,-6,6,0,-1,1,0,-1,2,19,-4,0,4,-19,0,-3,0,1,-1,-1,0,-1
KR_6727434411,420,-2,7,-7,-3,-2,6,4,-2,3,1,4,2,6,-4,5,1,1,2,3,0,-4,7,-1,-3,4,-1,0,0,0,0,0,-1,0,-1
KR_6716087405,420,-3,30,36,-6,-1,2,1,0,1,1,0,1,1,-4,4,0,-1,1,0,0,-8,4,1,-3,2,-6,0,-1,1,0,1,-1,1,-1
KR_6636278571,440,2,13,-25,5,2,0,2,1,3,4,1,0,1,4,0,4,-3,5,2,0,8,0,-3,-4,7,-1,0,1,-1,0,1,1,2,-1
KR_6753266508,420,1,18,31,-2,2,1,3,-1,3,2,-3,5,2,0,0,0,0,0,0,0,1,14,-3,-1,4,0,0,0,0,1,0,-1,0,-1
KR_6724205055,420,0,-24,22,2,0,1,1,8,1,9,-1,4,3,-5,8,3,0,0,0,0,4,5,4,-6,2,-2,0,-2,-1,-1,-1,-1,1,-1
KR_6630530780,420,-2,-69,-8,-1,-2,3,1,0,1,1,0,3,3,0,1,1,1,0,1,0,-2,-62,-1,-5,6,28,0,-2,0,-1,-1,-1,0,-1
KR_6203037217,420,-1,-53,-18,-1,0,4,4,4,2,6,-3,4,1,0,2,2,-2,2,0,0,3,3,3,-3,0,-1,0,1,1,1,1,-1,3,-1
KR_6756041321,420,0,43,0,-2,-2,4,2,-4,4,0,0,1,1,4,1,5,0,0,0,0,0,-316,2,-5,3,-3,0,0,-1,-1,0,1,1,-1
KR_6741519436,420,0,19,-13,-1,-3,5,2,0,1,1,-3,4,1,3,0,3,2,0,2,0,-3,-11,1,-3,2,1,0,-1,1,-1,-1,1,3,-1
KR_6675942324,420,0,32,-12,1,0,1,1,-5,8,3,8,0,8,0,3,3,-2,3,1,1,-6,-6,-1,-4,5,2,0,1,1,0,1,-1,2,-1
KR_6399774907,420,-3,-102,16,-13,-2,2,0,-3,7,4,-4,5,1,-3,4,1,-1,2,1,0,-2,-307,-3,-2,5,-2,0,-2,-1,1,-1,-1,5,-1
KR_6723759501,440,-3,-80,-13,-1,-4,4,0,0,2,2,0,1,1,2,2,4,1,0,1,0,3,6,2,-4,2,-1,0,0,1,-1,0,1,3,-1
KR_6748582372,420,0,-66,4,-3,2,0,2,-1,2,1,0,3,3,-2,6,4,-2,2,0,0,3,-9,2,-3,1,-4,0,-2,1,0,-1,1,2,-1
KR_6697904863,420,-3,-5,-12,-6,2,0,2,2,2,4,-2,4,2,-6,6,0,-2,2,0,0,-6,25,-2,0,2,0,0,-1,-1,-1,-1,-1,6,-1
KR_6760219009,420,-2,24,-12,-11,1,1,2,-3,5,2,-2,4,2,-6,7,1,-1,1,0,1,-17,101,2,-5,3,-1,0,0,0,0,1,1,0,-1
KR_6714710915,420,1,61,12,-4,-4,4,0,-2,5,3,3,1,4,0,1,1,-1,3,2,0,-7,-242,-2,-3,5,1,0,-1,1,-1,-1,1,6,-1
KR_6763996461,420,1,-3,27,-4,-8,9,1,4,0,4,2,2,4,-3,5,2,1,0,1,-1,3,4,-4,0,4,0,0,-1,0,0,-1,-1,0,-1
KR_6756895406,420,0,51,0,-2,3,0,3,-2,4,2,1,0,1,-2,2,0,-2,2,0,0,-9,2,-1,-4,5,7,0,0,1,1,0,-1,6,-1
KR_6747233612,420,0,49,-16,-9,-1,2,1,-3,4,1,1,1,2,-4,5,1,-2,2,0,0,-12,-2,-5,-3,8,-2,0,0,-1,0,-1,1,1,-1
KR_6755555379,420,-2,-38,28,-3,1,1,2,-1,2,1,0,2,2,-5,10,5,2,2,4,0,-8,-5,2,-7,5,2,0,-2,0,1,-1,1,0,-1
KR_6712156225,420,1,-69,20,-1,0,0,0,-1,2,1,3,1,4,-3,4,1,0,2,2,0,-4,-57,1,-4,3,-2,0,0,1,1,-1,-1,3,-1
KR_6700513415,420,1,39,-8,1,3,1,4,-3,3,0,0,2,2,3,3,6,-2,4,2,0,-10,302,-4,-2,6,4,0,0,1,1,1,1,6,-1
KR_6656955980,420,2,-30,20,5,6,0,6,2,0,2,-3,5,2,0,0,0,0,1,1,0,4,14,-1,-2,3,1,0,-1,-1,-1,-1,-1,2,-1
KR_6683495145,420,-2,-61,28,-5,-1,3,2,1,2,3,2,3,5,-7,9,2,0,5,5,1,-8,9,0,-2,2,-1,0,0,-1,-1,-1,1,2,-1
KR_6748934695,440,-1,-41,10,3,-1,4,3,-3,6,3,1,3,4,4,3,7,2,0,2,0,10,-4,-5,-4,9,7,0,0,-1,0,-1,-1,4,-1
KR_6756339374,420,-3,-53,19,-18,1,0,1,-1,3,2,-6,6,0,-12,12,0,0,3,3,0,-19,2,0,-3,3,0,0,-3,1,-1,-1,-1,4,-1
KR_6761835870,440,-1,-15,-9,-3,2,0,2,0,2,2,-5,5,0,-2,5,3,2,0,2,0,-4,-6,-1,-6,7,1,0,1,0,0,1,-1,0,-1
KR_6729891554,420,-5,-19,-20,-7,-4,4,0,-2,2,0,0,0,0,0,2,2,-1,2,1,0,-6,5,1,-6,5,5,0,1,1,-1,1,-1,3,-1
KR_6729944483,420,-2,-7,4,-8,-1,3,2,-3,4,1,-1,2,1,-3,4,1,0,0,0,-1,-13,-1,3,-7,4,-4,0,0,-1,1,-1,-1,3,-1
KR_6749419763,420,-8,-131,-58,-16,2,0,2,-5,7,2,-2,2,0,-8,10,2,-3,4,1,0,-11,0,3,-4,1,-5,0,-3,-1,0,-1,-1,6,-1
KR_6732965723,420,-3,-98,-22,-2,-6,6,0,3,3,6,0,1,1,0,1,1,1,0,1,0,-1,116,1,-3,2,0,0,-2,1,1,-1,-1,2,-1
KR_6642520777,420,1,42,32,2,-2,2,0,3,0,3,1,1,2,1,2,3,-1,1,0,0,4,-9,-3,-1,4,1,0,0,-1,0,0,1,4,-1
KR_6715668151,440,-3,-33,-52,-10,0,1,1,-1,2,1,-2,3,1,-8,9,1,1,1,2,0,-12,-2,-5,-4,9,-3,0,-1,1,-1,-1,1,4,-1
KR_6719190904,420,-4,-62,-10,-6,-2,2,0,-5,10,5,-1,4,3,2,4,6,0,0,0,0,0,241,0,-3,3,3,0,-1,-1,1,1,1,6,-1
KR_6693417933,440,-2,38,-4,-7,-2,6,4,-4,4,0,-1,3,2,-2,5,3,2,0,2,0,-10,-7,0,-1,1,-2,0,1,-1,0,1,1,6,-1
KR_6764712050,420,-2,-46,-44,-10,-4,5,1,3,2,5,-6,6,0,-3,5,2,0,0,0,0,-5,94,-3,-2,5,-1,0,0,-1,0,0,-1,2,-1
KR_6761380799,420,-2,-38,-17,-1,3,0,3,-2,3,1,-2,4,2,2,1,3,-2,4,2,0,2,3,2,-6,4,-1,0,-1,-1,-1,-1,-1,4,-1
KR_6764656455,420,-2,-22,-12,-13,0,3,3,-3,4,1,-1,1,0,-5,7,2,-4,4,0,0,-10,-4,2,-4,2,0,0,-1,0,-1,-1,-1,0,-1
KR_6593841486,420,-9,-59,-19,-19,-3,3,0,-4,5,1,-8,9,1,1,1,2,-5,6,1,0,-11,-11,-3,-4,7,1,0,-1,-1,0,-1,-1,5,-1
KR_6761766593,420,-6,-70,-20,-7,-3,4,1,0,2,2,-4,9,5,-1,6,5,1,1,2,2,-5,10,1,-5,4,-2,0,-1,1,-1,-1,1,1,-1
KR_6756906301,420,-3,-51,1,-7,2,2,4,-7,9,2,2,1,3,-3,4,1,-1,3,2,0,-7,-9,-1,-3,4,-2,0,-1,-1,1,-1,-1,2,-1
KR_6757704577,420,-3,-78,-9,-1,2,0,2,1,3,4,-2,4,2,-3,6,3,1,1,2,1,10,-112,2,-6,4,-1,0,-1,-1,1,-1,1,2,-1
KR_6713131668,420,0,-31,24,-2,-2,4,2,-3,4,1,3,4,7,0,0,0,0,0,0,0,-5,-12,-2,-6,8,-1,0,-1,0,-1,-1,1,0,-1
KR_6422678657,440,0,-3,15,-2,2,1,3,-2,7,5,4,0,4,-5,9,4,-1,2,1,0,-9,0,0,-2,2,0,0,0,1,0,0,1,3,-1
KR_6714963491,420,-2,-41,-8,-5,0,2,2,-1,5,4,-1,3,2,-1,4,3,-2,3,1,0,-3,-148,3,-5,2,-9,0,0,1,1,0,1,6,-1
KR_6685894783,420,2,58,-6,0,2,2,4,-6,6,0,4,1,5,-3,4,1,3,1,4,-1,-6,11,2,-5,3,-1,0,0,-1,1,0,-1,6,-1
KR_6528951423,420,-3,-83,-24,-7,-5,6,1,3,3,6,-5,6,1,-3,3,0,3,0,3,0,5,-1,1,-4,3,4,0,-1,1,-1,-1,-1,3,-1
KR_6741768533,420,-2,-46,-24,-2,2,1,3,0,2,2,-4,4,0,0,1,1,0,0,0,0,3,-17,-1,0,1,-1,0,-1,1,-1,-1,-1,4,-1
KR_6743281246,420,0,-35,-4,-3,-1,1,0,-5,7,2,5,0,5,-1,1,0,-1,1,0,0,-5,19,-5,-3,8,-5,0,1,1,-1,1,-1,2,-1
KR_6741540809,420,-2,-17,0,-5,-2,3,1,-3,3,0,1,1,2,-1,5,4,0,1,1,0,-4,-116,2,-4,2,-1,0,-1,-1,-1,-1,-1,4,-1
KR_5858345231,420,0,76,9,-8,5,1,6,-14,15,1,1,1,2,0,2,2,0,2,2,0,-6,8,-1,-2,3,-2,0,2,-1,0,1,1,5,-1
KR_6585418894,420,1,20,0,1,5,0,5,-4,6,2,-3,3,0,2,5,7,1,0,1,0,-7,-2,-5,-1,6,1,0,1,-1,1,1,-1,3,-1
KR_6537798583,440,-2,-48,-26,-2,-2,4,2,-2,5,3,5,1,6,-1,3,2,-2,2,0,0,-1,-3,-1,-2,3,2,0,-3,0,-1,-1,1,0,-1
KR_6616551159,420,-2,-51,-40,-11,-2,2,0,1,1,2,1,0,1,-9,9,0,-2,3,1,0,-15,-22,0,-4,4,-5,0,-2,-1,-1,-1,-1,3,-1
KR_6622765970,420,-3,14,-15,-9,-1,3,2,0,0,0,2,1,3,-3,5,2,-7,8,1,-1,-17,-2,-4,-1,5,3,0,-1,1,-1,-1,-1,3,-1
KR_6744758744,420,-3,-115,4,-10,-4,4,0,1,4,5,-3,5,2,-3,5,2,-1,1,0,-1,-6,-25,-1,-4,5,1,0,-3,-1,-1,-1,-1,3,-1
KR_6699793688,420,0,-3,-16,-1,1,0,1,-2,4,2,0,1,1,1,2,3,-1,2,1,0,-4,-2,4,-8,4,3,0,0,1,-1,0,1,3,-1
KR_6639645535,420,-3,-71,-20,-5,1,1,2,0,2,2,-4,6,2,-1,2,1,-1,2,1,-1,-5,10,7,-8,1,-4,0,-2,-1,-1,-1,-1,2,-1
KR_6685211704,420,1,134,4,-1,2,0,2,-7,8,1,3,3,6,3,2,5,-2,3,1,1,-10,0,2,-3,1,-1,0,0,0,0,1,1,0,-1
KR_6758060302,420,0,3,9,-1,-1,1,0,-3,4,1,3,1,4,0,2,2,0,1,1,0,3,37,0,-3,3,-23,0,1,1,1,1,1,2,-1
KR_6732723637,420,-1,5,8,-1,1,3,4,-1,3,2,2,2,4,-3,7,4,0,1,1,0,-5,-3,0,-4,4,-1,0,-2,-1,1,-1,-1,5,-1
KR_6750268576,420,1,-71,12,-3,1,0,1,5,2,7,-7,7,0,-1,2,1,-1,1,0,0,2,1,-1,-2,3,-2,0,0,1,0,0,1,3,-1
KR_6762430422,420,-2,-55,-35,-12,-4,6,2,-2,2,0,1,0,1,-2,3,1,-5,5,0,-1,-10,0,-3,0,3,-2,0,-1,-1,-1,-1,-1,5,-1
KR_6759703012,420,-12,-171,-41,-18,-8,9,1,-3,3,0,-5,5,0,-2,2,0,0,1,1,-1,-8,0,-1,-4,5,-2,0,-3,-1,-1,-1,-1,2,-1
KR_6693208535,420,-7,-50,-24,-13,-10,11,1,2,1,3,-2,5,3,0,2,2,-3,3,0,0,1,0,2,-3,1,2,0,-2,-1,1,-1,-1,3,-1
KR_6764490750,420,-4,-73,-20,-6,1,0,1,1,2,3,-3,3,0,-5,5,0,0,2,2,0,-6,-4,1,-5,4,-3,0,-2,1,-1,-1,-1,3,-1
KR_6754194027,420,-7,-37,-13,-8,-4,4,0,-4,6,2,-2,2,0,2,3,5,0,2,2,0,-7,4,2,-5,3,-2,0,-1,0,-1,-1,-1,0,-1
KR_6730421089,440,-1,-27,-12,1,-1,2,1,-1,1,0,0,2,2,6,1,7,-3,3,0,0,0,350,-1,-4,5,4,0,0,1,-1,0,1,6,-1
KR_6752984938,440,0,13,24,-7,-4,4,0,0,0,0,-1,2,1,1,2,3,-3,7,4,0,-6,10,-2,0,2,0,0,1,-1,1,1,-1,4,-1
KR_6728487524,420,-1,-126,16,-9,-1,2,1,-3,3,0,-1,1,0,-3,4,1,-1,1,0,0,-11,-18,3,-6,3,0,0,-1,-1,-1,-1,-1,3,-1
KR_6519885272,420,-1,25,-3,1,0,2,2,0,2,2,5,1,6,-4,4,0,0,0,0,0,-5,-2,-2,-1,3,2,0,1,1,-1,-1,1,3,-1
KR_6584688117,420,1,66,-5,5,2,0,2,1,6,7,0,3,3,1,2,3,1,1,2,1,2,312,-2,-2,4,1,0,0,1,-1,0,1,6,-1
KR_6670293228,420,5,10,26,2,-5,5,0,1,0,1,-1,2,1,4,3,7,3,0,3,0,8,-18,-4,-2,6,3,0,0,1,-1,-1,-1,3,-1
KR_6756240760,420,-2,35,-3,-2,0,0,0,-2,3,1,1,4,5,-1,1,0,0,0,0,0,-5,-2,-4,0,4,3,0,0,-1,-1,-1,1,6,-1
KR_6759597285,420,-1,9,-43,-1,-8,9,1,3,0,3,1,1,2,2,2,4,1,1,2,0,4,-3,1,-4,3,4,0,0,0,-1,-1,-1,0,-1
KR_6732442698,420,2,2,16,2,-1,3,2,2,2,4,3,0,3,-1,3,2,-1,2,1,0,5,-34,1,-3,2,13,0,0,1,1,0,-1,1,-1
KR_6762839587,420,-5,-39,-20,-13,2,0,2,-9,11,2,1,3,4,-5,8,3,-2,4,2,1,-12,10,1,-2,1,0,0,-2,-1,1,-1,1,4,-1
KR_6762693266,420,1,24,20,-2,-2,3,1,-3,3,0,3,2,5,0,0,0,0,1,1,0,-5,105,-6,0,6,0,0,1,1,0,1,-1,1,-1
KR_6752141184,440,0,-55,-24,-1,-1,2,1,4,0,4,0,1,1,0,3,3,-4,8,4,0,1,0,4,-7,3,-1,0,-2,0,-1,-1,-1,0,-1
KR_6662732397,420,-3,-16,-23,2,-1,2,1,-4,7,3,0,0,0,3,4,7,4,0,4,0,4,-15,-2,-2,4,-1,0,1,1,0,1,1,4,-1
KR_6742735238,420,-4,-61,-8,-16,1,1,2,0,1,1,-9,10,1,-9,10,1,1,1,2,0,-14,-14,-3,0,3,6,0,-1,1,-1,-1,-1,3,-1
KR_6759746301,440,1,33,17,0,4,0,4,-1,3,2,4,0,4,-7,9,2,0,2,2,0,-11,-23,0,-4,4,-1,0,0,0,1,1,-1,0,-1
KR_6691437672,420,-3,-46,-8,-9,0,1,1,-6,7,1,-4,5,1,-1,1,0,2,0,2,0,-4,-8,-4,0,4,0,0,0,1,-1,-1,-1,5,-1
KR_6714747764,420,-6,-67,5,-17,-6,6,0,-3,4,1,-5,7,2,-3,3,0,0,2,2,-1,-8,7,-1,0,1,-3,0,-3,1,-1,-1,-1,3,-1
KR_6763633618,420,-8,-147,-21,-18,-1,2,1,-3,5,2,-3,4,1,-8,8,0,-3,6,3,0,-9,-7,-4,-4,8,-6,0,-1,-1,-1,-1,-1,3,-1
KR_6723756890,440,2,-4,-4,0,3,0,3,0,4,4,1,0,1,0,1,1,-4,4,0,0,-3,-11,0,-1,1,0,0,0,1,1,0,-1,2,-1
KR_6760782523,440,2,30,13,3,2,1,3,-3,3,0,0,0,0,6,0,6,-2,3,1,0,3,-4,1,-1,0,1,0,0,1,0,0,-1,6,-1
KR_6667317702,420,-5,-81,-36,-11,-8,8,0,0,3,3,1,0,1,-4,5,1,0,0,0,0,-8,-7,-2,-3,5,0,0,-2,-1,1,-1,-1,3,-1
KR_6763599393,420,-2,-23,-16,-2,3,0,3,-2,2,0,-2,4,2,-2,3,1,1,0,1,0,0,10,-2,-4,6,0,0,-1,-1,1,-1,1,3,-1
KR_6544053996,420,0,111,-13,-3,-1,3,2,-4,8,4,-2,4,2,7,1,8,-3,3,0,0,-1,5,5,-8,3,0,0,1,-1,1,1,-1,1,-1
KR_6638341805,420,-5,-55,-13,-12,0,1,1,0,2,2,-3,3,0,-9,9,0,0,0,0,0,-9,0,0,-4,4,-6,0,-1,-1,-1,-1,-1,4,-1
KR_6708705448,420,-4,-31,-52,-7,-6,8,2,-3,4,1,4,1,5,-2,4,2,0,1,1,0,-7,-5,4,-5,1,-3,0,-1,-1,-1,-1,-1,2,-1
KR_6760629630,420,-1,-66,23,-1,-4,4,0,2,3,5,2,2,4,-3,3,0,2,0,2,0,-6,-4,-1,-2,3,-1,0,0,-1,1,-1,-1,3,-1
KR_6674436467,420,-3,-49,-8,-11,-2,2,0,-4,4,0,-7,9,2,2,1,3,0,0,0,0,-4,-5,-6,-1,7,-1,0,-1,-1,0,-1,-1,1,-1
KR_6747968581,420,2,-12,12,10,1,0,1,5,1,6,1,2,3,1,4,5,2,0,2,3,14,-1,-1,-4,5,0,0,1,1,1,1,1,6,-1
KR_6627903764,420,3,68,20,6,2,1,3,1,3,4,-1,3,2,2,5,7,2,2,4,0,-3,-6,-2,-2,4,-1,0,1,1,1,1,1,5,-1
KR_6764274367,420,-2,64,28,-3,-1,3,2,2,1,3,0,2,2,2,1,3,-6,6,0,0,-7,3,-4,-1,5,-5,0,2,1,0,1,1,3,-1
KR_6748667327,420,0,-2,-7,-1,0,1,1,-7,9,2,2,2,4,5,2,7,-1,1,0,2,-10,-7,2,-4,2,4,0,0,0,1,0,1,0,-1
KR_6641546706,420,-3,-77,-5,-4,-1,2,1,1,2,3,1,1,2,-5,5,0,0,0,0,0,0,-285,1,-5,4,0,0,-1,-1,-1,-1,-1,2,-1
KR_6759063951,440,6,60,-16,5,7,0,7,1,4,5,2,0,2,-4,7,3,-1,1,0,0,0,-8,-2,-1,3,2,0,0,-1,1,1,-1,5,-1
KR_6761830746,420,-4,-55,-26,-6,0,4,4,2,3,5,0,1,1,-6,6,0,-2,2,0,0,-1,-16,-2,-4,6,0,0,-2,1,-1,-1,-1,2,-1
KR_6672614664,420,-2,-7,-30,-10,1,1,2,-2,3,1,-2,4,2,-4,8,4,-3,3,0,0,-3,-134,-2,-1,3,0,0,-1,-1,-1,-1,-1,1,-1
KR_6743759352,420,-1,-29,0,-9,-4,7,3,1,1,2,0,4,4,-6,7,1,0,0,0,0,-15,322,2,-5,3,2,0,1,-1,1,1,-1,5,-1
KR_6755079862,420,-6,-11,0,-11,-3,3,0,-2,3,1,-1,1,0,-2,4,2,-3,3,0,0,-6,3,7,-9,2,-6,0,-1,1,-1,-1,-1,1,-1
KR_6626175257,420,-5,-112,-19,-13,-1,1,0,-2,3,1,-6,7,1,-4,5,1,0,0,0,0,-10,-7,-1,-4,5,-2,0,0,1,1,0,-1,2,-1
KR_6763539300,420,-1,-38,-8,-2,-1,2,1,-3,3,0,0,5,5,3,4,7,-1,1,0,0,6,-8,-1,-4,5,2,0,0,-1,-1,0,-1,4,-1
KR_6763285091,420,-2,-95,-17,-1,3,2,5,-4,5,1,-1,3,2,0,5,5,1,1,2,0,2,2,0,-3,3,2,0,-1,0,0,-1,-1,0,-1
KR_6695205931,420,-1,-89,-21,0,0,0,0,1,3,4,-2,3,1,2,3,5,-1,1,0,0,0,-14,0,-2,2,-1,0,-1,-1,0,-1,1,5,-1
KR_6700423148,420,-3,-4,-4,-9,-4,6,2,1,2,3,-5,6,1,0,1,1,-1,3,2,0,-4,-3,-3,-2,5,-2,0,1,1,-1,-1,1,5,-1
KR_6628368440,420,-2,-15,24,-6,1,0,1,-1,1,0,-5,5,0,-2,2,0,1,1,2,0,-2,-108,-4,0,4,-1,0,-1,0,0,-1,-1,0,-1
KR_6730136897,420,3,34,-5,2,3,0,3,1,2,3,-6,6,0,4,0,4,0,1,1,0,5,5,1,-3,2,-3,0,0,-1,-1,-1,-1,5,-1
KR_6750045048,440,-1,-20,-15,-4,-3,3,0,2,3,5,0,1,1,-4,4,0,1,1,2,-1,-5,-4,2,-4,2,2,0,0,1,1,1,-1,6,-1
KR_6734342171,420,-5,-27,-16,-5,-1,2,1,-2,3,1,-1,4,3,-1,3,2,0,0,0,2,-3,-3,-2,-3,5,-1,0,1,1,1,1,1,2,-1
KR_6703617634,420,3,49,-8,1,1,2,3,0,6,6,2,2,4,-1,1,0,-1,2,1,0,-4,-16,0,-5,5,0,0,0,-1,1,0,1,3,-1
KR_6527194390,420,-6,-45,-52,-14,-7,7,0,-4,4,0,-4,4,0,-1,1,0,2,1,3,0,-2,-4,-4,-1,5,0,0,-1,-1,-1,-1,-1,1,-1
KR_6763020162,440,1,-37,32,6,-1,2,1,0,1,1,2,0,2,4,3,7,1,0,1,0,7,-170,-2,-1,3,-4,0,1,0,1,1,-1,0,-1
KR_6620430657,420,-2,-48,-4,1,2,1,3,6,1,7,0,3,3,-4,5,1,-3,3,0,1,8,14,1,-5,4,-8,0,-2,1,-1,-1,1,5,-1
KR_6700863561,420,-2,-37,-28,1,-1,3,2,-1,3,2,3,0,3,1,0,1,-1,1,0,0,0,-19,0,-3,3,-2,0,-1,-1,1,-1,1,4,-1
KR_6697186842,440,1,17,4,-3,0,0,0,0,3,3,-7,9,2,3,4,7,1,0,1,0,-11,-3,4,-4,0,-1,0,0,0,1,-1,-1,0,-1
KR_6740562758,440,-4,-157,-34,-4,-1,2,1,3,2,5,-1,1,0,-1,7,6,-4,5,1,0,6,-1,6,-8,2,-3,0,-3,0,0,-1,-1,0,-1
KR_6649163719,420,-4,-122,-32,-11,1,4,5,0,2,2,-4,5,1,-6,7,1,-2,2,0,-2,-20,-8,-6,-2,8,-2,0,-3,-1,-1,-1,-1,5,-1
KR_6759601320,420,-3,-77,-5,-6,-1,3,2,0,4,4,-1,1,0,2,0,2,-6,7,1,0,-5,6,-1,-1,2,4,0,-1,1,-1,-1,1,4,-1
KR_6716628502,420,-1,-53,4,-4,0,2,2,-4,5,1,-3,4,1,0,2,2,3,0,3,0,-3,2,0,-1,1,2,0,0,-1,0,0,-1,6,-1
KR_6764358495,420,-1,26,-68,2,0,2,2,-3,6,3,5,1,6,1,2,3,-1,2,1,0,6,26,2,-3,1,-7,0,0,-1,0,0,1,5,-1
KR_6720377112,420,-1,23,0,-5,-5,5,0,-3,3,0,3,0,3,0,3,3,0,0,0,0,-3,-4,-1,-3,4,-1,0,0,1,0,0,1,3,-1
KR_6750716828,420,-5,-79,17,-13,-7,8,1,0,5,5,0,1,1,-6,7,1,0,2,2,-2,-12,-3,-2,-1,3,-2,0,-1,1,0,-1,-1,5,-1
KR_6619736953,420,-3,-40,-21,-2,2,0,2,-3,5,2,4,0,4,-2,3,1,-3,4,1,1,-7,-6,1,-3,2,1,0,-1,-1,-1,-1,1,5,-1
KR_6698276970,420,-3,5,8,-6,-2,3,1,0,2,2,0,1,1,-2,2,0,-2,2,0,0,-12,-32,2,-6,4,27,0,0,-1,0,0,-1,4,-1
KR_6010927841,420,-2,-29,3,-4,-3,3,0,-1,3,2,-2,4,2,3,1,4,-1,1,0,1,5,300,1,-3,2,-4,0,0,1,0,1,1,5,-1
KR_6530515544,440,3,-69,-4,9,2,2,4,1,3,4,6,2,8,-1,5,4,1,1,2,0,13,29,4,-6,2,0,0,0,-1,0,0,1,1,-1
