matchId,queueId,Diff_LV,Diff_CS,Diff_jglCS,Diff-K,Diff-K-top,K-WIN-top,K-LOSE-top,Diff-K-jug,K-WIN-jug,K-LOSE-jug,Diff-K-mid,K-WIN-mid,K-LOSE-mid,Diff-K-ad,K-WIN-ad,K-LOSE-ad,Diff-K-sup,K-WIN-sup,K-LOSE-sup,invadeKill,Diff-A,Diff_WARDplaced,Diff-ControlWARDplaced,LOSE_controlWARDPlaced,WIN_controlWARDPlaced,Diff_WARDkill,Diff_Inhibitor,Diff_TOWERkill,Diff_FirstDRAGON,Diff_FirstHERALD,Diff_Firsttower,Diff_FirstBLOOD,dragonType,result
KR_6742321943,420,-1,-24,-12,-6,-3,3,0,-2,4,2,-2,4,2,0,1,1,1,3,4,0,-4,-40,-1,-3,4,0,0,0,-1,0,0,-1,5,-1
KR_6749108542,420,-4,-62,-32,-2,-3,5,2,3,0,3,-1,3,2,-1,2,1,0,3,3,0,1,-4,-1,-4,5,-1,0,-1,-1,1,-1,-1,5,-1
KR_6716590751,420,-3,-56,28,-4,-2,2,0,0,2,2,-6,7,1,4,0,4,0,1,1,0,3,8,5,-7,2,0,0,-2,1,-1,-1,-1,6,-1
KR_6623295702,420,0,27,1,6,-2,4,2,7,2,9,2,0,2,3,5,8,-4,6,2,0,6,6,-2,0,2,-4,0,1,-1,1,1,-1,4,-1
KR_6760111659,420,-6,-41,-47,-13,-3,5,2,1,1,2,1,2,3,-11,11,0,-1,1,0,0,-8,2,-1,-3,4,0,0,-1,-1,-1,-1,1,3,-1
KR_6763586613,420,-4,-30,-40,-4,-3,4,1,-1,2,1,5,0,5,-5,6,1,0,2,2,0,-6,1,-1,-1,2,-1,0,-2,0,-1,-1,1,0,-1
KR_6705174182,420,-2,-19,0,3,1,1,2,6,3,9,0,0,0,-4,4,0,0,0,0,0,-4,5,1,-1,0,0,0,0,0,1,0,1,0,-1
KR_6748575715,440,-1,-40,2,0,-3,5,2,-1,4,3,3,1,4,3,4,7,-2,4,2,0,-1,-7,0,-3,3,-3,0,0,-1,1,0,1,5,-1
KR_6655932648,420,-7,-134,-26,-11,0,4,4,1,2,3,-6,6,0,-5,7,2,-1,1,0,-2,-14,-6,-1,-2,3,1,0,-3,-1,-1,-1,-1,4,-1
KR_6682953019,420,8,36,63,5,1,0,1,3,2,5,1,0,1,-1,3,2,1,0,1,0,4,3,-2,-1,3,-1,0,0,0,0,-1,-1,0,-1
KR_6747840801,420,-3,-60,20,2,-2,3,1,-1,3,2,6,1,7,-3,3,0,2,0,2,1,2,-5,-4,-1,5,-6,0,1,-1,1,1,1,1,-1
KR_6728943579,440,-1,5,0,-2,0,4,4,-1,1,0,-1,1,0,2,3,5,-2,2,0,-1,-3,-4,-1,-2,3,-1,0,0,-1,-1,-1,-1,3,-1
KR_6729995964,420,1,-12,-7,6,-4,5,1,-2,4,2,7,1,8,2,3,5,3,1,4,0,7,-49,-1,-2,3,28,0,0,1,-1,1,1,1,-1
KR_6688671217,420,0,-48,-10,-1,1,0,1,-3,4,1,-2,2,0,2,6,8,1,0,1,0,-4,18,-2,-5,7,-1,0,-1,1,-1,-1,1,1,-1
KR_6678927276,420,-3,-15,-7,-8,0,2,2,-2,4,2,-2,5,3,-4,6,2,0,2,2,0,-13,-14,-4,-2,6,-1,0,0,-1,-1,0,1,2,-1
KR_6746131864,440,-2,41,2,-6,-3,6,3,0,1,1,-6,6,0,-1,3,2,4,0,4,-2,-23,-5,-1,0,1,0,0,1,0,0,1,-1,0,-1
KR_6710489510,420,-11,-129,-56,-24,-9,9,0,-2,2,0,-1,4,3,-6,6,0,-6,7,1,0,-15,3,-2,-2,4,-2,0,-2,-1,0,-1,-1,4,-1
KR_6764572079,440,-2,-11,4,-12,-1,2,1,-3,4,1,-1,1,0,1,0,1,-8,9,1,0,-15,-5,0,-4,4,-8,0,-1,-1,0,-1,-1,1,-1
KR_6760193394,420,-4,-91,-34,-1,-6,6,0,5,0,5,-1,5,4,0,1,1,1,1,2,0,3,-115,-3,-3,6,-2,0,-2,-1,-1,-1,-1,6,-1
KR_6762002980,420,-6,-32,-16,-18,1,0,1,-8,8,0,-5,5,0,-2,2,0,-4,6,2,0,-25,3,1,-3,2,-6,0,-1,0,-1,-1,-1,0,-1
KR_6737497095,420,-3,-36,4,-8,-4,4,0,1,1,2,-7,9,2,-1,2,1,3,1,4,1,-9,-39,-2,-5,7,3,0,-1,-1,1,-1,1,6,-1
KR_6762183193,440,-2,24,4,-12,-4,4,0,0,3,3,0,1,1,-4,8,4,-4,4,0,-2,-20,-2,-4,-2,6,1,0,-1,-1,-1,-1,-1,4,-1
KR_6749496523,420,-1,-21,0,-5,-5,5,0,5,0,5,-2,3,1,-4,4,0,1,0,1,0,-10,3,-1,-5,6,-6,0,0,1,0,-1,1,4,-1
KR_6761298972,420,-3,-70,-19,-6,-5,6,1,4,0,4,-4,6,2,-1,1,0,0,0,0,0,-2,2,-1,-2,3,-2,0,0,-1,0,0,-1,2,-1
KR_6759684034,440,-2,-87,9,-9,-7,8,1,-2,3,1,0,2,2,0,0,0,0,1,1,0,-6,64,-3,-3,6,-1,0,0,-1,1,-1,-1,3,-1
KR_6731466280,420,-2,-32,-3,0,-2,2,0,1,3,4,0,2,2,-1,1,0,2,0,2,0,6,-2,-2,-4,6,1,0,-1,1,0,-1,-1,3,-1
KR_6762288025,420,0,-2,-12,4,0,0,0,-1,4,3,-1,4,3,4,0,4,2,0,2,0,4,7,-2,-3,5,3,0,0,-1,-1,0,1,6,-1
KR_6689681750,420,-4,-21,8,-11,-1,1,0,-9,9,0,2,1,3,-1,5,4,-2,2,0,0,-12,-18,-8,-2,10,3,0,0,-1,-1,0,-1,5,-1
KR_6688112317,420,-1,-58,0,4,3,1,4,1,2,3,-3,3,0,3,4,7,0,2,2,0,2,-6,0,-7,7,28,0,-1,-1,1,-1,-1,3,-1
KR_6728672916,440,-2,-8,-4,-4,-3,4,1,-1,2,1,1,3,4,-1,1,0,0,0,0,0,-8,-16,-1,-4,5,-1,0,0,-1,0,0,1,1,-1
KR_6720437061,420,-1,-20,-60,0,-4,4,0,-3,3,0,6,0,6,-3,7,4,4,0,4,-1,-3,0,-1,-4,5,1,0,-1,-1,-1,-1,-1,6,-1
KR_6535398588,420,1,1,-5,2,1,2,3,0,2,2,-3,5,2,3,0,3,1,1,2,0,1,3,-2,-3,5,-5,0,0,1,-1,1,-1,1,-1
KR_6750817286,420,-1,30,-22,-4,-2,4,2,-1,3,2,4,1,5,-5,6,1,0,1,1,-1,-7,2,-1,-5,6,1,0,0,-1,-1,0,-1,3,-1
KR_6749042530,420,1,55,-4,-1,1,2,3,-5,6,1,2,1,3,3,1,4,-2,3,1,1,-6,-8,-3,-3,6,2,0,1,1,-1,-1,1,5,-1
KR_6738864131,420,-3,-14,-4,-6,2,3,5,-5,6,1,-4,5,1,-2,3,1,3,1,4,0,5,109,-2,-6,8,2,0,-2,-1,-1,-1,1,2,-1
KR_6750113136,420,-5,2,-13,-11,-2,4,2,-1,2,1,-1,1,0,-7,7,0,0,3,3,0,-9,3,-1,-1,2,-3,0,0,-1,1,0,-1,6,-1
KR_6733654544,420,-2,-37,1,-8,-1,3,2,-3,3,0,0,0,0,-2,3,1,-2,2,0,0,-12,6,-3,-3,6,-2,0,0,1,-1,0,-1,2,-1
KR_6760849097,420,0,41,-12,-5,7,1,8,1,1,2,-9,9,0,-4,4,0,0,1,1,0,-10,-8,-7,-1,8,2,0,0,-1,-1,1,-1,5,-1
KR_6598124395,420,3,72,20,6,9,0,9,-2,4,2,2,2,4,-5,5,0,2,1,3,2,-4,-110,3,-6,3,0,0,3,-1,1,1,1,1,-1
KR_6752035614,420,-5,-69,-4,-8,0,2,2,-4,6,2,1,3,4,-2,3,1,-3,3,0,0,-7,-10,0,-3,3,-2,0,-2,-1,-1,-1,1,4,-1
KR_6733762850,420,4,18,-4,5,-3,4,1,4,3,7,-1,1,0,2,1,3,3,0,3,0,12,-309,0,-3,3,3,0,0,-1,1,1,1,3,-1
KR_6647909781,420,-3,-43,-4,-2,1,2,3,-1,1,0,-4,5,1,0,2,2,2,0,2,0,2,-456,-1,-2,3,1,0,-2,-1,1,-1,-1,1,-1
KR_6758126695,420,-4,-54,-9,-6,-4,5,1,-1,2,1,0,2,2,0,2,2,-1,2,1,1,-4,-94,-2,-5,7,-2,0,0,-1,1,0,1,1,-1
KR_6718490334,420,3,50,15,7,2,0,2,2,2,4,0,1,1,0,3,3,3,1,4,0,-1,13,2,-6,4,3,0,1,-1,1,1,1,3,-1
KR_6764629523,420,-2,-56,16,-6,1,2,3,0,3,3,-1,1,0,-4,4,0,-2,3,1,0,-9,-1,3,-4,1,-4,0,-1,1,1,-1,1,6,-1
KR_6759144637,420,-5,-70,-25,-7,0,0,0,0,2,2,0,5,5,-7,9,2,0,0,0,0,-6,0,-3,-1,4,0,0,-2,-1,1,-1,-1,6,-1
KR_6743665484,420,-2,10,-44,-6,-2,3,1,-6,6,0,-2,3,1,3,1,4,1,0,1,0,-1,209,1,-3,2,-4,0,-1,-1,-1,-1,1,5,-1
KR_6760442158,420,0,16,-13,2,-2,2,0,4,1,5,-2,4,2,1,2,3,1,3,4,1,15,-19,0,-6,6,6,0,0,1,-1,0,1,5,-1
KR_6674578790,420,2,43,-16,-1,-2,3,1,-2,2,0,3,2,5,-1,3,2,1,0,1,0,-6,-232,-3,-3,6,7,0,1,-1,-1,1,1,1,-1
KR_6760436883,440,-2,-19,-50,0,1,1,2,1,3,4,-2,5,3,-1,5,4,1,1,2,-1,-3,133,2,-5,3,2,0,0,1,-1,-1,-1,4,-1
KR_6684683574,420,-2,-3,-8,-5,0,1,1,-1,2,1,0,1,1,-3,3,0,-1,1,0,0,-6,-27,1,-3,2,12,0,0,-1,1,0,1,2,-1
KR_6726272745,420,-3,-4,-15,-4,2,2,4,-2,3,1,-2,2,0,-1,3,2,-1,2,1,0,-4,2,-1,-1,2,1,0,0,-1,1,0,-1,1,-1
KR_6720788488,420,-1,34,8,-2,-1,3,2,1,1,2,-9,9,0,9,0,9,-2,2,0,0,-3,-19,0,-5,5,0,0,1,-1,-1,1,-1,4,-1
KR_6740936485,420,-3,-24,4,-14,1,1,2,-10,14,4,0,1,1,-1,2,1,-4,4,0,0,-18,-20,-2,-2,4,2,0,0,-1,1,1,-1,3,-1
KR_6720819713,440,-3,-93,-18,-1,-4,4,0,3,4,7,-3,6,3,-1,6,5,4,0,4,-1,8,-4,0,-4,4,-1,0,-1,1,0,1,-1,6,-1
KR_6755551178,420,-2,-31,4,0,0,3,3,2,1,3,-2,4,2,1,1,2,-1,1,0,0,-5,18,5,-8,3,-7,0,-1,1,-1,-1,-1,5,-1
KR_6595630785,420,-4,11,-59,-8,-2,4,2,-4,5,1,-3,4,1,3,1,4,-2,3,1,0,-1,-19,3,-6,3,5,0,-1,-1,-1,-1,1,6,-1
KR_6731429381,420,0,-42,24,-5,-5,5,0,1,3,4,5,1,6,-5,5,0,-1,1,0,0,-3,26,0,-4,4,-2,0,-1,-1,-1,-1,-1,2,-1
KR_6668741054,420,-5,-68,-5,-9,-2,6,4,-1,5,4,-1,2,1,-2,2,0,-3,5,2,0,-8,-8,-3,-5,8,-1,0,-2,-1,1,-1,1,2,-1
KR_6764432198,420,-2,32,-24,1,5,0,5,0,4,4,0,1,1,-2,2,0,-2,2,0,-1,-8,7,-2,-4,6,3,0,-1,-1,1,-1,-1,5,-1
KR_6763583835,420,-1,-24,-11,-5,2,0,2,-4,5,1,-3,6,3,-1,2,1,1,0,1,0,-12,-2,0,-3,3,-2,0,0,1,-1,0,-1,6,-1
KR_6738716217,420,-5,-82,-32,-7,-5,6,1,0,1,1,0,2,2,-3,3,0,1,0,1,1,-1,2,4,-8,4,-6,0,-2,-1,0,-1,1,6,-1
KR_6673830096,420,-1,-62,8,-4,-2,2,0,0,1,1,-1,3,2,0,5,5,-1,1,0,1,1,-99,0,-7,7,-4,0,-1,1,-1,-1,1,3,-1
KR_6608873731,420,1,-32,22,-2,-4,4,0,2,1,3,-2,3,1,0,0,0,2,0,2,0,0,0,2,-3,1,-3,0,0,1,-1,-1,-1,5,-1
KR_6751683130,420,1,0,-6,4,2,1,3,-2,3,1,6,0,6,-3,5,2,1,2,3,1,3,115,0,-4,4,-4,0,0,0,0,1,1,0,-1
KR_6756620431,440,-5,2,-16,-14,2,2,4,-5,9,4,-2,2,0,-2,2,0,-7,7,0,0,-14,-59,2,-3,1,21,0,1,1,-1,1,1,5,-1
KR_6713253051,420,-1,2,-12,-2,-6,6,0,2,2,4,3,4,7,2,3,5,-3,4,1,-2,-9,-11,-2,-1,3,-1,0,1,-1,0,1,-1,6,-1
KR_6750075268,420,0,-25,8,-1,5,0,5,-1,5,4,-5,6,1,0,3,3,0,2,2,0,-2,3,4,-7,3,-3,0,2,-1,1,1,1,3,-1
KR_6754315470,420,1,0,-7,1,-4,4,0,-6,8,2,2,2,4,3,0,3,6,0,6,0,5,-15,-7,0,7,2,0,1,-1,-1,1,-1,6,-1
KR_6681610084,440,-1,-79,-16,-1,-2,3,1,2,1,3,3,0,3,-3,7,4,-1,3,2,0,2,-43,0,-5,5,19,0,-1,1,-1,-1,-1,6,-1
KR_6762557260,420,-2,-83,-12,0,0,0,0,0,2,2,1,0,1,-1,4,3,0,1,1,0,6,64,0,-5,5,2,0,-1,1,-1,-1,1,2,-1
KR_6753682231,420,2,23,-4,0,-1,3,2,5,2,7,3,2,5,-6,8,2,-1,2,1,0,4,-2,1,-3,2,-1,0,-1,0,-1,-1,1,0,-1
KR_6762402135,420,-2,-62,8,-4,0,1,1,0,2,2,-4,4,0,1,0,1,-1,1,0,0,-8,9,-2,-2,4,0,0,0,-1,1,0,1,2,-1
KR_6732079175,420,-7,-142,-28,-9,-4,5,1,-2,3,1,-1,3,2,-1,4,3,-1,1,0,0,-4,17,3,-4,1,-1,0,-2,-1,0,-1,-1,3,-1
KR_6625987990,420,2,57,4,8,2,0,2,-1,5,4,5,1,6,2,2,4,0,1,1,0,0,46,2,-4,2,-16,0,1,0,1,1,1,0,-1
KR_6625388193,420,1,31,5,3,3,0,3,0,4,4,1,2,3,-1,4,3,0,0,0,0,3,17,3,-6,3,0,0,0,0,1,0,1,0,-1
KR_6743079582,420,-1,19,-17,-8,1,3,4,-5,7,2,-7,8,1,5,3,8,-2,4,2,-1,-9,-7,-2,-3,5,-3,0,-1,-1,-1,-1,-1,5,-1
KR_6616450589,420,-4,-75,-40,-2,-3,4,1,2,0,2,-3,5,2,2,0,2,0,1,1,0,3,26,1,-5,4,-2,0,0,-1,1,-1,-1,4,-1
KR_6753162657,420,-3,-36,-8,-5,0,1,1,0,4,4,0,2,2,-5,5,0,0,0,0,0,-8,-64,2,-6,4,-3,0,0,0,0,0,-1,0,-1
KR_6762238955,420,3,-26,-4,3,3,0,3,-2,4,2,2,0,2,-3,3,0,3,1,4,0,-2,345,-3,-3,6,3,0,0,-1,1,1,1,2,-1
KR_6760200221,420,2,7,-16,2,1,1,2,5,2,7,-1,2,1,0,2,2,-3,4,1,0,6,24,-3,-2,5,-2,0,0,1,-1,0,1,5,-1
KR_6760954639,420,-4,5,0,-7,-4,4,0,-1,1,0,-1,3,2,-1,5,4,0,2,2,-1,-2,14,-1,-5,6,-11,0,0,0,1,0,-1,0,-1
KR_6578608222,420,-3,0,-15,-2,-5,5,0,2,3,5,-2,2,0,1,0,1,2,0,2,0,9,19,4,-6,2,0,0,0,1,-1,0,-1,1,-1
KR_6660860221,440,-6,-100,27,-17,-2,2,0,-3,5,2,-4,4,0,-7,7,0,-1,2,1,0,-16,-4,0,-3,3,-1,0,-2,-1,-1,-1,-1,5,-1
KR_6707357385,420,3,40,-32,7,3,3,6,0,4,4,4,1,5,0,4,4,0,2,2,1,-3,4,0,-3,3,1,0,2,1,1,1,-1,3,-1
KR_6761938621,420,-1,-13,-8,-8,-2,3,1,-1,3,2,1,2,3,-5,6,1,-1,1,0,-1,-7,3,4,-7,3,-4,0,-2,-1,-1,-1,-1,5,-1
KR_6704227392,420,0,-21,-8,-2,-2,3,1,-2,3,1,0,2,2,1,2,3,1,1,2,0,-4,-5,1,-4,3,3,0,-2,1,-1,-1,1,2,-1
KR_6715444763,420,-2,26,-46,-3,1,1,2,0,3,3,-1,2,1,-4,6,2,1,0,1,-1,-7,-5,-3,-3,6,4,0,-1,-1,-1,-1,-1,6,-1
KR_6761108282,440,0,14,20,-6,-1,3,2,-4,4,0,-1,2,1,0,1,1,0,2,2,0,-5,36,-4,-1,5,-32,0,0,0,0,0,-1,0,-1
KR_6659693938,420,-2,-4,0,-10,-2,2,0,-3,3,0,1,3,4,-6,6,0,0,1,1,0,-13,-4,-1,-1,2,-2,0,-1,-1,0,-1,-1,5,-1
KR_6758011525,420,-3,11,-15,4,3,1,4,0,2,2,-3,4,1,3,0,3,1,0,1,1,2,152,2,-4,2,3,0,1,1,-1,1,1,1,-1
KR_6714864334,420,-5,-27,-28,-11,-5,5,0,-2,3,1,2,2,4,0,4,4,-6,7,1,0,-6,0,3,-7,4,1,0,-2,0,-1,-1,-1,0,-1
KR_6735230323,440,3,0,36,0,-2,4,2,0,2,2,-1,6,5,1,2,3,2,3,5,-1,-6,-10,0,-5,5,1,0,0,0,1,1,-1,0,-1
KR_6730826571,440,-2,-19,15,-5,-1,1,0,-1,4,3,-7,9,2,5,0,5,-1,1,0,0,4,-3,-4,-5,9,5,0,0,1,-1,-1,1,4,-1
KR_6665978362,420,-4,-76,-2,-7,0,1,1,-2,4,2,-2,2,0,-1,1,0,-2,3,1,0,-9,-102,-2,-4,6,5,0,0,-1,-1,0,-1,3,-1
KR_6734388996,420,0,6,-5,2,-3,5,2,-2,3,1,1,0,1,5,0,5,1,0,1,0,4,-119,6,-7,1,-2,0,0,1,1,1,-1,4,-1
KR_6750084687,420,-3,-17,-10,-6,-4,4,0,1,1,2,0,2,2,-1,4,3,-2,3,1,-1,0,-2,1,-2,1,2,0,1,1,-1,1,-1,5,-1
KR_6596404193,420,-2,-71,-96,0,0,3,3,-1,9,8,1,1,2,1,1,2,-1,1,0,0,8,42,0,-2,2,-23,0,0,-1,0,0,-1,4,-1
KR_6715528858,420,-2,-29,8,-11,-5,6,1,-3,3,0,-6,6,0,4,10,14,-1,1,0,-1,-12,7,1,-3,2,-5,0,0,1,-1,1,-1,3,-1
KR_6708285402,420,-4,-43,-8,-5,6,1,7,-2,3,1,0,1,1,-6,6,0,-3,3,0,0,-11,4,4,-8,4,-5,0,0,-1,1,1,1,6,-1
KR_6744605406,420,-9,-120,-56,-27,-1,2,1,-8,8,0,-10,12,2,-7,7,0,-1,2,1,0,-25,-12,-4,0,4,-2,0,-3,-1,-1,-1,-1,2,-1
KR_6627963834,420,-3,-35,-24,-7,-2,4,2,-2,2,0,-5,8,3,0,1,1,2,0,2,0,-1,-1,-4,-3,7,1,0,0,-1,-1,-1,-1,5,-1
KR_6759299795,420,-3,-97,-8,-4,-7,9,2,-1,2,1,0,1,1,5,3,8,-1,2,1,-2,-1,-6,1,-5,4,-3,0,-2,-1,-1,-1,-1,1,-1
KR_6656521785,420,-4,-22,0,-5,-2,2,0,1,3,4,-1,3,2,-1,5,4,-2,3,1,0,-5,-2,0,-5,5,1,0,0,-1,1,0,-1,1,-1
KR_6760391302,420,3,-60,20,3,1,2,3,-1,1,0,1,1,2,2,0,2,0,0,0,0,2,31,1,-3,2,-7,0,0,0,0,0,1,0,-1
KR_6761008343,420,0,32,3,-5,-1,3,2,-3,5,2,3,2,5,0,3,3,-4,4,0,0,-3,6,3,-7,4,4,0,1,1,-1,1,-1,6,-1
KR_6763192042,420,-2,-3,20,-13,-2,2,0,-1,5,4,-4,4,0,-5,6,1,-1,2,1,-1,-15,15,-2,-5,7,-1,0,1,-1,1,1,-1,2,-1
KR_6685890032,420,0,3,-28,3,-4,6,2,-1,3,2,4,3,7,0,4,4,4,0,4,1,9,-11,0,-7,7,-2,0,0,-1,-1,0,1,1,-1
KR_6670980830,420,-4,-60,15,-8,-4,4,0,0,4,4,-5,6,1,3,2,5,-2,3,1,0,-7,1,-4,-2,6,-7,0,-2,-1,1,1,-1,4,-1
KR_6659331810,420,-5,-34,-24,-6,0,2,2,-1,4,3,-2,3,1,-2,3,1,-1,1,0,0,-4,-112,1,-6,5,1,0,0,-1,-1,0,-1,5,-1
KR_6760788560,420,-3,-27,-11,-4,1,1,2,0,3,3,-6,7,1,1,3,4,0,1,1,0,-11,3,2,-4,2,-3,0,0,-1,-1,-1,1,3,-1
KR_6713232273,420,-5,-51,-13,-13,-8,11,3,-1,2,1,2,2,4,-6,10,4,0,1,1,-1,-10,3,-1,-2,3,0,0,-3,-1,0,-1,-1,6,-1
KR_6744532107,420,2,20,-36,2,-1,1,0,-4,8,4,0,1,1,6,0,6,1,2,3,0,2,-57,2,-7,5,26,0,1,-1,1,1,1,6,-1
KR_6654588048,420,-4,-20,16,-11,1,2,3,-4,4,0,0,1,1,-3,3,0,-5,5,0,-1,-12,-19,-1,-2,3,2,0,-1,-1,-1,-1,-1,1,-1
KR_6650551363,420,-6,-123,-24,-11,-5,5,0,-2,3,1,-1,1,0,-3,4,1,0,0,0,0,-8,-15,-4,0,4,0,0,-1,-1,0,-1,-1,3,-1
KR_6763674903,420,-5,-60,20,-13,-2,5,3,-4,8,4,-5,5,0,0,1,1,-2,3,1,0,-9,-17,-5,-1,6,3,0,-2,-1,-1,-1,-1,2,-1
KR_6624642373,420,-2,-80,4,0,-1,1,0,0,4,4,-1,2,1,1,2,3,1,2,3,0,3,0,3,-7,4,-3,0,-1,1,0,-1,1,1,-1
KR_6632645315,420,-5,7,-44,-11,-7,8,1,-1,3,2,2,1,3,-4,5,1,-1,1,0,0,-11,-5,-7,-1,8,3,0,0,-1,1,-1,-1,6,-1
KR_6592500519,420,-2,-63,-21,-7,-2,3,1,3,0,3,0,1,1,-9,11,2,1,0,1,0,-6,-87,-4,-6,10,1,0,-2,-1,1,-1,-1,4,-1
KR_6757730276,420,0,-42,20,5,5,0,5,2,2,4,-1,1,0,-2,3,1,1,1,2,0,3,0,-2,-2,4,-1,0,0,1,1,0,1,6,-1
KR_6628353132,420,-2,-34,1,-3,3,0,3,4,0,4,-2,4,2,-4,8,4,-4,5,1,-2,-5,-31,-2,-3,5,0,0,0,-1,1,-1,-1,4,-1
KR_6743879413,440,0,1,-25,-4,-4,4,0,-4,5,1,-1,2,1,3,3,6,2,1,3,1,3,6,4,-8,4,0,0,-1,0,1,-1,1,0,-1
KR_6717843184,420,-5,-65,-4,-15,-4,6,2,-3,5,2,-5,5,0,-2,3,1,-1,1,0,-1,-12,-11,-4,-1,5,-3,0,-2,0,1,-1,-1,0,-1
KR_6742432711,420,-5,6,0,-10,1,3,4,-2,5,3,-4,4,0,-4,7,3,-1,3,2,1,0,-6,-3,-1,4,2,0,0,-1,-1,-1,1,4,-1
KR_6701604387,420,3,13,20,3,2,1,3,2,2,4,0,2,2,0,2,2,-1,4,3,0,0,6,3,-6,3,2,0,0,-1,-1,1,1,1,-1
KR_6748805865,420,-5,-42,-48,-6,0,1,1,2,2,4,-5,6,1,-1,4,3,-2,3,1,0,6,1,0,-4,4,0,0,-2,-1,-1,-1,1,3,-1
KR_6738034580,420,0,-21,4,1,1,1,2,3,2,5,-2,3,1,-1,4,3,0,2,2,0,-3,-6,0,-2,2,-2,0,0,-1,0,0,1,6,-1
KR_6725656289,420,-2,38,-36,-1,1,0,1,-1,2,1,4,4,8,-4,5,1,-1,2,1,-4,-8,-2,0,-2,2,-2,0,1,-1,-1,1,-1,2,-1
KR_6760180589,420,-4,-37,-9,-10,0,2,2,-2,3,1,-2,5,3,-7,7,0,1,0,1,0,-11,-7,-1,-3,4,2,0,0,0,-1,0,1,0,-1
KR_6754893458,420,-2,-25,-16,-1,0,5,5,-1,3,2,-5,6,1,6,1,7,-1,2,1,0,3,2,1,-5,4,2,0,0,-1,1,-1,-1,4,-1
KR_6719111174,420,-4,-82,3,-6,2,2,4,0,1,1,0,2,2,-5,6,1,-3,3,0,0,-4,1,5,-7,2,-4,0,1,-1,1,1,1,2,-1
KR_6715320924,420,1,84,-8,4,1,0,1,-2,2,0,1,0,1,5,2,7,-1,1,0,0,9,0,-3,-4,7,3,0,0,-1,1,0,1,4,-1
KR_6498379807,420,2,-54,28,7,-3,3,0,6,3,9,-2,4,2,5,0,5,1,0,1,0,6,-21,1,-7,6,-1,0,0,1,0,-1,1,5,-1
KR_6758145252,420,-2,-47,-7,-9,-3,3,0,-3,5,2,-1,3,2,-2,3,1,0,1,1,0,-4,39,-1,-5,6,-6,0,0,0,1,-1,-1,0,-1
KR_6728825479,420,-3,-31,-9,-1,-3,5,2,0,3,3,2,1,3,0,0,0,0,0,0,0,5,-41,1,-3,2,15,0,-1,-1,1,-1,-1,6,-1
KR_6614758619,420,0,-22,-8,4,2,1,3,-3,4,1,5,0,5,1,2,3,-1,2,1,0,3,-332,3,-7,4,-1,0,1,-1,1,1,1,2,-1
KR_6693695971,440,-4,-76,-15,-6,0,1,1,5,0,5,2,0,2,-7,12,5,-6,7,1,0,-4,9,0,-4,4,-1,0,-3,1,-1,-1,-1,3,-1
KR_6760948430,440,-2,-10,-36,-5,1,2,3,-1,4,3,-8,10,2,1,1,2,2,0,2,1,-6,-22,1,-6,5,3,0,2,0,-1,1,1,0,-1
KR_6692407039,420,-5,-23,-8,-9,-3,3,0,0,5,5,-4,4,0,-2,2,0,0,2,2,0,-4,-5,7,-9,2,-4,0,-2,-1,-1,-1,1,2,-1
KR_6759313185,420,0,-21,-2,-2,-3,3,0,-3,3,0,0,2,2,1,1,2,3,0,3,0,1,-48,-4,-3,7,22,0,0,1,-1,-1,-1,2,-1
KR_6629839397,420,-4,-81,-24,-10,3,1,4,2,1,3,-3,3,0,-5,5,0,-7,7,0,-1,-9,-2,-1,-2,3,1,0,-3,1,-1,-1,-1,1,-1
KR_6647850336,420,-2,-80,6,-7,-5,6,1,1,1,2,5,1,6,-10,10,0,2,1,3,0,-13,5,-2,-5,7,3,0,-1,1,1,-1,-1,4,-1
KR_6740118033,420,-3,-66,25,-7,1,4,5,0,2,2,2,2,4,-9,10,1,-1,1,0,0,-13,-38,1,-3,2,2,0,0,-1,0,-1,-1,3,-1
KR_6709921819,420,-1,-45,8,-2,-2,3,1,4,3,7,-1,2,1,-5,8,3,2,1,3,0,-5,5,-1,-4,5,-1,0,-1,1,-1,-1,1,2,-1
KR_6757520344,420,2,38,-12,1,4,2,6,2,2,4,-5,7,2,1,3,4,-1,3,2,1,-14,3,3,-5,2,-1,0,0,-1,-1,-1,1,3,-1
KR_6461030990,440,1,6,-38,-8,1,1,2,-3,3,0,-6,6,0,4,1,5,-4,4,0,-2,-10,11,-2,-6,8,-8,0,-1,-1,-1,-1,-1,5,-1
KR_6705316115,420,-3,-25,-42,-7,1,0,1,-9,10,1,4,1,5,-1,2,1,-2,3,1,0,-2,-4,-6,-1,7,-4,0,-2,0,-1,-1,1,0,-1
KR_6739907491,420,-2,-22,24,-7,-4,4,0,3,1,4,0,1,1,-8,11,3,2,0,2,0,-5,267,3,-5,2,0,0,-1,-1,1,-1,-1,6,-1
KR_6550974625,420,1,-11,-44,1,3,1,4,-2,4,2,-2,3,1,1,0,1,1,0,1,-1,-4,-31,-2,-3,5,-2,0,-1,-1,-1,-1,-1,4,-1
KR_6540105880,420,2,43,-3,0,2,3,5,0,3,3,0,3,3,-2,4,2,0,1,1,0,4,3,-1,-3,4,4,0,0,1,-1,0,-1,4,-1
KR_6760542452,440,0,34,-8,-3,4,1,5,-3,5,2,-1,3,2,-2,4,2,-1,3,2,0,-2,15,2,-4,2,2,0,0,1,0,1,-1,3,-1
KR_6656109493,420,1,-39,-8,-3,1,0,1,1,4,5,-2,7,5,-3,3,0,0,1,1,0,-1,6,0,-4,4,4,0,-1,0,-1,-1,1,0,-1
KR_6743050263,420,-2,-90,0,-8,-1,1,0,-2,6,4,-4,5,1,-1,5,4,0,2,2,1,-1,1,3,-5,2,-1,0,-1,-1,1,-1,1,5,-1
KR_6655975480,420,2,28,3,3,0,1,1,0,1,1,-1,3,2,1,0,1,3,1,4,1,4,120,2,-9,7,3,0,0,1,1,0,1,4,-1
KR_6749142915,420,-6,-40,-27,-13,2,1,3,-4,4,0,-8,11,3,-2,6,4,-1,1,0,0,-13,2,-1,-2,3,0,0,-1,-1,-1,-1,-1,1,-1
KR_6763476569,440,0,84,7,-1,1,1,2,0,0,0,3,0,3,-3,5,2,-2,2,0,0,-3,2,1,-2,1,0,0,1,0,1,1,1,0,-1
KR_6685675556,420,-6,-61,-49,-17,-1,3,2,-1,3,2,0,3,3,-15,16,1,0,0,0,-1,-23,-10,-2,-4,6,-1,0,-4,-1,-1,-1,-1,2,-1
KR_6658106160,440,-3,-23,-24,-14,0,3,3,-5,11,6,-2,2,0,-2,4,2,-5,6,1,0,-12,-1,0,-3,3,-5,0,-1,-1,-1,-1,-1,1,-1
KR_6741423021,420,-5,31,-16,-17,-2,4,2,-7,7,0,-3,5,2,-2,3,1,-3,4,1,0,-14,36,3,-7,4,-23,0,-1,-1,-1,-1,-1,4,-1
KR_6755554914,420,2,-18,8,4,1,1,2,3,1,4,1,2,3,0,5,5,-1,2,1,-1,5,-7,-1,-5,6,-1,0,0,1,1,0,-1,2,-1
KR_6654975881,420,-3,-51,-28,-4,1,0,1,-5,5,0,2,0,2,-1,4,3,-1,1,0,0,-8,8,5,-11,6,-5,0,-1,-1,0,-1,1,2,-1
KR_6757426328,420,-5,-7,-28,-10,4,2,6,-5,8,3,-7,9,2,0,2,2,-2,3,1,-3,-14,-11,-3,-1,4,0,0,0,1,1,-1,-1,2,-1
KR_6759182394,420,-1,-27,-6,-7,1,2,3,0,3,3,0,2,2,-9,9,0,1,0,1,-2,-10,-16,0,-7,7,2,0,0,-1,1,0,-1,4,-1
KR_6707796739,420,-2,-35,-3,0,-1,2,1,-1,4,3,1,0,1,1,1,2,0,0,0,1,2,-655,2,-8,6,-2,0,0,-1,0,0,1,4,-1
KR_6672992004,420,1,-130,31,-4,-1,1,0,2,1,3,-1,2,1,-3,5,2,-1,1,0,-2,0,-2,-1,-4,5,-5,0,0,1,1,0,-1,3,-1
KR_6711212671,420,-5,-73,-89,-10,0,2,2,-6,6,0,-2,7,5,-3,3,0,1,3,4,0,0,190,-1,-4,5,3,0,-2,-1,-1,-1,-1,6,-1
KR_6755226233,420,-1,-89,12,-5,-2,2,0,-1,5,4,-3,4,1,0,2,2,1,0,1,0,-1,-8,-2,-1,3,1,0,-2,1,1,-1,-1,6,-1
KR_6753260055,440,2,85,7,6,2,2,4,2,1,3,4,2,6,-1,5,4,-1,1,0,0,3,-13,0,-1,1,0,0,0,0,1,1,-1,0,-1
KR_6752527195,420,2,6,-8,4,-5,5,0,6,1,7,1,0,1,4,1,5,-2,2,0,0,2,2,-3,-1,4,-5,0,0,1,-1,1,-1,5,-1
KR_6717407355,440,0,21,40,-2,0,1,1,-5,6,1,5,0,5,-1,5,4,-1,1,0,0,-2,-4,0,-4,4,-4,0,0,-1,-1,0,1,2,-1
KR_6762345990,420,1,33,-4,0,-1,3,2,2,2,4,0,2,2,1,3,4,-2,2,0,0,2,1,-3,-2,5,1,0,0,0,-1,0,-1,0,-1
KR_6732991035,440,-8,-55,1,-17,0,0,0,-2,4,2,-2,3,1,-7,11,4,-6,6,0,0,-23,-62,1,-6,5,2,0,-1,-1,1,-1,-1,6,-1
KR_6689408577,420,-5,21,-43,-6,4,5,9,-6,6,0,-4,4,0,4,2,6,-4,5,1,0,-7,1,0,-5,5,-4,0,-1,-1,0,-1,-1,1,-1
KR_6731658290,440,-2,-84,-5,-12,-1,3,2,0,0,0,0,4,4,-10,11,1,-1,1,0,0,-6,-17,-2,-2,4,2,0,0,-1,0,0,-1,4,-1
KR_6558519620,420,0,-34,-8,-5,1,2,3,0,2,2,-6,7,1,1,1,2,-1,1,0,1,2,-108,0,-2,2,0,0,0,0,-1,0,1,0,-1
KR_6697569778,440,-1,-21,13,-4,2,1,3,-2,2,0,-6,6,0,2,1,3,0,1,1,0,0,-23,-4,-3,7,12,0,0,-1,-1,-1,-1,4,-1
KR_6742180747,420,1,39,-24,4,3,2,5,-2,3,1,3,0,3,-1,3,2,1,2,3,0,3,9,3,-6,3,5,0,0,1,1,1,-1,2,-1
KR_6736832380,440,1,23,-4,-3,1,1,2,-1,1,0,-4,6,2,1,4,5,0,1,1,-1,-1,2,-4,-3,7,1,0,0,-1,1,0,-1,2,-1
KR_6619234934,420,-6,-43,-4,-17,-2,4,2,-6,6,0,-3,5,2,-5,9,4,-1,3,2,0,-21,5,-4,-2,6,3,0,-1,1,-1,-1,-1,1,-1
KR_6567181667,420,-4,0,-20,-8,-3,4,1,-2,4,2,-2,2,0,-2,3,1,1,2,3,1,0,-14,-2,-3,5,1,0,-2,-1,-1,-1,1,4,-1
KR_6729731869,440,-2,35,18,-4,-6,7,1,-1,4,3,2,1,3,-3,4,1,4,1,5,-1,-7,-10,-4,-1,5,3,0,0,-1,-1,1,-1,4,-1
KR_6761350185,440,-6,-108,12,-11,-5,5,0,3,3,6,-1,6,5,-7,8,1,-1,1,0,-2,-4,-12,0,-3,3,-1,0,-1,0,0,-1,-1,0,-1
KR_6760429327,420,0,40,0,2,3,2,5,2,1,3,-3,4,1,1,3,4,-1,1,0,0,-3,-27,-1,-4,5,0,0,1,-1,1,1,1,3,-1
KR_6759415939,420,2,25,31,4,4,0,4,1,0,1,-7,9,2,5,0,5,1,2,3,0,6,6,-1,-3,4,4,0,0,-1,0,0,1,4,-1
KR_6646413725,420,-1,-6,32,-1,-2,4,2,-3,3,0,3,1,4,1,0,1,0,0,0,-1,-4,1,-3,-1,4,-1,0,0,1,0,0,-1,1,-1
KR_6757640354,440,-2,-18,-23,0,1,0,1,2,2,4,-1,1,0,0,1,1,-2,2,0,2,1,-5,2,-6,4,-1,0,-1,1,-1,-1,1,3,-1
KR_6650484062,420,-2,-69,12,5,-3,4,1,2,3,5,0,4,4,6,2,8,0,1,1,1,4,-7,-1,-6,7,5,0,-1,1,-1,-1,1,3,-1
KR_6681583936,420,1,-26,16,0,5,0,5,-2,4,2,-1,2,1,-3,4,1,1,2,3,0,1,-124,-4,-5,9,-2,0,0,1,-1,0,-1,6,-1
KR_6677633772,420,0,-1,8,2,-1,3,2,-3,4,1,2,1,3,1,1,2,3,0,3,0,4,2,-3,-6,9,3,0,-1,-1,-1,-1,1,3,-1
KR_6653673362,420,3,24,2,9,-2,5,3,7,3,10,7,1,8,-2,2,0,-1,1,0,1,8,26,0,-5,5,-2,0,1,1,1,1,1,1,-1
KR_6635782711,420,-3,-103,-1,-9,4,1,5,-5,9,4,-5,6,1,-5,6,1,2,1,3,0,-6,17,0,-4,4,-3,0,-2,-1,-1,-1,1,3,-1
KR_6755017656,420,-3,3,-2,-10,-2,2,0,-2,4,2,-7,9,2,4,3,7,-3,5,2,-2,-9,-10,-2,-6,8,-1,0,0,1,-1,-1,-1,2,-1
KR_6759308860,440,0,29,-12,5,-1,2,1,3,2,5,-1,1,0,3,3,6,1,2,3,0,4,2,-1,-3,4,1,0,1,0,1,1,1,0,-1
KR_6762192176,420,-3,-16,-6,-4,-1,4,3,1,2,3,-2,5,3,0,3,3,-2,2,0,0,-3,1,3,-9,6,-3,0,0,-1,-1,0,1,4,-1
KR_6759802563,420,-1,-17,-4,-2,1,2,3,-3,5,2,1,3,4,0,2,2,-1,1,0,0,-4,-295,0,-5,5,1,0,0,-1,-1,-1,1,1,-1
KR_6742293495,420,2,-35,12,0,2,0,2,3,2,5,-2,3,1,-4,6,2,1,0,1,0,-1,95,-6,-2,8,24,0,1,1,-1,1,1,3,-1
KR_6764613280,420,-3,-33,-20,-14,1,1,2,-7,7,0,0,5,5,-8,9,1,0,2,2,0,-12,-86,-7,-1,8,2,0,-1,-1,-1,-1,-1,3,-1
KR_6717407276,420,4,61,28,-2,-6,7,1,1,1,2,-9,10,1,7,1,8,5,0,5,0,-1,6,-3,-1,4,0,0,0,-1,-1,-1,1,2,-1
KR_6478590283,420,-1,-1,28,-8,4,1,5,-1,4,3,1,1,2,-7,7,0,-5,5,0,0,-17,-7,-3,-1,4,2,0,-1,-1,-1,-1,-1,2,-1
KR_6751044670,420,-2,-47,-28,-7,-3,4,1,0,1,1,-1,1,0,-5,5,0,2,3,5,0,-5,4,0,-2,2,-3,0,0,1,-1,-1,-1,4,-1
KR_6761343210,440,-1,-133,30,-7,-1,2,1,3,1,4,-5,7,2,-3,4,1,-1,3,2,-1,0,29,1,-2,1,-4,0,-3,-1,1,-1,-1,3,-1
KR_6747443890,420,-4,-71,4,-11,-3,3,0,-5,6,1,0,2,2,-3,3,0,0,0,0,0,-14,-40,2,-5,3,-5,0,-2,-1,-1,-1,-1,4,-1
KR_6661113895,420,-1,8,-4,1,6,0,6,0,3,3,-4,4,0,1,0,1,-2,2,0,0,4,-8,0,-6,6,4,0,1,-1,1,1,1,1,-1
KR_6660546016,420,3,-11,18,1,1,0,1,-2,2,0,1,5,6,0,3,3,1,1,2,0,-3,-8,-8,0,8,4,0,1,1,1,1,1,6,-1
KR_6749746586,440,0,25,15,-11,-1,2,1,0,2,2,-2,3,1,-6,6,0,-2,3,1,0,-9,-7,-6,-1,7,2,0,-1,-1,0,-1,-1,4,-1
KR_6754222798,420,-2,-19,-15,-4,0,2,2,-8,8,0,-5,5,0,9,2,11,0,1,1,0,3,-6,1,-4,3,1,0,0,-1,-1,1,1,3,-1
KR_6761134627,420,-1,-36,33,-6,1,1,2,-3,5,2,0,1,1,-7,8,1,3,0,3,0,-8,1,-5,-4,9,-1,0,0,-1,-1,0,-1,5,-1
KR_6741215205,420,0,23,-16,2,3,1,4,-1,3,2,-2,5,3,2,1,3,0,3,3,0,10,15,3,-5,2,-2,0,-1,-1,-1,-1,-1,6,-1
KR_6720524986,420,-3,24,16,-14,-1,2,1,-2,5,3,-7,8,1,-3,5,2,-1,3,2,0,-11,-21,1,-3,2,-1,0,-1,1,1,-1,-1,2,-1
KR_6728843162,420,-1,-51,-30,0,4,0,4,-5,6,1,0,1,1,0,1,1,1,0,1,-1,2,-10,1,-6,5,-5,0,-2,-1,-1,-1,-1,1,-1
KR_6719960317,420,-2,24,-52,-6,0,0,0,-3,5,2,-3,8,5,-3,7,4,3,0,3,-1,-2,130,-1,-5,6,-6,0,2,0,1,1,-1,0,-1
KR_6757886401,420,-3,-84,0,0,-1,4,3,2,2,4,0,2,2,2,1,3,-3,4,1,0,1,-8,2,-5,3,-3,0,-1,0,-1,-1,1,0,-1
KR_6701621759,440,-1,13,8,-1,-5,7,2,0,4,4,6,0,6,-3,5,2,1,1,2,1,10,-76,-2,-2,4,0,0,0,-1,0,0,1,4,-1
KR_6627898277,420,1,-14,8,0,1,0,1,1,3,4,2,3,5,-4,4,0,0,1,1,0,-1,4,1,-3,2,-1,0,0,1,1,0,-1,4,-1
KR_6598995174,420,-2,-16,-9,-6,0,2,2,0,5,5,4,1,5,-7,8,1,-3,5,2,0,-11,-3,-1,-2,3,1,0,0,-1,0,-1,1,5,-1
KR_6756464403,420,0,-25,-12,3,-2,3,1,3,1,4,3,3,6,0,3,3,-1,3,2,0,0,-11,-1,-1,2,2,0,0,1,-1,0,-1,6,-1
KR_6442008595,420,1,-60,-21,5,-4,4,0,3,2,5,2,1,3,1,1,2,3,1,4,0,19,-22,-1,-5,6,2,0,-1,1,0,-1,-1,6,-1
KR_6747244992,420,-5,-78,-20,-13,0,1,1,-3,5,2,-1,1,0,-3,4,1,-6,7,1,0,-10,-41,-3,-1,4,21,0,-2,-1,0,-1,1,2,-1
KR_6676566275,420,-6,-124,-28,-9,1,2,3,-5,5,0,-4,7,3,-2,4,2,1,0,1,-3,-5,35,-1,-2,3,1,0,-2,-1,-1,-1,-1,3,-1
KR_6698674611,420,-1,55,0,-4,-4,4,0,-2,4,2,2,1,3,0,2,2,0,1,1,0,4,50,-2,-3,5,-26,0,1,1,-1,-1,-1,6,-1
KR_6738006752,440,0,-56,20,8,3,2,5,1,0,1,-4,6,2,3,2,5,5,1,6,1,11,21,4,-5,1,-3,0,0,-1,1,-1,1,4,-1
KR_6742250223,440,-3,-5,-8,-5,-3,5,2,-1,4,3,-3,7,4,3,2,5,-1,4,3,0,-12,-37,0,-4,4,1,0,1,-1,-1,1,-1,4,-1
KR_6670865496,420,-2,-5,-43,-5,-1,5,4,-2,5,3,1,2,3,-2,3,1,-1,2,1,-2,-6,0,1,-2,1,1,0,0,-1,-1,-1,-1,2,-1
KR_6752738921,420,-4,-25,-52,-7,5,0,5,-1,3,2,-4,4,0,-7,8,1,0,2,2,0,-7,-3,-3,-2,5,-3,0,-1,-1,-1,-1,1,6,-1
KR_6728775405,420,0,1,8,-3,1,1,2,2,0,2,-9,9,0,0,2,2,3,0,3,0,1,-46,-2,-3,5,17,0,0,-1,-1,0,1,6,-1
KR_6749791739,440,0,36,-4,-2,0,3,3,-2,4,2,5,1,6,-4,6,2,-1,2,1,0,-4,-21,-2,-2,4,-3,0,1,-1,0,1,-1,6,-1
KR_6752150951,420,0,-1,4,-4,-1,4,3,-1,1,0,4,2,6,-3,4,1,-3,3,0,0,-7,-4,5,-7,2,-6,0,0,-1,0,-1,-1,6,-1
KR_6757754835,420,-4,-15,16,-4,-3,5,2,-2,5,3,1,1,2,-1,3,2,1,0,1,0,-6,-3,-3,-3,6,1,0,0,-1,0,0,1,2,-1
KR_6717775815,420,0,-60,11,2,1,2,3,1,3,4,-2,2,0,2,1,3,0,0,0,0,3,-7,-1,-4,5,-1,0,-1,1,-1,-1,-1,6,-1
KR_6678060532,420,-4,9,-32,-15,-3,3,0,0,0,0,-3,3,0,-8,8,0,-1,1,0,-1,-12,-6,-5,-1,6,0,0,-1,-1,-1,-1,-1,2,-1
KR_6722007266,420,-1,1,-12,0,-2,3,1,-2,3,1,0,0,0,2,1,3,2,0,2,0,0,292,-4,-2,6,0,0,0,0,0,0,-1,0,-1
KR_6750126736,420,1,9,3,-10,-4,7,3,-3,6,3,2,1,3,-5,6,1,0,1,1,1,-12,-5,-5,-1,6,0,0,0,-1,-1,1,1,3,-1
KR_6749025401,440,-2,-10,8,-8,-5,6,1,-2,4,2,-3,3,0,0,1,1,2,2,4,0,-5,22,-4,-4,8,-7,0,-1,-1,-1,-1,-1,1,-1
KR_6627552377,420,-1,-45,2,-4,-3,7,4,3,0,3,-2,2,0,-2,3,1,0,1,1,0,-5,3,-3,-5,8,-3,0,0,-1,-1,0,-1,1,-1
KR_6598017589,420,-8,-98,-35,-14,-2,3,1,-5,5,0,-3,5,2,-5,7,2,1,2,3,0,-20,10,0,-5,5,3,0,-2,-1,-1,-1,-1,1,-1
KR_6667049150,420,-3,-4,-17,-7,3,1,4,-6,6,0,-4,5,1,1,1,2,-1,2,1,0,-6,7,0,-7,7,-4,0,0,1,-1,0,-1,5,-1
KR_6661531589,420,0,31,-13,-9,7,2,9,-3,5,2,-5,8,3,-6,6,0,-2,3,1,0,-11,-9,-1,-2,3,0,0,0,-1,-1,1,1,3,-1
KR_6684103014,420,1,2,16,2,0,1,1,-2,2,0,0,3,3,2,1,3,2,2,4,0,1,4,0,-4,4,-1,0,0,1,-1,0,-1,6,-1
KR_6724632602,420,0,-6,4,-2,-1,2,1,-5,6,1,-3,4,1,4,0,4,3,1,4,0,3,33,-4,-2,6,-16,0,-1,1,-1,-1,-1,5,-1
KR_6722330255,420,-3,2,-12,-11,-8,8,0,-2,5,3,3,2,5,-7,7,0,3,0,3,0,-7,-4,1,-4,3,-1,0,-1,0,1,-1,1,0,-1
KR_6751998854,420,-3,-56,-6,-4,-2,3,1,2,1,3,4,1,5,-5,5,0,-3,3,0,0,-2,-10,-3,-3,6,0,0,0,1,-1,-1,1,2,-1
KR_6759150663,420,-1,-34,-20,-6,6,0,6,-2,2,0,-5,6,1,-4,4,0,-1,2,1,1,-7,3,1,-4,3,2,0,-2,-1,1,-1,1,1,-1
KR_6751062600,420,-2,-3,-14,-7,-3,6,3,1,1,2,-2,7,5,1,2,3,-4,4,0,1,0,2,-6,-2,8,3,0,0,0,-1,-1,-1,0,-1
KR_6762305415,420,-1,50,47,-1,-8,8,0,6,0,6,-2,3,1,-1,2,1,4,3,7,1,2,-4,-3,-5,8,9,0,0,0,1,0,1,0,-1
KR_6755009492,420,-4,-47,0,-11,-5,6,1,-2,5,3,0,1,1,-3,3,0,-1,1,0,0,-8,110,2,-5,3,0,0,-1,1,-1,-1,-1,4,-1
KR_6695342899,420,-2,-38,-3,-8,1,2,3,-4,6,2,-4,4,0,1,2,3,-2,2,0,-1,-12,-13,5,-6,1,4,0,0,1,1,0,-1,1,-1
KR_6761994302,420,1,-69,27,8,-1,2,1,5,5,10,6,0,6,-2,5,3,0,0,0,0,-3,-16,0,-8,8,5,0,-1,-1,1,-1,-1,3,-1
KR_6652627704,420,-4,-56,12,-11,-3,4,1,-2,4,2,-3,5,2,-3,3,0,0,1,1,-1,-14,3,4,-8,4,-4,0,0,-1,1,0,-1,4,-1
KR_6684684240,440,-4,-72,5,-9,0,3,3,-4,8,4,0,0,0,-3,4,1,-2,3,1,1,-8,-5,-2,-3,5,0,0,-2,-1,1,-1,1,1,-1
KR_6751938190,420,0,-37,0,4,1,0,1,-1,3,2,0,5,5,3,0,3,1,1,2,2,1,27,5,-6,1,-2,0,-1,-1,1,-1,1,2,-1
KR_6745734850,420,5,38,16,8,1,0,1,5,0,5,1,3,4,0,3,3,1,0,1,0,13,-6,-3,-3,6,0,0,2,1,1,1,1,4,-1
KR_6749510585,440,-1,-22,5,-9,-7,8,1,1,1,2,1,2,3,-1,1,0,-3,3,0,0,-8,390,-1,-3,4,0,0,-2,-1,1,-1,-1,5,-1
KR_6649168218,420,-5,-42,-4,-7,-1,3,2,-1,4,3,0,2,2,-5,6,1,0,1,1,0,-14,204,-5,-2,7,1,0,-2,-1,-1,-1,-1,1,-1
KR_6326277810,420,-5,-68,-16,-14,-5,6,1,-6,7,1,-3,4,1,0,2,2,0,0,0,0,-7,-9,-3,-4,7,-2,0,-1,1,-1,-1,-1,5,-1
KR_6742221972,440,3,26,28,4,5,0,5,-2,4,2,-1,4,3,-3,6,3,5,0,5,0,-4,-104,2,-5,3,-2,0,1,0,1,1,-1,0,-1
KR_6667712256,420,1,-36,-12,6,-3,3,0,2,2,4,0,1,1,1,0,1,6,0,6,0,8,-2,-1,-4,5,2,0,-1,1,-1,-1,-1,1,-1
KR_6732267621,420,3,-13,-16,-5,-5,6,1,-1,6,5,-5,5,0,3,3,6,3,0,3,-5,-13,3,-3,-3,6,-1,0,-1,-1,1,-1,-1,3,-1
KR_6755228424,420,-6,-90,-35,-14,-3,5,2,-4,4,0,-9,11,2,2,1,3,0,0,0,0,-5,-14,-4,-5,9,2,0,-2,-1,-1,-1,-1,4,-1
KR_6715410267,420,-2,-43,-7,-5,-1,2,1,0,3,3,-5,5,0,2,1,3,-1,2,1,0,-3,-386,-2,-2,4,0,0,-2,-1,-1,-1,-1,1,-1
KR_6759952785,440,-2,8,-20,-15,4,2,6,-5,7,2,-10,10,0,-2,3,1,-2,3,1,-3,-10,-7,5,-6,1,-3,0,-1,0,-1,-1,-1,0,-1
KR_6651616623,420,-1,-76,-1,-4,-2,4,2,2,2,4,-3,3,0,0,2,2,-1,1,0,0,-1,-13,-3,0,3,1,0,0,-1,0,-1,-1,6,-1
KR_6755393915,420,1,5,17,-1,0,2,2,1,1,2,-1,3,2,-1,3,2,0,1,1,0,-7,-1,3,-5,2,3,0,0,1,0,0,-1,6,-1
KR_6648738945,420,-1,-21,-2,-5,0,0,0,-2,3,1,0,6,6,-2,5,3,-1,3,2,-1,-17,-6,2,-6,4,5,0,-1,-1,-1,-1,-1,6,-1
KR_6722199306,420,-2,3,4,-6,-2,2,0,1,2,3,-3,5,2,0,4,4,-2,3,1,0,-4,-15,0,-4,4,0,0,0,-1,1,0,-1,1,-1
KR_6735204185,440,-3,-15,-9,0,-2,2,0,-1,2,1,5,1,6,-1,2,1,-1,2,1,0,3,-102,-1,-3,4,3,0,0,0,0,0,-1,0,-1
KR_6742890675,420,0,-2,5,1,1,2,3,-2,4,2,4,2,6,-2,2,0,0,0,0,0,-6,15,1,-4,3,-5,0,-1,1,-1,-1,1,6,-1
KR_6720474891,420,-5,-31,12,-11,-5,5,0,-4,7,3,0,4,4,-1,2,1,-1,3,2,0,-2,2,0,-2,2,2,0,-2,-1,-1,-1,1,4,-1
KR_6758978015,420,-4,-82,-16,-14,-6,7,1,-5,6,1,-1,6,5,1,2,3,-3,4,1,0,-2,1,3,-6,3,1,0,0,1,-1,-1,-1,4,-1
KR_6751215836,420,-4,-98,-5,1,1,3,4,1,1,2,-4,5,1,-1,5,4,4,0,4,-1,-2,20,-3,-4,7,0,0,1,-1,1,1,-1,6,-1
KR_6756129082,420,-2,34,-35,3,-2,2,0,0,2,2,4,0,4,2,2,4,-1,3,2,0,-1,7,0,-5,5,0,0,2,-1,1,1,1,3,-1
KR_6729831659,440,-4,-5,-24,-13,-2,4,2,-6,7,1,-3,5,2,-4,4,0,2,2,4,0,-8,331,3,-3,0,0,0,-1,-1,1,-1,-1,2,-1
KR_6760620206,420,-1,-17,-8,-7,1,3,4,0,3,3,-3,4,1,-5,5,0,0,0,0,0,-9,1,0,-4,4,3,0,0,0,1,1,1,0,-1
KR_6716861204,420,-1,-14,-19,-1,0,1,1,-1,1,0,-1,2,1,2,2,4,-1,5,4,0,-1,-3,0,-3,3,-1,0,0,-1,1,0,1,2,-1
KR_6273435028,440,4,69,12,6,7,1,8,-4,6,2,0,0,0,1,5,6,2,1,3,0,-2,6,-2,-2,4,-1,0,0,1,-1,0,1,4,-1
KR_6689981241,420,-6,-28,-38,-3,1,1,2,-3,5,2,-2,3,1,1,3,4,0,0,0,0,-3,-3,-2,-3,5,-4,0,-1,-1,1,-1,1,4,-1
KR_6750884435,420,0,-16,10,0,0,1,1,-2,3,1,3,4,7,2,2,4,-3,3,0,-1,-3,14,-1,-4,5,8,0,0,-1,1,0,-1,4,-1
KR_6748727983,440,-4,-9,-4,-2,-2,4,2,0,3,3,-5,5,0,5,0,5,0,1,1,1,7,-11,2,-4,2,-1,0,-1,-1,-1,-1,1,4,-1
KR_6629525922,420,1,-11,-8,-3,-2,2,0,2,4,6,-2,5,3,1,2,3,-2,2,0,-1,-4,-4,1,-4,3,-1,0,0,-1,-1,-1,-1,1,-1
KR_6638286249,420,0,-31,12,9,3,2,5,-1,5,4,4,0,4,1,3,4,2,2,4,0,7,-8,-5,-2,7,1,0,1,-1,0,1,1,5,-1
KR_6724595367,440,-2,-13,6,-8,2,1,3,-1,2,1,1,0,1,-9,9,0,-1,1,0,0,-15,78,4,-6,2,-7,0,0,1,1,0,-1,2,-1
KR_6692725599,440,1,51,2,0,3,2,5,-6,9,3,0,3,3,7,1,8,-4,6,2,-1,-3,-24,2,-3,1,0,0,2,-1,0,1,-1,3,-1
KR_6754135990,420,-3,-104,-11,-9,-4,7,3,0,2,2,-3,5,2,-6,7,1,4,1,5,0,-7,-17,-5,-3,8,3,0,-2,-1,1,-1,-1,6,-1
KR_6762561473,420,0,16,-8,-1,4,1,5,-1,2,1,-5,6,1,-3,4,1,4,0,4,0,-6,16,4,-5,1,-1,0,0,-1,1,-1,1,4,-1
KR_6459744883,440,-2,-5,-35,-7,1,0,1,-4,9,5,-3,4,1,2,0,2,-3,3,0,-2,-9,-6,1,-4,3,0,0,-1,-1,-1,-1,-1,6,-1
KR_6725763484,420,2,25,-4,6,2,2,4,1,1,2,2,2,4,1,2,3,0,1,1,0,7,-35,0,-5,5,5,0,1,-1,1,1,-1,5,-1
KR_6534644690,420,-1,-76,7,-1,-1,2,1,4,1,5,-1,2,1,-4,9,5,1,1,2,0,7,4,0,-3,3,-5,0,-1,-1,-1,-1,-1,3,-1
KR_6612828720,420,-3,11,-8,-5,-3,4,1,-1,2,1,-1,1,0,1,1,2,-1,2,1,0,-2,-7,2,-6,4,0,0,-1,-1,-1,-1,-1,6,-1
KR_6758195413,420,-1,16,-4,2,0,1,1,4,0,4,-3,7,4,3,3,6,-2,2,0,0,-8,-8,-3,-7,10,1,0,0,-1,1,0,-1,5,-1
KR_6725104603,420,-4,-41,17,-7,-2,2,0,-2,3,1,0,2,2,-1,3,2,-2,2,0,0,-5,-189,-4,-1,5,-2,0,0,-1,1,0,-1,4,-1
KR_6762843379,420,3,-40,17,10,0,3,3,5,3,8,1,2,3,-1,4,3,5,1,6,1,5,5,0,-4,4,0,0,0,0,-1,1,1,0,-1
KR_6758391514,420,-10,-143,-75,-16,-5,6,1,3,0,3,-4,6,2,-10,12,2,0,1,1,0,-22,-15,-2,-1,3,-1,0,-4,-1,-1,-1,-1,3,-1
KR_6760958394,420,-4,-115,-20,-10,-3,4,1,-1,2,1,-1,1,0,-3,6,3,-2,2,0,0,-11,-1,3,-4,1,-1,0,-1,1,1,-1,-1,2,-1
KR_6728178286,440,-2,-32,4,-4,0,2,2,-3,3,0,-4,4,0,-3,3,0,6,1,7,0,-5,-3,1,-2,1,2,0,0,1,1,0,1,1,-1
KR_6563797344,420,-4,-71,8,-5,1,1,2,-3,5,2,-5,6,1,3,1,4,-1,2,1,0,-5,32,-1,-2,3,-1,0,1,-1,-1,1,-1,6,-1
KR_6707486662,420,-3,-34,-19,-5,4,0,4,-5,6,1,-1,3,2,-4,4,0,1,1,2,0,-10,221,-3,-1,4,-3,0,-1,0,-1,-1,-1,0,-1
KR_6273505029,440,-2,46,-4,-1,-1,2,1,0,5,5,1,2,3,0,1,1,-1,2,1,0,5,-37,-3,-4,7,-3,0,0,1,-1,0,-1,2,-1
KR_6749986615,420,2,-52,4,3,1,2,3,-2,3,1,3,5,8,-2,4,2,3,1,4,1,-2,3,7,-7,0,-2,0,0,-1,0,1,1,5,-1
KR_6614544309,420,-1,-34,-20,-6,0,2,2,1,2,3,-1,3,2,-4,5,1,-2,2,0,-3,-13,-118,0,-4,4,-5,0,-3,-1,-1,-1,-1,3,-1
KR_6750246925,420,-3,-55,-4,-8,-1,4,3,-1,4,3,-3,6,3,-1,3,2,-2,3,1,0,-9,-5,1,-5,4,-2,0,0,-1,1,1,1,3,-1
KR_6630647897,420,4,89,-4,6,8,0,8,3,2,5,-3,4,1,-1,2,1,-1,2,1,0,-4,-9,-2,0,2,0,0,1,-1,1,1,1,5,-1
KR_6727734854,420,0,-38,-18,-4,1,2,3,2,0,2,-4,5,1,-5,6,1,2,0,2,1,1,-4,0,-3,3,2,0,-1,-1,1,-1,1,5,-1
KR_6692656467,420,-2,-6,1,1,-2,3,1,-2,3,1,2,4,6,0,2,2,3,0,3,1,2,-37,-1,-4,5,3,0,1,-1,-1,-1,-1,2,-1
KR_6684168642,440,0,14,6,-9,0,2,2,-4,5,1,1,1,2,-3,6,3,-3,3,0,0,-17,-10,-2,-2,4,0,0,1,-1,-1,-1,-1,5,-1
KR_6639134194,420,-1,14,0,-2,0,3,3,0,0,0,0,1,1,-1,1,0,-1,1,0,0,0,5,6,-7,1,-1,0,0,-1,-1,0,-1,4,-1
KR_6759615122,420,-2,-121,2,-10,-2,2,0,-2,3,1,-2,4,2,-2,3,1,-2,2,0,-1,-12,-9,-2,-6,8,-3,0,0,-1,0,-1,-1,1,-1
KR_6755782366,420,-5,-6,-34,-10,0,1,1,-2,4,2,0,1,1,-7,9,2,-1,3,2,0,-13,6,4,-8,4,-2,0,-2,-1,1,-1,-1,5,-1
KR_6761705453,440,-4,-77,-25,6,-4,4,0,2,1,3,5,1,6,3,1,4,0,2,2,0,-2,-13,2,-3,1,-2,0,-1,-1,0,-1,1,2,-1
KR_6763292577,420,1,-34,4,-4,-2,3,1,2,2,4,-2,4,2,-2,6,4,0,1,1,-1,-12,4,2,-8,6,-7,0,1,1,1,1,-1,5,-1
KR_6670910634,420,-2,12,-20,-8,3,3,6,1,3,4,-3,4,1,-4,4,0,-5,5,0,0,-10,-22,-4,-1,5,-3,0,-2,1,-1,-1,-1,3,-1
KR_6761181582,420,1,-20,-22,-3,-4,5,1,-4,6,2,5,1,6,1,5,6,-1,2,1,-1,-8,231,-2,-2,4,-22,0,0,-1,1,1,-1,6,-1
KR_6689128938,440,-4,-46,-6,-15,0,3,3,-3,5,2,-8,11,3,-3,3,0,-1,2,1,-2,-24,368,2,-4,2,-2,0,-2,0,0,-1,-1,0,-1
KR_6726876181,420,-2,-64,-28,-7,-1,1,0,-3,3,0,-4,6,2,1,4,5,0,1,1,-1,-3,-17,0,-5,5,3,0,0,0,1,0,-1,0,-1
KR_6711712600,420,-2,11,-8,-13,-4,6,2,-3,5,2,-3,3,0,-2,2,0,-1,2,1,0,-13,-2,-1,-3,4,-1,0,-1,-1,-1,-1,-1,4,-1
KR_6718721080,420,-7,-56,4,-13,-5,6,1,-5,6,1,2,0,2,-3,5,2,-2,2,0,0,-16,-14,-4,-4,8,1,0,-2,0,-1,-1,-1,0,-1
KR_6746520100,420,2,16,3,0,3,0,3,-2,7,5,0,1,1,1,2,3,-2,2,0,0,-4,0,-2,-3,5,-5,0,1,1,1,1,1,1,-1
KR_6723043796,420,-3,8,24,-6,-2,4,2,-1,1,0,-2,3,1,-1,1,0,0,0,0,0,-4,16,2,-3,1,-3,0,-1,1,1,-1,1,5,-1
KR_6757441244,440,-4,-117,-32,-18,-3,3,0,-8,9,1,-3,6,3,-6,7,1,2,2,4,-1,-11,-8,0,-6,6,-7,0,-2,0,-1,-1,-1,0,-1
KR_6735257628,420,0,30,0,-5,1,1,2,2,2,4,-5,6,1,-2,3,1,-1,1,0,0,-5,-4,-1,-3,4,0,0,0,0,0,0,-1,0,-1
KR_6386401179,420,0,-34,-13,3,1,3,4,2,0,2,1,3,4,-1,4,3,0,1,1,0,1,38,1,-6,5,-23,0,0,1,0,0,-1,2,-1
KR_6743147341,420,-6,-37,-35,-10,8,0,8,-5,7,2,-2,3,1,-6,6,0,-5,5,0,0,-16,4,4,-5,1,-5,0,-1,-1,-1,-1,1,4,-1
KR_6732961301,420,-5,-118,13,-14,1,1,2,-7,8,1,0,1,1,-6,9,3,-2,3,1,0,-14,-3,-3,-2,5,0,0,-1,1,-1,-1,-1,3,-1
KR_6687809464,420,-2,-37,-25,-1,-6,6,0,4,1,5,0,3,3,1,3,4,0,0,0,0,3,16,4,-7,3,-3,0,-1,-1,1,-1,1,2,-1
KR_6760760258,420,-4,-3,-64,-4,0,1,1,0,1,1,2,1,3,-7,10,3,1,1,2,0,-6,123,-1,-3,4,-2,0,-1,-1,1,-1,-1,6,-1
KR_6741152681,440,-1,-56,-23,-11,-1,1,0,2,1,3,-1,6,5,-2,5,3,-9,9,0,-1,-7,17,-2,-1,3,-24,0,0,-1,-1,-1,-1,6,-1
KR_6754168645,440,-1,2,-26,-3,0,0,0,1,1,2,0,0,0,-8,9,1,4,0,4,0,-5,-1,-2,-3,5,2,0,0,-1,1,1,-1,5,-1
KR_6727184526,440,-4,-9,-31,-3,1,2,3,-4,6,2,-2,2,0,2,2,4,0,0,0,1,3,2,2,-5,3,-3,0,0,-1,0,0,1,2,-1
KR_6763604553,420,-3,-125,-12,-6,0,0,0,-1,4,3,-3,3,0,-1,2,1,-1,1,0,0,-5,2,-1,-3,4,-1,0,-2,-1,-1,-1,-1,5,-1
KR_6572625443,420,-1,3,-55,-1,-4,4,0,1,1,2,1,2,3,0,2,2,1,0,1,0,1,1,-3,-5,8,-1,0,0,0,1,0,1,0,-1
KR_6758888194,420,2,-2,31,-1,3,0,3,1,4,5,3,0,3,-7,7,0,-1,2,1,-1,-3,-28,-1,-6,7,-1,0,-1,-1,1,-1,-1,4,-1
KR_6758450334,420,-4,-18,-51,-10,0,0,0,-9,9,0,-6,6,0,0,1,1,5,0,5,0,-4,-12,-1,-4,5,2,0,0,-1,1,-1,-1,6,-1
KR_6755783377,420,-1,0,9,2,0,2,2,3,0,3,2,2,4,-3,4,1,0,1,1,0,1,-15,-3,-3,6,5,0,0,1,-1,-1,1,4,-1
KR_6686668947,420,3,18,2,5,2,0,2,3,3,6,-2,2,0,0,0,0,2,2,4,0,6,-11,-1,-5,6,4,0,0,1,-1,0,1,6,-1
KR_6732910483,420,-3,-28,-28,-5,-4,6,2,3,1,4,0,1,1,-2,4,2,-2,3,1,0,4,287,-3,-4,7,3,0,-1,1,-1,-1,1,5,-1
KR_6759208526,420,-5,-52,8,-12,-4,5,1,-5,6,1,-1,2,1,-2,3,1,0,1,1,0,-11,-45,2,-3,1,12,0,-1,1,1,1,-1,3,-1
KR_6678557978,420,-2,21,-21,-7,-2,2,0,0,2,2,7,0,7,-11,13,2,-1,1,0,-1,-6,-5,-2,-4,6,-3,0,0,-1,1,1,-1,5,-1
KR_6707779947,420,-6,-135,-16,-10,-8,8,0,2,0,2,-3,3,0,0,2,2,-1,1,0,0,-2,10,0,-4,4,-1,0,-3,-1,1,-1,-1,5,-1
KR_6584295003,420,-2,-46,4,-5,-1,2,1,1,2,3,-1,1,0,-5,7,2,1,0,1,0,-1,-110,-1,-5,6,1,0,0,1,1,-1,-1,4,-1
KR_6688850281,420,-5,-51,-20,-10,-2,2,0,0,0,0,-7,8,1,-1,3,2,0,3,3,0,-3,-8,4,-8,4,-4,0,-3,-1,1,-1,1,5,-1
KR_6760272247,420,-2,-49,12,-6,-4,4,0,0,1,1,3,4,7,-7,7,0,2,1,3,0,-9,2,-1,-2,3,1,0,0,-1,-1,0,-1,4,-1
KR_6762696429,420,-2,-33,-16,-10,-3,3,0,1,2,3,-4,4,0,-2,2,0,-2,5,3,0,-9,-4,-2,-2,4,1,0,-1,-1,-1,-1,-1,3,-1
KR_6751363655,440,-8,-153,-24,-15,1,1,2,-1,2,1,-1,1,0,-12,13,1,-2,3,1,-1,-13,-462,0,-2,2,0,0,-1,-1,1,-1,-1,3,-1
KR_6713993054,420,3,48,8,6,0,1,1,0,4,4,4,2,6,1,0,1,1,2,3,-1,5,11,-2,-6,8,-4,0,0,-1,-1,1,-1,4,-1
KR_6625590368,440,4,76,2,5,2,1,3,-1,3,2,-2,2,0,0,6,6,6,0,6,0,-1,-2,-3,-2,5,-2,0,1,1,-1,-1,1,1,-1
KR_6741218847,440,-2,20,24,-3,1,0,1,-4,6,2,-4,6,2,5,4,9,-1,2,1,-1,-2,-5,-4,-3,7,1,0,-1,1,-1,-1,-1,6,-1
KR_6758765308,420,-1,67,9,-8,-1,2,1,-1,2,1,-3,4,1,-2,5,3,-1,1,0,1,-10,-58,0,-4,4,2,0,0,-1,-1,1,1,1,-1
KR_6717219174,420,3,-7,-4,10,5,3,8,-1,2,1,0,3,3,4,3,7,2,0,2,1,8,40,2,-6,4,2,0,2,0,1,1,1,0,-1
KR_6520052970,420,1,-9,36,4,0,1,1,1,4,5,0,3,3,4,1,5,-1,1,0,-1,4,143,0,-4,4,-1,0,0,1,-1,1,-1,2,-1
KR_6734458028,420,-1,28,-13,-2,0,0,0,0,3,3,-8,8,0,5,1,6,1,1,2,0,1,-17,2,-5,3,22,0,0,0,-1,0,1,0,-1
KR_6676789641,420,-4,-33,13,-10,0,3,3,-1,7,6,-7,7,0,-3,4,1,1,0,1,0,-1,36,-3,-6,9,-3,0,-1,-1,-1,-1,-1,4,-1
KR_6710773884,440,-2,3,21,-5,-2,3,1,-1,4,3,0,2,2,0,4,4,-2,2,0,0,-10,-1,4,-8,4,-3,0,-1,1,-1,-1,-1,4,-1
KR_6760879876,420,-2,58,-7,-12,0,1,1,-3,4,1,2,1,3,-9,9,0,-2,2,0,-2,-17,-24,4,-5,1,-4,0,1,-1,1,1,-1,3,-1
KR_6697584296,440,-2,-29,-18,-3,0,3,3,1,1,2,-6,6,0,0,3,3,2,1,3,0,3,6,5,-7,2,-3,0,-1,1,-1,-1,-1,6,-1
KR_6678549088,420,0,-41,35,-5,2,0,2,2,2,4,-3,3,0,-3,3,0,-3,4,1,1,-7,-5,-5,-5,10,-3,0,-1,1,-1,-1,1,5,-1
KR_6653204763,420,-1,-5,-36,-2,3,0,3,0,2,2,-3,4,1,-3,3,0,1,2,3,0,-1,-5,-3,-2,5,3,0,0,0,0,0,-1,0,-1
KR_6757740654,420,2,16,20,4,0,1,1,0,2,2,-5,7,2,7,0,7,2,0,2,0,7,8,-3,-2,5,-1,0,0,1,-1,1,1,4,-1
KR_6753095278,420,-3,-4,-9,-4,-2,5,3,0,0,0,0,1,1,-2,3,1,0,2,2,0,-4,4,-3,-4,7,1,0,0,0,0,0,1,0,-1
KR_6689349859,420,0,-22,-8,-1,2,2,4,0,1,1,0,2,2,-3,3,0,0,0,0,0,-5,-215,-3,-1,4,-7,0,0,-1,1,0,-1,4,-1
KR_6653469453,420,0,-13,12,2,3,1,4,-5,6,1,4,1,5,0,1,1,0,0,0,0,0,-494,1,-8,7,1,0,0,-1,-1,0,-1,6,-1
KR_6742955153,420,-2,-95,-15,3,1,4,5,-1,2,1,0,2,2,3,1,4,0,0,0,0,-1,17,5,-7,2,-6,0,-1,1,-1,-1,1,2,-1
KR_6614267700,440,-3,-77,3,-17,0,2,2,0,2,2,-12,12,0,-4,4,0,-1,2,1,0,-10,0,-4,-4,8,-2,0,-3,0,1,-1,-1,0,-1
KR_6742059179,420,-2,-51,-36,-3,0,2,2,2,0,2,0,1,1,-3,4,1,-2,2,0,0,-5,-42,-3,-2,5,14,0,0,-1,1,-1,1,3,-1
KR_6734214680,440,-3,24,-28,-7,-2,3,1,1,1,2,0,2,2,-1,3,2,-5,6,1,0,-10,-3,-4,-5,9,4,0,0,-1,-1,0,1,1,-1
KR_6746887166,420,-2,-39,8,-6,-3,5,2,0,2,2,-1,4,3,-1,3,2,-1,3,2,0,-9,-22,-2,-2,4,-3,0,-1,-1,-1,-1,-1,3,-1
KR_6594738319,420,-4,-42,-34,-13,-2,4,2,-6,6,0,-2,3,1,-3,3,0,0,1,1,-1,-11,-117,-1,-5,6,0,0,-1,-1,-1,-1,-1,4,-1
KR_6709073296,420,-8,-116,16,-13,-3,3,0,0,2,2,-3,4,1,-5,5,0,-2,2,0,-1,-12,0,0,-3,3,-4,0,-2,-1,-1,-1,-1,4,-1
KR_6740334868,420,-2,-20,-37,-3,-3,3,0,-4,4,0,-2,4,2,6,1,7,0,1,1,0,1,7,-2,-4,6,2,0,0,-1,-1,-1,1,3,-1
KR_6752961602,420,-1,-34,-4,0,2,2,4,-1,2,1,-2,3,1,-1,4,3,2,1,3,0,4,-6,-4,0,4,4,0,1,0,1,1,-1,0,-1
KR_6764047726,420,0,-31,28,-1,0,1,1,2,1,3,0,1,1,-2,3,1,-1,1,0,0,-1,4,0,-3,3,0,0,-1,-1,0,-1,-1,4,-1
KR_6609770301,420,1,-37,38,0,0,4,4,-2,3,1,4,0,4,-1,4,3,-1,2,1,1,3,-446,2,-8,6,-1,0,0,1,1,0,1,3,-1
KR_6746729368,420,0,-9,20,-10,-6,7,1,0,5,5,-3,4,1,-2,7,5,1,1,2,0,-1,-96,-2,-5,7,-2,0,-1,-1,-1,-1,-1,5,-1
KR_6724067083,420,-1,-5,22,0,-7,8,1,-1,5,4,2,2,4,3,1,4,3,0,3,0,0,-28,2,-7,5,6,0,-1,-1,1,-1,1,2,-1
KR_6741340914,420,-4,-10,-13,-9,2,0,2,-3,3,0,-3,3,0,0,2,2,-5,5,0,0,-12,2,1,-5,4,-3,0,0,-1,-1,-1,1,6,-1
KR_6764406938,420,-4,-5,-60,0,-3,3,0,-1,1,0,4,2,6,3,1,4,-3,4,1,0,-2,-2,2,-6,4,2,0,0,-1,1,0,1,5,-1
KR_6683391685,420,2,-13,4,5,1,3,4,5,0,5,-1,2,1,1,2,3,-1,1,0,0,4,29,-2,-2,4,1,0,0,-1,1,0,1,1,-1
KR_6423999125,420,-5,-41,-52,1,0,1,1,3,7,10,-3,4,1,0,3,3,1,0,1,0,5,-22,2,-6,4,-3,0,0,-1,-1,-1,-1,1,-1
KR_6751083012,420,1,-6,-5,9,-1,1,0,1,3,4,3,0,3,7,1,8,-1,2,1,0,11,-5,-8,-2,10,3,0,-1,1,-1,-1,1,3,-1
KR_6723868403,420,-4,6,-4,-3,-2,2,0,3,4,7,-5,5,0,1,2,3,0,1,1,0,-1,-8,-2,-2,4,1,0,0,-1,-1,-1,-1,1,-1
KR_6721689128,420,-2,-43,0,-7,-2,4,2,-5,6,1,-2,4,2,1,1,2,1,0,1,0,-13,-6,-4,-2,6,-2,0,-3,-1,-1,-1,-1,5,-1
KR_6604132453,440,-2,-17,-16,-9,1,0,1,-8,8,0,4,1,5,-6,7,1,0,1,1,0,-11,44,3,-5,2,-39,0,-1,-1,-1,1,-1,1,-1
KR_6745920639,440,-7,-116,-21,-15,-3,3,0,-4,5,1,-2,4,2,-5,6,1,-1,1,0,0,-16,10,1,-3,2,-4,0,-1,0,-1,-1,-1,0,-1
KR_6760052314,440,-2,-51,-21,-1,-4,6,2,3,0,3,1,2,3,-2,5,3,1,0,1,0,7,-4,-4,-3,7,-1,0,-1,-1,1,-1,-1,2,-1
KR_6759240758,420,1,29,-15,2,2,0,2,-2,2,0,-1,2,1,0,0,0,3,1,4,0,2,-22,-5,-3,8,-4,0,0,-1,1,-1,1,6,-1
KR_6733983940,420,-1,-86,-8,2,-3,3,0,1,1,2,4,2,6,0,3,3,0,1,1,0,8,-94,4,-6,2,0,0,0,1,0,-1,-1,4,-1
KR_6753492956,420,-3,-62,-17,-11,0,1,1,-1,3,2,-3,5,2,-2,4,2,-5,5,0,0,-12,-7,2,-4,2,-1,0,-2,-1,0,-1,-1,5,-1
KR_6759118479,420,-5,-24,-19,-6,-1,1,0,0,2,2,-3,3,0,-1,1,0,-1,2,1,0,-2,4,4,-5,1,-2,0,-1,0,-1,-1,-1,0,-1
KR_6269691119,420,0,46,-43,-1,-1,4,3,-3,5,2,-2,3,1,6,0,6,-1,3,2,0,0,-94,-1,-6,7,-1,0,0,-1,1,0,1,5,-1
KR_6735853201,420,-4,-21,8,-9,-2,2,0,1,5,6,-5,6,1,-3,5,2,0,1,1,-2,-12,-19,-5,-2,7,-5,0,-1,-1,-1,-1,-1,2,-1
KR_6764355093,420,-1,-7,8,-8,-2,5,3,-2,3,1,1,2,3,-5,7,2,0,0,0,-1,-12,109,-2,-6,8,0,0,0,-1,-1,1,-1,3,-1
KR_6754973840,420,-1,-66,-32,-4,-1,1,0,-2,3,1,-5,5,0,7,1,8,-3,4,1,0,0,6,-2,-3,5,-3,0,-3,1,-1,-1,1,6,-1
KR_6636309981,420,1,-6,20,0,3,0,3,-1,5,4,-2,2,0,-5,5,0,5,1,6,0,0,-1,-6,-3,9,2,0,-3,1,-1,-1,-1,1,-1
KR_6640042989,420,1,6,40,6,3,0,3,2,2,4,-2,3,1,5,3,8,-2,2,0,0,4,37,-7,0,7,-28,0,-1,-1,1,-1,-1,3,-1
KR_6725621918,440,-3,-75,12,-5,1,0,1,-9,10,1,5,0,5,-2,4,2,0,1,1,0,-15,0,3,-7,4,-2,0,-1,0,1,-1,-1,0,-1
KR_6473589675,420,-3,-10,4,-10,-2,3,1,5,1,6,-7,8,1,-7,7,0,1,1,2,0,-7,2,0,-4,4,1,0,0,-1,1,0,1,5,-1
KR_6728622739,420,-1,-14,-20,-5,0,0,0,-3,3,0,0,0,0,-1,1,0,-1,1,0,0,-7,-8,0,-5,5,1,0,-1,-1,-1,-1,-1,4,-1
KR_6598219215,420,-3,-47,4,-2,-3,3,0,-1,3,2,4,2,6,-2,7,5,0,1,1,1,-3,5,1,-5,4,-3,0,-2,1,-1,-1,1,2,-1
KR_6592376470,440,-8,-102,-16,-17,1,1,2,-2,7,5,-7,9,2,-7,8,1,-2,3,1,0,-11,2,0,-4,4,-3,0,-1,-1,1,-1,-1,6,-1
KR_6754515699,440,0,3,0,-9,-4,4,0,-3,3,0,0,2,2,-4,4,0,2,1,3,0,-5,12,-4,-4,8,-1,0,0,-1,0,1,-1,3,-1
KR_6713981088,420,-4,-24,-24,-5,-7,7,0,2,1,3,2,0,2,-2,3,1,0,1,1,0,-2,-10,-1,-1,2,-2,0,-3,-1,-1,-1,-1,1,-1
KR_6664354285,440,-2,-16,-31,1,1,2,3,4,0,4,-6,7,1,2,1,3,0,1,1,1,8,-9,4,-5,1,1,0,-1,-1,-1,-1,1,6,-1
KR_6764437283,420,2,29,16,2,0,3,3,2,0,2,2,1,3,3,2,5,-5,5,0,0,-1,-10,-2,-5,7,1,0,0,1,-1,-1,1,5,-1
KR_6759734156,440,-3,-52,-17,-7,2,0,2,3,0,3,0,1,1,-1,2,1,-11,11,0,1,-10,8,1,-5,4,-2,0,0,-1,-1,-1,1,3,-1
KR_6672959920,420,-1,-57,0,0,2,0,2,3,3,6,-2,3,1,-3,3,0,0,0,0,0,1,-9,-2,-4,6,-2,0,1,-1,-1,-1,-1,3,-1
KR_6629967024,420,-4,-38,-30,-13,-2,5,3,-8,8,0,1,2,3,-1,3,2,-3,3,0,0,-5,2,7,-9,2,-2,0,0,1,1,-1,-1,3,-1
KR_6572972367,420,-2,-16,-44,-6,-3,4,1,1,2,3,1,0,1,-2,4,2,-3,5,2,0,-1,129,10,-11,1,-2,0,-2,-1,-1,-1,-1,1,-1
KR_6742452650,420,0,-5,-4,2,-4,4,0,0,5,5,5,1,6,1,1,2,0,3,3,0,3,-9,-3,-2,5,1,0,1,-1,1,1,-1,2,-1
KR_6755964844,420,-1,32,16,-10,0,1,1,-4,6,2,-1,3,2,-3,3,0,-2,2,0,1,-13,-1,0,-4,4,-5,0,0,0,0,0,1,0,-1
KR_6567565568,420,-3,-17,10,-9,0,3,3,-3,3,0,-3,4,1,-3,4,1,0,1,1,-1,-8,-15,2,-5,3,-2,0,-2,-1,0,-1,-1,4,-1
KR_6614330059,440,-3,-92,-14,-2,0,1,1,-3,4,1,3,1,4,-1,1,0,-1,1,0,0,2,11,-3,-1,4,-3,0,0,-1,-1,0,-1,6,-1
KR_6689904734,420,-3,-36,-7,-5,0,1,1,4,2,6,0,0,0,-8,10,2,-1,1,0,0,-4,83,-3,-1,4,4,0,0,-1,-1,-1,-1,1,-1
KR_6743948949,440,0,11,9,-3,0,1,1,-2,3,1,-1,2,1,0,2,2,0,2,2,0,-3,-17,0,-2,2,-2,0,0,0,-1,0,1,0,-1
KR_6735130902,420,-6,-68,-28,-12,-2,3,1,-5,7,2,0,2,2,-2,4,2,-3,3,0,0,-8,-9,-2,-5,7,-2,0,-2,1,-1,-1,-1,6,-1
KR_6714153429,420,-7,-167,-12,-11,-3,6,3,-1,2,1,-3,3,0,-4,4,0,0,0,0,0,-8,-2,-1,-3,4,0,0,-2,-1,-1,-1,-1,1,-1
KR_6753601931,420,-3,-51,-7,-10,1,1,2,1,0,1,1,2,3,-4,5,1,-9,10,1,1,-4,-3,4,-7,3,-3,0,-3,-1,1,-1,1,4,-1
KR_6603645241,420,6,12,24,13,3,2,5,4,0,4,0,4,4,1,4,5,5,0,5,0,15,13,6,-8,2,4,0,0,1,0,1,1,4,-1
KR_6742485585,420,-5,-57,-14,-6,-5,5,0,0,1,1,-2,4,2,1,1,2,0,0,0,0,-3,-2,-1,-1,2,0,0,0,1,-1,-1,1,2,-1
KR_6749847131,440,1,-58,1,-1,-4,5,1,1,1,2,0,0,0,2,1,3,0,0,0,0,4,1,-3,-2,5,4,0,0,1,0,0,1,2,-1
KR_6735140062,420,2,-21,2,-1,5,1,6,3,1,4,-3,4,1,1,4,5,-7,8,1,0,-7,6,-1,-3,4,-2,0,1,-1,1,1,-1,6,-1
KR_6732246691,420,-5,-96,-28,0,-4,4,0,-1,2,1,-4,6,2,7,0,7,2,0,2,1,5,39,-2,-3,5,5,0,0,-1,-1,-1,1,5,-1
KR_6750300257,420,-1,10,20,-3,-4,4,0,3,3,6,3,1,4,-4,4,0,-1,2,1,1,5,-2,-1,-4,5,-1,0,-1,-1,0,-1,1,1,-1
KR_6630724207,420,-1,-41,-16,-3,-6,7,1,3,0,3,-2,2,0,2,2,4,0,2,2,0,9,-10,-2,-3,5,-3,0,-4,-1,-1,-1,-1,3,-1
KR_6751388735,420,0,-14,-25,5,4,0,4,3,1,4,-4,5,1,2,0,2,0,0,0,1,0,454,1,-3,2,-3,0,-1,1,1,-1,1,3,-1
KR_6761529108,440,-4,-4,-9,-6,-1,2,1,1,0,1,-2,2,0,-3,3,0,-1,1,0,0,-6,3,2,-6,4,-3,0,0,-1,0,-1,1,3,-1
KR_6734365730,440,0,-37,14,-2,0,0,0,1,4,5,-6,6,0,0,4,4,3,0,3,1,0,221,0,-2,2,0,0,0,-1,0,-1,1,5,-1
KR_6603532115,420,-3,-31,-3,-9,-4,4,0,-11,15,4,-1,4,3,3,2,5,4,1,5,2,-2,10,-2,-3,5,-1,0,-1,1,-1,-1,-1,5,-1
KR_6692555731,420,-3,-75,36,-7,3,3,6,-5,8,3,-1,3,2,-1,4,3,-3,3,0,-1,-14,10,4,-6,2,-3,0,-2,-1,-1,-1,1,6,-1
KR_6764179770,420,3,-29,-11,3,3,0,3,-1,3,2,3,0,3,-6,8,2,4,0,4,0,-7,-2,-5,-3,8,-1,0,-1,1,-1,-1,1,5,-1
KR_6654911689,420,2,3,-8,10,-2,3,1,5,0,5,0,0,0,4,1,5,3,1,4,1,11,1,2,-8,6,2,0,0,1,-1,1,1,2,-1
KR_6741557096,420,-4,-37,8,-1,-2,2,0,0,3,3,1,1,2,1,1,2,-1,2,1,0,3,4,-1,-7,8,-2,0,0,1,-1,-1,-1,2,-1
KR_6297141089,420,-1,-30,31,0,-1,2,1,-3,5,2,0,2,2,3,0,3,1,1,2,-1,1,-2,0,-9,9,5,0,0,-1,1,0,-1,4,-1
KR_6738995246,420,0,-37,-10,-5,1,0,1,-4,7,3,1,1,2,-4,4,0,1,0,1,-2,-6,-3,0,-6,6,-1,0,-1,0,0,-1,-1,0,-1
KR_6682711320,420,-1,-69,-8,5,3,2,5,1,2,3,-4,5,1,2,2,4,3,0,3,1,11,4,8,-9,1,-1,0,-1,1,1,-1,1,6,-1
KR_6749896543,420,0,-11,-33,-3,0,3,3,-2,2,0,0,3,3,0,3,3,-1,2,1,0,0,2,1,-4,3,2,0,1,-1,1,1,-1,1,-1
KR_6758241086,420,-2,22,-12,-2,-1,3,2,1,2,3,1,1,2,-5,6,1,2,0,2,1,2,-5,0,-5,5,-1,0,0,-1,-1,0,1,6,-1
KR_6720728212,440,1,-58,13,-1,0,1,1,1,2,3,2,2,4,-4,4,0,0,1,1,0,4,-4,0,-4,4,-3,0,-1,-1,-1,-1,-1,4,-1
KR_6731670264,420,-3,-60,-12,-10,3,2,5,-3,3,0,-8,10,2,-2,3,1,0,1,1,-1,-10,-3,0,-2,2,0,0,-1,-1,-1,-1,-1,3,-1
KR_6739895191,440,-3,-12,-8,-5,0,2,2,1,3,4,-7,8,1,3,1,4,-2,2,0,2,8,1,2,-3,1,-1,0,0,1,-1,-1,1,4,-1
KR_6742702123,420,3,57,-4,12,1,0,1,1,2,3,4,0,4,5,0,5,1,0,1,0,10,-1,-3,-3,6,8,0,0,1,-1,0,1,2,-1
KR_6667443055,420,-1,28,-18,-1,-1,4,3,-2,6,4,-2,4,2,4,1,5,0,0,0,0,-10,40,-1,-6,7,-14,0,1,1,-1,1,-1,5,-1
KR_6758924630,420,-3,-43,8,-10,0,1,1,1,2,3,-4,4,0,-5,5,0,-2,3,1,0,-11,20,3,-5,2,-23,0,-1,-1,1,-1,-1,4,-1
KR_6637335204,420,-5,-48,-20,-11,-5,6,1,-6,6,0,-2,2,0,2,0,2,0,1,1,0,-2,-24,0,-5,5,-2,0,-2,1,-1,-1,-1,6,-1
KR_6764683739,420,-4,12,-40,-5,-5,5,0,1,5,6,-1,2,1,0,0,0,0,0,0,0,-2,111,1,-4,3,3,0,-1,-1,1,-1,1,3,-1
KR_6699357412,420,-4,-168,15,-11,-4,5,1,0,3,3,0,3,3,-6,8,2,-1,1,0,-1,-4,-6,3,-5,2,-3,0,-4,-1,-1,-1,-1,5,-1
KR_6679342792,420,0,-41,28,-7,-1,4,3,1,2,3,-6,6,0,-2,2,0,1,0,1,-1,-2,-1,-4,0,4,-2,0,0,-1,1,-1,-1,5,-1
KR_6660932348,440,-2,-12,-27,-4,1,0,1,-3,3,0,0,2,2,-4,4,0,2,0,2,0,-8,2,-6,-2,8,0,0,0,-1,1,0,1,5,-1
KR_6732189629,420,-2,-43,-35,-2,-6,8,2,2,3,5,-1,3,2,3,1,4,0,0,0,-1,6,-12,3,-7,4,0,0,0,-1,-1,-1,-1,1,-1
KR_6574908874,440,-1,5,-8,-6,3,1,4,3,2,5,-2,2,0,-9,10,1,-1,3,2,-1,-6,-22,1,-1,0,-2,0,-1,0,-1,-1,-1,0,-1
KR_6614366879,420,-4,-53,-24,-9,1,1,2,-4,5,1,-2,3,1,-3,4,1,-1,1,0,0,-10,0,1,-6,5,0,0,-2,-1,-1,-1,-1,3,-1
KR_6675928894,440,-1,0,-19,-7,-4,5,1,0,2,2,-4,4,0,1,4,5,0,1,1,0,-6,-7,-6,-3,9,0,0,-2,-1,-1,-1,-1,5,-1
KR_6723888714,420,-1,16,-12,-1,4,0,4,-3,5,2,0,3,3,-1,3,2,-1,1,0,0,-11,5,1,-5,4,1,0,-1,1,1,-1,1,2,-1
KR_6742144693,440,-4,-11,15,-7,-3,4,1,4,1,5,-3,4,1,-2,5,3,-3,4,1,0,-4,-146,1,-2,1,-4,0,-2,0,-1,-1,1,0,-1
KR_6760610260,420,-3,-40,-16,-9,-2,3,1,0,2,2,-5,7,2,-6,7,1,4,1,5,0,-7,-22,-1,-5,6,-1,0,-1,1,-1,-1,-1,5,-1
KR_6711105659,420,2,39,12,5,3,1,4,1,2,3,2,2,4,-5,8,3,4,0,4,0,3,-8,-2,-2,4,3,0,2,-1,0,1,1,3,-1
KR_6693567369,420,-5,-82,4,-10,-2,2,0,0,4,4,-1,3,2,-6,6,0,-1,2,1,0,-7,-2,-5,-2,7,-4,0,-2,-1,1,-1,-1,6,-1
KR_6749285120,420,-2,31,2,-7,-4,5,1,-1,3,2,-2,3,1,1,3,4,-1,3,2,1,-9,5,-4,-4,8,1,0,1,-1,-1,1,1,2,-1
KR_6676600597,420,-4,-78,8,-9,-1,2,1,-5,7,2,-3,6,3,0,3,3,0,1,1,0,-9,-55,-3,-1,4,35,0,-1,1,1,-1,-1,4,-1
KR_6390726606,420,-2,14,-12,-3,3,0,3,-4,5,1,2,2,4,-5,6,1,1,1,2,2,-4,-7,-2,-2,4,6,0,0,1,1,0,1,1,-1
KR_6714702489,420,-1,-32,8,-13,-2,3,1,-3,3,0,-2,2,0,0,1,1,-6,6,0,0,-21,-154,2,-5,3,-2,0,0,-1,-1,0,-1,5,-1
KR_6659910695,420,-4,-10,-8,-9,0,2,2,-3,3,0,-4,6,2,-1,2,1,-1,1,0,0,-12,10,1,-6,5,-2,0,-1,-1,-1,-1,-1,1,-1
KR_6763033255,420,-3,-60,-32,-2,0,0,0,3,2,5,-4,4,0,1,2,3,-2,2,0,0,7,-43,-1,-5,6,21,0,-1,-1,-1,-1,-1,1,-1
KR_6744115080,420,-1,-9,-12,-3,-2,2,0,2,1,3,1,1,2,1,2,3,-5,5,0,2,-3,0,3,-5,2,-3,0,1,-1,1,1,1,5,-1
KR_6757987673,440,-2,23,-4,-11,-3,8,5,1,1,2,2,1,3,-7,7,0,-4,4,0,2,-14,7,3,-4,1,-2,0,0,-1,0,-1,1,1,-1
KR_6754765429,420,-3,-33,21,-10,-1,1,0,2,3,5,-10,11,1,0,3,3,-1,1,0,-1,-8,-5,2,-6,4,-3,0,-1,1,-1,-1,-1,2,-1
KR_6740514828,420,1,82,4,-5,0,3,3,-5,5,0,0,2,2,-1,2,1,1,1,2,0,-7,259,5,-7,2,-1,0,0,-1,-1,0,-1,3,-1
KR_6644558834,420,-3,-45,-19,-2,-3,5,2,1,2,3,-1,3,2,1,1,2,0,2,2,0,-3,9,1,-3,2,-1,0,-1,-1,-1,-1,1,1,-1
KR_6656576121,420,-2,-15,-10,-2,1,1,2,-2,2,0,4,0,4,-7,11,4,2,0,2,0,-3,-40,1,-6,5,10,0,-1,-1,1,-1,-1,5,-1
KR_6756923112,440,-2,17,-5,-10,-2,2,0,0,4,4,-3,5,2,0,2,2,-5,6,1,0,-6,9,1,-5,4,1,0,0,-1,1,-1,-1,4,-1
KR_6727477274,420,-3,-46,-4,-8,-4,4,0,1,3,4,-1,4,3,-3,5,2,-1,1,0,0,-9,-62,-1,-5,6,9,0,-1,0,1,-1,1,0,-1
KR_6751817490,420,-3,41,-1,-9,1,1,2,0,5,5,-8,8,0,-2,3,1,0,1,1,0,-6,-7,-2,-1,3,0,0,0,1,-1,0,-1,4,-1
KR_6535338887,420,-4,-23,-4,1,-3,4,1,4,1,5,-4,8,4,3,1,4,1,0,1,0,2,3,4,-7,3,-4,0,-3,1,-1,-1,1,2,-1
KR_6746351837,440,2,-30,-12,4,-1,2,1,3,2,5,5,1,6,-5,6,1,2,2,4,0,-1,410,-3,-1,4,1,0,1,1,1,1,-1,6,-1
KR_6669856941,420,0,-35,12,-6,-1,1,0,-5,5,0,3,0,3,-2,4,2,-1,4,3,0,-7,1,-1,-5,6,1,0,-1,1,-1,-1,-1,6,-1
KR_6686708590,420,-1,-95,0,-9,-2,2,0,1,3,4,5,2,7,-11,12,1,-2,2,0,0,-13,-4,1,-3,2,0,0,-2,1,-1,-1,1,6,-1
KR_6611092774,420,-3,-41,10,-12,-2,3,1,-1,2,1,0,0,0,-7,10,3,-2,2,0,0,-8,51,-2,-5,7,-26,0,-3,-1,1,-1,-1,3,-1
KR_6744824292,420,-1,-38,-8,-6,-5,6,1,-3,4,1,7,0,7,-3,3,0,-2,3,1,-2,4,6,-4,-1,5,-1,0,-1,-1,1,-1,-1,3,-1
KR_6764751368,420,-1,37,-31,-3,1,0,1,-5,5,0,2,1,3,-3,6,3,2,0,2,0,-2,0,2,-7,5,1,0,-1,-1,-1,-1,1,1,-1
KR_6759857743,420,-7,-118,-33,-16,1,1,2,-7,7,0,-5,6,1,-4,5,1,-1,1,0,-1,-14,-7,-8,-2,10,-5,0,-1,-1,-1,-1,-1,4,-1
KR_6726832376,420,-3,12,-27,-7,-7,7,0,-3,3,0,0,1,1,2,4,6,1,0,1,0,2,262,0,-4,4,1,0,-2,-1,-1,-1,1,6,-1
KR_6533365570,420,2,-16,9,5,2,2,4,3,1,4,5,0,5,-3,7,4,-2,3,1,-1,1,173,3,-9,6,1,0,0,1,1,1,-1,5,-1
KR_6748271884,420,0,-35,3,-1,3,1,4,0,2,2,-1,3,2,-4,5,1,1,0,1,-1,-3,6,2,-7,5,-5,0,0,-1,1,-1,-1,1,-1
KR_6759916900,420,1,-39,14,4,3,0,3,-1,2,1,3,3,6,-4,6,2,3,0,3,0,-3,343,-3,-2,5,1,0,0,1,0,0,1,1,-1
KR_6414089343,420,0,54,-4,-3,0,2,2,2,1,3,-3,4,1,-2,4,2,0,2,2,0,-1,9,1,-6,5,-4,0,0,-1,1,-1,-1,4,-1
KR_6660877156,420,-4,-117,-18,-11,1,3,4,-2,3,1,0,1,1,-13,13,0,3,0,3,1,-8,8,0,-3,3,-3,0,0,-1,1,1,1,5,-1
KR_6753262101,420,-3,6,21,-5,0,2,2,0,3,3,-2,3,1,-1,4,3,-2,4,2,0,-5,-5,0,-5,5,-5,0,0,-1,1,1,1,3,-1
KR_6730665662,420,-3,-2,-31,-11,-1,2,1,-5,6,1,-3,4,1,-1,3,2,-1,2,1,-1,-9,-10,-4,-2,6,0,0,-2,1,-1,-1,-1,3,-1
KR_6752057622,440,-1,-25,9,1,-2,2,0,-2,4,2,2,0,2,1,4,5,2,2,4,0,1,-8,-3,-2,5,-2,0,0,1,-1,0,1,3,-1
KR_6699278553,420,-2,72,4,-12,-2,3,1,-5,6,1,-6,7,1,1,0,1,0,0,0,0,-8,49,-3,-2,5,-12,0,-1,1,-1,1,-1,6,-1
KR_6742987663,440,1,19,4,2,2,1,3,-2,2,0,1,2,3,1,2,3,0,2,2,0,4,-1,6,-9,3,-3,0,0,-1,0,0,-1,1,-1
KR_6628251149,420,-1,-26,-13,-2,-3,4,1,-2,3,1,2,0,2,1,1,2,0,1,1,0,-3,-11,1,-3,2,4,0,0,1,-1,0,-1,6,-1
KR_6583149237,440,-3,-88,5,-11,1,1,2,-5,10,5,-4,4,0,-4,4,0,1,1,2,0,-6,-3,-5,-2,7,2,0,-1,-1,-1,-1,1,4,-1
KR_6762561992,420,-1,-32,-4,1,0,0,0,-1,7,6,-1,4,3,1,1,2,2,0,2,0,4,-2,-1,-3,4,5,0,-1,1,0,-1,1,5,-1
KR_6635162460,440,-2,27,-4,-13,-4,4,0,-10,10,0,1,1,2,-4,6,2,4,2,6,0,-23,-19,-5,0,5,0,0,0,-1,-1,-1,-1,3,-1
KR_6763872851,420,-1,-39,-16,-6,0,0,0,2,1,3,-1,2,1,-7,7,0,0,1,1,0,-8,16,-1,-3,4,4,0,1,0,1,-1,-1,0,-1
KR_6763905789,420,1,18,24,2,7,2,9,-4,7,3,-1,4,3,-3,3,0,3,0,3,-1,-8,-3,2,-7,5,-2,0,1,-1,1,1,-1,2,-1
KR_6728356648,440,2,45,-8,10,2,0,2,4,1,5,-1,3,2,5,1,6,0,1,1,1,6,-10,2,-4,2,0,0,2,0,1,1,1,0,-1
KR_6604379868,420,-4,-50,-4,-5,-2,2,0,-4,4,0,3,0,3,-2,5,3,0,1,1,0,5,-4,2,-7,5,2,0,0,-1,1,0,1,3,-1
KR_6608717312,420,-7,-80,-12,-16,-2,2,0,-5,5,0,-4,8,4,-5,7,2,0,0,0,-1,-13,-9,-1,-2,3,-3,0,0,-1,0,-1,-1,6,-1
KR_6703081517,420,0,-14,-12,0,-2,3,1,3,0,3,1,0,1,-2,3,1,0,0,0,0,0,-3,-3,-4,7,2,0,0,-1,-1,0,-1,6,-1
KR_6693174062,420,-1,30,-12,3,-1,4,3,-2,3,1,2,0,2,3,5,8,1,1,2,0,6,-5,-3,0,3,-4,0,-1,-1,-1,-1,1,1,-1
KR_6761022048,420,-1,-6,-16,5,4,0,4,-3,6,3,3,3,6,-2,4,2,3,0,3,0,-1,14,-1,-3,4,2,0,0,1,0,0,1,6,-1
KR_6659978582,420,0,-59,-12,-6,-5,6,1,1,0,1,-2,4,2,1,2,3,-1,3,2,0,1,140,0,-5,5,-3,0,-1,-1,-1,-1,-1,1,-1
KR_6763000655,420,1,-74,100,2,2,2,4,-3,3,0,0,2,2,1,0,1,2,0,2,0,-6,-46,-4,-5,9,13,0,0,-1,0,0,1,3,-1
KR_6731665166,420,0,-26,33,-3,3,1,4,0,2,2,-6,6,0,0,6,6,0,0,0,0,-2,-56,3,-6,3,0,0,2,0,-1,1,-1,0,-1
KR_6680858080,420,-2,-18,-14,1,1,3,4,-2,4,2,4,4,8,-3,4,1,1,0,1,-1,8,134,2,-5,3,4,0,-2,-1,-1,-1,-1,5,-1
KR_6755543735,440,0,-2,4,1,3,0,3,2,1,3,-1,2,1,-1,3,2,-2,2,0,0,4,0,0,-3,3,0,0,0,0,-1,0,1,0,-1
KR_6673530494,420,-2,28,-12,1,2,0,2,-1,3,2,-1,4,3,1,2,3,0,2,2,4,3,103,-3,-3,6,2,0,1,-1,1,1,1,1,-1
KR_6614782420,420,3,102,31,3,-2,4,2,3,6,9,0,3,3,-1,4,3,3,2,5,0,5,-4,-1,-4,5,2,0,2,1,1,1,1,5,-1
KR_6563958625,420,0,-22,11,1,-1,4,3,0,2,2,2,1,3,-2,5,3,2,1,3,0,5,-23,1,-8,7,0,0,0,1,1,0,1,3,-1
KR_6712241266,440,-4,-97,12,-4,-2,3,1,2,0,2,1,4,5,-5,5,0,0,0,0,-1,-3,-2,-1,-4,5,-3,0,-3,1,-1,-1,-1,2,-1
KR_6649922699,420,-4,23,-83,-7,0,1,1,-9,10,1,-1,2,1,2,2,4,1,2,3,0,-5,-4,-1,-4,5,-4,0,-1,-1,-1,-1,-1,2,-1
KR_6747293113,420,-1,-41,-12,-2,-1,1,0,0,4,4,3,0,3,-5,7,2,1,2,3,0,-8,-121,-1,-3,4,2,0,-1,-1,-1,-1,-1,5,-1
KR_6642277564,420,-7,-70,-1,-17,-2,2,0,-5,6,1,-5,5,0,-6,7,1,1,0,1,0,-16,-167,-4,-3,7,-4,0,-3,-1,-1,-1,-1,3,-1
KR_6742484877,420,-3,-3,-16,1,0,1,1,0,3,3,-6,7,1,5,0,5,2,1,3,0,10,-46,2,-7,5,9,0,0,1,-1,-1,1,6,-1
KR_6709863981,420,-5,-87,-1,-6,-3,4,1,1,1,2,1,3,4,-3,3,0,-2,2,0,0,-8,98,-2,-6,8,-3,0,-2,-1,1,-1,-1,2,-1
KR_6672721883,420,0,-14,-3,7,-2,3,1,0,4,4,3,0,3,0,2,2,6,0,6,0,15,7,3,-5,2,-2,0,-2,1,-1,-1,1,2,-1
KR_6679265673,420,1,66,13,10,1,2,3,2,3,5,-1,2,1,8,0,8,0,2,2,2,15,-1,7,-7,0,0,0,-1,1,-1,1,1,2,-1
KR_6695735874,420,-3,-23,16,-7,-3,4,1,1,0,1,-2,2,0,-1,2,1,-2,2,0,0,-7,-1,0,-3,3,-5,0,-1,0,-1,-1,-1,0,-1
KR_6655855701,420,1,3,8,-2,-5,5,0,6,0,6,0,1,1,-3,3,0,0,1,1,0,-4,-2,-2,-3,5,3,0,1,-1,1,1,-1,4,-1
KR_6597671774,420,-3,4,-6,-8,-5,5,0,-1,4,3,-6,7,1,3,2,5,1,0,1,0,-3,-6,-1,-1,2,-3,0,-1,-1,-1,-1,-1,3,-1
KR_6696400302,420,-1,-14,-8,0,-6,6,0,0,3,3,1,2,3,2,2,4,3,1,4,0,2,27,-5,-2,7,0,0,-2,-1,-1,-1,1,2,-1
KR_6717567919,420,0,4,19,-4,1,1,2,-2,5,3,3,1,4,-5,7,2,-1,2,1,0,-4,-3,2,-6,4,1,0,0,1,-1,0,-1,3,-1
KR_6727236662,420,-1,-38,13,-6,-1,1,0,1,2,3,1,1,2,-2,2,0,-5,5,0,0,-9,3,-2,-5,7,-3,0,-2,-1,1,-1,1,4,-1
KR_6694712792,420,0,-33,-4,3,-1,3,2,2,3,5,-1,1,0,2,3,5,1,0,1,0,7,-29,1,-2,1,-2,0,-2,-1,-1,-1,1,5,-1
KR_6709343207,420,0,-60,-1,0,-1,2,1,-1,5,4,3,0,3,-1,2,1,0,0,0,-1,2,-14,1,-4,3,2,0,0,-1,1,0,-1,5,-1
KR_6764799556,420,-3,-83,-7,-7,1,0,1,-2,7,5,0,4,4,-7,7,0,1,0,1,0,-10,21,0,-2,2,2,0,-2,-1,-1,-1,-1,4,-1
KR_6711481097,420,4,30,0,6,4,1,5,5,2,7,0,5,5,1,2,3,-4,4,0,-1,7,263,-2,-1,3,1,0,0,-1,1,-1,-1,3,-1
KR_6759046661,420,-1,28,-28,-1,-1,3,2,-5,5,0,1,2,3,-3,3,0,7,0,7,0,-1,-7,-4,0,4,5,0,-1,-1,-1,-1,1,2,-1
KR_6761704985,440,2,87,35,6,3,1,4,0,6,6,-2,2,0,3,1,4,2,0,2,1,6,-11,0,-3,3,-2,0,0,0,0,0,1,0,-1
KR_6745915686,440,-3,-29,-26,-5,-4,4,0,3,1,4,0,0,0,-6,6,0,2,1,3,0,1,9,3,-5,2,-1,0,-1,1,-1,-1,1,2,-1
KR_6736859329,420,0,4,11,-2,1,1,2,-4,5,1,3,0,3,-2,3,1,0,2,2,0,-4,1,1,-2,1,0,0,0,0,-1,0,-1,0,-1
KR_6697214870,420,-2,31,-6,-7,0,2,2,-8,9,1,2,0,2,0,2,2,-1,2,1,0,-10,-4,1,-2,1,-1,0,0,-1,1,1,-1,6,-1
KR_6293428436,420,-6,8,-7,-11,-2,3,1,0,4,4,0,3,3,-6,6,0,-3,3,0,0,-9,12,-4,-6,10,-8,0,-2,-1,-1,-1,-1,6,-1
KR_6761416799,420,-4,-54,-24,-2,3,2,5,1,4,5,-1,2,1,-2,4,2,-3,3,0,-1,4,1,-5,-4,9,0,0,0,0,1,1,-1,0,-1
KR_6758211865,420,-3,-32,8,-6,-4,5,1,-2,3,1,-1,1,0,0,2,2,1,0,1,0,-9,9,0,-5,5,-2,0,-1,1,0,-1,1,5,-1
KR_6695491298,420,-6,-98,8,-11,-4,5,1,-2,4,2,-6,9,3,2,1,3,-1,2,1,0,-14,-3,-5,-3,8,-2,0,-2,0,-1,-1,-1,0,-1
KR_6753566363,420,-3,-69,13,-7,-4,4,0,-2,3,1,1,1,2,-2,3,1,0,1,1,0,-11,-5,-3,-1,4,-3,0,0,-1,1,0,-1,3,-1
KR_6756280887,420,-4,-35,6,-13,-3,3,0,-4,5,1,1,3,4,-6,7,1,-1,3,2,0,-17,-1,0,-4,4,1,0,0,-1,-1,-1,1,1,-1
KR_6749078563,440,0,45,-11,2,1,2,3,-2,2,0,-5,6,1,7,2,9,1,0,1,0,3,0,-3,-2,5,1,0,0,1,-1,-1,-1,4,-1
KR_6757708230,440,-4,-79,-12,-5,-8,8,0,1,2,3,4,1,5,-2,3,1,0,0,0,0,-3,6,3,-7,4,-3,0,0,-1,1,-1,1,2,-1
KR_6729438400,420,-1,-37,-7,1,-3,3,0,2,2,4,-4,5,1,5,0,5,1,1,2,-1,6,10,2,-7,5,0,0,0,-1,1,-1,-1,3,-1
KR_6545571409,420,-2,6,-8,-3,1,1,2,1,1,2,-4,7,3,-5,8,3,4,0,4,0,-6,362,0,-6,6,1,0,-1,-1,-1,-1,1,4,-1
KR_6731753464,420,-5,-50,-91,-6,-5,7,2,-1,3,2,-1,6,5,2,0,2,-1,3,2,0,-11,1,2,-7,5,-1,0,-2,-1,-1,-1,-1,4,-1
KR_6758808460,420,1,-6,4,3,2,2,4,3,0,3,0,2,2,-1,4,3,-1,1,0,0,6,-2,1,-4,3,2,0,-2,-1,-1,-1,-1,1,-1
KR_6756602162,440,-2,-56,8,-10,-3,3,0,-1,4,3,-1,1,0,-3,3,0,-2,2,0,0,-11,0,2,-3,1,-2,0,0,0,1,0,-1,0,-1
KR_6637196138,420,-4,-81,-2,1,2,1,3,2,1,3,0,3,3,-1,4,3,-2,2,0,0,-7,-3,0,-5,5,-1,0,-2,1,-1,-1,-1,2,-1
KR_6696568292,420,1,-27,20,-4,2,0,2,-1,3,2,-7,7,0,2,2,4,0,4,4,0,-4,5,-1,-2,3,0,0,-1,1,-1,-1,-1,3,-1
KR_6578670353,420,-2,29,-36,-5,5,0,5,-2,2,0,0,4,4,-6,6,0,-2,3,1,0,-12,-7,-4,-3,7,-7,0,-3,-1,-1,-1,-1,4,-1
KR_6746317249,420,-3,29,-24,-5,-3,3,0,-1,2,1,0,1,1,2,1,3,-3,3,0,0,-11,-3,-1,-4,5,5,0,0,-1,-1,0,1,1,-1
KR_6752218218,420,0,19,12,-6,2,3,5,-3,3,0,-2,2,0,-3,4,1,0,0,0,0,-6,6,0,-3,3,-3,0,0,1,-1,0,-1,5,-1
KR_6749358341,440,-1,-60,13,-4,-3,3,0,0,1,1,-3,5,2,1,2,3,1,1,2,0,-6,126,-1,-2,3,2,0,0,1,0,0,-1,6,-1
KR_6759119349,420,2,11,-4,2,5,0,5,-2,4,2,3,1,4,-3,3,0,-1,3,2,0,-2,-7,0,-3,3,4,0,2,-1,1,1,-1,2,-1
KR_6754993091,420,1,5,-6,3,1,0,1,-1,2,1,-1,5,4,-2,4,2,6,0,6,0,2,-5,1,-8,7,-5,0,0,1,-1,0,1,1,-1
KR_6728474011,420,1,10,-1,2,-3,5,2,1,1,2,4,3,7,-1,3,2,1,1,2,0,-1,-5,-1,-4,5,-1,0,0,-1,1,-1,-1,4,-1
KR_6750066132,420,-6,-72,-12,-10,-7,7,0,-3,4,1,0,4,4,1,2,3,-1,2,1,0,-4,-10,-3,-1,4,1,0,-2,-1,-1,-1,-1,3,-1
KR_6732144196,420,2,-16,30,3,-2,2,0,3,1,4,1,1,2,0,4,4,1,1,2,2,8,2,0,-4,4,21,0,0,1,-1,-1,1,3,-1
KR_6724691893,440,0,57,27,-5,4,2,6,-3,6,3,-3,3,0,-2,4,2,-1,1,0,-1,-9,-5,-3,-1,4,2,0,-1,-1,1,1,-1,4,-1
KR_6750140706,420,-2,-12,-12,-12,0,1,1,1,2,3,-1,5,4,-4,5,1,-8,8,0,0,-17,105,1,-5,4,0,0,-1,-1,1,-1,-1,1,-1
KR_6704354845,420,2,-16,28,3,-4,4,0,1,1,2,3,2,5,3,1,4,0,1,1,-1,3,-2,-3,-4,7,4,0,1,1,-1,-1,-1,4,-1
KR_6737776810,420,-3,-61,11,-13,-2,2,0,-1,2,1,-6,8,2,-3,3,0,-1,2,1,0,-6,-2,-4,-4,8,0,0,-1,-1,1,-1,-1,2,-1
KR_6754809423,440,-5,-142,-27,-7,2,2,4,-4,6,2,-1,3,2,-7,9,2,3,1,4,0,-6,-4,-2,-1,3,0,0,-2,-1,-1,-1,-1,3,-1
KR_6760370907,420,-1,8,-4,-3,-2,3,1,-2,3,1,0,3,3,2,4,6,-1,1,0,0,-3,-4,-1,-1,2,0,0,0,-1,1,-1,1,6,-1
KR_6707265817,420,-5,-127,8,-18,-6,7,1,-10,11,1,-2,7,5,1,2,3,-1,4,3,0,-14,-4,0,-6,6,0,0,-3,0,-1,-1,-1,0,-1
KR_6758302121,420,-7,-5,-25,-17,0,0,0,-4,5,1,-6,6,0,-4,5,1,-3,5,2,0,-11,0,0,-2,2,0,0,-2,-1,-1,-1,-1,3,-1
KR_6753793726,420,-2,-49,-14,-10,-2,3,1,2,2,4,-2,4,2,-5,6,1,-3,4,1,-2,-12,-4,0,-4,4,-3,0,-1,-1,1,-1,-1,1,-1
KR_6689808992,420,-2,-14,-20,-5,-2,3,1,3,0,3,-8,9,1,0,5,5,2,2,4,-1,-7,-22,-4,-2,6,-4,0,0,-1,-1,-1,-1,2,-1
KR_6758009790,420,-8,-71,12,-14,-6,6,0,0,3,3,-1,5,4,-7,9,2,0,0,0,0,-7,3,-1,-1,2,0,0,-1,0,1,-1,-1,0,-1
KR_6733501493,440,-5,-61,1,-11,-5,5,0,-3,4,1,1,0,1,-2,3,1,-2,4,2,0,-7,-12,0,-6,6,6,0,-2,0,1,-1,-1,0,-1
KR_6760820555,420,3,-6,-3,3,2,1,3,1,4,5,1,1,2,-3,9,6,2,0,2,0,9,-1,0,-1,1,1,0,0,1,0,0,-1,6,-1
KR_6754019512,420,2,11,-4,7,0,3,3,-1,3,2,1,0,1,8,1,9,-1,3,2,0,8,2,2,-4,2,0,0,1,-1,1,1,1,4,-1
KR_6482331332,420,3,-39,12,5,-2,5,3,1,2,3,4,0,4,1,1,2,1,0,1,0,8,3,-2,-2,4,1,0,0,1,0,0,1,1,-1
KR_6758780922,420,0,20,4,4,0,4,4,-4,6,2,5,1,6,3,0,3,0,0,0,1,11,25,1,-1,0,-1,0,1,0,0,1,1,0,-1
KR_6738865716,420,-2,-22,-20,-5,4,0,4,-3,5,2,-3,3,0,-3,5,2,0,0,0,0,-2,-6,-3,-5,8,-2,0,-3,-1,1,-1,-1,2,-1
KR_6732759792,420,2,12,23,-3,1,1,2,-3,6,3,1,2,3,-2,3,1,0,2,2,1,-9,4,2,-3,1,0,0,0,-1,-1,-1,1,4,-1
KR_6723181769,420,1,2,40,7,-4,4,0,3,0,3,-2,3,1,8,0,8,2,0,2,0,11,55,5,-5,0,-33,0,0,-1,0,0,1,1,-1
KR_6714580430,440,0,3,24,-7,-1,2,1,0,2,2,-1,4,3,-5,5,0,0,2,2,0,-8,-6,0,-4,4,4,0,0,0,1,1,-1,0,-1
KR_6753215330,420,-7,-44,-45,-12,0,0,0,-6,7,1,-2,2,0,-1,3,2,-3,3,0,0,-15,-123,-3,-6,9,-3,0,0,-1,-1,0,-1,3,-1
KR_6740996404,420,3,79,-12,6,1,2,3,3,1,4,6,0,6,-5,6,1,1,1,2,0,-1,-1,-3,0,3,0,0,1,-1,1,1,-1,1,-1
KR_6603724231,420,-8,-152,-75,-21,-4,6,2,-10,10,0,-2,4,2,1,2,3,-6,6,0,-2,-30,2,-2,-2,4,-1,0,-4,1,-1,-1,-1,3,-1
KR_6718688930,420,-7,-63,-41,-21,-1,1,0,-7,7,0,-5,6,1,-7,7,0,-1,1,0,0,-27,-9,-6,0,6,-3,0,-2,-1,-1,-1,-1,1,-1
KR_6738128175,420,0,-29,-16,-8,-2,4,2,-6,9,3,-1,2,1,0,4,4,1,1,2,1,-17,26,2,-5,3,-2,0,0,-1,1,1,1,1,-1
KR_6759238815,420,-1,-47,28,-3,1,1,2,-3,3,0,1,0,1,1,2,3,-3,3,0,0,-5,13,-3,-5,8,-1,0,0,1,-1,-1,1,6,-1
KR_6678898172,420,1,-6,-1,4,-2,3,1,1,1,2,3,1,4,0,0,0,2,0,2,0,5,-1,0,-5,5,0,0,2,1,0,1,1,6,-1
KR_6747645279,420,2,-28,16,1,-2,3,1,2,0,2,1,0,1,-1,3,2,1,1,2,0,2,10,1,-7,6,-4,0,-1,-1,-1,-1,-1,4,-1
KR_6618201753,420,1,-33,-24,0,-1,1,0,1,2,3,1,1,2,-1,2,1,0,3,3,0,4,-36,0,-3,3,20,0,0,1,-1,1,1,4,-1
KR_6725118567,420,1,16,27,1,3,1,4,-1,4,3,-2,3,1,-1,3,2,2,1,3,0,1,-7,-1,-5,6,2,0,1,-1,1,1,1,4,-1
KR_6747103639,440,-1,-100,-11,-2,1,1,2,1,2,3,1,2,3,-3,4,1,-2,3,1,0,-1,-37,0,-1,1,21,0,-2,-1,-1,-1,1,3,-1
KR_6760937942,420,-6,-80,31,-4,-3,6,3,0,2,2,-3,5,2,-3,4,1,5,0,5,0,-5,-10,-2,-1,3,1,0,2,-1,1,1,1,2,-1
KR_6603814167,420,-6,-60,-3,-13,-4,5,1,-5,6,1,-2,2,0,-2,3,1,0,0,0,-1,-8,21,-3,-4,7,-3,0,-1,-1,-1,-1,-1,1,-1
KR_6752534742,440,-7,-148,-38,-18,-1,2,1,-1,4,3,-10,13,3,-6,6,0,0,0,0,0,-13,-28,-4,-1,5,1,0,-3,-1,-1,-1,-1,4,-1
KR_6725823878,420,-2,-18,15,-5,1,0,1,2,1,3,-5,5,0,-4,4,0,1,0,1,0,-8,5,2,-4,2,-3,0,0,-1,0,0,-1,6,-1
KR_6714757028,420,-1,-31,-24,2,2,2,4,-2,5,3,1,3,4,3,3,6,-2,2,0,1,-6,4,-5,-4,9,-4,0,-1,0,-1,1,1,0,-1
KR_6713184399,420,-3,-22,-16,-5,1,2,3,-4,5,1,-1,4,3,0,3,3,-1,2,1,-1,-6,-13,-5,-2,7,1,0,0,-1,-1,-1,-1,3,-1
KR_6760926562,420,-3,7,-17,-5,-1,2,1,-2,3,1,0,1,1,-1,4,3,-1,1,0,0,-2,6,3,-5,2,-6,0,0,-1,0,0,-1,2,-1
KR_6764423146,420,-2,19,-26,-8,-1,1,0,2,0,2,-1,2,1,-7,7,0,-1,1,0,0,-6,-12,6,-8,2,-3,0,-1,0,-1,-1,-1,0,-1
KR_6759879375,420,-2,-32,0,-2,3,1,4,0,5,5,-2,4,2,0,1,1,-3,3,0,0,-10,2,-3,-3,6,-1,0,-1,1,-1,-1,-1,2,-1
KR_6721773529,420,-1,61,-4,-6,0,1,1,3,0,3,-4,4,0,-3,4,1,-2,3,1,-2,-4,-29,-2,-5,7,32,0,0,-1,-1,0,-1,5,-1
KR_6748492929,420,-2,66,-5,-2,-1,6,5,2,1,3,-1,3,2,-1,5,4,-1,2,1,0,-8,-2,-1,-3,4,-4,0,-1,1,-1,-1,1,6,-1
KR_6759801368,420,0,-3,-23,-6,-7,8,1,-2,6,4,2,2,4,1,2,3,0,1,1,0,-1,113,-1,-4,5,3,0,-2,-1,-1,-1,-1,5,-1
KR_6733347549,440,-2,-27,20,-8,-3,3,0,-3,5,2,0,0,0,-2,3,1,0,1,1,0,-9,0,-1,-8,9,1,0,-1,-1,-1,-1,-1,6,-1
KR_6572922431,420,3,-54,21,-2,3,0,3,-4,4,0,-1,2,1,0,4,4,0,4,4,0,-4,24,1,-4,3,-2,0,0,-1,-1,0,-1,3,-1
KR_6699259779,420,0,8,-12,-7,1,1,2,-5,5,0,-1,3,2,1,4,5,-3,3,0,0,-10,0,-5,-3,8,-1,0,0,-1,-1,1,-1,5,-1
KR_6679189886,420,-1,0,-8,-2,1,0,1,1,3,4,-4,4,0,-1,3,2,1,0,1,1,-2,-2,6,-8,2,-1,0,0,1,0,0,1,2,-1
KR_6745780143,420,1,-15,-22,4,2,0,2,2,3,5,2,2,4,-1,1,0,-1,1,0,-1,2,-26,1,-5,4,-3,0,1,0,1,1,-1,0,-1
KR_6761690984,420,-2,-45,15,-11,-4,4,0,-4,8,4,-4,4,0,2,0,2,-1,1,0,0,-9,-16,-2,-3,5,-5,0,-2,-1,1,-1,-1,6,-1
KR_6710212024,420,-2,-81,32,-3,2,4,6,-1,2,1,-1,2,1,-3,4,1,0,3,3,-1,-2,16,0,-6,6,-12,0,0,1,1,0,-1,6,-1
KR_6732268620,420,1,-11,-12,4,1,2,3,5,0,5,-4,6,2,3,1,4,-1,1,0,-1,5,-11,0,-5,5,2,0,0,-1,1,0,-1,6,-1
KR_6660657882,420,-1,50,-29,0,1,1,2,-2,3,1,-1,2,1,2,0,2,0,1,1,0,-2,-15,-1,-1,2,1,0,0,-1,-1,0,1,4,-1
KR_6751330434,440,-3,-115,7,-15,-4,5,1,3,2,5,-5,5,0,-8,10,2,-1,3,2,-1,-8,-275,2,-4,2,1,0,-3,-1,1,-1,-1,2,-1
KR_6680519981,420,2,-21,0,8,-1,2,1,2,0,2,1,3,4,6,0,6,0,1,1,1,11,-118,1,-5,4,3,0,0,0,0,1,1,0,-1
KR_6673879476,420,2,21,15,2,-1,2,1,-5,6,1,3,2,5,3,2,5,2,0,2,0,-1,7,2,-6,4,-3,0,2,1,1,1,-1,6,-1
KR_6757412337,420,-2,-27,-22,-5,-2,2,0,-1,6,5,-3,11,8,4,2,6,-3,4,1,-1,1,-1,1,-4,3,1,0,0,0,0,-1,-1,0,-1
KR_6687887447,420,1,62,19,-1,4,2,6,-4,5,1,-3,3,0,3,2,5,-1,2,1,0,-5,123,4,-7,3,0,0,2,-1,0,1,1,2,-1
KR_6582863674,420,-2,68,-1,-8,1,1,2,-9,9,0,-2,3,1,0,2,2,2,1,3,0,-10,126,0,-5,5,0,0,0,-1,1,1,-1,4,-1
KR_6734765919,420,1,-26,-8,-4,-5,6,1,3,3,6,-1,4,3,-1,4,3,0,0,0,0,-5,10,4,-8,4,-3,0,-1,1,-1,-1,1,6,-1
KR_6730701285,420,-2,-9,-12,-5,2,0,2,-3,5,2,-2,2,0,-5,5,0,3,2,5,0,-1,6,-2,-4,6,3,0,-1,-1,1,-1,-1,4,-1
KR_6701569487,440,-4,-106,23,-13,-3,3,0,-2,6,4,0,0,0,-8,8,0,0,1,1,-1,-17,208,-4,-3,7,-2,0,-1,-1,1,-1,-1,4,-1
KR_6711066363,420,-4,-40,-23,-8,1,1,2,-6,8,2,-3,4,1,-1,1,0,1,0,1,0,-11,-94,-3,-2,5,1,0,-2,1,-1,-1,1,6,-1
KR_6713571531,420,-2,24,18,-5,1,0,1,-3,4,1,5,1,6,-3,5,2,-5,5,0,0,-8,-6,-2,-1,3,8,0,2,1,1,1,-1,5,-1
KR_6761511264,420,-2,-49,52,-8,-4,4,0,1,0,1,-10,11,1,4,2,6,1,2,3,0,-2,-17,-2,-3,5,4,0,-2,-1,0,-1,-1,1,-1
KR_6672126433,440,1,54,32,-5,-3,3,0,-3,4,1,2,0,2,-2,3,1,1,2,3,0,-7,-6,-4,0,4,0,0,0,1,-1,-1,1,3,-1
KR_6740420804,420,1,4,-16,-1,1,2,3,-5,5,0,1,2,3,2,0,2,0,1,1,0,-4,5,-6,0,6,1,0,0,-1,-1,1,-1,5,-1
KR_6719261646,420,-4,-60,11,-6,-5,6,1,0,3,3,-1,1,0,2,4,6,-2,3,1,0,0,1,-1,-5,6,-1,0,-2,-1,-1,-1,-1,3,-1
KR_6761286797,420,0,-1,4,2,4,1,5,-4,5,1,0,3,3,3,4,7,-1,2,1,-1,-4,-2,3,-6,3,0,0,1,1,-1,1,-1,6,-1
KR_6643103119,420,3,55,-12,8,3,0,3,1,2,3,3,0,3,1,2,3,0,0,0,0,3,24,-3,0,3,2,0,0,-1,-1,0,1,5,-1
KR_6762172600,420,-2,-63,-16,-3,0,0,0,1,0,1,-2,4,2,-2,5,3,0,0,0,0,3,1,-4,-2,6,1,0,0,0,1,-1,-1,0,-1
KR_6755131113,440,-3,-10,-25,-8,0,1,1,-4,7,3,1,1,2,0,1,1,-5,5,0,0,-8,22,1,-4,3,0,0,0,-1,-1,0,1,3,-1
KR_6762122042,420,0,-3,8,-6,-1,2,1,-2,4,2,1,0,1,-3,4,1,-1,2,1,0,-9,-15,-4,-1,5,3,0,0,-1,-1,-1,-1,5,-1
KR_6728038804,420,-6,-85,-28,-10,-1,3,2,-4,6,2,-1,2,1,-3,6,3,-1,3,2,0,-12,4,-2,-5,7,-4,0,0,-1,1,0,-1,2,-1
KR_6762158907,420,0,-19,-16,7,5,0,5,1,3,4,1,1,2,0,2,2,0,1,1,0,3,-8,-4,0,4,4,0,1,-1,-1,1,1,1,-1
KR_6544625978,420,0,31,0,9,6,0,6,1,3,4,3,2,5,-1,1,0,0,0,0,0,1,-38,6,-10,4,13,0,1,1,1,-1,1,1,-1
KR_6621457936,420,-2,-15,0,-12,-2,2,0,-2,5,3,-3,5,2,-5,7,2,0,1,1,0,-10,1,5,-8,3,-1,0,-1,-1,-1,-1,-1,6,-1
KR_6723242258,420,0,-31,-4,1,-1,3,2,1,2,3,1,3,4,0,0,0,0,0,0,0,1,-3,1,-5,4,-2,0,-1,-1,1,-1,1,3,-1
KR_6738000797,440,-4,-18,-26,-9,-4,4,0,2,2,4,1,3,4,-7,7,0,-1,2,1,0,-4,-6,-3,-1,4,2,0,-1,-1,1,-1,-1,4,-1
KR_6741888992,440,1,-10,-24,-5,1,1,2,-2,3,1,2,4,6,-6,6,0,0,2,2,1,1,-4,-1,-2,3,0,0,1,-1,1,1,1,3,-1
KR_6582851049,440,-6,-35,-33,-17,-2,3,1,1,4,5,1,1,2,-11,11,0,-6,8,2,0,-18,-47,1,-4,3,-3,0,-1,-1,-1,-1,1,1,-1
KR_6696519323,420,-3,-60,-24,-7,0,0,0,-3,4,1,-3,3,0,-1,2,1,0,0,0,0,-4,8,0,-3,3,1,0,0,-1,0,0,-1,2,-1
KR_6682545676,420,-2,34,24,-3,-4,5,1,0,5,5,1,1,2,0,2,2,0,1,1,-1,0,0,4,-6,2,-4,0,0,-1,1,1,-1,1,-1
KR_6628019501,420,-2,-56,32,-9,-3,4,1,-6,6,0,2,2,4,-2,8,6,0,1,1,0,-5,-17,-4,-2,6,3,0,-2,-1,1,-1,-1,5,-1
KR_6750991445,420,-2,-18,36,-3,-5,6,1,3,3,6,3,0,3,-4,4,0,0,1,1,0,0,111,-4,-3,7,5,0,0,1,0,-1,1,4,-1
KR_6726982320,420,-4,-79,15,-7,0,2,2,-1,2,1,0,2,2,-6,8,2,0,1,1,0,-6,-8,-5,-2,7,-1,0,0,-1,-1,0,1,5,-1
KR_6381552860,420,-1,-96,36,-2,-2,3,1,0,3,3,4,1,5,-2,6,4,-2,2,0,-1,-3,-49,-2,-2,4,17,0,-1,-1,-1,-1,-1,4,-1
KR_6742740366,420,1,-12,16,4,3,0,3,0,4,4,-1,1,0,2,1,3,0,0,0,0,3,-1,-1,-6,7,-6,0,0,-1,0,0,-1,1,-1
KR_6755709716,440,2,-21,24,-1,0,1,1,-1,1,0,4,2,6,-1,4,3,-3,4,1,-1,-2,-7,-5,-1,6,0,0,0,1,-1,-1,-1,4,-1
KR_6735250481,440,-6,-105,-44,-11,1,0,1,-4,4,0,-2,3,1,-5,6,1,-1,3,2,0,-7,-1,2,-4,2,-1,0,-2,-1,0,-1,1,1,-1
KR_6706330999,420,-6,-79,-65,-10,-1,1,0,-6,8,2,0,5,5,-2,4,2,-1,1,0,-2,-7,-104,0,-4,4,-1,0,-1,-1,-1,-1,-1,2,-1
KR_6763428342,420,1,-25,36,3,-4,4,0,5,2,7,1,1,2,1,2,3,0,0,0,0,2,-4,-2,-4,6,1,0,0,1,1,1,-1,2,-1
KR_6727811438,420,2,0,35,-3,-1,2,1,-1,5,4,5,0,5,-4,5,1,-2,2,0,0,-3,11,2,-5,3,-1,0,0,1,-1,0,-1,4,-1
KR_6760822348,420,2,22,-12,5,-2,2,0,1,1,2,0,4,4,0,3,3,6,1,7,0,7,-13,2,-7,5,0,0,-2,1,-1,-1,-1,1,-1
KR_6634964250,440,-1,-99,12,-6,-1,1,0,0,0,0,-5,5,0,2,1,3,-2,2,0,0,-6,4,-3,-1,4,-4,0,1,-1,1,1,-1,3,-1
KR_6764166709,420,-1,-26,8,-2,3,0,3,5,1,6,-11,12,1,-1,5,4,2,1,3,0,-1,1,-1,-4,5,-1,0,1,-1,1,1,1,4,-1
KR_6732918260,420,0,16,36,-2,1,2,3,-2,4,2,-3,3,0,1,1,2,1,0,1,0,-15,0,-2,-2,4,-2,0,1,1,1,1,-1,3,-1
KR_6752366131,420,1,13,-12,3,2,0,2,-1,5,4,3,0,3,0,0,0,-1,1,0,0,0,-10,-3,-3,6,4,0,1,-1,1,1,1,3,-1
KR_6632502219,420,-2,-3,-12,-5,0,0,0,1,3,4,-3,3,0,-3,6,3,0,0,0,0,-4,1,3,-5,2,3,0,1,0,-1,1,-1,0,-1
KR_6745315632,440,5,95,12,12,6,1,7,1,1,2,1,3,4,3,2,5,1,1,2,1,9,-307,2,-3,1,0,0,1,1,-1,1,1,3,-1
KR_6716823657,420,-1,-63,-8,-1,-1,3,2,-1,3,2,5,0,5,-2,4,2,-2,2,0,0,0,-3,1,-4,3,0,0,0,-1,-1,0,1,3,-1
KR_6663567705,440,-2,49,-30,-3,-4,5,1,2,4,6,-1,2,1,-2,5,3,2,1,3,0,-5,-6,-1,-4,5,0,0,0,-1,-1,-1,-1,6,-1
KR_6697676493,440,-7,-59,-7,-14,-2,2,0,-8,8,0,0,2,2,-3,4,1,-1,2,1,0,-18,-2,-2,-5,7,-1,0,-3,-1,-1,-1,1,5,-1
KR_6722648835,440,1,8,0,-6,1,2,3,-1,2,1,2,1,3,-3,5,2,-5,5,0,0,-10,-2,0,-3,3,-1,0,1,-1,1,1,-1,4,-1
KR_6733079646,420,-3,3,-4,-12,-1,1,0,-3,7,4,-2,3,1,-3,5,2,-3,4,1,0,-12,5,1,-5,4,1,0,0,1,1,0,-1,6,-1
KR_6742591228,420,-4,-114,-16,-5,-1,3,2,0,3,3,-1,3,2,-4,5,1,1,1,2,0,-8,1,4,-6,2,-3,0,0,1,1,0,1,2,-1
KR_6752005632,420,0,32,-39,-1,0,2,2,-2,5,3,1,1,2,5,2,7,-5,6,1,1,-4,5,7,-8,1,-1,0,0,-1,1,0,-1,3,-1
KR_6732992941,420,1,-23,-9,7,2,1,3,-9,10,1,1,2,3,8,0,8,5,0,5,-1,10,-5,4,-6,2,-5,0,-1,1,-1,-1,-1,5,-1
KR_6730410136,420,-2,-71,-20,1,3,0,3,0,3,3,1,3,4,-1,3,2,-2,2,0,0,-1,-1,1,-4,3,-3,0,0,1,-1,0,1,5,-1
KR_6728061178,420,1,45,16,3,0,1,1,1,2,3,-3,4,1,3,0,3,2,0,2,0,4,-19,1,-2,1,8,0,1,0,1,1,-1,0,-1
KR_6723598646,420,5,74,12,10,4,0,4,5,2,7,0,3,3,-1,4,3,2,1,3,0,8,6,-1,-8,9,-2,0,1,1,1,1,1,4,-1
KR_6681697320,440,4,-42,4,1,1,4,5,0,0,0,-2,3,1,2,1,3,0,0,0,0,-4,265,-4,-2,6,0,0,0,1,0,1,-1,1,-1
KR_6760742715,420,-5,-11,-32,-11,0,2,2,-3,5,2,-4,4,0,-5,11,6,1,3,4,-1,-14,-50,-2,-3,5,8,0,-1,-1,-1,-1,-1,4,-1
KR_6764673293,420,-1,1,-8,5,2,6,8,3,1,4,-5,7,2,3,0,3,2,0,2,0,17,-6,5,-9,4,1,0,-1,0,-1,-1,1,0,-1
KR_6764062825,420,-2,-8,-13,-3,-1,1,0,-1,2,1,-2,2,0,1,2,3,0,1,1,0,-3,300,-1,-4,5,-1,0,1,1,-1,-1,-1,3,-1
KR_6759542251,420,-2,6,-9,1,-2,4,2,-2,3,1,0,2,2,2,0,2,3,0,3,0,0,6,3,-6,3,1,0,1,0,-1,1,1,0,-1
KR_6613950821,420,0,-58,16,1,1,0,1,-8,8,0,5,1,6,4,2,6,-1,4,3,0,1,-23,-2,-2,4,3,0,0,1,1,0,-1,1,-1
KR_6763304230,440,2,1,-25,8,-2,3,1,1,1,2,4,3,7,5,1,6,0,1,1,1,13,-4,-6,-3,9,4,0,0,-1,1,1,1,4,-1
KR_6764057169,420,-4,-55,17,-3,1,0,1,-2,2,0,3,2,5,-4,6,2,-1,4,3,-1,-6,-1,-3,-6,9,1,0,-3,-1,-1,-1,-1,3,-1
KR_6725603607,420,1,-9,-4,-1,2,2,4,0,6,6,0,2,2,-2,2,0,-1,4,3,0,-2,14,-1,-6,7,-4,0,0,-1,1,1,1,3,-1
KR_6718386132,420,-1,-50,16,-4,0,0,0,0,0,0,-3,4,1,-3,4,1,2,0,2,0,2,-1,-3,-2,5,-1,0,0,1,-1,0,1,4,-1
KR_6621933944,420,-4,-63,19,-6,-4,4,0,-3,4,1,2,2,4,-1,4,3,0,1,1,-1,1,-7,2,-4,2,1,0,0,-1,-1,-1,-1,4,-1
KR_6684973441,440,-2,28,0,-2,-2,2,0,-5,5,0,1,0,1,2,0,2,2,1,3,0,-4,0,3,-5,2,-1,0,-1,1,-1,-1,1,1,-1
KR_6717717472,420,-3,11,-32,-3,-5,6,1,1,2,3,3,2,5,-3,3,0,1,1,2,-1,-3,-79,-5,0,5,-1,0,0,1,1,0,-1,2,-1
KR_6755632772,420,-1,53,4,-8,-2,2,0,-2,4,2,-2,3,1,-5,5,0,3,1,4,-1,-10,-2,1,-3,2,0,0,0,-1,-1,-1,-1,6,-1
KR_6683338202,420,-2,0,8,-9,-1,1,0,-8,8,0,2,0,2,-1,4,3,-1,1,0,0,-9,48,-3,-4,7,-22,0,0,1,0,0,1,4,-1
KR_6756405687,440,2,28,0,13,-3,4,1,4,1,5,1,4,5,5,0,5,6,1,7,0,11,3,5,-6,1,1,0,2,-1,-1,1,-1,2,-1
KR_6726963577,420,-4,-46,-34,-12,-7,7,0,-3,3,0,-3,4,1,-1,2,1,2,0,2,0,-11,68,2,-3,1,0,0,-1,-1,-1,-1,-1,2,-1
KR_6716051432,420,3,-18,8,4,4,1,5,-1,3,2,3,0,3,-3,5,2,1,2,3,-1,5,-13,1,-3,2,0,0,1,1,-1,1,-1,6,-1
KR_6711443468,420,-1,-58,-8,-1,1,2,3,-3,4,1,-2,4,2,2,0,2,1,0,1,0,0,-39,-4,-2,6,12,0,1,-1,-1,1,1,1,-1
KR_6605994823,420,-4,-63,-6,-2,-1,2,1,2,0,2,0,4,4,2,2,4,-5,5,0,0,-1,-3,-1,-2,3,0,0,-2,-1,-1,-1,-1,5,-1
KR_6592422813,420,-3,14,-4,-6,0,1,1,0,3,3,1,1,2,-7,8,1,0,0,0,0,-6,14,1,-3,2,0,0,0,0,1,0,1,0,-1
KR_6734608971,420,0,35,9,-5,-5,7,2,1,4,5,0,2,2,-1,3,2,0,0,0,0,-7,-2,1,-7,6,-1,0,1,1,1,1,-1,6,-1
KR_6761421215,420,1,-9,0,-4,-2,3,1,5,0,5,-1,6,5,-4,5,1,-2,3,1,-1,-4,15,-2,-3,5,1,0,0,-1,-1,0,-1,4,-1
KR_6757514871,440,1,68,-26,2,-5,5,0,0,0,0,3,6,9,2,1,3,2,1,3,-1,-1,-38,-2,-5,7,1,0,0,0,-1,1,-1,0,-1
KR_6754794747,420,-1,-3,48,-8,5,1,6,-5,5,0,-4,5,1,-2,3,1,-2,2,0,1,-4,-12,-1,-2,3,2,0,-1,-1,1,-1,1,1,-1
KR_6480065893,420,-1,34,27,-2,3,0,3,1,3,4,-3,4,1,-3,6,3,0,1,1,0,-8,3,3,-5,2,-1,0,2,1,1,1,-1,2,-1
KR_6321261508,420,-2,57,-8,2,1,0,1,2,1,3,-1,4,3,1,2,3,-1,1,0,0,8,23,3,-7,4,-12,0,-1,-1,-1,-1,1,2,-1
KR_6764444991,440,-1,-112,-5,-7,-4,4,0,1,2,3,0,2,2,0,2,2,-4,5,1,0,-1,-34,-1,-3,4,12,0,0,-1,-1,-1,-1,6,-1
KR_6722119374,420,1,-44,20,-1,-2,3,1,0,3,3,1,2,3,0,1,1,0,2,2,0,-5,0,0,-3,3,-1,0,-1,-1,0,-1,-1,6,-1
KR_6598941678,420,2,36,-24,-5,-1,1,0,-4,5,1,-3,3,0,1,1,2,2,2,4,0,0,5,2,-4,2,-1,0,0,1,1,1,-1,1,-1
KR_6604153916,420,-2,-90,0,-7,-2,4,2,-1,4,3,-1,3,2,-3,4,1,0,1,1,0,-13,5,-1,-2,3,-1,0,-3,-1,-1,-1,-1,4,-1
KR_6709947499,420,-2,28,12,-2,0,4,4,-1,4,3,-1,2,1,2,0,2,-2,2,0,0,-6,15,1,-8,7,-8,0,0,1,0,0,1,1,-1
KR_6695873789,420,-5,-42,-8,-7,-1,1,0,-8,8,0,1,3,4,0,3,3,1,0,1,0,-5,288,0,-8,8,1,0,0,0,0,0,-1,0,-1
KR_6735789458,420,2,8,5,3,-1,2,1,0,4,4,4,1,5,2,0,2,-2,2,0,0,6,-1,-2,-4,6,1,0,0,1,-1,-1,1,4,-1
KR_6704917556,420,0,-8,27,-1,1,1,2,3,0,3,-6,6,0,2,2,4,-1,1,0,0,3,0,3,-5,2,-2,0,1,1,1,1,1,3,-1
KR_6620964889,420,-1,-43,-16,-2,0,2,2,-4,5,1,-2,3,1,5,2,7,-1,1,0,0,1,6,-2,-2,4,0,0,1,-1,1,1,1,2,-1
KR_6727945697,420,-3,-56,-10,-11,-1,2,1,-6,8,2,-4,6,2,-1,4,3,1,0,1,-2,-15,50,4,-5,1,-14,0,-1,-1,-1,-1,-1,6,-1
KR_6658331567,420,-3,31,-9,-8,0,2,2,-3,5,2,-4,4,0,0,2,2,-1,2,1,0,-9,-212,-4,-3,7,-2,0,0,-1,-1,0,1,2,-1
KR_6635151467,420,-2,-6,12,-2,-1,2,1,-5,7,2,3,1,4,1,2,3,0,3,3,2,-4,14,7,-10,3,-6,0,-1,-1,-1,-1,1,4,-1
KR_6762845087,420,1,-20,4,0,6,1,7,-1,2,1,-4,7,3,-1,1,0,0,0,0,0,-2,12,6,-8,2,-4,0,-1,1,-1,1,-1,3,-1
KR_6755701542,420,-1,-70,0,-1,-1,4,3,4,0,4,0,0,0,-4,6,2,0,1,1,0,5,33,0,-7,7,-4,0,0,0,-1,0,-1,0,-1
KR_6693030460,420,-4,-42,-32,-11,-2,4,2,-3,5,2,-4,5,1,-2,3,1,0,0,0,0,-7,-2,1,-5,4,3,0,-1,1,-1,-1,-1,5,-1
KR_6763966194,420,-2,12,-4,-8,1,0,1,-5,6,1,0,1,1,-4,5,1,0,0,0,0,-13,-21,-3,-3,6,2,0,-1,-1,-1,-1,-1,2,-1
KR_6756954639,440,-2,-50,59,-10,-3,3,0,0,2,2,-6,7,1,0,2,2,-1,2,1,-1,-13,3,5,-9,4,-5,0,0,-1,1,-1,-1,5,-1
KR_6745779501,420,-2,46,-15,-7,-1,2,1,-2,3,1,-4,4,0,0,2,2,0,1,1,-2,-9,-3,2,-4,2,-1,0,0,-1,1,0,-1,2,-1
KR_6742537057,420,-1,12,24,-5,-2,3,1,3,0,3,1,0,1,-8,10,2,1,0,1,0,-5,-13,-1,-3,4,-1,0,0,1,-1,0,1,6,-1
KR_6752220296,420,0,-2,20,3,1,1,2,-1,4,3,3,3,6,1,2,3,-1,2,1,1,0,-10,-8,-2,10,4,0,0,1,-1,0,1,1,-1
KR_6720373934,420,0,23,1,1,3,1,4,-2,3,1,-5,7,2,3,1,4,2,2,4,1,-1,8,3,-4,1,0,0,1,-1,1,1,1,6,-1
KR_6758413218,420,-8,-128,0,-21,-2,2,0,-6,7,1,-3,6,3,-8,8,0,-2,2,0,0,-17,-1,1,-4,3,-1,0,-1,-1,0,-1,1,5,-1
KR_6610589063,420,-2,-47,-5,-6,-2,4,2,5,1,6,-8,9,1,0,2,2,-1,1,0,0,-6,-5,0,-3,3,3,0,0,-1,0,0,-1,2,-1
KR_6529738749,420,-4,-77,-33,-4,1,3,4,-5,7,2,3,2,5,1,4,5,-4,4,0,1,-4,-6,4,-6,2,-2,0,-1,1,1,-1,1,3,-1
KR_6756428150,420,-5,-49,-20,-9,-4,5,1,-2,2,0,-3,5,2,-1,3,2,1,2,3,0,-4,-22,2,-5,3,-1,0,-1,-1,-1,-1,-1,4,-1
KR_6572842097,420,1,-30,8,5,4,1,5,0,2,2,-3,4,1,1,1,2,3,0,3,0,7,-6,3,-7,4,-4,0,0,1,1,0,1,1,-1
KR_6741977867,420,-5,-110,-12,-12,-3,3,0,-1,2,1,-4,6,2,-5,7,2,1,0,1,0,-12,-11,-4,-2,6,2,0,-1,-1,0,-1,-1,1,-1
KR_6716407874,420,1,-2,8,0,-3,5,2,2,2,4,0,1,1,-2,4,2,3,1,4,0,0,-2,4,-7,3,2,0,-2,1,1,-1,1,5,-1
KR_6760649061,420,-4,-59,3,-13,-2,4,2,0,3,3,-4,5,1,-7,9,2,0,1,1,0,-8,-5,-2,-1,3,-2,0,-1,-1,-1,-1,-1,5,-1
KR_6733312134,420,0,27,20,-5,-1,2,1,0,2,2,-2,2,0,-2,7,5,0,0,0,0,-10,-13,-3,-2,5,1,0,1,-1,0,1,1,5,-1
KR_6578526187,420,-5,-101,-30,-16,-4,5,1,1,1,2,-2,3,1,-9,9,0,-2,2,0,-1,-12,-8,0,-3,3,3,0,-1,-1,-1,-1,-1,3,-1
KR_6755990162,420,0,41,21,1,-4,4,0,-2,3,1,3,0,3,3,0,3,1,1,2,0,1,4,5,-7,2,-1,0,-1,1,-1,-1,1,6,-1
KR_6760170044,420,0,-18,40,-2,2,3,5,1,0,1,1,2,3,0,2,2,-6,6,0,-1,-8,-8,0,-2,2,-3,0,3,1,1,1,-1,6,-1
KR_6739371622,420,-2,-39,-4,-3,-4,4,0,-3,5,2,-2,5,3,6,0,6,0,0,0,0,-4,49,-1,-5,6,-17,0,2,-1,1,1,1,4,-1
KR_6759592183,440,0,44,7,-2,-1,3,2,2,1,3,-2,3,1,2,4,6,-3,3,0,-1,-1,-12,-4,-3,7,1,0,0,-1,-1,-1,-1,3,-1
KR_6608101197,420,-2,-105,19,-1,-1,6,5,-1,5,4,0,4,4,1,2,3,0,0,0,1,2,-48,-1,-2,3,13,0,-2,-1,-1,-1,1,5,-1
KR_6378001442,420,-4,-45,1,-10,1,2,3,-3,3,0,-5,6,1,-2,5,3,-1,2,1,0,-10,8,3,-7,4,-5,0,-2,-1,1,-1,1,3,-1
KR_6663856587,420,1,38,-20,0,0,1,1,3,0,3,1,3,4,-2,4,2,-2,2,0,0,-2,-6,-3,-4,7,-3,0,0,-1,-1,0,1,3,-1
KR_6585221736,420,0,-25,-21,-8,-1,1,0,-10,10,0,-2,2,0,5,0,5,0,0,0,-1,-3,-32,-3,-3,6,-2,0,0,0,-1,0,-1,0,-1
KR_6760806918,420,0,21,-21,6,0,2,2,-2,4,2,2,0,2,5,1,6,1,0,1,0,6,-26,1,-4,3,-3,0,0,1,1,0,-1,1,-1
KR_6759081715,420,2,-5,20,5,-2,5,3,1,1,2,4,2,6,0,1,1,2,0,2,0,7,7,-4,-1,5,-5,0,0,0,0,-1,1,0,-1
KR_6764317722,420,-3,-92,24,-9,-1,3,2,1,0,1,0,0,0,-8,10,2,-1,1,0,0,-8,-21,-3,-3,6,3,0,-1,-1,-1,-1,-1,4,-1
KR_6648921184,420,-6,-102,-44,-10,-1,2,1,-6,6,0,0,0,0,-2,3,1,-1,2,1,0,-9,-11,0,-3,3,-2,0,-1,-1,-1,-1,-1,5,-1
KR_6386344309,420,-3,7,24,-8,-4,4,0,-4,4,0,-1,2,1,2,0,2,-1,2,1,0,-4,428,-1,-2,3,0,0,-1,0,1,1,-1,0,-1
KR_6711902223,440,1,-9,-2,2,1,3,4,1,1,2,2,0,2,-1,4,3,-1,1,0,0,1,-150,0,-3,3,-1,0,1,-1,1,1,1,5,-1
KR_6762672538,420,4,48,34,4,-4,4,0,3,0,3,-1,3,2,3,1,4,3,0,3,0,5,-2,-3,-2,5,4,0,0,1,1,-1,-1,3,-1
KR_6678728781,420,1,17,-8,2,1,2,3,-2,2,0,3,1,4,-1,2,1,1,0,1,0,0,-3,1,-4,3,-1,0,1,-1,1,1,1,5,-1
KR_6552448905,420,3,-19,-8,8,2,0,2,1,0,1,4,0,4,1,0,1,0,0,0,0,11,9,3,-6,3,-2,0,1,-1,1,1,1,2,-1
KR_6760834775,440,-1,-43,0,-1,0,0,0,-2,2,0,-3,5,2,6,4,10,-2,2,0,-2,-1,-1,-3,-5,8,-2,0,-1,-1,1,-1,-1,3,-1
KR_6721800587,420,-4,-46,22,-7,-6,7,1,-1,5,4,0,2,2,0,1,1,0,0,0,0,-2,40,-1,-3,4,-1,0,-1,-1,1,-1,-1,1,-1
KR_6759399020,420,0,1,17,-3,-2,4,2,-1,3,2,-2,6,4,1,2,3,1,0,1,0,-2,-22,-3,-3,6,2,0,0,-1,-1,0,-1,4,-1
KR_6762773771,420,-4,-16,-36,-6,-3,3,0,-3,3,0,-3,4,1,4,2,6,-1,2,1,0,-4,3,-3,-4,7,2,0,0,-1,1,0,-1,5,-1
KR_6750917073,420,-5,-42,-23,-7,-1,3,2,0,2,2,-5,7,2,0,3,3,-1,1,0,0,-8,-7,1,-4,3,-1,0,-2,1,0,-1,-1,2,-1
KR_6761144910,420,0,44,-7,5,-3,3,0,2,1,3,-1,2,1,3,0,3,4,0,4,0,12,-99,-5,-2,7,0,0,-1,0,1,1,-1,0,-1
KR_6752450261,420,1,-31,-6,4,2,2,4,1,5,6,-1,2,1,2,3,5,0,2,2,0,7,8,0,-5,5,-2,0,0,-1,1,0,-1,1,-1
KR_6719298972,420,0,-85,1,0,0,2,2,6,1,7,-1,2,1,-5,5,0,0,0,0,0,2,-6,0,-4,4,2,0,0,1,1,0,-1,6,-1
KR_6743594788,420,-4,-26,-3,-7,-2,5,3,-3,3,0,0,1,1,0,1,1,-2,3,1,0,-7,-14,1,-4,3,-1,0,-1,1,-1,-1,-1,3,-1
KR_6764387680,440,-1,-15,-4,-5,-4,5,1,-2,4,2,-1,2,1,2,1,3,0,2,2,0,1,8,-1,-3,4,0,0,0,-1,1,-1,-1,3,-1
KR_6761061894,440,1,15,24,-4,0,1,1,0,4,4,-3,3,0,-1,2,1,0,0,0,0,-1,-17,-3,-2,5,3,0,-1,-1,-1,-1,-1,6,-1
KR_6736447344,420,0,52,-12,2,-1,3,2,-2,4,2,0,1,1,1,2,3,4,0,4,0,-2,-32,0,-6,6,-4,0,1,1,1,1,1,3,-1
KR_6711230975,440,-4,-2,-26,-10,-1,3,2,1,3,4,-4,4,0,-4,4,0,-2,3,1,0,-8,5,5,-8,3,-2,0,0,1,1,0,-1,1,-1
KR_6717639596,420,0,-13,15,-2,1,3,4,1,1,2,-2,6,4,5,0,5,-7,7,0,1,-1,10,3,-5,2,-5,0,1,-1,1,-1,1,5,-1
KR_6749344975,420,-5,-73,-10,-1,-4,4,0,2,0,2,0,3,3,1,0,1,0,0,0,0,3,-114,0,-3,3,-2,0,-2,1,-1,-1,-1,6,-1
KR_6760059533,440,4,-2,33,12,6,1,7,1,1,2,-4,5,1,4,1,5,5,5,10,1,7,116,5,-6,1,-2,0,0,0,0,0,1,0,-1
KR_6716056047,420,-2,2,-17,1,-4,4,0,4,3,7,-2,5,3,1,2,3,2,1,3,-1,-2,111,3,-7,4,0,0,0,1,-1,-1,-1,2,-1
KR_6731001519,420,1,-38,8,-7,-1,2,1,-2,3,1,0,0,0,0,3,3,-4,5,1,-2,-9,39,1,-3,2,-15,0,0,0,-1,0,-1,0,-1
KR_6754795967,420,-2,-25,0,-7,1,2,3,2,0,2,-3,4,1,-6,8,2,-1,3,2,-1,-11,-5,-2,-2,4,0,0,-1,-1,-1,-1,-1,6,-1
KR_6713978346,420,-2,-11,8,-5,4,0,4,1,3,4,-1,3,2,-7,8,1,-2,4,2,1,-14,-185,-4,-3,7,-1,0,0,-1,1,1,1,4,-1
KR_6682924192,420,-2,-54,-16,-3,-1,2,1,-2,5,3,1,0,1,0,2,2,-1,1,0,-2,-9,-15,0,-4,4,1,0,0,-1,0,0,-1,1,-1
KR_6709771715,440,-1,6,6,-4,1,2,3,-1,4,3,-2,6,4,-2,2,0,0,0,0,0,-4,-5,-1,-4,5,-3,0,1,-1,1,-1,-1,5,-1
KR_6698519278,420,-1,-63,20,2,-2,2,0,5,2,7,-1,2,1,-1,2,1,1,0,1,0,0,3,0,-4,4,-1,0,0,1,1,-1,1,4,-1
KR_6723707237,420,-3,-30,0,1,-1,3,2,-2,2,0,2,1,3,4,2,6,-2,2,0,0,2,-14,0,-4,4,-2,0,-1,1,-1,-1,-1,1,-1
KR_6748961004,420,-5,-26,16,-18,0,2,2,-3,4,1,-6,7,1,-5,6,1,-4,5,1,0,-19,4,-3,-3,6,2,0,-1,-1,-1,-1,-1,2,-1
KR_6751466529,420,-2,22,-1,5,1,1,2,-1,7,6,0,3,3,4,5,9,1,1,2,0,11,-407,5,-9,4,-4,0,0,1,-1,0,1,3,-1
KR_6652308130,420,-3,-41,-11,0,3,0,3,1,3,4,-5,6,1,1,1,2,0,1,1,0,-2,-1,-1,-4,5,2,0,0,-1,-1,-1,1,3,-1
KR_6739964880,420,0,27,-8,-7,-1,1,0,-5,5,0,0,4,4,0,2,2,-1,2,1,0,-13,21,-3,-1,4,-3,0,-1,0,-1,-1,-1,0,-1
KR_6514154640,420,-3,-15,12,-10,1,1,2,-1,5,4,0,2,2,-9,12,3,-1,2,1,0,2,-5,-2,-6,8,5,0,-2,-1,-1,-1,1,3,-1
KR_6647828436,420,-3,-58,11,-11,-1,2,1,-3,3,0,-4,4,0,-4,5,1,1,0,1,-2,-15,-19,-7,-2,9,1,0,-3,-1,-1,-1,-1,2,-1
KR_6720527038,420,-4,-51,0,-10,-1,4,3,-6,8,2,-1,1,0,-3,4,1,1,0,1,0,-16,20,-4,0,4,-14,0,-1,-1,-1,-1,-1,3,-1
KR_6400052729,420,-4,-17,-20,-12,-3,4,1,-2,4,2,-3,4,1,-4,7,3,0,2,2,-1,-8,1,-5,0,5,2,0,0,-1,-1,0,-1,6,-1
KR_6745910624,420,-2,-39,-12,-14,0,3,3,-5,5,0,-2,4,2,-2,3,1,-5,9,4,-2,-23,-9,-1,-3,4,-9,0,-1,-1,1,-1,-1,3,-1
KR_6693276269,420,1,23,-26,1,0,1,1,-2,4,2,0,3,3,2,6,8,1,1,2,1,6,-1,-3,-2,5,0,0,-1,0,1,-1,1,0,-1
KR_6612511481,420,-4,-50,-10,-7,1,2,3,0,1,1,-6,6,0,-2,4,2,0,1,1,0,-5,35,1,-3,2,-27,0,0,-1,1,0,-1,1,-1
KR_6762955144,420,-2,1,-4,-5,-1,1,0,-2,2,0,-2,2,0,0,3,3,0,1,1,0,-5,-3,-4,-1,5,1,0,-1,0,1,-1,-1,0,-1
KR_6753622723,420,-1,-38,-24,4,1,0,1,-1,1,0,-1,2,1,5,3,8,0,1,1,2,5,14,0,-4,4,1,0,0,1,0,0,-1,2,-1
KR_6734048090,440,0,5,-4,-3,-3,4,1,-3,6,3,3,2,5,0,4,4,0,1,1,0,-12,-6,0,-2,2,0,0,-1,1,-1,-1,1,4,-1
KR_6756660363,420,-4,-67,-14,-8,-7,8,1,3,2,5,-1,1,0,1,4,5,-4,6,2,-2,-4,246,2,-3,1,4,0,0,-1,1,0,-1,2,-1
KR_6759866309,420,-3,-25,-36,-5,-2,3,1,2,1,3,1,3,4,-1,3,2,-5,5,0,0,-5,187,2,-3,1,18,0,0,0,-1,0,-1,0,-1
KR_6718707274,440,-4,4,-13,-6,-5,6,1,-1,1,0,0,1,1,0,2,2,0,3,3,0,-1,-8,-2,-1,3,1,0,-1,1,-1,-1,-1,3,-1
KR_6751261219,420,-1,-33,4,-2,5,0,5,-4,5,1,2,2,4,-2,4,2,-3,3,0,0,-7,4,0,-5,5,-2,0,1,-1,1,1,-1,1,-1
KR_6654857821,420,-3,-42,12,-11,-8,8,0,-2,4,2,1,4,5,-2,5,3,0,0,0,0,-5,-10,0,-4,4,-1,0,0,-1,1,1,-1,2,-1
KR_6484320145,420,0,-27,9,3,0,0,0,8,4,12,-1,1,0,-4,5,1,0,0,0,1,-5,99,-1,-2,3,2,0,0,-1,1,0,1,2,-1
KR_6744069388,420,-2,-70,0,0,0,1,1,0,2,2,0,0,0,0,3,3,0,1,1,0,1,-9,-1,-2,3,3,0,0,1,-1,0,1,1,-1
KR_6759420400,420,1,-46,8,4,-2,2,0,1,0,1,-4,7,3,6,2,8,3,2,5,0,14,-1,-2,-3,5,2,0,-1,1,-1,-1,1,5,-1
KR_6628563702,420,0,-17,-59,1,-2,3,1,3,1,4,-2,6,4,1,5,6,1,2,3,0,9,-11,-1,-1,2,-2,0,0,0,0,0,-1,0,-1
KR_6764346272,420,2,30,-42,7,2,0,2,-2,5,3,6,4,10,-1,2,1,2,0,2,1,15,-35,-4,-1,5,1,0,0,-1,-1,-1,1,1,-1
KR_6752096720,420,-5,-73,-28,-13,-4,4,0,-5,7,2,-2,5,3,0,4,4,-2,3,1,0,-6,18,0,-2,2,1,0,-1,0,0,-1,-1,0,-1
KR_6756883905,420,-3,31,-24,-5,-3,6,3,-1,4,3,-1,1,0,2,1,3,-2,4,2,0,-6,-3,2,-4,2,3,0,1,1,-1,-1,-1,3,-1
KR_6763236284,420,-5,-90,16,-5,-2,3,1,-1,4,3,-1,2,1,-2,2,0,1,0,1,0,-8,-8,-5,-3,8,-6,0,0,-1,1,0,1,4,-1
KR_6762376754,420,-4,-59,4,-12,-6,7,1,-1,1,0,-5,5,0,-2,3,1,2,0,2,0,-2,18,-2,-2,4,-1,0,0,-1,-1,0,1,6,-1
KR_6746493563,420,-3,-66,-20,-12,-3,3,0,1,2,3,-6,7,1,-2,6,4,-2,2,0,-2,-14,-7,0,-3,3,-2,0,-2,-1,1,-1,-1,3,-1
KR_6754331147,420,-3,-47,24,-10,-1,2,1,0,0,0,-5,6,1,-4,6,2,0,0,0,0,-12,-5,1,-5,4,-4,0,-1,1,0,-1,-1,5,-1
KR_6760909354,440,-6,-178,-21,-23,-4,6,2,-11,11,0,-4,7,3,-6,9,3,2,1,3,-4,-14,-18,-7,-1,8,-4,0,-3,0,-1,-1,-1,0,-1
KR_6742455296,420,-4,-37,-8,-8,-1,3,2,-2,2,0,0,1,1,-2,5,3,-3,3,0,0,-6,-7,-2,-2,4,-2,0,0,-1,-1,0,-1,5,-1
KR_6717210171,420,-3,-1,-39,-1,-2,5,3,1,1,2,-1,2,1,1,0,1,0,1,1,0,2,-2,2,-5,3,-4,0,-1,-1,1,1,-1,4,-1
KR_6762813917,420,-1,4,5,1,-2,3,1,-2,3,1,1,2,3,4,1,5,0,0,0,0,7,-1,4,-6,2,3,0,1,1,1,1,-1,3,-1
KR_6762899027,420,0,14,22,-5,1,1,2,-1,5,4,-3,4,1,-1,1,0,-1,2,1,0,-7,13,1,-2,1,-5,0,0,-1,-1,0,-1,6,-1
KR_6533242280,440,-2,-85,8,-5,-2,4,2,-1,3,2,-1,3,2,-1,3,2,0,0,0,0,1,3,1,-6,5,-4,0,-1,0,-1,-1,1,0,-1
KR_6718707152,420,-4,-91,6,-11,-7,8,1,-5,5,0,-3,5,2,4,2,6,0,1,1,0,-7,-292,1,-3,2,1,0,-1,-1,-1,-1,-1,4,-1
KR_6723401344,440,0,-40,-4,-5,-1,1,0,1,1,2,-5,6,1,2,2,4,-2,2,0,0,-2,8,-6,-1,7,-4,0,0,-1,1,0,-1,4,-1
KR_6758206451,420,-1,4,17,2,3,1,4,2,0,2,-1,5,4,-1,3,2,-1,3,2,0,4,8,3,-4,1,-4,0,0,1,0,1,1,1,-1
KR_6730508243,420,0,-18,22,2,-1,5,4,4,1,5,1,2,3,-2,4,2,0,1,1,-1,4,0,1,-5,4,-3,0,-1,-1,-1,-1,-1,6,-1
KR_6691293938,420,3,32,6,4,1,1,2,2,3,5,1,2,3,0,4,4,0,2,2,0,1,-12,2,-5,3,2,0,-1,0,1,-1,-1,0,-1
KR_6321203789,420,2,71,15,-1,1,0,1,-2,3,1,-2,3,1,1,0,1,1,1,2,0,-2,-14,0,-3,3,1,0,0,0,-1,1,-1,0,-1
KR_6660568423,420,-2,57,8,-2,-5,8,3,-1,2,1,1,2,3,0,8,8,3,0,3,0,2,21,-4,-3,7,1,0,-1,-1,1,-1,1,3,-1
KR_6732007073,420,0,-19,-20,1,0,1,1,3,0,3,-5,5,0,3,1,4,0,2,2,-1,4,7,2,-3,1,-2,0,1,0,1,1,-1,0,-1
KR_6688049265,420,-5,-78,19,-8,-1,1,0,-5,7,2,-5,5,0,0,0,0,3,0,3,-1,-6,-120,0,-4,4,-1,0,0,-1,-1,-1,-1,6,-1
KR_6751384095,420,-3,21,-43,-4,0,1,1,3,0,3,-3,5,2,-4,5,1,0,3,3,2,2,5,1,-5,4,-1,0,-2,-1,-1,-1,1,6,-1
KR_6670681005,420,-6,-67,-3,-18,-3,4,1,1,4,5,-3,4,1,-11,11,0,-2,2,0,0,-17,-9,-2,-1,3,0,0,-2,-1,-1,-1,-1,2,-1
KR_6712782189,440,-6,-143,24,-8,-2,4,2,1,4,5,0,3,3,0,2,2,-7,7,0,1,5,19,2,-7,5,-10,0,0,0,1,-1,-1,0,-1
KR_6705008660,420,-2,-33,-32,-6,-1,3,2,0,5,5,0,4,4,-5,8,3,0,2,2,-1,-13,5,1,-4,3,-3,0,-2,1,-1,-1,-1,2,-1
KR_6736525910,420,0,-47,32,0,-1,4,3,-6,7,1,1,2,3,3,4,7,3,1,4,3,4,7,-2,0,2,0,0,-1,0,-1,-1,-1,0,-1
KR_6719054369,420,-4,25,-41,-14,-1,3,2,-7,9,2,0,1,1,-5,8,3,-1,2,1,0,-11,4,1,-3,2,-2,0,-1,0,0,-1,-1,0,-1
KR_6763886438,420,2,31,32,-2,-5,5,0,-2,2,0,1,1,2,5,1,6,-1,2,1,0,-1,1,4,-8,4,1,0,0,1,-1,1,1,5,-1
KR_6747337670,420,-3,-36,-12,-6,1,1,2,-7,8,1,2,2,4,-3,5,2,1,0,1,1,-2,2,2,-4,2,0,0,-1,-1,-1,-1,1,2,-1
KR_6704163374,420,-2,-19,-24,0,-2,3,1,-4,5,1,-1,1,0,5,1,6,2,0,2,0,7,-4,-3,-3,6,3,0,0,-1,-1,0,1,3,-1
KR_6704709201,420,2,26,-3,3,9,1,10,2,0,2,-3,3,0,-5,7,2,0,0,0,0,-3,3,1,-4,3,-3,0,1,-1,1,1,1,6,-1
KR_6731852811,420,-4,-24,-21,-3,5,0,5,-3,4,1,-5,6,1,0,0,0,0,0,0,0,2,3,2,-2,0,0,0,-1,-1,-1,-1,-1,5,-1
KR_6763998420,420,-1,-52,-31,-2,6,1,7,-2,3,1,0,3,3,-5,6,1,-1,2,1,0,-9,-12,3,-7,4,-3,0,0,-1,-1,0,1,5,-1
KR_6691269805,420,-3,-91,-40,0,1,0,1,-1,2,1,-4,5,1,5,2,7,-1,1,0,0,3,-3,-2,-3,5,-6,0,0,-1,-1,-1,-1,6,-1
KR_6737155979,440,-1,8,4,-1,3,2,5,5,0,5,0,2,2,-7,8,1,-2,5,3,-1,4,-38,-3,-2,5,1,0,0,-1,1,-1,-1,5,-1
KR_6762191602,420,1,28,10,-2,0,1,1,2,2,4,-1,5,4,-1,2,1,-2,4,2,0,2,1,2,-5,3,1,0,-1,1,1,-1,-1,3,-1
KR_6753707053,420,1,34,-12,0,1,1,2,0,1,1,2,3,5,-3,4,1,0,2,2,0,-6,-60,2,-4,2,-28,0,-1,1,1,-1,-1,1,-1
KR_6672047811,420,-6,-45,-4,-8,-6,6,0,-2,5,3,-3,5,2,3,0,3,0,1,1,0,1,-2,3,-6,3,-1,0,-2,-1,1,-1,-1,5,-1
KR_6751806022,440,-7,-97,3,-27,-1,1,0,-9,11,2,-15,15,0,-4,7,3,2,0,2,0,-24,-48,-1,-2,3,1,0,-2,0,-1,-1,-1,0,-1
KR_6756521968,420,1,-16,-8,2,3,1,4,1,1,2,-1,4,3,0,1,1,-1,3,2,0,2,12,0,-3,3,-5,0,-1,1,-1,-1,-1,2,-1
KR_6750787007,420,0,8,-11,4,0,2,2,1,1,2,1,0,1,2,0,2,0,0,0,0,5,-145,-3,-3,6,1,0,1,1,1,1,1,2,-1
KR_6751142235,440,0,7,-11,-1,1,0,1,-5,8,3,1,1,2,2,0,2,0,2,2,0,-11,17,-1,-3,4,-3,0,0,-1,1,0,-1,2,-1
KR_6599928098,420,-1,-18,16,-8,-4,6,2,3,1,4,-3,3,0,-4,6,2,0,1,1,0,-6,-4,-4,-4,8,-1,0,-1,0,-1,-1,1,0,-1
KR_6693211202,420,-1,-50,12,-3,-1,2,1,0,2,2,-5,5,0,2,5,7,1,0,1,-1,1,-12,2,-5,3,-4,0,-1,-1,1,-1,-1,5,-1
KR_6764004407,420,3,71,-13,0,3,1,4,-8,9,1,1,0,1,2,1,3,2,1,3,0,-2,-3,-3,-1,4,-3,0,1,-1,-1,1,1,3,-1
KR_6673015650,420,1,25,3,2,-3,5,2,3,3,6,1,0,1,1,1,2,0,1,1,0,4,35,7,-8,1,-18,0,1,1,0,1,-1,5,-1
KR_6759940370,420,-1,46,-19,-2,-1,1,0,0,1,1,-1,2,1,2,2,4,-2,4,2,0,2,-16,-3,-1,4,3,0,3,0,1,1,1,0,-1
KR_6723732376,420,-2,-26,-22,-15,-2,3,1,-4,7,3,-5,5,0,-4,4,0,0,0,0,0,-15,-383,3,-7,4,0,0,-1,-1,-1,-1,-1,5,-1
KR_6753531157,420,0,21,15,-2,-3,4,1,-1,3,2,3,1,4,-1,1,0,0,1,1,0,-6,-7,0,-3,3,1,0,-2,1,-1,-1,-1,5,-1
KR_6652672387,420,1,19,-4,4,6,0,6,-3,5,2,-1,3,2,4,2,6,-2,3,1,0,0,-6,-2,-5,7,1,0,0,1,-1,1,1,5,-1
KR_6763488829,420,-2,0,-2,-12,-1,2,1,-3,5,2,-2,2,0,-6,7,1,0,1,1,0,-13,0,3,-8,5,-2,0,0,-1,-1,0,1,3,-1
KR_6746446000,420,-4,-55,-50,0,1,1,2,-2,6,4,2,4,6,1,5,6,-2,2,0,1,-1,-18,2,-5,3,0,0,-1,-1,1,-1,1,2,-1
KR_6751026300,420,2,15,10,1,2,1,3,0,5,5,-2,2,0,1,0,1,0,0,0,0,4,-3,0,-3,3,0,0,1,-1,1,1,1,4,-1
KR_6719873997,420,-1,-45,-16,-6,0,2,2,-4,4,0,3,1,4,-2,4,2,-3,4,1,0,-5,-3,-2,-1,3,1,0,-1,-1,-1,-1,-1,2,-1
KR_6728207827,420,-1,-59,-5,-5,1,0,1,-3,6,3,-5,6,1,1,1,2,1,1,2,0,-2,-9,-1,-8,9,1,0,0,-1,1,-1,-1,1,-1
KR_6764300532,420,-1,-26,12,-9,-4,6,2,1,1,2,-2,3,1,-3,4,1,-1,2,1,0,-3,-16,-2,-3,5,-3,0,0,-1,1,0,-1,4,-1
KR_6762820933,420,-4,-66,-10,-15,-1,3,2,-5,8,3,-8,9,1,-2,5,3,1,1,2,-1,-5,-32,-4,-2,6,4,0,-1,0,0,-1,-1,0,-1
KR_6761946907,420,1,34,-20,2,0,4,4,0,2,2,0,1,1,2,0,2,0,1,1,0,9,6,0,-7,7,2,0,0,-1,-1,-1,-1,5,-1
KR_6593596918,420,-4,-42,-5,-9,0,0,0,-4,4,0,-6,8,2,-2,5,3,3,1,4,0,-14,1,0,-4,4,0,0,0,1,-1,-1,-1,5,-1
KR_6731936505,420,-2,-15,12,-3,0,1,1,-3,6,3,3,0,3,-2,3,1,-1,2,1,0,-3,-3,-1,-4,5,-1,0,1,0,1,1,1,0,-1
KR_6593656279,420,-3,-54,-40,-6,-1,2,1,0,3,3,-6,10,4,-3,6,3,4,1,5,-1,0,0,1,-8,7,-2,0,-3,0,-1,-1,-1,0,-1
KR_6743151530,420,-1,7,-20,-8,-8,9,1,-4,4,0,3,1,4,2,1,3,-1,2,1,0,-7,-4,1,-7,6,-1,0,-2,-1,-1,-1,1,5,-1
KR_6623768732,420,-3,-62,-16,-5,-2,3,1,-2,3,1,1,1,2,-3,5,2,1,1,2,0,-1,-11,-9,0,9,-1,0,-1,-1,-1,-1,-1,3,-1
KR_6714480618,420,-9,-92,-5,-19,-1,4,3,2,1,3,-4,6,2,-15,15,0,-1,1,0,0,-24,-5,-2,-5,7,-5,0,-1,-1,1,-1,-1,4,-1
KR_6590930466,420,1,-21,-22,-1,-4,5,1,1,0,1,1,3,4,2,1,3,-1,1,0,0,2,-202,6,-8,2,-3,0,0,-1,-1,-1,1,4,-1
KR_6724297685,420,-1,-14,-24,-1,0,4,4,-4,6,2,0,1,1,-1,1,0,4,0,4,0,2,187,-4,-1,5,1,0,0,-1,1,0,-1,4,-1
KR_6708817293,440,0,12,-8,-5,-3,3,0,-1,2,1,5,0,5,-4,7,3,-2,2,0,0,-2,-4,-6,-1,7,4,0,0,-1,-1,0,-1,5,-1
KR_6727752348,420,-7,-132,-23,-15,-4,4,0,-3,4,1,-4,8,4,-4,4,0,0,3,3,0,-13,-36,-3,0,3,13,0,-4,0,-1,-1,-1,0,-1
KR_6751155061,420,-3,-16,-4,-10,1,1,2,-6,7,1,-1,3,2,-3,3,0,-1,1,0,0,-18,5,3,-6,3,0,0,-1,-1,-1,-1,1,1,-1
KR_6764455028,440,-1,-20,0,0,-1,2,1,-3,7,4,0,1,1,6,1,7,-2,3,1,0,3,5,2,-4,2,-4,0,1,1,0,1,1,4,-1
KR_6758709033,420,-3,-57,-20,-13,-5,5,0,-1,5,4,-3,4,1,-3,5,2,-1,4,3,-1,-6,-9,-3,-1,4,2,0,0,-1,-1,0,-1,1,-1
KR_6751745876,420,-3,-23,-29,-11,-5,6,1,-3,5,2,2,2,4,-3,4,1,-2,3,1,-1,-10,1,-2,-1,3,0,0,-2,-1,-1,-1,-1,2,-1
KR_6760907607,420,-2,24,-23,-7,2,1,3,-5,6,1,-2,5,3,-1,1,0,-1,1,0,-1,-4,-1,-1,-5,6,-8,0,0,-1,-1,1,-1,6,-1
KR_6729655562,420,-2,-25,5,-5,2,1,3,-4,6,2,-4,4,0,1,1,2,0,1,1,0,-5,0,-2,-2,4,1,0,1,-1,-1,1,1,6,-1
KR_6624662000,420,1,-36,8,-1,0,4,4,4,4,8,-1,2,1,-4,8,4,0,2,2,-1,-7,-26,-3,-2,5,1,0,-1,0,-1,-1,-1,0,-1
KR_6609662358,420,-3,-64,-1,-5,-2,3,1,1,1,2,-7,8,1,1,0,1,2,1,3,0,2,-19,-1,-4,5,-2,0,-4,1,0,-1,-1,2,-1
KR_6763362854,440,-3,-63,16,-1,-1,6,5,1,2,3,2,0,2,-1,4,3,-2,2,0,0,-5,-2,-3,-3,6,0,0,0,-1,0,0,1,5,-1
KR_6588815895,420,-2,-43,-41,-11,-1,3,2,-5,8,3,-1,2,1,2,1,3,-6,9,3,0,0,-1,0,-3,3,-2,0,-2,-1,-1,-1,-1,5,-1
KR_6761345500,440,3,53,-4,5,0,0,0,3,1,4,0,2,2,4,3,7,-2,4,2,0,6,15,6,-6,0,-4,0,-1,0,-1,1,1,0,-1
KR_6654647082,420,-3,-89,-29,-7,3,2,5,-1,1,0,-9,9,0,-1,1,0,1,1,2,0,-3,-3,1,-4,3,0,0,-1,-1,-1,-1,1,4,-1
KR_6650213322,420,0,0,-4,-2,0,1,1,-2,5,3,0,1,1,2,3,5,-2,2,0,0,-3,10,-2,-5,7,-1,0,0,0,-1,0,-1,0,-1
KR_6730135697,420,1,-18,17,3,0,0,0,3,0,3,0,1,1,0,2,2,0,0,0,0,8,18,3,-8,5,-1,0,0,-1,1,0,-1,2,-1
KR_6410785835,420,-1,-15,4,-2,3,1,4,1,1,2,-5,5,0,0,1,1,-1,3,2,0,-2,-1,-1,-3,4,1,0,0,-1,1,0,1,2,-1
KR_6733926332,440,0,-38,29,-4,-2,4,2,2,0,2,1,1,2,-1,3,2,-4,6,2,0,1,-55,-4,0,4,24,0,0,1,1,-1,-1,2,-1
KR_6727042408,420,0,-22,-1,2,-3,4,1,-1,2,1,-1,5,4,7,0,7,0,0,0,-1,8,1,3,-4,1,-3,0,-3,1,-1,1,-1,5,-1
KR_6762002561,420,-2,-31,-20,-5,0,1,1,-5,6,1,-1,8,7,2,2,4,-1,2,1,1,4,-40,2,-5,3,-2,0,0,-1,0,-1,1,2,-1
KR_6629939301,420,-2,10,10,-4,3,0,3,-1,4,3,-5,5,0,0,6,6,-1,2,1,0,-4,-29,-3,-3,6,1,0,-2,-1,1,-1,-1,4,-1
KR_6684605382,420,-1,70,-27,1,0,2,2,3,0,3,-2,5,3,-1,1,0,1,0,1,0,4,1,0,-4,4,-3,0,1,1,1,1,-1,5,-1
KR_6739181231,420,-2,-41,27,-3,-1,2,1,3,4,7,-1,4,3,-3,5,2,-1,3,2,1,4,-357,-1,-3,4,-1,0,0,-1,-1,-1,1,6,-1
KR_6756168353,420,0,-63,15,1,-1,2,1,-1,3,2,1,2,3,0,2,2,2,1,3,1,3,18,-3,-4,7,2,0,0,-1,0,0,1,6,-1
KR_6704533586,420,-4,-24,-52,-7,-3,3,0,-4,4,0,-1,3,2,2,1,3,-1,1,0,0,0,7,0,-4,4,-2,0,-1,-1,-1,-1,-1,5,-1
KR_6752467339,420,-2,-140,-12,-7,-1,2,1,4,4,8,-4,6,2,-2,3,1,-4,4,0,-1,-4,137,2,-5,3,1,0,0,-1,-1,-1,-1,5,-1
KR_6762703734,420,2,41,-16,4,5,0,5,0,2,2,5,2,7,-5,8,3,-1,2,1,0,-7,-3,1,-6,5,1,0,1,-1,1,1,1,1,-1
KR_6731400638,440,-4,-12,8,-10,2,1,3,-5,6,1,-9,10,1,-2,2,0,4,0,4,0,-1,-9,-1,-4,5,-2,0,0,-1,-1,-1,-1,6,-1
KR_6762273022,420,-1,-2,-24,-4,-2,3,1,0,3,3,-2,3,1,-3,3,0,3,1,4,0,1,4,-2,-2,4,0,0,0,1,0,0,1,1,-1
KR_6741904960,420,-3,-79,-29,-4,-1,3,2,-1,4,3,1,0,1,1,5,6,-4,6,2,0,-1,-30,1,-6,5,7,0,-1,1,0,-1,-1,2,-1
KR_6759816780,420,0,-30,-18,-8,-1,1,0,-4,4,0,1,2,3,0,0,0,-4,5,1,-1,-10,0,-2,-5,7,2,0,0,0,0,0,-1,0,-1
KR_6754721195,420,-2,-48,-12,-8,-1,2,1,-3,4,1,3,1,4,-4,6,2,-3,4,1,0,-7,-6,-4,-1,5,3,0,-1,0,0,-1,-1,0,-1
KR_6757128642,420,0,-17,26,1,-3,4,1,1,0,1,5,1,6,1,3,4,-3,3,0,0,1,-5,-3,-3,6,0,0,0,1,1,0,1,1,-1
KR_6608859820,420,-2,2,1,-3,0,1,1,-9,9,0,0,3,3,5,2,7,1,0,1,0,-9,51,1,-7,6,-17,0,0,0,-1,0,1,0,-1
KR_6641167062,420,1,48,-15,-5,1,2,3,1,0,1,-2,4,2,-3,4,1,-2,5,3,0,-5,-239,4,-5,1,-20,0,3,1,-1,1,-1,2,-1
KR_6764334857,420,-4,5,-71,-2,0,0,0,-1,3,2,-5,5,0,3,0,3,1,1,2,0,2,15,4,-8,4,-1,0,-1,-1,-1,-1,1,6,-1
KR_6728403544,420,0,26,-4,-6,3,1,4,-1,2,1,-1,2,1,-6,7,1,-1,2,1,-1,-17,-60,-3,-3,6,4,0,0,-1,-1,-1,-1,3,-1
KR_6654558850,420,-1,-10,-4,1,1,0,1,-2,5,3,4,0,4,-1,3,2,-1,1,0,0,2,8,1,-4,3,-3,0,0,-1,1,1,-1,5,-1
KR_6642555491,420,-3,-14,7,-6,5,0,5,0,2,2,-14,14,0,2,0,2,1,0,1,0,-6,-4,-3,-2,5,-3,0,0,1,0,0,1,5,-1
KR_6730403833,420,2,65,-20,0,-4,5,1,1,0,1,4,3,7,-2,3,1,1,0,1,0,-2,-8,0,-4,4,6,0,-1,-1,0,-1,1,3,-1
KR_6761097205,420,3,0,14,0,-3,3,0,0,2,2,0,1,1,2,0,2,1,0,1,0,-1,-25,-2,-2,4,7,0,0,-1,-1,0,-1,4,-1
KR_6753943796,420,0,-49,36,0,-2,5,3,4,0,4,4,1,5,-3,4,1,-3,3,0,0,3,239,-6,-1,7,-3,0,0,-1,1,0,-1,3,-1
KR_6629804099,420,3,0,-14,6,3,0,3,1,2,3,2,1,3,-2,7,5,2,0,2,0,1,-1,-1,-2,3,2,0,0,-1,-1,1,1,5,-1
KR_6748737194,440,-2,-3,-51,-10,2,1,3,-2,4,2,-2,3,1,-6,7,1,-2,2,0,0,-9,299,3,-4,1,2,0,0,-1,0,0,-1,4,-1
KR_6764327468,420,-2,-48,-28,-8,-1,3,2,-2,5,3,0,1,1,-4,5,1,-1,2,1,0,-9,17,1,-4,3,-5,0,-1,-1,0,-1,1,4,-1
KR_6760030426,420,0,8,0,-3,0,2,2,-7,8,1,-1,6,5,4,3,7,1,0,1,-1,0,12,7,-9,2,-6,0,0,-1,-1,0,-1,6,-1
KR_6669290588,420,-1,1,2,-9,-2,4,2,-4,5,1,3,2,5,-6,6,0,0,1,1,0,-16,-242,3,-4,1,-4,0,-3,-1,-1,-1,1,6,-1
KR_6692198734,420,-3,-24,1,-5,1,0,1,0,1,1,2,0,2,-6,6,0,-2,2,0,0,-4,6,3,-8,5,2,0,-2,-1,1,-1,-1,5,-1
KR_6677558706,420,-2,-89,8,1,-2,2,0,2,3,5,0,2,2,0,0,0,1,2,3,0,5,5,0,-3,3,-6,0,0,-1,1,0,-1,2,-1
KR_6760376490,420,1,-34,20,1,3,0,3,-1,2,1,-3,5,2,3,1,4,-1,1,0,0,-4,7,4,-6,2,-1,0,-1,0,-1,-1,1,0,-1
KR_6744444167,420,-4,-37,-28,-9,-3,3,0,3,1,4,-2,4,2,-8,8,0,1,0,1,0,-3,28,2,-7,5,-8,0,0,1,1,-1,-1,4,-1
KR_6761030597,420,0,51,-10,-3,0,1,1,-1,4,3,2,1,3,-2,7,5,-2,2,0,2,5,-7,3,-7,4,-2,0,-1,1,-1,-1,1,6,-1
KR_6753513884,420,-3,6,-24,-2,-1,2,1,1,2,3,-2,4,2,0,0,0,0,2,2,0,0,-10,1,-3,2,3,0,0,-1,0,-1,-1,5,-1
KR_6751412380,420,-2,-39,-21,-8,-3,4,1,-2,4,2,-4,4,0,0,3,3,1,0,1,0,-6,4,4,-7,3,1,0,0,-1,1,0,-1,1,-1
KR_6596331258,420,-2,-31,4,-8,-4,4,0,-1,4,3,0,5,5,-3,3,0,0,4,4,0,-4,0,0,-6,6,-7,0,-1,-1,-1,-1,-1,2,-1
KR_6735351159,440,0,22,-1,-10,0,0,0,-4,9,5,-1,2,1,-2,4,2,-3,3,0,-1,-20,15,3,-4,1,-1,0,-1,-1,0,-1,-1,4,-1
KR_6743597688,440,4,44,-8,9,3,0,3,0,1,1,2,2,4,5,1,6,-1,2,1,0,3,4,3,-6,3,4,0,1,1,1,1,1,5,-1
KR_6572786958,420,-4,-61,-4,-12,-7,7,0,-4,4,0,2,0,2,-2,3,1,-1,1,0,0,-12,5,2,-6,4,-5,0,-2,-1,-1,-1,-1,1,-1
KR_6761453203,420,0,10,8,2,-4,7,3,3,3,6,3,0,3,0,0,0,0,0,0,0,4,-6,0,-4,4,-2,0,0,-1,1,1,1,3,-1
KR_6740794447,420,-2,-54,-39,-7,-2,5,3,-6,6,0,1,0,1,0,1,1,0,0,0,0,-3,0,3,-5,2,-3,0,-1,-1,1,-1,-1,6,-1
KR_6755186770,420,2,-1,0,4,2,4,6,2,2,4,1,2,3,0,7,7,-1,1,0,1,-1,-11,3,-6,3,-3,0,0,1,-1,-1,1,6,-1
KR_6763221200,440,-5,-97,-32,-16,-1,1,0,-3,6,3,-3,5,2,-6,7,1,-3,3,0,0,-18,4,-1,-4,5,-4,0,-3,1,-1,-1,-1,3,-1
KR_6672375262,420,1,11,16,2,-2,3,1,-2,4,2,4,0,4,-2,6,4,4,0,4,-1,-2,3,0,-2,2,-2,0,-1,1,0,-1,-1,5,-1
KR_6760970277,420,2,1,64,4,5,0,5,2,0,2,4,5,9,-6,8,2,-1,2,1,0,-7,10,1,-6,5,-3,0,1,1,0,1,1,4,-1
KR_6758767610,420,-3,-11,-1,-4,1,0,1,-4,5,1,-5,8,3,3,5,8,1,1,2,0,-2,0,2,-3,1,0,0,0,0,1,0,1,0,-1
KR_6754238859,440,-3,-11,-30,-5,-2,2,0,-5,6,1,-2,3,1,4,5,9,0,1,1,0,-11,60,-6,0,6,5,0,-1,1,-1,-1,1,2,-1
KR_6739068347,420,-6,-22,-51,-6,-4,4,0,-3,4,1,1,1,2,0,3,3,0,1,1,-1,-9,22,1,-3,2,-2,0,-2,-1,-1,-1,-1,1,-1
KR_5600724468,420,-3,1,-12,-5,-8,8,0,0,1,1,-1,2,1,3,1,4,1,0,1,0,1,0,-4,-4,8,0,0,0,1,-1,-1,-1,3,-1
KR_6725629801,420,-1,-42,-26,2,-1,1,0,0,1,1,1,1,2,2,2,4,0,0,0,0,1,6,4,-7,3,-2,0,0,-1,1,0,1,6,-1
KR_6749399065,420,2,18,8,0,1,2,3,0,1,1,1,2,3,-3,3,0,1,0,1,0,-5,11,-1,-5,6,-3,0,1,-1,-1,1,1,4,-1
KR_6587899158,420,-1,-37,-4,-3,3,2,5,-5,5,0,-3,5,2,0,3,3,2,1,3,0,-4,-1,2,-4,2,1,0,0,-1,-1,-1,1,3,-1
KR_6645056961,420,0,-15,13,-2,2,0,2,0,1,1,-2,3,1,-4,5,1,2,1,3,0,-6,19,3,-9,6,-1,0,0,-1,1,0,-1,1,-1
KR_6733667124,420,-5,-100,-16,-14,-3,4,1,-2,7,5,-3,5,2,-6,8,2,0,1,1,0,-8,-403,-4,-1,5,0,0,-3,-1,-1,-1,-1,2,-1
KR_6480834337,420,-3,-41,-31,-2,-2,2,0,1,1,2,-3,3,0,2,2,4,0,0,0,0,4,-7,-2,-3,5,-1,0,-1,1,-1,-1,1,2,-1
KR_6740372285,420,-4,-37,-36,-4,-1,4,3,-3,3,0,-1,1,0,1,0,1,0,1,1,-1,-7,-1,-4,-3,7,1,0,0,-1,1,0,-1,4,-1
KR_6661844933,420,-6,-77,-31,-17,2,0,2,1,2,3,-2,5,3,-16,16,0,-2,2,0,0,-20,-11,-2,-3,5,1,0,-3,-1,-1,-1,-1,3,-1
KR_6604502554,420,-2,-34,12,-6,-1,1,0,1,1,2,-3,4,1,-3,4,1,0,0,0,0,-1,29,0,-3,3,-14,0,-1,-1,-1,-1,-1,3,-1
KR_6760192632,420,1,47,32,-6,2,1,3,0,3,3,0,0,0,-3,5,2,-5,8,3,1,-6,-9,0,-2,2,3,0,-1,1,-1,-1,1,1,-1
KR_6764271358,420,-3,-34,-16,-5,0,3,3,1,1,2,0,3,3,0,4,4,-6,8,2,0,-4,321,7,-10,3,-5,0,0,1,-1,0,1,4,-1
KR_6760211985,420,-2,-87,-8,2,2,0,2,0,2,2,-7,7,0,5,0,5,2,1,3,0,5,7,5,-8,3,-1,0,-1,1,1,-1,1,3,-1
KR_6531505082,420,-4,-40,-2,-12,-1,1,0,-2,5,3,-3,5,2,0,3,3,-6,6,0,0,-6,-7,-2,-7,9,-4,0,-2,0,0,-1,-1,0,-1
KR_6731824782,420,-2,-80,0,-10,0,3,3,-6,7,1,1,2,3,-7,11,4,2,1,3,-1,-6,-5,-1,-3,4,-1,0,-2,0,1,-1,1,0,-1
KR_6590729680,420,-1,-54,-10,-3,-2,2,0,-2,5,3,2,1,3,0,2,2,-1,2,1,0,3,39,0,-6,6,-3,0,0,1,-1,0,-1,2,-1
KR_6575240280,440,1,69,12,1,5,0,5,2,4,6,-2,4,2,-3,5,2,-1,1,0,0,0,-11,-2,0,2,4,0,1,-1,0,1,1,4,-1
KR_6742926847,420,-3,33,-20,-15,-2,2,0,-1,4,3,-3,6,3,-4,6,2,-5,6,1,-3,-27,-5,-4,-1,5,1,0,-3,-1,-1,-1,-1,3,-1
KR_6692576554,440,0,-44,21,1,1,0,1,4,0,4,3,2,5,-3,6,3,-4,7,3,1,-1,-19,-2,-1,3,1,0,1,-1,1,1,1,5,-1
KR_6693875350,440,1,-33,-16,6,0,0,0,-2,2,0,5,2,7,2,2,4,1,3,4,0,4,0,-1,-2,3,-1,0,0,0,0,0,1,0,-1
KR_6619395379,420,-1,-86,9,-6,-1,3,2,-1,2,1,0,1,1,-6,8,2,2,0,2,0,-10,5,-2,-2,4,0,0,-2,-1,-1,-1,-1,4,-1
KR_6760978008,420,-4,-30,1,-22,-3,3,0,-3,3,0,-7,7,0,-8,9,1,-1,1,0,-2,-27,1,-3,0,3,-1,0,-1,-1,-1,-1,-1,6,-1
KR_6678064833,420,-1,48,-1,-5,2,2,4,-3,3,0,-3,3,0,0,7,7,-1,2,1,-1,-12,9,-1,-3,4,-2,0,0,-1,-1,0,-1,5,-1
KR_6735180962,420,-2,-115,-20,-5,1,1,2,1,1,2,-7,7,0,0,1,1,0,0,0,0,-4,-6,-1,-3,4,1,0,-1,-1,1,-1,-1,3,-1
KR_6760177041,420,-3,-59,-24,-6,-2,3,1,-1,4,3,-3,4,1,1,4,5,-1,1,0,0,-2,135,-1,-2,3,20,0,-2,-1,-1,-1,1,1,-1
KR_6764083177,420,1,-32,8,6,0,1,1,1,0,1,3,1,4,0,2,2,2,1,3,1,15,52,3,-7,4,-2,0,-1,1,0,-1,1,3,-1
KR_6752043083,420,-4,-65,-9,-3,-7,8,1,0,1,1,-3,4,1,3,6,9,4,0,4,-1,4,10,-3,-1,4,-2,0,-2,-1,0,1,-1,5,-1
KR_6761929768,420,-2,-62,-24,-8,-1,2,1,0,4,4,-4,4,0,-2,3,1,-1,2,1,0,-2,-62,-1,-4,5,1,0,-2,-1,1,-1,1,6,-1
KR_6712843952,440,2,7,16,7,3,2,5,5,0,5,-5,5,0,5,0,5,-1,1,0,2,12,11,1,-4,3,2,0,-1,-1,-1,-1,1,2,-1
KR_6763378887,440,3,24,8,1,0,0,0,2,1,3,-2,2,0,1,4,5,0,0,0,0,-3,33,-2,-2,4,4,0,0,-1,1,1,-1,6,-1
KR_6739217582,420,-3,71,14,-4,-4,4,0,-1,3,2,2,1,3,-1,2,1,0,1,1,0,-5,33,3,-4,1,-2,0,2,0,1,1,-1,0,-1
KR_6688988926,420,2,60,24,3,2,1,3,-1,2,1,3,3,6,-4,6,2,3,1,4,0,6,50,-1,-2,3,-22,0,1,0,-1,1,-1,0,-1
KR_6695314728,440,0,-54,-16,3,1,1,2,1,0,1,-2,3,1,1,2,3,2,0,2,0,7,6,0,-4,4,-5,0,0,-1,-1,0,1,3,-1
KR_6718202625,420,-5,-85,-12,-10,0,0,0,-1,2,1,-4,4,0,-5,6,1,0,0,0,0,-8,-6,-5,-1,6,-1,0,-1,1,-1,-1,-1,6,-1
KR_6710522241,420,-2,-64,-22,2,-5,5,0,9,2,11,-4,5,1,2,0,2,0,0,0,1,21,1,2,-4,2,0,0,-1,1,1,-1,1,6,-1
KR_6760525076,420,-5,-64,-34,-6,-2,3,1,0,1,1,3,5,8,-5,5,0,-2,2,0,0,-8,38,0,-3,3,-20,0,-1,-1,-1,-1,1,5,-1
KR_6751144196,420,0,-94,9,-8,-5,5,0,5,3,8,-5,6,1,-2,3,1,-1,1,0,0,-6,6,-1,-3,4,-2,0,-1,1,-1,-1,-1,4,-1
KR_6649861007,420,-3,-60,4,-8,0,1,1,0,3,3,-3,4,1,-4,6,2,-1,2,1,0,-1,-1,3,-6,3,-5,0,-3,-1,-1,-1,-1,2,-1
KR_6681290229,440,0,-48,9,4,-5,6,1,2,4,6,-1,3,2,7,1,8,1,2,3,0,1,5,1,-5,4,3,0,-1,1,-1,-1,-1,3,-1
KR_6737611880,420,2,59,-13,5,4,0,4,-3,3,0,1,4,5,2,1,3,1,0,1,0,-1,3,-3,0,3,4,0,2,-1,1,1,-1,1,-1
KR_6758859584,420,0,52,-28,4,4,2,6,-1,1,0,2,3,5,-2,3,1,1,2,3,0,0,-8,3,-4,1,-1,0,1,0,-1,-1,-1,0,-1
KR_6749050982,440,2,7,12,8,0,1,1,5,2,7,-3,5,2,6,1,7,0,2,2,0,6,-1,-2,-1,3,1,0,2,1,1,1,1,2,-1
KR_6763298560,420,1,2,-8,0,-2,4,2,0,0,0,2,4,6,0,2,2,0,0,0,0,3,96,1,-6,5,0,0,0,-1,0,0,-1,6,-1
KR_6692388775,440,-1,-33,-4,3,-2,2,0,2,2,4,3,1,4,-2,4,2,2,1,3,-1,-3,2,1,-5,4,0,0,1,-1,1,1,-1,1,-1
KR_6759752705,440,-6,-29,-29,-17,-2,3,1,0,3,3,-2,4,2,-1,4,3,-12,13,1,0,-18,-4,2,-4,2,2,0,-1,1,-1,-1,-1,3,-1
KR_6746475735,420,-4,-14,-16,-12,1,0,1,-2,3,1,-1,5,4,-4,6,2,-6,6,0,-1,-8,1,5,-10,5,0,0,0,-1,-1,-1,-1,2,-1
KR_6746891818,440,-4,-106,28,-15,0,2,2,-1,1,0,-1,6,5,-14,14,0,1,1,2,0,-12,4,1,-4,3,-4,0,-2,-1,-1,-1,-1,3,-1
KR_6616757838,420,0,-36,-4,-2,-1,1,0,0,1,1,-1,2,1,0,1,1,0,3,3,0,3,-1,4,-7,3,-1,0,0,-1,-1,0,-1,2,-1
KR_6722205020,420,0,16,-4,7,-1,2,1,-3,3,0,1,1,2,3,4,7,7,1,8,0,11,-6,-1,-2,3,1,0,0,1,-1,1,1,5,-1
KR_6751808761,420,1,30,-24,4,1,1,2,2,1,3,-2,7,5,3,4,7,0,1,1,0,2,-4,2,-3,1,0,0,0,-1,1,1,1,5,-1
KR_6762713397,420,-3,-82,-17,-6,-5,5,0,-3,3,0,0,2,2,3,1,4,-1,5,4,0,-2,-2,3,-6,3,-1,0,-1,-1,-1,-1,1,3,-1
KR_6640803483,420,-1,6,-23,0,4,0,4,-3,6,3,2,2,4,-1,3,2,-2,2,0,0,1,11,5,-7,2,-4,0,0,1,-1,0,1,1,-1
KR_6755746864,420,-1,17,-4,-3,1,0,1,0,2,2,-3,5,2,-1,2,1,0,1,1,0,-4,-2,0,-5,5,-2,0,0,-1,-1,-1,-1,2,-1
KR_6751133903,420,-1,-31,-21,-1,-6,6,0,1,1,2,-2,4,2,4,2,6,2,3,5,1,3,17,-2,-3,5,-4,0,-1,-1,-1,-1,1,5,-1
KR_6760869329,420,2,-26,0,3,-2,2,0,-3,4,1,2,4,6,3,3,6,3,1,4,0,-3,9,1,-4,3,-1,0,0,-1,-1,0,1,4,-1
KR_6753304164,440,-4,-105,-27,-13,-1,1,0,-4,6,2,-4,5,1,-3,7,4,-1,1,0,0,-11,-10,-4,-4,8,-1,0,-1,-1,-1,-1,-1,6,-1
KR_6759285118,420,-1,-47,5,-3,4,0,4,-2,2,0,-1,1,0,-5,7,2,1,0,1,0,-1,-27,-3,-2,5,-4,0,0,-1,1,0,1,1,-1
KR_6758025832,420,5,53,5,9,4,1,5,-1,6,5,2,2,4,2,3,5,2,2,4,0,7,3,3,-7,4,5,0,0,1,-1,1,1,5,-1
KR_6673526859,420,-3,-54,-35,-5,1,0,1,-2,2,0,-2,2,0,-2,3,1,0,0,0,0,-2,-172,-3,-1,4,0,0,0,-1,1,-1,1,6,-1
KR_6739579355,420,1,-32,-8,0,-2,3,1,0,0,0,2,1,3,2,1,3,-2,4,2,0,1,-28,-1,-4,5,4,0,-1,-1,-1,-1,-1,4,-1
KR_6761259395,420,0,-45,0,2,-2,4,2,1,8,9,4,0,4,-1,2,1,0,0,0,0,6,261,-3,-2,5,-1,0,-1,1,-1,-1,1,2,-1
KR_6683113542,420,-2,-50,8,0,0,3,3,1,0,1,5,3,8,-4,4,0,-2,2,0,-1,0,-1,-1,-3,4,2,0,0,0,1,-1,-1,0,-1
KR_6742515516,420,-8,-115,-31,-14,-2,3,1,-1,1,0,-12,13,1,2,1,3,-1,2,1,0,-12,-10,-1,-2,3,-3,0,-2,1,0,-1,-1,1,-1
KR_6687360298,420,0,-33,20,0,-3,5,2,4,0,4,-2,5,3,0,3,3,1,1,2,1,0,-2,0,-5,5,-1,0,0,-1,1,-1,-1,4,-1
KR_6754796097,440,-5,-72,-32,-9,-2,2,0,-2,2,0,-9,11,2,4,0,4,0,2,2,0,-1,3,2,-4,2,1,0,0,-1,-1,-1,1,6,-1
KR_6713548690,420,-3,9,-24,-6,5,1,6,1,1,2,-7,7,0,0,1,1,-5,8,3,0,-12,-3,3,-6,3,-1,0,2,-1,1,1,1,3,-1
KR_6688891053,420,-1,-5,-5,0,2,3,5,-4,4,0,0,2,2,-1,3,2,3,1,4,1,-7,-47,1,-5,4,25,0,1,1,1,1,1,4,-1
KR_6755797401,440,-3,-86,-15,-9,-1,2,1,-4,4,0,-4,6,2,-1,2,1,1,1,2,0,-1,-4,-3,-4,7,-1,0,0,-1,0,0,1,5,-1
KR_6713300784,420,-2,-72,-44,4,-1,2,1,-2,3,1,2,1,3,4,0,4,1,1,2,0,5,-4,-2,-2,4,0,0,-1,-1,-1,-1,1,3,-1
KR_6757688072,420,2,32,15,3,1,1,2,-3,4,1,3,0,3,2,0,2,0,3,3,0,7,-1,-1,-3,4,-2,0,1,-1,-1,1,1,2,-1
KR_6762206881,420,2,-19,28,-2,0,2,2,0,6,6,3,0,3,-6,11,5,1,2,3,0,-1,21,-2,-1,3,1,0,0,-1,0,-1,-1,5,-1
KR_6725027798,420,-4,-50,-4,-2,1,1,2,2,1,3,-3,6,3,-2,5,3,0,0,0,0,3,-2,-3,-3,6,22,0,-2,-1,-1,-1,-1,1,-1
KR_6759855766,420,-2,7,-12,-7,2,1,3,-1,3,2,-2,3,1,-5,6,1,-1,1,0,-1,-5,45,6,-6,0,-3,0,-1,-1,1,-1,-1,2,-1
KR_6761212571,420,-2,-99,-28,-1,-4,6,2,1,1,2,-1,6,5,3,0,3,0,0,0,2,12,7,-1,-3,4,0,0,-3,-1,-1,-1,1,6,-1
KR_6629598069,420,1,27,20,-4,-2,2,0,-4,5,1,2,1,3,0,2,2,0,1,1,0,-2,-2,-2,-3,5,2,0,0,-1,1,0,1,4,-1
KR_6570208441,420,-3,-16,-44,0,1,2,3,-1,3,2,5,0,5,1,1,2,-6,6,0,0,6,47,5,-8,3,-3,0,-1,-1,1,-1,1,6,-1
KR_6614321860,420,0,29,-28,0,-2,2,0,-2,5,3,1,0,1,3,0,3,0,1,1,0,0,-2,0,-3,3,-1,0,-1,-1,-1,-1,1,4,-1
KR_6741869733,440,-5,-88,11,-14,-4,4,0,-1,4,3,-4,4,0,-4,4,0,-1,1,0,-2,-16,12,-1,-4,5,-2,0,-2,0,0,-1,-1,0,-1
KR_6676856150,420,-7,-40,-17,-15,-4,4,0,-4,4,0,-2,4,2,-6,6,0,1,0,1,0,-10,-17,-4,0,4,-2,0,-2,-1,-1,-1,-1,5,-1
KR_6705618129,420,-4,-24,-13,-2,4,2,6,-3,5,2,0,1,1,-2,5,3,-1,1,0,1,-6,1,-2,-3,5,-1,0,-1,1,-1,-1,1,6,-1
KR_6750127379,420,-5,-12,-12,-11,-2,3,1,-5,5,0,-2,3,1,-2,2,0,0,1,1,0,-5,17,2,-5,3,-6,0,-3,-1,-1,-1,1,3,-1
KR_6590814217,420,-2,-37,17,3,1,2,3,2,0,2,0,3,3,0,2,2,0,0,0,1,2,-3,1,-6,5,0,0,0,1,1,-1,1,3,-1
KR_6740005247,420,-2,21,-25,-3,3,0,3,-4,6,2,-2,4,2,0,5,5,0,0,0,-2,-10,208,3,-7,4,-1,0,1,-1,-1,1,-1,6,-1
KR_6695431068,440,-6,-121,-21,-17,-3,4,1,-6,7,1,-9,10,1,0,5,5,1,1,2,0,-1,-9,0,-3,3,-2,0,-3,0,-1,-1,1,0,-1
KR_6764298065,420,0,56,-32,0,-8,8,0,1,1,2,4,0,4,3,1,4,0,1,1,1,5,-11,1,-3,2,1,0,1,-1,-1,-1,1,3,-1
KR_6764085682,420,-3,-71,20,-5,5,0,5,-1,2,1,-1,4,3,-6,6,0,-2,2,0,-1,-6,-3,-4,-4,8,0,0,1,1,1,1,-1,2,-1
KR_6748293988,420,-3,-18,-16,-4,-3,4,1,-4,4,0,1,0,1,1,0,1,1,0,1,0,-2,4,4,-6,2,2,0,0,-1,-1,-1,1,4,-1
KR_6657028126,420,-1,48,-48,1,1,0,1,0,5,5,3,2,5,-2,3,1,-1,1,0,0,0,-2,3,-7,4,4,0,0,-1,-1,0,-1,2,-1
KR_6733421229,420,-1,24,0,-2,1,0,1,-3,6,3,-5,6,1,3,3,6,2,1,3,-1,1,-10,-1,-1,2,1,0,1,-1,0,1,-1,1,-1
KR_6752256500,440,-2,-9,-40,-9,-1,1,0,-2,3,1,-4,4,0,-2,5,3,0,2,2,0,-12,-6,-4,-2,6,-4,0,-1,-1,0,-1,-1,4,-1
KR_6657237605,420,-4,-36,-15,-8,0,2,2,-4,6,2,-1,1,0,-4,9,5,1,0,1,1,-6,4,-1,-3,4,-2,0,0,-1,-1,-1,1,1,-1
KR_6745023389,420,-1,-16,24,0,-1,3,2,2,0,2,3,0,3,-8,9,1,4,1,5,2,4,4,5,-7,2,-1,0,1,1,1,1,1,4,-1
KR_6720517635,420,-2,-35,-20,-6,-3,3,0,-3,4,1,-5,6,1,0,4,4,5,0,5,0,-6,4,0,-3,3,1,0,-1,-1,0,-1,-1,5,-1
KR_6704993916,420,-4,9,12,-8,-2,3,1,0,2,2,-6,7,1,0,3,3,0,1,1,0,-10,21,7,-9,2,-8,0,-1,-1,-1,-1,-1,6,-1
KR_6738303132,440,0,-79,7,0,-1,1,0,3,0,3,-2,3,1,1,1,2,-1,2,1,0,8,-8,2,-7,5,4,0,0,1,-1,-1,-1,4,-1
KR_6606083897,420,0,-15,-24,5,-1,3,2,1,2,3,2,1,3,5,0,5,-2,4,2,0,4,-5,2,-3,1,1,0,-2,1,-1,-1,-1,4,-1
KR_6421345726,420,-6,-90,-12,-15,-1,1,0,-3,5,2,-3,3,0,-6,8,2,-2,3,1,-2,-21,-55,0,-5,5,-6,0,-3,-1,-1,-1,-1,2,-1
KR_6667929566,420,0,-30,6,1,2,1,3,-1,3,2,-2,4,2,2,0,2,0,2,2,0,2,153,-2,-4,6,2,0,-1,-1,0,-1,1,3,-1
KR_6759095307,420,0,-76,20,1,-2,3,1,4,1,5,-1,2,1,0,3,3,0,0,0,0,9,10,1,-5,4,0,0,0,1,0,0,-1,4,-1
KR_6726765962,420,5,14,33,3,-1,1,0,4,1,5,2,1,3,-3,5,2,1,1,2,0,-1,278,2,-5,3,-5,0,1,1,1,1,-1,5,-1
KR_6732431440,420,0,15,8,-3,3,0,3,-6,7,1,1,2,3,-4,7,3,3,0,3,0,-1,-8,-5,-4,9,8,0,0,-1,0,-1,-1,3,-1
KR_6764291339,420,-6,0,-31,-19,-6,7,1,-4,9,5,1,1,2,-6,8,2,-4,5,1,0,-14,1,-2,-3,5,1,0,-1,-1,-1,-1,-1,1,-1
KR_6739387274,420,1,-54,0,2,2,3,5,2,2,4,-1,4,3,0,2,2,-1,2,1,0,5,6,3,-6,3,-1,0,0,0,0,0,1,0,-1
KR_6642716246,420,-3,-77,9,-5,-2,2,0,-3,3,0,0,1,1,0,0,0,0,2,2,0,-6,-6,0,-3,3,-2,0,-1,-1,-1,-1,1,4,-1
KR_6582757960,420,-5,32,-59,-10,-4,4,0,-2,2,0,0,1,1,-2,4,2,-2,3,1,0,-7,23,-2,-2,4,-3,0,-1,-1,-1,-1,-1,6,-1
KR_6523248740,420,0,13,14,-4,-5,5,0,-1,5,4,0,2,2,2,4,6,0,0,0,0,-5,327,-2,-2,4,-5,0,-1,1,1,-1,1,1,-1
KR_6636055181,420,-7,-72,-60,-17,-5,6,1,-4,4,0,-6,9,3,-1,9,8,-1,3,2,-3,-7,-4,-4,-3,7,2,0,-3,-1,-1,-1,1,1,-1
KR_6635759439,420,-3,-85,-3,-5,0,1,1,2,0,2,-4,5,1,-2,2,0,-1,1,0,0,1,-6,0,-4,4,3,0,-3,1,-1,-1,-1,6,-1
KR_6729813509,440,0,-4,4,1,-2,4,2,-4,5,1,2,2,4,3,2,5,2,2,4,1,5,9,-1,-6,7,-4,0,0,-1,1,1,1,4,-1
KR_6614356376,420,0,14,-12,-1,-2,2,0,0,0,0,1,2,3,1,0,1,-1,2,1,0,-5,224,0,-2,2,-4,0,-1,0,1,1,1,0,-1
KR_6716776629,420,-1,-6,32,-4,-2,4,2,-2,5,3,0,2,2,2,0,2,-2,2,0,0,-2,3,-2,-3,5,-2,0,0,0,-1,-1,-1,0,-1
KR_6755852217,420,-2,-17,-32,-4,-1,4,3,-3,4,1,1,1,2,-1,1,0,0,0,0,0,-4,38,1,-5,4,-10,0,0,1,-1,0,-1,6,-1
KR_6605680621,420,0,14,0,-8,1,1,2,-7,9,2,0,2,2,-1,3,2,-1,1,0,0,-10,-14,1,-6,5,-1,0,-1,1,-1,-1,-1,4,-1
KR_6648894228,420,-4,-77,20,-8,-3,3,0,0,5,5,-5,5,0,-2,8,6,2,1,3,0,-11,2,-2,-4,6,0,0,-1,1,1,-1,1,5,-1
KR_6757559138,440,-6,-95,-12,-18,-4,5,1,-3,6,3,-7,7,0,-2,5,3,-2,4,2,0,-16,-40,-3,-2,5,-5,0,-3,0,-1,-1,-1,0,-1
KR_6578535472,420,0,10,-4,-1,-1,3,2,-1,2,1,1,1,2,0,3,3,0,1,1,0,-3,2,-2,-3,5,-2,0,-1,1,-1,-1,1,2,-1
KR_6642392839,420,-4,8,-16,-7,-4,5,1,-4,5,1,2,1,3,1,1,2,-2,3,1,0,-7,2,0,-2,2,0,0,-1,-1,0,-1,1,2,-1
KR_6723028080,420,2,20,-3,1,1,3,4,1,1,2,-6,9,3,1,2,3,4,2,6,0,-6,6,-1,-4,5,0,0,1,1,0,1,-1,3,-1
KR_6655732404,420,-1,-46,-20,0,2,1,3,-1,3,2,0,2,2,-2,2,0,1,2,3,0,-1,11,5,-9,4,3,0,0,-1,-1,1,1,4,-1
KR_6737749731,420,-3,0,-20,-5,0,3,3,-4,7,3,0,1,1,0,3,3,-1,1,0,0,-3,7,-4,-1,5,-3,0,0,1,-1,0,1,5,-1
KR_6764530160,440,-3,-100,0,-10,-4,5,1,-7,7,0,0,1,1,-1,1,0,2,0,2,0,-7,39,-4,-3,7,-23,0,-1,-1,0,-1,-1,3,-1
KR_6735831350,420,1,12,-20,4,3,0,3,-1,5,4,0,3,3,2,4,6,0,0,0,0,4,-6,-4,-4,8,-7,0,1,1,1,1,1,4,-1
KR_6472183209,420,-4,-74,12,-15,-4,4,0,-1,6,5,-7,8,1,-2,2,0,-1,2,1,-1,-18,-199,1,-4,3,-4,0,-1,-1,0,-1,1,2,-1
KR_6761300097,440,-3,-68,-52,-1,0,0,0,-3,4,1,0,2,2,1,3,4,1,1,2,-2,-8,18,2,-6,4,-30,0,0,-1,0,0,-1,2,-1
KR_6751747600,420,-2,-23,12,4,2,3,5,3,2,5,2,1,3,-3,4,1,0,1,1,-1,0,-1,-3,0,3,1,0,1,1,1,1,-1,6,-1
KR_6748698798,420,0,-62,-10,2,1,0,1,0,3,3,3,0,3,-2,3,1,0,1,1,0,2,49,2,-3,1,-3,0,-1,-1,0,-1,1,4,-1
KR_6495534639,420,0,-67,-24,-4,1,2,3,-3,4,1,1,0,1,-3,3,0,0,2,2,-1,-7,4,-2,-1,3,-2,0,0,-1,1,-1,-1,1,-1
KR_6737692024,420,-2,8,-4,-5,5,1,6,-3,5,2,-3,4,1,-3,3,0,-1,1,0,1,-7,-5,-4,-3,7,2,0,0,-1,-1,-1,1,4,-1
KR_6743195899,420,-1,-1,28,-4,-3,3,0,0,2,2,-1,2,1,-3,4,1,3,1,4,-1,0,7,0,-3,3,1,0,0,1,-1,0,-1,3,-1
KR_6761623149,420,-1,-79,-4,0,-2,3,1,2,2,4,2,2,4,-2,2,0,0,0,0,0,3,-18,-2,-3,5,3,0,-2,-1,1,-1,-1,2,-1
KR_6752249793,420,0,-39,-33,0,-3,5,2,-7,9,2,-1,3,2,11,1,12,0,1,1,-3,-5,53,-1,-3,4,-1,0,-2,1,-1,-1,-1,1,-1
KR_6700083240,420,0,-30,-4,-2,4,1,5,1,1,2,-2,4,2,-3,3,0,-2,4,2,0,-4,-6,-3,-3,6,0,0,1,-1,1,1,-1,2,-1
KR_6747385291,420,-2,-17,2,-8,2,2,4,-6,6,0,-6,7,1,0,2,2,2,1,3,-1,-6,-3,-3,-3,6,1,0,-1,-1,-1,-1,-1,1,-1
KR_6281546927,420,-1,-46,16,-4,2,0,2,3,1,4,-1,4,3,-7,9,2,-1,1,0,0,-2,-14,8,-9,1,2,0,-2,-1,0,-1,1,3,-1
KR_6695461237,420,-4,-89,-17,-13,-6,7,1,1,1,2,-2,6,4,-3,6,3,-3,5,2,-1,-15,-10,-3,0,3,1,0,-3,0,-1,-1,-1,0,-1
KR_6647828839,420,1,-14,-4,0,3,1,4,-1,4,3,1,1,2,-1,2,1,-2,3,1,0,-7,5,3,-5,2,-1,0,0,-1,1,1,1,5,-1
KR_6642243053,420,-2,17,-14,-6,-5,5,0,-2,5,3,3,1,4,-2,3,1,0,0,0,0,-6,4,-1,-3,4,5,0,0,1,1,0,-1,4,-1
KR_6678164930,420,-5,-121,-40,-10,-1,1,0,-6,7,1,-1,3,2,0,2,2,-2,3,1,-2,1,7,-5,-2,7,0,0,-1,1,-1,-1,-1,2,-1
KR_6764119387,420,-2,-91,-12,-8,-1,1,0,-3,5,2,-2,2,0,-2,3,1,0,0,0,0,-9,-6,-1,-1,2,1,0,0,-1,-1,0,1,5,-1
KR_6701897272,420,0,-15,16,-7,-1,3,2,0,4,4,-2,3,1,-1,3,2,-3,3,0,0,-14,-11,0,-5,5,-2,0,0,1,1,0,-1,5,-1
KR_6504416069,420,-4,-52,-16,-10,-1,1,0,-5,7,2,-1,3,2,-3,4,1,0,0,0,0,-14,-32,3,-7,4,0,0,0,-1,-1,-1,-1,5,-1
KR_6749884178,420,-2,-53,-15,-3,1,1,2,-1,3,2,-4,4,0,-1,1,0,2,1,3,0,-8,-26,1,-4,3,0,0,0,1,-1,0,-1,2,-1
KR_6763528419,420,1,30,-18,10,1,2,3,1,1,2,5,0,5,1,3,4,2,0,2,1,12,-9,4,-6,2,-2,0,0,1,1,0,1,5,-1
KR_6627339821,420,3,5,60,2,-5,5,0,0,1,1,-1,3,2,5,1,6,3,1,4,0,7,-245,-2,-2,4,-2,0,1,1,-1,1,-1,6,-1
KR_6762223729,420,-4,-10,0,-10,-6,6,0,-2,2,0,0,1,1,-2,4,2,0,2,2,0,-8,-12,2,-5,3,0,0,-2,-1,-1,-1,-1,1,-1
KR_6610547266,420,-4,-42,-18,-9,-1,3,2,1,4,5,-3,4,1,-7,8,1,1,0,1,0,-11,-33,-3,-2,5,5,0,-3,1,-1,-1,-1,1,-1
KR_6728453784,420,-3,28,-30,0,-3,3,0,4,3,7,-2,4,2,1,2,3,0,1,1,-1,7,-27,-3,-3,6,0,0,1,-1,1,1,-1,4,-1
KR_6729586769,420,-1,-5,10,-2,-1,1,0,3,1,4,2,2,4,-4,6,2,-2,2,0,-1,-6,220,1,-7,6,0,0,1,-1,1,1,-1,2,-1
KR_6683567163,420,-2,-40,-4,-3,1,4,5,1,0,1,-6,7,1,2,1,3,-1,1,0,0,-2,-12,-5,0,5,2,0,-1,1,-1,-1,1,5,-1
KR_6713522187,420,-3,-32,-8,-12,-3,3,0,0,4,4,-2,3,1,-2,2,0,-5,5,0,0,-7,-15,-3,-3,6,0,0,-1,-1,1,-1,-1,4,-1
KR_6752239994,420,-4,-50,17,-14,-4,5,1,-3,4,1,-3,5,2,-4,6,2,0,2,2,0,-5,-6,-4,-2,6,-1,0,-2,-1,-1,-1,-1,5,-1
KR_6614659561,420,-3,10,-8,-4,-2,4,2,-2,4,2,4,0,4,-4,5,1,0,1,1,-2,-14,2,4,-8,4,-8,0,-2,-1,-1,-1,-1,5,-1
KR_6673041862,420,2,-7,7,-3,1,2,3,-3,4,1,0,3,3,-1,3,2,0,0,0,-1,-9,9,-5,-3,8,-4,0,1,-1,-1,1,-1,6,-1
KR_6741958395,420,-3,-46,-12,-8,-5,6,1,-3,4,1,3,2,5,-4,5,1,1,1,2,-1,-1,-116,0,-5,5,0,0,0,-1,-1,0,-1,6,-1
KR_5646953670,420,-4,-13,-17,-7,0,3,3,2,3,5,-3,4,1,-4,8,4,-2,2,0,-1,-16,226,3,-5,2,0,0,1,-1,1,1,-1,6,-1
KR_6713956278,420,-2,-65,-20,-8,-1,1,0,-3,5,2,-1,3,2,-1,3,2,-2,2,0,-2,-12,1,0,-3,3,0,0,-1,-1,-1,-1,-1,3,-1
KR_6750822928,420,-1,-64,-4,-12,-4,4,0,2,3,5,-3,4,1,-9,9,0,2,1,3,0,-12,-3,2,-5,3,1,0,-1,1,1,-1,-1,6,-1
KR_6761819858,440,-4,-96,-28,-13,-5,7,2,1,2,3,0,2,2,-9,10,1,0,0,0,-1,-9,-11,-7,-2,9,2,0,-2,-1,-1,-1,-1,1,-1
KR_6759560044,440,0,21,-41,-1,2,0,2,0,4,4,0,2,2,-4,7,3,1,2,3,0,-4,11,0,-3,3,-2,0,0,-1,-1,0,-1,2,-1
KR_6761321631,420,2,19,3,4,-3,6,3,1,0,1,1,3,4,5,0,5,0,0,0,0,10,1,5,-5,0,1,0,0,-1,-1,-1,1,3,-1
KR_6759700365,420,-3,-38,-13,-5,-1,2,1,1,1,2,-2,2,0,-1,1,0,-2,2,0,0,-7,15,-3,-1,4,-1,0,-1,-1,1,-1,1,4,-1
KR_6731860914,420,-2,42,0,-2,3,1,4,-3,7,4,-2,5,3,1,0,1,-1,1,0,0,3,24,4,-5,1,0,0,0,1,-1,0,-1,1,-1
KR_6732987121,420,5,61,-11,4,2,0,2,0,2,2,0,2,2,0,2,2,2,0,2,-1,5,11,2,-3,1,-1,0,4,1,1,1,1,6,-1
KR_6652308981,420,1,-12,-4,3,2,1,3,-2,3,1,-1,3,2,2,1,3,2,1,3,0,2,6,2,-4,2,-3,0,0,-1,-1,0,-1,6,-1
KR_6762744958,420,-2,53,8,-3,-2,3,1,1,1,2,-3,3,0,1,0,1,0,0,0,0,-6,-17,0,-7,7,0,0,0,1,-1,0,1,5,-1
KR_6738493630,420,1,6,-13,0,1,1,2,-3,5,2,3,2,5,-1,1,0,0,0,0,1,-2,10,3,-5,2,0,0,0,-1,1,1,1,2,-1
KR_6688808899,440,-1,-37,-32,2,2,1,3,-1,2,1,3,1,4,-1,1,0,-1,3,2,0,4,-4,-4,-3,7,5,0,-1,1,-1,1,1,1,-1
KR_6647186573,420,-2,-52,-20,-8,-2,3,1,0,3,3,-4,5,1,-2,4,2,0,2,2,-1,-18,0,-4,-4,8,3,0,-1,-1,-1,-1,-1,2,-1
KR_6757146714,420,2,26,8,-1,-4,4,0,-2,2,0,0,2,2,1,2,3,4,0,4,0,-1,-123,-2,-3,5,-1,0,0,1,-1,1,-1,1,-1
KR_6761855439,420,-7,-71,-8,-17,-6,6,0,-3,3,0,-6,8,2,1,5,6,-3,3,0,1,-17,-3,-3,-4,7,-3,0,0,-1,1,-1,1,3,-1
KR_6749442286,420,-1,19,-4,-5,-2,2,0,-3,3,0,0,1,1,0,5,5,0,2,2,0,-5,-307,-4,-3,7,-1,0,0,1,-1,-1,-1,1,-1
KR_6662778794,420,0,-84,-11,1,0,2,2,0,2,2,-3,3,0,3,2,5,1,0,1,0,7,1,-6,-1,7,1,0,-1,1,-1,-1,-1,1,-1
KR_6736642058,420,0,-30,11,-1,-1,2,1,1,5,6,1,2,3,0,2,2,-2,2,0,0,-4,-21,3,-7,4,6,0,-1,1,-1,-1,1,3,-1
KR_6762832285,420,3,14,-8,4,1,0,1,-2,3,1,3,0,3,-3,3,0,5,0,5,0,2,155,5,-6,1,1,0,0,-1,1,1,1,2,-1
KR_6730979883,420,-1,-5,24,2,-1,2,1,-7,7,0,2,2,4,6,0,6,2,0,2,0,-1,19,-1,-4,5,-1,0,1,1,-1,1,1,1,-1
KR_6753542814,420,1,-23,-12,2,6,0,6,-2,3,1,-5,5,0,0,1,1,3,0,3,0,2,-15,-6,-2,8,0,0,0,-1,-1,-1,1,2,-1
KR_6764260353,420,0,-25,7,2,-2,2,0,3,3,6,-1,2,1,0,4,4,2,1,3,0,4,0,2,-3,1,-1,0,-1,0,1,-1,-1,0,-1
KR_6707745440,420,-3,32,-12,0,1,3,4,2,2,4,2,1,3,-1,3,2,-4,4,0,0,-5,-189,-2,-4,6,1,0,1,-1,1,1,1,2,-1
KR_6656099704,420,-3,-65,-26,-5,0,1,1,1,6,7,-2,4,2,-2,3,1,-2,2,0,0,1,2,2,-6,4,-3,0,-1,-1,-1,-1,-1,6,-1
KR_6679363292,420,3,-50,15,9,-2,2,0,1,1,2,0,1,1,6,3,9,4,1,5,1,11,12,-2,-5,7,-2,0,-1,1,-1,-1,1,4,-1
KR_6739017383,420,-2,-70,1,-6,-1,4,3,-2,4,2,0,2,2,-3,5,2,0,0,0,0,-6,-10,-2,-2,4,-1,0,-2,-1,-1,-1,-1,4,-1
KR_6689825141,420,-3,-15,-19,-7,2,0,2,-7,10,3,2,2,4,-4,6,2,0,0,0,0,4,6,0,-6,6,-3,0,2,-1,1,1,-1,3,-1
KR_6756567043,420,-1,30,18,11,-1,2,1,5,1,6,5,1,6,3,5,8,-1,1,0,1,15,-371,4,-6,2,-1,0,0,1,-1,-1,1,1,-1
KR_6636532019,420,-5,-71,-33,-7,0,4,4,0,2,2,-2,4,2,-3,3,0,-2,2,0,-1,1,-146,-2,-4,6,-1,0,-1,-1,1,-1,-1,5,-1
KR_6681237257,420,-2,-54,6,-7,-1,1,0,2,1,3,4,0,4,-11,11,0,-1,3,2,0,-11,-7,3,-4,1,3,0,-4,-1,-1,-1,-1,3,-1
KR_6763493676,420,-2,30,-48,-2,5,0,5,0,4,4,-7,9,2,0,2,2,0,1,1,-1,-1,8,-2,-2,4,0,0,0,1,0,1,-1,1,-1
KR_6716502497,420,-4,18,-16,-11,-1,1,0,0,4,4,-1,2,1,-8,8,0,-1,1,0,1,-9,297,2,-6,4,-4,0,0,-1,1,0,1,5,-1
KR_6752139305,440,-5,-40,-34,-17,-3,4,1,-3,4,1,-3,4,1,-6,6,0,-2,2,0,0,-13,17,1,-6,5,0,0,-1,-1,-1,-1,-1,3,-1
KR_6737952685,420,-3,-66,-4,-10,-2,4,2,0,2,2,-2,3,1,-4,8,4,-2,2,0,-1,-11,-10,-2,-2,4,1,0,-3,-1,-1,-1,-1,2,-1
KR_6461728301,420,-5,-51,7,-11,-1,3,2,-2,5,3,0,1,1,-2,4,2,-6,7,1,0,-8,-60,-3,-2,5,27,0,-2,1,-1,-1,1,6,-1
KR_6760582964,420,-3,-31,-16,1,4,0,4,1,0,1,1,1,2,-2,2,0,-3,4,1,0,0,-49,-6,-2,8,28,0,-1,0,1,-1,1,0,-1
KR_6688508940,420,-3,-8,-23,-2,-4,4,0,0,2,2,-1,3,2,2,1,3,1,4,5,0,3,165,-2,-5,7,1,0,0,1,-1,1,-1,6,-1
KR_6731183995,440,-4,-6,-23,-11,0,1,1,-4,4,0,-4,7,3,-2,4,2,-1,2,1,0,-9,31,-2,-2,4,-26,0,0,1,-1,-1,-1,6,-1
KR_6273103956,440,-6,-54,8,-15,0,2,2,-3,4,1,-1,3,2,-9,9,0,-2,2,0,-1,-21,2,-4,-5,9,4,0,-2,-1,-1,-1,-1,2,-1
KR_6661830264,420,-1,-20,11,-4,0,0,0,-3,5,2,0,2,2,-1,3,2,0,0,0,0,-3,6,-3,-2,5,1,0,1,-1,-1,1,1,3,-1
KR_6764179797,420,0,13,8,-3,1,1,2,-2,4,2,-2,3,1,-1,1,0,1,0,1,0,-2,-3,-3,-6,9,-1,0,-1,1,-1,-1,-1,1,-1
KR_6741024277,420,-1,-63,10,-8,-1,5,4,4,0,4,-2,2,0,-9,10,1,0,0,0,0,-8,35,0,-3,3,-15,0,0,0,0,-1,-1,0,-1
KR_6760632179,420,2,23,5,0,1,1,2,-5,7,2,3,1,4,-2,3,1,3,2,5,0,-9,-29,-2,-6,8,-1,0,0,-1,-1,0,-1,1,-1
KR_6756694689,420,-1,5,16,-8,1,1,2,-5,9,4,2,0,2,-5,6,1,-1,1,0,0,-11,6,1,-4,3,-3,0,0,0,0,0,-1,0,-1
KR_6764490909,440,-2,-74,-8,-1,1,0,1,-6,7,1,0,1,1,5,2,7,-1,3,2,0,-1,-13,2,-5,3,0,0,-1,1,0,-1,1,5,-1
KR_6684633186,420,-2,-15,-26,-3,-3,4,1,-3,4,1,-1,4,3,2,2,4,2,0,2,0,5,-1,-1,-3,4,-1,0,-2,-1,-1,-1,1,2,-1
KR_6656125995,420,-1,42,-35,-3,0,0,0,-4,7,3,-1,6,5,1,3,4,1,0,1,0,0,21,1,-9,8,6,0,-1,1,-1,-1,-1,6,-1
KR_6761394554,420,-2,-6,7,-11,-4,4,0,-2,2,0,-1,4,3,-5,6,1,1,0,1,0,-4,4,1,-5,4,0,0,-1,-1,-1,-1,-1,3,-1
KR_6744160644,420,-3,-39,-19,-13,-3,5,2,1,2,3,0,1,1,0,1,1,-11,11,0,0,-6,8,1,-4,3,-3,0,-1,-1,-1,-1,-1,6,-1
KR_6763047966,420,-2,-36,20,-6,-2,2,0,1,3,4,1,1,2,-2,4,2,-4,6,2,0,-1,-12,-1,-5,6,3,0,0,1,-1,0,1,2,-1
KR_6764357589,420,-2,26,-3,-10,-2,3,1,1,5,6,-2,2,0,-6,6,0,-1,3,2,0,-9,147,2,-4,2,-1,0,-1,-1,-1,-1,-1,2,-1
KR_6752283516,420,-5,-79,-3,-6,-2,3,1,-2,2,0,1,1,2,-3,4,1,0,0,0,0,-7,-3,-4,-2,6,-1,0,-2,-1,-1,-1,-1,5,-1
KR_6763605587,420,-1,21,-48,-6,3,0,3,-4,6,2,4,2,6,-5,9,4,-4,7,3,-1,-2,-27,0,-5,5,-2,0,1,-1,1,1,1,2,-1
KR_6764432997,440,-3,-164,-9,-11,0,1,1,0,2,2,-6,6,0,-4,4,0,-1,1,0,0,-5,2,4,-5,1,-3,0,0,0,-1,0,-1,0,-1
KR_6743305310,420,-2,15,17,-5,-3,3,0,-8,9,1,4,1,5,1,2,3,1,0,1,0,-8,-16,1,-4,3,4,0,-1,1,0,-1,-1,1,-1
KR_6754928419,420,1,-35,-25,1,3,1,4,-2,4,2,-4,6,2,0,2,2,4,0,4,0,-1,0,-2,-3,5,5,0,1,-1,1,1,-1,5,-1
KR_6744647506,420,2,31,20,-1,3,0,3,-1,1,0,1,2,3,-3,5,2,-1,2,1,0,-1,6,1,-7,6,-1,0,0,-1,1,1,-1,5,-1
KR_6709102603,420,-3,-11,-20,-2,-1,2,1,-1,2,1,2,1,3,-1,3,2,-1,1,0,1,-3,-44,-6,-1,7,4,0,0,-1,0,0,1,3,-1
KR_6580265809,440,3,-7,10,3,2,1,3,3,2,5,-5,5,0,1,2,3,2,1,3,0,6,-8,-1,-4,5,0,0,0,-1,1,1,-1,5,-1
KR_6738601095,440,0,36,-21,-6,-5,5,0,1,0,1,-5,6,1,2,1,3,1,1,2,0,-4,0,0,-5,5,-1,0,0,-1,1,0,-1,5,-1
KR_6442152999,420,0,-3,-16,1,-2,2,0,3,0,3,3,1,4,-2,2,0,-1,1,0,-1,-3,16,0,-5,5,-2,0,0,1,-1,0,-1,1,-1
KR_6752267017,420,-4,-20,-19,-4,-1,2,1,-3,8,5,-6,7,1,4,1,5,2,0,2,0,-2,4,-5,-1,6,-5,0,0,-1,0,0,1,5,-1
KR_6624804292,420,-3,-27,13,-11,0,1,1,0,4,4,-5,7,2,-3,4,1,-3,3,0,0,-9,6,-5,-1,6,3,0,0,-1,-1,-1,-1,4,-1
KR_6645222346,420,1,-47,36,8,0,2,2,0,0,0,-3,5,2,8,2,10,3,1,4,2,23,-44,-1,-1,2,3,0,0,1,1,0,1,2,-1
KR_6425936056,420,-2,-12,5,-1,2,1,3,-5,5,0,3,0,3,0,1,1,-1,3,2,-1,-5,-7,-4,-3,7,-1,0,0,-1,1,0,-1,4,-1
KR_6752517032,420,0,-19,-4,3,-1,1,0,1,1,2,-2,5,3,1,1,2,4,0,4,0,7,-119,-4,-2,6,-1,0,0,-1,-1,-1,1,6,-1
KR_6764190330,420,0,10,5,0,-1,2,1,0,4,4,-1,3,2,2,1,3,0,0,0,0,9,102,1,-5,4,3,0,0,1,-1,0,1,6,-1
KR_6629381350,420,2,37,-7,-2,0,1,1,4,4,8,-8,10,2,2,2,4,0,0,0,0,6,1,2,-4,2,0,0,1,-1,1,-1,1,3,-1
KR_6734029550,420,-1,-76,12,-5,0,2,2,-1,5,4,0,1,1,0,2,2,-4,4,0,0,-7,-9,0,-5,5,1,0,-2,-1,1,-1,-1,6,-1
KR_6747095041,420,-4,-47,-4,-6,-2,3,1,0,0,0,3,2,5,-6,7,1,-1,1,0,0,-4,-6,-2,-2,4,-4,0,-3,-1,-1,-1,-1,2,-1
KR_6739494828,420,-3,-101,16,-3,-2,4,2,-1,3,2,0,4,4,-5,9,4,5,1,6,1,4,43,-5,-2,7,-11,0,-1,1,1,-1,1,1,-1
KR_6759956230,440,-3,26,-5,-4,0,5,5,1,0,1,0,0,0,-2,4,2,-3,3,0,0,-2,-9,1,-6,5,-4,0,-1,1,-1,-1,-1,5,-1
KR_6751547711,420,-1,-39,-19,-7,1,1,2,4,1,5,0,4,4,-7,8,1,-5,5,0,0,-4,-2,-2,-6,8,3,0,-1,-1,0,-1,-1,5,-1
KR_6653924718,420,0,-38,-12,-6,4,1,5,1,1,2,0,2,2,-9,9,0,-2,3,1,0,-15,6,1,-3,2,-3,0,-1,1,1,1,-1,6,-1
KR_6743042862,420,-1,-14,-21,-3,4,0,4,-2,2,0,-4,6,2,-2,4,2,1,1,2,0,3,30,-2,-3,5,-25,0,-2,-1,1,-1,-1,3,-1
KR_6722599352,420,0,-37,-3,1,-1,2,1,4,2,6,0,4,4,-3,5,2,1,0,1,0,-1,372,2,-4,2,-2,0,0,1,0,0,-1,2,-1
KR_6733556230,420,-5,-25,-36,-12,-3,4,1,-4,4,0,-4,8,4,-2,3,1,1,1,2,0,-9,3,1,-4,3,-4,0,-1,-1,1,-1,-1,4,-1
KR_6759536356,420,2,-42,-2,7,0,0,0,3,3,6,4,1,5,-1,3,2,1,0,1,0,-4,-3,-1,-3,4,-4,0,1,-1,1,1,1,1,-1
KR_6748484544,420,-1,-19,-24,1,0,2,2,0,5,5,-1,2,1,2,2,4,0,2,2,0,5,0,1,-4,3,1,0,0,-1,1,0,1,3,-1
KR_6620815063,420,-5,-58,-32,-8,0,2,2,2,2,4,-7,9,2,-4,4,0,1,1,2,-1,3,-5,-6,-3,9,1,0,0,-1,-1,-1,-1,4,-1
KR_6761711443,440,-3,-13,-12,-2,-4,4,0,-2,4,2,-4,7,3,7,1,8,1,1,2,1,-4,-193,7,-9,2,-3,0,-1,-1,-1,-1,-1,2,-1
KR_6683286355,420,-5,-25,-4,-10,-5,5,0,4,1,5,-4,6,2,-3,5,2,-2,3,1,0,-6,-27,0,-4,4,-1,0,-1,-1,-1,-1,-1,5,-1
KR_6684019626,420,-1,-36,0,-4,-3,3,0,6,3,9,-3,5,2,-3,5,2,-1,1,0,0,-2,28,2,-6,4,-1,0,-3,-1,-1,-1,-1,5,-1
KR_6760898371,420,-1,17,-12,-8,1,2,3,1,0,1,-8,8,0,0,5,5,-2,2,0,0,-6,0,1,-1,0,-2,0,0,0,0,1,-1,0,-1
KR_6761364994,420,-5,-74,-16,-6,-3,5,2,-1,2,1,1,2,3,0,2,2,-3,3,0,0,-7,44,3,-6,3,0,0,-3,-1,1,-1,-1,2,-1
KR_6753560225,440,1,53,2,0,2,0,2,-1,2,1,0,3,3,-1,6,5,0,0,0,0,3,-8,-2,-3,5,0,0,1,0,-1,1,1,0,-1
KR_6757664855,440,-4,-25,10,-9,-3,4,1,-8,9,1,1,0,1,-1,5,4,2,0,2,0,-5,346,1,-10,9,1,0,0,1,1,-1,1,3,-1
KR_6281575647,420,2,-19,-16,2,-2,3,1,-1,3,2,1,1,2,4,3,7,0,0,0,0,6,-39,-2,-3,5,28,0,-1,-1,-1,-1,-1,3,-1
KR_6747018968,420,-5,-16,-16,-8,-2,5,3,-4,5,1,1,3,4,-1,3,2,-2,2,0,0,-10,-31,-1,-3,4,-3,0,0,1,-1,-1,-1,3,-1
KR_6660015987,420,5,-2,0,3,-6,7,1,2,0,2,2,5,7,5,0,5,0,0,0,0,4,-109,-3,0,3,1,0,0,0,-1,-1,-1,0,-1
KR_6757954630,420,-1,-47,-4,-4,1,1,2,1,3,4,-2,2,0,-5,5,0,1,1,2,0,-6,4,-1,-2,3,-2,0,0,-1,0,0,-1,1,-1
KR_6756535247,420,-1,-11,-24,5,4,1,5,2,1,3,-1,3,2,0,3,3,0,1,1,0,-7,-37,4,-5,1,1,0,0,0,0,0,1,0,-1
KR_5876742441,420,1,-28,10,0,-1,5,4,2,0,2,0,3,3,-2,3,1,1,1,2,0,3,235,-1,-3,4,5,0,-1,1,-1,-1,-1,4,-1
KR_6756292636,420,-3,14,-12,1,2,1,3,2,5,7,-5,6,1,2,3,5,0,1,1,0,2,-3,-5,-1,6,7,0,0,-1,0,1,-1,3,-1
KR_6621069102,420,1,-22,21,-2,-4,6,2,-3,4,1,3,2,5,-2,4,2,4,2,6,1,-5,-4,1,-3,2,2,0,-1,1,-1,-1,1,3,-1
KR_6737009078,420,-5,-31,-4,-10,0,1,1,-5,7,2,-3,4,1,-3,3,0,1,0,1,0,-7,8,3,-7,4,0,0,-1,-1,-1,-1,1,1,-1
KR_6747062219,420,-1,-10,28,-2,-1,1,0,3,0,3,1,0,1,-4,5,1,-1,2,1,0,-4,22,2,-6,4,-3,0,-1,-1,-1,-1,1,2,-1
KR_6762587581,420,-3,-27,-12,-11,-2,3,1,0,2,2,-6,7,1,1,2,3,-4,4,0,0,-9,2,1,-5,4,-2,0,0,-1,-1,0,-1,4,-1
KR_6758055105,420,-2,-60,6,-8,-2,2,0,-1,5,4,5,4,9,-9,10,1,-1,1,0,-4,-15,-133,0,-2,2,21,0,-1,-1,-1,-1,-1,5,-1
KR_6751160715,420,-1,-16,19,-6,1,1,2,0,1,1,-3,5,2,-3,4,1,-1,3,2,0,-9,6,2,-6,4,-1,0,-1,1,-1,-1,1,6,-1
KR_6720779134,440,-6,-73,-12,-15,2,1,3,2,0,2,-5,7,2,-1,2,1,-13,13,0,0,-15,6,0,-6,6,-6,0,-1,1,1,-1,-1,1,-1
KR_6658528685,420,-1,-9,9,-7,-4,7,3,-3,3,0,1,1,2,1,1,2,-2,3,1,-1,-1,-21,1,-2,1,0,0,0,-1,-1,0,-1,5,-1
KR_6759329955,420,-4,-12,-47,-1,-1,2,1,-5,5,0,-1,3,2,3,3,6,3,0,3,0,0,-4,-4,-2,6,1,0,0,1,-1,1,1,5,-1
KR_6760834573,420,2,29,-4,-3,8,1,9,-1,1,0,-4,7,3,-6,7,1,0,0,0,0,-13,111,2,-5,3,0,0,1,1,-1,1,1,5,-1
KR_6755674487,420,-2,22,3,-7,-1,2,1,-5,5,0,0,2,2,-1,3,2,0,0,0,0,-7,-27,-3,-2,5,3,0,-1,-1,-1,-1,-1,6,-1
KR_6764124341,420,1,13,39,0,-1,2,1,4,2,6,-3,5,2,3,3,6,-3,3,0,0,-2,2,-5,-2,7,3,0,1,-1,-1,1,-1,1,-1
KR_6712683399,420,-5,-53,8,-11,1,0,1,0,3,3,-2,4,2,-2,5,3,-8,8,0,0,-11,1,4,-6,2,-6,0,0,1,1,-1,-1,5,-1
KR_6648770040,420,-2,16,8,-4,-2,2,0,-2,4,2,-2,3,1,2,6,8,0,0,0,-1,-7,-13,-4,-2,6,-3,0,0,-1,1,0,-1,2,-1
KR_6744680073,420,-5,-36,12,-8,-4,4,0,-4,8,4,0,0,0,2,1,3,-2,2,0,0,-3,-5,-4,-4,8,-3,0,-1,-1,-1,-1,-1,2,-1
KR_6738228465,420,0,38,18,-2,3,1,4,-1,2,1,-3,4,1,0,4,4,-1,4,3,0,2,-8,-2,-2,4,3,0,-1,-1,-1,-1,1,2,-1
KR_6757718542,420,-3,-22,-11,-1,-2,4,2,1,2,3,3,1,4,-4,6,2,1,4,5,2,0,-1,-1,-7,8,1,0,0,-1,-1,1,1,3,-1
KR_6599818188,420,-4,13,-24,-13,-3,5,2,-5,7,2,1,2,3,-6,6,0,0,2,2,0,-14,-111,-1,-4,5,-2,0,-2,-1,-1,-1,-1,6,-1
KR_6761614976,420,-2,-30,-24,-13,1,4,5,-6,6,0,-4,5,1,-2,4,2,-2,3,1,0,-18,-37,-2,-3,5,9,0,-1,0,-1,-1,-1,0,-1
KR_6732929127,420,2,80,8,1,1,1,2,1,4,5,0,3,3,-1,3,2,0,0,0,1,-9,24,-2,-2,4,-1,0,2,1,1,1,1,1,-1
KR_6742090306,420,-3,21,-26,-5,1,1,2,0,4,4,-8,9,1,2,0,2,0,1,1,0,-1,6,-1,-3,4,-1,0,1,1,-1,1,1,1,-1
KR_6754733693,420,-2,-18,-32,-3,2,0,2,2,2,4,-3,5,2,-4,5,1,0,1,1,0,-6,11,5,-8,3,-6,0,-2,1,-1,-1,1,6,-1
KR_6672857291,420,-2,-45,10,-5,3,2,5,-2,4,2,-6,7,1,0,3,3,0,4,4,-3,-7,8,3,-6,3,-5,0,-2,-1,-1,-1,-1,2,-1
KR_6472661642,420,-3,-59,27,-6,2,2,4,-2,4,2,2,1,3,-6,7,1,-2,2,0,1,-11,0,-2,-3,5,-2,0,-1,-1,1,1,1,5,-1
KR_6716601342,420,-3,-49,0,-8,-3,3,0,1,2,3,-1,1,0,-6,7,1,1,0,1,0,-8,-1,-1,-8,9,-2,0,-1,1,-1,-1,1,3,-1
KR_6759574825,420,-3,-47,27,-4,2,1,3,-1,3,2,-1,1,0,-5,7,2,1,0,1,0,-9,-7,-1,-4,5,-1,0,-2,-1,1,-1,1,6,-1
KR_6620284494,420,0,-91,-27,-3,-4,5,1,0,1,1,1,2,3,-3,5,2,3,2,5,-1,3,0,0,-2,2,-2,0,-1,-1,-1,-1,-1,1,-1
KR_5566310992,420,-6,-93,-23,-5,-2,3,1,0,6,6,-1,2,1,-2,3,1,0,1,1,-1,-11,14,0,-8,8,-7,0,-2,-1,-1,-1,-1,1,-1
KR_6708111276,420,-4,-56,7,-3,1,0,1,-6,6,0,-2,2,0,2,0,2,2,1,3,0,-1,262,-1,-4,5,-3,0,0,-1,-1,0,-1,5,-1
KR_6764661891,440,2,12,23,4,0,2,2,-1,1,0,2,1,3,0,0,0,3,2,5,0,0,-104,5,-9,4,-3,0,0,-1,-1,0,1,3,-1
KR_6745867989,420,2,-5,8,2,-1,3,2,3,1,4,2,1,3,0,1,1,-2,2,0,0,-4,5,0,-4,4,-1,0,0,1,0,0,-1,5,-1
KR_6631685094,420,-4,-115,4,-10,2,2,4,-2,4,2,-7,7,0,-5,6,1,2,0,2,0,-3,-25,1,-5,4,2,0,-2,-1,1,-1,1,3,-1
KR_6761146616,440,-1,-30,-24,-7,2,0,2,2,1,3,0,1,1,-1,5,4,-10,10,0,0,-7,-15,-1,-4,5,0,0,-1,0,1,-1,-1,0,-1
KR_6542784328,440,-2,-64,44,-5,-1,2,1,-4,7,3,2,2,4,-1,1,0,-1,2,1,0,-9,3,-2,0,2,2,0,0,1,-1,0,-1,2,-1
KR_6728013717,420,0,-12,-8,-1,0,3,3,-2,4,2,5,0,5,-4,4,0,0,1,1,0,5,19,1,-4,3,4,0,1,-1,1,1,-1,5,-1
KR_6682396709,420,0,-14,20,0,6,0,6,-6,8,2,0,0,0,-1,2,1,1,1,2,0,1,0,-4,-3,7,-3,0,0,-1,1,1,1,2,-1
KR_6749699941,440,-1,-80,-12,-14,0,0,0,-10,10,0,-1,1,0,-6,10,4,3,2,5,-1,-5,5,0,-1,1,-1,0,0,0,1,-1,-1,0,-1
KR_6711866751,420,-5,-88,-20,-10,-2,3,1,0,2,2,-5,5,0,-3,5,2,0,0,0,0,-7,-40,-2,-2,4,11,0,-3,-1,-1,-1,1,3,-1
KR_6761880775,420,-6,-65,-11,-9,-6,6,0,-1,1,0,0,4,4,-2,3,1,0,2,2,0,-7,-4,-2,-3,5,-1,0,0,-1,1,-1,-1,2,-1
KR_6386281430,420,-3,-52,-31,-6,1,2,3,-2,3,1,-1,2,1,-5,5,0,1,1,2,0,-8,-24,-4,-1,5,0,0,-3,-1,-1,-1,1,2,-1
KR_6692005845,420,-4,-47,-12,-6,-3,5,2,-4,7,3,-2,3,1,-2,2,0,5,0,5,0,-3,-10,-1,-1,2,0,0,-2,-1,1,-1,-1,2,-1
KR_6760233838,420,-2,-36,-11,-3,-1,2,1,-4,4,0,-3,3,0,5,3,8,0,0,0,0,7,12,5,-6,1,-2,0,1,1,1,1,-1,3,-1
KR_6688460045,420,-1,-30,8,0,4,0,4,-1,2,1,-3,5,2,0,3,3,0,2,2,0,3,-108,2,-6,4,2,0,0,-1,1,0,1,3,-1
KR_6724959027,420,-2,-13,-8,-2,-5,5,0,2,2,4,4,0,4,1,3,4,-4,6,2,0,-7,-6,0,-5,5,0,0,-1,1,-1,-1,1,5,-1
KR_6670130431,420,-4,-22,-32,-2,-1,2,1,-1,5,4,1,1,2,-2,2,0,1,0,1,0,3,14,-1,-2,3,-3,0,0,-1,1,0,1,6,-1
KR_6678502243,420,-3,-51,-16,-1,-4,4,0,1,0,1,-2,2,0,1,3,4,3,0,3,0,2,-3,-4,0,4,0,0,-1,-1,-1,-1,-1,6,-1
KR_6716788816,420,0,-27,-23,-4,0,2,2,1,3,4,-6,7,1,1,3,4,0,1,1,1,7,3,2,-5,3,2,0,0,-1,-1,-1,1,2,-1
KR_6763304464,420,-2,-17,-28,-2,-2,2,0,1,2,3,-4,4,0,3,1,4,0,0,0,0,4,409,4,-5,1,-1,0,1,1,-1,1,1,3,-1
KR_6655500683,420,-2,-64,-12,-5,-2,2,0,-1,3,2,-1,1,0,-2,4,2,1,1,2,0,-12,1,-2,-3,5,0,0,0,-1,-1,-1,-1,5,-1
KR_6755210467,420,1,61,42,0,2,2,4,-1,4,3,3,1,4,-3,3,0,-1,1,0,0,-3,0,1,-4,3,0,0,1,-1,-1,1,-1,1,-1
KR_6761626206,440,-2,13,13,2,-2,2,0,-1,1,0,-5,5,0,4,1,5,6,2,8,0,4,-4,-2,-3,5,-1,0,1,1,0,1,-1,2,-1
KR_6762980182,420,-2,-30,-4,0,-3,3,0,0,6,6,2,2,4,1,3,4,0,2,2,0,4,-10,-1,-2,3,-2,0,0,1,0,0,1,2,-1
KR_6649862730,420,3,10,24,5,-2,3,1,5,1,6,-2,2,0,3,1,4,1,2,3,1,5,-3,-2,-3,5,4,0,1,1,0,1,1,2,-1
KR_6684517639,420,-5,-1,-23,-3,0,1,1,-3,4,1,-3,5,2,3,1,4,0,1,1,1,4,5,-4,-2,6,-1,0,-1,1,-1,-1,1,5,-1
KR_6753944843,420,-5,-35,-12,-9,-6,8,2,-1,2,1,4,1,5,-3,4,1,-3,4,1,0,-10,42,-1,-4,5,-21,0,0,-1,-1,0,1,6,-1
KR_6731577063,420,-1,27,13,-13,-4,5,1,0,6,6,-5,5,0,-1,6,5,-3,3,0,0,-20,-5,-3,-2,5,0,0,2,0,-1,-1,-1,0,-1
KR_6727902305,420,-4,-50,-16,-14,-5,5,0,-3,4,1,-4,5,1,-1,4,3,-1,2,1,0,-8,5,-1,-2,3,-2,0,-2,-1,1,-1,-1,4,-1
KR_6727610364,420,-4,-46,-39,-15,-1,2,1,-4,4,0,-8,11,3,0,1,1,-2,2,0,0,-14,-4,-3,-4,7,2,0,-1,-1,1,-1,-1,4,-1
KR_6683448620,420,-1,-59,16,-6,3,2,5,1,2,3,-11,11,0,1,2,3,0,3,3,0,-12,1,3,-6,3,2,0,-2,-1,0,-1,-1,2,-1
KR_6762896668,440,-5,-18,-9,-13,-2,4,2,-1,3,2,-1,3,2,-7,7,0,-2,2,0,0,-13,-9,-2,-1,3,0,0,-1,-1,1,-1,-1,5,-1
KR_6721151567,420,2,-2,0,4,4,0,4,0,3,3,2,1,3,-1,3,2,-1,2,1,-1,-2,-10,-2,-4,6,0,0,1,-1,1,1,-1,6,-1
KR_6763162634,420,-1,-110,4,-6,0,2,2,-2,2,0,-2,3,1,-2,2,0,0,0,0,0,-7,-4,0,-2,2,-3,0,0,-1,-1,0,-1,6,-1
KR_6614281717,420,-3,9,-27,-5,2,0,2,-1,2,1,-5,7,2,-1,2,1,0,2,2,0,-11,-275,-3,-2,5,2,0,0,-1,1,1,1,6,-1
KR_6650365634,420,-1,-75,9,-1,0,2,2,2,3,5,1,6,7,-3,5,2,-1,1,0,0,-6,7,8,-9,1,-3,0,-1,0,1,-1,-1,0,-1
KR_6742660661,420,-6,-116,4,-6,-3,4,1,3,1,4,2,0,2,-6,6,0,-2,2,0,0,-7,13,-5,-3,8,5,0,-1,-1,-1,-1,1,6,-1
KR_6736647112,420,-4,-84,0,-9,-7,8,1,-1,3,2,2,3,5,-4,4,0,1,0,1,0,-4,0,0,-3,3,-1,0,-2,1,-1,-1,-1,1,-1
KR_6662516374,420,2,17,21,0,2,1,3,-2,3,1,0,1,1,0,7,7,0,0,0,0,-2,3,5,-6,1,-4,0,0,0,-1,1,-1,0,-1
KR_6759409497,420,2,-26,10,4,5,0,5,-2,4,2,0,1,1,1,2,3,0,0,0,0,2,-17,-2,-2,4,0,0,0,1,-1,0,-1,5,-1
KR_6741532836,420,0,-28,12,1,-2,2,0,-1,5,4,1,0,1,0,2,2,3,0,3,0,-1,-29,1,-4,3,3,0,-1,1,-1,-1,1,2,-1
KR_6748048384,420,-5,-158,32,-13,0,2,2,-6,7,1,-9,9,0,-1,2,1,3,0,3,-1,-6,1,-1,-5,6,-1,0,-2,1,-1,-1,-1,3,-1
KR_6764003663,420,-4,-75,-19,-6,-1,2,1,-3,3,0,-3,3,0,-1,2,1,2,1,3,-1,-9,152,-4,-3,7,-1,0,-3,-1,-1,-1,-1,2,-1
KR_6731904880,420,-3,-69,-24,-9,-1,4,3,-3,4,1,-3,4,1,-3,3,0,1,0,1,-1,-8,-270,-2,-5,7,2,0,-2,1,-1,-1,-1,3,-1
KR_6762381416,420,-5,-74,-10,-12,-4,4,0,-1,2,1,-6,9,3,3,3,6,-4,5,1,0,-10,3,0,-6,6,-4,0,-2,1,-1,-1,-1,1,-1
KR_6734305527,420,3,-21,9,7,5,1,6,-1,3,2,1,4,5,2,0,2,0,0,0,0,4,-1,2,-6,4,-1,0,0,0,1,-1,-1,0,-1
KR_6733636637,420,-4,-66,-24,-8,-1,2,1,-3,5,2,-3,4,1,-1,4,3,0,1,1,-1,-8,-211,0,-8,8,-2,0,0,-1,1,0,-1,6,-1
KR_6763631430,420,0,-63,8,-3,0,1,1,3,2,5,-3,3,0,0,4,4,-3,4,1,0,1,10,-1,-5,6,-8,0,-1,1,-1,-1,-1,2,-1
KR_6745127547,420,-2,-46,-37,-2,-3,3,0,0,2,2,7,1,8,-5,5,0,-1,1,0,0,5,8,1,-2,1,-2,0,-1,-1,-1,-1,-1,4,-1
KR_6752331233,420,-1,4,-12,-9,-3,6,3,-2,5,3,-2,6,4,-1,4,3,-1,2,1,0,-11,1,-3,-2,5,0,0,-1,-1,0,-1,1,3,-1
KR_6516329052,440,-8,-108,-22,-15,-4,4,0,-4,4,0,-7,7,0,0,2,2,0,1,1,0,-11,-18,-3,-2,5,-4,0,-2,-1,-1,-1,-1,6,-1
KR_6733640440,440,-4,-71,-14,-12,1,0,1,-1,1,0,1,1,2,-6,6,0,-7,7,0,-1,-10,-26,-1,-5,6,1,0,-1,-1,0,-1,-1,1,-1
KR_6739947416,420,2,86,-4,-1,1,1,2,-1,4,3,2,5,7,-3,3,0,0,1,1,0,-9,36,5,-5,0,-32,0,1,-1,-1,1,-1,5,-1
KR_6638302620,420,0,21,0,-6,-3,4,1,-4,6,2,-1,3,2,1,1,2,1,0,1,0,-7,-6,0,-5,5,0,0,0,-1,1,1,-1,4,-1
KR_6761054483,420,2,129,5,2,2,1,3,1,1,2,1,2,3,-5,9,4,3,0,3,1,-6,15,2,-4,2,-4,0,1,-1,-1,1,1,2,-1
KR_6742996212,420,-2,-25,21,-6,-3,5,2,-3,4,1,1,0,1,1,3,4,-2,2,0,0,-6,8,-3,-3,6,0,0,1,1,-1,-1,-1,1,-1
KR_6764622268,440,0,-9,1,-3,2,3,5,-1,2,1,-1,3,2,-3,4,1,0,1,1,0,-5,-2,-1,-3,4,-1,0,-1,0,-1,-1,-1,0,-1
KR_6441935862,420,0,-48,-20,-2,1,1,2,-2,4,2,-3,3,0,2,1,3,0,1,1,0,6,-15,2,-6,4,0,0,0,-1,-1,0,-1,3,-1
KR_6739449176,420,-5,35,-108,-10,-4,4,0,-3,3,0,-1,4,3,-1,4,3,-1,1,0,0,-4,8,2,-4,2,-4,0,-1,-1,-1,-1,-1,3,-1
KR_6284139529,420,-4,-47,-20,-5,3,0,3,-1,5,4,-2,2,0,-5,7,2,0,1,1,0,-5,-109,0,-4,4,-4,0,-2,1,-1,-1,1,1,-1
KR_6678133321,420,2,22,18,5,0,1,1,2,2,4,5,1,6,-3,4,1,1,0,1,0,-5,3,2,-4,2,2,0,0,1,-1,0,1,6,-1
KR_6504349701,420,-1,-1,-21,-5,-1,1,0,-2,5,3,-3,3,0,2,3,5,-1,1,0,2,-1,-52,1,-7,6,29,0,-1,-1,-1,-1,1,6,-1
KR_6710796530,420,-1,0,-12,0,-3,5,2,3,1,4,-1,1,0,0,7,7,1,2,3,0,1,-10,-1,-4,5,2,0,1,-1,-1,1,-1,3,-1
KR_6751426073,420,-4,-104,-18,-5,-3,4,1,2,2,4,-3,4,1,0,1,1,-1,2,1,0,4,-1,2,-7,5,-5,0,-3,-1,0,-1,1,6,-1
KR_6710625013,420,1,-92,16,4,-4,4,0,5,1,6,6,0,6,-4,5,1,1,1,2,-1,6,-3,-1,-4,5,0,0,-1,1,1,-1,-1,4,-1
KR_6763971149,420,2,1,60,0,1,2,3,-4,6,2,-2,2,0,5,3,8,0,2,2,1,0,0,0,-6,6,-4,0,-1,0,-1,-1,1,0,-1
KR_6667594640,420,-2,-62,-12,-10,-3,3,0,-2,4,2,-1,2,1,-5,6,1,1,2,3,0,-2,104,-3,-1,4,-2,0,-1,0,-1,-1,-1,0,-1
KR_6672294298,420,0,6,-12,2,2,1,3,-5,6,1,5,0,5,-1,2,1,1,0,1,1,8,-3,-2,-7,9,3,0,0,1,1,0,1,1,-1
KR_6727739339,420,-5,-38,-23,-14,3,0,3,-8,8,0,-4,6,2,-1,5,4,-4,4,0,0,-16,-7,-4,-3,7,2,0,-1,1,1,-1,-1,5,-1
KR_6743708249,440,-1,-36,21,-2,-1,1,0,0,2,2,0,1,1,0,0,0,-1,1,0,0,0,-7,-2,-3,5,-1,0,0,-1,-1,0,-1,4,-1
KR_6717722386,420,-5,-73,-12,-15,-1,3,2,3,2,5,-2,2,0,-11,12,1,-4,4,0,-2,-21,-9,-2,-2,4,5,0,-2,-1,-1,-1,-1,5,-1
KR_6739300086,420,-4,-50,-12,-4,-2,3,1,1,1,2,-4,7,3,0,2,2,1,1,2,-2,-8,289,-1,-3,4,0,0,-2,-1,-1,-1,-1,5,-1
KR_6717890677,420,-4,-87,-8,-7,2,0,2,0,3,3,-5,5,0,-2,4,2,-2,2,0,0,-1,-24,-4,-1,5,-3,0,-1,1,0,-1,-1,2,-1
KR_6672884060,420,-5,-47,14,-9,-2,4,2,-2,2,0,-1,1,0,-4,4,0,0,2,2,0,-1,3,-1,-5,6,-2,0,0,1,1,-1,-1,3,-1
KR_6761954128,420,3,43,23,7,6,1,7,0,3,3,0,4,4,0,6,6,1,0,1,0,2,-10,2,-6,4,-1,0,1,-1,1,1,1,5,-1
KR_6716639355,420,2,34,0,-2,3,0,3,-5,6,1,0,3,3,-1,1,0,1,1,2,1,-5,-5,-5,-4,9,-1,0,0,-1,1,1,1,6,-1
KR_6630092414,420,-5,-80,11,-7,0,4,4,-5,8,3,2,2,4,-1,3,2,-3,4,1,1,-8,-3,2,-6,4,-4,0,-1,-1,-1,-1,1,4,-1
KR_6746037852,420,-7,-96,-6,-13,-1,3,2,-5,6,1,0,5,5,-4,5,1,-3,3,0,0,-10,5,3,-4,1,1,0,-1,-1,1,-1,-1,4,-1
KR_6753181285,420,-6,-90,-29,-12,-1,1,0,-12,12,0,0,3,3,1,1,2,0,0,0,-1,-9,19,1,-7,6,-19,0,-1,-1,-1,-1,-1,2,-1
KR_6644353960,420,0,-59,-4,2,1,1,2,4,2,6,-1,4,3,-1,4,3,-1,1,0,0,0,3,3,-7,4,1,0,-1,-1,1,-1,1,5,-1
KR_6642090835,420,-1,-25,-25,-5,-5,5,0,6,0,6,0,2,2,-4,6,2,-2,2,0,0,3,15,0,-3,3,0,0,-1,-1,-1,-1,-1,1,-1
KR_6643221359,420,-2,32,0,-3,6,1,7,-4,6,2,3,2,5,-8,11,3,0,1,1,-2,-9,-7,-4,-2,6,-2,0,1,-1,-1,1,-1,5,-1
KR_6742943222,420,-2,-62,-12,-8,3,2,5,-3,6,3,-8,9,1,1,2,3,-1,2,1,0,-4,55,2,-6,4,-18,0,0,1,0,-1,-1,5,-1
KR_6611854943,420,-3,-40,-27,-10,0,2,2,-6,7,1,-4,6,2,-1,3,2,1,1,2,0,-7,5,-2,-4,6,-3,0,-1,-1,-1,-1,-1,6,-1
KR_6742987844,420,-2,-102,29,-4,-1,2,1,3,0,3,-3,4,1,-2,4,2,-1,1,0,0,-1,-9,1,-2,1,3,0,0,1,1,-1,-1,5,-1
KR_6756477549,420,-3,-25,0,-8,2,2,4,-3,3,0,2,0,2,-3,3,0,-6,7,1,-1,-10,-10,-5,-2,7,2,0,-1,-1,-1,-1,-1,3,-1
KR_6755168325,440,-4,-33,-5,-9,1,2,3,-1,3,2,-1,1,0,-7,9,2,-1,2,1,0,-11,3,-1,-4,5,-4,0,-2,-1,1,-1,-1,3,-1
KR_6705585460,440,-3,-57,-4,-10,0,0,0,-6,6,0,-1,3,2,-3,5,2,0,1,1,0,-13,8,-2,-6,8,-4,0,0,-1,-1,0,-1,6,-1
KR_6738515677,420,-4,-3,16,-9,-2,4,2,0,1,1,-1,7,6,-5,5,0,-1,1,0,0,-13,5,-3,-5,8,2,0,0,-1,-1,-1,1,3,-1
KR_6622387311,420,0,15,-4,-7,-2,3,1,-1,2,1,1,2,3,-4,5,1,-1,1,0,0,-10,8,0,-5,5,0,0,0,1,-1,-1,-1,1,-1
KR_6763391763,420,-3,-48,0,-4,-1,3,2,0,0,0,1,3,4,-3,3,0,-1,2,1,0,-4,-3,-3,0,3,-2,0,-1,-1,1,-1,-1,5,-1
KR_6614401377,440,-6,-69,-20,-12,-3,4,1,2,1,3,-2,3,1,-7,7,0,-2,2,0,0,-9,-13,-6,0,6,-2,0,-2,-1,-1,-1,-1,2,-1
KR_6760685965,420,-2,2,-38,-6,-5,7,2,0,0,0,-4,6,2,2,2,4,1,0,1,0,3,-96,2,-6,4,2,0,-1,-1,1,-1,-1,3,-1
KR_6656084659,420,-1,6,20,-2,0,1,1,2,2,4,1,1,2,1,0,1,-6,8,2,0,-2,-37,-1,-3,4,-2,0,-2,-1,1,-1,1,2,-1
KR_6747306602,420,-1,-1,-16,2,3,0,3,-1,2,1,0,1,1,-1,4,3,1,1,2,0,-3,107,0,-5,5,3,0,1,0,-1,1,-1,0,-1
KR_6762964266,420,-4,-25,-32,-2,-1,2,1,-1,3,2,1,0,1,-2,3,1,1,2,3,0,-1,1,2,-4,2,-1,0,-1,1,1,-1,-1,5,-1
KR_6698328508,420,0,-25,9,-2,1,1,2,-2,4,2,-3,4,1,1,1,2,1,0,1,-2,-9,13,3,-4,1,-2,0,0,-1,-1,0,-1,4,-1
KR_6744486235,420,1,-42,19,-3,-3,4,1,-2,3,1,0,4,4,2,4,6,0,4,4,0,2,30,-3,-4,7,-3,0,0,-1,-1,0,-1,6,-1
KR_6760215903,420,2,20,16,2,-1,2,1,2,1,3,2,1,3,0,3,3,-1,1,0,2,5,6,1,-5,4,-1,0,0,1,-1,0,1,2,-1
KR_6326202337,420,0,-29,-28,-4,-2,3,1,1,3,4,-2,4,2,-1,2,1,0,2,2,0,-7,-1,-3,-3,6,3,0,-1,-1,-1,-1,-1,1,-1
KR_6699944150,440,-4,-96,-21,-4,-1,2,1,-1,5,4,-2,5,3,-1,2,1,1,0,1,0,2,43,1,-3,2,-4,0,-2,1,-1,-1,1,5,-1
KR_6751247696,420,-4,-31,19,-12,1,1,2,-7,9,2,-4,5,1,0,3,3,-2,2,0,0,-16,-6,2,-5,3,-3,0,0,0,1,-1,1,0,-1
KR_6757606479,440,-2,-113,4,-8,-2,2,0,-6,8,2,-3,4,1,-2,5,3,5,1,6,0,-3,-9,-1,-4,5,-4,0,-1,0,-1,-1,-1,0,-1
KR_6764431328,420,-6,35,10,-14,1,0,1,-4,6,2,-4,5,1,-6,7,1,-1,1,0,-1,-15,51,-1,-2,3,-37,0,0,-1,1,1,-1,1,-1
KR_6761823656,420,5,22,15,9,2,0,2,1,3,4,6,0,6,-1,4,3,1,0,1,0,8,12,-3,-3,6,0,0,2,-1,1,1,-1,6,-1
KR_6752060755,420,-2,27,12,-5,2,2,4,-5,5,0,-2,4,2,-1,2,1,1,1,2,0,-2,-30,5,-7,2,24,0,0,1,-1,-1,1,1,-1
KR_6718308708,420,1,-14,-9,-2,1,3,4,-1,5,4,-5,6,1,2,3,5,1,0,1,0,-4,-315,-1,-3,4,0,0,0,1,-1,-1,-1,6,-1
KR_6764350957,440,-6,-88,20,-10,1,2,3,-4,5,1,-5,8,3,-2,2,0,0,1,1,0,-10,-1,-3,-3,6,1,0,0,-1,1,-1,-1,3,-1
KR_6700263820,440,1,-16,10,-3,5,0,5,-4,4,0,1,1,2,-3,5,2,-2,2,0,-1,-8,67,1,-7,6,2,0,-1,-1,1,-1,-1,4,-1
KR_6654629796,420,-1,-4,8,0,0,5,5,-2,5,3,-3,4,1,6,0,6,-1,1,0,0,1,-4,0,-3,3,1,0,0,1,1,-1,-1,2,-1
KR_6750317966,420,0,-47,24,2,-4,5,1,3,0,3,3,2,5,-1,2,1,1,0,1,0,10,-159,2,-5,3,2,0,1,1,1,1,-1,1,-1
KR_6750725138,420,-2,-52,-28,-1,3,0,3,1,1,2,-2,7,5,-5,7,2,2,0,2,0,-8,21,10,-10,0,2,0,-1,-1,1,-1,-1,2,-1
KR_6733846335,420,-3,-12,-2,-10,-1,3,2,-3,4,1,-5,6,1,1,1,2,-2,2,0,-1,-6,-12,-1,-3,4,3,0,1,0,1,1,-1,0,-1
KR_6755525544,440,0,4,-4,-1,0,1,1,-1,3,2,1,4,5,-1,2,1,0,1,1,0,-2,10,1,-8,7,0,0,0,1,-1,0,1,1,-1
KR_6699430636,420,2,-48,36,8,-3,5,2,6,1,7,7,0,7,-3,4,1,1,1,2,0,1,-6,4,-5,1,-2,0,-1,1,-1,-1,-1,5,-1
KR_6747209572,420,-1,-3,-40,-7,0,1,1,-2,5,3,0,3,3,-5,9,4,0,0,0,-1,0,4,0,-7,7,2,0,0,0,0,0,-1,0,-1
KR_6666964995,420,3,52,4,5,1,2,3,2,1,3,-2,3,1,1,4,5,3,3,6,-2,3,-5,3,-8,5,8,0,0,0,-1,0,-1,0,-1
KR_6728703846,440,-4,13,-12,-9,1,0,1,-8,9,1,-2,2,0,0,1,1,0,0,0,0,-5,-60,-1,-3,4,-1,0,0,-1,-1,0,-1,3,-1
KR_6747208798,440,-3,-67,7,-4,-4,4,0,5,1,6,-1,3,2,-4,5,1,0,0,0,0,2,-248,-2,-1,3,1,0,0,-1,-1,0,1,4,-1
KR_6762771071,420,-3,-35,-20,-1,-2,4,2,0,1,1,1,1,2,1,2,3,-1,1,0,0,2,-4,-1,-6,7,2,0,1,-1,1,1,1,1,-1
KR_6736396888,420,-1,-26,35,-6,-6,10,4,5,2,7,2,0,2,-6,8,2,-1,2,1,-1,-1,-31,-1,-4,5,-4,0,-2,-1,1,-1,-1,1,-1
KR_6764037005,420,0,-26,20,1,-6,6,0,1,0,1,0,1,1,3,1,4,3,0,3,-1,10,-4,-2,-5,7,4,0,0,1,-1,0,-1,3,-1
KR_6762733981,420,-1,-47,20,-3,-1,2,1,0,2,2,1,1,2,-3,3,0,0,2,2,0,3,4,4,-7,3,-5,0,-1,0,-1,-1,-1,0,-1
KR_6702010971,420,-4,-96,4,-5,-7,7,0,-3,4,1,-1,2,1,1,1,2,5,0,5,0,1,-6,-4,-1,5,7,0,0,1,1,1,-1,6,-1
KR_6654895198,420,1,13,7,3,-2,2,0,0,4,4,0,0,0,5,2,7,0,0,0,0,4,-1,-1,-3,4,2,0,0,1,1,0,-1,5,-1
KR_6651466426,420,1,4,-48,-2,-3,4,1,1,2,3,-1,4,3,3,2,5,-2,2,0,0,-2,7,5,-8,3,1,0,-1,1,-1,-1,1,6,-1
KR_6762952071,420,0,17,12,-2,0,1,1,-1,2,1,-2,3,1,1,1,2,0,2,2,0,-2,49,6,-8,2,-36,0,0,-1,1,0,-1,4,-1
KR_6749909207,440,1,46,0,8,6,0,6,-2,4,2,2,4,6,4,4,8,-2,5,3,-3,-5,8,3,-9,6,-1,0,2,1,0,1,-1,5,-1
KR_6635523961,420,-2,-27,-28,1,2,1,3,-1,3,2,-1,4,3,0,4,4,1,1,2,0,4,-6,-2,-5,7,4,0,0,0,-1,0,-1,0,-1
KR_6660789334,420,1,48,-12,-2,2,0,2,1,3,4,-3,5,2,-1,4,3,-1,3,2,0,6,0,7,-11,4,1,0,1,-1,1,1,-1,3,-1
KR_6758396001,420,0,-36,12,0,2,0,2,0,3,3,3,1,4,-6,6,0,1,1,2,1,3,0,5,-7,2,0,0,0,-1,1,0,1,2,-1
KR_6697192210,420,-6,-46,-4,-15,-2,2,0,-4,4,0,-7,7,0,-3,4,1,1,1,2,0,-12,-26,2,-3,1,-2,0,-1,0,-1,-1,-1,0,-1
KR_6756253019,420,-1,-10,4,-6,-5,5,0,-1,4,3,0,5,5,1,3,4,-1,5,4,0,-10,2,-1,-2,3,2,0,-1,1,1,-1,1,4,-1
KR_6761056165,420,-3,-6,-2,-9,3,0,3,-1,1,0,-3,4,1,-5,7,2,-3,3,0,0,-4,0,0,-4,4,-2,0,-1,1,-1,1,-1,3,-1
KR_6723836821,420,1,9,11,-3,3,3,6,-3,5,2,2,3,5,-4,6,2,-1,2,1,-2,-12,-10,3,-8,5,-3,0,-3,-1,-1,-1,-1,3,-1
KR_6715907994,440,-3,5,-36,-2,-1,2,1,2,4,6,1,2,3,-1,2,1,-3,3,0,-1,-8,-1,0,-3,3,2,0,-2,1,-1,-1,-1,5,-1
KR_6696577259,420,3,-43,24,4,0,2,2,2,3,5,-2,3,1,3,4,7,1,0,1,0,2,11,4,-6,2,1,0,0,1,-1,0,1,6,-1
KR_6648153854,420,1,47,20,0,1,2,3,1,0,1,1,2,3,-4,4,0,1,1,2,0,-5,5,0,-4,4,-2,0,0,1,1,0,1,5,-1
KR_6642164299,420,-2,-52,10,-6,0,0,0,0,2,2,0,3,3,-2,2,0,-4,4,0,0,-5,-8,0,-2,2,4,0,-1,-1,0,-1,-1,1,-1
KR_6762964468,420,-5,-25,-40,-5,-1,1,0,1,3,4,-3,4,1,-2,3,1,0,0,0,0,-1,203,2,-4,2,-4,0,0,-1,1,0,-1,6,-1
KR_6705792846,420,0,-15,-13,2,0,3,3,-1,3,2,1,3,4,2,4,6,0,0,0,0,4,-9,5,-7,2,-4,0,2,0,0,1,-1,0,-1
KR_6761243598,440,-1,-58,8,-4,-5,7,2,-5,8,3,5,0,5,1,3,4,0,3,3,0,-1,4,2,-5,3,-1,0,-1,0,0,-1,-1,0,-1
KR_6639308989,420,0,-40,0,-8,-2,4,2,-8,12,4,0,3,3,-1,2,1,3,0,3,1,-2,9,-1,-6,7,3,0,1,-1,1,1,1,2,-1
KR_5568655469,420,-3,5,-9,-13,-6,6,0,-6,6,0,-3,3,0,3,1,4,-1,1,0,0,-8,-15,-9,-1,10,2,0,-1,-1,-1,-1,1,1,-1
KR_6748369762,420,-2,-96,-21,0,-1,2,1,5,0,5,-2,5,3,-2,4,2,0,1,1,-1,3,-1,3,-6,3,-2,0,-2,1,-1,-1,-1,6,-1
KR_6604155566,440,-2,-20,33,-7,-3,3,0,-1,1,0,1,1,2,-2,3,1,-2,2,0,0,-8,-92,4,-7,3,22,0,-2,1,-1,-1,-1,6,-1
KR_6633054434,420,-2,-57,-20,-7,-2,3,1,-6,8,2,3,2,5,-2,3,1,0,4,4,1,-4,49,1,-4,3,-3,0,-2,-1,-1,-1,1,4,-1
KR_6733466953,420,3,-16,21,-1,-1,2,1,-1,4,3,1,0,1,1,1,2,-1,1,0,0,2,-5,-1,-5,6,-1,0,1,1,-1,1,1,2,-1
KR_6733180150,420,-3,-55,-16,-5,-5,5,0,0,1,1,-2,4,2,2,1,3,0,0,0,0,1,-29,3,-7,4,-3,0,-2,-1,-1,-1,1,3,-1
KR_6719458331,420,-2,4,16,1,0,1,1,-1,2,1,-2,4,2,6,0,6,-2,3,1,0,-3,1,0,-6,6,-2,0,0,1,-1,0,1,3,-1
KR_6707994409,420,0,11,0,4,-1,1,0,1,2,3,0,2,2,5,1,6,-1,1,0,0,5,-2,2,-5,3,-1,0,0,1,-1,1,1,4,-1
KR_6734334688,420,-8,-148,-15,-18,-5,5,0,2,1,3,-6,6,0,-8,12,4,-1,2,1,0,-5,4,0,-4,4,-4,0,-1,-1,-1,-1,-1,1,-1
KR_6628621469,420,-2,-44,-27,-3,-2,2,0,4,1,5,-5,6,1,0,2,2,0,1,1,-2,-6,3,2,-5,3,0,0,-1,0,-1,-1,-1,0,-1
KR_6659697265,420,-5,-31,-31,-10,-6,7,1,-2,3,1,2,1,3,-3,4,1,-1,1,0,0,-12,-2,0,-7,7,1,0,-1,-1,1,-1,-1,6,-1
KR_6761809259,420,-2,4,12,-5,-8,8,0,2,0,2,1,1,2,2,0,2,-2,3,1,0,2,9,2,-5,3,-6,0,-2,1,-1,-1,-1,2,-1
KR_6741057771,420,1,-59,20,-5,0,1,1,-1,5,4,1,1,2,-5,6,1,0,2,2,-1,-9,-9,-6,0,6,2,0,-2,-1,1,-1,-1,4,-1
KR_6759823978,420,1,13,24,-1,1,3,4,-1,4,3,3,0,3,-2,3,1,-2,2,0,1,-4,-7,-1,-4,5,0,0,0,1,0,0,1,5,-1
KR_6742974216,420,1,-51,8,2,4,0,4,1,3,4,-2,2,0,-2,2,0,1,1,2,0,-3,40,3,-4,1,-12,0,0,1,1,-1,-1,1,-1
KR_6676877444,420,-3,-51,-20,-9,-1,2,1,-6,6,0,1,3,4,-3,4,1,0,3,3,-1,-7,-142,3,-7,4,-1,0,-1,1,-1,-1,-1,6,-1
KR_6726119164,420,0,-15,-12,-2,-1,2,1,-2,7,5,0,3,3,0,2,2,1,0,1,0,-5,-38,2,-4,2,-1,0,0,-1,1,1,-1,6,-1
KR_6680702731,420,-5,-52,-12,-3,-1,5,4,-2,4,2,0,1,1,2,2,4,-2,2,0,1,1,1,-1,-3,4,-3,0,-1,-1,-1,-1,1,5,-1
KR_6750236693,420,0,10,29,-1,-7,8,1,2,2,4,4,0,4,-1,2,1,1,0,1,0,5,25,2,-5,3,1,0,0,1,-1,-1,-1,6,-1
KR_6724932295,420,-2,-3,4,-3,1,1,2,-3,3,0,1,3,4,0,1,1,-2,3,1,0,-5,-3,-2,-1,3,4,0,0,-1,-1,-1,-1,1,-1
KR_6653083713,420,-4,45,-32,-6,2,1,3,0,2,2,1,2,3,-8,10,2,-1,2,1,0,-12,11,0,-3,3,-3,0,1,-1,-1,1,-1,1,-1
KR_6731948694,420,0,-16,-8,3,-2,3,1,6,0,6,1,0,1,-2,2,0,0,0,0,0,-1,0,-3,-1,4,4,0,0,-1,-1,1,-1,1,-1
KR_6759962897,420,3,26,12,-1,-4,5,1,4,1,5,-2,4,2,1,1,2,0,1,1,0,7,-7,6,-7,1,-5,0,1,-1,1,1,-1,5,-1
KR_6631077628,420,-3,-108,13,-6,0,2,2,1,2,3,-5,5,0,0,0,0,-2,2,0,0,1,144,-1,-2,3,-4,0,-1,-1,-1,-1,-1,5,-1
KR_6593753293,420,-1,-47,1,-8,-5,5,0,2,3,5,-7,9,2,2,2,4,0,0,0,-1,0,-11,2,-7,5,-3,0,-1,-1,-1,-1,-1,5,-1
KR_6630617689,420,-3,-74,-48,-4,-1,4,3,0,2,2,0,2,2,-2,3,1,-1,1,0,0,-8,-2,-3,-3,6,0,0,0,-1,-1,-1,-1,2,-1
KR_6742036009,420,0,-10,-11,0,1,2,3,1,2,3,2,1,3,-2,5,3,-2,2,0,1,7,-1,2,-7,5,-6,0,-1,0,1,-1,1,0,-1
KR_6764304176,420,2,18,29,4,3,1,4,3,1,4,-4,4,0,-1,2,1,3,1,4,0,-2,-1,0,-4,4,1,0,0,-1,-1,0,1,6,-1
KR_6757610770,420,-5,-22,-32,-6,-2,3,1,-5,6,1,-1,3,2,2,2,4,0,1,1,0,-5,-8,-2,-7,9,8,0,-1,1,-1,-1,-1,4,-1
KR_6724377383,420,0,-23,-13,-2,5,1,6,-1,2,1,-4,4,0,-1,1,0,-1,1,0,-1,-5,44,1,-4,3,-18,0,0,-1,-1,0,-1,4,-1
KR_6603162670,420,0,-47,-3,-1,-3,3,0,1,2,3,2,3,5,-2,4,2,1,0,1,0,6,23,4,-5,1,-2,0,0,-1,-1,-1,1,1,-1
KR_6619541676,420,-11,-152,-39,-18,-5,5,0,-2,4,2,-2,3,1,-10,10,0,1,2,3,0,-15,-44,-3,-1,4,17,0,-4,-1,-1,-1,-1,5,-1
KR_6690174389,420,-3,-60,-8,-15,-3,4,1,-4,5,1,-1,2,1,-7,10,3,0,1,1,0,-12,14,8,-9,1,-7,0,-2,1,-1,-1,-1,6,-1
KR_6714668987,420,-1,51,-8,-5,0,1,1,-1,4,3,-1,2,1,-1,2,1,-2,2,0,-2,-7,-26,5,-9,4,1,0,0,1,1,0,-1,4,-1
KR_6652711349,420,-4,-65,-10,-13,1,2,3,2,2,4,-12,13,1,-6,6,0,2,1,3,-1,-9,-12,1,-1,0,4,0,0,-1,-1,-1,-1,6,-1
KR_6741352198,420,1,-59,35,-2,-1,1,0,1,0,1,-1,1,0,-1,1,0,0,0,0,0,-2,-123,-1,-2,3,5,0,0,1,-1,-1,-1,3,-1
KR_6731528283,440,-1,28,-17,-7,0,1,1,-1,2,1,-2,3,1,1,5,6,-5,7,2,0,-4,-22,3,-4,1,8,0,1,-1,1,1,-1,4,-1
KR_6631385984,420,5,47,19,9,1,2,3,0,3,3,2,2,4,4,4,8,2,1,3,0,1,-7,5,-10,5,3,0,2,0,1,1,1,0,-1
KR_6680974722,420,4,44,50,5,3,1,4,1,0,1,2,1,3,-2,3,1,1,1,2,0,5,-7,-2,-4,6,3,0,1,1,1,1,1,1,-1
KR_6417865733,420,0,-27,28,2,-4,4,0,1,3,4,6,1,7,-1,5,4,0,0,0,0,0,18,-2,-3,5,-3,0,0,-1,1,-1,1,4,-1
KR_6762712382,420,-3,-90,-9,-7,-6,10,4,-1,2,1,-2,2,0,3,3,6,-1,1,0,-1,0,-4,-2,-1,3,-5,0,0,-1,-1,1,-1,1,-1
KR_6763466052,420,-1,-28,-33,7,4,0,4,2,2,4,2,1,3,0,2,2,-1,1,0,0,4,63,1,-5,4,-6,0,0,-1,1,0,-1,4,-1
KR_6739854984,420,-4,-55,32,-15,-1,3,2,-9,9,0,-6,6,0,1,0,1,0,0,0,0,-14,-18,1,-3,2,0,0,-2,-1,0,-1,-1,3,-1
KR_6734883158,420,-1,-51,8,0,-6,6,0,2,1,3,3,3,6,0,3,3,1,1,2,-1,3,66,3,-7,4,-19,0,-3,1,1,-1,-1,6,-1
KR_6704135831,420,1,41,8,-3,1,0,1,-1,3,2,1,2,3,-5,6,1,1,1,2,0,-3,9,-1,-2,3,-1,0,-1,-1,1,-1,-1,4,-1
KR_6759033371,420,-2,-119,28,-7,-3,5,2,-2,3,1,-3,6,3,0,1,1,1,1,2,1,-3,11,5,-6,1,1,0,-1,-1,1,-1,1,6,-1
KR_6749380493,440,-1,-81,3,-4,-1,1,0,4,3,7,-1,3,2,-6,7,1,0,1,1,0,5,0,4,-5,1,0,0,0,-1,-1,0,1,5,-1
KR_6748492190,420,-1,24,-13,-2,1,1,2,-2,7,5,-1,4,3,1,1,2,-1,1,0,0,-6,-20,-1,-5,6,3,0,0,-1,-1,-1,-1,5,-1
KR_6757572126,420,1,50,-12,-4,0,3,3,-4,4,0,2,1,3,0,2,2,-2,2,0,0,3,16,0,-2,2,0,0,0,-1,-1,1,1,1,-1
KR_6761003728,420,-6,26,-15,-15,-2,5,3,-5,6,1,-3,4,1,-4,5,1,-1,2,1,-2,-16,-6,1,-4,3,-4,0,-1,-1,-1,-1,-1,6,-1
KR_6672893951,420,2,16,4,3,-1,2,1,3,0,3,1,2,3,0,2,2,0,0,0,0,8,11,3,-5,2,-1,0,-1,-1,-1,1,-1,3,-1
KR_6756301536,420,0,11,-22,3,0,2,2,-4,7,3,-3,3,0,4,1,5,6,3,9,0,1,13,-2,-3,5,-4,0,2,-1,0,1,1,3,-1
KR_6745653655,440,-4,-113,-25,-10,-3,6,3,-3,3,0,-3,5,2,-2,2,0,1,2,3,0,-7,-10,-2,-1,3,3,0,-1,-1,-1,-1,-1,6,-1
KR_6744933935,420,-4,-82,-16,-9,-1,3,2,-2,3,1,-3,6,3,-1,3,2,-2,2,0,0,-5,-9,-2,-1,3,0,0,-3,-1,-1,-1,-1,3,-1
KR_6763575387,420,-4,-44,-7,-8,-7,7,0,-2,3,1,1,1,2,0,3,3,0,0,0,-1,-6,-11,-5,-1,6,2,0,-1,-1,-1,-1,-1,1,-1
KR_6733907615,420,0,-78,-8,-3,-2,2,0,4,0,4,-4,4,0,0,1,1,-1,1,0,0,1,-14,4,-11,7,-2,0,-1,1,-1,-1,1,5,-1
KR_6735657059,420,-3,2,1,-8,-4,5,1,-1,5,4,-1,1,0,-1,3,2,-1,2,1,0,-5,-2,0,-2,2,-2,0,0,0,-1,0,-1,0,-1
KR_6578729530,420,4,35,-38,4,3,0,3,2,2,4,0,0,0,-1,3,2,0,0,0,0,2,47,-4,-3,7,-36,0,2,-1,-1,1,-1,4,-1
KR_6755730591,420,-3,-34,-7,-8,3,0,3,-1,3,2,-3,5,2,-7,7,0,0,2,2,0,-3,-4,-1,-4,5,1,0,0,1,1,-1,-1,6,-1
KR_6695284198,420,-1,-21,18,2,4,1,5,0,3,3,4,2,6,-5,7,2,-1,2,1,0,-4,-335,3,-4,1,-4,0,-2,-1,1,-1,1,3,-1
KR_6269216895,420,-4,-53,-48,-9,-2,2,0,-5,5,0,2,2,4,0,3,3,-4,4,0,-1,-13,4,3,-5,2,-4,0,-1,-1,-1,-1,-1,2,-1
KR_6764693596,420,-1,-62,-5,0,-1,4,3,-1,5,4,1,1,2,-1,2,1,2,1,3,0,3,-7,-4,-4,8,0,0,0,1,0,0,1,3,-1
KR_6762107394,420,-1,-28,12,-4,-4,4,0,2,2,4,-1,3,2,-1,1,0,0,0,0,0,2,209,1,-7,6,1,0,-1,1,-1,-1,-1,1,-1
KR_6713068868,420,-4,-72,-21,-7,0,4,4,-4,6,2,0,1,1,-3,4,1,0,2,2,0,-3,-3,2,-4,2,-3,0,-1,1,1,-1,1,5,-1
KR_6700202935,440,0,20,-19,-6,0,2,2,-2,6,4,0,1,1,-3,3,0,-1,1,0,0,-13,-44,-3,-3,6,1,0,0,-1,-1,1,-1,3,-1
KR_6758900301,420,-4,-77,-10,-10,-4,4,0,-4,7,3,-2,3,1,1,1,2,-1,1,0,0,-5,5,-1,-2,3,0,0,-1,0,0,-1,1,0,-1
KR_6542806097,440,-4,-92,24,-6,-7,7,0,-2,2,0,4,0,4,-2,2,0,1,1,2,0,-3,0,0,-2,2,-1,0,-2,1,-1,-1,-1,1,-1
KR_6743259863,420,1,52,12,-3,2,1,3,-2,3,1,2,4,6,-5,7,2,0,1,1,0,-8,-329,-3,-1,4,-2,0,0,-1,-1,-1,-1,3,-1
KR_6760851111,420,-2,-33,17,-8,-5,5,0,-2,2,0,0,1,1,-1,4,3,0,1,1,0,-4,23,-3,-2,5,1,0,-3,1,-1,-1,-1,1,-1
KR_6677769559,420,-5,-46,-24,-6,-5,6,1,3,2,5,2,2,4,-3,4,1,-3,3,0,0,-2,0,-2,-3,5,-2,0,-3,-1,1,-1,-1,2,-1
KR_6754104763,440,3,46,11,10,5,1,6,2,1,3,0,2,2,-1,2,1,4,0,4,0,11,-1,1,-3,2,1,0,-1,1,-1,-1,-1,4,-1
KR_6762169172,420,-4,-91,-13,-4,-2,2,0,-1,1,0,-1,2,1,0,2,2,0,3,3,0,-2,2,-3,-4,7,6,0,-1,1,-1,-1,1,6,-1
KR_6749268524,420,-8,-47,-40,-16,-1,2,1,-4,5,1,-2,3,1,-9,11,2,0,1,1,-1,-13,-2,0,-3,3,-1,0,0,-1,-1,0,-1,3,-1
KR_6764521988,420,-1,-81,-21,-3,-1,1,0,-1,4,3,4,2,6,-4,6,2,-1,2,1,0,-7,3,-1,-3,4,1,0,0,1,0,-1,-1,3,-1
KR_6728859705,440,-3,-110,-30,-11,0,2,2,-1,3,2,0,1,1,-2,3,1,-8,8,0,-1,-20,-6,-3,-2,5,-3,0,-3,-1,1,-1,-1,3,-1
KR_6764101945,420,-4,-63,33,-11,1,0,1,-1,3,2,0,3,3,-6,6,0,-5,7,2,0,-18,-11,2,-5,3,-5,0,0,0,0,-1,-1,0,-1
KR_6758381577,440,1,-42,17,-7,-1,3,2,-5,7,2,3,1,4,-2,5,3,-2,2,0,0,4,-9,2,-4,2,0,0,-1,0,-1,-1,-1,0,-1
KR_6718695443,440,-3,-106,-36,-6,0,3,3,0,1,1,-4,5,1,0,0,0,-2,3,1,0,-7,-3,1,-2,1,-2,0,-3,0,0,-1,1,0,-1
KR_6748788589,420,0,15,31,3,-3,3,0,6,0,6,-3,6,3,2,2,4,1,0,1,0,3,-2,0,-4,4,-4,0,1,-1,1,1,1,6,-1
KR_6755103008,420,-1,-46,-11,0,2,2,4,-4,7,3,0,2,2,2,2,4,0,1,1,0,-3,-96,-1,-5,6,-2,0,0,0,0,0,1,0,-1
KR_6294957742,420,-8,-125,-42,-21,-5,5,0,-5,8,3,-2,3,1,-9,10,1,0,1,1,0,-16,-3,-3,-2,5,0,0,-4,-1,0,-1,-1,3,-1
KR_6743757156,420,-3,-15,-37,-5,-2,4,2,-3,4,1,2,1,3,-2,4,2,0,1,1,0,0,5,2,-6,4,1,0,0,-1,0,0,-1,4,-1
KR_6713740278,420,-5,-6,-39,-17,-4,5,1,-5,6,1,0,1,1,-7,8,1,-1,2,1,-1,-11,25,-4,-2,6,-20,0,-1,-1,0,-1,-1,1,-1
KR_6572153479,440,0,20,16,-5,-1,2,1,0,2,2,-2,3,1,-3,3,0,1,0,1,0,-4,6,3,-5,2,-4,0,0,1,-1,0,-1,6,-1
KR_6759314209,420,-1,-9,20,-10,2,0,2,-4,6,2,-4,4,0,-2,3,1,-2,3,1,0,-4,10,-2,-2,4,-1,0,0,-1,-1,0,-1,2,-1
KR_6764683770,420,-2,7,-19,-7,-1,1,0,-1,2,1,-3,4,1,0,1,1,-2,2,0,0,-8,-8,4,-6,2,-1,0,0,1,-1,-1,-1,2,-1
KR_6763208887,440,2,102,-33,-1,5,1,6,-6,7,1,4,2,6,2,0,2,-6,7,1,0,5,-2,2,-2,0,1,0,-1,-1,1,1,1,4,-1
KR_6723523068,440,-2,-20,-9,1,-1,2,1,0,3,3,1,3,4,3,0,3,-2,3,1,1,4,-8,1,-6,5,2,0,-1,-1,1,-1,1,5,-1
KR_6715403018,420,-4,-37,8,-14,-4,5,1,-1,2,1,-1,1,0,-7,7,0,-1,1,0,0,-16,-21,-5,-1,6,-4,0,0,-1,1,0,-1,6,-1
KR_6723068278,420,-3,-94,-4,-7,2,1,3,-4,5,1,1,5,6,-6,6,0,0,0,0,0,-9,-17,-2,-2,4,1,0,-2,-1,-1,-1,-1,4,-1
KR_6668666168,420,-2,-22,-44,-12,1,1,2,-5,7,2,-8,8,0,0,3,3,0,1,1,0,-14,-2,-1,-4,5,-2,0,0,-1,-1,-1,-1,5,-1
KR_6695998161,440,-1,8,-23,-2,4,0,4,-4,4,0,-2,4,2,0,2,2,0,1,1,0,-4,-17,-1,-4,5,-3,0,0,-1,0,0,1,1,-1
KR_6653618997,420,0,-44,-19,-2,-4,4,0,3,1,4,4,1,5,-3,3,0,-2,3,1,0,-1,223,0,-4,4,17,0,0,1,-1,0,-1,2,-1
KR_6731877444,420,1,19,-8,2,-1,1,0,-1,4,3,0,2,2,1,3,4,3,1,4,0,3,3,-4,-3,7,-1,0,0,-1,0,0,-1,1,-1
KR_6754671714,420,5,82,32,10,0,2,2,0,1,1,-1,2,1,5,1,6,6,1,7,0,6,-2,-3,-2,5,1,0,4,1,1,1,1,2,-1
KR_6711203532,420,-4,-45,11,-10,-7,7,0,1,2,3,2,3,5,-4,4,0,-2,2,0,0,-14,-5,2,-6,4,0,0,-2,0,-1,-1,-1,0,-1
KR_6763767019,420,0,-44,40,4,-3,3,0,2,5,7,6,1,7,-1,3,2,0,2,2,0,2,-62,-2,-7,9,15,0,-1,1,-1,-1,1,1,-1
KR_6629277554,420,1,-16,12,4,-3,4,1,-1,3,2,5,3,8,2,4,6,1,2,3,0,-1,9,0,-1,1,3,0,-1,-1,1,1,-1,6,-1
KR_6647263908,420,-4,-44,-16,-4,1,0,1,-4,7,3,0,3,3,-3,7,4,2,0,2,0,-8,53,0,-4,4,-13,0,0,1,-1,0,-1,6,-1
KR_6686504762,420,-5,-29,0,-5,0,3,3,-1,5,4,-2,3,1,0,3,3,-2,3,1,0,-4,-8,-1,-4,5,-2,0,-2,-1,-1,-1,-1,6,-1
KR_6757881170,420,-6,-31,-21,-10,3,1,4,-3,3,0,-2,4,2,-6,6,0,-2,2,0,0,-12,1,-4,-3,7,0,0,-1,0,-1,-1,-1,0,-1
KR_6701380231,420,-1,83,-20,-7,4,0,4,-1,3,2,-3,4,1,-6,6,0,-1,2,1,0,-5,6,1,-4,3,-5,0,0,-1,1,-1,-1,2,-1
KR_6647230419,420,-5,30,-14,-7,0,1,1,-3,6,3,0,3,3,-2,5,3,-2,2,0,0,-8,294,3,-6,3,0,0,0,0,-1,-1,-1,0,-1
KR_6764518238,420,0,88,4,5,2,1,3,1,1,2,-2,4,2,3,2,5,1,3,4,0,2,-184,-2,-5,7,5,0,0,1,-1,1,1,3,-1
KR_6747702309,420,-4,-35,-19,-11,-1,3,2,-8,9,1,-6,6,0,3,0,3,1,0,1,-1,-8,5,1,-4,3,1,0,0,1,-1,1,-1,3,-1
KR_6752060603,420,-2,-24,7,-7,-3,3,0,0,2,2,-6,6,0,1,4,5,1,0,1,0,-8,-111,4,-6,2,-2,0,-1,1,-1,-1,1,5,-1
KR_6673030872,420,-4,-20,-16,-8,-3,5,2,1,3,4,-3,4,1,-4,7,3,1,0,1,0,-4,-31,0,-2,2,12,0,-1,1,-1,-1,-1,4,-1
KR_6711962345,420,-1,43,-4,-4,1,2,3,-2,5,3,1,3,4,-2,3,1,-2,4,2,0,-5,-6,1,-3,2,-2,0,0,-1,-1,0,-1,3,-1
KR_6667051423,420,-5,-66,-32,-12,-2,2,0,-2,4,2,0,1,1,-9,11,2,1,0,1,0,-20,12,-5,-3,8,-1,0,0,-1,-1,-1,-1,2,-1
KR_6756461792,420,-4,-27,-3,-4,-2,2,0,0,1,1,2,0,2,-1,2,1,-3,3,0,0,-4,-6,-1,-3,4,-3,0,-1,0,0,-1,1,0,-1
KR_6760092073,420,-4,-47,-12,-13,-2,3,1,1,1,2,-1,1,0,-8,9,1,-3,4,1,0,-11,-3,0,-5,5,3,0,-2,-1,-1,-1,-1,5,-1
KR_6684314075,420,-1,-38,-10,-2,0,2,2,0,2,2,0,4,4,0,2,2,-2,2,0,0,-4,243,-1,-4,5,0,0,-1,1,0,-1,1,4,-1
KR_6752521679,420,0,-16,25,-2,0,1,1,2,2,4,2,1,3,-4,5,1,-2,3,1,0,-4,21,1,-4,3,-17,0,1,-1,1,1,1,5,-1
KR_6761610908,440,-1,61,16,1,-1,3,2,2,1,3,8,1,9,-7,9,2,-1,1,0,0,-4,0,-5,-2,7,-2,0,-1,1,-1,-1,1,6,-1
KR_6762086116,420,-2,9,-38,-9,3,1,4,-7,7,0,-2,4,2,-5,5,0,2,2,4,0,-5,5,1,-3,2,1,0,-2,-1,-1,-1,-1,3,-1
KR_6723909395,420,-3,-88,13,-12,-4,5,1,-3,6,3,-5,5,0,-2,4,2,2,1,3,0,0,-41,-3,0,3,14,0,-3,-1,-1,-1,1,6,-1
KR_6598093289,420,-6,-67,14,-16,-4,4,0,0,1,1,0,0,0,-10,11,1,-2,2,0,0,-12,-9,-6,-1,7,5,0,-1,-1,-1,-1,-1,2,-1
KR_6642307256,420,-4,-39,-4,-6,2,1,3,-2,2,0,-1,1,0,-1,2,1,-4,5,1,0,-7,12,-4,0,4,-3,0,0,0,1,0,-1,0,-1
KR_6614732736,420,-5,-147,-22,-13,-2,2,0,-4,4,0,0,2,2,-7,8,1,0,0,0,0,-18,16,-7,0,7,-15,0,-3,-1,0,-1,-1,2,-1
KR_6687978985,420,-1,-62,12,2,3,4,7,-1,2,1,-1,4,3,1,2,3,0,1,1,0,3,1,3,-4,1,-4,0,0,1,0,0,-1,4,-1
KR_6655625939,420,0,-34,13,0,7,0,7,-1,5,4,-2,4,2,-5,8,3,1,0,1,0,-7,-6,0,-4,4,-1,0,0,1,0,-1,1,3,-1
KR_6735397236,440,1,31,36,0,3,0,3,1,1,2,-4,5,1,-1,3,2,1,1,2,0,-5,13,-5,-3,8,-1,0,1,1,1,1,-1,4,-1
KR_6764021097,420,-3,-102,16,-6,-3,3,0,-6,6,0,0,3,3,2,1,3,1,0,1,0,-2,28,-5,-1,6,-6,0,-2,1,-1,-1,-1,5,-1
KR_6753673566,420,-3,28,1,-14,-4,4,0,-6,6,0,-2,4,2,-1,2,1,-1,1,0,0,-17,-10,0,-2,2,-1,0,-2,-1,-1,-1,-1,4,-1
KR_6750339352,420,0,-26,13,-4,1,0,1,-1,1,0,-2,2,0,-2,2,0,0,0,0,0,-3,-5,-2,-5,7,-3,0,0,-1,1,0,-1,4,-1
KR_6744704829,440,1,-10,8,-2,2,2,4,-3,4,1,3,2,5,-5,7,2,1,1,2,0,1,-2,-2,-6,8,-3,0,-1,1,-1,-1,1,5,-1
KR_6763126887,420,-1,-19,-28,-1,-2,4,2,-2,2,0,-3,6,3,3,0,3,3,1,4,0,0,1,-1,-5,6,-1,0,-1,1,-1,-1,1,4,-1
KR_6763347508,420,-6,-17,-23,-5,-5,6,1,-2,2,0,-1,2,1,1,2,3,2,0,2,0,0,9,1,-4,3,-1,0,0,1,-1,-1,-1,4,-1
KR_6678938280,420,0,-2,8,-1,-3,5,2,0,1,1,0,2,2,2,3,5,0,0,0,-1,3,3,2,-2,0,-1,0,-2,-1,-1,-1,-1,5,-1
KR_6596074859,420,-1,-32,20,-3,1,1,2,-7,7,0,0,2,2,2,2,4,1,1,2,0,-2,-94,1,-4,3,-4,0,0,-1,0,0,-1,2,-1
KR_6760059248,420,-2,-35,12,0,0,2,2,-3,3,0,2,3,5,1,1,2,0,3,3,0,1,-2,0,-2,2,-4,0,0,-1,-1,1,-1,1,-1
KR_6722756675,440,-5,14,-32,-11,-2,3,1,1,1,2,-1,1,0,-7,7,0,-2,2,0,0,-13,-1,-5,0,5,0,0,-1,1,-1,-1,-1,6,-1
KR_6749410001,440,-5,-103,-4,-6,0,0,0,-1,1,0,-4,6,2,-4,5,1,3,5,8,2,-4,-13,0,-4,4,2,0,-3,-1,-1,-1,1,5,-1
KR_6630576192,420,-3,-62,8,-1,-2,3,1,4,1,5,-4,6,2,2,1,3,-1,3,2,1,6,44,2,-5,3,-12,0,-2,-1,1,-1,1,5,-1
KR_6689067098,420,-2,-70,8,-10,-5,6,1,0,7,7,-4,5,1,2,4,6,-3,4,1,0,-11,-46,-4,0,4,15,0,0,-1,1,-1,-1,2,-1
KR_6664047855,440,-1,-25,26,-2,3,0,3,1,0,1,-4,4,0,0,0,0,-2,3,1,0,-2,1,3,-6,3,2,0,0,1,0,0,1,6,-1
KR_6671612395,420,-1,-14,-28,-4,1,0,1,-1,2,1,-3,7,4,1,2,3,-2,2,0,0,2,78,1,-5,4,-1,0,-1,1,-1,-1,-1,1,-1
KR_6720888378,440,-1,-23,-8,-1,-5,6,1,3,2,5,2,0,2,0,1,1,-1,4,3,0,7,-2,-2,-4,6,-2,0,-1,-1,-1,-1,1,5,-1
KR_6731603586,440,-3,-103,-36,-7,1,1,2,-2,3,1,-4,5,1,-1,2,1,-1,1,0,0,-12,36,-3,-2,5,-16,0,-2,-1,-1,-1,-1,4,-1
KR_6751785854,420,-2,-50,21,-4,-3,7,4,-2,6,4,-3,7,4,0,2,2,4,0,4,0,-1,-4,-2,-3,5,0,0,-1,1,1,-1,-1,6,-1
KR_6656654303,420,0,7,12,-2,2,1,3,0,6,6,-5,5,0,1,1,2,0,2,2,1,-9,-11,-1,-3,4,3,0,2,1,1,1,1,2,-1
KR_6760907459,420,-2,-44,-48,-3,2,0,2,-4,6,2,3,3,6,-3,9,6,-1,1,0,1,-14,7,-2,-3,5,-4,0,-1,-1,1,-1,1,3,-1
KR_6738334390,420,-1,30,-4,-3,-2,3,1,-1,2,1,3,0,3,-2,2,0,-1,1,0,0,-5,4,4,-9,5,-3,0,0,-1,-1,-1,1,3,-1
KR_6664877098,420,-2,-18,14,-13,-5,5,0,-6,6,0,-4,8,4,2,1,3,0,2,2,1,-15,71,-1,-1,2,-1,0,-2,-1,-1,-1,1,2,-1
KR_6734904322,420,-4,-73,-15,-12,-10,10,0,0,5,5,4,0,4,-6,6,0,0,0,0,0,-11,-4,-1,-1,2,0,0,-2,0,1,-1,-1,0,-1
KR_6726260257,420,-2,41,-27,-5,1,1,2,0,1,1,0,2,2,-5,8,3,-1,1,0,0,-6,-6,-2,-4,6,0,0,-1,0,-1,-1,1,0,-1
KR_6753337577,440,2,15,-4,5,4,0,4,1,4,5,1,1,2,-3,3,0,2,1,3,0,3,-12,-1,-3,4,1,0,1,-1,1,1,1,3,-1
KR_6761925255,420,-2,2,-27,0,1,1,2,3,1,4,-1,2,1,-4,4,0,1,1,2,0,-1,5,1,-8,7,-7,0,1,-1,1,1,1,2,-1
KR_6727418819,440,0,-20,-24,-4,0,1,1,-2,5,3,4,0,4,-1,2,1,-5,5,0,0,-4,0,1,-3,2,0,0,0,0,1,0,-1,0,-1
KR_6742532932,420,-3,-9,-16,-7,-2,2,0,-3,3,0,-1,1,0,-1,1,0,0,0,0,0,-6,-36,-3,-2,5,-1,0,-1,-1,-1,-1,-1,4,-1
KR_6752595744,420,-2,-66,-16,-3,-2,5,3,1,1,2,-1,3,2,-1,3,2,0,0,0,0,-4,-17,4,-5,1,-2,0,-1,-1,1,-1,1,1,-1
KR_6690396507,420,0,28,39,2,3,1,4,3,3,6,-2,4,2,-3,6,3,1,1,2,0,-2,1,0,-3,3,0,0,1,0,1,1,1,0,-1
KR_6753798788,420,-3,-83,-28,-11,-6,9,3,3,1,4,0,3,3,0,4,4,-8,10,2,-1,-5,-3,-1,-2,3,-2,0,-3,-1,-1,-1,-1,6,-1
KR_6761003635,420,0,-48,12,-2,-4,5,1,-1,2,1,3,1,4,0,4,4,0,1,1,0,1,-3,0,-2,2,2,0,-1,1,0,-1,-1,6,-1
KR_6273617073,420,3,4,28,0,-4,4,0,2,1,3,-3,6,3,4,0,4,1,0,1,0,0,14,-1,-3,4,1,0,2,1,1,1,-1,2,-1
KR_6728529302,420,2,36,33,-1,2,0,2,-2,5,3,0,2,2,-2,3,1,1,0,1,1,4,-1,0,-3,3,2,0,0,0,-1,0,1,0,-1
KR_6752244722,420,-2,-19,-11,1,-6,8,2,3,1,4,-4,4,0,6,3,9,2,0,2,1,3,-3,2,-6,4,1,0,0,1,-1,-1,1,6,-1
KR_6743655983,420,-1,10,12,0,-4,4,0,-1,3,2,3,0,3,1,1,2,1,2,3,0,2,37,-4,-5,9,-23,0,0,1,-1,1,1,6,-1
KR_6706770860,440,2,45,-4,1,1,1,2,-3,5,2,1,1,2,1,3,4,1,1,2,0,3,-3,0,-2,2,-2,0,0,-1,1,0,1,3,-1
KR_6702710533,440,-3,-61,15,-6,-7,7,0,3,2,5,-1,3,2,-4,5,1,3,1,4,0,-11,-5,2,-4,2,-2,0,-1,1,-1,-1,-1,4,-1
KR_6750199299,420,-1,0,-17,-3,2,2,4,-1,3,2,-2,4,2,-3,4,1,1,1,2,0,-6,-17,-1,-4,5,1,0,0,1,0,0,1,1,-1
KR_6741623154,420,-2,-52,-15,-3,0,1,1,0,4,4,-3,4,1,3,0,3,-3,4,1,0,1,-20,-1,-1,2,-1,0,0,-1,-1,-1,-1,1,-1
KR_6754568914,440,1,81,8,-4,-2,3,1,-1,4,3,-4,6,2,4,0,4,-1,1,0,0,-2,17,-1,-7,8,-5,0,0,1,-1,0,-1,5,-1
KR_6755691158,420,-2,-37,0,0,8,0,8,-1,1,0,-5,7,2,-5,6,1,3,0,3,0,5,7,0,-2,2,-3,0,0,1,1,0,-1,5,-1
KR_6758372061,420,-3,-50,-6,-10,-4,4,0,-4,6,2,0,1,1,-1,2,1,-1,1,0,0,-10,-197,-1,-3,4,-24,0,-1,1,-1,-1,-1,3,-1
KR_6752591773,420,2,29,-20,6,-2,3,1,-2,2,0,4,0,4,5,0,5,1,0,1,0,5,-11,1,-4,3,-25,0,2,-1,1,1,1,1,-1
KR_6756441772,420,-2,-26,0,-17,-4,4,0,-3,3,0,-3,3,0,-5,6,1,-2,6,4,-1,-16,19,-1,-2,3,-3,0,-2,0,-1,-1,-1,0,-1
KR_6748574271,420,-5,-63,-36,-4,3,0,3,1,2,3,-2,5,3,-4,7,3,-2,3,1,0,5,-27,1,-5,4,0,0,-1,-1,-1,-1,-1,5,-1
KR_6722835436,440,-3,-26,0,-1,-4,4,0,-1,2,1,-1,5,4,3,0,3,2,0,2,0,-5,8,0,-3,3,0,0,0,1,1,0,1,4,-1
KR_6756967237,420,5,66,27,7,4,0,4,4,2,6,0,1,1,0,4,4,-1,1,0,1,3,410,-2,-2,4,0,0,0,1,1,1,1,4,-1
KR_6712923040,420,0,-32,16,-1,0,2,2,1,5,6,1,3,4,-1,1,0,-2,3,1,0,-3,-5,0,-5,5,-7,0,-1,0,-1,-1,1,0,-1
KR_6761983245,420,2,11,16,6,0,3,3,1,3,4,-3,3,0,3,2,5,5,0,5,0,12,9,2,-6,4,-8,0,0,1,0,0,-1,4,-1
KR_6665783468,420,-4,-50,-37,-14,-2,2,0,-5,6,1,-1,2,1,-4,4,0,-2,3,1,-1,-13,215,-6,-1,7,0,0,-2,-1,-1,-1,-1,5,-1
KR_6662176335,440,-4,-65,24,-10,-2,2,0,-9,10,1,0,3,3,0,3,3,1,1,2,-1,-12,-6,0,0,0,-1,0,-1,-1,1,-1,-1,1,-1
KR_6720321261,420,3,69,12,7,8,1,9,4,2,6,1,1,2,-9,11,2,3,0,3,3,15,1,-4,-3,7,-1,0,1,1,1,1,1,4,-1
KR_6637539499,420,-2,-85,-6,1,1,0,1,6,2,8,1,1,2,-6,6,0,-1,1,0,0,0,156,0,-6,6,-2,0,-2,1,-1,-1,1,4,-1
KR_6745460866,420,-4,-31,-4,-7,0,2,2,-5,6,1,-1,1,0,0,2,2,-1,1,0,0,-2,-6,0,-3,3,0,0,-1,-1,-1,-1,-1,4,-1
KR_6748507810,440,-3,36,-11,-10,3,1,4,-4,4,0,-1,2,1,-2,3,1,-6,6,0,0,1,22,1,-2,1,-2,0,0,-1,0,0,-1,5,-1
KR_6742789607,420,1,13,-7,4,4,0,4,-1,2,1,1,4,5,1,2,3,-1,2,1,3,-1,12,2,-5,3,4,0,1,-1,0,1,1,6,-1
KR_6764540761,420,-2,40,4,-8,-4,5,1,0,1,1,-1,4,3,-3,7,4,0,1,1,0,-8,-5,-3,-4,7,7,0,-1,0,-1,-1,1,0,-1
KR_6723934612,420,-3,-50,-1,-9,0,1,1,2,2,4,-3,7,4,-6,6,0,-2,3,1,1,-15,368,-2,-5,7,3,0,0,1,1,0,1,6,-1
KR_6746309762,420,-2,-7,-3,-4,2,1,3,1,2,3,0,1,1,-8,9,1,1,3,4,0,0,100,-1,-5,6,-1,0,-1,-1,0,-1,-1,5,-1
KR_6762912970,420,-2,40,-13,-12,2,3,5,-2,4,2,-5,6,1,-7,7,0,0,2,2,0,-18,-3,-5,0,5,-4,0,0,-1,-1,1,-1,3,-1
KR_6666083808,420,0,-26,20,0,-1,1,0,-3,3,0,1,1,2,3,0,3,0,0,0,0,-3,4,2,-6,4,-3,0,0,1,0,0,1,6,-1
KR_6732355492,440,0,1,-4,-6,0,3,3,-1,6,5,-3,6,3,-4,6,2,2,0,2,0,-15,4,-2,-7,9,-3,0,-3,-1,-1,-1,1,3,-1
KR_6741080665,440,-7,-81,-20,-13,-4,5,1,-1,3,2,-2,2,0,-6,8,2,0,1,1,0,-13,3,4,-8,4,-6,0,-1,-1,-1,-1,-1,1,-1
KR_6746481759,440,-4,-69,-4,2,1,1,2,2,3,5,-7,8,1,6,0,6,0,0,0,0,6,-7,-1,-2,3,0,0,0,-1,1,1,1,3,-1
KR_6762707704,420,-1,-102,-4,-6,1,4,5,3,2,5,-2,2,0,-4,6,2,-4,4,0,0,-6,-3,-2,-5,7,0,0,-3,1,-1,-1,-1,6,-1
KR_6729722176,420,-4,-85,22,0,3,3,6,0,5,5,-4,6,2,3,1,4,-2,3,1,0,0,-4,2,-4,2,-1,0,-2,1,-1,-1,1,1,-1
KR_6759121447,420,-5,-43,-20,-13,-4,4,0,-1,2,1,0,1,1,-4,5,1,-4,7,3,-1,-13,-96,-4,-2,6,0,0,-2,-1,-1,-1,-1,3,-1
KR_6694596829,440,2,2,-4,7,-2,3,1,2,0,2,-3,5,2,7,1,8,3,0,3,0,10,1,-1,-3,4,0,0,-1,0,-1,-1,-1,0,-1
KR_6756494413,420,-8,-69,-28,-12,-6,6,0,-1,4,3,0,1,1,-5,6,1,0,0,0,0,-11,-223,-4,-2,6,-6,0,-1,-1,0,-1,1,3,-1
KR_6761886603,440,1,-15,29,1,2,2,4,3,0,3,-4,5,1,0,2,2,0,1,1,0,3,55,-3,-4,7,2,0,0,-1,0,0,1,1,-1
KR_6763553297,420,-3,-29,-36,-7,1,1,2,-2,3,1,-3,3,0,-1,2,1,-2,4,2,0,-12,-7,0,-4,4,3,0,-1,-1,-1,-1,1,4,-1
KR_6689078428,420,-3,-67,-25,-5,-2,4,2,-3,3,0,0,1,1,1,3,4,-1,1,0,1,0,-4,0,-2,2,2,0,-1,0,-1,-1,1,0,-1
KR_6738220891,440,-1,-46,4,3,-1,1,0,1,1,2,1,1,2,-1,3,2,3,0,3,0,7,-256,-4,-1,5,-2,0,0,-1,-1,0,1,2,-1
KR_6737739262,420,-2,-23,-5,-7,1,1,2,1,3,4,-6,7,1,-2,3,1,-1,1,0,0,-4,0,2,-6,4,-3,0,-1,1,-1,-1,-1,6,-1
KR_6761523795,420,-3,20,-24,-1,-1,3,2,2,2,4,-1,3,2,2,1,3,-3,3,0,0,4,5,4,-7,3,-4,0,0,-1,1,0,1,6,-1
KR_6764041258,420,-4,-83,-2,-15,0,2,2,-8,8,0,-5,6,1,-2,2,0,0,0,0,-1,-14,-1,2,-5,3,1,0,-1,-1,0,-1,-1,3,-1
KR_6737049290,440,-1,-21,0,-3,-6,6,0,-3,3,0,5,1,6,3,0,3,-2,2,0,1,-7,-26,0,-5,5,-6,0,0,1,-1,0,1,1,-1
KR_6731477743,440,-3,-40,11,-5,-1,1,0,-1,2,1,0,4,4,-1,1,0,-2,2,0,-1,-4,-24,-2,-4,6,4,0,0,1,1,0,-1,3,-1
KR_6642331986,420,1,20,-12,5,1,0,1,-2,3,1,6,0,6,0,4,4,0,0,0,0,1,-1,-3,-4,7,-3,0,0,0,1,1,-1,0,-1
KR_6764213241,420,2,2,4,0,-2,3,1,-3,3,0,-3,5,2,6,2,8,2,2,4,1,-3,-140,-2,-1,3,2,0,2,-1,1,1,1,5,-1
KR_6755160332,420,-3,-78,8,-2,2,0,2,-7,9,2,2,5,7,2,1,3,-1,1,0,0,-10,4,0,-1,1,-3,0,0,-1,1,-1,-1,6,-1
KR_6299334559,420,-3,-67,37,-13,-5,5,0,-4,5,1,-7,8,1,2,1,3,1,1,2,0,-3,-4,-2,-2,4,4,0,-1,1,-1,-1,1,3,-1
KR_6754951941,440,-3,-14,-12,-6,-2,3,1,-5,5,0,2,4,6,-1,5,4,0,1,1,0,-5,-35,0,-2,2,-2,0,0,-1,-1,-1,1,1,-1
KR_6761080725,440,-5,-76,-16,-11,0,3,3,-3,6,3,1,2,3,-7,7,0,-2,4,2,1,-11,8,-2,-1,3,1,0,-1,-1,0,-1,1,5,-1
KR_6485496530,420,3,46,8,0,0,1,1,-2,3,1,-1,3,2,1,3,4,2,0,2,0,-1,22,2,-6,4,-1,0,1,1,1,1,-1,3,-1
KR_6764199751,420,-4,-81,-4,-6,-6,6,0,-3,5,2,0,2,2,-1,3,2,4,0,4,0,2,109,0,-6,6,1,0,-1,-1,-1,-1,1,1,-1
KR_6756505443,420,3,35,-4,6,2,1,3,-1,2,1,1,2,3,2,2,4,2,3,5,0,6,-17,4,-5,1,1,0,1,1,1,1,1,3,-1
KR_6730648144,420,-4,-129,-45,-8,-12,13,1,0,3,3,1,1,2,0,4,4,3,0,3,1,5,76,0,-8,8,-2,0,0,-1,-1,-1,1,5,-1
KR_6600375183,420,0,19,40,-2,2,0,2,-2,2,0,-2,5,3,-1,2,1,1,0,1,0,2,32,2,-5,3,-2,0,0,1,0,0,1,5,-1
KR_6728845422,420,-4,-85,-40,-14,0,0,0,-1,2,1,-5,8,3,-4,4,0,-4,4,0,-1,-10,23,-5,-2,7,-5,0,-1,-1,-1,-1,-1,2,-1
KR_6734950875,420,-7,-75,-23,-15,-3,4,1,-1,2,1,-7,8,1,-3,4,1,-1,1,0,0,-8,-20,1,-5,4,-2,0,-3,-1,1,-1,1,1,-1
KR_6744885559,420,-2,7,-12,-5,-1,2,1,-5,6,1,1,2,3,-1,4,3,1,1,2,0,-7,0,-1,-3,4,-3,0,0,-1,-1,0,-1,5,-1
KR_6659790547,420,1,-49,11,-2,2,1,3,-4,6,2,0,1,1,-2,4,2,2,1,3,0,-3,-5,-3,-2,5,1,0,1,-1,1,1,-1,1,-1
KR_6764487288,440,0,36,-8,0,0,2,2,-1,1,0,-2,5,3,4,1,5,-1,1,0,0,-4,32,-3,-3,6,-19,0,1,1,1,1,-1,4,-1
KR_6749104473,440,-1,-50,4,-6,2,0,2,1,0,1,-1,4,3,-8,9,1,0,2,2,0,-3,-33,0,-3,3,18,0,-1,1,1,-1,1,5,-1
KR_6761665174,420,1,-49,0,3,-1,1,0,6,3,9,-3,4,1,0,1,1,1,2,3,0,0,6,-1,-2,3,2,0,-1,1,0,-1,-1,3,-1
KR_6638260566,420,-3,-50,5,-12,-1,2,1,-2,4,2,-2,5,3,-6,6,0,-1,2,1,0,-18,-13,-3,-3,6,-1,0,-2,1,-1,-1,-1,3,-1
KR_6731508635,420,0,-17,-16,-4,-1,3,2,-1,5,4,4,1,5,-2,2,0,-4,5,1,-1,-10,-1,-5,-1,6,1,0,0,-1,-1,-1,-1,6,-1
KR_6760005114,420,-2,-45,-16,-7,-3,3,0,1,2,3,-7,9,2,0,2,2,2,1,3,0,0,-4,-6,-2,8,1,0,-1,-1,-1,-1,1,2,-1
KR_6751001656,420,-3,-27,-28,-6,-4,4,0,1,1,2,-1,5,4,-2,2,0,0,1,1,0,-3,-3,0,-2,2,1,0,-3,0,-1,-1,-1,0,-1
KR_6751950210,420,0,-70,4,-5,2,0,2,-3,3,0,-1,2,1,-3,3,0,0,0,0,0,-5,-27,1,-5,4,-3,0,-1,-1,-1,-1,-1,2,-1
KR_6748865707,420,-2,-82,3,-3,3,1,4,5,1,6,-3,8,5,-6,7,1,-2,4,2,-1,-3,15,3,-4,1,-3,0,-2,1,0,-1,-1,1,-1
KR_6271052584,440,-3,-72,-8,-1,0,0,0,-3,5,2,2,1,3,-1,1,0,1,0,1,0,-1,5,3,-6,3,-3,0,-2,-1,0,-1,1,1,-1
KR_6738527519,440,-4,-22,-16,-7,-2,3,1,2,1,3,-3,4,1,-8,8,0,4,0,4,-1,-3,4,0,-4,4,-2,0,0,-1,-1,-1,-1,2,-1
KR_6757684679,420,-2,-53,-20,0,1,3,4,-3,3,0,-1,1,0,-3,4,1,6,1,7,0,8,-14,-3,-3,6,1,0,-1,-1,-1,-1,1,1,-1
KR_6741151546,420,-5,-32,16,-9,-6,6,0,1,0,1,-3,4,1,0,1,1,-1,1,0,0,-3,4,0,-7,7,-8,0,-1,-1,1,-1,-1,6,-1
KR_6578639252,420,-1,4,11,1,3,2,5,4,0,4,1,2,3,-6,7,1,-1,2,1,0,-1,-1,2,-3,1,-2,0,0,1,1,-1,1,6,-1
KR_6665375059,420,-8,-63,-33,-24,-7,7,0,-3,4,1,-7,8,1,-5,5,0,-2,2,0,0,-27,-54,0,-5,5,-6,0,-2,-1,-1,-1,-1,5,-1
KR_6758699585,420,5,87,12,9,3,1,4,-1,4,3,7,0,7,0,4,4,0,2,2,-1,-2,11,-1,-4,5,0,0,1,1,1,1,-1,6,-1
KR_6536686151,440,-2,-45,1,-7,1,1,2,3,3,6,-5,7,2,-7,7,0,1,0,1,0,-17,5,-1,-3,4,-4,0,2,1,1,1,-1,1,-1
KR_6719312136,440,-2,-45,7,-3,-6,8,2,0,1,1,2,1,3,0,5,5,1,0,1,1,1,8,-2,-2,4,-2,0,-1,1,1,-1,1,6,-1
KR_6748076262,420,-1,43,-10,-6,1,2,3,-9,10,1,3,2,5,-2,6,4,1,0,1,1,-6,-7,-3,-2,5,2,0,1,-1,1,1,-1,1,-1
KR_6598261629,420,-1,-66,-1,-1,2,1,3,1,4,5,-1,2,1,-7,9,2,4,0,4,0,3,242,4,-7,3,-2,0,-2,-1,-1,-1,1,5,-1
KR_6761895564,420,-1,35,-12,-3,7,0,7,-6,7,1,-5,9,4,1,1,2,0,0,0,1,-10,4,2,-2,0,-2,0,2,-1,1,1,1,2,-1
KR_6761095099,420,3,83,6,12,4,2,6,-2,3,1,7,3,10,-2,2,0,5,3,8,0,-3,274,4,-5,1,-3,0,1,0,1,1,1,0,-1
KR_6724884985,420,-3,-74,-27,-1,2,1,3,-5,7,2,-1,3,2,0,2,2,3,0,3,-1,-4,-6,-3,-3,6,2,0,0,1,1,0,-1,6,-1
KR_6663716415,440,-2,-21,12,-1,5,0,5,-6,6,0,-3,4,1,3,0,3,0,0,0,0,-9,-26,-4,-5,9,1,0,0,-1,-1,0,1,5,-1
KR_6755630768,420,-6,-91,-32,-10,-2,3,1,-2,2,0,-5,8,3,-1,2,1,0,1,1,0,0,13,0,-5,5,-2,0,-1,-1,1,-1,1,2,-1
KR_6687724598,420,-4,-99,-17,-12,-3,5,2,-1,2,1,-4,5,1,0,0,0,-4,4,0,0,-10,-26,-2,-3,5,-5,0,-2,-1,-1,-1,-1,6,-1
KR_6730928837,420,-4,-25,-4,-4,-3,4,1,1,3,4,-5,6,1,4,1,5,-1,1,0,0,2,-7,2,-4,2,3,0,-2,-1,1,-1,-1,5,-1
KR_6735330466,420,-1,20,-12,-6,0,1,1,-2,2,0,0,1,1,-3,4,1,-1,1,0,1,-4,3,1,-3,2,-2,0,0,1,-1,0,1,4,-1
KR_6749280102,440,-1,-24,-40,-2,-3,3,0,1,2,3,-2,3,1,2,1,3,0,2,2,0,-1,5,-1,-3,4,1,0,-1,0,1,-1,1,0,-1
KR_6712963250,440,-3,27,-67,-9,1,0,1,2,0,2,-6,8,2,-5,6,1,-1,5,4,0,-8,5,-1,-2,3,-3,0,-1,-1,-1,-1,-1,2,-1
KR_6551101983,440,3,24,12,4,0,3,3,-4,5,1,5,2,7,1,1,2,2,0,2,0,4,-18,8,-12,4,5,0,-1,0,1,-1,-1,0,-1
KR_6762378941,440,-1,-30,17,-7,-1,3,2,-3,5,2,-3,5,2,0,2,2,0,1,1,-1,-2,8,2,-4,2,-1,0,0,-1,0,0,-1,4,-1
KR_6661041207,420,-2,9,-8,-8,0,0,0,-1,5,4,0,4,4,-3,5,2,-4,4,0,0,-11,11,2,-8,6,-7,0,0,-1,-1,-1,1,5,-1
KR_6557108497,420,2,25,35,1,-1,2,1,1,1,2,-3,5,2,6,0,6,-2,3,1,1,-1,-3,1,-7,6,0,0,0,0,-1,1,1,0,-1
KR_6752472824,420,-4,-104,11,-4,-2,2,0,-3,5,2,-1,4,3,2,1,3,0,1,1,0,-6,-3,-1,-5,6,-4,0,0,-1,1,-1,-1,4,-1
KR_6673697161,420,-1,-31,-4,2,1,0,1,4,1,5,-1,2,1,-2,4,2,0,1,1,0,3,-1,-2,-1,3,4,0,1,-1,1,1,1,2,-1
KR_6760332434,420,-2,52,-4,-6,-2,2,0,2,5,7,-2,2,0,-4,4,0,0,3,3,0,-3,6,-2,-3,5,-5,0,1,-1,1,1,-1,2,-1
KR_6749687430,420,-1,-30,17,-3,0,3,3,-1,4,3,-1,4,3,-1,2,1,0,1,1,-1,-3,201,2,-6,4,2,0,0,0,1,-1,-1,0,-1
KR_6568142186,440,-4,-31,10,-11,-1,3,2,0,0,0,-2,2,0,-8,11,3,0,0,0,-1,-13,-3,-2,-2,4,-3,0,0,-1,1,1,-1,2,-1
KR_6619267789,420,-1,82,-12,-5,4,1,5,1,4,5,0,3,3,-8,8,0,-2,3,1,0,-19,113,0,-3,3,-1,0,2,1,-1,1,1,3,-1
KR_6615756115,440,3,111,52,-3,-1,4,3,0,4,4,-1,4,3,2,0,2,-3,3,0,1,-15,-2,3,-4,1,3,0,2,0,0,1,1,0,-1
KR_6756275273,420,-1,-80,8,-2,3,1,4,-3,5,2,2,4,6,-6,7,1,2,0,2,0,2,-7,0,-4,4,2,0,-1,0,-1,-1,1,0,-1
KR_6736472608,440,2,0,11,8,4,1,5,-6,7,1,1,1,2,6,0,6,3,0,3,0,7,-14,2,-2,0,0,0,0,1,-1,1,1,5,-1
KR_6610403359,420,-1,3,-36,0,3,2,5,-1,6,5,0,0,0,-2,4,2,0,0,0,1,-5,13,-5,-3,8,-1,0,-1,-1,1,-1,1,1,-1
KR_6757467490,440,-7,-56,-32,-15,-1,2,1,-6,6,0,-1,3,2,-6,9,3,-1,1,0,0,-12,-142,-3,-3,6,-5,0,-1,1,-1,-1,1,3,-1
KR_6743676086,420,-1,31,21,-5,2,1,3,0,2,2,-4,6,2,-3,3,0,0,0,0,0,-10,-1,-2,-3,5,4,0,0,0,0,0,1,0,-1
KR_6674645321,440,-3,-94,8,0,-5,7,2,2,0,2,0,3,3,2,1,3,1,1,2,1,-5,-3,-1,-3,4,-2,0,0,-1,1,-1,1,4,-1
KR_6742940080,420,-7,-107,-11,-14,-3,3,0,-4,6,2,-3,5,2,-2,3,1,-2,2,0,-1,-7,-261,1,-2,1,-2,0,0,0,0,0,-1,0,-1
KR_6761191990,420,-2,-38,-8,-16,-7,8,1,0,3,3,-4,7,3,-4,4,0,-1,3,2,0,-8,-259,-3,-3,6,-1,0,-1,-1,0,-1,-1,6,-1
KR_6763321833,420,-2,0,-35,-3,-4,7,3,-1,1,0,-1,5,4,1,1,2,2,1,3,0,1,-123,-3,-1,4,1,0,-1,-1,1,-1,-1,1,-1
KR_6743830089,420,-3,-44,8,-9,6,0,6,-6,7,1,-6,7,1,-2,3,1,-1,2,1,0,-10,-9,1,-7,6,-1,0,1,-1,1,1,1,5,-1
KR_6642746858,420,-2,-95,-35,-4,0,5,5,1,5,6,0,2,2,-3,6,3,-2,2,0,0,9,209,2,-6,4,-6,0,-1,-1,0,-1,-1,3,-1
KR_6764345038,420,-1,75,-7,-1,0,2,2,-2,3,1,0,1,1,0,1,1,1,0,1,0,3,8,1,-3,2,-2,0,1,1,-1,1,-1,6,-1
KR_6682864016,420,-2,-46,-16,1,-9,10,1,11,0,11,2,2,4,-5,7,2,2,2,4,0,19,2,-2,-1,3,6,0,-2,-1,1,-1,-1,1,-1
KR_6738644724,420,-6,-105,-19,-6,-4,4,0,0,0,0,-5,8,3,2,1,3,1,1,2,0,0,17,2,-6,4,-21,0,-2,-1,-1,-1,-1,6,-1
KR_6750644702,420,-4,-71,4,-11,-7,8,1,-2,3,1,3,0,3,-4,4,0,-1,1,0,0,-5,7,-5,-1,6,0,0,-1,1,1,-1,-1,3,-1
KR_6689604327,420,-3,-107,-28,-11,-8,8,0,0,3,3,-1,3,2,-3,5,2,1,0,1,0,-3,-225,-1,-4,5,2,0,-3,-1,1,-1,-1,2,-1
KR_6743821887,420,1,45,17,7,2,3,5,-1,3,2,0,4,4,6,2,8,0,0,0,0,4,-6,-1,-2,3,4,0,0,1,-1,0,1,6,-1
KR_6673396400,420,-6,-35,-17,-17,1,1,2,-7,7,0,-4,4,0,-6,7,1,-1,1,0,0,-19,-1,0,-3,3,-1,0,-1,-1,-1,-1,-1,5,-1
KR_6753753745,440,3,23,4,6,3,0,3,-2,3,1,-3,4,1,7,0,7,1,2,3,0,9,2,-1,-2,3,4,0,0,1,1,0,1,2,-1
KR_6681894189,440,-2,-24,-2,-9,-2,3,1,0,3,3,-7,10,3,-1,1,0,1,0,1,-1,-16,3,-4,-2,6,-4,0,0,1,1,-1,-1,5,-1
KR_6689056981,420,-1,-5,9,1,1,0,1,-3,5,2,1,2,3,2,1,3,0,0,0,0,-1,-53,-3,-2,5,5,0,-1,-1,-1,-1,1,3,-1
KR_6708317453,420,-2,5,-1,-4,2,0,2,1,2,3,2,0,2,-9,9,0,0,1,1,1,-7,-22,2,-4,2,0,0,0,0,1,0,1,0,-1
KR_6757571132,420,-3,-63,-12,-6,0,1,1,2,1,3,1,3,4,-10,10,0,1,0,1,0,-9,-19,-3,-3,6,-1,0,-2,-1,-1,-1,-1,5,-1
KR_6741354573,420,-3,65,16,-8,6,3,9,2,0,2,-1,3,2,-9,10,1,-6,8,2,0,-19,10,9,-11,2,-1,0,-1,1,1,1,1,1,-1
KR_6668331999,420,-3,29,20,-5,1,1,2,-9,11,2,0,3,3,3,3,6,0,1,1,0,-5,-3,-1,-1,2,0,0,0,1,-1,0,1,5,-1
KR_6611551630,420,-2,-16,4,-2,7,0,7,-10,11,1,0,0,0,1,4,5,0,1,1,1,-5,-56,0,-5,5,14,0,0,-1,-1,-1,1,2,-1
KR_6752653035,420,-5,-29,-39,-11,-2,3,1,-2,4,2,0,2,2,-8,10,2,1,1,2,0,-16,-4,-2,-3,5,-4,0,0,-1,-1,1,1,2,-1
KR_6682778713,420,-2,-38,-4,-5,-2,3,1,1,2,3,-2,2,0,-2,2,0,0,3,3,0,-4,1,0,-5,5,-3,0,-1,-1,-1,-1,-1,3,-1
KR_6586562767,420,-4,-25,-10,-11,-5,6,1,-2,5,3,0,2,2,-3,4,1,-1,2,1,-1,-9,1,0,-3,3,-1,0,-2,-1,-1,-1,-1,3,-1
KR_6752864967,420,1,-37,8,3,0,2,2,-1,4,3,1,2,3,3,2,5,0,0,0,0,3,16,-1,-3,4,-2,0,0,1,-1,-1,-1,3,-1
KR_6725958915,420,-2,-15,21,-16,-6,8,2,-6,7,1,-2,4,2,1,3,4,-3,3,0,-1,-17,-2,1,-5,4,1,0,-2,-1,1,-1,-1,3,-1
KR_6763137744,420,1,-83,-1,0,-1,2,1,1,3,4,-1,6,5,1,1,2,0,0,0,0,11,19,-2,-7,9,-6,0,0,1,-1,0,1,2,-1
KR_6755587906,420,-4,-60,-31,-7,1,0,1,-2,4,2,-5,5,0,0,5,5,-1,3,2,0,-3,-6,9,-10,1,5,0,0,1,1,0,-1,5,-1
KR_6729754043,420,-2,-36,-4,-7,-2,2,0,-1,3,2,0,1,1,1,4,5,-5,5,0,0,-5,2,-3,-5,8,-3,0,-1,-1,0,-1,-1,4,-1
KR_6738446036,420,0,-41,4,-2,2,0,2,-3,7,4,-2,4,2,1,5,6,0,2,2,0,0,9,5,-6,1,-6,0,-1,-1,1,-1,-1,4,-1
KR_6699308838,440,0,40,-11,3,1,2,3,2,1,3,-3,3,0,3,1,4,0,2,2,0,2,13,3,-4,1,0,0,0,0,-1,0,1,0,-1
KR_6648004061,420,-1,-79,-16,-2,1,1,2,-4,5,1,4,6,10,-3,5,2,0,2,2,-1,-3,0,-5,-3,8,-1,0,-1,1,-1,-1,-1,4,-1
KR_6688841060,440,-2,47,-20,-7,-2,5,3,-5,6,1,6,0,6,-7,8,1,1,0,1,0,-9,-11,-5,-1,6,1,0,-2,-1,-1,-1,-1,6,-1
KR_6761005870,440,-2,21,-32,3,-3,3,0,-3,4,1,1,2,3,2,5,7,6,1,7,0,5,-4,-1,-1,2,2,0,1,-1,1,1,1,1,-1
KR_6621951644,420,-3,-27,-32,-6,-2,4,2,3,5,8,-1,3,2,-6,7,1,0,1,1,0,4,14,7,-10,3,1,0,0,1,-1,-1,-1,1,-1
KR_6731784248,420,-3,-59,-12,0,-2,4,2,0,0,0,0,4,4,0,7,7,2,1,3,0,2,-10,5,-8,3,1,0,0,-1,-1,1,-1,6,-1
KR_6758172249,420,4,-19,10,10,-1,2,1,1,0,1,3,1,4,2,0,2,5,0,5,0,11,1,-2,-4,6,3,0,1,1,0,1,-1,4,-1
KR_6761974883,420,-2,4,8,3,-2,3,1,-1,3,2,2,2,4,-3,6,3,7,1,8,0,-1,-39,0,-3,3,14,0,4,0,1,1,-1,0,-1
KR_6734671730,420,-6,-142,-8,-5,2,1,3,0,2,2,-3,5,2,-3,3,0,-1,1,0,1,2,-116,-1,-2,3,-7,0,-1,1,1,1,1,4,-1
KR_6715446000,420,0,-106,-4,8,-2,2,0,8,2,10,0,1,1,2,1,3,0,2,2,0,13,-27,-1,-5,6,-4,0,0,1,0,0,1,3,-1
KR_6698554576,420,0,34,-31,2,0,0,0,-6,7,1,2,0,2,0,1,1,6,1,7,0,0,2,-5,-4,9,1,0,0,0,0,0,-1,0,-1
KR_6743608913,440,3,35,-14,4,1,4,5,-2,3,1,0,0,0,5,0,5,0,1,1,-1,6,-2,3,-4,1,-3,0,-1,-1,-1,-1,-1,6,-1
KR_6751910449,420,0,23,-47,-4,3,3,6,-2,6,4,-5,5,0,1,3,4,-1,3,2,0,3,-22,1,-4,3,2,0,0,-1,-1,-1,-1,3,-1
KR_6600316248,420,-1,-75,-20,-6,-3,3,0,4,2,6,-7,9,2,1,1,2,-1,2,1,0,-3,6,-3,-2,5,-3,0,0,-1,-1,-1,-1,2,-1
KR_6761982388,420,-4,-22,-1,-5,-2,3,1,-4,6,2,-1,4,3,7,0,7,-5,5,0,-1,-3,9,3,-8,5,-1,0,0,1,0,0,-1,4,-1
KR_6733133208,420,-2,-96,-36,-7,-5,7,2,1,3,4,-3,6,3,0,1,1,0,1,1,0,3,-298,-1,-4,5,-6,0,-2,-1,-1,-1,1,5,-1
KR_6695588129,420,-1,-13,8,-6,-1,4,3,0,3,3,-3,3,0,-2,3,1,0,0,0,0,-9,-15,-3,-4,7,2,0,-1,-1,-1,-1,1,3,-1
KR_6723960226,420,-4,-27,-14,-13,-2,3,1,-1,1,0,-6,6,0,-3,3,0,-1,2,1,0,-6,-15,-4,-2,6,3,0,-1,0,-1,-1,-1,0,-1
KR_6744554234,420,-3,-29,18,-9,-6,7,1,0,1,1,0,1,1,-3,4,1,0,4,4,0,-18,-23,0,-3,3,1,0,-1,1,-1,-1,1,5,-1
KR_6713267357,420,-2,-24,24,-6,-1,2,1,-4,4,0,-4,6,2,0,2,2,3,2,5,0,-6,-67,1,-3,2,1,0,-2,-1,0,-1,1,5,-1
KR_6728764084,420,-3,-69,-12,-3,-3,4,1,4,1,5,-3,3,0,-1,1,0,0,0,0,0,1,-9,-3,-1,4,0,0,-1,-1,-1,-1,1,3,-1
KR_6726458911,440,-6,-73,-38,-5,-1,1,0,0,2,2,2,0,2,-5,5,0,-1,1,0,0,-1,15,3,-7,4,-4,0,0,1,1,0,-1,1,-1
KR_6681141228,420,-5,-11,-27,-10,-3,3,0,-1,2,1,-5,5,0,-1,1,0,0,1,1,0,-8,4,-1,-3,4,0,0,-1,-1,-1,-1,-1,6,-1
KR_6764266209,420,-4,-34,-28,-4,-1,2,1,1,5,6,-2,3,1,-3,6,3,1,0,1,0,-7,164,1,-4,3,-5,0,1,-1,1,-1,1,1,-1
KR_6710803633,440,0,-15,-17,5,5,1,6,-1,1,0,4,1,5,-3,4,1,0,0,0,0,5,2,1,-4,3,0,0,1,-1,1,1,-1,6,-1
KR_6761128430,420,0,-25,10,0,1,1,2,-1,1,0,1,3,4,-3,3,0,2,0,2,0,-6,5,2,-4,2,-1,0,0,-1,-1,-1,-1,4,-1
KR_6731771981,420,-2,-31,-17,1,-1,2,1,-1,3,2,0,1,1,4,1,5,-1,3,2,0,2,-3,-1,-3,4,-4,0,0,-1,-1,0,-1,6,-1
KR_6740756487,420,-2,-20,7,-6,-4,4,0,3,2,5,-1,3,2,0,4,4,-4,5,1,0,0,27,-3,-2,5,-3,0,0,-1,-1,0,-1,2,-1
KR_6764229108,420,2,37,-16,-4,3,1,4,-1,4,3,1,2,3,-7,8,1,0,1,1,-1,-16,1,1,-7,6,3,0,-1,-1,-1,-1,-1,4,-1
KR_6726996239,420,-5,-110,-37,-12,-2,2,0,-7,8,1,1,6,7,-2,4,2,-2,2,0,-2,-13,-8,-7,-3,10,1,0,-4,1,-1,-1,-1,1,-1
KR_6762745511,420,-1,-60,-28,0,-1,3,2,2,2,4,1,2,3,-5,7,2,3,0,3,1,9,174,5,-6,1,-1,0,0,-1,-1,-1,1,1,-1
KR_6690484111,420,-2,-23,8,-3,-3,5,2,-3,6,3,4,0,4,0,2,2,-1,3,2,1,-3,44,0,-2,2,-20,0,-1,1,-1,-1,1,3,-1
KR_6761043309,420,-2,-44,-56,0,5,1,6,0,0,0,-3,5,2,-1,2,1,-1,1,0,0,-7,4,3,-5,2,-2,0,0,1,0,0,1,2,-1
KR_6760879325,420,0,21,4,2,1,0,1,0,2,2,4,2,6,-3,8,5,0,0,0,1,5,9,4,-5,1,2,0,1,-1,1,1,1,6,-1
KR_6656034573,420,0,-13,-9,2,0,2,2,0,5,5,0,1,1,1,0,1,1,2,3,0,8,165,1,-4,3,4,0,-1,1,-1,1,-1,5,-1
KR_6684852356,440,-2,-23,-31,-3,-1,3,2,-1,3,2,3,0,3,-3,3,0,-1,2,1,0,-1,-12,2,-5,3,1,0,0,1,-1,-1,1,2,-1
KR_6764032588,440,-4,-60,0,-9,2,2,4,-6,6,0,-1,4,3,-3,3,0,-1,1,0,0,-4,-8,-3,0,3,1,0,-1,-1,1,-1,1,6,-1
KR_6759836609,440,0,-7,7,3,0,3,3,0,2,2,-3,3,0,4,0,4,2,0,2,-1,10,5,-2,-4,6,-5,0,0,-1,1,1,-1,5,-1
KR_6732982314,420,-3,-88,-27,-7,-2,4,2,3,1,4,-4,6,2,-1,3,2,-3,3,0,0,3,-18,-2,-2,4,1,0,-2,-1,-1,-1,-1,5,-1
KR_6739694622,420,-2,-24,-25,-7,0,2,2,-1,2,1,0,2,2,-8,10,2,2,0,2,0,-10,-5,0,-3,3,0,0,-3,-1,-1,-1,-1,5,-1
KR_6743189923,420,-3,39,-23,4,0,3,3,0,3,3,5,1,6,0,4,4,-1,2,1,0,3,-39,-2,-3,5,2,0,1,0,1,1,1,0,-1
KR_6643973311,420,2,26,-15,2,1,2,3,8,0,8,-2,3,1,0,1,1,-5,5,0,0,1,10,6,-9,3,-1,0,1,1,1,1,1,3,-1
KR_6758954263,420,-3,-25,-8,-10,-2,3,1,-4,5,1,-1,3,2,-4,4,0,1,1,2,0,-8,-124,-3,-1,4,20,0,-3,-1,-1,-1,1,6,-1
KR_6656710995,420,-1,-56,-4,-3,1,0,1,3,0,3,-3,5,2,-4,6,2,0,0,0,0,-4,-2,-2,-2,4,0,0,0,-1,1,0,-1,4,-1
KR_6726975589,420,0,23,-25,6,0,2,2,5,0,5,-1,2,1,2,1,3,0,1,1,-1,5,-1,4,-6,2,-3,0,0,1,1,0,-1,1,-1
KR_6744935880,420,-3,-61,12,-9,0,1,1,0,0,0,-1,2,1,-4,5,1,-4,8,4,0,-9,-38,3,-3,0,47,0,0,-1,1,-1,-1,1,-1
KR_6758849927,420,-2,9,-4,-1,-2,4,2,4,3,7,-5,6,1,-1,2,1,3,0,3,-1,2,-2,1,-5,4,-6,0,-1,1,-1,-1,-1,5,-1
KR_6743474286,420,1,11,-6,-2,-2,5,3,4,0,4,1,2,3,-4,5,1,-1,2,1,-2,-8,-1,2,-3,1,-5,0,-2,-1,-1,-1,-1,2,-1
KR_6726980626,420,-2,-102,-28,-3,-2,4,2,0,2,2,-2,6,4,1,0,1,0,2,2,1,6,-2,1,-4,3,1,0,-2,-1,-1,-1,1,2,-1
KR_6753042520,420,-3,5,-1,-9,0,1,1,-5,5,0,1,1,2,-4,5,1,-1,2,1,0,-6,-20,2,-3,1,4,0,-1,-1,-1,-1,-1,1,-1
KR_6756468583,440,-3,-10,-24,-9,-5,5,0,-1,5,4,-3,5,2,-1,5,4,1,2,3,0,2,-103,-1,-3,4,-2,0,0,1,1,0,-1,6,-1
KR_6685814049,440,-5,-25,-20,-10,3,0,3,-1,2,1,-3,4,1,-9,11,2,0,0,0,-1,-9,-58,-2,-4,6,-3,0,-1,-1,0,-1,-1,1,-1
KR_6670956828,420,0,42,8,3,6,1,7,-1,3,2,8,1,9,-9,12,3,-1,4,3,0,-3,2,3,-7,4,-2,0,2,-1,1,1,-1,5,-1
KR_5568819112,420,0,45,4,2,0,1,1,5,0,5,1,2,3,-1,3,2,-3,3,0,0,0,3,4,-4,0,-6,0,0,1,-1,-1,-1,3,-1
KR_6572790105,420,0,3,4,0,0,1,1,-1,2,1,-2,3,1,2,1,3,1,1,2,0,-3,1,-5,-2,7,3,0,0,0,0,0,-1,0,-1
KR_6636991388,420,1,21,0,-1,0,3,3,-2,2,0,-1,3,2,1,0,1,1,1,2,0,1,-11,1,-3,2,3,0,0,1,1,1,-1,3,-1
KR_6738940545,440,1,55,-4,1,1,1,2,0,1,1,-4,4,0,7,2,9,-3,5,2,0,3,29,2,-4,2,-11,0,1,1,-1,1,-1,3,-1
KR_6674171578,420,0,5,-26,3,4,1,5,-1,2,1,1,1,2,0,1,1,-1,3,2,0,1,1,-2,-3,5,2,0,0,1,1,1,1,2,-1
KR_6724778589,440,-2,20,-21,-5,-3,4,1,3,3,6,-1,2,1,-1,3,2,-3,3,0,0,-3,-12,3,-6,3,-1,0,0,-1,1,0,-1,3,-1
KR_6733114020,420,-5,-45,-13,-7,-3,3,0,2,0,2,-3,5,2,-2,4,2,-1,2,1,0,-1,-6,-2,-1,3,3,0,-1,1,-1,-1,-1,4,-1
KR_6676168557,420,-7,-22,-6,-10,-3,3,0,-3,3,0,2,0,2,-4,4,0,-2,3,1,0,-7,-4,-3,-3,6,-4,0,-3,0,-1,-1,-1,0,-1
KR_6726079317,420,-1,-33,-4,-8,-1,5,4,-6,7,1,3,0,3,-3,3,0,-1,2,1,0,-12,23,-3,-1,4,-2,0,0,-1,1,0,1,2,-1
KR_6493242032,420,-1,5,31,-1,-3,4,1,3,1,4,0,2,2,0,2,2,-1,1,0,0,9,3,-1,-4,5,3,0,1,1,-1,1,1,2,-1
KR_6745100119,420,-3,-56,-11,-5,-3,3,0,1,1,2,-2,2,0,-2,2,0,1,3,4,0,-7,25,1,-6,5,-2,0,-1,-1,-1,-1,1,6,-1
KR_6718090514,420,-2,-74,29,-3,3,1,4,1,1,2,-4,4,0,-3,3,0,0,1,1,0,-3,-2,-6,-1,7,3,0,1,-1,1,1,-1,2,-1
KR_6732579046,420,0,-34,-37,-4,3,1,4,-1,3,2,1,1,2,-5,5,0,-2,2,0,0,-12,-9,-2,-5,7,0,0,-1,-1,-1,-1,-1,4,-1
KR_6756316980,420,-2,3,11,-3,2,2,4,-3,6,3,0,2,2,-1,2,1,-1,3,2,0,-7,-8,-1,-2,3,0,0,-2,-1,-1,-1,1,5,-1
KR_6747525203,420,4,11,-40,11,-2,2,0,2,0,2,2,0,2,11,0,11,-2,2,0,0,16,10,-2,-2,4,1,0,-1,1,-1,-1,-1,6,-1
KR_6745638323,440,1,6,-4,0,2,2,4,-6,7,1,0,1,1,2,2,4,2,2,4,-1,0,316,-3,-2,5,-1,0,1,0,0,1,-1,0,-1
KR_6749373053,440,-3,-29,32,-4,-1,2,1,-7,7,0,5,2,7,1,3,4,-2,3,1,-1,-4,2,-2,-5,7,1,0,-1,1,1,-1,-1,6,-1
KR_6755702952,420,-1,-34,-48,2,1,2,3,3,3,6,-1,3,2,-1,3,2,0,1,1,-1,-3,4,8,-10,2,-4,0,-1,-1,0,-1,-1,6,-1
KR_6740196589,420,-9,-76,-21,-22,-5,5,0,-4,5,1,-6,8,2,-2,3,1,-5,6,1,-1,-23,-108,3,-8,5,-2,0,-2,-1,1,-1,-1,2,-1
KR_6734487773,420,-5,-11,-24,-15,-3,3,0,0,2,2,-5,7,2,-9,9,0,2,0,2,-2,-19,-1,1,-5,4,0,0,-2,1,-1,-1,-1,4,-1
KR_6759475260,420,1,23,-12,7,0,2,2,-4,4,0,1,1,2,5,0,5,5,0,5,1,8,5,0,-2,2,1,0,-1,1,-1,-1,1,1,-1
KR_6754420486,420,2,69,1,3,2,1,3,1,0,1,-2,3,1,2,0,2,0,0,0,0,2,-3,-1,-4,5,2,0,1,1,-1,1,1,2,-1
KR_6672250797,440,-1,-70,23,-7,-3,3,0,-4,5,1,-6,8,2,0,3,3,6,0,6,0,1,-7,1,-4,3,0,0,-2,1,-1,-1,-1,3,-1
KR_6277098598,420,1,7,-5,-1,1,2,3,-2,3,1,0,2,2,0,2,2,0,0,0,0,-3,134,-1,-4,5,-3,0,0,0,0,0,-1,0,-1
KR_6704307119,440,-2,-42,14,-6,4,1,5,-4,4,0,-1,2,1,-4,5,1,-1,1,0,0,-9,7,2,-4,2,-4,0,0,-1,1,1,-1,6,-1
KR_6604098288,420,-2,-18,-28,-1,1,1,2,-3,4,1,-2,2,0,1,0,1,2,0,2,0,1,6,5,-5,0,-1,0,-2,-1,-1,-1,-1,5,-1
KR_6740089982,420,1,-7,4,3,-3,4,1,5,1,6,-2,5,3,1,3,4,2,0,2,0,8,-56,-4,-2,6,17,0,-1,1,1,-1,1,5,-1
KR_6440303638,420,-2,43,-2,-10,1,1,2,-9,12,3,-2,2,0,0,1,1,0,1,1,0,-8,3,2,-3,1,-4,0,0,1,1,0,-1,6,-1
KR_6646306999,420,-1,-66,12,-2,-4,4,0,2,2,4,0,1,1,-5,9,4,5,0,5,0,1,-1,-2,-5,7,-3,0,-1,-1,1,-1,1,2,-1
KR_6623806282,420,-3,-62,-29,-5,-1,1,0,-3,4,1,-1,3,2,1,0,1,-1,1,0,0,0,-27,0,-5,5,27,0,-1,-1,0,-1,-1,6,-1
KR_6764073209,440,3,26,16,-5,-10,10,0,-1,2,1,9,2,11,-4,4,0,1,0,1,-1,-16,-14,-3,-1,4,1,0,-1,0,-1,-1,-1,0,-1
KR_6281612791,420,2,68,-4,4,2,1,3,4,2,6,0,1,1,-2,8,6,0,1,1,0,5,-2,-1,-8,9,0,0,-1,-1,0,-1,1,3,-1
KR_6751234631,420,1,43,-27,3,3,1,4,3,3,6,-1,5,4,-2,2,0,0,1,1,0,-1,1,4,-8,4,2,0,0,-1,-1,0,1,6,-1
KR_6736159186,420,-1,-41,5,-7,-2,3,1,-3,5,2,-2,5,3,1,2,3,-1,2,1,0,-8,39,2,-4,2,1,0,-2,0,-1,-1,-1,0,-1
KR_6751299385,420,-2,-22,-22,-9,-4,4,0,-3,4,1,0,2,2,-2,4,2,0,2,2,0,-9,1,-4,-2,6,2,0,0,-1,0,0,-1,1,-1
KR_6571087900,420,-6,-91,-12,-10,-1,3,2,-3,5,2,-1,2,1,-2,2,0,-3,3,0,0,-10,-5,-4,-2,6,-3,0,-2,-1,1,-1,1,6,-1
KR_6762453974,420,3,26,5,0,0,0,0,-2,4,2,1,3,4,-3,5,2,4,1,5,0,0,6,2,-5,3,4,0,0,1,1,0,1,2,-1
KR_6721644592,420,-4,19,-40,-5,1,0,1,-5,6,1,1,0,1,-1,1,0,-1,1,0,0,-3,33,1,-4,3,-2,0,0,-1,1,0,1,4,-1
KR_6738132331,440,-2,-52,-5,-4,-1,3,2,2,3,5,0,0,0,-6,6,0,1,0,1,0,-5,0,0,-2,2,1,0,0,1,-1,0,-1,6,-1
KR_6689009480,420,-2,-36,-16,-2,0,3,3,1,4,5,-1,3,2,-1,1,0,-1,1,0,0,-4,-5,-1,-3,4,-2,0,-1,-1,1,-1,1,5,-1
KR_6717686854,440,-6,-68,-1,-11,2,1,3,-4,5,1,-2,4,2,-6,6,0,-1,3,2,-1,-4,9,0,-8,8,1,0,0,-1,1,-1,-1,1,-1
KR_6743067483,420,-6,-146,-31,-12,-5,5,0,-2,2,0,3,3,6,-6,6,0,-2,2,0,-2,-11,-3,-1,-4,5,-4,0,-2,-1,-1,-1,-1,4,-1
KR_6761951820,420,-3,-58,-17,-5,0,1,1,-5,5,0,-4,5,1,0,2,2,4,1,5,0,-2,0,-5,-5,10,-7,0,0,0,0,0,1,0,-1
KR_6728829791,440,0,-46,-49,6,-3,6,3,2,2,4,1,1,2,6,0,6,0,1,1,-1,13,-3,-3,-1,4,2,0,-2,-1,-1,-1,-1,3,-1
KR_6685941254,420,-1,25,4,-2,9,0,9,1,2,3,0,2,2,-7,8,1,-5,5,0,-1,-7,6,3,-6,3,-6,0,-1,-1,-1,-1,-1,1,-1
KR_6764480655,440,-7,-98,-20,-12,-4,4,0,1,0,1,-2,2,0,-3,3,0,-4,5,1,0,-18,-3,-4,-6,10,-2,0,-2,1,1,-1,-1,2,-1
KR_6738529509,420,-4,-57,-27,-6,-2,4,2,0,3,3,-5,7,2,4,1,5,-3,4,1,-1,-2,-1,0,-5,5,2,0,-1,1,-1,-1,-1,5,-1
KR_6732296716,420,1,48,36,6,2,1,3,3,2,5,-5,6,1,3,0,3,3,0,3,0,2,-33,-1,-3,4,3,0,0,-1,1,0,1,6,-1
KR_6725236662,420,1,-36,-27,0,1,5,6,-3,5,2,-1,2,1,4,0,4,-1,1,0,0,0,-9,1,-4,3,-2,0,1,1,1,1,-1,5,-1
KR_6483225817,420,1,51,-12,1,0,3,3,-1,2,1,2,0,2,1,2,3,-1,1,0,0,-2,-380,-3,-3,6,1,0,1,0,0,1,1,0,-1
KR_6757976799,420,-1,-21,-4,-2,1,0,1,2,4,6,0,4,4,-2,3,1,-3,3,0,0,-4,99,2,-7,5,-1,0,1,-1,1,1,-1,2,-1
KR_6623567473,420,2,-17,5,0,1,2,3,-3,8,5,3,1,4,-2,3,1,1,2,3,-1,-1,370,0,-4,4,-2,0,0,0,-1,0,-1,0,-1
KR_6709466936,420,-4,-45,-21,-13,-6,6,0,-3,3,0,-3,6,3,0,2,2,-1,1,0,-1,-8,-19,-5,-1,6,-1,0,-1,0,-1,-1,-1,0,-1
KR_6745202112,440,-2,-18,-12,-9,0,1,1,-6,6,0,-7,8,1,2,6,8,2,1,3,-1,-6,0,-1,-4,5,5,0,0,-1,1,-1,1,4,-1
KR_6637097741,420,-4,-52,1,-14,-2,2,0,-4,5,1,0,3,3,-4,5,1,-4,4,0,-3,-18,5,2,-7,5,-3,0,-3,-1,0,-1,-1,5,-1
KR_6723741160,440,-2,83,0,-1,-1,2,1,-6,9,3,0,1,1,1,3,4,5,0,5,0,-6,50,2,-4,2,-16,0,0,1,0,0,1,4,-1
KR_6697177282,420,-6,-50,-44,-17,-7,8,1,-4,5,1,-2,4,2,-3,4,1,-1,1,0,0,-28,5,1,-4,3,-4,0,0,-1,1,-1,1,5,-1
KR_6655914781,420,-1,-50,4,2,1,0,1,-1,4,3,-1,2,1,0,3,3,3,0,3,1,0,-11,4,-5,1,-4,0,0,0,0,1,1,0,-1
KR_6747112651,420,-3,-4,-4,-1,-2,3,1,4,5,9,-2,7,5,2,0,2,-3,5,2,0,12,114,1,-6,5,0,0,0,0,0,1,-1,0,-1
KR_6739898151,420,-6,-35,-128,-4,1,1,2,-1,2,1,-2,3,1,0,0,0,-2,2,0,0,-9,-4,-1,-1,2,-2,0,-1,-1,-1,-1,-1,2,-1
KR_6758858638,440,-4,-60,8,-8,-3,4,1,-1,1,0,-1,1,0,-2,3,1,-1,1,0,0,-8,-207,0,-4,4,-2,0,-1,1,0,-1,-1,6,-1
KR_6749365584,420,-1,-1,-1,-2,-5,5,0,4,0,4,2,1,3,-2,4,2,-1,2,1,0,-1,-7,-1,-1,2,1,0,0,-1,0,0,-1,2,-1
KR_6625929452,420,-2,-55,-20,-18,-2,4,2,-2,3,1,-6,9,3,-7,7,0,-1,1,0,-3,-26,-5,-8,0,8,-1,0,0,-1,1,-1,-1,1,-1
KR_6707969066,420,-1,7,-49,-1,0,2,2,1,4,5,1,2,3,-1,1,0,-2,3,1,-1,-3,13,5,-12,7,-1,0,0,1,-1,-1,-1,6,-1
KR_6665497971,420,1,13,-5,-3,4,0,4,-2,4,2,-2,5,3,-1,5,4,-2,3,1,0,-10,26,-2,-2,4,4,0,-1,-1,1,1,-1,1,-1
KR_6727002991,420,2,9,-24,0,3,0,3,1,5,6,1,1,2,0,4,4,-5,6,1,0,0,-10,0,-3,3,0,0,-1,-1,0,-1,-1,6,-1
KR_6732423661,420,5,51,15,6,3,0,3,0,2,2,0,1,1,0,0,0,3,0,3,0,2,1,-4,-3,7,-2,0,2,-1,1,1,1,4,-1
KR_6762115578,420,-6,-120,-28,-6,-5,6,1,-2,2,0,-1,2,1,2,0,2,0,0,0,0,-3,131,-2,-2,4,-3,0,-2,1,-1,-1,-1,5,-1
KR_6683311367,420,-1,-36,0,-1,-1,1,0,-1,1,0,-3,5,2,3,0,3,1,0,1,0,-3,1,4,-8,4,0,0,-1,1,1,-1,1,3,-1
KR_6657155062,420,0,-40,-22,0,-1,1,0,-1,4,3,3,0,3,1,1,2,-2,2,0,0,3,-10,3,-3,0,-1,0,1,-1,1,1,-1,4,-1
KR_6644471276,420,-1,-69,6,-8,2,1,3,-3,5,2,-3,4,1,-4,6,2,0,1,1,0,-11,-3,-2,-2,4,4,0,-1,1,-1,-1,-1,2,-1
KR_6702099300,420,-3,-10,-16,-5,0,1,1,1,3,4,-4,5,1,-2,3,1,0,0,0,0,-5,-4,0,-3,3,0,0,0,1,-1,0,1,5,-1
KR_6714530942,420,-2,-109,-17,-13,-3,5,2,5,3,8,0,1,1,-13,14,1,-2,2,0,-1,-4,-238,-2,-2,4,1,0,-3,-1,-1,-1,-1,5,-1
KR_6651333766,420,-5,-49,-29,-14,-2,4,2,1,0,1,-3,5,2,-4,4,0,-6,6,0,0,-10,-11,-1,-1,2,0,0,-1,-1,-1,-1,-1,1,-1
KR_6754444579,420,-2,-54,-4,-5,-6,6,0,2,0,2,-1,5,4,1,0,1,-1,1,0,0,0,-19,-3,-2,5,-4,0,-2,-1,-1,-1,-1,4,-1
KR_6734058430,440,-1,33,-20,0,1,2,3,3,0,3,-3,4,1,-5,7,2,4,0,4,0,7,-6,0,-5,5,5,0,-1,1,1,1,1,1,-1
KR_6722358915,440,2,77,39,1,2,0,2,0,0,0,-2,3,1,0,1,1,1,0,1,0,2,-6,4,-6,2,-2,0,0,0,1,0,1,0,-1
KR_6694956121,420,-5,-65,-52,-6,-4,4,0,-3,4,1,0,1,1,1,1,2,0,0,0,0,-4,3,-3,-7,10,-3,0,0,1,-1,-1,-1,5,-1
KR_6752105854,420,-1,-24,-12,-8,-8,8,0,-5,6,1,3,0,3,0,1,1,2,0,2,0,-2,-114,0,-4,4,-3,0,-1,-1,-1,-1,-1,2,-1
KR_6725892107,420,-1,33,5,3,1,0,1,-3,4,1,1,3,4,-2,3,1,6,0,6,1,9,-144,3,-6,3,-2,0,0,-1,-1,0,1,2,-1
KR_6753285256,440,-2,-85,-6,-9,-2,2,0,-5,5,0,-6,10,4,3,1,4,1,2,3,0,-10,8,0,-6,6,2,0,0,-1,-1,1,1,5,-1
KR_6721224736,420,-2,-11,-12,-7,-3,3,0,1,1,2,-5,8,3,-1,4,3,1,3,4,0,-1,-3,5,-8,3,-5,0,0,-1,-1,-1,-1,3,-1
KR_6699085267,420,2,-30,-3,6,3,0,3,1,0,1,3,0,3,0,3,3,-1,1,0,0,8,34,3,-5,2,1,0,0,1,-1,0,-1,6,-1
KR_6763025585,420,0,53,4,-4,2,1,3,3,2,5,1,1,2,-8,8,0,-2,2,0,-1,-4,13,-2,-1,3,-4,0,0,-1,-1,0,-1,6,-1
KR_6748250146,420,-2,-10,0,-2,1,1,2,-1,5,4,-3,3,0,1,0,1,0,2,2,0,-7,32,2,-4,2,-6,0,0,-1,1,1,-1,3,-1
KR_6746960821,420,-4,-51,-15,-12,0,1,1,0,3,3,-4,7,3,-8,10,2,0,2,2,-1,-21,100,-4,-1,5,3,0,-1,-1,-1,-1,-1,2,-1
KR_6672462980,420,-4,-98,16,-10,-1,2,1,-4,5,1,-4,4,0,-1,2,1,0,0,0,0,-7,-7,-3,-2,5,-2,0,-1,1,-1,-1,-1,3,-1
KR_6731769718,420,-1,3,12,1,-4,5,1,2,3,5,-1,3,2,4,0,4,0,3,3,1,7,-14,0,-4,4,1,0,-1,-1,-1,-1,1,2,-1
KR_6695803880,420,-6,-130,-19,-22,-10,12,2,-4,8,4,-1,4,3,-5,8,3,-2,2,0,0,-4,-12,-4,-2,6,-4,-1,-4,0,-1,-1,-1,0,-1
KR_6607103190,420,0,-71,-6,-2,-3,4,1,-3,4,1,0,2,2,3,2,5,1,1,2,0,-8,-7,-4,-2,6,5,0,-1,-1,0,-1,-1,6,-1
KR_6755467963,420,-6,-76,-4,-16,-7,8,1,-6,6,0,-3,4,1,0,1,1,0,1,1,1,-12,-5,-3,-2,5,0,0,-1,-1,1,-1,1,6,-1
KR_6755057188,420,0,-8,20,2,0,1,1,5,2,7,1,0,1,-5,9,4,1,1,2,1,-1,-3,-2,-4,6,1,0,0,1,-1,0,1,5,-1
KR_6760982592,440,3,70,-8,11,0,2,2,2,3,5,1,3,4,-1,2,1,9,2,11,2,10,24,1,-1,0,-2,0,0,0,1,1,1,0,-1
KR_6751816710,420,-5,-31,6,-15,-2,2,0,-5,5,0,-1,4,3,-7,8,1,0,0,0,-1,-20,-82,-3,-4,7,-2,0,-1,-1,1,-1,-1,1,-1
KR_6629897071,420,-6,-68,-8,-11,-4,4,0,2,2,4,3,0,3,-10,10,0,-2,3,1,1,-13,-8,4,-4,0,-1,0,-3,-1,-1,-1,1,5,-1
KR_6725458414,420,-3,13,-12,-5,2,1,3,-1,3,2,-3,6,3,-2,3,1,-1,1,0,0,-10,1,-1,-3,4,-2,0,0,-1,-1,-1,-1,5,-1
KR_6754483659,420,-3,-100,1,-10,-1,2,1,-2,5,3,2,0,2,-3,4,1,-6,6,0,0,-9,20,-2,-2,4,-2,0,0,-1,0,0,-1,4,-1
KR_6763116243,420,1,59,8,2,2,0,2,3,0,3,-1,2,1,-1,2,1,-1,2,1,0,-1,-96,-2,-1,3,4,0,0,1,1,0,1,1,-1
KR_6717788239,420,-2,-71,12,-1,2,1,3,0,0,0,-2,2,0,-2,6,4,1,2,3,0,-5,-21,-2,-4,6,-1,0,-2,1,-1,-1,1,4,-1
KR_6738692317,420,0,26,-24,1,1,1,2,1,0,1,-2,3,1,-1,2,1,2,2,4,0,0,25,0,-2,2,3,0,1,-1,1,1,-1,4,-1
KR_6733848562,420,0,-34,-4,-7,-1,4,3,5,0,5,-5,10,5,-5,6,1,-1,1,0,-1,3,36,0,-6,6,-18,0,-2,-1,-1,-1,-1,3,-1
KR_6758428102,420,0,14,23,1,0,1,1,3,1,4,2,2,4,-1,1,0,-3,3,0,-1,4,-9,6,-6,0,-1,0,0,-1,-1,0,-1,2,-1
KR_6643510378,420,-4,-82,-16,-4,2,0,2,-3,6,3,-3,3,0,-4,7,3,4,0,4,0,-5,0,-2,-4,6,-2,0,0,-1,0,0,1,3,-1
KR_6696351978,420,-3,-76,11,-3,-4,4,0,2,2,4,-2,4,2,2,0,2,-1,2,1,0,3,13,3,-6,3,0,0,-1,-1,1,-1,1,1,-1
KR_6674711308,440,0,18,8,2,-1,2,1,-1,1,0,3,0,3,0,3,3,1,1,2,0,3,-17,-1,-3,4,5,0,1,1,-1,1,1,3,-1
KR_6719478676,420,-1,-43,36,0,-1,2,1,0,1,1,2,1,3,-2,2,0,1,0,1,1,4,-4,2,-4,2,-2,0,-1,-1,-1,-1,1,3,-1
KR_6752413327,420,-2,-10,-16,-6,-3,4,1,-4,6,2,-2,3,1,0,0,0,3,0,3,0,-6,-3,-1,-1,2,2,0,-1,1,-1,-1,-1,3,-1
KR_5890131023,420,-3,-98,-8,-9,-1,2,1,-1,4,3,-4,4,0,-1,2,1,-2,4,2,0,-11,-13,2,-5,3,-1,0,0,-1,1,1,-1,4,-1
KR_6764099753,420,-2,-33,16,-1,1,0,1,-5,6,1,3,2,5,0,2,2,0,0,0,0,-5,-14,3,-3,0,0,0,0,0,1,-1,-1,0,-1
KR_6448926800,420,-2,-61,-25,-8,-1,3,2,-5,7,2,-4,8,4,2,6,8,0,2,2,-2,-8,-385,-1,-4,5,6,0,0,-1,-1,-1,1,2,-1
KR_6655995059,420,-4,-76,12,-3,-1,1,0,1,2,3,-1,2,1,0,4,4,-2,2,0,0,-12,-9,-5,-2,7,3,0,0,1,1,0,1,2,-1
KR_6459849543,440,-5,35,-21,-5,4,3,7,-4,7,3,-3,5,2,-2,2,0,0,1,1,0,-6,-12,-9,-2,11,-6,0,0,-1,-1,0,1,1,-1
KR_6567319844,420,-1,-14,-12,1,-2,3,1,2,1,3,3,2,5,1,2,3,-3,4,1,0,9,11,1,-6,5,3,0,0,-1,0,1,1,5,-1
KR_6729384796,420,-3,-81,4,-6,1,2,3,2,2,4,0,6,6,-8,8,0,-1,1,0,0,-8,0,1,-4,3,-7,0,-1,-1,-1,-1,-1,3,-1
KR_6726930328,440,-3,-77,4,-5,2,2,4,0,2,2,-2,4,2,-3,3,0,-2,2,0,0,-1,-309,-3,-1,4,0,0,0,-1,-1,0,1,1,-1
KR_6763869817,420,-3,-32,-49,-13,-5,6,1,-2,4,2,-5,6,1,0,1,1,-1,3,2,-1,-9,-11,-2,-3,5,1,0,-1,-1,-1,-1,-1,3,-1
KR_6757437813,420,-1,-35,-9,4,2,2,4,2,2,4,-7,7,0,4,0,4,3,0,3,0,9,-44,-5,-1,6,20,0,-1,-1,-1,-1,1,5,-1
KR_6699471082,420,-4,-73,-16,-5,-1,3,2,2,2,4,-3,3,0,-2,4,2,-1,1,0,0,-7,1,-3,-2,5,2,0,-1,-1,-1,-1,-1,2,-1
KR_6662067920,420,2,69,37,5,2,1,3,0,2,2,6,2,8,-3,3,0,0,1,1,0,0,5,1,-7,6,-3,0,0,1,1,-1,-1,1,-1
KR_6746922813,420,-3,-55,-16,-1,-1,2,1,-1,3,2,-4,8,4,3,1,4,2,1,3,-1,0,53,1,-5,4,-1,0,-2,-1,1,-1,-1,2,-1
KR_6631029414,420,1,21,-16,1,1,1,2,-2,6,4,0,1,1,1,2,3,1,0,1,-1,-3,6,1,-1,0,-2,0,-1,-1,-1,-1,-1,1,-1
KR_6728891065,440,-2,-1,12,-2,0,1,1,2,2,4,0,3,3,-2,4,2,-2,2,0,0,-7,34,2,-7,5,-2,0,0,-1,-1,-1,-1,5,-1
KR_6764008358,420,-5,-74,-20,-3,0,1,1,5,2,7,-3,3,0,-2,4,2,-3,7,4,0,-7,-8,0,-4,4,-2,0,-1,-1,-1,-1,-1,5,-1
KR_6763014833,420,-3,-26,-32,-3,-2,4,2,0,1,1,0,2,2,0,1,1,-1,1,0,0,-3,-4,-5,-4,9,2,0,0,-1,-1,-1,-1,2,-1
KR_6753885533,420,1,0,20,6,-1,1,0,-3,5,2,4,1,5,4,1,5,2,1,3,0,6,-7,-2,-2,4,0,0,0,1,0,1,1,6,-1
KR_6758538740,420,-5,-20,-75,-10,5,1,6,-3,5,2,-4,7,3,-5,6,1,-3,4,1,-1,-3,3,1,-5,4,-4,0,-2,-1,-1,-1,-1,3,-1
KR_6533623760,420,-1,-77,-20,-1,-4,5,1,4,2,6,-4,4,0,3,0,3,0,1,1,0,2,-146,1,-4,3,2,0,-1,1,-1,-1,-1,2,-1
KR_6743583581,420,1,-29,9,-3,2,1,3,3,1,4,0,0,0,-9,12,3,1,2,3,0,-5,-1,-6,-2,8,1,0,0,-1,1,-1,-1,6,-1
KR_6755037422,420,-2,-58,-16,-7,0,3,3,0,3,3,-1,3,2,-6,6,0,0,2,2,-1,-1,1,0,-3,3,-5,0,0,-1,1,1,-1,3,-1
KR_6622132176,420,-5,-22,19,-7,-1,3,2,-3,5,2,2,3,5,-3,5,2,-2,2,0,0,-10,13,-1,-3,4,-1,0,-1,-1,1,-1,1,2,-1
KR_6602914244,420,-3,-4,-13,-3,-9,9,0,-1,4,3,6,2,8,-1,2,1,2,0,2,0,3,13,1,-5,4,0,0,0,-1,-1,-1,1,1,-1
KR_6753311592,440,1,48,-16,3,3,1,4,-1,3,2,1,0,1,-1,2,1,1,0,1,0,2,-13,0,-5,5,0,0,-1,1,0,-1,1,4,-1
KR_6717281466,420,1,23,-20,0,-1,5,4,-1,3,2,-1,1,0,2,1,3,1,2,3,0,-3,-18,4,-6,2,5,0,0,1,-1,-1,1,3,-1
KR_6728028075,420,-1,-35,-6,-6,-2,2,0,0,4,4,-1,2,1,-2,4,2,-1,2,1,0,-4,-5,-2,-2,4,4,0,-1,-1,-1,-1,-1,6,-1
KR_6759541758,420,1,81,-22,8,1,2,3,2,3,5,3,1,4,2,2,4,0,2,2,0,5,-136,0,-5,5,3,0,2,0,1,1,-1,0,-1
KR_6759252251,420,-2,-9,0,-8,-2,4,2,-4,6,2,-3,5,2,-1,1,0,2,0,2,0,-5,-1,-2,-2,4,-1,0,0,-1,1,0,-1,1,-1
KR_6763341205,420,-4,-82,1,-12,-2,3,1,-3,4,1,-3,8,5,-3,4,1,-1,1,0,0,-7,15,0,-2,2,3,0,0,-1,1,0,-1,5,-1
KR_6594066126,420,1,-6,32,1,-2,2,0,1,3,4,2,0,2,3,4,7,-3,4,1,1,0,3,-4,-3,7,4,0,1,1,1,1,1,5,-1
KR_6763968626,420,0,21,-8,-3,-3,5,2,-1,5,4,-1,1,0,4,1,5,-2,3,1,0,-2,3,-4,-2,6,3,0,1,1,-1,1,1,4,-1
KR_6752086798,420,1,35,8,2,-1,3,2,1,2,3,4,0,4,-2,6,4,0,1,1,0,4,-301,3,-6,3,-4,0,0,-1,-1,-1,-1,2,-1
KR_6751075246,420,-3,0,2,-1,-2,5,3,-3,6,3,-1,6,5,6,2,8,-1,2,1,1,6,9,4,-8,4,-2,0,0,1,-1,-1,1,1,-1
KR_6718063094,420,-5,-92,-24,-17,0,2,2,-6,8,2,0,3,3,-6,7,1,-5,5,0,0,-26,3,-2,-2,4,-2,0,-2,1,-1,-1,1,5,-1
KR_6732811609,420,2,-45,0,6,3,1,4,-2,6,4,3,0,3,3,0,3,-1,2,1,0,3,-4,-2,-2,4,-1,0,-1,1,0,-1,1,4,-1
KR_6704606498,420,-1,-24,11,-5,-3,5,2,1,1,2,-2,3,1,0,1,1,-1,1,0,0,-12,-6,-3,0,3,0,0,-1,1,-1,-1,1,6,-1
KR_6633050028,420,-3,-17,-7,-5,-1,2,1,-3,8,5,1,2,3,-2,3,1,0,1,1,0,-2,-1,1,-4,3,-2,0,-1,-1,1,-1,-1,2,-1
KR_6739783724,420,0,-73,-16,-6,-2,2,0,-3,3,0,-2,4,2,0,1,1,1,2,3,-2,-6,-30,-1,-4,5,1,0,-1,1,-1,-1,-1,3,-1
KR_6507218420,420,2,-47,1,11,-1,2,1,5,0,5,2,1,3,5,1,6,0,2,2,0,10,-3,1,-5,4,1,0,-1,1,-1,-1,-1,2,-1
KR_6756563078,420,-3,-44,4,-4,-2,2,0,-1,4,3,3,1,4,0,1,1,-4,4,0,-1,-2,2,-2,-1,3,-1,0,0,-1,-1,-1,-1,5,-1
KR_6686639486,440,-2,82,-23,-4,9,0,9,-7,9,2,-2,3,1,-8,8,0,4,0,4,2,-10,278,0,-3,3,-2,0,1,-1,0,1,1,2,-1
KR_6725510768,420,-6,-105,-32,-12,-8,8,0,3,1,4,-1,4,3,-6,6,0,0,2,2,0,-14,5,-1,-3,4,0,0,-2,-1,1,-1,-1,5,-1
KR_6740429850,420,-1,6,-5,-4,-1,2,1,-3,4,1,4,0,4,-3,5,2,-1,2,1,0,-7,-3,0,-6,6,-6,0,-1,1,0,-1,-1,4,-1
KR_6731026711,420,0,-41,-3,-1,1,0,1,-1,5,4,-1,3,2,0,0,0,0,1,1,0,0,26,2,-4,2,-2,0,0,-1,0,0,1,2,-1
KR_6742725944,420,0,22,0,6,0,1,1,0,4,4,1,4,5,3,1,4,2,4,6,1,14,6,-1,-2,3,1,0,0,0,1,0,1,0,-1
KR_6761861909,420,-1,26,-20,-6,-1,2,1,-5,9,4,-4,4,0,6,1,7,-2,2,0,1,0,314,5,-8,3,-7,0,-1,-1,-1,-1,1,1,-1
KR_6637273612,420,0,-28,0,-4,-4,4,0,2,2,4,0,1,1,-3,4,1,1,0,1,0,3,-185,-2,-4,6,0,0,0,-1,1,-1,-1,4,-1
KR_6729881147,440,1,29,-24,7,-4,5,1,-4,6,2,1,1,2,9,2,11,5,0,5,1,5,3,-3,-3,6,1,0,0,1,-1,1,1,2,-1
KR_6761190330,420,-1,-47,-9,-8,0,1,1,-7,7,0,2,0,2,-5,7,2,2,0,2,0,-10,16,-1,-4,5,-4,0,0,-1,-1,0,-1,2,-1
KR_6680348839,420,1,66,28,0,-1,2,1,1,4,5,-3,6,3,2,0,2,1,0,1,0,-1,-408,0,-3,3,-3,0,0,-1,1,0,-1,3,-1
KR_6758110565,420,0,55,-20,-3,0,0,0,-4,4,0,-2,2,0,2,0,2,1,1,2,0,-7,1,-1,-2,3,2,0,2,-1,1,1,-1,3,-1
KR_6759504467,420,1,4,-10,5,4,3,7,5,1,6,-4,7,3,2,3,5,-2,4,2,0,5,7,1,-3,2,-1,0,0,-1,0,1,-1,5,-1
KR_6748649106,420,0,-8,-10,-4,-4,6,2,2,2,4,-3,6,3,2,2,4,-1,3,2,-1,-8,-17,-3,-2,5,-1,0,-1,1,1,-1,-1,2,-1
KR_6722216614,440,-7,-45,-40,-16,3,0,3,-5,6,1,0,0,0,-9,9,0,-5,7,2,0,-11,-3,-2,-1,3,1,0,-2,-1,0,-1,-1,5,-1
KR_6751627306,420,-5,-104,-16,-1,-3,5,2,-4,5,1,5,1,6,3,1,4,-2,4,2,0,-4,-3,3,-6,3,-4,0,-1,-1,1,-1,-1,4,-1
KR_6736996911,440,-3,-11,-9,-2,-3,5,2,-6,8,2,-2,2,0,2,2,4,7,0,7,0,5,306,1,-4,3,0,0,-1,1,0,-1,1,2,-1
KR_6649021934,420,0,-59,0,-4,3,1,4,-2,5,3,-1,3,2,0,1,1,-4,4,0,0,-6,-23,2,-8,6,3,0,-1,1,-1,-1,-1,2,-1
KR_6759662653,420,-1,0,3,3,3,1,4,3,2,5,-4,5,1,2,3,5,-1,4,3,-1,1,-4,-4,-2,6,0,0,1,1,1,1,-1,4,-1
KR_6748600829,420,-4,-48,15,-16,-7,9,2,1,1,2,-8,9,1,-3,4,1,1,0,1,0,-11,4,-4,-3,7,-2,0,-2,-1,-1,-1,-1,4,-1
KR_6687047758,420,-1,1,-12,-2,1,3,4,-1,4,3,0,0,0,-1,2,1,-1,1,0,-1,-4,-5,-2,-3,5,1,0,-1,1,-1,-1,-1,6,-1
KR_6761630588,420,0,28,4,3,2,3,5,7,1,8,2,3,5,-8,8,0,0,0,0,0,-5,46,4,-6,2,-16,0,1,-1,0,1,-1,1,-1
KR_6743729251,420,-2,-26,4,-9,-1,3,2,-4,6,2,-5,6,1,0,2,2,1,0,1,0,-10,46,-1,-3,4,-29,0,0,-1,1,0,1,3,-1
KR_6702131697,420,2,-37,4,0,3,1,4,1,3,4,-2,3,1,2,1,3,-4,5,1,-1,-7,17,3,-6,3,-3,0,0,-1,-1,0,-1,2,-1
KR_6749917406,420,0,-2,-20,-9,1,2,3,2,0,2,-1,3,2,-10,10,0,-1,1,0,-1,-12,-4,2,-6,4,-8,0,0,1,-1,0,-1,1,-1
KR_6566802725,440,-2,-30,-23,-6,3,1,4,-3,3,0,-2,4,2,-4,4,0,0,5,5,0,-15,-2,-2,-4,6,-4,0,0,1,1,0,-1,1,-1
KR_6733625968,440,1,41,13,-4,1,2,3,-3,4,1,3,0,3,-2,6,4,-3,4,1,0,-4,-1,-2,-1,3,1,0,0,1,-1,-1,-1,6,-1
KR_6761854957,440,-10,-139,-32,-21,-6,8,2,-4,5,1,-4,4,0,-6,8,2,-1,1,0,0,-17,-26,-2,-2,4,-3,0,-4,-1,-1,-1,1,6,-1
KR_6749195681,420,-4,-64,-21,-8,-1,1,0,-3,4,1,-2,6,4,-1,2,1,-1,1,0,-1,-5,16,0,-3,3,-7,0,0,-1,-1,0,-1,4,-1
KR_6760717474,420,-2,-68,-32,0,-1,1,0,-5,6,1,-1,5,4,4,0,4,3,1,4,0,3,3,0,-3,3,2,0,0,0,-1,0,1,0,-1
KR_6764336853,420,-2,-52,29,-8,-5,6,1,0,1,1,0,4,4,-5,6,1,2,0,2,0,-4,8,2,-3,1,3,0,0,1,1,0,1,5,-1
KR_6738335031,440,-3,-125,-8,-17,-5,6,1,-2,2,0,-2,4,2,-3,6,3,-5,6,1,-3,-16,12,-1,-5,6,-6,0,0,-1,-1,-1,-1,5,-1
KR_6728596609,420,-1,28,-20,0,1,0,1,1,1,2,2,0,2,-4,4,0,0,1,1,0,-1,-118,3,-5,2,-3,0,0,1,-1,0,-1,4,-1
KR_6732644629,420,-3,29,-52,-5,0,0,0,-6,6,0,3,2,5,-2,4,2,0,0,0,0,-4,-75,2,-5,3,0,0,-1,-1,-1,-1,-1,5,-1
KR_6742189855,420,1,-20,-6,4,3,1,4,1,2,3,-1,2,1,1,3,4,0,1,1,0,3,-11,-1,0,1,0,0,-1,-1,-1,-1,-1,5,-1
KR_6684808334,440,-1,-18,20,-12,-1,2,1,0,1,1,0,1,1,-6,6,0,-5,5,0,-1,-20,29,-5,-3,8,-3,0,-1,-1,-1,-1,-1,6,-1
KR_6585121848,420,0,29,29,4,-1,2,1,5,2,7,-2,7,5,0,4,4,2,0,2,0,1,187,1,-6,5,-2,0,0,1,1,0,1,1,-1
KR_6753946270,420,0,87,-21,7,0,0,0,4,3,7,2,1,3,3,2,5,-2,6,4,3,7,3,1,-4,3,2,0,-1,-1,-1,-1,1,3,-1
KR_6763665006,420,-1,-33,-28,-6,2,2,4,-4,4,0,0,3,3,-4,6,2,0,1,1,0,-5,-8,-4,-1,5,4,0,0,-1,-1,1,-1,5,-1
KR_6762219768,420,-1,20,-7,-4,-1,1,0,-3,4,1,-1,4,3,1,3,4,0,1,1,0,-4,7,-5,-1,6,-1,0,0,0,-1,0,1,0,-1
KR_6762401798,420,1,27,4,3,3,0,3,-2,2,0,1,1,2,1,0,1,0,0,0,0,-1,-23,-2,-3,5,3,0,1,-1,1,1,1,4,-1
KR_6762932910,420,-3,-39,-32,-6,0,1,1,-3,6,3,-5,5,0,0,1,1,2,0,2,-1,-3,-3,-2,-1,3,-1,0,-1,-1,-1,-1,-1,5,-1
KR_6611140323,420,-2,22,-15,-2,3,0,3,2,4,6,-2,4,2,-5,5,0,0,1,1,0,-5,-8,-3,-4,7,2,0,1,1,1,1,-1,3,-1
KR_6668368359,420,-5,-50,12,-4,0,2,2,0,4,4,-3,5,2,-1,3,2,0,2,2,0,7,0,1,-6,5,4,0,0,1,-1,-1,1,6,-1
KR_6606078915,420,0,5,20,0,0,1,1,3,1,4,1,2,3,-1,1,0,-3,5,2,0,-3,22,-2,-3,5,0,0,0,1,1,1,-1,1,-1
KR_6657628434,420,-4,22,12,-9,-1,1,0,0,2,2,-10,11,1,2,0,2,0,0,0,0,1,-5,-3,-2,5,4,0,0,-1,1,0,1,5,-1
KR_6758951586,440,2,-1,-12,-2,-1,2,1,-2,3,1,-6,6,0,2,5,7,5,2,7,0,-5,8,2,-4,2,-3,0,-2,0,-1,-1,1,0,-1
KR_6725545267,420,1,49,-1,1,3,0,3,0,5,5,1,2,3,-2,5,3,-1,1,0,0,6,-1,2,-5,3,3,0,1,-1,-1,-1,-1,1,-1
KR_6754700555,420,-1,-14,-1,1,-4,4,0,-2,3,1,-1,3,2,7,1,8,1,2,3,1,-7,-24,-2,-2,4,0,0,-1,-1,-1,-1,1,6,-1
KR_6634475945,420,3,-128,12,1,-1,2,1,-1,2,1,4,1,5,-2,3,1,1,0,1,0,2,-2,-1,-4,5,1,0,0,1,-1,0,-1,1,-1
KR_6744822774,420,0,-104,-12,-1,0,2,2,-2,5,3,4,0,4,-3,3,0,0,1,1,0,-5,2,2,-5,3,3,0,0,1,-1,0,1,2,-1
KR_6742108613,420,-3,16,-16,-1,2,3,5,1,0,1,-2,2,0,0,1,1,-2,3,1,0,0,2,3,-3,0,-3,0,-3,-1,-1,-1,1,3,-1
KR_6762019883,420,-3,-140,18,4,1,2,3,-3,5,2,5,0,5,0,3,3,1,1,2,0,4,8,4,-7,3,0,0,-1,1,0,-1,-1,3,-1
KR_6743300624,420,-4,-83,19,-12,1,2,3,-4,4,0,-5,9,4,-7,8,1,3,2,5,-2,-4,-48,-2,-1,3,0,0,-2,-1,-1,-1,1,2,-1
KR_6618449202,420,-3,-75,-28,-7,-1,2,1,-3,6,3,2,0,2,-5,8,3,0,2,2,0,-9,-116,-2,-5,7,-4,0,0,1,1,0,-1,1,-1
KR_6696519199,420,-1,-49,36,-2,-6,6,0,0,4,4,7,0,7,-2,2,0,-1,1,0,0,-6,-1,3,-7,4,0,0,-1,1,1,-1,1,2,-1
KR_6520454352,420,1,25,-8,4,-2,3,1,1,2,3,2,1,3,4,2,6,-1,3,2,1,1,5,0,-3,3,-4,0,0,1,1,1,1,2,-1
KR_6716651827,420,-3,17,-23,-9,-2,2,0,-1,2,1,-2,4,2,0,1,1,-4,4,0,0,-15,-5,-4,-1,5,0,0,1,-1,-1,1,-1,4,-1
KR_6751563746,420,-4,16,15,-8,0,1,1,-1,1,0,0,3,3,-4,6,2,-3,4,1,0,-6,-11,2,-3,1,-2,0,1,-1,-1,1,-1,4,-1
KR_6762135409,420,-2,-44,-20,-7,-2,2,0,-2,2,0,-3,5,2,1,2,3,-1,3,2,0,-2,-2,2,-6,4,-3,0,0,1,-1,-1,1,4,-1
KR_6737579807,420,-1,2,21,-5,0,4,4,-2,3,1,1,2,3,-2,2,0,-2,2,0,0,-8,-5,2,-5,3,-1,0,0,0,0,-1,-1,0,-1
KR_6738067243,420,-5,-53,-41,-8,-10,10,0,5,1,6,-1,4,3,-2,3,1,0,0,0,1,-6,-16,-4,-4,8,-2,0,-1,-1,-1,-1,1,1,-1
KR_6714856638,420,-2,-67,12,-13,0,0,0,-2,3,1,-6,6,0,-5,6,1,0,2,2,0,-12,3,-2,-3,5,-3,0,-1,-1,1,-1,-1,4,-1
KR_6749402033,420,-1,-17,-32,1,-2,4,2,0,4,4,-1,2,1,4,0,4,0,0,0,0,6,-7,-1,-4,5,0,0,0,-1,-1,1,1,1,-1
KR_6645002315,420,-1,13,9,-7,-1,1,0,-1,3,2,-2,3,1,-1,3,2,-2,2,0,0,-12,-3,-5,-1,6,1,0,-1,-1,-1,-1,-1,1,-1
KR_6722095876,420,2,3,-41,6,3,0,3,3,4,7,1,4,5,1,2,3,-2,3,1,0,13,-16,3,-9,6,2,0,1,1,1,1,1,6,-1
KR_6724711224,420,-5,-46,-9,-8,-2,4,2,-1,2,1,-4,5,1,3,1,4,-4,5,1,0,-5,-198,1,-5,4,1,0,-1,-1,0,1,-1,4,-1
KR_6763214673,420,1,23,-12,8,-1,2,1,0,2,2,2,0,2,6,1,7,1,1,2,0,6,5,3,-7,4,2,0,-1,1,-1,-1,1,1,-1
KR_6752788219,420,-2,43,3,-8,2,2,4,-1,1,0,-3,3,0,-6,7,1,0,1,1,-1,-14,6,1,-4,3,-1,0,0,1,0,0,-1,1,-1
KR_6758428282,420,-2,-33,-33,-3,-4,4,0,1,4,5,2,1,3,1,1,2,-3,3,0,2,7,4,-1,-5,6,-1,0,-1,-1,0,-1,1,1,-1
KR_6756596700,420,-4,-65,-32,-15,-3,3,0,-1,2,1,-3,5,2,-5,7,2,-3,3,0,0,-5,7,-3,0,3,1,0,0,-1,-1,-1,-1,6,-1
KR_6719839730,420,-1,22,3,-4,1,2,3,-2,2,0,-1,2,1,-1,4,3,-1,2,1,1,-6,2,3,-6,3,0,0,0,-1,0,1,1,3,-1
KR_6670831067,420,-3,-37,-11,-7,0,1,1,-3,5,2,0,1,1,-5,7,2,1,2,3,-1,-8,-6,-3,-6,9,2,0,-1,-1,-1,-1,-1,3,-1
KR_6678387092,420,0,3,-16,1,0,2,2,-3,7,4,4,2,6,0,3,3,0,1,1,0,5,18,3,-6,3,-4,0,2,0,-1,-1,1,0,-1
KR_6723887116,420,-4,-8,-23,-4,-1,2,1,2,0,2,-3,3,0,-1,1,0,-1,3,2,0,0,-7,-2,-2,4,1,0,-2,-1,-1,-1,-1,3,-1
KR_6477051596,420,-4,-45,-5,-12,-2,2,0,-4,4,0,0,3,3,-3,4,1,-3,3,0,0,-11,-33,-1,-2,3,0,0,0,-1,0,0,-1,3,-1
KR_6757822441,420,1,-25,-8,5,-1,1,0,10,1,11,-6,7,1,1,0,1,1,0,1,1,9,-236,-3,-7,10,-1,0,-1,-1,-1,-1,1,5,-1
KR_6644413495,420,-4,-108,11,-10,-5,7,2,-2,2,0,-3,5,2,0,1,1,0,0,0,-1,-5,-14,-3,-3,6,1,0,-2,-1,-1,-1,-1,5,-1
KR_6620257508,420,-5,-65,0,-7,-4,5,1,2,2,4,1,2,3,-2,3,1,-4,5,1,0,-6,6,2,-3,1,2,0,-1,-1,1,-1,1,2,-1
KR_6658791123,420,-4,-67,-24,-7,2,2,4,-3,3,0,-1,2,1,-4,7,3,-1,1,0,0,-6,-28,0,-2,2,14,0,0,1,-1,0,-1,1,-1
KR_6764500087,420,2,34,-14,4,3,2,5,0,0,0,2,3,5,-1,3,2,0,1,1,0,1,-1,-2,0,2,2,0,1,-1,1,1,-1,4,-1
KR_6749312236,420,1,27,-21,0,-1,3,2,-3,7,4,8,2,10,-4,4,0,0,0,0,0,0,9,4,-7,3,-2,0,0,-1,-1,-1,-1,6,-1
KR_6723201054,420,1,-85,32,1,-5,6,1,3,1,4,-3,5,2,1,3,4,5,1,6,0,2,6,3,-7,4,3,0,-1,-1,1,-1,1,5,-1
KR_6578594627,420,-4,-21,-68,-5,-1,2,1,0,1,1,-5,6,1,-3,5,2,4,0,4,-1,-3,-9,-5,-2,7,0,0,-1,0,-1,-1,-1,0,-1
KR_6749712529,420,0,46,3,-3,4,1,5,-7,10,3,1,2,3,-1,3,2,0,0,0,0,-10,-49,3,-7,4,-1,0,1,-1,1,1,1,5,-1
KR_6657073942,420,2,-40,36,1,-2,4,2,0,2,2,3,0,3,0,3,3,0,2,2,0,-2,16,-2,-2,4,3,0,-1,1,-1,-1,-1,5,-1
KR_6736752026,420,0,15,20,-2,3,1,4,4,0,4,-6,7,1,0,1,1,-3,3,0,0,-6,17,3,-7,4,-6,0,-1,0,1,-1,-1,0,-1
KR_6689480986,420,-4,-99,-1,-9,-5,5,0,-1,2,1,-5,7,2,-4,5,1,6,1,7,0,7,-25,-4,-1,5,1,0,-2,1,-1,-1,-1,2,-1
KR_6760811635,440,-2,-100,13,-4,-3,5,2,3,6,9,-2,3,1,-2,3,1,0,1,1,-2,1,-5,0,-4,4,-3,0,-1,1,-1,-1,-1,3,-1
KR_6745417714,420,2,41,-4,6,1,1,2,1,4,5,2,0,2,4,1,5,-2,3,1,0,7,2,-2,-1,3,-2,0,-1,-1,-1,-1,1,1,-1
KR_6763939853,420,1,27,8,2,1,1,2,2,3,5,3,0,3,-2,5,3,-2,4,2,0,-2,4,0,-2,2,-6,0,-1,0,0,-1,-1,0,-1
KR_6488536931,420,-5,-40,-43,-13,9,0,9,-3,4,1,-7,8,1,-11,17,6,-1,2,1,-2,-13,-4,0,-4,4,-2,0,-2,0,0,-1,-1,0,-1
KR_6749097275,420,3,19,0,5,3,1,4,1,2,3,-2,2,0,3,0,3,0,0,0,0,0,23,1,-2,1,1,0,1,0,1,1,1,0,-1
KR_6757167564,420,1,81,16,0,-2,2,0,4,1,5,-3,5,2,0,7,7,1,1,2,1,3,3,-2,-2,4,-1,0,0,-1,-1,-1,1,4,-1
KR_6748404607,440,0,-9,4,0,-2,6,4,0,2,2,2,2,4,-1,4,3,1,1,2,0,-2,-3,1,-4,3,0,0,-1,1,-1,-1,-1,6,-1
KR_6730309240,420,2,36,-2,5,3,1,4,-1,1,0,2,2,4,2,1,3,-1,1,0,0,1,-10,0,-6,6,-4,0,1,1,1,1,-1,2,-1
KR_6763504101,420,-1,-7,-45,-2,-1,1,0,-2,3,1,0,0,0,1,0,1,0,0,0,0,0,6,2,-5,3,1,0,0,-1,1,0,-1,6,-1
KR_6710824190,420,-4,-1,16,-8,0,1,1,-5,5,0,-1,4,3,-1,4,3,-1,1,0,0,-8,1,3,-4,1,-1,0,-2,1,1,-1,1,3,-1
KR_6655792182,420,1,-55,30,1,-3,5,2,2,2,4,1,2,3,0,1,1,1,0,1,0,3,5,5,-6,1,0,0,-1,1,1,-1,-1,1,-1
KR_6745124841,420,3,16,-12,10,3,0,3,3,2,5,4,1,5,0,2,2,0,1,1,0,10,0,-1,-6,7,0,0,-1,-1,1,-1,1,1,-1
KR_6628186586,420,-2,-34,-12,-5,2,0,2,-3,5,2,-3,4,1,-1,2,1,0,0,0,-1,-4,12,-2,-4,6,-6,0,1,1,1,1,-1,6,-1
KR_6695377114,420,2,26,-18,7,2,0,2,2,2,4,4,3,7,-3,5,2,2,2,4,0,6,1,-5,-3,8,-1,0,0,1,1,1,1,3,-1
KR_6704783670,420,-3,-62,-35,-2,-4,6,2,-1,3,2,0,1,1,3,2,5,0,1,1,0,3,-1,-1,-3,4,0,0,0,-1,1,1,-1,3,-1
KR_6727106266,420,0,-46,17,-6,-5,6,1,3,0,3,-1,2,1,-3,4,1,0,1,1,0,-2,-47,-5,-2,7,9,0,0,1,-1,-1,1,4,-1
KR_6722072565,420,-2,-18,-20,1,-4,4,0,3,4,7,-1,3,2,1,1,2,2,1,3,0,9,-3,-1,-1,2,1,0,1,-1,1,1,-1,3,-1
KR_6731849560,420,-2,-2,-14,-2,-1,2,1,2,1,3,2,3,5,-5,6,1,0,0,0,0,-1,0,-1,-3,4,-2,0,0,-1,1,0,-1,4,-1
KR_6741033382,420,-3,9,-25,-3,0,1,1,-1,4,3,-3,5,2,0,1,1,1,0,1,0,2,-193,-5,-3,8,0,0,0,1,1,1,-1,1,-1
KR_6544545477,420,-4,-84,-12,-11,2,0,2,0,4,4,-5,5,0,-4,5,1,-4,4,0,0,-8,-35,2,-8,6,-1,0,-2,-1,1,-1,-1,6,-1
KR_6716107528,420,-4,-41,-16,-5,-1,2,1,3,2,5,-5,6,1,-3,4,1,1,0,1,0,-8,-4,2,-5,3,-2,0,-1,-1,1,-1,-1,5,-1
KR_6760761120,420,-3,6,6,-4,-4,4,0,8,1,9,-3,3,0,-3,4,1,-2,3,1,0,4,1,1,-3,2,2,0,-1,1,-1,-1,1,4,-1
KR_6764720860,420,0,-16,-24,3,2,2,4,-1,1,0,-3,3,0,6,0,6,-1,1,0,0,5,-2,-2,-3,5,2,0,0,1,0,-1,-1,2,-1
KR_6737556230,420,1,11,-23,2,-1,3,2,-3,4,1,1,2,3,3,0,3,2,0,2,0,2,-23,2,-5,3,0,0,1,1,-1,1,1,5,-1
KR_6683465994,420,2,24,30,3,2,1,3,0,2,2,-1,2,1,-1,4,3,3,0,3,0,-2,0,5,-7,2,0,0,0,1,-1,0,1,2,-1
KR_6283068242,420,-3,-24,8,-3,-1,3,2,3,2,5,-3,7,4,0,2,2,-2,4,2,-1,-2,6,1,-7,6,-5,0,-1,-1,1,1,-1,1,-1
KR_6724799359,420,0,30,10,-2,2,0,2,1,3,4,0,2,2,-3,6,3,-2,2,0,0,-7,2,2,-5,3,-2,0,0,1,1,0,-1,1,-1
KR_6760948650,420,-7,-50,-28,-16,-4,5,1,-6,7,1,-4,4,0,-2,2,0,0,0,0,-2,-19,9,2,-5,3,2,0,-1,-1,-1,-1,-1,6,-1
KR_6761949696,420,2,-6,-9,10,1,0,1,0,2,2,5,1,6,4,2,6,0,1,1,1,8,12,9,-10,1,-1,0,0,1,-1,0,1,3,-1
KR_6763377981,440,0,-11,44,-6,1,1,2,-2,2,0,2,0,2,-5,5,0,-2,2,0,0,-9,-3,2,-4,2,-4,0,-1,-1,1,-1,-1,4,-1
KR_6761628997,440,-5,-6,15,-5,-1,5,4,1,4,5,-1,2,1,-3,5,2,-1,1,0,0,-5,6,4,-5,1,-2,0,-1,1,-1,-1,-1,4,-1
KR_6763828828,420,0,-1,-7,-8,-8,8,0,-8,10,2,3,1,4,2,0,2,3,0,3,0,-1,-19,1,-5,4,-1,0,-1,0,-1,-1,-1,0,-1
KR_6572304656,440,-5,-134,-36,-1,3,1,4,-5,5,0,-2,5,3,3,2,5,0,0,0,0,2,28,-4,0,4,2,0,0,0,1,-1,1,0,-1
KR_6426009378,420,0,-108,-8,-6,2,0,2,0,1,1,-3,5,2,-5,5,0,0,0,0,0,-2,5,1,-6,5,-7,0,-1,-1,-1,-1,-1,2,-1
KR_6716755164,420,-2,-98,-36,-1,1,0,1,-3,5,2,1,0,1,-1,6,5,1,2,3,0,4,-29,2,-4,2,-2,0,1,0,1,1,-1,0,-1
KR_6719081873,420,-5,-54,-48,-9,-1,3,2,-7,8,1,-1,3,2,-1,3,2,1,1,2,1,-7,33,3,-7,4,-6,0,-1,-1,-1,-1,1,4,-1
KR_6760891958,440,-2,-72,-34,-1,-3,3,0,5,1,6,-5,6,1,3,1,4,-1,2,1,0,15,-27,-2,-1,3,19,0,-2,-1,-1,-1,-1,3,-1
KR_6750569594,420,0,43,5,-1,0,1,1,-5,5,0,3,2,5,1,0,1,0,0,0,0,-4,6,9,-11,2,-7,0,0,-1,-1,1,1,4,-1
KR_6289074894,440,-3,-74,-11,-5,-2,2,0,0,3,3,1,1,2,-4,4,0,0,0,0,1,1,-502,-3,-1,4,29,0,-2,1,0,-1,1,3,-1
KR_6754604006,440,-2,1,8,4,1,1,2,4,0,4,1,1,2,-4,5,1,2,1,3,1,4,30,-3,-1,4,-28,0,-2,-1,-1,-1,1,5,-1
KR_6756401050,420,-6,-112,-12,-10,-1,1,0,-5,6,1,-3,4,1,-2,3,1,1,2,3,0,-5,5,-3,-2,5,1,0,-2,0,-1,-1,-1,0,-1
KR_6717289929,440,-5,-88,-44,-7,0,4,4,-2,3,1,-3,3,0,0,4,4,-2,2,0,1,-8,-5,2,-6,4,1,0,-2,-1,0,-1,1,2,-1
KR_6701467785,420,-2,-9,11,2,0,3,3,0,2,2,2,1,3,-1,4,3,1,1,2,0,1,104,5,-9,4,-1,0,1,1,1,1,1,4,-1
KR_6762961298,420,0,-3,-2,2,3,0,3,-2,2,0,-1,3,2,1,1,2,1,0,1,1,5,-8,-5,-4,9,2,0,0,1,-1,1,1,6,-1
KR_6761786521,420,-2,-25,16,-2,-3,3,0,-3,3,0,-4,4,0,5,0,5,3,1,4,0,1,47,1,-3,2,-22,0,-1,-1,-1,-1,-1,3,-1
KR_6760673958,420,4,71,22,8,2,0,2,-1,3,2,2,0,2,1,1,2,4,0,4,0,7,-3,3,-6,3,-2,0,1,-1,-1,1,1,3,-1
KR_6729828605,420,-2,-6,-8,-9,4,0,4,-3,6,3,-3,5,2,-7,7,0,0,1,1,0,-11,-31,0,-3,3,1,0,-1,-1,1,1,-1,3,-1
KR_6748425352,420,-3,-123,-28,0,2,1,3,0,2,2,-1,4,3,-1,2,1,0,0,0,0,-1,3,5,-8,3,-3,0,0,-1,0,-1,-1,3,-1
KR_6764103270,420,-4,-87,-20,-8,0,2,2,-1,3,2,-2,4,2,-4,4,0,-1,3,2,-1,-8,-36,-3,-2,5,3,0,-1,-1,-1,-1,-1,4,-1
KR_6759882919,440,1,27,-2,-3,0,2,2,1,3,4,0,0,0,-5,5,0,1,0,1,0,-7,0,-2,-5,7,-2,0,0,-1,0,0,-1,5,-1
KR_6738295496,440,-3,-90,16,-6,-5,6,1,0,5,5,0,2,2,3,1,4,-4,4,0,0,-9,-4,0,-5,5,-8,0,-2,-1,1,-1,-1,2,-1
KR_6736170800,420,0,-80,4,4,1,1,2,0,2,2,0,2,2,2,2,4,1,0,1,1,4,-3,-1,-4,5,1,0,0,1,-1,0,1,4,-1
KR_6763630571,440,1,2,1,0,-1,2,1,-4,4,0,0,3,3,5,2,7,0,1,1,0,-2,-5,-6,-2,8,4,0,1,1,1,1,1,4,-1
KR_6762763389,420,-5,-73,-28,-9,-8,8,0,-2,2,0,1,0,1,1,1,2,-1,2,1,0,-2,1,0,-5,5,1,0,-2,-1,-1,-1,-1,4,-1
KR_6762432709,420,-2,-51,-12,-7,-1,3,2,-2,3,1,-5,5,0,1,3,4,0,0,0,-1,-4,12,-3,-2,5,1,0,-1,-1,-1,-1,-1,4,-1
KR_6701301709,420,-1,31,8,-6,-1,1,0,-1,3,2,0,0,0,-4,6,2,0,3,3,0,-6,-1,3,-3,0,1,0,0,1,-1,-1,1,3,-1
KR_6762136490,420,-1,-3,44,-7,0,3,3,-3,3,0,3,3,6,-5,6,1,-2,2,0,0,-16,9,-4,-2,6,0,0,-1,-1,1,-1,-1,5,-1
KR_6717470010,420,1,-19,-12,1,-2,2,0,7,1,8,1,2,3,-4,5,1,-1,1,0,1,6,-17,0,-3,3,3,0,-1,1,-1,-1,1,2,-1
KR_6613823504,420,-5,-104,0,-8,0,2,2,-3,5,2,-1,2,1,-2,3,1,-2,2,0,0,-7,-59,-3,-2,5,37,0,0,-1,1,-1,-1,1,-1
KR_6674116681,420,-8,-133,-46,-16,-8,8,0,-1,1,0,-3,4,1,-2,4,2,-2,2,0,-1,-13,-23,-4,-3,7,0,0,-2,-1,-1,-1,-1,1,-1
KR_6644294183,420,1,7,-12,-2,-3,4,1,0,2,2,2,1,3,-1,2,1,0,0,0,0,2,-4,0,-6,6,-2,0,1,-1,1,-1,1,4,-1
KR_6758897938,440,2,23,12,-3,0,1,1,0,4,4,-3,5,2,0,3,3,0,1,1,0,2,-25,-1,-4,5,-2,0,0,1,1,0,-1,2,-1
KR_6756455623,420,-2,-48,9,-13,-3,5,2,2,1,3,-3,4,1,-4,6,2,-5,5,0,-1,-14,-6,0,-4,4,-3,0,-1,-1,-1,-1,-1,1,-1
KR_6648356978,420,-2,-16,-16,-6,-6,6,0,-4,5,1,3,1,4,3,1,4,-2,2,0,-1,-4,217,-2,-2,4,-3,0,-1,1,-1,-1,-1,1,-1
KR_6734898533,420,-1,56,-14,-9,0,0,0,-6,7,1,-4,4,0,-1,3,2,2,1,3,0,-7,-13,2,-4,2,0,0,0,-1,-1,1,-1,6,-1
KR_6686670340,420,-3,-71,-8,-12,-5,5,0,-2,3,1,0,2,2,-4,5,1,-1,1,0,0,-9,0,2,-7,5,-7,0,-2,-1,-1,-1,-1,4,-1
KR_6690203144,440,0,28,0,3,-5,7,2,4,0,4,-1,3,2,5,0,5,0,1,1,0,2,-11,0,-4,4,2,0,1,1,-1,1,-1,5,-1
KR_6654606495,420,1,6,-6,2,3,2,5,-1,2,1,0,1,1,-2,5,3,2,0,2,0,3,-19,-2,-3,5,2,0,1,-1,1,1,-1,5,-1
KR_6764555003,440,1,-12,0,5,1,1,2,1,6,7,1,2,3,1,2,3,1,0,1,1,5,8,0,-4,4,-4,0,0,1,-1,-1,1,4,-1
KR_6761429194,420,0,-49,-7,1,3,1,4,-1,4,3,-2,3,1,1,0,1,0,0,0,1,3,-299,-2,-1,3,3,0,0,1,1,0,1,1,-1
KR_6606804878,420,-6,-46,-44,-4,-2,4,2,0,3,3,0,2,2,-3,5,2,1,2,3,1,-9,5,-3,-1,4,2,0,-2,-1,-1,-1,1,3,-1
KR_6761572783,440,0,27,16,5,0,1,1,3,0,3,0,3,3,3,2,5,-1,1,0,0,5,8,7,-7,0,0,0,1,1,1,1,-1,2,-1
KR_6761734494,420,-1,-43,3,-2,-3,4,1,2,4,6,-2,2,0,1,2,3,0,2,2,0,3,-23,4,-5,1,-5,0,-1,0,-1,-1,-1,0,-1
KR_6703989417,420,-2,-14,-12,-11,1,2,3,-7,9,2,-5,5,0,1,2,3,-1,3,2,0,-15,45,1,-2,1,-19,0,1,0,-1,1,1,0,-1
KR_6728118613,420,-3,-120,-52,-5,-3,3,0,-5,7,2,1,3,4,0,3,3,2,0,2,-1,-11,-20,-3,-1,4,4,0,-1,1,-1,-1,-1,1,-1
KR_6742072163,440,0,-80,-8,1,0,0,0,3,0,3,2,2,4,-3,7,4,-1,2,1,-1,-3,19,2,-4,2,-3,0,-1,-1,0,-1,-1,4,-1
KR_6592338440,420,0,-96,-9,0,1,0,1,5,0,5,-1,3,2,-2,3,1,-3,3,0,0,-1,-21,5,-7,2,-31,0,-1,-1,0,-1,-1,3,-1
KR_6732330780,420,0,-8,-7,1,1,1,2,-4,5,1,0,4,4,3,2,5,1,0,1,0,-1,-140,-2,-4,6,-3,0,-3,-1,-1,-1,-1,1,-1
KR_6760496406,420,-5,-110,-4,-16,-3,4,1,-2,4,2,-8,9,1,-3,3,0,0,1,1,0,-10,-6,-7,-1,8,4,0,-1,-1,-1,-1,-1,4,-1
KR_6698572085,420,-1,-2,-5,-1,-1,3,2,0,2,2,1,1,2,1,0,1,-2,2,0,0,-1,0,-1,-2,3,-1,0,-1,1,-1,-1,1,2,-1
KR_6752846818,420,0,48,-11,-2,-4,4,0,0,2,2,-2,3,1,6,0,6,-2,2,0,1,6,2,0,-3,3,1,0,0,1,0,0,1,2,-1
KR_6710638052,420,0,-6,-4,-8,0,3,3,-5,6,1,-3,4,1,3,2,5,-3,4,1,-2,-11,16,-3,-5,8,1,0,1,-1,1,1,-1,4,-1
KR_6432042118,420,0,-26,-10,3,3,1,4,1,3,4,-3,6,3,1,0,1,1,1,2,0,4,4,1,-4,3,2,0,0,0,0,1,1,0,-1
KR_6755762337,440,-4,-48,-14,-3,2,1,3,1,3,4,-4,6,2,-2,2,0,0,1,1,-1,-1,8,0,-4,4,4,0,0,0,1,-1,-1,0,-1
KR_6753884718,420,-5,-34,-20,-12,1,1,2,-7,10,3,-4,4,0,0,2,2,-2,3,1,0,-7,-3,2,-8,6,-3,0,0,-1,-1,-1,-1,5,-1
KR_6764537352,440,-1,-1,-9,-2,-3,3,0,2,1,3,0,3,3,1,2,3,-2,3,1,0,0,110,-6,-3,9,7,0,-1,-1,-1,-1,-1,3,-1
KR_6604568259,420,-6,-91,-12,-8,-3,4,1,-1,3,2,0,2,2,-2,4,2,-2,2,0,0,-2,1,0,-6,6,-1,0,0,-1,1,-1,1,2,-1
KR_6493085987,420,-2,-36,0,-8,0,0,0,-1,4,3,-3,3,0,-2,2,0,-2,2,0,0,-13,-2,-3,-3,6,0,0,0,1,1,0,-1,1,-1
KR_6631352028,420,1,61,22,2,-1,1,0,4,0,4,2,0,2,-3,3,0,0,1,1,0,-1,-22,0,-8,8,3,0,2,0,1,1,1,0,-1
KR_6733702423,440,-3,-78,-40,-10,1,1,2,-5,6,1,-3,3,0,-3,6,3,0,0,0,-1,-13,-3,0,-7,7,4,0,0,-1,1,0,-1,4,-1
KR_6761512931,420,-2,-36,9,-6,0,1,1,5,0,5,-5,7,2,-6,6,0,0,1,1,0,-3,-8,-5,-2,7,0,0,0,-1,0,0,-1,6,-1
KR_6752390429,420,-5,-9,-8,-7,-1,1,0,-1,1,0,0,0,0,-5,6,1,0,2,2,0,-6,-121,-1,-2,3,-1,0,-1,-1,1,-1,-1,6,-1
KR_6762292462,420,-2,-48,4,-12,-1,1,0,-3,4,1,1,3,4,-11,11,0,2,0,2,0,-9,3,-2,-2,4,2,0,-1,-1,0,-1,1,6,-1
KR_6749405597,440,-2,1,-8,0,1,1,2,2,2,4,-3,4,1,0,3,3,0,1,1,1,9,22,0,-5,5,0,0,0,1,0,0,1,2,-1
KR_6760911959,420,1,-15,-4,0,-2,3,1,-1,6,5,2,2,4,0,3,3,1,1,2,0,-5,-11,-2,-4,6,3,0,-1,-1,1,-1,-1,6,-1
KR_6599810942,420,3,-24,-16,2,-2,3,1,-2,4,2,-2,6,4,6,2,8,2,0,2,0,13,-3,2,-4,2,3,0,-1,1,-1,-1,1,1,-1
KR_6688619637,420,-1,-17,4,-5,0,3,3,1,2,3,-1,1,0,-6,7,1,1,2,3,0,-4,-25,-3,-2,5,18,0,0,-1,1,0,-1,4,-1
KR_6729987781,420,3,86,57,9,1,1,2,3,2,5,2,0,2,2,4,6,1,0,1,1,8,29,3,-7,4,6,0,0,-1,1,1,1,1,-1
KR_6617240908,420,-6,-123,-7,-20,-2,2,0,-7,7,0,-2,2,0,-9,9,0,0,2,2,0,-22,-5,1,-1,0,-2,0,0,-1,-1,-1,-1,3,-1
KR_6762090765,420,-3,-91,0,-2,-5,6,1,1,1,2,-2,7,5,3,1,4,1,1,2,0,8,-8,3,-6,3,-6,0,0,-1,-1,0,-1,2,-1
KR_6727000664,420,-3,-106,10,-7,-11,12,1,2,0,2,-1,6,5,-1,1,0,4,0,4,0,6,0,1,-6,5,-2,0,-2,-1,-1,-1,-1,5,-1
KR_6759198835,420,-3,-89,-8,-3,-4,4,0,3,0,3,0,1,1,-5,7,2,3,0,3,0,-2,-1,5,-10,5,1,0,0,-1,1,0,-1,6,-1
KR_6620470161,420,-3,-42,-40,-1,2,0,2,-4,5,1,-1,1,0,1,1,2,1,3,4,0,-2,12,6,-6,0,-1,0,0,-1,1,1,1,4,-1
KR_6629783611,420,0,1,6,0,0,3,3,3,3,6,-3,6,3,-1,2,1,1,0,1,0,-5,17,1,-5,4,-3,0,-1,-1,1,-1,-1,2,-1
KR_6756973689,440,-1,-73,-8,-1,0,0,0,-2,5,3,0,4,4,0,4,4,1,0,1,-1,5,2,-1,-5,6,0,0,0,-1,1,0,-1,5,-1
KR_6747305915,420,-2,-29,-8,-3,-3,4,1,-1,1,0,1,2,3,-1,4,3,1,3,4,0,-1,-7,0,-5,5,-3,0,-1,-1,0,-1,-1,4,-1
KR_6672920816,420,1,15,-26,0,0,1,1,-4,7,3,5,1,6,0,1,1,-1,2,1,0,-5,258,-1,-2,3,3,0,1,0,1,1,1,0,-1
KR_6728647303,420,-1,-109,-12,-3,-4,5,1,0,2,2,2,4,6,-2,3,1,1,0,1,-1,6,6,0,-4,4,-1,0,-2,1,-1,-1,-1,1,-1
KR_6762064828,420,-2,-22,7,-11,-6,8,2,-1,2,1,-6,6,0,1,1,2,1,0,1,1,-9,-8,-3,0,3,-1,0,-2,-1,-1,-1,1,2,-1
KR_6741182361,440,-3,-49,-17,-9,-6,7,1,0,1,1,-2,4,2,2,2,4,-3,3,0,-1,-9,-5,1,-2,1,0,0,-3,-1,-1,-1,-1,4,-1
KR_6749169826,420,-3,-24,-13,-3,3,1,4,-6,7,1,-1,2,1,2,0,2,-1,1,0,0,-7,-20,3,-6,3,-1,0,0,-1,-1,1,1,2,-1
KR_6726888733,440,1,25,-4,-3,0,2,2,-2,3,1,1,2,3,-1,1,0,-1,1,0,0,2,-11,-4,0,4,1,0,0,0,-1,0,-1,0,-1
KR_6707812428,420,-4,-16,-24,-8,-2,2,0,-2,5,3,-3,3,0,0,4,4,-1,3,2,0,-2,11,-1,-4,5,-2,0,1,-1,1,1,1,2,-1
KR_6757315261,440,1,-16,7,-6,-2,3,1,1,0,1,-2,6,4,-3,7,4,0,1,1,0,-12,-6,1,-4,3,-1,0,0,-1,-1,1,1,1,-1
KR_6763622115,420,-3,-69,-24,0,1,1,2,-1,1,0,-2,5,3,7,0,7,-5,5,0,0,-2,-41,3,-8,5,30,0,0,1,-1,-1,1,1,-1
KR_6639554795,420,-2,-14,17,-7,-3,4,1,2,0,2,0,1,1,-1,3,2,-5,5,0,0,-5,-4,-4,-2,6,3,0,0,-1,-1,0,-1,1,-1
KR_6750786064,420,-3,6,0,-7,-2,3,1,6,1,7,-8,9,1,-4,5,1,1,0,1,0,-2,-111,-2,-2,4,2,0,-3,1,0,-1,1,1,-1
KR_6603691723,420,-3,-111,0,-8,-3,3,0,-3,4,1,4,1,5,-5,5,0,-1,2,1,0,-15,-4,1,-6,5,-2,0,-3,1,-1,-1,-1,5,-1
KR_6762665878,420,-2,-3,-34,-4,1,1,2,0,0,0,3,3,6,-9,9,0,1,1,2,0,-8,-17,-1,-3,4,4,0,-1,0,-1,-1,-1,0,-1
KR_6683021080,420,-3,-29,7,-8,-4,5,1,-2,3,1,-1,1,0,0,1,1,-1,1,0,0,-4,-5,3,-5,2,0,0,-1,1,-1,-1,-1,6,-1
KR_6761997828,420,-10,-126,-23,-28,-5,5,0,-2,3,1,-4,6,2,-9,10,1,-8,9,1,0,-22,-13,-5,-1,6,-5,0,-4,-1,-1,-1,-1,4,-1
KR_6103491158,420,-6,6,-35,-12,-1,1,0,-4,6,2,-3,3,0,-5,6,1,1,0,1,0,-10,3,2,-6,4,-1,0,0,1,-1,0,1,5,-1
KR_6734077803,440,2,47,-8,-2,3,1,4,-2,5,3,2,2,4,-2,2,0,-3,4,1,0,-9,-11,1,-5,4,4,0,2,1,-1,1,-1,4,-1
KR_6745712120,420,-1,-35,-5,-7,-2,3,1,1,2,3,0,4,4,-6,7,1,0,0,0,-2,-15,-12,3,-7,4,-2,0,-1,-1,0,-1,-1,2,-1
KR_6739240266,420,0,-20,-5,10,-1,5,4,6,2,8,-1,2,1,7,2,9,-1,2,1,-1,22,4,0,-6,6,0,0,1,1,-1,1,-1,6,-1
KR_6763393660,440,0,50,22,-1,2,0,2,-4,4,0,0,0,0,1,1,2,0,0,0,0,-5,-11,-4,0,4,1,0,0,1,0,0,-1,2,-1
KR_6720648356,420,-2,-58,4,-6,-2,3,1,-3,3,0,-1,2,1,1,0,1,-1,1,0,0,-5,5,1,-6,5,-4,0,-2,-1,-1,-1,-1,5,-1
KR_6759972844,440,-2,-100,-12,-7,-2,4,2,-4,6,2,0,4,4,0,4,4,-1,1,0,0,0,3,5,-10,5,-1,0,0,-1,0,-1,-1,2,-1
KR_6487545446,420,-3,-77,-36,-10,-2,2,0,-4,4,0,-1,4,3,-2,4,2,-1,1,0,0,-9,4,-5,-4,9,-7,0,-1,-1,-1,-1,-1,6,-1
KR_6757534049,420,-3,-31,0,-5,-7,7,0,-4,4,0,6,1,7,1,1,2,-1,3,2,-1,6,5,3,-6,3,-3,0,0,1,-1,1,-1,4,-1
KR_6644766413,420,-4,-11,-20,-12,-1,1,0,-5,6,1,2,0,2,-3,4,1,-5,5,0,0,-8,5,2,-4,2,-3,0,-2,0,-1,-1,-1,0,-1
KR_6761689300,440,-4,-32,-7,-6,-3,3,0,0,1,1,0,3,3,-1,4,3,-2,3,1,0,-3,6,4,-7,3,-1,0,0,-1,0,0,-1,1,-1
KR_6724012393,420,0,36,13,-1,1,4,5,1,0,1,5,2,7,-2,7,5,-6,6,0,0,0,-143,1,-2,1,-14,0,-1,-1,1,1,1,6,-1
KR_6744557649,420,0,-13,-13,1,0,2,2,3,1,4,-1,4,3,0,2,2,-1,4,3,-1,4,-102,1,-6,5,0,0,1,-1,0,1,-1,3,-1
KR_6662162275,420,-3,-88,-23,-5,0,1,1,-3,3,0,0,1,1,-2,3,1,0,1,1,0,-4,-12,-2,-3,5,0,0,0,-1,-1,-1,-1,5,-1
KR_6610311285,420,-2,-73,8,-2,-1,2,1,-1,2,1,3,1,4,0,2,2,-3,3,0,0,-2,-436,-4,-2,6,0,0,0,-1,1,0,-1,5,-1
KR_6644486223,420,1,106,37,-3,1,0,1,-3,6,3,-2,7,5,0,2,2,1,0,1,0,-7,0,-3,-3,6,2,0,0,1,-1,0,-1,3,-1
KR_6735185930,440,-2,-53,18,-2,-2,2,0,0,4,4,0,2,2,0,2,2,0,1,1,-1,-2,-16,1,-4,3,-3,0,0,1,0,-1,-1,5,-1
KR_6751500147,420,-1,-54,4,1,-4,7,3,0,1,1,4,1,5,-1,2,1,2,0,2,0,2,-67,-3,-3,6,4,0,0,-1,1,1,-1,3,-1
KR_6614201396,420,0,-17,12,2,-6,6,0,-2,6,4,4,0,4,0,2,2,6,0,6,0,1,12,7,-9,2,0,0,-1,1,-1,-1,-1,2,-1
KR_6559781122,420,-1,53,-10,-1,4,2,6,-3,6,3,-4,4,0,5,0,5,-3,3,0,0,-7,283,-2,-4,6,9,0,-1,1,1,-1,-1,5,-1
KR_6761530811,440,4,53,-9,13,-1,8,7,1,3,4,6,1,7,4,1,5,3,3,6,-1,2,130,0,-4,4,1,0,3,-1,0,1,-1,5,-1
KR_6614153223,420,2,17,28,5,1,1,2,6,0,6,2,4,6,0,2,2,-4,4,0,0,-3,1,-1,-4,5,-2,0,1,1,1,1,-1,5,-1
KR_6718238290,420,-2,-30,-28,7,-3,4,1,0,2,2,9,1,10,1,2,3,0,3,3,0,17,-3,-3,-2,5,1,0,-2,0,-1,-1,1,0,-1
KR_6745028579,420,-1,-23,0,0,-1,2,1,0,0,0,-1,4,3,2,1,3,0,1,1,0,4,195,1,-2,1,18,0,0,-1,-1,-1,-1,6,-1
KR_6754326199,440,2,0,5,4,0,0,0,0,4,4,0,2,2,3,1,4,1,2,3,0,4,1,4,-5,1,-6,0,0,1,-1,0,-1,3,-1
KR_6728427261,420,6,25,21,3,2,2,4,4,1,5,0,2,2,-3,3,0,0,0,0,0,2,1,1,-4,3,-2,0,0,-1,1,1,1,1,-1
KR_6672289131,420,3,22,-23,5,-3,4,1,1,3,4,5,1,6,1,0,1,1,0,1,0,3,-8,-2,-2,4,-1,0,-1,0,0,-1,-1,0,-1
KR_6681555994,420,-5,45,-32,-15,-4,6,2,-8,8,0,-1,5,4,-3,4,1,1,0,1,0,-14,-18,-2,-1,3,0,0,-1,1,0,-1,-1,5,-1
KR_6743539241,420,-1,-29,8,-2,5,1,6,-1,1,0,0,3,3,-1,1,0,-5,7,2,-1,-13,-15,0,-5,5,0,0,0,-1,1,-1,-1,4,-1
KR_6761633135,420,0,-6,6,0,2,1,3,3,2,5,2,1,3,-7,7,0,0,1,1,0,-4,-1,-1,-2,3,2,0,-1,-1,-1,-1,1,6,-1
KR_6761747481,420,1,13,5,2,2,1,3,-2,4,2,-1,2,1,0,2,2,3,1,4,0,1,-34,0,-6,6,3,0,0,1,-1,-1,-1,6,-1
KR_6616799011,420,-5,-104,-28,-15,-1,4,3,-1,4,3,-12,14,2,-1,2,1,0,1,1,-5,-17,2,1,-3,2,-1,0,-5,-1,-1,-1,-1,3,-1
KR_6752820340,420,2,2,24,1,2,2,4,-1,3,2,-1,3,2,1,1,2,0,0,0,0,-1,-57,0,-1,1,-4,0,2,1,1,1,1,6,-1
KR_6761087622,420,-4,-37,-4,-17,-5,5,0,1,2,3,-10,14,4,-4,6,2,1,1,2,-1,-22,123,1,-4,3,1,0,-1,0,-1,-1,-1,0,-1
KR_6673874510,420,0,-21,2,-2,-1,2,1,0,5,5,-2,4,2,-2,4,2,3,3,6,0,5,-18,0,-2,2,29,0,-1,-1,-1,-1,-1,3,-1
KR_6753900851,420,4,-21,12,4,1,0,1,0,3,3,-2,2,0,4,2,6,1,1,2,-1,3,14,4,-7,3,-1,0,1,1,1,1,-1,2,-1
KR_6665520526,440,-3,-27,-53,1,2,3,5,2,3,5,-2,3,1,0,0,0,-1,1,0,0,1,120,-2,-1,3,1,0,-1,-1,-1,-1,1,4,-1
KR_6721615170,420,-3,-2,14,-4,2,0,2,-2,2,0,-3,5,2,-2,2,0,1,0,1,-1,-7,-21,2,-5,3,0,0,0,-1,-1,0,-1,2,-1
KR_6726853643,420,-7,-30,-4,-16,-5,6,1,-6,6,0,2,0,2,-4,4,0,-3,3,0,0,-11,-9,-1,-4,5,-2,0,-2,1,0,-1,-1,6,-1
KR_5831809148,420,-2,-27,-16,2,1,1,2,-3,4,1,-2,4,2,3,1,4,3,0,3,0,5,89,2,-6,4,-2,0,0,-1,1,1,-1,4,-1
KR_6761237202,440,3,75,18,4,-5,7,2,-1,3,2,4,0,4,4,0,4,2,0,2,-1,4,13,1,-1,0,2,0,0,1,0,1,-1,5,-1
KR_6725571276,420,-5,-134,0,-14,-9,9,0,-3,5,2,-2,2,0,-3,7,4,3,1,4,0,0,-24,-1,-4,5,-3,0,-2,1,-1,-1,-1,4,-1
KR_6764409288,420,-1,-21,-8,-7,-3,5,2,2,2,4,0,4,4,-2,5,3,-4,5,1,0,-6,0,-3,0,3,-1,0,0,0,0,0,1,0,-1
KR_6738960140,420,0,53,-10,6,4,0,4,-2,4,2,1,2,3,3,1,4,0,0,0,0,3,4,0,-2,2,-1,0,0,-1,1,0,1,4,-1
KR_6739427023,420,0,-22,20,-1,0,3,3,0,3,3,-5,6,1,4,2,6,0,0,0,0,7,-50,4,-5,1,21,0,-1,-1,-1,-1,-1,1,-1
KR_6731527723,420,-3,-82,-22,-1,-3,4,1,2,2,4,3,2,5,-3,4,1,0,1,1,-1,5,59,2,-6,4,-1,0,0,-1,-1,-1,-1,5,-1
KR_6684723867,440,-2,-9,16,-5,-4,4,0,-5,6,1,-4,5,1,8,1,9,0,1,1,-1,-7,6,2,-5,3,-1,0,-2,1,-1,-1,-1,5,-1
KR_6756490897,420,-1,13,-16,-2,-2,4,2,-2,3,1,1,0,1,0,3,3,1,2,3,0,1,-3,-4,-1,5,2,0,0,-1,-1,-1,-1,5,-1
KR_6573075077,420,-1,-30,-3,-4,3,1,4,-2,3,1,-4,6,2,-1,5,4,0,0,0,-3,-11,0,1,-3,2,3,0,-2,-1,1,-1,-1,4,-1
KR_6754894890,420,0,-5,-16,6,2,0,2,0,3,3,1,0,1,1,2,3,2,0,2,0,8,-392,-4,-3,7,29,0,0,-1,-1,0,1,2,-1
KR_6665276037,420,1,-31,15,-3,-1,1,0,2,2,4,1,2,3,-3,5,2,-2,3,1,0,-15,6,-4,-2,6,-3,0,1,-1,1,1,-1,3,-1
KR_6760854894,420,-1,-46,-1,-7,-1,1,0,-5,8,3,-6,7,1,3,2,5,2,2,4,0,5,9,-3,0,3,-4,0,-1,0,-1,-1,1,0,-1
KR_6763780632,420,1,31,2,3,1,1,2,-3,4,1,6,2,8,0,1,1,-1,1,0,0,-1,-5,-1,-5,6,0,0,1,1,0,1,-1,2,-1
KR_6662014895,420,-3,14,19,-7,-2,3,1,-2,4,2,-2,3,1,0,2,2,-1,2,1,1,-4,105,2,-4,2,1,0,1,-1,1,1,1,6,-1
KR_6764323698,420,-3,16,-12,-6,-4,5,1,0,2,2,-2,3,1,1,4,5,-1,1,0,1,0,2,0,-3,3,0,0,-2,-1,-1,-1,1,4,-1
KR_6753717493,420,-5,-57,-30,-13,-2,6,4,-7,9,2,-2,4,2,-3,3,0,1,1,2,0,-12,-3,0,-1,1,-6,0,0,0,-1,0,-1,0,-1
KR_6743652662,420,-3,-66,15,1,-3,4,1,1,2,3,3,2,5,1,3,4,-1,4,3,0,6,-1,-2,-7,9,3,0,0,1,1,1,-1,6,-1
KR_6751899021,440,-4,-16,-36,-12,-4,7,3,-7,8,1,0,4,4,-2,2,0,1,0,1,-1,-3,3,-2,-1,3,0,0,-3,-1,-1,-1,-1,6,-1
KR_6756893600,440,0,-1,12,-8,-10,11,1,1,1,2,3,1,4,0,3,3,-2,2,0,0,-15,-7,2,-6,4,1,0,-1,0,-1,-1,1,0,-1
KR_6621829534,420,1,-21,20,-7,0,3,3,0,3,3,0,1,1,-2,6,4,-5,5,0,-2,-10,-5,-2,-4,6,-1,0,-1,-1,-1,1,-1,2,-1
KR_6646662142,420,-4,-157,9,-15,-1,2,1,0,1,1,-8,9,1,-6,10,4,0,0,0,0,-14,36,-2,-2,4,-24,0,-1,-1,0,-1,-1,3,-1
KR_6724149681,420,0,-41,-13,-2,-4,6,2,1,1,2,2,2,4,-4,6,2,3,0,3,0,4,-7,-3,-3,6,3,0,-1,1,0,-1,-1,4,-1
KR_6741377380,440,-1,7,0,-5,0,2,2,-2,4,2,-1,2,1,4,1,5,-6,6,0,-3,-9,-1,-1,-5,6,1,0,-1,-1,1,-1,-1,1,-1
KR_6752560494,420,-4,-54,-22,-6,2,0,2,0,3,3,-2,3,1,-5,6,1,-1,2,1,2,-11,-18,0,-6,6,-3,0,-3,-1,-1,-1,1,6,-1
KR_6659589621,420,1,37,-6,-2,2,2,4,0,3,3,-2,4,2,-2,3,1,0,3,3,0,-1,6,1,-5,4,-8,0,1,-1,1,1,1,3,-1
KR_6734339599,440,-3,-134,-33,-4,0,0,0,-4,4,0,1,2,3,1,0,1,-2,8,6,0,4,8,-2,0,2,-2,0,-2,-1,-1,-1,-1,1,-1
KR_6751047234,440,0,23,-20,-7,0,3,3,1,3,4,-2,4,2,-6,7,1,0,1,1,-2,-17,-9,-5,-2,7,3,0,1,-1,1,-1,-1,6,-1
KR_6752513998,420,-3,-48,21,-7,2,0,2,-2,3,1,-2,3,1,-5,5,0,0,0,0,-1,-11,0,-4,-3,7,-2,0,-1,0,-1,-1,-1,0,-1
KR_6756030040,420,0,-58,4,-3,-1,1,0,0,5,5,-6,6,0,3,2,5,1,0,1,0,-8,-3,-2,-5,7,4,0,0,-1,-1,0,1,4,-1
KR_6727077339,420,-2,-8,1,-5,-2,2,0,-1,4,3,1,1,2,-3,4,1,0,1,1,0,0,7,2,-5,3,-5,0,-1,-1,-1,-1,-1,6,-1
KR_6750952404,420,3,75,-2,7,1,3,4,3,2,5,5,1,6,-2,4,2,0,0,0,1,-2,241,-5,-1,6,-1,0,3,1,1,1,1,1,-1
KR_6653810377,420,1,-58,-8,-4,-1,2,1,1,2,3,2,1,3,-5,5,0,-1,1,0,0,-4,172,-6,-1,7,-1,0,0,-1,0,-1,-1,5,-1
KR_6694667933,440,-9,-19,-20,-16,-5,6,1,-4,4,0,-3,3,0,0,1,1,-4,4,0,0,-21,1,-4,-2,6,-6,0,-2,-1,-1,-1,1,2,-1
KR_6721653232,420,-4,-82,14,-14,-7,9,2,2,0,2,-5,6,1,-2,2,0,-2,2,0,0,-1,-2,-2,-4,6,0,0,-2,-1,-1,-1,-1,4,-1
KR_6760782567,420,-1,-36,8,2,-5,7,2,2,2,4,1,1,2,2,3,5,2,0,2,2,14,-7,1,-3,2,0,0,-2,1,-1,-1,1,1,-1
KR_6569735061,440,-5,-94,-20,-7,-5,6,1,-3,3,0,-2,6,4,3,0,3,0,2,2,0,1,-4,1,-3,2,-2,0,-3,-1,-1,-1,1,3,-1
KR_6742153857,420,6,56,-10,10,8,1,9,0,3,3,0,2,2,3,3,6,-1,2,1,1,5,2,2,-4,2,0,0,1,0,1,1,1,0,-1
KR_6758929348,420,-3,-5,-34,-5,5,1,6,-4,5,1,-2,4,2,-3,5,2,-1,1,0,0,-8,-8,1,-4,3,0,0,0,-1,-1,0,-1,6,-1
KR_6699748787,440,-4,-42,-12,-11,-4,4,0,-2,3,1,-3,3,0,0,1,1,-2,2,0,0,-13,3,3,-7,4,1,0,-1,1,-1,-1,-1,6,-1
KR_6705559126,420,-6,-84,-16,-12,-2,3,1,-2,6,4,-3,5,2,-7,7,0,2,0,2,0,-7,-1,-5,-4,9,-1,0,-1,0,-1,-1,-1,0,-1
KR_6747213560,420,-10,-55,-29,-16,-6,6,0,-5,5,0,1,3,4,-7,8,1,1,0,1,0,-9,-41,0,-5,5,10,0,-1,-1,0,-1,-1,3,-1
KR_6753031476,420,2,26,20,2,2,0,2,-2,4,2,2,1,3,-1,3,2,1,0,1,0,2,20,2,-6,4,-2,0,0,-1,1,0,-1,4,-1
KR_6732503579,420,-6,-63,-28,-9,-1,1,0,-2,4,2,-2,2,0,-2,4,2,-2,2,0,0,-12,28,1,-3,2,-2,0,-2,-1,1,-1,-1,4,-1
KR_6598347135,420,1,13,-24,-4,2,1,3,-6,6,0,0,0,0,1,3,4,-1,1,0,0,-9,-9,-4,-3,7,3,0,0,-1,1,-1,-1,3,-1
KR_6672210234,440,-7,-54,16,-23,0,5,5,-6,7,1,-13,13,0,-3,4,1,-1,1,0,0,-15,-17,-2,-1,3,0,0,-4,-1,-1,-1,-1,4,-1
KR_6751809894,420,0,-29,4,-4,-2,3,1,5,1,6,-3,6,3,-3,4,1,-1,2,1,0,-5,-130,-2,-4,6,0,0,-3,-1,-1,-1,-1,2,-1
KR_6755286431,420,-5,-43,-44,-10,-3,4,1,-3,5,2,0,3,3,-4,5,1,0,1,1,-1,-4,-5,-2,-3,5,-2,0,-2,-1,1,-1,-1,2,-1
KR_6674238950,420,1,44,4,-1,1,1,2,0,2,2,-1,6,5,0,2,2,-1,1,0,-1,2,4,0,-4,4,-1,0,0,0,1,0,-1,0,-1
KR_6732161558,420,-5,-45,-32,-5,-4,4,0,-5,6,1,-2,3,1,6,2,8,0,2,2,-1,0,-289,-4,-1,5,1,0,1,-1,-1,1,-1,2,-1
KR_6684170288,420,-3,21,-12,-11,-2,5,3,-11,11,0,1,1,2,2,1,3,-1,2,1,0,-9,-15,-3,-4,7,3,0,0,-1,1,0,-1,1,-1
KR_6514095438,420,-1,-96,-8,-2,-7,11,4,-2,3,1,7,0,7,-1,4,3,1,1,2,-1,1,2,1,-2,1,2,0,-2,-1,-1,-1,-1,1,-1
KR_6758365387,420,-1,-24,-1,2,0,1,1,-2,4,2,0,1,1,1,2,3,3,0,3,1,6,101,3,-5,2,-2,0,-1,0,1,1,1,0,-1
KR_6748936790,420,0,-26,-12,-2,2,3,5,-1,1,0,0,1,1,-3,3,0,0,0,0,0,-6,-22,1,-4,3,3,0,0,1,1,0,-1,4,-1
KR_6705061325,420,0,-22,-41,5,2,1,3,-1,4,3,-2,4,2,4,3,7,2,0,2,1,15,8,2,-4,2,-4,0,1,0,0,1,1,0,-1
KR_6750750139,420,-3,-8,9,-9,-2,5,3,-3,8,5,-7,9,2,-2,4,2,5,0,5,-1,-3,-341,-1,0,1,2,0,-1,-1,-1,-1,-1,1,-1
KR_6723776513,420,-2,19,-26,-2,-3,3,0,-1,3,2,2,4,6,-1,3,2,1,3,4,0,2,5,-3,-1,4,-2,0,0,-1,1,0,-1,2,-1
KR_6703229643,420,-1,-86,-4,-2,-5,7,2,-1,4,3,4,1,5,1,1,2,-1,2,1,0,1,6,0,-5,5,-4,0,-2,1,-1,-1,-1,3,-1
KR_6752180969,420,-2,-43,-12,-7,-3,4,1,2,2,4,-8,8,0,2,0,2,0,3,3,0,-3,3,2,-3,1,-3,0,-1,1,-1,-1,-1,1,-1
KR_6743641868,420,-3,-89,-28,-4,-3,4,1,1,2,3,-1,4,3,0,1,1,-1,2,1,-1,-6,-1,2,-5,3,-1,0,0,-1,1,0,-1,6,-1
KR_6732782276,440,-6,-39,-35,-15,-3,4,1,-6,8,2,-5,8,3,2,4,6,-3,3,0,0,-16,10,4,-5,1,-2,0,-2,0,-1,-1,1,0,-1
KR_6730494601,420,-3,11,-39,-5,-3,3,0,-2,4,2,-2,3,1,0,3,3,2,1,3,0,-4,0,-1,-2,3,-1,0,-1,0,-1,-1,-1,0,-1
KR_6748823272,440,-9,-84,-36,-21,2,0,2,-11,13,2,-4,5,1,-8,8,0,0,1,1,1,-24,-45,-2,-3,5,-1,0,-2,0,-1,-1,1,0,-1
KR_5568744114,420,-4,-19,24,-4,-1,2,1,3,0,3,-1,2,1,-4,5,1,-1,1,0,0,-4,0,0,-6,6,0,0,1,1,1,1,-1,4,-1
KR_6518681502,440,-5,-119,3,-7,-6,6,0,-3,4,1,2,0,2,0,0,0,0,1,1,-1,-12,-10,0,-4,4,-6,0,-1,-1,0,-1,-1,2,-1
KR_6735103357,420,-3,-67,-17,-9,-2,4,2,-1,5,4,0,3,3,-2,3,1,-4,5,1,0,-4,23,0,-3,3,-2,0,-2,1,-1,-1,-1,5,-1
KR_6604714997,420,-4,-47,-29,-4,-3,4,1,-3,6,3,-2,5,3,2,2,4,2,0,2,0,2,8,2,-3,1,-3,0,-1,-1,-1,-1,1,2,-1
KR_6753284219,420,-4,-31,-48,-11,2,1,3,-1,2,1,-2,2,0,-9,9,0,-1,1,0,1,-15,21,1,-5,4,-5,0,-2,-1,-1,1,1,5,-1
KR_6733534837,440,1,4,12,1,2,0,2,0,3,3,-3,5,2,-1,3,2,3,3,6,0,2,0,-1,-3,4,-3,0,0,0,-1,0,-1,0,-1
KR_6764212002,420,-3,26,0,-10,0,2,2,-3,5,2,-1,3,2,-6,7,1,0,1,1,0,-14,8,2,-5,3,-7,0,-1,0,1,-1,-1,0,-1
KR_6749158335,440,2,16,28,3,1,0,1,8,0,8,-2,5,3,-5,6,1,1,1,2,0,0,-66,1,-3,2,0,0,1,-1,1,1,-1,5,-1
KR_6681046210,440,-2,-45,4,-7,-2,3,1,-3,3,0,0,2,2,-3,3,0,1,1,2,0,-8,-12,-3,-2,5,6,0,-1,-1,-1,-1,1,5,-1
KR_6759826327,440,2,-4,-31,3,-1,1,0,-1,4,3,1,1,2,4,0,4,0,1,1,0,5,7,1,-5,4,0,0,1,-1,0,-1,-1,5,-1
KR_6716712550,420,-2,36,-21,-7,0,1,1,2,2,4,-6,8,2,-3,4,1,0,0,0,0,-4,33,1,-2,1,-34,0,0,-1,-1,-1,-1,4,-1
KR_6750690174,420,-3,-10,16,-2,-5,5,0,5,0,5,1,1,2,0,3,3,-3,6,3,-1,-1,7,5,-5,0,-3,0,0,1,0,0,-1,5,-1
KR_6572852492,420,-1,-44,-2,-1,-1,2,1,1,5,6,-1,5,4,-1,2,1,1,0,1,-3,8,4,2,-6,4,-3,0,-1,0,-1,-1,-1,0,-1
KR_6743193574,420,0,-34,24,0,0,2,2,-3,4,1,2,1,3,1,3,4,0,1,1,0,7,7,2,-4,2,2,0,0,1,1,-1,-1,4,-1
KR_6717953599,420,-1,35,-10,3,1,1,2,4,0,4,-1,3,2,-1,4,3,0,0,0,0,1,-1,-1,-1,2,3,0,0,-1,1,1,1,5,-1
KR_6758806879,440,-8,-90,-18,-18,-2,3,1,-3,4,1,-11,11,0,-3,8,5,1,0,1,0,-11,2,-7,-3,10,2,0,-3,-1,1,-1,-1,2,-1
KR_6708333147,420,1,13,2,0,1,0,1,-2,5,3,0,3,3,-1,2,1,2,2,4,0,-4,6,2,-6,4,1,0,0,1,1,1,-1,2,-1
KR_6667659244,420,-3,-31,-16,-14,-7,8,1,-5,7,2,-1,3,2,0,2,2,-1,1,0,0,-7,-40,-4,-3,7,21,0,-3,-1,-1,-1,-1,1,-1
KR_6584338920,420,0,-50,-11,-4,-3,3,0,-2,2,0,3,3,6,-5,7,2,3,1,4,1,-8,-6,-6,-5,11,-3,0,-1,-1,-1,-1,1,2,-1
KR_6741475861,440,1,28,20,-3,-5,7,2,-6,6,0,2,0,2,-1,3,2,7,0,7,0,3,2,-3,-5,8,4,0,-2,1,0,-1,1,6,-1
KR_6750214997,420,0,-24,16,-2,-4,5,1,1,1,2,2,3,5,-2,4,2,1,1,2,0,-3,8,-1,-4,5,-1,0,0,-1,0,0,-1,6,-1
KR_6747547912,420,-1,-17,-12,-1,-6,6,0,1,3,4,1,2,3,-1,2,1,4,1,5,0,-1,25,4,-6,2,-2,0,0,-1,0,1,1,6,-1
KR_6734843956,420,-5,-69,16,-15,-2,3,1,-2,3,1,-8,8,0,-1,4,3,-2,3,1,0,-11,-3,-3,-1,4,0,0,-1,1,-1,-1,-1,6,-1
KR_6728767684,420,-2,-53,8,-15,-1,1,0,1,1,2,-1,3,2,-10,10,0,-4,4,0,0,-21,197,0,-5,5,-3,0,-1,1,1,-1,-1,4,-1
KR_6760195595,420,-2,-40,-2,1,-3,3,0,-5,5,0,3,0,3,6,1,7,0,0,0,0,7,4,1,-6,5,2,0,0,-1,-1,0,-1,2,-1
KR_6755115418,420,-5,-51,-16,-9,-9,9,0,0,2,2,1,2,3,-1,3,2,0,1,1,0,-4,2,3,-7,4,-2,0,0,-1,-1,-1,-1,3,-1
KR_6712075134,420,-1,-17,27,-1,-1,2,1,4,2,6,1,0,1,-3,6,3,-2,2,0,-1,2,230,0,-4,4,-1,0,-2,1,-1,-1,-1,3,-1
KR_6736169420,420,-3,-22,-16,-8,1,1,2,-3,4,1,-3,3,0,-1,4,3,-2,2,0,0,-8,-21,-3,-3,6,0,0,-1,0,-1,1,-1,0,-1
KR_6570336914,420,-3,-43,1,-7,-6,7,1,0,2,2,0,3,3,-1,1,0,0,1,1,0,-3,15,-3,-2,5,1,0,-1,-1,-1,-1,1,5,-1
KR_6760490613,420,-1,-39,-10,2,2,2,4,0,1,1,3,3,6,-3,4,1,0,0,0,0,8,-2,-5,-2,7,-4,0,0,0,1,1,-1,0,-1
KR_6529663065,440,-6,-121,-27,-13,-9,10,1,-2,3,1,-2,2,0,0,1,1,0,0,0,0,-16,-39,-7,-5,12,-3,0,-1,1,-1,-1,-1,6,-1
KR_6761439063,440,-1,-34,2,3,2,0,2,-3,10,7,1,0,1,1,2,3,2,1,3,1,1,2,5,-8,3,2,0,-1,0,-1,-1,1,0,-1
KR_6744537120,420,-1,-55,4,-8,-3,5,2,1,2,3,-2,3,1,-1,4,3,-3,6,3,1,-2,-11,-2,-3,5,-1,0,-1,-1,-1,-1,1,1,-1
KR_6387815759,420,-3,-56,-36,-4,-1,2,1,1,0,1,-3,6,3,-1,1,0,0,0,0,0,-9,-129,1,-5,4,-2,0,-1,-1,-1,-1,-1,1,-1
KR_6759198659,440,-5,-139,-7,-11,1,3,4,-3,9,6,-7,7,0,-2,3,1,0,0,0,1,-10,-4,-3,0,3,3,0,-1,0,1,-1,1,0,-1
KR_6683821798,420,-4,-28,-28,-4,-4,5,1,1,1,2,3,0,3,-3,3,0,-1,1,0,0,4,-12,-9,-3,12,-2,0,-1,1,-1,-1,-1,6,-1
KR_6740027092,420,-1,-10,-16,-3,-2,3,1,2,1,3,-5,6,1,-1,6,5,3,0,3,0,-1,110,-1,-3,4,2,0,0,-1,-1,-1,-1,5,-1
KR_6725502045,420,-7,-102,-43,-11,-5,5,0,-2,2,0,-4,4,0,-1,3,2,1,1,2,0,-2,8,0,-5,5,-2,0,-3,-1,-1,-1,-1,5,-1
KR_6744790316,420,3,120,-39,12,2,1,3,3,1,4,3,1,4,3,1,4,1,2,3,0,-2,2,1,-6,5,5,0,1,1,1,1,1,2,-1
KR_6584025695,420,1,53,18,-2,1,3,4,-3,5,2,0,3,3,-2,2,0,2,0,2,0,-5,-5,-2,-3,5,0,0,0,1,-1,1,-1,1,-1
KR_6746756059,420,-2,-20,-22,-4,-2,4,2,-1,5,4,1,2,3,-3,4,1,1,1,2,0,-3,-6,2,-4,2,-3,0,0,0,-1,1,-1,0,-1
KR_6710891676,420,-5,-115,-32,-8,-1,3,2,-4,6,2,-1,2,1,-1,1,0,-1,1,0,0,-8,13,-5,-2,7,-8,0,-1,-1,1,-1,-1,3,-1
KR_6763938615,420,-1,-28,40,-4,-1,3,2,2,0,2,-4,5,1,1,3,4,-2,5,3,0,-2,26,0,-2,2,-1,0,0,1,0,0,-1,3,-1
KR_6685000329,420,4,37,16,12,1,1,2,2,3,5,4,0,4,2,3,5,3,0,3,0,17,5,1,-5,4,2,0,-1,1,-1,-1,-1,4,-1
KR_6667104649,420,0,-36,24,-4,-2,3,1,0,2,2,1,3,4,-2,3,1,-1,2,1,0,-9,29,0,-3,3,3,0,-1,1,1,-1,1,3,-1
KR_6627383678,420,-2,-41,9,-8,-1,1,0,-1,5,4,2,1,3,-8,8,0,0,1,1,0,-16,0,2,-5,3,-6,0,0,0,1,0,-1,0,-1
KR_6761879877,420,0,-39,-4,-1,-1,1,0,2,2,4,-1,3,2,1,1,2,-2,2,0,0,4,-3,0,-5,5,1,0,0,0,-1,0,1,0,-1
KR_6762008837,420,-5,-66,0,-8,1,2,3,4,2,6,-8,8,0,-6,6,0,1,0,1,0,-6,-288,-3,-1,4,1,0,-3,-1,-1,-1,-1,1,-1
KR_6736710282,420,-7,-81,4,-11,-6,6,0,1,1,2,-3,4,1,-2,3,1,-1,1,0,0,-9,-9,-4,-4,8,-5,0,-1,-1,1,-1,-1,1,-1
KR_6760668109,420,-1,-15,5,-4,0,1,1,-6,8,2,-1,2,1,-5,5,0,8,0,8,0,-5,-25,1,-2,1,21,0,0,1,0,0,-1,1,-1
KR_6753732992,420,-2,-51,-6,-7,-8,8,0,-1,6,5,2,1,3,-3,5,2,3,0,3,-2,-10,-50,0,-3,3,12,0,-1,1,-1,-1,-1,3,-1
KR_6760822005,420,-3,26,-19,-6,-2,4,2,2,0,2,-7,8,1,-1,4,3,2,1,3,-1,1,-4,-3,-2,5,3,0,-2,1,-1,-1,-1,3,-1
KR_6741233958,440,-8,-130,-31,-24,-6,9,3,-4,5,1,-4,5,1,0,1,1,-10,12,2,-1,-13,8,-3,-2,5,0,0,-3,-1,-1,-1,-1,6,-1
KR_6722576592,440,1,54,-15,-2,0,2,2,1,0,1,-2,3,1,-2,3,1,1,1,2,0,1,5,0,-2,2,2,0,2,-1,1,1,-1,3,-1
KR_6651339200,420,1,-45,-25,9,2,0,2,6,1,7,0,2,2,1,0,1,0,2,2,0,13,-9,0,-7,7,2,0,1,1,-1,1,1,5,-1
KR_6752430288,420,-4,-10,-20,-10,-1,2,1,-4,6,2,-3,6,3,-1,2,1,-1,1,0,0,-11,-2,-1,-6,7,11,0,-1,1,-1,-1,-1,4,-1
KR_6740395428,440,-2,-57,28,-7,-4,7,3,2,2,4,-3,3,0,-2,2,0,0,0,0,0,-3,16,0,-2,2,1,0,-2,-1,-1,-1,-1,4,-1
KR_6631702988,420,3,27,9,6,2,2,4,4,4,8,3,1,4,-1,1,0,-2,3,1,0,6,2,-5,-2,7,-4,0,1,-1,0,1,1,1,-1
KR_6676355117,420,-1,-54,-6,-4,-4,4,0,3,0,3,-3,3,0,1,3,4,-1,1,0,0,5,-3,-4,-2,6,-2,0,-2,1,-1,-1,-1,6,-1
KR_6680586844,420,4,79,76,-1,5,0,5,-2,2,0,-4,4,0,1,1,2,-1,1,0,0,-8,4,0,-4,4,5,0,1,1,1,1,1,1,-1
KR_6730165282,420,-7,-119,-32,-10,-3,4,1,-7,7,0,-1,1,0,3,0,3,-2,2,0,0,-9,30,-3,-5,8,-4,0,0,0,-1,-1,-1,0,-1
KR_6726990942,420,0,17,18,-3,1,0,1,0,1,1,1,1,2,-5,6,1,0,0,0,0,-2,-251,2,-6,4,-2,0,1,-1,1,1,-1,6,-1
KR_6654618726,420,-5,-97,-13,-9,-2,4,2,-3,7,4,0,1,1,-1,5,4,-3,4,1,0,-8,20,-2,-3,5,-6,0,-2,-1,-1,-1,-1,4,-1
KR_6718678817,420,-3,-52,4,-11,0,2,2,-4,5,1,-3,3,0,-1,5,4,-3,4,1,-2,-9,7,-1,-3,4,0,0,-1,-1,1,-1,-1,6,-1
KR_6733402664,440,-3,-15,-29,-2,0,2,2,-2,5,3,1,2,3,0,1,1,-1,1,0,0,-6,-8,3,-7,4,-5,0,0,-1,1,-1,1,6,-1
KR_6747301439,420,3,-13,26,7,-1,2,1,-2,3,1,1,3,4,9,0,9,0,2,2,0,5,-11,5,-7,2,-2,0,1,1,0,1,-1,4,-1
KR_6745011915,440,-6,-89,-8,-14,-4,5,1,3,1,4,-2,3,1,-7,8,1,-4,4,0,0,-10,1,-1,-3,4,-8,0,-2,1,1,-1,-1,2,-1
KR_6734809306,420,2,-42,11,1,0,1,1,3,2,5,3,1,4,-2,3,1,-3,6,3,-2,-3,7,3,-5,2,1,0,0,-1,1,1,-1,3,-1
KR_6748937167,420,-1,-1,13,-1,-3,5,2,-2,3,1,0,2,2,3,1,4,1,2,3,1,-2,-9,-1,-3,4,1,0,0,1,-1,1,1,5,-1
KR_6752111746,420,-1,-22,-4,0,0,2,2,0,2,2,3,0,3,-5,6,1,2,1,3,0,-3,-1,1,-3,2,-1,0,-1,-1,1,-1,-1,3,-1
KR_6739108860,420,0,-4,-19,5,2,1,3,0,3,3,4,2,6,0,2,2,-1,1,0,-1,4,10,0,-3,3,-2,0,0,-1,1,1,-1,2,-1
KR_6761241028,420,-4,-35,-27,-8,1,2,3,-13,13,0,3,0,3,1,1,2,0,0,0,1,-3,435,0,-6,6,0,0,-2,1,-1,-1,1,1,-1
KR_6712427486,420,-5,-6,-24,-11,1,1,2,-3,5,2,3,1,4,-8,10,2,-4,4,0,-2,-15,-4,-1,-4,5,4,0,-1,1,1,-1,-1,5,-1
KR_6744489841,440,1,-51,12,-8,1,1,2,0,3,3,-6,7,1,1,0,1,-4,6,2,0,-5,-5,1,-3,2,-1,0,0,0,1,0,-1,0,-1
KR_6720699996,420,-2,3,-8,4,0,1,1,3,1,4,2,2,4,-2,8,6,1,0,1,0,3,-2,-2,-5,7,-4,0,-1,-1,-1,-1,1,3,-1
KR_6757751362,420,1,-14,7,2,-1,2,1,0,3,3,5,1,6,-1,3,2,-1,2,1,0,2,3,5,-6,1,1,0,-1,-1,-1,-1,1,1,-1
KR_6602566882,420,3,-37,-8,2,1,0,1,2,5,7,-2,4,2,3,3,6,-2,2,0,0,4,6,6,-9,3,1,0,0,0,0,1,1,0,-1
KR_5890043032,420,-4,-19,-8,-10,1,2,3,-2,5,3,-10,10,0,2,1,3,-1,2,1,0,-15,-6,3,-7,4,2,0,1,-1,1,1,-1,5,-1
KR_6592259064,420,1,-32,-4,0,1,0,1,2,0,2,1,0,1,-2,3,1,-2,4,2,0,2,127,4,-10,6,3,0,0,1,1,0,-1,3,-1
KR_6756167400,420,-2,-40,13,-5,-2,3,1,-4,5,1,0,3,3,0,1,1,1,1,2,0,-4,-18,2,-6,4,2,0,0,-1,-1,-1,1,3,-1
KR_6741796787,420,0,-34,-8,1,3,1,4,-6,7,1,-5,5,0,6,1,7,3,0,3,0,3,1,0,-4,4,1,0,0,1,0,1,-1,5,-1
KR_6738579735,420,2,5,12,0,-3,5,2,4,0,4,1,2,3,-3,4,1,1,2,3,0,7,-47,0,-3,3,22,0,1,1,-1,1,-1,1,-1
KR_6687937982,420,-3,-43,32,-9,0,1,1,-1,5,4,-1,4,3,-5,5,0,-2,2,0,0,-11,4,0,-2,2,2,0,0,1,1,-1,1,1,-1
KR_6621141250,420,-4,-55,-9,-5,1,0,1,3,3,6,0,1,1,-9,9,0,0,2,2,0,-5,2,-1,-5,6,-3,0,-1,-1,-1,-1,-1,4,-1
KR_6733064534,420,-2,-51,0,-3,-1,3,2,-2,7,5,-1,2,1,0,1,1,1,0,1,0,2,-42,-1,-6,7,13,0,-1,1,1,-1,1,4,-1
KR_6705511936,440,-1,12,-8,-4,-2,2,0,0,3,3,-6,6,0,2,0,2,2,0,2,0,-10,-57,0,-6,6,1,0,-1,0,-1,-1,1,0,-1
KR_6668527784,420,-2,9,-32,-8,-3,3,0,-5,7,2,0,2,2,-2,3,1,2,0,2,0,-8,-7,4,-7,3,-1,0,-1,-1,-1,-1,1,2,-1
KR_6442264992,420,0,-47,-31,5,1,3,4,-3,4,1,4,1,5,2,2,4,1,0,1,1,4,23,4,-9,5,-5,0,-1,-1,0,-1,-1,6,-1
KR_6658878226,420,-2,-20,30,0,-1,3,2,1,2,3,4,2,6,-3,4,1,-1,2,1,0,0,-282,-2,-2,4,-1,0,0,1,1,0,1,2,-1
KR_6762411348,420,1,36,-3,-2,-2,4,2,0,3,3,-5,7,2,2,3,5,3,1,4,0,2,-3,-5,-2,7,1,0,0,0,-1,0,-1,0,-1
KR_5986939053,420,-10,-90,-45,-15,-2,3,1,-4,6,2,-7,7,0,-2,2,0,0,0,0,0,-12,-4,-2,-3,5,-3,0,-2,-1,-1,-1,1,3,-1
KR_6675531960,420,0,-39,8,-1,4,0,4,0,4,4,1,2,3,-4,5,1,-2,4,2,0,-3,-351,1,-5,4,1,0,0,-1,0,0,-1,6,-1
KR_6657354702,420,-6,-114,-28,-8,0,0,0,3,1,4,-7,7,0,-4,5,1,0,1,1,-1,2,2,2,-5,3,-3,0,-3,1,-1,-1,-1,2,-1
KR_6716762316,420,1,-67,8,0,-2,3,1,-3,5,2,2,0,2,3,2,5,0,1,1,-1,-1,-13,-10,-1,11,0,0,0,-1,-1,-1,-1,1,-1
KR_6710837335,440,-1,16,-14,-5,-2,4,2,-4,8,4,-2,4,2,-2,6,4,5,0,5,1,6,92,0,-3,3,1,0,1,-1,-1,1,-1,6,-1
KR_6727060134,420,-5,-161,-48,-13,-6,8,2,-4,4,0,-9,14,5,7,2,9,-1,1,0,0,4,-22,-3,-2,5,0,0,-4,-1,-1,-1,1,1,-1
KR_6762797827,420,-3,-94,-7,-7,0,2,2,0,0,0,-4,4,0,0,5,5,-3,3,0,0,-4,0,2,-9,7,4,0,-1,-1,1,1,-1,5,-1
KR_6725114813,440,3,45,-39,6,0,1,1,-3,6,3,5,5,10,4,1,5,0,0,0,0,11,1,3,-7,4,1,0,1,0,0,1,-1,0,-1
KR_6764258477,420,-5,-13,-56,-1,2,0,2,-3,3,0,0,2,2,0,0,0,0,0,0,0,-3,-21,5,-5,0,-2,0,-1,0,-1,-1,1,0,-1
KR_6760517011,420,-4,-23,0,-8,-5,5,0,-1,3,2,-1,2,1,-3,5,2,2,0,2,0,-9,-1,2,-7,5,-3,0,-1,0,0,-1,1,0,-1
KR_6558147391,420,1,-7,24,-5,-2,3,1,-2,3,1,0,1,1,-1,4,3,0,0,0,0,-1,19,1,-4,3,-1,0,2,-1,1,1,-1,3,-1
KR_6717860903,420,-5,-12,3,-4,-2,2,0,1,4,5,1,3,4,-4,4,0,0,1,1,0,-1,-12,-2,-5,7,2,0,0,1,1,0,1,6,-1
KR_6753742832,420,-4,-81,-16,-9,-3,4,1,0,2,2,-4,5,1,1,5,6,-3,4,1,0,-1,-4,-2,-3,5,0,0,0,-1,1,0,1,2,-1
KR_6704911317,420,2,-42,36,1,1,2,3,-2,7,5,-3,4,1,2,1,3,3,1,4,0,11,-5,-1,-4,5,-2,0,-2,0,0,-1,-1,0,-1
KR_6670740420,420,-3,-32,2,-8,0,3,3,-2,6,4,-5,6,1,-1,5,4,0,0,0,0,-20,-6,0,-2,2,0,0,0,-1,0,-1,-1,3,-1
KR_6758900053,420,0,30,-37,4,-3,4,1,4,0,4,5,1,6,1,1,2,-3,4,1,1,7,-1,0,-3,3,0,0,0,0,-1,1,1,0,-1
KR_6655433511,420,-2,-19,20,0,0,1,1,-3,5,2,-2,3,1,3,1,4,2,1,3,2,4,-4,-2,-1,3,-2,0,1,-1,1,1,1,6,-1
KR_6746070796,440,-1,2,13,6,8,1,9,-4,5,1,-3,3,0,3,2,5,2,2,4,1,10,-4,-1,-2,3,0,0,0,0,-1,1,1,0,-1
KR_6749453165,440,0,-18,-4,1,3,1,4,-2,5,3,2,2,4,-4,5,1,2,0,2,-1,-4,-16,2,-5,3,-3,0,0,-1,-1,0,-1,3,-1
KR_6728480520,440,-3,-10,-27,-8,2,0,2,1,3,4,-4,4,0,-4,6,2,-3,3,0,0,-12,23,1,-5,4,-21,0,-1,-1,0,-1,-1,3,-1
KR_6588635054,420,-8,-59,-18,-16,-7,7,0,-7,7,0,-2,4,2,0,0,0,0,1,1,0,-13,3,2,-6,4,-3,0,-2,-1,-1,-1,-1,4,-1
KR_6673434447,420,-1,-30,-6,-4,0,1,1,1,3,4,3,1,4,-6,7,1,-2,2,0,0,-8,-17,1,-6,5,2,0,0,-1,-1,0,1,1,-1
KR_6702314109,420,-2,-2,-27,-1,1,0,1,2,2,4,0,1,1,-1,3,2,-3,3,0,0,1,4,0,-4,4,1,0,0,-1,1,-1,-1,3,-1
KR_6763488777,420,-1,10,-12,0,6,0,6,-4,8,4,-3,4,1,1,2,3,0,1,1,0,6,-24,0,-2,2,2,0,0,1,-1,1,-1,4,-1
KR_6652369448,420,-3,-17,8,-15,-1,2,1,-4,4,0,0,2,2,-6,7,1,-4,4,0,0,-10,35,4,-6,2,-25,0,0,1,0,0,-1,5,-1
KR_6764418640,440,2,12,0,1,1,1,2,-2,5,3,1,2,3,0,1,1,1,0,1,0,5,0,1,-5,4,-1,0,0,-1,-1,0,1,5,-1
KR_6733735175,420,-2,-68,3,-3,1,0,1,-4,5,1,3,1,4,-1,3,2,-2,2,0,-1,-9,109,-1,-2,3,4,0,1,-1,1,1,-1,2,-1
KR_6743193439,420,-1,-16,20,-3,-3,3,0,-3,4,1,-2,2,0,3,4,7,2,1,3,0,-2,104,-7,-1,8,2,0,0,-1,1,1,1,5,-1
KR_6726150539,420,-2,-36,-30,-4,-1,3,2,-3,3,0,1,1,2,1,0,1,-2,2,0,0,-2,110,2,-4,2,2,0,0,0,-1,-1,-1,0,-1
KR_6762573076,420,-1,-7,-51,-7,-4,5,1,-3,5,2,-1,1,0,-2,5,3,3,1,4,0,-1,-11,3,-6,3,0,0,0,-1,-1,-1,-1,6,-1
KR_6742387867,420,-1,-21,-20,-5,-4,5,1,-3,5,2,-2,4,2,3,1,4,1,0,1,0,6,11,-4,-1,5,-6,0,-2,-1,-1,-1,-1,5,-1
KR_6764278610,420,-1,-37,16,-3,0,1,1,0,0,0,-3,4,1,0,1,1,0,2,2,0,-6,-1,-1,-3,4,-5,0,0,-1,-1,-1,1,6,-1
KR_6685408629,420,-3,-58,16,-1,-1,2,1,4,2,6,-2,2,0,1,1,2,-3,4,1,1,2,136,0,-4,4,-3,0,1,0,1,1,1,0,-1
KR_6740963677,420,-3,-51,-5,-1,0,2,2,2,0,2,-2,3,1,-1,1,0,0,0,0,0,-1,5,3,-7,4,-2,0,-1,1,0,-1,1,6,-1
KR_6764023787,420,0,-14,12,-2,0,3,3,3,1,4,-3,4,1,0,0,0,-2,2,0,0,-8,16,0,-3,3,3,0,0,-1,1,0,1,5,-1
KR_6718699366,420,-6,-114,-20,-12,-6,6,0,2,4,6,-4,5,1,-2,4,2,-2,3,1,1,-5,-10,-1,-3,4,2,0,-2,-1,-1,-1,1,6,-1
KR_6760492354,420,-2,7,-14,4,3,1,4,1,3,4,-1,2,1,1,3,4,0,1,1,0,4,3,1,-4,3,7,0,0,-1,1,0,1,3,-1
KR_6733081632,420,-3,-53,-20,-9,0,2,2,-2,3,1,-2,2,0,0,1,1,-5,5,0,-1,-9,-2,0,-2,2,-2,0,0,1,1,0,-1,3,-1
KR_6704355578,420,-7,-74,-32,-14,0,1,1,-4,4,0,-2,3,1,-2,2,0,-6,7,1,0,-11,113,2,-8,6,-4,0,0,-1,-1,-1,-1,3,-1
KR_6732291745,440,-1,-57,4,-7,-2,3,1,-7,9,2,1,1,2,0,1,1,1,0,1,0,-8,-10,-1,-6,7,2,0,-2,-1,-1,-1,-1,1,-1
KR_6651294096,420,1,14,-8,0,-1,2,1,1,0,1,-2,3,1,1,0,1,1,1,2,0,-3,0,-1,-4,5,4,0,0,1,-1,0,1,3,-1
KR_6761589139,420,1,-17,8,6,-1,3,2,2,2,4,4,1,5,1,1,2,0,1,1,0,12,165,0,-7,7,-1,0,0,-1,-1,-1,-1,3,-1
KR_6535293355,420,-1,-16,-12,2,-4,6,2,5,3,8,-4,5,1,4,6,10,1,1,2,-1,5,7,-4,-2,6,0,0,-3,-1,-1,-1,-1,3,-1
KR_6639788982,420,-1,-61,-8,-1,1,1,2,-2,3,1,-1,3,2,0,2,2,1,0,1,0,-3,-37,-2,-1,3,21,0,0,-1,1,0,1,1,-1
KR_6735295867,420,-2,9,-8,-5,-3,3,0,-1,3,2,-2,2,0,2,3,5,-1,1,0,0,-3,-1,-1,-4,5,0,0,-1,1,-1,-1,-1,6,-1
KR_6764620011,420,-2,-33,-20,5,-4,4,0,-2,4,2,2,0,2,6,1,7,3,0,3,0,5,9,6,-9,3,0,0,-1,1,1,-1,-1,3,-1
KR_6756098640,440,-2,4,-12,-6,1,0,1,-2,4,2,-13,14,1,10,0,10,-2,6,4,-2,-10,-3,-2,0,2,-1,0,0,-1,1,-1,-1,2,-1
KR_6719076581,420,-2,26,-12,-9,1,1,2,-7,7,0,0,0,0,-2,2,0,-1,4,3,0,-9,2,-3,-1,4,-3,0,0,-1,0,0,-1,4,-1
KR_6653813087,420,-3,-77,12,-6,-1,2,1,-3,5,2,-4,5,1,3,3,6,-1,1,0,0,2,0,-9,0,9,-1,0,-2,1,1,-1,1,2,-1
KR_6738301841,420,-9,-119,-26,-13,-3,3,0,-4,6,2,-1,2,1,-5,6,1,0,0,0,0,-11,-2,2,-5,3,-4,0,-2,1,1,-1,-1,5,-1
KR_6747264344,420,0,-20,-16,-9,-3,4,1,-8,8,0,1,3,4,-3,3,0,4,2,6,-3,-15,9,-7,-1,8,-3,0,0,-1,1,-1,-1,5,-1
KR_6755014321,420,-1,28,-3,-4,-1,4,3,-3,4,1,0,0,0,0,1,1,0,0,0,0,-1,-1,-5,-2,7,5,0,0,-1,-1,0,1,4,-1
KR_6666585767,420,-3,-6,-12,-5,0,3,3,2,2,4,2,2,4,-3,5,2,-6,7,1,0,-4,3,0,-6,6,-3,0,-1,-1,-1,-1,1,2,-1
KR_6583014442,440,-3,-47,-15,-7,-2,3,1,-1,1,0,0,3,3,-5,6,1,1,0,1,0,-8,59,3,-5,2,-26,0,0,1,0,0,1,2,-1
KR_6513771521,420,-1,-34,4,-2,-3,4,1,-4,6,2,5,1,6,0,2,2,0,0,0,0,-1,0,-1,-4,5,-1,0,0,-1,0,0,1,1,-1
KR_6711838163,440,-1,-69,20,-5,-5,5,0,3,1,4,-1,3,2,-2,4,2,0,2,2,0,-3,-45,2,-5,3,25,0,-1,-1,-1,-1,-1,5,-1
KR_6733202337,420,-3,35,-17,-5,1,1,2,-2,2,0,-1,3,2,-3,3,0,0,1,1,0,-7,2,-3,-4,7,-1,0,-1,1,-1,-1,-1,3,-1
KR_6741624181,420,0,40,-8,3,-1,2,1,-3,4,1,3,0,3,5,0,5,-1,1,0,0,6,-66,1,-3,2,-2,0,1,0,-1,1,1,0,-1
KR_6746426016,420,-1,-40,20,1,-4,6,2,-3,4,1,5,0,5,0,4,4,3,3,6,0,1,-96,6,-9,3,-5,0,-1,1,-1,-1,-1,1,-1
KR_6644555705,420,-1,-96,6,-2,-3,3,0,1,1,2,2,1,3,-2,3,1,0,1,1,0,0,109,-2,-5,7,0,0,0,-1,-1,-1,-1,5,-1
KR_6613723480,420,-1,-55,-17,-4,1,2,3,-2,2,0,-3,3,0,0,1,1,0,1,1,0,-5,-282,-5,-2,7,-2,0,0,0,-1,-1,-1,0,-1
KR_6759405587,440,-1,-29,16,-5,1,0,1,-2,3,1,-5,6,1,1,3,4,0,1,1,0,-11,-20,-4,-1,5,0,0,0,1,1,0,1,1,-1
KR_6656832809,420,-1,-75,-11,8,6,1,7,6,0,6,-4,8,4,0,6,6,0,1,1,1,9,4,0,-6,6,1,0,-3,-1,1,-1,1,2,-1
KR_6762156228,420,-2,-1,-8,-6,3,0,3,-3,4,1,-1,1,0,-2,4,2,-3,3,0,0,-7,-9,-2,-6,8,6,0,-1,-1,1,-1,-1,1,-1
KR_6760220166,420,1,-15,-12,-1,4,1,5,-4,5,1,0,2,2,-1,3,2,0,1,1,0,-2,-256,-6,-1,7,1,0,0,1,0,1,1,2,-1
KR_6711977452,420,-6,-81,-6,-14,-3,4,1,4,0,4,-13,15,2,-1,1,0,-1,3,2,0,-19,1,0,-2,2,0,0,-4,1,-1,-1,1,4,-1
KR_6729845679,440,-1,14,-16,-5,6,0,6,-8,10,2,-2,3,1,-3,5,2,2,2,4,0,-17,4,1,-5,4,-1,0,1,-1,0,1,-1,6,-1
KR_6692664709,440,0,31,6,4,3,1,4,-2,3,1,-1,5,4,5,4,9,-1,2,1,1,-6,9,4,-6,2,-3,0,0,1,1,1,-1,4,-1
KR_6751360627,420,-1,-25,-20,-2,3,0,3,1,5,6,-1,2,1,-3,6,3,-2,3,1,0,-6,-12,-5,-4,9,4,0,1,1,1,1,-1,3,-1
KR_6742542887,420,-1,-28,4,-2,-4,4,0,-3,3,0,1,0,1,3,1,4,1,4,5,0,2,23,3,-5,2,-4,0,0,0,-1,-1,-1,0,-1
KR_6755785681,420,-4,-96,13,-10,-2,3,1,0,3,3,0,1,1,-4,5,1,-4,4,0,0,-5,-327,-5,-3,8,-1,0,-1,0,0,-1,1,0,-1
KR_6751520744,420,1,22,-7,-3,-1,3,2,2,2,4,-2,4,2,-4,4,0,2,2,4,0,-3,33,0,-4,4,-27,0,0,-1,1,0,-1,6,-1
KR_6611602215,420,-3,-35,-11,-9,-4,4,0,-5,6,1,0,0,0,-4,4,0,4,5,9,0,-18,-4,-6,-4,10,4,0,0,-1,1,1,-1,6,-1
KR_6762631642,420,-5,-84,-22,-13,-8,11,3,2,2,4,-4,5,1,0,4,4,-3,3,0,-1,-2,1,3,-7,4,-5,0,-1,-1,-1,-1,-1,1,-1
KR_6762550837,420,-2,-7,-11,-7,-3,4,1,1,2,3,-2,2,0,-3,4,1,0,1,1,0,-12,-19,-1,-4,5,-4,0,1,-1,-1,1,1,2,-1
KR_6627448987,420,-5,-20,-9,-9,3,0,3,-9,10,1,-5,9,4,1,2,3,1,0,1,0,-11,29,1,-3,2,4,0,-2,-1,-1,-1,-1,6,-1
KR_6713049600,420,3,27,-12,10,-4,6,2,1,2,3,8,0,8,4,0,4,1,0,1,0,7,7,2,-6,4,2,0,-1,-1,1,-1,-1,3,-1
KR_6744599881,420,0,-4,-36,5,-6,7,1,4,0,4,2,4,6,0,1,1,5,0,5,0,11,-29,1,-3,2,0,0,0,1,-1,-1,1,1,-1
KR_6758072051,420,2,-44,-4,0,3,0,3,2,4,6,-3,3,0,-3,5,2,1,0,1,0,1,2,-1,-1,2,-2,0,0,-1,0,0,-1,5,-1
KR_6762542108,440,4,12,4,7,-1,3,2,-1,4,3,-4,4,0,11,2,13,2,0,2,1,14,9,-3,-4,7,3,0,1,-1,0,1,1,5,-1
KR_6761916964,440,-3,34,-20,-9,-4,5,1,2,1,3,-3,4,1,1,0,1,-5,6,1,0,-8,21,-3,-4,7,-1,0,0,-1,-1,0,-1,1,-1
KR_6762872061,420,-1,23,-15,2,1,0,1,2,0,2,0,4,4,-2,3,1,1,1,2,0,4,-117,2,-6,4,0,0,0,-1,1,-1,1,4,-1
KR_6761776534,420,-4,-84,-12,-5,0,1,1,1,3,4,-2,3,1,-4,4,0,0,0,0,0,3,-5,-4,-4,8,-2,0,-1,1,-1,-1,1,3,-1
KR_6723872788,420,3,59,39,4,2,0,2,0,2,2,6,0,6,-3,4,1,-1,2,1,0,0,-15,2,-5,3,-2,0,-1,1,1,-1,-1,2,-1
KR_6762452343,440,-1,-44,-24,-7,-4,4,0,1,3,4,3,0,3,-1,3,2,-6,6,0,0,-6,-26,-1,-1,2,-3,0,-1,-1,1,-1,-1,3,-1
KR_6630558808,420,-3,16,-32,-1,1,0,1,-3,4,1,-1,3,2,3,1,4,-1,1,0,0,0,-3,-8,-2,10,1,0,-1,1,-1,-1,1,6,-1
KR_6298603525,420,-1,-42,8,0,4,1,5,-6,8,2,0,2,2,-1,2,1,3,1,4,0,-2,-6,0,-4,4,-1,0,-2,1,-1,-1,-1,3,-1
KR_6702270514,420,-4,6,-8,-8,-1,2,1,-9,9,0,-1,2,1,3,1,4,0,1,1,0,-5,10,-1,-2,3,-25,0,0,-1,-1,0,-1,2,-1
KR_6731881695,420,1,20,-8,0,1,1,2,-2,3,1,-5,6,1,7,0,7,-1,1,0,1,5,-282,2,-7,5,-2,0,0,-1,-1,1,1,5,-1
KR_6751342970,420,-1,-16,0,-5,1,1,2,-4,5,1,2,3,5,-4,6,2,0,1,1,0,-10,-12,2,-6,4,-1,0,-1,-1,1,-1,-1,4,-1
KR_6271243131,420,-3,-39,16,-9,0,2,2,-4,4,0,-1,2,1,0,1,1,-4,4,0,0,-13,12,-1,-4,5,-1,0,0,-1,0,0,-1,5,-1
KR_6622446315,420,-8,-76,-18,-14,-5,6,1,-3,4,1,0,1,1,-3,3,0,-3,3,0,0,-7,-6,0,-2,2,-2,0,-2,-1,1,-1,-1,2,-1
KR_6731439708,440,-4,-66,-16,-7,0,0,0,1,0,1,-2,4,2,-4,4,0,-2,2,0,0,-7,0,-1,-1,2,-3,0,0,-1,1,-1,-1,3,-1
KR_6606199681,420,-2,-38,-1,-5,5,1,6,-2,3,1,-3,4,1,-3,5,2,-2,2,0,0,-9,2,-3,-3,6,-1,0,1,-1,1,1,-1,6,-1
KR_6714268300,420,1,9,8,5,1,2,3,3,1,4,-1,3,2,3,2,5,-1,1,0,0,13,-378,-1,-2,3,3,0,0,-1,-1,0,-1,1,-1
KR_6764819482,420,-4,-81,-8,3,1,1,2,0,2,2,0,0,0,4,3,7,-2,2,0,-1,3,-116,0,-8,8,3,0,-3,1,-1,-1,-1,2,-1
KR_6667505997,420,0,-7,-4,-4,1,0,1,-2,5,3,-1,1,0,-1,3,2,-1,1,0,0,-2,-4,-3,-2,5,3,0,0,1,1,0,-1,5,-1
KR_6665472508,440,-1,-70,-4,-2,1,1,2,1,3,4,0,2,2,-2,3,1,-2,2,0,0,-2,-5,0,-2,2,4,0,0,-1,1,-1,-1,1,-1
KR_6751214911,440,0,-22,-13,-3,4,1,5,1,4,5,-4,4,0,-5,5,0,1,0,1,0,-6,-5,2,-6,4,1,0,1,-1,1,1,-1,3,-1
KR_6742749630,420,-4,-2,-14,-8,-4,4,0,0,2,2,3,0,3,-6,6,0,-1,2,1,0,-6,-2,0,-3,3,3,0,-1,-1,-1,-1,-1,1,-1
KR_6748941464,420,-4,-61,-16,-11,0,2,2,-3,3,0,-3,5,2,-2,2,0,-3,3,0,0,-9,4,1,-3,2,0,0,-3,-1,-1,-1,-1,4,-1
KR_6640552974,420,1,3,-39,-6,4,0,4,-4,4,0,-2,2,0,-2,3,1,-2,3,1,0,-4,-9,1,-2,1,0,0,0,1,0,-1,-1,1,-1
KR_6758852500,420,-1,-38,8,2,0,4,4,-1,1,0,4,0,4,0,4,4,-1,1,0,0,1,-47,4,-6,2,13,0,-2,-1,1,-1,-1,6,-1
KR_6706490531,420,-4,-63,-9,-8,-3,4,1,-1,2,1,-2,4,2,2,1,3,-4,5,1,0,-7,101,5,-6,1,13,0,0,-1,-1,-1,1,3,-1
KR_6742290962,420,1,-27,10,1,-1,3,2,3,1,4,3,5,8,-1,3,2,-3,4,1,0,-2,2,1,-6,5,-2,0,-1,-1,-1,-1,1,6,-1
KR_6387793747,420,0,68,12,3,2,1,3,1,0,1,-1,4,3,3,1,4,-2,2,0,0,-1,18,3,-7,4,0,0,1,-1,1,1,-1,4,-1
KR_6649806829,420,-5,-67,5,-11,-2,3,1,-4,10,6,3,2,5,-7,8,1,-1,1,0,0,-4,8,2,-4,2,0,0,-1,-1,1,-1,1,4,-1
KR_6714233027,420,1,0,-28,-4,2,1,3,2,1,3,-2,2,0,-5,6,1,-1,2,1,0,-6,41,-4,-3,7,2,0,-1,-1,-1,-1,-1,5,-1
KR_6718442523,420,0,-53,-17,-1,3,0,3,-2,7,5,1,4,5,-7,9,2,4,1,5,-1,0,-20,3,-7,4,-1,0,-1,-1,-1,-1,-1,3,-1
KR_6763726793,440,-3,-86,12,-10,-4,5,1,2,2,4,-1,7,6,-3,3,0,-4,4,0,1,-3,45,-6,0,6,-2,0,-3,-1,-1,-1,1,1,-1
KR_6731612967,420,-3,-47,-33,-6,2,4,6,-6,8,2,0,1,1,-3,4,1,1,0,1,0,2,1,1,-4,3,-6,0,-1,-1,-1,-1,-1,5,-1
KR_6761115953,420,-3,-61,-6,-6,-2,3,1,-2,4,2,2,3,5,-3,5,2,-1,1,0,0,-6,1,0,-3,3,-5,0,-1,-1,0,-1,-1,2,-1
KR_6730349935,440,-1,-26,11,-2,-1,2,1,1,3,4,2,1,3,-4,4,0,0,1,1,-2,-6,18,-3,-2,5,0,0,0,-1,1,1,-1,3,-1
KR_6745416566,420,-1,10,18,-7,-6,6,0,-1,3,2,-2,3,1,1,3,4,1,0,1,0,-4,1,0,-7,7,0,0,0,-1,-1,0,-1,6,-1
KR_6755622766,420,-6,-26,-4,-15,-4,4,0,-3,3,0,-4,5,1,-4,4,0,0,3,3,-1,-20,-16,-7,0,7,0,0,-2,0,-1,-1,-1,0,-1
KR_6736997266,420,1,40,-21,5,0,0,0,1,2,3,2,0,2,2,2,4,0,1,1,-1,4,-26,0,-3,3,1,0,0,-1,-1,0,-1,3,-1
KR_6750166480,420,0,-48,-18,5,2,0,2,0,3,3,2,2,4,-3,3,0,4,0,4,0,7,-109,-2,-3,5,1,0,1,-1,1,1,-1,6,-1
KR_6758803658,420,-1,-30,-8,-5,3,0,3,-1,3,2,-1,5,4,-3,5,2,-3,3,0,0,-9,-2,3,-6,3,-4,0,-2,-1,-1,-1,-1,5,-1
KR_6655029516,420,-1,32,-8,-3,-1,2,1,-1,3,2,-3,5,2,0,0,0,2,0,2,0,0,2,-1,-4,5,1,0,0,-1,1,0,-1,3,-1
KR_6752571524,420,1,22,0,0,-1,2,1,3,0,3,-5,6,1,1,1,2,2,2,4,1,-5,41,-3,-2,5,-18,0,1,-1,-1,1,1,3,-1
KR_6707148668,420,0,-90,-4,-3,3,1,4,0,3,3,-1,2,1,-5,6,1,0,2,2,0,-4,-1,2,-3,1,3,0,0,1,-1,0,1,1,-1
KR_6759261295,440,-4,-38,-11,-9,-2,3,1,2,5,7,0,3,3,-9,10,1,0,1,1,-1,-14,-13,-2,-3,5,2,0,-1,1,0,-1,-1,2,-1
KR_6751178649,420,-5,-58,-6,-9,-1,3,2,-4,4,0,-4,6,2,-2,4,2,2,1,3,-1,-4,-1,4,-6,2,-2,0,-1,-1,-1,-1,-1,3,-1
KR_6715230797,420,-6,-44,-42,-7,-3,3,0,-1,4,3,-1,3,2,-3,6,3,1,0,1,0,3,4,3,-5,2,-4,0,-2,-1,-1,-1,-1,2,-1
KR_6754070639,420,0,-36,0,-3,-3,3,0,4,4,8,-5,8,3,-3,6,3,4,0,4,2,-12,-1,0,-2,2,-1,0,1,1,0,1,-1,4,-1
KR_6764683019,420,-5,-15,28,-1,-10,10,0,0,2,2,3,0,3,5,3,8,1,1,2,0,-1,2,1,-5,4,-3,0,-1,1,1,-1,1,6,-1
KR_6762632369,440,-1,53,6,-6,0,0,0,-3,5,2,-3,6,3,-1,5,4,1,3,4,-1,0,-3,1,-3,2,0,0,0,1,1,0,-1,4,-1
KR_6756742535,420,4,-64,0,12,-2,3,1,0,4,4,0,2,2,5,0,5,9,0,9,0,17,8,2,-2,0,0,0,1,-1,-1,1,1,4,-1
KR_6696469975,420,-2,-135,8,-6,-2,4,2,-2,3,1,2,2,4,-4,4,0,0,1,1,0,-10,-4,-2,-2,4,-3,0,0,-1,1,-1,-1,5,-1
KR_6480764457,420,-4,-10,17,-7,-11,11,0,4,2,6,-3,4,1,0,3,3,3,0,3,0,2,-13,-3,-3,6,3,0,0,1,-1,-1,-1,6,-1
KR_6764136190,420,1,-5,-44,-5,-1,3,2,-2,4,2,3,1,4,-4,5,1,-1,1,0,0,-10,-15,-6,0,6,0,0,-2,-1,-1,-1,-1,4,-1
KR_6573025710,420,-2,-41,4,-1,-4,4,0,0,2,2,5,5,10,-2,4,2,0,1,1,0,0,167,6,-6,0,0,0,-2,-1,-1,-1,1,5,-1
KR_6640108803,420,-2,-37,-16,-5,2,2,4,0,2,2,-2,2,0,-2,3,1,-3,3,0,0,-3,-69,1,-2,1,11,0,-1,-1,-1,-1,1,1,-1
KR_6762785271,420,-2,-12,29,-6,-5,5,0,-3,5,2,3,0,3,-2,3,1,1,1,2,0,-5,0,-3,-3,6,0,0,0,-1,-1,0,-1,6,-1
KR_6734535845,420,-3,-43,38,-13,-1,3,2,-5,5,0,-7,7,0,0,3,3,0,0,0,0,-8,-15,-3,0,3,-3,0,-1,1,-1,-1,1,3,-1
KR_6763371200,420,0,6,13,-4,-6,6,0,1,1,2,3,0,3,0,2,2,-2,2,0,0,5,-48,-1,-4,5,25,0,-2,0,-1,-1,-1,0,-1
KR_6757925590,420,-1,-64,32,-3,2,1,3,-3,6,3,-3,3,0,1,0,1,0,0,0,0,-3,-1,-4,-4,8,-2,0,2,1,-1,1,1,3,-1
KR_6744229258,420,-1,46,21,-7,0,2,2,-3,4,1,-1,3,2,-1,4,3,-2,2,0,0,-6,6,3,-6,3,-2,0,0,-1,1,1,-1,6,-1
KR_6731839305,420,2,53,4,-1,2,1,3,-1,2,1,-1,3,2,-1,5,4,0,0,0,0,-7,11,-1,-6,7,4,0,1,-1,-1,1,-1,1,-1
KR_6699275665,420,-7,-63,-11,-14,0,2,2,-6,6,0,-2,4,2,-6,6,0,0,2,2,0,-17,4,1,-5,4,3,0,-2,-1,1,-1,-1,6,-1
KR_6726512513,420,0,-43,-33,1,-3,3,0,5,0,5,-4,6,2,3,4,7,0,1,1,0,10,6,3,-6,3,-3,0,-2,1,1,-1,-1,6,-1
KR_6724979613,420,-3,-43,8,1,-4,5,1,3,1,4,0,3,3,2,2,4,0,3,3,0,6,-5,-1,-3,4,2,0,1,0,1,1,-1,0,-1
KR_6713856350,420,-3,-11,-12,-3,1,2,3,1,1,2,4,4,8,-3,4,1,-6,6,0,0,-1,-283,-1,-1,2,2,0,-3,1,-1,-1,-1,4,-1
KR_6493048570,420,-2,-41,-21,-12,0,2,2,-4,4,0,-1,4,3,-5,6,1,-2,2,0,0,-15,-132,-1,-2,3,-1,0,-3,-1,-1,-1,-1,2,-1
KR_6668953648,420,-4,-78,-36,-7,0,2,2,-3,5,2,-2,3,1,1,1,2,-3,3,0,0,-6,-4,-6,-2,8,3,0,-1,1,1,-1,-1,4,-1
KR_6757623337,420,-4,-30,0,-9,2,2,4,-2,3,1,-4,5,1,-3,4,1,-2,2,0,1,-7,-3,-2,-5,7,2,0,-1,-1,-1,-1,1,2,-1
KR_6707189787,440,0,-62,-18,-1,-2,2,0,3,0,3,-1,2,1,1,5,6,-2,2,0,0,-1,-4,4,-5,1,2,0,-1,-1,-1,-1,-1,1,-1
KR_6653424491,420,-5,-32,-31,-8,1,1,2,-4,5,1,0,1,1,-2,5,3,-3,4,1,1,-7,32,-2,-2,4,-10,0,0,1,-1,1,1,2,-1
KR_6743975273,440,-3,-47,12,-6,0,2,2,-5,6,1,-1,1,0,-4,5,1,4,1,5,1,-13,-6,3,-5,2,-2,0,-3,-1,1,-1,1,4,-1
KR_6755105512,420,-3,-37,-24,-11,-1,1,0,3,0,3,-4,7,3,-7,8,1,-2,2,0,-1,-13,0,1,-6,5,-1,0,-2,0,0,-1,-1,0,-1
KR_6675544707,420,-7,-43,-36,-19,-3,4,1,-4,10,6,-4,4,0,-8,8,0,0,0,0,0,-13,57,21,-27,6,-22,0,-1,-1,-1,-1,-1,3,-1
KR_6733459810,420,2,26,-41,9,1,1,2,3,1,4,5,2,7,1,3,4,-1,2,1,0,16,-16,0,-5,5,1,0,1,1,1,1,1,6,-1
KR_6666481777,420,-4,-102,-28,-9,-2,3,1,0,2,2,-2,4,2,-2,3,1,-3,3,0,0,-2,-3,-5,-2,7,1,0,-2,-1,-1,-1,-1,5,-1
KR_6760715473,420,-2,-50,32,-4,-1,1,0,4,1,5,-4,6,2,-3,5,2,0,0,0,0,-5,0,-3,-3,6,-3,0,0,0,0,0,-1,0,-1
KR_6749357490,440,-4,-47,-35,-8,-2,6,4,2,3,5,-6,8,2,-3,7,4,1,1,2,0,3,-4,0,-3,3,0,0,0,-1,-1,-1,1,6,-1
KR_6762090143,420,-2,3,-12,-5,-3,4,1,0,1,1,-2,2,0,-1,4,3,1,1,2,0,-1,-135,0,-6,6,-2,0,0,-1,1,0,-1,5,-1
KR_6760582647,420,2,-4,-27,1,-2,4,2,-2,2,0,1,1,2,4,2,6,0,0,0,0,2,-4,1,-3,2,2,0,-1,1,-1,-1,1,2,-1
KR_6672871465,420,-1,15,8,-4,-1,2,1,-1,1,0,3,0,3,-4,5,1,-1,2,1,1,-3,2,1,-4,3,-2,0,1,1,0,1,1,1,-1
KR_6753642296,420,-3,-88,-41,-12,-5,5,0,-9,9,0,1,2,3,1,1,2,0,1,1,0,0,-1,-3,-2,5,-5,0,-2,-1,-1,-1,-1,2,-1
KR_6741945763,420,-1,-47,-21,0,2,1,3,0,3,3,-5,5,0,3,2,5,0,1,1,-1,7,100,-2,-2,4,-2,0,-1,-1,-1,-1,-1,5,-1
KR_6748511416,440,-1,-36,0,-5,-7,8,1,2,0,2,2,0,2,-1,2,1,-1,2,1,0,0,-116,-1,-1,2,0,0,-1,-1,-1,-1,1,6,-1
KR_6763041818,420,-1,0,-25,0,-2,2,0,1,3,4,1,2,3,-2,5,3,2,0,2,0,-2,-1,-4,-4,8,-2,0,0,0,-1,0,1,0,-1
KR_6761015070,440,-5,-97,4,-18,-1,4,3,-4,4,0,-2,4,2,-11,13,2,0,0,0,0,-27,-37,-3,-3,6,-6,0,-3,0,-1,-1,-1,0,-1
KR_6723802726,420,-2,-41,3,-4,1,2,3,-3,5,2,-1,2,1,0,3,3,-1,1,0,0,-7,0,-1,-2,3,-4,0,-1,-1,1,-1,-1,1,-1
KR_6626623106,420,0,15,4,-4,4,1,5,-1,3,2,-1,4,3,-5,6,1,-1,2,1,-1,-6,22,3,-5,2,-3,0,-1,0,0,-1,-1,0,-1
KR_6634307472,420,-5,-29,-11,-14,-3,3,0,-7,8,1,-2,5,3,-2,3,1,0,1,1,0,-8,-8,-3,-1,4,1,0,-1,-1,-1,-1,-1,4,-1
KR_6724756516,440,-2,-24,12,-3,-2,2,0,6,2,8,-3,4,1,-4,4,0,0,1,1,0,2,-1,0,-2,2,0,0,1,1,1,1,1,1,-1
KR_6559838811,420,1,-20,-16,8,3,3,6,2,2,4,5,1,6,-1,5,4,-1,1,0,1,8,155,-2,-3,5,3,0,2,-1,1,1,1,1,-1
KR_6670086972,420,1,-12,12,-2,4,0,4,2,2,4,-7,9,2,0,2,2,-1,2,1,0,-4,86,-2,-1,3,-30,0,0,0,1,1,-1,0,-1
KR_6761051235,420,0,7,12,-3,0,1,1,1,4,5,-6,6,0,1,1,2,1,1,2,0,4,-42,0,-3,3,-4,0,0,1,-1,0,-1,2,-1
KR_6764430188,420,-1,6,15,-5,-1,2,1,1,3,4,-3,5,2,0,6,6,-2,3,1,0,-5,-3,-2,-3,5,0,0,1,-1,1,1,-1,4,-1
KR_6749572071,440,2,-41,-12,4,-4,6,2,1,1,2,3,0,3,2,0,2,2,0,2,0,16,2,-4,-2,6,-1,0,0,1,0,0,-1,2,-1
KR_6489299886,420,-8,-82,-111,-18,-5,5,0,-2,6,4,-7,7,0,-3,4,1,-1,3,2,-4,-20,-23,-5,-1,6,-3,0,-3,-1,-1,-1,-1,2,-1
KR_6762464574,420,-2,38,-4,-10,-1,2,1,-2,3,1,-6,9,3,-3,4,1,2,2,4,0,-6,4,-6,-4,10,-8,0,1,-1,-1,1,1,6,-1
KR_6759186389,420,-6,-68,-54,-7,5,0,5,-1,1,0,-12,12,0,1,0,1,0,0,0,0,-3,-4,1,-2,1,-5,0,-2,-1,-1,-1,-1,4,-1
KR_6603637099,420,0,-37,-8,4,1,0,1,1,3,4,4,0,4,-3,3,0,1,0,1,0,-2,188,-1,-5,6,-4,0,0,1,1,1,-1,2,-1
KR_6738327083,420,-7,-116,-31,-7,-7,7,0,2,2,4,-3,4,1,-1,4,3,2,0,2,0,2,-130,-3,-4,7,-1,0,-3,1,-1,-1,-1,2,-1
KR_6723315470,420,-1,61,-8,-4,1,2,3,-1,1,0,-4,7,3,-1,1,0,1,0,1,0,-10,20,0,-4,4,0,0,0,0,1,1,-1,0,-1
KR_6704677988,440,0,14,29,-4,0,2,2,-6,8,2,-1,3,2,2,1,3,1,0,1,0,-6,-21,3,-4,1,-2,0,0,1,-1,1,1,6,-1
KR_6681892917,420,-4,-109,-20,-3,1,1,2,-4,6,2,1,3,4,0,2,2,-1,2,1,0,0,-5,-6,-1,7,3,0,0,-1,-1,0,-1,3,-1
KR_6623193777,420,-7,-69,-40,-18,-3,4,1,-12,14,2,-1,1,0,-2,5,3,0,0,0,0,-12,-3,2,-4,2,-5,0,0,-1,1,-1,-1,2,-1
KR_6631150228,420,-7,-75,-34,-16,-1,1,0,-5,5,0,-4,4,0,-4,7,3,-2,2,0,0,-12,96,5,-7,2,-2,0,-2,-1,-1,-1,-1,2,-1
KR_6633149347,420,1,76,24,5,0,2,2,3,1,4,3,0,3,-1,3,2,0,1,1,0,2,-3,0,-3,3,-4,0,2,1,1,1,1,2,-1
KR_6686473405,420,-1,-9,28,-1,1,1,2,-3,3,0,-2,3,1,0,0,0,3,2,5,0,-2,19,0,-3,3,3,0,0,1,1,0,-1,5,-1
KR_6436480969,420,-2,4,-10,0,1,1,2,-4,4,0,1,0,1,3,4,7,-1,1,0,0,3,-5,-5,-2,7,-1,0,-1,-1,1,-1,1,4,-1
KR_6704599780,440,-3,29,-50,-8,1,2,3,-7,8,1,-1,2,1,0,0,0,-1,1,0,1,-19,2,-2,-1,3,-1,0,0,-1,-1,1,1,5,-1
KR_6629870373,420,-1,-62,50,-3,3,0,3,1,1,2,0,1,1,-7,9,2,0,0,0,0,-4,1,1,-7,6,-3,0,-1,0,1,-1,-1,0,-1
KR_6655559808,420,-2,-57,11,-3,5,0,5,-7,7,0,0,1,1,0,0,0,-1,2,1,0,-9,5,-1,-3,4,2,0,-1,1,1,-1,1,5,-1
KR_6650277799,420,-7,-64,-60,3,-1,4,3,4,1,5,1,1,2,-1,1,0,0,0,0,0,3,5,9,-11,2,-3,0,-1,-1,-1,-1,-1,3,-1
KR_6759693076,440,0,28,7,6,-1,1,0,-2,4,2,7,1,8,1,0,1,1,0,1,0,6,-9,3,-4,1,-2,0,1,1,-1,1,1,4,-1
KR_6725142388,440,0,-57,-12,2,0,1,1,-2,5,3,2,1,3,0,7,7,2,1,3,0,5,36,-1,-1,2,-13,0,0,-1,1,0,-1,3,-1
KR_6734137477,420,-5,-24,-28,-11,-2,2,0,-2,4,2,-6,7,1,-3,4,1,2,1,3,-1,-18,-297,-4,-1,5,0,0,-1,-1,-1,-1,-1,2,-1
KR_6752251456,420,0,8,4,4,-1,8,7,1,4,5,1,2,3,3,6,9,0,0,0,3,10,0,2,-3,1,0,0,0,0,1,0,1,0,-1
KR_6660856166,420,0,-44,19,-7,-1,2,1,0,1,1,-1,5,4,-4,4,0,-1,1,0,0,-10,3,0,-7,7,1,0,-1,1,-1,-1,-1,3,-1
KR_6761260524,420,-3,-25,-12,-2,-4,4,0,-3,6,3,1,0,1,1,2,3,3,0,3,0,7,9,3,-9,6,2,0,0,-1,-1,0,-1,2,-1
KR_6743215643,420,4,40,20,7,-4,6,2,4,0,4,5,0,5,1,2,3,1,2,3,0,6,27,2,-4,2,1,0,0,1,1,-1,-1,6,-1
KR_6756334919,420,-1,-4,12,-4,-2,3,1,-1,5,4,2,2,4,-3,5,2,0,0,0,0,-2,5,2,-2,0,3,0,0,1,-1,-1,1,2,-1
KR_6761666830,440,-2,-37,-16,-6,2,1,3,-2,2,0,-2,2,0,-3,3,0,-1,1,0,1,-16,-2,-4,-3,7,-1,0,0,-1,1,0,1,4,-1
KR_6695566421,440,2,39,12,12,0,2,2,3,2,5,-1,7,6,9,0,9,1,0,1,0,0,1,2,-4,2,1,0,2,-1,1,1,-1,2,-1
KR_6730489637,420,1,22,-8,-1,3,2,5,-5,6,1,1,1,2,-2,3,1,2,0,2,0,2,94,-1,-3,4,2,0,-1,-1,-1,1,1,1,-1
KR_6704928492,420,1,8,6,0,2,3,5,1,4,5,-3,6,3,0,3,3,0,1,1,1,8,11,3,-6,3,-1,0,0,-1,1,1,1,5,-1
KR_6751344123,420,-1,0,0,-1,2,1,3,-3,4,1,-3,5,2,2,2,4,1,2,3,0,-2,13,-1,-4,5,2,0,0,1,0,1,1,5,-1
KR_6596160854,420,-1,-74,-20,-9,0,0,0,-1,3,2,-1,5,4,-6,6,0,-1,2,1,-2,-12,-2,-4,-2,6,0,0,0,-1,0,-1,-1,5,-1
KR_6759692079,420,0,-10,14,0,3,1,4,-6,6,0,4,1,5,-1,3,2,0,1,1,0,-2,0,1,-5,4,1,0,0,1,1,1,1,4,-1
KR_6649990986,420,-1,6,-32,2,5,3,8,1,1,2,-1,5,4,-2,4,2,-1,2,1,0,1,220,-5,0,5,-2,0,1,1,-1,1,1,5,-1
KR_6743875126,440,-5,-152,-40,-7,-3,3,0,-10,12,2,-1,4,3,1,0,1,6,0,6,-1,0,0,1,-4,3,1,0,-2,1,-1,-1,-1,3,-1
KR_6757961192,420,-4,-93,-1,-16,-1,5,4,-4,6,2,-1,3,2,-7,8,1,-3,3,0,-4,-14,10,5,-6,1,-4,0,-1,-1,-1,-1,-1,5,-1
KR_6720650436,420,0,-29,0,-4,0,1,1,-2,7,5,-2,2,0,2,1,3,-2,3,1,0,-3,1,2,-6,4,-6,0,0,-1,-1,0,-1,5,-1
KR_6636873848,420,-2,-9,-8,-9,2,0,2,-5,5,0,-1,1,0,0,3,3,-5,6,1,2,-4,-1,-2,-1,3,1,0,-1,1,-1,-1,1,3,-1
KR_6762375162,420,-3,-74,3,-4,-3,3,0,-1,3,2,0,5,5,1,2,3,-1,1,0,0,-10,19,4,-8,4,2,0,-1,-1,1,-1,1,5,-1
KR_6649284818,420,-6,-54,4,-13,-4,4,0,-3,4,1,-1,4,3,-4,6,2,-1,2,1,0,-10,6,4,-4,0,-1,0,-2,1,-1,-1,1,5,-1
KR_6298620964,420,-2,-5,10,-5,3,0,3,-1,3,2,2,2,4,-8,10,2,-1,1,0,0,-9,-9,0,-5,5,0,0,-2,-1,-1,-1,1,1,-1
KR_6744068965,420,-7,-23,-27,-14,1,2,3,-5,8,3,-4,5,1,-3,5,2,-3,3,0,0,-19,6,3,-3,0,-3,0,0,-1,1,-1,-1,3,-1
KR_6579834211,420,3,9,-12,2,-1,5,4,2,1,3,2,0,2,2,2,4,-3,3,0,0,4,2,-2,-4,6,4,0,0,-1,1,0,1,3,-1
KR_6541438734,420,-1,-6,-21,-8,-4,4,0,1,4,5,0,2,2,-6,10,4,1,2,3,0,1,15,3,-7,4,-7,0,-1,-1,-1,-1,-1,3,-1
KR_6731790304,420,2,14,23,5,-1,2,1,-1,4,3,0,4,4,7,1,8,0,1,1,0,6,63,3,-5,2,-23,0,0,1,-1,1,1,6,-1
KR_6745963146,440,1,30,0,2,1,0,1,-5,5,0,-1,1,0,6,3,9,1,2,3,0,2,1,6,-7,1,-3,0,0,-1,0,0,1,4,-1
KR_6760734691,420,-4,-95,-12,-5,-2,3,1,1,2,3,-4,6,2,-3,3,0,3,3,6,0,-1,-8,-5,0,5,2,0,0,1,-1,0,-1,1,-1
KR_6760234278,420,-2,-42,-4,-6,-3,4,1,-2,4,2,0,0,0,0,5,5,-1,2,1,0,-2,21,-2,-2,4,-2,0,-1,0,0,-1,-1,0,-1
KR_6636146096,420,-3,-28,-20,1,-1,2,1,1,2,3,-1,3,2,2,3,5,0,2,2,0,0,-50,-2,-2,4,35,0,-2,-1,-1,-1,1,6,-1
KR_6713857436,420,-6,-84,-12,-17,2,2,4,-2,2,0,-7,7,0,-4,4,0,-6,7,1,1,-11,75,-3,-1,4,-1,0,-2,-1,-1,-1,1,5,-1
KR_6570936892,420,1,55,19,-3,-4,8,4,-1,6,5,4,2,6,-1,2,1,-1,2,1,0,-1,3,5,-7,2,2,0,1,1,1,1,1,1,-1
KR_6761300409,440,-5,-89,-4,-19,1,1,2,-8,10,2,-5,7,2,-7,7,0,0,1,1,1,-19,-2,-1,-5,6,-3,0,-2,1,-1,-1,1,5,-1
KR_6614539633,420,-2,25,-29,-2,-2,3,1,3,3,6,-1,2,1,0,1,1,-2,2,0,0,-1,4,2,-5,3,0,0,0,-1,0,0,-1,3,-1
KR_6762566555,440,-1,34,8,-4,3,1,4,0,1,1,-1,3,2,-6,6,0,0,0,0,0,-3,0,-5,0,5,0,0,-1,-1,-1,-1,1,3,-1
KR_6714563255,420,-4,-52,-20,-7,0,3,3,-2,3,1,-1,4,3,-3,6,3,-1,3,2,0,-8,2,-2,-2,4,-5,0,0,1,1,0,-1,6,-1
KR_6623682630,420,1,50,18,1,4,3,7,-3,5,2,-4,4,0,3,1,4,1,1,2,0,3,15,2,-4,2,3,0,1,-1,1,1,1,3,-1
KR_6727360122,420,2,47,8,-6,-7,9,2,3,5,8,-1,1,0,-2,3,1,1,0,1,1,-13,-17,0,-5,5,-2,0,3,-1,1,1,1,2,-1
KR_6762152727,420,-4,-139,-8,-2,-4,4,0,1,1,2,0,3,3,0,1,1,1,0,1,0,6,22,2,-5,3,2,0,-1,0,1,-1,-1,0,-1
KR_6648475569,420,1,1,-23,6,-2,3,1,3,0,3,5,1,6,0,3,3,0,1,1,0,8,-36,2,-2,0,7,0,0,1,1,1,1,3,-1
KR_6750870184,420,-2,-54,-24,-6,1,1,2,-3,4,1,-6,8,2,0,5,5,2,0,2,0,0,71,-2,-1,3,4,0,0,-1,-1,-1,-1,2,-1
KR_6654594451,420,-3,-61,18,-12,-5,5,0,-1,4,3,-2,3,1,-3,3,0,-1,2,1,0,-7,1,-2,-2,4,2,0,0,1,1,0,-1,6,-1
KR_6392254557,420,-4,-25,-12,-2,0,2,2,-1,3,2,3,1,4,0,2,2,-4,4,0,1,-6,3,3,-5,2,-3,0,1,0,0,1,1,0,-1
KR_6758383088,420,-4,-100,-8,-8,-2,4,2,1,2,3,-4,4,0,-2,6,4,-1,1,0,-1,-3,193,3,-5,2,-1,0,-3,1,-1,-1,-1,1,-1
KR_6753200830,420,-2,-55,-1,-3,1,1,2,-5,8,3,1,4,5,-2,4,2,2,0,2,-1,-1,8,1,-3,2,-4,0,0,-1,-1,-1,-1,2,-1
KR_6754002577,420,2,-52,0,-2,0,2,2,2,1,3,-1,3,2,-3,4,1,0,0,0,-1,-5,10,2,-7,5,-8,0,0,-1,-1,0,-1,4,-1
KR_6731717733,420,-1,-28,3,-4,1,2,3,-1,1,0,-2,2,0,-2,4,2,0,2,2,-3,-6,1,-7,0,7,2,0,0,-1,-1,-1,-1,6,-1
KR_6740199662,440,0,33,-8,-9,0,0,0,-1,2,1,-3,4,1,-2,4,2,-3,5,2,0,-2,-26,-4,-1,5,1,0,0,-1,1,1,-1,6,-1
KR_6753575571,420,-3,-49,-36,-6,2,0,2,-1,4,3,-1,4,3,-8,8,0,2,1,3,-1,-2,5,2,-3,1,-2,0,1,-1,1,1,-1,6,-1
KR_6748055552,420,-1,19,-3,-7,3,1,4,1,1,2,-5,5,0,-7,9,2,1,0,1,1,-13,15,2,-7,5,-11,0,0,-1,1,1,1,5,-1
KR_6717889650,420,0,15,6,1,-3,4,1,2,6,8,0,3,3,1,2,3,1,1,2,0,1,12,0,-4,4,-2,0,1,-1,-1,-1,1,2,-1
KR_6763456900,440,0,38,-9,-2,1,1,2,-1,3,2,-1,2,1,1,3,4,-2,2,0,-2,-6,-14,-1,-3,4,-1,0,0,-1,-1,0,-1,5,-1
KR_6764395155,420,-2,-41,14,-13,-3,3,0,0,1,1,-4,5,1,-7,7,0,1,0,1,-3,-20,6,4,-8,4,2,0,-2,-1,-1,-1,-1,4,-1
KR_6761124673,420,-3,-22,-12,-4,-4,4,0,1,2,3,1,1,2,0,3,3,-2,3,1,0,-3,27,2,-4,2,-26,0,-1,1,0,-1,1,6,-1
KR_6727740202,420,-6,-83,-32,-7,-2,3,1,-3,3,0,1,4,5,-5,6,1,2,0,2,1,-2,-294,1,-3,2,-1,0,-1,-1,-1,-1,1,1,-1
KR_6375108044,440,0,-48,2,3,-2,2,0,3,0,3,1,1,2,2,2,4,-1,1,0,0,2,0,0,0,0,-6,0,-1,-1,1,-1,-1,6,-1
KR_6661418759,420,4,89,-4,8,-2,4,2,1,3,4,5,3,8,5,0,5,-1,1,0,1,4,-6,3,-7,4,3,0,0,1,0,0,1,6,-1
KR_6762596961,420,-1,-22,-32,-6,-2,3,1,3,0,3,-12,13,1,4,0,4,1,2,3,0,3,12,0,-4,4,-3,0,-2,-1,-1,-1,-1,1,-1
KR_6753863305,420,1,-32,10,2,0,1,1,0,2,2,5,2,7,-2,7,5,-1,1,0,0,1,170,0,-4,4,0,0,1,1,1,1,-1,1,-1
KR_6752608368,420,1,25,1,-2,2,1,3,-3,4,1,1,3,4,-2,2,0,0,1,1,0,-4,-243,2,-3,1,-2,0,1,1,1,1,1,3,-1
KR_6642573792,420,2,3,34,2,2,1,3,-3,6,3,0,2,2,3,3,6,0,4,4,0,4,1,-1,-4,5,-2,0,1,-1,1,1,-1,2,-1
KR_6760935017,420,-2,54,2,-13,1,1,2,-2,5,3,-5,7,2,-3,3,0,-4,4,0,0,-17,10,-4,0,4,3,0,-1,-1,-1,-1,-1,4,-1
KR_6760768422,420,-2,-29,-22,0,-3,3,0,1,3,4,9,1,10,-1,2,1,-6,7,1,0,-5,1,3,-8,5,-2,0,1,-1,0,1,-1,2,-1
KR_6587449229,420,2,-20,4,-3,-3,4,1,4,3,7,0,2,2,-4,6,2,0,0,0,0,-9,-17,1,-4,3,2,0,1,-1,1,1,-1,1,-1
KR_6761704205,420,-2,-41,4,-5,-1,2,1,1,2,3,-5,5,0,0,1,1,0,0,0,0,-1,-19,-1,-3,4,3,0,0,1,0,0,1,6,-1
KR_6728359252,420,1,-3,-4,-3,1,1,2,2,0,2,-3,4,1,-4,6,2,1,1,2,0,-7,5,5,-10,5,-2,0,0,-1,-1,0,1,6,-1
KR_6681955537,420,0,-29,14,-1,-2,3,1,1,4,5,-2,2,0,1,5,6,1,0,1,1,-4,-207,-2,-2,4,0,0,1,0,-1,1,1,0,-1
KR_6746988566,420,-1,-8,-21,-1,0,0,0,-4,4,0,0,2,2,2,0,2,1,2,3,-1,-6,1,2,-5,3,-1,0,0,0,0,1,-1,0,-1
KR_6764534167,420,5,99,28,9,7,0,7,3,5,8,-4,5,1,2,2,4,1,3,4,2,-2,-2,-1,-3,4,1,0,2,-1,1,1,1,5,-1
KR_6764501281,420,-7,-48,-36,-19,-2,3,1,0,4,4,-3,3,0,-6,8,2,-8,8,0,-2,-18,-68,-4,0,4,-1,0,-2,-1,-1,-1,-1,1,-1
KR_6742902133,440,1,-25,-17,-3,2,3,5,0,0,0,-2,2,0,-1,3,2,-2,2,0,0,-3,-11,-3,-3,6,-2,0,0,-1,-1,-1,-1,5,-1
KR_6672900375,440,0,2,20,-1,-4,4,0,2,1,3,0,1,1,1,0,1,0,0,0,0,-1,3,0,-1,1,-2,0,0,1,0,0,1,4,-1
KR_6748705868,420,-4,-61,6,-12,-6,6,0,-1,4,3,2,4,6,-5,6,1,-2,2,0,0,-1,-1,0,-3,3,1,0,-1,-1,0,-1,-1,5,-1
KR_6710093745,420,-8,-43,-43,-18,-3,4,1,-3,4,1,-3,3,0,0,4,4,-9,10,1,0,-14,-11,-7,-1,8,-1,0,-1,-1,-1,-1,-1,2,-1
KR_6643054736,420,0,17,21,-3,1,1,2,2,0,2,0,2,2,-4,5,1,-2,2,0,0,-5,-86,-4,-2,6,-1,0,0,-1,-1,0,-1,6,-1
KR_6740454415,420,2,-13,5,1,3,3,6,0,4,4,-3,5,2,-3,4,1,4,1,5,0,0,-3,-1,-1,2,0,0,0,1,-1,0,-1,4,-1
KR_6731709898,420,0,-49,17,4,4,0,4,-3,5,2,-1,1,0,4,0,4,0,0,0,0,10,-33,4,-6,2,18,0,-1,-1,1,-1,1,1,-1
KR_6753990143,420,-2,-48,-13,-5,-4,7,3,-1,2,1,2,2,4,-1,4,3,-1,1,0,0,9,2,0,-2,2,3,0,-2,-1,-1,-1,-1,1,-1
KR_6741342482,420,-1,22,-16,-3,-1,1,0,-2,6,4,-1,2,1,0,3,3,1,0,1,0,4,5,-1,-5,6,6,0,0,1,0,1,-1,5,-1
KR_6745376127,420,-1,28,-17,3,-6,6,0,0,1,1,-1,3,2,10,1,11,0,2,2,0,10,12,2,-4,2,1,0,0,1,1,1,1,6,-1
KR_6717129641,420,-7,-73,-41,-8,1,1,2,0,4,4,-7,9,2,-1,2,1,-1,4,3,-2,-8,-43,3,-7,4,15,0,1,-1,1,1,-1,1,-1
KR_6716803236,420,-1,-21,-4,0,0,1,1,1,4,5,-1,5,4,0,2,2,0,2,2,0,2,0,1,-6,5,-3,0,-1,-1,1,-1,1,5,-1
KR_6707950782,420,-2,61,4,-6,2,1,3,-6,8,2,-3,4,1,2,0,2,-1,1,0,0,-8,67,-1,-2,3,-3,0,1,1,-1,1,1,3,-1
KR_6746458002,440,1,-65,8,-1,-3,3,0,8,0,8,-1,2,1,-2,2,0,-3,3,0,-1,4,-437,0,-3,3,1,0,0,1,0,0,-1,5,-1
KR_6738899096,420,3,39,-16,4,0,2,2,3,1,4,0,3,3,0,1,1,1,1,2,0,5,-13,3,-6,3,0,0,0,-1,1,0,-1,3,-1
KR_6702120149,420,-1,-68,11,-2,3,0,3,0,1,1,2,0,2,-6,8,2,-1,2,1,0,-10,-23,-1,-2,3,-2,0,-1,1,1,-1,-1,3,-1
KR_6749383068,420,-3,11,24,-1,-3,4,1,2,1,3,-1,2,1,0,3,3,1,1,2,0,3,-10,-4,-4,8,3,0,0,-1,-1,-1,1,3,-1
KR_6751180335,440,-6,-61,-88,-3,-4,4,0,-1,1,0,3,2,5,-6,6,0,5,2,7,0,3,-142,0,-3,3,6,0,-1,-1,-1,-1,-1,2,-1
KR_6762670638,420,-3,24,-8,-4,-1,3,2,-1,5,4,0,3,3,-1,2,1,-1,1,0,-1,-3,-52,2,-6,4,24,0,1,1,1,1,-1,6,-1
KR_6740055482,440,0,12,-20,8,-2,3,1,2,7,9,1,2,3,5,1,6,2,2,4,1,15,-38,4,-7,3,20,0,0,1,-1,-1,1,4,-1
KR_6743027886,420,-4,-25,-6,-18,-2,3,1,-6,7,1,-2,4,2,-4,6,2,-4,5,1,0,-24,41,1,-7,6,-28,0,-2,-1,-1,-1,-1,5,-1
KR_6733482622,420,-7,-89,-59,-13,-12,12,0,-3,6,3,2,1,3,1,2,3,-1,1,0,0,-2,-1,3,-9,6,0,0,-1,1,-1,-1,-1,4,-1
KR_6662972919,420,0,18,4,1,2,0,2,-3,3,0,-1,3,2,1,1,2,2,0,2,0,-4,-23,-6,-2,8,3,0,0,1,1,0,1,6,-1
KR_6764228767,420,-8,-95,-43,-17,-4,5,1,-13,13,0,-3,6,3,3,1,4,0,1,1,1,-7,-83,3,-6,3,20,0,-2,-1,-1,-1,1,5,-1
KR_6763145991,440,-1,15,-12,1,0,1,1,4,2,6,-4,6,2,-2,3,1,3,0,3,0,3,6,3,-7,4,0,0,-1,1,-1,-1,1,2,-1
KR_6739775512,440,-2,18,20,-10,3,0,3,1,1,2,-10,10,0,1,1,2,-5,6,1,0,-13,-331,-3,-2,5,-2,0,-1,-1,1,-1,1,2,-1
KR_6741610745,420,2,-9,12,3,-2,2,0,-2,5,3,2,2,4,3,3,6,2,1,3,0,1,2,-2,-2,4,0,0,-1,1,-1,-1,-1,3,-1
KR_6493163168,420,1,38,13,-6,-5,8,3,-4,7,3,3,0,3,1,1,2,-1,2,1,0,1,11,1,-5,4,-3,0,0,1,-1,-1,-1,2,-1
KR_6636219581,420,-5,-56,-44,-11,0,2,2,0,1,1,-8,10,2,-1,4,3,-2,2,0,0,-4,-50,-2,-3,5,28,0,-1,-1,-1,-1,1,5,-1
KR_6614842981,420,-5,-75,16,-8,-3,3,0,1,3,4,0,1,1,-4,5,1,-2,2,0,0,-9,-3,-7,-2,9,-1,0,-1,-1,-1,-1,1,4,-1
KR_6632842487,420,-4,-50,-12,-6,-2,3,1,1,2,3,-1,2,1,-3,3,0,-1,1,0,0,-3,13,3,-6,3,2,0,0,-1,0,0,-1,2,-1
KR_5887276356,420,-2,-38,48,-8,0,1,1,-2,6,4,-5,6,1,0,6,6,-1,2,1,2,-14,16,-2,-4,6,0,0,-1,1,-1,-1,1,3,-1
KR_6735283583,440,-2,-9,-32,-5,-6,6,0,-2,2,0,2,1,3,2,3,5,-1,3,2,0,-4,-275,2,-3,1,-6,0,0,0,-1,0,1,0,-1
KR_6736511700,420,0,69,0,-2,-2,4,2,-1,5,4,2,1,3,1,1,2,-2,2,0,1,-8,292,3,-5,2,-6,0,1,-1,1,1,1,5,-1
KR_6761311961,420,0,50,-12,-3,0,0,0,3,3,6,-3,4,1,-3,4,1,0,3,3,1,-8,3,0,-4,4,2,0,0,-1,1,0,1,2,-1
KR_6719086842,420,-4,-97,11,-12,-2,5,3,-1,3,2,-6,7,1,-2,5,3,-1,2,1,-1,-15,-3,2,-5,3,1,0,-2,-1,1,-1,-1,1,-1
KR_6743874962,420,0,-11,-4,1,-2,3,1,7,0,7,1,1,2,-4,6,2,-1,1,0,0,4,7,0,-2,2,1,0,-1,1,-1,-1,1,3,-1
KR_6749237803,440,-4,-127,-3,-8,-4,7,3,1,3,4,4,0,4,-11,12,1,2,1,3,0,-3,-30,3,-4,1,15,0,-1,1,-1,-1,-1,2,-1
KR_6755111596,420,-1,40,4,-4,-8,8,0,1,3,4,0,1,1,1,3,4,2,0,2,0,-3,14,-5,-1,6,3,0,0,0,0,-1,1,0,-1
KR_6762438525,420,-4,-36,-19,-5,-1,1,0,1,2,3,-1,1,0,-1,5,4,-3,4,1,0,-3,12,-2,-5,7,-9,0,0,-1,1,0,1,4,-1
KR_6760726609,420,-3,-51,-24,-10,-5,7,2,0,6,6,-3,3,0,-1,3,2,-1,3,2,-1,-5,-6,0,-4,4,2,0,-1,-1,0,-1,-1,3,-1
KR_6472704970,420,0,-10,28,3,1,2,3,0,4,4,4,0,4,-2,2,0,0,1,1,0,-1,-7,1,-7,6,0,0,0,-1,1,0,-1,3,-1
KR_6752695798,420,-4,12,-26,-10,-4,5,1,0,4,4,-5,8,3,-1,3,2,0,0,0,0,-6,-3,-3,-2,5,2,0,1,-1,0,-1,-1,6,-1
KR_6739093920,420,-1,0,5,-9,3,1,4,-6,8,2,-4,4,0,-2,3,1,0,1,1,-2,-21,-237,1,-7,6,3,0,1,-1,1,1,-1,4,-1
KR_6688821958,420,-5,-81,-13,-12,-4,4,0,4,2,6,-5,6,1,-6,9,3,-1,2,1,0,-6,-59,-2,-1,3,23,0,-2,-1,-1,-1,-1,2,-1
KR_6588172207,420,-1,22,28,-5,-2,3,1,-1,3,2,1,1,2,-3,5,2,0,2,2,0,-7,22,-4,-3,7,-22,0,0,-1,1,-1,-1,2,-1
KR_6706908805,420,-1,-108,9,0,-3,4,1,-1,3,2,3,4,7,0,5,5,1,0,1,1,5,-2,0,-2,2,-2,0,1,-1,1,1,1,6,-1
KR_6763800208,440,-1,28,20,-4,0,1,1,-1,2,1,-4,4,0,0,2,2,1,1,2,0,-9,-5,5,-7,2,2,0,2,-1,-1,1,1,2,-1
KR_6758179171,420,-1,-8,2,4,3,1,4,-5,7,2,0,1,1,5,0,5,1,0,1,1,8,-7,-2,-3,5,4,0,1,1,-1,1,1,4,-1
KR_6673961198,420,-4,-25,-26,-14,0,1,1,-5,6,1,-2,3,1,-2,3,1,-5,5,0,-2,-14,-1,-4,-3,7,-4,0,-2,-1,1,-1,-1,1,-1
KR_6675942758,420,-6,-10,-27,-15,0,1,1,-5,5,0,-2,3,1,-5,5,0,-3,4,1,0,-14,-7,-8,-1,9,3,0,-1,-1,1,-1,-1,3,-1
KR_6688518971,420,-4,-14,-12,-6,-3,3,0,3,0,3,3,0,3,-1,5,4,-8,8,0,0,-2,1,7,-7,0,-4,0,0,0,-1,0,-1,0,-1
KR_6394183070,420,-1,-25,0,3,2,1,3,-2,5,3,-1,5,4,2,2,4,2,0,2,0,10,-118,0,-4,4,0,0,-1,-1,1,-1,-1,5,-1
KR_6699815107,440,2,38,8,5,-2,2,0,-4,5,1,1,0,1,2,2,4,8,0,8,0,4,-37,-3,-5,8,-2,0,-1,-1,-1,-1,1,4,-1
KR_6730993870,420,4,26,12,15,4,1,5,4,2,6,1,2,3,5,3,8,1,0,1,3,16,-2,3,-4,1,2,0,3,-1,0,1,1,4,-1
KR_6752223470,420,-5,-79,-12,-10,-2,2,0,-6,6,0,1,3,4,-2,4,2,-1,1,0,0,-9,-1,-1,-2,3,-7,0,0,0,1,0,-1,0,-1
KR_6697252493,420,-3,-40,0,-13,-3,4,1,3,2,5,-7,8,1,-4,7,3,-2,3,1,0,-10,-7,3,-5,2,1,0,0,1,1,1,-1,6,-1
KR_6695315226,420,1,33,20,-4,1,1,2,0,3,3,3,0,3,-6,7,1,-2,2,0,0,-7,4,2,-4,2,-1,0,0,-1,1,0,-1,2,-1
KR_6744031647,440,-1,-6,-7,-3,1,2,3,-2,2,0,-1,3,2,-2,2,0,1,1,2,0,1,22,-5,-5,10,-2,0,0,-1,-1,0,-1,3,-1
KR_6681933566,420,1,41,-24,-1,0,3,3,1,1,2,0,5,5,0,0,0,-2,3,1,-1,-4,-38,-2,-2,4,2,0,0,-1,1,0,-1,1,-1
KR_6729752504,440,0,60,8,-2,-2,2,0,1,2,3,3,1,4,-3,4,1,-1,1,0,0,1,-102,-2,-6,8,4,0,3,0,1,1,-1,0,-1
KR_6687323364,420,-2,-58,0,-11,0,1,1,-4,5,1,-2,7,5,-4,4,0,-1,2,1,0,-17,31,2,-6,4,-16,0,0,0,0,-1,-1,0,-1
KR_6704186812,420,-1,-62,15,4,-1,3,2,7,1,8,-2,5,3,0,5,5,0,1,1,0,9,7,1,-5,4,0,0,-1,1,-1,-1,1,3,-1
KR_6739868210,440,-2,62,-4,-11,1,2,3,-4,4,0,-5,5,0,3,0,3,-6,8,2,0,-10,-3,-3,-1,4,1,0,-1,-1,0,-1,-1,1,-1
KR_6610496138,420,-6,-81,-26,-11,-6,6,0,2,2,4,-9,9,0,2,1,3,0,1,1,0,-3,-20,-3,-3,6,0,0,-1,-1,-1,-1,-1,2,-1
KR_6654418752,420,-2,-22,-37,-8,2,1,3,-4,6,2,-3,5,2,0,2,2,-3,4,1,-1,-12,14,-1,-3,4,-3,0,-1,-1,-1,-1,-1,6,-1
KR_6724009890,420,-7,-11,-12,-9,-1,2,1,2,2,4,-1,1,0,-5,5,0,-4,5,1,0,-7,54,2,-3,1,-3,0,0,0,1,0,1,0,-1
KR_6750525644,420,2,85,9,-1,0,0,0,-6,7,1,-1,3,2,4,1,5,2,0,2,0,-1,3,0,-5,5,-1,0,2,-1,1,1,-1,5,-1
KR_6758239311,420,-2,-83,16,-5,-1,1,0,-4,4,0,1,2,3,-4,4,0,3,0,3,0,-5,7,7,-9,2,-2,0,0,-1,1,-1,1,2,-1
KR_6604168309,440,-4,23,-17,-10,1,3,4,0,2,2,-1,4,3,-9,11,2,-1,1,0,0,-12,93,-6,-1,7,-24,0,-2,1,-1,-1,-1,4,-1
KR_6762264462,420,-5,-6,-16,-17,2,0,2,-6,6,0,-13,13,0,0,1,1,0,0,0,0,-17,4,1,-5,4,3,0,0,-1,-1,0,1,2,-1
KR_6724896482,420,-4,-137,13,-3,2,2,4,-3,3,0,-4,4,0,2,1,3,0,0,0,-1,-2,-192,1,-5,4,0,0,-1,-1,0,-1,-1,4,-1
KR_6738413918,440,-2,-79,-28,-3,-1,2,1,-1,4,3,2,0,2,-3,4,1,0,0,0,0,-5,44,-6,-2,8,5,0,-1,-1,1,-1,-1,3,-1
KR_6762825493,420,1,-5,24,-6,-8,11,3,3,0,3,0,1,1,-1,6,5,0,0,0,-2,-4,-13,-9,-2,11,3,0,-1,1,-1,-1,-1,5,-1
KR_6758196129,420,-3,-6,12,-7,-6,6,0,-1,2,1,2,0,2,-3,5,2,1,0,1,0,-8,-8,4,-7,3,2,0,-1,1,1,-1,-1,2,-1
KR_6696465441,420,-1,-16,-8,-4,2,1,3,-4,4,0,1,3,4,-4,5,1,1,0,1,0,-6,104,0,-3,3,0,0,-1,-1,-1,-1,-1,1,-1
KR_6732882392,420,-3,-52,0,-6,-2,3,1,-2,4,2,1,0,1,-2,4,2,-1,1,0,-1,-11,-2,0,-5,5,-7,0,-1,1,-1,-1,-1,5,-1
KR_5536140245,420,-3,-29,8,-7,2,0,2,-6,8,2,-2,2,0,-1,3,2,0,0,0,0,-6,-23,-4,-5,9,1,0,0,-1,-1,-1,-1,3,-1
KR_6632130981,420,2,1,-5,9,-1,2,1,6,1,7,-2,3,1,4,6,10,2,0,2,0,16,5,-1,-4,5,0,0,2,-1,1,1,1,4,-1
KR_6283110950,420,0,-22,12,3,0,3,3,2,4,6,2,4,6,0,8,8,-1,2,1,0,8,13,2,-5,3,-1,0,-1,1,-1,-1,-1,1,-1
KR_6749052519,420,1,77,8,1,3,0,3,-3,4,1,1,2,3,1,3,4,-1,4,3,0,1,-2,3,-6,3,-3,0,1,-1,1,1,1,4,-1
KR_6763104623,440,-1,1,-3,-7,-2,2,0,-1,3,2,3,4,7,-4,6,2,-3,3,0,-1,-6,9,4,-8,4,5,0,-1,1,1,-1,-1,6,-1
KR_6757900284,420,-4,-62,7,-9,-6,6,0,3,0,3,-4,6,2,-1,4,3,-1,1,0,0,-7,6,0,-5,5,-1,0,-2,-1,0,-1,-1,1,-1
KR_6742462179,420,-6,-87,-52,-6,1,0,1,-6,6,0,-2,3,1,1,0,1,0,1,1,0,-3,0,-1,-3,4,1,0,-1,-1,0,-1,-1,4,-1
KR_6759423502,420,1,-51,-22,-1,0,0,0,4,0,4,-3,4,1,-3,5,2,1,0,1,0,-1,-3,-3,-1,4,2,0,-1,0,-1,-1,-1,0,-1
KR_6623636381,420,0,-21,-11,0,0,3,3,2,4,6,2,1,3,-3,4,1,-1,2,1,0,1,-6,-2,-4,6,2,0,2,-1,0,1,1,3,-1
KR_6764022045,420,1,-99,14,5,2,2,4,0,5,5,-2,3,1,4,0,4,1,0,1,0,7,2,-1,-4,5,0,0,0,-1,-1,-1,-1,5,-1
KR_6749039144,420,-1,69,-24,-8,-1,2,1,0,2,2,-2,8,6,-5,5,0,0,0,0,0,-7,0,-2,0,2,3,0,0,-1,-1,0,-1,2,-1
KR_6740592764,420,-3,-69,-12,-9,1,0,1,-6,7,1,-3,4,1,-2,4,2,1,1,2,-1,-4,-44,0,-2,2,27,0,0,-1,1,-1,-1,3,-1
KR_6757924855,420,-3,-45,4,-8,2,0,2,0,1,1,0,3,3,-9,11,2,-1,1,0,0,-7,29,-3,-3,6,-6,0,-1,-1,-1,-1,-1,2,-1
KR_6762500808,420,-4,-54,-28,-8,-3,8,5,-3,4,1,3,1,4,-5,5,0,0,1,1,0,1,-5,-4,-2,6,-2,0,-3,1,-1,-1,-1,2,-1
KR_6757649785,420,-5,12,-20,-16,-7,9,2,-5,6,1,-3,4,1,0,3,3,-1,3,2,-1,-11,0,-3,-3,6,0,0,-1,1,0,-1,-1,3,-1
KR_6610151735,420,2,67,-20,-2,-4,5,1,0,3,3,0,3,3,-2,3,1,4,0,4,1,-1,26,2,-6,4,2,0,1,-1,0,1,1,2,-1
KR_6748246175,420,2,56,-20,-5,1,1,2,-2,3,1,-1,5,4,-3,5,2,0,0,0,0,-5,1,-1,-3,4,5,0,2,-1,-1,1,-1,1,-1
KR_6661028220,420,-4,-83,-35,-9,-3,3,0,-1,2,1,0,2,2,-4,5,1,-1,2,1,0,-6,-29,4,-7,3,3,0,0,0,-1,-1,-1,0,-1
KR_6661081120,420,-2,-66,6,-7,-3,4,1,-1,3,2,1,2,3,-2,9,7,-2,2,0,1,0,36,0,-9,9,-3,0,-2,1,-1,-1,-1,5,-1
KR_6604733338,420,2,-76,30,-3,-1,2,1,-5,8,3,3,0,3,-3,3,0,3,0,3,0,-2,-32,-9,0,9,-3,0,-3,-1,-1,-1,-1,1,-1
KR_6628204004,420,-8,-45,-35,-6,-1,2,1,-3,3,0,-5,6,1,4,1,5,-1,2,1,0,-4,-17,5,-6,1,-5,0,-1,-1,-1,-1,-1,1,-1
KR_6761942383,440,-1,0,-28,-2,0,0,0,-3,3,0,4,3,7,0,5,5,-3,4,1,-1,-11,1,1,-4,3,0,0,0,-1,0,-1,-1,5,-1
KR_6731658651,420,-1,-49,-40,-3,-3,5,2,3,3,6,-2,2,0,1,2,3,-2,2,0,0,0,-8,1,-2,1,-2,0,-1,1,-1,-1,-1,4,-1
KR_6739123369,440,-3,-51,8,-10,-1,3,2,2,0,2,-5,5,0,3,2,5,-9,9,0,-1,-16,38,3,-7,4,-30,0,0,-1,0,-1,-1,3,-1
KR_6745380156,440,-2,13,-3,-2,1,1,2,0,1,1,0,0,0,-6,9,3,3,0,3,0,0,1,-2,-4,6,0,0,-1,-1,-1,-1,-1,1,-1
KR_6513622857,420,-6,-68,-8,-13,-3,4,1,-5,5,0,2,0,2,-6,7,1,-1,3,2,-1,-13,-9,1,-3,2,1,0,-1,0,-1,-1,-1,0,-1
KR_6665575222,420,-2,-23,-23,-9,0,0,0,-2,3,1,-2,2,0,-4,8,4,-1,1,0,-3,-21,-31,-3,-4,7,2,0,-1,-1,-1,-1,-1,6,-1
KR_6757416928,440,-8,-28,-13,-21,0,2,2,-8,8,0,-11,11,0,-1,3,2,-1,1,0,-1,-19,-17,2,-4,2,-4,0,-2,0,-1,-1,-1,0,-1
KR_6568214502,440,-1,35,-38,8,0,5,5,3,2,5,-1,2,1,2,1,3,4,0,4,0,1,-14,-5,-3,8,2,0,2,-1,1,1,1,2,-1
KR_6705586393,420,-2,-87,-21,-4,-2,3,1,2,3,5,-5,6,1,0,5,5,1,0,1,0,-4,10,-6,-3,9,-1,0,0,-1,1,0,-1,4,-1
KR_6750018479,420,-6,-19,-50,-15,-3,3,0,-3,3,0,-2,4,2,-6,6,0,-1,1,0,0,-27,-50,-2,-5,7,-7,0,-1,-1,-1,-1,-1,2,-1
KR_6747623873,420,0,38,0,2,0,2,2,-2,5,3,1,3,4,4,1,5,-1,5,4,0,2,-1,-2,-3,5,2,0,-2,1,-1,-1,1,1,-1
KR_6693080052,420,1,-1,28,0,-3,4,1,-1,6,5,2,2,4,2,3,5,0,4,4,-1,3,32,1,-5,4,-1,0,-1,-1,-1,-1,1,2,-1
KR_6757491325,420,0,-38,16,0,0,2,2,-3,4,1,0,2,2,1,1,2,2,0,2,0,-1,-1,2,-6,4,1,0,0,1,-1,0,1,4,-1
KR_6762850987,420,-3,-48,-6,-4,-1,1,0,0,1,1,2,3,5,-5,8,3,0,3,3,0,-10,-74,-2,-1,3,-1,0,-1,-1,1,-1,1,4,-1
KR_6585075062,420,0,-59,-21,2,-1,3,2,3,3,6,-1,2,1,-4,7,3,5,0,5,0,-1,16,4,-6,2,-6,0,-1,1,-1,-1,-1,1,-1
KR_6732076758,420,-3,1,0,-2,2,3,5,3,3,6,-4,6,2,-3,4,1,0,0,0,0,-3,4,-1,-2,3,0,0,0,1,1,0,1,6,-1
KR_6755035934,420,0,9,-4,1,-6,6,0,3,1,4,3,1,4,-1,7,6,2,1,3,0,3,15,2,-4,2,0,0,1,-1,-1,1,-1,3,-1
KR_6743020794,420,-4,-76,-12,-8,-1,2,1,0,1,1,-1,6,5,-5,6,1,-1,1,0,-1,-5,-13,1,-4,3,1,0,0,-1,0,0,-1,5,-1
KR_6717771648,420,-3,16,16,-11,-1,4,3,-6,7,1,-4,4,0,-4,6,2,4,0,4,0,-17,-12,-2,-4,6,4,0,-1,-1,1,-1,1,3,-1
KR_6762194515,420,-3,-79,4,-9,3,3,6,0,2,2,-2,2,0,-8,8,0,-2,3,1,0,-14,1,-6,-3,9,-3,0,-3,-1,-1,-1,1,1,-1
KR_6762962613,420,-6,-27,-8,-13,-2,2,0,-2,3,1,-7,7,0,-2,3,1,0,0,0,0,-6,52,-2,-4,6,4,0,-1,1,-1,-1,-1,4,-1
KR_6741795472,420,-3,-55,-2,-8,-5,5,0,0,1,1,0,0,0,-3,8,5,0,2,2,0,-2,-6,-5,-3,8,4,0,-2,-1,-1,-1,-1,3,-1
KR_6732172054,420,1,-55,32,3,-3,5,2,3,3,6,2,2,4,1,1,2,0,1,1,0,5,-1,2,-5,3,2,0,-1,1,0,-1,-1,4,-1
KR_6758831761,420,3,11,20,4,-3,4,1,0,2,2,4,2,6,4,0,4,-1,2,1,0,-2,7,0,-3,3,2,0,2,0,-1,1,-1,0,-1
KR_6740207706,440,-4,9,-48,-5,-1,3,2,2,1,3,-4,5,1,-1,3,2,-1,3,2,0,-2,5,-1,-2,3,0,0,-1,-1,-1,-1,-1,4,-1
KR_6724436832,420,-1,6,0,-2,4,1,5,-1,5,4,1,1,2,-4,4,0,-2,2,0,0,-11,-6,0,-4,4,-4,0,0,-1,-1,-1,1,1,-1
KR_6764634771,440,1,21,-9,-3,-5,5,0,2,0,2,3,4,7,-6,6,0,3,3,6,0,-18,3,1,-6,5,-8,0,0,-1,0,-1,1,3,-1
KR_6656896049,420,0,9,13,-1,1,2,3,3,2,5,1,1,2,-4,5,1,-2,2,0,0,-2,-5,-2,-5,7,3,0,0,0,1,1,1,0,-1
KR_6764738527,440,1,-31,-9,-4,-3,6,3,4,2,6,-1,3,2,-2,4,2,-2,3,1,0,-2,105,1,-4,3,-1,0,0,-1,0,0,-1,5,-1
KR_6652442341,420,-5,-76,8,-9,-3,4,1,0,3,3,-4,6,2,-3,6,3,1,2,3,-1,0,-195,1,-3,2,-2,0,-2,0,-1,-1,1,0,-1
KR_6750408544,420,-1,-53,16,1,0,5,5,-2,5,3,3,0,3,-1,2,1,1,1,2,0,2,0,1,-2,1,-3,0,-2,1,-1,-1,-1,3,-1
KR_6731423168,420,-3,-101,-22,-12,-2,5,3,-4,5,1,-2,2,0,-5,6,1,1,1,2,0,-7,-60,-4,-2,6,26,0,-1,1,-1,-1,-1,6,-1
KR_6623036884,420,-2,-54,-44,-3,1,1,2,-3,6,3,1,2,3,-1,2,1,-1,1,0,0,-4,5,-1,-4,5,-2,0,-1,1,1,-1,1,5,-1
KR_6707844856,420,-4,2,-9,-12,-1,2,1,-3,3,0,-4,5,1,-4,8,4,0,1,1,0,-19,11,1,-5,4,-3,0,1,-1,0,1,-1,5,-1
KR_6757342671,420,-4,2,-17,-13,-1,2,1,-1,3,2,-10,10,0,0,2,2,-1,1,0,-1,-6,6,0,-3,3,0,0,0,-1,-1,0,-1,5,-1
KR_6746028775,440,-3,17,-25,-5,-1,3,2,-1,2,1,-7,10,3,1,1,2,3,0,3,1,-1,161,2,-3,1,-1,0,-1,-1,0,-1,1,6,-1
KR_6748988912,420,0,34,-8,-2,-1,4,3,-1,1,0,0,0,0,-1,2,1,1,0,1,0,2,1,2,-5,3,-2,0,0,-1,1,-1,-1,2,-1
KR_6757703850,420,1,-43,0,-2,-1,4,3,-5,9,4,1,1,2,1,0,1,2,0,2,-1,4,-3,0,-4,4,6,0,0,0,-1,1,-1,0,-1
KR_6759231149,440,-2,17,20,-7,-2,3,1,2,2,4,-2,4,2,-5,7,2,0,2,2,0,-7,-191,1,-1,0,4,0,0,-1,-1,0,1,2,-1
KR_6597893154,440,-7,-107,-55,-22,1,3,4,-5,5,0,-10,10,0,1,3,4,-9,9,0,-1,-24,-49,-3,-1,4,10,0,-2,0,0,-1,-1,0,-1
KR_6687930442,420,1,11,-8,7,5,0,5,0,1,1,-3,5,2,0,1,1,5,0,5,0,2,9,1,-4,3,0,0,1,1,0,1,1,6,-1
KR_6761746806,440,0,-14,12,-5,1,0,1,0,4,4,1,2,3,-2,3,1,-5,6,1,0,-11,5,3,-7,4,-4,0,0,0,0,1,1,0,-1
KR_6664293082,440,-2,6,-19,-4,-2,5,3,-5,7,2,1,2,3,3,2,5,-1,2,1,-2,-8,-10,-1,-4,5,-3,0,-1,1,-1,-1,-1,3,-1
KR_6678835161,420,1,-1,6,6,-1,1,0,3,3,6,0,0,0,4,0,4,0,0,0,0,9,-109,2,-7,5,-1,0,2,-1,1,1,1,4,-1
KR_6684791149,440,-7,-120,-9,-18,0,1,1,-8,8,0,-2,3,1,-8,8,0,0,1,1,0,-23,1,-5,-1,6,0,0,-2,1,0,-1,-1,2,-1
KR_6653833956,420,2,92,-4,7,1,1,2,10,1,11,-7,8,1,2,3,5,1,0,1,0,10,2,0,-6,6,2,0,2,-1,1,1,-1,6,-1
KR_6592197726,420,-3,-94,-12,-11,1,0,1,-4,5,1,-3,3,0,-6,6,0,1,1,2,-1,-11,-2,2,-4,2,2,0,-1,-1,-1,-1,-1,2,-1
KR_6535600949,420,-1,-59,-13,-8,-2,6,4,1,1,2,-6,6,0,-1,2,1,0,3,3,-1,-8,235,-2,-3,5,-3,0,-2,1,-1,-1,-1,4,-1
KR_6599591483,420,-2,-36,-4,4,2,2,4,2,4,6,3,1,4,-4,6,2,1,0,1,0,-4,-7,4,-7,3,-2,0,-2,1,-1,-1,1,3,-1
KR_6751257720,420,-1,-61,-12,-3,0,2,2,1,2,3,3,2,5,-5,6,1,-2,2,0,0,-2,-5,0,-4,4,1,0,-2,-1,-1,-1,-1,6,-1
KR_6636385653,420,-4,-93,30,-10,-3,3,0,3,1,4,0,2,2,-9,10,1,-1,1,0,0,-13,23,1,-4,3,-5,0,-2,-1,1,-1,-1,6,-1
KR_6743847745,420,-7,-54,-24,-10,2,0,2,-7,7,0,-6,7,1,2,0,2,-1,2,1,0,-12,11,2,-3,1,0,0,-2,-1,1,-1,1,5,-1
KR_6764559384,420,2,-7,20,-4,1,1,2,-3,6,3,1,1,2,-4,5,1,1,0,1,0,-9,109,3,-9,6,0,0,0,1,1,1,1,3,-1
KR_6680579152,420,-2,-32,31,-3,1,3,4,5,1,6,-9,9,0,0,0,0,0,1,1,0,3,-13,3,-5,2,-2,0,0,1,-1,0,-1,6,-1
KR_6751103348,440,-5,-38,4,-21,-1,4,3,-4,5,1,0,0,0,-12,14,2,-4,5,1,0,-11,-165,6,-8,2,-1,0,-1,-1,-1,-1,-1,5,-1
KR_6692998441,420,-1,-6,-37,-6,1,0,1,0,1,1,-3,3,0,-4,5,1,0,1,1,0,-7,-16,-1,-2,3,-5,0,0,-1,-1,-1,-1,3,-1
KR_6695662189,420,-3,-30,-28,-6,-2,3,1,-7,7,0,-1,1,0,3,1,4,1,0,1,0,-10,2,4,-7,3,-1,0,0,-1,-1,0,1,3,-1
KR_6741357212,420,-5,-51,-4,-12,-3,3,0,-3,3,0,-2,3,1,-4,9,5,0,1,1,0,-15,-41,2,-4,2,-4,0,-2,-1,-1,-1,-1,6,-1
KR_6760588729,420,-7,-45,-4,-16,0,2,2,-8,9,1,-2,3,1,-5,5,0,-1,2,1,0,-14,4,-2,-3,5,0,0,-1,-1,-1,-1,-1,2,-1
KR_6755400120,440,-2,15,-16,2,0,1,1,-1,2,1,-2,3,1,8,0,8,-3,4,1,1,5,-25,-1,-3,4,3,0,0,-1,-1,0,1,3,-1
KR_6747615629,420,-3,-16,-24,-9,-5,6,1,0,1,1,-4,4,0,0,0,0,0,0,0,0,-5,2,-3,-2,5,-1,0,0,-1,0,-1,-1,4,-1
KR_6644783423,420,1,24,-8,4,5,1,6,2,3,5,-5,6,1,2,2,4,0,1,1,0,-3,-10,-3,-2,5,-1,0,0,-1,-1,1,-1,2,-1
KR_6590020385,420,-7,-70,-3,-9,-3,4,1,-5,8,3,1,1,2,-3,4,1,1,3,4,0,-1,-52,-3,0,3,0,0,-3,0,-1,-1,-1,0,-1
KR_6668867199,420,0,-31,32,-9,-2,2,0,1,1,2,-6,7,1,-3,7,4,1,0,1,0,-10,-6,-3,-2,5,3,0,-2,0,-1,-1,1,0,-1
KR_6762123964,420,-1,-23,4,2,1,0,1,3,5,8,-2,4,2,3,1,4,-3,5,2,0,-3,381,3,-5,2,-6,0,0,1,1,0,1,4,-1
KR_6735699800,420,1,-25,-4,10,-1,1,0,-1,4,3,5,0,5,5,0,5,2,0,2,0,13,22,3,-9,6,-4,0,0,1,-1,0,1,3,-1
KR_6632250996,420,1,29,21,0,0,0,0,1,1,2,-4,4,0,1,1,2,2,0,2,0,1,3,-3,-2,5,9,0,0,-1,1,1,1,6,-1
KR_6682815635,420,0,23,32,-4,-4,4,0,-2,3,1,-2,4,2,0,2,2,4,1,5,0,-3,-3,-3,-4,7,-5,0,-1,1,-1,-1,1,1,-1
KR_6761013686,420,-1,-29,-24,-9,2,1,3,-3,7,4,-4,4,0,-1,2,1,-3,3,0,0,-4,-9,1,-3,2,-1,0,-1,-1,-1,-1,-1,5,-1
KR_6746588885,420,-2,8,16,-10,2,1,3,0,4,4,-6,6,0,-7,8,1,1,1,2,-1,-10,6,-2,-3,5,3,0,0,-1,1,0,1,2,-1
KR_6695467892,440,-1,16,-18,-2,4,1,5,-3,3,0,-3,5,2,1,1,2,-1,2,1,0,-4,114,-2,-4,6,4,0,0,1,1,1,1,5,-1
KR_6761482097,420,-4,-36,-4,-10,-1,3,2,-1,3,2,-2,4,2,-5,6,1,-1,1,0,0,-14,2,3,-5,2,-1,0,0,-1,-1,0,-1,5,-1
KR_6614302144,420,-1,-11,23,2,0,2,2,2,1,3,4,0,4,-5,5,0,1,0,1,2,4,206,1,-6,5,0,0,0,1,1,0,1,1,-1
KR_6613805584,420,-1,-6,-4,-6,-1,4,3,0,1,1,0,3,3,-1,3,2,-4,7,3,-1,0,15,1,-3,2,-3,0,-1,-1,1,-1,-1,4,-1
KR_6743324080,420,-2,-26,-1,-11,-1,2,1,-5,5,0,-1,4,3,-6,8,2,2,0,2,0,-17,-118,1,-3,2,-3,0,1,-1,1,1,1,1,-1
KR_6718662873,420,3,7,14,0,-4,4,0,0,2,2,4,2,6,0,2,2,0,1,1,0,-3,-41,3,-5,2,23,0,1,-1,1,1,1,2,-1
KR_6618873266,420,-2,-2,-28,-8,-2,3,1,-2,2,0,4,2,6,-4,5,1,-4,4,0,-1,-6,5,3,-5,2,0,0,-2,-1,1,-1,-1,2,-1
KR_6743091565,440,-6,-38,-29,-8,-2,2,0,-6,6,0,-1,1,0,0,1,1,1,3,4,0,-12,-2,-7,-3,10,0,0,0,-1,-1,-1,-1,4,-1
KR_6749046321,420,-3,-3,-16,-11,3,0,3,-1,4,3,-6,6,0,-4,5,1,-3,3,0,0,-16,-156,5,-8,3,-8,0,-2,-1,1,-1,-1,3,-1
KR_6599470063,420,-8,-116,-9,-21,-3,4,1,-1,5,4,-2,2,0,-14,16,2,-1,1,0,0,-16,3,-5,0,5,1,0,-2,-1,-1,-1,1,5,-1
KR_6655910385,420,-1,-27,8,-9,-4,5,1,1,4,5,-4,4,0,-1,2,1,-1,2,1,0,-9,11,4,-8,4,-4,0,0,0,-1,0,-1,0,-1
KR_6758792564,420,-4,-59,16,-9,0,2,2,-2,3,1,-3,6,3,-5,6,1,1,0,1,0,-10,-4,-4,-2,6,-3,0,-1,-1,1,-1,-1,5,-1
KR_6744602585,420,-6,-58,-60,-16,0,2,2,-12,12,0,-3,5,2,1,0,1,-2,5,3,0,-16,12,0,-3,3,-6,0,-2,-1,-1,-1,-1,3,-1
KR_6733963966,440,-5,-49,-11,-5,-1,2,1,-6,6,0,-3,3,0,5,3,8,0,3,3,1,-6,-6,-5,0,5,-2,0,-1,-1,-1,-1,1,1,-1
KR_6761799606,420,0,-38,20,-7,-1,3,2,0,3,3,-3,4,1,-1,2,1,-2,2,0,-1,-3,-3,4,-7,3,-1,0,0,1,0,1,-1,4,-1
KR_6738240029,420,-3,-20,-48,-7,0,2,2,-4,5,1,-3,3,0,0,1,1,0,0,0,0,-10,9,-3,-1,4,0,0,-1,0,1,-1,1,0,-1
KR_6764679649,440,-2,-72,-20,-9,1,1,2,-2,4,2,-10,11,1,4,1,5,-2,2,0,-1,-11,7,5,-6,1,-5,0,-1,0,0,-1,-1,0,-1
KR_6683346914,420,-3,-80,-24,-6,-4,6,2,0,2,2,-3,4,1,1,3,4,0,0,0,0,4,0,-2,-2,4,-2,0,-4,1,-1,-1,1,3,-1
KR_6638579484,420,-1,-29,-22,1,-1,4,3,2,4,6,1,1,2,-1,4,3,0,1,1,0,8,-27,-2,-4,6,20,0,0,-1,-1,1,1,2,-1
KR_5646868481,420,-10,-90,-67,2,-2,2,0,-2,4,2,-1,4,3,6,0,6,1,0,1,0,1,27,2,-5,3,4,0,-1,-1,-1,-1,-1,5,-1
KR_6738297878,420,-5,-27,-56,-14,-5,5,0,-6,7,1,0,5,5,-4,6,2,1,1,2,-1,-15,-5,-1,-5,6,-2,0,-3,-1,-1,-1,-1,2,-1
KR_6761394466,440,-3,-81,-24,-7,0,2,2,3,4,7,-7,7,0,-1,3,2,-2,2,0,0,-5,23,0,-2,2,0,0,-1,1,0,-1,1,3,-1
KR_6755601766,440,-5,-63,-21,-10,-2,3,1,-4,6,2,-1,3,2,0,3,3,-3,3,0,0,-10,23,-5,-1,6,-9,0,-1,-1,0,-1,-1,2,-1
KR_6758037862,420,-5,-115,-36,-9,-4,6,2,-2,2,0,-4,4,0,3,0,3,-2,3,1,0,-3,-12,0,-3,3,5,0,-1,-1,0,-1,-1,4,-1
KR_6761469217,420,-3,-8,11,-11,-4,5,1,-4,4,0,-6,7,1,-1,4,3,4,1,5,0,1,8,-4,-2,6,2,0,-1,-1,-1,-1,1,3,-1
KR_6739590882,440,-3,-85,5,-6,-2,3,1,-2,2,0,0,1,1,-2,4,2,0,4,4,0,-1,-3,0,-3,3,3,0,-2,1,0,-1,-1,6,-1
KR_6625446734,420,-3,-75,7,-11,-6,7,1,-3,5,2,-1,2,1,2,4,6,-3,3,0,-1,-15,-3,1,-6,5,4,0,-2,1,-1,-1,-1,6,-1
KR_6701989039,420,2,78,-12,3,0,1,1,1,2,3,3,1,4,0,2,2,-1,1,0,0,5,17,5,-5,0,3,0,0,-1,-1,0,1,6,-1
KR_6594144376,420,-2,-56,-10,-1,-4,6,2,-3,5,2,4,0,4,1,1,2,1,2,3,0,-3,-7,0,-2,2,2,0,1,-1,-1,1,1,4,-1
KR_6627451367,420,-1,-11,-56,-1,-1,2,1,2,1,3,-2,5,3,2,7,9,-2,3,1,0,7,-7,-2,-2,4,3,0,-1,-1,1,-1,-1,5,-1
KR_6734345562,420,-1,-48,-12,-5,-1,4,3,1,4,5,0,1,1,-4,4,0,-1,1,0,0,-2,115,4,-6,2,-1,0,-4,-1,-1,-1,-1,5,-1
KR_6739654463,420,-2,-14,-13,-7,2,1,3,-7,7,0,-2,2,0,-1,1,0,1,0,1,-1,-6,-12,-3,-5,8,0,0,-1,1,-1,-1,-1,4,-1
KR_6750824257,420,0,-83,-36,-4,1,1,2,0,3,3,-5,5,0,-1,3,2,1,0,1,0,0,7,-9,-1,10,-2,0,0,-1,1,0,-1,1,-1
KR_6727800041,420,-8,-149,-33,-18,-2,2,0,0,2,2,-8,9,1,-2,3,1,-6,6,0,0,-3,-413,0,-1,1,28,-1,-5,-1,-1,-1,-1,1,-1
KR_6726015407,420,-1,14,1,1,-1,2,1,1,5,6,-3,5,2,1,5,6,3,1,4,0,2,17,3,-4,1,-5,0,-1,1,-1,-1,1,6,-1
KR_6751345112,420,0,-70,7,-7,-1,2,1,4,2,6,-1,4,3,-10,11,1,1,1,2,-1,-6,37,-3,-1,4,2,0,-2,0,-1,-1,-1,0,-1
KR_6691056303,420,-2,-36,-4,-1,-8,11,3,7,3,10,-2,4,2,2,2,4,0,1,1,4,15,9,1,-2,1,2,0,-2,0,0,-1,1,0,-1
KR_6759799299,420,-4,3,-31,-4,1,2,3,-7,7,0,-2,3,1,4,1,5,0,3,3,-1,-3,-125,-6,-2,8,2,0,-1,1,0,-1,-1,1,-1
KR_6602013532,420,-4,-30,-40,-6,-2,4,2,0,1,1,-1,2,1,-1,3,2,-2,3,1,1,-1,-6,-3,-6,9,0,0,-1,-1,1,-1,1,3,-1
KR_6689347436,420,-2,7,-13,-3,1,3,4,-1,6,5,-1,3,2,-3,3,0,1,1,2,0,2,41,-5,-1,6,-18,0,0,-1,1,1,1,6,-1
KR_6635247581,440,-1,-56,-8,-8,7,1,8,-5,5,0,0,2,2,-10,12,2,0,3,3,0,-16,11,-5,0,5,-4,0,0,1,1,-1,-1,2,-1
KR_6764064857,420,2,49,16,3,0,1,1,1,1,2,1,0,1,3,1,4,-2,2,0,0,0,0,0,-6,6,1,0,0,1,-1,0,1,3,-1
KR_6616774703,420,-1,1,6,-4,-2,6,4,1,3,4,-3,3,0,1,3,4,-1,2,1,0,-3,5,0,-3,3,5,0,-2,1,-1,-1,1,2,-1
KR_6647864192,420,-6,-80,-45,-9,-1,3,2,-1,2,1,-5,7,2,0,2,2,-2,4,2,0,-1,-3,1,-4,3,0,0,-2,1,-1,-1,1,4,-1
KR_6740942273,420,-2,-14,-11,0,3,0,3,0,4,4,1,2,3,-2,2,0,-2,4,2,0,1,6,2,-4,2,-2,0,0,1,-1,0,1,1,-1
KR_6743441789,420,1,-20,54,0,-2,3,1,3,0,3,-1,5,4,-1,1,0,1,0,1,0,7,-4,-1,-3,4,1,0,0,-1,1,1,-1,1,-1
KR_6760657339,420,-2,21,-1,-7,0,0,0,-4,5,1,-5,5,0,3,1,4,-1,2,1,0,-9,-5,-4,-2,6,-2,0,1,-1,-1,-1,1,6,-1
KR_6673068798,420,-2,-82,60,-5,-1,1,0,1,3,4,-7,9,2,2,2,4,0,1,1,0,-4,6,-1,-5,6,-3,0,0,-1,1,0,-1,5,-1
KR_6757771883,420,3,35,36,0,2,0,2,1,6,7,1,4,5,-3,7,4,-1,1,0,-3,-9,2,0,-3,3,1,0,2,-1,-1,1,-1,2,-1
KR_6677327370,440,0,-4,-12,-3,0,2,2,1,2,3,2,0,2,-5,6,1,-1,1,0,0,-5,5,-1,-2,3,-2,0,0,1,0,0,-1,4,-1
KR_6754031835,420,-5,-57,-9,-6,-1,1,0,-2,2,0,-4,5,1,1,0,1,0,0,0,0,-7,-14,-6,0,6,-1,0,-3,-1,-1,-1,-1,2,-1
KR_6730758543,420,0,-23,-17,3,7,1,8,1,5,6,-4,4,0,1,1,2,-2,5,3,0,2,-32,1,-3,2,2,0,1,-1,1,1,-1,1,-1
KR_6749072200,420,0,-29,40,-1,-3,5,2,-3,4,1,1,2,3,-1,4,3,5,0,5,0,0,-15,4,-7,3,-4,0,0,1,-1,-1,1,1,-1
KR_6669001925,420,-2,-42,-16,-2,-4,4,0,5,1,6,4,0,4,-7,7,0,0,2,2,-1,-1,106,-3,-3,6,1,0,0,-1,1,-1,-1,6,-1
KR_6582905332,440,-1,-47,-19,3,0,0,0,-4,4,0,3,0,3,2,5,7,2,1,3,0,-1,4,1,-4,3,-4,0,1,-1,-1,1,1,5,-1
KR_6717167190,420,-6,-64,-4,-12,-3,3,0,-8,9,1,-1,2,1,-1,6,5,1,1,2,0,-15,14,-1,-5,6,-6,0,-1,-1,-1,-1,1,5,-1
KR_6760588567,420,-1,-37,27,-4,0,3,3,-2,2,0,1,2,3,-1,3,2,-2,2,0,1,1,32,0,-5,5,2,0,0,0,1,0,1,0,-1
KR_6763850636,420,-1,-58,-37,-4,1,2,3,4,0,4,-3,4,1,-5,6,1,-1,2,1,-1,-4,135,2,-4,2,-1,0,-1,-1,-1,-1,-1,4,-1
KR_6735213577,420,-1,35,-4,-7,1,7,8,0,2,2,-6,7,1,-2,5,3,0,0,0,-2,-9,-1,5,-6,1,-3,0,-1,-1,1,-1,-1,5,-1
KR_6664327197,440,2,-36,9,7,-3,4,1,3,0,3,1,1,2,5,0,5,1,4,5,0,24,34,-4,-4,8,4,0,0,1,0,-1,-1,2,-1
KR_6761391954,420,0,15,9,-2,2,2,4,-1,1,0,-3,3,0,0,2,2,0,0,0,0,-3,-9,-1,-5,6,2,0,0,1,-1,0,1,3,-1
KR_6751360051,420,0,-24,8,0,3,1,4,-2,4,2,0,5,5,-3,6,3,2,1,3,-1,-4,-7,4,-6,2,0,0,-1,0,1,-1,-1,0,-1
KR_6762933897,420,-5,-31,0,-12,-1,3,2,-6,6,0,0,3,3,0,2,2,-5,7,2,0,-18,-1,-1,-5,6,-2,0,-1,-1,1,-1,-1,3,-1
KR_6752166812,420,2,41,18,5,0,2,2,-3,7,4,3,2,5,7,2,9,-2,5,3,-1,9,5,1,-5,4,-2,0,-1,1,-1,-1,-1,6,-1
KR_6619587211,420,0,-11,12,-3,-3,5,2,2,0,2,-5,8,3,3,0,3,0,1,1,0,-3,-4,-1,-3,4,-1,0,-1,1,0,-1,-1,3,-1
KR_6615957581,420,-2,11,25,-7,-1,5,4,-1,1,0,-7,7,0,1,6,7,1,2,3,0,-9,2,-2,-4,6,-3,0,-2,-1,0,-1,-1,6,-1
KR_6742161879,420,0,-17,8,1,0,2,2,2,1,3,3,1,4,-2,2,0,-2,2,0,0,1,-56,3,-5,2,-1,0,1,0,1,1,-1,0,-1
KR_6603848515,420,-1,34,-8,3,-2,4,2,-1,2,1,1,2,3,6,1,7,-1,2,1,0,0,-3,-3,-2,5,4,0,0,-1,1,0,1,3,-1
KR_6741762282,420,-5,-55,-16,-7,0,1,1,-1,2,1,1,1,2,-6,8,2,-1,2,1,1,-11,8,-1,-6,7,0,0,-2,-1,-1,-1,1,3,-1
KR_6727181372,420,-7,-110,-40,-19,-8,8,0,-7,8,1,-2,5,3,0,1,1,-2,2,0,-4,-25,-16,-6,-1,7,3,0,-2,-1,-1,-1,-1,4,-1
KR_6594057969,420,1,-21,20,3,-1,2,1,2,1,3,4,2,6,-1,4,3,-1,2,1,0,8,50,7,-9,2,-4,0,0,1,0,0,1,4,-1
KR_6749963118,420,-4,-12,-12,-12,-3,3,0,2,0,2,-1,3,2,-7,7,0,-3,4,1,-1,-9,-12,2,-6,4,-1,0,0,-1,1,-1,-1,3,-1
KR_6754401676,440,2,-5,13,-1,-3,5,2,2,2,4,-1,2,1,2,8,10,-1,1,0,0,-9,-11,-6,-1,7,3,0,-1,0,-1,-1,-1,0,-1
KR_6747379333,420,0,-19,4,2,2,3,5,-3,4,1,0,2,2,1,1,2,2,0,2,0,3,-13,0,-4,4,2,0,0,1,0,0,1,4,-1
KR_6741482002,420,-3,-25,16,-14,1,0,1,-5,5,0,-3,9,6,-5,8,3,-2,2,0,1,-22,38,2,-5,3,-26,0,-1,1,-1,-1,1,3,-1
KR_6741398945,420,-3,15,24,-19,-2,2,0,-7,8,1,-3,5,2,-6,8,2,-1,1,0,-2,-22,2,-1,-4,5,-4,0,1,-1,1,1,1,5,-1
KR_6726991667,420,-1,-32,16,-3,2,0,2,1,1,2,-1,1,0,0,1,1,-5,5,0,0,-15,-5,4,-5,1,-2,0,-1,-1,1,1,1,1,-1
KR_6735095189,420,0,-25,-20,-5,0,0,0,5,0,5,-2,4,2,-5,5,0,-3,3,0,0,0,-40,-1,-6,7,31,0,0,-1,-1,0,-1,1,-1
KR_6584376238,420,-4,-22,-36,-1,-1,2,1,2,5,7,0,2,2,-2,2,0,0,0,0,0,1,12,2,-4,2,-3,0,-1,-1,1,-1,1,3,-1
KR_6760069926,420,-3,-64,10,-2,-3,5,2,2,0,2,0,2,2,-3,3,0,2,0,2,0,1,-17,0,-2,2,1,0,0,-1,1,-1,-1,1,-1
KR_6741129621,440,-2,-15,-41,-7,-5,8,3,0,1,1,3,0,3,-4,5,1,-1,2,1,0,-6,-26,-3,-1,4,2,0,0,1,-1,-1,1,5,-1
KR_6753762271,420,-4,-113,-45,-12,-3,8,5,-3,5,2,0,3,3,-4,6,2,-2,4,2,1,-5,10,-2,0,2,-3,0,-2,-1,-1,-1,1,4,-1
KR_6763178283,420,-2,-1,-26,-5,-5,5,0,0,1,1,-3,5,2,4,0,4,-1,1,0,1,3,6,0,-4,4,-3,0,-1,-1,-1,-1,1,3,-1
KR_6740362830,420,0,0,8,-3,0,2,2,2,2,4,-4,5,1,0,4,4,-1,1,0,-1,-3,-4,1,-3,2,-4,0,0,-1,-1,1,-1,3,-1
KR_6679746710,440,1,-17,-4,7,7,1,8,-2,3,1,-3,4,1,1,0,1,4,0,4,0,5,-2,-4,-1,5,-3,0,1,1,-1,-1,1,4,-1
KR_6717797638,420,-2,-68,19,-1,1,1,2,-2,4,2,1,1,2,4,2,6,-5,6,1,0,-3,3,8,-9,1,1,0,0,1,-1,0,1,6,-1
KR_6730977679,420,-4,-13,16,-11,0,3,3,-3,5,2,-5,7,2,-2,3,1,-1,1,0,0,-10,-6,1,-3,2,-2,0,-1,0,1,-1,-1,0,-1
KR_6764076682,420,2,49,40,1,3,0,3,-4,5,1,-1,3,2,3,0,3,0,0,0,-1,0,7,1,-4,3,-3,0,0,1,-1,1,-1,6,-1
KR_6654627594,420,-4,-103,-10,-3,0,0,0,1,1,2,-3,7,4,-2,2,0,1,1,2,0,-4,-13,-2,-3,5,-4,-1,-5,-1,-1,-1,-1,5,-1
KR_6756001400,420,-4,-86,-19,-4,-4,5,1,2,3,5,-2,3,1,-2,3,1,2,1,3,0,-10,-3,-7,-1,8,-1,0,-1,-1,0,-1,1,2,-1
KR_6756015736,420,2,68,-16,2,-1,1,0,2,3,5,-1,3,2,2,1,3,0,1,1,0,3,15,3,-4,1,-2,0,1,-1,1,-1,1,5,-1
KR_6759259590,420,-4,-16,-23,-10,2,2,4,2,3,5,-1,2,1,-4,5,1,-9,9,0,0,-9,-8,-3,-2,5,3,0,-1,-1,-1,-1,-1,1,-1
KR_6629843995,420,-1,-10,0,0,0,3,3,1,2,3,-2,7,5,1,1,2,0,1,1,0,2,1,3,-4,1,-1,0,-1,0,-1,-1,-1,0,-1
KR_6683709415,440,-1,6,-13,-3,1,3,4,-4,4,0,10,0,10,-6,6,0,-4,4,0,0,-17,-2,0,-2,2,0,0,0,-1,1,1,1,3,-1
KR_6679343012,420,-1,-58,1,9,-1,2,1,-2,6,4,6,1,7,4,0,4,2,0,2,1,13,-56,-1,-5,6,-1,0,-2,-1,-1,-1,1,3,-1
KR_6753526113,420,1,-7,-3,-3,0,3,3,1,2,3,1,2,3,-3,4,1,-2,2,0,0,-4,-32,0,-3,3,-3,0,0,1,1,-1,-1,2,-1
KR_6764257028,420,1,33,8,-1,3,1,4,1,3,4,-1,3,2,-4,5,1,0,1,1,0,-2,41,-1,-6,7,-18,0,0,-1,1,-1,-1,5,-1
KR_6717643998,420,0,-33,-23,1,-2,4,2,-2,4,2,2,0,2,2,1,3,1,1,2,-1,-2,-11,-4,-5,9,7,0,0,-1,-1,1,-1,1,-1
KR_6727013809,420,-6,-73,-32,-9,-3,4,1,1,1,2,-5,6,1,2,0,2,-4,4,0,1,0,-3,-1,-2,3,-1,0,-2,1,-1,-1,1,2,-1
KR_6628226174,420,-1,-52,-9,-5,-6,7,1,0,2,2,1,2,3,1,0,1,-1,3,2,0,3,20,4,-5,1,-6,0,0,1,-1,0,1,1,-1
KR_6727951308,420,-2,-21,-20,-1,1,1,2,-2,6,4,-1,3,2,2,2,4,-1,1,0,1,-6,-23,5,-8,3,2,0,-1,1,-1,-1,1,3,-1
KR_6731538774,420,2,7,16,0,0,1,1,0,2,2,-3,5,2,0,5,5,3,1,4,2,5,19,-1,-2,3,3,0,0,1,0,0,1,4,-1
KR_6764771782,420,-1,-89,4,-4,1,1,2,3,1,4,1,2,3,-9,9,0,0,1,1,0,-6,42,-6,0,6,-33,0,-1,-1,-1,-1,-1,3,-1
KR_6698599972,420,-3,-13,-8,-3,1,1,2,-4,9,5,2,0,2,2,3,5,-4,5,1,2,-2,0,4,-5,1,-1,0,0,1,1,0,1,2,-1
KR_6504085136,420,-5,-76,-34,1,-3,3,0,4,2,6,0,1,1,0,2,2,0,1,1,0,8,25,4,-6,2,1,0,0,0,0,0,1,0,-1
KR_6693209907,420,-3,0,26,-6,1,2,3,3,3,6,-4,8,4,-6,6,0,0,1,1,0,-7,98,4,-5,1,3,0,-2,0,-1,-1,-1,0,-1
KR_6763182909,420,1,19,-10,-1,3,1,4,-8,8,0,0,3,3,4,0,4,0,1,1,-1,-7,2,-1,-2,3,-2,0,-1,-1,-1,1,-1,2,-1
KR_6753760694,420,-2,5,-16,-8,-4,4,0,-3,5,2,2,0,2,-1,3,2,-2,2,0,0,-9,-14,0,-4,4,-1,0,1,-1,-1,1,-1,4,-1
KR_6724514498,440,-3,-73,-16,-5,-1,1,0,-4,4,0,-1,1,0,0,2,2,1,0,1,0,-4,-1,-1,-5,6,-2,0,0,1,-1,-1,-1,3,-1
KR_6730994143,420,-3,-86,-8,-4,0,3,3,-1,2,1,0,2,2,-2,2,0,-1,1,0,0,-9,6,-4,-2,6,-5,0,-1,-1,0,-1,-1,6,-1
KR_6721836563,420,-4,-49,4,-16,0,2,2,-3,4,1,-5,7,2,-7,9,2,-1,2,1,0,-14,6,-1,-3,4,0,0,-1,-1,-1,-1,-1,3,-1
KR_6735025353,420,-5,37,-12,-9,-2,2,0,-2,2,0,3,2,5,-4,5,1,-4,4,0,0,-9,1,1,-5,4,2,0,0,-1,1,1,1,1,-1
KR_6760708392,420,-6,-79,-5,-9,-3,3,0,0,3,3,1,1,2,-6,8,2,-1,2,1,-1,-8,3,0,-4,4,1,0,-1,-1,0,-1,-1,2,-1
KR_6750496548,420,-2,-55,-20,1,0,1,1,1,2,3,1,1,2,-2,3,1,1,0,1,0,-2,12,-1,-3,4,-2,0,-1,0,-1,-1,1,0,-1
KR_6728736098,440,2,54,-5,14,0,2,2,3,1,4,1,2,3,2,5,7,8,1,9,0,16,7,-1,-3,4,0,0,-1,1,-1,1,1,1,-1
KR_6742285419,420,-1,-34,-8,-4,1,1,2,-5,5,0,5,0,5,-5,5,0,0,1,1,0,-7,0,-4,-2,6,-3,0,-1,-1,-1,-1,-1,4,-1
KR_6738886123,420,0,78,0,5,-4,5,1,3,2,5,-3,4,1,2,2,4,7,2,9,0,5,-45,0,-3,3,0,0,0,1,0,1,1,6,-1
KR_6742594626,420,-8,-95,-20,-14,-5,5,0,-1,3,2,-3,3,0,2,0,2,-7,7,0,-1,-8,0,1,-6,5,-3,0,-3,-1,-1,-1,-1,3,-1
KR_6739853799,420,-3,1,-32,-14,-3,5,2,-6,6,0,-3,4,1,-3,3,0,1,0,1,0,-11,25,1,-4,3,-5,0,-2,-1,-1,-1,-1,1,-1
KR_6630406185,420,-3,-23,-16,-1,-2,3,1,0,1,1,2,0,2,-1,1,0,0,0,0,0,-4,2,-5,-3,8,-1,0,0,-1,0,0,1,3,-1
KR_6740241897,420,-3,-91,-28,-1,1,0,1,0,2,2,0,1,1,-3,6,3,1,1,2,0,-5,-12,-7,0,7,4,0,-1,-1,0,-1,-1,4,-1
KR_6761999088,420,-5,-129,-17,-9,-2,3,1,-5,7,2,-3,5,2,-2,5,3,3,0,3,-1,-3,-15,-2,-2,4,-3,0,-3,-1,-1,-1,-1,5,-1
KR_6678094960,420,0,-2,-2,4,-1,2,1,4,3,7,2,0,2,1,4,5,-2,3,1,0,2,12,2,-5,3,4,0,1,-1,1,1,-1,6,-1
KR_6652605433,420,-4,-83,-4,-5,-4,5,1,2,1,3,-1,2,1,-2,5,3,0,1,1,0,-1,0,0,-7,7,4,0,-1,-1,-1,-1,-1,6,-1
KR_6610732308,420,-2,-62,-8,-1,0,2,2,-2,3,1,3,1,4,-1,2,1,-1,1,0,0,-4,-3,-2,-5,7,1,0,-1,-1,-1,-1,-1,1,-1
KR_6502543064,440,-4,5,-19,-12,-1,1,0,-2,3,1,-6,6,0,-1,3,2,-2,3,1,0,-14,-18,0,-6,6,1,0,2,-1,1,1,-1,6,-1
KR_6740208610,420,-2,-14,-48,-7,1,3,4,-3,3,0,-5,7,2,3,3,6,-3,3,0,0,-2,2,2,-4,2,-6,0,0,-1,1,1,1,3,-1
KR_6763536943,440,-1,-7,-28,4,-2,3,1,-1,1,0,-2,4,2,1,0,1,8,1,9,0,4,-2,-1,-3,4,1,0,0,1,-1,1,1,1,-1
KR_6757878386,440,-1,2,24,-8,-1,3,2,0,0,0,-10,11,1,4,1,5,-1,3,2,0,-14,4,0,-1,1,-1,0,0,0,0,0,1,0,-1
KR_6755118709,440,2,-17,-28,4,0,1,1,4,1,5,-5,8,3,4,1,5,1,1,2,0,6,5,5,-7,2,0,0,-1,-1,-1,-1,-1,6,-1
KR_6620434274,420,-4,-66,-12,-4,3,2,5,-6,6,0,-1,2,1,3,1,4,-3,3,0,0,1,5,3,-7,4,1,0,0,-1,-1,0,-1,3,-1
KR_6745967915,420,-5,-75,0,-11,-1,2,1,-7,7,0,3,0,3,-5,5,0,-1,1,0,0,-14,7,-1,-7,8,-5,0,0,0,0,-1,-1,0,-1
KR_6752777317,420,-1,-19,-8,1,2,2,4,0,1,1,4,0,4,-3,5,2,-2,2,0,0,-1,-5,3,-4,1,0,0,0,-1,0,-1,1,3,-1
KR_6623138412,420,-3,-1,24,-8,1,0,1,-3,5,2,-5,5,0,-1,3,2,0,5,5,0,-14,-26,-8,0,8,-4,0,-1,-1,1,-1,-1,4,-1
KR_6704332032,440,1,70,2,-2,-1,1,0,-1,3,2,2,0,2,0,3,3,-2,3,1,0,0,-122,0,-1,1,0,0,0,1,1,1,-1,4,-1
KR_6740864834,420,-2,79,17,-5,0,3,3,-3,3,0,-1,3,2,-1,3,2,0,0,0,0,-8,1,4,-7,3,3,0,0,1,0,0,1,2,-1
KR_6685605260,420,-1,-67,0,-6,-2,6,4,-2,5,3,4,0,4,-7,8,1,1,0,1,0,-4,18,0,-6,6,0,0,0,-1,1,-1,-1,3,-1
KR_6753431706,420,-1,-27,-20,-4,-5,5,0,1,2,3,1,1,2,0,6,6,-1,2,1,-4,-3,-39,1,-5,4,-3,0,-1,1,-1,-1,-1,4,-1
KR_6725607037,420,-1,-36,8,-5,3,1,4,0,1,1,-4,5,1,-3,5,2,-1,2,1,0,-3,127,0,-4,4,-3,0,1,-1,1,1,-1,6,-1
KR_6683762765,420,-5,-30,-56,-11,-4,4,0,-7,9,2,0,0,0,3,0,3,-3,4,1,0,-6,253,8,-9,1,-2,0,-1,-1,-1,-1,-1,3,-1
KR_6760776922,420,0,-15,-1,-4,-2,3,1,-2,5,3,-3,4,1,3,2,5,0,2,2,-1,-5,141,-4,-2,6,-3,0,1,1,1,1,-1,4,-1
KR_6614826982,420,-4,-47,-27,-4,2,0,2,-4,6,2,1,1,2,-4,4,0,1,0,1,0,-7,-8,0,-4,4,0,0,0,-1,1,0,1,2,-1
KR_6750904655,420,-2,8,40,-9,-4,5,1,-3,3,0,-1,1,0,0,1,1,-1,1,0,0,-8,144,2,-5,3,-4,0,0,1,0,1,-1,2,-1
KR_6684874289,440,3,50,6,0,0,2,2,-1,3,2,3,1,4,-2,2,0,0,1,1,0,-1,-19,-1,-7,8,10,0,0,-1,-1,0,-1,5,-1
KR_6762010654,420,-4,-79,-15,-13,0,3,3,-3,4,1,-12,13,1,-1,4,3,3,2,5,-1,-2,-6,3,-4,1,-1,0,-1,-1,-1,-1,-1,3,-1
KR_6644817061,420,-8,-89,-44,-4,-5,6,1,-5,7,2,0,2,2,7,2,9,-1,3,2,0,-12,4,0,-4,4,0,0,-1,-1,-1,-1,1,3,-1
KR_6704909040,420,2,74,32,-7,4,3,7,1,1,2,-2,3,1,-5,5,0,-5,6,1,0,-16,-10,-2,-5,7,2,0,-2,1,-1,-1,-1,1,-1
KR_6764652674,420,-2,-49,-4,-1,-4,4,0,-3,4,1,1,0,1,4,3,7,1,1,2,0,-3,-10,-3,-2,5,1,0,0,-1,0,-1,1,2,-1
KR_6698709999,440,-2,-24,-12,-5,0,1,1,-3,5,2,0,0,0,2,1,3,-4,4,0,0,-10,-1,0,-5,5,1,0,0,0,-1,-1,1,0,-1
KR_6713214150,420,-4,-107,-25,-11,-5,5,0,-1,2,1,-2,5,3,-5,9,4,2,0,2,0,-4,-1,-7,-2,9,1,0,-1,-1,-1,-1,1,6,-1
KR_6750665239,420,-1,-82,-4,-3,-1,3,2,2,2,4,1,1,2,-5,7,2,0,0,0,0,-1,19,2,-3,1,2,0,0,1,1,1,-1,6,-1
KR_6724546643,420,0,-39,12,-4,-2,4,2,-3,6,3,2,0,2,-1,2,1,0,0,0,0,-7,-5,1,-6,5,-4,0,-2,-1,-1,-1,1,4,-1
KR_6751774581,440,-8,-53,-19,-20,-2,4,2,-4,7,3,-6,7,1,-7,7,0,-1,1,0,-1,-20,-40,2,-6,4,2,0,-2,1,-1,-1,-1,1,-1
KR_6699255124,420,-3,-40,-4,-11,-4,5,1,-1,1,0,-4,5,1,-1,2,1,-1,1,0,0,-8,6,0,-5,5,-2,0,-2,-1,-1,-1,1,1,-1
KR_6764129960,420,-2,-26,-42,0,2,1,3,1,3,4,0,0,0,-1,3,2,-2,2,0,0,-4,-18,2,-4,2,-3,0,0,-1,1,1,-1,1,-1
KR_6758916028,420,0,-53,0,1,-6,6,0,4,1,5,3,1,4,1,3,4,-1,1,0,0,1,8,2,-7,5,1,0,-1,1,-1,-1,1,6,-1
KR_6759232540,440,-3,-25,-9,-6,-6,7,1,3,3,6,2,3,5,-2,2,0,-3,3,0,0,-5,-6,0,-7,7,-1,0,0,-1,-1,-1,1,5,-1
KR_6609117734,420,-4,36,-8,-5,0,1,1,-1,4,3,-1,3,2,-3,4,1,0,1,1,1,2,-269,-1,-1,2,-26,0,1,-1,1,1,1,3,-1
KR_6764355284,420,0,13,7,7,0,3,3,1,2,3,0,3,3,7,2,9,-1,2,1,0,13,-8,-2,-6,8,8,0,0,1,0,0,1,4,-1
KR_6742273614,420,-4,-73,-8,-7,-3,4,1,-1,2,1,2,3,5,-4,4,0,-1,2,1,0,-4,-330,-4,-2,6,2,0,-1,1,0,-1,-1,5,-1
KR_6762097180,420,-4,-91,20,-5,0,2,2,2,2,4,-2,4,2,-5,5,0,0,2,2,0,-4,-8,1,-4,3,-5,0,-2,-1,1,-1,-1,1,-1
KR_6727075621,420,0,-1,12,-4,-1,4,3,0,2,2,-2,5,3,1,2,3,-2,2,0,0,2,-26,1,-3,2,3,0,0,-1,-1,0,-1,1,-1
KR_6686423639,440,-3,-23,-56,-8,-5,5,0,0,1,1,4,0,4,-4,15,11,-3,3,0,-1,-6,-21,3,-5,2,-1,0,-1,-1,0,-1,-1,1,-1
KR_6764245357,420,0,-78,-20,3,-4,6,2,2,0,2,5,0,5,1,4,5,-1,1,0,0,6,-7,-1,-5,6,24,0,-3,1,-1,-1,1,2,-1
KR_6731674519,420,-1,52,-16,-3,1,0,1,-6,7,1,2,1,3,0,1,1,0,0,0,0,-2,-5,-5,-3,8,-1,0,0,1,0,0,-1,4,-1
KR_6672760327,420,-1,-25,-6,-5,-5,6,1,-2,2,0,3,0,3,-1,2,1,0,1,1,0,-2,24,-2,-1,3,-2,0,-2,-1,-1,-1,1,6,-1
KR_6760929322,420,1,-17,-28,4,-5,5,0,2,2,4,1,3,4,6,1,7,0,1,1,-1,5,-1,0,-2,2,-2,0,-1,-1,-1,-1,-1,3,-1
KR_6643564640,440,-1,49,12,-9,1,1,2,-9,10,1,2,2,4,-2,4,2,-1,2,1,0,-13,26,1,-4,3,-1,0,0,0,0,0,-1,0,-1
KR_6729466026,420,-4,-36,-44,-3,1,1,2,-5,7,2,0,2,2,1,0,1,0,2,2,0,-4,-339,0,-3,3,4,0,0,-1,-1,0,1,5,-1
KR_6744132008,420,0,9,4,-4,0,3,3,-1,3,2,-1,1,0,-2,3,1,0,0,0,0,-10,-4,1,-3,2,3,0,0,0,0,-1,1,0,-1
KR_6761688640,420,-1,9,-10,2,-1,2,1,1,2,3,5,2,7,-1,1,0,-2,2,0,0,-6,19,-1,-4,5,2,0,0,-1,0,1,1,4,-1
KR_6734169003,420,-2,34,-34,-12,0,2,2,-4,8,4,-6,6,0,1,2,3,-3,3,0,-1,-9,-15,-1,-3,4,3,0,-1,-1,1,-1,-1,5,-1
KR_6743655647,420,-5,-79,-34,-6,1,1,2,-3,5,2,-3,4,1,-1,2,1,0,0,0,1,-5,-17,3,-7,4,-1,0,-1,-1,0,-1,1,4,-1
KR_6675338222,420,-3,6,-40,-6,-2,3,1,-2,3,1,2,1,3,-1,1,0,-3,3,0,0,-1,6,-4,-4,8,0,0,0,-1,1,0,-1,3,-1
KR_6683083387,420,-5,-94,-12,-7,2,4,6,0,2,2,-6,6,0,-3,4,1,0,2,2,-1,-9,-263,-7,-1,8,-3,0,-1,-1,1,1,1,2,-1
KR_6666458500,420,0,7,22,-3,-5,5,0,1,2,3,2,0,2,-1,1,0,0,0,0,0,1,147,-1,-4,5,-19,0,-2,-1,-1,-1,1,3,-1
KR_6639230024,420,-1,-15,-20,-5,0,2,2,3,1,4,-4,4,0,-4,5,1,0,1,1,0,1,2,-2,-3,5,4,0,0,1,1,1,-1,5,-1
KR_6759570654,440,-6,-30,-14,-19,2,0,2,-1,3,2,-3,4,1,-12,12,0,-5,6,1,0,-5,3,1,-1,0,-2,0,-1,-1,-1,-1,-1,3,-1
KR_6695375197,420,2,-22,-12,4,1,3,4,3,2,5,6,1,7,-1,2,1,-5,5,0,0,5,-6,-1,-1,2,1,0,-1,-1,-1,-1,-1,5,-1
KR_6751133730,420,-4,-50,-4,-9,-3,4,1,1,2,3,0,3,3,-7,8,1,0,0,0,0,-12,208,-2,-2,4,4,0,0,1,1,1,-1,4,-1
KR_6603512344,420,-2,-58,10,-3,-5,5,0,0,2,2,0,3,3,2,1,3,0,0,0,2,-2,1,1,-5,4,-4,0,-1,1,-1,-1,1,4,-1
KR_6698476532,420,-2,-33,0,-2,-5,6,1,4,1,5,2,3,5,-2,2,0,-1,1,0,0,1,11,0,-4,4,3,0,0,1,-1,0,-1,1,-1
KR_6761967259,420,5,3,0,4,-2,4,2,2,1,3,2,3,5,1,6,7,1,0,1,0,14,-20,2,-6,4,-2,0,-2,1,-1,-1,-1,2,-1
KR_6573018632,420,-4,-45,24,-14,-6,6,0,1,1,2,-4,6,2,-3,3,0,-2,2,0,0,-13,1,0,-6,6,-2,0,-2,-1,1,-1,-1,4,-1
KR_6752075771,440,-3,-105,-32,-6,-6,6,0,0,4,4,1,4,5,0,3,3,-1,1,0,0,0,20,-5,-3,8,-1,0,1,-1,-1,-1,-1,6,-1
KR_6753295436,420,-4,26,-8,-14,1,0,1,-8,8,0,2,0,2,-11,11,0,2,1,3,0,-24,-19,-2,-3,5,-3,0,-2,-1,0,-1,-1,1,-1
KR_6736443499,420,0,-1,3,-5,0,2,2,-5,11,6,1,1,2,4,1,5,-5,5,0,-1,-6,0,-1,-1,2,0,0,-1,-1,-1,-1,-1,5,-1
KR_6764262639,420,-2,-80,20,-15,-5,5,0,0,6,6,0,2,2,-8,8,0,-2,2,0,-1,-12,4,2,-5,3,-8,0,0,-1,1,0,-1,4,-1
KR_6700023511,440,-1,42,-16,1,3,0,3,1,1,2,1,1,2,-4,4,0,0,0,0,0,-1,56,0,-4,4,-3,0,0,1,-1,0,1,5,-1
KR_6654276225,420,-2,-10,14,-2,-1,1,0,4,1,5,-7,8,1,1,1,2,1,0,1,0,-4,66,0,-4,4,-1,0,-1,1,-1,-1,-1,6,-1
KR_6750734828,420,-3,-55,-24,-5,-2,2,0,0,8,8,-2,5,3,2,1,3,-3,3,0,0,0,-500,0,-1,1,4,0,-2,1,0,-1,1,2,-1
KR_6716441536,420,0,-33,-12,-1,-1,1,0,1,1,2,-1,3,2,-1,3,2,1,0,1,-2,-3,21,-1,-5,6,-1,0,0,-1,-1,0,-1,6,-1
KR_6730728779,420,-2,-59,25,-9,-7,7,0,-1,3,2,3,1,4,-3,6,3,-1,3,2,0,-18,-6,-4,0,4,-2,0,-2,-1,-1,-1,-1,5,-1
KR_6742840813,420,-1,-5,-4,-2,8,2,10,-1,4,3,-9,10,1,3,1,4,-3,3,0,1,-5,-138,-2,-4,6,-3,0,-2,-1,1,-1,1,4,-1
KR_6752648974,420,1,16,0,0,0,0,0,0,2,2,-2,4,2,2,3,5,0,2,2,0,-3,45,-2,-7,9,-27,0,-1,0,-1,-1,1,0,-1
KR_6753235716,420,0,13,-2,-7,0,1,1,-3,5,2,-6,6,0,1,1,2,1,0,1,0,-5,-4,0,-3,3,0,0,-1,-1,1,-1,-1,2,-1
KR_6755710271,420,4,101,48,4,3,2,5,-2,2,0,0,1,1,0,4,4,3,0,3,0,2,4,-1,-4,5,-1,0,0,-1,-1,1,-1,6,-1
KR_6688049141,420,-1,15,7,-3,2,3,5,-2,3,1,-4,8,4,-2,4,2,3,0,3,0,3,2,0,-4,4,1,0,0,0,1,-1,-1,0,-1
KR_6666001410,420,0,-2,-22,-2,-1,1,0,1,3,4,-3,8,5,2,1,3,-1,1,0,0,0,-333,1,-3,2,1,0,0,-1,-1,0,-1,6,-1
KR_6710645070,420,-1,-77,-9,-1,-2,5,3,0,2,2,1,0,1,-1,1,0,1,0,1,0,1,5,-1,-2,3,-3,0,-1,0,-1,-1,-1,0,-1
KR_6740271805,420,-1,-30,9,2,0,1,1,6,0,6,-4,5,1,-3,4,1,3,0,3,0,-1,2,1,-3,2,-1,0,0,1,1,0,1,2,-1
KR_6758010988,420,-2,-31,8,-12,-2,5,3,-2,2,0,-2,2,0,-4,6,2,-2,2,0,0,-16,2,0,-3,3,1,0,-1,1,-1,-1,1,5,-1
KR_6761875803,420,0,-19,-4,-3,1,1,2,4,1,5,-2,3,1,-4,4,0,-2,3,1,0,3,3,3,-7,4,-5,0,-1,-1,-1,-1,-1,3,-1
KR_6726186365,420,-4,9,12,-10,-2,2,0,-3,3,0,3,0,3,-1,3,2,-7,7,0,0,-8,0,1,-2,1,-1,0,0,-1,-1,-1,-1,2,-1
KR_6631270065,420,1,34,19,2,1,3,4,3,1,4,2,1,3,-4,5,1,0,0,0,0,-5,-8,-2,-2,4,-2,0,1,-1,1,1,-1,5,-1
KR_6741407045,420,2,0,18,1,-1,3,2,-2,4,2,2,3,5,1,0,1,1,0,1,-1,2,31,-4,-2,6,-17,0,-1,1,-1,1,-1,1,-1
KR_6729768314,420,0,3,-36,-5,5,0,5,0,2,2,-2,7,5,-8,8,0,0,0,0,-1,-10,-41,1,-3,2,20,0,1,-1,1,1,-1,4,-1
KR_6742395028,420,-2,-43,-44,-1,2,1,3,1,2,3,-2,3,1,-1,1,0,-1,1,0,0,0,-126,4,-5,1,-4,0,0,-1,1,0,1,4,-1
KR_6672206214,420,0,-28,-14,2,-3,4,1,-2,2,0,5,1,6,3,2,5,-1,1,0,1,3,-222,3,-5,2,-5,0,1,-1,1,1,1,6,-1
KR_6760257858,420,-1,-47,-1,-4,-7,7,0,0,1,1,3,1,4,0,3,3,0,0,0,1,1,5,-4,-3,7,0,0,0,-1,-1,0,1,2,-1
KR_6756679445,420,0,34,0,-1,1,3,4,-1,1,0,2,2,4,-1,5,4,-2,3,1,0,-6,-4,-1,-6,7,5,0,0,0,-1,0,-1,0,-1
KR_6757034140,440,-5,-51,-10,-9,-1,2,1,-7,7,0,-3,3,0,1,3,4,1,1,2,0,-10,-104,-2,-1,3,-5,0,-1,1,-1,-1,1,3,-1
KR_6705192781,420,0,48,4,-4,0,3,3,-4,4,0,-2,2,0,-1,1,0,3,4,7,0,0,-4,1,-2,1,-3,0,1,1,-1,-1,1,6,-1
KR_6738368217,440,-4,-96,-26,-9,-1,2,1,-1,4,3,1,2,3,-1,3,2,-7,8,1,0,-2,3,4,-4,0,-3,0,-2,-1,-1,-1,1,6,-1
KR_6752028647,420,-4,-23,-4,-4,-1,2,1,1,3,4,-6,6,0,1,2,3,1,2,3,0,-4,-118,3,-4,1,0,0,-2,-1,-1,-1,1,4,-1
KR_6731586637,420,-2,-49,-4,-5,-2,3,1,-2,5,3,-3,7,4,2,0,2,0,0,0,0,1,-14,2,-2,0,-1,0,0,0,0,0,-1,0,-1
KR_6377971169,420,1,-39,5,0,0,1,1,-1,6,5,3,2,5,-2,4,2,0,1,1,0,-1,1,2,-6,4,2,0,1,1,1,1,1,4,-1
KR_6761302662,420,-1,-2,-38,3,2,3,5,2,1,3,4,1,5,-4,4,0,-1,1,0,2,6,-7,-1,-6,7,3,0,-1,-1,1,-1,1,5,-1
KR_6738742483,420,-1,99,35,-4,1,3,4,-4,6,2,-1,3,2,-1,2,1,1,1,2,-1,-9,1,-1,-5,6,-2,0,3,-1,1,1,-1,4,-1
KR_6673282052,420,-2,-17,-9,-7,1,1,2,-3,6,3,-6,6,0,0,2,2,1,1,2,0,-10,1,-2,-2,4,-2,0,-1,0,-1,-1,1,0,-1
KR_6753171227,440,-4,-93,53,-15,-4,5,1,-3,5,2,-1,2,1,-2,3,1,-5,5,0,0,-14,3,3,-3,0,-1,0,-2,1,1,-1,-1,5,-1
KR_6743900909,440,-1,-118,36,-7,-3,3,0,5,0,5,-4,6,2,-3,4,1,-2,2,0,-2,-1,-12,-8,-1,9,2,0,-1,-1,1,1,-1,6,-1
KR_6751675385,420,-6,-80,-52,-12,-3,7,4,-6,8,2,0,2,2,-1,1,0,-2,2,0,-2,-14,182,-4,-2,6,3,0,-3,-1,-1,-1,-1,1,-1
KR_6747876576,440,-1,29,12,-5,5,2,7,-1,2,1,0,1,1,-5,5,0,-4,5,1,-2,-10,2,-6,0,6,-1,0,-1,1,-1,-1,-1,6,-1
KR_6755685097,420,0,-10,-5,-2,1,1,2,0,2,2,1,0,1,-3,4,1,-1,1,0,0,-6,-6,0,-5,5,3,0,0,-1,1,0,-1,4,-1
KR_6714833510,420,-3,5,-37,1,0,3,3,6,0,6,4,0,4,-11,14,3,2,0,2,1,9,-10,-3,-1,4,3,0,0,1,1,-1,1,6,-1
KR_6755126885,420,-3,19,1,0,-2,3,1,5,1,6,-2,4,2,-2,2,0,1,0,1,0,-3,-14,0,-3,3,1,0,0,1,-1,0,-1,5,-1
KR_6697711066,440,2,-15,11,-7,6,0,6,2,1,3,-10,11,1,-4,4,0,-1,2,1,0,-3,32,0,-2,2,-17,0,1,-1,-1,1,-1,2,-1
KR_6745958601,440,-2,-9,-3,-10,-4,7,3,-3,3,0,-2,3,1,-1,2,1,0,0,0,0,-12,6,-4,-3,7,4,0,-1,1,-1,-1,-1,4,-1
KR_6760808763,420,-3,-27,-14,-5,-1,4,3,-3,6,3,-2,3,1,2,1,3,-1,2,1,-1,5,6,-1,-4,5,-2,0,-1,0,-1,-1,-1,0,-1
KR_6692899567,420,-1,-10,-6,1,5,0,5,1,3,4,-1,3,2,-3,6,3,-1,2,1,-1,-2,2,1,-5,4,2,0,0,-1,-1,0,-1,6,-1
KR_6690191797,420,-3,-76,-8,-11,-2,4,2,-4,4,0,1,3,4,-5,6,1,-1,1,0,0,-12,0,-5,-3,8,-4,0,0,1,1,-1,1,4,-1
KR_6606182571,420,-3,-94,11,-7,-2,3,1,-5,5,0,1,3,4,-1,3,2,0,0,0,0,-4,-2,-1,-1,2,-5,0,-1,-1,-1,-1,1,6,-1
KR_6631162733,420,-2,-38,5,-1,-1,4,3,0,1,1,0,3,3,0,3,3,0,0,0,0,9,-12,-3,-4,7,5,0,-1,1,-1,-1,1,3,-1
KR_6653311277,420,-3,-18,4,-15,-2,2,0,-3,6,3,-2,2,0,-5,7,2,-3,8,5,1,-8,213,-2,-2,4,2,0,0,-1,-1,0,-1,3,-1
KR_6751755389,420,-1,-40,-15,2,3,0,3,3,1,4,2,4,6,-7,7,0,1,1,2,-1,3,2,-1,-4,5,2,0,-1,1,-1,-1,-1,5,-1
KR_6732970171,420,-3,-36,-30,-2,2,1,3,1,0,1,1,1,2,-4,5,1,-2,2,0,0,-2,11,3,-7,4,-1,0,-2,1,1,-1,-1,6,-1
KR_6651953405,420,-6,-86,-15,-17,2,0,2,-1,2,1,0,2,2,-16,16,0,-2,3,1,0,-23,22,-2,-8,10,-17,0,-1,-1,1,-1,-1,4,-1
KR_6741339701,420,1,63,32,7,-4,5,1,3,1,4,0,2,2,10,2,12,-2,3,1,2,8,259,4,-7,3,2,0,0,1,-1,0,1,3,-1
KR_6739266273,420,1,-34,-12,1,-4,5,1,7,1,8,-2,3,1,-1,2,1,1,0,1,0,11,-309,1,-3,2,0,0,-1,1,-1,-1,-1,4,-1
KR_6710284995,420,-3,-73,-20,-1,-2,4,2,-3,5,2,0,0,0,3,1,4,1,1,2,0,0,5,-1,-4,5,1,0,-1,-1,1,-1,1,3,-1
KR_6670345358,420,0,-76,-50,2,1,2,3,-5,7,2,4,2,6,1,2,3,1,0,1,0,0,-3,-1,-3,4,0,0,-2,-1,-1,-1,-1,3,-1
KR_6604338605,420,-1,-76,8,4,2,2,4,4,0,4,0,2,2,-1,2,1,-1,3,2,0,2,1,4,-8,4,-1,0,0,0,1,-1,1,0,-1
KR_6761969253,420,-1,-98,8,-1,0,2,2,1,2,3,-3,3,0,2,2,4,-1,1,0,1,2,-8,-3,-3,6,6,0,0,1,0,0,1,1,-1
KR_6750541974,420,-3,-35,-13,-1,2,2,4,1,2,3,-1,2,1,-2,2,0,-1,1,0,0,-1,-6,3,-6,3,-2,0,-1,1,1,-1,1,6,-1
KR_6757907129,420,-3,-53,8,-5,-2,5,3,-1,2,1,-1,3,2,2,2,4,-3,7,4,-1,-6,-7,-2,0,2,-1,0,-1,-1,-1,-1,-1,4,-1
KR_6731933615,420,-3,-7,-13,-5,1,1,2,-2,3,1,-3,3,0,-1,6,5,0,0,0,0,2,3,2,-6,4,-2,0,0,-1,-1,-1,-1,6,-1
KR_6759483769,420,-2,-42,-28,1,1,2,3,-3,4,1,0,2,2,5,2,7,-2,3,1,0,-3,-8,1,-4,3,0,0,0,-1,0,0,1,3,-1
KR_6761561534,420,-1,-24,32,-6,-2,2,0,0,1,1,-4,6,2,1,4,5,-1,1,0,0,2,9,2,-6,4,-5,0,0,-1,1,-1,-1,5,-1
KR_6746882050,420,-4,-91,-40,-8,0,3,3,-1,1,0,-4,5,1,-2,5,3,-1,2,1,0,-2,25,3,-5,2,0,0,-1,0,0,-1,1,0,-1
KR_6620449723,420,0,-15,8,-1,2,1,3,0,2,2,-1,1,0,-2,2,0,0,0,0,0,-2,27,0,-7,7,-1,0,-1,1,-1,-1,-1,4,-1
KR_6727952380,420,-3,-52,2,0,-3,3,0,4,1,5,-5,5,0,3,1,4,1,2,3,0,2,-17,-5,-2,7,3,0,-1,-1,0,-1,-1,3,-1
KR_6675670834,420,2,-24,24,12,8,1,9,-7,8,1,3,5,8,8,3,11,0,2,2,-1,7,5,4,-5,1,0,0,2,-1,-1,1,-1,3,-1
KR_6317366949,420,-5,-67,7,-15,0,2,2,-3,3,0,-4,5,1,-7,7,0,-1,2,1,0,-15,-4,-6,-1,7,-1,0,-2,-1,-1,-1,-1,1,-1
KR_6764301377,420,1,-22,0,7,-1,2,1,3,1,4,11,3,14,-6,8,2,0,0,0,0,-1,-10,1,-2,1,0,0,0,1,-1,-1,1,6,-1
KR_6611883540,420,-4,-46,24,-2,1,1,2,6,0,6,-4,4,0,0,5,5,-5,6,1,0,-5,23,1,-3,2,0,0,-2,1,-1,-1,1,3,-1
KR_6762423009,420,-2,37,-8,-2,1,1,2,1,0,1,-4,6,2,0,1,1,0,3,3,0,2,-34,-3,-4,7,26,0,-1,1,-1,-1,-1,4,-1
KR_6750514210,420,-3,-95,-4,-5,0,0,0,-1,3,2,-4,4,0,-1,1,0,1,0,1,0,-2,-2,3,-8,5,-5,0,0,-1,0,0,-1,1,-1
KR_6687724392,420,0,49,-28,0,0,4,4,6,1,7,-2,3,1,-1,3,2,-3,3,0,0,-4,-7,-6,-3,9,3,0,-2,-1,-1,-1,1,4,-1
KR_6621661104,420,1,-11,-3,2,-3,4,1,-3,3,0,2,3,5,3,0,3,3,1,4,0,6,-4,0,-3,3,-1,0,-3,0,-1,-1,1,0,-1
KR_6740152287,440,-1,-28,8,-7,1,4,5,-1,3,2,1,1,2,-6,8,2,-2,3,1,0,-10,12,0,-4,4,-1,0,0,0,-1,-1,-1,0,-1
KR_6683031125,420,-1,-80,12,-5,2,0,2,-2,3,1,-1,3,2,-1,1,0,-3,4,1,0,-2,-2,1,-2,1,-1,0,1,0,1,-1,-1,0,-1
KR_6654960919,420,1,2,-32,-5,-2,2,0,0,1,1,1,1,2,-5,8,3,1,1,2,0,0,8,-2,-5,7,5,0,-1,-1,-1,-1,1,4,-1
KR_6758974417,420,0,-34,-24,-3,1,2,3,3,4,7,2,0,2,-9,9,0,0,0,0,1,-2,1,-5,-2,7,0,0,0,-1,-1,0,1,3,-1
KR_6764253292,420,-2,-16,5,-9,-2,4,2,0,2,2,2,1,3,-5,5,0,-4,4,0,0,-6,-48,-2,-4,6,17,0,-1,1,1,-1,1,5,-1
KR_6757895409,420,3,85,12,5,2,1,3,1,1,2,6,1,7,-4,4,0,0,2,2,0,3,-16,-2,-3,5,5,0,1,-1,-1,1,1,6,-1
KR_6749477343,420,1,26,-22,0,-3,3,0,0,3,3,-2,3,1,3,0,3,2,0,2,0,5,-1,-1,-3,4,3,0,-1,1,-1,-1,-1,3,-1
KR_6657187067,420,1,30,-12,-7,1,3,4,2,0,2,-2,5,3,-6,6,0,-2,3,1,0,-8,6,-2,-1,3,-2,0,2,-1,1,1,1,5,-1
KR_6603746359,420,-3,-33,0,-10,-3,4,1,-3,3,0,-1,4,3,-2,5,3,-1,2,1,0,-8,-3,-1,-4,5,-2,0,-3,1,-1,-1,-1,2,-1
KR_6688572939,420,-1,42,-24,-2,0,1,1,1,3,4,0,3,3,-3,3,0,0,2,2,0,2,4,5,-9,4,1,0,0,-1,-1,-1,-1,4,-1
KR_6738136451,420,0,-8,32,-1,-4,7,3,2,1,3,-2,3,1,3,0,3,0,0,0,0,5,17,3,-6,3,-5,0,-1,-1,-1,-1,-1,3,-1
KR_6761242935,420,-5,2,-37,-11,-1,3,2,-5,8,3,2,1,3,-1,2,1,-6,8,2,0,-3,-13,-3,-8,11,4,0,-2,-1,-1,-1,-1,2,-1
KR_6762970717,440,-5,-25,-4,-10,1,1,2,1,3,4,-10,11,1,0,3,3,-2,4,2,0,-7,-5,-4,-2,6,3,0,-1,-1,-1,-1,-1,4,-1
KR_6699950722,420,1,-3,12,-4,-2,2,0,0,3,3,3,1,4,-4,7,3,-1,1,0,0,-11,-6,1,-4,3,-1,0,-2,0,1,-1,1,0,-1
KR_6627885809,420,-6,-39,-16,-7,-5,5,0,-2,3,1,0,4,4,-2,3,1,2,2,4,0,-2,-4,-1,-1,2,0,0,-2,1,-1,-1,-1,2,-1
KR_6763030011,420,-3,-69,-13,-7,-2,3,1,-3,5,2,1,0,1,-3,4,1,0,0,0,0,-12,9,-3,-4,7,-6,0,-1,-1,0,-1,-1,4,-1
KR_6634269702,420,-2,-29,-32,-6,2,0,2,2,2,4,-4,4,0,-6,6,0,0,0,0,0,-7,35,-1,-4,5,-23,0,1,1,1,1,1,4,-1
KR_6754820973,420,-3,13,-34,-3,2,1,3,-4,5,1,1,1,2,-2,3,1,0,0,0,0,-4,-45,-3,-1,4,21,0,-1,-1,-1,-1,-1,3,-1
KR_6758841831,420,-1,-4,4,2,-1,2,1,1,6,7,-1,2,1,2,1,3,1,0,1,0,2,-4,0,-2,2,1,0,-1,1,-1,-1,1,1,-1
KR_6753139440,420,-4,-19,-89,-3,0,1,1,-2,2,0,1,2,3,0,0,0,-2,3,1,0,-1,2,3,-6,3,-5,0,-2,-1,-1,-1,1,6,-1
KR_6728025409,420,-1,-25,0,-4,0,2,2,1,3,4,-8,8,0,3,0,3,0,1,1,0,-9,1,1,-4,3,-3,0,0,1,-1,0,1,6,-1
KR_6755489149,440,-2,21,-48,2,0,0,0,2,3,5,0,2,2,4,0,4,-4,5,1,0,3,7,5,-8,3,1,0,0,1,-1,0,1,1,-1
KR_6584201568,420,1,-27,-16,4,-1,2,1,-1,1,0,-1,2,1,6,2,8,1,0,1,0,6,-19,-3,-3,6,-4,0,-1,1,-1,-1,-1,1,-1
KR_6762645555,420,1,35,-3,11,0,2,2,4,0,4,4,1,5,2,1,3,1,2,3,0,7,14,6,-9,3,-4,0,2,0,1,1,1,0,-1
KR_6745113667,440,-9,-85,-14,-19,-9,9,0,-2,3,1,-4,6,2,-5,5,0,1,0,1,0,-11,-46,-4,-2,6,0,0,-3,-1,-1,-1,-1,6,-1
KR_6761829399,420,0,-29,0,3,0,0,0,-1,3,2,0,1,1,4,0,4,0,1,1,-1,1,23,-8,-1,9,-30,0,0,-1,1,0,-1,5,-1
KR_6703453711,440,-6,-83,-16,-21,-5,5,0,-1,4,3,-7,10,3,-2,3,1,-6,9,3,-1,-23,-1,0,-3,3,-4,0,0,-1,-1,1,-1,3,-1
KR_6540069793,420,4,75,4,1,0,2,2,0,5,5,-1,2,1,1,1,2,1,0,1,0,5,9,6,-13,7,-1,0,0,-1,1,0,1,5,-1
KR_6742001017,420,-1,10,-36,3,1,3,4,0,3,3,0,2,2,-1,2,1,3,0,3,0,7,-3,-2,-1,3,-2,0,0,0,0,0,1,0,-1
KR_6734439212,440,0,-50,4,4,2,0,2,2,1,3,2,2,4,-1,1,0,-1,2,1,0,0,27,0,-2,2,-25,0,0,-1,1,0,1,5,-1
KR_6728699685,420,-1,52,-6,-4,-3,4,1,0,1,1,0,1,1,-1,4,3,0,0,0,0,-2,5,0,-3,3,1,0,-1,0,-1,1,-1,0,-1
KR_6764289865,420,3,49,0,10,3,0,3,-4,4,0,10,0,10,2,3,5,-1,1,0,0,10,-163,3,-5,2,1,0,1,-1,-1,1,1,2,-1
KR_6755055756,420,-4,13,-8,-11,-1,2,1,-12,14,2,0,1,1,1,1,2,1,0,1,1,-9,0,0,-6,6,0,0,0,-1,-1,-1,1,5,-1
KR_6657113165,420,-3,-148,24,-5,-1,3,2,5,0,5,-3,4,1,-6,6,0,0,3,3,0,3,-1,2,-6,4,-1,0,-2,-1,1,-1,-1,1,-1
KR_6289144688,440,-8,-131,-32,-6,-4,4,0,-7,8,1,3,0,3,3,0,3,-1,1,0,0,5,23,0,-2,2,-2,0,-2,-1,-1,-1,-1,4,-1
KR_6659540654,420,-3,-125,-5,-15,0,3,3,-2,6,4,-2,3,1,-10,10,0,-1,1,0,-1,-21,1,-5,0,5,-3,0,-4,-1,-1,-1,-1,1,-1
KR_6719169076,420,-1,48,-18,-3,-1,2,1,-1,1,0,-2,2,0,0,0,0,1,2,3,0,-6,23,-5,-4,9,-8,0,1,1,0,1,-1,5,-1
KR_6709355259,420,-3,-13,-17,-9,4,0,4,-5,5,0,-3,3,0,-1,1,0,-4,5,1,0,-13,-23,-1,-4,5,3,0,-2,-1,1,-1,1,5,-1
KR_6603667704,420,1,-6,4,1,1,0,1,2,1,3,2,0,2,-3,5,2,-1,1,0,0,2,1,1,-4,3,-1,0,0,1,1,1,1,3,-1
KR_6716441026,420,1,67,5,1,1,1,2,1,4,5,0,1,1,-3,9,6,2,0,2,-1,4,-4,-1,-6,7,6,0,0,-1,0,-1,-1,2,-1
KR_6764501033,420,-2,-12,0,-6,0,0,0,1,2,3,-4,4,0,0,2,2,-3,3,0,0,-10,4,2,-5,3,-1,0,0,1,-1,0,-1,4,-1
KR_6763951763,420,-1,-14,-14,-2,1,0,1,-1,1,0,-2,4,2,0,0,0,0,0,0,0,-4,23,-4,-3,7,0,0,-1,0,1,-1,-1,0,-1
KR_6683021079,420,-3,-28,16,-11,-2,2,0,3,0,3,-2,5,3,-10,11,1,0,0,0,0,-12,-3,0,-4,4,1,0,0,-1,1,0,-1,6,-1
KR_6605778453,420,2,-19,0,-9,-4,5,1,1,2,3,-6,7,1,2,2,4,-2,3,1,-1,-13,-4,3,-6,3,0,0,-1,1,-1,-1,-1,6,-1
KR_6742789985,420,-2,-2,-7,-5,-2,2,0,0,1,1,-5,5,0,0,2,2,2,1,3,0,-1,28,0,-5,5,-5,0,0,-1,-1,-1,-1,5,-1
KR_6716657899,420,2,66,-20,6,1,0,1,-1,4,3,4,1,5,2,0,2,0,1,1,0,7,5,5,-10,5,-5,0,0,1,0,0,1,2,-1
KR_6514215127,420,0,10,14,2,4,3,7,4,1,5,0,4,4,-5,7,2,-1,2,1,-2,-2,0,0,-3,3,-1,0,1,1,0,1,-1,1,-1
KR_6725209801,420,-4,41,-16,-10,-1,2,1,-7,9,2,-1,3,2,-1,4,3,0,1,1,1,-5,-4,-3,-1,4,-5,0,0,-1,-1,0,1,1,-1
KR_6764323579,420,-4,-12,-25,-12,-4,4,0,1,0,1,-2,2,0,-4,6,2,-3,3,0,-1,-13,-11,-8,-1,9,5,0,-1,-1,1,-1,-1,6,-1
KR_6664889667,420,1,-86,24,-4,1,0,1,-3,3,0,-4,5,1,2,0,2,0,1,1,0,2,15,-1,-1,2,-3,0,0,-1,-1,-1,-1,4,-1
KR_6701512441,420,1,30,12,-8,3,3,6,1,5,6,0,2,2,-7,8,1,-5,5,0,-2,-11,-12,-4,-2,6,0,0,0,-1,-1,-1,-1,3,-1
KR_6758742010,420,-5,-38,0,-8,-2,2,0,-3,4,1,-2,2,0,1,1,2,-2,3,1,0,-6,-3,-1,-2,3,3,0,-1,-1,-1,-1,1,3,-1
KR_6663544898,440,-6,-87,2,-6,-4,6,2,-2,3,1,-8,9,1,8,0,8,0,1,1,0,-2,-7,-4,0,4,0,0,-1,-1,-1,-1,-1,2,-1
KR_6677808189,420,0,48,0,-3,2,1,3,-3,5,2,-1,5,4,-2,4,2,1,1,2,-1,-3,-201,0,-6,6,0,0,-1,1,-1,-1,-1,2,-1
KR_6632089119,420,-5,-19,-14,-4,-1,3,2,0,2,2,-1,1,0,-2,3,1,0,1,1,0,-3,88,-5,-5,10,2,0,0,1,-1,0,1,6,-1
KR_6662113326,420,-1,-62,4,-2,0,3,3,2,0,2,-2,3,1,-1,3,2,-1,3,2,-1,5,3,1,-5,4,-3,0,1,-1,1,1,-1,6,-1
KR_6760264047,420,0,-13,-4,-2,-3,4,1,-4,4,0,5,3,8,-1,5,4,1,1,2,-1,-1,-10,-2,-3,5,3,0,-1,-1,0,-1,-1,3,-1
KR_6725169638,420,-6,-120,-6,-22,-8,9,1,-2,4,2,-5,5,0,-2,4,2,-5,5,0,-1,-12,-1,0,-4,4,-1,0,-4,-1,-1,-1,-1,2,-1
KR_6518744873,440,-2,-42,-24,2,1,1,2,0,2,2,1,3,4,0,1,1,0,1,1,1,4,-25,3,-5,2,0,0,0,-1,1,1,1,2,-1
KR_6764614811,420,-3,5,-27,-9,2,1,3,-2,5,3,-2,4,2,-5,5,0,-2,2,0,0,-7,-21,0,-5,5,1,0,-1,-1,-1,-1,-1,6,-1
KR_6742647523,420,1,24,-16,5,1,1,2,3,0,3,-4,4,0,5,0,5,0,0,0,0,9,-15,4,-6,2,-1,0,0,1,-1,0,1,6,-1
KR_6752720499,420,1,33,-2,-1,0,2,2,2,6,8,-1,2,1,-1,1,0,-1,1,0,0,0,-5,0,-4,4,4,0,0,0,0,0,1,0,-1
KR_6747030282,420,-4,-57,-8,-6,1,2,3,-4,6,2,-3,9,6,0,1,1,0,1,1,0,-4,-7,2,-2,0,-1,0,-1,-1,-1,-1,1,6,-1
KR_6760597841,440,-5,-99,-32,-3,-7,7,0,-1,1,0,-2,6,4,7,0,7,0,2,2,1,6,4,4,-4,0,0,0,-2,1,1,-1,1,4,-1
KR_6624391290,420,-1,49,-24,-2,-1,2,1,-3,5,2,-1,2,1,3,1,4,0,0,0,0,-1,5,2,-4,2,1,0,0,1,-1,-1,-1,1,-1
KR_6741680124,420,-1,-24,11,-3,-1,2,1,0,2,2,0,3,3,0,0,0,-2,2,0,0,-11,-25,-1,-2,3,1,0,1,-1,1,1,-1,4,-1
KR_6620210875,420,0,47,8,-3,-2,3,1,2,1,3,0,3,3,-2,2,0,-1,1,0,0,-8,-27,6,-8,2,-3,0,2,-1,1,1,-1,2,-1
KR_6741629226,420,1,-8,4,0,1,0,1,2,0,2,-2,4,2,-2,3,1,1,1,2,0,4,0,4,-8,4,4,0,1,-1,1,1,-1,5,-1
KR_6719295355,440,1,-4,7,8,-4,5,1,-1,1,0,6,4,10,1,2,3,6,1,7,0,14,6,6,-6,0,2,0,1,1,0,1,1,3,-1
KR_6742002945,440,-3,-82,-68,-6,-5,5,0,0,3,3,-2,3,1,1,0,1,0,1,1,-1,-7,-16,-3,0,3,1,0,-2,-1,0,-1,-1,5,-1
KR_6659070086,420,-2,31,-9,-8,1,0,1,-6,8,2,-4,4,0,1,1,2,0,1,1,0,-4,17,-4,-1,5,-1,0,-1,0,-1,-1,-1,0,-1
KR_6762683067,420,-1,-51,-8,1,2,0,2,2,1,3,-3,3,0,2,0,2,-2,3,1,0,-1,-10,-5,-5,10,0,0,-2,-1,-1,-1,-1,3,-1
KR_6753529189,420,-2,-10,-2,0,0,1,1,1,2,3,4,1,5,-4,6,2,-1,1,0,0,7,3,4,-6,2,-4,0,-1,1,-1,-1,1,4,-1
KR_6750833214,420,0,-39,12,-8,-1,4,3,-3,11,8,-4,4,0,1,3,4,-1,1,0,0,-7,0,0,-4,4,-1,0,0,-1,1,0,-1,3,-1
KR_6762791450,420,-2,-27,-27,-6,-5,6,1,0,1,1,-2,3,1,3,1,4,-2,2,0,0,-4,12,-6,0,6,3,0,-2,-1,-1,-1,-1,6,-1
KR_6619140787,420,-1,-21,-16,-1,-3,4,1,3,4,7,-1,2,1,-1,4,3,1,0,1,0,0,-2,2,-8,6,1,0,-2,-1,-1,-1,1,4,-1
KR_6740834996,420,-4,-26,-3,7,1,2,3,1,1,2,-4,4,0,8,0,8,1,0,1,0,4,-7,0,-1,1,1,0,0,-1,1,1,-1,3,-1
KR_6760766517,420,-5,5,8,-8,-2,2,0,-3,4,1,-1,2,1,-4,6,2,2,0,2,1,-6,22,-1,-4,5,-8,0,0,-1,-1,1,1,3,-1
KR_6676215224,420,0,29,19,-2,-3,3,0,1,1,2,-1,2,1,0,0,0,1,0,1,0,6,-3,2,-5,3,-1,0,0,1,-1,-1,-1,5,-1
KR_6741421270,440,-5,-13,-33,-12,-4,5,1,-1,2,1,3,0,3,-7,8,1,-3,8,5,2,-5,-11,-3,-1,4,0,0,-1,-1,1,-1,1,6,-1
KR_6594053404,420,-2,-35,-1,-8,1,1,2,-6,8,2,-3,4,1,-2,2,0,2,1,3,-1,-11,39,-5,-2,7,-14,0,-1,-1,-1,-1,-1,1,-1
KR_6699711718,420,-4,-85,-24,-7,-3,4,1,0,3,3,-5,5,0,2,0,2,-1,1,0,-2,-9,-2,0,-8,8,-2,0,-2,-1,-1,-1,-1,6,-1
KR_6747499450,420,-5,-3,-16,-20,-4,4,0,-9,11,2,-1,3,2,-5,7,2,-1,4,3,0,-16,0,-3,-3,6,2,0,0,-1,-1,-1,-1,3,-1
KR_6752540052,420,3,43,-28,10,3,0,3,-3,3,0,3,6,9,5,4,9,2,1,3,0,2,183,-4,-1,5,-1,0,2,-1,1,1,1,4,-1
KR_6723252587,420,-5,-41,-28,-9,-1,1,0,0,1,1,-1,2,1,-4,5,1,-3,3,0,0,-9,-11,-3,-3,6,-7,0,-1,-1,-1,-1,-1,2,-1
KR_6689404579,420,-3,-74,-1,-10,-5,5,0,-3,4,1,7,1,8,-8,9,1,-1,1,0,-2,-17,-3,-1,-5,6,-2,0,0,1,1,-1,-1,3,-1
KR_6764465795,420,1,28,-14,3,2,2,4,1,5,6,3,1,4,-2,4,2,-1,1,0,0,2,8,5,-9,4,-5,0,2,-1,1,1,1,3,-1
KR_6647247914,420,-2,-116,-52,-9,1,0,1,-5,7,2,-3,5,2,-2,3,1,0,1,1,-2,-12,-1,2,-7,5,2,0,0,-1,1,-1,-1,5,-1
KR_6756768557,420,0,52,-4,-7,1,1,2,-8,8,0,3,1,4,-2,3,1,-1,2,1,0,-10,-29,-5,-1,6,5,0,0,0,-1,-1,1,0,-1
KR_6741452886,420,0,1,-22,5,-2,2,0,2,2,4,2,3,5,3,2,5,0,0,0,0,10,-29,-1,-7,8,2,0,0,-1,-1,1,1,4,-1
KR_6756788179,440,0,-51,-22,-8,-5,5,0,-2,3,1,-2,5,3,2,1,3,-1,1,0,0,0,-6,-4,-2,6,4,0,-1,-1,-1,-1,-1,4,-1
KR_6751830824,420,0,63,36,-3,2,0,2,-2,3,1,1,1,2,0,5,5,-4,5,1,0,-3,-7,1,-4,3,-1,0,0,0,-1,0,-1,0,-1
KR_6730612120,440,-1,-88,28,-5,-3,5,2,1,4,5,4,1,5,-6,7,1,-1,1,0,-2,-13,14,-1,-2,3,-2,0,-1,1,0,-1,-1,3,-1
KR_6659647148,420,-1,-10,-41,-4,0,4,4,-5,6,1,0,1,1,-1,2,1,2,0,2,0,0,5,-4,-3,7,-1,0,0,-1,-1,0,1,5,-1
KR_6720427552,420,-2,-77,-18,-3,1,1,2,-5,6,1,-1,3,2,5,3,8,-3,3,0,0,-3,-419,-7,0,7,2,0,0,-1,1,0,-1,4,-1
KR_6758950924,420,-2,-11,-60,0,4,0,4,-2,3,1,-2,4,2,1,1,2,-1,2,1,0,2,-46,-2,-2,4,30,0,0,-1,-1,-1,-1,5,-1
KR_6738847944,420,-4,-45,-4,-6,1,2,3,-1,6,5,-5,6,1,-1,3,2,0,4,4,0,-8,-23,2,-5,3,2,0,0,-1,1,0,1,4,-1
KR_6656815875,420,-4,-56,-13,-6,2,3,5,-5,5,0,4,2,6,-8,8,0,1,0,1,1,-11,10,-4,-2,6,-2,0,1,-1,-1,-1,1,2,-1
KR_6701487696,420,-2,-57,-20,-7,0,1,1,-8,10,2,0,2,2,1,2,3,0,1,1,0,-4,-15,1,-6,5,0,0,-1,1,-1,-1,-1,6,-1
KR_6742047727,420,-4,-7,32,-7,-5,5,0,-1,2,1,4,0,4,-4,7,3,-1,1,0,0,-4,-4,-2,-1,3,-1,0,0,0,-1,0,1,0,-1
KR_6695227452,420,-3,-33,3,-1,-3,5,2,2,2,4,0,2,2,-1,3,2,1,0,1,0,-5,34,2,-7,5,-24,0,0,1,-1,0,1,1,-1
KR_6736111479,420,0,9,-24,4,-2,4,2,4,1,5,-1,3,2,0,4,4,3,2,5,0,7,12,5,-7,2,0,0,0,0,0,0,-1,0,-1
KR_6759784906,420,-2,-2,-13,-1,0,0,0,3,1,4,-2,3,1,0,5,5,-2,2,0,0,5,-45,3,-5,2,19,0,0,-1,-1,-1,-1,3,-1
KR_6759747723,420,-5,-55,-24,-10,1,4,5,-3,5,2,-1,1,0,-7,7,0,0,3,3,0,-5,2,-3,0,3,3,0,-1,0,0,-1,-1,0,-1
KR_6728763781,440,-4,-17,-21,-10,0,1,1,0,2,2,-7,9,2,-4,5,1,1,3,4,0,-4,40,1,-3,2,-27,0,-2,-1,-1,-1,-1,2,-1
KR_6737726175,420,-3,6,-16,-6,-1,3,2,-1,4,3,-4,4,0,1,3,4,-1,2,1,0,2,105,0,-3,3,-1,0,0,1,0,0,-1,1,-1
KR_6762634730,420,-2,17,4,-6,-5,6,1,-1,2,1,-4,6,2,3,2,5,1,0,1,0,-7,-5,-4,-5,9,4,0,-2,0,-1,-1,-1,0,-1
KR_6741919610,420,-3,-34,-34,2,-1,2,1,-1,4,3,3,1,4,2,1,3,-1,2,1,3,7,-50,6,-9,3,12,0,0,-1,0,0,1,2,-1
KR_6737799809,420,1,95,-17,0,1,1,2,-9,10,1,7,3,10,4,1,5,-3,5,2,1,-4,-216,1,-4,3,-1,0,2,1,1,1,1,2,-1
KR_6649752114,420,-5,-120,3,-19,-3,4,1,-4,7,3,0,1,1,-10,10,0,-2,3,1,-1,-18,-14,-4,-3,7,7,0,-3,0,-1,-1,-1,0,-1
KR_6512056916,420,-2,-59,-8,-13,-1,3,2,-5,5,0,0,3,3,-6,8,2,-1,3,2,-2,-15,5,0,-6,6,-3,0,0,-1,0,-1,-1,3,-1
KR_6601530182,420,-2,-33,-47,2,-1,2,1,-1,3,2,0,3,3,2,3,5,2,1,3,0,4,-47,1,-2,1,4,0,-1,1,0,-1,1,3,-1
KR_6619345070,420,-4,0,8,-5,-5,5,0,5,1,6,4,0,4,-6,7,1,-3,3,0,1,-10,-2,0,-4,4,0,0,-3,1,-1,-1,1,5,-1
KR_6740317644,440,-3,-20,14,-5,-2,4,2,-3,4,1,-3,4,1,5,0,5,-2,4,2,-1,-10,-1,-2,0,2,-1,0,-2,-1,1,-1,-1,3,-1
KR_6649994925,420,0,133,-32,-2,5,0,5,1,2,3,-2,2,0,-5,5,0,-1,2,1,0,-12,-6,1,-2,1,2,0,1,1,-1,1,-1,5,-1
KR_6599630701,420,-3,56,-40,-7,3,0,3,-3,6,3,-5,6,1,-3,3,0,1,1,2,0,-5,-170,0,-3,3,-1,0,-1,-1,-1,-1,-1,6,-1
KR_6727031143,420,-4,-33,-25,-5,0,1,1,4,0,4,-5,5,0,-3,4,1,-1,1,0,0,-2,8,0,-6,6,0,0,-1,-1,-1,-1,1,2,-1
KR_6756485927,420,-2,-8,23,-8,-7,8,1,3,1,4,-2,5,3,-1,1,0,-1,2,1,0,-1,3,2,-5,3,-2,0,-1,1,-1,-1,-1,5,-1
KR_6622983898,420,-3,-86,-6,-10,-3,4,1,-3,4,1,3,2,5,-6,7,1,-1,1,0,-3,-17,8,4,-7,3,-2,0,-1,-1,1,-1,-1,3,-1
KR_6731513407,420,-3,-58,0,-9,-1,3,2,-3,6,3,-2,2,0,-3,4,1,0,0,0,0,-10,4,1,-3,2,-8,0,0,1,-1,-1,-1,5,-1
KR_6742948999,440,-7,-68,-20,-9,1,0,1,-4,5,1,-5,6,1,-3,4,1,2,0,2,0,-7,4,-2,-3,5,-6,0,0,-1,0,0,-1,5,-1
KR_6749225909,420,-2,-60,-16,-1,1,1,2,1,2,3,0,4,4,-4,7,3,1,1,2,0,2,-11,-5,-2,7,2,0,-1,-1,0,-1,-1,3,-1
KR_6678438666,420,7,58,16,8,5,0,5,-1,1,0,-1,4,3,5,1,6,0,1,1,0,1,-4,-3,-2,5,3,0,4,-1,1,1,1,5,-1
KR_6763089104,420,-1,41,11,-1,1,0,1,-4,5,1,2,1,3,1,2,3,-1,1,0,1,-6,1,-1,-1,2,-2,0,0,1,1,1,1,4,-1
KR_6384392797,420,-2,-22,-34,-8,-2,2,0,-1,2,1,1,3,4,-8,8,0,2,1,3,0,-13,-16,-5,-4,9,-1,0,-1,-1,-1,-1,-1,5,-1
KR_6737143920,420,-4,-88,4,-7,-2,3,1,1,2,3,1,0,1,-7,8,1,0,1,1,0,-11,-60,1,-5,4,-6,0,-2,-1,-1,-1,-1,5,-1
KR_6718055355,420,-2,-62,-12,-2,1,1,2,1,3,4,0,2,2,-4,5,1,0,0,0,0,-3,-255,-4,-2,6,3,0,-1,1,-1,-1,-1,2,-1
KR_6473068810,420,-3,-44,-37,-3,2,0,2,0,2,2,-3,5,2,2,1,3,-4,4,0,0,-4,20,0,-5,5,1,0,-1,-1,-1,-1,-1,3,-1
KR_6760556475,420,-4,-59,22,-12,-2,3,1,1,1,2,-8,9,1,-2,2,0,-1,1,0,-1,-15,-3,-1,-7,8,-5,0,-2,-1,1,-1,-1,1,-1
KR_6680137393,420,-1,0,-5,-4,1,0,1,-4,5,1,-1,2,1,1,3,4,-1,2,1,0,-2,-207,-4,-9,13,2,0,-1,1,-1,-1,-1,1,-1
KR_6593452792,420,-1,-52,9,-4,2,1,3,-1,2,1,-6,8,2,1,2,3,0,0,0,0,3,11,4,-7,3,-1,0,0,-1,-1,0,1,5,-1
KR_6758693314,420,0,-34,8,-1,1,0,1,0,4,4,0,2,2,-3,6,3,1,0,1,1,-5,-134,0,-2,2,-4,0,0,1,1,-1,1,6,-1
KR_6764326428,420,2,54,-4,-6,-3,3,0,0,2,2,-3,6,3,1,1,2,-1,1,0,0,-8,-1,-1,-4,5,0,0,1,-1,0,1,1,1,-1
KR_6720292952,420,-5,-77,-19,-7,-6,7,1,-3,6,3,0,1,1,0,2,2,2,1,3,0,-7,-5,-2,-3,5,-4,0,-2,-1,-1,-1,-1,6,-1
KR_6621736181,420,0,-10,6,-5,2,2,4,-2,4,2,1,2,3,-7,7,0,1,2,3,0,-7,-132,-3,-1,4,-2,0,0,-1,-1,1,1,1,-1
KR_6764516971,420,-1,16,-4,-2,-1,3,2,-2,2,0,-1,1,0,2,1,3,0,0,0,0,-2,-2,-3,-2,5,2,0,0,-1,-1,-1,-1,4,-1
KR_6692913344,440,0,-66,32,3,-2,3,1,4,2,6,1,1,2,-3,5,2,3,0,3,1,6,-14,2,-3,1,4,0,-1,-1,1,-1,1,1,-1
KR_6745005349,440,-1,54,-20,4,3,0,3,-4,4,0,6,0,6,-1,2,1,0,0,0,0,1,6,-2,0,2,1,0,-1,1,-1,-1,1,3,-1
KR_6682029738,420,-7,-124,-36,-13,-2,3,1,-4,7,3,-2,5,3,0,2,2,-5,7,2,-1,-2,-46,-2,-1,3,25,0,-4,1,-1,-1,-1,5,-1
KR_6701921787,420,2,-12,0,6,0,3,3,2,2,4,-1,2,1,3,0,3,2,0,2,0,3,7,1,-4,3,-3,0,1,1,0,1,1,4,-1
KR_6648721819,420,-2,-101,-19,-5,-2,2,0,3,0,3,-10,11,1,3,3,6,1,0,1,0,9,29,0,-4,4,2,0,-2,-1,1,-1,-1,3,-1
KR_6631069105,420,-5,-11,-16,-9,-2,3,1,0,1,1,-2,3,1,-2,4,2,-3,4,1,0,-6,-7,0,-3,3,-1,0,-1,0,-1,-1,1,0,-1
KR_6749028592,420,-3,-4,-30,3,4,0,4,-3,3,0,3,1,4,-1,4,3,0,2,2,0,6,8,-2,0,2,2,0,0,-1,-1,0,-1,1,-1
KR_6669923889,420,-2,-17,10,-7,1,1,2,1,5,6,-5,6,1,-4,6,2,0,1,1,0,-8,2,-3,-3,6,2,0,0,1,-1,-1,-1,6,-1
KR_6756039513,440,-4,-143,16,-9,-6,7,1,2,0,2,-1,3,2,-2,3,1,-2,2,0,0,-4,-3,5,-8,3,0,0,-1,0,0,-1,-1,0,-1
KR_6686782637,420,-3,-47,-20,-5,0,0,0,-2,4,2,-2,3,1,-2,4,2,1,1,2,-2,-9,5,1,-6,5,-1,0,-1,1,-1,-1,-1,6,-1
KR_6741283917,420,1,20,12,4,3,1,4,0,4,4,3,0,3,-1,1,0,-1,1,0,0,-1,3,1,-3,2,2,0,0,1,1,1,1,2,-1
KR_6728275715,420,-4,-37,-8,-4,1,2,3,-1,4,3,-5,5,0,0,1,1,1,0,1,0,-3,-8,-1,-3,4,-5,0,0,-1,-1,-1,-1,1,-1
KR_6622808559,420,1,15,22,-1,1,0,1,2,2,4,-1,3,2,-2,5,3,-1,2,1,0,1,-16,-4,-2,6,0,0,-1,1,-1,-1,1,5,-1
KR_6719503265,420,0,-93,-20,1,-1,3,2,0,1,1,2,1,3,-1,4,3,1,1,2,0,6,100,6,-8,2,-4,0,-1,1,-1,-1,-1,2,-1
KR_6544580597,420,-1,-8,-28,2,-1,2,1,-1,4,3,-3,4,1,5,1,6,2,1,3,0,7,-13,-2,-5,7,4,0,0,-1,-1,-1,1,5,-1
KR_6741176144,420,-1,-16,4,-3,1,2,3,-4,4,0,-1,1,0,1,0,1,0,3,3,0,-9,-1,-1,-1,2,-3,0,0,1,-1,-1,1,3,-1
KR_6646149484,420,-7,-109,-27,-12,-7,7,0,-1,4,3,-3,3,0,0,3,3,-1,1,0,-1,-3,247,1,-6,5,0,0,-1,-1,-1,-1,-1,3,-1
KR_6748517778,440,-4,43,-36,-6,-1,1,0,-3,5,2,0,2,2,-2,3,1,0,1,1,0,-7,2,1,-7,6,4,0,-2,-1,-1,-1,-1,6,-1
KR_6751792558,420,-3,13,-15,-8,2,2,4,-3,5,2,-3,6,3,-4,5,1,0,0,0,0,-11,-19,-6,-2,8,-1,0,2,-1,1,1,1,6,-1
KR_6632564419,420,1,-51,-43,11,-1,1,0,3,1,4,2,2,4,8,1,9,-1,2,1,0,11,5,3,-7,4,-1,0,0,0,-1,0,1,0,-1
KR_6762943733,420,2,-22,4,5,0,0,0,2,4,6,0,0,0,1,2,3,2,4,6,-1,8,25,2,-7,5,-9,0,1,1,-1,1,1,4,-1
KR_6647167471,420,-4,-14,-24,-3,-1,3,2,-4,5,1,-2,3,1,4,4,8,0,0,0,0,-3,0,3,-6,3,-2,0,-1,-1,-1,-1,1,1,-1
KR_6733320679,420,-4,-22,-20,-11,-3,3,0,0,0,0,-4,5,1,-2,3,1,-2,2,0,0,-5,-106,-1,-4,5,-4,0,-1,0,-1,-1,-1,0,-1
KR_6588284386,420,-4,-14,-18,-9,0,1,1,-6,7,1,5,2,7,-5,7,2,-3,3,0,1,-4,8,2,-5,3,-2,0,0,-1,1,-1,1,6,-1
KR_6614366137,420,1,-32,-4,5,-2,2,0,6,0,6,-3,3,0,1,5,6,3,0,3,0,9,117,-1,-4,5,5,0,0,-1,1,1,-1,5,-1
KR_6726363564,420,-3,-86,6,-4,-3,4,1,5,4,9,-5,6,1,1,3,4,-2,3,1,0,-6,-27,4,-6,2,-4,0,-1,-1,1,-1,1,4,-1
KR_6749545111,420,-9,-51,-63,-16,1,3,4,-4,5,1,-1,1,0,-13,14,1,1,1,2,-1,-15,-5,1,-6,5,-3,0,-1,-1,-1,-1,-1,2,-1
KR_6657404491,420,-2,-40,-31,1,-2,6,4,3,2,5,1,3,4,-2,4,2,1,0,1,0,8,-3,-3,-1,4,1,0,0,1,-1,1,1,6,-1
KR_6702339062,420,-2,-9,-20,-10,-1,1,0,-4,4,0,1,1,2,-2,3,1,-4,4,0,0,-12,-14,2,-4,2,-6,0,-1,-1,1,-1,-1,4,-1
KR_6707933459,420,-1,-55,20,-9,0,3,3,-1,4,3,2,1,3,1,2,3,-11,12,1,-1,-18,-7,-1,-3,4,-1,0,-2,-1,1,-1,-1,6,-1
KR_6702159205,420,1,91,0,-6,-5,6,1,0,1,1,-1,2,1,2,1,3,-2,2,0,0,-10,5,2,-6,4,2,0,0,-1,0,0,-1,2,-1
KR_6682638072,420,-6,-69,-38,0,3,1,4,2,3,5,-4,4,0,0,3,3,-1,1,0,0,5,5,-2,-3,5,1,0,-3,-1,-1,-1,-1,6,-1
KR_6697217616,420,-5,-93,-14,-16,-2,2,0,-3,3,0,-4,5,1,-3,4,1,-4,4,0,0,-13,18,-1,-4,5,-5,0,-3,-1,-1,-1,-1,3,-1
KR_6725984102,440,1,24,4,-1,-4,6,2,-1,3,2,1,0,1,4,5,9,-1,1,0,0,0,-107,3,-8,5,2,0,0,-1,0,0,1,5,-1
KR_6740478343,420,-2,2,-46,3,0,0,0,2,3,5,2,1,3,0,2,2,-1,2,1,0,8,6,5,-7,2,0,0,-1,1,-1,-1,1,6,-1
KR_6756656721,420,-3,-4,-4,-8,0,1,1,-3,3,0,-5,6,1,2,0,2,-2,2,0,0,-4,1,4,-7,3,1,0,0,-1,-1,0,1,2,-1
KR_6624696014,420,0,-28,44,3,4,0,4,2,6,8,-7,7,0,7,0,7,-3,4,1,-2,-5,3,-2,-6,8,0,0,1,1,1,1,-1,3,-1
KR_6732155867,420,-2,34,-30,0,1,0,1,-3,6,3,-2,3,1,1,1,2,3,0,3,0,-1,-10,-5,-2,7,5,0,0,0,1,0,-1,0,-1
KR_6681182978,420,-5,5,-2,-12,0,0,0,0,4,4,-8,10,2,-3,3,0,-1,1,0,1,-8,-8,-1,-4,5,-2,0,-1,-1,-1,-1,1,6,-1
KR_6757010215,440,-3,8,-4,-2,2,0,2,-1,3,2,-1,3,2,-1,4,3,-1,3,2,0,-1,155,-2,-3,5,-3,0,-1,0,-1,-1,-1,0,-1
KR_6714033325,420,-3,-89,-11,-2,1,0,1,-3,3,0,-2,2,0,6,5,11,-4,4,0,0,2,-1,-1,-4,5,0,0,0,1,1,1,-1,1,-1
KR_6764634854,420,-2,-3,-11,-11,1,3,4,-2,2,0,-5,5,0,-2,5,3,-3,5,2,0,-24,-3,-2,-6,8,-6,0,-1,-1,1,-1,-1,1,-1
KR_6741167351,440,-1,4,16,0,1,0,1,-2,3,1,4,0,4,-1,1,0,-2,2,0,0,-5,293,0,-5,5,2,0,0,1,1,0,1,3,-1
KR_6700030335,420,0,-40,9,-2,0,0,0,-5,5,0,-3,3,0,0,3,3,6,0,6,0,-1,16,-3,-3,6,-1,0,0,1,-1,1,-1,6,-1
KR_6752326107,420,-6,-69,-29,-15,-4,4,0,-1,2,1,-3,3,0,-6,7,1,-1,1,0,0,-9,39,1,-1,0,-1,0,-1,-1,-1,-1,-1,2,-1
KR_6594769735,420,2,35,2,6,2,1,3,2,1,3,1,1,2,0,1,1,1,0,1,0,3,-257,3,-5,2,3,0,0,1,0,0,1,1,-1
KR_6605850113,420,-2,-72,-28,-1,-3,4,1,-1,3,2,2,1,3,1,1,2,0,0,0,0,6,3,-4,-2,6,-3,0,-1,-1,1,-1,1,2,-1
KR_6760250460,420,-5,-102,-23,-8,1,0,1,-1,2,1,-2,4,2,-6,8,2,0,0,0,1,-2,11,-2,-3,5,-4,0,-3,-1,-1,-1,1,5,-1
KR_6574943727,440,-8,-85,-32,-18,-4,5,1,1,1,2,-3,4,1,-3,6,3,-9,9,0,-1,-9,3,1,-4,3,-3,0,-1,-1,0,-1,-1,6,-1
KR_6746895791,420,-2,-49,28,-1,-1,5,4,6,2,8,-5,6,1,1,0,1,-2,3,1,0,-1,-19,-3,-2,5,1,0,-1,1,-1,-1,-1,4,-1
KR_6706964793,420,-3,-82,8,-8,-5,6,1,2,1,3,-4,4,0,1,2,3,-2,3,1,0,-2,-2,0,-4,4,-2,0,-1,-1,0,-1,-1,2,-1
KR_6697085861,420,1,10,9,6,-1,3,2,-1,2,1,9,0,9,-4,4,0,3,1,4,0,12,-2,2,-7,5,2,0,0,-1,1,1,-1,1,-1
KR_6713006014,420,-1,78,7,-13,-1,2,1,-2,4,2,-4,8,4,-4,5,1,-2,3,1,-3,-12,0,-1,-3,4,-1,0,0,0,0,0,-1,0,-1
KR_6758395530,420,1,11,20,4,2,2,4,0,3,3,0,2,2,2,1,3,0,1,1,0,2,246,4,-4,0,-6,0,0,1,1,0,-1,5,-1
KR_6695863875,420,-3,-44,12,-9,-4,6,2,-1,5,4,-1,2,1,-3,8,5,0,0,0,-3,-13,-4,-3,-3,6,-2,0,-1,0,-1,-1,-1,0,-1
KR_6738213661,440,2,4,12,2,2,0,2,2,3,5,2,2,4,-5,5,0,1,0,1,-1,-5,23,2,-6,4,-3,0,-2,-1,-1,-1,-1,5,-1
KR_6675872461,420,1,3,27,7,-4,4,0,-1,4,3,4,1,5,6,0,6,2,1,3,0,10,-12,3,-5,2,-1,0,0,1,1,1,1,2,-1
KR_6763321642,420,-3,-44,-24,1,1,0,1,-2,2,0,0,1,1,0,1,1,2,0,2,0,1,-11,-6,-4,10,-6,0,0,-1,1,0,1,3,-1
KR_6705564294,420,1,-17,24,0,3,0,3,0,1,1,1,2,3,-4,5,1,0,0,0,0,-1,-6,2,-4,2,1,0,0,1,0,-1,-1,3,-1
KR_6742642563,420,1,-33,-6,-1,1,2,3,1,1,2,0,1,1,-3,4,1,0,0,0,0,5,-346,3,-6,3,1,0,-1,-1,1,-1,1,2,-1
KR_6749330854,440,2,-48,-28,9,5,0,5,3,1,4,1,0,1,1,2,3,-1,3,2,0,8,26,0,-3,3,-1,0,-1,-1,1,-1,1,6,-1
KR_6377912934,420,-3,-63,-16,-7,0,2,2,-3,5,2,-2,2,0,1,3,4,-3,3,0,0,-4,-153,6,-9,3,-9,0,-2,0,-1,-1,1,0,-1
KR_6390638624,420,-2,-104,-20,-11,-4,6,2,-3,5,2,-1,3,2,-1,2,1,-2,5,3,0,4,8,-6,-1,7,-3,0,-1,-1,1,-1,-1,4,-1
KR_6706572174,420,-2,-12,15,-6,-1,1,0,-3,3,0,-2,5,3,0,3,3,0,1,1,-1,-10,-13,-2,-4,6,-1,0,0,1,1,0,-1,4,-1
KR_6764693593,420,0,-57,5,-1,2,0,2,-2,3,1,3,2,5,-4,5,1,0,0,0,0,-1,-4,-2,-3,5,1,0,0,0,1,0,-1,0,-1
KR_6693826273,440,1,48,7,-2,2,0,2,-1,2,1,1,0,1,-5,6,1,1,1,2,0,-3,6,3,-9,6,1,0,0,1,-1,0,-1,3,-1
KR_6656152107,420,-6,-103,-33,-10,-2,5,3,-5,5,0,2,0,2,-5,5,0,0,1,1,1,-8,-19,4,-5,1,-5,0,-2,-1,0,-1,1,1,-1
KR_6750064179,420,-5,-70,-4,-12,-4,4,0,-6,7,1,-2,2,0,0,2,2,0,0,0,0,-8,-288,-6,0,6,5,0,-1,-1,-1,-1,-1,2,-1
KR_6707340781,420,-2,58,-32,2,4,2,6,-5,8,3,1,0,1,2,0,2,0,1,1,1,1,-32,3,-5,2,17,0,1,-1,1,1,1,3,-1
KR_6641399108,420,-2,-66,-12,-5,-3,5,2,3,0,3,-2,3,1,-3,7,4,0,2,2,-1,-2,-28,0,-5,5,0,0,1,-1,-1,1,-1,1,-1
KR_6642290968,420,-1,-63,13,-2,2,1,3,-2,3,1,-2,2,0,-1,4,3,1,0,1,0,5,33,1,-4,3,1,0,-2,-1,-1,-1,-1,2,-1
KR_6764815104,420,0,34,-32,0,4,1,5,0,2,2,-3,5,2,-2,4,2,1,0,1,-1,-7,-6,-1,-3,4,-1,0,-1,1,-1,-1,-1,5,-1
KR_6763819360,440,1,34,4,9,6,0,6,-3,4,1,1,3,4,-1,2,1,6,1,7,1,9,122,-8,-1,9,17,0,-1,-1,-1,-1,1,4,-1
KR_6611895076,420,0,2,-17,4,4,0,4,2,1,3,1,1,2,0,2,2,-3,4,1,0,-3,-36,-5,-1,6,20,0,0,-1,1,0,-1,2,-1
KR_6755049543,440,-2,73,-8,-5,-2,4,2,0,5,5,-2,2,0,1,3,4,-2,2,0,0,3,1,1,-4,3,4,0,0,0,0,1,1,0,-1
KR_6749516548,420,1,21,17,3,-2,4,2,3,1,4,2,2,4,-1,3,2,1,0,1,0,8,4,4,-6,2,1,0,1,1,-1,1,-1,3,-1
KR_6744889025,420,-7,-81,-21,-14,0,1,1,-5,5,0,-1,3,2,-9,9,0,1,0,1,0,-10,-69,-1,-2,3,-27,0,-1,-1,-1,-1,-1,4,-1
KR_6681416430,420,-3,-72,10,-18,-1,3,2,-1,4,3,-4,5,1,-4,4,0,-8,8,0,0,-16,-14,2,-7,5,-2,0,-1,-1,1,-1,-1,2,-1
KR_6742954985,420,-4,-53,1,-15,-2,2,0,-3,5,2,-2,2,0,-7,7,0,-1,1,0,0,-18,-11,-6,-2,8,-1,0,-2,-1,-1,-1,-1,6,-1
KR_6723107625,420,-1,-57,9,-4,0,1,1,4,0,4,-6,9,3,-2,4,2,0,0,0,-1,3,31,2,-4,2,-5,0,0,-1,1,-1,-1,4,-1
KR_6600302240,420,2,-41,18,4,0,2,2,-2,7,5,4,1,5,2,0,2,0,2,2,-1,6,-1,-3,-4,7,3,0,-1,1,-1,-1,-1,2,-1
KR_6764636073,420,-1,-7,-28,-3,-5,7,2,6,0,6,0,2,2,0,3,3,-4,5,1,0,-5,4,0,-4,4,-6,0,0,1,-1,-1,-1,3,-1
KR_6762160551,420,-5,-76,-13,-8,1,1,2,-2,2,0,-2,3,1,-4,5,1,-1,1,0,0,-10,-3,1,-4,3,-2,0,-1,-1,-1,-1,-1,2,-1
KR_6750909113,420,-2,12,-9,-11,0,2,2,-1,3,2,-4,7,3,-6,7,1,0,2,2,-1,-11,15,2,-6,4,-3,0,0,0,1,0,-1,0,-1
KR_6737127259,440,-3,-47,17,0,-1,6,5,-3,3,0,1,0,1,1,1,2,2,0,2,0,1,53,0,-4,4,6,0,-1,-1,0,-1,-1,4,-1
KR_6762196183,440,0,-22,-32,7,6,1,7,-1,2,1,-1,2,1,3,2,5,0,0,0,2,4,-15,-4,-1,5,1,0,-1,1,-1,-1,1,4,-1
KR_6643748645,440,-1,-7,-15,-3,0,1,1,-2,3,1,3,0,3,-3,4,1,-1,2,1,2,-3,-57,-2,-4,6,0,0,-1,1,-1,-1,1,5,-1
KR_6760727308,420,2,84,4,5,2,2,4,1,5,6,-3,4,1,2,3,5,3,1,4,0,-2,8,0,-5,5,0,0,0,-1,0,0,-1,1,-1
KR_6764622208,420,-4,8,-41,-13,-4,4,0,-4,5,1,-1,2,1,1,0,1,-5,5,0,-1,-12,4,5,-6,1,-2,0,-1,0,-1,-1,-1,0,-1
KR_6761610935,420,-3,0,31,-5,-3,4,1,-1,1,0,-1,2,1,-1,1,0,1,2,3,-1,-6,6,-1,-4,5,2,0,0,-1,1,1,-1,1,-1
KR_6732115643,420,-4,-67,-1,-11,1,3,4,1,1,2,-4,6,2,-9,10,1,0,1,1,0,-12,-12,2,-5,3,-1,0,-1,0,-1,-1,1,0,-1
KR_6656003091,420,-4,-98,0,-5,-2,2,0,-5,7,2,3,1,4,-4,4,0,3,0,3,0,-11,-7,-3,-3,6,1,0,0,1,1,-1,-1,5,-1
KR_6706578749,440,1,-62,12,-3,3,1,4,-3,7,4,-1,1,0,0,2,2,-2,2,0,-1,-7,-5,1,-6,5,-2,0,0,-1,-1,-1,-1,5,-1
KR_6748311640,420,-2,-42,-4,1,-3,5,2,1,1,2,-4,4,0,4,2,6,3,0,3,1,8,-18,-4,-2,6,5,0,-1,0,-1,-1,1,0,-1
KR_6764728891,440,-2,-29,-3,1,3,0,3,4,1,5,-1,2,1,-5,7,2,0,0,0,0,-2,6,2,-7,5,-3,0,-2,0,0,-1,1,0,-1
KR_6760252814,420,-2,-6,-2,1,-2,3,1,1,1,2,2,1,3,1,1,2,-1,2,1,0,8,11,0,-2,2,1,0,0,1,-1,-1,-1,5,-1
KR_6659415552,420,-2,-57,29,-8,-6,6,0,-2,4,2,-6,8,2,0,3,3,6,1,7,0,2,4,-3,-2,5,-1,0,0,-1,1,1,-1,5,-1
KR_6759906256,440,-2,-37,4,-10,2,1,3,-5,9,4,-1,3,2,-6,6,0,0,1,1,0,-9,-10,-3,-2,5,4,0,0,0,0,1,-1,0,-1
KR_6745960934,420,-4,-67,-16,-6,2,0,2,-3,3,0,-6,9,3,1,1,2,0,0,0,0,-4,-7,-1,-2,3,-5,0,0,-1,1,0,1,2,-1
KR_6728353503,420,-3,-36,-36,-13,-3,3,0,-1,4,3,-1,3,2,-8,12,4,0,1,1,-3,-6,4,0,-5,5,0,0,-3,-1,-1,-1,-1,2,-1
KR_6648080160,420,1,87,12,4,0,3,3,2,2,4,1,1,2,0,1,1,1,0,1,0,5,5,5,-8,3,-3,0,0,1,1,0,1,3,-1
KR_6684377183,420,-4,1,-24,-5,-2,3,1,-2,6,4,-2,5,3,0,1,1,1,2,3,0,-5,116,-1,-4,5,0,0,-1,1,-1,-1,1,3,-1
KR_6728885406,440,2,16,19,2,-2,4,2,1,2,3,-3,4,1,4,3,7,2,1,3,0,-2,0,-1,-3,4,-2,0,2,-1,1,1,-1,6,-1
KR_6687201330,420,-1,-90,-13,4,-3,3,0,5,1,6,0,2,2,-1,3,2,3,1,4,0,9,7,0,-5,5,1,0,0,-1,1,-1,1,3,-1
KR_6763819436,420,2,4,32,10,7,0,7,3,3,6,-2,3,1,-2,8,6,4,0,4,1,8,-2,2,-5,3,-3,0,2,1,1,1,-1,6,-1
KR_6724685298,420,-2,-33,25,-3,-6,6,0,2,2,4,2,3,5,-1,3,2,0,1,1,2,0,-7,2,-5,3,6,0,-2,1,1,-1,1,6,-1
KR_6728674158,420,1,6,16,3,6,0,6,2,1,3,-2,2,0,-3,5,2,0,0,0,0,-3,-4,2,-5,3,2,0,0,-1,1,1,1,3,-1
KR_6447676237,420,-2,-5,13,-4,2,0,2,0,4,4,-6,6,0,0,0,0,0,0,0,0,-5,-18,2,-5,3,-4,0,-2,1,-1,-1,1,3,-1
KR_6729794005,440,2,34,-20,4,2,1,3,4,2,6,0,4,4,-4,6,2,2,1,3,0,6,-11,-2,-3,5,2,0,2,0,1,1,1,0,-1
KR_6726886597,420,4,33,16,8,1,2,3,-1,5,4,2,2,4,4,4,8,2,1,3,0,4,5,1,-4,3,-2,0,1,1,1,1,1,5,-1
KR_6751322326,440,-3,-50,-8,-4,-3,5,2,-5,5,0,5,2,7,0,1,1,-1,1,0,-1,1,-2,2,-6,4,-1,0,0,1,0,0,-1,5,-1
KR_6748541769,440,-1,48,12,-11,0,2,2,-4,6,2,-4,5,1,-5,5,0,2,0,2,0,-14,-11,-1,-1,2,4,0,0,0,-1,0,-1,0,-1
KR_6713310293,420,-6,-112,-57,-10,-4,6,2,-1,2,1,1,3,4,1,2,3,-7,7,0,-2,-17,13,1,-4,3,-2,0,-2,-1,-1,-1,-1,5,-1
KR_6762672678,420,-3,-35,-8,-12,-2,3,1,-1,3,2,-8,9,1,-1,2,1,0,0,0,0,-8,2,0,-7,7,1,0,-2,-1,0,-1,-1,3,-1
KR_6758447969,420,-5,-123,-8,-10,-7,7,0,-1,1,0,1,5,6,-1,2,1,-2,2,0,0,-5,-5,-4,-2,6,-4,0,-2,-1,1,-1,-1,6,-1
KR_6731414367,440,0,2,5,-4,0,1,1,2,1,3,-2,5,3,-3,4,1,-1,1,0,0,-2,13,-3,-3,6,-2,0,0,0,-1,0,-1,0,-1
KR_6328794727,420,-3,-15,6,-5,1,1,2,-3,4,1,-2,3,1,-2,6,4,1,1,2,1,-5,3,-1,-3,4,-3,0,0,1,1,0,1,2,-1
KR_6717233801,440,-2,-13,-19,-6,-4,5,1,-4,4,0,-1,1,0,2,2,4,1,1,2,0,-8,-20,-4,-4,8,19,0,0,1,1,0,-1,3,-1
KR_6687763810,420,-5,4,-24,-10,-9,9,0,0,6,6,-2,4,2,1,2,3,0,0,0,0,-10,-199,-3,-4,7,-3,0,-1,-1,-1,-1,1,5,-1
KR_6707404192,420,-6,-134,-36,-18,-5,6,1,-2,4,2,2,1,3,-8,11,3,-5,5,0,-1,-16,-8,-4,-1,5,-3,0,-2,-1,-1,-1,-1,3,-1
KR_6546521393,420,-2,-46,0,-3,-4,4,0,-1,2,1,3,4,7,-2,6,4,1,3,4,-1,-3,-2,-1,-4,5,5,0,0,1,1,-1,-1,1,-1
KR_6716622492,420,-2,31,-24,-4,-2,2,0,0,1,1,0,2,2,-1,5,4,-1,2,1,0,-8,17,-2,-3,5,-2,0,0,-1,1,0,-1,2,-1
KR_6746250101,420,-3,15,-32,-11,-2,2,0,-3,4,1,-1,2,1,-2,3,1,-3,5,2,-2,-19,-5,-1,-3,4,0,0,-1,-1,-1,-1,-1,4,-1
KR_6659845438,420,-3,29,-20,2,0,2,2,4,2,6,0,5,5,-2,4,2,0,0,0,0,2,-3,-1,-2,3,-1,0,0,1,0,0,-1,4,-1
KR_6756494119,420,1,27,9,-5,-1,1,0,-1,1,0,-3,3,0,1,0,1,-1,1,0,0,-5,7,1,-5,4,-1,0,-1,1,-1,-1,-1,6,-1
KR_6753306499,440,-6,-22,11,-8,-1,2,1,-1,3,2,0,2,2,-3,4,1,-3,3,0,0,-8,-2,-3,0,3,-4,0,-1,1,0,-1,1,2,-1
KR_6756636250,420,-2,-46,-9,-5,0,0,0,0,1,1,-2,6,4,-3,4,1,0,3,3,0,-3,-6,-4,-2,6,6,0,0,-1,0,0,-1,6,-1
KR_6756711251,420,2,57,-6,8,5,0,5,5,2,7,-2,4,2,0,3,3,0,0,0,0,-2,36,6,-9,3,2,0,1,-1,1,1,1,4,-1
KR_6754384229,420,-3,12,16,-9,1,4,5,0,1,1,-6,7,1,-3,5,2,-1,2,1,-1,-14,55,-2,-5,7,-28,0,0,-1,1,-1,-1,4,-1
KR_6487565791,420,0,75,-36,-2,3,0,3,-6,6,0,-2,2,0,2,1,3,1,2,3,0,-5,-31,1,-5,4,3,0,0,-1,1,0,-1,3,-1
KR_6697123233,420,-5,-57,-19,-10,0,3,3,0,2,2,-1,3,2,-5,5,0,-4,4,0,0,-13,-10,-3,-2,5,1,0,-3,1,-1,-1,-1,4,-1
KR_6737955408,420,-2,15,-12,-6,-4,5,1,-1,2,1,-4,5,1,1,3,4,2,0,2,0,-3,0,-3,-3,6,4,0,-1,-1,-1,-1,-1,6,-1
KR_6761717833,440,4,17,8,5,4,0,4,3,1,4,-2,2,0,1,0,1,-1,2,1,0,-1,2,7,-9,2,-2,0,0,-1,1,0,1,6,-1
KR_6763558571,420,-3,-60,-4,-8,-3,4,1,-3,3,0,-4,5,1,2,0,2,0,0,0,0,3,116,-3,-1,4,2,0,-2,-1,-1,-1,-1,4,-1
KR_6753530881,420,3,-6,3,3,0,2,2,4,0,4,0,1,1,-2,5,3,1,1,2,0,5,10,1,-7,6,2,0,2,-1,0,1,-1,1,-1
KR_6752294826,420,-3,-48,-19,-7,-1,1,0,0,1,1,1,2,3,1,1,2,-8,8,0,0,2,-12,0,-3,3,1,0,-2,-1,1,-1,-1,4,-1
KR_6630509264,420,0,-41,-11,3,1,1,2,0,1,1,0,2,2,0,0,0,2,0,2,1,5,-4,-5,-3,8,2,0,0,-1,0,0,1,1,-1
KR_6752187274,440,-1,39,-25,-5,-3,3,0,-5,5,0,1,0,1,5,1,6,-3,4,1,1,-11,7,0,-3,3,-2,0,-2,1,-1,-1,1,3,-1
KR_6733552711,420,1,6,-9,2,-1,1,0,4,1,5,1,1,2,0,0,0,-2,3,1,0,0,8,3,-6,3,-2,0,0,-1,1,0,1,3,-1
KR_6645278419,420,-2,-150,-6,-7,-1,2,1,-2,4,2,-6,7,1,1,2,3,1,1,2,1,-4,-5,3,-6,3,3,0,-4,-1,-1,-1,1,5,-1
KR_6657330229,420,0,-18,22,13,1,2,3,1,3,4,2,1,3,5,1,6,4,0,4,2,16,1,2,-3,1,0,0,1,1,1,1,1,3,-1
KR_6763001647,420,-6,-70,-44,-9,-2,3,1,-3,5,2,-1,3,2,-2,2,0,-1,1,0,0,-14,6,2,-4,2,-5,0,-2,-1,-1,-1,-1,2,-1
KR_6764541224,440,-4,-18,-40,-11,-4,5,1,-7,8,1,-2,4,2,-3,9,6,5,0,5,-3,-16,-1,2,-5,3,-2,0,0,-1,-1,0,-1,1,-1
KR_6732403455,420,1,46,13,-4,1,0,1,-3,4,1,1,2,3,-2,2,0,-1,1,0,0,-12,-4,-3,-4,7,0,0,0,1,-1,0,-1,4,-1
KR_6684094272,440,-2,-46,20,-13,-4,5,1,0,2,2,-2,5,3,-3,7,4,-4,5,1,0,-8,2,-5,0,5,3,0,-2,-1,0,-1,-1,1,-1
KR_6643607754,440,2,-47,-1,-4,2,3,5,2,1,3,-8,8,0,1,5,6,-1,3,2,1,-3,-8,3,-6,3,-3,0,1,1,1,1,1,4,-1
KR_6763976073,420,-5,-36,-88,-10,-2,2,0,0,2,2,-9,12,3,1,1,2,0,2,2,0,-9,-118,-2,-3,5,-5,0,-3,0,-1,-1,-1,0,-1
KR_6744639966,420,-6,-99,-44,-13,-1,3,2,-6,8,2,-3,3,0,-2,3,1,-1,2,1,0,-13,-11,-3,0,3,-1,0,-1,-1,-1,-1,1,6,-1
KR_6760984225,420,-3,-22,6,-6,2,0,2,-4,4,0,-2,3,1,-1,4,3,-1,1,0,0,-7,-13,3,-7,4,7,0,-1,0,1,-1,-1,0,-1
KR_6742733633,420,-3,-70,-4,-8,-2,3,1,-7,7,0,3,0,3,-1,3,2,-1,1,0,0,-10,212,-2,-2,4,1,0,-1,-1,-1,-1,-1,4,-1
KR_6734042672,420,-5,-77,-23,-7,1,2,3,-3,3,0,0,2,2,-2,2,0,-3,3,0,0,-11,325,3,-6,3,-2,0,-1,-1,-1,-1,-1,5,-1
KR_6750065211,420,-2,-8,-20,1,-2,4,2,5,2,7,-2,5,3,1,1,2,-1,1,0,2,12,5,3,-7,4,2,0,1,1,-1,1,1,4,-1
KR_6714431970,420,3,19,-20,6,-1,2,1,2,2,4,2,0,2,-1,2,1,4,0,4,0,7,-21,2,-6,4,4,0,1,-1,-1,1,1,4,-1
KR_6730215621,420,-2,-44,-33,-6,-1,2,1,1,3,4,-2,4,2,-4,4,0,0,1,1,-1,-4,-6,-2,-5,7,-2,0,-2,-1,-1,-1,-1,4,-1
KR_6673782491,420,1,72,-13,2,2,3,5,0,3,3,0,4,4,1,2,3,-1,1,0,0,-14,11,4,-7,3,1,0,-1,1,-1,-1,1,6,-1
KR_6761540406,420,-2,11,-8,-4,0,1,1,-3,4,1,-2,3,1,0,3,3,1,1,2,0,-3,132,-3,-2,5,0,0,-1,1,-1,-1,-1,4,-1
KR_6722447303,420,0,-35,-24,-4,2,1,3,0,2,2,-4,4,0,-2,5,3,0,1,1,0,-11,-2,-4,-2,6,2,0,0,-1,-1,-1,-1,4,-1
KR_6752534007,420,-1,-61,-12,-8,1,1,2,-4,8,4,-3,4,1,-1,1,0,-1,3,2,0,-11,-10,-6,0,6,-1,0,-1,-1,-1,-1,-1,6,-1
KR_6684521373,420,-4,39,-56,-12,-2,2,0,0,1,1,-8,8,0,0,1,1,-2,3,1,0,-1,-9,-2,0,2,-1,0,0,1,-1,0,-1,6,-1
KR_6764531126,440,-1,-12,-40,1,-1,2,1,-6,6,0,3,2,5,6,1,7,-1,1,0,0,2,-7,-1,0,1,0,0,-1,0,-1,-1,-1,0,-1
KR_6672345991,440,-1,-65,-4,-6,-1,3,2,-4,5,1,-1,2,1,-1,5,4,1,0,1,0,-6,-17,0,-2,2,-1,0,0,-1,-1,-1,-1,4,-1
KR_6722215172,420,-3,-5,-27,-10,-4,4,0,-1,2,1,-2,5,3,-3,3,0,0,1,1,-1,-10,-8,-4,-4,8,-2,0,-1,-1,1,-1,-1,6,-1
KR_6764264631,420,-3,-51,-4,-8,-5,6,1,-2,2,0,1,3,4,-2,6,4,0,2,2,0,-1,4,3,-4,1,-2,0,-1,1,1,-1,-1,5,-1
KR_6749352087,420,-2,-78,1,2,-6,6,0,2,4,6,3,2,5,0,4,4,3,0,3,0,5,-4,-3,-4,7,3,0,-1,0,-1,-1,1,0,-1
KR_6493008987,420,-4,-64,-10,-15,-3,3,0,-5,5,0,-3,4,1,-4,5,1,0,1,1,0,-13,-1,-5,-1,6,-1,0,-2,-1,-1,-1,-1,3,-1
KR_6752805468,440,-4,39,-13,-9,3,0,3,-1,2,1,-4,8,4,-3,6,3,-4,5,1,0,-7,-8,-4,-4,8,-3,0,-1,-1,-1,-1,-1,6,-1
KR_6756138570,440,-1,-90,-1,3,2,3,5,2,2,4,0,4,4,-2,3,1,1,0,1,2,9,63,6,-8,2,-14,0,0,-1,1,1,1,6,-1
KR_6762952877,420,0,21,9,-2,-2,2,0,1,1,2,2,1,3,-1,2,1,-2,3,1,0,-3,19,-1,-3,4,-7,0,0,-1,1,1,1,2,-1
KR_6755225569,420,-2,-72,10,-10,2,1,3,-2,4,2,-7,8,1,-2,2,0,-1,2,1,0,-8,-3,0,-4,4,1,0,-2,-1,1,-1,1,2,-1
KR_6672917792,420,1,27,29,-8,-4,4,0,-3,8,5,0,2,2,3,2,5,-4,5,1,0,-4,7,3,-4,1,-1,0,-1,-1,-1,-1,-1,5,-1
KR_6679202590,420,-2,-79,-11,4,3,0,3,-4,5,1,2,2,4,5,0,5,-2,3,1,0,6,10,3,-6,3,0,0,1,1,1,1,1,1,-1
KR_6739204704,420,-2,-27,-26,0,2,1,3,4,0,4,-2,3,1,0,2,2,-4,4,0,0,-2,-37,-4,-1,5,2,0,0,-1,1,0,1,4,-1
KR_6762646977,440,0,-12,21,3,4,1,5,-2,4,2,-3,4,1,4,0,4,0,4,4,0,-1,7,-1,-1,2,-1,0,1,-1,-1,1,1,3,-1
KR_6705481378,420,-5,-43,-36,-10,-4,4,0,1,2,3,-7,8,1,1,2,3,-1,1,0,0,2,24,-5,-1,6,-2,0,-1,-1,-1,-1,-1,1,-1
KR_6762574935,440,3,38,-2,6,-6,6,0,0,6,6,1,1,2,8,3,11,3,0,3,0,10,-3,-1,-1,2,1,0,2,1,1,1,1,6,-1
KR_6599413718,420,2,18,-22,3,4,2,6,-1,2,1,-1,4,3,0,1,1,1,1,2,0,-3,-15,-2,-3,5,4,0,1,0,1,1,-1,0,-1
KR_6692476963,440,-2,-80,30,-7,-9,9,0,-5,5,0,-1,1,0,7,1,8,1,1,2,-1,-1,0,-1,-1,2,2,0,-1,1,-1,-1,-1,4,-1
KR_6758580702,420,1,48,7,-1,-2,2,0,-4,4,0,1,2,3,3,4,7,1,0,1,0,6,-2,-2,-3,5,-4,0,1,1,-1,-1,-1,4,-1
KR_6632195522,420,0,-51,-3,6,0,1,1,0,3,3,-2,4,2,6,0,6,2,0,2,0,1,11,3,-4,1,-2,0,-1,1,1,1,1,4,-1
KR_6755813423,420,5,113,31,7,0,1,1,2,4,6,-8,9,1,13,0,13,0,0,0,0,9,2,3,-5,2,0,0,2,1,1,1,1,5,-1
KR_6614052485,420,0,7,0,-3,-1,3,2,-2,5,3,-6,7,1,3,1,4,3,0,3,0,-2,0,1,-6,5,-5,0,-1,-1,-1,-1,-1,1,-1
KR_6711933370,420,-3,-60,-32,-4,-1,5,4,-5,6,1,-1,3,2,2,1,3,1,0,1,0,-7,-36,-2,-3,5,2,0,-2,0,-1,-1,1,0,-1
KR_6740550557,420,-1,-6,4,-5,-2,3,1,-4,6,2,6,0,6,-4,5,1,-1,1,0,0,-11,-38,-1,-5,6,12,0,0,1,-1,0,-1,6,-1
KR_6614928670,420,-3,-75,22,-6,-2,2,0,-3,4,1,5,0,5,-5,7,2,-1,2,1,-1,-3,-1,0,-2,2,-1,0,-1,-1,1,-1,-1,5,-1
KR_6690184775,420,0,16,13,-3,5,0,5,-7,8,1,0,3,3,1,2,3,-2,2,0,0,-13,-2,2,-6,4,-4,0,0,-1,1,0,1,6,-1
KR_6468751223,420,-3,-23,-13,-2,-4,5,1,1,1,2,0,1,1,1,2,3,0,0,0,0,1,4,-2,-3,5,-4,0,0,-1,0,0,-1,3,-1
KR_6585186384,420,-2,-51,-43,-10,-2,5,3,2,2,4,-6,6,0,-4,7,3,0,0,0,2,-8,18,5,-7,2,-2,0,-5,1,-1,-1,1,2,-1
KR_6738924404,420,-1,35,-8,1,1,0,1,1,5,6,-2,5,3,0,3,3,1,1,2,0,6,19,-2,-1,3,5,0,0,0,0,0,1,0,-1
KR_6687084797,420,-5,-17,-12,-8,2,0,2,-3,3,0,-2,5,3,-3,3,0,-2,4,2,-3,-18,-21,-1,-5,6,2,0,-1,-1,-1,-1,-1,6,-1
KR_6732013071,420,-3,-57,24,-3,-2,2,0,1,2,3,-3,3,0,3,0,3,-2,5,3,0,1,-15,2,-6,4,-3,0,0,1,1,0,-1,1,-1
KR_6761558018,420,0,16,-16,-5,0,0,0,-4,5,1,0,0,0,0,1,1,-1,2,1,-1,-8,-45,-3,-6,9,12,0,0,-1,-1,0,-1,3,-1
KR_6759861474,420,0,48,-29,3,-1,3,2,0,2,2,3,0,3,3,0,3,-2,2,0,0,7,29,4,-7,3,-10,0,0,1,-1,0,1,6,-1
KR_6750331861,420,-7,-122,-31,-8,-6,6,0,-2,5,3,1,1,2,-1,4,3,0,0,0,0,-2,-1,2,-5,3,-8,0,-4,-1,0,-1,-1,1,-1
KR_6761325086,420,-4,-84,-11,-9,-5,6,1,-3,3,0,0,1,1,-2,2,0,1,0,1,0,-14,5,-1,-2,3,0,0,-2,-1,-1,-1,-1,6,-1
KR_6718521328,420,-4,-107,-4,-6,-1,1,0,0,4,4,-2,4,2,-3,4,1,0,1,1,-1,-1,4,-2,-4,6,-1,0,0,1,-1,0,-1,6,-1
KR_6757494422,440,-7,-124,-11,-15,0,2,2,-8,11,3,-2,2,0,-5,9,4,0,0,0,-1,-10,-14,0,-3,3,-4,0,-1,0,-1,-1,-1,0,-1
KR_6744622860,420,-2,13,8,-2,1,1,2,-1,3,2,1,2,3,-3,4,1,0,0,0,-1,-4,3,6,-8,2,-5,0,1,0,1,-1,-1,0,-1
KR_6571169758,420,0,-12,-6,-2,-1,2,1,6,4,10,-1,2,1,-4,4,0,-2,3,1,0,-3,6,0,-3,3,1,0,0,1,-1,0,1,2,-1
KR_6660956376,420,-2,-73,-24,-9,-4,4,0,-1,5,4,-2,2,0,-3,4,1,1,0,1,0,-6,-12,-3,-1,4,3,0,-1,-1,-1,-1,-1,5,-1
KR_6708598357,420,-4,-63,-40,-10,0,0,0,-1,5,4,-2,4,2,-7,7,0,0,0,0,0,-17,-13,-3,-2,5,3,0,-1,0,-1,-1,-1,0,-1
KR_6739915671,420,3,-6,24,8,1,2,3,6,0,6,6,1,7,-5,7,2,0,1,1,0,3,-44,-3,-1,4,24,0,2,1,1,1,1,5,-1
KR_6749125243,420,0,-3,37,-4,-6,6,0,-1,2,1,2,3,5,1,1,2,0,1,1,-1,-5,-27,-2,-3,5,3,0,0,1,0,0,-1,5,-1
KR_6758955292,420,-1,-36,6,-5,-4,6,2,-5,5,0,-2,2,0,1,3,4,5,0,5,-1,-1,-87,1,-3,2,-2,0,-4,-1,-1,-1,-1,3,-1
KR_6629677528,420,-2,-47,-36,-3,-2,3,1,-5,6,1,0,1,1,4,0,4,0,0,0,0,-1,-16,-5,-3,8,0,0,-2,-1,-1,-1,-1,3,-1
KR_6630603927,420,1,43,24,3,2,0,2,4,1,5,-2,3,1,-2,6,4,1,1,2,0,3,-7,1,-5,4,3,0,1,0,0,1,1,0,-1
KR_6713139592,420,-2,6,12,-9,2,1,3,-1,2,1,0,2,2,-9,10,1,-1,5,4,-3,-16,12,2,-4,2,-3,0,0,-1,-1,0,-1,2,-1
KR_6760822947,420,1,-10,17,-4,-3,4,1,-1,2,1,-1,3,2,1,2,3,0,0,0,0,-2,-41,-5,-2,7,2,0,-1,1,-1,-1,1,1,-1
KR_6753010435,420,-2,-2,-8,1,4,0,4,-4,6,2,0,1,1,0,1,1,1,0,1,-1,-5,-5,0,-6,6,0,0,0,-1,1,1,-1,5,-1
KR_6744229218,420,-3,2,0,-8,4,0,4,-3,3,0,-3,5,2,-4,4,0,-2,2,0,0,-7,-36,-3,-3,6,6,0,-1,-1,0,-1,-1,2,-1
KR_6710900254,420,-1,-19,0,-4,1,3,4,1,1,2,4,0,4,-5,7,2,-5,5,0,0,-4,-3,3,-6,3,1,0,-2,-1,-1,-1,1,5,-1
KR_6723966906,420,-4,-46,-15,-7,1,2,3,-4,6,2,-1,3,2,-2,4,2,-1,2,1,0,-2,30,4,-6,2,-3,0,-1,-1,-1,-1,-1,2,-1
KR_6747528664,420,-2,-23,-4,-6,1,1,2,-1,3,2,-1,4,3,-6,7,1,1,0,1,-3,-1,15,-5,-3,8,0,0,-1,0,0,-1,1,0,-1
KR_6741137312,440,0,-59,-24,-6,-1,1,0,-2,3,1,-5,6,1,1,2,3,1,1,2,0,-5,-4,2,-4,2,-2,0,0,-1,-1,-1,1,1,-1
KR_6686588418,440,-3,-49,0,2,-5,6,1,0,2,2,5,1,6,1,2,3,1,0,1,0,4,4,-2,-3,5,4,0,-1,1,-1,-1,1,5,-1
KR_6757658303,420,0,-33,11,-2,2,1,3,0,2,2,-1,2,1,-4,5,1,1,0,1,0,-11,96,-7,-3,10,-1,0,0,-1,1,0,-1,5,-1
KR_6740608712,420,2,28,-11,0,0,0,0,-3,4,1,-5,7,2,6,2,8,2,2,4,0,-2,7,-1,-1,2,0,0,-1,-1,-1,-1,-1,4,-1
KR_6749752136,420,-1,-32,6,-6,-3,4,1,-1,3,2,0,2,2,-2,5,3,0,0,0,0,0,-21,-2,-2,4,0,0,-1,1,-1,-1,-1,1,-1
KR_6761152067,420,-3,-99,8,-10,-1,3,2,0,0,0,-4,6,2,-6,6,0,1,0,1,0,-8,-12,-4,-2,6,2,0,-2,1,-1,-1,-1,4,-1
KR_6762754689,420,1,46,-16,1,3,0,3,0,1,1,-1,3,2,0,1,1,-1,1,0,0,2,-59,-3,-1,4,1,0,1,0,-1,1,-1,0,-1
KR_6759652295,420,0,48,-7,3,-1,3,2,-1,2,1,1,2,3,0,4,4,4,3,7,0,-1,-7,0,-1,1,0,0,0,1,-1,0,1,3,-1
KR_6739281651,420,5,75,15,8,3,1,4,-1,3,2,1,1,2,6,1,7,-1,1,0,0,3,8,-1,-2,3,2,0,0,1,-1,0,1,6,-1
KR_6755069297,420,0,-4,5,2,-2,3,1,3,0,3,0,2,2,1,3,4,0,0,0,0,3,5,0,-6,6,-2,0,1,1,1,1,1,3,-1
KR_6724521336,420,-3,-70,-30,-6,0,1,1,1,3,4,-3,4,1,-4,4,0,0,0,0,-1,-3,-1,1,-3,2,-4,0,0,-1,-1,0,-1,2,-1
KR_6759166513,420,-2,-21,-6,-7,-1,2,1,-2,2,0,-3,3,0,0,3,3,-1,1,0,0,-5,-2,-2,-6,8,-2,0,0,1,-1,0,-1,1,-1
KR_6717671335,420,2,63,8,3,1,2,3,-1,3,2,4,3,7,-1,1,0,0,1,1,0,6,-1,-1,-1,2,2,0,1,0,-1,1,1,0,-1
KR_6743130093,420,-2,12,-4,-6,0,2,2,-3,4,1,-1,1,0,-1,1,0,-1,1,0,0,-8,0,1,-3,2,-3,0,-1,1,-1,-1,1,2,-1
KR_6724869932,420,-2,6,-18,-4,2,3,5,-3,4,1,-1,2,1,-3,5,2,1,2,3,0,-4,4,2,-5,3,2,0,0,-1,0,-1,-1,2,-1
KR_6742403548,420,-1,-8,-11,-3,2,0,2,-2,4,2,-1,3,2,-2,2,0,0,0,0,0,-4,-2,0,-2,2,-2,0,-1,-1,0,-1,-1,2,-1
KR_6619087459,420,-1,-10,12,0,3,1,4,1,1,2,1,2,3,-4,6,2,-1,1,0,0,-3,11,0,-6,6,0,0,0,-1,1,1,1,4,-1
KR_6748201371,420,-1,-33,12,-2,-3,3,0,-1,4,3,-1,2,1,3,2,5,0,1,1,0,1,-10,-5,-2,7,-1,0,-1,1,-1,-1,1,6,-1
KR_6764418337,420,-1,18,16,1,5,0,5,0,1,1,-6,9,3,4,0,4,-2,3,1,1,8,4,-3,-2,5,4,0,1,-1,-1,1,1,3,-1
KR_6690574145,440,-2,36,16,-7,-4,4,0,-2,2,0,4,2,6,-3,5,2,-2,7,5,0,-17,-2,-3,-4,7,-1,0,0,-1,-1,-1,1,1,-1
KR_6750146297,420,-2,17,16,-8,0,0,0,-2,4,2,-1,1,0,-4,8,4,-1,3,2,0,-18,47,4,-5,1,-31,0,-1,-1,1,-1,-1,2,-1
KR_6610442368,420,-1,10,-43,-4,0,2,2,-4,4,0,1,1,2,-1,1,0,0,1,1,0,-2,3,1,-4,3,-4,0,-1,-1,-1,-1,-1,2,-1
KR_6753972337,420,1,18,-29,1,0,1,1,0,1,1,4,1,5,-3,4,1,0,1,1,-1,2,-29,0,-3,3,0,0,0,-1,-1,1,-1,4,-1
KR_6762496904,420,-2,-31,-7,-3,-1,3,2,1,3,4,1,2,3,-3,5,2,-1,2,1,1,1,2,6,-7,1,1,0,-2,1,1,-1,1,1,-1
KR_6742554774,420,0,100,-28,1,2,1,3,1,2,3,1,2,3,-1,4,3,-2,2,0,1,-3,-3,0,-2,2,-4,0,2,-1,1,1,1,5,-1
KR_6756596519,420,-2,-73,-15,0,2,1,3,3,3,6,-3,3,0,-4,5,1,2,0,2,0,4,1,-5,-3,8,-2,0,-3,-1,-1,-1,1,5,-1
KR_6572235546,440,-1,1,15,-2,-1,1,0,9,3,12,-1,3,2,-5,6,1,-4,4,0,-1,-2,-44,-3,0,3,20,0,-2,1,-1,-1,-1,4,-1
KR_6614124138,420,1,8,20,0,1,2,3,-1,1,0,-2,2,0,2,1,3,0,1,1,1,-2,-4,-8,-1,9,2,0,1,1,1,1,1,4,-1
KR_6639070983,420,1,-21,8,0,1,3,4,3,2,5,1,1,2,-3,3,0,-2,3,1,0,-2,6,3,-4,1,-4,0,-1,1,1,-1,-1,1,-1
KR_6751906425,420,1,13,20,-2,-4,6,2,1,1,2,-2,3,1,2,4,6,1,1,2,0,0,-1,-2,-1,3,5,0,0,-1,-1,-1,1,4,-1
KR_6738193995,440,0,-41,-14,2,2,0,2,1,2,3,-2,4,2,-1,2,1,2,0,2,0,5,0,2,-5,3,-1,0,0,-1,1,-1,-1,6,-1
KR_6739174302,420,-4,-12,-29,-8,-4,5,1,1,2,3,0,0,0,-2,3,1,-3,3,0,0,-2,-99,-2,-1,3,1,0,0,-1,-1,0,-1,2,-1
KR_6618802028,420,3,21,32,-2,2,1,3,-1,3,2,-3,3,0,0,3,3,0,2,2,-1,-5,-127,-2,-4,6,-2,0,0,-1,-1,1,-1,6,-1
KR_6740161795,420,-1,-39,-4,-6,-6,6,0,-1,3,2,5,2,7,-2,3,1,-2,4,2,0,-1,-9,-1,-5,6,5,0,0,-1,-1,-1,-1,5,-1
KR_6761071967,420,1,-6,12,2,3,0,3,2,2,4,0,2,2,-1,4,3,-2,2,0,0,1,-1,-3,-3,6,2,0,0,-1,0,0,-1,4,-1
KR_6755106012,440,-2,-83,-24,-12,-2,4,2,1,4,5,-10,11,1,-2,5,3,1,0,1,-1,-15,178,-6,-4,10,1,0,1,-1,1,-1,-1,2,-1
KR_6750694558,420,-8,-111,-37,-18,-4,7,3,-2,2,0,-7,8,1,-3,5,2,-2,2,0,0,-10,-9,-6,0,6,-1,0,-5,1,-1,-1,-1,4,-1
KR_6742258026,420,-4,-126,-19,-8,0,1,1,-1,5,4,-2,3,1,-1,4,3,-4,4,0,0,-15,-2,-2,-3,5,0,0,0,0,-1,-1,-1,0,-1
KR_6745053331,420,1,6,13,-5,-2,3,1,0,1,1,1,4,5,-3,3,0,-1,1,0,0,0,15,-2,-4,6,-2,0,1,-1,1,1,1,4,-1
KR_6760210269,420,0,31,-16,4,2,1,3,3,1,4,-3,6,3,3,6,9,-1,1,0,0,3,5,1,-5,4,-1,0,0,-1,1,1,-1,2,-1
KR_6734530456,420,-2,-64,0,-7,-4,4,0,2,4,6,1,0,1,-3,6,3,-3,3,0,0,-7,5,2,-7,5,-4,0,-1,-1,1,-1,-1,4,-1
KR_6758307496,420,-1,6,-4,0,-1,2,1,-2,3,1,-1,5,4,-1,3,2,5,0,5,0,5,0,-5,-5,10,0,0,0,0,-1,0,-1,0,-1
KR_6759630555,420,-2,-1,25,-9,6,1,7,-8,11,3,-2,3,1,-5,6,1,0,3,3,0,-18,-2,-6,0,6,2,0,1,-1,1,1,1,6,-1
KR_6762376548,420,0,-50,20,-4,-1,2,1,1,2,3,1,4,5,-5,7,2,0,4,4,0,3,-220,4,-6,2,-5,0,-1,1,-1,-1,1,1,-1
KR_6650284602,420,-1,26,-10,-3,2,1,3,-3,3,0,0,3,3,-2,4,2,0,2,2,0,-5,62,-7,-2,9,-19,0,-1,1,-1,-1,1,1,-1
KR_6657066208,420,2,2,20,0,-1,3,2,-1,4,3,-1,4,3,2,0,2,1,0,1,0,-1,-18,0,-3,3,-2,0,0,0,1,0,1,0,-1
KR_6738992024,420,-2,-56,-23,-1,-1,2,1,-1,6,5,-1,2,1,2,3,5,0,0,0,0,-4,107,2,-4,2,-2,0,-1,1,-1,-1,-1,5,-1
KR_6659402758,420,-5,-34,-28,-7,-5,5,0,2,1,3,-1,4,3,1,0,1,-4,4,0,0,-1,3,1,-4,3,-2,0,-1,-1,1,-1,-1,5,-1
KR_6738011997,420,-1,-12,-15,-4,-2,3,1,-4,4,0,-1,4,3,2,3,5,1,0,1,1,-5,5,3,-6,3,1,0,0,-1,1,0,1,6,-1
KR_6763194812,420,3,96,9,-8,5,0,5,1,1,2,-4,6,2,-9,11,2,-1,1,0,-2,-11,-7,-3,-2,5,5,0,3,1,-1,1,-1,1,-1
KR_6672971306,420,0,13,-12,2,-1,2,1,-1,5,4,2,0,2,0,1,1,2,1,3,0,-1,-29,2,-3,1,4,0,0,0,0,0,-1,0,-1
KR_6749495723,420,0,6,-16,1,1,0,1,-5,6,1,1,1,2,2,2,4,2,2,4,-1,-4,-20,5,-9,4,3,0,0,-1,-1,-1,-1,2,-1
KR_6681773481,440,-4,-117,-32,-4,-2,4,2,-4,4,0,-4,5,1,4,0,4,2,1,3,0,4,-11,-5,0,5,4,0,-1,0,-1,-1,-1,0,-1
KR_6762189331,420,-6,-44,-16,-9,-2,4,2,-4,4,0,-7,8,1,1,1,2,3,0,3,0,-5,-10,0,-5,5,3,0,0,1,-1,-1,1,1,-1
KR_6650099720,420,-6,-34,32,-11,1,2,3,0,1,1,-11,11,0,-1,5,4,0,0,0,1,-9,-11,-3,0,3,2,0,0,1,1,0,1,4,-1
KR_6742339490,420,-3,-61,-12,1,0,1,1,8,1,9,-4,4,0,-3,4,1,0,0,0,0,5,-5,7,-9,2,-7,0,0,-1,1,1,1,5,-1
KR_6761260035,420,1,-24,-7,2,-2,4,2,1,0,1,3,1,4,1,1,2,-1,2,1,0,8,268,3,-4,1,3,0,1,-1,1,1,-1,4,-1
KR_6764193873,420,2,31,40,-5,-2,2,0,-4,6,2,3,2,5,-4,6,2,2,0,2,0,-8,-97,1,-3,2,0,0,1,0,1,1,-1,0,-1
KR_6710416209,420,-3,-40,0,-7,0,1,1,-1,3,2,-2,2,0,-1,1,0,-3,3,0,0,-5,-25,-1,-1,2,13,0,-1,0,-1,1,-1,0,-1
KR_6763618249,420,-3,-11,16,-7,2,0,2,-2,2,0,-3,4,1,-2,2,0,-2,2,0,0,-8,12,-5,-3,8,4,0,0,0,1,-1,-1,0,-1
KR_6760875266,420,-2,-52,-25,1,2,0,2,1,1,2,-3,6,3,-2,4,2,3,0,3,0,5,-4,1,-4,3,3,0,-1,-1,1,-1,1,5,-1
KR_6742908421,420,-8,-19,-72,-3,4,0,4,-1,1,0,-3,4,1,0,3,3,-3,3,0,0,0,-13,2,-5,3,1,0,-1,-1,-1,-1,1,1,-1
KR_6551097408,440,-6,-45,-24,-12,-2,5,3,5,2,7,0,2,2,-10,11,1,-5,5,0,-2,-9,2,-2,-2,4,-2,0,-1,-1,0,1,1,4,-1
KR_6465135630,420,0,-17,27,-5,1,1,2,3,4,7,-6,8,2,-5,7,2,2,0,2,0,-9,-10,7,-8,1,2,0,-1,1,1,-1,-1,3,-1
KR_6572982490,420,0,-46,0,3,-4,4,0,6,1,7,-4,5,1,2,5,7,3,0,3,0,9,-18,-1,-3,4,3,0,-2,1,-1,-1,-1,5,-1
KR_6670478090,420,-5,-10,-19,-7,-1,2,1,0,3,3,-5,7,2,-1,2,1,0,0,0,0,-10,-38,0,-5,5,7,0,-1,-1,1,-1,1,5,-1
KR_6742699983,420,1,-41,-4,1,-1,5,4,2,5,7,1,3,4,-2,3,1,1,0,1,-1,6,10,-1,-4,5,2,0,1,0,0,1,-1,0,-1
KR_6754053113,420,-1,-10,-8,4,-2,6,4,0,2,2,3,0,3,2,0,2,1,0,1,0,7,137,1,-6,5,3,0,1,1,-1,-1,-1,5,-1
KR_6760598275,420,-3,-47,-28,-5,-3,4,1,1,1,2,-3,3,0,1,3,4,-1,1,0,0,1,-12,-6,-1,7,1,0,-2,-1,-1,-1,-1,1,-1
KR_6734880892,420,1,-20,-24,-6,-1,1,0,0,1,1,2,2,4,-6,6,0,-1,1,0,0,-3,370,-1,-1,2,-1,0,0,1,-1,-1,-1,4,-1
KR_6490841821,420,-1,-33,12,-6,1,1,2,2,1,3,0,3,3,-6,7,1,-3,3,0,0,-10,-8,-3,-1,4,0,0,-2,-1,-1,-1,-1,1,-1
KR_6752917773,440,-6,-86,-28,-11,-4,4,0,-3,3,0,-5,6,1,-1,1,0,2,1,3,0,-3,2,-1,-3,4,-2,0,-2,-1,-1,-1,-1,3,-1
KR_6682570765,420,-1,-2,-12,-1,0,1,1,2,6,8,-1,2,1,-3,5,2,1,0,1,1,1,8,1,-4,3,-2,0,1,1,1,1,1,3,-1
KR_6687225912,420,-2,-22,-4,-4,-1,3,2,2,1,3,-1,4,3,-2,2,0,-2,3,1,0,-5,25,2,-6,4,0,0,-1,0,1,-1,1,0,-1
KR_6611820054,420,-8,-93,4,-25,-6,7,1,0,0,0,-5,5,0,-12,12,0,-2,2,0,0,-12,-4,3,-5,2,-5,0,-3,-1,-1,-1,-1,4,-1
KR_6753851138,420,-1,-26,-16,-11,-3,6,3,-9,10,1,1,1,2,1,3,4,-1,1,0,-3,-8,-3,0,-3,3,1,0,0,0,-1,-1,-1,0,-1
KR_6752318643,420,4,22,10,8,2,1,3,1,3,4,0,6,6,1,5,6,4,2,6,1,5,10,6,-7,1,1,0,2,1,1,1,1,2,-1
KR_6760772957,440,-5,-83,-4,-15,-3,4,1,-7,8,1,-5,6,1,-1,1,0,1,0,1,-1,-17,-33,2,-7,5,-9,0,-2,0,-1,-1,-1,0,-1
KR_6759826220,420,-3,-24,2,-10,-8,9,1,0,2,2,1,1,2,-4,6,2,1,0,1,0,-13,7,-1,-4,5,-5,0,-2,-1,-1,-1,-1,5,-1
KR_6764222757,420,-3,74,-7,-6,1,1,2,-4,6,2,-4,5,1,-1,2,1,2,0,2,0,-5,102,2,-5,3,-6,0,0,-1,-1,0,1,1,-1
KR_6748850672,420,0,-20,-8,2,1,1,2,-6,7,1,2,1,3,5,1,6,0,1,1,0,0,5,4,-6,2,0,0,0,-1,1,0,-1,5,-1
KR_6739209063,420,-3,30,16,-9,1,2,3,-7,9,2,4,0,4,-1,2,1,-6,6,0,0,-15,-7,2,-7,5,5,0,0,-1,0,0,-1,6,-1
KR_6709476833,420,1,30,36,-5,-4,4,0,-3,5,2,1,4,5,1,1,2,0,0,0,0,-10,-24,1,-5,4,25,0,-1,1,-1,-1,1,5,-1
KR_6384421060,420,2,42,29,0,3,2,5,2,1,3,2,1,3,-7,7,0,0,0,0,0,0,1,-3,-3,6,-1,0,-1,1,0,-1,1,1,-1
KR_6681362080,420,-1,-2,4,1,0,2,2,-4,5,1,-1,5,4,4,1,5,2,1,3,0,-3,-5,-2,-4,6,2,0,0,-1,-1,-1,1,1,-1
KR_6717624709,420,-3,-37,3,-6,-4,5,1,2,3,5,2,2,4,-2,3,1,-4,5,1,0,-8,-245,1,-6,5,-5,0,-1,1,-1,-1,-1,5,-1
KR_6631219092,420,-2,-24,-26,-1,-2,4,2,-1,2,1,1,0,1,1,0,1,0,1,1,0,-1,27,1,-5,4,-4,0,0,0,0,0,-1,0,-1
KR_6727579324,420,0,-83,-4,1,-2,2,0,1,2,3,1,1,2,-1,8,7,2,1,3,0,6,-306,0,-5,5,5,0,0,1,1,1,1,6,-1
KR_6762769796,420,-2,-38,20,-2,0,1,1,1,1,2,-5,6,1,1,2,3,1,1,2,1,-5,305,-2,-3,5,0,0,-1,-1,1,-1,1,5,-1
KR_6716746778,420,1,20,-8,4,3,0,3,0,2,2,0,1,1,2,3,5,-1,1,0,0,3,0,-4,-1,5,1,0,1,1,1,1,1,6,-1
KR_6753906264,420,3,17,-16,3,-6,6,0,6,2,8,1,1,2,-1,1,0,3,1,4,0,7,6,-1,-2,3,-2,0,0,-1,-1,-1,-1,6,-1
KR_6760550860,420,-7,-85,-36,-13,-5,7,2,-2,5,3,-2,2,0,-3,7,4,-1,4,3,-2,-9,-31,-2,-2,4,6,0,-4,1,-1,-1,-1,5,-1
KR_6685005730,420,-3,-124,0,-4,-4,6,2,5,3,8,2,1,3,-6,8,2,-1,2,1,0,1,-1,0,-2,2,0,0,-2,-1,-1,-1,-1,6,-1
KR_6729110461,420,2,-43,-4,2,1,1,2,1,1,2,2,0,2,-2,3,1,0,0,0,-1,-5,-3,-4,-4,8,2,0,0,1,-1,0,-1,1,-1
KR_6632407076,420,-3,28,12,0,4,1,5,-4,5,1,4,0,4,-6,6,0,2,0,2,0,1,-1,-2,-3,5,0,0,-3,1,-1,-1,1,1,-1
KR_6760719159,420,0,10,-16,4,3,0,3,9,0,9,-4,5,1,-4,6,2,0,1,1,1,9,17,-1,-2,3,1,0,0,-1,-1,0,1,6,-1
KR_6757453044,420,0,-6,-20,-2,-5,5,0,-2,7,5,7,2,9,0,2,2,-2,4,2,0,-2,-13,4,-4,0,2,0,0,-1,1,-1,1,2,-1
KR_6733257766,420,-2,-26,-20,-5,1,0,1,-1,3,2,-4,4,0,-1,2,1,0,1,1,0,-4,83,0,-1,1,1,0,-2,-1,-1,-1,-1,6,-1
KR_6733598595,420,-1,-76,16,-1,-3,4,1,2,2,4,-1,6,5,2,1,3,-1,6,5,0,-1,2,1,-4,3,1,0,-2,1,0,-1,-1,2,-1
KR_6764450083,420,-1,-22,15,0,-1,2,1,2,2,4,-1,2,1,-2,4,2,2,3,5,0,5,-7,-10,-1,11,1,0,-1,1,-1,-1,1,1,-1
KR_6738593276,420,-2,-68,8,-5,-4,5,1,1,2,3,-1,2,1,-2,3,1,1,1,2,0,-1,-328,-2,-2,4,2,0,0,-1,-1,0,-1,1,-1
KR_6618109284,420,-2,-56,1,-1,-5,5,0,0,2,2,1,0,1,2,1,3,1,0,1,0,3,7,0,-5,5,2,0,0,1,1,1,-1,3,-1
KR_6705086837,420,-4,-39,-37,-5,1,2,3,-4,6,2,-5,5,0,0,1,1,3,0,3,-2,-3,-3,-5,-1,6,4,0,-1,-1,-1,-1,-1,2,-1
KR_6624568856,420,-8,-2,-65,-5,3,1,4,-2,2,0,-5,6,1,-1,4,3,0,1,1,1,-8,-8,0,-2,2,-3,0,-1,-1,-1,-1,1,2,-1
KR_6759910954,440,-6,-23,-8,-14,4,0,4,-3,3,0,-10,11,1,-2,2,0,-3,4,1,0,-13,16,-4,-4,8,-1,0,-1,-1,1,-1,-1,5,-1
KR_6759881146,420,-1,-40,22,-12,-4,5,1,-1,3,2,-6,6,0,-2,3,1,1,1,2,0,-9,6,3,-7,4,-6,0,-1,-1,-1,-1,-1,4,-1
KR_6686565866,420,-6,-124,-2,-15,-5,5,0,-4,6,2,-1,5,4,-2,4,2,-3,4,1,-1,-3,31,2,-5,3,-36,0,-2,0,-1,-1,-1,0,-1
KR_6632357143,420,-2,53,-12,-6,0,1,1,-3,3,0,-5,6,1,1,1,2,1,1,2,0,-10,-202,-1,-3,4,-1,0,-1,-1,1,-1,1,2,-1
KR_6748507484,440,2,8,-28,8,2,0,2,2,0,2,3,0,3,1,1,2,0,1,1,0,8,28,2,-3,1,1,0,0,0,1,0,1,0,-1
KR_6692054087,420,0,-79,8,-1,-1,2,1,0,2,2,-1,3,2,0,3,3,1,1,2,0,1,154,-3,-3,6,3,0,-1,1,1,-1,-1,1,-1
KR_6683388293,420,-1,68,22,2,3,0,3,5,3,8,-1,1,0,-5,7,2,0,1,1,0,-4,-280,4,-6,2,4,0,0,-1,1,1,-1,5,-1
KR_6756191624,420,-1,22,12,-6,3,0,3,-7,8,1,-3,4,1,3,3,6,-2,3,1,0,-11,1,0,-5,5,2,0,1,0,1,1,1,0,-1
KR_6690735757,440,-2,-66,4,-6,-2,2,0,-1,2,1,-4,5,1,-1,1,0,2,0,2,0,-5,-3,0,-2,2,1,0,-1,0,0,-1,-1,0,-1
KR_6716334997,420,-1,23,-60,-6,0,0,0,-2,3,1,-8,9,1,3,0,3,1,1,2,0,5,9,-1,-3,4,1,0,0,-1,-1,0,1,2,-1
KR_6697153708,420,-2,-67,-2,-10,1,4,5,-5,7,2,-1,3,2,-5,6,1,0,1,1,0,-9,-3,-3,-4,7,1,0,0,-1,0,-1,-1,5,-1
KR_6671551482,420,-6,-35,-24,-14,-6,6,0,-1,4,3,-5,6,1,0,1,1,-2,3,1,0,-10,324,-1,-2,3,-2,0,0,-1,1,-1,1,3,-1
KR_6644122322,420,-2,11,-44,-12,-1,2,1,-8,11,3,2,1,3,-2,2,0,-3,3,0,0,-11,-123,1,-6,5,4,0,0,-1,1,-1,-1,5,-1
KR_6739835111,440,-2,-7,-4,-9,5,0,5,-6,10,4,0,3,3,-9,10,1,1,0,1,1,-13,-1,-2,-1,3,-2,0,0,1,1,1,1,2,-1
KR_6690438213,420,-1,-8,12,0,-1,2,1,1,0,1,0,2,2,2,2,4,-2,3,1,0,5,-26,1,-3,2,19,0,-2,-1,-1,-1,-1,4,-1
KR_6593777735,420,-2,36,29,-2,0,1,1,4,1,5,-3,7,4,-1,2,1,-2,3,1,1,1,22,1,-6,5,0,0,0,1,-1,-1,1,6,-1
KR_6424569572,420,-5,-24,-51,-11,3,1,4,-4,6,2,-5,7,2,-2,7,5,-3,3,0,-2,-20,3,-5,-4,9,3,0,-1,0,-1,-1,-1,0,-1
KR_6752299810,420,-4,-46,-9,-7,-2,2,0,-1,5,4,-3,3,0,-3,3,0,2,2,4,0,-4,9,0,-4,4,-6,0,1,-1,1,1,-1,6,-1
KR_6695388111,440,0,-35,25,0,1,2,3,0,0,0,0,0,0,-1,1,0,0,1,1,0,-2,-11,-5,-5,10,4,0,0,1,0,0,1,1,-1
KR_6748849079,420,0,-42,4,2,1,2,3,2,1,3,-3,7,4,-1,1,0,3,0,3,1,14,-3,-2,-4,6,0,0,0,-1,-1,0,1,5,-1
KR_6661171560,420,-5,-131,-24,-9,0,0,0,-4,4,0,-2,3,1,-5,5,0,2,0,2,0,-12,11,6,-8,2,-7,0,-1,-1,1,-1,1,1,-1
KR_6657307900,420,-7,-138,-16,-10,-7,7,0,-2,2,0,-2,2,0,0,1,1,1,0,1,0,-7,-15,-4,-2,6,2,0,-1,-1,-1,-1,-1,4,-1
KR_6668437382,420,-3,25,-46,-5,-1,2,1,-2,3,1,1,1,2,-3,7,4,0,1,1,0,-4,-6,-4,-5,9,0,0,-1,-1,-1,-1,-1,5,-1
KR_6723961286,420,-1,-23,-18,-9,0,1,1,-4,5,1,1,2,3,-4,4,0,-2,2,0,0,-15,137,-4,-3,7,-3,0,1,1,1,1,-1,6,-1
KR_6751065319,420,-3,-73,-17,-7,-4,5,1,3,1,4,-1,3,2,-1,4,3,-4,4,0,0,7,2,-4,-3,7,2,0,0,1,-1,-1,-1,5,-1
KR_6763340335,440,0,-20,23,-11,-8,8,0,-1,2,1,0,3,3,-6,6,0,4,0,4,0,-15,1,-6,0,6,-4,0,-1,0,-1,-1,1,0,-1
KR_6752417788,420,-3,-8,-15,-7,-1,2,1,-3,7,4,-1,1,0,0,3,3,-2,2,0,-1,-6,0,2,-6,4,-4,0,0,0,0,0,-1,0,-1
KR_6752271335,420,-3,-87,-4,-5,-11,11,0,1,1,2,1,0,1,2,0,2,2,0,2,1,6,122,0,-2,2,3,0,0,-1,-1,-1,1,4,-1
KR_6762428920,420,-3,5,-20,-3,3,1,4,-1,5,4,-2,3,1,-2,4,2,-1,2,1,0,-2,-4,3,-6,3,-5,0,0,-1,-1,-1,-1,1,-1
KR_5568649310,420,-3,-47,-40,-5,2,3,5,-2,3,1,-2,3,1,-2,5,3,-1,1,0,1,-9,-20,-4,-4,8,-2,0,0,-1,-1,-1,1,1,-1
KR_6764158851,420,-1,-15,-10,4,0,2,2,-2,4,2,2,1,3,2,3,5,2,1,3,-1,5,-3,-4,-3,7,0,0,-1,1,-1,-1,-1,5,-1
KR_6689766989,420,-9,-78,-41,-12,-3,3,0,-5,5,0,-2,4,2,-3,3,0,1,2,3,0,-6,-6,-4,-1,5,2,0,-1,-1,-1,-1,1,3,-1
KR_6739003220,440,-3,-79,-17,-10,0,1,1,-3,3,0,-3,4,1,-1,3,2,-3,3,0,-1,-9,5,1,-3,2,-5,0,-1,-1,1,-1,-1,1,-1
KR_6739706140,420,-4,-71,-11,-11,-6,6,0,-3,3,0,-3,4,1,0,2,2,1,1,2,0,-11,7,-1,-4,5,-5,0,0,1,-1,-1,1,2,-1
KR_6743709513,420,-2,-19,-22,-3,1,2,3,-1,2,1,2,2,4,-4,6,2,-1,2,1,0,-4,2,-2,-1,3,4,0,-2,-1,-1,-1,-1,3,-1
KR_6726895744,420,-4,-14,14,1,1,2,3,-3,3,0,-3,4,1,5,0,5,1,1,2,-1,5,-2,-1,-2,3,0,0,-2,1,-1,1,-1,4,-1
KR_6723505388,420,1,33,18,11,-4,5,1,5,2,7,6,2,8,6,2,8,-2,2,0,4,12,0,-2,-3,5,4,0,1,1,1,1,1,3,-1
KR_6748931194,420,-2,-45,-16,-4,-1,2,1,1,2,3,-2,4,2,-1,3,2,-1,2,1,0,5,2,2,-4,2,1,0,-1,-1,1,-1,-1,5,-1
KR_6728195083,420,0,3,-4,3,-4,5,1,5,0,5,2,2,4,0,0,0,0,0,0,-1,7,22,4,-5,1,-1,0,-1,1,0,-1,1,4,-1
KR_6763816613,420,-6,-44,-1,-6,-3,4,1,4,0,4,-5,7,2,-2,3,1,0,1,1,0,-5,-17,2,-4,2,0,0,-1,-1,1,-1,1,1,-1
KR_6739474753,420,-3,-22,-27,1,-4,4,0,1,3,4,2,1,3,1,2,3,1,1,2,0,6,3,2,-6,4,2,0,-1,-1,-1,-1,1,3,-1
KR_6728741496,440,-2,-29,-19,4,2,3,5,4,1,5,-3,4,1,3,0,3,-2,2,0,-1,0,16,4,-6,2,0,0,2,1,-1,1,-1,3,-1
KR_6764239043,420,-6,-89,-1,-12,-5,5,0,0,1,1,-2,3,1,-4,4,0,-1,1,0,0,-12,-15,-1,-3,4,1,0,-3,-1,-1,-1,-1,4,-1
KR_6755828935,420,-5,-25,-19,-13,-3,4,1,-6,7,1,3,3,6,-7,9,2,0,2,2,0,-14,-19,3,-6,3,-3,0,-2,0,0,-1,-1,0,-1
KR_6726718667,440,-5,-48,-4,-11,0,2,2,-7,7,0,1,1,2,-3,3,0,-2,2,0,0,-14,6,2,-6,4,-6,0,-1,-1,0,-1,-1,4,-1
KR_6748264829,420,-3,18,-27,-8,-3,4,1,-5,8,3,-1,4,3,2,0,2,-1,1,0,0,-5,220,0,-4,4,2,0,-1,-1,1,-1,-1,4,-1
KR_6759660852,420,-3,-64,0,-1,5,0,5,-7,9,2,4,2,6,-3,4,1,0,0,0,0,-3,5,3,-4,1,-5,0,0,-1,1,0,1,3,-1
KR_6735241598,440,-3,-6,-12,-11,-1,1,0,-3,4,1,-1,2,1,-4,4,0,-2,2,0,0,-6,10,2,-5,3,-1,0,-3,1,-1,-1,-1,4,-1
KR_6762701032,420,-2,-19,0,-6,-4,4,0,-6,6,0,3,1,4,2,1,3,-1,1,0,0,-11,-109,3,-7,4,-5,0,0,-1,1,0,1,5,-1
KR_6630120674,420,-1,-38,8,-8,-3,3,0,1,3,4,-1,3,2,-1,4,3,-4,5,1,0,-2,0,0,-3,3,6,0,0,0,0,0,-1,0,-1
KR_6764590980,420,2,20,16,-1,-3,5,2,2,1,3,0,2,2,-2,7,5,2,1,3,1,-2,-8,-4,-4,8,-3,0,-1,1,-1,-1,1,3,-1
KR_6738787293,420,2,-2,19,-3,0,3,3,0,4,4,-1,5,4,-3,4,1,1,0,1,0,-5,2,3,-6,3,-1,0,0,0,-1,1,1,0,-1
KR_6721077107,420,-3,-53,-19,-8,0,1,1,-2,2,0,1,0,1,-4,4,0,-3,4,1,-2,-13,-14,-1,-5,6,1,0,-1,-1,1,-1,-1,6,-1
KR_6744456659,420,-1,3,-4,-2,0,0,0,-1,5,4,2,1,3,-3,6,3,0,3,3,1,5,10,4,-5,1,0,0,0,1,1,0,1,1,-1
KR_6695560140,420,-2,14,25,-4,1,0,1,-1,3,2,-3,6,3,-1,2,1,0,0,0,0,-8,-1,-2,-3,5,-3,0,0,-1,1,0,-1,4,-1
KR_6634373184,420,-2,-79,-20,-2,1,1,2,4,4,8,-3,5,2,-3,3,0,-1,2,1,0,2,1,3,-11,8,-3,0,0,-1,1,0,-1,5,-1
KR_6738588491,440,2,-35,26,1,2,1,3,3,2,5,3,1,4,-7,7,0,0,0,0,0,-7,-44,4,-8,4,27,0,0,1,0,-1,1,6,-1
KR_6724777544,420,1,9,-12,1,5,0,5,-5,5,0,1,4,5,-2,6,4,2,0,2,0,-11,-11,-4,-2,6,3,0,2,-1,1,1,1,5,-1
KR_6748228265,420,-2,-107,-23,4,1,2,3,4,2,6,-1,4,3,0,0,0,0,0,0,0,6,117,2,-5,3,-1,0,0,-1,-1,-1,1,4,-1
KR_6706643869,420,0,4,-20,1,1,1,2,3,0,3,-1,4,3,-2,3,1,0,1,1,0,0,-7,0,-8,8,2,0,0,-1,-1,-1,-1,5,-1
KR_6708368936,420,-3,-65,-16,-8,-3,3,0,2,1,3,-2,2,0,-1,1,0,-4,4,0,0,-9,0,0,-4,4,3,0,-1,-1,-1,-1,-1,6,-1
KR_6745308464,420,0,61,-7,-2,0,3,3,-3,6,3,1,2,3,-2,7,5,2,1,3,1,-2,-227,8,-10,2,-1,0,0,-1,1,-1,1,2,-1
KR_6619369485,420,-1,16,-13,-1,4,0,4,-6,9,3,1,2,3,-1,4,3,1,0,1,3,7,5,3,-5,2,-4,0,0,-1,-1,0,1,1,-1
KR_6760255243,420,2,-39,-17,2,1,2,3,0,2,2,0,0,0,2,0,2,-1,2,1,0,2,-27,1,-6,5,0,0,-1,1,-1,-1,1,6,-1
KR_6659802370,420,-8,-142,-50,-14,-1,3,2,-1,3,2,-7,7,0,-2,3,1,-3,5,2,0,-9,-37,5,-6,1,0,0,-2,-1,1,-1,-1,1,-1
KR_6601234545,420,-2,-72,31,-7,1,0,1,-3,7,4,0,6,6,-2,4,2,-3,4,1,0,-9,-9,-4,-3,7,-1,0,0,1,-1,-1,1,1,-1
KR_6627951396,420,-1,-40,4,-5,-3,4,1,4,2,6,-3,9,6,-2,4,2,-1,1,0,0,-1,5,0,-1,1,-2,0,1,-1,1,1,-1,4,-1
KR_6748361862,440,1,-11,8,3,4,2,6,2,1,3,3,0,3,-6,7,1,0,1,1,2,2,4,5,-7,2,-7,0,1,1,1,1,1,4,-1
KR_6734129707,440,3,-41,36,6,-1,1,0,4,1,5,1,2,3,2,2,4,0,1,1,0,3,1,-2,-1,3,-2,0,0,0,1,0,1,0,-1
KR_6273222273,440,-4,-20,4,-11,3,1,4,-3,3,0,-3,3,0,-7,8,1,-1,3,2,0,-12,-8,-4,-2,6,2,0,-2,-1,-1,-1,-1,1,-1
KR_6722911821,440,-4,-39,-20,-6,2,0,2,-2,4,2,-3,4,1,-2,5,3,-1,3,2,1,-1,-8,1,-3,2,1,0,-1,1,-1,-1,1,1,-1
KR_6689985950,420,-1,-71,-4,3,-4,5,1,3,0,3,1,0,1,1,4,5,2,0,2,0,7,-1,-3,-4,7,-1,0,-1,1,-1,-1,1,6,-1
KR_6738040931,440,-1,57,4,-2,0,3,3,-5,7,2,4,1,5,5,2,7,-6,7,1,0,-7,-5,1,-6,5,-1,0,0,1,1,0,1,4,-1
KR_6744730374,420,0,-43,-20,3,1,1,2,1,4,5,0,3,3,-1,2,1,2,0,2,0,2,116,-4,0,4,1,0,0,1,1,0,-1,3,-1
KR_6754847927,420,-3,-82,20,-2,-1,1,0,-2,3,1,1,2,3,-1,2,1,1,0,1,0,-6,13,0,-2,2,1,0,-1,1,1,-1,-1,1,-1
KR_6750926412,420,-2,-38,9,-2,0,4,4,-1,2,1,1,2,3,-2,5,3,0,2,2,0,-2,-1,-2,-3,5,-1,0,0,1,-1,-1,-1,1,-1
KR_6732447498,440,-4,-76,-1,-9,0,2,2,-1,1,0,-3,5,2,-5,7,2,0,1,1,0,-3,-5,0,-6,6,-3,0,-1,-1,1,-1,-1,3,-1
KR_6761713209,420,0,14,-3,-4,1,0,1,-1,2,1,-2,2,0,-1,1,0,-1,2,1,0,-6,17,0,-7,7,-2,0,0,-1,-1,0,-1,3,-1
KR_6638989939,420,1,-61,-8,-1,-6,8,2,0,3,3,3,2,5,2,4,6,0,2,2,0,7,-26,0,-1,1,16,0,-2,1,0,-1,1,3,-1
KR_6759604522,420,-4,-35,4,-4,-1,3,2,-1,3,2,1,1,2,-3,6,3,0,2,2,0,-2,-1,0,-5,5,-2,0,-1,-1,1,-1,1,4,-1
KR_6713820814,420,-7,-102,-21,-18,-3,6,3,-5,6,1,-3,3,0,-6,7,1,-1,1,0,-2,-16,-10,-2,-2,4,0,0,-3,-1,-1,-1,-1,4,-1
KR_6390583581,420,-3,-25,4,0,-2,3,1,2,3,5,3,4,7,-3,5,2,0,0,0,1,-1,6,-4,0,4,-2,0,0,1,1,0,1,1,-1
KR_6321241687,420,0,43,-33,-3,2,0,2,-1,3,2,-3,4,1,0,0,0,-1,3,2,0,-4,0,1,-4,3,-2,0,-1,-1,-1,-1,-1,1,-1
KR_6650040304,420,0,18,12,3,5,0,5,-2,4,2,-2,3,1,2,0,2,0,1,1,0,3,1,4,-7,3,-3,0,0,-1,0,0,1,4,-1
KR_6733296613,420,0,-61,-4,2,-2,3,1,3,0,3,-1,2,1,-1,2,1,3,0,3,0,8,-120,-2,-2,4,1,0,-2,-1,-1,-1,1,2,-1
KR_6731535049,420,4,8,12,8,5,2,7,5,0,5,0,2,2,-2,2,0,0,0,0,0,1,4,0,-1,1,1,0,1,-1,1,-1,1,3,-1
KR_6758966064,420,4,83,40,13,3,3,6,5,0,5,-6,6,0,8,2,10,3,0,3,0,1,-12,-1,-3,4,3,0,3,-1,1,1,1,4,-1
KR_6730963162,420,-1,-19,-8,-2,-3,4,1,-2,3,1,-1,3,2,2,3,5,2,0,2,0,-8,1,-1,-5,6,-6,0,-2,-1,-1,-1,1,1,-1
KR_6743498912,420,-6,-35,7,-10,-1,2,1,-4,5,1,0,3,3,-6,6,0,1,0,1,1,-7,-2,1,-5,4,-1,0,-2,-1,1,-1,1,6,-1
KR_6684330040,420,-5,-142,-24,-4,-2,3,1,5,0,5,-5,5,0,-2,4,2,0,0,0,0,7,-15,-2,-2,4,0,0,-3,-1,1,-1,-1,1,-1
KR_6733667721,420,-6,-27,-52,-16,1,0,1,-1,2,1,-10,12,2,-5,6,1,-1,4,3,-1,-15,-17,-1,-3,4,0,0,0,-1,1,-1,-1,3,-1
KR_6755267679,440,1,34,-3,-5,2,0,2,-3,4,1,0,1,1,-4,4,0,0,0,0,0,-12,-2,-4,-2,6,-2,0,-1,-1,1,-1,1,4,-1
KR_6741487844,420,-3,29,-11,-5,1,0,1,-4,4,0,-2,2,0,0,1,1,0,1,1,0,-8,41,5,-8,3,-24,0,1,-1,1,1,1,2,-1
KR_6724544140,420,-4,-80,-4,-11,-3,6,3,-5,5,0,0,5,5,-4,6,2,1,0,1,0,-16,2,4,-7,3,0,0,-1,-1,-1,-1,1,6,-1
KR_6760667575,420,0,5,3,1,3,1,4,-1,4,3,0,2,2,-3,3,0,2,0,2,0,4,-46,2,-5,3,21,0,0,1,1,0,-1,4,-1
KR_6739311103,420,0,24,-16,0,-3,6,3,-3,6,3,1,1,2,4,3,7,1,0,1,0,2,-8,-7,-3,10,2,0,0,-1,1,-1,-1,4,-1
KR_6740780145,420,2,55,13,9,0,2,2,0,1,1,8,1,9,1,4,5,0,1,1,1,-3,-6,-4,-2,6,9,0,1,1,1,1,1,4,-1
KR_6764491851,420,-3,-52,-6,-9,-6,7,1,2,1,3,-2,3,1,-4,7,3,1,4,5,0,-1,-349,-1,-4,5,1,0,-2,0,-1,-1,-1,0,-1
KR_6659730709,420,-2,-77,20,2,2,1,3,1,2,3,3,1,4,-2,2,0,-2,2,0,1,0,10,-6,-2,8,-2,0,-1,-1,-1,-1,1,2,-1
KR_6749968312,420,-2,-40,-5,-10,-3,3,0,0,0,0,-5,7,2,-1,4,3,-1,1,0,0,-11,0,-3,-3,6,0,0,0,-1,1,0,-1,6,-1
KR_6764145746,420,-2,-31,16,-4,4,0,4,-1,3,2,1,2,3,-7,7,0,-1,1,0,0,-10,-3,2,-5,3,1,0,1,0,1,1,1,0,-1
KR_6742875809,420,-3,-26,0,-5,-1,5,4,-3,3,0,-2,3,1,1,2,3,0,1,1,1,-7,5,-4,-3,7,0,0,0,-1,0,0,1,2,-1
KR_6695598239,420,-4,-54,4,-6,1,2,3,-1,3,2,-4,4,0,-1,4,3,-1,1,0,0,-6,9,5,-6,1,-4,0,-1,-1,-1,-1,1,1,-1
KR_6711258379,420,-1,-28,-18,0,-2,2,0,-2,4,2,4,0,4,-1,2,1,1,0,1,0,2,-80,-4,-1,5,1,0,0,1,-1,-1,1,5,-1
KR_6696443404,420,0,-46,-4,-5,4,1,5,-4,5,1,-7,8,1,2,2,4,0,0,0,0,-2,-31,1,-4,3,-1,0,1,-1,-1,1,1,5,-1
KR_6644428964,420,0,-61,15,-4,0,0,0,2,1,3,1,0,1,-7,9,2,0,2,2,0,0,39,0,-5,5,-2,0,0,-1,-1,-1,-1,6,-1
KR_6764516590,420,-1,-21,32,-2,-1,2,1,2,1,3,3,0,3,-4,6,2,-2,2,0,0,-5,12,5,-9,4,-3,0,1,1,1,1,-1,1,-1
KR_6699290816,420,1,-20,-1,5,0,1,1,2,3,5,3,1,4,2,1,3,-2,4,2,0,6,-297,2,-4,2,-1,0,-1,1,1,-1,-1,2,-1
KR_6729402172,440,-6,-43,-52,-7,-3,3,0,-4,7,3,-3,3,0,3,2,5,0,0,0,-1,-7,4,-2,-6,8,-1,0,-1,-1,-1,-1,-1,5,-1
KR_6747903719,420,4,61,-3,7,4,1,5,1,2,3,4,0,4,-5,9,4,3,0,3,-1,-3,16,2,-3,1,-7,0,0,0,0,0,-1,0,-1
KR_6321179513,420,-3,-52,-7,1,0,1,1,-3,5,2,0,2,2,4,1,5,0,2,2,0,2,111,0,-6,6,-3,0,0,-1,-1,-1,-1,5,-1
KR_6754057004,420,-1,-68,-11,0,0,1,1,0,3,3,3,0,3,-2,4,2,-1,1,0,0,0,-10,-2,-1,3,0,0,-1,-1,1,-1,-1,5,-1
KR_6751393343,420,2,50,0,11,7,1,8,-8,8,0,0,2,2,5,2,7,7,3,10,0,11,1,0,-4,4,2,0,2,-1,0,1,1,2,-1
KR_6623112463,420,-1,-10,-9,6,-2,2,0,2,5,7,6,2,8,0,3,3,0,3,3,-1,8,-1,2,-4,2,0,0,0,1,-1,-1,-1,1,-1
KR_6761516247,420,-2,13,-44,-2,0,1,1,1,4,5,0,2,2,-3,3,0,0,1,1,0,-7,8,1,-3,2,3,0,0,-1,1,1,1,2,-1
KR_6732507480,440,-2,-25,-3,-7,-2,2,0,-2,3,1,2,0,2,-3,6,3,-2,2,0,0,-5,-6,1,-4,3,0,0,-1,-1,-1,-1,1,5,-1
KR_6760845476,420,-5,-73,-16,-10,-4,4,0,-1,2,1,-3,5,2,-2,3,1,0,0,0,0,-11,-3,-7,-3,10,4,0,0,-1,1,-1,-1,6,-1
KR_6738381971,420,-5,-78,-52,-4,-2,2,0,0,3,3,-2,5,3,-1,5,4,1,2,3,0,6,180,-1,-3,4,-1,-1,-3,-1,-1,-1,1,1,-1
KR_6760097420,420,1,18,-21,4,2,1,3,-3,4,1,0,0,0,3,1,4,2,1,3,0,4,-24,2,-5,3,0,0,1,-1,1,-1,-1,3,-1
KR_6672801894,420,0,-30,-12,4,2,3,5,4,1,5,2,0,2,-3,4,1,-1,1,0,0,8,130,3,-6,3,-5,0,-2,-1,-1,-1,-1,5,-1
KR_6639048958,420,3,58,17,2,0,2,2,3,0,3,-1,5,4,1,0,1,-1,1,0,0,11,-2,0,-4,4,-3,0,0,-1,0,1,-1,5,-1
KR_6748880352,420,-3,-72,8,-4,-1,1,0,-1,2,1,1,5,6,-3,4,1,0,1,1,0,-9,1,-2,-5,7,5,0,-1,-1,1,-1,-1,3,-1
KR_6722751883,420,3,48,12,-2,2,3,5,-2,2,0,1,1,2,-3,5,2,0,2,2,0,-7,-4,1,-6,5,2,0,1,-1,1,1,-1,2,-1
KR_6668481676,420,0,-6,-18,7,-2,3,1,2,3,5,3,0,3,1,3,4,3,1,4,1,16,-5,2,-3,1,5,0,0,0,0,0,1,0,-1
KR_6761597835,420,0,51,-33,-1,4,0,4,-1,1,0,-7,7,0,2,1,3,1,0,1,0,0,12,3,-5,2,1,0,0,-1,-1,-1,-1,3,-1
KR_6713287560,420,3,39,0,-2,5,0,5,-2,2,0,-2,4,2,-5,7,2,2,4,6,-2,-5,-191,1,-3,2,1,0,0,-1,0,-1,-1,5,-1
KR_6640053396,420,0,31,-11,0,1,2,3,0,4,4,-1,3,2,0,2,2,0,1,1,0,-3,-3,-1,-6,7,2,0,0,-1,0,0,-1,4,-1
KR_6629796407,420,-3,-3,-8,-10,2,2,4,-2,4,2,1,3,4,-11,12,1,0,1,1,0,-14,4,1,-5,4,-3,0,0,-1,-1,-1,1,1,-1
KR_6749322382,420,0,6,-21,2,-2,4,2,1,2,3,1,0,1,3,2,5,-1,2,1,0,11,-21,-6,-3,9,-2,0,-2,-1,1,-1,1,1,-1
KR_6735052775,420,0,39,-20,0,0,0,0,-3,5,2,2,1,3,-1,1,0,2,0,2,0,0,-6,-1,-2,3,2,0,0,1,-1,-1,1,6,-1
KR_6717427640,420,-4,-49,-10,-7,-4,5,1,-3,4,1,1,3,4,-1,3,2,0,0,0,0,-7,106,2,-6,4,3,0,-1,-1,-1,-1,1,1,-1
KR_6764692805,440,3,-3,-3,0,-6,6,0,2,2,4,2,1,3,3,1,4,-1,2,1,0,8,-15,-3,-3,6,-2,0,0,1,-1,0,-1,1,-1
KR_6763581245,420,-1,34,-11,-4,2,0,2,-2,2,0,-3,4,1,-1,2,1,0,0,0,0,-2,21,1,-2,1,0,0,0,1,-1,0,-1,5,-1
KR_6728057896,420,-4,-72,1,-10,0,0,0,-8,9,1,2,1,3,-2,3,1,-2,3,1,0,-9,-13,0,-4,4,-2,0,-2,0,0,-1,1,0,-1
KR_6733783429,420,0,88,32,1,2,1,3,-3,4,1,3,2,5,-4,4,0,3,0,3,0,-7,63,3,-4,1,-21,0,0,-1,1,0,1,2,-1
KR_6707095494,440,-3,-50,-33,-1,-1,3,2,-2,3,1,0,1,1,1,1,2,1,0,1,0,2,-3,-5,0,5,1,0,0,-1,-1,0,-1,2,-1
KR_6750948091,420,0,-3,5,-8,-3,3,0,-4,6,2,2,3,5,-3,4,1,0,1,1,0,-12,296,-2,-3,5,0,0,-1,-1,-1,-1,-1,5,-1
KR_6760954428,420,1,12,8,1,-1,3,2,2,1,3,-5,6,1,4,2,6,1,1,2,1,13,-7,3,-7,4,-1,0,0,1,-1,0,1,3,-1
KR_6722529696,420,-4,-64,-11,-1,-1,2,1,1,4,5,-4,5,1,5,3,8,-2,2,0,1,3,219,2,-4,2,2,0,-2,-1,-1,-1,1,5,-1
KR_6748925773,440,-2,-62,12,-9,-2,2,0,0,1,1,-3,6,3,-4,4,0,0,0,0,-1,-14,-5,1,-3,2,-3,0,0,1,1,0,-1,4,-1
KR_6747333030,420,1,-10,-2,1,4,1,5,-3,3,0,3,2,5,-7,8,1,4,0,4,1,-4,-5,1,-5,4,-4,0,1,0,-1,-1,1,0,-1
KR_6583091139,440,-5,-50,-28,-12,-1,1,0,1,3,4,-4,5,1,2,5,7,-10,11,1,0,-2,0,-2,-3,5,1,0,-1,1,1,-1,-1,1,-1
KR_6755629124,440,-5,-63,-28,-9,-1,4,3,-6,6,0,-3,3,0,0,2,2,1,0,1,1,0,-292,-4,-2,6,-1,0,-1,0,-1,-1,1,0,-1
KR_6668811743,420,2,-4,-4,3,3,2,5,1,3,4,0,1,1,-1,5,4,0,1,1,0,-5,3,3,-7,4,1,0,2,-1,1,1,-1,6,-1
KR_6752660589,420,-6,-130,-18,-12,-3,4,1,-5,6,1,-2,5,3,-4,6,2,2,0,2,-3,-10,-403,-3,-3,6,-1,0,-2,-1,0,-1,-1,2,-1
KR_6714801092,420,0,-79,-28,4,-2,2,0,3,5,8,3,2,5,-1,3,2,1,1,2,0,1,0,-3,-2,5,1,0,-1,1,-1,-1,-1,6,-1
KR_6760289158,420,-5,-43,-24,-11,-5,5,0,1,4,5,0,0,0,-5,6,1,-2,3,1,0,-3,0,2,-3,1,0,0,-1,1,-1,-1,-1,1,-1
KR_6620774604,420,-5,-89,-10,-15,-3,4,1,3,1,4,-10,13,3,-5,7,2,0,2,2,-2,-9,-12,-2,-2,4,3,0,-3,-1,-1,-1,-1,3,-1
KR_6731908658,420,0,10,-8,-4,2,1,3,1,1,2,0,6,6,-5,9,4,-2,4,2,0,-10,-1,1,-4,3,-5,0,1,-1,0,-1,-1,3,-1
KR_6738039989,440,-2,-10,8,-4,6,1,7,-5,6,1,0,3,3,-6,8,2,1,0,1,0,-14,2,7,-10,3,-4,0,-1,-1,-1,-1,1,6,-1
KR_6726984913,420,-4,-24,20,-11,-3,3,0,-2,5,3,-2,3,1,-4,4,0,0,0,0,0,-15,17,-5,0,5,-1,0,-1,-1,-1,-1,-1,5,-1
KR_6735342647,420,-5,-88,8,-7,1,3,4,2,1,3,2,0,2,-5,7,2,-7,7,0,0,-3,-14,-4,-4,8,1,0,-2,-1,-1,-1,-1,6,-1
KR_6731553115,440,-1,-25,-16,-4,-3,3,0,0,1,1,-1,3,2,-2,5,3,2,0,2,1,2,2,-2,-2,4,6,0,0,-1,1,0,1,1,-1
KR_6759799372,420,1,-13,24,-4,5,2,7,-1,5,4,4,3,7,-9,12,3,-3,3,0,0,-7,-1,1,-6,5,-1,0,0,-1,0,-1,1,3,-1
KR_6572710906,420,-4,-65,-4,-9,-2,3,1,-2,2,0,3,1,4,-5,5,0,-3,4,1,0,-7,18,3,-6,3,2,0,-2,1,1,-1,1,4,-1
KR_6762374156,420,0,26,0,-11,-1,2,1,-3,4,1,-1,2,1,-3,6,3,-3,3,0,0,-13,14,7,-8,1,-1,0,0,1,0,0,1,4,-1
KR_6655647890,420,-1,-12,0,-4,-1,1,0,-4,6,2,2,1,3,-1,5,4,0,1,1,0,-3,-8,3,-7,4,1,0,-1,1,-1,-1,-1,2,-1
KR_6750997019,420,-6,-54,-23,-1,0,1,1,0,1,1,0,1,1,-4,4,0,3,3,6,0,2,48,0,-4,4,-35,0,0,-1,-1,0,-1,4,-1
KR_6741199515,420,-3,9,-4,-10,-3,5,2,-4,8,4,3,1,4,-7,7,0,1,2,3,0,-13,-2,-5,-2,7,-1,0,-1,-1,1,-1,-1,1,-1
KR_6283156900,420,-2,-81,-39,-2,3,1,4,-5,6,1,-2,2,0,2,0,2,0,0,0,-2,-7,-4,4,-7,3,-4,0,1,-1,1,1,-1,6,-1
KR_6684554308,420,-2,0,-28,-3,-2,3,1,-1,2,1,0,0,0,-1,3,2,1,1,2,1,1,229,-2,-5,7,2,0,0,1,-1,1,1,2,-1
KR_6749725295,440,-4,-31,5,-15,2,1,3,-8,8,0,-4,6,2,-5,6,1,0,0,0,0,-17,-9,-1,-1,2,2,0,0,-1,1,0,1,3,-1
KR_6754173827,420,-3,-103,0,-5,-2,3,1,2,2,4,1,1,2,-2,2,0,-4,4,0,0,1,0,2,-6,4,-4,0,-3,1,0,-1,-1,6,-1
KR_6750451547,420,-1,-2,8,1,0,1,1,-2,4,2,4,3,7,-1,5,4,0,2,2,-1,-6,-2,-1,-3,4,1,0,-2,-1,-1,-1,-1,6,-1
KR_6761551711,420,-4,-17,5,-8,-7,7,0,-1,1,0,6,0,6,-3,3,0,-3,3,0,0,-9,-5,-3,-1,4,2,0,0,-1,1,-1,-1,2,-1
KR_6682882580,420,-7,-55,-57,-11,2,1,3,-4,7,3,-6,6,0,-3,6,3,0,0,0,1,-2,383,2,-2,0,0,0,-3,-1,-1,-1,1,3,-1
KR_6638157029,420,-1,-110,28,-1,-3,3,0,2,0,2,-2,3,1,4,5,9,-2,4,2,-1,8,48,-2,-3,5,-22,0,0,-1,-1,-1,-1,6,-1
KR_6682742917,420,-5,-66,-17,-9,1,2,3,-3,5,2,-6,8,2,-1,3,2,0,0,0,-1,-1,-7,-3,-1,4,2,0,-1,1,0,-1,-1,3,-1
KR_6658857349,420,-1,9,-2,-7,0,2,2,0,2,2,-6,7,1,-4,8,4,3,0,3,0,-1,-4,-3,0,3,1,0,0,-1,1,1,1,4,-1
KR_6605995545,420,-2,-22,-4,-4,-1,4,3,-7,9,2,3,0,3,0,1,1,1,0,1,0,3,16,4,-7,3,-3,0,-2,1,-1,-1,-1,6,-1
KR_6732809725,440,-1,49,-41,-11,0,4,4,1,2,3,3,0,3,-12,12,0,-3,4,1,-1,-10,7,6,-9,3,-2,0,-1,0,0,-1,-1,0,-1
KR_6763079221,440,2,-4,-19,4,2,0,2,5,0,5,1,1,2,-1,2,1,-3,3,0,0,6,2,4,-5,1,3,0,0,-1,1,0,-1,4,-1
KR_6725145977,440,0,89,-20,-5,5,0,5,-2,4,2,-1,5,4,-7,9,2,0,0,0,0,-10,-2,-5,-2,7,-3,0,0,-1,-1,0,1,5,-1
KR_6681487011,420,-5,-30,7,-4,-6,6,0,-2,4,2,1,1,2,-1,4,3,4,0,4,0,4,2,0,-2,2,3,0,0,-1,0,-1,-1,1,-1
KR_6736794863,440,-5,-93,-20,-6,0,2,2,3,0,3,-2,3,1,-1,6,5,-6,6,0,0,-1,-29,0,-4,4,14,0,-1,0,-1,-1,-1,0,-1
KR_6708354690,420,1,-21,-4,-2,5,0,5,-2,3,1,6,0,6,-11,12,1,0,0,0,1,-20,-5,0,-2,2,0,0,-1,-1,1,-1,1,1,-1
KR_6749356980,420,-1,3,-28,-1,0,1,1,-2,4,2,1,3,4,3,3,6,-3,4,1,0,-2,2,3,-6,3,1,0,0,1,0,0,1,5,-1
KR_6727995843,420,-5,-77,-40,-5,-2,4,2,-2,4,2,-3,6,3,2,1,3,0,1,1,0,1,1,0,-6,6,4,0,-1,-1,-1,-1,-1,3,-1
KR_6732595670,420,-3,-34,2,-13,0,1,1,-5,6,1,-7,10,3,2,3,5,-3,4,1,1,-14,-121,0,-5,5,0,0,1,1,1,1,-1,3,-1
KR_6764011103,420,-3,-51,-27,-7,-5,7,2,3,3,6,2,2,4,-4,4,0,-3,5,2,-1,-1,-21,4,-7,3,-4,0,0,-1,0,0,1,3,-1
KR_6756363922,420,-4,15,-5,-8,-3,3,0,-1,2,1,5,1,6,-6,7,1,-3,3,0,0,-12,183,0,-2,2,-1,0,0,0,1,0,-1,0,-1
KR_6642035675,420,1,8,24,1,2,5,7,-2,4,2,3,5,8,0,3,3,-2,2,0,-2,-1,-21,0,-3,3,4,0,1,0,0,1,-1,0,-1
KR_6762439101,420,2,59,16,-1,1,1,2,-2,3,1,-3,4,1,3,1,4,0,0,0,0,4,8,2,-5,3,-2,0,0,1,-1,1,-1,3,-1
KR_6639583864,420,0,49,-35,1,1,1,2,-2,3,1,4,1,5,-2,4,2,0,1,1,0,1,3,-4,-4,8,-4,0,1,1,-1,1,-1,4,-1
KR_6758570313,420,-2,-31,-22,-5,1,3,4,-3,4,1,-4,5,1,0,1,1,1,0,1,-1,-6,-9,-5,-2,7,2,0,-1,1,-1,-1,-1,6,-1
KR_6760830299,420,-2,9,-36,-2,1,1,2,-2,3,1,0,3,3,-1,3,2,0,1,1,0,-8,-4,-1,-5,6,1,0,0,0,1,1,1,0,-1
KR_6734219949,440,-5,-65,0,-7,-1,2,1,-2,3,1,-1,1,0,-2,5,3,-1,2,1,0,-6,7,-1,-4,5,2,0,0,-1,0,0,-1,5,-1
KR_6727642846,420,0,8,19,1,-1,1,0,7,0,7,-3,3,0,-2,3,1,0,2,2,0,2,-226,-2,-2,4,2,0,-1,-1,-1,-1,-1,3,-1
KR_6759527300,420,-1,15,20,1,1,0,1,4,0,4,-3,4,1,-1,4,3,0,0,0,0,0,9,6,-7,1,-6,0,0,-1,1,0,1,2,-1
KR_6687281487,420,0,34,-6,3,3,0,3,5,0,5,-4,4,0,-1,1,0,0,0,0,0,1,-6,0,-7,7,2,0,0,0,-1,0,1,0,-1
KR_6632684383,420,-6,-80,1,-13,-3,4,1,-2,4,2,-1,3,2,-7,7,0,0,1,1,-1,-19,-25,-5,0,5,4,0,0,-1,-1,-1,-1,5,-1
KR_6627864422,420,-4,-64,-4,-11,-2,4,2,-1,3,2,2,0,2,-8,10,2,-2,3,1,0,-5,5,-2,-3,5,1,0,-3,-1,-1,-1,-1,2,-1
KR_6763221540,420,0,-39,-27,-3,3,1,4,-1,2,1,-2,3,1,-4,6,2,1,0,1,0,-8,110,-2,-3,5,-2,0,0,0,0,0,1,0,-1
KR_6757491102,420,1,24,8,6,-3,5,2,2,2,4,6,0,6,3,0,3,-2,4,2,0,8,240,3,-5,2,0,0,0,1,1,1,1,6,-1
KR_6684610116,420,1,19,16,-2,-3,3,0,0,5,5,-4,4,0,4,2,6,1,3,4,0,5,-3,-1,-2,3,0,0,1,-1,1,1,1,2,-1
KR_6720253352,420,4,5,-13,11,2,1,3,4,1,5,4,2,6,1,2,3,0,3,3,0,6,-34,2,-5,3,18,0,1,-1,0,1,-1,4,-1
KR_6758468293,420,0,-43,20,4,0,1,1,-1,3,2,8,0,8,-2,2,0,-1,6,5,0,2,-182,0,-3,3,1,0,-1,1,-1,-1,1,5,-1
KR_6705473680,440,0,12,-20,2,-3,5,2,0,3,3,3,3,6,-1,2,1,3,1,4,0,2,-8,1,-1,0,-1,0,0,1,-1,-1,-1,3,-1
KR_6760591515,420,-2,-54,-19,-8,-3,4,1,2,0,2,2,2,4,-5,7,2,-4,4,0,0,-8,-6,-2,-1,3,-1,0,-2,-1,-1,-1,-1,5,-1
KR_6654339766,420,-3,19,-12,-3,-2,2,0,-3,3,0,1,4,5,3,0,3,-2,2,0,0,-6,0,-4,-3,7,-3,0,-1,0,1,-1,-1,0,-1
KR_6672121246,420,-1,-3,-16,-5,-2,3,1,1,1,2,-3,5,2,-1,6,5,0,2,2,0,-3,-2,-5,-1,6,-3,0,0,-1,-1,0,-1,3,-1
KR_6695468724,440,-2,-17,-16,-5,0,0,0,4,0,4,0,1,1,-3,3,0,-6,7,1,0,0,6,5,-6,1,-1,0,0,-1,-1,-1,-1,1,-1
KR_6744190938,420,-1,10,65,-7,1,1,2,1,1,2,-8,9,1,0,2,2,-1,1,0,0,1,2,-1,-2,3,0,0,2,1,1,1,-1,5,-1
KR_6638343676,420,-3,-72,-25,-3,-2,4,2,2,2,4,-1,4,3,1,2,3,-3,4,1,-1,0,-20,2,-5,3,-3,0,-1,-1,1,-1,-1,5,-1
KR_6441236773,420,-4,-86,4,-13,1,1,2,-3,4,1,-8,8,0,-2,2,0,-1,2,1,0,-10,-29,0,-3,3,10,0,-2,-1,1,-1,-1,5,-1
KR_6642489502,420,0,7,8,-5,-1,2,1,-3,3,0,-5,6,1,5,0,5,-1,1,0,0,-2,5,0,-3,3,1,0,0,-1,0,0,-1,1,-1
KR_6717872228,420,-6,-25,-27,-9,1,0,1,-2,3,1,-2,2,0,-3,5,2,-3,3,0,0,-4,-20,1,-7,6,1,0,-2,-1,1,-1,-1,6,-1
KR_6764139753,420,0,75,-8,-4,-2,3,1,2,1,3,-3,5,2,-1,2,1,0,1,1,0,-5,3,5,-8,3,3,0,-1,-1,-1,-1,-1,2,-1
KR_6748402765,420,-3,-93,12,-9,2,0,2,1,3,4,0,3,3,-12,12,0,0,0,0,0,-11,-10,1,-3,2,0,0,-2,-1,-1,-1,-1,3,-1
KR_6606248096,420,-2,-33,-8,-2,-3,3,0,0,2,2,-1,1,0,2,0,2,0,1,1,0,2,-8,1,-2,1,24,0,0,-1,0,0,-1,3,-1
KR_6724607606,440,1,-4,-4,-1,-1,2,1,-1,1,0,8,0,8,-7,7,0,0,1,1,2,-4,-43,-1,-5,6,22,0,-2,-1,-1,-1,1,3,-1
KR_6763547017,440,-4,-27,-22,-6,-5,6,1,-1,2,1,1,4,5,0,1,1,-1,1,0,0,3,-284,-2,-1,3,3,0,-1,-1,0,-1,-1,5,-1
KR_6759256983,420,3,44,20,11,2,1,3,1,1,2,4,1,5,6,2,8,-2,2,0,0,11,-1,5,-8,3,4,0,0,1,1,1,1,5,-1
KR_6758975342,420,-3,-73,-24,-7,-1,2,1,1,0,1,-7,8,1,-1,2,1,1,1,2,0,-5,-3,0,-3,3,0,0,-2,-1,1,-1,1,1,-1
KR_6762150762,440,2,16,25,4,-5,6,1,2,0,2,0,3,3,5,2,7,2,0,2,1,7,1,1,-6,5,5,0,-1,-1,1,-1,1,4,-1
KR_6716805397,420,-6,-71,-64,-1,-2,3,1,3,2,5,-1,3,2,0,4,4,-1,3,2,1,5,15,-1,-2,3,-5,0,-1,0,-1,-1,1,0,-1
KR_6610796289,420,1,26,1,1,3,2,5,-2,4,2,4,0,4,-2,3,1,-2,4,2,0,-7,-31,7,-8,1,3,0,2,-1,0,1,1,6,-1
KR_6748961532,420,-2,-19,-24,-2,-2,3,1,-1,5,4,-1,4,3,2,3,5,0,2,2,0,0,11,-1,-2,3,-3,0,-1,-1,-1,-1,1,2,-1
KR_6716534004,420,-2,-48,8,-2,-3,5,2,2,7,9,-1,3,2,-1,5,4,1,1,2,0,8,1,4,-7,3,-5,0,-1,1,-1,-1,-1,3,-1
KR_6755397864,420,-6,-139,24,-13,-5,6,1,-4,5,1,1,5,6,-5,8,3,0,0,0,0,-8,-13,-6,0,6,2,0,-3,1,-1,-1,-1,5,-1
KR_6759504809,420,2,42,36,-4,1,0,1,-6,6,0,-3,5,2,4,0,4,0,2,2,0,-5,-2,0,-5,5,-1,0,0,0,0,0,1,0,-1
KR_6762564784,420,-1,-6,-24,-1,0,2,2,1,2,3,0,0,0,-5,6,1,3,1,4,0,-1,17,5,-6,1,5,0,0,-1,1,0,-1,4,-1
KR_6687414691,440,-3,-59,-16,-6,1,2,3,-4,5,1,-2,3,1,-1,1,0,0,0,0,0,-13,19,-1,-5,6,-1,0,-1,-1,-1,-1,1,3,-1
KR_6682861321,420,1,8,-4,-5,1,2,3,-2,5,3,-5,5,0,0,2,2,1,0,1,0,-5,143,-3,-4,7,-1,0,-1,1,-1,-1,-1,2,-1
KR_6762449154,420,-1,12,20,-4,0,3,3,4,2,6,0,2,2,-10,13,3,2,0,2,0,-6,4,-2,-6,8,-2,0,-1,0,1,-1,-1,0,-1
KR_6747786447,420,-1,-21,-8,-1,-1,1,0,1,1,2,1,1,2,-1,4,3,-1,1,0,1,-2,-1,-1,-4,5,3,0,-1,-1,-1,-1,1,3,-1
KR_6663644554,440,-3,-30,-38,-4,-4,6,2,-4,5,1,2,2,4,2,3,5,0,2,2,1,2,11,5,-11,6,-3,0,-1,1,-1,-1,-1,4,-1
KR_6639994756,420,0,2,32,-2,3,0,3,-4,7,3,-3,3,0,2,1,3,0,2,2,0,1,-11,-5,-1,6,3,0,1,-1,1,1,1,6,-1
KR_6648972739,420,1,51,-32,-1,-1,2,1,-1,1,0,-1,2,1,4,0,4,-2,2,0,0,-3,68,-3,-4,7,2,0,1,-1,-1,1,1,2,-1
KR_6761522718,420,3,13,4,5,9,0,9,-2,2,0,-1,5,4,-2,3,1,1,0,1,0,0,3,-1,-4,5,0,0,-1,-1,1,-1,-1,1,-1
KR_6739946205,420,-5,3,-44,-14,-4,6,2,-3,4,1,-7,8,1,1,1,2,-1,1,0,0,-13,1,0,-4,4,0,0,-1,1,-1,-1,1,4,-1
KR_6746687021,420,1,25,-24,-6,0,0,0,-2,2,0,-3,4,1,2,4,6,-3,4,1,-1,-10,-19,-2,-3,5,4,0,0,0,1,0,-1,0,-1
KR_6657015884,420,-3,-75,-48,-4,-4,6,2,-3,3,0,-1,2,1,3,3,6,1,0,1,-1,6,3,-2,-2,4,2,0,-1,-1,-1,-1,-1,6,-1
KR_6654350542,420,0,-35,28,4,-4,4,0,1,5,6,-2,5,3,8,1,9,1,0,1,2,4,-12,0,-5,5,-1,0,0,0,-1,-1,1,0,-1
KR_6686712578,420,-2,-36,-5,-1,1,1,2,-2,2,0,3,1,4,-2,2,0,-1,2,1,0,-8,-18,1,-5,4,-3,0,0,-1,-1,0,-1,3,-1
KR_6753900951,420,2,42,1,-6,-1,2,1,-6,7,1,2,1,3,0,5,5,-1,3,2,1,-4,-305,1,-5,4,2,0,0,-1,1,-1,1,5,-1
KR_6755075286,440,-1,5,12,-3,2,1,3,-5,6,1,-1,2,1,1,2,3,0,0,0,0,1,4,1,-4,3,-1,0,0,1,1,0,1,5,-1
KR_6746146847,420,-2,34,-26,0,5,0,5,-4,6,2,-1,5,4,-1,3,2,1,0,1,0,6,-6,1,-2,1,0,0,0,-1,1,1,-1,2,-1
KR_6752151992,420,-4,-33,-13,-8,2,3,5,1,1,2,1,2,3,-6,6,0,-6,6,0,1,-11,21,-5,-1,6,-1,0,0,-1,-1,-1,1,5,-1
KR_6634556899,420,-1,-33,-9,-1,0,1,1,1,0,1,0,1,1,2,2,4,-4,4,0,0,-5,-26,-3,-4,7,-6,0,0,-1,1,0,1,6,-1
KR_6753953382,420,-3,-43,-8,-7,-2,4,2,3,1,4,-2,5,3,-3,3,0,-3,3,0,2,4,8,-2,-3,5,0,0,-3,-1,-1,-1,1,2,-1
KR_6572565815,420,-4,-59,-22,-12,-3,3,0,-1,5,4,-6,7,1,1,0,1,-3,3,0,-2,-16,-270,3,-5,2,-4,0,0,-1,-1,0,-1,5,-1
KR_6751828992,420,0,-43,17,1,1,2,3,2,1,3,-4,5,1,7,1,8,-5,6,1,0,-4,4,-1,-1,2,-1,0,-1,1,1,-1,1,5,-1
KR_6743795741,420,-2,-30,-7,1,1,0,1,3,3,6,0,3,3,-1,1,0,-2,2,0,0,5,-10,1,-5,4,-5,0,-1,-1,1,-1,1,3,-1
KR_6742262148,440,-5,-35,-7,-10,-2,2,0,-2,3,1,1,0,1,-6,6,0,-1,3,2,0,-4,5,0,-1,1,-2,0,-2,-1,-1,-1,-1,3,-1
KR_6759578604,440,-2,-10,12,-4,-3,3,0,-1,1,0,-1,2,1,1,1,2,0,1,1,0,-5,7,1,-6,5,-5,0,-1,-1,-1,-1,1,4,-1
KR_6753715850,420,-6,-89,-15,-19,0,2,2,3,1,4,-5,6,1,-11,11,0,-6,7,1,0,-13,-1,2,-5,3,-1,0,-2,-1,1,-1,-1,2,-1
KR_6741284946,420,1,4,-28,-3,1,2,3,-1,2,1,-1,1,0,-1,3,2,-1,1,0,0,-7,68,5,-8,3,-1,0,0,1,1,1,1,5,-1
KR_6695909877,440,-1,15,-19,-4,0,1,1,2,5,7,-4,4,0,-1,6,5,-1,1,0,-2,-9,-3,-4,-4,8,1,0,0,-1,1,1,-1,3,-1
KR_6758351817,420,-5,-38,-23,-12,-7,7,0,-1,3,2,0,1,1,-3,4,1,-1,2,1,0,-6,-5,1,-4,3,0,0,-1,-1,-1,-1,1,3,-1
KR_6644448885,420,-1,-33,-36,4,3,1,4,-4,6,2,0,1,1,4,2,6,1,0,1,0,9,0,1,-2,1,-2,0,-3,-1,-1,-1,1,2,-1
KR_6682940212,420,2,28,-21,-2,0,1,1,0,2,2,0,2,2,0,1,1,-2,3,1,0,-4,41,-4,-2,6,1,0,0,-1,1,-1,-1,5,-1
KR_6754554342,440,2,31,8,10,5,1,6,5,2,7,3,3,6,0,1,1,-3,3,0,1,17,280,2,-5,3,0,0,0,-1,-1,-1,1,6,-1
KR_6687536216,420,-1,65,-12,-5,-6,7,1,-12,13,1,3,0,3,10,0,10,0,1,1,3,9,12,3,-6,3,4,0,2,-1,-1,1,1,3,-1
KR_6670952998,440,2,31,-8,0,4,0,4,0,1,1,-6,6,0,2,0,2,0,2,2,1,5,-1,0,-2,2,0,0,0,1,0,-1,1,4,-1
KR_6687485612,420,-1,-10,36,-3,-2,6,4,-2,3,1,2,1,3,1,0,1,-2,5,3,0,-1,-5,-4,-3,7,-2,0,-1,1,-1,-1,1,3,-1
KR_6763793939,420,0,5,35,-9,-2,2,0,-1,2,1,2,0,2,-7,12,5,-1,2,1,0,-4,33,-2,-2,4,-2,0,1,-1,1,1,-1,6,-1
KR_6664280358,420,2,-3,9,8,3,3,6,-2,4,2,6,1,7,3,2,5,-2,2,0,1,12,-1,5,-7,2,-1,0,-1,-1,1,-1,1,2,-1
KR_6743807016,440,-2,31,1,-4,-3,3,0,1,1,2,5,0,5,-5,7,2,-2,3,1,0,-6,2,-3,-3,6,0,0,-2,-1,-1,-1,1,5,-1
KR_6755807521,420,3,10,8,12,1,4,5,-1,4,3,2,2,4,9,2,11,1,1,2,0,8,-5,-2,-4,6,1,0,0,0,1,1,1,0,-1
KR_6690170556,420,-2,-70,21,-11,-4,4,0,4,0,4,-4,5,1,-4,5,1,-3,3,0,-2,-15,7,3,-5,2,-4,0,-3,-1,-1,-1,-1,5,-1
KR_6674049496,420,-1,-56,-32,6,-2,4,2,1,3,4,7,2,9,-1,3,2,1,0,1,1,15,2,3,-8,5,-4,0,-1,1,1,-1,1,2,-1
KR_6753876493,420,0,-43,19,0,-5,8,3,1,3,4,1,1,2,3,2,5,0,2,2,-1,-1,7,0,-5,5,-1,0,1,-1,0,-1,-1,3,-1
KR_6659557849,420,-2,1,-52,-7,1,1,2,-1,5,4,-1,4,3,-4,6,2,-2,2,0,0,-1,-7,0,-5,5,-2,0,0,1,-1,-1,-1,3,-1
KR_6755587935,420,1,29,28,-5,0,3,3,-2,5,3,-1,3,2,-3,5,2,1,0,1,0,-8,8,1,-6,5,-4,0,1,1,-1,-1,1,5,-1
KR_6763571398,440,1,50,-2,1,8,0,8,-3,3,0,-2,3,1,-3,5,2,1,1,2,0,-4,-118,2,-4,2,1,0,-1,1,1,1,1,3,-1
KR_6710657033,420,-2,-4,-8,-10,-1,3,2,-3,4,1,-1,2,1,1,0,1,-6,6,0,0,-6,24,-1,-5,6,-2,0,-2,-1,1,-1,-1,2,-1
KR_6605682557,420,-2,-79,-8,-3,-2,3,1,2,3,5,-3,4,1,1,3,4,-1,1,0,0,4,0,-1,-4,5,3,0,-1,1,1,-1,-1,1,-1
KR_6727369672,440,-7,-25,-3,-15,-6,7,1,0,3,3,-3,4,1,-3,3,0,-3,4,1,0,-5,-6,-5,-1,6,2,0,-2,-1,-1,-1,-1,4,-1
KR_6746736547,420,2,60,24,1,2,2,4,-2,3,1,-1,2,1,0,4,4,2,1,3,0,2,-26,3,-6,3,13,0,0,0,1,1,-1,0,-1
KR_6733710552,420,-2,7,-39,-3,-1,2,1,-1,3,2,-2,3,1,-2,4,2,3,0,3,0,-5,-7,1,-8,7,-2,0,0,-1,0,0,-1,3,-1
KR_6750251043,420,-2,-31,4,2,-3,3,0,-1,4,3,0,3,3,7,0,7,-1,1,0,0,5,-6,2,-5,3,-5,0,0,0,0,0,1,0,-1
KR_6714290949,420,-3,-87,-4,-8,-1,4,3,-1,1,0,-2,3,1,-5,5,0,1,0,1,0,-9,35,-2,-5,7,-1,0,0,1,-1,0,-1,3,-1
KR_6742901325,420,-2,-73,-4,-5,-6,6,0,0,3,3,-3,3,0,4,0,4,0,1,1,0,-1,-8,-1,-4,5,-3,0,0,-1,-1,-1,-1,1,-1
KR_6762348602,420,-7,-176,-16,-7,-10,10,0,-1,2,1,4,0,4,0,3,3,0,2,2,0,-5,23,0,-4,4,-5,0,-3,1,-1,-1,1,5,-1
KR_6760780484,420,-5,-101,-11,-11,-1,3,2,-6,7,1,0,3,3,-4,6,2,0,0,0,-1,-10,-31,1,-2,1,4,0,-2,-1,-1,-1,-1,6,-1
KR_6761372441,440,-5,-51,21,-4,1,0,1,-1,2,1,0,2,2,-3,3,0,-1,1,0,0,-3,-35,1,-5,4,-3,0,-1,1,-1,-1,-1,3,-1
KR_6732933833,420,1,20,-13,5,2,2,4,2,0,2,4,2,6,-2,2,0,-1,1,0,0,1,-24,1,-4,3,0,0,-1,-1,1,-1,-1,5,-1
KR_6764796400,440,-1,-10,15,-7,-1,2,1,-1,2,1,-1,2,1,-5,6,1,1,0,1,0,-3,-422,-2,-2,4,-5,0,0,-1,-1,0,-1,2,-1
KR_6754608004,420,1,46,-9,1,4,1,5,-3,5,2,5,1,6,0,1,1,-5,5,0,0,1,-18,-3,-2,5,-3,0,0,1,-1,-1,-1,1,-1
KR_6656991583,420,1,24,32,4,2,0,2,1,0,1,1,1,2,-1,3,2,1,0,1,0,-3,-155,-4,-2,6,-2,0,1,1,0,1,1,1,-1
KR_6752934504,440,3,-6,24,4,0,1,1,2,1,3,2,0,2,0,1,1,0,1,1,0,1,1,0,-3,3,-1,0,0,1,1,1,-1,5,-1
KR_6629901964,420,-2,-42,-20,-6,-3,3,0,-2,4,2,-3,5,2,1,2,3,1,0,1,0,-2,-3,-2,-1,3,-2,0,0,-1,-1,0,-1,6,-1
KR_6762334612,420,-2,-13,-32,-6,1,2,3,-8,8,0,1,1,2,-2,3,1,2,3,5,-1,-6,1,3,-6,3,1,0,-1,-1,-1,-1,-1,6,-1
KR_6734067907,420,0,-94,24,-3,-3,4,1,2,1,3,0,2,2,-4,5,1,2,0,2,0,-7,-6,-1,-2,3,2,0,-1,1,1,1,-1,1,-1
KR_6743021070,420,0,56,0,-2,-1,1,0,-5,8,3,0,1,1,4,4,8,0,2,2,-1,-4,70,2,-4,2,-26,0,0,1,-1,0,-1,5,-1
KR_6653903814,420,-1,-50,18,1,1,0,1,3,1,4,-4,7,3,2,2,4,-1,2,1,0,5,-18,5,-7,2,14,0,1,-1,1,1,-1,5,-1
KR_6751171321,420,-2,-17,16,-4,-6,7,1,2,1,3,1,1,2,0,5,5,-1,1,0,0,-6,-1,4,-9,5,-3,0,0,-1,1,0,-1,1,-1
KR_6713877437,420,5,80,24,12,3,1,4,-3,4,1,2,3,5,8,1,9,2,0,2,0,4,2,3,-6,3,1,0,2,-1,1,1,1,1,-1
KR_6656658331,420,-2,-106,-4,2,0,3,3,0,1,1,2,2,4,-1,2,1,1,0,1,0,2,4,-1,-7,8,-7,0,-2,1,-1,-1,-1,5,-1
KR_6764265046,420,-3,-62,-12,-5,2,1,3,1,0,1,-4,4,0,-1,2,1,-3,4,1,0,-15,-1,3,-5,2,-3,0,-1,-1,0,-1,1,4,-1
KR_6687127950,420,-2,-31,-26,-6,0,0,0,-3,4,1,-1,2,1,-2,2,0,0,1,1,-2,-11,4,-1,-4,5,-5,0,0,-1,-1,0,-1,4,-1
KR_6730907836,420,-4,26,-41,-10,-1,4,3,-4,5,1,-3,4,1,-4,4,0,2,0,2,0,-11,27,1,-4,3,2,0,0,-1,1,1,1,4,-1
KR_6742209229,420,-4,-64,-12,-9,-2,3,1,0,0,0,-2,3,1,-4,6,2,-1,1,0,0,-3,14,2,-4,2,-3,0,0,-1,-1,0,-1,2,-1
KR_6764650535,420,0,-39,16,1,-2,3,1,4,1,5,-8,8,0,6,1,7,1,0,1,-1,1,2,-4,-3,7,1,0,1,-1,0,1,-1,4,-1
KR_6741056157,440,-3,-69,-1,-6,-2,3,1,-3,3,0,3,2,5,-3,3,0,-1,1,0,0,-18,432,-3,-2,5,-6,0,-2,-1,-1,-1,-1,6,-1
KR_6620382435,420,-2,-86,-1,-8,-1,2,1,-4,7,3,-2,4,2,0,2,2,-1,3,2,0,-3,2,1,-3,2,-1,0,-1,-1,-1,-1,-1,5,-1
KR_6717851958,420,3,-26,4,15,4,1,5,1,0,1,4,1,5,0,4,4,6,0,6,0,16,0,3,-7,4,-1,0,-1,1,1,-1,-1,2,-1
KR_6720578476,420,-5,-123,15,-10,0,1,1,-1,2,1,2,1,3,-10,11,1,-1,3,2,0,-11,6,-5,0,5,0,0,-1,-1,1,-1,-1,4,-1
KR_6713395585,420,-5,-38,-36,-12,-1,1,0,-6,8,2,1,1,2,-5,7,2,-1,1,0,-1,-13,-12,-3,0,3,-2,0,0,-1,-1,-1,-1,4,-1
KR_6759308824,420,0,-10,-13,5,4,0,4,-1,4,3,-4,4,0,5,1,6,1,0,1,0,8,8,3,-7,4,-4,0,-2,-1,-1,-1,1,5,-1
KR_6713796628,420,-1,-25,-7,-1,-1,2,1,-4,7,3,0,2,2,2,1,3,2,1,3,-1,0,46,-1,-3,4,-14,0,0,-1,1,1,-1,3,-1
KR_6671686136,420,-2,-21,-11,-8,-2,2,0,-5,7,2,-1,3,2,1,1,2,-1,2,1,1,-8,8,-1,-3,4,-3,0,-1,-1,1,1,1,5,-1
KR_6764302304,420,-1,-81,4,-2,1,3,4,-2,4,2,-1,4,3,1,7,8,-1,3,2,0,-1,40,1,-7,6,-16,0,1,1,1,1,1,2,-1
KR_6733653684,420,0,-18,-11,-2,-2,3,1,1,2,3,-2,4,2,-1,3,2,2,0,2,0,1,-10,2,-8,6,-1,0,-1,-1,-1,-1,1,5,-1
KR_6752507377,420,0,-34,-3,-3,1,0,1,0,1,1,2,0,2,-5,6,1,-1,1,0,0,-7,0,0,-5,5,3,0,0,0,-1,-1,-1,0,-1
KR_6681863582,420,-2,-42,-26,-3,-1,1,0,-4,5,1,2,1,3,-2,3,1,2,0,2,0,9,2,4,-8,4,2,0,0,1,-1,0,-1,2,-1
KR_6751775593,420,-3,1,-39,-14,2,2,4,-5,6,1,-9,9,0,-2,8,6,0,0,0,0,-16,-37,-6,-2,8,0,0,-1,-1,-1,-1,-1,3,-1
KR_6752193058,420,0,-6,-4,7,2,4,6,0,4,4,4,1,5,0,4,4,1,3,4,-1,6,19,8,-10,2,-3,0,0,1,0,1,-1,1,-1
KR_6726957104,420,-5,9,-10,-14,-2,2,0,-4,7,3,1,3,4,-6,7,1,-3,4,1,0,-22,-142,-4,-2,6,15,0,-2,-1,-1,-1,-1,1,-1
KR_6656956678,420,-4,-81,-20,-8,1,1,2,0,3,3,-6,7,1,0,1,1,-3,3,0,0,-5,4,3,-4,1,-1,0,-1,-1,-1,-1,-1,4,-1
KR_6763698110,420,1,13,0,2,3,1,4,2,2,4,2,0,2,-3,4,1,-2,3,1,-1,-9,1,2,-5,3,-5,0,1,-1,1,1,-1,3,-1
KR_6760313919,420,-1,-20,28,-7,-3,4,1,1,2,3,-2,3,1,-5,5,0,2,0,2,0,-4,111,-2,-4,6,2,0,-1,1,-1,-1,1,1,-1
KR_6610662943,420,-4,-11,-12,-15,-3,4,1,-6,8,2,0,2,2,-3,4,1,-3,3,0,-1,-16,-35,-2,-3,5,-1,0,-1,-1,-1,-1,-1,2,-1
KR_6761667613,440,-4,-63,-3,-16,-2,3,1,0,0,0,-6,6,0,-3,6,3,-5,5,0,0,-12,2,-1,-3,4,-3,0,-2,0,-1,-1,-1,0,-1
KR_6731574921,420,-2,-19,-4,-2,-2,2,0,2,1,3,4,1,5,-4,4,0,-2,2,0,0,-1,-6,0,-3,3,-2,0,-2,-1,-1,-1,1,5,-1
KR_6269634899,420,2,19,-4,8,1,1,2,1,1,2,3,0,3,3,0,3,0,0,0,0,7,-12,1,-3,2,-1,0,1,1,1,1,1,6,-1
KR_6745665875,420,-2,-33,22,2,0,2,2,7,3,10,1,1,2,-7,9,2,1,1,2,0,11,2,1,-5,4,11,0,1,1,-1,1,1,4,-1
KR_6754285751,420,-2,-26,-14,-15,0,3,3,-1,1,0,-7,9,2,-6,7,1,-1,3,2,1,-12,-13,-6,-6,12,5,0,-2,0,-1,-1,1,0,-1
KR_6753803766,420,3,24,17,14,2,2,4,0,1,1,3,1,4,9,0,9,0,1,1,0,15,8,2,-3,1,2,0,0,1,1,1,1,4,-1
KR_6671875424,420,-2,-36,-40,-9,-1,3,2,-2,3,1,-4,6,2,-2,2,0,0,0,0,0,-7,-5,0,-2,2,-1,0,-2,-1,-1,-1,-1,5,-1
KR_6763494601,420,-1,7,-59,0,-3,4,1,-1,1,0,2,0,2,4,2,6,-2,3,1,1,12,0,3,-8,5,0,0,1,1,-1,1,1,2,-1
KR_6649932888,420,-8,-142,-44,-23,-3,4,1,-1,1,0,-4,6,2,-10,12,2,-5,5,0,-3,-21,102,-1,-2,3,-3,0,-3,-1,-1,-1,-1,2,-1
KR_6747154128,420,0,46,-13,-5,6,1,7,0,2,2,-9,11,2,-3,3,0,1,0,1,1,-2,-1,3,-4,1,1,0,-2,-1,-1,-1,1,4,-1
KR_6762237504,420,1,13,-4,0,-1,1,0,-3,5,2,1,3,4,2,4,6,1,1,2,0,-3,-25,2,-6,4,-1,0,1,1,-1,1,1,1,-1
KR_6671934454,420,-3,-11,-1,-6,-4,5,1,-2,2,0,6,0,6,-3,5,2,-3,3,0,0,-7,-93,3,-4,1,-21,0,-1,0,1,-1,1,0,-1
KR_6649943009,420,-1,-10,8,-3,-1,2,1,3,4,7,1,1,2,-4,7,3,-2,2,0,0,-5,191,-4,-1,5,0,0,1,1,0,1,-1,1,-1
KR_6752262773,420,-2,-49,-8,-2,-2,2,0,-1,7,6,-1,4,3,2,2,4,0,1,1,0,-4,40,1,-5,4,2,0,-1,0,1,-1,1,0,-1
KR_6757297620,420,-6,-120,-19,-10,-4,5,1,-2,4,2,-2,4,2,0,2,2,-2,2,0,0,-11,153,-8,-3,11,-3,0,0,-1,-1,-1,-1,3,-1
KR_6572780375,420,2,-20,16,5,-1,3,2,3,2,5,4,0,4,-2,2,0,1,0,1,0,1,-1,-4,-5,9,2,0,1,1,1,1,1,4,-1
KR_6690249310,440,0,33,-32,5,1,1,2,10,0,10,2,5,7,-1,5,4,-7,8,1,-1,2,27,3,-4,1,-1,0,0,-1,-1,1,-1,4,-1
KR_6704093714,420,-1,-8,-3,-4,4,0,4,-3,5,2,-2,5,3,1,3,4,-4,5,1,1,-8,20,3,-7,4,-10,0,-1,-1,1,-1,1,3,-1
KR_6759979886,420,-1,49,-12,-5,-1,2,1,-1,2,1,0,4,4,-2,3,1,-1,1,0,1,-3,5,5,-8,3,-3,0,0,-1,-1,0,1,1,-1
KR_6522088874,440,7,113,8,14,3,0,3,6,2,8,0,3,3,5,2,7,0,1,1,0,12,1,0,-5,5,-1,0,1,-1,1,1,1,6,-1
KR_6738411718,420,1,47,35,4,-3,6,3,5,0,5,0,0,0,3,2,5,-1,2,1,0,13,-7,0,-5,5,-2,0,-1,1,-1,-1,1,3,-1
KR_6752248873,420,-5,-72,-28,-10,-2,2,0,0,1,1,1,3,4,-8,8,0,-1,1,0,0,-10,3,0,-3,3,-3,0,-1,-1,-1,-1,-1,2,-1
KR_6390391298,420,-6,-138,-19,-10,-1,1,0,3,2,5,-1,2,1,-8,8,0,-3,3,0,0,-8,82,-3,-4,7,-3,0,-1,-1,-1,-1,-1,3,-1
KR_6722952543,420,1,-85,-19,7,0,0,0,1,2,3,6,3,9,0,4,4,0,0,0,0,8,-104,-4,-4,8,-1,0,-1,-1,-1,-1,1,1,-1
KR_6757588762,420,-1,44,11,-2,-9,9,0,6,1,7,0,2,2,3,3,6,-2,2,0,0,0,21,-2,-1,3,0,0,0,-1,0,0,-1,1,-1
KR_6630590310,420,2,53,4,2,4,0,4,-2,2,0,-2,3,1,2,0,2,0,1,1,0,0,13,-1,-3,4,-1,0,0,-1,1,0,1,6,-1
KR_6707942109,420,-1,46,-24,-1,3,0,3,-2,3,1,2,1,3,-3,7,4,-1,1,0,1,-10,3,-2,-2,4,0,0,0,-1,-1,1,1,4,-1
KR_6752185467,440,-3,-90,-8,-6,-7,7,0,-5,7,2,4,2,6,2,3,5,0,5,5,0,-2,-301,0,-2,2,-2,0,-3,1,-1,-1,1,3,-1
KR_6675775233,420,1,33,-8,2,0,1,1,-2,2,0,-1,1,0,2,0,2,3,0,3,0,5,35,1,-6,5,-39,0,0,1,-1,0,1,1,-1
KR_6753253747,420,0,22,-20,3,-1,3,2,2,0,2,0,2,2,2,0,2,0,1,1,0,3,4,0,-3,3,-3,0,0,-1,1,0,1,5,-1
KR_6758997348,420,-6,-39,-7,-13,0,2,2,-3,5,2,-5,6,1,-5,5,0,0,1,1,0,-9,7,-2,-2,4,-2,0,-1,-1,-1,-1,-1,2,-1
KR_6762894374,420,-2,-29,-7,-4,-1,3,2,4,0,4,-2,2,0,-3,5,2,-2,2,0,0,-2,42,-4,-1,5,-24,0,-1,-1,-1,-1,-1,4,-1
KR_6615565560,420,-7,-120,-4,-14,1,5,6,1,0,1,0,2,2,-16,17,1,0,0,0,-3,-12,-1,-8,-2,10,-2,0,-3,-1,-1,-1,-1,4,-1
KR_6614219120,440,0,-36,9,-6,-3,4,1,-3,4,1,-2,2,0,2,1,3,0,0,0,0,-4,-2,5,-7,2,0,0,1,-1,-1,-1,-1,6,-1
KR_6642130234,420,2,-5,-11,-2,2,1,3,-2,3,1,1,2,3,-3,5,2,0,1,1,-2,-9,-6,-2,-1,3,-2,0,-1,1,0,-1,-1,5,-1
KR_6717525078,420,0,-16,-8,-1,-1,4,3,-1,2,1,0,3,3,1,0,1,0,0,0,0,-10,-8,0,-6,6,-1,0,0,-1,1,0,-1,1,-1
KR_6588314371,420,2,55,16,-2,3,0,3,0,1,1,-7,8,1,2,0,2,0,0,0,0,0,-197,-1,-2,3,-2,0,1,1,-1,1,-1,3,-1
KR_6764003622,420,-1,41,-3,-5,-2,5,3,-5,6,1,-3,4,1,5,0,5,0,0,0,-2,-4,-13,0,-2,2,-2,0,-1,-1,-1,-1,-1,4,-1
KR_6675617323,420,-2,17,-51,-1,-7,7,0,0,4,4,5,1,6,0,3,3,1,2,3,-1,4,1,2,-5,3,5,0,0,-1,-1,-1,-1,4,-1
KR_6761094263,420,-1,-87,20,-3,3,0,3,-1,2,1,-3,3,0,-2,2,0,0,3,3,0,-6,-6,1,-4,3,-1,0,0,1,1,0,-1,3,-1
KR_6390786449,420,-1,-68,-20,-5,-5,5,0,2,1,3,-1,2,1,0,1,1,-1,3,2,-1,-8,48,-3,-4,7,-24,0,0,-1,-1,0,-1,6,-1
KR_6747274522,420,-1,-19,4,0,1,5,6,-4,5,1,1,2,3,2,1,3,0,1,1,-2,-3,0,3,-6,3,4,0,-1,-1,1,-1,-1,4,-1
KR_6620223323,420,-3,-79,-4,-3,-4,7,3,0,2,2,2,3,5,-2,5,3,1,0,1,0,4,-8,-1,-2,3,0,0,-3,-1,1,-1,1,3,-1
KR_6751610562,420,-4,22,-55,-7,-1,2,1,0,1,1,0,3,3,-6,8,2,0,2,2,1,-8,285,1,-4,3,0,0,-1,1,-1,-1,1,6,-1
KR_6738919282,420,0,6,12,2,3,1,4,2,1,3,0,1,1,1,2,3,-4,5,1,0,1,2,2,-3,1,-4,0,1,-1,0,1,-1,3,-1
KR_6759645084,440,2,-6,5,-4,-4,6,2,-5,6,1,1,5,6,5,1,6,-1,1,0,1,-2,2,1,-2,1,1,0,0,0,0,0,1,0,-1
KR_6604141767,440,-1,-28,12,-12,1,0,1,-3,4,1,0,1,1,2,1,3,-12,15,3,-1,-11,30,-4,-4,8,-11,0,1,0,1,1,-1,0,-1
KR_6730230779,420,0,-68,2,-3,1,2,3,-4,4,0,-2,3,1,4,3,7,-2,5,3,0,0,9,-1,-6,7,-3,0,1,0,0,1,-1,0,-1
KR_6764455064,420,-1,-38,20,-4,-3,4,1,-2,4,2,1,2,3,0,2,2,0,1,1,0,4,145,-2,-3,5,-2,0,-1,-1,1,-1,-1,4,-1
KR_6651558555,420,-3,-10,-24,-7,0,2,2,-3,5,2,2,2,4,-3,5,2,-3,4,1,1,-3,-33,2,-4,2,2,0,-2,1,-1,-1,1,2,-1
KR_6763288806,420,-2,-3,0,-6,-3,5,2,1,1,2,-4,4,0,1,1,2,-1,1,0,0,-6,-2,0,-4,4,-2,0,-1,1,-1,-1,-1,1,-1
KR_6737470189,420,0,-3,-20,-8,0,0,0,-2,5,3,-1,4,3,-4,5,1,-1,1,0,-1,-13,-11,-1,-7,8,0,0,0,1,1,1,-1,5,-1
KR_6751353653,420,-3,-4,-26,-4,-1,2,1,-5,6,1,2,2,4,0,1,1,0,0,0,-1,-10,2,3,-7,4,-4,0,-1,-1,-1,-1,-1,2,-1
KR_6751209580,420,-3,-12,-32,-7,-3,6,3,1,3,4,-6,9,3,3,5,8,-2,3,1,0,1,15,3,-6,3,-3,0,-1,1,-1,-1,-1,4,-1
KR_6725179579,420,-3,-95,8,-1,-4,5,1,0,1,1,-3,5,2,2,0,2,4,0,4,0,8,11,-3,-1,4,-1,0,-4,1,-1,-1,-1,2,-1
KR_6762457498,420,-4,5,-20,-16,2,0,2,-9,10,1,0,4,4,-7,8,1,-2,3,1,0,-14,-3,-2,-1,3,-1,0,-1,-1,-1,-1,1,6,-1
KR_6754048443,420,0,-19,1,-6,1,4,5,-1,3,2,-2,2,0,-1,4,3,-3,3,0,0,-9,4,-3,-3,6,-5,0,0,1,-1,0,-1,1,-1
KR_6714095187,420,-1,-51,-17,-2,-2,3,1,7,0,7,1,3,4,-7,7,0,-1,4,3,0,-1,-47,0,-4,4,27,0,0,1,-1,0,-1,1,-1
KR_6736749913,440,-6,-29,-24,-13,-2,2,0,-4,6,2,0,1,1,-7,7,0,0,3,3,0,-11,3,-2,-3,5,-1,0,0,-1,1,0,-1,2,-1
KR_6743753650,420,2,6,4,-1,2,1,3,0,7,7,-2,2,0,-1,3,2,0,1,1,0,-7,3,3,-3,0,0,0,0,1,-1,0,-1,3,-1
KR_6763048934,440,-2,-40,-23,-5,-3,3,0,-1,2,1,-4,5,1,-1,3,2,4,0,4,0,3,15,-3,-2,5,3,0,-1,-1,-1,-1,-1,4,-1
KR_6639199022,420,-1,40,0,-2,5,0,5,-5,7,2,-3,3,0,0,1,1,1,0,1,-1,-4,-127,1,-2,1,3,0,-1,-1,1,-1,-1,4,-1
KR_6273836155,420,-6,-73,-20,-11,-6,7,1,0,3,3,0,1,1,-3,3,0,-2,3,1,0,-4,-11,4,-8,4,-6,0,-2,-1,0,-1,-1,1,-1
KR_6732484599,420,1,47,-16,-2,2,1,3,-1,2,1,-1,4,3,-1,1,0,-1,3,2,0,-13,-12,1,-4,3,2,0,2,-1,1,1,1,1,-1
KR_6690924579,420,-3,-16,-10,2,2,3,5,3,1,4,-2,4,2,0,1,1,-1,1,0,0,-1,8,-3,-2,5,-2,0,0,-1,0,0,1,2,-1
KR_6730034027,420,-2,-67,8,-2,-4,4,0,3,0,3,-3,4,1,-1,2,1,3,1,4,0,4,-381,-1,-3,4,0,0,0,-1,0,-1,1,5,-1
KR_6588343105,420,3,-59,21,6,1,1,2,0,3,3,2,4,6,1,3,4,2,0,2,0,6,25,-3,-2,5,-3,0,0,1,0,1,1,1,-1
KR_6763517318,420,-3,-62,-30,-4,1,1,2,-3,3,0,1,3,4,-2,2,0,-1,1,0,0,-9,-9,-2,-5,7,-3,0,-1,-1,-1,-1,-1,4,-1
KR_6756445231,440,0,31,15,-3,3,0,3,2,2,4,-3,3,0,-3,4,1,-2,4,2,1,-5,24,1,-4,3,-15,0,-1,-1,1,-1,1,2,-1
KR_6629195952,420,-1,-72,-20,1,-3,3,0,-2,2,0,3,1,4,0,1,1,3,0,3,0,5,5,-6,0,6,-2,0,-1,0,-1,-1,-1,0,-1
KR_6741546966,420,-2,-31,-1,-11,-8,8,0,-1,6,5,-2,2,0,2,3,5,-2,3,1,-1,-12,-10,-7,-3,10,5,0,-1,-1,-1,-1,-1,2,-1
KR_6762536986,440,-5,0,18,-13,-1,1,0,-8,8,0,2,2,4,-2,6,4,-4,4,0,0,-22,-10,-3,-2,5,0,0,-3,-1,1,-1,-1,5,-1
KR_6694832090,440,-6,-112,-16,-13,-2,5,3,-4,4,0,-3,4,1,-5,10,5,1,1,2,2,-6,-1,-2,-1,3,4,0,-2,-1,1,-1,1,5,-1
KR_6752705788,420,2,73,-12,11,2,1,3,1,0,1,0,0,0,7,0,7,1,2,3,1,15,-10,0,-3,3,0,0,0,1,1,0,1,4,-1
KR_6755570821,440,0,-35,2,-1,-4,5,1,-1,5,4,2,2,4,-3,4,1,5,0,5,0,3,18,0,0,0,0,0,0,1,-1,-1,1,2,-1
KR_6614440268,420,-1,-6,7,-5,-1,1,0,-2,3,1,-1,3,2,-1,1,0,0,1,1,0,-11,-44,0,-4,4,6,0,0,-1,0,0,-1,4,-1
KR_6734497181,420,0,2,-24,1,0,1,1,-2,3,1,-2,3,1,5,2,7,0,1,1,-1,-4,0,-2,-3,5,2,0,0,-1,1,-1,-1,4,-1
KR_6632746769,420,-3,9,-12,-4,2,0,2,4,0,4,-4,4,0,-7,8,1,1,0,1,0,-2,-7,-1,-3,4,-1,0,-1,-1,1,-1,-1,4,-1
KR_6713846845,420,-8,-30,-32,-20,-4,4,0,-11,12,1,0,1,1,-3,3,0,-2,2,0,0,-14,37,-5,-2,7,-21,0,-1,-1,1,-1,-1,5,-1
KR_6762077627,420,3,-6,12,7,3,0,3,-2,3,1,-1,2,1,5,2,7,2,1,3,1,6,1,8,-10,2,-2,0,1,1,1,1,1,6,-1
KR_6719960645,420,2,-41,-12,2,2,1,3,2,0,2,-5,7,2,3,0,3,0,0,0,2,-1,-9,-6,-2,8,1,0,0,-1,1,0,1,4,-1
KR_6687962220,440,-5,-78,-36,-6,-3,4,1,-4,6,2,-4,4,0,5,0,5,0,1,1,0,-2,-30,1,-2,1,11,0,-1,0,-1,-1,-1,0,-1
KR_6684568441,420,-3,53,1,-4,7,0,7,-2,6,4,-2,3,1,-4,5,1,-3,5,2,0,-5,-18,0,-5,5,5,0,-1,-1,1,1,1,1,-1
KR_6748437587,420,-1,9,-20,2,-2,3,1,9,3,12,-2,2,0,-1,1,0,-2,2,0,0,-1,0,1,-3,2,1,0,1,-1,1,1,1,6,-1
KR_6756246855,420,-1,-37,-10,-6,-1,3,2,-5,6,1,0,1,1,-1,3,2,1,0,1,0,-5,6,-5,-2,7,-5,0,-1,-1,-1,-1,-1,4,-1
KR_6754528164,420,-3,5,-1,-9,1,1,2,-2,6,4,-2,4,2,-5,6,1,-1,2,1,0,-7,-4,3,-5,2,-7,0,0,-1,0,-1,-1,3,-1
KR_6675606978,420,-1,-32,3,-1,4,2,6,-6,6,0,1,3,4,0,1,1,0,0,0,0,3,173,4,-6,2,-4,0,-3,-1,-1,-1,1,6,-1
KR_6644706851,420,3,15,28,2,4,1,5,-4,5,1,0,1,1,2,2,4,0,0,0,0,1,-5,4,-7,3,0,0,0,1,0,0,1,3,-1
KR_6618768277,420,-3,-63,-50,-1,-1,3,2,1,4,5,-6,8,2,0,2,2,5,2,7,0,2,-3,1,-4,3,1,0,-1,1,-1,-1,1,2,-1
KR_6652657178,420,-1,-9,15,-2,-4,7,3,-3,4,1,6,1,7,0,0,0,-1,1,0,0,-3,-5,-1,-4,5,-2,0,-1,-1,-1,-1,-1,1,-1
KR_6672160853,420,3,36,24,1,-3,4,1,0,1,1,3,1,4,1,3,4,0,0,0,0,-4,1,4,-7,3,0,0,1,1,-1,-1,-1,3,-1
KR_6679672254,420,-2,-91,-18,-5,-2,2,0,2,2,4,-3,7,4,0,2,2,-2,3,1,0,-8,-3,1,-4,3,-3,0,-1,-1,0,-1,-1,2,-1
KR_6760314965,420,0,-24,34,-10,-1,2,1,-1,1,0,-6,6,0,-3,4,1,1,0,1,0,-13,15,-7,0,7,0,0,-1,1,-1,-1,1,6,-1
KR_6757641928,420,1,18,20,-4,-2,2,0,2,2,4,2,5,7,-4,5,1,-2,5,3,-1,-14,0,1,-3,2,2,0,1,1,1,1,-1,1,-1
KR_6760711374,440,-2,-107,-4,-3,1,2,3,-5,5,0,-1,3,2,-1,6,5,3,1,4,1,-1,-15,-3,-3,6,-1,0,-2,-1,-1,-1,1,3,-1
KR_6749464963,440,-5,-95,-22,-4,-7,9,2,-2,2,0,-1,3,2,6,0,6,0,0,0,0,6,5,0,-3,3,-1,0,0,0,0,-1,-1,0,-1
KR_6668623624,420,-7,3,-8,-11,-4,4,0,-1,2,1,-1,4,3,-2,5,3,-3,3,0,-1,-7,-40,0,-4,4,-1,0,0,1,1,0,-1,5,-1
KR_6753807604,420,-5,-78,-40,-5,-1,1,0,-2,3,1,-2,6,4,0,2,2,0,1,1,0,1,-226,0,-3,3,-38,0,-1,-1,1,-1,1,4,-1
KR_6727750878,420,-1,-30,-79,-3,-1,2,1,-3,3,0,-3,4,1,4,1,5,0,0,0,-1,2,-3,3,-4,1,-1,0,0,0,0,-1,-1,0,-1
KR_6673515767,420,-11,-71,-68,-20,-5,6,1,-5,6,1,-2,4,2,-4,5,1,-4,5,1,0,-14,-4,0,-2,2,-2,0,-2,-1,-1,-1,-1,5,-1
KR_6751126200,440,3,71,-15,4,3,1,4,-2,4,2,-4,5,1,7,1,8,0,0,0,0,-2,176,-4,-2,6,17,0,1,1,1,1,1,2,-1
KR_6764413661,420,-1,-58,15,-2,1,3,4,-2,4,2,1,2,3,-2,6,4,0,0,0,0,-2,-3,-3,-2,5,2,0,-1,-1,1,1,1,3,-1
KR_6682852242,420,0,6,-32,1,0,2,2,2,0,2,-3,6,3,1,3,4,1,1,2,0,8,5,1,-7,6,6,0,-1,-1,-1,-1,-1,5,-1
KR_6759497310,420,-2,-31,8,-5,-3,4,1,-1,2,1,2,2,4,-4,6,2,1,1,2,0,-2,35,-4,-5,9,-17,0,0,-1,-1,-1,1,1,-1
KR_6695690279,440,0,12,1,-2,0,3,3,0,2,2,-2,6,4,-1,3,2,1,1,2,0,0,-12,-2,-1,3,1,0,0,-1,-1,0,1,2,-1
KR_6759928996,420,4,-10,-4,9,8,1,9,3,2,5,2,3,5,-6,6,0,2,0,2,0,10,-5,1,-3,2,-1,0,1,1,1,1,-1,2,-1
KR_6764299560,420,-3,-57,15,-12,3,2,5,-5,6,1,-4,7,3,-6,6,0,0,0,0,0,-16,24,2,-6,4,-2,0,-1,-1,-1,-1,1,1,-1
KR_6590912101,420,1,-10,-18,4,3,0,3,2,0,2,1,0,1,0,4,4,-2,2,0,0,5,-8,-3,-1,4,2,0,0,-1,-1,0,1,2,-1
KR_6442366873,420,-2,-27,-8,-7,-2,2,0,-3,3,0,0,3,3,-2,3,1,0,0,0,0,-10,-21,-3,-2,5,1,0,-1,1,-1,-1,-1,2,-1
KR_6761511017,420,-2,-9,24,-4,-2,3,1,-3,3,0,-4,4,0,1,1,2,4,1,5,0,-5,6,4,-6,2,1,0,0,1,-1,-1,1,3,-1
KR_6738742310,420,-2,-117,0,-6,0,1,1,-4,5,1,-3,5,2,0,2,2,1,0,1,0,-6,-2,-1,-2,3,-2,0,0,-1,1,-1,-1,3,-1
KR_6475934268,420,1,-20,0,6,-1,2,1,3,2,5,1,4,5,2,4,6,1,0,1,0,11,24,-1,-7,8,0,0,0,1,1,1,1,4,-1
KR_6735645453,420,-4,-65,-25,-9,-1,4,3,-3,5,2,0,5,5,-4,8,4,-1,1,0,-2,-11,18,-2,-1,3,-4,0,0,0,-1,0,1,0,-1
KR_6668548734,420,-3,-84,-19,-8,-2,2,0,2,2,4,-1,1,0,-3,4,1,-4,4,0,-1,-6,-106,-2,-2,4,-4,0,-1,-1,-1,-1,-1,6,-1
KR_6740111232,440,-2,-37,-8,-4,2,1,3,-3,4,1,-3,4,1,3,1,4,-3,4,1,0,1,-6,-1,-4,5,-4,0,-1,-1,-1,-1,-1,1,-1
KR_6751239790,420,0,-35,-33,1,2,3,5,2,1,3,3,2,5,-5,8,3,-1,2,1,1,5,-7,1,-3,2,-1,0,-1,-1,-1,-1,1,2,-1
KR_6728909929,440,-6,-101,-50,-11,2,1,3,-2,3,1,0,4,4,-6,7,1,-5,5,0,1,-18,12,2,-4,2,-1,0,-1,-1,0,-1,1,4,-1
KR_6759799670,440,2,52,16,11,2,3,5,6,1,7,0,4,4,4,1,5,-1,6,5,1,11,15,-3,-3,6,0,0,0,0,-1,1,1,0,-1
KR_6704296407,420,-3,-20,-18,-10,-2,2,0,-1,2,1,-4,6,2,0,1,1,-3,3,0,0,-7,-3,-3,0,3,-3,0,-1,-1,-1,-1,-1,2,-1
KR_6685905203,420,4,84,-21,12,2,0,2,1,0,1,3,1,4,6,1,7,0,0,0,0,18,-50,-2,-4,6,35,0,2,-1,0,1,-1,4,-1
KR_6746517587,420,-5,-51,-20,-16,2,0,2,-1,2,1,-5,8,3,-8,8,0,-4,4,0,0,-12,10,-3,-2,5,-6,0,-4,-1,-1,-1,-1,4,-1
KR_6707976280,420,1,8,-13,8,1,1,2,1,3,4,2,1,3,3,3,6,1,1,2,1,11,-1,-2,-2,4,0,0,-1,-1,-1,-1,1,1,-1
KR_6719980660,420,-2,-67,-8,-1,-3,5,2,1,3,4,0,2,2,1,2,3,0,2,2,0,4,-13,0,-4,4,-3,0,-1,-1,-1,-1,-1,5,-1
KR_6693378966,420,-3,-36,-6,-7,-4,4,0,2,1,3,-1,1,0,-3,3,0,-1,1,0,0,-15,-9,-2,-3,5,4,0,-1,-1,-1,-1,-1,1,-1
KR_6622022278,420,-2,-21,36,-6,1,0,1,0,3,3,0,1,1,-8,12,4,1,1,2,0,-13,-4,-1,-1,2,-1,0,0,1,1,-1,1,5,-1
KR_6743569554,420,-1,-3,9,-6,-6,6,0,0,1,1,1,1,2,0,3,3,-1,1,0,0,-1,-2,-3,-4,7,4,0,-1,1,0,-1,-1,6,-1
KR_6761133114,420,-2,28,-4,-5,3,2,5,3,0,3,-2,2,0,-8,9,1,-1,1,0,0,-4,36,1,-3,2,-2,0,0,0,-1,1,-1,0,-1
KR_6488699840,420,-2,19,-16,-8,-1,1,0,-2,4,2,-3,7,4,-1,6,5,-1,2,1,0,-3,202,3,-4,1,-1,0,1,-1,1,1,-1,1,-1
KR_6690920509,420,5,35,1,8,4,1,5,-4,5,1,2,2,4,6,1,7,0,0,0,0,3,0,2,-6,4,3,0,-1,1,1,-1,1,1,-1
KR_6676937016,420,-4,-27,-15,-9,-4,5,1,-3,4,1,-7,8,1,3,0,3,2,3,5,0,2,-20,0,-3,3,-1,0,0,-1,-1,-1,-1,2,-1
KR_6762179677,420,0,32,4,-1,0,3,3,1,3,4,0,3,3,1,2,3,-3,3,0,0,-2,20,0,-4,4,3,0,1,-1,-1,1,-1,3,-1
KR_6734583533,420,2,-14,3,11,6,0,6,-2,4,2,7,0,7,0,0,0,0,0,0,0,7,117,0,-2,2,0,0,-1,1,-1,-1,1,6,-1
KR_6759776155,440,-3,-57,8,-9,-3,5,2,-4,6,2,-2,2,0,0,3,3,0,1,1,0,-5,-2,2,-7,5,0,0,-1,-1,1,-1,-1,6,-1
KR_6751247009,440,2,10,-8,-1,-2,5,3,0,3,3,5,2,7,-7,7,0,3,0,3,-1,-4,319,-1,-2,3,-3,0,-2,1,1,-1,-1,6,-1
KR_6753428358,420,-1,-85,24,-8,-1,3,2,-7,7,0,0,4,4,-2,2,0,2,2,4,0,-10,-2,-1,-5,6,-7,0,-1,1,1,-1,-1,5,-1
KR_6612916101,420,2,66,-26,3,3,1,4,1,0,1,1,1,2,-1,4,3,-1,1,0,-1,-5,-14,2,-4,2,4,0,1,-1,1,1,-1,3,-1
KR_6743902583,420,-4,-116,10,-9,-3,4,1,-5,6,1,2,2,4,-4,7,3,1,0,1,-2,-6,34,-1,-2,3,2,0,-2,-1,-1,-1,1,3,-1
KR_6693728525,420,0,-39,20,-1,5,0,5,-2,3,1,-3,4,1,0,2,2,-1,1,0,0,-2,-46,4,-6,2,3,0,-1,1,1,-1,1,3,-1
KR_6741227597,420,-3,-33,-24,-6,2,2,4,-2,3,1,-5,5,0,2,1,3,-3,3,0,0,-6,9,-4,-3,7,1,0,-1,-1,-1,-1,-1,2,-1
KR_6622073091,420,5,76,15,11,3,1,4,4,0,4,0,3,3,4,1,5,0,1,1,0,14,6,4,-7,3,-4,0,1,1,-1,1,1,5,-1
KR_6762733910,420,-2,-16,-13,0,0,1,1,2,2,4,-1,3,2,1,0,1,-2,3,1,1,-4,-237,1,-4,3,-1,0,0,1,-1,-1,1,1,-1
KR_6753574922,420,-2,33,-28,-6,-1,3,2,-8,9,1,3,1,4,0,1,1,0,1,1,0,-8,-4,-1,-6,7,1,0,-1,1,-1,-1,1,3,-1
KR_6762147122,420,-3,-83,-32,-9,-9,9,0,0,0,0,2,3,5,-1,1,0,-1,1,0,0,-3,-1,4,-4,0,-2,0,-3,-1,-1,-1,1,3,-1
KR_6610053130,420,-5,-38,-49,-10,0,2,2,-2,2,0,-6,7,1,-1,4,3,-1,1,0,0,-6,9,-2,-7,9,-3,0,0,-1,-1,0,1,6,-1
KR_6730716266,420,1,8,11,-2,-1,1,0,-2,3,1,1,1,2,-2,2,0,2,0,2,-1,0,-4,4,-9,5,4,0,0,-1,-1,0,-1,5,-1
KR_6606172249,420,1,36,3,-3,1,1,2,-2,2,0,0,3,3,-2,2,0,0,3,3,-1,-10,4,-1,-2,3,6,0,0,-1,0,-1,-1,4,-1
KR_6764393948,420,2,54,-24,-3,1,2,3,-2,5,3,-3,6,3,2,1,3,-1,1,0,0,-6,-21,0,-2,2,-1,0,-2,-1,-1,-1,1,1,-1
KR_6761951157,420,0,17,12,-1,-2,3,1,2,1,3,0,0,0,-1,5,4,0,0,0,0,2,16,-4,-2,6,0,0,-1,-1,1,-1,-1,6,-1
KR_6732449341,440,-4,-15,-35,-12,-4,5,1,-2,2,0,0,1,1,-5,6,1,-1,1,0,0,-12,-1,4,-9,5,-7,0,0,0,-1,-1,-1,0,-1
KR_6761828303,440,-1,-8,0,-4,-1,3,2,0,3,3,0,3,3,-3,3,0,0,0,0,0,-9,6,1,-3,2,2,0,0,0,1,0,1,0,-1
KR_6764148315,420,-3,-14,0,-2,-3,4,1,3,0,3,-3,4,1,2,2,4,-1,1,0,0,-2,-1,0,-1,1,1,0,0,1,0,0,-1,5,-1
KR_6684570797,420,-4,-29,-12,-2,0,0,0,1,2,3,-1,3,2,-1,3,2,-1,1,0,0,0,8,1,-4,3,-4,0,1,0,-1,1,1,0,-1
KR_6764735268,420,-5,-164,-16,-16,-4,5,1,-9,9,0,-5,7,2,0,3,3,2,0,2,0,-10,2,5,-8,3,1,0,-3,-1,-1,-1,-1,1,-1
KR_6662114562,420,-3,-42,-2,-8,1,1,2,0,5,5,-1,2,1,-5,6,1,-3,3,0,-1,-2,68,-1,-2,3,1,0,-2,1,-1,-1,-1,6,-1
KR_6658750657,420,-2,-32,-38,-2,-4,6,2,-3,6,3,1,3,4,5,1,6,-1,3,2,-3,-5,2,5,-7,2,-4,0,-1,1,1,-1,-1,4,-1
KR_6583725627,420,0,22,12,-4,-2,3,1,-2,3,1,-2,2,0,-1,3,2,3,2,5,-1,-3,2,-4,-3,7,2,0,0,0,-1,0,-1,0,-1
KR_6739864866,420,-2,-15,-4,-6,-7,7,0,-5,6,1,2,0,2,2,0,2,2,0,2,0,2,-4,-1,-3,4,2,0,0,0,-1,-1,-1,0,-1
KR_6693519971,420,-5,-26,4,-13,-5,11,6,-4,7,3,0,2,2,-6,7,1,2,0,2,0,-12,3,0,-8,8,-4,0,-1,-1,1,-1,1,3,-1
KR_6760526008,420,-2,21,-24,4,1,1,2,1,3,4,5,2,7,-1,2,1,-2,2,0,2,5,5,2,-6,4,-1,0,0,-1,1,0,1,6,-1
KR_6446527845,420,-2,-6,-12,-1,-1,2,1,3,1,4,-2,4,2,-1,1,0,0,1,1,0,0,-4,-1,-2,3,-4,0,0,-1,-1,-1,1,2,-1
KR_6748764886,420,-1,29,16,-4,-1,4,3,1,2,3,-2,3,1,-1,2,1,-1,1,0,0,-7,-9,3,-5,2,-1,0,-1,1,-1,-1,1,6,-1
KR_6751449015,420,-1,-57,-28,3,-3,3,0,2,1,3,3,1,4,3,1,4,-2,2,0,0,7,6,4,-5,1,1,0,0,-1,1,-1,1,3,-1
KR_6657098598,420,1,15,28,-2,2,2,4,2,4,6,-2,3,1,-4,7,3,0,0,0,-3,-5,-2,-5,-3,8,0,0,1,1,0,1,-1,1,-1
KR_6708407625,420,0,15,-15,-6,-5,6,1,3,0,3,1,3,4,-4,4,0,-1,3,2,0,-7,-186,-4,-3,7,0,0,1,-1,1,1,1,4,-1
KR_6599498836,420,1,12,20,11,1,3,4,6,1,7,0,6,6,3,0,3,1,0,1,2,11,10,4,-5,1,-3,0,0,0,0,0,1,0,-1
KR_6603876370,420,-4,-46,12,-3,-1,2,1,-1,3,2,-2,2,0,1,1,2,0,1,1,0,1,-14,2,-5,3,0,0,0,1,1,1,-1,6,-1
KR_6738433764,440,0,-11,18,-9,-3,4,1,0,0,0,-2,3,1,0,1,1,-4,7,3,0,-12,0,-2,-2,4,-3,0,1,-1,-1,-1,-1,3,-1
KR_6736587481,420,-4,-16,-24,-1,-1,4,3,-1,4,3,5,2,7,-5,6,1,1,0,1,0,0,31,5,-7,2,-21,0,1,1,1,1,-1,1,-1
KR_6763253274,440,-5,-10,-42,-13,2,1,3,-2,2,0,-10,10,0,-1,2,1,-2,2,0,-1,-9,-5,2,-2,0,0,0,0,-1,-1,0,-1,3,-1
KR_6394222556,420,-2,54,8,-5,-2,2,0,-2,4,2,3,5,8,-1,2,1,-3,4,1,0,-12,-5,-3,-5,8,-2,0,0,1,1,0,1,6,-1
KR_6572718002,420,-1,-20,-26,-1,-3,4,1,2,2,4,0,2,2,2,2,4,-2,2,0,0,3,32,1,-5,4,2,0,0,-1,-1,-1,1,6,-1
KR_6713394698,420,1,16,29,1,5,2,7,6,0,6,-6,7,1,-3,4,1,-1,2,1,-3,-17,7,3,-6,3,-1,0,-1,1,1,1,-1,4,-1
KR_6731791474,420,-1,-34,7,6,-1,3,2,3,3,6,-4,4,0,7,2,9,1,0,1,0,12,3,-2,-5,7,1,0,0,-1,0,0,1,4,-1
KR_6472184998,420,-3,-61,-6,-5,-4,5,1,-5,6,1,-2,3,1,3,1,4,3,1,4,0,0,7,0,-3,3,-1,0,-1,-1,1,-1,1,3,-1
KR_6754620720,420,-6,-51,-32,-6,0,0,0,1,4,5,-2,3,1,-4,5,1,-1,1,0,0,-5,137,4,-8,4,-10,0,-2,0,-1,-1,1,0,-1
KR_6728680628,420,-3,91,-41,-7,-9,9,0,-3,3,0,2,1,3,0,1,1,3,0,3,-1,-12,-17,0,-4,4,-3,0,0,-1,-1,1,-1,5,-1
KR_6758105374,420,-3,-8,-16,-4,1,2,3,2,5,7,-1,2,1,-6,6,0,0,2,2,0,-10,-6,-2,-2,4,0,0,0,-1,0,-1,-1,1,-1
KR_6653023662,420,-1,-59,16,-5,-1,3,2,3,1,4,-3,3,0,-1,2,1,-3,3,0,0,-1,14,2,-6,4,1,0,-1,-1,1,-1,-1,1,-1
KR_6761866781,420,-3,-6,-27,-8,1,0,1,-1,1,0,-1,1,0,-7,8,1,0,0,0,0,-8,-3,4,-8,4,-5,0,-1,1,-1,-1,-1,2,-1
KR_6748870773,440,2,20,24,3,3,1,4,4,1,5,3,1,4,-7,9,2,0,2,2,0,1,1,-1,-2,3,0,0,1,0,1,1,-1,0,-1
KR_6756201936,420,0,-55,-16,-8,-4,4,0,1,3,4,-1,2,1,-5,5,0,1,0,1,0,-6,-201,4,-6,2,-2,0,0,0,-1,0,-1,0,-1
KR_6750301035,420,-2,-33,0,-6,6,0,6,-2,4,2,-2,5,3,-8,9,1,0,1,1,1,-11,99,-2,-3,5,2,0,0,-1,1,0,1,1,-1
KR_6716297326,420,1,31,-36,-1,-1,2,1,-3,3,0,-1,3,2,3,0,3,1,1,2,1,2,5,-2,-2,4,1,0,1,-1,0,1,1,2,-1
KR_6752109032,440,-1,-22,23,-3,2,4,6,3,0,3,-3,3,0,-6,6,0,1,1,2,0,-3,10,2,-3,1,-2,0,2,0,1,1,1,0,-1
KR_6727084977,420,-7,-145,-57,-20,0,5,5,-3,4,1,-3,3,0,-8,8,0,-6,8,2,0,-7,2,-1,-1,2,0,0,-4,-1,-1,-1,-1,3,-1
KR_6753671865,420,-2,23,-8,-7,-2,3,1,-1,7,6,-1,4,3,-1,6,5,-2,3,1,2,-8,-32,-7,-2,9,7,0,-1,-1,-1,-1,1,3,-1
KR_6603591658,420,3,42,-27,9,-4,5,1,4,2,6,4,0,4,7,0,7,-2,2,0,0,17,7,4,-5,1,-1,0,2,-1,1,1,-1,4,-1
KR_6601724177,420,2,0,-8,0,2,0,2,-3,6,3,1,0,1,1,3,4,-1,1,0,0,-1,8,0,-6,6,2,0,0,1,0,0,-1,2,-1
KR_6763569579,420,0,-47,-4,3,2,0,2,-1,1,0,1,4,5,2,0,2,-1,1,0,0,6,17,3,-8,5,-6,0,0,0,1,0,-1,0,-1
KR_6757598106,420,-5,-93,-50,-11,-4,5,1,1,0,1,-3,7,4,-3,4,1,-2,2,0,0,3,-73,2,-7,5,18,0,-3,-1,-1,-1,1,2,-1
KR_6763921715,420,-1,-12,-40,-5,-1,3,2,1,1,2,-5,8,3,-3,5,2,3,1,4,0,-8,-10,5,-5,0,-3,0,-1,-1,-1,-1,1,4,-1
KR_6763657425,420,2,15,9,0,1,2,3,-3,6,3,2,0,2,1,1,2,-1,1,0,0,-1,-6,2,-6,4,1,0,0,-1,1,0,-1,1,-1
KR_6752442982,420,0,-12,24,-1,-3,4,1,2,0,2,0,0,0,1,0,1,-1,1,0,0,0,-4,4,-5,1,-5,0,0,1,-1,0,-1,5,-1
KR_6761905920,420,4,16,-31,10,7,0,7,-4,4,0,3,1,4,5,2,7,-1,1,0,0,-3,-6,3,-5,2,-2,0,1,-1,-1,1,1,1,-1
KR_6757665762,420,0,29,4,-2,-5,5,0,3,1,4,-2,4,2,-1,5,4,3,1,4,-1,-2,-6,2,-4,2,-1,0,-1,1,0,-1,-1,5,-1
KR_6740196180,420,-2,-36,-9,0,0,0,0,-2,4,2,1,0,1,1,1,2,0,0,0,0,1,28,4,-6,2,-1,0,0,1,1,0,-1,2,-1
KR_6718171944,420,-1,-4,4,-1,-2,3,1,3,2,5,1,3,4,0,2,2,-3,4,1,0,-1,-26,2,-7,5,7,0,0,-1,-1,0,1,3,-1
KR_6760597424,420,-3,-126,-8,-3,-4,5,1,2,0,2,4,2,6,-5,7,2,0,0,0,0,-1,45,0,-3,3,-5,0,0,1,-1,-1,1,4,-1
KR_6762900234,420,-1,-43,20,-2,-5,6,1,2,1,3,0,5,5,3,2,5,-2,2,0,0,-1,-12,-3,-5,8,9,0,0,0,-1,0,1,0,-1
KR_6743351304,420,-4,-74,-8,-12,-7,7,0,-3,4,1,-4,4,0,1,2,3,1,0,1,0,-7,-4,-4,-2,6,-2,0,-3,-1,-1,-1,-1,6,-1
KR_6763930085,420,7,83,1,8,3,2,5,2,2,4,0,2,2,3,0,3,0,1,1,0,-4,4,3,-5,2,0,0,0,1,0,1,1,3,-1
KR_6756280891,420,0,20,-3,-5,1,1,2,-3,5,2,-1,5,4,-1,5,4,-1,2,1,0,-7,-6,-2,-6,8,-4,0,0,1,1,1,1,3,-1
KR_6735160470,420,-1,-36,8,-2,3,1,4,2,0,2,-6,6,0,0,3,3,-1,1,0,1,3,-1,0,-4,4,1,0,-1,1,-1,1,1,3,-1
KR_6760894443,420,1,3,30,2,2,1,3,-1,2,1,4,0,4,-2,2,0,-1,1,0,0,-5,-7,0,-3,3,1,0,-1,1,-1,-1,1,6,-1
KR_6742851081,420,0,-36,-8,-1,3,1,4,3,2,5,-6,6,0,0,4,4,-1,2,1,0,2,1,-1,-3,4,-4,0,0,1,1,0,1,3,-1
KR_6718107894,420,0,39,-36,-4,0,2,2,4,0,4,1,0,1,-6,6,0,-3,6,3,0,-1,-16,0,0,0,1,0,-1,-1,-1,-1,-1,4,-1
KR_6752758185,420,-3,-1,-4,-7,-6,7,1,-4,4,0,-3,3,0,6,3,9,0,1,1,0,-9,43,-2,-2,4,-10,0,0,1,1,-1,-1,5,-1
KR_6638211994,420,-3,-34,25,-6,-1,1,0,-3,8,5,1,2,3,-2,7,5,-1,2,1,0,-13,55,-2,-5,7,-2,0,0,1,1,0,-1,2,-1
KR_6679329595,420,-6,-88,-20,-11,-5,6,1,1,1,2,-2,6,4,-5,6,1,0,0,0,0,-2,-5,-3,-3,6,-1,0,-2,-1,-1,-1,-1,5,-1
KR_6608011150,420,-2,-5,-23,-6,-2,2,0,-4,4,0,-3,3,0,3,1,4,0,0,0,0,-4,4,0,-3,3,0,0,-2,-1,-1,-1,-1,3,-1
KR_6730702068,420,1,-18,-13,3,1,3,4,2,1,3,-8,8,0,5,4,9,3,0,3,0,1,-1,0,-3,3,-2,0,1,0,-1,1,-1,0,-1
KR_6762847416,420,3,14,8,0,-1,2,1,2,1,3,4,2,6,-2,4,2,-3,5,2,0,-1,-4,1,-5,4,1,0,-1,0,0,-1,-1,0,-1
KR_6710873087,440,-3,-32,-29,-6,0,1,1,-5,5,0,-3,3,0,2,1,3,0,1,1,0,-2,-12,0,-4,4,5,0,-1,0,-1,-1,-1,0,-1
KR_6610623159,420,2,-50,1,3,-1,3,2,1,1,2,4,0,4,0,2,2,-1,2,1,0,-2,0,4,-8,4,1,0,1,0,1,1,-1,0,-1
KR_6756566359,420,-8,-33,-45,-8,-2,2,0,-1,3,2,-6,9,3,1,0,1,0,1,1,0,-6,136,-2,-2,4,0,0,0,1,-1,0,-1,2,-1
KR_6733727148,440,0,-2,-7,2,1,0,1,4,2,6,-1,3,2,-1,5,4,-1,1,0,0,4,0,3,-7,4,-4,0,0,-1,-1,0,-1,3,-1
KR_6757027923,420,-3,-41,-5,-9,1,2,3,-3,5,2,0,1,1,-5,5,0,-2,2,0,0,-5,9,1,-6,5,-5,0,-2,0,1,-1,-1,0,-1
KR_6684363099,420,-2,-12,13,-13,-4,4,0,1,2,3,-2,5,3,-6,6,0,-2,2,0,0,-16,-16,-7,0,7,1,0,0,0,-1,1,-1,0,-1
KR_6545284268,440,2,-29,20,11,2,1,3,1,2,3,1,2,3,7,0,7,0,0,0,0,12,3,4,-8,4,0,0,0,1,-1,0,1,3,-1
KR_6570895471,420,-6,-83,-20,-13,-3,4,1,-3,3,0,-2,2,0,-3,7,4,-2,2,0,0,-3,-43,2,-3,1,24,0,-1,-1,-1,-1,-1,6,-1
KR_6568053595,440,-2,26,6,-8,1,0,1,0,0,0,-4,5,1,1,3,4,-6,7,1,0,-14,-6,-4,-5,9,-5,0,1,-1,1,1,-1,6,-1
KR_6745732513,420,-1,-72,-4,0,2,1,3,2,2,4,-3,5,2,-1,5,4,0,4,4,1,5,1,2,-3,1,-2,0,-2,-1,1,-1,1,1,-1
KR_6752486003,420,2,126,16,-1,2,1,3,1,0,1,-4,4,0,-1,1,0,1,0,1,0,-3,20,2,-5,3,-2,0,1,1,-1,1,-1,4,-1
KR_6623929371,420,-1,37,-7,-4,-2,4,2,-5,5,0,10,0,10,-8,10,2,1,2,3,0,-2,-8,0,-3,3,-2,0,-1,1,-1,-1,-1,6,-1
KR_6668729992,420,-2,-48,-24,-4,0,1,1,-4,6,2,1,0,1,-1,4,3,0,2,2,0,-7,-5,1,-6,5,-7,0,-1,1,-1,-1,-1,2,-1
KR_6625386620,420,-3,-57,-4,-12,-2,2,0,-4,5,1,-2,4,2,-2,5,3,-2,2,0,0,-8,84,-1,-4,5,-1,0,0,-1,-1,-1,-1,5,-1
KR_6764261643,420,-3,-34,16,0,-3,6,3,-6,7,1,7,0,7,2,1,3,0,1,1,0,3,-17,7,-7,0,1,0,-1,1,-1,-1,1,6,-1
KR_6604434935,420,-4,-28,-2,-8,-6,7,1,1,0,1,4,0,4,-6,9,3,-1,1,0,0,-8,-4,-1,-3,4,-1,0,-2,1,-1,-1,-1,2,-1
KR_6741228063,420,2,4,-21,9,1,1,2,1,2,3,0,2,2,7,1,8,0,1,1,0,11,2,0,-3,3,-5,0,1,0,-1,1,1,0,-1
KR_6705616804,420,0,6,-14,-3,0,2,2,-2,3,1,1,2,3,-2,4,2,0,1,1,0,-5,27,-3,-3,6,-1,0,-1,-1,1,1,1,4,-1
KR_6692162985,420,-6,-63,-36,-9,-5,5,0,-3,6,3,0,4,4,1,4,5,-2,3,1,3,8,2,-1,-4,5,3,0,-4,1,-1,-1,1,2,-1
KR_6757692565,420,-3,-95,-25,-6,2,0,2,-1,3,2,0,3,3,-3,3,0,-4,5,1,0,-10,6,2,-3,1,0,0,0,-1,-1,1,-1,1,-1
KR_6759386009,420,1,-4,12,-6,-2,3,1,-4,5,1,-2,6,4,1,1,2,1,1,2,0,-6,-5,-5,0,5,2,0,-1,-1,-1,-1,-1,5,-1
KR_6679641725,420,-3,-102,-36,-7,-2,3,1,-2,7,5,1,4,5,-3,4,1,-1,3,2,0,-6,-1,1,-8,7,-3,0,-2,-1,-1,-1,1,5,-1
KR_6736448538,420,0,-51,-20,3,3,0,3,0,0,0,-1,1,0,1,2,3,0,0,0,1,0,5,4,-6,2,-7,0,-1,-1,1,-1,1,5,-1
KR_6759354001,420,-3,-26,-19,-2,4,1,5,0,3,3,-1,2,1,-4,6,2,-1,2,1,-3,-2,-42,3,-7,4,2,0,0,0,-1,-1,1,0,-1
KR_6762960783,420,-3,6,-11,-11,-3,5,2,-2,4,2,-2,2,0,-3,5,2,-1,2,1,0,-12,-49,2,-4,2,20,0,-1,0,-1,-1,-1,0,-1
KR_6719395072,440,-1,-14,-4,-3,1,2,3,-1,2,1,-3,7,4,0,1,1,0,0,0,-1,0,-2,3,-6,3,1,0,0,1,1,1,-1,3,-1
KR_6759391490,420,-2,-23,17,-7,2,1,3,0,1,1,6,2,8,-11,11,0,-4,4,0,1,-13,-6,-1,-3,4,0,0,0,1,1,1,1,5,-1
KR_6734871747,420,-3,-63,-24,1,-1,2,1,0,2,2,-2,2,0,4,0,4,0,2,2,0,5,3,4,-5,1,0,0,1,1,-1,-1,-1,1,-1
KR_6699883457,440,1,-8,-12,-2,-2,4,2,1,5,6,3,1,4,-3,9,6,-1,2,1,-2,-13,-273,-4,-5,9,-1,0,-1,-1,-1,-1,-1,3,-1
KR_6645129390,420,-1,-29,-13,2,1,0,1,5,0,5,-5,6,1,-2,3,1,3,0,3,0,9,3,-5,-4,9,4,0,1,-1,0,1,1,5,-1
KR_6710769957,420,-3,-23,24,-17,-1,2,1,-7,7,0,3,1,4,-8,8,0,-4,4,0,0,-14,-3,0,-6,6,1,0,0,-1,1,1,-1,5,-1
KR_6720480617,420,-3,-59,-21,-13,-3,3,0,-3,4,1,0,1,1,-2,4,2,-5,5,0,0,-13,-311,4,-5,1,-4,0,0,0,-1,-1,1,0,-1
KR_6675841131,440,-4,-44,9,-10,1,3,4,-9,9,0,-1,3,2,-2,5,3,1,0,1,0,-11,5,2,-7,5,-7,0,-1,0,-1,-1,1,0,-1
KR_6708538182,420,0,7,-14,-6,-3,3,0,-2,3,1,3,1,4,-3,4,1,-1,2,1,0,-7,6,-1,-3,4,1,0,0,1,-1,1,-1,6,-1
KR_6658770204,420,-5,-55,-8,-8,0,2,2,-2,4,2,1,2,3,-1,1,0,-6,7,1,0,-7,6,2,-7,5,-4,0,-2,-1,1,-1,1,1,-1
KR_6503974694,420,2,-46,9,3,-2,2,0,0,4,4,1,1,2,2,1,3,2,0,2,0,3,13,0,-5,5,-2,0,0,-1,-1,1,1,6,-1
KR_6604087214,420,-5,-48,-12,-9,-2,3,1,-1,2,1,-7,7,0,1,4,5,0,0,0,0,2,5,0,-4,4,0,0,-1,-1,-1,-1,-1,5,-1
KR_6751091197,420,-5,-31,-44,-13,0,3,3,-3,6,3,0,4,4,-9,11,2,-1,1,0,0,-11,3,-3,-2,5,0,0,-2,-1,-1,-1,-1,4,-1
KR_6753341999,440,-4,-55,-36,-3,-7,7,0,-3,3,0,2,1,3,3,3,6,2,0,2,0,2,19,-3,-1,4,-2,0,-1,0,1,-1,1,0,-1
KR_6669312957,420,2,63,-24,2,5,0,5,-1,2,1,3,1,4,-4,5,1,-1,2,1,0,1,7,1,-2,1,-2,0,-1,0,-1,-1,1,0,-1
KR_5890136611,420,-1,-51,0,-1,-1,4,3,2,1,3,-4,6,2,2,1,3,0,2,2,1,-1,-3,-4,-2,6,-2,0,-3,-1,-1,-1,1,1,-1
KR_6741683669,420,-2,-14,-18,0,-1,1,0,1,4,5,3,0,3,1,0,1,-4,4,0,0,3,157,7,-8,1,0,0,0,1,-1,1,1,3,-1
KR_6750023427,420,-1,-92,-4,-4,1,3,4,6,2,8,1,1,2,-9,11,2,-3,3,0,0,-1,-17,-3,-3,6,0,0,-1,-1,1,-1,-1,6,-1
KR_6668627819,420,-2,-96,-28,2,-4,5,1,2,3,5,1,0,1,-1,3,2,4,0,4,0,5,8,0,-6,6,-5,0,0,-1,1,0,-1,5,-1
KR_6727972650,420,-4,-39,-44,-6,-1,2,1,-7,10,3,-2,2,0,6,1,7,-2,2,0,0,6,-15,4,-5,1,-3,0,-2,-1,-1,-1,-1,4,-1
KR_6763918744,420,-5,-21,-20,-18,-3,3,0,-6,6,0,-4,5,1,3,2,5,-8,10,2,-1,-12,-13,2,-5,3,2,0,-2,0,-1,-1,-1,0,-1
KR_6727804386,420,-1,-16,-10,-8,-1,5,4,3,2,5,1,1,2,-5,7,2,-6,7,1,0,-21,237,-4,-1,5,5,0,-1,-1,-1,-1,-1,2,-1
KR_6744510426,420,-4,-43,-13,-13,0,2,2,-3,4,1,4,1,5,-12,12,0,-2,3,1,-2,-21,33,0,-5,5,-34,0,-2,-1,-1,-1,-1,2,-1
KR_6727126449,420,-6,-135,-17,-14,-5,5,0,0,5,5,-12,13,1,2,1,3,1,0,1,0,-6,1,-2,-5,7,1,0,-3,1,0,-1,-1,1,-1
KR_6552509405,420,0,6,10,2,-5,5,0,2,1,3,4,0,4,1,2,3,0,1,1,1,13,-1,-1,-2,3,-1,0,0,-1,0,0,1,2,-1
KR_6709615126,420,-5,-44,-24,-12,-5,5,0,1,6,7,-4,6,2,-2,3,1,-2,2,0,0,-15,-8,-4,-1,5,-1,0,-2,1,-1,-1,1,3,-1
KR_6724817948,420,-5,-139,-47,-5,-2,3,1,-1,3,2,-3,4,1,0,2,2,1,0,1,0,-4,-8,-5,-2,7,-3,0,-1,-1,-1,-1,-1,5,-1
KR_6705400254,440,-3,19,14,-1,-5,6,1,-5,5,0,-2,2,0,5,0,5,6,2,8,-1,-6,-26,-5,-1,6,28,0,1,-1,1,1,-1,5,-1
KR_6597665127,420,-1,-53,-23,3,-2,5,3,5,3,8,0,4,4,1,0,1,-1,1,0,0,9,-15,-2,-1,3,1,0,0,-1,1,-1,-1,2,-1
KR_6393382766,420,-1,-5,4,-6,-1,1,0,1,0,1,-2,5,3,-2,4,2,-2,2,0,-1,-9,-3,1,-5,4,-5,0,-1,-1,1,-1,-1,1,-1
KR_6748949028,420,1,21,-27,0,2,2,4,1,3,4,2,0,2,-4,5,1,-1,3,2,0,-3,-1,3,-5,2,-1,0,1,-1,0,1,-1,2,-1
KR_6755771241,420,1,-2,-18,6,-2,3,1,10,2,12,2,0,2,-5,6,1,1,1,2,0,10,4,-3,-3,6,0,0,-1,1,-1,-1,1,1,-1
KR_6718230009,420,-1,-37,-19,-4,2,3,5,-2,4,2,-3,4,1,-1,5,4,0,1,1,0,-2,4,1,-5,4,0,0,0,0,1,-1,-1,0,-1
KR_6754070322,420,-1,1,10,-1,1,1,2,1,4,5,1,1,2,-2,2,0,-2,2,0,0,-7,1,-4,-6,10,2,0,0,1,-1,0,-1,6,-1
KR_6747592373,440,0,-88,9,-5,1,0,1,-2,3,1,-5,9,4,0,0,0,1,0,1,0,-9,361,-3,-1,4,-1,0,-1,-1,0,-1,1,6,-1
KR_6756773242,420,1,48,-16,7,3,1,4,-2,3,1,2,1,3,2,1,3,2,0,2,0,-3,-1,2,-5,3,1,0,1,-1,1,1,1,2,-1
KR_6745451154,420,-2,-77,20,-5,-1,3,2,3,0,3,-6,6,0,1,1,2,-2,2,0,0,-3,-13,1,-4,3,-3,0,-2,-1,1,-1,-1,3,-1
KR_6728817210,440,-3,-33,-3,-1,-2,6,4,2,2,4,2,1,3,-2,2,0,-1,2,1,0,-6,-25,-3,-4,7,2,0,-2,1,1,-1,1,6,-1
KR_6599773353,420,-3,-73,-64,-8,0,3,3,-6,7,1,-3,5,2,1,3,4,0,1,1,-2,-8,224,-4,-1,5,-1,0,-1,-1,-1,-1,-1,5,-1
KR_6756132275,420,-4,-12,-24,-8,-1,1,0,-5,5,0,-2,2,0,-2,3,1,2,1,3,0,-8,0,0,-2,2,0,0,-1,1,1,-1,1,4,-1
KR_6713133492,420,-2,-14,-11,-3,1,0,1,1,1,2,-2,2,0,-2,2,0,-1,2,1,0,-7,-9,-6,-2,8,-2,0,0,-1,1,1,1,3,-1
KR_6682690094,420,-1,-38,18,-7,-3,6,3,-4,6,2,0,2,2,-1,3,2,1,0,1,0,2,93,1,-5,4,3,0,-1,1,-1,-1,1,1,-1
KR_6620289903,420,-2,-10,-13,-8,-2,2,0,-1,5,4,-2,3,1,-2,5,3,-1,1,0,0,-7,5,2,-5,3,-2,0,0,-1,1,-1,1,1,-1
KR_6763176136,440,-1,-22,-4,-3,2,0,2,-3,4,1,3,3,6,-2,4,2,-3,4,1,0,-8,20,-3,-2,5,-1,0,0,0,1,-1,1,0,-1
KR_6628040561,420,5,13,28,14,-5,5,0,-1,2,1,11,3,14,4,1,5,5,0,5,-1,23,3,-1,-4,5,0,0,1,1,0,1,1,4,-1
KR_6732381252,420,1,16,-4,1,-2,2,0,1,1,2,2,2,4,0,2,2,0,0,0,0,2,-293,4,-8,4,-4,0,0,1,-1,0,-1,3,-1
KR_6760842741,420,0,21,8,-8,-1,1,0,4,0,4,-8,9,1,-4,5,1,1,3,4,-1,-14,-6,2,-5,3,-8,0,0,0,-1,-1,-1,0,-1
KR_5884240509,420,-1,-56,20,-3,0,2,2,2,1,3,0,2,2,-2,5,3,-3,3,0,0,-6,-6,1,-4,3,-2,0,0,-1,1,1,-1,2,-1
KR_6674429767,420,-1,-2,-19,-6,2,0,2,0,4,4,-5,8,3,-3,3,0,0,0,0,0,-1,-10,-3,-3,6,0,0,-1,-1,-1,-1,-1,5,-1
KR_6683086166,420,-1,-31,12,-2,-2,2,0,1,1,2,1,0,1,-2,3,1,0,1,1,0,-3,-12,-3,-2,5,1,0,-1,-1,0,-1,1,4,-1
KR_6742826680,420,-1,-16,17,-5,-4,4,0,3,3,6,-2,5,3,-3,5,2,1,1,2,-2,4,-10,-1,-5,6,-1,0,0,-1,-1,-1,-1,3,-1
KR_6744232108,420,-3,-23,-8,-7,2,2,4,-1,4,3,-3,6,3,-2,2,0,-3,3,0,0,-3,-301,2,-6,4,-6,0,-2,-1,-1,-1,1,4,-1
KR_6618084200,420,0,-20,36,-2,-2,2,0,0,6,6,-7,7,0,1,3,4,6,0,6,2,7,-7,-2,-4,6,3,0,0,1,1,0,1,3,-1
KR_6750661141,420,5,17,16,18,2,2,4,0,2,2,10,2,12,5,0,5,1,0,1,0,13,7,5,-7,2,-1,0,1,1,1,1,1,6,-1
KR_6763260949,420,-1,35,4,-3,-4,5,1,1,2,3,0,2,2,0,1,1,0,0,0,0,0,2,1,-2,1,2,0,-1,1,-1,-1,-1,2,-1
KR_6762004847,420,-2,-125,-24,-2,1,0,1,-4,4,0,-2,2,0,2,2,4,1,0,1,0,-3,83,-4,-2,6,-1,0,-1,-1,-1,-1,-1,2,-1
KR_6763449926,420,-5,-36,-41,-10,-1,1,0,-7,7,0,-3,3,0,0,0,0,1,0,1,0,-5,-274,3,-6,3,-2,0,-1,-1,-1,-1,-1,3,-1
KR_6744971341,420,-3,-53,-52,-1,-1,2,1,-1,1,0,0,3,3,1,0,1,0,1,1,0,2,46,2,-4,2,-15,0,-1,-1,-1,-1,-1,5,-1
KR_6761779616,420,0,-8,8,-5,-1,2,1,-1,3,2,3,2,5,-8,9,1,2,0,2,0,-10,1,1,-6,5,0,0,0,1,1,0,-1,3,-1
KR_6732229090,420,2,32,6,6,-2,5,3,5,1,6,-1,4,3,1,4,5,3,0,3,1,3,-244,4,-6,2,0,0,1,1,1,1,1,1,-1
KR_6678331933,420,-3,-16,12,-2,6,0,6,-3,3,0,-1,4,3,-6,7,1,2,2,4,1,-8,-32,1,-4,3,9,0,0,-1,1,-1,1,6,-1
KR_6726867456,440,-3,-26,-9,-7,0,2,2,-1,5,4,-1,4,3,-5,7,2,0,3,3,0,-14,3,-2,0,2,1,0,-1,-1,1,-1,-1,3,-1
KR_6741283361,420,0,-18,-19,-4,3,1,4,-7,9,2,-2,2,0,4,2,6,-2,4,2,0,-4,7,-3,-3,6,-1,0,0,-1,-1,0,1,1,-1
KR_6716212642,420,-2,-23,-3,-7,-6,6,0,-1,3,2,-2,2,0,2,5,7,0,0,0,0,1,-260,1,-6,5,-5,0,-1,-1,-1,-1,-1,2,-1
KR_6760411312,440,2,-59,1,2,-1,3,2,5,2,7,2,3,5,-2,3,1,-2,2,0,0,1,-2,2,-4,2,1,0,0,-1,1,1,1,2,-1
KR_6717468341,420,-2,-11,15,-9,0,1,1,-2,3,1,-4,6,2,-2,2,0,-1,1,0,0,-15,185,1,-4,3,0,0,-1,-1,-1,-1,-1,5,-1
KR_6712198948,440,-2,-46,-36,-1,-1,1,0,-2,6,4,5,2,7,-4,5,1,1,0,1,0,-5,65,-1,-3,4,0,0,-1,-1,1,1,1,1,-1
KR_6643894075,420,-6,-153,-52,-11,-3,5,2,0,2,2,-6,8,2,-3,4,1,1,1,2,-2,-1,-45,-2,0,2,16,0,-2,-1,-1,-1,-1,2,-1
KR_6759166794,420,1,19,-20,-2,-1,2,1,1,3,4,-6,6,0,3,0,3,1,0,1,0,0,-41,-3,-5,8,32,0,1,-1,1,1,1,2,-1
KR_6679691223,440,-1,-33,-2,-3,3,0,3,-1,3,2,-1,1,0,-4,7,3,0,1,1,0,-8,0,4,-10,6,-6,0,0,-1,0,0,-1,6,-1
KR_6643664964,420,2,5,21,6,-2,3,1,2,1,3,3,1,4,1,1,2,2,0,2,0,6,12,8,-10,2,-1,0,2,1,1,1,1,2,-1
KR_6757617963,420,2,-82,-19,8,1,0,1,2,1,3,1,1,2,4,1,5,0,1,1,0,9,-130,-3,-2,5,0,0,1,1,0,1,-1,5,-1
KR_6682735870,420,-6,-107,0,-9,-3,4,1,-2,3,1,-1,3,2,-3,3,0,0,0,0,1,-1,-1,-7,-3,10,1,0,0,-1,1,0,1,6,-1
KR_6723930496,420,-8,-46,-50,-21,-1,2,1,-8,10,2,-8,9,1,-5,6,1,1,2,3,0,-23,-12,-7,-2,9,2,0,-1,1,0,-1,-1,5,-1
KR_6745614273,420,-4,-84,-20,-8,3,3,6,-1,2,1,-3,6,3,-6,6,0,-1,3,2,0,-6,-10,3,-3,0,0,0,-3,0,0,-1,1,0,-1
KR_6733000347,440,-1,-25,4,1,1,0,1,4,0,4,-4,5,1,1,2,3,-1,4,3,0,2,-6,-1,-2,3,0,0,1,1,-1,1,1,2,-1
KR_6560746375,420,-3,-1,-4,-5,0,4,4,0,5,5,-2,2,0,-4,7,3,1,1,2,0,-4,15,4,-7,3,-11,0,0,-1,-1,-1,-1,4,-1
KR_6732081020,420,0,10,4,0,-3,3,0,2,1,3,-1,4,3,0,3,3,2,0,2,0,10,-6,-6,-1,7,4,0,0,1,-1,0,1,5,-1
KR_6746007258,440,-7,-52,-24,-16,-3,4,1,-8,8,0,-4,6,2,2,3,5,-3,3,0,-2,-17,-190,-1,-1,2,-8,0,0,-1,-1,0,-1,5,-1
KR_6723203780,420,-1,-42,-17,3,0,0,0,1,1,2,1,5,6,1,0,1,0,0,0,0,2,68,1,-4,3,1,0,0,-1,-1,-1,-1,1,-1
KR_6755182581,420,-5,-31,-17,-9,-1,3,2,1,1,2,1,3,4,-8,11,3,-2,3,1,0,-6,-104,6,-8,2,-2,0,-2,0,1,-1,-1,0,-1
KR_6619976993,420,0,23,-4,-4,1,2,3,0,1,1,2,5,7,-7,8,1,0,1,1,0,-5,-156,0,-3,3,-4,0,-2,-1,-1,-1,1,4,-1
KR_6619481201,420,1,1,-20,-1,2,1,3,2,4,6,0,3,3,-6,10,4,1,0,1,0,9,-2,-5,-1,6,0,0,-3,-1,1,-1,1,5,-1
KR_6748649378,420,-5,0,-41,-23,0,2,2,-5,6,1,0,2,2,-9,10,1,-9,9,0,0,-16,-174,-1,-6,7,-2,0,-1,-1,-1,-1,-1,1,-1
KR_6685052031,440,0,-5,-28,-3,1,0,1,-1,5,4,-2,4,2,-1,2,1,0,0,0,0,-4,-13,4,-9,5,7,0,1,1,-1,-1,1,6,-1
KR_6664882221,420,-3,-79,-16,-7,1,1,2,0,1,1,-2,3,1,-6,7,1,0,0,0,0,-10,-4,-2,-2,4,-3,0,0,-1,-1,-1,1,1,-1
KR_6714022641,420,-3,-55,15,-10,-3,4,1,-1,3,2,-5,9,4,-1,3,2,0,2,2,-1,-13,-2,-3,-1,4,-2,0,1,1,-1,1,-1,4,-1
KR_6624202918,420,-4,-49,-31,-8,-4,5,1,-5,6,1,-4,4,0,0,1,1,5,0,5,0,-2,52,1,-4,3,-1,0,-2,-1,-1,-1,-1,5,-1
KR_6687436315,440,-8,-53,-60,-12,1,5,6,-6,7,1,-1,3,2,-4,5,1,-2,2,0,0,-16,176,-3,-1,4,1,0,-2,-1,-1,-1,1,2,-1
KR_6764365494,420,4,14,0,4,1,0,1,0,2,2,1,1,2,3,2,5,-1,1,0,0,3,-69,-1,-2,3,30,0,2,1,1,1,1,3,-1
KR_6652184881,420,1,111,-16,1,3,2,5,-2,2,0,2,4,6,0,4,4,-2,3,1,1,-10,9,3,-4,1,-3,0,0,-1,-1,0,1,3,-1
KR_6733429216,420,-3,-25,-30,-5,2,0,2,-9,9,0,-2,3,1,3,1,4,1,1,2,0,-4,-20,3,-4,1,18,0,-1,1,-1,-1,1,1,-1
KR_6685571433,420,3,24,-4,0,-1,2,1,3,3,6,-1,4,3,0,2,2,-1,1,0,0,-1,-5,0,-1,1,-2,0,1,0,1,1,-1,0,-1
KR_6715858716,420,2,43,17,5,-3,3,0,5,2,7,5,4,9,-1,3,2,-1,1,0,0,-3,4,1,-4,3,5,0,2,-1,1,1,-1,4,-1
KR_6758798888,420,3,60,28,-11,3,1,4,-5,5,0,-2,4,2,-3,3,0,-4,5,1,-1,-27,-5,-3,0,3,1,0,-1,-1,-1,-1,-1,5,-1
KR_6716205397,420,0,-46,28,-3,-3,4,1,1,0,1,2,0,2,-6,9,3,3,1,4,-1,-2,-2,-1,-3,4,8,0,-2,1,-1,-1,-1,1,-1
KR_6742475739,420,2,-3,24,12,-2,2,0,4,1,5,3,2,5,6,3,9,1,2,3,0,15,6,1,-5,4,2,0,0,-1,-1,0,1,6,-1
KR_5794412882,420,0,6,36,3,-1,3,2,0,3,3,-1,1,0,2,0,2,3,2,5,0,2,-203,-3,-6,9,2,0,0,1,-1,-1,-1,4,-1
KR_6761909917,420,-5,-113,-41,-11,-4,6,2,1,1,2,0,3,3,-6,9,3,-2,4,2,2,2,8,7,-9,2,-2,0,-2,0,1,-1,1,0,-1
KR_6643813246,420,-2,-22,-23,-6,-6,8,2,5,1,6,-8,9,1,5,4,9,-2,5,3,-1,-1,12,1,-4,3,3,0,0,-1,-1,-1,-1,1,-1
KR_6761956443,440,2,-29,5,-3,2,0,2,-3,6,3,-1,4,3,-3,7,4,2,0,2,-1,-5,1,0,-8,8,-1,0,0,-1,-1,1,-1,2,-1
KR_6733360800,420,-5,-39,-25,-8,-4,5,1,-4,6,2,-3,5,2,5,1,6,-2,3,1,0,2,2,-1,-2,3,-6,0,-1,-1,-1,-1,1,1,-1
KR_6647014361,420,-2,18,-41,-6,2,1,3,-6,6,0,-4,6,2,1,4,5,1,0,1,0,-14,8,-7,0,7,1,0,0,-1,-1,0,-1,1,-1
KR_6611625359,420,-1,1,0,-4,0,1,1,-1,3,2,0,4,4,-4,6,2,1,0,1,1,-5,-1,2,-2,0,0,0,-1,-1,-1,-1,1,6,-1
KR_6424755381,420,-1,36,6,-4,6,1,7,-6,6,0,-1,4,3,-6,8,2,3,0,3,0,-11,-14,5,-9,4,-1,0,2,-1,0,1,1,3,-1
KR_6743123169,420,-3,-107,-16,-12,0,1,1,-3,3,0,-3,3,0,-5,7,2,-1,2,1,-1,-14,6,-3,-3,6,-2,0,0,0,0,0,-1,0,-1
KR_6749996952,420,-4,-25,-4,-6,0,1,1,1,2,3,0,4,4,-5,5,0,-2,2,0,0,-3,-4,4,-8,4,-5,0,-1,1,1,-1,-1,4,-1
KR_6753597980,420,0,51,-35,1,4,1,5,-1,2,1,-3,4,1,1,3,4,0,1,1,0,2,2,-1,-3,4,5,0,0,-1,0,0,-1,4,-1
KR_6761514867,440,-3,-23,6,1,-5,5,0,-3,5,2,4,1,5,3,2,5,2,1,3,-1,7,-9,2,-3,1,-2,0,0,1,-1,1,-1,2,-1
KR_6712737192,420,0,-7,8,-5,-1,3,2,-6,8,2,0,0,0,1,4,5,1,1,2,0,-10,30,-3,-3,6,-2,0,-1,0,-1,-1,1,0,-1
KR_6752480347,420,1,100,0,1,-1,1,0,-4,6,2,6,0,6,0,3,3,0,0,0,-1,1,-1,1,-6,5,1,0,0,-1,-1,1,-1,1,-1
KR_6742852533,440,-7,-32,-13,-22,-7,7,0,-7,7,0,-5,7,2,-3,4,1,0,1,1,0,-11,-34,-12,-2,14,3,0,-3,1,-1,-1,-1,3,-1
KR_6654953809,420,-5,-52,-30,-14,-1,2,1,-4,8,4,-2,2,0,-6,8,2,-1,2,1,0,-9,1,-1,-3,4,1,0,-1,-1,-1,-1,-1,4,-1
KR_6743183954,420,-1,-26,0,-3,2,2,4,1,0,1,-5,6,1,0,3,3,-1,1,0,0,0,-4,2,-4,2,2,0,0,-1,1,1,-1,6,-1
KR_5794468283,420,1,-17,33,3,1,0,1,2,1,3,-1,4,3,1,4,5,0,1,1,0,6,17,-2,-4,6,-1,0,-1,-1,1,-1,-1,4,-1
KR_6747997518,420,-6,-117,-16,-9,-2,2,0,0,0,0,-4,4,0,-2,3,1,-1,1,0,0,-6,-5,-2,-2,4,2,0,-2,-1,-1,-1,-1,4,-1
KR_6753497840,420,-3,6,-1,-6,3,1,4,2,0,2,-4,5,1,-3,3,0,-4,4,0,0,-10,-20,1,-3,2,1,0,-1,1,0,-1,-1,4,-1
KR_6560806773,420,-6,-108,-33,-13,-4,5,1,-5,5,0,-3,5,2,1,1,2,-2,2,0,0,-16,-21,0,-3,3,-3,0,-2,-1,-1,-1,1,3,-1
KR_6719120647,420,-2,-37,-5,-5,-3,3,0,2,2,4,-4,8,4,-1,4,3,1,1,2,2,1,-98,-2,-5,7,-4,0,-1,-1,1,-1,1,4,-1
KR_6671917101,420,-3,8,-8,-5,4,1,5,-4,6,2,0,1,1,-3,3,0,-2,4,2,0,-5,2,1,-5,4,-2,0,0,-1,-1,-1,-1,1,-1
KR_6677886281,420,-1,-10,1,-2,0,3,3,-6,8,2,1,4,5,2,0,2,1,0,1,0,-2,0,1,-5,4,0,0,-1,-1,1,-1,1,4,-1
KR_6703496752,420,3,-44,56,-1,-4,4,0,1,0,1,-2,4,2,4,2,6,0,1,1,0,4,-2,-1,-2,3,-1,0,0,0,1,1,-1,0,-1
KR_6762851552,420,0,-40,-27,-4,-3,5,2,-1,2,1,1,0,1,-3,5,2,2,0,2,0,0,-124,1,-5,4,-31,0,-2,0,-1,-1,-1,0,-1
KR_6762528135,440,-9,-156,-43,-16,-2,4,2,-5,7,2,-2,2,0,-7,7,0,0,0,0,0,-8,264,1,-2,1,0,0,-4,-1,1,-1,1,1,-1
KR_6724797945,420,-2,-56,-8,-7,-4,5,1,3,1,4,-3,4,1,-2,4,2,-1,1,0,0,1,31,1,-4,3,-1,0,0,1,1,-1,-1,6,-1
KR_6696397355,420,0,-63,4,-1,1,1,2,3,2,5,-2,4,2,-1,5,4,-2,2,0,0,1,-2,2,-4,2,0,0,0,-1,1,-1,-1,4,-1
KR_6699609502,420,1,41,12,5,-1,2,1,7,0,7,-4,7,3,2,1,3,1,1,2,0,15,-1,-1,-4,5,0,0,1,0,1,1,-1,0,-1
KR_6699495902,420,-2,1,4,-11,-1,2,1,-4,6,2,-6,8,2,2,3,5,-2,2,0,0,-15,-3,-4,0,4,2,0,0,-1,1,1,1,6,-1
KR_6756517942,440,-4,-13,-8,-16,-8,8,0,-3,3,0,-4,4,0,-1,2,1,0,0,0,0,-30,-2,-5,-1,6,0,0,-1,-1,-1,-1,-1,5,-1
KR_6731298412,440,1,-31,50,2,0,2,2,1,4,5,2,0,2,1,1,2,-2,4,2,0,1,-13,-1,-4,5,4,0,0,1,0,0,-1,6,-1
KR_6750240153,420,-3,-14,-8,-9,-4,4,0,-6,6,0,-5,6,1,4,1,5,2,2,4,0,-6,-5,-5,-2,7,-1,0,1,-1,1,1,1,3,-1
KR_6759541680,420,1,7,33,3,-2,2,0,-1,3,2,0,2,2,6,0,6,0,2,2,1,0,5,5,-7,2,3,0,1,1,1,1,1,6,-1
KR_6763070506,420,1,-10,17,3,0,4,4,2,3,5,5,1,6,-3,4,1,-1,2,1,0,1,3,4,-6,2,-4,0,1,1,1,1,-1,1,-1
KR_6760685687,420,-1,-6,16,-8,-7,9,2,-1,3,2,1,0,1,-2,4,2,1,1,2,0,-4,0,0,-4,4,1,0,1,1,-1,-1,-1,3,-1
KR_6762449357,440,-4,-106,-13,-3,0,2,2,-8,8,0,0,1,1,1,4,5,4,1,5,-1,-2,2,-2,-3,5,-4,0,-2,1,-1,-1,-1,6,-1
KR_6761069404,420,-1,-32,4,-2,-1,2,1,1,0,1,-4,5,1,-2,3,1,4,0,4,-1,-2,16,3,-9,6,-6,0,0,-1,1,0,-1,5,-1
KR_6764623524,440,-3,-74,-11,-5,7,1,8,0,1,1,-1,2,1,-6,6,0,-5,6,1,-1,-12,-250,2,-4,2,0,0,-1,-1,-1,-1,-1,5,-1
KR_6610491517,420,-3,-25,-24,1,-2,2,0,-2,4,2,2,1,3,2,1,3,1,2,3,0,2,-125,-6,-2,8,1,0,-2,0,-1,-1,1,0,-1
KR_6697717264,440,-2,-52,2,-1,5,1,6,0,1,1,0,0,0,-5,5,0,-1,6,5,0,-5,4,1,-4,3,0,0,-1,-1,1,1,1,2,-1
KR_6738424201,440,-1,-12,21,-9,-2,3,1,1,2,3,-4,4,0,-3,3,0,-1,4,3,0,-18,-111,-5,0,5,-3,0,-1,-1,1,-1,1,5,-1
KR_6493357592,420,-5,-111,2,-14,-3,4,1,-1,6,5,-3,3,0,-6,6,0,-1,1,0,0,-7,-4,-6,0,6,0,0,-2,1,-1,-1,1,6,-1
KR_6757480480,420,-5,-48,-48,-12,1,1,2,-5,5,0,-3,3,0,-3,3,0,-2,5,3,0,-10,-9,1,-2,1,0,0,-1,0,-1,-1,-1,0,-1
KR_6625523202,420,-3,-6,8,-2,-2,3,1,2,1,3,-1,2,1,-1,3,2,0,1,1,0,-2,23,2,-5,3,0,0,1,-1,1,1,1,2,-1
KR_6759819926,440,-2,-29,0,-5,-2,4,2,-5,6,1,0,3,3,3,2,5,-1,1,0,0,-5,11,-1,-4,5,0,0,-1,0,-1,-1,1,0,-1
KR_6726827262,440,0,21,-12,-8,-3,3,0,1,2,3,-9,11,2,1,2,3,2,0,2,0,-12,-69,-2,-2,4,1,0,-1,-1,-1,-1,-1,5,-1
KR_6757439167,420,-2,-26,-31,0,1,2,3,-1,1,0,-2,2,0,-1,2,1,3,0,3,0,1,-1,-2,-2,4,1,0,-2,-1,-1,-1,1,6,-1
KR_6748456058,420,-2,-30,-12,-8,-2,2,0,-2,3,1,-3,4,1,-2,2,0,1,0,1,-1,-5,0,0,-4,4,3,0,0,-1,0,0,-1,2,-1
KR_6384448493,420,-4,-54,-3,-14,-3,4,1,-2,4,2,-4,4,0,-4,4,0,-1,1,0,0,-16,17,1,-6,5,-9,0,0,-1,1,1,-1,1,-1
KR_6736732674,420,-7,-81,-35,-10,1,1,2,0,2,2,-4,4,0,-1,3,2,-6,6,0,-1,-11,-257,-1,-6,7,-1,0,-3,-1,-1,-1,-1,3,-1
KR_6749964228,420,-2,17,-18,6,1,1,2,1,2,3,1,3,4,2,2,4,1,0,1,0,3,4,5,-5,0,-1,0,1,1,-1,1,1,1,-1
KR_6764702143,420,2,41,-2,1,2,0,2,-4,6,2,0,0,0,2,1,3,1,0,1,0,1,160,3,-7,4,2,0,0,-1,-1,1,1,1,-1
KR_6755855927,420,-4,-49,-19,-7,3,2,5,-5,6,1,-1,3,2,-3,3,0,-1,1,0,0,-8,-2,1,-2,1,2,0,0,-1,-1,-1,-1,4,-1
KR_6751024089,440,2,18,0,4,-2,2,0,5,2,7,0,4,4,1,1,2,0,5,5,0,2,240,-2,0,2,-1,0,1,1,0,1,-1,4,-1
KR_6753562789,420,-5,-103,-23,-10,2,0,2,2,0,2,-2,3,1,-13,14,1,1,0,1,-1,-6,-1,3,-6,3,-1,0,0,1,-1,-1,-1,1,-1
KR_6762089934,420,1,-41,8,-3,1,0,1,1,2,3,-3,4,1,-3,3,0,1,1,2,0,0,14,4,-6,2,-2,0,0,-1,1,0,-1,3,-1
KR_6761406548,420,-1,-77,-24,-3,0,1,1,-1,4,3,0,3,3,-3,6,3,1,1,2,0,-4,-149,3,-5,2,9,0,-1,1,-1,-1,1,2,-1
KR_6763900444,420,-1,2,-44,4,-3,6,3,0,1,1,-1,1,0,8,0,8,0,1,1,0,6,-2,-2,-3,5,2,0,0,1,-1,1,-1,2,-1
KR_6652390085,420,-1,-21,-16,-4,-6,6,0,3,0,3,-1,1,0,0,3,3,0,3,3,0,-2,4,3,-5,2,-5,0,-1,1,-1,-1,1,3,-1
KR_6655090274,420,-1,-15,0,-1,3,0,3,0,4,4,-4,5,1,1,6,7,-1,2,1,0,-7,-8,-6,0,6,0,0,0,-1,1,1,1,2,-1
KR_6659032161,420,-3,-59,-13,-4,0,4,4,-4,5,1,2,6,8,-3,5,2,1,0,1,0,3,3,-4,-1,5,1,0,-1,0,-1,-1,1,0,-1
KR_6663679778,440,-5,-8,2,-15,0,2,2,-5,7,2,-3,5,2,-6,10,4,-1,2,1,0,-16,-3,0,-3,3,-3,0,-1,-1,-1,-1,-1,5,-1
KR_6743399721,420,-1,-36,-4,-9,2,0,2,3,2,5,-11,13,2,-2,3,1,-1,3,2,0,-5,0,-1,-2,3,0,0,-2,-1,-1,-1,-1,5,-1
KR_6634370216,420,-6,-52,-28,-5,-1,1,0,-6,6,0,-2,7,5,3,0,3,1,1,2,0,-6,-18,-6,-1,7,1,0,-2,-1,-1,-1,1,5,-1
KR_6759347583,420,-4,-10,8,-7,-3,3,0,-2,3,1,3,0,3,-5,5,0,0,0,0,0,-12,2,3,-5,2,-1,0,0,-1,1,0,-1,4,-1
KR_6760925454,420,-1,-23,-4,-5,-2,3,1,0,4,4,-3,3,0,-1,5,4,1,0,1,0,-9,-11,-4,-3,7,1,0,-1,-1,1,-1,1,1,-1
KR_6758828795,420,0,-42,-24,1,0,1,1,-1,5,4,0,2,2,0,0,0,2,1,3,0,-1,119,2,-4,2,0,0,0,-1,-1,0,1,2,-1
KR_6709619920,420,-6,-36,-32,-15,-1,3,2,-9,11,2,-1,1,0,-3,7,4,-1,2,1,-1,-14,-3,-6,-2,8,-1,0,-2,-1,-1,-1,-1,3,-1
KR_6763435155,420,-1,-13,19,-5,-1,1,0,-8,9,1,3,1,4,1,2,3,0,1,1,0,-10,-5,-5,-7,12,5,0,-1,1,-1,1,-1,2,-1
KR_6272231900,420,-1,13,18,-7,-2,5,3,-2,4,2,-2,4,2,-3,3,0,2,0,2,1,-13,10,1,-8,7,-4,0,0,-1,1,1,1,2,-1
KR_6724728650,420,-3,-38,-40,-8,-4,4,0,-2,5,3,-2,2,0,2,2,4,-2,4,2,0,-2,-267,2,-4,2,-5,0,0,-1,0,0,-1,4,-1
KR_6741809307,420,0,101,3,-6,-4,4,0,-2,4,2,-5,5,0,3,0,3,2,1,3,1,1,1,0,-3,3,0,0,1,1,-1,1,1,1,-1
KR_6613878033,420,-2,-7,-8,-3,1,1,2,2,2,4,0,2,2,-4,5,1,-2,2,0,0,-14,-6,1,-5,4,-2,0,-1,-1,-1,-1,-1,3,-1
KR_6764329566,420,1,-11,16,2,-2,3,1,4,2,6,1,1,2,-4,4,0,3,1,4,0,5,-4,2,-6,4,0,0,0,-1,0,0,-1,6,-1
KR_6755511857,420,-1,-27,3,-7,-2,4,2,-7,7,0,6,1,7,-3,3,0,-1,2,1,0,-14,8,-3,-2,5,1,0,-1,-1,0,-1,1,1,-1
KR_6684309857,420,-5,-80,-24,-16,0,3,3,-3,6,3,-7,7,0,-3,8,5,-3,4,1,0,-7,15,-5,-2,7,2,0,-2,-1,-1,-1,-1,2,-1
KR_6760846524,420,0,15,12,-1,-2,3,1,-4,6,2,0,1,1,3,2,5,2,3,5,0,-1,1,-6,-1,7,-1,0,0,-1,-1,0,-1,4,-1
KR_6752026128,440,-2,-30,-28,-1,-5,5,0,1,3,4,-2,2,0,3,1,4,2,1,3,0,10,-3,1,-7,6,0,0,0,-1,0,0,1,3,-1
KR_6755671213,420,-5,-72,-16,-11,-1,2,1,-2,6,4,-5,6,1,-3,5,2,0,0,0,-1,-12,-11,-3,-3,6,0,0,0,0,0,0,-1,0,-1
KR_6712908017,440,-3,15,-4,-4,-2,3,1,-1,4,3,1,1,2,-2,4,2,0,1,1,1,-7,7,5,-8,3,-3,0,1,-1,1,1,1,4,-1
KR_6753654403,420,2,1,-8,8,5,0,5,1,2,3,-2,2,0,2,1,3,2,0,2,0,3,36,-1,-4,5,6,0,1,-1,1,1,1,3,-1
KR_6709585826,420,-3,-13,-10,-12,-4,4,0,-2,3,1,0,5,5,-5,6,1,-1,1,0,0,-20,-3,-7,-1,8,-2,0,-2,1,-1,-1,-1,6,-1
KR_6689432142,420,2,52,-24,-3,-3,3,0,0,0,0,-2,4,2,1,0,1,1,0,1,0,1,-98,4,-4,0,-2,0,0,0,-1,0,-1,0,-1
KR_6732945805,420,-3,-12,-37,-6,0,2,2,-5,9,4,-1,4,3,-2,4,2,2,0,2,0,-10,-8,-5,-1,6,1,0,0,-1,-1,-1,-1,2,-1
KR_6755267084,420,-1,-13,-24,1,1,2,3,-4,5,1,1,5,6,3,1,4,0,0,0,0,5,239,0,-5,5,-1,0,0,-1,1,-1,1,5,-1
KR_6688912766,420,-3,-65,-25,-3,0,0,0,0,4,4,-5,5,0,2,1,3,0,1,1,0,-1,-8,-8,-1,9,4,0,0,1,-1,-1,1,3,-1
KR_6668785285,420,-4,-138,11,-7,-3,4,1,-1,3,2,-2,3,1,0,3,3,-1,3,2,0,-1,-9,1,-2,1,-5,0,-1,1,0,-1,-1,2,-1
KR_6763570629,420,-1,-88,-13,3,0,2,2,5,2,7,0,3,3,-3,4,1,1,0,1,1,0,-80,-1,-3,4,-2,0,-2,1,-1,-1,1,1,-1
KR_6762719483,420,-7,-94,-20,-6,-1,1,0,3,1,4,0,3,3,-7,7,0,-1,2,1,0,-2,-121,-1,-4,5,-4,0,-2,-1,-1,-1,-1,3,-1
KR_6691912510,420,-2,-1,-7,-11,0,1,1,-2,3,1,-4,4,0,-3,5,2,-2,2,0,0,-6,-363,-2,-3,5,0,0,0,-1,1,0,-1,6,-1
KR_6756336751,420,-2,-44,1,-9,-2,2,0,3,1,4,-3,3,0,-7,9,2,0,0,0,0,-4,-16,-1,-3,4,1,0,-3,1,-1,-1,-1,3,-1
KR_6750740125,420,-2,-31,-4,-6,-2,2,0,-1,2,1,0,5,5,-2,5,3,-1,1,0,0,-4,-34,3,-4,1,21,0,0,-1,0,-1,-1,5,-1
KR_6761611724,440,-3,39,-18,-4,3,1,4,-2,3,1,-6,9,3,2,0,2,-1,4,3,0,-7,1,3,-5,2,0,0,-1,-1,-1,-1,1,2,-1
KR_6763835605,440,0,-21,-6,-1,0,1,1,-5,6,1,2,1,3,4,5,9,-2,2,0,0,7,8,-4,-4,8,0,0,0,-1,-1,-1,-1,2,-1
KR_6754986714,420,-3,8,-8,-4,0,3,3,0,2,2,-4,5,1,1,2,3,-1,2,1,0,-7,-1,2,-5,3,-1,0,-2,1,1,-1,1,6,-1
KR_6761411591,420,-2,-161,4,0,-2,2,0,0,5,5,1,1,2,0,0,0,1,0,1,0,4,-19,-3,-5,8,-1,0,-1,1,1,-1,-1,6,-1
KR_6726927654,420,0,-55,-27,-6,-3,3,0,-1,3,2,-1,2,1,-6,7,1,5,0,5,0,-3,12,-4,-3,7,-2,0,0,-1,-1,-1,-1,5,-1
KR_6587516539,420,-1,-59,20,-7,-4,4,0,-4,7,3,0,3,3,1,1,2,0,1,1,0,-2,0,1,-6,5,0,0,-1,1,-1,-1,-1,1,-1
KR_6688645998,420,-4,-10,-32,-11,-3,3,0,-1,2,1,3,0,3,-9,9,0,-1,1,0,0,-4,-155,-4,-2,6,19,0,-2,-1,1,-1,1,2,-1
KR_6737897762,420,-4,-64,21,-14,-5,5,0,-5,5,0,-1,4,3,-3,7,4,0,1,1,0,-11,18,1,-3,2,-1,0,-2,-1,-1,-1,1,5,-1
KR_6715963910,420,-3,-73,-20,-17,0,2,2,-6,7,1,-2,2,0,-8,8,0,-1,1,0,0,-26,-31,-2,-3,5,7,0,-2,-1,-1,-1,-1,5,-1
KR_6704339961,420,-5,-61,-12,-15,-1,2,1,-4,5,1,-1,4,3,-7,7,0,-2,2,0,-3,-24,-14,-3,-4,7,-1,0,-1,-1,-1,-1,-1,6,-1
KR_6764774823,420,-3,-29,-15,2,-3,4,1,0,3,3,-2,4,2,9,1,10,-2,2,0,0,8,-3,2,-8,6,-4,0,-1,-1,1,-1,1,2,-1
KR_6638532236,420,-5,-74,-12,-9,0,3,3,-2,4,2,-8,12,4,0,2,2,1,0,1,0,-4,0,-3,-2,5,-4,0,-3,-1,-1,-1,-1,4,-1
KR_6764063624,420,-3,-69,-15,-7,-6,6,0,2,2,4,1,1,2,-2,4,2,-2,5,3,0,-1,12,-1,-5,6,0,0,-1,-1,-1,-1,-1,1,-1
KR_6750984723,420,-3,19,0,-10,-1,3,2,3,0,3,-6,6,0,-6,6,0,0,0,0,0,-12,17,2,-6,4,0,0,0,1,1,0,-1,5,-1
KR_6716706558,420,-4,-69,-10,-11,-8,9,1,-2,4,2,2,1,3,-3,4,1,0,2,2,0,-3,0,5,-10,5,-4,0,-3,0,-1,-1,-1,0,-1
KR_6727899473,420,-4,-64,-15,-8,-2,4,2,-1,1,0,1,5,6,-6,8,2,0,2,2,-1,-9,2,-2,-1,3,1,0,-1,0,1,-1,-1,0,-1
KR_6682796697,420,-1,-15,-62,0,3,2,5,0,5,5,2,1,3,-3,5,2,-2,5,3,-1,-6,-251,3,-5,2,-3,0,0,-1,-1,-1,-1,3,-1
KR_6750114456,420,-1,-6,-8,-3,1,0,1,-8,9,1,3,0,3,0,1,1,1,0,1,0,-9,1,-1,-5,6,2,0,0,0,0,0,1,0,-1
KR_6751425356,420,-2,-60,-13,-6,-1,2,1,2,3,5,-4,4,0,-4,6,2,1,1,2,1,0,-251,1,-5,4,-4,0,0,-1,-1,-1,1,6,-1
KR_6757910760,420,-2,-71,-16,-5,-1,3,2,0,0,0,-4,5,1,0,4,4,0,2,2,-2,0,4,-1,-3,4,-1,0,-1,-1,-1,-1,-1,6,-1
KR_6764613289,420,-1,11,-36,-4,3,0,3,-3,3,0,-2,4,2,-2,3,1,0,1,1,-1,-5,-10,-2,-1,3,2,0,-1,-1,-1,-1,-1,5,-1
KR_6739956991,440,4,-55,-18,2,2,0,2,4,1,5,-6,6,0,1,1,2,1,1,2,1,6,-55,-4,-3,7,28,0,0,-1,-1,-1,1,2,-1
KR_6667190027,420,1,-43,-4,-2,-3,3,0,-3,3,0,2,1,3,1,1,2,1,1,2,0,1,0,1,-4,3,3,0,0,1,-1,0,-1,6,-1
KR_6749624861,440,-4,13,-19,-9,-3,6,3,1,2,3,1,2,3,-6,6,0,-2,2,0,-1,-1,6,7,-10,3,1,0,0,-1,-1,0,-1,2,-1
KR_6749060134,420,-2,-10,-31,-2,0,0,0,-5,6,1,-3,3,0,7,1,8,-1,2,1,0,5,6,3,-5,2,-3,0,-1,0,-1,-1,-1,0,-1
KR_6731507684,420,-2,-18,-12,6,2,2,4,2,0,2,1,1,2,3,0,3,-2,2,0,0,2,-39,2,-5,3,3,0,0,1,1,0,1,5,-1
KR_6760223471,420,-5,-110,-26,-17,-2,2,0,-5,7,2,-4,5,1,-1,2,1,-5,5,0,0,-11,-5,0,-4,4,-8,0,-3,-1,-1,-1,-1,2,-1
KR_6763101155,420,-1,-37,-15,1,-1,4,3,-1,3,2,1,1,2,0,0,0,2,1,3,1,8,-50,-1,-4,5,24,0,-1,-1,-1,-1,1,6,-1
KR_6734069658,420,0,21,-14,-7,-4,5,1,-2,4,2,1,1,2,0,1,1,-2,2,0,0,-5,-37,4,-5,1,-2,0,0,1,-1,0,-1,1,-1
KR_6764590640,420,1,-16,1,-2,0,0,0,-5,6,1,1,2,3,3,0,3,-1,2,1,0,-1,-51,1,-3,2,2,0,0,1,-1,0,-1,1,-1
KR_6757492829,420,-5,-1,-22,-10,-2,5,3,3,1,4,-5,5,0,-3,6,3,-3,3,0,-1,-13,237,3,-4,1,0,0,0,0,-1,-1,-1,0,-1
KR_6726514900,420,-2,-24,0,-5,-4,5,1,1,4,5,-4,5,1,1,2,3,1,1,2,-1,-1,17,3,-3,0,-2,0,-1,1,-1,-1,-1,4,-1
KR_6756625935,420,0,15,12,-3,8,0,8,1,1,2,-3,5,2,-6,7,1,-3,3,0,0,-11,-8,0,-2,2,-1,0,0,-1,0,-1,1,6,-1
KR_6763586260,420,0,-4,48,3,-3,5,2,4,1,5,-2,2,0,2,0,2,2,2,4,0,5,-4,-3,-2,5,1,0,0,-1,-1,0,1,1,-1
KR_5987072368,420,1,46,-36,5,4,1,5,1,4,5,-4,4,0,4,0,4,0,1,1,1,14,5,-2,-5,7,1,0,2,-1,1,1,1,4,-1
KR_6743664107,420,-2,-14,-36,-7,-3,3,0,-1,2,1,-4,5,1,1,4,5,0,3,3,0,-3,10,-2,-5,7,-3,0,0,-1,1,0,-1,4,-1
KR_6753692835,420,-2,25,-24,-4,-1,3,2,0,3,3,0,2,2,-1,1,0,-2,2,0,1,0,2,0,-4,4,-5,0,0,-1,-1,0,1,6,-1
KR_6758838738,420,0,91,-4,8,0,1,1,-1,1,0,4,1,5,4,0,4,1,0,1,0,11,-5,1,-5,4,3,0,1,1,-1,1,-1,1,-1
KR_5887280750,420,0,-25,1,2,-1,3,2,0,4,4,-3,4,1,5,4,9,1,1,2,0,4,-42,-7,-4,11,1,0,0,1,-1,-1,1,2,-1
KR_6513851533,420,0,-69,-16,-4,3,1,4,-1,2,1,-2,4,2,-2,3,1,-2,5,3,0,-1,5,0,-5,5,1,0,-1,-1,1,1,-1,4,-1
KR_6759741408,420,-4,35,-21,-5,-2,4,2,3,1,4,-4,6,2,0,1,1,-2,2,0,0,-2,-3,3,-4,1,-1,0,-2,-1,-1,-1,1,2,-1
KR_6727511994,420,-2,-18,-56,0,0,3,3,-4,6,2,2,1,3,3,0,3,-1,1,0,0,1,-30,-1,-4,5,16,0,-1,-1,1,-1,-1,2,-1
KR_6758572922,420,-3,-31,18,-6,-3,4,1,0,3,3,2,0,2,-2,2,0,-3,3,0,-1,-11,4,0,-5,5,-6,0,-1,1,1,-1,-1,2,-1
KR_6728525285,420,4,94,12,-1,5,0,5,-2,4,2,-2,2,0,-1,4,3,-1,1,0,0,-9,405,2,-4,2,-2,0,0,1,-1,0,-1,4,-1
KR_6755360121,420,-1,23,-4,-2,-2,4,2,3,2,5,2,3,5,-5,6,1,0,1,1,0,-8,4,0,-3,3,-1,0,1,1,1,1,1,5,-1
KR_6751541539,420,-3,-68,-16,-4,-3,4,1,2,4,6,0,2,2,-3,5,2,0,0,0,0,-2,-6,-7,-3,10,0,0,-1,-1,-1,-1,-1,3,-1
KR_6624310299,420,-2,-29,-16,-3,0,2,2,-2,3,1,0,3,3,-1,3,2,0,0,0,-1,-3,9,2,-6,4,-9,0,0,-1,0,0,-1,5,-1
KR_6599373095,420,-2,-38,-28,-1,-2,4,2,-1,5,4,0,1,1,0,1,1,2,0,2,1,-3,-25,-1,-5,6,4,0,-1,-1,1,-1,1,1,-1
KR_6739903686,420,-3,13,-8,-2,-2,3,1,0,2,2,-3,5,2,2,1,3,1,0,1,0,-3,3,2,-8,6,-2,0,0,-1,1,0,-1,5,-1
KR_6666502569,420,-1,-113,-11,-7,-5,5,0,-1,2,1,-2,3,1,1,2,3,0,0,0,0,-4,-152,-2,-4,6,5,0,-1,-1,-1,-1,-1,3,-1
KR_6757774387,420,-3,-44,-59,-4,0,1,1,-4,4,0,-5,7,2,3,0,3,2,0,2,0,-1,-7,0,-4,4,14,0,-1,-1,-1,-1,-1,5,-1
KR_6764598910,420,-1,-28,0,-8,-3,3,0,-7,7,0,1,2,3,0,3,3,1,2,3,0,-11,9,-3,-3,6,1,0,0,1,1,1,-1,4,-1
KR_6764311370,420,0,10,-4,1,-2,2,0,3,2,5,-1,1,0,0,1,1,1,2,3,0,-1,-3,5,-7,2,2,0,1,1,0,1,1,4,-1
KR_6748986167,420,-2,7,8,-9,-1,3,2,-1,4,3,2,1,3,-7,9,2,-2,3,1,0,-6,-79,2,-5,3,-5,0,0,-1,-1,0,-1,3,-1
KR_6761483977,440,-2,30,8,-1,0,0,0,-3,3,0,2,1,3,-1,1,0,1,0,1,0,-1,-4,-4,-1,5,4,0,0,-1,1,0,1,2,-1
KR_6739564356,420,-1,-8,-4,-6,1,0,1,-3,3,0,-1,2,1,-3,4,1,0,1,1,-1,-8,-1,1,-4,3,3,0,-1,0,1,-1,-1,0,-1
KR_6630058374,420,3,-8,-28,1,-1,3,2,-6,6,0,6,0,6,1,3,4,1,0,1,-1,-5,0,1,-6,5,-1,0,0,-1,1,0,-1,3,-1
KR_6636445251,420,-1,-59,22,-3,4,0,4,-3,5,2,0,3,3,-4,5,1,0,0,0,0,-12,-6,2,-9,7,-4,0,1,-1,1,1,-1,6,-1
KR_6659395539,420,0,-91,6,2,-1,5,4,4,2,6,3,2,5,-5,5,0,1,0,1,0,10,-2,-2,-1,3,-3,0,-1,-1,1,-1,-1,3,-1
KR_6713099971,420,-4,-3,-5,-8,-1,4,3,-5,6,1,2,3,5,-3,6,3,-1,5,4,0,-13,-6,-1,-4,5,-1,0,-2,-1,-1,-1,1,1,-1
KR_6684197148,440,-6,-86,16,-15,-3,4,1,1,0,1,-4,6,2,-8,8,0,-1,3,2,0,-17,-2,-5,0,5,0,0,-1,-1,-1,-1,-1,4,-1
KR_6764199001,420,-1,-50,9,-3,2,2,4,3,2,5,-2,3,1,-5,5,0,-1,2,1,0,-3,-40,-6,-2,8,2,0,0,1,0,-1,1,3,-1
KR_6734147817,440,-2,-46,-23,-4,1,1,2,0,3,3,1,3,4,-5,5,0,-1,2,1,0,-8,-40,3,-8,5,0,0,0,-1,-1,-1,1,2,-1
KR_6650156434,420,-6,-87,-19,-19,-6,7,1,-3,3,0,-6,7,1,-4,6,2,0,1,1,0,-13,248,-3,0,3,12,0,-3,-1,-1,-1,1,4,-1
KR_6640698199,420,-7,-58,-28,-15,-1,2,1,-2,2,0,-3,5,2,-7,8,1,-2,2,0,0,-9,6,4,-6,2,-2,0,0,-1,1,0,-1,4,-1
KR_6424646438,420,-2,-28,16,-5,1,0,1,1,3,4,-6,6,0,-2,7,5,1,0,1,2,0,0,-1,-6,7,0,0,-1,1,-1,-1,1,3,-1
KR_6752350113,420,-2,-13,-18,2,-1,2,1,2,5,7,1,2,3,1,0,1,-1,2,1,0,7,153,4,-5,1,0,0,0,0,-1,-1,-1,0,-1
KR_6736951073,420,-3,-13,-30,2,5,1,6,-1,3,2,-2,2,0,1,1,2,-1,1,0,1,-2,-21,1,-4,3,-1,0,1,-1,1,1,1,4,-1
KR_6762039908,420,-2,8,-11,-4,-5,5,0,-3,7,4,1,3,4,5,0,5,-2,2,0,0,9,-5,-5,0,5,0,0,-1,-1,1,-1,-1,3,-1
KR_6742148468,420,-2,-43,-39,-4,3,0,3,-5,9,4,-3,6,3,1,1,2,0,1,1,-2,3,0,0,-2,2,-2,0,0,-1,-1,-1,-1,1,-1
KR_6713798510,420,-5,-65,7,-14,-4,4,0,-2,3,1,0,1,1,-5,6,1,-3,3,0,-2,-16,0,-3,-2,5,1,0,-3,-1,-1,-1,-1,3,-1
KR_6657193948,420,-3,-52,-23,-3,0,0,0,-3,5,2,3,2,5,-4,5,1,1,0,1,0,-5,-7,-1,-3,4,-2,0,-1,0,0,-1,-1,0,-1
KR_6643175836,420,-2,-43,4,-7,-3,3,0,0,0,0,4,0,4,-8,10,2,0,1,1,0,-8,22,-3,-2,5,-3,0,0,-1,1,0,-1,4,-1
KR_6717373633,420,-5,-4,-16,-8,-1,1,0,3,3,6,-8,10,2,-1,4,3,-1,1,0,0,-9,-17,1,-4,3,-2,0,-2,-1,-1,-1,-1,6,-1
KR_6728638952,440,-1,31,-36,0,-2,3,1,0,2,2,-1,4,3,6,5,11,-3,5,2,0,7,53,1,-4,3,-27,0,0,0,-1,-1,1,0,-1
KR_6764137642,420,-1,1,-16,-6,1,2,3,-4,6,2,-2,5,3,3,1,4,-4,4,0,-1,-6,-12,-6,-6,12,3,0,0,-1,-1,0,-1,6,-1
KR_6763597778,420,-3,-22,4,-7,5,0,5,-6,6,0,-1,3,2,-4,6,2,-1,2,1,0,-12,0,-1,-4,5,-5,0,-1,-1,0,-1,1,3,-1
KR_6763619568,440,-1,-82,-19,-6,-5,5,0,-2,3,1,3,0,3,-1,5,4,-1,2,1,0,-1,109,4,-5,1,0,0,-1,-1,0,-1,-1,2,-1
KR_6741096871,420,-1,49,16,-8,4,0,4,-4,5,1,-1,5,4,-4,5,1,-3,3,0,0,-19,4,0,-4,4,1,0,1,1,-1,1,-1,3,-1
KR_6751401107,420,1,26,-8,3,-2,3,1,4,1,5,0,3,3,0,1,1,1,0,1,0,5,4,1,-7,6,-1,0,2,-1,1,1,-1,4,-1
KR_6738384299,440,-7,-84,-40,-12,0,4,4,-5,7,2,-4,5,1,-2,4,2,-1,1,0,0,-5,6,2,-5,3,0,0,0,-1,-1,0,-1,2,-1
KR_6712466302,420,-2,7,-4,3,-1,2,1,-5,12,7,2,2,4,7,2,9,0,1,1,-1,-4,-11,5,-9,4,2,0,0,0,1,0,1,0,-1
KR_6699331111,420,-3,34,-8,-7,2,1,3,0,2,2,-1,1,0,-8,10,2,0,0,0,1,-6,113,5,-7,2,-2,0,-1,-1,1,-1,-1,1,-1
KR_6614449180,420,2,36,12,6,-1,1,0,-3,4,1,6,1,7,3,1,4,1,0,1,0,5,237,1,-5,4,4,0,0,0,0,1,-1,0,-1
KR_6736511525,420,-5,-77,-36,-3,-4,5,1,6,0,6,-4,5,1,-1,4,3,0,2,2,1,6,-5,3,-4,1,0,0,-3,0,-1,-1,-1,0,-1
KR_6653770307,420,2,64,-20,1,-4,5,1,-3,4,1,3,2,5,3,1,4,2,1,3,-1,0,-5,-4,0,4,3,0,-1,-1,0,-1,-1,5,-1
KR_6646216407,420,2,24,-29,2,1,1,2,0,3,3,-2,5,3,2,1,3,1,0,1,1,6,-5,-4,-2,6,3,0,1,-1,-1,1,1,6,-1
KR_6754745819,420,0,37,32,0,0,1,1,0,1,1,-3,4,1,2,2,4,1,0,1,0,-7,-6,-3,-4,7,2,0,2,0,-1,1,1,0,-1
KR_6752587622,420,-6,-6,-48,-15,-5,5,0,-3,4,1,-2,5,3,-5,6,1,0,0,0,-1,-23,2,-1,-4,5,0,0,-1,0,0,-1,-1,0,-1
KR_6699257737,420,-5,-96,-32,-15,-2,3,1,-1,1,0,-1,1,0,-6,6,0,-5,6,1,-1,-10,-10,-5,-1,6,3,0,-3,1,-1,-1,-1,1,-1
KR_6693660254,440,-7,-80,-25,-18,0,3,3,-4,5,1,0,1,1,-10,11,1,-4,5,1,-2,-18,-46,-2,-1,3,0,0,-1,-1,1,-1,-1,6,-1
KR_6436407563,420,-3,-43,-28,-9,-3,4,1,-3,7,4,-3,3,0,-1,6,5,1,0,1,0,-18,-6,-1,-6,7,-3,0,-2,-1,-1,-1,-1,2,-1
KR_6708394973,420,-2,-72,-5,-3,3,2,5,0,1,1,-4,5,1,-2,6,4,0,2,2,0,-9,-127,2,-5,3,-3,0,0,1,0,0,-1,2,-1
KR_6667840989,420,-1,0,-20,-1,-4,4,0,-5,6,1,-1,1,0,6,0,6,3,1,4,0,5,-4,1,-4,3,3,0,1,0,1,-1,1,0,-1
KR_6644639198,420,-2,2,-12,-3,1,0,1,4,1,5,-2,4,2,1,1,2,-7,7,0,0,-4,31,6,-6,0,-5,0,0,-1,-1,0,1,3,-1
KR_6695415709,420,-5,-73,-4,-18,1,1,2,-3,6,3,-5,5,0,-5,5,0,-6,9,3,-3,-19,-14,-2,0,2,0,0,-3,-1,-1,-1,1,5,-1
KR_6709815832,420,-4,-3,-34,-3,0,0,0,6,3,9,-10,10,0,-1,4,3,2,1,3,0,-4,-81,-3,-3,6,3,0,-2,-1,-1,-1,1,6,-1
KR_6614973440,420,-1,-73,4,-3,2,2,4,-1,3,2,-1,2,1,-4,5,1,1,0,1,0,-4,15,-4,-1,5,-2,0,-1,-1,-1,-1,1,6,-1
KR_6713368230,420,-1,28,-44,1,-2,4,2,-3,4,1,1,1,2,5,0,5,0,1,1,1,14,0,3,-7,4,2,0,1,-1,-1,-1,1,3,-1
KR_6760033078,420,-1,-11,-9,-3,1,1,2,-4,5,1,2,4,6,4,1,5,-6,6,0,1,-5,67,0,-2,2,2,0,0,1,1,0,1,3,-1
KR_6745672223,440,-2,-45,17,-11,-1,1,0,-2,4,2,-2,4,2,-3,3,0,-3,5,2,-1,-14,4,0,-3,3,-2,0,-1,-1,-1,-1,-1,4,-1
KR_6689223529,440,-3,-71,-28,-4,0,1,1,0,2,2,-1,2,1,0,2,2,-3,3,0,0,-2,0,-2,-2,4,-3,0,-2,-1,-1,-1,-1,6,-1
KR_6727375447,420,-8,-84,-36,-25,-5,5,0,-3,5,2,-8,8,0,-7,7,0,-2,3,1,-1,-21,-3,-1,-4,5,-3,0,-4,1,-1,-1,-1,6,-1
KR_6712956412,420,-6,-100,4,-19,-5,5,0,-8,10,2,-1,3,2,-3,6,3,-2,3,1,-2,-13,26,3,-6,3,1,0,-3,-1,-1,-1,-1,5,-1
KR_6757575497,420,-8,-102,-29,-14,-8,8,0,-4,4,0,-4,4,0,3,0,3,-1,3,2,0,0,134,0,-3,3,2,0,0,0,-1,-1,-1,0,-1
KR_6699947224,440,0,-19,17,0,2,1,3,0,6,6,1,1,2,-1,6,5,-2,2,0,0,3,25,0,-6,6,-6,0,-1,-1,1,-1,-1,4,-1
KR_6678596866,420,-4,-69,20,-6,-3,3,0,1,1,2,-6,6,0,2,3,5,0,1,1,0,-2,-5,-1,-2,3,-1,0,-1,1,-1,-1,-1,4,-1
KR_6752441332,420,-1,7,-8,6,4,3,7,-3,4,1,1,1,2,2,2,4,2,2,4,1,5,-8,1,-6,5,-2,0,0,0,1,0,1,0,-1
KR_6631665177,420,0,43,13,-2,1,1,2,-5,6,1,2,0,2,1,5,6,-1,1,0,0,-4,33,-2,-4,6,-30,0,0,1,1,0,-1,1,-1
KR_6761801828,420,-2,35,5,1,-6,10,4,3,1,4,-2,5,3,3,4,7,3,0,3,3,11,4,2,-7,5,1,0,0,1,1,0,1,5,-1
KR_6755643939,440,-1,-62,-24,2,4,0,4,0,2,2,-4,5,1,2,0,2,0,0,0,0,5,-7,4,-5,1,-5,0,0,-1,1,-1,1,6,-1
KR_6692123200,420,-4,-50,-24,-13,-4,5,1,-3,3,0,2,2,4,-8,8,0,0,0,0,0,-16,-194,-5,0,5,0,0,0,-1,-1,-1,-1,4,-1
KR_6734851846,420,-2,24,-4,-6,3,2,5,-1,1,0,-5,5,0,-2,3,1,-1,1,0,0,-11,-2,2,-6,4,-1,0,-1,-1,1,-1,-1,4,-1
KR_6640871176,420,1,-87,11,-3,-2,5,3,1,3,4,-11,12,1,7,0,7,2,0,2,-1,8,5,5,-7,2,-5,0,0,1,0,-1,-1,5,-1
KR_6760883874,420,1,8,-4,2,0,2,2,0,2,2,1,2,3,2,1,3,-1,1,0,0,2,5,2,-5,3,-1,0,1,1,1,1,1,1,-1
KR_6722864313,420,-6,-9,-44,-9,1,1,2,-1,4,3,-1,2,1,-6,7,1,-2,3,1,0,-3,-2,-4,-3,7,-1,0,0,1,-1,-1,-1,6,-1
KR_6735154713,420,4,17,-4,3,0,3,3,2,2,4,2,0,2,1,5,6,-2,2,0,-2,-6,-26,-3,-3,6,-1,0,0,1,1,0,-1,3,-1
KR_6459912044,440,0,5,13,-11,-7,9,2,6,0,6,-8,9,1,-3,3,0,1,3,4,-1,-8,-52,-2,-2,4,11,0,-1,1,-1,-1,-1,6,-1
KR_6602527828,420,2,-14,-5,5,7,0,7,0,4,4,0,1,1,-2,7,5,0,1,1,0,4,-8,2,-9,7,5,0,1,1,-1,1,-1,4,-1
KR_6748906023,420,-5,-40,-3,-18,-8,8,0,-3,5,2,-5,6,1,-2,4,2,0,0,0,0,-11,-7,-2,-4,6,0,0,-1,1,-1,-1,1,3,-1
KR_6618374490,420,-4,-82,4,-11,-2,2,0,-1,4,3,0,3,3,-5,7,2,-3,3,0,0,-5,-5,-3,-2,5,-3,0,-1,-1,1,-1,1,3,-1
KR_6716573629,420,-3,-39,-7,-9,1,1,2,-3,5,2,-3,5,2,-3,4,1,-1,2,1,-1,-8,-7,-2,-4,6,0,0,-2,0,-1,-1,-1,0,-1
KR_6763653914,440,-4,-102,-28,-7,-2,2,0,-5,5,0,2,0,2,2,0,2,-4,4,0,-1,-4,28,-5,-5,10,-1,0,-1,-1,-1,-1,-1,3,-1
KR_6711326489,420,1,50,0,2,2,0,2,-2,5,3,0,4,4,-2,3,1,4,0,4,0,7,3,1,-5,4,-2,0,0,-1,-1,1,1,1,-1
KR_6733734071,420,-3,30,-17,-3,1,1,2,-5,8,3,-2,5,3,-1,2,1,4,1,5,1,2,15,-3,-2,5,1,0,-1,0,0,-1,1,0,-1
KR_6744172710,420,-9,-153,-29,-24,-9,9,0,3,0,3,-9,14,5,-5,5,0,-4,4,0,0,-7,0,-6,-3,9,-5,0,-3,-1,-1,-1,1,5,-1
KR_6672529879,420,-1,29,-4,-2,-1,2,1,-2,5,3,0,3,3,0,3,3,1,0,1,0,1,4,-5,-2,7,3,0,1,-1,-1,1,-1,5,-1
KR_6639265729,420,-4,-65,0,-7,-4,5,1,0,1,1,-1,3,2,-1,4,3,-1,1,0,0,-9,8,1,-4,3,0,0,0,0,1,0,1,0,-1
KR_6763549770,420,-1,-16,-48,-4,1,1,2,-3,3,0,0,3,3,-3,6,3,1,0,1,-1,-14,-2,2,-6,4,1,0,-1,1,-1,-1,-1,2,-1
KR_6753586634,420,1,-21,8,-2,-1,4,3,2,1,3,-4,4,0,1,5,6,0,0,0,-1,-1,-17,-3,-4,7,-1,0,-1,0,-1,-1,-1,0,-1
KR_6764368422,420,-1,-106,10,-5,-1,1,0,1,3,4,0,3,3,-5,5,0,0,1,1,0,-6,13,2,-6,4,-4,0,-1,-1,-1,-1,-1,1,-1
KR_6676279772,420,-12,-175,-5,-30,-5,5,0,-5,6,1,-9,10,1,-8,9,1,-3,4,1,0,-20,-9,-1,-1,2,-3,0,-2,-1,1,-1,-1,5,-1
KR_6750643693,420,-5,-50,-4,-12,-2,2,0,-3,3,0,0,1,1,-5,6,1,-2,3,1,0,-15,-4,-3,-2,5,-2,0,-2,-1,1,-1,1,2,-1
KR_6760650281,420,0,-2,5,1,-1,3,2,-1,4,3,1,2,3,0,3,3,2,0,2,0,5,-401,-6,-2,8,-1,0,-1,1,-1,-1,1,4,-1
KR_6749193316,440,3,-11,-7,9,6,1,7,0,5,5,1,0,1,1,0,1,1,0,1,2,24,-12,2,-9,7,4,0,0,0,1,-1,1,0,-1
KR_6682683874,420,-1,48,-15,-9,0,3,3,-1,2,1,-6,6,0,-1,2,1,-1,1,0,-1,-13,11,2,-6,4,3,0,0,-1,-1,0,-1,4,-1
KR_6754128678,420,-3,-30,-2,-3,0,2,2,-2,5,3,1,0,1,0,0,0,-2,2,0,0,-8,-189,3,-7,4,-1,0,-1,1,-1,-1,1,2,-1
KR_6730598036,420,-4,-111,-8,-4,0,0,0,1,3,4,-4,4,0,0,3,3,-1,2,1,0,-3,-24,1,-3,2,-1,0,-2,-1,-1,-1,1,4,-1
KR_6717763559,420,1,9,28,3,-2,3,1,6,1,7,-1,2,1,-2,2,0,2,1,3,0,8,6,2,-4,2,-4,0,0,1,-1,0,-1,6,-1
KR_6742775593,420,1,24,-12,-3,-5,6,1,2,0,2,0,5,5,-1,2,1,1,1,2,-1,2,-21,0,-6,6,2,0,0,-1,-1,-1,-1,5,-1
KR_6761892610,420,0,-11,12,-4,1,1,2,-2,4,2,-3,3,0,2,2,4,-2,3,1,0,-5,8,4,-7,3,-1,0,0,1,1,1,1,6,-1
KR_6754101383,420,-3,-15,-32,-7,2,0,2,-5,6,1,-3,3,0,-1,3,2,0,0,0,0,-7,-28,0,-3,3,0,0,0,1,-1,0,-1,1,-1
KR_6761026195,420,-4,7,-16,-7,-2,3,1,0,1,1,-6,6,0,0,0,0,1,0,1,0,0,4,-1,-2,3,7,0,-1,-1,0,-1,1,4,-1
KR_6704552005,440,-4,6,-24,-9,-1,3,2,-4,6,2,-4,7,3,-1,2,1,1,0,1,0,-12,23,4,-5,1,-2,0,-1,-1,-1,-1,-1,5,-1
KR_6751954864,440,3,45,-12,11,0,1,1,4,2,6,1,0,1,5,2,7,1,0,1,3,19,5,1,-5,4,2,0,1,-1,-1,1,1,2,-1
KR_6584121521,420,-1,-29,13,3,-5,5,0,0,0,0,4,0,4,2,0,2,2,2,4,0,9,-7,7,-9,2,5,0,0,1,-1,0,-1,1,-1
KR_6761834822,420,-2,-18,-36,-10,-5,5,0,-5,9,4,2,1,3,-1,3,2,-1,2,1,0,-12,33,-1,-3,4,-8,0,-1,1,-1,-1,1,2,-1
KR_6708881923,440,2,22,0,-3,1,2,3,-1,1,0,-2,4,2,0,3,3,-1,1,0,0,-8,165,3,-6,3,-1,0,1,1,1,1,-1,4,-1
KR_6655560479,420,-2,-8,-15,0,-1,1,0,1,2,3,0,1,1,-1,1,0,1,0,1,0,2,7,6,-8,2,-4,0,-1,-1,-1,-1,1,4,-1
KR_6588862056,420,-3,-40,10,-3,1,0,1,0,1,1,-2,3,1,-2,4,2,0,4,4,2,-3,-4,-3,-2,5,0,0,-1,-1,0,-1,1,6,-1
KR_6751312561,420,-1,-21,-3,-6,1,3,4,-5,8,3,0,2,2,-1,4,3,-1,2,1,0,-12,16,-1,-3,4,3,0,-1,-1,-1,-1,1,3,-1
KR_6764344421,420,3,89,12,5,-3,3,0,0,1,1,3,1,4,3,3,6,2,1,3,0,7,15,-6,-5,11,2,0,1,0,-1,1,1,0,-1
KR_6761583848,440,-3,5,-7,-7,-1,3,2,0,2,2,-3,3,0,1,3,4,-4,5,1,0,-9,221,0,-3,3,-5,0,-1,1,-1,-1,1,4,-1
KR_6757825471,420,1,38,4,1,0,3,3,1,0,1,0,1,1,0,4,4,0,0,0,0,4,17,3,-5,2,-4,0,1,0,1,1,-1,0,-1
KR_6647127600,420,-4,49,14,-11,-2,2,0,-2,4,2,0,2,2,-5,7,2,-2,2,0,0,-9,-2,2,-5,3,-2,0,-1,-1,-1,-1,-1,3,-1
KR_6712363498,420,-2,-18,3,-2,5,1,6,-6,6,0,0,2,2,-1,4,3,0,2,2,1,0,-8,4,-6,2,-1,0,0,-1,0,-1,1,5,-1
KR_6635731375,420,-1,-58,-22,1,-3,3,0,5,8,13,-4,5,1,2,0,2,1,1,2,0,3,-4,-1,-2,3,1,0,-2,1,1,-1,-1,5,-1
KR_6747685648,420,0,29,-12,0,0,1,1,-1,2,1,1,3,4,0,4,4,0,0,0,0,-2,7,1,-4,3,-7,0,0,1,-1,0,1,1,-1
KR_6584208412,420,-3,27,-40,-4,-2,3,1,-2,4,2,-1,3,2,-1,1,0,2,0,2,0,-4,5,-1,-2,3,-1,0,-1,-1,-1,-1,-1,1,-1
KR_6744570845,440,-5,-53,-21,-3,3,2,5,-2,6,4,-2,2,0,-3,4,1,1,1,2,1,4,0,-3,-1,4,-2,0,-1,-1,-1,-1,1,3,-1
KR_6653391661,420,-2,-52,16,-3,-1,2,1,-1,5,4,8,1,9,-5,7,2,-4,5,1,0,-5,-162,-1,-4,5,-2,0,0,1,1,-1,-1,2,-1
KR_6751143503,420,-1,-22,-5,-2,1,0,1,2,1,3,1,2,3,-3,3,0,-3,3,0,0,-8,5,-3,-3,6,0,0,-1,1,-1,-1,-1,4,-1
KR_6763416811,420,-1,-91,4,-6,-1,2,1,-2,3,1,0,0,0,0,2,2,-3,4,1,0,-4,-4,0,-2,2,-1,0,0,-1,1,0,1,5,-1
KR_6724994993,420,-3,-121,24,-4,-5,7,2,1,0,1,-7,9,2,4,2,6,3,0,3,0,6,66,-3,-3,6,5,0,0,0,1,0,-1,0,-1
KR_6656761268,420,-1,-1,-20,-3,1,0,1,-4,5,1,2,3,5,1,1,2,-3,4,1,0,-7,72,-4,-3,7,-31,0,1,-1,1,1,-1,6,-1
KR_6731456954,440,-10,-153,-39,-20,-3,5,2,-2,3,1,-8,9,1,-2,3,1,-5,5,0,0,-11,-18,-2,-3,5,3,0,-4,-1,-1,-1,-1,6,-1
KR_6273776495,420,-2,-30,0,-9,0,1,1,1,3,4,-2,3,1,-9,9,0,1,2,3,0,-6,2,1,-4,3,0,0,0,1,-1,0,-1,5,-1
KR_6729378098,440,-7,-34,-15,-21,1,3,4,-6,6,0,-10,10,0,-4,6,2,-2,3,1,-1,-20,5,2,-6,4,-1,0,-3,-1,1,-1,-1,1,-1
KR_6722594865,420,-1,35,3,-8,-2,4,2,1,1,2,2,2,4,-4,4,0,-5,5,0,-1,-12,-2,-4,-2,6,1,0,-1,-1,-1,-1,-1,2,-1
KR_6660167834,420,-4,-67,7,-6,-1,2,1,2,2,4,-4,6,2,-3,3,0,0,2,2,-1,-8,0,-2,-3,5,-2,0,0,-1,-1,-1,-1,2,-1
KR_5889838175,420,-6,-116,-20,-16,-5,5,0,-6,8,2,-1,1,0,0,4,4,-4,5,1,0,-6,-3,-1,-4,5,-1,0,-3,-1,-1,-1,-1,4,-1
KR_6762449637,420,1,0,32,1,-1,1,0,0,2,2,0,3,3,0,3,3,2,0,2,-1,1,-9,1,-2,1,2,0,0,-1,1,0,-1,5,-1
KR_6700106183,440,2,37,40,0,0,0,0,-3,3,0,4,1,5,1,1,2,-2,2,0,0,-1,24,3,-6,3,-12,0,0,1,-1,0,-1,2,-1
KR_6753719966,440,-5,-32,-48,-10,-1,1,0,-4,5,1,-3,6,3,-3,6,3,1,0,1,-1,0,7,0,-3,3,-3,0,-4,-1,-1,-1,-1,2,-1
KR_6739926827,420,-1,-29,33,-6,-3,5,2,2,1,3,-7,7,0,2,3,5,0,3,3,1,4,-2,-2,-4,6,1,0,-1,-1,-1,-1,1,2,-1
KR_6686564613,420,0,-34,4,1,-2,2,0,4,1,5,1,2,3,2,2,4,-4,4,0,0,-2,-11,0,-1,1,6,0,1,-1,0,1,-1,3,-1
KR_6618833579,420,-1,-54,-6,-5,-2,4,2,2,1,3,-4,5,1,-1,4,3,0,0,0,0,2,-46,-7,-1,8,11,0,-1,-1,0,-1,-1,5,-1
KR_6751950530,420,-8,-113,-43,-18,-5,5,0,-3,6,3,-8,8,0,-2,3,1,0,1,1,0,-6,32,-8,0,8,0,0,-4,-1,-1,-1,-1,3,-1
KR_6653263935,420,-1,-7,20,5,-2,6,4,2,0,2,3,0,3,0,2,2,2,0,2,0,2,-11,-3,-3,6,-1,0,0,1,0,0,1,6,-1
KR_6732285499,440,0,7,-36,1,2,0,2,1,2,3,0,2,2,-1,4,3,-1,3,2,-1,-1,11,-3,-2,5,0,0,1,1,-1,1,-1,6,-1
KR_6645497344,420,0,4,-24,0,0,0,0,1,1,2,4,1,5,-1,3,2,-4,4,0,0,-3,5,3,-5,2,0,0,2,-1,1,1,1,1,-1
KR_6762196048,420,-1,-50,-28,-10,-3,4,1,-1,1,0,-6,6,0,0,2,2,0,0,0,0,-10,-191,-7,-1,8,-2,0,-2,-1,0,-1,-1,5,-1
KR_6687291170,420,-4,-74,16,-2,-1,1,0,1,2,3,-5,6,1,5,0,5,-2,3,1,1,4,-12,3,-4,1,3,0,0,1,0,0,1,4,-1
KR_6757466595,420,-3,-141,11,-8,-2,4,2,1,3,4,-3,4,1,0,1,1,-4,8,4,0,0,7,2,-7,5,-8,0,-2,0,-1,-1,-1,0,-1
KR_6760164504,420,-1,26,-47,3,-2,3,1,0,2,2,0,0,0,3,1,4,2,1,3,0,2,19,-1,-2,3,5,0,0,-1,-1,1,1,2,-1
KR_6751808646,420,1,16,23,-4,1,2,3,-3,6,3,-4,6,2,3,3,6,-1,1,0,1,-2,25,4,-9,5,-6,0,1,-1,1,1,1,4,-1
KR_6603767534,420,-3,-33,0,-5,-4,6,2,-4,8,4,4,0,4,0,3,3,-1,3,2,0,2,-4,-5,-1,6,2,0,-1,1,-1,-1,1,6,-1
KR_6737940483,420,-3,17,-14,-15,-2,4,2,-6,8,2,-5,5,0,-1,2,1,-1,3,2,-2,-7,14,-3,-1,4,-11,0,-1,0,0,-1,-1,0,-1
KR_6737522669,420,-1,-19,4,-7,5,0,5,1,3,4,-5,6,1,-4,9,5,-4,4,0,-2,-8,71,-1,-5,6,-31,0,2,-1,1,1,-1,2,-1
KR_6762808135,420,-3,-57,8,-1,-4,5,1,0,1,1,-1,3,2,3,3,6,1,0,1,0,5,28,-1,-5,6,-4,0,0,0,-1,0,-1,0,-1
KR_6731841190,420,0,12,-12,-1,-1,2,1,0,2,2,-2,2,0,0,3,3,2,1,3,0,1,-13,-6,-3,9,3,0,0,1,-1,0,-1,2,-1
KR_6764595691,440,1,-69,-15,-2,-1,2,1,-2,3,1,-3,3,0,3,1,4,1,2,3,0,4,-32,8,-11,3,15,0,-1,-1,-1,-1,-1,4,-1
KR_6755735452,420,-1,15,20,-1,0,1,1,4,2,6,-2,2,0,-2,2,0,-1,1,0,-1,-5,-10,-1,-4,5,-2,0,1,0,1,-1,-1,0,-1
KR_6763842426,420,1,38,-13,1,-2,3,1,-1,5,4,-1,2,1,4,2,6,1,1,2,0,-3,-14,3,-4,1,-5,0,0,-1,-1,-1,1,3,-1
KR_6718709303,420,-3,-67,0,-10,-3,3,0,-3,3,0,-3,3,0,-2,5,3,1,1,2,0,-7,-7,-7,-2,9,-2,0,-2,1,-1,-1,1,1,-1
KR_6685933764,420,3,41,4,8,0,0,0,2,2,4,4,1,5,-1,7,6,3,0,3,-1,3,-5,-1,-4,5,2,0,0,1,-1,0,-1,6,-1
KR_6717367731,420,5,28,13,6,2,1,3,2,5,7,3,3,6,1,2,3,-2,2,0,0,5,6,2,-3,1,-2,0,-1,1,-1,-1,1,5,-1
KR_6742374732,420,-2,30,20,-8,2,1,3,-5,5,0,-2,4,2,-2,3,1,-1,2,1,1,-13,33,2,-7,5,-27,0,1,1,1,-1,1,5,-1
KR_6759196885,420,0,56,-3,4,-3,4,1,1,2,3,-1,4,3,9,0,9,-2,2,0,2,-2,-11,4,-4,0,-1,0,0,-1,0,1,1,1,-1
KR_6740287776,420,-5,5,12,-8,-3,6,3,2,0,2,-3,5,2,-2,2,0,-2,3,1,0,-7,1,0,-3,3,1,0,0,1,1,-1,-1,6,-1
KR_6732348200,420,4,-55,0,12,-2,3,1,3,1,4,2,1,3,9,0,9,0,0,0,1,20,38,-1,-5,6,-1,0,0,1,0,0,1,5,-1
KR_6711319790,420,4,6,-12,10,4,0,4,4,1,5,3,1,4,-2,3,1,1,2,3,1,7,-9,1,-3,2,4,0,-1,1,1,-1,1,5,-1
KR_6645596274,420,0,27,-16,-2,1,1,2,1,0,1,0,0,0,-3,6,3,-1,2,1,0,-1,-10,-7,-2,9,2,0,0,-1,1,0,-1,2,-1
KR_6742255302,420,0,37,-6,-4,-3,4,1,-1,2,1,3,2,5,-2,5,3,-1,1,0,0,-1,-5,-3,-4,7,3,0,-1,1,-1,-1,-1,4,-1
KR_6755324579,420,0,-90,12,-1,-4,4,0,3,0,3,-2,4,2,1,2,3,1,0,1,0,7,7,0,-4,4,0,0,-1,0,-1,-1,1,0,-1
KR_6421258493,420,-3,-29,5,-8,-2,2,0,5,1,6,1,3,4,-10,12,2,-2,2,0,-2,-16,352,4,-5,1,-6,0,0,1,1,-1,-1,6,-1
KR_6760568103,420,0,-35,-19,6,5,0,5,-1,2,1,0,1,1,0,4,4,2,0,2,0,7,1,2,-5,3,-1,0,3,-1,1,1,-1,4,-1
KR_6721673582,420,-5,33,-10,-14,-1,1,0,-2,2,0,-8,8,0,-5,6,1,2,0,2,0,-15,-15,0,-2,2,-3,0,1,-1,1,1,-1,1,-1
KR_6656719671,420,-1,63,-44,-9,3,1,4,-2,5,3,1,0,1,-8,8,0,-3,3,0,0,-13,23,1,-5,4,-4,0,-1,1,1,-1,1,4,-1
KR_6750884684,420,-3,-25,-50,-4,1,3,4,-5,6,1,2,2,4,-3,3,0,1,1,2,0,-2,-13,0,-3,3,3,0,-1,-1,-1,-1,-1,4,-1
KR_6755340245,420,-5,8,-20,-17,-2,3,1,-6,7,1,2,3,5,-4,5,1,-7,9,2,-1,-17,2,0,-3,3,-2,0,0,-1,-1,0,-1,1,-1
KR_6755984526,420,-3,-65,-4,-9,-5,6,1,1,2,3,-6,6,0,2,3,5,-1,1,0,-1,-6,-10,0,-4,4,0,0,0,-1,-1,-1,-1,2,-1
KR_6644185406,420,-2,-68,-19,-6,1,1,2,-2,2,0,-5,7,2,-1,2,1,1,2,3,0,4,-7,-1,-3,4,-1,0,-1,-1,0,-1,-1,3,-1
KR_6763388992,440,-5,-88,-32,-10,-6,6,0,-1,2,1,-2,2,0,0,7,7,-1,3,2,-1,-6,-8,-4,0,4,-1,0,-1,-1,1,-1,-1,4,-1
KR_6663357525,420,-2,-42,0,-4,-2,4,2,0,2,2,0,1,1,2,0,2,-4,4,0,0,-3,-6,0,-5,5,4,0,-1,1,-1,-1,1,1,-1
KR_6735352242,420,0,-14,32,-4,3,1,4,1,3,4,-1,1,0,-1,1,0,-6,6,0,0,-6,10,-3,-4,7,-1,0,-1,-1,1,1,-1,4,-1
KR_6756008702,420,3,57,0,3,-2,7,5,-5,6,1,2,0,2,7,2,9,1,1,2,0,2,0,2,-5,3,-1,0,0,1,-1,-1,-1,2,-1
KR_6656620953,420,-6,-97,1,-21,-2,2,0,-7,7,0,-4,4,0,-6,7,1,-2,3,1,0,-20,61,1,-4,3,3,0,-1,-1,-1,-1,1,4,-1
KR_6703516103,420,0,17,4,0,-4,4,0,2,2,4,4,1,5,-1,2,1,-1,1,0,0,1,-1,0,-5,5,1,0,-1,0,-1,-1,-1,0,-1
KR_6750106729,420,-2,-107,50,-5,1,0,1,0,3,3,-2,4,2,-3,4,1,-1,1,0,0,-7,0,4,-4,0,-1,0,-1,1,-1,-1,-1,2,-1
KR_6763236813,420,-4,-69,-9,-9,-3,3,0,0,2,2,0,2,2,-5,7,2,-1,2,1,-2,-5,-6,-9,-1,10,-1,0,-1,1,-1,-1,-1,4,-1
KR_6745454495,420,0,40,-17,-1,-2,2,0,-3,3,0,-1,1,0,2,1,3,3,3,6,-1,3,5,1,-7,6,-1,0,0,-1,1,0,-1,3,-1
KR_6761584630,440,3,-32,15,4,1,0,1,-1,7,6,2,0,2,1,1,2,1,2,3,0,-3,383,-6,-3,9,-4,0,0,-1,-1,0,1,3,-1
KR_6425879245,420,1,-1,20,0,0,1,1,-2,4,2,2,2,4,0,4,4,0,0,0,0,1,4,-1,-3,4,6,0,0,0,-1,0,1,0,-1
KR_6764316530,420,2,-2,12,6,0,3,3,-1,5,4,3,1,4,1,2,3,3,1,4,0,7,3,2,-5,3,1,0,0,1,1,0,1,4,-1
KR_6760770869,420,3,-1,16,3,1,2,3,1,2,3,-3,4,1,3,3,6,1,1,2,0,4,8,1,-4,3,0,0,-1,-1,0,-1,1,6,-1
KR_6697160665,420,-2,29,0,-6,-1,1,0,2,3,5,0,3,3,-5,6,1,-2,3,1,0,-9,168,-3,-1,4,-1,0,0,-1,1,0,1,6,-1
KR_6642430076,420,0,0,8,-2,0,1,1,1,2,3,-3,4,1,-1,4,3,1,0,1,0,-3,-2,-1,-4,5,0,0,1,-1,1,1,1,5,-1
KR_6703366384,440,-1,45,12,-2,-2,2,0,-3,3,0,2,1,3,1,0,1,0,2,2,0,-3,-2,-3,-3,6,1,0,0,-1,0,0,1,3,-1
KR_6660999987,440,1,-30,0,-6,1,2,3,-2,3,1,-2,2,0,-1,4,3,-2,2,0,0,-2,-21,-5,-2,7,0,0,1,-1,-1,-1,-1,4,-1
KR_6747088971,420,-1,33,-9,-2,0,1,1,-2,5,3,-3,4,1,1,2,3,2,1,3,0,1,3,3,-5,2,1,0,0,-1,1,0,-1,2,-1
KR_6760342057,420,-3,-9,-15,0,-5,6,1,1,2,3,3,0,3,2,1,3,-1,1,0,0,2,-6,2,-5,3,-2,0,-1,-1,0,-1,1,6,-1
KR_6757492068,420,-3,-27,2,-10,-1,1,0,1,0,1,0,1,1,-7,7,0,-3,3,0,-1,-6,3,-1,-3,4,-6,0,-1,-1,-1,-1,-1,6,-1
KR_6758901440,440,1,41,4,2,-2,3,1,4,4,8,1,5,6,2,4,6,-3,3,0,0,11,-7,4,-5,1,0,0,1,1,-1,1,1,4,-1
KR_6644409993,420,1,38,-25,3,2,2,4,-2,2,0,0,2,2,-2,2,0,5,0,5,1,2,37,3,-7,4,1,0,0,-1,1,-1,1,3,-1
KR_6679312980,420,2,-42,-10,3,1,0,1,-1,3,2,1,3,4,3,2,5,-1,1,0,0,8,4,0,-2,2,1,0,0,-1,1,-1,1,3,-1
KR_6326333494,420,2,-42,8,4,2,2,4,1,3,4,0,3,3,1,1,2,0,0,0,0,3,8,0,-3,3,0,0,0,0,0,0,1,0,-1
KR_6713315531,420,-4,-18,-8,-5,-1,2,1,-3,4,1,0,3,3,-2,3,1,1,0,1,-1,0,123,3,-4,1,3,0,-2,-1,1,-1,-1,1,-1
KR_6757144180,420,-4,-68,-6,-13,-3,5,2,0,1,1,-4,5,1,-3,4,1,-3,4,1,0,-8,-70,-2,-3,5,-3,0,-3,-1,-1,-1,-1,4,-1
KR_6759998645,440,-3,-81,-14,-12,-5,6,1,-3,4,1,2,1,3,-6,9,3,0,1,1,-1,-16,-2,-2,-1,3,-1,0,0,-1,1,-1,-1,2,-1
KR_6711348723,420,2,-22,12,-3,3,2,5,-5,6,1,-2,2,0,1,3,4,0,0,0,0,-2,10,1,-4,3,4,0,-1,-1,-1,-1,-1,6,-1
KR_6698427926,420,-7,-84,-52,-15,-2,3,1,-2,5,3,-6,7,1,0,4,4,-5,5,0,0,-7,-6,0,-3,3,-4,0,-3,-1,-1,-1,1,1,-1
KR_6400361071,420,-5,-41,-29,-10,3,1,4,2,1,3,-3,4,1,-10,12,2,-2,2,0,0,-10,0,0,-3,3,-2,0,0,-1,1,-1,-1,6,-1
KR_6688964682,420,-1,-29,-3,1,2,0,2,-1,7,6,1,2,3,-1,2,1,0,0,0,-2,2,17,-5,-1,6,3,0,0,-1,1,1,-1,2,-1
KR_6725438983,420,1,-6,13,-5,-1,1,0,-5,8,3,1,0,1,1,1,2,-1,1,0,0,-5,17,-2,-3,5,-2,0,0,-1,1,0,-1,5,-1
KR_6513733763,420,-6,-83,-23,-10,1,0,1,-5,6,1,-1,3,2,-4,6,2,-1,3,2,-1,-7,24,-5,-2,7,-20,0,-3,-1,1,-1,-1,3,-1
KR_6619833953,420,5,-6,8,7,0,3,3,2,2,4,1,3,4,2,3,5,2,1,3,0,7,-245,-2,-3,5,1,0,1,1,1,1,1,5,-1
KR_6761676208,420,1,27,-19,-2,-2,2,0,2,3,5,1,1,2,-3,6,3,0,0,0,0,-4,6,-1,-4,5,0,0,1,-1,1,1,1,3,-1
KR_6740889175,420,-4,-75,-11,-11,-4,7,3,-3,6,3,-1,5,4,-4,4,0,1,1,2,0,-7,-1,1,-5,4,3,0,0,1,-1,-1,1,3,-1
KR_6731806726,420,-1,-34,18,-6,-1,2,1,0,1,1,-1,3,2,-3,3,0,-1,1,0,0,1,30,-2,-4,6,-1,0,-1,-1,1,-1,-1,4,-1
KR_6753756817,420,-2,-66,-1,-4,2,2,4,0,3,3,0,1,1,-3,3,0,-3,3,0,0,-7,-3,-1,-6,7,1,0,0,-1,1,-1,-1,1,-1
KR_6704654436,420,3,-28,4,9,2,2,4,1,0,1,2,1,3,4,2,6,0,0,0,0,6,6,-5,-2,7,-2,0,0,-1,-1,-1,1,4,-1
KR_6756778495,420,1,-38,12,0,-2,3,1,-2,2,0,2,2,4,2,1,3,0,1,1,0,2,-6,-1,-3,4,2,0,0,-1,-1,0,-1,2,-1
KR_6755557618,440,-3,34,-36,-17,-2,2,0,0,2,2,-4,5,1,-2,5,3,-9,9,0,-2,-25,329,1,-3,2,-4,0,-3,0,-1,-1,-1,0,-1
KR_6763977782,420,1,3,7,0,1,2,3,2,2,4,0,2,2,4,2,6,-7,8,1,0,-1,2,-2,-5,7,1,0,0,-1,-1,0,1,2,-1
KR_6742400668,420,-3,-55,-16,-4,-5,5,0,-4,5,1,1,3,4,1,0,1,3,2,5,0,-5,-10,1,-1,0,-1,0,1,-1,0,1,1,4,-1
KR_6705410553,440,-1,-23,-8,-4,-1,3,2,6,0,6,-1,2,1,-3,3,0,-5,6,1,0,-3,34,4,-9,5,1,0,0,-1,1,-1,-1,1,-1
KR_6728210722,420,1,-15,32,-1,5,0,5,3,1,4,-3,3,0,-4,5,1,-2,2,0,1,5,9,0,-4,4,-1,0,-1,0,0,-1,-1,0,-1
KR_6692637829,420,-3,-80,4,-2,-2,6,4,2,3,5,-2,5,3,0,0,0,0,0,0,1,5,555,3,-4,1,-4,0,0,-1,-1,-1,1,5,-1
KR_6717342100,440,-2,44,9,-8,2,2,4,2,1,3,-1,3,2,-9,11,2,-2,2,0,1,-17,45,0,-6,6,-33,0,-1,-1,1,-1,1,6,-1
KR_6755750655,420,0,-12,15,-4,-1,3,2,0,6,6,-11,12,1,3,2,5,5,0,5,0,3,20,1,-3,2,2,0,-1,-1,0,-1,-1,4,-1
KR_6756044498,440,-2,-21,-12,-6,-1,2,1,3,1,4,-9,9,0,-3,4,1,4,0,4,0,5,-14,0,-6,6,-2,0,-1,-1,0,-1,-1,3,-1
KR_6757587685,420,2,38,2,-6,3,2,5,-2,5,3,-2,3,1,-1,3,2,-4,4,0,0,-26,10,5,-10,5,-10,0,1,-1,-1,1,1,4,-1
KR_5884195744,420,3,33,-12,0,0,1,1,4,1,5,-3,7,4,1,1,2,-2,5,3,0,-4,45,-3,-8,11,-2,0,0,-1,-1,-1,-1,3,-1
KR_6750014396,420,-2,-43,-20,1,2,0,2,0,2,2,-2,4,2,1,1,2,0,0,0,-1,1,8,3,-5,2,-5,0,0,-1,1,0,-1,5,-1
KR_6273813166,420,0,-27,-10,2,-1,2,1,1,1,2,4,1,5,-2,2,0,0,0,0,0,-8,-2,-1,-8,9,1,0,0,-1,1,0,1,2,-1
KR_6738772680,420,-1,-56,0,-3,-4,4,0,2,3,5,-1,4,3,-1,3,2,1,1,2,-2,-5,-13,-1,-3,4,2,0,-1,1,0,-1,1,4,-1
KR_6739336427,420,-4,-74,-28,-4,-1,1,0,-4,6,2,1,1,2,1,3,4,-1,2,1,0,-6,-7,0,-4,4,-1,0,0,-1,-1,-1,1,4,-1
KR_6731449443,420,-4,-101,8,-15,-1,2,1,2,2,4,-6,6,0,-10,10,0,0,0,0,0,-15,7,0,-5,5,-1,0,-2,-1,-1,-1,-1,4,-1
KR_6722691033,420,-4,-61,-14,-2,-6,6,0,0,2,2,0,2,2,0,1,1,4,2,6,0,1,-27,-1,-2,3,-2,0,0,1,0,-1,1,4,-1
KR_6649172832,420,1,-29,4,0,-2,3,1,2,2,4,-1,3,2,2,1,3,-1,1,0,-1,-3,-26,0,-6,6,13,0,0,-1,-1,0,-1,6,-1
KR_6744707124,420,-6,-109,-48,-11,0,2,2,-3,5,2,-4,6,2,-1,4,3,-3,5,2,-2,-11,-6,1,-6,5,-5,0,-2,0,-1,-1,-1,0,-1
KR_6744684175,440,-4,-21,-30,-15,1,0,1,-6,8,2,-7,10,3,-3,4,1,0,2,2,-1,-12,-10,-2,-4,6,3,0,0,-1,1,0,-1,6,-1
KR_6731984673,420,-2,16,-20,0,2,0,2,4,0,4,-3,4,1,-4,4,0,1,1,2,0,-1,-18,4,-7,3,3,0,-1,-1,-1,-1,1,6,-1
KR_6742716745,420,-4,-1,-21,-3,-2,2,0,1,1,2,-4,4,0,1,0,1,1,0,1,0,3,0,7,-7,0,-7,0,-2,-1,-1,-1,-1,2,-1
KR_6694150304,440,-7,-47,12,-14,2,2,4,-3,5,2,-6,6,0,-6,7,1,-1,3,2,-1,-15,-25,-4,-2,6,-4,0,-1,-1,-1,-1,-1,5,-1
KR_6667096261,420,-2,-50,-21,-1,-1,2,1,2,4,6,1,1,2,-2,3,1,-1,4,3,0,4,6,2,-5,3,-5,0,1,-1,1,-1,-1,5,-1
KR_6738282474,440,-2,-2,-26,-6,3,0,3,-5,5,0,-6,8,2,1,1,2,1,0,1,0,-15,8,2,-7,5,0,0,0,1,-1,-1,1,4,-1
KR_6750111123,420,1,-43,-15,1,1,0,1,1,1,2,0,4,4,-3,7,4,2,0,2,0,4,-37,-2,-5,7,17,0,0,-1,1,-1,1,6,-1
KR_6746279624,420,-2,6,-4,-6,-2,4,2,-3,5,2,0,2,2,-3,3,0,2,0,2,0,1,-258,1,-4,3,-4,0,-1,-1,1,-1,1,4,-1
KR_6750600631,420,5,27,-2,17,3,1,4,5,0,5,2,4,6,4,0,4,3,0,3,0,13,-18,-1,-3,4,4,0,3,1,1,1,-1,2,-1
KR_6757811111,420,0,-47,-23,-2,3,0,3,-5,6,1,-3,5,2,1,3,4,2,1,3,0,3,-1,0,-3,3,-1,0,0,-1,1,-1,-1,6,-1
KR_6726657209,440,0,-27,-31,2,-1,5,4,3,1,4,3,2,5,-1,5,4,-2,3,1,1,0,-4,4,-5,1,0,0,0,0,0,0,1,0,-1
KR_6746893770,420,0,-50,-11,-3,-2,2,0,0,3,3,-5,6,1,3,0,3,1,1,2,0,10,11,-2,-3,5,0,0,-1,-1,1,-1,-1,3,-1
KR_6756649163,420,-4,-87,-19,-5,-1,3,2,5,0,5,-6,7,1,-3,4,1,0,4,4,0,-3,-12,7,-9,2,-8,0,-2,-1,-1,-1,1,2,-1
KR_6756991868,420,-4,-82,-5,-12,0,2,2,-1,2,1,-8,9,1,-2,2,0,-1,3,2,0,-5,-53,-4,-5,9,17,0,0,0,-1,0,1,0,-1
KR_6761022027,420,2,-5,-32,4,-3,3,0,1,1,2,2,1,3,4,3,7,0,2,2,-1,7,10,-1,-3,4,4,0,0,1,-1,-1,-1,6,-1
KR_6759089407,420,-3,-63,-20,-1,-3,3,0,0,2,2,1,1,2,0,3,3,1,0,1,0,0,3,3,-7,4,-7,0,-1,1,-1,-1,-1,6,-1
KR_6682608794,420,-3,-16,-30,-15,-1,2,1,-3,5,2,-11,11,0,0,0,0,0,1,1,0,-9,11,4,-6,2,0,0,-1,-1,-1,-1,-1,1,-1
KR_6730416366,420,-3,18,-44,-5,-2,4,2,2,1,3,0,2,2,-5,7,2,0,0,0,-1,-8,-4,0,-4,4,2,0,-2,1,-1,-1,-1,5,-1
KR_6756091493,440,-2,-48,-16,-5,-4,5,1,1,3,4,0,2,2,-2,4,2,0,0,0,0,-3,1,-2,-3,5,2,0,-1,-1,1,-1,1,5,-1
KR_6631804628,440,0,45,-4,-6,-9,11,2,-3,4,1,-1,1,0,6,1,7,1,0,1,0,-1,-13,-2,-3,5,1,0,-1,-1,-1,-1,1,5,-1
KR_6762417026,420,-1,-13,5,-4,-1,3,2,-2,3,1,-6,6,0,2,1,3,3,0,3,0,-5,1,5,-6,1,-6,0,1,-1,0,1,-1,5,-1
KR_6603428600,420,3,6,12,-2,0,4,4,2,2,4,0,3,3,-4,5,1,0,3,3,-2,-8,-251,1,-8,7,-2,0,0,-1,1,0,-1,4,-1
KR_6719116181,420,-2,-19,-14,-9,-2,3,1,-5,5,0,-3,4,1,1,1,2,0,0,0,0,-7,5,3,-4,1,-3,0,-1,-1,-1,-1,-1,6,-1
KR_6753193487,440,0,-40,-1,7,4,2,6,2,1,3,1,1,2,1,0,1,-1,1,0,0,-1,3,6,-6,0,0,0,-2,1,1,-1,1,3,-1
KR_6761740867,420,-1,-20,17,-2,-4,4,0,3,0,3,-4,5,1,2,0,2,1,1,2,0,10,1,0,-4,4,1,0,0,-1,-1,-1,-1,6,-1
KR_6459884361,440,-5,42,-32,-21,-8,11,3,-1,5,4,-8,10,2,-2,3,1,-2,2,0,-4,-39,2,-3,-1,4,1,0,-1,-1,1,-1,-1,4,-1
KR_6684119436,420,1,-36,26,-5,0,2,2,-3,7,4,2,1,3,-3,4,1,-1,1,0,1,-9,-7,-5,-3,8,-3,0,-1,-1,1,-1,1,1,-1
KR_6698986791,420,0,111,0,1,1,1,2,1,3,4,3,1,4,-1,4,3,-3,4,1,2,3,3,0,-3,3,0,0,0,0,0,0,1,0,-1
KR_6635064001,440,-2,-42,-17,-9,-3,3,0,-1,4,3,-1,2,1,-4,6,2,0,0,0,0,-12,-11,-5,-4,9,2,0,-1,-1,1,-1,-1,6,-1
KR_6726060366,420,3,29,4,3,0,2,2,-3,3,0,4,0,4,5,1,6,-3,5,2,0,3,6,4,-5,1,-3,0,-1,-1,-1,-1,1,3,-1
KR_6590039319,420,-11,-140,-12,-8,1,0,1,1,2,3,-4,4,0,-3,6,3,-3,4,1,0,-7,0,-4,-2,6,0,0,-3,-1,-1,-1,-1,5,-1
KR_6756186659,440,-3,16,-21,-2,-10,11,1,1,0,1,3,0,3,3,1,4,1,3,4,1,3,-3,1,-3,2,0,0,1,1,1,1,1,6,-1
KR_6744204153,420,0,-42,-2,-2,-3,3,0,1,2,3,-2,3,1,3,0,3,-1,1,0,0,-1,2,-1,-5,6,5,0,-1,1,-1,-1,1,2,-1
KR_6687996024,420,1,57,9,6,4,0,4,0,4,4,-1,2,1,2,1,3,1,0,1,0,6,12,0,-5,5,0,0,0,1,-1,0,1,5,-1
KR_6736890874,420,-5,-58,0,-11,-3,4,1,-1,2,1,-2,4,2,-4,4,0,-1,1,0,0,-3,6,-4,-3,7,-3,0,-1,-1,0,-1,1,5,-1
KR_6676576858,420,-2,-62,4,-4,0,2,2,2,2,4,-9,9,0,3,2,5,0,2,2,2,-1,1,2,-3,1,-1,0,-1,0,-1,-1,1,0,-1
KR_6757667071,420,-2,-87,-20,-1,-2,2,0,-5,5,0,-2,5,3,7,2,9,1,0,1,0,1,-6,0,-4,4,2,0,0,-1,1,-1,-1,3,-1
KR_6644753264,420,-4,-78,-9,-5,-2,2,0,-1,2,1,-2,3,1,0,1,1,0,0,0,-1,-2,-1,-4,-3,7,0,0,0,0,-1,0,-1,0,-1
KR_6749558895,420,-6,-13,-4,-16,-3,3,0,-7,8,1,0,1,1,-3,4,1,-3,5,2,0,-15,-3,-2,-1,3,-2,0,-1,-1,1,-1,1,4,-1
KR_6761143339,440,-1,38,29,-4,-1,2,1,-4,4,0,4,1,5,-5,6,1,2,1,3,-1,-16,-18,-4,-1,5,4,0,0,1,1,-1,-1,3,-1
KR_6720183252,440,-3,-17,-6,-7,-1,2,1,-7,10,3,2,1,3,0,2,2,-1,2,1,0,-6,2,1,-2,1,-1,0,0,1,1,0,1,2,-1
KR_6519987996,420,2,-30,-12,6,-1,1,0,1,1,2,6,4,10,1,2,3,-1,2,1,-2,1,8,0,-5,5,-2,0,1,-1,1,1,-1,1,-1
KR_6723825207,420,-3,-31,-29,-9,-5,5,0,-9,9,0,2,1,3,1,2,3,2,2,4,0,-5,-4,-8,-3,11,-1,0,0,1,0,-1,-1,2,-1
KR_6690667910,420,-3,-33,-25,-9,-3,3,0,-4,4,0,-1,1,0,-2,2,0,1,0,1,0,-9,7,-2,-2,4,5,0,-1,-1,-1,-1,-1,1,-1
KR_6713285192,420,-3,-55,0,-3,-2,2,0,0,2,2,-3,5,2,-2,4,2,4,0,4,0,0,-2,0,-2,2,-2,0,-1,-1,-1,-1,-1,3,-1
KR_6752694860,420,-2,-21,-32,-1,2,2,4,-1,5,4,-3,4,1,0,1,1,1,0,1,0,-4,2,0,-2,2,-2,0,2,1,1,1,-1,2,-1
KR_6654831040,420,-1,4,0,-7,-1,2,1,3,1,4,-8,9,1,0,0,0,-1,2,1,0,-2,372,0,-2,2,2,0,-1,1,1,-1,-1,4,-1
KR_6755215176,440,-4,-79,-12,-4,-2,2,0,1,2,3,1,2,3,-4,6,2,0,1,1,0,-7,0,3,-7,4,-2,0,0,0,0,-1,-1,0,-1
KR_6754821870,420,-1,-31,-27,7,2,2,4,0,2,2,0,5,5,5,1,6,0,0,0,1,10,-3,-4,-4,8,6,0,0,1,-1,0,1,3,-1
KR_6717523035,440,-2,-8,0,-8,3,0,3,-1,1,0,-6,8,2,-4,8,4,0,2,2,0,-7,-11,1,-3,2,4,0,-1,-1,1,-1,-1,1,-1
KR_6601178210,420,-4,-52,16,-17,-1,4,3,-1,3,2,-1,5,4,-11,11,0,-3,5,2,-1,-22,-11,1,-4,3,-1,0,0,-1,-1,-1,-1,6,-1
KR_6739568764,420,1,57,0,3,2,1,3,0,3,3,-1,1,0,6,0,6,-4,4,0,0,-2,-2,1,-3,2,0,0,1,1,-1,1,-1,6,-1
KR_6752326498,420,-1,-27,0,-7,0,3,3,-4,4,0,3,0,3,-6,7,1,0,1,1,-1,-9,4,-3,-2,5,-5,0,0,0,1,0,-1,0,-1
KR_6689124162,420,0,-7,4,2,0,0,0,-1,2,1,2,1,3,1,1,2,0,0,0,0,0,10,-3,-2,5,-1,0,0,-1,-1,0,1,6,-1
KR_6762370708,420,2,47,-20,1,0,3,3,-4,6,2,0,1,1,4,2,6,1,1,2,0,4,-3,-3,-4,7,-2,0,1,-1,-1,1,-1,1,-1
KR_6734259083,440,1,-6,4,-4,-4,6,2,2,0,2,-2,3,1,0,4,4,0,2,2,-1,-7,-51,0,-3,3,-5,0,0,-1,-1,1,-1,1,-1
KR_6764523598,420,0,18,4,-3,1,0,1,1,2,3,1,2,3,-3,6,3,-3,4,1,0,-6,-2,-7,-3,10,0,0,0,-1,-1,1,-1,5,-1
KR_6697642716,440,1,53,3,-2,-1,1,0,3,1,4,-4,6,2,-1,2,1,1,1,2,0,-7,1,1,-5,4,0,0,0,1,1,0,1,6,-1
KR_6763383838,420,2,-11,-4,0,0,3,3,0,1,1,-2,3,1,2,1,3,0,0,0,0,4,-6,-2,-3,5,-2,0,0,0,1,0,-1,0,-1
KR_6607315031,420,-1,-35,-12,0,0,2,2,0,0,0,3,3,6,-1,4,3,-2,4,2,0,-1,-2,1,-5,4,0,0,0,-1,-1,-1,1,1,-1
KR_6670433620,420,-2,-37,-16,4,6,0,6,4,1,5,-3,5,2,-3,3,0,0,0,0,0,1,-2,-7,-2,9,4,0,0,-1,1,-1,1,6,-1
KR_6755820205,420,-3,-68,-31,-7,0,2,2,-2,3,1,0,1,1,-5,8,3,0,0,0,-1,-5,2,-1,-2,3,-8,0,1,-1,1,1,-1,5,-1
KR_6689166214,440,4,22,-7,5,3,0,3,0,1,1,0,2,2,4,2,6,-2,2,0,0,1,0,3,-7,4,2,0,1,-1,1,1,-1,6,-1
KR_6749233885,420,-2,-11,-8,-2,-1,3,2,3,1,4,-1,4,3,-1,2,1,-2,2,0,-1,-7,10,5,-12,7,-3,0,0,-1,-1,-1,-1,6,-1
KR_6650073054,420,3,43,-28,6,0,4,4,1,4,5,0,3,3,3,1,4,2,0,2,0,1,-20,1,-4,3,0,0,1,1,-1,1,1,5,-1
KR_6755642343,420,-2,26,-28,0,0,1,1,3,3,6,1,1,2,0,0,0,-4,4,0,0,1,-8,-3,-1,4,2,0,0,1,-1,1,-1,4,-1
KR_6741712337,420,-8,-99,-34,-9,-4,6,2,-4,6,2,-1,3,2,3,0,3,-3,3,0,0,-10,0,-3,0,3,-1,0,0,-1,-1,-1,1,2,-1
KR_6747056135,420,-1,-24,-4,0,-6,6,0,-1,2,1,-2,2,0,6,0,6,3,0,3,0,3,-5,-3,0,3,0,0,-1,1,-1,-1,-1,4,-1
KR_6684569955,420,-3,3,-11,-6,-2,3,1,0,1,1,-3,5,2,-1,4,3,0,0,0,0,-7,-22,-1,-4,5,-2,0,0,-1,-1,1,-1,5,-1
KR_6746534325,420,-2,-50,-12,-1,0,2,2,3,0,3,-9,9,0,5,0,5,0,2,2,0,1,-39,-6,-3,9,-1,0,1,1,1,1,1,3,-1
KR_6756959693,420,-1,-50,5,0,-1,2,1,3,1,4,0,4,4,-3,5,2,1,1,2,0,1,-10,1,-4,3,-5,0,0,1,0,0,-1,1,-1
KR_6675727331,420,-3,-129,-32,-13,-5,5,0,0,2,2,-5,5,0,-1,4,3,-2,3,1,0,-14,-1,4,-6,2,-5,0,-2,-1,-1,-1,1,6,-1
KR_6629738954,420,-2,-19,-4,-8,-2,3,1,0,2,2,-4,5,1,-4,7,3,2,0,2,0,-14,-7,-1,-3,4,0,0,0,-1,-1,-1,-1,5,-1
KR_6676219206,420,-1,-97,-12,-3,-4,4,0,2,0,2,-4,8,4,3,2,5,0,0,0,0,1,5,0,-2,2,2,0,0,0,1,0,-1,0,-1
KR_6752167138,420,-2,10,-4,-2,-6,6,0,2,1,3,1,4,5,2,1,3,-1,1,0,0,7,2,-2,-4,6,3,0,0,0,0,0,1,0,-1
KR_6759569037,420,5,46,25,15,5,2,7,3,2,5,-2,4,2,3,1,4,6,0,6,0,20,-1,0,-2,2,3,0,1,-1,-1,1,-1,3,-1
KR_6729759737,420,-4,36,-10,3,-2,3,1,3,2,5,0,3,3,2,0,2,0,0,0,0,5,21,1,-4,3,3,0,1,0,1,1,1,0,-1
KR_6761462675,420,-3,-30,-20,-9,-2,3,1,-2,3,1,-3,4,1,-1,2,1,-1,1,0,0,-3,10,3,-6,3,0,0,0,-1,-1,0,1,3,-1
KR_6734392511,420,-3,-2,-16,-10,1,1,2,-7,8,1,-4,5,1,-3,7,4,3,0,3,0,-1,4,2,-4,2,1,0,0,-1,-1,-1,-1,1,-1
KR_6763507073,420,-1,-18,-13,-1,-2,3,1,-1,1,0,2,2,4,2,1,3,-2,2,0,1,1,-1,7,-10,3,0,0,1,-1,-1,1,1,3,-1
KR_6714633512,420,-1,-15,-16,4,-1,4,3,-4,5,1,1,1,2,5,0,5,3,1,4,1,6,-9,3,-4,1,-1,0,0,1,1,1,-1,5,-1
KR_6711902727,420,-1,26,12,-2,3,2,5,-3,5,2,1,0,1,-3,5,2,0,0,0,0,-14,-1,-1,-3,4,-2,0,1,-1,0,1,1,4,-1
KR_6625445968,420,-3,-19,-32,1,1,1,2,0,1,1,-1,2,1,1,5,6,0,0,0,1,10,4,2,-5,3,-3,0,0,-1,1,1,1,4,-1
KR_6675453941,420,-1,-98,31,-3,1,0,1,-1,2,1,-4,4,0,1,0,1,0,1,1,0,-2,4,3,-6,3,-7,0,-1,1,0,-1,1,1,-1
KR_6723251193,420,-6,15,-13,-5,-2,3,1,0,3,3,-8,8,0,5,2,7,0,1,1,0,2,6,1,-4,3,-4,0,-1,1,0,-1,1,5,-1
KR_6756837264,440,1,-28,17,5,-1,3,2,2,2,4,2,3,5,1,0,1,1,0,1,0,2,5,-2,-2,4,3,0,0,1,-1,-1,1,5,-1
KR_6614245993,420,3,97,5,3,3,1,4,2,1,3,-2,2,0,1,0,1,-1,1,0,0,3,3,-2,-2,4,-1,0,1,1,1,1,-1,6,-1
KR_6717829167,420,0,-39,16,-3,1,0,1,6,1,7,1,4,5,-9,10,1,-2,2,0,-1,6,8,0,-4,4,-3,0,0,-1,1,1,-1,6,-1
KR_6760917312,420,-3,-81,-12,-3,-1,2,1,0,1,1,1,1,2,-1,1,0,-2,2,0,0,0,-34,6,-6,0,28,0,-1,-1,0,-1,-1,4,-1
KR_6742295746,440,4,83,11,9,-1,4,3,3,0,3,-1,2,1,4,2,6,4,0,4,0,16,-1,5,-5,0,-4,0,2,1,1,1,1,1,-1
KR_6750360368,420,0,-15,7,-5,0,2,2,-1,10,9,-3,5,2,-1,1,0,0,2,2,0,-15,9,2,-4,2,-3,0,-1,-1,0,-1,1,1,-1
KR_6753073853,420,-4,-50,-2,-8,1,0,1,0,2,2,-6,8,2,-2,8,6,-1,1,0,-1,-10,5,-1,-5,6,-7,0,-2,-1,1,-1,-1,2,-1
KR_6695921183,420,-1,24,0,1,0,0,0,-1,3,2,-3,3,0,4,2,6,1,1,2,0,5,-325,-1,-6,7,4,0,-1,-1,1,-1,-1,4,-1
KR_6748570028,420,0,-81,-12,3,-6,9,3,3,2,5,4,0,4,1,6,7,1,1,2,2,3,-10,0,-3,3,0,0,-1,1,1,-1,1,2,-1
KR_6756850477,420,0,-5,-19,0,0,2,2,-2,4,2,1,1,2,-2,2,0,3,0,3,0,6,-2,-2,-2,4,1,0,0,1,-1,0,-1,4,-1
KR_6755506464,420,-6,-105,-40,-18,1,0,1,-8,9,1,-4,4,0,-3,3,0,-4,5,1,-1,-16,-12,-2,-2,4,0,0,-2,1,-1,-1,-1,1,-1
KR_6732746063,440,-5,-85,-61,-11,-2,3,1,-2,5,3,-4,6,2,1,0,1,-4,4,0,0,-7,13,6,-8,2,-2,0,-1,-1,0,-1,-1,3,-1
KR_6407497319,420,-2,-72,-13,-8,0,1,1,-9,10,1,2,1,3,-2,6,4,1,2,3,0,-6,-106,-5,0,5,2,0,-2,-1,-1,-1,1,6,-1
KR_6542418825,420,-7,-94,-5,-10,-3,4,1,-3,5,2,2,1,3,-5,7,2,-1,5,4,0,-10,-241,6,-7,1,0,0,-1,1,-1,-1,-1,1,-1
KR_6753740988,420,0,-14,-24,2,-2,3,1,1,2,3,4,1,5,1,1,2,-2,2,0,0,3,0,4,-5,1,-1,0,-1,-1,1,-1,-1,3,-1
KR_6570398927,420,-3,-91,20,-15,0,3,3,-4,4,0,-10,10,0,-2,2,0,1,1,2,0,-12,14,-1,-3,4,-3,0,-1,-1,1,-1,-1,1,-1
KR_6762490925,420,-3,-49,-4,-7,0,4,4,2,1,3,-5,5,0,-3,4,1,-1,2,1,0,-3,-5,-2,-3,5,0,0,0,-1,-1,0,-1,3,-1
KR_6611992552,420,2,33,8,5,6,3,9,1,3,4,-1,1,0,1,3,4,-2,3,1,0,-2,4,7,-9,2,-2,0,2,-1,1,1,1,3,-1
KR_6760979055,420,-1,-91,-1,-5,-6,6,0,2,3,5,1,0,1,0,3,3,-2,3,1,-1,0,-9,-3,-2,5,5,0,-1,0,1,-1,-1,0,-1
KR_6764025985,420,-7,-60,-1,-17,-3,3,0,1,0,1,-11,12,1,-3,4,1,-1,4,3,-1,-18,-186,-3,-3,6,-4,0,-4,-1,-1,-1,1,2,-1
KR_6761371249,440,-1,-74,-50,0,-2,7,5,-2,4,2,2,0,2,0,2,2,2,0,2,0,5,-8,-7,-1,8,2,0,-2,-1,-1,-1,-1,1,-1
KR_6762759831,440,0,7,-5,1,-3,4,1,1,3,4,-1,3,2,1,1,2,3,0,3,-1,-1,7,9,-10,1,1,0,0,1,1,0,-1,6,-1
KR_6661926429,420,1,-41,-31,3,-1,3,2,4,4,8,-2,2,0,1,1,2,1,0,1,0,8,5,1,-4,3,-2,0,1,1,-1,1,-1,4,-1
KR_6760023957,440,2,85,-18,7,4,0,4,3,4,7,2,2,4,-2,3,1,0,1,1,0,7,-8,-3,-3,6,-1,0,0,-1,0,1,1,2,-1
KR_6762605553,420,-4,-24,-32,2,-3,3,0,3,1,4,-1,6,5,3,2,5,0,0,0,2,13,2,-1,-5,6,-1,0,0,1,-1,0,1,6,-1
KR_6634375128,420,0,7,0,-3,1,1,2,-4,4,0,1,1,2,-2,2,0,1,0,1,0,-4,-9,0,-4,4,1,0,1,-1,1,1,1,3,-1
KR_6753321152,440,6,144,17,9,4,1,5,-3,5,2,3,3,6,3,5,8,2,1,3,-1,1,-2,1,-4,3,4,0,1,-1,0,1,-1,2,-1
KR_6739040029,440,-2,-17,0,-10,0,4,4,0,2,2,-4,7,3,-1,2,1,-5,6,1,0,-8,362,0,0,0,0,0,0,1,1,-1,-1,3,-1
KR_6747461723,420,1,44,6,-2,-1,3,2,-4,6,2,1,2,3,2,0,2,0,0,0,0,-1,37,5,-8,3,-4,0,0,0,0,0,-1,0,-1
KR_6747726864,420,0,-49,4,1,2,2,4,2,4,6,-3,3,0,1,1,2,-1,2,1,0,4,4,3,-9,6,-5,0,-1,-1,0,-1,1,2,-1
KR_6759078932,420,2,110,7,3,4,1,5,-2,7,5,-1,1,0,1,1,2,1,1,2,1,-2,22,3,-3,0,-2,0,1,1,1,1,1,4,-1
KR_6697779157,420,-2,-65,0,-4,2,2,4,0,1,1,-4,4,0,-1,3,2,-1,2,1,0,-6,-123,-2,-1,3,1,0,-1,-1,1,-1,-1,2,-1
KR_6718113358,420,1,25,14,5,4,0,4,0,3,3,-2,5,3,1,7,8,2,0,2,-1,-2,130,-1,-4,5,-1,0,2,-1,1,1,-1,4,-1
KR_6763492292,420,-2,-83,-12,-10,0,2,2,-1,5,4,-3,3,0,-4,6,2,-2,3,1,0,-14,3,-1,-3,4,-1,0,-2,-1,-1,-1,-1,3,-1
KR_6730664098,420,-3,-21,-12,-7,-1,1,0,-1,3,2,-4,6,2,2,2,4,-3,4,1,0,-8,302,-4,-3,7,1,0,0,1,-1,0,-1,1,-1
KR_6764567566,420,-2,-11,-10,-3,0,0,0,2,1,3,-5,6,1,1,1,2,-1,2,1,0,0,16,-5,-2,7,5,0,-1,-1,1,-1,-1,1,-1
KR_6757849243,420,-1,-4,-3,-6,-1,2,1,-5,5,0,-3,6,3,1,2,3,2,0,2,0,-6,-2,-3,-3,6,3,0,-1,-1,-1,-1,-1,4,-1
KR_6634316643,420,-5,-60,-56,-10,0,1,1,-4,7,3,-4,4,0,-1,3,2,-1,1,0,0,-6,-7,0,-3,3,4,0,-1,-1,-1,-1,1,4,-1
KR_6685879119,440,-3,-11,-20,-8,1,2,3,2,0,2,-1,5,4,-8,10,2,-2,2,0,0,-8,2,-1,-1,2,-3,0,-1,1,-1,-1,-1,4,-1
KR_6764257216,420,-4,18,-16,-9,1,1,2,0,3,3,-2,4,2,1,1,2,-9,10,1,-1,-10,1,4,-6,2,-5,0,0,0,0,0,-1,0,-1
KR_6672032869,440,0,-15,-36,-6,-2,5,3,4,2,6,-3,5,2,0,1,1,-5,5,0,1,-2,-40,2,-2,0,2,0,-1,-1,-1,-1,1,1,-1
KR_6760975214,420,-5,-134,-13,-12,-3,4,1,-1,2,1,-1,3,2,-5,5,0,-2,2,0,0,-6,-7,-1,-4,5,-2,0,-2,-1,1,-1,1,4,-1
KR_6716362297,420,-5,-56,-26,-11,0,1,1,-3,5,2,1,1,2,-2,6,4,-7,7,0,-3,-19,-8,2,-6,4,1,0,-1,-1,-1,-1,-1,6,-1
KR_6714205982,420,-8,-83,-49,-17,-2,3,1,-4,6,2,-3,3,0,-6,9,3,-2,2,0,-1,-17,-33,-2,-2,4,-3,0,-1,-1,-1,-1,-1,1,-1
KR_6750508147,420,0,34,14,-1,0,1,1,0,2,2,0,5,5,-2,3,1,1,0,1,0,-3,-3,0,-4,4,-2,0,-1,-1,-1,-1,-1,4,-1
KR_6752640134,420,2,80,7,5,-2,3,1,1,0,1,1,4,5,5,1,6,0,3,3,2,9,-107,4,-8,4,2,0,1,1,1,1,1,3,-1
KR_6654905036,420,-2,-35,-3,-3,1,1,2,-2,4,2,-1,2,1,-3,9,6,2,2,4,1,-2,11,-2,-3,5,-3,0,0,-1,1,-1,1,1,-1
KR_6742525143,420,2,-13,-7,-6,-2,4,2,-3,3,0,1,6,7,-2,4,2,0,0,0,0,-6,86,-7,-2,9,4,0,0,-1,1,-1,1,5,-1
KR_6729832554,420,-2,-90,-4,-2,-4,4,0,1,4,5,5,2,7,-3,6,3,-1,1,0,-1,-4,-5,1,-5,4,1,0,-1,-1,-1,-1,-1,6,-1
KR_6647058136,420,-2,-39,-40,-9,2,1,3,-4,5,1,-4,4,0,-3,5,2,0,1,1,-1,-5,4,-1,-2,3,-2,0,-2,-1,-1,-1,-1,6,-1
KR_6676979837,420,1,-1,-12,4,-6,7,1,-2,2,0,2,0,2,8,1,9,2,1,3,0,4,-46,-3,-2,5,27,0,0,-1,-1,-1,1,3,-1
KR_6764347236,420,3,-8,24,6,-2,2,0,-2,4,2,4,1,5,2,5,7,4,0,4,0,-2,-2,7,-9,2,-3,0,0,0,1,0,1,0,-1
KR_6442078580,420,-1,-42,4,-2,-1,3,2,0,4,4,-4,5,1,3,2,5,0,1,1,0,-7,207,-1,-6,7,1,0,1,1,-1,1,1,2,-1
KR_6669265799,420,-1,32,-46,-5,-2,3,1,-2,6,4,1,1,2,-2,5,3,0,1,1,-4,-10,-9,-1,-4,5,2,0,0,-1,-1,0,-1,1,-1
KR_6763898111,420,-3,-28,14,-5,1,3,4,-1,3,2,0,0,0,-4,4,0,-1,1,0,0,-8,-14,-3,-3,6,-2,0,-1,1,-1,-1,-1,1,-1
KR_6755267476,420,-2,-50,-28,-1,2,0,2,-3,3,0,-3,5,2,3,3,6,0,0,0,1,-2,-27,2,-3,1,-3,0,0,-1,1,0,1,5,-1
KR_6727158563,420,-5,-48,-23,-7,-5,5,0,-1,2,1,-5,7,2,0,1,1,4,2,6,0,0,20,-6,-1,7,-30,0,-2,0,-1,-1,-1,0,-1
KR_6664904823,420,-2,41,-12,-9,1,0,1,-3,4,1,-7,7,0,2,3,5,-2,4,2,0,-6,-34,0,-5,5,36,0,0,1,-1,0,1,3,-1
KR_6747239737,420,-4,-7,-52,-7,3,0,3,-9,10,1,1,2,3,-2,4,2,0,1,1,0,-14,169,1,-4,3,-2,0,0,1,0,-1,1,3,-1
KR_6750575430,420,-3,17,8,-3,-2,2,0,-6,7,1,3,2,5,2,0,2,0,1,1,0,-6,-16,-1,-2,3,2,0,0,1,-1,0,1,3,-1
KR_6764307594,420,-3,-68,20,-6,-1,4,3,0,3,3,-2,4,2,-3,4,1,0,0,0,-1,1,185,-1,-2,3,21,0,-1,0,-1,-1,-1,0,-1
KR_6754355075,420,0,-19,20,0,2,2,4,1,2,3,-3,3,0,0,2,2,0,0,0,-1,-4,4,1,-4,3,1,0,0,-1,1,0,-1,2,-1
KR_6763826235,420,-2,-56,-4,-4,3,1,4,-1,4,3,-1,3,2,-4,5,1,-1,3,2,0,-10,0,3,-6,3,0,0,0,1,-1,-1,1,1,-1
KR_6744532425,420,-2,35,-12,-11,2,0,2,1,2,3,-7,7,0,-7,8,1,0,1,1,-3,-24,-14,-5,-4,9,0,0,-1,1,1,-1,-1,4,-1
KR_6654921289,420,-2,-32,-8,2,-2,3,1,4,3,7,-1,2,1,1,0,1,0,0,0,0,3,-25,-3,-1,4,5,0,-1,0,-1,-1,-1,0,-1
KR_6761973470,420,0,17,16,-2,-1,3,2,-2,4,2,0,4,4,1,1,2,0,3,3,0,1,6,-1,-1,2,3,0,0,-1,-1,0,-1,5,-1
KR_6747644713,440,-3,19,24,-8,0,2,2,-3,4,1,-3,4,1,-2,6,4,0,2,2,0,-6,-7,-4,-2,6,2,0,0,-1,1,-1,1,3,-1
KR_6716851489,420,-3,11,0,-8,1,0,1,-3,5,2,-5,9,4,1,1,2,-2,3,1,0,-19,14,3,-7,4,2,0,-1,-1,-1,-1,-1,3,-1
KR_6516006608,420,-3,-116,-9,-7,-8,8,0,2,4,6,-2,2,0,0,6,6,1,2,3,-1,0,-4,0,-3,3,-1,0,-1,1,1,-1,-1,5,-1
KR_6742830817,420,-5,-111,-5,-10,2,0,2,-8,9,1,-2,2,0,-3,5,2,1,1,2,0,-8,-132,1,-4,3,-2,0,-3,-1,-1,-1,-1,4,-1
KR_6611646576,420,-1,-107,5,-7,0,4,4,-1,5,4,-4,4,0,-4,5,1,2,0,2,-1,-8,48,-2,-2,4,-4,0,-1,-1,-1,-1,-1,3,-1
KR_6599734576,420,-3,-70,0,-1,-1,2,1,-1,5,4,0,3,3,1,3,4,0,1,1,0,2,-242,0,-2,2,-2,0,0,-1,0,1,1,6,-1
KR_6757154841,420,-5,-12,-36,-10,-2,5,3,-2,5,3,2,1,3,-5,6,1,-3,3,0,1,-14,-3,0,-5,5,-3,0,-1,-1,-1,-1,1,5,-1
KR_6762041764,420,1,-27,28,-3,2,2,4,-3,7,4,-3,5,2,1,2,3,0,1,1,0,-2,4,-2,-5,7,-4,0,0,1,0,0,1,3,-1
KR_6733526419,420,-2,-1,-7,-5,-5,5,0,-4,6,2,1,2,3,2,1,3,1,0,1,-1,-1,0,-2,-5,7,3,0,0,-1,-1,0,-1,1,-1
KR_6718282774,420,0,-11,12,-2,-1,1,0,4,2,6,-2,3,1,-3,5,2,0,0,0,-1,-9,-3,-1,-2,3,2,0,0,-1,1,0,-1,4,-1
KR_6764190635,420,2,27,8,2,0,4,4,-4,5,1,0,3,3,9,1,10,-3,4,1,1,-6,-1,-1,-4,5,6,0,0,1,0,0,1,5,-1
KR_6704910587,420,2,28,3,6,0,1,1,0,2,2,3,1,4,3,0,3,0,0,0,0,4,-56,-4,-5,9,35,0,0,-1,1,-1,1,5,-1
KR_6603570153,420,-6,-88,-16,-10,-6,8,2,1,4,5,-1,1,0,-3,4,1,-1,2,1,0,-7,-7,0,-2,2,-2,0,0,-1,0,-1,1,6,-1
KR_6744507625,420,1,-33,22,0,-5,5,0,3,2,5,0,1,1,0,2,2,2,0,2,0,0,-11,-4,-3,7,0,0,-1,1,-1,-1,-1,2,-1
KR_6762421256,440,-5,-109,-8,-16,-2,3,1,1,5,6,-5,5,0,-11,11,0,1,1,2,-1,-10,-39,-1,-3,4,0,0,-2,1,1,-1,-1,3,-1
KR_6763639055,420,-3,-31,-18,-9,-4,6,2,-6,8,2,-3,4,1,0,1,1,4,2,6,0,-9,-8,-9,-4,13,-1,0,0,-1,-1,0,-1,6,-1
KR_6654598770,420,-2,31,18,-5,4,1,5,-3,6,3,1,2,3,-2,2,0,-5,6,1,0,-8,-41,-2,-3,5,21,0,-1,-1,1,-1,-1,6,-1
KR_6751533266,420,0,-5,-15,-4,-3,3,0,3,1,4,-4,6,2,1,2,3,-1,2,1,0,-1,7,-4,-3,7,0,0,0,1,0,0,-1,3,-1
KR_6747383672,420,0,28,14,2,4,2,6,-3,7,4,2,0,2,-2,4,2,1,1,2,1,-4,-9,-2,-2,4,2,0,0,-1,-1,0,1,5,-1
KR_6759909636,420,-4,-81,-11,-4,1,2,3,2,0,2,-8,9,1,-2,3,1,3,0,3,0,-1,16,-4,-4,8,-1,0,-2,1,-1,-1,1,3,-1
KR_6692275897,420,2,-22,20,-7,-2,3,1,-1,5,4,-4,4,0,0,2,2,0,0,0,0,-5,-4,-2,-4,6,-2,0,-2,-1,-1,-1,-1,5,-1
KR_6409854798,420,4,6,31,7,2,0,2,0,1,1,-1,7,6,4,1,5,2,2,4,-1,6,33,-1,-2,3,2,0,2,0,0,1,-1,0,-1
KR_6735210098,440,2,-13,-3,8,-1,1,0,-3,8,5,2,2,4,10,0,10,0,4,4,2,8,2,4,-6,2,1,0,-1,1,-1,-1,1,3,-1
KR_6717743996,420,-2,-82,-10,-4,0,1,1,-3,3,0,4,1,5,-3,6,3,-2,2,0,0,-2,5,2,-2,0,-3,0,1,1,1,1,-1,5,-1
KR_6741280444,440,5,-10,-1,5,2,1,3,3,2,5,2,1,3,-1,1,0,-1,1,0,0,6,0,-1,-4,5,1,0,0,1,0,0,1,1,-1
KR_6723089648,420,-1,39,-24,5,0,2,2,2,2,4,1,3,4,1,1,2,1,1,2,0,4,-21,0,-4,4,20,0,0,-1,-1,1,1,1,-1
KR_6746402383,420,0,13,-12,-3,-1,2,1,-6,8,2,0,1,1,1,4,5,3,0,3,0,-8,-6,-1,-3,4,0,0,0,-1,1,0,-1,2,-1
KR_6761765852,440,0,39,-4,4,1,1,2,1,2,3,-1,4,3,2,1,3,1,2,3,0,5,8,1,-3,2,1,0,0,0,0,0,1,0,-1
KR_6529654707,420,-4,-61,4,-10,-7,7,0,-2,5,3,0,1,1,-1,5,4,0,1,1,0,-4,89,-3,-1,4,-1,0,-2,1,1,-1,-1,3,-1
KR_6724862191,440,-1,15,20,-4,-6,8,2,-1,2,1,0,4,4,3,0,3,0,0,0,0,-9,-6,0,-5,5,2,0,0,-1,-1,0,1,2,-1
KR_6761707795,440,0,-18,21,3,-1,4,3,2,0,2,2,0,2,2,1,3,-2,2,0,0,8,-2,-2,-8,10,3,0,0,1,0,1,1,1,-1
KR_6728930043,440,-1,61,-4,-5,-1,4,3,-6,7,1,3,0,3,0,2,2,-1,2,1,1,-3,-4,4,-5,1,-1,0,0,-1,-1,0,1,1,-1
KR_6599871069,420,0,-24,16,-7,-1,2,1,-1,3,2,-7,10,3,0,4,4,2,0,2,0,-3,-34,-1,-3,4,-2,0,0,-1,1,0,-1,3,-1
KR_6760789259,440,-2,-82,-18,0,2,3,5,-1,4,3,2,0,2,-3,5,2,0,2,2,0,-1,1,-1,-6,7,-6,0,1,-1,0,1,-1,5,-1
KR_6747363515,420,-4,-61,24,-17,1,1,2,-1,3,2,-6,10,4,-7,8,1,-4,4,0,-1,-17,-7,-4,0,4,0,0,-2,-1,-1,-1,-1,2,-1
KR_6751952703,440,-3,-33,-31,1,-2,3,1,-5,7,2,5,1,6,4,2,6,-1,2,1,0,1,5,-1,-3,4,-2,0,-1,-1,1,-1,-1,3,-1
KR_6619198189,420,-6,-82,12,-13,-3,5,2,-3,5,2,-3,4,1,-6,7,1,2,0,2,-1,-11,-225,-8,0,8,0,0,-1,-1,0,-1,-1,4,-1
KR_6707175006,420,-1,-25,19,0,1,0,1,-1,8,7,-2,4,2,2,2,4,0,0,0,-1,4,98,-7,-2,9,3,0,1,-1,1,1,1,2,-1
KR_6733916945,420,-1,12,-32,-3,-3,4,1,-2,2,0,0,2,2,2,0,2,0,0,0,0,4,-386,-4,-4,8,8,0,0,-1,-1,0,-1,6,-1
KR_6761910652,420,-1,-18,-15,-7,-2,2,0,0,1,1,-1,4,3,-5,8,3,1,1,2,0,-12,11,2,-6,4,-3,0,-1,-1,1,-1,-1,1,-1
KR_6730578340,420,5,103,19,5,2,1,3,1,4,5,2,0,2,0,2,2,0,1,1,0,-7,-37,-1,-3,4,24,0,2,1,-1,1,1,3,-1
KR_6762792554,420,-1,18,-1,-2,-3,5,2,-2,4,2,5,0,5,-1,3,2,-1,1,0,0,-2,26,-2,-1,3,-5,0,-1,-1,1,-1,1,6,-1
KR_6762203741,420,-3,-57,-4,-4,-1,1,0,1,1,2,-1,3,2,-2,3,1,-1,1,0,0,-2,5,2,-3,1,-6,0,0,1,1,0,-1,5,-1
KR_6574977011,440,-3,-19,13,-16,-5,5,0,2,2,4,-1,2,1,-10,10,0,-2,2,0,-1,-22,0,0,-2,2,0,0,-1,-1,1,-1,-1,1,-1
KR_6733482086,420,-2,19,-4,-9,-3,4,1,-7,7,0,3,0,3,-2,3,1,0,0,0,0,-10,0,0,-3,3,4,0,0,1,-1,0,-1,3,-1
KR_6718008723,420,2,12,-4,5,2,2,4,3,0,3,0,3,3,1,3,4,-1,2,1,0,3,-2,5,-7,2,-3,0,0,-1,-1,1,-1,1,-1
KR_6679296166,420,0,0,0,-1,-1,2,1,1,7,8,0,2,2,-1,4,3,0,0,0,0,-4,311,-1,-2,3,0,0,1,1,1,1,1,6,-1
KR_6740705572,420,-3,-54,7,-10,-7,7,0,-1,2,1,1,3,4,-2,3,1,-1,3,2,0,-7,-9,-5,-3,8,-3,0,-2,-1,-1,-1,-1,6,-1
KR_6741011488,420,-6,-77,-24,-18,-5,5,0,-1,2,1,-5,5,0,-5,5,0,-2,2,0,-1,-14,158,-4,-1,5,-2,0,-3,-1,-1,-1,-1,4,-1
KR_6736486849,420,1,98,-37,5,1,2,3,1,3,4,1,2,3,-2,5,3,4,0,4,0,-3,-32,0,-4,4,0,0,0,-1,1,0,1,1,-1
KR_6763032484,420,1,-29,-6,0,-1,2,1,2,2,4,-1,5,4,-2,5,3,2,2,4,1,1,88,-1,-2,3,0,0,1,-1,1,1,1,5,-1
KR_6540129995,420,-2,-56,-10,-2,-1,1,0,-1,2,1,0,2,2,0,0,0,0,0,0,0,0,-69,-4,0,4,0,0,0,-1,-1,-1,-1,5,-1
KR_6757069338,420,-1,2,-11,-6,2,2,4,-2,4,2,0,1,1,-7,8,1,1,0,1,1,-9,19,-2,-4,6,-6,0,-1,-1,1,-1,1,1,-1
KR_6763179028,420,-3,-28,-12,-7,-5,5,0,0,4,4,2,0,2,-1,3,2,-3,3,0,-1,-10,0,2,-5,3,1,0,0,-1,-1,0,-1,4,-1
KR_6745872211,420,-2,-43,-20,3,1,1,2,3,1,4,2,3,5,-3,7,4,0,0,0,0,10,3,2,-3,1,0,0,1,1,1,-1,1,3,-1
KR_6762100792,420,2,77,24,2,4,1,5,2,1,3,-3,3,0,0,1,1,-1,1,0,0,-4,0,-1,-1,2,-3,0,0,-1,-1,0,1,1,-1
KR_6273342369,440,-1,-60,8,-2,3,0,3,-2,5,3,0,7,7,-3,9,6,0,3,3,0,-8,-8,0,-7,7,0,0,0,1,-1,0,-1,4,-1
KR_6705549958,440,-2,11,-28,-1,0,3,3,-2,3,1,-2,3,1,2,3,5,1,3,4,0,0,6,-1,-3,4,-1,0,-1,1,-1,-1,1,3,-1
KR_6676755869,420,-4,-23,-23,-7,1,3,4,-4,6,2,2,2,4,-5,7,2,-1,2,1,0,-3,-6,-3,-2,5,-2,0,0,-1,0,1,-1,5,-1
KR_6725050990,420,-4,-35,-11,-9,-3,4,1,-3,4,1,-2,3,1,-2,3,1,1,1,2,0,-9,4,-4,0,4,3,0,0,-1,-1,-1,1,5,-1
KR_6763770360,420,1,6,2,2,5,1,6,-6,6,0,1,1,2,-3,4,1,5,0,5,0,-2,-3,-4,-4,8,1,0,0,1,0,0,-1,6,-1
KR_6721753907,440,3,15,28,3,0,0,0,3,1,4,-2,5,3,1,2,3,1,2,3,0,-1,10,3,-7,4,0,0,1,1,1,1,1,2,-1
KR_6687475568,420,-6,-11,-12,-10,-2,3,1,3,1,4,-7,8,1,-2,2,0,-2,2,0,0,-5,-4,-3,-4,7,-3,0,-2,-1,-1,-1,-1,1,-1
KR_6643329233,420,0,-15,-8,3,-1,1,0,3,0,3,-1,4,3,2,0,2,0,0,0,2,12,20,3,-6,3,-2,0,0,0,-1,0,1,0,-1
KR_6752049823,440,-2,-54,0,-5,-2,3,1,-2,2,0,1,0,1,-2,2,0,0,5,5,0,-3,112,1,-3,2,0,0,0,0,0,0,1,0,-1
KR_6761273530,420,-3,8,12,-2,-3,4,1,0,1,1,-1,4,3,1,1,2,1,1,2,0,0,7,1,-4,3,-2,0,-1,1,1,-1,1,1,-1
KR_6570272518,420,-3,-33,-2,-4,-3,4,1,-1,3,2,0,3,3,-1,5,4,1,0,1,-1,-2,45,-3,-4,7,-14,0,0,1,0,-1,-1,5,-1
KR_6723141207,420,-7,-22,-28,-18,-1,2,1,-2,3,1,-1,2,1,-11,11,0,-3,3,0,0,-15,-2,-1,-1,2,-4,0,-1,-1,0,-1,-1,6,-1
KR_6760741144,420,-1,-79,-23,-1,-1,4,3,1,1,2,-1,2,1,-1,3,2,1,0,1,0,-1,-2,-1,-5,6,0,0,0,-1,0,0,1,3,-1
KR_6725851484,420,-5,-46,-16,-17,0,2,2,-2,2,0,-6,6,0,-5,6,1,-4,5,1,0,-16,-11,1,-2,1,0,0,-2,-1,1,-1,-1,6,-1
KR_6670584948,420,-4,-75,-40,-8,-2,2,0,0,3,3,-5,6,1,1,2,3,-2,2,0,0,0,-308,4,-5,1,-5,0,-1,1,-1,-1,-1,4,-1
KR_6624940784,420,1,-22,20,-4,-2,3,1,-1,5,4,1,2,3,1,0,1,-3,3,0,0,-4,5,2,-5,3,-4,0,-1,-1,-1,-1,-1,3,-1
KR_6741575434,420,-3,-117,4,-11,1,0,1,-3,4,1,0,3,3,-8,10,2,-1,3,2,0,-9,2,-4,-2,6,1,0,-2,-1,0,-1,-1,6,-1
KR_6759937367,420,-3,-27,-2,-6,0,2,2,-1,3,2,3,0,3,-6,7,1,-2,3,1,0,-6,-13,0,-4,4,-1,0,0,-1,-1,-1,-1,1,-1
KR_6760847665,440,-3,-67,-22,0,5,0,5,-1,3,2,-4,5,1,0,2,2,0,1,1,1,1,-40,4,-9,5,2,0,-1,1,1,-1,-1,6,-1
KR_6739728233,420,-2,-27,13,-4,-3,3,0,-1,2,1,0,0,0,0,2,2,0,1,1,0,-6,-2,-3,-3,6,1,0,0,-1,1,0,-1,3,-1
KR_6755459786,440,4,76,-8,9,4,1,5,2,3,5,4,2,6,0,2,2,-1,2,1,2,-1,14,-2,-1,3,-1,0,1,1,1,1,1,3,-1
KR_6575670374,420,-1,39,-34,-5,-2,3,1,-4,6,2,-3,4,1,4,1,5,0,2,2,0,-5,-8,-5,-1,6,-2,0,0,-1,-1,1,-1,2,-1
KR_6724606184,420,1,8,-8,-2,-2,3,1,2,0,2,1,1,2,-6,6,0,3,1,4,0,0,-23,-3,-2,5,-1,0,0,-1,1,-1,-1,3,-1
KR_6742405963,420,0,-108,-12,-6,-3,3,0,-2,4,2,-1,1,0,-1,2,1,1,0,1,0,-5,-7,-6,0,6,1,0,0,-1,-1,0,-1,3,-1
KR_6654313226,420,-2,-104,-20,0,2,1,3,1,1,2,-1,2,1,-2,2,0,0,1,1,0,1,-1,0,-4,4,0,0,0,-1,1,0,-1,5,-1
KR_6745883124,440,-2,-8,-13,2,-2,2,0,1,0,1,3,1,4,-2,4,2,2,1,3,0,2,1,-2,-1,3,1,0,-1,-1,1,-1,-1,6,-1
KR_6752559621,420,3,-3,-19,5,0,2,2,-2,4,2,7,1,8,0,2,2,0,0,0,0,7,-9,2,-5,3,3,0,0,0,0,0,1,0,-1
KR_6720721366,420,-5,-63,-10,-9,-9,9,0,0,2,2,2,2,4,-3,3,0,1,0,1,2,2,-191,4,-6,2,1,0,-1,0,-1,-1,1,0,-1
KR_6744149816,420,3,2,13,5,2,0,2,2,7,9,0,3,3,1,1,2,0,1,1,-1,-4,1,1,-8,7,-3,0,-2,-1,-1,-1,-1,3,-1
KR_6754020910,420,1,96,-32,-2,0,2,2,-3,6,3,1,2,3,0,3,3,0,1,1,0,1,-1,1,-2,1,3,0,0,0,-1,0,-1,0,-1
KR_6755252636,420,0,-18,4,3,3,1,4,1,1,2,1,5,6,-2,3,1,0,1,1,0,1,7,3,-5,2,-3,0,1,1,-1,1,1,2,-1
KR_6568866889,420,-4,-44,-16,-2,-3,6,3,0,0,0,-3,4,1,2,1,3,2,1,3,0,1,-222,-2,-2,4,2,0,0,-1,-1,-1,1,6,-1
KR_6764200433,420,1,44,36,-2,0,2,2,0,0,0,1,0,1,0,0,0,-3,3,0,0,-3,-4,3,-7,4,-3,0,1,-1,1,1,-1,3,-1
KR_6764301413,420,-6,-70,-20,-14,-4,4,0,-1,1,0,0,2,2,-4,4,0,-5,5,0,0,-12,3,4,-7,3,-1,0,-2,0,1,-1,-1,0,-1
KR_6716705417,420,-3,0,-12,-4,-3,3,0,1,2,3,1,1,2,-1,6,5,-2,3,1,0,1,3,5,-7,2,-2,0,0,-1,0,0,1,2,-1
KR_6764286652,420,-1,-66,7,-4,-3,3,0,-2,3,1,3,0,3,-2,2,0,0,1,1,0,-9,0,1,-5,4,-2,0,-1,1,-1,-1,-1,1,-1
KR_6759870085,420,3,41,0,4,1,1,2,1,0,1,-3,3,0,5,0,5,0,0,0,0,6,4,-1,-4,5,1,0,0,0,-1,0,1,0,-1
KR_6600394599,420,-1,23,-4,-3,-4,4,0,-4,5,1,0,3,3,3,1,4,2,3,5,0,-3,2,0,-3,3,1,0,-1,-1,1,-1,-1,3,-1
KR_6741291273,420,-3,-34,15,-9,1,0,1,2,1,3,-6,7,1,-3,6,3,-3,4,1,1,-4,-2,-3,-2,5,-1,0,-1,1,-1,-1,1,5,-1
KR_6695300636,420,-5,-58,-8,-5,-2,4,2,-2,3,1,1,1,2,-2,3,1,0,1,1,0,-3,41,1,-5,4,-12,0,-1,-1,0,-1,-1,1,-1
KR_6593858250,420,-6,-8,-32,-10,-3,3,0,1,0,1,-3,6,3,-3,5,2,-2,2,0,0,-9,10,1,-5,4,-3,0,-2,1,-1,-1,-1,4,-1
KR_6718139601,420,-3,10,-28,-8,-4,4,0,-5,5,0,1,2,3,-4,7,3,4,0,4,0,-11,-46,1,-4,3,-2,0,-1,-1,-1,-1,-1,6,-1
KR_6534786203,420,-1,-13,-4,-3,-2,2,0,3,1,4,-2,4,2,-3,4,1,1,2,3,0,-5,389,-3,0,3,1,0,1,-1,1,1,-1,5,-1
KR_6649897717,420,0,33,-8,-4,0,1,1,0,2,2,0,2,2,-2,2,0,-2,2,0,-1,0,-5,-6,-2,8,4,0,0,-1,1,0,-1,6,-1
KR_6708756479,420,0,-31,-8,-3,-2,3,1,-1,2,1,1,2,3,0,3,3,-1,1,0,0,4,11,3,-9,6,-3,0,-1,1,1,-1,-1,2,-1
KR_6695343122,420,1,57,16,-1,3,2,5,5,2,7,0,3,3,-4,6,2,-5,8,3,1,-1,-303,8,-8,0,-4,0,1,1,1,-1,1,3,-1
KR_6756630466,420,1,-62,-25,4,4,1,5,0,1,1,-4,6,2,-1,2,1,5,0,5,0,1,-11,0,-3,3,0,0,0,-1,-1,1,1,1,-1
KR_6678788520,420,-5,-58,-51,-12,0,2,2,-6,8,2,-3,3,0,-1,4,3,-2,4,2,0,-10,-18,-4,-7,11,1,0,-1,-1,-1,-1,1,4,-1
KR_6634214517,420,-3,-75,17,-16,-1,2,1,-2,5,3,-3,3,0,-9,10,1,-1,1,0,0,-14,-7,-5,-4,9,-5,0,-1,-1,1,-1,-1,2,-1
KR_6723945150,440,-2,-13,-3,-10,1,2,3,0,4,4,-3,4,1,-1,4,3,-7,7,0,0,-7,-16,-3,-3,6,2,0,0,-1,0,0,-1,5,-1
KR_6764069062,420,5,127,8,4,0,0,0,-3,4,1,2,3,5,5,0,5,0,2,2,0,4,-14,1,-2,1,-1,0,0,1,1,1,-1,3,-1
KR_6760788535,420,-1,-1,-26,-9,7,1,8,-4,6,2,0,3,3,-8,8,0,-4,5,1,0,-11,2,-5,-6,11,1,0,1,-1,1,1,1,6,-1
KR_6753212570,420,-7,-102,-19,-10,-1,5,4,1,2,3,-3,3,0,-4,4,0,-3,3,0,-1,-21,-10,-5,-2,7,-1,0,0,-1,1,-1,-1,4,-1
KR_6763339491,440,-2,-91,20,-5,3,1,4,1,1,2,-4,5,1,-2,2,0,-3,3,0,0,-3,-4,-2,-2,4,-3,0,-1,1,-1,-1,1,5,-1
KR_6764576322,420,-1,-59,3,3,-2,3,1,0,0,0,3,1,4,2,0,2,0,1,1,0,3,-3,-4,-1,5,3,0,0,0,-1,0,1,0,-1
KR_6609850756,420,2,26,12,-1,-1,4,3,2,3,5,3,1,4,-4,4,0,-1,2,1,0,-1,0,3,-5,2,1,0,1,0,0,1,1,0,-1
KR_6741293307,420,-4,-67,27,-3,-6,6,0,-3,4,1,2,0,2,3,1,4,1,1,2,0,-9,-299,1,-3,2,3,0,-1,-1,1,-1,-1,6,-1
KR_6739168086,420,-9,-142,-31,-11,-4,4,0,-1,1,0,-7,8,1,3,4,7,-2,3,1,0,-10,-37,-3,-3,6,22,0,-5,-1,-1,-1,1,1,-1
KR_6642844767,420,-1,-64,-45,-1,0,1,1,-8,10,2,4,0,4,3,0,3,0,1,1,1,-5,-4,3,-4,1,-2,0,0,1,-1,-1,1,6,-1
KR_6760283654,420,-2,-39,0,-10,-3,5,2,0,2,2,1,3,4,-4,8,4,-4,5,1,0,-12,1,0,-3,3,-3,0,0,1,1,0,-1,3,-1
KR_6751309316,420,-4,48,0,-15,1,2,3,-1,2,1,-7,9,2,-8,8,0,0,0,0,0,-10,28,-1,-3,4,-22,0,0,0,0,-1,-1,0,-1
KR_6757884656,420,2,18,8,5,-1,2,1,3,1,4,0,0,0,3,2,5,0,1,1,0,2,19,0,-3,3,6,0,1,0,0,1,1,0,-1
KR_6693656828,420,-1,51,-3,-3,2,2,4,-2,3,1,1,1,2,-3,3,0,-1,1,0,0,-3,40,2,-3,1,-14,0,0,-1,-1,-1,-1,5,-1
KR_6721275021,420,2,7,23,1,-3,4,1,1,3,4,2,0,2,1,1,2,0,0,0,0,2,0,5,-7,2,-2,0,0,-1,-1,0,-1,6,-1
KR_6758881792,420,-1,-51,-10,-6,-1,4,3,3,0,3,-6,6,0,-2,2,0,0,2,2,0,-1,19,0,-3,3,0,0,0,-1,1,0,-1,5,-1
KR_6762755737,420,3,33,16,8,0,3,3,0,3,3,6,1,7,3,1,4,-1,1,0,1,8,7,2,-3,1,0,0,0,1,-1,1,1,2,-1
KR_6690705338,440,-3,51,0,-6,3,0,3,-2,5,3,-3,3,0,3,1,4,-7,7,0,0,-10,-13,-1,-3,4,3,0,0,-1,-1,0,1,5,-1
KR_6756959371,420,1,-16,28,0,-1,3,2,4,1,5,-1,3,2,-1,3,2,-1,3,2,0,-1,8,2,-3,1,3,0,0,-1,-1,-1,-1,6,-1
KR_6750383617,420,-3,-127,0,4,-1,3,2,2,1,3,-4,4,0,3,2,5,4,0,4,0,9,30,4,-5,1,1,0,-1,1,1,-1,-1,6,-1
KR_6728488289,420,-1,-30,20,-4,-2,3,1,2,0,2,-2,6,4,-1,1,0,-1,2,1,1,-1,-13,-3,-3,6,5,0,-1,1,1,-1,1,1,-1
KR_6678681316,420,-3,-57,8,-9,-4,4,0,-2,3,1,1,2,3,-5,7,2,1,0,1,0,-9,1,2,-8,6,-1,0,0,0,1,0,1,0,-1
KR_6764021771,420,2,29,36,3,2,0,2,2,3,5,-2,4,2,0,3,3,1,1,2,1,4,-3,4,-7,3,-2,0,0,1,1,0,1,6,-1
KR_6723870845,420,-4,-104,-7,-14,-4,4,0,-9,10,1,0,3,3,0,4,4,-1,2,1,-3,-20,-8,0,-5,5,5,0,-2,-1,-1,-1,-1,6,-1
KR_6751315056,420,-3,-82,-13,0,-2,2,0,2,1,3,-3,6,3,-2,9,7,5,2,7,0,4,0,0,-5,5,-5,0,0,-1,1,-1,-1,6,-1
KR_6722489712,420,-1,0,-28,-1,2,2,4,-2,5,3,0,1,1,-1,2,1,0,0,0,0,1,58,1,-6,5,7,0,0,1,-1,-1,-1,1,-1
KR_6758173895,420,-1,-5,4,-5,5,0,5,-1,3,2,-5,9,4,-5,6,1,1,1,2,0,0,53,5,-6,1,0,0,-1,0,1,-1,-1,0,-1
KR_6698769126,420,0,51,-28,-5,1,0,1,-1,4,3,-3,4,1,-3,7,4,1,0,1,-1,-2,33,-4,-3,7,-5,0,0,-1,-1,-1,-1,2,-1
KR_6750819343,440,-4,10,-4,-8,-1,1,0,-1,3,2,5,1,6,-12,12,0,1,0,1,1,-10,-19,-6,-1,7,-4,0,0,-1,0,0,1,6,-1
KR_6729678025,420,-3,-7,-15,1,1,0,1,-2,5,3,-1,4,3,-1,3,2,4,0,4,0,2,-357,-1,-3,4,1,0,-1,1,-1,-1,-1,6,-1
KR_6764085669,420,1,26,-13,2,1,3,4,1,1,2,-2,3,1,4,1,5,-2,2,0,0,3,20,1,-3,2,-3,0,2,1,-1,1,1,6,-1
KR_6704038433,420,-2,-18,8,-9,-3,3,0,1,3,4,-3,4,1,-4,4,0,0,1,1,0,-5,0,-3,-3,6,3,0,0,1,1,0,-1,4,-1
KR_6726957146,440,0,-36,0,0,-1,3,2,1,3,4,-1,3,2,-2,4,2,3,3,6,0,6,-7,-4,-2,6,2,0,1,-1,-1,1,1,1,-1
KR_6590861387,420,-5,-27,-24,-3,-2,3,1,3,0,3,-2,5,3,-1,5,4,-1,1,0,-1,-5,277,-2,0,2,0,0,-1,-1,-1,-1,1,5,-1
KR_6725201119,420,-3,-102,-12,-7,-6,7,1,3,0,3,0,2,2,-4,4,0,0,0,0,0,1,-5,-3,-2,5,-3,0,-3,-1,-1,-1,-1,2,-1
KR_6749311967,420,-7,-60,-67,-17,-1,2,1,-5,7,2,-4,5,1,-8,9,1,1,1,2,0,-23,8,-2,-5,7,-33,0,0,-1,1,-1,-1,5,-1
KR_6714353800,420,4,60,4,6,1,0,1,1,0,1,-4,10,6,5,0,5,3,0,3,-1,19,-1,0,-5,5,3,0,1,1,-1,-1,-1,3,-1
KR_6607386883,420,0,24,0,-1,1,2,3,-5,6,1,-3,3,0,3,3,6,3,0,3,0,0,-5,-3,-2,5,2,0,0,0,-1,1,-1,0,-1
KR_6603438736,420,-2,-56,24,-5,-4,5,1,-3,7,4,3,1,4,-1,1,0,0,0,0,0,-7,-7,-3,-3,6,-1,0,0,1,-1,-1,1,5,-1
KR_6606038204,420,-3,-87,-14,-12,-5,5,0,-2,2,0,0,1,1,-3,6,3,-2,2,0,-1,-12,-11,-1,-3,4,-1,0,0,-1,1,0,-1,4,-1
KR_6717930771,420,-5,-57,-43,-13,3,0,3,-6,6,0,1,1,2,-11,12,1,0,0,0,0,-15,10,0,-2,2,-3,0,1,-1,1,-1,-1,3,-1
KR_5557122570,420,0,-4,-21,-2,1,0,1,-6,6,0,1,1,2,2,0,2,0,0,0,0,-4,-18,-6,-5,11,2,0,-1,1,-1,-1,1,2,-1
KR_6755799266,420,-2,-6,12,-2,-1,1,0,2,2,4,-4,5,1,0,2,2,1,0,1,1,-3,-9,-1,-2,3,1,0,0,-1,-1,0,1,3,-1
KR_6689936827,420,-2,-21,-11,7,0,1,1,4,2,6,4,1,5,4,1,5,-5,6,1,1,17,8,-1,-4,5,0,0,1,1,1,1,1,2,-1
KR_6572931828,420,-2,-74,-5,-9,1,0,1,1,1,2,-9,9,0,-1,3,2,-1,1,0,0,-1,-5,1,-4,3,-3,0,-1,-1,1,-1,-1,2,-1
KR_6746531952,420,-2,11,-5,-8,-2,3,1,-4,7,3,-2,3,1,1,0,1,-1,1,0,0,-6,10,2,-5,3,-1,0,0,-1,1,-1,-1,5,-1
KR_6708372663,420,-3,-6,-16,-5,-1,1,0,0,3,3,0,2,2,-3,5,2,-1,2,1,0,-9,5,1,-3,2,-1,0,0,0,-1,0,1,0,-1
KR_6763015794,420,-1,2,-24,-12,-4,4,0,-4,4,0,-4,4,0,-1,1,0,1,0,1,0,-15,114,1,-3,2,2,0,0,-1,0,0,-1,5,-1
KR_6675486952,420,-4,7,-20,-4,-3,3,0,2,1,3,-7,7,0,4,0,4,0,0,0,0,0,-47,1,-3,2,20,0,-2,1,-1,-1,-1,1,-1
KR_6632309151,420,-5,-23,-72,-8,-1,2,1,-2,2,0,-5,10,5,-1,2,1,1,0,1,-1,1,4,2,-3,1,-1,0,-1,-1,-1,-1,-1,6,-1
KR_6744245419,420,-1,-12,-15,2,-1,4,3,0,2,2,1,2,3,2,2,4,0,0,0,0,2,-1,-2,-4,6,-1,0,1,1,1,1,1,5,-1
KR_6570988734,420,-3,-77,2,-10,-1,3,2,1,2,3,-3,4,1,-4,6,2,-3,3,0,1,-10,-6,-5,0,5,0,0,-1,-1,-1,-1,1,4,-1
KR_6731387507,440,-1,-45,-38,-3,2,1,3,-6,7,1,5,2,7,-4,4,0,0,0,0,0,-3,9,1,-10,9,-3,0,-2,-1,-1,-1,-1,2,-1
KR_6759312493,440,1,-28,-5,-4,4,3,7,1,1,2,-1,2,1,-10,10,0,2,0,2,-1,-9,2,2,-4,2,-2,0,1,-1,1,-1,-1,6,-1
KR_6742353071,420,2,57,13,8,-1,2,1,5,1,6,0,2,2,4,2,6,0,0,0,0,4,22,-1,-2,3,0,0,2,1,1,1,-1,4,-1
KR_6717140722,420,-2,-29,-17,-5,-2,2,0,1,2,3,-3,3,0,1,0,1,-2,3,1,0,-1,0,-7,-2,9,5,0,0,-1,1,0,-1,6,-1
KR_6747199855,420,-1,-71,11,-1,-3,5,2,2,1,3,0,0,0,1,2,3,-1,2,1,0,1,-16,1,-4,3,3,0,-1,0,1,-1,1,0,-1
KR_6742048734,420,1,33,8,-9,-2,2,0,-3,4,1,-2,2,0,-2,3,1,0,0,0,0,-13,-25,1,-3,2,-2,0,0,-1,1,0,-1,5,-1
KR_6715810141,420,-3,-118,4,-10,-9,9,0,0,2,2,0,1,1,1,0,1,-2,2,0,-1,3,2,2,-4,2,-2,0,-2,-1,1,-1,-1,1,-1
KR_6763613361,440,-6,-13,-100,-9,1,3,4,-1,2,1,-6,6,0,-3,3,0,0,5,5,0,-3,-3,-2,-3,5,1,0,-1,-1,1,-1,1,3,-1
KR_6715245226,420,1,-4,0,2,0,0,0,-1,2,1,2,0,2,-1,3,2,2,1,3,0,-2,1,2,-5,3,1,0,0,-1,0,0,1,6,-1
KR_6748326318,420,-2,4,-2,-2,-2,4,2,-3,5,2,0,2,2,1,3,4,2,0,2,0,-4,-7,-1,-5,6,1,0,1,-1,-1,1,-1,6,-1
KR_6614958146,420,-6,-61,-46,-10,-2,3,1,-2,5,3,0,3,3,-1,3,2,-5,5,0,-1,-6,-16,1,-4,3,-2,0,0,-1,1,-1,-1,1,-1
KR_6478334687,420,-2,-35,-20,-7,3,1,4,-6,6,0,0,2,2,-2,3,1,-2,3,1,0,-11,-327,-1,-4,5,0,0,-1,-1,1,-1,-1,1,-1
KR_6610267367,420,-2,-37,6,-2,-2,3,1,-1,3,2,4,1,5,-2,5,3,-1,1,0,0,-2,-19,1,-3,2,-4,0,-1,1,-1,-1,-1,4,-1
KR_6731806052,420,-3,-61,-20,-7,-3,5,2,-1,3,2,2,2,4,-1,1,0,-4,4,0,0,4,4,1,-6,5,-1,0,-2,1,-1,-1,1,2,-1
KR_6644821166,420,1,88,35,1,4,1,5,-1,1,0,0,2,2,-2,2,0,0,0,0,0,-2,19,-1,-3,4,-26,0,1,-1,1,1,-1,6,-1
KR_6725087118,420,-1,28,-5,-4,0,0,0,3,0,3,-1,2,1,-5,5,0,-1,2,1,0,0,383,1,-1,0,-1,0,1,-1,1,-1,-1,4,-1
KR_6755696377,420,-1,-104,8,-1,-1,2,1,0,6,6,-1,3,2,-1,5,4,2,3,5,0,7,-24,-1,-4,5,-5,0,-1,-1,-1,-1,-1,3,-1
KR_6752805364,420,-2,-40,11,-7,0,1,1,-2,4,2,-1,2,1,-3,5,2,-1,1,0,0,-8,3,3,-6,3,-4,0,-1,0,0,-1,1,0,-1
KR_6724952922,440,2,-1,20,4,2,0,2,-2,4,2,-5,5,0,5,3,8,4,0,4,0,6,24,0,-2,2,-17,0,2,-1,0,1,1,2,-1
KR_6732351518,440,-1,-48,-17,-3,-4,5,1,7,1,8,-9,10,1,5,0,5,-2,2,0,0,4,-9,0,-1,1,0,0,1,-1,0,-1,1,4,-1
KR_6665223160,420,-2,-82,-27,-8,0,2,2,-2,4,2,-7,7,0,0,1,1,1,0,1,0,-6,3,-2,-4,6,3,0,-1,1,1,-1,-1,3,-1
KR_6743700453,420,0,-18,18,4,-1,1,0,-2,2,0,0,2,2,4,0,4,3,0,3,0,5,9,3,-7,4,-3,0,0,0,1,0,1,0,-1
KR_6754713806,420,-2,20,-19,-7,-1,3,2,2,2,4,-6,6,0,-1,4,3,-1,2,1,0,-5,3,1,-5,4,-1,0,1,-1,1,1,1,1,-1
KR_6723862806,440,-3,-12,5,-7,-4,5,1,-3,4,1,0,2,2,-3,6,3,3,2,5,0,-9,29,-2,-3,5,1,0,0,0,0,-1,-1,0,-1
KR_6727423078,420,-2,-63,-16,6,-4,6,2,8,2,10,-2,2,0,3,2,5,1,0,1,0,13,-33,-1,-3,4,-2,0,-1,1,-1,-1,-1,2,-1
KR_6647339500,420,-6,-133,-16,-10,0,3,3,-5,6,1,0,3,3,-3,3,0,-2,2,0,0,-11,-2,-2,0,2,-2,0,-2,-1,-1,-1,1,4,-1
KR_6748619760,420,3,44,8,8,0,1,1,-1,3,2,1,1,2,8,3,11,0,0,0,0,7,92,0,-5,5,0,0,0,1,-1,1,1,3,-1
KR_6762534331,420,-7,-59,-20,-20,-2,3,1,-8,8,0,-3,6,3,-5,7,2,-2,2,0,-2,-25,-17,0,-4,4,-3,0,-1,-1,1,1,-1,5,-1
KR_6642356054,420,-6,-110,-9,-15,-1,2,1,-8,9,1,0,1,1,-6,6,0,0,0,0,-1,-22,-6,-3,-3,6,3,0,-1,-1,1,-1,-1,5,-1
KR_6619426763,420,0,-23,1,7,0,2,2,5,1,6,1,3,4,-1,1,0,2,2,4,0,2,6,-1,-3,4,-3,0,1,-1,1,1,1,5,-1
KR_6734442202,420,-3,-8,-21,-8,-2,4,2,0,0,0,-2,4,2,-3,4,1,-1,1,0,0,-11,-11,-2,-2,4,-2,0,0,1,1,0,1,5,-1
KR_6751857947,420,-4,-49,-12,-9,-6,8,2,-5,6,1,-1,1,0,1,0,1,2,0,2,0,-1,5,1,-3,2,-1,-1,-2,-1,-1,-1,-1,4,-1
KR_6733255049,420,-4,-34,18,-10,5,1,6,-1,3,2,0,1,1,-11,12,1,-3,3,0,-1,-7,-1,-3,-3,6,3,0,0,1,-1,-1,-1,4,-1
KR_6756282460,420,-3,-86,-14,-1,4,4,8,0,1,1,-5,5,0,-1,5,4,1,3,4,-2,-4,12,8,-11,3,-8,0,0,1,-1,0,-1,2,-1
KR_6760725360,420,-4,-72,-15,-10,-9,9,0,1,4,5,1,1,2,-2,3,1,-1,1,0,0,2,13,3,-7,4,-2,0,-1,-1,-1,-1,-1,6,-1
KR_6762020074,420,1,-84,32,3,-1,3,2,-1,3,2,1,3,4,3,1,4,1,0,1,0,9,-13,0,-3,3,1,0,0,1,1,1,1,6,-1
KR_6748267069,420,-1,56,-55,0,1,1,2,-2,3,1,-1,2,1,2,5,7,0,0,0,0,-4,0,3,-6,3,2,0,1,-1,1,1,-1,2,-1
KR_6759599299,420,-4,18,-12,-9,-3,3,0,0,3,3,-4,4,0,2,2,4,-4,5,1,0,-5,6,1,-3,2,1,0,-2,0,-1,-1,-1,0,-1
KR_6745918947,420,-1,6,-8,-3,-5,6,1,0,3,3,1,3,4,0,7,7,1,1,2,-1,-4,-4,-6,-1,7,1,0,1,-1,1,1,-1,2,-1
KR_6718450599,420,2,-10,36,-3,-6,7,1,1,5,6,0,1,1,1,1,2,1,1,2,0,6,-1,2,-4,2,-1,0,-2,-1,1,-1,-1,4,-1
KR_6757571958,440,-6,-98,-52,-15,0,4,4,-4,4,0,-6,6,0,-6,8,2,1,0,1,0,-18,-15,5,-9,4,-7,0,-2,0,-1,-1,1,0,-1
KR_6742990605,420,-3,-10,-54,-2,3,0,3,-1,4,3,-4,4,0,-2,4,2,2,0,2,0,6,-2,-1,-3,4,3,0,-1,0,-1,-1,1,0,-1
KR_6763822333,420,-5,-80,14,-11,-5,5,0,-5,5,0,0,2,2,-2,3,1,1,1,2,0,-7,11,-1,-2,3,-6,0,-2,1,-1,-1,-1,4,-1
KR_6760577014,420,-4,-66,0,-3,-1,3,2,3,0,3,-2,3,1,1,0,1,-4,4,0,0,2,-4,2,-5,3,-10,0,-1,-1,1,-1,1,4,-1
KR_6719818829,420,-1,-24,-9,-6,-2,4,2,-3,3,0,0,1,1,-1,1,0,0,0,0,0,-4,11,3,-5,2,-3,0,0,0,-1,-1,-1,0,-1
KR_5568670903,420,-2,19,-25,-11,-4,4,0,-4,5,1,1,2,3,-3,5,2,-1,2,1,0,-14,-12,-7,-1,8,1,0,-1,-1,0,-1,1,1,-1
KR_6663178856,420,0,-86,-21,-3,-2,3,1,3,1,4,-3,3,0,-1,4,3,0,0,0,0,-1,-1,1,-5,4,-1,0,0,-1,-1,0,1,1,-1
KR_6750880186,420,-3,18,-40,-5,0,3,3,-6,6,0,1,2,3,-1,2,1,1,0,1,0,-12,2,2,-7,5,-5,0,-1,1,-1,-1,1,5,-1
KR_6740954925,420,-5,-75,20,-10,-4,5,1,-2,3,1,-3,4,1,-1,5,4,0,2,2,0,-4,-383,1,-2,1,1,0,-2,-1,0,-1,1,2,-1
KR_6740356712,420,0,13,0,0,3,2,5,0,2,2,2,1,3,-3,5,2,-2,2,0,0,-2,4,3,-7,4,-8,0,0,1,1,1,-1,5,-1
KR_6763247010,440,-6,-11,-20,-13,-1,2,1,-4,7,3,0,0,0,-3,3,0,-5,5,0,0,-12,9,1,-4,3,1,0,0,1,0,0,1,6,-1
KR_6742865313,420,1,-70,7,0,3,0,3,4,1,5,4,1,5,-12,15,3,1,0,1,0,-6,4,1,-3,2,-2,0,-1,-1,1,-1,-1,3,-1
KR_6717489560,420,-3,6,-12,-4,-3,4,1,2,2,4,-2,2,0,3,3,6,-4,4,0,0,2,9,-3,-3,6,-2,0,-1,-1,-1,1,1,3,-1
KR_6752368019,420,-1,-68,16,-5,-3,3,0,0,1,1,2,2,4,-2,2,0,-2,2,0,0,-6,-2,-2,-3,5,0,0,-2,0,-1,-1,-1,0,-1
KR_6616652228,420,0,-18,-12,-3,-1,1,0,-1,2,1,-4,7,3,2,5,7,1,1,2,0,-3,7,-5,-2,7,-1,0,0,1,-1,-1,1,6,-1
KR_6741630739,420,-2,-49,-42,-2,3,1,4,3,1,4,-8,8,0,-2,5,3,2,5,7,0,1,315,0,-3,3,-3,0,0,1,1,1,-1,6,-1
KR_6761922886,420,-1,-7,4,-8,1,1,2,3,2,5,-2,3,1,-4,4,0,-6,6,0,0,-7,24,2,-4,2,4,0,1,-1,0,1,-1,5,-1
KR_6741066457,420,-4,-56,24,-9,-1,4,3,-2,4,2,-3,4,1,-3,6,3,0,0,0,0,-14,5,0,-3,3,1,0,0,1,-1,0,1,6,-1
KR_6627763232,420,-5,-21,-28,-9,-3,3,0,0,3,3,2,0,2,-6,8,2,-2,2,0,0,-6,1,0,-4,4,-3,0,-1,-1,-1,-1,-1,1,-1
KR_6758239773,420,-4,-53,-20,-8,-2,3,1,-2,2,0,-2,2,0,-3,4,1,1,0,1,0,-3,-4,1,-4,3,-3,0,0,0,-1,0,-1,0,-1
KR_6620351019,420,1,-12,-13,-2,0,1,1,-5,5,0,0,1,1,1,3,4,2,0,2,0,-5,-9,-1,0,1,1,0,0,1,-1,0,1,6,-1
KR_6744871739,420,-2,-28,-40,-3,-3,3,0,1,3,4,-1,2,1,0,0,0,0,2,2,0,0,1,2,-6,4,2,0,1,1,-1,1,1,5,-1
KR_6764378311,420,2,-36,-21,-2,1,2,3,3,1,4,0,1,1,-4,8,4,-2,3,1,0,0,-68,2,-5,3,22,0,0,-1,1,-1,-1,2,-1
KR_6760480618,420,0,2,4,0,-1,3,2,-1,6,5,1,5,6,0,7,7,1,0,1,0,-5,279,-1,-4,5,-2,0,1,-1,0,1,1,5,-1
KR_6761283770,420,-3,8,-8,-3,-1,2,1,-3,6,3,0,5,5,1,3,4,0,2,2,0,-1,-5,0,-2,2,1,0,0,0,1,0,-1,0,-1
KR_6596416324,420,0,-53,7,-8,0,1,1,0,2,2,1,1,2,-8,9,1,-1,1,0,-1,-11,303,0,-7,7,-4,0,-1,-1,-1,-1,-1,6,-1
KR_6649214869,420,2,6,-44,-1,0,1,1,-3,4,1,-2,3,1,3,5,8,1,0,1,0,-2,4,0,-1,1,-1,0,1,-1,1,1,-1,1,-1
KR_6743164253,420,-5,19,-8,-7,-5,5,0,4,1,5,-7,7,0,3,1,4,-2,3,1,1,-5,-2,0,-6,6,-1,0,0,-1,1,0,1,4,-1
KR_6710123560,420,4,6,16,2,-1,3,2,-3,3,0,-2,4,2,4,0,4,4,2,6,0,0,-5,1,-5,4,3,0,1,-1,1,1,1,3,-1
KR_6759832104,420,-1,26,-12,-8,-2,4,2,-4,5,1,-2,4,2,0,1,1,0,0,0,1,-5,-5,-3,-3,6,-2,0,0,0,-1,0,1,0,-1
KR_6643292008,420,1,15,-1,-4,0,6,6,-2,2,0,3,2,5,-3,4,1,-2,3,1,-1,-12,10,2,-5,3,3,0,-1,-1,-1,-1,-1,3,-1
KR_6732823815,420,-7,-40,12,-12,-4,5,1,2,0,2,-9,10,1,-2,5,3,1,0,1,0,-10,34,1,-6,5,1,0,0,-1,1,0,-1,6,-1
KR_6705856804,420,3,26,5,1,7,0,7,-3,4,1,0,1,1,-1,5,4,-2,4,2,0,0,4,2,-6,4,-2,0,1,-1,1,1,-1,2,-1
KR_6628163941,420,-4,-106,21,-15,-1,1,0,-1,3,2,-7,9,2,-7,7,0,1,1,2,2,-9,-25,-3,-3,6,-4,0,-2,-1,-1,-1,1,4,-1
KR_6556103755,420,0,-28,-15,4,-1,3,2,1,3,4,3,2,5,1,1,2,0,1,1,0,1,-3,3,-4,1,-3,0,1,0,1,1,1,0,-1
KR_6742785969,420,-2,32,-3,-9,-1,3,2,-2,3,1,1,2,3,-8,9,1,1,1,2,0,-13,5,0,-2,2,-4,0,0,-1,1,0,1,6,-1
KR_6762738424,420,2,-74,19,8,0,1,1,6,0,6,-1,3,2,2,2,4,1,0,1,0,8,-4,3,-4,1,-1,0,1,1,1,1,1,4,-1
KR_6629980193,420,-7,-17,-4,-6,-3,4,1,-1,2,1,-3,5,2,1,1,2,0,0,0,0,-5,-1,0,-7,7,-3,0,-2,-1,-1,-1,-1,1,-1
KR_6631691877,420,0,78,16,6,-1,2,1,0,2,2,8,1,9,-1,8,7,0,3,3,1,6,9,-5,-2,7,3,0,1,-1,-1,1,1,5,-1
KR_6721221896,420,0,-28,-20,2,3,0,3,-2,4,2,1,4,5,2,5,7,-2,3,1,2,-8,-3,-4,-1,5,0,0,-2,1,-1,-1,1,6,-1
KR_6683455370,420,0,-29,21,-3,0,2,2,-2,4,2,1,3,4,-2,5,3,0,1,1,-1,-5,-6,-6,-1,7,-2,0,0,1,-1,1,-1,4,-1
KR_6321129801,420,0,-2,-8,-5,0,2,2,-5,8,3,-1,3,2,2,3,5,-1,1,0,-1,-6,10,-3,-4,7,-3,0,0,-1,1,-1,-1,6,-1
KR_6733533141,440,0,-14,18,-4,2,1,3,-1,5,4,3,0,3,-6,7,1,-2,3,1,1,-4,34,1,-5,4,-23,0,0,-1,1,-1,1,4,-1
KR_6737761230,420,1,28,-4,-1,1,0,1,3,1,4,-1,1,0,-3,4,1,-1,1,0,0,0,6,1,-4,3,-4,0,1,-1,1,1,1,4,-1
KR_6654259095,420,-3,-29,-8,-4,-1,5,4,2,2,4,-1,5,4,-3,4,1,-1,1,0,0,-9,-38,-2,0,2,13,0,-2,-1,-1,-1,-1,6,-1
KR_6751280712,420,1,-27,-24,2,-1,1,0,0,0,0,-1,2,1,4,0,4,0,0,0,0,3,-2,1,-6,5,0,0,1,-1,1,1,1,4,-1
KR_6761591789,420,-2,-22,-19,-5,2,0,2,-1,5,4,-2,3,1,2,1,3,-6,7,1,0,-5,0,1,-3,2,1,0,0,-1,1,0,1,6,-1
KR_6742578230,420,0,25,-36,-6,0,1,1,1,3,4,4,2,6,-10,10,0,-1,1,0,0,-7,-3,-2,-2,4,-4,0,0,-1,1,0,1,6,-1
KR_6685945795,420,-2,-1,-20,1,-1,4,3,1,5,6,6,2,8,-8,9,1,3,0,3,-2,0,-6,-1,-2,3,1,0,1,1,1,1,-1,6,-1
KR_6688860387,420,-3,-5,-21,0,-6,8,2,-2,3,1,0,3,3,7,1,8,1,0,1,-1,6,13,2,-6,4,-1,0,0,1,-1,-1,-1,3,-1
KR_6644494888,420,-4,-48,-22,-7,0,0,0,0,1,1,-4,5,1,-7,9,2,4,1,5,0,-4,31,0,-4,4,-21,0,0,-1,1,0,-1,3,-1
KR_6759638556,420,1,47,9,7,3,1,4,4,1,5,-3,6,3,3,1,4,0,1,1,1,11,-87,0,-2,2,1,0,1,-1,1,1,1,3,-1
KR_6702809595,420,-6,-40,-12,-7,3,0,3,-1,3,2,-1,1,0,-10,12,2,2,0,2,0,-9,-3,0,-4,4,-1,0,-3,1,-1,-1,-1,2,-1
KR_6657397330,420,0,-61,-16,-2,-2,4,2,4,1,5,2,2,4,-4,6,2,-2,2,0,2,1,-36,-1,-3,4,15,0,0,0,0,-1,1,0,-1
KR_6761244234,440,1,22,12,4,4,1,5,-3,3,0,3,1,4,2,1,3,-2,2,0,1,6,-176,-2,-2,4,-6,0,0,-1,1,1,1,5,-1
KR_6679234255,420,-4,26,-24,-10,-4,5,1,-3,4,1,2,4,6,-3,3,0,-2,3,1,0,-12,-7,-5,-1,6,3,0,-1,-1,-1,-1,1,4,-1
KR_6668608843,420,0,-53,-8,1,3,0,3,0,1,1,-4,5,1,-2,4,2,4,0,4,0,0,-3,3,-6,3,18,0,-1,1,-1,-1,1,4,-1
KR_6658037664,420,2,-7,-11,1,2,4,6,-1,3,2,0,3,3,-3,5,2,3,1,4,0,-4,-50,0,-5,5,1,0,0,-1,-1,1,1,5,-1
KR_6742987197,440,1,-3,-2,4,0,0,0,1,2,3,2,0,2,-1,2,1,2,1,3,0,0,-44,2,-4,2,28,0,0,1,1,0,1,5,-1
KR_6742384114,420,-5,-103,-13,-9,-1,4,3,-3,5,2,-2,4,2,-2,2,0,-1,1,0,-2,-11,-10,-1,-2,3,0,0,-1,-1,1,-1,-1,4,-1
KR_6741603629,420,-1,5,7,0,-6,8,2,1,2,3,1,0,1,3,3,6,1,1,2,0,-2,-3,-1,-4,5,-2,0,-1,0,-1,-1,1,0,-1
KR_6748937535,420,0,-11,4,-1,-2,2,0,0,2,2,-1,5,4,1,1,2,1,0,1,0,1,11,4,-5,1,-4,0,-1,-1,-1,-1,1,2,-1
KR_6560864608,420,0,26,-12,-5,1,3,4,-4,4,0,-2,3,1,-3,3,0,3,0,3,0,-4,2,2,-7,5,-3,0,0,-1,1,1,-1,4,-1
KR_6745421704,420,-5,-97,8,-1,0,1,1,-5,6,1,4,2,6,1,0,1,-1,2,1,0,-2,-5,-3,-2,5,0,0,0,-1,1,-1,1,4,-1
KR_6734915411,420,-1,-3,1,-7,2,1,3,-3,3,0,2,2,4,-8,8,0,0,1,1,0,-10,14,-2,-5,7,-6,0,-1,-1,1,-1,1,2,-1
KR_6727303680,420,-5,-67,-37,-6,-4,6,2,2,5,7,-3,4,1,-1,3,2,0,3,3,-1,-8,2,1,-4,3,0,0,-2,-1,-1,-1,-1,4,-1
KR_6718002448,420,-4,-14,-20,-13,-3,3,0,-2,5,3,-2,3,1,-6,8,2,0,1,1,0,-14,-8,-1,-2,3,1,0,-3,-1,-1,-1,-1,3,-1
KR_6743771233,440,2,59,-8,1,0,0,0,-2,3,1,2,2,4,-1,1,0,2,2,4,0,3,13,3,-4,1,-3,0,-1,1,-1,-1,1,6,-1
KR_6756393409,440,-4,32,-12,-1,2,2,4,-5,5,0,-3,5,2,4,1,5,1,0,1,1,1,2,2,-5,3,-4,0,-1,1,-1,-1,1,6,-1
KR_6655695466,420,2,51,-20,-6,1,3,4,-6,6,0,1,2,3,-2,4,2,0,1,1,0,-9,-7,-4,-1,5,4,0,2,-1,-1,1,-1,5,-1
KR_6753623132,420,-7,-102,-25,-6,-1,1,0,-2,6,4,-2,3,1,-3,5,2,2,0,2,0,4,-13,-3,-3,6,3,0,-3,0,-1,-1,1,0,-1
KR_6727068702,420,-9,-183,-56,-23,-3,4,1,-16,17,1,0,1,1,-5,5,0,1,0,1,0,-16,-53,-2,-3,5,0,0,-3,-1,1,-1,-1,6,-1
KR_6687547718,420,-1,-20,-5,2,-6,6,0,-2,3,1,6,1,7,1,2,3,3,1,4,0,4,1,0,-4,4,-5,0,0,-1,-1,0,1,6,-1
KR_6762562512,420,-2,12,-36,-4,-4,5,1,4,2,6,-2,7,5,0,2,2,-2,3,1,0,1,-302,0,-3,3,2,0,0,-1,-1,-1,1,3,-1
KR_6748618620,420,-3,-34,-8,-2,4,0,4,-1,5,4,-1,3,2,-3,5,2,-1,1,0,0,-7,-1,0,-5,5,3,0,2,-1,1,1,1,6,-1
KR_6744514086,420,-2,-22,-17,-10,2,0,2,-2,2,0,-3,3,0,-6,11,5,-1,1,0,0,-4,10,-3,-2,5,-2,0,-1,-1,-1,-1,1,1,-1
KR_6693090110,420,-2,-1,-30,-10,-2,2,0,-5,8,3,-3,4,1,3,1,4,-3,3,0,0,-4,-4,-5,-1,6,2,0,-1,-1,-1,-1,-1,6,-1
KR_6646351190,420,-6,-64,-17,-8,3,0,3,-3,5,2,-5,8,3,-1,3,2,-2,2,0,-1,-14,-175,-1,-3,4,3,0,-4,-1,-1,-1,-1,2,-1
KR_6724449989,420,-4,-6,-40,-3,1,2,3,3,4,7,-5,5,0,0,3,3,-2,3,1,0,4,-106,4,-7,3,0,0,0,-1,1,1,-1,3,-1
KR_6758722730,420,-1,22,2,5,0,2,2,4,1,5,4,1,5,-1,1,0,-2,4,2,0,5,25,-3,-2,5,-32,0,0,-1,-1,0,-1,3,-1
KR_6751362248,420,-1,-12,-1,1,2,0,2,3,1,4,-4,5,1,0,3,3,0,0,0,0,-4,0,2,-5,3,3,0,0,0,-1,-1,1,0,-1
KR_6674333880,420,1,-39,-12,0,-3,3,0,-1,2,1,3,0,3,0,2,2,1,1,2,0,2,5,1,-4,3,-1,0,-1,1,-1,-1,-1,4,-1
KR_6735061482,420,-1,4,-32,-5,-1,4,3,0,5,5,-4,5,1,-1,3,2,1,3,4,0,-8,5,-1,-5,6,-1,0,0,1,0,0,-1,5,-1
KR_6760904262,420,2,-14,-25,5,0,1,1,4,3,7,0,1,1,2,2,4,-1,3,2,0,5,-201,0,-3,3,2,0,-2,-1,0,-1,-1,3,-1
KR_6750050106,420,0,-34,-15,-3,3,0,3,-1,3,2,1,1,2,-5,9,4,-1,4,3,-1,-8,-4,0,-3,3,-3,0,0,1,1,1,-1,2,-1
KR_6726995068,420,-2,-5,19,-5,1,3,4,-1,2,1,1,2,3,-3,5,2,-3,5,2,-2,-13,-34,-1,-2,3,11,0,-1,1,1,-1,-1,3,-1
KR_6724058090,420,0,-31,-4,9,0,0,0,3,3,6,0,2,2,3,0,3,3,0,3,1,15,54,0,-1,1,-1,0,0,1,0,1,1,1,-1
KR_6741821879,420,0,4,-1,1,-1,1,0,2,4,6,-1,2,1,0,3,3,1,0,1,0,6,4,1,-4,3,-4,0,0,1,1,-1,-1,4,-1
KR_6743883565,420,-2,-64,4,-5,-2,3,1,0,1,1,-2,2,0,-1,4,3,0,2,2,0,0,-18,2,-6,4,0,0,0,1,1,-1,-1,5,-1
KR_6516361880,440,-1,24,-24,3,-5,7,2,5,1,6,-2,4,2,0,4,4,5,2,7,0,5,275,3,-6,3,-1,0,-1,0,0,-1,-1,0,-1
KR_6730757043,420,1,-49,11,-5,-3,4,1,2,1,3,-2,4,2,-1,2,1,-1,1,0,0,-1,375,-6,-1,7,2,0,0,1,0,0,-1,3,-1
KR_6760783137,420,-2,-14,16,-5,2,1,3,-2,5,3,-3,3,0,-4,7,3,2,1,3,0,2,-2,-1,-3,4,3,0,0,0,1,-1,-1,0,-1
KR_6671924909,420,-4,33,-8,-9,0,2,2,2,4,6,-3,4,1,-3,4,1,-5,6,1,-1,-6,-37,1,-4,3,-4,0,-1,1,1,-1,-1,2,-1
KR_5889804948,420,-6,-68,-29,-14,-5,6,1,-5,6,1,-3,6,3,-2,3,1,1,2,3,0,-16,3,-1,-3,4,-3,0,-3,-1,-1,-1,-1,4,-1
KR_6632942468,420,1,-37,-9,-2,-1,2,1,-1,7,6,-2,4,2,1,0,1,1,0,1,0,6,46,-2,-2,4,1,0,-1,1,-1,-1,-1,2,-1
KR_6746532662,440,0,49,16,-3,1,1,2,1,3,4,-6,7,1,2,0,2,-1,2,1,-1,-2,-36,-1,-3,4,18,0,0,-1,0,-1,-1,3,-1
KR_6742673350,420,-4,-3,-9,-6,-4,5,1,-4,5,1,2,0,2,1,3,4,-1,1,0,0,-8,-22,-1,-5,6,-4,0,-1,-1,-1,-1,1,4,-1
KR_6740305537,420,-2,-56,-20,-10,0,1,1,-2,3,1,0,4,4,-6,6,0,-2,2,0,0,-12,15,-3,-1,4,-4,0,-3,-1,-1,-1,1,2,-1
KR_6741551670,440,-2,-10,3,-6,-4,4,0,-3,6,3,-1,2,1,0,2,2,2,3,5,0,-5,-4,-3,-5,8,1,0,-2,-1,-1,-1,1,6,-1
KR_6731859898,420,-5,-73,-35,-5,-2,4,2,-2,3,1,-3,4,1,0,1,1,2,0,2,0,-1,11,-8,-1,9,-3,0,-1,-1,1,-1,1,5,-1
KR_6610895041,420,2,33,31,0,0,1,1,-1,3,2,0,2,2,1,4,5,0,1,1,-1,-6,-5,0,-4,4,0,0,0,-1,0,0,-1,5,-1
KR_6750046026,420,-4,-69,-10,-4,-1,2,1,-5,6,1,3,0,3,-5,6,1,4,0,4,0,-6,-13,-6,-6,12,3,0,-1,-1,-1,-1,1,4,-1
KR_6712836321,420,-1,-45,-26,2,-1,2,1,2,6,8,-1,4,3,1,2,3,1,0,1,0,4,-3,-1,-3,4,2,0,0,-1,-1,0,-1,2,-1
KR_6681526883,420,-4,17,-4,-9,-1,3,2,-2,3,1,-1,1,0,-3,5,2,-2,3,1,0,-4,-27,-2,-2,4,4,0,0,-1,-1,0,-1,5,-1
KR_6710852970,420,-1,18,-18,5,0,1,1,0,4,4,1,3,4,3,3,6,1,0,1,0,5,9,-1,-6,7,-3,0,1,-1,1,1,-1,6,-1
KR_6739565038,420,0,-68,-55,5,0,3,3,0,2,2,0,1,1,4,5,9,1,0,1,2,17,-2,-3,0,3,-1,0,0,-1,0,0,-1,5,-1
KR_6724412516,420,0,10,0,-1,4,2,6,-4,5,1,-2,3,1,1,0,1,0,0,0,0,-4,-2,1,-6,5,3,0,0,1,-1,-1,-1,2,-1
KR_6748540096,420,-1,-93,19,-4,-5,5,0,-5,9,4,-1,4,3,8,1,9,-1,2,1,2,2,71,2,-3,1,1,0,-1,1,-1,-1,-1,2,-1
KR_6690718238,420,-7,-174,-32,-14,-3,3,0,-2,3,1,-4,5,1,-3,5,2,-2,2,0,0,-9,-38,1,-4,3,26,0,-2,-1,0,-1,-1,5,-1
KR_6725586384,420,0,-26,29,0,4,1,5,-1,6,5,-4,6,2,-4,5,1,5,0,5,-1,-4,-21,1,-3,2,-1,0,0,1,0,1,-1,4,-1
KR_6760848362,440,-6,7,-12,-15,-2,4,2,-1,4,3,-3,3,0,-8,11,3,-1,3,2,-2,-13,484,1,-4,3,-1,0,-1,1,0,-1,-1,5,-1
KR_6707949269,420,-4,-63,-36,-4,3,1,4,2,2,4,-3,4,1,-5,5,0,-1,1,0,-1,-5,-5,1,-6,5,4,0,1,-1,1,1,-1,4,-1
KR_6743957266,420,0,30,-18,1,0,2,2,-6,10,4,0,4,4,6,1,7,1,1,2,2,-5,-2,-1,-5,6,0,0,0,-1,1,-1,1,6,-1
KR_6760675508,420,-1,-4,16,-4,5,2,7,2,1,3,-7,7,0,-3,4,1,-1,3,2,0,-17,-42,-3,-3,6,22,0,0,1,-1,0,-1,4,-1
KR_6723571489,440,-1,25,-8,-1,1,1,2,0,1,1,-3,4,1,-1,2,1,2,1,3,0,-1,-6,2,-6,4,1,0,0,-1,1,0,1,6,-1
KR_5536098152,420,-4,-85,-42,-8,0,2,2,-4,4,0,-3,4,1,-2,3,1,1,0,1,0,-8,-14,-4,-2,6,0,0,-3,-1,-1,-1,-1,1,-1
KR_6746712663,420,-5,26,-19,-15,-1,3,2,0,4,4,5,0,5,-15,16,1,-4,4,0,1,-6,4,3,-7,4,1,0,0,-1,1,0,1,5,-1
KR_6742950823,420,-5,-25,10,-13,-3,4,1,-5,5,0,-4,6,2,-1,3,2,0,3,3,0,-13,-318,0,-2,2,1,0,-1,1,-1,-1,1,1,-1
KR_6762813130,420,-6,-65,-28,-18,-1,2,1,-11,11,0,-1,1,0,-3,5,2,-2,2,0,-1,-15,-37,-7,0,7,37,0,-2,-1,1,-1,-1,6,-1
KR_5568548545,420,-10,-113,-9,-15,-2,2,0,-6,10,4,-3,5,2,-3,3,0,-1,2,1,-1,-17,5,3,-4,1,-3,-1,-6,0,-1,-1,-1,0,-1
KR_6760660086,420,-3,-58,-14,-4,0,0,0,-1,2,1,1,1,2,-2,4,2,-2,5,3,0,-3,0,-2,-4,6,8,0,-1,0,1,-1,1,0,-1
KR_6653015968,420,-3,-17,-20,-4,-2,4,2,1,3,4,-5,6,1,1,0,1,1,0,1,0,-5,52,0,-1,1,4,0,1,-1,-1,1,-1,6,-1
KR_6763483064,440,-1,-38,0,-7,-5,5,0,-2,5,3,0,1,1,2,2,4,-2,2,0,0,-4,-37,2,-9,7,22,0,-1,1,1,-1,1,6,-1
KR_6714893945,440,3,-3,8,6,-1,2,1,3,2,5,0,4,4,2,3,5,2,1,3,0,-1,12,-3,-2,5,1,0,1,-1,1,1,-1,3,-1
KR_6675583377,420,-5,-84,-28,-16,-3,3,0,-3,4,1,-2,4,2,-7,7,0,-1,1,0,-1,-13,-10,-2,-2,4,-2,0,-3,-1,-1,-1,-1,3,-1
KR_6713774381,420,-5,-51,-23,-13,-6,6,0,-3,5,2,2,2,4,-6,9,3,0,1,1,0,-9,-14,3,-4,1,1,0,-1,-1,-1,-1,-1,2,-1
KR_6708673343,420,-3,-41,20,-8,0,1,1,2,2,4,-4,4,0,-7,8,1,1,1,2,0,-12,2,-5,-3,8,0,0,-1,-1,-1,-1,1,4,-1
KR_6744632011,420,-5,-51,8,-16,-2,4,2,-4,5,1,-3,4,1,-6,6,0,-1,2,1,0,-18,-5,-7,-1,8,-3,0,-2,-1,-1,-1,-1,3,-1
KR_6761578737,420,-5,-39,4,-13,1,5,6,-2,2,0,-2,4,2,-6,7,1,-4,5,1,0,-14,3,-3,0,3,-2,0,0,-1,1,1,1,1,-1
KR_6760807433,420,-3,-111,-13,-2,-1,2,1,3,1,4,0,1,1,-3,4,1,-1,2,1,0,0,4,2,-6,4,-4,0,-3,1,-1,-1,-1,3,-1
KR_5890232067,420,-2,-3,-13,-5,0,2,2,-1,5,4,-2,3,1,-2,5,3,0,3,3,0,-7,21,-3,-2,5,-4,0,0,-1,-1,1,1,4,-1
KR_6736695496,420,-3,-18,-37,-5,-6,7,1,-2,3,1,-1,2,1,2,2,4,2,0,2,0,-3,1,5,-6,1,-4,0,-2,-1,-1,-1,-1,5,-1
KR_6657013678,420,-3,13,12,-4,-4,4,0,-3,4,1,3,1,4,0,1,1,0,1,1,0,-4,15,1,-5,4,-2,0,0,0,1,0,-1,0,-1
KR_6692257057,440,-2,-19,-5,-1,2,1,3,0,7,7,1,2,3,-4,6,2,0,1,1,0,-1,-13,-7,-1,8,-2,0,0,-1,-1,-1,1,3,-1
KR_6736680567,420,-3,6,-7,1,-1,2,1,-2,5,3,1,2,3,3,0,3,0,1,1,0,4,15,3,-5,2,-1,0,1,1,1,1,1,5,-1
KR_6756705263,420,0,-24,-18,-1,0,6,6,0,1,1,5,0,5,-5,7,2,-1,1,0,0,8,24,-3,-2,5,2,0,-2,0,-1,-1,-1,0,-1
KR_6726442884,420,-2,-15,-8,-9,-8,9,1,-5,6,1,0,1,1,5,1,6,-1,2,1,-2,-7,0,-2,-3,5,2,0,-1,-1,-1,-1,-1,2,-1
KR_6715408724,420,-7,-60,8,-18,-4,6,2,-7,7,0,-3,4,1,0,1,1,-4,4,0,-1,-10,35,-4,-1,5,-11,0,-3,-1,-1,-1,-1,6,-1
KR_6759255911,440,-2,9,-14,-4,0,1,1,2,1,3,-1,2,1,-5,7,2,0,2,2,1,0,17,2,-5,3,-1,0,-1,-1,1,-1,1,2,-1
KR_6759820020,420,-8,-122,-29,-19,1,1,2,-2,4,2,-12,12,0,-5,6,1,-1,3,2,0,-17,-46,-1,-3,4,16,0,-3,-1,-1,-1,1,1,-1
KR_6708923489,420,2,62,16,-1,0,1,1,0,4,4,-2,3,1,0,2,2,1,1,2,0,-7,1,-3,-3,6,-3,0,0,0,1,0,1,0,-1
KR_6749241964,440,0,-8,-17,3,2,2,4,-5,8,3,2,4,6,5,1,6,-1,3,2,-1,-2,-24,-2,-1,3,2,0,0,-1,-1,1,-1,2,-1
KR_6751882796,440,-1,-53,16,-6,-2,2,0,0,1,1,-3,3,0,-3,6,3,2,1,3,0,-3,107,1,-6,5,1,0,0,1,1,0,-1,1,-1
KR_6764113155,420,-1,-34,-24,-2,-5,6,1,2,2,4,2,1,3,3,3,6,-4,5,1,0,-4,4,4,-6,2,-1,0,0,-1,-1,0,-1,2,-1
KR_6665853988,420,-2,-56,-11,-4,-3,3,0,-1,2,1,-3,4,1,-1,1,0,4,0,4,0,-3,110,-2,-3,5,-3,0,0,-1,1,0,1,2,-1
KR_6740724492,420,-1,27,-19,-2,1,1,2,-7,9,2,2,0,2,-1,4,3,3,3,6,1,-2,17,1,-4,3,2,0,0,-1,-1,1,1,6,-1
KR_6558416925,420,2,4,7,-2,6,2,8,4,0,4,-3,4,1,-4,7,3,-5,7,2,0,-11,-26,-5,-5,10,6,0,0,1,1,-1,1,2,-1
KR_6713741052,420,-5,-71,1,-9,3,0,3,-2,4,2,0,1,1,-6,7,1,-4,5,1,0,-15,4,2,-3,1,-1,0,-2,-1,-1,-1,-1,3,-1
KR_6704840907,440,-2,31,-17,0,0,2,2,-2,3,1,2,4,6,-3,4,1,3,0,3,0,2,21,1,-8,7,-6,0,0,-1,1,0,1,4,-1
KR_6695767993,440,-1,-35,12,0,-7,8,1,2,4,6,4,2,6,3,3,6,-2,3,1,2,1,-217,-2,-1,3,-14,0,1,-1,1,1,1,2,-1
KR_6684498102,420,-3,-50,1,-8,-1,3,2,-1,4,3,-5,6,1,-2,4,2,1,2,3,0,-3,4,0,-3,3,-2,0,-1,-1,-1,-1,1,3,-1
KR_6673073790,420,0,5,0,-4,1,2,3,0,2,2,1,3,4,-3,5,2,-3,5,2,0,-4,-40,-3,-2,5,12,0,2,-1,1,1,1,4,-1
KR_6667281400,420,2,31,9,1,0,2,2,1,0,1,-2,5,3,0,1,1,2,0,2,0,2,-5,-4,0,4,7,0,0,-1,-1,0,-1,3,-1
KR_6754243875,420,-1,-8,14,-3,-1,3,2,-1,1,0,0,3,3,-1,2,1,0,0,0,0,-6,10,1,-3,2,-1,0,-1,1,-1,-1,1,5,-1
KR_6689877068,420,2,-38,-28,2,5,1,6,2,1,3,-3,4,1,-2,4,2,0,0,0,0,1,-3,2,-8,6,-1,0,-1,1,-1,-1,-1,5,-1
KR_6761649063,420,0,28,12,-7,1,0,1,0,1,1,-2,2,0,-3,3,0,-3,3,0,0,-4,-12,0,-4,4,2,0,0,-1,-1,1,-1,6,-1
KR_6685480347,420,-3,-59,-18,-7,-1,3,2,-1,2,1,-9,10,1,5,0,5,-1,1,0,1,2,0,0,-3,3,-2,0,-2,-1,-1,-1,1,6,-1
KR_6762296353,420,-5,-43,-20,-7,-2,3,1,-3,3,0,-2,3,1,-1,5,4,1,2,3,0,-11,323,-4,-1,5,0,0,-1,1,-1,-1,1,1,-1
KR_6697297123,420,-3,31,-4,-6,-2,3,1,-2,2,0,-1,2,1,0,2,2,-1,1,0,0,-10,-6,-4,-3,7,4,0,0,-1,1,0,1,2,-1
KR_6729490326,420,1,-39,-4,-4,4,2,6,0,2,2,-4,6,2,-3,4,1,-1,2,1,0,-4,2,3,-6,3,1,0,-1,-1,0,-1,-1,1,-1
KR_6534706615,420,-2,13,-13,-3,-4,4,0,0,2,2,0,5,5,1,1,2,0,0,0,0,-5,4,2,-5,3,-1,0,-1,-1,0,-1,-1,4,-1
KR_6694791535,440,3,68,1,13,2,0,2,6,2,8,-1,2,1,7,6,13,-1,2,1,0,19,3,5,-7,2,-2,0,1,1,1,1,1,6,-1
KR_6656561964,420,-3,-42,-8,-8,-2,2,0,-2,4,2,1,0,1,-4,5,1,-1,2,1,0,-12,171,1,-5,4,-2,0,-1,-1,-1,-1,1,4,-1
KR_6459789098,440,2,13,4,6,1,0,1,5,0,5,2,0,2,-4,7,3,2,2,4,0,11,7,0,-4,4,1,0,1,1,-1,-1,-1,2,-1
KR_6705735912,420,2,18,8,6,1,1,2,3,1,4,2,1,3,0,3,3,0,1,1,0,6,8,1,-2,1,1,0,1,1,1,1,1,1,-1
KR_6682923761,420,-1,-48,-20,-1,-3,6,3,2,1,3,3,0,3,-2,2,0,-1,1,0,0,3,-2,3,-6,3,2,0,-1,1,1,-1,1,5,-1
KR_6668924796,420,-2,-36,4,0,0,3,3,2,0,2,-4,5,1,0,5,5,2,0,2,0,-3,7,-1,-3,4,-4,0,-1,1,-1,-1,-1,6,-1
KR_6614233775,420,0,-24,28,-4,-4,4,0,-1,5,4,1,1,2,0,3,3,0,0,0,0,3,-191,-2,-3,5,6,0,0,1,-1,-1,-1,1,-1
KR_6756407871,420,1,31,13,-3,-3,3,0,-3,4,1,1,6,7,0,2,2,2,1,3,-1,-10,-5,0,-1,1,0,0,1,1,1,1,1,4,-1
KR_6737858328,420,-1,-57,27,-1,-1,2,1,1,3,4,-1,2,1,-1,3,2,1,0,1,0,3,8,-6,0,6,0,0,0,1,-1,0,-1,3,-1
KR_6604111804,440,-4,-55,-16,-8,-3,3,0,-2,3,1,-4,4,0,1,0,1,0,0,0,0,-2,39,-3,-1,4,-11,0,-1,1,-1,-1,1,3,-1
KR_6601958372,420,-4,-1,-12,-10,1,2,3,3,3,6,-2,5,3,-12,12,0,0,0,0,0,-14,5,0,-5,5,-4,0,-1,-1,-1,-1,-1,2,-1
KR_6744262619,420,1,-4,-16,5,0,1,1,0,0,0,2,0,2,0,4,4,3,1,4,0,0,3,3,-5,2,-4,0,1,-1,1,1,1,1,-1
KR_6693589999,420,-5,-64,-16,-11,-5,7,2,-2,2,0,-3,4,1,-1,3,2,0,2,2,-2,-4,-17,-5,-1,6,-1,0,-1,-1,-1,-1,-1,3,-1
KR_6758757919,440,1,-19,-8,0,-2,3,1,-2,6,4,-1,2,1,1,4,5,4,1,5,0,-7,32,0,-5,5,-3,0,1,1,-1,1,-1,2,-1
KR_6743984225,420,-1,-69,11,0,3,1,4,0,4,4,-3,4,1,0,3,3,0,2,2,0,0,15,2,-9,7,6,0,1,1,1,1,1,5,-1
KR_6732934710,420,-1,-36,5,-6,1,2,3,0,2,2,-3,4,1,-3,4,1,-1,1,0,0,-4,89,1,-2,1,-3,0,-2,0,-1,-1,1,0,-1
KR_6744391982,420,1,-78,14,1,3,0,3,1,0,1,1,0,1,-4,4,0,0,2,2,-1,-2,36,-1,-4,5,-2,0,0,-1,1,1,-1,6,-1
KR_6727518347,440,-5,-23,-16,-14,0,0,0,0,0,0,-4,5,1,-10,13,3,0,0,0,1,-10,-15,-4,0,4,-1,0,-1,0,1,-1,1,0,-1
KR_6609884676,420,-1,20,-19,-4,0,1,1,-3,3,0,2,1,3,-5,6,1,2,0,2,0,-8,-135,-6,0,6,3,0,0,1,1,0,-1,2,-1
KR_6754453534,420,-2,-30,4,-1,2,2,4,2,2,4,-2,5,3,-2,3,1,-1,3,2,3,-4,-3,1,-3,2,-1,0,0,1,1,-1,1,6,-1
KR_6757853840,420,-4,-84,-8,-7,-1,2,1,-2,2,0,-2,5,3,-4,5,1,2,0,2,-1,-5,0,-1,-4,5,-4,0,0,0,0,-1,-1,0,-1
KR_6699959470,420,-2,-36,-24,-4,-2,2,0,-3,4,1,1,3,4,-1,3,2,1,1,2,-1,0,-6,0,-3,3,-1,0,1,1,1,1,-1,3,-1
KR_6733399173,420,-1,-59,-1,0,2,0,2,-4,7,3,1,3,4,1,3,4,0,0,0,2,-2,11,3,-6,3,-10,0,0,-1,0,0,1,5,-1
KR_6764115645,420,5,40,5,11,0,1,1,4,2,6,3,1,4,5,4,9,-1,2,1,0,7,191,3,-6,3,-3,0,3,-1,1,1,-1,5,-1
KR_6762650165,420,-2,39,-8,-8,2,3,5,-5,5,0,0,0,0,-3,4,1,-2,3,1,0,-18,18,-5,-1,6,-2,0,0,-1,1,0,1,4,-1
KR_6670288661,420,-1,-85,-1,-14,0,1,1,2,3,5,-9,10,1,-5,5,0,-2,3,1,-1,-5,-10,0,-4,4,-1,0,-3,-1,-1,-1,-1,3,-1
KR_6665698327,420,-1,-10,12,-4,-5,6,1,5,2,7,-8,8,0,4,1,5,0,2,2,0,0,378,-1,-1,2,-1,0,-1,1,1,-1,-1,2,-1
KR_6695859726,440,-5,-53,0,-10,-1,3,2,-1,3,2,-8,8,0,1,1,2,-1,2,1,1,-10,-9,-8,-4,12,3,0,0,-1,0,0,1,2,-1
KR_6675826403,420,-2,-35,12,-6,-3,7,4,-1,3,2,1,1,2,-3,5,2,0,1,1,-1,-5,0,2,-8,6,2,0,0,-1,1,-1,-1,5,-1
KR_6742568100,420,2,65,-32,2,2,1,3,2,0,2,-2,4,2,2,0,2,-2,4,2,0,-1,125,3,-5,2,-7,0,2,-1,1,1,-1,3,-1
KR_6753596120,420,-2,-37,17,-7,-2,2,0,-1,3,2,-5,6,1,3,4,7,-2,3,1,0,-2,-37,-1,-2,3,25,0,-1,0,-1,-1,1,0,-1
KR_6761933586,420,-3,-27,-8,-9,-3,3,0,0,0,0,0,3,3,-3,3,0,-3,3,0,0,-8,-8,-1,-5,6,0,0,-2,-1,-1,-1,-1,1,-1
KR_6598582778,420,-1,-33,7,-4,1,3,4,-3,4,1,0,1,1,-1,2,1,-1,3,2,0,-5,-1,-1,-4,5,-2,0,-1,-1,-1,-1,1,6,-1
KR_6717785152,420,0,57,-8,-3,3,1,4,0,2,2,0,3,3,-4,4,0,-2,3,1,-1,0,-7,-2,-2,4,5,0,-1,1,-1,-1,-1,3,-1
KR_6761937544,420,-4,-19,4,-5,-1,1,0,-2,3,1,-1,5,4,-3,7,4,2,1,3,0,-3,-7,-4,0,4,-2,0,-1,0,0,-1,-1,0,-1
KR_6759338428,420,-4,-92,4,-6,-2,2,0,4,1,5,-4,4,0,-3,3,0,-1,1,0,0,1,11,3,-5,2,-2,0,0,1,-1,0,-1,1,-1
KR_6606134790,420,-4,-65,-19,-1,2,1,3,0,2,2,1,1,2,-3,7,4,-1,2,1,0,-4,-31,-8,-1,9,14,0,-2,1,-1,-1,-1,1,-1
KR_6738387574,440,-4,-86,28,-10,-3,6,3,-3,5,2,-2,3,1,1,2,3,-3,3,0,0,-3,70,-1,0,1,-1,0,0,0,-1,-1,-1,0,-1
KR_6733593380,420,-2,34,-27,-5,-2,3,1,1,3,4,-2,3,1,-2,5,3,0,4,4,0,3,-2,5,-7,2,-5,0,-1,-1,-1,-1,-1,3,-1
KR_6745995949,420,0,11,-18,0,2,1,3,-2,4,2,-3,4,1,3,1,4,0,0,0,0,-2,268,-3,-1,4,-1,0,0,0,1,0,-1,0,-1
KR_6763635499,420,1,-51,-15,-8,2,1,3,1,3,4,0,1,1,-11,14,3,0,0,0,-3,-19,8,2,-6,4,0,0,-1,1,1,-1,-1,5,-1
KR_6759467025,420,-1,5,20,-5,-6,7,1,-1,4,3,-2,3,1,1,0,1,3,0,3,0,-4,4,-3,-2,5,1,0,-1,-1,0,-1,1,5,-1
KR_6632444255,420,2,24,8,-1,-3,6,3,-5,6,1,2,0,2,3,0,3,2,2,4,-1,-4,2,1,-2,1,0,0,0,-1,-1,-1,-1,2,-1
KR_6440060637,420,-2,4,3,-1,0,1,1,-2,2,0,-2,2,0,1,1,2,2,0,2,0,-4,-21,-2,-4,6,-3,0,-1,1,-1,-1,-1,5,-1
KR_6757846270,420,-4,-27,6,-6,-3,4,1,-1,1,0,0,4,4,-2,4,2,0,2,2,0,-15,-2,6,-11,5,0,0,0,1,1,-1,1,1,-1
KR_6558625519,420,-5,-105,-28,-10,0,2,2,-3,4,1,-3,3,0,-7,11,4,3,0,3,0,-6,18,-4,-4,8,-7,0,-1,-1,-1,-1,1,4,-1
KR_6758020325,420,-5,5,-37,-7,-3,4,1,-6,7,1,-1,2,1,4,1,5,-1,1,0,0,-6,1,-2,-3,5,0,0,-1,-1,-1,-1,1,4,-1
KR_6676832013,420,-2,48,-5,2,-1,4,3,0,2,2,-2,4,2,2,2,4,3,1,4,0,0,-2,-3,-1,4,0,0,-1,-1,-1,-1,-1,2,-1
KR_6661405827,420,-3,-3,-19,-1,4,2,6,-5,9,4,2,1,3,-1,5,4,-1,1,0,2,-5,2,-2,-1,3,3,0,1,1,-1,1,1,1,-1
KR_6748906600,420,0,19,-20,-11,-8,9,1,-3,4,1,-3,5,2,-1,3,2,4,0,4,1,-3,4,-5,-2,7,1,0,0,-1,-1,-1,1,1,-1
KR_6687264161,420,-2,-29,20,-5,5,1,6,-6,6,0,-1,1,0,-3,4,1,0,0,0,0,-9,-7,-5,-2,7,-1,0,1,-1,1,1,1,2,-1
KR_6616709944,420,-1,-42,28,-4,-2,2,0,6,0,6,-5,6,1,1,2,3,-4,4,0,0,-4,-3,-2,-2,4,-3,0,0,-1,1,0,-1,2,-1
KR_6742139206,440,0,7,4,-9,-5,5,0,0,1,1,0,3,3,-3,4,1,-1,2,1,0,-13,39,2,-4,2,-18,0,0,-1,1,0,-1,2,-1
KR_6763300397,440,0,39,-20,-5,-1,3,2,1,1,2,-1,3,2,-2,5,3,-2,2,0,0,-6,188,-2,-4,6,3,0,0,-1,-1,-1,-1,5,-1
KR_6710488074,420,-1,-5,12,-3,0,1,1,-4,5,1,-4,4,0,1,2,3,4,0,4,1,-7,-22,-5,-2,7,4,0,0,1,-1,-1,1,5,-1
KR_6743060958,420,2,51,-8,-2,0,0,0,1,2,3,0,3,3,-2,2,0,-1,1,0,0,-2,5,4,-6,2,2,0,1,-1,1,1,-1,3,-1
KR_6731916098,420,-6,-19,-31,-11,-6,6,0,-4,6,2,-2,3,1,1,2,3,0,0,0,1,-8,-1,-1,-3,4,-2,0,-3,-1,-1,-1,1,4,-1
KR_6754224798,420,-3,-24,6,-7,-3,3,0,1,1,2,-2,3,1,-3,3,0,0,1,1,0,-7,-10,-1,-4,5,1,0,0,1,1,0,-1,2,-1
KR_6741349906,440,-4,-81,-12,-12,1,4,5,-4,4,0,-7,7,0,0,1,1,-2,3,1,0,-4,3,1,-4,3,0,-1,-2,0,0,-1,-1,0,-1
KR_6739528963,420,-1,-44,-28,2,-1,1,0,-1,3,2,0,1,1,2,0,2,2,1,3,0,5,8,-3,-3,6,2,0,0,-1,-1,-1,-1,2,-1
KR_6757610338,420,1,7,-4,5,0,2,2,-2,3,1,5,4,9,0,2,2,2,0,2,0,-2,6,2,-5,3,1,0,0,1,0,0,1,1,-1
KR_6642623116,420,4,16,18,1,4,0,4,-6,6,0,4,5,9,-1,4,3,0,0,0,0,4,6,4,-7,3,-1,0,0,1,0,0,-1,1,-1
KR_6748590277,440,-2,-56,16,1,1,1,2,3,2,5,11,1,12,-11,11,0,-3,5,2,2,-10,-5,-2,0,2,2,0,0,0,0,-1,1,0,-1
