matchId,queueId,Diff_LV,Diff_CS,Diff_jglCS,Diff-K,Diff-K-top,K-WIN-top,K-LOSE-top,Diff-K-jug,K-WIN-jug,K-LOSE-jug,Diff-K-mid,K-WIN-mid,K-LOSE-mid,Diff-K-ad,K-WIN-ad,K-LOSE-ad,Diff-K-sup,K-WIN-sup,K-LOSE-sup,invadeKill,Diff-A,Diff_WARDplaced,Diff-ControlWARDplaced,LOSE_controlWARDPlaced,WIN_controlWARDPlaced,Diff_WARDkill,Diff_Inhibitor,Diff_TOWERkill,Diff_FirstDRAGON,Diff_FirstHERALD,Diff_Firsttower,Diff_FirstBLOOD,dragonType,result
KR_6760468396,420,0,22,4,2,4,0,4,3,0,3,-2,3,1,-3,3,0,0,0,0,0,1,-33,3,-5,2,-5,0,0,-1,1,0,1,4,-1
KR_6748600200,420,-2,-22,0,2,0,3,3,2,2,4,0,1,1,1,0,1,-1,1,0,0,16,5,0,-5,5,-10,0,0,-1,-1,0,-1,5,-1
KR_6753905934,420,-4,-46,-9,-7,-5,5,0,-1,2,1,0,1,1,-2,3,1,1,2,3,0,-7,-2,-1,-5,6,8,0,-3,1,-1,-1,-1,2,-1
KR_6769363410,420,-3,-5,5,-4,-6,6,0,1,1,2,-4,5,1,2,2,4,3,2,5,0,1,-1,-2,-5,7,7,0,0,1,1,0,-1,5,-1
KR_6671468088,420,-2,-12,-24,-7,0,1,1,-1,1,0,-3,3,0,-5,5,0,2,0,2,0,-7,36,1,-9,8,-7,0,1,-1,1,1,1,4,-1
KR_6777260164,420,-1,-31,-23,-4,-6,7,1,5,2,7,-5,5,0,-1,1,0,3,0,3,0,0,97,1,-6,5,1,0,1,-1,-1,1,-1,3,-1
KR_6772380551,420,-1,4,-12,-2,0,2,2,0,4,4,-1,2,1,0,3,3,-1,2,1,0,-6,-1,0,-10,10,0,0,1,-1,1,1,-1,5,-1
KR_6748083742,420,-2,-23,8,1,-3,5,2,4,0,4,5,0,5,-4,6,2,-1,1,0,0,5,20,6,-12,6,-4,0,0,1,1,0,1,6,-1
KR_6777743109,420,-2,-14,5,-10,-2,2,0,-3,5,2,-8,9,1,3,2,5,0,1,1,0,-8,-2,0,-7,7,3,0,-1,-1,-1,-1,-1,1,-1
KR_6758676261,420,0,12,17,-1,3,3,6,2,0,2,-1,5,4,-3,9,6,-2,2,0,-1,6,-24,-6,-4,10,6,0,2,-1,1,1,-1,2,-1
KR_6772557742,420,-1,-57,16,-4,-3,3,0,-1,2,1,1,3,4,-1,2,1,0,0,0,0,-8,2,1,-6,5,1,0,-1,-1,1,-1,-1,2,-1
KR_6741898964,420,0,11,12,-1,-2,2,0,1,4,5,2,1,3,-2,3,1,0,2,2,0,-6,-17,2,-6,4,3,0,0,1,-1,0,-1,5,-1
KR_6774260798,420,0,-41,-9,1,2,1,3,1,0,1,-1,1,0,-1,1,0,0,1,1,0,-3,0,1,-7,6,-3,0,0,-1,-1,0,1,4,-1
KR_6740581763,420,0,-60,20,-4,1,2,3,-1,4,3,-4,8,4,-1,2,1,1,0,1,0,-5,2,3,-7,4,-3,0,0,1,1,0,1,4,-1
KR_6765715219,420,-5,-60,11,-13,-2,3,1,-7,8,1,-1,4,3,-1,4,3,-2,2,0,1,-11,-8,-5,-5,10,-1,0,-2,1,-1,-1,1,4,-1
KR_6771815966,420,-1,-33,24,-3,2,1,3,-2,3,1,1,1,2,-5,7,2,1,0,1,0,-4,-8,-6,-6,12,-2,0,-1,1,-1,-1,-1,3,-1
KR_6774247594,420,-2,-18,-1,-3,3,1,4,1,2,3,-2,7,5,-4,5,1,-1,1,0,0,-2,19,-1,-6,7,-4,0,1,1,1,-1,1,1,-1
KR_6751036952,440,1,44,-30,0,7,1,8,1,1,2,-5,6,1,3,1,4,-6,7,1,1,-9,-1,0,-3,3,0,0,1,0,-1,1,1,0,-1
KR_6746856505,420,1,2,-1,-2,1,1,2,-3,6,3,2,1,3,-1,1,0,-1,2,1,0,0,-37,0,-5,5,-1,0,1,-1,1,1,-1,2,-1
KR_6736333092,420,-1,-63,-42,-4,-2,2,0,-2,3,1,-2,4,2,1,1,2,1,0,1,0,-5,1,-2,-6,8,1,0,-1,-1,-1,-1,1,4,-1
KR_6766094707,440,-2,-18,-20,-4,1,0,1,-1,2,1,0,3,3,-4,7,3,0,1,1,0,6,3,-2,-4,6,5,0,-1,-1,-1,-1,-1,2,-1
KR_6776079201,420,0,-24,-7,3,1,1,2,-3,4,1,6,1,7,0,2,2,-1,1,0,0,1,4,2,-7,5,-4,0,1,-1,-1,1,1,2,-1
KR_6776039330,420,-3,-58,-9,-10,-2,4,2,-3,5,2,-3,5,2,-2,3,1,0,1,1,0,-9,16,-2,-5,7,-6,0,-2,-1,-1,-1,-1,1,-1
KR_6766398720,420,-2,8,20,0,3,3,6,3,1,4,-4,4,0,-1,4,3,-1,1,0,0,-6,6,5,-9,4,-5,0,0,1,1,1,1,1,-1
KR_6777243192,420,-1,-55,21,-5,0,2,2,-1,3,2,-3,6,3,-1,2,1,0,1,1,-1,-2,7,-6,-3,9,-2,0,-2,-1,-1,-1,-1,4,-1
KR_6776052741,440,-4,-4,-11,-11,0,0,0,0,2,2,-6,6,0,-4,5,1,-1,1,0,0,-10,-1,1,-5,4,-2,0,-2,-1,-1,-1,-1,6,-1
KR_6764574111,420,-1,-57,-10,8,0,2,2,3,0,3,1,2,3,-2,7,5,6,0,6,0,15,-96,1,-5,4,-1,0,-1,-1,-1,-1,1,3,-1
KR_6776438648,420,-2,-7,-42,-11,0,2,2,-7,10,3,1,3,4,-4,5,1,-1,2,1,0,-16,-227,1,-7,6,-1,0,0,-1,-1,-1,1,5,-1
KR_6770500705,420,-3,6,-10,-12,0,3,3,-4,6,2,-2,4,2,-6,8,2,0,0,0,-1,-9,-52,-2,-4,6,21,0,0,-1,-1,-1,-1,3,-1
KR_6767830083,420,-4,-21,-28,-5,4,0,4,2,2,4,-3,6,3,-4,5,1,-4,4,0,0,-5,-11,0,-5,5,5,0,-3,-1,-1,-1,-1,6,-1
KR_6759215848,420,0,87,9,0,2,2,4,-2,3,1,1,1,2,-1,1,0,0,0,0,0,-14,1,2,-6,4,-3,0,1,-1,1,1,1,5,-1
KR_6743563114,420,0,32,-40,3,1,1,2,-4,6,2,-1,3,2,0,1,1,7,1,8,0,5,-115,8,-14,6,-1,0,0,-1,-1,0,-1,5,-1
KR_6775390874,420,-5,-61,-11,-13,1,2,3,0,2,2,-6,7,1,-5,7,2,-3,3,0,0,-18,-5,-3,-7,10,-1,0,-2,1,1,-1,1,1,-1
KR_6749723213,420,-3,-61,-14,-5,-1,2,1,-2,6,4,2,2,4,-5,7,2,1,0,1,-1,-3,-23,0,-3,3,0,0,-1,-1,1,-1,-1,6,-1
KR_6765284196,420,-1,-93,3,0,-1,2,1,2,0,2,4,0,4,0,2,2,-5,5,0,0,0,-10,-3,-6,9,3,0,-2,1,1,-1,1,1,-1
KR_6768090102,420,-1,14,0,-2,1,2,3,1,5,6,-4,5,1,-1,5,4,1,1,2,0,4,1,2,-9,7,-1,0,0,-1,-1,0,-1,3,-1
KR_6772593849,420,-3,-93,-11,-7,-3,6,3,-2,3,1,-1,3,2,1,2,3,-2,2,0,0,-11,23,2,-6,4,-2,0,-1,-1,-1,-1,-1,3,-1
KR_6749108734,420,-1,-7,0,-5,2,0,2,-3,3,0,0,0,0,-3,3,0,-1,2,1,0,-11,-9,1,-7,6,0,0,-2,-1,-1,-1,-1,4,-1
KR_6733211830,420,-4,-50,-4,-8,-3,4,1,-1,6,5,-1,1,0,-3,4,1,0,2,2,0,-3,9,-1,-7,8,0,0,1,1,1,1,-1,6,-1
KR_6774223563,420,-4,-114,17,-6,-3,3,0,3,4,7,-2,2,0,-4,5,1,0,0,0,0,-6,-5,-1,-6,7,-7,0,-1,-1,1,-1,1,2,-1
KR_6765047948,420,0,-22,-12,-3,2,1,3,3,5,8,-2,2,0,-5,6,1,-1,1,0,-2,1,-13,4,-10,6,-1,0,-1,-1,-1,-1,-1,6,-1
KR_6775954509,420,-4,-37,9,-10,-3,3,0,-1,4,3,-8,8,0,2,2,4,0,0,0,0,-14,-5,-4,-5,9,-3,0,-2,-1,-1,-1,-1,2,-1
KR_6774313561,420,-5,-89,-36,1,1,3,4,-2,3,1,0,2,2,1,3,4,1,0,1,0,-11,2,5,-10,5,-6,0,0,-1,1,1,1,3,-1
KR_6742843896,420,1,16,17,2,-1,3,2,2,2,4,-1,1,0,3,1,4,-1,2,1,0,0,-82,0,-6,6,1,0,-1,-1,-1,-1,-1,6,-1
KR_6775070277,420,1,32,18,-1,2,0,2,-4,6,2,-2,2,0,2,2,4,1,0,1,0,0,-1,0,-7,7,4,0,-1,1,-1,-1,-1,4,-1
KR_6761870703,440,-2,-41,-40,1,3,2,5,4,1,5,-2,4,2,-2,5,3,-2,3,1,1,5,-8,-2,-5,7,3,0,0,1,0,1,1,6,-1
KR_6727692571,420,-4,-71,9,-6,-2,2,0,-1,3,2,0,4,4,-2,3,1,-1,2,1,0,-1,96,-4,-5,9,4,0,-1,1,-1,-1,-1,6,-1
KR_6776076388,420,-5,-65,-28,-12,1,2,3,-2,7,5,-6,7,1,-5,6,1,0,0,0,0,-10,-132,-3,-4,7,-1,0,-2,-1,-1,-1,1,5,-1
KR_6777085651,420,1,-1,-10,4,1,2,3,4,0,4,-4,5,1,3,2,5,0,0,0,0,5,7,-4,-2,6,2,0,0,-1,1,0,1,6,-1
KR_6768028742,420,-1,17,16,6,2,1,3,-1,2,1,6,0,6,0,0,0,-1,1,0,0,1,-2,-4,-5,9,5,0,0,1,1,0,1,2,-1
KR_6738337204,440,-4,-46,-8,-10,-3,6,3,0,1,1,0,0,0,-6,6,0,-1,2,1,-1,-9,6,2,-6,4,-7,0,-2,1,-1,-1,-1,6,-1
KR_6772030943,420,-5,-79,-27,-7,1,2,3,2,0,2,-4,7,3,-4,5,1,-2,4,2,0,-7,44,-2,-5,7,-10,0,0,-1,1,-1,-1,6,-1
KR_6762204434,420,-6,-21,-25,-19,-1,1,0,-5,6,1,-5,7,2,-7,8,1,-1,1,0,0,-28,-4,-2,-3,5,0,0,-2,-1,-1,-1,-1,4,-1
KR_6760717705,420,1,-43,-8,4,3,0,3,2,1,3,0,0,0,0,1,1,-1,1,0,0,2,-12,-4,-3,7,4,0,-1,1,-1,-1,1,5,-1
KR_6740512631,420,-6,-44,19,-10,1,1,2,-8,11,3,1,5,6,-5,6,1,1,3,4,1,-4,-13,-4,-1,5,0,0,-1,-1,-1,-1,1,1,-1
KR_6772513741,420,-1,51,-15,-8,-2,2,0,0,1,1,-3,4,1,-3,4,1,0,0,0,0,-8,3,-4,-3,7,1,0,0,-1,-1,0,-1,2,-1
KR_6736636903,420,-4,-61,-1,-7,-3,4,1,-2,3,1,-1,3,2,-3,7,4,2,0,2,0,-6,29,4,-6,2,-13,0,-2,-1,-1,-1,-1,6,-1
KR_6743536639,420,-2,-1,8,-3,-1,2,1,2,1,3,-2,6,4,-1,6,5,-1,1,0,0,1,26,2,-6,4,7,0,-1,1,-1,-1,1,4,-1
KR_6719379269,420,1,72,26,-10,-8,8,0,1,2,3,-1,2,1,-3,7,4,1,0,1,0,-2,-11,-6,-1,7,1,0,-1,1,-1,-1,1,5,-1
KR_6757958051,420,0,5,-19,9,0,2,2,3,3,6,2,3,5,4,0,4,0,1,1,0,2,20,7,-11,4,-2,0,1,0,1,1,1,0,-1
KR_6713303083,420,-6,-12,5,-18,-2,3,1,-6,6,0,2,1,3,-11,11,0,-1,1,0,0,-22,2,-2,-5,7,-3,0,-2,-1,1,-1,-1,1,-1
KR_6736590848,420,-2,-14,28,-2,-1,3,2,0,4,4,-1,2,1,0,2,2,0,2,2,0,-3,33,2,-6,4,0,0,0,1,1,-1,1,1,-1
KR_6776547730,420,-3,8,12,-9,3,2,5,-4,4,0,1,1,2,-6,8,2,-3,3,0,0,-15,15,-2,-5,7,1,0,-2,1,-1,-1,-1,5,-1
KR_6775541749,420,-3,-65,8,-13,-2,3,1,-8,10,2,-4,6,2,2,2,4,-1,3,2,-1,-18,-35,-1,-2,3,-1,0,-2,-1,-1,-1,-1,1,-1
KR_6777197313,420,-3,1,5,-5,3,2,5,0,3,3,-6,8,2,0,1,1,-2,5,3,1,0,-6,-3,-1,4,-1,0,0,1,1,0,1,4,-1
KR_6771495121,420,-7,-87,-24,-13,-3,3,0,-6,6,0,1,2,3,-5,6,1,0,0,0,0,-12,-33,-4,-2,6,0,0,-1,1,-1,-1,1,5,-1
KR_6770350001,420,-6,-90,-28,-4,0,3,3,-2,4,2,-1,3,2,1,3,4,-2,2,0,0,-5,-47,1,-9,8,31,0,-1,-1,-1,-1,1,2,-1
KR_6775432688,420,2,25,-20,1,6,0,6,-1,4,3,0,2,2,-5,8,3,1,0,1,0,2,2,-2,-6,8,0,0,1,1,-1,1,1,3,-1
KR_6768567585,420,-4,-81,-31,-18,2,1,3,-7,8,1,-8,11,3,-5,9,4,0,1,1,-1,-8,-15,-2,-5,7,-5,0,-2,-1,-1,-1,-1,5,-1
KR_6732515462,420,-4,-10,-37,-2,2,0,2,-2,4,2,0,2,2,-3,3,0,1,1,2,0,-6,-81,2,-7,5,-4,0,-2,-1,-1,-1,1,3,-1
KR_6731140881,420,-2,-41,-12,1,1,0,1,0,3,3,3,0,3,-2,5,3,-1,1,0,0,-2,11,1,-7,6,-5,0,2,-1,1,1,-1,4,-1
KR_6740756058,420,0,-14,-3,4,-2,2,0,3,2,5,3,1,4,1,2,3,-1,1,0,0,6,12,0,-7,7,-2,0,0,-1,-1,0,-1,4,-1
KR_6773855535,440,0,3,8,-5,1,1,2,6,2,8,-1,1,0,-7,9,2,-4,6,2,-2,-9,6,3,-7,4,1,0,1,-1,1,1,-1,3,-1
KR_6741887983,440,-2,-123,13,-7,-2,3,1,-2,7,5,-3,5,2,-2,3,1,2,2,4,-2,-12,-3,-5,-5,10,2,0,-1,-1,-1,-1,-1,1,-1
KR_6712406055,420,0,-9,-6,-3,0,1,1,0,5,5,-1,3,2,-3,4,1,1,2,3,0,-8,-6,-2,-4,6,1,0,0,-1,1,1,-1,6,-1
KR_6765080571,420,-2,10,-14,0,1,3,4,1,3,4,-3,3,0,2,5,7,-1,2,1,0,9,9,2,-7,5,0,0,1,1,1,1,-1,1,-1
KR_6760395718,420,1,1,-7,8,4,0,4,0,2,2,0,0,0,5,0,5,-1,1,0,1,11,-14,4,-10,6,-2,0,0,-1,1,0,1,2,-1
KR_6759160520,420,-1,-53,-23,-1,-1,2,1,-1,2,1,0,3,3,0,1,1,1,0,1,0,2,-7,-2,-4,6,2,0,0,-1,1,1,-1,3,-1
KR_6733856039,420,-4,-21,-32,-9,1,1,2,-4,7,3,-3,4,1,-5,5,0,2,0,2,0,-6,-7,-2,-4,6,5,0,-1,-1,-1,-1,-1,5,-1
KR_6693596977,420,-2,10,4,0,-3,3,0,2,4,6,-3,4,1,2,0,2,2,0,2,0,3,3,0,-6,6,3,0,-1,1,1,-1,1,4,-1
KR_6776120289,420,-2,-57,-48,-4,4,1,5,2,2,4,-6,7,1,-1,6,5,-3,3,0,0,-12,-35,6,-10,4,1,0,-1,-1,-1,-1,-1,4,-1
KR_6763399284,440,2,20,29,8,1,1,2,3,1,4,1,1,2,3,6,9,0,1,1,0,4,-101,1,-9,8,1,0,1,0,1,1,-1,0,-1
KR_6763829919,420,2,-74,26,4,2,2,4,5,2,7,-3,5,2,0,6,6,0,1,1,-2,2,-8,-2,-3,5,0,0,0,-1,-1,-1,-1,1,-1
KR_6774229220,420,-6,-20,-7,-16,-1,1,0,0,3,3,-2,3,1,-8,9,1,-5,7,2,0,-17,-17,-3,-3,6,1,0,-2,-1,-1,-1,-1,4,-1
KR_6716343305,420,-4,23,-24,-6,1,1,2,-6,6,0,-4,4,0,1,0,1,2,0,2,0,-10,2,2,-8,6,-4,0,0,-1,-1,-1,1,1,-1
KR_6761915019,420,-1,-14,-14,1,1,3,4,-1,3,2,0,2,2,-1,6,5,2,0,2,0,-2,-50,1,-6,5,21,0,-2,-1,-1,-1,-1,1,-1
KR_6774964859,420,-2,-2,-1,-2,-5,7,2,3,2,5,-1,1,0,2,1,3,-1,2,1,1,-6,18,-3,-6,9,5,0,0,1,-1,0,1,5,-1
KR_6744982614,420,-4,-42,-39,-4,5,0,5,-7,8,1,-1,2,1,0,3,3,-1,1,0,1,-10,-138,-1,-4,5,3,0,0,-1,1,-1,1,4,-1
KR_6764785202,440,-4,-90,-4,-10,-4,5,1,-5,5,0,3,1,4,-3,4,1,-1,3,2,0,-4,-14,-2,-3,5,3,0,-1,1,1,-1,-1,5,-1
KR_6775884596,420,0,-15,13,-2,0,2,2,-3,4,1,0,3,3,0,2,2,1,1,2,0,-2,15,1,-7,6,1,0,-1,-1,-1,-1,1,5,-1
KR_6752155790,420,0,-1,20,-3,2,0,2,5,1,6,-4,4,0,-6,6,0,0,1,1,0,-6,-13,8,-10,2,-5,0,0,1,1,0,-1,6,-1
KR_6761307020,440,-1,15,-22,0,-2,3,1,-2,4,2,3,2,5,2,1,3,-1,1,0,0,-5,-302,2,-5,3,-1,0,0,-1,-1,0,1,1,-1
KR_6757139456,420,-4,-67,-20,-13,-8,8,0,-1,2,1,-2,3,1,-2,3,1,0,1,1,0,-7,27,-6,-4,10,-12,0,-1,0,1,-1,-1,0,-1
KR_6776702613,420,-2,-52,-10,-3,-3,3,0,-1,2,1,0,2,2,-1,3,2,2,1,3,0,1,-5,1,-7,6,8,0,-1,1,-1,-1,-1,5,-1
KR_6765519082,420,-5,-52,-16,-11,-2,3,1,-1,3,2,-5,5,0,-3,6,3,0,0,0,0,-11,-28,2,-6,4,0,0,0,-1,-1,0,1,6,-1
KR_6775738219,420,-1,16,-28,2,2,2,4,-1,3,2,0,1,1,-1,2,1,2,0,2,0,4,-15,1,-6,5,-7,0,0,-1,-1,-1,1,5,-1
KR_6767530189,420,-3,-19,8,-6,2,1,3,0,7,7,-2,5,3,-3,5,2,-3,5,2,2,-4,6,2,-7,5,-1,0,-1,-1,1,-1,-1,5,-1
KR_6763999187,420,-5,-101,-12,-10,-3,4,1,1,3,4,-9,10,1,2,2,4,-1,3,2,-1,-8,-11,3,-5,2,-3,0,0,1,1,1,-1,3,-1
KR_6777088434,420,0,-3,0,1,-1,1,0,1,1,2,0,2,2,1,1,2,0,0,0,0,-1,9,1,-7,6,-1,0,1,-1,1,1,-1,6,-1
KR_6774860221,440,-4,-59,-6,-16,0,5,5,-5,5,0,-6,6,0,-1,3,2,-4,5,1,-1,-9,114,0,-7,7,2,0,-2,0,1,-1,-1,0,-1
KR_6728997088,420,-4,-3,-24,-9,-2,5,3,-2,4,2,-3,4,1,1,2,3,-3,3,0,0,1,25,4,-5,1,-3,0,1,-1,-1,1,1,6,-1
KR_6774174163,420,-2,-47,4,-9,-4,5,1,-1,3,2,-3,4,1,2,2,4,-3,4,1,0,-3,-5,-1,-4,5,-4,0,-2,1,-1,-1,1,2,-1
KR_6755159524,420,-4,-29,8,-11,-1,2,1,-5,9,4,1,2,3,-5,7,2,-1,3,2,0,-14,-12,-2,-5,7,0,0,0,-1,0,-1,-1,5,-1
KR_6775791852,420,-3,-35,-29,-5,0,2,2,0,1,1,-1,2,1,-2,2,0,-2,3,1,0,-7,1,-2,-6,8,-1,0,-1,-1,-1,-1,-1,4,-1
KR_6776724442,420,-2,17,-8,-7,-3,4,1,3,1,4,-2,2,0,-3,3,0,-2,2,0,0,-8,-10,-3,-4,7,1,0,0,-1,-1,0,-1,3,-1
KR_6743516841,420,0,55,30,-3,1,2,3,-4,6,2,-2,4,2,0,4,4,2,0,2,-2,-13,-44,-7,-6,13,6,0,0,-1,-1,0,-1,6,-1
KR_6772899191,420,-1,36,-31,-9,1,1,2,-1,2,1,-5,6,1,-5,6,1,1,0,1,0,-16,38,-3,-6,9,-19,0,0,-1,-1,-1,-1,3,-1
KR_6769129208,420,-5,-42,-22,-17,1,3,4,-4,5,1,-10,11,1,-1,1,0,-3,5,2,-2,-22,4,1,-5,4,0,0,-2,-1,-1,-1,-1,4,-1
KR_6771465717,420,-1,-58,-18,2,4,1,5,2,2,4,-2,2,0,-5,6,1,3,0,3,0,2,-6,-3,-3,6,2,0,0,-1,1,1,-1,4,-1
KR_6742360937,420,1,-34,-17,10,1,2,3,4,2,6,1,0,1,-3,3,0,7,0,7,0,9,11,4,-13,9,-6,0,0,-1,1,0,-1,3,-1
KR_6753467087,420,-2,-3,6,-4,-6,7,1,1,4,5,0,2,2,-2,2,0,3,0,3,1,-3,-10,-6,-2,8,4,0,2,1,-1,1,1,4,-1
KR_6748101013,420,-4,-54,-11,-6,-5,6,1,-1,2,1,1,3,4,-3,5,2,2,1,3,0,-11,-3,-1,-8,9,-2,0,0,-1,1,1,-1,6,-1
KR_6773995642,420,-3,-84,1,-14,1,1,2,1,4,5,-6,9,3,-9,13,4,-1,2,1,0,-11,-3,0,-9,9,-4,0,-2,1,-1,-1,-1,6,-1
KR_6774183983,420,-2,3,13,-4,0,0,0,-4,4,0,3,2,5,0,1,1,-3,3,0,0,-8,-47,-1,-4,5,0,0,0,-1,-1,0,1,6,-1
KR_6775488132,420,-3,20,-1,-11,0,1,1,-2,5,3,-2,3,1,-5,5,0,-2,2,0,0,-21,-48,-1,-4,5,-1,0,-2,-1,1,-1,-1,1,-1
KR_6768301724,420,-4,-74,27,-12,-7,7,0,3,2,5,-6,9,3,-3,4,1,1,2,3,-1,-9,-9,-6,-2,8,-2,0,-2,-1,-1,-1,-1,6,-1
KR_6739258762,420,1,-32,12,-2,1,0,1,-3,5,2,1,2,3,-1,4,3,0,0,0,0,-5,10,1,-5,4,3,0,0,1,1,0,-1,6,-1
KR_6777054305,420,-1,-42,16,-4,-3,7,4,2,0,2,-1,2,1,-4,9,5,2,1,3,-1,3,8,-1,-7,8,-2,0,-1,1,-1,-1,1,4,-1
KR_6773097947,420,-3,-61,-14,-13,0,2,2,-6,9,3,-3,3,0,-4,6,2,0,3,3,0,-21,22,3,-9,6,-2,0,0,-1,-1,0,-1,4,-1
KR_6763934944,420,0,-32,7,2,1,0,1,-1,4,3,0,2,2,1,5,6,1,2,3,0,-3,-17,-2,-4,6,1,0,0,1,-1,-1,-1,6,-1
KR_6756244280,420,-2,-41,-32,0,3,1,4,0,3,3,1,0,1,-2,5,3,-2,2,0,0,-3,1,-1,-7,8,-3,0,-1,-1,-1,-1,-1,6,-1
KR_6776991620,420,1,9,12,1,1,0,1,3,0,3,1,1,2,-3,3,0,-1,1,0,0,1,16,-2,-8,10,-1,0,-2,1,-1,-1,1,3,-1
KR_6763373130,420,2,27,-2,1,0,1,1,-2,2,0,2,2,4,-2,2,0,3,0,3,0,4,2,-1,-6,7,7,0,2,-1,1,1,-1,2,-1
KR_6770601970,420,-1,-7,7,-9,-2,4,2,2,0,2,-3,3,0,-5,8,3,-1,1,0,0,-13,-45,-2,-8,10,10,0,0,-1,-1,0,1,6,-1
KR_6776718651,420,-3,-20,7,-2,-3,4,1,-1,2,1,-1,3,2,3,0,3,0,0,0,0,-5,247,4,-11,7,-4,0,0,1,1,1,-1,2,-1
KR_6777374756,420,-1,-25,4,-1,-3,3,0,1,2,3,0,2,2,0,1,1,1,1,2,0,2,-33,2,-7,5,1,0,-1,-1,-1,-1,1,4,-1
KR_6753110221,420,-3,-21,-17,-9,1,0,1,0,1,1,-4,6,2,-5,7,2,-1,1,0,0,-14,3,1,-8,7,-3,0,-1,1,-1,-1,-1,6,-1
KR_6701180227,420,1,-35,-31,9,1,1,2,4,1,5,2,2,4,3,0,3,-1,1,0,0,15,46,0,-6,6,1,0,-2,1,-1,-1,1,2,-1
KR_6685243963,420,3,-24,20,2,3,4,7,1,2,3,-1,2,1,-1,1,0,0,1,1,0,8,-3,-3,-4,7,5,0,-1,-1,-1,-1,-1,2,-1
KR_6754710689,420,-11,-163,-56,-18,-3,3,0,-2,2,0,-8,8,0,-3,5,2,-2,3,1,-1,-16,-8,-7,-1,8,5,0,-4,-1,-1,-1,-1,4,-1
KR_6744143825,420,-2,1,-17,-6,-2,2,0,-3,4,1,-3,4,1,3,0,3,-1,2,1,0,-4,-8,5,-9,4,-2,0,0,1,-1,-1,-1,3,-1
KR_6773326622,420,-9,-49,-40,-15,-1,4,3,-2,8,6,-2,3,1,-5,5,0,-5,5,0,-1,-16,-31,6,-8,2,-4,0,-3,-1,1,-1,-1,5,-1
KR_6773228738,420,0,-61,10,-1,0,2,2,-1,4,3,0,2,2,0,2,2,0,0,0,0,-5,-8,-1,-4,5,-1,0,-1,1,-1,-1,-1,4,-1
KR_6777260152,420,-2,-11,4,-5,-4,4,0,2,2,4,1,0,1,-3,4,1,-1,1,0,0,1,16,2,-8,6,-2,0,-1,1,-1,-1,-1,4,-1
KR_6770860630,420,-4,-53,-11,-9,-7,7,0,4,2,6,1,3,4,-5,6,1,-2,3,1,0,-8,10,4,-7,3,0,0,-2,-1,1,-1,1,3,-1
KR_6774750606,420,-3,-55,20,-3,-4,5,1,0,1,1,3,0,3,-3,6,3,1,1,2,0,-3,44,-1,-5,6,0,0,1,-1,1,1,1,4,-1
KR_6719693700,420,0,-36,-16,-3,1,3,4,0,3,3,-6,6,0,2,1,3,0,1,1,0,-5,1,7,-11,4,-8,0,-2,-1,-1,-1,-1,4,-1
KR_6777664086,420,-4,-52,-21,-5,-2,2,0,-5,6,1,-2,2,0,2,1,3,2,1,3,0,-3,-4,1,-4,3,-6,0,-1,1,1,-1,1,1,-1
KR_6762647080,420,-4,-90,11,-18,-3,5,2,-5,7,2,-5,7,2,-2,3,1,-3,3,0,0,-12,-11,1,-6,5,-2,0,-4,1,-1,-1,1,3,-1
KR_6736610410,420,-4,-48,-38,-9,0,3,3,-5,5,0,2,0,2,-5,5,0,-1,1,0,0,-14,1,-3,-1,4,-3,0,-2,-1,-1,-1,-1,3,-1
KR_6752070427,420,-3,-77,11,-10,1,1,2,-5,7,2,-3,5,2,-2,3,1,-1,1,0,-1,-9,2,7,-12,5,0,0,-2,-1,-1,-1,-1,3,-1
KR_6755225220,420,-7,-101,-20,-13,0,1,1,-8,9,1,-2,5,3,5,2,7,-8,10,2,-3,-13,1,-4,-2,6,-3,0,-1,-1,-1,-1,-1,5,-1
KR_6763421814,420,0,3,-12,0,-2,2,0,3,1,4,1,1,2,0,3,3,-2,3,1,0,6,1,-5,-5,10,1,0,-1,-1,-1,-1,-1,4,-1
KR_6774418512,420,0,-65,40,-4,-2,3,1,3,1,4,0,0,0,-5,6,1,0,1,1,0,-5,4,0,-4,4,-3,0,-1,-1,-1,-1,-1,6,-1
KR_6731945818,440,0,-23,-8,0,-1,2,1,0,1,1,-2,5,3,2,2,4,1,3,4,0,1,6,1,-5,4,0,0,-1,-1,-1,-1,1,1,-1
KR_6743170139,420,-6,-90,4,-8,1,0,1,-1,3,2,-5,5,0,-3,5,2,0,1,1,1,-7,-7,-1,-7,8,8,0,-2,-1,-1,-1,1,3,-1
KR_6766773362,420,1,33,36,1,-2,4,2,7,0,7,-3,4,1,1,4,5,-2,2,0,-2,0,12,-2,-5,7,-4,0,2,1,1,1,-1,1,-1
KR_6773123203,440,0,48,-28,-2,-1,2,1,3,4,7,-3,4,1,-2,6,4,1,0,1,1,4,-43,-1,-7,8,10,0,-1,-1,0,-1,1,5,-1
KR_6776319702,420,-1,5,-6,6,-1,4,3,1,1,2,3,0,3,1,0,1,2,1,3,0,4,-26,2,-8,6,-1,0,0,-1,1,0,1,2,-1
KR_6755252867,420,0,23,-2,3,1,1,2,1,2,3,-3,8,5,-1,6,5,5,1,6,1,6,13,4,-7,3,-6,0,0,-1,-1,0,-1,1,-1
KR_6760247898,420,-2,-1,-31,1,-1,2,1,1,4,5,-3,3,0,2,0,2,2,0,2,0,3,18,3,-6,3,-7,0,0,-1,-1,0,1,1,-1
KR_6767554551,420,-1,-45,-45,-4,-2,2,0,0,3,3,-3,7,4,-1,5,4,2,2,4,0,-2,3,1,-6,5,-5,0,0,0,-1,-1,1,0,-1
KR_6775361491,420,-1,-50,-5,-2,5,0,5,-4,5,1,-2,3,1,-2,4,2,1,1,2,0,-9,-9,0,-7,7,-3,0,-1,-1,1,-1,1,1,-1
KR_6776226638,420,-2,-22,-8,-3,-3,3,0,-2,5,3,-2,3,1,5,1,6,-1,2,1,0,1,-145,0,-6,6,-3,0,-3,1,-1,-1,1,5,-1
KR_6774436389,440,-3,-39,-16,-9,-1,3,2,-1,2,1,-2,2,0,-3,5,2,-2,2,0,0,-9,10,3,-6,3,-7,0,0,-1,1,0,-1,1,-1
KR_6777762517,420,-1,-64,14,0,-1,2,1,0,2,2,1,2,3,0,7,7,0,2,2,0,2,4,0,-7,7,2,0,-2,-1,-1,-1,1,6,-1
KR_6729601803,420,-3,-12,-35,-8,0,1,1,-5,6,1,0,0,0,-2,4,2,-1,2,1,0,-6,4,-2,-5,7,-3,0,-3,-1,-1,-1,-1,4,-1
KR_6760130708,420,0,-77,-10,-7,-1,2,1,0,5,5,3,1,4,-9,12,3,0,2,2,-3,-6,17,-1,-2,3,-2,0,-3,1,-1,-1,-1,2,-1
KR_6756369069,420,2,47,-25,2,1,1,2,-1,4,3,2,2,4,1,1,2,-1,2,1,0,7,2,1,-8,7,-6,0,1,-1,1,1,-1,3,-1
KR_6726703730,420,-3,-17,-4,-8,-2,2,0,-1,3,2,-1,2,1,-2,3,1,-2,4,2,0,-6,-5,-2,-5,7,-5,0,-1,-1,-1,-1,-1,1,-1
KR_6768909409,420,-3,6,-19,-6,-2,2,0,-2,2,0,-2,5,3,-2,2,0,2,0,2,0,-4,-6,-3,-7,10,-6,0,0,-1,-1,0,-1,5,-1
KR_6776341866,420,1,-16,-7,3,-3,4,1,2,2,4,-2,5,3,2,0,2,4,0,4,0,4,-5,-2,-6,8,5,0,1,-1,1,1,1,6,-1
KR_6766678476,420,-1,-32,-3,-2,-1,2,1,0,1,1,-5,5,0,1,1,2,3,0,3,0,-2,0,1,-7,6,-3,0,-1,-1,-1,-1,-1,4,-1
KR_6770456010,420,0,18,-16,-3,-1,3,2,-3,7,4,2,1,3,-2,4,2,1,0,1,1,-1,8,1,-7,6,-4,0,1,-1,1,1,1,6,-1
KR_6765720844,420,1,-12,-1,0,-2,2,0,1,1,2,4,2,6,-3,6,3,0,0,0,0,-1,-10,-4,-4,8,5,0,-1,1,-1,-1,-1,3,-1
KR_6722561298,420,-2,-41,-12,-4,-3,3,0,0,4,4,3,2,5,-2,2,0,-2,3,1,2,9,-7,1,-6,5,0,0,0,-1,1,0,1,2,-1
KR_6762871498,420,-1,40,25,-8,-3,4,1,-5,5,0,-1,3,2,1,1,2,0,0,0,0,-14,-11,-4,-7,11,-5,0,0,1,-1,0,-1,6,-1
KR_6776862504,420,1,50,-20,-1,1,1,2,-6,8,2,-2,3,1,4,2,6,2,2,4,0,-1,-5,-2,-3,5,2,0,1,-1,-1,1,1,4,-1
KR_6776039612,420,-1,28,21,-1,-1,3,2,-1,4,3,-2,3,1,2,2,4,1,1,2,0,1,-3,-1,-5,6,1,0,0,-1,1,1,1,6,-1
KR_6646350098,420,-1,-68,-15,0,-1,2,1,2,0,2,1,0,1,-1,3,2,-1,2,1,0,0,6,7,-11,4,5,0,-1,1,1,1,1,4,-1
KR_6672209072,420,-4,-69,-24,-1,-2,4,2,-2,6,4,-1,2,1,4,3,7,0,2,2,0,1,0,2,-6,4,-4,0,-2,1,-1,-1,-1,1,-1
KR_6771775887,420,0,-3,-6,-3,1,0,1,-1,2,1,-2,2,0,-1,1,0,0,1,1,0,-5,-10,2,-5,3,6,0,0,-1,1,1,-1,2,-1
KR_6749759236,420,-4,-76,6,-9,0,2,2,3,1,4,-6,6,0,-6,6,0,0,0,0,0,-11,6,-2,-4,6,-2,0,-1,-1,-1,-1,-1,1,-1
KR_6725109717,420,-5,-36,-2,-9,0,1,1,-4,5,1,-3,3,0,2,2,4,-4,5,1,0,-6,-8,0,-5,5,1,0,0,1,-1,0,-1,4,-1
KR_6708209248,420,-2,-28,29,-6,0,1,1,-4,4,0,-1,2,1,-2,3,1,1,0,1,-1,-10,0,-5,-3,8,-7,0,-2,-1,-1,-1,-1,2,-1
KR_6765021247,420,0,32,-11,-10,-4,6,2,-3,5,2,-1,2,1,-1,3,2,-1,1,0,-3,-14,7,-6,-4,10,-3,0,1,-1,-1,1,-1,4,-1
KR_6776734306,420,-4,-41,-28,-11,-2,4,2,-4,5,1,-4,4,0,-1,1,0,0,0,0,0,-10,-11,6,-9,3,-7,0,-3,-1,-1,-1,-1,2,-1
KR_6769401354,420,-1,0,2,3,1,5,6,0,2,2,1,2,3,0,3,3,1,0,1,0,2,-2,1,-8,7,3,0,0,0,1,-1,1,0,-1
KR_6773148629,440,-3,1,-8,-8,1,1,2,-2,3,1,0,1,1,2,1,3,-9,11,2,0,-13,-8,4,-6,2,-4,0,-1,-1,1,-1,-1,6,-1
KR_6768547759,420,-4,-43,-11,-9,-1,2,1,-4,5,1,-2,2,0,-2,6,4,0,1,1,0,-14,-7,0,-9,9,-4,0,-2,-1,-1,-1,-1,1,-1
KR_6765872902,440,0,-9,-7,3,4,0,4,0,2,2,-1,2,1,0,3,3,0,2,2,0,0,5,2,-7,5,2,0,0,0,0,0,1,0,-1
KR_6776988558,420,-3,-77,-43,-14,-2,2,0,-7,8,1,-3,5,2,-1,3,2,-1,1,0,0,-6,-25,0,-5,5,0,0,-1,-1,-1,-1,-1,3,-1
KR_6744202245,420,-5,-40,-25,-6,-5,5,0,-2,6,4,4,1,5,-2,3,1,-1,1,0,0,-5,4,0,-5,5,0,0,-1,1,-1,-1,1,1,-1
KR_6674679333,420,1,9,6,0,1,2,3,-4,4,0,1,0,1,3,3,6,-1,3,2,-1,-2,1,0,-4,4,2,0,0,-1,1,0,-1,1,-1
KR_6724608860,420,0,-15,0,1,2,0,2,-1,3,2,-1,2,1,1,0,1,0,0,0,0,0,10,3,-9,6,-2,0,0,1,1,0,-1,3,-1
KR_6750663604,420,-1,18,-19,1,1,0,1,2,2,4,5,0,5,-4,4,0,-3,4,1,0,1,-4,2,-7,5,9,0,1,1,1,1,-1,5,-1
KR_6768146742,440,-4,-22,5,-16,-1,2,1,-6,7,1,-5,6,1,-4,7,3,0,1,1,0,-10,1,0,-5,5,0,0,0,-1,1,1,-1,5,-1
KR_6768061638,420,0,-31,8,-8,-1,4,3,-1,4,3,-3,3,0,-1,2,1,-2,2,0,0,-13,43,1,-9,8,-3,0,-1,-1,-1,-1,1,3,-1
KR_6773652890,420,-2,-99,36,-9,-2,4,2,-2,4,2,-1,2,1,-5,5,0,1,1,2,0,-7,-22,3,-9,6,2,0,-3,-1,-1,-1,-1,1,-1
KR_6777663473,420,-4,-74,-26,-4,1,3,4,-3,4,1,-1,2,1,0,2,2,-1,1,0,-1,-3,173,-2,-7,9,1,0,-2,1,-1,-1,1,4,-1
KR_6777573988,440,1,-30,2,6,-1,1,0,8,1,9,5,1,6,-6,7,1,0,2,2,0,5,8,3,-6,3,-2,0,-1,1,1,-1,-1,1,-1
KR_6776968368,420,-5,-20,1,-5,-2,2,0,1,3,4,1,0,1,1,4,5,-6,6,0,0,-3,-1,-2,-3,5,0,0,-2,1,-1,-1,-1,3,-1
KR_6739319025,420,-3,-3,14,-14,-4,5,1,2,2,4,-3,5,2,-6,6,0,-3,3,0,0,-11,34,-1,-5,6,0,0,-1,-1,-1,-1,-1,5,-1
KR_6729792578,420,-4,-148,-5,-9,-3,3,0,-1,7,6,-1,3,2,-2,3,1,-2,2,0,0,-3,-6,-2,-5,7,1,0,-2,-1,-1,-1,-1,3,-1
KR_6772930017,420,2,69,22,0,2,3,5,0,1,1,2,3,5,-5,5,0,1,0,1,0,-7,7,-2,-6,8,-3,0,0,1,-1,-1,1,5,-1
KR_6774171811,420,2,-49,-35,-3,4,1,5,-4,5,1,0,1,1,-3,4,1,0,2,2,1,-10,-8,-4,-6,10,-2,0,1,-1,1,1,1,5,-1
KR_6640551584,420,0,-64,16,0,-4,4,0,3,3,6,-1,5,4,0,0,0,2,1,3,0,-1,18,-1,-6,7,-2,0,-1,1,1,-1,-1,2,-1
KR_6723550532,420,-2,6,-56,-7,-3,5,2,-4,7,3,3,2,5,1,3,4,-4,4,0,-2,-7,-4,5,-10,5,-3,0,1,-1,-1,1,1,4,-1
KR_6752279390,420,-2,-70,-13,1,-1,1,0,2,4,6,-2,4,2,2,2,4,0,0,0,0,3,0,-2,-7,9,-3,0,-2,1,-1,-1,1,6,-1
KR_6777133481,420,0,32,42,-2,-4,6,2,-1,3,2,-2,4,2,2,1,3,3,0,3,-1,0,-16,0,-6,6,-2,0,1,-1,-1,1,-1,4,-1
KR_6769591859,420,1,-3,33,5,6,0,6,5,1,6,-3,3,0,-3,3,0,0,0,0,0,-3,0,2,-5,3,-2,0,2,1,1,1,1,2,-1
KR_6777372448,420,-6,22,-25,-9,-2,2,0,-4,6,2,-3,3,0,2,0,2,-2,2,0,0,-15,15,4,-8,4,-1,0,1,-1,1,1,-1,5,-1
KR_6776662516,420,-4,-34,-36,-9,-2,2,0,-1,3,2,-3,5,2,-2,3,1,-1,1,0,0,-1,2,3,-6,3,-7,0,0,-1,1,0,1,1,-1
KR_6774080232,420,0,-62,-2,-5,0,3,3,-1,2,1,-3,3,0,-1,2,1,0,0,0,-1,-11,-9,-2,-4,6,-3,0,-1,-1,1,-1,-1,6,-1
KR_6744479556,420,-5,-17,-25,-4,-3,3,0,-4,5,1,5,0,5,-2,3,1,0,0,0,0,1,-3,2,-9,7,5,0,0,1,1,1,-1,2,-1
KR_6767767446,420,-2,-45,13,-13,3,1,4,-6,7,1,-5,8,3,-3,5,2,-2,3,1,-2,-18,68,-5,-3,8,-20,0,-1,-1,-1,-1,-1,5,-1
KR_6761022038,420,0,-79,32,3,-1,3,2,-2,4,2,3,0,3,3,4,7,0,1,1,0,9,28,2,-8,6,-3,0,0,-1,1,1,-1,2,-1
KR_6777410641,420,1,30,12,2,0,1,1,0,2,2,0,2,2,5,2,7,-3,3,0,0,3,0,6,-11,5,3,0,-1,1,-1,-1,1,1,-1
KR_6774940878,420,-1,-60,8,-4,-1,1,0,-2,4,2,-2,3,1,1,2,3,0,2,2,0,-7,21,-6,-4,10,-7,0,0,1,1,0,-1,4,-1
KR_6741565652,420,-3,-78,-32,3,-4,4,0,-1,3,2,2,2,4,4,1,5,2,1,3,2,9,2,0,-6,6,0,0,-2,-1,-1,-1,1,2,-1
KR_6741296872,420,0,-11,-16,3,1,1,2,2,3,5,5,0,5,-6,7,1,1,1,2,0,0,-1,1,-9,8,-3,0,0,-1,1,1,1,2,-1
KR_6732023458,440,1,-26,0,0,-1,1,0,-1,2,1,0,4,4,1,1,2,1,0,1,0,9,-14,3,-8,5,2,0,0,1,0,0,1,6,-1
KR_6656743521,420,-3,-50,-31,2,0,1,1,-3,4,1,0,4,4,4,2,6,1,0,1,0,7,-4,-3,-3,6,-1,0,-1,1,-1,-1,1,2,-1
KR_6761481981,420,-1,-23,-13,-5,-2,3,1,-4,4,0,0,5,5,2,2,4,-1,2,1,0,-6,-50,-1,-7,8,30,0,1,1,-1,-1,-1,6,-1
KR_6756768833,420,4,-6,12,13,5,0,5,1,2,3,6,0,6,0,2,2,1,0,1,0,16,-9,1,-6,5,4,0,0,-1,-1,0,1,5,-1
KR_6768777800,420,-1,71,-1,-14,3,1,4,-9,10,1,-1,3,2,-6,8,2,-1,2,1,-3,-33,-33,-1,-6,7,2,0,-1,-1,-1,-1,-1,4,-1
KR_6773495356,440,-4,-63,-29,-12,-1,4,3,-11,12,1,-4,4,0,3,0,3,1,3,4,-2,-12,359,-2,-1,3,3,0,1,-1,1,-1,-1,2,-1
KR_6740614485,420,0,38,20,-11,-1,1,0,-5,5,0,2,2,4,-3,5,2,-4,4,0,-1,-18,4,2,-7,5,0,0,2,-1,1,1,-1,3,-1
KR_6710065568,420,2,4,24,1,1,1,2,2,0,2,1,0,1,-1,1,0,-2,2,0,0,0,-15,-1,-10,11,0,0,0,-1,-1,0,1,1,-1
KR_6776589075,420,-1,-7,4,-3,2,1,3,-2,4,2,0,3,3,-2,6,4,-1,4,3,0,-4,-5,0,-8,8,3,0,0,-1,-1,0,1,1,-1
KR_6768727628,420,-3,-21,-23,-18,-2,5,3,-4,6,2,-3,3,0,-1,2,1,-8,10,2,-3,-36,2,-1,-5,6,-3,0,-2,-1,-1,-1,-1,1,-1
KR_6738512690,440,-3,6,-16,-6,0,0,0,-4,6,2,-4,7,3,2,6,8,0,0,0,0,-10,-13,2,-8,6,4,0,-1,-1,1,-1,-1,5,-1
KR_6754112753,420,-2,-3,-5,0,-3,4,1,3,3,6,0,2,2,0,3,3,0,0,0,0,7,1,2,-6,4,-1,0,0,-1,-1,-1,-1,4,-1
KR_6761123433,420,-3,-124,5,-6,-2,2,0,-1,1,0,0,3,3,-4,5,1,1,0,1,0,-3,-12,2,-9,7,0,0,-1,1,-1,-1,-1,3,-1
KR_6760225029,420,0,-15,24,7,0,1,1,3,5,8,0,0,0,3,1,4,1,0,1,0,11,35,3,-10,7,3,0,1,0,-1,1,1,0,-1
KR_6760891179,420,0,-48,-5,0,-2,2,0,7,0,7,-1,4,3,-1,4,3,-3,3,0,1,1,23,-2,-8,10,3,0,0,-1,1,-1,1,5,-1
KR_6741168293,420,-3,-9,-2,-6,-1,4,3,-5,8,3,-1,2,1,2,2,4,-1,2,1,0,-14,22,1,-6,5,-3,0,-1,1,-1,-1,1,2,-1
KR_6776816362,420,0,-35,0,-1,0,0,0,0,3,3,0,2,2,-3,5,2,2,0,2,0,-7,8,-1,-4,5,6,0,1,-1,1,1,1,6,-1
KR_6671275475,420,1,-18,-8,1,3,1,4,-2,5,3,3,1,4,-4,4,0,1,1,2,1,0,3,1,-7,6,-5,0,0,-1,1,-1,1,3,-1
KR_6773932146,420,-3,39,-15,-6,-2,2,0,-4,7,3,-1,2,1,0,3,3,1,0,1,0,-3,18,-3,-6,9,1,0,-1,-1,-1,-1,-1,5,-1
KR_6761441425,440,-6,-132,3,-11,2,1,3,-4,5,1,-6,6,0,-3,4,1,0,0,0,0,-7,57,6,-7,1,-6,0,-1,1,-1,-1,-1,6,-1
KR_6720994436,420,2,99,-3,0,-1,6,5,1,2,3,-2,5,3,3,4,7,-1,2,1,-5,-11,-3,-1,-7,8,3,0,1,1,-1,1,-1,3,-1
KR_6739485889,440,-3,-51,-45,-3,2,1,3,-1,3,2,-1,1,0,0,1,1,-3,3,0,0,0,10,-3,-2,5,2,0,0,-1,1,0,1,3,-1
KR_6739413772,420,-1,-11,-34,5,-3,6,3,0,1,1,4,1,5,1,3,4,3,0,3,1,8,30,0,-4,4,2,0,-1,1,-1,-1,1,5,-1
KR_6668988126,420,0,-38,-16,0,1,4,5,0,1,1,-2,2,0,0,3,3,1,0,1,-1,0,11,2,-9,7,-3,0,1,-1,1,1,-1,2,-1
KR_6773496023,420,-3,-59,-6,-4,-3,3,0,0,1,1,-1,2,1,1,1,2,-1,1,0,0,-3,21,-4,-3,7,0,0,-1,1,-1,-1,1,4,-1
KR_6775690868,420,-1,10,-16,-7,0,1,1,2,2,4,1,0,1,-2,4,2,-8,9,1,1,-3,4,-3,-2,5,0,0,-1,-1,-1,-1,1,2,-1
KR_6776092771,420,1,17,-19,4,1,0,1,-5,10,5,2,1,3,6,1,7,0,3,3,-2,-3,-7,-1,-6,7,0,0,1,1,1,1,-1,2,-1
KR_6768738069,420,-1,9,16,-14,-4,5,1,-4,5,1,-2,4,2,0,4,4,-4,6,2,0,-11,-104,-3,-5,8,-1,0,-2,0,-1,-1,-1,0,-1
KR_6776714646,420,-6,-63,-18,-11,-5,5,0,-1,2,1,-5,6,1,1,2,3,-1,1,0,0,-1,-7,-4,-5,9,-4,0,-1,-1,-1,-1,-1,2,-1
KR_6737541335,420,2,27,0,0,-1,1,0,2,2,4,-2,5,3,3,3,6,-2,2,0,-3,-1,-12,-2,-4,6,0,0,0,1,-1,-1,-1,3,-1
KR_6736707016,420,1,-41,21,-4,-3,5,2,0,4,4,1,0,1,-2,3,1,0,0,0,0,2,-18,-4,-4,8,10,0,1,1,1,1,-1,6,-1
KR_6743950624,420,-5,-62,-7,-7,-2,2,0,-2,8,6,-1,5,4,1,4,5,-3,4,1,1,-12,-11,-2,-4,6,-1,0,-2,-1,-1,-1,1,1,-1
KR_6765862740,420,0,-104,18,3,2,2,4,-4,7,3,0,2,2,2,1,3,3,1,4,0,0,18,-3,-8,11,-3,0,-1,-1,1,-1,1,1,-1
KR_6765973853,420,-1,-13,0,-9,-4,5,1,-1,3,2,-3,5,2,4,4,8,-5,7,2,-3,-11,7,5,-7,2,-4,0,-2,-1,-1,-1,-1,2,-1
KR_6768470305,420,-4,-8,-4,-5,-3,4,1,-1,3,2,-1,4,3,-1,2,1,1,2,3,0,-6,-10,5,-8,3,-2,0,0,0,1,-1,-1,0,-1
KR_6771502525,420,-3,-64,-36,1,-2,3,1,6,1,7,-2,3,1,2,3,5,-3,4,1,0,-8,-14,-6,-5,11,1,0,-2,1,1,-1,1,2,-1
KR_6767135881,420,2,-49,23,11,8,0,8,2,1,3,-1,1,0,0,2,2,2,0,2,0,11,8,3,-8,5,0,0,-1,1,1,-1,1,6,-1
KR_6768737462,420,-2,8,-32,-11,-1,2,1,-3,5,2,1,4,5,-8,9,1,0,0,0,0,-9,25,-2,-4,6,-3,0,0,-1,-1,-1,-1,1,-1
KR_6765248239,420,1,-12,9,0,-2,2,0,5,3,8,-2,4,2,1,3,4,-2,2,0,0,1,49,0,-6,6,-4,0,1,0,1,1,1,0,-1
KR_6776756057,420,-2,-3,-39,-3,-2,2,0,-3,3,0,-3,3,0,4,1,5,1,2,3,0,2,-25,1,-7,6,5,0,0,1,-1,1,-1,4,-1
KR_6765820915,420,-2,8,-18,-6,2,1,3,-1,6,5,-3,3,0,-2,5,3,-2,3,1,1,-12,2,0,-4,4,-6,0,-1,-1,-1,-1,1,6,-1
KR_6769227329,420,1,16,-5,1,1,3,4,-4,7,3,-2,2,0,6,5,11,0,1,1,-1,-7,-5,-6,-3,9,2,0,-1,1,-1,1,-1,3,-1
KR_6774128207,420,-2,3,-32,-3,-2,3,1,-5,7,2,3,2,5,2,1,3,-1,1,0,0,-5,-41,-1,-1,2,1,0,1,-1,1,1,1,4,-1
KR_6735279214,420,-1,-27,9,-2,-3,3,0,1,2,3,6,1,7,-3,3,0,-3,3,0,0,-4,5,4,-11,7,-5,0,-2,-1,-1,-1,-1,6,-1
KR_6751715321,420,-3,-30,-28,-8,-4,6,2,-6,7,1,0,3,3,-1,3,2,3,1,4,0,-9,7,5,-10,5,-6,0,0,-1,-1,0,-1,5,-1
KR_6772812738,420,0,-51,5,-4,-1,2,1,1,2,3,0,3,3,-2,4,2,-2,2,0,0,-5,11,4,-10,6,2,0,-1,-1,1,-1,-1,1,-1
KR_6768884015,420,-2,-25,-27,-12,-1,1,0,2,4,6,-4,5,1,-5,5,0,-4,6,2,0,-11,3,-1,-6,7,-9,0,0,-1,1,0,-1,2,-1
KR_6769724853,420,-4,6,10,-16,2,2,4,-5,6,1,-8,8,0,-3,4,1,-2,2,0,-1,-25,2,2,-6,4,-2,0,-1,-1,-1,-1,-1,2,-1
KR_6741393869,420,-2,-33,-12,-5,2,1,3,5,0,5,-4,6,2,-8,8,0,0,0,0,0,-2,4,5,-13,8,-3,0,-1,1,-1,-1,-1,4,-1
KR_6774060951,420,-2,-19,31,-3,-2,2,0,0,3,3,1,2,3,-1,3,2,-1,2,1,0,-7,-10,-4,-3,7,4,0,-2,1,1,-1,-1,3,-1
KR_6773882517,420,-2,-43,6,-1,-2,2,0,3,1,4,3,0,3,-3,3,0,-2,3,1,0,2,59,2,-7,5,5,0,-1,-1,1,-1,-1,4,-1
KR_6752410119,420,0,-42,11,3,-1,1,0,1,1,2,4,0,4,0,1,1,-1,1,0,0,6,27,-1,-7,8,2,0,-1,1,-1,-1,1,1,-1
KR_6738190927,420,-2,-31,0,-7,0,3,3,-1,3,2,-6,7,1,0,3,3,0,1,1,0,-8,5,-3,-4,7,-3,0,0,-1,1,0,1,2,-1
KR_6776715153,420,-6,-105,-13,-9,-2,2,0,1,3,4,-6,7,1,-1,5,4,-1,1,0,0,-7,-2,-1,-3,4,0,0,-2,-1,-1,-1,-1,3,-1
KR_6749863445,420,-1,-16,-11,-14,-1,2,1,-4,8,4,-4,7,3,-4,8,4,-1,1,0,-2,-21,15,-1,-4,5,0,0,-2,-1,1,-1,-1,5,-1
KR_6749992805,420,-4,-62,11,-9,-3,3,0,-1,2,1,1,2,3,-5,5,0,-1,1,0,0,-17,-14,2,-5,3,-5,0,0,-1,1,1,-1,4,-1
KR_6766083591,420,-1,17,17,-7,0,1,1,0,0,0,-2,5,3,-3,7,4,-2,4,2,0,-14,-1,1,-7,6,-6,0,1,-1,0,1,-1,6,-1
KR_6772363641,420,-3,-48,-11,-8,-2,3,1,-1,4,3,0,0,0,-2,3,1,-3,4,1,0,-5,38,3,-8,5,2,0,-1,-1,-1,-1,-1,6,-1
KR_6762708338,420,0,-32,16,1,-1,2,1,-6,7,1,0,2,2,5,1,6,3,1,4,-1,4,22,2,-9,7,-4,0,1,-1,1,1,-1,5,-1
KR_6716732149,420,-3,-33,-24,-3,3,3,6,-1,1,0,0,0,0,-2,3,1,-3,3,0,0,-7,2,-1,-5,6,-5,0,0,-1,1,0,-1,5,-1
KR_6758188116,420,-1,8,18,-8,-1,6,5,0,2,2,-5,5,0,-2,6,4,0,2,2,0,-5,-22,3,-6,3,-3,0,0,-1,1,-1,-1,4,-1
KR_6777128280,420,-1,-6,-7,-1,-1,3,2,3,2,5,-2,4,2,-1,4,3,0,0,0,0,10,0,-4,-5,9,-1,0,-2,1,-1,-1,-1,5,-1
KR_6775542176,420,-1,7,7,-8,-2,2,0,-4,6,2,-1,5,4,0,2,2,-1,1,0,-1,-7,-6,-2,-6,8,0,0,0,1,1,-1,-1,1,-1
KR_6726053761,420,-1,9,-2,1,0,1,1,-2,8,6,3,2,5,2,4,6,-2,4,2,0,-8,-4,1,-8,7,-1,0,1,-1,1,1,-1,3,-1
KR_6776377942,420,-1,-29,-2,1,0,3,3,-1,5,4,3,1,4,-2,5,3,1,1,2,1,3,-27,-3,-7,10,4,0,0,-1,-1,0,-1,5,-1
KR_6743454390,420,-3,-104,-15,5,-2,3,1,6,0,6,0,2,2,2,2,4,-1,3,2,0,15,3,1,-6,5,-4,0,-3,-1,1,-1,-1,4,-1
KR_6765022097,420,0,29,-4,-4,-1,2,1,-2,4,2,-1,2,1,0,0,0,0,0,0,0,-8,-39,3,-8,5,0,0,0,1,1,0,-1,6,-1
KR_6770058283,420,-4,-64,32,-12,3,1,4,-4,5,1,-8,9,1,-4,4,0,1,0,1,0,-16,-152,-4,-4,8,6,0,-1,1,1,-1,-1,4,-1
KR_6747658601,420,0,-4,25,-4,3,0,3,-5,5,0,-3,3,0,2,1,3,-1,1,0,0,-7,-2,-3,-3,6,7,0,0,1,-1,0,-1,3,-1
KR_6769819471,420,-4,-34,-51,-4,0,1,1,-5,7,2,-1,1,0,3,3,6,-1,2,1,0,-5,40,1,-7,6,-7,0,0,-1,1,1,1,1,-1
KR_6772421726,420,0,13,16,-3,1,1,2,2,1,3,-1,5,4,-3,4,1,-2,2,0,0,-11,-1,4,-8,4,3,0,0,0,1,1,-1,0,-1
KR_6766441326,420,0,-50,13,2,1,4,5,-1,3,2,-3,5,2,6,0,6,-1,1,0,0,1,3,2,-7,5,-3,0,3,1,1,1,1,3,-1
KR_6775983965,420,-2,3,-8,-10,3,0,3,-4,6,2,1,1,2,-9,10,1,-1,1,0,0,-19,-5,0,-5,5,2,0,-1,1,-1,-1,-1,4,-1
KR_6776615066,420,-1,18,5,-2,0,1,1,1,1,2,-4,4,0,2,0,2,-1,1,0,1,-1,-1,1,-7,6,-1,0,0,1,-1,0,1,5,-1
KR_6769639028,440,-7,-129,-24,-22,-10,10,0,0,1,1,-3,3,0,-9,9,0,0,0,0,-1,-17,3,-1,-5,6,-5,0,-3,-1,0,-1,-1,2,-1
KR_6768593642,420,1,-42,-15,11,0,1,1,3,3,6,3,0,3,3,4,7,2,0,2,-2,10,-9,-1,-5,6,8,0,-1,1,-1,-1,-1,5,-1
KR_6756121215,420,-5,-49,-28,-5,-1,3,2,-1,4,3,-3,5,2,2,1,3,-2,3,1,0,-5,6,0,-6,6,0,0,-2,-1,-1,-1,-1,5,-1
KR_6760650499,420,-2,-48,-21,-3,-1,4,3,6,1,7,-2,3,1,-3,3,0,-3,4,1,0,-5,15,-3,-3,6,-4,0,1,-1,1,1,1,6,-1
KR_6684329562,420,-4,-32,-32,-12,-1,4,3,4,1,5,1,1,2,-16,17,1,0,1,1,-2,-16,0,-2,-8,10,5,0,-1,-1,1,-1,-1,2,-1
KR_6685484233,420,-2,-2,24,-4,0,4,4,2,1,3,0,0,0,-6,7,1,0,0,0,0,-5,35,-1,-9,10,4,0,0,1,1,1,-1,6,-1
KR_6772632000,420,-3,4,-12,-5,1,1,2,-7,7,0,0,3,3,1,3,4,0,0,0,0,-10,-15,6,-11,5,-2,0,0,-1,1,1,1,2,-1
KR_6765603819,420,-1,-16,3,-5,-1,2,1,-4,5,1,-2,4,2,2,1,3,0,1,1,0,-5,-3,0,-6,6,-4,0,-1,-1,-1,-1,-1,2,-1
KR_6756402258,420,1,45,0,3,1,1,2,-3,4,1,0,2,2,5,0,5,0,1,1,0,3,12,-3,-4,7,0,0,1,1,1,1,1,6,-1
KR_6758100696,420,3,30,25,2,1,2,3,-1,4,3,2,1,3,1,0,1,-1,1,0,0,5,11,0,-6,6,2,0,2,1,1,1,-1,1,-1
KR_6765193110,420,-1,-12,-4,2,-2,2,0,1,1,2,-1,4,3,4,0,4,0,0,0,0,5,-40,-1,-6,7,-1,0,-1,1,-1,-1,-1,2,-1
KR_6772023045,420,-2,-2,2,-3,0,2,2,-4,5,1,1,1,2,0,1,1,0,0,0,0,-1,1,-2,-6,8,0,0,-1,-1,-1,-1,-1,6,-1
KR_6747435194,420,0,15,9,-2,-1,3,2,0,5,5,-2,3,1,0,3,3,1,1,2,0,6,0,1,-9,8,-11,0,-1,1,-1,-1,-1,6,-1
KR_6746258152,420,-1,62,-16,0,-1,2,1,0,4,4,2,0,2,-1,3,2,0,0,0,1,-1,2,2,-8,6,-4,0,0,1,-1,0,1,3,-1
KR_6768069396,420,2,7,-20,4,2,0,2,-4,6,2,0,2,2,4,0,4,2,3,5,0,12,-33,-4,-4,8,6,0,0,-1,1,0,1,1,-1
KR_6774719177,440,3,-11,43,0,-1,1,0,0,2,2,2,3,5,-1,3,2,0,0,0,0,-7,-5,-4,-6,10,4,0,1,1,1,1,1,4,-1
KR_6774501397,420,0,-9,-15,2,-2,3,1,0,2,2,0,2,2,2,1,3,2,1,3,0,3,15,-3,-3,6,-2,0,-1,-1,-1,-1,1,4,-1
KR_6763219839,440,-5,-32,-9,-16,-3,3,0,3,1,4,-2,3,1,-9,12,3,-5,6,1,0,-9,11,11,-14,3,-6,0,-1,-1,-1,-1,1,2,-1
KR_6773061373,420,0,-14,-19,-4,0,0,0,-4,5,1,1,4,5,1,7,8,-2,3,1,0,-12,3,4,-7,3,-1,0,0,-1,1,-1,1,4,-1
KR_6776520778,420,0,-14,-17,3,1,2,3,-6,6,0,5,0,5,4,0,4,-1,1,0,-2,2,40,-3,-5,8,-2,0,-1,-1,1,-1,-1,3,-1
KR_6748107873,420,-2,-37,-10,0,0,3,3,-5,7,2,5,0,5,-2,2,0,2,0,2,0,1,5,-4,-6,10,-1,0,-1,1,1,-1,-1,6,-1
KR_6774977652,440,-4,-23,-28,-10,-1,1,0,-3,4,1,0,4,4,0,0,0,-6,6,0,0,-11,5,0,-5,5,-3,0,0,-1,-1,-1,-1,6,-1
KR_6770091088,420,-5,-50,-22,-7,-4,6,2,-2,3,1,2,1,3,-2,4,2,-1,2,1,0,0,-3,-1,-5,6,3,0,-1,-1,-1,-1,1,5,-1
KR_6777826516,420,-1,3,2,-6,-2,3,1,0,0,0,-2,4,2,-3,3,0,1,1,2,0,-8,3,0,-7,7,-1,0,0,-1,-1,0,-1,2,-1
KR_6772583942,420,1,48,0,4,0,3,3,4,0,4,-2,4,2,1,3,4,1,0,1,0,-2,-3,-3,-5,8,-1,0,1,1,1,1,1,2,-1
KR_6760047072,420,-3,-98,-8,-7,1,1,2,-2,6,4,0,3,3,-6,6,0,0,1,1,0,-12,6,1,-8,7,-7,0,0,1,-1,-1,-1,2,-1
KR_6774390311,420,-2,-5,-25,-6,-4,4,0,-4,5,1,-4,4,0,3,2,5,3,1,4,-1,-2,0,1,-6,5,-2,0,0,1,-1,0,-1,1,-1
KR_6765178982,420,-1,-26,17,-7,4,4,8,-2,6,4,-3,4,1,-5,7,2,-1,2,1,-1,-10,-36,2,-8,6,-4,0,-2,-1,-1,-1,1,1,-1
KR_6741866385,440,-1,-27,24,-5,-6,6,0,-2,3,1,-2,5,3,5,2,7,0,0,0,0,0,8,2,-7,5,1,0,0,1,-1,0,-1,1,-1
KR_6660876647,420,-11,-126,-24,-17,-7,8,1,-2,3,1,-3,4,1,-3,3,0,-2,2,0,0,-17,-4,1,-6,5,0,0,-3,-1,1,-1,-1,4,-1
KR_6763521956,420,-1,4,20,3,2,2,4,3,5,8,0,1,1,-3,5,2,1,1,2,0,-1,46,2,-7,5,4,0,0,1,1,0,1,6,-1
KR_6767923842,420,-2,-62,-25,-13,-3,3,0,-2,5,3,-1,3,2,-6,7,1,-1,1,0,0,-19,-8,-6,-4,10,-1,0,-3,-1,-1,-1,-1,5,-1
KR_6696276551,440,-3,14,18,-7,-2,2,0,-3,8,5,-1,3,2,1,2,3,-2,2,0,1,-9,31,-6,-1,7,-24,0,1,-1,-1,1,1,1,-1
KR_6767793870,420,-2,-77,36,-5,-4,5,1,-1,2,1,-9,9,0,10,1,11,-1,1,0,0,-11,7,3,-6,3,-1,0,0,1,1,-1,1,3,-1
KR_6760903417,420,-3,20,-24,-7,-3,4,1,4,1,5,-5,5,0,-2,6,4,-1,1,0,0,-6,-5,-2,-8,10,-2,0,0,-1,0,0,-1,2,-1
KR_6763714961,420,-1,-15,-20,6,-1,2,1,0,3,3,3,1,4,7,0,7,-3,4,1,3,12,-7,-5,-3,8,1,0,-1,-1,-1,-1,1,1,-1
KR_6763626662,420,4,84,26,6,-1,1,0,2,1,3,-2,4,2,6,3,9,1,0,1,0,9,-35,-4,-5,9,1,0,2,-1,1,1,-1,6,-1
KR_6773145499,420,-1,-45,-3,-4,3,0,3,-5,5,0,-3,3,0,3,2,5,-2,3,1,0,-9,-10,2,-9,7,-4,0,-1,1,1,-1,-1,2,-1
KR_6732513476,420,-2,27,1,-10,-4,4,0,-2,5,3,-6,6,0,-1,5,4,3,0,3,0,-12,116,3,-11,8,0,0,0,0,-1,-1,-1,0,-1
KR_6773158103,420,-3,46,-40,-7,-3,3,0,-4,5,1,-4,7,3,5,0,5,-1,2,1,1,-7,-9,-2,-7,9,7,0,0,1,-1,0,1,5,-1
KR_6769771840,420,2,8,-2,4,-5,5,0,4,5,9,0,1,1,4,2,6,1,0,1,-1,11,-12,-5,-4,9,9,0,1,-1,-1,1,-1,3,-1
KR_6740216827,440,1,4,0,1,1,4,5,3,1,4,-3,6,3,1,1,2,-1,3,2,-1,-1,1,-1,-6,7,1,0,-1,1,-1,-1,-1,6,-1
KR_6773678544,420,-1,39,4,-3,-4,5,1,3,4,7,0,3,3,-1,3,2,-1,2,1,2,-1,31,0,-5,5,0,0,0,-1,1,1,-1,4,-1
KR_6775132137,420,-4,-39,-29,-10,-4,4,0,-1,5,4,-5,6,1,1,1,2,-1,3,2,0,-1,-5,-1,-4,5,-3,0,0,-1,-1,-1,-1,6,-1
KR_6754300935,420,-4,-18,-16,-14,-5,7,2,1,4,5,2,4,6,-12,13,1,0,2,2,-1,-7,2,-2,-3,5,-2,0,-2,-1,1,-1,-1,4,-1
KR_6777541216,420,2,5,-8,-5,-3,5,2,-1,6,5,-2,3,1,-2,2,0,3,1,4,0,-6,6,-3,-4,7,0,0,0,-1,1,0,-1,5,-1
KR_6777540253,420,3,44,15,4,1,2,3,-2,8,6,1,1,2,2,3,5,2,0,2,-1,-3,-10,1,-11,10,-3,0,1,1,1,1,-1,2,-1
KR_6771360507,420,-2,-19,-36,0,-1,3,2,0,1,1,2,3,5,2,2,4,-3,3,0,0,5,-14,-7,-3,10,4,0,0,1,-1,-1,-1,5,-1
KR_6738844662,420,-4,-27,-16,-9,-5,6,1,1,3,4,-3,3,0,0,1,1,-2,4,2,0,-4,170,-4,-2,6,1,0,-4,-1,-1,-1,-1,4,-1
KR_6767922510,420,-4,-39,0,-13,-3,5,2,-1,5,4,-2,5,3,-4,4,0,-3,3,0,0,-7,1,0,-4,4,3,0,-2,-1,1,-1,-1,5,-1
KR_6744664165,420,-1,11,-36,0,-5,6,1,3,1,4,-1,3,2,2,1,3,1,1,2,0,3,-7,-1,-3,4,4,0,-1,1,-1,-1,-1,3,-1
KR_6777582238,420,0,24,8,-1,2,1,3,-1,4,3,-2,3,1,0,0,0,0,1,1,0,-7,-38,-2,-3,5,4,0,-1,1,-1,-1,1,6,-1
KR_6759004279,420,1,10,12,4,1,0,1,4,1,5,0,1,1,0,1,1,-1,1,0,0,5,-7,1,-5,4,-9,0,1,1,1,1,-1,1,-1
KR_6770150242,440,-2,-24,-58,-12,1,5,6,-5,5,0,-2,3,1,0,1,1,-6,8,2,0,-2,-7,-3,-6,9,0,0,0,-1,1,-1,1,5,-1
KR_6771211962,420,-4,-38,-22,-4,-2,3,1,6,2,8,-3,4,1,-5,6,1,0,0,0,-1,-3,20,1,-10,9,-7,0,0,-1,-1,0,-1,5,-1
KR_6777342108,420,-1,4,-29,-4,-1,2,1,0,2,2,-4,5,1,1,4,5,0,2,2,-2,-1,-35,3,-10,7,-1,0,-1,-1,-1,-1,-1,6,-1
KR_6768304814,420,0,-87,11,4,3,2,5,-4,5,1,-1,5,4,2,3,5,4,1,5,1,2,5,-1,-5,6,1,0,-2,-1,-1,-1,-1,5,-1
KR_6771550583,420,-2,-32,-23,-2,1,0,1,-1,2,1,-3,3,0,2,3,5,-1,1,0,0,-11,-3,-3,-4,7,6,0,2,-1,1,1,-1,4,-1
KR_6763204614,420,0,43,27,-10,3,3,6,-3,3,0,-3,4,1,-5,8,3,-2,3,1,1,-21,-15,-6,-2,8,3,0,-1,1,1,-1,1,6,-1
KR_6735229438,420,-2,-3,-4,-3,0,0,0,0,3,3,-1,3,2,-2,2,0,0,0,0,0,-6,36,6,-10,4,3,0,0,-1,1,0,1,4,-1
KR_6756419953,420,3,8,25,4,4,0,4,1,1,2,1,0,1,-4,8,4,2,0,2,0,0,1,-3,-3,6,3,0,1,1,1,1,1,3,-1
KR_6774153440,420,-6,-123,-44,-9,0,0,0,-4,5,1,0,1,1,-5,7,2,0,0,0,0,-11,-37,-1,-4,5,-4,0,-3,-1,-1,-1,-1,4,-1
KR_6722361091,420,-1,-18,20,-2,-2,3,1,-3,4,1,-3,3,0,6,2,8,0,1,1,0,3,14,2,-7,5,-13,0,0,-1,-1,0,-1,5,-1
KR_6772464473,420,-5,-52,-29,-8,-1,2,1,-7,8,1,-4,6,2,4,0,4,0,1,1,-1,-9,-1,0,-6,6,1,0,-2,-1,-1,-1,-1,6,-1
KR_6774432541,420,-4,14,-20,-7,0,2,2,-4,7,3,0,0,0,-3,5,2,0,1,1,0,-10,17,-1,-6,7,0,0,0,-1,-1,0,-1,3,-1
KR_6739570471,420,-4,-72,2,-3,-1,1,0,4,1,5,-5,5,0,-1,1,0,0,0,0,1,2,-14,-1,-8,9,2,0,0,1,-1,-1,1,6,-1
KR_6768528477,420,2,-14,31,-1,4,1,5,3,2,5,-1,4,3,-6,6,0,-1,1,0,0,-7,-4,1,-5,4,2,0,1,-1,1,1,-1,3,-1
KR_6741561727,420,-1,-34,-3,1,0,1,1,-3,3,0,-1,3,2,2,2,4,3,0,3,0,5,3,0,-7,7,-1,0,1,1,1,1,1,1,-1
KR_6774606371,420,-1,13,-3,-8,0,1,1,-2,3,1,-3,4,1,-3,3,0,0,0,0,0,-19,4,4,-9,5,-2,0,-1,1,-1,-1,-1,4,-1
KR_6767925212,420,-1,37,8,-6,3,1,4,-2,5,3,-6,10,4,-3,5,2,2,1,3,0,-16,2,1,-5,4,3,0,0,1,1,1,-1,6,-1
KR_6776216519,420,1,22,5,-1,2,1,3,-2,3,1,2,2,4,-3,3,0,0,1,1,0,-5,35,2,-8,6,-3,0,0,1,1,1,1,3,-1
KR_6772447333,420,-3,-4,13,-9,1,4,5,-8,11,3,3,2,5,-6,7,1,1,0,1,1,-20,3,0,-5,5,5,0,-1,1,-1,-1,1,1,-1
KR_6776850317,420,1,10,23,1,-1,1,0,0,2,2,-4,4,0,0,4,4,6,0,6,0,5,10,-4,-3,7,3,0,0,1,1,0,-1,5,-1
KR_6766758156,420,-6,-52,-39,-15,-2,3,1,-4,5,1,-2,6,4,-4,4,0,-3,3,0,0,-18,108,-7,-2,9,0,0,-2,-1,-1,-1,-1,5,-1
KR_6728419262,440,-5,42,-36,-9,-4,7,3,0,2,2,-5,6,1,0,3,3,0,0,0,0,-2,-1,-2,-2,4,1,0,0,-1,-1,-1,1,1,-1
KR_6771248446,420,-4,-13,-38,-4,-5,5,0,1,2,3,-6,7,1,6,1,7,0,0,0,0,0,12,0,-4,4,0,0,0,1,-1,1,1,2,-1
KR_6775308242,420,2,37,12,3,1,0,1,6,3,9,-7,9,2,1,0,1,2,0,2,0,2,13,6,-8,2,-6,0,0,1,0,0,1,6,-1
KR_6645364264,420,-2,-26,15,-9,0,2,2,-4,5,1,-4,4,0,-1,4,3,0,0,0,-1,-19,-13,-2,-5,7,2,0,-1,-1,-1,-1,-1,4,-1
KR_6777450480,440,2,-20,-5,6,-5,7,2,6,1,7,3,2,5,4,0,4,-2,2,0,-1,17,22,5,-9,4,-6,0,1,-1,-1,1,-1,6,-1
KR_6712588063,420,0,-8,-7,-7,-2,2,0,-6,10,4,-2,4,2,5,0,5,-2,2,0,0,-9,-15,-2,-5,7,-3,0,-3,-1,-1,-1,-1,1,-1
KR_6685579985,420,0,4,5,-9,-2,2,0,-4,6,2,2,1,3,-3,4,1,-2,2,0,0,-7,-3,-4,-5,9,4,0,0,1,-1,0,-1,1,-1
KR_6754055614,420,-1,18,3,-4,2,0,2,-4,6,2,-4,9,5,1,2,3,1,0,1,0,-9,-2,-4,-4,8,-2,0,0,-1,-1,-1,1,3,-1
KR_6715765178,420,-5,-49,-28,-11,-5,5,0,-4,6,2,-2,4,2,0,1,1,0,0,0,1,-18,51,-3,-7,10,0,0,0,1,-1,-1,1,3,-1
KR_6775336339,420,-3,0,-15,-9,0,3,3,-1,5,4,-3,4,1,-6,6,0,1,0,1,0,-14,7,1,-3,2,-2,0,0,1,1,0,-1,6,-1
KR_6773634956,420,-1,-53,0,1,-3,3,0,2,1,3,-1,1,0,0,1,1,3,0,3,0,1,8,3,-12,9,-5,0,-1,1,-1,-1,-1,6,-1
KR_6739277398,420,-4,13,-26,-8,-3,4,1,-1,1,0,0,2,2,-5,5,0,1,1,2,0,-10,-26,-2,-2,4,0,0,-2,1,-1,-1,-1,1,-1
KR_6777856976,420,-6,-53,-22,-7,-4,6,2,-1,1,0,0,1,1,-2,6,4,0,1,1,-1,-8,-3,-5,-2,7,0,0,-2,-1,-1,-1,-1,5,-1
KR_6771133608,420,2,-11,21,4,2,0,2,-5,5,0,5,4,9,2,1,3,0,2,2,0,-5,13,2,-7,5,-6,0,0,-1,1,1,-1,2,-1
KR_6776632578,420,0,-15,7,-2,-9,10,1,4,0,4,4,2,6,1,3,4,-2,3,1,0,3,45,0,-5,5,6,0,-1,1,-1,-1,-1,2,-1
KR_6720558892,420,-5,-35,-31,-9,-2,2,0,2,2,4,0,1,1,-7,7,0,-2,2,0,-2,-9,9,7,-12,5,-5,0,0,-1,1,1,-1,1,-1
KR_6775956948,420,-2,-9,4,-4,-1,4,3,1,2,3,-3,3,0,-1,3,2,0,0,0,0,-13,83,-4,-4,8,2,0,-1,-1,-1,-1,-1,6,-1
KR_6772815960,420,0,40,5,-1,0,1,1,-2,5,3,1,1,2,1,0,1,-1,2,1,0,-2,8,3,-6,3,-8,0,0,1,-1,1,-1,6,-1
KR_6727772442,420,-1,20,5,-1,-1,2,1,-2,3,1,-2,4,2,4,2,6,0,1,1,-1,-5,-11,3,-7,4,-2,0,0,-1,-1,1,-1,4,-1
KR_6727094524,420,-2,-57,14,-10,2,1,3,-4,5,1,0,3,3,-6,7,1,-2,3,1,0,-17,-5,-6,-2,8,-3,0,-2,1,1,-1,-1,2,-1
KR_6755937065,420,-8,-105,-20,-12,-3,4,1,-1,4,3,-5,5,0,0,1,1,-3,3,0,-1,-11,-16,-5,-2,7,-5,0,-7,-1,-1,-1,-1,4,-1
KR_6771105410,420,-1,8,-4,-1,0,2,2,2,4,6,-2,3,1,-2,6,4,1,1,2,-2,-8,8,7,-11,4,5,0,0,1,-1,0,1,2,-1
KR_6767715579,420,2,31,26,1,5,3,8,2,1,3,-3,6,3,0,0,0,-3,3,0,1,-2,6,3,-7,4,-4,0,-1,1,1,-1,1,6,-1
KR_6759610536,420,2,-94,17,1,-1,1,0,1,3,4,4,0,4,-4,6,2,1,2,3,0,-2,-3,-2,-6,8,-5,0,-1,-1,1,-1,1,3,-1
KR_6737924373,420,-3,-38,6,-2,-2,3,1,1,1,2,0,1,1,-1,1,0,0,0,0,0,-5,-20,0,-5,5,-6,0,0,0,-1,-1,-1,0,-1
KR_6773575862,420,-4,-17,-30,-9,-3,3,0,4,3,7,-2,4,2,-7,9,2,-1,2,1,1,2,33,2,-7,5,1,0,0,-1,1,-1,1,2,-1
KR_6771634393,440,-1,5,7,-4,4,0,4,-3,7,4,0,2,2,0,0,0,-5,6,1,0,-8,17,-2,-4,6,1,0,0,-1,0,-1,-1,2,-1
KR_6771992042,420,-1,-42,-24,-2,-1,1,0,2,2,4,-3,7,4,1,1,2,-1,1,0,0,4,12,9,-11,2,-6,0,0,-1,-1,0,1,1,-1
KR_6774109718,420,-1,-1,-16,0,3,2,5,-1,1,0,-3,5,2,1,2,3,0,0,0,0,-4,-6,2,-8,6,3,0,0,-1,1,0,1,3,-1
KR_6776912943,420,1,-11,-4,2,-1,1,0,4,2,6,5,1,6,-6,9,3,0,2,2,0,9,5,1,-7,6,-7,0,2,-1,1,1,-1,1,-1
KR_6748831461,420,-4,-36,12,-6,-1,2,1,-2,5,3,1,1,2,-5,6,1,1,0,1,0,-10,248,2,-5,3,0,0,-2,-1,-1,-1,1,2,-1
KR_6776207814,420,0,-14,49,-3,2,1,3,2,3,5,-2,4,2,-4,5,1,-1,1,0,0,-5,3,0,-5,5,-1,0,-1,1,1,-1,1,6,-1
KR_6773534439,420,0,-17,7,4,0,1,1,2,2,4,-1,2,1,2,0,2,1,3,4,0,6,-12,2,-7,5,4,0,1,-1,1,1,-1,4,-1
KR_6770123276,420,3,-10,2,5,3,1,4,-1,2,1,3,1,4,6,1,7,-6,7,1,0,7,16,-3,-3,6,2,0,-1,-1,1,-1,-1,6,-1
KR_6777565101,420,-3,-9,-15,-4,-1,1,0,-2,4,2,-3,4,1,2,1,3,0,1,1,0,1,-12,-2,-6,8,1,0,-1,1,-1,-1,1,2,-1
KR_6774993575,440,-5,-16,-8,-12,1,0,1,-8,10,2,0,1,1,-4,4,0,-1,2,1,0,-10,-32,1,-5,4,4,0,0,1,1,1,-1,5,-1
KR_6773030924,420,-1,2,0,-1,4,0,4,2,2,4,0,1,1,-7,9,2,0,2,2,2,3,39,0,-7,7,4,0,-1,-1,-1,-1,1,3,-1
KR_6768324806,420,1,-22,-8,-4,-5,7,2,2,1,3,2,4,6,-3,6,3,0,0,0,-1,-1,28,-3,-6,9,-4,0,-2,-1,-1,-1,-1,3,-1
KR_6714562212,420,-6,-94,-28,-14,-7,7,0,-2,5,3,-8,11,3,4,1,5,-1,1,0,-1,-18,-44,-9,-1,10,-1,0,-3,1,-1,-1,-1,5,-1
KR_6747493909,420,-1,60,-4,-7,1,3,4,-7,9,2,1,0,1,0,1,1,-2,2,0,0,-5,8,-2,-7,9,-2,0,0,-1,1,1,-1,6,-1
KR_6777796315,420,-1,32,-19,1,1,2,3,2,6,8,1,2,3,-2,5,3,-1,1,0,0,-5,-23,1,-9,8,-1,0,-1,-1,-1,-1,1,2,-1
KR_6772121580,420,0,-31,0,-1,3,0,3,1,1,2,1,2,3,-3,4,1,-3,4,1,0,-4,8,-1,-7,8,-2,0,-1,-1,1,-1,-1,2,-1
KR_6738302021,420,-4,-40,-40,-2,-2,3,1,-2,5,3,1,1,2,1,0,1,0,3,3,0,-5,17,2,-10,8,1,0,0,-1,1,0,1,4,-1
KR_6773959769,420,2,-20,-8,5,3,0,3,0,3,3,-1,1,0,3,1,4,0,0,0,0,7,0,2,-4,2,2,0,-1,1,-1,-1,1,3,-1
KR_6775200823,420,-1,59,-14,13,2,1,3,0,4,4,7,2,9,3,2,5,1,0,1,2,20,-12,-5,-5,10,5,0,2,1,1,1,1,6,-1
KR_6742171091,440,-2,19,-18,-7,-2,4,2,-1,2,1,-1,1,0,1,1,2,-4,4,0,-1,-9,-8,2,-5,3,-4,0,0,-1,-1,0,-1,5,-1
KR_6735310071,420,4,119,4,5,0,1,1,1,5,6,-1,3,2,3,0,3,2,0,2,3,21,3,1,-6,5,0,0,2,1,1,1,1,4,-1
KR_6764691822,420,0,-8,5,-4,2,0,2,1,1,2,0,1,1,-7,7,0,0,0,0,0,-9,0,3,-7,4,1,0,0,-1,-1,-1,-1,5,-1
KR_6774220807,420,-4,-83,-4,-6,-2,3,1,-4,6,2,-2,3,1,3,0,3,-1,1,0,0,-4,2,2,-7,5,-4,0,1,1,1,-1,-1,3,-1
KR_6775059038,420,3,-42,31,4,5,0,5,-2,4,2,2,0,2,-2,3,1,1,0,1,1,5,-4,-1,-4,5,-4,0,0,1,-1,1,1,2,-1
KR_6736532595,420,-3,-16,-25,-10,-1,3,2,-10,11,1,0,1,1,1,1,2,0,1,1,-1,-9,4,0,-7,7,1,0,0,1,-1,-1,-1,6,-1
KR_6761131934,420,-1,-39,-10,0,-1,3,2,5,5,10,0,4,4,-4,5,1,0,0,0,1,2,-7,2,-11,9,-1,0,-1,-1,-1,-1,1,3,-1
KR_6776324397,420,-2,-17,-25,-2,3,0,3,1,2,3,1,1,2,-5,6,1,-2,2,0,0,-5,-1,7,-13,6,-6,0,0,-1,-1,-1,-1,1,-1
KR_6768280921,420,-6,-38,-6,-13,-4,4,0,-3,5,2,-3,4,1,-1,4,3,-2,2,0,0,-12,5,2,-9,7,-9,0,-1,-1,-1,1,-1,3,-1
KR_6716449648,420,-2,-43,43,-2,-2,4,2,1,1,2,1,2,3,-1,4,3,-1,2,1,0,6,-8,2,-5,3,1,0,0,-1,1,0,-1,1,-1
KR_6768144730,420,-6,-87,-50,-11,-5,5,0,-5,5,0,-1,1,0,0,1,1,0,1,1,0,-9,-4,-4,-5,9,-2,0,-2,-1,-1,-1,-1,4,-1
KR_6730343868,420,2,26,16,6,-1,3,2,-4,6,2,5,1,6,5,2,7,1,0,1,0,5,131,7,-11,4,1,0,-1,1,-1,-1,-1,1,-1
KR_6745329698,420,-3,-14,-27,1,-2,3,1,0,1,1,1,0,1,2,3,5,0,0,0,-1,8,-3,2,-8,6,-3,0,-1,1,-1,-1,-1,3,-1
KR_6769936346,420,-1,-55,18,-4,0,1,1,-3,3,0,0,2,2,1,0,1,-2,2,0,0,-6,70,0,-6,6,-1,0,-3,-1,-1,-1,-1,3,-1
KR_6651000890,420,0,14,-34,-2,0,1,1,-1,3,2,-2,3,1,-1,2,1,2,0,2,0,-4,-4,-2,-6,8,2,0,1,-1,-1,1,1,3,-1
KR_6768883072,420,-2,-31,12,-6,-1,3,2,-8,9,1,3,2,5,-3,5,2,3,0,3,-1,-8,-2,-1,-2,3,0,0,0,-1,0,-1,-1,3,-1
KR_6774132050,420,-7,-58,3,-14,-2,2,0,-4,5,1,-1,2,1,-4,5,1,-3,5,2,0,-15,-3,-4,-2,6,5,0,-2,1,-1,-1,-1,3,-1
KR_6758349644,420,-3,-23,20,-7,-2,2,0,0,3,3,-3,4,1,1,6,7,-3,3,0,0,-6,6,1,-6,5,0,0,0,-1,1,1,-1,3,-1
KR_6767050057,420,0,11,48,0,4,1,5,2,0,2,-1,1,0,0,2,2,-5,5,0,-1,-3,30,2,-5,3,-6,0,1,-1,1,1,-1,4,-1
KR_6770129893,420,-3,-44,-20,-8,2,2,4,-2,2,0,-1,2,1,-6,6,0,-1,2,1,-1,-6,24,4,-6,2,-3,0,-1,-1,-1,-1,-1,6,-1
KR_6742701204,420,-6,-92,9,-11,-2,3,1,0,2,2,-5,6,1,-5,5,0,1,2,3,0,-4,-12,-5,-6,11,0,0,-3,-1,1,-1,-1,2,-1
KR_6755803772,420,0,17,-32,-3,3,2,5,-3,6,3,-1,4,3,-1,1,0,-1,2,1,0,-4,4,4,-9,5,1,0,-1,-1,-1,-1,1,3,-1
KR_6776453041,420,-5,-62,-64,-9,-2,4,2,-4,9,5,0,2,2,-3,3,0,0,1,1,-1,-10,-3,1,-5,4,-4,0,0,-1,-1,-1,-1,1,-1
KR_6757347903,420,-1,66,-4,-8,0,0,0,-4,7,3,0,1,1,-3,5,2,-1,1,0,0,-16,1,-2,-3,5,-5,0,1,1,-1,-1,1,4,-1
KR_6769232965,420,-1,-35,4,0,1,0,1,0,4,4,2,2,4,-4,5,1,1,1,2,0,1,-5,-4,-2,6,3,0,0,-1,-1,1,1,5,-1
KR_6768613160,420,-3,-47,12,-3,0,2,2,-1,1,0,1,2,3,-4,7,3,1,2,3,0,-6,13,-4,-4,8,3,0,-1,0,-1,-1,-1,0,-1
KR_6775550856,420,2,7,9,-1,1,0,1,0,5,5,0,5,5,0,1,1,-2,2,0,0,-6,-9,-5,-5,10,8,0,0,-1,1,0,1,1,-1
KR_6748977181,420,-1,-13,-17,4,-3,4,1,5,2,7,2,2,4,1,2,3,-1,1,0,1,12,-12,1,-8,7,2,0,0,1,1,1,1,6,-1
KR_6764802513,420,-1,-22,-12,3,1,2,3,-2,3,1,0,0,0,1,1,2,3,2,5,0,1,0,5,-8,3,-3,0,0,1,1,-1,-1,6,-1
KR_6768897304,420,-2,12,-53,-4,4,2,6,-2,4,2,0,1,1,-3,3,0,-3,4,1,0,-5,4,2,-7,5,-1,0,-1,-1,-1,-1,-1,2,-1
KR_6777194461,420,-7,-21,-26,-7,-3,3,0,-4,5,1,-1,3,2,-1,5,4,2,1,3,0,-2,-239,0,-5,5,1,0,0,-1,1,0,1,5,-1
KR_6768211534,420,1,33,38,3,-6,6,0,2,4,6,2,0,2,3,0,3,2,0,2,0,12,37,1,-6,5,10,0,-1,1,-1,-1,-1,3,-1
KR_6769356072,420,0,35,-10,-3,-5,6,1,-4,6,2,5,2,7,0,3,3,1,2,3,1,-3,-3,-2,-8,10,-4,0,1,-1,-1,1,1,2,-1
KR_6768889315,420,-1,-40,-20,-4,1,2,3,-1,4,3,-3,3,0,-1,2,1,0,0,0,-2,-1,-3,-1,-6,7,-3,0,0,-1,-1,0,-1,3,-1
KR_6773034503,440,-4,-90,-2,-19,-3,3,0,-6,6,0,-6,10,4,-3,6,3,-1,2,1,-6,-34,-9,-5,-3,8,-1,0,-3,-1,-1,-1,-1,4,-1
KR_6769125198,420,-3,-81,0,-5,1,1,2,-2,4,2,0,2,2,-2,4,2,-2,4,2,0,-5,-10,-2,-7,9,0,0,-1,1,-1,-1,-1,5,-1
KR_6740534899,420,-4,-37,-4,-4,-3,4,1,-3,6,3,-3,4,1,3,2,5,2,0,2,0,1,5,3,-8,5,-2,0,-1,-1,-1,-1,1,4,-1
KR_6704155033,420,-6,-110,9,-12,-5,7,2,0,4,4,-6,8,2,-3,8,5,2,2,4,-1,-2,-3,-5,-2,7,0,0,-2,-1,-1,-1,-1,5,-1
KR_6772412819,420,0,-26,12,-2,0,1,1,-4,5,1,0,0,0,-3,3,0,5,0,5,-1,-3,66,-3,-5,8,-25,0,1,-1,1,-1,-1,4,-1
KR_6777788453,420,-4,-63,0,-3,-4,5,1,-5,6,1,-4,5,1,9,0,9,1,1,2,4,-1,8,-1,-8,9,-10,0,-1,-1,0,-1,1,2,-1
KR_6736635899,420,-4,10,-28,-10,-1,3,2,-3,4,1,-9,9,0,3,0,3,0,0,0,0,-8,13,4,-6,2,0,0,-1,-1,-1,-1,1,5,-1
KR_6776484410,420,0,-48,9,-5,-1,1,0,2,4,6,-4,4,0,-2,3,1,0,1,1,0,-8,1,0,-10,10,-2,0,0,-1,-1,0,1,5,-1
KR_6774151106,420,-2,0,-31,-13,-4,4,0,-6,8,2,-2,3,1,-2,3,1,1,1,2,0,-15,8,2,-7,5,0,0,-2,-1,-1,-1,-1,5,-1
KR_6742666405,420,0,-76,28,-1,6,4,10,-5,5,0,0,3,3,-1,3,2,-1,1,0,-1,1,9,4,-10,6,-5,0,-1,1,-1,-1,-1,2,-1
KR_6768176793,420,0,-21,-20,-4,-2,2,0,-6,7,1,3,3,6,3,2,5,-2,2,0,0,-14,-3,0,-3,3,2,0,-1,-1,-1,-1,-1,6,-1
KR_6776663730,420,-3,-31,3,-4,-2,3,1,3,2,5,5,1,6,-10,11,1,0,0,0,1,-9,-39,3,-9,6,-1,0,0,-1,1,-1,1,3,-1
KR_6774017383,420,-3,-60,32,-15,0,2,2,-3,6,3,-4,5,1,-7,8,1,-1,2,1,-1,-13,13,-1,-3,4,-1,0,-2,-1,1,-1,-1,2,-1
KR_6768160018,420,2,-76,1,4,-1,4,3,0,5,5,2,2,4,2,1,3,1,0,1,0,0,2,5,-8,3,-1,0,-1,1,-1,-1,1,6,-1
KR_6774793193,420,-2,-54,-15,-10,1,2,3,-6,6,0,-1,3,2,-3,4,1,-1,2,1,0,-17,-28,6,-10,4,1,0,-1,-1,-1,-1,-1,6,-1
KR_6774611142,440,-3,-3,-30,-1,0,2,2,-3,3,0,1,3,4,0,1,1,1,2,3,0,-4,-57,1,-6,5,13,0,-1,-1,-1,-1,-1,1,-1
KR_6759221446,420,-1,-61,-16,-4,2,0,2,2,2,4,-3,3,0,-7,8,1,2,1,3,0,-5,1,-1,-4,5,-5,0,-1,-1,-1,-1,-1,4,-1
KR_6776902306,440,-4,-87,-3,-8,0,1,1,-2,3,1,-1,2,1,-4,6,2,-1,1,0,0,-8,-19,-3,-5,8,2,0,-2,1,-1,-1,-1,6,-1
KR_6777390894,420,-2,-31,-23,-5,-2,2,0,-4,6,2,0,1,1,0,1,1,1,0,1,0,-7,75,-1,-5,6,5,0,-1,1,-1,-1,1,4,-1
KR_6772013070,420,-6,-99,5,-21,-1,2,1,-10,10,0,-3,5,2,-5,9,4,-2,2,0,-2,-21,-10,-4,-3,7,-3,0,-2,-1,-1,-1,-1,1,-1
KR_6772451514,420,1,-41,4,4,5,0,5,2,0,2,-3,3,0,1,3,4,-1,2,1,0,6,-1,5,-9,4,-3,0,2,-1,1,1,1,3,-1
KR_6767659931,420,-4,-40,28,-13,0,2,2,0,4,4,-6,6,0,-8,9,1,1,1,2,-2,-19,-6,0,-11,11,1,0,-1,-1,1,-1,-1,3,-1
KR_6723421002,420,-1,-16,12,-1,-1,2,1,-3,7,4,1,4,5,1,2,3,1,1,2,0,-7,-85,6,-11,5,0,0,1,1,1,1,1,5,-1
KR_6775101560,420,1,11,14,2,1,2,3,-2,5,3,2,1,3,-1,2,1,2,0,2,0,4,8,4,-7,3,-2,0,0,1,-1,1,-1,2,-1
KR_6744867975,420,4,64,-15,6,4,1,5,0,2,2,5,0,5,-3,4,1,0,0,0,1,-1,-1,3,-6,3,-3,0,2,-1,-1,1,1,2,-1
KR_6777667814,420,-2,-20,34,-14,-1,2,1,1,1,2,-4,6,2,-11,11,0,1,0,1,0,-22,-75,0,-6,6,17,0,-4,-1,-1,-1,1,1,-1
KR_6749448576,420,-4,-47,-8,-8,-5,6,1,2,5,7,0,1,1,-3,5,2,-2,2,0,2,0,-6,-1,-6,7,-1,0,0,-1,1,1,1,1,-1
KR_6719985757,420,-1,3,-7,-5,3,2,5,1,3,4,-4,6,2,-1,5,4,-4,4,0,0,-15,-276,1,-9,8,1,0,0,-1,-1,1,-1,3,-1
KR_6774447040,420,-2,-75,40,-4,-2,2,0,1,0,1,0,3,3,-5,5,0,2,0,2,0,-10,-7,-2,-6,8,2,0,-1,-1,1,-1,-1,2,-1
KR_6777492840,420,-3,-69,-4,-4,-2,2,0,-1,2,1,1,0,1,-2,2,0,0,0,0,0,-4,41,-1,-7,8,-24,0,0,-1,-1,0,1,5,-1
KR_6751486076,440,2,41,6,3,1,2,3,1,1,2,-6,6,0,6,0,6,1,0,1,0,3,-34,-1,-7,8,5,0,1,1,1,1,-1,3,-1
KR_6767520298,420,-4,-5,1,-8,1,1,2,-6,6,0,3,3,6,-5,5,0,-1,1,0,0,-24,3,4,-7,3,-1,0,-2,-1,1,-1,-1,4,-1
KR_6775224624,420,-3,-15,-47,0,0,2,2,-1,3,2,-1,5,4,2,2,4,0,2,2,1,0,-110,2,-6,4,-7,0,0,1,1,0,1,6,-1
KR_6771609211,420,1,-11,-25,3,2,3,5,0,3,3,2,1,3,-1,3,2,0,0,0,0,10,3,5,-9,4,0,0,0,-1,1,1,-1,6,-1
KR_6761552166,420,0,17,6,8,-1,2,1,-2,4,2,4,1,5,0,4,4,7,0,7,0,3,0,-1,-4,5,-1,0,0,1,1,1,-1,1,-1
KR_6776104268,420,-4,-68,-18,-8,-5,6,1,1,2,3,0,3,3,-6,10,4,2,0,2,3,2,-17,-6,-3,9,3,0,-1,-1,-1,-1,1,4,-1
KR_6769629641,420,-6,-21,-48,-13,-2,4,2,-4,4,0,-1,3,2,-6,6,0,0,0,0,0,-14,-22,3,-8,5,-7,0,0,-1,-1,0,-1,2,-1
KR_6773154298,420,-1,-28,15,-6,2,0,2,-4,4,0,1,1,2,-5,5,0,0,0,0,0,-7,38,3,-8,5,2,0,-1,-1,1,-1,-1,2,-1
KR_6773903293,440,-5,-116,-20,-6,0,1,1,-1,3,2,-5,6,1,1,1,2,-1,2,1,0,-1,2,4,-7,3,-9,0,-2,-1,0,-1,1,5,-1
KR_6774137261,420,0,-14,0,0,-3,3,0,4,2,6,-1,1,0,1,2,3,-1,3,2,0,1,145,6,-11,5,-3,0,-2,-1,1,-1,1,2,-1
KR_6776291610,420,-2,-13,0,-9,-4,6,2,-5,6,1,2,1,3,-4,7,3,2,2,4,0,-8,-8,-3,-5,8,-5,0,-1,-1,-1,-1,-1,1,-1
KR_6756844798,420,-2,-23,-13,-6,0,0,0,-5,5,0,0,3,3,1,6,7,-2,3,1,-2,-4,-4,5,-8,3,-7,0,-2,1,-1,-1,-1,2,-1
KR_6777467618,420,-3,-35,9,-9,-1,2,1,-4,6,2,-6,6,0,2,0,2,0,0,0,0,-9,-3,-1,-4,5,0,0,-2,1,-1,-1,1,6,-1
KR_6671383769,420,-1,-8,8,-3,-3,7,4,-1,2,1,4,2,6,-2,2,0,-1,1,0,1,-7,14,-2,-4,6,1,0,1,-1,1,1,1,2,-1
KR_6729885775,420,0,-22,-38,4,1,2,3,-1,4,3,0,2,2,-1,4,3,5,0,5,-1,-3,8,4,-9,5,-2,0,0,-1,1,0,-1,5,-1
KR_6769103734,420,-4,5,-36,-7,0,1,1,-2,2,0,-1,2,1,-3,5,2,-1,2,1,0,-5,-1,0,-6,6,-5,0,-1,-1,-1,-1,-1,6,-1
KR_6775488805,420,-2,-61,3,0,-1,2,1,-1,2,1,-4,6,2,5,3,8,1,1,2,0,0,-123,-2,-4,6,1,0,-1,-1,-1,-1,-1,5,-1
KR_6766200583,440,-2,19,-8,-11,-3,4,1,-6,8,2,-3,5,2,3,4,7,-2,2,0,0,0,21,-3,-5,8,0,0,-1,-1,1,1,-1,3,-1
KR_6772342909,420,-4,-7,-12,-2,-3,3,0,2,4,6,-2,4,2,1,1,2,0,0,0,1,-10,13,6,-10,4,-5,0,0,1,1,0,1,4,-1
KR_6761954572,420,5,16,-12,2,-2,3,1,0,1,1,-2,3,1,7,1,8,-1,1,0,0,5,-29,-3,-5,8,3,0,0,-1,1,0,-1,5,-1
KR_6777705511,420,0,-25,5,5,-1,3,2,4,0,4,4,0,4,-4,6,2,2,0,2,1,-4,14,0,-6,6,1,0,-1,-1,1,-1,1,2,-1
KR_6777161616,420,0,1,-15,-1,1,1,2,-1,3,2,1,2,3,1,1,2,-3,3,0,0,0,-1,0,-7,7,4,0,-1,1,-1,-1,-1,4,-1
KR_6763873652,420,-1,-36,-8,-1,0,3,3,-1,2,1,5,1,6,-4,4,0,-1,2,1,0,-1,6,2,-7,5,0,0,0,-1,1,-1,-1,2,-1
KR_6774676821,420,0,15,12,-5,-2,2,0,-3,5,2,5,4,9,-5,7,2,0,0,0,0,-15,-7,-3,-4,7,5,0,0,1,0,0,1,3,-1
KR_6777071484,420,1,-4,10,-1,1,1,2,3,0,3,-1,2,1,-5,6,1,1,0,1,0,-6,0,0,-5,5,-5,0,2,-1,1,1,-1,5,-1
KR_6753989946,420,-3,-103,1,-6,7,2,9,-6,7,1,0,0,0,-7,9,2,0,0,0,0,-13,-7,-3,-8,11,-4,0,-1,-1,1,-1,1,5,-1
KR_6777027437,420,-2,-4,-31,0,-1,3,2,-2,4,2,1,1,2,2,1,3,0,1,1,0,5,-26,-2,-6,8,7,0,0,-1,1,-1,-1,2,-1
KR_6763984641,440,1,-20,-12,-4,2,5,7,0,5,5,-2,2,0,-4,5,1,0,0,0,1,-4,-3,4,-8,4,-4,0,1,-1,-1,-1,1,6,-1
KR_6772086706,420,-5,-35,20,-4,-2,3,1,-2,5,3,-2,3,1,0,4,4,2,0,2,0,-6,-13,0,-4,4,2,0,-1,1,1,-1,-1,6,-1
KR_6770683266,420,-3,-48,-4,-8,-2,2,0,0,1,1,0,3,3,-2,2,0,-4,5,1,0,-12,-8,-3,-5,8,4,0,0,0,-1,-1,1,0,-1
KR_6773974518,420,2,13,-5,-5,-2,4,2,0,0,0,-1,2,1,-2,5,3,0,1,1,1,-7,9,-1,-4,5,-4,0,-1,1,-1,-1,1,6,-1
KR_6748764742,420,5,5,36,14,5,2,7,5,2,7,-2,4,2,6,0,6,0,1,1,0,10,28,-2,-5,7,-2,0,2,-1,1,1,-1,4,-1
KR_6751382471,420,-2,15,-28,-2,0,2,2,0,3,3,-3,4,1,0,2,2,1,3,4,0,-4,-14,2,-8,6,-5,0,-2,1,-1,-1,1,3,-1
KR_6775394163,420,0,-22,3,-2,2,0,2,0,2,2,-5,5,0,0,4,4,1,1,2,0,-5,-12,-2,-8,10,-2,0,-1,-1,1,-1,1,3,-1
KR_6757687766,420,0,-13,-2,6,1,0,1,5,5,10,-4,6,2,5,1,6,-1,1,0,0,11,17,8,-11,3,-1,0,0,1,-1,-1,1,5,-1
KR_6776574969,420,3,44,-17,6,5,4,9,-4,5,1,3,1,4,0,2,2,2,0,2,1,1,9,2,-10,8,1,0,0,-1,1,1,1,1,-1
KR_6769265039,420,3,26,-7,9,2,1,3,1,2,3,8,0,8,-2,9,7,0,0,0,0,10,4,2,-6,4,4,0,2,-1,1,1,-1,1,-1
KR_6744410920,420,0,-43,-17,10,0,3,3,2,2,4,4,0,4,4,1,5,0,0,0,0,11,-32,4,-10,6,2,0,1,1,1,1,1,2,-1
KR_6742280031,420,0,-1,8,2,-1,2,1,4,2,6,-2,2,0,2,1,3,-1,3,2,1,9,5,2,-8,6,-3,0,-1,1,-1,-1,1,2,-1
KR_6768605978,420,-2,-21,7,-10,-2,2,0,-2,3,1,-5,6,1,-2,3,1,1,1,2,0,-18,5,3,-9,6,-7,0,-2,1,-1,-1,1,4,-1
KR_6767404889,440,-4,-29,-68,-11,0,1,1,-6,8,2,0,2,2,-2,3,1,-3,4,1,-1,-10,-6,2,-5,3,-1,0,-1,-1,-1,-1,-1,1,-1
KR_6775797716,420,-4,-35,-4,-7,-6,6,0,-2,3,1,0,3,3,-1,4,3,2,2,4,0,-8,-13,0,-6,6,5,0,0,-1,-1,-1,-1,1,-1
KR_6683640893,420,-5,-95,7,-8,0,1,1,-4,4,0,-4,4,0,1,0,1,-1,2,1,0,-8,5,4,-10,6,-3,0,0,1,-1,-1,1,2,-1
KR_6777387728,420,0,-41,-12,-3,0,2,2,1,2,3,-3,4,1,-3,4,1,2,0,2,-1,-3,1,-5,-2,7,-1,0,-2,-1,-1,-1,-1,2,-1
KR_6760182924,420,-2,-4,23,-9,-3,5,2,-6,8,2,-3,6,3,2,6,8,1,1,2,0,-11,39,5,-6,1,-1,0,2,-1,1,1,-1,4,-1
KR_6775691046,420,-1,-30,-16,4,1,1,2,2,2,4,1,1,2,-1,2,1,1,0,1,0,0,53,0,-4,4,-18,0,0,-1,1,1,1,3,-1
KR_6729976304,420,-4,-80,-10,-6,-3,4,1,-1,2,1,-1,1,0,0,0,0,-1,3,2,0,-3,-8,-1,-6,7,3,0,-3,1,-1,-1,1,2,-1
KR_6770341923,440,-1,-40,-18,-3,2,1,3,0,0,0,-5,5,0,-1,1,0,1,2,3,0,-5,1,0,-6,6,3,0,0,0,-1,0,1,0,-1
KR_6671128239,420,-2,-39,1,-2,1,1,2,-4,7,3,1,0,1,2,3,5,-2,2,0,0,-6,-3,-4,-3,7,2,0,-1,-1,1,-1,-1,6,-1
KR_6765800190,420,5,75,47,5,5,1,6,-2,4,2,1,3,4,0,2,2,1,0,1,0,-2,9,-1,-7,8,7,0,1,1,-1,1,1,6,-1
KR_6770538130,420,3,5,3,6,-2,5,3,7,1,8,0,3,3,-2,5,3,3,0,3,0,7,23,0,-8,8,0,0,1,-1,1,1,-1,3,-1
KR_6776592889,420,-3,-75,12,-5,0,1,1,-3,5,2,-2,2,0,0,2,2,0,0,0,0,-4,-46,1,-6,5,-8,0,-1,-1,1,1,-1,4,-1
KR_6773874141,420,-1,-42,8,-4,-2,2,0,-4,6,2,4,1,5,-2,2,0,0,0,0,0,-4,16,-3,-3,6,-5,0,0,1,1,1,1,5,-1
KR_6768036689,420,-1,-13,-19,-2,-3,3,0,0,2,2,5,0,5,0,6,6,-4,5,1,0,-7,27,-1,-4,5,0,0,0,1,-1,0,1,1,-1
KR_6769189598,420,-2,-60,28,-4,-1,2,1,-3,3,0,0,0,0,-3,5,2,3,0,3,0,-4,1,-3,-4,7,-3,0,0,-1,-1,-1,-1,6,-1
KR_6774388434,420,-1,54,-16,-1,1,2,3,2,2,4,0,1,1,-1,1,0,-3,4,1,0,-3,-14,-2,-9,11,5,0,0,-1,-1,0,-1,5,-1
KR_6767328173,420,-10,-86,-67,-22,-5,5,0,-8,8,0,-4,4,0,-6,6,0,1,1,2,0,-25,7,-6,-1,7,-2,0,-4,-1,-1,-1,-1,4,-1
KR_6776061645,420,-3,-1,-26,-9,-3,3,0,-3,4,1,-2,4,2,-1,1,0,0,1,1,0,-7,2,-4,-2,6,0,0,-1,-1,1,-1,1,4,-1
KR_6774409861,420,-4,-35,8,-6,1,1,2,-4,5,1,-2,2,0,-1,1,0,0,0,0,0,-9,-43,-3,-6,9,2,0,0,-1,1,0,1,5,-1
KR_6773016432,420,0,-16,8,-5,-2,2,0,-3,4,1,0,0,0,3,3,6,-3,7,4,0,-2,0,-1,-4,5,1,0,-2,-1,-1,-1,1,5,-1
KR_6756449042,420,2,54,33,7,3,1,4,3,3,6,1,1,2,1,6,7,-1,1,0,0,3,-9,2,-12,10,-3,0,0,1,1,1,-1,2,-1
KR_6777510189,420,-4,-75,0,-8,-2,4,2,-5,5,0,-2,3,1,1,3,4,0,0,0,0,-8,-4,-3,-2,5,-1,0,-2,-1,-1,-1,1,1,-1
KR_6776790155,420,3,44,5,3,0,1,1,4,0,4,-4,5,1,2,1,3,1,0,1,-1,3,3,-6,-4,10,3,0,1,1,1,1,-1,3,-1
KR_6742503935,440,0,-13,-15,0,-3,3,0,0,3,3,3,1,4,-2,5,3,2,0,2,0,1,131,2,-5,3,4,0,-1,1,-1,-1,1,3,-1
KR_6776821083,420,1,-19,20,-6,-1,3,2,-5,9,4,-1,3,2,-3,4,1,4,1,5,0,-15,-17,0,-7,7,-3,0,0,1,-1,0,-1,1,-1
KR_6774489900,420,2,36,-4,1,4,0,4,1,2,3,0,0,0,-4,5,1,0,0,0,1,-1,26,6,-10,4,1,0,0,0,1,1,1,0,-1
KR_6753967821,420,-1,-11,11,-3,-1,4,3,0,3,3,0,4,4,-2,3,1,0,0,0,0,-5,9,5,-9,4,1,0,0,-1,1,0,-1,2,-1
KR_6738553766,420,-1,1,-16,-6,-1,3,2,-2,9,7,-1,3,2,-2,2,0,0,1,1,-1,-2,-6,-1,-4,5,-2,0,-3,-1,-1,-1,-1,3,-1
KR_6768406134,420,-3,-9,-11,-5,-1,5,4,0,1,1,-2,4,2,-3,3,0,1,1,2,0,-9,43,-1,-6,7,3,0,-1,1,-1,-1,-1,1,-1
KR_6768495112,440,-3,-31,-52,-6,-1,3,2,1,2,3,-3,5,2,-1,5,4,-2,3,1,0,-4,8,-3,-3,6,0,0,-2,-1,-1,-1,-1,2,-1
KR_6731690936,420,0,-31,4,3,0,1,1,-1,3,2,0,2,2,2,3,5,2,2,4,0,0,22,0,-6,6,-1,0,-1,-1,-1,-1,1,4,-1
KR_6774301175,420,2,22,34,-7,2,0,2,-1,3,2,0,2,2,-7,8,1,-1,2,1,0,-12,3,0,-7,7,-4,0,0,-1,1,-1,-1,3,-1
KR_6768579931,440,-3,-44,-26,-3,-2,3,1,1,4,5,-3,3,0,2,2,4,-1,1,0,-1,-1,6,-1,-3,4,0,0,0,1,-1,-1,-1,3,-1
KR_6671832759,440,-6,-95,-21,-12,-2,6,4,-1,1,0,-7,8,1,-2,5,3,0,2,2,0,-16,27,1,-3,2,-23,0,-3,-1,-1,-1,1,1,-1
KR_6768135827,420,1,-12,4,-4,-2,2,0,1,1,2,-1,2,1,-1,2,1,-1,1,0,-1,-6,-38,0,-7,7,4,0,0,1,-1,0,-1,1,-1
KR_6772281785,420,-2,-38,13,-9,2,1,3,-3,6,3,-3,6,3,-3,3,0,-2,2,0,0,-11,-9,-2,-3,5,-5,0,0,-1,1,-1,1,1,-1
KR_6775509612,420,-1,5,-14,-8,1,1,2,-5,10,5,3,1,4,-7,9,2,0,0,0,-1,-6,8,-4,-5,9,-3,0,-1,-1,-1,-1,-1,4,-1
KR_6775668010,420,0,19,-16,-1,-1,2,1,-3,3,0,1,1,2,1,3,4,1,0,1,0,1,-18,-4,-1,5,1,0,-1,1,-1,-1,1,2,-1
KR_6775556730,420,-6,-77,-19,-9,-5,7,2,-1,5,4,-1,2,1,-2,2,0,0,0,0,0,-4,-33,-2,-6,8,1,0,-1,-1,1,-1,1,6,-1
KR_6692239917,420,-2,-10,22,-7,0,2,2,-3,5,2,-2,2,0,-1,4,3,-1,2,1,1,-13,6,3,-8,5,-2,0,0,-1,-1,0,1,6,-1
KR_6748128752,420,-2,33,-32,-6,-4,4,0,3,2,5,-1,1,0,1,3,4,-5,5,0,0,-1,0,5,-10,5,2,0,0,1,-1,-1,-1,2,-1
KR_6745820442,420,0,-11,12,-1,2,1,3,-3,3,0,-2,2,0,2,3,5,0,2,2,0,-7,-7,-2,-7,9,1,0,-1,-1,1,-1,1,2,-1
KR_6768532774,420,-1,-4,-2,-3,0,3,3,2,1,3,0,2,2,-3,5,2,-2,3,1,-1,-2,13,10,-12,2,-5,0,0,1,-1,-1,-1,2,-1
KR_6773019416,420,-4,-67,5,-8,-2,3,1,2,4,6,-3,3,0,-1,3,2,-4,4,0,-1,-8,3,-1,-4,5,-1,0,-3,0,-1,-1,-1,0,-1
KR_6729902829,420,0,-31,8,-6,-1,3,2,2,3,5,-5,6,1,-2,4,2,0,0,0,0,-8,-21,8,-11,3,-8,0,0,-1,1,0,-1,5,-1
KR_6773674543,440,-3,-50,-2,-11,-2,2,0,-5,5,0,0,2,2,-2,3,1,-2,3,1,-1,-18,36,1,-5,4,-2,0,0,-1,1,0,-1,6,-1
KR_6775502464,420,2,27,15,3,3,0,3,2,4,6,-1,4,3,-2,3,1,1,0,1,0,-2,19,-1,-4,5,-4,0,1,0,1,1,1,0,-1
KR_6772956665,420,-1,-25,5,0,-2,5,3,4,4,8,1,1,2,-3,4,1,0,0,0,0,-1,27,1,-9,8,3,0,0,-1,0,-1,-1,6,-1
KR_6771175838,420,-4,8,-23,-12,1,1,2,-7,11,4,0,3,3,-3,3,0,-3,3,0,-2,-10,-26,4,-11,7,-1,0,-1,-1,1,-1,-1,1,-1
KR_6734772851,440,-7,-33,-57,-16,-5,8,3,-8,8,0,-5,9,4,2,5,7,0,0,0,0,-12,-10,0,-4,4,-3,0,-2,0,-1,-1,1,0,-1
KR_6764647834,420,0,32,-6,1,-1,1,0,-2,2,0,3,1,4,1,6,7,0,2,2,0,-2,-109,-2,-4,6,3,0,0,-1,1,0,-1,4,-1
KR_6772073884,420,-5,-5,-28,-2,-5,5,0,8,2,10,1,5,6,-2,4,2,-4,4,0,0,-5,-5,-2,-7,9,4,0,-1,-1,-1,-1,-1,2,-1
KR_6747936864,420,-2,-27,-6,1,-3,4,1,-2,5,3,3,3,6,2,3,5,1,0,1,0,4,-2,1,-5,4,-5,0,1,-1,-1,1,-1,5,-1
KR_6730127881,420,-3,-24,-33,-8,-1,1,0,-6,7,1,1,3,4,-4,6,2,2,0,2,0,-22,1,-3,-7,10,-2,0,-2,-1,1,-1,-1,1,-1
KR_6773976318,420,0,-17,3,-1,-1,2,1,-2,4,2,0,4,4,0,1,1,2,1,3,0,-5,-1,5,-10,5,-1,0,-1,1,-1,-1,1,1,-1
KR_6739318556,420,5,24,19,5,3,0,3,1,1,2,4,0,4,-6,6,0,3,0,3,1,8,52,-4,-5,9,-16,0,1,-1,1,1,1,1,-1
KR_6776373170,440,-5,-92,-34,-10,0,0,0,-5,6,1,-3,5,2,-2,5,3,0,1,1,0,-6,5,4,-9,5,-3,0,-1,-1,0,-1,1,1,-1
KR_6777122707,420,-4,-45,-20,-6,-2,2,0,-2,5,3,2,0,2,0,2,2,-4,5,1,0,-6,100,5,-7,2,0,0,-3,-1,-1,-1,1,1,-1
KR_6775006637,420,-5,-131,-16,-16,0,2,2,-5,6,1,0,3,3,-8,10,2,-3,3,0,0,-12,-7,-5,-3,8,-5,0,-1,-1,1,-1,-1,4,-1
KR_6771367047,420,-2,64,8,-1,0,1,1,-1,3,2,-2,2,0,2,2,4,0,0,0,0,-1,-3,-2,-5,7,6,0,2,0,-1,1,-1,0,-1
KR_6777287344,420,-4,-56,12,-6,-2,3,1,0,2,2,-1,1,0,0,1,1,-3,5,2,0,-7,2,-2,-6,8,-1,0,-1,-1,-1,-1,-1,2,-1
KR_6774008313,420,-2,-79,29,0,0,2,2,1,5,6,2,0,2,-2,5,3,-1,1,0,0,-15,-247,-5,-2,7,0,0,0,1,1,1,-1,3,-1
KR_6774776619,420,-2,-21,-1,-8,-2,3,1,1,1,2,-4,9,5,-2,3,1,-1,1,0,-1,-3,-9,-5,-5,10,3,0,-2,-1,-1,-1,-1,3,-1
KR_6777174746,420,1,12,-28,-1,0,1,1,1,2,3,-1,1,0,0,1,1,-1,1,0,0,-1,-12,1,-6,5,3,0,1,-1,1,1,1,6,-1
KR_6777765172,420,-1,-28,-11,-12,-2,3,1,-3,4,1,-1,2,1,-6,6,0,0,2,2,-1,-16,-3,1,-9,8,-4,0,0,-1,1,0,-1,1,-1
KR_6726421264,420,0,-19,15,-2,-5,5,0,5,2,7,0,2,2,0,2,2,-2,2,0,-1,1,-286,-3,-3,6,4,0,-1,-1,-1,-1,-1,2,-1
KR_6774327247,420,-2,-47,-9,-2,-2,3,1,1,1,2,3,1,4,-1,2,1,-3,4,1,0,-4,5,-1,-7,8,-3,0,0,-1,-1,0,-1,2,-1
KR_6774131522,420,-2,-3,-27,-7,1,1,2,-1,3,2,-2,5,3,-3,5,2,-2,3,1,0,-5,7,-4,-5,9,-3,0,0,-1,-1,-1,-1,6,-1
KR_6740052385,420,-1,-43,-24,-3,1,0,1,-2,4,2,0,0,0,-1,2,1,-1,1,0,0,-5,-9,-3,-4,7,4,0,1,-1,1,1,-1,2,-1
KR_6764661088,420,-2,-40,0,-2,-1,3,2,-2,4,2,2,1,3,0,1,1,-1,1,0,0,0,-1,-4,-3,7,0,0,1,-1,1,1,-1,1,-1
KR_6753317647,420,1,118,22,-4,1,2,3,0,2,2,-3,7,4,-6,6,0,4,0,4,0,-11,3,-4,-4,8,2,0,0,-1,0,1,1,2,-1
KR_6773362962,420,0,14,0,-2,-6,6,0,1,2,3,5,0,5,-1,4,3,-1,1,0,1,-1,1,3,-10,7,-1,0,0,1,-1,1,1,3,-1
KR_6671460927,420,-3,-22,4,-9,-2,3,1,-3,4,1,-6,6,0,2,0,2,0,0,0,0,-12,5,-3,-3,6,-5,0,-1,-1,-1,-1,-1,4,-1
KR_6769216446,420,0,-37,0,-4,-5,5,0,5,4,9,-5,6,1,1,3,4,0,0,0,-2,0,-11,5,-8,3,3,0,-2,-1,-1,-1,-1,3,-1
KR_6740873357,420,-2,14,-40,1,-4,4,0,0,2,2,-1,2,1,5,3,8,1,1,2,0,9,97,0,-9,9,1,0,1,1,-1,-1,1,1,-1
KR_6774361791,420,-3,-32,-8,-8,-1,2,1,1,1,2,-3,4,1,-2,4,2,-3,3,0,0,-12,-55,2,-5,3,21,0,-1,-1,1,-1,-1,5,-1
KR_6776593230,420,-3,-39,-12,-11,-3,4,1,3,1,4,2,1,3,-3,5,2,-10,10,0,0,-4,-4,2,-12,10,0,0,-1,-1,-1,-1,-1,1,-1
KR_6775681614,420,1,11,17,0,0,3,3,-4,5,1,1,1,2,0,1,1,3,0,3,0,-1,3,2,-5,3,3,0,0,1,1,0,1,3,-1
KR_6770909926,420,3,48,-16,6,2,1,3,3,1,4,-1,6,5,2,1,3,0,1,1,1,12,-14,5,-8,3,3,0,0,-1,-1,1,1,1,-1
KR_6755149526,420,-3,27,-20,-15,-5,7,2,-5,6,1,-1,4,3,1,1,2,-5,5,0,1,-19,1,-4,-3,7,-3,0,0,-1,1,1,1,4,-1
KR_6764928253,440,-2,-30,1,-1,2,0,2,-1,2,1,2,0,2,-5,9,4,1,1,2,0,0,1,2,-7,5,-5,0,0,-1,-1,0,-1,5,-1
KR_6777462788,420,1,-31,-17,2,3,2,5,-1,1,0,5,1,6,-2,4,2,-3,4,1,0,-1,-3,0,-6,6,-3,0,-1,1,1,-1,1,5,-1
KR_6769412426,420,-3,-53,-11,-11,-5,6,1,2,4,6,-4,6,2,2,1,3,-6,6,0,0,1,15,0,-5,5,-5,0,0,1,1,-1,1,3,-1
KR_6771429992,420,-2,13,-17,1,-1,2,1,-1,4,3,3,2,5,1,2,3,-1,2,1,0,0,0,1,-9,8,2,0,-1,1,-1,-1,-1,5,-1
KR_6684113984,420,-4,-71,2,-8,0,2,2,1,1,2,-2,2,0,-3,4,1,-4,5,1,-1,-12,-19,4,-11,7,-4,0,-2,1,-1,-1,-1,5,-1
KR_6776833134,420,-1,-7,4,-10,-2,4,2,-4,6,2,-3,5,2,-1,2,1,0,1,1,0,-15,27,-3,-5,8,-2,0,0,-1,-1,0,-1,6,-1
KR_6759780703,440,-4,-5,-52,-7,2,3,5,-2,3,1,0,1,1,-4,5,1,-3,3,0,0,-9,-10,-3,-3,6,-2,0,0,-1,-1,0,-1,5,-1
KR_6773651696,440,0,-42,-11,1,2,0,2,2,2,4,-2,3,1,1,0,1,-2,2,0,0,4,-1,3,-6,3,-3,0,0,0,-1,0,1,0,-1
KR_6766621226,420,-2,-23,-44,0,0,1,1,-5,5,0,3,2,5,1,2,3,1,0,1,0,-3,6,6,-8,2,-6,0,0,-1,-1,0,1,6,-1
KR_6770180847,420,0,-11,-21,1,2,0,2,0,5,5,4,3,7,-6,7,1,1,2,3,0,1,-21,-5,-4,9,0,0,0,-1,-1,-1,-1,3,-1
KR_6729526731,440,-3,36,-4,-10,-3,4,1,-1,5,4,1,1,2,-1,1,0,-6,7,1,-1,-12,0,1,-5,4,-1,0,-1,1,-1,-1,-1,5,-1
KR_6777784674,420,-1,4,20,-7,-1,1,0,1,1,2,-4,5,1,-4,6,2,1,2,3,0,-16,-21,-4,-4,8,3,0,-2,1,-1,-1,-1,4,-1
KR_6771996826,420,0,-5,-5,-2,-5,5,0,2,2,4,-3,4,1,3,1,4,1,0,1,0,-2,-4,-3,-6,9,-5,0,0,1,-1,-1,-1,2,-1
KR_6769767941,440,0,-11,-12,1,-1,4,3,4,1,5,1,1,2,0,2,2,-3,3,0,0,1,6,-1,-5,6,-5,0,1,-1,1,1,1,3,-1
KR_6767419973,440,-1,0,0,-8,-1,2,1,-3,4,1,3,4,7,-2,5,3,-5,6,1,-1,-6,3,3,-6,3,-2,0,-1,1,1,-1,-1,5,-1
KR_6775504016,420,0,7,-38,-3,0,3,3,-4,4,0,-2,3,1,2,1,3,1,1,2,0,-3,17,5,-12,7,1,0,-2,1,-1,-1,-1,1,-1
KR_6772350927,420,-1,34,-52,-9,-2,2,0,-3,4,1,0,2,2,-4,4,0,0,0,0,0,-8,-9,0,-6,6,-2,0,1,-1,1,1,-1,5,-1
KR_6769870838,420,3,80,48,-5,1,2,3,-2,5,3,1,0,1,-5,8,3,0,1,1,0,-5,9,2,-3,1,2,0,3,1,-1,1,1,3,-1
KR_6768112091,420,-2,-61,17,-8,-5,6,1,0,3,3,-1,4,3,-1,1,0,-1,1,0,-1,-12,8,-2,-7,9,-3,0,-1,-1,-1,-1,-1,2,-1
KR_6738657451,440,-3,-38,-4,-13,-1,1,0,-4,7,3,-10,10,0,-2,2,0,4,0,4,0,-28,1,-4,-3,7,-3,0,0,1,0,0,-1,5,-1
KR_6770320971,420,-2,-65,-31,-3,5,0,5,-4,6,2,-3,4,1,-1,4,3,0,1,1,0,0,-38,7,-12,5,1,0,-2,-1,-1,-1,-1,5,-1
KR_6771666455,420,-2,-55,-8,-6,-1,4,3,3,3,6,-6,7,1,-1,4,3,-1,1,0,1,-10,-6,1,-8,7,-1,0,-2,-1,-1,-1,1,2,-1
KR_6699668737,420,-2,-37,2,-2,0,1,1,1,3,4,-4,6,2,2,1,3,-1,2,1,0,1,-5,-4,-4,8,2,0,-1,1,-1,-1,1,6,-1
KR_6765301450,420,-4,-15,-83,-3,2,1,3,-3,3,0,0,1,1,-3,5,2,1,0,1,0,-3,1,-1,-5,6,3,0,-1,-1,-1,-1,1,5,-1
KR_6751073979,420,2,67,-4,4,-1,2,1,0,1,1,4,2,6,3,1,4,-2,2,0,0,5,-7,3,-6,3,8,0,0,1,-1,0,-1,4,-1
KR_6736985463,420,-3,-64,-32,-10,4,1,5,-8,8,0,1,1,2,-3,5,2,-4,6,2,-2,-10,-6,-4,-5,9,-5,0,-1,1,1,-1,-1,6,-1
KR_6719976598,420,-3,-12,-19,-2,-2,2,0,1,4,5,-1,2,1,2,3,5,-2,2,0,0,-2,10,9,-12,3,-5,0,-2,-1,-1,-1,-1,5,-1
KR_6766515542,420,-3,-23,-13,-2,-6,7,1,3,3,6,-5,5,0,4,2,6,2,0,2,0,7,6,-2,-5,7,2,0,1,-1,-1,1,-1,3,-1
KR_6766191744,420,-3,-17,-23,-7,-3,3,0,-2,4,2,0,2,2,-2,4,2,0,0,0,0,-16,-2,-2,-3,5,2,0,0,-1,-1,-1,1,6,-1
KR_6683496426,420,-2,-8,6,3,-1,3,2,3,2,5,0,3,3,3,2,5,-2,2,0,0,5,204,2,-8,6,0,0,0,-1,1,0,1,5,-1
KR_6699710755,420,0,-39,3,5,-1,3,2,-2,2,0,6,1,7,2,2,4,0,0,0,0,7,5,-1,-6,7,3,0,1,-1,1,1,-1,6,-1
KR_6766713706,420,2,10,21,-3,0,0,0,2,2,4,1,2,3,-4,6,2,-2,3,1,0,-5,9,-8,-7,15,-14,0,0,1,-1,-1,-1,5,-1
KR_6720009123,420,-2,7,30,-5,-1,2,1,-4,4,0,0,1,1,0,1,1,0,0,0,1,-7,-9,-2,-7,9,-2,0,-2,1,-1,-1,1,1,-1
KR_6726149618,420,-2,-29,7,-5,-2,3,1,-1,3,2,0,3,3,-1,6,5,-1,1,0,0,-5,0,4,-11,7,4,0,-3,1,-1,-1,-1,6,-1
KR_6777365457,420,2,78,12,-1,0,1,1,0,4,4,2,1,3,-2,4,2,-1,1,0,0,-12,-64,-4,-4,8,6,0,3,-1,1,1,-1,6,-1
KR_6756665081,420,1,-51,-13,5,2,2,4,3,1,4,1,3,4,-2,2,0,1,0,1,0,4,162,2,-4,2,-2,0,0,1,1,-1,-1,3,-1
KR_6770375564,420,-2,-8,-8,-6,-2,3,1,3,0,3,3,1,4,-7,11,4,-3,5,2,0,-6,3,-4,-1,5,2,0,-1,1,0,-1,-1,4,-1
KR_6741267932,420,-1,7,-4,-4,-2,2,0,-2,3,1,-4,6,2,4,1,5,0,0,0,-1,-1,-2,-2,-4,6,-1,0,-1,-1,-1,-1,-1,1,-1
KR_6774596925,420,1,-29,7,2,-2,2,0,2,4,6,-2,3,1,4,2,6,0,1,1,0,5,1,0,-4,4,-2,0,-1,1,-1,-1,-1,2,-1
KR_6773901094,420,1,-10,5,5,1,1,2,4,2,6,-2,3,1,1,2,3,1,3,4,0,6,-36,4,-8,4,22,0,0,1,1,0,1,3,-1
KR_6774539819,420,1,-58,27,-1,-1,2,1,0,2,2,-2,2,0,-1,1,0,3,0,3,0,-3,48,1,-6,5,-3,0,0,-1,1,0,-1,3,-1
KR_6774582517,420,-3,11,-9,-8,-1,1,0,-4,9,5,0,1,1,-3,5,2,0,1,1,-1,-7,-11,9,-11,2,-2,0,-1,-1,-1,-1,1,4,-1
KR_6759885516,420,-3,-94,-32,-15,-4,4,0,-1,3,2,-4,7,3,-4,7,3,-2,5,3,-1,-12,-40,-3,-6,9,-3,0,-1,-1,-1,-1,-1,2,-1
KR_6701280263,420,-6,39,-44,-4,-2,3,1,0,2,2,0,2,2,-2,3,1,0,0,0,1,-6,3,1,-6,5,-3,0,0,-1,-1,-1,1,5,-1
KR_6775545715,420,-1,3,0,2,1,0,1,0,1,1,6,0,6,-5,6,1,0,2,2,0,-5,1,-1,-7,8,-2,0,-1,1,1,-1,1,5,-1
KR_6769650009,420,-6,-43,-31,-14,-1,3,2,-2,2,0,-10,12,2,-2,3,1,1,0,1,0,-22,-2,0,-5,5,-4,0,-2,-1,-1,-1,1,3,-1
KR_6776787134,420,-1,-34,-8,-5,-4,5,1,-2,3,1,-6,9,3,1,2,3,6,1,7,0,3,10,-1,-5,6,3,0,-2,-1,-1,-1,-1,2,-1
KR_6776174023,420,-1,60,-16,0,0,3,3,-1,3,2,0,3,3,1,4,5,0,1,1,-1,-15,-6,-3,-3,6,6,0,0,1,1,0,-1,2,-1
KR_6772999160,440,-4,-73,-12,-11,1,2,3,-5,7,2,-1,2,1,-7,8,1,1,1,2,0,-13,-37,1,-8,7,17,0,0,-1,1,1,-1,6,-1
KR_6775653067,420,-1,-1,-15,-6,-7,8,1,2,1,3,-1,1,0,0,3,3,0,3,3,0,-1,-8,-4,-4,8,-2,0,0,1,-1,0,-1,5,-1
KR_6763220624,420,2,-5,4,6,1,1,2,5,1,6,-1,6,5,0,2,2,1,1,2,0,7,10,5,-9,4,-1,0,1,1,-1,1,1,3,-1
KR_6672759849,420,0,2,-20,1,-4,8,4,-1,2,1,5,1,6,0,2,2,1,1,2,-1,-2,36,0,-6,6,1,0,0,-1,1,1,-1,1,-1
KR_6772807391,420,-3,-6,-21,-9,-3,3,0,-4,4,0,-2,4,2,-1,2,1,1,0,1,0,-5,-3,0,-6,6,0,0,-1,1,-1,-1,-1,2,-1
KR_6777527619,420,-3,-65,-3,-16,-4,4,0,-7,8,1,-4,6,2,2,1,3,-3,3,0,0,-15,4,-5,-1,6,-4,0,-2,0,-1,-1,-1,0,-1
KR_6715721791,420,-4,-45,-13,-13,-1,3,2,-3,6,3,-4,5,1,-4,4,0,-1,1,0,0,-22,-13,1,-7,6,6,0,-1,-1,-1,-1,1,5,-1
KR_6770477773,420,-8,-40,-15,-24,1,3,4,0,0,0,-17,19,2,-2,5,3,-6,9,3,-1,-24,-2,-2,-2,4,-1,0,-2,1,-1,-1,-1,3,-1
KR_6722757491,420,-5,-95,-5,-7,-2,2,0,0,2,2,-1,6,5,-4,4,0,0,1,1,0,0,-7,-1,-6,7,-3,0,-2,-1,-1,-1,-1,4,-1
KR_6758746572,420,-2,-47,-43,1,-1,3,2,-4,5,1,4,4,8,1,1,2,1,1,2,-1,5,-34,-1,-4,5,5,0,0,-1,1,-1,-1,3,-1
KR_6748181599,440,-1,2,-12,0,7,1,8,-2,4,2,0,1,1,-4,5,1,-1,2,1,0,0,3,0,-3,3,-2,0,0,-1,0,0,1,4,-1
KR_6768264303,420,0,7,9,-7,-2,3,1,-3,6,3,-1,2,1,-1,1,0,0,0,0,0,-12,-16,0,-3,3,0,0,-1,1,-1,-1,-1,2,-1
KR_6742405618,420,-4,-54,-42,-6,-2,3,1,4,1,5,-3,5,2,-7,8,1,2,1,3,0,3,127,-2,-4,6,-11,0,-1,-1,-1,-1,1,1,-1
KR_6699440593,420,-1,-39,9,-3,-2,4,2,-2,2,0,-1,2,1,2,2,4,0,0,0,0,-5,2,-8,-4,12,6,0,1,1,1,1,-1,3,-1
KR_6769097689,420,-2,-12,-8,-6,3,1,4,-5,6,1,-3,3,0,0,5,5,-1,4,3,-3,-14,259,-2,-5,7,1,0,-2,0,-1,-1,1,0,-1
KR_6729998781,420,-4,-45,-4,-11,-5,6,1,-3,8,5,-2,3,1,0,2,2,-1,1,0,-1,-8,-28,-2,-5,7,0,0,-1,-1,1,-1,1,5,-1
KR_6760220229,420,0,-47,4,4,3,2,5,1,1,2,0,4,4,-3,5,2,3,0,3,0,14,7,1,-7,6,2,0,-1,1,1,-1,1,6,-1
KR_6772364730,420,-8,-69,-42,-6,-1,5,4,0,0,0,-1,3,2,-2,4,2,-2,2,0,0,-13,-11,-7,-1,8,0,0,-4,-1,-1,-1,1,1,-1
KR_6771735288,420,0,28,-24,5,2,0,2,3,4,7,-1,2,1,1,2,3,0,0,0,0,9,0,1,-8,7,0,0,0,-1,-1,-1,1,5,-1
KR_6751089023,420,-5,-51,7,-11,-3,3,0,-4,4,0,-4,4,0,4,0,4,-4,4,0,0,-12,7,4,-8,4,2,0,-2,1,-1,-1,-1,5,-1
KR_6774952644,420,-2,29,-25,-5,-1,2,1,-2,6,4,-1,3,2,0,1,1,-1,1,0,0,-7,1,-1,-4,5,0,0,0,-1,-1,1,1,4,-1
KR_6770215061,440,0,5,-12,-4,2,1,3,-1,4,3,-3,6,3,-2,4,2,0,3,3,0,2,-20,-3,-4,7,6,0,-2,-1,-1,-1,-1,5,-1
KR_6768593838,420,0,-17,-4,-2,3,1,4,-3,4,1,-3,5,2,3,3,6,-2,2,0,0,-6,-2,1,-6,5,-2,0,0,1,1,1,1,5,-1
KR_6770710241,420,-3,-64,4,-14,-2,3,1,-3,4,1,-7,8,1,-2,3,1,0,0,0,0,-10,-4,-2,-5,7,-5,0,-1,-1,-1,-1,-1,6,-1
KR_6772837160,420,2,24,-8,1,0,1,1,-2,3,1,-2,2,0,4,0,4,1,0,1,0,-2,47,-2,-3,5,-25,0,0,-1,-1,0,-1,6,-1
KR_6775409988,420,-2,-61,19,0,2,1,3,-1,2,1,2,3,5,-3,3,0,0,0,0,0,-10,-7,-2,-4,6,-3,0,-1,-1,1,-1,-1,2,-1
KR_6759348790,420,-3,-16,-8,-7,3,0,3,-3,4,1,-5,5,0,-1,6,5,-1,1,0,-1,-2,-7,0,-6,6,5,0,-1,0,-1,-1,-1,0,-1
KR_6765299958,420,-12,-211,-25,-18,-7,8,1,-2,4,2,-5,5,0,-4,5,1,0,0,0,0,-18,-3,-4,-1,5,-8,-2,-6,1,-1,-1,-1,3,-1
KR_6744813264,420,0,-4,-3,0,-1,1,0,7,3,10,0,1,1,-5,5,0,-1,1,0,0,-8,121,3,-7,4,-1,0,0,-1,-1,0,-1,1,-1
KR_6774793854,440,5,73,-17,11,-3,3,0,4,2,6,7,1,8,2,2,4,1,1,2,2,5,1,3,-7,4,3,0,1,1,1,1,1,6,-1
KR_6773638873,420,3,52,39,4,-1,2,1,1,1,2,1,0,1,1,2,3,2,0,2,0,3,-4,-5,-4,9,5,0,1,1,1,1,1,4,-1
KR_6772021087,420,-2,6,-1,1,4,0,4,-5,6,1,-1,2,1,0,2,2,3,1,4,0,0,12,7,-10,3,-4,0,0,-1,1,0,-1,3,-1
KR_6774203180,420,4,14,2,12,1,4,5,3,1,4,1,2,3,5,0,5,2,1,3,1,16,1,1,-6,5,9,0,0,-1,1,1,1,5,-1
KR_6756746377,420,1,-37,21,0,-3,5,2,5,1,6,-1,4,3,0,1,1,-1,1,0,0,11,26,3,-6,3,1,0,-2,1,-1,-1,-1,4,-1
KR_6748181744,420,-1,19,-8,-12,-2,2,0,-4,9,5,2,3,5,-2,5,3,-6,7,1,0,-16,-109,2,-8,6,-7,0,0,-1,-1,-1,1,6,-1
KR_6766573657,420,-2,-78,0,-8,4,0,4,-2,2,0,-6,6,0,-3,4,1,-1,1,0,0,-14,-25,-3,-4,7,0,0,0,-1,1,-1,-1,1,-1
KR_6731908651,420,-3,-16,-40,-7,1,1,2,-7,9,2,-4,7,3,0,3,3,3,0,3,-3,-7,-4,-4,-7,11,-2,0,0,-1,-1,-1,-1,4,-1
KR_6777390457,420,-8,-103,-13,-16,-10,10,0,-2,3,1,-1,3,2,-4,4,0,1,0,1,0,-10,-2,-2,-7,9,-3,0,-2,1,-1,-1,1,6,-1
KR_6776207833,420,0,-1,28,-5,0,0,0,0,1,1,-2,4,2,-1,4,3,-2,3,1,0,0,-7,-6,-5,11,3,0,-1,1,-1,-1,-1,3,-1
KR_6773087718,420,0,-55,-1,2,3,1,4,-3,6,3,2,1,3,-2,4,2,2,1,3,0,6,9,0,-4,4,-4,0,-1,-1,1,-1,-1,3,-1
KR_6750152950,420,1,15,13,-1,0,1,1,-1,3,2,4,2,6,0,2,2,-4,4,0,0,-5,-118,-5,-3,8,4,0,-1,0,-1,-1,1,0,-1
KR_6774042825,420,-2,2,4,-7,3,1,4,-4,8,4,-1,2,1,0,2,2,-5,5,0,0,-10,-5,-9,-2,11,-3,0,0,1,-1,-1,1,6,-1
KR_6768887252,420,2,81,20,-1,4,1,5,-4,4,0,1,1,2,-1,4,3,-1,1,0,0,0,0,-2,-6,8,5,0,1,1,-1,1,-1,5,-1
KR_6769193288,420,-1,-29,2,-4,2,1,3,1,2,3,2,3,5,-10,12,2,1,1,2,0,-10,28,0,-6,6,-3,0,-1,-1,1,-1,-1,2,-1
KR_6775973640,420,-1,-17,-15,1,2,1,3,4,1,5,0,1,1,-5,5,0,0,2,2,0,0,-1,-3,-5,8,2,0,0,-1,0,0,1,4,-1
KR_6776359349,420,-1,35,-17,9,-2,2,0,2,2,4,0,0,0,5,1,6,4,1,5,0,10,5,5,-9,4,-6,0,0,1,1,1,1,4,-1
KR_6775372554,420,-3,0,16,-7,0,0,0,0,4,4,-3,4,1,-3,5,2,-1,2,1,0,-9,-2,-4,-4,8,-5,0,-2,-1,-1,-1,-1,5,-1
KR_6773980858,420,1,17,-5,7,-1,2,1,6,1,7,2,1,3,3,2,5,-3,3,0,0,15,23,2,-9,7,0,0,0,1,1,0,1,3,-1
KR_6772005145,420,-2,-22,0,-10,-1,1,0,0,2,2,-2,3,1,-6,6,0,-1,2,1,0,-9,-2,2,-10,8,-7,0,0,-1,-1,0,-1,5,-1
KR_6700533950,420,-1,-32,12,-2,0,0,0,-3,6,3,1,2,3,-1,2,1,1,2,3,0,-2,-4,-4,-2,6,0,0,0,1,-1,0,1,3,-1
KR_6768846766,420,0,-23,0,-3,-1,2,1,0,3,3,2,1,3,-3,5,2,-1,1,0,0,-6,-7,-4,-3,7,1,0,0,-1,1,1,1,2,-1
KR_6775507270,420,-2,-27,4,-5,-3,4,1,-2,2,0,1,0,1,1,2,3,-2,2,0,0,-5,9,3,-7,4,0,0,-1,1,1,-1,-1,5,-1
KR_6745545358,420,0,-45,18,0,-2,4,2,0,4,4,1,1,2,3,1,4,-2,2,0,0,7,-10,-6,-4,10,0,0,-1,0,-1,-1,-1,0,-1
KR_6766740298,420,-4,-44,-12,-8,-3,6,3,-5,5,0,0,2,2,0,2,2,0,1,1,-1,-9,5,0,-6,6,-5,0,-2,-1,1,-1,-1,5,-1
KR_6748175328,420,-1,6,-24,1,-2,3,1,1,4,5,0,1,1,1,7,8,1,0,1,0,5,0,3,-7,4,-7,0,-1,-1,-1,-1,-1,6,-1
KR_6745478786,420,-1,-67,-33,2,-2,4,2,-1,4,3,3,3,6,2,0,2,0,0,0,0,5,0,-2,-5,7,-6,0,-1,0,0,-1,-1,0,-1
KR_6768492773,420,1,-48,11,3,-2,6,4,2,0,2,3,1,4,0,2,2,0,1,1,1,13,-9,2,-9,7,1,0,0,1,-1,-1,-1,4,-1
KR_6738724658,440,-2,-15,13,-8,2,0,2,-3,3,0,-5,6,1,0,3,3,-2,5,3,0,-17,1,1,-6,5,3,0,1,-1,1,-1,-1,1,-1
KR_6739534552,420,-3,1,-31,-7,-6,7,1,2,0,2,-2,2,0,2,4,6,-3,4,1,0,-7,-38,-5,-4,9,3,0,-3,-1,-1,-1,1,5,-1
KR_6776053705,420,1,13,1,1,-1,3,2,-1,4,3,0,3,3,3,3,6,0,0,0,0,5,-2,0,-5,5,-1,0,1,1,1,1,-1,6,-1
KR_6774788948,420,2,24,-16,2,1,2,3,0,3,3,5,2,7,-5,7,2,1,1,2,0,3,-1,2,-8,6,2,0,-1,-1,1,-1,1,5,-1
KR_6760164254,420,0,82,-16,-2,-1,3,2,0,2,2,-2,5,3,0,5,5,1,0,1,0,-2,-1,-8,-3,11,-6,0,0,-1,1,0,-1,4,-1
KR_6755767028,420,-1,33,0,-1,0,5,5,-1,2,1,-1,2,1,1,0,1,0,0,0,0,-2,52,-5,-2,7,1,0,0,1,-1,0,1,3,-1
KR_6672282522,420,-7,-37,-41,-11,-2,4,2,-4,6,2,-2,4,2,-3,3,0,0,0,0,0,-15,-13,3,-10,7,3,0,-2,1,-1,-1,1,2,-1
KR_6774559884,420,0,-46,2,-5,-4,5,1,2,1,3,-1,1,0,0,2,2,-2,2,0,0,-4,-20,3,-8,5,-5,0,0,1,1,0,1,3,-1
KR_6777763108,420,0,-38,14,-4,2,1,3,-3,3,0,-4,7,3,0,2,2,1,1,2,-1,-10,86,3,-10,7,7,0,0,-1,-1,-1,-1,6,-1
KR_6771234233,420,0,23,9,-3,2,0,2,-3,5,2,-3,4,1,2,2,4,-1,1,0,0,-3,6,-4,-5,9,-1,0,-1,-1,-1,-1,-1,6,-1
KR_6758623271,420,-3,-18,4,-3,-3,5,2,0,2,2,-3,5,2,1,1,2,2,0,2,0,-6,26,0,-7,7,-22,0,0,-1,-1,0,-1,2,-1
KR_6777070887,420,1,27,-7,-4,0,3,3,-4,5,1,-2,5,3,1,2,3,1,0,1,0,-14,3,-5,-1,6,2,0,0,1,-1,0,1,2,-1
KR_6762654469,420,0,-18,-18,5,2,2,4,2,5,7,6,1,7,2,2,4,-7,7,0,2,-5,-17,-2,-4,6,9,0,0,-1,1,1,-1,5,-1
KR_6776830494,420,0,21,-3,-3,0,1,1,3,3,6,0,2,2,-9,10,1,3,0,3,0,-12,1,-3,-5,8,5,0,0,1,-1,0,-1,1,-1
KR_6777718422,420,-4,8,-19,-9,-1,2,1,-3,3,0,0,2,2,-2,6,4,-3,4,1,-2,-22,14,-5,-5,10,4,0,-2,-1,1,-1,-1,4,-1
KR_6705012997,420,-5,-55,-38,-13,3,1,4,-3,6,3,-7,7,0,-2,4,2,-4,4,0,-1,-25,-80,1,-5,4,9,0,-3,-1,-1,-1,-1,5,-1
KR_6775080549,420,0,15,-3,-1,1,1,2,-1,5,4,1,2,3,-4,8,4,2,0,2,1,-5,-276,1,-8,7,3,0,0,1,1,-1,1,6,-1
KR_6777507451,420,-4,-67,-34,-7,-3,4,1,2,4,6,-2,3,1,-5,6,1,1,0,1,0,-8,-198,3,-7,4,-3,0,0,-1,1,-1,-1,1,-1
KR_6726785127,420,-6,-60,-5,-17,-3,3,0,-11,12,1,-4,4,0,0,4,4,1,2,3,0,-16,6,1,-9,8,3,0,-1,1,-1,-1,-1,3,-1
KR_6768745354,420,2,41,-2,1,4,0,4,0,5,5,-1,2,1,-2,3,1,0,0,0,0,4,16,2,-7,5,-1,0,0,1,-1,-1,-1,3,-1
KR_6744700503,420,-2,-47,24,-5,0,3,3,-1,1,0,1,0,1,-3,6,3,-2,2,0,0,-2,26,-1,-5,6,-3,0,-1,-1,1,1,1,3,-1
KR_6776491984,420,0,43,2,-5,-2,3,1,0,2,2,-1,3,2,-3,4,1,1,0,1,1,1,0,0,-5,5,3,0,-1,0,-1,-1,1,0,-1
KR_6777126669,420,2,5,-8,5,3,1,4,1,1,2,3,0,3,-1,5,4,-1,2,1,0,3,-5,-1,-8,9,0,0,1,-1,1,1,-1,1,-1
KR_6775990896,420,-1,32,-3,-8,-1,5,4,0,2,2,-3,5,2,-3,4,1,-1,1,0,0,-6,-10,-2,-8,10,8,0,-1,-1,-1,-1,1,4,-1
KR_6608199792,440,0,31,2,-2,-2,2,0,0,2,2,-5,8,3,4,1,5,1,0,1,0,2,6,4,-8,4,-3,0,0,-1,-1,-1,1,2,-1
KR_6740289867,440,-1,58,-4,-6,0,3,3,-2,4,2,-5,5,0,0,1,1,1,0,1,0,-7,-6,4,-9,5,-2,0,0,0,-1,0,-1,0,-1
KR_6777454259,420,-4,-45,-4,-9,0,1,1,-8,9,1,0,0,0,3,2,5,-4,4,0,0,-8,-9,3,-9,6,0,0,0,1,-1,1,1,4,-1
KR_6766204331,420,-4,-39,-18,-11,-4,5,1,-5,6,1,-1,3,2,-1,3,2,0,0,0,0,-5,-36,-2,-3,5,-4,0,-1,-1,-1,-1,-1,5,-1
KR_6762064509,420,-5,-42,-48,-12,-1,1,0,-11,12,1,-1,3,2,2,1,3,-1,1,0,0,-16,-3,1,-9,8,-1,0,0,1,-1,-1,-1,4,-1
KR_6722414892,420,-2,-40,-18,0,0,3,3,2,1,3,0,3,3,-2,3,1,0,2,2,0,-2,19,2,-5,3,-4,0,0,-1,1,-1,-1,5,-1
KR_6773678037,420,-5,-76,29,-10,-3,3,0,-2,5,3,-1,3,2,-3,3,0,-1,1,0,0,-11,0,-2,-1,3,1,0,-1,1,1,-1,-1,4,-1
KR_6776716952,420,-6,-87,-16,-5,-2,2,0,-3,5,2,2,1,3,0,0,0,-2,3,1,0,-3,4,5,-10,5,-4,0,-3,1,-1,-1,-1,2,-1
KR_6776063087,420,-4,-6,-9,-13,-1,2,1,0,5,5,-6,6,0,-3,3,0,-3,3,0,-1,-12,1,-3,-3,6,-4,0,0,-1,-1,0,-1,4,-1
KR_6769555402,420,-5,-62,-27,-10,2,2,4,-2,4,2,-3,4,1,-8,9,1,1,0,1,0,-10,-5,-3,-4,7,-2,0,-1,-1,-1,-1,1,2,-1
KR_6773840427,420,0,-11,1,-7,-2,4,2,2,2,4,-1,4,3,-4,4,0,-2,2,0,-2,-14,-3,5,-10,5,-1,0,0,1,-1,-1,-1,6,-1
KR_6773848858,420,-1,13,2,0,-1,3,2,1,3,4,-1,1,0,3,2,5,-2,3,1,0,0,1,0,-6,6,2,0,0,1,-1,0,-1,3,-1
KR_6690740392,420,0,20,-10,6,-2,2,0,1,5,6,7,0,7,-1,1,0,1,1,2,0,3,-9,0,-6,6,-1,0,-1,1,-1,-1,1,5,-1
KR_6772501810,420,0,-58,16,-9,-3,5,2,2,2,4,-1,4,3,-7,7,0,0,0,0,0,-13,-6,-5,-5,10,0,0,-2,1,1,-1,-1,1,-1
KR_6777221582,420,-2,7,13,-6,0,0,0,1,2,3,-1,5,4,-5,5,0,-1,3,2,-1,-14,-7,-1,-6,7,2,0,0,-1,-1,-1,1,5,-1
KR_6776375459,420,0,-3,-20,-2,0,1,1,-1,4,3,1,1,2,-2,3,1,0,0,0,0,-4,-11,-5,-2,7,2,0,0,-1,-1,0,-1,4,-1
KR_6729382053,420,-6,-53,-23,-11,-1,1,0,-9,10,1,-1,1,0,-1,4,3,1,0,1,-2,-17,-48,-8,-5,13,-1,0,-1,1,-1,-1,-1,4,-1
KR_6755394063,420,-3,-1,-24,-9,-2,3,1,-5,7,2,-4,4,0,0,3,3,2,1,3,0,-2,37,-3,-3,6,-14,0,-1,-1,1,-1,-1,6,-1
KR_6716272168,420,-2,7,13,-8,0,0,0,-1,2,1,-5,7,2,-2,3,1,0,1,1,0,-9,-5,-3,-4,7,1,0,-1,0,-1,-1,-1,0,-1
KR_6774500804,420,3,63,13,-2,-2,2,0,-2,3,1,-2,6,4,2,0,2,2,1,3,0,-8,0,-5,-2,7,4,0,2,-1,1,1,-1,4,-1
KR_6747803360,420,3,-12,-3,10,0,5,5,-4,4,0,3,2,5,11,0,11,0,1,1,0,22,4,2,-7,5,-2,0,0,1,1,-1,1,5,-1
KR_6776877185,420,0,-48,51,-2,-4,4,0,2,3,5,1,1,2,-1,1,0,0,0,0,0,-1,14,0,-5,5,-1,0,-1,1,-1,-1,-1,2,-1
KR_6776405316,440,-3,-47,-11,-4,-3,4,1,2,1,3,-2,5,3,0,3,3,-1,3,2,1,1,-44,-1,-6,7,-1,0,0,1,1,-1,1,6,-1
KR_6773543537,420,-4,41,-24,-3,-1,2,1,-4,5,1,-6,6,0,7,1,8,1,1,2,0,-3,-4,0,-5,5,3,0,0,-1,-1,0,1,5,-1
KR_6764777094,420,2,82,-15,2,-3,6,3,5,1,6,1,2,3,-1,3,2,0,0,0,0,8,-78,2,-7,5,0,0,0,1,1,1,1,1,-1
KR_6776557609,420,-2,-34,18,-3,2,0,2,0,2,2,0,1,1,-4,6,2,-1,1,0,1,-7,0,-5,-3,8,-6,0,-1,-1,1,1,1,5,-1
KR_6776985125,420,-4,-45,-11,-7,-5,5,0,-7,7,0,3,0,3,0,3,3,2,3,5,0,1,109,1,-4,3,1,0,-1,-1,-1,-1,-1,6,-1
KR_6774818653,420,1,75,-4,1,-2,4,2,-1,3,2,2,3,5,0,2,2,2,2,4,0,-5,-18,-4,-5,9,5,0,1,-1,1,1,-1,5,-1
KR_6755776000,420,-1,-25,1,-4,3,2,5,3,1,4,-3,4,1,-6,8,2,-1,1,0,0,-3,-9,2,-10,8,1,0,-1,1,-1,-1,-1,2,-1
KR_6758779976,420,1,4,-28,9,0,3,3,4,2,6,1,2,3,2,3,5,2,2,4,1,15,14,2,-7,5,1,0,-2,-1,-1,-1,1,3,-1
KR_6698505345,420,-7,-65,-19,-16,1,1,2,-7,7,0,-3,4,1,-3,5,2,-4,4,0,0,-22,9,1,-10,9,0,0,-2,-1,-1,-1,-1,6,-1
KR_6745743056,420,-3,-23,-40,-9,0,2,2,-4,8,4,0,1,1,-3,3,0,-2,2,0,-3,-20,-39,0,-6,6,-1,0,-2,-1,-1,-1,-1,2,-1
KR_6763235644,420,0,-29,18,-3,3,0,3,-2,3,1,-1,1,0,-2,2,0,-1,1,0,0,-7,-3,1,-13,12,4,0,0,-1,1,0,-1,3,-1
KR_6749071919,420,-1,-22,-20,0,0,1,1,0,3,3,-1,2,1,0,2,2,1,0,1,0,-3,-12,-2,-6,8,3,0,0,-1,1,0,1,3,-1
KR_6700717024,420,0,-32,-6,3,-1,4,3,1,3,4,1,1,2,1,2,3,1,1,2,0,6,-1,2,-5,3,7,0,-1,1,1,-1,1,6,-1
KR_6775278105,420,-1,48,38,-1,0,0,0,-2,3,1,2,1,3,-2,2,0,1,2,3,0,-5,5,-5,-4,9,4,0,1,-1,1,1,-1,2,-1
KR_6734740352,440,-2,14,28,-6,3,1,4,0,2,2,0,4,4,-4,6,2,-5,5,0,1,-16,6,-3,-6,9,-5,0,0,1,1,0,1,3,-1
KR_6776486343,420,2,41,-17,0,2,0,2,-2,5,3,-3,6,3,4,0,4,-1,1,0,0,8,9,1,-6,5,-3,0,0,-1,-1,0,-1,1,-1
KR_6756180830,420,0,47,-4,1,0,3,3,-2,2,0,8,0,8,-2,3,1,-3,3,0,0,4,-13,3,-6,3,1,0,2,1,1,1,1,5,-1
KR_6771688447,420,-1,26,-6,-3,0,1,1,-4,8,4,-1,3,2,0,3,3,2,0,2,0,-1,5,2,-9,7,-4,0,1,-1,-1,1,-1,6,-1
KR_6758853857,420,-3,-50,-27,-5,-1,2,1,-3,8,5,-2,2,0,1,0,1,0,0,0,0,-11,2,2,-10,8,1,0,0,1,-1,0,-1,3,-1
KR_6776716163,420,-2,52,-17,-2,-1,2,1,0,2,2,-1,3,2,0,2,2,0,1,1,0,-3,-8,-1,-7,8,-2,0,1,-1,1,1,-1,5,-1
KR_6776748933,420,2,74,-8,-1,-1,2,1,2,2,4,-1,4,3,-3,6,3,2,0,2,0,-6,-1,2,-5,3,0,0,0,1,-1,-1,1,2,-1
KR_6776502634,420,-3,-68,-7,-4,1,1,2,2,0,2,3,1,4,-11,13,2,1,2,3,0,-8,23,1,-7,6,-2,0,0,1,1,-1,1,5,-1
KR_6774673096,420,0,-77,-3,-1,-1,3,2,8,2,10,-1,1,0,-3,7,4,-4,5,1,0,8,3,-2,-7,9,2,0,0,-1,1,-1,-1,5,-1
KR_6772355649,420,-4,32,24,-9,-2,3,1,-7,8,1,0,2,2,0,3,3,0,0,0,0,-15,-34,-9,0,9,-1,0,0,-1,-1,-1,-1,4,-1
KR_6740523276,420,2,31,-4,-2,2,0,2,-5,6,1,1,2,3,-3,5,2,3,1,4,0,-2,76,2,-5,3,-4,0,1,-1,-1,1,-1,4,-1
KR_6777382631,420,-1,9,-17,-2,0,0,0,0,2,2,-2,4,2,-1,2,1,1,0,1,0,-1,-10,1,-9,8,-3,0,-1,0,0,-1,1,0,-1
KR_6770607823,420,0,-5,-12,-4,1,2,3,-4,6,2,1,3,4,-2,3,1,0,0,0,0,-7,-16,-4,-1,5,-3,0,-2,-1,-1,-1,1,1,-1
KR_6722438667,420,0,2,20,-9,0,0,0,-4,5,1,-4,5,1,-1,3,2,0,1,1,0,-12,-3,6,-9,3,-5,0,0,-1,1,0,-1,3,-1
KR_6745556086,420,1,-3,8,-4,-6,7,1,1,1,2,-2,4,2,1,4,5,2,1,3,-1,-1,231,1,-5,4,-5,0,-1,-1,-1,-1,-1,5,-1
KR_6770502535,420,-3,37,-11,-9,3,1,4,-2,3,1,-3,3,0,-5,6,1,-2,3,1,0,-13,-105,3,-8,5,2,0,-1,-1,-1,-1,-1,3,-1
KR_6759679871,440,-2,-63,-18,1,3,4,7,-3,3,0,1,3,4,-1,3,2,1,0,1,1,0,-6,3,-8,5,-1,0,0,0,-1,1,1,0,-1
KR_6772122815,420,1,-7,2,4,-2,3,1,5,1,6,0,2,2,-1,3,2,2,1,3,-1,11,-12,-1,-3,4,1,0,-3,1,-1,-1,-1,5,-1
KR_6769793411,440,-1,23,10,-8,-1,1,0,-8,8,0,-2,3,1,3,2,5,0,0,0,0,-11,1,-3,-6,9,5,0,0,-1,1,0,-1,6,-1
KR_6743310107,420,-1,-49,-52,3,4,1,5,4,0,4,-8,8,0,2,3,5,1,1,2,0,3,-2,2,-7,5,-2,0,0,1,-1,-1,1,2,-1
KR_6772271276,420,-2,-1,-9,-9,-7,7,0,0,2,2,0,2,2,-2,2,0,0,0,0,0,-7,14,-3,-6,9,-5,0,1,1,-1,1,-1,5,-1
KR_6760849150,420,0,54,-4,3,2,2,4,3,0,3,-4,5,1,3,0,3,-1,2,1,-1,4,5,2,-8,6,-2,0,0,0,-1,0,-1,0,-1
KR_6752120642,420,-7,-67,-44,-6,-1,3,2,0,2,2,-3,6,3,-2,2,0,0,1,1,0,-6,-13,-4,-3,7,0,0,-1,1,-1,-1,-1,3,-1
KR_6774232503,420,-2,2,14,-6,-2,2,0,-1,8,7,-7,9,2,5,1,6,-1,2,1,1,-6,7,-6,-2,8,-4,0,1,-1,1,1,-1,5,-1
KR_6728776117,440,3,41,33,7,2,2,4,4,1,5,0,3,3,1,7,8,0,0,0,0,12,-20,-3,-4,7,-2,0,1,-1,1,1,-1,6,-1
KR_6773307043,420,-5,12,-10,-11,-4,4,0,-2,3,1,-4,4,0,-2,4,2,1,1,2,0,-12,5,-1,-3,4,1,0,0,1,-1,-1,1,4,-1
KR_6775591449,420,-3,-18,-28,-12,2,1,3,1,1,2,-3,3,0,-5,7,2,-7,7,0,0,-21,8,-3,-6,9,-2,0,-2,-1,-1,-1,-1,4,-1
KR_6714476071,420,0,5,-17,3,1,2,3,4,3,7,-4,6,2,0,3,3,2,1,3,0,3,7,0,-4,4,1,0,-1,-1,-1,-1,1,3,-1
KR_6757910255,420,-6,-113,-5,-12,-4,5,1,-3,5,2,-3,3,0,2,3,5,-4,4,0,0,-5,-9,-2,-4,6,6,0,-2,0,-1,-1,-1,0,-1
KR_6758106951,420,-1,7,-4,-3,0,1,1,5,0,5,1,0,1,-8,11,3,-1,1,0,0,-11,7,6,-10,4,-7,0,0,-1,1,-1,-1,5,-1
KR_6725071131,420,-3,-29,-48,-6,3,1,4,-3,3,0,-3,6,3,-3,6,3,0,1,1,0,4,8,5,-9,4,-3,0,0,-1,1,1,1,6,-1
KR_6770633972,420,1,22,-32,2,-2,3,1,0,4,4,0,3,3,-1,2,1,5,0,5,0,8,5,-3,-5,8,4,0,0,-1,1,0,1,4,-1
KR_6762686593,420,-2,18,2,-7,1,1,2,3,1,4,-8,9,1,-3,3,0,0,0,0,0,-8,-14,-3,-4,7,3,0,0,-1,-1,-1,-1,1,-1
KR_6748933168,440,-1,99,-45,-2,6,0,6,2,3,5,-3,5,2,-7,9,2,0,1,1,1,-5,-4,-1,-6,7,-1,0,0,-1,-1,1,1,4,-1
KR_6775346173,420,-2,-41,5,-3,-3,5,2,3,0,3,-1,4,3,-6,6,0,4,1,5,1,9,15,0,-8,8,-2,0,-1,1,-1,-1,-1,2,-1
KR_6749678839,420,-1,-14,8,-3,2,0,2,1,2,3,-2,2,0,-3,3,0,-1,2,1,0,-8,-6,-2,-4,6,5,0,0,-1,1,0,1,1,-1
KR_6767504039,420,-2,56,-4,-6,2,2,4,3,4,7,-3,5,2,-8,12,4,0,0,0,-3,-9,-3,1,-7,6,4,0,-1,-1,-1,-1,-1,6,-1
KR_6722305471,420,-7,-51,-51,-12,-2,2,0,-2,4,2,-1,3,2,-3,4,1,-4,4,0,0,-11,4,-2,-8,10,-7,0,-1,-1,-1,-1,1,1,-1
KR_6773641961,440,-4,-89,-14,-8,-3,4,1,-1,5,4,-1,3,2,-3,8,5,0,2,2,-1,-8,9,-1,-5,6,-2,0,-3,-1,-1,-1,-1,6,-1
KR_6774507075,420,-4,-38,-38,-9,-4,4,0,0,1,1,-3,4,1,-2,5,3,0,0,0,0,-6,-36,-3,-5,8,2,0,-1,1,-1,-1,1,5,-1
KR_6756140262,420,-6,-85,-12,-9,-5,6,1,-1,1,0,-3,7,4,1,1,2,-1,1,0,0,-13,-24,1,-6,5,4,0,-1,-1,1,-1,1,1,-1
KR_6760875057,420,-5,-120,-1,-11,-5,6,1,-4,7,3,-2,2,0,3,2,5,-3,3,0,0,-4,-10,-3,-7,10,0,0,-2,0,-1,-1,1,0,-1
KR_6725258252,420,-4,-36,-28,-11,-2,3,1,-3,3,0,-3,4,1,-3,3,0,0,2,2,0,-9,-4,-5,-3,8,2,0,-1,-1,-1,-1,-1,6,-1
KR_6766655580,420,0,-11,-1,-2,1,4,5,-3,4,1,0,1,1,-2,3,1,2,0,2,0,-3,118,3,-6,3,-4,0,2,-1,-1,1,1,5,-1
KR_6775415864,420,-3,-73,-14,-7,-1,2,1,-2,4,2,-3,5,2,0,2,2,-1,3,2,0,-1,12,-7,-1,8,-4,0,0,-1,-1,-1,1,3,-1
KR_6762648519,420,-4,-81,-1,0,1,1,2,3,2,5,0,1,1,-3,5,2,-1,3,2,0,5,-5,4,-8,4,3,0,0,-1,1,1,1,2,-1
KR_6761552706,420,0,-4,0,-2,0,0,0,1,2,3,-2,2,0,-2,3,1,1,0,1,0,-2,108,-2,-6,8,4,0,0,1,-1,0,1,2,-1
KR_6769380252,420,-3,-70,-9,-2,1,1,2,9,2,11,-7,10,3,-6,7,1,1,1,2,0,-4,-3,2,-7,5,3,0,-1,1,-1,-1,1,3,-1
KR_6771773271,420,-2,-7,-5,-2,1,0,1,-2,6,4,1,2,3,-3,3,0,1,1,2,0,-2,94,3,-8,5,5,0,0,1,-1,0,1,3,-1
KR_6734066478,420,-4,-19,-1,-6,0,2,2,-1,5,4,0,2,2,-4,5,1,-1,1,0,0,-5,5,3,-9,6,-8,0,-1,1,1,-1,-1,5,-1
KR_6773839055,420,-3,24,-34,-1,0,3,3,-1,4,3,2,1,3,0,2,2,-2,2,0,0,1,28,3,-8,5,-6,0,-1,1,-1,-1,1,3,-1
KR_6759768187,420,1,7,23,-6,0,3,3,-4,6,2,0,1,1,-2,3,1,0,0,0,0,0,-4,2,-8,6,5,0,0,1,-1,0,-1,5,-1
KR_6757637105,420,3,25,23,6,1,0,1,2,3,5,1,4,5,-1,3,2,3,0,3,0,16,0,2,-8,6,3,0,0,1,1,0,1,3,-1
KR_6744510160,420,-5,-85,11,-8,-5,6,1,-3,4,1,-1,2,1,-1,4,3,2,4,6,-1,2,2,2,-7,5,3,0,1,1,-1,1,-1,2,-1
KR_6738300771,420,-1,66,13,-4,-2,4,2,1,0,1,-3,4,1,0,1,1,0,2,2,0,-10,9,6,-9,3,-1,0,3,1,-1,1,1,6,-1
KR_6777661319,420,-5,-62,-39,-19,-2,3,1,-5,5,0,-9,10,1,-4,5,1,1,1,2,-3,-25,-7,-4,-2,6,4,0,-1,-1,-1,-1,-1,2,-1
KR_6768404214,420,-2,-15,15,-7,1,1,2,0,2,2,-3,6,3,-4,5,1,-1,1,0,0,-11,26,4,-7,3,-3,0,0,1,-1,-1,-1,1,-1
KR_6767516535,420,-2,-21,16,0,3,1,4,-8,11,3,2,1,3,0,1,1,3,2,5,0,-2,-13,6,-7,1,1,0,0,-1,0,-1,-1,2,-1
KR_6770711874,420,2,-20,24,-1,2,2,4,1,2,3,-2,3,1,-3,6,3,1,1,2,0,-2,6,3,-8,5,-3,0,1,1,1,1,1,6,-1
KR_6729001876,420,-1,-28,-4,-1,-2,3,1,2,5,7,-1,1,0,0,2,2,0,0,0,0,-6,10,3,-9,6,-7,0,0,1,1,0,1,1,-1
KR_6729088737,420,-1,-20,-16,1,-4,4,0,8,1,9,-1,2,1,-3,3,0,1,0,1,0,-1,6,1,-4,3,1,0,-1,1,-1,-1,1,6,-1
KR_6662915059,420,-1,-24,-34,-3,2,1,3,-3,4,1,0,2,2,-2,4,2,0,1,1,0,-4,-4,1,-8,7,3,0,-2,-1,-1,-1,-1,2,-1
KR_6736245194,420,-2,-78,-32,-8,-2,2,0,0,3,3,2,2,4,-3,5,2,-5,6,1,-1,-5,4,-2,-5,7,-8,0,-1,-1,-1,-1,-1,6,-1
KR_6768171652,420,1,-9,-4,0,-2,3,1,2,3,5,0,2,2,-1,3,2,1,1,2,0,5,-3,-5,-5,10,-3,0,-1,-1,1,-1,-1,1,-1
KR_6765128787,420,-2,25,-13,-6,-1,2,1,-2,4,2,-3,4,1,-1,3,2,1,0,1,1,-3,-54,1,-9,8,37,0,0,-1,-1,0,1,5,-1
KR_6760128140,420,-4,-21,-14,-7,-1,3,2,0,0,0,2,1,3,-5,5,0,-3,5,2,0,-11,-4,-1,-6,7,-5,0,-3,-1,-1,-1,1,2,-1
KR_6747751246,420,-1,46,-17,-2,-3,3,0,0,4,4,-1,5,4,2,0,2,0,1,1,0,2,2,2,-9,7,3,0,1,1,-1,-1,-1,6,-1
KR_6776295214,420,0,22,1,0,-2,2,0,-2,4,2,3,1,4,1,5,6,0,1,1,0,-5,-1,4,-9,5,4,0,1,1,-1,1,1,3,-1
KR_6770663204,420,-1,20,-12,0,1,2,3,4,2,6,-4,5,1,0,2,2,-1,2,1,0,-11,23,-3,-5,8,3,0,0,1,1,1,1,4,-1
KR_6763217283,420,-3,-32,-21,-6,-1,2,1,-3,5,2,-2,5,3,0,4,4,0,1,1,1,8,-7,-1,-6,7,-1,0,0,-1,-1,-1,1,6,-1
KR_6757858067,420,-4,-102,-5,-2,2,0,2,2,1,3,-4,4,0,-2,3,1,0,1,1,0,-4,3,2,-8,6,-3,0,0,1,1,0,1,6,-1
KR_6729037232,420,-3,-40,-16,-13,0,4,4,2,0,2,-5,9,4,-8,12,4,-2,3,1,0,-14,50,-3,-6,9,-3,0,-3,-1,-1,-1,-1,3,-1
KR_6769904525,420,-3,5,-5,-6,-2,3,1,0,3,3,1,3,4,-5,8,3,0,1,1,0,-6,8,2,-6,4,-2,0,-1,1,1,-1,-1,3,-1
KR_6776721714,420,3,31,-10,3,5,2,7,0,2,2,3,3,6,-4,4,0,-1,2,1,0,6,-1,-1,-4,5,-1,0,0,-1,1,-1,-1,6,-1
KR_6772410510,420,0,38,-20,-9,5,1,6,-1,3,2,-3,3,0,-7,8,1,-3,4,1,0,-13,-37,4,-8,4,6,0,0,-1,-1,-1,1,4,-1
KR_6730679921,420,1,47,4,-3,2,0,2,-4,4,0,-4,5,1,2,3,5,1,0,1,0,-4,44,2,-10,8,-35,0,0,1,-1,-1,1,3,-1
KR_6683207370,420,-7,-77,-20,-12,2,2,4,-7,10,3,-5,5,0,0,3,3,-2,2,0,0,-9,32,0,-5,5,-4,0,1,1,-1,-1,1,4,-1
KR_6741847068,420,1,-15,16,2,-1,3,2,0,4,4,1,2,3,0,2,2,2,1,3,-1,-6,152,3,-8,5,-2,0,-1,1,1,-1,-1,1,-1
KR_6738836978,420,-5,-29,-8,-2,0,1,1,-4,7,3,-4,4,0,8,0,8,-2,4,2,1,-9,97,1,-5,4,-6,0,1,-1,1,1,1,3,-1
KR_6774001842,440,-2,-73,17,-5,3,0,3,-7,8,1,-4,4,0,0,0,0,3,1,4,0,0,5,-2,-6,8,-3,0,0,1,1,0,1,4,-1
KR_6776265982,420,-6,-55,-8,-19,-3,5,2,-4,5,1,-8,8,0,-2,5,3,-2,3,1,0,-13,0,-2,-4,6,2,0,0,-1,-1,1,-1,4,-1
KR_6756163341,420,-4,-59,-20,-7,-7,7,0,4,5,9,-1,4,3,2,3,5,-5,5,0,1,3,-5,0,-6,6,-2,0,0,-1,1,-1,1,1,-1
KR_6773597549,440,-2,27,-18,-8,0,0,0,-5,5,0,-5,6,1,2,2,4,0,1,1,0,-13,11,3,-5,2,-3,0,1,-1,1,1,-1,5,-1
KR_6748198797,420,-1,20,1,-3,0,1,1,1,1,2,-3,4,1,-1,8,7,0,0,0,0,-6,2,-3,-6,9,2,0,1,-1,1,1,-1,5,-1
KR_6765170760,420,-3,7,-3,-3,3,3,6,0,1,1,-2,3,1,-3,8,5,-1,1,0,0,-4,12,0,-5,5,5,0,-1,0,-1,1,1,0,-1
KR_6774603154,420,-3,-22,-1,-7,-2,2,0,-3,3,0,-3,3,0,2,1,3,-1,2,1,0,-7,-6,4,-10,6,-2,0,-1,1,-1,-1,1,2,-1
KR_6770767055,420,-2,-47,-12,-1,0,3,3,1,2,3,-4,4,0,2,0,2,0,0,0,0,-4,-1,1,-6,5,2,0,1,1,1,1,1,2,-1
KR_6762248539,420,-1,0,-52,2,1,1,2,4,1,5,-2,6,4,2,2,4,-3,3,0,0,-6,-8,-4,-6,10,2,0,-1,-1,1,-1,1,6,-1
KR_6777267822,440,-6,-90,-12,-14,0,0,0,-10,11,1,-2,3,1,-1,1,0,-1,1,0,0,-12,1,0,-3,3,-6,0,-1,1,-1,-1,-1,5,-1
KR_6770388210,420,0,52,8,2,3,0,3,-2,4,2,-2,5,3,4,2,6,-1,1,0,0,-7,0,2,-9,7,-1,0,0,1,1,1,1,4,-1
KR_6771428902,440,-2,6,8,5,-1,3,2,4,3,7,0,4,4,1,1,2,1,1,2,1,0,-6,3,-7,4,-2,0,-1,-1,1,-1,-1,1,-1
KR_6776248397,420,2,14,19,-1,2,1,3,4,2,6,-1,4,3,-5,7,2,-1,2,1,-1,-8,-28,-3,-5,8,2,0,0,-1,-1,-1,-1,5,-1
KR_6773687398,420,-4,-52,-22,-6,-7,7,0,3,0,3,0,2,2,-2,4,2,0,2,2,0,3,-7,-5,-6,11,-1,0,-4,-1,-1,-1,-1,5,-1
KR_6771389264,420,3,-4,-5,-1,1,2,3,-1,3,2,2,1,3,-1,3,2,-2,2,0,-1,0,4,-2,-6,8,6,0,1,-1,-1,1,-1,5,-1
KR_6777365160,420,1,-13,-11,-2,-1,1,0,-1,2,1,0,2,2,-2,2,0,2,0,2,0,1,-1,2,-5,3,-3,0,-1,-1,-1,-1,1,6,-1
KR_6729581674,440,0,37,-27,-6,-6,8,2,4,2,6,-4,4,0,-4,6,2,4,3,7,0,-11,8,0,-5,5,-4,0,1,-1,-1,1,-1,2,-1
KR_6777352134,420,-1,-4,-49,1,2,1,3,2,2,4,-3,6,3,2,2,4,-2,2,0,0,5,-36,-6,-4,10,5,0,-1,-1,-1,-1,-1,4,-1
KR_6755477378,420,-3,-48,8,-6,0,1,1,0,2,2,-6,7,1,0,0,0,0,1,1,1,-5,41,3,-10,7,-5,0,-1,-1,-1,-1,1,4,-1
KR_6719532867,420,-2,-6,-18,-5,2,2,4,-7,8,1,-1,1,0,0,3,3,1,1,2,0,-10,-33,-5,-5,10,2,0,-2,-1,-1,-1,-1,5,-1
KR_6699415126,420,-2,-76,-20,-5,-4,7,3,-4,5,1,0,3,3,3,2,5,0,2,2,0,2,-273,3,-6,3,0,0,0,-1,1,1,1,6,-1
KR_6761763060,420,2,2,32,0,1,2,3,2,4,6,0,1,1,-3,4,1,0,0,0,0,0,0,1,-9,8,-2,0,0,1,-1,-1,-1,2,-1
KR_6775234424,420,-4,-31,24,-9,-6,6,0,-2,5,3,-5,6,1,2,1,3,2,0,2,0,-5,-14,-3,-4,7,5,0,-1,1,-1,-1,-1,2,-1
KR_6741911836,440,-3,-60,6,-6,-3,4,1,-3,6,3,-2,2,0,1,1,2,1,2,3,0,-12,6,-2,-6,8,-7,0,-2,-1,1,-1,-1,2,-1
KR_6772095731,420,0,-5,-2,2,-1,1,0,1,3,4,4,1,5,-3,4,1,1,0,1,-1,-2,9,2,-10,8,7,0,2,1,1,1,-1,1,-1
KR_6777432655,420,-9,-99,-36,-14,-6,6,0,-2,4,2,-2,2,0,-1,2,1,-3,4,1,0,-8,0,2,-6,4,-5,0,-2,-1,-1,-1,1,5,-1
KR_6763379224,420,3,25,-7,7,-4,5,1,4,1,5,0,2,2,3,1,4,4,0,4,0,10,-113,0,-5,5,2,0,0,-1,-1,-1,1,3,-1
KR_6777159969,420,-1,-28,0,-3,-1,1,0,-1,4,3,0,3,3,2,0,2,-3,3,0,0,-3,3,7,-10,3,-5,0,0,-1,-1,-1,-1,1,-1
KR_6749739400,420,-3,-48,-36,-4,-1,5,4,-2,4,2,-1,4,3,0,1,1,0,1,1,0,-3,30,5,-9,4,-6,0,-2,-1,-1,-1,-1,4,-1
KR_6776209780,420,0,-15,-19,-1,0,2,2,-3,4,1,1,0,1,0,1,1,1,0,1,0,-5,5,-1,-9,10,2,0,-1,-1,1,-1,1,2,-1
KR_6736279622,420,0,38,-7,3,-1,2,1,1,4,5,-2,4,2,3,1,4,2,1,3,3,7,-5,1,-7,6,1,0,0,1,-1,1,1,2,-1
KR_6732484764,440,3,24,0,8,0,1,1,6,0,6,-3,3,0,4,0,4,1,1,2,0,8,-8,-5,-3,8,4,0,1,-1,1,1,-1,1,-1
KR_6769773905,420,-2,11,4,-5,1,0,1,-1,4,3,-5,6,1,2,1,3,-2,2,0,-1,-14,-57,2,-9,7,-3,0,-1,-1,1,-1,1,3,-1
KR_6723226623,420,-9,-74,-18,-13,-2,5,3,-2,3,1,-3,4,1,-3,4,1,-3,5,2,0,-14,-3,-3,-3,6,2,0,-1,0,-1,-1,-1,0,-1
KR_6748677846,420,1,34,-11,4,-1,2,1,1,1,2,3,0,3,-5,6,1,6,2,8,-1,4,205,1,-11,10,-4,0,2,-1,1,1,-1,4,-1
KR_6776786653,420,0,31,-4,0,0,1,1,1,0,1,-3,6,3,2,3,5,0,0,0,0,2,19,0,-8,8,5,0,0,-1,1,0,-1,5,-1
KR_6767801269,420,-2,-41,-4,1,-2,3,1,-2,6,4,1,0,1,1,3,4,3,0,3,0,0,92,-1,-3,4,1,0,0,-1,1,0,1,3,-1
KR_6768719155,420,0,36,-12,-3,0,2,2,2,2,4,-9,9,0,3,2,5,1,0,1,-1,2,-7,-6,-2,8,1,0,1,1,1,1,-1,6,-1
KR_6773607173,420,-8,-28,-16,-14,-3,4,1,-5,7,2,0,1,1,-4,4,0,-2,2,0,0,-18,1,2,-6,4,-1,0,-1,-1,1,-1,-1,6,-1
KR_6685777150,420,-4,-109,-27,-14,-5,6,1,-4,5,1,1,1,2,-4,6,2,-2,3,1,0,-22,-13,2,-7,5,-3,0,-5,-1,-1,-1,-1,4,-1
KR_6774019996,440,-5,-70,-32,-18,-3,5,2,4,0,4,0,1,1,-18,18,0,-1,3,2,0,-18,-203,-4,-3,7,-2,0,-1,-1,-1,-1,-1,2,-1
KR_6777303861,420,0,-2,35,2,-3,5,2,0,2,2,2,3,5,6,1,7,-3,3,0,-1,-3,5,-3,-3,6,-2,0,0,-1,1,1,-1,1,-1
KR_6737240144,420,-3,-36,-11,-5,-6,7,1,-6,7,1,1,3,4,2,2,4,4,0,4,-1,-5,-16,-4,-7,11,2,0,0,1,-1,-1,1,2,-1
KR_6773961699,420,-3,-49,-1,-14,-1,1,0,-3,3,0,-5,5,0,-6,6,0,1,2,3,0,-18,14,-2,-6,8,-2,0,-2,-1,-1,-1,-1,1,-1
KR_6756690530,420,2,-6,-28,10,0,2,2,5,2,7,2,1,3,3,1,4,0,0,0,0,9,0,3,-9,6,2,0,0,-1,1,0,1,1,-1
KR_6776763814,420,-3,12,9,-3,0,0,0,-1,3,2,0,1,1,-3,4,1,1,2,3,0,-9,28,2,-4,2,-3,0,0,-1,1,1,1,2,-1
KR_6773282233,420,1,-18,-6,1,-1,1,0,3,3,6,2,1,3,-4,4,0,1,0,1,0,1,-7,-1,-3,4,-1,0,0,0,1,0,-1,0,-1
KR_6772477804,420,1,-28,-4,5,1,1,2,1,3,4,2,3,5,1,2,3,0,1,1,0,5,38,2,-4,2,3,0,-2,-1,1,-1,1,3,-1
KR_6775194183,420,-2,18,-25,-8,-5,5,0,2,3,5,-4,5,1,-3,5,2,2,0,2,0,-13,-15,6,-10,4,-2,0,0,1,-1,-1,-1,2,-1
KR_6697664320,420,2,-57,16,5,3,0,3,0,2,2,4,0,4,-2,3,1,0,1,1,1,2,19,-7,-3,10,2,0,-1,1,1,-1,1,1,-1
KR_6772373512,420,-1,-69,-1,3,2,0,2,2,2,4,-4,6,2,2,0,2,1,1,2,1,5,29,-1,-6,7,-4,0,-1,1,-1,-1,1,6,-1
KR_6776296595,420,-3,-57,-40,-3,-2,2,0,-4,4,0,1,1,2,-1,4,3,3,0,3,-3,-6,-3,0,-7,7,6,0,-1,-1,1,-1,-1,5,-1
KR_6776797596,420,-1,5,25,-3,0,1,1,-3,6,3,-1,1,0,2,1,3,-1,1,0,0,-4,125,2,-7,5,-29,0,0,-1,1,0,-1,3,-1
KR_6775249998,420,0,-7,14,-1,1,0,1,-1,3,2,-1,4,3,1,4,5,-1,1,0,0,3,7,1,-9,8,2,0,1,1,-1,1,1,4,-1
KR_6749393564,420,-2,-11,-40,-3,-2,3,1,-3,4,1,3,0,3,-2,4,2,1,0,1,0,2,85,4,-6,2,-24,0,-1,0,-1,-1,-1,0,-1
KR_6754956252,420,0,-70,21,-2,0,2,2,0,3,3,0,6,6,-2,3,1,0,0,0,0,0,0,0,-3,3,1,0,-2,0,0,-1,-1,0,-1
KR_6776645482,420,-2,-65,13,3,-2,3,1,0,4,4,-1,3,2,5,1,6,1,2,3,0,12,13,8,-10,2,-8,0,-1,1,-1,-1,1,2,-1
KR_6776315476,420,-5,-57,-32,-11,0,0,0,-2,2,0,-4,5,1,-2,2,0,-3,3,0,0,-9,-23,-5,-5,10,0,0,-2,-1,-1,-1,-1,1,-1
KR_6767476050,440,-1,10,-13,-1,4,0,4,-2,3,1,-1,1,0,-2,2,0,0,1,1,0,-8,-14,-3,-3,6,1,0,0,-1,-1,0,1,4,-1
KR_6734177288,420,-5,-62,-3,-13,-4,4,0,0,4,4,-3,4,1,-4,4,0,-2,2,0,0,-15,-1,-2,-5,7,-4,0,-2,-1,1,-1,-1,4,-1
KR_6776574945,420,-2,-46,28,-10,-9,11,2,3,0,3,1,3,4,-1,4,3,-4,4,0,0,-4,-4,2,-8,6,2,0,-2,1,-1,-1,-1,6,-1
KR_6777046126,420,-2,-13,-18,-10,0,2,2,-3,5,2,0,3,3,-1,2,1,-6,7,1,-1,-15,27,-6,-4,10,-2,0,0,-1,-1,-1,-1,2,-1
KR_6776407018,420,-1,22,-3,-3,-3,4,1,6,0,6,-4,6,2,-2,2,0,0,1,1,0,3,-5,-5,-1,6,2,0,0,1,-1,0,-1,2,-1
KR_6763295155,440,0,-51,-6,0,5,2,7,-6,6,0,0,2,2,1,0,1,0,3,3,0,3,14,-4,-6,10,-2,0,0,-1,-1,0,-1,1,-1
KR_6767097147,440,-1,23,12,-7,-1,2,1,-7,8,1,-3,3,0,5,0,5,-1,2,1,0,-8,5,0,-4,4,0,0,0,-1,-1,0,-1,2,-1
KR_6771558198,440,-6,-95,-55,-7,-4,7,3,-4,5,1,-1,3,2,1,1,2,1,1,2,-1,-1,-27,0,-7,7,0,0,0,-1,0,-1,1,2,-1
KR_6770547153,420,1,4,-4,4,1,0,1,3,1,4,0,2,2,-1,1,0,1,1,2,0,5,-1,1,-5,4,4,0,0,-1,1,1,1,1,-1
KR_6752933793,420,-3,-41,-23,-3,-7,8,1,2,5,7,-2,2,0,5,4,9,-1,1,0,-3,-2,5,4,-8,4,-5,0,0,-1,-1,-1,-1,6,-1
KR_6722523147,420,-2,-30,-18,-2,2,0,2,-1,3,2,0,2,2,-1,2,1,-2,2,0,0,-5,8,-1,-5,6,0,0,0,-1,-1,0,1,6,-1
KR_6769993220,420,3,25,31,4,2,0,2,-2,5,3,1,1,2,3,0,3,0,2,2,0,1,-34,1,-7,6,4,0,1,-1,1,1,1,4,-1
KR_6774005466,420,-4,-44,-33,-12,-3,4,1,-1,3,2,-3,6,3,-5,6,1,0,2,2,1,-16,-8,-4,-4,8,0,0,-3,-1,-1,-1,-1,1,-1
KR_6762219981,420,0,98,-19,-1,0,0,0,-7,7,0,2,1,3,3,2,5,1,0,1,-1,-9,-2,-3,-8,11,6,0,-1,-1,-1,-1,-1,6,-1
KR_6743530461,420,-1,44,20,-11,-8,8,0,2,0,2,-8,11,3,-1,1,0,4,0,4,0,-5,27,2,-7,5,-1,0,-1,-1,1,-1,1,4,-1
KR_6777795657,440,0,-35,-20,-2,-4,5,1,-3,6,3,3,1,4,-2,2,0,4,0,4,1,10,-4,2,-4,2,0,0,-1,-1,0,-1,1,1,-1
KR_6759628027,420,0,-74,17,6,2,1,3,4,2,6,1,0,1,1,2,3,-2,2,0,0,9,25,-1,-8,9,3,0,0,1,-1,0,1,4,-1
KR_6777867633,420,-4,-38,-41,-7,-3,3,0,-3,4,1,-2,2,0,-1,1,0,2,1,3,0,-8,-6,3,-8,5,-2,0,-1,-1,1,-1,-1,6,-1
KR_6756955335,420,-3,-73,20,-8,-2,2,0,1,1,2,-3,4,1,-4,5,1,0,1,1,0,-17,-1,-4,-4,8,-6,0,-1,1,-1,-1,1,4,-1
KR_6774136533,420,0,-13,4,-12,5,3,8,-10,10,0,-2,2,0,-3,7,4,-2,3,1,0,-25,-10,-3,-3,6,4,0,0,1,-1,-1,-1,4,-1
KR_6776295237,420,-7,-50,7,-11,-4,4,0,-1,1,0,-2,3,1,-3,6,3,-1,1,0,-1,-11,-11,-7,0,7,5,0,-1,-1,1,-1,1,6,-1
KR_6777100610,420,-1,-67,-6,0,-1,3,2,0,1,1,-2,6,4,0,2,2,3,1,4,0,6,17,2,-9,7,-1,0,-1,-1,-1,-1,-1,6,-1
KR_6722379337,420,3,-13,-34,9,-1,2,1,4,3,7,2,1,3,4,0,4,0,0,0,-1,12,7,1,-8,7,-1,0,1,1,0,1,-1,2,-1
KR_6771377742,420,-3,-66,-13,-3,1,1,2,0,1,1,-3,3,0,-2,3,1,1,1,2,0,6,-9,-1,-5,6,-2,0,-1,-1,-1,-1,-1,4,-1
KR_6739677460,420,-2,-52,-22,-8,0,3,3,-4,6,2,-2,2,0,-2,5,3,0,1,1,-1,-9,-28,2,-6,4,1,0,1,-1,1,1,-1,4,-1
KR_6755199980,420,-3,-32,9,-4,-1,4,3,-3,4,1,-4,4,0,2,5,7,2,1,3,2,1,-3,-3,-6,9,-1,0,1,-1,1,1,1,5,-1
KR_6770077161,420,-3,-21,4,-5,-1,3,2,-3,3,0,4,0,4,-3,3,0,-2,2,0,0,-11,6,-5,-3,8,-1,0,-1,1,-1,-1,-1,4,-1
KR_6742451986,440,-6,-70,-16,-13,-1,1,0,-4,6,2,-6,9,3,-2,4,2,0,0,0,0,-19,-13,-11,0,11,1,0,-1,1,-1,-1,-1,5,-1
KR_6776087459,420,-3,18,-4,-5,-2,3,1,1,3,4,-3,3,0,1,4,5,-2,2,0,0,-7,28,11,-15,4,-14,0,-1,1,-1,-1,-1,1,-1
KR_6768757942,420,-8,-127,-52,-21,-4,5,1,-1,5,4,0,1,1,-12,12,0,-4,5,1,-2,-22,-7,-5,-7,12,-4,0,-2,1,1,-1,-1,1,-1
KR_6768590733,420,0,2,-14,2,0,0,0,1,3,4,-1,2,1,1,0,1,1,0,1,0,3,22,4,-7,3,-2,0,0,-1,1,0,1,6,-1
KR_6776571925,420,-3,2,40,-13,-3,4,1,-3,6,3,1,2,3,-6,6,0,-2,3,1,0,-21,-22,-6,-4,10,-2,0,-1,-1,1,-1,1,5,-1
KR_6766249267,420,-4,-14,-15,-8,-1,3,2,-1,3,2,-2,3,1,-3,3,0,-1,1,0,0,-12,-8,-2,-5,7,-1,0,-1,1,-1,-1,1,6,-1
KR_6760223826,420,2,17,28,5,3,0,3,0,3,3,-1,2,1,1,1,2,2,0,2,0,4,1,1,-7,6,-2,0,0,1,-1,0,1,6,-1
KR_6777247240,420,-2,-63,4,-5,-1,1,0,-2,2,0,2,2,4,-3,4,1,-1,1,0,0,-6,-4,-1,-4,5,-1,0,0,-1,-1,0,1,4,-1
KR_6770702940,440,0,0,-7,-4,-3,4,1,2,2,4,3,2,5,-6,6,0,0,1,1,0,-2,0,3,-8,5,4,0,-1,1,-1,-1,1,3,-1
KR_6765030176,420,2,-16,24,5,2,2,4,3,1,4,4,0,4,-5,6,1,1,2,3,1,1,-2,3,-7,4,-3,0,1,1,1,-1,1,6,-1
KR_6775271963,420,-5,-49,13,-7,1,3,4,-1,2,1,-3,3,0,2,5,7,-6,6,0,1,1,-18,-6,-2,8,3,0,-2,-1,-1,-1,1,2,-1
KR_6772340772,420,0,16,-1,-2,-7,8,1,6,1,7,2,0,2,0,1,1,-3,3,0,0,3,8,-6,-4,10,8,0,0,1,-1,-1,1,5,-1
KR_6774593223,420,4,31,20,6,3,2,5,1,2,3,-1,2,1,1,1,2,2,2,4,0,7,-2,-7,-4,11,4,0,0,-1,1,0,1,1,-1
KR_6772171448,420,-4,-85,2,-12,-2,2,0,-3,5,2,-2,3,1,-1,4,3,-4,4,0,0,-8,66,-6,-6,12,0,0,-2,-1,1,-1,-1,3,-1
KR_6700880449,420,-5,5,-31,-13,1,2,3,-6,6,0,-2,2,0,-4,5,1,-2,2,0,0,-21,1,0,-8,8,-1,0,-1,-1,-1,-1,1,1,-1
KR_6774729072,420,-1,-14,8,-3,0,1,1,-4,8,4,0,1,1,-1,4,3,2,1,3,0,-3,34,-2,-7,9,-2,0,1,1,-1,1,1,6,-1
KR_6776257997,420,0,48,43,-6,1,2,3,0,4,4,0,2,2,-4,6,2,-3,5,2,-1,-3,-5,1,-4,3,-4,0,0,-1,1,-1,-1,3,-1
KR_6777215625,420,-2,-11,28,-5,-3,3,0,-1,1,0,2,3,5,-2,2,0,-1,2,1,0,-1,65,2,-7,5,-40,0,-1,1,1,-1,-1,5,-1
KR_6740257534,420,3,-10,36,5,-2,3,1,1,2,3,3,0,3,-2,4,2,5,0,5,0,5,0,-5,-3,8,3,0,0,1,1,0,-1,4,-1
KR_6757157983,420,-5,-27,8,-14,-6,6,0,-7,7,0,-3,5,2,3,2,5,-1,2,1,0,0,1,-5,-5,10,-6,0,-2,1,-1,-1,-1,4,-1
KR_6751972364,420,-3,-25,12,-7,0,3,3,2,3,5,-1,1,0,-3,4,1,-5,5,0,1,-16,-4,-6,-5,11,-2,0,-1,1,-1,-1,1,1,-1
KR_6747871061,440,-1,-6,-16,-2,2,0,2,0,2,2,-6,8,2,4,2,6,-2,2,0,0,-3,-3,0,-5,5,3,0,0,-1,-1,-1,1,2,-1
KR_6767950233,420,2,49,7,4,-5,6,1,1,3,4,3,1,4,3,1,4,2,0,2,0,8,-5,1,-8,7,4,0,0,1,-1,0,-1,2,-1
KR_6761648509,420,-1,-50,23,-6,1,2,3,-3,4,1,-1,6,5,-2,3,1,-1,1,0,0,-12,-9,-5,-6,11,7,0,0,1,1,0,1,4,-1
KR_6771509726,420,-2,-61,0,-4,-3,3,0,-2,4,2,0,3,3,1,1,2,0,1,1,0,1,-23,0,-6,6,-2,0,-1,-1,-1,-1,-1,3,-1
KR_6777371050,420,3,34,2,-2,2,0,2,-2,3,1,0,2,2,-2,2,0,0,0,0,0,-14,17,0,-6,6,1,0,0,-1,1,0,1,4,-1
KR_6770893118,420,1,79,23,-1,0,0,0,0,5,5,-1,3,2,0,2,2,0,1,1,0,4,-51,2,-7,5,2,0,3,1,1,1,-1,2,-1
KR_6774421793,420,-1,-15,-9,4,4,2,6,-1,4,3,3,1,4,0,5,5,-2,2,0,1,10,69,4,-7,3,-4,0,-1,-1,1,-1,1,5,-1
KR_6776702692,420,-2,-82,21,-6,-1,3,2,-2,2,0,-1,3,2,-3,3,0,1,1,2,-1,-5,117,2,-5,3,-12,0,0,1,-1,0,-1,3,-1
KR_6753411432,420,-9,-134,-40,-4,1,0,1,-2,4,2,-1,3,2,-2,2,0,0,0,0,0,-5,-23,-1,-3,4,0,0,-4,0,-1,-1,-1,0,-1
KR_6767564369,420,-1,1,-42,-1,-1,4,3,5,2,7,-1,2,1,-2,4,2,-2,2,0,-1,-5,-8,2,-8,6,1,0,-1,-1,1,-1,-1,4,-1
KR_6777199375,420,-2,-6,-27,-1,-5,6,1,1,2,3,1,2,3,2,3,5,0,1,1,1,3,-2,-5,-7,12,-6,0,-1,1,-1,-1,1,1,-1
KR_6775394109,420,-2,-49,-12,-4,3,1,4,2,2,4,-4,6,2,-2,4,2,-3,3,0,0,-5,6,2,-6,4,-3,0,-1,0,-1,-1,1,0,-1
KR_6773543497,420,2,17,4,2,0,1,1,1,2,3,1,1,2,-3,5,2,3,1,4,0,-1,3,-2,-5,7,2,0,0,-1,1,-1,-1,4,-1
KR_6777320347,420,-2,0,-29,1,-1,3,2,5,0,5,0,2,2,-2,4,2,-1,3,2,0,-4,-6,0,-4,4,2,0,0,1,-1,0,1,1,-1
KR_6773340766,420,0,-33,3,0,1,1,2,1,2,3,-4,5,1,0,2,2,2,0,2,0,-5,0,-1,-6,7,2,0,-2,1,-1,-1,-1,2,-1
KR_6753421477,420,-3,-16,37,-9,-2,2,0,2,3,5,-2,3,1,-8,9,1,1,0,1,-2,-17,18,-8,-4,12,3,0,0,-1,1,0,-1,4,-1
KR_6777373887,420,-1,11,-6,0,-3,4,1,1,3,4,0,2,2,3,2,5,-1,2,1,0,-1,129,6,-11,5,4,0,1,1,1,1,-1,6,-1
KR_6774210536,420,-3,-80,-46,-5,-4,6,2,0,2,2,1,0,1,-1,4,3,-1,1,0,0,-4,-10,-1,-1,2,0,0,-2,-1,-1,-1,1,2,-1
KR_6737381875,420,-1,-77,-21,-3,0,1,1,-2,3,1,-2,2,0,0,2,2,1,0,1,0,3,-5,3,-5,2,3,0,-1,-1,-1,-1,-1,4,-1
KR_6776140012,420,1,27,-8,-5,0,0,0,2,0,2,-6,6,0,-1,4,3,0,0,0,0,-1,26,-3,-3,6,-20,0,0,-1,-1,-1,-1,4,-1
KR_6769909076,420,-3,-65,1,-4,0,4,4,0,3,3,-3,3,0,-1,3,2,0,0,0,0,-4,-2,3,-7,4,2,0,-1,1,-1,-1,-1,5,-1
KR_6776415624,420,-1,-79,19,-2,6,0,6,-6,7,1,-1,1,0,-2,5,3,1,0,1,0,1,-5,0,-4,4,-7,0,-2,-1,-1,-1,-1,4,-1
KR_6706558453,440,-1,12,8,-4,3,2,5,-5,6,1,0,1,1,-3,5,2,1,0,1,0,-11,2,-3,-3,6,4,0,0,-1,1,1,-1,4,-1
KR_6777107192,420,0,-35,-29,4,1,1,2,-4,5,1,1,2,3,6,1,7,0,1,1,0,11,141,2,-7,5,6,0,0,1,-1,0,1,6,-1
KR_6777240641,420,-2,-76,28,-8,0,3,3,-1,2,1,2,2,4,-9,12,3,0,1,1,0,-13,-5,-3,-6,9,-1,0,0,1,1,-1,1,5,-1
KR_6764926020,420,1,2,24,5,1,0,1,2,1,3,-2,6,4,3,1,4,1,1,2,0,7,33,6,-11,5,-4,0,0,-1,1,0,1,6,-1
KR_6771893346,420,-4,-2,-14,-9,2,1,3,-3,4,1,-3,3,0,-2,3,1,-3,3,0,0,-13,-21,0,-7,7,0,0,-1,0,-1,-1,1,0,-1
KR_6756035302,420,-1,-76,20,-9,-3,3,0,0,6,6,-5,6,1,-1,3,2,0,1,1,0,-6,-14,-3,-3,6,14,0,-1,-1,1,-1,-1,3,-1
KR_6776753112,420,-2,-10,-16,0,-1,2,1,-5,5,0,2,3,5,4,3,7,0,1,1,0,0,-200,1,-8,7,-5,0,0,-1,-1,0,-1,6,-1
KR_6767635221,420,-2,-54,-18,-5,-2,2,0,3,2,5,-2,3,1,-4,5,1,0,0,0,0,-4,-5,-4,-4,8,8,0,0,-1,-1,0,-1,2,-1
KR_6777291538,420,0,32,-8,2,2,0,2,-1,4,3,1,1,2,0,2,2,0,0,0,0,1,0,1,-6,5,3,0,1,-1,1,1,1,5,-1
KR_6743432661,420,0,-21,0,4,2,1,3,5,3,8,2,1,3,-2,4,2,-3,3,0,0,2,-137,-3,-5,8,6,0,0,-1,1,1,1,4,-1
KR_6756024669,420,-2,-97,14,-10,0,0,0,0,2,2,-8,11,3,-1,2,1,-1,1,0,0,6,-7,-1,-3,4,-6,0,-2,1,-1,-1,-1,6,-1
KR_6729016282,420,-3,-35,-26,-8,1,3,4,-7,8,1,1,1,2,1,6,7,-4,5,1,1,-11,1,-2,-9,11,-5,0,0,-1,-1,-1,1,6,-1
KR_6767889536,420,0,35,-3,-6,0,1,1,-2,5,3,0,1,1,-3,6,3,-1,3,2,0,-5,4,-2,-5,7,0,0,-1,-1,1,-1,-1,6,-1
KR_6758514549,420,0,-13,-6,-7,4,0,4,-4,4,0,-2,4,2,-3,4,1,-2,2,0,0,-10,-3,1,-6,5,-4,0,-1,-1,-1,-1,-1,2,-1
KR_6702253084,420,-4,-96,0,-12,-1,1,0,-3,4,1,-1,1,0,-4,5,1,-3,3,0,0,-8,-9,0,-7,7,0,0,-3,-1,-1,-1,-1,3,-1
KR_6776215551,420,0,-50,-4,3,2,1,3,1,2,3,0,2,2,-2,4,2,2,0,2,0,2,-4,-2,-7,9,3,0,1,1,1,1,1,1,-1
KR_6730454280,420,1,43,2,-2,-1,2,1,-1,3,2,-2,3,1,4,0,4,-2,3,1,0,0,-129,-3,-6,9,-5,0,0,-1,-1,0,-1,5,-1
KR_6766850668,420,-1,-20,-11,1,-3,3,0,-1,4,3,2,0,2,4,2,6,-1,1,0,0,6,6,-1,-5,6,-4,0,0,1,-1,-1,-1,3,-1
KR_6751301934,440,0,-17,-6,-2,1,2,3,4,0,4,-3,4,1,-1,3,2,-3,3,0,0,-2,5,0,-4,4,-3,0,-2,1,1,-1,1,2,-1
KR_6773918381,420,0,-6,2,-7,2,2,4,-5,7,2,-6,8,2,0,2,2,2,0,2,-1,-16,-2,3,-8,5,-6,0,0,-1,1,0,-1,5,-1
KR_6730432434,420,1,30,16,2,2,1,3,-4,5,1,0,1,1,2,2,4,2,0,2,2,1,-24,0,-6,6,-2,0,-2,-1,-1,-1,1,3,-1
KR_6774383779,420,-2,-1,24,-6,-3,3,0,-1,3,2,1,2,3,-1,2,1,-2,2,0,0,-8,-10,3,-9,6,2,0,1,1,1,1,-1,3,-1
KR_6736487556,420,-3,-27,-4,2,-3,3,0,1,3,4,1,1,2,3,2,5,0,1,1,1,10,5,1,-7,6,2,0,-2,1,-1,-1,1,5,-1
KR_6776467192,420,-5,-30,-11,-14,-2,4,2,-5,6,1,-2,4,2,-3,4,1,-2,2,0,0,-23,-2,-1,-6,7,-5,0,-2,-1,-1,-1,-1,3,-1
KR_6749207127,440,-1,80,-14,-5,-1,3,2,-1,2,1,3,1,4,-1,4,3,-5,5,0,0,-9,10,1,-7,6,4,0,0,-1,-1,-1,-1,6,-1
KR_6765683843,420,0,6,-24,-7,0,2,2,-2,2,0,-4,6,2,-1,4,3,0,0,0,0,-8,4,4,-9,5,-1,0,0,1,-1,0,-1,3,-1
KR_6774698910,420,0,-35,-26,1,-1,3,2,-5,10,5,0,1,1,2,2,4,5,0,5,-1,0,-34,3,-9,6,3,0,-1,1,-1,-1,-1,4,-1
KR_6775556138,420,0,-25,24,-6,-2,5,3,-4,5,1,-2,6,4,0,2,2,2,0,2,0,-4,0,-3,-7,10,0,0,0,1,-1,-1,1,1,-1
KR_6760926377,420,-4,18,-13,-3,1,1,2,-2,3,1,0,2,2,1,1,2,-3,5,2,0,-8,4,2,-6,4,-2,0,0,-1,1,0,1,6,-1
KR_6670842955,420,-3,-31,-41,-8,7,1,8,-5,6,1,-3,7,4,-8,8,0,1,3,4,-1,-9,-10,-2,-5,7,0,0,-3,-1,-1,-1,-1,5,-1
KR_6765709704,420,-3,-71,-27,2,-3,4,1,4,2,6,-4,5,1,5,1,6,0,2,2,0,9,-7,-2,-5,7,-4,0,-1,1,-1,-1,-1,6,-1
KR_6771579716,420,-4,-6,-20,-14,-4,5,1,2,2,4,0,2,2,-2,3,1,-10,12,2,0,-10,-18,4,-8,4,-4,0,-1,-1,-1,-1,-1,3,-1
KR_6730121194,420,-5,-54,27,-13,0,2,2,-3,6,3,-7,9,2,-3,4,1,0,0,0,0,-20,-76,-5,-6,11,-6,0,-1,1,1,-1,-1,6,-1
KR_6776238542,420,-5,-50,-41,-15,0,2,2,-13,14,1,1,4,5,-1,2,1,-2,2,0,0,-20,-7,-5,-5,10,7,0,-1,-1,1,-1,-1,3,-1
KR_6774842264,420,3,-3,-13,3,1,1,2,5,1,6,-3,4,1,-1,7,6,1,1,2,0,4,-14,3,-8,5,1,0,1,1,-1,-1,1,2,-1
KR_6777455716,420,2,13,18,-3,-1,2,1,2,5,7,-7,9,2,1,0,1,2,0,2,0,7,-9,1,-4,3,-2,0,-1,-1,-1,-1,-1,4,-1
KR_6767658158,420,2,80,-3,-4,1,2,3,-1,2,1,-8,10,2,1,3,4,3,0,3,0,2,-22,1,-6,5,1,0,0,1,-1,-1,-1,1,-1
KR_6771413835,420,3,8,8,11,2,1,3,4,0,4,1,1,2,0,2,2,4,0,4,0,13,30,4,-5,1,4,0,1,1,1,-1,-1,4,-1
KR_6750483705,420,2,-19,19,5,0,1,1,1,1,2,5,1,6,-2,4,2,1,1,2,0,10,8,0,-7,7,4,0,2,1,1,1,1,5,-1
KR_6768333720,440,-3,-63,13,-6,-5,6,1,4,1,5,0,4,4,-2,5,3,-3,3,0,0,-4,-50,1,-4,3,10,0,-1,1,1,-1,1,1,-1
KR_6745884041,420,-3,0,-15,-4,-3,4,1,-8,8,0,2,2,4,5,4,9,0,1,1,0,-5,12,7,-10,3,1,0,1,-1,-1,1,1,6,-1
KR_6771796901,420,0,25,-32,2,0,1,1,-1,3,2,3,1,4,0,6,6,0,1,1,0,6,2,2,-7,5,8,0,1,-1,1,1,-1,6,-1
KR_6776194054,420,-2,-24,-8,-5,0,2,2,-3,5,2,-2,3,1,-2,3,1,2,0,2,1,-13,11,3,-8,5,-4,0,1,1,1,1,1,5,-1
KR_6774283969,420,0,70,-3,-8,-1,1,0,-5,7,2,-2,2,0,0,1,1,0,0,0,0,-17,-101,-3,-4,7,5,0,1,1,1,1,-1,6,-1
KR_6774657161,420,-1,-6,-22,-8,-7,9,2,-7,7,0,3,2,5,1,1,2,2,0,2,0,-5,-7,3,-10,7,2,0,-3,1,-1,-1,1,2,-1
KR_6777151109,420,-1,-32,-7,-1,0,2,2,3,0,3,2,0,2,-5,7,2,-1,2,1,-1,2,422,1,-6,5,1,0,0,-1,-1,0,-1,3,-1
KR_6742280493,420,-3,-5,-28,-6,-2,6,4,1,1,2,-2,2,0,-4,4,0,1,0,1,1,-5,-21,-1,-5,6,4,0,0,-1,-1,-1,1,3,-1
KR_6737200698,440,2,6,14,2,2,0,2,2,0,2,-5,6,1,0,1,1,3,0,3,-1,5,-119,-1,-6,7,-4,0,-1,1,-1,-1,-1,6,-1
KR_6776814294,420,-3,-71,-7,1,2,0,2,-1,3,2,1,3,4,-3,5,2,2,0,2,1,5,7,-2,-8,10,-4,0,-1,1,1,-1,1,4,-1
KR_6743676545,420,1,-52,45,-4,0,2,2,4,0,4,-4,5,1,-5,6,1,1,0,1,-1,-7,-15,1,-7,6,-1,0,-1,-1,-1,-1,-1,3,-1
KR_6775473109,420,-6,-109,12,-13,-2,3,1,-2,2,0,-4,5,1,-3,4,1,-2,2,0,0,-18,5,1,-3,2,-6,0,-2,-1,1,-1,-1,2,-1
KR_6774620181,420,0,26,-20,2,-1,1,0,4,2,6,-5,5,0,4,0,4,0,2,2,0,7,7,-6,-2,8,1,0,0,-1,-1,0,1,4,-1
KR_6756487312,440,-8,-33,-18,-15,-8,9,1,2,1,3,1,5,6,-6,7,1,-4,4,0,0,-15,2,5,-5,0,-4,0,-2,-1,-1,-1,-1,6,-1
KR_6770808933,420,-2,-86,-4,2,-3,7,4,3,2,5,4,1,5,0,1,1,-2,2,0,1,12,59,6,-9,3,-6,0,0,1,-1,-1,1,1,-1
KR_6769666923,420,-1,27,-56,4,-2,4,2,3,1,4,4,1,5,-1,1,0,0,0,0,0,4,0,2,-6,4,-5,0,-1,-1,-1,-1,1,2,-1
KR_6775866965,420,-3,12,-20,-10,0,1,1,-8,9,1,-4,4,0,1,0,1,1,0,1,0,-16,-4,-5,-2,7,-7,0,0,-1,-1,0,-1,3,-1
KR_6771742100,420,-4,-36,-3,-1,-5,6,1,2,4,6,4,1,5,-1,2,1,-1,2,1,0,2,-12,-4,-4,8,3,0,-1,1,-1,-1,1,4,-1
KR_6742092857,440,-3,-36,8,-7,0,2,2,-1,2,1,-4,4,0,-3,6,3,1,0,1,1,-2,4,-4,-4,8,-1,0,0,1,1,0,1,4,-1
KR_6770488642,420,-4,-67,-3,-6,0,2,2,-3,5,2,-4,4,0,-1,5,4,2,1,3,0,-7,-14,-6,-2,8,4,0,-1,-1,1,-1,1,1,-1
KR_6776486345,420,1,-17,2,5,6,0,6,0,6,6,0,4,4,0,3,3,-1,1,0,-1,-5,-11,5,-8,3,3,0,1,1,1,1,-1,4,-1
KR_6772856632,420,1,88,32,-9,-2,2,0,2,0,2,-5,7,2,-2,2,0,-2,3,1,0,-7,-21,-4,-4,8,0,0,0,-1,-1,-1,-1,2,-1
KR_6776934826,420,-1,-46,-21,-8,-1,3,2,-4,6,2,-3,4,1,0,2,2,0,1,1,0,-10,12,-7,-3,10,5,0,-1,-1,-1,-1,-1,1,-1
KR_6774123658,420,-6,-40,-3,-11,0,1,1,1,2,3,0,3,3,-12,12,0,0,0,0,1,-9,-14,1,-6,5,0,0,0,-1,1,1,-1,2,-1
KR_6731885549,420,0,-13,15,2,2,2,4,-3,4,1,-2,2,0,1,2,3,4,1,5,0,10,16,-2,-6,8,-3,0,1,1,1,1,1,1,-1
KR_6771197270,420,-3,-49,7,-15,-6,6,0,-2,3,1,-4,5,1,-3,3,0,0,0,0,0,-20,43,-3,-7,10,-2,0,-2,-1,-1,-1,-1,4,-1
KR_6759108215,420,-4,-73,19,-5,-3,4,1,-1,2,1,0,3,3,-2,5,3,1,1,2,0,-8,3,-1,-3,4,-5,0,0,1,1,0,-1,1,-1
KR_6750745595,420,-2,-32,26,-6,2,0,2,-1,3,2,-2,2,0,-5,5,0,0,1,1,0,-15,-1,-8,-5,13,4,0,0,-1,-1,-1,-1,4,-1
KR_6775647819,420,2,-19,11,-2,1,1,2,1,3,4,-4,4,0,1,2,3,-1,2,1,0,-1,3,0,-8,8,-6,0,0,-1,1,0,-1,3,-1
KR_6763837271,420,0,29,-19,-7,0,1,1,-6,7,1,-2,4,2,0,1,1,1,1,2,0,-3,12,-3,-3,6,-2,0,-2,1,-1,-1,-1,2,-1
KR_6772488707,420,-2,7,1,-2,-2,3,1,7,3,10,-3,5,2,-2,2,0,-2,3,1,0,-11,4,3,-6,3,-4,0,0,-1,1,1,-1,5,-1
KR_6772428854,420,2,48,15,-2,-1,1,0,1,1,2,3,0,3,-3,6,3,-2,2,0,0,-6,107,-1,-7,8,1,0,-1,0,1,-1,1,0,-1
KR_6726983819,440,-2,-66,1,-4,3,1,4,-2,3,1,-5,7,2,0,3,3,0,1,1,0,-7,8,1,-8,7,-4,0,0,-1,1,0,1,1,-1
KR_6777430706,420,-1,-33,27,-10,-2,2,0,-2,3,1,1,2,3,-6,6,0,-1,2,1,0,-11,-74,-3,-3,6,-5,0,0,1,1,1,-1,6,-1
KR_6709248213,420,-8,-56,-17,-17,-6,7,1,-6,7,1,-3,3,0,-2,5,3,0,3,3,0,-8,-22,-7,-3,10,8,0,-2,-1,-1,-1,-1,4,-1
KR_6771757103,420,0,-59,-4,-5,-4,4,0,4,2,6,0,3,3,-3,4,1,-2,3,1,0,-3,17,-13,-1,14,-2,0,-2,-1,-1,-1,-1,5,-1
KR_6761301832,420,-2,6,-24,-4,0,0,0,-1,1,0,1,1,2,-5,8,3,1,0,1,0,-1,7,-1,-6,7,3,0,2,-1,1,1,-1,3,-1
KR_6765027877,420,1,1,-3,1,3,2,5,-3,5,2,1,0,1,0,0,0,0,0,0,0,-2,10,0,-7,7,0,0,1,1,1,1,-1,6,-1
KR_6776758868,420,-3,-57,2,-5,-1,1,0,-3,3,0,1,1,2,-2,2,0,0,0,0,0,-7,-52,-4,-5,9,1,0,-1,-1,-1,-1,-1,3,-1
KR_6742432506,420,-5,-58,0,-8,-2,5,3,-3,4,1,-5,7,2,-1,6,5,3,0,3,0,-10,-44,-6,-2,8,7,0,-3,-1,-1,-1,1,4,-1
KR_6738498427,440,-4,-70,18,-10,-4,4,0,2,2,4,-9,9,0,3,1,4,-2,2,0,0,-2,5,-1,-4,5,-7,0,-2,-1,-1,-1,-1,6,-1
KR_6741568139,440,-3,-88,-39,-8,-2,2,0,-2,3,1,-1,4,3,0,4,4,-3,5,2,2,-8,3,1,-4,3,0,0,-2,-1,-1,-1,1,4,-1
KR_6771151007,420,-3,31,7,-2,-2,6,4,2,0,2,-1,2,1,-1,1,0,0,1,1,0,-9,10,9,-15,6,-3,0,0,1,-1,0,1,5,-1
KR_6773337936,420,-1,-18,-8,-1,4,0,4,1,3,4,-3,4,1,-3,3,0,0,0,0,0,-3,-34,-1,-5,6,-1,0,-1,-1,-1,-1,1,1,-1
KR_6723246105,420,-2,51,-15,-5,0,1,1,2,4,6,-2,5,3,-6,7,1,1,0,1,0,-9,-15,1,-10,9,2,0,0,-1,-1,-1,1,5,-1
KR_6775240293,420,-2,5,-19,-1,0,2,2,0,1,1,0,2,2,-2,3,1,1,1,2,0,-6,9,2,-8,6,0,0,1,-1,1,1,1,5,-1
KR_6757360638,420,-2,2,-20,0,-1,1,0,-1,3,2,-2,3,1,3,1,4,1,0,1,0,4,0,-3,-4,7,1,0,0,-1,-1,-1,-1,3,-1
KR_6738405034,420,0,-18,0,2,3,2,5,1,0,1,-1,3,2,0,4,4,-1,1,0,0,3,3,3,-10,7,-4,0,0,-1,-1,-1,1,3,-1
KR_6748156492,420,0,-8,-3,0,0,2,2,0,2,2,0,3,3,0,4,4,0,2,2,-1,-7,-8,-4,-1,5,9,0,0,-1,1,1,-1,5,-1
KR_6756666018,440,0,18,-8,4,-1,4,3,3,0,3,-3,3,0,1,1,2,4,0,4,0,11,0,-1,-4,5,-2,0,-1,1,-1,-1,-1,4,-1
KR_6725194985,420,-3,-66,0,-5,-4,4,0,0,5,5,3,3,6,-3,5,2,-1,1,0,0,3,-11,-6,-2,8,3,0,-1,1,-1,-1,-1,4,-1
KR_6709508260,420,-5,-118,-33,-14,-5,5,0,-1,4,3,-6,7,1,-1,3,2,-1,2,1,-1,-14,-4,-3,-3,6,1,0,-4,-1,-1,-1,-1,5,-1
KR_6777517123,420,-3,-26,-16,-10,-3,6,3,-3,3,0,2,6,8,-1,6,5,-5,5,0,0,-3,3,-2,-7,9,-2,0,-1,1,-1,-1,-1,6,-1
KR_6742480791,440,1,19,-44,0,3,1,4,-5,5,0,-5,6,1,6,3,9,1,0,1,0,-13,-11,0,-4,4,0,0,0,-1,0,-1,1,4,-1
KR_6723453205,420,0,-21,-32,10,6,1,7,1,5,6,3,4,7,-1,6,5,1,0,1,0,3,19,1,-8,7,2,0,1,-1,1,1,1,2,-1
KR_6763674523,420,-4,-56,-28,-11,-2,2,0,-2,2,0,-4,4,0,-1,2,1,-2,2,0,-1,-11,1,-1,-3,4,-6,0,-1,-1,-1,-1,-1,5,-1
KR_6774141201,420,-3,-39,4,-10,-2,2,0,-3,7,4,-3,5,2,-2,2,0,0,0,0,0,-5,-115,-5,-6,11,2,0,-3,-1,-1,-1,-1,1,-1
KR_6777162526,420,-1,-9,-8,-5,1,4,5,-5,7,2,1,0,1,-2,2,0,0,0,0,0,-16,-3,-2,-4,6,1,0,-1,-1,-1,-1,1,6,-1
KR_6773706915,420,-2,-17,-5,-9,-3,3,0,-3,5,2,-3,5,2,1,0,1,-1,2,1,-1,-22,10,-2,-6,8,-1,0,0,-1,1,-1,-1,1,-1
KR_6763017980,420,-1,13,4,-4,-2,3,1,-2,2,0,0,2,2,0,1,1,0,0,0,0,-12,5,-1,-7,8,-3,0,0,-1,-1,0,1,2,-1
KR_6743677146,420,-4,-43,-28,-11,-5,7,2,3,2,5,-2,3,1,-9,9,0,2,0,2,0,-13,-7,-5,-2,7,2,0,-1,-1,-1,-1,-1,3,-1
KR_6767308491,420,-3,0,-22,-4,-1,1,0,-2,6,4,-3,6,3,1,3,4,1,2,3,-1,-5,-4,2,-5,3,-5,0,-2,-1,-1,-1,-1,4,-1
KR_6772723916,440,-4,-88,-20,-1,-6,6,0,-1,4,3,3,3,6,1,1,2,2,0,2,0,3,-12,-2,-3,5,-4,0,-3,1,-1,-1,1,2,-1
KR_6777056353,420,-6,-49,-14,-13,-2,2,0,-3,4,1,-2,5,3,-2,2,0,-4,4,0,0,-14,14,-5,-5,10,-5,0,-1,-1,1,-1,-1,3,-1
KR_6699874127,420,0,25,-3,-4,2,1,3,-3,4,1,-1,1,0,0,6,6,-2,3,1,0,-7,5,7,-10,3,-10,0,-1,-1,-1,1,-1,1,-1
KR_6754589800,420,-4,-61,-36,-3,-1,2,1,0,3,3,-4,6,2,2,0,2,0,0,0,0,2,44,2,-4,2,-4,0,1,-1,1,1,1,5,-1
KR_6771751812,440,0,55,-5,1,4,1,5,1,2,3,-1,4,3,0,1,1,-3,4,1,0,-6,9,9,-10,1,-7,0,1,1,-1,1,1,3,-1
KR_6756558093,420,0,17,-32,-2,2,0,2,0,4,4,0,1,1,-4,5,1,0,0,0,0,-4,2,-2,-7,9,8,0,-1,-1,1,-1,1,3,-1
KR_6774210289,420,1,1,-26,1,-2,5,3,1,5,6,1,0,1,1,2,3,0,1,1,1,7,-8,3,-4,1,2,0,2,-1,1,1,1,1,-1
KR_6770491209,420,-2,30,4,-3,0,2,2,-1,6,5,3,0,3,-4,6,2,-1,1,0,0,-9,-5,-4,-6,10,6,0,0,1,-1,0,-1,6,-1
KR_6777309984,420,-5,-12,-20,-15,1,1,2,-8,9,1,-6,6,0,-1,8,7,-1,1,0,0,-12,-10,-4,-5,9,0,0,-2,-1,-1,-1,-1,1,-1
KR_6732238201,420,-2,-48,-5,-8,-1,1,0,-9,10,1,0,1,1,0,1,1,2,1,3,0,-13,-6,0,-9,9,-4,0,0,-1,1,0,-1,2,-1
KR_6751407126,420,-4,-73,13,-10,3,2,5,-5,6,1,-3,3,0,-1,7,6,-4,4,0,1,-19,41,3,-6,3,-26,0,-2,-1,0,-1,1,3,-1
KR_6731699022,420,-4,9,9,-7,2,2,4,-3,9,6,0,5,5,-1,3,2,-5,5,0,-1,-13,2,1,-5,4,-3,0,1,-1,0,1,-1,5,-1
KR_6719902479,420,-4,-82,8,-10,-4,8,4,3,0,3,-5,6,1,-6,6,0,2,1,3,1,-14,8,-1,-4,5,1,0,-4,-1,-1,-1,1,4,-1
KR_6777431915,420,2,-19,-4,0,1,4,5,-1,6,5,3,6,9,-6,9,3,3,2,5,1,-5,-1,-3,-6,9,3,0,-2,-1,-1,-1,1,1,-1
KR_6753714729,420,-4,19,-26,-1,-1,2,1,0,4,4,0,2,2,0,0,0,0,0,0,1,-9,-11,1,-4,3,-2,0,0,-1,1,0,1,2,-1
KR_6766078254,420,-4,-11,11,-9,-2,3,1,-2,6,4,-3,7,4,-1,2,1,-1,3,2,0,-6,8,3,-6,3,-4,0,-1,-1,1,-1,-1,4,-1
KR_6775194908,420,0,-23,22,-3,-3,3,0,2,1,3,0,1,1,-2,3,1,0,0,0,0,-3,1,-3,-6,9,-4,0,0,-1,-1,0,1,4,-1
KR_6777057372,420,-2,-52,-20,-1,-2,4,2,-2,4,2,1,2,3,2,2,4,0,1,1,1,-3,-31,5,-9,4,-1,0,-1,-1,1,-1,1,2,-1
KR_6763361663,420,-1,14,7,-10,-1,3,2,-2,5,3,-3,3,0,-1,1,0,-3,4,1,0,-5,-8,-3,-2,5,3,0,-1,-1,1,-1,-1,4,-1
KR_6776317957,420,-3,19,16,-6,-2,5,3,-4,4,0,5,1,6,-2,2,0,-3,3,0,0,-15,-41,-8,-4,12,0,0,0,-1,1,0,1,2,-1
KR_6776279712,420,-2,0,6,-8,-3,4,1,-2,2,0,0,1,1,-2,6,4,-1,1,0,-1,-14,4,7,-12,5,3,0,0,-1,-1,0,-1,5,-1
KR_6775919371,420,-4,-26,-9,-3,-4,5,1,2,0,2,2,0,2,-3,3,0,0,0,0,0,3,-8,1,-9,8,-3,0,-1,1,-1,-1,-1,6,-1
KR_6753177431,420,1,-11,-10,6,-1,1,0,7,1,8,0,3,3,-1,8,7,1,0,1,2,16,8,-3,-8,11,-2,0,-1,-1,-1,-1,1,3,-1
KR_6772380602,420,1,25,3,5,1,2,3,-2,5,3,1,0,1,1,2,3,4,1,5,1,3,5,-2,-2,4,3,0,0,1,1,0,1,5,-1
KR_6756215071,420,2,40,-7,4,5,0,5,-1,4,3,-3,3,0,2,0,2,1,1,2,0,4,39,2,-5,3,-2,0,1,-1,1,1,1,1,-1
KR_6749317491,420,0,-12,8,-5,0,0,0,0,2,2,-6,8,2,1,0,1,0,0,0,0,-5,10,3,-7,4,-4,0,0,-1,1,-1,1,4,-1
KR_6772659058,420,0,9,-29,0,-3,4,1,0,3,3,1,2,3,3,1,4,-1,2,1,0,7,129,1,-4,3,3,0,0,-1,1,0,1,4,-1
KR_6739219648,420,-5,-34,-18,-8,0,2,2,1,3,4,-2,4,2,-4,4,0,-3,4,1,0,-3,-16,-1,-4,5,-5,0,0,-1,1,1,1,2,-1
KR_6762556259,420,-3,-12,-30,-12,-2,3,1,-2,5,3,-1,2,1,-4,4,0,-3,3,0,0,-8,-8,5,-9,4,5,0,-1,1,-1,-1,1,2,-1
KR_6762350486,420,-5,-56,-15,-12,-1,1,0,-4,5,1,-3,4,1,-2,2,0,-2,2,0,0,-12,-5,-4,-3,7,-1,0,-2,-1,-1,-1,-1,4,-1
KR_6749477086,440,-9,-89,-33,-19,-3,4,1,-5,5,0,-7,7,0,-6,7,1,2,0,2,0,-10,0,4,-7,3,-2,0,-2,-1,-1,-1,1,3,-1
KR_6757738040,420,0,-27,23,-5,2,2,4,-2,4,2,-4,5,1,-1,4,3,0,2,2,0,-8,-9,-3,-7,10,-5,0,0,-1,1,-1,1,1,-1
KR_6755259604,420,-1,-10,0,-5,-1,3,2,-3,5,2,-1,1,0,0,1,1,0,2,2,0,-6,-13,1,-10,9,-3,0,0,-1,1,0,-1,5,-1
KR_6725124803,420,3,-20,32,7,1,0,1,-6,8,2,-2,4,2,12,0,12,2,1,3,0,14,11,-1,-5,6,3,0,1,-1,-1,1,1,1,-1
KR_6775418444,420,2,-6,18,2,3,1,4,3,2,5,0,1,1,-5,6,1,1,1,2,2,7,-6,-1,-4,5,5,0,-1,1,-1,-1,1,5,-1
KR_6738448107,420,-1,-45,6,-1,3,1,4,0,2,2,-2,2,0,1,4,5,-3,3,0,0,0,-3,5,-10,5,-5,0,-1,1,-1,-1,-1,4,-1
KR_6746095131,420,0,-8,-20,-10,2,0,2,-8,9,1,-2,2,0,-2,4,2,0,0,0,0,-13,-11,-8,-1,9,0,0,0,-1,-1,1,1,5,-1
KR_6759661505,420,-1,-35,-34,-1,-2,3,1,-3,3,0,0,1,1,2,2,4,2,1,3,0,1,-18,3,-9,6,-7,0,1,1,1,1,-1,6,-1
KR_6777749633,420,-2,-78,-20,-3,3,0,3,0,4,4,-6,6,0,2,1,3,-2,2,0,1,-7,119,2,-7,5,-2,0,0,1,-1,1,1,3,-1
KR_6777648439,420,3,-8,20,10,2,0,2,3,4,7,7,1,8,-1,3,2,-1,1,0,0,16,45,2,-3,1,10,0,0,-1,1,1,-1,4,-1
KR_6774392323,420,-2,22,-13,-2,-3,3,0,-3,3,0,0,0,0,6,0,6,-2,2,0,0,0,25,7,-12,5,-6,0,-1,-1,-1,-1,1,5,-1
KR_6777207124,420,-1,-45,4,1,-1,2,1,1,2,3,-3,3,0,2,1,3,2,0,2,0,6,2,0,-6,6,-3,0,0,1,1,0,-1,5,-1
KR_6770359769,420,-6,-68,-11,-17,-5,6,1,-4,5,1,-6,6,0,-1,4,3,-1,1,0,-1,-24,1,0,-6,6,-9,0,-1,-1,1,-1,-1,5,-1
KR_6770455342,420,-3,0,-12,-10,0,2,2,-9,10,1,3,1,4,-1,4,3,-3,3,0,-3,-19,-25,2,-9,7,-2,0,-1,1,1,-1,-1,2,-1
KR_6777741977,420,1,39,15,-4,-2,2,0,1,2,3,-2,4,2,-3,4,1,2,0,2,0,-5,5,0,-5,5,-6,0,0,-1,-1,-1,-1,5,-1
KR_6770612008,420,-7,-83,-12,-18,-2,3,1,-8,10,2,-5,6,1,1,1,2,-4,4,0,0,-20,-41,-2,-6,8,-1,0,-2,-1,-1,-1,1,4,-1
KR_6750676549,420,-1,27,-16,-5,0,1,1,1,1,2,2,0,2,-9,9,0,1,1,2,0,-7,-119,-9,-2,11,5,0,-2,-1,-1,-1,1,3,-1
KR_6740086455,420,-4,-57,-8,-12,-1,3,2,2,3,5,-3,6,3,-7,8,1,-3,4,1,0,-15,-17,2,-5,3,-2,0,-2,-1,-1,-1,-1,4,-1
KR_6747720934,420,-4,3,19,-14,-5,8,3,-6,8,2,-4,6,2,2,2,4,-1,1,0,1,-10,30,1,-6,5,-6,0,1,-1,1,1,1,1,-1
KR_6754506719,420,-5,-84,-26,-13,-3,4,1,-3,9,6,-1,2,1,-7,7,0,1,0,1,0,-6,-162,-2,-3,5,-4,0,-1,-1,1,-1,1,3,-1
KR_6772116918,440,2,-35,0,8,4,1,5,2,2,4,0,0,0,2,0,2,0,3,3,0,15,-2,2,-6,4,3,0,0,1,-1,-1,1,6,-1
KR_6774107514,420,-4,-17,-28,-15,0,2,2,-9,10,1,1,1,2,-5,5,0,-2,3,1,-1,-27,-21,-4,-8,12,7,0,0,-1,1,-1,-1,3,-1
KR_6772807115,420,-2,25,-25,0,0,1,1,-1,4,3,0,1,1,2,1,3,-1,1,0,0,-7,-28,-4,-6,10,8,0,0,-1,-1,-1,-1,3,-1
KR_6766968012,420,2,9,-15,2,0,1,1,3,1,4,-3,5,2,1,0,1,1,0,1,0,5,-18,0,-6,6,-1,0,-1,-1,-1,-1,-1,3,-1
KR_6759178453,420,-5,-65,-11,-9,-6,6,0,6,0,6,-3,4,1,-6,6,0,0,1,1,0,-6,8,-5,-3,8,-2,0,-2,-1,-1,-1,-1,2,-1
KR_6772395404,420,2,23,19,-1,-1,1,0,1,1,2,-2,3,1,1,2,3,0,1,1,0,-3,-124,0,-9,9,2,0,1,1,1,1,-1,3,-1
KR_6747953344,420,-2,-23,7,-7,0,2,2,-1,2,1,-6,6,0,0,5,5,0,1,1,-2,-11,-3,-10,-4,14,0,0,-2,-1,1,-1,-1,5,-1
KR_6770685145,420,-1,-39,19,-2,1,3,4,0,4,4,1,0,1,-5,7,2,1,0,1,1,-11,-2,-4,-6,10,0,0,0,-1,-1,0,1,2,-1
KR_6772289955,420,0,26,12,-2,-4,4,0,1,3,4,1,2,3,-1,2,1,1,0,1,0,1,15,5,-11,6,-4,0,0,1,-1,0,-1,1,-1
KR_6777290558,420,-2,-18,-7,-2,0,3,3,-1,3,2,-1,2,1,-1,3,2,1,0,1,0,-5,3,1,-5,4,-7,0,-1,-1,1,-1,-1,5,-1
KR_6761415445,420,0,11,-19,-2,1,5,6,0,3,3,-4,8,4,4,3,7,-3,3,0,0,-8,-4,0,-7,7,-5,0,0,-1,1,1,1,5,-1
KR_6748575746,420,-6,-87,-1,-14,-5,5,0,-1,3,2,-7,10,3,0,2,2,-1,2,1,0,-2,-41,-3,-3,6,21,0,-3,-1,-1,-1,-1,3,-1
KR_6768052184,420,-3,-72,-23,-9,-3,5,2,-2,4,2,1,1,2,-3,4,1,-2,4,2,0,-7,-10,-3,-3,6,9,0,0,-1,-1,-1,-1,5,-1
KR_6775601077,420,0,-36,-8,-2,1,1,2,0,3,3,-5,5,0,2,6,8,0,2,2,0,9,-11,5,-7,2,-7,0,-2,-1,-1,-1,1,3,-1
KR_6755048548,420,-2,-21,-8,-4,4,0,4,-2,4,2,0,2,2,-5,10,5,-1,2,1,0,-5,6,2,-6,4,-3,0,-1,-1,0,-1,-1,3,-1
KR_6725228959,420,-3,-30,4,-8,-4,4,0,0,4,4,0,1,1,-2,3,1,-2,2,0,0,-7,4,3,-7,4,-5,0,-2,-1,-1,-1,-1,1,-1
KR_6773751092,420,-2,-4,-6,2,2,0,2,1,1,2,0,3,3,0,0,0,-1,1,0,0,-1,-8,3,-7,4,2,0,-1,-1,1,-1,1,3,-1
KR_6767894293,440,-2,-31,-46,-7,-2,2,0,-1,1,0,-1,1,0,-1,3,2,-2,2,0,-1,-5,60,1,-5,4,-1,0,-1,-1,-1,-1,-1,4,-1
KR_6776781227,420,-1,10,-17,3,1,1,2,0,2,2,1,5,6,2,2,4,-1,1,0,0,10,17,0,-4,4,-8,0,-2,-1,-1,-1,-1,2,-1
KR_6773377833,420,1,49,-31,-8,3,0,3,-5,6,1,0,1,1,-4,8,4,-2,2,0,0,-15,-72,2,-9,7,2,0,-2,-1,1,-1,-1,1,-1
KR_6775283559,420,0,56,16,4,1,2,3,2,1,3,-1,2,1,2,2,4,0,0,0,0,4,5,1,-7,6,0,0,0,1,-1,0,1,5,-1
KR_6753532216,420,-5,-50,-11,-18,-5,5,0,-8,9,1,-2,2,0,-3,6,3,0,2,2,0,-34,9,-7,-2,9,-2,0,-3,-1,-1,-1,-1,5,-1
KR_6691978783,420,2,42,17,-5,-3,4,1,2,3,5,-1,2,1,0,1,1,-3,6,3,0,-5,-8,-1,-5,6,1,0,0,-1,-1,1,-1,6,-1
KR_6772654533,420,3,78,24,8,3,0,3,2,4,6,1,3,4,3,2,5,-1,2,1,1,7,44,1,-5,4,2,0,1,1,1,1,1,3,-1
KR_6746092951,420,3,7,-10,-4,2,0,2,-2,3,1,-2,2,0,0,1,1,-2,2,0,0,-4,-4,-2,-7,9,-2,0,0,1,-1,0,-1,4,-1
KR_6717089312,420,-1,-5,-8,-3,-1,2,1,0,2,2,1,1,2,-2,3,1,-1,1,0,0,-4,-5,-1,-5,6,-3,0,0,1,-1,0,-1,3,-1
KR_6776451725,420,1,26,-6,12,1,2,3,2,1,3,1,2,3,5,0,5,3,1,4,0,14,3,1,-7,6,1,0,0,1,1,0,1,1,-1
KR_6773754755,420,-1,-7,8,-3,4,1,5,-1,4,3,-4,7,3,-3,4,1,1,0,1,-1,-9,233,-2,-3,5,3,0,0,1,-1,0,-1,5,-1
KR_6775203420,420,-1,82,-8,-6,2,1,3,-3,3,0,-3,6,3,-3,6,3,1,0,1,-1,-4,-1,3,-9,6,-1,0,-1,1,-1,-1,-1,4,-1
KR_6745495640,420,-7,-62,-41,-13,-4,4,0,-4,5,1,-5,7,2,0,3,3,0,0,0,0,-10,2,1,-6,5,-7,0,-3,-1,-1,-1,-1,5,-1
KR_6777545930,440,0,27,8,4,2,0,2,1,3,4,3,0,3,-1,1,0,-1,2,1,0,0,9,1,-4,3,1,0,0,1,-1,-1,1,1,-1
KR_6774504315,420,0,-13,0,2,-3,3,0,7,1,8,0,1,1,-2,5,3,0,0,0,0,-1,159,9,-11,2,-5,0,0,1,1,0,1,6,-1
KR_6734609371,420,-2,-41,1,-7,-4,6,2,-1,4,3,-3,3,0,0,3,3,1,1,2,0,-6,5,-3,-4,7,-3,0,0,1,-1,-1,-1,5,-1
KR_6761835658,420,-1,-34,-15,-8,-4,4,0,-3,3,0,2,1,3,-3,3,0,0,1,1,0,-8,-5,0,-9,9,-3,0,-2,-1,-1,-1,-1,1,-1
KR_6774785127,420,4,24,17,5,-4,6,2,-1,1,0,4,2,6,2,0,2,4,0,4,0,2,-31,1,-8,7,2,0,0,1,0,1,-1,5,-1
KR_6771578396,420,-4,-50,-24,-10,-1,1,0,-2,4,2,-4,6,2,-2,2,0,-1,1,0,0,-13,-8,-4,-1,5,-2,0,-1,-1,1,-1,-1,4,-1
KR_6775736492,420,-1,-31,-4,-5,-1,3,2,2,2,4,-2,2,0,-3,5,2,-1,2,1,0,-9,-3,-5,-6,11,0,0,-1,1,1,1,-1,4,-1
KR_6777268184,420,-1,24,-12,-4,-2,5,3,2,4,6,-2,2,0,-4,5,1,2,0,2,0,0,6,2,-8,6,-2,0,-1,1,-1,-1,-1,4,-1
KR_6753644533,420,-3,-88,-25,-1,3,0,3,-3,4,1,2,3,5,-1,1,0,-2,2,0,0,-1,-111,4,-11,7,-3,0,0,-1,1,-1,-1,4,-1
KR_6774801126,420,-2,-7,-19,-1,0,1,1,-2,3,1,-5,5,0,5,0,5,1,2,3,0,-2,-278,4,-8,4,2,0,0,-1,-1,0,1,1,-1
KR_6770523254,420,-1,18,11,3,2,1,3,0,3,3,2,1,3,-1,5,4,0,1,1,0,13,-1,0,-8,8,0,0,1,0,1,-1,-1,0,-1
KR_6755911604,420,2,-43,48,-3,3,1,4,-1,2,1,-5,5,0,1,2,3,-1,1,0,0,-12,0,-1,-3,4,3,0,0,0,-1,0,-1,0,-1
KR_6706070529,420,-3,12,-7,-9,-8,9,1,2,3,5,0,4,4,0,2,2,-3,4,1,-1,-16,0,5,-10,5,-6,0,-2,1,-1,-1,-1,3,-1
KR_6769170724,420,-3,8,-38,-8,-1,2,1,-1,4,3,-2,5,3,-2,2,0,-2,2,0,0,-1,28,-5,-3,8,-1,0,-1,-1,-1,-1,-1,3,-1
KR_6775278487,420,-6,-46,1,-12,0,0,0,-7,9,2,2,0,2,-6,7,1,-1,1,0,1,-11,-5,0,-2,2,-3,0,0,1,-1,-1,1,4,-1
KR_6734854537,420,4,-2,0,5,-3,4,1,5,0,5,0,1,1,2,4,6,1,0,1,0,10,7,4,-9,5,-3,0,-1,1,-1,-1,-1,3,-1
KR_6772850921,420,-2,14,4,-5,1,1,2,-6,8,2,-1,2,1,0,1,1,1,1,2,0,-7,2,3,-9,6,-1,0,-1,-1,-1,-1,-1,4,-1
KR_6770516251,420,-3,49,11,-12,-3,3,0,-3,5,2,-3,7,4,-2,4,2,-1,1,0,0,-15,4,-4,-4,8,1,0,-2,-1,-1,-1,-1,2,-1
KR_6723522463,420,1,33,4,7,-4,5,1,3,0,3,2,2,4,7,1,8,-1,1,0,0,9,-53,2,-7,5,-3,0,0,1,-1,-1,1,1,-1
KR_6738476303,440,-4,-59,-24,-10,-3,3,0,-1,3,2,0,2,2,-4,4,0,-2,2,0,2,-9,107,4,-6,2,2,0,0,-1,-1,0,1,3,-1
KR_6765540171,440,0,55,-9,-10,1,1,2,2,1,3,-7,8,1,-7,8,1,1,0,1,0,-15,-338,-1,-2,3,-2,0,-1,1,-1,-1,-1,3,-1
KR_6761957396,420,0,21,12,2,4,0,4,-4,5,1,2,0,2,1,1,2,-1,1,0,0,-3,-19,-2,-8,10,6,0,2,-1,1,1,-1,2,-1
KR_6774647769,420,-2,-22,-1,-7,1,3,4,-4,5,1,-4,5,1,1,3,4,-1,3,2,0,-7,4,-1,-6,7,4,0,-1,1,-1,1,1,3,-1
KR_6776957247,420,-2,-8,-6,-4,-4,4,0,-2,4,2,5,1,6,2,2,4,-5,5,0,0,-8,-2,8,-11,3,-3,0,0,1,-1,-1,1,6,-1
KR_6776840734,420,3,9,18,11,-1,3,2,4,2,6,3,1,4,3,2,5,2,3,5,0,17,30,3,-7,4,2,0,1,1,1,1,1,5,-1
KR_6770507020,420,-1,-86,37,-3,-1,5,4,2,0,2,-1,3,2,-5,6,1,2,0,2,0,-10,-6,-3,-4,7,1,0,0,-1,1,0,-1,3,-1
KR_6750171021,420,3,93,-39,3,1,1,2,4,1,5,2,1,3,-3,4,1,-1,2,1,-1,-5,-25,-1,-6,7,-3,0,0,1,-1,1,-1,3,-1
KR_6777284045,420,0,44,14,-1,5,1,6,-2,4,2,2,0,2,-6,7,1,0,1,1,0,-8,-4,-4,-4,8,1,0,0,-1,-1,-1,1,3,-1
KR_6746166487,420,-1,33,-20,-1,0,4,4,-5,6,1,3,3,6,1,4,5,0,3,3,0,-7,8,-1,-6,7,-7,0,0,1,-1,1,-1,6,-1
KR_6765080330,420,1,48,-16,-6,2,1,3,-4,5,1,-3,4,1,1,3,4,-2,2,0,0,-5,16,7,-12,5,-3,0,-1,-1,-1,1,1,6,-1
KR_6776132237,420,-3,-32,8,-10,-8,8,0,0,1,1,1,1,2,-2,2,0,-1,2,1,0,-20,-6,0,-8,8,-2,0,-1,-1,-1,-1,-1,3,-1
KR_6773934317,420,-1,14,-16,-1,2,1,3,3,3,6,-1,3,2,-3,3,0,-2,2,0,-2,-1,-12,3,-8,5,-1,0,2,-1,1,1,-1,6,-1
KR_6775251659,420,-2,8,-1,-6,0,0,0,1,0,1,0,1,1,-5,5,0,-2,2,0,0,-7,1,0,-6,6,-4,0,-1,-1,1,-1,-1,4,-1
KR_6740802527,420,-4,-21,-11,-6,-2,2,0,3,2,5,-3,5,2,0,3,3,-4,5,1,0,-9,-7,4,-9,5,-9,0,0,-1,1,1,1,5,-1
KR_6772839477,420,1,31,12,-2,3,0,3,-1,2,1,-4,5,1,1,0,1,-1,1,0,0,-3,-32,4,-9,5,0,0,-1,1,-1,-1,1,3,-1
KR_6776580536,440,-3,14,-26,-1,-2,3,1,0,2,2,1,2,3,0,0,0,0,1,1,0,6,-6,-4,-2,6,0,0,-1,1,-1,-1,1,4,-1
KR_6777314997,420,-2,4,-32,1,-2,5,3,0,4,4,4,1,5,0,1,1,-1,1,0,0,-4,-11,-1,-7,8,-3,0,1,-1,1,1,-1,3,-1
KR_6776014744,420,-1,-8,-11,-3,-3,6,3,0,4,4,-2,6,4,1,6,7,1,1,2,1,-3,3,0,-7,7,-2,0,0,1,1,1,1,6,-1
KR_6776748050,420,-3,-50,-10,-3,1,1,2,2,2,4,0,1,1,-4,7,3,-2,3,1,0,-3,-4,-4,-4,8,-1,0,0,-1,1,1,-1,1,-1
KR_6765932763,420,1,-53,2,4,3,1,4,3,1,4,4,3,7,-6,6,0,0,0,0,0,6,-3,-2,-7,9,-4,0,-1,-1,1,-1,-1,6,-1
KR_6773030645,420,-2,-28,-8,-4,0,0,0,-5,5,0,-1,1,0,2,2,4,0,4,4,0,-3,-6,-2,-3,5,3,0,0,-1,1,1,1,2,-1
KR_6773161920,420,4,63,18,8,4,3,7,1,1,2,2,3,5,1,3,4,0,1,1,0,1,29,1,-6,5,-3,0,1,-1,1,1,1,5,-1
KR_6774392275,420,2,0,12,5,1,2,3,0,6,6,0,1,1,1,3,4,3,1,4,0,6,6,0,-4,4,-1,0,-1,1,-1,-1,-1,1,-1
KR_6773727930,420,-1,-12,19,1,2,1,3,-2,5,3,0,2,2,2,1,3,-1,2,1,0,-7,8,-3,-2,5,0,0,-1,-1,-1,-1,-1,6,-1
KR_6740892516,420,-3,8,-18,-10,-1,3,2,-3,4,1,0,2,2,-6,7,1,0,2,2,0,-10,-2,2,-6,4,0,0,-1,1,1,-1,-1,5,-1
KR_6765486421,440,-2,17,-74,-2,-7,7,0,4,3,7,-1,2,1,0,4,4,2,1,3,1,2,-325,2,-5,3,-3,0,1,-1,-1,-1,1,2,-1
KR_6777450153,440,1,3,-20,1,2,1,3,-2,2,0,0,2,2,-1,7,6,2,0,2,0,0,-8,2,-6,4,1,0,0,-1,-1,-1,-1,4,-1
KR_6773870507,420,-3,-63,-1,-5,-3,4,1,-3,7,4,1,2,3,-1,3,2,1,1,2,0,3,-1,-3,-2,5,-4,0,-1,0,-1,-1,-1,0,-1
KR_6773042821,420,-3,-76,11,-14,-1,4,3,-1,5,4,0,1,1,-5,6,1,-7,7,0,0,-15,-11,-4,0,4,0,0,-4,-1,-1,-1,-1,1,-1
KR_6766960809,440,-4,-27,-22,-3,-1,2,1,5,0,5,-2,3,1,-4,7,3,-1,1,0,0,-6,1,3,-8,5,-11,0,0,1,1,1,1,3,-1
KR_6775343802,420,1,74,15,-3,-2,4,2,-1,1,0,-2,2,0,2,1,3,0,0,0,0,-3,-2,-3,-6,9,4,0,0,-1,-1,0,-1,5,-1
KR_6743589747,420,0,-5,-18,1,2,0,2,2,0,2,1,2,3,-4,4,0,0,0,0,0,-3,-4,1,-8,7,1,0,1,-1,1,1,1,5,-1
KR_6768756999,420,1,22,11,1,2,1,3,-1,2,1,-4,6,2,1,1,2,3,0,3,0,-3,-2,0,-11,11,6,0,1,1,1,1,1,2,-1
KR_6767225672,420,-1,-6,-4,-1,0,3,3,0,1,1,-2,3,1,1,2,3,0,0,0,0,0,1,1,-7,6,0,0,0,-1,0,0,-1,6,-1
KR_6758697028,420,-2,-28,-13,-7,1,0,1,-3,4,1,-5,5,0,1,1,2,-1,4,3,0,-1,31,1,-6,5,-13,0,0,-1,-1,0,1,4,-1
KR_6777663688,420,0,-53,-12,-1,1,0,1,1,2,3,1,0,1,-8,10,2,4,4,8,-3,-8,15,-2,-7,9,2,0,0,-1,1,0,-1,5,-1
KR_6766070671,420,2,-28,-4,10,3,2,5,2,1,3,5,0,5,0,2,2,0,0,0,0,12,-1,1,-5,4,2,0,0,1,1,0,1,6,-1
KR_6773933322,420,-3,-23,-33,-9,-2,2,0,-3,4,1,-1,7,6,-1,3,2,-2,2,0,-2,-23,-11,-3,-5,8,5,0,-2,-1,-1,-1,-1,4,-1
KR_6775191952,420,-2,-81,11,1,-2,2,0,1,2,3,0,2,2,-1,4,3,3,0,3,0,9,1,0,-6,6,-6,0,0,1,1,-1,-1,4,-1
KR_6756562625,440,5,40,17,1,1,2,3,-3,4,1,2,2,4,1,4,5,0,1,1,-1,-7,19,3,-7,4,-4,0,0,1,-1,1,-1,5,-1
KR_6728028602,420,1,21,1,-6,-1,5,4,3,2,5,-5,7,2,-1,2,1,-2,2,0,0,-8,-29,2,-6,4,-2,0,1,1,-1,1,1,3,-1
KR_6776519564,420,1,9,-19,5,-1,2,1,-3,5,2,5,0,5,3,2,5,1,0,1,-1,3,18,2,-7,5,0,0,-1,-1,1,-1,-1,5,-1
KR_6775303953,420,-2,8,9,6,0,2,2,2,2,4,3,2,5,-1,2,1,2,0,2,1,12,-2,0,-9,9,1,0,-1,1,1,-1,1,1,-1
KR_6709002165,420,-3,18,-11,-7,3,2,5,-5,7,2,-1,2,1,-4,5,1,0,4,4,0,-13,-63,-6,-4,10,-6,0,-1,-1,1,-1,-1,1,-1
KR_6773856104,420,-2,-57,7,-2,1,1,2,4,1,5,-2,3,1,-3,3,0,-2,2,0,0,1,-2,6,-9,3,-3,0,0,-1,1,0,-1,5,-1
KR_6739028778,420,0,-4,-12,-5,-2,4,2,-4,6,2,-1,5,4,-1,3,2,3,0,3,0,-3,95,-1,-6,7,-1,0,0,-1,1,0,-1,6,-1
KR_6767926665,420,-2,-2,-10,-4,-2,2,0,-2,4,2,0,0,0,-1,2,1,1,1,2,0,-3,-1,-2,-3,5,-1,0,-1,1,-1,-1,-1,2,-1
KR_6776432076,420,0,-42,-12,-4,2,2,4,0,2,2,-1,2,1,-4,4,0,-1,1,0,0,0,6,-3,-3,6,-1,0,-1,-1,-1,-1,-1,6,-1
KR_6774217830,420,-3,-23,-32,-4,-1,2,1,-2,5,3,-6,6,0,7,1,8,-2,2,0,0,-8,-7,5,-9,4,-1,0,-1,-1,-1,-1,-1,4,-1
KR_6764892219,440,3,65,13,2,-2,4,2,1,2,3,2,2,4,-1,4,3,2,0,2,0,0,-34,1,-8,7,22,0,2,-1,1,1,-1,6,-1
KR_6766741157,440,-3,-15,-9,-4,-3,5,2,1,4,5,-2,2,0,-3,6,3,3,0,3,0,-7,8,1,-6,5,-3,0,-1,1,-1,-1,1,4,-1
KR_6775502987,420,-1,-18,24,-4,1,0,1,4,0,4,-4,4,0,-4,5,1,-1,1,0,0,-7,17,2,-7,5,-5,0,0,-1,1,1,1,5,-1
KR_6740966264,420,1,9,28,-3,0,1,1,-4,5,1,0,1,1,0,1,1,1,0,1,1,-2,23,2,-6,4,-2,0,0,1,1,0,1,4,-1
KR_6774097368,420,-5,-64,-20,-9,-5,6,1,-3,3,0,-2,3,1,0,2,2,1,1,2,0,-8,1,-7,0,7,1,0,-2,1,-1,-1,-1,4,-1
KR_6775344924,420,-3,-26,-17,-3,-3,4,1,1,3,4,0,2,2,1,1,2,-2,3,1,0,-6,-22,-6,-2,8,-1,0,1,1,1,1,-1,2,-1
KR_6678440433,420,-2,9,-4,-5,-1,3,2,-4,5,1,-5,6,1,4,0,4,1,1,2,0,-5,-26,-3,-2,5,0,0,0,-1,1,-1,-1,5,-1
KR_6740925345,420,-2,5,-3,-9,1,1,2,-5,6,1,-7,7,0,-1,2,1,3,0,3,0,-10,-5,-5,-8,13,-4,0,-2,-1,-1,-1,1,3,-1
KR_6768320876,420,-3,-61,8,-6,-5,5,0,3,1,4,-2,4,2,-3,3,0,1,1,2,1,5,-6,-2,-5,7,2,0,-1,1,1,-1,1,3,-1
KR_6769607210,420,-3,17,-40,-8,2,5,7,-2,7,5,-5,5,0,-4,5,1,1,0,1,0,-11,-38,0,-6,6,-5,0,1,-1,1,1,-1,2,-1
KR_6774457604,420,0,-7,-22,0,0,2,2,-1,3,2,2,1,3,0,3,3,-1,1,0,0,1,20,0,-6,6,4,0,1,-1,1,1,1,3,-1
KR_6759693536,420,0,5,-3,-2,3,0,3,-1,2,1,-3,6,3,-1,2,1,0,0,0,0,0,0,-2,-5,7,6,0,0,1,-1,0,1,3,-1
KR_6774911204,420,-5,-56,-18,-17,-5,5,0,-1,2,1,-4,6,2,-6,7,1,-1,1,0,0,-15,-11,-5,-2,7,0,0,-3,-1,-1,-1,-1,1,-1
KR_6773035731,420,-4,-21,-10,-4,-3,6,3,-2,5,3,0,7,7,2,3,5,-1,2,1,1,0,12,-6,-2,8,0,0,0,-1,-1,-1,1,5,-1
KR_6748516330,420,-2,-35,11,-4,2,1,3,-2,7,5,-4,4,0,0,0,0,0,0,0,0,-6,-14,-2,-3,5,-5,0,0,-1,-1,0,-1,5,-1
KR_6773292425,420,-7,-134,-4,-14,-2,2,0,-1,3,2,-1,1,0,-9,10,1,-1,3,2,0,-14,-5,0,-6,6,-8,0,-2,-1,-1,-1,-1,5,-1
KR_6772326781,420,-3,-16,-35,-10,-2,3,1,2,3,5,-1,4,3,-6,6,0,-3,3,0,0,-7,-5,-4,-5,9,-1,0,0,1,1,-1,-1,3,-1
KR_6769575261,420,-2,0,-11,-3,1,4,5,5,1,6,0,3,3,-6,8,2,-3,3,0,1,-4,-39,-1,-6,7,2,0,-2,1,-1,-1,1,3,-1
KR_6740032862,420,-2,-39,-12,-4,-3,6,3,2,3,5,-1,5,4,-3,3,0,1,0,1,0,-2,-51,-2,-3,5,0,0,0,-1,0,-1,-1,6,-1
KR_6769233489,420,-3,-46,-24,-7,-1,3,2,-1,5,4,-7,7,0,2,1,3,0,0,0,0,1,-1,1,-7,6,1,0,-1,-1,1,-1,1,3,-1
KR_6771084629,420,-3,11,3,-5,-3,3,0,0,2,2,-5,5,0,1,0,1,2,1,3,0,0,6,1,-5,4,-3,0,0,0,-1,-1,-1,0,-1
KR_6768786129,420,-2,5,19,0,-2,4,2,1,0,1,0,3,3,2,1,3,-1,3,2,0,2,-7,-7,-2,9,2,0,-1,-1,1,1,-1,2,-1
KR_6776007000,420,-3,-13,10,-9,-2,3,1,0,0,0,2,0,2,-5,5,0,-4,4,0,0,-9,-1,0,-4,4,0,0,-3,-1,-1,-1,-1,4,-1
KR_6772882977,420,0,-8,-4,-1,-2,2,0,-2,3,1,3,2,5,-1,1,0,1,0,1,0,-1,63,-2,-4,6,-4,0,0,-1,-1,0,1,5,-1
KR_6723049432,420,2,-8,19,0,-3,3,0,-5,5,0,-2,2,0,9,2,11,1,0,1,0,5,35,3,-8,5,-2,0,-3,-1,-1,-1,1,3,-1
KR_6765100462,420,-6,-104,-34,-13,0,4,4,-5,9,4,0,4,4,-6,6,0,-2,2,0,0,-19,7,6,-12,6,-2,0,-3,-1,-1,-1,-1,4,-1
KR_6771073935,420,-2,-44,-5,-7,-6,7,1,3,1,4,-2,2,0,-3,8,5,1,3,4,0,-2,-15,0,-7,7,2,0,-2,1,-1,-1,1,4,-1
KR_6746040114,420,2,19,-23,11,-2,3,1,6,1,7,5,1,6,1,1,2,1,0,1,0,12,6,2,-6,4,-1,0,0,0,1,-1,-1,0,-1
KR_6749248280,420,0,-5,8,-3,0,1,1,0,1,1,0,2,2,-2,3,1,-1,1,0,0,-7,-1,-5,-4,9,0,0,0,-1,1,-1,-1,4,-1
KR_6774662088,420,-1,18,-18,-6,-1,3,2,-4,5,1,0,1,1,-2,5,3,1,1,2,0,-5,-128,-8,-1,9,3,0,1,-1,1,1,-1,3,-1
KR_6775691986,420,2,-2,10,-1,1,0,1,3,2,5,2,2,4,0,1,1,-7,8,1,0,-1,-31,1,-5,4,2,0,-1,1,-1,-1,-1,6,-1
KR_6769365102,420,0,-123,-13,-4,3,1,4,3,1,4,-3,7,4,-7,8,1,0,1,1,0,-4,116,5,-9,4,3,0,-1,1,1,-1,1,4,-1
KR_6748556399,420,0,-44,-27,3,1,2,3,-2,5,3,2,1,3,0,4,4,2,1,3,0,10,7,3,-10,7,-6,0,-2,-1,-1,-1,-1,1,-1
KR_6771740166,420,-2,-8,0,-2,0,1,1,1,0,1,-3,5,2,1,0,1,-1,2,1,0,2,-4,-1,-6,7,-1,0,-1,-1,-1,-1,-1,2,-1
KR_6771893756,440,0,20,-14,-2,3,0,3,-7,8,1,0,2,2,5,4,9,-3,5,2,1,-1,1,3,-7,4,7,0,0,-1,1,0,1,1,-1
KR_6767947033,420,1,39,-20,2,0,5,5,-7,9,2,0,0,0,6,0,6,3,2,5,0,1,-4,0,-8,8,4,0,-2,-1,-1,1,-1,2,-1
KR_6777664028,420,-3,-4,-8,-1,-1,2,1,0,3,3,1,2,3,0,4,4,-1,1,0,0,-2,-52,-5,-3,8,-3,0,0,1,-1,0,-1,2,-1
KR_6737459964,420,-2,-43,5,-4,-4,4,0,3,0,3,-4,6,2,1,1,2,0,1,1,0,-2,135,6,-10,4,-6,0,1,-1,1,1,1,1,-1
KR_6738271368,440,2,48,7,4,1,3,4,2,0,2,0,2,2,2,1,3,-1,2,1,0,-1,10,3,-7,4,3,0,1,-1,-1,-1,1,6,-1
KR_6739540314,420,0,-13,15,-2,-2,3,1,-1,5,4,2,3,5,-1,3,2,0,3,3,-4,0,16,-3,-8,11,-4,0,-1,1,-1,-1,-1,4,-1
KR_6755150152,420,-2,-36,12,-9,-2,4,2,-2,3,1,-6,6,0,1,1,2,0,1,1,0,-11,4,0,-7,7,-2,0,-1,1,0,-1,-1,4,-1
KR_6761394020,440,-5,-110,-52,-6,1,6,7,-4,7,3,0,2,2,1,1,2,-4,7,3,0,0,13,8,-10,2,-3,0,-3,-1,-1,-1,-1,1,-1
KR_6776918508,420,-1,10,-11,-5,1,1,2,-3,5,2,1,0,1,-3,5,2,-1,1,0,0,-11,-17,3,-6,3,-2,0,-1,-1,-1,-1,1,3,-1
KR_6730937785,420,-2,-24,4,4,-1,2,1,3,1,4,2,2,4,0,1,1,0,1,1,0,15,6,5,-8,3,-3,0,1,0,1,1,1,0,-1
KR_6773933856,420,0,51,23,-2,0,1,1,1,3,4,-1,1,0,-3,5,2,1,0,1,0,1,-1,-7,-5,12,3,0,-1,-1,1,-1,-1,6,-1
KR_6775976990,420,0,-24,12,-2,-1,3,2,0,2,2,3,2,5,-4,5,1,0,0,0,0,-5,116,-2,-4,6,4,0,1,1,0,1,-1,6,-1
KR_6718898330,420,0,-67,-4,1,-3,3,0,0,1,1,5,0,5,0,3,3,-1,2,1,-1,1,-1,3,-7,4,0,0,-1,1,1,-1,-1,6,-1
KR_6777762746,440,1,30,16,-3,-3,6,3,1,2,3,2,0,2,-6,9,3,3,0,3,0,-8,9,-2,-2,4,-3,0,0,1,1,1,-1,3,-1
KR_6770278765,440,-2,-100,-12,-3,-4,4,0,0,3,3,1,0,1,-1,1,0,1,0,1,0,-1,-28,3,-5,2,-5,0,1,1,-1,-1,-1,1,-1
KR_6707381678,440,-1,18,-38,4,-1,5,4,14,0,14,-3,6,3,-3,3,0,-3,5,2,1,17,6,4,-7,3,3,0,-1,0,-1,-1,1,0,-1
KR_6776100125,420,-2,13,-25,-9,-1,1,0,-2,3,1,-3,6,3,-1,2,1,-2,2,0,0,-8,-9,-6,-2,8,1,0,-1,-1,1,-1,-1,2,-1
KR_6765638606,420,1,-18,-10,2,-3,4,1,5,1,6,2,1,3,-2,2,0,0,0,0,-1,6,48,-2,-8,10,9,0,0,1,-1,0,-1,5,-1
KR_6770238816,420,0,11,-44,3,1,3,4,0,2,2,1,2,3,0,2,2,1,0,1,0,3,-5,0,-8,8,2,0,-2,-1,-1,-1,1,6,-1
KR_6736265164,420,-5,4,-19,-12,4,0,4,-2,4,2,-5,7,2,-4,6,2,-5,5,0,1,-20,33,3,-6,3,1,0,-1,-1,-1,-1,1,1,-1
KR_6777057170,420,-1,27,4,-2,0,3,3,0,3,3,1,3,4,-2,3,1,-1,1,0,0,-15,1,-1,-6,7,-7,0,1,-1,1,1,1,1,-1
KR_6776862654,420,0,-48,7,-3,-3,3,0,5,1,6,-1,4,3,-4,4,0,0,0,0,0,-6,-84,-3,-5,8,23,0,-1,1,1,-1,1,5,-1
KR_6766531728,420,-4,-29,8,-13,-3,3,0,-1,2,1,0,3,3,-11,13,2,2,0,2,1,-14,7,-1,-7,8,3,0,-2,1,-1,-1,1,6,-1
KR_6762579475,420,0,38,7,-1,-2,2,0,-1,3,2,3,0,3,-3,3,0,2,2,4,0,-2,-4,-1,-5,6,0,0,-1,-1,1,-1,-1,5,-1
KR_6777628962,420,-2,-71,-23,-6,2,1,3,-3,5,2,-4,4,0,-2,2,0,1,0,1,-1,-12,39,4,-11,7,-1,0,0,-1,1,0,-1,3,-1
KR_6734966284,420,-3,43,-1,-9,1,3,4,2,2,4,-8,8,0,-3,4,1,-1,1,0,0,-13,-6,2,-6,4,3,0,1,-1,1,1,1,2,-1
KR_6767014927,420,0,11,8,2,1,1,2,-1,4,3,1,0,1,-1,2,1,2,1,3,1,0,3,-1,-5,6,-4,0,-1,1,-1,-1,1,1,-1
KR_6767668425,420,2,-14,15,-3,-2,2,0,0,4,4,0,2,2,-1,3,2,0,1,1,0,1,32,2,-7,5,-1,0,-1,1,-1,-1,-1,4,-1
KR_6769856979,420,1,-10,24,-2,-1,3,2,1,2,3,-6,6,0,-1,3,2,5,1,6,0,-3,117,-2,-8,10,-3,0,2,1,1,1,-1,4,-1
KR_6770540809,420,0,-32,-6,-1,-2,2,0,-2,6,4,5,2,7,-1,2,1,-1,1,0,1,0,-10,-7,-1,8,5,0,-1,1,-1,-1,-1,3,-1
KR_6688069932,420,0,22,10,2,4,1,5,-3,6,3,-2,4,2,3,0,3,0,1,1,0,7,37,3,-11,8,-7,0,0,1,-1,1,-1,6,-1
KR_6677457153,420,1,26,2,-3,-3,3,0,-2,3,1,-1,3,2,4,0,4,-1,1,0,0,3,-6,-4,-4,8,-1,0,-1,-1,-1,-1,-1,6,-1
KR_6699955000,420,-2,3,29,-6,-1,4,3,-1,3,2,-1,2,1,-3,4,1,0,0,0,0,-12,-3,-2,-3,5,0,0,-1,1,-1,-1,-1,1,-1
KR_6763071709,420,-4,-27,-8,-7,-2,3,1,1,2,3,-1,1,0,-1,2,1,-4,4,0,0,-2,22,6,-11,5,-2,0,0,-1,-1,0,-1,5,-1
KR_6770531988,420,-3,24,-13,-8,0,0,0,-4,4,0,-2,7,5,2,0,2,-4,6,2,-1,-5,-22,-4,-4,8,5,0,1,-1,-1,1,-1,6,-1
KR_6723573600,420,0,39,-8,-4,-1,2,1,2,3,5,-6,6,0,1,2,3,0,0,0,0,-5,12,0,-5,5,-5,0,0,-1,1,1,-1,4,-1
KR_6739066721,420,-1,-36,-12,-6,-6,6,0,5,0,5,-3,6,3,-2,3,1,0,1,1,0,1,14,-4,-7,11,-16,0,-1,-1,-1,-1,-1,3,-1
KR_6769638919,420,-1,-5,-28,-4,3,0,3,-3,5,2,-5,6,1,2,1,3,-1,1,0,0,-10,9,3,-9,6,-6,0,0,-1,1,1,1,2,-1
KR_6730959466,420,-1,-3,-16,-4,0,0,0,-3,4,1,0,2,2,-1,1,0,0,0,0,0,-2,0,-1,-4,5,-3,0,-1,-1,-1,-1,-1,3,-1
KR_6774761588,420,2,56,-13,9,1,0,1,2,1,3,0,2,2,4,5,9,2,0,2,0,18,7,5,-8,3,1,0,0,1,-1,0,-1,6,-1
KR_6734381933,420,-2,-2,17,-7,-3,3,0,-2,3,1,0,1,1,-2,2,0,0,0,0,0,-11,48,-1,-7,8,-2,0,0,0,1,0,-1,0,-1
KR_6776818648,420,1,36,-18,0,0,1,1,-2,4,2,-1,2,1,0,1,1,3,0,3,0,5,5,2,-8,6,-3,0,-1,1,-1,1,1,2,-1
KR_6769389938,420,-1,-5,-8,-5,2,0,2,-5,7,2,-1,5,4,0,1,1,-1,1,0,0,-12,-15,-4,-4,8,0,0,-1,1,-1,-1,1,2,-1
KR_6766180906,440,-6,-103,11,-12,-2,3,1,-3,3,0,-3,4,1,-2,3,1,-2,4,2,0,-17,109,0,-5,5,-6,0,-2,1,-1,-1,-1,4,-1
KR_6773176190,420,-2,-81,-16,0,-1,1,0,2,3,5,1,2,3,-1,3,2,-1,2,1,0,-1,-47,0,-4,4,31,0,-1,-1,-1,-1,-1,3,-1
KR_6749463345,420,2,24,40,3,0,2,2,3,3,6,1,3,4,-2,2,0,1,0,1,1,-6,5,-1,-5,6,-6,0,-1,-1,1,-1,1,4,-1
KR_6764499665,420,-1,66,-37,-4,-2,6,4,5,4,9,-4,4,0,-1,4,3,-2,2,0,0,-8,0,2,-7,5,8,0,1,-1,1,1,1,6,-1
KR_6749239772,420,0,33,0,-3,3,1,4,2,0,2,-5,6,1,-2,3,1,-1,1,0,0,-7,43,4,-5,1,0,0,0,1,1,0,1,5,-1
KR_6767834162,420,-1,-8,-20,-1,3,1,4,-5,6,1,-2,4,2,3,3,6,0,0,0,-2,-5,-65,-10,-3,13,5,0,1,-1,-1,-1,-1,6,-1
KR_6777188738,420,1,18,3,-3,1,1,2,2,3,5,-3,5,2,-2,3,1,-1,1,0,1,-3,-9,-6,-3,9,4,0,0,1,1,-1,1,2,-1
KR_6765550321,420,-5,-64,-11,-3,4,1,5,-2,3,1,2,3,5,-7,8,1,0,0,0,0,-8,6,3,-6,3,-9,0,-1,-1,-1,-1,1,1,-1
KR_6763450125,420,-2,2,31,-10,-4,4,0,-1,2,1,-6,6,0,0,2,2,1,0,1,0,-15,-3,1,-5,4,1,0,0,-1,-1,1,-1,4,-1
KR_6777392085,420,-4,-1,-3,-8,2,0,2,-4,4,0,2,3,5,-7,9,2,-1,1,0,1,-12,-5,-1,-7,8,-2,0,-2,-1,-1,-1,1,5,-1
KR_6745736332,420,-2,-21,-17,-3,1,1,2,-5,8,3,1,2,3,-2,5,3,2,1,3,0,5,33,3,-10,7,-3,0,0,-1,1,-1,-1,2,-1
KR_6762909579,420,-2,9,-29,-7,-2,2,0,-2,3,1,-2,5,3,-4,5,1,3,3,6,0,-12,4,1,-6,5,2,0,0,1,-1,0,-1,1,-1
KR_6751456454,420,-3,2,-16,-5,1,2,3,-6,8,2,-1,4,3,1,3,4,0,1,1,0,-3,5,4,-8,4,-3,0,0,-1,1,0,1,6,-1
KR_6772570445,420,-1,18,3,-7,-3,3,0,0,1,1,-1,4,3,-3,7,4,0,0,0,0,-8,-4,1,-5,4,-1,0,0,1,-1,0,1,4,-1
KR_6743675964,420,-5,-53,-5,-11,1,1,2,-5,7,2,-5,6,1,0,2,2,-2,2,0,0,-11,3,3,-10,7,-6,0,-3,-1,-1,-1,-1,4,-1
KR_6761025562,440,1,-10,1,4,-1,2,1,5,0,5,4,1,5,-5,6,1,1,1,2,0,-2,-1,4,-6,2,-3,0,-1,-1,1,-1,-1,4,-1
KR_6775630535,420,1,21,20,-5,-2,2,0,-2,3,1,4,2,6,0,4,4,-5,5,0,0,-5,7,-3,-4,7,-4,0,0,-1,1,0,-1,3,-1
KR_6737400945,420,-3,-5,-14,-6,1,1,2,0,1,1,-2,3,1,-5,10,5,0,0,0,0,-11,-35,5,-9,4,3,0,0,-1,1,-1,-1,3,-1
KR_6776291066,420,-5,5,-15,-13,-6,6,0,-4,5,1,1,1,2,-3,4,1,-1,1,0,0,-5,22,1,-8,7,-1,0,-1,1,-1,1,-1,3,-1
KR_6767187446,440,3,22,19,9,1,0,1,1,4,5,5,2,7,-2,2,0,4,0,4,0,14,35,4,-10,6,2,0,1,1,1,1,-1,4,-1
KR_6768107590,440,-4,-45,20,-13,-3,7,4,-1,2,1,-1,3,2,-3,8,5,-5,5,0,-1,-14,11,-1,-5,6,-1,0,-4,-1,-1,-1,-1,3,-1
KR_6759956308,420,-4,-95,-42,-7,-1,1,0,0,0,0,-5,6,1,-1,1,0,0,0,0,0,-9,-23,-1,-3,4,-1,0,-2,-1,-1,-1,-1,6,-1
KR_6759452585,420,-6,-45,-39,-8,-5,6,1,0,1,1,-1,1,0,5,4,9,-7,7,0,0,-6,-12,-1,-5,6,3,0,-1,1,-1,-1,-1,6,-1
KR_6772771459,420,0,-60,-24,4,2,0,2,-2,7,5,1,2,3,4,1,5,-1,2,1,0,13,28,2,-9,7,-2,0,0,-1,1,1,1,5,-1
KR_6775929773,420,-1,11,-1,-3,4,0,4,1,0,1,-7,8,1,-2,5,3,1,0,1,0,-3,-4,2,-5,3,0,0,1,-1,1,1,-1,4,-1
KR_6774557500,420,1,17,40,-1,-2,3,1,0,1,1,2,2,4,1,0,1,-2,2,0,0,2,-2,-5,-2,7,4,0,-2,1,-1,-1,-1,1,-1
KR_6774230224,420,0,-24,10,2,0,1,1,0,5,5,1,0,1,0,2,2,1,1,2,1,10,1,-1,-6,7,-1,0,-2,1,1,-1,1,6,-1
KR_6768651513,420,-3,-42,8,-14,-2,2,0,1,5,6,-9,9,0,-4,6,2,0,2,2,-2,-17,1,-1,-4,5,-4,0,-1,-1,1,-1,-1,5,-1
KR_6733378754,420,0,53,-14,-3,0,3,3,-4,5,1,-3,4,1,4,0,4,0,0,0,0,-5,-1,1,-5,4,0,0,0,-1,-1,-1,-1,2,-1
KR_6745148566,420,-2,-39,8,5,0,1,1,0,5,5,0,6,6,4,1,5,1,0,1,-1,4,-177,5,-8,3,26,0,0,1,1,-1,-1,5,-1
KR_6684312846,420,1,-31,-18,2,1,0,1,2,1,3,-1,9,8,-1,2,1,1,0,1,1,12,8,5,-8,3,-4,0,-1,1,-1,-1,1,6,-1
KR_6771961038,440,-2,-71,-4,-3,0,1,1,0,1,1,-2,3,1,-1,1,0,0,2,2,0,-3,-1,-1,-4,5,-1,0,-1,-1,1,-1,-1,2,-1
KR_6756251546,420,1,40,15,2,2,2,4,0,3,3,2,0,2,-2,3,1,0,0,0,0,-2,22,1,-5,4,3,0,0,-1,0,0,-1,2,-1
KR_6691614128,420,0,-13,-42,1,1,1,2,0,3,3,1,1,2,-2,2,0,1,0,1,-1,-2,6,4,-9,5,-4,0,-1,-1,-1,-1,-1,2,-1
KR_6765456763,420,-1,-75,-16,-4,0,2,2,-4,5,1,-2,5,3,0,2,2,2,0,2,0,-3,-5,-4,-4,8,3,0,0,-1,1,0,-1,6,-1
KR_6770376599,440,-1,15,-2,-6,2,0,2,-2,5,3,-4,6,2,-1,3,2,-1,1,0,1,-3,-11,1,-5,4,-2,0,-1,-1,1,-1,1,5,-1
KR_6777286597,420,-3,14,-36,-15,0,3,3,-6,8,2,0,2,2,-7,9,2,-2,2,0,0,-12,-80,-6,-3,9,3,0,-2,-1,-1,-1,-1,2,-1
KR_6777115571,420,2,-2,-8,9,-4,4,0,2,1,3,2,0,2,3,2,5,6,0,6,0,14,-36,0,-8,8,-2,0,0,1,1,0,1,2,-1
KR_6776192357,420,1,-55,-24,-4,0,0,0,0,5,5,-1,5,4,-2,3,1,-1,3,2,0,-3,2,2,-6,4,-5,0,-3,-1,0,-1,-1,2,-1
KR_6777822421,420,0,42,-28,-2,0,0,0,-4,6,2,1,6,7,2,3,5,-1,2,1,0,-11,-30,3,-6,3,-3,0,0,1,-1,0,1,1,-1
KR_6740706268,420,-4,-38,-27,-3,1,0,1,0,5,5,-2,2,0,-3,7,4,1,1,2,0,-7,-30,-2,-4,6,0,0,0,0,-1,-1,-1,0,-1
KR_6773573285,420,-2,-28,28,-10,-3,4,1,-1,4,3,-2,3,1,-7,7,0,3,0,3,0,-12,5,1,-7,6,-8,0,-1,-1,1,-1,-1,4,-1
KR_6776092987,420,-7,-56,-76,-9,-3,3,0,-1,2,1,-1,3,2,-1,5,4,-3,3,0,0,-9,4,1,-7,6,3,0,-2,1,-1,-1,1,2,-1
KR_6756544153,420,-2,-19,-11,2,-2,5,3,0,3,3,0,1,1,5,2,7,-1,2,1,2,13,-6,-3,-3,6,2,0,1,0,-1,1,1,0,-1
KR_6776717601,420,-3,-115,-26,-5,-3,3,0,0,2,2,0,3,3,-1,2,1,-1,1,0,0,-5,9,1,-4,3,-1,0,0,-1,-1,0,-1,4,-1
KR_6726879641,440,3,14,5,3,3,1,4,1,4,5,1,2,3,-1,1,0,-1,1,0,0,-2,-3,0,-4,4,0,0,0,-1,1,0,1,3,-1
KR_6766963070,420,-2,-38,-33,-5,-1,5,4,-1,2,1,-1,1,0,-2,7,5,0,2,2,0,-10,-13,3,-10,7,-3,0,1,-1,1,1,-1,4,-1
KR_6765462278,420,-4,12,-21,-19,0,2,2,-2,2,0,-5,5,0,-9,11,2,-3,3,0,0,-20,-7,-3,-3,6,-1,0,-1,-1,-1,1,-1,3,-1
KR_6775663214,420,-4,-41,-5,-9,-3,3,0,-1,5,4,-1,3,2,1,3,4,-5,5,0,0,-12,-1,7,-9,2,-3,0,-2,-1,-1,-1,-1,2,-1
KR_6733270556,420,-1,13,16,-3,-3,4,1,2,3,5,0,2,2,-2,3,1,0,2,2,0,-10,2,5,-8,3,-4,0,0,-1,1,1,1,2,-1
KR_6777713434,420,-1,-63,-7,-4,-2,4,2,0,2,2,-2,2,0,2,2,4,-2,3,1,0,-1,2,-4,-4,8,-8,0,-1,-1,-1,-1,-1,2,-1
KR_6732289096,420,-2,-49,19,-4,3,1,4,-5,5,0,-3,6,3,0,2,2,1,0,1,0,-7,-45,-1,-6,7,16,0,0,1,-1,0,-1,3,-1
KR_6774817720,420,0,-39,-16,-1,-1,2,1,2,0,2,-2,5,3,-1,3,2,1,1,2,-1,8,37,-1,-7,8,1,0,0,-1,-1,-1,-1,4,-1
KR_6763090011,420,0,-28,2,-4,-1,4,3,-3,5,2,0,2,2,3,2,5,-3,4,1,0,-3,-6,0,-7,7,4,0,-1,1,1,-1,-1,1,-1
KR_6775385087,420,2,-12,13,1,1,2,3,-2,3,1,3,3,6,0,2,2,-1,1,0,0,-2,3,1,-8,7,-2,0,0,-1,-1,1,-1,5,-1
KR_6777019699,420,3,10,-9,3,1,1,2,-1,4,3,-1,3,2,3,1,4,1,0,1,-1,2,281,-1,-2,3,3,0,0,-1,1,0,-1,6,-1
KR_6769964300,420,-2,51,-29,-5,-2,3,1,-1,3,2,0,1,1,-2,5,3,0,0,0,0,-7,0,-4,-4,8,2,0,-1,-1,-1,-1,-1,2,-1
KR_6775848920,440,0,40,-4,-6,1,0,1,-1,1,0,-2,3,1,4,0,4,-8,8,0,0,-5,9,6,-7,1,0,0,1,1,1,1,1,3,-1
KR_6751913566,420,0,-26,-3,5,-4,6,2,4,0,4,4,1,5,2,2,4,-1,2,1,1,13,35,6,-9,3,-3,0,0,1,0,0,1,1,-1
KR_6767776618,420,2,-2,38,3,-1,4,3,6,0,6,1,1,2,-2,2,0,-1,1,0,0,6,21,0,-9,9,4,0,0,-1,1,1,-1,5,-1
KR_6729363509,420,0,-33,8,-4,2,1,3,0,3,3,2,1,3,-7,8,1,-1,1,0,0,-3,136,-4,-4,8,-3,0,-1,-1,1,-1,-1,4,-1
KR_6777813614,420,-1,15,13,-4,-2,3,1,1,2,3,-3,5,2,-1,5,4,1,0,1,1,0,-136,-2,-4,6,5,0,0,-1,-1,0,1,4,-1
KR_6775913647,420,-3,6,-8,-10,-3,3,0,-4,6,2,3,0,3,-7,7,0,1,0,1,0,-17,18,0,-6,6,5,0,-1,-1,-1,-1,-1,6,-1
KR_6776112900,420,-1,-20,-12,-8,-1,3,2,-2,6,4,-1,3,2,-4,6,2,0,1,1,0,-10,10,0,-7,7,-3,0,-2,1,-1,-1,1,4,-1
KR_6738287534,440,3,-47,3,7,-1,2,1,5,1,6,5,0,5,-5,7,2,3,1,4,0,2,-21,-4,-2,6,0,0,1,1,1,1,-1,6,-1
KR_6776324123,420,-7,-34,-8,-16,-5,6,1,-9,10,1,0,1,1,0,1,1,-2,5,3,0,-20,1,1,-7,6,-1,0,-2,-1,-1,-1,-1,2,-1
KR_6771770905,420,-5,-40,-23,-13,-3,4,1,-6,7,1,-5,5,0,2,1,3,-1,2,1,0,-10,-5,3,-7,4,3,0,-1,-1,-1,-1,-1,2,-1
KR_6768501211,440,-2,13,-15,5,0,3,3,-3,3,0,-2,4,2,3,2,5,7,2,9,2,6,0,-3,-3,6,0,0,1,-1,1,1,1,5,-1
KR_6748008427,420,-1,-31,32,-7,-6,7,1,2,3,5,-1,1,0,-1,2,1,-1,2,1,0,-6,23,-3,-6,9,4,0,-1,-1,-1,-1,-1,1,-1
KR_6766144286,440,1,-49,-4,-3,5,0,5,2,2,4,0,1,1,-5,6,1,-5,6,1,0,6,8,3,-6,3,-3,0,-2,1,-1,-1,-1,3,-1
KR_6764706342,420,-2,-42,-11,-7,-3,4,1,1,2,3,0,2,2,-5,6,1,0,0,0,0,-6,5,0,-6,6,2,0,-1,-1,-1,1,-1,1,-1
KR_6699304908,420,-4,-23,-20,-7,-2,4,2,-3,4,1,0,2,2,-3,5,2,1,1,2,0,-14,5,3,-7,4,-9,0,0,-1,1,-1,-1,5,-1
KR_6776013544,420,2,105,-16,11,-1,1,0,5,3,8,1,9,10,4,2,6,2,2,4,2,2,24,4,-4,0,3,0,1,-1,-1,1,1,5,-1
KR_6777859469,420,1,66,34,-4,2,1,3,-4,7,3,0,0,0,-2,4,2,0,0,0,0,-14,11,3,-8,5,1,0,1,-1,1,1,-1,6,-1
KR_6753570213,420,-2,-6,20,-11,-1,2,1,-5,6,1,-1,2,1,-4,7,3,0,0,0,0,-12,-6,1,-6,5,-5,0,-1,1,-1,-1,-1,5,-1
KR_6748188719,420,-7,-57,-37,-11,-2,3,1,-6,8,2,0,1,1,-4,5,1,1,1,2,0,-10,-47,-2,-4,6,1,0,-4,-1,-1,-1,-1,5,-1
KR_6774450383,420,-3,-56,-11,3,0,3,3,3,0,3,2,0,2,-3,5,2,1,1,2,1,-2,-156,-2,-4,6,2,0,-1,1,1,-1,1,3,-1
KR_6737251785,420,-6,-34,-7,-15,-4,4,0,-2,3,1,-2,2,0,-9,9,0,2,0,2,0,-14,-26,0,-6,6,-3,0,-2,-1,-1,-1,-1,4,-1
KR_6664917370,420,1,2,-25,3,-2,2,0,4,3,7,-4,5,1,4,1,5,1,0,1,0,4,-2,1,-9,8,-1,0,0,-1,1,0,1,3,-1
KR_6772840140,420,-1,-19,-1,-2,-1,2,1,-3,7,4,-1,2,1,8,0,8,-5,5,0,-2,0,6,-3,-2,5,-4,0,-1,-1,-1,-1,-1,3,-1
KR_6775795516,420,-2,-67,-5,-3,0,0,0,-1,3,2,-2,3,1,1,2,3,-1,3,2,0,2,13,2,-7,5,-8,0,0,0,-1,0,-1,0,-1
KR_6775064836,420,2,-27,-5,9,2,1,3,4,0,4,-1,3,2,5,1,6,-1,1,0,0,13,-3,-2,-7,9,-3,0,-1,1,-1,-1,-1,1,-1
KR_6773196221,420,2,34,-36,11,3,0,3,3,2,5,1,2,3,1,0,1,3,0,3,1,13,8,0,-8,8,3,0,0,1,1,0,1,6,-1
KR_6728061668,420,-2,-29,5,-4,-1,2,1,-8,8,0,4,0,4,0,3,3,1,0,1,0,-7,4,2,-7,5,-7,0,0,-1,1,0,-1,3,-1
KR_6776137947,420,-4,-19,-26,-6,-3,5,2,4,0,4,2,2,4,-3,5,2,-6,7,1,0,-4,-19,1,-7,6,-2,0,-1,-1,-1,-1,1,2,-1
KR_6764050704,420,-2,-42,-27,-6,2,0,2,-1,4,3,0,3,3,-3,3,0,-4,4,0,-1,-10,-3,0,-5,5,-3,0,-2,-1,-1,-1,-1,6,-1
KR_6756805743,420,-1,30,4,-10,1,3,4,-3,3,0,2,2,4,-10,10,0,0,0,0,0,-14,2,3,-7,4,7,0,1,1,1,1,1,3,-1
KR_6774695181,440,-3,-55,-16,-3,0,1,1,-1,1,0,4,0,4,-1,2,1,-5,5,0,1,2,-6,0,-5,5,-3,0,-1,-1,0,-1,1,5,-1
KR_6775281795,420,3,29,17,3,1,2,3,-1,6,5,3,0,3,-2,2,0,2,0,2,-1,1,-9,-6,-5,11,6,0,0,1,1,0,-1,4,-1
KR_6727213439,420,-1,6,-21,-4,1,1,2,-1,2,1,-6,8,2,-1,3,2,3,1,4,0,-6,84,9,-15,6,-41,0,1,-1,1,1,-1,6,-1
KR_6775891545,420,1,-37,-8,0,-1,3,2,2,1,3,0,1,1,1,1,2,-2,3,1,-1,-3,0,-2,-5,7,0,0,-1,-1,-1,-1,-1,5,-1
KR_6762765717,420,0,-56,12,-2,3,2,5,1,3,4,-1,1,0,-2,5,3,-3,5,2,0,8,-6,-2,-5,7,-1,0,-2,1,-1,-1,1,3,-1
KR_6741289724,420,0,-34,10,5,-2,3,1,3,1,4,7,1,8,-3,4,1,0,1,1,0,3,-2,-1,-5,6,0,0,0,-1,1,1,1,2,-1
KR_6710435250,420,-1,-37,-9,8,-2,2,0,6,1,7,5,1,6,-1,5,4,0,0,0,1,11,-108,-2,-5,7,-1,0,-1,-1,1,-1,1,1,-1
KR_6762993454,420,-5,-82,-40,-8,-3,3,0,-4,6,2,5,1,6,-2,2,0,-4,6,2,-1,-6,-5,4,-9,5,1,0,-1,-1,-1,-1,-1,1,-1
KR_6769058329,420,-3,-19,9,-8,0,1,1,-8,10,2,-1,8,7,1,3,4,0,0,0,-1,-9,1,-5,-3,8,-4,0,-1,-1,-1,-1,-1,3,-1
KR_6772303071,420,0,-12,24,0,2,2,4,2,2,4,-1,3,2,-3,3,0,0,3,3,-1,-5,-10,-3,-4,7,1,0,0,1,-1,0,-1,6,-1
KR_6751937046,420,-2,64,-12,-4,1,1,2,-3,6,3,0,5,5,0,3,3,-2,3,1,-2,-13,52,-3,-3,6,-2,0,0,-1,-1,0,-1,4,-1
KR_6771941624,420,3,-43,0,1,5,0,5,-1,5,4,1,1,2,-2,2,0,-2,2,0,0,-6,-22,-7,-3,10,-1,0,-1,0,-1,-1,-1,0,-1
KR_6705114245,420,-4,-58,-3,-10,1,1,2,-2,4,2,-3,3,0,-6,8,2,0,0,0,0,-14,-1,-2,-1,3,0,0,0,-1,-1,-1,-1,2,-1
KR_6770510497,420,-1,-13,-5,0,2,0,2,-5,5,0,-2,4,2,4,1,5,1,0,1,0,8,29,4,-8,4,-4,0,-2,-1,-1,-1,1,3,-1
KR_6767741526,420,-7,-50,-50,-12,1,2,3,-1,3,2,-8,8,0,-5,6,1,1,0,1,0,-15,3,2,-9,7,-5,0,-1,-1,0,-1,-1,6,-1
KR_6774132464,420,2,62,-6,2,2,1,3,4,3,7,-3,7,4,2,1,3,-3,4,1,0,-4,-12,1,-5,4,-4,0,-1,-1,-1,-1,1,4,-1
KR_6756320671,420,-4,-45,0,-17,-3,5,2,-4,5,1,-4,4,0,-1,4,3,-5,7,2,-1,-16,-14,-5,-5,10,-2,0,-2,1,-1,-1,-1,6,-1
KR_6762995821,420,1,-5,-11,-1,3,0,3,3,4,7,0,1,1,-7,8,1,0,3,3,0,-6,-7,-6,-2,8,-2,0,0,-1,1,1,-1,2,-1
KR_6766052217,420,-2,-69,-12,-2,-1,4,3,-1,3,2,1,0,1,0,3,3,-1,1,0,0,3,10,1,-9,8,-1,0,-3,1,-1,-1,1,4,-1
KR_6768690334,420,-1,25,-15,-5,3,1,4,-6,7,1,-1,5,4,-2,6,4,1,1,2,0,-11,2,-3,-5,8,2,0,1,1,-1,1,-1,3,-1
KR_6774576600,420,1,8,-21,4,5,1,6,-1,5,4,1,1,2,0,5,5,-1,1,0,0,-6,-4,4,-10,6,1,0,1,-1,1,1,1,6,-1
KR_6775993593,420,-2,16,-2,-6,-5,5,0,-2,2,0,-1,2,1,1,2,3,1,1,2,0,-5,-1,-2,-3,5,0,0,-3,1,-1,-1,-1,4,-1
KR_6774930548,420,2,3,17,5,3,3,6,0,4,4,1,0,1,0,2,2,1,1,2,2,8,12,-3,-4,7,-1,0,0,1,-1,0,1,2,-1
KR_6765306214,420,-5,-57,-12,-11,-5,6,1,-6,6,0,0,0,0,2,2,4,-2,2,0,-1,-12,1,-3,-4,7,1,0,-1,1,-1,-1,-1,4,-1
KR_6728553727,420,-1,-35,0,3,6,0,6,1,1,2,-2,3,1,-3,6,3,1,0,1,0,-6,-5,2,-6,4,-2,0,0,-1,-1,-1,-1,2,-1
KR_6777235626,420,1,25,18,-1,2,1,3,-1,4,3,4,0,4,-5,5,0,-1,1,0,0,-4,-2,2,-7,5,0,0,0,-1,1,-1,-1,3,-1
KR_6761475800,420,-3,-25,15,-10,-3,5,2,-1,2,1,-7,7,0,1,2,3,0,0,0,-2,-13,-19,-2,-5,7,0,0,-1,-1,1,-1,-1,5,-1
KR_6773019672,420,-2,-23,-8,-3,4,0,4,-2,4,2,0,1,1,-5,6,1,0,1,1,0,-4,0,-2,-6,8,1,0,-1,-1,1,-1,-1,1,-1
KR_6777643894,420,-3,5,3,-2,0,0,0,-4,6,2,1,1,2,1,2,3,0,1,1,1,4,223,1,-6,5,0,0,0,-1,1,-1,1,6,-1
KR_6777526402,420,0,26,8,3,4,2,6,0,6,6,-6,6,0,2,3,5,3,0,3,1,7,10,5,-10,5,-5,0,0,1,-1,0,1,1,-1
KR_6730217427,420,-2,22,8,-3,1,2,3,1,2,3,-3,5,2,0,3,3,-2,2,0,0,1,25,2,-6,4,-3,0,-1,-1,-1,-1,1,1,-1
KR_6723504085,420,-1,14,-28,2,0,1,1,1,1,2,-1,3,2,-1,2,1,3,1,4,0,5,-2,3,-5,2,3,0,0,1,-1,0,-1,1,-1
KR_6768441016,420,-1,-23,-31,1,0,2,2,3,2,5,0,4,4,-2,4,2,0,2,2,0,2,-3,-1,-4,5,-4,0,-1,1,-1,-1,-1,6,-1
KR_6776567444,420,-2,-12,-13,-6,2,1,3,-4,6,2,-1,7,6,-3,5,2,0,0,0,0,-2,-19,3,-6,3,-1,0,-1,1,-1,-1,-1,6,-1
KR_6742395821,420,-2,10,-28,-7,2,2,4,-1,2,1,-4,5,1,-1,3,2,-3,3,0,0,-11,-7,-1,-5,6,-4,0,0,-1,-1,0,-1,2,-1
KR_6727832421,420,-3,-52,-42,-7,-6,6,0,0,4,4,3,0,3,-1,2,1,-3,4,1,1,8,11,0,-3,3,-7,0,-2,-1,-1,-1,1,1,-1
KR_6774066323,420,0,3,22,3,-1,2,1,4,1,5,1,2,3,-3,4,1,2,2,4,-1,-1,15,4,-6,2,-2,0,0,1,-1,0,-1,5,-1
KR_6770218544,420,1,61,1,-3,0,2,2,-2,5,3,0,0,0,-1,1,0,0,0,0,0,-11,3,0,-4,4,-1,0,1,1,1,1,1,4,-1
KR_6772531799,420,-1,8,-12,-9,-4,5,1,0,1,1,-3,3,0,-2,2,0,0,0,0,0,-9,25,3,-8,5,-2,0,-1,1,-1,-1,-1,6,-1
KR_6774095986,420,-3,-43,-23,-6,-2,4,2,1,4,5,-1,2,1,-1,2,1,-3,5,2,0,-8,4,0,-3,3,-1,0,0,-1,-1,0,-1,5,-1
KR_6772790816,420,-1,4,-16,-1,-4,6,2,3,2,5,-1,2,1,0,1,1,1,0,1,-1,6,-1,1,-7,6,3,0,-1,-1,-1,1,-1,6,-1
KR_6744989626,420,-6,-94,0,-16,-2,2,0,1,1,2,-5,7,2,-6,8,2,-4,4,0,0,-5,7,0,-4,4,-4,0,-1,1,1,-1,1,6,-1
KR_6764877794,420,2,-19,16,0,4,0,4,-1,3,2,-1,1,0,-1,3,2,-1,2,1,0,-5,-197,2,-8,6,-2,0,0,1,-1,-1,1,3,-1
KR_6766549323,420,-1,-1,20,-2,-1,1,0,1,1,2,1,3,4,-3,5,2,0,0,0,1,0,35,0,-7,7,-1,0,-1,-1,-1,-1,1,4,-1
KR_6734314305,420,1,16,10,1,6,1,7,-1,4,3,-4,5,1,1,4,5,-1,1,0,0,1,1,-2,-3,5,2,0,0,-1,1,1,-1,4,-1
KR_6775286515,420,1,-13,20,-1,1,1,2,-4,7,3,-1,3,2,3,1,4,0,1,1,1,0,-1,-4,-3,7,2,0,-1,1,1,-1,1,3,-1
KR_6777411225,420,-4,28,16,-5,2,1,3,-1,3,2,-3,4,1,-1,1,0,-2,3,1,0,-5,4,-6,-6,12,-4,0,1,-1,-1,1,-1,6,-1
KR_6774018003,420,-2,-22,2,-4,2,2,4,-4,5,1,1,4,5,-2,6,4,-1,2,1,-2,-9,-17,-3,-7,10,-2,0,0,1,-1,1,-1,2,-1
KR_6752683525,420,-2,-18,8,-3,-3,4,1,2,2,4,5,1,6,-7,14,7,0,1,1,-1,2,18,3,-7,4,-7,0,-2,1,-1,-1,-1,2,-1
KR_6777202555,420,-5,-74,-18,-7,4,1,5,-1,2,1,1,2,3,-9,9,0,-2,2,0,0,-16,-9,-4,-3,7,-2,0,0,1,-1,-1,-1,6,-1
KR_6776817214,420,-1,-59,3,-5,3,0,3,-2,4,2,-7,7,0,1,1,2,0,4,4,0,-10,36,-4,-3,7,1,0,0,1,-1,1,-1,4,-1
KR_6776371206,420,-2,-13,-16,2,-3,5,2,3,1,4,-1,3,2,3,1,4,0,0,0,0,2,-18,-2,-5,7,-1,0,1,1,-1,-1,1,2,-1
KR_6774305340,420,-2,-48,-8,-10,1,1,2,-1,5,4,-6,7,1,-5,5,0,1,0,1,0,-16,2,-1,-7,8,-5,0,0,-1,-1,1,-1,4,-1
KR_6706617941,440,1,7,4,0,-1,1,0,-2,4,2,2,0,2,2,1,3,-1,1,0,0,-1,2,1,-4,3,4,0,0,1,-1,0,-1,6,-1
KR_6773911812,420,-2,-45,-37,-4,2,0,2,-4,4,0,0,1,1,-2,2,0,0,1,1,0,-11,29,4,-9,5,-8,0,0,-1,-1,-1,-1,5,-1
KR_6775040840,440,-1,-16,-4,0,1,5,6,0,5,5,-2,5,3,-1,5,4,2,1,3,-1,-9,1,2,-7,5,2,0,1,-1,0,1,-1,2,-1
KR_6758482182,420,-3,6,0,-4,-3,4,1,5,1,6,-2,4,2,-4,9,5,0,0,0,0,-4,-9,-3,-6,9,0,0,-1,-1,-1,-1,1,1,-1
KR_6728028448,420,-6,-65,-23,-25,-6,6,0,-5,7,2,-5,6,1,-3,5,2,-6,6,0,-1,-24,-33,-3,-3,6,-3,0,-2,-1,1,-1,-1,3,-1
KR_6776348164,440,-3,1,-4,-17,0,1,1,-5,6,1,-5,5,0,-6,7,1,-1,1,0,-1,-15,-51,2,-6,4,-3,0,-1,-1,-1,-1,-1,2,-1
KR_6775823388,420,-1,-63,-4,-1,-4,7,3,0,1,1,4,0,4,-1,3,2,0,0,0,0,4,-5,1,-5,4,-5,0,-1,1,-1,-1,1,1,-1
KR_6773957434,420,2,-16,12,2,-3,3,0,4,1,5,4,0,4,-4,4,0,1,0,1,0,6,4,3,-8,5,-9,0,-1,-1,-1,-1,-1,1,-1
KR_6774350230,420,1,-37,-8,-2,-3,3,0,1,4,5,2,1,3,-3,6,3,1,1,2,-1,-6,-6,-4,-3,7,-4,0,0,1,-1,-1,-1,6,-1
KR_6700077949,420,1,27,-19,9,-2,3,1,3,4,7,1,2,3,7,0,7,0,1,1,0,15,0,2,-6,4,-2,0,-1,-1,-1,-1,1,4,-1
KR_6776608739,420,-1,-50,47,0,1,2,3,3,1,4,-4,5,1,-1,3,2,1,1,2,1,-12,-21,-4,-5,9,-1,0,-1,-1,1,-1,1,1,-1
KR_6776823571,420,-4,0,-16,-7,-2,2,0,-4,4,0,-3,4,1,2,1,3,0,2,2,0,-11,11,0,-3,3,1,0,-1,-1,-1,-1,1,1,-1
KR_6770214631,440,4,10,9,7,2,3,5,3,4,7,-3,5,2,4,1,5,1,0,1,1,8,-10,-6,-2,8,6,0,0,1,-1,1,1,2,-1
KR_6755757149,420,1,-21,-11,7,4,1,5,0,2,2,3,4,7,-1,4,3,1,0,1,2,12,1,1,-6,5,3,0,0,-1,1,1,1,2,-1
KR_6702426370,420,1,-24,3,5,-3,3,0,3,0,3,2,1,3,0,3,3,3,0,3,-1,15,37,1,-8,7,4,0,-1,1,-1,-1,-1,2,-1
KR_6742489661,420,-2,-56,-24,-13,-2,3,1,-2,6,4,-7,8,1,-2,4,2,0,1,1,-3,-5,3,0,-5,5,-2,0,-5,-1,-1,-1,-1,3,-1
KR_6729086744,420,-3,-49,8,-6,0,2,2,1,4,5,-3,5,2,-1,5,4,-3,4,1,-1,-6,13,-5,-2,7,6,0,-1,-1,1,-1,-1,5,-1
KR_6749834349,420,0,-15,-20,-5,-2,5,3,-2,4,2,-2,5,3,0,4,4,1,0,1,0,-12,0,-2,-4,6,0,0,-2,1,-1,-1,-1,3,-1
KR_6770474011,420,-2,-31,20,-5,-1,1,0,-1,2,1,0,2,2,-1,4,3,-2,3,1,0,-6,-12,-6,-1,7,4,0,-2,-1,-1,-1,-1,1,-1
KR_6763434332,420,1,50,10,4,3,1,4,-2,5,3,1,1,2,3,3,6,-1,1,0,1,2,3,1,-6,5,4,0,0,1,-1,0,1,2,-1
KR_6745915636,420,-5,-30,-33,-9,-2,2,0,-1,4,3,-3,3,0,-1,2,1,-2,3,1,0,-9,5,-1,-4,5,0,0,-1,-1,-1,-1,-1,4,-1
KR_6775344265,420,0,-20,-2,-13,-6,6,0,2,1,3,0,1,1,-3,4,1,-6,7,1,-2,-11,-10,1,-4,3,-4,0,-3,-1,-1,-1,-1,3,-1
KR_6774081651,420,-4,-36,6,-5,-2,2,0,0,1,1,-2,2,0,-3,4,1,2,0,2,0,-5,-15,-6,-4,10,2,0,0,-1,1,0,1,5,-1
KR_6771788222,440,1,-24,3,5,-6,6,0,7,1,8,1,2,3,2,2,4,1,2,3,0,11,33,-2,-3,5,0,0,-1,1,-1,-1,-1,2,-1
KR_6774493323,420,1,-6,-5,-1,2,1,3,2,1,3,0,2,2,-3,4,1,-2,2,0,1,2,-19,-7,-2,9,6,0,-1,1,-1,-1,1,4,-1
KR_6733033222,420,-1,-58,-30,0,-2,2,0,-3,5,2,0,1,1,3,1,4,2,0,2,0,2,44,1,-7,6,-23,0,0,-1,0,-1,1,4,-1
KR_6726160532,420,0,-11,-15,2,2,5,7,-2,4,2,6,1,7,-2,2,0,-2,4,2,1,-1,6,-2,-5,7,-1,0,-1,-1,1,-1,1,2,-1
KR_6771734392,420,2,31,11,-4,-3,3,0,-1,3,2,-2,2,0,0,1,1,2,0,2,0,-5,-42,-1,-6,7,4,0,-1,1,-1,-1,1,3,-1
KR_6776515765,420,-4,-66,-32,-3,1,1,2,-1,2,1,1,1,2,-3,3,0,-1,1,0,0,-7,-3,5,-8,3,6,0,-1,-1,-1,-1,-1,2,-1
KR_6754511530,420,-1,-4,4,1,0,0,0,1,1,2,-3,3,0,3,1,4,0,0,0,0,3,6,2,-6,4,-6,0,0,1,1,0,-1,3,-1
KR_6761045014,420,-1,-49,10,4,1,0,1,-2,4,2,1,0,1,3,0,3,1,1,2,0,9,8,4,-6,2,-1,0,-1,1,1,-1,1,6,-1
KR_6772634673,420,1,23,-15,6,4,0,4,3,3,6,1,0,1,-1,4,3,-1,2,1,0,1,131,2,-8,6,2,0,-1,1,-1,-1,1,1,-1
KR_6749946046,420,5,56,16,15,4,1,5,4,1,5,5,3,8,0,1,1,2,0,2,1,9,-3,4,-6,2,-10,0,1,-1,1,1,1,3,-1
KR_6727700249,420,-2,-55,-4,-7,-2,3,1,-8,9,1,5,0,5,-3,4,1,1,0,1,0,-2,-4,-6,-3,9,0,0,-1,1,-1,-1,1,1,-1
KR_6768161437,420,-2,28,-12,-11,-6,6,0,-6,7,1,2,2,4,0,2,2,-1,1,0,1,-13,30,-2,-6,8,1,0,-1,1,-1,-1,1,6,-1
KR_6737201389,420,0,55,-28,4,-2,2,0,1,2,3,4,0,4,-1,3,2,2,0,2,0,8,-114,-1,-5,6,5,0,1,-1,-1,-1,-1,2,-1
KR_6776534520,420,-3,-46,16,-1,-1,3,2,4,4,8,0,1,1,-4,5,1,0,0,0,0,5,-70,3,-8,5,1,0,-1,-1,1,-1,1,4,-1
KR_6744213575,420,0,9,-22,0,4,0,4,2,3,5,-4,5,1,-1,3,2,-1,1,0,0,4,27,1,-4,3,7,0,-1,-1,-1,1,-1,4,-1
KR_6777636961,420,-4,-53,-12,-7,-2,3,1,-2,4,2,-1,1,0,-2,2,0,0,3,3,1,-3,46,4,-11,7,-20,0,0,-1,1,0,1,4,-1
KR_6731624513,420,-2,-5,-10,-2,-1,1,0,-2,5,3,-1,3,2,-1,1,0,3,0,3,0,2,-49,1,-6,5,-1,0,0,0,-1,0,1,0,-1
KR_6775322612,420,-3,-27,-40,-4,-3,3,0,-2,4,2,0,1,1,1,2,3,0,0,0,1,0,-131,3,-10,7,-4,0,0,-1,-1,-1,1,5,-1
KR_6774131306,420,-3,-88,1,-10,-1,4,3,-8,9,1,-3,4,1,2,0,2,0,0,0,0,-11,-24,-3,-4,7,1,0,-1,-1,-1,-1,-1,1,-1
KR_6728515249,440,0,-4,17,2,1,1,2,2,0,2,3,0,3,-2,5,3,-2,6,4,0,1,9,6,-9,3,-1,0,0,0,1,0,1,0,-1
KR_6776674065,420,-3,-75,11,-10,0,1,1,2,2,4,-9,9,0,1,0,1,-4,5,1,0,-12,45,-2,-4,6,-5,0,1,1,1,1,-1,5,-1
KR_6773749293,420,-2,-75,-31,-11,-7,7,0,-3,6,3,1,2,3,-2,3,1,0,2,2,-1,-4,-55,-1,-2,3,3,0,-1,1,-1,-1,-1,6,-1
KR_6777695077,440,2,-7,5,2,3,3,6,2,2,4,-9,11,2,4,5,9,2,1,3,0,1,272,1,-2,1,-2,0,2,1,1,1,1,3,-1
KR_6770139144,420,-5,-95,1,-10,-1,1,0,-3,5,2,-9,10,1,-1,3,2,4,0,4,0,-10,-38,1,-7,6,1,0,-2,1,-1,-1,-1,6,-1
KR_6776935186,420,-2,-5,-1,-2,2,0,2,-6,8,2,-2,4,2,2,2,4,2,0,2,0,-4,-28,3,-6,3,3,0,0,1,1,-1,-1,3,-1
KR_6775260748,420,0,-33,-4,4,2,2,4,4,1,5,-5,6,1,4,4,8,-1,1,0,0,2,-24,-1,-4,5,2,0,1,-1,-1,1,1,3,-1
KR_6683804054,420,0,-1,44,-1,0,3,3,2,1,3,1,0,1,-3,5,2,-1,1,0,0,-1,1,0,-5,5,-5,0,-2,-1,1,-1,1,3,-1
KR_6753318899,420,-6,-45,30,-13,-2,4,2,1,1,2,-1,2,1,-9,11,2,-2,3,1,0,-15,11,-4,-4,8,4,0,0,0,0,-1,-1,0,-1
KR_6746048851,420,-4,13,-28,-4,0,1,1,-1,3,2,0,1,1,-4,6,2,1,0,1,1,-5,9,8,-10,2,-6,0,0,-1,-1,0,1,4,-1
KR_6759065155,420,0,-10,-24,-2,4,0,4,-3,5,2,-2,4,2,-1,3,2,0,0,0,0,-8,-1,0,-5,5,0,0,0,-1,1,0,-1,3,-1
KR_6777305139,420,-2,-72,-24,-3,-4,4,0,3,1,4,-1,3,2,-1,4,3,0,0,0,0,-2,9,1,-7,6,-4,0,0,0,-1,-1,-1,0,-1
KR_6750621550,420,0,-17,-16,7,-2,3,1,1,2,3,4,0,4,5,1,6,-1,1,0,0,14,0,2,-7,5,2,0,1,-1,-1,1,1,2,-1
KR_6768529107,420,-1,-1,-8,-1,2,1,3,-1,1,0,-1,1,0,-1,2,1,0,0,0,0,-3,-21,2,-6,4,-1,0,-1,1,-1,-1,1,4,-1
KR_6773878596,420,0,51,0,0,-2,3,1,-2,7,5,-1,3,2,6,1,7,-1,2,1,0,9,-191,3,-6,3,6,0,0,-1,1,0,-1,5,-1
KR_6772196726,420,-2,34,-28,-7,-3,4,1,-3,6,3,-3,3,0,4,0,4,-2,2,0,-1,-5,-1,0,-5,5,-1,0,0,-1,-1,1,-1,2,-1
KR_6772029675,420,-2,-44,39,-10,0,3,3,-7,7,0,0,0,0,-3,4,1,0,2,2,0,-10,4,-3,-1,4,-7,0,-1,-1,1,-1,1,1,-1
KR_6775699760,420,0,-49,4,-4,-3,3,0,-1,3,2,1,0,1,-1,2,1,0,0,0,0,-5,12,-1,-8,9,-1,0,-1,1,-1,-1,-1,4,-1
KR_6762131955,420,1,59,-7,2,1,1,2,3,2,5,1,0,1,-4,4,0,1,0,1,0,-2,3,3,-4,1,-2,0,1,1,1,1,1,1,-1
KR_6749374653,440,5,-33,20,7,-5,6,1,10,1,11,-3,3,0,4,0,4,1,0,1,0,16,5,3,-7,4,1,0,1,1,0,1,1,3,-1
KR_6765895601,440,0,10,4,-5,1,4,5,-1,3,2,-2,4,2,-4,6,2,1,1,2,0,-4,-509,1,-5,4,2,0,-2,1,0,-1,-1,4,-1
KR_6775889919,420,-1,-38,35,-7,-2,3,1,3,1,4,-4,4,0,-5,6,1,1,0,1,-1,-10,159,1,-4,3,-1,0,1,-1,1,1,-1,4,-1
KR_6727469625,420,2,31,4,3,-5,7,2,3,4,7,0,3,3,3,0,3,2,1,3,-2,4,14,7,-10,3,4,0,3,1,1,1,-1,5,-1
KR_6774126199,420,1,84,-6,-4,0,2,2,3,1,4,-2,4,2,-3,6,3,-2,2,0,-1,-11,-29,-5,-1,6,-3,0,0,-1,-1,-1,-1,5,-1
KR_6765645542,420,-2,-16,-24,-3,0,2,2,2,1,3,-4,5,1,-1,2,1,0,2,2,0,-1,-1,3,-6,3,-1,0,0,-1,1,0,-1,5,-1
KR_6756591582,420,0,71,-14,-4,-1,3,2,-6,7,1,-1,4,3,4,0,4,0,0,0,1,7,10,3,-11,8,6,0,1,1,-1,1,1,2,-1
KR_6777287973,420,-5,-34,-24,-12,-7,7,0,0,1,1,-5,6,1,0,3,3,0,0,0,0,-2,-36,1,-6,5,0,0,-2,1,-1,-1,1,3,-1
KR_6775768177,420,-1,-4,17,-2,0,3,3,-2,3,1,-2,4,2,1,1,2,1,0,1,0,-4,-173,-5,-4,9,6,0,2,1,-1,1,1,6,-1
KR_6777870665,420,-3,-71,-28,-12,1,1,2,-10,11,1,-1,7,6,-2,6,4,0,0,0,-2,-9,-12,-5,-5,10,4,0,-2,-1,-1,-1,-1,6,-1
KR_6777822549,420,-3,-44,-14,-8,-1,2,1,-5,5,0,-1,4,3,0,0,0,-1,1,0,0,-6,-32,-5,-4,9,14,0,-2,1,-1,-1,-1,2,-1
KR_6777589010,440,-4,-51,-10,-8,-5,5,0,-6,7,1,4,3,7,0,1,1,-1,1,0,-1,-12,-1,1,-6,5,-1,0,-1,-1,1,-1,-1,5,-1
KR_6767629605,420,-2,25,-22,-7,-4,5,1,3,4,7,-1,3,2,-7,9,2,2,0,2,-1,-5,86,-2,-5,7,2,0,1,-1,1,1,-1,1,-1
KR_6764685354,420,0,-49,9,-4,1,2,3,-3,4,1,3,1,4,-3,4,1,-2,2,0,0,-5,4,-5,-4,9,13,0,-1,-1,1,-1,1,6,-1
KR_6774946028,420,-1,-32,21,-6,-5,7,2,3,2,5,0,3,3,-1,2,1,-3,3,0,1,-10,-20,2,-10,8,-2,0,0,1,-1,-1,1,5,-1
KR_6717804676,420,-4,-52,13,-7,-1,1,0,-2,3,1,0,1,1,-1,2,1,-3,4,1,0,-6,-3,3,-7,4,-4,0,-2,1,1,-1,-1,4,-1
KR_6773773906,420,-2,-25,-7,-1,-1,5,4,-2,4,2,-1,2,1,3,1,4,0,2,2,0,-10,-7,-4,-8,12,3,0,0,1,1,0,1,2,-1
KR_6711613936,420,-3,-51,6,-10,-4,6,2,2,2,4,-1,2,1,-5,5,0,-2,3,1,0,-5,-6,-3,-6,9,-1,0,-2,1,-1,-1,-1,6,-1
KR_6761522060,440,1,-32,-8,1,5,2,7,-2,3,1,0,4,4,-2,2,0,0,0,0,-1,-1,15,-2,-1,3,1,0,0,1,1,1,-1,5,-1
KR_6762186123,420,0,-19,38,5,4,1,5,2,1,3,-1,3,2,0,2,2,0,1,1,1,1,10,2,-11,9,-4,0,0,1,0,0,1,5,-1
KR_6776555009,420,0,-57,18,2,2,0,2,3,2,5,-1,3,2,-1,5,4,-1,1,0,-1,-3,14,1,-4,3,-3,0,-1,1,1,-1,-1,6,-1
KR_6743502054,420,-6,-85,23,-15,-9,9,0,1,2,3,-3,4,1,-2,9,7,-2,2,0,-1,-7,-2,1,-6,5,0,0,-2,-1,-1,-1,-1,2,-1
KR_6776837616,420,0,-21,27,0,1,1,2,-1,1,0,0,3,3,1,2,3,-1,1,0,0,-3,-2,-4,-5,9,5,0,0,1,1,0,1,6,-1
KR_6772421923,420,2,70,-17,5,3,0,3,2,1,3,0,3,3,1,3,4,-1,2,1,0,-2,-42,-1,-4,5,2,0,0,-1,1,0,1,6,-1
KR_6708493690,420,1,34,8,-4,-3,4,1,3,4,7,-4,5,1,0,5,5,0,1,1,0,-5,10,-2,-7,9,-1,0,1,-1,-1,1,1,1,-1
KR_6767509519,420,-3,-24,-20,-5,4,1,5,-5,6,1,0,2,2,-3,3,0,-1,2,1,0,-13,-9,-8,-6,14,3,0,0,-1,1,1,-1,6,-1
KR_6752337404,420,-1,9,-26,-3,-1,3,2,-3,5,2,4,3,7,-3,5,2,0,0,0,-1,-4,-5,-3,-3,6,-1,0,0,-1,-1,1,-1,5,-1
KR_6761990653,420,4,76,4,6,0,1,1,2,0,2,-1,1,0,4,2,6,1,1,2,0,4,-27,-3,-2,5,1,0,0,-1,-1,0,1,4,-1
KR_6776193977,420,3,62,10,4,-2,2,0,-1,3,2,-1,3,2,6,2,8,2,0,2,0,5,-2,-1,-8,9,2,0,0,1,-1,1,-1,5,-1
KR_6763738912,420,1,-19,-37,-3,-3,3,0,-1,4,3,1,4,5,0,2,2,0,0,0,0,-2,4,-4,-6,10,-2,0,0,-1,-1,-1,-1,5,-1
KR_6758419262,420,-1,68,7,-2,2,1,3,-2,5,3,1,0,1,-3,3,0,0,1,1,0,-10,58,5,-10,5,6,0,1,-1,1,1,1,4,-1
KR_6777278907,420,-3,22,-8,-12,-3,5,2,-9,9,0,3,2,5,-3,4,1,0,1,1,0,-21,1,-3,-4,7,-3,0,-1,-1,-1,-1,1,1,-1
KR_6751081118,420,-6,-38,-24,-19,-5,7,2,-3,5,2,-6,7,1,0,2,2,-5,6,1,0,-18,-19,3,-7,4,-3,0,-1,-1,-1,-1,1,2,-1
KR_6761346420,420,0,-16,33,2,0,1,1,-1,5,4,0,4,4,3,0,3,0,0,0,-1,5,-271,0,-9,9,-5,0,-1,-1,1,-1,-1,2,-1
KR_6776803596,420,-5,23,8,-9,-2,2,0,-2,3,1,1,1,2,-7,9,2,1,0,1,0,-10,8,-2,-3,5,-2,0,1,1,-1,-1,-1,1,-1
KR_6717687756,420,-3,-53,-38,-11,-3,3,0,-8,8,0,1,1,2,1,2,3,-2,3,1,0,-7,14,-6,-4,10,2,0,-2,-1,-1,-1,-1,4,-1
KR_6743794571,420,-3,8,3,-10,0,1,1,-8,13,5,-1,1,0,0,1,1,-1,1,0,0,-13,0,-2,-6,8,-1,0,-1,1,-1,1,-1,4,-1
KR_6777090485,420,1,-19,10,-4,3,1,4,1,2,3,-2,4,2,-7,8,1,1,1,2,-1,-2,-6,-3,-5,8,2,0,-1,1,1,-1,-1,2,-1
KR_6770509463,420,-1,-11,16,0,-3,4,1,0,0,0,-1,4,3,3,0,3,1,1,2,0,4,-7,0,-6,6,5,0,-1,-1,-1,-1,-1,4,-1
KR_6741810805,440,2,19,-3,1,-6,7,1,0,4,4,0,1,1,6,1,7,1,2,3,0,5,-16,0,-6,6,-5,0,-1,1,1,-1,1,4,-1
KR_6759157417,420,-1,42,-57,-4,0,1,1,-1,4,3,-4,4,0,2,0,2,-1,1,0,0,-6,-103,-5,-6,11,14,0,-1,-1,-1,-1,-1,3,-1
KR_6776069127,420,0,-1,8,-6,-2,2,0,-9,9,0,2,1,3,3,2,5,0,2,2,2,1,-14,-4,-7,11,7,0,-1,-1,-1,-1,1,5,-1
KR_6772871688,420,-1,-14,-24,-6,3,0,3,-1,3,2,-2,4,2,-4,4,0,-2,2,0,0,-14,-9,-3,-7,10,-7,0,0,-1,-1,-1,-1,6,-1
KR_6774356365,420,-3,-56,-35,-10,1,3,4,-1,3,2,-3,6,3,-7,9,2,0,1,1,0,1,-29,-6,0,6,4,0,0,-1,-1,0,-1,1,-1
KR_6764590437,420,1,20,16,3,0,4,4,3,4,7,1,1,2,-1,3,2,0,0,0,0,-9,4,1,-8,7,-2,0,1,-1,1,1,1,3,-1
KR_6755570107,420,-2,-66,-28,-8,1,1,2,-1,3,2,-2,2,0,-2,5,3,-4,4,0,0,-12,-27,2,-8,6,-3,0,0,-1,0,-1,1,3,-1
KR_6767527623,420,4,25,6,7,-2,4,2,7,1,8,1,1,2,4,1,5,-3,3,0,1,11,-18,-3,-7,10,4,0,0,1,1,1,-1,2,-1
KR_6748748646,420,-3,-113,-17,-5,-2,4,2,0,3,3,-6,6,0,4,1,5,-1,1,0,0,4,24,3,-6,3,-6,0,-2,-1,-1,-1,-1,2,-1
KR_6754451262,420,-7,-132,-8,-19,-7,8,1,-3,5,2,-2,2,0,-9,9,0,2,0,2,0,-8,-17,-1,-5,6,5,0,-5,-1,-1,-1,-1,1,-1
KR_6720465304,420,2,-32,31,6,3,0,3,5,1,6,3,0,3,-2,4,2,-3,3,0,0,13,-228,-1,-7,8,3,0,1,-1,1,1,1,6,-1
KR_6747417856,420,-1,-71,-1,-5,-1,1,0,1,3,4,-1,2,1,-5,5,0,1,1,2,0,-6,-8,-5,-2,7,7,0,-1,1,-1,-1,-1,5,-1
KR_6737866421,420,-5,-65,8,-16,-1,4,3,-3,4,1,-3,5,2,-2,2,0,-7,8,1,-2,-21,54,6,-10,4,-7,0,-2,0,-1,-1,-1,0,-1
KR_6717157649,420,2,46,0,-2,-4,4,0,0,2,2,-2,9,7,2,1,3,2,0,2,0,-2,16,7,-9,2,-3,0,0,1,-1,-1,-1,5,-1
KR_6777633858,420,-2,37,22,-2,-3,4,1,-4,4,0,2,1,3,1,3,4,2,0,2,0,-7,100,-3,-4,7,3,0,-1,-1,-1,-1,-1,6,-1
KR_6771004988,420,-4,-53,-40,-12,-8,10,2,-3,5,2,-5,6,1,5,0,5,-1,2,1,-3,-17,9,5,-11,6,-7,0,-3,-1,-1,-1,-1,3,-1
KR_6755807901,420,-4,-72,-23,-8,-5,6,1,0,3,3,-3,4,1,0,4,4,0,2,2,0,-12,2,-6,-2,8,-2,0,-2,-1,1,-1,-1,4,-1
KR_6775516984,420,-3,-4,-19,-4,-5,6,1,2,1,3,0,0,0,-1,3,2,0,1,1,0,-1,11,4,-8,4,-1,0,-1,1,1,-1,1,1,-1
KR_6776540566,420,-3,-20,-22,-8,-6,8,2,-1,4,3,0,2,2,-3,5,2,2,2,4,-1,1,-15,-6,-4,10,1,0,-1,0,-1,-1,-1,0,-1
KR_6769578323,420,-2,-4,-36,-11,-1,1,0,-2,3,1,-6,7,1,-3,4,1,1,0,1,0,-13,-34,-3,-6,9,-4,0,-1,-1,-1,-1,-1,3,-1
KR_6759575651,420,-1,-4,-12,-7,3,0,3,-3,4,1,1,0,1,-6,6,0,-2,2,0,-1,-15,-28,3,-9,6,-4,0,0,-1,0,-1,-1,2,-1
KR_6760226029,420,-2,-12,-57,0,-5,5,0,2,2,4,4,0,4,2,4,6,-3,4,1,0,1,14,3,-7,4,2,0,-1,-1,-1,-1,1,6,-1
KR_6752797601,420,-5,-38,-50,-5,1,2,3,1,1,2,-1,2,1,-3,4,1,-3,5,2,0,-6,0,2,-5,3,-4,0,0,-1,1,-1,-1,3,-1
KR_6774131898,420,0,-17,-6,-1,1,0,1,2,2,4,4,3,7,-6,7,1,-2,3,1,0,-9,-4,-2,-2,4,1,0,0,-1,1,-1,1,2,-1
KR_6774035650,420,-2,-26,-25,4,0,1,1,-2,2,0,1,1,2,5,2,7,0,0,0,0,10,-3,0,-6,6,2,0,0,-1,-1,-1,-1,5,-1
KR_6772687208,420,1,-3,-20,4,2,0,2,-4,4,0,6,1,7,-1,4,3,1,1,2,0,3,-1,2,-7,5,-1,0,0,0,1,0,1,0,-1
KR_6775051520,420,-4,-57,-8,-9,-5,5,0,-2,5,3,-3,4,1,4,1,5,-3,3,0,0,-3,3,2,-6,4,-4,0,-1,-1,-1,-1,-1,6,-1
KR_6750910404,420,2,25,-5,-1,1,4,5,0,2,2,2,2,4,-4,4,0,0,0,0,0,-3,-1,3,-6,3,0,0,0,0,-1,0,-1,0,-1
KR_6748175444,420,1,-20,-3,-3,0,1,1,1,0,1,0,3,3,-5,8,3,1,0,1,0,-6,41,-1,-6,7,-3,0,-1,1,-1,-1,1,3,-1
KR_6777530577,420,1,-10,29,5,4,1,5,-2,3,1,2,2,4,1,4,5,0,0,0,0,-2,-11,0,-6,6,-2,0,1,-1,1,1,-1,3,-1
KR_6774813167,420,3,42,16,-5,2,1,3,-2,3,1,1,2,3,0,0,0,-6,6,0,0,-9,15,1,-7,6,0,0,0,-1,-1,0,-1,3,-1
KR_6776944570,440,1,-8,-19,6,-1,1,0,3,2,5,2,0,2,2,3,5,0,1,1,0,1,5,3,-6,3,5,0,1,1,1,1,1,2,-1
KR_6771730266,420,-7,-91,-8,-14,-9,10,1,0,0,0,-3,4,1,-1,2,1,-1,1,0,0,-12,-2,-2,-4,6,-4,0,-2,-1,-1,-1,-1,4,-1
KR_6772670977,420,1,6,-6,8,-3,5,2,5,2,7,2,3,5,4,0,4,0,2,2,0,15,7,4,-8,4,-5,0,0,-1,0,0,-1,1,-1
KR_6670542161,420,0,-54,-3,-2,-1,2,1,-1,1,0,3,0,3,-5,6,1,2,0,2,0,-3,-2,-5,-2,7,-2,0,-1,-1,-1,-1,1,3,-1
KR_6692429207,420,0,-41,-10,2,-1,3,2,0,2,2,2,1,3,-2,5,3,3,0,3,0,7,-5,4,-9,5,4,0,1,1,1,1,-1,2,-1
KR_6774127588,420,0,12,-9,1,-1,1,0,0,2,2,-1,3,2,4,2,6,-1,1,0,1,-1,-20,0,-7,7,0,0,0,1,-1,1,1,5,-1
KR_6767766971,420,-1,16,-20,0,3,1,4,-1,6,5,0,3,3,-1,3,2,-1,1,0,0,-9,-70,1,-7,6,-5,0,4,-1,1,1,1,1,-1
KR_6760076215,420,-4,-74,-16,-11,-2,2,0,-3,6,3,0,3,3,-4,5,1,-2,2,0,0,-14,-62,3,-4,1,2,0,0,-1,1,-1,1,3,-1
KR_6675582501,420,1,67,-9,0,-2,2,0,1,4,5,-4,5,1,5,0,5,0,0,0,0,2,-3,-2,-5,7,1,0,0,-1,-1,-1,-1,2,-1
KR_6773340917,420,-1,-38,-24,-5,1,0,1,-1,2,1,1,0,1,-4,5,1,-2,2,0,0,-6,-4,1,-4,3,-4,0,-2,-1,-1,-1,-1,1,-1
KR_6712317486,420,-6,-77,-16,-10,-3,3,0,-4,7,3,-5,5,0,1,2,3,1,0,1,-2,-6,-4,-4,-4,8,-3,0,-1,-1,-1,-1,-1,3,-1
KR_6762886490,420,-4,-38,-16,-6,-2,2,0,-3,4,1,0,2,2,-1,3,2,0,1,1,0,-7,1,2,-4,2,-4,0,-2,-1,-1,-1,1,3,-1
KR_6773284283,420,-1,13,-18,-5,2,1,3,-1,6,5,-4,5,1,-3,3,0,1,0,1,0,-15,-8,2,-8,6,-6,0,0,1,-1,0,-1,2,-1
KR_6730163444,420,-1,64,-20,-14,-2,5,3,-4,7,3,-3,6,3,-7,10,3,2,0,2,0,-34,-1,3,-11,8,-3,0,0,-1,-1,-1,-1,4,-1
KR_6774581801,420,-5,-46,-18,-13,0,2,2,-10,11,1,0,4,4,-3,3,0,0,0,0,0,-21,-15,3,-5,2,1,0,-2,-1,-1,-1,-1,6,-1
KR_6772749987,420,0,13,10,-2,-6,8,2,-1,4,3,3,2,5,1,6,7,1,2,3,0,-4,-22,3,-6,3,1,0,-1,1,0,-1,1,4,-1
KR_6706462971,420,4,53,31,-1,1,1,2,-3,7,4,3,1,4,-1,2,1,-1,1,0,0,-6,15,5,-9,4,-1,0,1,1,-1,1,-1,3,-1
KR_6756558334,420,4,2,28,3,1,4,5,-1,2,1,5,2,7,-1,2,1,-1,1,0,0,8,4,2,-6,4,-4,0,0,1,1,0,-1,5,-1
KR_6762303501,420,-3,-102,-24,-6,2,1,3,-9,10,1,1,1,2,1,3,4,-1,3,2,0,-5,11,0,-5,5,-5,0,-1,-1,-1,-1,-1,3,-1
KR_6723575411,420,0,20,-48,6,-3,5,2,6,2,8,0,3,3,2,3,5,1,2,3,-2,4,-2,3,-9,6,-1,0,0,1,1,0,-1,3,-1
KR_6777302802,420,0,33,-21,1,-1,5,4,-4,6,2,4,1,5,3,2,5,-1,1,0,0,4,-4,0,-9,9,-1,0,1,-1,-1,-1,-1,6,-1
KR_6772360976,420,-1,-57,11,-5,-1,4,3,3,2,5,-3,5,2,-4,4,0,0,0,0,0,1,10,5,-7,2,0,0,0,-1,1,1,-1,1,-1
KR_6757160122,420,-2,-77,7,3,0,1,1,-3,3,0,1,2,3,4,0,4,1,0,1,0,-4,4,-1,-6,7,3,0,0,1,1,-1,-1,2,-1
KR_6777121629,420,-2,-100,20,-6,-3,4,1,-3,6,3,5,0,5,-5,5,0,0,0,0,0,-10,-9,-7,-2,9,-4,0,-2,1,-1,-1,1,1,-1
KR_6742051043,420,0,21,9,-6,-4,4,0,-1,5,4,1,4,5,0,3,3,-2,4,2,0,-6,-44,-4,-6,10,1,0,-1,0,-1,-1,-1,0,-1
KR_6725891199,420,0,56,-19,-4,3,0,3,-3,7,4,-1,4,3,-4,6,2,1,2,3,0,-7,0,-1,-6,7,2,0,1,-1,-1,1,1,1,-1
KR_6774247522,420,-3,-36,4,-9,-1,2,1,-1,6,5,-6,9,3,1,4,5,-2,3,1,0,-18,-8,0,-6,6,3,0,0,1,-1,0,-1,3,-1
KR_6741578951,420,-1,37,11,0,2,0,2,-2,5,3,-2,8,6,1,1,2,1,0,1,0,-6,-30,3,-6,3,17,0,-1,-1,0,-1,1,1,-1
KR_6723529686,420,-4,13,-24,-12,2,1,3,-1,5,4,-6,8,2,-6,8,2,-1,1,0,2,-9,15,3,-11,8,-5,0,0,-1,-1,-1,1,1,-1
KR_6775441405,420,-5,30,-28,-12,-1,1,0,-1,1,0,-9,10,1,-1,6,5,0,0,0,1,-19,7,-1,-6,7,-2,0,-1,-1,-1,-1,1,4,-1
KR_6774678039,420,-6,-39,-20,-12,-1,2,1,-4,4,0,-6,7,1,-1,4,3,0,1,1,0,-12,-35,-8,-1,9,-3,0,0,-1,-1,-1,1,1,-1
KR_6765241166,420,-2,-27,-4,-14,1,1,2,-5,6,1,-3,3,0,-7,8,1,0,1,1,0,-19,-5,-2,-2,4,-1,0,0,-1,1,-1,-1,6,-1
KR_6748202667,420,-2,-27,-4,-8,-1,3,2,0,3,3,-1,2,1,-6,6,0,0,0,0,0,-7,-8,0,-7,7,3,0,-2,-1,1,-1,-1,5,-1
KR_6730193759,440,-4,-87,24,-10,-5,6,1,-1,2,1,0,3,3,0,1,1,-4,4,0,0,2,5,2,-4,2,-6,0,-2,-1,0,-1,1,4,-1
KR_6770823442,420,-2,-33,-11,-2,1,1,2,-1,2,1,-2,3,1,1,2,3,-1,2,1,0,-5,23,5,-9,4,3,0,-1,1,-1,-1,-1,1,-1
KR_6775418733,420,-2,-25,-10,2,0,2,2,1,2,3,-2,4,2,3,3,6,0,2,2,2,7,5,3,-8,5,-6,0,-1,0,-1,-1,1,0,-1
KR_6773137420,420,-4,-36,15,-15,-6,7,1,-5,7,2,-2,4,2,-1,1,0,-1,1,0,-3,-20,262,-7,-2,9,4,0,0,1,-1,-1,-1,4,-1
KR_6763707619,420,-1,-54,25,1,-4,5,1,-5,5,0,4,1,5,5,1,6,1,0,1,0,2,-5,-4,-5,9,7,0,-1,1,-1,-1,1,5,-1
KR_6738152583,420,0,-18,24,1,-3,4,1,5,1,6,-3,3,0,1,2,3,1,1,2,0,8,300,-7,-3,10,3,0,0,1,1,-1,-1,5,-1
KR_6595235615,420,-3,-44,5,-4,-1,2,1,-5,10,5,0,3,3,3,3,6,-1,2,1,0,-3,-118,-4,-7,11,-1,0,-3,1,-1,-1,1,1,-1
KR_6756647934,440,-1,8,-1,-1,-1,2,1,3,1,4,1,0,1,-1,5,4,-3,3,0,0,-3,-16,-1,-6,7,-2,0,0,1,-1,0,1,5,-1
KR_6777803929,420,-2,-17,15,-5,0,0,0,-3,3,0,1,1,2,-2,6,4,-1,2,1,0,-9,-5,-2,-4,6,4,0,1,-1,1,1,1,6,-1
KR_6767877047,420,1,11,6,-6,4,0,4,-4,4,0,3,3,6,-6,7,1,-3,3,0,-2,-21,9,3,-8,5,3,0,0,-1,1,1,-1,3,-1
KR_6716184308,420,-3,30,16,-9,-4,6,2,2,1,3,-4,4,0,-1,3,2,-2,2,0,0,-13,-33,-1,-3,4,1,0,0,-1,-1,0,-1,3,-1
KR_6762127846,420,-4,-90,11,-13,-2,3,1,2,2,4,-6,6,0,-6,8,2,-1,1,0,0,-10,-4,-4,0,4,-3,0,-3,-1,-1,-1,-1,5,-1
KR_6704318542,420,0,0,0,-4,2,1,3,-3,6,3,0,2,2,-3,3,0,0,0,0,0,-6,31,3,-9,6,-3,0,-1,-1,-1,-1,-1,5,-1
KR_6762002566,420,-3,-47,-20,-5,-1,1,0,-3,5,2,5,0,5,-6,6,0,0,0,0,0,-10,-22,3,-6,3,-3,0,0,-1,1,1,1,3,-1
KR_6772625146,420,-1,25,-24,-6,-2,4,2,-3,6,3,-1,4,3,0,2,2,0,0,0,0,0,-5,-5,-3,8,0,0,0,-1,-1,-1,1,4,-1
KR_6751140755,420,1,4,-3,-1,5,1,6,-2,5,3,1,0,1,-5,5,0,0,0,0,0,-4,-13,1,-6,5,-5,0,-1,1,1,-1,1,3,-1
KR_6770028735,420,0,75,-23,-3,4,1,5,1,1,2,-1,2,1,-1,4,3,-6,7,1,0,-9,-7,1,-5,4,2,0,1,-1,-1,1,1,5,-1
KR_6768720847,420,1,6,17,-4,-5,7,2,0,0,0,6,1,7,-3,4,1,-2,2,0,0,-8,-2,0,-5,5,-1,0,-1,1,-1,-1,-1,4,-1
KR_6773905426,420,1,-65,18,-10,-1,1,0,-2,4,2,0,4,4,-5,5,0,-2,3,1,-3,-24,5,0,-9,9,-7,0,-2,-1,1,-1,-1,3,-1
KR_6775858804,420,0,-67,4,-5,-2,4,2,0,1,1,-2,3,1,0,1,1,-1,2,1,0,-3,-12,-1,-4,5,-5,0,0,1,-1,-1,-1,4,-1
KR_6736424700,420,0,-27,3,2,1,0,1,-2,4,2,-1,1,0,1,1,2,3,0,3,-1,6,5,-4,-4,8,1,0,0,-1,-1,0,-1,5,-1
KR_6765087859,420,-7,-155,-40,-5,4,1,5,-1,4,3,-2,2,0,-8,9,1,2,1,3,-1,-10,-14,-9,-3,12,5,0,-3,1,-1,-1,-1,2,-1
KR_6767541415,420,-2,-41,0,-10,-4,4,0,0,3,3,-2,4,2,-3,5,2,-1,1,0,0,-14,-5,-4,-4,8,2,0,-1,1,-1,-1,-1,2,-1
KR_6774121596,420,-1,18,-12,-3,-1,3,2,-7,9,2,-2,5,3,5,1,6,2,0,2,0,-5,12,2,-6,4,-7,0,0,-1,-1,-1,1,3,-1
KR_6773939676,420,-3,-59,-26,-7,-3,3,0,2,1,3,1,2,3,-2,2,0,-5,5,0,0,-6,-217,0,-5,5,3,0,0,-1,-1,-1,-1,3,-1
KR_6737629160,420,-1,60,5,-7,-3,4,1,-6,6,0,2,2,4,0,4,4,0,1,1,-1,-17,-65,-5,-5,10,5,0,1,-1,1,1,-1,6,-1
KR_6775247519,420,1,-13,-24,6,-2,2,0,5,1,6,4,1,5,0,1,1,-1,1,0,-1,10,-11,-4,-2,6,-1,0,-1,-1,-1,-1,-1,3,-1
KR_6748108716,420,-2,-40,-1,-5,-3,3,0,2,0,2,-1,1,0,0,2,2,-3,3,0,0,-4,44,4,-8,4,4,0,0,-1,-1,0,1,5,-1
KR_6774056492,420,-2,4,-16,-7,-4,4,0,4,0,4,-11,12,1,3,0,3,1,0,1,0,-17,-5,-1,-1,2,0,0,0,-1,-1,0,-1,4,-1
KR_6722264286,420,-7,-39,-38,-22,-1,4,3,-9,11,2,-12,12,0,-1,3,2,1,0,1,-5,-22,-1,-1,-4,5,-5,0,-2,-1,-1,-1,-1,3,-1
KR_6765730308,420,0,-26,0,3,3,2,5,3,0,3,-2,2,0,-3,4,1,2,0,2,0,6,38,1,-7,6,4,0,0,-1,1,1,1,1,-1
KR_6760771799,420,-1,-32,24,-10,0,1,1,-1,2,1,-8,9,1,-4,4,0,3,0,3,1,-12,-16,-5,-2,7,0,0,-2,-1,-1,-1,1,1,-1
KR_6773635807,440,0,76,14,0,6,2,8,-2,3,1,2,2,4,-5,6,1,-1,3,2,1,-15,3,4,-8,4,-2,0,0,0,0,1,1,0,-1
KR_6772417139,420,-2,-30,-21,-4,0,1,1,-4,6,2,2,3,5,-3,6,3,1,0,1,0,-2,-1,-2,-3,5,8,0,-1,-1,1,-1,-1,2,-1
KR_6776016145,420,1,-13,17,-8,-3,3,0,4,0,4,-3,5,2,-4,7,3,-2,2,0,0,-10,10,-1,-7,8,-2,0,0,-1,-1,1,-1,2,-1
KR_6768028587,420,-5,-4,-21,-14,-3,5,2,-9,11,2,0,3,3,-3,5,2,1,0,1,-3,-17,-12,0,-5,5,4,0,0,-1,1,1,-1,2,-1
KR_6752198774,420,-3,26,-11,-10,2,2,4,-5,6,1,-3,5,2,-3,4,1,-1,2,1,0,-15,-17,-2,-4,6,4,0,-2,-1,-1,-1,-1,5,-1
KR_6722800010,420,2,33,14,6,3,1,4,0,2,2,4,1,5,-1,3,2,0,2,2,0,-2,7,4,-6,2,1,0,0,-1,1,-1,1,3,-1
KR_6733833801,420,1,-11,11,1,-2,2,0,-1,4,3,4,0,4,-1,3,2,1,0,1,0,-6,-3,0,-8,8,0,0,1,-1,1,1,-1,2,-1
KR_6739828145,420,-3,-39,8,-7,-2,2,0,-2,2,0,-5,6,1,2,2,4,0,1,1,0,-3,-104,-3,-4,7,-4,0,-1,-1,-1,-1,-1,2,-1
KR_6745955543,420,-3,-44,-28,-5,0,3,3,2,5,7,-6,7,1,1,2,3,-2,4,2,-1,-14,12,-2,-4,6,-4,0,-2,-1,-1,-1,-1,1,-1
KR_6772372682,420,-5,-21,-11,-3,-2,3,1,2,0,2,1,1,2,-4,7,3,0,1,1,0,-2,-45,-2,-1,3,20,0,-2,-1,1,-1,1,6,-1
KR_6771848039,420,0,-15,26,-2,2,0,2,2,1,3,-3,3,0,-4,9,5,1,0,1,0,6,-9,-3,-2,5,2,0,-1,-1,-1,-1,1,3,-1
KR_6764770192,420,-1,5,-5,2,-5,5,0,2,1,3,2,1,3,2,0,2,1,0,1,0,6,-15,0,-3,3,2,0,0,1,-1,-1,1,3,-1
KR_6688017072,420,-1,-26,-20,-2,-7,7,0,5,1,6,-1,4,3,-1,5,4,2,0,2,0,10,-13,-5,-2,7,1,0,0,-1,1,-1,1,2,-1
KR_6777247800,420,-3,-32,-31,-2,-4,4,0,4,0,4,-4,6,2,0,3,3,2,0,2,1,4,-292,1,-8,7,-1,0,-1,-1,-1,-1,1,5,-1
KR_6771067744,420,0,32,14,-13,-4,4,0,-3,6,3,-1,3,2,-4,4,0,-1,3,2,0,-13,5,2,-6,4,-3,0,-1,-1,-1,-1,-1,6,-1
KR_6776287259,420,-3,-67,-7,-2,-1,2,1,0,2,2,2,1,3,-5,7,2,2,1,3,0,0,13,0,-5,5,0,0,-1,-1,-1,-1,-1,1,-1
KR_6757977816,420,-8,-64,-31,-22,2,2,4,-14,15,1,-6,6,0,-3,4,1,-1,2,1,0,-21,81,4,-8,4,-3,0,-2,-1,-1,-1,-1,5,-1
KR_6773575727,420,-4,-41,-21,-8,-3,4,1,3,1,4,-6,7,1,3,1,4,-5,5,0,0,-8,-4,-1,-4,5,0,0,-1,1,-1,-1,-1,2,-1
KR_6743656603,420,-8,-92,-44,-10,-5,7,2,-7,7,0,2,1,3,0,1,1,0,0,0,0,-4,39,-3,-5,8,1,0,-3,-1,-1,-1,-1,2,-1
KR_6728056974,420,0,4,-4,1,1,2,3,-2,5,3,0,4,4,1,2,3,1,0,1,0,1,-2,2,-7,5,4,0,-1,1,-1,-1,-1,3,-1
KR_6749528580,420,0,10,4,-6,0,2,2,-2,3,1,-2,3,1,-3,5,2,1,0,1,0,-14,17,-6,-2,8,-2,0,-1,1,-1,-1,-1,5,-1
KR_6765990152,440,0,9,0,-5,1,0,1,1,1,2,1,0,1,-8,8,0,0,1,1,0,-6,-5,0,-5,5,-3,0,0,-1,-1,-1,1,6,-1
KR_6755671831,420,3,24,30,2,3,2,5,3,0,3,-5,9,4,-1,1,0,2,1,3,0,-4,48,2,-5,3,-26,0,0,-1,1,1,1,3,-1
KR_6720515021,420,1,-29,4,0,-1,2,1,3,2,5,2,0,2,-3,4,1,-1,2,1,-2,-5,10,2,-9,7,-3,0,-1,-1,-1,-1,-1,5,-1
KR_6777176882,420,-1,-24,0,-9,-3,5,2,-2,4,2,1,1,2,-5,9,4,0,2,2,-1,-8,-33,2,-5,3,-1,0,-2,-1,-1,-1,-1,6,-1
KR_6772966889,420,-3,-22,-2,-13,-7,7,0,-3,3,0,-1,2,1,-4,5,1,2,1,3,0,-5,-26,-3,-3,6,5,0,-2,-1,-1,-1,-1,1,-1
KR_6733185915,420,-2,6,-19,-4,-3,4,1,-6,7,1,5,2,7,2,2,4,-2,2,0,0,-7,-9,-5,-3,8,1,0,1,-1,-1,1,-1,2,-1
KR_6768289234,420,1,-18,32,-5,3,0,3,0,1,1,-3,5,2,-4,6,2,-1,1,0,0,-4,11,1,-8,7,-8,0,0,-1,1,0,-1,5,-1
KR_6776512286,420,0,-68,-13,5,2,0,2,4,5,9,0,3,3,-1,4,3,0,0,0,0,2,-10,0,-9,9,2,0,0,1,1,-1,1,2,-1
KR_6656843431,420,0,-17,0,-2,1,0,1,-1,3,2,-1,4,3,-1,1,0,0,0,0,0,-2,-5,-5,-3,8,-1,0,0,-1,1,0,1,2,-1
KR_6772447435,420,-2,22,8,-6,0,0,0,1,1,2,-2,4,2,-6,6,0,1,1,2,0,-10,-18,-2,-2,4,-1,0,-2,-1,1,1,1,4,-1
KR_6737240157,440,-1,-25,19,-3,-1,2,1,5,1,6,-4,7,3,-2,4,2,-1,2,1,-1,-4,6,0,-5,5,2,0,0,1,-1,-1,-1,2,-1
KR_6773093582,420,-3,-23,-17,-7,-2,2,0,-3,5,2,-2,2,0,1,3,4,-1,1,0,0,-6,-7,5,-9,4,1,0,0,1,-1,0,-1,2,-1
KR_6725846284,420,-4,2,-8,-6,1,2,3,1,6,7,-2,3,1,-3,3,0,-3,3,0,-1,0,2,2,-8,6,6,0,0,-1,1,1,-1,6,-1
KR_6776609264,420,-2,118,-20,-3,1,2,3,-2,3,1,2,2,4,-4,7,3,0,0,0,0,-10,-48,-4,-2,6,-8,0,1,1,1,1,1,1,-1
KR_6718682830,420,-1,-29,37,-1,-1,2,1,0,1,1,4,1,5,-4,5,1,0,1,1,1,-3,-2,-5,-3,8,-2,0,1,1,1,1,1,5,-1
KR_6759679104,420,-1,-59,-1,-1,-2,2,0,1,4,5,0,3,3,0,2,2,0,1,1,0,1,-32,0,-7,7,1,0,-1,1,1,1,-1,5,-1
KR_6759400161,420,0,60,4,0,-3,5,2,3,6,9,1,2,3,2,2,4,-3,4,1,1,-1,33,0,-5,5,-1,0,1,0,1,1,1,0,-1
KR_6723464576,420,-3,-17,12,-5,3,3,6,0,1,1,0,3,3,-8,10,2,0,3,3,0,-12,-4,-4,-5,9,0,0,0,-1,1,1,-1,1,-1
KR_6733307701,440,-10,-161,-46,-25,-3,4,1,-4,6,2,-7,7,0,-7,7,0,-4,5,1,-1,-18,17,-2,-3,5,-9,0,-3,-1,-1,-1,-1,3,-1
KR_6769132917,420,-5,-102,-4,-9,-5,5,0,2,0,2,-1,4,3,-1,3,2,-4,4,0,0,-3,-4,-2,-4,6,3,0,-1,-1,1,-1,-1,5,-1
KR_6762226662,420,1,0,-11,2,2,1,3,-3,5,2,4,1,5,0,2,2,-1,1,0,0,-5,-2,-2,-5,7,1,0,1,-1,1,1,1,3,-1
KR_6773593741,420,-3,-43,9,-3,1,0,1,-6,8,2,1,3,4,-2,4,2,3,1,4,0,-1,-297,4,-8,4,3,0,0,1,1,0,-1,6,-1
KR_6768871495,420,3,84,-46,7,1,0,1,-1,5,4,4,1,5,4,3,7,-1,2,1,0,16,1,-4,-5,9,3,0,1,1,-1,1,-1,5,-1
KR_6727849046,420,-3,-82,-31,-7,-2,2,0,-3,4,1,0,2,2,-2,4,2,0,2,2,0,-5,32,0,-7,7,-1,0,0,-1,-1,0,-1,2,-1
KR_6773973025,420,-4,-49,-28,-8,0,1,1,0,4,4,-6,6,0,-2,3,1,0,1,1,-2,-9,-20,2,-9,7,-5,0,-1,-1,-1,-1,-1,3,-1
KR_6749493133,440,2,-108,30,8,-2,3,1,3,2,5,2,2,4,2,0,2,3,3,6,1,11,34,0,-6,6,-3,0,1,-1,1,1,1,5,-1
KR_6775851590,420,-5,-38,7,-4,-1,1,0,1,4,5,3,1,4,-6,7,1,-1,1,0,0,-4,2,2,-9,7,-9,0,-1,-1,-1,-1,-1,4,-1
KR_6774884161,420,0,20,-32,0,5,0,5,-3,4,1,0,0,0,-2,2,0,0,4,4,0,-4,-4,0,-5,5,2,0,-1,-1,-1,-1,1,3,-1
KR_6776791008,420,-1,-12,22,-6,-1,2,1,-1,3,2,1,2,3,-5,6,1,0,1,1,0,-9,-5,-2,-5,7,2,0,-1,-1,1,-1,-1,6,-1
KR_6775624555,420,2,-16,-5,2,-2,2,0,2,3,5,0,1,1,1,1,2,1,1,2,1,9,-9,2,-6,4,1,0,0,1,1,1,1,4,-1
KR_6771620989,420,-1,10,-5,-2,-4,4,0,0,3,3,-1,1,0,2,3,5,1,0,1,0,0,-17,0,-4,4,3,0,-1,-1,-1,-1,1,6,-1
KR_6762287987,420,-2,-39,-44,-5,-1,1,0,-5,5,0,-1,2,1,2,3,5,0,0,0,0,-5,-30,-1,-5,6,-2,0,-1,1,-1,-1,-1,1,-1
KR_6738376479,420,-9,-63,-56,-16,-6,6,0,-2,5,3,-2,3,1,-4,4,0,-2,2,0,0,-12,-9,0,-4,4,-2,0,-3,1,1,-1,-1,3,-1
KR_6756696592,420,-1,-27,-11,3,1,0,1,3,2,5,-4,5,1,6,1,7,-3,4,1,1,-1,-9,-7,-2,9,2,0,0,-1,-1,0,1,6,-1
KR_6777453486,420,-2,-44,-32,2,0,1,1,1,1,2,2,0,2,0,1,1,-1,2,1,0,3,110,1,-5,4,-3,0,-1,-1,1,-1,1,3,-1
KR_6771627372,420,-4,-59,-8,-9,-3,5,2,-4,5,1,1,1,2,-5,6,1,2,0,2,0,-4,-18,-2,-2,4,1,0,-2,1,1,-1,-1,6,-1
KR_6773302384,440,-2,-3,-35,-6,0,1,1,-1,4,3,-2,2,0,2,1,3,-5,5,0,0,-5,-19,3,-5,2,-2,0,0,-1,1,0,1,4,-1
KR_6775860430,420,-1,-42,-39,-1,3,2,5,-4,6,2,-2,6,4,2,5,7,0,1,1,0,16,-56,-7,-3,10,0,0,-2,-1,-1,-1,1,1,-1
KR_6772321169,420,-3,22,-4,-11,1,2,3,-4,4,0,-2,2,0,-7,7,0,1,0,1,0,-15,18,-1,-3,4,5,0,-2,-1,-1,-1,-1,5,-1
KR_6694680930,420,-3,-64,12,-7,0,2,2,-4,8,4,-4,5,1,-3,4,1,4,0,4,0,-8,8,2,-7,5,-7,0,-1,1,-1,-1,1,4,-1
KR_6767506045,420,-3,-88,4,-6,-2,4,2,-1,5,4,-1,1,0,0,3,3,-2,2,0,0,-9,-3,-1,-9,10,1,0,-2,1,-1,-1,-1,4,-1
KR_6768288270,420,-2,-8,-15,-5,-1,2,1,0,3,3,0,1,1,-3,6,3,-1,1,0,0,-2,-27,0,-5,5,6,0,0,-1,1,0,1,6,-1
KR_6760771834,420,1,-26,-5,2,2,0,2,3,1,4,-3,4,1,-1,4,3,1,1,2,-1,0,-37,-3,-6,9,6,0,-2,1,-1,-1,-1,4,-1
KR_6729838013,420,-1,-23,13,-8,-1,1,0,-4,4,0,-2,2,0,3,3,6,-4,5,1,-1,-17,35,0,-8,8,-3,0,0,-1,1,0,-1,5,-1
KR_6776766134,420,0,-48,5,-1,1,1,2,1,3,4,-4,6,2,1,1,2,0,1,1,0,2,0,0,-4,4,-1,0,1,1,-1,1,-1,6,-1
KR_6762433200,420,3,32,20,1,3,0,3,1,1,2,-2,2,0,-3,7,4,2,3,5,0,-3,-5,-2,-7,9,8,0,0,1,-1,0,-1,6,-1
KR_6740484688,420,-5,-68,0,-7,-1,1,0,-2,3,1,0,1,1,-2,2,0,-2,2,0,0,-9,0,-2,-3,5,0,0,0,0,1,-1,-1,0,-1
KR_6767177479,420,2,15,12,1,0,2,2,-1,4,3,2,0,2,1,3,4,-1,2,1,0,0,-3,-1,-5,6,-2,0,-1,1,1,-1,-1,6,-1
KR_6737572422,420,1,-62,34,-1,0,1,1,0,2,2,-1,2,1,-1,3,2,1,3,4,0,5,4,-1,-7,8,-2,0,0,1,1,-1,1,5,-1
KR_6776513731,420,-2,12,-18,-2,0,2,2,-1,3,2,0,0,0,-1,3,2,0,0,0,0,-9,-9,-4,-6,10,-1,0,-2,-1,-1,-1,-1,4,-1
KR_6709777195,420,-4,-46,-16,-7,2,2,4,2,2,4,-7,8,1,-4,5,1,0,1,1,2,-12,-28,1,-7,6,-2,0,0,-1,1,1,1,3,-1
KR_6700671024,420,2,31,-9,2,2,2,4,5,0,5,-2,2,0,0,2,2,-3,3,0,-1,-2,0,1,-7,6,-1,0,1,1,-1,1,-1,2,-1
KR_6756195522,420,0,-43,2,-4,-3,5,2,5,2,7,-8,12,4,0,5,5,2,0,2,1,2,0,3,-9,6,-2,0,-1,1,-1,-1,1,2,-1
KR_6701225232,420,1,39,-9,1,-4,7,3,4,1,5,3,0,3,-2,3,1,0,2,2,-1,10,-3,-3,-5,8,3,0,-1,1,-1,-1,-1,2,-1
KR_6731848508,420,-8,-151,-31,-21,-3,3,0,-1,3,2,-6,6,0,-10,12,2,-1,1,0,0,-17,-4,-6,-3,9,2,0,-2,-1,-1,-1,-1,1,-1
KR_6768837685,420,3,-62,7,9,4,1,5,0,2,2,3,2,5,4,0,4,-2,3,1,2,18,31,8,-10,2,1,0,0,-1,1,0,1,1,-1
KR_6771565316,420,-2,-12,8,-3,1,2,3,-5,7,2,1,0,1,0,1,1,0,0,0,0,-3,0,-2,-3,5,-1,0,0,-1,1,1,-1,6,-1
KR_6769144279,420,0,8,20,-2,-4,4,0,0,3,3,1,0,1,2,2,4,-1,1,0,0,-1,1,1,-8,7,-2,0,0,1,-1,0,1,1,-1
KR_6718898399,420,0,-15,30,-1,3,0,3,-1,2,1,-1,3,2,-2,3,1,0,1,1,0,-3,-13,-4,-5,9,-2,0,0,1,1,1,1,6,-1
KR_6774614971,420,-2,-31,8,-6,-3,3,0,-2,4,2,-2,3,1,1,1,2,0,0,0,0,-6,8,0,-6,6,-5,0,0,-1,1,0,-1,1,-1
KR_6774010494,420,-1,15,-16,-9,4,1,5,2,2,4,-9,10,1,-2,3,1,-4,5,1,1,-9,-9,-2,-5,7,-1,0,-1,-1,-1,-1,1,3,-1
KR_6759117231,420,-4,58,-36,-10,0,1,1,-2,2,0,-7,7,0,-1,2,1,0,0,0,0,-15,-30,2,-6,4,0,0,0,-1,1,-1,-1,2,-1
KR_6756017812,420,0,19,-16,0,3,1,4,-5,7,2,-2,4,2,3,2,5,1,1,2,-1,1,155,-5,-2,7,5,0,0,0,-1,0,-1,0,-1
KR_6752240814,420,-4,-80,-32,-6,-2,2,0,2,4,6,-2,4,2,-3,5,2,-1,1,0,0,-7,-4,0,-9,9,5,0,0,1,-1,-1,-1,1,-1
KR_6765031291,420,-4,19,4,-8,0,1,1,-2,3,1,0,2,2,-5,5,0,-1,1,0,1,-16,-12,-3,-6,9,1,0,0,-1,-1,-1,1,5,-1
KR_6765873945,420,-1,-57,-4,3,1,1,2,1,0,1,3,1,4,-1,3,2,-1,2,1,2,5,114,4,-9,5,-3,0,-1,1,1,-1,1,2,-1
KR_6771557711,420,-4,-42,-2,-14,-7,7,0,-4,6,2,-1,3,2,-1,2,1,-1,2,1,0,-10,-160,1,-7,6,1,0,-1,-1,-1,-1,-1,5,-1
KR_6775863893,420,2,-15,22,0,-2,3,1,0,5,5,-1,2,1,1,1,2,2,0,2,0,-4,12,-2,-6,8,-16,0,0,1,-1,0,1,4,-1
KR_6773793988,420,2,-44,9,0,1,0,1,2,3,5,-1,2,1,-4,5,1,2,1,3,0,-2,5,-1,-6,7,-7,0,0,-1,1,0,-1,2,-1
KR_6762008658,420,4,-22,-16,8,2,2,4,0,4,4,6,0,6,-1,3,2,1,0,1,0,12,6,2,-6,4,-7,0,0,-1,1,0,-1,5,-1
KR_6718980505,420,-4,-88,-31,-9,-2,2,0,0,4,4,-2,3,1,0,2,2,-5,7,2,0,-11,-3,-2,-6,8,2,0,0,1,1,0,1,1,-1
KR_6774029782,420,-3,-49,-2,-17,1,4,5,-5,5,0,-8,9,1,2,1,3,-7,7,0,-1,-24,-49,3,-7,4,5,0,-2,-1,-1,-1,-1,1,-1
KR_6774062384,420,2,20,-11,6,2,2,4,0,1,1,3,2,5,0,3,3,1,0,1,0,0,6,-5,-7,12,0,0,1,-1,-1,-1,-1,6,-1
KR_6776052221,420,-2,-18,4,-4,0,1,1,2,3,5,2,0,2,-7,8,1,-1,1,0,0,-1,-7,-8,-4,12,0,0,-1,-1,1,-1,-1,5,-1
KR_6776469747,420,-2,-41,-28,0,3,0,3,-2,6,4,-4,6,2,0,3,3,3,2,5,0,3,-31,-2,-5,7,17,0,-2,1,-1,-1,1,6,-1
KR_6770538348,420,1,9,-28,-4,3,1,4,2,1,3,-1,1,0,-6,6,0,-2,2,0,0,-5,-56,-4,-4,8,-3,0,0,-1,-1,1,1,1,-1
KR_6766218258,440,0,-40,4,6,3,1,4,0,3,3,3,2,5,1,0,1,-1,1,0,0,4,-2,-2,-1,3,0,0,-2,-1,-1,-1,-1,4,-1
KR_6776492536,420,-1,-29,4,0,-1,1,0,1,0,1,1,2,3,1,2,3,-2,2,0,0,2,3,4,-9,5,-4,0,0,1,-1,-1,1,4,-1
KR_6736101960,420,-6,-67,4,-14,-5,6,1,-6,7,1,1,2,3,-4,5,1,0,2,2,0,-24,-1,-1,-5,6,2,0,-2,-1,-1,-1,-1,6,-1
KR_6763116258,420,0,28,33,3,2,2,4,2,1,3,-3,4,1,0,2,2,2,0,2,1,3,1,1,-5,4,-1,0,0,1,1,0,1,2,-1
KR_6755793977,420,-3,35,4,-11,-2,3,1,-1,3,2,-6,7,1,-2,4,2,0,0,0,0,-7,-42,2,-5,3,19,0,-1,-1,-1,-1,-1,6,-1
KR_6660644849,420,2,36,-4,-4,2,4,6,-4,7,3,3,1,4,-5,9,4,0,1,1,-2,-5,1,-2,-8,10,-2,0,0,-1,-1,-1,-1,4,-1
KR_6774240672,420,-3,-40,22,-7,0,1,1,-5,6,1,-2,4,2,0,1,1,0,1,1,0,-3,20,-2,-3,5,0,0,0,1,-1,-1,1,6,-1
KR_6745016141,420,1,-17,-15,6,0,2,2,3,0,3,-1,2,1,3,1,4,1,0,1,0,4,21,-3,-4,7,0,0,-1,-1,-1,-1,-1,4,-1
KR_6754188116,420,-2,-32,7,-4,-1,2,1,6,0,6,0,0,0,-9,11,2,0,2,2,0,-6,-4,1,-11,10,1,0,-2,-1,-1,-1,-1,4,-1
KR_6759112632,420,-2,1,-12,-5,-2,3,1,-3,5,2,0,2,2,1,1,2,-1,1,0,0,-9,2,-2,-4,6,-1,0,-1,0,-1,-1,-1,0,-1
KR_6773785265,420,2,18,18,-5,1,2,3,-1,3,2,-11,14,3,5,0,5,1,1,2,0,-7,0,-7,-6,13,2,0,2,1,1,1,1,6,-1
KR_6742541167,420,-3,24,16,-4,1,2,3,-1,3,2,-1,3,2,-3,3,0,0,0,0,0,-15,35,2,-5,3,-1,0,0,1,1,0,1,3,-1
KR_6767479186,420,-1,18,-19,1,-1,3,2,1,2,3,1,2,3,0,0,0,0,1,1,0,3,29,3,-4,1,3,0,1,1,-1,1,1,5,-1
KR_6773005416,420,0,-19,13,1,-2,3,1,-1,5,4,0,3,3,1,3,4,3,0,3,0,2,3,0,-8,8,-3,0,0,-1,1,0,1,3,-1
KR_6747964135,440,-2,-17,0,-7,-1,4,3,-3,5,2,1,2,3,-2,2,0,-2,2,0,0,-3,-61,-3,-2,5,0,0,0,-1,1,1,-1,4,-1
KR_6762170722,420,0,7,8,7,-5,5,0,5,2,7,0,2,2,6,0,6,1,1,2,1,-1,-185,5,-9,4,5,0,1,-1,1,1,1,4,-1
KR_6774477748,420,0,-11,8,-2,4,2,6,-7,10,3,1,4,5,1,4,5,-1,1,0,0,-6,-15,-1,-6,7,3,0,0,1,-1,0,1,5,-1
KR_6769843890,420,-6,-118,-15,-3,-3,5,2,-2,3,1,-1,3,2,3,2,5,0,0,0,1,11,10,0,-12,12,-1,0,0,-1,-1,-1,1,2,-1
KR_6777319736,420,-1,-29,16,2,2,0,2,1,0,1,0,1,1,-4,4,0,3,0,3,0,2,-1,0,-5,5,5,0,0,-1,1,0,1,1,-1
KR_6771821314,420,2,34,-5,9,3,2,5,2,2,4,0,1,1,1,4,5,3,0,3,2,3,9,3,-9,6,-4,0,2,-1,1,1,1,1,-1
KR_6775162727,420,-3,-60,-15,-8,2,1,3,3,1,4,-4,6,2,-7,7,0,-2,2,0,0,-14,-39,6,-12,6,0,0,0,0,-1,-1,-1,0,-1
KR_6769186244,420,-3,15,-3,-2,1,1,2,1,3,4,-2,2,0,1,1,2,-3,3,0,0,-1,-9,-2,-6,8,-3,0,1,-1,-1,1,1,5,-1
KR_6770135140,420,2,-26,2,-1,2,0,2,1,2,3,-1,3,2,-1,2,1,-2,2,0,0,-2,-51,-1,-4,5,23,0,0,-1,-1,0,-1,6,-1
KR_6741215761,420,-3,6,-32,-10,-5,6,1,-2,3,1,-1,2,1,-2,2,0,0,1,1,0,-14,26,-2,-6,8,2,0,-2,-1,-1,-1,-1,2,-1
KR_6777709734,420,-4,-36,-41,-4,1,0,1,-4,6,2,-1,2,1,-3,5,2,3,0,3,0,0,-7,0,-3,3,1,0,-1,1,-1,-1,1,5,-1
KR_6777480561,420,-3,-23,3,-18,-2,3,1,-1,2,1,-5,6,1,-4,4,0,-6,7,1,-1,-21,183,0,-7,7,-8,0,-3,-1,-1,-1,-1,1,-1
KR_6773399249,420,-8,-80,-16,-16,-2,4,2,-5,6,1,-5,6,1,-3,5,2,-1,1,0,0,-14,-7,-2,-6,8,-6,0,-2,1,-1,-1,-1,3,-1
KR_6777870223,420,1,36,15,-8,-2,4,2,-6,7,1,3,0,3,0,2,2,-3,3,0,-1,-15,-4,-3,-6,9,2,0,0,-1,-1,0,-1,2,-1
KR_6748139845,420,-1,50,0,-8,2,2,4,-10,12,2,-3,4,1,0,2,2,3,0,3,-1,-17,107,0,-5,5,-2,0,2,-1,-1,1,-1,5,-1
KR_6765273420,420,-1,-39,-3,-2,0,5,5,2,1,3,2,2,4,-4,4,0,-2,3,1,0,5,-6,-1,-3,4,-3,0,-2,-1,-1,-1,-1,5,-1
KR_6723499009,420,-4,-10,-19,-7,-4,5,1,1,2,3,-2,2,0,-3,4,1,1,0,1,0,-6,-5,0,-7,7,-4,0,-1,-1,-1,-1,-1,2,-1
KR_6777511831,420,1,-35,-4,1,0,2,2,-1,3,2,0,2,2,-2,6,4,4,0,4,0,6,5,-4,-4,8,-5,0,-1,-1,1,1,-1,4,-1
KR_6776003512,440,-2,-96,-43,-6,1,1,2,-8,9,1,6,0,6,-5,7,2,0,1,1,1,1,6,0,-2,2,-1,0,-1,-1,-1,-1,1,1,-1
KR_6737480516,420,-1,-8,-25,2,-3,3,0,2,2,4,1,3,4,-1,2,1,3,0,3,0,-2,-58,-6,-1,7,3,0,1,1,-1,1,-1,2,-1
KR_6762206911,420,-5,-76,-21,-17,-1,4,3,-6,8,2,-1,1,0,-7,8,1,-2,3,1,0,-20,-11,-3,-5,8,5,0,-2,1,-1,-1,-1,5,-1
KR_6774172815,420,3,10,31,12,0,0,0,0,6,6,3,1,4,10,1,11,-1,2,1,0,17,-3,-2,-6,8,2,0,1,1,-1,1,-1,5,-1
KR_6770603574,420,-5,-99,-41,-16,-1,2,1,-4,4,0,-2,3,1,-8,8,0,-1,1,0,0,-19,-16,-7,-3,10,-1,0,0,-1,1,-1,-1,1,-1
KR_6736317512,420,-1,12,-27,-1,-3,3,0,-1,2,1,1,1,2,3,0,3,-1,2,1,0,1,19,3,-9,6,-9,0,-1,1,1,-1,1,1,-1
KR_6736366069,420,2,-10,4,-6,2,2,4,-6,7,1,-3,3,0,0,2,2,1,2,3,-1,-10,8,0,-6,6,-8,0,0,-1,-1,0,-1,6,-1
KR_6749935012,420,3,13,23,2,0,3,3,1,1,2,-4,4,0,4,0,4,1,0,1,0,3,38,-5,-7,12,-2,0,0,1,-1,1,-1,4,-1
KR_6775387477,420,0,-26,0,-3,-2,3,1,0,2,2,-2,3,1,0,4,4,1,1,2,0,-4,-14,-4,-5,9,-5,0,-1,0,-1,-1,1,0,-1
KR_6773707635,420,3,47,9,1,2,2,4,-2,3,1,1,0,1,0,0,0,0,0,0,0,-1,1,-1,-3,4,1,0,0,1,1,0,1,1,-1
KR_6763777956,420,-4,0,-47,-7,-1,5,4,-2,2,0,0,3,3,-2,2,0,-2,2,0,0,-11,12,0,-8,8,-5,0,-1,-1,-1,-1,1,6,-1
KR_6775832701,420,1,-40,0,-5,2,1,3,-3,5,2,-1,4,3,-5,5,0,2,0,2,0,-8,5,2,-6,4,-1,0,0,1,1,0,1,2,-1
KR_6777611076,420,-2,23,-40,0,1,2,3,-3,6,3,-2,3,1,1,2,3,3,0,3,0,0,101,-4,-7,11,7,0,1,-1,-1,1,-1,4,-1
KR_6772868189,420,-4,-23,-27,-6,-6,8,2,2,0,2,1,2,3,-2,5,3,-1,1,0,0,-9,-26,0,-5,5,-4,0,-1,-1,-1,-1,1,1,-1
KR_6769153109,420,-4,-73,3,-13,2,0,2,-5,5,0,-4,5,1,-5,5,0,-1,1,0,-1,-13,3,2,-4,2,0,0,-1,-1,1,-1,-1,1,-1
KR_6733641781,420,-1,17,-17,-5,0,0,0,-2,4,2,-7,8,1,2,2,4,2,1,3,-2,-14,11,1,-6,5,-2,0,0,-1,1,0,-1,1,-1
KR_6746222991,420,1,-89,6,2,-1,5,4,2,0,2,-2,3,1,1,1,2,2,2,4,0,-1,-20,-5,-2,7,2,0,0,1,1,0,-1,3,-1
KR_6728939825,420,-5,-46,-45,-9,-3,3,0,0,5,5,-4,4,0,-1,8,7,-1,1,0,0,-8,38,3,-8,5,-5,0,-2,0,1,-1,-1,0,-1
KR_6777730884,420,-1,-32,2,-1,-3,4,1,5,0,5,-1,3,2,2,2,4,-4,6,2,-1,-2,-20,6,-12,6,1,0,0,0,-1,0,-1,0,-1
KR_6768451490,440,0,-5,15,-5,0,0,0,0,4,4,-1,4,3,-3,5,2,-1,4,3,1,-3,26,1,-7,6,-6,0,0,-1,0,0,1,1,-1
KR_6749912423,420,-1,-15,-1,-1,2,0,2,-4,4,0,0,0,0,0,1,1,1,0,1,0,-4,102,-1,-6,7,3,0,0,-1,-1,0,-1,4,-1
KR_6777815552,420,-2,-24,0,0,-2,2,0,-3,6,3,1,1,2,1,3,4,3,0,3,0,5,10,5,-10,5,3,0,-1,1,-1,-1,-1,4,-1
KR_6775778820,420,-2,-74,11,-6,-3,4,1,-2,5,3,-2,4,2,-3,4,1,4,0,4,0,3,24,-2,-3,5,-5,0,1,-1,1,1,-1,6,-1
KR_6774275129,420,0,-1,0,-8,-2,3,1,-3,5,2,-3,6,3,0,0,0,0,1,1,0,-15,-19,-6,-2,8,-4,0,-1,-1,-1,-1,1,6,-1
KR_6763136129,420,-1,31,-8,-2,-3,4,1,0,3,3,0,1,1,0,2,2,1,1,2,0,-2,-7,-1,-4,5,9,0,0,-1,1,-1,-1,2,-1
KR_6735174271,420,5,103,36,6,3,0,3,2,2,4,3,0,3,-1,2,1,-1,2,1,0,6,1,-2,-8,10,7,0,2,-1,1,1,-1,6,-1
KR_6776907013,420,-1,-12,8,-5,-1,2,1,-1,5,4,-3,4,1,3,0,3,-3,3,0,0,-7,-15,2,-7,5,-2,0,-1,-1,-1,-1,-1,5,-1
KR_6727978049,420,1,-12,13,-1,3,2,5,-1,2,1,-1,3,2,-1,2,1,-1,1,0,0,2,-13,0,-2,2,2,0,-2,1,1,-1,-1,4,-1
KR_6765870759,420,-3,-28,-27,-5,-1,3,2,5,0,5,-6,8,2,0,3,3,-3,3,0,-1,-2,218,-1,-4,5,1,0,0,1,1,0,-1,2,-1
KR_6708285385,420,3,27,4,3,1,0,1,-2,5,3,1,1,2,0,2,2,3,0,3,0,2,-2,-2,-4,6,-2,0,-1,-1,-1,-1,-1,5,-1
KR_6772768855,420,0,-53,17,-2,0,1,1,-2,7,5,2,1,3,-1,3,2,-1,1,0,0,-8,-2,-2,-4,6,2,0,-1,-1,-1,-1,-1,4,-1
KR_6775720232,420,-4,-23,-16,-10,-2,4,2,-1,3,2,0,3,3,-7,7,0,0,0,0,0,-8,-10,0,-4,4,0,0,-2,-1,1,1,-1,6,-1
KR_6762282968,420,-5,-35,-56,-6,-1,3,2,0,4,4,-1,3,2,1,2,3,-5,5,0,-2,-9,-8,-4,-6,10,-2,0,-2,-1,-1,-1,-1,4,-1
KR_6748098725,420,0,-13,-50,3,0,1,1,1,3,4,-3,5,2,2,2,4,3,1,4,0,3,-139,0,-8,8,-7,0,0,1,-1,-1,1,4,-1
KR_6733167299,420,-1,-26,-4,-3,6,0,6,-6,7,1,-5,7,2,3,0,3,-1,2,1,0,-8,-29,-4,-1,5,-8,0,1,1,1,1,-1,3,-1
KR_6770145566,420,1,13,4,-1,1,3,4,1,1,2,0,1,1,0,2,2,-3,5,2,0,0,-1,1,-8,7,-3,0,0,-1,-1,-1,1,2,-1
KR_6683587160,420,-3,-53,50,-9,-7,8,1,-1,2,1,-3,4,1,-3,5,2,5,0,5,-1,-14,3,-4,-7,11,-2,0,-1,-1,1,-1,-1,6,-1
KR_6773815229,420,-2,-61,-4,-4,-3,4,1,-1,3,2,1,3,4,-3,3,0,2,0,2,0,1,9,-3,-5,8,-4,0,-1,-1,-1,-1,-1,4,-1
KR_6756715692,420,2,-38,41,-4,1,2,3,-2,4,2,4,1,5,-4,8,4,-3,5,2,0,-10,12,-2,-4,6,1,0,0,1,1,1,-1,1,-1
KR_6756127014,420,0,50,28,-5,1,0,1,-3,4,1,-2,5,3,-1,5,4,0,0,0,0,0,33,2,-5,3,-4,0,0,1,-1,0,1,2,-1
KR_6773089591,420,-6,-65,-10,-17,-7,7,0,-2,5,3,-1,3,2,-6,6,0,-1,1,0,0,-6,0,-2,-6,8,-5,0,-1,-1,-1,-1,-1,4,-1
KR_6725658858,420,-1,31,21,0,0,1,1,-1,4,3,0,4,4,2,2,4,-1,2,1,0,-10,-200,-5,-2,7,6,0,0,-1,1,0,1,3,-1
KR_6770858408,420,-2,3,-16,3,3,2,5,0,6,6,-3,4,1,2,3,5,1,1,2,1,9,-16,3,-10,7,-2,0,0,-1,1,0,1,6,-1
KR_6774225701,440,-6,-86,-3,-11,-4,5,1,-1,5,4,-4,6,2,-2,5,3,0,1,1,-1,-3,-6,-4,-4,8,1,0,-2,-1,1,-1,-1,2,-1
KR_6777703637,420,-3,-20,3,-10,0,2,2,0,2,2,-3,4,1,-4,5,1,-3,3,0,0,-13,0,1,-7,6,0,0,-1,-1,-1,-1,-1,2,-1
KR_6764085091,420,-1,-17,0,-1,2,1,3,0,2,2,-1,2,1,-1,3,2,-1,2,1,0,1,6,4,-8,4,-5,0,0,-1,-1,0,-1,2,-1
KR_6709787923,420,-3,-66,-12,-8,-3,5,2,-1,3,2,-4,5,1,2,1,3,-2,2,0,0,-4,-106,-2,-4,6,-1,0,-1,0,-1,-1,-1,0,-1
KR_6728468555,420,0,2,-4,3,1,2,3,-2,4,2,0,1,1,3,2,5,1,0,1,0,-2,31,-1,-6,7,3,0,1,-1,1,1,1,5,-1
KR_6666179836,420,-2,-40,0,-2,3,1,4,-3,6,3,-1,2,1,-1,2,1,0,0,0,-1,-11,-6,1,-6,5,3,0,0,-1,1,1,-1,5,-1
KR_6764710688,420,-1,38,-25,-2,2,0,2,-1,2,1,2,2,4,-5,5,0,0,1,1,0,-9,2,1,-9,8,0,0,1,-1,1,1,-1,2,-1
KR_6771920155,420,-7,-18,-73,-3,-3,4,1,-3,4,1,0,2,2,4,1,5,-1,1,0,0,6,-8,3,-9,6,4,0,-2,-1,-1,-1,-1,6,-1
KR_6773417973,420,-1,-1,-4,-3,-2,3,1,-1,4,3,1,2,3,-2,6,4,1,1,2,0,-7,8,-3,-4,7,-3,0,1,-1,1,1,1,4,-1
KR_6685688906,420,-2,15,-27,-5,-2,4,2,5,0,5,-1,5,4,-5,9,4,-2,2,0,1,-14,-14,4,-13,9,-1,0,0,-1,-1,-1,1,5,-1
KR_6738621159,420,2,6,8,8,0,2,2,3,0,3,4,1,5,0,3,3,1,2,3,-1,11,-8,4,-7,3,-2,0,0,-1,-1,0,-1,1,-1
KR_6755730849,420,-2,-11,-4,-8,-4,4,0,1,5,6,0,3,3,-4,4,0,-1,1,0,0,-22,-13,-6,-9,15,-1,0,-2,-1,1,-1,-1,1,-1
KR_6777823152,420,-4,-53,9,-9,-2,4,2,-6,6,0,-3,4,1,0,2,2,2,1,3,0,-13,-15,-3,-5,8,-2,0,-1,-1,1,-1,1,2,-1
KR_6741899950,420,0,39,-7,-4,-8,8,0,0,5,5,-4,6,2,8,1,9,0,1,1,-1,-6,1,2,-6,4,-3,0,-1,1,-1,-1,-1,3,-1
KR_6744968455,420,-6,-140,-23,-8,-4,4,0,2,3,5,-1,1,0,-5,11,6,0,1,1,0,-4,16,-3,-2,5,-9,0,0,-1,1,-1,-1,6,-1
KR_6771354714,420,-3,-62,-9,-4,0,4,4,1,1,2,-3,6,3,-2,4,2,0,0,0,0,-8,-8,0,-4,4,0,0,0,-1,1,-1,1,3,-1
KR_6722216813,420,-3,15,-23,-11,1,2,3,-2,4,2,-8,8,0,-2,6,4,0,2,2,0,-19,2,2,-7,5,-5,0,-1,-1,-1,-1,-1,6,-1
KR_6768428573,440,-3,-37,4,-5,-1,3,2,1,3,4,0,0,0,-3,5,2,-2,2,0,0,-6,-23,1,-5,4,7,0,0,1,1,-1,-1,5,-1
KR_6776873153,420,1,-53,14,-1,2,0,2,1,2,3,-7,7,0,4,2,6,-1,1,0,-1,-1,-13,-3,-7,10,5,0,-1,1,-1,-1,1,5,-1
KR_6751980461,420,2,30,-15,7,3,0,3,-1,2,1,2,2,4,5,1,6,-2,3,1,0,5,5,0,-6,6,2,0,2,1,1,1,-1,2,-1
KR_6775075812,420,-2,-5,-48,7,0,0,0,2,0,2,2,0,2,3,6,9,0,2,2,0,11,-8,2,-9,7,10,0,0,1,-1,0,1,1,-1
KR_6741975656,420,0,-28,25,0,-5,5,0,1,2,3,3,0,3,-2,2,0,3,1,4,0,1,10,-1,-10,11,-8,0,-1,1,-1,-1,1,6,-1
KR_6774389738,420,-6,-39,-1,-7,-5,5,0,-2,2,0,-2,3,1,0,4,4,2,2,4,0,-5,-4,6,-9,3,-7,0,0,0,0,-1,1,0,-1
KR_6733910121,420,-1,-55,24,-5,-2,2,0,1,2,3,0,2,2,-5,5,0,1,1,2,0,-1,-34,1,-5,4,-5,0,-3,-1,-1,-1,1,6,-1
KR_6777225065,420,0,-33,21,-4,-2,2,0,1,3,4,-2,4,2,-3,3,0,2,1,3,0,-3,26,-3,-5,8,-2,0,1,-1,1,1,-1,3,-1
KR_6775152689,420,-1,-4,30,-4,1,0,1,1,2,3,-4,4,0,-2,2,0,0,0,0,0,-6,-12,-4,-2,6,4,0,0,-1,-1,-1,-1,6,-1
KR_6765072025,420,-5,-64,-34,-6,1,3,4,1,2,3,-1,8,7,-5,6,1,-2,2,0,-1,1,-5,-1,-6,7,2,0,-1,-1,-1,-1,-1,6,-1
KR_6764550995,420,-6,-86,-6,-10,-1,1,0,-3,3,0,-3,5,2,-1,4,3,-2,2,0,0,-9,106,3,-6,3,1,0,-1,1,-1,-1,-1,4,-1
KR_6776186874,420,-4,-64,10,-7,-2,3,1,-5,7,2,-4,4,0,4,3,7,0,2,2,0,-3,-36,-11,0,11,20,0,-2,-1,-1,-1,1,5,-1
KR_6763073208,420,-1,-22,-49,-2,0,1,1,-3,6,3,-3,3,0,1,4,5,3,0,3,0,-2,-13,-2,-4,6,-1,0,0,-1,1,0,-1,5,-1
KR_6752468378,440,-2,-69,4,1,3,0,3,-2,4,2,3,1,4,-3,4,1,0,1,1,0,0,6,-1,-2,3,-2,0,-2,1,-1,-1,-1,6,-1
KR_6764661217,440,0,44,-12,-3,0,0,0,0,1,1,-1,1,0,-1,3,2,-1,1,0,0,-3,4,3,-6,3,1,0,0,1,-1,0,-1,5,-1
KR_6769259283,420,1,-8,-16,4,-4,6,2,4,3,7,-1,3,2,4,0,4,1,2,3,0,3,-265,5,-9,4,-1,0,-1,-1,-1,-1,-1,4,-1
KR_6772251937,420,-6,-104,-34,-5,-2,3,1,-3,3,0,3,1,4,-3,3,0,0,1,1,-2,-10,-6,-4,-5,9,0,0,0,-1,1,-1,-1,3,-1
KR_6775330087,420,-1,9,11,-4,-2,3,1,1,4,5,2,2,4,-3,5,2,-2,2,0,0,-7,-14,-7,-6,13,3,0,-1,1,-1,-1,-1,2,-1
KR_6763469757,440,2,5,8,3,0,1,1,0,1,1,0,1,1,0,4,4,3,1,4,-1,-1,1,-2,-5,7,1,0,1,-1,1,1,-1,3,-1
KR_6776979508,420,-2,-62,2,-6,-7,7,0,1,1,2,0,2,2,-1,4,3,1,0,1,-2,-8,121,-1,-7,8,3,0,1,1,1,1,-1,2,-1
KR_6773558873,420,-4,-71,-18,0,2,0,2,0,0,0,-2,3,1,-2,4,2,2,2,4,0,-2,5,-1,-3,4,1,0,0,-1,1,1,1,5,-1
KR_6719827939,420,-7,-47,11,-15,-1,5,4,-5,5,0,-4,5,1,-3,5,2,-2,4,2,0,-10,1,-2,-2,4,4,0,-2,-1,-1,-1,-1,6,-1
KR_6745208535,420,1,29,11,-1,0,0,0,-1,2,1,0,1,1,-1,1,0,1,0,1,0,-5,29,0,-5,5,-4,0,0,1,-1,0,1,6,-1
KR_6769949797,420,-4,-42,-16,-19,4,1,5,-4,8,4,-5,6,1,-10,10,0,-4,4,0,0,-24,-31,-2,-3,5,-3,0,-1,-1,-1,-1,1,3,-1
KR_6753119104,420,-3,-81,-26,-9,0,2,2,0,3,3,-9,10,1,-3,4,1,3,0,3,0,-17,4,1,-7,6,-11,0,-1,-1,-1,-1,-1,1,-1
KR_6752027380,420,-3,-36,-28,-8,-3,4,1,-1,4,3,-1,2,1,0,1,1,-3,3,0,-1,-16,4,-2,-8,10,1,0,-1,1,-1,-1,-1,5,-1
KR_6769570449,420,-5,-73,15,-9,-2,4,2,1,1,2,-8,8,0,1,3,4,-1,1,0,0,-4,-27,-1,-4,5,-5,0,-2,-1,1,-1,-1,1,-1
KR_6772699775,420,-4,68,-10,-9,-1,1,0,-4,7,3,-1,2,1,0,3,3,-3,3,0,0,-14,23,2,-6,4,2,0,1,0,-1,1,-1,0,-1
KR_6777233819,420,-2,-15,-4,-3,-1,2,1,-2,4,2,0,2,2,-1,1,0,1,1,2,0,2,28,1,-6,5,-26,0,-1,1,-1,-1,-1,6,-1
KR_6767901549,420,-1,20,-12,-3,2,1,3,-4,6,2,-3,4,1,0,1,1,2,0,2,0,3,0,-1,-5,6,3,0,0,-1,1,1,1,6,-1
KR_6762380822,440,-1,9,12,-3,1,2,3,-1,4,3,-5,8,3,0,3,3,2,2,4,0,-5,5,-2,-3,5,-4,0,0,1,1,0,1,2,-1
KR_6774652714,420,1,33,19,-5,-3,5,2,5,1,6,-3,3,0,-3,5,2,-1,1,0,-1,-9,-4,3,-7,4,-1,0,-1,-1,-1,-1,-1,5,-1
KR_6759704775,420,4,22,-17,0,0,1,1,3,2,5,-4,4,0,0,3,3,1,0,1,0,-3,19,0,-5,5,-3,0,1,0,-1,1,-1,0,-1
KR_6740570606,420,-1,-11,3,-4,-2,3,1,1,4,5,1,0,1,-4,6,2,0,1,1,0,0,-1,0,-7,7,-5,0,-1,1,-1,-1,1,3,-1
KR_6756886533,420,-2,19,3,-2,2,1,3,-2,4,2,-2,4,2,-2,5,3,2,0,2,0,-5,0,-2,-6,8,1,0,-1,1,-1,-1,-1,5,-1
KR_6777852287,420,-1,-25,-18,-8,-1,2,1,1,3,4,-2,4,2,-2,3,1,-4,7,3,0,-5,-48,-2,-4,6,4,0,-3,-1,-1,-1,-1,2,-1
KR_6770526163,420,-1,-30,-8,-7,-3,4,1,-1,4,3,0,0,0,-3,7,4,0,3,3,-1,-5,-5,3,-11,8,-2,0,-1,-1,1,-1,-1,6,-1
KR_6752770442,420,0,70,21,2,-1,1,0,-1,2,1,-2,2,0,4,0,4,2,1,3,0,4,-36,-2,-6,8,18,0,-1,1,-1,1,1,6,-1
KR_6747903122,440,2,-23,20,6,0,0,0,2,3,5,1,0,1,1,2,3,2,0,2,0,3,18,-3,-2,5,-3,0,-3,-1,-1,-1,-1,6,-1
KR_6776341803,420,0,29,2,-7,-1,1,0,-6,7,1,0,1,1,-2,2,0,2,1,3,0,-8,-12,-4,-6,10,1,0,0,-1,-1,0,-1,4,-1
KR_6759839709,420,0,-20,4,-1,-1,1,0,1,3,4,1,4,5,-4,7,3,2,0,2,-1,-6,5,2,-7,5,-5,0,-1,-1,1,-1,-1,1,-1
KR_6709744939,420,-4,22,-66,-11,-1,1,0,-1,5,4,-6,7,1,-2,4,2,-1,3,2,0,-1,85,-8,-2,10,2,0,0,1,-1,-1,-1,3,-1
KR_6738995737,420,0,-21,-13,-3,-1,2,1,-3,3,0,3,0,3,-2,4,2,0,0,0,0,-5,-136,-2,-6,8,2,0,-1,1,-1,-1,-1,4,-1
KR_6743684025,420,1,21,4,-3,-5,7,2,1,2,3,-1,4,3,-1,2,1,3,1,4,0,-3,-2,-2,-4,6,4,0,1,1,0,1,-1,3,-1
KR_6752521983,440,-3,-25,-20,-5,1,5,6,0,3,3,-4,5,1,-1,5,4,-1,2,1,-1,8,-1,2,-6,4,-9,0,0,0,1,-1,-1,0,-1
KR_6758189339,420,1,45,8,-4,-2,2,0,-2,3,1,-2,6,4,0,1,1,2,0,2,0,2,-9,2,-7,5,3,0,-1,1,-1,-1,1,3,-1
KR_6773133288,420,-1,-22,-21,4,-3,3,0,3,3,6,0,1,1,4,1,5,0,1,1,1,15,1,4,-11,7,5,0,-1,-1,-1,-1,1,2,-1
KR_6741157660,420,-7,-109,-56,-19,-6,8,2,-5,6,1,-1,3,2,-6,7,1,-1,1,0,1,-24,-13,-6,-2,8,1,0,-1,-1,-1,-1,1,2,-1
KR_6647554113,420,-4,-42,18,-17,-1,1,0,-7,7,0,-5,6,1,-4,4,0,0,0,0,0,-19,25,-2,-3,5,-2,0,-2,-1,-1,-1,-1,4,-1
KR_6770720944,420,-6,-109,-9,-17,-1,2,1,-3,3,0,-3,6,3,-6,7,1,-4,4,0,-1,-9,-12,-1,-5,6,-1,0,-1,-1,1,-1,-1,2,-1
KR_6717364258,420,3,41,-11,0,-1,2,1,-1,2,1,-3,7,4,4,0,4,1,1,2,0,3,31,-3,-5,8,5,0,1,-1,-1,1,-1,3,-1
KR_6742472335,420,-1,0,22,-6,-1,4,3,-2,4,2,-3,7,4,-2,4,2,2,0,2,-1,-13,22,-5,-4,9,2,0,0,1,-1,0,-1,4,-1
KR_6772974001,440,0,18,9,-5,-3,4,1,-2,5,3,-3,6,3,-1,6,5,4,2,6,0,6,7,2,-4,2,-1,0,0,1,-1,1,1,2,-1
KR_6772232078,440,1,-6,-12,-2,2,2,4,-2,2,0,5,3,8,-4,8,4,-3,4,1,0,-4,1,0,-4,4,1,0,1,0,-1,-1,1,0,-1
KR_6773018238,440,-3,-5,-30,-4,2,1,3,0,2,2,-5,6,1,-2,3,1,1,0,1,0,-7,-12,1,-4,3,0,0,1,-1,1,1,1,4,-1
KR_6743355755,420,-3,-49,1,-9,0,0,0,-1,4,3,-3,8,5,-3,3,0,-2,2,0,0,-13,-13,-4,-3,7,6,0,-2,-1,1,-1,1,3,-1
KR_6748785115,420,-3,-52,-17,-5,-1,1,0,-1,3,2,0,2,2,-3,6,3,0,1,1,0,0,9,-3,-3,6,3,0,1,-1,1,1,-1,4,-1
KR_6729275299,420,-3,-13,6,-10,0,1,1,-3,4,1,-7,7,0,2,3,5,-2,2,0,0,-7,3,1,-7,6,-2,0,0,-1,1,1,1,5,-1
KR_6764463057,440,-3,34,1,-3,2,1,3,-3,5,2,-2,6,4,3,4,7,-3,3,0,0,-8,-130,1,-6,5,0,0,0,1,1,0,1,5,-1
KR_6774239723,420,-3,-39,-36,-5,-1,3,2,3,2,5,-1,2,1,-5,5,0,-1,2,1,0,-11,4,0,-8,8,5,0,0,-1,1,0,-1,1,-1
KR_6776613405,420,0,-48,7,3,-3,5,2,3,1,4,1,5,6,1,0,1,1,0,1,1,5,27,-3,0,3,-2,0,-1,-1,1,-1,1,4,-1
KR_6774500814,420,-4,-72,-28,-5,-2,3,1,2,2,4,-2,2,0,-2,2,0,-1,2,1,0,-6,5,1,-9,8,-8,0,-3,-1,-1,-1,-1,1,-1
KR_6749702560,420,-4,-49,-5,-6,1,3,4,1,1,2,-1,2,1,-5,6,1,-2,2,0,0,-12,27,-3,-5,8,-2,0,-1,1,-1,-1,-1,4,-1
KR_6776133451,420,-4,-34,-20,-13,-2,3,1,-4,6,2,-2,4,2,-5,6,1,0,3,3,0,-12,1,-4,-6,10,-6,0,-1,-1,1,-1,1,3,-1
KR_6717136146,420,-4,-57,0,-8,-1,4,3,-5,5,0,1,1,2,-4,4,0,1,0,1,0,-4,7,3,-8,5,-4,0,-1,-1,-1,-1,1,5,-1
KR_6737403741,420,1,-34,8,1,0,1,1,1,5,6,1,0,1,0,2,2,-1,2,1,0,-1,-4,-4,-5,9,-2,0,0,-1,0,0,-1,3,-1
KR_6777030269,420,0,-40,-12,-3,2,1,3,-2,6,4,3,0,3,-6,6,0,0,2,2,-2,-9,-8,1,-7,6,0,0,-2,-1,-1,-1,-1,1,-1
KR_6729481974,420,0,19,-36,2,2,1,3,-1,4,3,-1,4,3,3,5,8,-1,2,1,1,1,-8,-3,-6,9,-2,0,1,1,-1,1,1,4,-1
KR_6774289181,420,-2,-64,11,-12,-1,2,1,-10,12,2,-1,3,2,-2,3,1,2,0,2,0,-8,15,-1,-5,6,-2,0,-1,1,-1,-1,-1,5,-1
KR_6749200581,440,-3,-38,-2,-6,1,3,4,-3,7,4,-2,4,2,-3,4,1,1,2,3,0,-15,-6,4,-10,6,-7,0,1,1,1,1,-1,5,-1
KR_6745500431,420,2,2,3,3,1,2,3,0,3,3,-3,4,1,4,4,8,1,1,2,0,3,9,2,-12,10,-1,0,1,-1,-1,1,1,5,-1
KR_6772578394,420,3,21,18,7,1,1,2,6,0,6,-2,4,2,3,2,5,-1,1,0,0,11,-19,1,-8,7,-5,0,1,1,1,1,1,6,-1
KR_6774335218,420,-5,-70,-15,-1,-3,4,1,0,2,2,0,1,1,1,1,2,1,1,2,1,7,11,-5,-3,8,-4,0,0,1,1,1,1,3,-1
KR_6776550857,420,-2,48,13,-4,2,0,2,-3,4,1,1,1,2,-6,8,2,2,0,2,0,-11,-2,3,-8,5,-5,0,0,-1,1,1,1,3,-1
KR_6731991531,420,-2,-23,-9,-2,-2,2,0,0,0,0,-1,1,0,0,1,1,1,0,1,0,-2,-8,-3,-10,13,-2,0,0,1,-1,-1,1,6,-1
KR_6755216683,420,-4,-36,-23,-11,3,1,4,-5,5,0,-5,5,0,-3,5,2,-1,3,2,1,-25,-4,2,-4,2,0,0,0,-1,1,1,1,3,-1
KR_6777085482,420,-5,-76,-27,-8,-2,2,0,-1,3,2,-3,5,2,-2,3,1,0,2,2,0,-10,8,2,-6,4,-2,0,-1,-1,-1,-1,-1,4,-1
KR_6770455469,420,-2,-26,-15,-3,2,0,2,-2,3,1,-3,3,0,-3,5,2,3,0,3,0,5,-22,3,-5,2,-5,0,-2,1,-1,-1,-1,5,-1
KR_6753404048,420,5,13,-28,5,0,2,2,4,2,6,-1,1,0,1,0,1,1,0,1,0,4,7,1,-5,4,-2,0,1,1,-1,1,1,3,-1
KR_6775927191,420,-1,-44,26,-2,2,0,2,-5,6,1,0,1,1,1,3,4,0,1,1,0,-1,-8,-8,-3,11,-1,0,-1,1,-1,-1,-1,5,-1
KR_6740339190,420,-3,-58,-3,-15,-1,2,1,-5,7,2,-1,6,5,-3,3,0,-5,6,1,0,-12,86,5,-9,4,-14,0,0,1,1,1,1,5,-1
KR_6746284054,420,-5,-92,17,-11,-2,4,2,1,4,5,1,1,2,-8,8,0,-3,3,0,0,-9,-7,-4,-7,11,-6,0,-1,-1,-1,-1,-1,6,-1
KR_6723604539,420,-2,55,15,-8,3,0,3,-5,6,1,2,1,3,-3,4,1,-5,5,0,0,-17,-3,3,-8,5,0,0,-1,-1,1,1,-1,1,-1
KR_6769068992,420,-4,-18,-16,-11,-3,4,1,-8,9,1,4,2,6,-3,3,0,-1,1,0,0,-13,-16,-5,-2,7,5,0,-2,-1,-1,-1,1,6,-1
KR_6774755622,420,-4,-69,-13,-19,-2,4,2,-1,2,1,-7,8,1,-7,8,1,-2,3,1,-1,-15,-7,-5,-5,10,-4,0,-1,-1,-1,-1,-1,1,-1
KR_6686597925,420,3,14,3,11,4,1,5,4,0,4,6,1,7,-1,3,2,-2,3,1,0,1,-24,-2,-5,7,6,0,-1,-1,-1,1,1,3,-1
KR_6777223298,420,0,-5,20,1,3,1,4,5,4,9,-3,4,1,0,4,4,-4,5,1,-1,6,3,1,-7,6,5,0,-1,1,-1,-1,-1,1,-1
KR_6705982767,420,0,-33,20,0,0,3,3,4,5,9,-2,5,3,-1,3,2,-1,1,0,0,4,-11,0,-5,5,5,0,0,-1,1,1,1,1,-1
KR_6772377369,420,-3,-117,-24,4,-5,5,0,-2,4,2,-3,3,0,9,1,10,5,1,6,0,10,10,0,-3,3,-5,0,-3,-1,-1,-1,-1,3,-1
KR_6774250024,420,-1,-32,9,2,-2,4,2,0,2,2,1,0,1,2,1,3,1,0,1,0,5,-2,-2,-7,9,2,0,2,-1,1,1,1,6,-1
KR_6767436095,440,-4,-59,-32,1,-1,3,2,3,2,5,2,0,2,-2,3,1,-1,1,0,0,2,4,1,-8,7,-3,0,0,-1,1,1,1,4,-1
KR_6772447035,420,0,-99,-4,-7,0,2,2,1,3,4,-2,2,0,-7,8,1,1,2,3,0,-5,16,-3,-5,8,27,0,-2,-1,1,-1,-1,1,-1
KR_6774952005,420,-2,-64,0,-6,-1,1,0,1,0,1,-5,7,2,-5,6,1,4,0,4,-1,-14,0,0,-7,7,-8,0,0,1,-1,0,-1,3,-1
KR_6770501231,420,-6,-68,-33,-17,-3,5,2,-9,10,1,-3,3,0,-3,5,2,1,0,1,0,-11,-17,-9,-3,12,-1,0,-4,-1,-1,-1,-1,4,-1
KR_6731464487,420,-1,-26,-28,-2,-1,2,1,1,2,3,-2,2,0,0,1,1,0,0,0,0,2,-122,-3,-7,10,3,0,-1,-1,-1,-1,-1,4,-1
KR_6758300871,420,-2,-69,12,-8,-2,2,0,-4,6,2,2,0,2,-3,5,2,-1,2,1,0,-10,-114,2,-8,6,-5,0,-1,1,-1,-1,1,4,-1
KR_6777037804,420,3,13,7,0,0,1,1,0,2,2,-1,1,0,0,1,1,1,1,2,0,5,3,6,-11,5,-3,0,-1,1,-1,-1,-1,6,-1
KR_6758026829,420,2,-51,-8,9,-1,3,2,5,0,5,1,3,4,6,4,10,-2,2,0,0,20,7,1,-7,6,-8,0,-2,1,-1,-1,-1,6,-1
KR_6753508492,420,-7,-62,-41,-19,-3,3,0,-8,10,2,1,0,1,-6,6,0,-3,3,0,0,-28,-17,-4,-4,8,6,0,-2,-1,-1,-1,-1,4,-1
KR_6774463748,420,1,33,-48,2,8,0,8,-5,7,2,-3,4,1,1,5,6,1,0,1,-1,-4,-4,3,-7,4,1,0,1,-1,1,1,-1,3,-1
KR_6777816895,420,0,-41,15,-3,1,0,1,0,2,2,0,0,0,-2,3,1,-2,3,1,0,-4,201,-6,-4,10,5,0,-1,-1,1,-1,-1,1,-1
KR_6730878067,420,-6,-84,-19,-6,-1,5,4,-1,4,3,0,2,2,-3,3,0,-1,3,2,-1,-3,2,1,-5,4,-2,0,0,1,-1,-1,-1,3,-1
KR_6719346290,420,-6,-22,-5,-12,-5,5,0,-2,4,2,-2,3,1,-2,3,1,-1,1,0,0,-8,-120,-7,-2,9,2,0,-2,-1,-1,-1,-1,4,-1
KR_6673358281,420,-1,3,-57,-2,2,2,4,-2,5,3,0,3,3,-3,6,3,1,0,1,0,-13,-2,6,-8,2,0,0,1,-1,1,-1,-1,4,-1
KR_6760112152,420,0,-25,1,-1,2,1,3,-2,5,3,-3,3,0,1,3,4,1,0,1,0,4,18,-2,-2,4,-23,0,-1,-1,-1,-1,-1,6,-1
KR_6729320790,420,0,-33,-4,4,1,2,3,-5,6,1,3,3,6,4,0,4,1,0,1,0,3,4,3,-8,5,2,0,2,-1,1,1,-1,2,-1
KR_6737958767,420,-4,-55,4,-8,-1,2,1,-4,9,5,0,3,3,-1,2,1,-2,3,1,0,-2,30,2,-6,4,-5,0,-1,-1,-1,-1,1,1,-1
KR_6769605282,440,-2,-40,8,-2,-1,2,1,2,2,4,2,1,3,-3,5,2,-2,3,1,0,0,-8,-4,-4,8,-2,0,0,-1,-1,-1,1,3,-1
KR_6772180648,420,-4,-28,-6,0,-1,1,0,0,2,2,1,3,4,2,0,2,-2,4,2,1,3,-8,-5,-2,7,4,0,0,1,1,0,1,2,-1
KR_6685625561,420,-1,-7,-26,7,1,2,3,1,6,7,-1,3,2,4,1,5,2,0,2,0,13,-5,0,-8,8,-1,0,-1,-1,-1,-1,-1,1,-1
KR_6776894951,420,-2,-23,-10,-6,-2,2,0,-1,1,0,0,3,3,-4,4,0,1,2,3,-2,-5,-5,4,-7,3,-1,0,-2,-1,-1,-1,-1,3,-1
KR_6769096315,420,-4,-98,-22,-5,-6,6,0,1,5,6,2,3,5,-2,6,4,0,0,0,0,2,2,0,-5,5,2,0,0,-1,1,0,1,2,-1
KR_6776417077,420,3,-12,24,4,2,0,2,3,0,3,2,3,5,-2,4,2,-1,1,0,0,3,3,2,-6,4,1,0,0,-1,1,-1,-1,4,-1
KR_6768522790,420,-5,-87,-27,-9,-3,3,0,-4,4,0,1,1,2,-4,4,0,1,1,2,0,-8,-27,1,-7,6,-3,0,0,-1,-1,-1,-1,6,-1
KR_6737729596,420,-2,69,-8,-5,1,0,1,-4,6,2,0,1,1,-2,2,0,0,1,1,0,-12,-14,0,-6,6,-1,0,1,-1,-1,1,1,2,-1
KR_6760025873,420,1,4,8,3,3,0,3,-2,5,3,3,2,5,0,2,2,-1,1,0,-1,4,22,4,-8,4,-22,0,1,0,1,1,-1,0,-1
KR_6777870372,420,-2,29,-2,5,0,2,2,1,2,3,3,0,3,1,2,3,0,1,1,0,11,-10,1,-8,7,17,0,-1,1,-1,-1,1,2,-1
KR_6777323877,420,4,-15,-18,10,2,0,2,-2,4,2,9,2,11,1,1,2,0,1,1,0,7,15,3,-7,4,1,0,0,-1,1,0,1,1,-1
KR_6774220706,420,-1,-8,53,-4,-3,3,0,0,0,0,6,1,7,-7,7,0,0,1,1,0,-11,-13,-1,-6,7,-2,0,-2,-1,-1,-1,-1,6,-1
KR_6660200652,420,-1,7,6,1,3,1,4,-1,3,2,-3,7,4,-1,2,1,3,0,3,0,0,2,1,-6,5,-4,0,-1,0,-1,-1,1,0,-1
KR_6769912004,420,-1,2,-33,-2,-4,4,0,1,0,1,1,2,3,0,3,3,0,2,2,0,-1,22,1,-8,7,-18,0,-1,0,-1,-1,-1,0,-1
KR_6739335159,420,-1,6,-16,-7,1,3,4,-5,8,3,1,1,2,-3,3,0,-1,1,0,-1,-9,-1,5,-10,5,-2,0,0,1,-1,0,-1,1,-1
KR_6753703703,420,2,56,9,3,1,2,3,-5,6,1,2,1,3,2,3,5,3,1,4,0,2,-2,0,-5,5,4,0,0,1,-1,0,-1,1,-1
KR_6742710602,420,-4,-15,-10,-5,2,0,2,-2,9,7,0,3,3,-5,8,3,0,0,0,1,-16,21,3,-9,6,-1,0,-2,1,-1,-1,-1,3,-1
KR_6754596267,420,1,4,12,2,-1,2,1,1,4,5,3,2,5,1,3,4,-2,3,1,0,1,133,5,-9,4,-30,0,0,-1,1,0,-1,6,-1
KR_6702575735,420,-5,-46,-12,-8,-1,3,2,-1,4,3,-4,4,0,-2,3,1,0,0,0,0,-9,34,1,-8,7,-3,0,-2,-1,-1,-1,-1,1,-1
KR_6733679131,420,-1,-43,-12,1,1,1,2,1,0,1,-1,2,1,-1,5,4,1,0,1,0,3,7,3,-8,5,-3,0,0,-1,-1,-1,-1,4,-1
KR_6729271247,420,-4,-37,-10,-11,2,0,2,0,3,3,-5,5,0,-8,8,0,0,1,1,0,-12,-6,-6,-2,8,1,0,-2,-1,-1,-1,-1,3,-1
KR_6774270319,420,-2,-117,15,-2,-1,1,0,-3,4,1,3,1,4,-2,5,3,1,0,1,0,-9,-12,2,-8,6,-1,0,0,1,1,-1,-1,1,-1
KR_6775607362,420,-4,-67,-8,-3,0,2,2,1,1,2,-3,4,1,-2,3,1,1,0,1,0,-4,-10,-6,-4,10,-2,0,-1,1,-1,-1,1,6,-1
KR_6758068952,420,-3,-45,-11,-7,3,1,4,-4,5,1,0,2,2,-5,5,0,-1,3,2,0,-5,5,-1,-5,6,-2,0,-1,-1,1,-1,-1,5,-1
KR_6729311950,420,-2,-9,-17,-5,-5,5,0,0,2,2,0,2,2,1,3,4,-1,1,0,-1,-1,-21,1,-6,5,0,0,-2,1,-1,-1,-1,3,-1
KR_6768182710,420,-2,-32,-24,-9,-2,3,1,2,2,4,-2,6,4,-4,7,3,-3,4,1,0,-7,-1,-4,-5,9,3,0,-2,-1,-1,-1,-1,2,-1
KR_6776253482,420,1,-5,15,-5,-3,6,3,2,1,3,-3,4,1,4,2,6,-5,7,2,0,-5,-8,3,-8,5,-4,0,1,1,-1,-1,-1,6,-1
KR_6774639891,420,-2,-38,-28,-8,-3,4,1,-1,5,4,0,1,1,-1,3,2,-3,3,0,-2,-9,-15,-4,-4,8,-5,0,0,-1,1,-1,-1,4,-1
KR_6752548892,420,-4,26,-35,2,-2,2,0,3,0,3,2,1,3,1,1,2,-2,2,0,0,9,-53,-4,-4,8,24,0,1,-1,1,1,-1,5,-1
KR_6775726652,420,1,4,-11,3,-1,3,2,6,2,8,0,2,2,-1,2,1,-1,1,0,0,6,2,-4,-3,7,-5,0,0,1,-1,0,-1,2,-1
KR_6776723000,420,-2,-68,-23,-5,-1,2,1,-5,10,5,2,2,4,1,2,3,-2,3,1,0,-1,332,-2,-5,7,-1,0,0,-1,1,0,-1,5,-1
KR_6777054129,420,-2,-19,-4,-6,0,1,1,-4,8,4,3,1,4,4,1,5,-9,9,0,0,-4,-21,5,-9,4,2,0,-2,1,1,-1,-1,6,-1
KR_6771960996,420,-1,-17,-8,-7,0,0,0,-8,8,0,1,1,2,-1,2,1,1,1,2,0,-6,-1,-4,-2,6,-1,0,0,-1,-1,0,-1,6,-1
KR_6769169412,420,0,-54,2,3,-1,1,0,8,1,9,-5,8,3,1,2,3,0,2,2,0,8,-25,0,-5,5,-1,0,-1,-1,-1,-1,-1,4,-1
KR_6756393841,420,-2,59,-32,3,3,2,5,3,2,5,-1,3,2,-1,1,0,-1,1,0,0,-3,-50,-5,-3,8,21,0,-1,1,-1,-1,1,3,-1
KR_6687754610,420,1,30,28,2,0,2,2,-2,4,2,0,2,2,2,0,2,2,0,2,0,-3,28,-1,-8,9,-2,0,0,1,-1,-1,1,6,-1
KR_6776707013,420,-3,-61,4,-8,-3,3,0,-1,2,1,-1,2,1,3,2,5,-6,6,0,0,-1,5,-1,-6,7,-1,0,-2,1,-1,-1,-1,6,-1
KR_6769308764,420,-5,-106,-3,-15,-5,5,0,1,3,4,-2,5,3,-5,6,1,-4,4,0,-1,-9,-6,-2,-6,8,-6,0,-1,-1,-1,-1,-1,6,-1
KR_6771527814,420,-1,5,26,-6,2,3,5,0,2,2,1,3,4,-2,2,0,-7,8,1,2,1,-11,0,-5,5,3,0,0,-1,1,-1,1,3,-1
KR_6771686384,420,1,20,-19,-1,-4,5,1,1,2,3,3,2,5,0,4,4,-1,2,1,-2,-3,0,8,-10,2,4,0,0,1,-1,0,-1,6,-1
KR_6777428369,420,1,31,6,3,0,3,3,2,2,4,-2,2,0,2,1,3,1,1,2,0,-4,-2,0,-5,5,-1,0,-1,1,-1,-1,1,6,-1
KR_6770406967,440,-3,-82,-11,-4,1,1,2,-3,5,2,-3,5,2,1,3,4,0,0,0,0,-2,0,-1,-4,5,-1,0,0,-1,1,-1,-1,4,-1
KR_6777781311,420,1,57,27,-2,2,0,2,-1,3,2,3,0,3,-4,6,2,-2,2,0,0,-3,22,0,-5,5,-1,0,0,1,-1,-1,-1,3,-1
KR_6727848043,420,4,7,4,6,-5,5,0,0,3,3,0,1,1,11,1,12,0,1,1,-1,6,9,3,-7,4,-2,0,2,-1,1,1,1,6,-1
KR_6765257751,420,0,4,-8,1,-1,1,0,3,0,3,2,2,4,-3,4,1,0,0,0,0,5,2,7,-11,4,-2,0,0,1,-1,0,-1,6,-1
KR_6776875691,420,-8,-95,-20,-12,-2,3,1,-1,3,2,-6,9,3,-2,2,0,-1,1,0,0,-10,14,-3,-3,6,-3,0,-2,-1,-1,-1,1,4,-1
KR_6742246175,440,1,27,-12,-1,1,0,1,-6,8,2,1,1,2,2,2,4,1,1,2,0,-10,7,3,-7,4,-3,0,1,-1,1,1,-1,1,-1
KR_6763906462,420,1,-8,45,5,0,0,0,-3,4,1,0,1,1,5,0,5,3,0,3,0,9,-39,4,-9,5,4,0,0,1,1,-1,1,4,-1
KR_6772392003,420,-4,-22,-40,-2,2,1,3,1,2,3,0,2,2,-4,6,2,-1,1,0,0,4,-3,0,-4,4,-1,0,0,-1,-1,0,-1,1,-1
KR_6752541795,420,-3,-67,-15,-7,-6,7,1,0,3,3,3,1,4,-3,5,2,-1,1,0,-1,-9,-3,2,-6,4,-1,0,-1,-1,-1,-1,-1,6,-1
KR_6730327417,420,-3,22,10,-1,0,1,1,-3,4,1,4,4,8,0,2,2,-2,3,1,0,-5,-27,4,-12,8,3,0,-1,-1,1,-1,-1,4,-1
KR_6775094883,420,-5,-84,-20,-6,1,1,2,0,2,2,-5,6,1,-2,3,1,0,0,0,-1,-6,-2,-1,-4,5,1,0,-1,-1,-1,-1,-1,1,-1
KR_6777283723,420,-1,-53,18,-3,-1,4,3,1,2,3,-1,3,2,-3,4,1,1,1,2,0,-3,-13,-1,-6,7,3,0,-1,-1,1,-1,1,3,-1
KR_6761702659,420,2,43,24,7,1,3,4,0,4,4,4,1,5,1,1,2,1,2,3,0,1,-4,0,-5,5,3,0,0,1,1,1,1,5,-1
KR_6770283993,420,-4,-82,5,-4,-4,4,0,1,2,3,0,1,1,-2,2,0,1,0,1,0,3,6,2,-4,2,0,0,0,1,-1,-1,1,1,-1
KR_6770581424,420,1,-21,-10,7,-1,2,1,2,1,3,1,3,4,5,1,6,0,1,1,0,13,-5,-1,-4,5,-2,0,1,1,1,1,1,4,-1
KR_6741067068,420,-4,-11,-27,-7,0,1,1,-6,9,3,-2,2,0,3,3,6,-2,2,0,0,-5,-88,3,-12,9,-6,0,0,-1,-1,0,-1,1,-1
KR_6764489356,420,-5,-31,-20,-5,-1,3,2,0,2,2,-3,4,1,1,4,5,-2,3,1,0,7,-6,1,-6,5,-5,0,-3,1,-1,-1,-1,3,-1
KR_6759486098,420,-3,-11,-23,-7,-1,1,0,0,2,2,-5,6,1,1,4,5,-2,3,1,0,-3,-106,2,-6,4,-2,0,-1,-1,-1,-1,-1,3,-1
KR_6763871807,420,-2,-66,2,-3,-2,4,2,-2,3,1,1,3,4,-1,4,3,1,1,2,0,-7,24,-5,-3,8,-2,0,-1,1,-1,1,1,5,-1
KR_6745731921,420,-1,-31,-5,2,3,3,6,-1,3,2,4,0,4,0,3,3,-4,4,0,2,3,-3,5,-10,5,-7,0,1,-1,-1,-1,1,5,-1
KR_6768191714,440,-2,-19,-26,-9,-5,5,0,-6,6,0,2,1,3,-2,6,4,2,0,2,0,-6,10,4,-7,3,0,0,0,-1,-1,-1,-1,6,-1
KR_6662842341,420,-1,14,-21,-2,2,2,4,-5,5,0,-2,2,0,3,1,4,0,0,0,0,-4,3,2,-7,5,-3,0,-1,-1,-1,-1,1,1,-1
KR_6767863162,420,2,-6,1,0,1,3,4,3,1,4,-3,5,2,-2,4,2,1,1,2,-3,-3,-113,3,-8,5,0,0,-1,1,-1,-1,-1,1,-1
KR_6776412838,420,2,21,-4,6,0,2,2,1,2,3,3,1,4,6,1,7,-4,5,1,0,8,-9,-4,-5,9,0,0,-1,1,-1,-1,-1,2,-1
KR_6765259854,420,-3,28,-3,0,-1,2,1,-1,2,1,-1,1,0,3,3,6,0,0,0,0,4,2,1,-6,5,-5,0,-1,-1,-1,-1,1,5,-1
KR_6750413705,420,1,-29,24,7,-1,1,0,2,1,3,6,0,6,1,5,6,-1,1,0,0,13,-1,0,-5,5,-1,0,0,1,1,-1,1,6,-1
KR_6772642338,420,0,-6,2,-4,0,3,3,-2,4,2,3,1,4,-3,3,0,-2,2,0,0,-9,-3,-1,-7,8,0,0,0,1,-1,1,1,3,-1
KR_6682085134,420,-3,-43,-15,-3,-1,4,3,-2,3,1,-1,3,2,0,4,4,1,1,2,0,-5,9,4,-9,5,-5,0,0,-1,1,0,1,5,-1
KR_6775067407,440,-5,-64,-25,-12,-1,1,0,-3,3,0,-5,7,2,-4,4,0,1,2,3,0,-6,5,-2,-3,5,-2,0,-2,-1,0,-1,-1,3,-1
KR_6777772728,420,-3,-25,-20,-8,1,3,4,-1,4,3,-5,5,0,-1,4,3,-2,2,0,-3,-8,-301,-9,0,9,5,0,-1,-1,1,1,-1,3,-1
KR_6757852051,420,-1,-39,12,3,1,1,2,3,0,3,7,2,9,-4,4,0,-4,6,2,1,-7,29,1,-6,5,-2,0,0,0,1,1,1,0,-1
KR_6770157841,440,-5,-130,-17,-19,-7,7,0,-1,5,4,-6,6,0,-5,7,2,0,0,0,0,-8,4,-2,-4,6,-3,0,-2,-1,-1,-1,-1,5,-1
KR_6768035667,420,1,-1,29,2,3,0,3,1,3,4,-4,6,2,3,0,3,-1,1,0,0,3,21,2,-6,4,2,0,2,1,1,1,-1,6,-1
KR_6777436321,420,-5,54,-23,-4,1,1,2,-5,6,1,-1,5,4,1,2,3,0,0,0,1,-7,9,3,-9,6,-6,0,-1,1,-1,-1,1,2,-1
KR_6737406008,420,-8,-63,-5,-14,-3,4,1,0,3,3,-10,10,0,-1,4,3,0,1,1,-1,-15,-13,-7,-1,8,4,0,-1,-1,1,-1,-1,6,-1
KR_6761460764,420,3,2,-16,11,1,1,2,2,3,5,4,2,6,4,0,4,0,0,0,0,9,-60,1,-8,7,1,0,1,-1,1,1,1,2,-1
KR_6740081026,420,-4,-1,-25,-9,-4,4,0,-4,5,1,-3,4,1,-1,1,0,3,0,3,0,-12,66,2,-8,6,1,0,1,-1,1,1,-1,6,-1
KR_6724383146,420,-4,-26,-4,-12,0,4,4,-1,4,3,-1,2,1,-7,10,3,-3,3,0,0,-13,9,1,-7,6,-4,0,-1,-1,1,1,1,5,-1
KR_6775571946,420,-2,0,2,-1,2,1,3,-2,5,3,2,3,5,-2,2,0,-1,1,0,-1,-5,7,1,-7,6,-8,0,0,1,-1,0,-1,6,-1
KR_6769564557,420,0,-14,-14,-4,0,2,2,2,1,3,-6,7,1,2,2,4,-2,2,0,0,-17,-36,-1,-5,6,-1,0,1,-1,-1,-1,-1,6,-1
KR_6716756223,420,-5,-81,1,-8,-1,2,1,-1,1,0,-2,6,4,-4,6,2,0,1,1,0,-7,33,-2,-5,7,3,0,-1,-1,1,-1,-1,6,-1
KR_6749839087,420,-6,-72,14,-15,-5,5,0,-7,9,2,1,4,5,-3,7,4,-1,2,1,0,-19,-7,0,-8,8,-1,0,-2,0,-1,-1,-1,0,-1
KR_6775895714,420,0,16,8,2,1,0,1,1,1,2,3,1,4,-3,5,2,0,0,0,0,-1,0,-1,-7,8,1,0,0,1,1,0,-1,1,-1
KR_6776778476,420,2,-7,-12,-1,-1,2,1,-2,5,3,-1,2,1,2,0,2,1,0,1,1,3,29,7,-10,3,-8,0,-2,-1,-1,-1,1,3,-1
KR_6767492753,440,-6,-77,-28,-19,-1,1,0,-4,5,1,1,3,4,-9,10,1,-6,7,1,-1,-23,-6,1,-3,2,-1,0,-1,-1,-1,-1,-1,2,-1
KR_6777665623,420,3,16,3,11,4,1,5,8,1,9,1,1,2,-2,5,3,0,3,3,1,5,33,-3,-4,7,2,0,2,-1,1,1,1,4,-1
KR_6770074358,420,-4,-18,-23,-4,4,1,5,-5,5,0,0,1,1,-3,4,1,0,0,0,1,-7,37,-2,-4,6,-14,0,-3,-1,-1,-1,1,5,-1
KR_6775601119,420,-1,-18,-9,5,-3,4,1,-2,6,4,0,1,1,9,1,10,1,1,2,0,14,-2,0,-4,4,0,0,0,1,-1,-1,1,4,-1
KR_6776705262,420,-5,-85,0,-4,-3,4,1,-3,4,1,-2,2,0,2,1,3,2,0,2,0,-3,-9,-1,-5,6,-2,0,-2,-1,-1,-1,-1,3,-1
KR_6756451555,420,1,29,-20,1,2,0,2,-3,6,3,-3,7,4,3,4,7,2,0,2,-2,-3,0,3,-12,9,3,0,-1,-1,1,-1,1,1,-1
KR_6766951418,420,-4,0,-13,-13,-8,8,0,1,3,4,-1,1,0,-2,3,1,-3,3,0,0,-11,-4,-6,-5,11,3,0,-1,-1,-1,-1,-1,5,-1
KR_6776184291,420,0,16,9,-2,-3,4,1,1,3,4,-1,4,3,3,0,3,-2,2,0,0,-5,10,3,-8,5,-3,0,-3,1,-1,-1,-1,3,-1
KR_6676265058,420,-2,-66,-32,-2,0,1,1,-1,6,5,0,1,1,-1,1,0,0,0,0,0,2,3,2,-6,4,1,0,0,1,-1,0,1,3,-1
KR_6777384225,420,1,-20,23,-2,-1,1,0,1,1,2,0,1,1,-1,3,2,-1,2,1,0,-1,5,0,-7,7,-6,0,-1,-1,1,-1,-1,2,-1
KR_6760421060,420,-4,-29,-36,-9,-1,1,0,-4,5,1,-4,4,0,-1,3,2,1,2,3,0,-14,-110,-4,-2,6,-4,0,0,-1,-1,-1,-1,1,-1
KR_6748804005,420,-3,-76,-31,-11,-4,8,4,-3,4,1,-4,5,1,-1,4,3,1,3,4,0,-11,-8,5,-9,4,-8,0,-2,-1,-1,-1,-1,6,-1
KR_6741510363,440,-7,-149,-49,-8,-4,4,0,0,1,1,-7,8,1,0,1,1,3,0,3,0,-15,100,0,-8,8,2,0,-2,-1,-1,-1,1,5,-1
KR_6767473438,440,-1,-71,11,-8,-3,3,0,-3,6,3,-3,3,0,-3,6,3,4,1,5,0,-7,122,-3,-5,8,-4,0,-1,-1,0,-1,-1,1,-1
KR_6724759810,420,1,-28,13,5,-1,1,0,0,5,5,0,1,1,4,2,6,2,0,2,0,7,-1,-3,-5,8,2,0,-1,1,-1,-1,1,6,-1
KR_6763237039,440,-2,-74,-16,-8,0,0,0,2,0,2,-2,2,0,-9,9,0,1,3,4,0,-6,1,-2,-2,4,-1,0,-1,0,-1,-1,-1,0,-1
KR_6758447659,440,-4,-68,-32,-12,3,3,6,-4,5,1,-6,7,1,-4,5,1,-1,1,0,0,-13,-16,-5,-1,6,1,0,-1,-1,1,-1,1,6,-1
KR_6773232738,420,2,80,-12,4,5,1,6,1,4,5,-2,2,0,1,0,1,-1,1,0,0,-3,51,6,-12,6,-22,0,1,1,-1,1,1,6,-1
KR_6761245259,440,-1,29,0,-7,-1,2,1,-3,5,2,-3,3,0,0,0,0,0,2,2,0,-9,-54,-4,-4,8,1,0,0,0,1,0,1,0,-1
KR_6726419678,420,-2,-41,-47,-2,0,1,1,-2,2,0,1,2,3,-2,4,2,1,0,1,0,-8,-6,-2,-5,7,-2,0,-1,-1,1,-1,1,1,-1
KR_6775380077,420,-2,-24,-24,-4,-7,7,0,6,0,6,-1,2,1,-1,1,0,-1,1,0,-1,1,-8,-3,-5,8,2,0,-1,1,-1,-1,-1,4,-1
KR_6767804697,420,0,-22,-10,-10,-1,2,1,-3,7,4,2,0,2,-9,9,0,1,0,1,-2,-18,-7,-2,-6,8,-1,0,0,-1,-1,-1,-1,2,-1
KR_6685559552,420,-4,-33,-24,-16,-2,3,1,-2,5,3,0,2,2,-7,8,1,-5,5,0,-2,-17,-8,3,-7,4,7,0,-1,-1,-1,-1,1,6,-1
KR_6776888115,420,-1,-38,25,-15,-7,8,1,-1,1,0,-1,3,2,0,3,3,-6,6,0,0,-14,-4,-2,-5,7,-3,0,-1,1,-1,-1,-1,3,-1
KR_6772081246,420,-5,-39,-29,-12,-2,2,0,-1,3,2,0,2,2,-5,9,4,-4,5,1,2,-16,9,0,-4,4,-7,0,-2,-1,-1,-1,1,6,-1
KR_6772997602,420,-2,-8,11,-2,0,1,1,-1,3,2,1,3,4,0,1,1,-2,2,0,0,-11,4,-4,-4,8,5,0,-1,1,1,-1,-1,6,-1
KR_6777152798,420,-3,-19,-8,-8,-4,7,3,-7,7,0,3,1,4,0,2,2,0,0,0,0,-15,-2,0,-7,7,-3,0,0,-1,1,1,-1,6,-1
KR_6761789854,440,-2,-70,-21,5,1,2,3,0,2,2,-2,4,2,5,3,8,1,0,1,0,9,35,2,-8,6,-3,0,0,1,1,1,-1,4,-1
KR_6749835462,420,-1,-83,-20,-4,1,0,1,-2,5,3,-4,4,0,3,0,3,-2,2,0,0,-2,-15,1,-5,4,2,0,-2,-1,1,-1,1,4,-1
KR_6767894257,420,-3,-49,-39,-10,0,2,2,-2,4,2,-5,5,0,-3,5,2,0,0,0,-3,-17,-1,2,-8,6,-7,0,-1,-1,1,-1,-1,6,-1
KR_6658475042,420,0,17,25,-2,1,0,1,-5,7,2,1,1,2,0,3,3,1,1,2,0,-6,34,3,-8,5,1,0,0,1,1,1,1,6,-1
KR_6768536810,420,1,52,6,-5,1,3,4,0,2,2,-5,6,1,-1,2,1,0,1,1,-1,-5,-45,-8,-2,10,4,0,1,1,-1,1,-1,5,-1
KR_6726842769,440,0,17,-5,1,-2,3,1,-1,2,1,0,1,1,5,1,6,-1,1,0,0,6,34,1,-4,3,-2,0,-2,1,-1,-1,-1,6,-1
KR_6772259093,420,-5,-70,3,-8,-1,1,0,-1,4,3,-3,4,1,0,2,2,-3,3,0,0,-5,-18,-1,-5,6,25,0,-2,-1,-1,-1,-1,5,-1
KR_6731409212,420,-4,-77,16,-7,0,5,5,-4,7,3,-1,2,1,-4,7,3,2,1,3,-1,-8,-11,-1,-3,4,-7,0,0,1,1,-1,-1,4,-1
KR_6755043122,420,-2,-14,4,-4,1,0,1,2,3,5,-6,6,0,-2,2,0,1,0,1,0,-6,-1,0,-4,4,1,0,0,-1,1,0,-1,1,-1
KR_6753401202,420,-1,-21,-8,0,-1,3,2,-1,3,2,1,4,5,2,0,2,-1,1,0,1,3,-7,-2,-3,5,1,0,-1,-1,0,-1,1,4,-1
KR_6741332686,420,2,-40,3,4,1,1,2,2,1,3,-1,2,1,-1,2,1,3,1,4,0,2,2,0,-5,5,1,0,0,-1,1,1,-1,1,-1
KR_6769204628,420,-1,-97,-25,-5,-5,5,0,0,2,2,-1,3,2,-1,2,1,2,0,2,2,-5,-1,2,-8,6,-5,0,-3,0,-1,-1,1,0,-1
KR_6774538285,420,-1,-76,16,-1,-5,5,0,7,1,8,-3,4,1,0,3,3,0,1,1,0,6,3,0,-6,6,1,0,-3,-1,-1,-1,-1,6,-1
KR_6756485252,420,0,7,-36,-2,-7,7,0,-2,3,1,2,5,7,5,1,6,0,0,0,0,5,6,0,-5,5,0,0,-2,1,-1,-1,1,2,-1
KR_6775933566,420,-2,9,4,0,-1,1,0,2,1,3,2,0,2,-4,5,1,1,2,3,0,5,4,-1,-6,7,3,0,-1,1,-1,-1,1,4,-1
KR_6776960985,420,-2,-48,2,-4,-4,5,1,1,1,2,3,2,5,-5,10,5,1,1,2,0,-6,-19,-4,-6,10,-2,0,-2,-1,-1,-1,1,1,-1
KR_6770381546,420,-1,-41,12,-1,4,1,5,-3,4,1,0,1,1,-4,4,0,2,1,3,0,-10,-6,-1,-7,8,-6,0,0,-1,1,1,1,6,-1
KR_6776502302,420,0,-61,-3,5,1,0,1,1,4,5,5,1,6,-2,3,1,0,1,1,0,-5,52,4,-9,5,-4,0,-1,1,-1,-1,-1,4,-1
KR_6771527537,420,1,16,6,1,1,4,5,-1,3,2,1,2,3,-1,7,6,1,0,1,-2,0,6,4,-11,7,0,0,0,-1,1,1,-1,3,-1
KR_6748823130,420,-5,-54,7,-4,-1,1,0,1,0,1,1,1,2,-7,7,0,2,1,3,1,-4,-4,-3,-5,8,-4,0,0,-1,1,0,1,5,-1
KR_6762707580,420,-1,64,-20,-7,1,1,2,-1,2,1,-7,8,1,-1,2,1,1,0,1,0,-16,-12,-3,-4,7,-2,0,-1,-1,1,-1,-1,6,-1
KR_6767168037,420,-2,-66,-30,-7,-1,4,3,0,4,4,-6,7,1,-1,7,6,1,0,1,0,-4,-1,-8,-3,11,1,0,-2,-1,-1,-1,-1,1,-1
KR_6768555224,440,-2,-22,-20,-7,1,1,2,-5,7,2,4,0,4,-4,7,3,-3,3,0,0,-1,-2,1,-4,3,3,0,0,-1,-1,-1,-1,4,-1
KR_6678633361,420,0,-10,-11,-2,2,2,4,-1,2,1,-1,1,0,-1,5,4,-1,1,0,0,-12,-3,4,-9,5,0,0,2,1,1,1,1,3,-1
KR_6716719719,420,-2,84,20,-9,1,0,1,1,4,5,-9,11,2,-2,3,1,0,2,2,0,-17,-109,-1,-5,6,-1,0,-1,1,-1,-1,1,2,-1
KR_6771535136,440,-1,26,10,-3,0,2,2,1,0,1,-3,3,0,-2,4,2,1,2,3,0,-9,1,-2,-4,6,4,0,0,-1,-1,0,-1,2,-1
KR_6777454758,420,-1,34,0,1,-4,4,0,4,3,7,-2,3,1,1,1,2,2,1,3,-1,-6,19,5,-9,4,-2,0,0,1,-1,-1,-1,5,-1
KR_6731854292,420,-2,32,12,-9,-4,4,0,1,1,2,-5,6,1,1,2,3,-2,3,1,0,-3,-27,-4,-4,8,1,0,0,-1,-1,1,-1,5,-1
KR_6773688714,420,-2,-23,-1,-5,-5,5,0,0,1,1,-1,1,0,0,2,2,1,0,1,0,-13,-6,-2,-4,6,-2,0,0,-1,-1,0,-1,6,-1
KR_6774406853,440,-3,-47,-29,-10,-1,2,1,1,0,1,-1,3,2,-3,7,4,-6,6,0,0,-18,12,0,-3,3,-2,0,-1,-1,-1,-1,-1,5,-1
KR_6773906800,420,1,82,25,-4,3,0,3,-2,4,2,1,2,3,-5,6,1,-1,1,0,1,-8,-8,-7,-4,11,3,0,0,-1,0,0,1,5,-1
KR_6775611193,420,1,-9,0,2,-3,3,0,0,2,2,4,0,4,0,1,1,1,0,1,0,3,-6,-2,-6,8,4,0,1,1,1,1,1,4,-1
KR_6755331734,420,-1,-17,19,1,-2,3,1,1,4,5,0,4,4,1,4,5,1,0,1,0,-3,-20,-3,-8,11,6,0,-1,1,1,-1,1,3,-1
KR_6712005821,420,2,81,1,7,-2,3,1,0,2,2,8,1,9,1,1,2,0,2,2,0,3,8,3,-5,2,0,0,2,-1,-1,1,1,4,-1
KR_6734755824,440,2,-7,-11,5,0,3,3,2,2,4,1,1,2,-3,4,1,5,2,7,0,2,-10,5,-10,5,-1,0,0,-1,-1,0,1,2,-1
KR_6741945255,440,-1,-24,4,-5,1,0,1,0,3,3,-2,2,0,-2,2,0,-2,2,0,0,-6,-1,-3,-2,5,2,0,0,-1,1,-1,1,2,-1
KR_6737672466,420,-4,-6,-11,-7,3,0,3,0,4,4,1,1,2,-7,9,2,-4,4,0,0,5,-1,0,-7,7,1,0,-1,-1,1,-1,1,5,-1
KR_6770731750,420,-4,-74,23,-7,-2,2,0,0,3,3,-4,5,1,-1,9,8,0,1,1,0,-8,4,5,-10,5,-5,0,-1,-1,-1,-1,1,5,-1
KR_6734902461,420,-7,-54,4,-14,-2,3,1,-1,4,3,-5,5,0,-3,3,0,-3,3,0,0,-10,0,-3,-4,7,-8,0,-1,-1,1,-1,-1,4,-1
KR_6767617505,420,0,3,1,-3,-1,3,2,2,2,4,-4,5,1,0,1,1,0,2,2,-1,-4,-6,-6,-2,8,2,0,1,1,-1,1,-1,1,-1
KR_6763177404,440,-7,-101,-28,-16,-1,5,4,-5,7,2,-2,4,2,-4,5,1,-4,4,0,2,-5,-16,-3,-8,11,2,0,-3,-1,-1,-1,1,6,-1
KR_6762455753,420,-3,-41,-29,-2,-3,4,1,0,2,2,3,0,3,-1,2,1,-1,1,0,-1,-11,-12,-1,-3,4,1,0,-1,-1,1,-1,-1,3,-1
KR_6748142542,420,-3,-29,-2,-2,7,2,9,-9,12,3,2,1,3,-6,7,1,4,2,6,1,-7,-3,-4,-4,8,0,0,0,-1,1,1,1,3,-1
KR_6773971496,420,0,-16,-35,3,0,5,5,-1,2,1,-1,3,2,1,2,3,4,0,4,1,8,211,2,-6,4,0,0,0,-1,-1,0,1,2,-1
KR_6726766810,420,2,14,-24,2,1,1,2,3,2,5,1,0,1,-4,5,1,1,0,1,1,1,-41,1,-8,7,4,0,-1,-1,-1,-1,1,1,-1
KR_6742159948,440,1,-19,20,-4,-1,3,2,-5,7,2,4,2,6,-1,4,3,-1,2,1,1,-5,-4,2,-4,2,-5,0,-1,-1,1,-1,1,6,-1
KR_6766390003,420,-2,29,-20,-2,-1,1,0,-2,4,2,-3,3,0,4,0,4,0,1,1,0,-7,15,3,-7,4,-5,0,0,-1,-1,-1,1,1,-1
KR_6770622562,420,0,-3,21,-1,2,1,3,-4,5,1,-3,6,3,3,3,6,1,0,1,0,-12,-5,-1,-5,6,3,0,2,-1,1,1,1,1,-1
KR_6751425846,420,-2,-64,11,-2,0,1,1,0,2,2,3,1,4,-8,11,3,3,0,3,0,0,-2,1,-5,4,0,0,-1,-1,1,-1,-1,3,-1
KR_6765807293,420,-4,-49,-58,-11,2,1,3,-2,3,1,-4,5,1,-4,4,0,-3,3,0,0,-13,1,4,-8,4,-5,0,-2,-1,1,-1,-1,3,-1
KR_6767600696,420,-2,-59,3,-11,-7,9,2,-3,7,4,3,1,4,-6,7,1,2,0,2,0,-3,-9,-5,-1,6,0,0,-2,0,-1,-1,-1,0,-1
KR_6760468926,420,-2,-59,-8,-2,-1,2,1,0,6,6,-1,3,2,-1,2,1,1,0,1,0,1,-3,2,-5,3,5,0,-1,-1,1,-1,1,5,-1
KR_6757074696,420,-7,-126,-28,-5,-1,3,2,-2,8,6,-2,2,0,-1,3,2,1,1,2,0,-6,4,7,-13,6,-2,0,-1,-1,-1,-1,1,5,-1
KR_6744341563,420,-2,-25,-10,-5,-1,1,0,0,2,2,1,3,4,-2,4,2,-3,4,1,-2,-13,2,-8,-2,10,2,0,0,1,-1,0,-1,3,-1
KR_6693453247,420,-6,-103,-24,-16,-7,7,0,-5,6,1,2,5,7,-3,7,4,-3,3,0,-2,-15,40,2,-7,5,-11,0,-2,-1,1,-1,-1,3,-1
KR_6768254335,420,-3,2,26,-6,-2,2,0,-4,5,1,2,1,3,-2,4,2,0,1,1,0,-6,-6,-4,-3,7,-1,0,-1,1,-1,-1,-1,3,-1
KR_6768995668,420,-3,-16,-19,-6,3,1,4,-1,3,2,1,3,4,-9,9,0,0,0,0,0,-11,-36,-1,-4,5,4,0,0,-1,1,-1,1,1,-1
KR_6768803190,420,0,-16,46,8,-4,5,1,5,1,6,3,0,3,0,2,2,4,0,4,1,10,-41,1,-8,7,29,0,1,-1,1,1,1,5,-1
KR_6768305273,420,-4,30,-5,-5,-2,2,0,-2,4,2,-2,2,0,0,2,2,1,1,2,0,-3,-172,5,-5,0,1,0,0,1,-1,-1,1,1,-1
KR_6773939674,420,-4,-82,-42,-11,-2,3,1,2,1,3,-6,7,1,-5,5,0,0,0,0,-1,-12,-11,-9,-4,13,5,0,0,-1,-1,-1,-1,4,-1
KR_6689492848,420,-2,10,-20,-12,-2,2,0,-1,6,5,-4,4,0,-4,5,1,-1,5,4,-1,-22,-2,-6,-4,10,0,0,-2,-1,-1,-1,-1,1,-1
KR_6776472081,420,0,-27,-5,0,-3,3,0,-7,7,0,5,0,5,4,3,7,1,3,4,0,6,-6,-6,-7,13,-4,0,-1,1,-1,-1,1,5,-1
KR_6761127562,420,1,-17,-12,-1,6,0,6,-2,4,2,-3,3,0,-2,4,2,0,1,1,0,-7,0,2,-5,3,-2,0,-1,-1,1,-1,1,2,-1
KR_6774013054,420,-2,-22,27,-10,-1,4,3,-1,2,1,0,2,2,-8,9,1,0,0,0,0,-21,-31,-2,-5,7,-3,0,-2,-1,1,-1,1,6,-1
KR_6776517130,440,-2,-51,-23,-4,5,0,5,-5,5,0,-1,5,4,-1,1,0,-2,2,0,0,-9,10,6,-8,2,-4,0,-2,0,-1,-1,1,0,-1
KR_6774481830,420,-1,26,-1,-1,-4,4,0,2,0,2,3,1,4,-3,5,2,1,1,2,2,1,48,1,-4,3,3,0,-1,1,-1,-1,1,5,-1
KR_6737565639,420,-6,-74,-29,-13,-3,5,2,-6,7,1,-2,2,0,-3,4,1,1,1,2,0,-20,-9,-1,-6,7,1,0,-3,-1,-1,-1,-1,2,-1
KR_6774669803,420,-2,-42,11,-4,4,1,5,3,2,5,-9,9,0,-3,4,1,1,0,1,2,-5,-42,0,-5,5,3,0,-1,-1,-1,-1,1,3,-1
KR_6748704905,420,-4,7,19,-10,-2,3,1,-3,4,1,-3,3,0,-2,2,0,0,0,0,0,-7,-14,-5,0,5,-1,0,0,-1,-1,0,-1,2,-1
KR_6742270928,420,-2,-42,0,-6,-5,6,1,0,2,2,0,1,1,-1,4,3,0,1,1,0,-5,8,9,-13,4,-5,0,-2,1,-1,-1,1,4,-1
KR_6700734884,420,-3,-82,-10,-4,-4,5,1,3,4,7,2,1,3,-6,6,0,1,1,2,0,0,-8,3,-6,3,0,0,-1,-1,1,-1,-1,6,-1
KR_6766236058,420,1,1,-4,4,2,0,2,6,1,7,-5,5,0,1,1,2,0,0,0,0,4,36,1,-6,5,0,0,0,-1,-1,-1,1,1,-1
KR_6744246212,420,0,-19,1,0,2,1,3,-4,11,7,0,2,2,2,1,3,0,0,0,2,4,-1,-1,-4,5,4,0,0,1,-1,-1,1,3,-1
KR_6775583418,420,-1,-13,28,-16,-9,12,3,2,1,3,-4,5,1,-3,4,1,-2,4,2,0,-6,6,-3,-5,8,3,0,0,-1,1,-1,-1,5,-1
KR_6757320646,420,-2,28,-4,-9,0,1,1,-6,7,1,-7,8,1,2,0,2,2,0,2,0,-10,-15,-3,-5,8,6,0,2,1,-1,1,1,2,-1
KR_6771123828,420,-3,-25,-23,-14,-4,4,0,-5,9,4,0,2,2,-4,6,2,-1,2,1,0,-26,3,0,-7,7,-3,0,-2,-1,-1,-1,-1,6,-1
KR_6776858311,420,-1,5,1,-4,-3,4,1,-2,2,0,1,1,2,2,1,3,-2,3,1,0,-7,60,1,-4,3,-2,0,-1,1,1,-1,-1,1,-1
KR_6776271373,420,0,8,-8,0,1,3,4,0,4,4,-2,3,1,2,4,6,-1,1,0,0,2,-5,-1,-4,5,-2,0,-1,-1,0,-1,-1,2,-1
KR_6744920006,420,5,65,18,9,2,0,2,8,3,11,1,1,2,-3,6,3,1,1,2,0,1,-104,-2,-6,8,5,0,3,1,-1,1,-1,4,-1
KR_6757814289,420,-5,-43,-14,-12,-7,8,1,-2,4,2,-5,6,1,1,5,6,1,0,1,0,-11,4,-9,-3,12,0,0,-1,0,-1,-1,1,0,-1
KR_6774659255,420,-3,-50,-5,-8,1,1,2,-3,4,1,0,0,0,-5,7,2,-1,3,2,0,-15,-13,0,-4,4,4,0,-1,-1,-1,-1,1,4,-1
KR_6777226662,420,-2,19,-1,-2,-2,2,0,1,2,3,-1,5,4,1,0,1,-1,1,0,0,-7,4,-4,-3,7,3,0,-2,-1,1,-1,1,2,-1
KR_6748736105,420,0,-53,4,4,-1,2,1,2,1,3,-3,6,3,4,2,6,2,1,3,0,6,-45,2,-9,7,10,0,0,-1,-1,-1,1,4,-1
KR_6767078956,420,1,25,-5,4,1,2,3,1,1,2,2,2,4,-1,3,2,1,1,2,0,6,10,3,-7,4,0,0,0,1,-1,0,-1,1,-1
KR_6758646036,420,1,-32,18,1,5,2,7,1,0,1,2,0,2,0,1,1,-7,7,0,0,-1,15,3,-8,5,-6,0,0,-1,-1,-1,-1,3,-1
KR_6774842854,420,-5,-42,-28,-10,-1,1,0,-2,3,1,-2,3,1,-5,5,0,0,1,1,-1,-10,-1,-3,-5,8,-4,0,-2,-1,1,-1,-1,5,-1
KR_6718677818,420,-2,-80,14,-13,-4,4,0,-6,7,1,0,5,5,-2,4,2,-1,2,1,-1,-18,124,1,-5,4,-3,0,-2,1,-1,-1,-1,6,-1
KR_6726412720,420,-2,-33,8,-4,-6,7,1,2,1,3,1,0,1,-2,2,0,1,1,2,0,12,23,-4,-5,9,-2,0,-2,1,-1,-1,1,1,-1
KR_6771140357,420,-1,-13,17,-6,-4,4,0,1,3,4,1,2,3,-4,7,3,0,1,1,0,2,23,0,-4,4,1,0,-1,1,-1,-1,-1,1,-1
KR_6769513741,420,-1,-35,9,-4,-3,3,0,-2,3,1,2,4,6,-1,1,0,0,0,0,0,0,1,2,-9,7,6,0,0,1,-1,1,1,1,-1
KR_6751086578,440,3,13,38,6,1,3,4,0,1,1,2,0,2,0,4,4,3,0,3,2,17,-6,-4,-4,8,-1,0,2,1,1,1,1,6,-1
KR_6769305828,420,-2,-4,-11,-4,-3,4,1,3,2,5,-3,5,2,1,1,2,-2,3,1,-1,-2,5,2,-8,6,2,0,-1,-1,-1,-1,-1,4,-1
KR_6776614878,420,1,-18,-22,8,-1,2,1,0,2,2,0,3,3,6,1,7,3,0,3,0,15,7,2,-7,5,2,0,0,1,1,0,1,1,-1
KR_6775429247,420,-2,-29,1,-5,-2,2,0,-4,5,1,-3,3,0,3,1,4,1,0,1,0,-1,2,1,-8,7,-6,0,0,1,-1,1,-1,2,-1
KR_6774707485,420,-2,-66,-14,-4,0,1,1,-1,2,1,0,3,3,-3,4,1,0,0,0,0,-3,-30,-1,-6,7,-3,0,0,1,-1,0,-1,4,-1
KR_6742792263,420,-1,41,-9,-9,0,2,2,-5,6,1,0,4,4,-5,6,1,1,0,1,0,-15,-14,0,-6,6,-3,0,-1,1,-1,-1,-1,5,-1
KR_6773735636,440,-3,-32,-7,-4,-2,4,2,-1,1,0,0,2,2,-1,4,3,0,2,2,0,-3,4,-3,-3,6,6,0,-2,-1,-1,-1,-1,2,-1
KR_6772259956,420,-1,29,9,4,5,0,5,1,0,1,-3,6,3,1,1,2,0,0,0,0,2,6,5,-6,1,-5,0,1,-1,1,1,1,1,-1
KR_6730842276,420,0,20,8,-4,1,1,2,0,1,1,-2,2,0,-2,4,2,-1,3,2,0,-2,-8,-1,-6,7,0,0,-2,1,1,-1,1,4,-1
KR_6777160551,420,-4,-77,30,-15,-1,3,2,-5,6,1,-5,7,2,-4,4,0,0,0,0,0,-17,-7,-3,-3,6,-5,0,-3,1,-1,-1,1,1,-1
KR_6765040377,420,-3,-6,-4,-12,0,3,3,-8,9,1,2,2,4,-5,9,4,-1,1,0,-3,-22,3,0,-7,7,1,0,-1,1,-1,-1,-1,4,-1
KR_6773271560,420,-7,-160,-7,-8,-4,4,0,-5,6,1,3,2,5,0,4,4,-2,3,1,0,-5,-31,1,-4,3,-5,0,-3,-1,-1,-1,1,3,-1
KR_6774370747,420,1,-12,22,1,0,1,1,1,3,4,0,0,0,0,3,3,0,0,0,0,4,34,5,-9,4,-6,0,0,-1,1,1,1,3,-1
KR_6776234504,420,1,30,-19,2,-4,5,1,0,1,1,-1,2,1,5,2,7,2,2,4,1,6,9,2,-7,5,1,0,-1,1,-1,-1,1,6,-1
KR_6771916817,420,-2,21,-15,-1,-2,2,0,0,3,3,4,1,5,1,6,7,-4,5,1,0,-2,7,4,-11,7,-4,0,-1,0,-1,-1,1,0,-1
KR_6745559019,420,-1,-23,16,0,-1,5,4,3,2,5,1,2,3,-2,2,0,-1,1,0,0,0,-4,-1,-5,6,5,0,-1,-1,1,-1,-1,6,-1
KR_6743638702,420,-1,-40,-26,-1,1,1,2,0,4,4,1,0,1,-4,4,0,1,0,1,0,-8,1,1,-6,5,-3,0,0,1,1,0,1,4,-1
KR_6770679987,420,-1,25,-3,-4,0,4,4,-4,5,1,-2,4,2,-1,2,1,3,1,4,0,-4,7,-2,-6,8,-5,0,1,1,-1,1,-1,1,-1
KR_6731937495,420,0,-31,-4,-2,-1,1,0,3,3,6,-1,5,4,0,2,2,-3,3,0,0,4,-3,0,-6,6,3,0,0,0,-1,-1,-1,0,-1
KR_6763374340,440,-1,-6,-7,2,-1,3,2,-2,2,0,3,0,3,0,2,2,2,1,3,0,4,-2,1,-4,3,-2,0,0,0,0,0,1,0,-1
KR_6771720587,440,0,46,24,-10,-2,2,0,-5,6,1,-3,5,2,-2,6,4,2,1,3,0,-13,-1,2,-6,4,-2,0,0,1,0,0,-1,5,-1
KR_6759120005,420,-1,-36,20,-4,-2,4,2,1,1,2,0,3,3,2,0,2,-5,6,1,0,-2,17,0,-10,10,-6,0,0,-1,1,-1,-1,6,-1
KR_6747799956,420,-2,-33,-8,-1,-5,5,0,-1,2,1,4,2,6,1,1,2,0,2,2,0,-2,-2,-1,-5,6,-1,0,0,-1,1,0,-1,3,-1
KR_6774353480,420,1,-20,38,3,5,2,7,2,2,4,-5,6,1,-2,3,1,3,0,3,0,5,0,-1,-4,5,4,0,3,-1,1,1,-1,6,-1
KR_6730274562,420,-2,32,2,1,-2,2,0,2,2,4,-1,3,2,3,0,3,-1,1,0,0,-1,16,0,-7,7,-10,0,0,1,1,0,-1,5,-1
KR_6753325991,420,-10,-53,-4,-24,-6,6,0,-3,4,1,-10,11,1,-2,3,1,-3,3,0,0,-14,-3,-4,-5,9,-1,0,-4,-1,-1,-1,-1,5,-1
KR_6774522844,420,-1,26,-12,2,7,0,7,-5,6,1,-1,2,1,1,3,4,0,0,0,0,-4,24,1,-7,6,-7,0,0,-1,-1,-1,1,2,-1
KR_6743646423,420,-2,-42,-7,-6,0,0,0,-3,4,1,1,1,2,-3,4,1,-1,1,0,0,-9,-7,-4,-5,9,0,0,-1,-1,-1,-1,-1,3,-1
KR_6774119186,420,3,37,4,5,-1,1,0,1,2,3,0,1,1,3,0,3,2,0,2,0,8,5,3,-5,2,2,0,1,-1,1,1,1,4,-1
KR_6773693616,420,-2,-17,-24,-3,-2,2,0,4,4,8,-6,6,0,-1,5,4,2,1,3,0,1,107,-2,-4,6,3,0,0,-1,1,0,1,6,-1
KR_6766851353,420,-1,13,8,-6,0,1,1,0,1,1,-1,1,0,-5,6,1,0,0,0,0,-10,-3,-3,-6,9,4,0,-1,-1,1,-1,-1,3,-1
KR_6747512079,420,-1,32,-20,0,-3,3,0,-1,3,2,3,2,5,0,2,2,1,1,2,0,6,3,2,-6,4,1,0,0,1,-1,0,-1,4,-1
KR_6773743018,420,-5,13,-14,-8,1,2,3,0,2,2,-4,5,1,-6,6,0,1,1,2,0,-7,0,2,-6,4,-2,0,0,-1,-1,-1,-1,2,-1
KR_6766912025,420,-1,-38,-6,2,-5,5,0,6,3,9,1,2,3,-1,5,4,1,1,2,2,17,-186,-2,-7,9,5,0,0,1,1,-1,1,6,-1
KR_6770416555,420,-1,-30,-4,4,0,1,1,2,4,6,1,3,4,1,4,5,0,1,1,1,5,-9,2,-9,7,-2,0,0,-1,1,0,1,4,-1
KR_6768741893,420,-2,-58,-20,-8,5,2,7,-6,9,3,0,3,3,-2,5,3,-5,6,1,-1,-8,4,1,-7,6,-6,0,-1,-1,1,-1,-1,5,-1
KR_6737020291,420,2,14,-16,4,2,3,5,-6,8,2,1,1,2,-1,5,4,8,0,8,1,7,1,2,-6,4,-3,0,0,-1,-1,-1,1,5,-1
KR_6740518311,420,0,9,8,-2,-4,6,2,1,4,5,3,0,3,-4,5,1,2,0,2,0,-6,3,2,-11,9,-3,0,1,1,0,1,-1,3,-1
KR_6716602001,420,-3,-52,-14,-9,0,3,3,1,3,4,-5,5,0,-3,5,2,-2,2,0,0,-12,-11,-2,-5,7,6,0,0,-1,-1,0,-1,5,-1
KR_6777148663,420,0,27,0,0,0,1,1,4,0,4,1,1,2,-5,6,1,0,1,1,0,-3,15,1,-8,7,-1,0,0,-1,1,0,-1,3,-1
KR_6762030671,420,0,62,23,-5,-1,2,1,-1,2,1,3,0,3,-5,8,3,-1,3,2,-1,-10,-3,1,-6,5,2,0,-1,0,-1,-1,-1,0,-1
KR_6762888369,420,-1,-56,20,-7,-1,1,0,4,1,5,-7,7,0,-1,2,1,-2,2,0,0,-12,2,-2,-3,5,-2,0,-2,1,-1,-1,-1,1,-1
KR_6773323290,420,-4,-51,-11,-7,-3,3,0,4,2,6,0,3,3,-4,6,2,-4,4,0,0,0,4,1,-7,6,2,0,0,1,-1,0,1,3,-1
KR_6769152776,420,1,60,28,-6,1,1,2,3,0,3,-4,6,2,-5,6,1,-1,2,1,1,-14,-10,-2,-4,6,-2,0,-1,1,-1,1,1,2,-1
KR_6759862750,420,-2,-7,-13,4,1,0,1,-3,6,3,2,2,4,3,3,6,1,1,2,3,12,0,2,-6,4,-1,0,0,1,1,-1,1,5,-1
KR_6773985532,420,-3,-60,31,-4,-1,3,2,-1,2,1,0,1,1,-5,6,1,3,0,3,0,-5,-5,-6,-4,10,-3,0,-1,-1,1,-1,-1,4,-1
KR_6777049243,420,1,-51,-21,1,3,1,4,-1,4,3,2,2,4,-4,6,2,1,1,2,-1,1,67,-2,-5,7,-4,0,0,-1,-1,0,1,2,-1
KR_6740886322,420,-2,-37,-7,-3,1,1,2,2,3,5,-12,13,1,6,1,7,0,2,2,-1,3,-5,3,-7,4,0,0,-1,-1,-1,-1,-1,4,-1
KR_6759996750,420,-3,37,-21,-6,2,1,3,-5,6,1,-2,2,0,-4,4,0,3,0,3,0,-9,5,1,-6,5,-6,0,0,-1,-1,-1,1,5,-1
KR_6707879790,420,-3,9,-17,-4,1,1,2,1,3,4,1,0,1,-4,4,0,-3,5,2,0,-11,-13,-3,-2,5,1,0,-1,-1,-1,-1,-1,1,-1
KR_6739379649,420,0,-20,-19,4,3,1,4,3,1,4,0,1,1,-2,5,3,0,1,1,0,-2,2,2,-9,7,-1,0,0,-1,1,-1,1,4,-1
KR_6768565959,420,3,26,-4,0,3,1,4,-3,6,3,-2,4,2,1,0,1,1,0,1,-2,-7,12,-3,-2,5,5,0,1,-1,-1,1,-1,2,-1
KR_6756629006,420,-3,-41,-13,0,2,1,3,-3,4,1,1,1,2,0,1,1,0,3,3,0,3,-2,5,-8,3,-3,0,-1,-1,-1,-1,-1,5,-1
KR_6776649548,420,-2,-45,5,-3,-3,5,2,-1,3,2,0,3,3,-2,3,1,3,0,3,-1,-8,-9,0,-4,4,-2,0,1,-1,1,1,1,4,-1
KR_6761237442,420,-1,-80,-13,-1,3,0,3,2,1,3,-4,5,1,-1,5,4,-1,1,0,0,3,-9,-1,-5,6,-5,0,-3,-1,-1,-1,-1,6,-1
KR_6777160866,420,-3,-71,-5,-7,0,2,2,-2,3,1,-2,3,1,-3,4,1,0,2,2,0,-12,1,1,-8,7,-5,0,-1,-1,-1,-1,1,3,-1
KR_6775362264,420,2,6,0,3,0,1,1,-1,2,1,3,3,6,-2,2,0,3,0,3,0,-7,31,-3,-6,9,1,0,1,-1,-1,1,1,5,-1
KR_6775029266,420,2,41,19,-5,-2,4,2,-1,4,3,1,2,3,-1,3,2,-2,3,1,0,-6,-11,-2,-4,6,4,0,-2,-1,-1,-1,1,3,-1
KR_6775252363,420,-1,-18,2,3,3,1,4,2,1,3,-3,4,1,1,1,2,0,0,0,0,1,-8,-1,-5,6,4,0,0,-1,1,1,1,6,-1
KR_6777335036,420,-2,-59,4,-7,-1,2,1,-2,2,0,-3,5,2,0,4,4,-1,2,1,1,-10,33,0,-3,3,2,0,-2,-1,-1,-1,1,5,-1
KR_6761927524,440,1,5,-16,3,8,1,9,3,4,7,-4,4,0,-3,5,2,-1,1,0,0,3,-6,4,-8,4,2,0,1,1,1,1,1,4,-1
KR_6746924620,420,-3,-6,15,-1,-1,5,4,1,5,6,1,1,2,-3,6,3,1,1,2,1,-9,-1,-1,-7,8,5,0,0,1,1,1,1,1,-1
KR_6758583482,420,-2,-71,-28,-5,1,0,1,1,4,5,2,2,4,-9,10,1,0,1,1,0,4,-12,-5,-6,11,1,0,0,-1,1,-1,-1,2,-1
KR_6774039744,420,-3,-33,-25,-9,-1,1,0,-2,3,1,-4,6,2,-1,1,0,-1,1,0,0,-15,-70,1,-5,4,1,0,0,1,-1,-1,1,2,-1
KR_6768148677,440,0,7,-12,-10,2,0,2,-6,6,0,-7,8,1,-2,6,4,3,1,4,0,-8,10,-2,-4,6,-1,0,0,-1,1,-1,-1,6,-1
KR_6775382025,420,2,22,6,-4,1,0,1,-2,5,3,-3,6,3,-2,4,2,2,1,3,0,-2,32,2,-8,6,-4,0,0,1,-1,-1,-1,6,-1
KR_6676561233,420,-2,-38,7,-11,-5,5,0,-1,2,1,-2,2,0,0,1,1,-3,3,0,-3,-19,33,-1,-6,7,-20,0,0,-1,1,1,1,1,-1
KR_6728104497,420,-4,-27,-2,-7,3,1,4,-6,6,0,-4,5,1,0,2,2,0,0,0,0,-8,-6,-1,-5,6,0,0,-1,-1,-1,-1,-1,1,-1
KR_6777586309,420,-1,46,-20,-11,1,1,2,-3,7,4,-9,10,1,-1,2,1,1,1,2,-1,-17,-12,-1,-5,6,6,0,-1,-1,-1,-1,-1,6,-1
KR_6770747248,420,1,-26,0,4,-2,2,0,-2,3,1,0,2,2,7,0,7,1,0,1,0,2,-5,-2,-6,8,2,0,0,1,1,0,-1,5,-1
KR_6777764738,420,-2,25,-4,-11,1,1,2,-11,12,1,-1,2,1,-1,6,5,1,0,1,3,-14,-43,5,-9,4,-4,0,1,-1,1,1,1,2,-1
KR_6775876948,420,-3,16,-31,-7,1,1,2,-3,4,1,-6,6,0,1,2,3,0,0,0,0,-8,11,0,-5,5,-1,0,-2,-1,1,-1,-1,2,-1
KR_6754848752,420,-4,-24,-11,-13,-2,2,0,2,3,5,-4,5,1,-5,6,1,-4,5,1,0,-12,-33,-6,-4,10,0,0,-2,-1,-1,-1,-1,1,-1
KR_6660946221,420,-3,-51,19,-8,-1,3,2,0,2,2,-4,6,2,-4,10,6,1,1,2,-1,-21,-2,0,-6,6,0,0,-1,-1,-1,-1,1,3,-1
KR_6729530278,420,-2,-5,21,-18,-5,6,1,-5,7,2,1,5,6,-7,9,2,-2,2,0,-2,-17,42,-5,-4,9,2,0,-1,-1,-1,-1,-1,6,-1
KR_6777377439,420,-3,-24,2,-7,-2,2,0,5,0,5,-7,7,0,-4,5,1,1,1,2,0,-7,99,2,-9,7,3,0,1,-1,1,1,-1,3,-1
KR_6773875509,420,-3,-28,20,-14,-2,2,0,0,2,2,-5,6,1,-6,6,0,-1,1,0,0,-17,-152,-1,-7,8,2,0,-1,-1,1,-1,-1,4,-1
KR_6775717362,420,-1,-66,4,1,-3,3,0,4,3,7,1,0,1,-1,2,1,0,1,1,0,2,-1,-2,-4,6,5,0,0,1,1,1,-1,5,-1
KR_6748370103,420,-5,-156,-23,-14,-4,8,4,0,1,1,-5,5,0,-1,4,3,-4,4,0,0,0,11,0,-6,6,-2,0,-4,-1,-1,-1,1,3,-1
KR_6771300989,440,-5,-55,-8,-11,-5,6,1,-6,7,1,-1,1,0,2,1,3,-1,3,2,0,-9,3,1,-6,5,-4,0,-1,1,-1,-1,-1,3,-1
KR_6729210773,420,-4,-79,-1,1,5,0,5,-3,3,0,1,2,3,-1,2,1,-1,1,0,1,2,0,-2,-4,6,1,0,1,-1,1,-1,1,6,-1
KR_6742332214,440,-1,-42,0,3,0,1,1,3,1,4,2,0,2,-1,2,1,-1,2,1,0,5,-29,-2,-3,5,2,0,0,1,0,-1,1,6,-1
KR_6744256102,420,-1,24,-15,-5,-3,3,0,-8,9,1,0,2,2,5,1,6,1,2,3,0,0,15,-1,-5,6,-3,0,0,0,-1,-1,1,0,-1
KR_6756356847,420,-1,-17,20,-5,-4,4,0,-3,4,1,-2,3,1,2,1,3,2,1,3,-1,-2,-18,-3,-3,6,4,0,-2,1,-1,-1,-1,5,-1
KR_6770021107,420,-1,4,-11,0,1,1,2,3,2,5,-1,3,2,-4,6,2,1,2,3,0,-3,-16,0,-6,6,1,0,0,-1,1,1,-1,4,-1
KR_6678470872,420,1,41,13,6,3,1,4,-3,8,5,-3,4,1,9,0,9,0,0,0,0,4,7,1,-7,6,1,0,1,1,1,1,1,2,-1
KR_6777030099,420,-4,13,-40,-4,-3,4,1,2,1,3,-2,2,0,-2,3,1,1,0,1,0,-6,-2,4,-10,6,2,0,0,-1,1,0,-1,5,-1
KR_6770839907,420,-5,-29,-24,-12,-1,2,1,-10,10,0,-3,3,0,2,3,5,0,0,0,0,-18,-36,-9,-2,11,-1,0,0,-1,-1,-1,-1,6,-1
KR_6773530002,420,0,-29,7,-3,-4,5,1,-2,3,1,3,0,3,0,4,4,0,0,0,0,-2,6,2,-7,5,-5,0,-2,1,-1,-1,-1,5,-1
KR_6775983416,420,2,9,-25,4,-2,4,2,0,4,4,4,1,5,1,2,3,1,1,2,-1,13,10,-4,-4,8,2,0,0,1,-1,0,-1,3,-1
KR_6744118054,420,-2,-13,-24,-7,-3,3,0,-2,3,1,-2,4,2,0,1,1,0,0,0,0,0,-1,0,-8,8,1,0,-2,1,-1,-1,-1,5,-1
KR_6764743454,420,0,46,-10,-2,3,1,4,-2,2,0,-3,3,0,0,2,2,0,0,0,0,-4,-17,2,-9,7,2,0,0,-1,-1,-1,1,2,-1
KR_6760362250,420,-2,10,-27,-5,-3,3,0,-3,4,1,2,0,2,-1,7,6,0,0,0,0,-7,-14,-2,-4,6,4,0,-1,1,-1,-1,-1,5,-1
KR_6772396416,420,-3,-11,-5,-2,2,0,2,-3,4,1,-1,3,2,3,1,4,-3,5,2,0,1,38,1,-8,7,-20,0,0,1,-1,0,-1,6,-1
KR_6716737674,420,1,29,14,-4,1,0,1,0,2,2,-4,4,0,0,2,2,-1,2,1,0,-4,1,-1,-6,7,0,0,0,-1,1,0,1,6,-1
KR_6763557532,420,-6,-83,-22,-8,-7,8,1,1,1,2,-1,3,2,0,1,1,-1,1,0,0,0,-33,5,-9,4,0,0,-2,-1,-1,-1,-1,6,-1
KR_6771799547,420,-3,-35,-23,-7,-3,4,1,0,1,1,-2,4,2,-3,5,2,1,0,1,-1,-11,135,4,-7,3,-4,0,0,-1,-1,-1,-1,6,-1
KR_6767547371,420,-3,-129,-16,-10,-3,4,1,-6,7,1,0,4,4,0,1,1,-1,1,0,0,-7,-11,-6,-4,10,0,0,-3,-1,1,-1,-1,2,-1
KR_6772345664,420,-3,-23,-16,-5,0,2,2,-4,6,2,1,1,2,-2,2,0,0,1,1,0,-8,2,1,-7,6,3,0,1,-1,1,1,-1,1,-1
KR_6706431744,420,3,36,16,9,4,0,4,-1,4,3,2,0,2,1,4,5,3,1,4,1,0,-27,2,-5,3,-1,0,0,-1,1,1,1,5,-1
KR_6764944070,420,0,0,6,-6,0,0,0,5,1,6,-2,4,2,-7,10,3,-2,2,0,1,-13,19,-1,-6,7,-2,0,1,-1,1,1,1,4,-1
KR_6768000260,420,0,-36,-30,-2,3,1,4,3,1,4,0,1,1,-7,8,1,-1,1,0,0,-5,148,3,-9,6,0,0,1,-1,1,1,-1,3,-1
KR_6745776214,420,-3,-50,4,-6,-1,1,0,3,4,7,-3,4,1,-5,6,1,0,0,0,0,-13,-3,-1,-3,4,-3,0,-1,-1,-1,-1,-1,6,-1
KR_6774690216,420,0,35,7,-4,-1,2,1,-3,4,1,2,2,4,-1,1,0,-1,1,0,0,-4,-5,0,-5,5,3,0,-1,-1,1,-1,-1,1,-1
KR_6776783065,420,-3,1,9,-11,2,0,2,-7,7,0,-1,3,2,-2,5,3,-3,3,0,0,-15,18,2,-9,7,-9,0,0,1,-1,-1,1,4,-1
KR_6774899704,440,0,-20,-1,-6,-2,3,1,-1,5,4,0,0,0,-3,4,1,0,3,3,-1,-11,-5,-3,-5,8,-2,0,0,1,-1,-1,-1,5,-1
KR_6774994135,440,-2,-14,-28,-5,1,1,2,1,5,6,-4,4,0,-1,4,3,-2,3,1,0,-4,8,-1,-7,8,0,0,1,-1,1,1,-1,3,-1
KR_6773380830,420,-2,-39,-18,-4,1,1,2,0,2,2,-2,3,1,-2,3,1,-1,1,0,0,-2,-3,0,-5,5,-3,0,1,-1,-1,1,1,5,-1
KR_6771310248,420,1,84,14,7,4,1,5,0,4,4,-3,7,4,6,0,6,0,1,1,0,-3,10,5,-8,3,-6,0,1,1,1,1,1,6,-1
KR_6773521469,420,-2,-67,-13,-8,-7,8,1,-1,3,2,2,2,4,-2,3,1,0,2,2,-1,-10,-8,2,-7,5,-1,0,0,-1,-1,-1,-1,6,-1
KR_6775883677,440,-1,-27,8,-7,0,1,1,-5,6,1,0,0,0,-1,1,0,-1,1,0,0,-8,-6,-5,-3,8,-1,0,-1,1,-1,-1,-1,6,-1
KR_6772251765,440,-6,-49,-22,-17,1,2,3,-12,12,0,-3,6,3,-3,4,1,0,1,1,-3,-29,3,1,-4,3,1,0,0,0,-1,-1,-1,0,-1
KR_6777191323,420,0,17,-8,-7,0,1,1,-2,4,2,1,0,1,-4,5,1,-2,2,0,0,-7,9,-1,-5,6,3,0,1,1,-1,1,1,2,-1
KR_6776152560,420,-4,-52,-30,-18,-3,5,2,-8,8,0,-1,1,0,-5,6,1,-1,3,2,0,-26,1,-3,-2,5,-3,0,-3,-1,-1,-1,-1,4,-1
KR_6656773752,420,-2,-36,-11,-4,-5,5,0,1,2,3,3,3,6,-2,2,0,-1,2,1,0,-1,-4,-2,-4,6,2,0,-1,1,-1,-1,1,1,-1
KR_6774921840,420,-1,-6,-11,-9,-2,5,3,7,1,8,-6,7,1,-5,7,2,-3,4,1,0,-7,-2,-1,-7,8,-3,0,0,-1,-1,-1,1,6,-1
KR_6773672607,420,0,42,31,-5,2,2,4,-2,4,2,-1,3,2,-4,9,5,0,0,0,-2,-16,-1,0,-6,6,1,0,-1,-1,-1,-1,-1,2,-1
KR_6723631172,420,-5,-14,-24,-18,-4,6,2,-1,1,0,-7,9,2,-4,7,3,-2,2,0,0,-19,-7,-5,-2,7,1,0,-1,-1,1,-1,-1,5,-1
KR_6740281174,420,-4,-66,-9,-12,-2,3,1,-6,7,1,-3,5,2,0,3,3,-1,1,0,0,-15,-29,-1,-10,11,1,0,0,1,-1,-1,-1,4,-1
KR_6773975402,420,1,70,14,-4,-1,1,0,-4,4,0,2,2,4,3,1,4,-4,4,0,0,-9,-6,-1,-6,7,6,0,0,1,0,0,-1,1,-1
KR_6669077853,420,-3,-55,-20,-7,-1,3,2,-2,4,2,-5,5,0,1,0,1,0,0,0,0,-7,2,-2,-5,7,-3,0,-2,-1,-1,-1,1,3,-1
KR_6754425123,420,1,12,12,0,-1,1,0,3,1,4,3,0,3,-3,6,3,-2,2,0,0,6,-11,6,-6,0,-1,0,0,1,-1,0,-1,2,-1
KR_6736193388,420,0,5,-8,-2,2,2,4,2,3,5,-4,4,0,-2,2,0,0,0,0,0,-11,1,3,-6,3,-3,0,1,-1,1,1,-1,4,-1
KR_6718120402,440,-4,-51,-5,-8,-4,5,1,4,0,4,1,2,3,-3,3,0,-6,7,1,-1,-19,-12,-10,0,10,4,0,-1,-1,-1,-1,-1,1,-1
KR_6770070805,420,-5,-17,1,-16,-5,7,2,-9,10,1,0,3,3,-3,4,1,1,2,3,-1,-22,-27,-6,-2,8,3,0,-1,-1,-1,-1,-1,5,-1
KR_6729021326,420,-6,-96,13,-12,-1,3,2,0,4,4,-6,6,0,-6,7,1,1,0,1,0,-18,2,-1,-8,9,-5,0,-1,1,-1,-1,-1,4,-1
KR_6751148727,420,-2,1,13,-4,2,1,3,-5,6,1,0,2,2,-1,2,1,0,2,2,0,0,2,3,-7,4,0,0,1,-1,1,1,-1,2,-1
KR_6770875100,420,-4,-11,0,-9,-2,2,0,-4,6,2,-1,5,4,-1,1,0,-1,1,0,0,-10,19,-1,-9,10,-5,0,1,0,1,1,-1,0,-1
KR_6770147016,420,-4,-33,-18,-8,-2,3,1,-2,2,0,4,0,4,-7,9,2,-1,1,0,0,-14,40,-3,-5,8,-20,0,0,-1,-1,0,-1,1,-1
KR_6759416464,420,1,9,-2,4,0,0,0,5,2,7,0,0,0,0,1,1,-1,2,1,0,7,2,-1,-3,4,6,0,2,-1,1,1,-1,3,-1
KR_6776891502,420,0,-12,12,1,2,2,4,-5,7,2,1,0,1,5,1,6,-2,3,1,0,-4,-7,-1,-3,4,10,0,-1,-1,1,-1,-1,4,-1
KR_6747615718,420,-3,-9,6,-10,-1,2,1,0,3,3,-2,3,1,-5,5,0,-2,3,1,0,-10,23,-4,-4,8,1,0,0,0,1,1,-1,0,-1
KR_6753796101,420,-1,0,-32,0,2,1,3,-5,6,1,2,1,3,2,2,4,-1,1,0,0,-7,-11,-8,-3,11,3,0,1,-1,-1,1,1,4,-1
KR_6757494469,420,-3,-34,-22,-5,1,0,1,-6,6,0,-2,3,1,1,0,1,1,0,1,0,-8,-4,1,-6,5,0,0,-1,1,1,-1,-1,1,-1
KR_6682709575,420,-5,-58,-38,-12,0,3,3,-4,4,0,-1,3,2,-2,3,1,-5,5,0,-2,-13,54,-2,-7,9,0,0,-3,-1,-1,-1,-1,1,-1
KR_6738087750,440,-6,-76,-25,-9,-4,5,1,0,0,0,-1,3,2,-3,5,2,-1,1,0,0,-12,-24,0,-3,3,-3,0,-2,1,-1,-1,-1,2,-1
KR_6770782670,420,-3,-40,-20,-5,-3,4,1,2,4,6,-8,8,0,2,3,5,2,0,2,0,1,-6,-5,-5,10,-1,0,-1,-1,-1,-1,-1,5,-1
KR_6666228154,420,1,-37,-9,4,6,0,6,-3,3,0,1,3,4,0,3,3,0,0,0,0,4,-23,-3,-3,6,6,0,1,-1,1,1,1,3,-1
KR_6776924802,420,-2,-21,-7,-3,2,1,3,0,1,1,0,1,1,-3,7,4,-2,2,0,0,-4,-38,1,-5,4,-4,0,0,-1,1,1,-1,5,-1
KR_6760025822,420,-4,-80,-47,-6,0,1,1,-5,5,0,1,2,3,-4,5,1,2,0,2,0,-2,156,-1,-7,8,7,0,-1,-1,-1,-1,-1,5,-1
KR_6671509812,420,-3,-78,14,-10,-6,6,0,-1,4,3,0,3,3,-3,4,1,0,1,1,0,-2,2,0,-10,10,-10,0,-2,-1,1,-1,-1,2,-1
KR_6758488261,420,-2,-69,3,-1,6,4,10,3,2,5,-2,2,0,-8,9,1,0,1,1,1,2,3,2,-7,5,1,0,-1,1,1,-1,1,4,-1
KR_6777675815,440,0,5,19,-5,2,1,3,-4,6,2,1,0,1,-4,5,1,0,0,0,-1,-14,8,3,-8,5,0,0,-1,-1,1,-1,-1,2,-1
KR_6729837110,420,-2,-69,-25,-3,2,1,3,-2,3,1,1,2,3,-4,6,2,0,0,0,0,-5,5,1,-6,5,2,0,-2,1,-1,-1,-1,2,-1
KR_6765070056,420,1,-38,-21,6,-3,3,0,4,2,6,1,1,2,3,5,8,1,1,2,1,11,-3,-1,-4,5,6,0,1,-1,1,1,-1,2,-1
KR_6774120645,420,-1,-24,0,-9,-2,3,1,-2,5,3,1,3,4,-7,8,1,1,1,2,1,-15,4,0,-4,4,-4,0,-1,1,-1,-1,1,2,-1
KR_6682139044,420,0,-6,-17,1,0,1,1,1,2,3,2,3,5,-1,3,2,-1,1,0,0,2,-7,-8,-4,12,5,0,-2,1,-1,-1,-1,2,-1
KR_6741725860,420,-5,-62,-23,-8,-3,3,0,1,1,2,-1,2,1,-2,2,0,-3,3,0,0,-10,-5,1,-6,5,0,0,-2,1,-1,-1,-1,4,-1
KR_6774862563,420,3,65,-8,8,-1,2,1,4,0,4,1,0,1,3,4,7,1,0,1,1,5,16,2,-8,6,4,0,2,1,1,1,1,4,-1
KR_6776955720,420,-1,-32,24,-1,1,1,2,2,3,5,0,1,1,-2,4,2,-2,2,0,0,-4,17,1,-6,5,-5,0,0,-1,1,-1,-1,3,-1
KR_6760824154,440,-5,-52,12,-14,-1,3,2,-9,11,2,-2,3,1,-2,5,3,0,1,1,0,-14,-1,-4,-1,5,-1,0,-1,-1,1,-1,1,1,-1
KR_6695224670,420,2,48,15,-2,-1,2,1,-4,4,0,0,1,1,3,1,4,0,1,1,0,-5,1,-1,-5,6,-3,0,-1,1,-1,-1,-1,3,-1
KR_6776302590,440,-2,-32,-4,-4,-3,4,1,2,0,2,2,2,4,-6,8,2,1,0,1,0,-1,159,-1,-6,7,-1,0,-1,0,0,-1,-1,0,-1
KR_6775784496,420,-5,-54,-31,-6,-2,3,1,-1,4,3,0,1,1,0,2,2,-3,3,0,1,0,3,3,-11,8,-12,0,-2,-1,-1,-1,1,5,-1
KR_6768752701,420,0,22,16,3,-2,2,0,0,4,4,1,1,2,4,2,6,0,1,1,0,3,-1,-5,-4,9,2,0,1,-1,1,1,1,2,-1
KR_6762521509,440,-2,-17,30,-2,2,3,5,0,3,3,-1,4,3,1,5,6,-4,5,1,-1,-2,-8,-4,-3,7,-1,0,1,-1,1,1,-1,6,-1
KR_6776994126,420,-2,-83,-42,-10,-1,3,2,-2,4,2,-1,2,1,-2,2,0,-4,4,0,0,-15,-10,-1,-2,3,1,0,-1,-1,1,-1,-1,4,-1
KR_6746000397,420,1,4,11,-7,-2,4,2,-5,5,0,3,1,4,-2,3,1,-1,1,0,0,-12,8,-3,-2,5,-3,0,-2,1,-1,-1,1,4,-1
KR_6776975317,420,1,-39,-13,0,-1,1,0,-1,2,1,-3,4,1,5,1,6,0,0,0,0,4,-2,-4,-4,8,1,0,-2,-1,1,-1,1,5,-1
KR_6772317431,420,-1,-7,-25,2,2,0,2,3,0,3,-1,4,3,-2,2,0,0,1,1,0,2,4,1,-3,2,0,0,1,-1,1,1,1,6,-1
KR_6769042038,420,-4,-37,-29,-7,-5,5,0,-3,3,0,-3,7,4,3,2,5,1,0,1,0,-8,198,1,-8,7,-3,0,-1,-1,1,-1,1,5,-1
KR_6773734683,440,-2,-15,-23,-4,0,3,3,2,0,2,-5,5,0,-1,4,3,0,2,2,0,-4,-68,3,-7,4,0,0,0,1,-1,0,1,1,-1
KR_6772439325,420,4,56,16,-2,0,3,3,2,7,9,-6,7,1,3,3,6,-1,1,0,0,-12,12,1,-6,5,-4,0,1,-1,1,1,1,4,-1
KR_6776216214,420,3,8,19,3,-2,2,0,-2,6,4,6,3,9,3,0,3,-2,5,3,0,9,-12,2,-6,4,1,0,0,-1,1,-1,-1,4,-1
KR_6772854889,440,-4,-38,-5,-10,-1,1,0,-2,4,2,-2,2,0,-5,8,3,0,0,0,0,-10,-19,-1,-5,6,-2,0,-1,-1,1,-1,1,4,-1
KR_6772261162,420,-6,-58,-8,-19,-5,6,1,-2,3,1,-4,4,0,-5,7,2,-3,3,0,0,-16,-2,-4,-1,5,1,0,-4,-1,-1,-1,-1,5,-1
KR_6771092200,420,-2,25,-30,-5,-1,1,0,2,1,3,-11,13,2,3,2,5,2,0,2,0,-2,-106,2,-7,5,1,0,0,-1,1,0,-1,6,-1
KR_6759256089,420,-5,-62,-25,-6,-1,1,0,-3,6,3,3,2,5,-4,6,2,-1,2,1,0,-9,3,1,-7,6,0,0,0,1,-1,0,1,5,-1
KR_6770999613,420,0,22,-31,3,0,0,0,-4,4,0,2,0,2,4,2,6,1,0,1,0,6,0,0,-5,5,2,0,0,1,-1,0,-1,1,-1
KR_6770910204,420,2,-17,8,-2,-2,5,3,0,2,2,3,1,4,-3,5,2,0,0,0,0,-2,-28,0,-7,7,-4,0,-1,-1,-1,-1,-1,2,-1
KR_6708324378,420,-2,23,-10,-7,1,1,2,-3,5,2,-4,4,0,-2,3,1,1,0,1,0,-4,-12,-7,-3,10,5,0,0,-1,1,0,-1,5,-1
KR_6777135757,420,1,46,28,-2,0,0,0,-2,2,0,-2,2,0,2,3,5,0,1,1,0,-1,25,5,-6,1,1,0,0,-1,0,0,1,5,-1
KR_6776735334,420,-1,-11,-20,-5,-2,3,1,2,1,3,-7,7,0,-2,4,2,4,0,4,1,3,11,-3,-4,7,-3,0,-2,-1,-1,-1,1,3,-1
KR_6762593670,440,-5,-33,-11,-14,-2,2,0,-5,5,0,-4,5,1,-3,4,1,0,0,0,-2,-17,6,0,-2,2,-5,0,0,-1,-1,0,-1,5,-1
KR_6734888054,420,-2,-69,-3,-9,-2,4,2,0,3,3,-5,6,1,-3,4,1,1,0,1,0,-12,2,-2,-3,5,-3,0,0,-1,-1,-1,-1,4,-1
KR_6775518415,440,-2,26,-12,-2,4,0,4,0,6,6,-5,5,0,0,4,4,-1,3,2,0,-7,1,1,-6,5,0,0,-1,1,-1,-1,-1,5,-1
KR_6710128801,420,-4,-68,1,-13,-7,8,1,-4,6,2,1,5,6,-2,7,5,-1,1,0,-1,-11,7,-3,-5,8,-4,0,-2,-1,-1,-1,-1,4,-1
KR_6685790682,420,-6,-12,5,-7,-1,2,1,-7,8,1,1,1,2,1,4,5,-1,2,1,0,-14,4,3,-8,5,-4,0,-1,-1,-1,-1,-1,1,-1
KR_6770873869,420,-5,-62,0,-6,-2,2,0,1,0,1,-2,5,3,-2,3,1,-1,1,0,0,-4,-212,1,-10,9,-23,0,-1,-1,-1,-1,-1,1,-1
KR_6595198222,420,-5,-74,-25,-7,-3,3,0,0,3,3,-3,4,1,-3,3,0,2,0,2,0,-7,-149,-1,-6,7,-2,0,-2,-1,1,-1,-1,6,-1
KR_6772695738,420,-6,-48,-18,-10,-2,2,0,-4,4,0,-3,4,1,0,0,0,-1,1,0,0,-9,29,4,-8,4,-6,0,0,1,-1,1,-1,2,-1
KR_6774455848,420,0,29,20,-1,-1,3,2,-1,4,3,-1,3,2,-2,3,1,4,0,4,0,1,-2,-4,-2,6,0,0,2,-1,-1,1,1,2,-1
KR_6777838202,420,2,-5,8,-4,2,1,3,-3,5,2,0,0,0,-4,6,2,1,0,1,0,-5,21,3,-6,3,-3,0,1,-1,1,1,-1,5,-1
KR_6728143242,440,-6,2,-56,-14,-3,5,2,-5,7,2,-2,2,0,2,0,2,-6,7,1,0,-12,-8,-2,-2,4,1,0,-2,-1,-1,-1,1,3,-1
KR_6777718807,420,-2,12,-57,0,1,0,1,-5,5,0,2,0,2,2,2,4,0,1,1,0,-1,0,1,-5,4,-1,0,0,-1,-1,0,-1,5,-1
KR_6770517500,420,2,-15,-1,2,1,2,3,1,2,3,0,5,5,0,1,1,0,0,0,0,6,8,4,-9,5,0,0,0,-1,1,0,-1,2,-1
KR_6691279586,420,-3,-47,-10,-4,1,1,2,0,1,1,1,1,2,-6,10,4,0,1,1,-2,-11,3,-2,-6,8,-2,0,-2,-1,1,-1,-1,6,-1
KR_6777273678,420,-3,16,-5,-5,-1,1,0,0,5,5,-2,2,0,-2,4,2,0,0,0,0,-12,6,-1,-6,7,-4,0,-1,-1,-1,-1,1,5,-1
KR_6756639742,420,-4,-17,9,-10,0,0,0,-5,8,3,-4,6,2,-1,2,1,0,0,0,0,-19,28,3,-10,7,-4,0,-1,-1,-1,-1,-1,4,-1
KR_6772764576,420,-3,-67,5,-5,-3,5,2,-2,2,0,-2,4,2,1,3,4,1,0,1,0,-2,-34,1,-8,7,1,0,1,-1,-1,-1,-1,1,-1
KR_6769099685,420,-2,-9,13,-9,-1,1,0,0,3,3,-4,5,1,-4,4,0,0,0,0,0,-9,6,-1,-3,4,3,0,-1,-1,-1,-1,-1,6,-1
KR_6775130545,440,1,26,-8,6,-2,3,1,1,0,1,5,0,5,3,2,5,-1,2,1,1,8,-10,-3,-5,8,1,0,0,-1,1,0,1,2,-1
KR_6773200929,420,-3,-65,-3,-7,-4,4,0,-6,7,1,1,2,3,2,1,3,0,0,0,0,-6,-248,3,-6,3,-1,0,-1,-1,-1,-1,-1,5,-1
KR_6723499949,420,-2,-25,9,-5,2,0,2,2,0,2,0,3,3,-7,7,0,-2,3,1,0,-10,-2,-1,-5,6,-3,0,0,-1,-1,-1,-1,3,-1
KR_6697299017,420,-1,-48,-4,-1,-2,4,2,2,2,4,-1,2,1,1,2,3,-1,1,0,0,5,-7,-2,-7,9,6,0,-1,1,-1,-1,-1,5,-1
KR_6774179042,420,1,14,13,1,0,1,1,1,1,2,2,1,3,-3,4,1,1,1,2,0,1,0,2,-8,6,-4,0,1,1,1,1,-1,3,-1
KR_6774773661,420,-1,4,-12,0,-2,3,1,0,0,0,1,2,3,1,1,2,0,0,0,0,7,-9,-2,-4,6,-2,0,0,-1,-1,0,-1,1,-1
KR_6722851000,440,-5,-103,-27,-15,-2,3,1,-2,3,1,0,2,2,-2,3,1,-9,11,2,-1,-15,-1,0,-3,3,-2,0,-1,-1,0,-1,-1,6,-1
KR_6763815255,420,-4,-67,0,-8,-5,5,0,-2,2,0,-1,2,1,0,1,1,0,1,1,0,-6,-1,2,-6,4,-4,0,0,-1,1,0,1,5,-1
KR_6775100738,420,3,17,40,-6,-1,1,0,-2,3,1,1,2,3,-4,5,1,0,0,0,0,-10,-4,2,-8,6,-1,0,0,-1,-1,0,-1,5,-1
KR_6776526857,420,-6,14,-17,-10,-1,1,0,0,0,0,-5,5,0,-3,5,2,-1,3,2,0,-12,37,5,-9,4,-6,0,0,-1,-1,0,1,3,-1
KR_6716668156,420,-3,-23,-10,-9,-1,1,0,-11,11,0,2,0,2,2,4,6,-1,2,1,0,-14,27,1,-6,5,-21,0,-1,-1,-1,-1,1,2,-1
KR_6728389992,420,-1,-20,12,-6,1,2,3,-3,5,2,-3,4,1,-2,6,4,1,0,1,1,-15,-26,-3,-4,7,1,0,0,-1,-1,-1,1,2,-1
KR_6769308864,420,2,42,-4,1,0,2,2,1,2,3,-2,2,0,2,4,6,0,0,0,0,4,-7,4,-7,3,4,0,0,1,-1,-1,1,6,-1
KR_6774765594,420,-4,-67,-16,-7,0,1,1,-3,4,1,-6,8,2,-2,3,1,4,0,4,0,-2,9,-1,-6,7,-2,0,-3,-1,-1,-1,-1,1,-1
KR_6776151249,420,3,16,-3,14,4,0,4,3,1,4,5,3,8,1,2,3,1,0,1,1,18,1,4,-7,3,3,0,1,1,1,1,1,3,-1
KR_6760541304,420,1,9,12,4,3,1,4,-2,2,0,0,1,1,1,2,3,2,0,2,0,3,12,-3,-4,7,5,0,0,-1,1,0,-1,5,-1
KR_6774568093,440,-4,3,0,-10,0,2,2,-1,5,4,-8,8,0,0,1,1,-1,1,0,0,-12,-10,-1,-7,8,1,0,0,1,1,0,-1,3,-1
KR_6689413779,420,-3,-45,-5,-7,1,1,2,-1,2,1,-6,6,0,-1,2,1,0,0,0,0,-6,-19,-2,-4,6,2,0,-1,-1,-1,-1,-1,5,-1
KR_6771552093,420,-1,-64,4,2,-4,4,0,3,1,4,2,0,2,0,1,1,1,1,2,0,12,71,4,-7,3,-6,0,0,1,-1,-1,-1,6,-1
KR_6747991446,420,-6,-111,-16,-11,-2,7,5,-4,4,0,-1,2,1,-4,5,1,0,0,0,1,-6,-1,1,-5,4,-4,0,-1,-1,1,-1,1,2,-1
KR_6765051135,420,-1,-30,3,-4,-6,6,0,3,0,3,-4,4,0,3,0,3,0,0,0,0,2,-3,2,-6,4,-5,0,0,1,-1,0,1,1,-1
KR_6746956077,420,-3,19,-9,-3,3,0,3,-2,3,1,-6,6,0,1,1,2,1,0,1,1,-10,-13,5,-11,6,-3,0,0,-1,1,0,1,4,-1
KR_6764558389,420,0,40,3,-1,-2,2,0,-3,5,2,2,1,3,4,1,5,-2,3,1,-1,2,0,2,-7,5,-1,0,0,1,-1,0,-1,4,-1
KR_6737353541,420,4,72,14,2,0,1,1,1,3,4,-1,5,4,2,2,4,0,1,1,1,0,-10,2,-9,7,-2,0,1,1,-1,1,1,5,-1
KR_6772712701,420,-2,-12,-25,-4,-3,4,1,-1,2,1,0,3,3,0,2,2,0,0,0,0,-7,15,4,-7,3,3,0,2,0,-1,1,1,0,-1
KR_6686538816,420,-2,-6,-8,-11,1,1,2,-3,6,3,1,1,2,-4,4,0,-6,8,2,0,-18,6,-1,-8,9,1,0,-2,1,-1,-1,1,6,-1
KR_6776805345,420,-5,-71,-13,-7,-2,3,1,-2,7,5,-5,7,2,2,2,4,0,1,1,0,-3,-3,-2,-3,5,0,0,-3,1,-1,-1,-1,5,-1
KR_6775835817,420,-5,-65,-42,-12,-4,4,0,-2,3,1,-5,9,4,-1,2,1,0,0,0,0,-11,3,0,-8,8,-4,0,-1,-1,-1,-1,-1,4,-1
KR_6738489926,420,-1,-18,2,-7,2,2,4,0,7,7,-5,6,1,-4,4,0,0,2,2,3,-10,-13,7,-11,4,-5,0,-2,-1,-1,-1,1,4,-1
KR_6773686459,420,-4,-21,-7,-7,-1,2,1,-2,7,5,1,1,2,-3,3,0,-2,2,0,-1,-7,18,3,-7,4,2,0,-1,1,-1,-1,-1,1,-1
KR_6776928199,440,-3,-58,31,-7,1,3,4,-1,3,2,-2,3,1,-4,5,1,-1,1,0,1,-11,3,-4,-3,7,1,0,-1,1,1,-1,1,6,-1
KR_6768810933,420,-6,-99,-9,-9,-2,3,1,-4,5,1,-2,4,2,-1,2,1,0,0,0,0,-8,-1,-1,-2,3,-2,0,-2,-1,-1,-1,-1,3,-1
KR_6750101524,420,-3,-52,7,-10,0,1,1,-4,6,2,-5,6,1,-2,3,1,1,1,2,0,-14,6,0,-4,4,-6,0,-1,-1,-1,-1,-1,1,-1
KR_6776384315,420,-1,-53,-29,-2,0,0,0,-4,5,1,2,0,2,-1,1,0,1,0,1,0,-6,-8,-5,-1,6,1,0,-2,1,-1,-1,1,2,-1
KR_6774632986,420,-2,17,-13,-2,-1,4,3,-1,1,0,0,1,1,-1,2,1,1,1,2,0,-1,0,-1,-3,4,5,0,0,-1,-1,0,1,1,-1
KR_6683987555,420,-2,-13,-10,-2,0,2,2,-4,7,3,0,2,2,6,2,8,-4,4,0,0,7,0,3,-12,9,-4,0,-1,-1,-1,-1,1,1,-1
KR_6767108096,420,-3,-89,-36,-5,-7,7,0,-3,3,0,2,4,6,3,0,3,0,0,0,0,0,141,0,-4,4,3,0,-1,-1,-1,-1,-1,2,-1
KR_6747902531,420,-3,-86,-16,-7,-1,3,2,1,2,3,-3,4,1,-5,6,1,1,1,2,0,-12,2,4,-12,8,-7,0,1,-1,1,1,-1,6,-1
KR_6735020772,420,0,9,-5,-4,1,2,3,2,2,4,-1,3,2,-4,7,3,-2,2,0,0,-12,-9,-1,-5,6,0,0,0,-1,1,1,1,2,-1
KR_6737454291,420,0,-41,1,-8,-1,1,0,-4,7,3,3,1,4,-4,4,0,-2,2,0,-1,-13,-1,-2,-4,6,4,0,-1,-1,-1,-1,1,6,-1
KR_6771927761,440,-1,-74,28,-2,1,0,1,2,0,2,-1,3,2,-3,4,1,-1,2,1,0,-4,5,6,-10,4,0,0,0,1,1,0,1,6,-1
KR_6743579935,420,-3,-93,-3,-8,-5,5,0,-2,4,2,1,2,3,0,0,0,-2,2,0,0,-5,-10,10,-13,3,-1,0,-1,-1,-1,-1,-1,3,-1
KR_6770163120,420,-1,-12,28,3,-7,7,0,3,2,5,5,0,5,1,0,1,1,3,4,0,8,6,-4,-3,7,4,0,0,1,-1,-1,1,3,-1
KR_6773244226,420,2,-14,17,3,6,1,7,1,3,4,-4,4,0,0,5,5,0,1,1,0,2,3,3,-8,5,1,0,0,-1,1,0,1,1,-1
KR_6738880083,420,1,87,5,9,-2,4,2,5,6,11,3,0,3,2,3,5,1,1,2,0,4,-9,1,-4,3,2,0,2,1,1,1,1,1,-1
KR_6774103500,420,-3,-7,-45,-3,-1,1,0,1,3,4,-5,5,0,4,1,5,-2,2,0,0,-6,-9,-3,-4,7,0,0,-1,-1,-1,-1,-1,5,-1
KR_6758449913,420,0,-68,2,-5,2,1,3,-2,2,0,-6,8,2,1,1,2,0,0,0,0,-4,-58,-6,-3,9,17,0,-2,-1,-1,-1,1,1,-1
KR_6725042188,420,1,-2,18,-1,2,1,3,-4,7,3,-1,2,1,0,4,4,2,0,2,0,-3,29,4,-9,5,-6,0,2,-1,1,1,1,4,-1
KR_6763733487,420,0,-20,35,-4,-3,4,1,-2,2,0,-2,3,1,0,1,1,3,1,4,0,-12,-6,-1,-6,7,-5,0,1,-1,1,1,-1,1,-1
KR_6768475009,420,3,54,-5,10,8,1,9,-1,3,2,-3,7,4,4,2,6,2,0,2,0,6,-5,1,-4,3,-2,0,4,-1,1,1,1,3,-1
KR_6774539509,420,-2,-84,-18,-6,-1,3,2,-1,3,2,-2,2,0,4,0,4,-6,7,1,-1,0,-6,-5,-4,9,-4,0,-2,1,-1,-1,-1,4,-1
KR_6771342111,420,-4,-84,-17,-10,-4,4,0,-4,4,0,1,2,3,-3,5,2,0,1,1,0,-13,-11,-1,-7,8,3,0,0,-1,1,0,-1,6,-1
KR_6748163849,440,-3,-19,-26,-1,3,0,3,1,2,3,-3,5,2,-2,6,4,0,1,1,0,1,-228,-3,-2,5,-4,0,-2,-1,1,-1,1,6,-1
KR_6776500431,420,0,-55,-13,-2,-3,3,0,0,3,3,0,4,4,-2,6,4,3,0,3,0,4,171,-3,-1,4,3,0,0,-1,-1,0,-1,2,-1
KR_6776350128,420,-4,-35,-11,-6,-3,3,0,2,3,5,0,1,1,0,2,2,-5,5,0,1,0,120,-3,-4,7,-6,0,-2,-1,-1,-1,1,1,-1
KR_6751192345,440,-3,-97,-39,-8,-4,5,1,0,3,3,0,4,4,-2,6,4,-2,2,0,0,-3,6,1,-6,5,1,0,-2,-1,-1,-1,-1,5,-1
KR_6717244386,420,-1,17,5,-8,4,1,5,-5,5,0,2,1,3,-7,7,0,-2,2,0,0,-20,-69,-2,-5,7,29,0,1,-1,-1,-1,-1,5,-1
KR_6760967145,420,-2,-9,-16,-1,-3,5,2,2,3,5,-2,4,2,0,3,3,2,0,2,0,-3,5,1,-6,5,-1,0,0,-1,-1,-1,-1,4,-1
KR_6745145729,420,-2,-39,-1,-3,1,1,2,1,1,2,-5,5,0,-1,4,3,1,0,1,0,-2,-191,-3,-7,10,4,0,0,-1,-1,-1,1,2,-1
KR_6738288474,420,-1,22,-20,-1,1,4,5,5,4,9,-8,9,1,1,6,7,0,0,0,0,3,12,0,-9,9,1,0,-1,-1,1,-1,-1,2,-1
KR_6775463794,420,-2,-10,-16,-4,-1,2,1,-5,6,1,-1,4,3,3,1,4,0,0,0,0,-7,-42,-3,-3,6,22,0,0,1,1,-1,1,6,-1
KR_6774438193,420,-2,17,-20,-6,0,1,1,-1,2,1,0,3,3,-5,7,2,0,0,0,0,-11,3,1,-7,6,-7,0,-1,-1,-1,-1,-1,2,-1
KR_6770555992,420,-4,-27,-4,-7,-1,3,2,1,3,4,-7,7,0,0,4,4,0,0,0,0,-7,3,-2,-9,11,6,0,-2,-1,-1,-1,1,3,-1
KR_6747834377,420,0,-18,5,-4,2,1,3,-2,6,4,-3,4,1,-1,2,1,0,0,0,0,-6,19,2,-10,8,1,0,1,-1,1,1,-1,1,-1
KR_6761639377,420,-2,-36,0,-9,-1,4,3,-2,3,1,2,0,2,-4,6,2,-4,4,0,0,-14,-272,-1,-3,4,0,0,-1,-1,-1,-1,1,5,-1
KR_6774949063,420,1,6,-11,-2,0,1,1,3,1,4,-2,2,0,-5,6,1,2,3,5,0,-3,-3,7,-9,2,-3,0,0,-1,1,0,-1,5,-1
KR_6670444882,420,-3,-19,-41,-7,-1,2,1,-3,5,2,-1,2,1,-2,2,0,0,0,0,-2,-8,-7,-2,-6,8,7,0,-2,-1,-1,-1,-1,4,-1
KR_6758460994,420,0,28,-26,5,-1,2,1,-2,5,3,-2,2,0,9,1,10,1,1,2,0,5,4,-3,-5,8,-1,0,1,1,-1,1,1,3,-1
KR_6741794585,420,-1,30,28,-4,0,1,1,-5,6,1,0,2,2,0,2,2,1,1,2,0,-9,-19,-6,-6,12,4,0,-1,1,-1,-1,1,5,-1
KR_6744960431,420,0,-12,0,-2,-2,2,0,-1,2,1,0,1,1,-1,2,1,2,0,2,0,-4,-9,0,-6,6,-1,0,0,-1,1,0,-1,4,-1
KR_6760384353,420,2,31,11,0,-3,3,0,-1,4,3,0,2,2,2,3,5,2,0,2,0,-5,9,3,-7,4,-5,0,0,1,1,-1,1,4,-1
KR_6766163180,420,-1,-81,28,-5,-3,4,1,-2,3,1,-3,4,1,2,2,4,1,2,3,1,-11,-7,-5,0,5,-3,0,-1,1,-1,-1,1,6,-1
KR_6751887665,420,1,7,8,4,2,1,3,3,0,3,-1,1,0,4,0,4,-4,7,3,0,4,1,5,-6,1,-1,0,1,1,1,1,-1,6,-1
KR_6772900896,420,-2,-65,32,-5,1,0,1,-2,2,0,-4,6,2,0,3,3,0,0,0,0,-7,-20,3,-9,6,-1,0,-1,-1,1,-1,-1,1,-1
KR_6767832385,420,-2,-47,9,-3,0,2,2,-3,5,2,2,0,2,-1,5,4,-1,2,1,0,-11,-5,-4,-5,9,-1,0,0,1,1,0,1,6,-1
KR_6752438928,420,2,27,-22,-2,1,3,4,-2,4,2,-3,4,1,4,0,4,-2,2,0,0,-3,9,4,-9,5,-1,0,0,-1,-1,0,-1,1,-1
KR_6770481881,420,0,-13,-8,4,-1,2,1,5,0,5,2,3,5,-2,4,2,0,0,0,0,10,60,1,-6,5,0,0,-1,1,1,-1,1,6,-1
KR_6772696779,420,-1,18,-4,-3,-1,5,4,-3,4,1,-1,2,1,-1,2,1,3,1,4,0,-4,-1,-3,-3,6,1,0,0,-1,1,0,1,5,-1
KR_6774829218,420,-3,-27,0,-9,-5,5,0,-1,2,1,0,1,1,-3,4,1,0,0,0,0,-5,52,-3,-2,5,-3,0,0,-1,-1,0,-1,6,-1
KR_6769188731,420,1,-20,-16,1,2,0,2,-3,6,3,2,3,5,-1,5,4,1,0,1,0,-4,10,3,-10,7,-4,0,0,1,1,1,1,5,-1
KR_6724460742,420,-5,-19,-10,-13,2,1,3,-6,8,2,0,1,1,-6,7,1,-3,4,1,0,-22,27,-1,-5,6,-2,0,-1,-1,1,-1,1,5,-1
KR_6760528885,420,-2,-3,17,-15,-2,4,2,-2,3,1,-6,9,3,-2,5,3,-3,3,0,0,-21,9,-2,-5,7,-4,0,-1,-1,1,-1,-1,5,-1
KR_6777544791,420,1,5,24,9,0,2,2,2,3,5,1,1,2,5,1,6,1,2,3,0,13,-9,0,-6,6,5,0,0,-1,1,-1,-1,1,-1
KR_6764619803,420,-3,-40,23,-13,-1,2,1,-1,3,2,-4,5,1,-7,8,1,0,0,0,0,-23,-7,1,-9,8,-1,0,-2,-1,1,-1,-1,2,-1
KR_6777458430,440,0,-1,0,1,3,0,3,6,1,7,-8,8,0,0,2,2,0,2,2,2,-4,174,-1,-3,4,-1,0,1,-1,-1,1,1,1,-1
KR_6767250852,420,-3,-59,3,-5,0,1,1,-2,3,1,-1,1,0,-1,6,5,-1,2,1,0,-5,-11,-1,-5,6,-2,0,-1,0,-1,-1,-1,0,-1
KR_6775649377,420,-2,-20,-5,-11,2,2,4,-5,6,1,1,2,3,-7,9,2,-2,2,0,1,-20,17,-2,-6,8,-2,0,-2,1,-1,-1,1,4,-1
KR_6732589869,440,-4,-17,-37,-10,0,1,1,-5,5,0,-1,1,0,0,2,2,-4,4,0,0,-14,-28,1,-5,4,-1,0,1,0,1,1,1,0,-1
KR_6776611952,420,1,36,-4,-1,4,1,5,-3,5,2,-1,3,2,-2,2,0,1,2,3,0,-6,2,5,-13,8,0,0,0,-1,1,-1,1,5,-1
KR_6777388470,440,-4,-67,35,-13,-6,6,0,-5,6,1,0,4,4,-3,7,4,1,0,1,0,-8,-5,0,-7,7,2,0,-3,-1,-1,-1,1,6,-1
KR_6744845575,420,-3,-33,-8,-6,4,1,5,-9,10,1,0,3,3,-1,2,1,0,0,0,0,-7,31,-2,-3,5,-17,0,0,-1,-1,-1,1,5,-1
KR_6745092789,420,-3,-38,-12,-5,-4,6,2,-7,7,0,2,0,2,2,1,3,2,0,2,0,-6,-129,0,-5,5,4,0,-1,1,-1,-1,1,6,-1
KR_6766993598,420,-6,-89,-15,-14,-4,4,0,-3,5,2,-1,4,3,-6,9,3,0,0,0,0,-11,4,1,-7,6,1,0,-1,-1,-1,-1,-1,2,-1
KR_6768239688,420,0,17,-7,0,-2,2,0,5,3,8,-2,2,0,-3,7,4,2,1,3,-1,-6,1,-3,-5,8,-3,0,0,1,-1,1,-1,6,-1
KR_6769134571,420,-7,-39,-18,-11,-3,5,2,-2,4,2,-7,7,0,1,1,2,0,0,0,0,-10,0,-2,-5,7,1,0,-3,1,-1,-1,1,4,-1
KR_6738701420,420,-5,-76,-12,-5,-3,4,1,-6,9,3,0,2,2,7,0,7,-3,3,0,1,3,-10,1,-9,8,0,0,-1,1,-1,-1,1,2,-1
KR_6655546075,420,-1,-34,8,-5,-1,2,1,-3,5,2,1,0,1,-2,3,1,0,0,0,0,-5,3,-1,-5,6,-25,0,-1,0,-1,-1,-1,0,-1
KR_6777004560,420,-4,-6,-11,-14,-7,8,1,-1,4,3,1,1,2,-2,4,2,-5,6,1,-1,-11,6,-5,-5,10,3,0,0,1,-1,-1,-1,4,-1
KR_6773936303,420,-2,52,-27,1,-2,4,2,4,2,6,-2,4,2,1,1,2,0,1,1,0,3,-31,-5,-4,9,1,0,-1,-1,-1,-1,1,2,-1
KR_6760565763,420,-8,-17,-6,-16,0,2,2,-11,11,0,-3,3,0,-2,3,1,0,0,0,0,-19,-57,-3,-4,7,-1,0,-2,-1,1,-1,-1,3,-1
KR_6766865752,420,-1,1,-2,-1,2,3,5,-5,5,0,5,0,5,1,1,2,-4,4,0,0,-4,-27,1,-6,5,-1,0,0,-1,1,-1,1,6,-1
KR_6753150281,420,-3,-28,15,-2,0,2,2,-3,5,2,3,1,4,2,3,5,-4,4,0,0,-5,-4,0,-7,7,-1,0,0,-1,-1,-1,-1,1,-1
KR_6772331584,420,-1,9,8,-3,-3,5,2,1,4,5,-1,2,1,1,2,3,-1,1,0,0,-1,-22,-8,-4,12,6,0,-1,1,-1,-1,-1,4,-1
KR_6760609159,420,2,31,-11,7,1,0,1,-2,6,4,7,1,8,0,2,2,1,1,2,0,6,24,3,-7,4,-1,0,0,1,1,1,1,5,-1
KR_6722913886,420,-1,68,-4,-5,3,0,3,-11,14,3,1,1,2,0,4,4,2,2,4,0,-11,35,-7,-5,12,-29,0,2,-1,-1,1,-1,3,-1
KR_6763055632,420,-4,-84,19,-6,-2,3,1,-3,5,2,-3,5,2,0,2,2,2,0,2,0,-14,-201,3,-8,5,-4,0,-1,1,-1,-1,1,3,-1
KR_6765183496,420,-2,-59,28,-13,-2,2,0,-2,3,1,-2,3,1,-4,6,2,-3,3,0,0,-14,-1,-1,-6,7,0,0,-2,-1,1,-1,-1,1,-1
KR_6771825488,420,-1,34,18,-11,-3,3,0,-4,5,1,-1,2,1,-1,2,1,-2,2,0,0,-15,-64,2,-6,4,5,0,1,-1,-1,1,-1,5,-1
KR_6661108113,420,-2,-19,-3,2,0,1,1,1,5,6,1,0,1,2,3,5,-2,3,1,0,4,-16,-3,-4,7,5,0,-1,1,-1,-1,-1,6,-1
KR_6776832055,420,-3,-47,21,-5,-3,4,1,-1,2,1,2,1,3,-2,3,1,-1,1,0,0,-4,138,2,-4,2,0,0,-1,-1,-1,-1,1,6,-1
KR_6775818131,420,1,-35,-12,6,3,2,5,-2,5,3,-1,1,0,2,1,3,4,4,8,0,10,5,1,-4,3,-4,0,0,-1,-1,0,1,1,-1
KR_6777695518,420,-2,-27,-7,-7,-2,2,0,-6,6,0,1,3,4,1,0,1,-1,1,0,0,1,5,2,-4,2,0,0,-2,-1,-1,-1,1,4,-1
KR_6771354227,420,0,65,7,0,2,0,2,3,0,3,-6,6,0,1,2,3,0,0,0,0,0,-28,-2,-6,8,11,0,1,-1,-1,1,-1,1,-1
KR_6776944192,420,-10,-133,-63,-13,-2,3,1,-5,5,0,-2,5,3,-3,6,3,-1,2,1,0,-14,-5,-4,-2,6,-4,0,-4,-1,-1,-1,-1,2,-1
KR_6772205932,420,0,37,-11,4,0,1,1,2,2,4,3,2,5,-2,7,5,1,0,1,0,-1,-156,1,-5,4,-3,0,0,-1,1,-1,-1,3,-1
KR_6717177672,420,-3,-52,-40,-3,0,3,3,2,2,4,0,1,1,-4,6,2,-1,2,1,0,-2,-136,-3,-3,6,4,0,-1,-1,1,-1,-1,1,-1
KR_6772998455,420,-3,67,-7,-9,-2,3,1,-1,3,2,-5,6,1,-1,2,1,0,2,2,0,-16,11,0,-6,6,-7,0,0,-1,1,-1,-1,2,-1
KR_6764738995,440,0,46,20,3,-3,3,0,2,1,3,1,0,1,7,2,9,-4,5,1,0,2,-12,-4,-5,9,5,0,1,1,-1,1,-1,3,-1
KR_6767201625,420,0,26,-21,-1,2,0,2,-3,4,1,0,2,2,-1,2,1,1,1,2,-2,-3,-33,-2,-7,9,-1,0,0,-1,-1,0,-1,4,-1
KR_6770752297,420,-1,14,8,-4,0,2,2,3,4,7,-1,1,0,-4,4,0,-2,3,1,0,-12,-1,-3,-1,4,-1,0,-1,-1,1,-1,-1,4,-1
KR_6769840972,440,1,18,3,5,0,2,2,0,2,2,3,4,7,3,2,5,-1,1,0,2,4,-5,-5,0,5,1,0,0,1,-1,1,1,3,-1
KR_6732480490,420,-5,-45,-8,-11,1,2,3,-4,5,1,-3,3,0,-4,4,0,-1,2,1,0,-13,9,0,-7,7,1,0,0,-1,1,-1,-1,4,-1
KR_6760115338,420,-2,-104,-1,-2,3,0,3,3,2,5,-4,5,1,-4,6,2,0,1,1,0,0,-49,2,-5,3,30,0,-1,-1,1,-1,1,3,-1
KR_6769239591,420,-6,-47,-16,-15,-1,1,0,-2,4,2,-6,6,0,-4,5,1,-2,4,2,0,-11,-26,-5,-5,10,-5,0,-2,-1,1,-1,-1,1,-1
KR_6777709019,420,-1,18,-3,-8,3,1,4,0,2,2,-5,5,0,-3,3,0,-3,3,0,-1,-9,0,2,-7,5,2,0,1,-1,1,1,-1,1,-1
KR_6774570228,420,-1,-41,-15,-4,-2,3,1,-4,6,2,-2,3,1,3,2,5,1,0,1,0,-2,-2,-1,-6,7,3,0,-1,-1,-1,-1,-1,4,-1
KR_6720978716,420,1,60,-11,0,1,3,4,4,1,5,1,0,1,-3,5,2,-3,3,0,0,-7,3,2,-5,3,-3,0,1,-1,1,1,1,3,-1
KR_6762711468,420,0,-54,8,-9,0,3,3,1,1,2,-1,1,0,-11,12,1,2,1,3,-3,-12,7,-1,-3,4,-2,0,-1,-1,0,-1,-1,3,-1
KR_6771291186,420,-2,-39,13,-9,-2,2,0,0,3,3,1,1,2,-6,8,2,-2,3,1,0,-6,-9,-4,-6,10,5,0,-1,-1,1,-1,-1,2,-1
KR_6699490742,420,-4,-85,-11,-6,-1,2,1,0,5,5,-4,4,0,-3,4,1,2,1,3,0,-3,-12,-1,-4,5,2,0,-1,1,-1,-1,-1,6,-1
KR_6765082367,420,-2,-80,-8,-6,-6,7,1,-3,5,2,3,1,4,1,2,3,-1,1,0,0,-6,-20,-3,-2,5,3,0,-2,1,-1,-1,1,5,-1
KR_6744502304,420,-4,-8,-12,-4,0,1,1,-1,2,1,-3,5,2,-1,2,1,1,0,1,0,-13,-4,4,-12,8,-4,0,0,-1,-1,-1,-1,1,-1
KR_6767256013,420,-1,-45,7,0,-1,1,0,-2,4,2,1,1,2,0,1,1,2,0,2,0,3,-14,2,-6,4,4,0,0,-1,-1,0,1,1,-1
KR_6756839399,420,2,3,10,5,-2,3,1,3,2,5,-1,3,2,-1,5,4,6,1,7,1,7,-3,-7,-4,11,4,0,1,1,-1,1,1,2,-1
KR_6677291396,420,-1,27,-7,-7,-3,4,1,-3,6,3,0,1,1,1,1,2,-2,2,0,0,-10,-3,2,-8,6,4,0,0,0,-1,0,-1,0,-1
KR_6777037460,420,-1,13,40,-5,0,1,1,-2,3,1,-3,4,1,1,3,4,-1,2,1,1,-10,12,6,-12,6,-2,0,0,0,-1,0,1,0,-1
KR_6768298336,420,0,-9,0,1,-3,3,0,1,4,5,5,1,6,-2,3,1,0,0,0,0,1,-2,0,-7,7,-5,0,-2,-1,-1,-1,1,2,-1
KR_6751432957,420,-2,0,-5,-6,0,0,0,-2,2,0,-2,4,2,-1,2,1,-1,1,0,0,-11,-190,4,-10,6,-1,0,-1,-1,1,-1,1,6,-1
KR_6771766192,440,-2,0,21,-3,-1,1,0,1,0,1,-2,3,1,-2,2,0,1,0,1,0,-3,5,1,-3,2,-2,0,0,1,1,0,-1,2,-1
KR_6777073303,420,1,13,15,3,-2,4,2,-3,5,2,1,1,2,3,0,3,4,1,5,0,6,-42,-3,-5,8,26,0,-1,1,-1,-1,1,3,-1
KR_6771894930,420,-4,-5,-25,-6,-1,2,1,1,1,2,-3,5,2,0,4,4,-3,4,1,0,2,-10,-4,-4,8,2,0,-1,-1,-1,-1,1,3,-1
KR_6751682596,420,-3,-59,-9,-12,-1,1,0,-5,7,2,-3,8,5,1,3,4,-4,5,1,0,-11,-29,1,-7,6,-1,0,-1,-1,-1,-1,1,1,-1
KR_6739652351,420,-4,-51,-15,-4,1,3,4,-8,9,1,-5,8,3,6,0,6,2,1,3,1,-2,-3,7,-11,4,-1,0,-1,-1,-1,-1,1,3,-1
KR_6719345883,420,-1,-13,-4,6,2,0,2,1,3,4,2,1,3,0,1,1,1,0,1,0,10,4,1,-6,5,-1,0,0,-1,-1,0,1,4,-1
KR_6772669521,420,0,4,-12,-1,-2,4,2,0,2,2,-1,2,1,1,0,1,1,0,1,0,5,39,5,-11,6,-2,0,-1,1,-1,1,-1,6,-1
KR_6741440781,420,0,-19,-37,5,-3,3,0,0,7,7,4,2,6,4,4,8,0,0,0,0,9,1,0,-4,4,1,0,0,1,-1,0,-1,1,-1
KR_6772637343,420,1,3,7,-1,1,1,2,3,0,3,-3,4,1,0,2,2,-2,2,0,0,0,-18,-4,-3,7,-1,0,0,-1,1,1,-1,3,-1
KR_6731493554,420,-1,-22,-11,-3,0,3,3,0,3,3,-4,6,2,3,1,4,-2,2,0,0,-2,2,0,-8,8,-2,0,-2,-1,-1,-1,1,6,-1
KR_6742287594,420,1,27,-31,-3,-2,4,2,-3,6,3,-1,3,2,2,2,4,1,0,1,0,-5,-11,-4,-8,12,10,0,0,1,0,0,1,2,-1
KR_6765967951,420,-1,10,-20,0,1,0,1,-1,3,2,-1,2,1,1,1,2,0,0,0,0,2,-4,-3,-6,9,-4,0,0,1,-1,0,-1,1,-1
KR_6773846620,420,0,15,18,3,-2,3,1,-1,2,1,0,1,1,2,5,7,4,1,5,0,11,-13,-4,-6,10,6,0,0,-1,1,-1,-1,1,-1
KR_6777181720,420,-3,-67,-16,-1,0,1,1,-1,4,3,-1,2,1,0,5,5,1,0,1,-2,0,-1,4,-7,3,-3,0,0,-1,0,1,-1,5,-1
KR_6765441327,440,-2,-18,20,-3,-2,3,1,-1,2,1,-1,3,2,0,0,0,1,1,2,0,-8,-43,2,-5,3,-3,0,-1,0,0,-1,1,0,-1
KR_6772891148,420,-4,-31,18,-12,-1,4,3,-1,2,1,-2,2,0,-5,6,1,-3,4,1,0,-14,-13,-2,-5,7,-5,0,-1,-1,1,-1,1,4,-1
KR_6749464198,420,-2,-113,17,-5,-1,2,1,1,1,2,1,0,1,-3,4,1,-3,3,0,0,-2,-3,-4,-2,6,-1,0,-1,1,-1,-1,1,4,-1
KR_6759723027,420,-1,40,-13,6,1,1,2,6,0,6,1,0,1,0,3,3,-2,3,1,0,12,-158,5,-7,2,-2,0,0,-1,-1,-1,1,5,-1
KR_6728249844,420,-7,-102,-4,-13,-4,5,1,-4,6,2,-1,2,1,0,1,1,-4,4,0,0,-13,2,4,-10,6,0,0,-3,-1,1,-1,-1,4,-1
KR_6759594894,440,-1,-5,32,-3,1,3,4,1,1,2,0,3,3,-5,8,3,0,2,2,0,1,-3,2,-8,6,5,0,0,-1,-1,0,1,4,-1
KR_6771161426,420,1,-11,-11,2,1,1,2,0,2,2,-1,4,3,4,1,5,-2,3,1,0,4,9,0,-4,4,-1,0,0,-1,1,0,1,2,-1
KR_6777582254,420,2,10,23,0,-2,4,2,-1,4,3,4,0,4,-2,2,0,1,0,1,0,2,123,5,-10,5,5,0,2,1,1,1,-1,4,-1
KR_6638029981,420,-1,-34,-17,-2,-1,4,3,2,0,2,-3,3,0,0,3,3,0,0,0,0,5,-215,2,-4,2,5,0,0,-1,1,1,1,6,-1
KR_6766560470,420,-3,-18,-24,-16,3,1,4,-7,10,3,-5,8,3,-8,10,2,1,0,1,0,-15,15,-3,-4,7,-2,0,-2,-1,-1,-1,-1,1,-1
KR_6730146343,420,-2,11,-16,1,-2,2,0,-1,3,2,1,0,1,3,1,4,0,0,0,0,1,137,2,-8,6,4,0,1,1,-1,1,-1,1,-1
KR_6759785824,420,-1,-9,-4,-8,-2,2,0,-4,5,1,-2,5,3,2,0,2,-2,2,0,0,-11,15,1,-6,5,0,0,0,-1,-1,0,-1,3,-1
KR_6756699911,420,0,-57,-12,-1,1,3,4,1,0,1,1,3,4,-4,6,2,0,1,1,0,-4,-5,-1,-6,7,-3,0,0,-1,1,1,-1,3,-1
KR_6775996690,420,-5,-40,-15,-12,0,1,1,-3,4,1,-2,3,1,-2,3,1,-5,5,0,0,-7,-7,0,-6,6,-3,0,-3,-1,-1,-1,1,6,-1
KR_6775261234,420,-2,0,-36,-7,1,1,2,-5,5,0,0,2,2,-3,5,2,0,0,0,-1,-9,-49,-3,-3,6,-1,0,-1,-1,-1,-1,-1,1,-1
KR_6747034429,420,-2,-22,-4,0,2,0,2,-1,2,1,-3,3,0,0,2,2,2,0,2,1,2,-4,-2,-4,6,0,0,0,-1,1,0,1,6,-1
KR_6739836523,420,-5,-49,-9,-21,-1,1,0,-7,8,1,-2,2,0,-6,6,0,-5,6,1,-2,-21,19,-3,-4,7,-3,0,-2,-1,-1,-1,-1,2,-1
KR_6755158007,420,1,-7,-4,6,3,0,3,3,0,3,1,4,5,-1,1,0,0,0,0,0,9,17,-2,-6,8,-3,0,0,-1,1,-1,1,3,-1
KR_6765332542,420,0,24,-4,1,4,0,4,-1,4,3,-2,2,0,0,3,3,0,1,1,0,0,-1,3,-7,4,1,0,0,-1,0,0,1,2,-1
KR_6763660796,420,-5,-47,-56,-9,-4,5,1,0,1,1,-2,3,1,-2,5,3,-1,1,0,0,-5,4,1,-8,7,-3,0,0,-1,1,0,-1,2,-1
KR_6749532295,420,-4,-34,-12,-13,0,3,3,-3,5,2,-7,7,0,0,2,2,-3,5,2,0,-10,-3,1,-9,8,7,0,-1,-1,-1,-1,-1,3,-1
KR_6766583142,420,-3,-104,13,-12,-3,3,0,-1,1,0,-6,6,0,-2,5,3,0,0,0,0,-2,-1,-7,-4,11,1,0,0,1,-1,-1,-1,6,-1
KR_6741768333,420,-5,-35,-7,-10,-5,6,1,-7,8,1,-2,5,3,3,2,5,1,0,1,1,-6,-2,-4,-6,10,-4,0,-1,-1,1,-1,1,4,-1
KR_6743661633,420,-1,-82,1,-5,1,3,4,1,2,3,-7,8,1,-2,3,1,2,0,2,0,-3,15,3,-6,3,-5,0,-2,-1,1,-1,-1,4,-1
KR_6774145385,420,2,21,-7,2,3,2,5,1,1,2,4,1,5,-5,6,1,-1,2,1,1,-16,28,6,-9,3,2,0,1,-1,-1,1,1,5,-1
KR_6768125876,420,-2,-23,-9,-4,0,3,3,2,2,4,-2,3,1,-4,5,1,0,1,1,-2,-10,-14,-3,-6,9,1,0,0,-1,1,0,-1,6,-1
KR_6770663438,440,2,-9,26,2,-5,6,1,2,2,4,-1,4,3,4,4,8,2,2,4,0,-2,2,-1,-1,2,-1,0,-1,1,-1,-1,1,1,-1
KR_6772374720,420,-2,-41,-2,-3,3,0,3,-1,6,5,-2,4,2,-2,4,2,-1,1,0,-1,-10,-5,5,-9,4,2,0,-2,-1,1,-1,-1,6,-1
KR_6761903763,420,0,-115,-19,3,-1,3,2,1,6,7,3,1,4,2,2,4,-2,3,1,-1,8,19,1,-5,4,-8,0,-1,1,-1,-1,-1,5,-1
KR_6774199544,420,1,-49,46,-2,4,0,4,6,2,8,-3,6,3,-5,5,0,-4,4,0,0,-7,-1,-2,-3,5,2,0,0,-1,-1,0,1,2,-1
KR_6777242352,420,-1,21,15,-2,-8,8,0,6,2,8,-4,5,1,5,1,6,-1,3,2,1,3,5,4,-9,5,4,0,1,1,1,-1,1,2,-1
KR_6749804219,420,-3,-44,-14,-8,0,3,3,-1,6,5,-7,7,0,-2,4,2,2,0,2,0,-7,-17,6,-8,2,-2,0,-1,-1,1,-1,1,5,-1
KR_6723366873,420,2,0,-8,1,3,0,3,3,2,5,1,0,1,-5,6,1,-1,1,0,0,-2,-31,6,-14,8,27,0,-1,1,-1,-1,1,1,-1
KR_6767988844,420,1,21,0,4,-1,1,0,0,3,3,4,1,5,2,5,7,-1,2,1,-1,-2,9,-1,-7,8,-7,0,2,1,1,1,-1,4,-1
KR_6742766800,420,-2,-69,19,-11,-2,3,1,-1,3,2,-2,3,1,-4,5,1,-2,2,0,0,-24,0,-1,-4,5,1,0,0,1,1,-1,-1,5,-1
KR_6774119700,420,-5,-35,-38,-9,-2,2,0,-5,5,0,-1,4,3,-1,2,1,0,0,0,0,-4,-317,-4,-3,7,-2,0,0,-1,1,-1,-1,2,-1
KR_6766403719,420,-3,-47,-11,-4,0,2,2,-1,2,1,1,1,2,-3,5,2,-1,1,0,0,-8,-21,3,-8,5,-3,0,-1,1,-1,-1,1,6,-1
KR_6776064086,420,-2,2,-4,-5,0,1,1,3,2,5,-4,4,0,-4,5,1,0,0,0,0,-3,0,-2,-6,8,-3,0,1,-1,1,1,-1,1,-1
KR_6771858264,420,0,13,16,-1,2,2,4,1,0,1,0,1,1,-1,1,0,-3,4,1,0,-7,5,1,-7,6,-5,0,0,-1,-1,0,1,2,-1
KR_6767107719,420,1,-3,9,-1,2,0,2,1,2,3,3,1,4,-5,5,0,-2,2,0,1,0,-10,0,-5,5,9,0,0,1,1,0,1,4,-1
KR_6639528913,420,2,36,-6,-1,-2,2,0,5,3,8,-2,2,0,-3,3,0,1,0,1,0,-7,-9,-13,-2,15,5,0,1,1,1,1,1,6,-1
KR_6773345421,420,-2,-40,-3,-11,-3,3,0,-6,6,0,-3,3,0,0,4,4,1,1,2,-1,-21,95,-12,-2,14,1,0,-1,-1,-1,-1,-1,6,-1
KR_6775515176,420,-2,38,-40,-6,1,1,2,-6,8,2,-1,2,1,2,3,5,-2,4,2,0,4,3,0,-5,5,-5,0,0,-1,-1,0,1,1,-1
KR_6769641417,420,-3,1,-31,-6,1,0,1,-3,3,0,-4,5,1,0,0,0,0,0,0,0,-5,0,-1,-3,4,-2,0,-1,1,-1,-1,1,6,-1
KR_6773589129,440,3,-66,-12,6,-1,4,3,5,0,5,2,0,2,-1,2,1,1,3,4,0,9,2,2,-3,1,4,0,-1,1,1,-1,-1,5,-1
KR_6651051937,420,-1,-48,5,-5,-2,3,1,-2,5,3,2,1,3,-4,6,2,1,2,3,0,4,26,-3,-2,5,4,0,0,-1,-1,0,1,5,-1
KR_6772568823,420,1,18,-4,-3,2,1,3,-2,5,3,-2,3,1,-1,4,3,0,0,0,0,-5,8,7,-10,3,1,0,0,-1,-1,0,-1,5,-1
KR_6766107497,420,-3,-32,0,-4,-1,4,3,-1,4,3,2,2,4,-3,3,0,-1,1,0,0,-6,4,-1,-6,7,-5,0,0,1,1,-1,-1,2,-1
KR_6753307035,420,0,7,24,3,2,1,3,2,2,4,-2,4,2,-1,3,2,2,0,2,1,6,145,-2,-6,8,-1,0,2,-1,1,1,1,4,-1
KR_6777791680,420,-1,-18,-20,-3,6,0,6,-1,2,1,-2,3,1,-5,6,1,-1,1,0,1,-10,10,-2,-6,8,-2,0,0,-1,-1,-1,1,1,-1
KR_6776029007,420,-1,-61,4,0,-1,2,1,5,1,6,-4,5,1,-2,2,0,2,1,3,0,-8,10,3,-6,3,0,0,0,-1,1,0,-1,3,-1
KR_6767870974,420,-2,-45,-32,-4,3,0,3,-4,6,2,0,3,3,2,0,2,-5,6,1,0,-10,-4,-2,-5,7,-3,0,0,0,1,0,-1,0,-1
KR_6767823401,420,-1,51,-11,1,1,1,2,1,1,2,-1,2,1,0,1,1,0,0,0,0,0,-32,3,-6,3,1,0,0,1,1,0,1,2,-1
KR_6770328909,420,-2,-48,-3,2,0,2,2,1,2,3,-1,2,1,-2,2,0,4,1,5,0,5,-2,2,-5,3,-2,0,0,1,-1,0,1,5,-1
KR_6685520578,420,-1,-81,4,1,3,0,3,2,0,2,0,1,1,-4,5,1,0,0,0,0,-2,10,3,-8,5,-7,0,-1,1,1,1,1,1,-1
KR_6774947987,420,0,10,-1,-8,1,1,2,3,0,3,-5,5,0,-6,10,4,-1,2,1,-2,-13,-6,-3,-5,8,5,0,-1,-1,1,-1,-1,3,-1
KR_6716777841,420,-5,8,-31,-12,-5,5,0,0,0,0,-5,7,2,-2,4,2,0,2,2,0,-13,-5,1,-6,5,-3,0,-1,-1,1,-1,1,2,-1
KR_6752620540,420,0,-32,-20,0,-3,5,2,1,2,3,2,4,6,3,0,3,-3,3,0,0,13,12,-6,-3,9,-1,0,0,-1,-1,0,1,5,-1
KR_6776295157,420,-5,-60,-14,-11,-2,2,0,1,4,5,-5,5,0,-7,7,0,2,0,2,-1,-12,-76,-4,-3,7,-1,0,0,-1,-1,-1,-1,4,-1
KR_6744451927,420,-3,-18,0,0,1,2,3,-2,3,1,-1,3,2,-1,2,1,3,0,3,0,-8,-6,-1,-8,9,1,0,0,-1,-1,-1,1,3,-1
KR_6610160550,420,-1,-39,-13,0,1,1,2,-1,3,2,-1,3,2,0,3,3,1,0,1,0,8,-150,-1,-7,8,2,0,0,1,-1,-1,-1,4,-1
KR_6775266478,420,-1,-15,-16,1,-4,6,2,1,1,2,2,2,4,3,0,3,-1,1,0,0,17,22,-2,-6,8,3,0,-1,1,-1,-1,-1,5,-1
KR_6770381923,420,-3,-44,-20,-3,-1,3,2,1,3,4,0,4,4,1,1,2,-4,4,0,0,2,-16,-1,-6,7,1,0,-1,-1,-1,-1,-1,4,-1
KR_6772656597,420,-2,-58,-21,-2,0,1,1,-3,7,4,2,2,4,-1,8,7,0,0,0,0,5,-5,-2,-7,9,-1,0,0,1,-1,-1,-1,2,-1
KR_6736138473,420,-1,-60,-32,-5,3,1,4,-1,4,3,-3,7,4,-3,5,2,-1,2,1,0,-3,-2,-6,-5,11,1,0,-2,-1,-1,-1,1,4,-1
KR_6734168348,420,-2,-21,4,0,1,1,2,0,1,1,3,0,3,0,3,3,-4,4,0,0,3,-24,-2,-8,10,6,0,0,-1,1,1,-1,4,-1
KR_6745438556,420,-2,10,-3,-7,0,0,0,0,1,1,-5,5,0,-2,2,0,0,0,0,0,-5,-36,-1,-10,11,0,0,1,1,-1,1,-1,4,-1
KR_6773153915,420,-5,-59,-15,-11,-3,3,0,-3,3,0,0,2,2,-3,5,2,-2,2,0,0,-13,-2,1,-5,4,-7,0,-1,-1,-1,-1,-1,3,-1
KR_6776859549,420,-4,-74,-6,-4,-4,6,2,1,2,3,0,2,2,0,2,2,-1,1,0,-1,-1,-34,-2,-9,11,20,0,-1,-1,1,1,-1,6,-1
KR_6767978526,420,1,93,4,-2,-3,4,1,-1,5,4,0,3,3,1,3,4,1,1,2,0,-2,-32,-1,-6,7,2,0,1,-1,0,1,1,5,-1
KR_6764161619,420,1,35,-1,-7,2,0,2,-9,10,1,0,4,4,0,4,4,0,2,2,-2,-13,-4,-8,-4,12,-1,0,0,-1,-1,0,-1,1,-1
KR_6777737912,420,-3,-3,21,-13,-2,2,0,-3,6,3,-4,4,0,-3,6,3,-1,2,1,-1,-18,-4,4,-8,4,-3,0,-1,-1,1,-1,-1,3,-1
KR_6719917686,420,-1,-74,-12,4,2,2,4,3,2,5,-2,4,2,-1,6,5,2,2,4,0,14,67,3,-6,3,0,0,-3,1,1,-1,1,6,-1
KR_6772540541,420,-1,-32,-21,-10,2,2,4,2,3,5,-6,8,2,-5,6,1,-3,3,0,-1,-10,-4,-4,-5,9,-1,0,0,-1,-1,0,-1,5,-1
KR_6771734756,440,2,-43,35,-3,-2,4,2,-2,7,5,3,2,5,-4,6,2,2,0,2,-1,-6,2,-3,-3,6,0,0,-1,-1,-1,-1,-1,5,-1
KR_6775217687,420,-3,33,-24,-7,-1,2,1,-2,6,4,-4,5,1,1,0,1,-1,1,0,0,-9,-11,-9,-1,10,6,0,1,-1,1,1,-1,1,-1
KR_6772317038,420,-1,-32,-16,2,1,1,2,5,0,5,-3,4,1,-2,3,1,1,0,1,0,11,0,3,-6,3,3,0,-1,-1,1,-1,-1,3,-1
KR_6776540819,420,-5,-25,6,-9,-5,5,0,-3,4,1,-1,1,0,-1,4,3,1,1,2,0,-10,-6,1,-8,7,4,0,-1,1,1,-1,1,2,-1
KR_6724775178,420,-2,-3,-35,-5,7,0,7,-7,7,0,-5,5,0,1,1,2,-1,3,2,0,-1,5,2,-6,4,-6,0,-1,0,-1,-1,1,0,-1
KR_6744832838,420,-1,-12,-33,4,-1,2,1,1,1,2,1,1,2,0,0,0,3,0,3,0,4,-33,8,-11,3,2,0,0,1,1,0,1,4,-1
KR_6712788200,420,-8,-89,-24,-18,-4,6,2,-5,7,2,-2,3,1,-3,5,2,-4,4,0,-2,-20,1,-6,-1,7,-4,0,-3,-1,-1,-1,-1,4,-1
KR_6763965606,420,0,-44,28,-5,3,1,4,-3,4,1,-2,5,3,-2,4,2,-1,2,1,1,-2,-17,-5,-2,7,2,0,1,-1,1,-1,1,4,-1
KR_6763016298,440,1,-81,24,-3,1,1,2,1,0,1,4,1,5,-9,10,1,0,1,1,0,-8,2,3,-4,1,-3,0,-1,-1,-1,-1,-1,2,-1
KR_6763063242,420,0,56,-19,-5,-1,1,0,0,1,1,1,0,1,-3,3,0,-2,3,1,0,-8,-10,1,-7,6,-1,0,0,-1,-1,-1,1,4,-1
KR_6775879053,420,1,11,-5,3,-1,1,0,-1,2,1,1,0,1,4,0,4,0,1,1,0,8,24,5,-7,2,-1,0,0,-1,1,0,1,2,-1
KR_6773111402,420,-2,-17,-8,-7,-10,10,0,-2,8,6,-3,6,3,4,2,6,4,1,5,0,3,376,-8,-2,10,2,0,-1,1,1,-1,1,6,-1
KR_6744176350,420,0,-41,11,-1,-3,3,0,0,2,2,2,1,3,0,0,0,0,0,0,0,-1,105,1,-8,7,8,0,1,1,1,1,1,1,-1
KR_6770400044,420,-4,-92,2,-3,-1,4,3,4,0,4,-5,7,2,-5,7,2,4,0,4,0,-5,-22,-1,-8,9,2,0,-2,-1,-1,-1,-1,2,-1
KR_6772431378,420,-2,-76,12,1,-2,5,3,-1,3,2,2,2,4,2,1,3,0,0,0,0,3,-14,5,-10,5,-4,0,0,1,1,0,1,1,-1
KR_6758520405,420,-1,-26,-15,1,-3,3,0,2,0,2,1,3,4,2,0,2,-1,2,1,0,9,67,5,-9,4,-6,0,0,1,1,0,1,3,-1
KR_6742613183,420,-7,-74,-25,-17,-2,2,0,-11,13,2,-3,4,1,-4,4,0,3,1,4,0,-18,-8,-5,-5,10,2,0,-1,-1,-1,-1,-1,2,-1
KR_6734939728,420,-2,-15,-25,-1,0,2,2,-1,3,2,-1,1,0,3,1,4,-2,4,2,0,2,-12,3,-9,6,0,0,0,-1,1,0,-1,5,-1
KR_6768439897,440,-2,-77,21,-7,0,3,3,-1,4,3,2,1,3,-7,7,0,-1,3,2,0,-11,50,-2,-4,6,-2,0,-2,0,1,-1,-1,0,-1
KR_6759027852,420,-1,52,-4,-3,-6,9,3,-2,3,1,0,4,4,4,0,4,1,2,3,-1,-3,-17,-3,-5,8,1,0,-2,-1,-1,-1,-1,3,-1
KR_6724224125,420,-2,-28,-2,-7,3,0,3,0,0,0,-3,3,0,-5,5,0,-2,2,0,0,-15,-3,-7,-3,10,3,0,0,-1,1,1,-1,6,-1
KR_6773073675,420,-3,-34,-36,-12,-2,5,3,-5,5,0,-5,5,0,0,1,1,0,1,1,0,-3,9,-4,-2,6,1,0,-1,-1,-1,-1,-1,5,-1
KR_6777709299,420,0,9,-20,-1,-1,2,1,-1,6,5,-5,6,1,3,2,5,3,0,3,0,3,-9,-3,-4,7,9,0,-1,-1,-1,-1,1,3,-1
KR_6754572456,420,1,-5,-12,-3,1,2,3,-2,5,3,-2,3,1,0,3,3,0,2,2,0,-6,-5,-6,-5,11,4,0,0,1,0,1,-1,6,-1
KR_6773927606,420,-1,27,22,-4,-2,2,0,-4,5,1,3,0,3,-1,4,3,0,1,1,-1,-9,8,-6,-4,10,-3,0,0,-1,1,0,-1,6,-1
KR_6775914219,420,2,-48,11,3,2,1,3,-1,3,2,-3,3,0,2,2,4,3,0,3,0,5,21,5,-11,6,-3,0,1,1,-1,1,-1,6,-1
KR_6776913524,440,-4,-70,0,-20,-2,3,1,1,0,1,-7,7,0,-12,13,1,0,2,2,0,-15,3,-8,-2,10,0,0,-1,-1,-1,-1,1,4,-1
KR_6748065563,420,-4,-2,-49,-14,-5,5,0,-3,6,3,0,2,2,-4,4,0,-2,3,1,0,-15,-37,4,-8,4,1,0,-2,-1,1,-1,-1,1,-1
KR_6750279671,420,-5,-15,-21,-8,-3,3,0,0,4,4,-4,7,3,0,6,6,-1,2,1,1,-19,-38,-3,-6,9,-5,0,0,1,-1,0,1,1,-1
KR_6774554835,420,-6,-76,-12,-11,-4,4,0,-3,5,2,0,0,0,-5,9,4,1,1,2,0,-4,4,-3,-5,8,-9,0,-3,1,-1,-1,-1,6,-1
KR_6776484180,420,0,16,-15,0,-3,6,3,1,3,4,4,1,5,-3,5,2,1,1,2,0,-6,0,0,-6,6,1,0,2,-1,1,1,1,1,-1
KR_6731884071,440,-5,-82,-27,-11,0,1,1,1,2,3,-7,7,0,-2,2,0,-3,4,1,0,-20,0,1,-8,7,-4,0,-2,-1,1,-1,1,3,-1
KR_6774100317,420,1,21,1,-4,4,2,6,-6,8,2,-1,4,3,-2,3,1,1,0,1,0,-22,-40,2,-5,3,2,0,2,-1,1,1,1,5,-1
KR_6768916623,420,-2,-25,28,-13,-1,2,1,-7,10,3,-2,5,3,-2,2,0,-1,2,1,0,-22,-4,0,-7,7,-1,0,-1,-1,-1,-1,-1,3,-1
KR_6771662244,420,-2,-68,16,-3,0,1,1,1,2,3,0,1,1,-3,3,0,-1,1,0,0,-6,12,0,-6,6,-2,0,0,-1,1,0,1,5,-1
KR_6774618667,420,-1,69,-9,-5,4,0,4,-9,9,0,-1,2,1,0,3,3,1,0,1,0,-15,2,0,-6,6,3,0,0,1,1,0,-1,4,-1
KR_6752108958,420,0,-41,32,-1,2,0,2,-1,1,0,-2,2,0,0,1,1,0,0,0,0,-8,-1,2,-6,4,-3,0,0,1,1,0,1,5,-1
KR_6739782192,420,-2,-21,-31,-6,1,0,1,-3,5,2,-2,3,1,-1,1,0,-1,1,0,0,-6,-4,-2,-2,4,0,0,0,-1,-1,-1,1,5,-1
KR_6762627967,440,-1,-7,-20,-2,-4,4,0,4,0,4,0,1,1,-2,4,2,0,0,0,0,0,4,-2,-3,5,3,0,1,-1,-1,-1,-1,4,-1
KR_6765302119,420,0,56,-28,-3,0,1,1,-2,5,3,1,1,2,-3,4,1,1,2,3,0,0,-46,3,-8,5,-5,0,0,1,-1,0,1,6,-1
KR_6760098758,420,-1,47,-17,-9,0,1,1,-1,2,1,-6,6,0,-3,3,0,1,0,1,0,-22,-101,-5,-5,10,5,0,1,-1,1,1,-1,1,-1
KR_6767381278,420,0,-98,5,-1,2,2,4,0,4,4,-1,1,0,0,4,4,-2,3,1,0,6,0,3,-7,4,-2,0,-1,1,1,-1,-1,5,-1
KR_6767651300,420,0,12,19,-8,-3,3,0,-2,3,1,0,1,1,-4,9,5,1,2,3,-1,-8,2,-3,-3,6,3,0,1,-1,1,-1,-1,1,-1
KR_6754380286,420,-4,-7,-3,-10,-2,2,0,-6,8,2,2,2,4,-4,5,1,0,1,1,0,-16,-41,-3,-5,8,3,0,0,-1,1,-1,1,4,-1
KR_6772145244,420,1,36,14,-4,0,0,0,-3,3,0,-1,2,1,-1,2,1,1,0,1,0,-6,-7,-2,-4,6,-5,0,1,0,-1,1,-1,0,-1
KR_6774936197,420,0,48,8,0,-1,2,1,3,1,4,1,2,3,-3,3,0,0,0,0,0,6,42,0,-4,4,1,0,-1,-1,-1,-1,1,1,-1
KR_6774050678,420,-3,-42,0,-5,-3,4,1,-1,3,2,-3,5,2,0,2,2,2,2,4,0,-3,1,0,-4,4,2,0,-2,-1,-1,-1,-1,4,-1
KR_6740299073,420,-2,0,0,-12,0,1,1,1,2,3,-6,6,0,-5,5,0,-2,3,1,0,-19,0,-1,-5,6,-2,0,-1,-1,1,-1,1,3,-1
KR_6730944026,420,1,8,4,5,3,3,6,5,3,8,1,0,1,4,1,5,-8,8,0,2,10,9,-2,-10,12,-3,0,0,1,-1,-1,1,3,-1
KR_6759482535,440,0,11,8,-1,3,1,4,-1,4,3,3,0,3,-7,8,1,1,1,2,0,-3,-4,-2,-6,8,-3,0,-1,1,1,-1,1,2,-1
KR_6714149046,420,-2,-14,-9,-1,-2,2,0,1,2,3,-2,4,2,3,4,7,-1,4,3,0,-5,8,1,-9,8,1,0,-1,1,-1,-1,1,4,-1
KR_6775532227,420,-2,-11,-9,-1,1,2,3,-3,3,0,0,3,3,0,2,2,1,2,3,0,-1,32,-6,-3,9,8,0,-1,-1,-1,-1,1,6,-1
KR_6771187859,420,-3,-114,-22,-3,-1,2,1,1,4,5,-3,6,3,0,2,2,0,0,0,-1,6,-5,-1,-5,6,7,0,-1,-1,-1,-1,-1,4,-1
KR_6777027950,420,3,9,30,4,3,1,4,0,1,1,-2,2,0,2,1,3,1,0,1,0,3,0,-2,-2,4,-2,0,1,1,1,1,1,2,-1
KR_6775776039,420,0,-67,-4,-5,0,1,1,-3,4,1,1,1,2,-4,4,0,1,0,1,0,-5,-37,-2,-4,6,-1,0,-2,-1,1,-1,1,5,-1
KR_6771004834,420,-5,5,-33,-13,-3,3,0,-5,5,0,0,3,3,-3,4,1,-2,3,1,0,-13,-13,0,-3,3,-2,0,0,-1,-1,-1,-1,6,-1
KR_6749883454,420,-2,-15,1,-1,-5,6,1,4,1,5,1,2,3,-1,2,1,0,0,0,0,4,-10,0,-5,5,0,0,-1,-1,1,-1,1,4,-1
KR_6762587660,420,-3,36,-8,-12,1,0,1,-5,6,1,-4,5,1,-1,2,1,-3,3,0,0,-21,-59,-6,-4,10,-2,0,0,-1,-1,0,-1,5,-1
KR_6717502086,420,-3,38,-9,-10,-3,3,0,-2,6,4,0,1,1,-5,6,1,0,1,1,0,-12,-14,-8,-6,14,-1,0,0,1,-1,-1,-1,6,-1
KR_6737863213,420,-5,-66,-21,-6,-1,2,1,-2,5,3,-5,5,0,2,1,3,0,0,0,0,-1,32,-2,-8,10,1,0,-3,1,-1,-1,1,6,-1
KR_6775140419,420,-4,4,16,-9,-1,1,0,-2,4,2,1,3,4,-3,7,4,-4,4,0,0,-14,-5,-3,-6,9,-2,0,1,0,1,1,-1,0,-1
KR_6670809238,420,-3,-37,-3,-6,0,2,2,-3,6,3,-3,4,1,-1,6,5,1,0,1,0,-13,-83,0,-8,8,-3,0,-1,-1,-1,-1,1,3,-1
KR_6773059391,420,-4,-43,12,-6,-1,1,0,0,4,4,-1,2,1,-6,7,1,2,1,3,0,-10,-5,-1,-6,7,4,0,0,1,1,1,-1,5,-1
KR_6731786783,420,1,12,35,0,-3,5,2,2,2,4,-5,5,0,6,1,7,0,1,1,1,5,3,-2,-5,7,-5,0,-1,1,-1,-1,1,2,-1
KR_6765194861,420,0,-30,-3,3,-2,4,2,3,5,8,-1,3,2,1,2,3,2,1,3,1,3,-124,0,-4,4,0,0,-1,-1,1,-1,1,1,-1
KR_6681700667,420,-5,-70,-9,-10,-4,4,0,-6,6,0,0,1,1,2,0,2,-2,2,0,0,-9,-2,0,-6,6,-1,0,-1,1,-1,-1,-1,6,-1
KR_6729437021,420,0,-8,4,-3,0,3,3,-2,4,2,-2,3,1,0,0,0,1,0,1,0,-5,2,-5,-6,11,2,0,0,-1,-1,0,1,3,-1
KR_6677020013,420,0,-2,-29,-6,2,0,2,-3,3,0,-3,4,1,-1,4,3,-1,3,2,0,-5,-6,-2,-4,6,-8,0,-1,-1,1,-1,-1,5,-1
KR_6763304187,440,-4,-90,-2,-14,-1,5,4,-1,4,3,-3,5,2,-7,8,1,-2,2,0,0,-11,2,0,-3,3,0,0,-1,-1,-1,-1,-1,6,-1
KR_6772309103,420,3,-20,6,4,0,2,2,1,3,4,4,1,5,-2,4,2,1,0,1,0,-2,36,-4,-5,9,-2,0,0,-1,-1,0,-1,1,-1
KR_6768372213,440,-3,-46,28,-4,4,3,7,-5,7,2,-3,4,1,-1,4,3,1,3,4,1,-4,9,1,-7,6,-5,0,-1,-1,1,-1,1,1,-1
KR_6712849021,420,-2,-18,-22,1,0,3,3,-1,1,0,-4,4,0,4,1,5,2,0,2,0,-5,11,2,-6,4,-6,0,-1,-1,1,-1,1,2,-1
KR_6773866964,420,2,-54,3,0,-1,1,0,4,0,4,-2,5,3,-1,3,2,0,0,0,0,-5,1,0,-7,7,-5,0,-1,1,-1,-1,-1,6,-1
KR_6704654755,440,-1,6,-1,-3,3,3,6,-3,3,0,-5,7,2,0,5,5,2,0,2,1,-6,7,0,-3,3,-2,0,0,-1,1,-1,1,5,-1
KR_6723717604,420,1,42,-46,-1,0,3,3,4,0,4,-6,7,1,2,0,2,-1,1,0,0,1,112,4,-7,3,0,0,1,-1,-1,1,-1,5,-1
KR_6761335725,440,2,17,-24,2,4,1,5,-2,2,0,2,1,3,0,3,3,-2,5,3,0,-5,24,1,-5,4,-11,0,1,0,-1,-1,1,0,-1
KR_6768643106,420,0,5,-4,0,3,0,3,-2,5,3,-1,1,0,2,0,2,-2,2,0,0,-10,3,-3,-7,10,-2,0,0,1,-1,0,-1,6,-1
KR_6758544929,420,-1,23,33,-6,2,1,3,-4,5,1,0,2,2,-1,2,1,-3,4,1,0,-11,-24,2,-7,5,-2,0,-1,0,0,-1,1,0,-1
KR_6759935666,420,0,-22,17,3,5,1,6,0,5,5,-1,2,1,0,2,2,-1,1,0,0,7,7,-2,-3,5,-4,0,1,-1,-1,1,1,3,-1
KR_6776622842,420,-2,-28,-30,-8,-4,5,1,-8,8,0,2,1,3,3,1,4,-1,3,2,0,3,-1,-4,-3,7,3,0,1,-1,1,1,-1,3,-1
KR_6768455183,420,-3,-27,9,-7,0,1,1,-2,5,3,-1,7,6,-4,4,0,0,1,1,0,-5,-38,-3,-5,8,5,0,-2,1,-1,-1,1,1,-1
KR_6748513746,420,-2,1,7,-8,2,1,3,0,4,4,-10,10,0,-1,4,3,1,0,1,0,-3,1,1,-4,3,-3,0,-1,-1,-1,-1,1,5,-1
KR_6776331613,420,0,-32,37,-7,-1,3,2,-2,2,0,-1,1,0,1,4,5,-4,4,0,0,-17,19,3,-6,3,-8,0,0,1,1,0,-1,5,-1
KR_6770812660,420,-4,-71,23,-13,-3,3,0,-5,5,0,-1,3,2,-4,6,2,0,0,0,-1,-16,-10,-3,-5,8,-3,0,-2,-1,1,-1,-1,2,-1
KR_6776449781,420,-1,-40,13,-9,-2,2,0,-3,5,2,0,6,6,-5,5,0,1,0,1,-1,-6,11,-8,-3,11,5,0,-1,-1,-1,-1,-1,5,-1
KR_6773006870,420,1,28,23,4,1,0,1,4,1,5,-2,2,0,0,1,1,1,0,1,0,3,8,1,-4,3,-4,0,2,1,1,1,1,2,-1
KR_6764991762,420,0,41,-1,2,-1,2,1,2,2,4,0,2,2,1,3,4,0,1,1,0,1,-2,0,-7,7,0,0,0,-1,-1,-1,1,1,-1
KR_6728164280,420,2,26,6,1,2,0,2,-4,5,1,-2,3,1,5,2,7,0,1,1,0,-8,43,0,-9,9,-25,0,0,-1,-1,1,-1,1,-1
KR_6745771488,420,0,26,-28,-6,1,2,3,-1,4,3,-4,4,0,-2,7,5,0,1,1,0,-6,-58,1,-6,5,1,0,0,-1,1,-1,-1,4,-1
KR_6773769197,420,0,-34,-7,1,-4,6,2,4,0,4,-3,3,0,2,0,2,2,0,2,0,7,14,0,-6,6,-5,0,0,-1,1,0,-1,4,-1
KR_6776261767,420,-3,-30,5,-10,-4,5,1,-4,6,2,1,1,2,-4,5,1,1,1,2,0,-13,-6,0,-3,3,-4,0,-1,-1,-1,-1,-1,3,-1
KR_6772234714,420,-1,22,3,-3,-3,4,1,-1,2,1,1,1,2,-2,4,2,2,0,2,0,-3,-5,-1,-2,3,6,0,1,-1,1,1,1,5,-1
KR_6772074208,420,-1,-85,4,1,1,1,2,-2,10,8,2,0,2,0,5,5,0,2,2,1,5,-30,0,-5,5,12,0,-1,-1,-1,-1,1,6,-1
KR_6772294662,420,-4,-49,-19,-2,-1,2,1,-1,2,1,-1,2,1,0,6,6,1,0,1,1,3,-150,-4,-5,9,-3,0,-1,-1,-1,-1,1,5,-1
KR_6740952390,420,1,0,3,-3,0,3,3,-4,5,1,1,3,4,3,1,4,-3,3,0,-2,-9,-42,-2,-5,7,3,0,0,-1,-1,0,-1,3,-1
KR_6748331539,420,-2,-53,4,0,1,0,1,-2,4,2,3,0,3,0,1,1,-2,2,0,0,3,-8,-3,-5,8,-3,0,-2,1,-1,-1,-1,1,-1
KR_6735464484,420,-1,-21,-5,-3,-5,6,1,-1,2,1,-1,2,1,3,1,4,1,0,1,0,-1,-4,-3,-1,4,0,0,-2,-1,-1,-1,-1,1,-1
KR_6762082360,420,1,-18,-12,0,2,1,3,1,3,4,0,1,1,-3,8,5,0,2,2,1,2,-10,-1,-7,8,1,0,-1,-1,-1,-1,1,6,-1
KR_6777650746,440,-3,-14,-24,-6,-3,3,0,-3,4,1,1,1,2,-2,6,4,1,0,1,0,-3,5,3,-6,3,-1,0,-1,-1,-1,-1,1,5,-1
KR_6771880681,420,2,20,23,-6,-4,4,0,2,0,2,1,3,4,-3,4,1,-2,2,0,0,-4,-103,1,-7,6,-5,0,0,1,1,0,-1,2,-1
KR_6775273487,420,3,13,13,1,1,1,2,0,1,1,-1,2,1,2,0,2,-1,1,0,0,-1,0,-1,-3,4,-3,0,-1,-1,-1,-1,-1,5,-1
KR_6770910790,420,-4,-5,-15,-7,0,2,2,-3,5,2,-3,4,1,-2,3,1,1,0,1,0,-11,-14,-3,-3,6,-3,0,0,-1,-1,-1,-1,6,-1
KR_6776670134,420,-1,22,-37,-13,3,1,4,-5,6,1,-8,8,0,1,2,3,-4,5,1,-1,-17,-12,-2,-8,10,5,0,-1,1,-1,-1,-1,3,-1
KR_6768318017,420,-2,-17,14,-1,2,0,2,-7,8,1,3,2,5,2,5,7,-1,1,0,0,-1,9,1,-9,8,-2,0,-1,1,-1,-1,1,2,-1
KR_6730337804,420,-3,-104,-20,-13,-7,7,0,-4,7,3,2,1,3,0,1,1,-4,4,0,0,-3,4,-3,-3,6,-6,0,-3,-1,-1,-1,-1,4,-1
KR_6775668282,420,-1,39,-4,-5,2,1,3,-2,3,1,-4,4,0,-1,1,0,0,1,1,0,-9,-4,-3,-8,11,-3,0,0,-1,-1,-1,1,2,-1
KR_6739554906,440,-3,-57,-4,-6,3,0,3,-5,6,1,-4,4,0,0,2,2,0,2,2,1,-3,-4,5,-10,5,6,0,0,1,-1,0,1,3,-1
KR_6769266400,420,0,-35,-13,1,0,0,0,3,2,5,0,3,3,-3,5,2,1,1,2,0,1,-25,4,-8,4,0,0,-1,1,-1,-1,1,1,-1
KR_6773980024,440,-3,-2,-20,-10,-4,5,1,0,2,2,-2,2,0,0,1,1,-4,5,1,0,-6,-25,2,-4,2,23,0,0,-1,1,0,-1,3,-1
KR_6764515490,420,-2,-25,13,-9,2,2,4,-2,5,3,-4,6,2,-4,4,0,-1,1,0,1,-19,4,2,-6,4,-4,0,0,0,1,0,1,0,-1
KR_6758496908,420,1,28,5,3,2,0,2,3,0,3,2,1,3,-3,3,0,-1,1,0,0,2,-42,-2,-6,8,32,0,1,1,1,1,1,1,-1
KR_6740525593,420,-2,-64,4,-2,1,0,1,0,4,4,-1,2,1,-3,6,3,1,0,1,0,3,1,5,-8,3,5,0,1,1,1,1,1,1,-1
KR_6684075586,420,4,65,16,-3,2,1,3,0,2,2,-4,5,1,-3,4,1,2,0,2,-1,-15,8,-3,-2,5,-2,0,0,0,1,0,-1,0,-1
KR_6765698926,420,-1,74,-53,-6,1,1,2,-2,5,3,0,2,2,-7,9,2,2,0,2,1,-9,1,0,-6,6,-3,0,-1,-1,-1,-1,1,6,-1
KR_6726726840,420,-4,-67,15,-8,-4,4,0,-4,5,1,0,2,2,-1,4,3,1,0,1,0,-10,16,0,-8,8,-1,0,0,-1,1,0,-1,4,-1
KR_6746146546,420,-1,-5,24,-8,-2,2,0,1,0,1,-1,2,1,-5,7,2,-1,1,0,0,-9,5,0,-6,6,-3,0,-1,-1,-1,-1,-1,5,-1
KR_6774493805,420,-3,-41,0,-2,-1,2,1,-1,1,0,2,3,5,0,2,2,-2,2,0,-1,-12,-3,3,-6,3,1,0,-1,1,1,1,-1,3,-1
KR_6769303843,420,-3,-18,-4,-5,-2,3,1,-2,4,2,0,1,1,-1,3,2,0,0,0,0,-10,11,1,-8,7,-6,0,0,-1,1,0,-1,3,-1
KR_6769947564,440,-1,49,-21,2,2,0,2,1,1,2,-2,3,1,-1,4,3,2,1,3,0,1,-8,4,-9,5,-5,0,0,1,-1,0,-1,6,-1
KR_6771890198,420,-3,-38,-4,-9,0,1,1,-1,1,0,-1,2,1,-7,7,0,0,1,1,-1,-12,3,2,-5,3,0,0,-2,-1,-1,-1,-1,6,-1
KR_6756783691,420,5,8,13,13,6,0,6,4,2,6,0,1,1,2,4,6,1,1,2,0,12,5,-2,-4,6,0,0,0,1,1,1,1,2,-1
KR_6770586955,420,-2,-36,32,-13,1,4,5,-1,4,3,-4,5,1,-9,9,0,0,1,1,-2,-22,23,-4,-6,10,-7,0,-3,-1,-1,-1,1,5,-1
KR_6749138321,440,-5,-95,-24,-13,-4,4,0,-5,7,2,-2,2,0,-1,3,2,-1,3,2,-2,-13,5,-1,-3,4,-5,0,-2,-1,-1,-1,-1,6,-1
KR_6772946644,420,-2,-27,-7,-11,-7,9,2,-3,5,2,-1,2,1,0,4,4,0,2,2,0,-16,-3,-3,-2,5,2,0,1,-1,1,-1,-1,6,-1
KR_6763153575,420,-2,-40,-5,-3,-4,6,2,-2,2,0,6,0,6,-3,3,0,0,0,0,0,-1,1,0,-6,6,2,0,-2,1,-1,-1,1,5,-1
KR_6770550338,420,0,-3,-15,3,5,2,7,-2,3,1,1,0,1,-1,3,2,0,1,1,1,-4,20,-4,-6,10,1,0,1,-1,1,1,1,3,-1
KR_6741220570,420,1,-8,-16,6,2,1,3,4,0,4,-1,3,2,0,1,1,1,1,2,0,0,-9,-5,-2,7,5,0,0,1,-1,-1,1,6,-1
KR_6776614568,420,0,20,-7,2,-1,2,1,4,2,6,-1,1,0,-1,4,3,1,1,2,0,3,-2,-1,-8,9,-2,0,1,-1,-1,1,1,6,-1
KR_6723783880,420,4,55,19,4,-3,3,0,7,1,8,0,5,5,0,4,4,0,3,3,0,-6,-6,-6,-6,12,6,0,1,-1,1,1,1,6,-1
KR_6769921248,420,-2,-83,19,-8,-1,1,0,-2,4,2,-2,2,0,-2,3,1,-1,1,0,0,-7,-2,2,-6,4,0,0,-2,-1,1,-1,-1,2,-1
KR_6699532641,420,2,-37,40,3,3,0,3,4,0,4,-1,4,3,-5,5,0,2,0,2,0,-2,-3,0,-7,7,1,0,1,-1,1,1,-1,3,-1
KR_6776041033,420,-1,34,11,-5,2,1,3,-4,4,0,-5,5,0,2,1,3,0,1,1,0,-8,-54,0,-8,8,2,0,0,1,1,0,-1,2,-1
KR_6776044043,420,0,-48,28,1,1,2,3,1,2,3,1,1,2,-1,1,0,-1,1,0,0,-1,-46,5,-9,4,10,0,0,-1,1,-1,1,6,-1
KR_6757811705,420,1,11,1,4,3,1,4,0,1,1,-1,1,0,1,2,3,1,1,2,-1,0,-83,2,-6,4,-2,0,0,0,1,0,-1,0,-1
KR_6769761566,440,-4,-29,4,-12,-1,3,2,-7,7,0,-3,5,2,-3,4,1,2,0,2,0,-7,-2,-5,-2,7,-4,0,-1,-1,-1,-1,-1,6,-1
KR_6757996484,420,-3,-58,-27,-1,1,2,3,-1,4,3,0,3,3,-3,7,4,2,0,2,1,3,-4,-3,-6,9,-2,0,-1,-1,1,-1,1,1,-1
KR_6731519167,420,-2,-58,43,-6,-2,2,0,-1,3,2,-4,4,0,1,1,2,0,0,0,0,-4,41,-3,-6,9,0,0,-1,-1,-1,-1,1,4,-1
KR_6758352350,420,0,-23,21,-4,-4,5,1,2,3,5,6,1,7,-6,6,0,-2,2,0,0,3,-6,-2,-4,6,3,0,-2,-1,-1,-1,1,2,-1
KR_6756246418,420,-2,12,-20,4,1,2,3,-1,1,0,-2,5,3,6,3,9,0,0,0,3,9,-2,2,-7,5,1,0,-1,-1,1,1,1,1,-1
KR_6772700992,420,-2,48,-24,-8,-1,3,2,0,2,2,-6,7,1,-2,3,1,1,1,2,0,-22,-10,-5,-3,8,4,0,0,-1,0,0,-1,4,-1
KR_6756618418,420,-5,-40,1,-14,-2,3,1,-1,4,3,-6,6,0,-3,8,5,-2,3,1,0,-15,-2,1,-5,4,-3,0,0,1,1,-1,-1,4,-1
KR_6773571926,440,-2,-48,20,-5,0,2,2,0,6,6,-1,6,5,-2,2,0,-2,2,0,0,-10,-19,-2,-4,6,-3,0,1,1,1,1,-1,6,-1
KR_6775304587,420,0,-53,8,-3,1,0,1,-5,5,0,1,0,1,0,1,1,0,1,1,0,-4,29,1,-10,9,-2,0,-1,-1,-1,-1,-1,5,-1
KR_6765339170,420,-2,-20,-16,-5,2,2,4,-4,4,0,0,2,2,-3,3,0,0,2,2,0,-2,18,3,-7,4,-8,0,-1,-1,1,1,-1,6,-1
KR_6772680718,420,0,2,19,-1,0,2,2,-4,5,1,0,2,2,-3,5,2,6,1,7,0,-2,5,1,-4,3,3,0,4,1,1,1,1,4,-1
KR_6771512368,420,3,-3,-4,0,2,2,4,2,0,2,-2,3,1,-1,3,2,-1,2,1,-1,-3,-1,-7,-1,8,-1,0,1,1,1,1,-1,4,-1
KR_6767803269,420,-4,-88,27,-10,-6,8,2,0,3,3,-1,3,2,-3,5,2,0,0,0,-1,-5,6,-3,-5,8,2,0,-1,-1,-1,-1,-1,4,-1
KR_6773479666,420,0,4,0,-2,2,3,5,-2,4,2,-1,4,3,0,2,2,-1,2,1,0,-1,-5,-2,-3,5,5,0,-1,-1,1,-1,-1,5,-1
KR_6758712372,420,1,0,39,-1,3,0,3,1,1,2,-2,2,0,-1,2,1,-2,3,1,0,-3,-4,-2,-7,9,2,0,1,1,1,-1,1,6,-1
KR_6773226209,420,-1,8,20,-7,-3,4,1,1,6,7,-6,6,0,4,0,4,-3,3,0,0,-12,-1,3,-8,5,-5,0,0,-1,1,1,-1,6,-1
KR_6771032777,420,-2,-45,24,-9,-5,7,2,-3,3,0,0,2,2,-1,3,2,0,0,0,-1,-10,0,0,-6,6,-4,0,-1,-1,-1,-1,-1,5,-1
KR_6770819385,420,-1,-22,-12,-5,3,1,4,-1,6,5,-4,5,1,-1,4,3,-2,2,0,0,-4,-7,2,-8,6,0,0,0,-1,-1,0,-1,4,-1
KR_6758025664,420,0,22,7,4,3,1,4,1,3,4,0,2,2,-2,5,3,2,0,2,0,6,26,0,-8,8,0,0,0,0,1,1,1,0,-1
KR_6777836579,420,2,7,8,3,1,1,2,2,4,6,0,0,0,1,3,4,-1,1,0,0,2,-11,0,-9,9,4,0,-1,1,1,-1,1,5,-1
KR_6774119250,420,-4,-30,2,-7,-3,3,0,3,2,5,-2,4,2,-3,5,2,-2,2,0,0,-16,-1,-3,-1,4,-3,0,-3,-1,-1,-1,1,1,-1
KR_6773229683,420,-3,-5,-30,-5,-1,2,1,1,3,4,-1,1,0,-5,5,0,1,1,2,-1,-6,4,4,-8,4,-7,0,-1,-1,-1,-1,-1,5,-1
KR_6777472896,420,-3,15,-20,-11,1,2,3,0,2,2,-3,6,3,-6,8,2,-3,3,0,0,-13,2,-1,-5,6,4,0,0,-1,1,-1,1,6,-1
KR_6775838676,420,-2,-52,-2,-12,1,1,2,-1,2,1,-2,2,0,-8,8,0,-2,2,0,0,-20,9,-1,-8,9,-5,0,-1,-1,1,-1,-1,2,-1
KR_6766357137,420,-2,-29,-12,-7,-3,5,2,3,3,6,-2,5,3,-5,6,1,0,2,2,-1,-12,20,-1,-7,8,1,0,1,1,1,1,-1,1,-1
KR_6770232871,420,-3,-3,-11,1,0,0,0,0,1,1,0,5,5,-3,4,1,4,0,4,0,-1,4,2,-8,6,-1,0,-1,-1,-1,-1,1,5,-1
KR_6768351035,420,-2,-27,-11,-2,0,2,2,0,1,1,-5,6,1,2,0,2,1,0,1,0,-1,-13,-2,-2,4,5,0,-1,1,-1,-1,-1,6,-1
KR_6769983553,420,0,8,22,4,0,1,1,0,5,5,4,2,6,0,3,3,0,1,1,0,1,5,5,-6,1,0,0,-1,1,1,-1,-1,4,-1
KR_6772389044,420,-7,-94,-36,-9,1,3,4,-6,7,1,-2,5,3,-4,8,4,2,1,3,1,-14,-13,-5,-3,8,-2,0,-1,-1,1,-1,1,5,-1
KR_6776106894,440,-3,-33,0,-10,-3,5,2,-2,2,0,-2,2,0,-1,1,0,-2,2,0,0,-23,-6,2,-7,5,5,0,-1,-1,1,-1,-1,1,-1
KR_6742591107,420,-3,65,-23,-6,1,2,3,-2,5,3,-6,6,0,2,2,4,-1,1,0,-2,-14,-4,-2,-5,7,0,0,2,1,1,1,-1,3,-1
KR_6733507923,420,-5,-55,0,-8,-2,2,0,-5,8,3,0,4,4,1,2,3,-2,3,1,-1,-6,74,-4,-3,7,1,0,-1,-1,1,-1,-1,1,-1
KR_6776752312,420,-1,0,28,-17,-6,6,0,4,3,7,-4,4,0,-9,10,1,-2,3,1,1,-23,-12,-1,-6,7,-4,0,-1,-1,-1,-1,1,5,-1
KR_6761359792,420,-2,-26,-4,2,0,2,2,2,1,3,-1,3,2,1,1,2,0,1,1,0,4,-2,-2,-5,7,-2,0,1,-1,1,1,-1,2,-1
KR_6765874488,440,-4,-3,-7,-12,-1,3,2,-3,3,0,-5,7,2,0,5,5,-3,5,2,1,-9,1,4,-6,2,-4,0,-1,-1,-1,-1,1,5,-1
KR_6733130197,420,-1,-2,-6,-2,-1,2,1,0,3,3,0,1,1,0,5,5,-1,3,2,0,-8,-2,-5,-3,8,-1,0,0,-1,1,0,-1,2,-1
KR_6762979627,420,0,74,7,1,1,0,1,-2,3,1,0,2,2,1,1,2,1,1,2,0,1,3,1,-4,3,5,0,0,-1,-1,1,1,2,-1
KR_6668922414,420,-3,-57,-39,-6,-2,3,1,-3,5,2,0,1,1,-2,4,2,1,0,1,-1,-7,-6,0,-7,7,0,0,-1,-1,-1,-1,-1,5,-1
KR_6776621941,420,-1,-15,31,-7,1,1,2,4,2,6,-7,8,1,-4,8,4,-1,2,1,0,-10,-2,-6,-3,9,4,0,0,-1,1,1,-1,1,-1
KR_6762836336,420,-1,-6,12,0,1,0,1,0,2,2,0,4,4,3,1,4,-4,4,0,0,5,0,2,-6,4,0,0,1,-1,1,1,1,6,-1
KR_6773134244,420,2,18,5,6,1,2,3,2,1,3,0,3,3,3,1,4,0,0,0,0,4,31,1,-8,7,-4,0,0,1,0,0,1,5,-1
KR_6768547372,420,1,26,16,-3,5,2,7,-2,4,2,1,2,3,-6,7,1,-1,1,0,1,-17,-38,-4,-4,8,-1,0,2,-1,-1,1,1,5,-1
KR_6768044979,420,-1,-29,-22,-7,-6,7,1,-1,2,1,0,1,1,0,0,0,0,2,2,0,-10,-2,-6,-6,12,6,0,-1,-1,1,-1,-1,6,-1
KR_6771898549,420,-5,-47,9,-14,-5,5,0,-5,6,1,2,0,2,-3,4,1,-3,3,0,0,-17,-4,2,-6,4,4,0,-2,-1,1,-1,-1,4,-1
KR_6769188024,420,-5,-82,-12,-8,-1,2,1,-1,2,1,-2,3,1,-1,6,5,-3,3,0,0,-8,-3,-1,-5,6,1,0,-2,-1,-1,-1,1,6,-1
KR_6775039745,420,3,60,48,5,5,1,6,-2,2,0,1,1,2,-2,4,2,3,1,4,0,-5,11,4,-8,4,-1,0,0,-1,-1,1,-1,5,-1
KR_6775950591,440,-4,-35,-1,-10,-2,3,1,-5,6,1,2,0,2,-3,3,0,-2,2,0,0,-16,6,0,-5,5,-8,0,0,-1,0,0,-1,1,-1
KR_6747993720,420,0,-10,11,-6,-1,2,1,0,1,1,-3,6,3,-2,2,0,0,2,2,0,-3,2,-5,-6,11,-2,0,-2,-1,-1,-1,-1,3,-1
KR_6761825320,440,-1,20,-8,-10,1,2,3,-5,6,1,-1,1,0,-2,5,3,-3,3,0,0,-13,-10,-2,-5,7,1,0,-3,1,-1,-1,-1,5,-1
KR_6774851272,420,0,8,32,0,-3,4,1,4,3,7,-2,2,0,1,3,4,0,1,1,0,-5,3,-3,-5,8,6,0,0,1,1,0,1,6,-1
KR_6743891554,420,-3,-10,-18,-3,2,1,3,2,1,3,-3,4,1,-2,6,4,-2,2,0,-2,-10,3,0,-10,10,-8,0,0,-1,1,0,-1,3,-1
KR_6763695232,420,-2,-31,-19,-5,2,1,3,1,1,2,-4,6,2,-4,4,0,0,2,2,0,-9,-42,2,-6,4,26,0,-1,-1,1,-1,-1,1,-1
KR_6764434975,420,-3,-15,0,-9,-3,3,0,-1,3,2,1,2,3,-3,6,3,-3,4,1,0,-16,-152,0,-6,6,-3,0,-2,-1,1,-1,-1,5,-1
KR_6748814887,420,1,2,-34,-1,-4,4,0,1,4,5,3,0,3,0,1,1,-1,2,1,0,5,-24,1,-8,7,-2,0,-1,-1,1,-1,1,1,-1
KR_6768320174,420,3,23,17,5,-2,2,0,6,1,7,0,0,0,2,1,3,-1,1,0,0,6,-110,0,-7,7,5,0,2,1,-1,1,1,3,-1
KR_6777080210,420,-2,9,-4,-3,-3,5,2,2,0,2,-2,4,2,1,3,4,-1,3,2,0,-5,-35,1,-3,2,-2,0,-1,-1,1,-1,1,3,-1
KR_6760447016,420,-5,5,-4,-7,-2,3,1,-4,6,2,-3,3,0,3,0,3,-1,2,1,0,-9,-5,0,-6,6,-2,0,0,1,-1,0,-1,5,-1
KR_6763677305,420,-5,-68,-22,-9,1,1,2,0,3,3,-4,4,0,-5,7,2,-1,2,1,0,-9,7,-1,-5,6,-3,0,-2,-1,-1,-1,1,2,-1
KR_6685395373,420,-3,-35,32,-8,0,2,2,-1,2,1,-2,2,0,-5,7,2,0,1,1,-1,-9,16,-2,-5,7,-5,0,-1,-1,-1,-1,-1,6,-1
KR_6765996802,420,-2,-51,2,-8,-2,3,1,-1,2,1,0,1,1,-5,5,0,0,0,0,0,-13,-11,-1,-6,7,0,0,-2,1,1,-1,-1,3,-1
KR_6773284431,420,-1,-64,6,-2,1,2,3,-1,4,3,-3,4,1,1,2,3,0,1,1,0,-3,25,-2,-4,6,1,0,-1,-1,1,-1,1,5,-1
KR_6750630155,420,-3,36,-4,-7,-2,2,0,-1,3,2,0,1,1,0,7,7,-4,5,1,-1,-18,-21,3,-8,5,1,0,0,-1,-1,-1,-1,4,-1
KR_6772133015,420,-1,-57,-18,4,4,1,5,0,2,2,1,2,3,-1,8,7,0,0,0,-1,6,-5,-2,-3,5,-2,0,-1,-1,-1,-1,-1,4,-1
KR_6707148642,440,-2,-33,13,-1,7,0,7,-2,5,3,-1,2,1,-6,8,2,1,0,1,0,-14,-2,-6,-2,8,-1,0,-1,1,-1,1,1,4,-1
KR_6763594855,420,-1,75,-43,-5,1,1,2,-3,5,2,1,2,3,2,4,6,-6,6,0,1,3,-12,2,-7,5,0,0,0,0,-1,0,1,0,-1
KR_6773185399,420,-2,-53,-3,-4,-1,4,3,4,2,6,0,0,0,-6,6,0,-1,1,0,0,-9,39,1,-6,5,0,0,-1,1,1,-1,1,2,-1
KR_6765745130,420,0,-38,16,8,0,0,0,0,1,1,2,0,2,6,1,7,0,0,0,0,8,7,1,-6,5,-3,0,1,1,1,1,1,1,-1
KR_6741680581,420,-4,-43,-24,-4,2,2,4,-5,8,3,-3,3,0,0,1,1,2,0,2,0,-11,-6,3,-6,3,-5,0,0,-1,1,0,-1,1,-1
KR_6777099246,420,-1,-5,12,-7,-1,2,1,1,4,5,-9,12,3,0,4,4,2,1,3,0,-11,-8,-1,-8,9,0,0,-1,1,1,-1,-1,6,-1
KR_6776718976,420,2,-57,11,-3,3,0,3,-6,8,2,-1,3,2,1,1,2,0,0,0,0,-4,14,-1,-7,8,-2,0,0,-1,1,0,-1,1,-1
KR_6768230227,420,-3,12,22,-13,-5,6,1,-4,4,0,-4,4,0,0,1,1,0,0,0,0,-8,19,-2,-3,5,-5,0,-1,1,1,-1,-1,2,-1
KR_6738126143,420,0,36,-21,8,4,2,6,0,5,5,0,2,2,1,2,3,3,0,3,1,-3,2,1,-6,5,2,0,1,-1,-1,1,1,3,-1
KR_6749285230,420,-3,-31,-20,-10,1,0,1,-7,9,2,-5,7,2,-1,2,1,2,1,3,0,-3,-9,-6,-4,10,4,0,-1,1,-1,-1,-1,3,-1
KR_6744005342,420,-3,15,-12,-5,-2,3,1,-1,2,1,1,2,3,-2,3,1,-1,1,0,0,-3,71,0,-7,7,0,0,-2,1,-1,-1,1,3,-1
KR_6777468614,420,-6,-150,-4,-9,-5,6,1,3,2,5,-2,3,1,-5,6,1,0,0,0,0,-2,-6,3,-8,5,-2,0,-4,1,-1,-1,1,2,-1
KR_6760024452,440,0,18,-12,-1,-7,7,0,-2,5,3,-1,2,1,5,1,6,4,2,6,0,1,14,-4,-1,5,6,0,0,-1,1,0,-1,5,-1
KR_6775993108,420,0,9,-37,-1,-3,5,2,-5,7,2,0,0,0,2,3,5,5,0,5,-1,2,34,3,-9,6,-5,0,1,-1,-1,-1,-1,3,-1
KR_6776807860,420,-1,0,-24,-7,-2,3,1,0,1,1,2,2,4,-6,11,5,-1,2,1,-3,1,3,2,-6,4,0,0,-1,-1,-1,-1,-1,5,-1
KR_6776662571,420,0,19,-16,4,1,2,3,-2,4,2,2,1,3,0,2,2,3,0,3,0,1,43,2,-4,2,-13,0,0,1,1,1,1,3,-1
KR_6776320236,420,-2,-9,4,-4,2,0,2,-3,3,0,-1,3,2,-1,2,1,-1,1,0,0,-6,15,-2,-5,7,-1,0,0,-1,1,0,-1,4,-1
KR_6748416210,420,-3,-31,12,-1,2,2,4,-2,4,2,2,0,2,-3,5,2,0,0,0,0,-4,7,1,-6,5,-5,0,-1,0,1,-1,-1,0,-1
KR_6745531245,420,-1,-73,29,-3,-2,3,1,2,2,4,1,0,1,-6,9,3,2,0,2,0,-1,-40,8,-11,3,-3,0,-1,1,-1,-1,1,5,-1
KR_6772981997,420,0,25,-5,0,2,1,3,-3,3,0,1,1,2,3,0,3,-3,4,1,0,-1,6,-1,-6,7,1,0,1,1,-1,1,1,5,-1
KR_6776412074,420,-2,-41,2,1,-1,3,2,0,3,3,0,1,1,2,4,6,0,0,0,0,3,-10,1,-7,6,-4,0,0,-1,1,-1,-1,2,-1
KR_6774294008,420,-1,-33,-4,-11,-6,6,0,-1,2,1,-2,4,2,-3,5,2,1,0,1,0,-12,18,3,-7,4,-2,0,-1,1,-1,-1,-1,3,-1
KR_6772463809,420,-3,-23,-9,-8,-4,5,1,-5,5,0,0,1,1,0,3,3,1,0,1,0,-1,15,-2,-2,4,2,0,-2,0,-1,-1,-1,0,-1
KR_6708365576,420,-4,-14,-23,-9,2,0,2,-2,3,1,-3,5,2,-5,6,1,-1,2,1,0,-18,-67,-2,-5,7,0,0,1,-1,1,1,1,5,-1
KR_6734158426,420,-4,-31,-2,-11,-5,6,1,-1,2,1,-3,5,2,0,3,3,-2,2,0,0,-8,-43,-2,-5,7,3,0,-1,1,-1,-1,-1,3,-1
KR_6772475549,420,-3,-12,-8,-7,0,3,3,-5,6,1,-3,3,0,1,5,6,0,0,0,1,-7,-21,3,-8,5,1,0,0,1,-1,-1,1,4,-1
KR_6767430311,420,-4,-16,-4,-2,3,3,6,-2,5,3,-1,3,2,0,1,1,-2,2,0,0,-12,-111,2,-7,5,-1,0,0,-1,1,0,1,1,-1
KR_6775328972,420,5,-15,15,7,0,0,0,4,0,4,3,0,3,2,2,4,-2,2,0,0,17,55,1,-5,4,6,0,0,1,-1,-1,1,2,-1
KR_6777357674,420,-3,-49,2,-3,-2,4,2,6,3,9,-3,3,0,-3,4,1,-1,4,3,-1,-7,-1,-3,-3,6,13,0,-1,1,1,1,-1,6,-1
KR_6777746351,440,2,0,2,4,1,0,1,3,1,4,-1,1,0,1,7,8,0,2,2,1,6,174,6,-8,2,5,0,0,1,0,0,1,6,-1
KR_6729386241,420,0,24,-38,-8,0,2,2,-2,2,0,-4,5,1,-1,5,4,-1,2,1,0,-8,-8,1,-6,5,6,0,0,-1,1,-1,1,5,-1
KR_6718675461,420,-2,-12,-17,-9,-2,3,1,-4,8,4,1,2,3,-3,3,0,-1,1,0,-1,-11,36,-1,-7,8,1,0,0,-1,1,-1,-1,5,-1
KR_6681778661,420,-4,-56,-4,-1,0,1,1,-2,5,3,3,0,3,-3,4,1,1,1,2,0,3,91,-1,-3,4,5,0,-1,1,-1,-1,1,5,-1
KR_6773808944,420,0,0,-5,-6,2,1,3,-1,5,4,-2,3,1,-5,8,3,0,2,2,-1,-9,-10,-3,-6,9,-1,0,-1,-1,1,-1,-1,4,-1
KR_6723980343,420,-2,-40,-4,-3,1,0,1,-2,6,4,1,0,1,-2,2,0,-1,1,0,0,-10,1,-5,-4,9,-4,0,-2,-1,-1,-1,-1,1,-1
KR_6738009256,420,-1,11,-4,-10,-1,2,1,-2,4,2,-8,9,1,1,0,1,0,1,1,0,-9,67,2,-11,9,7,0,0,1,-1,1,-1,6,-1
KR_6742355761,420,-2,-103,-20,-3,0,0,0,-4,4,0,1,1,2,-1,3,2,1,0,1,1,-4,26,-3,-6,9,-1,0,-1,1,-1,-1,1,1,-1
KR_6736946609,420,1,-63,25,-5,0,2,2,0,1,1,-1,2,1,-4,6,2,0,1,1,0,-9,59,0,-7,7,-4,0,0,-1,-1,0,-1,1,-1
KR_6777220506,420,-2,-31,8,-1,2,0,2,-8,9,1,8,3,11,-1,7,6,-2,2,0,1,-10,-3,-2,-5,7,-5,0,0,1,-1,-1,1,6,-1
KR_6771849027,440,0,-21,28,-2,-2,3,1,0,2,2,3,2,5,-4,4,0,1,2,3,0,-5,-74,0,-2,2,-2,0,-1,0,-1,-1,1,0,-1
KR_6740157627,440,-4,-25,-4,-11,0,2,2,-3,4,1,-2,4,2,4,1,5,-10,11,1,0,-15,7,-5,-2,7,-3,0,-1,-1,-1,-1,-1,2,-1
KR_6774428114,420,-2,25,-5,-2,4,0,4,-1,2,1,2,0,2,-6,6,0,-1,1,0,-1,-4,10,5,-11,6,-2,0,1,-1,1,1,-1,5,-1
KR_6741399563,420,-4,50,-18,-3,-5,5,0,-3,4,1,-2,5,3,1,2,3,6,0,6,1,0,-31,2,-8,6,1,0,-2,-1,-1,-1,1,4,-1
KR_6772560801,420,0,-47,-22,9,3,2,5,5,1,6,2,1,3,1,3,4,-2,2,0,0,11,0,0,-7,7,-1,0,1,-1,1,1,1,3,-1
KR_6770247672,420,4,58,31,5,0,1,1,8,4,12,-2,3,1,0,2,2,-1,1,0,0,5,11,9,-14,5,-1,0,4,1,-1,1,-1,2,-1
KR_6776431628,420,0,41,8,3,-4,4,0,6,0,6,5,1,6,-3,6,3,-1,4,3,0,8,15,2,-8,6,0,0,1,1,1,1,-1,4,-1
KR_6774296063,420,-1,-9,-20,-5,1,0,1,1,2,3,-4,4,0,-2,3,1,-1,1,0,0,-10,39,2,-8,6,-1,0,1,1,1,1,-1,3,-1
KR_6709036871,420,-1,-36,0,-10,-2,2,0,-2,3,1,-4,4,0,-3,4,1,1,0,1,0,-11,112,-2,-4,6,2,0,-1,-1,1,-1,1,2,-1
KR_6728319904,440,-2,8,2,1,1,0,1,-5,5,0,-1,5,4,4,0,4,2,1,3,0,-2,6,1,-2,1,-2,0,1,1,1,1,-1,1,-1
KR_6751271017,440,-7,-47,-69,-17,-3,3,0,-2,3,1,-2,4,2,-9,14,5,-1,3,2,0,-13,-9,-1,-6,7,-3,0,0,-1,-1,-1,1,1,-1
KR_6740882762,420,-1,34,12,2,3,1,4,-2,3,1,-3,3,0,2,1,3,2,1,3,0,-2,-5,-4,-3,7,4,0,1,1,-1,1,-1,6,-1
KR_6753206630,420,-2,-39,7,0,-2,3,1,-1,3,2,4,0,4,-1,3,2,0,2,2,0,-3,-12,-7,-2,9,-1,0,-2,1,-1,-1,-1,6,-1
KR_6746179030,420,-6,-42,3,-8,-1,2,1,2,1,3,-5,6,1,-3,6,3,-1,1,0,0,-13,5,-4,-5,9,1,0,-1,1,-1,-1,-1,2,-1
KR_6756786451,420,0,38,3,-1,3,0,3,-4,4,0,0,3,3,-1,4,3,1,1,2,-1,-8,-79,-3,-5,8,5,0,-1,1,-1,-1,-1,5,-1
KR_6740073450,420,-6,-77,16,-11,-1,3,2,-1,3,2,4,0,4,-13,14,1,0,0,0,-2,-11,-1,2,-9,7,-5,0,-3,1,1,-1,-1,2,-1
KR_6763681456,420,0,3,4,-6,-1,2,1,1,2,3,1,1,2,-7,7,0,0,1,1,0,-14,0,1,-7,6,1,0,0,-1,0,0,1,6,-1
KR_6777840644,420,-1,-24,2,0,3,1,4,-3,6,3,0,1,1,0,3,3,0,2,2,0,0,11,0,-7,7,1,0,0,1,1,0,-1,4,-1
KR_6767545771,420,-4,-23,-8,-5,-1,4,3,1,1,2,-3,4,1,-1,3,2,-1,1,0,0,-6,-47,-4,-4,8,1,0,-1,-1,-1,-1,1,6,-1
KR_6774193597,440,-7,-53,-32,-15,-5,6,1,-2,4,2,1,4,5,-4,5,1,-5,6,1,0,-14,13,1,-3,2,-7,0,-1,-1,-1,-1,1,6,-1
KR_6772752679,420,2,15,22,1,-2,3,1,3,2,5,-1,2,1,1,1,2,0,0,0,0,9,9,-1,-4,5,1,0,1,1,1,1,-1,1,-1
KR_6772262229,420,-4,-42,-67,-11,2,2,4,-6,8,2,-4,6,2,-1,1,0,-2,4,2,-3,-10,-9,-2,-2,4,-1,0,-2,-1,-1,-1,-1,6,-1
KR_6767297218,420,1,-16,-17,3,2,1,3,-3,4,1,1,0,1,0,5,5,3,1,4,0,-1,12,3,-9,6,-7,0,-1,-1,-1,-1,1,4,-1
KR_6760954174,420,0,-15,-56,3,-5,9,4,0,3,3,-1,2,1,4,1,5,5,0,5,0,8,-22,0,-6,6,-2,0,-2,1,-1,-1,-1,5,-1
KR_6759726484,420,2,35,1,7,4,1,5,4,0,4,-6,10,4,3,3,6,2,0,2,2,11,3,-1,-4,5,6,0,2,1,-1,1,1,4,-1
KR_6759480509,420,1,16,-6,4,3,3,6,1,4,5,-1,2,1,-1,3,2,2,0,2,-1,7,9,2,-4,2,-6,0,2,-1,1,1,1,1,-1
KR_6776537521,420,-2,-67,-21,-5,1,1,2,-1,2,1,-3,5,2,-1,1,0,-1,1,0,0,-3,-40,2,-7,5,13,0,-1,-1,1,-1,1,6,-1
KR_6769128538,420,-1,48,11,-2,-4,5,1,-1,3,2,0,1,1,4,2,6,-1,1,0,0,-3,-46,-1,-6,7,0,0,0,1,-1,0,1,4,-1
KR_6775154527,420,-5,-32,-11,-11,0,1,1,-5,5,0,-2,5,3,-2,4,2,-2,2,0,0,-9,-1,-3,-4,7,-3,0,0,-1,1,1,-1,6,-1
KR_6772257991,440,-2,-57,-12,-9,0,1,1,0,3,3,-4,4,0,-3,4,1,-2,2,0,0,-6,20,3,-4,1,-3,0,-1,0,1,-1,-1,0,-1
KR_6777267002,420,-2,-21,-15,-8,-2,2,0,-3,5,2,-2,3,1,-3,4,1,2,0,2,0,-8,-14,-2,-4,6,18,0,-1,-1,-1,-1,1,6,-1
KR_6738847847,420,-4,-36,-8,-10,1,0,1,1,3,4,-6,6,0,-4,5,1,-2,2,0,0,-8,-25,-1,-6,7,0,0,-1,-1,-1,-1,-1,4,-1
KR_6748984854,420,0,33,24,-4,-3,3,0,2,2,4,2,1,3,-3,3,0,-2,2,0,0,-7,4,1,-3,2,0,0,1,-1,1,1,-1,5,-1
KR_6739901666,420,2,-5,1,2,-1,2,1,3,3,6,2,0,2,1,2,3,-3,3,0,0,1,2,-1,-6,7,2,0,-1,-1,1,-1,-1,1,-1
KR_6757267599,420,0,35,-49,3,3,2,5,-2,4,2,1,0,1,1,1,2,0,0,0,0,2,1,-2,-3,5,3,0,-2,1,-1,-1,1,5,-1
KR_6777470523,420,1,14,9,7,1,3,4,-1,1,0,7,1,8,1,0,1,-1,1,0,2,-1,24,5,-7,2,-1,0,2,1,1,1,1,3,-1
KR_6774359289,420,-7,-85,-12,-18,1,0,1,-5,7,2,-6,7,1,-6,6,0,-2,4,2,0,-14,0,-2,-7,9,1,0,-2,-1,1,-1,-1,6,-1
KR_6770561430,420,0,-52,22,-6,1,2,3,0,2,2,-5,5,0,-2,4,2,0,1,1,-2,-8,11,-4,-2,6,-4,0,1,-1,1,1,-1,2,-1
KR_6751323060,420,-3,-22,20,-5,-2,3,1,-4,8,4,2,3,5,0,3,3,-1,1,0,0,-7,15,-5,-3,8,-1,0,0,1,-1,0,-1,6,-1
KR_6775787133,420,2,65,50,11,1,2,3,1,2,3,6,0,6,1,2,3,2,0,2,0,13,17,6,-8,2,1,0,2,1,1,1,-1,1,-1
KR_6756242232,420,0,45,-5,1,-2,2,0,-2,4,2,1,0,1,4,1,5,0,2,2,0,3,-293,-1,-2,3,1,0,-1,-1,-1,-1,1,2,-1
KR_6669115845,420,-1,-49,-1,-6,-4,5,1,-5,9,4,4,0,4,-6,7,1,5,1,6,-1,-7,306,3,-6,3,-3,0,-1,-1,1,-1,-1,5,-1
KR_6743052930,420,-1,-13,3,0,2,0,2,-1,2,1,-1,5,4,-3,4,1,3,1,4,0,-10,-25,-2,-4,6,0,0,0,-1,1,1,-1,5,-1
KR_6688508246,420,-4,-41,10,-14,0,0,0,-6,8,2,-2,4,2,-4,4,0,-2,3,1,0,-27,0,-1,-5,6,-3,0,-1,-1,-1,-1,-1,3,-1
KR_6719949065,420,-4,15,-44,-10,-3,3,0,-5,6,1,0,3,3,-3,4,1,1,1,2,0,-10,-8,2,-5,3,0,0,-2,-1,-1,-1,-1,3,-1
KR_6771649546,440,-4,-56,-18,-8,1,0,1,2,1,3,-4,4,0,-4,6,2,-3,3,0,0,-6,-8,1,-5,4,0,0,-1,-1,-1,-1,1,1,-1
KR_6751324171,420,0,-46,3,-4,3,0,3,-5,5,0,-2,2,0,2,2,4,-2,2,0,0,-6,56,-3,-6,9,2,0,0,1,-1,1,-1,1,-1
KR_6767517641,420,-3,-36,9,-10,2,0,2,-6,9,3,0,1,1,-4,5,1,-2,3,1,0,-18,34,-4,-3,7,-25,0,0,-1,1,1,-1,5,-1
KR_6756388539,420,-2,44,-23,-4,-4,4,0,-2,3,1,-1,2,1,2,4,6,1,0,1,0,-7,-21,4,-8,4,1,0,-1,-1,1,-1,-1,4,-1
KR_6773052846,420,-2,-47,28,1,2,1,3,0,2,2,-2,3,1,2,1,3,-1,2,1,-1,9,-26,-4,-8,12,-6,0,-1,1,-1,-1,-1,5,-1
KR_6759656695,420,-3,-28,-21,-14,-3,3,0,0,2,2,-2,3,1,-6,8,2,-3,3,0,-1,-20,5,0,-8,8,-5,0,0,-1,-1,-1,-1,1,-1
KR_6762921599,420,4,62,4,0,1,0,1,2,3,5,-2,3,1,-1,3,2,0,1,1,0,-5,-8,-5,-2,7,7,0,0,-1,1,1,-1,4,-1
KR_6775942933,440,1,-13,7,0,0,2,2,2,3,5,0,0,0,3,0,3,-5,6,1,0,2,-6,-3,-5,8,3,0,-1,-1,1,-1,-1,1,-1
KR_6772164822,420,-1,-36,13,0,-2,3,1,0,4,4,1,1,2,1,3,4,0,1,1,0,1,-4,-1,-3,4,2,0,-2,1,-1,-1,1,1,-1
KR_6740856216,420,0,46,0,-7,3,0,3,-6,8,2,2,0,2,-4,5,1,-2,2,0,0,-20,-7,-3,-4,7,1,0,-1,-1,-1,1,-1,5,-1
KR_6771646180,420,-1,-56,8,1,-3,4,1,1,2,3,-1,3,2,3,1,4,1,1,2,1,1,-7,3,-12,9,2,0,0,-1,1,0,1,2,-1
KR_6756022268,420,-1,9,-2,3,3,0,3,0,3,3,-3,4,1,3,1,4,0,1,1,0,-3,-49,-3,-4,7,5,0,1,-1,1,1,1,3,-1
KR_6734877090,420,2,28,1,-1,2,1,3,4,2,6,-3,4,1,-4,5,1,0,0,0,1,-11,-8,-3,-7,10,-7,0,0,1,1,1,1,3,-1
KR_6771682194,420,0,2,11,-3,-4,4,0,1,2,3,5,1,6,-4,5,1,-1,1,0,0,-3,-124,0,-6,6,-1,0,0,1,1,1,1,1,-1
KR_6767760299,420,0,-2,-23,-5,1,2,3,3,1,4,-4,6,2,-2,5,3,-3,4,1,1,-5,-5,1,-7,6,-6,0,-1,-1,-1,-1,1,6,-1
KR_6757231940,420,-3,59,3,-4,2,2,4,-2,4,2,-4,4,0,-1,4,3,1,0,1,1,-8,-9,4,-7,3,5,0,1,0,-1,1,1,0,-1
KR_6775675032,420,0,52,-7,-1,1,0,1,0,1,1,-3,5,2,2,2,4,-1,2,1,0,0,21,2,-8,6,8,0,-1,-1,1,1,1,4,-1
KR_6752984114,420,-1,8,-5,-5,2,1,3,1,0,1,-3,4,1,-5,5,0,0,1,1,0,-12,-1,1,-8,7,-7,0,2,-1,1,1,1,3,-1
KR_6735929860,420,-4,-60,-13,-17,-6,6,0,-3,7,4,-9,9,0,-2,4,2,3,0,3,-1,-6,2,-4,-1,5,-1,0,-1,-1,1,-1,-1,6,-1
KR_6757757149,420,2,-2,15,7,4,0,4,-2,5,3,1,2,3,4,0,4,0,0,0,0,4,4,0,-6,6,1,0,0,1,1,0,1,6,-1
KR_6774776503,420,-1,-6,8,-4,1,1,2,-1,2,1,0,0,0,-4,4,0,0,0,0,0,-9,38,0,-8,8,-5,0,0,-1,-1,0,-1,4,-1
KR_6765545440,420,2,41,6,-4,-3,3,0,3,1,4,-5,9,4,-1,2,1,2,1,3,1,-17,-83,-5,-4,9,31,0,0,-1,-1,0,1,2,-1
KR_6731650169,420,0,3,5,-7,1,2,3,-5,7,2,-2,2,0,0,0,0,-1,2,1,-1,-6,35,-4,-5,9,2,0,0,1,-1,-1,-1,5,-1
KR_6739472042,420,-6,-24,-20,-5,-2,2,0,-3,4,1,-1,3,2,-2,6,4,3,1,4,0,-2,5,3,-8,5,5,0,-2,1,-1,-1,-1,4,-1
KR_6774766051,420,-3,-4,-6,-6,0,2,2,-1,3,2,-4,4,0,1,1,2,-2,2,0,-1,-13,-6,-5,-3,8,-4,0,-1,-1,-1,-1,-1,3,-1
KR_6777727463,420,0,-9,14,-7,-3,5,2,-2,3,1,-3,9,6,-1,2,1,2,0,2,0,-8,2,-2,-3,5,-1,0,0,-1,-1,-1,-1,2,-1
KR_6777846339,420,-2,-7,-8,-12,0,3,3,-3,5,2,-6,7,1,-1,3,2,-2,3,1,-1,-14,-21,-7,0,7,0,0,0,1,-1,0,-1,6,-1
KR_6774147918,420,4,24,12,1,3,1,4,2,1,3,-3,4,1,-1,2,1,0,0,0,0,-9,2,0,-3,3,-1,0,1,-1,1,1,1,4,-1
KR_6742140566,420,-4,25,-44,-10,-2,4,2,-5,6,1,1,2,3,-6,9,3,2,1,3,1,-17,-73,-1,-5,6,-7,0,2,-1,-1,1,1,6,-1
KR_6772082092,420,2,51,12,7,3,1,4,1,1,2,3,6,9,1,2,3,-1,2,1,0,9,8,6,-8,2,1,0,-1,1,-1,-1,1,1,-1
KR_6743834692,420,0,-45,-4,-7,-1,2,1,-4,6,2,1,2,3,-2,2,0,-1,1,0,0,-10,-8,-1,-2,3,0,0,-1,-1,-1,-1,-1,5,-1
KR_6747579528,420,0,-7,-15,-3,1,2,3,1,4,5,0,2,2,-3,6,3,-2,3,1,0,-2,-2,4,-8,4,-7,0,1,-1,1,1,-1,3,-1
KR_6761695555,420,-2,-88,0,0,1,2,3,0,2,2,-1,3,2,1,1,2,-1,1,0,-1,0,2,1,-5,4,-3,0,-2,1,-1,-1,-1,2,-1
KR_6774705324,420,-2,-51,-19,-4,0,1,1,-3,4,1,-2,4,2,-1,8,7,2,0,2,0,0,3,2,-9,7,2,0,1,1,1,1,1,6,-1
KR_6743682297,420,2,35,8,-1,6,0,6,0,1,1,-1,2,1,-5,6,1,-1,1,0,0,-11,-17,-1,-3,4,1,0,2,-1,1,1,-1,1,-1
KR_6678973901,420,-4,-29,4,-13,-2,2,0,-4,4,0,-2,3,1,-5,5,0,0,0,0,0,-17,0,2,-8,6,-5,0,-1,-1,-1,-1,-1,3,-1
KR_6734786799,420,-7,-47,-20,-18,-6,8,2,-1,1,0,-7,7,0,-3,3,0,-1,1,0,0,-17,40,-3,-5,8,-17,0,-2,-1,-1,-1,-1,6,-1
KR_6765493285,420,-1,-22,4,-8,5,0,5,1,2,3,-3,6,3,-8,12,4,-3,3,0,-2,-14,46,-7,-1,8,-31,0,-2,1,-1,-1,-1,1,-1
KR_6765006669,420,1,1,-24,6,0,0,0,6,0,6,0,3,3,1,1,2,-1,1,0,0,11,-24,5,-9,4,19,0,0,1,1,1,-1,6,-1
KR_6774136092,420,4,52,1,10,4,0,4,2,1,3,3,2,5,-2,6,4,3,0,3,0,7,6,4,-17,13,0,0,0,1,-1,0,-1,1,-1
KR_6743746505,420,-3,1,-9,-11,-1,3,2,-2,4,2,-4,7,3,-2,2,0,-2,2,0,0,-11,3,6,-9,3,-8,0,-2,-1,-1,-1,-1,3,-1
KR_6771785009,420,-1,29,-32,1,2,2,4,5,0,5,-4,5,1,-2,2,0,0,0,0,0,-3,0,-2,-7,9,-1,0,0,1,1,0,-1,1,-1
KR_6768337835,420,-3,-27,-4,-3,-2,4,2,-1,1,0,-4,9,5,4,1,5,0,0,0,0,9,5,-1,-7,8,-3,0,0,-1,-1,0,-1,4,-1
KR_6730753346,420,-7,-67,-13,-15,-2,3,1,-9,10,1,-3,4,1,1,3,4,-2,3,1,-2,-19,-30,-6,-2,8,-2,0,-2,-1,-1,-1,-1,6,-1
KR_6738363735,440,-4,-29,-3,-1,-2,3,1,3,1,4,-1,4,3,2,4,6,-3,4,1,0,5,4,-1,-8,9,5,0,0,1,-1,-1,1,1,-1
KR_6774994523,420,-3,-31,17,-5,-2,5,3,6,3,9,-4,4,0,-3,4,1,-2,2,0,0,-2,-8,-2,-6,8,0,0,-2,-1,1,-1,-1,2,-1
KR_6773854069,420,3,64,0,5,6,2,8,-1,3,2,2,3,5,-3,4,1,1,0,1,0,-3,-7,1,-10,9,0,0,0,-1,1,1,-1,3,-1
KR_6776778164,420,-1,16,-18,-7,1,2,3,-1,2,1,4,1,5,-10,13,3,-1,2,1,-3,-7,-5,-5,-4,9,4,0,-1,1,1,-1,-1,2,-1
KR_6770121302,440,-1,-47,-18,-2,-6,6,0,-1,2,1,4,1,5,1,1,2,0,1,1,0,6,-1,-4,-3,7,-1,0,-1,-1,-1,-1,1,2,-1
KR_6739213534,420,1,13,18,-4,-1,2,1,-3,5,2,3,4,7,-1,3,2,-2,3,1,0,-6,-9,0,-7,7,1,0,-1,-1,-1,-1,-1,4,-1
KR_6753039773,420,-1,54,27,-5,0,1,1,-4,7,3,0,2,2,1,2,3,-2,3,1,0,-15,30,-2,-5,7,2,0,-1,-1,1,1,-1,5,-1
KR_6776715131,420,-2,23,-55,3,0,0,0,-1,2,1,4,1,5,-3,3,0,3,0,3,-1,5,5,2,-6,4,1,0,2,-1,1,1,-1,2,-1
KR_6776098246,440,-2,-15,17,-3,-2,4,2,-3,7,4,2,1,3,0,2,2,0,1,1,0,-2,-2,1,-4,3,-1,0,-3,1,-1,-1,-1,3,-1
KR_6775377343,420,-2,-14,1,-6,0,4,4,-5,7,2,1,1,2,-3,3,0,1,0,1,0,-2,175,-3,-4,7,0,0,-2,-1,1,-1,1,2,-1
KR_6769808375,420,0,1,16,-3,1,2,3,-2,3,1,1,2,3,1,4,5,-4,5,1,0,-6,-12,-2,-5,7,0,0,0,-1,1,0,1,2,-1
KR_6770128398,420,-2,-13,-16,-6,-3,4,1,1,0,1,-1,2,1,0,1,1,-3,4,1,0,-6,-8,-1,-7,8,2,0,-1,-1,-1,-1,-1,4,-1
KR_6763998655,420,-3,4,-1,-6,-3,3,0,1,2,3,-4,4,0,1,1,2,-1,1,0,0,-5,-4,-1,-6,7,3,0,0,-1,1,0,-1,3,-1
KR_6771051127,420,0,-48,-3,4,-2,2,0,-1,3,2,2,0,2,5,1,6,0,2,2,0,10,6,0,-8,8,7,0,0,1,-1,1,1,4,-1
KR_6774521230,420,-4,-19,10,-7,2,1,3,1,0,1,-3,4,1,-5,5,0,-2,3,1,-1,-14,-28,0,-9,9,1,0,0,-1,1,0,-1,4,-1
KR_6774625784,420,-1,-20,13,-1,0,2,2,6,0,6,0,1,1,-5,7,2,-2,2,0,0,7,62,-1,-7,8,-10,0,0,-1,1,1,-1,1,-1
KR_6774216789,420,-1,-59,0,-2,-1,2,1,-4,6,2,-2,6,4,4,0,4,1,2,3,0,6,26,-3,-2,5,3,0,-1,1,-1,-1,1,5,-1
KR_6762589053,420,-1,-67,9,-5,-3,3,0,2,2,4,-3,4,1,-1,1,0,0,3,3,0,3,10,-3,-4,7,8,0,-2,-1,-1,-1,-1,3,-1
KR_6763080286,420,-5,-96,19,-8,-1,2,1,-4,5,1,0,1,1,-3,4,1,0,1,1,-1,-15,22,1,-8,7,2,0,-1,1,-1,-1,-1,3,-1
KR_6772884669,440,-4,-27,-9,-11,-2,3,1,0,3,3,-9,10,1,-2,5,3,2,0,2,0,-10,-18,-3,-4,7,1,0,-2,-1,-1,-1,-1,1,-1
KR_6770311352,420,-3,-16,-35,-6,0,1,1,-3,7,4,0,2,2,-5,9,4,2,2,4,-1,-10,-26,2,-7,5,1,0,0,-1,-1,-1,-1,1,-1
KR_6768771521,420,1,-31,24,-1,-4,5,1,-1,1,0,-2,3,1,3,1,4,3,0,3,0,-5,4,1,-4,3,1,0,0,1,1,1,1,5,-1
KR_6775099178,420,0,-5,24,5,3,0,3,1,3,4,1,1,2,0,6,6,0,1,1,0,-1,24,8,-10,2,-6,0,0,-1,1,0,1,6,-1
KR_6675864239,420,-3,-40,-42,1,-4,5,1,2,2,4,0,1,1,3,5,8,0,1,1,0,12,90,-2,-5,7,0,0,0,-1,-1,1,1,1,-1
KR_6771246707,420,-5,-46,-48,-4,3,1,4,-11,13,2,1,0,1,4,1,5,-1,1,0,0,2,-4,-3,-8,11,0,0,-2,-1,1,-1,1,4,-1
KR_6777273017,420,-2,25,9,-10,1,2,3,-1,2,1,-3,4,1,-4,5,1,-3,3,0,0,-20,-4,-3,-6,9,-4,0,0,-1,1,-1,1,1,-1
KR_6776037319,420,2,107,5,-4,0,0,0,0,3,3,0,0,0,-4,4,0,0,0,0,0,-1,-26,0,-11,11,3,0,1,1,1,1,-1,6,-1
KR_6765755762,420,-5,-172,-5,-6,-5,6,1,1,1,2,-3,5,2,1,2,3,0,1,1,0,2,3,2,-9,7,-2,0,-2,-1,1,-1,-1,5,-1
KR_6742755967,420,-3,-23,21,-12,-1,4,3,-5,6,1,1,1,2,-6,6,0,-1,1,0,0,-9,17,-2,-6,8,-4,0,-1,1,-1,-1,-1,4,-1
KR_6776615789,420,-3,-60,-6,-5,2,1,3,-2,3,1,-4,5,1,3,4,7,-4,4,0,0,1,-13,4,-7,3,-1,0,-2,1,1,-1,-1,1,-1
KR_6768477691,420,-6,-133,-14,-9,0,0,0,-3,5,2,0,2,2,4,0,4,-10,10,0,0,2,-3,-3,-4,7,1,0,-2,-1,-1,-1,-1,6,-1
KR_6776973895,420,-4,-3,-32,-11,3,0,3,-5,5,0,-1,2,1,-2,3,1,-6,6,0,0,-17,-22,-2,-7,9,0,0,-1,-1,-1,-1,-1,1,-1
KR_6721062787,420,-5,-82,-27,-8,-1,4,3,-1,3,2,0,2,2,-4,6,2,-2,2,0,-1,-8,-53,-1,-6,7,23,0,-3,-1,-1,-1,-1,2,-1
KR_6773631311,420,-2,-26,3,-4,-3,6,3,-1,3,2,-1,3,2,0,2,2,1,2,3,0,-7,-3,-1,-6,7,5,0,-1,-1,1,-1,1,3,-1
KR_6758395536,440,0,74,-24,1,2,0,2,-2,6,4,3,0,3,1,1,2,-3,3,0,0,0,0,1,-5,4,1,0,0,-1,-1,0,1,2,-1
KR_6741368611,420,0,-39,13,2,2,0,2,-1,2,1,-4,5,1,4,3,7,1,0,1,0,2,14,1,-6,5,-6,0,0,1,1,0,-1,4,-1
KR_6775772965,420,-3,-45,-24,-8,0,3,3,-3,4,1,-3,4,1,-1,1,0,-1,1,0,0,-1,-117,-2,-8,10,-4,0,-1,-1,1,-1,1,1,-1
KR_6736505784,440,-4,-82,-20,-4,-2,3,1,-2,2,0,0,1,1,-1,1,0,1,3,4,0,0,-4,-1,-3,4,0,0,-2,-1,0,-1,-1,5,-1
KR_6722829070,420,0,5,10,1,0,1,1,1,2,3,3,0,3,-2,5,3,-1,2,1,0,-8,6,1,-8,7,-1,0,-1,-1,1,-1,-1,2,-1
KR_6774205982,440,-2,-29,-18,-3,2,0,2,1,5,6,-3,5,2,-5,7,2,2,0,2,0,0,-2,-1,-8,9,-6,0,-1,-1,-1,-1,1,2,-1
KR_6750808444,420,1,-10,29,1,0,1,1,3,5,8,1,3,4,-4,4,0,1,0,1,0,-5,17,2,-8,6,4,0,0,-1,1,0,1,4,-1
KR_6718008695,440,0,-76,16,-8,-1,3,2,-3,5,2,0,3,3,-4,7,3,0,0,0,0,-4,-7,2,-6,4,0,0,-1,1,-1,-1,-1,6,-1
KR_6738688443,440,-3,0,-9,-12,-3,3,0,-6,8,2,0,5,5,-3,3,0,0,1,1,-2,-23,-2,-1,-2,3,-1,0,-2,1,-1,-1,-1,5,-1
KR_6769952853,420,-3,6,-32,-7,0,1,1,-2,5,3,-9,9,0,3,0,3,1,0,1,0,-4,1,4,-7,3,-4,0,1,-1,1,1,-1,2,-1
KR_6722971787,420,-1,-80,23,-3,1,1,2,-1,4,3,0,1,1,-5,6,1,2,1,3,0,-5,-11,-5,-5,10,3,0,-1,-1,1,-1,-1,5,-1
KR_6771454156,420,-2,-41,12,-8,-5,5,0,-1,4,3,-1,4,3,-2,7,5,1,2,3,0,-2,-4,-3,-3,6,1,0,-2,-1,-1,-1,-1,5,-1
KR_6712540996,420,-1,-78,8,-1,-1,4,3,2,3,5,1,1,2,2,1,3,-5,6,1,-1,-1,18,1,-7,6,1,0,-2,1,-1,-1,-1,3,-1
KR_6777114440,420,-2,-12,14,-5,-6,6,0,2,4,6,-4,5,1,3,1,4,0,1,1,0,-6,-28,1,-5,4,-3,0,-1,0,-1,-1,1,0,-1
KR_6774005070,440,-2,-68,-23,6,3,2,5,1,3,4,2,2,4,-2,3,1,2,2,4,0,4,-2,2,-5,3,1,0,-1,-1,-1,-1,1,6,-1
KR_6772718469,420,-2,-53,-1,-6,0,0,0,-3,4,1,-3,4,1,1,2,3,-1,1,0,0,-4,-51,5,-7,2,-3,0,-1,-1,1,-1,-1,6,-1
KR_6777608998,420,-2,37,12,-9,-3,3,0,0,1,1,-1,2,1,-1,2,1,-4,4,0,1,-10,-8,3,-8,5,3,0,-1,1,-1,-1,1,5,-1
KR_6772406164,420,-2,27,-19,-6,-4,6,2,-5,7,2,2,4,6,-3,5,2,4,1,5,0,-14,-14,2,-10,8,0,0,-2,-1,-1,-1,-1,2,-1
KR_6689550903,420,-2,-10,-39,0,-1,1,0,4,1,5,-3,4,1,-1,5,4,1,2,3,0,2,64,2,-6,4,-6,0,-1,-1,-1,-1,-1,2,-1
KR_6756801146,420,-6,-58,-16,-21,-3,4,1,-15,15,0,1,5,6,-5,5,0,1,0,1,0,-26,-10,-3,-2,5,-6,0,-3,-1,-1,-1,-1,2,-1
KR_6774915424,420,-1,-62,-20,-2,2,0,2,-1,5,4,-3,4,1,1,5,6,-1,4,3,0,0,-27,-1,-7,8,-2,0,0,1,-1,-1,1,2,-1
KR_6777502320,420,-1,28,-26,-6,-2,3,1,-3,5,2,-2,3,1,4,0,4,-3,4,1,0,-8,-28,-3,-4,7,-2,0,-1,-1,-1,-1,1,5,-1
KR_6761341015,440,-6,-78,-31,-6,1,2,3,-2,5,3,-2,2,0,-3,4,1,0,2,2,1,-6,3,5,-6,1,-4,0,0,-1,-1,-1,1,4,-1
KR_6708498921,420,-2,7,3,-4,0,2,2,2,3,5,-1,6,5,-7,9,2,2,0,2,0,2,20,-2,-4,6,1,0,-1,-1,-1,-1,1,6,-1
KR_6776221843,420,-4,-95,-16,-5,-2,3,1,-4,6,2,1,4,5,0,2,2,0,3,3,0,8,-14,4,-7,3,-7,0,-1,1,-1,-1,-1,2,-1
KR_6741265241,420,1,9,16,-1,2,2,4,0,4,4,-4,4,0,2,0,2,-1,1,0,0,2,2,-1,-5,6,3,0,0,-1,-1,0,-1,1,-1
KR_6775296407,420,-3,-5,0,-10,-1,2,1,-6,8,2,-1,1,0,-4,4,0,2,0,2,0,-14,-6,-6,-3,9,0,0,-1,1,-1,-1,-1,5,-1
KR_6712341365,420,-4,-45,-1,-8,-8,8,0,2,3,5,0,1,1,-4,4,0,2,0,2,0,-9,-4,-2,-5,7,-3,0,-1,-1,-1,-1,-1,4,-1
KR_6773459633,440,-6,-47,-33,-13,-2,2,0,-6,8,2,2,1,3,-7,9,2,0,1,1,0,-11,-26,-6,-3,9,5,0,-1,-1,-1,-1,-1,3,-1
KR_6758039673,420,-2,-36,-12,-7,-4,4,0,0,4,4,-3,3,0,1,0,1,-1,1,0,0,2,39,1,-10,9,-2,0,0,-1,-1,0,1,3,-1
KR_6774362516,420,0,-10,-18,-13,1,0,1,-3,5,2,-5,6,1,-7,9,2,1,2,3,0,-24,-19,-2,-3,5,-2,0,-1,-1,-1,-1,-1,2,-1
KR_6775390944,420,-1,56,-2,-6,0,2,2,-4,5,1,2,2,4,-4,5,1,0,1,1,0,-11,-5,-1,-6,7,8,0,0,1,-1,1,-1,2,-1
KR_6744439784,420,0,45,-4,0,-4,5,1,0,3,3,-1,5,4,3,1,4,2,0,2,1,4,12,-3,-4,7,-4,0,-1,1,-1,-1,1,2,-1
KR_6755332824,420,-2,-55,-29,-1,-2,5,3,1,1,2,-2,5,3,1,2,3,1,1,2,0,1,30,5,-6,1,-3,0,-1,-1,-1,-1,-1,5,-1
KR_6775862387,420,-1,-70,17,-2,1,1,2,1,4,5,-3,4,1,0,1,1,-1,1,0,0,-2,-3,0,-6,6,-3,0,0,-1,1,0,-1,1,-1
KR_6776886581,420,-3,9,-24,-7,-1,1,0,3,2,5,-3,4,1,-6,6,0,0,2,2,-1,-10,10,2,-11,9,-3,0,-1,1,-1,-1,-1,2,-1
KR_6681249099,420,0,-34,-28,-2,0,0,0,-1,3,2,-4,6,2,3,1,4,0,0,0,0,-6,25,-6,-2,8,2,0,-1,-1,-1,-1,-1,6,-1
KR_6776667608,420,-3,-26,-26,-10,2,2,4,-5,7,2,-9,11,2,-1,3,2,3,0,3,0,-3,61,1,-5,4,-3,0,-1,-1,1,1,-1,5,-1
KR_6748988968,420,-1,-43,-12,-9,-4,5,1,-7,10,3,4,1,5,-3,4,1,1,0,1,0,-2,-13,-5,-5,10,2,0,-2,0,-1,-1,-1,0,-1
KR_6703818250,420,-3,-8,-31,-1,-3,3,0,1,2,3,0,1,1,1,3,4,0,2,2,-1,5,-42,3,-5,2,0,0,-1,1,-1,-1,-1,1,-1
KR_6742314715,420,-4,-54,-31,-5,-4,4,0,0,0,0,0,2,2,-2,7,5,1,1,2,1,-3,1,4,-5,1,5,0,1,-1,-1,-1,1,1,-1
KR_6771868200,440,-3,-60,-2,-8,-4,6,2,-5,6,1,2,0,2,5,0,5,-6,10,4,0,-17,-6,-4,-3,7,4,0,0,0,1,0,-1,0,-1
KR_6775489872,420,0,35,-9,-4,-1,1,0,1,2,3,1,1,2,-5,5,0,0,0,0,0,-4,-2,4,-9,5,-3,0,0,1,1,-1,-1,6,-1
KR_6740732406,420,1,17,-24,4,2,3,5,-1,7,6,-2,4,2,4,0,4,1,0,1,0,9,-19,-3,-5,8,5,0,0,1,-1,1,1,5,-1
KR_6763703346,440,0,-6,0,3,1,6,7,-4,6,2,2,1,3,0,1,1,4,0,4,0,0,-3,-2,-2,4,5,0,1,-1,-1,-1,-1,2,-1
KR_6758820606,420,-1,-17,-24,1,0,1,1,1,2,3,1,3,4,0,3,3,-1,1,0,0,0,4,-1,-6,7,-3,0,1,-1,1,1,1,3,-1
KR_6770206635,420,-2,9,-3,2,0,1,1,5,1,6,2,5,7,-1,3,2,-4,4,0,-1,-1,-2,5,-9,4,-6,0,1,0,1,1,-1,0,-1
KR_6671415479,420,-4,-41,-20,-6,-4,4,0,-4,6,2,0,2,2,2,2,4,0,0,0,0,-10,3,1,-6,5,-3,0,-1,1,-1,-1,-1,6,-1
KR_6771467773,420,-3,-47,7,-10,-1,2,1,-5,6,1,-3,6,3,-1,2,1,0,0,0,0,-11,-2,-1,-7,8,-3,0,0,-1,1,-1,-1,3,-1
KR_6769668160,420,-2,-41,-8,-3,-2,3,1,-1,2,1,-5,7,2,4,1,5,1,2,3,0,1,-5,-2,-7,9,-4,0,-1,1,-1,1,-1,3,-1
KR_6758338709,420,0,-41,47,-2,-2,2,0,2,0,2,-2,2,0,0,1,1,0,0,0,0,2,27,-6,-3,9,-1,0,-1,1,-1,-1,-1,2,-1
KR_6776886787,420,3,-33,-9,7,3,0,3,-1,2,1,2,2,4,1,1,2,2,1,3,0,0,-49,0,-5,5,26,0,0,-1,1,1,-1,3,-1
KR_6770023394,420,0,8,-14,-4,4,1,5,-2,4,2,-1,3,2,-6,7,1,1,0,1,0,-11,-37,-4,-4,8,2,0,0,-1,1,0,-1,4,-1
KR_6749480211,420,-2,-38,-21,-9,-1,1,0,1,1,2,-6,7,1,-2,7,5,-1,2,1,-1,-7,-2,2,-10,8,-1,0,0,-1,-1,0,-1,1,-1
KR_6771667974,440,-1,-82,8,-6,-3,4,1,-2,5,3,-1,3,2,-2,6,4,2,4,6,0,-4,-12,0,-2,2,0,0,-2,0,0,-1,-1,0,-1
KR_6741973569,420,-6,-76,-8,-7,-3,5,2,-3,3,0,0,2,2,-1,2,1,0,1,1,0,-7,-24,-2,-3,5,-2,0,-2,1,-1,-1,-1,3,-1
KR_6709873954,420,-5,-28,-4,-8,-2,2,0,1,3,4,1,1,2,-6,8,2,-2,2,0,0,-11,-7,-3,-5,8,4,0,-1,-1,-1,-1,-1,4,-1
KR_6709271250,420,-3,-15,-31,-4,-2,3,1,0,3,3,-4,4,0,-2,3,1,4,1,5,0,3,-33,3,-7,4,-8,0,0,-1,-1,-1,-1,4,-1
KR_6771985728,420,-3,-113,-24,-3,0,3,3,-2,5,3,-1,4,3,-1,5,4,1,0,1,0,5,-58,2,-9,7,13,0,-3,-1,-1,-1,-1,3,-1
KR_6776987088,420,3,0,24,6,9,2,11,3,0,3,-4,4,0,-5,10,5,3,0,3,0,10,6,0,-5,5,0,0,-1,-1,1,1,-1,3,-1
KR_6694735113,420,0,-97,-25,11,1,0,1,5,1,6,1,0,1,3,4,7,1,0,1,0,17,120,1,-6,5,3,0,1,-1,-1,1,-1,2,-1
KR_6768241910,420,-4,-73,2,-8,-2,3,1,-4,4,0,2,0,2,-2,4,2,-2,2,0,0,-3,-24,-1,-5,6,-7,0,0,1,-1,-1,-1,4,-1
KR_6774213972,420,1,9,-9,3,2,2,4,1,2,3,2,2,4,-2,2,0,0,0,0,0,-5,-3,-3,-6,9,1,0,0,-1,-1,1,1,6,-1
KR_6669094663,420,-4,-89,-6,-4,-1,2,1,-4,7,3,1,1,2,1,1,2,-1,1,0,0,-2,-18,-7,-4,11,6,0,-1,1,-1,-1,-1,4,-1
KR_6770967570,420,-5,-90,-29,-8,3,0,3,-12,13,1,3,3,6,-2,4,2,0,0,0,-1,-3,-25,-1,-6,7,-5,0,-1,-1,1,-1,-1,1,-1
KR_6752802326,440,-2,12,-12,-4,-7,8,1,-2,2,0,1,3,4,2,1,3,2,0,2,0,-13,-49,6,-9,3,2,0,0,-1,1,0,1,4,-1
KR_6774447797,420,2,-40,44,0,-2,3,1,1,4,5,4,4,8,-2,6,4,-1,1,0,-1,2,4,-1,-4,5,-1,0,0,1,1,1,-1,6,-1
KR_6777342831,420,-1,1,-5,2,2,1,3,1,1,2,-5,6,1,3,1,4,1,0,1,-1,-3,-15,3,-5,2,1,0,1,-1,1,1,-1,5,-1
KR_6771629503,420,0,-24,21,-4,-2,2,0,-2,4,2,2,0,2,-1,4,3,-1,1,0,0,-10,-1,0,-5,5,2,0,0,1,1,1,-1,3,-1
KR_6777870764,420,1,1,12,1,0,1,1,-3,3,0,1,2,3,2,2,4,1,1,2,0,5,-168,-3,-6,9,6,0,-2,-1,-1,-1,-1,5,-1
KR_6775076391,420,-4,-63,0,-9,1,2,3,-3,4,1,-5,7,2,-1,4,3,-1,1,0,0,-13,-17,-3,-2,5,-1,0,0,-1,-1,-1,-1,2,-1
KR_6775674796,420,-5,-33,-8,-11,0,0,0,1,2,3,-4,7,3,-7,7,0,-1,1,0,0,-18,4,-1,-6,7,-2,0,0,-1,-1,-1,-1,5,-1
KR_6774405246,420,-1,24,-20,-5,1,1,2,-1,4,3,-2,4,2,-3,5,2,0,0,0,1,-10,12,-1,-5,6,-2,0,0,-1,1,1,1,5,-1
KR_6734985120,420,3,-45,27,4,0,2,2,-1,2,1,1,1,2,2,2,4,2,1,3,0,2,15,-2,-2,4,3,0,0,1,0,0,-1,6,-1
KR_6760992784,420,0,34,4,-3,0,2,2,-3,8,5,2,1,3,-2,7,5,0,2,2,0,-4,-20,-3,-2,5,6,0,0,1,-1,0,1,3,-1
KR_6747690570,420,-2,-28,-22,-5,-3,4,1,0,4,4,3,2,5,-4,7,3,-1,1,0,0,-4,3,1,-8,7,1,0,-1,1,-1,-1,1,4,-1
KR_6762866212,420,0,-6,-22,-3,0,3,3,-1,5,4,3,2,5,-3,3,0,-2,3,1,-1,-3,1,0,-7,7,-1,0,0,1,1,1,-1,1,-1
KR_6762392838,420,1,-28,16,-4,0,3,3,-4,8,4,-1,1,0,0,4,4,1,0,1,-1,-12,-4,-4,-6,10,5,0,0,1,-1,0,-1,2,-1
KR_6753354276,420,-3,-9,-29,-4,0,3,3,-4,6,2,0,2,2,2,2,4,-2,2,0,0,-6,-18,-4,-4,8,0,0,0,-1,-1,-1,1,6,-1
KR_6775976826,420,1,-53,-3,6,4,0,4,-1,3,2,2,1,3,2,4,6,-1,2,1,0,10,36,2,-7,5,-2,0,-1,-1,1,-1,-1,4,-1
KR_6755564982,420,-3,-56,-23,-3,-1,2,1,-7,7,0,1,0,1,4,1,5,0,0,0,0,-6,-4,-2,-5,7,1,0,0,-1,-1,0,1,3,-1
KR_6766793273,420,-1,1,-16,-10,-8,8,0,-5,7,2,2,2,4,-2,7,5,3,0,3,0,-13,1,0,-6,6,2,0,-1,1,1,1,1,4,-1
KR_6761961434,440,0,-15,31,-4,2,3,5,-2,4,2,-5,9,4,4,3,7,-3,3,0,-1,-1,3,-4,-1,5,5,0,1,1,-1,1,-1,5,-1
KR_6769406700,420,-1,-39,-13,-10,3,1,4,0,1,1,-9,10,1,-2,2,0,-2,2,0,-1,-25,-51,3,-6,3,14,0,-3,-1,-1,-1,-1,1,-1
KR_6761666906,420,-2,-79,4,-9,1,0,1,-3,4,1,-1,2,1,-6,9,3,0,0,0,1,-5,-6,-2,-5,7,-4,0,-1,-1,1,-1,1,5,-1
KR_6773208013,420,2,18,34,1,6,0,6,-4,4,0,-2,5,3,1,5,6,0,3,3,0,-7,-1,-3,-6,9,-1,0,-1,1,-1,-1,1,2,-1
KR_6763399985,420,1,51,1,-1,0,1,1,2,1,3,-2,3,1,-2,3,1,1,0,1,0,-2,-3,6,-9,3,0,0,0,-1,1,1,1,5,-1
KR_6765722939,420,-3,-33,-27,-2,-2,5,3,-2,3,1,1,1,2,2,0,2,-1,2,1,0,-1,1,1,-7,6,1,0,0,0,1,-1,1,0,-1
KR_6769137272,420,1,24,-6,5,0,3,3,-3,8,5,0,4,4,5,1,6,3,6,9,1,-9,5,-5,-7,12,3,0,0,-1,-1,0,1,1,-1
KR_6767552801,420,-2,-27,14,-7,-2,2,0,-1,1,0,1,3,4,-4,4,0,-1,1,0,0,-10,-13,2,-10,8,-1,0,0,-1,1,0,-1,6,-1
KR_6774853456,420,-3,-30,24,-14,-9,10,1,-1,5,4,-4,5,1,3,0,3,-3,3,0,0,-2,6,2,-5,3,-7,0,-2,1,-1,-1,-1,3,-1
KR_6776154069,440,3,39,8,0,-3,6,3,0,2,2,2,2,4,-2,4,2,3,3,6,1,-2,-13,-4,-4,8,11,0,-1,-1,-1,-1,1,5,-1
KR_6763253342,420,-5,-68,-23,-9,-5,7,2,-3,4,1,-3,3,0,1,0,1,1,1,2,0,-5,9,0,-5,5,-5,0,-1,1,-1,-1,-1,1,-1
KR_6776771174,420,0,-35,45,7,1,0,1,3,2,5,-1,3,2,3,4,7,1,1,2,0,7,-4,3,-9,6,-4,0,-1,1,1,-1,1,4,-1
KR_6773956077,420,2,28,12,4,-1,2,1,2,0,2,3,1,4,-1,1,0,1,0,1,0,2,4,-1,-5,6,1,0,0,1,-1,0,1,4,-1
KR_6777341951,420,-5,-93,-31,-13,-2,2,0,1,2,3,-2,3,1,-6,6,0,-4,5,1,0,-10,4,3,-7,4,-6,0,-1,-1,1,-1,-1,1,-1
KR_6777527842,440,-2,-42,-8,-6,-5,5,0,1,2,3,1,0,1,-2,3,1,-1,1,0,0,-6,-1,1,-9,8,0,0,0,-1,1,0,-1,6,-1
KR_6762045610,420,-1,54,-16,0,-1,2,1,-2,4,2,10,1,11,-6,8,2,-1,2,1,-4,-18,-6,4,-7,3,0,0,1,1,-1,1,-1,4,-1
KR_6768310784,440,1,80,38,1,1,3,4,2,1,3,1,4,5,-4,4,0,1,2,3,1,-3,-7,1,-6,5,3,0,1,1,-1,1,1,6,-1
KR_6772582487,420,-1,1,4,-14,0,2,2,2,0,2,-9,11,2,-8,9,1,1,0,1,-1,-24,-83,0,-7,7,1,0,-2,-1,1,-1,-1,5,-1
KR_6768808104,420,-3,-35,-7,-11,1,0,1,-4,6,2,-2,3,1,-6,7,1,0,1,1,0,-19,1,-2,-5,7,-8,0,-1,-1,-1,-1,-1,1,-1
KR_6775913006,440,0,-47,20,-4,-3,4,1,-2,3,1,1,2,3,-5,5,0,5,2,7,-1,-11,3,0,-6,6,1,0,-1,-1,1,-1,-1,6,-1
KR_6711548516,420,0,-29,-4,0,-1,2,1,-3,3,0,-2,2,0,1,1,2,5,0,5,0,-1,17,0,-4,4,0,0,0,-1,1,0,1,4,-1
KR_6775022044,420,0,43,-9,3,1,2,3,-2,4,2,0,1,1,4,3,7,0,0,0,1,7,-4,5,-6,1,2,0,0,1,1,-1,1,1,-1
KR_6758025199,420,3,0,5,5,2,0,2,-2,3,1,3,2,5,2,1,3,0,1,1,0,9,1,2,-9,7,4,0,1,1,1,1,-1,4,-1
KR_6776896681,420,-1,-79,-25,0,-3,4,1,4,4,8,0,4,4,-1,4,3,0,2,2,1,8,9,3,-9,6,-5,0,-2,-1,-1,-1,1,5,-1
KR_6777458143,420,-1,25,-13,-4,4,0,4,-5,5,0,1,1,2,-4,5,1,0,1,1,0,-9,-12,-1,-6,7,-2,0,-1,-1,-1,-1,1,5,-1
KR_6743580705,420,3,4,6,1,0,1,1,-1,1,0,1,2,3,1,2,3,0,0,0,0,1,-11,0,-5,5,3,0,-1,-1,-1,-1,-1,4,-1
KR_6762377378,420,2,25,-32,1,0,1,1,0,3,3,-1,1,0,3,2,5,-1,1,0,0,4,1,-1,-6,7,5,0,0,-1,1,0,1,5,-1
KR_6777332158,420,-2,-34,-31,0,-1,3,2,1,3,4,0,3,3,1,2,3,-1,2,1,0,5,-33,-8,-3,11,5,0,-1,1,-1,-1,-1,2,-1
KR_6715001065,420,-5,-63,-28,-8,-3,3,0,0,0,0,-2,6,4,-1,2,1,-2,3,1,0,-7,0,2,-6,4,-6,0,-3,-1,-1,-1,-1,5,-1
KR_6761767233,420,-3,13,23,-5,-2,4,2,0,1,1,-1,5,4,-2,2,0,0,0,0,0,-18,-13,-3,-6,9,1,0,0,-1,1,-1,-1,4,-1
KR_6743731412,420,3,-1,11,2,-3,4,1,4,2,6,-1,2,1,0,5,5,2,1,3,3,3,29,4,-9,5,-2,0,0,-1,1,0,1,1,-1
KR_6770699041,420,0,-28,-1,-3,-2,2,0,1,3,4,0,3,3,-3,3,0,1,1,2,0,1,-112,1,-3,2,1,0,-1,-1,1,-1,-1,5,-1
KR_6774080293,420,5,64,39,2,5,0,5,-6,7,1,4,2,6,-2,4,2,1,1,2,-1,-9,-7,-9,-3,12,4,0,1,-1,1,1,-1,1,-1
KR_6713272729,420,-1,1,1,-4,-8,8,0,3,3,6,-1,3,2,2,2,4,0,0,0,0,3,8,-3,-3,6,1,0,-1,1,-1,-1,-1,4,-1
KR_6742445089,440,-2,-34,-30,-7,2,1,3,-1,4,3,1,1,2,-9,11,2,0,1,1,-1,-5,10,3,-6,3,-1,0,-2,0,0,-1,-1,0,-1
KR_6775579611,420,-2,31,-21,-3,2,0,2,-5,6,1,-1,1,0,4,0,4,-3,3,0,1,-5,-18,-1,-3,4,1,0,-1,-1,-1,-1,1,1,-1
KR_6764180224,420,-3,11,-28,-5,0,1,1,-1,2,1,2,0,2,-6,9,3,0,1,1,-2,-7,4,-2,-6,8,-7,0,-1,-1,-1,-1,-1,2,-1
KR_6748642954,420,2,34,12,5,2,3,5,0,2,2,2,2,4,0,4,4,1,1,2,0,1,-8,5,-8,3,6,0,2,1,1,1,-1,2,-1
KR_6755831559,420,-2,-25,-13,3,-2,3,1,1,1,2,-1,2,1,1,2,3,4,0,4,0,11,6,-1,-4,5,1,0,1,1,1,1,1,4,-1
KR_6766037060,420,-2,8,4,-8,2,0,2,-2,2,0,0,3,3,-6,6,0,-2,2,0,0,-17,-10,1,-6,5,-2,0,-1,-1,-1,-1,1,3,-1
KR_6775219232,420,1,-3,16,-13,3,0,3,-5,5,0,-5,6,1,0,2,2,-6,8,2,-1,-9,16,-1,-6,7,-6,0,0,-1,-1,0,-1,5,-1
KR_6775905877,420,-4,-14,-24,-7,3,0,3,-2,3,1,-8,8,0,1,3,4,-1,2,1,0,-12,-33,-6,-3,9,-1,0,-1,-1,-1,-1,-1,3,-1
KR_6734913981,420,-2,36,-7,-6,0,0,0,0,2,2,-1,1,0,-3,3,0,-2,2,0,0,-5,6,0,-6,6,0,0,-1,-1,1,-1,-1,3,-1
KR_6754239434,420,-2,-1,-16,0,-3,9,6,0,2,2,1,2,3,3,1,4,-1,2,1,1,-1,6,3,-7,4,0,0,1,-1,-1,1,1,6,-1
KR_6776543583,420,-1,-7,-37,-1,-1,3,2,-1,2,1,4,3,7,-4,4,0,1,0,1,-2,-1,-149,0,-5,5,2,0,-1,1,1,-1,-1,3,-1
KR_6734293371,420,-5,-19,-22,0,0,2,2,0,2,2,-1,4,3,-1,3,2,2,1,3,1,0,48,3,-8,5,-30,0,-1,-1,-1,-1,1,5,-1
KR_6766740312,420,-3,-32,-7,-6,-4,4,0,-2,2,0,-3,4,1,3,3,6,0,0,0,0,-4,-5,-2,-7,9,2,0,-1,-1,-1,-1,-1,3,-1
KR_6776810559,420,1,63,3,-2,1,1,2,-3,5,2,1,3,4,-3,3,0,2,0,2,-1,-13,-57,0,-4,4,0,0,-1,1,-1,1,-1,4,-1
KR_6639516214,420,-3,-21,12,0,-2,2,0,2,0,2,0,1,1,0,1,1,0,1,1,0,1,-9,1,-6,5,2,0,0,1,1,-1,1,2,-1
KR_6777294113,420,1,15,7,1,-4,5,1,2,2,4,2,3,5,2,2,4,-1,2,1,0,6,30,0,-6,6,0,0,0,-1,1,0,-1,4,-1
KR_6774077271,420,-7,-97,-12,-17,-4,6,2,0,1,1,-4,5,1,-8,8,0,-1,1,0,0,-13,42,5,-10,5,-4,0,-1,-1,1,-1,-1,2,-1
KR_6765750184,420,-4,-33,4,-8,-4,6,2,0,4,4,-1,1,0,-4,5,1,1,0,1,0,-2,40,0,-6,6,-10,0,-2,-1,-1,-1,-1,4,-1
KR_6777841313,420,-2,-10,-10,-4,3,0,3,1,2,3,-5,7,2,-3,5,2,0,1,1,0,-5,8,1,-6,5,-4,0,0,1,1,-1,1,4,-1
KR_6766131253,420,2,-37,8,-4,-1,3,2,-1,3,2,2,1,3,-3,3,0,-1,1,0,0,-9,34,5,-11,6,-3,0,-2,1,-1,-1,-1,2,-1
KR_6771723846,420,-3,-52,0,-4,-6,6,0,0,3,3,2,1,3,-1,2,1,1,0,1,0,-2,5,0,-3,3,-2,0,-1,-1,1,-1,-1,4,-1
KR_6769832512,420,-5,-20,8,-16,-9,9,0,1,3,4,-5,5,0,1,2,3,-4,5,1,0,-6,-3,-1,-5,6,-1,0,0,1,1,-1,-1,3,-1
KR_6777520134,420,-2,54,-24,-6,1,0,1,2,1,3,-5,5,0,0,1,1,-4,6,2,1,-7,8,4,-9,5,0,0,0,-1,-1,0,1,2,-1
KR_6776940276,420,-1,2,-45,-1,-2,2,0,0,2,2,-1,2,1,2,2,4,0,0,0,0,5,44,4,-8,4,-32,0,0,1,-1,0,1,2,-1
KR_6776120305,420,3,-16,2,1,0,2,2,2,0,2,2,0,2,-3,4,1,0,0,0,0,0,-9,-3,-5,8,4,0,0,-1,1,0,-1,2,-1
KR_6739051631,420,-1,-21,-38,0,-2,2,0,3,2,5,-4,5,1,5,2,7,-2,2,0,-1,9,-6,0,-6,6,-1,0,-1,0,-1,-1,-1,0,-1
KR_6775953240,420,-1,-86,3,-1,-2,3,1,1,0,1,-5,5,0,5,3,8,0,0,0,0,6,-42,0,-7,7,19,0,-3,-1,-1,-1,-1,2,-1
KR_6776639134,420,-5,-7,-38,-7,-5,5,0,0,6,6,-2,2,0,0,4,4,0,0,0,0,-2,21,2,-9,7,1,0,-1,-1,-1,-1,-1,1,-1
KR_6741809541,440,0,36,28,3,0,1,1,-2,3,1,8,0,8,1,1,2,-4,7,3,0,0,19,-1,-4,5,-1,0,0,0,0,0,-1,0,-1
KR_6769986595,420,-7,-61,-23,-18,-2,3,1,-3,3,0,-7,8,1,-4,5,1,-2,2,0,-1,-16,-24,2,-5,3,-4,0,-1,-1,-1,-1,-1,3,-1
KR_6776840560,420,-4,29,-21,-6,-2,2,0,-1,2,1,-1,3,2,-3,3,0,1,0,1,0,-8,-5,0,-5,5,6,0,-1,-1,-1,-1,-1,3,-1
KR_6775251022,420,-4,-60,-17,-3,-2,3,1,-4,7,3,3,1,4,2,3,5,-2,2,0,0,-3,-3,-2,-7,9,-3,0,-2,-1,-1,-1,-1,3,-1
KR_6773873815,420,-5,-66,-20,-4,0,2,2,-2,3,1,2,4,6,-3,4,1,-1,1,0,0,-4,5,-4,-3,7,-3,0,-1,-1,1,-1,1,6,-1
KR_6736658666,420,2,37,-12,7,2,0,2,-1,4,3,1,1,2,6,1,7,-1,1,0,0,9,-31,-4,-6,10,8,0,1,-1,-1,1,-1,3,-1
KR_6774507239,420,-4,-28,10,-9,1,1,2,1,1,2,-8,8,0,-5,5,0,2,0,2,-1,-7,-6,-7,0,7,3,0,-2,1,-1,-1,-1,6,-1
KR_6773552533,420,-2,-54,42,-8,-4,5,1,1,2,3,0,2,2,-4,5,1,-1,1,0,0,-7,3,-3,-4,7,-8,0,0,1,-1,-1,-1,3,-1
KR_6773019712,420,-1,-26,-4,-6,-2,3,1,-2,4,2,6,1,7,-8,10,2,0,0,0,0,-3,-3,-3,-4,7,4,0,0,1,-1,1,1,1,-1
KR_6744172171,420,0,78,28,-7,2,1,3,0,5,5,-4,6,2,-4,6,2,-1,1,0,0,-6,-1,-2,-4,6,9,0,3,-1,1,1,-1,5,-1
KR_6775364066,420,2,0,-8,8,1,1,2,1,4,5,1,4,5,3,0,3,2,0,2,0,10,-54,-2,-7,9,35,0,0,-1,1,0,1,1,-1
KR_6772384689,420,0,58,11,1,2,0,2,2,2,4,1,2,3,-3,3,0,-1,1,0,0,0,13,-1,-4,5,0,0,0,1,-1,0,-1,1,-1
KR_6775408231,420,1,-19,15,-2,-2,4,2,4,1,5,1,0,1,-5,6,1,0,1,1,2,5,18,5,-10,5,-1,0,-1,1,-1,-1,1,2,-1
KR_6776831771,420,1,-1,20,-2,0,3,3,-5,6,1,3,1,4,0,3,3,0,1,1,0,-4,-5,-2,-6,8,-3,0,1,1,-1,1,1,3,-1
KR_6732899457,420,-8,-112,-41,-25,-7,7,0,-9,9,0,-6,7,1,-2,5,3,-1,2,1,-2,-31,-9,-6,-2,8,-1,0,-3,1,1,-1,-1,4,-1
KR_6776156031,420,-3,-6,-3,-8,1,1,2,-3,3,0,-1,5,4,-7,7,0,2,0,2,0,-11,0,-2,-3,5,-3,0,-2,-1,-1,-1,-1,3,-1
KR_6775713212,420,1,4,-12,6,0,2,2,-2,5,3,1,3,4,1,2,3,6,0,6,1,12,40,1,-5,4,2,0,0,1,-1,-1,1,4,-1
KR_6755031650,420,-6,-66,-42,-9,0,3,3,-6,7,1,2,0,2,-2,4,2,-3,3,0,-1,-11,-64,-5,-6,11,32,0,-1,1,-1,-1,-1,4,-1
KR_6741665075,420,-3,-67,-12,1,-3,3,0,2,6,8,2,3,5,-1,3,2,1,0,1,0,1,4,0,-4,4,-2,0,-1,1,-1,-1,1,6,-1
KR_6776531579,420,2,23,4,6,1,1,2,-1,3,2,3,0,3,3,1,4,0,1,1,0,9,-3,-11,-4,15,-2,0,0,-1,-1,0,-1,6,-1
KR_6774353120,420,0,10,39,-3,0,1,1,1,2,3,1,2,3,-6,6,0,1,0,1,0,-1,47,8,-12,4,0,0,-1,-1,1,-1,-1,3,-1
KR_6777179654,420,-3,-29,-7,-5,-5,6,1,0,4,4,-1,2,1,1,5,6,0,1,1,0,-7,-18,-5,-4,9,1,0,-2,-1,1,-1,-1,5,-1
KR_6772080195,420,-4,-42,11,-4,1,2,3,-3,5,2,-1,4,3,-1,3,2,0,0,0,0,-7,3,-5,-2,7,0,0,0,-1,1,1,-1,1,-1
KR_6777611067,440,-1,7,-5,-10,2,1,3,-4,5,1,-4,4,0,-4,4,0,0,1,1,0,-13,0,4,-9,5,-4,0,0,-1,-1,0,-1,1,-1
KR_6756817300,420,5,67,-18,8,4,0,4,3,1,4,2,2,4,0,2,2,-1,2,1,0,12,-24,0,-5,5,7,0,0,-1,-1,1,1,3,-1
KR_6741880413,440,0,-51,-22,-2,1,0,1,-1,2,1,1,3,4,-2,4,2,-1,1,0,0,1,16,-2,-5,7,-19,0,0,-1,1,0,1,1,-1
KR_6771371189,440,3,29,20,6,2,0,2,2,1,3,-1,4,3,3,5,8,0,0,0,0,10,2,2,-6,4,2,0,1,-1,1,1,1,2,-1
KR_6730222555,420,-4,-20,-12,-7,-5,5,0,-2,4,2,4,1,5,-3,4,1,-1,2,1,0,-1,22,-4,-5,9,5,0,-2,-1,1,-1,1,1,-1
KR_6776924048,420,-2,-78,5,-7,-4,7,3,7,0,7,-2,2,0,-5,7,2,-3,4,1,-1,-9,5,-2,-5,7,-1,0,-2,1,-1,-1,-1,3,-1
KR_6748297205,420,0,-4,42,-4,1,2,3,1,1,2,-2,5,3,-3,3,0,-1,1,0,-1,-6,4,1,-6,5,-1,0,1,1,-1,1,-1,4,-1
KR_6748191699,440,-3,-10,12,-8,-1,3,2,-3,3,0,-4,5,1,1,0,1,-1,2,1,0,-10,-4,-1,-4,5,-1,0,-1,1,1,-1,-1,6,-1
KR_6775971454,420,0,-14,0,-1,-1,1,0,4,1,5,-1,3,2,-4,5,1,1,1,2,0,2,-30,-5,-5,10,3,0,0,1,1,0,-1,4,-1
KR_6775434209,420,-1,16,16,-5,0,0,0,0,1,1,-1,2,1,-3,6,3,-1,2,1,0,-9,-18,-8,-3,11,5,0,0,-1,-1,0,1,4,-1
KR_6775042423,420,-1,-26,1,3,0,2,2,-1,3,2,0,3,3,3,1,4,1,0,1,-1,6,-1,5,-8,3,-2,0,0,1,1,0,-1,1,-1
KR_6707976244,420,0,-60,-40,10,6,0,6,-3,6,3,1,2,3,3,0,3,3,0,3,0,9,292,3,-6,3,8,0,0,1,1,0,1,5,-1
KR_6717335324,420,-4,20,-3,-4,1,1,2,0,0,0,-4,4,0,-1,4,3,0,0,0,0,-6,-10,1,-5,4,4,0,0,-1,1,-1,1,2,-1
KR_6732015168,420,2,-4,-37,9,6,2,8,5,0,5,4,1,5,-5,9,4,-1,1,0,3,14,-2,-1,-7,8,1,0,1,-1,1,-1,1,5,-1
KR_6772359773,420,-1,-13,2,0,1,0,1,2,2,4,-4,6,2,0,1,1,1,1,2,0,0,-7,-1,-3,4,7,0,-1,-1,-1,-1,1,2,-1
KR_6729687644,420,0,59,-19,-4,4,1,5,-2,6,4,-2,3,1,-8,8,0,4,2,6,0,-7,-24,0,-7,7,-1,0,-1,-1,1,-1,1,5,-1
KR_6772232063,420,4,56,21,0,-2,6,4,-2,8,6,6,1,7,2,2,4,-4,4,0,-1,-1,15,2,-7,5,0,0,1,1,-1,1,-1,3,-1
KR_6774033751,440,-2,1,11,-6,0,0,0,-3,3,0,1,1,2,-5,6,1,1,2,3,0,-3,2,0,-6,6,-4,0,1,1,-1,1,-1,4,-1
KR_6763135843,420,1,43,9,6,-1,1,0,4,2,6,-3,4,1,5,1,6,1,0,1,0,9,2,2,-5,3,-1,0,1,1,1,1,-1,2,-1
KR_6770232816,420,0,16,-6,-8,-5,6,1,-6,6,0,1,2,3,0,0,0,2,0,2,0,-17,-6,-3,-5,8,4,0,1,0,1,1,-1,0,-1
KR_6774104519,420,-5,-49,-21,-6,4,0,4,-3,6,3,-3,5,2,0,3,3,-4,9,5,0,-4,-7,3,-11,8,-3,0,0,-1,-1,-1,-1,3,-1
KR_6774543768,420,-4,-27,0,-5,-2,4,2,2,1,3,-4,5,1,-1,2,1,0,0,0,0,-1,65,5,-6,1,-4,0,-1,-1,1,-1,-1,3,-1
KR_6765891534,420,-2,-5,16,-7,0,1,1,-4,6,2,-1,5,4,-2,2,0,0,1,1,1,-5,7,-3,-4,7,-6,0,0,-1,-1,0,1,1,-1
KR_6777515911,440,1,57,18,4,2,1,3,0,2,2,-4,9,5,3,1,4,3,2,5,1,6,-4,-7,-4,11,2,0,0,1,-1,0,1,1,-1
KR_6775173761,420,0,21,3,0,3,0,3,-2,3,1,0,1,1,-1,4,3,0,4,4,0,-4,4,-1,-7,8,2,0,0,1,1,0,1,4,-1
KR_6769938117,420,0,7,-4,-6,2,1,3,-2,3,1,-1,3,2,-5,8,3,0,0,0,0,-9,6,-4,-4,8,-2,0,0,-1,-1,0,-1,1,-1
KR_6773615329,420,-3,-44,-13,-1,0,2,2,6,1,7,-3,5,2,-2,3,1,-2,4,2,0,-5,-1,-1,-8,9,0,0,-1,-1,1,-1,-1,3,-1
KR_6772980038,420,-2,-12,-4,-1,-2,2,0,-3,3,0,3,1,4,1,1,2,0,0,0,0,-2,1,0,-7,7,-1,0,0,1,-1,0,1,2,-1
KR_6773924228,440,4,29,2,16,5,0,5,5,0,5,0,3,3,3,0,3,3,1,4,0,13,35,2,-4,2,-2,0,3,-1,1,1,1,3,-1
KR_6741741010,440,0,83,12,-4,0,1,1,-1,5,4,1,1,2,-2,4,2,-2,4,2,0,-11,-1,-3,-6,9,5,0,2,-1,1,1,1,6,-1
KR_6774589248,420,-4,-65,-28,-13,-5,5,0,-3,3,0,-1,3,2,-1,4,3,-3,3,0,0,-11,42,-3,-5,8,-2,0,-1,-1,1,-1,-1,5,-1
KR_6738832724,420,-6,-75,-45,-13,0,2,2,-4,4,0,-5,5,0,-3,4,1,-1,1,0,-1,-19,-29,-3,-2,5,18,0,-2,-1,-1,-1,-1,4,-1
KR_6747502794,420,2,-3,-10,13,4,0,4,4,2,6,0,1,1,4,2,6,1,1,2,0,12,13,2,-10,8,-2,0,1,0,1,1,1,0,-1
KR_6758323154,420,-2,12,2,-8,-3,5,2,-4,6,2,0,1,1,-1,4,3,0,2,2,-1,-14,-6,-6,-4,10,1,0,-1,-1,-1,-1,-1,2,-1
KR_6737792903,420,-1,-17,-3,-3,4,1,5,-4,5,1,-1,3,2,-2,2,0,0,0,0,0,-4,-301,0,-8,8,0,0,0,-1,-1,-1,-1,1,-1
KR_6728194176,440,-1,-79,21,-5,0,2,2,-6,6,0,2,0,2,-1,2,1,0,3,3,0,-4,32,3,-7,4,-3,0,-2,1,-1,-1,-1,1,-1
KR_6776769365,420,0,-35,13,0,-3,5,2,4,3,7,3,1,4,-5,8,3,1,0,1,0,-11,4,4,-11,7,-2,0,-1,-1,1,-1,-1,3,-1
KR_6763935332,420,1,18,3,-3,-3,4,1,4,2,6,-4,5,1,1,3,4,-1,1,0,-2,2,-9,-6,-3,9,7,0,-1,-1,-1,-1,-1,3,-1
KR_6764168751,420,-2,-61,8,-7,-2,3,1,-5,7,2,-1,3,2,-1,2,1,2,0,2,0,-8,45,5,-7,2,-12,0,-1,1,-1,-1,-1,5,-1
KR_6777421592,420,-6,-26,-19,-11,-4,4,0,-5,9,4,0,2,2,-1,4,3,-1,1,0,0,-15,-4,-3,-1,4,0,0,-2,-1,-1,-1,-1,4,-1
KR_6773757846,420,-3,29,-54,-4,0,1,1,-4,5,1,-1,3,2,2,2,4,-1,1,0,0,-7,-34,-2,-5,7,-2,0,-2,-1,-1,-1,-1,1,-1
KR_6775062326,420,1,25,-16,0,0,2,2,-2,3,1,-4,5,1,3,4,7,3,0,3,0,-4,5,3,-12,9,-5,0,-1,1,-1,1,1,4,-1
KR_6754460913,420,-4,-50,-24,-4,1,3,4,-2,5,3,-3,5,2,1,3,4,-1,2,1,2,5,8,5,-8,3,-4,0,0,-1,1,0,-1,4,-1
KR_6776562309,420,-4,9,-20,-1,4,0,4,-1,3,2,-3,9,6,1,3,4,-2,2,0,0,-3,-5,-1,-5,6,2,0,-1,1,-1,-1,-1,2,-1
KR_6777527708,420,-2,10,24,-10,0,1,1,1,0,1,-3,4,1,-6,8,2,-2,3,1,0,-18,-3,-1,-7,8,-1,0,0,-1,1,-1,-1,1,-1
KR_6775097861,420,1,16,-2,1,-2,2,0,1,3,4,1,0,1,1,0,1,0,0,0,0,4,2,-1,-5,6,1,0,0,1,-1,0,-1,5,-1
KR_6774306387,420,-2,-21,3,-5,3,0,3,2,2,4,-4,4,0,-6,6,0,0,2,2,0,-6,-9,-3,-6,9,-3,0,-1,-1,1,-1,-1,4,-1
KR_6769449231,420,-1,33,1,-2,-1,1,0,-3,4,1,1,2,3,0,3,3,1,1,2,0,-4,10,4,-5,1,-2,0,0,1,-1,1,1,4,-1
KR_6750535302,420,-3,-85,0,-1,0,1,1,6,0,6,1,2,3,-5,6,1,-3,4,1,0,6,-4,2,-7,5,-3,0,-3,-1,-1,-1,1,5,-1
KR_6729434984,420,-3,-53,1,-8,0,2,2,-2,4,2,-3,4,1,-2,3,1,-1,1,0,0,-7,-6,-2,-4,6,-1,0,-1,1,-1,-1,-1,3,-1
KR_6676282782,420,-3,-10,7,-7,-5,5,0,2,2,4,-1,4,3,-1,3,2,-2,3,1,0,-6,-11,0,-4,4,3,0,-2,-1,1,-1,1,3,-1
KR_6769932977,440,0,-63,-10,2,5,4,9,-1,1,0,-2,3,1,3,2,5,-3,5,2,0,3,-2,0,-3,3,-1,0,0,0,1,1,-1,0,-1
KR_6752706309,420,-4,-53,9,-20,-6,6,0,-2,2,0,-5,7,2,-3,4,1,-4,5,1,-1,-14,11,-13,-1,14,-1,0,-1,-1,-1,-1,-1,2,-1
KR_6734021375,420,-3,3,-13,-6,-1,3,2,0,1,1,-3,3,0,-2,2,0,0,0,0,0,-1,8,1,-6,5,0,0,0,1,-1,0,-1,3,-1
KR_6748134586,420,0,23,-19,-5,-2,3,1,-2,3,1,-1,2,1,0,3,3,0,0,0,-1,0,-3,1,-9,8,-1,0,0,-1,-1,0,-1,6,-1
KR_6765227781,420,-1,32,4,-4,0,0,0,-3,4,1,2,1,3,-1,3,2,-2,3,1,0,-5,-104,0,-4,4,2,0,0,-1,-1,0,1,3,-1
KR_6766066903,420,-3,-55,-4,-4,-2,5,3,-3,4,1,2,2,4,-2,5,3,1,0,1,2,2,4,6,-12,6,-11,0,0,-1,-1,-1,1,3,-1
KR_6774051912,420,-1,1,1,-9,2,2,4,-3,4,1,-1,2,1,-5,8,3,-2,2,0,0,-16,-3,0,-3,3,1,0,0,-1,-1,1,-1,2,-1
KR_6768058517,420,-2,-6,23,-5,0,2,2,1,0,1,0,2,2,-6,7,1,0,1,1,0,-10,-3,-2,-5,7,3,0,0,-1,1,0,-1,1,-1
KR_6764599173,440,1,50,12,2,0,1,1,-2,5,3,1,2,3,3,3,6,0,0,0,1,-4,4,0,-3,3,-3,0,1,-1,1,1,1,5,-1
KR_6747665361,420,-2,-44,-24,-5,-5,5,0,1,3,4,-3,8,5,-2,4,2,4,2,6,0,-4,-8,-11,-1,12,8,0,0,-1,1,-1,1,5,-1
KR_6737163783,440,-1,-18,4,-2,-5,5,0,0,4,4,4,2,6,0,2,2,-1,1,0,0,-4,34,2,-4,2,-18,0,0,-1,1,0,1,5,-1
KR_6685616795,420,-1,2,-31,-3,-1,4,3,-1,3,2,1,0,1,0,3,3,-2,2,0,0,-2,-9,-4,-5,9,4,0,-2,-1,-1,-1,1,6,-1
KR_6747971417,420,-2,27,-1,-2,0,0,0,2,4,6,-2,6,4,0,2,2,-2,2,0,0,-6,-18,3,-6,3,0,0,0,-1,0,0,-1,3,-1
KR_6767621899,420,-1,-1,9,-2,0,1,1,-2,9,7,1,3,4,1,4,5,-2,2,0,0,-4,-10,5,-11,6,-6,0,0,1,-1,-1,-1,1,-1
KR_6767224628,420,-1,30,-6,-12,-1,3,2,-1,2,1,1,1,2,-6,7,1,-5,5,0,0,-11,-8,-7,-3,10,-4,0,0,1,-1,-1,-1,2,-1
KR_6761763169,440,-6,-88,-46,-10,2,1,3,-3,4,1,-4,6,2,-5,8,3,0,0,0,-2,-13,-2,-5,-4,9,-5,0,-1,-1,-1,-1,-1,6,-1
KR_6776013964,420,0,41,-49,7,4,0,4,-1,3,2,5,0,5,-4,5,1,3,0,3,0,1,7,5,-9,4,-1,0,1,1,1,1,1,5,-1
KR_6758729672,440,-3,-69,-2,-4,-1,2,1,0,2,2,-5,5,0,3,1,4,-1,2,1,0,-6,-137,4,-6,2,-7,0,-4,-1,1,-1,1,5,-1
KR_6743845197,420,-1,-5,28,-5,-1,1,0,-1,3,2,-4,5,1,2,0,2,-1,1,0,-1,-7,-11,-3,-6,9,5,0,-1,0,1,-1,-1,0,-1
KR_6769013433,420,2,-59,-6,4,-2,4,2,6,3,9,3,2,5,-2,2,0,-1,1,0,0,7,-1,-1,-4,5,-1,0,0,1,-1,-1,1,6,-1
KR_6756372120,420,-4,-74,-20,-4,-1,2,1,-3,4,1,-1,1,0,-2,3,1,3,1,4,0,-2,-23,-6,-5,11,4,0,-1,1,-1,-1,1,4,-1
KR_6726924375,440,-1,40,9,-8,-4,7,3,4,0,4,-5,10,5,-6,9,3,3,1,4,0,-15,-18,-2,-2,4,0,0,1,-1,-1,1,1,1,-1
KR_6773922681,420,-3,-24,-27,-6,-3,3,0,-3,4,1,-7,10,3,9,4,13,-2,3,1,0,0,-3,1,-6,5,1,0,0,1,-1,-1,1,5,-1
KR_6776861027,420,-3,-34,8,-14,-1,5,4,-6,8,2,-3,4,1,-2,3,1,-2,2,0,0,-15,30,-1,-5,6,3,0,-1,1,-1,-1,-1,3,-1
KR_6766108699,420,1,-38,1,8,2,0,2,5,2,7,-3,3,0,2,1,3,2,0,2,0,13,-17,-2,-5,7,0,0,0,-1,-1,0,1,3,-1
KR_6758296701,420,-5,-15,-24,-4,0,2,2,0,2,2,-1,4,3,1,1,2,-4,4,0,0,-4,10,-2,-5,7,-6,0,0,-1,1,1,1,1,-1
KR_6762330275,420,-2,-39,17,-14,-3,4,1,1,4,5,-4,5,1,-5,7,2,-3,3,0,0,-13,-10,-1,-4,5,-5,0,-2,-1,-1,-1,-1,6,-1
KR_6750056446,420,1,-34,5,0,1,1,2,-7,8,1,-2,4,2,7,3,10,1,2,3,-1,5,-225,-5,-2,7,3,0,0,-1,1,0,-1,4,-1
KR_6716088299,420,0,-10,-6,8,2,1,3,5,2,7,0,0,0,1,2,3,0,1,1,1,12,1,4,-8,4,2,0,0,0,1,0,1,0,-1
KR_6777541082,440,-2,-26,-16,-10,1,4,5,-3,5,2,-3,5,2,-4,4,0,-1,1,0,0,-14,2,-1,-5,6,-2,0,-1,-1,-1,-1,-1,2,-1
KR_6772487347,420,-2,-34,7,-5,-2,2,0,3,0,3,-3,3,0,-1,2,1,-2,3,1,0,-4,2,3,-9,6,2,0,0,-1,1,0,1,1,-1
KR_6777551587,420,-1,-37,16,-1,-1,2,1,5,3,8,0,5,5,-6,8,2,1,0,1,-1,-7,10,1,-8,7,-4,0,0,1,-1,0,-1,3,-1
KR_6777764447,420,-4,-61,11,-9,-4,4,0,-3,5,2,-1,3,2,-1,3,2,0,2,2,0,-10,-3,5,-8,3,-8,0,-1,-1,-1,-1,-1,4,-1
KR_6729647547,420,-3,-62,-28,-11,1,0,1,-8,10,2,0,2,2,-3,5,2,-1,1,0,-1,-16,-9,-1,-5,6,-1,0,-2,-1,-1,-1,-1,1,-1
KR_6777263379,420,-1,-9,-20,-2,-1,2,1,3,2,5,-3,3,0,-1,2,1,0,1,1,0,5,0,0,-8,8,-2,0,0,1,1,1,-1,6,-1
KR_6751026143,440,2,-30,-20,0,1,2,3,2,1,3,1,0,1,-4,4,0,0,1,1,0,-4,377,2,-8,6,1,0,0,0,-1,0,-1,0,-1
KR_6775539588,420,-2,-24,11,-8,1,2,3,-1,3,2,-1,2,1,-5,6,1,-2,2,0,0,-9,-6,-6,-1,7,-3,0,-1,-1,1,-1,-1,4,-1
KR_6775542484,420,0,-1,-15,1,2,1,3,1,1,2,0,2,2,-1,1,0,-1,1,0,0,3,2,2,-8,6,-3,0,-2,-1,-1,-1,1,4,-1
KR_6758640640,420,1,-3,-26,-6,-3,3,0,-1,7,6,1,5,6,-1,4,3,-2,2,0,-1,-2,32,3,-11,8,-11,0,0,-1,1,0,-1,4,-1
KR_6775497646,420,-4,-11,-36,-6,-3,4,1,-2,3,1,-4,5,1,-1,2,1,4,0,4,0,-6,16,0,-6,6,-4,0,-1,-1,-1,-1,1,1,-1
KR_6763421981,420,0,-31,-7,-7,2,2,4,0,4,4,-5,5,0,-5,6,1,1,0,1,0,-15,-7,-3,-3,6,4,0,-1,-1,-1,-1,-1,4,-1
KR_6775524075,420,-2,51,13,-10,-3,3,0,-5,5,0,-3,3,0,1,3,4,0,1,1,0,-11,-1,-3,-6,9,4,0,1,-1,1,1,-1,4,-1
KR_6775449330,420,-2,-11,0,-3,-3,5,2,3,2,5,0,2,2,0,4,4,-3,3,0,0,4,27,5,-11,6,0,0,-1,-1,-1,-1,1,5,-1
KR_6761105043,440,0,-30,-25,-1,-2,2,0,-5,6,1,-2,2,0,3,1,4,5,1,6,0,5,17,-2,-2,4,6,0,0,-1,-1,0,1,5,-1
KR_6740433481,420,0,4,-19,2,-5,5,0,1,3,4,5,2,7,1,3,4,0,0,0,0,14,4,1,-9,8,-5,0,0,0,-1,-1,-1,0,-1
KR_6773145472,420,-2,53,9,-10,-7,8,1,-1,3,2,-2,6,4,0,4,4,0,0,0,0,-22,28,-3,-8,11,8,0,0,-1,-1,1,1,3,-1
KR_6773179382,420,-2,-71,-4,-7,0,3,3,-2,5,3,-3,5,2,-2,2,0,0,1,1,0,-2,-2,1,-5,4,2,0,-1,-1,-1,-1,-1,4,-1
KR_6775136134,420,-2,-5,29,1,0,1,1,0,5,5,-1,2,1,2,6,8,0,0,0,0,-14,-4,-1,-8,9,-1,0,1,-1,1,1,-1,4,-1
KR_6777006420,420,-2,-34,9,-2,-1,2,1,3,1,4,1,3,4,-3,4,1,-2,4,2,0,2,-10,-3,-3,6,1,0,-1,0,1,-1,-1,0,-1
KR_6760261916,420,0,51,23,-4,-5,6,1,0,4,4,1,4,5,-1,6,5,1,2,3,0,-8,-3,1,-5,4,-1,0,1,1,-1,-1,-1,6,-1
KR_6742923383,420,-3,-70,-13,-10,-1,2,1,0,4,4,-5,7,2,-3,5,2,-1,1,0,0,-9,31,-5,-2,7,4,0,-1,-1,-1,-1,-1,5,-1
KR_6776248572,420,0,3,-18,-4,2,0,2,-3,3,0,1,0,1,-4,5,1,0,1,1,0,-2,-25,4,-10,6,0,0,0,-1,1,-1,-1,4,-1
KR_6759016599,420,-1,-23,14,-6,-2,2,0,-5,5,0,0,1,1,2,1,3,-1,1,0,0,-14,-9,-6,-2,8,1,0,0,-1,-1,-1,1,6,-1
KR_6764156153,420,-5,-53,24,-20,1,2,3,-8,9,1,-3,4,1,-9,9,0,-1,2,1,0,-21,-6,-3,-4,7,1,0,-3,-1,1,-1,-1,2,-1
KR_6775270415,440,-2,6,1,-3,0,0,0,1,3,4,-4,4,0,1,0,1,-1,2,1,0,-3,-9,0,-5,5,0,0,-1,0,-1,-1,1,0,-1
KR_6669288188,420,3,44,-35,14,-2,4,2,6,3,9,5,4,9,5,2,7,0,1,1,1,13,-56,3,-9,6,-1,0,2,1,1,1,1,4,-1
KR_6743350213,420,0,-59,-15,-1,0,0,0,0,3,3,-2,2,0,0,3,3,1,2,3,0,2,17,-2,-4,6,-3,0,0,-1,-1,0,-1,5,-1
KR_6757300926,420,0,29,-2,1,0,0,0,-2,4,2,0,2,2,1,4,5,2,2,4,0,3,6,0,-7,7,2,0,-1,1,-1,-1,1,1,-1
KR_6702266498,420,-4,-58,-14,-7,-1,1,0,-2,3,1,-2,3,1,-4,4,0,2,0,2,0,-5,5,-2,-9,11,-4,0,0,1,-1,-1,1,6,-1
KR_6773352615,420,0,21,10,-2,3,1,4,-2,3,1,1,1,2,-4,4,0,0,0,0,0,-16,-3,-1,-5,6,0,0,0,1,-1,0,-1,3,-1
KR_6773826673,440,3,38,5,1,5,0,5,-7,8,1,5,1,6,-2,4,2,0,0,0,-1,-6,-7,-5,-3,8,-2,0,1,-1,1,1,-1,6,-1
KR_6774119803,420,-4,-13,-9,-14,2,1,3,-1,3,2,-5,5,0,-9,9,0,-1,1,0,0,-12,-15,0,-3,3,-3,0,-1,-1,-1,-1,-1,4,-1
KR_6775150534,420,-3,-32,-4,-2,-3,3,0,2,0,2,-2,5,3,0,2,2,1,1,2,0,-5,-3,-2,-6,8,-1,0,0,-1,1,0,-1,1,-1
KR_6688609353,420,-2,26,-8,-4,-1,3,2,-7,8,1,0,0,0,3,1,4,1,0,1,0,-5,-4,-2,-6,8,1,0,-2,-1,-1,-1,1,2,-1
KR_6775383102,420,-3,-39,-8,-8,-2,2,0,-5,8,3,-2,5,3,0,4,4,1,1,2,0,-11,-27,-2,-2,4,-1,0,-1,1,-1,-1,-1,3,-1
KR_6777626187,420,3,12,16,3,6,0,6,-3,3,0,1,1,2,1,5,6,-2,2,0,0,0,6,7,-11,4,-5,0,1,-1,1,1,-1,4,-1
KR_6757092261,420,3,99,-12,11,1,1,2,7,1,8,1,0,1,3,0,3,-1,1,0,0,12,-7,0,-5,5,1,0,1,1,-1,1,1,3,-1
KR_6775351914,420,0,3,-4,4,-1,3,2,1,5,6,1,1,2,3,2,5,0,1,1,-1,4,15,-4,-3,7,2,0,2,-1,1,1,-1,2,-1
KR_6741384280,420,-1,-1,17,-6,-2,4,2,-2,6,4,-1,5,4,-2,3,1,1,1,2,-1,-3,-3,6,-7,1,5,0,-1,-1,-1,1,-1,5,-1
KR_6761461468,440,1,1,-2,0,0,2,2,0,4,4,5,0,5,-4,8,4,-1,3,2,3,-2,7,7,-11,4,-4,0,-1,1,-1,-1,1,1,-1
KR_6751117087,440,-5,-57,-51,-10,-4,4,0,-3,4,1,1,2,3,-2,2,0,-2,5,3,0,-10,6,-5,-3,8,1,0,-2,-1,-1,-1,-1,4,-1
KR_6725266965,420,-4,-3,12,0,-3,4,1,0,4,4,-2,3,1,2,3,5,3,0,3,2,9,8,5,-9,4,-5,0,0,1,1,-1,1,5,-1
KR_6756486391,420,-1,-44,-24,1,-3,3,0,3,1,4,4,3,7,-1,1,0,-2,2,0,0,-1,9,5,-8,3,1,0,1,-1,1,1,1,6,-1
KR_6739376167,420,2,31,-8,4,1,1,2,2,1,3,0,1,1,1,5,6,0,1,1,0,1,78,-3,-6,9,7,0,1,1,-1,1,1,2,-1
KR_6752196024,420,-2,-42,-11,-3,2,1,3,-2,3,1,-1,3,2,-1,1,0,-1,1,0,0,-4,29,0,-5,5,5,0,-2,-1,-1,-1,1,2,-1
KR_6768957238,420,-3,42,-40,-11,-1,1,0,-1,2,1,-4,4,0,-7,8,1,2,0,2,0,-17,-10,1,-8,7,0,0,-1,-1,-1,-1,-1,5,-1
KR_6738243442,420,-3,-89,-21,-11,3,0,3,-3,4,1,-2,3,1,-6,6,0,-3,4,1,-1,-15,101,1,-7,6,-5,0,0,-1,-1,-1,-1,4,-1
KR_6743809980,420,4,-33,-4,6,1,0,1,0,3,3,2,1,3,3,0,3,0,1,1,0,8,-2,-2,-8,10,7,0,0,-1,1,0,1,3,-1
KR_6777530637,420,3,-8,-2,3,1,3,4,7,3,10,-1,3,2,-2,6,4,-2,5,3,0,8,2,4,-7,3,-2,0,2,-1,1,-1,-1,3,-1
KR_6750612543,420,-2,-22,-32,0,5,0,5,-4,6,2,-3,3,0,1,1,2,1,0,1,-1,-5,-43,1,-7,6,-2,0,-1,-1,-1,-1,-1,4,-1
KR_6769630082,420,1,7,4,2,-1,2,1,1,3,4,-2,2,0,6,3,9,-2,4,2,2,1,2,1,-6,5,2,0,-1,1,-1,-1,1,2,-1
KR_6776393005,420,0,45,8,-4,-6,7,1,3,1,4,0,2,2,-1,3,2,0,0,0,0,-2,-40,5,-10,5,6,0,0,-1,1,1,-1,4,-1
KR_6773380758,420,0,-26,17,-7,1,2,3,0,2,2,-5,5,0,-2,4,2,-1,1,0,-1,-6,-4,-3,-2,5,-3,0,-3,-1,-1,-1,-1,1,-1
KR_6730024097,420,0,30,-20,-3,0,3,3,0,3,3,0,2,2,-1,6,5,-2,3,1,0,-5,-80,-5,-3,8,16,0,0,-1,1,0,-1,4,-1
KR_6766170588,420,-6,-101,-8,-19,0,1,1,-2,8,6,-1,2,1,-16,20,4,0,1,1,0,-24,112,1,-3,2,-3,-1,-5,1,-1,-1,1,4,-1
KR_6773218923,420,2,10,18,1,2,3,5,2,2,4,-2,5,3,-1,4,3,0,1,1,0,8,28,-2,-3,5,-3,0,0,1,1,-1,-1,4,-1
KR_6777304177,420,-5,-97,0,-10,-2,3,1,0,2,2,-7,9,2,-1,5,4,0,0,0,0,-1,-12,-3,-4,7,-3,0,-2,-1,-1,-1,-1,4,-1
KR_6752651363,420,-6,-69,-16,-17,-4,5,1,-2,2,0,-4,4,0,-5,6,1,-2,2,0,0,-17,-2,-2,-7,9,-4,0,-1,1,-1,-1,-1,3,-1
KR_6681690117,420,0,63,-6,3,4,1,5,0,4,4,5,1,6,-9,11,2,3,1,4,0,-2,49,-3,-3,6,-23,0,3,-1,1,1,1,2,-1
KR_6749956190,420,0,0,-16,2,-5,5,0,3,2,5,4,0,4,1,5,6,-1,2,1,-1,7,17,0,-4,4,0,0,-1,1,-1,-1,-1,2,-1
KR_6773863069,420,-1,-30,-12,-5,-1,1,0,-3,5,2,-2,4,2,-1,2,1,2,0,2,0,0,-8,1,-8,7,-2,0,0,1,-1,0,-1,6,-1
KR_6776052496,420,-2,-33,-5,-8,-1,4,3,0,1,1,-2,4,2,-3,3,0,-2,2,0,-1,-11,20,-4,-5,9,-3,0,-2,-1,-1,-1,-1,2,-1
KR_6726497110,420,-3,8,13,-2,-3,4,1,-3,3,0,1,2,3,0,3,3,3,0,3,0,-8,192,-3,-4,7,2,0,0,1,-1,-1,1,6,-1
KR_6773646779,420,-4,-15,-42,-5,3,0,3,-2,4,2,-3,3,0,-3,3,0,0,0,0,0,-6,1,0,-4,4,-7,0,-2,-1,-1,-1,-1,4,-1
KR_6777006588,420,3,-27,16,4,5,0,5,1,2,3,-3,4,1,2,0,2,-1,1,0,0,11,-7,0,-5,5,6,0,0,1,-1,0,-1,6,-1
KR_6773937443,420,1,-14,-16,0,-1,2,1,-3,6,3,-4,5,1,6,3,9,2,0,2,0,2,-8,2,-11,9,6,0,-2,1,-1,-1,1,5,-1
KR_6736896314,420,-1,-72,-5,-4,-2,3,1,3,5,8,-1,3,2,-2,4,2,-2,3,1,0,2,-27,-4,-6,10,6,0,0,-1,1,0,-1,2,-1
KR_6768259658,440,-4,-50,0,-7,-3,5,2,-4,5,1,-1,2,1,0,0,0,1,0,1,0,-1,-39,-5,-3,8,-1,0,-1,-1,-1,-1,-1,4,-1
KR_6763654755,420,-5,-102,-1,-10,0,0,0,-1,4,3,-7,7,0,2,2,4,-4,4,0,-1,-8,0,-1,-5,6,-5,0,-1,-1,1,-1,-1,5,-1
KR_6760658553,420,-1,-2,6,1,-2,2,0,6,1,7,-5,5,0,0,1,1,2,1,3,0,6,2,0,-6,6,0,0,-1,-1,-1,-1,-1,4,-1
KR_6765821095,420,2,46,-20,-3,2,0,2,-1,5,4,2,3,5,-3,5,2,-3,3,0,0,-7,-14,-6,-5,11,5,0,-1,-1,-1,-1,-1,3,-1
KR_6756674298,420,-2,-74,15,-3,1,2,3,5,0,5,-2,2,0,-4,6,2,-3,3,0,-2,-1,-3,-5,-2,7,-1,0,-2,-1,-1,-1,-1,3,-1
KR_6727876907,420,3,27,4,-1,-2,3,1,6,1,7,-3,4,1,1,1,2,-3,3,0,0,-5,29,3,-10,7,3,0,1,-1,1,1,-1,5,-1
KR_6765447085,420,-1,-33,-8,3,1,2,3,-2,2,0,1,1,2,3,0,3,0,0,0,0,5,-6,5,-7,2,-1,0,0,-1,-1,-1,1,2,-1
KR_6744941153,420,-2,-27,-9,-3,0,1,1,3,1,4,3,1,4,-5,6,1,-4,4,0,0,-7,6,2,-8,6,7,0,-1,1,-1,-1,-1,1,-1
KR_6773617002,420,-3,-60,10,-12,-3,4,1,2,1,3,-3,5,2,-5,5,0,-3,6,3,0,-7,-40,0,-5,5,-1,0,-1,1,-1,-1,-1,6,-1
KR_6761314164,420,-1,-45,-1,-11,-1,3,2,-7,7,0,-2,3,1,-1,3,2,0,2,2,0,-12,-5,-3,-5,8,3,0,-1,-1,-1,-1,-1,4,-1
KR_6775738142,420,-3,-36,-45,-3,-1,3,2,-1,2,1,-5,6,1,3,0,3,1,1,2,0,-1,101,3,-7,4,-4,0,-1,-1,-1,-1,1,6,-1
KR_6685856387,420,-1,9,-24,-2,1,0,1,2,3,5,-1,2,1,-3,5,2,-1,2,1,1,-1,14,2,-5,3,-2,0,1,-1,1,1,1,5,-1
KR_6763834775,420,-1,-29,31,-3,0,2,2,0,2,2,-3,4,1,-1,1,0,1,0,1,0,-2,-2,5,-10,5,0,0,-1,-1,0,-1,1,4,-1
KR_6774961808,420,4,34,-12,2,-2,5,3,1,2,3,2,1,3,1,4,5,0,0,0,0,8,-11,-5,-1,6,0,0,-1,-1,-1,-1,-1,1,-1
KR_6673323376,420,-5,-77,-12,-12,-9,9,0,-3,5,2,-3,5,2,4,2,6,-1,3,2,0,-8,-2,-1,-5,6,-4,0,-3,1,-1,-1,-1,5,-1
KR_6729955320,420,-6,-58,-29,-8,3,1,4,-5,8,3,0,6,6,-6,8,2,0,3,3,1,-14,-17,1,-6,5,2,0,-2,-1,-1,-1,-1,4,-1
KR_6730305371,420,-1,-39,-18,-3,0,1,1,0,2,2,0,2,2,-4,6,2,1,2,3,0,3,9,0,-6,6,-5,0,-1,-1,-1,-1,-1,1,-1
KR_6770500307,420,-6,-58,0,-14,-6,8,2,3,2,5,-4,5,1,-5,6,1,-2,3,1,1,-10,2,-5,-3,8,3,0,-1,-1,-1,-1,1,3,-1
KR_6759326041,420,-3,-40,7,-10,-5,5,0,-1,1,0,-1,3,2,-3,6,3,0,0,0,0,-7,-2,-5,-2,7,0,0,-4,-1,-1,-1,1,4,-1
KR_6772544791,420,-6,-78,-3,-14,3,1,4,-2,2,0,-3,4,1,-11,11,0,-1,2,1,0,-18,-12,-4,-3,7,-4,0,-2,-1,1,-1,-1,5,-1
KR_6769209002,420,-4,-61,-22,-6,-1,3,2,-4,6,2,-4,4,0,4,2,6,-1,2,1,-3,-8,8,-2,-7,9,-4,0,-2,-1,-1,-1,-1,2,-1
KR_6735172509,420,-4,-55,-29,-15,-2,4,2,-10,10,0,2,0,2,-6,7,1,1,1,2,0,-16,-12,-1,-6,7,-5,0,-2,0,1,-1,-1,0,-1
KR_6768104198,420,0,6,11,0,1,2,3,-1,4,3,0,2,2,-2,2,0,2,0,2,0,-2,-18,1,-9,8,3,0,1,-1,1,1,1,2,-1
KR_6770756189,420,-4,-80,10,-9,-4,4,0,-1,5,4,-4,4,0,0,5,5,0,2,2,0,-8,-31,-1,-6,7,1,0,-4,1,-1,-1,-1,6,-1
KR_6740898590,420,-1,-51,11,-4,3,0,3,1,5,6,-2,4,2,-5,5,0,-1,1,0,0,-14,-2,-4,-6,10,0,0,0,-1,1,1,1,6,-1
KR_6679713170,420,0,23,-1,-13,1,0,1,-5,7,2,-2,3,1,-4,6,2,-3,3,0,0,-16,1,2,-9,7,-2,0,0,1,-1,1,-1,6,-1
KR_6733798334,420,-1,7,-36,7,4,2,6,1,3,4,0,2,2,1,2,3,1,0,1,0,17,-5,-2,-3,5,7,0,1,1,-1,1,1,5,-1
KR_6771056443,420,0,21,-15,4,-5,6,1,5,2,7,0,2,2,3,0,3,1,0,1,0,5,-2,-3,-6,9,5,0,-1,1,1,-1,-1,6,-1
KR_6775158715,440,-1,-24,18,-8,1,1,2,-4,4,0,2,2,4,-5,6,1,-2,2,0,1,-9,8,3,-6,3,2,0,0,-1,1,0,1,6,-1
KR_6748898331,420,2,-27,13,0,-2,3,1,2,1,3,6,0,6,-5,7,2,-1,2,1,1,4,3,1,-7,6,-6,0,-1,-1,-1,-1,1,2,-1
KR_6767430865,420,-3,-47,-1,-2,-1,2,1,-1,1,0,-1,3,2,0,2,2,1,1,2,0,5,-133,4,-7,3,-4,0,-1,1,0,-1,1,2,-1
KR_6774362077,420,-3,-16,-36,-3,-4,4,0,-2,3,1,5,1,6,-3,4,1,1,0,1,0,-4,30,-4,-4,8,-1,0,0,1,-1,0,1,4,-1
KR_6767505837,420,-1,-28,3,-3,-3,4,1,2,2,4,-3,3,0,0,0,0,1,0,1,0,1,-10,-5,-4,9,2,0,-1,-1,-1,-1,-1,4,-1
KR_6776207949,420,-2,-61,23,-6,-4,4,0,-4,4,0,-2,4,2,3,4,7,1,0,1,0,-2,37,-2,-4,6,-9,0,-1,1,-1,-1,-1,5,-1
KR_6773301902,420,-4,-79,23,-7,-3,3,0,1,2,3,-3,3,0,-3,5,2,1,1,2,0,-6,-13,-3,-2,5,1,0,0,1,-1,-1,-1,2,-1
KR_6772591419,420,-6,-17,-27,-14,-1,2,1,-5,8,3,-3,5,2,-3,5,2,-2,3,1,0,-18,-38,3,-8,5,-2,0,-3,0,-1,-1,-1,0,-1
KR_6771642878,420,0,6,30,-1,1,1,2,1,2,3,0,1,1,-2,2,0,-1,1,0,1,-2,80,0,-5,5,-32,0,1,-1,1,1,1,1,-1
KR_6738992209,420,-4,-58,-8,-9,-3,4,1,2,4,6,-5,6,1,-3,3,0,0,0,0,1,-14,1,1,-8,7,-1,0,-1,1,-1,-1,1,6,-1
KR_6724292448,420,-2,12,-3,0,1,0,1,-4,5,1,1,2,3,-1,2,1,3,1,4,0,-3,-7,-2,-7,9,2,0,0,1,-1,0,1,3,-1
KR_6723657766,420,-1,-11,-14,-3,-2,4,2,-2,3,1,-2,2,0,2,3,5,1,0,1,0,2,-7,-2,-5,7,4,0,-3,-1,-1,-1,-1,6,-1
KR_6774250193,420,-3,11,7,-8,-7,7,0,1,4,5,-1,2,1,0,3,3,-1,1,0,0,-6,-3,-2,-5,7,2,0,-1,1,-1,-1,-1,6,-1
KR_6775094828,420,-1,-10,-14,0,-1,2,1,2,2,4,0,1,1,2,2,4,-3,3,0,0,2,7,6,-9,3,-3,0,0,-1,1,-1,-1,4,-1
KR_6772465957,420,-3,-43,11,-4,5,0,5,-3,4,1,0,1,1,-3,4,1,-3,3,0,0,-7,-18,2,-10,8,3,0,0,1,-1,0,1,3,-1
KR_6755004188,420,0,55,32,0,2,1,3,-3,3,0,5,2,7,-3,4,1,-1,1,0,0,-11,9,0,-4,4,-5,0,-1,-1,1,-1,1,4,-1
KR_6704980254,420,-5,-36,7,-10,-2,2,0,0,1,1,-2,2,0,-5,5,0,-1,2,1,0,-10,-3,0,-8,8,0,0,0,1,1,0,-1,5,-1
KR_6776285031,420,-1,28,0,-12,-1,2,1,-1,1,0,-7,7,0,-3,4,1,0,0,0,0,-16,6,-1,-4,5,0,0,-1,1,-1,-1,-1,3,-1
KR_6776964707,420,1,-62,8,7,0,1,1,7,0,7,-2,2,0,1,4,5,1,1,2,4,13,15,3,-9,6,9,0,-1,1,-1,-1,1,1,-1
KR_6731777483,420,-1,-46,4,1,-2,2,0,3,0,3,1,4,5,0,2,2,-1,2,1,0,-5,13,-1,-6,7,1,0,0,1,1,1,-1,5,-1
KR_6738962053,420,-1,-43,-34,2,3,1,4,0,3,3,-2,4,2,1,0,1,0,0,0,0,6,9,3,-7,4,-5,0,1,1,-1,-1,-1,3,-1
KR_6769996424,420,3,4,11,-1,2,0,2,-3,4,1,0,2,2,3,2,5,-3,4,1,0,1,-40,-3,-4,7,2,0,-1,1,-1,-1,1,3,-1
KR_6773080216,420,3,56,-19,9,-1,2,1,3,1,4,0,1,1,7,3,10,0,1,1,0,12,3,2,-6,4,-1,0,0,1,-1,0,1,1,-1
KR_6758883914,440,-2,-108,-13,-5,-2,6,4,-2,3,1,-1,3,2,0,5,5,0,2,2,-1,-4,-1,2,-5,3,2,0,0,-1,1,0,-1,1,-1
KR_6773178070,420,-3,-61,-8,-4,-2,2,0,0,2,2,-2,3,1,0,3,3,0,0,0,-2,-5,6,2,-8,6,-8,0,0,1,1,0,-1,2,-1
KR_6777397506,420,-2,-51,14,-1,-5,5,0,3,3,6,2,0,2,-5,5,0,4,2,6,0,1,-2,-4,-3,7,1,0,-2,1,-1,-1,-1,2,-1
KR_6772941868,420,-1,-22,21,3,0,2,2,3,0,3,1,0,1,-1,1,0,0,0,0,0,-2,-4,3,-6,3,-5,0,0,-1,1,0,1,3,-1
KR_6775290474,420,-1,10,-4,-2,1,1,2,-4,5,1,2,1,3,-3,3,0,2,0,2,0,2,-4,1,-6,5,5,0,0,-1,-1,-1,-1,1,-1
KR_6752928568,420,-3,-53,-24,-3,5,1,6,-6,7,1,2,0,2,-4,4,0,0,1,1,-1,-12,1,-1,-5,6,-3,0,-2,-1,1,-1,-1,6,-1
KR_6744476788,420,-5,-40,-21,-12,-2,3,1,-7,9,2,2,0,2,-3,3,0,-2,2,0,-1,-11,27,-1,-5,6,-3,0,-1,-1,-1,-1,-1,2,-1
KR_6769080551,420,-3,-9,-25,-2,2,1,3,3,0,3,-3,5,2,-3,3,0,-1,1,0,1,0,-11,-1,-5,6,1,0,0,-1,1,-1,1,6,-1
KR_6743854298,420,-5,-46,4,-11,-4,4,0,-3,6,3,0,2,2,-4,6,2,0,1,1,0,-16,-14,0,-5,5,-3,0,0,-1,-1,-1,1,1,-1
KR_6776736094,420,-1,0,-9,0,-1,5,4,0,4,4,0,4,4,0,0,0,1,1,2,0,-5,25,-2,-5,7,4,0,-1,1,-1,-1,-1,5,-1
KR_6682730987,420,-3,-78,-33,-7,0,2,2,-3,5,2,-1,2,1,-3,3,0,0,1,1,0,-5,2,-4,-7,11,1,0,-1,-1,1,-1,-1,1,-1
KR_6762024882,440,-1,-32,-16,-4,0,1,1,0,3,3,1,3,4,-2,6,4,-3,4,1,0,-5,-44,0,-2,2,3,0,0,1,0,0,-1,3,-1
KR_6749590146,420,2,5,11,-7,0,3,3,1,2,3,-2,4,2,-4,8,4,-2,4,2,0,1,9,2,-14,12,-6,0,0,-1,-1,-1,-1,5,-1
KR_6762940242,420,2,25,7,-1,1,1,2,-2,3,1,4,0,4,-5,8,3,1,0,1,0,2,3,-1,-5,6,-2,0,0,1,-1,-1,-1,3,-1
KR_6774848951,440,0,36,-8,-1,3,1,4,0,2,2,-2,3,1,-2,5,3,0,0,0,0,0,-3,-1,-4,5,-3,0,-1,-1,1,-1,-1,5,-1
KR_6732687606,420,-1,-10,-5,-2,-2,3,1,2,1,3,-1,3,2,-3,5,2,2,0,2,1,3,-41,-1,-6,7,4,0,0,-1,-1,0,1,6,-1
KR_6732300712,440,-1,-37,4,-4,-2,2,0,-2,3,1,-2,3,1,3,2,5,-1,3,2,0,-8,0,1,-7,6,-1,0,0,0,-1,-1,-1,0,-1
KR_6764440336,440,1,38,-6,1,-1,1,0,0,2,2,1,0,1,3,0,3,-2,2,0,0,-2,1,0,-6,6,-5,0,0,0,1,0,1,0,-1
KR_6749787557,420,-1,6,-1,1,-4,5,1,5,2,7,-2,2,0,3,0,3,-1,1,0,0,-1,46,2,-9,7,-22,0,0,1,-1,1,1,1,-1
KR_6777646170,420,-1,2,-32,-1,3,3,6,-6,7,1,-3,4,1,4,0,4,1,0,1,1,-3,-2,-1,-6,7,7,0,-1,-1,-1,-1,1,3,-1
KR_6759161146,420,-6,-97,0,-10,-3,3,0,-3,4,1,-1,4,3,-2,2,0,-1,1,0,0,-16,-3,0,-5,5,-4,0,-2,1,-1,-1,1,2,-1
KR_6769848931,420,-5,10,-22,-10,-3,5,2,-5,6,1,-4,5,1,3,7,10,-1,1,0,0,-15,-62,-1,-7,8,0,0,-1,-1,-1,-1,1,4,-1
KR_6748260646,420,1,53,-3,5,1,3,4,0,5,5,6,1,7,2,1,3,-4,4,0,0,2,2,1,-5,4,0,0,2,0,1,1,-1,0,-1
KR_6776920569,420,-2,-5,-27,0,-1,1,0,-4,6,2,2,0,2,4,3,7,-1,2,1,0,0,-6,-6,-6,12,-3,0,-1,1,-1,1,1,5,-1
KR_6742819499,420,-1,-9,-13,0,-1,2,1,4,0,4,1,2,3,-4,5,1,0,0,0,0,1,-1,4,-9,5,-3,0,-2,-1,-1,-1,-1,1,-1
KR_6769266217,420,-3,-33,-23,-5,1,2,3,-2,3,1,-2,3,1,1,4,5,-3,4,1,0,-3,-4,-6,-2,8,-1,0,1,1,-1,1,-1,4,-1
KR_6759082339,420,0,51,-33,-5,0,1,1,2,3,5,-4,6,2,-2,4,2,-1,1,0,0,-5,-2,1,-7,6,-4,0,0,1,-1,1,-1,3,-1
KR_6777776376,420,-2,-76,20,-6,-2,4,2,-4,4,0,0,0,0,-2,2,0,2,0,2,0,-4,17,-6,-5,11,-6,0,0,1,1,-1,-1,3,-1
KR_6777589243,420,-1,-53,-12,-4,-1,2,1,1,1,2,-2,5,3,0,1,1,-2,2,0,0,0,4,3,-7,4,-7,0,0,1,1,0,-1,4,-1
KR_6764417343,420,-1,31,8,0,7,0,7,1,2,3,0,0,0,-7,8,1,-1,1,0,0,-5,29,-4,-4,8,1,0,-1,-1,1,1,1,3,-1
KR_6767860400,420,4,42,7,8,7,1,8,3,1,4,0,1,1,-1,1,0,-1,3,2,0,-1,17,0,-6,6,0,0,1,-1,1,1,1,6,-1
KR_6767262164,420,-4,4,-16,-17,-3,3,0,0,3,3,-4,4,0,-8,11,3,-2,4,2,0,-17,-12,-2,-6,8,-1,0,-2,-1,-1,-1,-1,1,-1
KR_6768459800,420,1,-51,22,0,-1,1,0,2,1,3,-2,2,0,-1,5,4,2,3,5,0,6,-6,8,-14,6,0,0,-1,1,1,1,-1,5,-1
KR_6774133608,420,0,-9,20,-6,1,1,2,-1,3,2,-1,3,2,-2,2,0,-3,4,1,0,-10,-13,-6,-1,7,3,0,1,-1,1,1,-1,4,-1
KR_6773779423,420,0,-73,10,-3,1,1,2,-2,2,0,-3,4,1,1,3,4,0,1,1,0,-3,29,-1,-7,8,-3,0,0,-1,1,1,-1,4,-1
KR_6777181445,420,0,-18,-4,4,-2,3,1,-3,6,3,3,3,6,3,2,5,3,0,3,-2,8,5,2,-7,5,2,0,1,1,1,1,-1,5,-1
KR_6777057954,420,1,-33,54,-8,-1,3,2,-6,8,2,2,1,3,-5,5,0,2,2,4,0,-6,0,2,-10,8,-1,0,0,-1,-1,-1,-1,6,-1
KR_6776154126,420,0,-48,14,2,-2,2,0,7,0,7,-1,5,4,-2,3,1,0,1,1,1,6,65,6,-12,6,-3,0,0,-1,1,0,1,3,-1
KR_6769744698,420,-1,-15,-24,-8,-1,3,2,-3,5,2,0,1,1,-4,5,1,0,1,1,0,-12,-4,3,-6,3,1,0,0,-1,1,-1,-1,1,-1
KR_6764604299,420,-1,-42,-1,3,1,2,3,-4,4,0,4,2,6,2,3,5,0,3,3,1,11,7,5,-10,5,-1,0,-1,1,-1,-1,1,4,-1
KR_6754810520,420,2,-57,-3,3,-3,3,0,-1,3,2,4,3,7,0,2,2,3,0,3,0,7,-3,-4,-4,8,7,0,0,1,1,-1,-1,5,-1
KR_6737546560,420,0,20,4,0,6,0,6,-2,4,2,1,3,4,-5,7,2,0,1,1,1,-3,18,-5,-3,8,3,0,1,-1,1,1,1,4,-1
KR_6771306378,420,0,45,28,-5,3,1,4,1,1,2,-7,9,2,-2,5,3,0,2,2,0,-10,-18,3,-7,4,-4,0,1,1,-1,1,-1,5,-1
KR_6774255835,420,-2,-32,-13,-1,1,1,2,0,4,4,-2,3,1,-2,6,4,2,1,3,0,-2,252,3,-6,3,-1,0,-1,-1,-1,-1,-1,5,-1
KR_6768240500,420,-2,-2,6,-2,2,2,4,1,4,5,-3,3,0,-1,2,1,-1,3,2,0,-6,22,0,-7,7,-4,0,0,-1,-1,-1,1,4,-1
KR_6694814747,420,-3,14,-12,-7,-1,2,1,-2,5,3,-1,3,2,-4,5,1,1,1,2,0,-10,-1,-4,-2,6,1,0,0,-1,-1,0,-1,5,-1
KR_6775555431,420,1,3,2,-1,1,1,2,0,0,0,0,1,1,-2,5,3,0,0,0,-1,-6,36,1,-5,4,0,0,0,-1,1,0,-1,2,-1
KR_6773407564,420,4,47,4,1,1,2,3,-1,3,2,2,2,4,-2,5,3,1,1,2,0,-9,-4,3,-8,5,-6,0,0,1,1,1,1,6,-1
KR_6751337947,420,1,7,16,-5,-1,2,1,1,1,2,-3,5,2,-2,3,1,0,0,0,0,-3,32,-5,-1,6,-19,0,-3,1,-1,-1,-1,1,-1
KR_6777210174,420,-2,34,7,-9,-1,1,0,-5,7,2,-2,3,1,0,1,1,-1,1,0,0,-12,18,-2,-4,6,-4,0,0,1,-1,0,-1,2,-1
KR_6744865250,420,-1,33,-36,-12,-1,3,2,1,3,4,-3,5,2,-7,8,1,-2,2,0,-2,-23,28,-5,-4,9,-15,0,0,-1,1,1,-1,2,-1
KR_6700160509,420,-6,-52,-18,-7,1,1,2,0,4,4,-3,3,0,-4,5,1,-1,1,0,0,-5,6,-5,-5,10,-5,0,0,-1,-1,0,-1,4,-1
KR_6777297577,420,-1,43,-7,6,-1,3,2,-2,3,1,5,1,6,4,2,6,0,1,1,0,5,5,4,-7,3,-5,0,1,1,-1,1,-1,3,-1
KR_6760687450,420,-3,-27,4,-9,-2,2,0,0,5,5,-4,6,2,-3,5,2,0,1,1,0,-11,-3,1,-6,5,1,0,-1,-1,-1,-1,1,1,-1
KR_6772626143,420,-3,-21,1,-7,-1,3,2,-3,7,4,-1,3,2,-2,3,1,0,1,1,0,-6,-9,0,-7,7,-1,0,0,-1,-1,-1,-1,6,-1
KR_6756552840,420,-3,-47,14,-5,-2,3,1,-3,3,0,-2,2,0,0,3,3,2,1,3,0,-12,0,1,-6,5,-3,0,-1,1,1,-1,1,5,-1
KR_6776463832,420,-4,-43,8,-8,3,1,4,-8,8,0,3,1,4,-7,9,2,1,0,1,0,-8,-11,2,-9,7,5,0,0,1,1,0,1,5,-1
KR_6726671336,440,-3,-85,4,0,-2,3,1,-1,6,5,-1,2,1,3,2,5,1,0,1,0,0,-2,1,-7,6,-1,0,-1,-1,1,1,-1,3,-1
KR_6768874002,420,-3,-29,28,-13,0,4,4,-2,3,1,-11,13,2,-2,4,2,2,1,3,-1,-5,-15,1,-7,6,-7,0,-1,1,-1,-1,-1,3,-1
KR_6763414387,420,3,5,-4,15,0,1,1,6,1,7,4,2,6,4,1,5,1,0,1,1,20,-1,-4,-5,9,0,0,1,1,1,1,1,2,-1
KR_6727997268,420,0,-65,25,-2,0,0,0,0,2,2,-1,2,1,-2,3,1,1,1,2,0,-4,17,-2,-6,8,-2,0,0,-1,1,-1,1,2,-1
KR_6712362703,420,0,9,53,3,-6,6,0,5,1,6,2,4,6,5,2,7,-3,3,0,1,12,4,1,-4,3,-1,0,0,1,1,1,1,6,-1
KR_6734396418,420,-5,-56,0,-12,-4,4,0,0,2,2,-6,6,0,1,2,3,-3,3,0,0,-10,5,-2,-2,4,0,0,-2,0,-1,-1,-1,0,-1
KR_6773400182,420,-2,-12,-9,-3,-3,4,1,-8,11,3,-1,2,1,3,1,4,6,0,6,-1,-8,8,1,-3,2,1,0,0,-1,1,1,-1,6,-1
KR_6768399980,420,2,-9,13,4,0,1,1,3,1,4,0,1,1,0,3,3,1,1,2,0,5,-28,0,-9,9,5,0,1,1,1,1,1,3,-1
KR_6775183198,420,-4,-93,-32,-4,0,0,0,-5,5,0,-2,4,2,4,0,4,-1,2,1,0,-2,-34,8,-11,3,32,0,-1,-1,1,-1,-1,1,-1
KR_6766478460,420,0,6,-19,6,-2,2,0,1,2,3,0,1,1,4,2,6,3,1,4,2,14,11,-1,-4,5,0,0,0,1,-1,1,1,1,-1
KR_6775078963,420,-2,36,8,-6,0,5,5,-6,6,0,-1,1,0,0,5,5,1,0,1,0,-9,-26,-3,-3,6,1,0,0,-1,-1,-1,1,4,-1
KR_6740136059,420,-3,-3,-2,-13,-4,5,1,-4,6,2,0,1,1,-4,4,0,-1,1,0,0,-14,18,-4,-5,9,0,0,0,-1,1,0,-1,2,-1
KR_6742031183,440,3,47,-3,8,-2,2,0,1,1,2,2,0,2,6,0,6,1,0,1,0,11,-40,-1,-1,2,25,0,-1,0,-1,-1,1,0,-1
KR_6736364579,420,0,28,5,-6,3,1,4,-7,8,1,-2,2,0,-1,2,1,1,2,3,0,-11,19,3,-8,5,-4,0,-1,1,1,-1,1,5,-1
KR_6774908877,420,1,-4,12,3,-1,1,0,7,1,8,-1,2,1,-1,1,0,-1,3,2,0,8,5,10,-11,1,1,0,0,-1,1,0,1,4,-1
KR_6769235163,420,-1,23,-15,-3,-3,3,0,-4,4,0,0,0,0,3,1,4,1,0,1,0,-3,1,0,-8,8,0,0,1,-1,-1,1,-1,3,-1
KR_6776073459,420,1,23,-8,4,4,2,6,0,2,2,-3,5,2,2,3,5,1,0,1,2,6,6,0,-6,6,0,0,1,1,1,1,1,1,-1
KR_6777858278,420,-5,-89,-47,-9,0,4,4,-2,3,1,-6,6,0,0,3,3,-1,2,1,0,-9,34,4,-7,3,2,0,-2,-1,-1,-1,-1,5,-1
KR_6728033670,420,1,52,4,0,0,1,1,1,3,4,-3,4,1,1,2,3,1,3,4,0,5,16,2,-6,4,3,0,0,-1,-1,0,1,3,-1
KR_6773601177,420,-2,-16,-23,-11,-5,6,1,-4,4,0,-3,3,0,1,2,3,0,1,1,0,-10,4,2,-5,3,-3,0,0,-1,-1,-1,-1,3,-1
KR_6729133979,420,1,-30,-7,10,6,0,6,2,1,3,-3,4,1,6,0,6,-1,1,0,1,15,6,1,-5,4,-4,0,1,1,-1,1,1,4,-1
KR_6772776525,420,0,11,-8,0,-1,2,1,-1,5,4,2,1,3,1,1,2,-1,1,0,0,5,-7,-1,-6,7,3,0,0,1,1,0,1,2,-1
KR_6719960554,420,-3,-41,-45,-8,0,4,4,-2,6,4,0,2,2,-7,9,2,1,1,2,0,-8,8,2,-9,7,-4,0,-3,-1,-1,-1,-1,4,-1
KR_6737423941,420,-3,-28,-8,-11,-2,2,0,0,3,3,-3,3,0,-6,8,2,0,0,0,0,-10,20,-2,-5,7,-3,0,0,1,1,-1,1,5,-1
KR_6777727816,420,-5,-55,-26,-9,-3,5,2,0,3,3,-4,9,5,-1,2,1,-1,1,0,0,-17,-16,-2,-7,9,-4,0,0,-1,1,-1,-1,3,-1
KR_6775428761,420,1,11,5,0,1,0,1,-5,7,2,0,1,1,1,4,5,3,0,3,0,6,-40,-2,-3,5,28,0,0,1,-1,0,1,6,-1
KR_6769422857,420,-4,-33,0,-9,1,1,2,-2,3,1,-1,5,4,-1,2,1,-6,6,0,0,-10,0,3,-8,5,-1,0,-1,-1,-1,-1,-1,5,-1
KR_6777423456,420,-1,2,6,0,0,1,1,-1,3,2,2,3,5,0,3,3,-1,1,0,0,5,3,4,-6,2,-8,0,-1,-1,1,-1,-1,6,-1
KR_6774070410,420,-2,-7,-6,-4,-1,2,1,3,0,3,-3,4,1,-5,9,4,2,0,2,0,-1,-2,6,-11,5,-4,0,-1,1,-1,-1,1,6,-1
KR_6777862767,420,1,51,-7,-1,0,1,1,-1,3,2,2,4,6,0,1,1,-2,3,1,-1,-14,16,4,-8,4,0,0,1,1,0,1,-1,4,-1
KR_6758604026,420,-2,68,-7,-6,-1,2,1,-4,5,1,-1,3,2,1,3,4,-1,2,1,1,-18,-17,1,-8,7,1,0,0,-1,1,-1,1,4,-1
KR_6759891423,440,-2,35,9,-4,-2,2,0,-1,4,3,-5,5,0,1,2,3,3,1,4,0,-3,-52,-8,-3,11,10,0,0,1,-1,0,-1,5,-1
KR_6775348767,420,-4,-38,20,-9,0,1,1,1,2,3,0,2,2,-7,10,3,-3,3,0,0,-17,-4,-1,-6,7,-2,0,0,-1,1,1,-1,4,-1
KR_6747946109,440,-2,-48,0,-4,-7,7,0,-2,7,5,3,0,3,2,4,6,0,1,1,2,-1,10,-1,-3,4,-7,0,-2,1,-1,-1,1,5,-1
KR_6756897791,420,-4,-9,-2,-11,-1,3,2,-4,4,0,-1,1,0,-3,3,0,-2,2,0,0,-12,5,-4,-3,7,1,0,0,-1,1,0,-1,6,-1
KR_6777715404,420,-2,3,-5,-6,-1,3,2,-4,5,1,-2,3,1,0,0,0,1,1,2,-1,-10,-5,-3,-9,12,5,0,-1,-1,1,-1,1,5,-1
KR_6777599060,420,3,2,11,3,1,0,1,-3,4,1,2,2,4,5,1,6,-2,2,0,0,9,4,3,-5,2,-2,0,0,-1,1,0,1,2,-1
KR_6735346780,420,-3,-9,-7,-11,2,1,3,-6,6,0,-6,7,1,1,2,3,-2,2,0,0,-21,-10,-3,-4,7,2,0,-1,-1,-1,-1,1,4,-1
KR_6730807245,420,-5,-80,-26,-6,1,1,2,-2,2,0,3,0,3,-7,7,0,-1,1,0,-1,-15,-4,-8,-3,11,-8,0,-1,-1,-1,-1,-1,2,-1
KR_6776836058,420,-5,-34,-6,-11,3,1,4,-4,4,0,-5,5,0,-4,6,2,-1,1,0,0,-17,3,3,-5,2,-1,0,-2,-1,-1,-1,1,5,-1
KR_6775582318,420,-1,-31,23,-6,-5,6,1,-1,4,3,4,1,5,-5,7,2,1,0,1,-1,-8,8,3,-10,7,-4,0,0,-1,-1,0,-1,3,-1
KR_6738545276,420,-2,78,9,-6,-4,4,0,-6,7,1,3,1,4,2,0,2,-1,2,1,0,-3,-7,3,-9,6,1,0,-2,1,-1,1,1,4,-1
KR_6768334983,420,-2,-39,-12,-7,1,1,2,-2,3,1,-2,5,3,-3,5,2,-1,2,1,0,-12,-273,-4,-5,9,5,0,-1,-1,-1,-1,-1,1,-1
KR_6769448513,420,3,25,20,7,3,0,3,2,3,5,5,4,9,-2,5,3,-1,1,0,0,4,86,0,-6,6,10,0,2,1,1,1,-1,3,-1
KR_6773322355,420,-2,-48,-2,-8,-2,3,1,-4,6,2,-8,9,1,6,1,7,0,0,0,0,-7,4,-3,-5,8,5,0,-1,1,-1,1,1,4,-1
KR_6776877799,420,0,-28,-7,-5,2,0,2,-5,7,2,1,0,1,-3,6,3,0,1,1,0,-16,0,-2,-2,4,1,0,0,1,-1,-1,-1,5,-1
KR_6774582112,420,0,32,15,-4,-1,2,1,0,3,3,-1,4,3,0,3,3,-2,2,0,0,-4,-36,-5,-1,6,6,0,-1,1,1,-1,-1,2,-1
KR_6770292490,420,-1,26,24,-5,-2,2,0,-2,5,3,-1,3,2,-1,3,2,1,1,2,0,-6,2,-1,-5,6,6,0,0,-1,-1,-1,1,6,-1
KR_6683914912,420,-1,-35,-2,-2,-1,3,2,3,1,4,-1,4,3,-2,3,1,-1,1,0,0,-3,-8,-3,-9,12,0,0,1,-1,1,-1,-1,5,-1
KR_6774489232,420,-2,-30,-8,-4,2,2,4,-4,4,0,2,0,2,-2,3,1,-2,2,0,0,-5,34,-2,-7,9,0,0,0,1,-1,0,-1,5,-1
KR_6740609424,420,-4,-62,1,-3,0,2,2,0,2,2,0,2,2,-4,7,3,1,0,1,0,-6,-13,-6,-2,8,4,0,-3,-1,-1,-1,1,3,-1
KR_6776504395,420,2,-60,9,3,3,0,3,1,5,6,-4,6,2,3,2,5,0,0,0,0,1,0,1,-7,6,-2,0,-2,-1,1,-1,-1,5,-1
KR_6733354442,440,-4,-49,-16,-7,-2,2,0,2,2,4,-8,9,1,-2,2,0,3,0,3,0,-5,-5,1,-3,2,-3,0,-1,-1,1,-1,-1,5,-1
KR_6768317281,420,-3,-71,-7,-6,2,0,2,-4,6,2,0,1,1,-5,5,0,1,0,1,0,-8,-13,-5,-2,7,2,0,-1,-1,1,-1,-1,2,-1
KR_6763762309,420,3,50,24,7,10,1,11,1,4,5,-4,5,1,0,0,0,0,1,1,1,13,5,-3,-1,4,2,0,2,-1,1,1,1,1,-1
KR_6669250797,420,-5,-76,-47,-4,-2,3,1,-2,5,3,-3,3,0,3,0,3,0,0,0,0,2,-6,2,-5,3,-3,0,-1,-1,-1,-1,1,6,-1
KR_6762987164,420,1,13,-39,-1,1,1,2,-1,1,0,0,0,0,-1,1,0,0,0,0,0,-2,-4,-2,-4,6,-1,0,-1,-1,1,-1,1,5,-1
KR_6775201044,420,0,-35,-18,2,2,4,6,7,0,7,0,1,1,-5,6,1,-2,5,3,0,2,3,-2,-7,9,-6,0,0,-1,1,1,-1,4,-1
KR_6742402003,440,0,10,42,-3,2,2,4,-2,3,1,2,0,2,-5,5,0,0,0,0,0,-7,-46,3,-5,2,16,0,1,-1,1,1,-1,6,-1
KR_6775508960,420,-2,-67,-16,-2,2,0,2,-1,3,2,0,1,1,-4,6,2,1,0,1,0,-2,-21,-2,-4,6,2,0,0,-1,1,1,-1,6,-1
KR_6772291860,440,-5,-88,8,-6,2,1,3,-1,3,2,-6,6,0,-2,2,0,1,0,1,1,-14,-2,-4,-6,10,-1,0,0,1,-1,0,1,3,-1
KR_6732567628,420,0,-80,-12,-1,-3,3,0,1,2,3,2,3,5,-1,3,2,0,0,0,0,4,-11,-7,-2,9,-1,0,-1,-1,-1,-1,-1,4,-1
KR_6738015879,440,-1,25,-27,-2,1,1,2,-1,3,2,0,3,3,0,1,1,-2,2,0,0,-2,14,-3,-7,10,-4,0,1,-1,-1,1,-1,5,-1
KR_6745956965,440,-5,-92,-12,-9,-1,1,0,-1,3,2,0,1,1,0,1,1,-7,8,1,0,-1,9,1,-1,0,-2,0,0,-1,1,-1,-1,4,-1
KR_6771956410,420,-3,-30,-12,-12,-1,3,2,-1,2,1,-9,10,1,-1,3,2,0,0,0,0,-11,-9,-1,-6,7,-2,0,-4,-1,1,-1,-1,4,-1
KR_6737966673,420,-4,-37,-37,-14,1,3,4,-2,6,4,-5,6,1,-3,5,2,-5,6,1,0,-27,21,1,-7,6,-3,0,0,-1,-1,-1,1,2,-1
KR_6777656063,420,-1,-12,1,-7,2,1,3,-3,3,0,-3,4,1,0,2,2,-3,3,0,0,-11,-5,3,-7,4,-2,0,0,-1,1,0,-1,2,-1
KR_6772387701,420,-1,-55,31,-4,-1,3,2,3,3,6,-6,6,0,-2,3,1,2,0,2,0,-3,-14,-4,-4,8,5,0,0,-1,1,1,1,3,-1
KR_6777858578,420,5,23,-12,11,0,4,4,5,0,5,2,2,4,3,0,3,1,0,1,0,12,7,-1,-5,6,7,0,1,1,-1,1,1,2,-1
KR_6748280552,420,-4,2,-7,-13,0,2,2,-6,6,0,-3,3,0,-6,6,0,2,0,2,0,-11,-2,-2,-4,6,-1,0,-3,-1,-1,-1,-1,3,-1
KR_6764870052,420,-1,39,16,6,2,0,2,3,2,5,6,2,8,-4,5,1,-1,1,0,0,5,-2,7,-8,1,-7,0,1,1,1,1,1,1,-1
KR_6776622531,420,-1,-46,1,5,3,2,5,1,4,5,3,0,3,-2,4,2,0,0,0,0,12,27,-5,-2,7,4,0,0,1,-1,-1,1,2,-1
KR_6732743542,440,-3,-22,9,-5,-2,3,1,0,2,2,-1,1,0,-3,4,1,1,0,1,0,-4,-38,-2,-4,6,22,0,0,1,-1,-1,-1,6,-1
KR_6716696543,420,-4,-57,-32,-8,-2,2,0,-6,6,0,-2,3,1,4,0,4,-2,2,0,-1,-10,-13,0,-5,5,2,0,-1,1,-1,-1,-1,3,-1
KR_6776748110,420,1,-5,4,-5,0,1,1,-2,2,0,-8,11,3,3,0,3,2,0,2,0,-1,6,0,-5,5,7,0,-1,-1,-1,-1,-1,3,-1
KR_6762893712,420,-2,-5,-9,2,2,1,3,2,2,4,1,4,5,-2,4,2,-1,1,0,0,0,18,3,-8,5,-1,0,1,-1,1,1,1,3,-1
KR_6732207013,420,1,51,18,3,4,1,5,-1,3,2,3,0,3,-2,5,3,-1,1,0,0,-2,-4,1,-8,7,3,0,3,1,1,1,1,1,-1
KR_6755833885,440,-1,-9,0,-7,-1,3,2,-1,2,1,-1,1,0,-4,4,0,0,2,2,0,-12,-3,0,-3,3,-2,0,0,1,-1,0,1,3,-1
KR_6777875700,420,-5,-112,-39,-4,-1,2,1,-3,5,2,1,2,3,0,2,2,-1,3,2,0,-4,33,4,-7,3,-1,0,-2,-1,-1,-1,1,6,-1
KR_6773989707,420,-5,-45,-24,-10,-1,2,1,-1,3,2,-1,3,2,-7,7,0,0,1,1,1,-7,-21,-6,-2,8,-2,0,-2,-1,-1,-1,1,6,-1
KR_6767986545,420,-2,-28,-11,5,-1,1,0,2,6,8,2,2,4,3,0,3,-1,1,0,1,3,25,2,-7,5,5,0,1,1,-1,1,1,2,-1
KR_6775737037,420,-4,-15,-44,-1,-1,1,0,-5,6,1,2,0,2,-2,5,3,5,0,5,0,1,1,-5,-2,7,0,0,0,1,-1,0,-1,2,-1
KR_6776866086,420,-6,-99,-12,-13,-4,5,1,-7,7,0,-4,4,0,2,1,3,0,0,0,0,-5,-30,1,-8,7,1,0,0,-1,1,-1,-1,5,-1
KR_6761936383,440,2,7,-8,0,3,3,6,-2,3,1,5,0,5,-6,6,0,0,0,0,0,-2,5,3,-5,2,0,0,1,0,1,1,-1,0,-1
KR_6745712252,420,-5,-88,-9,-16,-8,8,0,-3,5,2,-7,8,1,1,0,1,1,0,1,0,-12,-6,1,-6,5,-3,0,-2,-1,-1,-1,-1,4,-1
KR_6775651063,420,1,7,3,-6,5,2,7,-1,3,2,-4,4,0,-5,5,0,-1,1,0,0,-5,-4,-7,-1,8,4,0,0,-1,-1,1,1,4,-1
KR_6774877601,420,-1,13,-1,-3,-5,5,0,2,2,4,1,1,2,-2,5,3,1,1,2,3,1,-1,4,-9,5,-2,0,-2,1,1,-1,1,3,-1
KR_6776291369,420,-3,-48,-20,-4,0,1,1,-5,6,1,0,1,1,3,1,4,-2,2,0,0,-2,-152,-4,-3,7,0,0,-3,-1,1,-1,-1,1,-1
KR_6729660973,420,-3,-36,-30,-7,2,0,2,-6,8,2,4,0,4,-7,7,0,0,1,1,-1,-24,-38,2,-9,7,-7,0,0,-1,1,0,-1,2,-1
KR_6751860856,420,0,-26,-34,2,0,3,3,3,2,5,-1,4,3,0,3,3,0,1,1,0,5,1,-3,-3,6,0,0,0,1,-1,0,1,6,-1
KR_6776677044,420,-6,-32,-32,-5,-5,5,0,1,5,6,2,2,4,-4,6,2,1,1,2,0,-6,9,2,-6,4,-3,0,0,1,-1,0,1,4,-1
KR_6777772366,420,0,13,27,-2,-2,3,1,-1,3,2,-2,2,0,2,0,2,1,0,1,0,-11,31,-1,-7,8,-4,0,0,0,1,0,-1,0,-1
KR_6766140594,440,0,-96,9,-5,-3,3,0,-3,7,4,2,1,3,1,1,2,-2,4,2,-1,-5,0,0,-6,6,4,0,0,0,-1,-1,-1,0,-1
KR_6772944387,440,0,40,-16,2,1,0,1,2,2,4,1,0,1,-2,9,7,0,1,1,0,-4,-5,2,-8,6,2,0,0,-1,1,0,-1,5,-1
KR_6771597508,420,-1,8,16,-7,0,3,3,-2,5,3,-2,4,2,-2,4,2,-1,3,2,0,-6,-5,1,-4,3,0,0,-1,1,-1,-1,-1,3,-1
KR_6771781933,420,0,-61,-3,2,0,1,1,3,0,3,-1,2,1,0,1,1,0,0,0,0,9,12,-1,-7,8,3,0,0,1,-1,-1,1,2,-1
KR_6772957800,420,-2,-5,-8,-5,-1,2,1,-3,8,5,0,3,3,2,0,2,-3,4,1,1,-4,-9,-6,-6,12,-2,0,-1,-1,-1,-1,1,2,-1
KR_6729764675,420,0,-30,-11,2,4,0,4,-2,4,2,5,2,7,-6,8,2,1,2,3,3,0,5,-1,-7,8,0,0,0,-1,1,0,-1,3,-1
KR_6764005953,440,3,65,32,1,5,0,5,-6,8,2,2,0,2,0,1,1,0,1,1,-1,-10,6,0,-4,4,-2,0,1,1,1,1,-1,3,-1
KR_6688539128,420,0,107,-8,-6,1,1,2,-4,6,2,-5,6,1,4,6,10,-2,2,0,-2,-15,-4,-2,-5,7,3,0,2,-1,-1,1,-1,4,-1
KR_6769368776,440,2,-26,23,0,-1,2,1,1,4,5,-3,4,1,2,3,5,1,0,1,0,-3,-2,-2,-6,8,2,0,1,1,-1,1,1,6,-1
KR_6761866323,420,1,15,17,4,-1,2,1,-1,5,4,4,2,6,1,2,3,1,0,1,0,2,11,4,-9,5,-1,0,0,1,-1,0,-1,1,-1
KR_6774875713,420,-2,-28,-3,-7,0,3,3,-4,5,1,-4,4,0,1,4,5,0,1,1,0,-9,-71,2,-6,4,5,0,0,-1,1,-1,-1,2,-1
KR_6773720451,420,-3,-5,-15,-1,2,0,2,-2,6,4,5,0,5,-6,8,2,0,2,2,0,-9,290,-1,-5,6,4,0,0,-1,1,1,1,5,-1
KR_6751251541,420,0,-4,-4,-1,2,1,3,-5,6,1,1,0,1,2,0,2,-1,1,0,1,-1,-9,-2,-3,5,5,0,0,1,-1,0,1,4,-1
KR_6755125911,420,-6,-121,-19,-16,2,0,2,-3,4,1,-3,4,1,-12,12,0,0,1,1,-2,-23,-11,-5,-1,6,2,0,-2,-1,1,-1,-1,6,-1
KR_6674726180,420,-1,-31,1,3,4,3,7,0,2,2,1,1,2,-1,2,1,-1,2,1,0,7,5,5,-9,4,-1,0,2,-1,1,1,-1,4,-1
KR_6748148925,420,4,37,-5,1,-1,1,0,-2,2,0,-1,4,3,3,4,7,2,0,2,0,0,2,-1,-4,5,1,0,0,-1,1,0,1,3,-1
KR_6772063217,420,-3,-40,8,-12,-4,4,0,-5,6,1,-1,2,1,-1,1,0,-1,1,0,0,-12,-5,-3,-4,7,4,0,-1,1,-1,-1,-1,6,-1
KR_6733078410,420,-6,-63,-9,-7,-4,4,0,-2,8,6,-2,4,2,0,3,3,1,0,1,2,-1,-2,2,-6,4,-13,0,-1,-1,-1,-1,1,5,-1
KR_6768312056,420,-9,-107,-48,-12,-3,3,0,-5,5,0,-4,4,0,0,1,1,0,1,1,0,-12,-30,1,-4,3,-1,0,0,-1,1,0,-1,1,-1
KR_6748127460,420,-2,-1,-15,0,-3,4,1,-1,3,2,5,4,9,-2,5,3,1,4,5,0,-5,-36,-2,-7,9,3,0,-1,-1,-1,-1,1,1,-1
KR_6773113054,420,1,-72,0,-4,-1,1,0,-3,7,4,-1,2,1,0,3,3,1,1,2,0,-3,-9,-6,-3,9,-5,0,-1,-1,1,-1,-1,3,-1
KR_6772968475,420,0,-65,12,1,4,2,6,-3,6,3,-1,4,3,0,2,2,1,1,2,0,5,-13,-2,-4,6,0,0,-1,-1,-1,-1,1,2,-1
KR_6752697656,420,-2,-60,0,-3,0,2,2,-1,3,2,0,1,1,-4,7,3,2,0,2,0,-5,-50,-3,-5,8,16,0,-1,-1,-1,-1,-1,2,-1
KR_6724697641,420,-3,-33,-8,-9,-2,2,0,-1,3,2,-1,2,1,-4,4,0,-1,2,1,0,-13,-9,2,-10,8,-2,0,-3,1,-1,-1,-1,2,-1
KR_6765978828,420,0,38,7,3,-1,4,3,-1,2,1,5,0,5,1,1,2,-1,1,0,4,9,-3,-2,-7,9,6,0,-1,1,-1,-1,1,3,-1
KR_6759554275,420,0,-33,-14,1,-2,3,1,1,3,4,5,1,6,-2,4,2,-1,1,0,1,4,6,1,-4,3,-6,0,-1,1,-1,-1,1,6,-1
KR_6727248174,420,-3,-1,-1,-11,-3,3,0,2,1,3,-9,11,2,0,5,5,-1,2,1,0,-6,-21,1,-9,8,-4,0,0,-1,-1,-1,-1,6,-1
KR_6767945721,420,-2,11,-30,0,-4,7,3,-3,3,0,3,1,4,3,2,5,1,0,1,0,7,-3,-1,-4,5,5,0,0,1,-1,1,1,6,-1
KR_6777223015,420,0,42,8,0,-1,1,0,-4,5,1,4,0,4,2,0,2,-1,1,0,0,-2,11,0,-4,4,5,0,0,1,1,1,1,6,-1
KR_6755555883,420,-4,-17,-29,-9,-7,7,0,0,1,1,-2,4,2,0,4,4,0,0,0,0,1,-1,12,-13,1,-3,0,-1,0,-1,-1,-1,0,-1
KR_6777400563,420,0,-17,-4,-3,-8,9,1,2,3,5,2,2,4,0,1,1,1,0,1,0,-1,-17,-3,-5,8,-4,0,-1,-1,-1,-1,-1,2,-1
KR_6722389478,420,-2,13,9,-2,1,0,1,-5,7,2,1,1,2,1,2,3,0,0,0,0,-7,-27,2,-5,3,5,0,0,-1,1,0,1,1,-1
KR_6774264791,420,-3,-38,-5,-13,-3,5,2,-8,9,1,0,2,2,0,4,4,-2,2,0,0,-15,-18,-2,-4,6,3,0,-3,-1,-1,-1,-1,3,-1
KR_6734675819,420,-1,-4,-28,0,-5,6,1,2,4,6,-1,4,3,2,1,3,2,2,4,0,4,3,-1,-3,4,5,0,-1,1,-1,-1,-1,2,-1
KR_6775232827,440,-3,31,-29,-3,1,0,1,-7,8,1,2,1,3,2,0,2,-1,2,1,0,4,-29,0,-8,8,-2,0,0,-1,-1,-1,-1,2,-1
KR_6742086505,420,-3,-53,-10,-4,5,2,7,-7,11,4,-5,8,3,1,4,5,2,0,2,4,-5,4,2,-10,8,0,0,-2,-1,-1,-1,1,3,-1
KR_6775891083,420,-2,-82,17,-5,1,1,2,-1,3,2,3,0,3,-7,7,0,-1,1,0,0,-11,-7,-1,-3,4,-2,0,-1,-1,1,-1,-1,5,-1
KR_6768795809,420,1,34,2,0,2,4,6,1,1,2,-1,3,2,1,0,1,-3,3,0,0,-4,28,3,-8,5,0,0,-1,1,-1,-1,-1,4,-1
KR_6742906097,420,1,38,34,-2,0,2,2,1,3,4,-1,2,1,-2,4,2,0,0,0,0,2,-24,-1,-5,6,0,0,0,1,1,0,-1,6,-1
KR_6771622969,440,0,-17,-4,-1,2,1,3,-1,3,2,1,2,3,0,1,1,-3,3,0,0,-13,-3,1,-3,2,-1,0,0,-1,0,0,-1,6,-1
KR_6774567628,420,3,87,-36,4,-1,1,0,2,4,6,-1,2,1,1,2,3,3,1,4,0,2,-2,1,-5,4,-3,0,1,-1,1,1,-1,6,-1
KR_6770120953,420,1,10,-31,1,2,3,5,-1,5,4,4,1,5,-3,4,1,-1,1,0,-1,3,9,1,-8,7,2,0,0,-1,-1,0,1,6,-1
KR_6737811912,420,-2,-3,-43,-1,-2,4,2,2,6,8,3,0,3,-6,7,1,2,0,2,0,3,-4,-1,-5,6,5,0,1,1,-1,1,-1,2,-1
KR_6751144518,420,-1,-31,25,-1,1,2,3,0,3,3,0,1,1,-1,4,3,-1,2,1,0,4,16,-4,-4,8,2,0,-1,1,1,-1,-1,1,-1
KR_6747081588,420,-2,-43,10,-5,3,0,3,0,3,3,5,0,5,-10,10,0,-3,3,0,0,-18,126,4,-8,4,-6,0,-3,1,1,-1,-1,4,-1
KR_6753364321,420,-1,14,-1,-5,-3,3,0,0,2,2,0,2,2,-2,3,1,0,0,0,0,2,-22,0,-5,5,-7,0,-2,1,-1,-1,-1,2,-1
KR_6737779095,420,0,1,-8,-2,-5,5,0,-2,5,3,6,1,7,1,4,5,-2,3,1,0,-10,7,1,-8,7,3,0,2,0,1,1,1,0,-1
KR_6773973533,420,-1,-19,5,-3,-1,2,1,0,2,2,-3,3,0,2,2,4,-1,1,0,0,5,38,3,-6,3,-3,0,-1,1,-1,-1,1,1,-1
KR_6777082300,420,-6,-20,-38,-18,-1,4,3,-6,7,1,-1,3,2,-10,10,0,0,1,1,-1,-18,-37,0,-6,6,-2,0,-1,0,0,-1,-1,0,-1
KR_6772860617,420,-3,-22,-12,-8,0,1,1,1,2,3,-5,5,0,-4,5,1,0,0,0,0,-11,-107,2,-9,7,0,0,0,-1,-1,-1,-1,4,-1
KR_6769752285,420,4,6,-5,3,-1,3,2,-2,2,0,2,1,3,4,0,4,0,1,1,-1,3,-25,4,-8,4,0,0,-1,1,-1,-1,-1,4,-1
KR_6733220603,420,0,-37,48,-5,0,2,2,-2,7,5,1,2,3,-3,5,2,-1,2,1,-1,-16,-5,-1,-3,4,1,0,2,-1,1,1,-1,5,-1
KR_6768246403,440,0,23,-24,5,-3,5,2,4,1,5,1,1,2,3,1,4,0,0,0,0,12,3,-1,-4,5,0,0,1,1,-1,-1,1,2,-1
KR_6727552911,440,1,-76,-28,13,1,3,4,-1,5,4,0,3,3,10,2,12,3,0,3,3,24,-20,-5,-1,6,2,0,1,0,1,-1,1,0,-1
KR_6737087217,420,-4,-88,-40,-5,-7,8,1,2,1,3,-5,6,1,5,0,5,0,1,1,0,-7,4,-4,-2,6,-4,0,-1,-1,-1,-1,-1,3,-1
KR_6760511718,420,-2,-15,-12,-8,-3,6,3,0,4,4,-6,8,2,-2,3,1,3,2,5,0,-2,-34,0,-4,4,1,0,-2,1,-1,-1,1,1,-1
KR_6777152121,420,1,-25,6,-3,1,0,1,-4,4,0,6,1,7,-4,6,2,-2,3,1,0,-1,-6,-2,-9,11,-3,0,0,1,1,0,-1,6,-1
KR_6743744825,420,-2,17,7,-6,-3,3,0,-2,5,3,-1,2,1,1,1,2,-1,2,1,0,-7,58,11,-17,6,-30,0,0,1,-1,-1,1,1,-1
KR_6753387255,420,0,7,-6,2,1,0,1,0,2,2,6,2,8,-4,6,2,-1,1,0,0,1,-13,-1,-5,6,6,0,0,1,-1,-1,1,5,-1
KR_6773719368,420,-2,17,-3,-6,-2,3,1,0,3,3,0,2,2,-5,6,1,1,0,1,0,-4,-245,-5,-4,9,8,0,-1,1,-1,-1,-1,6,-1
KR_6733353813,420,3,45,16,-1,-1,2,1,3,2,5,-1,3,2,-3,4,1,1,0,1,0,-3,-117,-2,-3,5,-1,0,-1,1,-1,-1,-1,2,-1
KR_6771346980,420,1,-35,13,-7,2,3,5,-3,4,1,-5,5,0,-1,3,2,0,1,1,0,-8,-4,0,-7,7,-5,0,0,-1,-1,-1,1,4,-1
KR_6773914083,420,-5,-56,4,-10,1,0,1,-1,1,0,-10,10,0,-1,3,2,1,0,1,0,-9,-64,-1,-4,5,22,0,0,-1,-1,-1,1,5,-1
KR_6777850994,420,-4,-60,-3,-3,-1,3,2,0,4,4,-2,4,2,-1,5,4,1,0,1,0,4,-5,2,-5,3,-3,0,-3,-1,-1,-1,1,3,-1
KR_6775587161,420,0,36,-1,-2,-3,4,1,2,0,2,-3,4,1,0,2,2,2,0,2,0,11,-9,0,-7,7,-1,0,0,1,1,0,-1,1,-1
KR_6776483664,420,-1,-26,-6,-11,0,0,0,-4,6,2,-5,6,1,-2,4,2,0,0,0,0,-11,-11,-6,-4,10,1,0,0,0,-1,0,-1,0,-1
KR_6775821201,420,-3,-62,4,-8,-3,5,2,-1,4,3,-2,5,3,-4,7,3,2,1,3,0,7,55,-4,-4,8,3,0,-2,-1,-1,-1,-1,4,-1
KR_6774427645,420,-2,-11,4,-12,-1,3,2,-2,5,3,-2,2,0,-5,7,2,-2,2,0,0,-9,0,2,-8,6,-5,0,1,-1,1,1,-1,4,-1
KR_6770209878,440,1,13,-13,2,0,0,0,-1,3,2,3,0,3,1,0,1,-1,1,0,0,2,69,2,-5,3,-3,0,1,1,0,1,-1,4,-1
KR_6751236792,420,-4,-84,-11,-6,-3,4,1,2,2,4,-4,5,1,-1,2,1,0,0,0,1,-5,-1,-5,-7,12,0,0,-4,1,-1,-1,1,1,-1
KR_6768854524,440,0,-16,28,-3,-3,4,1,2,0,2,-1,2,1,-2,5,3,1,1,2,0,0,-19,-4,-2,6,0,0,-2,-1,-1,-1,-1,2,-1
KR_6762988597,420,-3,-63,-2,-4,1,2,3,-2,4,2,2,0,2,-3,4,1,-2,3,1,0,-7,-1,-1,-5,6,-3,0,-1,-1,-1,-1,-1,2,-1
KR_6732673177,440,1,21,27,6,5,0,5,-2,4,2,3,1,4,-1,2,1,1,2,3,1,-1,-2,-1,-6,7,2,0,1,-1,1,1,1,6,-1
KR_6773453382,420,-4,-51,0,-14,0,2,2,-10,13,3,-1,3,2,0,1,1,-3,4,1,1,-15,-29,2,-7,5,-1,0,-1,-1,-1,-1,1,3,-1
KR_6770248974,420,-4,-77,-21,-12,-3,4,1,-4,5,1,7,0,7,-4,4,0,-8,8,0,0,-19,-4,1,-6,5,-6,0,-2,-1,-1,-1,-1,5,-1
KR_6776486098,420,2,33,18,1,3,0,3,-1,2,1,-2,3,1,2,3,5,-1,1,0,0,-5,-12,-4,-5,9,3,0,1,-1,1,1,-1,2,-1
KR_6727948938,420,-5,-49,12,-15,-2,3,1,-6,6,0,0,1,1,-5,6,1,-2,2,0,0,-15,-122,1,-6,5,-9,0,-1,-1,-1,-1,-1,1,-1
KR_6742445637,420,-1,-44,-13,3,1,4,5,-2,2,0,2,2,4,2,1,3,0,1,1,0,5,184,4,-7,3,3,0,1,1,1,1,1,1,-1
KR_6681389625,420,-6,-46,-1,-13,-7,7,0,-2,4,2,-2,3,1,-5,7,2,3,1,4,-2,-6,-22,-3,-7,10,-3,0,-2,-1,-1,-1,-1,2,-1
KR_6763349732,420,-5,-65,-4,-4,1,1,2,-3,4,1,-1,2,1,0,3,3,-1,1,0,0,-10,25,2,-7,5,-3,0,0,1,-1,0,-1,6,-1
KR_6773670944,420,1,2,26,0,1,1,2,2,4,6,-2,6,4,0,1,1,-1,2,1,0,6,31,1,-7,6,-2,0,0,1,1,1,-1,1,-1
KR_6773740242,420,-3,-19,-16,-6,0,0,0,1,1,2,-4,6,2,-3,4,1,0,0,0,0,-5,-14,4,-9,5,-6,0,0,-1,-1,0,-1,4,-1
KR_6763489255,420,-4,0,-34,-9,-2,2,0,-11,12,1,0,3,3,3,1,4,1,0,1,-1,-18,-11,-4,-4,8,-3,0,0,-1,-1,1,-1,1,-1
KR_6770629744,420,-1,3,36,3,1,2,3,2,2,4,3,3,6,0,3,3,-3,5,2,0,-2,-15,3,-7,4,0,0,0,-1,1,-1,1,6,-1
KR_6754602989,420,1,-9,16,3,0,2,2,-1,5,4,3,2,5,-1,5,4,2,1,3,0,2,-1,0,-7,7,-3,0,-1,1,-1,-1,1,6,-1
KR_6749395005,420,1,-27,-24,-2,5,1,6,1,5,6,0,6,6,-4,4,0,-4,4,0,0,-11,2,-4,-7,11,-3,0,0,-1,-1,-1,-1,4,-1
KR_6777315864,420,-3,-30,8,-6,-2,5,3,1,2,3,0,3,3,-4,6,2,-1,1,0,0,-8,2,-3,-5,8,4,0,0,-1,1,-1,-1,3,-1
KR_6773691110,420,-3,80,-20,-4,-1,5,4,-1,2,1,-2,3,1,2,2,4,-2,3,1,0,-6,17,2,-4,2,-3,0,1,-1,1,1,1,1,-1
KR_6777530439,420,0,33,4,-5,2,2,4,0,4,4,-1,2,1,-3,3,0,-3,4,1,-1,-10,13,4,-6,2,-2,0,0,1,-1,1,-1,4,-1
KR_6716190480,420,-6,-92,-1,-14,-1,2,1,2,2,4,-14,15,1,-1,6,5,0,1,1,0,-12,18,-5,-3,8,-1,0,-1,-1,1,-1,1,1,-1
KR_6772330182,420,-5,-19,-1,-12,-3,4,1,-5,5,0,-6,6,0,1,6,7,1,1,2,0,-10,137,-2,-3,5,0,0,0,-1,1,0,-1,2,-1
KR_6773962784,420,-1,-34,-6,-5,1,1,2,1,0,1,-1,2,1,-5,5,0,-1,1,0,0,-4,-31,1,-7,6,-1,0,-1,-1,-1,-1,-1,2,-1
KR_6738611152,420,-3,-72,-16,-2,-2,3,1,2,0,2,-2,3,1,-1,1,0,1,0,1,0,-3,-16,-2,-3,5,5,0,-2,-1,-1,-1,1,1,-1
KR_6765196750,420,2,-15,-13,-2,-4,4,0,-2,4,2,3,2,5,2,1,3,-1,1,0,0,0,0,2,-8,6,-1,0,0,-1,1,0,-1,2,-1
KR_6777159933,420,1,-13,-16,4,0,1,1,4,2,6,-1,1,0,1,1,2,0,1,1,0,0,4,2,-7,5,-4,0,1,1,1,1,-1,3,-1
KR_6737379253,420,-1,28,-5,-8,0,1,1,-5,6,1,2,2,4,0,1,1,-5,6,1,-1,-18,-12,-2,-5,7,-5,0,-1,-1,-1,-1,-1,4,-1
KR_6760322909,420,-3,22,-10,5,0,2,2,-2,8,6,3,2,5,2,0,2,2,0,2,0,3,-50,3,-8,5,22,0,0,-1,-1,0,1,1,-1
KR_6727967440,420,0,-31,12,-6,4,0,4,1,3,4,-5,5,0,-7,8,1,1,0,1,0,-9,11,0,-3,3,-4,0,-1,-1,1,-1,-1,5,-1
KR_6760782935,420,-2,-12,-14,0,-1,4,3,5,4,9,-2,4,2,2,1,3,-4,4,0,0,0,-29,-8,-2,10,3,0,0,-1,1,-1,-1,3,-1
KR_6773215056,440,-1,-12,-19,0,4,1,5,-1,5,4,-1,2,1,-4,6,2,2,0,2,0,-5,-55,5,-6,1,20,0,0,1,0,0,-1,5,-1
KR_6767721380,420,-4,-47,1,-10,-4,4,0,-1,2,1,3,2,5,-9,11,2,1,0,1,0,-18,-2,-3,-7,10,0,0,-1,-1,-1,1,1,6,-1
KR_6769257516,420,3,40,19,2,-1,2,1,6,1,7,-1,3,2,0,2,2,-2,3,1,1,6,-9,-2,-3,5,6,0,0,1,-1,0,1,4,-1
KR_6776535487,420,-2,-41,-12,-3,-3,3,0,0,2,2,0,1,1,0,1,1,0,0,0,0,-4,7,1,-8,7,0,0,0,1,0,0,-1,3,-1
KR_6731141521,420,-1,40,-19,3,-3,3,0,3,1,4,0,2,2,4,0,4,-1,2,1,0,14,8,2,-4,2,4,0,0,-1,-1,0,1,2,-1
KR_6733320352,420,-2,2,-47,-5,0,1,1,-1,2,1,-1,1,0,-1,2,1,-2,2,0,0,-7,-23,-3,-6,9,-5,0,0,-1,-1,0,-1,2,-1
KR_6727105931,420,-4,-47,-1,-15,-2,4,2,-5,6,1,-6,8,2,-5,6,1,3,0,3,-2,-12,-63,-2,-3,5,12,0,-1,-1,-1,-1,-1,5,-1
KR_6768342396,440,2,18,-19,7,2,0,2,1,3,4,3,0,3,1,2,3,0,1,1,0,7,2,-1,-3,4,4,0,0,-1,-1,0,1,1,-1
KR_6728205187,420,-3,-58,4,-10,-1,2,1,-9,11,2,-1,1,0,0,2,2,1,0,1,-1,-10,-7,-5,-3,8,-6,0,-2,-1,-1,-1,-1,4,-1
KR_6773570935,420,0,-56,20,1,-1,1,0,4,2,6,0,2,2,-4,4,0,2,0,2,0,-3,2,0,-10,10,4,0,-1,-1,-1,-1,1,6,-1
KR_6774486999,420,-3,20,-23,-10,-1,2,1,-1,4,3,-3,3,0,-3,4,1,-2,2,0,0,-10,6,-1,-8,9,-3,0,-1,1,-1,-1,-1,3,-1
KR_6708044414,420,1,7,12,-1,1,0,1,0,3,3,-1,2,1,1,1,2,-2,2,0,0,-1,-29,4,-7,3,3,0,0,1,0,0,1,2,-1
KR_6730020523,420,1,-9,43,-6,-2,3,1,0,4,4,2,0,2,-7,7,0,1,3,4,0,-3,-7,-2,-7,9,-1,0,0,-1,1,1,1,5,-1
KR_6726366192,420,-3,-6,-17,-10,-2,2,0,-3,8,5,-2,2,0,-5,6,1,2,0,2,-2,-12,-74,2,-7,5,-4,0,-1,-1,1,-1,-1,2,-1
KR_6742518212,420,0,-10,-4,-4,3,2,5,-1,1,0,0,1,1,-6,6,0,0,2,2,0,-8,-2,2,-5,3,-2,0,1,-1,1,-1,-1,2,-1
KR_6700684981,420,-1,-19,19,-9,-1,2,1,-5,8,3,-3,3,0,0,5,5,0,2,2,0,-6,-6,-6,-1,7,3,0,-1,1,-1,-1,-1,2,-1
KR_6774149846,420,2,7,-1,-1,-3,4,1,2,1,3,-3,6,3,4,1,5,-1,2,1,0,-4,-9,0,-5,5,3,0,-2,1,-1,-1,-1,2,-1
KR_6682678457,420,-2,-49,8,-6,0,2,2,0,2,2,-1,2,1,-5,8,3,0,1,1,0,-4,-36,-6,-5,11,7,0,-1,-1,-1,-1,1,3,-1
KR_6774020045,440,0,45,-12,-8,0,2,2,-2,2,0,2,1,3,-4,6,2,-4,6,2,0,-1,0,-4,-2,6,7,0,-1,-1,0,-1,-1,2,-1
KR_6748471062,420,3,26,16,3,0,1,1,2,2,4,-1,2,1,1,1,2,1,0,1,1,6,-16,4,-8,4,-5,0,0,1,1,1,1,6,-1
KR_6766763431,420,-5,-88,-28,-10,-1,1,0,-3,6,3,-4,4,0,0,3,3,-2,2,0,1,-7,2,0,-4,4,-3,0,-2,-1,-1,-1,1,1,-1
KR_6772351604,420,-3,-42,-5,-1,0,2,2,-5,8,3,5,2,7,-3,6,3,2,0,2,0,4,20,-3,-1,4,3,0,-1,-1,-1,-1,-1,4,-1
KR_6763894839,420,2,-27,0,7,-1,1,0,5,0,5,4,1,5,-2,3,1,1,0,1,0,10,1,6,-10,4,4,0,1,1,1,1,1,3,-1
KR_6773549322,420,-2,-74,9,-1,-3,4,1,-2,5,3,-2,2,0,4,0,4,2,1,3,0,0,23,2,-6,4,-2,0,-1,1,-1,-1,1,1,-1
KR_6748264973,420,-6,-29,-3,-10,-2,2,0,-2,3,1,-2,5,3,-4,9,5,0,0,0,0,-13,-16,3,-9,6,-5,0,-2,-1,-1,-1,1,4,-1
KR_6769500166,420,-5,-57,-45,-10,0,2,2,-5,8,3,1,3,4,-2,6,4,-4,5,1,0,-3,5,-2,-2,4,5,0,-1,-1,-1,-1,1,2,-1
KR_6774310093,420,0,-39,-16,2,0,0,0,2,0,2,-2,3,1,0,2,2,2,0,2,0,6,-8,-4,-6,10,10,0,0,-1,1,0,1,5,-1
KR_6768634568,420,-2,-42,4,-4,0,3,3,-2,3,1,-1,1,0,-3,4,1,2,0,2,0,-14,18,-2,-4,6,0,0,-1,1,-1,-1,-1,1,-1
KR_6769722047,420,-3,-38,-19,-2,1,1,2,0,2,2,-3,4,1,-2,3,1,2,1,3,1,-7,9,4,-7,3,-9,0,0,-1,1,1,1,5,-1
KR_6735011379,420,0,-44,0,-4,-1,1,0,-1,2,1,-1,2,1,-3,5,2,2,0,2,0,-5,-12,-1,-5,6,2,0,0,1,-1,0,-1,4,-1
KR_6726783881,440,-3,-55,-5,-4,-2,3,1,-2,3,1,2,0,2,-1,1,0,-1,4,3,0,-1,-2,-2,-3,5,1,0,0,1,1,0,-1,6,-1
KR_6742589131,420,0,-17,27,-5,-2,3,1,-2,3,1,-1,2,1,0,3,3,0,0,0,0,-5,27,1,-6,5,-2,0,0,1,-1,0,1,4,-1
KR_6765951269,440,1,14,-5,3,0,0,0,-3,4,1,4,0,4,4,1,5,-2,2,0,0,8,-2,0,-4,4,5,0,1,-1,1,1,1,5,-1
KR_6775999473,420,-2,-42,-8,-5,0,1,1,-6,6,0,1,1,2,0,1,1,0,0,0,-1,-8,3,1,-4,3,-3,0,1,1,-1,1,-1,6,-1
KR_6739305816,420,-7,-42,-48,-18,-6,6,0,-6,7,1,-8,8,0,2,3,5,0,0,0,0,-13,-11,-5,-3,8,-1,0,-1,-1,1,-1,1,2,-1
KR_6772774287,420,-1,-5,12,-7,-1,1,0,0,2,2,-5,6,1,-1,2,1,0,1,1,0,-7,-118,-3,-3,6,-6,0,-3,1,-1,-1,-1,6,-1
KR_6767132510,420,-2,23,-22,2,-1,1,0,1,0,1,3,3,6,0,6,6,-1,2,1,0,-4,-3,3,-5,2,5,0,0,-1,1,0,1,6,-1
KR_6760242770,420,-1,8,9,-4,-2,3,1,2,2,4,-5,8,3,1,2,3,0,0,0,0,2,-9,-4,-5,9,-1,0,-1,-1,1,1,-1,5,-1
KR_6777559667,420,2,40,48,-4,2,1,3,-2,5,3,2,0,2,-2,3,1,-4,4,0,0,-6,4,1,-6,5,-2,0,0,1,-1,0,-1,6,-1
KR_6747851808,420,-1,-52,-4,-3,-1,2,1,2,1,3,-2,4,2,-2,4,2,0,1,1,0,-5,-16,-9,-8,17,8,0,-2,-1,-1,-1,-1,4,-1
KR_6760084859,420,0,17,-4,1,0,3,3,3,1,4,-1,2,1,-4,7,3,3,0,3,1,4,22,1,-4,3,-6,0,-1,-1,-1,-1,1,2,-1
KR_6771425376,420,0,-24,11,-3,3,1,4,0,0,0,-2,3,1,-3,4,1,-1,1,0,-1,-6,-20,-6,-1,7,-4,0,0,-1,-1,0,-1,6,-1
KR_6775082347,420,-3,-14,-44,-2,-1,1,0,-1,3,2,-1,3,2,0,1,1,1,0,1,0,2,-12,4,-7,3,1,0,0,-1,1,0,1,1,-1
KR_6672113932,420,-3,-12,-11,-9,1,0,1,-7,7,0,1,2,3,-4,6,2,0,1,1,0,-16,16,-3,-6,9,0,0,-1,-1,1,-1,-1,4,-1
KR_6768866561,420,1,38,-11,5,2,1,3,-1,3,2,4,2,6,-2,5,3,2,0,2,0,4,-4,2,-9,7,2,0,0,-1,-1,0,1,6,-1
KR_6754164564,440,1,-28,-20,6,3,0,3,-1,1,0,3,2,5,1,1,2,0,2,2,0,7,10,4,-6,2,-3,0,0,-1,0,0,-1,3,-1
KR_6700021110,420,-2,-84,12,-1,-2,2,0,4,0,4,-4,6,2,-1,3,2,2,0,2,2,1,6,-4,-5,9,-4,0,0,-1,1,-1,1,6,-1
KR_6777125957,420,-3,32,-12,-15,-1,2,1,-10,10,0,-3,4,1,-2,6,4,1,2,3,1,-17,-51,1,-6,5,2,0,-1,1,1,-1,1,5,-1
KR_6762480165,420,-4,-4,11,-11,-2,2,0,0,3,3,-3,6,3,-4,6,2,-2,2,0,1,-11,-108,4,-10,6,-2,0,-1,-1,1,-1,1,5,-1
KR_6772417390,420,1,-29,16,0,1,2,3,2,1,3,0,1,1,-5,6,1,2,1,3,0,-5,5,-1,-3,4,1,0,1,-1,1,1,-1,5,-1
KR_6740835733,420,2,-9,-9,16,2,2,4,3,4,7,3,2,5,3,2,5,5,0,5,0,16,5,-1,-7,8,-3,0,0,-1,-1,1,1,3,-1
KR_6742689260,420,-2,-12,19,-10,-1,3,2,-6,9,3,0,1,1,-4,6,2,1,1,2,0,-11,3,-2,-6,8,7,0,0,-1,1,-1,-1,2,-1
KR_6765725459,420,-1,22,-41,7,3,1,4,0,3,3,0,2,2,3,0,3,1,1,2,-1,7,9,3,-8,5,6,0,0,-1,-1,1,-1,6,-1
KR_6775395701,420,0,-7,12,-2,0,0,0,-5,5,0,-3,3,0,3,0,3,3,0,3,0,-8,-38,0,-8,8,0,0,0,-1,-1,0,1,3,-1
KR_6771648768,440,-2,-10,-28,4,0,3,3,1,2,3,3,0,3,-1,1,0,1,0,1,0,8,-11,-4,-4,8,9,0,0,-1,1,-1,-1,4,-1
KR_6775984005,420,-2,-11,-4,-7,-2,2,0,0,2,2,0,0,0,-4,10,6,-1,1,0,0,-8,33,2,-6,4,-4,0,-2,-1,-1,-1,-1,5,-1
KR_6777211142,420,-3,-112,-18,-8,0,1,1,5,1,6,-4,6,2,-7,8,1,-2,4,2,0,-7,-270,1,-6,5,-5,0,-2,-1,1,-1,1,4,-1
KR_6750794804,440,0,25,-9,1,1,1,2,1,1,2,-1,5,4,-1,2,1,1,4,5,-1,6,-18,1,-3,2,0,0,0,-1,-1,0,-1,3,-1
KR_6776531532,420,-2,-107,23,-8,-2,4,2,-4,8,4,-2,6,4,-1,4,3,1,1,2,2,-1,7,-2,-5,7,-3,0,-2,-1,1,-1,1,3,-1
KR_6774534845,420,-4,-60,25,-11,-8,8,0,0,2,2,-3,4,1,1,0,1,-1,1,0,0,3,-8,-4,-3,7,-1,0,-3,1,-1,-1,1,1,-1
KR_6774472616,420,0,11,6,-5,-2,3,1,4,1,5,-1,1,0,-5,5,0,-1,2,1,-2,1,3,5,-11,6,6,0,-1,-1,-1,-1,1,6,-1
KR_6752477982,420,-2,23,-19,-3,0,0,0,-5,8,3,0,4,4,2,3,5,0,2,2,0,-2,5,5,-7,2,-6,0,1,-1,-1,-1,-1,5,-1
KR_6762273848,420,-4,-55,1,-14,0,0,0,-7,9,2,1,2,3,-7,10,3,-1,2,1,-1,-20,-3,3,-11,8,-10,0,-2,-1,-1,-1,1,4,-1
KR_6765027545,420,-6,-22,-21,-10,0,1,1,-2,4,2,0,2,2,-6,6,0,-2,2,0,-2,-16,-9,-3,-4,7,-3,0,-1,-1,-1,-1,-1,1,-1
KR_6766637372,420,-5,-57,0,-11,-1,4,3,-6,7,1,-3,3,0,-1,3,2,0,0,0,0,-16,1,-5,-3,8,-4,0,-1,-1,1,-1,-1,2,-1
KR_6748136817,420,-1,70,-59,12,3,0,3,5,1,6,3,3,6,1,2,3,0,0,0,0,18,-31,3,-7,4,-1,0,-1,-1,-1,-1,1,5,-1
KR_6775306338,440,2,-10,8,0,-1,2,1,1,2,3,-1,6,5,-1,1,0,2,2,4,-1,-2,1,0,-5,5,-1,0,0,-1,1,0,-1,1,-1
KR_6775021870,420,-3,-26,-47,-11,2,2,4,-4,6,2,-2,4,2,-6,8,2,-1,1,0,-1,-28,-26,-4,-6,10,-2,0,-2,-1,-1,-1,1,4,-1
KR_6776333812,420,-4,-49,-16,-7,-3,3,0,0,3,3,2,2,4,-5,5,0,-1,2,1,0,-10,-3,-3,-5,8,1,0,-1,-1,1,-1,-1,5,-1
KR_6757437776,420,1,80,-4,-8,1,1,2,1,4,5,-1,3,2,-5,7,2,-4,4,0,0,-17,-5,3,-9,6,-1,0,-2,-1,-1,-1,1,1,-1
KR_6770058778,440,-1,-34,16,-5,-2,3,1,-4,7,3,0,2,2,3,0,3,-2,2,0,0,-9,0,-5,-4,9,-2,0,0,0,1,0,-1,0,-1
KR_6746105966,420,-6,-43,-30,-10,0,3,3,-2,6,4,-3,5,2,-4,9,5,-1,4,3,-1,-4,6,3,-7,4,6,0,-2,-1,1,-1,-1,4,-1
KR_6766564533,420,-4,-21,-48,-5,-4,4,0,0,4,4,3,2,5,-3,5,2,-1,1,0,-1,-4,17,0,-9,9,-2,0,-1,0,-1,-1,-1,0,-1
KR_6767996559,420,0,-3,-2,3,-6,6,0,7,0,7,-3,4,1,3,2,5,2,0,2,0,8,-4,4,-12,8,3,0,1,-1,-1,1,-1,2,-1
KR_6749407122,420,0,-35,-2,-1,3,0,3,0,2,2,4,0,4,-7,8,1,-1,2,1,0,3,5,6,-9,3,0,0,0,-1,1,-1,-1,2,-1
KR_6767578584,420,-1,-13,-10,-1,3,1,4,1,5,6,-3,6,3,0,4,4,-2,4,2,2,3,-41,2,-7,5,4,0,0,-1,-1,0,1,2,-1
KR_6740470617,420,0,-32,23,-2,4,0,4,-6,9,3,0,2,2,0,2,2,0,0,0,1,2,44,3,-8,5,-4,0,-1,-1,-1,-1,1,3,-1
KR_6738828429,420,-1,20,13,-1,2,1,3,0,2,2,0,5,5,-3,5,2,0,0,0,0,-3,-2,0,-4,4,0,0,0,-1,1,-1,-1,5,-1
KR_6777136010,420,-2,-58,-24,-2,4,0,4,-5,6,1,-2,2,0,1,1,2,0,0,0,-1,-4,-8,-4,-5,9,6,0,-1,-1,-1,-1,-1,2,-1
KR_6772391041,420,-3,-64,-27,-9,-1,2,1,-4,7,3,-1,2,1,-4,9,5,1,0,1,0,-10,-10,-1,-5,6,2,0,0,-1,1,-1,1,5,-1
KR_6777749652,420,1,-25,26,1,-1,1,0,0,5,5,2,4,6,0,0,0,0,1,1,-1,2,-35,0,-5,5,-2,0,0,1,-1,-1,-1,4,-1
KR_6767958462,420,0,59,7,-9,-7,7,0,-1,2,1,-3,6,3,3,2,5,-1,1,0,0,-12,-41,-3,-4,7,0,0,-2,1,-1,-1,1,2,-1
KR_6777143707,420,-2,6,9,-4,0,2,2,-1,3,2,-2,3,1,-2,2,0,1,1,2,0,-10,-7,-2,-4,6,-2,0,1,-1,1,1,1,1,-1
KR_6775148378,420,-3,-93,-8,6,-4,7,3,1,3,4,0,2,2,7,0,7,2,0,2,0,16,-11,-2,-5,7,-9,0,-1,1,-1,-1,-1,2,-1
KR_6761307765,420,-2,-14,5,-8,0,2,2,-5,5,0,0,1,1,-3,3,0,0,0,0,0,-14,-7,-2,-9,11,-4,0,-2,1,-1,-1,-1,5,-1
KR_6735522839,420,0,53,-15,-6,0,0,0,-7,9,2,2,0,2,-1,1,0,0,1,1,0,-9,-16,-2,-7,9,0,0,0,-1,1,0,-1,2,-1
KR_6740615774,420,2,36,36,2,-4,5,1,-1,5,4,0,1,1,5,0,5,2,0,2,0,-2,-15,5,-7,2,4,0,0,1,1,1,1,6,-1
KR_6718616823,420,0,-25,-4,-3,-1,3,2,0,2,2,-3,4,1,2,1,3,-1,3,2,1,4,-113,2,-9,7,-4,0,-3,-1,-1,-1,1,2,-1
KR_6669039061,420,-3,-3,8,-2,1,1,2,-1,5,4,0,1,1,-2,3,1,0,1,1,0,-3,-7,-3,-5,8,2,0,0,1,1,-1,-1,4,-1
KR_6736649852,420,-5,-9,-30,-3,-7,7,0,3,3,6,0,3,3,-1,3,2,2,0,2,0,-3,-2,1,-7,6,-4,0,-2,1,-1,-1,1,1,-1
KR_6756965346,420,2,-8,4,-3,-2,5,3,2,1,3,-3,5,2,3,0,3,-3,3,0,0,-5,13,1,-8,7,-6,0,0,-1,1,-1,-1,1,-1
KR_6729125161,420,-5,-67,9,-13,-5,7,2,-3,4,1,0,3,3,-5,5,0,0,4,4,0,-17,2,2,-7,5,0,0,1,-1,1,1,-1,4,-1
KR_6776905789,420,-1,16,-16,1,-1,2,1,3,2,5,-2,2,0,1,2,3,0,1,1,0,1,-7,-7,-3,10,11,0,0,1,-1,1,1,3,-1
KR_6777566345,420,-3,-47,-35,-6,1,0,1,-5,6,1,1,3,4,-3,3,0,0,0,0,0,-9,-2,5,-8,3,1,0,-1,-1,-1,-1,-1,5,-1
KR_6758232884,420,1,-9,10,0,0,1,1,2,1,3,3,0,3,-5,5,0,0,1,1,0,2,0,-2,-3,5,0,0,0,-1,-1,-1,-1,2,-1
KR_6740373138,440,-3,-98,-3,0,-6,8,2,0,0,0,-3,5,2,3,3,6,6,1,7,0,9,-33,-6,-2,8,3,0,-2,0,1,-1,1,0,-1
KR_6701333830,420,-6,-87,-8,-12,-4,4,0,1,3,4,-2,2,0,-6,8,2,-1,1,0,0,-12,-10,1,-3,2,-5,0,-2,1,-1,-1,-1,5,-1
KR_6772916434,420,3,-6,-11,2,2,0,2,5,1,6,-1,3,2,-4,5,1,0,1,1,0,2,5,-1,-5,6,2,0,1,-1,-1,-1,1,3,-1
KR_6771805827,420,0,-13,-1,-2,-2,3,1,2,1,3,4,0,4,-2,2,0,-4,4,0,-1,3,-9,-4,-6,10,0,0,-1,1,-1,-1,-1,6,-1
KR_6682037755,420,-4,-54,-29,-18,-2,4,2,-14,17,3,2,2,4,-2,3,1,-2,3,1,-1,-19,0,-4,-3,7,-2,0,-3,-1,1,-1,-1,3,-1
KR_6750366909,420,2,-5,0,1,1,0,1,0,2,2,0,3,3,0,4,4,0,1,1,1,8,-1,-4,-2,6,2,0,1,1,1,1,1,5,-1
KR_6762655915,420,-8,-92,-55,-15,1,0,1,-2,2,0,-6,7,1,-4,5,1,-4,4,0,-1,-26,-7,-2,-4,6,-4,0,-3,-1,-1,-1,-1,3,-1
KR_6770504353,420,-1,21,-24,-2,-1,2,1,4,0,4,-4,7,3,1,2,3,-2,2,0,-2,-8,2,-3,-2,5,1,0,-1,-1,-1,-1,-1,5,-1
KR_6772144910,440,-3,-25,0,-11,-2,2,0,-2,5,3,-3,5,2,-2,3,1,-2,2,0,0,-14,-70,4,-10,6,3,0,0,-1,1,-1,-1,3,-1
KR_6733902877,420,-2,-23,8,-4,1,1,2,-4,4,0,0,1,1,0,4,4,-1,3,2,0,-8,0,1,-10,9,-9,0,0,-1,1,0,1,1,-1
KR_6763345146,420,-5,-61,-26,-9,1,1,2,0,3,3,-3,3,0,-4,5,1,-3,4,1,0,-8,-7,2,-8,6,-7,0,-3,-1,1,-1,-1,1,-1
KR_6745711387,420,1,51,-10,6,2,3,5,0,1,1,-1,3,2,6,0,6,-1,1,0,0,-2,142,-2,-2,4,-3,0,2,-1,-1,1,1,4,-1
KR_6768755638,420,1,-59,28,0,0,1,1,1,2,3,0,2,2,0,3,3,-1,1,0,0,-3,-2,-2,-5,7,-3,0,0,1,-1,0,-1,4,-1
KR_6774678718,420,-3,34,-24,-3,-2,4,2,4,5,9,-2,4,2,-3,4,1,0,0,0,0,-9,7,-5,-8,13,2,0,1,1,-1,1,-1,5,-1
KR_6764891958,420,-1,-32,31,0,-1,3,2,1,1,2,5,0,5,-4,4,0,-1,3,2,1,0,-3,-3,-3,6,-4,0,0,-1,1,0,1,1,-1
KR_6755119353,420,-4,-87,-48,-10,-1,2,1,-5,8,3,-1,3,2,0,3,3,-3,5,2,-1,-7,2,-3,-2,5,-3,0,-2,1,-1,-1,-1,2,-1
KR_6770980259,420,1,56,-17,1,-2,5,3,0,3,3,4,1,5,3,3,6,-4,4,0,0,-8,-8,2,-7,5,3,0,0,-1,-1,-1,-1,1,-1
KR_6766870712,440,-1,-79,0,2,2,0,2,1,1,2,-2,2,0,2,1,3,-1,1,0,0,5,6,-5,-3,8,1,0,-1,-1,-1,-1,1,2,-1
KR_6719246956,420,-6,-80,-5,-14,-4,4,0,-3,3,0,-4,7,3,1,2,3,-4,5,1,0,-13,-35,-2,-4,6,-3,0,-2,-1,-1,-1,-1,1,-1
KR_6771713424,420,-2,7,-17,-7,-1,2,1,-3,3,0,1,0,1,-2,3,1,-2,2,0,0,-9,41,-2,-6,8,-20,0,-1,1,-1,-1,-1,4,-1
KR_6666153169,420,-6,-25,-20,-12,-1,3,2,-3,5,2,0,0,0,-5,9,4,-3,4,1,0,-12,2,1,-5,4,3,0,-1,-1,-1,-1,1,6,-1
KR_6710479939,420,1,24,9,3,4,1,5,-1,6,5,-1,2,1,0,4,4,1,0,1,0,7,22,2,-8,6,8,0,-1,-1,1,1,1,4,-1
KR_6776665142,420,-6,-94,-23,-11,-4,5,1,-3,4,1,-1,3,2,-4,5,1,1,0,1,-2,-17,7,0,-11,11,2,0,-2,-1,-1,-1,-1,4,-1
KR_6775198891,420,-3,-16,23,-13,-8,9,1,-3,4,1,-1,3,2,-1,7,6,0,2,2,1,-18,16,0,-6,6,2,0,0,1,1,-1,-1,2,-1
KR_6767601074,420,-3,-74,0,-3,0,0,0,-7,7,0,3,3,6,-1,3,2,2,0,2,0,6,0,-1,-5,6,3,0,-1,1,0,-1,-1,5,-1
KR_6775644261,420,-2,-21,1,-6,-1,2,1,-1,2,1,0,0,0,-2,2,0,-2,2,0,0,-7,-18,2,-7,5,-4,0,-1,-1,1,-1,-1,6,-1
KR_6768343935,420,-5,10,6,-13,-6,6,0,-1,6,5,-3,3,0,-3,7,4,0,0,0,-1,-12,6,-2,-8,10,9,0,0,1,-1,-1,-1,4,-1
KR_6776521694,420,-6,-38,-11,-12,0,1,1,2,1,3,-6,6,0,-5,6,1,-3,4,1,-2,-15,-11,1,-6,5,-4,0,-1,-1,-1,-1,-1,1,-1
KR_6777790579,420,-3,-13,16,-14,-5,5,0,-2,4,2,-2,2,0,-2,2,0,-3,3,0,0,-11,-20,2,-7,5,-2,0,-2,-1,-1,-1,-1,1,-1
KR_6774978541,420,1,27,-23,1,2,1,3,-3,4,1,0,4,4,2,2,4,0,1,1,0,-2,-24,-2,-5,7,2,0,0,-1,-1,0,1,3,-1
KR_6777828423,420,1,64,-11,0,1,3,4,2,1,3,-4,7,3,1,1,2,0,0,0,0,0,6,3,-7,4,-3,0,1,1,-1,-1,1,5,-1
KR_6765006362,420,0,4,-19,-3,-2,2,0,-1,3,2,3,0,3,-2,4,2,-1,2,1,0,1,-2,-3,-8,11,-2,0,-1,-1,-1,-1,-1,4,-1
KR_6765890874,420,-2,18,-11,0,-2,3,1,4,0,4,-2,3,1,1,0,1,-1,3,2,0,-4,-3,2,-7,5,-2,0,0,-1,1,0,1,4,-1
KR_6769478235,420,-2,-27,-12,-1,0,1,1,1,2,3,2,1,3,-2,3,1,-2,2,0,0,1,-1,-1,-5,6,-2,0,-1,-1,-1,-1,-1,2,-1
KR_6759711969,420,-3,-60,1,-12,0,3,3,0,4,4,-8,8,0,-2,4,2,-2,2,0,0,-9,0,-2,-5,7,-4,0,-1,1,1,-1,1,4,-1
KR_6744057241,420,-5,-39,-9,-10,4,2,6,-10,11,1,-2,4,2,-3,5,2,1,0,1,2,-10,-2,3,-10,7,0,0,-2,1,-1,-1,1,6,-1
KR_6776575937,420,-5,-48,-31,-9,0,1,1,0,1,1,2,0,2,-5,6,1,-6,6,0,0,-5,-10,-7,-3,10,8,0,-2,1,-1,-1,1,2,-1
KR_6770589368,420,-2,-70,-37,-8,-1,2,1,0,4,4,-5,6,1,-4,5,1,2,2,4,0,-15,174,0,-3,3,-4,0,-2,-1,-1,-1,1,5,-1
KR_6736639555,420,-5,-17,-23,-2,4,2,6,-4,5,1,0,1,1,0,4,4,-2,3,1,2,2,-15,0,-7,7,6,0,-3,1,-1,-1,1,3,-1
KR_6770354303,420,-4,-31,-4,-6,-2,4,2,1,4,5,-8,8,0,2,0,2,1,0,1,0,5,-5,-5,-4,9,-3,0,-2,-1,-1,-1,-1,4,-1
KR_6776945576,420,-3,-94,15,-5,-3,3,0,0,4,4,-4,4,0,-2,3,1,4,0,4,0,-7,-10,0,-6,6,3,0,-2,1,1,-1,-1,2,-1
KR_6772065784,420,-2,-27,-23,-8,-2,3,1,-2,3,1,0,3,3,-4,8,4,0,1,1,-1,-6,-1,3,-7,4,0,0,0,-1,1,-1,-1,3,-1
KR_6776034883,420,0,3,-1,1,2,2,4,-1,3,2,-1,4,3,-1,4,3,2,0,2,0,-3,-10,-2,-3,5,4,0,0,1,-1,-1,1,4,-1
KR_6775821060,420,-3,-56,18,-13,-3,3,0,2,2,4,-2,3,1,-10,10,0,0,0,0,0,-26,-18,-3,-4,7,-2,0,-2,1,1,-1,-1,1,-1
KR_6685503821,420,-2,-63,-20,2,-4,4,0,-2,4,2,2,1,3,4,0,4,2,0,2,1,7,12,2,-8,6,0,0,-1,-1,-1,-1,1,3,-1
KR_6772810535,420,-3,6,1,-3,-2,2,0,-1,5,4,2,1,3,-1,1,0,-1,2,1,0,-4,1,2,-7,5,1,0,0,-1,1,-1,-1,6,-1
KR_6760107584,420,-5,-93,-16,-18,-1,3,2,-3,4,1,-7,7,0,-6,6,0,-1,1,0,0,-15,-7,-1,-5,6,-1,0,-1,-1,1,-1,-1,3,-1
KR_6729718516,420,-3,-69,-44,-5,-1,2,1,0,7,7,-2,3,1,-2,4,2,0,0,0,-3,-14,4,1,-8,7,-3,0,-1,1,-1,-1,1,2,-1
KR_6776715039,420,-3,-40,-24,-15,1,1,2,-5,5,0,-5,5,0,-5,5,0,-1,1,0,-1,-19,-8,-2,-6,8,-1,0,-1,-1,-1,-1,-1,4,-1
KR_6749417501,420,-2,36,2,-6,-1,2,1,-3,5,2,3,1,4,-2,4,2,-3,3,0,0,-7,-3,-1,-4,5,-4,0,0,-1,0,-1,1,2,-1
KR_6768890505,440,-9,-122,-39,-14,-9,9,0,-6,8,2,4,0,4,-2,7,5,-1,5,4,0,-15,15,-2,-6,8,-1,0,-3,-1,-1,-1,1,5,-1
KR_6772109710,420,-1,-29,6,-4,2,3,5,1,2,3,-4,6,2,-3,4,1,0,0,0,0,-8,32,-1,-4,5,-2,0,0,-1,1,-1,-1,5,-1
KR_6776300476,420,-1,3,-4,-4,-2,2,0,2,3,5,0,0,0,-1,3,2,-3,3,0,0,-7,2,1,-5,4,-4,0,0,1,1,0,1,2,-1
KR_6772143556,420,-3,-34,-12,-9,-5,5,0,-2,3,1,-1,3,2,0,0,0,-1,1,0,-1,-11,39,4,-6,2,-25,0,-1,-1,1,-1,-1,3,-1
KR_6774522465,420,0,-15,-5,6,-1,4,3,2,1,3,3,0,3,2,0,2,0,0,0,0,6,-1,-6,-4,10,6,0,0,-1,1,0,1,3,-1
KR_6748241686,420,1,-2,8,1,3,1,4,1,1,2,-1,2,1,-3,5,2,1,1,2,0,-5,-5,-2,-4,6,0,0,0,-1,-1,1,-1,1,-1
KR_6772737087,420,0,-2,-12,3,-1,4,3,1,4,5,2,1,3,3,2,5,-2,4,2,1,2,8,-1,-5,6,-23,0,-2,1,-1,-1,1,6,-1
KR_6775312801,420,0,-3,-35,-1,1,3,4,-2,2,0,0,2,2,2,0,2,-2,2,0,1,-3,-5,2,-7,5,2,0,0,-1,-1,0,1,1,-1
KR_6774312775,420,-3,49,-34,-5,-3,3,0,-2,3,1,1,1,2,-1,4,3,0,0,0,0,-4,-6,0,-6,6,3,0,0,-1,1,0,1,3,-1
KR_6735210820,420,0,33,-17,-4,-1,2,1,-5,5,0,0,1,1,2,2,4,0,1,1,-2,-5,0,1,-7,6,0,0,0,-1,-1,0,-1,5,-1
KR_6761906924,440,-4,-28,-27,-7,1,0,1,-5,7,2,-3,5,2,-2,3,1,2,1,3,0,-1,-28,1,-8,7,5,0,-2,-1,-1,-1,-1,1,-1
KR_6774258556,420,2,52,16,-3,-2,3,1,-3,6,3,-1,5,4,3,1,4,0,5,5,-1,-7,-15,-1,-6,7,2,0,0,-1,1,1,-1,1,-1
KR_6752310929,420,2,49,4,-2,-3,4,1,0,4,4,-1,4,3,2,2,4,0,0,0,0,-3,-33,-3,-6,9,2,0,1,-1,1,1,-1,6,-1
KR_6777425198,420,2,9,22,2,2,1,3,3,2,5,-4,7,3,0,4,4,1,2,3,0,7,-39,1,-8,7,26,0,0,0,1,-1,-1,0,-1
KR_6677743064,420,0,4,16,-1,0,2,2,1,3,4,0,4,4,-2,2,0,0,0,0,0,-8,23,-3,-3,6,-2,0,1,-1,1,1,-1,3,-1
KR_6759274434,420,-4,-31,0,-12,3,2,5,-4,5,1,-2,4,2,-8,10,2,-1,1,0,0,-24,7,-2,-6,8,-1,0,-1,-1,-1,-1,1,4,-1
KR_6773922857,420,2,80,-18,3,1,2,3,0,2,2,2,0,2,1,2,3,-1,1,0,0,4,-29,4,-10,6,4,0,-1,1,-1,-1,1,4,-1
KR_6753948031,420,-2,1,-21,2,-3,4,1,-2,5,3,12,1,13,-5,7,2,0,0,0,1,12,-6,-4,-2,6,4,0,-1,-1,-1,-1,1,2,-1
KR_6737885882,420,-2,-70,-12,-5,1,2,3,-1,4,3,-4,6,2,0,3,3,-1,1,0,-1,3,-8,-2,-4,6,2,0,-1,-1,-1,-1,-1,4,-1
KR_6763295161,440,-2,-55,-24,-5,-1,4,3,-2,2,0,-1,2,1,2,3,5,-3,3,0,0,0,-7,0,-4,4,-5,0,-2,-1,1,1,1,4,-1
KR_6775345771,420,-4,-60,6,-10,-1,2,1,-1,4,3,-3,5,2,-2,3,1,-3,5,2,0,-15,-5,-6,-3,9,2,0,-3,-1,-1,-1,1,3,-1
KR_6726398850,440,0,-54,-3,-1,1,0,1,-3,5,2,1,1,2,1,1,2,-1,1,0,0,-4,0,2,-9,7,-2,0,0,-1,1,-1,1,5,-1
KR_6777799567,420,-2,1,12,-5,-3,3,0,2,2,4,-2,3,1,-2,4,2,0,2,2,0,-3,6,2,-8,6,-3,0,1,1,1,1,1,2,-1
KR_6639561650,420,-9,-176,-10,-17,-3,6,3,-4,6,2,-5,5,0,-5,6,1,0,0,0,0,-15,-4,-3,-4,7,-6,-1,-6,-1,-1,-1,-1,6,-1
KR_6682839609,420,-3,-39,2,-12,0,3,3,-3,3,0,-5,5,0,-4,4,0,0,1,1,0,-15,-43,-4,-5,9,4,0,-1,-1,-1,-1,-1,6,-1
KR_6770954880,420,0,-89,22,-2,-1,4,3,9,1,10,-3,4,1,-7,8,1,0,0,0,0,-2,47,-1,-7,8,0,0,-1,-1,1,-1,1,6,-1
KR_6715370063,420,-1,-30,-29,5,1,1,2,-3,4,1,0,1,1,6,2,8,1,0,1,1,6,-8,-6,-5,11,7,0,0,-1,-1,1,1,1,-1
KR_6764277578,420,-5,-71,-4,-9,-8,8,0,-7,10,3,3,0,3,0,5,5,3,0,3,0,0,14,6,-10,4,-7,0,-1,1,-1,-1,1,6,-1
KR_6732156871,420,-7,-85,8,-17,-1,3,2,-1,2,1,-6,6,0,-8,8,0,-1,1,0,-1,-23,-12,-7,0,7,0,0,-2,-1,-1,-1,-1,4,-1
KR_6708812493,420,-5,-66,-14,-6,-2,3,1,-2,3,1,-2,3,1,-2,3,1,2,2,4,0,-6,24,1,-5,4,3,0,0,-1,1,0,-1,2,-1
KR_6766961486,420,0,-38,-16,-4,3,0,3,-3,4,1,-4,7,3,0,2,2,0,0,0,0,-4,-35,0,-8,8,24,0,0,-1,-1,0,-1,4,-1
KR_6764202789,420,-5,-90,-8,-9,0,1,1,-4,8,4,-1,1,0,-3,4,1,-1,1,0,0,-9,-5,-7,-1,8,-5,0,-3,1,-1,-1,-1,3,-1
KR_6761825218,420,-2,-36,20,-5,0,2,2,-2,5,3,1,1,2,-3,5,2,-1,1,0,0,-15,-10,-3,-5,8,2,0,-1,1,-1,-1,-1,2,-1
KR_6766183480,440,-2,17,-19,-4,-1,1,0,0,3,3,-4,5,1,1,0,1,0,0,0,0,0,6,0,-5,5,0,0,-1,-1,-1,-1,-1,6,-1
KR_6775312521,420,-1,-76,-3,-1,2,1,3,0,6,6,0,1,1,-5,5,0,2,1,3,0,-2,61,-6,-3,9,-30,0,-2,-1,1,-1,-1,3,-1
KR_6777172282,420,-3,-41,-20,-5,-3,5,2,-3,5,2,0,1,1,-1,2,1,2,0,2,0,-7,14,-2,-7,9,-11,0,0,1,-1,0,-1,5,-1
KR_6758944799,420,-7,-89,-38,-7,-3,3,0,-2,2,0,-1,1,0,-1,2,1,0,0,0,-1,-9,-28,-3,-2,5,-4,0,-1,-1,-1,-1,-1,5,-1
KR_6772142424,420,-1,-73,-1,-3,-3,5,2,-1,2,1,-2,3,1,4,1,5,-1,1,0,-1,2,-221,1,-8,7,-3,0,-1,1,-1,-1,-1,1,-1
KR_6777794995,440,1,17,16,0,-3,4,1,1,2,3,2,2,4,0,3,3,0,2,2,0,1,-5,-3,-3,6,4,0,0,1,-1,-1,1,6,-1
KR_6770489232,420,1,-13,-15,3,-1,1,0,-3,4,1,6,0,6,-1,4,3,2,1,3,1,11,-221,0,-7,7,-1,0,0,-1,-1,0,1,1,-1
KR_6737416046,420,-1,4,4,-3,6,1,7,-3,3,0,-1,3,2,-4,6,2,-1,3,2,0,-7,3,-3,-4,7,4,0,-1,-1,-1,-1,-1,2,-1
KR_6656675932,420,1,16,16,0,1,0,1,-3,4,1,-2,2,0,5,2,7,-1,3,2,0,3,1,-3,-5,8,2,0,0,1,-1,0,1,6,-1
KR_6773940216,420,-1,-8,-35,5,3,2,5,2,5,7,2,1,3,-3,5,2,1,0,1,0,0,6,4,-7,3,-6,0,0,1,-1,0,-1,1,-1
KR_6767730308,420,4,35,8,8,1,1,2,4,2,6,-1,3,2,4,1,5,0,0,0,0,14,34,1,-6,5,1,0,2,-1,-1,1,-1,3,-1
KR_6776763242,420,-4,-88,-9,-4,-1,1,0,0,2,2,-5,5,0,-3,4,1,5,2,7,1,1,-32,-2,-3,5,0,0,-1,1,-1,-1,1,6,-1
KR_6777265761,420,0,46,15,-4,1,4,5,-1,4,3,-5,6,1,1,1,2,0,0,0,0,-11,118,2,-5,3,-4,0,0,1,1,0,-1,2,-1
KR_6704251076,420,1,8,10,1,1,2,3,-2,4,2,-1,5,4,3,0,3,0,0,0,0,5,64,-2,-8,10,1,0,1,1,-1,1,1,6,-1
KR_6749282909,440,-1,-25,6,1,2,2,4,-4,4,0,4,2,6,-3,4,1,2,2,4,0,1,16,1,-5,4,6,0,1,-1,1,1,1,6,-1
KR_6777128044,420,0,20,-3,2,-5,7,2,0,2,2,1,6,7,5,0,5,1,1,2,0,10,6,1,-3,2,-1,0,-1,0,1,-1,1,0,-1
KR_6764950086,440,3,29,-19,15,4,1,5,1,3,4,9,0,9,-1,5,4,2,1,3,1,21,2,-2,-6,8,4,0,2,-1,1,1,1,3,-1
KR_6755013524,420,-4,-15,-41,-12,-4,5,1,-2,8,6,-7,7,0,-1,3,2,2,1,3,0,-11,-6,0,-5,5,-1,0,-1,-1,-1,-1,1,4,-1
KR_6775295865,420,-3,15,10,-5,-1,2,1,-1,6,5,-1,3,2,1,4,5,-3,4,1,1,-3,41,-1,-5,6,6,0,0,1,-1,0,1,5,-1
KR_6774484772,420,0,18,-12,4,-1,2,1,-1,6,5,2,2,4,4,2,6,0,1,1,0,10,-16,1,-6,5,-4,0,-1,1,-1,-1,1,3,-1
KR_6751274256,420,-1,41,8,-5,1,1,2,-2,3,1,1,3,4,-5,5,0,0,1,1,0,-7,43,1,-11,10,-23,0,-1,1,-1,1,-1,2,-1
KR_6749812876,420,-6,-52,-13,-12,-3,4,1,0,2,2,-1,2,1,-7,7,0,-1,2,1,1,-16,3,4,-9,5,-2,0,-1,-1,1,-1,1,2,-1
KR_6744035265,420,0,-22,-4,1,3,1,4,1,5,6,-3,4,1,-2,5,3,2,0,2,0,5,42,5,-7,2,-6,0,0,-1,1,1,1,4,-1
KR_6688039743,420,-2,-55,28,-15,2,0,2,-8,8,0,-3,6,3,-5,6,1,-1,2,1,0,-24,5,-4,-2,6,-2,0,-3,-1,-1,-1,-1,1,-1
KR_6766914629,420,-6,-176,24,-12,-6,7,1,-3,4,1,-4,8,4,1,0,1,0,0,0,0,-8,-15,0,-2,2,0,0,-3,1,-1,-1,-1,6,-1
KR_6776969280,420,-8,-121,-12,-17,-2,2,0,-2,3,1,-7,8,1,-5,5,0,-1,1,0,0,-17,-5,-2,-3,5,-2,0,-4,0,-1,-1,-1,0,-1
KR_6760805844,420,-1,-69,12,7,3,1,4,-1,5,4,3,1,4,1,3,4,1,0,1,2,8,21,3,-8,5,-3,0,0,1,1,0,1,3,-1
KR_6777484907,420,-1,5,5,-10,-1,2,1,0,1,1,-4,8,4,-4,5,1,-1,2,1,0,-15,-8,-5,-3,8,-1,0,0,1,1,0,-1,3,-1
KR_6739132246,420,-2,51,-23,-13,0,1,1,-5,8,3,-6,6,0,-2,3,1,0,0,0,0,-19,17,1,-7,6,2,0,-1,-1,-1,-1,-1,6,-1
KR_6751698546,420,1,-28,1,-4,-2,3,1,-3,8,5,2,1,3,1,0,1,-2,3,1,0,0,4,4,-7,3,-4,0,0,-1,-1,1,-1,6,-1
KR_6769304276,420,-4,-72,27,-7,-4,4,0,0,2,2,-1,4,3,-1,4,3,-1,4,3,0,-5,-1,5,-6,1,0,0,-1,-1,1,-1,1,2,-1
KR_6727283948,420,-4,-31,12,-13,-4,5,1,-3,5,2,-4,6,2,-3,5,2,1,0,1,0,-4,-21,-4,-7,11,3,0,0,-1,-1,-1,-1,4,-1
KR_6775484596,420,1,49,9,0,6,1,7,-5,5,0,-4,4,0,-2,5,3,5,0,5,0,-13,-7,5,-9,4,-4,0,1,1,1,1,1,3,-1
KR_6748108402,420,3,0,-21,3,-3,3,0,-1,2,1,1,1,2,3,3,6,3,0,3,0,5,-1,-2,-3,5,0,0,0,-1,1,0,1,1,-1
KR_6766991015,420,1,-42,35,0,3,1,4,-7,9,2,3,2,5,3,1,4,-2,2,0,2,-8,9,-2,-6,8,0,0,-1,-1,1,-1,1,1,-1
KR_6676180866,420,-4,-21,-29,-14,0,2,2,-4,6,2,-7,7,0,-4,6,2,1,0,1,0,-7,-2,-1,-5,6,3,0,0,-1,-1,-1,-1,1,-1
KR_6666254082,420,2,68,14,0,-2,4,2,4,1,5,5,0,5,-5,5,0,-2,2,0,0,-2,-19,-4,-8,12,-2,0,-1,1,0,-1,-1,5,-1
KR_6735004417,420,-5,39,-11,-13,3,0,3,-8,8,0,-2,4,2,-3,5,2,-3,3,0,0,-25,-8,-7,-4,11,7,0,0,-1,1,1,-1,5,-1
KR_6741775332,420,-1,-4,-11,2,1,2,3,-4,5,1,0,1,1,5,2,7,0,1,1,0,-6,1,3,-9,6,-1,0,1,1,-1,1,1,5,-1
KR_6762485529,440,-5,-36,15,-4,-1,2,1,-2,3,1,0,1,1,-1,4,3,0,1,1,0,-1,-20,-1,-4,5,3,0,-2,-1,1,-1,1,4,-1
KR_6775669573,420,-1,34,-16,-5,0,2,2,-6,9,3,-1,2,1,3,4,7,-1,1,0,-1,3,-218,-6,-3,9,0,0,1,-1,-1,1,-1,1,-1
KR_6770519605,420,-1,11,-7,1,-1,2,1,5,5,10,-2,4,2,0,0,0,-1,1,0,-1,4,8,-1,-5,6,4,0,1,-1,1,1,-1,2,-1
KR_6745935860,440,-2,16,-15,-1,1,1,2,3,2,5,-2,2,0,-3,5,2,0,1,1,-1,-7,2,-3,-2,5,1,0,0,-1,0,0,-1,1,-1
KR_6770513452,420,-7,-54,-5,-23,-1,1,0,-2,3,1,-10,11,1,-10,11,1,0,0,0,-2,-20,41,1,-5,4,-4,0,-1,0,-1,-1,-1,0,-1
KR_6743397469,420,-3,-3,-32,-4,-4,5,1,2,4,6,0,0,0,-2,4,2,0,0,0,0,-5,30,-4,-3,7,2,0,0,1,-1,0,1,4,-1
KR_6772482665,420,-3,-11,-23,-12,1,1,2,-2,3,1,-3,3,0,-8,10,2,0,0,0,0,-15,171,1,-4,3,-20,0,2,-1,1,1,-1,4,-1
KR_6773164653,420,-1,9,-10,-2,1,1,2,-2,4,2,-3,3,0,1,2,3,1,0,1,0,13,-42,0,-8,8,0,0,0,-1,1,0,1,2,-1
KR_6768462632,420,-2,-40,-4,-4,10,0,10,-3,3,0,-9,9,0,-4,9,5,2,0,2,-1,-14,2,-1,-7,8,2,0,1,-1,1,1,-1,6,-1
KR_6764612257,420,-2,-9,-19,-2,-1,3,2,3,2,5,-3,4,1,1,3,4,-2,3,1,-2,-4,1,1,-7,6,-1,0,-2,-1,-1,-1,-1,3,-1
KR_6734560828,420,1,63,-18,2,1,0,1,3,2,5,1,5,6,-3,5,2,0,3,3,0,5,7,1,-6,5,5,0,0,1,-1,-1,-1,4,-1
KR_6776972770,420,2,40,-7,8,6,0,6,-2,5,3,8,0,8,-5,8,3,1,1,2,0,6,158,5,-9,4,-4,0,1,1,-1,1,-1,5,-1
KR_6716709593,420,-3,-42,-24,-5,-4,4,0,-3,5,2,1,2,3,0,4,4,1,1,2,1,-1,-4,-1,-6,7,-1,0,-1,-1,-1,-1,1,2,-1
KR_6767481741,440,-5,-16,-45,-12,-2,2,0,-4,5,1,-4,4,0,0,2,2,-2,2,0,0,-16,-15,-4,-2,6,3,0,0,-1,1,-1,-1,1,-1
KR_6757258587,420,-2,-63,-30,0,0,1,1,1,3,4,-2,2,0,2,2,4,-1,1,0,0,4,115,5,-6,1,2,0,1,-1,1,1,1,4,-1
KR_6692178467,420,-1,59,-34,-6,2,0,2,-2,7,5,-1,3,2,-3,7,4,-2,2,0,0,-25,-4,-8,-1,9,-2,0,0,-1,1,1,1,2,-1
KR_6762663640,420,-1,-41,15,4,1,3,4,2,4,6,-2,4,2,2,2,4,1,0,1,1,14,15,-1,-7,8,11,0,0,-1,1,1,1,1,-1
KR_6760912747,420,-2,-70,4,-4,3,1,4,-4,6,2,5,3,8,-7,8,1,-1,1,0,0,-5,-13,0,-5,5,0,0,0,1,1,1,-1,2,-1
KR_6747890941,420,-1,1,-22,-5,-1,1,0,-5,6,1,3,0,3,-2,2,0,0,1,1,-1,-4,-21,-1,-10,11,-3,0,-1,1,-1,-1,-1,5,-1
KR_6763607095,420,-2,-50,-36,-4,1,2,3,0,2,2,-2,3,1,-3,4,1,0,0,0,0,-3,-21,-6,-1,7,0,0,-1,-1,1,-1,1,4,-1
KR_6741508925,420,2,57,24,-7,1,4,5,-2,6,4,-2,5,3,-3,8,5,-1,1,0,-1,-18,41,-4,-2,6,-12,0,1,-1,1,-1,-1,2,-1
KR_6735966631,420,2,-3,-20,2,-7,8,1,2,3,5,3,1,4,3,2,5,1,0,1,-1,-1,326,-8,-3,11,-24,0,1,1,-1,1,-1,6,-1
KR_6773634456,420,-1,28,-16,-5,-1,2,1,-2,4,2,0,3,3,-1,2,1,-1,1,0,-1,-9,9,3,-6,3,-1,0,1,-1,1,1,-1,4,-1
KR_6772037400,440,-2,-25,-3,-1,1,1,2,-1,2,1,-1,2,1,-1,5,4,1,0,1,0,-6,8,7,-11,4,0,0,1,-1,1,1,-1,4,-1
KR_6704270285,420,-3,-126,0,-6,-2,2,0,-2,5,3,-1,3,2,-3,6,3,2,0,2,0,-1,-43,-1,-5,6,16,0,-2,1,-1,-1,-1,6,-1
KR_6776856913,420,-4,-80,-20,-10,4,1,5,-2,3,1,-2,3,1,-10,10,0,0,1,1,0,-9,-15,-5,-2,7,5,0,-1,-1,-1,-1,-1,2,-1
KR_6776968413,420,-2,-31,-24,-9,1,0,1,-6,9,3,2,0,2,-1,2,1,-5,6,1,1,-17,-11,-5,-3,8,0,0,-2,-1,-1,-1,1,2,-1
KR_6776590943,420,-3,3,-30,-4,-2,2,0,3,1,4,-3,3,0,-2,7,5,0,2,2,0,0,8,-3,-4,7,-1,0,-1,-1,-1,-1,1,5,-1
KR_6709254721,420,-2,-29,9,-5,4,0,4,-5,5,0,0,4,4,-1,4,3,-3,5,2,1,-15,-2,4,-13,9,2,0,-1,1,-1,-1,1,5,-1
KR_6776208947,420,0,-10,-33,-1,-2,4,2,3,2,5,-2,3,1,1,2,3,-1,1,0,0,5,137,2,-6,4,1,0,-1,1,-1,-1,1,1,-1
KR_6774050784,420,-3,-74,19,-12,-3,3,0,-7,7,0,-2,3,1,0,7,7,0,2,2,0,-9,-2,-2,-4,6,1,0,-1,1,1,-1,-1,3,-1
KR_6749552878,420,-4,-76,-39,-16,-2,4,2,-3,3,0,-3,6,3,-8,10,2,0,0,0,-2,-17,42,0,-5,5,-5,0,0,0,-1,0,-1,0,-1
KR_6741475017,420,-3,-11,-5,-7,-3,3,0,1,6,7,0,1,1,-4,5,1,-1,1,0,0,-4,-5,1,-6,5,-2,0,-1,0,-1,-1,-1,0,-1
KR_6777846352,420,-1,-35,-4,-1,2,1,3,0,2,2,1,2,3,-3,3,0,-1,2,1,0,-1,-1,1,-5,4,-9,0,-2,-1,-1,-1,-1,6,-1
KR_6756996214,420,2,-28,0,5,0,1,1,0,2,2,3,0,3,1,0,1,1,0,1,0,3,63,2,-9,7,-1,0,0,1,-1,0,1,5,-1
KR_6740575664,420,-1,-22,24,-5,0,2,2,-3,6,3,-2,3,1,0,4,4,0,0,0,0,-8,-28,-3,-7,10,10,0,0,1,-1,-1,-1,3,-1
KR_6740245111,420,3,23,-9,8,3,2,5,0,3,3,4,0,4,2,1,3,-1,1,0,1,9,109,-2,-6,8,3,0,1,1,-1,-1,1,4,-1
KR_6769000132,420,-1,-22,-22,-7,-5,6,1,5,1,6,-4,5,1,0,4,4,-3,4,1,-1,-6,-15,-7,-2,9,7,0,0,-1,1,-1,-1,2,-1
KR_6734429301,420,-6,-57,-30,-9,2,0,2,-7,7,0,-4,5,1,0,0,0,0,0,0,0,-9,12,0,-6,6,0,0,0,1,-1,-1,-1,3,-1
KR_6774087698,420,0,38,0,-7,-2,3,1,-5,5,0,-1,4,3,0,3,3,1,0,1,0,-10,1,1,-5,4,1,0,-2,-1,-1,1,-1,5,-1
KR_6773108734,420,-2,-6,20,-6,2,0,2,-3,5,2,-3,4,1,-4,4,0,2,0,2,0,-5,-4,0,-7,7,-4,0,0,-1,1,1,-1,3,-1
KR_6776403356,420,-2,-7,-4,-1,-1,3,2,-3,3,0,3,1,4,0,2,2,0,0,0,0,2,-9,1,-7,6,2,0,-1,-1,1,1,-1,1,-1
KR_6771774369,420,-2,28,-19,-6,1,1,2,-2,2,0,-1,2,1,-4,4,0,0,0,0,0,-11,10,-1,-4,5,-4,0,1,-1,1,1,-1,4,-1
KR_6772397004,420,0,-18,-1,-3,0,1,1,1,2,3,-2,3,1,-1,2,1,-1,1,0,0,-7,-5,-6,-3,9,25,0,0,-1,1,1,-1,3,-1
KR_6774375406,420,2,32,-16,7,6,1,7,0,3,3,0,1,1,3,0,3,-2,3,1,-3,-3,6,2,-5,3,-4,0,2,-1,-1,1,-1,3,-1
KR_6776149212,420,-1,-20,25,-7,-1,2,1,-7,8,1,3,3,6,1,3,4,-3,4,1,1,-6,-9,-3,-5,8,-1,0,-2,1,-1,-1,1,5,-1
KR_6756356878,420,0,-47,10,-2,0,2,2,2,1,3,0,1,1,-2,4,2,-2,2,0,0,-9,-12,-3,-6,9,8,0,0,-1,1,0,1,3,-1
KR_6725596482,420,-1,46,11,0,0,0,0,-1,2,1,-3,3,0,4,0,4,0,1,1,0,1,5,3,-9,6,2,0,0,1,-1,1,1,3,-1
KR_6769252042,420,4,112,-9,5,3,0,3,0,2,2,2,1,3,0,4,4,0,0,0,0,0,-28,-1,-5,6,0,0,2,1,1,1,1,1,-1
KR_6768653350,420,-6,-98,-28,-11,-7,7,0,-2,3,1,2,4,6,-3,4,1,-1,1,0,0,-18,-6,-4,-3,7,-7,0,0,-1,-1,-1,-1,4,-1
KR_6754375978,420,-1,13,-12,4,-5,7,2,4,3,7,1,0,1,0,0,0,4,0,4,0,9,18,1,-8,7,3,0,1,1,1,1,-1,2,-1
KR_6767772639,420,1,-35,-20,-4,0,3,3,-1,2,1,0,3,3,-2,3,1,-1,4,3,0,1,11,-2,-3,5,0,0,0,-1,1,0,-1,5,-1
KR_6750194888,420,-1,-76,-28,-4,2,0,2,-3,6,3,2,3,5,-5,7,2,0,0,0,0,4,-55,-4,-4,8,4,0,-3,-1,-1,-1,-1,5,-1
KR_6775393753,440,2,62,6,-6,-3,3,0,-3,6,3,1,3,4,-1,2,1,0,0,0,0,-8,-39,-4,-4,8,10,0,-1,1,-1,-1,-1,1,-1
KR_6723662483,420,-1,26,32,-3,-1,2,1,2,2,4,0,3,3,-4,5,1,0,2,2,1,-8,-31,0,-8,8,0,0,-1,-1,1,-1,1,3,-1
KR_6771466074,420,-3,-94,21,-5,1,1,2,3,1,4,-3,4,1,-5,7,2,-1,1,0,-1,-1,22,4,-9,5,0,0,-2,-1,-1,-1,-1,2,-1
KR_6746847114,420,4,24,5,-1,1,2,3,1,5,6,1,3,4,-6,8,2,2,3,5,1,-10,-6,1,-7,6,-4,0,0,-1,1,-1,1,4,-1
KR_6700638873,420,-3,-5,0,-4,0,1,1,-4,5,1,-1,3,2,0,4,4,1,0,1,0,-3,-3,2,-6,4,0,0,0,-1,1,-1,1,3,-1
KR_6772328125,420,1,-28,24,-2,0,2,2,1,2,3,1,0,1,-6,7,1,2,1,3,0,-5,8,2,-7,5,0,0,-1,1,1,-1,-1,6,-1
KR_6766240880,420,0,2,-20,-4,-2,2,0,-2,5,3,2,1,3,-2,2,0,0,1,1,-1,-6,-25,-1,-8,9,6,0,1,1,1,1,-1,5,-1
KR_6745320228,420,-5,-101,-23,-6,-5,5,0,1,2,3,-3,4,1,0,2,2,1,2,3,-1,-2,8,-4,-4,8,-5,0,-3,-1,-1,-1,-1,3,-1
KR_6772734156,420,-1,-5,-26,-2,-5,8,3,-2,2,0,1,2,3,2,2,4,2,0,2,0,10,-2,2,-9,7,5,0,-1,1,-1,-1,-1,3,-1
KR_6762772421,420,-1,-29,-4,2,2,1,3,0,3,3,3,0,3,-2,3,1,-1,2,1,0,1,-5,-2,-5,7,1,0,0,-1,-1,-1,1,3,-1
KR_6777610172,440,-3,-7,-5,-6,0,1,1,-1,3,2,-1,3,2,-4,4,0,0,1,1,0,-6,35,-4,-5,9,-1,0,-1,-1,1,-1,-1,6,-1
KR_6757780132,420,2,16,10,2,-3,3,0,-2,3,1,5,2,7,2,1,3,0,1,1,1,2,-6,-2,-6,8,6,0,0,1,1,0,1,6,-1
KR_6741980712,440,4,7,12,12,8,0,8,3,3,6,-1,1,0,2,0,2,0,1,1,0,6,-21,6,-9,3,-6,0,1,-1,1,1,1,2,-1
KR_6774502599,420,0,44,-22,0,-1,2,1,-2,5,3,0,3,3,1,1,2,2,0,2,0,1,1,-3,-2,5,4,0,0,1,-1,0,1,1,-1
KR_6758738341,420,3,56,-27,5,2,4,6,-3,6,3,1,1,2,5,0,5,0,1,1,0,-3,-10,0,-8,8,1,0,0,-1,-1,-1,1,6,-1
KR_6731980723,420,0,37,-15,0,0,1,1,-1,4,3,-2,3,1,3,0,3,0,0,0,0,8,-5,0,-5,5,6,0,-1,1,1,-1,1,4,-1
KR_6734500666,420,0,9,-24,-5,-1,4,3,-3,4,1,-2,7,5,1,1,2,0,0,0,0,-2,8,2,-7,5,-6,0,0,1,1,1,-1,5,-1
KR_6758660891,420,-2,-23,5,-4,-1,2,1,1,4,5,-3,4,1,-1,1,0,0,1,1,-1,-7,18,-2,-7,9,-9,0,-1,-1,-1,-1,-1,4,-1
KR_6762294096,420,-1,24,0,-2,5,0,5,-1,2,1,-3,5,2,-2,3,1,-1,1,0,0,-9,5,6,-10,4,-9,0,0,-1,1,1,1,5,-1
KR_6742329825,420,-2,-23,5,-7,0,2,2,-1,4,3,-6,6,0,-1,2,1,1,0,1,0,-13,-3,3,-8,5,-2,0,0,1,-1,-1,1,5,-1
KR_6774979758,420,-2,-3,-16,-9,0,0,0,1,2,3,-2,2,0,-5,8,3,-3,3,0,0,-15,4,0,-9,9,-13,0,-1,-1,-1,-1,-1,5,-1
KR_6772289342,420,-6,-45,-16,-19,-8,9,1,-5,7,2,-7,7,0,1,2,3,0,0,0,0,-8,1,2,-7,5,-4,0,-1,1,-1,-1,1,4,-1
KR_6760004000,420,1,44,-32,9,3,2,5,3,2,5,1,0,1,2,1,3,0,0,0,0,10,5,4,-9,5,-1,0,0,1,1,0,1,5,-1
KR_6736339895,420,-3,-32,-7,-6,-1,2,1,3,2,5,1,2,3,-7,8,1,-2,2,0,0,-10,-1,0,-7,7,-6,0,-3,-1,1,-1,-1,3,-1
KR_6769970195,440,-1,4,-37,4,1,3,4,1,1,2,0,3,3,1,4,5,1,1,2,0,0,0,1,-7,6,2,0,-1,1,1,-1,1,4,-1
KR_6733235967,420,-4,-48,8,-10,1,2,3,-1,2,1,-3,4,1,-6,6,0,-1,1,0,0,-11,32,1,-9,8,-39,0,-3,-1,-1,-1,-1,5,-1
KR_6766093944,440,0,-44,-24,1,-3,3,0,0,1,1,-1,5,4,2,0,2,3,0,3,0,10,-6,-4,-2,6,-1,0,-1,-1,-1,-1,1,6,-1
KR_6692327327,420,-3,-23,-6,-3,-7,7,0,-2,4,2,1,1,2,0,1,1,5,0,5,0,-8,0,-4,-5,9,4,0,0,1,-1,1,1,2,-1
KR_6775373742,420,-4,-32,-34,-8,0,0,0,-4,5,1,1,1,2,-3,4,1,-2,2,0,0,-11,-4,-3,-7,10,3,0,0,-1,1,0,-1,6,-1
KR_6729459621,420,0,-32,12,0,-5,5,0,4,3,7,1,2,3,-2,2,0,2,0,2,0,2,-28,-4,-6,10,-4,0,-1,1,-1,-1,1,4,-1
KR_6731460187,420,-3,-31,24,-5,-2,3,1,1,1,2,6,1,7,-10,12,2,0,0,0,0,-7,-22,-4,-4,8,2,0,-2,1,-1,-1,1,4,-1
KR_6777236023,420,-1,-25,1,3,4,0,4,0,3,3,-3,3,0,2,0,2,0,0,0,0,3,-42,0,-3,3,23,0,0,-1,-1,0,1,1,-1
KR_6776711258,420,-3,-4,24,-5,0,3,3,-1,2,1,-2,2,0,-3,4,1,1,0,1,0,-12,4,0,-7,7,-4,0,0,-1,-1,0,1,6,-1
KR_6727792489,420,-2,-41,-10,-2,-4,4,0,0,4,4,1,0,1,1,0,1,0,1,1,1,-4,-1,0,-5,5,2,0,0,1,-1,-1,1,4,-1
KR_6776833229,420,2,1,31,4,0,1,1,2,1,3,0,3,3,1,3,4,1,0,1,0,-2,-1,-4,-4,8,-3,0,1,1,1,1,1,6,-1
KR_6771859672,440,1,-24,3,-2,-1,2,1,6,0,6,0,2,2,-6,7,1,-1,1,0,0,7,8,0,-8,8,-3,0,-1,1,-1,-1,-1,3,-1
KR_6774541174,420,-4,-68,8,-18,-4,4,0,-4,4,0,-2,2,0,-6,6,0,-2,2,0,0,-23,16,-2,-5,7,-5,0,-3,-1,-1,-1,-1,4,-1
KR_6682181688,420,-2,19,-15,3,-1,2,1,-2,4,2,5,0,5,3,6,9,-2,2,0,0,8,-109,1,-11,10,-6,0,-1,1,-1,-1,-1,4,-1
KR_6774799216,440,-1,-80,4,-1,-2,5,3,1,2,3,4,1,5,-3,6,3,-1,2,1,0,6,6,1,-7,6,-5,0,0,0,-1,0,-1,0,-1
KR_6771754827,420,-6,-15,8,-10,-3,3,0,-1,3,2,-2,3,1,-5,7,2,1,1,2,0,-7,-16,-2,-4,6,4,0,0,-1,-1,-1,-1,2,-1
KR_6775796748,420,-3,17,7,-4,-5,5,0,0,2,2,2,3,5,1,1,2,-2,2,0,0,-2,-1,1,-7,6,-3,0,0,1,-1,0,1,3,-1
KR_6750336980,420,0,-40,28,-7,0,1,1,-3,4,1,-1,2,1,0,2,2,-3,4,1,0,-8,-8,-4,-6,10,6,0,2,-1,1,1,-1,5,-1
KR_6775146534,420,-1,13,15,-2,-3,3,0,0,4,4,0,3,3,1,3,4,0,1,1,0,3,13,-3,-4,7,-2,0,-1,1,1,-1,-1,2,-1
KR_6746171423,420,-2,-27,19,-7,2,1,3,1,0,1,2,2,4,-2,5,3,-10,10,0,-1,-12,-10,-2,-6,8,3,0,0,1,1,-1,-1,6,-1
KR_6769710195,440,0,-16,15,-3,-2,3,1,1,2,3,0,1,1,-4,4,0,2,0,2,0,-5,-15,-2,-5,7,-2,0,0,-1,0,0,-1,4,-1
KR_6770328935,420,0,-48,-4,-2,0,5,5,-2,4,2,0,2,2,0,3,3,0,0,0,-1,4,10,5,-8,3,-1,0,1,-1,-1,1,-1,2,-1
KR_6774554870,420,-4,-37,0,-7,-1,2,1,-2,5,3,-2,3,1,-1,4,3,-1,1,0,0,-12,-5,-1,-6,7,0,0,0,-1,1,1,-1,2,-1
KR_6761837272,440,-2,-114,16,1,3,0,3,6,1,7,-2,8,6,-4,4,0,-2,6,4,1,2,-3,3,-4,1,-4,0,1,1,1,1,1,4,-1
KR_6761935215,420,1,-3,-24,3,-1,1,0,2,2,4,-1,1,0,3,0,3,0,0,0,0,8,-10,1,-7,6,-1,0,1,1,1,1,1,1,-1
KR_6687782682,420,-1,69,-3,-2,-1,2,1,0,1,1,-3,3,0,3,0,3,-1,1,0,0,-2,-1,2,-6,4,6,0,-1,-1,-1,-1,-1,5,-1
KR_6761848298,440,2,95,9,-1,3,0,3,0,3,3,-1,5,4,-3,4,1,0,1,1,-1,-11,1,-3,-3,6,2,0,0,1,1,1,-1,4,-1
KR_6769644076,420,-3,-48,-6,-4,0,1,1,-4,5,1,-1,2,1,1,3,4,0,3,3,1,1,-3,0,-8,8,-1,0,-2,-1,1,-1,1,3,-1
KR_6709535309,420,-2,-42,45,-9,-2,3,1,-9,9,0,2,0,2,-1,2,1,1,0,1,0,-17,0,0,-4,4,0,0,-2,-1,-1,-1,-1,6,-1
KR_6768051958,420,3,-37,13,1,0,2,2,-2,4,2,3,2,5,-1,4,3,1,1,2,0,-9,-105,2,-8,6,-6,0,0,-1,1,1,1,2,-1
KR_6776233809,420,1,-55,8,8,0,2,2,-1,3,2,4,2,6,5,4,9,0,2,2,0,-3,11,4,-10,6,0,0,0,-1,1,0,-1,3,-1
KR_6772617730,420,-2,-1,-14,-8,-1,1,0,-1,4,3,-2,2,0,-2,3,1,-2,2,0,0,-8,-30,-5,-3,8,-6,0,-1,-1,-1,-1,1,3,-1
KR_6773560679,420,-5,-55,8,-8,-6,7,1,1,2,3,-4,5,1,1,2,3,0,0,0,0,-4,-19,2,-5,3,-4,0,-1,-1,1,-1,1,5,-1
KR_6774129543,420,-3,-28,-17,-5,4,0,4,-3,4,1,-1,2,1,-2,5,3,-3,4,1,-1,2,-8,-1,-7,8,6,0,0,-1,-1,0,-1,2,-1
KR_6775822883,420,2,51,-9,2,0,3,3,3,1,4,-2,4,2,0,4,4,1,0,1,1,0,-5,2,-7,5,-2,0,0,-1,-1,-1,1,3,-1
KR_6777104171,420,1,-11,9,1,-3,5,2,3,1,4,2,0,2,0,1,1,-1,1,0,0,-1,4,3,-9,6,1,0,0,1,-1,-1,1,4,-1
KR_6774708753,420,-1,-57,-8,-10,0,2,2,-2,3,1,-1,1,0,-5,5,0,-2,2,0,0,-17,30,-2,-6,8,-23,0,0,-1,-1,-1,1,5,-1
KR_6763002276,420,0,-10,29,-4,-1,2,1,0,3,3,5,0,5,-5,8,3,-3,3,0,0,7,49,0,-7,7,3,0,0,-1,-1,0,-1,4,-1
KR_6776600984,420,4,3,16,2,3,3,6,-4,7,3,0,3,3,0,4,4,3,1,4,-2,9,26,-6,-8,14,3,0,1,-1,-1,-1,1,3,-1
KR_6774895561,420,3,-54,8,0,0,1,1,-2,3,1,0,0,0,2,2,4,0,2,2,0,8,-9,-4,-4,8,-1,0,-1,1,-1,-1,-1,1,-1
KR_6755096280,420,0,44,22,-4,-2,3,1,1,8,9,-2,3,1,-2,5,3,1,1,2,1,-11,-15,1,-10,9,3,0,-1,1,-1,-1,1,5,-1
KR_6733951133,420,0,2,-9,0,4,0,4,-2,6,4,2,5,7,-4,5,1,0,2,2,0,1,-11,-2,-6,8,-2,0,1,-1,1,1,-1,5,-1
KR_6774700495,420,-3,10,-12,-6,-2,3,1,-1,3,2,-2,2,0,0,3,3,-1,2,1,0,-8,140,1,-7,6,-9,0,0,1,-1,0,1,6,-1
KR_6774656033,420,1,-20,8,2,1,1,2,3,2,5,-1,3,2,-2,5,3,1,1,2,0,7,50,0,-5,5,1,0,-1,1,1,-1,-1,3,-1
KR_6770540833,420,0,-41,-8,6,2,0,2,2,3,5,0,1,1,2,2,4,0,0,0,1,5,3,-1,-6,7,1,0,-1,1,-1,-1,1,4,-1
KR_6771884017,420,2,-25,5,0,1,1,2,3,3,6,-6,7,1,-1,1,0,3,2,5,-1,10,1,0,-4,4,2,0,0,-1,1,0,-1,1,-1
KR_6753958706,420,-1,23,-21,1,-1,2,1,1,3,4,4,0,4,-4,4,0,1,0,1,0,-1,-2,1,-8,7,0,0,0,-1,-1,0,-1,2,-1
KR_6752854099,440,-3,-136,-3,-6,-3,5,2,-6,7,1,3,1,4,-1,4,3,1,0,1,0,6,-5,1,-7,6,2,0,0,1,-1,-1,-1,4,-1
KR_6691967067,420,-3,-52,20,-6,-1,1,0,-1,4,3,-3,4,1,-1,2,1,0,1,1,0,-5,2,1,-7,6,-3,0,0,1,-1,-1,-1,1,-1
KR_6775364122,420,-4,-21,13,-6,0,3,3,-4,4,0,4,0,4,-3,5,2,-3,3,0,0,-16,5,5,-7,2,-10,0,-1,1,1,-1,1,5,-1
KR_6777315619,420,1,-26,2,0,1,0,1,-2,4,2,2,2,4,-4,6,2,3,0,3,0,-4,15,3,-7,4,-4,0,-1,-1,1,-1,1,1,-1
KR_6682881869,420,-5,-71,-15,-13,-5,5,0,0,3,3,-3,3,0,-1,5,4,-4,5,1,-3,-12,-7,0,-4,4,2,0,-3,1,-1,-1,-1,1,-1
KR_6763118979,420,-1,-8,-11,-1,1,2,3,4,1,5,-1,2,1,-5,6,1,0,0,0,1,2,5,7,-9,2,-3,0,0,-1,1,1,1,4,-1
KR_6767784578,420,-2,-16,-7,-2,-4,5,1,3,1,4,-1,1,0,1,3,4,-1,2,1,0,4,20,-4,-6,10,2,0,0,1,-1,-1,1,1,-1
KR_6776135545,420,-2,-29,-27,-9,-3,3,0,2,2,4,-4,5,1,-5,6,1,1,0,1,1,-12,3,-3,-4,7,-2,0,-1,-1,-1,-1,-1,3,-1
KR_6775514342,420,-1,-48,-6,-7,-5,6,1,-1,2,1,-1,4,3,2,4,6,-2,2,0,0,-8,16,3,-9,6,-3,0,-2,-1,-1,-1,-1,4,-1
KR_6770049683,420,1,-11,0,-5,-5,6,1,0,5,5,-3,3,0,3,0,3,0,1,1,0,1,3,3,-12,9,0,0,-1,1,-1,-1,1,1,-1
KR_6775035527,420,3,-4,-26,11,1,1,2,2,2,4,6,0,6,2,3,5,0,0,0,1,17,6,3,-9,6,-1,0,-1,-1,-1,-1,1,1,-1
KR_6764490912,420,-7,-116,-35,-15,-1,2,1,-4,5,1,-6,7,1,-3,5,2,-1,2,1,0,-9,2,-7,-2,9,0,0,-1,-1,-1,-1,-1,1,-1
KR_6674719484,420,-6,-1,-21,-10,-2,3,1,-7,9,2,2,3,5,-2,3,1,-1,1,0,0,-20,-17,1,-9,8,-4,0,-1,1,-1,-1,-1,2,-1
KR_6768685378,420,-2,-17,-5,-4,-2,2,0,2,2,4,-2,2,0,-1,2,1,-1,1,0,0,0,-12,-3,-4,7,4,0,0,-1,1,1,1,5,-1
KR_6699767439,420,-5,-33,-31,-11,-6,6,0,2,5,7,-3,4,1,2,0,2,-6,7,1,0,-5,2,-3,-5,8,-5,0,-3,-1,-1,-1,-1,3,-1
KR_6761195554,440,-1,-1,17,-2,-5,5,0,0,2,2,0,2,2,2,4,6,1,0,1,0,2,6,-3,-4,7,2,0,0,-1,-1,1,-1,3,-1
KR_6755184425,420,-2,-84,-7,-1,-5,6,1,3,0,3,3,1,4,-3,7,4,1,1,2,0,7,-50,-2,-7,9,12,0,-2,-1,1,-1,-1,6,-1
KR_6771735736,420,0,-6,-7,0,-4,4,0,0,1,1,-1,3,2,2,0,2,3,0,3,0,2,6,0,-6,6,2,0,0,1,-1,0,1,5,-1
KR_6767944061,420,-2,-24,6,-9,-2,2,0,-1,5,4,-6,7,1,0,4,4,0,1,1,0,-6,-8,-1,-5,6,-1,0,-1,-1,-1,-1,-1,2,-1
KR_6772068596,420,-8,-92,-46,-15,-5,6,1,-4,5,1,-2,5,3,-3,7,4,-1,3,2,0,-19,-32,-4,-2,6,4,0,-3,-1,-1,-1,-1,1,-1
KR_6774036148,440,0,-49,15,-2,-2,3,1,-1,2,1,5,0,5,-2,5,3,-2,2,0,0,-6,-33,-4,-4,8,2,0,-2,1,-1,-1,-1,2,-1
KR_6770364021,420,0,47,-12,-2,-2,4,2,4,1,5,-4,7,3,2,2,4,-2,3,1,0,-9,14,-5,-6,11,1,0,1,-1,-1,1,1,5,-1
KR_6774202961,420,-2,-4,-17,-5,0,0,0,0,4,4,-4,4,0,0,3,3,-1,1,0,0,-4,-15,1,-5,4,-3,0,-1,-1,-1,-1,-1,1,-1
KR_6757397298,420,-1,-15,-32,-3,-1,1,0,-2,3,1,1,2,3,3,2,5,-4,5,1,0,1,1,2,-9,7,4,0,0,1,-1,-1,1,2,-1
KR_6772526954,420,-2,-48,-11,0,1,1,2,1,2,3,-1,1,0,0,4,4,-1,1,0,0,3,108,3,-8,5,-5,0,0,1,1,-1,1,3,-1
KR_6750294206,420,-1,22,9,-4,5,0,5,-2,3,1,2,1,3,-3,3,0,-6,7,1,0,-8,-7,0,-7,7,6,0,0,1,1,-1,1,6,-1
KR_6737704283,420,0,70,-13,-3,0,2,2,2,1,3,1,1,2,-4,8,4,-2,2,0,0,-3,-8,-6,-5,11,4,0,1,1,-1,1,1,6,-1
KR_6776535518,420,0,55,2,9,8,0,8,-7,9,2,5,3,8,4,4,8,-1,1,0,0,7,7,5,-6,1,-4,0,0,1,-1,-1,1,3,-1
KR_6769337735,420,-7,-63,-22,-13,0,0,0,2,4,6,-9,10,1,-5,7,2,-1,2,1,-2,-19,-5,1,-8,7,0,0,-1,-1,-1,-1,-1,3,-1
KR_6774726487,420,-4,-54,-28,-4,4,0,4,-1,6,5,0,3,3,-8,9,1,1,0,1,0,-3,3,2,-8,6,-3,0,1,-1,1,1,1,3,-1
KR_6774238504,420,1,-27,-17,1,1,2,3,0,4,4,2,1,3,-2,3,1,0,0,0,0,3,-5,-6,-5,11,3,0,-2,1,-1,-1,-1,6,-1
KR_6757443436,420,-2,-11,-13,-6,1,0,1,-2,4,2,1,5,6,-3,5,2,-3,4,1,0,-18,6,-1,-4,5,-5,0,-1,-1,-1,-1,1,2,-1
KR_6770801488,420,-1,76,-28,-3,0,2,2,-3,5,2,-4,5,1,6,0,6,-2,3,1,1,-9,2,-2,-7,9,2,0,0,1,-1,-1,1,3,-1
KR_6734275858,420,-6,-62,-25,-14,-1,2,1,-5,7,2,-1,2,1,-6,7,1,-1,3,2,0,-14,-5,-5,-2,7,1,0,-1,-1,-1,-1,-1,2,-1
KR_6773064757,420,0,0,-7,-4,3,0,3,-3,6,3,-1,2,1,-1,4,3,-2,3,1,-1,-7,3,3,-7,4,-3,0,0,-1,-1,0,-1,6,-1
KR_6769722196,420,-1,22,5,-5,0,6,6,-1,3,2,-2,2,0,-2,4,2,0,0,0,0,-6,-5,0,-8,8,-3,0,0,-1,-1,-1,1,4,-1
KR_6765699956,420,1,-9,31,-2,1,0,1,4,1,5,-8,8,0,0,4,4,1,0,1,0,0,4,1,-3,2,-2,0,-1,-1,-1,-1,-1,4,-1
KR_6733764437,420,-1,-12,-10,0,-2,3,1,-5,8,3,5,3,8,0,1,1,2,1,3,0,-1,10,1,-5,4,1,0,-1,-1,-1,-1,1,6,-1
KR_6747023715,420,-3,1,8,-10,-1,2,1,-3,4,1,0,2,2,-5,6,1,-1,2,1,1,-15,4,-2,-2,4,-1,0,0,-1,1,0,1,3,-1
KR_6772674453,420,-5,-26,-50,-8,-2,2,0,-2,4,2,1,1,2,-4,5,1,-1,3,2,1,-7,11,-2,-6,8,-6,0,-3,-1,-1,-1,1,6,-1
KR_6737435752,420,-2,25,-9,-4,1,3,4,-7,7,0,-3,6,3,4,0,4,1,0,1,0,-9,-8,-6,-2,8,7,0,-1,-1,-1,-1,1,4,-1
KR_6748189976,420,1,13,4,9,3,2,5,0,2,2,5,2,7,-4,6,2,5,2,7,0,7,1,-1,-5,6,1,0,2,-1,1,1,1,4,-1
KR_6749545450,420,0,-18,32,0,-1,1,0,2,1,3,3,1,4,-2,4,2,-2,3,1,0,2,-27,1,-9,8,-2,0,0,1,1,0,1,3,-1
KR_6743947332,420,-5,-67,9,-12,-3,3,0,-3,4,1,3,1,4,-8,9,1,-1,2,1,0,-13,2,-1,-7,8,0,0,-1,-1,1,-1,1,4,-1
KR_6776157135,420,-1,-11,17,-8,1,1,2,-2,4,2,-5,5,0,-1,2,1,-1,1,0,0,-8,22,-2,-5,7,5,0,0,-1,1,0,1,3,-1
KR_6773637056,420,-3,-19,-2,-6,-4,9,5,-2,6,4,4,0,4,-2,6,4,-2,2,0,3,-8,10,4,-11,7,2,0,0,1,-1,0,1,3,-1
KR_6746125064,420,-2,28,-12,-4,-3,5,2,-3,5,2,4,0,4,-3,3,0,1,0,1,0,-7,7,1,-4,3,2,0,0,-1,-1,0,1,1,-1
KR_6774615863,420,0,42,16,1,-2,2,0,2,2,4,-1,1,0,2,1,3,0,0,0,1,6,3,-5,-5,10,6,0,-1,1,-1,-1,1,2,-1
KR_6728299420,420,-1,-24,-14,-6,1,1,2,-1,5,4,-1,5,4,-5,6,1,0,1,1,0,-9,-28,1,-7,6,-6,0,-1,-1,-1,-1,-1,3,-1
KR_6772941260,420,-1,22,-10,1,0,1,1,11,1,12,-4,5,1,-6,8,2,0,0,0,1,11,26,-5,-1,6,-1,0,-1,-1,1,-1,1,4,-1
KR_6776168491,420,3,-6,22,5,1,1,2,5,1,6,-2,3,1,-1,6,5,2,0,2,-1,3,0,-2,-6,8,-1,0,1,1,1,1,-1,2,-1
KR_6757172395,420,1,45,-16,0,-1,2,1,0,1,1,-3,4,1,3,0,3,1,1,2,0,-3,80,-4,-5,9,2,0,0,-1,-1,1,1,2,-1
KR_6767301130,420,-1,11,-24,-3,2,1,3,-2,6,4,-1,1,0,-4,5,1,2,2,4,0,-9,-39,1,-6,5,2,0,0,-1,1,0,1,5,-1
KR_6777450935,420,1,45,0,-6,3,0,3,-1,2,1,-5,6,1,-3,3,0,0,1,1,0,-2,-10,-2,-7,9,3,0,0,1,-1,-1,1,5,-1
KR_6741467888,420,-2,-6,-12,-6,0,1,1,-5,6,1,-2,4,2,1,2,3,0,0,0,0,-13,1,-3,-8,11,-5,0,-1,1,-1,-1,1,6,-1
KR_6776364659,420,-5,-72,-9,-5,0,5,5,-2,4,2,-6,7,1,1,6,7,2,1,3,3,9,16,8,-11,3,-9,0,-1,1,-1,-1,1,5,-1
KR_6770758677,420,1,-42,-21,6,6,2,8,-3,5,2,2,0,2,0,1,1,1,0,1,0,6,-5,4,-6,2,2,0,0,-1,1,1,1,6,-1
KR_6777220255,420,-5,-42,-3,-3,2,1,3,-4,4,0,1,1,2,-1,2,1,-1,2,1,0,-11,8,7,-8,1,-5,0,0,-1,1,-1,1,5,-1
KR_6769866355,420,-2,37,2,-7,0,1,1,-4,7,3,-5,6,1,2,4,6,0,0,0,0,-9,-8,0,-2,2,-1,0,-1,1,-1,-1,1,1,-1
KR_6773303537,420,-1,4,-17,0,-1,3,2,1,3,4,-2,2,0,2,1,3,0,0,0,0,2,8,0,-4,4,0,0,0,1,-1,-1,1,2,-1
KR_6769501832,420,1,-4,0,-3,-2,3,1,0,2,2,0,1,1,0,2,2,-1,1,0,0,-3,9,-6,-3,9,2,0,0,1,-1,0,1,6,-1
KR_6741372196,420,0,-18,13,-3,-7,7,0,1,3,4,1,1,2,3,1,4,-1,2,1,0,1,9,1,-6,5,-5,0,-1,1,-1,-1,-1,4,-1
KR_6761019728,440,2,38,21,-5,-1,3,2,0,1,1,0,1,1,-3,4,1,-1,2,1,0,-7,3,-5,-4,9,1,0,3,1,1,1,1,2,-1
KR_6761767547,420,5,15,28,3,3,0,3,0,4,4,-2,4,2,0,2,2,2,0,2,0,-4,-5,1,-5,4,-2,0,1,1,-1,1,-1,1,-1
KR_6755186486,420,-3,2,19,-9,0,1,1,-2,2,0,-4,4,0,-2,2,0,-1,1,0,0,-9,-5,-2,-4,6,-5,0,0,-1,1,0,-1,5,-1
KR_6776736937,420,1,29,1,3,-1,3,2,-2,4,2,-3,4,1,8,1,9,1,1,2,0,2,0,-1,-7,8,0,0,1,-1,1,1,1,5,-1
KR_6772523958,420,-4,-77,-12,-7,-1,2,1,-1,1,0,1,2,3,-4,4,0,-2,3,1,0,-6,-2,5,-10,5,-5,0,0,-1,1,0,-1,6,-1
KR_6745032707,420,-2,21,11,-9,0,2,2,-3,5,2,-4,5,1,-1,7,6,-1,2,1,-1,-8,141,0,-5,5,-4,0,0,1,-1,-1,-1,2,-1
KR_6753059256,440,0,-45,-36,-1,-5,6,1,3,2,5,-1,2,1,2,0,2,0,1,1,0,4,16,-1,-5,6,-1,0,-1,0,-1,-1,-1,0,-1
KR_6721555070,420,-2,-26,-15,-5,0,1,1,-7,9,2,0,1,1,1,3,4,1,1,2,0,-5,6,5,-9,4,-1,0,0,-1,-1,0,1,2,-1
KR_6774199449,420,1,13,-1,1,-2,3,1,2,1,3,5,2,7,-3,5,2,-1,1,0,0,1,5,1,-8,7,2,0,0,1,1,0,-1,6,-1
KR_6767450554,420,-2,9,-16,-1,1,0,1,-3,7,4,-2,6,4,3,0,3,0,1,1,1,-6,0,3,-5,2,0,0,-1,1,-1,-1,1,6,-1
KR_6775908105,420,-4,-50,-42,-5,0,2,2,-1,4,3,2,1,3,-7,9,2,1,0,1,0,-5,-4,3,-12,9,-1,0,-2,-1,-1,-1,-1,1,-1
KR_6777470010,420,-2,-35,0,0,-2,3,1,-1,2,1,2,2,4,2,1,3,-1,2,1,0,4,5,1,-5,4,-2,0,0,1,-1,0,-1,4,-1
KR_6777401740,420,-3,-8,-28,-3,1,2,3,1,4,5,-2,4,2,-4,4,0,1,0,1,-1,-2,-6,1,-5,4,3,0,0,-1,-1,0,-1,4,-1
KR_6776330921,420,1,-45,-4,2,0,2,2,1,0,1,0,4,4,1,1,2,0,1,1,0,8,-51,-5,-2,7,4,0,-1,1,-1,-1,-1,4,-1
KR_6754057325,420,-1,46,-25,-7,-4,4,0,3,3,6,0,2,2,-2,6,4,-4,5,1,0,-12,-7,1,-4,3,-5,0,0,-1,1,1,1,5,-1
KR_6773613778,420,1,-12,-1,-1,1,1,2,3,1,4,-1,3,2,-1,6,5,-3,3,0,0,-4,-20,0,-7,7,0,0,2,-1,1,1,-1,2,-1
KR_6745065162,420,-7,-74,-33,-14,0,2,2,-8,10,2,-3,4,1,-3,5,2,0,0,0,0,-17,-39,-3,-4,7,-3,0,-4,-1,-1,-1,-1,5,-1
KR_6777377842,420,1,8,-7,1,0,1,1,1,1,2,1,3,4,-1,3,2,0,0,0,0,-4,1,2,-7,5,1,0,-1,1,-1,-1,1,4,-1
KR_6774332110,420,-2,-21,-17,-6,-4,4,0,0,3,3,0,1,1,-2,3,1,0,0,0,0,-2,22,-1,-6,7,1,0,-1,1,-1,-1,-1,5,-1
KR_6759494526,420,-2,2,3,-6,3,1,4,-1,3,2,-1,4,3,-6,8,2,-1,3,2,0,-12,-4,-2,-6,8,-1,0,-1,-1,1,1,-1,6,-1
KR_6777824020,420,-3,-36,-30,-5,3,0,3,1,1,2,-1,3,2,-8,8,0,0,1,1,0,-9,128,5,-7,2,-1,0,-1,-1,1,-1,1,6,-1
KR_6776728244,420,-2,-5,15,-5,-2,3,1,0,1,1,1,1,2,-4,6,2,0,1,1,0,-4,-1,-2,-7,9,-3,0,0,-1,1,0,-1,1,-1
KR_6761537967,420,-1,41,-3,-4,-1,1,0,-3,5,2,-2,5,3,2,3,5,0,1,1,0,-1,14,2,-7,5,-5,0,-1,-1,-1,-1,-1,3,-1
KR_6776056280,420,-1,35,3,-6,0,1,1,-5,6,1,1,0,1,-3,4,1,1,0,1,0,-6,-14,-4,-7,11,6,0,-1,-1,1,-1,-1,3,-1
KR_6770728885,420,-4,-12,-13,-6,-4,4,0,2,2,4,-1,3,2,-3,3,0,0,1,1,0,3,-37,-4,-2,6,-1,0,0,-1,-1,-1,-1,1,-1
KR_6772467270,420,-3,-86,0,-17,-7,7,0,-4,4,0,-5,8,3,2,6,8,-3,3,0,0,-19,-12,1,-5,4,-2,0,-2,-1,-1,-1,1,3,-1
KR_6743732962,420,1,-3,-1,4,0,3,3,-1,5,4,0,3,3,2,4,6,3,0,3,-1,0,-1,-6,-3,9,0,0,-1,-1,-1,-1,-1,1,-1
KR_6767764820,420,-3,-29,-20,-5,1,2,3,1,0,1,-3,4,1,-4,6,2,0,0,0,0,-4,37,6,-9,3,-1,0,-1,-1,1,-1,-1,5,-1
KR_6766454607,420,-3,16,-27,-1,-1,3,2,3,1,4,-4,7,3,1,2,3,0,1,1,-1,1,-5,0,-7,7,1,0,-1,-1,-1,-1,1,3,-1
KR_6760615301,420,-1,11,-19,-6,3,1,4,2,0,2,-4,5,1,-7,10,3,0,1,1,0,-11,83,2,-10,8,-9,0,-1,0,-1,-1,-1,0,-1
KR_6775052181,420,1,1,12,-1,-5,5,0,0,1,1,2,0,2,1,1,2,1,2,3,0,-5,-19,2,-7,5,2,0,-1,-1,-1,-1,-1,5,-1
KR_6731367062,420,-3,5,-48,-8,-3,4,1,-2,4,2,4,1,5,-5,6,1,-2,2,0,0,-8,-147,0,-6,6,-1,0,-1,-1,-1,-1,-1,3,-1
KR_6765944078,420,-3,-50,-36,-3,0,1,1,-2,4,2,-1,1,0,1,1,2,-1,1,0,0,1,9,1,-9,8,-7,0,-2,-1,-1,-1,1,1,-1
KR_6770134304,420,-2,-38,-1,-4,-2,4,2,0,3,3,1,0,1,-4,8,4,1,0,1,0,-4,-15,0,-6,6,-10,0,0,1,1,0,-1,5,-1
KR_6732131690,440,-6,-55,-39,-25,-5,6,1,-8,10,2,-3,5,2,-7,8,1,-2,3,1,-1,-28,-5,-1,-7,8,9,0,-1,-1,-1,-1,-1,4,-1
KR_6772551646,420,-4,9,-18,-6,-1,1,0,0,3,3,-4,5,1,0,3,3,-1,1,0,-1,-8,-15,-4,-6,10,-1,0,0,-1,-1,0,-1,2,-1
KR_6753372682,420,-4,-28,-4,-8,0,0,0,-7,7,0,2,4,6,-3,4,1,0,1,1,0,-9,0,4,-9,5,-3,0,-1,-1,-1,-1,-1,3,-1
KR_6738142157,440,-2,47,9,-4,0,1,1,-2,2,0,0,0,0,2,2,4,-4,5,1,0,-3,24,1,-7,6,0,0,0,-1,1,1,1,4,-1
KR_6769647962,420,-1,-62,3,0,-3,5,2,0,2,2,1,1,2,2,4,6,0,2,2,1,8,38,-3,-6,9,-3,0,-2,1,-1,-1,-1,6,-1
KR_6775991269,420,-3,-38,-20,-4,-2,3,1,-7,9,2,4,0,4,1,2,3,0,0,0,0,-4,-2,-3,-4,7,-2,0,0,-1,1,0,-1,6,-1
KR_6776543715,420,5,-57,42,17,5,0,5,5,0,5,4,2,6,1,4,5,2,0,2,0,14,9,8,-9,1,1,0,1,1,1,1,1,5,-1
KR_6772468241,420,-2,-36,3,-8,-3,4,1,-3,4,1,-1,4,3,-2,4,2,1,4,5,-1,-7,43,4,-9,5,-24,0,1,-1,1,1,-1,6,-1
KR_6771001119,420,-3,48,1,-6,-1,1,0,-2,4,2,-1,2,1,-2,3,1,0,0,0,0,-11,-8,-5,-3,8,-2,0,1,-1,1,1,-1,2,-1
KR_6704921966,420,1,81,-21,2,2,0,2,2,2,4,0,4,4,0,2,2,-2,2,0,0,3,40,-1,-5,6,2,0,1,-1,1,1,1,4,-1
KR_6774878246,420,-3,-84,-1,-5,2,1,3,-2,3,1,-2,3,1,-4,8,4,1,0,1,-1,-8,-12,-1,-3,4,2,0,-1,1,-1,-1,-1,5,-1
KR_6741204830,420,-2,-2,-8,-9,-1,2,1,-5,8,3,-1,3,2,-3,5,2,1,0,1,0,-16,23,3,-9,6,-3,0,-1,-1,-1,-1,1,2,-1
KR_6773930781,420,-3,-32,0,-12,1,1,2,-5,8,3,-4,8,4,-5,6,1,1,0,1,-2,-12,3,1,-6,5,-4,0,0,1,-1,0,-1,3,-1
KR_6704324156,420,-1,-44,-26,2,-1,2,1,1,3,4,1,2,3,1,0,1,0,1,1,0,8,-19,-7,-2,9,4,0,-1,1,-1,-1,-1,5,-1
KR_6766587556,420,-3,-3,0,0,3,2,5,-1,3,2,3,0,3,-3,4,1,-2,3,1,1,-6,19,2,-7,5,-3,0,0,-1,1,0,1,3,-1
KR_6775139873,420,0,19,23,-4,-2,3,1,3,2,5,-3,5,2,-1,3,2,-1,4,3,-1,-3,12,-2,-5,7,-3,0,1,1,1,1,-1,3,-1
KR_6777369037,420,0,-24,-1,4,1,2,3,2,1,3,3,1,4,-2,3,1,0,1,1,-1,2,5,-1,-9,10,2,0,0,1,1,0,-1,3,-1
KR_6733974152,420,-6,-63,-36,-13,-3,5,2,-2,3,1,2,1,3,-6,8,2,-4,5,1,-1,-14,-31,1,-6,5,0,0,-3,-1,-1,-1,-1,1,-1
KR_6775007128,420,-4,-42,17,-9,-4,4,0,1,2,3,-2,2,0,-5,6,1,1,1,2,1,-7,24,-5,-6,11,0,0,2,-1,-1,1,1,1,-1
KR_6772440674,420,-7,2,-55,-16,-3,3,0,-8,10,2,-4,4,0,1,5,6,-2,2,0,0,-12,-3,-1,-2,3,-3,0,0,-1,-1,-1,-1,1,-1
KR_6758699575,440,3,-21,-31,8,6,0,6,1,0,1,0,0,0,2,2,4,-1,1,0,0,16,-117,-2,-5,7,-6,0,-1,1,1,-1,1,6,-1
KR_6739280578,420,-3,-117,-13,-13,-2,3,1,-8,9,1,-2,2,0,-1,2,1,0,1,1,0,-21,-28,-1,-8,9,-8,0,-2,-1,-1,-1,1,4,-1
KR_6730058286,420,1,36,-6,10,0,2,2,4,5,9,0,0,0,6,0,6,0,1,1,2,21,7,0,-7,7,-2,0,3,-1,1,1,1,1,-1
KR_6776486078,420,0,43,13,-1,4,0,4,1,2,3,-4,6,2,-4,6,2,2,0,2,0,-2,4,3,-8,5,3,0,-1,1,1,-1,-1,3,-1
KR_6685515733,420,-1,4,-4,-6,4,0,4,-3,3,0,0,5,5,-6,6,0,-1,1,0,0,-14,43,5,-11,6,-3,0,0,1,-1,-1,-1,6,-1
KR_6734928019,420,-2,-20,14,-5,-3,5,2,-2,7,5,-1,3,2,0,1,1,1,1,2,0,-4,4,2,-7,5,-9,0,0,1,1,-1,1,4,-1
KR_6756507108,420,-1,-60,-17,-7,0,3,3,0,2,2,-3,5,2,-4,9,5,0,0,0,0,-5,1,0,-9,9,2,0,-1,-1,-1,-1,-1,6,-1
KR_6777640910,420,3,27,2,-2,0,1,1,-5,6,1,-3,3,0,3,1,4,3,0,3,0,-3,4,2,-7,5,-3,0,0,1,-1,0,1,6,-1
KR_6761684782,420,2,-26,25,2,4,0,4,8,0,8,0,0,0,-10,11,1,0,0,0,0,10,309,5,-7,2,5,0,0,-1,1,0,-1,4,-1
KR_6760895155,420,-1,22,7,0,-2,2,0,0,1,1,-1,2,1,2,2,4,1,0,1,1,5,6,-6,-5,11,0,0,1,-1,1,1,1,1,-1
KR_6768577152,420,-2,-11,-20,9,3,2,5,4,3,7,2,2,4,-2,4,2,2,0,2,0,10,10,6,-10,4,-4,0,1,1,1,1,-1,5,-1
KR_6775393243,420,-2,49,-20,1,1,0,1,2,3,5,-2,3,1,-1,3,2,1,0,1,-1,-4,-34,0,-5,5,3,0,-1,-1,-1,-1,-1,1,-1
KR_6766362230,420,0,4,-6,-3,-1,4,3,-1,2,1,-5,7,2,2,2,4,2,1,3,-1,-11,-7,-4,-5,9,4,0,-1,-1,-1,-1,-1,1,-1
KR_6762693049,420,-4,-40,-42,-6,-2,4,2,-4,8,4,-4,5,1,6,1,7,-2,2,0,1,-3,4,6,-10,4,-1,0,-2,-1,-1,-1,1,6,-1
KR_6774280546,440,-1,34,35,-4,2,1,3,-2,3,1,-2,2,0,-1,3,2,-1,1,0,0,-11,255,3,-10,7,-4,0,1,-1,1,1,1,4,-1
KR_6772990338,420,-1,16,4,-2,-2,2,0,-2,2,0,0,5,5,2,1,3,0,2,2,0,0,11,0,-7,7,-4,0,-1,-1,-1,-1,1,6,-1
KR_6776872631,420,0,4,-15,0,-2,3,1,2,4,6,0,3,3,1,2,3,-1,1,0,0,1,-110,5,-10,5,-3,0,-3,-1,-1,-1,1,5,-1
KR_6773389879,420,0,14,-20,2,-3,4,1,0,2,2,1,2,3,5,0,5,-1,1,0,2,-3,-4,-1,-6,7,2,0,0,-1,-1,0,1,5,-1
KR_6761179485,420,0,46,-26,-3,1,0,1,0,3,3,-4,6,2,4,0,4,-4,4,0,0,-10,-19,0,-5,5,0,0,0,-1,0,0,1,4,-1
KR_6756704034,420,-4,-45,-29,-11,1,1,2,-4,5,1,-6,6,0,-4,6,2,2,0,2,0,-13,268,5,-9,4,-6,0,0,-1,-1,0,-1,1,-1
KR_6776600480,420,-1,-7,-7,-1,-2,3,1,0,2,2,-2,4,2,5,0,5,-2,4,2,0,1,9,-1,-7,8,-2,0,-1,-1,-1,-1,1,5,-1
KR_6758707821,420,1,-12,-23,4,2,2,4,1,3,4,1,3,4,0,0,0,0,2,2,0,3,19,1,-9,8,-7,0,0,1,1,0,1,4,-1
KR_6756903266,420,1,-49,-20,-2,-1,4,3,0,1,1,1,3,4,-5,7,2,3,1,4,0,21,11,7,-10,3,-10,0,-2,-1,-1,-1,-1,3,-1
KR_6754353686,420,2,32,15,-6,3,1,4,-2,2,0,-4,8,4,-3,4,1,0,3,3,0,-11,122,1,-5,4,1,0,0,1,-1,0,-1,1,-1
KR_6774217782,420,2,10,-9,3,1,2,3,2,2,4,-2,4,2,0,3,3,2,1,3,2,10,9,2,-5,3,1,0,0,1,-1,1,1,2,-1
KR_6776867980,420,-4,-18,-3,-5,1,0,1,-2,3,1,-5,8,3,-1,3,2,2,0,2,0,-2,4,3,-9,6,-4,0,-1,1,-1,-1,1,3,-1
KR_6769553152,440,-1,68,12,3,0,3,3,-6,6,0,9,1,10,-1,1,0,1,0,1,0,-1,-4,0,-4,4,6,0,0,1,0,0,1,6,-1
KR_6776810048,420,-6,-96,-32,-11,-2,4,2,2,5,7,-1,2,1,-10,11,1,0,1,1,-2,-13,26,0,-6,6,-1,0,-2,1,1,-1,-1,2,-1
KR_6768851404,420,5,69,26,7,-1,2,1,1,3,4,3,1,4,2,3,5,2,1,3,0,0,3,2,-7,5,1,0,-1,1,1,1,1,5,-1
KR_6775301721,420,-2,-38,-3,-15,-2,3,1,-2,4,2,-5,7,2,-7,7,0,1,2,3,-1,-19,-11,-5,-2,7,4,0,-1,-1,-1,-1,-1,3,-1
KR_6742586916,420,0,14,0,-6,-1,2,1,0,3,3,-2,2,0,-2,2,0,-1,1,0,0,-5,110,0,-6,6,3,0,-1,-1,-1,-1,-1,5,-1
KR_6732723953,420,-3,-30,-48,-3,-3,4,1,-8,8,0,5,3,8,1,2,3,2,0,2,1,0,-8,-3,-5,8,-4,0,-1,1,-1,-1,1,3,-1
KR_6775626287,420,-1,-51,15,-11,-1,2,1,-5,6,1,-3,8,5,-2,3,1,0,1,1,0,-13,136,-1,-5,6,0,0,-1,1,-1,-1,1,2,-1
KR_6753149113,420,-2,14,-19,-8,5,1,6,-3,4,1,-5,5,0,-4,6,2,-1,2,1,0,-20,24,3,-10,7,-2,0,0,0,-1,-1,-1,0,-1
KR_6767959120,420,-1,9,1,-18,-5,5,0,-5,5,0,-3,6,3,-3,4,1,-2,2,0,-1,-32,4,-2,-5,7,-3,0,0,-1,-1,0,-1,3,-1
KR_6736398596,420,-2,3,-15,-5,1,2,3,-5,6,1,-3,3,0,4,1,5,-2,4,2,0,-13,4,-1,-4,5,-3,0,1,-1,1,1,1,5,-1
KR_6771215824,420,-2,-18,-4,-4,-5,6,1,1,2,3,3,2,5,-2,5,3,-1,1,0,1,-1,2,-5,-3,8,-3,0,-1,1,1,-1,1,4,-1
KR_6640495432,420,-5,-105,-17,-15,-6,6,0,4,0,4,-6,6,0,-9,12,3,2,1,3,-1,-7,-2,-4,-6,10,2,0,-2,-1,-1,-1,-1,2,-1
KR_6767969952,420,-2,1,-24,-5,0,0,0,0,3,3,-3,3,0,0,3,3,-2,2,0,0,-7,7,5,-7,2,0,0,0,1,1,0,1,5,-1
KR_6775522626,420,-2,-30,-23,-7,1,0,1,-2,4,2,-2,2,0,-2,3,1,-2,2,0,0,-8,1,-5,-5,10,-1,0,0,1,-1,0,-1,1,-1
KR_6764697549,440,1,11,24,2,2,3,5,1,1,2,-2,5,3,4,1,5,-3,4,1,1,4,-2,2,-6,4,4,0,-2,0,1,-1,1,0,-1
KR_6776184817,420,0,-10,-2,1,1,1,2,-2,3,1,1,3,4,1,4,5,0,2,2,0,1,34,-5,-4,9,1,0,0,1,1,-1,1,6,-1
KR_6772460625,420,2,4,4,0,-1,1,0,-1,1,0,0,0,0,0,0,0,2,0,2,0,-1,-47,1,-7,6,3,0,0,-1,1,1,-1,1,-1
KR_6767255358,420,2,67,34,-1,1,0,1,1,2,3,2,1,3,-4,5,1,-1,2,1,0,-2,14,2,-9,7,2,0,0,1,1,-1,-1,1,-1
KR_6770753336,420,-3,-11,-43,-8,-2,2,0,-3,7,4,-3,3,0,0,2,2,0,0,0,0,-8,0,4,-6,2,0,0,-1,-1,-1,-1,-1,4,-1
KR_6747770889,440,1,31,-13,10,-1,1,0,-1,5,4,14,0,14,-1,3,2,-1,1,0,0,6,-129,1,-5,4,1,0,0,1,-1,0,1,3,-1
KR_6752863824,420,-3,-24,1,-7,-2,2,0,2,5,7,-8,8,0,1,3,4,0,1,1,0,-9,-27,-2,-7,9,4,0,0,1,1,0,1,1,-1
KR_6775418846,420,-2,-31,28,-8,1,0,1,0,1,1,-1,3,2,-4,7,3,-4,4,0,0,-8,-134,-1,-6,7,-4,0,-2,-1,-1,-1,-1,6,-1
KR_6777345392,420,-4,-34,-24,-11,-5,5,0,-3,4,1,-5,5,0,3,0,3,-1,3,2,0,-11,6,2,-5,3,-6,0,-2,-1,1,-1,-1,1,-1
KR_6733289617,420,-5,-4,-68,-11,-1,2,1,-7,8,1,-1,2,1,-3,4,1,1,1,2,1,-15,-145,-2,-4,6,-1,0,-1,-1,-1,-1,1,3,-1
KR_6717300488,420,-2,-17,9,-2,0,1,1,-3,4,1,2,1,3,-3,7,4,2,0,2,0,-10,-41,0,-7,7,-4,0,-1,1,-1,-1,-1,2,-1
KR_6723261489,420,-5,-65,-9,-11,0,2,2,4,0,4,0,5,5,-5,6,1,-10,11,1,0,-15,-56,-1,-3,4,-1,0,-3,-1,1,-1,-1,6,-1
KR_6773867203,420,-4,8,-11,-4,1,2,3,-3,5,2,-3,3,0,0,3,3,1,1,2,0,-8,-10,1,-6,5,-2,0,0,-1,-1,-1,1,5,-1
KR_6775642469,420,5,11,-1,9,4,0,4,0,2,2,4,0,4,1,2,3,0,1,1,0,11,3,1,-6,5,0,0,0,-1,-1,1,-1,2,-1
KR_6769480296,420,0,-70,4,2,-4,7,3,5,2,7,4,0,4,-4,6,2,1,0,1,0,11,-6,-1,-8,9,2,0,-2,1,-1,-1,-1,6,-1
KR_6709821357,420,-3,-84,32,-4,-4,4,0,1,2,3,-5,6,1,4,4,8,0,2,2,0,-1,19,0,-5,5,1,0,0,-1,1,1,-1,1,-1
KR_6759385230,440,0,-70,18,-1,-3,4,1,1,2,3,1,1,2,1,2,3,-1,1,0,0,4,-220,-2,-5,7,-25,0,0,1,-1,0,-1,5,-1
KR_6774106955,420,-4,-148,-27,-16,0,0,0,-5,7,2,0,5,5,-11,11,0,0,0,0,-1,-15,-32,1,-6,5,-4,0,-1,0,1,-1,-1,0,-1
KR_6746170871,420,-11,-125,-33,-17,-6,7,1,-7,8,1,0,2,2,-2,4,2,-2,2,0,0,-10,-7,-3,-2,5,2,0,-5,-1,-1,-1,-1,5,-1
KR_6723355654,420,1,85,-28,-1,1,1,2,-3,6,3,0,5,5,1,1,2,0,1,1,0,-7,-45,1,-7,6,20,0,2,1,-1,1,1,1,-1
KR_6763756128,420,0,-10,-14,-5,-1,3,2,0,4,4,-6,7,1,3,2,5,-1,2,1,0,-13,3,-5,-5,10,-3,0,0,-1,1,0,1,1,-1
KR_6722273581,420,2,50,-9,4,3,1,4,1,4,5,-1,7,6,-2,6,4,3,0,3,0,-3,-5,1,-4,3,-2,0,2,1,-1,1,1,6,-1
KR_6767639406,420,-3,-29,-4,-1,6,0,6,0,3,3,0,2,2,-7,8,1,0,0,0,0,-2,-1,5,-9,4,-2,0,-1,-1,-1,1,-1,3,-1
KR_6729552122,420,-4,-92,-1,-11,-3,4,1,-5,8,3,1,3,4,-4,4,0,0,2,2,0,-17,-4,-1,-3,4,-2,0,0,-1,1,-1,-1,5,-1
KR_6774049629,420,-3,-29,-27,-3,-9,9,0,2,0,2,4,3,7,2,1,3,-2,2,0,0,5,-22,2,-8,6,-1,0,0,1,-1,-1,-1,4,-1
KR_6769962021,420,0,-14,7,-1,1,2,3,0,4,4,1,2,3,-3,4,1,0,1,1,0,-7,-1,-5,-2,7,-5,0,0,-1,-1,0,1,5,-1
KR_6766808792,420,-2,18,13,-11,2,2,4,-10,10,0,0,2,2,-1,2,1,-2,2,0,0,-19,-26,-5,-3,8,-5,0,-1,1,-1,-1,1,3,-1
KR_6772848319,420,5,43,19,7,4,1,5,5,4,9,-5,6,1,4,4,8,-1,2,1,0,6,22,6,-12,6,6,0,2,-1,1,1,-1,6,-1
KR_6770230502,420,-3,-68,-1,-13,2,2,4,-5,6,1,-8,9,1,-1,2,1,-1,2,1,0,-2,11,-2,-3,5,-1,0,-2,-1,-1,-1,-1,1,-1
KR_6764698521,440,-2,-17,5,-4,0,2,2,6,1,7,-5,6,1,-4,7,3,-1,2,1,0,2,0,-3,-5,8,-5,0,-1,1,1,1,1,4,-1
KR_6773250592,420,-6,-86,-9,-19,-4,4,0,-6,6,0,-5,5,0,-7,8,1,3,1,4,0,-22,-10,-4,-5,9,3,0,-3,-1,1,-1,-1,4,-1
KR_6739124541,420,1,3,0,0,-1,2,1,2,2,4,0,3,3,-4,5,1,3,0,3,0,12,346,7,-13,6,1,0,-2,-1,-1,-1,-1,5,-1
KR_6768374873,440,-4,-22,-6,-9,-3,4,1,-2,3,1,1,1,2,-4,5,1,-1,3,2,0,-13,-6,0,-7,7,1,0,-2,-1,-1,-1,-1,6,-1
KR_6772140822,420,-9,-108,-21,-18,0,3,3,-1,1,0,-8,8,0,-4,4,0,-5,5,0,0,-18,-13,-3,-4,7,-2,0,-3,-1,-1,-1,-1,3,-1
KR_6756346330,420,-4,-22,-61,-4,-2,4,2,-3,3,0,1,0,1,1,4,5,-1,2,1,0,-7,12,3,-8,5,3,0,0,-1,1,1,-1,1,-1
KR_6756050216,420,-2,0,-10,-4,-4,4,0,1,4,5,1,1,2,0,4,4,-2,2,0,0,-10,-31,-3,-5,8,4,0,-2,1,-1,-1,-1,3,-1
KR_6687598205,420,-1,-8,-38,-6,-4,5,1,-2,4,2,1,2,3,0,4,4,-1,1,0,-1,-7,18,-2,-6,8,3,0,-1,-1,-1,-1,-1,4,-1
KR_6681283748,420,-6,-84,3,-6,-1,1,0,1,3,4,-1,6,5,-3,3,0,-2,2,0,0,-10,-5,3,-10,7,0,0,0,-1,-1,0,1,4,-1
KR_6771101457,420,1,-9,0,5,2,2,4,-3,4,1,2,1,3,3,4,7,1,0,1,0,5,-10,-1,-8,9,-4,0,0,-1,-1,-1,1,3,-1
KR_6776439388,440,-2,-72,-9,-1,0,1,1,3,0,3,0,2,2,-6,7,1,2,0,2,1,4,35,-1,-4,5,-3,0,-1,-1,-1,-1,1,4,-1
KR_6776333761,420,5,131,8,9,3,2,5,1,0,1,2,0,2,3,3,6,0,0,0,-1,7,-22,-5,-3,8,13,0,3,1,-1,1,-1,1,-1
KR_6741278793,420,-3,-26,-5,-9,-1,1,0,-2,3,1,-4,5,1,-2,4,2,0,2,2,0,-6,-4,1,-4,3,-4,0,-3,-1,-1,-1,-1,5,-1
KR_6760402837,420,-5,-147,-5,-6,-3,3,0,0,0,0,-1,2,1,-3,3,0,1,0,1,0,-1,-15,0,-4,4,-2,0,-1,-1,-1,-1,-1,6,-1
KR_6676201459,420,-3,-40,-4,-12,-8,10,2,-1,4,3,-4,6,2,1,2,3,0,0,0,-1,-16,7,0,-9,9,-5,0,-2,1,-1,-1,-1,1,-1
KR_6724712816,420,-2,25,-14,-10,3,1,4,-10,11,1,6,0,6,-8,9,1,-1,1,0,0,-16,-35,-3,-7,10,4,0,-1,-1,1,1,-1,2,-1
KR_6745947729,420,4,-15,18,14,2,3,5,5,4,9,1,2,3,4,2,6,2,0,2,2,12,11,4,-11,7,7,0,1,1,1,1,-1,5,-1
KR_6775440107,420,0,44,-28,4,1,2,3,0,2,2,1,1,2,1,0,1,1,0,1,0,6,3,1,-4,3,-1,0,-1,-1,1,-1,1,4,-1
KR_6769658196,420,-2,69,4,-10,-2,2,0,-5,5,0,-2,2,0,-1,1,0,0,0,0,0,-8,-23,-5,-6,11,1,0,-1,-1,-1,-1,-1,5,-1
KR_6763866206,420,-5,-17,-16,-11,-3,3,0,2,3,5,-1,2,1,-9,11,2,0,2,2,0,-13,-130,-3,-2,5,-4,0,-2,-1,1,-1,1,5,-1
KR_6746182177,420,-4,-62,5,-10,-6,6,0,-3,3,0,2,1,3,-3,3,0,0,0,0,0,-10,-2,3,-9,6,1,0,1,1,1,1,-1,3,-1
KR_6765850302,440,1,32,13,-2,1,1,2,1,5,6,0,6,6,-3,5,2,-1,2,1,0,-10,-10,-2,-5,7,1,0,0,1,0,0,1,6,-1
KR_6777028715,420,0,12,1,6,2,2,4,-2,4,2,-1,3,2,5,2,7,2,0,2,2,12,13,-3,-4,7,5,0,0,1,1,1,-1,2,-1
KR_6742038196,420,-2,-7,-24,-8,1,2,3,-2,3,1,1,1,2,-7,7,0,-1,1,0,0,-6,-5,0,-7,7,1,0,0,-1,-1,1,-1,1,-1
KR_6737397994,420,-4,-10,-11,-7,-1,6,5,-2,3,1,-6,6,0,0,5,5,2,0,2,-2,-6,-1,-1,-6,7,5,0,-1,1,-1,-1,1,5,-1
KR_6776809215,420,2,41,31,3,4,2,6,-1,1,0,4,0,4,-6,7,1,2,1,3,0,1,34,0,-4,4,-1,0,0,-1,1,-1,1,5,-1
KR_6769054070,420,-5,-69,-19,-8,-3,5,2,-5,7,2,3,2,5,-2,6,4,-1,2,1,-1,-9,0,-6,-2,8,-2,0,0,-1,1,0,-1,1,-1
KR_6742239312,420,-9,-152,-53,-13,-4,5,1,-4,5,1,0,0,0,-3,4,1,-2,2,0,0,-10,-11,-3,-4,7,0,0,-3,-1,-1,-1,-1,1,-1
KR_6768220881,420,0,25,-15,-1,1,1,2,1,1,2,-3,4,1,0,2,2,0,0,0,0,1,-29,-1,-2,3,4,0,0,-1,-1,0,-1,6,-1
KR_6767047282,420,-3,-47,-37,-8,2,0,2,-4,6,2,-3,6,3,-3,3,0,0,1,1,1,-12,-1,-3,-3,6,0,0,0,-1,-1,0,1,2,-1
KR_6755761630,420,-2,-42,-29,-6,-2,2,0,-5,7,2,0,3,3,0,1,1,1,0,1,0,-5,44,-3,-3,6,-28,0,-2,-1,-1,-1,-1,4,-1
KR_6669078203,440,1,23,8,8,1,5,6,3,3,6,-4,5,1,6,1,7,2,0,2,0,5,-14,4,-9,5,0,0,0,-1,1,-1,1,3,-1
KR_6775486626,420,-6,-53,7,-13,1,1,2,-1,3,2,-5,7,2,-7,9,2,-1,1,0,0,-18,-1,0,-3,3,0,0,-2,-1,-1,-1,-1,3,-1
KR_6774159728,420,-4,-55,10,-13,-1,2,1,1,2,3,-5,8,3,-7,7,0,-1,1,0,0,-10,8,5,-8,3,-6,0,-3,-1,-1,-1,1,5,-1
KR_6777596496,420,-7,-80,-8,-15,-3,4,1,-3,4,1,-1,3,2,-5,6,1,-3,4,1,-1,-12,1,-2,-3,5,-3,0,-1,0,-1,-1,-1,0,-1
KR_6741213699,420,2,33,16,-3,-2,2,0,-1,3,2,2,4,6,-3,5,2,1,2,3,-1,1,-31,-1,-4,5,2,0,0,1,-1,0,-1,6,-1
KR_6776835980,420,-1,-32,16,-1,0,2,2,-1,1,0,-1,1,0,0,0,0,1,0,1,0,0,-25,-2,-3,5,1,0,0,1,1,0,-1,5,-1
KR_6766666246,420,-1,-1,-32,-1,4,1,5,-2,5,3,3,2,5,-6,8,2,0,0,0,0,2,-52,0,-8,8,2,0,1,-1,1,1,1,2,-1
KR_6762928324,420,1,-8,12,3,0,1,1,5,2,7,-2,6,4,-1,3,2,1,0,1,0,7,-5,4,-8,4,-3,0,1,1,1,1,-1,6,-1
KR_6774016227,420,0,63,-26,-8,-2,3,1,-5,5,0,-1,4,3,1,4,5,-1,1,0,0,2,-39,3,-6,3,-1,0,-2,1,-1,-1,1,5,-1
KR_6749424125,440,-3,27,-12,1,-1,1,0,0,3,3,-1,1,0,2,1,3,1,0,1,0,3,45,-1,-7,8,4,0,1,-1,1,1,1,2,-1
KR_6772897873,420,-3,-39,-25,-3,-3,3,0,0,0,0,2,3,5,-2,3,1,0,1,1,0,4,6,-2,-5,7,4,0,-1,-1,-1,-1,-1,2,-1
KR_6750423007,420,2,8,11,10,3,2,5,4,1,5,1,2,3,2,0,2,0,1,1,0,12,14,-3,-2,5,-1,0,0,-1,-1,1,-1,4,-1
KR_6740567324,420,0,64,2,-8,-1,4,3,-5,5,0,2,2,4,-3,3,0,-1,2,1,-2,-23,-68,-8,-4,12,0,0,0,-1,-1,-1,-1,2,-1
KR_6756541769,420,-4,-32,-22,-6,-3,3,0,-6,7,1,-3,3,0,5,0,5,1,0,1,0,0,15,-2,-7,9,1,0,0,-1,-1,1,1,4,-1
KR_6715957551,420,-3,-13,-23,-5,-1,3,2,-1,3,2,3,1,4,-6,6,0,0,0,0,1,-17,6,1,-7,6,-3,0,0,1,1,0,1,5,-1
KR_6770297307,420,-1,-27,1,-7,-5,6,1,1,0,1,-1,4,3,-5,9,4,3,0,3,1,-6,15,-4,-4,8,0,0,-1,-1,-1,-1,1,2,-1
KR_6740194031,420,-1,8,0,0,1,0,1,2,0,2,-3,4,1,-1,4,3,1,0,1,0,0,25,2,-8,6,2,0,0,1,-1,0,-1,1,-1
KR_6776818799,420,-4,-73,24,-9,3,0,3,-5,5,0,1,3,4,-5,5,0,-3,3,0,1,-12,6,-2,-3,5,-7,0,-1,-1,-1,-1,1,4,-1
KR_6775579687,420,-5,-34,-12,-4,-1,1,0,-1,3,2,0,0,0,-2,3,1,0,0,0,0,-4,3,1,-4,3,0,0,-2,-1,-1,-1,-1,4,-1
KR_6764430667,420,1,102,-12,-2,1,2,3,-3,5,2,-1,3,2,1,2,3,0,0,0,0,-3,24,-2,-3,5,-3,0,1,-1,-1,1,1,5,-1
KR_6776162630,420,0,-32,-4,0,-2,5,3,2,1,3,0,1,1,0,1,1,0,2,2,-1,3,-7,0,-6,6,-4,0,-1,-1,-1,-1,-1,1,-1
KR_6777642429,420,1,-28,8,-4,-3,4,1,2,4,6,1,3,4,-4,8,4,0,1,1,0,-2,-3,5,-10,5,4,0,-2,-1,-1,-1,-1,2,-1
KR_6756404240,420,-2,17,-28,-2,3,0,3,-4,4,0,-1,4,3,0,2,2,0,1,1,0,-1,4,1,-10,9,-5,0,0,1,-1,-1,-1,1,-1
KR_6773913107,420,-3,-50,-33,-6,3,1,4,-2,3,1,-4,5,1,-4,4,0,1,2,3,0,0,1,4,-6,2,1,0,-2,-1,-1,-1,-1,6,-1
KR_6775381046,420,1,51,23,-3,-2,3,1,0,3,3,4,0,4,-5,5,0,0,1,1,0,-4,-2,-5,-1,6,3,0,3,1,1,1,-1,3,-1
KR_6727600366,420,4,74,33,2,2,0,2,0,1,1,0,1,1,0,2,2,0,0,0,-1,-2,-5,-3,-7,10,1,0,-1,-1,1,1,-1,2,-1
KR_6763370937,440,0,19,0,0,-1,3,2,2,4,6,0,3,3,-2,6,4,1,3,4,-3,-2,-1,1,-3,2,-2,0,1,-1,0,1,-1,5,-1
KR_6767491266,420,-7,-46,-53,-13,-5,7,2,-5,6,1,-1,4,3,-1,2,1,-1,1,0,1,-9,-4,-4,-2,6,5,0,-2,-1,-1,-1,1,5,-1
KR_6773198894,420,-8,-133,-29,-18,-5,6,1,-5,5,0,-3,4,1,-3,3,0,-2,2,0,0,-15,-17,-3,-2,5,-1,0,-3,-1,-1,-1,-1,5,-1
KR_6736588490,420,1,32,-4,6,-1,1,0,0,4,4,1,3,4,11,1,12,-5,6,1,1,3,66,-4,-3,7,6,0,0,1,-1,0,1,6,-1
KR_6716631306,420,-3,-71,3,3,0,1,1,1,3,4,-2,2,0,3,4,7,1,0,1,0,5,4,0,-7,7,-8,0,1,-1,1,1,1,4,-1
KR_6658538556,420,1,-7,25,4,4,0,4,-2,3,1,-2,2,0,1,0,1,3,0,3,1,2,3,2,-7,5,2,0,-1,1,1,-1,1,5,-1
KR_6746116791,420,-2,-47,-7,-5,0,0,0,-3,5,2,-3,5,2,0,4,4,1,1,2,0,-5,11,-1,-5,6,5,0,0,-1,-1,0,1,4,-1
KR_6765295197,420,0,38,12,1,-3,4,1,-1,2,1,6,1,7,1,1,2,-2,2,0,1,-2,11,4,-7,3,-2,0,-1,1,1,-1,1,3,-1
KR_6755817474,420,-3,34,-52,-6,-4,5,1,1,4,5,0,3,3,-3,4,1,0,2,2,0,-8,0,4,-11,7,0,0,0,-1,-1,0,1,4,-1
KR_6777419886,420,-2,22,1,2,1,0,1,4,1,5,-1,3,2,-3,4,1,1,1,2,0,0,-8,1,-5,4,3,0,2,1,1,1,-1,3,-1
KR_6762773633,420,-1,-3,35,-4,6,0,6,-4,4,0,-4,5,1,-1,4,3,-1,2,1,0,-5,24,0,-5,5,-5,0,-1,1,1,-1,-1,1,-1
KR_6765647530,420,0,25,-1,-2,1,2,3,-1,1,0,-4,6,2,-2,2,0,4,0,4,0,-4,-15,1,-6,5,-2,0,1,-1,-1,1,-1,2,-1
KR_6774260186,420,-1,-37,22,-2,-2,3,1,-3,3,0,-2,3,1,3,1,4,2,4,6,0,-1,-3,-3,-5,8,0,0,0,1,-1,0,-1,5,-1
KR_6775357884,420,-2,-8,-24,-8,1,1,2,-3,4,1,-3,5,2,-1,5,4,-2,3,1,0,-6,14,-3,-3,6,-3,0,-2,-1,-1,-1,-1,6,-1
KR_6730056392,420,-3,20,-40,-11,5,2,7,-6,6,0,-4,7,3,-6,6,0,0,0,0,-1,-15,64,5,-11,6,-24,0,-1,-1,-1,-1,-1,2,-1
KR_6774571145,420,-1,10,16,-3,-1,2,1,-4,4,0,1,2,3,2,1,3,-1,1,0,0,-1,-84,2,-8,6,0,0,0,-1,1,0,-1,4,-1
KR_6729629191,420,-8,-58,-38,-17,-6,6,0,-5,7,2,-1,2,1,-5,7,2,0,1,1,0,-6,27,-2,-8,10,1,0,-3,-1,-1,-1,1,2,-1
KR_6766345687,420,-1,-3,-8,-3,4,1,5,-1,2,1,-4,6,2,-2,3,1,0,2,2,0,3,124,7,-10,3,2,0,-2,0,-1,-1,-1,0,-1
KR_6739299980,420,-4,-21,-13,-4,-1,1,0,-2,4,2,1,2,3,2,2,4,-4,8,4,0,0,68,2,-10,8,2,0,1,1,-1,1,1,6,-1
KR_6744798568,420,-2,-7,-42,-8,0,2,2,-9,9,0,2,2,4,0,5,5,-1,3,2,1,-15,-7,5,-10,5,-9,0,0,1,-1,1,-1,5,-1
KR_6769374460,420,-4,9,0,-11,1,1,2,-3,4,1,-3,4,1,-7,7,0,1,2,3,-1,-14,-16,-9,-1,10,-1,0,-1,-1,1,-1,-1,2,-1
KR_6772074809,420,3,64,30,-3,1,1,2,-2,2,0,-1,3,2,-3,3,0,2,0,2,0,-11,-8,-4,-3,7,6,0,1,-1,1,1,-1,2,-1
KR_6726953218,440,-1,-36,-16,-4,-2,2,0,-3,7,4,3,2,5,-1,2,1,-1,2,1,0,0,23,-1,-5,6,2,0,-1,-1,0,-1,-1,4,-1
KR_6747844226,440,3,-23,33,10,2,1,3,4,3,7,0,1,1,2,2,4,2,1,3,0,6,-1,-7,-3,10,0,0,0,1,1,0,1,6,-1
KR_6776260819,420,-2,-19,0,-1,-1,1,0,0,5,5,0,2,2,0,3,3,0,2,2,-2,4,-123,-2,-8,10,-9,0,-1,-1,1,-1,-1,6,-1
KR_6771575830,420,0,-10,-1,-4,0,1,1,1,1,2,-1,2,1,-6,6,0,2,0,2,0,-3,-16,-3,-5,8,3,0,-1,1,-1,-1,1,4,-1
KR_6752407680,420,-4,6,-12,-10,-7,7,0,-1,3,2,0,1,1,0,2,2,-2,3,1,0,-15,9,6,-12,6,-6,0,1,-1,-1,1,-1,6,-1
KR_6733273454,420,-3,-18,18,-5,-5,6,1,2,1,3,-1,2,1,-1,3,2,0,3,3,0,-6,-5,1,-6,5,4,0,-1,-1,-1,-1,-1,3,-1
KR_6732313655,420,-3,-6,-24,-6,0,1,1,-2,5,3,-1,2,1,-4,5,1,1,0,1,0,-9,11,1,-7,6,-3,0,0,-1,1,0,-1,6,-1
KR_6754046646,440,-3,-40,17,-10,-3,7,4,-1,1,0,1,5,6,-7,7,0,0,2,2,-1,-16,7,-4,-3,7,-1,0,-1,1,-1,-1,-1,3,-1
KR_6775118127,420,-6,-29,-27,-11,-1,1,0,1,0,1,-4,4,0,-4,4,0,-3,3,0,0,-14,-18,-6,-3,9,4,0,-1,-1,-1,-1,-1,6,-1
KR_6773834460,420,-3,-67,4,-6,0,0,0,-1,3,2,-2,3,1,-1,3,2,-2,2,0,0,-3,55,-2,-4,6,-5,0,0,-1,-1,-1,-1,5,-1
KR_6741967758,420,-1,-3,4,-1,-1,3,2,0,2,2,-2,3,1,1,1,2,1,0,1,0,-3,6,-1,-5,6,1,0,0,-1,-1,0,1,6,-1
KR_6670525945,420,-4,-35,-15,-5,-1,4,3,1,2,3,1,1,2,-6,6,0,0,1,1,0,-7,0,2,-9,7,-5,0,-1,-1,-1,-1,-1,4,-1
KR_6774078095,420,-2,-12,9,-8,-5,6,1,-1,3,2,0,0,0,-5,6,1,3,0,3,0,-2,47,-7,-3,10,-23,0,-1,1,-1,-1,-1,2,-1
KR_6777114816,420,1,37,-3,3,0,1,1,4,2,6,2,0,2,-3,4,1,0,0,0,0,-1,-3,2,-7,5,-4,0,0,-1,-1,1,-1,1,-1
KR_6772836345,440,-1,30,4,-5,1,3,4,-2,6,4,-2,2,0,-3,4,1,1,0,1,0,-6,2,2,-7,5,6,0,-1,-1,-1,-1,-1,1,-1
KR_6728112608,420,-1,-22,29,-5,2,3,5,1,5,6,2,1,3,-6,8,2,-4,5,1,0,-3,4,2,-8,6,-2,0,-1,-1,1,-1,-1,1,-1
KR_6749665317,420,-2,20,-7,-6,-2,6,4,1,2,3,-2,4,2,0,2,2,-3,3,0,0,1,1,1,-6,5,1,0,1,1,1,1,-1,3,-1
KR_6774750972,420,-6,-51,21,-12,1,3,4,-5,6,1,1,2,3,-7,8,1,-2,3,1,0,-16,-2,1,-3,2,-3,0,-1,-1,-1,-1,-1,2,-1
KR_6774764026,420,1,2,-6,3,2,0,2,3,0,3,-6,7,1,4,5,9,0,1,1,0,11,-5,3,-7,4,-2,0,0,1,1,1,-1,4,-1
KR_6766206690,420,-2,-34,-17,-4,1,2,3,1,2,3,-6,6,0,0,1,1,0,0,0,0,-8,-8,0,-6,6,3,0,0,1,-1,0,1,4,-1
KR_6771751366,440,1,-12,-2,0,0,0,0,2,3,5,-5,9,4,5,1,6,-2,4,2,0,2,0,2,-4,2,1,0,0,-1,1,0,1,2,-1
KR_6775478505,420,-3,16,-17,-4,-1,3,2,1,0,1,-2,2,0,0,4,4,-2,2,0,0,-8,-1,-4,-1,5,-6,0,0,-1,0,0,-1,3,-1
KR_6727430654,420,-5,-51,-24,-14,1,0,1,-6,9,3,-1,3,2,-7,7,0,-1,2,1,0,-20,-5,-1,-7,8,0,0,-1,-1,1,-1,-1,3,-1
KR_6772559961,420,-3,-21,-36,-1,-4,6,2,-3,4,1,3,3,6,2,1,3,1,1,2,1,-4,-5,2,-6,4,-1,0,-1,-1,-1,-1,1,2,-1
KR_6770105720,420,-1,-10,4,-2,-3,3,0,-2,5,3,1,0,1,2,4,6,0,1,1,1,5,-103,-4,-6,10,3,0,-1,1,-1,-1,1,2,-1
KR_6776859571,420,0,24,12,-12,1,0,1,1,4,5,-2,4,2,-11,13,2,-1,1,0,0,-25,12,-1,-5,6,-6,0,0,-1,1,-1,-1,6,-1
KR_6757589905,420,0,40,8,-1,2,2,4,-3,6,3,1,1,2,0,1,1,-1,1,0,0,-2,21,10,-11,1,-8,0,1,-1,1,1,1,4,-1
KR_6706701313,440,1,16,-20,10,-3,3,0,-1,3,2,7,0,7,3,3,6,4,0,4,2,16,-1,-2,-3,5,-2,0,-1,1,-1,-1,1,4,-1
KR_6772441541,420,2,-18,-17,3,0,2,2,1,5,6,0,2,2,1,2,3,1,0,1,0,11,0,2,-7,5,-1,0,0,1,1,0,1,1,-1
KR_6772473043,420,-2,-70,-20,7,0,1,1,3,2,5,-1,4,3,3,3,6,2,0,2,0,8,-1,3,-10,7,1,0,0,-1,1,1,-1,3,-1
KR_6704080766,420,-6,-54,-21,-16,-3,3,0,-4,9,5,-3,3,0,-2,7,5,-4,5,1,-1,-18,-310,2,-8,6,-4,0,-3,-1,1,-1,-1,5,-1
KR_6727326241,420,-5,-22,-4,-1,-3,4,1,-2,4,2,-1,3,2,2,5,7,3,1,4,1,-2,4,-4,-7,11,0,0,-1,-1,1,-1,1,5,-1
KR_6762025198,420,0,-42,-1,-5,1,3,4,3,0,3,0,5,5,-10,11,1,1,0,1,-1,-12,10,-1,-4,5,-3,0,0,-1,-1,-1,-1,5,-1
KR_6757416808,420,-3,-65,-20,-8,-3,3,0,-2,3,1,-2,2,0,-1,2,1,0,0,0,0,-6,5,0,-5,5,2,0,-1,0,-1,-1,1,0,-1
KR_6740160821,420,-2,-18,-6,-9,-1,2,1,2,2,4,1,3,4,-8,8,0,-3,3,0,2,-4,29,-2,-9,11,-2,0,1,-1,1,1,1,1,-1
KR_6773620600,420,-3,-98,-24,-2,0,1,1,2,4,6,2,2,4,-6,8,2,0,1,1,0,-2,-9,1,-7,6,1,0,-2,-1,1,-1,-1,3,-1
KR_6761055414,420,0,-2,-36,3,1,3,4,-1,2,1,1,3,4,1,0,1,1,0,1,0,1,-35,5,-6,1,18,0,-1,-1,-1,-1,-1,3,-1
KR_6777810669,420,-1,-31,20,-1,-1,3,2,7,2,9,-3,3,0,-4,7,3,0,1,1,0,-5,-22,0,-10,10,9,0,-1,1,1,-1,1,2,-1
KR_6737546013,420,1,-12,-13,4,-1,3,2,4,1,5,-1,3,2,2,2,4,0,1,1,0,1,-4,-3,-7,10,1,0,1,-1,1,1,-1,4,-1
KR_6767989770,420,-3,17,14,-6,2,1,3,0,2,2,-4,4,0,-3,7,4,-1,1,0,-1,-17,18,-4,-5,9,4,0,0,-1,1,0,-1,6,-1
KR_6738838617,420,-1,-68,16,-8,-2,3,1,0,5,5,-4,6,2,-2,4,2,0,0,0,0,0,3,-9,-4,13,-20,0,-2,-1,-1,-1,-1,5,-1
KR_6777664508,420,-2,12,-7,0,-2,2,0,-3,3,0,0,2,2,2,2,4,3,1,4,0,-3,15,-2,-5,7,2,0,0,1,1,0,1,2,-1
KR_6762879499,420,-3,27,-30,-12,-1,1,0,1,3,4,-9,11,2,-2,2,0,-1,2,1,0,-9,-4,7,-10,3,-1,0,0,-1,-1,0,-1,3,-1
KR_6767147766,420,-3,-3,-4,-6,1,1,2,-3,3,0,-3,3,0,-1,1,0,0,0,0,0,-5,31,2,-6,4,-6,0,0,-1,-1,0,-1,1,-1
KR_6729186457,420,-7,-50,-5,-12,0,2,2,-1,4,3,-4,4,0,-5,7,2,-2,2,0,0,-20,-76,-1,-6,7,-1,0,-1,-1,-1,-1,1,6,-1
KR_6775422720,420,-4,-61,-13,-7,0,3,3,-4,5,1,-1,3,2,-2,4,2,0,1,1,0,-16,-9,-2,-5,7,4,0,0,-1,1,0,1,4,-1
KR_6755835603,420,-2,-46,26,-8,-5,6,1,-2,4,2,1,2,3,-2,5,3,0,0,0,0,-12,-15,-2,-6,8,0,0,1,-1,0,1,-1,2,-1
KR_6750656160,420,-2,39,-30,-7,-1,3,2,-4,5,1,-3,5,2,0,2,2,1,1,2,0,-11,4,5,-13,8,2,0,-1,-1,-1,-1,-1,4,-1
KR_6775530246,420,-1,47,-4,-9,0,0,0,-7,7,0,0,0,0,-1,4,3,-1,1,0,-1,-9,-6,-4,-4,8,0,0,0,-1,-1,0,-1,3,-1
KR_6775855240,420,4,11,-10,7,-2,3,1,3,0,3,0,1,1,3,3,6,3,0,3,0,5,-5,-2,-8,10,-2,0,0,1,-1,1,-1,6,-1
KR_6763804111,420,1,2,4,4,-1,6,5,-1,2,1,8,1,9,-1,1,0,-1,2,1,1,1,9,1,-7,6,2,0,-1,1,-1,-1,1,1,-1
KR_6775445523,420,-1,-43,12,-3,-1,3,2,2,3,5,-5,5,0,0,3,3,1,0,1,0,3,-2,-4,-4,8,-4,0,-1,1,1,-1,-1,2,-1
KR_6761064838,420,-3,-38,-21,-3,-1,2,1,-3,6,3,-2,3,1,3,6,9,0,4,4,2,2,-23,2,-6,4,-1,0,0,1,1,0,1,1,-1
KR_6717076155,420,1,48,-7,5,3,1,4,-1,8,7,-1,2,1,3,1,4,1,3,4,0,14,-11,4,-7,3,-1,0,0,1,-1,-1,1,1,-1
KR_6747809514,440,-3,-24,-18,-5,3,0,3,1,2,3,-2,3,1,-2,7,5,-5,5,0,0,3,-6,1,-4,3,-1,0,0,-1,1,0,1,6,-1
KR_6754915341,420,-2,-22,4,-5,-3,4,1,-5,8,3,-1,3,2,5,3,8,-1,2,1,1,-1,-16,0,-4,4,-4,0,1,1,-1,1,1,5,-1
KR_6760048157,420,1,-9,-13,4,2,0,2,3,2,5,-2,2,0,2,1,3,-1,1,0,0,4,-33,7,-14,7,1,0,2,1,1,1,1,6,-1
KR_6761828584,420,-1,-29,-20,0,1,1,2,3,3,6,1,2,3,-4,4,0,-1,1,0,0,0,0,4,-8,4,-2,0,-1,0,0,-1,-1,0,-1
KR_6742553044,420,-1,-3,-16,-4,-6,7,1,0,3,3,-1,2,1,3,5,8,0,0,0,0,10,53,3,-8,5,-12,0,-1,-1,-1,-1,-1,1,-1
KR_6719203653,420,-2,2,8,-5,0,0,0,-7,10,3,1,2,3,-2,6,4,3,1,4,-1,-4,3,-2,-5,7,-3,0,-2,-1,-1,-1,-1,2,-1
KR_6746139345,420,-3,-136,-11,-9,-2,2,0,-1,2,1,1,3,4,-6,6,0,-1,1,0,0,-10,-45,0,-6,6,21,0,-2,-1,-1,-1,-1,2,-1
KR_6769676751,440,-2,-82,-32,-5,1,0,1,1,2,3,1,3,4,-9,10,1,1,0,1,0,1,3,2,-9,7,-8,0,-1,1,-1,-1,1,4,-1
KR_6774219516,420,-2,-73,-2,-8,-8,8,0,1,2,3,0,4,4,-2,5,3,1,1,2,-2,-11,-25,-2,-5,7,2,0,0,-1,-1,-1,-1,1,-1
KR_6708910064,420,-3,-29,0,-8,-2,2,0,-1,3,2,2,1,3,-5,7,2,-2,2,0,-1,-8,26,-1,-5,6,0,0,-2,-1,-1,-1,-1,3,-1
KR_6774716111,420,0,-41,-4,-3,0,1,1,-1,3,2,-2,2,0,2,4,6,-2,2,0,0,-1,17,-1,-4,5,-1,0,-2,-1,1,-1,1,4,-1
KR_6767694315,420,-2,35,-1,-2,0,2,2,3,2,5,-6,7,1,0,1,1,1,0,1,0,5,33,-1,-5,6,-27,0,2,-1,1,1,1,5,-1
KR_6771378097,420,-4,-56,5,-5,-4,5,1,-5,9,4,2,2,4,-1,5,4,3,1,4,0,-9,-4,1,-7,6,1,0,-1,-1,1,-1,-1,4,-1
KR_6776547456,420,-3,-37,-1,-3,2,1,3,-5,7,2,2,2,4,-2,5,3,0,0,0,0,-7,49,1,-7,6,2,0,-1,-1,-1,-1,1,2,-1
KR_6749502293,420,2,-34,-32,2,-2,3,1,-1,2,1,-1,4,3,5,2,7,1,1,2,0,6,2,0,-7,7,3,0,1,0,-1,1,1,0,-1
KR_6749446316,420,-4,-48,-36,-4,3,3,6,4,1,5,-8,10,2,-3,3,0,0,1,1,0,-6,-37,0,-9,9,-4,0,-3,-1,-1,-1,-1,1,-1
KR_6766954478,440,-4,-8,11,-15,-3,3,0,-5,5,0,2,4,6,-7,8,1,-2,2,0,-1,-20,-9,-4,-1,5,2,0,-1,0,-1,-1,-1,0,-1
KR_6775339182,420,-1,-3,11,1,0,1,1,1,2,3,3,2,5,-1,3,2,-2,2,0,0,1,-2,2,-11,9,-6,0,-1,-1,1,-1,-1,2,-1
KR_6777246617,420,-1,11,1,0,-1,3,2,5,0,5,2,2,4,-7,8,1,1,2,3,0,5,9,3,-7,4,-6,0,0,-1,1,-1,-1,6,-1
KR_6729894146,420,0,3,-23,-12,3,1,4,-6,9,3,-4,4,0,-7,11,4,2,0,2,-1,-17,20,-9,-2,11,0,0,-2,-1,-1,-1,-1,6,-1
KR_6758621719,420,-4,-25,-34,-13,-3,5,2,-1,3,2,-6,7,1,-6,6,0,3,0,3,0,-12,-16,-2,-8,10,-2,0,-1,-1,-1,-1,-1,1,-1
KR_6770862383,420,-2,-13,-17,-10,-2,3,1,-2,4,2,-3,6,3,-3,4,1,0,0,0,0,-9,-29,-1,-3,4,-2,0,-1,1,-1,-1,-1,5,-1
KR_6760713790,420,0,-18,-26,-2,-4,5,1,-1,2,1,0,1,1,1,0,1,2,0,2,0,4,-2,3,-8,5,5,0,0,1,1,1,-1,4,-1
KR_6769991747,420,-1,5,-29,-7,-1,2,1,-6,6,0,2,4,6,0,2,2,-2,3,1,-1,-15,-13,-2,-5,7,5,0,-1,-1,-1,-1,-1,2,-1
KR_6776754081,420,0,33,4,-3,1,2,3,-1,3,2,-5,5,0,3,2,5,-1,1,0,0,-9,-1,-4,-4,8,6,0,0,-1,-1,0,-1,4,-1
KR_6773075097,440,-2,-4,-7,-4,7,0,7,-3,3,0,-2,2,0,-5,5,0,-1,3,2,0,-13,-46,-5,-4,9,17,0,0,-1,1,0,1,3,-1
KR_6744219459,420,-3,17,-16,-9,3,0,3,-2,6,4,-4,6,2,-6,7,1,0,2,2,0,-11,-18,2,-7,5,-3,0,0,1,1,-1,-1,4,-1
KR_6767502555,420,-2,-29,-29,-4,-2,3,1,3,1,4,-2,6,4,-3,4,1,0,1,1,0,-7,-2,-1,-6,7,-3,0,-1,-1,-1,-1,-1,5,-1
KR_6734896487,420,-7,-27,-19,-17,-4,4,0,-4,7,3,-2,2,0,-8,9,1,1,1,2,0,-14,11,1,-5,4,-2,0,-1,1,-1,-1,-1,5,-1
KR_6766052565,420,2,-17,-20,4,1,1,2,-4,6,2,7,0,7,-2,3,1,2,0,2,0,7,-4,-1,-4,5,0,0,0,-1,1,0,1,5,-1
KR_6776379254,420,-2,-33,-4,-5,0,1,1,1,2,3,-1,5,4,0,1,1,-5,5,0,0,-4,33,-10,-2,12,-2,0,-1,-1,-1,-1,-1,5,-1
KR_6759311455,420,-1,14,-14,-3,-2,4,2,2,4,6,-3,4,1,1,1,2,-1,1,0,0,1,1,-4,-3,7,3,0,-1,-1,1,1,-1,4,-1
KR_6764857079,420,1,28,-3,0,-1,3,2,0,2,2,-2,3,1,3,2,5,0,1,1,0,-4,24,-3,-6,9,1,0,0,-1,-1,1,-1,4,-1
KR_6775540267,420,-2,38,-51,-6,-2,2,0,-6,9,3,-1,3,2,4,2,6,-1,1,0,1,-2,4,1,-8,7,-5,0,0,-1,-1,0,1,4,-1
KR_6744819140,420,-1,-26,12,-4,2,0,2,-4,5,1,-2,3,1,-4,5,1,4,2,6,0,-4,-6,-3,-2,5,-3,0,-1,-1,-1,-1,-1,6,-1
KR_6767592055,420,-2,10,-23,-2,-2,2,0,2,1,3,-10,10,0,7,0,7,1,2,3,0,7,-1,0,-4,4,2,0,-1,1,-1,-1,1,4,-1
KR_6772407216,420,0,-9,-12,0,4,0,4,0,1,1,0,1,1,-6,7,1,2,0,2,1,-3,-68,0,-9,9,15,0,-1,-1,-1,-1,1,1,-1
KR_6774285083,420,0,-26,-2,5,-1,3,2,4,1,5,-1,2,1,1,2,3,2,1,3,0,6,-1,0,-5,5,-7,0,-1,1,-1,-1,1,5,-1
KR_6770537334,420,0,28,4,2,0,1,1,3,1,4,-1,3,2,-1,2,1,1,0,1,0,4,29,-5,-4,9,0,0,0,1,-1,0,1,6,-1
KR_6775251279,420,-5,-63,28,-10,-5,6,1,0,1,1,-2,3,1,-3,4,1,0,0,0,0,-9,8,-1,-5,6,-4,0,-1,1,1,-1,1,2,-1
KR_6766212611,420,1,-3,4,8,-1,1,0,3,2,5,1,3,4,5,0,5,0,1,1,1,12,4,4,-8,4,5,0,0,1,1,1,1,4,-1
KR_6770679011,420,-2,-53,-7,-6,-1,1,0,-2,2,0,2,1,3,-7,8,1,2,1,3,0,-8,-14,-8,-2,10,1,0,-2,-1,-1,-1,1,2,-1
KR_6765505323,420,0,-49,-22,-9,2,1,3,-1,2,1,-4,7,3,-7,8,1,1,0,1,-1,-8,31,-4,-3,7,-12,0,1,-1,-1,1,-1,5,-1
KR_6760275890,420,-6,-104,-24,-7,1,1,2,-1,2,1,-1,5,4,-4,5,1,-2,3,1,0,5,-36,-4,-2,6,4,0,-3,-1,-1,-1,-1,5,-1
KR_6773495953,420,-2,-55,25,0,-1,5,4,-1,7,6,2,1,3,0,1,1,0,0,0,-1,-4,-7,-4,-3,7,-3,0,0,-1,1,1,-1,4,-1
KR_6768456674,440,3,26,35,10,4,2,6,-3,4,1,-1,4,3,2,1,3,8,1,9,0,9,98,5,-9,4,2,0,0,-1,1,0,1,1,-1
KR_6775164447,420,-1,-21,-1,-10,-1,1,0,-5,8,3,-3,4,1,-2,2,0,1,0,1,0,-11,3,1,-7,6,-4,0,-1,1,-1,-1,1,5,-1
KR_6776761129,420,-6,-60,-40,-20,-1,3,2,-6,8,2,-5,6,1,-2,6,4,-6,9,3,1,-22,0,-4,-4,8,0,0,-2,-1,-1,-1,-1,6,-1
KR_6776141428,420,1,-30,7,2,5,0,5,-1,7,6,-2,2,0,1,1,2,-1,1,0,0,-4,-3,0,-8,8,-1,0,0,-1,1,0,1,1,-1
KR_6776739512,420,-4,-62,-5,-7,-1,2,1,-1,1,0,-1,3,2,-4,9,5,0,1,1,0,-8,-143,-3,-5,8,0,0,0,-1,1,0,-1,2,-1
KR_6698464602,420,-5,-29,-29,-5,1,2,3,-3,4,1,0,1,1,-3,3,0,0,0,0,0,-6,-8,-3,-5,8,4,0,0,-1,1,-1,1,3,-1
KR_6777793794,420,-1,-66,44,-13,-3,3,0,-5,6,1,1,0,1,-6,6,0,0,1,1,0,-17,-3,-1,-5,6,-5,0,-1,-1,-1,-1,-1,5,-1
KR_6764905075,420,2,-48,11,3,-1,4,3,5,3,8,-1,3,2,0,1,1,0,3,3,1,14,0,-3,-4,7,1,0,0,1,1,0,1,4,-1
KR_6762155362,420,-1,53,-19,-2,1,2,3,-1,2,1,-1,2,1,0,1,1,-1,1,0,0,-3,36,-1,-4,5,-3,0,0,-1,1,0,-1,4,-1
KR_6776924998,420,-2,-56,10,0,-1,1,0,-2,8,6,2,1,3,1,1,2,0,0,0,0,0,110,3,-8,5,-5,0,1,1,1,1,-1,6,-1
KR_6776986609,420,-1,0,5,-4,-1,3,2,2,1,3,5,0,5,-7,7,0,-3,4,1,0,1,-123,-3,-5,8,6,0,1,1,1,1,1,1,-1
KR_6704226392,420,1,32,14,-5,-1,4,3,1,1,2,1,2,3,-4,4,0,-2,2,0,0,-8,49,-1,-8,9,-14,0,1,-1,1,1,1,2,-1
KR_6768900568,420,-1,-50,24,-8,-1,2,1,-1,4,3,0,2,2,-6,6,0,0,2,2,0,-10,11,4,-12,8,-3,0,0,-1,1,1,-1,5,-1
KR_6772495574,420,-4,-97,-38,-6,1,1,2,-1,5,4,0,6,6,-1,4,3,-5,9,4,-2,-6,2,1,-4,3,1,0,0,-1,-1,-1,-1,4,-1
KR_6716529331,420,-4,1,-29,-3,-1,2,1,-3,3,0,-3,5,2,2,0,2,2,1,3,0,-4,3,3,-5,2,0,0,0,-1,1,0,1,4,-1
KR_6726004528,420,-6,-77,-44,-13,-3,5,2,-6,9,3,-2,5,3,-2,3,1,0,0,0,0,-2,-7,1,-7,6,3,0,0,-1,-1,-1,-1,1,-1
KR_6774131603,420,-3,0,3,-5,0,2,2,-2,3,1,1,2,3,-2,3,1,-2,3,1,0,-7,-14,-3,-5,8,3,0,-2,-1,-1,-1,-1,5,-1
KR_6763772051,420,-3,-29,-32,-2,1,1,2,0,4,4,-2,4,2,0,2,2,-1,1,0,0,-6,-11,-5,-4,9,-2,0,-2,-1,-1,-1,-1,1,-1
KR_6767934435,420,-4,1,-24,-4,1,0,1,5,1,6,-5,5,0,-4,4,0,-1,1,0,0,-3,15,1,-6,5,-4,0,0,0,-1,0,-1,0,-1
KR_6775181050,420,-5,-132,6,-8,-4,4,0,1,0,1,0,0,0,-5,5,0,0,0,0,0,-7,-5,-4,-4,8,-7,0,-1,-1,-1,-1,-1,5,-1
KR_6752985388,420,-2,38,-20,-3,-2,3,1,-1,4,3,2,0,2,-2,3,1,0,1,1,0,-7,-7,-2,-5,7,-1,0,0,-1,-1,0,1,3,-1
KR_6770873994,420,1,26,-15,-7,-1,1,0,-2,4,2,-5,6,1,2,2,4,-1,3,2,0,-8,-5,1,-5,4,-2,0,-1,-1,-1,-1,-1,4,-1
KR_6767175694,420,-3,-7,12,-8,-5,7,2,-1,3,2,-5,5,0,3,0,3,0,0,0,1,4,32,2,-8,6,-3,0,-1,0,-1,-1,1,0,-1
KR_6776294920,420,-2,-33,0,-3,0,3,3,-3,3,0,0,1,1,2,0,2,-2,2,0,0,0,-9,2,-5,3,-4,0,-1,-1,-1,-1,-1,1,-1
KR_6773102571,420,0,-18,-20,-6,-5,5,0,2,3,5,0,3,3,-5,7,2,2,1,3,0,-4,8,5,-12,7,-10,0,-1,-1,-1,-1,1,3,-1
KR_6685458596,420,-1,36,-18,5,-2,5,3,2,1,3,-1,3,2,3,3,6,3,1,4,2,14,8,5,-7,2,-3,0,-1,-1,-1,-1,1,5,-1
KR_6769671558,440,-2,-39,5,-4,4,1,5,1,3,4,-3,4,1,-6,6,0,0,2,2,0,-4,1,4,-7,3,3,0,-1,0,-1,-1,-1,0,-1
KR_6738580282,440,0,62,3,4,1,1,2,0,1,1,4,0,4,-2,5,3,1,1,2,0,0,-12,0,-3,3,4,0,1,1,1,1,1,3,-1
KR_6777694607,420,-2,-45,10,-8,-2,2,0,-1,6,5,-3,5,2,1,1,2,-3,5,2,-1,-11,-12,0,-7,7,-1,0,0,1,1,-1,-1,6,-1
KR_6767091184,420,-5,-66,-20,-9,-2,2,0,-3,4,1,0,1,1,-2,3,1,-2,2,0,0,-8,-7,6,-10,4,0,0,-2,-1,1,-1,-1,4,-1
KR_6775936324,420,-1,-48,4,-3,2,0,2,-5,7,2,3,2,5,-4,5,1,1,0,1,0,-8,-5,-1,-6,7,1,0,1,-1,1,1,1,3,-1
KR_6754354275,420,2,-35,27,0,-5,5,0,2,1,3,2,1,3,1,1,2,0,0,0,0,6,-35,1,-3,2,-6,0,-1,-1,1,-1,-1,2,-1
KR_6770520144,420,-7,-49,-36,-12,-6,7,1,-2,4,2,0,4,4,-6,6,0,2,0,2,1,-15,141,-4,-2,6,-1,0,0,-1,-1,-1,1,4,-1
KR_6774358456,420,-6,15,-10,-10,-6,7,1,2,4,6,0,2,2,-5,5,0,-1,2,1,0,-8,-41,1,-5,4,1,0,-2,-1,-1,-1,1,5,-1
KR_6777493957,420,-7,-8,-20,-5,-4,5,1,-4,7,3,1,1,2,2,1,3,0,1,1,1,2,-2,2,-5,3,-1,0,-1,-1,-1,-1,1,5,-1
KR_6689542526,420,0,27,-16,-3,1,1,2,0,3,3,-1,2,1,-2,2,0,-1,1,0,0,0,-1,0,-4,4,-1,0,0,-1,0,0,-1,5,-1
KR_6774790161,420,1,-55,-33,4,1,2,3,0,2,2,2,0,2,1,1,2,0,0,0,0,4,1,0,-5,5,-1,0,0,-1,-1,0,1,3,-1
KR_6777077063,420,-2,-69,16,0,0,5,5,4,1,5,-5,5,0,0,2,2,1,0,1,0,-14,-2,0,-7,7,-2,0,1,-1,1,1,1,4,-1
KR_6767412386,420,-4,4,8,-17,-3,4,1,-1,1,0,-4,8,4,-7,9,2,-2,2,0,0,-24,6,-1,-4,5,-3,0,-1,-1,-1,-1,-1,1,-1
KR_6771513311,420,-2,-20,-19,-10,-7,8,1,-1,6,5,-2,3,1,1,3,4,-1,1,0,0,-5,9,10,-12,2,-3,0,-2,1,-1,-1,-1,1,-1
KR_6725212675,420,-3,-44,-4,2,2,1,3,2,1,3,1,2,3,-3,4,1,0,1,1,0,3,-47,4,-8,4,17,0,0,-1,-1,-1,-1,2,-1
KR_6777424895,420,1,-35,-7,5,2,1,3,2,4,6,5,0,5,-5,5,0,1,0,1,0,2,6,-2,-7,9,-5,0,-3,-1,1,-1,1,6,-1
KR_6732809934,420,-1,3,-20,-4,0,3,3,-1,2,1,-4,6,2,2,1,3,-1,2,1,1,-14,5,6,-13,7,-5,0,0,1,1,0,1,2,-1
KR_6777539466,440,-3,-10,-47,-9,1,0,1,-6,7,1,0,3,3,-5,6,1,1,0,1,0,-14,-9,4,-10,6,-2,0,0,-1,-1,0,-1,4,-1
KR_6744434810,420,0,46,-6,0,-3,3,0,-3,4,1,-1,3,2,5,1,6,2,0,2,-1,4,-1,-3,-2,5,2,0,1,1,1,1,-1,4,-1
KR_6757800017,420,-4,-51,32,-14,-3,4,1,-4,6,2,-4,7,3,-2,5,3,-1,1,0,-1,-20,-22,0,-5,5,0,0,-1,1,1,-1,1,4,-1
KR_6729931426,420,-6,-55,-19,-13,1,4,5,1,1,2,-5,5,0,-9,9,0,-1,1,0,-1,-16,-43,0,-6,6,12,0,-2,-1,1,-1,-1,1,-1
KR_6771728260,440,-1,19,-11,3,1,1,2,-1,2,1,-1,7,6,5,1,6,-1,2,1,0,16,1,2,-6,4,2,0,0,1,1,-1,-1,3,-1
KR_6766657892,420,-2,-11,12,-6,-1,2,1,-2,4,2,3,0,3,-4,5,1,-2,2,0,0,-6,8,4,-8,4,-4,0,-1,0,-1,-1,1,0,-1
KR_6774913115,420,-4,-24,11,-10,-2,2,0,0,2,2,-2,3,1,-5,5,0,-1,2,1,0,-16,0,0,-7,7,-2,0,0,-1,-1,-1,-1,5,-1
KR_6721066874,420,-6,-33,-26,-13,-4,4,0,-3,4,1,-4,7,3,-2,2,0,0,0,0,0,-19,7,4,-8,4,-3,0,-2,-1,-1,-1,-1,5,-1
KR_6777539413,420,3,28,-12,-1,-1,2,1,-3,5,2,2,2,4,4,1,5,-3,3,0,-1,-7,-11,1,-6,5,-5,0,0,1,-1,0,-1,4,-1
KR_6775619845,420,-3,13,-16,-2,-1,2,1,2,2,4,-2,2,0,-1,6,5,0,1,1,0,-8,-7,-1,-6,7,-1,0,0,1,-1,-1,-1,2,-1
KR_6762266584,420,0,8,16,2,5,0,5,-3,7,4,4,3,7,-2,6,4,-2,2,0,2,14,40,2,-9,7,-6,0,-1,-1,1,-1,1,2,-1
KR_6777157110,420,0,31,5,-7,0,2,2,-2,6,4,1,1,2,-6,7,1,0,0,0,-2,-14,3,4,-9,5,-6,0,1,1,-1,1,-1,1,-1
KR_6681613473,420,-4,-43,6,-4,-11,11,0,7,0,7,4,2,6,-6,7,1,2,0,2,0,2,12,8,-11,3,-5,0,-1,-1,-1,-1,1,5,-1
KR_6741817406,440,-3,-9,-15,-6,-6,8,2,-7,8,1,-1,4,3,4,0,4,4,0,4,0,-2,-266,-1,-4,5,-3,0,-1,-1,-1,-1,-1,2,-1
KR_6777126527,420,1,55,19,1,3,2,5,-3,4,1,-5,8,3,5,0,5,1,0,1,0,2,-12,1,-5,4,0,0,-1,1,-1,-1,-1,2,-1
KR_6716569322,420,-5,-33,-9,-11,-5,5,0,-2,2,0,0,2,2,-1,3,2,-3,4,1,-1,-19,-13,-10,-2,12,5,-1,-3,1,-1,-1,-1,4,-1
KR_6772363452,420,3,-30,19,3,1,1,2,1,1,2,0,2,2,-2,3,1,3,0,3,0,-4,6,1,-6,5,-3,0,0,0,1,-1,-1,0,-1
KR_6767604872,420,3,38,24,4,2,0,2,0,2,2,1,2,3,2,0,2,-1,2,1,0,7,1,-1,-8,9,0,0,0,1,-1,0,-1,5,-1
KR_6766665278,420,-4,-102,-21,-5,-1,3,2,2,2,4,-8,8,0,4,2,6,-2,3,1,0,3,0,-2,-5,7,-3,0,-2,-1,-1,-1,-1,1,-1
KR_6768422139,420,-1,-52,11,-2,2,1,3,3,2,5,1,3,4,-7,9,2,-1,1,0,-1,-12,1,-1,-6,7,-3,0,1,-1,1,1,-1,6,-1
KR_6774626130,420,0,-2,-1,1,0,1,1,-3,3,0,-1,3,2,0,2,2,5,1,6,0,4,3,1,-8,7,1,0,-1,1,1,-1,1,4,-1
KR_6753523628,420,0,0,-20,3,-1,3,2,-7,9,2,6,0,6,1,2,3,4,0,4,0,2,0,1,-6,5,2,0,2,1,1,1,1,4,-1
KR_6759776816,420,-1,-21,-2,3,2,1,3,-2,3,1,0,3,3,2,1,3,1,0,1,0,0,5,3,-8,5,-6,0,-1,-1,1,-1,-1,5,-1
KR_6777095173,420,-2,-71,-40,-7,-2,3,1,0,5,5,-4,10,6,-3,5,2,2,1,3,-1,-9,-12,3,-6,3,-1,0,-2,-1,-1,-1,-1,5,-1
KR_6765805622,420,0,-42,28,0,2,0,2,0,3,3,0,2,2,-1,2,1,-1,1,0,0,2,8,1,-3,2,-1,0,-1,-1,1,-1,-1,6,-1
KR_6745471217,420,-1,35,-11,-3,-2,2,0,1,2,3,-1,4,3,-1,4,3,0,1,1,0,0,-46,-6,-2,8,21,0,0,-1,1,0,-1,6,-1
KR_6757870044,420,3,57,-43,10,9,0,9,4,1,5,2,2,4,-7,9,2,2,0,2,0,5,4,3,-8,5,5,0,1,-1,1,1,1,6,-1
KR_6774265748,420,-4,-50,-6,-14,-3,4,1,-4,5,1,-2,2,0,-2,5,3,-3,4,1,-2,-16,-1,0,-4,4,-5,0,0,1,-1,-1,-1,1,-1
KR_6748231395,420,-2,-18,11,-2,-3,5,2,2,3,5,0,2,2,-3,4,1,2,0,2,0,-6,84,2,-6,4,1,0,0,-1,1,0,1,5,-1
KR_6769152466,420,1,33,-6,1,3,1,4,0,1,1,-5,5,0,2,1,3,1,0,1,0,4,-8,-1,-6,7,2,0,0,-1,-1,-1,-1,2,-1
KR_6737447394,420,-2,-43,19,-1,2,2,4,2,1,3,2,2,4,-8,9,1,1,0,1,0,-3,7,2,-7,5,-3,0,-2,-1,1,-1,-1,2,-1
KR_6745648776,420,0,36,-24,1,1,4,5,5,2,7,-6,7,1,-2,2,0,3,0,3,0,-2,-33,1,-8,7,-4,0,1,-1,1,1,-1,4,-1
KR_6775695577,420,3,69,-5,7,1,0,1,6,1,7,1,0,1,-3,4,1,2,0,2,1,4,6,2,-7,5,4,0,1,0,1,1,1,0,-1
KR_6726262951,420,-2,-13,-20,-1,1,1,2,0,2,2,1,4,5,-2,5,3,-1,1,0,0,-10,4,2,-9,7,-1,0,1,-1,1,1,1,3,-1
KR_6753292422,420,-1,-66,16,-4,-1,3,2,-1,5,4,0,5,5,-1,1,0,-1,2,1,0,-5,1,-2,-4,6,4,0,-4,-1,-1,-1,1,2,-1
KR_6722909932,440,-3,26,-23,-6,0,0,0,-4,4,0,0,0,0,-1,1,0,-1,1,0,0,-6,12,0,-4,4,2,0,0,0,-1,0,-1,0,-1
KR_6777261603,420,-6,-90,-12,-8,-5,6,1,-5,7,2,4,1,5,-2,2,0,0,0,0,0,-4,2,0,-5,5,-3,0,-2,-1,-1,-1,-1,5,-1
KR_6774145403,420,-2,32,-1,-10,1,1,2,0,3,3,-8,9,1,-1,3,2,-2,4,2,0,-12,4,1,-5,4,-4,0,-2,-1,-1,-1,1,1,-1
KR_6735251587,420,-2,-89,11,-8,-3,3,0,1,3,4,-4,5,1,-1,4,3,-1,3,2,0,-18,36,1,-7,6,-1,0,0,-1,-1,0,1,5,-1
KR_6772019517,440,2,36,8,-2,-3,4,1,3,1,4,2,0,2,-5,7,2,1,1,2,0,-3,3,-6,-4,10,-1,0,0,-1,1,0,-1,4,-1
KR_6757019779,420,-3,-42,-15,-9,-6,6,0,-1,3,2,0,1,1,-1,3,2,-1,1,0,0,-1,-8,3,-5,2,-1,0,-1,1,-1,-1,-1,1,-1
KR_6772909483,420,-3,-63,-20,-6,-1,2,1,1,2,3,1,2,3,-2,2,0,-5,5,0,0,-5,-138,-5,-4,9,-2,0,-2,-1,-1,-1,-1,3,-1
KR_6719813982,420,-6,-80,-3,-13,-2,2,0,-4,5,1,-2,5,3,-3,3,0,-2,2,0,0,-20,12,2,-8,6,-1,0,-3,-1,1,-1,-1,1,-1
KR_6774170155,420,-6,-77,11,-18,-3,4,1,-5,5,0,-4,4,0,-4,4,0,-2,3,1,0,-15,0,-1,-5,6,-10,0,0,-1,1,-1,-1,3,-1
KR_6775657738,420,-2,6,-10,-11,0,2,2,-5,7,2,-4,4,0,-3,3,0,1,0,1,-1,-18,-8,0,-2,2,-2,0,1,-1,-1,1,-1,2,-1
KR_6721742670,420,-4,-51,-22,-10,-3,4,1,0,1,1,-1,2,1,-5,5,0,-1,2,1,0,-8,-17,-1,-5,6,2,0,1,1,1,-1,-1,3,-1
KR_6756699515,420,-2,6,-16,-5,-4,6,2,2,1,3,-4,5,1,1,1,2,0,0,0,0,2,-37,4,-9,5,-2,0,-2,1,-1,-1,1,3,-1
KR_6747065872,420,-9,-160,-31,-24,-4,4,0,-5,5,0,-3,4,1,-12,12,0,0,1,1,0,-21,-16,-3,-6,9,3,-2,-3,-1,-1,-1,-1,1,-1
KR_6777349676,420,3,82,28,4,0,1,1,1,1,2,4,0,4,-3,3,0,2,0,2,1,7,1,3,-8,5,5,0,1,1,1,1,1,2,-1
KR_6671429389,420,-2,-36,-16,-9,-8,9,1,0,0,0,0,2,2,-1,5,4,0,1,1,-1,-6,-145,-6,-3,9,0,0,-3,-1,-1,-1,-1,4,-1
KR_6777006968,420,-1,-49,64,-5,-1,1,0,-4,5,1,-1,4,3,0,1,1,1,2,3,0,-3,21,0,-7,7,3,0,-1,1,-1,-1,-1,3,-1
KR_6750885833,440,4,60,16,7,0,1,1,1,0,1,1,2,3,-1,4,3,6,0,6,0,-4,-93,0,-5,5,-2,0,3,0,0,1,1,0,-1
KR_6767729627,420,-1,-44,11,-1,2,0,2,-1,5,4,-2,4,2,1,4,5,-1,3,2,0,0,-1,7,-7,0,-5,0,-1,-1,1,-1,1,6,-1
KR_6775888098,420,3,63,12,-1,0,2,2,0,3,3,2,2,4,-3,7,4,0,1,1,-1,-2,7,2,-10,8,-8,0,1,0,-1,1,-1,0,-1
KR_6774281393,420,1,30,23,-6,-2,3,1,1,2,3,-2,3,1,-1,3,2,-2,4,2,0,-15,-9,-2,-10,12,4,0,0,1,-1,0,-1,2,-1
KR_6773891096,420,-5,-8,-18,-9,-1,1,0,1,3,4,-1,3,2,-7,7,0,-1,1,0,0,-2,-8,1,-10,9,1,0,-1,-1,1,-1,1,4,-1
KR_6760859931,420,-3,6,6,-9,2,0,2,0,4,4,-6,6,0,-6,6,0,1,0,1,0,-15,-5,-4,-5,9,-4,0,0,1,-1,-1,-1,2,-1
KR_6756323867,420,1,-2,-8,7,-2,2,0,8,0,8,0,0,0,-3,3,0,4,1,5,0,11,-1,0,-4,4,-3,0,0,1,1,0,1,4,-1
KR_6776116662,420,0,26,-7,-1,0,2,2,2,4,6,-1,3,2,-4,5,1,2,0,2,0,-7,290,-5,-3,8,4,0,1,1,1,1,1,1,-1
KR_6721874138,420,-3,-45,-9,-9,-5,5,0,-3,7,4,-4,5,1,-1,3,2,4,0,4,3,4,-15,0,-11,11,-5,0,0,1,-1,0,1,4,-1
KR_6765007826,420,-2,0,-6,-3,0,2,2,-6,6,0,1,3,4,2,2,4,0,0,0,0,-8,3,2,-5,3,-5,0,-1,1,1,-1,1,2,-1
KR_6733546692,420,-3,-3,-20,-8,0,3,3,0,5,5,-5,6,1,-1,2,1,-2,2,0,0,-7,11,1,-5,4,-1,0,-1,-1,-1,-1,1,2,-1
KR_6742226586,420,-1,-20,-26,-1,3,0,3,-5,7,2,1,1,2,0,3,3,0,1,1,0,-13,3,0,-8,8,-8,0,-1,-1,1,-1,1,3,-1
KR_6772487090,420,-1,52,7,-8,0,1,1,-3,3,0,-3,8,5,-1,1,0,-1,1,0,0,-8,-156,-2,-6,8,-1,0,0,-1,1,-1,1,1,-1
KR_6768016674,420,-7,-54,-60,-11,1,1,2,-2,2,0,0,3,3,-10,12,2,0,1,1,0,-8,9,-2,-3,5,-4,0,-1,-1,1,-1,-1,6,-1
KR_6752728721,420,0,-22,-33,-2,-2,3,1,0,3,3,0,2,2,2,1,3,-2,2,0,-1,-6,-25,-2,-5,7,3,0,-1,1,-1,-1,-1,4,-1
KR_6775023836,420,1,34,-4,7,-2,3,1,5,1,6,0,2,2,5,0,5,-1,2,1,0,10,4,-3,-8,11,-2,0,1,1,1,1,1,5,-1
KR_6742073185,420,-5,-4,-11,-17,-1,2,1,-11,13,2,-4,5,1,-1,2,1,0,1,1,0,-21,-17,1,-8,7,0,0,-2,1,-1,-1,-1,2,-1
KR_6774332342,420,0,3,-19,-5,-1,2,1,-1,4,3,0,3,3,-2,3,1,-1,1,0,-1,-1,1,-3,-5,8,-2,0,-1,0,-1,-1,-1,0,-1
KR_6749823745,420,1,43,-2,3,0,2,2,-3,6,3,4,1,5,4,0,4,-2,2,0,0,6,6,5,-7,2,-1,0,-1,-1,-1,-1,1,5,-1
KR_6741585192,420,-2,-21,19,-11,-6,7,1,-3,3,0,-1,2,1,-2,2,0,1,2,3,0,-10,-21,2,-7,5,-1,0,-2,0,1,-1,-1,0,-1
KR_6770297990,420,1,29,9,-2,1,0,1,-1,3,2,-4,4,0,0,3,3,2,1,3,0,-8,37,-2,-2,4,-3,0,1,-1,1,1,1,6,-1
KR_6740033987,420,-5,-37,6,-14,-1,1,0,0,2,2,-11,11,0,-2,4,2,0,1,1,0,-12,-3,-5,-1,6,-3,0,-2,-1,-1,-1,1,3,-1
KR_6773690803,420,-1,-48,-48,6,0,3,3,1,3,4,1,3,4,5,2,7,-1,1,0,0,3,2,1,-6,5,-7,0,-1,1,1,-1,1,1,-1
KR_6656726842,420,3,35,-40,2,1,2,3,-3,4,1,3,1,4,-1,4,3,2,0,2,0,2,-5,-2,-5,7,2,0,1,-1,-1,1,1,6,-1
KR_6772827499,420,-4,-53,20,-6,-1,3,2,-1,2,1,-3,3,0,-1,2,1,0,0,0,1,-9,-6,2,-4,2,0,0,-1,1,-1,-1,1,4,-1
KR_6765768187,440,-4,-7,2,-5,3,1,4,-2,3,1,-3,3,0,-3,5,2,0,0,0,0,-7,-38,-1,-2,3,14,0,1,-1,1,1,-1,5,-1
KR_6773965710,420,0,33,15,-5,-1,1,0,4,4,8,-4,4,0,3,1,4,-7,9,2,0,-7,-51,5,-9,4,-3,0,-1,1,1,-1,1,5,-1
KR_6732081654,420,-2,-14,20,-5,-3,4,1,-3,4,1,3,2,5,2,2,4,-4,4,0,1,-5,-231,2,-8,6,7,0,0,-1,1,0,1,4,-1
KR_6773662327,420,-2,-62,-6,-10,-3,4,1,1,4,5,-4,8,4,-3,4,1,-1,1,0,0,-10,-4,-4,-2,6,-3,0,0,1,1,-1,-1,5,-1
KR_6760718560,420,-3,-41,16,4,-3,5,2,1,1,2,6,1,7,0,4,4,0,0,0,0,-3,23,4,-5,1,1,0,0,0,0,1,1,0,-1
KR_6777513129,420,-2,-51,31,-7,-4,6,2,0,1,1,0,3,3,-2,5,3,-1,2,1,-1,-15,27,5,-10,5,-11,0,-2,-1,-1,-1,-1,6,-1
KR_6764984156,420,0,33,33,-3,-1,1,0,0,2,2,-4,4,0,3,0,3,-1,1,0,0,-5,-2,-4,-7,11,0,0,1,1,-1,1,1,2,-1
KR_6777232769,420,-1,-35,17,-2,-1,1,0,1,1,2,-2,2,0,-2,2,0,2,0,2,0,-2,9,5,-7,2,-2,0,1,1,1,1,-1,6,-1
KR_6770071332,420,-4,-10,8,-14,1,0,1,-4,4,0,-6,7,1,-6,7,1,1,0,1,-2,-20,-10,-6,-5,11,-10,0,-2,-1,-1,-1,-1,3,-1
KR_6774196172,420,-1,-45,-5,-8,2,1,3,-2,7,5,-5,6,1,-2,6,4,-1,2,1,0,-9,85,-3,-5,8,-5,0,0,-1,1,-1,1,3,-1
KR_6748014819,420,0,-1,-11,12,2,1,3,-5,6,1,8,1,9,7,1,8,0,1,1,0,4,58,14,-15,1,-2,0,1,1,1,1,1,2,-1
KR_6765667947,420,0,-64,11,-4,-3,4,1,-3,3,0,1,0,1,0,1,1,1,1,2,0,-3,8,-5,-4,9,-8,0,-1,1,-1,-1,-1,6,-1
KR_6775369612,420,3,-7,17,9,4,0,4,2,4,6,1,2,3,3,1,4,-1,2,1,0,15,11,3,-8,5,-1,0,0,-1,1,0,-1,3,-1
KR_6775645964,420,-3,-58,-22,-13,0,3,3,-5,6,1,-1,2,1,-8,8,0,1,1,2,0,-14,-3,-1,-5,6,-2,0,1,-1,1,1,-1,5,-1
KR_6745040822,420,-1,35,-1,-2,7,0,7,-3,4,1,1,1,2,-5,7,2,-2,3,1,0,-14,35,-7,-3,10,-4,0,-1,-1,-1,-1,-1,5,-1
KR_6762323547,420,-4,-29,-4,-13,-2,2,0,-5,6,1,-6,6,0,2,6,8,-2,3,1,0,-19,0,-4,-5,9,-3,0,-4,-1,-1,-1,-1,2,-1
KR_6769320834,420,-2,-22,14,-8,-5,6,1,0,2,2,-5,5,0,2,0,2,0,1,1,0,-10,10,4,-8,4,2,0,0,-1,1,0,1,6,-1
KR_6734794771,420,-4,-70,15,-10,0,3,3,-2,2,0,-2,3,1,-4,6,2,-2,2,0,-1,-17,-11,-5,-3,8,-2,0,-1,-1,-1,-1,-1,6,-1
KR_6717750046,420,-2,33,15,-8,2,1,3,-4,5,1,-2,3,1,-3,5,2,-1,2,1,0,-18,-9,-1,-6,7,-4,0,0,-1,1,1,-1,3,-1
KR_6719448618,420,-1,-62,12,-11,-5,5,0,-4,4,0,-1,4,3,2,1,3,-3,3,0,-1,-13,-1,-6,-3,9,-3,0,-1,-1,-1,-1,-1,4,-1
KR_6772641956,420,1,22,4,7,5,0,5,1,2,3,0,1,1,1,0,1,0,0,0,0,9,12,4,-9,5,-4,0,0,1,1,1,1,2,-1
KR_6762832113,420,0,-8,13,1,-5,6,1,0,1,1,0,1,1,3,7,10,3,1,4,0,7,1,-5,-3,8,4,0,-1,-1,-1,-1,1,4,-1
KR_6720240759,420,-3,-62,-1,-6,-2,2,0,0,2,2,-2,2,0,-2,3,1,0,2,2,-1,-8,30,-4,-5,9,4,0,0,1,-1,0,-1,3,-1
KR_6764699936,420,2,-54,-6,-5,1,2,3,-2,4,2,5,0,5,-7,10,3,-2,3,1,0,-11,-8,-5,-1,6,-3,0,-1,1,-1,-1,-1,3,-1
KR_6775262296,420,-1,-34,-6,0,3,1,4,1,1,2,2,1,3,-5,5,0,-1,2,1,2,2,64,0,-6,6,3,0,-1,1,1,-1,1,1,-1
KR_6747918726,440,-1,-65,-28,-6,0,1,1,3,0,3,-4,5,1,-1,3,2,-4,4,0,0,0,-13,0,-5,5,-1,0,0,1,-1,-1,1,2,-1
KR_6775055196,420,-1,0,-15,-1,-1,2,1,0,4,4,0,3,3,1,2,3,-1,3,2,0,5,9,-2,-4,6,0,0,0,-1,-1,-1,-1,2,-1
KR_6771694336,420,-3,7,24,-8,3,1,4,-3,4,1,-4,6,2,-3,4,1,-1,1,0,1,-18,-5,-1,-5,6,-1,0,-1,1,1,1,1,2,-1
KR_6776835486,420,-6,-111,-22,-14,0,1,1,-4,4,0,-3,4,1,-5,5,0,-2,2,0,0,-15,-35,2,-7,5,-4,0,-2,-1,-1,-1,-1,1,-1
KR_6661024882,420,-5,-28,-1,-22,-6,7,1,0,4,4,-2,4,2,-12,14,2,-2,3,1,-1,-24,-4,-4,-5,9,-3,0,-2,1,-1,-1,-1,3,-1
KR_6776046631,420,2,-10,-20,-3,0,1,1,-1,3,2,1,2,3,-1,1,0,-2,3,1,0,-5,-23,7,-11,4,-7,0,0,0,-1,0,-1,0,-1
KR_6725085778,420,0,36,-20,-6,-3,4,1,-5,6,1,-6,6,0,7,3,10,1,0,1,0,-4,-33,-2,-4,6,-2,0,0,-1,-1,-1,-1,6,-1
KR_6774749589,440,-3,-34,12,-8,-3,4,1,0,0,0,-1,3,2,-4,5,1,0,2,2,0,-9,-1,0,-8,8,-3,0,0,-1,1,0,-1,2,-1
KR_6776096916,420,-3,-45,-1,-6,5,2,7,-2,2,0,-4,5,1,-4,7,3,-1,1,0,0,-10,47,0,-4,4,-24,0,-1,-1,-1,-1,1,1,-1
KR_6776341270,420,-4,-16,-28,-15,-1,3,2,-5,6,1,-2,6,4,-6,7,1,-1,1,0,0,-28,-50,7,-11,4,-2,0,-1,-1,-1,1,1,5,-1
KR_6773902235,420,-2,-30,-13,-1,1,0,1,3,4,7,-5,5,0,0,5,5,0,3,3,0,1,-25,3,-10,7,-3,0,0,0,-1,0,-1,0,-1
KR_6776594788,420,-6,-34,-2,-13,-2,3,1,-3,3,0,-4,4,0,-3,4,1,-1,1,0,0,-11,-11,2,-6,4,-5,0,0,-1,1,-1,-1,1,-1
KR_6775609864,420,2,18,11,-3,5,0,5,-1,3,2,-1,3,2,-5,6,1,-1,1,0,0,0,-5,-1,-5,6,0,0,-1,-1,1,-1,1,1,-1
KR_6730869670,420,0,17,-11,1,1,0,1,4,1,5,-4,5,1,-1,2,1,1,1,2,0,-1,-15,-8,-2,10,8,0,0,1,1,0,1,2,-1
KR_6756776809,420,-3,-41,-4,-9,-5,5,0,-1,4,3,0,3,3,-4,5,1,1,1,2,0,-10,7,1,-6,5,-3,0,-2,-1,-1,-1,1,1,-1
KR_6774531183,420,-2,-61,-2,-2,0,1,1,2,1,3,1,2,3,-3,5,2,-2,2,0,0,-6,-3,-3,-3,6,-5,0,0,-1,1,0,1,3,-1
KR_6769296804,420,-6,-34,-20,-7,2,2,4,-4,7,3,-3,5,2,0,3,3,-2,2,0,0,-12,-9,-7,-6,13,3,0,-1,-1,1,-1,-1,5,-1
KR_6730959701,420,-6,-39,4,-19,-7,10,3,3,3,6,-7,9,2,-9,9,0,1,0,1,0,-21,-14,-1,-6,7,-3,0,-1,-1,1,-1,-1,2,-1
KR_6766175550,420,-2,-41,19,-6,2,2,4,-1,5,4,-4,7,3,0,6,6,-3,3,0,0,-5,-12,0,-6,6,-7,0,1,0,1,1,1,0,-1
KR_6686661395,420,-3,-29,-28,-2,0,2,2,3,0,3,1,2,3,-3,4,1,-3,3,0,0,4,3,-4,-5,9,1,0,0,-1,1,-1,1,1,-1
KR_6733776966,420,1,28,-8,1,1,1,2,-3,3,0,2,0,2,0,0,0,1,0,1,0,-4,-16,1,-9,8,1,0,-1,1,-1,-1,1,5,-1
KR_6774632917,420,-2,-23,-47,-9,-2,5,3,-9,10,1,0,1,1,4,1,5,-2,3,1,0,-10,12,1,-4,3,-8,0,-1,1,-1,-1,-1,2,-1
KR_6777709598,440,-4,-21,20,-3,-4,6,2,-9,11,2,4,2,6,5,0,5,1,2,3,0,2,5,0,-4,4,-3,0,-1,0,0,-1,1,0,-1
KR_6776742828,420,2,46,15,-2,1,1,2,0,1,1,1,2,3,0,2,2,-4,4,0,-1,-7,108,-2,-5,7,0,0,2,-1,1,1,-1,4,-1
KR_6736209700,420,-4,-28,-32,-9,-8,9,1,-1,5,4,0,1,1,1,2,3,-1,2,1,0,-1,0,-5,-2,7,-3,0,-1,1,-1,-1,-1,1,-1
KR_6752081306,420,0,27,-25,2,2,2,4,-5,5,0,0,2,2,3,3,6,2,0,2,-2,-1,2,-2,-8,10,2,0,1,-1,-1,1,-1,4,-1
KR_6761685064,440,-2,16,-8,-9,0,0,0,2,4,6,-6,6,0,-5,6,1,0,2,2,-2,-5,14,5,-10,5,-2,0,-1,-1,1,-1,-1,4,-1
KR_6772798451,420,0,-4,11,-8,-4,6,2,-4,5,1,-1,4,3,0,4,4,1,1,2,0,-6,-1,-5,-4,9,4,0,-2,-1,1,-1,1,5,-1
KR_6770086280,420,0,-41,-1,0,-2,5,3,4,2,6,0,2,2,-1,2,1,-1,2,1,0,1,50,-4,-4,8,0,0,1,-1,1,1,1,5,-1
KR_6748093789,420,-8,-44,-12,-11,-3,5,2,0,1,1,-9,11,2,2,3,5,-1,1,0,1,-11,-29,0,-4,4,2,0,-4,1,-1,-1,1,5,-1
KR_6740387448,420,1,-30,24,0,0,0,0,1,2,3,-1,1,0,-1,1,0,1,0,1,0,3,-4,-1,-6,7,4,0,-1,-1,1,-1,-1,4,-1
KR_6776328742,420,-2,-19,-32,-6,-5,5,0,-4,6,2,2,2,4,1,5,6,0,0,0,1,-6,0,1,-5,4,1,0,0,-1,-1,-1,-1,1,-1
KR_6769334108,420,-5,-43,0,-17,-3,3,0,-5,7,2,0,3,3,-10,10,0,1,1,2,0,-11,-7,-4,-2,6,0,0,-2,1,-1,-1,-1,5,-1
KR_6738983652,420,-2,1,-19,-4,-1,4,3,-2,5,3,-1,5,4,-3,5,2,3,1,4,0,3,25,-5,-5,10,3,0,0,1,1,1,1,3,-1
KR_6777349527,420,-1,49,-25,-1,-2,3,1,-2,3,1,1,3,4,2,0,2,0,1,1,0,2,85,4,-7,3,11,0,1,0,0,1,-1,0,-1
KR_6755220687,420,1,-29,-14,-8,1,2,3,-3,3,0,-2,3,1,-1,3,2,-3,3,0,0,-17,-10,-5,-3,8,5,0,0,-1,1,0,-1,2,-1
KR_6775031840,420,-3,-3,0,-17,-8,8,0,-3,4,1,-4,6,2,-2,3,1,0,1,1,0,-16,-20,-1,-12,13,-3,0,-1,-1,1,1,-1,1,-1
KR_6768658053,420,-1,-112,19,-7,-1,3,2,1,3,4,-3,4,1,-5,6,1,1,1,2,0,-13,-16,-3,-6,9,3,0,-2,-1,-1,-1,-1,1,-1
KR_6733054979,420,-3,-66,20,-8,0,1,1,-4,6,2,-1,3,2,2,1,3,-5,5,0,0,-5,-7,0,-4,4,5,0,0,0,-1,-1,-1,0,-1
KR_6701116686,420,-2,-25,16,-2,1,3,4,3,0,3,-4,6,2,-2,6,4,0,1,1,0,-4,-39,-3,-6,9,2,0,-1,1,-1,-1,-1,6,-1
KR_6774293439,420,-2,7,-29,-8,-2,4,2,-2,5,3,-1,3,2,0,3,3,-3,3,0,-1,-6,2,0,-5,5,-1,0,0,-1,-1,0,-1,3,-1
KR_6745478892,420,-3,-63,0,-9,-4,4,0,-3,4,1,1,1,2,-3,3,0,0,0,0,0,-12,1,-4,-6,10,-4,0,-2,1,-1,-1,-1,2,-1
KR_6773498028,420,-1,8,-2,0,-2,3,1,7,1,8,-1,2,1,-3,4,1,-1,2,1,0,3,7,0,-3,3,0,0,0,0,-1,0,-1,0,-1
KR_6743295160,420,-4,-127,-36,-8,-1,1,0,2,2,4,1,0,1,-5,6,1,-5,5,0,0,-6,-13,-5,-4,9,-8,0,-3,-1,-1,-1,-1,5,-1
KR_6776160342,420,-3,-41,-10,-6,2,0,2,-3,3,0,1,2,3,-6,7,1,0,1,1,0,-7,7,3,-10,7,-2,0,-1,1,-1,-1,-1,2,-1
KR_6774497879,420,1,-25,-3,-2,1,0,1,-3,3,0,1,1,2,-2,5,3,1,2,3,0,3,1,-1,-5,6,-1,0,0,-1,-1,-1,-1,5,-1
KR_6739054491,420,-5,-127,-44,-11,-1,3,2,-6,8,2,-3,3,0,2,1,3,-3,3,0,0,-10,-20,3,-6,3,0,0,-2,-1,1,-1,-1,6,-1
KR_6775213385,420,-3,-25,-2,-1,-1,2,1,0,2,2,-1,2,1,1,3,4,0,0,0,1,5,102,-1,-6,7,-3,0,1,1,1,1,1,4,-1
KR_6756196810,420,0,-17,2,-1,3,0,3,-1,2,1,0,1,1,-2,2,0,-1,1,0,0,-4,-23,1,-6,5,3,0,1,-1,1,1,1,2,-1
KR_6729904019,420,-2,2,-6,-3,-2,2,0,4,1,5,0,1,1,-2,3,1,-3,3,0,0,-7,-59,-5,-3,8,24,0,-2,-1,1,-1,1,4,-1
KR_6750887846,420,-4,-44,5,-4,-3,3,0,-2,4,2,-3,4,1,3,2,5,1,0,1,0,-1,-1,3,-7,4,2,0,-1,1,-1,-1,-1,6,-1
KR_6757900398,420,-5,-66,-42,-14,-4,4,0,-2,4,2,1,2,3,-7,8,1,-2,2,0,-1,-14,-16,5,-7,2,1,0,-1,-1,1,-1,-1,5,-1
KR_6773703223,420,0,-21,-20,4,1,2,3,3,1,4,2,1,3,-1,3,2,-1,2,1,0,3,4,2,-5,3,-1,0,0,1,1,1,-1,1,-1
KR_6730105968,420,-2,-77,-15,-6,-1,3,2,-1,2,1,0,6,6,-3,4,1,-1,3,2,1,-5,-11,-2,-5,7,-5,0,-2,-1,-1,-1,1,4,-1
KR_6710190313,420,3,17,21,1,-1,1,0,2,6,8,-2,3,1,3,3,6,-1,1,0,0,-8,16,1,-5,4,-5,0,-1,0,-1,1,-1,0,-1
KR_6770662505,420,0,7,-14,3,2,0,2,-4,8,4,6,0,6,3,4,7,-4,4,0,0,4,7,3,-10,7,5,0,-1,-1,1,-1,1,6,-1
KR_6775940618,420,0,-24,-4,4,-1,3,2,3,3,6,2,2,4,1,2,3,-1,3,2,0,-3,1,0,-6,6,2,0,0,1,-1,1,1,3,-1
KR_6768446263,420,0,-62,36,-7,1,0,1,-5,6,1,-2,2,0,-2,3,1,1,1,2,0,-8,-6,-7,-1,8,6,0,-2,1,-1,-1,1,3,-1
KR_6776167684,420,1,46,-15,-1,3,2,5,-2,4,2,-4,5,1,1,1,2,1,0,1,0,-10,-3,-3,-7,10,3,0,1,-1,1,1,-1,5,-1
KR_6726606943,420,-1,40,-40,-11,0,2,2,-7,10,3,0,1,1,0,2,2,-4,4,0,0,-17,-175,-1,-6,7,2,0,0,-1,1,-1,1,3,-1
KR_6773186886,440,0,-40,-2,-6,1,0,1,0,1,1,3,1,4,-9,9,0,-1,2,1,0,-9,-22,-2,-1,3,-4,0,-2,-1,1,-1,-1,3,-1
KR_6775405736,440,0,36,-14,-3,-5,7,2,0,5,5,0,0,0,1,2,3,1,3,4,0,2,4,7,-11,4,-2,0,-1,0,1,-1,1,0,-1
KR_6748375741,420,-1,-49,-20,-2,0,1,1,-3,5,2,0,1,1,1,3,4,0,0,0,0,-4,-17,-1,-6,7,-5,0,0,-1,-1,-1,-1,2,-1
KR_6773311223,420,-4,21,-31,-5,-3,3,0,-2,5,3,-1,2,1,-1,2,1,2,0,2,0,2,10,3,-9,6,-3,0,1,1,-1,-1,1,6,-1
KR_6766998128,420,-2,8,11,-10,1,0,1,-6,7,1,-1,3,2,-2,5,3,-2,2,0,-1,-13,-35,-4,-6,10,0,0,0,-1,1,1,-1,3,-1
KR_6595306187,420,-4,-61,41,-10,-2,3,1,-3,7,4,2,0,2,-8,9,1,1,0,1,0,-14,103,-3,-7,10,1,0,0,-1,-1,-1,1,2,-1
KR_6772304715,440,0,-38,5,-8,0,1,1,-1,1,0,-3,4,1,2,0,2,-6,8,2,-1,-10,-8,-3,-2,5,-6,0,-1,1,-1,-1,-1,5,-1
KR_6756314018,420,-7,-92,0,-17,-2,2,0,-7,7,0,-5,7,2,-3,4,1,0,1,1,0,-12,-6,-1,-4,5,1,0,-2,-1,-1,-1,-1,3,-1
KR_6770804491,420,0,-6,8,-4,-1,1,0,-3,6,3,0,5,5,-1,4,3,1,3,4,1,2,-10,-1,-3,4,-1,0,0,-1,-1,0,1,4,-1
KR_6736695515,420,-3,8,-28,1,1,1,2,1,5,6,2,0,2,-2,4,2,-1,1,0,0,4,52,10,-12,2,-21,0,-1,-1,-1,-1,1,6,-1
KR_6771204824,420,-4,11,-20,-11,-2,2,0,-2,4,2,-6,7,1,2,1,3,-3,5,2,0,-10,8,1,-5,4,0,0,-1,-1,1,-1,-1,3,-1
KR_6741825516,420,-4,-10,-18,-10,-3,3,0,0,6,6,-2,4,2,-3,5,2,-2,2,0,0,-13,-21,-4,-3,7,-1,0,0,-1,1,1,-1,4,-1
KR_6767535360,420,0,-28,29,0,2,2,4,1,2,3,-3,4,1,0,1,1,0,0,0,0,-3,-2,0,-3,3,-1,0,1,-1,1,1,1,6,-1
KR_6773974243,420,0,38,20,-1,1,2,3,-1,7,6,3,1,4,-1,1,0,-3,3,0,0,-9,2,-1,-3,4,-3,0,0,-1,-1,0,-1,5,-1
KR_6740787824,420,-2,17,-11,-6,-3,4,1,-2,6,4,-4,7,3,1,2,3,2,0,2,-1,-9,4,-2,-3,5,0,0,0,1,-1,-1,-1,4,-1
KR_6775667357,420,-1,-33,-11,-1,0,1,1,-2,2,0,-1,2,1,1,4,5,1,0,1,0,-2,69,-3,-5,8,-2,0,-1,-1,-1,1,1,4,-1
KR_6773986699,420,-3,-13,2,-5,2,0,2,-1,2,1,-2,3,1,-4,4,0,0,0,0,0,-5,-9,2,-5,3,2,0,1,-1,1,1,1,3,-1
KR_6768616269,420,1,7,26,-2,-1,3,2,-1,4,3,-4,5,1,4,2,6,0,2,2,0,0,-16,-8,-3,11,2,0,-1,1,-1,-1,-1,4,-1
KR_6745339110,420,0,-17,28,-4,-1,3,2,-1,3,2,-1,2,1,3,4,7,-4,4,0,-2,-5,1,-4,-5,9,-7,0,0,-1,-1,-1,1,6,-1
KR_6777313705,440,1,3,7,2,-3,5,2,0,1,1,2,0,2,-3,5,2,6,1,7,0,-5,-6,-1,-5,6,4,0,-1,1,-1,-1,1,6,-1
KR_6777458318,440,1,-28,18,0,-2,2,0,3,1,4,1,0,1,-2,4,2,0,0,0,0,0,-3,-1,-3,4,-3,0,-1,-1,0,-1,-1,2,-1
KR_6771626047,420,-2,-15,-11,-4,2,1,3,-4,7,3,-2,4,2,-1,2,1,1,0,1,0,0,12,-2,-5,7,-2,0,0,-1,-1,0,1,3,-1
KR_6763633034,420,-2,-77,-41,0,-2,2,0,-1,4,3,5,1,6,0,5,5,-2,2,0,-1,6,13,5,-8,3,-2,0,-1,-1,-1,-1,-1,6,-1
KR_6772755658,420,4,72,-25,9,6,0,6,-1,2,1,-2,4,2,5,0,5,1,1,2,0,4,5,0,-5,5,4,0,0,1,-1,-1,1,6,-1
KR_6746211325,420,-2,-1,-3,-2,-1,4,3,2,2,4,-1,2,1,-3,3,0,1,0,1,0,-1,-4,-1,-6,7,-3,0,0,-1,1,0,1,6,-1
KR_6748083217,420,2,13,-1,6,2,1,3,4,1,5,2,1,3,0,2,2,-2,2,0,0,12,36,-1,-5,6,4,0,1,1,1,1,1,4,-1
KR_6715926415,420,-5,-89,-24,-8,0,1,1,2,0,2,-2,4,2,-6,7,1,-2,2,0,1,-2,-11,-6,-2,8,1,0,-1,-1,-1,-1,1,3,-1
KR_6773076875,440,3,14,-24,6,1,1,2,0,2,2,1,1,2,1,2,3,3,0,3,-1,7,72,2,-5,3,1,0,1,1,-1,1,-1,1,-1
KR_6766125720,420,1,10,8,-6,0,1,1,-5,7,2,1,1,2,-3,3,0,1,1,2,0,-9,-11,-2,-7,9,-4,0,-1,-1,-1,-1,-1,3,-1
KR_6777398779,420,0,-4,-29,-6,-1,3,2,-1,3,2,-1,2,1,-2,3,1,-1,2,1,0,-10,2,1,-4,3,4,0,0,-1,-1,-1,-1,6,-1
KR_6774666416,420,-3,-62,-1,-7,-4,6,2,-4,6,2,0,1,1,2,0,2,-1,2,1,0,-2,46,-5,-6,11,4,0,-1,-1,0,-1,-1,2,-1
KR_6772589786,420,-5,-74,-4,-10,-1,3,2,-7,8,1,-2,5,3,-1,2,1,1,0,1,0,-20,-1,-1,-4,5,-5,0,-2,-1,-1,-1,-1,5,-1
KR_6776759818,420,0,23,-5,-6,0,0,0,5,0,5,-2,3,1,-9,13,4,0,0,0,0,-5,-14,-2,-5,7,6,0,-2,1,-1,-1,1,4,-1
KR_6758423624,440,1,1,8,9,-2,2,0,13,1,14,-2,4,2,0,1,1,0,1,1,0,10,-7,4,-4,0,-3,0,2,1,1,1,1,4,-1
KR_6758274467,420,-4,-56,-20,-12,-15,16,1,1,4,5,-3,6,3,4,1,5,1,0,1,-1,-6,29,-2,-4,6,1,0,-1,-1,1,-1,-1,1,-1
KR_6773528983,420,-2,-66,-8,-8,-1,1,0,1,3,4,-4,6,2,-4,6,2,0,0,0,-1,-9,-52,-1,-5,6,0,0,-2,-1,-1,-1,-1,4,-1
KR_6769221219,420,-2,-64,-20,1,0,1,1,3,0,3,2,2,4,-4,4,0,0,2,2,0,0,5,0,-4,4,-2,0,-1,1,1,1,1,2,-1
KR_6777045607,420,2,26,2,3,0,4,4,1,2,3,1,2,3,1,1,2,0,2,2,0,6,0,-1,-6,7,0,0,0,-1,-1,0,-1,2,-1
KR_6771413968,420,0,-33,-11,-2,1,2,3,4,1,5,-1,4,3,-5,8,3,-1,2,1,0,-2,79,0,-3,3,-4,0,1,1,1,1,1,3,-1
KR_6743343943,420,-8,-137,-25,-14,-4,5,1,0,2,2,-3,5,2,-4,6,2,-3,4,1,0,-14,9,-3,-8,11,-4,0,-3,-1,-1,-1,1,6,-1
KR_6773745682,440,2,-25,3,6,3,0,3,2,2,4,-1,3,2,1,4,5,1,1,2,0,8,-57,0,-2,2,10,0,-1,-1,0,-1,1,4,-1
KR_6775159601,420,-5,-57,-16,-21,-5,6,1,-8,9,1,-1,3,2,-4,4,0,-3,4,1,-1,-34,-302,-4,-4,8,0,0,-4,-1,-1,-1,-1,5,-1
KR_6769071801,420,-2,-20,-4,-9,1,1,2,-4,5,1,-3,3,0,-5,5,0,2,0,2,0,-11,-17,0,-6,6,-7,0,0,-1,0,0,-1,2,-1
KR_6757406831,420,-1,31,16,0,-1,2,1,1,1,2,0,1,1,0,1,1,0,0,0,0,-2,-5,0,-2,2,-3,0,1,0,1,1,1,0,-1
KR_6777667933,420,-5,-50,-14,-11,-3,3,0,-7,8,1,-2,6,4,2,3,5,-1,2,1,-1,-9,-118,0,-9,9,-2,0,-2,-1,-1,-1,-1,6,-1
KR_6776469720,420,-1,-44,34,-3,0,2,2,0,3,3,0,2,2,-3,3,0,0,0,0,0,-2,37,-1,-4,5,-40,0,1,1,1,1,1,4,-1
KR_6773942300,440,-2,-13,-13,-1,0,1,1,-2,6,4,-5,6,1,6,0,6,0,3,3,0,0,118,-2,-5,7,-6,0,0,-1,-1,0,-1,3,-1
KR_6776481180,420,-1,15,-4,-1,-1,2,1,4,1,5,-2,2,0,-1,1,0,-1,1,0,0,-1,-8,-3,-3,6,1,0,0,-1,-1,0,1,3,-1
KR_6776552109,420,-2,-15,23,-10,2,1,3,-4,7,3,-1,4,3,-3,6,3,-4,4,0,0,-19,-29,-2,-2,4,5,0,0,1,-1,-1,-1,5,-1
KR_6671223914,420,-2,23,-16,-4,-2,3,1,5,0,5,0,1,1,-4,5,1,-3,3,0,0,-2,6,1,-7,6,0,0,-1,1,1,-1,-1,5,-1
KR_6754791193,420,0,-26,35,3,3,3,6,4,2,6,-1,7,6,-1,1,0,-2,4,2,1,-4,-9,2,-5,3,2,0,1,-1,1,1,1,1,-1
KR_6772536165,420,2,70,-6,2,-1,1,0,0,4,4,-1,1,0,3,2,5,1,0,1,0,5,3,2,-7,5,1,0,0,1,-1,-1,-1,2,-1
KR_6670792978,420,-5,-57,-51,-17,-1,3,2,1,1,2,-13,15,2,-5,9,4,1,1,2,-1,-9,8,3,-7,4,-4,0,-2,-1,-1,-1,-1,3,-1
KR_6760712761,440,0,-1,11,-7,-1,2,1,-6,8,2,0,4,4,-1,4,3,1,3,4,0,-9,-15,-3,-2,5,1,0,0,1,-1,1,-1,5,-1
KR_6771300979,420,0,15,-8,3,0,3,3,3,4,7,-2,8,6,2,0,2,0,2,2,1,-5,12,-2,-2,4,-5,0,-2,1,-1,-1,1,2,-1
KR_6733949454,420,-3,-52,-24,-2,-1,2,1,-2,5,3,1,1,2,2,2,4,-2,6,4,-1,-7,-10,6,-10,4,0,0,0,-1,1,0,1,2,-1
KR_6674785872,420,0,6,9,3,2,1,3,1,0,1,-2,3,1,1,0,1,1,0,1,0,2,-7,-7,-1,8,-1,0,1,-1,1,1,-1,5,-1
KR_6768216200,420,-5,-43,-19,-19,-4,5,1,-3,3,0,-10,12,2,-2,2,0,0,1,1,-1,-21,3,-3,-4,7,-5,0,-3,-1,1,-1,-1,5,-1
KR_6770109191,440,-1,10,-4,-2,0,1,1,-1,3,2,0,1,1,-5,5,0,4,0,4,0,-5,8,1,-4,3,-2,0,1,1,1,1,1,2,-1
KR_6772982430,420,-3,-59,-11,-6,-1,2,1,-4,8,4,1,1,2,-3,4,1,1,0,1,1,1,-20,-1,-5,6,-3,0,0,1,-1,-1,1,5,-1
KR_6765024181,420,-8,-94,-48,-13,-8,8,0,-2,3,1,-3,4,1,-1,2,1,1,0,1,0,-23,9,1,-7,6,-6,0,-2,-1,-1,-1,-1,6,-1
KR_6774032053,420,-2,-18,-2,-6,1,3,4,-1,4,3,0,4,4,-2,4,2,-4,4,0,-1,-8,6,4,-10,6,0,0,-2,1,1,-1,1,5,-1
KR_6777874179,420,-5,-31,-8,-13,-5,6,1,-3,3,0,-1,3,2,-4,5,1,0,0,0,0,-8,-2,-2,-8,10,-6,0,-1,-1,-1,-1,-1,5,-1
KR_6745773760,420,-2,-30,-21,-3,-4,4,0,1,0,1,-2,2,0,2,2,4,0,3,3,0,5,-19,2,-9,7,4,0,-2,-1,1,-1,-1,3,-1
KR_6775264730,440,-3,-19,0,-8,-4,5,1,-4,6,2,0,0,0,-1,4,3,1,1,2,-2,-9,11,2,-8,6,-6,0,-1,1,1,-1,-1,1,-1
KR_6770572307,420,-3,-19,-8,-10,-2,2,0,3,1,4,-2,2,0,-9,9,0,0,1,1,-1,-13,6,-7,-2,9,4,0,-1,1,1,-1,-1,6,-1
KR_6767495630,420,-1,-63,16,-3,9,2,11,-8,9,1,-1,1,0,-4,5,1,1,1,2,0,-6,-10,-6,-2,8,0,0,1,-1,-1,-1,1,4,-1
KR_6767645897,420,-3,-45,-22,-6,0,1,1,0,2,2,-4,4,0,-3,3,0,1,0,1,0,-5,0,3,-7,4,-2,0,0,-1,1,0,1,3,-1
KR_6610283280,420,2,11,-19,1,2,0,2,-2,2,0,1,1,2,1,1,2,-1,1,0,0,-2,-130,-1,-6,7,0,0,-1,-1,1,-1,1,4,-1
KR_6772809644,420,-3,-25,-8,-13,0,1,1,-1,4,3,0,3,3,-9,11,2,-3,3,0,-1,-25,-2,-1,-4,5,-1,0,-2,-1,-1,-1,-1,4,-1
KR_6771295775,420,1,0,-6,-2,-4,5,1,-1,1,0,2,2,4,-2,4,2,3,1,4,0,7,6,0,-6,6,-1,0,0,-1,0,-1,-1,4,-1
KR_6765232942,420,-3,-1,-1,-10,1,4,5,-6,9,3,0,1,1,1,2,3,-6,6,0,0,-17,-5,-4,-3,7,-5,0,-1,-1,-1,-1,1,3,-1
KR_6745858441,420,1,-5,-35,6,-3,3,0,4,2,6,0,3,3,3,0,3,2,0,2,0,13,5,5,-7,2,4,0,1,1,1,1,1,2,-1
KR_6769662805,420,-6,7,-4,-11,1,0,1,-3,5,2,-2,5,3,-6,8,2,-1,1,0,0,-16,24,1,-6,5,-3,0,0,-1,-1,-1,-1,2,-1
KR_6755829948,420,2,39,24,2,3,1,4,-1,2,1,-4,7,3,3,2,5,1,1,2,0,0,29,-5,-3,8,3,0,-1,1,-1,1,-1,6,-1
KR_6766763598,420,-1,-33,-15,1,0,0,0,2,1,3,-2,3,1,-3,5,2,4,1,5,0,-2,2,5,-7,2,-7,0,-1,1,-1,-1,-1,3,-1
KR_6776733312,420,-4,-19,3,-5,-2,5,3,-3,4,1,-1,2,1,1,1,2,0,0,0,0,1,-7,2,-5,3,-1,0,0,-1,1,1,1,6,-1
KR_6775886769,440,1,32,19,0,0,0,0,0,4,4,1,3,4,-1,2,1,0,1,1,1,1,9,-2,-5,7,-5,0,0,0,-1,0,-1,0,-1
KR_6772378087,420,-3,-42,30,-8,-1,2,1,-2,4,2,-7,10,3,3,1,4,-1,1,0,0,-10,3,-3,-5,8,2,0,0,1,1,0,-1,6,-1
KR_6772351994,420,4,52,-9,13,3,1,4,5,0,5,2,2,4,-2,5,3,5,1,6,0,12,2,6,-9,3,3,0,0,-1,1,1,1,2,-1
KR_6687494607,420,-4,-3,-24,-6,-6,6,0,-3,3,0,5,2,7,-1,1,0,-1,1,0,0,-12,-4,-8,-3,11,2,0,0,-1,-1,0,1,2,-1
KR_6776211052,420,2,27,2,5,3,0,3,-2,3,1,2,1,3,2,0,2,0,2,2,0,5,3,5,-9,4,-4,0,-1,-1,1,-1,-1,3,-1
KR_6738493765,420,-5,-16,-7,-8,-4,4,0,0,0,0,2,2,4,-3,6,3,-3,5,2,0,-8,-35,0,-6,6,-5,0,-2,1,-1,-1,1,2,-1
KR_6732995733,420,-1,30,-22,-5,0,2,2,0,2,2,6,2,8,-6,7,1,-5,6,1,0,-3,-6,0,-4,4,5,0,0,-1,-1,-1,1,5,-1
KR_6737594745,420,-3,-54,-17,-7,-5,5,0,-4,5,1,3,3,6,0,4,4,-1,1,0,0,-4,-1,-1,-9,10,-5,0,-2,-1,-1,-1,1,4,-1
KR_6739977335,420,-1,-20,4,-4,-1,2,1,2,5,7,3,0,3,-8,9,1,0,1,1,0,-11,1,2,-4,2,-1,0,-2,1,-1,-1,-1,6,-1
KR_6768444253,420,-2,-21,-2,-12,-2,3,1,0,4,4,-5,7,2,-6,6,0,1,0,1,0,-20,-3,1,-7,6,0,0,-1,-1,1,-1,-1,5,-1
KR_6739022049,420,2,8,13,0,-1,1,0,2,1,3,0,1,1,-2,6,4,1,0,1,0,-1,25,-1,-7,8,0,0,0,1,-1,-1,-1,2,-1
KR_6773649785,440,-4,-82,4,-6,-6,7,1,-3,5,2,-1,2,1,2,1,3,2,0,2,0,1,-3,3,-5,2,0,0,-1,-1,-1,-1,-1,4,-1
KR_6681965427,420,-2,-69,0,-4,0,2,2,2,0,2,0,2,2,-5,5,0,-1,3,2,0,-3,0,2,-6,4,1,0,1,1,1,1,-1,5,-1
KR_6769745625,420,2,92,23,3,1,1,2,0,3,3,1,2,3,4,0,4,-3,4,1,0,11,22,-3,-5,8,-2,0,0,-1,-1,-1,-1,1,-1
KR_6733719057,420,-3,-37,-8,-9,-3,3,0,-2,6,4,2,4,6,-6,6,0,0,0,0,0,-12,64,-2,-6,8,-23,0,1,-1,1,1,1,1,-1
KR_6733088746,420,-3,4,-2,-6,6,0,6,-1,3,2,-1,5,4,-5,6,1,-5,6,1,0,-13,107,1,-3,2,-2,0,2,1,1,1,1,1,-1
KR_6773892287,420,-5,-50,-10,-11,2,0,2,-4,4,0,0,1,1,-8,9,1,-1,1,0,0,-22,-1,2,-8,6,2,0,-1,-1,1,1,-1,1,-1
KR_6774355007,420,2,33,29,1,3,2,5,-1,6,5,4,1,5,-5,5,0,0,0,0,1,-1,25,3,-6,3,-2,0,1,1,-1,1,1,4,-1
KR_6776577129,420,-8,-62,-44,-19,2,4,6,-2,4,2,-7,7,0,-10,10,0,-2,4,2,0,-18,0,-2,-3,5,0,0,-2,0,1,-1,1,0,-1
KR_6736581883,420,-2,-32,3,-2,-3,3,0,-3,5,2,1,5,6,3,1,4,0,0,0,0,1,3,1,-3,2,-2,0,1,1,1,1,1,1,-1
KR_6729833915,420,3,2,18,10,-1,2,1,6,0,6,1,5,6,3,0,3,1,0,1,0,10,-8,-2,-3,5,5,0,1,-1,1,1,-1,4,-1
KR_6775383071,420,0,-23,20,-1,1,2,3,-1,2,1,2,0,2,-2,5,3,-1,1,0,0,2,13,4,-6,2,4,0,1,1,-1,1,-1,4,-1
KR_6755079636,420,-5,-29,-9,-5,2,1,3,-2,2,0,-2,3,1,-2,2,0,-1,1,0,0,-10,-8,1,-5,4,2,0,0,1,1,1,1,2,-1
KR_6702423087,420,-2,-66,16,-2,-2,4,2,-1,3,2,5,0,5,-4,5,1,0,1,1,0,-5,-6,-3,-5,8,0,0,-1,1,-1,-1,1,3,-1
KR_6741981590,440,-2,-5,-21,0,4,0,4,1,0,1,0,1,1,0,2,2,-5,5,0,0,-4,-43,5,-9,4,22,0,0,-1,1,0,-1,4,-1
KR_6726719260,420,-3,-52,-16,-10,2,0,2,-4,7,3,-8,8,0,-3,5,2,3,0,3,0,-2,-10,-4,-5,9,0,0,0,-1,-1,-1,-1,3,-1
KR_6766483948,420,-1,-63,-24,-3,1,1,2,-4,6,2,-3,4,1,1,3,4,2,0,2,0,-3,-4,-1,-7,8,1,0,-2,-1,-1,-1,1,4,-1
KR_6770860788,420,1,-6,-7,-2,1,2,3,-1,2,1,3,0,3,-3,6,3,-2,2,0,-1,-10,-2,-5,-3,8,2,0,-1,-1,1,1,-1,1,-1
KR_6766379178,420,-3,-12,-2,-8,-5,5,0,0,2,2,-5,5,0,1,3,4,1,1,2,0,-11,-152,4,-10,6,-3,0,-1,-1,-1,-1,1,6,-1
KR_6768827807,420,-1,16,15,-8,-1,3,2,0,2,2,0,1,1,-2,3,1,-5,6,1,0,-8,37,-3,-4,7,-22,0,-1,-1,-1,-1,1,6,-1
KR_6767537207,420,1,8,-30,4,1,1,2,1,2,3,1,2,3,5,2,7,-4,5,1,0,6,-8,1,-6,5,0,0,1,1,-1,1,1,2,-1
KR_6772986282,420,0,-8,15,-7,-2,2,0,0,2,2,-2,3,1,-2,4,2,-1,3,2,-2,-13,3,-2,-6,8,4,0,-1,-1,-1,-1,1,2,-1
KR_6738892399,420,3,43,-1,7,0,1,1,2,2,4,1,3,4,6,0,6,-2,3,1,0,6,-46,0,-5,5,7,0,0,1,-1,-1,1,1,-1
KR_6772428617,420,-7,-105,0,-15,0,0,0,-7,7,0,-6,6,0,-3,4,1,1,3,4,0,-13,1,-7,-1,8,-7,0,-3,-1,-1,-1,-1,6,-1
KR_6769457090,420,-5,-74,-34,-11,-2,3,1,-4,4,0,3,1,4,-7,8,1,-1,1,0,0,-9,-7,-3,-4,7,-6,0,-3,-1,-1,-1,-1,5,-1
KR_6726973614,440,0,-40,-5,2,1,1,2,3,1,4,1,0,1,1,6,7,-4,4,0,0,7,-5,-3,-3,6,1,0,0,-1,-1,-1,-1,4,-1
KR_6777074427,420,-2,-25,8,-9,-2,2,0,-5,5,0,-2,2,0,1,2,3,-1,1,0,0,-14,-7,3,-9,6,-1,0,-1,-1,-1,-1,1,3,-1
KR_6749065277,420,-2,7,-2,-11,1,0,1,-1,6,5,-4,5,1,-6,8,2,-1,1,0,-1,-16,41,-1,-2,3,-28,0,-1,-1,-1,1,-1,3,-1
KR_6767372477,420,-4,-25,-28,-9,0,1,1,0,1,1,-6,6,0,0,1,1,-3,3,0,0,-9,57,3,-11,8,-34,0,0,-1,1,1,-1,1,-1
KR_6729954100,420,-4,-61,-20,-4,-3,3,0,-2,4,2,1,3,4,2,3,5,-2,3,1,0,-1,24,0,-6,6,3,0,-2,-1,1,-1,-1,4,-1
KR_6762004821,440,-5,-72,-47,-4,-2,2,0,-4,6,2,-1,3,2,3,0,3,0,1,1,0,-5,-11,3,-6,3,4,0,-1,-1,-1,-1,1,5,-1
KR_6768181093,420,0,15,-17,1,-1,3,2,3,2,5,2,5,7,-2,7,5,-1,1,0,0,5,3,1,-5,4,2,0,1,-1,-1,1,-1,6,-1
KR_6730277674,420,-5,-35,-20,-12,-2,3,1,0,1,1,-2,5,3,-9,9,0,1,1,2,0,1,-8,-9,-6,15,2,0,-2,-1,-1,-1,1,6,-1
KR_6774338070,420,1,54,5,10,6,0,6,-2,4,2,0,1,1,2,8,10,4,1,5,0,11,0,1,-3,2,1,0,0,1,-1,1,-1,3,-1
KR_6774418373,420,-2,-7,22,-5,-2,4,2,-3,4,1,1,2,3,-1,1,0,0,0,0,0,-7,34,1,-6,5,-6,0,0,1,-1,-1,-1,2,-1
KR_6775476858,420,-5,11,-1,-14,0,2,2,-12,12,0,0,1,1,0,3,3,-2,3,1,0,-24,-2,1,-7,6,5,0,0,-1,1,0,1,3,-1
KR_6772916583,420,-5,-28,-39,-18,-3,3,0,-6,7,1,-4,5,1,-6,8,2,1,0,1,-1,-12,3,1,-4,3,0,0,-1,-1,-1,-1,-1,2,-1
KR_6770867645,420,3,-29,0,5,-2,3,1,5,2,7,2,0,2,-2,5,3,2,0,2,0,19,55,2,-9,7,-4,0,-1,-1,1,-1,-1,5,-1
KR_6691316123,420,3,84,-16,6,3,1,4,4,1,5,0,3,3,0,4,4,-1,1,0,0,6,-114,0,-6,6,2,0,-1,-1,-1,-1,1,5,-1
KR_6774427037,420,-2,-23,-16,-1,-4,4,0,1,2,3,-1,3,2,3,2,5,0,2,2,0,1,5,-2,-6,8,2,0,2,-1,-1,1,1,4,-1
KR_6766571255,420,-2,-62,8,-10,-1,3,2,0,5,5,-4,5,1,-3,4,1,-2,4,2,0,-14,42,2,-7,5,-9,0,-1,-1,-1,-1,-1,5,-1
KR_6692110636,420,-3,-71,-42,0,-6,7,1,-1,4,3,2,0,2,7,1,8,-2,3,1,-1,6,-6,-5,-2,7,0,0,0,1,1,-1,-1,4,-1
KR_6752222081,440,2,-33,32,6,-1,2,1,5,1,6,2,4,6,1,1,2,-1,1,0,0,8,154,0,-4,4,-3,0,0,1,-1,0,1,3,-1
KR_6741888502,420,1,-45,-24,-3,-3,4,1,-2,3,1,-3,5,2,5,3,8,0,0,0,0,2,4,2,-7,5,-6,0,-2,-1,-1,-1,-1,5,-1
KR_6723413667,420,2,11,-19,4,1,3,4,1,4,5,7,1,8,-4,8,4,-1,1,0,1,4,1,-1,-5,6,-2,0,0,-1,1,1,1,5,-1
KR_6770507402,420,-1,-9,29,-1,-4,4,0,4,1,5,-3,4,1,1,1,2,1,1,2,-1,2,36,-1,-9,10,-7,0,0,1,-1,0,-1,3,-1
KR_6755397107,420,3,42,-8,-3,2,1,3,0,2,2,0,3,3,-6,7,1,1,0,1,0,-6,-3,-2,-6,8,1,0,-2,1,1,-1,-1,6,-1
KR_6770024083,420,-1,17,-18,-9,0,0,0,-2,3,1,-3,4,1,-3,5,2,-1,1,0,0,-8,4,-1,-6,7,0,0,0,1,-1,0,-1,6,-1
KR_6766921079,420,-7,-58,-11,-9,-2,5,3,-3,5,2,-1,3,2,0,7,7,-3,4,1,0,-10,42,-7,-3,10,-18,0,0,-1,1,0,-1,2,-1
KR_6764586806,440,-2,-45,-34,-4,-2,4,2,0,4,4,1,1,2,-1,3,2,-2,4,2,0,0,6,3,-6,3,-4,0,-1,1,-1,-1,1,3,-1
KR_6768895926,420,-1,-37,-40,-6,2,1,3,-1,2,1,1,1,2,-5,5,0,-3,4,1,-1,-11,-3,3,-6,3,-2,0,-1,-1,1,-1,-1,2,-1
KR_6737141244,420,1,-48,13,3,0,0,0,-1,2,1,-1,3,2,4,0,4,1,0,1,0,11,0,0,-5,5,1,0,1,1,-1,-1,1,6,-1
KR_6766301488,420,0,-44,-6,-2,-1,2,1,2,3,5,0,1,1,0,1,1,-3,3,0,0,-1,6,3,-8,5,-4,0,0,1,1,-1,-1,1,-1
KR_6717144271,420,-2,-18,-20,-8,-4,4,0,-6,6,0,1,0,1,2,1,3,-1,1,0,0,-8,25,-1,-5,6,0,0,0,-1,0,0,-1,3,-1
KR_6717365851,420,1,8,24,-2,0,1,1,-3,6,3,1,2,3,-4,4,0,4,0,4,0,-8,16,2,-9,7,-5,0,1,-1,1,1,1,5,-1
KR_6777255215,420,-1,-50,16,8,-4,4,0,0,3,3,5,1,6,6,1,7,1,0,1,0,15,2,-3,-6,9,3,0,2,1,1,1,1,4,-1
KR_6764385181,440,-1,-20,-1,-3,0,2,2,1,1,2,-1,1,0,-2,2,0,-1,1,0,0,-3,18,0,-8,8,-1,0,0,0,1,0,1,0,-1
KR_6751426237,420,-3,-27,-39,-8,-3,3,0,-3,7,4,-5,5,0,-1,3,2,4,0,4,0,-3,33,0,-5,5,-10,0,1,-1,-1,1,-1,2,-1
KR_6771356734,420,-1,12,-4,-1,-1,2,1,-2,4,2,-2,3,1,4,1,5,0,0,0,0,3,10,-4,-4,8,1,0,1,1,-1,1,1,3,-1
KR_6768862758,440,-3,-69,-7,-4,0,1,1,-1,2,1,0,1,1,-2,4,2,-1,2,1,0,-5,-10,-2,-3,5,7,0,0,-1,-1,-1,-1,6,-1
KR_6676244732,420,-1,-29,19,-12,-4,5,1,-3,7,4,1,3,4,-7,8,1,1,0,1,-2,-11,-15,4,-8,4,-2,0,-1,-1,-1,-1,-1,1,-1
KR_6766912941,420,-5,-75,-27,-7,-1,4,3,-4,4,0,0,3,3,-3,7,4,1,1,2,0,-7,0,-3,-6,9,-2,0,-1,-1,-1,-1,1,1,-1
KR_6726414885,420,-2,-9,9,-1,3,1,4,0,3,3,-4,4,0,1,5,6,-1,2,1,0,-8,-2,-2,-8,10,-3,0,-1,-1,1,1,-1,4,-1
KR_6772950854,420,2,33,0,-3,1,2,3,-4,4,0,-1,2,1,-1,5,4,2,1,3,0,-8,-8,-6,0,6,-2,0,-1,1,-1,-1,-1,5,-1
KR_6770952822,420,-3,-7,5,-4,-4,4,0,0,2,2,2,1,3,-1,3,2,-1,4,3,2,0,9,1,-7,6,-3,0,-1,1,-1,1,1,1,-1
KR_6770300085,440,-1,29,0,0,1,1,2,-5,7,2,3,3,6,1,4,5,0,2,2,0,-1,-417,1,-4,3,-4,0,0,0,0,0,-1,0,-1
KR_6777087022,420,0,-64,6,5,-1,2,1,-1,4,3,-2,3,1,7,0,7,2,0,2,0,12,31,-1,-6,7,-1,0,0,-1,-1,-1,1,5,-1
KR_6748030018,420,0,-26,3,0,1,2,3,0,2,2,1,1,2,-3,4,1,1,1,2,0,0,6,-1,-6,7,-10,0,1,1,1,1,-1,3,-1
KR_6767228634,420,-1,-77,4,-3,-2,3,1,-1,2,1,-2,4,2,4,0,4,-2,2,0,0,4,-20,0,-6,6,-2,0,-1,-1,-1,-1,1,5,-1
KR_6737505502,420,1,-12,31,-3,1,3,4,1,3,4,2,3,5,-1,2,1,-6,6,0,-2,-9,-18,-1,-4,5,5,0,-1,1,-1,-1,-1,4,-1
KR_6777877401,420,-4,-14,-15,-10,-3,3,0,3,1,4,0,2,2,-6,8,2,-4,5,1,0,-16,-16,-5,-5,10,3,0,-1,-1,1,-1,-1,4,-1
KR_6773550498,420,1,-51,10,5,2,3,5,6,1,7,-1,2,1,-2,3,1,0,1,1,0,6,-7,-4,-2,6,-1,0,1,-1,1,-1,-1,6,-1
KR_6777600458,440,0,-12,36,-5,-3,7,4,1,0,1,-2,2,0,0,2,2,-1,1,0,1,-10,-6,2,-11,9,-3,0,0,1,0,0,1,5,-1
KR_6769476977,420,-3,-8,16,-5,0,1,1,0,1,1,0,3,3,-5,6,1,0,0,0,0,-8,20,-1,-6,7,-1,0,0,-1,-1,0,1,2,-1
KR_6775521277,420,-3,-17,-23,-2,0,1,1,-1,2,1,-1,3,2,-1,3,2,1,0,1,0,-1,-28,-3,-2,5,-2,0,0,1,-1,0,-1,3,-1
KR_6771145945,420,-3,-46,-26,-5,3,3,6,-1,1,0,-5,5,0,-2,5,3,0,0,0,0,-5,-9,-2,-5,7,2,0,-1,-1,-1,-1,-1,2,-1
KR_6776664451,420,3,29,0,-2,2,1,3,1,4,5,0,1,1,-2,4,2,-3,3,0,1,-5,32,-9,-4,13,2,0,0,1,1,0,1,2,-1
KR_6749163862,420,3,-10,0,3,-3,3,0,2,0,2,3,1,4,1,4,5,0,1,1,-1,9,3,-2,-5,7,2,0,0,-1,-1,1,-1,2,-1
KR_6693497623,420,-3,-70,12,-10,0,3,3,-4,5,1,-1,1,0,-4,4,0,-1,1,0,0,-16,-8,-9,-2,11,0,0,-1,-1,-1,-1,-1,2,-1
KR_6739364024,420,-2,23,28,-3,1,2,3,-2,5,3,1,2,3,-2,6,4,-1,2,1,0,-14,-12,-1,-3,4,-1,0,0,1,1,1,1,3,-1
KR_6686100077,420,3,-19,-15,13,5,2,7,1,2,3,3,1,4,3,1,4,1,0,1,3,35,0,3,-9,6,9,0,-1,-1,-1,-1,1,3,-1
KR_6772698365,420,-2,-36,28,-8,-1,2,1,-3,5,2,-2,4,2,-4,7,3,2,2,4,0,-11,18,0,-6,6,-3,0,-1,1,-1,-1,-1,3,-1
KR_6775941256,420,2,29,12,4,5,0,5,5,1,6,1,1,2,-4,8,4,-3,5,2,0,-3,8,2,-8,6,-1,0,1,-1,1,1,1,5,-1
KR_6777038223,420,0,-39,7,-7,-2,5,3,2,4,6,-4,5,1,0,2,2,-3,4,1,-1,-11,-5,-3,-6,9,-3,0,-2,-1,-1,-1,-1,6,-1
KR_6776464062,420,-4,-64,-31,-8,0,0,0,-4,5,1,-3,3,0,1,3,4,-2,3,1,0,-6,2,-4,-2,6,-2,0,-2,-1,-1,-1,-1,6,-1
KR_6746827245,420,-4,-22,-31,-10,-5,5,0,4,1,5,-2,3,1,0,2,2,-7,7,0,0,-8,-78,2,-9,7,-3,0,-2,-1,-1,-1,1,5,-1
KR_6759798341,420,1,27,-6,0,-5,7,2,0,2,2,5,6,11,-1,3,2,1,0,1,0,-8,240,-5,-6,11,-3,0,-1,-1,1,-1,-1,1,-1
KR_6685683466,420,-3,-22,-24,1,-1,1,0,-6,6,0,6,2,8,0,0,0,2,0,2,0,0,2,0,-6,6,-2,0,-1,-1,-1,-1,1,2,-1
KR_6771592144,420,-3,-47,-25,-15,-6,6,0,-4,5,1,-1,3,2,-2,10,8,-2,2,0,1,-9,-6,-3,-4,7,0,0,-3,-1,-1,-1,1,3,-1
KR_6759296441,420,1,-3,-16,4,-1,2,1,4,3,7,1,3,4,1,2,3,-1,2,1,0,4,4,-4,-4,8,7,0,-1,-1,-1,-1,1,5,-1
KR_6756749726,420,0,-11,0,-11,1,1,2,0,1,1,2,3,5,-10,10,0,-4,5,1,-2,-16,12,2,-5,3,-4,0,0,-1,1,-1,-1,5,-1
KR_6776169015,420,0,38,4,-5,2,0,2,0,2,2,-4,6,2,-3,3,0,0,3,3,0,-7,16,-3,-2,5,-1,0,-2,1,-1,-1,1,4,-1
KR_6770789417,420,-1,-32,-4,-9,-1,5,4,-7,9,2,-1,4,3,-1,2,1,1,1,2,1,-16,-19,-2,-8,10,1,0,-2,-1,1,-1,1,2,-1
KR_6732825309,420,-2,-13,-8,-3,1,0,1,-1,3,2,-2,4,2,-2,3,1,1,0,1,2,-3,-4,-4,-4,8,-9,0,-1,-1,-1,-1,1,4,-1
KR_6762006353,420,-2,10,-23,-1,1,2,3,1,1,2,-3,3,0,-1,3,2,1,0,1,0,-6,-10,1,-5,4,-1,0,1,-1,-1,1,1,4,-1
KR_6772781314,420,-3,-38,-1,-7,-3,3,0,1,4,5,1,2,3,-4,5,1,-2,2,0,0,-10,-134,-3,-4,7,3,0,-1,-1,-1,-1,-1,2,-1
KR_6740196899,420,-4,-111,-1,-8,-3,5,2,0,1,1,-2,3,1,-2,4,2,-1,1,0,0,-7,-4,-3,-2,5,-5,0,-1,-1,-1,-1,-1,4,-1
KR_6749351411,420,4,68,-2,4,2,0,2,0,2,2,-1,2,1,3,1,4,0,0,0,0,9,5,-7,-3,10,3,0,0,-1,1,0,1,2,-1
KR_6756446308,420,-1,-14,-23,-5,-7,8,1,-1,3,2,2,0,2,1,2,3,0,1,1,0,2,3,-5,-4,9,-3,0,1,-1,1,1,-1,2,-1
KR_6772519933,420,-4,-9,-2,-11,-3,3,0,-3,3,0,-3,4,1,-3,3,0,1,0,1,0,-7,33,-3,-3,6,1,0,0,-1,-1,0,-1,2,-1
KR_6763237806,440,-1,-57,1,-2,0,1,1,-1,2,1,-1,6,5,1,2,3,-1,2,1,0,-3,-46,-6,-4,10,18,0,-1,1,1,-1,1,1,-1
KR_6773948192,420,-4,-6,-9,-8,-1,2,1,-2,3,1,-4,5,1,0,5,5,-1,1,0,0,-11,-1,-5,-4,9,-3,0,0,-1,-1,0,1,5,-1
KR_6745590501,420,1,8,17,3,2,3,5,2,2,4,-2,5,3,0,1,1,1,0,1,0,-2,-153,-5,-4,9,8,0,1,1,1,1,1,1,-1
KR_6774256054,440,5,18,24,7,0,1,1,4,0,4,4,0,4,-2,2,0,1,1,2,0,6,286,1,-8,7,-8,0,2,1,1,1,1,2,-1
KR_6764889634,420,-1,8,8,-9,-1,1,0,-3,4,1,0,3,3,-4,4,0,-1,1,0,0,-14,-12,-1,-5,6,1,0,-1,-1,1,-1,1,1,-1
KR_6682223727,420,-2,-11,27,-8,1,4,5,-1,4,3,-1,5,4,-1,1,0,-6,9,3,-1,-14,27,0,-5,5,-1,0,1,1,-1,-1,-1,3,-1
KR_6760247528,420,-10,-104,-16,-23,0,2,2,0,0,0,-9,10,1,-13,14,1,-1,2,1,0,-19,-17,3,-8,5,0,-1,-6,-1,-1,-1,-1,3,-1
KR_6655226387,420,-2,-53,-11,-1,-2,4,2,0,4,4,-2,3,1,3,0,3,0,0,0,0,-9,17,1,-4,3,-2,0,0,-1,1,1,-1,1,-1
KR_6709279795,420,-4,-108,-30,-4,-2,2,0,-1,4,3,2,1,3,-4,5,1,1,1,2,-2,-5,-11,-2,-3,5,-2,0,-1,1,-1,-1,-1,2,-1
KR_6749326370,420,-5,3,-6,6,1,1,2,1,0,1,5,2,7,-1,2,1,0,0,0,0,-3,7,1,-6,5,1,0,-1,-1,1,-1,1,3,-1
KR_6755371306,420,-8,-73,-35,-13,2,0,2,-7,7,0,-6,6,0,-1,5,4,-1,1,0,0,-15,-2,1,-3,2,-1,0,-1,-1,1,-1,1,2,-1
KR_6772452081,420,1,-12,32,-3,0,0,0,-1,4,3,4,2,6,-5,6,1,-1,1,0,-1,-7,1,-2,-5,7,5,0,0,1,1,0,-1,4,-1
KR_6766944534,420,-3,-26,7,-1,-1,3,2,-7,9,2,2,3,5,3,1,4,2,1,3,1,-5,-1,0,-4,4,0,0,0,1,-1,-1,1,6,-1
KR_6723708157,420,-1,17,-13,2,2,0,2,-2,6,4,1,5,6,1,4,5,0,2,2,1,8,1,1,-8,7,6,0,3,-1,1,1,1,3,-1
KR_6775554948,420,2,-56,12,-1,5,1,6,-8,9,1,1,1,2,2,1,3,-1,1,0,-1,-7,-12,4,-9,5,4,0,0,-1,1,1,-1,2,-1
KR_6729723072,420,-2,-20,-1,-3,2,0,2,-1,2,1,-1,5,4,-1,1,0,-2,2,0,0,-5,-108,7,-11,4,-9,0,-2,-1,-1,-1,1,1,-1
KR_6763699927,420,2,-45,-11,0,0,1,1,5,3,8,1,1,2,-2,3,1,-4,4,0,0,-5,-1,2,-6,4,-3,0,0,-1,1,-1,1,2,-1
KR_6777225131,420,-2,-7,-3,4,0,1,1,-1,1,0,1,6,7,2,2,4,2,0,2,1,-5,-4,0,-4,4,2,0,-1,-1,-1,-1,1,6,-1
KR_6776213655,420,-4,-49,-17,-5,1,1,2,4,1,5,0,0,0,-8,8,0,-2,3,1,-1,-4,-8,0,-12,12,-4,0,-1,-1,1,-1,-1,2,-1
KR_6748074264,420,-1,-43,-20,-7,-4,4,0,-6,7,1,1,3,4,-1,7,6,3,0,3,0,-12,-6,-5,-4,9,-3,0,-1,-1,-1,-1,-1,1,-1
KR_6773457467,420,3,11,36,4,0,1,1,2,1,3,1,2,3,0,6,6,1,1,2,0,4,-4,3,-7,4,7,0,0,1,-1,0,-1,1,-1
KR_6764523991,420,-6,-85,-7,-12,-4,5,1,-3,5,2,-1,2,1,-5,8,3,1,2,3,-1,-8,-50,2,-10,8,19,0,-2,1,-1,-1,-1,2,-1
KR_6766158732,440,1,-58,48,6,-1,2,1,8,1,9,4,2,6,-5,7,2,0,1,1,0,6,-1,0,-7,7,-1,0,0,0,-1,-1,-1,0,-1
KR_6777520548,440,3,-72,-32,0,3,1,4,-1,2,1,-2,2,0,-1,1,0,1,0,1,-1,-3,0,4,-10,6,4,0,-1,-1,-1,-1,-1,6,-1
KR_6748864076,420,-2,5,-11,-6,-3,4,1,0,3,3,-4,4,0,1,2,3,0,1,1,0,-6,40,-3,-4,7,-2,0,0,1,1,1,-1,2,-1
KR_6772398126,420,4,27,69,0,3,0,3,0,4,4,-5,6,1,3,1,4,-1,1,0,0,-6,-35,7,-12,5,0,0,0,-1,1,1,1,1,-1
KR_6764582983,420,-4,-31,-7,-11,-6,6,0,-1,4,3,-4,6,2,1,2,3,-1,5,4,-1,-8,2,2,-7,5,-2,0,-1,1,-1,-1,-1,1,-1
KR_6760571480,420,0,-6,14,1,-3,6,3,3,1,4,-7,10,3,6,2,8,2,0,2,2,8,21,2,-7,5,-8,0,0,0,0,-1,1,0,-1
KR_6723018457,440,-1,20,-8,-2,6,2,8,6,0,6,2,2,4,-8,10,2,-8,9,1,-1,-6,5,-2,-2,4,4,0,-2,0,-1,-1,-1,0,-1
KR_6771512546,420,-1,-61,3,-2,-2,3,1,3,0,3,0,2,2,-3,8,5,0,0,0,0,9,9,-1,-5,6,-5,0,0,1,1,0,-1,6,-1
KR_6737059249,420,-3,-13,-23,-6,2,2,4,-4,6,2,-2,2,0,-1,1,0,-1,1,0,0,-11,1,-4,-4,8,-3,0,0,1,-1,0,-1,2,-1
KR_6775954958,420,-6,-48,-32,-10,-3,3,0,-6,9,3,1,4,5,-1,1,0,-1,1,0,0,-12,-7,-1,-6,7,-3,0,-2,-1,-1,-1,-1,3,-1
KR_6770698320,420,-3,9,4,-6,0,1,1,-2,3,1,-5,5,0,0,1,1,1,0,1,0,-14,-2,-4,-5,9,-5,0,-3,-1,-1,-1,1,4,-1
KR_6713141785,420,0,-40,40,-10,-2,3,1,-2,7,5,-2,6,4,-4,4,0,0,0,0,-2,-9,1,-3,-3,6,3,0,0,-1,-1,-1,-1,5,-1
KR_6777679917,420,0,-9,20,3,0,2,2,2,1,3,-1,4,3,1,2,3,1,1,2,0,8,4,3,-5,2,1,0,1,1,-1,1,-1,6,-1
KR_6759277597,420,-1,-3,-32,-5,2,4,6,0,1,1,-1,3,2,-4,4,0,-2,2,0,0,-6,-6,-4,-5,9,-2,0,1,-1,1,1,1,6,-1
KR_6777572517,420,-2,-28,-20,-5,3,0,3,-2,4,2,1,0,1,-7,9,2,0,0,0,0,-11,-8,3,-8,5,0,0,-1,-1,1,-1,-1,6,-1
KR_6755817273,420,1,-19,0,-1,-2,3,1,0,2,2,0,2,2,0,1,1,1,3,4,-1,2,1,1,-4,3,-4,0,0,-1,1,0,-1,5,-1
KR_6737423563,420,-3,-62,-31,-7,-5,8,3,-1,2,1,-2,2,0,3,0,3,-2,2,0,1,-6,-13,-2,-3,5,3,0,-2,-1,-1,-1,1,5,-1
KR_6776472518,440,-4,-54,12,-8,1,3,4,-1,2,1,3,2,5,-9,9,0,-2,3,1,0,-6,24,-3,-3,6,-3,0,-1,-1,1,-1,1,5,-1
KR_6769214553,420,-4,20,-37,-4,-1,3,2,-1,3,2,-2,5,3,-4,5,1,4,1,5,0,-9,-9,-3,-5,8,3,0,0,-1,-1,-1,-1,2,-1
KR_6775322796,420,-2,0,-6,-2,-1,1,0,-1,1,0,-2,2,0,4,0,4,-2,2,0,0,-4,-5,-1,-5,6,2,0,0,1,-1,0,1,4,-1
KR_6758356650,420,-2,11,9,-3,2,0,2,-2,3,1,3,2,5,-6,6,0,0,0,0,0,-5,2,-4,-5,9,-2,0,0,-1,-1,0,-1,3,-1
KR_6777205266,420,0,63,-4,-3,5,0,5,-2,4,2,-3,7,4,-3,3,0,0,0,0,0,-7,-42,-4,-3,7,22,0,0,-1,-1,1,-1,4,-1
KR_6772393284,420,-2,-39,2,-5,-8,8,0,2,3,5,2,1,3,0,4,4,-1,4,3,-1,2,4,2,-8,6,4,0,-1,-1,-1,-1,-1,6,-1
KR_6772154600,440,1,-54,0,8,0,1,1,3,2,5,4,0,4,1,3,4,0,0,0,0,14,19,7,-10,3,-5,0,0,1,-1,1,-1,3,-1
KR_6725811722,420,2,-35,-9,-1,1,3,4,1,2,3,1,2,3,-4,5,1,0,3,3,0,3,-54,-1,-5,6,-1,0,0,-1,-1,-1,-1,3,-1
KR_6776289398,420,1,18,-17,3,-2,5,3,7,3,10,-1,1,0,-1,5,4,0,1,1,1,9,-6,0,-7,7,9,0,0,-1,1,0,1,5,-1
KR_6746194366,420,0,-29,0,-3,-5,7,2,4,0,4,-3,3,0,3,4,7,-2,3,1,0,6,-20,2,-7,5,-1,0,-1,-1,-1,-1,-1,6,-1
KR_6744103974,420,-1,3,-2,-6,2,2,4,-8,9,1,-1,2,1,1,4,5,0,0,0,0,-9,174,-10,-2,12,6,0,-1,-1,1,1,1,4,-1
KR_6763416047,420,-2,-14,21,-2,1,2,3,-2,3,1,2,2,4,-7,10,3,4,2,6,-1,-10,31,-2,-4,6,-1,0,-1,1,-1,-1,-1,6,-1
KR_6692035898,420,-2,-29,-29,0,-2,4,2,3,0,3,-1,5,4,0,1,1,0,1,1,0,3,5,2,-7,5,0,0,-2,-1,1,-1,1,2,-1
KR_6776092619,420,1,-11,12,-1,1,1,2,3,1,4,-4,4,0,1,2,3,-2,3,1,0,1,-105,1,-9,8,-5,0,0,1,1,0,-1,3,-1
KR_6758597033,420,-1,-42,-2,1,-1,3,2,4,2,6,0,2,2,-3,3,0,1,0,1,0,-1,18,1,-6,5,-5,0,-1,1,1,-1,1,6,-1
KR_6774847372,420,-2,11,-1,-5,-2,3,1,0,1,1,-1,2,1,-2,4,2,0,0,0,0,-9,-3,-3,-5,8,6,0,2,1,1,1,1,2,-1
KR_6770767796,420,0,-15,-23,-2,0,2,2,-9,9,0,3,1,4,2,2,4,2,1,3,0,-1,5,-2,-2,4,4,0,0,-1,-1,-1,1,1,-1
KR_6762180319,420,-3,-25,-3,-14,-7,7,0,0,1,1,-1,3,2,-4,5,1,-2,2,0,0,-15,8,3,-10,7,0,0,-1,-1,1,-1,-1,5,-1
KR_6772957159,420,-3,-55,20,-10,1,2,3,-1,3,2,-2,3,1,-6,7,1,-2,4,2,0,-8,0,-8,-3,11,1,0,0,-1,1,0,-1,6,-1
KR_6736953626,420,-2,-47,4,-10,-3,5,2,-3,4,1,-3,3,0,-2,4,2,1,1,2,0,-8,-13,-7,-4,11,4,0,-1,1,1,-1,-1,4,-1
KR_6766376157,420,1,-38,27,3,0,0,0,1,6,7,4,3,7,-1,2,1,-1,2,1,-1,9,-12,2,-8,6,1,0,0,1,1,1,-1,1,-1
KR_6733335421,420,-3,-46,-14,-10,0,1,1,-5,7,2,-2,5,3,-3,5,2,0,0,0,0,-11,-2,-5,-4,9,-6,0,0,-1,-1,-1,-1,2,-1
KR_6776905639,420,-3,6,13,-2,-2,2,0,-1,3,2,1,0,1,0,2,2,0,1,1,0,-3,-36,2,-9,7,8,0,1,1,-1,-1,-1,6,-1
KR_6776415009,420,-5,-24,-29,-5,-4,4,0,-3,4,1,0,2,2,2,0,2,0,0,0,0,-8,2,1,-6,5,3,0,0,-1,-1,-1,1,4,-1
KR_6770774814,420,-1,16,-16,-3,1,0,1,-6,6,0,3,1,4,0,2,2,-1,2,1,0,-1,-7,-4,-3,7,2,0,0,-1,-1,0,-1,2,-1
KR_6776744786,420,-1,-3,25,-5,1,1,2,-2,4,2,-3,4,1,-1,2,1,0,1,1,0,-8,20,-4,-4,8,1,0,-1,-1,1,-1,-1,4,-1
KR_6729316344,420,-5,5,2,-14,-4,6,2,-8,8,0,-1,2,1,0,3,3,-1,1,0,0,-20,18,-3,-3,6,-5,0,-1,1,1,-1,1,4,-1
KR_6772496555,420,-4,-29,28,-6,2,1,3,-3,5,2,2,2,4,-5,5,0,-2,5,3,0,-13,-1,0,-5,5,2,0,-1,1,1,-1,1,6,-1
KR_6754530757,420,-4,-52,-4,-3,-3,3,0,0,2,2,1,2,3,1,5,6,-2,2,0,0,-3,8,-1,-7,8,-1,0,-3,-1,-1,-1,-1,3,-1
KR_6729226885,420,-2,-43,-4,-11,-1,1,0,-7,7,0,-2,3,1,-1,2,1,0,0,0,0,-18,17,-4,-5,9,-2,0,-1,-1,1,-1,-1,6,-1
KR_6777190950,420,-6,-42,-19,-8,-2,2,0,-1,3,2,-3,6,3,-1,4,3,-1,1,0,0,-17,258,0,-4,4,1,0,-1,-1,-1,-1,1,2,-1
KR_6767731701,420,-1,-10,-9,7,1,1,2,3,3,6,1,1,2,3,1,4,-1,2,1,0,5,70,1,-9,8,7,0,2,1,1,1,1,4,-1
KR_6770563735,420,-6,-80,6,-17,-4,4,0,-3,6,3,-5,7,2,-9,10,1,4,0,4,-4,-16,10,-2,-6,8,-1,0,-1,-1,0,-1,-1,2,-1
KR_6762470323,420,0,-39,-25,5,0,0,0,2,1,3,-2,4,2,4,2,6,1,0,1,0,12,102,3,-6,3,-12,0,-2,-1,-1,-1,1,5,-1
KR_6759132663,420,0,-24,9,1,-1,3,2,2,1,3,2,0,2,-1,3,2,-1,1,0,0,-4,31,-2,-5,7,-3,0,0,-1,1,1,-1,1,-1
KR_6777112790,420,-1,38,-40,-4,-1,1,0,-2,2,0,1,0,1,-2,3,1,0,1,1,0,-10,14,2,-8,6,-1,0,0,-1,-1,-1,1,4,-1
KR_6775555306,420,0,-2,-16,0,4,2,6,-3,4,1,-1,3,2,0,3,3,0,0,0,0,-2,-7,-2,-7,9,7,0,0,-1,-1,0,1,6,-1
KR_6716112888,420,-3,-26,8,-6,-1,4,3,-5,5,0,0,2,2,1,3,4,-1,1,0,0,-7,-6,-3,-6,9,2,0,0,1,1,0,-1,5,-1
KR_6754290808,420,-2,-20,12,-3,-6,7,1,-1,3,2,0,2,2,3,0,3,1,1,2,0,3,-8,-5,-7,12,4,0,-2,-1,-1,-1,-1,1,-1
KR_6745112870,420,-1,-53,14,-3,-1,2,1,-3,4,1,1,4,5,-1,3,2,1,2,3,1,4,-9,1,-7,6,5,0,-2,1,-1,-1,1,4,-1
KR_6774645445,420,4,-27,9,6,-1,3,2,2,1,3,4,0,4,2,0,2,-1,2,1,1,5,6,2,-6,4,3,0,-1,1,1,-1,1,3,-1
KR_6772477164,420,0,59,7,1,-3,3,0,1,3,4,0,2,2,3,0,3,0,0,0,-1,10,9,-1,-4,5,4,0,0,0,1,0,-1,0,-1
KR_6745819778,420,-3,7,8,-3,1,1,2,-2,3,1,-3,4,1,1,5,6,0,0,0,0,-12,-29,-4,-4,8,0,0,-1,1,-1,-1,1,4,-1
KR_6773009501,420,-1,3,-18,5,2,1,3,0,1,1,1,3,4,-2,6,4,4,0,4,0,6,-9,5,-12,7,2,0,-1,-1,1,-1,1,3,-1
KR_6753490055,420,-3,7,-24,-1,0,4,4,-1,3,2,3,0,3,-4,4,0,1,0,1,0,-5,-5,3,-11,8,-3,0,-1,1,-1,-1,1,2,-1
KR_6718649663,420,-3,-50,8,-20,-3,3,0,-9,13,4,-5,10,5,-4,8,4,1,1,2,-2,-25,-27,-2,-3,5,-1,0,-3,-1,-1,-1,-1,1,-1
KR_6727933038,420,-3,8,-31,-13,-2,3,1,-6,6,0,0,1,1,-5,5,0,0,1,1,0,-11,0,1,-6,5,2,0,-1,-1,-1,-1,-1,3,-1
KR_6703802619,420,-1,18,0,-3,-3,3,0,0,4,4,-2,2,0,1,5,6,1,0,1,0,-4,1,-2,-2,4,3,0,1,-1,-1,-1,-1,2,-1
KR_6772934119,440,-6,-25,0,-7,3,0,3,-5,5,0,-1,2,1,-3,5,2,-1,1,0,0,-5,-4,-1,-4,5,-3,0,0,-1,-1,0,-1,1,-1
KR_6765476445,420,0,-30,15,5,-1,1,0,9,1,10,-1,2,1,-3,6,3,1,1,2,0,5,-3,-1,-4,5,1,0,1,1,1,1,1,3,-1
KR_6773110667,420,2,8,-15,2,0,3,3,1,2,3,0,2,2,1,2,3,0,1,1,0,4,-17,0,-7,7,6,0,0,1,-1,1,-1,4,-1
KR_6777258551,420,0,-31,12,-3,-1,3,2,-1,5,4,0,3,3,-1,2,1,0,0,0,0,2,-2,-4,-5,9,-2,0,0,1,1,0,-1,6,-1
KR_6771382806,420,0,-24,-24,0,1,0,1,-4,5,1,-1,3,2,4,1,5,0,0,0,0,-3,12,0,-8,8,-9,0,-1,1,-1,-1,1,2,-1
KR_6776116536,420,2,44,2,-2,3,1,4,-2,3,1,3,1,4,-4,4,0,-2,2,0,0,-7,-4,-1,-4,5,2,0,1,-1,1,1,-1,2,-1
KR_6774598940,420,-2,21,-2,1,1,1,2,4,2,6,-4,4,0,-3,4,1,3,0,3,0,-2,-40,-2,-6,8,1,0,-1,1,1,-1,-1,5,-1
KR_6741724303,440,-1,-41,-4,-5,-3,3,0,1,2,3,-1,1,0,-2,3,1,0,1,1,0,-8,-3,-1,-3,4,0,0,0,-1,1,0,1,5,-1
KR_6776362810,420,-4,-42,-36,-4,0,0,0,-4,4,0,-3,4,1,1,1,2,2,0,2,2,0,2,-1,-7,8,4,0,0,-1,-1,0,1,5,-1
KR_6700624523,420,-7,-41,-24,-15,-2,4,2,-5,7,2,-2,2,0,-3,3,0,-3,3,0,0,-27,-36,0,-6,6,-1,0,-1,-1,-1,-1,1,5,-1
KR_6774275249,420,2,-31,-25,6,-1,3,2,4,0,4,1,4,5,2,0,2,0,0,0,0,17,-18,1,-5,4,4,0,0,-1,1,0,1,2,-1
KR_6776443329,420,-6,-57,-5,-14,-2,2,0,-2,2,0,-6,6,0,-4,4,0,0,0,0,0,-11,-21,1,-6,5,-7,0,-3,-1,-1,-1,-1,4,-1
KR_6769612693,420,0,6,10,-4,1,1,2,-1,5,4,-2,3,1,-2,2,0,0,0,0,1,2,-4,-3,-6,9,5,0,-1,1,-1,-1,1,1,-1
KR_6712576866,420,-5,-105,2,-9,-5,5,0,0,3,3,-2,2,0,2,2,4,-4,5,1,0,-2,-1,0,-10,10,-11,0,-3,-1,-1,-1,1,3,-1
KR_6671111019,420,-4,-54,-29,-6,1,4,5,-2,5,3,-5,6,1,-1,2,1,1,0,1,0,-5,6,-4,-4,8,-3,0,0,-1,-1,-1,-1,4,-1
KR_6776796615,420,-4,-43,-7,-14,-3,3,0,-2,2,0,1,0,1,-7,8,1,-3,4,1,0,-19,-16,-5,-5,10,0,0,-1,-1,-1,-1,-1,4,-1
KR_6746986904,420,2,-17,-14,-5,3,4,7,-4,5,1,2,2,4,-6,8,2,0,1,1,0,-1,3,-1,-7,8,-3,0,-2,-1,-1,-1,-1,5,-1
KR_6770437207,420,-3,-77,4,-7,-3,3,0,-4,4,0,2,0,2,-3,6,3,1,0,1,-1,-9,-4,-1,-9,10,-2,0,-1,-1,-1,-1,-1,3,-1
KR_6770262190,420,2,67,12,5,2,0,2,-4,6,2,2,0,2,5,0,5,0,0,0,0,7,5,-1,-5,6,-2,0,1,-1,1,1,1,5,-1
KR_6765799315,420,0,-50,15,1,0,2,2,-1,6,5,-1,4,3,1,3,4,2,1,3,0,3,0,4,-7,3,0,0,2,1,1,1,1,4,-1
KR_6749390758,420,-4,-56,-19,1,-6,7,1,2,2,4,3,1,4,2,5,7,0,0,0,-1,6,-47,2,-8,6,20,0,-1,-1,1,-1,-1,3,-1
KR_6755787814,420,-1,-28,-24,3,6,0,6,-4,6,2,-1,7,6,2,1,3,0,1,1,0,4,-4,-1,-6,7,3,0,0,-1,-1,1,1,6,-1
KR_6740879054,420,-5,-17,-11,-11,-1,1,0,-1,2,1,-7,8,1,-3,5,2,1,0,1,0,-4,-22,-4,-1,5,-4,0,-2,-1,-1,-1,-1,6,-1
KR_6747894830,420,-2,-54,-2,-4,-1,2,1,-1,3,2,-1,5,4,-1,3,2,0,0,0,0,1,2,-3,-5,8,-5,0,0,-1,-1,0,-1,2,-1
KR_6769691808,420,-2,-64,-31,-2,-2,2,0,-1,4,3,3,1,4,-1,1,0,-1,1,0,-1,-1,2,5,-10,5,-9,0,-2,1,-1,-1,-1,1,-1
KR_6758051784,420,2,-18,9,4,5,0,5,2,5,7,3,0,3,-4,4,0,-2,2,0,0,4,0,0,-6,6,-1,0,0,1,1,0,-1,3,-1
KR_6707268743,420,-3,41,0,-10,-4,5,1,-6,6,0,3,0,3,-3,4,1,0,0,0,0,-18,-43,-2,-6,8,1,0,0,-1,1,0,-1,6,-1
KR_6776648697,420,-7,15,-36,-11,-4,5,1,-5,6,1,-1,2,1,-1,1,0,0,1,1,0,-8,3,2,-3,1,-2,0,0,-1,0,0,1,6,-1
KR_6734870915,420,-5,-26,2,-10,-6,6,0,1,1,2,-2,2,0,-2,2,0,-1,2,1,0,-7,19,2,-8,6,-7,0,0,-1,-1,-1,-1,3,-1
KR_6770716035,420,-1,-76,-25,-1,-2,4,2,-3,4,1,2,2,4,3,1,4,-1,3,2,1,1,31,3,-7,4,1,0,-1,-1,1,-1,1,6,-1
KR_6772502519,420,3,-3,-2,5,1,0,1,-3,5,2,3,4,7,1,1,2,3,1,4,0,6,-6,-2,-4,6,8,0,0,-1,-1,-1,-1,6,-1
KR_6765437049,420,-4,-22,-7,-11,3,2,5,-6,6,0,1,5,6,-9,10,1,0,3,3,0,-7,15,-3,-6,9,4,0,-1,0,-1,-1,1,0,-1
KR_6777662498,440,1,-5,14,-2,-3,3,0,0,2,2,2,1,3,-1,3,2,0,0,0,0,-4,4,0,-4,4,-1,0,0,0,1,-1,-1,0,-1
KR_6776065495,440,-4,-53,4,-11,-1,2,1,-1,3,2,-2,2,0,-7,10,3,0,1,1,-1,-19,-6,-1,-7,8,-3,0,0,-1,1,1,-1,4,-1
KR_6688574856,420,-6,-77,12,-13,0,0,0,-4,5,1,-5,6,1,-5,6,1,1,1,2,0,-12,-3,2,-6,4,-3,0,0,-1,-1,-1,-1,2,-1
KR_6716648184,420,2,35,12,3,-1,1,0,-1,6,5,2,1,3,2,0,2,1,0,1,0,6,-16,1,-7,6,0,0,-1,1,1,-1,1,1,-1
KR_6776366269,420,4,71,60,1,3,1,4,5,0,5,-4,4,0,-2,3,1,-1,1,0,-1,0,31,0,-6,6,0,0,0,1,1,1,-1,1,-1
KR_6776003584,440,2,-6,12,-3,-2,2,0,2,2,4,-3,7,4,1,1,2,-1,1,0,0,2,20,4,-6,2,-2,0,0,-1,1,0,-1,1,-1
KR_6759474679,420,-1,-37,-5,1,-1,2,1,-2,2,0,-4,5,1,7,2,9,1,0,1,1,5,-178,1,-8,7,-2,0,0,1,1,1,1,3,-1
KR_6762142630,420,-4,20,10,-3,1,1,2,-1,1,0,-4,4,0,0,2,2,1,0,1,0,-4,-1,-3,-3,6,1,0,1,-1,-1,1,1,2,-1
KR_6763786602,420,-5,-12,-12,-7,-4,7,3,2,0,2,1,1,2,-6,6,0,0,1,1,0,-1,12,2,-7,5,-5,0,-2,-1,-1,-1,-1,1,-1
KR_6773095590,420,0,-17,-4,4,1,1,2,1,2,3,-1,2,1,1,1,2,2,0,2,0,9,84,7,-9,2,-5,0,0,-1,-1,-1,-1,4,-1
KR_6765919375,440,-1,11,-36,-2,0,3,3,3,0,3,-4,4,0,4,2,6,-5,6,1,0,6,-1,-6,-5,11,3,0,0,1,-1,-1,1,3,-1
KR_6699820045,420,-3,5,-10,1,1,3,4,0,1,1,-2,3,1,6,0,6,-4,7,3,0,3,-25,5,-11,6,-3,0,0,-1,-1,0,1,6,-1
KR_6769883819,420,-2,-16,-29,5,-2,2,0,0,4,4,1,2,3,5,0,5,1,0,1,0,9,-3,-2,-5,7,-1,0,-1,1,-1,-1,-1,5,-1
KR_6774137864,420,1,-24,2,6,2,2,4,3,1,4,0,1,1,-1,3,2,2,0,2,0,8,41,-3,-5,8,3,0,0,-1,1,1,-1,2,-1
KR_6774002605,420,-4,-23,-20,-12,2,0,2,-4,7,3,-5,6,1,-4,5,1,-1,2,1,0,-16,8,2,-6,4,-10,0,0,-1,1,1,-1,4,-1
KR_6749902304,420,-6,-37,-26,-20,-6,6,0,-3,3,0,-9,10,1,-3,6,3,1,3,4,0,-10,8,-1,-2,3,-3,0,-2,-1,-1,-1,-1,4,-1
KR_6776320387,420,-2,-37,-2,-4,0,1,1,-2,4,2,1,0,1,0,1,1,-3,3,0,0,-4,1,-1,-7,8,-9,0,-2,-1,-1,-1,-1,3,-1
KR_6744643568,420,3,-41,18,5,-1,2,1,3,4,7,2,0,2,4,1,5,-3,5,2,0,11,123,-2,-5,7,-4,0,-1,1,-1,-1,-1,5,-1
KR_6767066566,420,1,27,4,3,2,2,4,0,4,4,4,1,5,-2,2,0,-1,2,1,-1,0,-383,3,-5,2,-3,0,1,0,1,1,-1,0,-1
KR_6776309096,420,-1,-13,-8,2,-1,2,1,-1,3,2,1,5,6,3,2,5,0,1,1,0,-5,-14,-3,-4,7,1,0,-1,-1,1,-1,1,2,-1
KR_6702382073,420,2,51,15,3,0,1,1,-4,7,3,3,1,4,3,0,3,1,0,1,0,2,-33,-1,-7,8,0,0,1,1,-1,1,-1,6,-1
KR_6777581809,420,-2,-126,-3,-5,1,3,4,-2,3,1,0,1,1,-4,5,1,0,1,1,0,-11,34,1,-4,3,-4,0,-2,-1,1,1,-1,1,-1
KR_6726237658,420,3,-41,13,3,2,1,3,6,1,7,0,1,1,-4,4,0,-1,2,1,1,1,38,1,-7,6,-3,0,1,1,1,1,1,2,-1
KR_6769288324,420,-3,-8,8,-8,-1,5,4,-2,4,2,-1,2,1,-3,4,1,-1,2,1,-3,-17,-8,-5,-2,7,1,0,-1,-1,1,-1,-1,2,-1
KR_6768688468,420,-2,-37,-32,4,1,0,1,4,1,5,3,2,5,-4,8,4,0,1,1,0,-2,-6,-2,-6,8,-6,0,0,1,-1,1,-1,5,-1
KR_6761729958,420,-2,-8,4,-8,4,0,4,0,3,3,-6,7,1,-2,3,1,-4,4,0,0,-17,-103,-3,-7,10,-24,0,0,-1,1,-1,-1,6,-1
KR_6746748637,420,-4,20,13,-9,-6,6,0,2,1,3,-3,3,0,0,2,2,-2,2,0,0,-11,24,2,-8,6,2,0,-1,1,1,-1,-1,2,-1
KR_6767711337,420,1,-95,8,1,-3,4,1,2,2,4,0,0,0,2,0,2,0,0,0,0,6,-13,3,-8,5,-5,0,-1,1,-1,-1,1,6,-1
KR_6748635480,420,-3,-86,-10,-16,-6,6,0,-4,6,2,-2,3,1,-4,7,3,0,1,1,0,-16,-21,-5,-5,10,-2,0,-4,1,-1,-1,-1,3,-1
KR_6757427316,420,1,41,7,8,-1,3,2,3,1,4,-3,7,4,4,2,6,5,1,6,0,3,147,2,-10,8,-2,0,3,1,1,1,-1,5,-1
KR_6777052298,420,-3,-47,9,-13,-1,2,1,-3,4,1,-3,3,0,-1,2,1,-5,5,0,-1,-13,4,-5,-3,8,-4,0,0,1,-1,0,-1,2,-1
KR_6772734393,420,-7,-36,-54,-9,-1,2,1,5,1,6,-2,3,1,-4,7,3,-7,9,2,0,-8,-1,3,-10,7,0,0,0,1,-1,-1,1,2,-1
KR_6772607080,420,-4,6,-6,-2,-3,3,0,3,3,6,-1,2,1,1,0,1,-2,2,0,0,-3,-3,5,-6,1,1,0,0,1,1,1,1,3,-1
KR_6773648096,420,0,-47,8,-1,-4,4,0,1,0,1,0,1,1,2,0,2,0,0,0,0,0,-3,1,-7,6,1,0,0,1,1,0,-1,3,-1
KR_6732195435,420,-2,22,-26,-2,-3,3,0,-1,4,3,-2,3,1,5,3,8,-1,1,0,1,-3,-7,-2,-10,12,1,0,1,-1,-1,1,1,2,-1
KR_6745503075,420,-2,-33,1,-1,0,1,1,1,4,5,-1,1,0,0,3,3,-1,1,0,1,-5,-10,-3,-9,12,1,0,-1,-1,0,-1,1,1,-1
KR_6731954856,420,-3,-4,33,-11,-5,10,5,-2,4,2,-1,2,1,-2,3,1,-1,2,1,0,-18,3,0,-6,6,1,0,0,-1,-1,0,1,3,-1
KR_6769673980,420,-4,-76,-43,-11,-3,5,2,-2,2,0,-3,4,1,-2,2,0,-1,1,0,-1,-10,23,-6,-2,8,0,0,-1,-1,-1,-1,1,4,-1
KR_6766702629,440,-5,-2,-4,-5,2,0,2,1,3,4,-5,7,2,0,2,2,-3,3,0,0,-9,-104,0,-3,3,-1,0,0,-1,-1,0,-1,1,-1
KR_6771536221,420,-4,-1,7,-6,0,1,1,-3,3,0,-1,1,0,-1,2,1,-1,1,0,0,-11,38,0,-4,4,-4,0,0,1,-1,1,1,3,-1
KR_6775331260,420,-1,-26,13,-5,-1,1,0,0,4,4,-7,8,1,-4,6,2,7,2,9,-2,-14,-5,-2,-6,8,-1,0,-2,1,-1,-1,-1,1,-1
KR_6769746438,420,0,-31,5,-4,0,1,1,-4,7,3,0,2,2,0,2,2,0,1,1,0,-4,-3,-4,-5,9,0,0,-1,0,-1,-1,1,0,-1
KR_6773239796,420,-1,26,-11,-5,-1,2,1,-2,3,1,1,2,3,-1,1,0,-2,2,0,-1,-2,-41,-7,-3,10,-1,0,1,-1,1,1,-1,1,-1
KR_6712435215,420,-2,52,-1,-4,1,1,2,1,5,6,1,3,4,-8,9,1,1,0,1,1,-13,65,0,-5,5,2,0,0,1,1,-1,1,1,-1
KR_6773026957,420,-2,-15,-22,-7,-1,1,0,-1,1,0,1,4,5,-8,10,2,2,1,3,0,1,-15,-3,-5,8,-1,0,0,-1,-1,0,-1,5,-1
KR_6763480182,420,3,37,8,7,3,2,5,-1,2,1,3,1,4,1,0,1,1,0,1,0,6,7,-3,-4,7,4,0,1,1,-1,1,1,4,-1
KR_6771523224,420,1,-8,-25,4,1,0,1,2,0,2,-1,2,1,2,1,3,0,0,0,0,5,-18,2,-5,3,0,0,0,1,0,0,1,4,-1
KR_6767457650,420,-1,-65,-15,-1,0,2,2,1,1,2,-1,1,0,-2,3,1,1,1,2,-1,2,4,6,-10,4,-6,0,-1,-1,1,-1,-1,4,-1
KR_6765971687,420,1,-32,-8,8,10,0,10,4,1,5,-2,5,3,-2,3,1,-2,2,0,0,1,197,3,-9,6,2,0,-1,-1,1,-1,1,4,-1
KR_6743265484,420,-4,-4,11,-10,-4,4,0,-4,4,0,4,1,5,2,1,3,-8,9,1,0,-11,-18,1,-5,4,1,0,-1,-1,1,-1,-1,1,-1
KR_6776008208,420,-5,-77,-4,-8,-3,3,0,1,1,2,0,2,2,-5,5,0,-1,1,0,0,-3,8,3,-7,4,-5,0,-3,-1,-1,-1,-1,6,-1
KR_6775554914,420,1,-19,9,4,-1,1,0,1,2,3,-2,2,0,4,1,5,2,0,2,0,7,-155,4,-9,5,0,0,-1,1,-1,-1,1,5,-1
KR_6777100291,420,-3,-19,-25,-6,-3,3,0,1,4,5,1,2,3,-4,5,1,-1,2,1,-1,-2,30,-3,-7,10,0,0,0,1,-1,-1,-1,3,-1
KR_6726731805,440,-3,-45,-43,-4,-1,4,3,-2,2,0,-1,2,1,-1,4,3,1,0,1,0,1,28,2,-7,5,-7,0,-1,1,-1,-1,-1,6,-1
KR_6758852997,440,-2,-81,8,-11,-8,9,1,0,2,2,0,1,1,-3,4,1,0,0,0,0,-11,38,-3,-4,7,-13,0,0,-1,-1,0,-1,4,-1
KR_6775706065,420,-2,-69,-14,-1,-5,5,0,2,1,3,-1,3,2,2,2,4,1,0,1,0,5,-16,1,-5,4,-1,0,0,-1,1,-1,-1,5,-1
KR_6773779318,420,-3,19,-17,-2,0,4,4,-1,4,3,2,3,5,-1,4,3,-2,2,0,-4,-10,-122,-2,-7,9,5,0,-1,-1,-1,-1,-1,5,-1
KR_6773373166,420,0,5,-62,-4,2,0,2,2,1,3,0,2,2,-5,9,4,-3,3,0,0,-2,-16,-4,-6,10,2,0,-1,-1,-1,-1,-1,3,-1
KR_6772630189,420,0,-20,35,-1,0,1,1,-3,7,4,-2,2,0,3,2,5,1,0,1,0,-4,-4,0,-8,8,-7,0,1,1,1,1,1,1,-1
KR_6748228087,420,-7,-95,-17,-16,0,2,2,-9,10,1,-2,4,2,-2,3,1,-3,3,0,0,-17,-27,-3,-2,5,2,0,0,-1,-1,-1,-1,1,-1
KR_6777560828,420,0,2,13,-6,3,0,3,-6,7,1,-3,4,1,1,1,2,-1,2,1,0,-8,-1,0,-3,3,-2,0,-2,-1,-1,-1,1,6,-1
KR_6776704484,420,-2,-16,25,-6,0,1,1,-1,4,3,0,2,2,-6,7,1,1,0,1,0,-15,-47,-1,-8,9,38,0,0,0,1,0,-1,0,-1
KR_6705071450,420,2,-2,12,2,0,3,3,2,2,4,2,4,6,-1,2,1,-1,1,0,0,3,5,-2,-5,7,-2,0,-1,1,-1,-1,-1,4,-1
KR_6751882286,420,0,-28,13,2,-1,2,1,1,1,2,1,1,2,-2,2,0,3,0,3,0,10,-8,-5,-5,10,0,0,-1,1,1,-1,-1,3,-1
KR_6772517746,420,0,20,13,-3,1,2,3,2,2,4,0,2,2,-4,4,0,-2,4,2,0,0,116,1,-7,6,2,0,0,-1,-1,0,1,3,-1
KR_6725349514,420,-2,-43,8,0,2,1,3,0,6,6,0,3,3,0,2,2,-2,4,2,0,-6,5,3,-10,7,-3,0,1,-1,1,1,-1,1,-1
KR_6763476861,420,-2,-42,2,-10,-3,3,0,-5,6,1,-3,6,3,0,3,3,1,0,1,1,-2,3,-3,-8,11,-7,0,-2,1,-1,-1,-1,4,-1
KR_6759082037,420,-4,1,-8,-5,-2,3,1,-2,5,3,-1,1,0,1,3,4,-1,2,1,0,-8,31,2,-7,5,-1,0,-1,1,-1,-1,-1,1,-1
KR_6774861939,420,-5,-117,-16,-7,-2,2,0,-6,7,1,1,3,4,0,2,2,0,0,0,-1,0,4,-3,-3,6,3,0,-3,1,1,-1,-1,3,-1
KR_6721907247,420,-6,-152,-24,-16,-7,7,0,-2,3,1,-2,2,0,1,2,3,-6,7,1,0,-1,-288,-5,-4,9,-3,0,-2,-1,-1,-1,-1,5,-1
KR_6745134590,420,1,28,4,2,-1,2,1,1,5,6,-1,4,3,3,2,5,0,1,1,1,-4,18,2,-6,4,-6,0,2,1,-1,1,-1,1,-1
KR_6759214911,420,-1,-25,-8,1,5,0,5,-3,5,2,0,1,1,1,2,3,-2,2,0,0,-8,5,0,-7,7,-3,0,1,-1,1,1,-1,2,-1
KR_6775968455,420,-1,-48,5,0,2,1,3,-1,3,2,0,2,2,-1,2,1,0,0,0,0,-1,-5,1,-6,5,0,0,-1,1,-1,-1,1,4,-1
KR_6740423501,440,-5,-65,-24,-5,-4,4,0,1,1,2,2,0,2,-4,6,2,0,1,1,0,-3,6,4,-9,5,-2,0,0,1,1,-1,-1,6,-1
KR_6769861574,420,1,49,8,1,-1,2,1,0,1,1,-2,3,1,2,0,2,2,0,2,0,-5,-162,3,-9,6,5,0,0,1,-1,1,1,2,-1
KR_6774012435,420,-1,37,24,-2,0,0,0,1,0,1,-1,3,2,-1,3,2,-1,1,0,0,-2,-29,-2,-5,7,7,0,-2,-1,-1,-1,-1,5,-1
KR_6776020570,420,5,127,10,3,2,0,2,-2,4,2,1,1,2,2,0,2,0,1,1,1,2,31,-3,-8,11,-5,0,0,1,-1,-1,1,1,-1
KR_6773719732,420,-1,-98,-12,-7,-2,2,0,0,3,3,-1,2,1,-1,1,0,-3,3,0,0,-4,-8,0,-8,8,-4,0,-1,-1,-1,-1,-1,1,-1
KR_6771985460,420,-1,-4,-7,-1,-1,2,1,1,1,2,-1,1,0,0,2,2,0,0,0,0,2,-31,-1,-4,5,1,0,2,1,1,1,1,6,-1
KR_6773785594,420,-3,-37,-22,1,0,3,3,1,4,5,2,0,2,-4,4,0,2,0,2,2,6,0,-1,-3,4,-1,0,-2,-1,-1,-1,1,5,-1
KR_6775622247,420,-3,-12,-14,1,-1,2,1,0,2,2,-4,4,0,6,0,6,0,1,1,0,11,-125,-1,-6,7,-4,0,0,-1,-1,0,-1,6,-1
KR_6767167600,420,-6,-46,-37,-10,-1,4,3,1,3,4,0,1,1,-8,9,1,-2,3,1,0,-11,-65,1,-4,3,23,0,-3,-1,-1,-1,-1,3,-1
KR_6742432608,420,-1,-9,3,-5,0,2,2,1,2,3,-1,2,1,-3,4,1,-2,2,0,-1,-6,6,1,-8,7,-2,0,0,-1,-1,0,1,1,-1
KR_6772175564,420,-2,-29,7,-6,-4,4,0,0,1,1,1,4,5,-4,6,2,1,2,3,0,-8,13,-3,-3,6,2,0,0,1,-1,0,1,4,-1
KR_6774412947,420,3,63,5,7,-1,3,2,2,1,3,2,3,5,3,3,6,1,1,2,0,8,-6,-3,-4,7,8,0,2,1,1,1,-1,2,-1
KR_6760889332,420,-2,-26,-9,-1,0,0,0,1,2,3,1,0,1,0,2,2,-3,3,0,0,-2,8,1,-5,4,2,0,1,1,1,1,-1,4,-1
KR_6772225610,420,0,-5,-8,4,4,0,4,2,2,4,-2,4,2,-4,9,5,4,1,5,0,-11,-4,-4,-3,7,-1,0,1,-1,1,-1,1,1,-1
KR_6771685585,420,0,-27,-4,-4,4,0,4,-4,5,1,2,2,4,-6,8,2,0,0,0,0,-3,-1,-2,-6,8,-3,0,-1,1,-1,-1,1,6,-1
KR_6766590703,420,-2,-54,-18,-9,-2,3,1,-3,5,2,-1,3,2,-3,3,0,0,0,0,0,-5,65,3,-9,6,-4,0,-1,1,1,-1,-1,2,-1
KR_6744576403,420,3,25,-3,6,0,0,0,1,2,3,-2,3,1,6,1,7,1,1,2,0,9,3,0,-6,6,0,0,2,1,-1,1,1,2,-1
KR_6774016496,420,-2,-95,-7,-3,-2,2,0,2,5,7,1,0,1,-4,5,1,0,1,1,-1,-4,7,3,-7,4,-8,0,0,-1,1,0,-1,6,-1
KR_6768389391,420,-7,-75,-30,-23,-9,10,1,-1,4,3,-3,4,1,-8,9,1,-2,3,1,-1,-16,5,0,-5,5,0,0,-2,1,-1,-1,-1,1,-1
KR_6741135563,420,0,40,-22,-2,-1,1,0,2,4,6,0,1,1,-2,2,0,-1,1,0,0,-2,-19,1,-10,9,1,0,-1,-1,1,-1,-1,6,-1
KR_6755609845,420,-4,-19,-26,-4,-1,2,1,-1,4,3,-1,2,1,1,1,2,-2,2,0,0,-8,-6,-1,-7,8,-1,0,0,-1,1,0,1,1,-1
KR_6726673200,420,-6,-37,-64,-11,-2,3,1,0,2,2,-10,10,0,1,4,5,0,3,3,-2,-14,-2,-1,-5,6,-10,0,0,1,1,-1,-1,3,-1
KR_6770121316,420,-2,-41,-4,-8,0,4,4,0,3,3,-3,3,0,-4,4,0,-1,1,0,0,-7,12,2,-7,5,-6,0,-2,-1,1,-1,1,5,-1
KR_6739158834,420,-3,-50,1,-3,-2,3,1,1,2,3,1,3,4,-1,4,3,-2,3,1,-1,1,387,-3,-5,8,8,0,-1,0,1,-1,-1,0,-1
KR_6753356466,420,-2,0,-28,0,-2,3,1,2,4,6,2,1,3,-1,2,1,-1,1,0,-1,-3,-15,-2,-10,12,1,0,0,1,0,0,-1,6,-1
KR_6717293654,420,-4,-12,-31,-8,-3,3,0,-1,2,1,-2,4,2,-2,3,1,0,0,0,0,-5,-3,-2,-6,8,2,0,0,-1,1,0,-1,4,-1
KR_6772679179,420,-3,-18,-19,-9,0,2,2,-8,9,1,-3,3,0,4,2,6,-2,2,0,0,-1,-11,-1,-5,6,-3,0,-1,0,-1,-1,-1,0,-1
KR_6638086066,420,-3,-52,-13,2,0,2,2,0,4,4,1,1,2,2,1,3,-1,1,0,0,4,-11,4,-6,2,-1,0,1,-1,1,1,-1,4,-1
KR_6722875901,440,-3,-57,-12,-9,-2,3,1,-2,3,1,1,1,2,-4,5,1,-2,3,1,0,-7,-8,0,-5,5,0,0,0,-1,1,1,-1,1,-1
KR_6738205571,420,2,-20,4,4,-2,3,1,3,2,5,2,2,4,2,1,3,-1,2,1,0,19,0,-3,-6,9,0,0,-1,1,-1,-1,-1,1,-1
KR_6762543744,420,0,-25,19,1,1,1,2,-3,4,1,-3,4,1,4,1,5,2,1,3,0,1,144,2,-7,5,-3,0,-1,-1,-1,-1,1,2,-1
KR_6776390300,420,2,58,-4,1,3,3,6,-4,5,1,1,2,3,1,3,4,0,2,2,0,-5,-1,-5,-2,7,-2,0,2,-1,1,1,-1,2,-1
KR_6765900526,420,3,25,-22,3,3,1,4,0,1,1,0,1,1,-1,1,0,1,0,1,0,4,1,2,-7,5,-1,0,0,1,-1,-1,1,4,-1
KR_6706513396,440,-6,-49,-35,-11,-3,3,0,-1,2,1,-1,4,3,-5,8,3,-1,2,1,-2,-18,-9,3,-6,3,-1,0,-3,-1,-1,-1,1,6,-1
KR_6767575370,420,-1,-4,16,-2,-3,4,1,-2,4,2,5,0,5,0,1,1,-2,2,0,0,-1,2,2,-4,2,-6,0,0,1,-1,-1,1,6,-1
KR_6776993229,420,-1,4,-24,4,-2,3,1,1,1,2,3,1,4,1,0,1,1,0,1,0,2,16,0,-6,6,1,0,0,1,-1,-1,1,3,-1
KR_6685399258,420,-2,35,-17,-9,-1,3,2,2,1,3,-1,1,0,-9,9,0,0,0,0,0,-21,44,3,-6,3,-16,0,-2,-1,-1,1,-1,2,-1
KR_6775889904,420,2,-26,10,3,0,2,2,1,4,5,-1,3,2,2,0,2,1,0,1,0,13,-28,4,-8,4,2,0,1,1,1,1,-1,5,-1
KR_6771962217,440,-3,-14,-24,-12,1,2,3,-3,5,2,-3,5,2,-1,2,1,-6,6,0,0,-18,-5,-4,-2,6,4,0,-2,-1,-1,-1,1,2,-1
KR_6776416229,420,-1,-15,-5,-5,0,0,0,-1,5,4,-3,3,0,-1,6,5,0,1,1,0,-10,-2,-5,-4,9,1,0,-1,1,-1,-1,-1,2,-1
KR_6776384505,420,-2,-18,-23,-6,1,1,2,-4,4,0,-2,3,1,-2,4,2,1,0,1,0,-13,15,-1,-4,5,2,0,-1,0,1,-1,-1,0,-1
KR_6775879315,420,1,37,4,0,0,2,2,-1,3,2,4,2,6,-3,3,0,0,2,2,0,4,-2,3,-5,2,0,0,0,1,1,1,-1,2,-1
KR_6776329034,420,1,24,8,-3,0,1,1,-3,4,1,2,0,2,-2,5,3,0,1,1,0,2,-2,-2,-6,8,-3,0,1,-1,-1,1,-1,2,-1
KR_6766518148,420,-2,7,-12,2,0,2,2,0,3,3,0,3,3,3,0,3,-1,1,0,1,4,6,4,-6,2,1,0,1,-1,1,1,1,6,-1
KR_6775459461,420,1,26,-37,4,3,1,4,-4,5,1,-2,4,2,7,1,8,0,0,0,0,7,0,3,-7,4,1,0,1,-1,1,1,-1,5,-1
KR_6740354403,420,1,64,0,0,2,2,4,-2,3,1,-1,1,0,2,1,3,-1,2,1,0,-10,-6,-1,-3,4,1,0,1,1,-1,1,-1,3,-1
KR_6775812205,420,0,-62,-3,-2,-2,2,0,1,4,5,-2,3,1,0,3,3,1,0,1,0,2,-24,-2,-3,5,1,0,0,-1,-1,0,-1,6,-1
KR_6776037617,420,3,31,-1,10,4,0,4,3,1,4,-1,5,4,5,2,7,-1,1,0,0,10,4,2,-6,4,4,0,0,1,1,-1,1,6,-1
KR_6776402422,420,-2,-13,-20,-4,-2,2,0,-1,2,1,-3,3,0,2,0,2,0,0,0,0,-1,-3,-2,-6,8,1,0,0,-1,-1,0,1,1,-1
KR_6762334627,420,-1,56,-15,-2,1,3,4,0,1,1,1,1,2,-5,8,3,1,1,2,0,0,-2,-2,-4,6,0,0,1,-1,1,1,1,5,-1
KR_6774414471,420,-1,69,-10,-3,1,2,3,-5,6,1,-3,6,3,4,0,4,0,1,1,0,-17,11,6,-9,3,-2,0,2,-1,1,1,1,4,-1
KR_6774977015,440,2,5,36,1,-1,1,0,2,2,4,1,2,3,-1,3,2,0,1,1,0,3,-1,0,-5,5,1,0,-1,-1,1,-1,-1,5,-1
KR_6777308394,420,0,-31,-8,-4,3,3,6,3,2,5,-4,7,3,-6,6,0,0,1,1,-1,-7,-1,1,-6,5,2,0,0,-1,1,-1,-1,1,-1
KR_6776858639,420,0,11,4,0,-6,7,1,4,3,7,1,2,3,1,0,1,0,0,0,-1,5,-23,-4,-5,9,3,0,-1,1,-1,-1,-1,4,-1
KR_6740449297,420,3,35,-38,8,2,1,3,0,3,3,2,0,2,4,2,6,0,1,1,0,10,24,1,-5,4,-1,0,1,-1,1,1,-1,1,-1
KR_6765583568,420,3,82,9,2,0,5,5,-1,2,1,4,0,4,-1,2,1,0,0,0,-1,-9,-33,-1,-3,4,2,0,4,1,1,1,-1,5,-1
KR_6743633142,420,-6,-105,-48,-14,1,2,3,-5,5,0,-2,3,1,-7,7,0,-1,1,0,-1,-13,1,1,-5,4,-5,0,-1,-1,-1,-1,-1,4,-1
KR_6758502823,420,-5,-43,-22,-13,-3,4,1,-4,5,1,-3,4,1,2,3,5,-5,5,0,0,-18,-3,-1,-7,8,-11,0,-4,-1,-1,-1,1,2,-1
KR_6771627176,420,2,-38,-7,3,-1,2,1,2,2,4,0,4,4,3,0,3,-1,1,0,0,3,-85,0,-4,4,-2,0,-1,0,-1,-1,1,0,-1
KR_6774153103,420,-3,-33,-22,-9,-4,5,1,-4,8,4,-1,4,3,-3,5,2,3,0,3,0,-11,26,6,-9,3,-5,0,0,-1,1,0,-1,1,-1
KR_6740270863,420,1,-76,-4,5,-2,3,1,-1,5,4,4,0,4,4,0,4,0,1,1,0,8,46,-1,-5,6,6,0,-1,1,1,-1,1,1,-1
KR_6774544962,420,-2,-62,13,-8,-6,7,1,0,3,3,0,4,4,-1,4,3,-1,2,1,0,-3,42,-1,-5,6,-32,0,0,-1,-1,0,-1,5,-1
KR_6775192786,420,-2,-18,-13,-2,-1,2,1,3,1,4,-1,1,0,-1,2,1,-2,2,0,0,-3,3,-1,-5,6,-4,0,-1,-1,-1,-1,-1,5,-1
KR_6777644029,420,-2,-13,-27,1,1,1,2,0,3,3,-2,3,1,2,1,3,0,0,0,0,5,12,6,-9,3,-2,0,1,-1,1,1,1,6,-1
KR_6773985757,440,0,51,-4,7,-2,2,0,3,1,4,3,1,4,1,5,6,2,4,6,0,11,2,2,-4,2,-4,0,1,-1,-1,1,-1,3,-1
KR_6767021852,420,-1,-33,-8,-5,-5,5,0,1,2,3,-2,2,0,-1,4,3,2,1,3,-1,-1,169,4,-6,2,-5,0,0,-1,-1,-1,-1,4,-1
KR_6762608638,420,-3,-54,-22,-1,-1,1,0,-4,6,2,1,1,2,3,1,4,0,0,0,0,2,-6,-3,-4,7,-2,0,-2,1,-1,-1,1,4,-1
KR_6752367136,420,-4,-50,-35,-9,-1,2,1,-2,2,0,-3,5,2,-2,3,1,-1,1,0,0,-11,-31,-2,-6,8,0,0,-1,-1,-1,-1,-1,3,-1
KR_6767745193,420,-3,20,-32,-16,-1,4,3,-3,3,0,-5,6,1,-2,2,0,-5,7,2,0,-17,-9,-1,-5,6,-1,0,-2,1,-1,-1,-1,4,-1
KR_6771716747,440,-4,-26,-32,-2,5,1,6,1,1,2,-8,9,1,0,1,1,0,0,0,0,1,-3,-3,-1,4,1,0,-1,-1,1,-1,1,4,-1
KR_6734007488,420,-1,-32,20,0,-1,3,2,2,1,3,1,1,2,-4,5,1,2,0,2,0,0,19,-1,-5,6,1,0,-1,-1,-1,-1,-1,2,-1
KR_6773893698,420,-1,1,-21,-5,2,0,2,-2,3,1,-4,6,2,-2,2,0,1,0,1,0,-2,-1,0,-5,5,-6,0,-1,-1,-1,-1,-1,1,-1
KR_6768872531,420,3,65,43,-1,-5,6,1,1,3,4,-1,2,1,4,1,5,0,1,1,-1,0,-4,0,-7,7,1,0,1,-1,-1,1,-1,6,-1
KR_6732196944,440,0,3,17,-9,0,2,2,-5,5,0,1,2,3,-7,9,2,2,1,3,0,-13,-5,-1,-2,3,-2,0,-1,-1,0,-1,-1,4,-1
KR_6772581499,420,-1,0,-36,0,-3,4,1,0,1,1,1,1,2,3,1,4,-1,1,0,0,13,-2,6,-12,6,1,0,0,0,-1,0,-1,0,-1
KR_6770644992,420,-2,-33,25,-14,-5,7,2,-8,9,1,0,2,2,1,3,4,-2,2,0,0,-22,7,-3,-4,7,-2,0,1,1,-1,1,-1,6,-1
KR_6759924702,420,0,-8,0,-7,-4,4,0,3,2,5,-6,6,0,0,2,2,0,1,1,0,-8,1,-2,-3,5,-4,0,0,-1,0,0,1,2,-1
KR_6757844818,420,0,-85,-1,-14,-4,5,1,-7,7,0,-2,4,2,2,2,4,-3,3,0,-1,-12,3,-1,-6,7,1,0,-3,1,-1,-1,-1,3,-1
KR_6776353848,420,0,-26,28,-2,-2,4,2,3,1,4,-2,2,0,-1,2,1,0,1,1,0,-2,-3,-1,-4,5,0,0,0,1,-1,0,1,2,-1
KR_6775267008,420,3,-32,-5,4,0,1,1,2,1,3,0,1,1,3,2,5,-1,1,0,0,9,5,2,-6,4,0,0,0,1,-1,-1,1,6,-1
KR_6744458684,420,-3,-33,-4,-8,-3,4,1,-3,3,0,1,1,2,-3,4,1,0,0,0,0,-4,15,0,-7,7,-6,0,0,-1,1,0,-1,3,-1
KR_6772922348,420,-2,-24,11,-14,-4,4,0,-2,2,0,1,2,3,-8,8,0,-1,1,0,0,-17,-3,-5,-5,10,0,0,-1,-1,-1,-1,-1,3,-1
KR_6766081718,420,-1,-30,28,-4,-4,4,0,3,0,3,-1,3,2,-2,4,2,0,0,0,0,2,37,-1,-8,9,1,0,0,1,1,0,-1,5,-1
KR_6765477843,420,-1,-15,-22,1,0,3,3,4,1,5,0,2,2,-4,6,2,1,1,2,-1,0,-13,-9,-2,11,2,0,1,1,1,1,-1,1,-1
KR_6777632276,420,-2,-27,-23,-4,0,1,1,0,4,4,-2,3,1,-4,6,2,2,0,2,0,-9,9,-5,-4,9,-6,0,-2,1,1,-1,1,1,-1
KR_6769806188,420,0,11,11,1,1,2,3,-2,4,2,-1,2,1,1,1,2,2,0,2,0,1,9,3,-8,5,-2,0,0,1,1,0,1,3,-1
KR_6777092182,420,-2,-21,-12,-7,-1,2,1,0,3,3,-4,7,3,-2,3,1,0,1,1,0,-12,5,-1,-3,4,-1,0,0,0,-1,0,-1,0,-1
KR_6776946650,420,-2,-18,39,-12,-2,3,1,-3,3,0,1,1,2,-3,4,1,-5,5,0,0,-17,-5,2,-6,4,-3,0,-3,-1,-1,-1,-1,4,-1
KR_6753374043,420,3,88,8,-1,-3,4,1,-2,5,3,1,0,1,5,3,8,-2,2,0,0,-4,10,-7,-2,9,-2,0,1,1,1,1,1,6,-1
KR_6750739731,440,-6,-85,-44,-13,-4,5,1,0,1,1,-5,8,3,-3,4,1,-1,2,1,-1,-8,9,-3,-2,5,2,0,-2,0,-1,-1,-1,0,-1
KR_6776428961,420,-5,-17,-24,-8,3,0,3,-1,5,4,-3,4,1,3,0,3,-10,11,1,0,-18,28,-2,-4,6,1,0,-1,-1,-1,-1,-1,5,-1
KR_6750514874,420,0,24,8,1,-4,4,0,-3,3,0,2,1,3,5,0,5,1,0,1,0,4,-1,-4,-3,7,-1,0,0,1,-1,-1,-1,2,-1
KR_6751427479,440,-1,-11,29,-1,-1,2,1,0,0,0,1,1,2,-3,3,0,2,1,3,0,-3,-43,-4,-5,9,1,0,1,1,-1,1,-1,2,-1
KR_6704578291,440,3,59,-6,0,-1,1,0,-3,7,4,-2,5,3,5,1,6,1,1,2,0,-3,-66,-3,0,3,4,0,1,1,1,1,1,4,-1
KR_6739125203,420,-2,2,2,-3,1,2,3,-5,5,0,1,2,3,1,1,2,-1,1,0,0,-3,0,1,-6,5,-4,0,-1,1,1,-1,1,5,-1
KR_6742974961,420,-4,-15,-15,-7,-2,4,2,-3,4,1,2,0,2,-1,4,3,-3,3,0,0,-9,24,-1,-4,5,0,0,-2,-1,-1,-1,-1,5,-1
KR_6762104961,420,-9,-92,-19,-15,0,2,2,-8,8,0,-3,4,1,-3,5,2,-1,2,1,1,-14,1,-3,-5,8,-5,0,-2,-1,-1,-1,1,3,-1
KR_6754927820,420,-4,-16,11,-7,-1,1,0,-2,4,2,-4,5,1,0,1,1,0,0,0,0,-13,-5,-5,-3,8,3,0,0,1,1,1,-1,4,-1
KR_6734717959,440,-5,-119,-14,-7,-2,2,0,-1,7,6,-2,6,4,-2,3,1,0,1,1,0,-3,21,-2,-7,9,1,0,0,-1,-1,-1,-1,2,-1
KR_6732605954,420,0,19,17,-2,-2,2,0,-3,4,1,2,1,3,-2,2,0,3,0,3,0,-5,-11,-2,-6,8,4,0,0,-1,1,0,1,2,-1
KR_6777045440,420,-4,-44,-15,-9,0,1,1,-1,3,2,-4,6,2,-5,6,1,1,1,2,0,-11,-2,-2,-6,8,-1,0,0,-1,1,0,-1,3,-1
KR_6754106919,440,0,30,-4,-1,1,1,2,-1,2,1,-1,4,3,1,7,8,-1,2,1,0,-4,396,-4,-1,5,1,0,-1,1,-1,-1,1,4,-1
KR_6762824648,420,-1,-34,0,-5,2,1,3,2,3,5,-1,2,1,-7,8,1,-1,1,0,0,-10,15,-4,-3,7,0,0,-1,-1,1,-1,1,2,-1
KR_6754565526,420,-1,-61,-15,2,-3,4,1,2,2,4,0,2,2,1,3,4,2,0,2,0,-2,370,-4,-2,6,4,0,0,1,1,1,1,3,-1
KR_6773105164,420,-6,-64,-20,-14,1,1,2,2,2,4,-6,6,0,-12,13,1,1,1,2,0,-17,-5,-5,-3,8,2,0,-3,-1,-1,-1,1,5,-1
KR_6710173356,420,-4,-46,-25,-7,5,0,5,4,0,4,-1,4,3,-17,20,3,2,1,3,0,-8,42,2,-7,5,-6,0,-1,-1,-1,1,1,4,-1
KR_6774430666,420,-4,-28,-45,-2,2,0,2,-4,6,2,-1,2,1,-1,3,2,2,0,2,0,2,-3,-2,-5,7,1,0,0,-1,1,0,-1,1,-1
KR_6747427072,420,-1,-27,-15,-8,-4,4,0,0,4,4,-3,3,0,2,5,7,-3,4,1,0,-4,-18,2,-5,3,-4,0,-1,0,-1,-1,-1,0,-1
KR_6733195637,420,-3,-17,-18,-13,-1,1,0,-12,15,3,1,0,1,-1,4,3,0,1,1,0,-14,-20,1,-7,6,3,0,-1,-1,-1,-1,-1,6,-1
KR_6771821560,420,-2,-24,-7,5,-5,5,0,1,6,7,5,1,6,3,0,3,1,1,2,0,4,-65,2,-6,4,28,0,1,1,1,-1,1,4,-1
KR_6720223114,420,-3,-73,-27,-4,4,1,5,-3,5,2,2,3,5,-4,11,7,-3,3,0,2,-16,8,5,-10,5,-2,0,-3,-1,1,-1,1,3,-1
KR_6735010431,420,-2,-109,4,-8,-7,8,1,1,1,2,-1,3,2,0,4,4,-1,2,1,0,0,-219,-3,-1,4,3,0,0,-1,1,1,-1,2,-1
KR_6777469897,420,-2,-97,23,-6,0,1,1,2,0,2,0,1,1,-5,7,2,-3,3,0,0,-2,14,1,-8,7,-3,0,-2,1,-1,-1,-1,5,-1
KR_6765481448,420,0,-5,-19,7,1,1,2,1,2,3,4,1,5,-1,3,2,2,0,2,0,3,-37,4,-6,2,31,0,0,1,-1,0,1,3,-1
KR_6774931518,420,-3,-54,1,-2,1,3,4,1,5,6,2,2,4,-5,9,4,-1,2,1,1,1,13,-1,-6,7,0,0,-3,1,-1,-1,1,3,-1
KR_6732583503,420,1,-34,9,-2,-3,3,0,0,2,2,0,4,4,1,1,2,0,1,1,0,2,103,2,-6,4,-2,0,0,-1,1,-1,1,6,-1
KR_6729853322,420,-2,-18,-25,-9,1,0,1,-4,4,0,-5,5,0,-1,1,0,0,0,0,0,-16,6,-3,-6,9,-5,0,-2,-1,-1,-1,-1,4,-1
KR_6773207878,420,-5,-83,-19,-19,0,1,1,-9,10,1,-3,7,4,-5,6,1,-2,2,0,-3,-21,-31,0,-6,6,-3,0,-2,-1,-1,-1,-1,4,-1
KR_6746985201,420,1,73,19,-1,-2,4,2,4,0,4,-3,5,2,-1,4,3,1,1,2,0,3,-5,2,-6,4,-2,0,1,1,1,1,-1,2,-1
KR_6698650649,420,0,-37,-36,-5,-6,7,1,-3,7,4,-3,3,0,5,2,7,2,0,2,-1,10,99,-3,-5,8,-21,0,0,1,-1,-1,-1,5,-1
KR_6775011203,420,-3,0,-44,-5,2,0,2,-2,3,1,-2,3,1,-2,3,1,-1,1,0,0,-8,-32,0,-5,5,1,0,-1,1,-1,-1,-1,3,-1
KR_6742824037,420,-3,-22,-7,-12,-2,3,1,-3,5,2,-4,4,0,0,4,4,-3,3,0,0,-11,21,-3,-2,5,1,0,-1,1,-1,-1,-1,4,-1
KR_6742349494,420,-8,-100,-60,-20,-5,5,0,-12,12,0,1,0,1,-3,4,1,-1,2,1,0,-24,-37,-2,-6,8,15,0,-2,-1,1,-1,-1,5,-1
KR_6742048244,420,4,-4,7,4,1,0,1,0,3,3,2,1,3,0,1,1,1,0,1,0,-2,-5,3,-9,6,-2,0,0,-1,1,0,-1,2,-1
KR_6766072541,420,4,33,9,7,7,1,8,3,0,3,-1,4,3,-2,2,0,0,1,1,0,1,28,2,-6,4,5,0,0,1,-1,1,1,6,-1
KR_6773166246,420,-3,-36,-5,-5,-3,3,0,-4,5,1,-2,4,2,3,2,5,1,0,1,-1,0,25,0,-9,9,1,0,0,1,-1,0,-1,1,-1
KR_6777755383,420,-1,1,-36,-2,-6,7,1,2,3,5,0,1,1,2,2,4,0,1,1,-1,-1,10,-2,-3,5,2,0,-1,-1,-1,-1,-1,5,-1
KR_6768047390,420,-2,-72,-9,1,4,0,4,0,2,2,-1,3,2,-2,5,3,0,1,1,0,-7,0,-4,-6,10,-4,0,0,1,1,1,-1,6,-1
KR_6738213213,440,-2,-27,-23,-3,-1,3,2,-1,1,0,5,3,8,-5,6,1,-1,2,1,0,-6,19,2,-6,4,-1,0,-2,0,-1,-1,-1,0,-1
KR_6751201882,440,-1,-67,1,-7,-3,3,0,-1,3,2,-3,3,0,-1,1,0,1,1,2,0,-17,-43,-1,-6,7,30,0,0,-1,1,0,1,3,-1
KR_6776500691,420,-2,-38,16,-7,-3,4,1,-1,3,2,-6,7,1,4,3,7,-1,1,0,1,10,36,1,-6,5,-15,0,1,1,-1,1,1,4,-1
KR_6722736527,420,-6,-128,-22,-9,0,2,2,-5,6,1,-1,3,2,-3,3,0,0,1,1,0,-4,10,1,-6,5,-2,0,-3,-1,1,-1,-1,5,-1
KR_6745782612,420,-3,-42,13,-4,2,0,2,-4,5,1,-2,2,0,1,0,1,-1,1,0,0,-4,-1,-3,-3,6,-2,0,0,-1,-1,-1,1,5,-1
KR_6775312424,420,-1,23,-4,0,2,0,2,-4,4,0,4,2,6,-1,3,2,-1,3,2,0,-6,20,-1,-4,5,-3,0,-1,-1,1,-1,-1,2,-1
KR_6756615367,420,-2,-2,-45,-19,2,0,2,-8,8,0,-10,11,1,-3,6,3,0,1,1,0,-19,0,-5,-3,8,-3,0,-1,0,-1,-1,1,0,-1
KR_6685764865,420,-4,-14,-20,-1,-3,4,1,0,2,2,-1,2,1,4,0,4,-1,1,0,0,4,3,-1,-10,11,-14,0,0,1,-1,0,-1,6,-1
KR_6776495830,420,-4,-116,28,-11,-1,3,2,-3,4,1,-9,10,1,3,3,6,-1,2,1,0,-8,-22,3,-9,6,-8,0,-3,-1,-1,-1,1,1,-1
KR_6741021719,420,-6,-139,-14,-13,1,2,3,-7,10,3,0,0,0,-6,7,1,-1,1,0,1,-19,-14,-3,-4,7,-2,0,-3,-1,1,-1,1,6,-1
KR_6750352788,420,-4,-57,-6,-19,-1,3,2,-2,3,1,0,2,2,-18,21,3,2,0,2,0,-25,-2,-4,-3,7,0,0,-5,-1,-1,-1,-1,3,-1
KR_6777850415,420,-5,-65,-16,-11,-2,3,1,-6,7,1,0,2,2,-4,4,0,1,0,1,0,-13,-12,-2,-5,7,-4,0,0,1,-1,-1,-1,2,-1
KR_6775140282,420,-1,-41,-33,0,-5,6,1,2,0,2,1,0,1,-1,4,3,3,2,5,-1,1,-4,4,-9,5,0,0,-1,-1,1,-1,-1,2,-1
KR_6773817726,420,1,-49,-16,3,5,0,5,2,2,4,-3,4,1,-2,5,3,1,1,2,0,7,17,0,-7,7,3,0,-1,1,-1,-1,-1,1,-1
KR_6728257985,420,-5,-45,-7,-14,-2,3,1,-1,2,1,-6,7,1,-7,9,2,2,0,2,-2,-27,-62,-5,-3,8,-3,0,-2,-1,-1,-1,-1,6,-1
KR_6771610333,420,-1,-16,-20,-4,0,0,0,0,4,4,-2,3,1,-4,6,2,2,4,6,0,-1,-6,0,-5,5,-4,0,0,-1,-1,0,1,4,-1
KR_6768834403,420,-2,-30,-4,-7,-4,6,2,-8,9,1,2,2,4,2,3,5,1,0,1,0,-2,-7,-2,-6,8,3,0,-1,-1,1,-1,-1,2,-1
KR_6777437778,420,-1,-25,-24,3,-2,2,0,1,5,6,1,1,2,1,2,3,2,1,3,0,4,19,1,-5,4,1,0,0,1,0,0,-1,3,-1
KR_6772918463,420,2,22,5,-3,0,2,2,-4,4,0,2,1,3,-5,6,1,4,1,5,0,-2,-29,-6,-2,8,9,0,-2,-1,1,-1,-1,2,-1
KR_6737896954,420,2,32,12,1,-1,1,0,0,4,4,5,1,6,-3,4,1,0,0,0,0,-1,-6,2,-7,5,6,0,0,1,1,-1,-1,4,-1
KR_6768701856,420,-3,-35,8,-6,-2,2,0,-1,4,3,-2,3,1,2,1,3,-3,4,1,0,-9,-5,0,-4,4,3,0,0,1,1,1,1,4,-1
KR_6735995177,420,-2,-40,-7,-4,-2,2,0,-3,3,0,-1,1,0,3,1,4,-1,2,1,0,-10,14,-2,-5,7,-7,0,0,1,-1,-1,-1,2,-1
KR_6770752146,420,-3,-7,6,-6,-1,1,0,-1,2,1,-3,4,1,-2,3,1,1,0,1,0,-9,9,-5,-5,10,-2,0,0,-1,1,0,1,1,-1
KR_6775272117,420,-2,5,4,-6,-1,3,2,-1,5,4,-2,5,3,0,2,2,-2,2,0,0,-9,-135,-1,-6,7,2,0,-1,-1,-1,-1,-1,4,-1
KR_6774618472,420,-1,-34,1,-8,1,1,2,-2,2,0,-2,2,0,-5,9,4,0,2,2,-3,-12,-11,-6,-2,8,4,0,0,-1,1,1,-1,3,-1
KR_6747848908,420,5,105,2,16,-1,4,3,12,3,15,3,2,5,0,4,4,2,0,2,-1,8,-5,-2,-3,5,7,0,1,0,0,1,1,0,-1
KR_6773220927,420,-3,-90,-9,-6,-4,4,0,4,2,6,-3,4,1,-3,4,1,0,1,1,0,-3,6,-3,-4,7,-3,0,-3,-1,1,-1,-1,5,-1
KR_6771821378,440,-4,-87,20,-18,-4,4,0,-1,2,1,-5,6,1,-8,8,0,0,1,1,0,-13,-7,-4,-3,7,-3,0,-1,-1,1,-1,-1,6,-1
KR_6757703991,420,0,-16,-28,3,-4,4,0,7,2,9,-1,3,2,-2,6,4,3,0,3,0,8,6,0,-5,5,-3,0,1,-1,1,1,1,1,-1
KR_6759994493,420,-2,-23,8,-4,1,3,4,-3,4,1,0,1,1,-1,2,1,-1,2,1,0,-4,167,1,-7,6,-3,0,3,1,-1,1,1,2,-1
KR_6777671081,420,0,24,-15,6,0,1,1,-1,3,2,2,0,2,1,2,3,4,1,5,1,8,5,-1,-5,6,0,0,0,-1,1,1,1,5,-1
KR_6771516253,440,-2,-58,-4,-5,-2,3,1,-6,6,0,-2,2,0,5,1,6,0,1,1,0,-6,-68,1,-5,4,-4,0,0,0,1,-1,-1,0,-1
KR_6741450628,420,-2,4,-17,-2,2,1,3,-4,4,0,-4,4,0,3,0,3,1,1,2,0,9,2,2,-6,4,4,0,-1,-1,-1,-1,1,5,-1
KR_6706424286,420,-2,-31,-46,-9,-6,6,0,-3,5,2,1,0,1,-2,4,2,1,1,2,0,-9,2,4,-7,3,-7,0,0,-1,1,-1,1,2,-1
KR_6776750711,420,0,27,21,5,3,1,4,-1,2,1,-2,3,1,3,1,4,2,0,2,3,14,9,5,-10,5,0,0,0,-1,1,0,1,1,-1
KR_6774976672,420,-4,-45,15,-12,-1,2,1,-6,7,1,-1,3,2,-2,6,4,-2,3,1,-1,-24,-44,-1,-5,6,3,0,-2,1,-1,-1,-1,4,-1
KR_6774051497,440,-3,-86,19,-4,-1,1,0,-2,2,0,4,1,5,-5,6,1,0,1,1,-1,-9,5,1,-6,5,-7,0,0,-1,1,1,-1,1,-1
KR_6772029449,420,3,9,13,8,0,1,1,3,1,4,3,1,4,2,0,2,0,0,0,0,8,-6,6,-14,8,0,0,0,-1,1,0,1,4,-1
KR_6777360290,420,0,24,5,-12,-5,6,1,-5,6,1,4,2,6,-4,6,2,-2,2,0,0,-9,-2,0,-9,9,-2,0,-1,1,-1,-1,-1,6,-1
KR_6692636636,420,-5,-5,-9,-11,-5,6,1,3,2,5,-7,8,1,-1,3,2,-1,1,0,0,-4,-8,-2,-6,8,-3,0,0,-1,1,1,-1,3,-1
KR_6771799192,420,-1,-54,3,-5,-1,3,2,1,4,5,-3,5,2,0,4,4,-2,3,1,0,0,15,-1,-4,5,2,0,0,-1,-1,-1,-1,3,-1
KR_6776511508,420,-3,-83,-9,-8,-1,1,0,1,2,3,-1,2,1,-8,9,1,1,0,1,0,-3,-3,-4,-1,5,-2,0,1,-1,1,1,-1,2,-1
KR_6766626283,420,-3,-1,15,-12,-3,5,2,-2,3,1,-2,5,3,-2,4,2,-3,3,0,0,-18,-4,-5,-2,7,1,0,-1,1,-1,-1,-1,2,-1
KR_6766391428,420,-2,-44,4,-1,-1,3,2,-6,6,0,-1,3,2,7,2,9,0,0,0,0,7,1,1,-10,9,2,0,-1,1,-1,-1,1,5,-1
KR_6766848498,420,-2,-13,-30,-8,0,0,0,-4,4,0,0,1,1,-1,4,3,-3,3,0,0,-8,-3,-7,-5,12,5,0,-1,-1,-1,-1,-1,5,-1
KR_6704623806,420,-1,29,-20,1,-2,3,1,0,2,2,-2,3,1,2,1,3,3,0,3,2,8,6,3,-7,4,2,0,-1,1,-1,-1,1,4,-1
KR_6766809016,420,0,-84,12,-8,-3,3,0,-2,3,1,-1,4,3,-3,7,4,1,2,3,0,-9,8,-4,-3,7,-4,0,-2,0,-1,-1,-1,0,-1
KR_6683831207,420,-2,-7,-16,-2,-5,6,1,-1,2,1,1,1,2,3,0,3,0,0,0,0,1,9,3,-9,6,-6,0,-1,1,1,-1,-1,5,-1
KR_6750359975,420,0,24,3,-2,2,1,3,-3,3,0,-1,4,3,1,2,3,-1,3,2,0,2,-17,3,-8,5,4,0,-1,1,-1,-1,1,1,-1
KR_6775404501,420,-2,-41,8,-4,-1,5,4,2,1,3,-5,5,0,0,3,3,0,1,1,0,5,4,3,-7,4,-2,0,0,-1,1,-1,-1,2,-1
KR_6737261799,420,-3,-89,7,-8,-1,1,0,-4,9,5,-3,3,0,2,2,4,-2,2,0,0,-23,-32,-3,-6,9,-3,0,0,-1,-1,-1,1,2,-1
KR_6772974885,420,0,-23,12,-1,1,0,1,2,4,6,3,2,5,-5,6,1,-2,2,0,-1,-5,-6,-4,-6,10,0,0,-1,1,-1,-1,-1,5,-1
KR_6763654421,420,0,-22,25,-2,0,1,1,-1,1,0,-3,5,2,3,1,4,-1,2,1,0,-7,-103,2,-9,7,-5,0,0,1,-1,-1,1,4,-1
KR_6771318272,420,-2,-40,8,-5,1,1,2,-2,2,0,1,1,2,-4,5,1,-1,2,1,0,-5,4,1,-6,5,-4,0,0,-1,1,0,-1,3,-1
KR_6771049368,420,-2,-41,-46,-1,3,0,3,-3,4,1,-4,5,1,2,0,2,1,0,1,0,-4,-10,-2,-6,8,-4,0,0,-1,-1,0,-1,1,-1
KR_6777057345,420,-3,6,-47,-10,1,2,3,-1,3,2,-2,2,0,-7,10,3,-1,2,1,-2,-6,-9,0,-6,6,-1,0,0,-1,-1,1,-1,4,-1
KR_6773694887,440,-3,-42,-9,2,-1,2,1,4,1,5,-3,3,0,1,1,2,1,0,1,0,5,89,2,-7,5,-1,0,-1,-1,-1,-1,1,2,-1
KR_6773303649,440,-2,-1,-16,-5,2,0,2,-4,4,0,4,0,4,-5,6,1,-2,2,0,0,-4,2,-1,-3,4,-1,0,0,-1,1,0,-1,4,-1
KR_6770701574,420,1,58,13,-2,-1,3,2,0,3,3,0,4,4,-1,2,1,0,0,0,0,0,-33,0,-6,6,-1,0,0,1,-1,0,-1,4,-1
KR_6776598469,420,0,80,-4,-3,-4,5,1,-1,1,0,-2,3,1,5,3,8,-1,1,0,0,-3,10,-6,-7,13,-9,0,0,1,-1,-1,-1,2,-1
KR_6769656455,420,0,-38,1,-4,2,0,2,-7,9,2,-2,2,0,2,0,2,1,1,2,0,1,20,-2,-4,6,-5,0,-2,1,-1,-1,-1,5,-1
KR_6670628857,420,-3,-54,-16,-10,-3,3,0,-3,6,3,0,2,2,-3,8,5,-1,1,0,0,-10,3,2,-7,5,-5,0,-1,-1,-1,-1,-1,4,-1
KR_6749371058,440,-3,-8,13,-19,-5,7,2,0,1,1,-7,7,0,-6,6,0,-1,3,2,0,-29,14,-6,-5,11,-3,0,0,-1,1,-1,-1,6,-1
KR_6764906514,420,-2,19,-5,-1,-1,2,1,-1,3,2,5,2,7,-1,2,1,-3,4,1,2,1,6,0,-4,4,0,0,-1,-1,-1,-1,1,2,-1
KR_6771880837,440,-2,-77,11,-5,-3,3,0,1,1,2,-1,3,2,-2,2,0,0,0,0,0,-4,2,1,-8,7,-2,0,-1,1,-1,-1,-1,5,-1
KR_6757119290,420,-2,-7,15,-5,-4,5,1,1,1,2,-2,2,0,-1,1,0,1,0,1,0,-2,-4,-2,-5,7,-1,0,-1,-1,-1,-1,1,2,-1
KR_6715296493,420,-1,-19,-12,2,-2,3,1,-1,4,3,1,1,2,5,0,5,-1,3,2,0,-1,6,6,-9,3,6,0,0,-1,1,-1,1,3,-1
KR_6742038796,420,6,90,21,8,2,1,3,-1,2,1,1,2,3,2,2,4,4,0,4,0,9,-3,2,-7,5,5,0,1,-1,-1,1,1,4,-1
KR_6765849972,420,1,50,-17,-1,6,0,6,-3,6,3,-2,4,2,-2,3,1,0,0,0,0,-2,16,-4,-5,9,0,0,1,-1,1,1,-1,4,-1
KR_6740967572,420,1,20,-7,8,1,2,3,-2,6,4,2,1,3,3,1,4,4,0,4,1,14,-20,0,-8,8,25,0,1,1,0,1,1,6,-1
KR_6774752610,420,1,31,17,-1,1,0,1,-1,2,1,-2,3,1,-3,3,0,4,1,5,0,-2,-35,-2,-5,7,4,0,0,-1,1,0,1,3,-1
KR_6777101178,420,-6,-14,-20,-6,-2,2,0,-2,3,1,-1,6,5,0,1,1,-1,1,0,-1,-12,-10,-3,-4,7,3,0,-1,-1,-1,-1,-1,1,-1
KR_6773812195,420,0,67,-11,6,5,1,6,-2,4,2,2,0,2,-2,4,2,3,0,3,0,-1,-42,-3,-3,6,2,0,2,-1,1,1,1,2,-1
KR_6761630572,420,-3,-28,-4,-6,-3,3,0,-1,3,2,0,4,4,-4,5,1,2,0,2,0,-14,-2,5,-8,3,0,0,0,-1,1,-1,1,5,-1
KR_6777048255,420,-4,-60,-42,-7,-1,3,2,2,3,5,-5,6,1,-3,4,1,0,0,0,0,-10,-7,-3,-4,7,4,0,0,1,1,0,-1,2,-1
KR_6774306642,420,-2,-41,1,-5,0,1,1,-3,7,4,2,2,4,-1,4,3,-3,4,1,0,-12,5,-2,-8,10,1,0,-2,-1,-1,1,-1,6,-1
KR_6685462875,420,-3,-17,-12,-7,3,0,3,-9,10,1,2,1,3,-3,3,0,0,0,0,0,-18,32,-1,-9,10,-3,0,1,-1,1,1,-1,3,-1
KR_6774468358,420,-6,-72,-24,-16,0,2,2,-6,6,0,0,2,2,0,3,3,-10,12,2,-2,-14,13,-8,-4,12,-5,0,-2,1,-1,-1,-1,6,-1
KR_6729354902,420,-2,13,-8,0,2,0,2,2,3,5,-1,2,1,-3,6,3,0,2,2,0,0,2,4,-9,5,-1,0,1,1,-1,-1,1,3,-1
KR_6765479061,420,-1,-9,-33,-2,2,0,2,-8,8,0,2,2,4,2,1,3,0,0,0,0,-10,-32,-3,-4,7,26,0,0,-1,1,-1,1,5,-1
KR_6771666243,420,0,-18,4,-1,-2,4,2,2,3,5,-2,7,5,1,3,4,0,0,0,1,4,12,0,-6,6,-3,0,-1,1,-1,-1,1,5,-1
KR_6759884847,420,-5,-95,-7,-15,-5,5,0,-4,5,1,0,4,4,-5,5,0,-1,1,0,0,-19,14,-1,-5,6,-10,0,-1,-1,-1,-1,1,5,-1
KR_6774711557,420,1,16,-4,-1,5,0,5,-4,5,1,0,2,2,-1,2,1,-1,1,0,0,-7,-110,5,-9,4,-6,0,-1,-1,-1,-1,-1,4,-1
KR_6745803597,420,-1,-32,11,-2,-2,2,0,6,0,6,-4,5,1,-2,3,1,0,0,0,0,-2,115,2,-9,7,0,0,0,1,1,0,-1,3,-1
KR_6774112275,420,0,6,-16,0,0,2,2,3,1,4,0,1,1,-5,6,1,2,0,2,0,4,-47,-2,-10,12,24,0,-1,-1,1,-1,1,2,-1
KR_6757647866,420,2,53,-8,8,-3,7,4,-3,5,2,3,3,6,7,2,9,4,0,4,-1,-1,1,0,-6,6,-2,0,1,-1,-1,1,-1,1,-1
KR_6776975240,420,0,4,-36,1,0,1,1,-2,7,5,-1,1,0,2,2,4,2,0,2,0,-2,-29,-4,-4,8,0,0,0,-1,1,1,-1,6,-1
KR_6776004530,420,-1,-30,4,-2,-4,5,1,3,4,7,0,1,1,-3,6,3,2,1,3,0,-3,-3,4,-8,4,-4,0,-1,-1,-1,-1,1,1,-1
KR_6771852423,420,1,-31,40,5,3,2,5,0,4,4,4,4,8,-6,11,5,4,0,4,0,4,-60,3,-8,5,1,0,1,1,1,1,1,5,-1
KR_6769080609,420,-2,-116,-5,-4,2,0,2,3,1,4,-3,4,1,-9,10,1,3,0,3,-3,-4,-3,-4,-2,6,-3,0,-1,-1,-1,-1,-1,4,-1
KR_6729597888,420,4,24,6,7,-2,5,3,4,4,8,1,2,3,-1,2,1,5,0,5,0,6,18,0,-8,8,-4,0,2,1,1,1,-1,1,-1
KR_6776036396,420,0,-9,8,6,-1,1,0,0,2,2,1,1,2,5,0,5,1,0,1,0,4,-3,-3,-6,9,0,0,0,-1,1,0,1,4,-1
KR_6745224019,440,-1,-31,-3,-4,-1,2,1,-1,2,1,5,0,5,-4,4,0,-3,3,0,0,-7,14,3,-7,4,-4,0,0,-1,-1,-1,-1,3,-1
KR_6763382541,420,-3,-28,-34,-9,1,1,2,0,2,2,2,0,2,-10,12,2,-2,2,0,0,-7,-1,1,-8,7,5,0,0,-1,1,0,-1,4,-1
KR_6767774098,420,1,-20,8,3,0,0,0,-3,7,4,4,0,4,4,1,5,-2,2,0,0,1,-16,1,-6,5,8,0,-1,-1,1,-1,-1,1,-1
KR_6731995552,420,-4,-82,-7,-8,-6,6,0,-3,6,3,2,4,6,-2,3,1,1,2,3,0,-7,-3,1,-9,8,0,0,-1,-1,-1,-1,-1,2,-1
KR_6776793319,420,-5,-28,-3,-11,-4,6,2,-6,6,0,-3,3,0,2,1,3,0,0,0,0,-7,3,1,-5,4,-4,0,0,-1,1,-1,-1,3,-1
KR_6770407890,420,-6,-100,-16,-16,-4,4,0,-5,5,0,0,2,2,-4,7,3,-3,3,0,0,-19,1,-2,-5,7,-1,0,-3,-1,1,-1,-1,4,-1
KR_6712653515,420,-1,-15,5,-2,-8,8,0,-1,3,2,-1,1,0,7,1,8,1,0,1,0,10,-38,-4,-5,9,-5,0,-1,1,-1,-1,-1,4,-1
KR_6773016013,420,0,33,0,5,-3,4,1,1,4,5,3,1,4,4,0,4,0,0,0,0,8,1,-2,-5,7,0,0,2,-1,1,1,1,3,-1
KR_6756063034,420,-3,-36,-39,-1,0,3,3,1,2,3,-2,3,1,-1,2,1,1,0,1,1,2,13,4,-8,4,-3,0,-1,-1,-1,-1,1,2,-1
KR_6775024540,420,-4,-68,-14,-4,0,2,2,-1,2,1,-1,1,0,-3,4,1,1,0,1,0,-7,-91,-6,-1,7,10,0,-1,1,-1,-1,1,1,-1
KR_6775707893,420,-8,-142,-38,-11,-1,1,0,-3,4,1,-3,3,0,-5,5,0,1,0,1,0,-21,-26,-3,-4,7,-3,0,-1,-1,-1,-1,-1,2,-1
KR_6773525757,420,-3,-30,-28,-7,1,1,2,-2,2,0,-5,5,0,-1,2,1,0,0,0,0,-7,-22,3,-8,5,2,0,0,1,-1,0,-1,5,-1
KR_6740919276,420,-1,-43,-8,4,-2,3,1,3,2,5,-2,4,2,6,2,8,-1,1,0,0,10,5,0,-4,4,4,0,1,1,1,1,-1,5,-1
KR_6765893819,420,-3,-69,24,-6,-4,5,1,-4,7,3,-3,3,0,5,2,7,0,0,0,0,-6,-8,0,-7,7,-6,0,0,-1,1,1,-1,2,-1
KR_6770526696,420,-1,-13,-11,2,-2,3,1,-2,5,3,4,0,4,2,1,3,0,3,3,0,1,7,3,-8,5,-4,0,1,1,1,1,-1,3,-1
KR_6774236075,420,-1,-45,-6,-3,1,0,1,0,2,2,-2,3,1,0,2,2,-2,2,0,0,-5,6,-6,-1,7,-7,0,1,-1,-1,1,-1,2,-1
KR_6767410313,420,1,-8,2,-5,0,2,2,1,3,4,-4,6,2,-1,1,0,-1,1,0,0,-5,4,-5,-6,11,1,0,-1,1,-1,1,1,4,-1
KR_6773061350,420,0,24,40,3,0,2,2,4,3,7,-1,3,2,4,1,5,-4,5,1,1,2,-12,-2,-7,9,2,0,0,1,1,-1,1,1,-1
KR_6694844736,420,3,38,13,5,8,0,8,-1,4,3,-1,3,2,-2,4,2,1,1,2,0,-6,112,5,-8,3,-2,0,1,-1,1,1,1,1,-1
KR_6770961014,420,0,-10,10,0,2,1,3,-1,2,1,-4,5,1,4,2,6,-1,1,0,1,9,-68,-4,-4,8,0,0,1,-1,-1,-1,1,3,-1
KR_6755179401,420,3,-16,3,9,0,2,2,3,6,9,2,1,3,3,3,6,1,0,1,0,15,-4,4,-8,4,2,0,2,-1,1,1,1,4,-1
KR_6768359772,420,1,-27,20,9,4,0,4,2,2,4,7,1,8,-2,5,3,-2,2,0,0,18,4,3,-9,6,-6,0,-1,1,-1,-1,1,2,-1
KR_6745265859,440,-5,-65,-4,-3,3,0,3,-5,5,0,1,1,2,-5,6,1,3,0,3,0,-4,7,2,-7,5,-7,0,0,-1,1,0,1,2,-1
KR_6773858678,420,-2,42,-40,-6,-4,4,0,-1,5,4,-1,3,2,-2,7,5,2,1,3,1,0,-9,-7,-5,12,2,0,0,-1,-1,-1,1,3,-1
KR_6702345700,420,-7,-127,-32,-13,-1,1,0,-2,5,3,-2,5,3,-8,9,1,0,0,0,0,-11,-36,2,-5,3,-2,0,-3,-1,-1,-1,-1,5,-1
KR_6685729231,420,-2,-33,-12,-6,-1,2,1,1,3,4,-1,3,2,-4,6,2,-1,1,0,0,-9,-9,-8,-3,11,3,0,0,-1,1,0,-1,4,-1
KR_6777090729,420,-1,-37,29,-12,-2,3,1,-4,7,3,1,0,1,-5,6,1,-2,3,1,-3,-19,-11,-5,-3,8,2,0,-2,1,-1,-1,1,5,-1
KR_6742369811,420,-1,21,11,0,-2,2,0,3,0,3,-2,3,1,1,1,2,0,0,0,0,9,-10,-4,-3,7,8,0,-1,-1,1,-1,1,3,-1
KR_6752853822,440,1,44,-8,5,0,0,0,1,2,3,-1,1,0,5,0,5,0,1,1,0,7,-2,-4,-5,9,5,0,1,-1,-1,1,1,1,-1
KR_6766169241,440,-4,-54,-28,-6,-3,3,0,-3,4,1,2,1,3,-3,3,0,1,0,1,0,-2,0,-2,-3,5,2,0,0,-1,-1,0,-1,5,-1
KR_6746065420,420,2,55,-12,-2,-2,4,2,-1,2,1,2,0,2,-1,1,0,0,0,0,0,-5,24,1,-5,4,0,0,1,-1,-1,1,-1,5,-1
KR_6773823038,420,-1,37,-57,-1,0,0,0,-4,4,0,1,2,3,-1,4,3,3,0,3,0,-3,11,5,-12,7,-2,0,-1,-1,-1,-1,1,4,-1
KR_6774081355,420,1,-56,-7,1,1,0,1,2,1,3,-1,2,1,0,2,2,-1,1,0,0,3,46,4,-8,4,-2,0,-1,1,-1,-1,1,4,-1
KR_6767846882,420,0,36,9,-5,2,1,3,2,0,2,-6,8,2,-1,1,0,-2,2,0,0,-9,27,3,-5,2,-3,0,0,-1,-1,1,-1,6,-1
KR_6762628130,420,-5,-103,9,-13,2,1,3,-10,11,1,0,2,2,-4,7,3,-1,1,0,-2,-14,-34,-6,-2,8,-3,0,-4,-1,-1,-1,1,1,-1
KR_6771880037,440,-2,-30,-24,-5,-2,4,2,0,1,1,3,2,5,-2,3,1,-4,4,0,0,-2,5,1,-6,5,-4,0,-1,-1,0,-1,-1,1,-1
KR_6769053073,420,-3,-68,13,-12,-2,3,1,-3,4,1,-1,3,2,-6,7,1,0,2,2,0,-9,28,2,-5,3,0,0,-1,-1,-1,-1,-1,6,-1
KR_6745099144,420,-3,-51,-24,-8,-2,3,1,-1,5,4,-5,9,4,2,1,3,-2,2,0,0,0,-8,2,-6,4,-1,0,-2,1,-1,-1,-1,5,-1
KR_6715797682,420,0,48,-8,3,-1,4,3,-1,6,5,4,4,8,2,0,2,-1,1,0,0,-1,6,-2,-4,6,-1,0,0,-1,-1,1,-1,6,-1
KR_6726877940,440,1,22,-1,0,1,1,2,-6,9,3,3,0,3,1,2,3,1,0,1,0,0,-6,0,-4,4,3,0,0,-1,-1,0,-1,5,-1
KR_6774547384,420,-1,-50,15,1,-2,3,1,-1,3,2,1,1,2,3,0,3,0,1,1,0,5,6,-3,-5,8,0,0,1,1,-1,-1,-1,5,-1
KR_6770186540,420,1,27,25,-5,-1,1,0,-4,5,1,1,1,2,-1,2,1,0,1,1,0,-10,0,2,-6,4,4,0,1,1,1,1,-1,6,-1
KR_6759144618,420,0,-42,9,1,0,2,2,2,0,2,1,1,2,-2,4,2,0,0,0,0,6,35,-2,-6,8,4,0,0,1,1,0,-1,3,-1
KR_6776947928,420,-2,-12,-17,-2,2,1,3,1,3,4,-4,6,2,-1,6,5,0,1,1,1,-2,7,4,-10,6,-1,0,-1,-1,-1,-1,1,1,-1
KR_6774040504,420,-3,-12,4,-5,-3,6,3,0,4,4,-5,5,0,2,0,2,1,0,1,0,-4,3,-1,-4,5,0,0,-2,1,-1,-1,1,4,-1
KR_6761556989,420,1,-29,-26,4,0,2,2,1,5,6,1,0,1,2,2,4,0,1,1,-1,6,-5,0,-5,5,6,0,-1,-1,-1,-1,-1,4,-1
KR_6775835841,440,-1,-15,-1,-6,-1,2,1,1,1,2,2,1,3,-8,9,1,0,3,3,0,-3,10,4,-9,5,-8,0,0,-1,1,0,-1,1,-1
KR_6742854672,420,-1,-60,-6,-6,-1,1,0,-1,3,2,-1,3,2,-1,3,2,-2,2,0,0,-4,150,1,-6,5,-7,0,-1,-1,-1,-1,-1,4,-1
KR_6769927176,420,-2,-9,0,-3,1,2,3,2,4,6,-2,2,0,-3,3,0,-1,1,0,0,-13,-5,1,-5,4,-4,0,0,-1,1,1,-1,5,-1
KR_6773100489,420,4,8,17,-1,0,2,2,-2,6,4,2,3,5,-1,2,1,0,1,1,-1,-6,0,3,-5,2,-6,0,-1,-1,1,-1,-1,3,-1
KR_6749701716,420,0,-19,-8,-3,5,1,6,4,1,5,-1,4,3,-11,12,1,0,0,0,0,-4,-9,-3,-5,8,-2,0,0,1,-1,-1,-1,5,-1
KR_6752466826,420,-3,-3,-13,-5,-1,2,1,-1,1,0,-1,3,2,-1,4,3,-1,1,0,0,-1,4,2,-6,4,-2,0,0,1,-1,0,1,3,-1
KR_6776047235,440,0,-71,13,2,-1,2,1,-4,5,1,-5,5,0,6,0,6,6,3,9,2,9,10,-2,-2,4,-4,0,-1,1,-1,-1,1,4,-1
KR_6771029965,420,-2,-55,13,-4,0,2,2,0,3,3,-5,7,2,-1,4,3,2,0,2,0,-9,-6,0,-6,6,3,0,-1,1,-1,-1,-1,2,-1
KR_6763713588,440,4,-20,4,12,6,0,6,-1,8,7,3,2,5,2,0,2,2,2,4,0,8,12,8,-9,1,-2,0,-2,0,1,-1,-1,0,-1
KR_6731523390,420,0,-7,-8,2,-1,3,2,0,2,2,1,0,1,1,3,4,1,1,2,0,-2,-123,1,-7,6,1,0,-1,-1,-1,-1,1,6,-1
KR_6759127401,420,-3,-20,7,-3,-3,3,0,2,1,3,-2,4,2,1,1,2,-1,1,0,0,-5,-51,-2,-6,8,15,0,-1,-1,-1,-1,-1,3,-1
KR_6773437568,420,0,-34,7,1,0,1,1,0,4,4,-1,2,1,0,2,2,2,1,3,0,-1,7,-1,-5,6,-2,0,1,1,1,-1,-1,4,-1
KR_6772896654,420,0,31,-16,-2,-3,3,0,1,3,4,3,0,3,-1,3,2,-2,2,0,1,0,52,6,-7,1,-31,0,0,-1,1,-1,1,1,-1
KR_6718033466,440,0,-11,9,-8,-1,2,1,-3,4,1,-4,4,0,-2,2,0,2,5,7,0,-10,104,-3,-6,9,-1,0,-1,1,-1,1,-1,1,-1
KR_6737788003,420,-4,-7,-16,-7,-1,3,2,-2,3,1,1,3,4,-2,3,1,-3,3,0,0,-11,7,2,-6,4,-4,0,-2,-1,-1,-1,1,6,-1
KR_6761875377,440,1,-35,-13,4,3,0,3,-4,5,1,3,2,5,2,0,2,0,1,1,0,2,-9,0,-5,5,1,0,0,-1,-1,1,1,3,-1
KR_6729161316,420,-2,-42,2,-6,-5,5,0,-4,5,1,-1,9,8,4,2,6,0,1,1,0,-8,-19,6,-8,2,2,0,-1,-1,-1,-1,1,1,-1
KR_6759935781,440,2,-3,-20,1,0,1,1,1,3,4,2,1,3,0,0,0,-2,3,1,0,2,45,4,-11,7,-3,0,-1,-1,-1,-1,-1,3,-1
KR_6748175408,420,0,-38,11,2,-1,1,0,-2,6,4,5,5,10,-1,6,5,1,1,2,1,9,2,5,-10,5,-1,0,0,-1,-1,0,1,6,-1
KR_6768829660,420,-6,-43,-12,-16,-5,8,3,3,0,3,-7,8,1,-6,6,0,-1,2,1,-1,-22,-11,-3,-3,6,1,0,-4,-1,1,-1,1,4,-1
KR_6777129261,420,-3,-16,-8,-5,4,0,4,-2,5,3,-4,5,1,-2,4,2,-1,3,2,1,-3,-18,-1,-5,6,-3,0,0,-1,-1,0,1,2,-1
KR_6750005753,420,-3,-22,28,-11,-5,5,0,1,3,4,-2,5,3,-5,6,1,0,0,0,1,-1,21,-3,-5,8,-3,0,-1,-1,-1,-1,1,4,-1
KR_6761626100,440,0,-7,3,-3,2,0,2,-1,2,1,0,4,4,-2,4,2,-2,2,0,0,-12,-3,-1,-4,5,4,0,0,-1,0,0,-1,1,-1
KR_6769082345,420,-1,13,-11,-4,-3,3,0,-2,4,2,-9,12,3,10,1,11,0,1,1,-2,8,9,8,-17,9,-5,0,-1,1,-1,-1,1,4,-1
KR_6777812218,420,-1,31,-4,-3,4,2,6,-4,7,3,-1,1,0,-3,5,2,1,1,2,0,-6,-36,-3,-6,9,3,0,0,-1,-1,1,1,4,-1
KR_6770598180,420,-3,-24,17,-1,-2,3,1,-1,5,4,0,0,0,0,3,3,2,2,4,0,1,16,-2,-7,9,-1,0,1,-1,-1,1,1,1,-1
KR_6678891857,420,2,7,-5,2,4,1,5,-1,4,3,0,1,1,-2,6,4,1,0,1,0,1,-8,3,-10,7,-2,0,-1,-1,-1,-1,-1,2,-1
KR_6777112093,420,-4,-13,28,-5,-1,1,0,-5,8,3,1,0,1,3,3,6,-3,4,1,1,-6,10,7,-8,1,-2,0,0,-1,1,0,1,4,-1
KR_6765836678,440,0,-44,28,-4,-2,2,0,0,3,3,-1,1,0,-1,3,2,0,0,0,0,-5,15,-3,-3,6,1,0,0,0,1,0,-1,0,-1
KR_6777783711,420,-1,-60,-25,-2,-3,3,0,-1,5,4,3,2,5,-1,2,1,0,1,1,0,7,-23,-3,-6,9,0,0,0,-1,-1,-1,1,1,-1
KR_6730969904,420,-7,-144,-44,-12,-1,2,1,-4,6,2,-3,4,1,-3,5,2,-1,1,0,0,-10,1,1,-8,7,-4,0,-2,-1,-1,-1,1,5,-1
KR_6775416114,420,-1,24,4,-9,-1,2,1,-2,4,2,-1,2,1,-2,6,4,-3,4,1,0,-10,-19,-1,-7,8,2,0,1,1,1,1,-1,1,-1
KR_6753318059,420,-1,-14,-4,-2,-4,4,0,3,1,4,-2,3,1,0,3,3,1,0,1,0,-9,-47,-2,-7,9,3,0,-2,1,-1,-1,1,5,-1
KR_6737691961,420,-4,-32,-20,-14,-4,4,0,-8,10,2,-1,3,2,-1,8,7,0,1,1,-2,-8,1,2,-6,4,-2,0,-2,-1,-1,-1,1,1,-1
KR_6768596126,440,-2,-12,7,-15,-12,12,0,0,4,4,1,2,3,-5,5,0,1,1,2,-1,-8,-2,-5,-1,6,0,0,-2,-1,-1,-1,-1,4,-1
KR_6763744188,420,-11,-146,-52,-18,-2,2,0,-9,10,1,-6,6,0,2,0,2,-3,3,0,-1,-22,-2,-6,0,6,4,0,-3,1,-1,-1,-1,3,-1
KR_6777841348,420,-3,-21,-14,-9,1,0,1,-2,7,5,-5,6,1,-3,6,3,0,0,0,-1,-10,9,-1,-7,8,-7,0,0,-1,-1,-1,-1,3,-1
KR_6688144539,420,-4,-41,-56,-3,-2,2,0,1,2,3,-4,5,1,2,0,2,0,1,1,0,0,-154,3,-9,6,0,0,-1,0,-1,-1,1,0,-1
KR_6769262135,420,-3,10,-24,-6,-1,2,1,-3,5,2,2,2,4,-4,7,3,0,1,1,0,-11,1,2,-8,6,-3,0,-1,-1,-1,-1,1,6,-1
KR_6774036404,420,-5,-101,-8,-10,-1,3,2,-1,5,4,-2,2,0,-7,7,0,1,0,1,0,-18,94,-3,-3,6,0,0,-4,1,-1,-1,-1,4,-1
KR_6775273970,420,0,-24,-8,2,-3,3,0,-1,2,1,1,0,1,4,0,4,1,1,2,0,9,-2,1,-9,8,5,0,1,1,1,1,1,2,-1
KR_6726674027,440,2,-20,-20,6,-2,3,1,4,3,7,2,2,4,3,0,3,-1,3,2,-2,0,10,1,-6,5,-4,0,0,-1,1,-1,-1,1,-1
KR_6766690844,420,-6,-28,-16,-16,-4,6,2,-5,6,1,-3,6,3,-2,4,2,-2,2,0,-2,-16,-125,0,-7,7,-2,0,-2,-1,-1,-1,-1,4,-1
KR_6769861563,420,1,-16,39,-4,-2,2,0,-5,6,1,2,0,2,-2,2,0,3,0,3,0,-5,-6,1,-9,8,5,0,0,1,-1,0,1,2,-1
KR_6776723625,420,-5,-103,-49,-6,0,3,3,-3,3,0,0,0,0,-3,4,1,0,2,2,0,-9,-9,-1,-3,4,-1,0,-1,-1,-1,-1,1,3,-1
KR_6745917074,420,0,-39,-18,3,3,0,3,1,1,2,0,1,1,0,1,1,-1,1,0,0,4,12,-3,-6,9,1,0,0,-1,-1,0,1,2,-1
KR_6774353447,420,0,67,5,-13,-4,6,2,-6,8,2,-2,4,2,-3,4,1,2,1,3,0,-17,-21,3,-9,6,2,0,-1,-1,-1,-1,1,4,-1
KR_6748201511,420,4,42,0,10,2,0,2,8,1,9,3,0,3,-4,10,6,1,0,1,0,7,0,1,-7,6,-1,0,0,1,-1,0,1,1,-1
KR_6746887002,420,-1,-12,0,-9,0,2,2,-1,2,1,-6,8,2,-1,7,6,-1,2,1,0,-15,-11,-5,-5,10,-2,0,-1,-1,-1,-1,-1,3,-1
KR_6745806990,420,-2,-19,0,-7,-1,1,0,-2,2,0,-2,2,0,-4,4,0,2,1,3,0,-2,-119,1,-7,6,1,0,0,-1,-1,0,-1,2,-1
KR_6765570213,420,-6,-69,-1,-10,-3,3,0,-6,6,0,1,0,1,-3,6,3,1,0,1,0,-5,112,1,-5,4,-2,0,-2,1,-1,-1,-1,6,-1
KR_6774254112,420,1,-6,27,3,-2,4,2,2,3,5,6,0,6,-5,8,3,2,1,3,0,1,4,0,-5,5,-3,0,0,1,1,1,1,3,-1
KR_6775249003,420,-4,-22,-29,-9,-2,4,2,-4,5,1,4,1,5,-5,6,1,-2,2,0,0,-12,-10,1,-9,8,0,0,-1,1,-1,-1,1,5,-1
KR_6756457877,420,0,80,7,-1,2,1,3,-2,6,4,4,1,5,-1,3,2,-4,5,1,0,-5,-3,-3,-5,8,2,0,0,1,-1,0,1,4,-1
KR_6767897006,420,1,3,34,3,-1,2,1,3,1,4,-2,2,0,2,2,4,1,0,1,0,7,-3,2,-7,5,1,0,0,1,1,0,-1,5,-1
KR_6772740963,420,0,-51,4,-2,-2,3,1,-1,3,2,3,1,4,0,2,2,-2,2,0,0,-6,33,-2,-6,8,-9,0,-1,-1,-1,-1,-1,3,-1
KR_6773390024,440,0,-42,0,3,-3,4,1,0,1,1,3,1,4,2,2,4,1,0,1,0,14,58,-1,-4,5,5,0,-2,1,-1,-1,-1,6,-1
KR_6772035206,440,-1,15,5,-3,-2,2,0,-3,6,3,0,4,4,1,2,3,1,1,2,0,-5,-6,-3,-4,7,1,0,1,1,1,1,-1,4,-1
KR_6670170554,420,0,25,-22,0,-1,3,2,-2,4,2,3,1,4,-2,4,2,2,0,2,0,5,-3,-1,-5,6,1,0,-1,-1,1,-1,1,5,-1
KR_6762885580,420,-3,1,-11,-5,1,1,2,2,4,6,-4,4,0,-2,2,0,-2,2,0,0,-16,32,2,-5,3,-42,0,-1,-1,1,-1,-1,3,-1
KR_6777814183,420,-3,-33,2,-5,0,1,1,-4,5,1,-1,1,0,0,3,3,0,2,2,-1,-6,2,3,-8,5,4,0,0,1,-1,0,-1,2,-1
KR_6765101037,420,-5,-23,22,-13,-3,6,3,-6,6,0,-3,4,1,-1,3,2,0,0,0,0,-6,-38,1,-6,5,-1,0,-1,-1,-1,-1,1,2,-1
KR_6708157035,420,-5,28,-41,-11,0,1,1,-3,5,2,0,1,1,-6,6,0,-2,2,0,0,-13,-6,-3,-2,5,0,0,0,-1,1,-1,-1,1,-1
KR_6777429744,420,-4,-96,21,-14,-9,9,0,-6,8,2,2,1,3,-1,4,3,0,0,0,-1,-8,-3,-3,-6,9,2,-1,-2,1,-1,-1,-1,4,-1
KR_6664002108,420,-5,-40,-1,-10,-2,3,1,-3,4,1,-1,5,4,-1,5,4,-3,4,1,0,-20,2,0,-9,9,-5,0,-1,-1,1,-1,1,1,-1
KR_6732635912,420,-1,-44,-16,-8,-2,3,1,-1,5,4,1,4,5,-5,7,2,-1,1,0,-1,-2,14,6,-11,5,-3,0,0,-1,-1,-1,-1,6,-1
KR_6777855964,440,0,18,-31,3,0,1,1,-1,1,0,-5,7,2,8,0,8,1,0,1,0,10,-2,-3,-4,7,1,0,0,1,-1,0,1,3,-1
KR_6771635763,420,-5,-13,0,-9,-5,7,2,2,3,5,-4,4,0,-1,2,1,-1,3,2,0,-5,-32,-1,-6,7,4,0,-2,1,-1,-1,-1,2,-1
KR_6748628941,420,-5,-110,-21,-9,-5,6,1,5,1,6,-2,4,2,-6,6,0,-1,1,0,0,-4,38,1,-3,2,-21,0,-2,-1,0,-1,-1,6,-1
KR_6776944062,420,1,39,-38,1,2,0,2,-2,4,2,0,0,0,-1,2,1,2,0,2,0,2,-38,-2,-6,8,5,0,-1,-1,-1,-1,1,6,-1
KR_6743841487,420,-1,-4,32,-11,-2,2,0,-7,8,1,2,1,3,-5,5,0,1,0,1,0,-15,-2,-4,-5,9,3,0,-1,1,-1,-1,-1,2,-1
KR_6776900032,420,2,-36,3,7,1,4,5,-4,6,2,2,0,2,2,1,3,6,4,10,0,10,-5,5,-7,2,-1,0,-1,0,-1,-1,-1,0,-1
KR_6731779412,440,1,-11,-3,-2,-7,7,0,2,1,3,-1,3,2,4,5,9,0,0,0,0,10,-1,-1,-4,5,1,0,1,-1,-1,-1,-1,3,-1
KR_6777150738,420,0,46,-19,-7,0,1,1,-2,4,2,1,2,3,-5,7,2,-1,1,0,-1,-5,5,3,-8,5,-1,0,0,-1,1,0,-1,1,-1
KR_6775218551,420,-5,-72,-33,-7,-3,6,3,-3,4,1,-1,2,1,0,1,1,0,0,0,0,0,-14,-3,-1,4,0,0,-1,-1,1,1,1,4,-1
KR_6770213667,440,-1,-22,6,-6,-6,6,0,-3,3,0,-3,3,0,3,1,4,3,0,3,0,4,7,0,-7,7,1,0,0,1,1,-1,-1,1,-1
KR_6768972194,420,-1,0,22,-4,1,1,2,-6,7,1,2,1,3,-1,3,2,0,2,2,0,-4,-31,-2,-6,8,-5,0,1,1,1,1,-1,2,-1
KR_6757809413,420,-3,11,7,-5,3,1,4,3,1,4,-5,5,0,-7,10,3,1,1,2,0,-5,11,2,-6,4,-6,0,1,-1,1,1,1,2,-1
KR_6771190133,420,-1,21,7,-3,1,5,6,-4,7,3,-1,4,3,1,1,2,0,0,0,1,-6,58,5,-10,5,-26,0,1,1,-1,1,1,4,-1
KR_6769776072,420,-3,-78,10,-10,-1,3,2,2,2,4,-5,5,0,-4,4,0,-2,2,0,0,-12,9,-3,-3,6,-6,0,-1,-1,1,-1,-1,4,-1
KR_6766411429,420,-1,18,-20,-8,-1,2,1,-5,7,2,2,1,3,-3,4,1,-1,1,0,0,-15,36,-1,-6,7,5,0,1,-1,1,1,-1,3,-1
KR_6774720117,420,-4,-25,-16,-9,4,0,4,-3,6,3,-5,6,1,-4,7,3,-1,1,0,0,-5,3,-1,-2,3,-1,0,1,-1,-1,-1,-1,5,-1
KR_6740618024,420,-6,-96,-8,-8,3,1,4,-4,4,0,-2,4,2,-3,7,4,-2,3,1,0,-1,0,-1,-7,8,0,0,-1,1,-1,-1,-1,3,-1
KR_6774016589,420,0,43,5,0,3,1,4,0,2,2,5,1,6,-8,9,1,0,1,1,0,0,13,3,-6,3,-2,0,0,1,-1,1,-1,6,-1
KR_6754750970,420,0,1,8,6,1,1,2,3,1,4,-3,4,1,1,3,4,4,2,6,0,14,-15,-3,-3,6,5,0,2,-1,1,1,-1,6,-1
KR_6727872742,420,3,-15,35,4,-2,3,1,3,0,3,1,3,4,2,0,2,0,0,0,-1,2,5,4,-8,4,-3,0,0,1,-1,0,-1,2,-1
KR_6680651807,420,-5,-60,3,-8,1,1,2,-6,8,2,-2,3,1,-2,2,0,1,0,1,-1,-21,-6,-2,-6,8,2,0,0,-1,1,0,-1,6,-1
KR_6777481220,420,-2,-58,-4,-3,2,3,5,-1,3,2,0,0,0,-3,4,1,-1,2,1,0,-8,-45,0,-7,7,4,0,-1,1,1,-1,1,5,-1
KR_6776586055,420,-1,8,-9,-10,-2,6,4,0,3,3,-4,5,1,-2,6,4,-2,2,0,-4,-15,-1,-1,-7,8,1,0,0,1,-1,0,-1,1,-1
KR_6772199808,420,1,-13,-2,3,0,1,1,1,1,2,1,4,5,3,2,5,-2,2,0,0,2,-54,-4,-3,7,17,0,0,1,-1,0,1,1,-1
KR_6777569165,420,2,20,-11,0,-2,2,0,-2,4,2,3,1,4,2,0,2,-1,4,3,0,-4,-13,-2,-4,6,3,0,-1,-1,-1,-1,-1,4,-1
KR_6718629883,420,3,5,47,-5,-2,2,0,-1,1,0,3,1,4,-2,3,1,-3,3,0,-1,-6,46,0,-7,7,-19,0,0,1,-1,-1,-1,6,-1
KR_6777575964,420,-2,-29,-47,0,1,1,2,-2,3,1,0,1,1,1,1,2,0,2,2,0,2,51,1,-6,5,-31,0,-1,-1,-1,-1,1,4,-1
KR_6745947120,420,-2,-87,18,-11,-2,3,1,-8,9,1,3,3,6,-4,4,0,0,2,2,0,-19,7,0,-9,9,-7,0,1,-1,-1,1,-1,1,-1
KR_6775436147,420,-3,-40,-24,-5,-5,5,0,3,3,6,-5,5,0,3,1,4,-1,2,1,0,-4,10,0,-5,5,-1,0,1,1,1,-1,1,1,-1
KR_6743570012,420,1,-19,25,-1,0,2,2,2,4,6,0,2,2,-3,3,0,0,0,0,0,-9,6,0,-4,4,1,0,0,-1,1,1,-1,6,-1
KR_6774160221,420,-3,-31,-57,9,0,2,2,4,1,5,-1,4,3,6,1,7,0,0,0,1,17,7,7,-11,4,3,0,1,1,1,1,1,4,-1
KR_6775438860,420,-1,31,-30,-6,-1,2,1,-5,6,1,-4,5,1,4,1,5,0,0,0,0,2,1,-1,-6,7,4,0,-1,1,-1,1,-1,5,-1
KR_6771153868,420,3,-26,54,3,-2,2,0,3,1,4,3,0,3,-1,4,3,0,0,0,0,-1,121,-1,-5,6,-3,0,-2,-1,-1,-1,-1,2,-1
KR_6728085319,420,2,-25,20,-2,4,2,6,3,1,4,-1,3,2,-7,11,4,-1,2,1,0,-1,9,-1,-3,4,1,0,1,-1,-1,1,1,2,-1
KR_6777596690,420,-2,14,-31,-5,1,0,1,-7,9,2,1,1,2,1,2,3,-1,1,0,-1,-15,-6,1,-5,4,-5,0,0,-1,0,0,-1,5,-1
KR_6765686017,420,0,-15,4,-10,-1,1,0,-1,3,2,-6,8,2,-1,5,4,-1,1,0,0,-20,-11,-1,-5,6,-3,0,0,1,-1,0,-1,6,-1
KR_6777462493,420,1,-51,0,-5,1,3,4,0,2,2,-5,6,1,-1,5,4,0,1,1,0,-14,9,2,-6,4,-7,0,-2,0,-1,-1,1,0,-1
KR_6775343119,420,-2,-40,-15,1,0,1,1,0,3,3,-2,2,0,3,1,4,0,0,0,0,10,26,1,-4,3,0,0,0,-1,1,0,1,2,-1
KR_6756527762,420,-5,-12,9,-8,-3,4,1,3,5,8,-3,3,0,-4,6,2,-1,2,1,0,-8,-16,-2,-6,8,3,0,0,1,-1,0,-1,6,-1
KR_6775179513,420,0,29,-22,3,-1,2,1,1,2,3,2,2,4,2,3,5,-1,2,1,0,8,-26,-2,-4,6,4,0,-1,-1,1,-1,1,1,-1
KR_6774300188,420,1,-83,-34,-1,-5,6,1,-1,5,4,-1,3,2,4,0,4,2,0,2,0,-1,-11,0,-5,5,4,0,-1,1,1,1,-1,1,-1
KR_6751824596,420,-3,19,11,1,-2,2,0,2,2,4,-3,5,2,-1,2,1,5,0,5,0,9,15,5,-10,5,-5,0,-1,1,-1,-1,1,5,-1
KR_6773523175,420,-3,-43,-5,-7,-2,2,0,1,2,3,-5,5,0,-1,3,2,0,2,2,0,-6,-4,-1,-5,6,-5,0,-1,-1,-1,-1,-1,1,-1
KR_6722641958,420,1,16,-12,0,-1,3,2,0,3,3,0,2,2,-1,2,1,2,2,4,0,-1,17,-3,-5,8,-2,0,-1,-1,-1,-1,-1,1,-1
KR_6771510716,420,-1,-66,-9,-9,-6,6,0,-1,2,1,-2,2,0,-2,3,1,2,4,6,0,-11,60,-5,-6,11,2,0,0,1,-1,-1,-1,4,-1
KR_6768748581,420,-2,3,-16,-13,-3,4,1,5,1,6,-5,8,3,-6,7,1,-4,4,0,0,-8,6,1,-4,3,-2,0,-1,-1,1,-1,-1,1,-1
KR_6727638374,420,0,0,-4,-1,-4,5,1,6,1,7,-3,7,4,0,0,0,0,0,0,0,-1,-41,-1,-5,6,-4,0,0,0,1,1,-1,0,-1
KR_6769394807,420,-9,-81,-59,-19,-1,1,0,-8,9,1,-7,7,0,-2,4,2,-1,1,0,0,-17,-136,-3,-3,6,-2,0,-4,-1,-1,-1,-1,3,-1
KR_6773306162,440,-2,-76,-14,1,-2,3,1,1,1,2,3,0,3,-2,6,4,1,0,1,0,4,6,3,-9,6,-9,0,-1,1,1,-1,1,4,-1
KR_6756417142,420,-2,1,-24,-4,-1,3,2,-3,3,0,1,2,3,-1,5,4,0,0,0,0,3,2,-4,-5,9,1,0,-1,1,-1,-1,1,3,-1
KR_6768862625,420,-6,-53,-4,-7,-5,5,0,-1,4,3,0,2,2,-1,2,1,0,0,0,0,-4,10,2,-6,4,-9,0,0,-1,1,0,-1,5,-1
KR_6717422949,420,-2,-24,44,-5,2,2,4,1,0,1,-1,3,2,-6,6,0,-1,1,0,0,-17,4,1,-3,2,0,0,1,-1,1,1,1,2,-1
KR_6774376640,420,-3,-83,40,-11,-1,5,4,0,2,2,-6,6,0,-3,5,2,-1,2,1,-1,-17,42,2,-9,7,-2,0,-2,-1,-1,-1,-1,2,-1
KR_6776716221,420,1,12,-12,0,6,0,6,-1,3,2,-1,2,1,-5,5,0,1,1,2,0,-10,1,1,-4,3,0,0,-1,-1,1,-1,1,5,-1
KR_6774572502,420,-3,-28,-4,-12,0,1,1,-8,12,4,-6,8,2,1,3,4,1,0,1,1,-1,29,-3,-2,5,0,0,-1,0,-1,-1,1,0,-1
KR_6776593918,420,-5,-47,-31,-9,-2,2,0,-3,4,1,-3,5,2,-1,2,1,0,0,0,0,-18,-26,-5,-3,8,-2,0,0,1,1,0,1,6,-1
KR_6767805025,420,-3,-1,-28,-10,0,2,2,-1,2,1,-2,3,1,2,2,4,-9,9,0,0,-13,6,2,-6,4,2,0,1,-1,-1,1,-1,4,-1
KR_6776193365,420,0,-66,-7,-1,0,2,2,-2,2,0,-1,1,0,1,3,4,1,0,1,0,3,-1,-5,-3,8,4,0,0,1,-1,-1,-1,4,-1
KR_6750455208,420,1,42,-7,4,2,1,3,0,2,2,6,0,6,0,4,4,-4,5,1,0,3,-5,2,-7,5,-4,0,2,-1,1,-1,1,4,-1
KR_6766866780,420,-2,-36,-34,0,-2,2,0,-6,9,3,0,1,1,8,0,8,0,1,1,-1,5,-276,2,-8,6,-5,0,-1,-1,-1,-1,-1,1,-1
KR_6768600755,420,-1,-78,-24,-5,-2,4,2,-1,3,2,0,3,3,-1,1,0,-1,3,2,0,-7,-3,3,-7,4,0,0,0,-1,1,0,1,2,-1
KR_6773000210,420,1,17,-3,2,3,0,3,-2,6,4,1,0,1,0,3,3,0,0,0,0,1,-8,-2,-6,8,7,0,0,-1,1,0,1,6,-1
KR_6713994549,420,-5,-62,-18,-8,-1,2,1,-3,6,3,-3,4,1,-1,5,4,0,2,2,1,1,22,1,-8,7,-3,0,0,-1,-1,-1,1,3,-1
KR_6753498824,420,-1,-36,32,-1,6,2,8,-2,3,1,0,1,1,-3,3,0,-2,2,0,1,-3,-7,-1,-7,8,4,0,-2,1,-1,-1,1,5,-1
KR_6769905494,420,-5,6,-17,-11,1,0,1,-6,9,3,-4,7,3,-3,3,0,1,0,1,-2,-30,-25,2,-8,6,-5,0,2,-1,1,1,-1,1,-1
KR_6741684794,420,-3,-55,-8,-5,-1,5,4,-4,4,0,-1,1,0,2,0,2,-1,2,1,-1,-8,5,-4,-2,6,1,0,0,0,1,0,-1,0,-1
KR_6773878929,420,-3,-35,-15,-4,-3,4,1,-1,4,3,-4,4,0,4,1,5,0,0,0,0,0,-9,-3,-3,6,4,0,0,1,-1,-1,-1,4,-1
KR_6774285506,420,-1,-23,-44,-2,1,0,1,-1,5,4,2,1,3,-3,4,1,-1,2,1,0,-6,-24,1,-8,7,4,0,-1,1,-1,-1,1,2,-1
KR_6698443241,420,-2,-40,-7,-9,-3,4,1,0,2,2,-1,2,1,-5,7,2,0,0,0,2,-11,208,-2,-10,12,-3,0,-1,1,1,-1,1,6,-1
KR_6774414156,420,-1,5,-28,-2,-1,2,1,0,1,1,-2,2,0,1,2,3,0,2,2,1,-1,-46,-5,-3,8,3,0,1,1,1,1,1,5,-1
KR_6775677719,420,-3,-15,-8,-5,0,3,3,-3,6,3,-1,2,1,-1,3,2,0,3,3,0,0,-6,-4,-4,8,-6,0,-2,-1,1,-1,1,5,-1
KR_6776230725,420,-2,-12,8,-5,0,1,1,-3,5,2,-2,3,1,-5,8,3,5,0,5,-1,-5,9,5,-11,6,-5,0,-1,1,-1,-1,-1,2,-1
KR_6775895127,420,-1,-17,1,-1,1,2,3,1,3,4,0,1,1,-3,5,2,0,0,0,-2,-3,1,1,-7,6,1,0,1,-1,1,1,-1,2,-1
KR_6645312092,420,1,17,-20,-1,4,0,4,-1,3,2,-4,5,1,-1,3,2,1,1,2,-1,-7,7,3,-9,6,-3,0,0,1,-1,0,-1,4,-1
KR_6753753602,420,-4,-80,-19,-8,1,1,2,-3,7,4,-5,6,1,-2,2,0,1,1,2,0,-11,-30,0,-5,5,-6,0,-3,-1,-1,-1,-1,1,-1
KR_6721172277,420,-4,-22,-8,-7,-1,1,0,-2,6,4,0,3,3,-5,6,1,1,1,2,0,-10,12,3,-9,6,-4,0,-1,-1,-1,-1,1,1,-1
KR_6736458315,420,-1,-13,4,-1,1,1,2,-2,5,3,-2,3,1,-1,3,2,3,0,3,0,0,120,0,-6,6,-2,0,0,1,1,0,-1,4,-1
KR_6749486112,420,-6,-27,-4,-13,-3,4,1,-6,6,0,-2,3,1,0,2,2,-2,4,2,0,-10,-13,-8,-3,11,-2,0,-3,-1,-1,-1,1,4,-1
KR_6736919123,420,-4,16,-25,-6,-2,3,1,-7,7,0,-4,6,2,4,1,5,3,0,3,-1,-6,-60,-1,-5,6,8,0,-2,-1,1,-1,-1,6,-1
KR_6775597726,420,-1,-3,-8,-8,2,0,2,-2,2,0,-5,6,1,-5,7,2,2,0,2,0,-14,18,-2,-3,5,1,0,0,1,-1,0,1,2,-1
KR_6773242801,440,-3,-17,18,-11,-3,4,1,-4,5,1,-6,6,0,1,1,2,1,0,1,0,-9,2,-1,-2,3,-3,0,-1,-1,-1,-1,-1,5,-1
KR_6680018094,420,-4,-51,3,-1,0,1,1,2,2,4,-6,6,0,2,2,4,1,0,1,0,3,8,2,-7,5,4,0,0,1,-1,-1,-1,3,-1
KR_6752981245,440,-2,-50,20,-2,-5,6,1,2,1,3,4,1,5,-2,3,1,-1,1,0,0,4,-6,-1,-5,6,-1,0,-1,-1,1,1,-1,5,-1
KR_6736380716,440,-7,-133,-20,-16,-10,13,3,0,2,2,-2,2,0,-4,6,2,0,1,1,0,-9,3,0,-3,3,2,0,0,0,-1,-1,-1,0,-1
KR_6777226733,420,2,-17,-4,3,4,2,6,2,0,2,-2,7,5,1,2,3,-2,3,1,0,-3,-20,2,-13,11,0,0,1,1,1,1,-1,2,-1
KR_6774901835,420,-2,4,-2,-7,-3,3,0,-2,3,1,-3,3,0,2,1,3,-1,3,2,0,-4,-1,2,-7,5,3,0,-2,1,-1,-1,-1,6,-1
KR_6753678584,420,1,2,27,-10,-2,4,2,1,0,1,-8,8,0,-1,2,1,0,1,1,0,-14,-124,-5,-5,10,1,0,-1,-1,-1,-1,-1,3,-1
KR_6728134118,420,-2,-58,-7,-5,-7,7,0,-2,6,4,3,0,3,1,2,3,0,0,0,0,-7,-103,1,-5,4,-1,0,-1,1,-1,-1,-1,6,-1
KR_6776780226,420,-4,-35,-12,-9,-1,2,1,-1,4,3,-3,5,2,-2,5,3,-2,3,1,0,6,-9,2,-8,6,-2,0,0,1,-1,-1,-1,1,-1
KR_6731715265,420,-2,-44,-3,-4,0,2,2,-1,3,2,1,2,3,-2,6,4,-2,2,0,0,-11,4,2,-7,5,-1,0,1,0,1,1,-1,0,-1
KR_6771106302,420,-2,-20,-32,2,-2,4,2,4,0,4,1,2,3,-2,3,1,1,0,1,0,8,-168,0,-5,5,2,0,-1,-1,-1,-1,1,3,-1
KR_6773337430,420,2,47,23,3,3,0,3,0,3,3,4,0,4,-5,8,3,1,1,2,0,-3,-28,-1,-5,6,10,0,1,1,1,1,1,5,-1
KR_6730550561,420,-2,-78,-25,-2,1,3,4,0,2,2,-5,6,1,3,1,4,-1,1,0,0,5,1,-1,-4,5,-4,0,-1,-1,-1,-1,-1,1,-1
KR_6774126354,420,-3,-47,-36,-4,0,2,2,0,4,4,4,0,4,-1,2,1,-7,8,1,0,-8,-5,4,-9,5,5,0,-1,-1,-1,-1,-1,6,-1
KR_6770977253,420,2,-5,7,4,2,3,5,-1,2,1,2,1,3,2,0,2,-1,1,0,0,7,-7,3,-9,6,2,0,0,1,-1,-1,1,5,-1
KR_6666211101,420,0,-33,15,4,-3,3,0,6,2,8,-2,2,0,3,2,5,0,0,0,0,18,-4,-1,-5,6,-2,0,1,1,-1,1,-1,3,-1
KR_6745533653,420,-3,-38,8,-3,-3,3,0,1,2,3,2,2,4,-2,2,0,-1,1,0,0,-5,15,1,-5,4,0,0,0,-1,1,-1,1,2,-1
KR_6734705059,440,-3,-43,-12,-13,0,1,1,-9,10,1,-2,2,0,1,1,2,-3,5,2,1,-14,-9,-1,-5,6,2,0,-1,1,1,-1,1,6,-1
KR_6774029818,420,-1,-56,-19,-3,1,1,2,-5,5,0,0,3,3,1,3,4,0,0,0,0,-3,-2,-5,-4,9,3,0,-1,-1,-1,-1,-1,5,-1
KR_6673548557,420,-3,-62,-16,-5,3,1,4,-4,4,0,-3,4,1,-1,2,1,0,1,1,0,-9,-11,-3,-2,5,0,0,0,1,-1,-1,-1,5,-1
KR_6774586705,420,-2,47,8,-5,2,1,3,-6,9,3,0,3,3,-2,4,2,1,0,1,-1,-16,4,4,-9,5,3,0,0,-1,1,0,-1,1,-1
KR_6723316933,420,3,2,26,4,-3,6,3,1,3,4,5,1,6,1,3,4,0,0,0,0,6,19,-6,-1,7,5,0,2,-1,1,1,-1,5,-1
KR_6765809362,420,-2,-64,-28,-6,1,0,1,-2,3,1,-2,2,0,-3,6,3,0,0,0,0,-3,9,-3,-5,8,-2,0,0,-1,-1,0,1,6,-1
KR_6744424543,420,-2,-33,0,-7,2,1,3,-3,4,1,-6,6,0,0,1,1,0,1,1,0,-11,-40,-1,-6,7,-6,0,-1,-1,1,-1,-1,2,-1
KR_6772879906,420,3,-3,21,7,2,0,2,0,2,2,2,1,3,2,1,3,1,1,2,0,18,6,8,-13,5,7,0,1,-1,1,1,1,1,-1
KR_6774803708,440,-3,-1,-24,-5,-2,2,0,0,2,2,-4,4,0,0,2,2,1,1,2,0,1,-6,2,-6,4,1,0,0,-1,-1,-1,-1,3,-1
KR_6777539829,420,0,-2,14,-11,-1,2,1,-3,5,2,-1,2,1,-5,6,1,-1,1,0,0,-18,-14,2,-7,5,-2,0,-1,-1,1,1,-1,3,-1
KR_6773462655,420,-2,38,-4,-6,0,3,3,1,1,2,-5,6,1,-2,2,0,0,0,0,0,-4,6,5,-9,4,-3,0,1,-1,1,1,-1,4,-1
KR_6775374942,420,-2,-7,6,-5,-3,3,0,-1,3,2,2,0,2,-5,7,2,2,0,2,0,-14,-8,-2,-5,7,-1,0,-1,-1,1,-1,1,6,-1
KR_6775165122,420,-1,24,-4,-7,5,1,6,-4,8,4,-4,7,3,-3,6,3,-1,3,2,-3,-13,-8,4,-10,6,-2,0,0,-1,-1,-1,-1,3,-1
KR_6777016370,420,4,-24,-24,9,2,2,4,5,1,6,0,2,2,0,2,2,2,1,3,-1,14,-32,0,-4,4,8,0,0,0,-1,-1,-1,0,-1
KR_6774193251,420,-1,-39,12,-5,-5,6,1,4,1,5,1,2,3,0,3,3,-5,6,1,0,-5,-8,-4,0,4,-3,0,-1,-1,-1,-1,-1,4,-1
KR_6719758004,420,-4,-44,4,-4,1,1,2,-2,4,2,-2,3,1,-2,3,1,1,2,3,0,-13,-32,-3,-6,9,-2,0,-1,-1,-1,-1,-1,1,-1
KR_6731107010,420,-1,-19,-19,-4,-2,2,0,-2,4,2,-1,2,1,2,2,4,-1,3,2,0,-11,5,-1,-7,8,-1,0,-1,-1,1,-1,1,1,-1
KR_6712719653,420,-2,-18,-20,-3,1,1,2,-9,11,2,6,3,9,-1,1,0,0,0,0,0,-8,-4,0,-4,4,1,0,1,-1,1,-1,1,1,-1
KR_6767690455,420,1,62,0,8,-3,3,0,2,3,5,7,0,7,1,1,2,1,0,1,2,5,100,4,-8,4,2,0,0,1,1,0,1,5,-1
KR_6736593099,420,-7,-87,3,-19,-6,6,0,-8,10,2,0,1,1,-3,5,2,-2,2,0,0,-15,-6,-2,-6,8,3,0,-1,-1,-1,-1,-1,5,-1
KR_6749389810,420,-2,-38,-24,-10,-3,3,0,0,1,1,-2,4,2,-5,5,0,0,0,0,0,-11,2,0,-7,7,3,0,-1,-1,-1,-1,-1,3,-1
KR_6758055364,420,-2,2,-16,-1,1,2,3,1,0,1,-1,2,1,0,1,1,-2,2,0,0,-3,1,2,-7,5,1,0,-1,1,-1,-1,-1,2,-1
KR_6777170216,420,2,-26,4,8,3,1,4,0,0,0,8,2,10,-3,5,2,0,0,0,0,3,4,1,-9,8,4,0,-1,-1,1,-1,1,6,-1
KR_6707193425,420,-2,-36,-19,-8,2,0,2,-2,4,2,-3,6,3,-5,7,2,0,0,0,0,-12,-1,0,-4,4,1,0,-3,-1,-1,-1,-1,3,-1
KR_6777072283,420,-2,-38,-29,0,1,1,2,-3,7,4,1,6,7,0,2,2,1,0,1,1,7,21,7,-8,1,-8,0,-1,-1,-1,-1,1,5,-1
KR_6766832186,420,0,-5,-7,-4,1,1,2,-3,7,4,1,1,2,-5,5,0,2,1,3,0,-15,-7,-3,-4,7,1,0,1,-1,1,1,1,6,-1
KR_6777016417,420,-6,-48,-12,-13,-4,5,1,-2,2,0,-5,5,0,-1,3,2,-1,3,2,0,-14,3,-5,-3,8,-2,0,-2,-1,-1,-1,1,3,-1
KR_6769572669,420,1,-28,36,1,-1,4,3,2,0,2,2,0,2,-2,3,1,0,1,1,0,-2,-15,-10,-3,13,8,0,0,-1,1,1,-1,4,-1
KR_6737634428,420,1,-58,-4,-7,-5,5,0,-4,7,3,-2,3,1,1,1,2,3,1,4,-1,2,4,-2,-3,5,-2,0,0,1,-1,-1,-1,2,-1
KR_6770037880,420,-1,0,-10,0,-2,2,0,0,3,3,0,3,3,3,1,4,-1,1,0,0,0,-6,-1,-5,6,2,0,1,-1,1,1,1,6,-1
KR_6766681290,420,1,45,4,8,2,2,4,3,4,7,0,3,3,3,1,4,0,1,1,0,14,18,1,-9,8,5,0,0,1,-1,-1,-1,3,-1
KR_6706293784,420,-5,-63,-38,-12,-1,1,0,-2,4,2,-6,7,1,-5,8,3,2,1,3,-1,-8,37,-3,-4,7,-3,0,-4,-1,-1,-1,-1,5,-1
KR_6736760696,420,-2,-67,-29,-5,-1,2,1,-2,5,3,-4,4,0,2,1,3,0,0,0,0,-7,-17,5,-10,5,-2,0,1,1,1,1,1,5,-1
KR_6741252612,420,-5,-90,1,-8,-4,6,2,-3,4,1,-3,5,2,3,1,4,-1,2,1,0,-8,1,0,-9,9,-6,0,-1,-1,-1,-1,-1,3,-1
KR_6766229871,440,0,-48,16,-1,-3,4,1,2,1,3,0,1,1,0,2,2,0,1,1,0,-3,-4,3,-8,5,-3,0,-2,1,-1,-1,1,6,-1
KR_6714402877,420,-5,-96,-56,-14,1,3,4,-10,10,0,-3,5,2,-1,5,4,-1,1,0,-1,-9,-4,0,-5,5,1,0,-1,1,-1,-1,-1,6,-1
KR_6766436353,420,-1,1,4,-7,-3,3,0,-5,6,1,-1,1,0,1,2,3,1,0,1,0,-8,35,3,-9,6,-6,0,0,-1,-1,-1,-1,6,-1
KR_6775478165,420,-5,-128,-14,-9,-2,3,1,-1,1,0,-1,1,0,0,2,2,-5,5,0,0,-11,4,1,-6,5,-4,0,-2,-1,1,-1,-1,1,-1
KR_6739083144,420,0,10,19,-6,2,1,3,-4,5,1,-2,3,1,-2,2,0,0,3,3,0,-7,13,-4,-5,9,-5,0,0,-1,1,0,-1,3,-1
KR_6651142438,420,-1,-39,-25,-10,-1,1,0,-2,5,3,-3,5,2,-3,5,2,-1,1,0,-4,-6,-1,-4,-1,5,3,0,-1,-1,-1,-1,-1,3,-1
KR_6770470745,420,-2,15,24,-4,0,2,2,-4,10,6,0,3,3,0,3,3,0,3,3,0,-2,-34,1,-8,7,-2,0,-1,-1,-1,-1,1,4,-1
KR_6770164486,420,1,64,-23,1,-1,2,1,-6,7,1,0,1,1,8,1,9,0,0,0,0,5,15,1,-7,6,2,0,1,0,1,1,-1,0,-1
KR_6770629223,420,-1,20,-39,4,-1,3,2,3,0,3,-3,6,3,4,1,5,1,0,1,1,16,8,0,-6,6,-2,0,0,-1,1,0,1,6,-1
KR_6740557497,420,-3,-12,-8,-6,1,0,1,-5,5,0,-6,6,0,4,1,5,0,0,0,0,-1,-13,-9,-4,13,8,0,0,1,-1,-1,1,1,-1
KR_6726475367,440,-1,-5,-6,7,4,2,6,2,1,3,4,1,5,-3,3,0,0,0,0,1,12,2,5,-10,5,2,0,1,-1,-1,1,1,5,-1
KR_6760555710,420,0,0,-5,-4,-2,2,0,0,3,3,-2,3,1,-1,4,3,1,0,1,0,-8,-11,-2,-5,7,6,0,0,-1,1,0,-1,6,-1
KR_6772788791,420,-3,-62,-4,-8,-7,7,0,-3,6,3,0,2,2,4,2,6,-2,2,0,-1,-3,-29,4,-7,3,-3,0,-1,0,-1,-1,-1,0,-1
KR_6732233829,420,-2,4,-26,-6,2,0,2,0,1,1,-2,3,1,-3,6,3,-3,3,0,1,-17,12,2,-7,5,-5,0,-1,-1,-1,-1,1,4,-1
KR_6741322778,420,-5,-50,-28,-18,-3,3,0,-9,11,2,0,1,1,-3,4,1,-3,3,0,-1,-22,-5,0,-8,8,1,0,-3,-1,-1,-1,-1,4,-1
KR_6768474882,420,-1,18,18,-3,1,0,1,2,1,3,-3,7,4,-2,3,1,-1,3,2,1,1,-4,-1,-5,6,-5,0,-1,1,-1,-1,1,5,-1
KR_6774102777,420,-3,9,2,-8,4,1,5,-10,10,0,-4,4,0,-1,1,0,3,0,3,1,-4,40,1,-3,2,-1,0,-1,1,-1,-1,1,3,-1
KR_6760484611,420,0,58,-25,-6,-3,4,1,-2,3,1,-2,4,2,4,1,5,-3,4,1,0,-7,-26,-1,-6,7,2,0,0,1,-1,0,-1,6,-1
KR_6777200767,420,0,-14,20,-6,-1,2,1,1,2,3,-3,4,1,-2,6,4,-1,1,0,0,-8,2,-4,-10,14,2,0,0,1,1,0,-1,6,-1
KR_6773222063,420,-3,5,-8,-2,1,0,1,0,6,6,0,2,2,-2,6,4,-1,1,0,0,-2,-6,1,-9,8,-1,0,0,-1,1,0,-1,6,-1
KR_6749948819,420,-1,-60,-6,11,-3,4,1,3,0,3,9,1,10,-1,4,3,3,0,3,0,12,-12,2,-7,5,-1,0,0,1,1,-1,1,5,-1
KR_6772416608,420,2,-19,-12,-1,1,1,2,2,2,4,1,3,4,-3,3,0,-2,2,0,0,1,39,3,-7,4,-17,0,-1,-1,1,-1,-1,2,-1
KR_6775232793,420,1,29,-1,2,1,0,1,4,0,4,2,0,2,-4,5,1,-1,2,1,0,-7,-18,1,-7,6,7,0,0,1,1,-1,-1,3,-1
KR_6772211984,420,-1,-21,-21,-5,-3,5,2,-2,2,0,-1,3,2,1,4,5,0,0,0,-1,1,-4,-1,-3,4,3,0,-1,1,-1,-1,-1,6,-1
KR_6768413718,420,-3,-25,13,-8,2,1,3,-3,5,2,1,0,1,-5,5,0,-3,3,0,0,-16,1,-2,-4,6,-4,0,-2,-1,-1,-1,-1,5,-1
KR_6728420264,420,-3,-34,-31,-5,-1,2,1,-6,7,1,-2,4,2,8,0,8,-4,5,1,0,2,-2,-4,-3,7,-2,0,1,1,-1,1,1,3,-1
KR_6756460021,420,-2,-74,15,-5,-1,4,3,-3,3,0,2,1,3,-3,4,1,0,0,0,0,-6,15,-2,-6,8,4,0,0,-1,1,-1,1,4,-1
KR_6741590618,420,-3,-35,-21,2,-3,4,1,3,0,3,0,2,2,1,4,5,1,0,1,-1,8,3,1,-6,5,1,0,-1,-1,-1,-1,-1,5,-1
KR_6758748457,420,-1,-8,34,0,-1,2,1,3,4,7,-1,4,3,-2,6,4,1,1,2,0,-2,16,-1,-7,8,3,0,1,1,-1,1,1,6,-1
KR_6774104130,420,0,-26,-42,1,-2,3,1,5,1,6,-4,4,0,3,2,5,-1,2,1,0,8,-2,4,-9,5,-1,0,0,-1,1,0,1,5,-1
KR_6728030921,420,1,33,6,-7,-7,8,1,2,3,5,-3,3,0,0,2,2,1,0,1,0,-5,-16,-2,-5,7,1,0,0,-1,-1,-1,-1,1,-1
KR_6774295763,420,-3,-49,-15,-13,-4,4,0,-8,12,4,-2,2,0,1,3,4,0,1,1,-1,-15,1,-2,-6,8,-4,0,0,-1,-1,-1,-1,3,-1
KR_6666999410,420,0,40,12,-6,1,3,4,-1,5,4,-1,2,1,-5,7,2,0,0,0,1,-9,-2,0,-7,7,-1,0,0,-1,-1,-1,1,1,-1
KR_6776318482,420,-4,-7,8,-19,-2,4,2,-2,4,2,-4,6,2,-9,11,2,-2,2,0,0,-18,3,0,-4,4,-1,0,-3,-1,-1,-1,-1,3,-1
KR_6776183272,420,-6,-49,-4,-18,-2,2,0,-3,3,0,-8,9,1,-5,6,1,0,0,0,0,-16,16,2,-5,3,-7,0,-2,-1,-1,-1,-1,6,-1
KR_6777637729,420,0,1,-16,0,2,0,2,-2,2,0,4,0,4,-3,4,1,-1,2,1,0,-5,-28,-1,-5,6,2,0,0,0,1,0,1,0,-1
KR_6760812120,420,-2,25,-15,-8,2,1,3,2,2,4,-4,5,1,-4,5,1,-4,4,0,0,-8,90,2,-8,6,-1,0,0,-1,1,0,-1,2,-1
KR_6773427603,420,1,28,-10,2,2,1,3,-1,7,6,1,2,3,0,1,1,0,0,0,0,-8,-10,1,-7,6,6,0,0,-1,1,1,1,1,-1
KR_6772014882,420,-6,-55,-20,-17,-2,2,0,-5,9,4,-5,6,1,-3,3,0,-2,4,2,0,-10,-13,-5,-3,8,0,0,-1,-1,-1,-1,1,6,-1
KR_6774935124,440,-6,-40,-50,-19,-1,2,1,-4,6,2,-4,4,0,-2,4,2,-8,8,0,0,-12,-1,6,-7,1,0,0,-2,-1,-1,-1,-1,3,-1
KR_6777187981,420,-6,-57,19,-20,-1,2,1,-9,10,1,-7,9,2,-3,6,3,0,1,1,-1,-15,2,3,-5,2,-5,0,-1,1,-1,-1,-1,2,-1
KR_6777872318,420,-6,-28,-16,-11,0,1,1,1,0,1,-2,2,0,-4,6,2,-6,6,0,0,-18,6,-2,-2,4,-3,0,-1,-1,-1,-1,-1,4,-1
KR_6736303677,420,-4,-107,-45,-18,0,2,2,-5,7,2,-5,5,0,-7,7,0,-1,3,2,0,-19,28,-4,-2,6,0,0,-2,-1,-1,-1,-1,4,-1
KR_6717891338,420,-2,-33,-18,0,-1,3,2,-2,3,1,3,0,3,1,3,4,-1,1,0,0,11,-14,-1,-5,6,5,0,0,1,-1,-1,-1,5,-1
KR_6775139784,420,1,-18,-15,4,1,0,1,1,0,1,-3,4,1,5,0,5,0,0,0,0,4,-36,-2,-6,8,19,0,-1,1,-1,-1,1,6,-1
KR_6772726949,420,2,22,-9,2,2,0,2,-1,4,3,1,1,2,-1,1,0,1,1,2,0,-1,6,-1,-2,3,-1,0,1,1,-1,-1,-1,1,-1
KR_6765119677,420,0,-9,32,-5,-10,11,1,0,1,1,0,1,1,3,1,4,2,1,3,-2,6,-15,-1,-7,8,5,0,0,1,-1,1,-1,4,-1
KR_6743231464,420,-4,-62,1,-18,-5,5,0,-6,9,3,-3,4,1,-4,6,2,0,0,0,-1,-20,-3,-5,-3,8,-4,0,-2,-1,-1,-1,-1,5,-1
KR_6740608032,420,-2,-34,3,-7,2,1,3,0,7,7,-8,8,0,-1,4,3,0,1,1,0,-13,1,3,-9,6,-1,0,0,-1,1,0,-1,2,-1
KR_6767290839,420,-3,-14,-20,-7,3,2,5,-2,3,1,-5,5,0,-2,2,0,-1,1,0,0,-6,0,0,-8,8,-6,0,0,-1,1,1,1,1,-1
KR_6775269768,440,-2,-71,-16,-7,3,1,4,-4,4,0,1,2,3,-7,8,1,0,0,0,0,0,11,1,-3,2,0,0,-1,1,-1,-1,-1,1,-1
KR_6773864954,420,-2,-19,-24,-14,0,1,1,-1,2,1,-4,5,1,-8,9,1,-1,1,0,-1,-9,-41,-5,-4,9,-2,0,-1,-1,1,-1,-1,3,-1
KR_6775796469,420,-4,-55,-16,-18,-6,6,0,-4,9,5,-1,1,0,-3,5,2,-4,4,0,-4,-22,-2,-3,-3,6,-1,0,-3,1,-1,-1,-1,2,-1
KR_6774024954,420,0,-14,-4,-2,-2,3,1,-1,5,4,-1,3,2,2,4,6,0,0,0,0,0,7,2,-7,5,-2,0,0,-1,-1,-1,-1,3,-1
KR_6776647243,420,0,8,26,-3,-5,5,0,-1,2,1,-1,3,2,4,0,4,0,2,2,0,4,-4,1,-6,5,-3,0,-1,1,-1,1,1,5,-1
KR_6761082597,420,-5,-13,4,-8,-1,2,1,-3,4,1,-1,1,0,0,1,1,-3,3,0,0,-14,-50,-3,-3,6,5,0,-1,-1,-1,-1,1,5,-1
KR_6750888002,420,-1,-11,-20,-2,-2,3,1,2,2,4,-1,6,5,0,3,3,-1,4,3,1,7,-2,1,-6,5,0,0,-1,-1,-1,1,1,5,-1
KR_6774618604,420,-3,-61,16,-4,-4,6,2,1,3,4,0,0,0,-1,1,0,0,0,0,0,-2,-2,0,-6,6,4,0,-1,1,-1,-1,-1,3,-1
KR_6775412198,420,-3,-61,-4,-11,-4,4,0,3,1,4,-3,5,2,-5,7,2,-2,3,1,0,0,-9,-6,-2,8,-2,0,-2,-1,-1,-1,1,4,-1
KR_6772179888,420,-2,-103,0,-4,0,0,0,-1,1,0,-1,3,2,-1,4,3,-1,1,0,1,-3,3,3,-9,6,-1,0,-2,-1,-1,-1,1,5,-1
KR_6765054988,420,0,-17,23,0,0,1,1,4,1,5,-1,5,4,-2,4,2,-1,1,0,0,-5,-15,1,-6,5,7,0,-1,1,1,-1,1,5,-1
KR_6759254001,420,-1,-29,15,-8,-2,5,3,-1,4,3,-6,8,2,1,0,1,0,0,0,-1,-5,-4,0,-6,6,-4,0,-1,-1,-1,-1,-1,5,-1
KR_6775813554,420,-1,-31,-12,-4,-2,3,1,-1,3,2,-2,4,2,3,0,3,-2,2,0,0,1,-143,-7,-4,11,2,0,1,1,-1,1,-1,3,-1
KR_6775518698,420,-2,-44,4,4,3,1,4,0,2,2,2,1,3,0,5,5,-1,2,1,0,8,3,-4,-4,8,2,0,0,1,-1,-1,1,6,-1
KR_6698554126,420,0,18,29,-9,0,2,2,-3,4,1,-2,3,1,-4,7,3,0,0,0,0,-19,216,1,-7,6,-8,0,-1,-1,-1,-1,-1,4,-1
KR_6774611865,420,-2,-12,-16,-12,1,3,4,-3,9,6,-3,5,2,-6,6,0,-1,1,0,0,-20,-6,-2,-5,7,-4,0,-2,-1,-1,-1,-1,3,-1
KR_6723388679,420,-6,-35,-8,-11,-3,6,3,-1,2,1,-6,6,0,1,4,5,-2,2,0,0,-5,27,-2,-4,6,-1,0,-1,-1,-1,-1,1,2,-1
KR_6773326745,420,-2,-10,0,-8,0,0,0,1,2,3,-2,2,0,-3,3,0,-4,4,0,0,-16,-20,6,-11,5,-2,0,0,-1,1,0,1,3,-1
KR_6768005571,420,1,31,-29,2,-3,4,1,4,1,5,1,3,4,-2,5,3,2,1,3,1,9,12,3,-6,3,-4,0,0,-1,-1,-1,1,1,-1
KR_6736117757,420,0,36,-26,8,-3,4,1,7,1,8,-1,3,2,5,1,6,0,3,3,0,16,8,7,-9,2,4,0,0,1,-1,-1,1,2,-1
KR_6773987113,420,2,-8,53,-3,-3,5,2,1,7,8,0,2,2,1,1,2,-2,3,1,0,-1,-11,7,-10,3,-1,0,-2,1,1,-1,-1,4,-1
KR_6754970006,420,-1,27,-30,-2,0,2,2,-6,6,0,2,0,2,2,0,2,0,0,0,0,-5,-33,-1,-4,5,6,0,0,-1,-1,0,1,6,-1
KR_6763330835,420,-1,-59,28,0,1,1,2,-1,2,1,3,2,5,-1,3,2,-2,3,1,0,2,2,5,-8,3,-5,0,-1,1,-1,-1,-1,6,-1
KR_6774330518,420,-2,1,-1,-8,-1,4,3,-1,2,1,-2,4,2,-3,4,1,-1,1,0,-1,-9,-1,-2,-2,4,0,0,0,-1,-1,0,-1,4,-1
KR_6777779649,420,2,-2,-16,-7,-2,4,2,-2,5,3,-4,6,2,3,0,3,-2,3,1,0,-4,20,5,-9,4,-5,0,-1,1,-1,-1,-1,3,-1
KR_6737329610,420,-5,-104,-24,-8,-1,1,0,-2,3,1,3,1,4,-11,11,0,3,1,4,-2,-3,193,-1,-4,5,2,0,-2,-1,-1,-1,-1,3,-1
KR_6773987059,440,0,-30,-4,0,0,1,1,0,1,1,-2,5,3,-1,4,3,3,0,3,0,4,-25,-1,-5,6,4,0,0,-1,1,1,-1,2,-1
KR_6741537142,420,-4,-85,16,-5,0,2,2,-2,2,0,0,2,2,-2,5,3,-1,2,1,0,-2,-2,-2,-4,6,-3,0,-2,1,-1,-1,-1,1,-1
KR_6767205708,420,-2,-82,-38,-7,2,1,3,1,1,2,-4,5,1,-1,3,2,-5,5,0,0,-9,-1,7,-9,2,-5,0,0,-1,-1,-1,-1,3,-1
KR_6756287960,420,-1,-2,-14,2,-1,2,1,0,2,2,-3,3,0,3,0,3,3,2,5,0,9,8,-1,-5,6,0,0,-1,1,-1,-1,1,6,-1
KR_6759322971,440,1,5,18,-6,1,1,2,-3,4,1,0,1,1,-2,4,2,-2,4,2,0,-12,17,-1,-2,3,1,0,0,-1,1,-1,-1,2,-1
KR_6731125514,420,-3,24,0,-9,-2,3,1,-2,2,0,-3,5,2,-2,3,1,0,1,1,-1,-16,137,2,-6,4,-5,0,0,1,-1,0,-1,6,-1
KR_6777828553,420,-2,-63,-16,-11,0,1,1,-3,8,5,-8,9,1,1,4,5,-1,1,0,0,-12,7,4,-8,4,0,0,-3,-1,-1,-1,-1,5,-1
KR_6768666375,420,-2,-21,-7,-2,3,2,5,0,4,4,-1,2,1,-1,2,1,-3,3,0,0,-5,-3,-2,-4,6,0,0,0,-1,-1,-1,1,3,-1
KR_6727988444,420,1,-3,-8,1,-8,8,0,3,3,6,2,2,4,3,0,3,1,1,2,0,12,16,-8,-5,13,7,0,-1,-1,1,-1,-1,2,-1
KR_6770821249,420,2,-9,20,0,-2,2,0,1,6,7,6,1,7,-4,6,2,-1,2,1,0,-3,-22,2,-11,9,2,0,-1,1,1,-1,1,5,-1
KR_6762245426,420,0,31,8,0,-6,6,0,1,2,3,4,1,5,0,5,5,1,0,1,0,9,-2,-1,-6,7,3,0,-1,1,1,-1,1,1,-1
KR_6762831957,420,-3,-91,-8,-3,8,0,8,-6,9,3,0,4,4,-2,3,1,-3,5,2,1,6,-9,0,-4,4,20,0,-1,-1,1,-1,1,5,-1
KR_6771182814,420,-3,-54,-12,-10,-4,4,0,1,2,3,1,2,3,-8,11,3,0,3,3,0,-7,-18,-6,-4,10,-1,0,0,-1,1,1,1,3,-1
KR_6772433856,420,-3,-20,4,-12,-1,2,1,-3,5,2,-3,4,1,-2,3,1,-3,3,0,0,-21,1,-1,-6,7,-2,0,-1,-1,-1,-1,-1,6,-1
KR_6737384808,420,-1,21,1,-6,-2,2,0,2,1,3,-3,6,3,-3,4,1,0,3,3,0,-7,-32,-7,-2,9,1,0,-1,-1,-1,-1,1,3,-1
KR_6739079778,420,0,-47,0,-3,-2,3,1,1,6,7,4,1,5,-5,7,2,-1,1,0,0,-6,40,6,-10,4,-5,0,1,-1,-1,1,-1,2,-1
KR_6768050963,440,0,35,16,-2,-5,5,0,3,0,3,1,1,2,-1,3,2,0,1,1,1,-5,10,-5,-2,7,-1,0,0,1,1,0,1,5,-1
KR_6748160314,420,-5,-89,31,-8,2,1,3,-9,12,3,-6,7,1,5,0,5,0,3,3,1,-14,25,1,-6,5,-2,0,-1,-1,1,-1,1,6,-1
KR_6747060946,420,-2,-56,13,-6,2,0,2,0,1,1,0,1,1,-7,7,0,-1,3,2,0,-9,5,5,-7,2,-5,0,-1,-1,1,-1,-1,6,-1
KR_6771795189,440,-2,-21,-12,-4,1,0,1,-4,4,0,1,0,1,0,0,0,-2,2,0,0,-2,6,0,-7,7,-2,0,-1,-1,-1,-1,-1,2,-1
KR_6748036981,420,-1,-27,21,-1,2,0,2,1,4,5,-1,1,0,-2,3,1,-1,1,0,0,-5,4,-2,-5,7,1,0,0,-1,0,0,1,6,-1
KR_6772526088,420,2,10,-30,0,0,3,3,1,3,4,0,3,3,0,1,1,-1,2,1,0,5,30,-5,-3,8,5,0,1,-1,1,-1,1,1,-1
KR_6747149544,420,-3,-43,-9,-7,-2,3,1,-4,4,0,1,2,3,-4,7,3,2,2,4,0,-3,-6,-6,-4,10,4,0,-1,1,-1,-1,1,5,-1
KR_6682795565,420,-2,17,-10,-6,-1,1,0,-3,4,1,-2,3,1,-1,3,2,1,0,1,0,-13,5,2,-9,7,-2,0,0,-1,1,0,1,2,-1
KR_6727953348,420,-4,-5,-4,-9,0,3,3,2,5,7,-4,4,0,-3,4,1,-4,4,0,0,-14,-16,0,-7,7,-5,0,-1,-1,-1,-1,1,2,-1
KR_6770235192,420,0,-50,39,-3,-4,5,1,0,2,2,-4,5,1,5,2,7,0,0,0,0,0,0,-1,-4,5,-1,0,1,1,-1,-1,1,3,-1
KR_6734957841,420,-8,-102,-52,-12,-5,5,0,-3,3,0,-1,3,2,-3,3,0,0,1,1,0,-13,-12,-6,0,6,-2,0,-4,-1,1,-1,-1,1,-1
KR_6774990629,440,-1,49,28,-3,-2,5,3,-4,5,1,8,1,9,-2,2,0,-3,3,0,0,-11,2,3,-6,3,0,0,0,-1,-1,1,1,6,-1
KR_6735931897,420,-4,-38,-23,-7,0,1,1,-6,6,0,-1,3,2,-1,6,5,1,0,1,0,-5,2,1,-8,7,1,0,-1,-1,1,-1,-1,4,-1
KR_6772447867,420,-4,-33,-8,1,4,1,5,0,3,3,0,3,3,-3,3,0,0,1,1,0,5,-4,3,-7,4,2,0,0,-1,1,0,-1,6,-1
KR_6768494736,420,-1,-9,-2,-9,1,2,3,-5,5,0,-1,1,0,-5,5,0,1,0,1,0,-17,-1,1,-8,7,-3,0,-1,1,-1,1,1,4,-1
KR_6701835477,420,4,25,10,10,-1,3,2,0,2,2,0,2,2,8,1,9,3,2,5,0,17,9,-2,-5,7,0,0,2,1,-1,1,1,3,-1
KR_6773895052,420,-4,-42,-16,-12,0,1,1,-5,6,1,1,2,3,-5,5,0,-3,3,0,0,-25,-8,1,-8,7,0,0,-1,-1,-1,-1,-1,4,-1
KR_6775310820,420,0,-28,18,2,-2,2,0,0,2,2,-3,6,3,0,1,1,7,0,7,-2,-2,9,4,-10,6,1,0,0,1,1,-1,-1,4,-1
KR_6764613414,420,-1,-45,-16,-1,-2,3,1,2,1,3,0,2,2,-2,4,2,1,1,2,1,-2,115,0,-7,7,-1,0,-1,-1,-1,-1,1,5,-1
KR_6776849541,420,-1,8,4,-5,-1,1,0,-4,7,3,-1,2,1,1,1,2,0,0,0,0,-1,33,-2,-5,7,-3,0,-1,-1,1,-1,-1,2,-1
KR_6729748957,420,-2,-1,-15,-3,-1,1,0,0,4,4,0,5,5,-2,2,0,0,5,5,0,-9,1,-3,-4,7,-2,0,-2,1,-1,-1,-1,5,-1
KR_6771064343,420,1,-44,18,-4,1,0,1,-6,8,2,2,1,3,-2,4,2,1,0,1,0,-5,-29,-4,-5,9,-1,0,0,1,-1,0,-1,6,-1
KR_6753904466,420,4,21,16,12,1,1,2,3,3,6,2,2,4,4,0,4,2,2,4,0,11,-1,0,-6,6,4,0,0,1,-1,0,-1,3,-1
KR_6671224287,420,0,-56,8,0,-3,4,1,2,1,3,-1,1,0,2,1,3,0,1,1,0,5,-6,0,-4,4,1,0,0,1,-1,-1,-1,3,-1
KR_6765000348,420,-1,36,5,-6,-3,5,2,-2,4,2,1,1,2,-3,3,0,1,0,1,0,-4,1,-2,-5,7,-5,0,0,1,-1,0,1,2,-1
KR_6764504391,420,-3,47,-12,-3,-1,3,2,0,5,5,2,2,4,-4,5,1,0,0,0,0,-15,-51,4,-10,6,2,0,1,1,1,1,1,6,-1
KR_6770353605,440,-4,2,-4,-15,0,2,2,-3,4,1,-1,3,2,-12,14,2,1,2,3,0,-21,0,3,-5,2,-1,0,-1,0,0,-1,1,0,-1
KR_6774133792,420,-2,-36,-12,-3,1,0,1,0,5,5,1,0,1,-4,5,1,-1,2,1,0,-3,4,5,-9,4,-5,0,0,1,-1,0,-1,6,-1
KR_6722465953,420,-1,-55,7,3,1,1,2,3,2,5,-4,4,0,0,6,6,3,0,3,0,13,11,0,-7,7,6,0,0,-1,1,0,1,3,-1
KR_6759274852,420,-7,-14,-24,-13,-5,5,0,-1,2,1,1,0,1,-7,9,2,-1,1,0,0,-15,-33,-5,-3,8,4,0,-1,0,-1,-1,-1,0,-1
KR_6766478129,420,0,3,-3,1,-4,7,3,-7,7,0,4,0,4,9,1,10,-1,1,0,-1,3,-38,1,-6,5,1,0,-2,1,1,-1,-1,6,-1
KR_6777881638,420,-1,24,-32,-2,-1,3,2,-1,3,2,2,1,3,-1,2,1,-1,1,0,-1,-6,2,2,-8,6,-2,0,1,-1,1,-1,-1,3,-1
KR_6742415832,420,-2,-16,24,-10,-5,7,2,3,1,4,-1,2,1,-8,10,2,1,2,3,0,-8,-36,1,-6,5,-1,0,-1,-1,1,-1,-1,6,-1
KR_6775231046,420,1,28,13,3,-2,3,1,3,4,7,-2,3,1,2,0,2,2,0,2,1,2,-2,3,-7,4,2,0,1,1,-1,1,1,3,-1
KR_6770240145,420,0,-25,3,1,-3,3,0,8,2,10,2,0,2,-3,7,4,-3,3,0,0,8,13,9,-14,5,-2,0,0,-1,1,0,1,5,-1
KR_6769956437,420,1,-11,-14,2,-1,3,2,0,3,3,2,1,3,2,0,2,-1,1,0,0,5,86,6,-9,3,4,0,0,-1,-1,0,1,1,-1
KR_6764253230,420,-8,-40,-88,-25,-5,8,3,-9,10,1,-4,7,3,-7,8,1,0,2,2,0,-20,-29,-3,-2,5,3,0,-3,-1,-1,-1,-1,3,-1
KR_6767934075,420,0,-33,-8,-1,-1,2,1,-1,4,3,0,1,1,-1,3,2,2,2,4,1,-5,-11,-3,-7,10,-1,0,-1,-1,1,-1,1,1,-1
KR_6764717925,440,1,63,-1,2,-3,4,1,1,1,2,1,0,1,2,2,4,1,0,1,0,-3,-11,-4,-5,9,8,0,0,1,1,1,1,3,-1
KR_6757520811,420,2,81,30,-3,-1,1,0,3,0,3,-3,5,2,-2,6,4,0,1,1,0,-7,0,-4,-4,8,2,0,2,-1,1,1,-1,5,-1
KR_6776008021,420,0,28,15,-7,4,1,5,-3,6,3,-3,3,0,-6,7,1,1,0,1,0,-14,-7,-3,-6,9,9,0,-2,-1,-1,-1,-1,4,-1
KR_6774528555,420,0,1,-14,-4,-2,3,1,-3,4,1,-2,3,1,2,0,2,1,0,1,0,-4,8,1,-2,1,0,0,0,1,-1,0,-1,3,-1
KR_6762955902,420,-4,2,-19,-11,0,2,2,-4,5,1,-3,3,0,-3,5,2,-1,1,0,0,-19,-3,0,-7,7,0,0,-1,-1,-1,-1,-1,2,-1
KR_6761902560,440,-1,-42,11,-9,0,1,1,-1,2,1,1,3,4,-7,9,2,-2,2,0,0,-8,0,-4,-2,6,-4,0,-2,-1,-1,-1,-1,4,-1
KR_6761933918,420,-4,-33,9,-7,0,3,3,0,2,2,2,1,3,-5,6,1,-4,4,0,0,-3,-12,1,-8,7,-9,0,-2,-1,-1,-1,-1,5,-1
KR_6767190127,420,-2,-5,-19,4,-3,4,1,6,2,8,-2,3,1,2,5,7,1,0,1,0,1,4,3,-8,5,0,0,1,1,0,1,1,1,-1
KR_6744956657,420,-3,-66,-1,-7,-2,5,3,-2,4,2,-2,3,1,-1,3,2,0,1,1,0,-8,-6,3,-6,3,5,0,-2,1,-1,-1,-1,3,-1
KR_6734073219,420,3,-22,-3,5,-1,2,1,-2,3,1,1,3,4,5,1,6,2,0,2,-1,3,-31,-4,-3,7,3,0,0,1,-1,-1,-1,3,-1
KR_6765210509,420,-3,-82,-36,-5,0,3,3,0,2,2,-5,5,0,1,2,3,-1,1,0,-1,-16,-7,2,-6,4,2,0,-1,-1,-1,-1,-1,2,-1
KR_6737348150,420,1,31,-4,3,-2,2,0,1,2,3,1,2,3,3,0,3,0,1,1,1,4,28,0,-4,4,-2,0,0,1,-1,0,1,3,-1
KR_6708173779,420,-3,11,-37,-1,2,3,5,0,4,4,-2,3,1,0,1,1,-1,2,1,-1,-9,2,1,-7,6,-4,0,0,1,-1,0,-1,6,-1
KR_6765921212,440,-1,-76,11,-4,0,1,1,2,2,4,-3,4,1,-4,6,2,1,0,1,0,-2,39,1,-5,4,-14,0,0,-1,1,1,-1,2,-1
KR_6774086526,420,-3,-50,-4,-10,2,1,3,0,2,2,-8,13,5,-3,4,1,-1,2,1,0,-14,2,1,-5,4,5,0,-3,1,-1,-1,-1,1,-1
KR_6728312888,420,1,37,-19,5,-2,2,0,0,6,6,5,2,7,3,0,3,-1,2,1,0,10,12,9,-10,1,-4,0,1,1,1,1,1,6,-1
KR_6773695310,420,2,100,-23,0,-2,3,1,4,3,7,4,1,5,-5,5,0,-1,2,1,0,-6,2,2,-5,3,-1,0,0,-1,-1,0,1,4,-1
KR_6776725868,420,-2,-8,16,-5,-2,2,0,-3,3,0,-1,2,1,2,3,5,-1,2,1,0,-4,-22,2,-5,3,-3,0,-2,1,-1,-1,-1,2,-1
KR_6757466004,420,2,70,-32,7,0,1,1,2,0,2,1,4,5,4,0,4,0,0,0,0,6,-20,-3,-4,7,5,0,1,1,-1,1,1,6,-1
KR_6769898538,420,-4,-4,-16,-12,-1,2,1,-5,8,3,-5,6,1,-2,2,0,1,1,2,0,-21,-7,-4,-8,12,-5,0,-2,-1,-1,-1,-1,1,-1
KR_6722682442,420,-1,10,-25,3,4,1,5,-1,4,3,-1,2,1,-1,6,5,2,0,2,0,-3,2,0,-10,10,-1,0,0,-1,1,1,-1,5,-1
KR_6764931735,420,-3,-16,-21,-5,0,1,1,0,2,2,2,0,2,-5,5,0,-2,3,1,0,-6,-17,-3,-7,10,-3,0,0,-1,1,0,-1,3,-1
KR_6772926302,420,-1,19,12,-3,-2,5,3,-1,4,3,1,1,2,-2,4,2,1,0,1,0,4,-4,-4,-2,6,2,0,-1,1,1,-1,1,2,-1
KR_6773056715,420,2,7,4,-1,-2,2,0,-1,9,8,2,1,3,0,3,3,0,0,0,1,-4,-2,-6,-2,8,0,0,0,0,-1,0,1,0,-1
KR_6768828695,420,2,-2,30,-2,3,1,4,-1,3,2,-7,8,1,2,3,5,1,0,1,0,1,18,-1,-7,8,-2,0,0,1,-1,-1,-1,3,-1
KR_6773245529,420,-1,-32,-21,-9,-4,6,2,-1,4,3,2,1,3,-4,5,1,-2,2,0,0,-6,56,-5,-4,9,1,0,0,-1,-1,-1,-1,4,-1
KR_6776590696,420,-6,-106,-9,-12,-3,4,1,-1,1,0,-5,5,0,-2,4,2,-1,1,0,0,-8,-15,-1,-4,5,0,0,-1,1,-1,-1,-1,3,-1
KR_6773746247,440,2,6,8,7,6,0,6,-3,4,1,2,1,3,0,7,7,2,3,5,0,3,-14,-2,-3,5,1,0,1,0,1,1,1,0,-1
KR_6761560112,440,-3,-48,31,-6,-5,5,0,1,2,3,-3,3,0,-2,4,2,3,1,4,-1,-3,2,-3,-3,6,-3,0,-2,1,-1,-1,-1,4,-1
KR_6760064559,420,-4,-69,-16,-8,-1,2,1,-1,1,0,-4,4,0,-1,2,1,-1,1,0,0,-8,1,2,-6,4,-3,0,-1,-1,-1,-1,-1,2,-1
KR_6775770787,420,-2,-15,-8,0,2,1,3,-1,3,2,-1,1,0,1,1,2,-1,1,0,1,-1,16,-1,-4,5,-4,0,-1,1,-1,-1,1,2,-1
KR_6765773066,440,-2,2,-20,-1,3,2,5,0,1,1,0,4,4,-1,3,2,-3,5,2,0,-5,-8,0,-5,5,3,0,0,-1,-1,-1,-1,6,-1
KR_6763771497,420,-2,-76,5,-6,3,2,5,-5,5,0,0,2,2,-3,4,1,-1,2,1,0,0,2,-4,-6,10,-7,0,-2,-1,-1,-1,-1,5,-1
KR_6728322323,420,0,2,-7,-5,2,1,3,-2,5,3,-1,4,3,-4,8,4,0,2,2,0,-23,32,0,-6,6,-5,0,0,-1,1,1,-1,6,-1
KR_6776254155,420,-1,-36,-7,-9,0,1,1,2,1,3,-3,5,2,-2,2,0,-6,6,0,0,-9,-13,-4,-2,6,-4,0,-2,-1,-1,-1,-1,4,-1
KR_6739086639,420,0,-19,23,-12,1,1,2,-2,4,2,-4,4,0,-4,4,0,-3,4,1,0,-18,-36,-1,-5,6,0,0,-1,1,-1,-1,1,5,-1
KR_6741616551,420,3,35,17,8,6,0,6,5,3,8,-1,4,3,-1,3,2,-1,2,1,0,-2,43,0,-7,7,1,0,3,-1,1,1,1,3,-1
KR_6766043855,420,-4,-73,-7,-3,0,1,1,-3,6,3,1,0,1,-1,6,5,0,0,0,0,-4,-8,4,-10,6,-3,0,-2,-1,-1,-1,-1,4,-1
KR_6771014571,420,0,-27,-13,-5,-1,2,1,-6,7,1,3,2,5,-2,3,1,1,0,1,0,-7,21,2,-5,3,-1,0,-1,1,-1,-1,1,5,-1
KR_6771120493,420,-2,0,4,-7,0,3,3,-2,3,1,-5,6,1,-3,4,1,3,0,3,1,-7,-9,-2,-4,6,-2,0,0,1,-1,-1,1,2,-1
KR_6689478339,420,-2,-32,15,0,-1,2,1,-1,1,0,0,4,4,1,3,4,1,1,2,0,7,-1,-2,-7,9,2,0,0,1,-1,0,1,1,-1
KR_6752624531,440,2,53,-10,-1,-2,4,2,-1,4,3,-2,3,1,2,4,6,2,0,2,0,1,3,3,-4,1,-4,0,0,0,-1,-1,-1,0,-1
KR_6768811036,420,-2,-47,-24,-4,1,2,3,-3,3,0,2,4,6,-2,6,4,-2,4,2,-2,-13,-1,-5,-6,11,-3,0,0,-1,-1,-1,-1,5,-1
KR_6777300987,420,0,-22,-8,-6,2,1,3,-4,5,1,1,0,1,0,3,3,-5,5,0,0,-8,-1,3,-7,4,-6,0,-2,-1,-1,-1,-1,3,-1
KR_6768241528,420,-3,-109,3,-6,-1,3,2,-1,1,0,-3,3,0,-1,3,2,0,0,0,0,-2,-3,-2,-6,8,-2,0,1,1,1,1,-1,5,-1
KR_6706047868,420,-4,-47,-56,-12,-4,4,0,-3,9,6,-4,5,1,-1,3,2,0,1,1,0,-5,19,-2,-6,8,5,0,-1,-1,-1,-1,-1,2,-1
KR_6745100001,420,0,-49,-28,1,-1,2,1,4,3,7,-2,4,2,-1,1,0,1,1,2,0,6,-12,3,-7,4,2,0,1,-1,-1,1,1,1,-1
KR_6773913555,420,0,50,-13,-3,3,0,3,0,3,3,-8,9,1,1,0,1,1,0,1,0,-4,-6,-1,-2,3,-1,0,-1,-1,-1,1,-1,3,-1
KR_6737091587,420,-6,-42,-17,-19,-9,11,2,-1,2,1,-2,2,0,-9,11,2,2,0,2,-1,-18,-12,-6,-2,8,1,0,-2,-1,-1,-1,-1,4,-1
KR_6775772088,420,2,23,-22,0,2,0,2,-5,7,2,3,0,3,0,1,1,0,0,0,0,-5,-34,6,-8,2,-3,0,1,-1,1,1,1,4,-1
KR_6670532867,420,-3,-34,-8,-9,-4,6,2,1,4,5,-1,2,1,-1,4,3,-4,5,1,0,-13,1,-6,-3,9,3,0,-1,-1,-1,-1,-1,3,-1
KR_6774236802,420,-4,-69,-1,-11,-1,1,0,-2,3,1,-4,4,0,-4,4,0,0,2,2,0,-10,-33,-2,-4,6,20,0,-1,1,1,-1,-1,2,-1
KR_6775219875,440,-2,-15,-17,-4,0,1,1,-5,7,2,-2,3,1,1,2,3,2,1,3,0,-4,-3,-2,-3,5,-3,0,-1,1,-1,-1,-1,1,-1
KR_6772876747,420,0,-49,-20,6,-2,3,1,7,4,11,2,1,3,-2,5,3,1,0,1,2,21,27,2,-6,4,0,0,-1,-1,1,-1,-1,3,-1
KR_6769098970,420,-2,5,-36,0,-3,6,3,2,3,5,4,2,6,-2,3,1,-1,1,0,0,-6,-6,-4,-5,9,4,0,-1,-1,-1,-1,1,2,-1
KR_6776285252,420,-3,-10,2,-7,-3,3,0,-1,3,2,-3,3,0,-2,4,2,2,0,2,0,-3,-7,-3,-2,5,1,0,-1,-1,-1,-1,-1,5,-1
KR_6733352249,420,0,13,-15,0,4,0,4,-6,7,1,2,3,5,-1,3,2,1,1,2,0,-2,-8,-3,-5,8,-3,0,1,1,1,1,-1,3,-1
KR_6765950430,420,0,1,4,-3,-5,5,0,-1,2,1,1,3,4,1,2,3,1,0,1,0,-2,-5,-5,-3,8,2,0,0,-1,1,-1,-1,2,-1
KR_6777392760,440,-3,-77,-24,-9,2,1,3,-6,10,4,-6,8,2,0,2,2,1,2,3,-1,-10,-1,-2,-4,6,0,0,0,-1,0,-1,-1,1,-1
KR_6673605576,420,0,-66,11,-2,0,1,1,3,1,4,-1,3,2,-5,6,1,1,0,1,0,-1,-31,8,-11,3,23,0,-1,-1,-1,-1,-1,4,-1
KR_6744877887,420,0,-12,-24,-3,-5,6,1,-1,1,0,1,0,1,1,5,6,1,1,2,-1,-3,14,-4,-7,11,0,0,-1,-1,-1,-1,-1,3,-1
KR_6775258437,420,3,20,26,3,3,0,3,0,5,5,0,1,1,-1,1,0,1,1,2,0,-1,240,5,-15,10,-1,0,1,-1,1,1,-1,6,-1
KR_6776517851,420,-3,-43,15,-4,3,0,3,-7,8,1,4,2,6,-4,4,0,0,0,0,0,-10,33,2,-8,6,-26,0,0,-1,1,-1,1,1,-1
KR_6752171864,420,-1,27,-9,0,-2,2,0,-3,4,1,2,2,4,2,2,4,1,1,2,0,-4,-4,-3,-6,9,4,0,0,-1,-1,1,-1,5,-1
KR_6755539930,420,-1,18,11,-8,-4,5,1,2,0,2,-3,4,1,-4,7,3,1,1,2,0,-16,-9,-8,-3,11,5,0,0,1,-1,0,1,4,-1
KR_6742691857,420,-4,-79,-7,-13,0,2,2,-4,7,3,-2,4,2,-8,9,1,1,1,2,-1,-17,16,5,-11,6,-10,0,0,1,-1,0,1,6,-1
KR_6776112883,420,0,-53,-24,10,1,1,2,2,0,2,2,0,2,4,2,6,1,0,1,2,17,14,3,-10,7,-1,0,0,1,1,0,1,5,-1
KR_6774803298,420,0,12,20,-4,0,4,4,3,1,4,-3,5,2,-3,6,3,-1,1,0,1,-10,0,0,-5,5,-3,0,1,1,1,1,1,6,-1
KR_6768773437,420,-3,-4,1,-13,-4,4,0,-1,2,1,-2,4,2,-4,6,2,-2,2,0,0,-15,6,1,-7,6,-3,0,-2,-1,-1,-1,1,6,-1
KR_6760848389,420,0,-40,-4,-2,-4,4,0,2,3,5,-1,3,2,-1,2,1,2,0,2,-2,7,19,0,-6,6,-6,0,-1,-1,-1,-1,-1,3,-1
KR_6769704599,420,-4,6,7,-11,2,1,3,-6,7,1,-1,2,1,-3,4,1,-3,3,0,0,-21,16,-3,-5,8,-4,0,-1,-1,-1,-1,-1,4,-1
KR_6718916691,420,0,21,-8,-7,2,1,3,-2,4,2,0,3,3,-4,7,3,-3,3,0,0,-12,-202,-7,-3,10,-3,0,1,1,-1,1,1,2,-1
KR_6751225444,420,4,58,21,4,0,2,2,1,0,1,0,3,3,0,2,2,3,0,3,-2,-5,0,0,-6,6,4,0,0,1,1,1,-1,1,-1
KR_6749269746,420,-4,-101,-19,-11,-1,4,3,-7,9,2,-3,3,0,-1,6,5,1,1,2,0,-9,0,-3,-3,6,-3,0,-2,-1,-1,-1,-1,2,-1
KR_6760144188,420,0,29,-8,1,4,2,6,-12,13,1,10,2,12,-2,3,1,1,2,3,-2,-7,1,-3,-3,6,1,0,1,-1,1,1,1,3,-1
KR_6716760825,420,3,31,20,8,-3,4,1,2,3,5,13,0,13,-4,5,1,0,0,0,0,11,5,-1,-2,3,-1,0,0,1,1,-1,-1,3,-1
KR_6765152207,420,0,22,-16,0,-1,3,2,1,3,4,-2,2,0,0,2,2,2,1,3,1,5,21,5,-10,5,3,0,1,-1,1,1,1,6,-1
KR_6775734861,420,2,3,32,7,3,0,3,1,1,2,1,1,2,-1,1,0,3,1,4,0,11,0,4,-7,3,-2,0,0,1,1,1,-1,5,-1
KR_6746911048,420,-4,-21,-72,-11,3,1,4,-8,8,0,-1,2,1,-3,5,2,-2,3,1,0,-14,-10,-2,-5,7,5,0,-2,-1,-1,-1,-1,3,-1
KR_6775382792,420,-5,-83,-73,-18,1,3,4,-12,13,1,-1,7,6,-7,12,5,1,0,1,-1,-12,-19,-3,-3,6,1,0,-1,-1,-1,-1,-1,4,-1
KR_6776199157,420,-1,-53,24,1,-6,6,0,7,2,9,-2,5,3,1,3,4,1,0,1,0,5,8,8,-13,5,0,0,-2,1,-1,-1,-1,1,-1
KR_6765575213,420,-3,-91,-12,-7,-2,2,0,-2,3,1,-1,3,2,-5,9,4,3,1,4,0,-6,-5,-6,-3,9,2,0,-2,1,-1,-1,1,1,-1
KR_6775797880,420,-3,5,-12,-4,4,2,6,-2,3,1,-4,5,1,-1,1,0,-1,2,1,0,-9,-252,-1,-3,4,1,0,-1,-1,1,-1,-1,4,-1
KR_6772042797,420,-1,-10,-3,-2,-1,2,1,-4,4,0,-2,2,0,2,4,6,3,0,3,0,-8,11,-7,-3,10,4,0,0,1,1,-1,-1,4,-1
KR_6774274229,420,1,-6,33,3,-1,4,3,1,1,2,1,2,3,2,0,2,0,0,0,0,5,1,1,-7,6,-2,0,0,1,-1,0,-1,5,-1
KR_6776566938,420,-3,-18,-12,-9,-1,2,1,-3,6,3,-2,5,3,-2,3,1,-1,3,2,0,-10,-8,-5,-2,7,0,0,-1,-1,-1,-1,-1,3,-1
KR_6776922044,420,-3,11,-9,-6,0,0,0,-1,3,2,0,1,1,-5,5,0,0,0,0,0,-9,-6,1,-7,6,7,0,0,-1,-1,0,1,2,-1
KR_6770023495,420,1,24,12,2,1,3,4,-2,6,4,1,1,2,2,3,5,0,0,0,0,-3,6,0,-7,7,-3,0,1,1,-1,-1,1,1,-1
KR_6756285239,420,-6,-119,-41,-15,-5,5,0,-4,6,2,-1,7,6,-5,5,0,0,2,2,0,-14,-7,-1,-6,7,-1,0,-2,1,-1,-1,-1,6,-1
KR_6765503083,420,-4,-41,-40,-5,1,0,1,-2,2,0,1,1,2,-5,6,1,0,1,1,0,-9,-19,0,-10,10,1,0,-1,-1,0,-1,1,5,-1
KR_6768812891,420,2,69,-16,4,1,0,1,5,0,5,1,4,5,-2,5,3,-1,1,0,1,4,52,1,-8,7,7,0,1,1,1,1,1,6,-1
KR_6756083701,420,-1,-3,8,2,4,0,4,0,1,1,-6,7,1,6,0,6,-2,3,1,0,6,-41,4,-6,2,-1,0,1,-1,-1,1,1,3,-1
KR_6776855903,420,-5,-93,4,-18,-4,10,6,-1,3,2,-6,6,0,-5,7,2,-2,4,2,0,-21,-33,-3,-5,8,-1,0,-2,1,-1,-1,-1,2,-1
KR_6777003818,420,-2,-35,-16,-4,1,0,1,1,3,4,-3,6,3,-1,4,3,-2,2,0,-2,-10,18,-2,-5,7,-5,0,-1,-1,1,-1,-1,2,-1
KR_6775112860,420,0,-28,-20,7,4,1,5,3,0,3,4,5,9,-4,6,2,0,1,1,0,1,-8,-1,-6,7,-2,0,1,1,1,1,-1,1,-1
KR_6769378185,420,-3,21,-24,-3,1,0,1,-5,6,1,-1,1,0,0,0,0,2,0,2,0,-8,-33,1,-10,9,0,0,0,1,-1,0,1,5,-1
KR_6775237307,440,-1,11,-8,-1,0,3,3,-3,3,0,2,1,3,0,3,3,0,0,0,0,3,-26,-3,-2,5,0,0,-1,1,-1,-1,-1,5,-1
KR_6757494802,420,-4,-92,-21,-10,-2,3,1,0,0,0,-4,4,0,-3,5,2,-1,1,0,0,-8,-4,-3,-5,8,1,0,-3,-1,-1,-1,-1,6,-1
KR_6774806023,420,-3,-34,10,-5,4,2,6,-1,2,1,-2,4,2,-4,4,0,-2,2,0,0,-11,-13,-5,-5,10,-2,0,-3,-1,-1,-1,1,4,-1
KR_6767928508,420,0,12,-20,-2,2,1,3,-6,7,1,-2,4,2,2,0,2,2,2,4,0,-9,19,1,-6,5,-4,0,0,-1,-1,-1,-1,2,-1
KR_6752243240,420,-2,1,23,-12,2,0,2,-8,8,0,-2,4,2,-3,3,0,-1,1,0,0,-14,-34,-6,-6,12,2,0,0,-1,-1,1,-1,1,-1
KR_6775023864,420,1,-52,-3,3,1,0,1,0,2,2,1,3,4,3,0,3,-2,2,0,0,4,-45,2,-7,5,20,0,-1,1,-1,-1,1,3,-1
KR_6775560410,420,-1,-36,-7,-7,-1,3,2,3,0,3,0,1,1,-4,5,1,-5,5,0,0,-6,-27,0,-5,5,0,0,0,1,1,0,1,4,-1
KR_6776221984,420,-1,-43,0,-6,-6,7,1,2,1,3,-1,3,2,-3,4,1,2,2,4,0,-9,-11,0,-5,5,0,0,-1,-1,1,-1,-1,2,-1
KR_6739616736,420,-2,-64,-16,-2,1,1,2,2,0,2,-3,5,2,-2,4,2,0,0,0,0,7,-3,-9,-4,13,2,0,-2,1,-1,-1,1,6,-1
KR_6736815941,420,-8,-36,-45,-24,-7,7,0,-2,2,0,-8,10,2,-5,7,2,-2,2,0,0,-30,-3,-6,-3,9,3,0,-3,-1,-1,-1,-1,2,-1
KR_6777868018,420,-4,-68,-30,-11,1,1,2,-5,5,0,-3,3,0,-4,9,5,0,2,2,-1,-13,9,1,-6,5,-3,0,0,-1,-1,0,-1,6,-1
KR_6770527470,420,-2,10,4,-7,-1,2,1,-3,5,2,0,4,4,-2,2,0,-1,1,0,0,-1,-3,0,-6,6,-2,0,0,-1,-1,0,-1,1,-1
KR_6729673458,440,-1,4,28,-4,-7,8,1,1,0,1,-6,7,1,4,2,6,4,0,4,0,-8,-4,0,-6,6,-3,0,-1,-1,-1,-1,1,5,-1
KR_6716000973,420,-1,37,-2,-4,3,2,5,-7,10,3,4,0,4,-1,4,3,-3,4,1,1,-13,-3,-3,-5,8,2,0,-1,1,-1,-1,1,3,-1
KR_6777024792,420,-2,-37,-11,-5,-1,1,0,-1,3,2,-1,2,1,-2,2,0,0,0,0,0,-13,-27,1,-8,7,2,0,0,1,-1,0,-1,6,-1
KR_6694611273,420,-2,-39,6,-2,-2,5,3,1,3,4,0,1,1,-1,3,2,0,0,0,0,-3,0,1,-8,7,-1,0,0,1,-1,-1,1,3,-1
KR_6776042478,420,1,-19,5,-1,-4,4,0,0,2,2,0,1,1,1,3,4,2,0,2,0,-1,4,2,-10,8,0,0,0,-1,1,0,-1,3,-1
KR_6777572154,420,-4,1,-24,-15,-9,10,1,-1,7,6,-2,3,1,-2,5,3,-1,1,0,0,-9,-46,-3,-5,8,4,0,-1,-1,-1,-1,-1,3,-1
KR_6774089650,420,-1,-8,5,1,2,0,2,-4,5,1,0,3,3,6,3,9,-3,5,2,0,-5,0,-1,-2,3,5,0,0,1,1,1,-1,4,-1
KR_6746803658,420,-7,-147,-32,-13,-1,4,3,1,1,2,-8,8,0,-3,4,1,-2,2,0,-1,-18,-99,-5,-4,9,16,0,-3,-1,-1,-1,-1,1,-1
KR_6746491962,440,-2,-47,-12,-3,0,4,4,0,3,3,0,4,4,-1,2,1,-2,2,0,1,-5,-4,1,-3,2,0,0,0,-1,1,0,1,4,-1
KR_6748058261,420,1,19,38,-4,0,1,1,-2,3,1,-1,5,4,-1,2,1,0,1,1,0,-6,-8,-1,-5,6,-1,0,1,-1,1,1,-1,6,-1
KR_6768542217,420,-1,-1,6,-6,-2,4,2,-4,5,1,2,2,4,-2,5,3,0,1,1,0,-7,-2,0,-7,7,1,0,-1,1,-1,-1,1,1,-1
KR_6777274109,420,-6,-105,-16,-23,-8,8,0,-2,5,3,-6,8,2,-7,8,1,0,2,2,-1,-27,21,1,-7,6,-4,0,-3,-1,-1,-1,-1,4,-1
KR_6769086436,420,-4,-46,-7,-16,-3,3,0,-3,4,1,-3,5,2,-5,5,0,-2,3,1,0,-14,-5,-7,0,7,5,0,-2,1,-1,-1,-1,3,-1
KR_6775093393,420,-1,63,-15,-1,-5,5,0,2,1,3,-1,2,1,3,0,3,0,0,0,0,4,-8,-3,-5,8,3,0,0,1,-1,0,-1,6,-1
KR_6764454553,420,-2,-50,-8,-3,0,1,1,1,3,4,-4,7,3,0,2,2,0,1,1,0,3,-4,-2,-3,5,-4,0,0,-1,-1,-1,-1,2,-1
KR_6699973254,420,3,38,44,-7,2,1,3,-4,5,1,-3,6,3,-2,2,0,0,1,1,0,-7,-8,-3,-7,10,2,0,0,-1,1,-1,-1,2,-1
KR_6755268265,420,0,-37,-16,2,-3,4,1,3,2,5,5,2,7,-3,6,3,0,0,0,0,13,4,-5,-6,11,1,0,-1,-1,-1,-1,-1,3,-1
KR_6749546403,420,-3,4,4,-12,-4,6,2,-5,5,0,-1,2,1,-1,2,1,-1,1,0,0,-12,-1,-3,-6,9,2,0,0,-1,1,0,-1,2,-1
KR_6773071907,420,0,53,9,-6,1,1,2,-3,6,3,-2,3,1,-1,4,3,-1,3,2,0,-8,-29,-2,-7,9,-5,0,-1,-1,-1,-1,-1,2,-1
KR_6719844612,420,-3,-13,-61,5,5,0,5,2,2,4,-3,3,0,0,3,3,1,1,2,1,14,-2,3,-9,6,-7,0,-3,1,-1,-1,1,2,-1
KR_6723659105,420,-2,-32,36,-5,-2,3,1,-4,8,4,3,1,4,-3,4,1,1,0,1,0,-12,-1,-1,-5,6,4,0,0,-1,-1,-1,-1,1,-1
KR_6753850132,420,-3,-54,16,-7,-4,6,2,-1,7,6,1,2,3,-3,3,0,0,0,0,0,-10,2,2,-5,3,-4,0,-1,-1,1,-1,-1,6,-1
KR_6772927629,420,-3,-23,8,-3,-3,3,0,3,3,6,2,1,3,-3,4,1,-2,3,1,0,-3,-9,-1,-6,7,1,0,-1,-1,-1,-1,-1,3,-1
KR_6774461657,420,1,-40,5,3,0,3,3,1,3,4,-1,3,2,4,2,6,-1,1,0,0,0,20,-2,-4,6,-1,0,0,1,1,0,1,2,-1
KR_6777010950,420,1,-49,21,5,-4,5,1,1,2,3,1,3,4,7,3,10,0,2,2,-1,6,1,-2,-6,8,1,0,0,-1,-1,-1,-1,6,-1
KR_6777844862,420,-2,-52,16,-1,-5,5,0,2,2,4,-2,2,0,3,2,5,1,0,1,0,1,2,0,-6,6,0,0,0,1,1,0,-1,1,-1
KR_6770623548,420,-1,-3,15,-4,-2,3,1,-3,5,2,-2,2,0,1,1,2,2,1,3,0,-7,-32,-5,-6,11,1,0,1,-1,1,1,-1,2,-1
KR_6776470676,420,-3,-30,-1,-3,-2,3,1,-3,3,0,0,3,3,3,3,6,-1,1,0,0,1,17,0,-7,7,-7,0,0,-1,1,0,1,4,-1
KR_6682767664,420,1,43,20,-1,4,0,4,3,3,6,-1,4,3,-6,6,0,-1,1,0,1,-13,-2,2,-9,7,6,0,1,1,-1,1,1,5,-1
KR_6776989952,420,-2,-19,-5,-4,0,2,2,-1,3,2,-2,3,1,-2,5,3,1,0,1,0,-9,-7,-2,-7,9,3,0,-1,1,-1,-1,-1,1,-1
KR_6733577691,420,-1,47,-6,-6,3,0,3,-2,2,0,1,0,1,-8,8,0,0,0,0,0,-16,-3,3,-6,3,-1,0,-1,-1,1,-1,-1,4,-1
KR_6774888605,440,-3,-47,-4,-2,-3,4,1,1,2,3,5,0,5,1,1,2,-6,7,1,1,-1,10,-1,-3,4,-4,0,-1,1,0,-1,1,6,-1
KR_6772355094,420,0,-31,29,-3,-8,8,0,-3,5,2,6,3,9,0,2,2,2,0,2,0,-1,-4,4,-9,5,1,0,0,1,-1,1,-1,3,-1
KR_6770488805,420,-4,-5,8,-9,0,0,0,-4,9,5,0,0,0,-5,5,0,0,0,0,0,-13,-21,-11,-1,12,1,0,-1,1,-1,-1,-1,3,-1
KR_6747571315,420,0,-65,8,-5,1,3,4,-1,5,4,0,2,2,-5,10,5,0,0,0,0,-7,-65,-2,-4,6,17,0,-1,-1,-1,-1,1,4,-1
KR_6706356215,420,1,20,3,2,-2,2,0,0,3,3,-4,5,1,8,1,9,0,0,0,-1,2,-3,-1,-8,9,5,0,1,1,1,1,-1,1,-1
KR_6745183393,420,2,-7,28,-3,1,4,5,-3,3,0,-1,3,2,0,2,2,0,2,2,0,-1,6,-2,-7,9,-4,0,0,-1,-1,1,-1,1,-1
KR_6774027563,420,2,22,18,6,1,1,2,1,5,6,2,1,3,4,0,4,-2,2,0,0,16,-46,1,-10,9,3,0,2,1,-1,-1,1,6,-1
KR_6774303391,420,-4,-50,-36,-4,-4,4,0,-1,5,4,1,0,1,2,1,3,-2,2,0,0,2,27,2,-7,5,-7,0,-1,1,-1,-1,1,5,-1
KR_6760029188,420,-3,-12,-3,-7,-1,3,2,-3,4,1,1,1,2,-2,3,1,-2,4,2,0,-11,-1,-3,-4,7,3,0,-1,-1,-1,-1,-1,2,-1
KR_6762198583,420,-3,-4,-36,-10,-5,5,0,-1,6,5,-4,5,1,-1,5,4,1,1,2,0,-10,-1,0,-5,5,0,0,0,1,-1,0,-1,5,-1
KR_6775186921,420,-2,-41,-33,-11,3,0,3,-6,7,1,-4,5,1,-1,3,2,-3,6,3,0,-8,-5,2,-6,4,5,0,0,0,-1,1,-1,0,-1
KR_6764543875,440,-7,-17,-12,-15,-4,4,0,-1,1,0,-6,6,0,-1,2,1,-3,6,3,0,-16,-2,0,-6,6,-2,0,0,-1,1,0,-1,1,-1
KR_6732690742,420,2,42,-8,6,5,1,6,2,5,7,-1,4,3,0,5,5,0,1,1,0,0,6,8,-9,1,-1,0,2,1,1,1,-1,3,-1
KR_6772369112,420,2,-16,7,-1,-1,3,2,0,1,1,3,2,5,-5,6,1,2,0,2,1,-7,-11,-1,-7,8,-1,0,0,-1,-1,-1,1,5,-1
KR_6766909849,420,-4,2,2,-7,0,2,2,-1,1,0,-2,2,0,-2,3,1,-2,2,0,0,-9,-5,1,-5,4,-5,0,-1,1,-1,-1,-1,2,-1
KR_6769384277,420,-1,-4,48,-5,-3,4,1,0,3,3,1,5,6,-1,3,2,-2,2,0,0,-7,37,0,-10,10,-29,0,1,0,1,1,-1,0,-1
KR_6776247658,420,0,-20,-30,2,2,1,3,1,4,5,2,2,4,-3,6,3,0,3,3,0,-3,11,3,-9,6,-11,0,0,-1,1,-1,1,5,-1
KR_6777476068,420,-1,38,3,-6,1,2,3,0,3,3,1,2,3,-9,10,1,1,0,1,0,-12,-34,-3,-2,5,0,0,1,-1,1,1,1,1,-1
KR_6744520936,420,-2,-21,-6,-7,-2,3,1,-5,7,2,-3,7,4,1,2,3,2,1,3,0,-8,-17,3,-10,7,-10,0,-1,-1,-1,-1,-1,3,-1
KR_6765984739,440,-1,-15,-13,-1,-4,4,0,0,6,6,5,1,6,0,3,3,-2,4,2,2,8,-10,-3,-4,7,-2,0,-1,0,1,-1,1,0,-1
KR_6759468014,420,2,-28,26,-4,-2,4,2,2,1,3,-3,4,1,1,0,1,-2,3,1,0,-4,-14,1,-6,5,1,0,-1,1,-1,-1,-1,3,-1
KR_6755622580,420,2,15,0,1,4,0,4,1,3,4,-1,4,3,-4,5,1,1,0,1,0,2,-30,0,-8,8,14,0,0,-1,-1,-1,1,2,-1
KR_6773116666,420,0,-25,32,-8,-4,5,1,1,2,3,-1,3,2,-4,6,2,0,2,2,0,1,66,-3,-5,8,-17,0,0,-1,-1,-1,-1,2,-1
KR_6726310848,420,-4,-45,-21,-9,-3,3,0,-3,3,0,-2,3,1,0,4,4,-1,2,1,0,-10,19,-7,-4,11,-1,0,-2,-1,-1,-1,-1,3,-1
KR_6774294918,420,0,36,4,0,1,0,1,0,4,4,-1,3,2,-3,5,2,3,0,3,1,6,7,-1,-8,9,-4,0,0,1,-1,-1,1,1,-1
KR_6771404122,420,-1,-27,3,1,0,0,0,-1,1,0,-1,4,3,4,0,4,-1,2,1,0,8,8,8,-12,4,1,0,-1,-1,-1,-1,1,4,-1
KR_6776552434,440,-8,-67,-8,-28,-6,6,0,-2,2,0,-10,11,1,-6,8,2,-4,4,0,0,-26,16,-2,-1,3,1,0,-1,-1,1,-1,-1,4,-1
KR_6776698996,420,-6,-34,-10,-13,-1,2,1,-2,2,0,-5,6,1,-3,3,0,-2,2,0,0,-13,-9,-5,-4,9,-1,0,-3,-1,-1,-1,-1,1,-1
KR_6744451411,420,-1,58,-12,-1,0,2,2,1,4,5,-4,4,0,1,3,4,1,0,1,0,0,4,2,-5,3,-4,0,-1,1,-1,-1,1,5,-1
KR_6772547033,420,3,1,0,7,2,1,3,5,0,5,-2,4,2,0,2,2,2,0,2,0,6,-13,-3,-5,8,3,0,-1,-1,1,-1,-1,4,-1
KR_6776799128,420,-3,-10,-11,-4,-1,2,1,-1,2,1,0,3,3,0,2,2,-2,2,0,0,-1,29,0,-6,6,-1,0,0,0,0,0,1,0,-1
KR_6775204595,420,-4,-26,-16,-3,-2,6,4,-1,3,2,0,0,0,1,1,2,-1,1,0,0,-6,-9,-1,-8,9,4,0,0,0,1,1,-1,0,-1
KR_6772521122,420,-4,-10,6,-5,-3,4,1,0,1,1,-3,7,4,1,1,2,0,0,0,0,-2,4,2,-5,3,0,0,-1,1,-1,-1,1,1,-1
KR_6770312838,420,0,40,1,4,0,1,1,0,1,1,-4,4,0,3,3,6,5,0,5,0,6,7,4,-6,2,1,0,1,-1,1,1,1,2,-1
KR_6742006058,420,0,-12,-2,-7,-1,4,3,-4,5,1,3,0,3,-3,3,0,-2,5,3,0,-11,2,-3,-6,9,-3,0,1,1,1,1,-1,1,-1
KR_6768768446,420,1,40,9,-4,-1,3,2,2,3,5,-3,4,1,-2,3,1,0,1,1,0,-13,18,-5,-6,11,-4,0,0,-1,1,1,1,5,-1
KR_6774427567,420,0,27,-36,-9,1,2,3,-6,6,0,-5,5,0,0,4,4,1,0,1,0,-21,0,0,-5,5,-2,0,-2,-1,1,-1,1,5,-1
KR_6749490852,420,-4,7,17,-4,-3,4,1,-3,4,1,-1,4,3,2,4,6,1,1,2,0,-9,-7,5,-13,8,-5,0,0,1,-1,-1,1,5,-1
KR_6675804173,420,-5,-36,-42,-18,1,1,2,-4,5,1,2,2,4,-15,17,2,-2,3,1,0,-17,2,0,-4,4,-3,0,-2,-1,1,-1,-1,4,-1
KR_6748082962,420,4,-43,46,15,3,4,7,5,1,6,2,3,5,2,2,4,3,2,5,-1,15,36,2,-7,5,-6,0,0,1,1,0,-1,3,-1
KR_6774388290,420,-4,-68,-21,-8,-1,2,1,-2,4,2,-7,10,3,3,1,4,-1,1,0,0,2,6,-3,-3,6,3,0,1,-1,1,1,1,6,-1
KR_6775682438,420,-1,-10,-4,-3,4,0,4,-5,8,3,3,0,3,-5,6,1,0,1,1,0,-12,113,1,-8,7,-10,0,0,-1,1,0,1,3,-1
KR_6728228939,420,-1,-27,5,-3,-6,6,0,0,2,2,1,1,2,0,3,3,2,1,3,0,1,16,3,-5,2,-4,0,0,1,-1,-1,-1,3,-1
KR_6750972908,440,-5,-12,4,-15,1,2,3,-8,8,0,-2,3,1,-7,7,0,1,2,3,0,-24,-10,-7,-1,8,3,0,-1,-1,-1,-1,-1,2,-1
KR_6767427784,420,0,31,4,-1,-3,4,1,5,1,6,-3,6,3,0,3,3,0,0,0,0,9,-6,-1,-6,7,4,0,-1,1,1,-1,-1,6,-1
KR_6753913967,420,-1,18,1,-4,-1,2,1,-1,1,0,-1,2,1,0,0,0,-1,1,0,0,-2,-5,-2,-3,5,-3,0,0,1,-1,0,-1,4,-1
KR_6777796150,420,0,66,16,6,-1,6,5,-1,3,2,3,0,3,3,5,8,2,1,3,1,1,0,0,-8,8,-1,0,1,1,-1,1,1,5,-1
KR_6777530548,420,1,-44,-23,2,-1,4,3,2,3,5,2,2,4,-4,6,2,3,0,3,-2,-9,-1,-5,-5,10,-3,0,1,1,1,1,-1,6,-1
KR_6762350943,420,1,13,12,5,1,1,2,3,1,4,-2,3,1,0,1,1,3,0,3,0,10,3,1,-4,3,-2,0,0,-1,-1,0,1,4,-1
KR_6775254468,420,-8,-73,-46,-17,-1,3,2,-8,9,1,-7,10,3,2,1,3,-3,3,0,-1,-19,19,-8,-5,13,-5,0,-3,-1,-1,-1,-1,4,-1
KR_6771444156,440,-3,-19,-41,-4,-1,2,1,0,2,2,-4,5,1,2,3,5,-1,2,1,-1,-4,-15,2,-5,3,-1,0,-1,0,-1,-1,-1,0,-1
KR_6777119356,420,-5,-57,0,-12,0,0,0,-4,6,2,-3,4,1,0,4,4,-5,5,0,0,-14,13,1,-7,6,-7,0,-1,1,1,-1,1,2,-1
KR_6700853496,420,-2,-94,-4,-6,-2,3,1,-7,8,1,3,1,4,-4,6,2,4,0,4,-1,-7,5,-1,-2,3,-1,0,-2,-1,-1,-1,-1,2,-1
KR_6771444270,420,0,-10,-5,-2,-2,2,0,-1,2,1,2,2,4,-4,6,2,3,1,4,-1,-7,-3,2,-6,4,4,0,-1,-1,-1,-1,-1,4,-1
KR_6766806534,420,-1,25,-16,9,1,2,3,4,1,5,0,2,2,1,3,4,3,0,3,0,13,9,7,-11,4,-7,0,-1,1,-1,-1,-1,3,-1
KR_6725184321,420,-1,-19,-12,-3,-1,3,2,-2,2,0,3,1,4,-2,5,3,-1,1,0,0,-9,-25,-4,-3,7,4,0,-1,-1,1,-1,1,5,-1
KR_6776349979,420,-1,-2,-11,-9,0,2,2,-1,4,3,-3,3,0,-2,2,0,-3,3,0,0,-9,-6,-3,-4,7,-1,0,0,-1,1,-1,-1,6,-1
KR_6768517047,420,-1,-38,6,-6,-4,5,1,-8,8,0,2,0,2,2,1,3,2,1,3,0,1,-5,-3,-6,9,-2,0,-2,1,-1,-1,-1,3,-1
KR_6724669128,420,-2,64,9,-2,-3,4,1,0,3,3,2,3,5,-2,6,4,1,0,1,1,-8,20,1,-9,8,4,0,0,-1,-1,1,1,5,-1
KR_6716347402,420,1,-9,13,7,1,0,1,2,0,2,0,3,3,4,2,6,0,1,1,0,12,-4,0,-5,5,1,0,1,-1,1,1,1,4,-1
KR_6774892265,420,-4,-24,-24,-5,-2,2,0,0,2,2,-2,3,1,-1,3,2,0,0,0,0,-6,-7,0,-5,5,-15,0,0,-1,-1,0,-1,3,-1
KR_6684072920,420,-4,-19,-24,-13,1,1,2,-1,4,3,-6,6,0,-7,7,0,0,0,0,0,-9,-3,4,-8,4,-3,0,-2,-1,-1,-1,1,6,-1
KR_6776054933,420,-2,0,-13,-1,-1,1,0,0,4,4,-1,2,1,-1,3,2,2,0,2,0,3,-8,-5,-2,7,5,0,-1,-1,1,-1,-1,1,-1
KR_6729999587,420,-2,-59,-8,-4,-1,2,1,0,2,2,-4,5,1,1,2,3,0,0,0,0,7,9,-4,-5,9,4,0,0,-1,1,-1,1,5,-1
KR_6777117543,420,-4,-31,-19,-8,-1,4,3,-3,3,0,-1,2,1,-1,1,0,-2,2,0,0,-9,-22,1,-8,7,-5,0,-1,1,-1,-1,-1,1,-1
KR_6777824288,420,1,-42,-36,2,-4,5,1,1,2,3,1,3,4,4,1,5,0,2,2,-2,2,8,5,-9,4,-2,0,0,1,-1,-1,-1,5,-1
KR_6685360291,420,-3,-9,-34,-6,1,0,1,-5,8,3,1,1,2,-5,6,1,2,2,4,-1,-7,-3,-1,-5,6,-1,0,0,-1,-1,-1,-1,4,-1
KR_6671376288,420,-1,18,-7,1,5,1,6,0,4,4,-3,6,3,0,4,4,-1,3,2,-2,-5,2,3,-8,5,2,0,1,-1,-1,1,-1,6,-1
KR_6769232721,420,-1,-3,9,-8,3,0,3,-4,5,1,-4,4,0,-2,2,0,-1,1,0,0,-14,-5,-1,-5,6,0,0,0,1,-1,0,-1,1,-1
KR_6777299428,420,-2,-9,-21,-12,1,1,2,1,2,3,-8,8,0,-7,7,0,1,2,3,-1,-16,-4,2,-8,6,-3,0,-1,-1,-1,-1,-1,1,-1
KR_6774375397,420,0,-6,19,0,0,1,1,2,4,6,-1,3,2,0,3,3,-1,2,1,0,4,-1,0,-4,4,-3,0,1,1,-1,1,-1,1,-1
KR_6776741322,420,-5,-74,-13,-13,2,0,2,-2,3,1,-4,6,2,-6,7,1,-3,3,0,0,-20,12,-6,-4,10,2,0,-2,-1,-1,-1,1,2,-1
KR_6776031413,420,-1,6,19,-5,-1,1,0,0,4,4,1,3,4,-2,5,3,-3,3,0,0,-10,30,-7,-1,8,4,0,0,-1,1,0,1,2,-1
KR_6738550939,440,-4,-62,-46,-1,1,1,2,-2,3,1,-3,5,2,2,2,4,1,1,2,0,0,-3,3,-4,1,-1,0,-2,-1,-1,-1,-1,5,-1
KR_6736761509,420,1,18,-32,-3,-2,4,2,0,1,1,-1,3,2,1,2,3,-1,2,1,-1,3,-2,0,-6,6,-2,0,0,-1,-1,-1,-1,1,-1
KR_6773127485,420,-5,-23,-36,-12,-2,5,3,-1,6,5,-5,6,1,-5,5,0,1,1,2,0,-11,6,-10,-2,12,-7,0,0,1,1,-1,-1,1,-1
KR_6771504061,420,2,-57,-8,6,-1,1,0,2,2,4,4,1,5,1,0,1,0,1,1,0,8,-1,-2,-4,6,1,0,1,1,1,1,1,3,-1
KR_6718672168,420,-3,-58,8,-3,-7,7,0,4,1,5,-1,4,3,-1,2,1,2,0,2,0,2,-7,0,-5,5,0,0,-2,1,-1,-1,1,5,-1
KR_6770757499,420,-2,-55,-8,-8,-1,1,0,-1,2,1,-2,6,4,-1,3,2,-3,4,1,0,-2,-121,1,-7,6,-3,0,-1,-1,1,-1,-1,2,-1
KR_6772257785,420,3,24,4,6,1,0,1,1,3,4,2,2,4,1,3,4,1,0,1,0,-1,12,6,-13,7,-8,0,2,-1,1,1,1,3,-1
KR_6749463618,420,-2,-48,-11,-5,-3,3,0,0,3,3,-2,5,3,0,1,1,0,0,0,0,0,20,-3,-7,10,3,0,-1,1,-1,-1,-1,1,-1
KR_6775869217,420,-3,9,-34,-1,1,0,1,-6,7,1,3,0,3,1,0,1,0,0,0,0,0,0,1,-8,7,-5,0,1,-1,1,1,-1,3,-1
KR_6768663466,420,0,25,14,2,1,0,1,-5,9,4,7,0,7,-1,2,1,0,0,0,0,-1,-6,-2,-6,8,1,0,2,-1,1,1,-1,6,-1
KR_6768527792,420,-6,-87,-30,-14,2,3,5,-9,10,1,-5,6,1,-2,3,1,0,2,2,-2,-18,27,5,-7,2,-1,0,-2,1,-1,-1,-1,6,-1
KR_6748688537,420,-2,-44,-39,1,-5,6,1,0,6,6,-1,3,2,6,1,7,1,0,1,0,2,-5,1,-5,4,-2,0,0,1,-1,-1,1,3,-1
KR_6775852773,420,-2,-7,-4,-3,-1,3,2,1,1,2,-2,2,0,0,4,4,-1,2,1,0,4,-2,3,-8,5,1,0,0,-1,1,1,1,3,-1
KR_6774208216,420,-4,-31,-39,-6,3,2,5,-4,4,0,-3,3,0,-2,3,1,0,3,3,0,-11,-2,6,-8,2,-1,0,-1,-1,-1,-1,-1,1,-1
KR_6756565801,420,1,72,-3,0,2,1,3,-5,8,3,-2,4,2,4,1,5,1,0,1,0,-4,-29,-3,-5,8,-17,0,0,1,-1,1,1,2,-1
KR_6777141323,420,-1,-79,17,-4,-4,4,0,5,3,8,1,3,4,-6,6,0,0,1,1,0,-6,13,-4,-5,9,-2,0,-3,1,-1,-1,-1,1,-1
KR_6769110478,420,-3,-22,-33,-1,2,0,2,-2,3,1,0,5,5,-1,2,1,0,2,2,1,-1,-17,1,-7,6,2,0,-1,1,-1,-1,1,3,-1
KR_6768235234,420,0,-57,-22,1,1,0,1,0,5,5,-4,8,4,2,1,3,2,1,3,0,3,6,-3,-4,7,5,0,0,1,1,-1,-1,4,-1
KR_6765257908,420,-1,-35,3,-1,-2,4,2,0,3,3,1,1,2,0,2,2,0,0,0,0,2,-12,-9,-3,12,3,0,1,-1,1,1,-1,5,-1
KR_6756072861,420,-1,-34,-28,5,1,2,3,2,2,4,-2,3,1,2,2,4,2,2,4,0,8,3,2,-7,5,-2,0,0,1,-1,0,1,1,-1
KR_6773791196,420,4,25,57,3,2,1,3,2,0,2,-3,7,4,1,2,3,1,0,1,0,-8,-31,0,-5,5,0,0,2,1,1,1,1,4,-1
KR_6695063976,420,-2,-12,3,-4,2,0,2,-1,2,1,-4,5,1,-1,2,1,0,0,0,0,-6,-318,2,-6,4,-4,0,-1,-1,-1,-1,-1,4,-1
KR_6769978927,420,2,35,0,3,1,2,3,2,2,4,-1,3,2,-1,2,1,2,0,2,-1,7,-399,5,-9,4,-6,0,0,-1,1,0,-1,5,-1
KR_6756904262,420,-3,-11,-12,-10,-1,3,2,-9,9,0,0,2,2,-1,2,1,1,0,1,-1,-19,-3,-1,-3,4,3,0,-1,-1,-1,-1,-1,2,-1
KR_6772331711,420,-2,25,-1,-6,0,2,2,0,3,3,-3,5,2,0,3,3,-3,5,2,0,-8,1,-2,-6,8,-4,0,0,-1,-1,-1,1,3,-1
KR_6773706510,420,-2,-24,-7,-10,-3,4,1,-5,8,3,-1,5,4,-3,6,3,2,1,3,-2,-5,1,-5,-4,9,3,0,1,-1,-1,1,-1,2,-1
KR_6775242556,420,1,34,-22,-4,-4,4,0,0,2,2,-3,7,4,3,4,7,0,2,2,0,9,-5,-1,-8,9,4,0,0,-1,-1,-1,1,2,-1
KR_6772219397,440,3,7,48,-3,2,0,2,-1,3,2,-1,5,4,-5,5,0,2,1,3,0,-14,-3,0,-2,2,-1,0,0,1,1,0,1,2,-1
KR_6744100031,420,-1,27,-7,4,3,1,4,1,1,2,1,1,2,3,1,4,-4,4,0,0,6,5,1,-5,4,-1,0,-1,1,1,-1,1,2,-1
KR_6726848106,440,-1,-16,-4,-6,-3,8,5,-2,3,1,0,1,1,-1,5,4,0,1,1,0,-2,4,-2,-4,6,-4,0,1,0,0,1,1,0,-1
KR_6760201431,420,-3,-47,3,-8,-3,4,1,-2,4,2,-1,1,0,-3,3,0,1,1,2,0,-9,-4,0,-6,6,-3,0,0,0,-1,-1,-1,0,-1
KR_6760116480,420,0,-7,28,-2,1,1,2,-1,4,3,-1,5,4,-1,3,2,0,1,1,-1,-1,53,-3,-4,7,-16,0,1,1,-1,1,-1,4,-1
KR_6771229104,420,-2,55,40,8,2,3,5,3,3,6,0,8,8,6,4,10,-3,4,1,4,3,26,4,-6,2,-3,0,1,1,1,1,1,6,-1
KR_6721650727,420,-1,-3,-20,-3,0,4,4,-1,2,1,-3,4,1,-2,4,2,3,1,4,0,-2,-8,-1,-6,7,4,0,1,-1,-1,1,1,3,-1
KR_6771330380,420,2,-9,-14,0,1,0,1,1,2,3,1,1,2,-3,4,1,0,1,1,-1,0,-1,3,-6,3,0,0,0,-1,1,1,-1,1,-1
KR_6722951384,440,-2,-55,-5,1,-1,2,1,3,0,3,0,3,3,-1,6,5,0,3,3,0,7,46,-2,-6,8,-8,0,0,1,-1,-1,-1,2,-1
KR_6774102228,420,-4,-57,-24,-7,-3,3,0,-1,4,3,6,1,7,-5,5,0,-4,5,1,-1,-11,102,4,-6,2,-2,0,-3,-1,-1,-1,-1,1,-1
KR_6759044881,420,-6,-81,-12,-13,-2,3,1,-1,1,0,-2,3,1,-8,8,0,0,1,1,0,-12,36,-5,-4,9,-22,0,0,1,-1,-1,1,2,-1
KR_6748924095,420,-4,-50,12,-3,-2,4,2,-3,5,2,4,1,5,-2,2,0,0,1,1,0,-8,-17,-4,-6,10,3,0,0,1,1,-1,1,1,-1
KR_6746166848,420,-2,-30,-2,2,0,2,2,0,1,1,-1,6,5,3,1,4,0,1,1,0,10,-7,-8,-2,10,-2,0,1,-1,-1,1,1,5,-1
KR_6745497400,420,1,60,-10,-2,3,2,5,4,1,5,-1,2,1,-9,9,0,1,0,1,0,-10,23,3,-7,4,2,0,1,-1,-1,1,-1,1,-1
KR_6775151279,420,-4,-22,-25,-9,3,1,4,-4,4,0,-4,5,1,-4,4,0,0,1,1,0,-21,-15,1,-4,3,-4,0,-1,1,-1,-1,1,2,-1
KR_6768003704,440,-1,29,9,-5,3,2,5,-3,3,0,3,1,4,-6,6,0,-2,2,0,0,-6,240,-5,0,5,0,0,1,-1,1,-1,1,6,-1
KR_6775416180,420,-3,-39,-8,-10,0,0,0,-2,5,3,-3,3,0,-2,2,0,-3,6,3,0,-11,-5,-1,-5,6,-2,0,-1,-1,1,-1,-1,5,-1
KR_6768698309,420,-2,-19,-27,-4,-2,2,0,-3,3,0,-1,2,1,1,1,2,1,0,1,0,-5,6,-1,-6,7,1,0,0,1,1,1,1,2,-1
KR_6742073920,420,0,-2,-10,4,4,2,6,1,1,2,-1,4,3,0,3,3,0,0,0,0,1,-3,-1,-6,7,2,0,1,1,-1,1,-1,6,-1
KR_6753802821,420,0,-26,-8,-2,3,0,3,-1,1,0,-3,4,1,-1,4,3,0,1,1,0,-10,-5,-3,-6,9,-9,0,-1,1,-1,-1,-1,6,-1
KR_6704825414,420,2,-1,-8,3,-2,2,0,2,0,2,2,1,3,1,4,5,0,0,0,0,9,28,2,-5,3,-2,0,1,1,-1,1,1,4,-1
KR_6748175649,420,-3,6,-25,-1,0,0,0,2,1,3,0,1,1,-2,5,3,-1,1,0,0,-4,20,-1,-5,6,-1,0,0,1,-1,-1,1,4,-1
KR_6774227206,420,1,31,18,4,2,0,2,0,2,2,1,1,2,-1,3,2,2,2,4,1,0,10,-3,-2,5,-4,0,0,1,-1,0,1,5,-1
KR_6766848661,420,-5,-61,12,-12,-6,6,0,0,2,2,-4,5,1,1,3,4,-3,3,0,0,-9,-7,0,-6,6,-2,0,-1,-1,1,-1,-1,4,-1
KR_6774459951,420,-5,-32,29,-7,-2,2,0,-1,2,1,-3,6,3,-1,6,5,0,2,2,0,-2,6,-3,-4,7,-2,0,1,0,1,1,1,0,-1
KR_6774709270,420,-3,-50,12,-11,4,3,7,-4,5,1,-1,4,3,-2,2,0,-8,8,0,-1,-13,-5,-1,-7,8,0,0,-1,-1,1,-1,-1,5,-1
KR_6775138668,420,0,41,-8,-1,-1,1,0,-2,2,0,2,0,2,-2,3,1,2,1,3,0,-2,-2,-1,-4,5,-2,0,0,-1,1,1,1,2,-1
KR_6772328811,420,-5,-53,29,-9,-8,9,1,1,2,3,-3,5,2,0,3,3,1,0,1,0,-18,3,3,-6,3,-4,0,-2,-1,1,-1,-1,3,-1
KR_6749879418,420,0,3,16,-2,1,0,1,-1,2,1,1,1,2,-2,5,3,-1,3,2,2,-2,-5,0,-10,10,1,0,1,-1,1,1,-1,4,-1
KR_6773503929,440,0,-51,32,-4,2,2,4,0,2,2,0,4,4,-3,4,1,-3,3,0,0,-3,-19,-5,-1,6,-2,0,-2,0,1,-1,-1,0,-1
KR_6772281147,440,0,-29,-10,4,1,0,1,4,0,4,3,1,4,-7,7,0,3,0,3,1,4,-7,3,-5,2,2,0,1,1,1,1,1,5,-1
KR_6738462258,440,1,30,-16,-2,-1,3,2,0,3,3,0,3,3,-1,3,2,0,1,1,-1,-2,5,1,-8,7,0,0,0,-1,-1,0,-1,3,-1
KR_6774040138,420,-2,-15,0,-1,0,0,0,-2,6,4,-2,3,1,3,0,3,0,1,1,0,-2,-3,-7,-4,11,-3,0,0,1,-1,0,1,5,-1
KR_6768530389,420,-3,-34,-33,-7,-6,6,0,-4,5,1,0,3,3,-1,2,1,4,0,4,0,3,4,3,-7,4,2,0,-1,1,-1,-1,-1,4,-1
KR_6770344146,440,3,-37,-11,5,-1,2,1,4,0,4,0,3,3,1,1,2,1,1,2,0,6,-8,1,-3,2,-3,0,0,0,0,0,1,0,-1
KR_6719710784,420,-1,-41,-8,1,-3,3,0,0,3,3,-2,4,2,3,0,3,3,0,3,0,7,-2,-7,-1,8,3,0,1,1,1,1,1,4,-1
KR_6716696176,420,1,37,-1,2,-1,2,1,4,1,5,0,2,2,-2,9,7,1,0,1,0,0,-58,-4,-6,10,5,0,-1,-1,-1,-1,-1,1,-1
KR_6756770776,420,-3,-5,-9,-2,2,1,3,-1,6,5,-2,3,1,-1,2,1,0,2,2,0,0,-8,0,-4,4,1,0,-1,1,-1,-1,-1,2,-1
KR_6775182642,420,0,-20,8,-2,0,1,1,-1,1,0,-4,4,0,4,1,5,-1,1,0,0,-4,-3,-3,-6,9,-7,0,0,1,-1,0,-1,4,-1
KR_6761893301,440,-2,-30,-9,3,1,1,2,6,1,7,-1,2,1,-1,2,1,-2,2,0,0,5,3,2,-7,5,-1,-1,-3,1,1,-1,-1,2,-1
KR_6658424716,420,-2,-47,-28,-9,0,1,1,-3,4,1,-4,4,0,3,1,4,-5,5,0,0,-10,5,1,-8,7,-3,0,-1,1,-1,-1,-1,6,-1
KR_6771911640,420,-2,-14,-18,-3,1,0,1,-1,2,1,-4,5,1,3,2,5,-2,2,0,0,-5,2,1,-7,6,-1,0,1,-1,-1,1,-1,4,-1
KR_6768528401,420,-5,-147,0,-14,-4,4,0,1,4,5,-1,2,1,-4,4,0,-6,8,2,0,-11,-6,0,-3,3,0,0,-2,1,1,-1,-1,3,-1
KR_6704167704,420,0,7,-11,-8,-1,3,2,-5,7,2,0,3,3,-1,2,1,-1,1,0,0,-13,3,2,-9,7,-4,0,-1,-1,-1,-1,-1,1,-1
KR_6690668531,420,0,-28,12,8,1,2,3,4,3,7,1,0,1,5,3,8,-3,3,0,2,14,9,1,-6,5,-1,0,-1,1,-1,-1,1,1,-1
KR_6761775726,440,0,45,-24,-4,0,0,0,0,2,2,-1,5,4,-2,4,2,-1,1,0,0,6,-5,3,-7,4,-5,0,-2,-1,-1,-1,-1,4,-1
KR_6776231088,420,1,8,-12,-2,1,1,2,-4,6,2,0,2,2,2,4,6,-1,1,0,0,-3,6,-1,-7,8,-1,0,0,-1,1,0,-1,3,-1
KR_6742131321,420,-1,-22,8,3,1,1,2,-7,10,3,3,3,6,4,3,7,2,1,3,0,-5,14,-2,-4,6,-3,0,0,-1,-1,0,1,4,-1
KR_6774876893,420,-4,-53,8,-8,-1,1,0,-3,5,2,-2,2,0,-4,7,3,2,1,3,0,-14,0,4,-10,6,-1,0,-1,-1,-1,-1,1,3,-1
KR_6775262392,420,-2,48,-2,-7,3,1,4,-2,4,2,-6,9,3,-1,2,1,-1,2,1,-1,7,-17,0,-9,9,-1,0,-1,-1,-1,-1,-1,4,-1
KR_6759919497,420,-6,-29,-34,-11,-1,3,2,-2,5,3,-6,8,2,-4,5,1,2,1,3,1,-8,-6,1,-9,8,-5,0,-2,-1,-1,-1,1,1,-1
KR_6772047593,440,-2,52,-4,-6,-4,4,0,0,4,4,-1,3,2,-1,1,0,0,1,1,0,-5,1,-5,-3,8,-1,0,1,-1,1,1,-1,3,-1
KR_6685281276,420,-1,-48,0,0,1,0,1,-2,8,6,1,2,3,-2,6,4,2,1,3,0,-4,-5,-4,-6,10,-2,0,-1,1,1,-1,-1,2,-1
KR_6772211753,420,-6,-80,-10,-23,-3,4,1,-4,4,0,-8,9,1,-8,8,0,0,0,0,0,-17,2,-2,-2,4,-5,0,-3,-1,-1,-1,-1,5,-1
KR_6751820373,420,-3,-108,4,-12,-3,3,0,-5,5,0,1,1,2,-3,3,0,-2,2,0,-1,-16,2,0,-4,4,-3,0,-3,-1,1,-1,-1,3,-1
KR_6712657755,420,-1,-43,5,3,1,2,3,3,1,4,0,2,2,1,3,4,-2,2,0,-1,1,-11,-1,-5,6,0,0,0,-1,1,0,-1,2,-1
KR_6770471607,420,2,26,0,3,3,1,4,1,1,2,-3,5,2,4,0,4,-2,4,2,0,-1,2,-5,-4,9,3,0,1,1,-1,1,1,1,-1
KR_6776109904,420,-1,-47,12,-5,-3,3,0,0,2,2,2,3,5,-4,4,0,0,2,2,-2,-6,-55,-2,-4,6,-6,0,0,1,1,0,-1,4,-1
KR_6777153596,420,-3,-67,-23,-8,-1,1,0,-4,4,0,0,2,2,-2,2,0,-1,1,0,0,-12,-58,-3,-4,7,36,0,-2,1,-1,-1,-1,6,-1
KR_6777641041,420,2,-53,12,-6,0,2,2,-3,5,2,-5,7,2,1,2,3,1,0,1,0,-8,-14,-4,-5,9,3,0,0,-1,-1,-1,-1,6,-1
KR_6771977425,420,-1,-36,2,-13,-7,7,0,-1,2,1,-1,5,4,-4,5,1,0,1,1,0,-11,5,-1,-7,8,-4,0,-2,1,-1,-1,-1,3,-1
KR_6777767907,420,1,20,-3,0,-2,3,1,0,1,1,5,2,7,-2,2,0,-1,2,1,0,-1,-116,1,-4,3,-1,0,0,1,-1,0,-1,3,-1
KR_6773596165,420,-3,-75,12,-2,2,1,3,-5,5,0,-1,2,1,2,0,2,0,0,0,0,-9,-9,-3,-5,8,2,0,0,-1,1,0,1,2,-1
KR_6651188258,420,-1,-45,12,3,2,2,4,0,2,2,1,1,2,1,0,1,-1,1,0,0,0,8,5,-9,4,-8,0,1,1,1,1,-1,3,-1
KR_6772611656,420,-2,-31,-12,-1,0,2,2,-7,8,1,4,3,7,-1,5,4,3,0,3,0,1,-6,-1,-6,7,3,0,0,1,-1,0,-1,1,-1
KR_6755505460,420,-1,-34,-8,-5,-5,5,0,4,3,7,-6,6,0,2,4,6,0,0,0,-1,-10,-26,-3,-6,9,2,0,-1,1,1,1,-1,4,-1
KR_6776935102,420,0,-13,19,1,0,2,2,2,2,4,1,0,1,0,2,2,-2,2,0,0,3,-24,0,-8,8,-6,0,0,1,-1,-1,1,4,-1
KR_6777319756,420,0,2,-6,-3,-2,2,0,1,2,3,-5,6,1,1,1,2,2,0,2,0,3,9,1,-6,5,-9,0,0,-1,1,-1,1,2,-1
KR_6765162799,420,-3,64,-16,-17,1,1,2,-9,9,0,-3,3,0,-4,6,2,-2,3,1,0,-24,3,-6,-1,7,-2,0,1,-1,-1,1,-1,5,-1
KR_6777123301,420,-4,-71,17,-11,-5,5,0,2,0,2,-7,8,1,3,5,8,-4,4,0,1,-5,-7,0,-5,5,-1,0,-1,-1,1,-1,1,3,-1
KR_6776531612,420,0,-28,-7,-3,3,2,5,0,1,1,-4,7,3,-3,6,3,1,1,2,0,6,4,-2,-4,6,3,0,0,-1,1,0,-1,5,-1
KR_6773261465,420,-6,-25,-39,-16,-3,3,0,-1,1,0,-3,4,1,-11,11,0,2,1,3,-1,-32,9,-2,-3,5,1,0,-2,-1,-1,-1,-1,5,-1
KR_6771514156,420,2,4,0,3,0,2,2,-1,4,3,-1,4,3,3,3,6,2,1,3,1,-2,-10,1,-6,5,1,0,2,1,1,1,1,3,-1
KR_6776349392,420,-1,-61,-11,-2,-1,2,1,1,6,7,-3,3,0,3,2,5,-2,3,1,0,-9,-11,-1,-6,7,2,0,-1,1,-1,-1,-1,3,-1
KR_6769136361,420,-1,-27,-19,1,-2,3,1,-1,2,1,-1,3,2,6,3,9,-1,1,0,0,4,-11,-1,-9,10,-1,0,0,-1,-1,0,1,5,-1
KR_6733907287,420,2,-26,-4,-6,-2,2,0,-3,5,2,0,1,1,0,2,2,-1,1,0,0,-4,7,1,-5,4,-1,-2,-5,-1,-1,-1,-1,5,-1
KR_6769861221,440,2,25,23,1,0,2,2,-3,7,4,2,0,2,4,0,4,-2,3,1,0,-4,3,1,-8,7,-3,0,1,-1,1,1,1,4,-1
KR_6756608443,420,0,-9,12,-2,-5,6,1,-4,6,2,1,2,3,3,1,4,3,1,4,0,-1,-44,-4,-4,8,3,0,1,1,1,1,1,5,-1
KR_6765626968,420,0,-3,-4,-2,-2,2,0,0,3,3,-3,3,0,0,4,4,3,0,3,-1,1,3,-2,-4,6,-4,0,0,-1,1,1,-1,1,-1
KR_6774500935,420,0,-35,0,-1,2,0,2,0,0,0,3,0,3,-6,6,0,0,0,0,0,-1,12,3,-7,4,-3,0,-1,1,-1,-1,-1,5,-1
KR_6776440368,420,-1,-65,1,2,-2,4,2,0,4,4,-1,3,2,5,2,7,0,1,1,0,6,-24,3,-6,3,11,0,-1,-1,1,-1,1,1,-1
KR_6776503115,420,0,-36,3,2,2,5,7,-6,6,0,-2,5,3,0,3,3,8,1,9,0,6,6,-5,-4,9,-3,0,0,1,1,-1,-1,2,-1
KR_6770421297,420,0,-40,-8,0,-1,2,1,1,4,5,3,0,3,-2,4,2,-1,3,2,-1,-5,24,6,-11,5,4,0,0,-1,1,-1,-1,3,-1
KR_6734338967,420,-1,-72,-8,-4,0,1,1,-3,7,4,-2,3,1,4,0,4,-3,3,0,0,-1,-6,-3,-5,8,-8,0,0,-1,-1,-1,1,4,-1
KR_6777494330,420,-2,-30,15,-8,-1,1,0,-6,9,3,-2,2,0,1,2,3,0,0,0,0,-2,3,-3,-3,6,4,0,1,-1,1,1,-1,5,-1
KR_6773694610,420,-1,-20,23,-11,-7,8,1,-4,5,1,3,1,4,-6,8,2,3,4,7,1,-4,-9,1,-8,7,-2,0,-2,-1,1,-1,1,6,-1
KR_6776946967,420,-4,-83,-10,-9,-3,3,0,-4,5,1,0,2,2,-2,2,0,0,0,0,0,-13,23,-3,-3,6,-1,0,-1,1,-1,-1,1,2,-1
KR_6776885689,420,-1,-12,-13,-1,-4,4,0,-3,3,0,5,0,5,2,3,5,-1,1,0,0,-1,14,2,-10,8,3,0,-1,-1,1,1,1,2,-1
KR_6769342414,420,-4,-91,-51,-8,1,1,2,-3,3,0,-1,7,6,-5,9,4,0,3,3,0,-5,-5,1,-2,1,0,0,-1,-1,-1,-1,1,4,-1
KR_6742646912,420,-7,-107,-16,-5,1,2,3,-3,5,2,-3,7,4,0,4,4,0,1,1,0,-1,-27,4,-8,4,1,0,-2,-1,0,-1,1,1,-1
KR_6775645783,420,-1,-37,-3,-4,1,0,1,0,4,4,-3,4,1,0,1,1,-2,3,1,0,-3,-119,-4,-4,8,2,0,-1,1,-1,-1,-1,4,-1
KR_6756825569,420,-1,-25,-9,2,4,1,5,-2,2,0,-2,2,0,1,1,2,1,2,3,0,6,-7,2,-5,3,-2,0,-1,1,1,-1,1,2,-1
KR_6762929879,440,-2,-33,-9,-3,-2,2,0,-3,5,2,6,2,8,-3,4,1,-1,1,0,0,-3,-4,1,-2,1,2,0,0,1,-1,0,1,4,-1
KR_6774470823,420,-1,-15,-8,1,-1,2,1,-2,4,2,4,2,6,1,5,6,-1,1,0,0,2,-9,1,-6,5,-1,0,-1,1,-1,-1,1,3,-1
KR_6730909581,420,-2,-28,-1,-7,0,2,2,-3,4,1,-2,4,2,-5,7,2,3,1,4,-1,-15,10,3,-9,6,-2,0,0,1,1,0,-1,5,-1
KR_6771148937,420,-1,-33,4,-3,0,1,1,1,1,2,-3,5,2,-2,3,1,1,3,4,0,-2,-84,-1,-5,6,4,0,-1,-1,1,-1,-1,6,-1
KR_6698618214,420,-2,-28,22,-9,-8,8,0,-5,6,1,3,2,5,1,1,2,0,0,0,0,-6,-14,-3,-5,8,0,0,-2,-1,-1,-1,-1,2,-1
KR_6768670936,420,1,8,-20,-1,-4,5,1,4,2,6,0,1,1,-2,4,2,1,3,4,-1,-5,-24,-5,-3,8,6,0,-2,-1,-1,-1,-1,3,-1
KR_6776413838,420,0,-9,-16,3,0,1,1,1,0,1,2,1,3,-1,5,4,1,1,2,0,4,-112,-5,-3,8,6,0,-2,-1,1,-1,-1,3,-1
KR_6777711780,420,1,22,26,-3,-3,3,0,-1,3,2,1,1,2,3,4,7,-3,3,0,0,2,2,-2,-3,5,0,0,0,1,-1,0,1,3,-1
KR_6773429697,420,1,-23,-9,-3,0,0,0,0,2,2,-1,2,1,-1,2,1,-1,2,1,0,-3,1,-2,-8,10,-2,0,0,-1,1,0,-1,5,-1
KR_6775673333,420,-5,-91,-20,-6,0,4,4,-2,3,1,-4,4,0,-1,3,2,1,2,3,0,-2,-5,1,-6,5,4,0,-3,-1,-1,-1,1,3,-1
KR_6739276211,420,-5,30,-25,-13,-5,6,1,-4,5,1,-2,4,2,-3,5,2,1,0,1,0,-10,-3,0,-6,6,-3,0,0,-1,-1,0,1,6,-1
KR_6766610432,420,-3,-85,1,-3,-3,5,2,-4,5,1,3,1,4,-1,5,4,2,1,3,-1,3,-6,2,-6,4,-2,0,0,-1,-1,-1,-1,3,-1
KR_6777471497,420,0,-2,-8,-1,0,3,3,-1,1,0,0,1,1,0,3,3,0,1,1,0,-6,-7,0,-3,3,7,0,0,1,-1,-1,-1,3,-1
KR_6771569934,420,-1,-43,-33,0,3,0,3,-2,4,2,2,1,3,0,3,3,-3,3,0,0,0,5,2,-8,6,-1,0,-1,-1,-1,-1,-1,3,-1
KR_6753232791,420,-4,-57,-16,-15,2,0,2,-5,5,0,-1,3,2,-8,10,2,-3,4,1,0,-10,4,-1,-3,4,-1,0,-1,-1,-1,-1,-1,2,-1
KR_6745773649,420,-1,-4,-1,-1,1,2,3,-6,8,2,0,3,3,4,0,4,0,0,0,1,5,-39,-2,-6,8,8,0,-1,1,-1,-1,-1,2,-1
KR_6688128443,420,-1,-19,-10,0,-5,5,0,3,2,5,1,2,3,0,3,3,1,0,1,0,7,-30,1,-7,6,1,0,-2,1,1,-1,-1,6,-1
KR_6774212513,420,0,-22,2,-3,3,1,4,-5,5,0,2,3,5,-2,4,2,-1,3,2,0,-8,3,1,-6,5,-3,0,-2,-1,-1,-1,-1,2,-1
KR_6692724553,420,-2,-54,-21,-4,-5,5,0,-2,6,4,-4,9,5,5,2,7,2,0,2,0,-2,-3,0,-8,8,-2,0,-1,-1,-1,-1,-1,4,-1
KR_6776163380,420,-1,28,-5,-5,2,1,3,-2,6,4,2,2,4,-2,4,2,-5,5,0,0,-8,3,0,-6,6,-5,0,1,-1,-1,1,-1,2,-1
KR_6736619262,420,-3,-25,3,-11,2,0,2,-7,7,0,-2,3,1,-4,8,4,0,0,0,0,-14,-3,-1,-8,9,-2,0,-1,1,-1,-1,-1,2,-1
KR_6775504313,420,-1,-76,-3,5,-2,3,1,4,1,5,2,1,3,2,2,4,-1,1,0,0,14,-10,5,-8,3,-9,0,0,1,-1,-1,1,1,-1
KR_6768086203,440,-3,-28,13,-9,1,1,2,-5,6,1,1,1,2,-4,6,2,-2,2,0,0,-14,-13,3,-5,2,1,0,-1,-1,-1,-1,-1,2,-1
KR_6766732089,420,-1,-50,-28,-4,2,0,2,-4,6,2,1,1,2,-3,5,2,0,1,1,0,-10,-6,-2,-8,10,-4,0,-1,-1,1,-1,-1,1,-1
KR_6773332842,420,-4,-6,-19,-7,-3,3,0,-3,6,3,-2,4,2,5,1,6,-4,4,0,0,0,3,-4,-3,7,-4,0,-1,-1,-1,-1,1,3,-1
KR_6776912204,420,-1,0,12,-3,-7,7,0,2,2,4,-1,4,3,0,2,2,3,0,3,0,0,-36,1,-8,7,2,0,0,-1,-1,0,-1,6,-1
KR_6750636742,420,-3,-21,20,-8,2,1,3,-3,6,3,-1,3,2,-3,3,0,-3,4,1,0,-7,-28,-2,-6,8,5,0,0,0,0,-1,-1,0,-1
KR_6772376843,420,0,-42,-13,-6,-1,2,1,-5,5,0,-1,1,0,-1,1,0,2,0,2,-1,-12,-54,0,-5,5,27,0,0,1,-1,-1,-1,4,-1
KR_6744699202,420,-3,-45,-18,-6,-1,1,0,1,3,4,-3,5,2,-2,4,2,-1,2,1,0,-6,1,0,-6,6,-5,0,-1,-1,-1,-1,1,3,-1
KR_6773096181,420,-2,3,-16,-8,-3,5,2,-4,7,3,0,0,0,1,0,1,-2,3,1,0,-15,30,6,-9,3,-23,0,0,1,-1,1,-1,6,-1
KR_6769671700,420,-4,-74,4,0,-3,4,1,4,2,6,0,1,1,-1,5,4,0,0,0,0,1,6,2,-11,9,-2,0,-1,1,-1,-1,-1,2,-1
KR_6770757703,420,0,-3,24,-3,-5,6,1,2,3,5,-1,5,4,1,3,4,0,1,1,0,7,1,-2,-6,8,-4,0,-2,1,-1,-1,-1,1,-1
KR_6776023151,420,-6,45,-3,-10,0,1,1,0,4,4,-4,5,1,-6,6,0,0,0,0,0,-9,-6,-2,-2,4,-1,0,-1,1,-1,-1,-1,3,-1
KR_6775793433,420,0,-13,15,-7,0,1,1,-6,9,3,-2,5,3,-1,2,1,2,0,2,0,-8,-8,-4,-4,8,-4,0,-1,-1,-1,-1,-1,2,-1
KR_6777128798,420,-1,-36,-13,-5,-1,3,2,-3,3,0,6,0,6,-5,7,2,-2,3,1,-1,-3,-19,-1,-6,7,-1,0,-1,-1,-1,-1,1,3,-1
KR_6715977042,420,-6,-62,2,-16,-2,3,1,0,6,6,-6,6,0,-7,7,0,-1,1,0,-1,-20,-6,-5,-1,6,0,0,-2,1,-1,-1,-1,5,-1
KR_6768678771,420,-2,-9,-8,-5,2,1,3,-5,7,2,0,4,4,-2,2,0,0,2,2,-1,-9,-1,4,-10,6,0,0,-1,-1,1,-1,-1,5,-1
KR_6771919472,420,-4,-43,6,-7,1,1,2,-3,6,3,-1,3,2,-4,5,1,0,1,1,0,-7,-5,-3,-3,6,-4,0,-1,1,1,-1,-1,5,-1
KR_6751260422,420,-2,-31,-26,-3,3,0,3,-2,2,0,2,3,5,-5,5,0,-1,2,1,-2,-13,2,1,-8,7,-2,0,0,-1,1,-1,-1,4,-1
KR_6734982828,420,-2,-53,24,-12,-4,6,2,-3,7,4,1,0,1,-5,5,0,-1,3,2,-2,-13,3,-2,-8,10,-3,0,-1,-1,1,-1,-1,6,-1
KR_6719857560,420,-2,0,-31,-7,-2,3,1,2,4,6,-2,2,0,-4,6,2,-1,2,1,0,-2,0,5,-7,2,-7,0,0,-1,-1,0,-1,4,-1
KR_6743794895,420,-1,22,12,-9,0,1,1,0,2,2,0,2,2,-5,9,4,-4,4,0,0,-17,-5,-2,-7,9,5,0,0,-1,1,0,1,1,-1
KR_6769196542,420,-4,-49,-7,-3,1,1,2,-4,8,4,-3,3,0,0,1,1,3,0,3,0,-4,-28,-4,-3,7,5,0,-1,1,1,-1,1,6,-1
KR_6773904868,420,-7,-87,-31,-18,-5,5,0,-5,6,1,-4,4,0,-3,3,0,-1,1,0,0,-19,-18,-7,-3,10,4,0,-3,-1,-1,-1,-1,6,-1
KR_6748778612,420,-3,-58,-53,-4,1,3,4,-3,3,0,0,2,2,-1,6,5,-1,3,2,0,-7,-4,-3,-5,8,0,0,-2,-1,-1,-1,-1,3,-1
KR_6774138846,420,-4,-35,-27,-4,0,2,2,1,3,4,2,5,7,-5,5,0,-2,2,0,0,-16,3,4,-7,3,-2,0,0,-1,-1,0,1,1,-1
KR_6771962687,420,-4,-82,-5,-4,-1,1,0,-4,5,1,4,0,4,0,2,2,-3,3,0,0,-5,12,5,-9,4,-7,0,-2,-1,-1,-1,1,1,-1
KR_6764753834,420,-2,-30,-24,-4,-2,4,2,-5,8,3,4,6,10,0,3,3,-1,2,1,-1,-14,-4,6,-8,2,-3,0,1,-1,1,1,-1,1,-1
KR_6769334909,420,-2,-25,-16,-14,-4,4,0,-6,8,2,1,2,3,-7,8,1,2,0,2,-3,-22,-32,-4,-4,8,-3,0,0,-1,1,-1,-1,2,-1
KR_6769143938,420,-4,-1,9,-22,-3,7,4,-8,9,1,-1,4,3,-4,6,2,-6,9,3,-1,-26,-19,0,-6,6,-7,0,-1,-1,1,-1,-1,2,-1
KR_6705183246,420,-7,-44,-6,-10,-1,2,1,-4,4,0,-3,4,1,-2,3,1,0,0,0,0,-9,1,-2,-6,8,-4,0,-1,-1,-1,-1,-1,4,-1
KR_6764853381,440,0,-45,-28,-3,0,0,0,-3,6,3,-2,4,2,1,1,2,1,0,1,0,-3,-73,0,-5,5,-4,0,-1,-1,-1,-1,-1,5,-1
KR_6712481817,420,4,21,36,11,6,0,6,3,2,5,6,2,8,-4,6,2,0,2,2,0,1,-3,3,-7,4,1,0,2,1,1,1,1,1,-1
KR_6772981276,420,-1,-48,-25,-2,0,2,2,-1,1,0,1,2,3,-4,5,1,2,0,2,0,-1,0,-2,-4,6,-1,0,1,-1,1,1,-1,4,-1
KR_6774805352,420,0,-4,-12,0,1,1,2,0,2,2,7,0,7,-6,6,0,-2,2,0,-1,-1,29,8,-11,3,-6,0,0,-1,1,0,-1,6,-1
KR_6745903830,440,1,-27,20,-3,1,1,2,2,2,4,-6,6,0,-1,1,0,1,0,1,0,1,5,1,-2,1,0,0,-1,0,-1,-1,-1,0,-1
KR_6775498440,440,-3,-23,-4,-14,1,2,3,1,4,5,-4,4,0,-8,8,0,-4,6,2,0,-5,-7,-7,-1,8,4,0,0,-1,1,-1,-1,2,-1
KR_6774636043,420,-8,-154,-53,-12,-5,6,1,-3,3,0,1,2,3,-3,4,1,-2,2,0,0,-11,-2,-1,-3,4,-2,0,-2,-1,0,-1,-1,6,-1
KR_6737366534,420,-6,-16,-36,-15,3,1,4,-4,7,3,-7,7,0,-3,5,2,-4,4,0,1,-14,-8,-2,-4,6,-1,0,0,-1,-1,1,1,6,-1
KR_6750019064,420,1,17,8,-3,0,1,1,-4,5,1,1,3,4,2,2,4,-2,2,0,0,-4,-3,1,-7,6,-4,0,1,1,1,1,1,1,-1
KR_6708224790,420,-2,2,-25,-3,1,0,1,-3,4,1,-2,3,1,2,2,4,-1,1,0,0,-7,-10,-3,-7,10,3,0,0,-1,1,0,1,2,-1
KR_6771265733,420,-3,-11,13,-20,-4,5,1,-6,7,1,-7,8,1,-2,6,4,-1,4,3,0,-28,-9,-8,-4,12,-2,0,-1,-1,-1,-1,-1,4,-1
KR_6756155719,420,-1,30,-5,-9,1,0,1,-1,2,1,-1,3,2,-6,9,3,-2,2,0,0,-13,-23,3,-10,7,-3,0,-1,1,-1,-1,-1,4,-1
KR_6748830741,420,-1,-22,-11,0,-4,5,1,2,0,2,-3,9,6,5,3,8,0,0,0,0,-4,-1,-5,-3,8,1,0,-1,1,1,1,1,2,-1
KR_6770664746,420,-2,-6,-5,-1,1,1,2,5,2,7,-5,7,2,-3,4,1,1,0,1,0,-1,1,0,-6,6,-11,0,1,-1,1,1,-1,3,-1
KR_6773212691,420,-4,-27,8,-7,-2,2,0,-3,6,3,-1,1,0,-1,2,1,0,0,0,0,-11,-9,-1,-7,8,1,0,-1,1,-1,-1,-1,4,-1
KR_6777038748,420,-4,-40,20,-12,-1,2,1,-7,7,0,-2,4,2,-1,2,1,-1,1,0,0,-21,2,1,-4,3,-2,0,1,1,1,1,-1,3,-1
KR_6737653923,420,1,-11,-19,2,0,1,1,-5,8,3,2,0,2,6,3,9,-1,1,0,-1,4,-10,2,-7,5,2,0,0,-1,-1,-1,-1,3,-1
KR_6764027408,420,-1,-28,9,-2,0,3,3,-2,3,1,2,2,4,-6,9,3,4,0,4,1,-6,2,-5,-4,9,3,0,0,-1,1,-1,1,4,-1
KR_6723287492,420,-1,-41,18,1,-2,4,2,-1,4,3,-1,2,1,4,0,4,1,0,1,0,5,5,3,-8,5,-3,0,0,-1,-1,1,1,4,-1
KR_6769999359,420,-1,-50,1,-7,2,1,3,2,1,3,-4,7,3,-4,8,4,-3,3,0,0,-4,1,-2,-4,6,-7,0,-1,-1,1,-1,1,3,-1
KR_6767600194,420,-1,11,-15,-5,4,2,6,-7,7,0,1,0,1,-3,4,1,0,1,1,-1,-10,-114,4,-8,4,-3,0,-2,-1,-1,-1,-1,6,-1
KR_6728021850,420,-6,-62,-28,-10,-6,6,0,0,1,1,-3,4,1,-1,4,3,0,0,0,0,-4,-4,-5,-3,8,-2,0,-1,-1,-1,-1,-1,1,-1
KR_6777182069,420,-2,26,-64,-1,-3,4,1,-5,6,1,2,1,3,5,1,6,0,0,0,-3,-5,-48,2,-11,9,2,0,0,-1,-1,-1,-1,5,-1
KR_6744830370,420,-7,-78,-16,-12,0,2,2,-7,8,1,-4,5,1,-1,2,1,0,0,0,0,-13,3,-2,-7,9,-1,0,-2,-1,-1,-1,-1,3,-1
KR_6722971998,420,1,22,34,5,7,0,7,1,5,6,-2,5,3,-1,6,5,0,2,2,2,2,7,4,-9,5,-4,0,1,0,1,1,1,0,-1
KR_6754237660,420,-1,-15,-7,-1,-1,1,0,-1,4,3,-3,4,1,4,9,13,0,2,2,0,-1,7,-1,-6,7,0,0,0,1,-1,1,-1,5,-1
KR_6675916505,420,0,15,7,-5,1,3,4,-10,10,0,-1,2,1,7,2,9,-2,2,0,0,-5,-10,-4,-2,6,3,0,0,-1,1,1,-1,1,-1
KR_6772994356,420,0,48,16,-1,-1,3,2,-2,5,3,-1,2,1,6,2,8,-3,3,0,1,-3,5,5,-10,5,-4,0,1,1,1,1,1,2,-1
KR_6771843348,440,-1,-55,13,0,6,1,7,-3,5,2,0,3,3,-1,5,4,-2,4,2,1,11,-288,0,-3,3,0,0,0,1,1,1,1,3,-1
KR_6769969519,420,-5,-6,-9,-10,-1,1,0,-10,12,2,-2,2,0,2,3,5,1,1,2,0,-7,-9,-3,-4,7,-1,0,-1,-1,-1,-1,-1,6,-1
KR_6702379456,420,-4,-7,-24,-2,1,1,2,2,6,8,-2,4,2,-3,4,1,0,1,1,-1,-3,-18,4,-7,3,-7,0,-2,-1,-1,-1,1,6,-1
KR_6773374739,420,-4,-51,-31,-18,-2,3,1,-2,4,2,1,3,4,-9,11,2,-6,7,1,0,-20,-75,-4,-4,8,-6,0,-1,-1,-1,-1,-1,6,-1
KR_6775635907,420,-2,7,-24,-8,0,2,2,-2,5,3,-5,5,0,-3,4,1,2,2,4,0,-11,-3,-5,-3,8,0,0,-1,0,-1,-1,-1,0,-1
KR_6766072217,420,-2,-74,19,-2,-2,2,0,0,0,0,3,1,4,-1,2,1,-2,4,2,0,-4,-8,-5,-3,8,3,0,-2,1,1,-1,1,6,-1
KR_6768276789,420,-4,-69,-23,-7,-2,3,1,-5,5,0,-3,5,2,3,1,4,0,0,0,0,0,11,5,-8,3,-4,0,-1,-1,-1,-1,1,3,-1
KR_6774757577,420,2,16,-6,3,1,0,1,3,3,6,2,3,5,0,3,3,-3,4,1,0,3,-1,1,-7,6,4,0,2,-1,1,1,-1,4,-1
KR_6766046852,440,2,27,16,0,2,2,4,4,0,4,-1,4,3,-3,6,3,-2,4,2,2,10,-165,5,-7,2,-4,0,0,-1,-1,-1,1,4,-1
KR_6774589393,420,0,-15,32,-2,1,2,3,0,3,3,2,0,2,-5,5,0,0,0,0,0,-10,0,1,-5,4,1,0,0,-1,1,1,-1,3,-1
KR_6738905193,420,0,-15,13,0,0,3,3,-1,5,4,-5,6,1,5,2,7,1,0,1,0,-1,-7,-5,-2,7,9,0,0,-1,-1,-1,-1,1,-1
KR_6774736051,420,-1,-37,-16,-4,1,2,3,2,2,4,0,0,0,-2,3,1,-5,5,0,0,-2,-6,-3,-4,7,0,0,-3,-1,-1,-1,-1,6,-1
KR_6776893078,420,-1,34,-12,-8,-3,4,1,-2,2,0,0,0,0,-4,7,3,1,1,2,0,-8,-214,3,-9,6,-2,0,-1,-1,-1,-1,-1,5,-1
KR_6681871445,420,-2,-31,-17,-6,-1,1,0,-3,3,0,0,1,1,-2,5,3,0,1,1,0,-16,-17,0,-7,7,0,0,0,-1,-1,-1,1,6,-1
KR_6776936219,420,1,3,-11,6,-2,3,1,1,2,3,2,0,2,1,2,3,4,1,5,0,6,18,-1,-5,6,4,0,0,-1,1,1,-1,1,-1
KR_6760375350,420,-4,-104,-11,-9,1,1,2,-5,5,0,-6,7,1,1,1,2,0,1,1,0,-7,-15,-3,-2,5,1,0,-1,-1,1,-1,-1,6,-1
KR_6776141195,420,-3,-72,9,-5,-6,7,1,0,1,1,1,0,1,-1,2,1,1,0,1,-1,-4,-1,0,-7,7,5,0,1,1,1,1,-1,2,-1
KR_6756062946,420,-2,-63,-8,-13,-4,4,0,-1,3,2,-6,7,1,-4,6,2,2,0,2,0,-9,-30,3,-4,1,1,0,-2,1,-1,-1,-1,5,-1
KR_6735409533,420,-1,-6,-5,1,-1,3,2,2,1,3,-1,2,1,1,0,1,0,0,0,0,6,-3,-1,-2,3,5,0,0,-1,-1,0,1,4,-1
KR_6774228028,420,0,-22,-1,5,5,0,5,1,3,4,1,1,2,-4,6,2,2,0,2,0,8,-11,1,-6,5,5,0,0,1,1,0,1,6,-1
KR_6775677910,420,-4,-60,-21,-13,-1,3,2,-3,5,2,0,1,1,-9,12,3,0,2,2,-1,-15,28,-3,-4,7,-4,0,-1,-1,1,-1,-1,6,-1
KR_6709728916,420,-1,-59,29,-14,0,3,3,-5,5,0,-2,5,3,-5,9,4,-2,3,1,0,-12,-5,-9,-2,11,1,0,-2,-1,1,-1,-1,1,-1
KR_6759102481,420,-4,-29,-35,-17,-4,5,1,-6,6,0,-1,2,1,-7,8,1,1,0,1,-1,-15,4,0,-5,5,0,0,-2,-1,-1,-1,-1,5,-1
KR_6724796993,420,-3,-20,-1,-9,-2,2,0,-6,6,0,2,2,4,-3,3,0,0,0,0,0,-18,-69,-6,-5,11,3,0,-1,-1,-1,-1,-1,2,-1
KR_6763209082,420,-7,-78,-4,-14,-3,4,1,-2,4,2,-3,3,0,-4,6,2,-2,4,2,0,-11,-8,-6,0,6,2,0,-2,-1,-1,-1,1,1,-1
KR_6770998814,420,-3,-11,-5,-13,0,1,1,-7,10,3,-4,6,2,-2,5,3,0,3,3,0,-11,-4,-2,-6,8,-2,0,-2,-1,-1,-1,-1,3,-1
KR_6729748764,420,-6,-99,-17,-11,-3,3,0,1,3,4,-2,4,2,-7,7,0,0,1,1,0,-14,1,-1,-4,5,-7,0,-2,-1,-1,-1,-1,1,-1
KR_6704402135,420,-1,-16,-14,-9,-3,5,2,-3,4,1,2,3,5,-5,5,0,0,1,1,1,-18,235,-1,-7,8,-4,0,0,-1,-1,-1,-1,4,-1
KR_6754954491,420,-2,33,-16,-4,-1,2,1,2,2,4,-5,5,0,-1,3,2,1,0,1,0,-5,9,-3,-5,8,1,0,-1,-1,-1,-1,1,2,-1
KR_6719434297,420,-3,-39,-30,1,-1,2,1,2,3,5,-7,7,0,4,4,8,3,0,3,0,5,-23,0,-5,5,-5,0,0,-1,-1,1,1,3,-1
KR_6746229784,420,-8,-3,-46,-20,0,1,1,-10,10,0,-1,1,0,-7,10,3,-2,3,1,-1,-31,-14,-1,-5,6,0,0,-3,-1,-1,-1,1,2,-1
KR_6723249577,420,-4,10,-39,-10,-1,3,2,-7,8,1,1,3,4,-4,4,0,1,1,2,-1,-11,16,1,-7,6,3,0,0,1,-1,1,-1,6,-1
KR_6770053902,440,2,-46,11,1,-1,3,2,1,7,8,1,2,3,-2,5,3,2,1,3,0,2,-4,-4,-3,7,3,0,1,-1,1,1,-1,6,-1
KR_6764699044,420,0,3,-1,-1,-1,1,0,-2,5,3,2,1,3,0,4,4,0,1,1,0,2,-4,3,-10,7,5,0,2,1,-1,1,-1,2,-1
KR_6777804083,420,-2,-48,12,-6,1,2,3,-1,4,3,-1,5,4,-6,6,0,1,0,1,0,-2,2,0,-5,5,1,0,-1,1,-1,-1,-1,6,-1
KR_6694773374,420,4,51,9,10,3,2,5,1,4,5,0,1,1,2,0,2,4,0,4,0,9,10,6,-9,3,-3,0,0,1,-1,0,-1,6,-1
KR_6769441922,420,1,-15,-16,3,-3,3,0,-3,6,3,2,2,4,4,0,4,3,1,4,-1,7,-192,-2,-5,7,0,0,-1,-1,1,-1,1,2,-1
KR_6774725421,420,-5,-56,-15,-7,1,2,3,-4,7,3,0,3,3,-1,2,1,-3,3,0,0,-10,109,5,-10,5,1,0,-1,-1,-1,-1,-1,2,-1
KR_6775257444,420,-1,-4,-4,3,0,5,5,-2,2,0,3,2,5,1,2,3,1,0,1,0,-3,2,5,-7,2,-1,0,-1,1,-1,-1,-1,2,-1
KR_6772143464,420,3,14,20,0,-1,3,2,-3,3,0,0,3,3,3,3,6,1,0,1,-1,-6,2,-2,-8,10,3,0,1,-1,-1,1,1,5,-1
KR_6775474674,420,-2,-32,-8,-11,0,1,1,-3,6,3,2,0,2,-10,11,1,0,1,1,0,-13,-8,-4,-4,8,-5,0,-1,-1,1,-1,-1,5,-1
KR_6759508697,420,0,-20,-31,5,2,1,3,0,4,4,5,0,5,-3,5,2,1,0,1,0,3,-8,-5,-3,8,0,0,1,-1,1,1,-1,6,-1
KR_6776121012,420,-3,-60,-8,-9,0,0,0,-8,8,0,-3,7,4,1,1,2,1,1,2,0,-7,0,-5,-2,7,0,0,0,1,1,0,-1,1,-1
KR_6770658344,420,-2,31,-19,-4,1,2,3,1,0,1,-6,8,2,1,2,3,-1,2,1,0,-4,34,-2,-5,7,-2,0,-1,-1,-1,1,-1,1,-1
KR_6774568574,420,-3,4,-3,-5,-4,6,2,1,2,3,2,4,6,-2,5,3,-2,3,1,1,-3,16,-5,-4,9,9,0,1,-1,1,1,1,6,-1
KR_6722271131,420,-2,-38,-11,-1,-4,6,2,-3,4,1,-6,8,2,7,1,8,5,0,5,0,0,-28,-4,-2,6,-1,0,-4,1,-1,-1,-1,4,-1
KR_6765055084,420,1,-26,0,0,-3,4,1,2,2,4,2,0,2,-1,3,2,0,1,1,1,2,301,2,-8,6,-3,0,-1,-1,-1,-1,1,4,-1
KR_6757451871,420,-2,-28,21,-3,0,1,1,1,5,6,2,0,2,-4,6,2,-2,2,0,0,-2,1,-2,-5,7,-5,0,-1,1,-1,-1,1,6,-1
KR_6744038962,420,-9,-109,-45,-20,1,1,2,-15,15,0,-4,4,0,-1,1,0,-1,1,0,0,-22,-20,2,-6,4,2,0,-2,1,-1,-1,-1,4,-1
KR_6762119704,420,-1,52,14,-5,1,2,3,-3,5,2,-1,2,1,-1,5,4,-1,1,0,-1,4,5,2,-7,5,-4,0,0,-1,1,-1,-1,3,-1
KR_6772320930,420,2,-9,3,-4,-1,2,1,-1,2,1,0,2,2,-1,3,2,-1,1,0,0,-7,-103,-3,-5,8,2,0,0,1,-1,-1,-1,2,-1
KR_6777726873,420,-3,-21,-29,-5,2,0,2,1,4,5,1,1,2,-6,10,4,-3,4,1,-3,-18,-3,-2,-4,6,-4,0,0,-1,-1,-1,-1,2,-1
KR_6766903148,420,1,-21,14,-1,-3,5,2,0,3,3,3,3,6,-1,3,2,0,1,1,0,3,-6,-1,-7,8,-3,0,1,1,1,1,1,1,-1
KR_6752105524,420,-4,-29,-26,-9,-3,3,0,-2,6,4,-1,2,1,-4,4,0,1,0,1,0,-7,-17,1,-8,7,-2,0,-2,-1,-1,-1,-1,6,-1
KR_6739348154,420,2,90,28,0,-1,4,3,0,1,1,2,1,3,-2,3,1,1,0,1,0,-2,6,-2,-3,5,0,0,0,1,-1,0,1,6,-1
KR_6774403781,420,-3,3,-14,-8,3,1,4,-5,7,2,-2,5,3,-5,9,4,1,0,1,0,-6,4,5,-6,1,-6,0,-2,-1,1,1,1,6,-1
KR_6770523946,420,-3,12,-6,-5,1,0,1,-6,8,2,-1,3,2,1,1,2,0,0,0,0,-2,6,-3,-4,7,-3,0,0,-1,1,-1,-1,6,-1
KR_6768616132,420,-5,-12,-52,-9,0,4,4,-3,5,2,-5,6,1,-2,3,1,1,0,1,0,-9,6,3,-8,5,-3,0,1,-1,1,1,-1,5,-1
KR_6740971075,420,-6,-128,15,-16,-10,12,2,-1,2,1,0,3,3,-4,4,0,-1,1,0,1,-9,-4,-3,-2,5,-2,0,-3,-1,-1,-1,1,1,-1
KR_6758571717,420,-2,31,-19,-7,-1,4,3,-1,2,1,-2,3,1,-2,3,1,-1,1,0,0,-10,3,-2,-6,8,5,0,0,-1,-1,1,-1,4,-1
KR_6777279685,420,-1,-28,12,-5,0,0,0,0,2,2,-5,7,2,1,4,5,-1,2,1,0,-5,5,1,-7,6,-2,0,-1,1,-1,-1,-1,1,-1
KR_6732809309,440,-2,36,28,-8,-7,8,1,1,3,4,-2,3,1,-2,3,1,2,0,2,1,-12,-304,3,-4,1,-4,0,1,-1,0,1,1,5,-1
KR_6765045367,420,-2,-14,-10,-2,1,1,2,1,1,2,-7,7,0,2,1,3,1,0,1,0,3,-6,-4,-3,7,4,0,-1,-1,-1,-1,-1,4,-1
KR_6737737522,420,-2,-11,-24,-8,-1,2,1,-5,6,1,2,0,2,-1,2,1,-3,5,2,0,-13,-47,0,-6,6,20,0,-1,-1,-1,-1,1,3,-1
KR_6713291431,420,-8,-15,-38,-12,-3,3,0,-6,6,0,-2,4,2,0,0,0,-1,2,1,0,-2,-2,3,-5,2,2,0,-1,1,-1,-1,-1,3,-1
KR_6727867512,420,4,8,27,-4,1,1,2,0,3,3,-1,2,1,-1,2,1,-3,3,0,0,-11,23,4,-7,3,-3,0,0,-1,1,1,-1,6,-1
KR_6749124208,440,-6,-9,-3,-13,0,1,1,-3,4,1,-2,3,1,-7,8,1,-1,1,0,0,-24,-107,1,-9,8,-7,0,0,-1,1,1,1,1,-1
KR_6776749063,420,-3,-30,-14,-5,-1,1,0,5,2,7,0,2,2,-3,4,1,-6,8,2,0,-8,66,-1,-4,5,-1,0,0,-1,1,-1,1,6,-1
KR_6752865092,420,0,-7,17,1,-2,3,1,0,0,0,0,1,1,2,1,3,1,0,1,0,4,-9,-4,-8,12,6,0,-1,1,-1,-1,1,2,-1
KR_6752274196,420,0,48,-15,-2,-6,7,1,1,2,3,4,0,4,0,2,2,-1,1,0,0,-1,-9,-2,-3,5,1,0,1,-1,-1,-1,1,4,-1
KR_6772505587,420,-4,4,4,-10,-4,6,2,1,1,2,-4,4,0,0,2,2,-3,5,2,0,-5,-20,2,-6,4,2,0,-2,-1,-1,-1,-1,1,-1
KR_6764809888,420,0,-7,-2,4,3,3,6,0,3,3,1,2,3,-2,3,1,2,0,2,0,10,11,0,-10,10,3,0,0,-1,0,0,1,4,-1
KR_6767024307,440,-3,-57,-4,-15,1,3,4,-3,3,0,-1,1,0,-9,13,4,-3,12,9,-3,-24,0,-8,-2,10,3,0,-1,-1,1,-1,-1,3,-1
KR_6751017408,420,3,5,16,2,-2,3,1,2,1,3,-1,3,2,4,1,5,-1,2,1,0,-2,64,3,-5,2,-30,0,0,-1,-1,1,1,3,-1
KR_6751379220,420,2,-78,25,-3,-5,6,1,4,1,5,0,1,1,0,2,2,-2,3,1,0,2,34,0,-4,4,-3,0,-1,-1,-1,-1,-1,4,-1
KR_6768513385,440,-6,-39,12,-18,-3,3,0,0,5,5,-9,10,1,0,1,1,-6,6,0,0,-16,-7,-7,-2,9,-4,0,-3,-1,-1,-1,-1,1,-1
KR_6777730082,420,-1,14,-13,-9,-2,2,0,0,3,3,-1,1,0,-5,7,2,-1,1,0,0,-6,7,6,-10,4,-1,0,-1,-1,-1,-1,-1,2,-1
KR_6777537904,420,-6,-99,-24,-9,-1,2,1,-3,5,2,-2,3,1,-2,2,0,-1,1,0,0,-6,-8,-2,-4,6,-4,0,-3,-1,-1,-1,-1,3,-1
KR_6735960690,420,-1,-15,-23,0,2,2,4,3,3,6,2,0,2,-1,7,6,-6,6,0,1,-1,-2,2,-5,3,1,0,-1,-1,1,-1,1,4,-1
KR_6744176600,420,-7,-64,-9,-16,-5,5,0,0,4,4,0,4,4,-9,11,2,-2,3,1,0,-24,-1,-6,-2,8,1,0,-2,-1,-1,-1,1,3,-1
KR_6745111259,420,-4,-67,20,-9,-2,2,0,0,1,1,-5,5,0,-2,2,0,0,0,0,0,-6,-23,-6,-2,8,4,0,-2,-1,-1,-1,-1,2,-1
KR_6775753569,420,-3,-47,30,-3,-1,2,1,-1,5,4,-1,2,1,3,2,5,-3,3,0,-1,-10,13,0,-6,6,2,0,-1,-1,1,-1,-1,2,-1
KR_6731423792,420,-4,-28,-3,-18,-1,1,0,-1,2,1,-1,3,2,-12,12,0,-3,5,2,-2,-21,-132,-6,-3,9,0,0,-1,-1,-1,-1,-1,4,-1
KR_6771082109,420,-5,-49,-16,-15,-2,3,1,-4,4,0,-5,5,0,-7,8,1,3,0,3,-1,-25,5,-2,-6,8,-8,0,-1,-1,-1,-1,-1,3,-1
KR_6715011801,420,2,-24,17,1,-3,4,1,-1,3,2,5,3,8,-2,6,4,2,0,2,-2,-2,5,2,-8,6,1,0,-1,-1,-1,-1,-1,3,-1
KR_6763532076,420,-2,-43,12,-2,0,1,1,3,1,4,-6,7,1,2,2,4,-1,2,1,0,1,-4,-5,-3,8,-1,0,-1,1,-1,-1,-1,2,-1
KR_6751741489,420,0,5,35,-7,-4,5,1,-2,2,0,-3,4,1,2,0,2,0,0,0,0,-11,-17,-7,-2,9,-2,0,0,1,-1,0,-1,4,-1
KR_6684306952,420,-5,-57,-27,-16,-2,3,1,-6,6,0,-1,2,1,-5,7,2,-2,2,0,0,-27,35,-1,-5,6,-23,0,0,-1,1,1,-1,6,-1
KR_6774188664,420,1,-13,23,3,-1,2,1,4,0,4,1,0,1,-1,3,2,0,1,1,0,10,30,6,-7,1,-5,0,0,1,-1,1,-1,6,-1
KR_6773192873,420,1,-41,18,-4,0,0,0,2,4,6,-4,5,1,0,1,1,-2,4,2,0,-2,34,-3,-5,8,-26,0,0,1,-1,0,-1,3,-1
KR_6758622555,420,-4,-42,-30,-12,-2,4,2,-5,6,1,1,2,3,-6,7,1,0,3,3,0,-21,21,6,-8,2,-2,0,-1,-1,1,-1,-1,1,-1
KR_6707299440,440,-2,-72,3,-1,-1,7,6,-3,4,1,6,2,8,-3,4,1,0,0,0,0,5,4,4,-7,3,-3,0,-2,-1,-1,-1,1,5,-1
KR_6768725228,420,-5,11,-12,-6,1,5,6,-3,4,1,-6,7,1,3,1,4,-1,2,1,0,2,2,3,-5,2,-4,0,-1,1,-1,-1,-1,5,-1
KR_6775370165,420,0,5,29,-8,-1,3,2,0,2,2,-1,1,0,-4,5,1,-2,2,0,0,-9,-6,-6,-4,10,-2,0,-1,-1,1,-1,-1,5,-1
KR_6770027370,420,-4,21,7,-7,-1,4,3,-1,4,3,-4,4,0,-2,2,0,1,0,1,-1,0,1,-4,-6,10,5,0,-1,0,-1,-1,-1,0,-1
KR_6750980926,420,-2,17,-15,-6,-1,2,1,0,2,2,-4,6,2,-2,2,0,1,0,1,0,-2,-2,3,-7,4,-7,0,-1,-1,-1,-1,-1,5,-1
KR_6758385002,420,0,-50,16,-4,5,1,6,-1,3,2,-3,4,1,-3,3,0,-2,2,0,1,-15,-10,0,-7,7,0,0,0,-1,1,1,1,5,-1
KR_6769057684,420,-6,-82,-53,-8,-2,2,0,-7,8,1,0,0,0,1,0,1,0,1,1,1,-5,-4,0,-5,5,1,0,-1,-1,-1,-1,1,4,-1
KR_6771826745,420,2,-43,6,2,1,1,2,4,3,7,0,1,1,-2,6,4,-1,1,0,0,0,-6,-5,-6,11,0,0,0,-1,-1,-1,1,2,-1
KR_6774579469,420,-2,-94,-21,-5,-1,3,2,-4,6,2,-2,4,2,-1,4,3,3,0,3,0,1,38,-1,-6,7,1,0,0,-1,1,0,-1,4,-1
KR_6770324557,420,2,12,-24,6,0,0,0,4,3,7,1,1,2,-1,3,2,2,1,3,1,7,4,3,-7,4,-4,0,0,-1,1,1,1,6,-1
KR_6775227393,420,-4,-68,-1,-16,-4,6,2,-4,5,1,0,1,1,-3,5,2,-5,5,0,1,-13,-6,-3,-4,7,1,0,-2,-1,1,-1,1,2,-1
KR_6766873606,440,5,45,31,9,0,2,2,3,1,4,-1,2,1,8,2,10,-1,2,1,0,8,13,-1,-3,4,8,0,-1,1,-1,-1,-1,6,-1
KR_6765250570,420,-3,-39,-9,-11,-3,3,0,1,3,4,0,2,2,-8,8,0,-1,2,1,0,-13,-8,-1,-4,5,-2,0,-2,0,-1,-1,-1,0,-1
KR_6776786085,420,-2,-61,5,-11,1,3,4,-3,4,1,-4,6,2,-5,5,0,0,0,0,0,-16,-2,-1,-7,8,-2,0,-1,-1,-1,-1,1,6,-1
KR_6776448737,420,-3,-88,-12,-1,-3,3,0,2,2,4,2,1,3,0,3,3,-2,3,1,0,3,18,0,-7,7,1,0,0,1,-1,-1,-1,3,-1
KR_6759149329,420,-5,-83,-56,-6,-4,4,0,0,2,2,3,0,3,-6,7,1,1,0,1,-1,-3,-28,-2,-3,5,0,0,-3,-1,-1,-1,-1,4,-1
KR_6729684979,420,-1,-31,-33,-1,0,5,5,-3,4,1,3,3,6,0,2,2,-1,1,0,0,4,2,-2,-5,7,-4,0,-1,-1,1,-1,-1,5,-1
KR_6770417934,420,-3,0,-25,1,1,2,3,1,2,3,0,2,2,-1,3,2,0,2,2,0,2,8,-1,-3,4,-2,0,-1,-1,-1,-1,1,4,-1
KR_6773832217,420,-5,-69,0,-11,-3,5,2,-6,7,1,2,2,4,-4,5,1,0,0,0,0,-18,281,1,-6,5,-4,0,-1,-1,1,-1,1,5,-1
KR_6756307330,420,-1,-48,-9,-2,-2,4,2,2,6,8,-4,6,2,3,2,5,-1,2,1,-3,-4,3,-1,-8,9,-6,0,-1,-1,1,-1,-1,5,-1
KR_6777722245,420,-3,1,-8,-4,-2,3,1,-1,4,3,1,0,1,3,1,4,-5,5,0,0,-6,-3,4,-8,4,-3,0,-1,-1,-1,-1,-1,6,-1
KR_6770288177,440,2,-60,24,-1,3,0,3,-5,6,1,2,3,5,0,1,1,-1,1,0,0,2,-13,-4,-3,7,8,0,0,1,-1,0,-1,1,-1
KR_6774059445,420,2,8,-1,8,3,0,3,3,1,4,3,2,5,2,1,3,-3,4,1,0,14,31,2,-6,4,0,0,0,1,-1,-1,1,4,-1
KR_6774699424,420,0,-10,0,-2,-2,4,2,0,4,4,0,1,1,0,1,1,0,1,1,0,-6,-5,0,-7,7,-3,0,-1,1,-1,1,-1,4,-1
KR_6774110871,420,-3,-14,-28,1,2,2,4,4,2,6,-2,4,2,-1,2,1,-2,4,2,0,1,2,5,-12,7,6,0,0,0,-1,-1,1,0,-1
KR_6751864833,420,1,-17,16,0,-1,2,1,-3,3,0,5,1,6,-1,4,3,0,2,2,0,-2,0,-2,-4,6,0,0,0,1,-1,0,1,3,-1
KR_6773073763,420,0,-53,-11,-4,-1,3,2,0,3,3,0,7,7,-3,3,0,0,2,2,0,-1,5,4,-8,4,2,0,0,-1,-1,-1,-1,3,-1
KR_6777504503,420,-3,-59,-4,0,3,2,5,-2,6,4,3,3,6,-2,3,1,-2,2,0,0,7,-7,1,-7,6,-4,0,-2,1,1,-1,-1,3,-1
KR_6772195800,440,2,-57,-9,-1,0,1,1,0,2,2,-1,3,2,-3,4,1,3,0,3,-2,-2,7,-5,-4,9,-6,0,-2,-1,-1,-1,-1,2,-1
KR_6776480237,420,-6,-43,-11,-11,-2,2,0,-7,7,0,-3,5,2,-1,3,2,2,0,2,-2,-22,10,-2,-4,6,-6,0,-2,1,-1,-1,-1,6,-1
KR_6771107451,420,0,-26,-1,-3,0,4,4,-1,2,1,-1,2,1,0,1,1,-1,1,0,0,-5,0,-2,-5,7,-2,0,0,-1,1,1,1,1,-1
KR_6738368911,420,-2,-66,19,-4,-6,6,0,0,5,5,1,3,4,0,2,2,1,1,2,0,3,3,-6,-3,9,1,0,-1,1,-1,-1,-1,5,-1
KR_6766042496,420,-3,-41,4,-7,1,1,2,-2,3,1,-3,3,0,-2,4,2,-1,1,0,0,-11,-3,-4,-7,11,0,0,-1,1,1,-1,1,1,-1
KR_6772401939,420,-2,14,-11,-6,0,2,2,-1,2,1,-1,2,1,-4,5,1,0,3,3,0,-6,-3,-1,-4,5,3,0,-1,-1,0,-1,-1,4,-1
KR_6735359345,420,-6,-42,-31,-6,-1,2,1,-2,5,3,-2,2,0,-2,3,1,1,0,1,0,-10,11,7,-14,7,-9,0,-1,-1,-1,-1,1,1,-1
KR_6733884880,420,-4,-35,-54,-16,-4,4,0,1,6,7,-4,5,1,-7,8,1,-2,3,1,-1,-31,-67,5,-11,6,-3,0,-2,-1,-1,-1,-1,3,-1
KR_6774728423,420,-1,5,-5,-2,-3,3,0,-1,3,2,-1,2,1,3,2,5,0,0,0,0,-3,-2,0,-5,5,-4,0,0,-1,-1,0,-1,6,-1
KR_6773455410,420,0,31,1,-1,1,3,4,-3,4,1,-4,4,0,4,0,4,1,0,1,0,-1,-5,6,-10,4,0,0,0,-1,1,0,-1,3,-1
KR_6775252834,420,0,-43,24,-1,1,2,3,-2,2,0,-1,2,1,1,1,2,0,3,3,0,-3,-6,-5,-4,9,-2,0,0,0,1,0,1,0,-1
KR_6766616269,420,-1,-35,8,0,1,2,3,-2,3,1,6,0,6,-5,6,1,0,0,0,0,-3,-27,-2,-5,7,2,0,0,1,-1,-1,-1,1,-1
KR_6765320682,420,-5,-40,-28,-3,-5,7,2,0,3,3,1,1,2,-1,6,5,2,1,3,0,-1,2,2,-6,4,-1,0,-1,-1,1,-1,1,2,-1
KR_6747590457,420,-3,-22,-3,-7,-2,2,0,1,4,5,-1,1,0,-4,4,0,-1,3,2,0,-13,-8,-3,-4,7,2,0,0,1,1,0,1,3,-1
KR_6748545944,420,-4,-84,-53,-7,-1,2,1,-5,5,0,-4,5,1,1,3,4,2,1,3,0,-3,-3,4,-9,5,-4,0,-2,1,1,-1,-1,5,-1
KR_6766071095,420,-1,24,0,-4,-2,2,0,-2,3,1,-2,2,0,1,0,1,1,0,1,0,-1,7,3,-6,3,0,0,0,1,-1,0,-1,3,-1
KR_6740598174,420,-2,-64,-20,2,-2,3,1,7,5,12,-4,6,2,2,1,3,-1,2,1,0,12,-15,-4,-5,9,2,0,-2,-1,-1,-1,1,6,-1
KR_6777379868,420,0,-7,8,-10,-3,3,0,-6,7,1,1,0,1,-1,4,3,-1,3,2,0,-6,-27,-4,-4,8,4,0,-1,-1,-1,-1,-1,2,-1
KR_6768597768,420,-1,2,13,-7,-5,5,0,4,0,4,-1,1,0,-4,4,0,-1,1,0,0,-5,-1,-3,-4,7,-1,0,-1,1,-1,-1,-1,6,-1
KR_6772762708,440,-1,4,11,-6,-2,4,2,-2,3,1,-2,3,1,1,6,7,-1,5,4,0,-5,2,1,-5,4,6,0,1,1,1,1,1,2,-1
KR_6766645896,420,2,-20,0,2,2,1,3,-2,5,3,-2,3,1,2,2,4,2,0,2,0,2,-8,3,-10,7,-2,0,0,-1,-1,1,1,5,-1
KR_6663942592,420,-1,49,9,0,4,0,4,-2,4,2,-1,2,1,-1,4,3,0,1,1,0,-2,-1,2,-6,4,-1,0,0,1,-1,0,1,4,-1
KR_6777271733,420,-2,8,-17,-2,2,2,4,-2,4,2,0,3,3,-3,4,1,1,1,2,-1,-8,8,0,-8,8,-5,0,0,1,1,0,-1,5,-1
KR_6741114732,420,-2,16,0,-7,-1,2,1,1,5,6,0,3,3,-6,7,1,-1,2,1,0,-11,15,-4,-4,8,2,0,0,-1,1,-1,-1,4,-1
KR_6729573594,420,-4,-53,10,-4,-2,3,1,-2,5,3,-3,3,0,2,0,2,1,0,1,-1,-2,6,-2,-5,7,0,0,-2,-1,-1,-1,-1,5,-1
KR_6776495475,420,1,18,-1,-1,0,1,1,1,6,7,-3,4,1,1,2,3,0,0,0,0,-6,28,0,-6,6,-1,0,0,1,-1,0,-1,2,-1
KR_6739728354,420,-7,-93,-17,-18,-2,2,0,0,1,1,-5,6,1,-10,11,1,-1,1,0,1,-18,-41,-6,-4,10,2,0,-3,-1,-1,-1,1,3,-1
KR_6766955952,420,-4,-47,-26,0,-4,5,1,0,4,4,0,2,2,3,1,4,1,1,2,0,2,2,3,-6,3,1,0,-2,1,-1,-1,-1,2,-1
KR_6660783876,420,-2,9,-26,-6,0,2,2,-7,8,1,1,1,2,0,3,3,0,1,1,0,-9,-32,2,-7,5,1,0,0,-1,-1,1,-1,5,-1
KR_6776839748,420,-1,-20,-16,-5,0,1,1,-3,4,1,-3,6,3,1,1,2,0,1,1,0,-7,5,1,-5,4,-8,0,-1,-1,-1,-1,1,3,-1
KR_6726647247,420,0,20,13,-4,3,0,3,-1,4,3,-5,6,1,0,2,2,-1,1,0,-2,-6,21,3,-10,7,-2,0,1,-1,-1,1,-1,3,-1
KR_6772721091,420,0,35,-2,-6,0,1,1,-6,8,2,-2,2,0,0,2,2,2,0,2,0,-9,7,3,-6,3,-7,0,-2,1,-1,-1,1,1,-1
KR_6737331896,420,-4,-47,-35,-15,0,2,2,-5,8,3,-1,2,1,-7,9,2,-2,3,1,0,-27,14,2,-10,8,-6,0,-3,-1,-1,-1,-1,4,-1
KR_6776247846,420,1,37,3,-2,1,1,2,5,0,5,-7,7,0,0,0,0,-1,1,0,0,-4,43,2,-7,5,-4,0,1,1,-1,1,-1,1,-1
KR_6741219119,420,-5,-62,-28,-16,-6,7,1,-10,11,1,2,0,2,0,1,1,-2,3,1,0,-16,-2,-4,-5,9,2,0,-2,-1,-1,-1,-1,2,-1
KR_6760046535,440,-6,-61,-23,-8,-1,1,0,2,4,6,-5,7,2,1,1,2,-5,6,1,0,3,11,5,-6,1,1,0,-1,1,-1,1,-1,6,-1
KR_6759381575,420,-1,-97,-8,2,-1,2,1,0,3,3,3,0,3,0,0,0,0,1,1,0,7,10,1,-6,5,2,0,0,-1,1,1,1,4,-1
KR_6775554724,420,-10,-156,-34,-17,-6,6,0,-3,5,2,-3,3,0,-5,6,1,0,1,1,-1,-14,-9,-5,-5,10,-4,0,-4,-1,-1,-1,-1,5,-1
KR_6728003125,420,0,-67,-4,1,-2,4,2,2,2,4,-2,2,0,1,3,4,2,0,2,-1,4,-260,-3,-6,9,3,0,1,1,1,1,-1,5,-1
KR_6776814792,420,-4,-67,-17,-13,-1,1,0,-5,5,0,-4,6,2,-6,6,0,3,1,4,-1,-22,-3,-1,-6,7,0,0,-2,-1,-1,-1,-1,6,-1
KR_6772509062,420,-3,-42,-33,0,-1,2,1,-1,3,2,4,0,4,-2,4,2,0,0,0,0,4,-112,4,-7,3,1,0,0,1,-1,0,1,3,-1
KR_6741642790,440,3,-4,13,5,2,0,2,4,2,6,3,0,3,-2,3,1,-2,2,0,0,0,255,-1,-9,10,-1,0,-1,-1,1,1,-1,6,-1
KR_6749727827,420,1,-39,-2,-7,-2,3,1,-2,2,0,1,1,2,3,1,4,-7,8,1,-2,-15,-13,-7,0,7,4,0,-2,1,1,-1,-1,2,-1
KR_6756517246,420,-6,-39,2,-8,-4,5,1,-6,7,1,-2,6,4,1,2,3,3,1,4,0,-9,-4,-2,-4,6,-1,0,-1,1,1,-1,1,6,-1
KR_6768361513,420,-2,-30,-3,-5,0,0,0,-4,9,5,2,1,3,-2,3,1,-1,3,2,0,-9,7,1,-7,6,-6,0,-1,-1,1,-1,1,2,-1
KR_6768684758,420,1,11,12,-1,1,3,4,-3,3,0,2,2,4,-1,2,1,0,0,0,0,2,-20,3,-10,7,-4,0,-1,1,1,-1,-1,4,-1
KR_6774248876,420,-3,-5,-4,-16,3,1,4,0,1,1,-6,9,3,-9,10,1,-4,9,5,-2,-12,-8,-4,-2,6,-2,0,0,-1,-1,0,-1,3,-1
KR_6732590205,420,1,-4,-16,0,-1,2,1,-2,6,4,2,0,2,1,1,2,0,1,1,-1,0,-37,3,-8,5,-1,0,0,1,-1,0,-1,1,-1
KR_6717154920,420,-3,-55,-40,-6,-1,2,1,-1,2,1,1,1,2,-4,5,1,-1,1,0,0,-10,-8,-2,-3,5,2,0,0,-1,1,0,-1,1,-1
KR_6777068192,420,0,-19,-16,7,-2,5,3,0,2,2,2,0,2,6,1,7,1,1,2,0,12,-28,3,-5,2,5,0,-2,0,-1,-1,1,0,-1
KR_6777764100,420,-2,-31,-29,-8,1,1,2,-6,7,1,0,0,0,-2,2,0,-1,1,0,0,-7,-2,0,-6,6,1,0,-1,-1,-1,-1,1,5,-1
KR_6685644511,420,-3,-30,-12,-16,-2,3,1,-2,3,1,-5,6,1,-7,7,0,0,0,0,0,-25,6,-4,-4,8,-3,0,-2,-1,-1,-1,-1,1,-1
KR_6774111416,420,-8,-83,-44,-11,1,3,4,-1,2,1,-2,4,2,-5,11,6,-4,4,0,-1,-11,-6,3,-9,6,1,0,-1,-1,1,-1,-1,3,-1
KR_6739004539,420,-12,-214,-59,-17,-4,4,0,-2,3,1,-6,6,0,-5,6,1,0,1,1,0,-19,-97,-5,-3,8,4,-2,-6,-1,-1,-1,-1,6,-1
KR_6768297002,420,1,-22,24,-4,2,0,2,-1,4,3,-4,4,0,0,1,1,-1,1,0,0,0,-6,1,-5,4,0,0,0,-1,-1,0,1,5,-1
KR_6772839701,420,-1,97,-19,1,2,2,4,-2,3,1,-3,5,2,4,1,5,0,0,0,0,2,9,4,-6,2,0,0,3,-1,1,1,-1,5,-1
KR_6753745489,420,-2,28,-20,1,-1,1,0,2,4,6,2,0,2,-2,4,2,0,1,1,1,0,11,0,-5,5,2,0,0,-1,0,0,1,3,-1
KR_6769781940,420,-2,26,-26,-3,-3,3,0,1,5,6,2,1,3,-1,2,1,-2,2,0,0,-4,-24,-3,-7,10,3,0,0,-1,-1,0,-1,5,-1
KR_6765510737,420,0,-5,-7,-5,-1,1,0,0,3,3,-2,2,0,0,2,2,-2,6,4,0,-7,-12,-4,-2,6,3,0,-1,1,-1,-1,-1,6,-1
KR_6754983596,420,2,-17,44,-5,-3,3,0,3,2,5,-4,4,0,-2,2,0,1,0,1,0,-4,1,-3,-6,9,4,0,0,-1,-1,0,1,4,-1
KR_6755279939,420,-2,-71,28,-1,-4,4,0,0,2,2,4,3,7,-2,3,1,1,1,2,0,-1,-10,3,-5,2,2,0,-2,1,-1,-1,-1,4,-1
KR_6770101370,420,1,20,-30,2,3,0,3,1,2,3,-3,4,1,-1,2,1,2,0,2,0,9,-5,0,-7,7,1,0,0,-1,1,1,-1,4,-1
KR_6753779466,420,-2,-17,12,-3,0,1,1,-3,4,1,2,0,2,-1,2,1,-1,4,3,0,-5,-4,-1,-7,8,-7,0,0,-1,-1,0,1,1,-1
KR_6768311187,440,4,46,36,2,1,2,3,1,2,3,5,2,7,1,5,6,-6,7,1,0,1,-7,-5,-3,8,-2,0,0,1,0,1,1,3,-1
KR_6767819299,420,3,69,16,9,2,1,3,5,2,7,-7,7,0,10,0,10,-1,3,2,3,19,34,2,-7,5,-4,0,2,-1,1,1,-1,5,-1
KR_6752886169,420,-1,-45,-37,1,2,3,5,1,2,3,0,1,1,-1,8,7,-1,3,2,-1,-10,-29,3,-7,4,1,0,-2,-1,-1,-1,-1,5,-1
KR_6770109280,440,0,-23,20,2,2,2,4,-1,4,3,-3,4,1,4,0,4,0,2,2,0,0,-2,-3,-3,6,-3,0,0,-1,1,1,1,6,-1
KR_6776919364,420,-2,-40,7,0,1,1,2,0,3,3,-2,3,1,1,5,6,0,1,1,0,-3,11,-7,-5,12,1,0,-1,1,-1,-1,-1,3,-1
KR_6771900550,420,-4,-12,-14,-9,-3,3,0,0,5,5,-4,5,1,0,4,4,-2,2,0,0,-8,-10,1,-9,8,3,0,0,1,-1,-1,1,6,-1
KR_6777315860,420,-1,27,-40,3,0,1,1,3,0,3,0,0,0,1,2,3,-1,2,1,0,4,-38,1,-6,5,3,0,0,1,-1,0,1,4,-1
KR_6749291492,440,0,-11,4,6,-2,3,1,1,3,4,8,2,10,-1,4,3,0,1,1,0,2,5,1,-4,3,0,0,-1,1,0,-1,1,1,-1
KR_6775615281,420,-2,-26,-20,-8,2,0,2,-1,4,3,-4,7,3,-3,4,1,-2,2,0,0,-14,-10,-2,-7,9,2,0,0,-1,-1,-1,-1,1,-1
KR_6738404915,440,-6,-39,-32,-10,0,0,0,-5,7,2,-3,4,1,-2,3,1,0,2,2,0,-10,-6,0,-2,2,-2,0,-1,-1,-1,-1,-1,4,-1
