matchId,queueId,Diff_LV,Diff_CS,Diff_jglCS,Diff-K,Diff-K-top,K-WIN-top,K-LOSE-top,Diff-K-jug,K-WIN-jug,K-LOSE-jug,Diff-K-mid,K-WIN-mid,K-LOSE-mid,Diff-K-ad,K-WIN-ad,K-LOSE-ad,Diff-K-sup,K-WIN-sup,K-LOSE-sup,invadeKill,Diff-A,Diff_WARDplaced,Diff-ControlWARDplaced,LOSE_controlWARDPlaced,WIN_controlWARDPlaced,Diff_WARDkill,Diff_Inhibitor,Diff_TOWERkill,Diff_FirstDRAGON,Diff_FirstHERALD,Diff_Firsttower,Diff_FirstBLOOD,dragonType,result
KR_6749090521,420,2,-45,13,4,4,1,5,1,2,3,2,2,4,-3,5,2,0,1,1,1,-7,13,0,-6,6,1,0,-1,1,1,-1,1,1,-1
KR_6767136193,420,-4,-71,-22,-12,1,1,2,-2,2,0,-4,7,3,-7,7,0,0,0,0,-1,-12,-10,5,-9,4,-2,0,-1,-1,0,-1,-1,1,-1
KR_6765422028,420,0,21,35,0,2,0,2,-4,6,2,0,2,2,-1,2,1,3,0,3,0,-5,87,-3,-2,5,-2,0,1,1,1,1,-1,1,-1
KR_6765847553,420,0,21,27,-4,-1,2,1,0,1,1,1,2,3,-6,11,5,2,1,3,1,-2,74,1,-7,6,8,0,3,-1,1,1,1,6,-1
KR_6723659478,420,0,20,-8,-1,0,0,0,0,1,1,1,0,1,-1,3,2,-1,4,3,0,-7,-138,-3,-6,9,3,0,0,1,-1,0,1,4,-1
KR_6760174323,420,-6,-60,-63,-13,-4,4,0,-5,6,1,-2,3,1,0,1,1,-2,3,1,0,-10,17,-2,-3,5,3,0,-2,-1,1,-1,1,3,-1
KR_6766157805,420,-1,1,-28,-11,0,1,1,-9,10,1,-3,4,1,2,3,5,-1,2,1,-1,-10,-1,2,-5,3,-3,0,-1,1,-1,-1,1,3,-1
KR_6746174381,420,-3,-81,-4,-5,-5,5,0,-1,3,2,2,1,3,1,0,1,-2,2,0,0,2,-10,-3,-2,5,6,0,-2,-1,-1,-1,1,5,-1
KR_6749090310,440,-1,-50,-10,-1,-2,3,1,1,2,3,-1,7,6,4,1,5,-3,4,1,0,7,-4,-3,-4,7,1,0,-1,-1,-1,-1,1,1,-1
KR_6744416145,420,0,16,8,-1,2,2,4,-1,2,1,3,0,3,-2,7,5,-3,3,0,0,-5,2,-2,-6,8,0,0,0,1,-1,1,-1,4,-1
KR_6767370908,420,-2,12,11,1,-5,5,0,4,2,6,1,2,3,1,1,2,0,1,1,0,13,5,3,-7,4,1,0,0,-1,1,0,-1,3,-1
KR_6756545550,420,-3,-29,8,-11,-3,3,0,-4,4,0,-1,3,2,0,3,3,-3,3,0,0,-21,0,0,-3,3,-3,0,-1,-1,1,1,-1,6,-1
KR_6767651826,420,0,-20,-34,-5,-4,4,0,4,1,5,-2,8,6,-6,7,1,3,1,4,0,-5,302,0,-5,5,-1,0,-1,-1,-1,-1,1,1,-1
KR_6768913985,420,-1,-63,-8,4,-1,1,0,3,1,4,1,0,1,2,1,3,-1,3,2,0,7,-115,1,-7,6,0,0,0,-1,-1,0,-1,4,-1
KR_6605645939,420,2,16,16,4,1,1,2,-1,4,3,4,1,5,2,2,4,-2,3,1,0,-1,31,6,-8,2,0,0,0,1,-1,0,1,5,-1
KR_6667260778,420,0,32,24,-5,0,1,1,0,3,3,2,1,3,-1,3,2,-6,8,2,0,-14,-7,-2,-5,7,-8,0,0,-1,1,0,-1,1,-1
KR_6744713558,420,1,10,4,2,-3,3,0,4,0,4,-1,1,0,2,0,2,0,0,0,0,5,-3,1,-5,4,6,0,-1,1,-1,-1,-1,2,-1
KR_6747294032,420,0,-42,-20,4,0,3,3,0,1,1,5,0,5,0,4,4,-1,2,1,0,4,-44,-1,-6,7,5,0,0,-1,1,1,-1,2,-1
KR_6770515231,420,3,75,-5,2,3,2,5,-3,5,2,4,0,4,-1,3,2,-1,2,1,0,-5,-131,-2,-4,6,-1,0,2,1,1,1,1,4,-1
KR_6752803418,420,-1,42,-20,-5,1,1,2,4,6,10,-5,5,0,-7,10,3,2,1,3,0,-10,-4,-7,-1,8,2,0,0,-1,1,0,1,1,-1
KR_6687361624,420,4,47,-11,10,2,1,3,3,1,4,1,1,2,4,5,9,0,1,1,0,11,4,0,-6,6,0,0,1,-1,-1,1,-1,4,-1
KR_6768778085,440,-8,-155,4,-2,-6,6,0,3,1,4,3,2,5,-3,7,4,1,2,3,0,-10,0,-1,-3,4,1,0,-3,0,0,-1,1,0,-1
KR_6767457351,420,-2,-19,-13,3,-4,4,0,2,1,3,5,0,5,3,1,4,-3,3,0,0,10,-41,1,-4,3,13,0,0,1,1,-1,1,4,-1
KR_6768465777,420,0,-68,-26,5,-1,2,1,1,5,6,1,4,5,5,0,5,-1,3,2,0,13,-3,-3,-4,7,-6,0,0,1,1,-1,-1,2,-1
KR_6764124462,420,-3,-7,-10,-6,-5,6,1,-4,5,1,-2,7,5,2,2,4,3,1,4,0,-6,232,-2,-5,7,4,0,0,1,-1,1,1,3,-1
KR_6759086489,440,-2,-45,-30,-10,0,2,2,-9,9,0,1,2,3,-4,5,1,2,0,2,0,-12,9,0,-5,5,-10,0,0,-1,-1,0,-1,6,-1
KR_6749348861,440,2,-88,34,9,-4,5,1,3,2,5,6,0,6,5,3,8,-1,1,0,0,9,11,8,-10,2,0,0,-1,1,1,-1,1,6,-1
KR_6768098895,420,-5,-42,-14,-20,0,0,0,-10,10,0,0,1,1,-8,10,2,-2,2,0,0,-21,-137,-5,-2,7,0,0,-4,-1,-1,-1,-1,1,-1
KR_6763501564,420,-1,-27,0,-3,-2,3,1,-2,2,0,-1,2,1,2,4,6,0,1,1,2,-6,5,0,-6,6,-5,0,-1,1,-1,-1,1,6,-1
KR_6680851178,420,0,-19,16,1,-3,3,0,3,5,8,0,4,4,-2,2,0,3,1,4,0,10,45,2,-7,5,1,0,0,-1,1,1,1,3,-1
KR_6770278096,420,0,47,-11,2,1,0,1,1,2,3,-2,6,4,1,3,4,1,1,2,0,4,5,0,-2,2,0,0,0,1,-1,1,-1,5,-1
KR_6766680487,420,-8,-77,-60,-12,-4,5,1,-7,8,1,-1,3,2,2,2,4,-2,2,0,0,-13,13,1,-7,6,-4,0,-3,-1,-1,-1,1,6,-1
KR_6762164275,420,-1,30,-19,-4,-2,3,1,-3,4,1,-1,1,0,2,0,2,0,1,1,1,-2,37,1,-4,3,0,0,-1,0,-1,-1,1,0,-1
KR_6732008134,440,1,-12,8,7,1,0,1,0,4,4,5,1,6,1,1,2,0,2,2,1,4,2,1,-3,2,3,0,0,-1,1,0,1,3,-1
KR_6739023759,420,2,4,40,10,0,2,2,2,2,4,4,2,6,1,2,3,3,1,4,0,11,-7,-3,-3,6,5,0,1,1,1,1,-1,2,-1
KR_6755682914,440,1,60,-4,1,-3,4,1,-4,4,0,8,1,9,-3,5,2,3,0,3,0,-5,-3,3,-6,3,6,0,1,1,-1,1,1,4,-1
KR_6727077592,420,-6,-91,-4,-8,1,0,1,-4,6,2,0,2,2,-4,6,2,-1,2,1,0,-7,18,3,-8,5,-5,0,0,-1,1,-1,-1,6,-1
KR_6714571084,420,-4,-59,-3,-10,-2,2,0,-5,6,1,0,2,2,-5,7,2,2,0,2,0,-11,40,-1,-3,4,-18,0,-1,-1,1,-1,-1,4,-1
KR_6758814669,420,-1,-11,-28,-6,-1,1,0,2,2,4,-4,6,2,-3,3,0,0,0,0,0,-6,8,-4,-4,8,1,0,-1,-1,-1,-1,-1,6,-1
KR_6662179114,440,-4,-65,-21,-13,0,1,1,0,3,3,-1,4,3,-8,9,1,-4,6,2,0,-14,-5,1,-4,3,-1,0,-3,0,0,-1,1,0,-1
KR_6712548908,420,-1,-6,1,-1,1,3,4,0,3,3,1,2,3,-3,4,1,0,0,0,0,-8,-6,-2,-7,9,2,0,1,-1,1,1,1,4,-1
KR_6769709361,420,-1,-53,0,2,-5,6,1,3,0,3,3,2,5,0,3,3,1,1,2,0,4,36,4,-7,3,-4,0,1,1,1,1,1,1,-1
KR_6764165176,420,1,4,28,-3,2,1,3,-1,5,4,-3,4,1,1,2,3,-2,2,0,0,-2,1,-1,-5,6,-5,0,-1,1,-1,-1,-1,1,-1
KR_6749417825,420,2,-42,-3,12,9,1,10,0,2,2,3,1,4,0,0,0,0,0,0,1,11,8,2,-6,4,3,0,-1,0,0,-1,1,0,-1
KR_6744750354,420,-1,37,0,-5,0,2,2,-7,8,1,5,1,6,-3,3,0,0,0,0,0,-6,-24,6,-9,3,-2,0,0,1,0,0,1,1,-1
KR_6770775519,420,0,-32,-8,2,-4,5,1,5,1,6,0,1,1,2,1,3,-1,1,0,0,2,3,0,-4,4,-3,0,0,-1,0,-1,-1,6,-1
KR_6757544337,420,-4,-60,-11,-14,-9,10,1,-3,4,1,-1,1,0,-1,1,0,0,0,0,0,-8,37,1,-5,4,-22,0,0,-1,-1,-1,-1,4,-1
KR_6768242176,440,0,-17,-16,-7,-3,3,0,-6,7,1,1,0,1,-1,3,2,2,1,3,0,-12,5,-1,-2,3,1,0,1,1,-1,1,1,2,-1
KR_6649180542,420,-4,-54,-4,-4,-1,4,3,8,0,8,-3,3,0,-8,8,0,0,0,0,0,-3,0,1,-7,6,-2,0,-1,-1,-1,-1,-1,2,-1
KR_6767024866,420,-3,20,8,-10,-2,4,2,-4,8,4,1,0,1,-5,6,1,0,0,0,0,-20,5,-3,-5,8,-3,0,0,1,-1,0,-1,3,-1
KR_6756865969,420,0,-57,17,-4,3,1,4,-1,4,3,-1,4,3,-4,6,2,-1,4,3,-1,-15,1,2,-7,5,-4,0,0,-1,1,-1,-1,4,-1
KR_6770836101,440,0,-11,17,2,-5,8,3,0,0,0,2,2,4,2,3,5,3,0,3,-1,6,-63,2,-7,5,-1,0,0,1,-1,-1,-1,2,-1
KR_6764280932,420,-2,57,-28,-1,2,0,2,1,0,1,2,0,2,-3,5,2,-3,4,1,0,-2,16,8,-10,2,2,0,1,-1,1,1,1,3,-1
KR_6769287220,420,-3,-43,5,-12,-1,2,1,-2,4,2,-9,11,2,-1,3,2,1,1,2,-1,-19,3,2,-8,6,-2,0,1,1,-1,1,-1,5,-1
KR_6755946790,420,-2,-86,28,-5,-2,4,2,1,4,5,-3,5,2,-2,5,3,1,2,3,-1,-3,8,-2,-5,7,4,0,0,-1,-1,0,-1,6,-1
KR_6747764952,420,3,-65,11,7,3,0,3,2,0,2,2,0,2,0,2,2,0,0,0,0,9,6,3,-8,5,-7,0,0,1,-1,0,-1,2,-1
KR_6770285235,420,-2,-77,27,-4,-4,6,2,7,0,7,-4,4,0,-4,5,1,1,2,3,0,-11,30,-5,-4,9,-1,0,-1,1,-1,-1,1,3,-1
KR_6760445327,440,-4,-9,22,-7,-1,4,3,-8,9,1,-1,4,3,2,3,5,1,1,2,0,-8,-171,-1,-2,3,1,0,-1,-1,-1,-1,1,5,-1
KR_6757686187,420,0,-7,20,-3,3,0,3,-3,5,2,1,3,4,-4,4,0,0,0,0,0,-9,-4,-8,-1,9,1,0,0,-1,0,-1,1,1,-1
KR_6759450009,420,-6,-112,-20,-17,-9,9,0,-1,5,4,2,3,5,-4,4,0,-5,6,1,-1,-17,12,-3,-4,7,0,0,-2,-1,-1,-1,-1,5,-1
KR_6729856921,420,-5,-23,-17,-14,-7,7,0,-5,6,1,-2,5,3,1,2,3,-1,2,1,0,-22,-10,-5,-6,11,3,0,-1,1,-1,-1,1,2,-1
KR_6701021200,420,-4,-48,-33,-15,0,2,2,-8,8,0,-6,6,0,2,3,5,-3,4,1,-3,-23,7,2,-6,4,-1,0,0,-1,-1,-1,-1,3,-1
KR_6672273830,420,-1,-33,10,-2,0,5,5,-1,3,2,1,4,5,-5,5,0,3,0,3,1,5,2,2,-5,3,-1,0,0,-1,-1,-1,1,3,-1
KR_6690394698,420,-3,22,8,-6,5,1,6,-2,3,1,4,1,5,-6,9,3,-7,8,1,1,-6,-13,2,-6,4,-7,0,-2,-1,-1,-1,1,6,-1
KR_6657089962,420,-2,-47,7,-7,-2,3,1,0,4,4,-5,5,0,1,2,3,-1,1,0,-1,-4,35,-4,-3,7,-8,0,-1,-1,-1,-1,-1,4,-1
KR_6764693288,420,-2,-36,-16,-6,-6,6,0,-4,5,1,2,0,2,1,2,3,1,0,1,0,-4,121,0,-8,8,-6,0,0,-1,-1,0,-1,4,-1
KR_6717871848,420,-3,-22,-17,-5,-5,5,0,-2,5,3,2,1,3,0,2,2,0,1,1,0,-8,3,5,-8,3,-3,0,-1,1,-1,-1,1,6,-1
KR_6769200229,440,1,-44,19,-4,3,1,4,0,4,4,-2,2,0,-2,9,7,-3,4,1,-1,-6,-10,-4,-3,7,-5,0,1,1,1,1,-1,6,-1
KR_6770045544,420,0,-30,13,-5,-6,9,3,-2,2,0,0,3,3,3,1,4,0,0,0,-1,-8,6,2,-5,3,-5,0,0,-1,1,1,1,6,-1
KR_6672441805,420,-5,-21,-11,-4,-3,5,2,3,3,6,0,6,6,-4,5,1,0,0,0,0,0,-5,-4,-5,9,-3,0,0,1,-1,-1,-1,4,-1
KR_6757815658,420,-5,-85,12,-12,-2,3,1,-3,3,0,-2,4,2,-4,5,1,-1,2,1,0,-17,2,-9,-3,12,1,0,-2,-1,-1,-1,-1,1,-1
KR_6768470107,420,-2,7,-20,-5,0,1,1,-5,7,2,-3,4,1,2,1,3,1,0,1,0,1,56,2,-5,3,-27,0,0,-1,-1,-1,-1,2,-1
KR_6745755224,420,-5,-91,-1,-13,-7,8,1,0,2,2,-1,4,3,-7,8,1,2,0,2,0,-10,-6,-9,0,9,5,0,-2,-1,1,-1,-1,5,-1
KR_6761814049,440,-4,-85,-21,-7,-2,3,1,-4,5,1,1,2,3,-2,6,4,0,0,0,0,-5,-10,0,-5,5,0,0,-1,-1,1,-1,-1,6,-1
KR_6728616237,440,-2,-78,16,-2,-1,3,2,2,2,4,-1,3,2,-3,5,2,1,2,3,0,8,-6,-5,-2,7,4,0,0,-1,-1,0,-1,2,-1
KR_6762743248,420,0,75,-6,-1,-1,6,5,-1,3,2,4,2,6,-3,7,4,0,0,0,1,-12,0,-4,-4,8,2,0,2,-1,1,1,-1,3,-1
KR_6766110003,440,-3,-7,15,-3,1,1,2,3,1,4,-2,3,1,-5,6,1,0,0,0,0,-2,2,1,-3,2,-2,0,0,0,1,0,1,0,-1
KR_6683038189,420,-2,-1,36,-9,-2,3,1,-7,9,2,2,2,4,-1,2,1,-1,1,0,0,-8,-105,-3,-4,7,0,0,0,1,-1,-1,-1,1,-1
KR_6762828833,420,-2,-30,18,-9,-3,3,0,-1,2,1,-3,4,1,-1,2,1,-1,1,0,-1,-12,14,-7,-2,9,4,0,-1,0,-1,-1,-1,0,-1
KR_6739014021,420,1,-5,6,-6,-2,4,2,-4,4,0,1,2,3,2,2,4,-3,4,1,0,-6,-13,4,-8,4,-2,0,-1,1,-1,-1,-1,3,-1
KR_6709090314,420,-3,-41,24,-4,-3,4,1,1,2,3,-2,3,1,-1,4,3,1,1,2,0,3,-11,-5,-6,11,-7,0,-2,-1,-1,-1,-1,2,-1
KR_6768897036,420,-2,-37,-1,-4,-2,2,0,-1,1,0,-3,4,1,1,0,1,1,0,1,0,-1,8,3,-5,2,-1,0,0,-1,-1,-1,-1,1,-1
KR_6768696108,420,0,-29,10,3,0,1,1,0,2,2,2,0,2,0,2,2,1,2,3,0,5,14,-2,-1,3,0,0,1,-1,1,1,-1,3,-1
KR_6769233000,420,0,-24,-12,-3,-2,5,3,-1,3,2,-5,7,2,6,2,8,-1,2,1,0,9,-35,1,-7,6,2,0,-1,1,-1,-1,-1,6,-1
KR_6692982857,420,-1,16,-16,-8,-3,4,1,0,4,4,-1,4,3,0,1,1,-4,4,0,-1,-10,-46,-4,-2,6,7,0,0,-1,-1,-1,-1,2,-1
KR_6734737178,420,-1,25,-12,-3,-2,2,0,-1,3,2,4,1,5,-1,3,2,-3,4,1,0,2,-2,-4,-5,9,3,0,-1,1,-1,-1,-1,1,-1
KR_6759983535,420,-6,-102,-5,-16,1,0,1,-4,8,4,-2,3,1,-8,8,0,-3,3,0,0,-17,-9,-2,-6,8,-1,0,-2,-1,1,-1,-1,1,-1
KR_6692335094,420,-1,-5,-12,-6,-3,3,0,-3,3,0,-4,6,2,5,1,6,-1,2,1,0,6,0,1,-7,6,-2,0,-1,1,-1,-1,1,4,-1
KR_6718577707,420,0,7,6,-1,-3,3,0,2,3,5,2,1,3,-4,4,0,2,2,4,0,2,26,0,-4,4,0,0,0,1,-1,1,1,1,-1
KR_6769561916,440,-1,24,-4,-2,-3,5,2,0,1,1,1,1,2,3,3,6,-3,4,1,0,-12,-2,0,-6,6,0,0,0,1,-1,0,1,1,-1
KR_6757613060,420,-3,26,-11,-12,-4,5,1,-7,8,1,1,1,2,-3,3,0,1,1,2,0,-18,4,-4,-4,8,-21,0,-2,-1,-1,-1,-1,2,-1
KR_6759890789,420,-2,-41,14,-1,-3,5,2,2,2,4,-1,2,1,-2,4,2,3,1,4,-1,-3,1,-2,-5,7,3,0,-1,-1,1,-1,-1,1,-1
KR_6739678420,440,-2,-22,-4,-3,-2,3,1,1,2,3,1,2,3,-4,7,3,1,1,2,0,-4,0,-6,-2,8,0,0,0,1,1,0,1,1,-1
KR_6734853982,420,2,14,2,8,1,1,2,0,2,2,2,2,4,1,1,2,4,0,4,-1,8,-1,-3,-3,6,7,0,0,1,1,1,-1,2,-1
KR_6746792482,420,2,21,-16,12,3,2,5,1,0,1,-2,2,0,-1,7,6,11,0,11,-1,9,4,1,-7,6,2,0,1,0,1,1,1,0,-1
KR_6766035321,420,0,0,4,-2,-2,2,0,-1,4,3,2,0,2,1,0,1,-2,2,0,0,2,4,-4,-5,9,3,0,0,1,-1,-1,-1,3,-1
KR_6770517627,420,-3,-48,-12,-4,0,4,4,-2,6,4,-1,4,3,0,3,3,-1,3,2,-1,-5,32,-3,-4,7,-8,0,-2,1,-1,-1,1,6,-1
KR_6745972273,440,-3,-17,8,-10,-1,1,0,-3,3,0,-3,4,1,-3,4,1,0,0,0,0,-10,7,-2,-5,7,-2,0,-1,1,-1,-1,-1,3,-1
KR_6742714824,420,-7,-93,-12,-15,-4,5,1,-1,3,2,-3,3,0,-2,3,1,-5,5,0,-1,-17,-15,-9,-2,11,-2,0,-2,-1,1,-1,-1,1,-1
KR_6767724536,420,2,21,0,7,3,2,5,1,6,7,1,1,2,1,3,4,1,0,1,0,8,-2,2,-5,3,-3,0,-1,-1,1,-1,1,2,-1
KR_6725880179,420,4,31,27,2,1,1,2,0,2,2,0,1,1,1,4,5,0,2,2,0,-4,12,-3,-3,6,-4,0,-1,1,1,-1,1,4,-1
KR_6624566962,420,-1,-51,28,1,-1,2,1,1,2,3,3,0,3,-4,7,3,2,0,2,0,0,58,4,-8,4,-6,0,1,1,1,1,1,2,-1
KR_6564341276,420,-1,-27,4,-2,-1,2,1,0,4,4,-1,3,2,1,2,3,-1,1,0,0,-4,-6,-5,-2,7,-1,0,0,-1,-1,0,1,2,-1
KR_6729992905,440,2,-10,-13,-3,-1,1,0,-1,3,2,-5,5,0,-3,6,3,7,0,7,1,-5,136,1,-3,2,1,0,1,-1,1,1,1,4,-1
KR_6747791426,440,2,80,0,3,2,2,4,-2,5,3,4,0,4,0,1,1,-1,1,0,0,-3,-20,-4,-3,7,5,0,0,1,-1,0,1,3,-1
KR_6686949671,420,-1,-34,-17,0,-1,5,4,1,1,2,0,3,3,-2,2,0,2,0,2,0,0,0,1,-8,7,3,0,-2,1,-1,-1,-1,4,-1
KR_6759465057,420,-3,-41,-31,-11,-6,6,0,0,6,6,-2,4,2,-3,7,4,0,1,1,-2,-16,-31,-5,-5,10,25,0,-2,-1,1,-1,-1,6,-1
KR_6687321051,420,0,10,-3,-6,1,2,3,-5,6,1,-1,3,2,-1,3,2,0,0,0,0,-4,33,-3,-4,7,0,0,0,-1,-1,0,-1,4,-1
KR_6761636630,440,-2,4,-29,-1,1,3,4,-3,3,0,2,2,4,-1,1,0,0,4,4,1,9,-180,-1,-4,5,-2,0,-2,1,0,-1,1,6,-1
KR_6693029473,420,-2,-8,-12,0,1,0,1,-3,3,0,3,1,4,-1,7,6,0,1,1,1,8,8,3,-9,6,-5,0,-2,1,-1,-1,1,4,-1
KR_6761764299,420,-4,-36,-16,-8,-3,4,1,-1,1,0,-6,6,0,2,1,3,0,0,0,0,-3,33,-2,-4,6,-24,0,-1,-1,-1,-1,-1,3,-1
KR_6767048080,420,-6,-32,-8,-6,-3,3,0,1,4,5,-4,4,0,2,0,2,-2,2,0,0,-4,1,4,-6,2,-2,0,-1,1,1,-1,-1,6,-1
KR_6724942271,420,-4,-71,-24,-10,-2,2,0,-1,3,2,-6,7,1,0,2,2,-1,1,0,0,1,118,0,-3,3,3,0,-3,-1,-1,-1,-1,3,-1
KR_6766928383,420,-2,10,8,-4,-3,4,1,-2,3,1,5,0,5,-4,7,3,0,2,2,-1,-11,-15,-2,-6,8,2,0,0,0,-1,0,-1,0,-1
KR_6754180148,420,-1,-24,-28,-3,0,0,0,-1,7,6,0,1,1,-1,3,2,-1,1,0,0,-5,10,4,-10,6,-2,0,-1,-1,-1,-1,-1,3,-1
KR_6663514039,420,1,20,13,-1,2,0,2,-7,8,1,0,2,2,4,0,4,0,2,2,0,4,36,-1,-4,5,0,0,1,1,-1,1,-1,5,-1
KR_6765634025,420,-4,-51,2,-1,-1,4,3,3,3,6,2,2,4,-4,6,2,-1,2,1,0,-8,-268,-5,-4,9,-3,0,-1,-1,1,-1,1,5,-1
KR_6732693119,420,-1,27,-44,-7,-1,1,0,-4,6,2,-2,2,0,1,4,5,-1,1,0,0,-1,-25,0,-4,4,0,0,-1,-1,-1,-1,1,4,-1
KR_6768605840,420,-2,-31,29,-4,0,2,2,-1,3,2,-1,2,1,-2,4,2,0,0,0,0,-6,-199,-1,-3,4,2,0,0,0,1,0,-1,0,-1
KR_6627790042,420,-2,-93,8,-5,0,4,4,1,4,5,-1,1,0,-3,4,1,-2,2,0,0,-2,-327,-1,-4,5,0,0,-2,-1,1,-1,-1,1,-1
KR_6754989724,420,-1,-23,-1,0,-1,2,1,-2,4,2,1,0,1,2,3,5,0,1,1,0,1,-46,-6,-2,8,41,0,-2,-1,-1,-1,1,4,-1
KR_6708661355,420,-4,-1,15,-3,1,1,2,-2,3,1,1,2,3,1,1,2,-4,4,0,0,-3,4,1,-9,8,-7,0,0,0,-1,0,1,0,-1
KR_6737751219,420,0,-3,40,0,3,1,4,-2,3,1,-4,5,1,2,2,4,1,0,1,0,-9,-7,-3,-6,9,1,0,0,-1,-1,1,1,5,-1
KR_6751280513,420,1,43,19,5,5,1,6,0,2,2,-5,6,1,3,1,4,2,1,3,0,10,-4,0,-5,5,7,0,1,1,0,1,1,6,-1
KR_6768292727,420,-1,38,-9,-11,3,1,4,-1,3,2,-3,5,2,-7,8,1,-3,3,0,0,-17,-4,-4,-2,6,3,0,0,-1,1,-1,-1,1,-1
KR_6770357331,420,1,11,8,7,0,2,2,4,1,5,1,1,2,3,1,4,-1,3,2,1,9,-7,-5,-3,8,4,0,1,-1,1,1,1,5,-1
KR_6755216709,420,-1,-8,20,-1,0,1,1,0,1,1,0,4,4,-2,6,4,1,0,1,0,-4,2,0,-4,4,-5,0,1,1,0,1,1,4,-1
KR_6768495239,440,0,-9,-1,-5,0,1,1,-3,6,3,-1,5,4,-3,9,6,2,0,2,-2,-13,9,0,-4,4,-4,0,1,1,1,1,-1,3,-1
KR_6760451304,420,-1,22,37,-9,-1,2,1,2,1,3,-6,9,3,-1,5,4,-3,3,0,2,-8,-3,-1,-5,6,1,0,0,-1,1,0,1,1,-1
KR_6743678209,420,-3,-56,-2,-2,1,1,2,1,1,2,-1,3,2,-3,6,3,0,1,1,0,-1,5,1,-5,4,-4,0,0,1,-1,0,1,5,-1
KR_6732984396,420,4,-12,24,4,3,1,4,0,3,3,-3,6,3,5,3,8,-1,1,0,0,2,153,-1,-5,6,-13,0,0,1,-1,0,-1,6,-1
KR_6745682446,420,1,8,42,-2,1,0,1,1,3,4,-2,3,1,-2,6,4,0,1,1,0,-4,-2,1,-7,6,-2,0,-1,-1,-1,-1,1,1,-1
KR_6736356031,420,-7,-145,-11,-9,-2,3,1,-2,6,4,0,4,4,-4,6,2,-1,1,0,0,-5,-5,1,-5,4,-8,0,-2,-1,-1,-1,-1,6,-1
KR_6729010859,420,-4,-71,-16,-4,-2,3,1,-5,5,0,2,0,2,2,5,7,-1,1,0,-1,7,-2,-1,-4,5,3,0,0,1,1,0,-1,5,-1
KR_6770201363,420,-4,-82,-8,-3,-3,4,1,-1,4,3,1,4,5,-1,1,0,1,2,3,0,-8,17,6,-10,4,-4,0,-1,1,1,-1,1,3,-1
KR_6752507247,420,-1,-33,1,-5,1,4,5,-3,4,1,-1,2,1,-3,5,2,1,0,1,-1,-3,-11,-7,-1,8,8,0,-1,-1,-1,-1,-1,2,-1
KR_6755213927,420,0,6,0,-2,-3,4,1,-1,1,0,1,1,2,-1,1,0,2,0,2,0,-3,9,3,-6,3,0,0,0,-1,0,1,-1,4,-1
KR_6756201794,420,0,56,-9,-3,-1,1,0,-3,6,3,1,3,4,0,5,5,0,0,0,0,-5,-7,0,-8,8,7,0,0,1,1,0,1,4,-1
KR_6727629148,420,-8,-89,-54,-12,1,1,2,-3,5,2,-6,7,1,-2,4,2,-2,2,0,0,-11,-16,-4,-3,7,5,0,-3,-1,-1,-1,1,5,-1
KR_6697822660,420,-2,-64,7,-9,-3,7,4,-3,5,2,-5,5,0,6,0,6,-4,5,1,0,-7,-8,-4,-3,7,-3,0,-3,0,1,-1,-1,0,-1
KR_6762106511,420,-2,-75,-23,-7,-2,3,1,-3,4,1,-3,3,0,0,3,3,1,0,1,0,-7,-8,-3,-3,6,-1,0,0,-1,1,1,-1,2,-1
KR_6751087609,420,-3,-67,-49,-6,2,3,5,-1,2,1,-1,4,3,-6,6,0,0,0,0,0,-5,6,-4,-4,8,-2,0,-2,0,-1,-1,-1,0,-1
KR_6707311588,420,-2,-41,19,0,-3,4,1,2,1,3,-2,5,3,3,3,6,0,1,1,1,5,11,0,-7,7,1,0,-1,-1,1,-1,1,5,-1
KR_6730069124,440,-3,5,3,-1,-5,6,1,1,1,2,0,3,3,2,0,2,1,1,2,2,-2,22,-4,-3,7,2,0,0,0,-1,-1,1,0,-1
KR_6769999239,420,-3,28,-5,-6,0,3,3,-3,6,3,0,2,2,-2,2,0,-1,3,2,0,-14,3,-1,-4,5,3,0,0,-1,-1,1,1,3,-1
KR_6765324306,420,-2,-48,35,-4,-3,3,0,1,1,2,1,0,1,-1,2,1,-2,3,1,0,2,35,-1,-3,4,-1,0,-1,-1,1,-1,-1,2,-1
KR_6762305085,420,-1,-18,-9,-6,-2,3,1,0,3,3,-3,4,1,-2,4,2,1,2,3,-1,-10,183,-1,-4,5,-4,0,-1,-1,-1,-1,-1,1,-1
KR_6752080871,420,3,37,0,8,3,0,3,2,1,3,2,0,2,-1,3,2,2,1,3,0,8,-6,-3,-2,5,1,0,0,1,0,0,-1,4,-1
KR_6716123639,420,1,-30,-5,6,-3,3,0,3,1,4,0,3,3,3,3,6,3,1,4,0,4,15,2,-6,4,1,0,0,-1,1,-1,-1,2,-1
KR_6764006770,420,-6,-80,8,-7,-1,2,1,-2,4,2,0,3,3,-2,3,1,-2,3,1,0,-10,6,5,-7,2,0,0,0,0,0,0,1,0,-1
KR_6761278262,420,-1,0,-12,-5,-2,3,1,0,3,3,-1,2,1,-3,4,1,1,0,1,-1,-11,-20,0,-5,5,-2,0,0,1,1,1,-1,6,-1
KR_6768542713,420,2,28,32,-2,2,2,4,2,3,5,-1,1,0,-2,2,0,-3,3,0,0,-2,-2,-2,-4,6,0,0,-1,-1,1,-1,1,4,-1
KR_6768656151,420,-5,-82,-21,-6,-1,2,1,1,1,2,-2,2,0,3,3,6,-7,7,0,0,-6,-45,-1,-3,4,23,0,-1,0,-1,-1,-1,0,-1
KR_6755473127,440,-2,-34,-8,4,2,0,2,0,1,1,1,0,1,-2,3,1,3,0,3,0,9,10,1,-5,4,0,0,0,1,-1,-1,1,1,-1
KR_6754613401,420,2,-14,16,-1,-2,3,1,-1,4,3,6,0,6,-6,6,0,2,0,2,0,6,3,0,-5,5,-4,0,0,-1,-1,1,1,1,-1
KR_6717973648,420,1,39,-30,6,2,1,3,0,5,5,-1,5,4,6,1,7,-1,1,0,0,3,-21,1,-4,3,7,0,2,1,1,1,1,2,-1
KR_6745856136,420,0,70,-12,1,-1,2,1,2,0,2,-5,7,2,6,2,8,-1,1,0,0,7,-17,-8,-1,9,-1,0,-1,1,-1,-1,1,1,-1
KR_6743046487,420,-2,-59,4,-4,-3,5,2,0,0,0,-1,5,4,3,4,7,-3,3,0,0,1,6,0,-5,5,0,0,-1,1,-1,-1,-1,4,-1
KR_6760848451,420,-2,-26,-27,1,-3,3,0,-1,4,3,-1,1,0,5,1,6,1,1,2,0,8,-3,0,-3,3,-1,0,-3,1,-1,-1,-1,5,-1
KR_6694924515,420,1,-17,8,-5,-3,3,0,3,2,5,-1,4,3,-2,3,1,-2,5,3,0,0,-6,-1,-3,4,-5,0,0,1,-1,-1,-1,4,-1
KR_6740900620,420,-4,-28,-8,-19,-7,10,3,-2,4,2,-8,9,1,-5,8,3,3,0,3,0,-20,-13,-5,-1,6,3,0,-2,-1,-1,-1,1,2,-1
KR_6767238550,420,-1,16,-24,-4,1,3,4,-3,6,3,-5,7,2,3,2,5,0,0,0,0,-2,-3,1,-4,3,3,0,0,-1,-1,-1,1,1,-1
KR_6666227720,440,0,-53,20,-7,-2,2,0,-7,7,0,1,2,3,-2,3,1,3,0,3,-1,-13,-20,-1,-5,6,0,0,-1,1,1,-1,-1,4,-1
KR_6697866457,420,-2,-51,-31,-4,-6,6,0,4,0,4,-1,5,4,-1,3,2,0,0,0,0,1,12,2,-5,3,-3,0,-2,-1,-1,-1,-1,5,-1
KR_6644735219,420,-1,-22,-23,1,-3,5,2,-2,4,2,0,6,6,7,0,7,-1,1,0,0,8,14,2,-3,1,1,0,0,1,1,1,-1,5,-1
KR_6765963465,420,-3,-68,16,-7,-2,3,1,-5,5,0,2,2,4,0,2,2,-2,2,0,0,-15,4,4,-8,4,-2,0,0,-1,0,0,-1,2,-1
KR_6712414305,420,-1,-23,3,-5,1,1,2,1,3,4,-2,3,1,-5,7,2,0,0,0,0,-13,-1,-3,-2,5,-2,0,0,-1,1,-1,1,5,-1
KR_6760450036,420,-2,-9,-13,-3,-5,5,0,2,1,3,-2,2,0,3,1,4,-1,2,1,0,3,9,-4,-4,8,3,0,0,-1,1,1,1,3,-1
KR_6727361644,420,-2,-71,-11,-9,-4,5,1,-5,8,3,-2,2,0,-1,4,3,3,0,3,0,-3,-7,1,-4,3,2,0,-3,1,-1,-1,-1,2,-1
KR_6765562061,420,2,-56,20,-5,-5,5,0,0,2,2,-1,3,2,3,1,4,-2,3,1,0,-4,-8,-3,-5,8,-6,0,0,0,-1,1,-1,0,-1
KR_6763971263,420,-2,9,-20,-4,1,0,1,0,5,5,-2,4,2,-3,5,2,0,0,0,0,-5,-5,-2,-3,5,1,0,-1,1,-1,-1,-1,5,-1
KR_6768396583,420,0,-21,14,-1,-1,2,1,2,4,6,0,1,1,-1,5,4,-1,2,1,1,1,20,-3,-3,6,3,0,1,-1,1,1,1,6,-1
KR_6748879756,420,3,-16,32,3,1,3,4,3,1,4,0,3,3,-3,3,0,2,0,2,0,6,-2,-6,-3,9,1,0,3,1,1,1,1,4,-1
KR_6770671658,420,2,43,33,-3,-3,5,2,-1,3,2,1,0,1,-2,3,1,2,0,2,0,1,-10,-3,-3,6,5,0,0,-1,-1,0,-1,1,-1
KR_6717392337,420,1,28,-12,-2,3,1,4,3,2,5,-1,3,2,-10,10,0,3,1,4,-1,-9,14,3,-10,7,-3,0,-1,-1,1,-1,-1,6,-1
KR_6756508326,420,0,58,-6,0,2,3,5,0,5,5,3,2,5,-2,7,5,-3,3,0,0,-6,-234,-4,-5,9,0,0,-1,-1,-1,-1,-1,2,-1
KR_6770634341,420,-4,5,-19,-14,2,2,4,3,0,3,-1,2,1,-17,18,1,-1,4,3,-2,-18,-1,1,-4,3,-8,0,-1,-1,1,-1,-1,1,-1
KR_6745477594,420,-2,31,14,-6,1,1,2,0,2,2,-3,3,0,-3,3,0,-1,2,1,0,-13,-4,2,-4,2,7,0,1,-1,1,1,1,6,-1
KR_6707580801,420,-1,-14,20,-7,2,1,3,-4,7,3,1,2,3,-5,8,3,-1,2,1,0,-10,37,-5,-5,10,-1,0,-1,-1,-1,-1,1,4,-1
KR_6750858108,420,-3,-45,8,-15,0,2,2,-9,9,0,-3,4,1,-4,5,1,1,0,1,0,-20,-50,-1,-3,4,22,0,1,-1,1,1,-1,3,-1
KR_6742569458,440,-6,-99,4,-14,0,0,0,-9,10,1,1,2,3,-6,6,0,0,1,1,0,-11,6,-1,-3,4,-1,0,0,0,0,0,1,0,-1
KR_6728009201,440,-2,-28,-16,-10,-1,3,2,-7,9,2,2,1,3,-6,6,0,2,0,2,0,-12,10,4,-7,3,1,0,0,-1,-1,0,1,4,-1
KR_6718450983,420,-5,-72,-32,-14,-10,15,5,-8,8,0,-4,5,1,8,1,9,0,1,1,0,-1,27,2,-6,4,1,0,-4,-1,-1,-1,1,5,-1
KR_6717058406,420,-4,-20,0,-7,-5,5,0,-1,4,3,-2,2,0,1,0,1,0,0,0,0,-12,-9,-1,-6,7,3,0,-3,-1,-1,-1,-1,2,-1
KR_6769801006,420,-1,-2,-22,-2,-1,2,1,1,2,3,1,1,2,-2,3,1,-1,1,0,0,-9,10,1,-4,3,-1,0,0,-1,-1,-1,1,6,-1
KR_6569634793,420,0,-27,15,4,1,1,2,1,6,7,-2,4,2,3,3,6,1,0,1,-2,-5,-4,-5,-7,12,7,0,0,-1,1,0,-1,4,-1
KR_6659102252,420,1,66,20,-1,-1,3,2,-2,3,1,1,0,1,3,2,5,-2,2,0,0,3,0,-2,-5,7,2,0,0,1,-1,-1,-1,2,-1
KR_6712342653,420,-4,-83,-8,-11,-3,3,0,-7,7,0,2,3,5,-2,4,2,-1,1,0,0,-14,-8,-5,-2,7,0,0,-1,-1,-1,-1,-1,4,-1
KR_6763998415,420,-2,-8,10,-1,-1,3,2,-3,7,4,5,1,6,-3,4,1,1,1,2,0,7,17,1,-8,7,-8,0,-1,1,-1,-1,-1,4,-1
KR_6435653759,420,-7,-73,-29,-11,-3,4,1,0,3,3,-5,7,2,-1,4,3,-2,2,0,1,-11,-4,-2,-4,6,2,0,-2,1,-1,-1,1,5,-1
KR_6766518809,420,-1,-26,12,-4,1,0,1,-2,4,2,0,1,1,-5,7,2,2,2,4,0,-1,-7,3,-10,7,-5,0,-1,-1,-1,-1,1,1,-1
KR_6768914394,420,-4,-78,-20,-14,-5,6,1,-4,6,2,0,2,2,-3,4,1,-2,2,0,0,-18,3,-2,-2,4,-1,0,0,0,-1,-1,-1,0,-1
KR_6735852476,440,0,26,44,-10,-1,3,2,0,0,0,-1,1,0,0,1,1,-8,8,0,0,-20,-2,-3,-3,6,-4,0,-1,-1,1,-1,-1,1,-1
KR_6701071223,420,-4,-45,-21,-10,-1,1,0,0,6,6,-8,9,1,-2,3,1,1,0,1,0,-8,-12,-5,-6,11,-1,0,0,-1,1,-1,1,3,-1
KR_6752216941,420,-3,-34,3,-4,-3,4,1,-3,4,1,3,0,3,0,1,1,-1,1,0,1,-3,-112,-1,-7,8,-1,0,-1,1,-1,-1,1,2,-1
KR_6752897185,420,-1,-19,-14,-6,0,1,1,2,3,5,1,3,4,-6,9,3,-3,4,1,-1,-7,-27,2,-7,5,-6,0,1,-1,1,-1,-1,1,-1
KR_6748001001,420,0,-30,12,0,1,3,4,0,3,3,-2,3,1,-2,6,4,3,1,4,0,8,15,-2,-3,5,-6,0,0,-1,-1,-1,-1,1,-1
KR_6770559617,420,-4,-86,5,-11,1,3,4,-3,6,3,-4,6,2,-4,6,2,-1,2,1,0,-13,-3,-5,-5,10,-4,0,-2,-1,1,-1,-1,4,-1
KR_6769315698,440,-2,25,15,-1,-1,2,1,2,1,3,0,4,4,-3,3,0,1,0,1,-1,-5,-31,-1,-5,6,3,0,1,0,1,1,-1,0,-1
KR_6768549641,420,-5,-81,-16,-19,-4,6,2,-3,5,2,-6,8,2,-6,7,1,0,2,2,0,-24,-4,-3,-4,7,-1,0,-4,-1,-1,-1,-1,1,-1
KR_6701524570,420,0,6,-4,-3,0,1,1,-5,5,0,-1,2,1,2,2,4,1,1,2,0,-3,-98,0,-3,3,-3,0,0,1,1,0,-1,5,-1
KR_6770803010,420,-4,-71,-3,-13,-3,4,1,-2,2,0,-3,3,0,-7,9,2,2,0,2,-2,-22,2,-3,-3,6,0,0,-3,-1,-1,-1,-1,2,-1
KR_6762762425,420,-1,-36,-6,8,4,1,5,-1,3,2,2,1,3,0,1,1,3,0,3,0,12,3,5,-7,2,1,0,0,1,-1,1,1,2,-1
KR_6739237357,420,-1,-18,9,1,3,1,4,0,4,4,-3,4,1,-2,3,1,3,0,3,0,-13,8,-1,-3,4,-4,0,0,-1,1,-1,1,5,-1
KR_6667180659,420,2,8,4,3,-3,3,0,4,0,4,-4,4,0,5,0,5,1,2,3,-1,15,19,4,-9,5,1,0,1,1,-1,-1,-1,6,-1
KR_6770400564,420,-5,-35,-21,-9,-3,3,0,-9,9,0,1,1,2,0,1,1,2,2,4,0,-6,7,-3,-4,7,2,0,-2,-1,0,-1,1,1,-1
KR_6751817883,420,-2,-46,-11,-1,-2,3,1,2,1,3,2,0,2,-2,4,2,-1,1,0,0,0,3,2,-12,10,0,0,0,-1,-1,0,1,2,-1
KR_6740723144,420,-6,-110,-28,-17,-5,6,1,-1,2,1,-2,3,1,-9,9,0,0,2,2,-1,-15,-10,-5,0,5,-4,0,-3,-1,-1,-1,-1,4,-1
KR_6731131811,420,-4,-54,24,-14,-5,6,1,-4,4,0,-2,6,4,-4,4,0,1,0,1,0,-9,-32,-9,-1,10,4,0,-1,-1,-1,-1,-1,2,-1
KR_6742920454,420,0,-16,3,0,-1,2,1,2,3,5,-3,4,1,1,2,3,1,0,1,0,4,7,-4,-5,9,-1,0,1,-1,1,1,-1,4,-1
KR_6766888178,420,1,2,7,1,3,0,3,1,1,2,-3,3,0,1,3,4,-1,2,1,0,-5,-49,-2,-6,8,25,0,1,-1,1,1,-1,3,-1
KR_6743972471,420,-1,9,8,-4,-1,2,1,0,6,6,1,1,2,-4,4,0,0,1,1,0,-4,13,-1,-2,3,6,0,1,1,-1,-1,1,3,-1
KR_6724632257,420,3,-91,15,-4,1,1,2,2,4,6,-1,1,0,-5,8,3,-1,1,0,0,-8,-53,1,-4,3,10,0,0,-1,0,0,-1,3,-1
KR_6766846629,420,-1,17,-5,-10,-1,1,0,-11,14,3,6,4,10,-2,5,3,-2,2,0,-1,-11,-4,0,-3,3,-3,0,-2,-1,-1,-1,-1,2,-1
KR_6741396690,440,-2,21,-6,-8,-7,9,2,-3,6,3,4,0,4,-1,1,0,-1,1,0,0,-13,-273,-2,-2,4,1,0,-1,-1,-1,-1,1,6,-1
KR_6710591871,420,-8,-93,-6,-13,-4,4,0,-7,7,0,-2,3,1,-5,8,3,5,2,7,1,-8,-3,-1,-2,3,-2,0,-3,-1,-1,-1,1,4,-1
KR_6701809078,420,-6,-97,-4,-16,-5,6,1,-5,5,0,-2,3,1,-3,4,1,-1,1,0,1,-18,110,-6,-1,7,2,0,-1,-1,-1,-1,1,6,-1
KR_6763989938,420,-6,-19,-45,-14,0,2,2,-5,6,1,-8,9,1,0,2,2,-1,1,0,0,-14,-1,-6,-2,8,-2,0,-1,1,-1,-1,1,3,-1
KR_6734873780,420,-2,-33,8,5,-4,5,1,-1,3,2,-1,2,1,8,0,8,3,0,3,2,3,-2,-1,-4,5,-2,0,-1,1,-1,-1,1,4,-1
KR_6648860666,420,-1,-23,-13,2,1,1,2,2,6,8,3,3,6,-5,6,1,1,1,2,1,7,-2,-2,-5,7,1,0,-1,-1,1,-1,1,2,-1
KR_6758458061,420,-2,-83,-12,-7,0,2,2,-1,5,4,-3,3,0,-4,6,2,1,0,1,0,-10,4,-1,-5,6,-3,0,-1,-1,-1,-1,-1,3,-1
KR_6764968194,420,-2,-53,16,-1,2,1,3,-3,5,2,0,5,5,0,4,4,0,0,0,0,3,-346,0,-5,5,3,0,0,-1,0,0,1,4,-1
KR_6762090172,420,-3,-66,23,-9,-1,2,1,-7,7,0,-1,2,1,0,1,1,0,0,0,0,-14,3,1,-4,3,3,0,-2,-1,-1,-1,-1,1,-1
KR_6719124774,420,-3,-76,9,-8,2,0,2,-2,3,1,-3,4,1,-2,5,3,-3,3,0,2,-10,198,-7,-4,11,0,0,0,1,1,0,1,2,-1
KR_6722378895,420,0,-18,-27,4,2,1,3,3,2,5,-4,4,0,4,0,4,-1,3,2,0,6,9,-3,-4,7,-3,0,0,1,-1,0,-1,2,-1
KR_6760626521,420,-4,-15,-12,-13,-5,6,1,1,2,3,0,2,2,-9,9,0,0,1,1,0,-16,-7,-7,-2,9,-2,0,-1,-1,-1,-1,-1,5,-1
KR_6740902092,420,-1,-37,38,4,1,2,3,2,2,4,-5,6,1,6,1,7,0,0,0,0,7,17,8,-10,2,-3,0,-2,1,-1,-1,1,3,-1
KR_6733604927,420,0,-13,30,-4,2,0,2,-2,6,4,0,4,4,1,2,3,-5,7,2,0,-6,-13,1,-7,6,-3,0,0,1,-1,-1,-1,6,-1
KR_6767558712,420,0,-103,7,-1,-6,7,1,-3,4,1,2,3,5,5,2,7,1,1,2,0,-4,-5,-3,-5,8,1,0,-1,-1,-1,-1,1,2,-1
KR_6763527543,420,1,1,13,1,3,0,3,3,0,3,-2,2,0,-2,4,2,-1,1,0,0,-3,20,8,-8,0,-11,0,1,-1,-1,1,1,2,-1
KR_6717761506,420,-4,-30,3,-4,1,3,4,1,0,1,1,5,6,-4,6,2,-3,3,0,0,1,1,-2,-6,8,0,0,-1,-1,0,-1,-1,5,-1
KR_6680312075,440,-5,-55,13,-11,2,0,2,1,0,1,-4,8,4,-7,11,4,-3,6,3,1,-11,8,2,-2,0,-3,0,-2,-1,-1,-1,1,2,-1
KR_6693819932,420,-1,-41,16,1,-2,4,2,0,2,2,0,2,2,4,3,7,-1,1,0,-1,-13,9,-2,-7,9,-3,0,0,1,-1,-1,-1,5,-1
KR_6764140621,420,-1,-85,4,-4,-5,5,0,1,4,5,-2,2,0,3,2,5,-1,1,0,0,0,110,0,-4,4,2,0,0,1,-1,0,-1,1,-1
KR_6750063974,420,-5,-71,-16,-12,-10,10,0,-1,4,3,2,2,4,-5,6,1,2,2,4,-1,-5,-12,-7,-4,11,-4,0,-2,-1,-1,-1,-1,2,-1
KR_6702673449,420,-4,-64,-37,-5,-2,2,0,-3,4,1,-2,6,4,2,2,4,0,2,2,-2,-9,106,-4,-3,7,5,0,-1,-1,1,-1,-1,1,-1
KR_6769886891,420,-4,-36,-24,-6,1,2,3,1,2,3,-3,5,2,-1,2,1,-4,4,0,0,-9,-11,-5,-3,8,1,0,-2,-1,-1,-1,-1,6,-1
KR_6746123696,420,-2,-34,0,-10,-3,4,1,-1,3,2,-5,5,0,0,2,2,-1,1,0,0,-8,8,0,-10,10,-3,0,-2,-1,1,-1,-1,1,-1
KR_6766689250,420,-3,-14,27,-8,-1,5,4,-3,4,1,-6,8,2,1,3,4,1,0,1,0,-8,8,-4,-5,9,3,0,0,1,-1,1,1,5,-1
KR_6768736169,420,1,5,22,4,-3,4,1,4,3,7,1,1,2,3,1,4,-1,2,1,-1,-1,7,0,-6,6,4,0,0,1,1,0,-1,5,-1
KR_6762488593,420,-4,-72,-29,0,-5,7,2,4,2,6,2,3,5,1,4,5,-2,3,1,1,7,5,6,-7,1,-1,0,-2,-1,-1,-1,1,3,-1
KR_6768693594,440,-1,2,3,-5,-4,6,2,4,1,5,-6,6,0,1,4,5,0,2,2,0,-4,-2,-3,-2,5,0,0,0,-1,-1,-1,-1,4,-1
KR_6759540757,440,-3,-33,-48,-4,0,3,3,2,2,4,0,5,5,-6,6,0,0,2,2,0,6,131,-1,-5,6,6,0,-1,0,-1,1,-1,0,-1
KR_6666167993,440,5,38,17,10,5,3,8,-1,4,3,3,0,3,4,1,5,-1,3,2,1,8,1,0,-3,3,3,0,0,1,-1,1,1,6,-1
KR_6768742548,420,3,70,4,-4,3,1,4,-10,12,2,0,0,0,2,2,4,1,2,3,0,-8,2,-3,-4,7,-1,0,-1,-1,-1,-1,-1,1,-1
KR_6706856502,440,-1,-10,-12,0,-2,3,1,7,1,8,-1,2,1,-5,5,0,1,1,2,0,-5,-47,-3,-5,8,20,0,0,-1,-1,0,1,1,-1
KR_6745351606,440,-5,-12,-16,-16,-1,2,1,-5,7,2,-2,2,0,-6,7,1,-2,3,1,0,-28,-38,-3,-3,6,-4,0,0,-1,1,0,-1,6,-1
KR_6747821373,420,2,25,-4,-13,2,2,4,-1,6,5,-7,8,1,-4,6,2,-3,3,0,0,-19,-2,0,-6,6,-5,0,1,-1,-1,-1,-1,2,-1
KR_6758714341,420,-2,-36,0,-7,-3,4,1,-1,2,1,-2,2,0,0,2,2,-1,1,0,0,-2,-3,-7,-6,13,-3,0,0,-1,-1,-1,-1,1,-1
KR_6751196095,420,-5,-92,-20,-8,-1,2,1,-1,1,0,-1,2,1,-1,1,0,-4,4,0,0,-8,-1,-2,-3,5,-1,0,-1,-1,0,-1,-1,3,-1
KR_6756958877,420,1,-12,1,2,0,3,3,6,0,6,2,1,3,-5,5,0,-1,3,2,0,3,-5,2,-4,2,-5,0,1,-1,-1,1,1,1,-1
KR_6762815501,420,-1,10,8,2,-1,2,1,-2,4,2,4,0,4,1,3,4,0,2,2,0,-5,-9,-2,-4,6,2,0,1,1,1,1,1,4,-1
KR_6748593885,440,0,40,-35,-2,-3,4,1,-5,6,1,1,0,1,4,2,6,1,0,1,0,2,-8,-1,-2,3,3,0,0,1,-1,-1,1,4,-1
KR_6767069456,420,-3,-64,-22,-4,-1,3,2,-2,2,0,-1,2,1,-3,3,0,3,0,3,1,-1,-3,-2,-2,4,1,0,-2,-1,-1,-1,1,6,-1
KR_6749662738,420,-6,-74,-36,-5,-1,1,0,-1,3,2,-6,7,1,2,3,5,1,1,2,0,-6,-5,0,-5,5,-3,0,-2,-1,-1,-1,-1,6,-1
KR_6767305488,420,-1,-43,-12,-4,0,3,3,-2,3,1,-3,3,0,1,1,2,0,0,0,0,-5,-59,-2,-3,5,20,0,-1,0,1,-1,-1,0,-1
KR_6765412660,420,-3,-62,51,-6,-4,4,0,1,0,1,0,3,3,-4,6,2,1,1,2,0,-3,-7,0,-3,3,3,0,-1,1,1,-1,-1,5,-1
KR_6752941094,420,2,-54,-20,4,-1,1,0,-1,2,1,5,1,6,2,2,4,-1,1,0,0,11,-8,-1,-4,5,3,0,-1,0,-1,-1,1,0,-1
KR_6674329760,420,-5,-36,16,-7,-2,4,2,1,1,2,-2,2,0,-2,4,2,-2,2,0,0,-6,3,-8,-5,13,-2,0,-1,-1,1,1,1,6,-1
KR_6745441803,420,-4,-47,48,-11,0,2,2,-2,3,1,-2,4,2,-6,7,1,-1,2,1,0,-11,7,-4,-4,8,-2,0,-2,1,-1,-1,-1,2,-1
KR_6770356149,420,-2,-30,8,1,-1,2,1,4,0,4,-1,4,3,-2,6,4,1,0,1,0,4,9,0,-4,4,-2,0,0,0,0,0,1,0,-1
KR_6762440101,420,-6,-93,-34,-16,-7,7,0,-2,4,2,-2,5,3,-6,10,4,1,1,2,0,-11,21,1,-5,4,-4,0,-1,-1,-1,-1,-1,2,-1
KR_6760708244,420,-3,-59,-6,-6,5,1,6,-1,2,1,-2,3,1,-10,10,0,2,0,2,0,-12,21,1,-6,5,0,0,0,0,1,1,-1,0,-1
KR_6624534013,420,-2,-9,14,-2,0,3,3,-2,3,1,-2,3,1,2,2,4,0,1,1,0,1,8,3,-9,6,-4,0,0,-1,-1,0,-1,4,-1
KR_6762140322,420,0,-51,-12,3,-1,4,3,1,1,2,-3,5,2,6,2,8,0,1,1,0,8,-10,2,-6,4,1,0,-1,1,-1,-1,-1,2,-1
KR_6756693077,420,-2,-78,-16,-3,-1,1,0,-2,3,1,3,0,3,-2,2,0,-1,1,0,0,-10,9,2,-7,5,-7,0,0,-1,1,-1,1,1,-1
KR_6766234580,420,-1,20,-24,1,1,3,4,-3,7,4,3,2,5,-1,2,1,1,0,1,0,-4,-4,-1,-5,6,5,0,-1,-1,-1,-1,1,4,-1
KR_6753754658,440,-3,-38,0,-5,-2,5,3,1,1,2,-1,3,2,-4,7,3,1,0,1,0,-2,-9,1,-4,3,1,0,0,-1,0,0,1,5,-1
KR_6766206676,420,-2,-2,-8,-8,2,1,3,-3,6,3,0,3,3,-8,11,3,1,1,2,0,-8,-15,-5,-3,8,3,0,0,-1,-1,-1,1,1,-1
KR_6730604901,420,-5,-104,13,-12,-5,5,0,-2,6,4,0,4,4,-4,6,2,-1,1,0,0,-8,38,-3,-5,8,-21,0,-1,1,1,-1,-1,3,-1
KR_6751770669,420,1,13,-19,2,-1,1,0,5,1,6,1,1,2,-3,6,3,0,2,2,0,-1,22,0,-6,6,-1,0,-1,1,-1,-1,1,5,-1
KR_6733910483,420,-2,45,12,-11,0,2,2,-4,4,0,-5,6,1,-1,3,2,-1,1,0,0,-13,15,1,-5,4,8,0,-1,-1,-1,-1,1,5,-1
KR_6661914194,440,2,26,28,-3,2,2,4,5,4,9,-3,4,1,-3,4,1,-4,8,4,0,7,0,-3,-3,6,-3,0,-1,-1,1,-1,-1,3,-1
KR_6746739753,420,-2,-60,1,-8,-3,5,2,-3,4,1,2,1,3,-5,6,1,1,2,3,0,-7,-19,-2,-5,7,1,0,0,-1,-1,1,-1,3,-1
KR_6650282050,420,-1,-22,-42,-2,0,4,4,-3,5,2,1,3,4,3,4,7,-3,4,1,0,2,7,3,-6,3,-1,0,0,-1,-1,-1,-1,1,-1
KR_6754111735,420,-1,2,7,-3,3,0,3,-3,6,3,0,1,1,0,3,3,-3,3,0,0,-10,0,0,-7,7,0,0,1,-1,1,1,1,3,-1
KR_6691593390,420,1,35,28,1,-2,3,1,2,0,2,1,4,5,1,4,5,-1,1,0,0,7,-57,-6,-4,10,-1,0,0,1,-1,0,-1,6,-1
KR_6721824897,420,-7,-94,-33,-16,-6,6,0,0,1,1,-1,2,1,-8,9,1,-1,1,0,0,-17,-21,-3,-4,7,-3,0,-1,1,-1,-1,-1,5,-1
KR_6760499309,440,-2,12,1,-1,-4,5,1,2,2,4,0,3,3,-2,2,0,3,1,4,0,-2,2,2,-5,3,1,0,-2,0,-1,-1,1,0,-1
KR_6710254856,420,-3,-14,6,-9,2,1,3,-2,2,0,-3,3,0,-5,5,0,-1,1,0,-1,-12,102,1,-7,6,3,0,1,-1,1,1,-1,5,-1
KR_6758863122,420,-3,-29,0,-7,-3,4,1,-4,5,1,0,0,0,2,2,4,-2,2,0,0,-5,0,-1,-7,8,-3,0,0,-1,-1,-1,-1,5,-1
KR_6729796932,420,-2,-77,11,-1,-1,2,1,-2,6,4,2,3,5,4,2,6,-4,5,1,0,-13,-2,-2,-4,6,2,0,0,0,1,-1,1,0,-1
KR_6755297814,420,0,-33,4,-1,-2,2,0,3,0,3,-1,4,3,0,1,1,-1,1,0,0,0,114,-4,-5,9,6,0,1,-1,1,1,1,3,-1
KR_6764980149,420,-2,-7,8,-8,0,6,6,-3,7,4,-2,3,1,-4,8,4,1,2,3,0,-11,5,1,-4,3,-2,0,0,1,0,0,1,1,-1
KR_6769281696,420,-2,-9,23,-9,0,2,2,-5,5,0,-1,4,3,-1,3,2,-2,4,2,-1,-15,7,2,-7,5,-3,0,0,1,-1,1,-1,3,-1
KR_6752176424,420,0,45,-20,4,4,0,4,-3,4,1,4,0,4,1,2,3,-2,2,0,0,-1,7,3,-7,4,-3,0,0,-1,-1,0,1,3,-1
KR_6650096621,420,-1,-27,6,-1,-1,4,3,-2,9,7,-1,2,1,3,2,5,0,0,0,0,1,18,-1,-5,6,0,0,-1,1,-1,-1,-1,4,-1
KR_6742309094,420,1,-46,15,7,-2,2,0,1,1,2,1,2,3,7,1,8,0,0,0,1,9,26,7,-9,2,1,0,0,-1,1,0,1,5,-1
KR_6564408932,420,1,35,-1,0,1,0,1,-7,7,0,2,1,3,1,2,3,3,0,3,0,-5,25,-6,-3,9,5,0,0,1,1,0,1,5,-1
KR_6747810816,420,-2,44,-16,-5,-3,3,0,-1,3,2,-2,4,2,1,0,1,0,0,0,0,-5,-9,0,-3,3,-2,0,-1,-1,-1,-1,-1,3,-1
KR_6770720754,420,2,-60,31,-2,0,1,1,4,0,4,1,4,5,-4,8,4,-3,3,0,-3,-9,5,2,-7,5,0,0,-1,-1,1,-1,-1,1,-1
KR_6757853753,420,1,2,-9,3,2,1,3,-1,3,2,4,0,4,0,2,2,-2,2,0,0,-4,46,1,-5,4,-4,0,0,1,-1,0,-1,1,-1
KR_6756488742,420,-2,10,0,-3,4,1,5,1,5,6,-1,1,0,-6,10,4,-1,2,1,0,-8,0,-2,-3,5,2,0,-1,-1,1,-1,1,6,-1
KR_6715337178,420,-4,-67,-4,-15,-1,2,1,-1,4,3,0,1,1,1,3,4,-14,14,0,-1,-24,-50,-3,-5,8,11,0,-2,1,-1,-1,-1,1,-1
KR_6635132013,420,-7,18,-23,-13,2,2,4,-4,6,2,-10,10,0,0,1,1,-1,2,1,0,-14,8,-1,-4,5,2,0,1,-1,1,1,-1,2,-1
KR_6768527801,420,-1,-38,-23,4,3,0,3,5,0,5,-1,2,1,-4,5,1,1,2,3,0,1,24,0,-3,3,-2,0,2,-1,1,1,-1,2,-1
KR_6744046365,420,-1,-7,-3,-3,-1,2,1,6,3,9,-1,5,4,-4,5,1,-3,4,1,0,-6,29,-3,-5,8,-5,0,-2,1,-1,-1,-1,5,-1
KR_6768939716,420,2,33,31,10,-1,3,2,4,4,8,3,1,4,4,1,5,0,0,0,0,7,25,2,-4,2,1,0,1,-1,-1,1,1,3,-1
KR_6768550939,420,-2,-36,-14,0,-1,3,2,4,2,6,-3,3,0,0,1,1,0,0,0,0,2,-3,3,-6,3,1,0,-1,-1,1,-1,1,5,-1
KR_6765284295,420,-1,-28,0,-3,-4,4,0,1,0,1,-3,3,0,2,2,4,1,0,1,0,-3,0,1,-4,3,2,0,0,-1,0,0,1,1,-1
KR_6737315755,420,2,-17,-12,-1,-1,2,1,4,0,4,-4,5,1,0,2,2,0,1,1,0,5,3,-1,-5,6,-3,0,-1,-1,-1,-1,-1,5,-1
KR_6627901072,420,-2,7,-10,-9,1,1,2,-5,10,5,3,2,5,-5,8,3,-3,4,1,0,-12,-4,-1,-3,4,-4,0,1,1,1,1,1,1,-1
KR_6725637031,420,1,16,35,1,2,1,3,4,0,4,-5,5,0,2,2,4,-2,2,0,0,2,-21,1,-6,5,1,0,0,-1,1,0,1,3,-1
KR_6755700498,420,1,-56,-20,-4,-5,6,1,1,1,2,-2,4,2,-2,3,1,4,1,5,0,1,-198,4,-6,2,-3,0,1,0,-1,1,1,0,-1
KR_6752694310,420,-1,-72,14,-4,-3,3,0,-1,3,2,3,0,3,-3,3,0,0,2,2,0,-4,-1,-1,-4,5,1,0,0,1,1,1,-1,1,-1
KR_6766404365,420,1,24,-16,-6,-3,3,0,-3,3,0,-1,3,2,0,2,2,1,0,1,0,-2,0,2,-6,4,0,0,0,-1,-1,0,-1,1,-1
KR_6683109033,420,-8,-132,-14,-18,-4,5,1,-3,4,1,-4,5,1,-4,5,1,-3,3,0,0,-25,-1,-4,-6,10,-3,0,-2,1,-1,-1,-1,6,-1
KR_6762496117,420,3,43,32,4,3,1,4,2,4,6,4,1,5,-3,4,1,-2,2,0,-1,-1,-9,1,-6,5,5,0,2,1,1,1,-1,6,-1
KR_6751966798,420,1,-1,20,0,-1,2,1,-3,7,4,1,2,3,2,2,4,1,0,1,0,7,-5,-6,-5,11,1,0,-1,-1,0,-1,1,6,-1
KR_6763654611,440,3,14,3,5,-3,5,2,4,1,5,3,3,6,0,5,5,1,1,2,1,3,199,0,-6,6,5,0,1,1,1,1,1,4,-1
KR_6743831625,420,-2,-4,-24,-1,2,1,3,-1,1,0,-3,5,2,1,0,1,0,0,0,0,-5,-5,-4,-2,6,1,0,0,-1,-1,0,-1,4,-1
KR_6709529952,420,-2,-52,-20,2,-1,5,4,2,1,3,-3,5,2,3,1,4,1,1,2,0,16,-12,0,-4,4,4,0,-1,-1,-1,-1,-1,2,-1
KR_6766862036,440,1,30,-1,7,4,0,4,2,1,3,1,2,3,1,3,4,-1,2,1,1,5,0,1,-6,5,0,0,0,0,-1,0,1,0,-1
KR_6649631887,420,-2,-16,-30,-7,-3,3,0,-1,8,7,2,4,6,-5,7,2,0,1,1,0,-7,2,-2,-7,9,-2,0,-1,-1,-1,-1,1,3,-1
KR_6746180617,420,-5,-17,-54,-8,-1,1,0,-2,5,3,-2,2,0,-2,4,2,-1,1,0,0,-8,0,2,-4,2,2,0,-1,1,-1,-1,1,1,-1
KR_6770387621,420,-4,-55,-13,-12,2,1,3,-3,4,1,-3,5,2,-5,6,1,-3,3,0,-1,-20,-16,-3,-6,9,0,0,-2,1,-1,-1,-1,2,-1
KR_6746175582,420,-4,21,-34,-7,-1,2,1,-7,9,2,1,3,4,3,2,5,-3,3,0,-1,2,-3,-5,-1,6,6,0,-2,-1,-1,-1,-1,5,-1
KR_6695077194,420,-6,-1,0,-16,-5,8,3,0,1,1,-4,6,2,-4,5,1,-3,3,0,0,-12,-95,-3,-2,5,4,0,0,-1,1,1,-1,4,-1
KR_6770582814,420,-2,-51,-44,-7,-2,4,2,0,4,4,-4,5,1,2,1,3,-3,3,0,0,-10,-6,-3,-4,7,-6,0,-1,1,-1,-1,1,2,-1
KR_6758372806,420,-2,-54,0,-8,-4,6,2,-1,3,2,0,1,1,-4,5,1,1,0,1,-1,-2,-5,-8,0,8,-5,0,-2,-1,-1,-1,-1,1,-1
KR_6732329324,420,-4,-48,-4,-7,-2,5,3,3,2,5,-3,4,1,-4,4,0,-1,2,1,0,-11,-5,-2,-4,6,-1,0,-2,-1,-1,-1,-1,4,-1
KR_6758148944,420,-3,-36,-22,1,3,0,3,-5,7,2,5,1,6,-2,5,3,0,1,1,0,-11,-4,4,-10,6,0,0,0,-1,1,-1,-1,6,-1
KR_6770716730,420,3,-48,20,-2,-2,2,0,0,1,1,0,2,2,-2,4,2,2,1,3,0,-3,8,2,-9,7,-4,0,0,1,-1,-1,-1,5,-1
KR_6770847158,420,-2,-53,-8,-5,-4,4,0,2,2,4,-2,4,2,0,4,4,-1,2,1,2,0,4,-2,-4,6,-1,0,-2,1,-1,-1,1,6,-1
KR_6755575530,420,-2,-56,-12,-7,-3,4,1,-3,4,1,-1,3,2,0,2,2,0,0,0,0,1,3,1,-5,4,0,0,-1,-1,-1,-1,-1,3,-1
KR_6748902357,420,-2,-92,-10,-4,0,1,1,0,2,2,-2,4,2,-1,5,4,-1,1,0,0,0,10,3,-9,6,-3,0,-1,1,-1,-1,-1,1,-1
KR_6767136129,420,-2,-5,12,-9,-2,2,0,-3,3,0,0,4,4,-2,5,3,-2,2,0,0,-9,-8,0,-6,6,6,0,0,-1,-1,-1,-1,2,-1
KR_6750482541,420,0,52,-11,-2,-3,4,1,2,4,6,0,3,3,0,3,3,-1,2,1,0,-3,-2,-3,-4,7,5,0,-1,1,-1,-1,-1,2,-1
KR_6763521606,420,4,1,12,12,0,1,1,6,4,10,0,5,5,3,0,3,3,0,3,0,11,-8,-6,-3,9,2,0,1,-1,1,1,1,2,-1
KR_6766989736,420,0,31,12,-6,-1,2,1,-5,9,4,0,0,0,-3,6,3,3,0,3,0,-4,-4,-1,-3,4,1,0,0,1,-1,1,-1,6,-1
KR_6763222187,420,0,35,-3,0,1,0,1,1,1,2,-1,3,2,-3,4,1,2,0,2,0,4,-19,2,-7,5,3,0,0,1,-1,0,1,3,-1
KR_6750464692,420,-1,-47,-2,-5,-1,3,2,-3,6,3,-5,7,2,3,0,3,1,0,1,0,-9,24,2,-6,4,-1,0,0,1,-1,-1,-1,1,-1
KR_6767699895,440,1,53,20,-3,4,1,5,-1,4,3,1,0,1,-7,8,1,0,0,0,0,-6,39,1,-3,2,-16,0,0,1,-1,1,-1,6,-1
KR_6706830388,420,-3,-31,-33,-13,-2,2,0,-5,7,2,-2,6,4,-4,5,1,0,1,1,0,-21,-45,-1,-3,4,10,0,-2,-1,-1,-1,-1,2,-1
KR_6714616608,420,-1,55,-40,-4,2,1,3,-4,4,0,-2,3,1,0,1,1,0,0,0,0,-4,-12,-2,-4,6,-2,0,-1,-1,-1,-1,-1,2,-1
KR_6768638537,420,-2,-25,-21,-4,2,0,2,-1,2,1,-2,6,4,0,4,4,-3,5,2,0,-4,0,0,-3,3,-1,0,-4,-1,-1,-1,-1,3,-1
KR_6745365444,440,-1,-49,8,-6,-2,2,0,-1,4,3,-1,1,0,0,1,1,-2,2,0,0,-8,12,0,-7,7,-4,0,0,1,-1,0,-1,2,-1
KR_6764946020,420,-4,-82,4,-15,-3,4,1,-4,5,1,-6,7,1,-1,3,2,-1,1,0,0,-13,-6,-7,-1,8,6,0,-2,0,0,-1,-1,0,-1
KR_6760359580,420,-4,-74,-35,-9,-3,6,3,-2,4,2,2,1,3,-6,6,0,0,2,2,0,-8,-8,2,-7,5,-1,0,-1,-1,-1,-1,-1,2,-1
KR_6672467385,440,-1,-53,32,-3,-1,1,0,2,2,4,-2,2,0,-4,5,1,2,0,2,0,-14,72,-4,-4,8,-2,0,0,1,-1,-1,-1,5,-1
KR_6762268025,420,-2,-1,-12,-7,0,0,0,-5,5,0,0,1,1,1,2,3,-3,4,1,0,-7,2,-3,-1,4,3,0,-1,-1,1,-1,1,2,-1
KR_6768828724,420,0,-39,6,-3,-2,2,0,-1,1,0,1,1,2,-2,3,1,1,0,1,-1,-7,2,0,-5,5,-4,0,0,-1,-1,-1,-1,4,-1
KR_6620027472,440,-3,-50,-32,-1,-2,4,2,-3,3,0,2,4,6,3,0,3,-1,1,0,0,-1,-14,5,-8,3,-5,0,0,-1,1,0,1,4,-1
KR_6749289416,440,-1,-8,28,0,-1,2,1,0,1,1,1,0,1,1,1,2,-1,1,0,0,0,21,-2,-4,6,-9,0,-1,1,-1,-1,1,2,-1
KR_6755279716,420,0,-50,-39,1,1,4,5,-3,6,3,3,2,5,2,2,4,-2,3,1,0,2,24,0,-8,8,-5,0,0,-1,1,0,-1,4,-1
KR_6728185166,420,-1,17,-2,-3,0,2,2,-2,2,0,1,1,2,-1,4,3,-1,3,2,0,-9,34,1,-6,5,-14,0,0,1,-1,0,-1,4,-1
KR_6763288795,420,-1,-64,-4,0,-1,1,0,-3,3,0,-2,4,2,6,1,7,0,0,0,2,10,-20,-3,-4,7,1,0,1,-1,1,1,1,5,-1
KR_6763066445,420,0,-9,20,3,-4,6,2,0,1,1,-1,1,0,4,0,4,4,0,4,0,-2,19,0,-4,4,-2,0,1,1,-1,1,-1,6,-1
KR_6722333675,420,0,-37,-20,3,1,1,2,2,1,3,-1,5,4,1,3,4,0,1,1,0,1,22,5,-10,5,-2,0,0,1,1,0,-1,6,-1
KR_6762323914,420,-7,-13,-29,-8,-3,5,2,0,2,2,-3,3,0,2,1,3,-4,4,0,0,-4,5,4,-8,4,-3,0,0,1,-1,-1,1,5,-1
KR_6768848443,420,-2,-19,-9,-1,2,1,3,-3,4,1,3,4,7,-3,3,0,0,0,0,0,-2,7,3,-8,5,-1,0,-1,-1,-1,-1,-1,2,-1
KR_6770949241,420,-3,-61,8,-6,-3,3,0,0,3,3,1,2,3,-4,5,1,0,0,0,0,-3,5,1,-6,5,1,0,-2,1,-1,-1,1,6,-1
KR_6769624536,420,0,-17,-24,1,2,0,2,0,3,3,-3,4,1,3,1,4,-1,2,1,0,5,1,-2,-3,5,0,0,-1,-1,-1,-1,1,4,-1
KR_6668632590,420,2,29,-4,2,1,1,2,2,2,4,3,1,4,-1,3,2,-3,4,1,0,-2,-7,-2,-7,9,2,0,0,1,-1,1,1,5,-1
KR_6736652754,420,-3,17,4,-1,-2,5,3,-3,4,1,0,4,4,5,2,7,-1,1,0,0,3,-1,0,-4,4,2,0,-1,-1,-1,-1,1,4,-1
KR_6710665520,420,-4,-70,21,2,-3,3,0,4,2,6,2,2,4,-1,6,5,0,1,1,0,9,16,-1,-2,3,1,0,-3,1,-1,-1,1,1,-1
KR_6758163631,440,-2,8,-32,-5,-5,7,2,1,1,2,-2,6,4,-3,4,1,4,0,4,0,-9,-4,-1,-2,3,6,0,0,-1,1,-1,1,5,-1
KR_6770643977,440,1,16,4,-1,-3,4,1,1,1,2,2,2,4,-1,3,2,0,0,0,0,-1,1,3,-7,4,-2,0,0,1,-1,-1,1,3,-1
KR_6751082660,420,1,18,8,1,-1,1,0,5,2,7,1,0,1,-5,5,0,1,1,2,0,0,-75,4,-10,6,0,0,0,1,1,1,1,5,-1
KR_6731898158,420,-3,-35,-8,-10,-1,1,0,1,2,3,-3,3,0,-6,7,1,-1,2,1,-2,-14,-8,0,-5,5,6,0,0,-1,-1,0,-1,4,-1
KR_6694218303,420,-6,-94,-43,-8,1,2,3,-1,3,2,1,6,7,-2,2,0,-7,7,0,0,-6,2,-6,-3,9,-2,0,-1,-1,-1,-1,1,5,-1
KR_6756895283,440,-2,-55,-16,-9,-7,7,0,1,1,2,-4,4,0,1,3,4,0,0,0,0,-4,5,-7,-2,9,-5,0,-1,-1,-1,-1,-1,1,-1
KR_6738915770,420,-3,-54,-12,-10,-1,3,2,-5,5,0,-1,3,2,2,2,4,-5,5,0,0,-7,1,1,-7,6,-1,0,-1,-1,-1,-1,-1,1,-1
KR_6768681197,420,-3,26,-4,-5,2,2,4,-1,2,1,1,2,3,-5,7,2,-2,2,0,-2,-4,279,3,-6,3,-5,0,0,-1,1,0,-1,3,-1
KR_6688015215,420,-1,39,16,1,1,0,1,-2,3,1,1,0,1,2,4,6,-1,4,3,1,-4,27,1,-7,6,-2,0,0,-1,1,0,1,4,-1
KR_6744406665,420,1,45,7,-3,-1,3,2,-1,4,3,0,2,2,-1,4,3,0,1,1,0,-10,179,4,-8,4,-8,0,2,-1,1,1,-1,4,-1
KR_6764623850,420,-5,-28,0,-7,-3,4,1,-1,5,4,1,1,2,-4,4,0,0,0,0,0,-4,261,1,-5,4,-10,0,0,1,1,-1,-1,2,-1
KR_6732682303,440,-1,12,-8,-7,-3,3,0,1,3,4,-3,4,1,0,5,5,-2,2,0,0,-10,-4,-3,-2,5,3,0,1,1,-1,1,-1,3,-1
KR_6765505660,440,-3,-51,-33,-9,-4,5,1,-2,3,1,3,4,7,-3,5,2,-3,3,0,0,-1,13,6,-10,4,-8,0,-1,0,1,-1,-1,0,-1
KR_6762373861,440,-1,65,-40,-4,-1,2,1,-4,6,2,-2,3,1,0,2,2,3,0,3,0,-7,1,-1,-4,5,-2,0,1,-1,1,1,1,5,-1
KR_6712862204,420,-3,-15,-12,-7,-1,1,0,-1,6,5,-3,4,1,-3,4,1,1,1,2,0,-4,-112,3,-5,2,-3,0,0,1,-1,-1,1,1,-1
KR_6722775153,420,-2,-8,-12,-9,-2,3,1,-1,7,6,-1,2,1,-5,5,0,0,1,1,0,-11,2,1,-5,4,0,0,-1,-1,1,-1,-1,3,-1
KR_6697861379,420,-7,-125,5,-11,-4,5,1,1,3,4,-3,4,1,-3,5,2,-2,2,0,0,-11,-1,2,-8,6,-1,0,-2,-1,-1,-1,-1,4,-1
KR_6698917687,420,-3,-58,-17,-1,-5,5,0,2,2,4,-1,3,2,2,0,2,1,0,1,0,1,5,2,-6,4,1,0,-1,1,-1,-1,-1,3,-1
KR_6716033422,420,-1,-68,4,-8,1,2,3,4,1,5,-4,5,1,-5,8,3,-4,4,0,0,-6,-37,-1,-7,8,3,0,0,1,-1,-1,-1,1,-1
KR_6719358812,420,3,41,10,3,-2,5,3,-1,3,2,4,1,5,2,0,2,0,0,0,0,7,-19,1,-6,5,8,0,-1,0,-1,-1,1,0,-1
KR_6698722962,420,-3,-57,-4,-4,-5,7,2,3,4,7,2,3,5,-3,3,0,-1,1,0,1,1,28,-4,-1,5,-7,0,-3,1,-1,-1,1,4,-1
KR_6734187852,420,-5,-36,-4,-11,-2,2,0,-2,4,2,1,1,2,-5,6,1,-3,4,1,0,-15,-13,-2,-3,5,0,0,-1,-1,1,-1,-1,5,-1
KR_6765599941,420,-1,9,-38,-1,0,1,1,-6,7,1,1,2,3,-2,2,0,6,1,7,0,-1,-37,-4,-2,6,1,0,-1,-1,-1,-1,-1,2,-1
KR_6750087198,420,-5,-40,20,-7,-3,3,0,0,2,2,0,1,1,-2,2,0,-2,2,0,0,-11,21,-3,-1,4,-5,0,-1,1,-1,-1,-1,5,-1
KR_6742577472,440,1,75,17,-2,1,1,2,-3,5,2,0,6,6,1,0,1,-1,3,2,0,-6,-356,-3,-2,5,3,0,2,-1,1,1,-1,3,-1
KR_6767383574,440,-2,-20,-8,-6,1,2,3,0,2,2,-3,3,0,-1,1,0,-3,3,0,0,-10,-2,0,-5,5,-1,0,-1,-1,-1,-1,-1,6,-1
KR_6763508590,420,-2,20,-18,-2,0,2,2,-2,2,0,3,1,4,-2,3,1,-1,2,1,0,-6,2,0,-6,6,-1,0,-1,1,-1,-1,-1,4,-1
KR_6692493149,420,-2,-42,-20,-9,-2,2,0,-9,11,2,0,2,2,-2,4,2,4,3,7,-1,-3,-7,-4,-4,8,1,0,-2,0,-1,-1,-1,0,-1
KR_6620450587,420,-1,-66,-20,-2,3,1,4,-1,4,3,-2,2,0,-1,3,2,-1,2,1,1,4,-10,-1,-2,3,4,0,0,0,1,-1,1,0,-1
KR_6756114875,420,4,24,28,-2,0,1,1,-4,7,3,6,2,8,-4,5,1,0,1,1,0,3,-1,-3,-2,5,1,0,-2,0,1,-1,-1,0,-1
KR_6694734083,420,-2,-29,2,-12,1,1,2,4,2,6,-9,9,0,-8,8,0,0,0,0,0,-7,45,1,-5,4,-1,0,-2,-1,-1,-1,-1,2,-1
KR_6762094097,420,-3,56,-8,-1,-1,2,1,-2,5,3,-2,4,2,2,1,3,2,0,2,0,-2,-6,-1,-4,5,3,0,1,1,1,1,-1,1,-1
KR_6683769703,420,-2,-36,-4,-5,-4,5,1,2,2,4,1,0,1,-3,3,0,-1,1,0,0,-2,1,3,-11,8,-1,0,-1,-1,-1,-1,-1,5,-1
KR_6692521039,420,-4,-89,20,-3,-1,2,1,1,2,3,0,2,2,-1,1,0,-2,4,2,0,-2,17,-4,-7,11,-2,0,0,1,1,-1,1,3,-1
KR_6761638750,440,1,30,0,7,3,3,6,2,2,4,2,2,4,-4,4,0,4,2,6,0,-5,-3,1,-4,3,1,0,0,-1,1,1,-1,6,-1
KR_6763285956,420,-2,-20,-12,-9,1,2,3,-2,4,2,-4,6,2,-4,10,6,0,4,4,0,-3,-8,2,-6,4,-2,0,0,-1,1,-1,1,4,-1
KR_6746768048,420,1,-39,28,2,-2,2,0,1,2,3,0,4,4,1,5,6,2,0,2,0,0,-25,1,-3,2,1,0,1,-1,-1,1,-1,2,-1
KR_6670423188,420,-7,-44,-41,-10,-2,3,1,-3,5,2,-6,7,1,-2,2,0,3,0,3,0,-3,11,4,-9,5,-5,0,-1,-1,-1,-1,1,5,-1
KR_6733412341,420,-2,-55,-11,-4,1,1,2,1,3,4,2,1,3,-8,8,0,0,0,0,0,-3,4,5,-9,4,-6,0,-2,-1,-1,-1,-1,5,-1
KR_6682877438,420,0,-16,-2,2,1,1,2,-3,4,1,2,1,3,3,2,5,-1,3,2,0,-3,297,2,-8,6,1,0,0,1,-1,0,1,5,-1
KR_6674611445,420,-4,-94,0,-7,0,2,2,-3,3,0,-3,4,1,3,0,3,-4,4,0,-1,-14,-11,-2,-1,3,0,0,-1,-1,-1,-1,-1,5,-1
KR_6740868655,420,-3,-75,16,-9,1,0,1,-4,7,3,-3,5,2,-2,2,0,-1,1,0,-1,-14,-278,-2,-3,5,1,0,-2,-1,-1,-1,-1,6,-1
KR_6614429021,420,-3,-22,3,-9,3,1,4,-2,4,2,-2,5,3,-6,6,0,-2,2,0,0,-14,6,0,-5,5,-9,0,-2,1,1,-1,-1,2,-1
KR_6735957163,420,-2,-148,-19,-11,-7,7,0,1,3,4,-6,6,0,1,2,3,0,0,0,0,-2,-4,-1,-2,3,3,0,-3,-1,-1,-1,-1,6,-1
KR_6733447073,420,-5,-21,-34,-10,-3,4,1,-5,8,3,2,3,5,-4,6,2,0,1,1,0,-7,-28,0,-3,3,0,0,-1,-1,-1,-1,-1,1,-1
KR_6763644257,440,-5,-46,-48,-14,-5,6,1,-5,6,1,-6,7,1,2,3,5,0,1,1,-1,-18,-170,1,-6,5,0,0,-2,-1,-1,-1,-1,3,-1
KR_6616023738,420,0,-31,9,-1,3,2,5,0,3,3,0,4,4,-5,6,1,1,1,2,0,-4,-23,-1,-5,6,2,0,-1,-1,-1,-1,1,4,-1
KR_6646494965,420,-2,-40,11,-5,-2,5,3,0,2,2,2,2,4,-3,3,0,-2,3,1,0,-2,-4,3,-5,2,-6,0,-1,-1,-1,-1,-1,1,-1
KR_6769799853,420,-1,-38,4,-4,-5,5,0,-1,2,1,-3,4,1,5,1,6,0,1,1,1,4,-11,2,-6,4,-5,0,-1,-1,1,-1,1,1,-1
KR_6684594933,420,1,-19,-17,5,-2,2,0,1,2,3,2,3,5,4,0,4,0,1,1,0,11,-4,-3,-8,11,1,0,0,-1,1,0,1,1,-1
KR_6745227969,420,-3,-40,-10,-3,-3,3,0,2,2,4,0,1,1,-2,3,1,0,0,0,0,4,-4,-2,-5,7,-1,0,-1,-1,-1,-1,-1,2,-1
KR_6753067779,420,-2,-59,3,-6,3,0,3,-2,3,1,-4,4,0,-1,7,6,-2,2,0,0,-1,6,2,-7,5,-10,0,-1,-1,-1,-1,-1,4,-1
KR_6769557727,420,-3,-49,13,-3,-1,2,1,-1,2,1,-1,3,2,0,2,2,0,0,0,0,2,-96,-3,-5,8,-5,0,-2,-1,-1,-1,-1,1,-1
KR_6756740737,420,-3,-36,-24,-1,3,3,6,-2,4,2,-4,5,1,5,0,5,-3,3,0,0,-9,-5,-7,-1,8,-4,0,0,-1,-1,-1,1,2,-1
KR_6693530691,420,-4,-32,-36,-8,-5,5,0,-3,4,1,-1,4,3,0,1,1,1,0,1,0,-6,-7,-5,-4,9,0,0,-2,-1,-1,-1,-1,6,-1
KR_6759352400,420,2,11,-16,7,5,0,5,0,2,2,1,4,5,-1,3,2,2,0,2,0,4,-7,2,-5,3,1,0,-1,1,-1,-1,1,2,-1
KR_6751625104,420,-3,-5,-10,-10,0,1,1,-1,2,1,-2,6,4,-5,5,0,-2,2,0,-1,-13,-5,0,-5,5,-2,0,1,-1,1,1,-1,6,-1
KR_6739805631,420,-1,-49,1,-2,-1,2,1,2,1,3,1,1,2,-2,3,1,-2,2,0,0,-3,35,4,-11,7,-8,0,-1,1,-1,-1,-1,3,-1
KR_6745272850,420,-8,-46,-16,-13,-2,4,2,-6,7,1,0,1,1,-6,6,0,1,0,1,0,-21,2,0,-2,2,1,0,0,1,-1,-1,-1,4,-1
KR_6770234255,420,-5,-63,13,-16,-4,5,1,-2,4,2,-3,3,0,-6,6,0,-1,1,0,-1,-16,-5,-2,-3,5,-1,0,-3,-1,-1,-1,-1,4,-1
KR_6759462415,420,-1,-29,25,2,-2,2,0,-3,4,1,5,1,6,4,0,4,-2,2,0,0,5,17,4,-10,6,-1,0,0,1,-1,0,-1,3,-1
KR_6709756221,440,-1,-9,16,-7,-1,2,1,-3,7,4,-6,6,0,0,2,2,3,0,3,0,-10,2,2,-5,3,3,0,0,-1,-1,-1,-1,3,-1
KR_6739188488,420,-5,-82,-52,-3,-2,3,1,-3,3,0,6,0,6,1,1,2,-5,6,1,0,-4,3,-2,-6,8,-9,0,-1,-1,-1,-1,-1,5,-1
KR_6719846133,420,-1,-38,-12,-4,-4,5,1,4,3,7,1,0,1,-2,5,3,-3,4,1,0,1,-363,-1,-9,10,-4,0,-1,-1,-1,-1,1,5,-1
KR_6725954710,420,2,30,-11,5,0,2,2,-2,2,0,3,0,3,4,1,5,0,3,3,0,1,-2,-3,-4,7,7,0,2,1,1,1,1,6,-1
KR_6706827823,420,2,20,13,3,0,0,0,-1,2,1,2,4,6,3,0,3,-1,1,0,0,-1,-198,-2,-6,8,1,0,-1,-1,-1,-1,1,6,-1
KR_6753366774,420,-5,-77,7,-15,-4,4,0,-2,2,0,4,0,4,-13,14,1,0,1,1,-2,-8,6,-4,-3,7,-1,0,-2,-1,-1,-1,-1,5,-1
KR_6744609001,420,0,18,-4,1,5,1,6,-4,5,1,-2,4,2,3,2,5,-1,1,0,0,-5,2,2,-7,5,1,0,0,-1,0,0,-1,2,-1
KR_6761518014,440,-4,-101,-7,-7,-1,1,0,0,3,3,-2,7,5,-5,6,1,1,2,3,0,-2,21,0,-4,4,-3,0,-2,1,1,-1,-1,2,-1
KR_6709188316,420,-1,-60,17,-8,1,2,3,3,5,8,-4,5,1,-9,13,4,1,1,2,-1,-2,0,0,-5,5,0,0,-1,1,1,-1,-1,5,-1
KR_6735960839,420,-3,-64,-11,-2,-2,2,0,1,1,2,-2,4,2,2,1,3,-1,3,2,0,-3,44,-3,-1,4,-19,0,1,-1,1,1,1,1,-1
KR_6744563212,420,-4,-76,4,-15,-3,3,0,-2,2,0,-9,9,0,0,4,4,-1,4,3,0,-15,26,-2,-3,5,-4,0,-2,-1,-1,-1,-1,5,-1
KR_6744931204,420,1,4,5,6,3,0,3,4,1,5,5,0,5,-7,8,1,1,0,1,2,1,-9,-2,-4,6,3,0,-1,1,1,-1,1,6,-1
KR_6764581350,440,-2,-10,-16,-2,-2,6,4,-1,2,1,-1,3,2,1,0,1,1,0,1,-1,-2,-2,1,-5,4,0,0,0,1,-1,-1,-1,5,-1
KR_6705759211,420,1,-10,-36,0,5,1,6,-8,11,3,0,1,1,2,1,3,1,1,2,0,-4,-68,3,-6,3,22,0,1,1,0,1,1,6,-1
KR_6756747456,420,-2,23,-69,-3,-3,4,1,0,3,3,-3,5,2,3,2,5,0,2,2,0,3,36,-2,-4,6,-10,0,0,-1,1,1,1,3,-1
KR_6758353830,420,-3,-66,-5,-7,-2,6,4,1,1,2,-3,5,2,-3,5,2,0,2,2,0,-16,-3,1,-7,6,-3,0,0,1,-1,-1,1,6,-1
KR_6761823189,420,1,-21,16,1,1,0,1,-4,6,2,4,3,7,0,2,2,0,0,0,0,0,105,4,-10,6,-1,0,0,-1,1,1,-1,1,-1
KR_6681506954,440,-2,-27,-25,3,0,2,2,2,2,4,-1,4,3,0,0,0,2,0,2,1,3,-7,2,-8,6,1,0,-1,1,-1,-1,1,4,-1
KR_6755549754,420,1,76,-12,-4,2,0,2,0,0,0,1,2,3,-3,5,2,-4,4,0,0,-7,8,-2,-4,6,-1,0,0,-1,1,-1,-1,4,-1
KR_6756278329,420,-3,-12,-8,-7,3,0,3,-6,6,0,0,0,0,-2,3,1,-2,2,0,-1,-11,-20,-6,-4,10,5,0,-1,-1,0,-1,-1,6,-1
KR_6722627501,420,-4,-17,-52,-19,1,1,2,-11,12,1,-2,3,1,-5,8,3,-2,2,0,-1,-37,-174,-6,-3,9,0,0,-3,-1,-1,-1,-1,5,-1
KR_6766872466,420,-1,-21,-4,-8,-5,5,0,2,2,4,-5,9,4,0,1,1,0,2,2,-1,-12,28,2,-8,6,-6,0,0,-1,1,0,-1,4,-1
KR_6597487979,420,-7,-77,10,-14,-6,6,0,-1,2,1,0,0,0,-4,6,2,-3,3,0,0,-14,-23,-1,-4,5,0,0,-3,-1,-1,-1,-1,4,-1
KR_6682905998,420,-7,-13,-22,-8,-2,5,3,0,1,1,-1,4,3,-2,7,5,-3,5,2,0,-12,2,-1,-4,5,-2,0,-2,-1,1,-1,1,2,-1
KR_6763953910,420,2,28,44,5,1,1,2,1,2,3,-1,2,1,3,2,5,1,1,2,0,-1,2,2,-7,5,-4,0,0,-1,-1,0,-1,2,-1
KR_6740773489,440,1,-33,22,1,2,1,3,3,0,3,2,2,4,1,4,5,-7,8,1,0,0,-2,0,-6,6,-3,0,0,-1,1,1,1,2,-1
KR_6756463524,420,0,20,-21,-1,-1,3,2,2,1,3,5,1,6,-4,5,1,-3,3,0,0,-8,-146,3,-9,6,1,0,0,0,-1,0,1,0,-1
KR_6758369321,440,3,5,-2,1,1,1,2,-1,5,4,-1,2,1,1,0,1,1,4,5,0,-1,-1,-3,-2,5,1,0,1,1,1,1,1,1,-1
KR_6734063164,420,-5,-37,-24,-11,-2,4,2,-2,2,0,-3,4,1,-5,5,0,1,1,2,0,-17,-12,-7,-5,12,-2,0,-1,1,-1,-1,-1,1,-1
KR_6761920844,440,-4,-88,-16,-6,-6,8,2,-2,4,2,-1,1,0,6,1,7,-3,3,0,0,-3,2,-2,-3,5,1,0,0,-1,1,-1,-1,5,-1
KR_6753874643,440,-3,47,-27,0,2,0,2,-1,1,0,-4,4,0,5,0,5,-2,3,1,0,0,2,-1,-2,3,1,0,-1,1,-1,-1,1,6,-1
KR_6676055507,420,5,71,16,16,0,2,2,6,1,7,7,0,7,0,4,4,3,1,4,0,16,-106,-3,-3,6,1,0,1,-1,-1,1,1,5,-1
KR_6763485790,420,-4,-12,2,-5,-3,4,1,3,2,5,3,0,3,-8,9,1,0,1,1,0,-5,16,1,-5,4,-2,0,0,-1,-1,-1,1,2,-1
KR_6704546234,420,2,13,53,2,-2,4,2,-2,4,2,-1,1,0,5,0,5,2,1,3,0,6,-10,-4,-7,11,6,0,1,1,-1,1,1,6,-1
KR_6770652487,420,0,14,-21,5,-1,4,3,1,2,3,-1,4,3,5,1,6,1,0,1,0,6,-2,-2,-5,7,4,0,1,1,-1,-1,1,2,-1
KR_6745295575,420,-2,49,12,-3,-2,3,1,-2,4,2,-1,2,1,3,1,4,-1,1,0,0,-7,13,3,-5,2,-4,0,0,-1,-1,0,1,6,-1
KR_6758021251,420,-2,-26,0,-5,1,1,2,-2,6,4,-1,4,3,-5,5,0,2,0,2,1,-6,0,-2,-4,6,1,0,-1,-1,0,-1,1,2,-1
KR_6629560976,420,-2,14,-35,-2,1,1,2,3,4,7,-1,1,0,-4,4,0,-1,2,1,0,-4,7,2,-9,7,-4,0,1,-1,1,1,-1,5,-1
KR_6613733449,420,1,1,9,2,2,1,3,0,3,3,-2,3,1,1,0,1,1,0,1,0,0,-1,-2,-6,8,5,0,0,1,1,0,1,6,-1
KR_6743877604,420,1,-14,35,-2,-2,3,1,-3,5,2,-4,5,1,-3,4,1,10,1,11,-1,-4,7,-4,-5,9,-2,0,1,-1,1,1,-1,5,-1
KR_6768467436,420,0,-24,4,-5,-1,5,4,-1,4,3,0,4,4,-1,2,1,-2,2,0,-1,-11,4,4,-5,1,-5,0,-1,-1,-1,-1,-1,4,-1
KR_6714954327,420,-2,-26,-11,-1,-4,4,0,1,4,5,0,1,1,0,3,3,2,0,2,1,2,-3,-1,-7,8,0,0,1,-1,-1,1,-1,2,-1
KR_6754790262,420,0,39,17,2,2,1,3,-5,9,4,3,2,5,1,3,4,1,0,1,1,3,-16,2,-5,3,2,0,1,1,-1,1,1,5,-1
KR_6749426796,420,3,5,36,-1,1,1,2,3,0,3,-1,3,2,-3,3,0,-1,1,0,0,-4,20,1,-5,4,-2,0,0,0,1,0,-1,0,-1
KR_6770526531,420,-2,-19,-17,-11,-4,5,1,-2,3,1,-3,3,0,-2,2,0,0,1,1,0,-17,-12,-5,-2,7,7,0,-1,-1,-1,-1,-1,6,-1
KR_6738633113,420,-2,-8,16,-6,-5,5,0,-2,5,3,-2,2,0,0,2,2,3,1,4,0,-3,-1,0,-3,3,-3,0,0,1,-1,-1,1,6,-1
KR_6751415475,420,0,3,-12,1,-2,3,1,-1,3,2,-1,1,0,6,1,7,-1,1,0,0,-1,6,-2,-4,6,9,0,-1,-1,-1,-1,-1,1,-1
KR_6766940435,420,2,60,-42,9,-3,3,0,1,3,4,1,1,2,9,0,9,1,1,2,0,21,6,3,-4,1,1,0,-1,-1,-1,-1,1,2,-1
KR_6765743086,420,0,-23,-8,6,-3,4,1,6,1,7,-1,2,1,3,2,5,1,0,1,0,16,2,0,-5,5,1,0,-1,1,-1,-1,1,6,-1
KR_6745918458,420,-2,-1,-14,-5,7,1,8,-2,5,3,-3,4,1,-7,11,4,0,2,2,0,1,-8,3,-8,5,-2,0,-1,-1,-1,-1,-1,5,-1
KR_6769284150,440,-6,-37,-1,-13,-1,2,1,-4,4,0,-2,2,0,-3,5,2,-3,4,1,-1,-12,10,1,-5,4,0,0,-1,-1,-1,-1,-1,6,-1
KR_6770042671,420,-1,-41,-3,-1,-4,4,0,3,2,5,0,1,1,-1,4,3,1,0,1,0,6,-13,3,-7,4,-5,0,0,0,1,-1,-1,0,-1
KR_6762533804,420,2,-23,8,3,-4,6,2,3,0,3,0,1,1,4,3,7,0,1,1,0,7,10,2,-5,3,-3,0,-1,1,1,-1,-1,5,-1
KR_6700522512,420,2,-28,28,-7,-1,3,2,2,2,4,4,1,5,-4,4,0,-8,9,1,0,-11,234,1,-6,5,0,0,-1,-1,1,1,-1,5,-1
KR_6723044243,420,-1,-40,-16,-5,-3,4,1,3,5,8,-2,4,2,-3,5,2,0,0,0,-1,-7,-3,1,-5,4,-1,0,0,-1,-1,-1,-1,5,-1
KR_6757270995,420,-2,-17,5,-5,0,1,1,0,3,3,-1,4,3,-1,2,1,-3,4,1,0,-8,3,1,-6,5,-2,0,0,-1,-1,0,-1,1,-1
KR_6751745885,420,2,22,19,0,4,4,8,-1,4,3,-2,2,0,-1,3,2,0,0,0,0,-8,294,-2,-6,8,0,0,0,-1,-1,-1,1,1,-1
KR_6737214140,420,-1,-63,24,7,1,0,1,1,2,3,4,1,5,-1,1,0,2,1,3,0,5,-7,0,-6,6,-7,0,0,1,0,0,1,6,-1
KR_6757342449,420,0,54,32,-5,0,1,1,0,1,1,-1,2,1,-4,6,2,0,0,0,-1,-13,10,-2,-4,6,1,0,0,1,1,0,-1,1,-1
KR_6732256768,440,-1,-24,-5,-11,-1,4,3,-2,2,0,-5,5,0,-5,8,3,2,0,2,0,-11,2,0,-5,5,1,0,-1,-1,-1,-1,-1,2,-1
KR_6769512500,440,2,-4,8,6,1,1,2,1,0,1,1,1,2,5,0,5,-2,2,0,1,13,11,2,-8,6,-2,0,0,1,-1,-1,1,6,-1
KR_6768588139,420,-1,-7,-11,0,0,2,2,-3,5,2,1,1,2,3,1,4,-1,1,0,0,8,4,5,-7,2,1,0,1,-1,-1,1,1,3,-1
KR_6690771604,420,-4,-23,-11,-13,2,0,2,-9,9,0,-4,6,2,-2,8,6,0,1,1,0,-19,-116,-2,-4,6,1,0,-1,-1,1,-1,-1,2,-1
KR_6734093944,420,-4,24,1,-9,1,0,1,-1,6,5,-6,7,1,-2,3,1,-1,2,1,0,-8,-33,0,-3,3,-2,0,0,1,0,0,1,2,-1
KR_6770757628,420,-4,4,8,-7,-5,6,1,2,3,5,1,1,2,-4,5,1,-1,2,1,0,-1,37,-2,-3,5,2,0,-1,1,-1,-1,-1,5,-1
KR_6644691965,420,-1,16,23,-7,-7,8,1,-1,6,5,-4,5,1,3,0,3,2,0,2,-1,-9,86,2,-5,3,-1,0,0,1,-1,-1,-1,2,-1
KR_6765249760,420,-4,-25,-56,-10,-3,3,0,1,0,1,-2,3,1,-6,6,0,0,0,0,0,-5,119,-3,-1,4,-2,0,-1,-1,-1,-1,-1,2,-1
KR_6759228738,420,-2,-36,-1,-12,-1,3,2,-1,1,0,-7,7,0,-6,7,1,3,1,4,0,-17,38,-4,-3,7,-15,0,-1,-1,-1,-1,-1,2,-1
KR_6734857713,420,2,7,19,2,3,1,4,-2,4,2,-3,3,0,6,0,6,-2,4,2,0,0,-6,1,-9,8,5,0,1,-1,1,1,1,3,-1
KR_6706316739,420,3,-7,18,2,2,1,3,-2,4,2,-1,3,2,2,0,2,1,0,1,0,-3,25,-4,-5,9,-4,0,-1,1,-1,-1,1,6,-1
KR_6690898142,420,2,-20,4,6,1,1,2,3,1,4,-2,5,3,2,3,5,2,1,3,0,8,2,-2,-5,7,2,0,1,1,1,1,-1,4,-1
KR_6750465532,420,-3,-30,-20,-8,0,1,1,-1,3,2,1,2,3,-6,7,1,-2,2,0,0,-12,23,-4,-2,6,-26,0,0,-1,1,-1,-1,6,-1
KR_6704848875,420,-1,-44,-17,0,1,0,1,1,1,2,2,1,3,-4,7,3,0,0,0,0,1,140,1,-10,9,0,0,0,1,1,-1,-1,4,-1
KR_6752901766,420,-7,-57,-23,-15,-2,2,0,-2,3,1,-3,3,0,-4,5,1,-4,4,0,0,-16,-29,-3,-5,8,-2,0,-2,-1,1,-1,-1,6,-1
KR_6606609036,420,2,-19,32,3,-1,3,2,-3,5,2,0,5,5,5,0,5,2,1,3,1,-3,-1,3,-7,4,-1,0,1,1,-1,-1,1,1,-1
KR_6738661610,440,-3,4,-8,-3,1,1,2,1,1,2,-3,5,2,-2,2,0,0,1,1,0,-5,14,-1,-4,5,0,0,1,-1,1,1,1,1,-1
KR_6739438120,440,-2,-51,8,-4,0,2,2,-2,4,2,-3,5,2,5,1,6,-4,5,1,0,3,4,-1,-4,5,-8,0,-2,-1,-1,-1,1,4,-1
KR_6768476786,420,-2,-73,-4,-6,-3,3,0,3,0,3,-4,4,0,-3,4,1,1,1,2,0,-3,2,1,-4,3,-3,0,0,-1,1,1,-1,3,-1
KR_6694473745,420,-1,12,-12,-4,-1,1,0,0,2,2,0,1,1,-3,5,2,0,0,0,-1,-6,-5,-1,-4,5,-1,0,0,-1,-1,0,-1,6,-1
KR_6768607032,420,-1,25,-4,2,2,1,3,3,0,3,3,0,3,-2,4,2,-4,6,2,0,4,193,-4,-3,7,0,0,-1,1,-1,-1,1,1,-1
KR_6769017050,420,1,45,-15,2,6,0,6,3,1,4,-5,6,1,-3,6,3,1,1,2,0,2,2,1,-3,2,-4,0,0,-1,1,1,1,3,-1
KR_6739213088,420,0,-31,-12,4,2,1,3,1,2,3,2,4,6,-1,3,2,0,0,0,2,7,-115,-1,-6,7,1,0,0,1,1,0,1,2,-1
KR_6690034557,420,-6,-53,-37,-13,-8,8,0,-6,6,0,3,1,4,0,1,1,-2,2,0,0,-6,-3,-4,-3,7,-1,0,-1,-1,1,-1,-1,4,-1
KR_6699993495,420,1,-31,0,7,-1,5,4,2,2,4,5,2,7,2,2,4,-1,1,0,1,15,-113,-1,-5,6,-4,0,-2,1,-1,-1,1,5,-1
KR_6715399778,420,-4,-57,-32,-13,-1,2,1,-4,4,0,-4,6,2,-4,4,0,0,1,1,-1,-22,3,0,-5,5,-3,0,-3,-1,-1,-1,-1,3,-1
KR_6750959062,420,-2,-21,0,-4,-2,2,0,-3,5,2,2,1,3,-1,6,5,0,1,1,0,-14,144,0,-3,3,3,0,-2,-1,-1,-1,-1,4,-1
KR_6760848529,420,-2,38,0,-7,0,1,1,0,3,3,-4,8,4,-2,3,1,-1,2,1,0,-9,-14,-6,-5,11,1,0,-1,0,-1,-1,-1,0,-1
KR_6719508858,440,-3,28,-36,-1,1,1,2,-3,7,4,-1,1,0,4,0,4,-2,3,1,0,-2,-4,2,-4,2,0,0,0,-1,-1,0,1,6,-1
KR_6747447265,440,-1,-62,-27,2,0,2,2,1,0,1,-5,5,0,5,0,5,1,3,4,1,0,-16,2,-7,5,-7,0,0,1,-1,0,1,4,-1
KR_6759051984,420,2,45,32,5,-3,5,2,1,1,2,0,2,2,7,2,9,0,2,2,-1,4,-2,0,-9,9,5,0,1,1,1,1,-1,2,-1
KR_6746585867,420,-2,-54,-32,-1,-1,2,1,2,2,4,1,0,1,-2,2,0,-1,2,1,1,3,-7,0,-5,5,1,0,0,-1,-1,-1,1,2,-1
KR_6676448897,420,-1,-17,11,-7,0,1,1,-2,4,2,3,1,4,-2,3,1,-6,6,0,0,-18,2,-5,-5,10,-7,0,-2,0,1,-1,1,0,-1
KR_6692252115,420,-2,0,18,-2,-2,4,2,0,3,3,3,3,6,-2,6,4,-1,3,2,0,-2,26,5,-7,2,0,0,-2,-1,1,-1,-1,4,-1
KR_6695716830,420,-2,-43,-11,-9,-4,5,1,-2,8,6,-5,5,0,3,1,4,-1,2,1,1,3,-11,-2,-3,5,2,0,0,1,-1,0,1,5,-1
KR_6766703399,420,-1,55,11,3,1,5,6,2,1,3,3,0,3,2,1,3,-5,6,1,1,1,160,2,-6,4,-2,0,0,0,1,0,1,0,-1
KR_6629620843,420,-1,-13,-12,-6,-1,2,1,-3,6,3,0,2,2,0,3,3,-2,2,0,-1,-11,3,1,-7,6,-9,0,-1,-1,-1,-1,-1,4,-1
KR_6694400018,420,4,68,-15,1,6,1,7,2,3,5,3,2,5,-9,9,0,-1,2,1,1,-7,-4,3,-6,3,-2,0,1,-1,1,1,1,3,-1
KR_6642676844,420,-1,-28,-12,-5,-3,3,0,-1,1,0,-4,4,0,3,0,3,0,0,0,0,-1,-7,1,-9,8,-1,0,0,-1,1,0,-1,2,-1
KR_6548321200,420,1,-43,-7,-6,1,0,1,1,3,4,-4,4,0,-3,6,3,-1,1,0,0,-18,-8,-3,-9,12,-2,0,0,-1,-1,-1,1,5,-1
KR_6770324920,420,-1,-60,0,0,3,1,4,-1,3,2,1,1,2,-2,5,3,-1,2,1,0,-6,-2,1,-7,6,-3,0,-1,1,-1,-1,1,1,-1
KR_6756736395,420,-1,34,-13,-8,0,0,0,-1,3,2,-6,7,1,-1,4,3,0,0,0,0,0,10,0,-6,6,-2,0,0,-1,-1,0,1,2,-1
KR_6746187296,420,2,41,9,3,4,1,5,0,1,1,3,0,3,-4,4,0,0,0,0,0,-3,-37,-2,-3,5,-1,0,0,-1,1,1,1,6,-1
KR_6728877542,440,-9,-149,-41,-4,-3,3,0,1,2,3,-2,2,0,-1,1,0,1,1,2,0,-1,-121,-6,-1,7,9,0,-3,-1,-1,-1,-1,1,-1
KR_6766729671,440,-2,-72,-25,-1,-2,2,0,5,2,7,-1,2,1,-4,8,4,1,1,2,-1,5,3,3,-10,7,0,0,-1,-1,1,-1,-1,6,-1
KR_6764365703,420,-3,-10,-8,-9,0,0,0,-6,8,2,-2,4,2,-1,2,1,0,0,0,0,-15,-20,1,-5,4,0,0,-1,-1,1,-1,-1,6,-1
KR_6748792125,420,0,-12,-4,-2,-2,3,1,1,1,2,2,7,9,-2,3,1,-1,1,0,0,-2,77,1,-7,6,-1,0,-1,1,-1,-1,-1,2,-1
KR_6741184121,420,-6,-13,-42,-6,1,2,3,-1,7,6,-3,6,3,-2,4,2,-1,2,1,0,-3,-5,2,-6,4,-2,0,0,-1,-1,-1,1,6,-1
KR_6764875397,440,1,-13,-12,1,-3,5,2,2,3,5,0,1,1,1,1,2,1,1,2,0,3,-34,0,-4,4,2,0,-1,1,-1,-1,-1,4,-1
KR_6757901827,420,-5,-24,-7,-8,-3,3,0,-1,2,1,0,1,1,-2,3,1,-2,2,0,0,-8,-1,-3,-3,6,0,0,-3,-1,-1,-1,-1,1,-1
KR_6706630028,420,-1,-37,8,-6,1,1,2,0,0,0,-7,9,2,-1,2,1,1,0,1,-1,-9,9,1,-7,6,-5,0,-1,1,-1,-1,-1,4,-1
KR_6717078752,420,-3,-56,-5,-4,0,2,2,-1,1,0,0,0,0,1,3,4,-4,4,0,0,-3,-1,4,-8,4,-2,0,-1,1,1,-1,-1,3,-1
KR_6763422608,440,-4,-127,0,-8,0,1,1,-5,6,1,-1,3,2,-1,1,0,-1,1,0,0,-8,0,-2,-1,3,-1,0,-1,-1,-1,-1,1,4,-1
KR_6766733586,440,-1,25,-46,-1,2,2,4,-1,2,1,-4,4,0,2,1,3,0,1,1,0,-1,-8,1,-8,7,4,0,0,-1,0,0,1,3,-1
KR_6746454585,440,-2,-95,5,-4,-6,6,0,11,2,13,-4,5,1,-4,4,0,-1,1,0,0,-4,-22,1,-1,0,-2,0,-3,1,-1,-1,1,3,-1
KR_6758627188,420,-1,22,-7,-10,-2,3,1,2,1,3,-4,8,4,-6,8,2,0,1,1,0,-14,33,2,-4,2,-23,0,0,-1,-1,0,-1,4,-1
KR_6762957290,420,1,-32,30,-6,-2,3,1,-3,4,1,-1,5,4,-1,4,3,1,1,2,-1,-3,-2,-1,-3,4,0,0,-1,-1,-1,-1,-1,2,-1
KR_6768710737,420,0,-22,0,3,-3,4,1,-1,4,3,2,2,4,5,0,5,0,1,1,2,5,4,4,-7,3,2,0,-1,-1,-1,-1,1,2,-1
KR_6764761178,420,-1,-1,-19,-7,0,1,1,-2,4,2,1,0,1,-4,5,1,-2,2,0,0,-6,-6,-2,-6,8,0,0,0,-1,1,0,1,5,-1
KR_6765736830,440,-4,-86,-16,-1,-3,3,0,0,2,2,2,2,4,0,2,2,0,0,0,0,-3,-32,-3,-5,8,5,0,0,-1,1,0,1,1,-1
KR_6762139963,420,0,-13,12,-1,0,0,0,-1,4,3,-1,4,3,1,1,2,0,0,0,0,-1,47,-1,-5,6,-2,0,0,1,-1,1,-1,5,-1
KR_6691738804,420,-3,-84,28,-6,-1,2,1,-4,4,0,0,3,3,-3,5,2,2,0,2,-1,-4,-11,-3,-7,10,2,0,0,1,-1,-1,-1,2,-1
KR_6754235084,420,-3,7,-16,-5,-1,1,0,-3,4,1,-2,3,1,2,2,4,-1,1,0,0,-1,14,2,-5,3,0,0,0,-1,-1,-1,-1,5,-1
KR_6735901120,420,2,-3,-7,0,-4,5,1,-1,2,1,3,1,4,5,0,5,-3,3,0,0,0,6,-5,-3,8,2,0,0,0,-1,0,1,0,-1
KR_6750332694,420,-3,-22,-11,-3,-1,1,0,1,4,5,1,0,1,-3,5,2,-1,2,1,0,-2,10,0,-4,4,1,0,-1,1,-1,-1,-1,3,-1
KR_6425837309,440,-7,-95,14,-22,-5,5,0,-3,5,2,-6,10,4,-7,7,0,-1,1,0,0,-18,6,0,-6,6,-6,0,-3,-1,-1,-1,-1,6,-1
KR_6624094943,440,2,15,10,-3,-6,9,3,0,4,4,-1,5,4,3,0,3,1,1,2,1,-9,-106,0,-6,6,0,0,-1,-1,1,-1,1,4,-1
KR_6764170879,440,-2,26,0,-8,0,1,1,-8,8,0,0,1,1,-1,2,1,1,0,1,0,-8,0,-3,-5,8,4,0,0,0,1,0,1,0,-1
KR_6757440507,420,-4,6,1,-10,1,1,2,1,1,2,-9,9,0,-6,10,4,3,0,3,0,-7,-15,-4,-1,5,6,0,-1,-1,1,-1,-1,4,-1
KR_6608122861,420,3,11,64,-1,1,1,2,2,0,2,1,1,2,-5,7,2,0,0,0,0,-1,-8,-5,-3,8,-6,0,0,-1,-1,0,-1,2,-1
KR_6756693385,420,3,-9,-27,2,-3,4,1,1,1,2,4,0,4,1,1,2,-1,2,1,-1,2,-26,1,-5,4,2,0,1,1,1,1,-1,6,-1
KR_6767158865,420,0,37,-4,-4,0,1,1,-4,6,2,0,1,1,-1,2,1,1,0,1,0,-4,6,3,-7,4,-2,0,0,-1,-1,0,-1,5,-1
KR_6686965181,440,-1,-45,-8,-3,4,2,6,-3,3,0,1,2,3,-5,6,1,0,0,0,0,-4,1,0,-6,6,2,0,0,-1,1,-1,-1,5,-1
KR_6758791679,420,2,14,24,4,1,3,4,-1,6,5,2,3,5,0,3,3,2,0,2,1,-2,23,-2,-4,6,3,0,1,1,1,1,1,6,-1
KR_6669307179,420,-2,-1,30,-11,-1,1,0,-6,9,3,0,1,1,-1,3,2,-3,5,2,0,-21,-28,0,-4,4,4,0,0,1,1,1,-1,3,-1
KR_6761660358,420,0,-26,-16,-3,-1,2,1,-2,5,3,1,2,3,0,1,1,-1,1,0,0,-2,3,-1,-3,4,-3,0,-1,-1,-1,-1,1,6,-1
KR_6732670447,440,1,7,-17,-3,-3,4,1,0,2,2,-1,3,2,0,0,0,1,0,1,0,1,-8,-5,-5,10,1,0,0,-1,0,0,1,1,-1
KR_6770237815,420,-1,-54,7,1,-4,4,0,2,2,4,-1,3,2,7,3,10,-3,3,0,-1,7,-8,-9,-3,12,6,0,-1,0,-1,-1,-1,0,-1
KR_6716792503,420,-3,-51,-12,-15,-5,5,0,-5,6,1,-4,6,2,-2,3,1,1,0,1,0,-5,43,1,-8,7,-17,0,-1,-1,-1,-1,-1,2,-1
KR_6759757249,420,1,21,-20,2,-3,6,3,-2,3,1,0,1,1,5,0,5,2,0,2,0,10,-13,-2,-4,6,2,0,0,-1,1,0,1,3,-1
KR_6760703649,420,3,-41,0,11,2,2,4,2,1,3,3,1,4,3,1,4,1,0,1,0,9,-4,-3,-5,8,-1,0,0,0,-1,0,1,0,-1
KR_6627587500,420,-5,-73,-19,-12,-1,3,2,-1,2,1,-4,8,4,-4,7,3,-2,2,0,0,-9,-4,0,-7,7,-4,0,-4,1,1,-1,1,4,-1
KR_6737190810,420,0,1,-32,4,4,0,4,0,3,3,-2,5,3,-2,4,2,4,1,5,0,0,-8,-1,-7,8,4,0,1,-1,1,1,1,3,-1
KR_6759463296,420,1,12,8,-1,0,1,1,2,2,4,-3,6,3,2,0,2,-2,2,0,0,4,7,-5,-2,7,-4,0,0,-1,-1,0,-1,1,-1
KR_6710588481,420,-2,-26,5,-12,0,2,2,-6,9,3,-1,3,2,-6,6,0,1,3,4,0,-12,12,0,-7,7,-7,0,-1,-1,-1,-1,-1,1,-1
KR_6717125917,420,-6,-76,-28,-9,-2,3,1,-5,5,0,1,1,2,-3,5,2,0,0,0,0,-5,-7,-1,-3,4,-2,0,-3,-1,-1,-1,-1,4,-1
KR_6764203279,420,2,45,3,4,4,2,6,-3,5,2,6,0,6,-2,4,2,-1,4,3,0,-6,-81,0,-5,5,-1,0,1,-1,1,1,-1,5,-1
KR_6754410786,440,-6,-88,16,-20,-2,3,1,-5,5,0,-5,5,0,-5,5,0,-3,4,1,0,-23,0,1,-6,5,-1,0,-2,-1,-1,-1,-1,5,-1
KR_6649682429,420,1,13,-2,10,0,0,0,2,2,4,3,1,4,3,1,4,2,1,3,2,13,-4,5,-11,6,8,0,0,1,-1,0,1,2,-1
KR_6713930546,420,1,19,-13,2,7,3,10,0,1,1,-2,6,4,-1,2,1,-2,2,0,-1,-8,0,-1,-2,3,0,0,0,1,1,1,-1,2,-1
KR_6725969062,420,-2,-31,-40,-2,1,2,3,-2,3,1,-1,2,1,-1,3,2,1,0,1,0,4,-4,-5,-5,10,4,0,0,-1,-1,0,-1,1,-1
KR_6762470554,420,-2,-76,4,-8,-2,2,0,-2,3,1,0,1,1,-4,5,1,0,1,1,0,-7,14,-2,-4,6,-5,0,-1,-1,1,-1,-1,3,-1
KR_6760574723,440,-3,-29,-15,-4,-1,2,1,5,2,7,-1,4,3,0,1,1,-7,7,0,0,4,63,-1,-4,5,1,0,0,-1,1,-1,1,1,-1
KR_6754596570,420,-1,-32,-16,-3,-7,8,1,0,2,2,-1,1,0,2,2,4,3,0,3,0,-2,91,-6,-1,7,3,0,-1,0,-1,-1,1,0,-1
KR_6693950157,420,-5,-62,-23,-10,-5,7,2,2,3,5,-4,4,0,-2,4,2,-1,2,1,0,-9,0,-2,-4,6,-6,0,-2,-1,-1,-1,-1,1,-1
KR_6716343605,420,-3,-82,28,-8,-3,3,0,-1,3,2,-4,5,1,1,1,2,-1,1,0,0,-9,-66,0,-4,4,1,0,-2,-1,1,-1,-1,6,-1
KR_6770316924,420,0,-15,-2,-3,-1,1,0,-3,7,4,0,2,2,-1,4,3,2,0,2,0,-3,9,-2,-7,9,-1,0,1,1,-1,1,1,2,-1
KR_6766939896,420,-3,-68,16,-10,0,1,1,-3,6,3,-4,4,0,-3,3,0,0,0,0,0,-5,-15,-3,-2,5,-3,0,0,-1,-1,0,-1,4,-1
KR_6763404262,420,-2,-31,29,-5,1,1,2,0,1,1,-3,3,0,-4,6,2,1,0,1,0,-10,-2,4,-7,3,-3,0,-1,-1,1,-1,1,2,-1
KR_6770508987,420,0,20,-12,0,0,1,1,0,4,4,-1,2,1,1,1,2,0,0,0,0,4,2,-4,-5,9,1,0,0,-1,-1,0,1,5,-1
KR_6743802626,420,-1,4,8,0,0,2,2,0,3,3,-5,6,1,5,0,5,0,1,1,0,-3,-1,-1,-6,7,4,0,-2,1,0,-1,1,6,-1
KR_6755712338,440,-2,11,12,-3,1,3,4,-4,4,0,-4,4,0,-3,3,0,7,4,11,-1,-8,6,4,-7,3,-3,0,0,0,-1,0,1,0,-1
KR_6716456195,420,-5,-53,-13,-11,-2,3,1,-1,4,3,-3,5,2,-3,6,3,-2,2,0,0,-11,-7,-1,-4,5,-6,0,0,-1,-1,-1,1,3,-1
KR_6753326118,420,3,80,-3,3,0,2,2,-1,1,0,0,2,2,1,3,4,3,0,3,0,9,20,3,-7,4,0,0,0,1,-1,-1,1,5,-1
KR_6749563344,420,-1,-65,8,-2,-2,4,2,-1,3,2,2,1,3,0,2,2,-1,1,0,0,-3,8,0,-4,4,-7,0,-1,-1,-1,-1,-1,4,-1
KR_6742187996,420,0,17,48,-7,-4,5,1,0,1,1,0,1,1,-4,5,1,1,0,1,0,-9,18,1,-6,5,2,0,0,-1,-1,0,-1,2,-1
KR_6724760443,420,-2,-70,-24,-9,0,0,0,0,5,5,-4,4,0,-1,6,5,-4,4,0,-1,-12,9,2,-6,4,-4,0,-1,1,-1,-1,-1,4,-1
KR_6677794780,420,-2,13,-6,-13,-1,2,1,-2,5,3,-4,6,2,-4,5,1,-2,2,0,-2,-17,12,3,-7,4,-7,0,0,1,-1,-1,-1,1,-1
KR_6715444419,420,-6,-97,-6,-14,1,2,3,-2,8,6,-6,6,0,-7,10,3,0,1,1,-2,-20,-44,-3,-7,10,10,0,-2,-1,1,-1,-1,6,-1
KR_6654396614,420,0,-67,12,4,-2,3,1,0,4,4,1,2,3,3,1,4,2,0,2,0,7,-8,-3,-5,8,2,0,-2,1,-1,-1,1,2,-1
KR_6746283743,420,-2,-66,-32,2,-1,1,0,-3,5,2,4,1,5,0,5,5,2,0,2,-2,3,-33,7,-9,2,23,0,-1,-1,-1,-1,-1,5,-1
KR_6731551871,420,0,-2,12,-3,1,1,2,-2,6,4,-2,3,1,1,2,3,-1,2,1,0,-6,-199,-1,-8,9,3,0,0,1,-1,0,-1,2,-1
KR_6770317407,420,-1,35,20,1,-2,3,1,2,2,4,1,1,2,-1,1,0,1,1,2,0,-2,-5,-3,-2,5,3,0,0,1,1,0,-1,5,-1
KR_6754303792,420,-9,-100,-19,-5,-4,7,3,0,3,3,0,3,3,-2,2,0,1,1,2,0,-13,-9,-2,-4,6,2,0,-3,-1,-1,-1,-1,2,-1
KR_6756380681,420,-1,-29,-9,-2,0,3,3,1,4,5,-2,5,3,1,5,6,-2,3,1,0,-3,5,-1,-8,9,-6,0,0,-1,1,-1,-1,2,-1
KR_6732991024,420,-2,-26,15,-6,0,3,3,-5,6,1,-1,2,1,-4,4,0,4,0,4,0,-20,-4,-6,-2,8,1,0,0,1,-1,0,-1,3,-1
KR_6742741359,420,-3,-52,-15,-5,-4,5,1,1,5,6,-3,6,3,-4,6,2,5,0,5,1,-7,-8,-3,-3,6,-4,0,-2,-1,-1,-1,-1,6,-1
KR_6732910093,420,-1,17,4,-8,3,0,3,-3,4,1,-3,3,0,-4,6,2,-1,3,2,0,-12,15,-2,-5,7,1,0,-1,-1,1,1,1,2,-1
KR_6755260758,440,2,7,8,0,1,2,3,2,2,4,-1,5,4,-5,10,5,3,1,4,1,8,163,5,-9,4,-2,0,1,-1,1,1,1,5,-1
KR_6764949003,420,0,-7,-28,0,0,1,1,2,1,3,0,3,3,-2,3,1,0,2,2,2,3,-7,0,-7,7,-3,0,-3,-1,-1,-1,-1,3,-1
KR_6631492348,440,-3,-5,0,-9,-2,3,1,-1,2,1,-6,8,2,0,3,3,0,2,2,-1,-5,2,-4,0,4,0,0,0,1,-1,-1,-1,3,-1
KR_6675291440,420,-1,-19,0,-1,-1,3,2,-3,3,0,1,2,3,1,3,4,1,0,1,0,-2,-50,-2,-8,10,19,0,0,-1,-1,0,1,4,-1
KR_6727746874,420,-7,-69,-28,-14,-6,6,0,-2,8,6,-2,3,1,-1,5,4,-3,4,1,0,-7,-4,1,-5,4,0,0,-1,1,-1,-1,-1,2,-1
KR_6761219636,440,-1,-38,-11,-2,-1,4,3,-4,5,1,0,3,3,2,6,8,1,0,1,0,-2,17,-5,-2,7,4,0,1,-1,-1,-1,1,2,-1
KR_6745232869,420,-2,-34,-5,-12,-5,5,0,-2,3,1,-2,3,1,-3,7,4,0,1,1,-1,-22,-8,5,-7,2,0,0,0,-1,1,0,-1,2,-1
KR_6760725705,420,-1,-16,-4,-5,3,0,3,-1,1,0,-1,2,1,-4,5,1,-2,2,0,0,1,4,2,-4,2,-2,0,0,-1,1,-1,-1,4,-1
KR_6716535616,420,-4,-34,-27,-8,-1,1,0,-2,9,7,-3,5,2,-1,1,0,-1,1,0,0,-9,4,7,-10,3,1,0,0,-1,-1,0,-1,6,-1
KR_6746963444,420,-2,-34,-22,-5,-2,2,0,-3,4,1,0,2,2,0,1,1,0,1,1,0,-5,-14,3,-8,5,-5,0,-1,0,-1,-1,-1,0,-1
KR_6763205738,420,-2,-31,-9,-4,0,2,2,-1,2,1,0,2,2,-1,2,1,-2,3,1,0,-1,-11,2,-9,7,-2,0,1,-1,1,1,-1,4,-1
KR_6760202434,420,-3,-128,-39,-8,-1,2,1,-5,6,1,1,2,3,-4,6,2,1,1,2,0,-3,21,2,-6,4,2,0,-3,-1,1,-1,1,5,-1
KR_6717349721,420,-7,-58,-13,-14,-3,5,2,-1,2,1,-6,7,1,-3,3,0,-1,2,1,0,-10,-2,-4,-2,6,-1,0,-2,-1,-1,-1,-1,6,-1
KR_6751815600,420,2,26,-7,7,3,0,3,4,0,4,1,1,2,-2,4,2,1,0,1,0,4,2,5,-6,1,-3,0,2,1,1,1,1,1,-1
KR_6715967450,420,-2,-5,22,-4,-1,1,0,-1,5,4,-2,4,2,0,4,4,0,1,1,0,-13,5,1,-8,7,-1,0,1,1,1,1,1,6,-1
KR_6673885276,420,-1,-49,40,-11,-3,4,1,-2,3,1,0,0,0,-4,5,1,-2,2,0,0,-13,2,0,-6,6,-2,0,0,-1,1,0,-1,1,-1
KR_6703741714,420,-3,-55,10,-10,-2,4,2,0,2,2,-9,9,0,-1,3,2,2,0,2,0,-11,-2,3,-4,1,4,0,1,-1,-1,1,-1,4,-1
KR_6765692989,420,-3,4,-16,-3,-2,2,0,-2,4,2,0,2,2,1,1,2,0,1,1,0,-6,-71,3,-6,3,-4,0,-2,-1,-1,-1,1,6,-1
KR_6765238734,420,2,16,-10,0,1,1,2,0,2,2,0,2,2,-3,5,2,2,2,4,0,-3,34,-4,-4,8,4,0,0,0,-1,0,1,0,-1
KR_6764488653,440,-3,-39,13,-9,-2,3,1,-9,9,0,-3,5,2,0,3,3,5,0,5,0,-8,5,2,-5,3,-5,0,-1,0,0,-1,1,0,-1
KR_6760438975,420,-4,-55,-15,-3,-2,2,0,0,3,3,-2,3,1,0,4,4,1,0,1,0,-5,5,3,-6,3,3,0,0,-1,-1,-1,1,6,-1
KR_6745321307,420,-3,-9,20,-6,-2,4,2,2,2,4,-1,3,2,-5,7,2,0,0,0,1,-6,-4,1,-6,5,-1,0,-1,1,1,-1,1,3,-1
KR_6762633991,420,-3,-5,-18,-5,2,3,5,-3,7,4,-2,4,2,-3,7,4,1,0,1,0,-13,-17,-3,-5,8,2,0,1,1,1,1,1,4,-1
KR_6733781817,420,-4,-31,4,-5,0,2,2,-1,3,2,-4,6,2,0,2,2,0,0,0,0,-5,-7,-6,-4,10,-1,0,0,-1,-1,0,-1,1,-1
KR_6666545924,420,1,35,-40,8,1,1,2,3,1,4,4,1,5,-3,3,0,3,0,3,1,9,-3,-1,-6,7,1,0,0,-1,-1,0,1,2,-1
KR_6724827634,420,4,45,-25,1,1,1,2,-4,5,1,1,4,5,1,2,3,2,1,3,0,1,6,6,-8,2,0,0,0,-1,1,0,-1,1,-1
KR_6707658280,420,-6,-27,-28,-9,0,2,2,-2,2,0,-4,6,2,0,2,2,-3,3,0,0,-12,-7,-1,-7,8,-1,0,-2,1,-1,-1,-1,3,-1
KR_6762366534,420,-5,-21,-28,-9,-3,5,2,-4,6,2,0,1,1,-1,2,1,-1,1,0,0,-9,4,6,-10,4,-3,0,0,-1,1,-1,1,5,-1
KR_6598706742,420,-3,-50,-29,-2,-2,4,2,-2,3,1,1,3,4,2,0,2,-1,1,0,0,7,14,0,-6,6,-1,0,0,-1,-1,0,-1,4,-1
KR_6737101854,440,1,12,1,-3,0,0,0,2,2,4,-2,2,0,-2,6,4,-1,3,2,-1,-9,-2,-7,-3,10,7,0,-1,-1,-1,-1,-1,6,-1
KR_6750020902,420,-4,-52,13,-17,-5,5,0,-2,3,1,-1,3,2,-4,5,1,-5,5,0,-2,-19,-4,-5,-3,8,-2,0,-1,1,-1,-1,-1,1,-1
KR_6627633712,420,-2,-93,16,-6,0,0,0,-3,4,1,1,3,4,-4,6,2,0,1,1,0,-10,123,-1,-4,5,-5,0,0,-1,1,1,-1,2,-1
KR_6714487506,420,-7,-74,-8,-13,-5,5,0,-2,3,1,1,1,2,-6,6,0,-1,1,0,0,-12,0,1,-9,8,-4,0,-2,-1,-1,-1,1,6,-1
KR_6749257014,420,0,-76,-5,-4,-1,4,3,2,6,8,-5,5,0,-2,4,2,2,0,2,-1,1,4,4,-7,3,-3,0,-2,-1,-1,-1,-1,2,-1
KR_6642944143,420,-1,-11,-6,-1,3,0,3,2,2,4,-5,5,0,-3,3,0,2,0,2,0,-2,-4,-6,-2,8,0,0,-1,-1,1,1,-1,5,-1
KR_6766806572,420,-1,-20,11,-6,-1,1,0,3,1,4,-2,3,1,-1,4,3,-5,5,0,0,-1,4,0,-3,3,-3,0,-1,1,1,-1,-1,5,-1
KR_6701321165,420,0,-28,-44,1,-1,2,1,-1,2,1,-2,5,3,3,1,4,2,0,2,0,4,8,2,-6,4,-7,0,-1,1,-1,-1,1,1,-1
KR_6733564635,420,0,-8,3,-7,1,0,1,-2,3,1,-1,1,0,-4,4,0,-1,1,0,0,-16,-17,-9,-3,12,-2,0,0,-1,1,0,1,3,-1
KR_6692576846,420,-1,-52,-9,-4,-1,2,1,-1,3,2,-3,4,1,-2,3,1,3,0,3,-1,-8,-5,1,-4,3,-1,0,-1,-1,-1,-1,-1,4,-1
KR_6762444771,420,0,-23,-23,1,-2,2,0,3,1,4,-1,2,1,1,0,1,0,0,0,0,3,225,2,-6,4,-2,0,0,1,1,0,-1,2,-1
KR_6751491195,420,0,12,24,0,1,0,1,1,2,3,2,0,2,-4,6,2,0,0,0,0,6,0,4,-10,6,-3,0,-1,1,-1,-1,1,6,-1
KR_6749995604,420,-2,-44,4,-5,-3,3,0,-2,3,1,-1,5,4,1,0,1,0,0,0,0,-4,-42,-2,-5,7,25,0,-1,-1,-1,-1,-1,3,-1
KR_6723403397,420,-1,-59,-1,-4,-4,4,0,-2,5,3,1,3,4,2,3,5,-1,1,0,0,-5,-199,-4,-4,8,1,0,-2,-1,-1,-1,1,2,-1
KR_6743389653,420,-3,-47,17,-12,-3,3,0,2,1,3,-7,8,1,-2,3,1,-2,2,0,-2,-18,-8,-3,-1,4,0,0,0,-1,1,0,-1,5,-1
KR_6751064539,420,0,9,2,2,1,3,4,1,1,2,-2,3,1,2,2,4,0,1,1,0,0,-29,1,-5,4,6,0,0,1,-1,-1,-1,3,-1
KR_6768776831,420,-3,-21,-23,-10,-1,2,1,-10,10,0,-1,2,1,5,0,5,-3,4,1,-2,-10,4,0,-7,7,-1,0,0,1,1,-1,-1,4,-1
KR_6730273891,420,-1,-24,20,-3,0,2,2,-3,4,1,-3,5,2,2,2,4,1,0,1,0,2,28,4,-6,2,-4,0,0,1,1,0,-1,5,-1
KR_6768929483,420,0,-26,7,-6,0,0,0,-1,3,2,-3,5,2,1,4,5,-3,4,1,0,-12,-1,-1,-6,7,-1,0,2,-1,1,1,-1,2,-1
KR_6648234690,420,-3,-18,20,-9,-5,5,0,2,1,3,-2,3,1,-5,8,3,1,0,1,0,-6,-9,-2,-6,8,-1,0,0,1,-1,-1,-1,5,-1
KR_6765924735,420,-1,-72,-20,-12,-3,3,0,1,0,1,-1,2,1,-10,11,1,1,0,1,-2,-20,23,1,-5,4,-4,0,-1,0,-1,-1,-1,0,-1
KR_6738079657,440,-3,-110,-10,-12,-3,5,2,-1,2,1,-11,11,0,2,2,4,1,0,1,-2,-7,18,-4,-1,5,-5,0,-3,-1,-1,-1,-1,2,-1
KR_6713596774,420,-7,-95,-15,-20,-3,4,1,-7,7,0,-1,4,3,-10,11,1,1,0,1,0,-12,-3,-2,-4,6,-5,0,-3,-1,-1,-1,-1,5,-1
KR_6669032352,420,-3,-80,10,-3,-1,4,3,-1,2,1,-1,4,3,-3,5,2,3,0,3,-1,-1,5,-3,-6,9,-1,0,-1,1,-1,-1,-1,1,-1
KR_6756603311,420,-2,-24,20,-4,-3,4,1,1,0,1,-2,2,0,-1,4,3,1,0,1,0,-2,1,2,-7,5,-5,0,-1,1,-1,-1,-1,3,-1
KR_6760057503,420,-3,-20,7,-6,-3,4,1,2,5,7,-2,2,0,-2,2,0,-1,1,0,0,-2,-235,1,-8,7,-5,0,-1,-1,-1,-1,-1,4,-1
KR_6750276573,420,-2,-32,8,2,2,1,3,5,2,7,-5,5,0,1,1,2,-1,2,1,0,-1,31,5,-8,3,-3,0,-1,-1,-1,-1,1,1,-1
KR_6768299869,420,-3,-45,-5,-2,-1,2,1,2,3,5,-4,5,1,1,3,4,0,2,2,0,-2,-4,-5,-5,10,-4,0,-1,1,-1,-1,-1,1,-1
KR_6712393403,420,-4,-11,-20,-8,1,2,3,-2,4,2,-2,5,3,-4,6,2,-1,1,0,0,-23,-2,2,-6,4,-2,0,0,-1,1,-1,-1,2,-1
KR_6768173201,420,-2,-51,-2,-9,2,1,3,-8,9,1,-4,4,0,1,1,2,0,0,0,0,-14,6,5,-9,4,-7,0,1,-1,1,1,1,4,-1
KR_6746709816,420,-1,7,2,-13,0,2,2,-2,6,4,-1,3,2,-8,8,0,-2,4,2,-4,-11,-17,-5,-4,9,-1,0,0,0,0,0,-1,0,-1
KR_6694052157,420,-5,-4,-34,-10,-2,2,0,-2,5,3,-6,6,0,-1,2,1,1,0,1,0,-13,8,3,-8,5,-5,0,-1,1,-1,-1,-1,4,-1
KR_6711951408,420,2,14,4,5,-3,3,0,3,2,5,2,1,3,0,0,0,3,1,4,0,8,3,5,-10,5,2,0,1,1,-1,1,1,5,-1
KR_6738723215,420,-5,-82,-50,-4,-2,3,1,-3,4,1,-3,4,1,0,3,3,4,0,4,0,-1,0,0,-3,3,0,0,-2,-1,-1,-1,1,5,-1
KR_6741586625,420,-1,-10,-6,-2,0,2,2,3,2,5,-3,3,0,-1,2,1,-1,2,1,0,0,9,0,-5,5,-4,0,0,-1,-1,1,-1,4,-1
KR_6644789156,420,-2,48,-19,-10,5,1,6,-3,6,3,-5,5,0,-4,9,5,-3,4,1,-2,-23,-10,-1,-2,3,-3,0,-1,1,-1,-1,-1,5,-1
KR_6768515141,420,-1,-12,-21,2,-2,5,3,1,3,4,-1,3,2,1,3,4,3,0,3,0,3,42,1,-7,6,-3,0,0,1,-1,-1,-1,3,-1
KR_6651903508,420,1,-6,10,-4,-1,1,0,-5,6,1,0,2,2,0,2,2,2,0,2,-1,-11,0,-1,-5,6,6,0,0,0,-1,0,-1,0,-1
KR_6770728935,420,-2,-36,-2,-4,-2,5,3,3,2,5,-2,5,3,-3,3,0,0,1,1,-1,-2,5,-1,-5,6,-5,0,-2,-1,-1,-1,-1,6,-1
KR_6767687410,420,0,-1,-2,0,0,2,2,0,6,6,1,2,3,-2,3,1,1,1,2,0,4,-7,-1,-5,6,-6,0,0,-1,-1,-1,1,3,-1
KR_6743375547,420,4,44,48,-2,0,0,0,-2,4,2,0,2,2,0,7,7,0,2,2,0,-16,-3,-3,-3,6,3,0,0,1,1,-1,1,6,-1
KR_6763595954,420,-5,-53,9,-24,-3,4,1,-6,7,1,-1,2,1,-10,12,2,-4,4,0,-1,-27,6,2,-5,3,-3,0,-3,0,-1,-1,-1,0,-1
KR_6725594309,420,-2,-12,4,-1,1,2,3,-4,4,0,1,2,3,1,3,4,0,1,1,2,0,-6,-1,-3,4,-7,0,-1,-1,-1,-1,1,4,-1
KR_6689782821,440,1,12,20,1,5,0,5,1,1,2,2,2,4,-6,8,2,-1,1,0,1,-2,-6,1,-6,5,8,0,1,1,1,1,1,3,-1
KR_6725861586,420,-1,19,-4,-3,-1,6,5,1,2,3,-1,3,2,-2,2,0,0,1,1,0,-6,8,4,-10,6,-7,0,-3,-1,-1,-1,-1,6,-1
KR_6767995293,420,-1,4,-10,-8,-2,2,0,-3,3,0,-2,6,4,0,3,3,-1,1,0,0,-11,-3,4,-11,7,1,0,-1,-1,-1,-1,-1,5,-1
KR_6743510135,420,-2,-76,0,-5,-2,4,2,4,1,5,-2,3,1,-2,2,0,-3,3,0,0,-3,-14,0,-5,5,-2,0,0,-1,1,-1,1,1,-1
KR_6768868971,420,1,-40,-5,2,-3,4,1,-1,3,2,-1,3,2,2,1,3,5,2,7,0,6,34,0,-3,3,-22,0,0,-1,-1,-1,-1,1,-1
KR_6761868492,440,3,-4,12,3,2,2,4,-1,2,1,1,2,3,2,2,4,-1,1,0,-1,0,-1,-1,-6,7,7,0,0,1,-1,-1,-1,1,-1
KR_6754281715,420,-2,-42,-14,-5,-1,2,1,-4,6,2,-4,4,0,5,2,7,-1,1,0,0,-4,0,2,-5,3,4,0,-2,1,0,-1,-1,1,-1
KR_6745071876,420,-2,-11,-31,-8,-2,3,1,-5,5,0,1,2,3,-2,4,2,0,2,2,0,-5,-8,-1,-5,6,0,0,0,1,-1,-1,-1,6,-1
KR_6691860291,420,-1,12,-43,-6,3,0,3,-3,4,1,-3,4,1,-1,4,3,-2,3,1,0,-1,-3,-1,-4,5,-6,0,-1,-1,-1,-1,-1,3,-1
KR_6748980188,420,1,-26,40,5,4,0,4,-1,2,1,3,2,5,0,2,2,-1,3,2,0,1,-8,5,-12,7,-5,0,0,-1,-1,0,1,2,-1
KR_6680100269,420,-4,-79,-55,-14,-4,5,1,-4,5,1,-9,9,0,1,2,3,2,1,3,0,-8,34,-4,-4,8,-23,0,-2,1,-1,-1,-1,5,-1
KR_6740676913,420,4,-2,-20,6,0,2,2,3,2,5,0,2,2,2,1,3,1,0,1,1,14,37,-1,-4,5,1,0,0,1,-1,0,1,4,-1
KR_6641043620,420,-3,-106,-18,0,-8,9,1,2,2,4,3,4,7,2,3,5,1,0,1,0,7,-12,0,-2,2,2,0,-2,1,1,-1,-1,3,-1
KR_6757673080,420,2,11,-11,3,-3,3,0,6,1,7,4,1,5,-3,5,2,-1,1,0,0,10,7,-5,-2,7,4,0,0,-1,0,-1,1,1,-1
KR_6754221160,420,0,3,8,-6,-3,4,1,2,1,3,1,2,3,-4,5,1,-2,2,0,0,-1,-15,-2,-1,3,3,0,-1,0,-1,-1,-1,0,-1
KR_6758293864,420,-2,-39,7,-8,-2,4,2,-5,7,2,4,0,4,-5,5,0,0,0,0,-1,-13,3,1,-8,7,1,0,0,-1,1,-1,-1,1,-1
KR_6769843001,420,-5,-63,-15,-14,0,2,2,2,0,2,-3,3,0,-10,14,4,-3,3,0,0,-14,9,3,-5,2,-2,0,-1,1,1,-1,-1,5,-1
KR_6639152520,420,-5,-75,33,-13,-1,1,0,1,3,4,-3,3,0,-11,15,4,1,2,3,0,-9,6,7,-11,4,-1,0,-1,-1,-1,-1,1,2,-1
KR_6753539136,420,1,-19,-13,-5,-1,4,3,-3,6,3,-1,3,2,1,1,2,-1,2,1,0,1,-27,-3,-2,5,3,0,0,-1,-1,-1,-1,1,-1
KR_6659201154,420,-3,-37,-39,-14,-1,2,1,-6,9,3,-2,3,1,-2,7,5,-3,3,0,0,-15,-13,-1,-6,7,-3,0,-3,-1,-1,-1,-1,2,-1
KR_6757971970,440,-3,-56,-16,-4,-1,3,2,1,2,3,-3,3,0,-3,5,2,2,0,2,0,-5,4,7,-7,0,-4,0,-1,1,-1,-1,-1,1,-1
KR_6767538665,420,-3,-63,-4,-9,-3,8,5,-2,4,2,-1,2,1,-1,2,1,-2,2,0,0,-6,19,3,-9,6,-8,0,-1,-1,1,-1,-1,5,-1
KR_6766138131,420,-2,-28,8,-4,1,1,2,-2,7,5,2,1,3,-5,5,0,0,0,0,-1,-5,6,4,-8,4,-2,0,0,-1,-1,0,-1,5,-1
KR_6754016540,420,-2,23,-4,-5,1,0,1,-2,5,3,-2,3,1,0,5,5,-2,2,0,0,-8,10,1,-5,4,-9,0,-1,-1,1,-1,-1,3,-1
KR_6760009095,420,1,45,-39,-11,-1,4,3,-3,4,1,-2,5,3,-3,3,0,-2,2,0,0,-18,3,-4,-5,9,-4,0,0,-1,-1,0,-1,3,-1
KR_6764681021,420,-1,-8,-12,-2,-3,4,1,-1,3,2,2,1,3,-1,2,1,1,0,1,0,-3,-7,-3,-5,8,8,0,0,-1,0,0,-1,2,-1
KR_6764911032,420,-5,-37,-19,-16,0,4,4,-6,10,4,-8,8,0,-1,1,0,-1,2,1,0,-11,-106,-2,-4,6,-9,0,-2,-1,1,-1,-1,2,-1
KR_6755756238,420,2,-2,9,8,4,0,4,-1,5,4,1,0,1,2,4,6,2,1,3,2,14,1,1,-8,7,1,0,1,1,1,1,1,4,-1
KR_6770776697,420,-1,12,0,-1,-3,3,0,1,3,4,2,1,3,-5,6,1,4,0,4,0,-7,-2,1,-7,6,-4,0,0,-1,1,-1,1,6,-1
KR_6699115716,420,3,50,37,5,2,0,2,2,2,4,-1,3,2,3,0,3,-1,2,1,0,2,-111,3,-6,3,-2,0,0,1,1,0,1,3,-1
KR_6718497675,420,2,-3,-16,8,3,0,3,6,1,7,-3,5,2,0,1,1,2,0,2,0,9,29,-3,-5,8,-6,0,-1,0,-1,-1,-1,0,-1
KR_6765318654,420,1,22,-4,-8,2,1,3,0,6,6,-2,2,0,-4,6,2,-4,4,0,1,-13,-124,-3,-2,5,-1,0,0,1,-1,-1,1,6,-1
KR_6770448700,420,0,-15,3,-1,-2,2,0,-2,4,2,0,1,1,1,2,3,2,0,2,1,5,0,0,-3,3,-3,0,0,1,-1,-1,1,5,-1
KR_6708940782,420,1,-29,-15,9,0,4,4,2,4,6,-2,4,2,5,0,5,4,1,5,0,14,-8,-4,-2,6,1,0,1,1,-1,1,-1,6,-1
KR_6758111227,420,-2,-59,22,-1,-5,6,1,-1,4,3,0,1,1,5,2,7,0,2,2,0,4,2,0,-5,5,3,0,0,1,1,1,1,2,-1
KR_6763621213,440,-3,7,-8,-9,-6,6,0,-1,2,1,-2,3,1,2,2,4,-2,3,1,1,-4,-218,-2,-3,5,-6,0,0,-1,-1,0,1,4,-1
KR_6767197334,440,-1,-15,36,-5,3,0,3,2,1,3,-4,5,1,-5,5,0,-1,1,0,0,-4,19,0,-2,2,-2,0,-1,1,-1,-1,1,6,-1
KR_6716414451,420,-4,-60,-15,-13,0,3,3,2,2,4,-9,10,1,-6,7,1,0,0,0,0,-9,-1,2,-5,3,-9,0,-2,-1,-1,-1,-1,2,-1
KR_6737337126,420,-4,11,4,-9,-1,2,1,1,2,3,-6,7,1,0,2,2,-3,4,1,-2,-25,-5,-7,-1,8,4,0,0,1,-1,0,-1,4,-1
KR_6767486925,420,-1,-9,-25,0,-1,1,0,1,3,4,3,1,4,-3,3,0,0,0,0,0,-1,0,-1,-4,5,1,0,-1,-1,1,-1,1,4,-1
KR_6693054323,420,-6,-73,-32,-12,-3,3,0,-3,8,5,-1,3,2,-5,8,3,0,0,0,0,-19,8,-4,-4,8,-5,0,-3,1,-1,-1,1,5,-1
KR_6744191296,420,1,23,8,-4,-1,4,3,-7,7,0,1,2,3,1,0,1,2,0,2,0,-5,9,5,-7,2,-1,0,1,1,1,1,1,3,-1
KR_6754351727,420,1,-8,6,2,2,0,2,-1,4,3,0,2,2,-1,2,1,2,0,2,0,-1,6,-3,-4,7,4,0,0,1,-1,-1,-1,6,-1
KR_6672234045,420,-2,-74,4,-18,-3,3,0,-3,4,1,-3,4,1,-9,9,0,0,1,1,-1,-23,1,-1,-1,2,-1,0,-2,-1,-1,-1,-1,2,-1
KR_6769826407,440,0,54,-23,-8,-2,2,0,-2,7,5,-1,2,1,-3,3,0,0,0,0,0,-17,-5,-3,-4,7,4,0,0,-1,-1,0,-1,3,-1
KR_6746461949,420,-2,-1,-9,-2,0,0,0,1,1,2,2,2,4,-5,6,1,0,1,1,0,-2,9,2,-5,3,0,0,-1,-1,0,1,-1,1,-1
KR_6760384835,420,0,-31,0,2,1,1,2,6,1,7,-1,1,0,-4,4,0,0,0,0,0,4,-121,1,-7,6,1,0,-1,-1,1,-1,-1,2,-1
KR_6566797658,420,-4,-73,7,-13,-1,2,1,-4,5,1,2,2,4,0,2,2,-10,11,1,0,-13,-9,1,-7,6,-4,0,-1,-1,-1,-1,-1,3,-1
KR_6767409479,440,-1,-81,-7,2,-1,4,3,2,2,4,0,2,2,1,1,2,0,0,0,0,8,-32,3,-5,2,21,0,-2,1,-1,-1,1,6,-1
KR_6749180999,420,1,96,38,1,-3,3,0,-2,5,3,5,2,7,-1,2,1,2,1,3,0,-6,-61,0,-2,2,0,0,1,-1,1,1,-1,4,-1
KR_6743320674,420,4,23,16,5,0,3,3,-1,2,1,3,1,4,4,2,6,-1,1,0,-2,4,-18,-1,-5,6,3,0,1,1,-1,1,-1,2,-1
KR_6710668345,420,-4,-72,-63,5,2,1,3,-1,1,0,1,0,1,-1,3,2,4,0,4,0,9,-1,-2,0,2,0,-1,-4,-1,-1,-1,1,5,-1
KR_6683003668,420,0,-50,7,-2,1,1,2,-1,4,3,-1,4,3,-2,4,2,1,1,2,0,-5,15,-2,-6,8,-3,0,-1,-1,-1,-1,-1,1,-1
KR_6769978626,420,0,-25,24,-9,0,4,4,0,2,2,3,0,3,-10,11,1,-2,2,0,-1,-9,10,4,-7,3,-6,0,0,-1,1,0,-1,5,-1
KR_6767009194,420,-2,-42,-31,-6,-1,2,1,2,2,4,-3,6,3,-5,7,2,1,1,2,0,-11,88,2,-9,7,-4,0,-1,1,-1,-1,1,6,-1
KR_6753858209,420,-3,-39,-15,-4,0,2,2,-3,5,2,-2,3,1,1,2,3,0,1,1,0,-5,12,5,-8,3,-1,0,1,-1,1,1,1,5,-1
KR_6766205227,420,-1,15,-30,-2,-3,3,0,2,2,4,-1,3,2,-4,7,3,4,1,5,0,-4,-332,0,-5,5,-6,0,-1,-1,-1,-1,1,3,-1
KR_6763582317,420,-2,-41,-12,-3,1,3,4,-1,3,2,-3,3,0,1,4,5,-1,1,0,0,-5,4,5,-6,1,1,0,-2,1,-1,-1,-1,6,-1
KR_6748996330,440,-2,-31,-15,-6,2,1,3,-4,6,2,-1,2,1,-4,5,1,1,0,1,0,0,1,4,-12,8,-6,0,-1,-1,-1,-1,-1,5,-1
KR_6713710661,420,-4,-25,-8,-4,-4,5,1,3,2,5,2,1,3,-4,5,1,-1,2,1,0,1,245,-2,-2,4,0,0,0,-1,1,-1,1,5,-1
KR_6763749288,420,1,25,-16,1,0,3,3,1,6,7,1,1,2,-1,3,2,0,1,1,0,7,-41,7,-13,6,27,0,-1,1,-1,-1,-1,5,-1
KR_6768283477,420,-2,5,-12,-5,0,1,1,-3,3,0,1,2,3,-3,4,1,0,0,0,0,-6,-31,-2,-3,5,4,0,-1,1,-1,-1,-1,6,-1
KR_6739119507,440,2,40,6,2,-2,3,1,-3,3,0,6,4,10,-4,5,1,5,0,5,0,-3,8,1,-4,3,0,0,0,-1,-1,0,1,3,-1
KR_6739107330,420,-1,30,-13,-7,5,0,5,-2,3,1,-2,4,2,-9,10,1,1,0,1,-2,-21,0,-1,-6,7,3,0,1,-1,1,1,-1,4,-1
KR_6669056369,420,-1,-33,12,-1,1,0,1,-2,5,3,1,2,3,2,1,3,-3,3,0,0,3,10,4,-8,4,-5,0,0,1,-1,0,1,5,-1
KR_6765626628,420,-3,-15,-16,-3,-2,2,0,3,3,6,-5,5,0,2,0,2,-1,2,1,0,2,-77,1,-5,4,2,0,0,1,-1,0,-1,4,-1
KR_6724828596,440,0,3,13,-4,4,1,5,-5,11,6,2,0,2,-3,5,2,-2,3,1,-1,-21,-1,-1,-4,5,-6,0,-1,-1,1,1,-1,1,-1
KR_6716511002,420,-2,13,-7,-7,2,1,3,-1,3,2,-7,8,1,-1,5,4,0,1,1,-2,-6,-7,1,-5,4,2,0,-1,-1,1,-1,-1,2,-1
KR_6746580795,420,0,-28,30,-4,-2,2,0,-4,4,0,4,2,6,-2,4,2,0,0,0,0,-10,5,-1,-5,6,1,0,1,1,1,1,-1,5,-1
KR_6759830890,420,-1,-7,-15,-1,2,0,2,1,4,5,-2,2,0,-1,2,1,-1,1,0,0,-4,13,-3,-5,8,-2,0,1,-1,1,1,-1,4,-1
KR_6757903427,440,-1,1,-23,2,-2,3,1,1,2,3,0,3,3,5,3,8,-2,3,1,0,12,1,-3,-5,8,-5,0,-2,-1,-1,-1,1,3,-1
KR_6740606552,420,-5,-11,-33,-10,0,0,0,-5,5,0,0,1,1,-5,5,0,0,1,1,0,-16,-9,0,-8,8,4,0,0,-1,0,-1,-1,4,-1
KR_6750916200,420,-4,-17,-36,-5,-1,2,1,-1,4,3,1,1,2,0,3,3,-4,4,0,0,-5,1,2,-7,5,-2,0,-1,-1,1,1,1,4,-1
KR_6718551617,420,-1,-76,0,-7,-1,2,1,1,4,5,-8,9,1,2,1,3,-1,3,2,-2,-6,-2,-3,-4,7,-2,0,-1,1,-1,-1,-1,5,-1
KR_6667071004,420,0,-4,12,-5,0,1,1,3,0,3,0,1,1,-8,9,1,0,0,0,0,-8,-8,-3,-4,7,1,0,-3,-1,-1,-1,-1,2,-1
KR_6766227767,420,1,39,15,5,-1,2,1,2,2,4,1,2,3,5,1,6,-2,2,0,0,2,0,1,-4,3,6,0,1,1,1,-1,1,5,-1
KR_6715579377,420,4,73,20,4,6,0,6,0,2,2,2,0,2,-2,5,3,-2,4,2,0,8,-90,4,-7,3,-4,0,0,-1,-1,1,1,4,-1
KR_6695343633,420,-1,-30,9,-8,4,1,5,-3,4,1,1,3,4,-10,11,1,0,1,1,0,-16,5,5,-11,6,-8,0,-2,-1,-1,-1,1,6,-1
KR_6751425966,420,-1,-8,-27,-10,1,1,2,-5,7,2,0,3,3,-2,3,1,-4,4,0,0,-14,-2,-4,-1,5,0,0,0,-1,1,0,-1,1,-1
KR_6763086043,420,1,5,-6,5,1,5,6,-3,3,0,4,2,6,3,1,4,0,2,2,1,0,-1,3,-7,4,4,0,1,1,0,1,-1,2,-1
KR_6721986843,420,-5,-69,-16,-12,-2,3,1,-7,9,2,2,0,2,-3,3,0,-2,3,1,0,-4,-8,-3,-4,7,0,0,-3,1,-1,-1,1,5,-1
KR_6758198623,420,1,-15,-13,-3,2,0,2,-3,3,0,-2,2,0,0,1,1,0,1,1,-3,-5,-9,-4,-5,9,7,0,0,-1,-1,0,-1,2,-1
KR_6764823194,440,2,-33,-36,-1,-1,2,1,0,2,2,1,1,2,-2,3,1,1,2,3,0,0,1,4,-9,5,-5,0,-2,-1,-1,-1,-1,6,-1
KR_6749017131,420,2,12,8,-3,-3,5,2,2,3,5,1,1,2,-3,5,2,0,2,2,0,-1,-6,1,-7,6,-2,0,-1,-1,0,1,-1,4,-1
KR_6760698988,420,-4,38,-24,0,0,2,2,1,2,3,-6,6,0,4,1,5,1,1,2,0,3,-45,-2,-3,5,28,0,0,1,-1,1,1,1,-1
KR_6710576334,420,-1,-57,-24,-4,-1,3,2,3,3,6,0,2,2,-4,5,1,-2,2,0,0,-4,-5,-8,-4,12,3,0,0,-1,-1,0,-1,3,-1
KR_6644760708,420,1,82,10,-1,1,1,2,-2,5,3,1,1,2,-1,3,2,0,0,0,-1,-9,10,0,-8,8,2,0,0,-1,0,0,-1,1,-1
KR_6678784078,420,1,-9,-4,-2,-1,4,3,-1,2,1,-1,1,0,1,1,2,0,0,0,0,-11,-13,-2,-4,6,4,0,-1,1,1,-1,1,5,-1
KR_6749639120,420,-2,-65,-20,-6,5,0,5,-4,5,1,-7,8,1,-1,4,3,1,0,1,-1,-17,4,3,-3,0,-2,0,0,-1,1,1,-1,6,-1
KR_6695286327,420,-4,-25,7,-8,-3,5,2,-2,3,1,2,2,4,-6,7,1,1,0,1,-2,-14,-4,-1,-6,7,1,0,-2,-1,-1,-1,-1,5,-1
KR_6691996528,420,-2,-105,-13,4,-1,1,0,-2,3,1,-1,1,0,0,3,3,8,2,10,-1,5,21,2,-10,8,-5,0,-1,-1,-1,-1,-1,6,-1
KR_6625552729,420,-4,-6,-12,-7,2,1,3,-4,6,2,-3,4,1,-1,1,0,-1,1,0,0,-10,10,1,-5,4,0,0,-2,-1,-1,-1,-1,6,-1
KR_6758639694,420,-2,7,15,4,-2,5,3,2,2,4,0,3,3,3,1,4,1,0,1,3,8,0,-2,-3,5,2,0,1,1,0,1,1,1,-1
KR_6768528719,420,-4,-48,-4,-12,1,0,1,-2,5,3,0,2,2,-10,12,2,-1,1,0,0,-16,2,-8,-6,14,-4,0,0,1,-1,0,-1,4,-1
KR_6768917788,420,-2,-62,-27,-3,0,1,1,-1,2,1,4,0,4,-4,5,1,-2,2,0,0,-8,-17,-3,-3,6,-3,0,0,-1,-1,-1,-1,5,-1
KR_6767503958,420,-6,-64,-8,-15,-10,10,0,-2,2,0,0,3,3,-1,3,2,-2,2,0,-1,-5,-2,0,-4,4,-1,0,-3,-1,-1,-1,-1,2,-1
KR_6752320569,420,-2,38,1,-3,0,0,0,-1,4,3,-2,6,4,-1,4,3,1,0,1,0,-3,-3,0,-3,3,-3,0,-1,-1,-1,-1,-1,6,-1
KR_6766747662,420,0,1,-52,3,3,1,4,0,3,3,0,2,2,-4,6,2,4,0,4,0,5,-3,3,-8,5,6,0,0,0,1,1,-1,0,-1
KR_6761996802,420,-2,-67,-28,0,1,1,2,2,2,4,-3,5,2,-1,2,1,1,2,3,0,-1,12,6,-9,3,-2,0,-1,-1,1,-1,1,1,-1
KR_6751052145,440,0,14,7,-8,2,1,3,-2,3,1,1,0,1,-7,7,0,-2,2,0,0,-15,-15,5,-10,5,-5,0,-1,1,1,-1,-1,3,-1
KR_6742565836,420,1,20,32,6,5,2,7,-1,3,2,6,1,7,-4,8,4,0,0,0,0,-1,0,1,-2,1,2,0,0,1,1,1,-1,5,-1
KR_6760847183,420,-5,-59,-26,-18,-5,6,1,1,0,1,-4,5,1,-5,5,0,-5,5,0,0,-15,10,1,-3,2,-6,0,-1,-1,1,-1,-1,2,-1
KR_6702657768,420,-2,-17,-20,-5,-1,1,0,0,1,1,-2,2,0,0,3,3,-2,3,1,0,-6,0,0,-9,9,2,0,0,-1,-1,-1,-1,2,-1
KR_6764986407,420,0,-13,-25,5,-1,1,0,-1,1,0,3,1,4,5,0,5,-1,1,0,0,6,2,-1,-6,7,2,0,1,-1,-1,1,1,3,-1
KR_6747447734,420,-4,-74,-29,-11,-2,3,1,-1,3,2,-4,6,2,-2,2,0,-2,4,2,0,-7,-5,-4,-3,7,2,0,-1,-1,-1,-1,1,1,-1
KR_6754432485,440,1,12,-9,5,-1,2,1,6,1,7,-1,2,1,4,1,5,-3,4,1,0,-1,-2,3,-6,3,-4,0,-1,1,-1,-1,1,1,-1
KR_6770374503,420,-2,-71,36,-13,-8,8,0,-2,4,2,1,1,2,-2,4,2,-2,2,0,0,-13,3,-3,-1,4,2,0,-1,-1,1,-1,-1,5,-1
KR_6750429359,440,-2,-17,20,-4,0,1,1,-2,3,1,-1,1,0,-1,1,0,0,0,0,0,-2,-1,1,-8,7,-6,0,0,1,-1,-1,1,3,-1
KR_6650730319,420,-1,-34,10,6,6,0,6,1,2,3,0,5,5,0,2,2,-1,2,1,0,3,-42,7,-8,1,22,0,0,1,1,0,1,4,-1
KR_6710330038,420,-3,-39,-24,-6,-1,1,0,-3,5,2,2,1,3,-2,4,2,-2,3,1,1,-5,-93,2,-9,7,-3,0,0,1,-1,0,1,1,-1
KR_6767304946,420,1,-20,32,-3,-3,4,1,0,3,3,2,2,4,-3,7,4,1,0,1,0,2,-1,-1,-3,4,0,0,0,1,0,0,-1,1,-1
KR_6739411190,420,-1,23,-12,4,5,0,5,4,4,8,-3,4,1,1,3,4,-3,4,1,2,1,12,9,-11,2,-5,0,0,1,-1,1,1,2,-1
KR_6756998468,420,1,19,15,2,-1,1,0,3,1,4,-1,5,4,0,3,3,1,1,2,0,4,17,6,-8,2,-10,0,0,1,-1,0,-1,6,-1
KR_6718346662,420,-2,-17,24,-9,-1,2,1,-6,7,1,0,1,1,0,3,3,-2,5,3,-1,-14,3,-4,-5,9,-7,0,-1,0,-1,-1,-1,0,-1
KR_6742702384,420,-1,-11,-16,2,0,0,0,-1,3,2,1,0,1,2,1,3,0,1,1,0,4,4,2,-8,6,-2,0,0,-1,1,0,1,6,-1
KR_6736963655,440,3,57,-3,2,1,4,5,-2,6,4,-1,1,0,2,0,2,2,2,4,-1,-8,11,0,-6,6,-2,0,0,0,1,0,-1,0,-1
KR_6747630246,420,-5,-34,-36,-5,-1,2,1,-5,5,0,-2,4,2,3,3,6,0,0,0,-3,-8,-6,-2,-7,9,-1,0,-1,-1,-1,-1,-1,6,-1
KR_6756549402,420,0,-33,9,2,4,3,7,1,2,3,-3,3,0,2,2,4,-2,2,0,-1,-1,-158,-6,-6,12,14,0,-1,-1,0,-1,-1,3,-1
KR_6762116153,420,-3,-18,20,-9,-7,7,0,-2,3,1,-6,6,0,4,1,5,2,0,2,0,-11,13,-3,-3,6,-5,0,-1,1,-1,-1,1,6,-1
KR_6760472962,420,-6,-92,-3,-17,-3,3,0,-7,7,0,1,1,2,-5,7,2,-3,3,0,0,-24,-4,0,-6,6,-4,0,-2,-1,1,-1,-1,3,-1
KR_6718559299,420,-1,-82,4,-3,-2,2,0,-1,2,1,4,0,4,-3,4,1,-1,1,0,0,-6,-14,-8,-2,10,2,0,-1,-1,1,-1,1,4,-1
KR_6667787688,420,-5,-29,11,-1,-1,1,0,6,3,9,0,2,2,-7,8,1,1,2,3,-1,1,3,-6,-3,9,4,0,-2,-1,-1,-1,-1,3,-1
KR_6717364256,420,-10,-181,-37,-14,-4,5,1,-2,4,2,-2,3,1,-5,8,3,-1,1,0,-2,-10,1,0,-5,5,-8,0,-3,-1,-1,-1,-1,5,-1
KR_6766819043,420,-4,-12,32,-6,-2,3,1,-3,5,2,-4,5,1,2,1,3,1,0,1,0,-1,1,-5,-3,8,-2,0,0,1,1,0,-1,6,-1
KR_6764950681,420,-1,-2,-28,-5,3,0,3,-5,5,0,-4,5,1,1,0,1,0,1,1,0,-1,8,-3,-4,7,3,0,-2,1,-1,-1,-1,5,-1
KR_6674638947,420,1,40,15,3,0,2,2,1,1,2,2,3,5,-1,4,3,1,1,2,0,-5,44,3,-6,3,-22,0,0,1,1,1,-1,3,-1
KR_6763029142,420,3,-12,-18,4,-2,4,2,3,2,5,3,0,3,0,1,1,0,0,0,1,8,30,-3,-3,6,0,0,0,-1,-1,0,1,1,-1
KR_6747766175,420,-2,9,-3,-1,0,0,0,-5,5,0,0,3,3,4,1,5,0,1,1,0,1,-15,2,-5,3,0,0,0,-1,-1,-1,1,1,-1
KR_6723475916,420,2,-41,15,0,1,3,4,4,2,6,-2,4,2,0,3,3,-3,3,0,0,-1,-6,-1,-4,5,1,0,-1,-1,-1,-1,-1,6,-1
KR_6749606701,440,1,-7,16,3,0,3,3,0,4,4,4,4,8,-1,4,3,0,1,1,0,4,3,1,-8,7,-1,0,-1,-1,-1,-1,-1,1,-1
KR_6760955474,420,1,-67,-12,-3,4,0,4,0,1,1,0,2,2,-4,4,0,-3,3,0,0,-1,6,7,-12,5,-5,0,-1,-1,1,-1,-1,6,-1
KR_6644745137,420,-4,-12,-16,-3,-2,5,3,0,2,2,-5,5,0,3,4,7,1,0,1,1,6,-3,0,-7,7,-1,0,-2,-1,-1,-1,1,3,-1
KR_6732942217,420,0,-60,20,-1,-4,5,1,-3,4,1,-1,3,2,6,0,6,1,1,2,0,-1,-2,-4,-7,11,1,0,0,1,-1,-1,1,3,-1
KR_6768867292,440,-5,-33,-37,-12,-5,7,2,2,2,4,1,1,2,-3,4,1,-7,9,2,0,-11,-1,0,-4,4,1,0,-2,1,-1,-1,1,1,-1
KR_6768075267,420,-4,-110,-77,-5,-2,3,1,-4,7,3,0,3,3,-2,4,2,3,0,3,0,-3,50,-4,0,4,30,0,-2,-1,-1,-1,-1,2,-1
KR_6754815177,420,-2,1,-2,0,1,1,2,-1,4,3,1,1,2,-4,6,2,3,1,4,-1,-3,-1,1,-8,7,3,0,-1,1,-1,-1,-1,3,-1
KR_6761884483,440,1,-25,-16,7,2,1,3,2,2,4,6,3,9,-1,1,0,-2,2,0,0,3,-2,-1,0,1,-1,0,2,0,1,1,1,0,-1
KR_6729626660,440,0,-41,2,2,7,1,8,-5,7,2,-2,4,2,0,2,2,2,0,2,0,-2,-17,4,-10,6,-3,0,1,1,1,1,1,4,-1
KR_6765582154,420,-3,-35,21,-14,-2,4,2,-1,2,1,-4,4,0,-6,8,2,-1,1,0,0,-10,-21,-2,-8,10,-9,0,-1,1,-1,-1,1,1,-1
KR_6765839765,420,0,39,-12,0,0,2,2,1,1,2,-1,4,3,0,4,4,0,1,1,0,0,24,2,-8,6,-1,0,-1,-1,-1,-1,-1,6,-1
KR_6666763506,420,-1,-62,-15,-9,3,0,3,-4,4,0,1,2,3,-8,9,1,-1,2,1,-1,-11,-4,2,-8,6,3,0,0,-1,-1,-1,-1,4,-1
KR_6722725482,420,-6,-67,-6,-14,1,0,1,-4,5,1,-6,8,2,-4,4,0,-1,2,1,-1,-20,22,-5,-5,10,-7,0,-1,-1,1,-1,-1,4,-1
KR_6739582923,420,1,-30,12,8,3,0,3,2,1,3,0,4,4,1,2,3,2,0,2,-1,16,-24,1,-7,6,0,0,1,1,0,1,-1,4,-1
KR_6764923574,420,-1,-83,20,0,-2,3,1,0,5,5,2,2,4,1,3,4,-1,1,0,0,-1,0,-6,-5,11,-2,0,0,-1,1,-1,1,6,-1
KR_6751627858,420,-4,-32,-10,-12,4,1,5,-4,6,2,-9,10,1,-2,4,2,-1,2,1,0,-17,-6,-2,-5,7,1,0,-2,1,-1,-1,1,6,-1
KR_6720514736,420,-1,70,-21,-4,1,0,1,-2,4,2,-5,5,0,3,1,4,-1,2,1,0,-2,-24,0,-3,3,-1,0,-1,1,-1,-1,-1,6,-1
KR_6631150271,420,0,-24,-25,2,0,3,3,3,3,6,1,1,2,-2,2,0,0,0,0,-2,11,21,2,-7,5,-4,0,0,-1,-1,0,-1,6,-1
KR_6742528718,420,2,9,-23,0,0,3,3,0,1,1,3,1,4,-2,4,2,-1,2,1,0,3,49,-2,-3,5,-13,0,-1,-1,-1,-1,1,5,-1
KR_6766157228,440,1,-19,8,-1,0,0,0,2,0,2,1,3,4,-2,2,0,-2,2,0,0,3,-22,-3,-3,6,-3,0,-2,0,-1,-1,1,0,-1
KR_6679774720,420,-3,-61,-4,0,3,2,5,0,4,4,-1,1,0,-2,4,2,0,0,0,0,-2,14,4,-9,5,-2,0,1,-1,-1,1,-1,3,-1
KR_6680255230,420,-4,-38,0,-4,-1,4,3,-6,8,2,-1,2,1,4,1,5,0,1,1,1,3,1,-2,-5,7,-8,0,-1,0,-1,-1,1,0,-1
KR_6682852730,420,-2,-42,28,-7,-2,2,0,-1,5,4,-6,6,0,1,1,2,1,0,1,0,-5,-4,-1,-4,5,-2,0,0,-1,1,-1,1,6,-1
KR_6738016472,420,-2,-28,-2,-4,0,3,3,-1,6,5,-4,4,0,-2,2,0,3,0,3,4,3,37,5,-8,3,-9,0,0,-1,1,1,1,3,-1
KR_6737718967,420,-4,-115,1,-12,-2,4,2,0,1,1,-2,4,2,-8,8,0,0,0,0,-2,-11,2,-2,-6,8,-6,0,-2,-1,-1,-1,-1,1,-1
KR_6759367326,420,-3,-84,19,-4,-2,3,1,0,0,0,2,0,2,-4,4,0,0,0,0,0,-4,39,1,-6,5,-29,0,-2,-1,-1,-1,-1,2,-1
KR_6762147105,420,0,11,-16,2,6,0,6,-3,5,2,-6,6,0,5,0,5,0,0,0,1,0,-24,-2,-3,5,0,0,-1,0,-1,-1,1,0,-1
KR_6738666718,420,0,53,0,-1,3,0,3,3,1,4,-6,6,0,-2,4,2,1,0,1,1,-9,2,-3,-2,5,0,0,-1,-1,1,-1,1,6,-1
KR_6719857621,420,-6,-117,-8,-6,-1,3,2,-3,3,0,-1,2,1,-1,1,0,0,0,0,0,-11,16,2,-7,5,-6,0,-2,-1,1,-1,-1,5,-1
KR_6768623294,440,3,42,12,4,1,1,2,-2,3,1,0,1,1,1,2,3,4,1,5,0,-1,13,5,-9,4,1,0,0,0,-1,1,-1,0,-1
KR_6681753189,420,-3,-46,-3,-4,0,1,1,-2,3,1,-1,4,3,0,3,3,-1,1,0,0,-7,-42,-3,-3,6,14,0,0,1,-1,-1,-1,4,-1
KR_6738349480,420,-2,1,-32,0,1,5,6,0,1,1,2,2,4,-4,7,3,1,2,3,-1,-18,7,0,-6,6,-4,0,-1,1,0,-1,1,4,-1
KR_6748146150,420,-1,-31,26,8,-1,5,4,5,0,5,0,2,2,2,4,6,2,2,4,3,17,-48,7,-10,3,-1,0,-1,1,-1,-1,1,3,-1
KR_6761296943,420,-4,23,-31,-12,1,0,1,0,3,3,-3,4,1,-2,2,0,-8,8,0,0,-16,-10,-1,-2,3,1,0,0,-1,-1,0,1,1,-1
KR_6693632854,420,-4,-96,-9,-7,-4,4,0,1,1,2,-1,3,2,-4,4,0,1,1,2,-2,-4,-8,0,-3,3,2,0,-1,-1,-1,-1,-1,3,-1
KR_6687706991,420,1,-93,-3,5,-5,5,0,6,1,7,2,2,4,2,0,2,0,0,0,0,20,-3,-1,-6,7,3,0,0,-1,1,0,-1,5,-1
KR_6717909404,420,-3,-18,-28,-2,8,1,9,-3,4,1,-4,4,0,-4,4,0,1,0,1,0,-14,-7,2,-6,4,3,0,2,-1,1,1,1,1,-1
KR_6764242305,420,1,19,-12,-2,1,0,1,-6,8,2,3,2,5,0,0,0,0,2,2,0,-7,-10,1,-5,4,5,0,0,1,-1,0,1,6,-1
KR_6644801326,420,-2,-6,-12,-6,3,1,4,-1,1,0,-3,4,1,-4,4,0,-1,1,0,0,-6,0,-3,-4,7,0,0,0,1,-1,1,-1,5,-1
KR_6768257694,420,0,17,16,-6,-1,1,0,-2,2,0,1,3,4,-1,3,2,-3,3,0,-1,-9,14,0,-6,6,4,0,0,0,-1,0,-1,0,-1
KR_6757724212,440,-4,-152,17,-5,1,1,2,0,0,0,-8,13,5,-2,4,2,4,0,4,0,6,-22,3,-4,1,20,0,-1,-1,-1,-1,-1,4,-1
KR_6761563387,440,-2,17,-12,-6,-1,1,0,-5,5,0,-3,5,2,5,0,5,-2,5,3,0,-16,3,-7,-2,9,5,0,-1,-1,-1,1,1,6,-1
KR_6763188313,420,-1,-38,-39,5,-1,1,0,-1,4,3,7,1,8,-1,5,4,1,1,2,0,4,-91,6,-8,2,-1,0,0,1,1,0,-1,1,-1
KR_6764598646,420,0,31,0,-10,-3,5,2,1,1,2,-2,5,3,-3,8,5,-3,4,1,-2,-24,-5,2,-7,5,2,0,0,1,-1,1,-1,1,-1
KR_6682238032,420,1,35,-6,4,-5,6,1,6,1,7,1,2,3,3,0,3,-1,1,0,0,9,108,1,-9,8,-1,0,-1,1,-1,-1,-1,4,-1
KR_6768362872,420,-1,30,13,-3,6,0,6,-4,6,2,-4,9,5,-1,2,1,0,1,1,0,-16,9,1,-4,3,0,0,0,-1,-1,1,1,1,-1
KR_6769748687,440,-5,-90,-8,-7,-3,3,0,-1,2,1,2,0,2,-1,2,1,-4,5,1,0,-6,-1,-2,-6,8,-2,0,-1,1,-1,-1,-1,1,-1
KR_6707652117,420,0,-34,0,-2,-1,1,0,2,2,4,-1,2,1,-2,2,0,0,0,0,0,0,4,2,-5,3,4,0,0,1,-1,0,1,2,-1
KR_6624324896,440,-2,-57,11,-6,3,2,5,-2,4,2,-4,6,2,-2,5,3,-1,2,1,2,-10,1,-1,-5,6,-2,0,2,-1,1,1,1,2,-1
KR_6744966913,420,1,-42,18,0,1,3,4,-7,7,0,2,2,4,3,0,3,1,3,4,1,-4,3,2,-9,7,-7,0,-1,-1,-1,-1,1,2,-1
KR_6762152501,440,-2,-25,-12,-4,0,2,2,-7,8,1,4,2,6,-1,5,4,0,1,1,0,-11,-4,-4,-4,8,-3,0,0,-1,1,0,1,6,-1
KR_6770896464,420,1,61,12,1,-2,4,2,1,1,2,4,1,5,-2,4,2,0,2,2,0,7,-23,0,-8,8,4,0,1,1,-1,1,-1,4,-1
KR_6724877814,420,-5,-6,-4,-5,-1,3,2,-3,3,0,-1,1,0,0,2,2,0,2,2,0,-5,-5,-2,-2,4,1,0,0,-1,-1,-1,1,6,-1
KR_6682792152,420,4,18,3,5,0,1,1,-3,7,4,2,1,3,4,0,4,2,0,2,0,8,-59,1,-5,4,-22,0,1,-1,0,1,-1,2,-1
KR_6705518452,420,0,15,-1,-5,4,0,4,-1,6,5,-4,7,3,-2,5,3,-2,4,2,0,-7,40,-1,-7,8,-21,0,1,-1,-1,1,-1,5,-1
KR_6711623765,420,0,-19,-13,-5,3,0,3,-2,5,3,-3,3,0,-4,6,2,1,2,3,0,-5,-1,0,-5,5,1,0,-2,-1,-1,-1,1,4,-1
KR_6767062868,440,1,-3,44,1,0,1,1,0,3,3,-1,3,2,1,1,2,1,0,1,0,2,-32,-3,-3,6,-2,0,0,1,1,0,1,1,-1
KR_6702596625,420,-4,-115,-12,-10,-6,6,0,-1,5,4,2,0,2,-3,6,3,-2,5,3,-1,-10,-10,-2,-3,5,1,0,-3,-1,-1,-1,-1,1,-1
KR_6770769487,420,-4,-77,-12,-17,-2,5,3,-9,12,3,-3,3,0,-3,3,0,0,0,0,-1,-17,-2,1,-4,3,0,0,-1,-1,0,-1,-1,2,-1
KR_6734830716,420,0,55,-32,4,-1,3,2,-1,2,1,1,3,4,4,1,5,1,1,2,0,7,7,2,-4,2,0,0,1,-1,1,1,-1,2,-1
KR_6681144495,420,1,69,12,-3,0,0,0,-7,9,2,4,2,6,0,1,1,0,0,0,1,-5,-5,-1,-2,3,-3,0,0,-1,-1,0,1,4,-1
KR_6769006905,420,1,-4,-39,-2,1,1,2,-2,2,0,-1,3,2,0,0,0,0,1,1,0,3,5,-1,-8,9,3,0,0,-1,-1,0,-1,4,-1
KR_6751367868,420,0,4,-31,-2,3,1,4,-1,2,1,2,0,2,-3,5,2,-3,3,0,0,0,163,4,-9,5,-2,0,-1,-1,-1,-1,-1,4,-1
KR_6682782605,420,4,-4,2,2,3,1,4,-1,5,4,3,2,5,-1,2,1,-2,3,1,0,-2,0,-3,-4,7,1,0,2,-1,1,1,-1,5,-1
KR_6767314630,440,2,80,5,4,2,2,4,-4,5,1,3,3,6,5,2,7,-2,4,2,0,-2,-53,-2,-3,5,2,0,0,-1,1,1,1,5,-1
KR_6749361504,420,-4,-24,-21,-2,0,0,0,-2,3,1,1,4,5,-2,3,1,1,0,1,0,1,-5,1,-4,3,0,0,-1,-1,-1,-1,1,2,-1
KR_6767793856,420,-2,-13,1,-10,1,2,3,-7,7,0,-3,4,1,-1,6,5,0,0,0,-1,-12,-3,0,-8,8,-7,0,-2,-1,-1,-1,-1,3,-1
KR_6766776772,420,0,-23,-33,1,-2,3,1,-2,9,7,4,0,4,1,3,4,0,1,1,-1,2,9,5,-8,3,-3,0,-1,1,1,-1,-1,3,-1
KR_6675870150,420,-1,-43,-28,-3,-3,4,1,-1,4,3,2,0,2,-2,3,1,1,1,2,0,-3,5,1,-5,4,-6,0,0,1,-1,-1,-1,5,-1
KR_6739036104,440,1,-17,16,-2,1,1,2,-1,3,2,1,1,2,-5,6,1,2,0,2,0,-4,-9,-3,-2,5,-1,0,-1,1,-1,-1,-1,4,-1
KR_6768788477,440,-2,-85,-24,-5,-6,6,0,0,4,4,1,2,3,-1,4,3,1,1,2,0,2,-3,4,-7,3,2,0,-1,-1,-1,-1,-1,4,-1
KR_6733704869,440,-1,3,22,-14,0,1,1,-2,4,2,-7,10,3,-4,5,1,-1,7,6,0,-20,-10,1,-4,3,0,0,0,-1,1,0,1,1,-1
KR_6767637087,420,2,-22,-4,6,2,0,2,4,2,6,-2,2,0,2,2,4,0,0,0,0,5,-2,0,-7,7,-1,0,0,-1,-1,0,-1,2,-1
KR_6708999631,420,3,-62,-8,12,1,1,2,8,1,9,3,0,3,1,1,2,-1,4,3,0,13,-47,9,-12,3,25,0,0,1,-1,-1,1,6,-1
KR_6753018478,420,-1,12,16,-5,0,2,2,-3,4,1,-3,6,3,-1,4,3,2,0,2,0,-2,-7,-1,-6,7,0,0,1,1,1,1,-1,6,-1
KR_6730094910,420,-6,-54,-21,-11,-15,16,1,1,0,1,1,2,3,1,0,1,1,1,2,-1,-2,13,-1,-3,4,1,0,-2,-1,-1,-1,-1,1,-1
KR_6750836542,440,0,54,-8,6,5,1,6,0,8,8,1,2,3,-1,3,2,1,3,4,0,5,0,-1,-4,5,0,0,2,-1,1,1,1,5,-1
KR_6767114446,420,-4,6,-25,-9,-2,3,1,-1,2,1,-6,8,2,0,2,2,0,0,0,0,-5,-8,3,-6,3,-1,0,-1,-1,-1,-1,-1,1,-1
KR_6668540019,420,-6,-83,21,-19,-3,3,0,-9,11,2,-2,2,0,-4,4,0,-1,1,0,-1,-19,-11,-2,-3,5,-1,0,-3,1,-1,-1,-1,3,-1
KR_6761142816,420,-2,-31,-15,-1,2,1,3,-2,4,2,-2,3,1,3,0,3,-2,4,2,0,2,2,-2,-5,7,-3,0,0,-1,1,1,1,2,-1
KR_6764879647,420,-2,34,-32,-6,2,1,3,-5,6,1,0,3,3,-3,3,0,0,2,2,-4,-20,3,0,-3,3,-4,0,0,1,-1,1,-1,6,-1
KR_6750548985,420,-4,-38,-20,-6,1,4,5,-4,5,1,0,2,2,0,1,1,-3,4,1,-1,-7,-3,-5,-1,6,-1,0,1,-1,1,1,-1,4,-1
KR_6748075281,420,2,29,44,-2,3,1,4,4,1,5,-4,4,0,0,1,1,-5,5,0,-1,-5,-6,-1,-4,5,1,0,0,1,-1,0,-1,1,-1
KR_6760078687,420,-5,20,-30,-8,2,0,2,-3,7,4,-4,4,0,-2,7,5,-1,2,1,0,-15,1,0,-6,6,0,0,-1,0,-1,-1,-1,0,-1
KR_6728852617,440,-3,-28,-24,-3,-3,3,0,3,3,6,2,0,2,-2,2,0,-3,5,2,0,-7,-2,4,-6,2,-2,0,-2,-1,-1,-1,1,4,-1
KR_6693436375,420,-1,10,13,1,1,3,4,3,2,5,-2,2,0,0,2,2,-1,1,0,0,2,-4,-1,-4,5,3,0,-1,1,-1,-1,-1,2,-1
KR_6765137284,420,0,7,-9,2,2,1,3,1,1,2,-3,5,2,0,4,4,2,0,2,0,-1,2,-1,-2,3,-4,0,0,-1,1,0,1,2,-1
KR_6681858321,420,-4,-49,-38,-5,-4,5,1,-2,4,2,1,3,4,0,3,3,0,2,2,1,3,0,-3,-1,4,0,0,-1,-1,-1,-1,1,3,-1
KR_6755465857,420,-7,-38,-5,-11,-3,4,1,-4,6,2,-3,4,1,3,2,5,-4,5,1,0,-9,-14,1,-4,3,0,0,0,0,-1,1,1,0,-1
KR_6721385378,420,-4,-67,-39,-4,1,0,1,-1,2,1,0,2,2,-3,3,0,-1,1,0,0,-7,-58,-3,-7,10,1,0,-1,-1,-1,-1,-1,6,-1
KR_6745326155,420,-4,-46,-6,-8,-1,4,3,-4,5,1,-3,4,1,0,2,2,0,0,0,0,-11,-4,0,-5,5,4,0,0,-1,-1,0,1,2,-1
KR_6766563795,420,0,-38,-15,-6,0,2,2,-2,3,1,-6,6,0,0,3,3,2,0,2,0,-12,50,2,-5,3,-26,0,0,-1,1,0,-1,1,-1
KR_6770906091,420,1,19,24,-4,3,2,5,-3,5,2,3,1,4,-4,7,3,-3,3,0,0,-7,-4,3,-7,4,-2,0,0,-1,1,1,-1,4,-1
KR_6741697457,420,-1,-97,7,-12,-1,3,2,-5,5,0,-2,2,0,-5,9,4,1,0,1,0,-8,24,-7,-3,10,-3,0,-2,-1,-1,-1,-1,2,-1
KR_6768472597,420,1,-13,-26,3,-2,2,0,1,3,4,2,0,2,3,6,9,-1,2,1,0,8,-1,2,-10,8,-9,0,1,-1,1,1,-1,6,-1
KR_6703330136,420,-5,-30,-37,-12,3,0,3,-9,10,1,-5,7,2,-2,4,2,1,1,2,0,-14,-6,-4,-4,8,-1,0,-1,-1,-1,-1,-1,4,-1
KR_6737536947,420,-4,-47,-10,-1,1,0,1,0,1,1,0,3,3,0,3,3,-2,2,0,0,-5,25,0,-5,5,-2,0,0,-1,-1,0,1,1,-1
KR_6658929031,420,-3,32,-24,-5,0,2,2,-4,5,1,2,1,3,-2,4,2,-1,1,0,0,-9,161,-3,-4,7,0,0,-1,-1,-1,-1,1,4,-1
KR_6767082625,440,0,-41,4,0,-1,2,1,2,3,5,-2,3,1,0,2,2,1,2,3,0,-3,3,0,-2,2,-2,0,0,1,-1,0,1,5,-1
KR_6760596804,420,0,-27,-4,8,0,4,4,3,1,4,2,0,2,1,4,5,2,0,2,0,18,347,-4,-4,8,1,0,-1,-1,1,-1,1,6,-1
KR_6769983708,440,2,27,3,7,4,1,5,1,1,2,0,2,2,2,4,6,0,1,1,2,11,7,3,-7,4,-1,0,0,1,1,1,1,4,-1
KR_6770542018,420,-1,-70,-22,3,2,1,3,3,2,5,-2,5,3,-1,2,1,1,1,2,0,3,16,2,-6,4,0,0,-1,1,1,-1,-1,1,-1
KR_6700423636,420,-3,-26,-51,-6,-3,4,1,-1,1,0,-5,5,0,3,0,3,0,0,0,0,-2,2,2,-9,7,-2,0,-1,1,-1,-1,-1,2,-1
KR_6760346953,420,-3,-5,-5,-4,0,2,2,0,4,4,-6,7,1,2,3,5,0,0,0,1,3,-7,-1,-6,7,2,0,0,1,-1,-1,1,6,-1
KR_6765605350,420,-1,13,16,2,2,2,4,2,0,2,-3,5,2,-1,4,3,2,1,3,0,-4,0,-2,-5,7,0,0,0,-1,-1,0,1,1,-1
KR_6743286761,420,-1,-38,-23,-6,-6,7,1,1,0,1,-1,2,1,0,2,2,0,1,1,0,-1,29,-1,-4,5,-4,0,0,-1,-1,0,-1,6,-1
KR_6764818712,420,0,27,-5,-8,0,2,2,0,5,5,-3,3,0,-1,3,2,-4,4,0,0,-11,-6,0,-8,8,3,0,0,-1,-1,-1,-1,1,-1
KR_6766048009,440,-3,-10,-4,-15,-8,9,1,-7,7,0,1,2,3,-1,2,1,0,4,4,0,-12,-7,-2,-7,9,0,0,0,-1,-1,0,-1,4,-1
KR_6758795372,420,0,51,4,-7,1,0,1,-8,9,1,0,3,3,1,2,3,-1,5,4,-2,-15,-4,-4,-4,8,5,0,2,-1,1,1,-1,3,-1
KR_6769400077,440,1,15,-16,3,-3,5,2,0,3,3,4,0,4,2,3,5,0,3,3,-1,5,1,-5,-1,6,-2,0,-1,1,-1,-1,-1,4,-1
KR_6752961405,420,-2,-57,-7,-5,-1,1,0,0,0,0,0,3,3,-3,3,0,-1,1,0,0,-6,9,0,-6,6,-7,0,0,-1,1,0,-1,2,-1
KR_6680097764,420,0,-17,-23,-7,-1,1,0,-2,4,2,-5,8,3,1,1,2,0,2,2,0,-7,-4,-1,-5,6,1,0,0,-1,-1,0,-1,6,-1
KR_6734141287,420,-7,-20,-35,-14,-1,2,1,-2,3,1,-4,4,0,-3,4,1,-4,4,0,0,-17,36,2,-6,4,-22,-1,-3,-1,-1,-1,-1,4,-1
KR_6756761460,440,-1,54,-13,-8,1,1,2,-6,6,0,-2,4,2,-3,3,0,2,0,2,0,-7,3,-5,-3,8,-5,0,1,1,-1,1,1,6,-1
KR_6750649859,420,1,-13,-24,3,-2,5,3,3,4,7,0,3,3,-1,2,1,3,1,4,0,-5,0,-2,-6,8,3,0,1,-1,1,1,1,1,-1
KR_6755219199,420,-2,6,-3,-8,-3,4,1,-4,5,1,2,0,2,-1,2,1,-2,2,0,0,-9,-21,1,-4,3,-3,0,1,-1,1,1,1,2,-1
KR_6751517843,420,0,18,48,1,-1,1,0,0,3,3,2,3,5,1,0,1,-1,1,0,-1,-5,-3,0,-4,4,3,0,-1,1,-1,-1,-1,6,-1
KR_6757803422,420,-5,-23,-1,-8,-4,4,0,-5,5,0,-1,2,1,-3,5,2,5,0,5,-1,1,-11,0,-3,3,4,0,0,1,-1,-1,-1,3,-1
KR_6767868278,420,1,24,-16,-4,-1,5,4,2,1,3,1,2,3,-4,8,4,-2,3,1,0,1,-1,3,-5,2,1,0,0,-1,-1,0,1,2,-1
KR_6756298729,420,-3,-20,-4,-5,-1,2,1,-3,6,3,3,1,4,-6,7,1,2,1,3,0,-14,-7,-1,-4,5,3,0,0,1,0,0,1,1,-1
KR_6564386370,420,1,-5,13,-4,-1,4,3,0,4,4,3,1,4,-5,6,1,-1,2,1,0,4,9,-4,-1,5,2,0,-1,-1,1,-1,-1,3,-1
KR_6769448329,440,-2,12,-10,-1,1,2,3,-1,1,0,1,0,1,-7,11,4,5,1,6,0,-4,13,4,-6,2,-1,0,-1,0,-1,-1,-1,0,-1
KR_6748086845,420,-2,-29,-24,-1,3,0,3,4,0,4,0,3,3,-7,10,3,-1,1,0,0,2,7,6,-9,3,1,0,0,-1,-1,0,1,4,-1
KR_6750554387,420,-6,-94,-24,-13,-3,4,1,-3,4,1,0,0,0,-7,8,1,0,0,0,-1,-11,4,0,-5,5,-3,0,-3,-1,1,-1,-1,5,-1
KR_6684674000,420,0,-12,-4,-3,0,3,3,-1,6,5,3,1,4,-5,5,0,0,1,1,-1,-4,0,2,-5,3,-1,0,-1,-1,1,-1,-1,3,-1
KR_6762623175,420,-1,-18,4,-5,-2,2,0,0,3,3,-1,1,0,-2,3,1,0,0,0,0,-9,6,-3,-4,7,3,0,0,1,-1,0,1,4,-1
KR_6707202709,440,-4,9,-3,-5,2,0,2,1,0,1,-3,4,1,-1,1,0,-4,4,0,0,-3,176,-6,-2,8,4,0,1,-1,1,1,1,2,-1
KR_6747006589,420,-2,-21,24,-7,-2,2,0,-5,7,2,-1,2,1,0,2,2,1,0,1,0,1,-46,-2,-3,5,25,0,-2,1,-1,-1,1,4,-1
KR_6760786233,420,0,-31,-12,-1,-5,5,0,-1,2,1,0,1,1,2,0,2,3,0,3,0,7,-3,-4,-2,6,1,0,-2,-1,-1,-1,-1,6,-1
KR_6625329184,420,-1,-55,12,-2,-1,2,1,-2,5,3,0,2,2,-1,2,1,2,0,2,0,-2,30,2,-5,3,5,0,0,1,1,0,-1,5,-1
KR_6759361494,420,-4,12,-18,-14,-1,3,2,-3,4,1,-8,9,1,0,6,6,-2,2,0,0,-14,-51,1,-4,3,21,0,-2,-1,-1,-1,1,1,-1
KR_6765280675,440,-7,-104,-48,-20,1,0,1,-5,6,1,-4,5,1,-12,15,3,0,0,0,1,-25,-5,2,-5,3,-3,0,-3,1,-1,-1,1,4,-1
KR_6755670476,420,0,32,-28,0,1,0,1,3,1,4,-6,6,0,1,1,2,1,1,2,0,-5,-3,-3,-5,8,0,0,0,-1,1,1,1,5,-1
KR_6750162555,420,-2,13,-12,-7,2,2,4,0,3,3,-3,5,2,-5,8,3,-1,1,0,0,-10,-5,-1,-4,5,-2,0,0,-1,-1,-1,1,4,-1
KR_6696972572,420,1,-2,21,0,-1,2,1,4,1,5,2,4,6,-5,6,1,0,0,0,-1,-3,-1,-4,-6,10,3,0,0,-1,-1,-1,-1,3,-1
KR_6767553153,420,-1,-25,0,-6,-6,8,2,-2,4,2,-2,4,2,2,1,3,2,0,2,1,-3,-17,4,-5,1,1,0,-1,1,-1,-1,1,5,-1
KR_6745303075,420,-1,0,-13,-8,-1,3,2,-1,4,3,-2,3,1,-1,1,0,-3,3,0,0,-5,-4,-2,-7,9,-1,0,-1,-1,-1,-1,-1,5,-1
KR_6768404740,420,-3,-55,-8,-7,-3,4,1,-1,3,2,-4,4,0,1,1,2,0,1,1,0,-3,118,-3,-5,8,-2,0,0,-1,-1,-1,-1,2,-1
KR_6759286965,420,-4,-80,-45,-4,-3,4,1,0,3,3,0,3,3,-2,3,1,1,1,2,0,-1,-4,-1,-5,6,2,0,-2,-1,-1,-1,1,4,-1
KR_6758497657,420,-3,-7,12,-6,1,3,4,-1,4,3,-3,4,1,0,4,4,-3,3,0,2,3,-5,-4,-5,9,3,0,0,-1,1,-1,1,3,-1
KR_6767022049,440,2,-16,-9,1,3,0,3,1,3,4,-3,3,0,1,1,2,-1,1,0,0,-3,-17,-3,-1,4,2,0,0,-1,-1,-1,-1,4,-1
KR_6758250596,420,-2,-9,-4,-6,-1,3,2,1,2,3,-2,3,1,-2,2,0,-2,3,1,0,-9,-25,-1,-5,6,-2,0,0,-1,0,-1,1,3,-1
KR_6754169134,420,0,72,-17,3,-1,2,1,3,1,4,-1,4,3,1,1,2,1,0,1,0,2,-35,1,-6,5,0,0,1,1,-1,1,1,6,-1
KR_6741219461,420,-1,-7,4,-6,-2,2,0,0,4,4,-1,1,0,-4,6,2,1,0,1,0,-7,-24,3,-6,3,0,0,0,-1,1,1,-1,3,-1
KR_6758518937,420,-1,-36,4,-1,-1,3,2,1,1,2,-3,5,2,5,2,7,-3,3,0,0,1,315,2,-5,3,0,0,-1,1,-1,-1,-1,1,-1
KR_6768220631,420,2,16,-28,4,5,2,7,1,1,2,-2,2,0,1,2,3,-1,2,1,0,4,3,-1,-4,5,0,0,-1,-1,-1,-1,1,3,-1
KR_6733161378,420,-3,23,-1,-10,-1,1,0,0,2,2,-1,1,0,-7,9,2,-1,2,1,0,-19,-14,0,-7,7,1,0,0,-1,1,1,-1,5,-1
KR_6756583919,420,0,19,4,-1,0,2,2,-1,4,3,3,1,4,-1,3,2,-2,3,1,1,0,-3,4,-8,4,0,0,0,-1,0,-1,1,2,-1
KR_6769360115,420,0,15,0,8,3,1,4,1,2,3,0,3,3,2,2,4,2,0,2,1,4,8,6,-10,4,2,0,0,0,-1,0,1,0,-1
KR_6750851939,420,-2,4,-33,-2,0,2,2,0,3,3,0,3,3,-2,5,3,0,3,3,0,1,-14,2,-6,4,4,0,-1,-1,1,-1,1,4,-1
KR_6766190068,440,0,27,27,0,2,0,2,1,0,1,-6,7,1,1,0,1,2,0,2,0,3,3,0,-4,4,-1,0,0,0,1,1,-1,0,-1
KR_6753614313,420,-1,28,-2,-10,-1,1,0,-1,2,1,-5,7,2,-2,3,1,-1,1,0,0,-7,-16,-4,-3,7,2,0,0,-1,1,-1,-1,4,-1
KR_6754238543,420,-1,9,5,-2,0,1,1,0,2,2,-2,3,1,-1,4,3,1,1,2,0,-7,21,2,-6,4,-1,0,0,-1,-1,0,-1,1,-1
KR_6767953371,420,-4,-11,-14,-3,-1,5,4,3,1,4,1,4,5,-4,5,1,-2,6,4,0,-5,2,-3,-2,5,-3,0,-1,1,1,-1,1,2,-1
KR_6760248827,420,-4,9,-27,-2,-2,3,1,2,1,3,-1,3,2,2,1,3,-3,3,0,0,-6,7,1,-3,2,1,0,-1,-1,1,-1,1,5,-1
KR_6715386456,420,-1,-7,7,0,-2,2,0,1,6,7,4,1,5,-2,2,0,-1,1,0,-1,0,-7,-1,-6,7,1,0,1,-1,1,1,-1,3,-1
KR_6665196397,420,-5,-38,-16,-13,-4,4,0,-2,4,2,0,1,1,-7,8,1,0,1,1,1,-18,-4,0,-6,6,-2,0,-2,-1,1,-1,1,2,-1
KR_6717302773,420,-3,-65,-14,-6,-4,7,3,-4,7,3,4,1,5,-1,1,0,-1,2,1,1,-5,-173,1,-6,5,-1,0,-2,1,1,-1,1,2,-1
KR_6751463548,420,-1,-19,-32,-6,0,0,0,-5,6,1,-1,3,2,3,2,5,-3,3,0,-1,-4,-149,-2,-4,6,0,0,0,-1,-1,0,-1,1,-1
KR_6659127766,420,0,24,-55,-1,3,0,3,-8,8,0,3,1,4,2,4,6,-1,2,1,0,-7,-8,-3,-5,8,-1,0,-1,-1,-1,-1,1,6,-1
KR_6770909106,440,0,-46,4,-1,-4,5,1,0,0,0,4,1,5,-2,4,2,1,2,3,0,1,17,-4,-7,11,-4,0,0,-1,-1,-1,-1,4,-1
KR_6695411962,420,-1,-53,-9,-8,-2,2,0,0,0,0,3,3,6,-8,9,1,-1,2,1,-1,-10,0,-2,-2,4,-1,0,-2,-1,-1,-1,-1,1,-1
KR_6764164978,420,-7,-39,15,-19,-3,4,1,-5,6,1,-7,7,0,-7,9,2,3,2,5,-1,-20,1,-3,-3,6,-5,0,-2,1,-1,-1,-1,6,-1
KR_6740861453,420,-3,-20,-39,-7,1,0,1,-2,5,3,-5,6,1,-1,2,1,0,1,1,0,-9,0,0,-4,4,-1,0,-1,1,1,-1,1,6,-1
KR_6665764966,420,-2,25,-54,1,5,0,5,-4,6,2,-1,3,2,1,1,2,0,0,0,0,-3,39,0,-6,6,-19,0,1,-1,-1,-1,-1,4,-1
KR_6743532793,440,-2,-11,0,-5,-1,3,2,2,1,3,-2,3,1,-1,2,1,-3,4,1,-1,0,-4,1,-5,4,-5,0,-2,-1,-1,-1,-1,1,-1
KR_6756846494,440,2,-13,0,-2,-1,4,3,0,1,1,1,0,1,-5,6,1,3,0,3,0,-4,-12,-1,-3,4,2,0,1,0,1,-1,-1,0,-1
KR_6745625056,440,0,-42,-9,3,0,2,2,-3,4,1,0,5,5,5,2,7,1,3,4,0,6,12,0,-3,3,-4,0,-1,1,1,-1,1,3,-1
KR_6747472052,420,-1,33,5,0,-3,4,1,0,3,3,5,2,7,-2,4,2,0,1,1,0,4,4,1,-6,5,-4,0,0,-1,1,1,-1,4,-1
KR_6758216759,420,-2,-72,-19,-5,-2,3,1,-1,2,1,-4,4,0,1,3,4,1,0,1,-4,-3,-8,-1,-2,3,-5,0,-1,1,-1,-1,-1,6,-1
KR_6748288786,420,-2,-43,-17,-4,-4,7,3,-2,4,2,-2,4,2,5,0,5,-1,2,1,0,-6,-1,2,-8,6,1,0,-2,1,0,-1,-1,5,-1
KR_6744631475,420,-7,-94,-19,-11,0,0,0,-2,4,2,1,1,2,-9,9,0,-1,2,1,0,-13,-9,-2,-3,5,0,0,-2,-1,-1,-1,-1,4,-1
KR_6637855844,420,3,37,-4,7,1,0,1,-1,5,4,4,1,5,0,3,3,3,0,3,0,3,3,-2,-5,7,-4,0,0,-1,1,0,1,1,-1
KR_6750223793,420,-5,-24,-8,-12,-4,4,0,-7,7,0,-4,4,0,3,0,3,0,1,1,0,-11,-3,-2,-4,6,-1,0,-1,-1,-1,-1,-1,3,-1
KR_6682265012,420,-1,-3,12,1,0,3,3,-2,5,3,-1,2,1,5,1,6,-1,1,0,1,7,-10,-1,-5,6,4,0,0,1,-1,0,1,1,-1
KR_6770341646,420,-5,-10,-19,-14,1,0,1,-6,6,0,-3,3,0,-3,4,1,-3,3,0,-1,-20,10,2,-7,5,-8,0,-1,-1,-1,-1,-1,3,-1
KR_6763100243,440,-3,-23,-14,-6,0,3,3,-2,2,0,-4,4,0,1,5,6,-1,1,0,0,-8,-1,3,-4,1,1,0,0,1,-1,-1,-1,5,-1
KR_6757937503,420,-7,-106,2,-10,-5,5,0,-3,4,1,-7,7,0,3,1,4,2,1,3,0,-2,7,4,-7,3,-5,0,-2,0,-1,-1,1,0,-1
KR_6749319354,420,-5,-39,-19,-16,-2,3,1,3,0,3,-9,10,1,-7,8,1,-1,1,0,0,-3,-11,-6,-2,8,-3,0,-1,0,-1,-1,-1,0,-1
KR_6718064033,440,-5,-44,-24,-19,-3,5,2,-1,2,1,-4,4,0,-9,9,0,-2,3,1,0,-24,-2,1,-6,5,-5,0,-2,-1,1,-1,-1,4,-1
KR_6762025396,420,4,4,-5,10,1,3,4,4,1,5,0,2,2,8,1,9,-3,5,2,0,14,-1,1,-7,6,3,0,1,1,-1,1,1,3,-1
KR_6737984159,420,-4,12,0,-6,-1,1,0,-2,8,6,0,2,2,-3,6,3,0,0,0,0,-9,-3,2,-5,3,-1,0,0,1,-1,0,-1,6,-1
KR_6739493944,440,-3,-9,-15,-9,-2,3,1,-1,5,4,-3,5,2,-1,2,1,-2,3,1,0,-2,-22,-2,-3,5,5,0,0,-1,-1,0,1,3,-1
KR_6687246973,420,-2,-16,-24,-1,-2,2,0,0,2,2,-5,5,0,5,0,5,1,0,1,0,-3,-39,-6,-1,7,2,0,-1,-1,-1,-1,-1,1,-1
KR_6648884679,420,0,-56,19,-3,0,1,1,2,0,2,-3,4,1,-1,6,5,-1,1,0,0,-10,-1,-5,-5,10,-5,0,0,1,-1,0,-1,4,-1
KR_6602801296,420,1,22,5,-4,0,0,0,5,1,6,-10,10,0,4,1,5,-3,4,1,0,-3,-11,-3,-6,9,-1,0,0,1,1,0,1,6,-1
KR_6676331020,420,0,-14,25,-5,1,0,1,-4,7,3,-2,6,4,-3,5,2,3,1,4,-3,-11,3,0,-5,5,0,0,1,-1,1,1,-1,5,-1
KR_6742027341,420,0,61,4,-6,-1,2,1,0,3,3,-3,4,1,-1,1,0,-1,2,1,0,-5,-12,3,-7,4,4,0,1,-1,1,1,-1,5,-1
KR_6765985958,420,0,-56,1,-5,-2,3,1,1,1,2,5,0,5,-3,3,0,-6,6,0,0,-2,23,2,-6,4,4,0,-2,-1,-1,-1,1,4,-1
KR_6557628673,420,-3,-36,4,-5,-1,1,0,5,0,5,1,0,1,-11,11,0,1,1,2,0,-16,-21,3,-9,6,-1,0,-2,-1,1,-1,-1,5,-1
KR_6767426439,420,-5,-59,17,-2,2,1,3,-3,4,1,1,0,1,-1,3,2,-1,1,0,0,0,-97,1,-6,5,3,0,-1,1,-1,-1,1,5,-1
KR_6756812585,440,0,-13,-3,3,-3,4,1,0,2,2,3,1,4,6,3,9,-3,3,0,0,5,-106,3,-4,1,0,0,0,0,-1,-1,1,0,-1
KR_6758393777,420,-5,27,-43,-9,2,2,4,-3,4,1,1,0,1,-8,8,0,-1,1,0,0,-14,-8,0,-7,7,0,0,0,-1,1,-1,-1,4,-1
KR_6769988868,420,-5,-39,12,-19,-1,2,1,-3,4,1,-4,5,1,-13,15,2,2,0,2,0,-15,5,1,-6,5,-5,0,-2,1,-1,-1,-1,1,-1
KR_6764825133,420,-1,-7,8,-1,-1,3,2,-2,4,2,1,2,3,0,3,3,1,0,1,0,3,9,-4,-4,8,3,0,0,-1,1,-1,1,6,-1
KR_6760786887,420,-4,0,-24,-2,-2,2,0,0,4,4,1,0,1,0,5,5,-1,1,0,0,-1,21,1,-3,2,-5,0,1,-1,1,1,-1,5,-1
KR_6768393233,420,-2,-67,-6,-5,-6,9,3,2,1,3,1,3,4,-2,2,0,0,0,0,0,3,-6,-3,-3,6,1,0,-1,0,1,-1,1,0,-1
KR_6769340314,420,-5,-49,-44,0,2,2,4,0,3,3,-2,2,0,0,1,1,0,2,2,0,-3,-94,5,-12,7,-13,0,-1,-1,-1,-1,1,3,-1
KR_6755534054,420,0,50,34,0,1,1,2,0,1,1,-6,7,1,3,1,4,2,0,2,0,-2,2,-3,-3,6,-2,0,0,1,-1,0,-1,2,-1
KR_6763375150,420,-2,13,-19,3,4,1,5,-3,4,1,1,4,5,1,1,2,0,1,1,0,8,3,-1,-4,5,1,0,0,1,1,-1,1,5,-1
KR_6745989922,440,-5,-60,-45,-7,-3,3,0,-1,5,4,3,0,3,-6,6,0,0,1,1,-1,-13,-5,-5,-2,7,0,0,-1,-1,1,-1,-1,3,-1
KR_6729808539,440,-1,-44,0,0,2,1,3,2,3,5,0,3,3,-1,1,0,-3,3,0,0,8,-1,2,-6,4,-2,0,-1,-1,-1,-1,1,5,-1
KR_6769930752,420,-1,22,-13,-1,-1,2,1,-2,6,4,-3,3,0,4,3,7,1,2,3,0,-3,-2,-2,-4,6,0,0,-2,1,-1,-1,1,1,-1
KR_6769953845,420,-4,-57,-4,-12,-3,3,0,0,0,0,-8,8,0,-1,2,1,0,1,1,0,-3,1,1,-2,1,0,0,0,-1,1,-1,-1,5,-1
KR_6748041220,420,-5,-47,-12,-6,-1,2,1,-5,5,0,1,2,3,-1,3,2,0,0,0,0,-4,-38,-7,-1,8,-1,0,-1,-1,-1,-1,-1,2,-1
KR_6736865241,420,-3,-66,0,-6,-4,4,0,-2,4,2,3,2,5,-4,6,2,1,2,3,0,-2,-40,-4,-4,8,-1,0,-1,1,-1,-1,-1,6,-1
KR_6680903466,420,-1,-75,6,-4,-1,3,2,0,3,3,2,1,3,-6,6,0,1,1,2,0,-13,-5,2,-6,4,-4,0,0,-1,1,-1,-1,1,-1
KR_6691899469,420,1,-55,7,1,-6,6,0,4,1,5,4,3,7,0,2,2,-1,2,1,0,3,36,0,-6,6,-4,0,-1,-1,-1,-1,-1,3,-1
KR_6755275464,420,1,26,19,-3,4,0,4,0,3,3,1,2,3,-8,8,0,0,0,0,0,-5,-51,1,-8,7,18,0,-1,1,-1,-1,-1,2,-1
KR_6741625164,420,-4,-63,-29,-3,1,1,2,-3,4,1,-3,6,3,1,0,1,1,0,1,0,-2,20,1,-6,5,-20,0,-1,1,-1,-1,-1,4,-1
KR_6740442802,420,-1,-78,-4,-5,-3,5,2,3,3,6,-3,5,2,-1,5,4,-1,1,0,0,0,8,-1,-4,5,-3,0,0,-1,-1,-1,-1,1,-1
KR_6696594133,420,-1,43,-50,-4,0,2,2,-7,9,2,2,1,3,2,4,6,-1,2,1,0,-8,-7,2,-6,4,1,0,-1,-1,-1,-1,1,6,-1
KR_6767401977,420,2,-35,28,3,-2,4,2,5,2,7,2,0,2,-3,4,1,1,2,3,0,2,-3,3,-10,7,4,0,-1,-1,-1,-1,-1,4,-1
KR_6701592143,420,-3,-82,-49,-6,-5,7,2,-5,5,0,-3,8,5,5,1,6,2,0,2,2,-1,-9,-2,-6,8,4,0,-2,1,-1,-1,-1,2,-1
KR_6764445330,440,-1,45,14,-6,-1,3,2,1,4,5,-4,5,1,-2,4,2,0,1,1,0,-9,-17,3,-6,3,-1,0,1,0,-1,1,-1,0,-1
KR_6531434786,440,0,9,16,0,1,3,4,1,4,5,0,0,0,-3,4,1,1,0,1,0,-6,10,0,-9,9,2,0,0,-1,1,1,1,4,-1
KR_6752836856,420,-2,-62,-49,-9,0,1,1,2,0,2,-2,2,0,-6,6,0,-3,3,0,0,-16,5,-2,-6,8,-3,0,-2,-1,-1,-1,-1,5,-1
KR_6762345270,420,-5,-46,10,-14,-4,5,1,-4,5,1,-4,5,1,-2,5,3,0,0,0,0,-19,2,3,-9,6,-6,0,-1,-1,1,-1,-1,4,-1
KR_6761646706,420,-1,6,-11,-5,1,2,3,-7,11,4,0,0,0,1,3,4,0,1,1,0,-9,6,1,-7,6,-2,0,0,1,-1,0,1,1,-1
KR_6760906662,440,-1,-11,0,-2,-3,6,3,3,2,5,1,6,7,-1,5,4,-2,3,1,0,-5,-5,-3,-2,5,2,0,0,-1,1,-1,-1,1,-1
KR_6708821957,420,-6,-78,-3,-12,0,1,1,-5,7,2,-1,5,4,-6,6,0,0,1,1,0,-14,-118,-5,-4,9,-4,0,-4,-1,-1,-1,1,2,-1
KR_6767583686,420,0,-26,-6,-6,1,1,2,0,0,0,-3,3,0,-1,2,1,-3,3,0,0,-8,-17,-3,-1,4,3,0,-2,-1,-1,-1,1,5,-1
KR_6766895844,420,-1,36,13,-11,-2,4,2,1,3,4,-3,3,0,-4,5,1,-3,3,0,0,-12,0,-1,-3,4,-3,0,-1,-1,1,-1,-1,5,-1
KR_6745983816,420,0,-19,-16,0,5,1,6,1,2,3,-2,3,1,-4,5,1,0,0,0,0,-1,13,2,-6,4,3,0,0,1,-1,1,1,1,-1
KR_6700509277,420,0,-39,28,0,-2,4,2,2,4,6,4,0,4,-4,6,2,0,1,1,0,1,23,-6,-3,9,3,0,0,-1,-1,0,-1,4,-1
KR_6553840438,440,-4,22,4,-10,1,2,3,-4,8,4,-6,6,0,-2,2,0,1,0,1,0,-9,-50,3,-6,3,2,0,0,-1,1,1,1,3,-1
KR_6684568353,420,1,-9,14,-7,-1,1,0,0,2,2,2,0,2,-6,9,3,-2,4,2,0,-12,-1,1,-10,9,0,0,-1,1,-1,-1,1,2,-1
KR_6757556794,420,0,54,-3,-2,0,1,1,-3,5,2,-6,9,3,3,0,3,4,1,5,0,-1,3,-3,-3,6,0,0,1,-1,0,1,1,2,-1
KR_6765183641,420,-4,-11,-15,-3,-4,5,1,1,0,1,-3,7,4,-1,4,3,4,1,5,0,-2,-17,2,-5,3,-3,0,1,1,1,1,1,5,-1
KR_6716412465,420,-4,-15,-26,-2,-3,3,0,7,1,8,-1,2,1,-5,8,3,0,1,1,0,-4,2,1,-6,5,2,0,-2,1,-1,-1,1,1,-1
KR_6676440738,420,0,43,12,-4,1,0,1,0,2,2,-3,5,2,-2,2,0,0,2,2,0,-5,-11,-6,-3,9,3,0,0,1,-1,0,-1,2,-1
KR_6770501939,420,-5,-98,-1,-12,-1,2,1,-9,9,0,1,1,2,0,3,3,-3,4,1,0,-12,-6,1,-4,3,-7,0,-2,-1,-1,-1,1,1,-1
KR_6719592499,420,-1,-12,-8,0,-6,6,0,0,1,1,0,2,2,3,4,7,3,1,4,-1,-6,13,1,-5,4,-2,0,-1,1,-1,-1,-1,2,-1
KR_6762131688,420,2,28,-38,2,-3,5,2,4,2,6,-1,1,0,2,3,5,0,1,1,0,8,4,0,-2,2,0,0,-1,-1,-1,-1,1,2,-1
KR_6762424796,420,-2,-11,17,-9,-5,6,1,-5,6,1,4,1,5,-4,5,1,1,0,1,0,-11,32,2,-4,2,-11,0,-2,1,-1,-1,-1,1,-1
KR_6710623974,420,1,-29,12,-4,0,0,0,-5,7,2,0,1,1,-1,3,2,2,0,2,0,-4,3,0,-7,7,0,0,1,-1,1,-1,-1,3,-1
KR_6766895636,420,-2,-14,-20,-1,1,3,4,1,2,3,-2,5,3,0,0,0,-1,1,0,0,6,1,1,-6,5,0,0,-1,-1,-1,-1,1,4,-1
KR_6721042579,440,2,-18,12,1,-1,3,2,1,3,4,-2,3,1,3,2,5,0,3,3,0,-6,-6,2,-4,2,5,0,0,1,-1,-1,1,4,-1
KR_6770081033,420,-1,-45,24,-1,-1,2,1,-3,3,0,-2,3,1,3,0,3,2,0,2,0,3,7,5,-10,5,-4,0,0,1,-1,0,-1,3,-1
KR_6746469848,420,-1,25,6,-11,1,2,3,-3,3,0,-4,4,0,0,5,5,-5,5,0,-2,-28,-25,0,-7,7,4,0,1,-1,1,1,-1,5,-1
KR_6692166230,420,-1,-13,-9,-3,-5,6,1,2,3,5,0,1,1,3,2,5,-3,4,1,0,2,-6,-2,-4,6,3,0,-1,-1,1,-1,1,3,-1
KR_6425237688,420,-3,-82,-13,-7,-4,5,1,-3,5,2,-3,3,0,0,2,2,3,0,3,0,-9,30,4,-7,3,-3,0,-1,1,1,-1,1,5,-1
KR_6729758330,420,-5,-61,-3,-17,3,2,5,-6,7,1,-8,9,1,-4,6,2,-2,3,1,1,-8,1,-3,-3,6,0,0,0,1,-1,0,1,4,-1
KR_6719426215,420,-3,-50,-1,-8,0,1,1,-4,6,2,1,0,1,-5,5,0,0,1,1,0,0,-5,-8,-3,11,0,0,0,0,-1,0,-1,0,-1
KR_6759754402,420,-1,-49,-38,2,2,1,3,-2,4,2,0,1,1,-1,4,3,3,0,3,1,6,-52,0,-7,7,21,0,-2,-1,-1,-1,1,1,-1
KR_6755693646,440,1,-32,12,3,3,1,4,-1,1,0,0,2,2,3,2,5,-2,2,0,1,-1,9,5,-8,3,-1,0,1,-1,-1,1,1,6,-1
KR_6753864539,420,-2,17,-12,-3,0,0,0,3,1,4,0,1,1,-6,7,1,0,0,0,0,-4,-15,1,-6,5,-7,0,-1,-1,-1,-1,-1,2,-1
KR_6764239881,420,1,-21,28,6,4,0,4,0,1,1,-3,7,4,4,2,6,1,1,2,0,3,-2,0,-5,5,5,0,-1,1,-1,-1,-1,4,-1
KR_6768882476,420,0,-64,0,-1,4,0,4,-3,4,1,-2,4,2,-2,5,3,2,1,3,0,-11,115,-1,-6,7,0,0,0,0,1,-1,-1,0,-1
KR_6718540764,420,-3,-83,-6,-8,-1,3,2,0,1,1,1,0,1,-6,6,0,-2,3,1,0,-12,0,-2,-4,6,-6,0,-1,1,1,-1,-1,3,-1
KR_6648838723,420,-4,-106,-1,-17,-2,5,3,-9,12,3,2,5,7,-8,8,0,0,0,0,-3,-19,-11,-5,-5,10,-1,0,-3,-1,-1,-1,-1,2,-1
KR_6704515334,420,-1,-27,8,-5,1,2,3,-5,8,3,0,0,0,2,2,4,-3,3,0,-2,-18,-9,-1,-6,7,1,0,0,-1,1,0,-1,6,-1
KR_6753125652,420,1,-25,0,-3,-1,3,2,0,3,3,-1,4,3,-2,2,0,1,0,1,0,-4,17,-1,-2,3,-7,0,-1,1,-1,-1,-1,6,-1
KR_6744576942,420,0,49,-24,-7,1,0,1,-4,7,3,3,1,4,-3,3,0,-4,4,0,0,-16,-2,-1,-8,9,4,0,0,-1,-1,0,-1,5,-1
KR_6715718922,420,2,-31,33,7,0,2,2,2,0,2,3,2,5,2,2,4,0,0,0,0,14,18,2,-7,5,-2,0,2,1,1,1,1,5,-1
KR_6740810600,420,-2,6,45,-5,0,1,1,-1,3,2,-5,7,2,-2,4,2,3,0,3,0,-6,2,1,-5,4,-2,0,0,1,-1,-1,-1,6,-1
KR_6755773302,420,-2,-78,-9,-11,0,1,1,0,0,0,-5,7,2,-5,8,3,-1,1,0,-2,-14,-12,-1,-6,7,-3,0,0,-1,1,-1,-1,4,-1
KR_6768660160,420,-3,-96,0,-7,1,1,2,2,3,5,-3,3,0,-8,8,0,1,0,1,0,-12,11,1,-6,5,-3,0,-1,-1,-1,-1,-1,2,-1
KR_6770625648,420,-2,10,-16,-4,-3,6,3,-1,4,3,-2,2,0,3,1,4,-1,2,1,0,0,1,0,-6,6,3,0,0,1,-1,0,-1,5,-1
KR_6426158601,440,-2,-67,-36,2,1,2,3,-2,2,0,-2,4,2,5,1,6,0,2,2,0,2,-7,0,-5,5,2,0,-1,0,0,-1,1,0,-1
KR_6737576852,420,1,19,-28,0,-2,3,1,0,1,1,2,0,2,2,2,4,-2,2,0,0,1,13,-1,-6,7,-2,0,-1,1,-1,-1,-1,5,-1
KR_6768868621,420,-4,27,-36,-8,-1,1,0,-1,5,4,-4,4,0,0,1,1,-2,2,0,0,-3,-31,3,-8,5,-6,0,-1,-1,-1,-1,-1,2,-1
KR_6769772362,420,-2,-43,1,-4,2,0,2,2,0,2,-1,2,1,-5,5,0,-2,3,1,0,-5,-13,-5,-2,7,1,0,0,-1,1,0,1,6,-1
KR_6744529075,420,0,-17,26,-5,-5,7,2,2,2,4,2,2,4,-4,6,2,0,2,2,0,-6,13,-2,-4,6,0,0,0,-1,1,-1,-1,3,-1
KR_6760569076,440,-1,64,4,-6,-1,2,1,-5,5,0,-4,4,0,4,6,10,0,0,0,0,-1,-31,0,-2,2,0,0,0,1,-1,0,1,2,-1
KR_6763499926,420,2,25,11,0,-1,3,2,-2,3,1,-2,4,2,3,4,7,2,1,3,0,-5,125,0,-3,3,3,0,1,-1,1,1,-1,6,-1
KR_6751368390,420,0,0,35,2,-3,3,0,-5,6,1,5,1,6,0,4,4,5,1,6,0,0,-1,1,-8,7,2,0,0,1,1,0,-1,1,-1
KR_6740906644,420,-4,6,-37,-8,3,2,5,1,3,4,-4,5,1,-3,4,1,-5,5,0,0,-12,3,6,-14,8,5,0,-2,-1,1,-1,-1,2,-1
KR_6736090628,420,-4,-63,-31,-7,-3,4,1,-3,4,1,4,0,4,-3,6,3,-2,3,1,1,-6,-19,1,-4,3,5,0,-2,-1,1,-1,1,4,-1
KR_6766052427,420,-5,-8,-25,-6,-3,5,2,-3,5,2,-5,5,0,3,6,9,2,1,3,0,-1,-7,3,-8,5,0,0,-2,-1,-1,-1,-1,1,-1
KR_6770383395,420,-2,-64,-7,4,-1,1,0,3,1,4,1,2,3,-1,4,3,2,1,3,0,3,-1,0,-3,3,-5,0,1,1,1,1,1,3,-1
KR_6759235004,420,-1,-65,17,-5,-7,7,0,-1,6,5,1,0,1,-1,3,2,3,2,5,0,-3,-119,-4,-2,6,3,0,-1,0,-1,-1,-1,0,-1
KR_6757531661,420,-2,-12,7,-6,0,1,1,-1,3,2,0,4,4,-4,6,2,-1,1,0,1,-9,-2,0,-6,6,-2,0,0,-1,-1,-1,1,2,-1
KR_6679005125,420,-4,-41,-23,-6,1,1,2,0,3,3,-4,4,0,-1,5,4,-2,2,0,-1,-7,10,3,-8,5,-5,0,-1,-1,-1,-1,-1,2,-1
KR_6713047948,420,-1,-71,-16,-6,0,2,2,-1,3,2,-2,3,1,-4,5,1,1,2,3,0,-8,11,2,-7,5,0,0,-1,-1,1,-1,-1,5,-1
KR_6732726338,420,-4,-21,-31,-8,-1,1,0,0,1,1,-1,2,1,-6,7,1,0,0,0,0,-7,3,-1,-5,6,-6,0,-1,-1,-1,-1,-1,4,-1
KR_6732509827,440,-1,10,-19,-5,-1,4,3,-1,2,1,-1,5,4,-4,5,1,2,0,2,0,-5,8,3,-8,5,5,0,0,-1,1,1,-1,1,-1
KR_6735985398,440,-1,3,36,-5,-6,6,0,3,4,7,0,2,2,-2,3,1,0,0,0,-1,2,-2,4,-6,2,4,0,1,-1,-1,1,-1,1,-1
KR_6760587885,440,-5,-67,-9,-14,-2,3,1,-3,6,3,-2,6,4,-3,5,2,-4,9,5,0,-15,-67,2,-5,3,0,0,-2,-1,-1,-1,-1,2,-1
KR_6770962743,420,-2,-3,-2,-9,2,2,4,3,5,8,-5,5,0,-8,8,0,-1,2,1,0,-16,-2,-8,-3,11,1,0,0,-1,1,0,-1,4,-1
KR_6750136955,420,-3,-35,-18,-7,-3,3,0,-3,5,2,2,1,3,0,2,2,-3,4,1,0,-4,2,1,-6,5,-3,0,-1,-1,-1,-1,-1,3,-1
KR_6763232207,440,1,-76,21,-7,1,0,1,-2,4,2,-2,4,2,-1,5,4,-3,4,1,0,-15,-3,2,-5,3,-4,0,0,-1,-1,0,-1,4,-1
KR_6769274510,440,-6,-25,-41,-8,-2,2,0,-3,6,3,-2,2,0,0,4,4,-1,1,0,0,-6,0,2,-6,4,-5,0,-1,1,-1,-1,-1,5,-1
KR_6763262983,440,2,16,7,-2,0,2,2,-4,6,2,0,3,3,1,3,4,1,1,2,0,-2,19,5,-6,1,-1,0,0,0,-1,0,-1,0,-1
KR_6702621104,420,-1,23,11,-5,2,1,3,-7,9,2,2,1,3,-1,2,1,-1,1,0,-1,-16,3,0,-5,5,-3,0,1,1,1,1,-1,5,-1
KR_6766783008,420,0,-8,48,0,0,1,1,0,3,3,1,3,4,1,4,5,-2,4,2,0,-6,32,1,-6,5,-7,0,0,1,1,-1,1,6,-1
KR_6757113703,420,1,-4,11,1,2,2,4,3,2,5,2,0,2,-6,9,3,0,1,1,0,3,10,-1,-6,7,0,0,-1,1,1,-1,1,1,-1
KR_6767533979,440,2,33,16,1,-7,11,4,5,0,5,1,1,2,3,3,6,-1,1,0,-1,12,12,2,-4,2,-3,0,1,1,-1,-1,-1,4,-1
KR_6761794036,420,-6,-98,-4,-10,-5,5,0,-1,2,1,-8,9,1,2,4,6,2,3,5,0,-14,51,-3,-2,5,2,0,-2,-1,-1,-1,-1,6,-1
KR_6765466262,420,-5,-90,-11,-2,2,0,2,-2,4,2,4,2,6,-5,7,2,-1,2,1,0,-2,6,-1,-5,6,-3,0,-1,0,-1,-1,-1,0,-1
KR_6769237373,440,-3,-113,19,-16,-4,4,0,-2,5,3,-4,4,0,-5,5,0,-1,1,0,0,-12,-17,-4,0,4,-2,0,-1,-1,0,-1,-1,3,-1
KR_6768396133,440,1,-30,-16,-3,5,1,6,-1,5,4,0,3,3,-3,7,4,-4,4,0,-2,-5,14,-1,-7,8,-1,0,0,1,0,-1,-1,1,-1
KR_6735278619,420,-8,-29,-46,-15,1,1,2,-13,15,2,-2,4,2,-1,1,0,0,1,1,0,-17,-11,0,-6,6,4,0,0,-1,-1,-1,1,5,-1
KR_6702706434,420,1,3,1,8,2,1,3,3,2,5,-4,4,0,6,0,6,1,0,1,0,14,-36,0,-5,5,2,0,-1,1,-1,-1,1,6,-1
KR_6682234888,420,-4,-39,-35,-6,-2,5,3,0,1,1,-4,4,0,0,1,1,0,0,0,0,-4,-6,1,-7,6,2,0,-1,-1,-1,-1,-1,2,-1
KR_6691665269,420,-2,4,-4,-5,1,1,2,-4,5,1,-1,2,1,-2,4,2,1,0,1,0,-7,7,7,-9,2,-5,0,0,1,-1,0,-1,1,-1
KR_6762784087,440,1,-37,-4,1,0,0,0,0,1,1,-3,4,1,3,2,5,1,0,1,0,-7,30,-1,-6,7,2,0,1,0,0,1,1,0,-1
KR_6662447917,440,1,-13,-29,-2,-3,4,1,-2,4,2,-3,4,1,7,1,8,-1,1,0,0,-1,-3,2,-5,3,0,0,-2,-1,0,-1,1,1,-1
KR_6760336804,420,-1,-67,-20,-3,3,1,4,-4,6,2,-1,1,0,-1,3,2,0,1,1,0,0,-108,0,-4,4,-6,0,0,-1,0,-1,-1,5,-1
KR_6738749949,420,-2,49,-7,-7,1,1,2,-8,12,4,1,2,3,-1,2,1,0,1,1,0,-10,4,3,-6,3,-3,0,-1,-1,1,-1,1,3,-1
KR_6687914223,420,-1,13,-61,-1,1,1,2,2,1,3,-5,6,1,1,2,3,0,1,1,-1,5,-13,0,-4,4,3,0,0,0,-1,1,-1,0,-1
KR_6768375032,420,-4,38,-36,-5,0,2,2,0,2,2,-5,5,0,0,2,2,0,0,0,0,-8,8,-1,-3,4,3,0,1,-1,1,1,1,2,-1
KR_6757292548,420,-5,-43,-8,-15,-1,2,1,-4,5,1,3,2,5,-5,7,2,-8,11,3,-2,-26,-52,4,-6,2,0,0,1,-1,1,-1,-1,5,-1
KR_6759337449,440,1,61,-39,6,2,0,2,0,2,2,-4,9,5,7,2,9,1,0,1,4,15,1,1,-6,5,0,0,3,1,1,1,1,1,-1
KR_6677637906,440,2,33,30,7,6,1,7,3,1,4,3,1,4,-1,5,4,-4,8,4,1,1,-123,7,-8,1,-1,0,1,1,1,1,1,2,-1
KR_6754761232,420,-1,-4,-15,-3,-3,6,3,0,3,3,1,3,4,-2,2,0,1,1,2,0,-2,169,1,-5,4,1,0,0,-1,1,-1,-1,4,-1
KR_6644585457,420,1,-4,-1,4,1,1,2,-2,4,2,3,4,7,4,3,7,-2,2,0,0,9,1,-5,0,5,2,0,0,1,-1,1,1,1,-1
KR_6760063825,420,-4,-95,9,-7,-1,3,2,-1,6,5,-3,7,4,-1,3,2,-1,1,0,0,1,21,1,-6,5,-1,0,-1,-1,1,-1,1,2,-1
KR_6769321775,420,-3,-45,-4,-4,-2,4,2,-5,5,0,2,5,7,1,2,3,0,0,0,0,1,108,-3,-3,6,-1,0,0,0,-1,-1,1,0,-1
KR_6757397591,420,-4,-71,-19,-9,-3,3,0,-5,6,1,6,0,6,-5,7,2,-2,2,0,0,-12,-10,-5,-1,6,-1,0,-3,-1,-1,-1,-1,1,-1
KR_6769537156,420,-4,-49,-25,-5,3,0,3,1,3,4,-6,7,1,-1,2,1,-2,2,0,0,-4,-123,-2,-5,7,-4,0,0,-1,-1,0,1,5,-1
KR_6716813552,440,2,-22,-15,2,0,2,2,1,1,2,-2,3,1,4,4,8,-1,1,0,0,4,-3,-2,-1,3,4,0,-2,1,-1,-1,-1,5,-1
KR_6760769365,440,-5,14,-2,-5,3,1,4,-3,4,1,-1,2,1,-2,5,3,-2,2,0,0,-12,-10,-2,-2,4,-6,0,0,-1,1,-1,-1,3,-1
KR_6743646687,420,-1,-24,0,-3,-2,5,3,2,1,3,0,2,2,-2,5,3,-1,2,1,0,-5,-6,1,-5,4,0,0,0,-1,1,-1,1,6,-1
KR_6702445420,420,-2,-58,9,-6,2,1,3,0,1,1,-4,5,1,-4,7,3,0,0,0,0,-5,7,-1,-5,6,0,0,-1,1,1,-1,-1,3,-1
KR_6693445877,420,-2,-61,-10,-5,0,0,0,2,0,2,-3,3,0,-3,3,0,-1,4,3,0,-11,5,-1,-3,4,2,0,1,1,1,1,-1,2,-1
KR_6761691067,420,-4,-47,-4,-11,-3,3,0,-4,4,0,2,0,2,-5,7,2,-1,2,1,0,-17,-6,-2,-2,4,0,0,-2,-1,-1,-1,-1,3,-1
KR_6768058944,420,2,-7,20,8,3,0,3,4,1,5,1,1,2,-1,1,0,1,1,2,0,3,2,0,-4,4,-2,0,1,-1,1,1,-1,4,-1
KR_6770265520,440,-4,1,-33,-6,0,1,1,1,2,3,-3,9,6,-5,6,1,1,0,1,1,-3,34,0,-2,2,-16,0,0,0,0,-1,1,0,-1
KR_6747811612,420,-2,2,-24,-1,0,1,1,-1,2,1,-2,3,1,2,2,4,0,1,1,1,1,-7,0,-8,8,1,0,-1,-1,-1,-1,1,5,-1
KR_6753849313,420,3,33,8,6,0,1,1,4,4,8,0,1,1,-1,2,1,3,1,4,0,17,6,-1,-6,7,1,0,1,1,1,1,1,6,-1
KR_6768205463,440,-5,-55,-20,-9,0,1,1,1,0,1,-4,4,0,-5,5,0,-1,2,1,0,-8,-1,-2,-5,7,-3,0,-1,-1,-1,-1,-1,6,-1
KR_6758378755,440,-1,-24,-11,-6,-1,2,1,-3,6,3,-4,5,1,1,2,3,1,0,1,0,-2,3,-1,-3,4,-4,0,-1,0,0,-1,-1,0,-1
KR_6767837076,420,-6,-54,-10,-13,1,0,1,-7,8,1,-3,3,0,0,3,3,-4,4,0,0,-21,5,-9,-1,10,-3,0,-1,0,1,-1,-1,0,-1
KR_6751094367,420,-4,-11,-9,-2,-6,8,2,1,0,1,0,3,3,3,1,4,0,0,0,0,6,7,5,-8,3,1,0,-1,1,-1,-1,1,6,-1
KR_6762197249,420,3,-29,3,4,-2,2,0,0,1,1,3,0,3,3,0,3,0,1,1,1,6,-7,7,-11,4,-3,0,-1,1,-1,-1,1,5,-1
KR_6766663726,420,0,26,-29,-1,2,1,3,-3,4,1,2,0,2,-2,3,1,0,0,0,0,-5,-1,6,-7,1,0,0,0,-1,1,1,1,4,-1
KR_6725711918,420,-1,-40,15,-6,-2,3,1,-2,2,0,-1,5,4,0,1,1,-1,2,1,-1,-13,-21,-4,-2,6,3,0,0,-1,1,0,-1,6,-1
KR_6429839983,420,-1,-3,-36,-5,1,0,1,-1,6,5,-4,6,2,0,2,2,-1,1,0,0,-3,12,4,-9,5,-2,0,0,1,1,1,1,4,-1
KR_6754183735,420,-2,98,-26,-4,-1,2,1,-2,3,1,4,0,4,-3,5,2,-2,2,0,1,-8,44,4,-8,4,-24,0,0,1,-1,1,1,6,-1
KR_6758364372,420,-5,-55,14,-10,-3,3,0,-7,8,1,-1,2,1,0,1,1,1,0,1,0,-4,-7,-1,-7,8,1,0,0,-1,-1,-1,-1,5,-1
KR_6761316446,440,-4,-60,-16,-9,-1,2,1,0,1,1,-1,3,2,-6,7,1,-1,1,0,0,-14,13,1,-5,4,1,0,-1,-1,-1,-1,-1,5,-1
KR_6770934966,420,0,-40,-2,-3,-1,3,2,-2,5,3,0,1,1,1,2,3,-1,1,0,1,-2,-9,-3,-4,7,1,0,-2,-1,-1,-1,1,2,-1
KR_6760224156,420,0,9,12,5,0,2,2,-2,2,0,5,0,5,2,3,5,0,2,2,0,3,-3,0,-7,7,3,0,0,-1,1,0,-1,2,-1
KR_6764434966,420,-1,-7,12,-4,-3,4,1,-4,5,1,4,0,4,-2,5,3,1,2,3,0,-8,6,-2,-5,7,1,0,0,1,-1,-1,-1,1,-1
KR_6765189159,420,-1,-47,8,2,3,1,4,5,1,6,-4,7,3,0,0,0,-2,2,0,0,2,-5,-2,-3,5,2,0,-1,1,1,-1,-1,6,-1
KR_6758267227,420,3,48,-3,3,0,3,3,-2,3,1,3,3,6,2,2,4,0,1,1,0,-4,-1,0,-5,5,-1,0,3,0,-1,1,-1,0,-1
KR_6762627377,420,-1,-78,4,2,-3,4,1,4,1,5,1,0,1,0,0,0,0,1,1,0,5,37,-2,-6,8,-2,0,-1,1,-1,-1,1,3,-1
KR_6664364922,420,-1,-4,-9,2,-1,1,0,-1,4,3,2,2,4,3,2,5,-1,3,2,0,5,-12,0,-3,3,-2,0,0,1,0,0,1,2,-1
KR_6750238263,420,2,40,-1,2,0,1,1,-2,6,4,0,1,1,4,1,5,0,4,4,0,0,8,1,-7,6,1,0,0,1,1,0,-1,6,-1
KR_6757066923,420,-2,-34,-25,-1,-2,4,2,0,3,3,0,1,1,-1,6,5,2,1,3,-1,2,2,1,-5,4,-2,0,-3,-1,-1,-1,-1,5,-1
KR_6767560932,420,-3,-40,-2,-9,-2,2,0,0,2,2,-6,6,0,-1,1,0,0,0,0,0,-8,3,3,-5,2,1,0,-1,-1,-1,-1,1,6,-1
KR_6686535916,420,1,-10,23,3,0,1,1,6,1,7,-2,2,0,-2,6,4,1,1,2,0,-2,3,0,-6,6,-2,0,-1,-1,1,-1,1,6,-1
KR_6737356863,420,-1,-48,-11,5,0,0,0,0,3,3,0,5,5,5,2,7,0,0,0,0,2,-20,-2,-4,6,0,0,0,1,1,0,1,5,-1
KR_6764456760,420,-1,-55,4,-1,1,3,4,2,2,4,-2,4,2,-1,4,3,-1,1,0,0,0,2,5,-11,6,-3,0,0,1,1,-1,1,6,-1
KR_6760981601,420,-3,-46,-17,-4,-5,5,0,-2,3,1,-3,3,0,6,0,6,0,1,1,0,0,5,0,-6,6,3,0,-1,1,-1,-1,1,6,-1
KR_6770276599,420,-3,-88,-16,-4,0,3,3,1,2,3,1,4,5,-6,9,3,0,0,0,0,-1,6,4,-7,3,-5,0,-2,-1,-1,-1,1,5,-1
KR_6694031388,420,-1,-31,18,-8,-4,5,1,1,1,2,-3,4,1,1,1,2,-3,3,0,0,-2,-1,7,-9,2,0,0,1,1,-1,-1,1,3,-1
KR_6750933297,420,-2,24,5,-4,1,1,2,-1,1,0,1,0,1,-4,6,2,-1,3,2,0,-5,-2,-1,-5,6,0,0,-1,-1,-1,-1,-1,3,-1
KR_6756885070,420,0,70,1,-5,-4,5,1,0,2,2,-3,3,0,3,1,4,-1,2,1,1,-9,2,0,-8,8,2,0,0,1,1,0,1,1,-1
KR_6708208135,420,-2,-8,-16,-8,-2,3,1,1,3,4,1,0,1,-5,5,0,-3,4,1,0,-3,39,-2,-5,7,-17,0,1,-1,-1,1,-1,4,-1
KR_6742561070,440,-3,-46,-8,-4,7,1,8,-2,7,5,0,3,3,-7,11,4,-2,3,1,0,-4,19,0,-3,3,1,0,1,-1,1,-1,-1,3,-1
KR_6701144856,420,-1,-4,-24,0,-1,1,0,0,3,3,3,0,3,-2,5,3,0,1,1,0,6,21,3,-11,8,-1,0,1,-1,-1,1,-1,4,-1
KR_6746908102,420,-2,-20,-13,-4,-2,4,2,0,1,1,0,1,1,-4,5,1,2,0,2,0,0,-5,1,-5,4,1,0,-1,-1,1,-1,-1,1,-1
KR_6747330425,420,1,-5,-16,-1,3,0,3,-3,7,4,2,3,5,-3,3,0,0,2,2,0,-10,21,5,-11,6,2,0,2,1,1,1,1,6,-1
KR_6614885722,420,-4,-48,-26,-11,3,1,4,-7,7,0,-3,5,2,-5,5,0,1,1,2,0,-11,-109,1,-8,7,3,0,-2,-1,-1,-1,1,1,-1
KR_6758060716,420,4,1,8,5,3,1,4,0,1,1,2,2,4,0,1,1,0,0,0,0,6,-36,-6,-3,9,5,0,1,-1,-1,1,-1,3,-1
KR_6770444492,420,0,-60,-5,-3,-3,3,0,2,1,3,-1,1,0,-2,5,3,1,0,1,0,-7,-34,-4,-2,6,-1,0,-1,-1,1,-1,-1,1,-1
KR_6764401764,420,1,12,-18,1,-2,3,1,-6,7,1,6,2,8,0,3,3,3,1,4,-2,-2,3,2,-5,3,-4,0,0,-1,-1,-1,-1,5,-1
KR_6740162939,420,1,-14,16,-3,0,0,0,1,1,2,-2,5,3,-1,4,3,-1,2,1,0,-6,9,3,-7,4,-7,0,0,-1,1,0,-1,6,-1
KR_6762607870,420,0,-18,25,-5,0,1,1,1,5,6,-3,4,1,-4,5,1,1,1,2,0,-11,-29,-1,-5,6,0,0,1,0,-1,1,1,0,-1
KR_6757528396,420,-2,-17,21,-6,2,1,3,-1,3,2,-5,5,0,-1,4,3,-1,2,1,0,-5,-51,-3,-4,7,12,0,0,1,-1,-1,-1,1,-1
KR_6748372389,420,-3,-55,20,-6,0,1,1,-2,2,0,-5,6,1,4,1,5,-3,3,0,1,-11,-11,1,-6,5,0,0,0,-1,1,0,1,3,-1
KR_6768765058,420,0,-24,-7,1,5,1,6,4,1,5,-3,3,0,-6,6,0,1,2,3,-1,-4,10,-6,-4,10,2,0,1,-1,1,1,-1,1,-1
KR_6665458940,420,2,-46,36,3,-1,3,2,5,0,5,2,1,3,-1,3,2,-2,2,0,0,1,-95,-1,-7,8,1,0,-2,-1,-1,-1,1,3,-1
KR_6734062542,420,-1,-32,0,-4,-3,3,0,1,2,3,2,1,3,-5,6,1,1,0,1,-1,3,11,-1,-3,4,-1,0,1,-1,-1,1,-1,1,-1
KR_6766710239,420,1,-30,14,2,3,1,4,1,1,2,1,1,2,-2,3,1,-1,1,0,0,-3,7,5,-9,4,-1,0,0,-1,1,-1,1,2,-1
KR_6754108903,420,-4,-18,-3,-8,-1,2,1,-1,1,0,2,1,3,-7,9,2,-1,1,0,0,-1,10,2,-7,5,-2,0,-1,0,-1,-1,-1,0,-1
KR_6712745267,420,0,38,-7,-1,2,0,2,-2,3,1,1,2,3,-2,4,2,0,1,1,0,-7,-34,1,-9,8,-1,0,0,1,1,1,1,4,-1
KR_6758079886,420,0,-35,9,-5,-1,1,0,0,2,2,2,0,2,-7,9,2,1,1,2,0,-3,11,-1,-9,10,3,0,0,-1,1,0,-1,1,-1
KR_6768885930,420,2,-25,-15,2,0,5,5,2,0,2,0,5,5,-2,2,0,2,0,2,0,1,-97,-6,-4,10,-2,0,0,1,-1,-1,-1,6,-1
KR_6742595942,420,-1,1,0,-5,1,2,3,-4,7,3,0,2,2,-3,3,0,1,1,2,0,-2,-9,0,-5,5,-6,0,1,-1,-1,1,-1,1,-1
KR_6769789951,420,1,32,21,-2,2,0,2,-1,8,7,1,4,5,-5,8,3,1,1,2,2,-16,40,0,-7,7,-2,0,-1,-1,-1,-1,-1,4,-1
KR_6749186892,420,2,56,18,-3,2,0,2,1,3,4,-2,2,0,-3,3,0,-1,1,0,0,-11,141,3,-5,2,-2,0,1,-1,1,1,-1,1,-1
KR_6721809262,420,1,47,-19,5,1,1,2,2,0,2,1,2,3,1,3,4,0,3,3,0,5,-3,3,-8,5,3,0,1,1,-1,-1,-1,4,-1
KR_6712609891,420,-2,-37,4,-5,1,1,2,-2,4,2,-2,3,1,0,3,3,-2,3,1,0,-9,8,0,-5,5,-4,0,0,1,1,0,-1,5,-1
KR_6760192255,420,-4,-43,-29,-12,3,3,6,-4,6,2,-3,4,1,-2,4,2,-6,7,1,1,-7,-33,-6,-3,9,5,0,-1,-1,1,-1,1,5,-1
KR_6757137229,420,-4,-87,1,-5,-1,3,2,-4,4,0,0,2,2,0,3,3,0,3,3,0,1,-1,-2,-4,6,-1,0,-2,1,-1,-1,-1,6,-1
KR_6767843173,420,0,-5,-5,-3,-4,7,3,0,3,3,-3,5,2,1,2,3,3,0,3,0,-3,-16,0,-8,8,0,0,0,1,1,0,-1,5,-1
KR_6756931940,420,0,-37,19,-2,-2,6,4,3,4,7,0,2,2,-3,6,3,0,2,2,-1,1,-4,-2,-4,6,-3,0,1,-1,1,1,-1,1,-1
KR_6718458396,420,-2,50,-8,-12,1,4,5,0,1,1,-3,6,3,-8,9,1,-2,2,0,0,-15,8,3,-6,3,-2,0,2,-1,1,1,1,4,-1
KR_6724056757,420,3,-36,32,6,1,2,3,-1,6,5,4,0,4,2,2,4,0,1,1,0,-3,0,0,-6,6,2,0,0,1,-1,1,-1,6,-1
KR_6758404848,420,-4,-29,-8,-7,0,3,3,-5,10,5,2,2,4,2,1,3,-6,6,0,0,-10,-12,2,-6,4,-6,0,-1,-1,1,-1,1,2,-1
KR_6739245607,440,1,8,20,0,0,0,0,-4,5,1,3,3,6,2,1,3,-1,1,0,0,-5,0,0,-2,2,2,0,0,1,-1,0,1,1,-1
KR_6770184994,420,-3,-72,-24,-5,-1,3,2,0,1,1,-1,2,1,-3,4,1,0,0,0,0,-6,7,1,-7,6,0,0,-1,-1,-1,-1,1,6,-1
KR_6748262321,420,-1,-83,-13,-7,0,5,5,-3,4,1,0,1,1,-1,3,2,-3,3,0,0,-8,17,2,-6,4,-4,0,0,-1,1,-1,-1,1,-1
KR_6725041854,420,0,42,11,-4,-2,4,2,-2,3,1,-4,4,0,3,1,4,1,0,1,-1,-4,74,-3,-4,7,2,0,0,-1,1,1,-1,4,-1
KR_6765017525,420,0,-27,-8,6,0,4,4,-3,5,2,-1,1,0,3,2,5,7,0,7,0,9,5,0,-3,3,2,0,1,-1,1,1,1,1,-1
KR_6669675452,420,-3,-49,23,-6,2,2,4,-3,4,1,-6,6,0,2,3,5,-1,2,1,0,-2,6,3,-6,3,-1,0,-1,1,-1,-1,-1,3,-1
KR_6725148661,420,0,-28,-11,0,2,1,3,3,2,5,1,1,2,-4,5,1,-2,3,1,-2,0,18,-2,-6,8,0,0,1,-1,1,1,-1,1,-1
KR_6726523822,420,2,24,-28,1,2,1,3,-3,5,2,-1,2,1,0,0,0,3,0,3,0,2,-29,-3,-4,7,5,0,0,-1,0,0,1,1,-1
KR_6764392721,420,0,-54,-19,-6,-2,3,1,-3,5,2,2,3,5,-3,3,0,0,1,1,-2,-11,211,1,-5,4,-4,0,1,-1,1,1,-1,3,-1
KR_6758329572,440,-3,-19,-3,-5,-5,5,0,-3,6,3,-1,2,1,4,2,6,0,1,1,0,4,9,-3,-5,8,-3,0,-1,0,1,-1,1,0,-1
KR_6765982885,440,-5,-67,-40,-15,-3,3,0,-1,4,3,-5,5,0,-4,8,4,-2,2,0,0,-16,-16,0,-7,7,-4,0,-1,0,-1,-1,1,0,-1
KR_6764966152,420,-1,-8,-39,-9,-3,3,0,2,3,5,-1,4,3,-7,8,1,0,1,1,0,-10,-7,-2,-5,7,-2,0,-2,-1,-1,-1,-1,3,-1
KR_6673444271,420,-2,-42,-34,-7,1,1,2,-2,5,3,-4,5,1,1,1,2,-3,3,0,0,-11,-120,0,-6,6,1,0,-2,-1,-1,-1,1,5,-1
KR_6614074557,420,2,0,-24,6,-2,3,1,0,3,3,-1,3,2,10,1,11,-1,4,3,0,7,94,-1,-7,8,-5,0,-1,1,-1,-1,-1,2,-1
KR_6705374479,420,0,5,-4,0,2,0,2,1,1,2,-3,5,2,-2,5,3,2,1,3,0,-3,-43,-3,-2,5,17,0,0,0,1,0,-1,0,-1
KR_6746389612,420,2,16,-8,0,-1,2,1,-1,3,2,4,2,6,-1,2,1,-1,2,1,0,5,10,0,-6,6,3,0,1,-1,1,1,1,3,-1
KR_6770580883,420,-4,-43,-45,-2,-2,3,1,3,1,4,-2,2,0,0,1,1,-1,1,0,0,0,182,-1,-3,4,-3,0,0,1,1,-1,-1,4,-1
KR_6742262296,420,0,-64,-4,-6,0,3,3,-1,4,3,0,2,2,-2,3,1,-3,4,1,-1,-2,-6,3,-6,3,-2,0,0,-1,1,0,-1,2,-1
KR_6731459760,420,-2,46,-15,0,2,0,2,-2,2,0,2,1,3,-1,3,2,-1,1,0,0,-5,2,0,-5,5,-3,0,0,1,-1,-1,-1,3,-1
KR_6770465615,420,-3,-7,-3,-4,-2,4,2,3,1,4,-5,5,0,1,3,4,-1,2,1,0,6,-113,1,-8,7,-1,0,-1,1,-1,-1,-1,3,-1
KR_6569484660,420,-4,-43,-23,-6,-1,1,0,-6,8,2,0,3,3,2,2,4,-1,1,0,0,-11,36,5,-10,5,-18,0,-1,1,-1,-1,1,3,-1
KR_6749071074,420,-1,-70,3,3,-2,3,1,3,1,4,-3,6,3,4,3,7,1,0,1,0,6,35,3,-7,4,-1,0,0,1,-1,-1,1,5,-1
KR_6766676535,440,-4,-43,-8,-8,-5,7,2,0,4,4,3,1,4,-1,3,2,-5,5,0,0,-3,-6,2,-6,4,-1,0,-2,1,-1,-1,-1,6,-1
KR_6678489592,420,-2,-6,-1,-1,5,0,5,-2,4,2,0,1,1,-5,5,0,1,0,1,0,-10,2,1,-6,5,-6,0,-1,-1,-1,-1,-1,2,-1
KR_6758077044,420,-2,-36,-8,-10,-5,6,1,2,1,3,-4,5,1,-4,4,0,1,0,1,0,-7,2,-1,-5,6,0,0,-2,-1,0,-1,-1,5,-1
KR_6720546410,420,-7,-104,6,-23,-3,3,0,-5,5,0,-6,9,3,-8,8,0,-1,1,0,-1,-31,-2,-1,-3,4,-3,0,-2,-1,-1,-1,-1,4,-1
KR_6736086593,420,-5,-91,-16,-14,-2,2,0,1,5,6,-7,8,1,-1,3,2,-5,6,1,0,-3,-12,-4,-2,6,0,0,-2,-1,-1,-1,-1,5,-1
KR_6763707299,420,-3,-56,-34,-5,-3,4,1,1,1,2,-3,4,1,0,2,2,0,0,0,0,-2,7,0,-6,6,-6,0,-2,-1,-1,-1,-1,5,-1
KR_6758361713,420,-3,-29,-19,0,-5,6,1,1,2,3,3,1,4,2,4,6,-1,2,1,0,3,-2,-2,-2,4,6,0,-1,-1,1,-1,-1,2,-1
KR_6762715343,420,0,-39,-18,4,0,1,1,-2,3,1,2,1,3,3,1,4,1,3,4,0,11,-8,6,-10,4,1,0,1,1,-1,-1,-1,4,-1
KR_6764236215,440,1,68,8,-1,-1,2,1,1,2,3,-3,3,0,2,2,4,0,0,0,0,4,-4,-1,-6,7,6,0,0,-1,-1,0,1,4,-1
KR_6706594820,420,-3,-73,-17,1,-7,8,1,2,1,3,-2,5,3,3,2,5,5,2,7,-1,8,54,-1,-6,7,-22,0,0,-1,0,-1,-1,4,-1
KR_6686939697,420,-6,-39,-50,-17,-3,3,0,-3,3,0,0,5,5,-10,10,0,-1,1,0,0,-12,2,2,-5,3,-1,0,-1,-1,-1,-1,-1,4,-1
KR_6769412364,420,2,33,9,2,2,3,5,3,2,5,-1,3,2,-1,4,3,-1,2,1,0,2,11,-2,-4,6,-4,0,1,-1,1,1,-1,2,-1
KR_6746369750,420,-4,-26,-36,-2,0,2,2,-2,2,0,0,2,2,0,1,1,0,2,2,0,4,12,-3,-4,7,-3,0,0,-1,-1,0,-1,6,-1
KR_6735590650,420,-3,-16,20,-14,-3,4,1,-9,9,0,-4,8,4,3,0,3,-1,1,0,0,-16,11,-2,-4,6,-3,0,-1,1,-1,-1,-1,3,-1
KR_6639200614,420,-2,-54,-3,-6,1,1,2,-2,2,0,-1,3,2,-2,4,2,-2,3,1,0,-6,15,4,-12,8,-7,0,-1,-1,1,-1,1,4,-1
KR_6757262330,420,0,-69,-10,-1,-1,1,0,-3,4,1,1,1,2,0,2,2,2,2,4,0,-8,8,-2,-5,7,1,0,-1,1,-1,-1,-1,3,-1
KR_6761582055,440,-1,-30,9,2,-2,6,4,-6,6,0,7,0,7,6,2,8,-3,3,0,0,2,-256,0,-2,2,0,0,0,1,-1,0,-1,1,-1
KR_6753848160,420,0,-11,-12,4,1,1,2,1,3,4,5,1,6,0,2,2,-3,3,0,0,7,11,3,-6,3,0,0,-1,-1,1,-1,-1,3,-1
KR_6706759676,420,-1,33,-12,0,-1,2,1,0,2,2,3,1,4,-1,3,2,-1,2,1,1,-1,-110,5,-7,2,-6,0,0,0,-1,-1,1,0,-1
KR_6717293635,420,-1,5,-36,-4,5,0,5,-3,5,2,-3,6,3,-3,4,1,0,0,0,0,-5,3,-7,-3,10,-1,0,-2,-1,-1,-1,-1,2,-1
KR_6762439740,440,-2,3,-7,-7,2,2,4,-1,1,0,-4,5,1,-3,3,0,-1,2,1,0,-12,-2,-1,-4,5,-5,0,-1,-1,-1,-1,-1,3,-1
KR_6607836940,420,-3,-11,0,-9,-1,1,0,-3,6,3,-1,1,0,-3,4,1,-1,3,2,0,-4,-5,-1,-4,5,-5,0,0,-1,-1,0,-1,1,-1
KR_6737185604,440,1,-54,-8,-5,1,0,1,0,4,4,-1,2,1,-4,5,1,-1,3,2,0,-6,-35,-1,-6,7,-1,0,0,-1,1,0,-1,5,-1
KR_6767357632,440,-6,-88,11,-11,-3,4,1,0,5,5,-3,4,1,-5,6,1,0,2,2,0,-12,433,-3,-1,4,-17,0,0,1,0,-1,-1,5,-1
KR_6684715774,420,-8,-78,-48,-19,-7,7,0,-7,8,1,-3,3,0,-2,3,1,0,1,1,0,-15,-11,-11,-2,13,-3,0,-2,-1,1,-1,-1,6,-1
KR_6761825786,440,-5,-46,-5,-11,1,4,5,0,2,2,-8,8,0,-2,3,1,-2,4,2,1,-5,-9,-3,-4,7,-4,0,-1,-1,-1,-1,1,1,-1
KR_6744543009,420,-1,7,-13,-6,0,1,1,-3,5,2,-1,2,1,-2,2,0,0,0,0,0,-8,-8,-3,-6,9,-2,0,0,-1,-1,0,-1,3,-1
KR_6630478450,420,0,44,-5,-7,2,1,3,-2,4,2,3,1,4,-6,9,3,-4,4,0,0,-13,5,2,-5,3,1,0,-1,1,-1,-1,-1,1,-1
KR_6751366251,420,-4,-2,-31,-11,-2,5,3,0,3,3,-1,3,2,-10,12,2,2,1,3,0,-7,-11,3,-5,2,-1,0,-1,1,-1,-1,1,3,-1
KR_6507012176,440,-4,-59,-20,-4,2,1,3,2,0,2,-5,5,0,-2,4,2,-1,1,0,-1,-5,-5,5,-8,3,-3,0,1,-1,1,1,-1,6,-1
KR_6740443823,440,-5,-28,9,-19,-4,6,2,-4,5,1,-2,2,0,-4,5,1,-5,7,2,1,-26,1,1,-7,6,-3,0,-2,1,-1,-1,1,4,-1
KR_6770322117,420,1,-9,0,-2,5,1,6,-1,3,2,-3,4,1,2,1,3,-5,5,0,0,-4,-51,0,-7,7,28,0,0,-1,1,1,1,6,-1
KR_6762539062,420,0,-6,16,-2,-2,3,1,-1,3,2,0,3,3,4,1,5,-3,3,0,0,-2,11,-2,-7,9,-1,0,0,1,0,0,-1,5,-1
KR_6728509269,420,-4,-49,2,-3,-3,4,1,4,0,4,2,2,4,-4,4,0,-2,2,0,1,2,34,-2,-6,8,-21,0,-1,1,-1,-1,1,2,-1
KR_6722204895,420,0,-33,-8,-6,-1,1,0,-4,5,1,-2,6,4,1,1,2,0,0,0,0,-5,36,3,-6,3,-30,0,-1,0,-1,-1,-1,0,-1
KR_6750916013,420,1,24,12,0,3,0,3,1,0,1,-2,2,0,-1,2,1,-1,1,0,0,-3,-5,1,-7,6,2,0,0,-1,-1,0,1,6,-1
KR_6715929428,420,-3,-17,-7,-5,-2,2,0,-3,3,0,0,0,0,1,1,2,-1,1,0,0,-3,8,1,-9,8,-1,0,0,1,1,0,-1,2,-1
KR_6642826513,420,-2,-80,4,-9,-1,3,2,-3,4,1,-4,5,1,-3,4,1,2,0,2,0,-6,18,3,-8,5,-4,0,0,-1,-1,-1,-1,1,-1
KR_6768719087,420,2,-14,27,3,-2,6,4,2,2,4,3,1,4,1,3,4,-1,2,1,2,4,0,0,-4,4,4,0,-2,1,-1,-1,-1,6,-1
KR_6705643033,420,-4,-6,-24,-8,-6,7,1,2,1,3,-6,6,0,5,0,5,-3,3,0,1,-6,4,-2,-4,6,-3,0,-1,0,-1,-1,1,0,-1
KR_6696088873,420,1,-18,-19,-2,0,1,1,0,4,4,0,2,2,-3,5,2,1,0,1,0,2,-7,-4,-5,9,2,0,0,-1,-1,-1,1,6,-1
KR_6754369511,420,-1,21,-9,-1,-6,6,0,0,2,2,4,2,6,1,3,4,0,0,0,0,1,14,-1,-7,8,3,0,-2,1,-1,-1,1,6,-1
KR_6749349987,420,1,-24,2,-2,-1,3,2,0,2,2,-4,5,1,2,1,3,1,0,1,0,0,1,3,-10,7,-2,0,-1,-1,-1,-1,-1,3,-1
KR_6770345102,420,-2,-6,4,-6,-2,3,1,-1,2,1,-2,2,0,0,3,3,-1,1,0,0,-9,118,0,-4,4,1,0,0,-1,-1,0,-1,4,-1
KR_6644094112,420,-2,-32,-28,-11,-4,4,0,0,1,1,-5,5,0,-2,4,2,0,0,0,0,-9,0,0,-5,5,-6,0,0,-1,-1,0,-1,6,-1
KR_6666220792,420,-4,-86,-28,-8,-2,2,0,-5,5,0,2,1,3,-3,4,1,0,1,1,0,-12,-4,-6,-3,9,-3,0,-1,-1,-1,-1,1,5,-1
KR_6766865787,420,-3,-61,-27,-10,-2,5,3,-1,4,3,-2,3,1,-2,7,5,-3,4,1,1,-12,-11,-2,-5,7,4,0,0,-1,1,-1,1,4,-1
KR_6667043819,420,0,-79,19,2,-2,2,0,-1,2,1,7,0,7,1,1,2,-3,4,1,0,7,-45,-1,-4,5,12,0,-2,1,-1,-1,-1,3,-1
KR_6744619178,420,-3,-16,-4,-4,-6,7,1,0,3,3,-1,4,3,3,3,6,0,2,2,0,-8,-1,-6,-2,8,-4,0,0,1,-1,0,1,5,-1
KR_6694055359,420,-1,-23,11,-3,-1,1,0,-2,4,2,-1,3,2,2,1,3,-1,2,1,0,1,-109,2,-10,8,-1,0,0,-1,1,1,1,3,-1
KR_6759177715,420,-3,-43,-12,-3,-3,3,0,-3,5,2,3,1,4,-1,1,0,1,0,1,0,2,11,-1,-1,2,4,0,-1,-1,1,-1,1,2,-1
KR_6481976055,420,-3,-59,20,-5,-3,3,0,-1,5,4,1,1,2,0,3,3,-2,3,1,0,0,17,-2,-7,9,8,0,0,1,-1,-1,-1,5,-1
KR_6731274682,420,-7,-96,-104,-5,-2,2,0,0,0,0,1,1,2,-3,4,1,-1,1,0,0,-5,-21,-2,-2,4,-3,0,-3,-1,-1,-1,-1,5,-1
KR_6760664649,440,1,65,3,1,0,2,2,-3,5,2,-1,1,0,4,2,6,1,3,4,0,-11,85,0,-5,5,-2,0,0,-1,-1,0,-1,6,-1
KR_6724350348,440,3,-22,46,1,2,0,2,4,0,4,2,0,2,2,2,4,-9,9,0,0,-3,3,1,-5,4,0,0,0,1,-1,0,-1,6,-1
KR_6748940975,440,-6,-88,7,-10,-1,1,0,0,2,2,-3,4,1,-8,8,0,2,1,3,0,-10,13,3,-5,2,-6,0,-1,1,-1,-1,-1,6,-1
KR_6670906892,440,-4,-91,15,7,0,4,4,11,0,11,1,4,5,-6,7,1,1,1,2,0,12,-7,-2,0,2,1,0,-2,1,-1,-1,1,2,-1
KR_6770076489,420,-1,-12,-13,-4,1,1,2,-1,11,10,0,1,1,-4,6,2,0,0,0,0,-10,-49,-6,-2,8,-2,0,0,-1,-1,0,-1,4,-1
KR_6650215712,420,-7,-70,-36,-14,-1,2,1,-1,4,3,-6,7,1,-5,6,1,-1,2,1,0,-13,-2,-2,-3,5,2,0,-2,-1,-1,-1,-1,6,-1
KR_6760494453,440,3,-8,5,7,0,1,1,5,1,6,2,1,3,1,2,3,-1,1,0,0,8,13,3,-6,3,-8,0,0,-1,1,0,1,6,-1
KR_6672366447,420,-5,-23,-17,-11,-3,3,0,-2,3,1,-4,4,0,-1,3,2,-1,2,1,0,-10,-8,-1,-6,7,0,0,-1,-1,1,-1,1,3,-1
KR_6745121680,420,-1,27,6,-2,0,3,3,-2,2,0,2,1,3,-2,3,1,0,0,0,0,-2,113,-3,-6,9,3,0,0,1,-1,0,1,3,-1
KR_6764745908,420,-1,-55,4,0,-2,3,1,2,3,5,2,0,2,-2,2,0,0,0,0,0,5,-8,-1,-4,5,1,0,0,1,-1,-1,-1,1,-1
KR_6768471937,420,-1,15,-16,-7,-5,5,0,-1,2,1,-2,6,4,0,2,2,1,1,2,0,-8,-5,-4,-5,9,-3,0,-1,-1,-1,-1,-1,4,-1
KR_6763899515,420,-1,-17,-3,-1,-2,3,1,2,3,5,-3,5,2,0,2,2,2,0,2,-1,6,-260,-1,-5,6,-5,0,0,-1,-1,0,-1,3,-1
KR_6767509767,440,-3,19,-21,-5,6,0,6,-4,6,2,-6,7,1,-2,3,1,1,0,1,0,-4,12,3,-9,6,-7,0,0,-1,1,1,1,4,-1
KR_6704492225,420,-3,-44,-18,-2,-3,3,0,-1,2,1,0,2,2,-1,1,0,3,0,3,0,0,32,-3,-3,6,-6,0,-1,1,-1,-1,-1,5,-1
KR_6638330787,420,-4,42,-3,-11,0,2,2,-6,6,0,-3,3,0,-2,2,0,0,2,2,0,-14,-123,1,-9,8,-8,0,-2,-1,-1,-1,-1,3,-1
KR_6735678789,420,0,-44,27,-6,1,3,4,-2,4,2,2,4,6,-6,6,0,-1,2,1,1,-9,-5,-1,-2,3,3,0,-1,-1,1,1,1,5,-1
KR_6769518608,420,-4,-3,-28,-9,0,1,1,-2,3,1,-4,4,0,-2,3,1,-1,2,1,0,-6,14,0,-2,2,-5,0,0,-1,-1,0,-1,1,-1
KR_6722973618,420,-1,-64,-13,-7,-2,3,1,0,3,3,-1,4,3,-4,5,1,0,2,2,0,-11,15,1,-6,5,-6,0,-1,-1,-1,-1,-1,6,-1
KR_6759712099,420,1,-73,-2,1,6,1,7,1,2,3,-5,5,0,0,2,2,-1,1,0,0,-1,-58,-1,-5,6,29,0,-1,1,1,-1,-1,1,-1
KR_6721094786,420,1,84,27,1,3,1,4,0,2,2,1,3,4,-2,3,1,-1,2,1,1,2,-4,0,-5,5,0,0,0,0,1,1,1,0,-1
KR_6764766803,440,-1,19,-12,-11,0,3,3,-8,11,3,7,2,9,-10,13,3,0,2,2,-2,-21,15,1,-6,5,0,0,1,1,0,1,-1,1,-1
KR_6700267829,420,-1,-28,12,-8,-1,3,2,-2,4,2,-1,2,1,-4,4,0,0,2,2,0,-8,4,-8,-3,11,6,0,0,0,-1,0,1,0,-1
KR_6754055692,420,-3,-80,-4,-6,-1,3,2,-5,7,2,0,2,2,-1,2,1,1,0,1,0,-7,-106,1,-5,4,1,0,0,-1,1,-1,-1,5,-1
KR_6680823422,420,0,28,-12,-6,1,0,1,-4,6,2,-1,3,2,0,3,3,-2,2,0,0,-4,-9,-2,-2,4,1,0,-2,-1,-1,-1,-1,1,-1
KR_6764901832,420,-1,31,40,3,-1,1,0,1,3,4,0,4,4,4,4,8,-1,3,2,0,7,-18,1,-7,6,0,0,0,-1,-1,-1,-1,1,-1
KR_6764298485,420,-2,-47,-23,-4,-3,4,1,-3,3,0,0,2,2,2,2,4,0,1,1,0,2,4,3,-5,2,1,0,-2,1,-1,-1,-1,1,-1
KR_6767403490,440,3,40,12,7,-3,3,0,4,0,4,2,1,3,-1,4,3,5,3,8,0,3,-8,-3,-3,6,3,0,1,1,1,1,1,6,-1
KR_6677430282,420,-5,-54,-8,-5,1,0,1,6,2,8,-7,7,0,-3,4,1,-2,2,0,0,-11,-6,0,-6,6,0,0,-2,-1,-1,-1,-1,5,-1
KR_6688710760,420,1,-28,32,3,-2,3,1,3,1,4,-4,5,1,4,2,6,2,1,3,1,12,19,-2,-6,8,-4,0,-1,-1,1,-1,1,5,-1
KR_6750267552,420,-5,-123,16,-16,-1,4,3,-7,7,0,-6,7,1,0,4,4,-2,2,0,-4,-27,14,-6,-2,8,1,0,-1,0,-1,-1,-1,0,-1
KR_6715073986,420,-1,5,0,0,5,2,7,-3,4,1,0,3,3,1,4,5,-3,5,2,0,3,5,2,-5,3,0,0,1,-1,-1,-1,-1,5,-1
KR_6741338575,440,1,-34,7,3,-3,5,2,4,1,5,1,0,1,0,3,3,1,1,2,1,10,21,0,-7,7,2,0,0,1,1,1,1,5,-1
KR_6769372582,420,-1,8,-20,-6,2,2,4,-5,5,0,-5,6,1,2,2,4,0,0,0,0,-4,-13,0,-3,3,0,0,-1,-1,-1,-1,-1,1,-1
KR_6770671367,420,-2,-16,20,-6,-1,2,1,-3,4,1,-1,6,5,0,1,1,-1,1,0,0,-3,262,-1,-4,5,2,0,0,0,1,0,-1,0,-1
KR_6770683730,420,-4,-60,17,-7,-1,2,1,3,0,3,-3,3,0,-4,6,2,-2,2,0,2,-4,22,3,-6,3,-4,0,-1,1,0,-1,1,1,-1
KR_6769643537,420,-1,-21,12,1,1,0,1,-2,3,1,0,2,2,-3,4,1,5,0,5,1,0,-2,3,-4,1,3,0,0,1,1,0,1,1,-1
KR_6667395929,420,-1,-11,-20,-4,-1,1,0,-4,5,1,2,0,2,1,0,1,-2,4,2,0,-5,-9,3,-6,3,0,0,0,1,1,-1,1,5,-1
KR_6738671450,440,-2,-58,19,-10,1,0,1,-4,6,2,-1,4,3,-1,1,0,-5,5,0,0,-12,-3,-1,-4,5,1,0,0,-1,1,-1,-1,3,-1
KR_6763456378,420,0,-49,-22,-1,2,0,2,4,3,7,0,4,4,-7,9,2,0,0,0,0,4,-26,-1,-3,4,-1,0,0,-1,-1,0,1,5,-1
KR_6766810009,420,1,-8,5,2,7,1,8,-7,8,1,4,0,4,-2,3,1,0,0,0,0,-1,9,1,-4,3,0,0,1,-1,1,1,1,2,-1
KR_6718749599,420,-1,-29,8,-6,-1,1,0,-3,5,2,5,2,7,-6,8,2,-1,1,0,0,-5,-9,1,-8,7,1,0,0,1,-1,1,-1,3,-1
KR_6745294636,440,0,-12,13,0,0,1,1,-4,5,1,1,2,3,4,2,6,-1,2,1,1,5,17,0,-8,8,6,0,1,-1,1,1,1,2,-1
KR_6738285088,420,-1,-22,-4,-7,-1,2,1,-1,3,2,-2,4,2,1,2,3,-4,5,1,0,-5,2,1,-4,3,4,0,0,-1,0,0,-1,1,-1
KR_6766990145,420,-1,7,-30,-1,1,2,3,1,2,3,-1,1,0,-1,2,1,-1,1,0,0,-7,-54,-2,-4,6,2,0,0,1,1,-1,-1,5,-1
KR_6707794488,420,-8,-94,24,-21,-8,8,0,-5,9,4,-6,7,1,-3,4,1,1,0,1,0,-23,-2,-3,-7,10,-2,0,-1,1,1,-1,-1,3,-1
KR_6764376098,420,-2,-73,8,-6,0,0,0,-6,6,0,3,1,4,-3,3,0,0,0,0,-1,-16,-132,-3,-2,5,1,0,-1,-1,1,-1,-1,4,-1
KR_6760410098,420,1,23,50,6,3,0,3,4,1,5,0,1,1,-1,2,1,0,0,0,1,3,21,-3,-3,6,0,0,1,0,0,1,1,0,-1
KR_6767074366,420,0,-53,12,-5,-3,3,0,-1,3,2,4,0,4,-3,7,4,-2,3,1,0,-9,109,2,-6,4,-3,0,0,-1,-1,0,1,1,-1
KR_6732546631,420,1,29,11,-2,0,1,1,0,2,2,-5,7,2,3,1,4,0,0,0,0,-3,4,1,-7,6,0,0,-1,-1,-1,-1,-1,4,-1
KR_6733593003,420,2,28,23,-5,0,0,0,2,2,4,-4,4,0,-1,4,3,-2,4,2,1,-9,-13,-6,-3,9,4,0,-2,1,-1,-1,1,4,-1
KR_6763131654,420,1,60,-10,-1,3,3,6,-5,5,0,-2,3,1,3,1,4,0,0,0,0,-4,-7,-1,-6,7,-4,0,0,-1,-1,-1,1,4,-1
KR_6729645852,420,1,16,-8,-3,0,1,1,-2,4,2,0,0,0,-1,3,2,0,2,2,0,2,3,0,-10,10,-1,0,-1,-1,1,-1,-1,6,-1
KR_6741734287,440,1,-101,-14,3,-1,2,1,-1,3,2,4,1,5,-2,5,3,3,0,3,0,11,1,-1,-5,6,-2,0,-1,-1,0,-1,1,6,-1
KR_6671810379,420,-2,-20,-12,-6,-2,2,0,-1,6,5,0,0,0,-4,4,0,1,0,1,0,-8,-26,0,-4,4,-6,0,-1,-1,-1,-1,1,4,-1
KR_6727129542,420,4,-2,22,12,7,0,7,1,4,5,2,1,3,-2,3,1,4,0,4,-1,7,7,2,-7,5,-6,0,1,1,-1,1,-1,5,-1
KR_6768092327,420,-3,-40,-27,0,5,1,6,-1,2,1,3,1,4,-2,6,4,-5,7,2,0,0,-42,-1,-5,6,26,0,-1,1,1,-1,-1,4,-1
KR_6740935761,420,-1,-12,28,-9,0,2,2,-4,4,0,0,1,1,-3,4,1,-2,2,0,-1,-15,-2,-1,-5,6,-3,0,-1,-1,1,-1,-1,6,-1
KR_6767388568,440,-2,-48,-26,1,-4,6,2,3,1,4,5,0,5,-1,4,3,-2,2,0,0,10,6,3,-7,4,0,0,2,1,1,1,-1,3,-1
KR_6694125389,420,-4,-103,-11,-9,-2,3,1,-6,9,3,0,1,1,1,4,5,-2,2,0,0,-10,1,-1,-3,4,-4,0,-1,-1,1,-1,1,2,-1
KR_6765320590,420,1,10,4,2,-1,2,1,1,0,1,-1,2,1,0,6,6,3,0,3,0,7,0,-1,-6,7,-2,0,1,-1,-1,1,-1,5,-1
KR_6761946552,420,-4,-25,2,-6,-3,5,2,-3,4,1,-1,5,4,2,1,3,-1,1,0,0,-2,-203,-1,-5,6,4,0,-2,-1,1,-1,1,3,-1
KR_6768890134,420,-4,24,-43,-6,-1,4,3,0,5,5,-1,1,0,2,1,3,-6,6,0,0,0,3,-2,-2,4,1,0,0,-1,-1,-1,-1,2,-1
KR_6701461087,420,-2,-11,4,-2,1,2,3,2,3,5,-6,6,0,1,1,2,0,1,1,0,0,-5,0,-2,2,2,0,-1,-1,-1,-1,1,4,-1
KR_6761710023,420,-3,-24,-17,-8,4,1,5,2,3,5,-4,5,1,-10,10,0,0,0,0,0,-14,6,-6,-4,10,1,0,0,-1,1,-1,-1,1,-1
KR_6763088547,440,0,-2,20,6,5,0,5,0,1,1,-6,9,3,4,1,5,3,3,6,2,2,-7,-3,-3,6,3,0,2,1,1,1,1,5,-1
KR_6624557703,420,-1,-3,1,-7,-4,6,2,0,3,3,-2,2,0,-2,4,2,1,0,1,0,-4,5,-1,-7,8,-3,0,0,-1,-1,0,-1,1,-1
KR_6769445220,420,-2,-24,-19,-7,-2,2,0,-1,5,4,-3,3,0,-2,5,3,1,2,3,0,-20,-4,-2,-3,5,2,0,-2,-1,1,-1,1,3,-1
KR_6718934060,420,2,51,-11,9,2,2,4,-2,4,2,1,2,3,4,0,4,4,1,5,1,12,9,1,-3,2,1,0,1,1,-1,1,1,6,-1
KR_6747351949,440,1,-20,17,2,1,1,2,2,3,5,0,0,0,-1,4,3,0,0,0,0,-1,27,0,-4,4,2,0,0,-1,-1,0,1,1,-1
KR_6659756432,420,-8,-107,-15,-8,-3,3,0,-1,1,0,-2,4,2,-2,2,0,0,0,0,0,-6,15,-2,-2,4,-2,0,-4,-1,-1,-1,-1,4,-1
KR_6743259456,420,1,-13,-36,-3,-1,1,0,3,2,5,-3,3,0,-1,2,1,-1,1,0,-2,-4,8,4,-6,2,-7,0,-2,1,-1,-1,-1,6,-1
KR_6755055606,420,-4,-54,-40,-17,-4,5,1,-3,4,1,-4,6,2,-11,12,1,5,0,5,-2,-14,16,-3,-3,6,-2,0,-1,-1,-1,-1,-1,3,-1
KR_6689939958,420,1,3,-15,5,-1,1,0,2,3,5,-2,2,0,3,1,4,3,0,3,0,11,-11,-3,-4,7,5,0,0,-1,-1,1,1,1,-1
KR_6720755024,440,0,-88,0,0,-3,3,0,1,1,2,-2,3,1,3,0,3,1,0,1,0,9,7,-2,-5,7,0,0,0,-1,1,0,-1,1,-1
KR_6759512766,420,-5,-9,-28,-12,-3,4,1,0,1,1,-7,7,0,0,1,1,-2,2,0,0,-4,26,7,-8,1,-4,0,-1,-1,-1,-1,-1,6,-1
KR_6757046565,420,-5,1,-13,-10,-5,5,0,0,0,0,-3,3,0,-1,4,3,-1,1,0,0,-9,-11,-1,-2,3,-2,0,-1,-1,-1,-1,-1,3,-1
KR_6742891203,420,-4,-43,-29,-8,-1,1,0,-5,6,1,-3,4,1,3,4,7,-2,2,0,0,-3,-33,0,-5,5,-4,0,-2,-1,-1,-1,1,3,-1
KR_6765579224,420,-4,-63,-7,-8,0,4,4,0,4,4,-4,4,0,-4,6,2,0,3,3,0,-7,-7,-5,-4,9,1,0,-1,1,1,-1,1,1,-1
KR_6759993482,420,-7,-136,-22,-16,-1,2,1,-3,3,0,-6,7,1,-4,5,1,-2,3,1,0,-6,-8,-4,-4,8,2,0,-3,-1,-1,-1,1,4,-1
KR_6759538981,420,-4,-23,-46,-2,-1,1,0,4,0,4,1,3,4,-4,7,3,-2,3,1,-1,3,20,6,-12,6,-1,0,0,-1,1,1,-1,2,-1
KR_6709873540,420,0,4,-28,-2,3,1,4,1,3,4,-1,4,3,-2,4,2,-3,3,0,0,-1,-10,-5,-6,11,0,0,0,-1,1,1,-1,3,-1
KR_6768468853,420,1,-46,-34,6,2,3,5,3,2,5,-2,6,4,4,2,6,-1,1,0,0,9,8,3,-6,3,6,0,0,-1,-1,-1,-1,5,-1
KR_6727872128,420,0,-17,-17,2,3,0,3,-1,5,4,-5,6,1,2,0,2,3,0,3,1,-1,0,4,-8,4,3,0,0,-1,0,0,1,5,-1
KR_6747724401,440,-1,-98,4,2,2,1,3,-1,2,1,0,4,4,1,0,1,0,0,0,0,7,-4,4,-8,4,-2,0,-1,1,-1,-1,-1,2,-1
KR_6762965592,440,1,33,5,-1,-1,3,2,2,1,3,0,8,8,-1,4,3,-1,1,0,2,-6,30,-1,-8,9,4,0,1,0,-1,1,-1,0,-1
KR_6761140015,440,-4,-56,-14,-11,-1,4,3,-2,3,1,2,1,3,-7,8,1,-3,5,2,0,-15,15,8,-9,1,-5,0,-1,-1,-1,-1,-1,3,-1
KR_6715988967,420,-3,-71,-13,-9,-2,3,1,-4,6,2,-1,4,3,0,3,3,-2,2,0,0,-5,-32,-2,-4,6,-8,0,-1,-1,-1,-1,-1,5,-1
KR_6765230807,440,-1,65,-10,-2,2,1,3,0,5,5,1,0,1,-1,2,1,-4,4,0,0,-7,-3,0,-7,7,2,0,-1,-1,0,1,1,6,-1
KR_6762033743,420,0,-32,-43,5,5,0,5,1,1,2,-2,5,3,1,1,2,0,0,0,0,2,-235,2,-8,6,0,0,0,1,-1,1,1,1,-1
KR_6710554004,420,-1,-100,5,-8,-2,3,1,-3,6,3,-1,3,2,-1,3,2,-1,2,1,0,-3,103,-3,-1,4,-2,0,-1,-1,1,-1,-1,1,-1
KR_6683155468,420,-4,-86,-37,-6,-3,4,1,-4,5,1,-2,3,1,2,0,2,1,1,2,0,1,-3,-2,-3,5,-2,0,-1,-1,-1,-1,-1,2,-1
KR_6649484236,420,0,-36,-24,-1,-1,1,0,0,1,1,1,1,2,-1,3,2,0,0,0,0,-5,-2,0,-5,5,-4,0,0,-1,-1,-1,-1,6,-1
KR_6697011414,420,-1,-51,5,-5,1,3,4,-1,4,3,-2,2,0,-1,3,2,-2,2,0,0,-10,27,0,-5,5,-32,0,-1,-1,-1,-1,1,6,-1
KR_6751238551,420,-1,-65,11,-4,0,1,1,-3,3,0,0,3,3,-1,2,1,0,0,0,0,-7,-239,-2,-3,5,1,0,-1,1,-1,-1,-1,1,-1
KR_6649999057,420,-5,-66,2,-10,-2,2,0,-5,6,1,-2,3,1,-3,4,1,2,0,2,0,-7,-22,-4,-1,5,0,0,-2,1,-1,-1,-1,6,-1
KR_6759807680,420,-1,-9,-23,-8,0,4,4,-7,10,3,-2,6,4,0,6,6,1,2,3,2,-11,350,0,-6,6,-2,0,0,-1,1,-1,1,5,-1
KR_6754929288,420,-3,-17,-32,-4,-10,10,0,4,3,7,3,2,5,1,0,1,-2,2,0,-1,-7,20,4,-4,0,0,0,-2,-1,-1,-1,-1,5,-1
KR_6768548597,420,-1,-91,20,0,-2,2,0,1,6,7,0,3,3,2,2,4,-1,1,0,-1,0,4,-3,-5,8,5,0,0,-1,-1,0,-1,6,-1
KR_6767005141,440,-1,-46,31,-2,-6,6,0,-3,3,0,5,0,5,2,2,4,0,0,0,0,4,1,3,-9,6,-7,0,-3,-1,1,-1,-1,5,-1
KR_6758162896,420,-5,-12,6,-6,-4,5,1,-1,2,1,0,1,1,-4,4,0,3,1,4,0,0,12,-2,-2,4,0,0,0,1,-1,-1,1,5,-1
KR_6764269070,420,-1,15,0,-7,-2,3,1,-3,4,1,1,3,4,2,2,4,-5,5,0,0,-10,-38,-3,-6,9,1,0,-1,1,-1,-1,1,5,-1
KR_6762428684,420,-4,-31,-7,-13,-3,4,1,-1,3,2,-7,9,2,-2,3,1,0,0,0,-1,-15,7,1,-8,7,-8,0,-1,-1,-1,-1,-1,4,-1
KR_6722360070,420,-3,-35,-4,-10,0,2,2,-1,5,4,-4,5,1,-4,6,2,-1,2,1,-1,-16,-14,-3,-5,8,0,0,-1,-1,-1,-1,-1,2,-1
KR_6693846116,420,1,-11,-12,9,-1,1,0,3,3,6,-3,4,1,10,0,10,0,2,2,0,18,5,3,-9,6,-3,0,1,-1,0,1,-1,5,-1
KR_6741882766,420,5,-9,32,8,0,0,0,6,3,9,1,1,2,0,1,1,1,0,1,0,6,-5,6,-9,3,0,0,0,-1,1,0,1,1,-1
KR_6753277568,420,-6,-38,-23,-14,-3,3,0,-7,8,1,-6,6,0,3,1,4,-1,1,0,0,-8,-15,1,-8,7,-5,0,-3,1,-1,-1,-1,1,-1
KR_6744673270,420,-3,-51,-33,2,2,0,2,-3,5,2,3,2,5,-3,9,6,3,1,4,2,-1,-9,3,-6,3,-5,0,-1,-1,-1,-1,1,3,-1
KR_6621596985,420,0,4,16,-3,1,1,2,-6,6,0,-1,2,1,4,4,8,-1,1,0,1,4,27,-2,-5,7,-2,0,1,1,1,1,1,2,-1
KR_6769096155,420,0,-48,0,5,-1,3,2,1,2,3,2,0,2,-1,6,5,4,0,4,0,4,-4,1,-5,4,3,0,-1,1,-1,-1,1,3,-1
KR_6704763618,420,3,-24,17,4,0,1,1,3,4,7,1,2,3,0,2,2,0,1,1,0,1,-21,0,-4,4,-1,0,-1,1,-1,-1,-1,3,-1
KR_6760735223,440,-3,15,-9,-4,-2,2,0,0,4,4,-2,2,0,0,6,6,0,4,4,0,0,-9,2,-6,4,-2,0,0,-1,-1,0,1,6,-1
KR_6679740770,420,-3,-94,-35,-2,-2,3,1,2,1,3,-2,5,3,-1,3,2,1,0,1,-1,10,-21,-8,-3,11,4,0,-2,1,-1,-1,-1,4,-1
KR_6763971819,440,1,8,3,-2,-3,5,2,-3,3,0,2,1,3,0,5,5,2,1,3,0,-1,-1,0,-3,3,2,0,0,1,-1,-1,1,2,-1
KR_6692017815,420,4,-33,-4,13,0,2,2,9,0,9,0,1,1,3,2,5,1,0,1,0,16,-2,-4,-4,8,3,0,0,-1,1,-1,-1,5,-1
KR_6427487262,420,2,-37,-20,4,-2,5,3,-2,3,1,3,2,5,5,0,5,0,0,0,0,9,-8,-3,-4,7,3,0,1,-1,-1,1,-1,6,-1
KR_6743905579,420,0,13,21,2,-2,2,0,2,2,4,0,2,2,0,3,3,2,0,2,0,1,-7,-4,-3,7,4,0,-1,1,-1,-1,1,5,-1
KR_6702782419,420,-2,-79,21,0,-6,6,0,1,1,2,2,2,4,0,2,2,3,1,4,0,17,42,3,-7,4,1,0,-2,0,-1,-1,1,0,-1
KR_6712991267,420,-4,-54,-20,-4,-1,2,1,-5,6,1,4,1,5,-1,5,4,-1,1,0,-1,-7,-5,-2,-5,7,-1,0,-1,-1,1,-1,-1,1,-1
KR_6767973864,420,1,12,-33,3,4,0,4,1,1,2,0,2,2,-1,3,2,-1,2,1,0,-1,-107,-2,-3,5,-5,0,0,-1,-1,1,-1,6,-1
KR_6755786907,420,-3,-17,-20,-11,-2,2,0,-2,4,2,-3,4,1,-2,5,3,-2,2,0,0,-15,-19,-1,-4,5,-4,0,-1,-1,-1,-1,-1,5,-1
KR_6720145084,420,-1,43,8,-1,3,4,7,-1,3,2,-5,7,2,0,3,3,2,0,2,2,0,8,4,-7,3,1,0,0,0,1,-1,1,0,-1
KR_6766650466,440,0,-21,-28,-4,3,1,4,-2,3,1,1,3,4,-5,5,0,-1,2,1,0,-4,0,1,-2,1,2,0,-1,-1,-1,-1,-1,6,-1
KR_6759745036,440,0,17,-11,-1,0,0,0,-4,4,0,2,0,2,0,2,2,1,1,2,0,-1,-51,2,-5,3,32,0,-2,1,-1,-1,1,3,-1
KR_6733841447,420,2,27,3,2,1,0,1,1,2,3,-1,6,5,-2,4,2,3,2,5,0,-5,-4,1,-4,3,0,0,0,-1,1,0,1,5,-1
KR_6700228094,420,-7,-45,-15,-11,-4,5,1,-3,6,3,-3,3,0,0,3,3,-1,2,1,0,-11,2,-2,-3,5,3,0,-2,-1,-1,-1,-1,3,-1
KR_6722134952,420,0,-38,-3,1,-1,1,0,0,5,5,0,1,1,0,3,3,2,1,3,0,1,10,2,-7,5,1,0,-1,1,1,-1,-1,4,-1
KR_6758036070,420,-4,-18,-23,-6,-2,3,1,2,1,3,-3,5,2,-3,3,0,0,1,1,0,-10,110,-3,-3,6,3,0,-1,-1,1,-1,-1,3,-1
KR_6769584772,420,-2,-38,-8,-2,1,0,1,1,0,1,0,1,1,-3,4,1,-1,3,2,0,-2,277,-1,-4,5,-5,0,0,-1,1,0,-1,6,-1
KR_6752277052,440,3,32,-2,-2,2,1,3,3,1,4,-4,4,0,-3,5,2,0,2,2,0,-7,-6,0,-3,3,-1,0,0,1,1,-1,1,2,-1
KR_6761434809,420,-6,-26,-28,-3,0,1,1,-4,8,4,0,1,1,1,1,2,0,0,0,0,-2,3,3,-6,3,-3,0,-1,1,-1,-1,1,6,-1
KR_6750017568,420,-1,-17,21,-4,4,0,4,1,2,3,-4,4,0,-3,4,1,-2,2,0,0,-14,14,2,-8,6,-3,0,1,-1,-1,-1,1,5,-1
KR_6762313781,440,-1,29,10,-4,-2,4,2,3,0,3,-1,2,1,-3,5,2,-1,2,1,0,-5,-3,-3,-5,8,-1,0,0,-1,-1,0,-1,4,-1
KR_6765656999,420,3,15,0,9,1,1,2,2,3,5,3,0,3,2,1,3,1,0,1,0,13,2,4,-7,3,0,0,0,1,1,0,1,1,-1
KR_6662305020,440,-2,3,0,-6,1,0,1,-1,4,3,2,0,2,-10,12,2,2,0,2,0,-10,-1,-3,-9,12,2,0,0,0,1,0,1,0,-1
KR_6709315777,420,-4,-41,-37,-10,0,1,1,-3,7,4,-3,5,2,-3,3,0,-1,1,0,0,-11,-6,3,-5,2,-4,0,-1,-1,-1,-1,-1,2,-1
KR_6719769661,420,-1,-54,-24,-5,-2,3,1,-8,9,1,0,2,2,3,0,3,2,0,2,0,-2,12,4,-7,3,-6,0,0,-1,-1,0,-1,1,-1
KR_6762007406,420,-2,-1,-20,-5,-3,5,2,5,1,6,-5,6,1,-1,1,0,-1,1,0,0,-9,15,-1,-5,6,-3,0,-1,-1,-1,-1,-1,3,-1
KR_6737037096,440,-2,15,12,-3,-1,1,0,-3,5,2,-1,2,1,0,2,2,2,1,3,1,-1,-3,-2,-1,3,3,0,0,-1,1,0,1,4,-1
KR_6725383981,420,-5,-5,-7,-10,-6,6,0,-7,7,0,1,1,2,3,1,4,-1,2,1,0,-10,-3,-2,-1,3,-2,0,0,-1,1,-1,-1,4,-1
KR_6673544208,420,-1,-50,17,-5,-2,3,1,-4,4,0,6,0,6,-4,6,2,-1,1,0,0,0,-12,-7,-3,10,-2,0,-1,1,-1,-1,-1,3,-1
KR_6688333076,420,-2,-70,15,-3,-1,2,1,-4,6,2,0,1,1,1,3,4,1,1,2,0,-2,-1,-6,-3,9,-3,0,-2,1,-1,-1,-1,3,-1
KR_6729515128,420,-1,-19,-41,-9,-1,4,3,-2,3,1,1,2,3,-6,6,0,-1,1,0,0,-12,-61,-6,-2,8,-7,0,-2,0,-1,-1,-1,0,-1
KR_6767132347,420,0,1,8,5,-1,3,2,-4,7,3,3,3,6,6,0,6,1,1,2,0,2,1,1,-8,7,-1,0,0,1,-1,0,-1,1,-1
KR_6767303001,420,-6,-59,-17,-11,-2,2,0,-1,3,2,-1,2,1,-5,7,2,-2,2,0,-1,-15,-13,-9,-1,10,5,0,-1,1,-1,-1,-1,4,-1
KR_6674288861,440,-2,21,16,-5,0,2,2,5,2,7,-1,3,2,-5,11,6,-4,5,1,1,-6,14,4,-7,3,-4,0,1,1,1,1,1,2,-1
KR_6754034846,420,0,-29,16,0,-2,4,2,0,2,2,-3,4,1,2,0,2,3,0,3,0,2,-7,-3,-5,8,3,0,0,1,-1,0,-1,4,-1
KR_6735365202,420,-2,14,8,-4,-1,1,0,1,1,2,1,1,2,-5,7,2,0,1,1,0,-5,0,-1,-5,6,-3,0,0,1,1,0,1,5,-1
KR_6695155388,420,0,19,-28,2,3,1,4,1,3,4,-1,1,0,3,1,4,-4,4,0,0,-3,-5,-2,-6,8,1,0,1,-1,-1,1,-1,6,-1
KR_6768908516,420,-2,-13,-45,-6,-1,2,1,-4,7,3,0,2,2,-2,2,0,1,0,1,-1,0,2,3,-8,5,3,0,-1,1,-1,-1,-1,3,-1
KR_6725073836,420,-1,-48,-12,1,-1,1,0,2,2,4,1,1,2,-1,3,2,0,0,0,1,8,5,0,-5,5,-2,0,0,0,0,0,1,0,-1
KR_6659027593,420,-1,23,-32,-4,0,2,2,1,3,4,-1,3,2,-4,7,3,0,1,1,0,-4,-109,-1,-5,6,-2,0,-1,1,-1,-1,-1,6,-1
KR_6767692696,420,-1,1,-35,-4,0,0,0,2,5,7,1,3,4,-8,8,0,1,0,1,-1,-7,-144,0,-8,8,-8,0,0,-1,-1,0,-1,6,-1
KR_6761070449,420,-4,-41,-16,-13,-2,2,0,-7,9,2,-1,1,0,0,3,3,-3,4,1,0,-16,-12,-3,-4,7,2,0,0,-1,-1,-1,1,5,-1
KR_6747407345,420,-1,-80,8,-4,-3,4,1,2,0,2,-4,4,0,-1,1,0,2,0,2,0,-3,-7,-4,-3,7,5,0,-2,-1,-1,-1,-1,5,-1
KR_6730509388,420,-2,-10,1,0,-3,4,1,1,1,2,-1,2,1,1,2,3,2,0,2,0,8,-16,-2,-4,6,5,0,0,1,-1,-1,1,2,-1
KR_6640791929,420,0,-16,-13,1,-1,2,1,-1,3,2,2,3,5,1,3,4,0,0,0,-1,2,-11,-3,-6,9,2,0,0,-1,1,1,1,2,-1
KR_6769911241,440,-3,-3,-27,-7,1,0,1,0,1,1,-1,3,2,0,2,2,-7,7,0,0,-7,-12,5,-7,2,-5,0,0,-1,1,-1,-1,5,-1
KR_6751135858,440,2,88,-20,3,4,1,5,3,1,4,2,1,3,-4,6,2,-2,4,2,0,5,-48,3,-6,3,6,0,1,1,1,1,1,5,-1
KR_6769811940,440,-1,-9,-2,-4,0,0,0,0,0,0,-3,5,2,-2,6,4,1,0,1,0,2,-10,-2,-2,4,-1,0,0,1,-1,-1,-1,3,-1
KR_6760900650,420,-4,-18,-15,-9,0,2,2,-1,3,2,-5,8,3,-3,3,0,0,0,0,0,-15,-12,-1,-3,4,3,0,0,1,-1,-1,1,4,-1
KR_6688400148,420,0,5,10,-2,1,0,1,-1,6,5,4,0,4,-3,5,2,-3,3,0,0,-1,3,-1,-5,6,0,0,0,1,-1,0,-1,3,-1
KR_6764077702,420,0,78,-18,-3,-2,2,0,-4,5,1,1,1,2,1,3,4,1,0,1,-1,-2,3,1,-4,3,2,0,0,-1,0,0,-1,6,-1
KR_6764820134,420,0,-24,1,-4,4,0,4,-1,3,2,-1,3,2,-1,3,2,-5,5,0,1,-7,-6,-1,-4,5,-1,0,-2,-1,-1,-1,1,2,-1
KR_6728815259,440,-1,-44,-23,-7,2,1,3,-1,3,2,1,1,2,-7,10,3,-2,2,0,0,-20,-3,-1,-6,7,-2,0,-1,0,-1,-1,-1,0,-1
KR_6758975724,420,-2,45,8,-11,-2,3,1,-4,5,1,0,0,0,-3,3,0,-2,2,0,0,-10,-41,-6,-1,7,3,0,-1,1,-1,-1,1,3,-1
KR_6749495910,440,-1,-31,4,-1,0,1,1,3,0,3,0,1,1,-6,7,1,2,0,2,0,-14,-7,0,-5,5,1,0,0,-1,0,-1,1,1,-1
KR_6616510404,420,-4,-111,-19,-7,-2,3,1,0,3,3,-2,7,5,-1,4,3,-2,3,1,0,-5,-2,0,-5,5,-6,0,-5,-1,-1,-1,-1,4,-1
KR_6734275373,420,-5,5,-15,-16,-5,5,0,-5,5,0,-4,4,0,-1,4,3,-1,1,0,0,-25,-98,-1,-2,3,-4,0,-1,-1,-1,-1,-1,4,-1
KR_6769227979,420,-3,-47,-12,-5,-2,4,2,-1,3,2,-4,5,1,3,3,6,-1,2,1,0,-6,-21,1,-5,4,4,0,-1,1,-1,-1,-1,5,-1
KR_6738721716,420,-5,-51,-8,-15,-5,5,0,-2,5,3,-4,5,1,-2,2,0,-2,3,1,0,-15,-300,0,-5,5,-3,0,-2,-1,1,-1,-1,2,-1
KR_6742735548,420,-2,-41,-9,-2,-1,3,2,-6,8,2,2,1,3,-1,2,1,4,0,4,0,0,-28,-1,-6,7,1,0,0,0,0,0,1,0,-1
KR_6742692193,420,-1,-47,32,-11,-7,7,0,0,2,2,0,1,1,-3,3,0,-1,1,0,0,-7,-4,-2,-3,5,3,0,-1,-1,1,-1,-1,6,-1
KR_6753137786,420,0,19,-12,-5,3,0,3,-7,9,2,0,5,5,-3,4,1,2,1,3,-1,-7,3,-1,-4,5,2,0,1,-1,1,1,-1,2,-1
KR_6764599915,420,-4,24,-31,-5,-1,3,2,-2,3,1,2,2,4,-2,2,0,-2,3,1,0,-5,5,-4,-5,9,-1,0,0,-1,1,0,1,2,-1
KR_6718482907,420,1,-39,27,-6,-1,1,0,0,1,1,-4,4,0,1,0,1,-2,2,0,0,-7,-262,-1,-6,7,-3,0,-1,-1,-1,-1,-1,1,-1
KR_6760783404,420,0,74,-10,1,1,0,1,1,4,5,2,1,3,-2,3,1,-1,2,1,0,-6,-45,4,-8,4,22,0,1,-1,1,1,1,6,-1
KR_6673224966,420,-2,6,4,-6,-2,3,1,-1,3,2,-2,6,4,-1,4,3,0,1,1,-1,1,1,-1,-4,5,2,0,0,1,1,0,-1,5,-1
KR_6761798016,440,-7,-36,-48,-14,-3,4,1,-1,2,1,2,1,3,-7,8,1,-5,5,0,0,-14,26,-1,-4,5,-5,0,-1,-1,-1,-1,-1,2,-1
KR_6651641269,420,0,16,-24,-4,-4,5,1,-1,3,2,-3,3,0,3,1,4,1,0,1,0,0,-53,2,-5,3,24,0,-1,0,1,-1,-1,0,-1
KR_6769874604,420,-3,5,0,-1,2,1,3,0,4,4,-1,1,0,-4,5,1,2,1,3,0,-4,13,2,-7,5,-8,0,0,-1,1,-1,1,5,-1
KR_6719827504,420,-9,-44,-20,-13,-2,3,1,-7,8,1,-2,3,1,0,4,4,-2,2,0,0,-9,-12,2,-8,6,2,0,-2,-1,1,-1,-1,4,-1
KR_6750672766,440,-2,-94,4,-9,0,2,2,-1,4,3,-1,1,0,-3,3,0,-4,4,0,0,-13,5,1,-6,5,-4,0,-1,-1,1,-1,-1,5,-1
KR_6765036920,420,-2,-34,17,-8,-3,3,0,-4,6,2,3,0,3,-2,4,2,-2,2,0,-1,-3,-4,-2,-4,6,0,0,-3,-1,1,-1,-1,2,-1
KR_6715807948,420,-3,-76,16,-1,-5,5,0,5,1,6,0,2,2,0,1,1,-1,1,0,0,3,6,5,-7,2,-1,0,-1,1,1,-1,1,4,-1
KR_6425247865,420,-4,-46,2,-12,-3,6,3,0,2,2,-3,5,2,-5,6,1,-1,3,2,0,-21,-3,2,-6,4,0,0,0,1,-1,-1,-1,2,-1
KR_6749185108,420,-5,-69,-12,-14,-2,2,0,-5,6,1,-3,3,0,-2,7,5,-2,2,0,0,-12,-30,4,-11,7,-4,0,-1,-1,1,-1,-1,1,-1
KR_6738789109,420,-8,-112,-28,-17,0,2,2,-3,5,2,-1,2,1,-12,12,0,-1,1,0,2,-6,-3,-1,-4,5,1,0,-3,1,1,-1,1,6,-1
KR_6635359779,420,-1,-35,8,-3,0,1,1,3,6,9,-1,3,2,-5,10,5,0,1,1,0,-4,-46,1,-5,4,38,0,1,1,1,1,-1,6,-1
KR_6722968053,420,-1,-2,-11,-5,4,1,5,-3,9,6,-4,4,0,-2,2,0,0,0,0,0,-6,3,2,-7,5,-4,0,0,-1,1,-1,1,3,-1
KR_6764266195,420,-1,-2,-10,-6,0,2,2,-2,2,0,-3,3,0,0,2,2,-1,2,1,0,-4,-18,-4,-4,8,4,0,0,-1,-1,0,-1,1,-1
KR_6615586223,420,3,13,1,1,2,0,2,0,3,3,1,1,2,-1,1,0,-1,1,0,0,-2,-47,-11,0,11,4,0,-1,-1,-1,-1,-1,3,-1
KR_6770508340,420,-5,-48,-31,-19,-2,2,0,-7,10,3,-7,8,1,-3,3,0,0,2,2,-2,-25,-25,-8,-3,11,-1,0,0,1,-1,-1,-1,6,-1
KR_6750359319,440,-1,-51,-13,-4,1,3,4,-3,6,3,2,1,3,-5,5,0,1,4,5,-1,-2,-40,-3,-5,8,12,0,-2,1,-1,-1,-1,6,-1
KR_6748849125,420,-2,-38,-11,-7,-5,5,0,-2,3,1,-1,6,5,1,1,2,0,0,0,0,-11,-16,0,-4,4,0,0,0,-1,0,0,1,5,-1
KR_6735840761,420,-1,-24,8,-5,3,0,3,0,2,2,-3,6,3,-7,8,1,2,0,2,-1,-5,-2,4,-8,4,-4,0,-1,-1,1,-1,-1,6,-1
KR_6768596287,420,3,4,16,0,-3,5,2,1,2,3,1,2,3,0,4,4,1,1,2,0,2,18,1,-6,5,-1,0,1,-1,1,1,-1,2,-1
KR_6769484054,420,2,32,0,4,1,3,4,-2,4,2,3,0,3,-1,1,0,3,0,3,0,0,-5,-2,-4,6,7,0,1,-1,1,1,1,6,-1
KR_6764734371,420,-4,-51,8,-6,-1,2,1,0,1,1,3,1,4,-5,6,1,-3,4,1,0,-4,-7,-3,-1,4,1,0,-1,-1,0,-1,-1,3,-1
KR_6764014693,420,-6,-60,-23,-7,-1,3,2,0,1,1,-4,4,0,-2,3,1,0,1,1,0,-3,17,3,-6,3,-3,0,-1,-1,-1,-1,-1,4,-1
KR_6768328771,420,-1,38,-4,-3,-1,4,3,1,1,2,-1,2,1,-1,1,0,-1,3,2,0,-11,-13,1,-6,5,2,0,1,1,1,1,-1,1,-1
KR_6667498994,420,-3,-62,-23,-6,-3,4,1,1,4,5,-1,2,1,-4,6,2,1,0,1,0,-12,-3,-2,-4,6,-3,0,-3,-1,1,-1,-1,3,-1
KR_6743176267,420,-1,2,-15,-4,-5,6,1,0,2,2,-1,3,2,3,1,4,-1,4,3,0,1,-4,-1,-5,6,3,0,0,-1,-1,0,1,5,-1
KR_6714062237,420,-4,-99,12,-10,-7,7,0,-2,5,3,-1,2,1,0,5,5,0,4,4,0,-7,-8,-3,-4,7,-1,0,-1,1,-1,-1,1,1,-1
KR_6694237396,420,-3,-19,-16,-10,-5,5,0,-4,8,4,-1,4,3,-1,2,1,1,3,4,0,-3,1,-1,-5,6,-4,0,-1,0,-1,-1,1,0,-1
KR_6672302317,440,-1,1,-17,-1,2,0,2,1,1,2,-3,3,0,-1,4,3,0,0,0,0,3,-9,0,-5,5,-5,0,0,-1,-1,0,-1,5,-1
KR_6693669230,420,-1,25,12,-9,-5,5,0,2,5,7,3,1,4,-7,8,1,-2,3,1,0,-7,24,-3,-4,7,-1,0,-2,1,-1,-1,-1,2,-1
KR_6694032454,420,-5,-88,-3,-12,-4,4,0,-5,6,1,-1,2,1,-2,5,3,0,2,2,-1,-13,-3,-1,-4,5,-5,0,-2,1,-1,-1,-1,5,-1
KR_6768798955,440,-4,40,-32,-4,0,1,1,1,2,3,-2,4,2,-3,6,3,0,1,1,0,-6,-28,-1,-5,6,-5,0,1,0,1,1,1,0,-1
KR_6761199620,420,3,19,-13,11,2,0,2,3,0,3,2,2,4,-1,5,4,5,1,6,0,8,-2,4,-7,3,-2,0,0,-1,0,0,1,2,-1
KR_6759707639,440,-3,-12,8,-9,-2,3,1,-9,10,1,-3,4,1,2,3,5,3,1,4,1,-12,-10,-9,-1,10,-1,0,0,0,-1,0,1,0,-1
KR_6744206548,420,-2,3,-13,-6,0,0,0,-2,6,4,0,1,1,-4,4,0,0,1,1,0,-9,38,-2,-5,7,-19,0,0,-1,1,0,1,4,-1
KR_6734842872,420,5,11,4,5,5,0,5,0,2,2,0,4,4,1,1,2,-1,1,0,0,6,7,3,-6,3,2,0,0,-1,1,-1,-1,5,-1
KR_6755229171,420,0,-29,-4,-4,2,0,2,-5,5,0,3,0,3,-4,5,1,0,1,1,0,3,112,-6,-4,10,8,0,0,1,-1,0,-1,3,-1
KR_6724733586,420,-5,-20,-28,-15,1,2,3,-1,3,2,-12,14,2,-2,4,2,-1,1,0,0,-17,-4,0,-5,5,-4,0,-1,-1,-1,-1,-1,3,-1
KR_6682649107,420,-1,-27,8,-1,-1,2,1,-2,2,0,-2,2,0,3,2,5,1,0,1,-1,-2,-2,-1,-4,5,2,0,-1,-1,1,-1,-1,6,-1
KR_6752027665,420,1,-64,-17,12,-5,7,2,2,1,3,8,4,12,5,2,7,2,1,3,0,9,97,3,-8,5,0,0,1,1,1,1,1,5,-1
KR_6762391023,420,0,-24,-1,0,0,1,1,-3,5,2,1,2,3,1,1,2,1,0,1,0,3,22,2,-6,4,-5,0,-1,-1,1,-1,1,1,-1
KR_6759950464,420,1,5,20,-3,-1,5,4,-1,5,4,0,2,2,-2,4,2,1,0,1,-1,-5,114,1,-5,4,2,0,-2,-1,-1,-1,-1,4,-1
KR_6624198211,440,0,-25,-6,7,3,0,3,-2,3,1,1,4,5,8,1,9,-3,3,0,0,10,-4,-4,-3,7,8,0,0,-1,-1,-1,1,5,-1
KR_6767057235,420,-1,-2,-4,-1,2,1,3,-2,2,0,-2,3,1,1,2,3,0,0,0,0,-1,14,3,-7,4,0,0,0,1,-1,0,1,2,-1
KR_6770647527,420,-2,42,-22,-2,-4,4,0,-2,4,2,5,1,6,-1,4,3,0,0,0,0,-4,-8,-3,-3,6,3,0,0,1,1,1,1,4,-1
KR_6674908486,420,-1,1,7,3,-1,1,0,3,2,5,1,2,3,-1,1,0,1,1,2,1,2,-1,2,-6,4,3,0,0,1,0,0,1,5,-1
KR_6743821336,420,3,-49,44,3,2,2,4,-1,5,4,-2,4,2,3,1,4,1,0,1,1,5,-57,0,-2,2,18,0,0,-1,1,1,1,3,-1
KR_6748377252,420,0,5,8,-6,-1,1,0,-5,5,0,0,1,1,-2,5,3,2,1,3,0,-1,35,0,-5,5,-19,0,0,-1,1,1,-1,2,-1
KR_6701254092,420,-5,-29,-53,-8,4,1,5,-3,5,2,-4,4,0,-4,4,0,-1,1,0,0,-17,5,-3,-8,11,-10,0,-2,-1,-1,-1,1,2,-1
KR_6746753398,420,-2,-53,3,-6,2,2,4,0,2,2,-7,7,0,-5,9,4,4,0,4,-3,-13,-2,-7,-2,9,1,0,-1,1,-1,-1,-1,6,-1
KR_6757844380,440,-2,-65,12,3,-5,5,0,1,1,2,1,1,2,6,0,6,0,0,0,0,9,-24,-2,-1,3,-1,0,-1,1,1,-1,1,3,-1
KR_6767041499,420,-4,-60,-4,-7,-2,2,0,1,1,2,-3,6,3,-2,3,1,-1,1,0,-1,-6,9,0,-3,3,-5,0,0,-1,1,0,-1,5,-1
KR_6687782531,420,-7,-56,-28,-13,-3,5,2,-1,4,3,-4,5,1,-5,7,2,0,2,2,-2,-12,-47,-4,-2,6,4,0,-1,1,1,-1,-1,6,-1
KR_6762190245,420,-7,-71,-41,-8,-4,5,1,2,1,3,-5,5,0,-2,4,2,1,0,1,0,-1,-58,-2,-4,6,21,0,-1,-1,-1,-1,-1,4,-1
KR_6693287999,420,-6,-20,-3,-10,-4,5,1,-6,7,1,-1,3,2,1,1,2,0,2,2,0,-8,-4,5,-8,3,-11,0,-1,-1,1,-1,-1,1,-1
KR_6715499077,420,-2,1,11,-8,-5,5,0,-1,5,4,-3,5,2,-1,2,1,2,0,2,0,0,5,2,-6,4,-5,0,0,-1,1,0,-1,6,-1
KR_6725788063,420,-4,-56,-15,-11,-5,5,0,-4,8,4,-4,4,0,1,1,2,1,0,1,0,-4,-38,-2,-4,6,22,0,-1,-1,-1,-1,-1,2,-1
KR_6623688573,420,3,8,25,6,3,0,3,3,2,5,-1,4,3,1,1,2,0,0,0,0,2,-8,0,-7,7,-1,0,0,1,-1,-1,-1,4,-1
KR_6744442023,420,-1,-56,26,-8,1,3,4,-4,8,4,-2,3,1,-3,6,3,0,1,1,0,-5,8,3,-11,8,-3,0,-1,-1,-1,-1,-1,3,-1
KR_6642960467,420,-4,-30,-27,-11,3,0,3,0,2,2,-2,3,1,-4,4,0,-8,8,0,0,-11,1,-1,-5,6,-4,0,-2,-1,-1,-1,1,1,-1
KR_6751521449,420,-2,-119,6,-6,1,1,2,-6,6,0,0,1,1,0,1,1,-1,1,0,0,-7,-8,-7,-3,10,7,0,0,0,-1,0,1,0,-1
KR_6744055206,420,1,-55,-5,-3,0,3,3,-1,2,1,0,3,3,-4,7,3,2,0,2,0,-5,-275,2,-6,4,-6,0,1,-1,-1,1,-1,5,-1
KR_6758706985,420,-4,-47,0,-10,-2,3,1,2,1,3,0,6,6,-6,7,1,-4,4,0,0,-11,0,-3,-4,7,-3,0,-1,-1,1,-1,1,6,-1
KR_6767904259,420,0,-60,6,2,-2,3,1,2,3,5,3,1,4,-2,4,2,1,0,1,0,3,0,5,-10,5,-4,0,-2,-1,-1,-1,-1,3,-1
KR_6761613064,420,-4,-14,-12,-10,2,0,2,2,2,4,-3,4,1,-5,7,2,-6,8,2,0,-17,-93,-1,-7,8,4,0,0,-1,1,-1,-1,3,-1
KR_6768326230,420,0,22,12,-1,2,1,3,-1,2,1,0,3,3,0,3,3,-2,4,2,0,-2,-1,-2,-3,5,0,0,0,1,0,0,1,6,-1
KR_6766852705,420,4,45,16,-1,1,0,1,1,3,4,4,3,7,-2,4,2,-5,5,0,0,-7,-278,7,-11,4,-6,0,0,-1,-1,0,1,4,-1
KR_6757509489,420,-5,-52,-18,-9,-3,3,0,-1,2,1,-1,2,1,-3,3,0,-1,3,2,-1,-3,-32,-3,-5,8,-2,0,-1,-1,-1,-1,-1,5,-1
KR_6721184244,420,-1,-34,-9,-3,0,2,2,-4,4,0,-2,4,2,1,3,4,2,0,2,0,-6,178,-1,-4,5,2,0,0,-1,-1,-1,-1,5,-1
KR_6756432303,420,-3,-46,13,-9,3,3,6,-7,9,2,-3,3,0,-3,3,0,1,0,1,0,-2,0,-5,-2,7,0,0,1,-1,1,1,-1,4,-1
KR_6650782492,420,0,-22,30,-2,2,0,2,-2,8,6,4,0,4,-4,7,3,-2,2,0,1,-4,11,5,-11,6,-8,0,0,1,-1,-1,1,4,-1
KR_6769098994,420,-3,-8,25,-11,-1,1,0,-4,4,0,-3,4,1,-1,4,3,-2,4,2,0,-13,-209,2,-6,4,21,0,-1,1,-1,-1,1,2,-1
KR_6702647574,420,-1,-59,12,-5,-1,4,3,-1,1,0,-2,2,0,0,1,1,-1,2,1,0,-3,30,-4,-5,9,-3,0,0,-1,1,1,-1,6,-1
KR_6750237846,440,-1,6,-29,2,0,3,3,0,1,1,0,2,2,1,0,1,1,0,1,0,-2,4,3,-7,4,0,0,-1,1,1,-1,1,4,-1
KR_6751894467,420,0,8,24,-8,3,2,5,2,1,3,-3,6,3,-7,10,3,-3,4,1,-2,-14,-27,-4,-4,8,0,0,-1,-1,0,-1,1,4,-1
KR_6713790516,420,-1,-9,7,-8,-4,7,3,-5,7,2,2,1,3,-3,4,1,2,1,3,0,-19,0,-3,-5,8,0,0,-1,-1,-1,-1,1,4,-1
KR_6768333454,420,1,-13,39,3,2,0,2,-2,2,0,-1,4,3,4,2,6,0,0,0,-1,-2,1,4,-4,0,0,0,-1,-1,1,-1,-1,4,-1
KR_6611937685,420,-1,9,7,-10,1,0,1,-4,5,1,3,0,3,-2,4,2,-8,10,2,0,-15,18,0,-6,6,2,0,-1,1,1,-1,-1,6,-1
KR_6722128270,420,-6,-65,-51,-15,-6,7,1,-9,12,3,1,1,2,-1,4,3,0,1,1,0,-3,0,0,-5,5,5,0,-3,-1,-1,-1,-1,3,-1
KR_6738753973,420,-5,-29,-21,-10,-4,5,1,-7,8,1,-2,2,0,2,0,2,1,0,1,1,-16,242,-3,-2,5,-3,0,-1,-1,-1,-1,1,3,-1
KR_6737759535,420,-3,-65,-21,-4,0,2,2,-2,3,1,-2,3,1,1,2,3,-1,2,1,0,-6,-21,-2,-7,9,-1,0,-1,1,-1,-1,1,1,-1
KR_6765333728,420,-3,-16,7,-5,-3,3,0,1,2,3,-5,8,3,2,3,5,0,3,3,2,5,-3,0,-5,5,1,0,2,-1,0,1,1,3,-1
KR_6767323677,440,-1,-16,4,-1,-1,2,1,1,1,2,1,3,4,-7,8,1,5,0,5,-1,-1,33,-3,-5,8,-1,0,0,-1,0,0,-1,5,-1
KR_6734850011,420,-2,-2,-24,1,1,0,1,-4,6,2,5,0,5,0,4,4,-1,1,0,0,-1,-4,-3,-3,6,2,0,-1,1,-1,-1,1,1,-1
KR_6770547192,420,0,-11,28,2,-2,2,0,2,0,2,2,1,3,1,1,2,-1,4,3,0,4,-4,0,-5,5,1,0,0,1,-1,1,1,3,-1
KR_6696921645,420,-5,-63,-23,-12,-3,6,3,-4,5,1,-1,2,1,-2,2,0,-2,4,2,3,-4,16,3,-7,4,-5,0,-1,-1,1,-1,1,6,-1
KR_6725990048,440,-5,-83,-32,-9,-9,11,2,-1,3,2,2,3,5,-1,2,1,0,0,0,0,-9,-2,-1,-3,4,4,0,-1,-1,-1,-1,-1,2,-1
KR_6764769150,440,-3,-120,-7,-13,-7,9,2,-5,5,0,-2,4,2,0,1,1,1,2,3,0,4,3,-2,-4,6,2,0,-1,0,0,-1,-1,0,-1
KR_6767358969,440,3,37,8,8,7,0,7,-1,3,2,0,1,1,0,4,4,2,1,3,0,0,5,5,-8,3,-1,0,1,1,1,1,1,3,-1
KR_6770843757,420,0,19,9,7,2,0,2,3,1,4,-1,1,0,2,0,2,1,0,1,0,13,2,0,-7,7,2,0,0,-1,-1,0,1,2,-1
KR_6764291818,440,-3,-21,4,-2,-1,2,1,-4,6,2,-3,5,2,6,0,6,0,1,1,0,-5,-21,-3,-1,4,-1,0,0,-1,0,-1,1,4,-1
KR_6764667726,440,-1,-42,-19,-4,-1,2,1,-1,2,1,1,0,1,-3,4,1,0,1,1,0,2,-4,4,-5,1,-5,0,-1,1,1,-1,-1,1,-1
KR_6557682133,420,-2,-16,-13,-6,1,2,3,-6,8,2,0,1,1,0,2,2,-1,1,0,-1,-4,-10,-5,-3,8,-1,0,0,-1,1,0,-1,2,-1
KR_6755158790,420,0,-49,-24,2,-1,2,1,4,2,6,0,5,5,1,3,4,-2,2,0,0,1,118,0,-4,4,0,0,0,-1,1,0,-1,2,-1
KR_6770271738,420,-3,-91,-5,-4,-1,3,2,5,1,6,-4,7,3,-2,3,1,-2,2,0,0,-3,1,-2,-3,5,0,0,0,1,1,-1,-1,4,-1
KR_6605334193,420,-4,14,-20,-9,5,0,5,-5,8,3,-3,4,1,-11,15,4,5,0,5,0,-11,-17,-3,-4,7,-2,0,-2,-1,-1,-1,-1,4,-1
KR_6760272969,420,-4,18,-34,-13,0,1,1,-1,3,2,-8,10,2,-1,3,2,-3,4,1,-1,-12,-40,-1,-4,5,2,0,-2,-1,-1,-1,-1,3,-1
KR_6717078347,420,-4,-61,-14,-13,-2,3,1,2,2,4,-4,5,1,-1,2,1,-8,9,1,-1,-13,-12,-1,-6,7,1,0,-2,-1,-1,-1,-1,1,-1
KR_6656961260,420,1,30,-44,4,0,0,0,0,6,6,3,1,4,2,0,2,-1,1,0,0,10,9,0,-5,5,1,0,0,-1,1,1,1,3,-1
KR_6752261163,420,-2,-5,-24,-7,0,0,0,-3,5,2,0,2,2,-4,4,0,0,0,0,0,-8,1,2,-7,5,-1,0,-1,-1,1,-1,-1,2,-1
KR_6737657390,440,0,-28,8,1,2,0,2,0,3,3,-3,3,0,3,1,4,-1,3,2,0,-2,7,1,-6,5,-1,0,0,1,-1,0,1,6,-1
KR_6710699205,420,0,-39,-12,2,1,2,3,0,2,2,5,3,8,-5,6,1,1,0,1,0,-2,35,0,-5,5,3,0,-1,1,-1,-1,-1,6,-1
KR_6767090444,420,0,-44,1,-4,1,0,1,1,0,1,-5,6,1,-2,4,2,1,0,1,0,-6,-7,-2,-4,6,1,0,0,-1,1,-1,-1,4,-1
KR_6602144292,420,-1,63,4,-6,-1,2,1,-1,4,3,-6,6,0,3,3,6,-1,2,1,0,-1,-9,-4,-4,8,9,0,0,1,-1,-1,1,6,-1
KR_6746815097,420,1,-5,0,-3,0,0,0,-2,5,3,-2,5,3,0,4,4,1,0,1,0,-3,-8,4,-8,4,23,0,0,-1,1,0,1,4,-1
KR_6753639768,420,1,-20,7,2,2,1,3,4,1,5,-1,3,2,0,4,4,-3,5,2,0,-3,-20,0,-3,3,-1,0,1,0,1,1,1,0,-1
KR_6747557245,420,0,0,-4,1,0,2,2,2,0,2,1,4,5,-2,6,4,0,0,0,-2,-5,-9,2,-5,3,0,0,-1,-1,-1,-1,1,4,-1
KR_6762667204,420,-4,-6,-8,-14,2,1,3,-5,6,1,-5,10,5,-6,7,1,0,0,0,0,-19,0,-1,-2,3,-2,0,-1,-1,1,-1,-1,4,-1
KR_6746252975,420,-1,-19,-6,1,1,1,2,0,3,3,2,1,3,-2,2,0,0,0,0,-1,-1,5,-2,-5,7,-6,0,0,-1,1,1,-1,6,-1
KR_6702802478,420,-3,-69,8,-11,-2,4,2,-6,7,1,-1,2,1,-2,2,0,0,2,2,-1,-23,-12,-1,-6,7,-8,0,0,1,-1,-1,-1,1,-1
KR_6760186452,420,-1,30,-5,-1,-3,4,1,3,1,4,3,2,5,-3,3,0,-1,1,0,0,-4,276,4,-6,2,-1,0,0,1,1,1,1,3,-1
KR_6737942302,420,-4,-13,-37,-12,-2,2,0,-4,5,1,-2,3,1,-6,7,1,2,0,2,-1,-19,4,-3,-5,8,-5,0,-2,-1,-1,-1,-1,1,-1
KR_6696110245,420,-1,-61,-36,0,1,1,2,0,1,1,2,1,3,-2,3,1,-1,1,0,0,-1,7,0,-6,6,-5,0,-1,-1,1,-1,1,3,-1
KR_6768856187,420,-6,-103,-10,-10,1,1,2,-4,6,2,4,0,4,-7,9,2,-4,4,0,2,-9,3,-1,-3,4,2,0,-2,-1,-1,-1,1,3,-1
KR_6759688756,420,-6,-40,-25,-7,-1,3,2,0,2,2,-3,5,2,-1,2,1,-2,2,0,0,-6,-234,-1,-6,7,-2,0,-1,-1,-1,-1,1,5,-1
KR_6737893660,420,0,-4,7,1,6,1,7,-4,7,3,2,1,3,-1,2,1,-2,3,1,0,-4,6,0,-5,5,-2,0,-1,1,1,-1,1,6,-1
KR_6710665859,420,-5,-74,-37,-15,-2,3,1,-2,5,3,-7,7,0,-5,10,5,1,1,2,1,-17,-185,-1,-4,5,0,0,-3,-1,-1,-1,-1,4,-1
KR_6753373782,420,1,21,4,-4,-5,6,1,-1,1,0,0,1,1,1,2,3,1,1,2,0,-2,5,1,-3,2,0,0,-1,1,-1,-1,-1,2,-1
KR_6764723944,420,-2,-34,2,-7,-4,4,0,1,0,1,-2,3,1,-2,6,4,0,1,1,0,-12,55,-1,-3,4,-22,0,-1,-1,-1,-1,-1,1,-1
KR_6758117304,440,-1,-48,32,-7,-5,5,0,1,2,3,2,1,3,-3,3,0,-2,2,0,0,-12,3,0,-4,4,-3,0,-1,1,1,-1,-1,5,-1
KR_6738884551,420,-1,-1,11,-5,-1,1,0,1,3,4,1,0,1,-5,8,3,-1,2,1,0,-1,-6,6,-11,5,-3,0,-1,-1,-1,-1,1,4,-1
KR_6768592482,420,2,46,1,5,3,0,3,0,0,0,-2,2,0,4,2,6,0,1,1,0,5,2,1,-5,4,-3,0,1,-1,1,1,1,6,-1
KR_6749598466,420,0,38,-32,-6,3,0,3,-2,2,0,-3,9,6,-4,6,2,0,0,0,0,-15,-4,-1,-4,5,3,0,-1,-1,1,-1,1,3,-1
KR_6741474813,420,3,-36,20,-6,-1,1,0,0,2,2,-1,2,1,0,1,1,-4,4,0,0,-4,19,-4,-5,9,4,0,0,-1,-1,0,-1,1,-1
KR_6767247111,420,-3,-9,-4,-6,-2,2,0,0,2,2,-3,4,1,-1,6,5,0,0,0,0,-3,-5,-1,-5,6,0,0,0,1,1,1,-1,5,-1
KR_6765460561,420,-3,-19,-21,1,-1,2,1,1,3,4,-2,2,0,0,1,1,3,2,5,0,1,15,4,-6,2,1,0,3,-1,1,1,-1,6,-1
KR_6657187778,420,-5,-65,0,-13,2,1,3,-9,9,0,-3,4,1,-3,4,1,0,0,0,0,-18,-28,2,-5,3,-7,0,-2,-1,1,-1,-1,3,-1
KR_6752087115,420,-1,-44,-20,-5,-2,4,2,-1,2,1,-4,5,1,1,4,5,1,0,1,0,-8,-43,-4,-2,6,2,0,-2,-1,-1,-1,-1,3,-1
KR_6766754317,420,0,27,18,-3,1,1,2,1,6,7,-4,4,0,2,2,4,-3,3,0,0,-1,-33,2,-5,3,-5,0,1,1,1,1,-1,2,-1
KR_6751450928,420,-4,-122,-24,-8,-3,4,1,-2,4,2,1,2,3,-3,3,0,-1,1,0,0,-4,6,5,-7,2,-3,0,-1,1,1,-1,-1,5,-1
KR_6767978150,420,-1,-76,5,-4,-3,4,1,2,3,5,-1,3,2,-2,3,1,0,1,1,-1,-4,6,-1,-4,5,-4,0,1,1,-1,1,-1,6,-1
KR_6683797540,420,-1,-22,-20,-6,-5,5,0,1,3,4,-2,2,0,0,3,3,0,0,0,0,-4,-10,-1,-5,6,-2,0,0,1,-1,0,1,6,-1
KR_6768681227,420,0,29,-36,-1,1,3,4,-2,5,3,-2,3,1,0,2,2,2,1,3,0,-5,3,1,-6,5,1,0,0,-1,1,-1,1,2,-1
KR_6758923627,440,-3,-24,-55,-12,0,6,6,-4,4,0,2,2,4,-9,9,0,-1,3,2,0,-9,196,-3,-2,5,1,0,-1,-1,-1,-1,-1,1,-1
KR_6627061444,420,-4,-14,-26,-8,-2,3,1,0,2,2,2,3,5,-8,9,1,0,1,1,-1,-11,-5,-5,-4,9,-2,0,-1,-1,1,-1,-1,3,-1
KR_6680171521,420,-5,-35,-48,-12,-1,2,1,-5,6,1,-3,5,2,0,6,6,-3,3,0,-2,-5,-47,2,-6,4,-4,0,0,-1,-1,0,-1,1,-1
KR_6716057999,420,-4,-19,-2,-1,4,1,5,-3,5,2,-2,3,1,0,2,2,0,0,0,1,0,-116,-2,-2,4,0,0,0,1,0,0,1,1,-1
KR_6746501089,440,-1,-71,0,8,2,0,2,4,5,9,0,1,1,1,4,5,1,1,2,1,10,-47,-4,-3,7,31,0,-1,-1,0,-1,1,1,-1
KR_6765391115,420,-4,-61,-30,-6,-4,5,1,-5,7,2,-1,2,1,3,1,4,1,0,1,1,-2,-5,-2,-3,5,0,0,1,-1,-1,-1,1,5,-1
KR_6762267483,420,-5,-54,-27,-12,-4,4,0,0,1,1,2,1,3,-8,11,3,-2,2,0,-1,-8,-55,-1,-3,4,-4,0,-1,-1,-1,-1,-1,5,-1
KR_6650988804,420,-1,-12,1,-5,0,4,4,-1,2,1,-1,3,2,-4,6,2,1,0,1,0,-14,1,0,-7,7,-1,0,-1,-1,1,-1,-1,6,-1
KR_6734841441,420,-5,-37,-14,-10,0,1,1,-6,7,1,1,3,4,-2,2,0,-3,3,0,0,-3,-2,-1,-4,5,0,0,-1,-1,-1,-1,-1,3,-1
KR_6770669614,420,0,19,3,0,0,1,1,-4,4,0,2,2,4,2,3,5,0,2,2,1,-3,-9,-2,-5,7,-3,0,1,1,1,1,1,3,-1
KR_6706296352,420,-2,0,-6,-6,3,0,3,-7,7,0,1,3,4,-2,3,1,-1,2,1,0,-8,-153,-4,-3,7,2,0,-2,1,-1,-1,-1,2,-1
KR_6770278457,420,4,-1,-4,8,1,1,2,-2,5,3,2,0,2,2,1,3,5,1,6,0,6,0,3,-4,1,4,0,0,1,-1,-1,1,5,-1
KR_6763602228,420,0,12,-51,0,1,0,1,-2,2,0,-6,6,0,1,0,1,6,0,6,0,-1,7,0,-7,7,2,0,0,1,1,0,1,6,-1
KR_6770882829,420,-1,-57,-5,-1,1,2,3,0,2,2,1,1,2,-2,2,0,-1,3,2,0,0,-16,-1,-4,5,4,0,-2,1,-1,-1,-1,6,-1
KR_6764563569,440,4,51,28,10,3,2,5,5,0,5,3,1,4,-3,5,2,2,0,2,1,4,20,3,-5,2,1,0,0,0,0,1,1,0,-1
KR_6769829833,420,0,-30,31,-3,-1,2,1,3,1,4,-3,3,0,-1,2,1,-1,1,0,-1,-2,12,2,-5,3,-9,0,0,-1,1,0,-1,6,-1
KR_6765778556,420,-4,-39,-1,-4,-1,1,0,1,1,2,2,2,4,-5,5,0,-1,1,0,0,-2,10,1,-7,6,-2,0,-2,-1,-1,-1,-1,4,-1
KR_6556796458,420,-2,-27,-14,-2,4,2,6,-1,5,4,1,2,3,0,2,2,-6,6,0,0,-8,9,7,-11,4,0,0,1,1,-1,1,1,1,-1
KR_6721240015,420,-3,-35,-38,-4,1,2,3,-1,2,1,-2,2,0,-1,4,3,-1,2,1,0,-12,-6,-2,-2,4,-2,0,-1,-1,-1,-1,-1,4,-1
KR_6765263639,440,-5,-101,-11,-6,-2,4,2,5,0,5,-5,5,0,-3,5,2,-1,2,1,-2,-3,-1,-1,-3,4,2,0,-1,-1,1,-1,-1,5,-1
KR_6681194480,420,-2,-36,-2,-5,1,1,2,-1,3,2,-2,3,1,-3,3,0,0,1,1,0,-2,20,1,-6,5,-7,0,-1,-1,-1,-1,1,4,-1
KR_6690020991,420,-4,-74,-24,-9,-2,5,3,-4,5,1,0,2,2,-1,5,4,-2,2,0,-3,-7,-28,-2,-4,6,-2,0,-1,0,-1,-1,-1,0,-1
KR_6624460170,420,3,39,12,6,5,0,5,4,3,7,-1,3,2,-2,3,1,0,0,0,0,-2,6,0,-6,6,-1,0,1,-1,-1,1,1,4,-1
KR_6750626361,420,-4,17,-23,-9,-1,2,1,-3,6,3,-2,5,3,-2,3,1,-1,1,0,0,-7,-12,-1,-5,6,3,0,0,-1,1,0,1,2,-1
KR_6749354196,420,-3,-6,-16,-12,1,1,2,-1,4,3,-11,11,0,-2,6,4,1,0,1,-3,-15,2,-7,0,7,5,0,-1,-1,-1,-1,-1,4,-1
KR_6713669056,420,0,1,4,-2,1,0,1,-2,4,2,6,2,8,-7,7,0,0,1,1,1,-3,1,1,-6,5,0,0,0,-1,-1,0,1,1,-1
KR_6751819558,420,-2,-1,-13,-8,2,1,3,-3,5,2,-3,3,0,-4,6,2,0,0,0,0,-18,-4,-3,-3,6,-1,0,2,-1,1,1,-1,3,-1
KR_6765363122,440,-5,-6,-6,-6,1,1,2,-7,8,1,0,1,1,-2,3,1,2,0,2,0,-6,-4,1,-7,6,2,0,0,-1,-1,-1,-1,2,-1
KR_6765337993,420,-5,-34,-34,-9,-3,3,0,-1,1,0,-1,2,1,-4,5,1,0,1,1,0,-19,2,3,-6,3,0,0,-2,-1,0,-1,-1,1,-1
KR_6764619229,420,-1,-46,20,1,2,0,2,-1,2,1,2,1,3,-3,5,2,1,1,2,0,-6,7,4,-6,2,-5,0,-1,1,-1,-1,1,3,-1
KR_6768608339,420,3,-38,-14,4,1,1,2,6,1,7,2,2,4,-8,8,0,3,1,4,0,5,2,1,-7,6,3,0,-1,-1,1,-1,-1,6,-1
KR_6614474371,420,-7,-107,-33,-17,-2,4,2,-16,17,1,2,2,4,0,4,4,-1,1,0,-3,-21,-225,-2,-4,6,1,0,-1,-1,-1,-1,-1,3,-1
KR_6735924461,420,-2,-61,-24,-9,-5,6,1,-6,10,4,1,2,3,2,1,3,-1,1,0,0,-11,-9,-2,-6,8,-1,0,-1,-1,-1,-1,-1,1,-1
KR_6762518752,440,-2,-50,-27,-3,-3,5,2,-1,4,3,-1,2,1,1,0,1,1,0,1,0,-2,11,1,-4,3,2,0,0,0,-1,0,-1,0,-1
KR_6753401505,420,-1,-9,-20,3,3,0,3,-2,4,2,0,2,2,1,6,7,1,2,3,1,5,2,-6,-2,8,-2,0,0,1,0,0,1,6,-1
KR_6661272561,420,-5,-64,7,-11,-1,2,1,-4,6,2,3,2,5,-5,6,1,-4,4,0,0,-12,-12,2,-4,2,1,0,0,0,-1,-1,-1,0,-1
KR_6753939956,420,-4,-39,-12,-8,0,2,2,-8,9,1,3,2,5,-3,3,0,0,1,1,-1,-14,7,-2,-5,7,-3,0,-2,-1,-1,-1,-1,4,-1
KR_6765526859,440,-2,-8,-24,-3,1,2,3,-2,4,2,1,3,4,0,4,4,-3,4,1,1,-3,11,6,-10,4,-1,0,0,-1,1,0,1,5,-1
KR_6764172437,420,-3,-20,1,-6,2,0,2,-2,4,2,-7,10,3,1,2,3,0,0,0,0,-6,4,-5,-3,8,2,0,-1,1,1,-1,-1,6,-1
KR_6735837543,420,1,13,11,-6,1,1,2,0,3,3,-7,7,0,-2,2,0,2,0,2,-1,-6,-7,-3,-3,6,0,0,-1,-1,1,-1,-1,2,-1
KR_6747650938,420,-1,24,-14,-2,1,2,3,-3,4,1,1,2,3,-2,3,1,1,1,2,0,-11,11,4,-9,5,-4,0,0,-1,-1,1,1,1,-1
KR_6770945491,420,2,9,16,2,4,1,5,-3,5,2,0,2,2,2,2,4,-1,2,1,0,3,-6,0,-5,5,-1,0,0,1,1,0,-1,1,-1
KR_6695565942,420,-3,-19,-7,-3,0,2,2,-3,5,2,0,2,2,-1,4,3,1,0,1,0,-6,4,4,-7,3,-1,0,0,-1,-1,0,-1,1,-1
KR_6731547561,420,3,77,-12,-1,0,0,0,-1,4,3,2,4,6,-4,4,0,2,1,3,0,-11,3,-2,-7,9,2,0,-1,-1,-1,-1,-1,3,-1
KR_6762762193,420,-1,-9,-12,-7,-1,1,0,-1,3,2,-5,6,1,-1,3,2,1,0,1,0,-4,13,0,-6,6,-2,0,0,-1,-1,1,1,6,-1
KR_6705928168,420,-1,40,-6,-6,-4,5,1,-1,3,2,0,2,2,-1,2,1,0,0,0,0,-11,28,1,-6,5,-4,0,0,-1,1,0,-1,5,-1
KR_6759751675,420,-8,-85,-40,-20,-1,1,0,-2,3,1,-2,5,3,-10,11,1,-5,5,0,0,-30,284,-2,-3,5,-4,0,-2,1,-1,-1,-1,4,-1
KR_6766069311,420,2,5,24,-5,-3,4,1,-1,3,2,-2,2,0,-1,3,2,2,0,2,-2,-5,-70,2,-7,5,4,0,0,-1,0,0,-1,4,-1
KR_6714635807,420,-3,-18,2,-13,-2,4,2,0,6,6,-8,9,1,-2,2,0,-1,2,1,0,-10,-3,0,-4,4,-5,0,0,-1,-1,-1,1,2,-1
KR_6671441591,420,-2,-49,4,-4,-2,2,0,2,1,3,0,3,3,-6,7,1,2,0,2,-1,-2,10,0,-6,6,-4,0,0,-1,1,0,-1,4,-1
KR_6761709879,440,-5,-43,0,-9,-2,5,3,-4,4,0,0,5,5,-1,2,1,-2,3,1,0,-8,-52,0,-8,8,22,0,-1,0,0,-1,-1,0,-1
KR_6765498551,420,-2,-54,1,-3,3,0,3,-2,4,2,-1,2,1,0,1,1,-3,3,0,0,-9,27,2,-10,8,-4,0,0,-1,-1,0,1,5,-1
KR_6759843944,420,-1,-58,-12,-1,2,0,2,-1,2,1,-1,1,0,1,2,3,-2,3,1,0,1,18,6,-8,2,2,0,1,-1,1,1,-1,4,-1
KR_6738527445,420,0,24,-20,-1,1,1,2,2,3,5,-4,4,0,-1,2,1,1,0,1,0,-1,1,-3,-4,7,1,0,0,-1,1,0,1,3,-1
KR_6761122931,420,-2,-70,0,-14,-3,4,1,-3,4,1,-4,5,1,-3,4,1,-1,2,1,0,-14,32,-3,-3,6,-2,0,-1,1,-1,-1,-1,2,-1
KR_6765001494,420,-2,-42,-18,-9,-5,8,3,-4,5,1,-3,4,1,-1,4,3,4,1,5,-1,-7,-1,2,-5,3,1,0,-1,0,-1,-1,1,0,-1
KR_6668912902,440,-2,-41,12,-2,-3,4,1,1,0,1,-2,3,1,2,1,3,0,1,1,0,1,3,1,-2,1,-1,0,0,-1,0,-1,-1,2,-1
KR_6756284154,420,-2,63,-10,-8,2,0,2,1,2,3,-2,5,3,-8,8,0,-1,1,0,0,-10,181,1,-8,7,-4,0,-2,-1,-1,-1,-1,1,-1
KR_6744324712,420,-3,-40,6,4,4,1,5,-2,4,2,-1,4,3,1,2,3,2,0,2,1,8,2,4,-10,6,-2,0,-1,1,-1,-1,1,2,-1
KR_6761389196,440,-2,-72,12,-3,-1,2,1,1,1,2,2,0,2,3,0,3,-8,8,0,0,-3,20,-2,-5,7,-1,0,-1,1,-1,-1,1,1,-1
KR_6736889338,420,4,-18,14,5,7,0,7,-1,4,3,3,1,4,-3,4,1,-1,1,0,1,2,23,3,-6,3,0,0,1,-1,1,1,1,4,-1
KR_6767735574,420,-1,-20,3,-4,-2,2,0,-1,3,2,0,2,2,0,1,1,-1,2,1,0,-13,-5,-7,-2,9,0,0,-1,1,0,-1,-1,6,-1
KR_6676467531,420,-3,-42,-36,-12,-6,6,0,-4,5,1,0,1,1,-2,2,0,0,1,1,0,-8,-16,-4,-1,5,-2,0,-3,-1,-1,-1,-1,4,-1
KR_6761718569,420,-4,13,-4,-10,1,2,3,-5,5,0,-2,2,0,-4,4,0,0,2,2,0,-11,7,5,-9,4,-9,0,-2,-1,1,-1,1,3,-1
KR_6764665135,420,2,30,4,4,1,2,3,-1,5,4,1,1,2,3,1,4,0,1,1,0,-3,-64,2,-7,5,1,0,0,1,1,0,1,6,-1
KR_6736069706,420,1,36,-24,0,0,1,1,2,1,3,-3,8,5,2,1,3,-1,1,0,0,5,3,1,-6,5,2,0,1,0,-1,1,1,0,-1
KR_6754574815,420,5,94,2,6,5,0,5,-1,5,4,-5,6,1,3,3,6,4,2,6,0,-7,-18,1,-3,2,4,0,1,1,1,1,-1,2,-1
KR_6761385589,420,1,22,-4,-2,1,1,2,2,0,2,-2,5,3,-3,3,0,0,1,1,-1,-9,6,2,-6,4,1,0,0,1,1,1,-1,1,-1
KR_6680583176,420,-1,5,-25,-1,1,0,1,-4,5,1,0,3,3,2,1,3,0,0,0,0,1,2,5,-6,1,2,0,-1,1,-1,-1,1,2,-1
KR_6763657194,420,-3,-14,5,-7,1,3,4,0,5,5,2,3,5,-7,7,0,-3,3,0,0,-15,9,1,-5,4,-2,0,1,-1,0,1,1,1,-1
KR_6748113201,420,3,46,2,6,3,0,3,5,3,8,0,3,3,-2,4,2,0,1,1,0,4,-44,-3,-3,6,21,0,0,-1,-1,1,-1,5,-1
KR_6755357074,420,-3,-70,-27,-9,1,2,3,-4,6,2,-1,2,1,-1,3,2,-4,4,0,0,-5,-129,2,-5,3,0,0,-3,-1,-1,-1,-1,2,-1
KR_6750307069,420,-4,-53,-17,-8,1,0,1,-1,6,5,3,3,6,-9,11,2,-2,2,0,-1,-17,-2,2,-11,9,6,0,0,-1,-1,-1,-1,3,-1
KR_6733753653,440,-3,-88,-5,2,3,0,3,-4,7,3,7,2,9,-2,4,2,-2,4,2,0,7,-14,1,-8,7,-2,0,1,-1,1,1,-1,3,-1
KR_6703724968,420,-3,-59,-12,-10,0,1,1,-2,5,3,0,4,4,-7,7,0,-1,2,1,0,-11,-5,1,-6,5,-4,0,0,-1,1,1,1,6,-1
KR_6770819104,420,-1,-14,4,-1,-3,6,3,1,3,4,2,2,4,-2,4,2,1,0,1,1,0,10,3,-7,4,-4,0,1,-1,1,1,1,4,-1
KR_6765945084,440,-4,-54,8,-9,1,0,1,0,0,0,-6,6,0,-1,1,0,-3,3,0,0,-12,9,2,-5,3,-6,0,1,-1,1,-1,1,3,-1
KR_6734711834,420,-1,-8,5,-7,3,1,4,0,2,2,1,2,3,-7,10,3,-4,4,0,0,-13,4,0,-5,5,-7,0,0,1,1,1,1,5,-1
KR_6769442536,420,-1,-61,18,-3,-3,3,0,3,0,3,0,4,4,-4,11,7,1,1,2,0,-7,1,2,-7,5,1,0,-1,-1,-1,-1,-1,6,-1
KR_6752480599,420,-4,-86,-45,-3,1,1,2,-1,3,2,-1,5,4,-3,6,3,1,0,1,-1,-14,0,2,-6,4,-5,0,-1,-1,-1,-1,-1,5,-1
KR_6763438946,420,-3,-5,4,-11,0,0,0,-4,7,3,-5,6,1,0,3,3,-2,2,0,0,-17,-4,1,-6,5,1,0,-3,1,-1,-1,-1,2,-1
KR_6748227829,420,-1,33,4,-4,-1,3,2,-2,5,3,-2,6,4,1,0,1,0,0,0,-1,-2,13,-1,-4,5,0,0,0,1,1,1,-1,6,-1
KR_6751155877,420,-1,21,-7,3,0,1,1,-2,2,0,-3,6,3,7,0,7,1,0,1,0,5,2,0,-5,5,-2,0,1,1,-1,1,-1,2,-1
KR_6754913991,420,-5,-81,-31,-21,-1,3,2,-5,5,0,-1,1,0,-4,6,2,-10,10,0,-3,-28,4,-5,-3,8,-1,0,-4,-1,-1,-1,-1,5,-1
KR_6769778651,420,-1,-86,-20,1,-5,5,0,3,2,5,0,4,4,2,0,2,1,0,1,0,12,-3,-1,-2,3,0,0,-2,-1,-1,-1,-1,5,-1
KR_6642737069,420,-3,-44,-35,-6,-2,2,0,-2,4,2,-2,3,1,0,3,3,0,1,1,-1,-11,-8,2,-5,3,4,0,-1,1,-1,-1,-1,3,-1
KR_6768289893,420,1,30,9,0,1,3,4,-4,4,0,0,0,0,0,5,5,3,1,4,0,-1,77,0,-3,3,-15,0,0,-1,1,0,1,4,-1
KR_6770516237,420,1,46,4,-3,6,0,6,-4,5,1,-2,3,1,1,2,3,-4,5,1,0,-8,2,0,-5,5,-4,0,0,-1,1,1,-1,6,-1
KR_6768252333,420,-1,9,-12,-4,-1,3,2,-3,5,2,-1,2,1,-1,3,2,2,0,2,0,-2,0,-5,-2,7,-4,0,0,0,0,0,-1,0,-1
KR_6768735832,420,-4,18,-20,-8,0,1,1,0,3,3,-5,6,1,-2,5,3,-1,1,0,-1,-17,-2,-1,-6,7,-3,0,0,-1,1,-1,-1,5,-1
KR_6769624941,420,-3,-56,-5,-5,-2,4,2,0,2,2,-2,2,0,-1,2,1,0,0,0,0,-5,-7,-2,-4,6,10,0,-1,-1,-1,-1,1,1,-1
KR_6769774061,420,-1,31,13,-5,-1,2,1,-1,3,2,0,1,1,-6,6,0,3,0,3,0,-6,11,1,-7,6,-4,0,0,-1,1,0,1,6,-1
KR_6760693453,420,-3,-57,-1,-13,-2,4,2,-6,7,1,1,1,2,-9,10,1,3,0,3,-2,-9,-5,-2,-4,6,2,0,-2,-1,-1,-1,-1,5,-1
KR_6734676538,420,-1,-39,3,-1,1,3,4,1,4,5,-1,2,1,-3,7,4,1,2,3,1,-3,-113,1,-6,5,0,0,-1,-1,1,-1,1,6,-1
KR_6740772734,420,2,-55,-1,7,2,1,3,-2,3,1,0,1,1,6,0,6,1,1,2,0,9,8,-1,-4,5,0,0,0,1,1,1,1,1,-1
KR_6717815459,420,-2,-5,-3,-4,-2,5,3,0,4,4,-1,5,4,-2,4,2,1,1,2,0,10,11,-5,-5,10,2,0,-1,1,-1,-1,1,3,-1
KR_6654043465,440,1,28,-3,1,-1,1,0,3,1,4,0,0,0,1,0,1,-2,3,1,0,4,-3,-1,-4,5,2,0,-1,-1,-1,-1,-1,2,-1
KR_6740933709,420,1,34,4,-4,-2,3,1,-5,6,1,2,2,4,0,2,2,1,0,1,0,-4,-10,-1,-3,4,-2,0,1,1,-1,1,-1,4,-1
KR_6768544306,420,2,-7,-35,3,4,1,5,2,3,5,0,1,1,-4,4,0,1,1,2,0,7,21,-2,-4,6,-3,0,1,1,-1,1,-1,1,-1
KR_6770433637,440,-4,-10,-7,-8,-2,2,0,4,4,8,-10,10,0,-1,9,8,1,3,4,0,-19,-104,2,-4,2,-1,0,-1,1,-1,-1,1,6,-1
KR_6765152256,420,-2,-68,5,4,0,0,0,-3,7,4,3,1,4,2,1,3,2,0,2,0,8,-5,-3,-6,9,22,0,-1,-1,1,-1,1,3,-1
KR_6769683467,440,1,-52,-1,-3,-2,2,0,-3,4,1,-3,4,1,2,0,2,3,1,4,0,4,85,5,-7,2,-7,0,0,1,-1,-1,-1,3,-1
KR_6423499665,420,-5,-40,-25,-2,-1,4,3,-3,6,3,0,3,3,2,1,3,0,0,0,0,0,-9,-3,-4,7,-3,0,-1,-1,-1,-1,1,3,-1
KR_6770532497,420,0,97,24,-2,0,0,0,0,2,2,3,1,4,-3,4,1,-2,2,0,0,-6,54,0,-8,8,-16,0,2,-1,1,1,-1,6,-1
KR_6679948448,420,1,-22,-28,4,-1,1,0,4,1,5,-1,4,3,1,1,2,1,0,1,0,10,1,2,-3,1,1,0,1,-1,1,1,-1,4,-1
KR_6742193754,440,1,39,-24,5,2,1,3,3,1,4,5,1,6,-3,4,1,-2,2,0,1,-1,42,2,-6,4,-11,0,0,-1,-1,0,1,4,-1
KR_6769586829,420,0,-60,41,-5,2,1,3,-6,9,3,0,1,1,-3,3,0,2,0,2,0,-2,2,-5,-3,8,-6,0,1,-1,1,-1,-1,3,-1
KR_6765721092,420,-4,-75,-28,-12,1,1,2,-5,6,1,2,0,2,-6,7,1,-4,4,0,0,-15,11,-1,-6,7,-8,0,-2,-1,-1,-1,-1,3,-1
KR_6762851602,440,1,8,-11,-2,0,2,2,2,4,6,0,4,4,-2,2,0,-2,2,0,0,-4,-297,-7,-4,11,4,0,0,1,-1,1,-1,1,-1
KR_6768883631,420,0,-11,16,2,1,2,3,-1,4,3,3,1,4,-2,4,2,1,0,1,1,9,-31,1,-6,5,-1,0,0,1,-1,-1,1,2,-1
KR_6732846407,420,1,-31,-29,-1,2,0,2,-3,4,1,2,2,4,-2,2,0,0,2,2,0,-5,-22,0,-6,6,-6,0,0,-1,1,0,-1,6,-1
KR_6762454969,420,1,11,8,1,-2,3,1,4,0,4,-2,6,4,0,2,2,1,0,1,0,-2,-4,-3,-6,9,3,0,-1,-1,1,-1,-1,4,-1
KR_6730995302,420,-2,-21,-12,-1,-5,5,0,-3,3,0,1,2,3,2,0,2,4,0,4,0,1,7,0,-8,8,4,0,0,1,-1,0,1,4,-1
KR_6704393703,420,-1,-63,-9,-7,-4,5,1,-3,4,1,2,0,2,-1,3,2,-1,1,0,0,-9,178,-2,-6,8,-3,0,-3,-1,-1,-1,-1,4,-1
KR_6711920604,420,-1,15,-6,8,-1,2,1,2,1,3,2,4,6,3,2,5,2,1,3,0,13,-102,-2,-5,7,2,0,1,-1,-1,1,1,6,-1
KR_6751028787,440,-2,-63,-40,-15,-2,2,0,-4,7,3,-5,7,2,3,2,5,-7,8,1,0,-8,6,3,-7,4,-5,0,-3,-1,-1,-1,1,2,-1
KR_6692396496,420,0,47,11,-1,-1,3,2,4,3,7,-1,3,2,-1,4,3,-2,3,1,0,2,-1,-1,-5,6,-4,0,-1,1,-1,-1,-1,1,-1
KR_6768958071,420,1,41,17,-3,1,2,3,-2,3,1,1,1,2,-3,4,1,0,1,1,0,-7,-17,-3,-4,7,-3,0,-1,-1,1,-1,-1,5,-1
KR_6662124378,420,-4,-48,-28,-9,0,1,1,-1,2,1,-3,4,1,-5,8,3,0,0,0,0,-11,-32,-3,-5,8,-3,0,0,-1,-1,-1,-1,4,-1
KR_6765662832,440,-2,-3,-19,-6,-1,5,4,2,3,5,-6,6,0,-2,4,2,1,2,3,0,-4,0,-3,-1,4,0,0,-1,1,-1,-1,1,1,-1
KR_6716907146,420,-6,-41,-8,-15,-3,4,1,-8,9,1,-2,3,1,1,0,1,-3,3,0,0,-10,-4,-4,-2,6,-3,0,-1,1,-1,-1,-1,6,-1
KR_6761788011,440,4,73,20,7,6,0,6,-3,5,2,1,2,3,-7,8,1,10,1,11,0,-2,9,-1,-4,5,-1,0,3,-1,1,1,-1,6,-1
KR_6694030051,420,0,8,-12,10,11,1,12,-2,4,2,4,0,4,-2,3,1,-1,1,0,1,-3,36,-2,-6,8,-26,0,1,-1,1,1,1,2,-1
KR_6746399895,440,-6,-124,2,-19,-9,10,1,-1,3,2,0,3,3,-3,4,1,-6,7,1,-1,-24,-6,-5,-2,7,2,0,-2,1,-1,-1,1,6,-1
KR_6722839270,420,4,51,-9,0,0,2,2,1,1,2,-3,6,3,4,1,5,-2,2,0,0,4,51,4,-8,4,-25,0,1,-1,-1,1,-1,5,-1
KR_6767739031,420,0,-19,-20,-3,2,0,2,2,4,6,-3,3,0,-4,4,0,0,0,0,0,-10,-7,-7,-1,8,4,0,0,-1,1,0,1,3,-1
KR_6738141329,420,-6,-52,-30,-13,-7,7,0,-1,3,2,-3,4,1,1,0,1,-3,3,0,0,-5,-1,-2,-5,7,-8,0,-3,-1,-1,-1,-1,1,-1
KR_6767427010,420,-5,38,-44,-9,-3,3,0,-1,2,1,-3,4,1,-2,2,0,0,2,2,0,-9,-24,1,-5,4,4,0,-1,-1,-1,-1,-1,3,-1
KR_6743186880,420,-2,14,-5,-4,2,1,3,-4,5,1,-2,3,1,1,2,3,-1,1,0,-1,-3,4,-6,-2,8,-3,0,0,-1,1,1,-1,6,-1
KR_6764825067,420,-5,-9,-30,-10,-1,3,2,-4,4,0,-3,4,1,0,1,1,-2,3,1,0,-5,-5,-4,-2,6,-1,0,0,-1,-1,-1,-1,5,-1
KR_6767343441,420,-2,-69,-1,-7,0,0,0,3,2,5,-5,6,1,-5,6,1,0,0,0,-2,-12,-6,-5,-4,9,-4,0,-1,-1,-1,-1,-1,4,-1
KR_6760358166,420,-3,-86,0,-6,-2,2,0,-6,8,2,1,2,3,1,1,2,0,1,1,0,-5,-24,-5,-5,10,0,0,-2,1,-1,-1,1,5,-1
KR_6759789376,440,-1,49,-36,-8,0,0,0,-7,7,0,1,3,4,-2,4,2,0,1,1,-1,-7,-18,-3,-2,5,1,0,1,-1,1,1,-1,4,-1
KR_6706978424,440,2,66,18,-3,3,1,4,-4,4,0,1,2,3,-3,6,3,0,1,1,0,-7,14,1,-7,6,-3,0,1,1,1,1,1,3,-1
KR_6759046807,420,-4,-9,-23,-7,-4,5,1,-1,5,4,1,3,4,-3,4,1,0,0,0,0,-2,3,2,-5,3,-5,0,0,-1,1,-1,1,2,-1
KR_6624514823,420,-5,-59,-32,-5,-10,10,0,1,1,2,6,1,7,-1,3,2,-1,1,0,0,6,7,1,-6,5,2,0,-2,-1,-1,-1,-1,1,-1
KR_6735239276,420,0,-40,16,-7,-1,4,3,1,2,3,3,1,4,0,1,1,-10,10,0,0,-8,1,1,-8,7,1,0,1,1,1,1,-1,5,-1
KR_6750896067,420,-1,-5,10,-10,2,1,3,0,2,2,-8,8,0,-3,3,0,-1,1,0,0,-18,-7,-1,-4,5,-6,0,-2,-1,-1,-1,-1,6,-1
KR_6745650340,420,-1,-33,-15,-5,-1,3,2,-4,5,1,-1,1,0,1,2,3,0,1,1,0,-7,-63,-3,-3,6,10,0,0,-1,1,1,-1,2,-1
KR_6767697822,440,-6,-144,-7,-2,0,1,1,1,3,4,-2,4,2,0,1,1,-1,2,1,0,-1,-5,0,-1,1,-1,0,-1,0,0,-1,-1,0,-1
KR_6770117243,420,-1,-6,-3,-4,-1,2,1,0,2,2,0,1,1,-1,5,4,-2,3,1,0,-1,-5,-6,-1,7,0,0,0,1,-1,0,-1,2,-1
KR_6760258529,420,2,-20,-2,4,0,1,1,2,1,3,-1,5,4,-1,3,2,4,0,4,0,1,282,0,-3,3,-3,0,1,1,-1,1,-1,6,-1
KR_6745926945,420,-3,-36,-26,-4,-6,7,1,-1,2,1,4,5,9,-1,5,4,0,0,0,2,1,1,-3,-4,7,2,0,0,1,-1,-1,1,5,-1
KR_6676233792,420,-3,-19,17,-3,-2,3,1,0,4,4,2,1,3,-1,3,2,-2,2,0,0,-3,-5,4,-6,2,0,0,0,1,-1,0,-1,1,-1
KR_6753884777,420,-2,-29,-28,-11,-2,3,1,1,3,4,-5,6,1,-3,3,0,-2,2,0,-2,-15,-12,-4,-2,6,1,0,-2,-1,-1,-1,-1,2,-1
KR_6692366686,440,0,30,8,-5,-1,2,1,-3,4,1,5,0,5,-5,7,2,-1,2,1,0,3,-21,3,-7,4,0,0,-2,-1,1,-1,-1,5,-1
KR_6764516875,420,-2,-47,-37,-2,1,0,1,-2,5,3,0,5,5,1,5,6,-2,3,1,-1,1,-4,1,-7,6,-3,0,0,-1,-1,-1,-1,2,-1
KR_6770213020,420,-1,-6,-9,0,-2,3,1,4,1,5,-1,3,2,-1,5,4,0,1,1,1,9,-6,-3,-2,5,1,0,0,-1,-1,1,1,1,-1
KR_6718688728,420,-3,43,-28,-2,0,1,1,-5,7,2,1,1,2,0,3,3,2,1,3,0,-4,-13,-6,-1,7,1,0,-1,-1,-1,-1,1,6,-1
KR_6699508202,420,0,-6,24,-3,-1,2,1,2,2,4,1,1,2,-5,8,3,0,2,2,0,-3,7,3,-11,8,-7,0,0,1,-1,0,1,3,-1
KR_6767760021,420,1,39,12,-1,2,0,2,2,0,2,3,0,3,-8,8,0,0,0,0,0,-2,-4,4,-11,7,5,0,1,1,1,1,1,2,-1
KR_6726382225,420,-2,-32,28,-6,-6,7,1,1,4,5,4,2,6,-3,3,0,-2,2,0,0,-8,-2,-1,-5,6,-1,0,-2,1,1,-1,1,5,-1
KR_6764255833,420,-1,-47,-40,6,5,0,5,0,0,0,6,0,6,-6,7,1,1,0,1,0,8,-4,6,-8,2,0,0,1,-1,-1,-1,1,1,-1
KR_6722283939,420,-1,23,-9,-1,-1,4,3,2,2,4,-4,4,0,2,2,4,0,1,1,0,3,-3,-1,-3,4,1,0,1,1,1,1,1,6,-1
KR_6742531783,440,-1,-4,-18,-5,-1,3,2,-2,3,1,-5,7,2,1,0,1,2,1,3,0,-15,-8,-2,-4,6,1,0,0,0,1,-1,1,0,-1
KR_6766606473,420,-1,-56,-10,-7,1,0,1,-1,2,1,-1,2,1,-5,8,3,-1,2,1,0,-13,-1,-1,-4,5,-1,0,-1,-1,-1,-1,-1,4,-1
KR_6770567084,420,-2,9,-24,1,-1,1,0,2,2,4,-1,2,1,1,1,2,0,0,0,0,-1,7,4,-6,2,0,0,0,1,-1,0,1,3,-1
KR_6737135227,420,1,33,2,3,1,3,4,2,3,5,1,3,4,2,1,3,-3,3,0,-2,-1,70,-1,-3,4,4,0,1,1,1,1,-1,1,-1
KR_6768962315,420,0,13,23,-5,-2,4,2,-1,3,2,4,1,5,-2,5,3,-4,5,1,0,-6,-2,3,-6,3,-1,0,-1,1,-1,-1,1,6,-1
KR_6749526090,420,-1,39,-10,0,-6,7,1,2,4,6,0,0,0,1,2,3,3,0,3,1,14,-5,-3,-4,7,4,0,-1,1,1,1,1,2,-1
KR_6749618397,420,-7,-94,-36,-12,-4,5,1,-1,1,0,-4,4,0,-1,2,1,-2,3,1,0,-8,1,-1,-4,5,3,0,-1,1,-1,-1,-1,4,-1
KR_6716333682,420,1,-50,-12,9,1,0,1,5,5,10,2,0,2,-4,4,0,5,0,5,0,11,14,0,-5,5,1,0,0,1,-1,1,1,6,-1
KR_6740360793,420,-4,-104,3,-7,-6,6,0,0,3,3,-1,2,1,0,2,2,0,2,2,1,-6,-10,-4,-5,9,-5,0,-3,1,-1,-1,1,2,-1
KR_6709708490,440,0,-45,-9,-6,-3,3,0,-3,5,2,-2,2,0,3,1,4,-1,1,0,0,-3,2,-4,-5,9,1,0,-1,-1,-1,-1,1,2,-1
KR_6718263276,420,-1,-18,-12,-5,-4,4,0,1,0,1,-1,1,0,-2,2,0,1,3,4,0,-2,3,2,-4,2,-1,0,-1,-1,-1,-1,-1,2,-1
KR_6686351957,420,-1,-6,13,-4,-2,4,2,2,4,6,1,2,3,-7,7,0,2,1,3,-1,1,-2,-1,-10,11,0,0,1,-1,-1,1,-1,5,-1
KR_6741596288,420,-3,-9,-19,1,-7,7,0,0,5,5,5,2,7,2,0,2,1,0,1,-2,5,0,6,-9,3,-4,0,0,-1,1,1,-1,1,-1
KR_6767940895,420,-5,-105,-19,-8,-1,3,2,-3,6,3,-3,3,0,-1,1,0,0,1,1,0,-10,-36,-5,-1,6,-8,0,-1,1,1,-1,1,1,-1
KR_6766600564,420,-1,-50,4,-1,-2,2,0,-1,1,0,-1,1,0,1,0,1,2,0,2,0,3,6,0,-6,6,-3,0,-1,1,-1,-1,-1,6,-1
KR_6748086507,420,-2,-36,-43,0,-1,1,0,2,2,4,1,3,4,-3,5,2,1,1,2,0,14,15,-2,-6,8,-20,0,1,-1,1,1,-1,1,-1
KR_6746205974,420,-4,-23,7,-9,0,1,1,-1,4,3,-4,4,0,3,3,6,-7,7,0,-1,-16,-44,-1,-2,3,19,0,0,1,1,1,-1,3,-1
KR_6764557382,420,-3,-46,-4,-7,-2,2,0,3,2,5,2,1,3,-7,8,1,-3,4,1,0,-12,-2,0,-5,5,-8,0,-1,-1,1,-1,1,4,-1
KR_6740747537,420,-1,20,-9,-5,-1,3,2,-3,4,1,0,4,4,-2,3,1,1,2,3,0,-6,-8,0,-4,4,1,0,0,1,0,0,-1,5,-1
KR_6717120583,420,-3,39,-20,-6,3,0,3,-4,6,2,-2,3,1,-3,6,3,0,0,0,0,-8,-97,-2,-7,9,3,0,0,1,1,-1,-1,3,-1
KR_6770448113,420,-2,7,-23,0,-1,3,2,2,2,4,3,3,6,0,4,4,-4,4,0,1,4,-138,1,-7,6,5,0,0,1,-1,-1,1,3,-1
KR_6736449056,420,-3,-31,3,-10,-3,5,2,2,1,3,-6,8,2,-2,3,1,-1,2,1,-2,-9,-35,3,-9,6,3,0,-2,-1,0,-1,-1,1,-1
KR_6764138280,420,-2,-34,30,-2,-1,2,1,-2,3,1,3,2,5,-1,3,2,-1,1,0,-1,-7,14,-1,-5,6,6,0,0,1,1,0,1,1,-1
KR_6768445113,420,-5,-63,-2,-17,-14,15,1,-1,2,1,0,5,5,-3,3,0,1,0,1,0,-14,-8,-2,-3,5,-2,0,-3,-1,-1,-1,-1,3,-1
KR_6751446841,420,0,5,-4,-3,0,1,1,-4,8,4,-1,2,1,2,1,3,0,0,0,-1,-10,-5,3,-7,4,-2,0,1,-1,1,1,-1,5,-1
KR_6754860700,420,-1,-25,-12,5,2,2,4,1,0,1,2,0,2,1,3,4,-1,1,0,0,7,-7,-2,-3,5,1,0,0,-1,-1,-1,-1,5,-1
KR_6692194441,420,-7,-61,-5,-19,-3,4,1,3,2,5,-4,6,2,-12,12,0,-3,3,0,0,-16,-51,-6,0,6,7,0,-3,-1,1,-1,-1,3,-1
KR_6756715907,440,-2,-33,-15,-9,-2,3,1,1,1,2,1,3,4,-4,4,0,-5,6,1,0,-11,-22,-5,-3,8,3,0,-1,-1,-1,-1,-1,2,-1
KR_6706553937,420,-2,-16,-54,-7,-2,6,4,-1,2,1,-1,3,2,-3,4,1,0,0,0,0,-1,-5,1,-6,5,-3,0,-2,-1,-1,-1,-1,2,-1
KR_6718407175,420,-3,-60,-7,-9,-3,3,0,-1,2,1,-1,4,3,-2,2,0,-2,3,1,0,-8,-1,-2,-3,5,-1,0,-2,-1,-1,-1,-1,3,-1
KR_6710560922,420,-3,-32,-31,-8,-5,5,0,-3,5,2,1,4,5,-7,8,1,6,2,8,0,-3,5,3,-8,5,0,0,-2,-1,-1,-1,-1,4,-1
KR_6755513425,420,-4,-62,-4,-14,-2,2,0,-6,8,2,0,0,0,-5,6,1,-1,2,1,0,-11,73,2,-8,6,0,0,0,-1,-1,-1,-1,3,-1
KR_6548477606,440,-2,-98,-22,-5,0,2,2,-1,1,0,-4,6,2,-2,3,1,2,2,4,0,-7,2,4,-7,3,-2,0,-1,1,-1,-1,-1,6,-1
KR_6737157350,440,-2,-36,-25,3,-1,1,0,-1,1,0,2,0,2,2,0,2,1,2,3,0,11,17,4,-8,4,-2,0,0,1,-1,0,1,2,-1
KR_6765194003,420,0,16,-8,-8,-7,7,0,1,4,5,1,1,2,-1,3,2,-2,3,1,0,-6,-42,-6,-3,9,2,0,1,0,1,1,-1,0,-1
KR_6757789957,440,-2,-4,-22,-2,-1,2,1,0,2,2,0,4,4,-1,3,2,0,1,1,0,2,-33,-1,-3,4,18,0,0,-1,-1,0,1,5,-1
KR_6723654641,420,-3,-11,-31,-5,1,2,3,1,2,3,-3,6,3,-2,5,3,-2,2,0,0,-15,207,3,-6,3,-3,0,-2,-1,-1,-1,1,5,-1
KR_6766276273,420,-1,-26,4,-1,0,1,1,0,1,1,1,1,2,-4,6,2,2,0,2,0,-2,-31,-2,-4,6,-3,0,0,1,1,1,-1,4,-1
KR_6761828344,420,2,-15,-4,2,0,1,1,5,2,7,2,0,2,-4,5,1,-1,3,2,0,2,10,4,-8,4,-7,0,-1,-1,1,-1,1,4,-1
KR_6684748427,420,-7,-67,-11,-22,-6,7,1,-4,4,0,-5,6,1,-5,5,0,-2,2,0,0,-21,-15,-6,-1,7,0,0,-1,-1,-1,-1,1,1,-1
KR_6769151002,420,1,-12,-3,0,-1,1,0,7,1,8,-3,5,2,-3,5,2,0,1,1,1,3,17,7,-13,6,-4,0,0,1,1,0,1,2,-1
KR_6758651175,420,-4,-49,-47,5,-2,5,3,0,7,7,0,5,5,6,0,6,1,0,1,0,10,3,4,-8,4,-4,0,0,1,-1,0,-1,5,-1
KR_6744266747,420,3,22,9,5,-1,1,0,1,4,5,4,2,6,1,1,2,0,1,1,0,4,-12,0,-3,3,0,0,2,1,1,1,1,2,-1
KR_6767461150,420,4,78,-4,7,1,2,3,1,1,2,-4,4,0,9,1,10,0,1,1,0,7,-16,3,-6,3,8,0,0,1,1,0,1,2,-1
KR_6768201667,420,1,22,18,10,4,1,5,4,2,6,-2,5,3,5,2,7,-1,1,0,0,18,50,0,-7,7,-5,0,1,1,-1,1,-1,3,-1
KR_6731339033,420,0,34,15,1,0,1,1,-3,6,3,0,1,1,5,0,5,-1,1,0,2,3,-24,1,-6,5,6,0,0,1,-1,0,1,3,-1
KR_6620174887,440,-5,15,8,0,-2,3,1,6,2,8,2,1,3,-8,9,1,2,0,2,0,-10,6,5,-8,3,0,0,1,1,-1,-1,1,3,-1
KR_6761705348,440,-1,56,3,-5,5,3,8,-1,3,2,-4,6,2,-5,6,1,0,1,1,0,-9,-2,0,-4,4,-1,0,1,1,-1,1,1,1,-1
KR_6747691834,440,1,19,-30,3,-1,2,1,-1,1,0,-2,7,5,-2,2,0,9,0,9,0,-1,9,1,-5,4,1,0,1,1,1,1,1,1,-1
KR_6677835823,420,-2,-64,-21,-2,0,1,1,-5,5,0,1,3,4,1,4,5,1,0,1,0,-5,-9,2,-6,4,1,0,1,1,1,1,-1,3,-1
KR_6770742625,420,0,10,-8,-5,-3,3,0,-2,4,2,-1,2,1,1,2,3,0,1,1,0,-4,-20,5,-8,3,4,0,0,-1,-1,0,-1,2,-1
KR_6644710128,420,-3,-39,10,-8,-1,3,2,1,2,3,-9,10,1,3,3,6,-2,3,1,0,-6,-3,-2,-3,5,3,0,-1,-1,0,-1,-1,5,-1
KR_6762946675,420,-3,-55,-4,-4,-2,3,1,3,3,6,-3,4,1,-2,3,1,0,1,1,0,0,3,4,-9,5,1,0,0,-1,-1,-1,-1,1,-1
KR_6667687505,420,-2,-17,16,1,8,1,9,-3,4,1,-3,4,1,-2,5,3,1,0,1,0,-10,-38,-1,-5,6,15,0,1,-1,0,1,1,2,-1
KR_6741255706,420,-2,30,-19,-6,0,1,1,-1,6,5,-3,6,3,3,1,4,-5,7,2,-1,-15,6,-5,-4,9,1,0,1,-1,1,1,-1,5,-1
KR_6670855626,440,-5,-31,-35,-8,1,2,3,-9,9,0,-4,5,1,0,1,1,4,1,5,0,-11,101,-1,-5,6,-2,0,-1,1,-1,-1,1,2,-1
KR_6701668118,420,-3,-44,-12,-11,-2,3,1,-2,4,2,-9,9,0,3,1,4,-1,1,0,0,-4,1,2,-7,5,-6,0,-2,-1,1,-1,1,1,-1
KR_6740655620,420,-2,-33,1,-5,-1,1,0,4,1,5,-4,4,0,-3,5,2,-1,2,1,-1,-6,1,0,-6,6,-5,0,0,1,-1,-1,-1,5,-1
KR_6682687577,440,-8,-113,-7,-14,-9,10,1,-4,5,1,-3,5,2,0,3,3,2,1,3,0,1,3,-3,-2,5,-1,0,-3,1,-1,-1,-1,2,-1
KR_6759628539,420,-2,-39,-12,-9,-2,3,1,-2,2,0,0,1,1,-4,4,0,-1,1,0,0,-7,-12,0,-6,6,-3,0,0,-1,1,0,-1,4,-1
KR_6481890497,420,-3,-46,16,-7,-5,6,1,-3,4,1,-1,3,2,1,2,3,1,2,3,0,-3,13,4,-10,6,0,0,1,-1,1,1,-1,2,-1
KR_6761792134,440,-2,-4,-4,-3,-1,3,2,1,2,3,1,1,2,-2,5,3,-2,2,0,0,0,13,0,-3,3,1,0,0,1,-1,0,-1,4,-1
KR_6712970477,420,-3,8,15,-9,-1,1,0,-2,4,2,-5,5,0,-1,2,1,0,1,1,1,1,-4,-2,-5,7,-2,0,0,1,-1,-1,1,1,-1
KR_6737291431,440,-1,-36,19,-14,3,2,5,-2,6,4,0,4,4,-11,12,1,-4,6,2,-1,-8,12,1,-4,3,-3,0,-3,-1,1,-1,1,2,-1
KR_6731161867,420,-2,-27,4,-8,-5,7,2,0,2,2,1,2,3,-3,5,2,-1,1,0,-1,-1,-5,-3,-4,7,-2,0,-1,-1,-1,-1,-1,4,-1
KR_6768742416,440,0,13,16,-4,1,2,3,1,2,3,-3,5,2,-1,4,3,-2,2,0,0,-7,-5,0,-7,7,1,0,-1,0,1,-1,1,0,-1
KR_6738458370,420,-2,10,-16,-4,1,2,3,1,3,4,-5,5,0,0,2,2,-1,1,0,0,-11,-4,-3,-2,5,-1,0,-1,-1,1,-1,-1,1,-1
KR_6761765526,420,-1,21,-24,-7,-1,1,0,-2,4,2,-4,4,0,-1,6,5,1,2,3,-2,-12,-13,-3,-4,7,-4,0,0,-1,1,0,-1,6,-1
KR_6764310090,420,-6,-10,12,-18,-2,3,1,-4,7,3,-10,11,1,-1,4,3,-1,1,0,0,-19,0,-5,-3,8,-4,0,0,1,-1,-1,-1,2,-1
KR_6769078402,420,0,-12,12,2,-2,2,0,4,0,4,0,2,2,0,4,4,0,0,0,-1,1,4,3,-6,3,-3,0,0,-1,1,0,-1,6,-1
KR_6705560296,440,-1,-42,-14,-5,-3,4,1,-4,5,1,1,1,2,0,3,3,1,0,1,0,1,-1,-3,-5,8,0,0,0,-1,1,0,-1,4,-1
KR_6767933867,420,-4,-37,16,-12,-4,4,0,-5,5,0,4,2,6,-5,5,0,-2,2,0,-3,-17,-9,-3,-1,4,-3,0,0,0,-1,0,-1,0,-1
KR_6766927595,420,-2,-1,8,-8,0,1,1,-6,6,0,0,2,2,-1,2,1,-1,1,0,0,-10,4,-1,-4,5,0,0,-1,-1,1,-1,-1,6,-1
KR_6768932439,420,-2,25,-9,-11,-2,4,2,-8,8,0,2,0,2,0,1,1,-3,5,2,-1,-9,122,-3,-4,7,0,0,0,1,1,1,-1,3,-1
KR_6767339475,420,2,80,-4,-3,-2,2,0,2,1,3,-5,5,0,4,1,5,-2,3,1,0,1,15,3,-8,5,-4,0,1,0,-1,1,1,0,-1
KR_6770493505,420,0,-2,-8,-3,-2,3,1,4,3,7,0,3,3,-2,6,4,-3,4,1,0,2,-9,-3,-5,8,-4,0,-1,1,-1,-1,-1,5,-1
KR_6732686875,420,1,26,-18,-5,-2,5,3,0,4,4,-2,5,3,-1,5,4,0,1,1,-1,-9,10,0,-7,7,-7,0,0,-1,1,1,-1,1,-1
KR_6682602712,420,-6,-27,-40,-9,-3,4,1,0,1,1,-3,3,0,-1,6,5,-2,2,0,0,-8,-8,-4,-1,5,-2,0,-2,-1,-1,-1,-1,5,-1
KR_6763932722,420,1,-51,14,1,-3,5,2,2,4,6,-1,3,2,0,2,2,3,0,3,0,-5,-3,-4,-5,9,-6,0,-1,1,-1,-1,-1,3,-1
KR_6763576861,440,-2,-41,-17,-4,-1,2,1,1,4,5,-1,2,1,-4,6,2,1,0,1,0,-3,200,1,-2,1,-2,0,0,-1,1,0,1,3,-1
KR_6746568484,420,1,-33,-15,2,0,1,1,0,3,3,-1,2,1,4,3,7,-1,2,1,0,1,-2,-1,-5,6,4,0,0,1,1,0,-1,1,-1
KR_6764880010,420,1,7,-4,2,-1,2,1,-1,2,1,0,1,1,3,1,4,1,1,2,1,3,33,4,-7,3,0,0,-1,-1,-1,-1,1,1,-1
KR_6662414927,420,1,38,0,2,2,2,4,-1,4,3,-1,2,1,-1,3,2,3,1,4,0,1,-6,-1,-6,7,-1,0,0,1,-1,1,1,5,-1
KR_6763543068,420,1,-62,0,4,0,1,1,2,2,4,-1,2,1,0,5,5,3,0,3,-1,6,-17,-2,-6,8,-2,0,1,1,-1,1,-1,4,-1
KR_6725069581,420,4,-14,-10,9,2,0,2,3,3,6,-1,5,4,3,0,3,2,0,2,0,9,3,-2,-1,3,1,0,2,1,1,1,1,5,-1
KR_6757935195,420,3,74,-9,4,-3,4,1,-1,4,3,2,1,3,6,0,6,0,0,0,0,5,-3,2,-4,2,3,0,0,-1,0,0,1,3,-1
KR_6759658319,420,-2,-49,6,1,-2,2,0,1,3,4,5,2,7,-2,5,3,-1,1,0,0,1,0,-4,-3,7,0,0,-1,1,1,-1,1,4,-1
KR_6764156907,420,-4,-34,-41,-4,3,1,4,1,0,1,-1,5,4,-9,11,2,2,0,2,0,-8,-12,-1,-3,4,5,0,-1,-1,-1,-1,1,3,-1
KR_6631246563,420,-4,-48,25,-1,-1,1,0,2,2,4,0,3,3,-2,6,4,0,1,1,1,-2,71,-4,-3,7,-2,0,-1,-1,-1,-1,1,3,-1
KR_6665249162,420,-2,30,-43,-4,-1,3,2,-2,6,4,-2,4,2,0,1,1,1,0,1,1,-1,-12,2,-8,6,-4,0,-2,1,-1,-1,1,1,-1
KR_6590833183,420,-1,2,2,-7,-3,4,1,-8,8,0,4,2,6,-1,2,1,1,0,1,0,-13,0,1,-5,4,-5,0,0,1,-1,0,1,5,-1
KR_6754104350,420,1,-37,-4,-2,2,1,3,3,1,4,-5,5,0,0,1,1,-2,2,0,-1,-4,29,7,-9,2,-9,0,0,-1,1,0,-1,5,-1
KR_6429987457,420,-4,-61,-56,-9,-2,2,0,-3,4,1,-9,10,1,4,0,4,1,0,1,0,1,5,1,-4,3,1,0,-2,-1,-1,-1,-1,6,-1
KR_6753893153,420,-2,-32,24,-5,-2,2,0,-5,7,2,5,3,8,-2,3,1,-1,1,0,0,-8,-1,-2,-3,5,-4,0,-1,-1,1,-1,-1,5,-1
KR_6762670689,420,-2,-59,-38,-7,3,1,4,-3,4,1,-1,3,2,-6,6,0,0,2,2,0,-13,-4,-3,-7,10,-1,0,-2,-1,-1,-1,-1,5,-1
KR_6760615910,420,-3,12,-26,-11,3,1,4,-3,4,1,-7,7,0,-5,7,2,1,0,1,-1,-21,-15,-3,-6,9,3,0,-3,-1,-1,-1,-1,5,-1
KR_6751375764,420,2,-39,15,5,-1,1,0,2,4,6,4,1,5,-2,3,1,2,2,4,0,4,-5,-2,-4,6,2,0,-1,1,-1,-1,1,5,-1
KR_6694300233,420,-7,-72,-25,-6,-5,5,0,-6,10,4,1,1,2,5,0,5,-1,1,0,0,4,3,0,-8,8,3,0,-1,-1,-1,-1,1,1,-1
KR_6755991817,420,-1,-1,4,-5,0,3,3,-3,3,0,2,3,5,-4,6,2,0,0,0,0,-10,-17,2,-6,4,0,0,-1,-1,-1,-1,1,2,-1
KR_6728122309,420,-4,-2,17,-12,-1,4,3,-5,6,1,-6,7,1,-1,2,1,1,2,3,1,-12,24,-4,-3,7,-3,0,0,1,-1,1,-1,5,-1
KR_6691343971,420,2,11,-5,1,5,2,7,4,3,7,-3,4,1,2,3,5,-7,7,0,-1,3,-2,0,-4,4,2,0,-1,-1,1,-1,-1,3,-1
KR_6768568075,420,-6,-121,16,-10,-11,11,0,-2,4,2,0,3,3,3,0,3,0,0,0,0,-20,-6,-5,-3,8,0,0,0,-1,1,-1,-1,3,-1
KR_6764168314,420,2,-37,14,7,-2,3,1,1,2,3,5,0,5,4,2,6,-1,2,1,1,8,9,4,-7,3,2,0,2,1,1,1,1,2,-1
KR_6708680012,420,-6,-91,1,-9,0,2,2,3,1,4,-1,2,1,-11,11,0,0,1,1,0,-12,-3,5,-9,4,-6,0,-3,-1,-1,-1,-1,3,-1
KR_6710460192,420,-1,-32,2,-4,0,2,2,-1,2,1,-3,3,0,-1,5,4,1,1,2,-1,-5,8,1,-8,7,-4,0,-1,-1,-1,-1,-1,6,-1
KR_6745248429,440,-5,-32,-28,-19,0,2,2,0,3,3,-4,9,5,-12,13,1,-3,3,0,1,-30,-168,4,-8,4,-1,0,0,-1,1,-1,1,3,-1
KR_6768943593,420,1,48,13,5,0,0,0,0,2,2,2,1,3,2,1,3,1,0,1,0,4,-1,0,-4,4,6,0,1,1,1,1,1,5,-1
KR_6702853698,420,-3,2,-18,-6,-2,2,0,-5,9,4,-2,3,1,3,0,3,0,1,1,2,0,27,-2,-2,4,1,0,-1,-1,-1,-1,-1,4,-1
KR_6759961913,420,-4,0,8,-5,-2,3,1,2,0,2,-6,6,0,-1,6,5,2,2,4,0,-5,30,1,-8,7,-4,0,1,-1,1,1,-1,2,-1
KR_6742327015,420,1,-27,37,-1,-2,3,1,-2,5,3,2,0,2,2,1,3,-1,1,0,0,-1,27,1,-5,4,-4,0,0,-1,1,0,-1,4,-1
KR_6744430918,420,0,-11,21,3,-4,7,3,-4,4,0,3,0,3,10,0,10,-2,2,0,0,4,-2,1,-6,5,-2,0,0,0,-1,0,1,0,-1
KR_6765579154,420,-6,-41,-12,-10,-3,3,0,-5,6,1,-2,2,0,1,1,2,-1,1,0,0,-10,10,0,-8,8,-7,0,-2,-1,-1,-1,1,5,-1
KR_6705505292,420,0,16,-8,-4,-3,3,0,0,1,1,-3,3,0,1,1,2,1,0,1,0,-2,-9,3,-11,8,8,0,-1,-1,-1,-1,1,5,-1
KR_6717628409,420,0,-61,-4,6,-3,3,0,2,1,3,4,0,4,2,2,4,1,0,1,0,15,-1,-1,-4,5,7,0,-1,1,-1,-1,-1,4,-1
KR_6752616243,420,-3,-53,8,-7,-5,5,0,0,3,3,4,3,7,-5,7,2,-1,1,0,0,-12,-12,-2,-5,7,-1,0,-2,1,-1,-1,-1,1,-1
KR_6768780129,420,2,-18,21,4,-3,4,1,10,3,13,-1,5,4,-2,5,3,0,1,1,0,17,-22,7,-11,4,1,0,0,1,1,-1,1,3,-1
KR_6737609346,440,3,65,13,6,-3,4,1,2,0,2,5,2,7,1,3,4,1,2,3,0,2,4,0,-5,5,1,0,1,0,-1,1,1,0,-1
KR_6762775404,420,-3,-23,-20,0,-1,5,4,5,0,5,-2,3,1,-2,8,6,0,1,1,-1,5,2,-5,-5,10,-3,0,0,1,-1,-1,-1,1,-1
KR_6569713801,420,-2,-5,-31,-7,1,1,2,3,1,4,-6,7,1,-1,4,3,-4,4,0,-1,-13,-31,-5,-6,11,3,0,-1,-1,-1,-1,1,3,-1
KR_6727930312,420,-3,-70,36,-4,-1,2,1,-1,2,1,-1,3,2,-3,4,1,2,2,4,0,-6,-2,-1,-5,6,-7,0,-1,-1,1,-1,1,1,-1
KR_6758064272,440,0,-4,-7,5,0,0,0,0,1,1,0,1,1,5,1,6,0,0,0,0,5,-5,-1,-2,3,-2,0,0,1,0,0,1,6,-1
KR_6726278779,420,2,-23,24,-2,-2,3,1,0,4,4,-3,6,3,0,2,2,3,1,4,0,-11,14,-3,-5,8,-7,0,1,-1,-1,1,1,2,-1
KR_6721019712,420,2,45,18,-4,5,2,7,-1,4,3,-4,4,0,-5,7,2,1,0,1,0,-8,-10,-1,-6,7,0,0,0,1,-1,0,1,6,-1
KR_6713760301,420,-1,-46,-12,-10,-4,4,0,1,1,2,-5,5,0,-1,4,3,-1,1,0,0,-4,2,2,-8,6,2,0,-3,1,-1,-1,-1,5,-1
KR_6764806100,420,0,3,19,1,-2,2,0,1,1,2,-1,3,2,-1,1,0,4,0,4,0,6,12,0,-4,4,0,0,0,1,-1,0,1,3,-1
KR_6674927055,420,0,-21,-16,4,-1,1,0,2,1,3,-2,2,0,4,0,4,1,0,1,0,10,14,2,-5,3,1,0,0,-1,1,1,1,5,-1
KR_6767856044,420,-1,-49,20,-4,-2,4,2,2,2,4,1,0,1,-5,8,3,0,2,2,0,-4,-5,1,-6,5,-3,0,0,-1,1,-1,1,3,-1
KR_6635221184,420,-1,58,-8,-6,-4,4,0,-3,5,2,0,3,3,0,2,2,1,0,1,0,-1,7,-5,-3,8,4,0,1,1,-1,1,1,3,-1
KR_6766713422,420,-3,-34,15,-7,-4,5,1,-2,4,2,1,0,1,2,3,5,-4,4,0,-2,1,43,0,-5,5,-14,0,0,1,-1,0,-1,4,-1
KR_6762980491,420,0,12,0,-1,-2,4,2,1,1,2,1,1,2,-1,2,1,0,0,0,0,-2,-6,-4,-3,7,2,0,-1,-1,1,-1,1,5,-1
KR_6763178268,440,-1,-25,-9,1,0,0,0,0,2,2,1,2,3,2,0,2,-2,2,0,0,0,1,0,-5,5,-2,0,0,-1,1,0,1,6,-1
KR_6608061113,420,-5,-32,14,-22,-3,3,0,-9,9,0,-5,8,3,-3,4,1,-2,2,0,0,-23,-3,-4,-4,8,-1,0,-1,-1,-1,-1,-1,4,-1
KR_6680985159,420,-4,-17,4,-12,-1,2,1,-10,10,0,4,1,5,-5,8,3,0,1,1,0,-10,-3,0,-6,6,2,0,-1,-1,1,-1,-1,3,-1
KR_6749013865,420,2,-30,-16,5,5,1,6,0,3,3,2,1,3,-1,5,4,-1,1,0,0,2,16,-2,-5,7,1,0,1,-1,0,1,1,6,-1
KR_6725381158,420,-2,-56,0,-5,-4,4,0,1,3,4,5,0,5,-6,7,1,-1,4,3,0,2,3,2,-7,5,-5,0,0,-1,-1,-1,-1,6,-1
KR_6747873611,420,-5,-45,-39,-6,-3,3,0,0,2,2,-4,7,3,1,5,6,0,3,3,-1,-3,-21,3,-5,2,-3,0,0,-1,1,0,-1,4,-1
KR_6766925110,420,-3,-29,8,-6,-1,2,1,-2,6,4,0,0,0,-3,6,3,0,0,0,-1,-7,-43,-8,-4,12,7,0,-2,-1,1,-1,-1,1,-1
KR_6739609870,420,-4,-54,-17,-11,1,2,3,1,3,4,-4,6,2,-8,9,1,-1,2,1,1,-25,-3,-2,-5,7,-3,0,-1,-1,-1,-1,1,5,-1
KR_6737256339,440,-6,-23,1,-16,-2,3,1,-4,4,0,-2,2,0,-6,6,0,-2,2,0,0,-20,14,-3,-1,4,1,0,-1,-1,1,-1,-1,4,-1
KR_6747448221,420,3,7,12,3,-2,3,1,3,2,5,1,1,2,1,1,2,0,0,0,-1,-3,5,3,-6,3,-1,0,1,1,1,1,-1,5,-1
KR_6730852374,420,-3,-68,3,-3,0,0,0,0,1,1,0,2,2,-2,3,1,-1,1,0,0,1,55,-1,-8,9,-1,0,-1,-1,-1,-1,-1,6,-1
KR_6748441572,420,-1,-58,0,-4,4,0,4,-6,7,1,1,1,2,-3,3,0,0,2,2,0,-7,46,-1,-4,5,-23,0,1,-1,1,1,1,1,-1
KR_6739108122,420,-5,-110,0,-13,-1,1,0,-1,3,2,-1,2,1,-10,10,0,0,0,0,0,-18,1,0,-6,6,-6,0,-1,-1,-1,-1,-1,2,-1
KR_6768564795,420,-4,-41,-31,-7,-1,1,0,1,0,1,-5,6,1,-4,4,0,2,0,2,1,-5,-24,0,-7,7,-2,0,0,-1,1,0,1,6,-1
KR_6705693540,440,-6,-23,-28,-8,0,3,3,2,2,4,0,1,1,-5,6,1,-5,5,0,0,-9,-2,0,-6,6,-3,0,-1,-1,-1,-1,1,4,-1
KR_6612663634,420,2,-24,1,4,2,0,2,0,2,2,0,0,0,2,3,5,0,0,0,0,0,1,4,-9,5,-1,0,0,-1,1,1,-1,4,-1
KR_6740643469,420,-4,-87,-12,-10,-8,9,1,-2,3,1,1,6,7,0,3,3,-1,2,1,-1,1,11,1,-4,3,0,0,-5,-1,-1,-1,-1,4,-1
KR_6756992223,420,-5,-53,-21,-14,-2,3,1,-7,8,1,0,1,1,-4,4,0,-1,1,0,0,-15,-2,-4,-1,5,-3,0,-2,-1,-1,-1,-1,6,-1
KR_6769767405,440,-1,-8,9,-1,2,1,3,-2,3,1,0,6,6,1,2,3,-2,5,3,0,-1,-1,2,-9,7,-3,0,-1,-1,-1,-1,1,3,-1
KR_6711446311,420,-5,-57,-7,-10,-4,4,0,-2,3,1,-1,3,2,-1,4,3,-2,2,0,0,-9,41,0,-3,3,-24,0,-2,-1,-1,-1,-1,1,-1
KR_6764107600,420,1,-28,26,-1,3,0,3,-2,4,2,-1,4,3,-4,5,1,3,1,4,0,-4,-105,-2,-4,6,0,0,-3,-1,-1,-1,-1,2,-1
KR_6730268461,420,-1,-38,4,-9,1,0,1,-5,6,1,-1,2,1,-2,2,0,-2,2,0,0,-14,2,1,-4,3,-2,0,-1,-1,-1,-1,-1,2,-1
KR_6750693883,420,1,-17,-20,6,0,2,2,2,2,4,0,2,2,2,1,3,2,0,2,0,7,-38,-1,-5,6,13,0,0,-1,-1,1,1,3,-1
KR_6760388358,440,2,40,9,8,1,0,1,3,0,3,2,1,3,2,2,4,0,2,2,0,5,-18,0,-5,5,-1,0,1,1,1,1,1,1,-1
KR_6718148294,420,-4,-83,-15,-13,-5,5,0,-7,7,0,2,0,2,-3,5,2,0,1,1,0,-14,-21,0,-4,4,-2,0,-2,-1,-1,-1,-1,1,-1
KR_6765373156,420,0,-1,3,2,-2,6,4,4,2,6,-1,3,2,-2,3,1,3,1,4,0,3,7,2,-6,4,-2,0,1,0,0,1,-1,0,-1
KR_6761677126,440,0,-37,32,0,1,2,3,-1,2,1,-2,3,1,2,3,5,0,1,1,0,9,-13,-1,-5,6,8,0,-3,1,-1,-1,-1,5,-1
KR_6669222374,420,-3,-62,-7,-7,0,2,2,-3,5,2,-3,5,2,-1,3,2,0,1,1,0,-15,14,1,-7,6,4,0,-1,1,-1,-1,1,6,-1
KR_6673480546,420,-2,14,8,0,-1,1,0,-1,2,1,-2,2,0,0,2,2,4,0,4,0,-5,-80,3,-7,4,-7,0,-1,1,-1,-1,1,1,-1
KR_6725107915,420,-2,-11,-12,-10,2,0,2,0,4,4,-1,3,2,-11,11,0,0,0,0,0,-8,5,2,-7,5,-4,0,0,-1,1,-1,-1,2,-1
KR_6749731080,420,1,10,-4,-1,2,2,4,0,3,3,4,2,6,-5,6,1,-2,3,1,-2,-11,-4,-3,-3,6,1,0,0,-1,-1,0,-1,6,-1
KR_6681107316,420,-6,-49,-1,-12,2,0,2,-4,6,2,2,1,3,-11,11,0,-1,1,0,0,-21,-7,0,-4,4,2,0,1,-1,1,-1,1,3,-1
KR_6674503095,420,-3,-26,-5,-1,-3,4,1,-2,6,4,1,1,2,5,0,5,-2,3,1,1,5,-42,2,-7,5,0,0,-1,-1,1,-1,1,6,-1
KR_6720784288,420,-4,-4,-16,-12,-3,6,3,-5,5,0,1,1,2,-5,6,1,0,0,0,-1,-16,28,0,-9,9,0,0,-2,-1,1,-1,-1,4,-1
KR_6770810698,420,-5,-5,8,-2,-1,3,2,-2,4,2,-3,4,1,-2,7,5,6,2,8,1,-2,-2,0,-4,4,-2,0,0,-1,-1,1,1,2,-1
KR_6769622061,420,-6,-66,-35,-6,-3,3,0,-2,6,4,-4,4,0,3,1,4,0,2,2,0,-3,-12,-1,-4,5,-1,0,-1,1,-1,-1,1,3,-1
KR_6757024477,420,1,-32,44,-3,-3,3,0,-1,3,2,1,2,3,0,5,5,0,1,1,-1,-6,5,0,-7,7,0,0,1,-1,1,1,-1,6,-1
KR_6674560054,420,-2,-2,20,-3,-1,2,1,1,1,2,-1,3,2,-3,7,4,1,2,3,0,-4,-7,-1,-6,7,-7,0,-1,1,1,-1,1,2,-1
KR_6769270622,420,-1,15,9,-4,-4,4,0,3,1,4,-1,3,2,-2,3,1,0,0,0,0,2,8,-3,-5,8,-6,0,-1,1,-1,-1,1,5,-1
KR_6700830591,420,4,14,19,2,1,1,2,-1,2,1,-3,4,1,1,4,5,4,0,4,0,-7,3,-1,-6,7,-4,0,0,0,-1,0,-1,0,-1
KR_6612017663,420,-3,60,-44,-8,0,0,0,-4,6,2,-1,3,2,-2,2,0,-1,3,2,0,-12,-31,-5,-6,11,1,0,-1,-1,-1,-1,1,6,-1
KR_6770254931,420,0,-12,46,6,-4,4,0,7,4,11,1,2,3,0,3,3,2,1,3,0,-2,25,0,-7,7,-2,0,1,1,1,1,1,5,-1
KR_6741212691,420,-4,-18,-34,-12,-6,6,0,-2,2,0,-2,3,1,-1,1,0,-1,1,0,0,-11,65,-2,-4,6,-7,0,-3,-1,-1,-1,-1,4,-1
KR_6695936962,420,-5,-22,-27,-10,-3,6,3,-3,4,1,-3,5,2,0,5,5,-1,3,2,0,-4,33,1,-6,5,-5,0,-2,1,-1,-1,-1,5,-1
KR_6718057680,420,-2,16,12,-1,6,0,6,2,0,2,-5,5,0,-2,2,0,-2,2,0,0,-2,-1,-6,-1,7,-5,0,-2,-1,-1,-1,-1,5,-1
KR_6737168422,420,-2,-21,-32,-5,-2,3,1,0,5,5,-3,3,0,0,3,3,0,3,3,0,-6,2,-4,-6,10,0,0,0,-1,-1,-1,1,4,-1
KR_6726078870,420,2,31,-20,7,4,1,5,-1,7,6,0,2,2,2,4,6,2,0,2,1,0,-12,0,-7,7,-4,0,0,-1,1,1,1,2,-1
KR_6759552526,420,-1,-25,2,-1,0,1,1,-4,4,0,3,0,3,-2,3,1,2,1,3,0,-8,0,1,-9,8,-4,0,0,-1,-1,0,-1,5,-1
KR_6721279523,420,-3,-117,-58,-1,-1,1,0,0,3,3,0,0,0,0,1,1,0,2,2,-1,-2,6,0,-5,5,-6,0,-2,-1,-1,-1,-1,6,-1
KR_6734128462,420,1,-6,0,2,-2,2,0,1,0,1,1,1,2,1,1,2,1,0,1,0,4,-1,-2,-7,9,4,0,0,1,-1,0,1,2,-1
KR_6764116574,420,-4,-47,0,-2,1,1,2,1,0,1,-2,3,1,2,2,4,-4,6,2,0,5,-26,1,-5,4,2,0,-2,0,0,-1,-1,0,-1
KR_6733472847,420,-1,7,-21,2,-7,8,1,9,1,10,1,3,4,-3,4,1,2,0,2,-2,-2,-3,-5,-1,6,2,0,0,1,-1,0,-1,4,-1
KR_6711213387,420,0,-52,0,2,-5,7,2,-1,4,3,7,2,9,0,0,0,1,0,1,-1,-5,-1,10,-10,0,-4,0,0,0,0,1,-1,0,-1
KR_6650353889,420,-2,-50,-16,-5,4,1,5,-1,4,3,-1,5,4,-9,11,2,2,0,2,0,-3,-3,0,-5,5,1,0,-1,-1,0,-1,1,1,-1
KR_6770085358,420,-2,-52,16,-5,-2,3,1,1,1,2,-3,3,0,2,3,5,-3,3,0,0,-1,119,1,-4,3,1,0,-2,1,1,1,-1,4,-1
KR_6718679700,420,-10,-56,-53,-19,-3,3,0,-4,4,0,-5,7,2,-4,4,0,-3,3,0,0,-17,-8,0,-3,3,-6,0,-4,-1,-1,-1,-1,3,-1
KR_6696864481,420,0,-17,-16,2,0,3,3,3,1,4,-2,4,2,1,2,3,0,0,0,0,-1,7,4,-9,5,-5,0,0,1,1,0,1,4,-1
KR_6694147102,420,-2,-64,4,-4,0,1,1,-2,5,3,2,2,4,-4,6,2,0,2,2,0,-15,3,-1,-4,5,1,0,0,1,1,-1,-1,4,-1
KR_6770258003,420,-1,-23,34,-2,0,3,3,-2,2,0,-2,4,2,2,1,3,0,3,3,0,3,-7,-6,-4,10,1,0,-1,-1,-1,-1,-1,6,-1
KR_6734837963,420,1,17,4,-6,1,0,1,-3,8,5,3,1,4,-5,5,0,-2,2,0,-1,-12,2,-1,-4,5,-1,0,0,-1,-1,-1,-1,2,-1
KR_6769468701,420,-1,-23,3,-6,2,1,3,-1,2,1,-7,7,0,-1,4,3,1,0,1,0,-10,-1,3,-8,5,-4,0,-1,-1,-1,-1,-1,3,-1
KR_6626958573,420,-3,-35,4,-6,-2,4,2,-3,7,4,1,2,3,-2,4,2,0,0,0,0,-11,-117,0,-6,6,-3,0,0,-1,0,0,1,2,-1
KR_6730425021,420,-4,-10,-15,-4,1,1,2,-2,4,2,1,1,2,-4,6,2,0,0,0,2,-10,16,-2,-5,7,-1,0,-1,-1,-1,-1,1,6,-1
KR_6752312948,420,0,-41,-1,3,4,0,4,-1,1,0,-3,3,0,1,2,3,2,0,2,0,3,-12,1,-4,3,-1,0,1,0,1,1,1,0,-1
KR_6765747873,440,-3,-73,8,-18,-6,6,0,-12,13,1,2,1,3,-4,7,3,2,1,3,-3,-18,-2,-3,-2,5,-4,0,-1,-1,-1,-1,-1,6,-1
KR_6692362382,420,-2,-43,-9,-5,-5,6,1,-3,3,0,4,0,4,-2,4,2,1,0,1,0,-4,-40,-8,0,8,3,0,0,1,-1,-1,1,4,-1
KR_6759902002,420,2,41,23,-2,1,2,3,-5,6,1,3,0,3,-2,4,2,1,3,4,0,-13,141,1,-5,4,2,0,0,0,-1,0,1,0,-1
KR_6765518376,420,2,12,8,5,3,2,5,-2,3,1,0,4,4,4,3,7,0,1,1,0,7,-353,-3,-2,5,4,0,1,-1,-1,1,-1,1,-1
KR_6763283221,420,4,-16,-7,8,0,2,2,0,3,3,2,1,3,5,1,6,1,2,3,1,9,-25,1,-6,5,-3,0,1,-1,1,1,1,2,-1
KR_6757098836,420,-1,-29,15,-6,-1,1,0,2,0,2,-2,2,0,-4,5,1,-1,3,2,0,-5,-81,1,-5,4,-8,0,0,-1,1,0,-1,4,-1
KR_6765281969,420,-4,-18,5,-10,0,1,1,-3,4,1,1,4,5,-9,13,4,1,1,2,0,-12,0,-2,-3,5,-3,0,0,-1,1,-1,-1,3,-1
KR_6751149892,420,3,-15,3,4,0,1,1,2,2,4,0,2,2,3,3,6,-1,2,1,1,-4,1,2,-3,1,2,0,0,1,-1,0,1,5,-1
KR_6699053206,420,-1,-12,-2,-3,6,0,6,-4,5,1,-4,6,2,1,0,1,-2,4,2,0,-9,6,4,-7,3,-4,0,0,-1,1,0,1,4,-1
KR_6765181522,420,1,-2,4,4,-1,2,1,1,0,1,6,0,6,-3,3,0,1,0,1,0,-1,-7,0,-7,7,2,0,0,-1,1,1,-1,1,-1
KR_6701422292,420,-5,-39,0,-14,-4,5,1,1,2,3,-10,10,0,-2,4,2,1,0,1,0,-10,-2,1,-8,7,2,0,-2,-1,-1,-1,1,6,-1
KR_6770312563,420,2,7,3,4,2,1,3,2,4,6,-2,3,1,3,1,4,-1,1,0,0,3,2,1,-4,3,2,0,0,-1,-1,0,1,4,-1
KR_6754184525,440,1,11,1,1,5,1,6,1,2,3,-3,7,4,-2,3,1,0,0,0,1,-1,-33,-2,-4,6,20,0,0,-1,1,-1,1,5,-1
KR_6746026608,420,-2,3,-20,-4,2,1,3,-3,4,1,-2,4,2,0,2,2,-1,1,0,0,-3,-3,0,-3,3,0,0,-1,0,1,-1,-1,0,-1
KR_6762687817,420,-2,-45,-36,-5,-1,2,1,-3,3,0,0,2,2,-1,2,1,0,0,0,0,-8,1,-2,-3,5,-4,0,0,-1,-1,0,1,2,-1
KR_6687679610,420,-3,6,0,-6,-3,3,0,1,0,1,0,2,2,-2,4,2,-2,2,0,0,-3,-3,-5,-3,8,-3,0,0,-1,-1,0,-1,2,-1
KR_6744901791,420,1,19,-16,-3,5,0,5,0,4,4,-9,9,0,1,0,1,0,1,1,0,-10,0,0,-6,6,-5,0,1,1,-1,1,-1,2,-1
KR_6662221940,440,-3,-53,1,-8,-4,4,0,-2,6,4,0,0,0,-2,3,1,0,2,2,0,-8,-10,-3,-3,6,0,0,0,1,-1,-1,-1,2,-1
KR_6753868769,420,0,-56,-24,-5,-2,3,1,1,4,5,-3,4,1,-1,3,2,0,0,0,-1,-12,-29,-1,-5,6,-1,0,-1,1,-1,-1,-1,1,-1
KR_6745494945,420,-7,-22,-36,-16,-1,4,3,-7,7,0,-3,6,3,-1,4,3,-4,7,3,-2,-14,-16,-2,-3,5,1,0,0,-1,-1,-1,-1,5,-1
KR_6752761176,420,1,29,-28,7,-1,2,1,2,4,6,3,0,3,3,2,5,0,0,0,0,15,20,1,-8,7,0,0,1,-1,-1,-1,1,5,-1
KR_6762577485,420,-1,30,-8,-4,-3,3,0,-2,3,1,-2,4,2,3,1,4,0,0,0,0,-9,0,-3,-4,7,3,0,1,0,-1,-1,-1,0,-1
KR_6767460039,420,-4,-18,-14,-13,-3,3,0,-10,10,0,2,3,5,-2,4,2,0,0,0,-1,-18,13,-2,-2,4,-1,0,-1,-1,1,-1,-1,6,-1
KR_6676578618,420,-2,-51,-13,-10,-2,2,0,-6,9,3,0,2,2,0,0,0,-2,3,1,0,-11,-5,-2,-4,6,-1,0,-1,-1,-1,-1,-1,3,-1
KR_6770379392,440,0,-32,2,3,4,0,4,3,3,6,-5,5,0,-1,1,0,2,3,5,-1,5,-2,-5,-6,11,1,0,-1,1,-1,-1,-1,4,-1
KR_6714169053,440,-3,-167,-22,-6,-6,9,3,1,3,4,-2,5,3,3,1,4,-2,3,1,0,-1,2,4,-5,1,-1,0,-2,-1,0,-1,-1,6,-1
KR_6757498405,420,-2,-44,-21,-3,0,2,2,-5,7,2,-2,3,1,1,1,2,3,0,3,1,3,-22,1,-6,5,2,0,-1,1,-1,-1,1,5,-1
KR_6753306158,420,-1,-7,-50,-1,-3,5,2,-1,2,1,1,2,3,1,1,2,1,0,1,0,0,8,3,-11,8,-2,0,-1,-1,-1,-1,1,2,-1
KR_6770488647,420,0,-28,-20,4,0,3,3,3,0,3,1,2,3,-1,1,0,1,0,1,0,6,40,2,-5,3,1,0,0,-1,-1,0,-1,5,-1
KR_6764792303,420,-3,-55,5,-6,-4,5,1,-2,4,2,-2,2,0,2,3,5,0,0,0,0,-2,-3,5,-8,3,0,0,0,-1,-1,-1,-1,6,-1
KR_6762544579,420,1,34,-2,8,4,2,6,1,0,1,1,1,2,4,0,4,-2,2,0,0,13,24,5,-7,2,0,0,0,1,-1,-1,1,2,-1
KR_6765948504,420,0,-43,-8,6,-3,3,0,-4,6,2,1,2,3,6,0,6,6,2,8,0,4,-3,-3,-7,10,1,0,1,1,-1,-1,-1,2,-1
KR_6745697684,420,-1,-16,24,-2,-1,1,0,-4,7,3,-3,4,1,4,0,4,2,1,3,0,-11,4,-2,-4,6,1,0,0,1,1,0,-1,2,-1
KR_6763474628,440,0,73,-4,0,2,1,3,0,1,1,2,1,3,-4,5,1,0,0,0,0,-2,-6,-1,-4,5,3,0,0,-1,-1,0,1,1,-1
KR_6721536983,420,1,37,14,-4,-2,4,2,-4,4,0,2,1,3,-1,3,2,1,0,1,2,-4,11,5,-10,5,-5,0,0,1,-1,-1,1,2,-1
KR_6762180530,420,0,-65,11,-8,-3,3,0,-1,2,1,-2,2,0,-4,5,1,2,1,3,0,-9,11,-3,-3,6,1,0,-1,1,-1,-1,-1,4,-1
KR_6764982801,420,-3,-62,-12,-1,-1,4,3,-3,4,1,1,3,4,2,2,4,0,0,0,0,1,-51,-4,-5,9,28,0,0,-1,-1,-1,1,2,-1
KR_6681937609,420,0,20,-11,5,0,2,2,3,2,5,2,0,2,1,2,3,-1,2,1,1,4,9,8,-10,2,-1,0,0,-1,-1,-1,1,2,-1
KR_6658279561,420,-4,-10,-2,-8,-4,5,1,0,4,4,-2,2,0,-3,4,1,1,0,1,0,-1,30,5,-11,6,-3,0,0,-1,-1,-1,1,1,-1
KR_6736982895,420,1,35,-5,-5,-2,3,1,-7,8,1,3,1,4,2,2,4,-1,3,2,0,-3,-59,-8,-5,13,14,0,0,1,1,1,-1,3,-1
KR_6747947689,420,-1,-44,-19,-3,0,1,1,0,1,1,-1,2,1,-1,4,3,-1,2,1,0,-5,4,5,-6,1,2,0,0,1,1,-1,-1,4,-1
KR_6718286744,420,-3,-17,5,-8,1,1,2,-2,2,0,-6,7,1,0,2,2,-1,1,0,0,-15,0,-1,-5,6,-6,0,0,1,-1,-1,-1,3,-1
KR_6715293535,420,-3,7,-23,-8,-1,3,2,-3,5,2,1,2,3,-3,4,1,-2,2,0,0,-10,-11,-9,-2,11,3,0,-1,-1,-1,-1,-1,1,-1
KR_6764696999,440,-6,13,-116,-15,1,0,1,-6,6,0,1,2,3,-6,8,2,-5,6,1,-1,-10,-34,3,-4,1,-2,0,-1,-1,-1,-1,-1,6,-1
KR_6732225161,420,-3,-104,5,-1,-5,8,3,1,0,1,0,0,0,3,0,3,0,0,0,0,7,-1,-1,-6,7,-5,0,-1,1,1,-1,1,3,-1
KR_6763505407,420,-2,-1,0,-4,-1,1,0,-2,4,2,1,1,2,-1,2,1,-1,1,0,0,-6,0,-3,-2,5,-3,0,0,-1,1,0,-1,4,-1
KR_6750101944,420,-1,26,18,-1,-1,1,0,-5,8,3,0,2,2,7,0,7,-2,3,1,0,-2,7,2,-3,1,-1,0,1,1,-1,1,-1,3,-1
KR_6427066870,420,-1,-8,-44,-3,2,0,2,-4,6,2,0,1,1,1,1,2,-2,3,1,0,-4,32,-2,-6,8,-18,0,-1,-1,1,-1,-1,4,-1
KR_6718489134,420,-2,12,-4,-6,-1,3,2,-6,10,4,0,1,1,1,2,3,0,0,0,0,-12,5,4,-7,3,-9,0,0,-1,-1,-1,1,4,-1
KR_6644262612,420,2,9,22,7,2,0,2,0,3,3,7,2,9,-1,6,5,-1,2,1,0,12,27,9,-11,2,3,0,1,1,-1,1,-1,6,-1
KR_6770429556,420,-3,-41,4,-9,-2,3,1,0,1,1,-3,7,4,-4,5,1,0,1,1,0,-10,-10,-4,-2,6,1,0,-1,1,-1,-1,1,6,-1
KR_6732794792,420,1,-14,4,4,1,2,3,-1,3,2,4,0,4,0,4,4,0,1,1,0,4,174,2,-8,6,3,0,0,1,1,1,1,5,-1
KR_6766627532,420,-1,-47,14,-2,3,2,5,0,2,2,-1,1,0,-4,6,2,0,0,0,-1,-7,-2,-2,-6,8,1,0,-1,-1,1,-1,-1,4,-1
KR_6691959633,420,-1,-27,-12,-8,-2,2,0,-5,5,0,1,2,3,-2,5,3,0,0,0,-1,-16,17,-1,-6,7,-6,0,-2,-1,1,-1,-1,3,-1
KR_6755839989,420,-1,3,-42,4,4,0,4,1,0,1,2,1,3,1,0,1,-4,7,3,0,-2,-8,-3,-4,7,2,0,0,-1,-1,0,1,5,-1
KR_6765788849,420,0,-70,-3,2,3,2,5,-1,4,3,0,3,3,1,0,1,-1,1,0,0,1,14,-5,-3,8,-1,0,-1,-1,1,-1,-1,1,-1
KR_6737283023,440,1,-34,26,4,0,2,2,0,5,5,0,2,2,0,3,3,4,0,4,0,3,2,1,-8,7,2,0,0,1,0,-1,1,6,-1
KR_6766916900,420,-6,-7,-4,-14,-4,5,1,-5,7,2,-3,4,1,-2,2,0,0,0,0,0,-7,2,-5,0,5,1,0,-1,-1,-1,-1,-1,4,-1
KR_6764308515,420,2,6,-10,9,2,1,3,-4,4,0,4,0,4,0,4,4,7,0,7,0,12,172,1,-8,7,4,0,1,-1,1,1,1,4,-1
KR_6717967422,420,2,66,-19,5,2,2,4,4,0,4,3,1,4,-3,3,0,-1,1,0,-1,-4,-117,1,-6,5,-2,0,-1,-1,-1,-1,-1,5,-1
KR_6761159679,420,-3,-45,-28,-4,-4,4,0,-1,3,2,-2,2,0,3,1,4,0,0,0,0,5,20,3,-6,3,-2,0,0,-1,-1,-1,-1,2,-1
KR_6752269905,420,-2,-38,-18,-10,-4,6,2,-2,5,3,1,0,1,-4,5,1,-1,1,0,-3,-13,4,-4,-3,7,-2,0,-2,0,-1,-1,-1,0,-1
KR_6697882608,420,5,38,-10,7,0,0,0,2,4,6,4,1,5,1,3,4,0,2,2,0,2,83,-4,-4,8,-5,0,1,1,-1,1,-1,4,-1
KR_6754743866,420,-4,-83,0,-9,-2,5,3,-2,5,3,-4,6,2,-1,2,1,0,2,2,1,-10,-3,2,-7,5,-6,0,-2,-1,-1,1,1,1,-1
KR_6708477502,420,3,-2,50,-2,2,1,3,-3,5,2,2,2,4,-2,6,4,-1,1,0,0,-9,-3,-2,-3,5,-1,0,0,1,1,1,-1,1,-1
KR_6717879687,440,-5,-69,-20,-12,1,1,2,-4,4,0,1,1,2,-10,10,0,0,1,1,0,-19,103,-5,-1,6,0,0,-2,-1,-1,-1,-1,1,-1
KR_6757810029,440,-4,-36,-13,-8,-3,3,0,-1,2,1,-2,2,0,-1,4,3,-1,1,0,0,-5,-7,0,-4,4,2,0,0,-1,-1,-1,1,5,-1
KR_6740536570,420,-1,-26,7,-7,2,1,3,1,3,4,-3,4,1,-3,7,4,-4,5,1,1,-5,-10,-1,-6,7,-1,0,0,1,-1,-1,1,6,-1
KR_6766413851,420,-3,26,1,-13,-3,5,2,-4,5,1,0,3,3,-5,6,1,-1,1,0,1,-17,-9,-8,-5,13,-3,0,-2,-1,-1,-1,1,5,-1
KR_6725516303,420,-6,36,-44,-9,0,3,3,-1,4,3,-5,6,1,1,3,4,-4,5,1,1,-9,284,2,-6,4,2,0,0,-1,1,0,1,3,-1
KR_6770235703,420,-4,-92,-9,-8,0,1,1,-3,5,2,1,0,1,-5,5,0,-1,3,2,0,-16,-13,-1,-6,7,-5,0,0,1,-1,-1,1,3,-1
KR_6691627381,420,2,26,16,7,1,1,2,2,0,2,6,2,8,0,5,5,-2,3,1,4,5,13,3,-7,4,2,0,0,1,1,0,1,1,-1
KR_6725333221,420,-5,-107,-2,-12,-2,4,2,0,2,2,-5,5,0,-7,10,3,2,1,3,0,-6,-15,-9,-3,12,1,0,-2,-1,1,-1,-1,2,-1
KR_6764974539,420,1,-64,4,1,-1,3,2,-3,4,1,-1,4,3,4,0,4,2,0,2,0,5,-328,-3,-4,7,1,0,-1,-1,-1,1,-1,1,-1
KR_6687150249,420,-3,47,-13,-8,-4,5,1,2,2,4,-5,5,0,-1,2,1,0,0,0,0,-4,-9,-7,-6,13,5,0,0,-1,-1,0,-1,3,-1
KR_6614424703,420,0,8,3,3,-2,2,0,3,4,7,0,1,1,0,3,3,2,0,2,0,5,3,1,-7,6,-1,0,0,-1,1,1,1,3,-1
KR_6625479684,420,4,-36,22,14,3,0,3,4,1,5,5,1,6,0,3,3,2,1,3,0,21,2,3,-9,6,4,0,0,1,-1,1,1,5,-1
KR_6765859666,440,0,-12,12,0,1,2,3,3,1,4,-2,3,1,-2,2,0,0,2,2,0,-1,-26,2,-4,2,3,0,0,-1,-1,0,1,3,-1
KR_6764476790,420,-5,-60,-20,-1,1,0,1,4,1,5,-4,6,2,-3,6,3,1,0,1,1,2,7,0,-6,6,2,0,-1,-1,-1,-1,1,6,-1
KR_6485698785,420,2,31,13,3,-2,3,1,-7,9,2,8,0,8,3,0,3,1,0,1,0,-1,14,3,-6,3,-5,0,2,1,-1,1,-1,1,-1
KR_6694675071,420,-3,-34,-9,-4,0,2,2,-3,3,0,-5,7,2,2,0,2,2,1,3,-1,2,-5,-1,-4,5,-4,0,-1,-1,-1,-1,-1,5,-1
KR_6769649999,420,-6,-40,6,-10,-2,4,2,0,1,1,-6,6,0,-1,3,2,-1,1,0,0,-15,-17,1,-9,8,-6,0,-2,1,-1,-1,1,5,-1
KR_6760033462,420,-2,-56,16,-2,2,1,3,-1,3,2,-3,3,0,-2,5,3,2,0,2,0,-2,-17,-1,-6,7,-1,0,0,1,-1,-1,1,5,-1
KR_6754080227,420,-2,19,-4,-5,-4,4,0,-1,4,3,3,1,4,-4,4,0,1,0,1,0,-4,-4,0,-8,8,1,0,1,1,-1,1,-1,2,-1
KR_6756927240,420,0,-23,-20,-5,2,0,2,-4,5,1,-4,4,0,-1,2,1,2,1,3,-1,-8,-11,-2,-4,6,-4,0,1,-1,1,1,-1,6,-1
KR_6723889387,420,-1,-4,-32,1,-1,2,1,3,1,4,-1,4,3,3,0,3,-3,3,0,0,7,23,5,-11,6,-1,0,0,1,-1,0,1,1,-1
KR_6724826377,420,-3,-28,-62,-11,3,1,4,-5,6,1,-4,6,2,-5,7,2,0,1,1,0,-11,-33,-8,-2,10,0,0,-2,-1,-1,-1,-1,1,-1
KR_6722887226,420,-3,-33,-19,-1,0,1,1,1,3,4,0,0,0,0,1,1,-2,3,1,0,-1,-101,0,-8,8,0,0,0,1,1,0,-1,2,-1
KR_6761800303,420,-5,-95,-16,-13,-3,4,1,0,3,3,-1,3,2,-9,11,2,0,1,1,1,-16,-5,-3,-3,6,-3,0,-2,-1,-1,-1,1,2,-1
KR_6765450875,440,-5,12,-18,-20,0,2,2,-11,12,1,-1,4,3,-11,11,0,3,1,4,-1,-30,-42,1,-3,2,0,0,-2,-1,0,-1,-1,3,-1
KR_6694258619,420,2,-61,-4,6,2,0,2,5,3,8,-2,2,0,-1,3,2,2,0,2,0,7,129,2,-7,5,-2,0,1,-1,1,1,1,2,-1
KR_6745819811,420,0,46,10,-4,2,4,6,1,1,2,-8,8,0,0,4,4,1,0,1,0,-12,6,4,-9,5,-6,0,1,-1,-1,1,1,5,-1
KR_6745339665,420,-5,-73,-30,-5,-5,5,0,-3,4,1,1,5,6,1,2,3,1,1,2,0,1,-4,1,-3,2,0,0,-2,1,-1,-1,-1,4,-1
KR_6764131336,420,-3,2,-31,-9,-3,3,0,-2,2,0,-4,4,0,1,1,2,-1,1,0,0,-12,-36,-4,-3,7,-2,0,-3,-1,1,-1,1,2,-1
KR_6770950032,420,0,-41,12,-5,-4,4,0,0,3,3,-2,2,0,1,0,1,0,1,1,0,1,26,4,-8,4,-5,0,-2,0,-1,-1,-1,0,-1
KR_6766100797,420,-4,24,-9,-4,-8,11,3,2,0,2,-3,3,0,6,0,6,-1,2,1,0,-6,13,-2,-5,7,0,0,-1,1,-1,1,1,3,-1
KR_6739808988,420,-3,-16,8,-6,2,1,3,-5,5,0,-2,5,3,0,8,8,-1,2,1,0,-7,1,3,-10,7,0,0,-1,-1,0,-1,1,6,-1
KR_6753027745,440,-3,24,-20,-8,-3,5,2,0,2,2,-1,2,1,-4,4,0,0,3,3,-2,-10,-2,-3,-1,4,1,0,0,-1,-1,-1,-1,6,-1
KR_6664186700,420,-1,-14,47,0,2,1,3,-1,5,4,-5,7,2,4,1,5,0,1,1,0,6,-20,4,-7,3,-1,0,1,1,-1,1,-1,5,-1
KR_6770519755,420,-7,-110,-11,-15,-3,4,1,0,3,3,-2,4,2,-7,10,3,-3,4,1,-1,-11,-6,4,-9,5,-5,0,-3,-1,-1,-1,-1,5,-1
KR_6711998367,420,2,30,-17,5,3,0,3,3,0,3,-3,6,3,2,1,3,0,0,0,0,8,8,2,-5,3,6,0,1,1,1,1,-1,4,-1
KR_6738336610,420,3,-14,22,4,0,1,1,1,0,1,4,2,6,-3,3,0,2,1,3,0,1,-64,5,-9,4,8,0,-2,-1,1,-1,-1,2,-1
KR_6723053921,420,-2,-34,-17,-4,-3,3,0,1,5,6,-2,4,2,0,2,2,0,0,0,0,0,-1,-3,-4,7,0,0,-1,-1,-1,-1,-1,6,-1
KR_6765461566,420,2,-5,-6,5,0,1,1,4,1,5,-1,2,1,0,3,3,2,1,3,0,11,12,2,-2,0,0,0,1,1,-1,1,1,2,-1
KR_6758037831,420,-3,-66,0,-7,-3,3,0,1,1,2,-1,4,3,-1,2,1,-3,3,0,0,-12,3,0,-6,6,-1,0,-1,-1,1,-1,-1,1,-1
KR_6768367025,420,1,-17,-6,3,1,0,1,-1,4,3,0,1,1,1,1,2,2,1,3,0,1,22,0,-5,5,-4,0,0,-1,1,0,1,6,-1
KR_6732364457,420,0,62,-8,-1,-1,2,1,2,4,6,-2,3,1,0,1,1,0,0,0,1,5,-11,0,-4,4,-4,0,0,-1,1,0,1,2,-1
KR_6754120765,420,2,6,0,4,3,0,3,1,2,3,3,3,6,-2,6,4,-1,2,1,1,9,137,-3,-4,7,5,0,-1,-1,1,-1,1,6,-1
KR_6743199427,420,-1,-34,13,-4,-1,1,0,1,4,5,-3,3,0,-1,2,1,0,2,2,0,-3,39,-2,-3,5,-35,0,-1,-1,-1,-1,1,5,-1
KR_6770401165,420,0,-43,-1,-4,-1,1,0,1,0,1,2,0,2,-4,6,2,-2,2,0,0,-7,92,-1,-5,6,5,0,0,-1,1,0,-1,1,-1
KR_6652103137,420,-2,-36,-11,-4,0,2,2,-5,7,2,0,2,2,0,5,5,1,1,2,-1,-5,6,-1,-7,8,0,0,0,0,-1,0,-1,0,-1
KR_6770539839,420,-2,66,-12,-5,-3,3,0,1,2,3,-2,3,1,-1,1,0,0,1,1,0,-6,2,1,-6,5,4,0,0,1,1,1,-1,4,-1
KR_6746624727,420,-4,-59,-14,-10,-7,8,1,-3,4,1,2,0,2,-3,4,1,1,0,1,0,-9,25,-1,-4,5,-5,0,-1,-1,1,-1,-1,3,-1
KR_6718086256,420,-6,-19,-25,-17,4,0,4,-13,14,1,-2,2,0,-2,3,1,-4,4,0,0,-19,2,1,-7,6,-7,0,-2,-1,-1,-1,-1,2,-1
KR_6679951943,420,2,-38,14,-1,0,2,2,0,2,2,-1,2,1,-1,3,2,1,0,1,0,-5,2,-2,-7,9,2,0,1,1,1,1,1,4,-1
KR_6764807410,420,-4,-3,-21,-11,-2,4,2,-1,6,5,0,2,2,-6,6,0,-2,2,0,-1,-1,2,2,-5,3,3,0,-3,1,-1,-1,-1,3,-1
KR_6770465828,420,1,74,0,0,0,0,0,1,0,1,-1,3,2,0,2,2,0,0,0,0,1,1,0,-6,6,5,0,0,1,1,0,-1,6,-1
KR_6747733081,420,-1,14,17,-1,-1,2,1,-2,4,2,4,0,4,0,3,3,-2,2,0,0,-2,10,2,-5,3,-3,0,0,-1,1,0,-1,6,-1
KR_6770962431,440,0,-30,-3,-3,1,2,3,0,5,5,4,0,4,-6,7,1,-2,3,1,-1,2,15,1,-8,7,1,0,0,-1,0,-1,-1,5,-1
KR_6751934153,420,0,46,8,-8,1,1,2,-3,5,2,0,0,0,-4,4,0,-2,2,0,0,-14,73,-5,-2,7,3,0,0,-1,1,0,-1,5,-1
KR_6756681240,420,0,16,16,0,4,0,4,4,1,5,-5,8,3,-2,5,3,-1,2,1,2,4,-28,-2,-5,7,7,0,-1,-1,1,-1,1,2,-1
KR_6769504026,440,-3,-17,3,-6,-1,2,1,1,1,2,-1,2,1,-3,6,3,-2,2,0,0,-7,0,0,-5,5,0,0,-2,-1,-1,-1,-1,4,-1
KR_6700534086,420,1,-32,-4,-1,-3,4,1,1,2,3,1,2,3,0,2,2,0,0,0,0,2,-33,-2,-6,8,2,0,0,-1,-1,0,-1,2,-1
KR_6697786158,420,-2,13,-7,-6,1,0,1,-3,4,1,-4,8,4,-2,3,1,2,1,3,0,-3,-25,5,-9,4,-2,0,-2,-1,-1,-1,-1,4,-1
KR_6669180475,420,1,10,27,-2,1,0,1,-1,3,2,-1,4,3,1,4,5,-2,2,0,-1,-5,-6,0,-7,7,5,0,0,1,-1,0,-1,4,-1
KR_6740629854,420,-3,21,-22,-5,0,1,1,-4,7,3,0,1,1,1,2,3,-2,2,0,0,-7,-47,3,-8,5,17,0,0,-1,-1,-1,1,4,-1
KR_6719652532,420,-6,-63,30,-11,-6,6,0,-2,4,2,-1,1,0,0,6,6,-2,2,0,0,-6,-2,3,-4,1,0,0,-2,0,-1,-1,1,0,-1
KR_6756539648,420,-3,-10,-28,-14,2,1,3,-13,15,2,1,3,4,-5,5,0,1,1,2,0,-10,0,-4,-2,6,-1,0,0,0,-1,0,-1,0,-1
KR_6710672350,420,-3,37,1,-4,0,3,3,-5,7,2,1,4,5,2,4,6,-2,2,0,0,-8,31,3,-7,4,0,0,0,1,-1,1,1,6,-1
KR_6759743056,420,-4,-118,4,-9,-7,8,1,0,1,1,2,0,2,-6,7,1,2,0,2,0,-1,1,0,-3,3,0,0,-3,-1,-1,-1,-1,1,-1
KR_6664860036,420,-4,-34,17,-12,2,0,2,-7,8,1,-7,9,2,1,1,2,-1,1,0,0,-10,18,-6,-1,7,3,0,-2,-1,-1,-1,-1,4,-1
KR_6769247819,420,-4,11,0,-5,0,1,1,-1,3,2,-6,8,2,3,2,5,-1,3,2,0,-9,10,3,-7,4,-3,0,0,-1,-1,-1,-1,4,-1
KR_6757431265,420,-2,-2,-7,-4,-1,1,0,-4,5,1,1,2,3,0,4,4,0,0,0,0,-5,-2,0,-4,4,3,0,-1,1,-1,-1,-1,4,-1
KR_6704312732,420,-3,-46,5,-9,-2,2,0,2,1,3,-1,4,3,-8,9,1,0,2,2,0,-3,-4,-6,-4,10,2,0,0,1,1,-1,1,1,-1
KR_6769044071,420,-2,-43,-20,1,-1,2,1,0,2,2,4,1,5,-3,5,2,1,1,2,0,12,-2,-8,-1,9,2,0,-1,-1,1,-1,-1,4,-1
KR_6755400398,440,1,-116,4,5,3,3,6,2,2,4,-1,1,0,2,1,3,-1,2,1,0,4,14,-3,-3,6,-6,0,-1,-1,-1,-1,-1,6,-1
KR_6507081627,440,4,22,-4,10,0,3,3,0,6,6,4,1,5,3,3,6,3,1,4,0,10,-1,0,-5,5,3,0,3,0,1,1,-1,0,-1
KR_6765992912,420,-4,-27,23,-23,0,3,3,-9,11,2,-5,5,0,-8,8,0,-1,3,2,0,-30,-8,1,-6,5,1,0,-3,1,-1,-1,-1,3,-1
KR_6754511842,420,1,-14,24,-1,-2,3,1,-1,3,2,1,2,3,0,2,2,1,0,1,0,-4,-110,-6,-1,7,2,0,0,0,-1,0,-1,0,-1
KR_6680947196,420,-2,-11,-21,-1,-1,2,1,3,2,5,-1,3,2,1,6,7,-3,3,0,0,9,5,2,-5,3,-4,0,0,1,-1,0,-1,3,-1
KR_6745051384,420,1,106,-16,2,4,0,4,-3,4,1,0,2,2,-2,5,3,3,0,3,0,-7,13,1,-5,4,6,0,0,-1,1,1,1,3,-1
KR_6662368983,440,-2,-52,-20,3,1,0,1,0,3,3,0,1,1,0,1,1,2,0,2,0,8,13,3,-7,4,-6,0,0,-1,-1,0,-1,6,-1
KR_6749798872,420,2,40,16,1,-1,3,2,2,4,6,0,2,2,-1,4,3,1,1,2,-3,-6,-97,0,-7,7,4,0,0,1,-1,0,1,4,-1
KR_6750090141,420,-3,-30,-4,-5,-5,5,0,-2,7,5,0,2,2,2,1,3,0,2,2,0,-2,6,-3,-3,6,-1,0,-2,1,-1,-1,-1,5,-1
KR_6763266368,420,-6,-27,16,-13,-1,2,1,-3,5,2,-3,5,2,-3,5,2,-3,3,0,-1,-12,-10,-5,-2,7,-1,0,-2,-1,-1,-1,-1,1,-1
KR_6766984855,440,2,15,-15,6,1,3,4,5,0,5,0,0,0,1,3,4,-1,1,0,1,8,6,0,-4,4,4,0,1,-1,1,1,1,6,-1
KR_6748559119,440,0,-25,-11,9,2,3,5,-4,8,4,8,0,8,3,1,4,0,2,2,1,2,-4,-2,-3,5,0,0,0,-1,1,0,1,4,-1
KR_6762710025,440,-1,-31,-5,-10,-3,6,3,0,3,3,2,0,2,-8,8,0,-1,3,2,0,-14,42,0,-5,5,-5,0,0,-1,1,0,-1,1,-1
KR_6758874484,420,1,17,12,1,-3,4,1,2,0,2,1,2,3,-3,5,2,4,2,6,0,3,-6,-4,-3,7,2,0,0,1,-1,-1,1,2,-1
KR_6614673493,420,-4,15,-11,-4,0,1,1,-1,3,2,-1,3,2,-2,4,2,0,0,0,0,5,-7,-6,-3,9,-4,0,0,1,0,0,1,2,-1
KR_6753119362,420,-4,-53,-5,-15,-10,10,0,-2,3,1,-2,3,1,-1,4,3,0,1,1,0,-10,31,-1,-3,4,-12,0,1,-1,-1,1,-1,1,-1
KR_6611163473,420,-1,17,-5,-3,2,3,5,0,3,3,1,2,3,-5,6,1,-1,1,0,0,-1,-45,1,-5,4,13,0,0,-1,1,1,1,5,-1
KR_6721097851,440,-10,-108,-56,-18,-1,1,0,0,4,4,-4,7,3,-5,6,1,-8,8,0,0,-18,-6,-1,-5,6,4,0,-2,-1,0,-1,-1,3,-1
KR_6706716857,420,-1,-49,9,-1,0,2,2,0,5,5,-1,4,3,0,1,1,0,1,1,0,-3,18,3,-8,5,1,0,-1,1,-1,-1,1,1,-1
KR_6716913642,420,1,22,18,0,5,0,5,-3,4,1,-3,5,2,1,0,1,0,1,1,0,-6,-26,-2,-4,6,2,0,0,1,1,1,1,6,-1
KR_6623581235,420,-6,-66,-51,-15,0,1,1,-5,6,1,1,0,1,-9,10,1,-2,2,0,0,-15,15,-4,-2,6,-2,0,-2,-1,-1,-1,-1,4,-1
KR_6754434888,440,1,-57,20,4,-1,1,0,-2,3,1,-1,3,2,4,0,4,4,1,5,0,1,-12,2,-4,2,2,0,0,1,1,1,-1,4,-1
KR_6688124309,420,-2,-16,-2,0,-2,2,0,4,3,7,-6,6,0,3,0,3,1,2,3,0,5,-32,4,-9,5,0,0,0,-1,-1,0,1,6,-1
KR_6756733532,420,-2,-33,-50,-5,-3,3,0,-2,6,4,-1,3,2,1,0,1,0,0,0,1,1,-1,-4,-5,9,0,0,-1,-1,-1,-1,1,2,-1
KR_6704328191,420,-2,-37,-35,4,1,0,1,-2,4,2,3,0,3,1,3,4,1,1,2,1,3,2,3,-9,6,0,0,-1,-1,-1,-1,1,1,-1
KR_6628843866,420,-8,-80,4,-15,-6,6,0,-2,5,3,-3,4,1,-4,4,0,0,1,1,0,-7,158,0,-6,6,-1,0,-1,1,-1,-1,1,3,-1
KR_6423143620,420,-3,-29,7,-6,-3,3,0,-3,4,1,-2,2,0,2,2,4,0,1,1,0,-6,-6,0,-7,7,-1,0,0,1,-1,0,-1,1,-1
KR_6763270743,440,2,26,-27,5,4,1,5,3,2,5,-2,4,2,1,0,1,-1,2,1,-2,2,-9,3,-4,1,4,0,2,-1,1,1,-1,3,-1
KR_6724994115,420,-2,7,-5,-5,4,1,5,-5,6,1,0,0,0,-4,4,0,0,1,1,0,-9,185,-2,-4,6,2,0,-1,1,-1,-1,-1,2,-1
KR_6764093261,440,-4,-119,-35,-7,-4,5,1,3,2,5,-4,4,0,0,1,1,-2,4,2,0,0,0,3,-7,4,0,0,0,-1,-1,-1,1,6,-1
KR_6722656229,420,-4,-10,-24,-7,-3,3,0,-1,3,2,-2,2,0,-2,2,0,1,0,1,0,-6,4,3,-7,4,-6,0,0,1,-1,0,-1,4,-1
KR_6763096631,440,0,-14,-7,-5,4,2,6,-1,2,1,-8,9,1,1,3,4,-1,3,2,-1,-7,14,0,-5,5,3,0,0,-1,1,0,-1,4,-1
KR_6624473985,440,-2,-13,-4,2,-3,3,0,2,2,4,3,2,5,-1,2,1,1,1,2,0,8,-4,4,-7,3,-1,0,-2,1,-1,-1,-1,1,-1
KR_6758333288,420,-4,-53,-7,-15,-3,4,1,-6,7,1,-5,5,0,0,1,1,-1,2,1,2,-8,-27,-1,-6,7,-7,0,0,-1,-1,0,1,6,-1
KR_6768773251,420,-1,68,-43,-9,1,1,2,0,4,4,-2,3,1,-9,10,1,1,1,2,0,-7,7,-4,-3,7,3,0,0,-1,-1,-1,-1,5,-1
KR_6755834810,420,4,51,0,5,-2,4,2,3,2,5,6,3,9,0,4,4,-2,2,0,0,2,5,-2,-4,6,1,0,2,1,-1,1,1,2,-1
KR_6737292887,420,-1,24,-9,-3,-3,3,0,7,2,9,-2,3,1,-5,5,0,0,1,1,0,-1,1,6,-10,4,-3,0,-3,-1,-1,-1,1,4,-1
KR_6767941108,420,-2,-50,2,-9,-2,3,1,-1,2,1,-1,2,1,-4,6,2,-1,2,1,0,-13,-1,4,-8,4,0,0,-2,1,-1,-1,-1,1,-1
KR_6757077279,420,-1,-46,15,-6,-2,3,1,1,1,2,-7,9,2,1,3,4,1,0,1,0,-5,2,2,-8,6,2,0,-1,1,-1,-1,1,3,-1
KR_6768480930,420,1,-33,27,-1,-2,2,0,0,4,4,3,0,3,-3,6,3,1,0,1,0,-1,-3,-2,-4,6,-1,0,1,1,-1,1,-1,5,-1
KR_6758988443,420,0,-56,9,-7,0,1,1,-2,3,1,-3,3,0,-2,3,1,0,2,2,0,-7,-11,-7,-2,9,-2,0,-1,-1,0,-1,-1,1,-1
KR_6692609885,420,-2,-9,19,-4,-1,4,3,-2,2,0,2,4,6,-4,4,0,1,0,1,0,-12,-5,0,-3,3,1,0,0,-1,1,1,-1,1,-1
KR_6753042579,420,-3,-15,7,-8,0,3,3,0,1,1,-1,3,2,-4,4,0,-3,3,0,-1,-8,-6,-2,-4,6,4,0,0,-1,1,0,-1,5,-1
KR_6747411984,420,0,-22,-28,-1,-1,3,2,-1,3,2,-1,5,4,0,3,3,2,0,2,0,1,45,2,-7,5,-6,0,0,-1,1,0,-1,4,-1
KR_6747866716,420,-1,-2,-41,-6,0,1,1,1,4,5,-2,4,2,-1,3,2,-4,4,0,-1,-9,83,2,-11,9,3,0,-1,-1,1,1,1,2,-1
KR_6745027337,440,-3,-32,-4,-5,-6,7,1,1,2,3,-2,2,0,1,2,3,1,0,1,0,6,-1,2,-7,5,1,0,-2,1,-1,-1,1,3,-1
KR_6753925022,420,-4,-11,-24,-11,-1,1,0,0,6,6,0,2,2,-3,3,0,-7,7,0,0,-20,-29,-4,-5,9,4,0,0,1,-1,0,-1,4,-1
KR_6743247169,420,0,-14,1,-2,2,2,4,0,4,4,-4,4,0,-1,2,1,1,1,2,0,-1,1,-4,-5,9,3,0,-1,1,1,-1,-1,2,-1
KR_6739389131,440,-3,-26,8,-15,-7,8,1,1,2,3,-5,6,1,5,1,6,-9,9,0,-1,-5,-6,-3,-3,6,5,0,-1,-1,-1,-1,-1,3,-1
KR_6760395437,420,-3,-13,-8,-10,0,4,4,1,2,3,-6,6,0,-5,7,2,0,2,2,0,-15,-108,-5,-1,6,-22,0,0,-1,-1,-1,-1,4,-1
KR_6763927539,420,-1,-14,-46,-5,2,0,2,-2,3,1,-3,4,1,-1,3,2,-1,2,1,0,-9,-277,7,-10,3,-3,0,0,-1,-1,1,-1,2,-1
KR_6701240371,420,1,-15,1,-1,2,2,4,-1,2,1,1,1,2,0,1,1,-3,3,0,0,-10,1,-1,-5,6,-2,0,-1,-1,1,-1,-1,6,-1
KR_6770700337,420,-4,48,-39,-5,1,1,2,-2,3,1,-1,1,0,-3,6,3,0,0,0,0,-15,-2,-3,-5,8,1,0,1,-1,1,1,-1,5,-1
KR_6756876449,420,-4,-22,-7,-7,-3,3,0,-4,5,1,-1,3,2,1,1,2,0,0,0,0,-10,-4,-2,-5,7,5,0,-1,-1,-1,-1,1,4,-1
KR_6697635407,420,-2,-34,-11,-3,-3,3,0,1,0,1,-2,4,2,1,1,2,0,0,0,-1,-3,1,-1,-6,7,-1,0,0,0,-1,0,-1,0,-1
KR_6732672051,420,0,-29,-16,1,0,3,3,3,0,3,2,1,3,-2,4,2,-2,2,0,0,3,6,-3,-3,6,2,0,-1,-1,1,-1,1,6,-1
KR_6761247158,420,-2,-50,-11,-1,2,1,3,1,4,5,-1,4,3,-2,2,0,-1,3,2,0,4,-6,-2,-4,6,-1,0,1,1,1,1,-1,2,-1
KR_6749334462,420,-3,-53,0,-7,2,0,2,-6,6,0,-2,2,0,0,1,1,-1,1,0,0,-15,-15,6,-12,6,1,0,-1,-1,-1,-1,-1,2,-1
KR_6732582065,420,-2,-13,-12,-3,1,1,2,-1,2,1,1,1,2,-3,6,3,-1,2,1,0,-11,-6,-1,-5,6,-1,0,1,-1,-1,1,-1,6,-1
KR_6770644980,420,-1,-11,-20,-1,-1,1,0,3,2,5,-2,3,1,-1,3,2,0,0,0,0,0,29,0,-5,5,-2,0,-2,-1,-1,-1,-1,1,-1
KR_6694106774,420,4,74,36,5,-2,2,0,0,1,1,2,0,2,4,0,4,1,1,2,0,4,-6,0,-4,4,4,0,0,1,-1,-1,1,4,-1
KR_6422580509,420,-3,9,-16,-6,-2,2,0,-1,2,1,-2,3,1,0,1,1,-1,1,0,0,-8,13,1,-7,6,5,0,-1,-1,-1,-1,1,4,-1
KR_6770532242,420,-3,-69,12,-4,-1,2,1,-3,4,1,-1,2,1,1,2,3,0,0,0,0,-3,-241,-1,-5,6,-2,0,0,-1,1,0,-1,4,-1
KR_6756649992,420,-6,-93,-24,-19,-6,6,0,-6,11,5,-3,3,0,-5,7,2,1,1,2,0,-20,-27,-5,-6,11,-2,0,-2,-1,0,-1,-1,4,-1
KR_6742771757,420,-1,48,-4,-4,-4,5,1,0,6,6,-2,5,3,2,1,3,0,1,1,0,-2,2,4,-8,4,0,0,0,-1,-1,1,-1,6,-1
KR_6764493169,440,2,-4,6,-2,-3,3,0,-4,6,2,3,0,3,3,0,3,-1,2,1,0,-4,-3,-5,-5,10,-3,0,0,0,-1,1,1,0,-1
KR_6766216291,420,-1,8,40,-8,3,2,5,-3,5,2,-4,6,2,-5,7,2,1,0,1,-2,-13,41,5,-7,2,-1,0,-1,-1,1,-1,1,2,-1
KR_6553772823,440,0,9,21,-3,5,3,8,-7,8,1,0,1,1,0,1,1,-1,3,2,0,-5,-15,2,-6,4,-1,0,0,-1,-1,-1,-1,1,-1
KR_6755401018,440,-6,-46,-32,-4,0,0,0,0,1,1,5,1,6,-6,8,2,-3,4,1,1,-1,-2,1,-5,4,2,0,-1,-1,0,-1,1,1,-1
KR_6737096704,420,1,-13,8,4,-3,3,0,3,2,5,-1,4,3,2,3,5,3,1,4,0,8,27,-5,-3,8,-12,0,0,0,-1,-1,-1,0,-1
KR_6754963450,420,-2,-20,-37,-3,0,0,0,0,2,2,-3,5,2,-2,2,0,2,0,2,0,0,-17,-2,-2,4,-2,0,0,-1,1,0,1,3,-1
KR_6714120800,420,-4,-49,8,-8,-3,5,2,3,2,5,1,2,3,-7,7,0,-2,3,1,0,-13,-10,-1,-4,5,-1,0,-2,1,-1,-1,-1,3,-1
KR_6746634196,420,-2,19,12,-3,-5,5,0,2,1,3,-1,2,1,1,3,4,0,1,1,0,2,9,4,-6,2,4,0,-2,1,-1,-1,1,2,-1
KR_6754581728,420,-3,-43,-8,-10,-4,4,0,-5,5,0,3,2,5,-3,7,4,-1,2,1,0,-15,-3,-2,-3,5,0,0,-2,1,-1,-1,1,5,-1
KR_6628531531,420,-1,-20,-16,3,3,1,4,-5,5,0,0,4,4,5,1,6,0,2,2,0,4,-15,5,-12,7,0,0,0,-1,1,0,-1,6,-1
KR_6760399740,420,1,-31,32,0,6,1,7,-3,4,1,4,0,4,-6,6,0,-1,1,0,0,-7,27,-5,-3,8,3,0,0,1,1,1,-1,6,-1
KR_6768201031,420,-3,7,-22,-6,1,1,2,-5,8,3,-2,2,0,0,3,3,0,0,0,0,-7,39,-1,-6,7,2,0,1,1,1,1,-1,6,-1
KR_6749211514,420,0,16,8,-1,2,0,2,0,3,3,-4,5,1,2,1,3,-1,1,0,0,-1,7,-2,-4,6,-5,0,1,1,1,1,1,4,-1
KR_6681195754,440,2,43,8,-1,-2,6,4,1,7,8,-2,3,1,-5,7,2,7,2,9,-3,2,-5,-2,-2,4,0,0,0,1,-1,1,1,5,-1
KR_6769628588,420,-1,-74,-4,0,6,0,6,-3,5,2,2,1,3,-5,6,1,0,2,2,0,-6,-160,4,-7,3,-2,0,0,-1,1,1,-1,5,-1
KR_6691952237,420,0,-19,2,-5,0,1,1,-1,4,3,-1,3,2,-3,3,0,0,1,1,-1,-2,63,-6,-3,9,4,0,0,1,-1,-1,-1,1,-1
KR_6764665669,420,3,-20,40,3,-1,3,2,4,1,5,0,1,1,0,0,0,0,0,0,0,5,-32,0,-7,7,19,0,0,1,-1,-1,1,1,-1
KR_6680169386,420,-2,53,-40,-13,-7,7,0,-8,11,3,-1,3,2,4,2,6,-1,1,0,0,-7,-24,-1,-6,7,-6,0,0,1,-1,-1,1,4,-1
KR_6710089134,420,0,80,11,3,1,2,3,-1,5,4,2,1,3,1,3,4,0,2,2,2,0,-1,3,-6,3,-1,0,1,1,1,1,1,4,-1
KR_6745346008,420,-4,-28,-27,-12,-1,2,1,-6,6,0,-2,2,0,-3,5,2,0,0,0,1,-18,-11,-2,-6,8,-2,0,-3,-1,-1,-1,1,5,-1
KR_6709328401,420,-3,14,4,-6,-1,3,2,-4,7,3,-2,4,2,0,0,0,1,0,1,0,-2,-7,-4,-1,5,-3,0,-1,-1,-1,-1,-1,2,-1
KR_6750536755,420,-2,-56,-8,-3,0,2,2,-3,5,2,-4,4,0,2,0,2,2,0,2,0,1,-5,-4,-3,7,-2,0,-1,-1,-1,-1,-1,5,-1
KR_6767519780,420,-1,-24,22,-7,-1,2,1,1,1,2,0,3,3,-5,8,3,-2,2,0,0,-7,3,-8,-1,9,2,0,-1,1,-1,-1,1,5,-1
KR_6751781795,420,-2,-38,-17,-17,-1,4,3,-6,6,0,2,1,3,-10,13,3,-2,2,0,-1,-21,-19,1,-5,4,2,0,-3,-1,0,-1,-1,6,-1
KR_6690806874,420,-1,-16,-4,-1,-2,3,1,1,2,3,0,1,1,1,4,5,-1,2,1,2,5,17,-6,-4,10,2,0,0,1,-1,0,1,1,-1
KR_6552253788,420,-4,-82,4,-7,-2,3,1,-2,3,1,3,0,3,-5,10,5,-1,2,1,0,-3,23,-1,-4,5,0,0,-2,-1,-1,-1,-1,4,-1
KR_6764687581,420,-3,-64,-11,-10,4,2,6,-4,7,3,0,6,6,-9,11,2,-1,1,0,-2,-4,-4,2,-6,4,2,0,-2,-1,0,-1,-1,2,-1
KR_6760334798,420,-1,-6,8,-4,-1,3,2,0,0,0,0,2,2,-2,6,4,-1,1,0,0,-7,33,-1,-5,6,-5,0,-1,-1,1,-1,-1,4,-1
KR_6769695932,420,-3,-44,-12,-1,-3,3,0,1,2,3,0,1,1,2,1,3,-1,1,0,0,1,10,9,-11,2,1,0,-1,1,-1,1,-1,5,-1
KR_6739930292,420,-4,-81,-8,-5,2,1,3,-1,3,2,-2,2,0,-5,8,3,1,1,2,0,-7,8,-1,-5,6,-5,0,-3,-1,-1,-1,1,2,-1
KR_6755771555,420,0,9,-27,0,2,0,2,-3,6,3,0,4,4,2,1,3,-1,2,1,0,1,-8,1,-6,5,5,0,0,-1,1,0,-1,2,-1
KR_6637200942,440,-4,-104,-16,-19,-10,11,1,3,1,4,-7,9,2,-8,9,1,3,1,4,0,-9,-5,5,-8,3,-3,0,-3,-1,-1,-1,-1,6,-1
KR_6769188903,420,1,-9,21,-3,2,2,4,1,1,2,-1,4,3,-4,4,0,-1,3,2,0,-2,29,1,-3,2,-9,0,-1,-1,1,1,-1,4,-1
KR_6696703371,420,-2,55,-27,-5,4,2,6,-5,8,3,0,5,5,-5,5,0,1,0,1,1,-6,-40,4,-9,5,6,0,-1,-1,-1,1,-1,3,-1
KR_6674478209,420,-2,-52,-9,-5,-4,4,0,1,4,5,1,3,4,-2,3,1,-1,2,1,0,1,-12,-3,-6,9,-3,0,-2,-1,-1,-1,-1,2,-1
KR_6720048851,420,-1,-15,20,-2,2,1,3,1,4,5,0,3,3,-4,7,3,-1,2,1,0,-10,18,11,-13,2,-7,0,-3,1,-1,-1,-1,1,-1
KR_6734701434,420,-1,-41,-19,-1,0,0,0,-3,6,3,4,1,5,-2,2,0,0,0,0,0,-4,-11,-1,-4,5,3,0,0,-1,1,0,1,3,-1
KR_6770311029,420,-3,-58,16,-13,-5,5,0,-4,6,2,1,5,6,-2,4,2,-3,3,0,0,-17,-153,3,-6,3,-4,0,-3,0,1,-1,-1,0,-1
KR_6736614416,420,3,39,-16,4,2,0,2,-3,6,3,2,1,3,1,1,2,2,0,2,0,-2,8,3,-7,4,1,0,1,-1,1,1,-1,5,-1
KR_6769028013,420,3,75,-4,4,0,0,0,1,3,4,3,2,5,1,1,2,-1,1,0,0,2,26,-1,-4,5,-3,0,1,1,1,1,1,5,-1
KR_6767758340,420,1,68,5,3,1,2,3,5,1,6,0,3,3,-2,2,0,-1,3,2,0,0,-11,-1,-6,7,-4,0,-1,0,-1,-1,-1,0,-1
KR_6739257298,420,0,-24,-1,-1,-1,1,0,0,2,2,0,1,1,-1,2,1,1,0,1,0,3,7,0,-8,8,-6,0,0,1,-1,0,-1,6,-1
KR_6760899732,420,2,11,4,3,-1,3,2,1,1,2,-1,5,4,-2,6,4,6,0,6,0,-4,-15,-2,-5,7,-2,0,-1,-1,-1,-1,-1,2,-1
KR_6747503410,420,-3,-35,-28,-7,-2,2,0,-1,4,3,2,1,3,-6,6,0,0,1,1,0,-2,0,5,-9,4,-3,0,-1,1,-1,-1,-1,1,-1
KR_6705380937,420,-3,-5,-20,-5,0,2,2,-4,4,0,3,1,4,-1,3,2,-3,3,0,1,-4,12,0,-6,6,-1,0,1,0,-1,1,1,0,-1
KR_6689495111,420,1,40,-12,4,2,0,2,-1,2,1,0,2,2,2,4,6,1,1,2,1,-1,27,0,-6,6,1,0,0,1,1,1,1,5,-1
KR_6726362988,440,-5,-116,-6,-8,-7,7,0,0,4,4,-2,3,1,1,1,2,0,1,1,-1,-5,47,-2,-5,7,-25,0,-1,-1,-1,-1,-1,6,-1
KR_6724926270,420,0,-30,21,-1,-1,1,0,5,0,5,0,3,3,-1,2,1,-4,4,0,0,-2,2,-3,-4,7,-2,0,0,1,-1,0,-1,2,-1
KR_6770186975,420,-6,-58,12,-9,-1,1,0,-2,2,0,0,5,5,-6,7,1,0,0,0,-2,-17,-3,-1,-5,6,-4,0,-1,-1,1,-1,-1,1,-1
KR_6717807509,440,-1,-24,-4,2,-3,4,1,4,0,4,-2,4,2,2,2,4,1,0,1,0,9,-2,2,-4,2,-2,0,0,0,1,0,-1,0,-1
KR_6753212890,420,-4,-40,0,-14,-1,1,0,0,4,4,-6,6,0,-5,6,1,-2,2,0,0,-11,-15,-1,-4,5,0,0,0,-1,-1,-1,-1,2,-1
KR_6767183475,440,-4,-105,-43,-8,-1,1,0,-4,9,5,-5,6,1,1,5,6,1,1,2,1,2,-13,-5,-3,8,1,0,-3,-1,-1,-1,-1,6,-1
KR_6761410098,440,-1,26,-23,-4,2,2,4,0,2,2,-3,8,5,-3,3,0,0,0,0,0,6,-84,3,-7,4,-6,0,0,-1,0,0,-1,4,-1
KR_6605473920,420,0,9,-4,-2,-1,3,2,2,2,4,-6,8,2,3,1,4,0,0,0,2,2,-3,-2,-5,7,-4,0,0,-1,1,0,1,5,-1
KR_6744735830,420,-1,-28,-35,1,-1,1,0,1,2,3,-1,3,2,4,2,6,-2,2,0,0,9,18,0,-3,3,2,0,0,-1,-1,0,-1,2,-1
KR_6726044050,440,-1,-87,-16,0,1,5,6,0,0,0,1,1,2,-3,4,1,1,1,2,0,-1,-17,1,-6,5,0,0,-2,-1,-1,-1,1,3,-1
KR_6770489273,440,2,-22,51,5,0,1,1,6,0,6,5,0,5,-5,10,5,-1,2,1,0,7,-132,2,-6,4,-2,0,-1,-1,1,-1,1,6,-1
KR_6733520368,420,-3,-15,-3,-8,-1,4,3,3,3,6,-1,2,1,-6,6,0,-3,3,0,-1,-6,-23,-2,-3,5,0,0,-1,-1,0,-1,-1,2,-1
KR_6769005391,420,-3,-38,4,-4,0,0,0,0,1,1,0,1,1,-3,3,0,-1,3,2,0,-3,-33,2,-9,7,1,0,-1,-1,-1,-1,-1,6,-1
KR_6691632591,420,-6,-56,-22,-8,-2,2,0,-5,6,1,-1,1,0,2,3,5,-2,3,1,0,-4,-11,-4,-5,9,4,0,0,1,-1,-1,-1,4,-1
KR_6749575246,440,0,51,-12,2,-2,2,0,2,5,7,1,3,4,1,2,3,0,2,2,0,-3,-9,5,-6,1,-1,0,0,1,-1,0,1,6,-1
KR_6770941909,420,1,-16,4,5,4,0,4,-2,3,1,-1,3,2,1,7,8,3,0,3,0,8,10,-2,-2,4,1,0,2,0,1,1,-1,0,-1
KR_6770540979,420,3,6,29,-3,-1,1,0,-2,3,1,2,2,4,-1,3,2,-1,2,1,-1,-11,-294,0,-5,5,-2,0,-1,-1,-1,-1,-1,3,-1
KR_6770287833,440,-4,-113,20,-11,-3,6,3,-3,3,0,0,1,1,-4,4,0,-1,2,1,0,-13,2,0,-3,3,-1,0,-2,-1,1,-1,-1,1,-1
KR_6742154847,420,-1,36,-17,-4,0,1,1,-2,2,0,-3,4,1,0,1,1,1,1,2,0,-1,207,-2,-3,5,-1,0,-1,-1,1,1,1,4,-1
KR_6750366799,420,-4,-80,-4,-14,-2,4,2,0,4,4,0,1,1,-9,9,0,-3,3,0,-3,-21,-1,-2,-4,6,-6,0,0,-1,-1,-1,-1,3,-1
KR_6746698057,420,-2,-52,12,-4,4,1,5,-2,4,2,1,0,1,-8,8,0,1,1,2,0,3,-45,-1,-4,5,21,0,-1,1,1,1,-1,4,-1
KR_6769146126,420,-3,-20,-19,-5,-3,3,0,0,2,2,0,4,4,-3,4,1,1,0,1,-1,-2,14,-5,-4,9,-7,0,-1,1,-1,-1,-1,6,-1
KR_6770475083,440,-5,3,4,-16,-10,10,0,1,3,4,1,4,5,-4,8,4,-4,6,2,-1,-16,109,0,-2,2,-1,0,-2,0,-1,-1,-1,0,-1
KR_6744610975,420,-4,-73,4,-1,-4,5,1,1,1,2,2,1,3,-1,3,2,1,1,2,0,-2,5,2,-6,4,-6,0,0,0,-1,-1,1,0,-1
KR_6760187623,420,0,-56,-8,2,-2,5,3,-2,4,2,0,2,2,6,2,8,0,0,0,0,14,-385,-1,-4,5,-4,0,-1,-1,-1,-1,1,3,-1
KR_6642768681,420,5,38,10,14,-3,3,0,7,1,8,7,3,10,2,0,2,1,1,2,-1,17,-8,-1,-6,7,6,0,2,1,-1,1,-1,2,-1
KR_6746665702,420,-2,3,-7,-7,0,1,1,-4,6,2,-3,3,0,-2,5,3,2,2,4,1,-11,-20,3,-10,7,-5,0,0,-1,-1,0,1,4,-1
KR_6767174889,420,-2,15,30,-1,3,0,3,-3,4,1,-6,7,1,5,1,6,0,2,2,0,-2,52,-3,-6,9,-6,0,0,0,0,0,1,0,-1
KR_6749584756,420,-1,34,-23,-1,-2,2,0,0,2,2,-2,4,2,3,1,4,0,3,3,0,3,-14,-7,-2,9,5,0,0,1,-1,1,1,3,-1
KR_6740843595,420,-4,-67,5,-7,-4,4,0,1,0,1,0,1,1,-3,7,4,-1,1,0,0,-10,-3,0,-6,6,0,0,-2,-1,-1,-1,1,5,-1
KR_6618008442,420,-2,-36,-21,-5,-1,1,0,-3,3,0,6,0,6,-5,7,2,-2,4,2,0,-7,-94,1,-5,4,-2,0,-1,-1,-1,-1,1,3,-1
KR_6760218158,420,0,-14,-13,0,-2,3,1,0,4,4,2,1,3,-1,4,3,1,1,2,0,7,-114,2,-6,4,3,0,-1,-1,-1,-1,-1,3,-1
KR_6728224920,420,-5,-59,-34,-8,-3,4,1,-7,8,1,-2,6,4,1,6,7,3,1,4,-1,-5,-6,-2,-4,6,0,0,0,1,-1,-1,-1,3,-1
KR_6765316414,440,2,30,15,1,-4,7,3,2,2,4,2,1,3,2,0,2,-1,3,2,0,-1,4,2,-9,7,-1,0,0,0,-1,1,1,0,-1
KR_6753894796,420,0,-60,-7,1,-5,7,2,4,0,4,4,0,4,-1,3,2,-1,1,0,-1,-3,43,-4,-4,8,1,0,0,1,1,0,-1,6,-1
KR_6668330574,420,-3,28,-8,-9,1,2,3,2,2,4,-4,6,2,-3,6,3,-5,6,1,-3,-13,4,2,-8,6,0,0,-1,-1,-1,-1,-1,3,-1
KR_6691374236,420,4,19,-12,2,1,4,5,0,3,3,-2,3,1,4,2,6,-1,2,1,0,4,-5,-5,-3,8,-1,0,0,-1,-1,0,1,6,-1
KR_6740232465,420,-4,-28,-12,-16,-7,7,0,-1,5,4,-6,8,2,0,3,3,-2,4,2,0,-22,-8,0,-5,5,-1,0,-1,-1,-1,-1,-1,6,-1
KR_6769669570,420,-5,-23,-34,-17,-2,3,1,-3,4,1,0,3,3,-11,13,2,-1,1,0,0,-19,4,3,-10,7,-3,0,-2,-1,-1,-1,-1,5,-1
KR_6482122865,420,-2,-28,-38,-7,-1,2,1,-4,6,2,2,2,4,-1,1,0,-3,4,1,-1,-8,233,1,-5,4,-3,0,-2,-1,-1,-1,-1,3,-1
KR_6769899081,440,1,62,12,-2,0,4,4,1,1,2,1,2,3,-3,4,1,-1,4,3,-1,-2,-6,-2,-4,6,3,0,1,1,1,1,-1,1,-1
KR_6681237453,420,-2,42,-29,-18,3,3,6,-9,9,0,-5,7,2,-6,7,1,-1,3,2,-2,-20,-66,-2,-1,3,-4,0,0,-1,-1,-1,-1,4,-1
KR_6727168484,420,-2,-53,-6,-7,-2,4,2,-2,2,0,-4,7,3,1,5,6,0,0,0,0,-13,-4,-5,-2,7,0,0,-2,1,-1,-1,-1,6,-1
KR_6644155937,420,-1,-24,-12,0,-1,2,1,-2,4,2,-3,4,1,5,1,6,1,0,1,-2,-6,19,-3,-5,8,1,0,0,0,1,0,-1,0,-1
KR_6742232711,420,-5,18,-17,-10,-2,3,1,-4,7,3,-4,7,3,-2,4,2,2,1,3,0,-9,1,0,-3,3,-3,0,-1,-1,1,-1,-1,1,-1
KR_6770914901,420,1,-50,-20,-1,1,2,3,-2,6,4,-3,6,3,3,0,3,0,0,0,0,-2,7,4,-8,4,-4,0,2,-1,1,1,-1,4,-1
KR_6669731395,440,-1,-26,-16,-2,1,1,2,-1,4,3,-4,6,2,0,0,0,2,0,2,0,-5,4,-1,-5,6,-1,0,0,-1,-1,-1,-1,3,-1
KR_6729294690,420,1,-49,15,3,-2,2,0,5,1,6,-1,2,1,0,3,3,1,0,1,0,2,13,1,-7,6,-1,0,1,1,1,1,-1,4,-1
KR_6676975090,420,-4,-31,-21,-5,-2,2,0,0,2,2,0,1,1,-2,3,1,-1,1,0,0,-3,-46,-2,-5,7,-5,0,-1,1,-1,-1,-1,6,-1
KR_6763566221,420,-3,-47,16,-2,0,1,1,0,3,3,-2,3,1,1,4,5,-1,1,0,-1,-2,-4,0,-4,4,-4,0,1,-1,1,1,-1,6,-1
KR_6642769470,420,-3,-55,-41,-8,1,0,1,-5,8,3,0,2,2,-3,5,2,-1,2,1,0,-4,6,0,-3,3,1,0,-2,-1,-1,-1,-1,4,-1
KR_6716891528,420,1,53,27,3,-5,6,1,-1,4,3,5,1,6,4,2,6,0,4,4,-1,0,-11,-1,-5,6,3,0,0,0,-1,1,-1,0,-1
KR_6745464510,420,0,43,18,-3,3,1,4,-6,6,0,0,3,3,-1,2,1,1,2,3,0,-5,-4,-4,-2,6,2,0,-1,1,-1,-1,-1,2,-1
KR_6730052047,420,-5,-88,-7,-9,-6,6,0,-4,4,0,-4,5,1,5,1,6,0,0,0,0,-6,-12,-5,-2,7,5,0,-2,1,-1,-1,-1,1,-1
KR_6717915588,420,-1,-56,-16,-9,0,4,4,-5,6,1,-3,3,0,0,4,4,-1,1,0,0,-13,35,3,-4,1,1,0,-1,-1,1,-1,-1,2,-1
KR_6709924335,420,-2,-7,-6,-6,-1,3,2,-3,4,1,0,5,5,-3,3,0,1,0,1,0,-5,5,0,-8,8,1,0,-1,-1,-1,-1,-1,5,-1
KR_6766182162,420,2,21,4,8,2,1,3,4,1,5,3,1,4,-1,1,0,0,0,0,0,7,0,-3,-2,5,-1,0,1,-1,1,1,-1,2,-1
KR_6764953241,420,-1,4,-10,-11,3,1,4,-2,6,4,-2,3,1,-2,2,0,-8,10,2,-1,-13,10,-8,-1,9,6,0,0,-1,1,-1,-1,3,-1
KR_6769944408,420,-5,-41,-48,-6,2,1,3,-3,5,2,1,2,3,-4,5,1,-2,3,1,0,-2,-3,4,-6,2,-2,0,-1,-1,-1,-1,1,2,-1
KR_6713754925,420,-4,-45,-29,-6,-3,3,0,-2,5,3,2,1,3,-1,3,2,-2,2,0,0,0,-5,-1,-6,7,-4,0,0,1,-1,-1,1,3,-1
KR_6746355018,420,-2,-63,-12,-4,-3,3,0,1,1,2,-1,4,3,-1,1,0,0,0,0,0,-4,0,-1,-5,6,2,0,0,-1,-1,0,1,3,-1
KR_6649695591,420,0,20,-4,-11,-1,2,1,2,2,4,-6,7,1,-6,7,1,0,2,2,0,-14,5,-2,-4,6,-2,0,-1,-1,-1,-1,-1,5,-1
KR_6765801434,420,0,-34,1,-4,2,3,5,-1,3,2,-3,3,0,-2,4,2,0,0,0,-1,-6,-1,-1,-3,4,5,0,1,1,1,1,-1,5,-1
KR_6742362835,420,1,90,-12,0,2,0,2,0,3,3,5,0,5,-5,6,1,-2,2,0,0,-3,13,4,-5,1,-3,0,1,-1,1,1,1,4,-1
KR_6716149986,420,-3,-54,-33,-8,-2,2,0,-9,9,0,3,2,5,-2,3,1,2,1,3,0,-2,-172,-1,-4,5,3,0,-3,-1,-1,-1,-1,6,-1
KR_6687398384,440,0,-40,-30,9,1,2,3,5,1,6,0,4,4,-2,3,1,5,1,6,0,11,9,-1,-8,9,0,0,-1,1,-1,-1,1,6,-1
KR_6758220274,420,2,44,23,4,0,1,1,0,1,1,-1,5,4,2,2,4,3,1,4,0,1,3,0,-5,5,5,0,1,1,-1,1,1,3,-1
KR_6749607470,420,0,28,-36,3,-1,2,1,-2,4,2,5,1,6,2,1,3,-1,2,1,0,8,-42,1,-7,6,26,0,0,-1,-1,-1,1,1,-1
KR_6755314573,420,-6,-32,-14,-11,-3,4,1,-1,3,2,2,0,2,-9,10,1,0,1,1,0,-13,-3,2,-8,6,-2,0,-2,1,-1,-1,-1,2,-1
KR_6745415940,420,0,-5,13,-5,2,0,2,2,3,5,-1,2,1,-6,7,1,-2,3,1,0,-9,-50,-1,-4,5,24,0,-1,-1,-1,-1,-1,6,-1
KR_6755975215,420,-3,-69,-28,-4,-2,3,1,-3,4,1,-1,1,0,3,1,4,-1,1,0,0,6,-1,0,-3,3,-1,0,0,-1,-1,-1,-1,5,-1
KR_6692857095,420,-7,-107,-27,-22,-3,4,1,-1,4,3,-5,6,1,-10,12,2,-3,4,1,-1,-24,-6,0,-5,5,2,0,-3,-1,-1,-1,-1,5,-1
KR_6762176451,420,0,-27,0,-6,-8,9,1,-2,4,2,2,0,2,2,0,2,0,0,0,0,-14,-9,-4,-2,6,-2,0,-2,-1,-1,-1,-1,1,-1
KR_6743323019,420,-5,-99,35,-19,-5,6,1,-9,9,0,2,2,4,-2,4,2,-5,8,3,-1,-18,-4,-6,-1,7,-1,0,-3,0,-1,-1,-1,0,-1
KR_6647803678,420,-1,-51,-16,-3,-1,1,0,0,3,3,-1,4,3,-1,2,1,0,1,1,-2,-7,24,-2,-6,8,3,0,-1,1,-1,-1,-1,1,-1
KR_6719555106,420,-1,-15,9,-3,4,0,4,-6,7,1,0,2,2,2,0,2,-3,3,0,0,-9,1,-4,-3,7,-2,0,0,-1,1,0,1,4,-1
KR_6756928702,420,0,10,12,2,2,0,2,-2,2,0,0,2,2,0,4,4,2,1,3,0,3,2,-1,-5,6,2,0,0,-1,-1,0,1,4,-1
KR_6767441841,440,-3,-71,0,-2,0,1,1,4,1,5,0,4,4,-3,3,0,-3,3,0,0,-2,-168,1,-3,2,0,0,-1,0,0,-1,-1,0,-1
KR_6644371270,420,-3,-52,-7,-11,-1,3,2,-3,3,0,2,2,4,-9,9,0,0,0,0,0,-10,-23,2,-7,5,2,0,-1,-1,-1,-1,-1,1,-1
KR_6762675922,420,-5,-56,-17,-3,-1,2,1,4,2,6,0,1,1,-4,5,1,-2,3,1,0,-6,165,-6,-2,8,0,0,-2,-1,-1,-1,-1,4,-1
KR_6752196755,420,-5,-88,-13,-11,-4,6,2,-2,5,3,-1,3,2,-3,7,4,-1,1,0,0,-14,-11,-5,-2,7,1,0,-5,-1,-1,-1,1,1,-1
KR_6764905027,420,2,-19,12,2,4,1,5,0,1,1,-4,4,0,3,1,4,-1,1,0,0,6,-6,-3,-5,8,0,0,0,-1,1,0,-1,4,-1
KR_6762630472,420,-1,-18,-16,-10,-2,2,0,-5,8,3,2,2,4,-1,4,3,-4,4,0,0,-6,2,-6,-1,7,0,0,0,-1,-1,-1,-1,1,-1
KR_6743075723,420,0,32,0,-3,3,0,3,-2,5,3,-2,2,0,-2,2,0,0,0,0,0,-8,-9,-3,-3,6,-5,0,-1,-1,-1,-1,-1,1,-1
KR_6553900263,440,-1,-45,-42,-1,2,3,5,-7,8,1,3,5,8,2,1,3,-1,1,0,0,5,-87,4,-6,2,-3,0,-2,-1,-1,-1,1,4,-1
KR_6763675628,420,0,-21,1,1,-5,5,0,-3,6,3,5,2,7,3,2,5,1,1,2,1,7,-6,-2,-3,5,1,0,-2,-1,-1,-1,1,5,-1
KR_6741005503,420,-1,22,-50,-3,0,0,0,-2,2,0,-5,9,4,3,1,4,1,0,1,0,0,11,1,-5,4,-2,0,2,-1,1,1,1,2,-1
KR_6766644588,440,-6,-50,-42,-14,-7,8,1,5,2,7,-10,12,2,-5,6,1,3,1,4,0,-23,11,3,-6,3,-3,0,-2,-1,1,-1,1,1,-1
KR_6686626035,420,-6,-28,-32,-7,0,1,1,1,2,3,-3,3,0,-4,6,2,-1,2,1,1,-7,-30,6,-8,2,-5,0,-1,-1,-1,-1,1,1,-1
KR_6713976333,420,-1,-9,-12,-1,-3,4,1,0,1,1,1,4,5,0,5,5,1,0,1,0,-4,4,2,-7,5,-3,0,-1,1,-1,-1,-1,3,-1
KR_6648928873,420,-2,-70,0,-1,6,0,6,0,1,1,-4,5,1,-2,3,1,-1,2,1,1,-3,1,0,-6,6,-3,0,-1,-1,-1,-1,1,1,-1
KR_6744869546,440,-3,-2,-12,1,1,1,2,-1,3,2,4,0,4,-4,7,3,1,2,3,-1,-17,-58,-6,-2,8,-3,0,-1,-1,1,-1,-1,3,-1
KR_6750921746,440,0,66,23,-4,2,1,3,0,2,2,4,1,5,-10,10,0,0,1,1,1,-17,-13,4,-9,5,0,0,1,-1,1,1,1,5,-1
KR_6709715772,420,1,31,-33,-2,-3,4,1,0,1,1,-1,3,2,1,0,1,1,0,1,0,3,26,2,-6,4,-14,0,-1,1,-1,-1,-1,3,-1
KR_6770289258,420,-1,-80,-3,1,0,1,1,-1,4,3,6,0,6,-1,1,0,-3,4,1,0,-7,-130,2,-3,1,-1,0,-1,-1,1,-1,1,5,-1
KR_6745048937,420,-2,-9,-25,3,0,2,2,-2,2,0,-1,2,1,5,1,6,1,1,2,0,11,-51,4,-7,3,28,0,0,1,-1,-1,1,1,-1
KR_6770290995,420,-3,-51,11,-6,0,1,1,-1,3,2,-2,3,1,-1,2,1,-2,2,0,0,-9,-19,-4,-5,9,-6,0,-2,-1,-1,-1,-1,2,-1
KR_6663557386,420,0,4,-29,-6,1,1,2,-2,3,1,-1,3,2,-3,4,1,-1,1,0,0,-6,27,-6,-2,8,0,0,-3,-1,0,-1,-1,1,-1
KR_6768099118,420,-2,0,-23,-3,3,0,3,1,1,2,2,0,2,-1,4,3,-8,8,0,0,-5,4,0,-5,5,1,0,1,-1,1,-1,-1,2,-1
KR_6747969755,420,0,6,-2,0,-1,1,0,0,1,1,-4,5,1,5,0,5,0,2,2,0,11,8,5,-8,3,-5,0,0,1,-1,0,1,4,-1
KR_6760970318,420,-1,-42,4,-2,-1,2,1,-4,5,1,1,0,1,3,1,4,-1,1,0,0,0,20,0,-3,3,-4,0,-1,-1,1,-1,1,5,-1
KR_6762079258,420,-1,6,-5,3,1,4,5,1,4,5,-4,5,1,5,0,5,0,3,3,2,10,8,7,-11,4,-4,0,0,1,-1,0,1,6,-1
KR_6762667353,440,1,-43,-5,7,0,1,1,7,1,8,1,5,6,-2,3,1,1,0,1,0,13,8,0,-6,6,0,0,-2,1,-1,-1,-1,1,-1
KR_6769725821,420,-2,-59,2,-5,-5,5,0,-8,10,2,3,2,5,4,1,5,1,0,1,0,0,-11,0,-4,4,2,0,1,-1,1,1,1,4,-1
KR_6769060343,420,-1,-15,28,-4,1,1,2,0,3,3,-2,3,1,-5,6,1,2,0,2,0,-6,0,-1,-6,7,1,0,0,1,1,0,1,5,-1
KR_6763100788,440,-2,-31,-10,-7,-2,4,2,-7,8,1,-1,5,4,3,0,3,0,0,0,-1,-13,5,-1,-7,8,-3,0,-2,-1,-1,-1,-1,6,-1
KR_6770210358,420,-5,-38,-8,-12,2,0,2,-1,2,1,-3,5,2,-10,11,1,0,2,2,-1,-15,3,-5,-2,7,-4,0,-1,-1,-1,-1,-1,2,-1
KR_6762018636,420,-5,-34,-29,-7,3,1,4,0,1,1,-3,6,3,-4,4,0,-3,3,0,0,-11,2,4,-6,2,-3,0,0,-1,1,-1,1,6,-1
KR_6725137303,420,-1,4,-3,-3,1,2,3,-2,6,4,1,1,2,0,2,2,-3,3,0,0,-5,10,5,-8,3,-7,0,0,-1,-1,0,1,3,-1
KR_6760234947,420,1,-11,-9,-1,-1,1,0,2,2,4,1,2,3,-3,4,1,0,1,1,0,2,244,-1,-5,6,0,0,0,1,-1,-1,-1,1,-1
KR_6729561500,420,1,12,5,-3,-4,4,0,0,3,3,1,1,2,-2,5,3,2,0,2,0,2,23,-2,-8,10,-5,0,-1,1,-1,-1,1,1,-1
KR_6674386214,420,-2,-10,11,-1,-2,2,0,-1,3,2,4,0,4,-2,3,1,0,0,0,0,5,-2,2,-6,4,-4,0,-2,-1,-1,-1,1,1,-1
KR_6748068580,420,1,3,13,-2,0,2,2,3,3,6,0,4,4,-3,5,2,-2,2,0,0,2,11,0,-4,4,-4,0,1,-1,1,1,-1,1,-1
KR_6714882679,440,-1,-39,-10,-3,0,1,1,4,0,4,-6,6,0,0,2,2,-1,1,0,0,-1,4,7,-9,2,-3,0,-2,0,-1,-1,-1,0,-1
KR_6762488647,440,4,91,-1,8,1,0,1,0,4,4,5,1,6,-3,4,1,5,1,6,1,10,7,0,-8,8,-7,0,1,1,-1,1,1,5,-1
KR_6737172372,420,2,18,6,-3,2,1,3,-1,3,2,-3,4,1,0,2,2,-1,1,0,-1,-8,-61,4,-7,3,6,0,1,-1,1,1,-1,1,-1
KR_6767158258,420,-5,-45,-73,-5,0,2,2,-4,4,0,-2,6,4,1,0,1,0,2,2,0,-9,-58,3,-4,1,2,0,-1,-1,-1,-1,-1,3,-1
KR_6762918304,420,0,82,4,-3,3,2,5,-4,7,3,-5,5,0,5,4,9,-2,2,0,0,-10,-9,-1,-5,6,2,0,1,-1,-1,1,-1,1,-1
KR_6685862251,420,1,-101,10,-4,1,2,3,1,5,6,-2,2,0,-2,3,1,-2,2,0,0,-1,41,-3,-3,6,-15,0,-1,-1,1,1,-1,3,-1
KR_6753682861,440,-2,-43,8,-7,-1,2,1,0,3,3,-2,6,4,-5,8,3,1,4,5,0,-10,4,0,-5,5,-5,0,-3,-1,-1,-1,-1,2,-1
KR_6666189513,420,0,-60,6,-2,-5,6,1,5,1,6,-4,5,1,2,6,8,0,1,1,0,2,-2,2,-5,3,-1,0,0,-1,1,1,1,4,-1
KR_6680073954,420,-4,-69,-4,-7,3,1,4,-5,5,0,-3,4,1,-4,4,0,2,0,2,0,-5,-6,-7,-1,8,2,0,0,-1,0,0,-1,2,-1
KR_6764690158,440,-1,-74,-12,-7,0,2,2,0,1,1,1,4,5,-7,8,1,-1,1,0,0,-10,-120,-2,-4,6,0,0,0,1,-1,0,-1,4,-1
KR_6768520510,420,0,-6,-12,0,2,0,2,0,3,3,-2,2,0,-1,4,3,1,0,1,0,-3,-3,-5,-3,8,-8,0,1,1,-1,1,1,2,-1
KR_6759002481,420,-1,-36,0,-4,-5,6,1,3,1,4,2,0,2,-3,7,4,-1,3,2,0,-3,-18,1,-5,4,2,0,-1,-1,0,-1,1,1,-1
KR_6770458815,420,-1,-5,3,1,3,0,3,0,3,3,1,1,2,0,2,2,-3,3,0,0,-1,8,-2,-5,7,-4,0,0,-1,1,0,-1,6,-1
KR_6750176519,420,-5,-37,-10,-13,-3,3,0,-1,3,2,2,0,2,-5,7,2,-6,6,0,0,-10,-11,-2,-4,6,-1,0,-3,-1,-1,-1,-1,1,-1
KR_6744175830,420,0,47,-1,2,-1,3,2,1,0,1,-2,2,0,4,3,7,0,0,0,0,0,-4,3,-10,7,0,0,0,-1,-1,0,1,1,-1
KR_6730666953,420,1,13,4,1,0,2,2,-4,7,3,-1,4,3,5,3,8,1,1,2,0,3,-1,-1,-6,7,2,0,0,1,-1,0,1,1,-1
KR_6768095774,420,-1,-22,-19,5,-1,1,0,0,3,3,2,2,4,1,0,1,3,0,3,-1,10,-8,-3,-7,10,4,0,1,1,1,1,-1,4,-1
KR_6768759203,420,1,53,-27,-6,1,2,3,-1,4,3,-2,3,1,-2,5,3,-2,2,0,0,-3,6,1,-4,3,-1,0,0,-1,-1,0,-1,4,-1
KR_6704737331,420,-2,-62,-15,-1,-2,4,2,-3,3,0,7,1,8,-4,4,0,1,0,1,0,2,4,0,-4,4,-1,0,-1,1,-1,-1,-1,3,-1
KR_6729452833,420,-4,-39,-11,-3,-1,2,1,-2,3,1,-1,2,1,1,3,4,0,0,0,0,1,-259,-5,-6,11,29,0,-1,-1,-1,-1,1,5,-1
KR_6764773882,420,2,1,10,1,2,4,6,-1,5,4,-1,1,0,3,2,5,-2,2,0,0,3,-4,-3,-5,8,3,0,0,1,-1,-1,-1,1,-1
KR_6768699258,420,-1,9,6,1,-2,2,0,3,3,6,-1,5,4,2,2,4,-1,1,0,1,5,-1,-2,-5,7,-1,0,0,1,-1,0,-1,4,-1
KR_6768392398,420,-1,4,-12,-6,-3,3,0,-1,4,3,-2,3,1,-1,3,2,1,1,2,0,-9,48,4,-9,5,-5,0,1,-1,1,1,-1,6,-1
KR_6770003812,440,-1,-51,-37,-3,1,2,3,4,4,8,-5,5,0,4,2,6,-7,9,2,-2,6,-1,0,-6,6,0,0,-4,-1,-1,-1,-1,2,-1
KR_6732292004,420,0,3,16,-5,-2,5,3,-1,3,2,0,2,2,1,2,3,-3,3,0,0,-6,114,1,-9,8,-3,0,-1,1,-1,-1,-1,2,-1
KR_6718384385,420,-2,-54,-15,-2,1,2,3,-4,6,2,1,1,2,0,3,3,0,1,1,-1,-6,17,1,-7,6,1,0,-1,-1,-1,-1,-1,4,-1
KR_6754806336,420,2,-16,0,-2,3,0,3,-2,3,1,-4,4,0,1,2,3,0,1,1,1,-1,6,0,-6,6,-3,0,1,-1,1,1,1,5,-1
KR_6610984785,420,-2,-31,-36,-5,4,1,5,-1,2,1,-3,4,1,-3,4,1,-2,5,3,0,-14,7,1,-5,4,-7,0,0,1,-1,1,-1,2,-1
KR_6678517296,420,0,-34,-4,-1,1,1,2,0,6,6,1,3,4,1,1,2,-4,4,0,0,-8,5,-1,-4,5,-4,0,0,-1,1,0,-1,3,-1
KR_6680418500,420,0,90,-12,1,-2,4,2,0,5,5,-1,3,2,3,1,4,1,0,1,0,-6,3,-2,-3,5,1,0,1,-1,-1,1,1,1,-1
KR_6732263759,420,1,-1,10,1,7,1,8,-1,2,1,4,0,4,-8,9,1,-1,2,1,0,-8,-49,6,-10,4,17,0,0,-1,1,1,-1,3,-1
KR_6680154148,420,-4,-82,-20,-7,-3,3,0,-2,3,1,-2,4,2,0,3,3,0,0,0,0,-8,-45,-2,-4,6,37,0,-1,-1,-1,-1,-1,3,-1
KR_6691787959,420,-5,-55,-25,-11,-1,3,2,-4,4,0,-2,3,1,-3,4,1,-1,1,0,0,-9,2,2,-5,3,-6,0,0,-1,-1,0,-1,2,-1
KR_6691561699,420,1,-14,8,-5,-1,3,2,-3,6,3,-2,2,0,0,4,4,1,0,1,0,-3,-196,-2,-4,6,0,0,0,-1,-1,0,-1,6,-1
KR_6758435951,420,-1,-59,9,-11,-2,5,3,-2,3,1,-1,1,0,-8,9,1,2,2,4,0,-11,3,-3,-3,6,-1,0,0,-1,1,1,-1,3,-1
KR_6725045988,420,-7,-67,-19,-9,0,1,1,0,1,1,-3,4,1,-5,5,0,-1,1,0,0,-12,-21,-2,-5,7,-2,0,-2,-1,-1,-1,1,3,-1
KR_6760647300,420,2,48,20,3,-1,5,4,1,3,4,-1,1,0,3,0,3,1,0,1,5,11,-1,-3,-3,6,1,0,0,1,-1,0,1,1,-1
KR_6752977257,420,-2,-11,3,-2,5,1,6,2,1,3,-4,5,1,-2,2,0,-3,3,0,0,-5,-6,0,-5,5,0,0,0,-1,1,0,1,6,-1
KR_6765230690,420,-5,-71,-9,-12,-2,2,0,-3,4,1,-3,5,2,-2,5,3,-2,2,0,0,-1,0,-2,-7,9,-5,0,-3,-1,-1,-1,-1,5,-1
KR_6729244330,420,0,8,-24,5,0,1,1,1,1,2,1,2,3,3,1,4,0,0,0,0,10,-4,1,-5,4,2,0,0,-1,-1,0,1,2,-1
KR_6761534422,440,-2,15,-40,-7,-2,4,2,1,3,4,-5,5,0,2,0,2,-3,3,0,0,-5,0,0,-6,6,6,0,0,-1,1,0,-1,1,-1
KR_6718536374,420,0,18,-8,-3,-4,5,1,-4,11,7,3,2,5,2,0,2,0,1,1,0,7,1,2,-5,3,2,0,-2,1,-1,-1,-1,6,-1
KR_6762851131,440,-2,-41,-21,-4,1,3,4,5,0,5,-3,3,0,-6,6,0,-1,1,0,0,-7,2,-3,-5,8,1,0,0,-1,0,0,-1,1,-1
KR_6718580317,420,3,21,32,3,3,1,4,1,3,4,-4,7,3,2,2,4,1,1,2,0,-5,20,2,-7,5,-3,0,0,-1,1,0,1,5,-1
KR_6728909640,440,1,-37,14,3,-3,3,0,3,0,3,1,2,3,0,2,2,2,1,3,-1,-3,-71,0,-6,6,2,0,-2,-1,1,-1,-1,6,-1
KR_6695647756,420,-6,-57,-37,-14,-7,8,1,-5,5,0,-1,1,0,-3,5,2,2,0,2,1,-11,-2,1,-6,5,-4,0,-2,1,-1,-1,1,3,-1
KR_6764312583,440,-1,-20,20,-5,4,4,8,-2,5,3,-6,7,1,0,1,1,-1,1,0,-1,-4,-21,-3,-1,4,1,0,-2,1,-1,-1,-1,2,-1
KR_6739735426,420,-6,-106,16,-15,-5,5,0,-2,3,1,-1,4,3,-6,6,0,-1,1,0,-1,-12,2,-4,-4,8,0,0,0,1,-1,-1,-1,2,-1
KR_6769126675,420,-4,-94,-12,-9,0,1,1,-2,3,1,-4,5,1,-3,3,0,0,0,0,0,-7,-1,-4,-2,6,-2,0,-1,1,-1,-1,-1,5,-1
KR_6746516973,440,-3,9,-12,-11,-4,7,3,-1,3,2,-7,7,0,2,1,3,-1,1,0,0,-10,-24,3,-3,0,-1,0,-1,-1,-1,1,1,4,-1
KR_6694617167,420,-1,-35,28,-5,-3,6,3,2,2,4,-2,4,2,-2,7,5,0,1,1,1,1,18,-2,-3,5,-4,0,0,-1,1,0,1,4,-1
KR_6759951209,420,2,-14,31,7,1,1,2,0,2,2,6,0,6,0,1,1,0,1,1,0,-1,36,4,-8,4,0,0,-1,1,1,-1,1,6,-1
KR_6743248797,420,0,-13,10,-1,2,2,4,-2,4,2,-2,3,1,2,1,3,-1,4,3,0,-1,2,1,-6,5,3,0,0,1,-1,1,-1,5,-1
KR_6768406603,420,0,-31,23,0,1,0,1,-3,4,1,-1,1,0,3,1,4,0,2,2,0,-5,11,-1,-6,7,4,0,-1,1,-1,-1,1,3,-1
KR_6743216186,420,-6,-62,-32,-14,-2,2,0,-4,5,1,-2,3,1,-5,6,1,-1,1,0,-1,-14,-2,1,-6,5,-7,0,-1,-1,-1,-1,-1,3,-1
KR_6693848280,420,3,51,-4,6,0,1,1,3,0,3,3,1,4,-2,3,1,2,3,5,1,6,-115,-1,-4,5,-3,0,1,1,-1,1,1,6,-1
KR_6760714053,420,0,-33,-30,0,4,0,4,-4,5,1,-2,4,2,2,1,3,0,1,1,0,2,-9,4,-5,1,2,0,-1,-1,1,1,1,6,-1
KR_6756506572,440,-5,-45,24,-12,-2,3,1,1,0,1,-1,3,2,-8,9,1,-2,4,2,0,-28,-3,1,-5,4,2,0,0,-1,0,-1,-1,2,-1
KR_6738032368,420,0,33,-20,0,4,0,4,-1,4,3,-2,4,2,-1,6,5,0,1,1,0,0,-27,0,-4,4,3,0,1,1,1,1,-1,3,-1
KR_6691935384,420,-2,-51,9,-5,-3,4,1,3,3,6,-6,7,1,-1,5,4,2,1,3,-1,-9,2,-1,-7,8,-7,0,0,-1,-1,-1,-1,2,-1
KR_6569569469,420,-2,33,-44,-2,-1,1,0,2,5,7,-2,2,0,1,4,5,-2,2,0,0,1,-5,1,-6,5,3,0,1,-1,1,1,1,5,-1
KR_6602032102,420,1,37,18,-1,1,0,1,-1,4,3,1,3,4,-1,4,3,-1,2,1,0,-6,0,6,-11,5,-5,0,-1,0,-1,-1,-1,0,-1
KR_6754059283,420,-4,-74,-47,-5,-1,2,1,1,3,4,1,2,3,-3,4,1,-3,4,1,0,-2,-3,1,-6,5,-4,0,-3,-1,-1,-1,1,5,-1
KR_6745252615,420,-4,-43,1,-14,-1,2,1,-4,5,1,-5,8,3,-3,4,1,-1,2,1,0,-17,-42,-6,-5,11,2,0,-2,1,1,-1,-1,4,-1
KR_6664840690,420,1,60,33,-5,6,0,6,-6,8,2,-5,7,2,2,3,5,-2,3,1,-1,-9,4,1,-7,6,2,0,0,-1,1,1,-1,5,-1
KR_6723740049,420,-1,-2,24,-6,1,1,2,1,1,2,-3,6,3,-7,10,3,2,1,3,-2,-14,7,-3,-3,6,-1,0,0,-1,0,0,-1,3,-1
KR_6754834584,420,-1,34,-12,-2,-1,2,1,0,4,4,-3,4,1,2,1,3,0,3,3,0,-1,40,0,-4,4,-23,0,0,-1,1,0,1,1,-1
KR_6770348849,420,-3,-49,-32,1,3,1,4,-1,5,4,1,0,1,-2,3,1,0,1,1,1,-2,23,4,-9,5,-4,0,-1,-1,1,1,1,5,-1
KR_6749863359,420,-2,-53,0,-8,2,1,3,3,2,5,-3,3,0,-4,7,3,-6,7,1,0,-12,6,-3,-3,6,-1,0,-1,1,1,-1,-1,1,-1
KR_6743735943,420,-3,-70,4,-6,-2,4,2,-4,5,1,3,1,4,-3,3,0,0,2,2,0,0,-6,-3,-3,6,-5,0,-1,-1,0,-1,1,1,-1
KR_6753792161,420,-1,-23,-18,-4,1,1,2,-5,6,1,-3,3,0,5,2,7,-2,4,2,-1,-11,-4,-1,-5,6,-2,0,-1,-1,-1,-1,-1,4,-1
KR_6768148391,440,0,46,-18,-8,0,2,2,-2,3,1,-2,3,1,-1,3,2,-3,5,2,0,-8,-11,-5,-3,8,3,0,0,1,0,1,-1,2,-1
KR_6606481366,420,2,-25,16,-1,-5,7,2,3,6,9,-1,3,2,-1,3,2,3,0,3,-1,-1,-1,-1,-4,5,2,0,-1,1,-1,-1,-1,2,-1
KR_6751306047,420,-3,-68,16,-8,-6,6,0,-2,2,0,-3,5,2,3,1,4,0,1,1,-2,-14,0,1,-6,5,2,0,-2,1,-1,-1,-1,4,-1
KR_6607712478,420,4,10,10,5,3,0,3,-2,4,2,0,1,1,2,2,4,2,1,3,-1,5,-2,-7,-1,8,0,0,0,-1,1,0,-1,3,-1
KR_6764686388,440,1,-6,10,5,3,1,4,-5,5,0,1,2,3,4,0,4,2,0,2,0,9,25,2,-9,7,1,0,0,-1,-1,0,1,4,-1
KR_6717853295,420,-3,-21,-5,0,-2,2,0,0,3,3,2,1,3,2,1,3,-2,4,2,0,-2,5,1,-6,5,1,0,0,-1,-1,-1,1,4,-1
KR_6764644497,440,0,-10,0,-6,-3,4,1,-1,3,2,1,3,4,-3,6,3,0,1,1,0,-3,0,1,-4,3,-6,0,-1,-1,-1,-1,1,3,-1
KR_6766775170,420,-4,-57,0,-8,-5,6,1,1,1,2,-2,4,2,-1,1,0,-1,1,0,0,-8,-13,-1,-3,4,-3,0,-3,-1,-1,-1,1,6,-1
KR_6759519682,420,2,24,32,4,0,2,2,0,6,6,0,1,1,6,1,7,-2,2,0,0,-1,-15,-3,-5,8,7,0,1,-1,1,1,1,5,-1
KR_6757721221,420,-5,-13,-35,-7,0,4,4,-5,7,2,-1,2,1,-2,2,0,1,0,1,0,-3,100,-5,-1,6,0,0,0,-1,-1,1,1,5,-1
KR_6719579982,440,1,6,12,-6,-3,3,0,-1,3,2,0,0,0,-4,6,2,2,0,2,-2,-15,2,1,-3,2,-2,0,-1,-1,-1,-1,-1,4,-1
KR_6690837445,420,4,22,5,7,3,3,6,-2,3,1,4,1,5,3,6,9,-1,1,0,1,8,5,-2,-7,9,0,0,3,-1,1,1,1,4,-1
KR_6762550389,420,-6,-50,-8,-15,2,1,3,-3,6,3,-5,5,0,-6,8,2,-3,4,1,0,-14,-49,2,-6,4,16,0,-2,-1,-1,-1,-1,5,-1
KR_6670091796,420,-5,-58,-12,-16,0,2,2,-8,10,2,-4,4,0,-2,7,5,-2,2,0,0,-18,4,2,-7,5,-5,0,0,-1,-1,-1,-1,2,-1
KR_6770724973,420,0,65,-36,3,-1,2,1,-1,2,1,3,1,4,2,2,4,0,2,2,0,-5,287,0,-4,4,0,0,0,1,-1,0,1,5,-1
KR_6686961979,420,1,-7,44,-1,-1,3,2,2,1,3,-2,2,0,-1,1,0,1,0,1,0,-6,104,-1,-2,3,-3,0,0,0,0,0,-1,0,-1
KR_6738756051,420,0,63,-27,2,0,3,3,2,2,4,2,0,2,-2,5,3,0,2,2,0,-2,1,3,-6,3,-1,0,0,-1,0,-1,1,1,-1
KR_6766417758,420,-4,-84,-22,-12,-1,2,1,-4,5,1,-4,6,2,-3,5,2,0,0,0,-1,-16,24,1,-8,7,0,0,-2,1,-1,-1,1,2,-1
KR_6709123148,420,0,3,-17,3,0,1,1,0,3,3,1,1,2,2,1,3,0,3,3,0,5,-3,-1,-4,5,3,0,0,-1,1,1,-1,3,-1
KR_6648293185,420,-4,-93,-19,2,-1,1,0,5,0,5,-1,2,1,-5,7,2,4,0,4,0,8,-28,-1,-6,7,-6,0,-2,1,1,-1,1,6,-1
KR_6701016581,420,-5,-56,19,-11,-3,6,3,-3,7,4,-4,6,2,0,2,2,-1,1,0,0,-5,-7,-2,-6,8,-1,0,0,-1,-1,-1,-1,1,-1
KR_6664265934,420,-2,-44,-17,-8,-5,5,0,0,1,1,2,1,3,-3,4,1,-2,2,0,0,-10,10,0,-4,4,-2,0,-1,-1,1,-1,-1,3,-1
KR_6740805969,420,-2,11,0,-12,-5,5,0,2,3,5,-1,3,2,-4,4,0,-4,5,1,0,-19,7,2,-7,5,-3,0,0,-1,-1,-1,-1,3,-1
KR_6770957677,420,-1,-33,-14,1,7,1,8,-3,4,1,1,0,1,4,1,5,-8,10,2,0,1,-7,3,-9,6,-2,0,-2,-1,1,-1,-1,2,-1
KR_6650612276,420,-4,-94,5,-7,-3,3,0,1,2,3,-7,8,1,1,1,2,1,0,1,0,0,16,2,-4,2,0,0,-1,0,0,-1,1,0,-1
KR_6749574516,420,-5,-98,-15,-9,1,2,3,-5,6,1,0,4,4,-4,4,0,-1,1,0,0,-8,2,1,-7,6,-9,0,0,-1,1,-1,1,5,-1
KR_6768842338,420,0,17,30,0,1,0,1,1,2,3,-1,4,3,-2,2,0,1,1,2,0,-4,-5,-2,-3,5,-4,0,1,0,1,1,1,0,-1
KR_6697913183,420,-4,-60,-14,-3,-2,2,0,2,0,2,0,3,3,-3,3,0,0,0,0,0,1,-28,1,-4,3,4,0,-1,1,-1,-1,-1,5,-1
KR_6765555214,420,0,-15,21,0,0,3,3,-1,4,3,0,1,1,-2,4,2,3,1,4,0,-1,4,1,-8,7,0,0,0,0,1,0,-1,0,-1
KR_6766038660,420,0,14,11,-1,3,1,4,0,1,1,-1,1,0,2,5,7,-5,5,0,0,-4,40,-1,-5,6,-14,0,1,-1,1,1,-1,6,-1
KR_6740150056,420,-6,-97,-12,-12,-6,6,0,0,4,4,-7,7,0,1,1,2,0,0,0,0,-10,16,1,-5,4,-5,0,-2,1,-1,-1,-1,1,-1
KR_6767063601,420,-4,-70,31,-15,-2,3,1,-3,4,1,0,1,1,0,1,1,-10,11,1,0,-11,6,-2,-3,5,-1,0,0,1,-1,0,-1,6,-1
KR_6699563430,420,-3,-76,-8,-11,1,2,3,-3,4,1,-4,8,4,-3,5,2,-2,5,3,0,-8,-5,-2,-5,7,-1,0,-3,1,-1,-1,-1,5,-1
KR_6765832453,420,1,46,-2,2,3,0,3,-2,3,1,-1,1,0,3,1,4,-1,1,0,0,5,-138,3,-11,8,2,0,1,1,-1,1,1,4,-1
KR_6768140459,420,-1,17,1,-1,2,2,4,0,1,1,-5,6,1,1,2,3,1,1,2,0,-3,469,1,-5,4,-4,0,1,0,1,1,1,0,-1
KR_6724730205,420,-1,-34,-8,1,-2,3,1,-2,3,1,-5,5,0,6,0,6,4,1,5,0,14,-5,-7,-4,11,8,0,0,1,-1,-1,1,4,-1
KR_6594884394,420,-6,-48,-15,-9,-1,2,1,-4,8,4,-2,4,2,-1,4,3,-1,2,1,0,-1,6,-2,-3,5,-2,0,-1,1,-1,-1,-1,2,-1
KR_6738280398,420,-1,-38,24,-9,-3,4,1,1,0,1,2,3,5,-3,5,2,-6,6,0,0,-11,11,3,-7,4,-4,0,-1,1,-1,-1,-1,6,-1
KR_6760681608,440,-7,-17,-23,-20,-3,4,1,-9,9,0,-3,3,0,-5,5,0,0,0,0,0,-22,-2,-4,0,4,0,0,0,-1,-1,-1,-1,3,-1
KR_6742363479,420,0,-33,29,-2,3,1,4,-6,7,1,-1,2,1,0,3,3,2,0,2,0,-3,102,0,-4,4,0,0,-1,-1,1,-1,-1,5,-1
KR_6714828436,420,-4,14,-40,-11,-3,4,1,1,4,5,-4,4,0,-3,5,2,-2,2,0,0,-12,-2,-5,-3,8,3,0,0,-1,1,0,1,5,-1
KR_6743521973,420,-3,-72,5,3,0,3,3,-3,7,4,4,1,5,1,1,2,1,1,2,0,5,2,0,-3,3,-2,0,-1,-1,1,-1,1,5,-1
KR_6698318996,420,2,-4,-15,-1,-3,3,0,2,3,5,-2,3,1,0,6,6,2,2,4,0,8,0,1,-5,4,4,0,0,1,-1,-1,1,3,-1
KR_6764591650,440,-1,24,4,-3,0,0,0,2,1,3,2,1,3,-6,6,0,-1,1,0,-2,-16,-239,-1,-4,5,-4,0,0,-1,-1,0,-1,6,-1
KR_6648230789,420,-6,-97,5,-23,1,0,1,-4,7,3,-4,4,0,-15,15,0,-1,2,1,-1,-20,115,-4,-3,7,0,0,-2,-1,1,-1,-1,2,-1
KR_6766752490,420,-3,-22,4,-8,-4,4,0,-3,4,1,-6,6,0,4,4,8,1,0,1,0,-6,9,1,-3,2,-1,0,-1,-1,-1,-1,-1,2,-1
KR_6741334431,420,0,30,-15,-3,-1,2,1,3,1,4,0,3,3,-3,3,0,-2,4,2,0,-3,-22,5,-8,3,-2,0,-1,-1,-1,-1,1,2,-1
KR_6693251781,420,-4,-5,0,-8,-5,5,0,-1,4,3,-2,2,0,-1,4,3,1,0,1,0,0,5,0,-5,5,-5,0,-1,1,-1,-1,-1,5,-1
KR_6427718870,420,-1,5,12,-5,-3,4,1,0,3,3,0,2,2,-2,4,2,0,0,0,0,-6,-9,-5,-6,11,-1,0,-2,-1,0,-1,1,3,-1
KR_6657359166,420,2,-50,-12,4,2,0,2,1,1,2,3,0,3,-6,8,2,4,0,4,0,2,-11,-4,-2,6,-2,0,-1,1,-1,-1,1,5,-1
KR_6712073400,420,0,-18,-4,-1,-3,4,1,0,0,0,0,3,3,0,3,3,2,1,3,0,2,2,4,-6,2,-3,0,-1,0,1,-1,1,0,-1
KR_6662570721,420,1,-8,-13,-1,2,3,5,-4,5,1,0,3,3,2,1,3,-1,2,1,0,-1,2,-3,-4,7,4,0,0,-1,-1,-1,-1,3,-1
KR_6625801794,420,2,10,1,3,-2,3,1,1,1,2,2,1,3,2,2,4,0,0,0,0,5,4,0,-8,8,0,0,-1,1,-1,-1,1,5,-1
KR_6767598783,420,-1,-31,-17,4,-1,2,1,5,4,9,-2,5,3,2,3,5,0,3,3,-2,7,-1,3,-8,5,2,0,0,1,-1,-1,-1,5,-1
KR_6766676570,440,2,35,-25,11,0,2,2,6,4,10,0,4,4,4,2,6,1,4,5,3,18,12,-2,-2,4,3,0,-1,0,0,-1,1,0,-1
KR_6748037878,420,1,26,8,3,6,1,7,4,1,5,-1,6,5,-8,8,0,2,0,2,-1,-10,7,1,-5,4,-7,0,1,-1,-1,1,-1,5,-1
KR_6762971921,420,2,18,-16,-2,0,2,2,-2,4,2,-1,7,6,0,1,1,1,1,2,0,-6,39,5,-10,5,-1,0,0,1,-1,0,1,5,-1
KR_6704726351,420,-3,-32,-13,-4,3,0,3,-8,9,1,2,0,2,-1,4,3,0,0,0,0,-7,12,1,-6,5,-9,0,0,-1,-1,0,-1,6,-1
KR_6762559370,440,-2,0,-16,-8,0,3,3,2,1,3,-6,6,0,-5,6,1,1,0,1,-1,-3,16,0,-8,8,-4,0,0,1,-1,0,-1,3,-1
KR_6764991184,420,-3,-29,-7,-3,-1,1,0,4,0,4,3,0,3,-6,6,0,-3,3,0,0,-7,2,-2,-7,9,-3,0,-1,-1,1,-1,-1,1,-1
KR_6758017562,440,-3,-80,4,-8,-5,7,2,-1,1,0,-2,4,2,0,1,1,0,0,0,0,0,-6,1,-4,3,-1,0,-2,-1,-1,-1,-1,3,-1
KR_6730761016,420,-1,13,11,-5,2,3,5,1,2,3,-5,6,1,-3,7,4,0,0,0,-1,-5,191,2,-10,8,-1,0,0,1,-1,-1,-1,5,-1
KR_6770014285,440,3,18,13,1,-1,1,0,1,1,2,4,1,5,-4,7,3,1,1,2,0,-6,-7,-2,-4,6,2,0,-1,-1,-1,-1,-1,1,-1
KR_6733419459,420,-4,-47,-23,-8,-2,3,1,-2,6,4,-3,3,0,-2,4,2,1,1,2,0,-9,-2,0,-6,6,-3,0,1,-1,1,-1,-1,5,-1
KR_6762159664,420,-9,-128,0,-11,0,0,0,-1,3,2,-9,9,0,1,1,2,-2,3,1,0,-9,27,-2,-4,6,-1,0,-3,-1,-1,-1,-1,6,-1
KR_6764948090,420,-2,1,-21,-14,5,1,6,-7,7,0,-9,9,0,0,3,3,-3,3,0,-1,-26,8,-2,-5,7,-3,0,-1,-1,-1,-1,-1,3,-1
KR_6531159755,440,-3,-1,11,-8,-2,2,0,-2,3,1,-1,4,3,-1,1,0,-2,3,1,0,-11,-4,-3,-2,5,-3,0,-1,1,1,-1,-1,3,-1
KR_6767386920,440,-5,-130,-4,-12,-3,7,4,-1,2,1,2,1,3,-11,12,1,1,1,2,0,-6,-44,5,-6,1,20,0,-1,-1,0,-1,-1,5,-1
KR_6670947590,440,0,41,20,4,3,1,4,-1,5,4,-4,5,1,2,6,8,4,1,5,0,1,1,-3,-4,7,1,0,0,-1,1,1,1,3,-1
KR_6766679894,420,-1,42,-8,8,5,1,6,-1,2,1,0,5,5,4,3,7,0,0,0,2,10,1,-4,-5,9,2,0,0,1,0,0,1,1,-1
KR_6761873583,420,-1,12,0,-3,-4,4,0,-2,7,5,2,1,3,1,3,4,0,1,1,0,1,225,-3,-3,6,4,0,0,-1,1,-1,1,6,-1
KR_6713067320,420,-2,-70,-22,-2,-1,1,0,-1,3,2,1,1,2,-3,7,4,2,1,3,0,-5,5,-2,-7,9,-4,0,0,1,-1,-1,1,5,-1
KR_6755582184,420,-1,-26,8,-3,-2,4,2,1,1,2,0,1,1,-2,3,1,0,0,0,0,-4,-43,-1,-7,8,21,0,0,1,1,0,-1,4,-1
KR_6751997985,440,0,-16,-12,-3,-3,5,2,3,1,4,1,1,2,1,1,2,-5,8,3,-1,-8,-16,3,-7,4,0,0,-1,-1,0,-1,-1,6,-1
KR_6759598449,420,-2,-34,-36,-3,-1,1,0,-2,3,1,-1,2,1,-1,2,1,2,0,2,0,4,97,-2,-3,5,2,0,-1,1,-1,-1,-1,1,-1
KR_6757980424,420,3,-59,64,2,0,3,3,0,3,3,0,2,2,2,2,4,0,4,4,-1,1,44,1,-8,7,-16,0,-1,1,-1,-1,-1,1,-1
KR_6727553868,420,-3,-35,-29,-8,-4,5,1,0,1,1,-1,3,2,-2,3,1,-1,1,0,-1,-2,-5,2,-6,4,2,0,0,-1,-1,-1,-1,3,-1
KR_6706220276,420,-3,-3,-1,-3,-3,3,0,1,3,4,-2,3,1,0,2,2,1,0,1,0,4,-6,1,-5,4,0,0,0,-1,-1,0,-1,1,-1
KR_6749516429,420,0,28,18,-7,0,2,2,2,4,6,3,3,6,-7,7,0,-5,6,1,0,-9,-13,-3,-2,5,5,0,-1,1,-1,-1,-1,3,-1
KR_6743018511,440,-3,-38,-32,1,2,2,4,5,0,5,-2,2,0,-2,2,0,-2,3,1,0,1,6,4,-8,4,-8,0,-2,1,-1,-1,-1,6,-1
KR_6753575776,420,-2,-9,-16,-5,-1,2,1,-3,4,1,-1,3,2,0,2,2,0,2,2,0,-3,-8,0,-2,2,0,0,-2,1,-1,-1,1,3,-1
KR_6767829997,420,0,43,3,1,2,0,2,-2,7,5,2,1,3,0,3,3,-1,2,1,0,0,-8,1,-7,6,-1,0,1,1,1,1,1,4,-1
KR_6728319425,420,-4,-36,-28,-2,1,0,1,-2,6,4,0,2,2,1,3,4,-2,3,1,0,-1,22,4,-8,4,0,0,-1,1,-1,-1,1,1,-1
KR_6750594363,420,-4,6,-16,-4,-6,6,0,0,4,4,0,2,2,2,1,3,0,2,2,0,-2,2,0,-6,6,-1,0,-1,1,1,-1,1,3,-1
KR_6769867517,420,-3,0,11,-4,0,1,1,-4,6,2,1,2,3,0,4,4,-1,2,1,0,-6,-419,0,-5,5,-1,0,0,-1,1,0,1,3,-1
KR_6755475873,440,-6,-44,-26,-18,-1,4,3,-4,4,0,-1,2,1,-4,6,2,-8,10,2,0,-9,0,0,-5,5,-4,0,-2,0,-1,1,1,0,-1
KR_6723873419,420,-3,-13,7,-9,-4,5,1,1,5,6,-3,3,0,0,3,3,-3,5,2,2,-5,-16,-2,-3,5,0,0,-2,1,-1,-1,1,4,-1
KR_6766377318,420,0,-32,16,-5,-3,6,3,2,1,3,-4,4,0,-1,3,2,1,0,1,-1,-4,10,2,-5,3,-4,0,0,1,0,-1,-1,1,-1
KR_6694537847,420,-6,-23,8,-8,0,2,2,3,1,4,-1,3,2,-8,12,4,-2,3,1,0,-8,4,1,-5,4,-5,0,0,1,-1,-1,1,5,-1
KR_6732899052,420,-1,15,-12,0,-1,1,0,0,1,1,5,0,5,1,1,2,-5,5,0,0,-2,-4,-1,-7,8,4,0,0,-1,1,0,-1,6,-1
KR_6769146939,420,-1,-5,-4,-8,1,1,2,-2,4,2,-3,3,0,-5,7,2,1,1,2,0,-10,0,3,-6,3,-1,0,1,1,-1,1,-1,4,-1
KR_6761708970,440,-2,-21,-8,-4,-3,6,3,5,1,6,-3,3,0,-7,8,1,4,2,6,1,3,2,1,-3,2,3,0,-1,1,-1,-1,1,6,-1
KR_6766597160,420,-1,-39,-8,-3,-2,2,0,4,2,6,-1,1,0,-1,2,1,-3,4,1,0,-11,-13,-2,-3,5,-5,0,0,1,-1,0,1,4,-1
KR_6750847358,420,-2,-57,-14,1,2,1,3,3,0,3,1,2,3,-1,4,3,-4,4,0,1,5,2,3,-6,3,-1,0,-1,1,1,-1,1,1,-1
KR_6767576509,420,-1,-43,12,-1,-2,2,0,2,0,2,-3,3,0,3,0,3,-1,1,0,0,0,101,-7,-3,10,6,0,-2,1,-1,-1,-1,3,-1
KR_6770559612,420,-2,-10,-19,-5,-4,4,0,1,1,2,-4,4,0,0,2,2,2,0,2,1,3,2,0,-4,4,2,0,0,1,-1,-1,1,5,-1
KR_6738081217,420,2,12,-15,6,0,1,1,-1,6,5,5,1,6,1,3,4,1,2,3,0,0,-5,2,-5,3,0,0,1,-1,1,1,1,1,-1
KR_6769499871,420,2,17,-10,4,2,1,3,-2,6,4,-1,3,2,7,1,8,-2,2,0,0,13,19,1,-6,5,-3,0,0,1,-1,1,-1,3,-1
KR_6769705454,420,2,2,15,-4,-2,3,1,-1,2,1,1,0,1,-1,3,2,-1,1,0,0,-2,41,0,-6,6,1,0,-2,-1,-1,-1,-1,6,-1
KR_6766964775,420,-1,7,-1,-5,-3,4,1,-2,3,1,1,0,1,-1,2,1,0,0,0,0,-3,116,0,-5,5,-2,0,0,1,-1,1,-1,2,-1
KR_6705071075,420,-3,-2,-19,2,1,0,1,-6,6,0,2,1,3,5,0,5,0,1,1,1,6,22,3,-6,3,5,0,0,1,-1,1,1,4,-1
KR_6744562051,420,-5,-98,-14,-7,-5,5,0,5,3,8,-5,5,0,-3,5,2,1,0,1,1,-4,91,2,-9,7,-1,0,-1,1,-1,-1,1,3,-1
KR_6620369338,420,-3,-61,-4,-6,0,1,1,-4,9,5,0,3,3,-2,3,1,0,0,0,0,-10,33,9,-9,0,-4,0,-1,1,1,-1,1,4,-1
KR_6705011460,420,-4,-44,-46,-5,-4,5,1,0,1,1,-2,4,2,1,2,3,0,2,2,0,0,-10,-3,-4,7,-7,0,0,-1,1,0,1,3,-1
KR_6728753735,420,-4,0,-11,-12,-6,7,1,1,1,2,1,6,7,-5,5,0,-3,3,0,0,-15,-21,-5,-3,8,-1,0,-2,-1,-1,-1,-1,5,-1
KR_6768514771,420,-3,-41,-44,-5,-2,2,0,-1,3,2,-1,2,1,-3,4,1,2,1,3,0,-6,-2,-4,-3,7,1,0,-1,-1,-1,-1,1,6,-1
KR_6740629744,420,-2,-66,8,-2,-2,2,0,-5,7,2,7,1,8,-1,4,3,-1,2,1,0,0,7,1,-7,6,1,0,0,-1,1,-1,-1,4,-1
KR_6759865278,420,0,-22,-24,-2,1,4,5,-2,4,2,0,5,5,0,2,2,-1,3,2,0,4,4,1,-7,6,-6,0,0,1,0,-1,-1,5,-1
KR_6756257105,420,-1,-64,10,-6,-2,2,0,-4,7,3,2,1,3,0,2,2,-2,2,0,0,-5,-7,-2,-4,6,-1,0,0,1,-1,0,1,5,-1
KR_6716582188,420,-1,3,8,0,-2,4,2,0,4,4,-5,6,1,3,2,5,4,0,4,0,4,-12,-1,-2,3,6,0,0,-1,1,-1,-1,3,-1
KR_6768147913,420,-4,-15,4,-8,2,2,4,-1,1,0,-4,4,0,-3,5,2,-2,2,0,0,-13,2,1,-5,4,-4,0,-1,-1,0,-1,-1,1,-1
KR_6757961517,440,-4,-44,-24,-9,0,3,3,-4,4,0,0,2,2,-5,6,1,0,0,0,0,-12,-9,-1,-2,3,5,0,-2,-1,1,-1,1,3,-1
KR_6766886094,420,-3,63,-38,-15,-4,4,0,-7,8,1,-5,5,0,1,2,3,0,1,1,-1,-2,5,-3,-4,7,0,0,0,0,-1,0,-1,0,-1
KR_6770778533,420,-3,9,-16,0,-1,1,0,0,1,1,5,1,6,-2,3,1,-2,2,0,0,4,-112,-4,-5,9,5,0,-1,-1,-1,-1,-1,3,-1
KR_6767793841,420,-1,-7,-4,3,-2,3,1,-2,5,3,3,0,3,5,0,5,-1,2,1,0,5,23,1,-6,5,-5,0,0,1,-1,0,-1,2,-1
KR_6760385177,420,2,-20,27,10,-5,6,1,6,2,8,1,1,2,4,4,8,4,0,4,0,13,-4,-5,-2,7,5,0,-1,-1,1,-1,1,3,-1
KR_6704365647,420,0,-15,15,-3,-1,1,0,3,1,4,1,1,2,-5,6,1,-1,3,2,0,-8,36,3,-7,4,-4,0,-1,1,-1,-1,-1,3,-1
KR_6762943228,440,0,-14,9,-2,2,2,4,2,4,6,-1,1,0,-5,6,1,0,0,0,-1,-2,-31,2,-5,3,-2,0,0,1,1,0,-1,2,-1
KR_6770399805,420,-4,-40,-22,-13,1,1,2,-3,3,0,-4,4,0,-1,2,1,-6,6,0,0,-25,13,-2,-3,5,-1,0,-1,-1,1,-1,-1,4,-1
KR_6762900784,440,-6,-15,-26,-12,-6,6,0,-3,5,2,1,3,4,-4,9,5,0,3,3,0,-6,-2,0,-6,6,3,0,-2,1,-1,-1,1,3,-1
KR_6755652915,420,-1,-73,21,1,0,3,3,2,1,3,1,2,3,-2,3,1,0,1,1,1,-2,1,3,-9,6,5,0,0,0,1,0,1,0,-1
KR_6737172973,420,1,-38,-16,8,0,1,1,1,2,3,2,1,3,6,0,6,-1,1,0,0,10,-8,-1,-1,2,2,0,-1,-1,-1,1,1,4,-1
KR_6766697178,420,4,43,16,4,-1,1,0,3,1,4,-1,1,0,3,1,4,0,0,0,0,6,-33,4,-10,6,12,0,0,1,-1,0,1,1,-1
KR_6758467598,420,-2,-40,16,-1,-2,2,0,-1,4,3,0,4,4,0,1,1,2,0,2,0,3,9,0,-7,7,-7,0,-2,-1,1,-1,1,2,-1
KR_6742324960,420,0,-59,-15,1,3,1,4,-2,3,1,-2,4,2,2,1,3,0,1,1,0,2,38,-1,-8,9,-1,0,-1,1,-1,-1,-1,5,-1
KR_6769062304,420,3,-4,19,3,3,1,4,1,2,3,3,0,3,-2,4,2,-2,4,2,0,0,18,1,-5,4,0,0,1,1,1,1,-1,5,-1
KR_6770479853,420,0,16,4,-1,0,2,2,-7,8,1,2,1,3,4,2,6,0,1,1,0,3,40,1,-7,6,-12,0,0,1,1,1,1,6,-1
KR_6769874685,420,-4,-83,-15,-6,-2,3,1,-1,2,1,0,0,0,0,6,6,-3,4,1,0,-2,5,2,-8,6,-2,0,-2,-1,1,-1,-1,6,-1
KR_6769028121,420,-4,-118,-14,-9,4,0,4,-12,12,0,1,0,1,-1,4,3,-1,1,0,0,-14,-10,2,-5,3,-5,0,-2,-1,1,-1,1,3,-1
KR_6724602822,440,-1,-18,-20,-5,0,5,5,-3,4,1,-5,6,1,5,3,8,-2,3,1,0,-9,10,8,-8,0,-3,0,0,-1,-1,-1,-1,2,-1
KR_6734762902,420,0,-23,2,-5,-1,2,1,0,2,2,-4,4,0,2,2,4,-2,4,2,0,-2,-14,-2,-4,6,-1,0,-1,1,-1,-1,1,5,-1
KR_6741292092,420,1,33,6,9,4,1,5,-1,4,3,-9,9,0,15,0,15,0,1,1,0,6,2,3,-6,3,-5,0,2,1,1,1,-1,6,-1
KR_6687353104,440,-3,25,36,-9,-2,4,2,1,0,1,-3,5,2,-5,6,1,0,4,4,0,-6,23,-2,-5,7,-15,0,0,-1,1,0,-1,1,-1
KR_6705620196,440,-2,-37,-4,-6,-3,3,0,2,3,5,0,2,2,-4,7,3,-1,1,0,0,-4,4,-2,-6,8,-4,0,-1,1,-1,-1,-1,3,-1
KR_6557524278,420,-4,-58,0,-15,-3,5,2,-4,6,2,-3,4,1,-3,6,3,-2,3,1,0,-13,20,0,-5,5,-2,0,-3,-1,-1,-1,-1,2,-1
KR_6760890028,420,0,-46,20,-2,-2,3,1,1,1,2,-1,3,2,0,3,3,0,0,0,0,3,-4,-3,-3,6,0,0,-2,-1,-1,-1,-1,2,-1
KR_6753337514,420,0,-15,15,-3,-1,1,0,4,0,4,0,0,0,-1,4,3,-5,6,1,2,0,29,-7,-3,10,0,0,-1,-1,-1,-1,1,4,-1
KR_6742844897,420,-4,-1,-60,-9,-4,5,1,-2,6,4,-4,7,3,3,0,3,-2,4,2,0,-5,19,0,-6,6,-3,0,-1,-1,-1,-1,1,4,-1
KR_6768447486,420,-3,-26,-12,-3,-2,2,0,3,4,7,-1,3,2,-2,2,0,-1,3,2,0,-2,1,1,-6,5,-2,0,-1,-1,-1,-1,-1,5,-1
KR_6763362940,420,-1,-50,-22,0,0,0,0,1,2,3,0,3,3,-2,5,3,1,0,1,0,5,3,3,-6,3,-3,0,-2,-1,-1,-1,1,1,-1
KR_6770295785,440,-4,-25,-10,-18,-8,8,0,0,1,1,-10,12,2,1,3,4,-1,1,0,-1,-7,29,-7,0,7,0,0,-3,-1,0,-1,-1,3,-1
KR_6767523343,420,1,-81,-8,12,3,1,4,5,1,6,3,4,7,2,3,5,-1,1,0,0,16,-3,-1,-2,3,5,0,-1,1,0,-1,1,6,-1
KR_6770418681,420,5,10,-12,6,1,1,2,4,0,4,1,1,2,0,1,1,0,0,0,0,5,35,2,-5,3,-7,0,0,-1,1,1,1,5,-1
KR_6681773973,420,-2,-49,-9,0,5,0,5,0,3,3,-4,4,0,-1,5,4,0,0,0,0,-5,21,-3,-3,6,1,0,0,-1,-1,0,1,5,-1
KR_6750971978,420,2,-25,0,3,-2,2,0,4,3,7,3,1,4,-2,3,1,0,1,1,-1,-1,-19,-3,-5,8,1,0,0,1,-1,0,-1,3,-1
KR_6748709771,420,-5,8,-7,-7,4,1,5,1,4,5,-10,10,0,-2,3,1,0,1,1,0,-7,-6,-2,-5,7,0,0,-1,1,-1,1,1,1,-1
KR_6742645345,420,-3,-18,-8,-4,-1,2,1,-3,4,1,-1,2,1,0,1,1,1,0,1,0,-4,37,0,-4,4,-1,0,-1,-1,1,-1,-1,4,-1
KR_6760426874,420,-5,-25,-19,0,1,1,2,-3,7,4,0,2,2,4,2,6,-2,2,0,0,3,-9,-3,-3,6,-3,0,-2,-1,-1,-1,1,2,-1
KR_6760369647,420,-2,10,-24,-4,-3,5,2,-1,2,1,2,1,3,0,2,2,-2,2,0,0,-2,-25,2,-7,5,3,0,0,0,1,0,-1,0,-1
KR_6767904236,420,3,46,-7,8,0,1,1,2,4,6,1,2,3,3,2,5,2,2,4,0,14,-16,1,-5,4,5,0,0,1,-1,1,1,2,-1
KR_6752245205,420,-1,17,-24,2,-3,5,2,3,0,3,-1,4,3,1,1,2,2,0,2,0,4,-10,-3,-5,8,2,0,1,-1,1,1,-1,5,-1
KR_6744887229,420,-4,-62,-14,-10,-5,6,1,0,0,0,-2,2,0,-3,4,1,0,2,2,0,-5,2,-1,-8,9,1,0,-2,-1,-1,-1,-1,2,-1
KR_6767726881,420,0,16,8,-11,0,0,0,0,4,4,-6,7,1,-4,5,1,-1,1,0,-1,-7,1,-1,-5,6,-1,0,0,-1,-1,0,-1,1,-1
KR_6767496803,420,-1,47,-23,-8,-1,3,2,-3,5,2,-4,6,2,0,2,2,0,1,1,0,0,0,-3,-4,7,5,0,0,1,-1,0,-1,1,-1
KR_6744608976,420,-3,13,-3,-7,0,5,5,-2,3,1,2,1,3,-6,6,0,-1,2,1,0,-14,14,-6,-2,8,1,0,2,1,1,1,1,2,-1
KR_6767817454,420,-5,-54,-34,-9,-1,1,0,-3,3,0,-2,3,1,-4,6,2,1,0,1,0,-10,-47,-4,-4,8,2,0,1,1,-1,1,-1,4,-1
KR_6750473890,420,-5,-70,-20,-7,-1,2,1,-2,7,5,-3,4,1,1,3,4,-2,2,0,0,-6,-132,-4,-7,11,-7,0,-2,-1,-1,-1,1,3,-1
KR_6734461534,420,-2,7,-20,-1,4,1,5,-1,3,2,-1,2,1,-3,4,1,0,1,1,-1,-3,-9,-1,-7,8,-1,0,1,-1,-1,1,-1,2,-1
KR_6770447736,420,3,-3,3,6,0,1,1,8,0,8,-1,5,4,-2,6,4,1,3,4,-1,14,-6,3,-8,5,-3,0,1,1,1,1,-1,4,-1
KR_6615528721,420,0,-30,-8,2,-3,3,0,2,2,4,-2,4,2,4,2,6,1,1,2,0,-1,-6,-1,-5,6,5,0,0,0,-1,-1,1,0,-1
KR_6735523906,420,0,46,-18,2,1,1,2,1,7,8,1,1,2,-1,6,5,0,0,0,0,-7,2,-1,-5,6,1,0,-1,-1,-1,-1,1,6,-1
KR_6768340784,420,-2,16,-14,-3,-3,6,3,3,2,5,-1,3,2,-2,5,3,0,0,0,1,0,-5,-1,-8,9,6,0,0,-1,-1,-1,1,3,-1
KR_6757498715,440,0,41,-7,2,-1,2,1,-2,2,0,-1,7,6,4,1,5,2,3,5,0,0,0,-1,-3,4,5,0,2,0,0,1,1,0,-1
KR_6731282114,420,1,-14,-16,1,-2,3,1,-1,3,2,-1,3,2,2,1,3,3,1,4,0,0,-7,-2,-4,6,-5,0,0,1,-1,0,1,6,-1
KR_6635305133,420,-2,58,-4,-11,2,0,2,-4,5,1,-5,5,0,-2,2,0,-2,2,0,1,-9,-27,3,-5,2,24,0,0,-1,-1,0,1,6,-1
KR_6751055011,420,-5,-64,-23,-12,1,2,3,1,4,5,-9,10,1,-5,6,1,0,1,1,0,-16,-1,2,-6,4,0,0,-4,1,-1,-1,-1,2,-1
KR_6768403148,420,-2,-94,3,1,3,1,4,-1,4,3,-1,1,0,0,1,1,0,0,0,0,0,-4,1,-7,6,-2,0,0,1,1,-1,1,2,-1
KR_6753026260,420,-1,-3,8,-3,-1,1,0,1,3,4,1,1,2,-4,5,1,0,1,1,0,0,30,3,-8,5,-7,0,0,-1,1,0,-1,3,-1
KR_6757501011,440,-1,-87,20,-1,2,3,5,-3,5,2,-5,6,1,4,0,4,1,0,1,0,2,-238,0,-2,2,1,0,-1,-1,-1,-1,-1,5,-1
KR_6749897298,420,-1,-33,33,-4,2,1,3,-5,7,2,0,1,1,-2,5,3,1,0,1,-1,-3,31,0,-6,6,-1,0,0,-1,-1,0,-1,3,-1
KR_6761952275,440,-2,-82,2,-6,1,1,2,-6,6,0,-2,3,1,1,3,4,0,1,1,1,-4,6,2,-5,3,-1,0,-2,-1,-1,-1,1,2,-1
KR_6760026647,420,-6,-57,-19,-6,-7,7,0,-1,2,1,1,2,3,-3,6,3,4,1,5,1,6,-273,1,-4,3,-4,0,-2,1,-1,-1,1,6,-1
KR_6764413557,440,-1,21,-5,-5,-4,6,2,1,4,5,1,0,1,2,0,2,-5,5,0,0,-8,-4,-1,-5,6,-23,0,1,-1,-1,1,1,5,-1
KR_6758452534,420,-2,-48,-48,-8,0,2,2,0,2,2,1,5,6,-3,4,1,-6,6,0,0,-9,15,-2,-6,8,3,0,-1,-1,1,-1,-1,5,-1
KR_6530308283,420,-2,4,-26,-2,-3,6,3,-4,5,1,-3,3,0,8,0,8,0,1,1,0,-5,-1,2,-5,3,2,0,-1,1,-1,-1,-1,1,-1
KR_6738793603,420,1,-3,-4,3,-3,5,2,0,2,2,-3,6,3,9,0,9,0,1,1,1,12,9,3,-8,5,-4,0,1,1,-1,1,1,5,-1
KR_6765855421,440,-2,44,10,-5,-1,2,1,-2,2,0,2,1,3,-4,5,1,0,0,0,0,-12,4,1,-3,2,1,0,0,0,-1,0,1,0,-1
KR_6759180828,420,-1,7,-24,-7,-10,10,0,1,1,2,-1,8,7,0,2,2,3,1,4,-2,2,58,1,-6,5,2,0,-2,-1,-1,-1,-1,6,-1
KR_6727933293,440,1,-20,37,0,2,1,3,2,4,6,-7,7,0,2,5,7,1,1,2,0,-2,6,6,-7,1,0,0,2,1,0,1,1,3,-1
KR_6758294118,420,-1,-23,-4,-2,0,2,2,-4,4,0,0,1,1,2,1,3,0,3,3,1,1,14,-4,-6,10,2,0,-1,0,-1,-1,1,0,-1
KR_6769963897,440,-6,5,-28,-14,2,1,3,-2,3,1,-7,8,1,-4,5,1,-3,3,0,0,-20,6,0,-9,9,2,0,-1,-1,-1,-1,-1,5,-1
KR_6616875154,420,1,30,-5,-3,6,0,6,-2,4,2,-5,5,0,-2,4,2,0,2,2,0,-14,1,5,-8,3,3,0,1,1,-1,-1,-1,4,-1
KR_6741964943,420,-3,10,-32,-5,0,3,3,-5,5,0,-1,3,2,1,3,4,0,2,2,0,-5,-13,-8,0,8,3,0,-1,-1,0,-1,-1,6,-1
KR_6764555160,440,-2,33,20,-8,-1,1,0,0,2,2,3,3,6,-10,10,0,0,1,1,-1,-14,16,-1,-3,4,0,0,-1,-1,0,-1,-1,4,-1
KR_6678564061,420,0,-27,3,-2,1,2,3,-6,7,1,-1,1,0,4,2,6,0,2,2,-1,-8,4,1,-6,5,-1,0,1,1,-1,1,-1,5,-1
KR_6691361782,420,-8,-109,-32,-20,-5,5,0,-6,8,2,-3,4,1,-4,6,2,-2,2,0,0,-28,-23,-6,-5,11,-9,0,0,-1,1,-1,1,2,-1
KR_6770781962,420,-4,-25,-12,-6,1,1,2,-5,5,0,-1,2,1,-1,4,3,0,3,3,0,-7,-17,5,-12,7,3,0,0,1,-1,0,1,4,-1
KR_6768863249,420,-4,-12,-24,-7,0,2,2,-2,6,4,-1,2,1,-3,5,2,-1,3,2,-3,-8,211,2,-3,1,2,0,-1,-1,1,-1,-1,4,-1
KR_6765424691,420,-4,-55,-43,-9,-4,5,1,1,2,3,-3,4,1,-2,4,2,-1,1,0,0,-6,138,-1,-3,4,-1,0,-3,-1,-1,-1,-1,5,-1
KR_6762413481,420,1,-28,13,2,-2,3,1,2,1,3,0,1,1,6,2,8,-4,5,1,0,8,49,5,-9,4,-5,0,0,1,1,0,1,4,-1
KR_6769802746,420,-1,-12,-7,-3,2,1,3,-1,2,1,-1,3,2,-4,5,1,1,0,1,0,-5,-10,-1,-6,7,0,0,0,0,-1,-1,1,0,-1
KR_6743137774,420,-2,-63,4,2,3,1,4,-2,2,0,4,0,4,-2,4,2,-1,3,2,0,-3,15,3,-7,4,0,0,-1,-1,1,1,1,5,-1
KR_6746469032,420,-2,-18,8,-6,-2,4,2,-3,4,1,-3,3,0,2,0,2,0,0,0,0,-3,-4,1,-6,5,-7,0,-1,-1,-1,-1,-1,6,-1
KR_6719666759,420,-5,-82,-9,-8,-5,6,1,1,0,1,0,1,1,-2,4,2,-2,2,0,0,-7,0,-2,-2,4,-4,0,-1,-1,-1,-1,-1,5,-1
KR_6747498783,420,-3,-66,0,-9,-2,2,0,-4,5,1,-2,3,1,-1,1,0,0,0,0,-1,-8,-38,-5,-2,7,0,0,-1,-1,-1,-1,-1,2,-1
KR_6765813682,440,-2,14,-8,-7,0,1,1,-2,2,0,-2,3,1,1,1,2,-4,4,0,-1,-9,17,7,-9,2,0,0,0,1,-1,0,-1,2,-1
KR_6747759458,420,1,14,-17,0,1,3,4,-1,1,0,-1,1,0,1,4,5,0,0,0,0,-2,5,0,-6,6,-4,0,1,-1,1,1,1,5,-1
KR_6764814521,420,-4,-117,-28,-9,-2,3,1,1,0,1,1,0,1,-11,11,0,2,1,3,0,-5,19,-3,-6,9,3,0,-1,1,-1,-1,-1,4,-1
KR_6746207972,420,-4,-76,-8,-4,-5,6,1,5,2,7,0,4,4,-5,5,0,1,0,1,0,-3,4,-3,-4,7,6,0,-2,1,-1,-1,-1,1,-1
KR_6740086004,420,-2,-39,0,-6,1,1,2,0,1,1,-2,2,0,-1,1,0,-4,4,0,0,-6,-9,-2,-4,6,-4,0,-2,-1,-1,-1,-1,6,-1
KR_6766782901,420,-3,-27,-12,-8,0,2,2,2,3,5,-4,4,0,-4,6,2,-2,2,0,1,-7,-1,2,-8,6,-1,0,0,-1,-1,-1,1,1,-1
KR_6757973780,420,2,16,-8,4,2,1,3,-3,3,0,2,1,3,3,2,5,0,2,2,1,2,165,-4,-3,7,-1,0,1,-1,-1,-1,1,6,-1
KR_6754566306,420,-2,30,4,-14,0,1,1,-6,6,0,-2,3,1,-5,5,0,-1,1,0,0,-15,-3,-2,-4,6,-1,0,-1,0,-1,-1,-1,0,-1
KR_6706913186,420,2,31,8,8,-1,2,1,2,1,3,3,3,6,4,4,8,0,2,2,0,4,4,5,-8,3,-3,0,1,-1,1,1,1,6,-1
KR_6704930718,420,-2,9,-21,-5,3,0,3,-4,7,3,2,3,5,-8,11,3,2,1,3,-3,-6,-102,1,-7,6,1,0,-1,-1,-1,-1,1,1,-1
KR_6745200864,420,0,-16,0,0,1,2,3,2,3,5,-1,1,0,-2,4,2,0,2,2,-1,0,47,-3,-5,8,-8,0,0,-1,-1,1,-1,1,-1
KR_6711908631,420,-2,-12,-38,-4,-3,4,1,-4,7,3,-2,6,4,4,2,6,1,0,1,-1,10,7,-6,-9,15,5,0,-2,-1,-1,-1,-1,6,-1
KR_6768554440,420,-5,-15,-20,-2,1,1,2,-1,5,4,2,3,5,-1,2,1,-3,3,0,0,-2,2,0,-5,5,3,0,-1,-1,-1,-1,1,4,-1
KR_6750292058,420,-1,12,-23,1,-2,4,2,2,2,4,-2,4,2,0,2,2,3,0,3,0,6,69,-3,-7,10,-2,0,0,1,-1,-1,1,6,-1
KR_6718222119,420,-1,-2,49,-2,0,1,1,7,2,9,-3,3,0,-4,5,1,-2,2,0,0,-1,-9,-5,-4,9,0,0,-1,1,1,-1,-1,2,-1
KR_6766989304,420,-2,-107,-2,-2,-1,1,0,-2,2,0,2,1,3,-1,1,0,0,0,0,0,-3,1,1,-4,3,-2,0,0,-1,-1,0,1,3,-1
KR_6693573767,420,1,28,-48,1,5,1,6,-5,6,1,-2,6,4,-1,3,2,4,0,4,0,4,-1,-3,-4,7,6,0,0,0,-1,0,-1,0,-1
KR_6764226301,420,2,50,36,5,-2,4,2,-3,3,0,3,2,5,7,0,7,0,0,0,0,3,125,-2,-5,7,3,0,1,-1,1,1,-1,5,-1
KR_6757467445,440,-1,65,-20,-4,-1,2,1,-3,5,2,-3,5,2,2,2,4,1,0,1,0,1,-10,1,-5,4,-2,0,0,-1,1,0,1,3,-1
KR_6769568113,420,-2,-58,49,-13,-3,5,2,1,4,5,-5,6,1,-4,6,2,-2,2,0,0,-9,-136,0,-6,6,2,0,0,1,-1,-1,1,2,-1
KR_6715792668,420,-2,-4,11,0,1,0,1,1,1,2,1,1,2,-1,4,3,-2,3,1,0,0,-120,-6,-3,9,6,0,-1,-1,1,-1,-1,4,-1
KR_6717188620,420,0,-7,12,-5,-2,2,0,3,1,4,-1,3,2,-5,7,2,0,1,1,-1,-3,141,0,-6,6,2,0,0,-1,1,1,-1,3,-1
KR_6685369170,420,-4,-45,-17,-14,1,0,1,-7,8,1,-2,2,0,-4,5,1,-2,3,1,0,-15,37,0,-6,6,-34,0,-1,-1,-1,-1,-1,3,-1
KR_6743475634,440,-1,3,3,-8,2,0,2,-5,6,1,1,0,1,-5,5,0,-1,2,1,0,-15,-3,-2,-3,5,-6,0,-1,-1,-1,-1,-1,2,-1
KR_6715886663,420,0,17,24,0,1,0,1,4,0,4,0,4,4,-3,4,1,-2,3,1,0,3,46,3,-4,1,1,0,1,-1,1,1,-1,2,-1
KR_6718074352,420,2,22,20,1,-6,7,1,-1,2,1,-2,5,3,7,0,7,3,1,4,0,0,-7,0,-5,5,-2,0,1,1,-1,1,-1,3,-1
KR_6680362075,440,0,37,4,4,0,2,2,6,2,8,1,3,4,-4,5,1,1,0,1,0,0,13,2,-4,2,-2,0,0,-1,-1,0,-1,4,-1
KR_6764679680,420,-5,-17,1,-11,-2,3,1,-6,7,1,2,1,3,-5,5,0,0,0,0,0,-14,-14,0,-5,5,-2,0,-1,1,-1,-1,-1,6,-1
KR_6762367135,420,1,6,8,6,2,1,3,-2,2,0,3,0,3,1,5,6,2,0,2,1,6,4,1,-7,6,-2,0,1,-1,1,1,1,6,-1
KR_6745091536,420,-3,27,-24,-8,0,3,3,-4,6,2,-4,5,1,0,1,1,0,2,2,0,-3,-7,-4,-3,7,-6,0,0,1,-1,-1,-1,1,-1
KR_6755024525,420,0,-10,-8,3,-2,2,0,-1,4,3,5,2,7,2,4,6,-1,2,1,0,6,-7,1,-5,4,1,0,0,-1,1,0,1,4,-1
KR_6724129030,420,-2,15,16,-3,-3,5,2,0,6,6,1,0,1,1,2,3,-2,2,0,0,-8,10,2,-6,4,-3,0,-1,1,1,-1,1,2,-1
KR_6737325824,420,-4,-108,7,-6,-2,2,0,2,2,4,-3,4,1,-1,2,1,-2,2,0,0,-6,-3,2,-7,5,0,0,0,-1,1,1,-1,6,-1
KR_6680168224,420,-5,-39,-20,-12,-2,3,1,-2,3,1,-5,8,3,-3,7,4,0,0,0,0,-12,23,2,-8,6,0,0,-2,-1,-1,-1,-1,4,-1
KR_6761848898,440,1,5,14,3,2,2,4,3,1,4,0,7,7,-2,7,5,0,1,1,1,6,-12,-1,-5,6,3,0,2,1,1,1,1,2,-1
KR_6761507804,440,-4,-56,15,-10,-2,3,1,-4,5,1,2,4,6,1,0,1,-7,8,1,1,-16,-16,-3,-3,6,0,0,-2,-1,-1,-1,1,1,-1
KR_6769372617,420,-4,-90,0,-4,-5,6,1,3,1,4,-1,3,2,0,3,3,-1,1,0,-1,8,0,0,-6,6,0,0,-2,1,-1,-1,-1,2,-1
KR_6770160585,440,-1,42,-28,-1,1,0,1,-2,3,1,-1,1,0,1,0,1,0,2,2,0,-1,6,1,-5,4,-3,0,0,1,-1,-1,1,5,-1
KR_6732599659,440,1,43,-32,-6,2,0,2,-6,6,0,0,2,2,-4,6,2,2,0,2,0,-8,-20,-1,-4,5,-1,0,1,1,-1,-1,1,3,-1
KR_6769749287,420,0,-2,0,0,2,1,3,-4,4,0,6,0,6,0,4,4,-4,4,0,-2,-7,4,2,-6,4,0,0,0,1,-1,0,-1,2,-1
KR_6749633005,440,-1,-66,-16,-4,-1,2,1,3,2,5,-3,5,2,-1,4,3,-2,6,4,-1,-8,5,1,-4,3,-4,0,-2,-1,-1,-1,-1,3,-1
KR_6749534900,440,-2,-6,0,-11,-3,4,1,-3,5,2,-1,3,2,-3,7,4,-1,3,2,0,-5,-2,2,-5,3,-2,0,-2,-1,-1,-1,1,3,-1
KR_6764786427,420,-4,-93,-12,-10,-4,6,2,2,2,4,-4,8,4,-4,5,1,0,2,2,0,-5,-3,1,-3,2,2,0,-2,-1,-1,-1,-1,4,-1
KR_6674721671,420,-2,-1,-20,-3,0,3,3,-1,5,4,0,4,4,-1,1,0,-1,1,0,0,-6,-8,-5,-2,7,2,0,-1,0,-1,-1,-1,0,-1
KR_6770416345,440,1,26,18,-1,-1,5,4,0,3,3,1,1,2,-3,6,3,2,0,2,0,0,13,2,-4,2,0,0,0,-1,1,1,-1,5,-1
KR_6753342822,420,1,26,3,6,1,1,2,0,0,0,1,1,2,3,1,4,1,0,1,0,4,6,2,-6,4,-2,0,1,1,1,1,1,4,-1
KR_6726464276,420,1,9,-12,-2,-2,2,0,-3,7,4,0,6,6,3,0,3,0,2,2,0,-2,-31,-1,-4,5,1,0,2,1,-1,-1,1,4,-1
KR_6670885488,440,0,-32,5,-6,-1,7,6,0,1,1,-2,3,1,-3,6,3,0,1,1,0,-3,31,-3,-2,5,-3,0,0,-1,1,-1,1,1,-1
KR_6735340241,420,2,47,-4,4,2,3,5,0,4,4,0,5,5,4,1,5,-2,2,0,0,0,1,-6,-5,11,5,0,1,1,-1,1,1,6,-1
KR_6761482641,420,-2,-29,0,-4,-6,6,0,1,3,4,1,2,3,0,2,2,0,0,0,0,5,-9,-5,-3,8,-2,0,0,-1,1,1,1,2,-1
KR_6760972085,440,-1,-31,-31,0,0,2,2,-1,2,1,1,4,5,-2,6,4,2,0,2,0,-8,-2,-1,-6,7,-2,0,0,-1,0,0,-1,4,-1
KR_6669147971,420,0,-26,-19,-3,-5,5,0,1,2,3,0,8,8,1,1,2,0,1,1,0,1,-11,-1,-3,4,2,0,0,-1,-1,-1,1,5,-1
KR_6770479406,420,-1,31,-5,-7,1,1,2,-8,8,0,-1,3,2,-1,7,6,2,3,5,0,-5,29,1,-3,2,4,0,0,-1,1,0,-1,3,-1
KR_6642872165,420,-2,-34,-28,-7,-1,1,0,1,5,6,-3,3,0,-8,8,0,4,0,4,-2,-10,10,4,-8,4,-3,0,0,1,-1,0,1,4,-1
KR_6681522474,420,2,42,8,2,1,1,2,-4,6,2,4,1,5,2,4,6,-1,3,2,0,0,115,4,-8,4,-1,0,-1,1,0,-1,-1,3,-1
KR_6650962819,420,-2,-20,-24,-3,-1,2,1,0,2,2,-1,4,3,1,2,3,-2,3,1,0,-3,2,-1,-6,7,-6,0,-1,-1,-1,-1,1,5,-1
KR_6695760746,420,1,-36,-7,-5,1,0,1,3,2,5,-1,4,3,-1,2,1,-7,7,0,0,-8,22,-5,-7,12,5,0,0,-1,1,1,-1,5,-1
KR_6718237945,420,-5,-92,4,-9,1,2,3,0,2,2,-7,8,1,-3,4,1,0,0,0,0,-7,8,-1,-6,7,0,0,-2,-1,-1,-1,-1,4,-1
KR_6757090790,420,-7,-167,8,-12,-1,3,2,-7,8,1,1,0,1,-5,8,3,0,1,1,0,-18,-11,-2,-8,10,-4,0,-3,-1,1,-1,-1,6,-1
KR_6759929963,420,-3,-44,-16,-8,-3,5,2,-1,4,3,-1,4,3,-3,5,2,0,1,1,0,-4,-14,7,-12,5,-6,0,1,-1,1,-1,1,2,-1
KR_6731357817,420,-4,-36,-27,-7,-6,7,1,-1,3,2,-3,5,2,2,2,4,1,1,2,0,3,9,4,-9,5,-2,0,0,-1,-1,-1,-1,5,-1
KR_6764549758,420,-1,-41,12,-9,3,1,4,-5,7,2,2,2,4,-11,11,0,2,0,2,0,-19,-11,2,-5,3,-6,0,-1,-1,1,-1,-1,4,-1
KR_6764195699,420,1,13,-11,3,0,2,2,3,0,3,-3,8,5,3,1,4,0,1,1,0,-2,53,-2,-4,6,-15,0,1,1,1,1,1,2,-1
KR_6616192791,420,-4,-74,-15,-11,-1,1,0,-1,4,3,1,3,4,-8,9,1,-2,2,0,-1,-12,16,-3,-4,7,-7,0,-1,-1,1,-1,-1,4,-1
KR_6745181077,420,2,20,0,-2,4,0,4,-5,10,5,-2,3,1,-1,4,3,2,0,2,0,6,-10,0,-8,8,0,0,0,-1,1,0,1,3,-1
KR_6758485258,420,-3,-72,-51,-2,0,3,3,-2,4,2,0,2,2,0,3,3,0,1,1,0,0,-13,3,-7,4,2,0,0,-1,-1,-1,1,5,-1
KR_6760091251,420,2,54,-25,1,2,0,2,1,3,4,-3,4,1,0,1,1,1,1,2,0,-4,-22,1,-4,3,3,0,1,-1,-1,1,1,3,-1
KR_6736355666,420,1,-26,-14,3,0,2,2,0,2,2,-3,4,1,7,0,7,-1,2,1,0,2,0,1,-6,5,4,0,0,1,-1,0,-1,3,-1
KR_6768443253,420,-4,-78,-37,-9,-2,3,1,-6,8,2,0,3,3,-2,3,1,1,0,1,-1,-4,0,5,-8,3,-8,0,0,-1,1,1,-1,2,-1
KR_6750833688,420,-4,-41,-4,-8,-3,4,1,0,1,1,-8,8,0,3,1,4,0,1,1,0,-6,-32,4,-8,4,-2,0,-1,1,-1,-1,-1,6,-1
KR_6759636201,420,-1,-25,24,1,1,0,1,-1,1,0,-7,7,0,3,1,4,5,0,5,0,8,15,-2,-2,4,0,0,0,1,1,1,-1,6,-1
KR_6732765823,440,-2,-76,-17,-2,2,0,2,0,1,1,-5,6,1,-4,4,0,5,1,6,0,1,-116,-2,-4,6,-8,0,-2,0,-1,-1,-1,0,-1
KR_6741033481,420,-1,-41,-8,-4,-3,3,0,-3,6,3,-1,3,2,3,1,4,0,3,3,0,0,17,-1,-3,4,-1,0,0,-1,-1,0,1,1,-1
KR_6714750885,420,1,49,-39,7,3,0,3,0,1,1,2,1,3,2,1,3,0,0,0,0,12,8,5,-8,3,-3,0,1,1,1,1,-1,5,-1
KR_6740648822,420,4,91,56,1,-3,4,1,3,3,6,4,2,6,-3,5,2,0,0,0,-1,-15,-7,-4,-3,7,-3,0,0,1,-1,-1,-1,4,-1
KR_6717848151,420,-1,-29,10,3,-1,2,1,2,3,5,-3,5,2,-1,1,0,6,0,6,-1,7,20,1,-8,7,-2,0,1,1,0,1,-1,5,-1
KR_6764861652,420,0,106,11,-14,0,3,3,2,2,4,-4,5,1,-10,11,1,-2,3,1,0,-9,-15,-1,-5,6,1,0,0,1,-1,-1,1,1,-1
KR_6740628278,420,0,-35,-17,-4,0,1,1,3,1,4,-6,9,3,-2,3,1,1,0,1,0,-1,-16,1,-3,2,-3,0,-1,1,-1,-1,-1,4,-1
KR_6768860280,420,1,-42,-9,0,-4,4,0,0,5,5,3,1,4,-2,5,3,3,0,3,0,0,28,2,-8,6,-4,0,-2,-1,-1,-1,-1,3,-1
KR_6631408504,420,-1,-92,-10,1,1,2,3,-6,6,0,2,2,4,2,3,5,2,0,2,0,1,21,1,-7,6,-5,0,-1,-1,-1,-1,1,5,-1
KR_6731719527,420,-5,-60,12,-12,-7,9,2,-1,3,2,8,2,10,-11,11,0,-1,3,2,-3,-17,103,-3,-4,7,-1,0,-2,-1,1,-1,1,5,-1
KR_6692107582,420,-1,-15,28,1,1,1,2,1,3,4,0,2,2,-1,2,1,0,0,0,0,0,-7,-4,-3,7,-2,0,1,-1,-1,1,-1,5,-1
KR_6733000273,420,1,-7,-24,1,2,0,2,-1,4,3,3,0,3,-3,3,0,0,0,0,0,-3,41,-1,-4,5,-26,0,-2,-1,-1,-1,1,6,-1
KR_6769949012,420,0,-67,-15,0,0,1,1,4,1,5,-1,2,1,-1,3,2,-2,2,0,2,8,6,2,-8,6,0,0,0,1,1,-1,1,2,-1
KR_6766449298,420,2,22,-8,-1,1,2,3,4,2,6,-1,1,0,-3,6,3,-2,2,0,0,1,-16,2,-8,6,0,0,-1,-1,1,-1,-1,4,-1
KR_6768361771,440,-6,-67,-51,-12,0,1,1,-13,13,0,0,2,2,-1,5,4,2,2,4,-1,-16,27,-1,-3,4,-4,0,-2,-1,1,-1,1,2,-1
KR_6769665713,420,0,0,-3,0,4,1,5,-1,3,2,-1,1,0,-2,2,0,0,0,0,0,-7,3,-2,-7,9,-6,0,0,-1,1,0,1,6,-1
KR_6768976148,420,0,-29,-48,4,-1,2,1,-4,4,0,7,0,7,6,0,6,-4,6,2,0,4,-17,2,-6,4,0,0,-1,-1,-1,-1,1,1,-1
KR_6767424884,420,1,11,0,1,0,2,2,-4,6,2,1,4,5,1,1,2,3,2,5,0,2,16,2,-5,3,1,0,1,0,1,1,-1,0,-1
KR_6603512991,420,-4,-10,-4,-4,2,1,3,-1,2,1,-4,5,1,1,2,3,-2,2,0,0,-6,10,3,-6,3,-3,0,-1,-1,-1,-1,-1,5,-1
KR_6705612627,420,1,-30,13,1,1,2,3,5,0,5,1,2,3,-4,4,0,-2,3,1,0,-2,-58,-3,-3,6,22,0,0,1,1,0,1,2,-1
KR_6617831074,420,-4,8,-24,-1,1,2,3,-3,8,5,0,2,2,0,7,7,1,1,2,1,11,-5,-7,-5,12,3,0,0,0,-1,0,1,0,-1
KR_6664590936,420,0,-67,0,-4,-2,3,1,-1,4,3,0,2,2,-1,3,2,0,2,2,0,-8,20,2,-7,5,-2,0,-2,-1,-1,-1,-1,1,-1
KR_6770517882,420,-2,-14,-5,-2,-1,3,2,-1,3,2,0,1,1,2,1,3,-2,2,0,0,4,-494,3,-4,1,-8,0,0,-1,-1,0,-1,4,-1
KR_6742493274,420,0,-90,-5,3,-4,7,3,7,1,8,-2,3,1,3,0,3,-1,2,1,0,7,-7,1,-6,5,0,0,-1,-1,-1,-1,-1,3,-1
KR_6768403489,420,-2,-24,-12,-13,-2,2,0,-8,8,0,3,2,5,-6,6,0,0,0,0,-1,-22,-9,-5,-2,7,4,0,-1,-1,-1,-1,-1,3,-1
KR_6753269976,420,2,-17,8,2,-2,5,3,2,4,6,0,2,2,-1,3,2,3,0,3,0,5,3,0,-4,4,2,0,0,1,0,0,-1,4,-1
KR_6677575074,440,-1,-7,16,-8,-2,3,1,-1,2,1,-4,5,1,-2,4,2,1,5,6,0,-10,-127,-9,-5,14,5,0,-2,-1,-1,-1,1,5,-1
KR_6663348632,420,1,19,-20,4,3,2,5,0,3,3,1,3,4,-1,3,2,1,0,1,0,-2,21,2,-5,3,-3,0,1,-1,-1,1,1,5,-1
KR_6750709103,420,-3,-16,-8,-6,1,1,2,-1,2,1,0,3,3,-6,6,0,0,0,0,0,-6,2,3,-8,5,-7,0,-1,1,-1,-1,-1,4,-1
KR_6746444603,440,-3,-30,-4,-1,1,3,4,0,4,4,-4,5,1,3,1,4,-1,3,2,0,-6,5,-2,-4,6,2,0,-1,-1,-1,-1,1,1,-1
KR_6727668455,420,-3,-46,-8,-5,-4,8,4,3,2,5,2,3,5,-5,8,3,-1,2,1,-2,-12,11,-6,-2,8,6,0,-1,1,-1,-1,1,3,-1
KR_6710013370,420,-4,-19,-5,-3,-1,3,2,0,1,1,-2,2,0,0,2,2,0,1,1,0,-5,-2,-5,-1,6,-5,0,-1,-1,1,-1,-1,3,-1
KR_6763036508,420,-6,-77,-15,-9,-4,4,0,1,2,3,-1,2,1,1,2,3,-6,10,4,0,-3,-3,-1,-4,5,2,0,-1,1,1,-1,-1,3,-1
KR_6733291246,420,-4,-14,15,-16,-2,2,0,-7,8,1,-3,3,0,-5,5,0,1,0,1,0,-20,12,-2,-4,6,-7,0,-1,-1,1,-1,-1,3,-1
KR_6745360516,420,0,-36,27,-1,-1,2,1,1,0,1,0,1,1,-1,1,0,0,0,0,0,-2,2,-2,-2,4,1,0,1,1,-1,1,1,2,-1
KR_6620407310,420,-2,-29,-7,-8,-1,2,1,-2,3,1,0,1,1,-1,3,2,-4,5,1,-1,-11,12,-4,-6,10,-5,0,-1,-1,-1,-1,-1,5,-1
KR_6757703679,420,2,-16,7,1,2,1,3,-1,2,1,0,1,1,-2,4,2,2,1,3,0,-1,-6,-2,-3,5,5,0,0,-1,-1,-1,-1,2,-1
KR_6716067227,420,0,-25,5,-3,-3,4,1,-6,8,2,1,3,4,5,0,5,0,1,1,0,-6,-3,-2,-6,8,0,0,0,1,-1,0,-1,5,-1
KR_6747493875,420,-5,-83,-4,-5,-4,4,0,-1,1,0,2,3,5,-2,5,3,0,1,1,0,-5,8,4,-7,3,-2,0,0,-1,1,-1,1,6,-1
KR_6758021103,420,-1,47,-12,-5,-5,5,0,1,4,5,-2,2,0,4,3,7,-3,3,0,0,-2,42,1,-9,8,1,0,-1,1,-1,-1,-1,5,-1
KR_6749477427,420,2,38,18,-4,4,0,4,1,5,6,-6,9,3,-3,4,1,0,1,1,0,-4,8,2,-7,5,1,0,0,-1,0,0,1,5,-1
KR_6766171509,420,1,19,-5,-9,0,6,6,-2,3,1,-1,2,1,-4,5,1,-2,2,0,0,-16,-3,-2,-5,7,-6,0,-1,-1,1,1,1,2,-1
KR_6763092195,420,3,-36,14,8,5,0,5,1,1,2,-1,3,2,1,2,3,2,1,3,1,5,1,2,-4,2,6,0,1,1,1,1,1,3,-1
KR_6767042885,420,-5,-61,-12,-10,-4,6,2,-1,3,2,-1,1,0,-4,5,1,0,1,1,0,-9,-8,-1,-3,4,-1,0,-2,-1,-1,-1,1,2,-1
KR_6766898708,420,1,-82,17,-1,1,1,2,0,2,2,-2,5,3,0,0,0,0,1,1,0,2,0,-3,-3,6,-1,0,0,-1,1,1,-1,4,-1
KR_6768791849,420,0,-44,-12,-2,0,2,2,-3,4,1,-1,2,1,1,1,2,1,0,1,0,-3,-1,2,-6,4,2,0,-1,-1,-1,-1,-1,6,-1
KR_6769991644,440,1,20,16,-3,0,1,1,-3,6,3,-3,3,0,1,0,1,2,2,4,0,2,50,0,-8,8,-32,0,2,1,-1,1,-1,4,-1
KR_6672776061,420,1,6,-16,5,2,0,2,2,5,7,-4,5,1,5,2,7,0,1,1,0,9,-8,-6,-5,11,9,0,-1,-1,-1,-1,-1,5,-1
KR_6765316113,420,0,6,1,-2,-2,3,1,-2,3,1,1,1,2,0,2,2,1,0,1,0,-4,-27,-1,-4,5,-1,0,1,1,-1,-1,-1,6,-1
KR_6768684643,420,-5,-86,11,-11,-6,6,0,-3,4,1,-5,6,1,1,6,7,2,1,3,2,-3,20,-1,-4,5,-5,0,-1,1,-1,-1,-1,2,-1
KR_6758668746,420,0,-62,-28,3,1,0,1,2,2,4,-3,4,1,3,1,4,0,1,1,0,2,6,-1,-6,7,-2,0,-1,0,-1,-1,1,0,-1
KR_6758104025,420,-1,-83,4,-5,-2,5,3,-3,9,6,-1,1,0,-1,5,4,2,1,3,-1,-4,-7,1,-6,5,4,0,0,0,-1,-1,-1,0,-1
KR_6759848676,420,1,20,-12,4,1,3,4,0,2,2,0,5,5,2,0,2,1,0,1,0,4,1,6,-8,2,2,0,0,-1,1,1,1,3,-1
KR_6764054003,440,-4,-11,-24,-14,0,5,5,-1,2,1,-5,7,2,-7,8,1,-1,3,2,0,-15,-1,5,-8,3,3,0,0,-1,-1,0,-1,1,-1
KR_6766218544,420,-1,22,-24,-1,2,1,3,0,1,1,-1,2,1,-2,3,1,0,0,0,0,1,-4,0,-6,6,-1,0,0,-1,-1,-1,1,5,-1
KR_6717397314,420,-3,-74,-16,-13,0,2,2,0,3,3,-2,4,2,-11,11,0,0,2,2,-1,-19,28,3,-8,5,-9,0,-3,0,-1,-1,-1,0,-1
KR_6756639706,420,1,-60,-20,8,1,0,1,6,0,6,0,3,3,2,2,4,-1,2,1,0,15,29,1,-5,4,3,0,0,1,-1,-1,1,6,-1
KR_6732681131,420,-4,-56,-53,-9,1,1,2,-5,6,1,-2,3,1,-3,3,0,0,1,1,0,-10,9,1,-7,6,-4,0,-1,-1,-1,-1,-1,6,-1
KR_6667775210,420,-2,-31,-40,4,3,0,3,2,2,4,-1,1,0,0,5,5,0,2,2,0,3,0,-1,-6,7,0,0,-2,1,-1,-1,1,1,-1
KR_6556644658,420,-3,-56,-28,-8,1,1,2,-2,3,1,-5,11,6,-2,8,6,0,0,0,0,-5,2,-2,-8,10,0,0,1,-1,0,-1,1,5,-1
KR_6689119440,420,-6,1,-44,-17,-2,3,1,-7,7,0,3,2,5,-7,7,0,-4,4,0,-1,-14,-8,-2,-2,4,0,0,0,-1,-1,-1,-1,5,-1
KR_6742310576,420,-1,-40,7,-3,-1,2,1,-5,7,2,3,2,5,-1,3,2,1,0,1,1,0,-102,0,-6,6,0,0,0,-1,1,0,1,5,-1
KR_6742582518,420,2,-25,11,4,1,2,3,5,1,6,-1,4,3,1,3,4,-2,3,1,0,1,7,3,-9,6,3,0,0,1,1,0,-1,2,-1
KR_6722659909,420,-1,-34,17,-13,-5,6,1,-3,6,3,-2,2,0,-2,3,1,-1,1,0,0,-12,2,0,-6,6,-6,0,-2,-1,-1,-1,1,1,-1
KR_6761349607,420,2,5,5,3,-1,2,1,2,1,3,-6,6,0,7,2,9,1,1,2,0,9,3,3,-6,3,5,0,0,0,-1,-1,-1,0,-1
KR_6714481384,420,-3,-2,8,-2,-2,4,2,1,3,4,-5,6,1,4,0,4,0,0,0,0,-6,8,1,-6,5,-8,0,-1,1,1,-1,1,6,-1
KR_6763295010,420,-2,-61,-17,-1,-1,3,2,-2,3,1,0,1,1,2,5,7,0,1,1,0,3,-3,-3,-5,8,-2,0,-2,-1,-1,-1,-1,1,-1
KR_6757906519,420,-3,-51,-5,-7,-3,4,1,-3,6,3,-3,3,0,2,0,2,0,1,1,0,-2,-26,-1,-7,8,3,0,0,-1,1,0,-1,3,-1
KR_6742272073,420,-4,-5,-16,-8,-1,1,0,-4,5,1,1,3,4,-4,6,2,0,0,0,0,-11,5,-10,-2,12,-5,0,-1,-1,-1,-1,1,2,-1
KR_6765281475,420,-1,-26,10,-4,0,3,3,-2,3,1,-5,6,1,5,1,6,-2,3,1,0,-5,3,-1,-5,6,4,0,-1,1,-1,-1,-1,3,-1
KR_6714664904,420,0,-18,-4,-3,1,1,2,-1,2,1,-4,6,2,2,1,3,-1,1,0,0,-7,12,-2,-2,4,-4,0,0,1,-1,0,-1,5,-1
KR_6737303637,420,-3,-32,-28,-9,-5,5,0,2,2,4,-1,1,0,-5,8,3,0,0,0,-1,-9,91,-4,-2,6,4,0,-1,-1,1,-1,-1,3,-1
KR_6702498062,420,3,34,-16,8,0,4,4,-2,3,1,2,0,2,4,2,6,4,0,4,0,7,-32,3,-5,2,31,0,-1,-1,-1,-1,1,1,-1
KR_6699777003,420,-1,-51,7,-2,4,2,6,-1,3,2,-1,5,4,-2,4,2,-2,2,0,0,6,9,3,-7,4,-2,0,-1,-1,1,-1,1,5,-1
KR_6674006452,420,-3,-1,-31,-5,-1,4,3,-2,4,2,-2,3,1,-2,4,2,2,0,2,0,-6,3,6,-7,1,1,0,0,-1,1,0,1,3,-1
KR_6732206876,420,-7,-138,-13,-12,-8,9,1,-1,5,4,0,2,2,-3,5,2,0,2,2,0,-13,5,4,-13,9,-2,0,-3,0,1,-1,-1,0,-1
KR_6765932901,420,-2,15,-12,-7,-1,3,2,0,1,1,-5,8,3,0,3,3,-1,2,1,0,-10,-6,-5,-2,7,5,0,-1,1,-1,-1,-1,4,-1
KR_6766660450,420,-5,-15,-32,-11,-3,4,1,0,3,3,-2,4,2,-3,4,1,-3,3,0,0,-9,-3,-3,-3,6,1,0,-1,1,-1,-1,-1,3,-1
KR_6768149504,420,-1,-45,9,-3,-2,4,2,0,2,2,0,4,4,0,3,3,-1,1,0,0,3,-6,-2,-5,7,0,0,0,-1,-1,-1,1,6,-1
KR_6701644536,420,-2,5,2,-4,-1,2,1,-5,7,2,-1,2,1,2,4,6,1,1,2,0,-7,-4,2,-8,6,5,0,0,-1,-1,1,1,2,-1
KR_6747130822,420,1,76,-14,-1,3,0,3,-4,5,1,-3,6,3,0,2,2,3,2,5,0,-1,7,-5,-3,8,0,0,0,1,1,1,1,1,-1
KR_6770678702,420,-5,-46,-24,-11,-4,5,1,-4,4,0,0,2,2,-1,5,4,-2,2,0,0,-15,0,1,-4,3,-5,0,-2,-1,-1,-1,-1,4,-1
KR_6749179520,440,-4,-44,-26,-13,-3,4,1,1,1,2,-5,6,1,-3,7,4,-3,5,2,0,-12,-32,2,-5,3,1,0,-2,-1,-1,-1,-1,5,-1
KR_6755525617,420,1,-31,-3,3,-1,1,0,5,2,7,1,0,1,-2,5,3,0,0,0,0,4,-8,-1,-6,7,-7,0,0,1,1,0,1,4,-1
KR_6769688519,420,-1,-10,-17,-8,1,1,2,-3,5,2,1,1,2,-7,7,0,0,3,3,0,-10,4,0,-3,3,0,0,-1,1,-1,-1,-1,6,-1
KR_6650244743,420,-2,-24,4,-1,-4,4,0,3,5,8,3,0,3,-2,3,1,-1,2,1,0,-2,5,-1,-7,8,-6,0,0,-1,1,-1,-1,5,-1
KR_6749471697,420,0,-31,-15,2,-1,2,1,1,2,3,-2,5,3,2,2,4,2,0,2,0,5,-7,7,-9,2,1,0,0,1,-1,1,-1,4,-1
KR_6698447377,420,2,7,12,2,2,0,2,0,2,2,-3,5,2,2,0,2,1,0,1,1,7,5,3,-11,8,4,0,0,1,-1,0,1,6,-1
KR_6767104921,440,-1,19,8,-6,-1,2,1,-4,7,3,1,0,1,-1,2,1,-1,1,0,-1,-13,5,1,-7,6,-3,0,0,-1,-1,-1,-1,6,-1
KR_6738605856,420,-3,-57,-48,-2,-4,4,0,3,1,4,-1,2,1,1,3,4,-1,1,0,0,1,-36,0,-7,7,-3,0,-1,0,-1,-1,1,0,-1
KR_6744803559,420,-3,-45,-20,-7,0,1,1,-3,7,4,-2,4,2,-2,4,2,0,0,0,-1,-12,-30,-5,-4,9,-2,0,-2,1,-1,-1,-1,5,-1
KR_6742271054,440,-1,-48,-1,-4,0,2,2,-2,4,2,0,0,0,2,1,3,-4,5,1,0,1,-21,0,-6,6,-3,0,0,1,-1,0,-1,1,-1
KR_6688836805,420,-3,-43,-16,-9,1,1,2,-6,7,1,2,2,4,-4,4,0,-2,3,1,-1,-15,-61,-1,-6,7,16,0,0,1,1,0,-1,4,-1
KR_6744685062,420,-2,-37,4,-5,-5,6,1,2,3,5,-3,3,0,1,0,1,0,0,0,0,-4,-3,-2,-3,5,-2,0,-2,1,-1,-1,-1,2,-1
KR_6725759238,420,-4,-72,-7,-6,0,0,0,2,4,6,-4,6,2,-2,3,1,-2,2,0,0,-3,-90,-2,-2,4,-8,0,0,1,-1,-1,-1,6,-1
KR_6729742024,420,-1,-72,-17,3,-1,3,2,2,5,7,-2,2,0,3,2,5,1,0,1,0,4,-17,1,-5,4,2,0,0,-1,-1,-1,-1,5,-1
KR_6766489201,420,-1,-38,-12,0,1,3,4,-3,5,2,0,2,2,1,2,3,1,0,1,0,2,2,2,-6,4,1,0,0,1,1,0,1,6,-1
KR_6769915063,420,0,-35,12,1,-2,4,2,-4,10,6,4,1,5,1,4,5,2,0,2,0,2,-43,1,-5,4,28,0,0,1,-1,-1,1,4,-1
KR_6744644514,420,0,-16,-8,-1,1,0,1,-4,6,2,1,1,2,3,2,5,-2,2,0,0,-1,-26,-5,-2,7,3,0,1,-1,1,1,1,4,-1
KR_6762698778,440,-3,-63,-38,-2,0,2,2,3,1,4,2,1,3,-4,5,1,-3,3,0,0,5,-5,3,-5,2,0,0,-2,-1,-1,-1,-1,4,-1
KR_6766093505,420,-4,-30,-38,-10,0,2,2,-3,6,3,1,4,5,-6,6,0,-2,2,0,-3,-24,-1,-1,-5,6,0,0,-3,-1,-1,-1,-1,4,-1
KR_6684416361,420,-1,-7,-28,3,-5,5,0,0,5,5,3,2,5,5,1,6,0,2,2,0,2,0,4,-9,5,4,0,0,-1,-1,-1,1,3,-1
KR_6770503482,420,-4,18,-36,-8,-4,7,3,0,5,5,-1,3,2,-2,2,0,-1,3,2,0,-10,280,0,-5,5,-1,0,1,-1,-1,1,1,6,-1
KR_6767231755,420,1,62,-4,8,2,2,4,5,0,5,-2,3,1,2,1,3,1,1,2,3,19,-7,-1,-5,6,10,0,1,1,1,1,1,2,-1
KR_6725740354,420,-5,-117,-12,-15,-2,3,1,-2,2,0,0,3,3,-10,13,3,-1,1,0,0,-15,13,-2,-6,8,-3,0,-2,-1,1,-1,-1,4,-1
KR_6751418397,420,1,-25,8,4,5,2,7,1,3,4,-1,3,2,-1,2,1,0,2,2,0,8,-1,-2,-3,5,-4,0,0,1,1,1,-1,1,-1
KR_6761565772,420,3,65,11,9,1,2,3,6,0,6,-1,1,0,3,3,6,0,1,1,2,13,34,2,-2,0,-5,0,0,1,-1,0,1,6,-1
KR_6719520366,420,1,82,-3,-2,1,1,2,-2,3,1,-3,6,3,1,3,4,1,2,3,0,-11,3,2,-3,1,2,0,2,-1,1,1,-1,5,-1
KR_6759229551,420,-1,-43,-8,-5,2,0,2,0,1,1,-1,1,0,-6,6,0,0,0,0,0,-2,5,0,-4,4,-4,0,-1,1,-1,-1,-1,1,-1
KR_6747370310,420,0,1,-10,-5,3,0,3,-4,5,1,-2,3,1,1,1,2,-3,3,0,0,-9,-23,-4,-2,6,0,0,-1,-1,-1,-1,-1,1,-1
KR_6746395031,420,-2,-47,1,-3,-2,2,0,1,2,3,2,0,2,-5,6,1,1,1,2,0,-9,2,2,-6,4,-3,0,0,1,-1,-1,-1,4,-1
KR_6733488022,420,-1,9,15,-6,0,1,1,0,2,2,5,2,7,-7,7,0,-4,5,1,0,-9,6,2,-8,6,4,0,-1,1,-1,-1,-1,3,-1
KR_6746167591,420,-5,-34,-9,-14,-4,5,1,-5,6,1,-3,3,0,-2,3,1,0,1,1,-1,-12,-3,1,-8,7,0,0,-2,-1,-1,-1,-1,2,-1
KR_6611292516,420,0,-57,0,-1,3,0,3,-2,7,5,-3,3,0,-1,4,3,2,1,3,0,4,-1,3,-6,3,0,0,-1,-1,-1,-1,1,2,-1
KR_6743872800,420,-1,-43,-14,-2,-4,5,1,-2,3,1,4,1,5,1,2,3,-1,1,0,-1,-3,40,-3,-4,7,-19,0,0,1,-1,1,-1,1,-1
KR_6732428878,420,-4,-11,4,-5,-1,3,2,-3,7,4,-2,2,0,-2,5,3,3,1,4,0,-5,-11,0,-5,5,-1,0,0,0,0,0,-1,0,-1
KR_6769456407,420,1,10,-4,1,0,2,2,1,1,2,-1,2,1,0,0,0,1,0,1,0,6,85,2,-5,3,-39,0,-1,1,-1,-1,1,2,-1
KR_6767702356,420,2,119,12,1,6,0,6,-2,5,3,4,2,6,-1,4,3,-6,7,1,1,-9,297,3,-5,2,2,0,0,-1,1,1,1,6,-1
KR_6715356558,420,-3,-76,-24,-7,-1,1,0,0,1,1,-1,3,2,-4,4,0,-1,1,0,0,-10,21,2,-6,4,2,0,0,-1,1,0,1,4,-1
KR_6574275562,420,-2,48,-34,-1,0,2,2,6,2,8,-8,9,1,1,1,2,0,0,0,0,-1,-2,0,-9,9,0,0,-1,-1,-1,-1,1,1,-1
KR_6739484408,420,-4,-78,5,-6,0,0,0,-3,5,2,0,1,1,-5,6,1,2,1,3,0,-8,19,-1,-3,4,-7,0,-1,0,0,-1,1,0,-1
KR_6761678389,420,0,15,-20,-3,0,0,0,-5,6,1,-1,1,0,2,0,2,1,0,1,0,3,109,-2,-4,6,-1,0,0,-1,-1,0,-1,2,-1
KR_6759838790,420,-2,-40,5,-11,-4,5,1,-4,7,3,1,1,2,-2,2,0,-2,3,1,0,-10,8,4,-8,4,-9,0,0,1,-1,0,1,5,-1
KR_6767443763,420,-4,-65,-13,-14,-4,5,1,-8,8,0,-4,7,3,2,1,3,0,2,2,-1,-20,6,0,-4,4,0,0,-2,-1,-1,-1,-1,1,-1
KR_6750271435,420,-1,-67,2,1,2,0,2,-3,3,0,-4,5,1,4,0,4,2,0,2,0,3,17,1,-6,5,-4,0,0,-1,1,0,-1,6,-1
KR_6766823603,420,1,19,4,4,3,0,3,2,2,4,-1,3,2,-1,2,1,1,0,1,1,2,34,-1,-4,5,2,0,-1,-1,-1,-1,1,1,-1
KR_6677198756,440,2,22,22,5,2,1,3,-1,3,2,4,1,5,2,1,3,-2,2,0,0,-1,-10,3,-6,3,-3,0,1,0,1,1,1,0,-1
KR_6759728772,420,1,-4,23,-2,-2,3,1,-3,4,1,-3,6,3,4,0,4,2,0,2,1,0,-4,0,-5,5,-2,0,0,-1,1,0,1,1,-1
KR_6760899392,420,-1,-43,20,-6,-3,3,0,2,2,4,1,3,4,-6,7,1,0,1,1,0,-3,3,2,-4,2,1,0,0,1,0,0,-1,1,-1
KR_6745441162,420,-1,15,-16,-1,-5,6,1,2,2,4,0,4,4,1,2,3,1,1,2,0,-2,4,-3,-3,6,0,0,1,-1,1,1,-1,5,-1
KR_6767908039,420,-3,-67,4,-8,-2,2,0,-1,3,2,-2,4,2,-2,4,2,-1,1,0,-3,-14,-5,-2,-7,9,-5,0,0,1,0,0,-1,6,-1
KR_6724574299,420,0,42,-7,-4,-1,3,2,5,0,5,-5,7,2,-3,3,0,0,0,0,0,-6,-2,-1,-5,6,2,0,1,-1,1,1,-1,4,-1
KR_6707101879,440,0,-46,8,-3,0,0,0,-2,2,0,0,1,1,-5,6,1,4,0,4,0,-3,-34,3,-6,3,-4,0,0,-1,-1,0,-1,1,-1
KR_6728305696,420,-4,48,-73,-10,2,1,3,0,3,3,-1,3,2,-7,10,3,-4,4,0,-1,-15,-20,-3,-1,4,1,0,-1,-1,-1,-1,-1,3,-1
KR_6669655862,440,-3,-57,4,-3,-3,3,0,2,0,2,0,1,1,1,3,4,-3,4,1,0,4,7,0,-3,3,-4,0,0,0,-1,-1,-1,0,-1
KR_6759636055,420,-1,-35,16,-1,0,1,1,2,0,2,-3,5,2,1,2,3,-1,1,0,0,5,8,-1,-6,7,-1,0,0,-1,1,0,1,2,-1
KR_6765583666,420,-1,1,3,-3,-1,2,1,-1,3,2,-1,3,2,4,0,4,-4,5,1,3,1,6,-4,-6,10,1,0,1,1,1,1,1,5,-1
KR_6740304679,420,0,16,-14,-1,1,2,3,-1,4,3,0,1,1,0,1,1,-1,3,2,0,-4,-2,0,-7,7,5,0,1,-1,1,1,-1,5,-1
KR_6759202128,420,5,22,15,4,3,0,3,-3,4,1,3,1,4,0,1,1,1,0,1,0,-1,-7,0,-5,5,3,0,0,-1,1,0,1,5,-1
KR_6763569848,420,1,11,37,4,0,2,2,3,2,5,1,0,1,-1,1,0,1,0,1,0,6,26,1,-6,5,-1,0,0,0,-1,0,-1,0,-1
KR_6768959250,420,-1,10,10,-3,-4,5,1,0,2,2,-1,3,2,0,4,4,2,0,2,0,4,-63,-2,-3,5,-31,0,1,1,-1,1,1,6,-1
KR_6770116322,440,-1,-66,-12,1,-1,2,1,-1,2,1,1,6,7,1,1,2,1,0,1,0,2,18,3,-6,3,2,0,0,-1,1,1,1,6,-1
KR_6740979895,420,0,46,-11,1,-2,2,0,0,1,1,2,3,5,0,3,3,1,2,3,2,2,-7,-5,-1,6,1,0,0,-1,-1,0,1,3,-1
KR_6745157633,420,-6,-42,-58,-13,-6,6,0,1,2,3,-6,7,1,-4,7,3,2,0,2,0,2,-4,-2,-3,5,-4,0,-3,0,-1,-1,-1,0,-1
KR_6653920237,420,1,-5,-3,-1,0,4,4,1,1,2,3,1,4,-3,3,0,-2,2,0,0,-1,11,1,-6,5,-4,0,0,-1,-1,0,-1,3,-1
KR_6761970622,420,0,-45,27,-15,0,1,1,0,2,2,-3,5,2,-12,13,1,0,1,1,0,-16,3,2,-5,3,-5,0,0,-1,1,-1,-1,4,-1
KR_6750394773,420,-5,-73,1,-6,-5,5,0,-1,4,3,1,0,1,0,1,1,-1,1,0,0,-2,1,2,-5,3,0,0,-2,-1,1,-1,1,2,-1
KR_6690920650,420,-1,-11,-16,-3,1,0,1,-1,1,0,-6,6,0,0,3,3,3,0,3,0,-7,153,3,-9,6,-5,0,0,1,-1,-1,-1,5,-1
KR_6761115373,420,-2,-33,-2,-8,1,1,2,-3,4,1,-2,5,3,-2,3,1,-2,4,2,0,-8,0,1,-8,7,-1,0,1,-1,1,1,1,2,-1
KR_6765913013,440,-4,-65,-32,-9,-3,5,2,1,4,5,-10,11,1,5,3,8,-2,5,3,-1,-7,4,0,-3,3,4,0,0,0,-1,-1,-1,0,-1
KR_6694567420,420,-1,-41,-12,-8,-1,3,2,-1,3,2,1,0,1,-6,7,1,-1,1,0,-1,-5,37,-2,-5,7,-4,0,0,-1,1,0,-1,6,-1
KR_6758545066,420,-1,-7,17,0,1,1,2,0,1,1,4,0,4,-4,5,1,-1,3,2,0,-3,8,-7,-3,10,7,0,-1,-1,1,-1,-1,1,-1
KR_6693898069,420,0,-32,4,-4,1,2,3,2,3,5,-5,7,2,-3,3,0,1,0,1,0,2,9,0,-5,5,-5,0,0,-1,-1,-1,1,6,-1
KR_6754354525,420,-3,-25,-4,-9,3,0,3,-4,5,1,-3,4,1,-5,5,0,0,0,0,0,-11,0,-3,-3,6,-1,0,0,-1,1,0,1,2,-1
KR_6754400759,420,-3,-54,-20,-3,0,4,4,-4,5,1,0,3,3,-2,5,3,3,0,3,0,-5,-12,-6,-4,10,1,0,-3,1,1,1,-1,5,-1
KR_6770653529,420,-2,-62,-7,-9,-5,5,0,-4,6,2,5,2,7,-4,4,0,-1,1,0,0,-7,1,0,-4,4,-3,0,-1,-1,-1,-1,-1,3,-1
KR_6760606364,420,-1,-2,-16,1,-3,4,1,1,0,1,-1,7,6,4,3,7,0,2,2,0,5,53,1,-6,5,-15,0,-1,0,0,-1,-1,0,-1
KR_6766237869,440,1,53,2,1,-1,2,1,-6,6,0,2,1,3,-3,4,1,9,0,9,0,-1,-3,-6,-1,7,0,0,1,-1,1,1,-1,1,-1
KR_6751915418,420,-2,-18,9,0,2,2,4,3,1,4,-2,3,1,-4,5,1,1,1,2,1,-7,5,-2,-6,8,-6,0,0,-1,1,0,1,4,-1
KR_6747448970,420,-3,-88,-35,-6,-1,2,1,-4,5,1,-3,3,0,2,4,6,0,0,0,0,-3,20,-2,-3,5,-4,0,0,-1,1,0,-1,4,-1
KR_6754537913,420,-1,-53,6,-4,-6,7,1,2,2,4,-3,6,3,1,3,4,2,1,3,0,3,-6,1,-6,5,-2,0,0,0,0,-1,-1,0,-1
KR_6680210018,420,-3,-71,-25,-1,-1,2,1,0,3,3,-2,2,0,2,1,3,0,0,0,0,0,-33,0,-8,8,29,0,0,-1,1,-1,-1,4,-1
KR_6672935766,440,6,54,16,14,2,0,2,2,6,8,6,1,7,1,1,2,3,1,4,1,16,-3,2,-5,3,3,0,1,1,0,1,1,1,-1
KR_6670779912,440,1,53,-1,5,11,0,11,-2,6,4,-2,5,3,-3,4,1,1,0,1,-1,-2,-49,-2,-5,7,6,0,1,-1,1,1,-1,2,-1
KR_6724122699,420,-2,-6,0,-8,0,3,3,-2,3,1,-4,5,1,-1,7,6,-1,2,1,-1,-12,1,0,-3,3,-2,0,-1,-1,1,-1,-1,3,-1
KR_6760257335,420,-1,-42,-8,-3,-4,5,1,3,0,3,1,4,5,-2,6,4,-1,3,2,0,5,242,-3,-3,6,2,0,-1,1,-1,-1,-1,3,-1
KR_6768858433,420,-2,-2,-27,-3,0,1,1,-4,4,0,3,0,3,1,1,2,-3,3,0,0,-10,12,4,-8,4,-4,0,0,1,-1,0,-1,2,-1
KR_6725808365,420,2,13,3,3,-3,5,2,-2,2,0,3,1,4,7,0,7,-2,2,0,0,7,-11,-1,-5,6,0,0,1,1,-1,-1,-1,2,-1
KR_6767165789,420,-1,-82,6,-3,1,1,2,-2,4,2,1,2,3,-1,4,3,-2,3,1,0,-3,1,1,-5,4,-2,0,0,-1,1,0,-1,5,-1
KR_6730681540,420,1,-18,0,5,0,4,4,0,3,3,3,1,4,2,1,3,0,2,2,0,3,0,2,-5,3,2,0,-1,1,-1,-1,-1,3,-1
KR_6717190525,420,1,22,0,-3,-1,2,1,-2,3,1,1,1,2,-2,2,0,1,0,1,0,-3,2,2,-6,4,0,0,0,-1,0,1,-1,1,-1
KR_6768654951,420,3,-31,4,6,-3,4,1,5,1,6,0,2,2,2,0,2,2,0,2,0,10,-41,2,-9,7,20,0,0,-1,1,0,-1,5,-1
KR_6729670303,420,-1,-11,4,-8,-1,3,2,-4,7,3,-6,6,0,2,2,4,1,2,3,0,-14,11,1,-6,5,-1,0,0,-1,1,1,-1,4,-1
KR_6760162264,420,0,-34,37,5,-3,3,0,4,0,4,3,1,4,2,1,3,-1,1,0,0,10,5,0,-6,6,-2,0,-1,1,-1,-1,1,1,-1
KR_6764828809,440,-1,-61,-24,-1,-4,5,1,-4,4,0,9,3,12,-1,3,2,-1,2,1,0,1,-1,-1,-1,2,1,0,-1,0,-1,-1,1,0,-1
KR_6759525972,420,-5,-50,-12,-6,0,1,1,-5,7,2,0,1,1,0,2,2,-1,2,1,0,-10,4,0,-7,7,-2,0,-1,-1,-1,-1,-1,1,-1
KR_6706683068,420,-1,34,-33,1,-4,4,0,2,1,3,1,1,2,1,7,8,1,1,2,1,5,17,-4,-5,9,-4,0,-1,-1,-1,-1,1,2,-1
KR_6764559890,420,-4,-10,28,-16,-3,4,1,-3,4,1,-6,8,2,-3,4,1,-1,1,0,0,-14,-5,-5,-2,7,-3,0,-2,0,-1,-1,-1,0,-1
KR_6759375209,420,-2,30,-25,-12,-4,4,0,-7,7,0,-3,4,1,3,4,7,-1,1,0,-1,-9,-9,-1,-5,6,1,0,0,-1,1,0,-1,1,-1
KR_6759209100,420,-5,-60,-40,-2,2,1,3,-3,9,6,2,3,5,-3,9,6,0,0,0,-1,-6,-24,3,-9,6,0,0,0,1,-1,-1,-1,3,-1
KR_6714098525,420,-3,-78,-28,-4,0,2,2,-1,3,2,-1,1,0,-2,2,0,0,0,0,0,-7,116,-2,-4,6,2,0,0,-1,1,1,-1,6,-1
KR_6755603156,420,-5,-52,-4,-10,1,2,3,-2,4,2,0,2,2,-5,6,1,-4,5,1,0,-13,0,1,-5,4,-3,0,-1,0,1,-1,-1,0,-1
KR_6757915429,440,-2,30,14,-9,1,2,3,-6,8,2,2,0,2,1,5,6,-7,10,3,-1,-9,-8,-1,-2,3,-5,0,1,0,1,1,-1,0,-1
KR_6770790682,420,3,30,14,-2,0,0,0,0,2,2,-2,3,1,0,1,1,0,0,0,0,0,5,0,-5,5,-5,0,-1,-1,1,1,-1,3,-1
KR_6725088961,420,-5,-43,10,-15,-2,3,1,-7,7,0,-2,6,4,-2,4,2,-2,2,0,-4,-20,-2,-1,-4,5,-3,0,-3,-1,1,-1,-1,6,-1
KR_6693682380,420,-5,-17,-23,-14,-2,3,1,-3,4,1,-3,4,1,-3,4,1,-3,3,0,0,-12,-17,-5,-3,8,2,0,-1,-1,-1,-1,-1,2,-1
KR_6752959199,420,1,-60,0,7,-1,1,0,1,1,2,1,2,3,4,1,5,2,0,2,1,10,7,2,-7,5,4,0,-3,1,-1,-1,1,2,-1
KR_6768738869,420,0,-70,5,-2,1,0,1,-4,6,2,4,1,5,-3,4,1,0,0,0,0,-8,22,2,-7,5,-2,0,-1,1,-1,-1,-1,4,-1
KR_6738480340,420,-6,-111,-16,-8,-1,2,1,-1,2,1,1,0,1,-6,6,0,-1,1,0,0,-6,-7,-1,-4,5,2,0,-1,-1,1,-1,-1,1,-1
KR_6761363239,420,-3,-33,-23,-6,-5,5,0,2,4,6,-4,5,1,-2,4,2,3,0,3,-2,-4,104,7,-9,2,1,0,0,-1,1,-1,-1,5,-1
KR_6710513004,420,-2,-12,15,-7,2,2,4,-2,4,2,-4,4,0,-4,4,0,1,0,1,0,-19,-12,-6,-6,12,-1,0,1,1,-1,1,1,3,-1
KR_6704655056,420,-4,-25,-39,-14,-1,2,1,1,2,3,-7,8,1,-5,7,2,-2,4,2,-1,-6,-1,-3,-4,7,0,0,-2,-1,-1,-1,-1,1,-1
KR_6761061971,420,-1,-4,14,-1,1,2,3,1,3,4,1,0,1,-2,5,3,-2,5,3,0,5,-1,1,-4,3,-1,0,0,-1,0,-1,1,3,-1
KR_6749194200,440,0,-43,15,2,2,1,3,-3,5,2,1,1,2,-1,4,3,3,1,4,0,-4,6,-1,-4,5,-1,0,1,1,0,1,1,3,-1
KR_6770562879,420,0,-29,-1,4,1,1,2,1,2,3,1,2,3,0,2,2,1,0,1,0,7,6,3,-8,5,-1,0,0,-1,1,-1,1,3,-1
KR_6640855644,420,-4,-12,-34,-11,-2,3,1,-3,5,2,-3,4,1,-1,4,3,-2,2,0,0,-6,-32,1,-7,6,-4,0,0,-1,1,0,1,1,-1
KR_6722496192,420,0,35,13,-2,1,1,2,2,1,3,-1,3,2,-6,10,4,2,0,2,0,-3,15,4,-7,3,-8,0,0,0,-1,1,-1,0,-1
KR_6769523815,420,-1,-16,26,-8,-4,5,1,2,3,5,0,4,4,-3,4,1,-3,3,0,0,-5,-8,-3,-1,4,-3,0,-1,-1,-1,-1,1,4,-1
KR_6751033978,420,-1,-28,28,-7,1,0,1,-2,2,0,-5,6,1,0,3,3,-1,1,0,0,-7,-7,-2,-3,5,2,0,1,1,-1,1,-1,1,-1
KR_6765481891,440,-2,43,-21,3,4,0,4,-1,4,3,-1,1,0,1,1,2,0,1,1,0,2,-14,2,-7,5,6,0,0,1,1,1,1,2,-1
KR_6761802381,420,0,48,-12,-1,-3,4,1,-3,5,2,1,4,5,1,2,3,3,0,3,1,-4,21,0,-3,3,-2,0,-2,1,1,-1,1,6,-1
KR_6753733024,420,-4,-40,-8,-10,-2,2,0,0,2,2,-8,9,1,0,0,0,0,0,0,0,-11,5,-2,-4,6,1,0,-1,-1,-1,-1,-1,6,-1
KR_6649930766,420,-7,-87,-10,-15,-3,3,0,-13,14,1,-2,3,1,1,1,2,2,0,2,0,-22,3,5,-10,5,-3,0,-4,-1,-1,-1,-1,6,-1
KR_6755618590,420,-4,-79,-15,-8,0,2,2,3,0,3,-6,6,0,-5,7,2,0,1,1,0,-6,-17,-9,-1,10,3,0,-1,-1,-1,-1,-1,5,-1
KR_6705154980,420,-3,-42,15,-3,2,1,3,-1,1,0,-3,7,4,0,4,4,-1,1,0,0,0,7,3,-5,2,0,0,-1,-1,1,1,1,4,-1
KR_6715780822,420,-4,-59,0,-9,0,1,1,-2,6,4,-1,4,3,-7,9,2,1,0,1,1,-5,-13,0,-4,4,-3,0,-2,1,-1,-1,1,1,-1
KR_6740709414,420,-3,-48,-4,-8,-7,7,0,0,1,1,1,2,3,-1,4,3,-1,1,0,0,-3,18,1,-5,4,-5,0,-2,-1,-1,-1,-1,6,-1
KR_6756618542,420,1,31,15,0,1,1,2,-3,3,0,1,2,3,0,0,0,1,1,2,0,-5,0,4,-9,5,1,0,0,-1,1,0,-1,1,-1
KR_6767508594,420,-3,16,4,-3,-1,1,0,-1,2,1,-2,4,2,0,2,2,1,0,1,0,-3,-123,-3,-4,7,-3,0,-1,-1,-1,-1,1,4,-1
KR_6757854847,440,-7,-53,17,-15,-8,8,0,0,1,1,-4,4,0,-1,4,3,-2,4,2,0,-6,-5,-3,-4,7,1,0,-1,-1,-1,-1,-1,3,-1
KR_6769744215,420,-1,1,-31,-6,-3,4,1,2,4,6,0,1,1,-4,5,1,-1,1,0,-1,-7,3,4,-9,5,-2,0,2,1,1,1,-1,2,-1
KR_6715311260,420,-4,-83,-24,-5,2,0,2,0,1,1,-5,5,0,-2,3,1,0,1,1,0,-7,-1,-2,-3,5,1,0,-2,-1,-1,-1,1,4,-1
KR_6738203348,420,-3,-26,-1,-8,1,1,2,-3,4,1,-3,5,2,-3,4,1,0,0,0,0,-8,-33,-5,-3,8,4,0,-5,-1,-1,-1,-1,2,-1
KR_6763043236,440,-1,-37,-8,3,1,0,1,0,4,4,5,0,5,-4,4,0,1,0,1,0,9,165,1,-8,7,16,0,0,-1,1,0,-1,6,-1
KR_6751545259,420,1,-30,0,-4,-3,4,1,5,5,10,-1,2,1,-5,6,1,0,0,0,0,-4,7,4,-7,3,-3,0,0,-1,-1,0,1,6,-1
KR_6742812933,420,-2,-10,-22,-4,2,3,5,-6,7,1,-1,1,0,1,2,3,0,0,0,0,-9,-2,0,-4,4,1,0,0,-1,1,0,1,3,-1
KR_6759340683,420,1,18,13,5,0,1,1,1,1,2,3,0,3,1,2,3,0,3,3,0,5,34,-4,-6,10,3,0,0,-1,-1,0,1,1,-1
KR_6723904208,420,-3,-53,-8,-13,1,1,2,-1,5,4,-5,5,0,-10,11,1,2,1,3,-3,-18,-12,-4,-7,11,-1,0,-2,-1,-1,-1,-1,6,-1
KR_6757616068,420,0,-38,-4,-2,0,1,1,-1,3,2,0,0,0,0,6,6,-1,1,0,0,-3,4,0,-7,7,1,0,0,1,1,0,1,4,-1
KR_6692520756,420,-2,18,12,-2,0,0,0,-4,8,4,-4,5,1,5,0,5,1,1,2,0,-10,-6,-2,-6,8,-6,0,0,1,-1,-1,-1,4,-1
KR_6768305571,420,1,20,-10,-1,2,0,2,1,1,2,2,2,4,-5,6,1,-1,1,0,0,-9,-3,2,-7,5,-2,0,1,-1,1,1,1,4,-1
KR_6768434571,420,-1,-48,22,-3,2,0,2,-1,5,4,-1,2,1,-1,4,3,-2,2,0,0,-5,3,4,-7,3,-3,0,-1,1,1,-1,-1,3,-1
KR_6734858472,420,-4,0,-4,-11,0,4,4,-3,3,0,-5,7,2,-3,5,2,0,1,1,0,-11,3,0,-5,5,3,0,2,-1,1,1,1,2,-1
KR_6723128993,420,0,9,0,3,5,1,6,1,1,2,0,3,3,-1,1,0,-2,4,2,0,0,6,5,-5,0,-2,0,0,-1,0,1,1,2,-1
KR_6762170669,420,2,94,0,2,-2,3,1,3,1,4,2,1,3,-1,3,2,0,1,1,0,1,117,1,-6,5,-2,0,1,1,1,1,-1,2,-1
KR_6729927644,420,-2,-34,-22,-2,-1,1,0,-2,3,1,-1,3,2,1,1,2,1,0,1,0,4,1,-3,-2,5,-3,0,0,1,-1,0,1,1,-1
KR_6692220798,420,2,83,-12,2,3,0,3,4,1,5,-7,10,3,5,1,6,-3,3,0,2,8,11,3,-7,4,1,0,1,1,1,1,1,6,-1
KR_6687369096,420,-3,-27,-28,-2,0,1,1,3,2,5,3,1,4,-6,6,0,-2,2,0,0,0,89,0,-2,2,2,0,-2,1,-1,-1,-1,3,-1
KR_6750298528,440,2,14,0,5,-1,1,0,3,0,3,9,3,12,-4,5,1,-2,3,1,0,-2,-2,-2,-2,4,-2,0,0,-1,0,0,-1,3,-1
KR_6764587729,420,-2,-97,9,-4,-1,2,1,0,2,2,3,1,4,-3,4,1,-3,3,0,0,1,113,4,-7,3,3,0,-1,-1,-1,-1,-1,1,-1
KR_6661703508,420,-6,-102,-13,-13,-3,5,2,-1,4,3,-5,5,0,-3,3,0,-1,1,0,0,-4,-1,-2,-4,6,-5,0,-1,1,-1,-1,-1,5,-1
KR_6679999984,420,-1,16,-20,-3,-4,4,0,4,1,5,2,0,2,-4,4,0,-1,3,2,0,-5,6,1,-3,2,-3,0,0,-1,1,-1,-1,6,-1
KR_6737934962,420,4,65,11,8,9,0,9,-2,6,4,3,3,6,2,0,2,-4,4,0,0,5,-110,-1,-4,5,2,0,1,1,1,1,1,5,-1
KR_6674936619,420,3,29,-16,2,-2,3,1,2,1,3,-1,1,0,3,1,4,0,1,1,0,6,-2,-2,-2,4,2,0,0,-1,-1,0,1,6,-1
KR_6757039859,420,1,-20,-7,2,2,1,3,-1,2,1,2,1,3,0,6,6,-1,2,1,-1,-6,-39,-5,-4,9,5,0,0,1,-1,0,-1,5,-1
KR_6767101858,420,0,-41,9,-5,4,1,5,1,1,2,-3,6,3,-3,5,2,-4,4,0,-1,-3,4,0,-4,4,0,0,-1,1,1,-1,-1,5,-1
KR_6742250338,420,0,13,28,2,3,2,5,2,1,3,-4,7,3,3,3,6,-2,4,2,0,-3,-5,3,-9,6,1,0,1,1,1,1,-1,6,-1
KR_6758291903,420,0,-32,19,-4,-1,3,2,-1,2,1,-3,3,0,2,0,2,-1,1,0,0,-12,102,-4,-1,5,-2,0,-1,-1,-1,-1,-1,6,-1
KR_6765559134,420,2,-62,-15,2,6,0,6,-2,2,0,-6,7,1,3,2,5,1,0,1,0,2,7,5,-8,3,-2,0,0,1,-1,-1,1,5,-1
KR_6726379553,420,-6,-53,-36,-12,-5,5,0,2,1,3,-6,6,0,-3,4,1,0,2,2,0,-11,-4,4,-6,2,2,0,-2,-1,-1,-1,-1,5,-1
KR_6763016758,440,3,94,0,5,0,0,0,0,4,4,3,1,4,4,2,6,-2,4,2,0,1,-8,0,-5,5,-2,0,0,0,0,1,1,0,-1
KR_6770667062,420,-1,15,2,-4,1,2,3,-1,3,2,-1,3,2,1,2,3,-4,4,0,0,-10,5,3,-6,3,-2,0,0,-1,1,1,1,4,-1
KR_6764369550,420,-6,-103,-23,-9,0,4,4,-3,5,2,-1,1,0,-1,2,1,-4,4,0,0,-9,-5,-7,0,7,-2,0,-2,-1,1,1,1,6,-1
KR_6762799714,420,-2,-19,-9,-1,-1,1,0,-1,1,0,5,0,5,-2,3,1,-2,3,1,0,-3,2,4,-6,2,-7,0,0,1,0,0,1,1,-1
KR_6764713941,420,0,-23,-5,3,-3,4,1,1,2,3,1,4,5,4,1,5,0,2,2,1,9,-1,2,-5,3,-2,0,-1,1,-1,-1,1,1,-1
KR_6766978281,420,-1,1,-27,-7,3,0,3,-3,6,3,-4,5,1,-2,8,6,-1,1,0,0,-13,7,-3,-5,8,-2,0,-1,-1,1,-1,-1,3,-1
KR_6763498924,420,-2,-65,-11,-5,1,0,1,0,3,3,-5,5,0,-2,4,2,1,2,3,1,2,3,3,-8,5,0,0,1,-1,1,1,1,6,-1
KR_6714805053,420,-3,-16,-8,-10,0,3,3,-1,2,1,-6,8,2,-4,5,1,1,2,3,0,-13,-1,-1,-3,4,-2,0,-1,1,-1,-1,1,6,-1
KR_6756462571,420,-2,-70,-8,-4,-2,3,1,2,1,3,4,1,5,-6,8,2,-2,2,0,0,-4,1,-1,-4,5,-4,0,0,1,-1,-1,-1,4,-1
KR_6764340027,420,-4,-60,0,-11,0,1,1,-3,5,2,-6,6,0,-3,4,1,1,1,2,0,-8,-5,-2,-3,5,-1,0,-2,1,-1,-1,-1,6,-1
KR_6713405804,420,-4,-5,-51,-8,-4,7,3,-4,6,2,2,5,7,0,1,1,-2,2,0,0,-4,-14,1,-3,2,-3,0,-2,-1,-1,-1,-1,6,-1
KR_6730306481,420,0,-12,-8,-1,-1,1,0,3,2,5,-2,3,1,-1,4,3,0,2,2,-1,10,0,-1,-5,6,-2,0,1,1,-1,-1,-1,1,-1
KR_6746363491,440,2,-31,24,5,0,1,1,-1,4,3,-2,3,1,7,1,8,1,2,3,0,4,-5,0,-5,5,-2,0,-1,1,1,-1,-1,6,-1
KR_6728803370,420,0,-4,0,-3,-2,5,3,-4,6,2,0,0,0,3,3,6,0,1,1,1,0,-5,-5,-6,11,3,0,1,-1,1,1,1,6,-1
KR_6746983077,420,2,-31,-22,7,-2,6,4,-1,4,3,6,0,6,3,1,4,1,2,3,1,10,2,2,-6,4,3,0,0,1,-1,1,1,3,-1
KR_6762788684,440,-2,-91,-25,3,0,5,5,-4,5,1,4,0,4,0,0,0,3,1,4,0,16,-1,2,-7,5,3,0,-2,-1,-1,-1,1,6,-1
KR_6723501626,420,1,-16,12,1,2,2,4,0,4,4,-5,5,0,2,2,4,2,1,3,0,1,-14,-4,-4,8,1,0,0,-1,1,0,1,1,-1
KR_6764124663,420,-2,-21,7,-8,-4,5,1,-2,6,4,-2,5,3,-1,5,4,1,1,2,-3,-21,-4,-3,-2,5,2,0,0,-1,1,0,-1,4,-1
KR_6682756053,420,-5,40,-24,-12,1,1,2,-2,4,2,-4,4,0,-4,5,1,-3,3,0,0,-12,0,-3,-1,4,-2,0,0,-1,1,1,-1,4,-1
KR_6765231071,420,0,-21,4,-2,-2,4,2,-1,5,4,0,4,4,0,1,1,1,0,1,0,2,4,7,-9,2,-5,0,1,1,1,-1,-1,4,-1
KR_6768418195,440,1,47,-21,1,-1,1,0,1,2,3,3,2,5,-2,2,0,0,0,0,0,1,-16,2,-7,5,3,0,1,1,-1,1,-1,1,-1
KR_6745175565,420,0,48,-19,-8,0,3,3,2,1,3,-8,11,3,-3,6,3,1,0,1,-1,-5,0,-2,-6,8,-2,0,0,-1,-1,1,-1,3,-1
KR_6665214779,420,-1,-64,-5,-7,-4,4,0,1,1,2,-1,2,1,-3,7,4,0,0,0,0,-2,2,-2,-5,7,3,0,-1,1,1,-1,-1,6,-1
KR_6755363803,420,-1,-23,13,-3,-5,5,0,0,1,1,2,3,5,0,1,1,0,1,1,0,2,9,1,-7,6,-6,0,-1,-1,-1,-1,1,4,-1
KR_6755658532,440,1,-50,-15,0,0,3,3,-4,4,0,3,0,3,1,1,2,0,1,1,0,6,-1,3,-6,3,1,0,0,1,1,-1,-1,6,-1
KR_6765370791,420,0,-17,26,-11,-4,5,1,-2,3,1,-1,1,0,-1,5,4,-3,5,2,0,-12,6,2,-6,4,-8,0,-2,-1,1,-1,-1,2,-1
KR_6746542086,420,-2,-12,8,-6,1,0,1,2,0,2,1,2,3,-8,9,1,-2,3,1,0,-5,-1,1,-6,5,6,0,0,-1,-1,-1,1,6,-1
KR_6756166232,420,-1,-31,-2,-4,3,1,4,-1,4,3,-2,3,1,-2,4,2,-2,2,0,0,-2,3,-1,-3,4,1,0,1,1,-1,1,1,2,-1
KR_6725662749,420,-2,-47,-17,-4,-4,5,1,-3,4,1,6,0,6,-3,4,1,0,2,2,0,-7,186,2,-7,5,-4,0,-1,-1,1,-1,-1,2,-1
KR_6759666418,440,-5,-5,-39,-9,0,3,3,-3,5,2,0,2,2,-6,8,2,0,0,0,0,-8,47,1,-9,8,-26,0,0,-1,0,0,1,5,-1
KR_6698060308,420,-2,-9,-9,-9,1,0,1,-1,3,2,-5,5,0,-4,5,1,0,1,1,0,-14,-8,-3,-6,9,1,0,0,-1,-1,-1,-1,5,-1
KR_6740309053,420,-2,-37,0,-7,0,2,2,-2,2,0,-3,7,4,-3,3,0,1,0,1,-2,-14,-14,-1,-4,5,0,0,-1,-1,-1,-1,-1,6,-1
KR_6672904491,420,-1,-4,13,-2,-2,2,0,-4,9,5,2,0,2,1,1,2,1,0,1,0,2,2,-1,-3,4,-1,0,0,-1,1,0,-1,1,-1
KR_6604475960,420,-2,-7,8,3,-6,9,3,-1,3,2,4,0,4,6,6,12,0,2,2,0,-4,3,3,-7,4,0,0,0,1,1,-1,1,5,-1
KR_6610933037,420,-4,-69,8,-12,-4,5,1,-2,3,1,0,2,2,-4,4,0,-2,2,0,0,-8,-5,-7,-1,8,4,0,-1,-1,-1,-1,-1,4,-1
KR_6770666169,420,-8,-88,-35,-14,-4,4,0,-3,6,3,0,1,1,-5,5,0,-2,2,0,0,-11,5,-1,-5,6,-6,0,0,-1,1,-1,-1,4,-1
KR_6763449966,420,-1,-20,7,0,-1,2,1,2,3,5,-2,7,5,-1,2,1,2,1,3,0,9,-19,5,-9,4,-2,0,-1,-1,1,-1,-1,3,-1
KR_6755378442,420,1,-28,-17,0,3,0,3,1,0,1,1,5,6,-3,4,1,-2,2,0,0,7,73,-7,0,7,-24,0,0,-1,-1,-1,1,4,-1
KR_6761468589,420,-1,-27,0,0,-2,2,0,-5,6,1,3,2,5,5,3,8,-1,1,0,0,-4,7,-3,-3,6,-1,0,0,1,-1,-1,-1,2,-1
KR_6748411242,420,-4,-27,5,1,-2,4,2,2,1,3,0,4,4,-1,1,0,2,1,3,0,6,6,5,-7,2,-3,0,0,-1,1,1,1,4,-1
KR_6765168053,420,1,1,-12,4,-2,3,1,1,2,3,2,3,5,2,1,3,1,1,2,0,12,7,2,-6,4,-1,0,-1,1,1,-1,-1,2,-1
KR_6750814549,420,-2,-43,3,-4,3,0,3,2,2,4,-2,4,2,-6,6,0,-1,1,0,-1,-4,-2,-4,-3,7,4,0,0,-1,-1,0,-1,6,-1
KR_6765604774,420,-2,-46,-24,-7,-2,3,1,2,1,3,-6,6,0,-1,5,4,0,0,0,0,-2,6,0,-6,6,-3,0,-2,-1,-1,-1,-1,2,-1
KR_6732011569,440,-4,-17,-8,-1,-4,5,1,8,0,8,1,0,1,-4,5,1,-2,3,1,0,0,14,-1,-2,3,-1,0,-1,-1,1,-1,-1,6,-1
KR_6724973037,420,0,22,-8,2,2,0,2,-1,3,2,0,2,2,2,0,2,-1,2,1,0,1,6,2,-6,4,2,0,0,1,-1,-1,-1,1,-1
KR_6768530576,440,0,-41,-12,-7,0,0,0,0,2,2,1,0,1,-9,9,0,1,2,3,0,-10,477,-6,-4,10,-2,0,0,-1,-1,-1,-1,4,-1
KR_6760373999,420,0,-81,1,-2,-1,4,3,1,3,4,2,1,3,-4,7,3,0,1,1,0,3,-1,-2,-7,9,2,0,-2,-1,-1,-1,1,1,-1
KR_6616433610,420,-4,-102,-15,-9,-7,8,1,0,4,4,1,1,2,-3,3,0,0,0,0,-1,-6,23,-2,-1,3,-13,0,-3,-1,1,-1,-1,2,-1
KR_6743653304,440,-3,2,-14,-3,1,2,3,-3,5,2,-1,2,1,-1,4,3,1,1,2,0,-5,-8,-2,-3,5,-1,0,1,-1,1,1,1,1,-1
KR_6752340332,420,-1,-17,4,-1,0,2,2,0,2,2,2,0,2,-1,3,2,-2,2,0,0,0,16,1,-4,3,-3,0,1,1,-1,1,1,3,-1
KR_6750336959,420,-1,-35,10,0,-2,2,0,4,0,4,-2,5,3,0,2,2,0,1,1,2,10,-1,-1,-5,6,6,0,0,1,1,1,1,6,-1
KR_6711204492,420,2,75,12,1,-1,1,0,0,2,2,-2,3,1,1,4,5,3,0,3,0,0,-7,4,-6,2,2,0,0,-1,-1,-1,-1,5,-1
KR_6677109341,420,-1,-37,8,-2,1,3,4,-1,4,3,1,4,5,-2,3,1,-1,1,0,0,-5,-3,-1,-7,8,-5,0,0,-1,1,0,1,4,-1
KR_6762756603,420,-3,-2,-17,1,2,0,2,0,1,1,1,3,4,-1,1,0,-1,3,2,0,3,-6,1,-4,3,1,0,0,1,0,0,-1,2,-1
KR_6682231613,420,-3,-79,1,1,-1,3,2,-2,4,2,2,2,4,2,1,3,0,0,0,1,4,-2,2,-6,4,0,0,0,-1,-1,1,1,2,-1
KR_6770369684,420,-1,-20,9,1,1,3,4,0,5,5,6,2,8,-8,11,3,2,1,3,-2,6,12,3,-7,4,-4,0,0,0,1,0,-1,0,-1
KR_6755597852,420,-4,11,8,-9,0,1,1,0,5,5,-4,4,0,1,2,3,-6,6,0,0,-3,103,5,-8,3,0,0,0,-1,-1,-1,-1,2,-1
KR_6703685602,420,-1,22,19,-7,1,2,3,1,1,2,-8,12,4,-2,4,2,1,1,2,0,-11,2,3,-4,1,0,0,0,-1,-1,-1,-1,6,-1
KR_6752773126,420,-3,4,-27,-8,-2,2,0,-1,3,2,-1,1,0,-3,5,2,-1,2,1,0,-12,1,1,-7,6,-2,0,0,-1,-1,0,1,5,-1
KR_6710665016,420,-4,-66,-8,-14,-1,3,2,-4,8,4,-4,5,1,-4,5,1,-1,4,3,1,-7,-1,-2,-4,6,0,0,-1,-1,-1,-1,1,6,-1
KR_6425871859,440,1,68,12,-3,0,0,0,-4,6,2,1,2,3,-4,6,2,4,1,5,0,-7,-2,-5,-6,11,3,0,0,-1,1,1,-1,6,-1
KR_6770588203,420,-1,-24,4,-3,-1,2,1,2,4,6,-4,4,0,-1,2,1,1,0,1,0,-1,9,-3,-4,7,3,0,0,-1,1,0,-1,3,-1
KR_6722069597,420,-2,-22,4,0,3,1,4,2,2,4,1,3,4,-6,6,0,0,1,1,1,5,-2,-5,-4,9,4,0,0,-1,1,1,-1,4,-1
KR_6762373648,420,0,-21,16,-3,1,1,2,-3,7,4,-2,2,0,1,7,8,0,2,2,-1,-4,0,-2,-7,9,0,0,-2,1,-1,-1,-1,6,-1
KR_6723143144,420,1,12,-10,7,1,1,2,3,1,4,0,1,1,3,2,5,0,2,2,1,6,-42,4,-10,6,17,0,0,-1,1,0,1,4,-1
KR_6746379712,420,2,-10,7,9,3,0,3,2,1,3,2,3,5,-1,6,5,3,0,3,0,14,-10,-1,-7,8,-2,0,0,1,1,1,-1,3,-1
KR_6770128939,420,1,-50,20,2,1,1,2,-2,7,5,3,0,3,-2,2,0,2,2,4,0,-4,21,3,-6,3,-1,0,-2,-1,-1,-1,-1,4,-1
KR_6627668555,420,1,47,20,0,4,1,5,5,0,5,-9,10,1,0,2,2,0,1,1,0,-7,0,0,-5,5,1,0,-1,1,-1,-1,1,3,-1
KR_6770522146,420,1,27,-11,1,-1,2,1,-2,4,2,6,3,9,0,2,2,-2,3,1,1,-5,2,6,-8,2,1,0,0,1,1,1,1,2,-1
KR_6757617185,420,-1,-47,-4,-10,-3,5,2,3,2,5,-5,6,1,-5,6,1,0,1,1,-3,-12,15,-1,-5,6,1,0,-2,-1,1,-1,-1,3,-1
KR_6769853030,420,0,-40,-11,4,3,1,4,-2,7,5,2,0,2,1,1,2,0,1,1,0,7,27,1,-5,4,-3,0,1,-1,1,1,1,3,-1
KR_6760374354,440,1,25,-15,0,-3,3,0,-3,3,0,3,4,7,1,4,5,2,0,2,0,3,-24,0,-2,2,2,0,0,-1,-1,0,1,2,-1
KR_6761340127,420,-2,-37,9,-2,0,1,1,-2,3,1,2,2,4,-1,6,5,-1,3,2,0,-8,23,4,-7,3,2,0,0,1,1,0,1,4,-1
KR_6682700060,420,-3,-76,-8,-4,-5,5,0,2,1,3,3,2,5,-2,3,1,-2,2,0,0,-3,-2,-1,-2,3,-1,0,-1,-1,1,-1,-1,3,-1
KR_6737645138,420,-1,39,-12,-6,-6,6,0,1,4,5,0,2,2,-1,4,3,0,1,1,0,-4,65,4,-7,3,-34,0,0,-1,-1,-1,-1,1,-1
KR_6758032098,420,0,-58,8,-3,-2,4,2,-3,6,3,-3,4,1,3,2,5,2,0,2,0,2,-7,-5,-4,9,-3,0,-1,-1,-1,-1,-1,5,-1
KR_6765887611,440,1,-9,-16,2,1,0,1,2,2,4,-2,2,0,0,2,2,1,1,2,0,-3,-2,3,-5,2,-2,0,1,1,-1,1,1,2,-1
KR_6758931104,420,-4,-91,-22,-4,0,1,1,-2,6,4,-2,3,1,3,7,10,-3,3,0,-1,-9,205,3,-6,3,-2,0,0,-1,0,-1,-1,6,-1
KR_6765301068,420,-6,-88,-52,-10,2,2,4,-2,5,3,-1,2,1,-7,9,2,-2,3,1,-1,-8,-1,0,-8,8,0,0,-2,-1,-1,-1,-1,1,-1
KR_6764722688,420,-3,-41,-26,2,1,3,4,3,2,5,-3,3,0,0,3,3,1,0,1,0,6,-29,4,-9,5,1,0,-1,-1,1,1,-1,4,-1
KR_6737574608,420,-2,-3,8,-5,0,2,2,-4,5,1,0,3,3,-2,4,2,1,0,1,0,0,23,-4,-5,9,-2,0,0,-1,1,0,-1,3,-1
KR_6655912221,440,1,9,0,5,1,0,1,1,1,2,0,1,1,-4,6,2,7,3,10,0,0,-3,0,-6,6,0,0,-1,-1,1,-1,-1,1,-1
KR_6770161219,420,1,50,-34,3,1,0,1,-6,6,0,3,0,3,4,0,4,1,0,1,0,2,4,4,-6,2,-3,0,1,-1,-1,1,-1,5,-1
KR_6748105960,420,1,22,2,-1,0,2,2,0,3,3,3,0,3,-4,7,3,0,1,1,-1,-9,-9,-3,-6,9,2,0,0,-1,1,1,-1,5,-1
KR_6614589690,420,-2,-23,-15,-11,2,3,5,-5,8,3,-2,5,3,-6,8,2,0,0,0,0,-11,-5,-4,-5,9,2,0,-2,-1,-1,-1,-1,5,-1
KR_6768481897,420,2,9,35,3,4,0,4,0,3,3,0,0,0,-4,8,4,3,0,3,1,0,7,0,-7,7,-3,0,0,1,-1,-1,1,4,-1
KR_6725707914,420,-2,-34,-31,-2,2,0,2,0,4,4,-3,5,2,0,3,3,-1,4,3,2,2,10,0,-4,4,0,0,0,-1,1,1,1,4,-1
KR_6753577985,420,-1,-4,-3,-5,-5,6,1,5,1,6,-4,5,1,-1,4,3,0,1,1,-1,0,-29,-3,-5,8,1,0,-1,-1,1,-1,-1,5,-1
KR_6714344816,420,-1,-84,-28,-9,2,2,4,-4,4,0,-4,4,0,-3,3,0,0,3,3,-2,-19,-32,2,-7,5,25,0,-1,-1,-1,-1,-1,2,-1
KR_6768511032,420,-3,-8,8,-9,-1,2,1,-1,2,1,-2,3,1,-6,6,0,1,2,3,0,-7,-17,-1,-6,7,-2,0,-1,0,-1,-1,-1,0,-1
KR_6737684158,420,-6,-72,-52,-7,1,1,2,-1,2,1,-7,7,0,-2,3,1,2,2,4,0,-4,-13,-5,-5,10,-5,0,-1,-1,1,-1,1,2,-1
KR_6687392751,420,1,-5,28,9,2,2,4,5,2,7,-3,5,2,5,4,9,0,1,1,4,15,-48,-3,-4,7,14,0,0,-1,-1,1,1,5,-1
KR_6764247039,420,-4,-79,-3,-11,-1,3,2,0,1,1,0,0,0,-4,5,1,-6,9,3,-1,-2,-3,-7,-1,8,2,0,-3,1,-1,-1,-1,2,-1
KR_6760469087,420,1,14,-24,2,2,1,3,2,2,4,0,2,2,-3,3,0,1,0,1,0,0,-4,-4,-5,9,-8,0,-1,1,-1,-1,1,3,-1
KR_6722229318,420,-4,-31,-14,-10,0,0,0,-6,8,2,-5,6,1,1,2,3,0,1,1,0,-18,-3,-3,-2,5,0,0,0,-1,-1,0,-1,1,-1
KR_6653410432,420,1,34,14,0,0,4,4,-2,3,1,0,1,1,3,2,5,-1,1,0,0,1,0,0,-7,7,-1,0,2,-1,1,1,-1,2,-1
KR_6770450967,440,1,71,5,-8,-2,4,2,-5,9,4,2,0,2,-1,7,6,-2,3,1,1,-15,-139,-1,-4,5,-1,0,-2,-1,-1,-1,1,1,-1
KR_6507124532,440,1,65,-27,2,6,0,6,3,1,4,-5,6,1,-3,5,2,1,0,1,0,-5,224,1,-5,4,-3,0,2,1,-1,1,-1,3,-1
KR_6744660659,420,-2,-68,-24,-4,2,1,3,1,2,3,-2,2,0,-3,3,0,-2,2,0,0,-8,-37,-3,-6,9,2,0,-1,-1,-1,-1,1,2,-1
KR_6697727118,420,-1,-44,9,2,-3,4,1,6,4,10,2,3,5,-3,3,0,0,0,0,-1,1,-14,-5,-4,9,9,0,-1,0,1,-1,-1,0,-1
KR_6770647458,420,-5,10,-13,-9,-1,5,4,3,0,3,1,3,4,0,1,1,-12,14,2,-3,-12,247,-3,-5,8,-6,0,1,1,0,1,-1,3,-1
KR_6763154709,420,-4,-1,-25,-5,-1,2,1,0,4,4,0,2,2,-4,6,2,0,2,2,0,-10,4,1,-4,3,-8,0,0,-1,-1,-1,-1,1,-1
KR_6747424411,420,-6,9,-56,-4,1,0,1,0,2,2,-5,7,2,0,1,1,0,0,0,0,-7,3,-1,-9,10,-8,0,-1,-1,-1,-1,1,1,-1
KR_6734154612,420,-7,-54,-30,-11,-1,1,0,-5,5,0,-1,4,3,-3,8,5,-1,1,0,-1,-9,-7,2,-6,4,-5,0,0,-1,1,0,-1,6,-1
KR_6740322424,420,3,-26,10,4,-1,1,0,2,1,3,0,1,1,3,0,3,0,1,1,0,8,1,0,-5,5,-1,0,0,-1,1,0,1,3,-1
KR_6758277748,440,-1,-37,16,-1,0,2,2,1,2,3,-2,5,3,1,3,4,-1,3,2,-1,1,121,-3,-2,5,4,0,0,0,-1,0,-1,0,-1
KR_6718665831,420,-2,-44,5,-10,-1,3,2,0,1,1,0,1,1,-6,6,0,-3,3,0,0,-11,1,-2,-5,7,-7,0,0,-1,1,0,-1,3,-1
KR_6741842635,420,-2,-36,-51,-6,2,1,3,-1,1,0,-4,4,0,-2,3,1,-1,1,0,0,-9,2,-1,-6,7,-2,0,0,-1,1,-1,1,4,-1
KR_6692373296,420,-2,-46,-11,-4,-4,4,0,2,2,4,1,2,3,-3,3,0,0,0,0,0,-10,-3,2,-7,5,0,0,0,-1,1,0,1,5,-1
KR_6765623756,420,-1,18,9,4,4,1,5,-1,3,2,1,1,2,0,3,3,0,2,2,0,-1,3,2,-7,5,-4,0,-1,-1,1,-1,1,2,-1
KR_6769607983,420,-4,-70,-5,-15,0,1,1,1,2,3,-1,3,2,-12,12,0,-3,4,1,0,-15,-253,2,-6,4,-4,0,-2,-1,-1,-1,-1,6,-1
KR_6649615046,420,1,-21,35,3,-1,2,1,1,2,3,0,3,3,3,2,5,0,0,0,0,5,9,4,-6,2,0,0,-1,-1,-1,1,-1,4,-1
KR_6768389258,420,-2,-42,-13,-8,1,2,3,1,2,3,-5,5,0,-3,4,1,-2,2,0,1,-12,-7,2,-7,5,0,0,-1,-1,1,-1,1,2,-1
KR_6769088670,420,2,126,3,8,1,3,4,5,1,6,-4,5,1,4,2,6,2,0,2,2,5,-7,-4,-4,8,1,0,0,1,-1,-1,1,6,-1
KR_6762371990,420,-1,-31,-36,-1,0,2,2,1,4,5,1,3,4,1,4,5,-4,4,0,0,6,-5,-2,-2,4,2,0,-2,-1,-1,-1,-1,3,-1
KR_6761987314,420,-4,-64,-43,-1,-5,6,1,4,1,5,-1,2,1,0,3,3,1,0,1,0,4,22,4,-6,2,-4,0,-3,-1,1,-1,-1,4,-1
KR_6766033110,420,-1,-33,20,-7,-2,3,1,-1,5,4,4,0,4,-7,7,0,-1,1,0,0,-19,2,-2,-4,6,-1,0,-2,-1,-1,-1,1,3,-1
KR_6612192232,420,-7,-37,-30,-13,-4,5,1,-8,8,0,-1,2,1,0,2,2,0,0,0,0,-13,6,0,-3,3,0,0,-4,-1,-1,-1,1,6,-1
KR_6766601519,420,1,9,-4,2,2,1,3,-1,3,2,-4,5,1,5,0,5,0,0,0,0,11,155,3,-4,1,-3,0,-1,-1,1,-1,-1,2,-1
KR_6767848862,420,-3,-36,0,-8,1,0,1,-4,5,1,-5,6,1,-1,2,1,1,0,1,1,-8,-19,-6,-2,8,2,0,0,1,-1,0,1,4,-1
KR_6763051130,420,0,20,-32,0,-6,7,1,-1,2,1,3,0,3,4,0,4,0,1,1,0,11,149,1,-4,3,2,0,0,1,-1,1,-1,3,-1
KR_6767486234,420,-1,51,4,-2,-2,3,1,-2,4,2,-1,1,0,2,1,3,1,1,2,1,2,21,3,-9,6,-3,0,2,-1,1,1,1,4,-1
KR_6742676789,420,-1,-18,13,-1,0,0,0,2,1,3,4,0,4,-6,7,1,-1,1,0,0,4,0,4,-5,1,1,0,-1,-1,-1,-1,-1,1,-1
KR_6718522516,420,-3,-13,-8,-15,-2,2,0,-4,4,0,-5,7,2,-5,5,0,1,0,1,0,-24,0,-2,-5,7,-4,0,0,1,-1,0,-1,3,-1
KR_6678548594,420,-2,-33,-16,-8,-1,2,1,-1,3,2,0,2,2,-4,4,0,-2,2,0,-2,-14,-34,-6,-4,10,4,0,-1,-1,-1,-1,-1,1,-1
KR_6770190784,440,0,21,24,-4,5,1,6,-3,4,1,-1,2,1,-2,3,1,-3,4,1,0,-3,2,1,-7,6,1,0,-1,1,1,-1,1,5,-1
KR_6737157624,420,1,-27,2,6,0,2,2,3,0,3,-1,1,0,2,3,5,2,0,2,0,9,11,0,-4,4,-5,0,0,1,-1,-1,1,2,-1
KR_6765611778,440,-3,-82,-8,-8,-1,2,1,-2,2,0,-1,5,4,-3,9,6,-1,4,3,0,-8,9,3,-6,3,-7,0,-1,-1,1,-1,-1,1,-1
KR_6770435059,420,0,-27,-21,-1,4,2,6,-1,5,4,2,2,4,-5,9,4,-1,1,0,0,8,-8,2,-7,5,-1,0,0,-1,1,-1,-1,5,-1
KR_6614408849,420,-8,-224,-46,-17,-3,4,1,1,2,3,-6,6,0,-8,8,0,-1,2,1,-1,-10,4,-1,-2,3,1,-2,-5,-1,1,-1,-1,3,-1
KR_6768830094,420,0,-33,-24,3,0,3,3,-5,6,1,8,1,9,1,1,2,-1,1,0,0,8,-5,-1,-3,4,-2,0,-2,-1,-1,-1,-1,3,-1
KR_6751007807,420,-3,9,-12,-6,-2,3,1,0,2,2,0,1,1,-4,5,1,0,1,1,0,-6,0,2,-6,4,3,0,-1,1,-1,-1,-1,2,-1
KR_6678901059,420,-2,-25,-6,-6,0,2,2,1,0,1,-1,2,1,-5,6,1,-1,2,1,0,0,-2,0,-5,5,-2,0,-2,-1,-1,-1,1,1,-1
KR_6727191983,420,-2,7,9,-3,-4,5,1,-1,1,0,-2,3,1,4,0,4,0,1,1,0,3,-11,1,-6,5,2,0,1,1,-1,1,1,4,-1
KR_6736984045,420,0,6,8,1,1,1,2,-1,3,2,-1,3,2,1,2,3,1,0,1,0,2,3,0,-7,7,1,0,0,-1,1,0,1,2,-1
KR_6664561496,420,-2,-17,-16,-10,0,4,4,-2,3,1,-6,6,0,-1,3,2,-1,1,0,-2,-3,-10,-6,-5,11,3,0,-2,-1,-1,-1,-1,2,-1
KR_6749589618,420,-2,-75,-38,-16,4,1,5,0,2,2,-5,8,3,-10,11,1,-5,8,3,-1,-12,-1,-5,-4,9,-1,0,-3,-1,1,-1,-1,1,-1
KR_6755732262,420,-2,-24,-9,-6,1,2,3,-2,3,1,-4,4,0,-1,1,0,0,0,0,0,-12,-9,-3,-4,7,-17,0,-2,-1,-1,-1,1,1,-1
KR_6729729977,420,-1,-6,-13,5,-1,1,0,-1,4,3,0,0,0,4,1,5,3,0,3,0,5,-88,2,-7,5,7,0,0,1,-1,0,1,6,-1
KR_6712898236,420,0,4,-7,-2,-8,9,1,3,3,6,0,4,4,3,1,4,0,1,1,2,6,-3,0,-5,5,3,0,-1,-1,-1,-1,1,4,-1
KR_6683975546,420,1,60,-8,-2,-4,6,2,0,1,1,1,2,3,0,2,2,1,0,1,0,4,-1,3,-8,5,6,0,0,-1,-1,0,1,2,-1
KR_6574137130,420,-6,-82,-1,-10,-2,2,0,-1,3,2,-1,5,4,-4,7,3,-2,2,0,0,-5,-2,0,-5,5,1,0,0,-1,1,-1,-1,6,-1
KR_6746094259,420,-1,-20,-20,-1,-3,4,1,1,2,3,5,1,6,-4,7,3,0,3,3,-1,1,9,7,-8,1,0,0,-2,1,1,-1,-1,4,-1
KR_6766945647,420,0,45,-20,-3,-3,4,1,-1,4,3,1,0,1,-2,4,2,2,0,2,0,1,15,-1,-5,6,5,0,-1,-1,-1,-1,-1,2,-1
KR_6732997629,420,-2,-50,-16,-4,0,2,2,1,3,4,2,3,5,-3,4,1,-4,4,0,0,-7,-5,-2,-5,7,-2,0,-1,-1,1,-1,-1,3,-1
KR_6729255963,420,2,40,-15,3,4,0,4,1,5,6,-1,2,1,0,3,3,-1,1,0,0,3,-136,0,-8,8,-1,0,0,-1,1,1,1,3,-1
KR_6727665857,420,-3,-23,-12,-7,-1,1,0,-5,5,0,-1,5,4,0,2,2,0,2,2,0,-14,114,2,-8,6,-4,0,1,-1,1,1,1,3,-1
KR_6673096801,420,2,10,-17,6,0,2,2,3,1,4,6,0,6,-4,4,0,1,0,1,0,7,171,2,-5,3,4,0,1,1,-1,-1,1,4,-1
KR_6770254372,420,-3,22,-24,-5,-6,6,0,-2,5,3,0,1,1,3,0,3,0,1,1,0,-3,17,7,-10,3,-6,0,-1,-1,-1,-1,1,4,-1
KR_6654608800,420,-2,-13,20,-6,-2,2,0,-6,8,2,-1,2,1,1,3,4,2,1,3,0,-5,-3,-3,-5,8,-2,0,0,-1,1,0,1,4,-1
KR_6705851266,420,-3,-54,5,-14,1,0,1,-5,9,4,-4,6,2,-4,4,0,-2,3,1,0,-10,6,-2,-3,5,1,0,-2,1,-1,-1,-1,2,-1
KR_6754126575,420,-2,11,-4,-5,-2,3,1,0,3,3,-1,1,0,-2,4,2,0,1,1,0,-8,-214,-2,-1,3,0,0,-1,-1,-1,-1,-1,1,-1
KR_6694226268,420,-1,-25,27,-7,0,2,2,-2,3,1,1,2,3,-3,4,1,-3,3,0,0,-7,5,-1,-5,6,4,0,-1,1,1,-1,-1,3,-1
KR_6770158857,420,3,64,-6,2,3,0,3,-2,5,3,-1,2,1,3,1,4,-1,3,2,0,9,113,2,-7,5,1,0,1,-1,1,1,1,5,-1
KR_6756620699,420,0,-3,3,-4,-1,2,1,-1,6,5,-4,4,0,1,1,2,1,0,1,0,-3,-9,-4,-6,10,-1,0,-1,-1,-1,-1,-1,3,-1
KR_6697641477,420,-2,-19,-8,-2,-1,1,0,-1,2,1,1,2,3,1,1,2,-2,2,0,0,-11,12,2,-7,5,-1,0,0,-1,1,0,-1,4,-1
KR_6769898365,440,-3,25,-12,-3,-7,7,0,4,0,4,0,2,2,2,1,3,-2,3,1,0,4,-2,-1,-4,5,3,0,0,-1,1,-1,1,3,-1
KR_6758368480,420,0,32,8,2,-2,4,2,3,1,4,-3,4,1,1,1,2,3,1,4,0,3,-3,3,-8,5,-1,0,0,-1,-1,0,1,3,-1
KR_6694900074,420,-1,13,-20,1,-1,3,2,-1,2,1,3,1,4,0,2,2,0,1,1,0,6,12,0,-6,6,-2,0,0,1,-1,0,-1,6,-1
KR_6677469971,420,-4,15,5,-9,-2,5,3,-10,11,1,-4,4,0,2,3,5,5,1,6,-1,-9,1,2,-7,5,2,0,0,-1,-1,-1,-1,3,-1
KR_6741724555,420,-6,-101,-34,-9,-1,1,0,-1,5,4,-7,8,1,-1,2,1,1,1,2,-1,-13,3,-1,-2,3,-3,0,-2,1,-1,-1,-1,5,-1
KR_6768860420,420,-4,-53,6,-9,-2,4,2,-2,2,0,-5,5,0,1,3,4,-1,4,3,0,-10,0,-4,-3,7,-4,0,0,1,0,-1,1,3,-1
KR_6764722082,440,-5,93,-33,-3,-2,2,0,-2,2,0,4,0,4,-1,2,1,-2,2,0,0,-2,7,1,-4,3,-3,0,-1,1,-1,-1,-1,2,-1
KR_6755340099,440,1,-14,-1,2,5,1,6,-3,4,1,-5,6,1,4,0,4,1,2,3,0,3,118,2,-5,3,0,0,-1,1,-1,-1,-1,3,-1
KR_6614257855,420,-2,-6,-33,-4,2,1,3,-5,5,0,2,1,3,-3,6,3,0,0,0,0,-2,-33,0,-5,5,-1,0,-2,1,-1,-1,-1,3,-1
KR_6767412587,420,-4,-52,-16,-2,0,1,1,4,2,6,-4,5,1,-2,6,4,0,2,2,2,-3,4,-4,-2,6,-1,0,1,0,-1,1,1,0,-1
KR_6732658102,420,4,46,16,5,4,1,5,0,3,3,-4,4,0,7,3,10,-2,2,0,0,7,-3,5,-10,5,3,0,0,1,1,0,-1,1,-1
KR_6744467489,420,0,-12,-17,0,2,0,2,0,4,4,-1,3,2,0,2,2,-1,1,0,0,1,-26,3,-8,5,3,0,1,-1,0,1,1,3,-1
KR_6768722451,420,-2,-51,-12,-8,-1,3,2,-1,3,2,-1,5,4,-4,6,2,-1,1,0,0,-5,-4,-3,-3,6,2,0,0,-1,1,-1,-1,4,-1
KR_6758771979,420,3,22,16,-2,1,1,2,-3,7,4,-2,5,3,2,2,4,0,1,1,0,4,-205,1,-4,3,1,0,3,-1,1,1,-1,1,-1
KR_6769832324,440,-1,-16,19,-9,-6,7,1,0,3,3,-3,3,0,-2,2,0,2,0,2,0,-6,131,0,-3,3,1,0,0,0,1,0,1,0,-1
KR_6769883516,420,0,28,-8,-5,0,2,2,1,7,8,-2,4,2,-1,2,1,-3,3,0,-1,0,-3,-1,-6,7,2,0,0,-1,-1,0,-1,1,-1
KR_6652420074,420,-3,-14,-24,-8,-1,2,1,1,2,3,1,0,1,-6,8,2,-3,3,0,0,-12,1,0,-5,5,1,0,0,-1,1,0,-1,3,-1
KR_6683903677,420,1,9,52,0,1,0,1,-3,4,1,3,0,3,-5,6,1,4,0,4,2,-2,-1,4,-10,6,-2,0,-1,1,-1,-1,1,1,-1
KR_6768752394,420,3,35,27,-2,1,4,5,1,1,2,-3,6,3,-2,3,1,1,0,1,0,-9,0,1,-6,5,5,0,0,1,-1,0,-1,1,-1
KR_6747832072,420,-4,-13,-13,-9,3,0,3,-4,5,1,-3,5,2,-4,6,2,-1,3,2,-3,-24,108,1,-6,5,4,0,0,-1,-1,0,-1,6,-1
KR_6751988249,420,0,-17,3,0,0,3,3,-1,3,2,2,0,2,-1,4,3,0,0,0,0,-1,165,0,-5,5,-13,0,0,-1,-1,-1,1,4,-1
KR_6764861275,420,-5,-44,-25,-13,-6,9,3,-1,4,3,0,4,4,-3,5,2,-3,3,0,0,-18,6,1,-9,8,0,0,-1,1,-1,-1,-1,2,-1
KR_6759077540,420,3,1,7,7,6,0,6,-3,5,2,-1,1,0,5,2,7,0,1,1,0,-2,31,-2,-4,6,3,0,1,1,-1,1,1,2,-1
KR_6635807459,420,2,29,28,6,2,0,2,7,0,7,0,3,3,0,1,1,-3,3,0,0,5,42,-1,-5,6,-20,0,0,1,-1,0,1,1,-1
KR_6731837534,420,-1,-14,-21,2,-2,2,0,3,1,4,2,0,2,-1,1,0,0,0,0,0,5,0,1,-3,2,0,0,0,0,-1,0,1,0,-1
KR_6702941369,420,-1,-31,22,0,0,2,2,5,1,6,0,2,2,-4,4,0,-1,2,1,0,-7,2,1,-8,7,-2,0,1,-1,1,1,-1,2,-1
KR_6770903955,420,0,-20,47,0,-1,2,1,-1,4,3,1,2,3,3,2,5,-2,2,0,0,-1,3,3,-8,5,2,0,-1,1,-1,-1,1,5,-1
KR_6697976729,420,0,19,8,-2,0,3,3,0,5,5,-4,4,0,5,2,7,-3,4,1,0,3,96,0,-6,6,2,0,0,-1,-1,0,1,3,-1
KR_6768606054,420,3,95,20,4,3,0,3,2,1,3,0,3,3,-1,3,2,0,0,0,0,-2,-10,3,-5,2,4,0,1,-1,1,1,1,6,-1
KR_6743600708,420,-6,-42,-47,-15,-3,4,1,-4,7,3,-3,3,0,-4,8,4,-1,3,2,-1,-6,20,-2,-5,7,-9,0,0,1,-1,-1,-1,3,-1
KR_6767769305,420,-2,-19,-8,-8,-2,3,1,-2,4,2,-2,4,2,-1,3,2,-1,4,3,1,0,3,-3,-3,6,0,0,-1,1,-1,-1,1,4,-1
KR_6763181378,440,-5,-53,-32,-4,0,1,1,-2,5,3,-4,5,1,3,1,4,-1,1,0,0,-6,92,1,-4,3,21,0,-1,-1,-1,-1,1,3,-1
KR_6608145419,420,-10,-128,-13,-16,-3,4,1,-14,16,2,1,2,3,0,2,2,0,0,0,0,-16,4,4,-7,3,2,0,-2,-1,1,-1,-1,3,-1
KR_6697193576,420,-8,-56,-29,-14,-8,8,0,3,0,3,-9,13,4,2,0,2,-2,3,1,1,-5,5,-4,-5,9,2,0,-4,-1,-1,-1,1,2,-1
KR_6745287191,420,-2,-23,15,-6,-2,3,1,1,2,3,-3,5,2,-3,3,0,1,2,3,1,-7,31,1,-5,4,1,0,-1,0,-1,-1,1,0,-1
KR_6764957128,420,-6,-60,8,-19,-2,3,1,-9,10,1,-3,4,1,-3,4,1,-2,2,0,0,-18,-9,0,-4,4,3,0,-1,-1,1,1,-1,1,-1
KR_6764597768,420,-1,-31,22,-5,-5,5,0,2,3,5,0,1,1,0,1,1,-2,2,0,-1,-4,-40,-2,-2,4,0,0,-1,-1,-1,-1,-1,2,-1
KR_6741248493,420,-3,-50,5,-11,-3,3,0,-4,4,0,-2,2,0,-4,6,2,2,1,3,0,-13,-2,2,-6,4,-4,0,0,-1,-1,-1,-1,3,-1
KR_6763945524,420,-4,-58,2,-17,-4,4,0,0,2,2,0,2,2,-11,14,3,-2,3,1,0,-17,-6,-5,-1,6,-1,0,-3,-1,1,-1,1,6,-1
KR_6670144578,420,-5,-48,-22,-12,-2,3,1,-3,4,1,-2,2,0,-2,5,3,-3,3,0,0,-10,0,-1,-7,8,-5,0,0,-1,0,-1,1,5,-1
KR_6767001190,440,0,51,9,2,1,0,1,-1,3,2,0,4,4,1,1,2,1,2,3,0,-12,-10,-3,-4,7,-4,0,0,0,1,0,-1,0,-1
KR_6770368169,420,-2,-22,7,-7,-2,4,2,-2,4,2,1,3,4,0,2,2,-4,5,1,0,-10,21,-2,-3,5,3,0,0,-1,1,0,1,1,-1
KR_6743298792,440,-4,-32,-26,-2,4,2,6,-1,2,1,-4,4,0,-1,3,2,0,0,0,0,-10,-22,-5,-2,7,-1,0,0,-1,1,1,1,2,-1
KR_6715860643,420,-3,-7,-24,-12,-7,7,0,-3,5,2,0,3,3,-2,3,1,0,2,2,0,-15,37,-5,-2,7,-22,0,-1,-1,-1,-1,1,2,-1
KR_6682552187,420,-3,-74,4,-2,-3,4,1,0,2,2,2,3,5,0,1,1,-1,3,2,0,2,-3,1,-2,1,-5,0,-3,1,-1,-1,-1,4,-1
KR_6766879726,420,0,-19,-24,-8,2,2,4,0,2,2,2,0,2,-9,10,1,-3,6,3,0,-9,-15,-4,-4,8,-2,0,0,-1,-1,0,-1,2,-1
KR_6717543587,420,-3,-81,-11,-1,0,3,3,0,2,2,4,0,4,-4,4,0,-1,3,2,1,1,-26,0,-3,3,5,0,-1,-1,1,-1,1,4,-1
KR_6760221592,420,-1,-21,-4,-8,-2,3,1,-1,5,4,-4,7,3,0,0,0,-1,2,1,0,-8,15,0,-4,4,1,0,-1,1,-1,-1,-1,1,-1
KR_6767178125,420,-4,-73,-16,-8,-1,2,1,0,3,3,2,1,3,-8,8,0,-1,2,1,-1,-16,-4,2,-7,5,3,0,-1,-1,1,-1,-1,2,-1
KR_6701566638,420,-1,-56,-9,-2,-3,4,1,1,1,2,0,2,2,-1,2,1,1,0,1,0,-1,105,-3,-6,9,1,0,-2,1,-1,-1,1,3,-1
KR_6718004670,420,-4,10,5,-13,-6,7,1,-5,6,1,-2,4,2,1,0,1,-1,1,0,0,-17,-14,-6,-3,9,-1,0,0,1,0,0,-1,5,-1
KR_6766774387,420,1,-9,-12,2,0,1,1,-3,7,4,1,5,6,4,0,4,0,0,0,0,4,7,1,-4,3,1,0,0,1,-1,0,1,4,-1
KR_6597830935,420,-4,-47,-4,-10,-1,1,0,-3,3,0,1,0,1,-3,5,2,-4,5,1,0,-14,2,-3,-5,8,-3,0,-1,-1,1,-1,1,5,-1
KR_6765678502,440,-1,-4,16,4,1,0,1,0,2,2,8,0,8,-5,6,1,0,0,0,1,12,4,5,-6,1,-1,0,1,1,1,1,1,6,-1
KR_6765295785,420,-3,-28,-16,-3,-1,3,2,-4,7,3,4,0,4,-2,4,2,0,1,1,0,-3,-7,-2,-4,6,9,0,0,0,-1,-1,-1,0,-1
KR_6755296718,420,0,-93,-5,-7,-1,2,1,-6,7,1,0,4,4,-1,3,2,1,1,2,0,3,-51,-3,-2,5,25,0,-2,0,-1,-1,-1,0,-1
KR_6753533373,420,0,-60,38,-8,-4,5,1,0,1,1,3,1,4,-7,7,0,0,0,0,0,-3,1,-3,-5,8,0,0,0,-1,-1,-1,-1,1,-1
KR_6748070719,420,-4,-60,-26,-2,-1,2,1,0,2,2,-1,3,2,0,1,1,0,0,0,2,12,1,-1,-3,4,-1,0,0,0,-1,0,1,0,-1
KR_6761817405,420,-4,-47,0,-8,-5,7,2,0,1,1,1,1,2,-3,5,2,-1,2,1,0,-2,2,0,-6,6,-4,0,0,0,-1,-1,-1,0,-1
KR_6662175601,420,0,-1,5,2,1,2,3,4,3,7,2,0,2,-3,5,2,-2,2,0,0,-2,9,1,-10,9,3,0,0,-1,-1,0,1,1,-1
KR_6712314092,420,-7,-29,-72,-19,-1,3,2,-5,7,2,-6,8,2,-6,7,1,-1,2,1,0,-20,-5,-1,-5,6,1,0,-3,-1,-1,-1,-1,5,-1
KR_6697414502,440,-1,28,-10,2,0,0,0,-3,4,1,2,1,3,-2,5,3,5,2,7,0,-2,-5,0,-7,7,2,0,1,1,1,1,1,3,-1
KR_6727051996,420,0,-20,-9,0,2,0,2,0,5,5,2,2,4,-1,2,1,-3,4,1,0,-9,1,-1,-4,5,-1,0,0,-1,1,0,-1,3,-1
KR_6743365694,440,-5,-42,-24,-13,-6,6,0,-3,3,0,-3,3,0,-1,1,0,0,0,0,-1,-9,-23,-1,-3,4,2,0,-2,-1,-1,-1,-1,3,-1
KR_6755693386,420,1,24,26,-1,-2,3,1,1,1,2,3,0,3,-4,4,0,1,1,2,0,-5,-126,0,-5,5,0,0,1,1,1,1,1,3,-1
KR_6712373607,420,0,-34,30,-5,-2,2,0,-1,2,1,-1,3,2,-1,1,0,0,0,0,0,-7,0,1,-4,3,0,0,-1,-1,-1,-1,-1,4,-1
KR_6758342685,420,-3,20,2,-9,1,0,1,-2,4,2,-5,7,2,-3,5,2,0,2,2,-1,-8,-283,3,-8,5,-4,0,-1,0,-1,-1,-1,0,-1
KR_6730684628,420,-2,18,-16,-9,3,1,4,-5,6,1,-4,7,3,-2,4,2,-1,2,1,0,-6,10,3,-9,6,-5,0,0,-1,1,0,-1,3,-1
KR_6767964826,420,-1,-19,-24,-2,1,1,2,3,1,4,-1,3,2,-6,9,3,1,1,2,0,-8,1,0,-6,6,-3,0,2,1,1,1,-1,2,-1
KR_6749085765,440,1,36,-14,0,3,0,3,0,1,1,0,2,2,-3,3,0,0,0,0,0,-4,4,-1,-7,8,1,0,1,0,-1,1,-1,0,-1
KR_6642847195,420,-7,-53,-48,-11,0,3,3,-4,5,1,-1,2,1,-3,3,0,-3,3,0,0,-12,-10,-4,-1,5,-3,0,-2,-1,-1,-1,-1,3,-1
KR_6749212206,420,1,25,-28,-3,-4,4,0,-2,2,0,1,1,2,2,1,3,0,1,1,0,0,-3,4,-6,2,-1,0,-1,-1,-1,-1,1,3,-1
KR_6706494707,420,-1,-54,9,-2,4,0,4,0,4,4,-3,4,1,-2,6,4,-1,1,0,0,-1,6,3,-7,4,-6,0,-1,-1,-1,-1,-1,3,-1
KR_6755559103,420,0,-83,16,-7,-4,5,1,-2,5,3,-2,2,0,0,1,1,1,0,1,0,-6,5,6,-7,1,0,0,0,1,1,0,-1,4,-1
KR_6759614178,420,-1,3,0,0,0,3,3,0,1,1,2,1,3,-2,3,1,0,1,1,0,0,-9,-1,-6,7,4,0,0,1,-1,0,1,4,-1
KR_6652205747,420,-4,-84,-3,-11,1,1,2,-1,1,0,-5,6,1,-6,8,2,0,1,1,0,-9,-6,-3,-3,6,-1,0,-2,-1,-1,-1,1,1,-1
KR_6743400736,440,-8,-144,5,-8,-1,2,1,2,0,2,-10,10,0,2,0,2,-1,1,0,0,-6,2,3,-4,1,-2,0,-1,-1,1,-1,-1,6,-1
KR_6718767723,420,-4,-106,14,-15,-6,7,1,-1,2,1,-7,11,4,0,3,3,-1,5,4,-3,-9,52,3,-7,4,-9,0,-1,-1,-1,-1,1,2,-1
KR_6741361991,420,-1,-54,5,-6,-4,4,0,1,2,3,-2,4,2,-1,1,0,0,1,1,0,-3,1,0,-5,5,0,0,0,-1,1,0,-1,6,-1
KR_6766961020,420,-2,-50,7,-10,-5,6,1,0,2,2,1,0,1,-6,7,1,0,1,1,0,-11,-12,-4,-1,5,-3,0,-2,-1,-1,-1,-1,4,-1
KR_6763529202,420,0,-4,9,-9,-2,2,0,-2,5,3,-1,1,0,-4,8,4,0,1,1,-1,-12,-2,-1,-5,6,-1,0,-1,-1,-1,-1,-1,3,-1
KR_6755343247,440,-1,-13,-20,-5,0,0,0,0,2,2,0,1,1,-3,5,2,-2,2,0,-1,-6,-5,5,-11,6,-2,0,-1,-1,-1,-1,-1,6,-1
KR_6747907714,420,-4,-31,-23,-2,4,0,4,1,3,4,-1,3,2,-3,4,1,-3,3,0,0,-2,-6,1,-4,3,2,0,-3,-1,-1,-1,-1,5,-1
KR_6765396929,420,-4,-93,-15,-5,1,2,3,-1,4,3,-4,5,1,0,5,5,-1,3,2,0,-4,5,4,-7,3,-5,0,0,0,1,-1,-1,0,-1
KR_6727801177,420,0,-39,-5,0,-5,5,0,4,2,6,-1,2,1,2,3,5,0,0,0,0,6,-6,-2,-3,5,0,0,-2,-1,-1,-1,1,1,-1
KR_6748424115,420,-3,-35,-27,-8,-1,3,2,0,3,3,-4,6,2,-1,2,1,-2,3,1,0,-13,1,-1,-6,7,1,0,0,-1,1,0,1,3,-1
KR_6757124527,420,-3,-35,-4,-7,-5,6,1,-3,9,6,-1,2,1,3,3,6,-1,1,0,0,-9,1,0,-5,5,3,0,-1,-1,1,-1,-1,2,-1
KR_6727218792,420,-4,-59,9,-5,-2,4,2,-3,4,1,0,3,3,0,4,4,0,1,1,0,-1,-1,-2,-3,5,3,0,0,-1,1,-1,-1,4,-1
KR_6734079948,420,-4,-56,-31,-8,2,1,3,-2,5,3,-4,5,1,-1,1,0,-3,3,0,0,-13,-124,-5,-3,8,2,0,-1,-1,-1,-1,-1,5,-1
KR_6741268080,420,-1,-31,0,6,1,1,2,2,2,4,-1,3,2,3,3,6,1,1,2,1,14,9,-2,-3,5,2,0,-1,-1,1,-1,1,4,-1
KR_6756984011,420,-1,-18,3,-7,-5,6,1,-2,3,1,-3,4,1,3,1,4,0,2,2,2,-1,-7,2,-8,6,2,0,-1,1,-1,-1,1,1,-1
KR_6767276792,420,0,12,23,-6,3,0,3,-5,6,1,-2,5,3,-1,2,1,-1,2,1,-1,-9,-6,-4,-5,9,6,0,-3,-1,-1,-1,-1,2,-1
KR_6761196550,420,-1,-22,16,-2,-2,3,1,0,1,1,-2,5,3,2,0,2,0,1,1,0,-1,-17,-2,-3,5,5,0,-1,-1,-1,-1,-1,2,-1
KR_6770331753,440,2,10,38,2,-1,3,2,-2,6,4,1,1,2,4,3,7,0,1,1,0,-3,-3,-2,-5,7,-1,0,1,-1,1,1,1,4,-1
KR_6753562159,420,-5,-24,5,-5,0,3,3,5,0,5,-2,2,0,-4,4,0,-4,7,3,0,-7,-175,-7,-1,8,1,0,-1,0,-1,-1,-1,0,-1
KR_6735277367,420,-1,-55,5,2,1,1,2,3,0,3,1,2,3,-4,5,1,1,2,3,0,5,20,-1,-6,7,-6,0,-1,-1,1,-1,1,4,-1
KR_6716303780,420,-2,-32,25,-3,2,2,4,-1,4,3,-2,3,1,-2,5,3,0,0,0,0,-4,-198,-2,-7,9,0,0,0,1,-1,-1,-1,2,-1
KR_6760873599,420,4,7,1,7,0,2,2,3,1,4,2,1,3,1,3,4,1,0,1,0,9,7,6,-10,4,-3,0,0,1,1,0,-1,1,-1
KR_6769997332,420,-2,-79,12,-3,-2,3,1,4,2,6,-3,5,2,-2,2,0,0,4,4,0,-4,-3,-2,-5,7,0,0,0,0,1,0,-1,0,-1
KR_6678920188,420,-1,-10,1,-8,-1,2,1,-4,6,2,-2,3,1,-2,2,0,1,0,1,0,-6,-7,-4,-5,9,6,0,0,-1,-1,0,-1,1,-1
KR_6707653895,420,-2,-130,3,-3,-4,5,1,0,4,4,1,2,3,-2,5,3,2,2,4,0,2,8,1,-7,6,2,0,-1,-1,1,-1,-1,3,-1
KR_6745922881,420,-5,-71,-38,-12,1,2,3,-3,4,1,-2,3,1,-6,8,2,-2,2,0,0,-20,19,1,-5,4,-3,0,-1,-1,1,-1,-1,3,-1
KR_6737750343,420,3,79,5,5,0,1,1,5,0,5,-3,5,2,0,4,4,3,2,5,0,0,5,3,-8,5,3,0,2,1,1,1,1,6,-1
KR_6768864398,420,-3,24,20,-9,-4,4,0,2,1,3,-2,4,2,-5,6,1,0,4,4,0,-5,7,-2,-2,4,0,0,-1,1,-1,-1,-1,5,-1
KR_6768590202,420,0,19,-20,-1,0,1,1,-1,3,2,1,1,2,1,0,1,-2,3,1,0,1,-4,1,-5,4,-3,0,0,-1,1,0,1,2,-1
KR_6767621229,420,1,-34,28,0,0,2,2,-1,5,4,1,2,3,0,2,2,0,1,1,0,-2,4,1,-5,4,-5,0,1,1,-1,1,-1,1,-1
KR_6766067415,420,0,38,12,-5,-1,3,2,-5,7,2,4,1,5,-1,3,2,-2,3,1,-1,-9,0,-6,-5,11,10,0,-1,-1,1,-1,-1,5,-1
KR_6764749762,420,-2,-97,-9,-4,-1,4,3,-2,3,1,0,2,2,3,2,5,-4,4,0,0,-9,3,1,-6,5,-10,0,-1,-1,-1,-1,-1,2,-1
KR_6767172227,440,-4,9,-16,-13,1,0,1,-11,11,0,-2,3,1,0,0,0,-1,1,0,0,-11,13,-1,-7,8,0,0,0,-1,1,1,1,5,-1
KR_6764766239,420,0,-36,-12,1,2,1,3,1,4,5,0,2,2,-4,5,1,2,0,2,0,7,0,1,-8,7,2,0,0,-1,-1,-1,-1,6,-1
KR_6768901220,420,3,-83,35,12,1,0,1,8,0,8,1,1,2,3,4,7,-1,2,1,0,13,30,8,-14,6,3,0,0,1,1,0,-1,5,-1
KR_6764124746,420,-2,-63,-27,-5,-1,4,3,-2,6,4,-1,2,1,-2,4,2,1,0,1,0,-7,-5,-5,-5,10,2,0,0,-1,1,0,-1,6,-1
KR_6766992128,420,2,-23,16,2,-3,5,2,-1,3,2,4,2,6,2,1,3,0,2,2,1,3,8,1,-3,2,-5,0,1,1,1,1,1,5,-1
KR_6752731566,420,1,7,9,0,0,1,1,0,3,3,-1,3,2,0,0,0,1,0,1,0,-1,-20,0,-6,6,1,0,-1,-1,1,-1,1,5,-1
KR_6767922265,420,1,1,0,5,2,1,3,6,1,7,-2,2,0,1,1,2,-2,2,0,0,5,121,1,-9,8,0,0,1,1,1,1,1,2,-1
KR_6769675141,420,-1,-8,1,-4,-3,3,0,-1,2,1,5,0,5,-2,4,2,-3,4,1,0,-7,2,3,-6,3,-4,0,-1,-1,-1,-1,-1,2,-1
KR_6745641710,420,-3,-70,-13,0,-2,5,3,5,2,7,-1,5,4,-2,6,4,0,1,1,-1,4,5,4,-9,5,-7,0,-3,1,1,-1,-1,1,-1
KR_6686901349,420,-4,-78,-20,-8,-3,4,1,-1,4,3,-1,1,0,0,1,1,-3,4,1,0,-6,-14,-2,-5,7,-1,0,0,-1,-1,-1,1,3,-1
KR_6769279753,420,-1,0,-7,0,2,1,3,-2,2,0,-2,5,3,1,3,4,1,1,2,-2,2,13,0,-7,7,-3,0,0,0,-1,0,-1,0,-1
KR_6766823666,420,1,-35,10,2,0,2,2,4,0,4,-3,4,1,-1,3,2,2,0,2,0,5,0,-4,-4,8,1,0,-1,-1,-1,-1,1,6,-1
KR_6734788816,420,-5,-118,-25,-11,-7,7,0,-2,7,5,-1,3,2,-3,5,2,2,3,5,0,-1,-1,-7,-1,8,2,0,-2,-1,-1,-1,-1,4,-1
KR_6742600086,420,-2,-59,-15,-4,2,1,3,-1,1,0,-6,7,1,1,1,2,0,1,1,0,-2,0,-3,-3,6,0,0,-1,-1,-1,-1,1,5,-1
KR_6716707593,420,-4,-32,19,-8,2,0,2,-10,10,0,-2,3,1,3,2,5,-1,1,0,0,-13,7,-1,-5,6,-5,0,-2,-1,-1,-1,1,3,-1
KR_6666744481,420,-3,-49,2,-7,-3,3,0,-3,5,2,1,1,2,-2,3,1,0,0,0,0,-5,5,3,-8,5,-6,0,-2,-1,1,-1,1,1,-1
KR_6758935905,440,-3,8,19,-7,0,3,3,-6,9,3,-2,5,3,-1,6,5,2,2,4,-2,-15,-399,1,-1,0,0,0,0,0,1,0,1,0,-1
KR_6624404208,420,1,19,-11,-5,2,3,5,1,2,3,-3,5,2,-5,5,0,0,1,1,0,-10,-4,3,-7,4,-1,0,1,-1,1,-1,-1,2,-1
KR_6755378091,420,-3,-60,-28,-7,-4,5,1,-2,6,4,3,0,3,-3,5,2,-1,1,0,0,-1,0,-4,-2,6,0,0,-1,-1,-1,-1,1,4,-1
KR_6761041115,420,-1,20,-11,-3,5,0,5,-1,2,1,-3,7,4,-1,2,1,-3,4,1,0,-6,0,-1,-5,6,-4,0,0,1,-1,0,-1,5,-1
KR_6770029449,440,0,-29,-28,7,1,1,2,2,1,3,1,6,7,3,0,3,0,2,2,0,8,0,3,-7,4,-2,0,1,-1,-1,1,1,2,-1
KR_6759904290,420,-1,0,-4,0,5,0,5,-1,4,3,0,1,1,-3,4,1,-1,1,0,0,-1,-24,-1,-8,9,-2,0,0,1,-1,0,-1,1,-1
KR_6769676550,440,-1,-16,-15,-11,0,3,3,-1,4,3,-5,8,3,-3,5,2,-2,4,2,-2,-12,-6,-2,-5,7,3,0,-1,1,1,-1,-1,3,-1
KR_6769820467,420,3,-11,33,-1,1,1,2,0,1,1,2,1,3,-3,4,1,-1,1,0,0,-1,-261,6,-9,3,-1,0,0,1,1,0,1,2,-1
KR_6751815800,420,-4,12,-29,-11,-3,3,0,2,1,3,-6,7,1,-2,3,1,-2,3,1,-1,-12,2,2,-9,7,-1,0,-2,-1,0,-1,-1,3,-1
KR_6748816322,420,0,-36,0,-2,-1,2,1,2,1,3,4,2,6,-5,5,0,-2,2,0,0,-2,8,1,-5,4,-3,0,-2,-1,1,-1,1,5,-1
KR_6692108915,420,3,1,26,-3,2,0,2,2,1,3,-5,5,0,-2,2,0,0,0,0,0,-3,-5,-6,-3,9,0,0,0,1,-1,0,-1,1,-1
KR_6693638598,420,3,-62,24,-3,-4,7,3,1,2,3,2,0,2,-2,3,1,0,1,1,0,-2,-4,-1,-1,2,0,0,0,1,-1,0,-1,3,-1
KR_6770856048,420,1,87,-2,-1,1,1,2,0,3,3,1,4,5,-3,4,1,0,2,2,1,-4,-44,-5,-2,7,2,0,0,1,0,0,1,4,-1
KR_6713864702,420,-6,9,-20,-10,0,2,2,-10,11,1,4,2,6,-4,5,1,0,1,1,-1,-19,-9,-2,-3,5,1,0,-1,-1,1,-1,-1,3,-1
KR_6725630497,420,-2,-32,3,-1,5,1,6,3,1,4,-7,8,1,-3,5,2,1,0,1,0,-1,16,7,-11,4,-3,0,-1,-1,-1,-1,-1,4,-1
KR_6701097962,420,-1,-24,14,-2,0,1,1,-4,4,0,3,1,4,-1,4,3,0,1,1,0,-4,-8,0,-5,5,2,0,0,1,1,0,-1,2,-1
KR_6755741144,440,0,-19,25,5,-3,3,0,0,2,2,4,2,6,2,1,3,2,0,2,0,6,34,2,-6,4,3,0,-1,1,-1,-1,1,1,-1
KR_6762468553,420,-1,47,27,-3,3,0,3,-6,7,1,-2,3,1,1,2,3,1,1,2,0,-5,3,5,-6,1,2,0,0,1,1,0,-1,5,-1
KR_6747761780,420,1,-23,-7,1,2,0,2,-3,5,2,2,0,2,1,0,1,-1,1,0,0,2,-24,4,-6,2,2,0,0,1,-1,0,-1,2,-1
KR_6738254581,420,-1,-26,8,-7,-1,3,2,-5,7,2,1,2,3,0,3,3,-2,2,0,-2,-13,26,-2,-2,4,-16,0,1,-1,1,1,-1,5,-1
KR_6729504907,420,-1,7,-12,2,-2,2,0,-4,5,1,5,1,6,1,1,2,2,2,4,1,5,-58,3,-7,4,19,0,-1,1,-1,-1,1,4,-1
KR_6764965177,420,-6,-85,-32,-12,-3,4,1,-2,3,1,-5,7,2,0,3,3,-2,3,1,0,-11,6,-1,-6,7,0,0,-1,1,-1,-1,-1,2,-1
KR_6749022193,440,1,-7,24,-6,-3,5,2,1,2,3,0,5,5,-4,8,4,0,1,1,0,-3,22,3,-5,2,-3,0,0,-1,1,-1,1,4,-1
KR_6745207263,420,-2,-31,-4,-7,1,0,1,1,1,2,-3,5,2,-4,7,3,-2,2,0,0,-4,8,4,-8,4,-2,0,0,-1,1,0,-1,2,-1
KR_6594789534,420,-3,-45,-17,-3,-2,2,0,0,2,2,-1,3,2,1,2,3,-1,2,1,0,-2,-2,-2,-7,9,2,0,-1,-1,-1,-1,-1,6,-1
KR_6744661135,420,1,-31,19,0,0,2,2,-2,2,0,-1,2,1,4,4,8,-1,1,0,0,-4,-18,0,-6,6,2,0,-1,0,-1,-1,1,0,-1
KR_6708739650,420,0,26,2,-11,-1,1,0,-6,7,1,-7,8,1,3,2,5,0,2,2,0,-10,41,6,-10,4,-24,0,0,-1,1,0,1,4,-1
KR_6757791461,420,-2,35,15,-8,-3,3,0,0,6,6,0,0,0,0,2,2,-5,6,1,0,-13,-8,3,-8,5,2,0,0,1,-1,1,1,5,-1
KR_6652471563,420,-2,-47,5,-9,-1,2,1,-4,5,1,0,3,3,-3,5,2,-1,1,0,0,-15,-8,-3,-5,8,-4,0,-1,-1,-1,-1,-1,6,-1
KR_6719878378,420,0,19,15,-5,-1,2,1,-2,3,1,2,1,3,-5,5,0,1,1,2,-1,-8,130,-4,-1,5,-8,0,-1,-1,1,-1,-1,6,-1
KR_6769438515,420,0,-47,-36,-4,1,1,2,-1,3,2,-1,2,1,-4,4,0,1,0,1,0,-5,-10,0,-5,5,1,0,0,-1,-1,0,-1,1,-1
KR_6767499362,440,-5,-83,-28,-15,-5,6,1,5,1,6,-6,6,0,-3,4,1,-6,6,0,-1,-10,-14,-5,-2,7,3,0,-2,-1,-1,-1,-1,2,-1
KR_6750538131,420,-2,-38,-4,4,-2,3,1,4,4,8,1,1,2,-3,3,0,4,0,4,0,4,14,3,-8,5,-2,0,0,-1,1,1,1,4,-1
KR_6654092764,420,0,-23,-20,4,-2,2,0,6,1,7,-1,1,0,1,1,2,0,1,1,0,2,249,1,-8,7,-1,0,-1,-1,-1,-1,-1,3,-1
KR_6695838879,440,-5,-16,-5,-16,-2,4,2,-6,8,2,-6,6,0,0,3,3,-2,3,1,0,-16,44,-2,-2,4,-20,0,-1,1,-1,-1,-1,5,-1
KR_6686011611,420,-2,-48,-16,-4,1,1,2,0,2,2,-1,4,3,0,0,0,-4,5,1,0,-9,-14,3,-9,6,-5,0,-1,-1,1,-1,-1,4,-1
KR_6736412269,420,-2,-58,-21,-5,-4,5,1,-2,4,2,0,1,1,1,3,4,0,2,2,-2,-5,-4,-1,-5,6,-2,0,-2,-1,-1,-1,-1,4,-1
KR_6732504805,440,3,-5,-8,7,-3,3,0,3,1,4,6,1,7,0,0,0,1,0,1,0,10,-1,-1,-7,8,-3,0,-1,1,-1,-1,1,4,-1
KR_6767675115,420,3,-40,16,6,5,0,5,2,2,4,-1,3,2,0,1,1,0,2,2,0,0,-4,3,-8,5,-1,0,1,-1,0,1,1,2,-1
KR_6738439747,420,-2,-25,-21,-5,0,2,2,-7,8,1,0,0,0,2,0,2,0,0,0,0,-3,4,1,-6,5,-3,0,-1,-1,-1,-1,-1,2,-1
KR_6741041659,420,0,20,-6,-1,2,3,5,2,2,4,-1,3,2,-2,3,1,-2,2,0,0,3,60,3,-8,5,3,0,-1,1,-1,-1,-1,2,-1
KR_6686771856,420,2,12,5,1,-1,1,0,-2,2,0,1,1,2,3,2,5,0,0,0,0,1,-11,1,-5,4,0,0,-1,1,-1,-1,1,1,-1
KR_6761863495,420,-1,-11,-32,2,1,1,2,0,3,3,1,3,4,0,3,3,0,0,0,0,13,-34,4,-7,3,0,0,-1,1,-1,-1,-1,4,-1
KR_6673080678,420,1,-19,-6,-2,1,1,2,-2,2,0,-2,4,2,1,0,1,0,1,1,0,-1,-9,-2,-4,6,1,0,0,-1,-1,0,1,3,-1
KR_6734603405,420,-2,-78,-13,0,0,2,2,1,1,2,7,3,10,-8,8,0,0,3,3,0,-4,-24,0,-3,3,1,0,0,0,1,1,-1,0,-1
KR_6727107720,420,-3,-45,1,0,0,1,1,-5,10,5,4,0,4,-2,3,1,3,0,3,0,-1,-4,1,-8,7,-3,0,-2,-1,-1,-1,-1,3,-1
KR_6768366051,420,-7,-79,-4,-13,-5,6,1,-2,4,2,1,0,1,-4,6,2,-3,4,1,1,-18,-16,-2,-4,6,2,0,-2,-1,-1,-1,1,4,-1
KR_6766963181,420,0,-15,-8,4,-1,1,0,-2,3,1,0,2,2,5,1,6,2,0,2,0,-1,4,1,-5,4,1,0,-1,1,-1,-1,-1,2,-1
KR_6648524780,420,0,-27,-24,4,1,0,1,-3,6,3,1,3,4,4,2,6,1,0,1,0,6,-18,2,-9,7,2,0,-3,1,-1,-1,1,1,-1
KR_6769324123,420,-2,13,-34,-4,4,0,4,-3,3,0,-1,3,2,-2,3,1,-2,2,0,-1,-7,-8,-1,-3,4,-3,0,0,-1,1,-1,-1,3,-1
KR_6768846611,420,-2,22,-4,-6,-3,6,3,-4,6,2,1,2,3,-1,6,5,1,1,2,1,-11,-45,8,-10,2,16,0,-1,1,0,-1,1,1,-1
KR_6761370306,420,1,72,-4,7,3,0,3,2,0,2,-3,5,2,4,2,6,1,1,2,0,8,34,0,-6,6,-24,0,2,0,1,1,1,0,-1
KR_6746390736,420,3,-16,24,0,-1,3,2,1,2,3,1,3,4,0,1,1,-1,1,0,0,3,-7,-2,-6,8,2,0,-1,1,-1,-1,-1,4,-1
KR_6769426425,440,-5,-77,-16,-11,1,1,2,-9,10,1,4,2,6,-6,7,1,-1,1,0,-2,-14,1,-1,-3,4,-2,0,-1,-1,0,-1,-1,1,-1
KR_6770810290,420,1,47,-24,3,1,1,2,1,5,6,1,2,3,0,3,3,0,2,2,0,1,6,-2,-3,5,-3,0,1,-1,-1,1,1,2,-1
KR_6768904006,420,-3,-42,1,-3,-1,2,1,3,2,5,-3,4,1,-2,4,2,0,0,0,-2,1,2,2,-8,6,-1,0,2,1,1,1,-1,3,-1
KR_6762328951,420,-3,-66,-17,-4,-5,6,1,3,1,4,-2,3,1,0,1,1,0,1,1,0,1,-1,0,-6,6,-3,0,-2,-1,-1,-1,1,6,-1
KR_6694885205,420,-4,-48,-9,-1,2,0,2,-3,5,2,-1,1,0,1,0,1,0,0,0,0,3,-16,-7,-1,8,0,0,-2,0,-1,-1,1,0,-1
KR_6758437107,420,3,34,-12,9,5,2,7,-1,3,2,0,2,2,1,1,2,4,1,5,0,10,-19,4,-5,1,-3,0,1,0,0,1,-1,0,-1
KR_6765097018,420,-2,-73,0,-11,-1,3,2,-4,4,0,1,2,3,-6,8,2,-1,1,0,0,-12,-2,4,-10,6,-2,0,-1,1,1,-1,-1,4,-1
KR_6710553708,420,2,-16,4,2,0,2,2,-1,4,3,1,1,2,0,1,1,2,0,2,0,1,-39,-2,-5,7,6,0,1,-1,1,1,-1,3,-1
KR_6714822057,440,2,48,14,1,6,0,6,-2,3,1,0,1,1,-3,6,3,0,0,0,0,-12,1,0,-7,7,-1,0,1,1,1,1,1,3,-1
KR_6752281684,420,-3,-54,12,-4,-3,4,1,-4,5,1,-1,2,1,4,1,5,0,0,0,-1,-5,-4,0,-5,5,1,0,-1,1,1,-1,-1,4,-1
KR_6742285757,420,-3,-38,-11,-6,0,0,0,-2,3,1,-4,4,0,0,3,3,0,1,1,0,-2,2,3,-7,4,3,0,-1,-1,-1,-1,1,5,-1
KR_6768460462,420,-1,1,-21,1,3,0,3,-1,2,1,-2,4,2,4,1,5,-3,3,0,1,2,-34,-4,-4,8,5,0,-1,1,-1,-1,1,5,-1
KR_6723987658,420,-1,-26,5,-7,-3,3,0,-1,2,1,0,1,1,-2,3,1,-1,1,0,0,-1,159,-1,-5,6,5,0,-1,1,-1,-1,-1,5,-1
KR_6726767578,420,2,-47,-17,6,-1,2,1,5,0,5,-1,1,0,2,4,6,1,0,1,-1,13,8,3,-8,5,0,0,-3,-1,-1,-1,-1,2,-1
KR_6745537439,420,-3,-15,-36,-2,4,0,4,-3,5,2,2,3,5,-3,7,4,-2,2,0,0,-9,9,2,-5,3,-5,0,0,-1,-1,0,1,1,-1
KR_6738733461,420,1,2,0,9,5,1,6,3,0,3,0,2,2,1,3,4,0,2,2,0,8,1,1,-6,5,-5,0,0,-1,1,1,1,5,-1
KR_6686832172,420,-3,-41,-19,-7,-3,4,1,-5,5,0,0,1,1,3,0,3,-2,5,3,0,-8,1,-2,-7,9,-3,0,-2,-1,-1,-1,1,4,-1
KR_6710578669,420,-2,-6,-16,-7,1,1,2,-3,5,2,-3,6,3,0,1,1,-2,2,0,0,-9,-18,1,-4,3,1,0,-1,-1,-1,-1,-1,3,-1
KR_6735911866,420,-1,-24,-1,1,-3,4,1,1,2,3,4,2,6,0,3,3,-1,1,0,0,6,-30,-2,-4,6,9,0,0,-1,-1,-1,1,4,-1
KR_6711435537,420,-2,-51,-16,1,-3,4,1,-1,2,1,3,2,5,3,0,3,-1,3,2,-1,9,1,3,-8,5,0,0,-1,1,-1,-1,-1,5,-1
KR_6762357969,420,-3,3,23,-4,-2,4,2,-2,4,2,2,0,2,-1,2,1,-1,1,0,0,-3,-4,1,-6,5,-1,0,0,1,0,0,1,6,-1
KR_6746120278,420,-4,-78,-10,-4,4,0,4,-7,7,0,-1,3,2,-1,3,2,1,0,1,0,-5,8,1,-5,4,-1,0,-1,-1,-1,-1,-1,3,-1
KR_6763131593,420,-5,-86,-23,-10,-4,4,0,-4,6,2,-1,3,2,-1,3,2,0,1,1,0,-2,-15,-5,-3,8,0,0,0,-1,1,0,-1,4,-1
KR_6769515429,420,-1,-30,36,-5,-2,2,0,2,0,2,-4,5,1,0,0,0,-1,1,0,0,-2,11,2,-6,4,-1,0,0,1,-1,0,-1,4,-1
KR_6770131729,440,-1,25,-20,-4,-1,1,0,-4,5,1,2,0,2,2,4,6,-3,4,1,0,-8,3,3,-7,4,-5,0,-2,-1,-1,-1,-1,4,-1
KR_6769474474,440,-4,-35,-17,-11,-4,4,0,-3,4,1,0,4,4,1,2,3,-5,5,0,0,-11,-3,-7,0,7,-2,0,-2,0,-1,-1,-1,0,-1
KR_6766041312,420,-3,-11,11,-19,-4,5,1,-1,7,6,-2,5,3,-8,11,3,-4,4,0,-6,-28,-9,-1,-5,6,4,0,-3,-1,0,-1,-1,3,-1
KR_6724497827,440,-3,-62,18,-3,-5,8,3,0,2,2,-1,4,3,2,1,3,1,1,2,0,2,8,3,-7,4,-5,0,-2,1,-1,-1,-1,6,-1
KR_6760543252,420,-3,-49,-39,-2,-7,8,1,-1,4,3,1,2,3,3,2,5,2,0,2,0,10,-22,-1,-5,6,-1,0,0,1,-1,-1,1,3,-1
KR_6706906610,440,3,22,-5,7,-1,3,2,-1,2,1,2,2,4,3,0,3,4,0,4,0,8,-1,1,-5,4,5,0,1,-1,-1,1,1,4,-1
KR_6710612103,420,-6,-87,-20,-10,-3,4,1,0,4,4,-2,5,3,-3,6,3,-2,2,0,0,-1,1,3,-6,3,-3,0,-3,0,0,-1,-1,0,-1
KR_6732759824,420,-2,-43,-9,-5,0,3,3,4,2,6,-1,2,1,-8,9,1,0,2,2,0,-10,5,1,-6,5,-1,0,0,-1,1,1,-1,4,-1
KR_6760900327,420,-2,-29,-7,-3,0,3,3,0,1,1,-2,4,2,-2,4,2,1,2,3,0,4,-3,3,-5,2,-2,0,0,0,-1,-1,-1,0,-1
KR_6712606940,420,-1,-38,20,-4,0,1,1,-6,8,2,1,1,2,1,1,2,0,0,0,0,0,155,4,-7,3,-4,0,1,-1,1,1,1,4,-1
KR_6765300342,420,0,-12,16,-10,0,3,3,3,2,5,-4,5,1,-6,7,1,-3,3,0,-2,-26,-46,-2,-4,6,27,0,-1,1,1,1,-1,4,-1
KR_6760527107,420,0,-73,8,0,0,1,1,-1,3,2,2,0,2,0,2,2,-1,1,0,0,-3,4,4,-9,5,-4,0,0,1,-1,0,-1,3,-1
KR_6770535082,420,1,-46,12,-2,1,2,3,-1,1,0,-2,3,1,-2,3,1,2,0,2,0,-2,0,1,-9,8,-4,0,-1,1,-1,-1,-1,2,-1
KR_6768471355,420,-4,-56,-25,-6,-2,2,0,-4,7,3,2,1,3,-1,2,1,-1,3,2,0,-2,0,1,-6,5,1,0,0,0,1,0,-1,0,-1
KR_6708291915,420,-1,-38,-3,2,4,1,5,2,1,3,0,2,2,-3,5,2,-1,2,1,0,-1,1,-3,-6,9,5,0,0,-1,1,1,1,4,-1
KR_6690261667,420,-1,-44,4,-1,1,0,1,-1,1,0,-2,3,1,-1,1,0,2,0,2,0,-3,-2,5,-7,2,-4,0,0,-1,1,0,1,6,-1
KR_6706139165,420,-2,45,-16,-8,-1,3,2,-5,8,3,3,1,4,-6,7,1,1,0,1,0,-12,-4,-4,-1,5,4,0,-1,-1,-1,-1,1,6,-1
KR_6758179803,420,-1,-34,-28,-2,-3,3,0,-1,4,3,3,1,4,-1,4,3,0,2,2,0,9,8,5,-9,4,-2,0,0,-1,1,0,-1,3,-1
KR_6695013107,420,3,43,11,8,1,1,2,4,3,7,0,1,1,1,2,3,2,0,2,0,6,-280,-1,-6,7,2,0,1,1,1,1,1,6,-1
KR_6745986343,420,2,-16,4,6,1,1,2,-5,8,3,4,0,4,4,0,4,2,0,2,0,7,-8,3,-6,3,2,0,1,1,-1,1,1,5,-1
KR_6751809615,420,-1,1,12,-1,-1,4,3,-1,2,1,-3,3,0,0,3,3,4,1,5,0,0,-4,-3,-4,7,-2,0,-1,-1,1,-1,1,3,-1
KR_6768535030,420,5,11,16,10,1,0,1,3,2,5,0,2,2,4,2,6,2,1,3,-1,13,103,0,-5,5,-3,0,1,1,-1,1,-1,6,-1
KR_6741330931,440,-1,15,5,0,3,1,4,0,1,1,-2,4,2,1,3,4,-2,3,1,0,-3,7,-1,-8,9,0,0,0,-1,-1,0,-1,4,-1
KR_6765569618,420,-3,-77,-51,-5,0,2,2,-2,3,1,-1,6,5,-1,2,1,-1,1,0,0,-4,-98,0,-2,2,-3,0,-1,-1,-1,-1,-1,1,-1
KR_6757926672,420,0,-38,-8,0,-3,3,0,1,2,3,1,2,3,1,1,2,0,0,0,0,-2,-6,0,-7,7,-2,0,0,1,-1,-1,-1,3,-1
KR_6743602804,440,-1,-47,-1,6,-2,3,1,1,0,1,3,1,4,4,2,6,0,2,2,-1,3,-4,-3,-2,5,-1,0,-1,-1,-1,-1,-1,5,-1
KR_6759535195,420,-2,-41,-32,-1,-3,3,0,2,3,5,3,1,4,-2,6,4,-1,1,0,-1,7,-4,0,-7,7,-3,0,0,-1,-1,-1,-1,2,-1
KR_6768850162,440,-2,-15,-4,1,0,3,3,4,0,4,-1,1,0,1,1,2,-3,3,0,0,-1,-1,-2,-2,4,1,0,0,1,-1,1,-1,4,-1
KR_6765821675,420,-2,-33,-24,-4,-1,3,2,-2,4,2,-2,4,2,1,1,2,0,1,1,0,1,2,1,-7,6,-4,0,-1,-1,-1,-1,1,2,-1
KR_6769532422,420,1,-7,3,-2,-3,4,1,2,1,3,3,2,5,-4,4,0,0,1,1,0,-2,8,-4,-2,6,1,0,1,1,1,1,-1,5,-1
KR_6757864759,440,-4,-67,-27,-10,2,1,3,1,1,2,-11,13,2,-2,3,1,0,0,0,0,-7,-13,0,-2,2,1,0,-3,-1,-1,-1,1,4,-1
KR_6759042100,420,-2,-7,-31,0,-1,5,4,0,1,1,-4,4,0,6,0,6,-1,2,1,0,2,-9,0,-5,5,-1,0,-1,1,-1,-1,-1,3,-1
KR_6704907786,420,3,4,22,0,-3,4,1,1,2,3,-1,3,2,3,1,4,0,0,0,0,-5,9,2,-6,4,-6,0,1,-1,1,1,-1,6,-1
KR_6770385948,420,-1,-5,8,-2,0,1,1,2,1,3,-1,1,0,0,1,1,-3,3,0,0,-7,-2,-4,-4,8,-1,0,-1,-1,-1,-1,-1,6,-1
KR_6569523943,420,-1,-34,15,-11,-1,1,0,-4,4,0,5,2,7,-9,10,1,-2,2,0,0,-20,6,1,-5,4,-3,0,-1,-1,-1,-1,-1,4,-1
KR_6754261291,420,-1,11,-2,-2,-1,1,0,-5,8,3,1,0,1,2,1,3,1,1,2,0,1,4,2,-6,4,0,0,0,-1,1,0,1,4,-1
KR_6763415687,420,-4,-37,-4,-11,-3,4,1,-1,2,1,-1,3,2,-7,7,0,1,0,1,0,-22,40,-7,-4,11,-23,0,-1,-1,-1,-1,-1,3,-1
KR_6755261921,420,-2,-34,-12,0,-2,3,1,1,5,6,1,1,2,-1,7,6,1,0,1,0,2,-163,2,-6,4,7,0,0,-1,-1,0,1,4,-1
KR_6768815650,420,2,89,-8,-4,1,0,1,-7,7,0,2,0,2,1,1,2,-1,1,0,0,-3,-1,-1,-5,6,-1,0,-1,-1,-1,-1,-1,6,-1
KR_6765659615,420,-1,-37,-16,1,-2,3,1,-2,3,1,0,3,3,5,0,5,0,2,2,0,5,-4,3,-7,4,-2,0,0,-1,1,0,-1,3,-1
KR_6770699234,420,-2,21,-3,-10,-4,4,0,-4,6,2,-2,2,0,2,3,5,-2,4,2,0,-4,-18,-5,-3,8,3,0,-1,0,-1,-1,-1,0,-1
KR_6753384693,420,-2,28,-1,-9,-3,3,0,-5,6,1,0,2,2,1,5,6,-2,2,0,0,-10,-20,1,-3,2,0,0,0,1,-1,1,-1,3,-1
KR_6769525244,420,0,10,24,-1,0,1,1,-1,3,2,7,1,8,-8,8,0,1,0,1,2,-11,4,1,-4,3,1,0,1,1,1,1,1,1,-1
KR_6754287284,420,0,-49,27,0,-2,2,0,-2,2,0,3,2,5,1,0,1,0,0,0,0,2,-49,2,-7,5,28,0,-1,1,1,-1,1,3,-1
KR_6742050248,420,-3,13,-24,-6,-3,3,0,-5,6,1,2,2,4,0,3,3,0,0,0,0,-5,-3,1,-9,8,-3,0,-1,-1,-1,-1,1,4,-1
KR_6720706388,420,-1,-40,-11,-2,2,0,2,0,3,3,1,1,2,-3,3,0,-2,2,0,0,-9,-3,-4,-4,8,6,0,-2,-1,-1,-1,1,4,-1
KR_6731737794,420,-1,-10,-52,-2,-2,4,2,0,3,3,-1,2,1,-1,1,0,2,0,2,0,2,-108,4,-5,1,-2,0,0,-1,1,0,1,6,-1
KR_6682203184,420,-4,-27,-16,-2,-4,5,1,0,4,4,2,0,2,3,2,5,-3,3,0,0,-1,10,4,-8,4,2,0,-1,1,0,-1,-1,6,-1
KR_6756629064,420,1,15,23,-4,-4,5,1,0,2,2,-1,2,1,3,1,4,-2,7,5,0,4,-5,-2,-3,5,-3,0,-1,1,-1,-1,-1,2,-1
KR_6756294326,420,-1,-41,9,-5,0,2,2,-4,6,2,2,0,2,-2,4,2,-1,1,0,0,-6,6,-1,-4,5,3,0,0,-1,1,0,-1,3,-1
KR_6770452922,420,-3,20,-20,-2,0,2,2,1,2,3,0,1,1,-3,4,1,0,0,0,0,-4,7,2,-6,4,5,0,-1,1,-1,-1,1,5,-1
KR_6684802988,420,-3,-35,-24,-6,-2,3,1,-2,4,2,2,2,4,-1,1,0,-3,3,0,0,-5,-197,1,-5,4,-1,0,-1,-1,1,-1,-1,3,-1
KR_6699231644,420,-2,-33,-32,-4,-1,2,1,-2,4,2,4,5,9,-6,7,1,1,1,2,0,-9,-8,0,-5,5,5,0,-2,-1,-1,-1,-1,4,-1
KR_6729985418,420,-3,-68,-6,-3,-3,3,0,3,3,6,1,3,4,-2,2,0,-2,2,0,0,-6,-3,1,-8,7,5,0,0,-1,1,1,-1,4,-1
KR_6755668951,420,-1,31,-23,5,5,0,5,2,2,4,-4,5,1,4,0,4,-2,2,0,1,9,7,2,-6,4,-8,0,0,1,-1,0,1,6,-1
KR_6744145065,420,-5,-72,-3,-4,1,1,2,-4,5,1,-1,5,4,1,1,2,-1,1,0,0,-4,9,5,-11,6,-5,0,1,-1,1,1,-1,3,-1
KR_6761191844,420,-2,-59,13,-11,-4,4,0,-3,4,1,1,2,3,-3,4,1,-2,4,2,0,-5,-340,-2,-2,4,0,0,-2,-1,-1,-1,-1,2,-1
KR_6763329301,420,-2,-88,-36,-12,-3,3,0,-2,5,3,-2,3,1,-10,12,2,5,2,7,-1,-14,13,2,-7,5,-5,0,-1,-1,-1,-1,-1,1,-1
KR_6732270966,440,0,-20,16,-2,2,1,3,1,3,4,-3,3,0,0,2,2,-2,4,2,0,-2,108,2,-6,4,0,0,0,1,-1,0,1,6,-1
KR_6767841588,420,-6,-112,-7,-12,0,2,2,-3,4,1,-3,3,0,-3,3,0,-3,3,0,0,-14,-6,1,-5,4,-1,0,-2,-1,1,-1,1,1,-1
KR_6759775815,420,2,-39,4,5,-4,5,1,4,0,4,2,1,3,3,0,3,0,0,0,1,8,140,5,-6,1,0,0,1,1,0,1,1,4,-1
KR_6766432689,420,-1,-13,0,-4,3,0,3,0,4,4,0,4,4,-5,5,0,-2,3,1,0,-13,3,-5,-2,7,-1,0,-1,-1,-1,1,1,1,-1
KR_6763475463,420,-1,-16,-33,-4,1,2,3,-1,2,1,0,2,2,-3,3,0,-1,2,1,0,-10,9,0,-6,6,-13,0,-2,-1,0,-1,1,4,-1
KR_6763864785,420,-3,-11,-26,-9,2,0,2,-2,3,1,-3,3,0,-4,4,0,-2,2,0,0,-15,1,2,-9,7,2,0,-1,-1,-1,-1,1,1,-1
KR_6761555593,420,-2,-62,-6,-2,-1,2,1,-1,4,3,0,4,4,-1,4,3,1,1,2,0,2,38,-4,-4,8,-23,0,-2,-1,-1,-1,-1,3,-1
KR_6762674370,420,-2,-34,49,-10,-1,2,1,-2,4,2,-4,4,0,-2,5,3,-1,1,0,0,-9,-8,4,-6,2,-4,0,-2,-1,-1,-1,-1,3,-1
KR_6760848333,420,1,-58,4,2,0,2,2,4,0,4,-1,4,3,-1,3,2,0,0,0,0,6,7,5,-7,2,-6,0,0,1,1,0,-1,3,-1
KR_6770964372,420,-5,-22,-30,-4,0,2,2,0,2,2,-7,11,4,1,1,2,2,2,4,0,0,7,2,-6,4,-5,0,-1,0,1,-1,-1,0,-1
KR_6757231649,420,0,-60,38,3,-2,6,4,4,1,5,1,0,1,1,2,3,-1,2,1,0,10,-130,-2,-2,4,-3,0,-2,1,1,1,1,6,-1
KR_6764747475,440,-3,-53,3,-8,-2,2,0,0,2,2,0,3,3,-4,4,0,-2,2,0,0,-19,-2,1,-8,7,-3,0,-1,-1,1,-1,1,1,-1
KR_6730185515,420,-1,-25,9,-2,1,0,1,-5,5,0,-3,4,1,4,1,5,1,0,1,1,1,-11,-1,-3,4,5,0,0,-1,-1,-1,1,5,-1
KR_6766650535,420,-1,41,-15,-1,1,1,2,0,2,2,-2,7,5,-2,4,2,2,0,2,0,-1,-3,-1,-7,8,0,0,0,-1,0,0,-1,1,-1
KR_6767643682,420,0,-13,-8,-2,5,1,6,-2,5,3,-3,3,0,-1,2,1,-1,2,1,0,-2,-10,-1,-4,5,-5,0,0,-1,1,1,1,5,-1
KR_6769045129,420,-4,13,-12,-5,-2,2,0,1,3,4,0,1,1,0,2,2,-4,4,0,0,-6,-1,5,-9,4,-3,0,-2,-1,-1,-1,-1,4,-1
KR_6760482653,420,0,32,-20,-2,-2,4,2,2,0,2,0,2,2,0,1,1,-2,2,0,0,7,22,-1,-4,5,0,0,-1,-1,1,-1,1,2,-1
KR_6767016233,420,-1,72,-9,-5,-4,4,0,-1,3,2,0,2,2,0,4,4,0,0,0,0,-3,-16,1,-6,5,-3,0,-1,0,-1,-1,-1,0,-1
KR_6756806927,420,-1,-45,-4,-2,-4,5,1,1,3,4,2,1,3,0,2,2,-1,1,0,0,-3,11,4,-8,4,-2,0,0,0,-1,-1,1,0,-1
KR_6746487291,420,-2,-71,0,-3,-2,2,0,-1,3,2,-1,3,2,0,1,1,1,1,2,0,-4,8,1,-4,3,-3,0,-1,0,-1,-1,-1,0,-1
KR_6734146883,420,-3,-87,-28,-10,-2,3,1,1,5,6,-6,7,1,-3,3,0,0,0,0,0,-13,2,1,-6,5,-2,0,-1,-1,1,-1,-1,3,-1
KR_6721944998,420,0,-17,8,-6,-2,3,1,-1,4,3,-2,2,0,-2,3,1,1,2,3,0,-4,4,0,-5,5,-8,0,0,1,-1,0,-1,2,-1
KR_6758594757,420,1,27,22,6,-2,2,0,1,2,3,4,2,6,1,1,2,2,2,4,0,10,16,2,-6,4,4,0,1,1,1,1,1,6,-1
KR_6701306758,420,-3,-46,-8,-11,-5,5,0,-4,5,1,-1,2,1,-1,2,1,0,1,1,0,-8,-2,-3,-4,7,-7,0,-1,-1,-1,-1,-1,2,-1
KR_6721799070,420,1,-15,19,-4,1,0,1,-1,3,2,-4,5,1,1,3,4,-1,3,2,0,-7,173,-2,-7,9,-22,0,0,1,-1,-1,-1,3,-1
KR_6556703768,420,-1,-50,-26,-2,-5,5,0,2,0,2,3,1,4,-2,4,2,0,0,0,0,8,-16,4,-8,4,4,0,-1,-1,-1,-1,1,1,-1
KR_6755621624,420,-3,36,-15,-5,1,1,2,-2,2,0,0,3,3,-2,3,1,-2,2,0,0,-11,6,1,-7,6,-9,0,0,-1,0,0,1,4,-1
KR_6765342716,420,-2,-2,-25,-3,-1,2,1,1,2,3,-3,4,1,-1,2,1,1,2,3,0,-3,119,-2,-4,6,-3,0,0,1,1,-1,1,6,-1
KR_6685950501,420,-1,-15,2,-5,-2,4,2,0,4,4,-6,6,0,1,0,1,2,2,4,0,1,130,-1,-5,6,4,0,0,-1,1,0,-1,3,-1
KR_6764775606,420,-3,10,5,-15,-1,2,1,-3,4,1,-1,1,0,-4,5,1,-6,7,1,0,-18,-1,-2,-5,7,4,0,1,-1,0,1,-1,6,-1
KR_6705476828,420,-2,-32,2,-7,0,2,2,0,3,3,-4,5,1,-2,3,1,-1,1,0,0,-11,16,-4,-3,7,1,0,0,-1,-1,0,-1,1,-1
KR_6742808158,420,-4,-52,2,-11,-3,3,0,3,1,4,-6,8,2,-5,6,1,0,1,1,0,-13,22,-4,-5,9,-7,0,-1,1,1,-1,-1,4,-1
KR_6754462887,420,-2,-50,-8,-3,-2,4,2,-1,1,0,1,4,5,0,5,5,-1,2,1,0,-5,10,-2,-4,6,-2,0,0,-1,-1,0,1,5,-1
KR_6764375223,420,1,-7,-9,-2,-1,1,0,-2,2,0,-1,5,4,1,3,4,1,1,2,0,3,-6,5,-10,5,2,0,0,1,-1,0,-1,4,-1
KR_6762184421,420,0,14,8,-2,-2,2,0,-2,4,2,2,1,3,-4,5,1,4,0,4,0,-5,-20,0,-8,8,3,0,1,1,1,1,-1,5,-1
KR_6685068601,420,-4,-30,-7,-11,0,2,2,-6,6,0,-2,3,1,-1,1,0,-2,2,0,0,-17,8,7,-10,3,-1,0,1,0,1,1,-1,0,-1
KR_6685746188,420,-5,-16,27,-12,-4,4,0,0,2,2,-4,8,4,-5,8,3,1,0,1,2,-13,4,1,-7,6,-3,0,-1,-1,-1,-1,1,6,-1
KR_6693966624,420,-4,-37,12,-16,-1,2,1,0,3,3,-4,5,1,-7,7,0,-4,4,0,0,-22,-6,-2,-3,5,-4,0,0,-1,-1,0,-1,1,-1
KR_6751859974,420,0,54,-25,3,-1,3,2,1,2,3,0,1,1,2,0,2,1,2,3,0,6,0,3,-7,4,-3,0,0,-1,-1,0,1,2,-1
KR_6745281196,420,-5,-87,12,-12,-1,1,0,0,4,4,-3,7,4,-4,7,3,-4,4,0,0,-13,27,-6,-3,9,-1,0,-1,0,-1,-1,1,0,-1
KR_6767259113,440,0,-46,0,4,-1,3,2,4,1,5,2,1,3,-2,4,2,1,1,2,0,5,-2,-1,-2,3,0,0,-1,1,0,-1,1,5,-1
KR_6765114011,420,-3,-40,-12,-7,-4,7,3,-1,4,3,0,1,1,-1,3,2,-1,3,2,0,-4,1,4,-7,3,2,0,-2,1,-1,-1,-1,4,-1
KR_6764279878,420,-1,-55,6,-3,-5,5,0,-1,2,1,0,4,4,2,1,3,1,1,2,0,4,-2,0,-7,7,0,0,-1,1,-1,-1,-1,3,-1
KR_6764870115,440,-1,-16,-19,2,0,0,0,2,1,3,1,1,2,0,3,3,-1,2,1,0,10,30,4,-10,6,-4,0,-1,-1,0,-1,1,4,-1
KR_6757774901,440,2,-15,15,-2,1,0,1,-4,5,1,-2,2,0,7,1,8,-4,4,0,-1,-3,-13,3,-6,3,6,0,0,1,-1,0,-1,6,-1
KR_6715594807,420,0,33,12,-4,-2,3,1,-4,5,1,-1,4,3,4,1,5,-1,1,0,0,-6,-1,-1,-5,6,1,0,2,-1,1,1,-1,2,-1
KR_6766397217,420,-2,-54,-8,-10,2,2,4,-6,9,3,-2,2,0,-1,2,1,-3,3,0,0,-10,-5,-1,-5,6,0,0,-1,-1,-1,-1,-1,3,-1
KR_6767090169,420,3,-40,4,2,-2,4,2,1,3,4,0,1,1,3,0,3,0,0,0,-1,7,19,0,-6,6,3,0,0,1,-1,1,-1,5,-1
KR_6769549456,420,3,56,-12,1,2,1,3,-7,7,0,3,0,3,3,2,5,0,1,1,0,1,118,2,-8,6,3,0,0,-1,1,0,-1,3,-1
KR_6607827084,420,-2,6,-47,-5,-2,3,1,-6,6,0,0,4,4,3,0,3,0,1,1,0,-7,9,1,-6,5,3,0,0,0,-1,-1,1,0,-1
KR_6681482096,420,-2,-44,-48,-7,-4,5,1,2,2,4,-2,2,0,1,1,2,-4,4,0,0,-3,-8,-2,-5,7,4,0,0,1,-1,1,-1,1,-1
KR_6644758916,420,0,3,21,5,2,2,4,1,5,6,-1,1,0,5,0,5,-2,2,0,0,6,-48,-1,-3,4,6,0,0,-1,1,0,1,3,-1
KR_6718545946,420,-4,-84,0,-1,-3,4,1,0,6,6,3,3,6,0,3,3,-1,1,0,1,-1,15,-1,-4,5,-4,0,-1,1,1,-1,1,6,-1
KR_6741326032,420,-1,-59,-12,1,-6,7,1,6,1,7,-4,5,1,5,1,6,0,0,0,0,13,5,2,-6,4,-6,0,-1,0,1,-1,1,0,-1
KR_6769373822,420,-7,-55,-42,-10,-6,7,1,0,3,3,-4,7,3,0,2,2,0,1,1,0,-4,0,1,-6,5,-1,0,0,-1,-1,-1,-1,3,-1
KR_6677023910,420,-3,-85,-34,-7,-2,2,0,0,1,1,-1,2,1,-4,7,3,0,1,1,0,-8,-5,3,-7,4,1,0,-1,-1,-1,-1,1,4,-1
KR_6766677876,440,0,-66,6,-4,-1,1,0,1,1,2,0,2,2,-3,7,4,-1,2,1,0,-10,-5,-3,-3,6,-2,0,-1,1,-1,-1,-1,4,-1
KR_6753178713,420,-1,-13,-4,4,1,3,4,-1,5,4,2,1,3,1,2,3,1,1,2,0,3,-16,1,-7,6,1,0,-1,1,-1,-1,-1,5,-1
KR_6765669805,440,-2,-95,-8,-6,-1,2,1,1,0,1,-4,6,2,0,4,4,-2,6,4,-1,3,4,1,-7,6,0,0,-3,1,-1,-1,-1,5,-1
KR_6768754359,440,-2,19,4,-6,2,1,3,0,2,2,-3,3,0,-6,6,0,1,3,4,0,-7,-29,-6,-3,9,-2,0,0,-1,1,1,-1,3,-1
KR_6727701342,420,-2,-50,4,-6,3,1,4,-5,5,0,-1,1,0,-4,9,5,1,0,1,2,-4,136,0,-5,5,2,0,-2,-1,-1,-1,1,6,-1
KR_6763496684,440,0,-77,4,-1,-2,2,0,0,3,3,2,1,3,0,2,2,-1,1,0,0,0,166,4,-5,1,-3,0,0,1,1,0,-1,5,-1
KR_6769059806,420,2,-16,-12,-4,-1,3,2,-1,2,1,2,1,3,-3,4,1,-1,1,0,0,-5,0,-4,-2,6,1,0,-1,1,-1,-1,1,6,-1
KR_6734323099,420,1,-8,16,-5,1,4,5,-1,5,4,-4,5,1,0,4,4,-1,1,0,-1,-1,34,-3,-4,7,-10,0,0,-1,1,-1,-1,6,-1
KR_6755436494,420,-2,29,-16,-3,-3,3,0,-3,4,1,4,2,6,0,4,4,-1,1,0,1,-5,9,7,-9,2,2,0,-2,-1,-1,-1,1,2,-1
KR_6770934052,420,-2,-56,-20,-7,-3,3,0,2,2,4,0,1,1,-4,5,1,-2,2,0,0,-2,-449,1,-4,3,4,0,0,-1,0,0,-1,5,-1
KR_6768675322,420,-2,-95,-19,4,0,0,0,-1,4,3,-2,2,0,6,1,7,1,1,2,1,4,-20,-4,-5,9,0,0,1,-1,1,1,1,6,-1
KR_6648050015,420,1,-6,-16,0,3,2,5,3,1,4,-7,7,0,1,0,1,0,1,1,0,3,33,-2,-7,9,-1,0,0,1,-1,-1,-1,3,-1
KR_6741416901,420,-3,-32,-33,-1,-1,3,2,-1,4,3,2,2,4,-1,3,2,0,0,0,0,6,12,4,-7,3,-1,0,-1,-1,-1,-1,-1,6,-1
KR_6612684077,420,1,47,-5,0,0,1,1,-3,3,0,2,2,4,1,1,2,0,1,1,0,-6,7,2,-7,5,0,0,1,-1,-1,1,1,1,-1
KR_6701195536,420,-6,-120,19,-14,-3,3,0,-4,10,6,-5,7,2,-3,4,1,1,1,2,-1,-15,-20,1,-7,6,-7,0,-2,-1,-1,-1,-1,5,-1
KR_6749582799,420,-2,4,-27,-11,2,0,2,0,3,3,-10,10,0,-3,5,2,0,2,2,-1,-8,5,1,-4,3,0,0,-1,1,-1,-1,-1,3,-1
KR_6716212636,420,-1,-30,0,-10,-3,3,0,0,2,2,-3,3,0,-4,7,3,0,1,1,1,-11,1,4,-10,6,-2,0,1,-1,-1,1,1,5,-1
KR_6665139662,420,0,1,24,4,0,0,0,2,1,3,2,0,2,0,1,1,0,0,0,0,3,5,5,-9,4,-3,0,-1,-1,1,1,-1,1,-1
KR_6767069753,440,0,45,-1,0,2,0,2,-1,2,1,-3,3,0,1,1,2,1,0,1,0,0,-3,-8,-2,10,4,0,2,-1,1,1,-1,3,-1
KR_6746272340,420,0,-25,40,-15,-2,2,0,-1,5,4,-8,8,0,-3,5,2,-1,1,0,0,-13,18,-1,-6,7,-9,0,-1,1,-1,-1,-1,1,-1
KR_6648583499,420,1,-79,-12,-1,-4,4,0,3,1,4,1,2,3,-3,6,3,2,0,2,0,-3,2,-1,-9,10,-2,0,0,-1,1,0,-1,6,-1
KR_6744830599,440,-4,-42,-20,-4,1,1,2,-3,5,2,1,4,5,-1,2,1,-2,2,0,0,0,-1,-2,-5,7,-4,0,0,-1,1,0,-1,6,-1
KR_6751121861,420,-4,-34,-36,-9,-2,3,1,-2,3,1,-2,4,2,-2,4,2,-1,1,0,0,-1,21,-2,-8,10,-4,0,-1,-1,-1,-1,-1,5,-1
KR_6673802876,420,1,13,-24,-4,0,2,2,-1,3,2,-3,3,0,0,4,4,0,1,1,0,-3,-29,1,-5,4,-1,0,-1,0,-1,-1,-1,0,-1
KR_6742193571,420,-1,13,8,-4,-1,1,0,3,1,4,1,3,4,-3,6,3,-4,4,0,-1,-11,-2,-5,-3,8,4,0,-1,-1,-1,-1,-1,3,-1
KR_6758741552,420,-3,24,-5,-13,-1,2,1,1,2,3,-3,5,2,-9,9,0,-1,2,1,0,-9,19,0,-4,4,-2,0,0,-1,-1,0,1,5,-1
KR_6764711783,420,-3,-37,-24,-5,-6,6,0,-2,5,3,-2,3,1,6,2,8,-1,1,0,0,7,0,1,-7,6,5,0,1,-1,-1,1,1,1,-1
KR_6748405445,420,0,-42,16,1,-2,3,1,6,1,7,0,2,2,-2,3,1,-1,1,0,0,-6,-2,1,-8,7,-4,0,-1,-1,-1,-1,1,4,-1
KR_6763320185,420,-5,-20,-16,-10,0,0,0,-7,7,0,-4,5,1,1,2,3,0,1,1,0,-14,-136,-1,-3,4,-1,0,-1,-1,-1,-1,1,6,-1
KR_6697495592,420,1,12,23,-4,2,2,4,-4,5,1,2,0,2,-4,6,2,0,1,1,1,-9,-5,-1,-5,6,-1,0,0,-1,1,1,1,6,-1
KR_6770443018,420,-4,-54,-4,2,-4,5,1,1,2,3,5,3,8,0,0,0,0,0,0,0,1,14,-2,-4,6,4,0,-1,1,1,-1,1,4,-1
KR_6686047172,420,-2,-17,-2,-4,-5,5,0,2,5,7,2,1,3,0,1,1,-3,3,0,0,-1,118,0,-6,6,1,0,-1,-1,-1,-1,-1,1,-1
KR_6764932272,420,-2,52,-27,-13,-4,5,1,2,1,3,-4,6,2,-6,6,0,-1,3,2,0,-16,55,-7,-4,11,-1,0,0,-1,-1,0,-1,5,-1
KR_6741436953,440,0,11,20,4,-2,3,1,-1,3,2,8,0,8,-2,2,0,1,1,2,-1,-1,4,-2,-6,8,-2,0,0,1,1,0,-1,4,-1
KR_6747711330,420,-2,19,-5,-5,-3,6,3,3,1,4,-1,2,1,-3,8,5,-1,1,0,0,-7,-10,0,-5,5,0,0,0,-1,-1,-1,-1,3,-1
KR_6631091842,420,-4,-17,-28,-4,-1,1,0,-3,5,2,-4,5,1,5,0,5,-1,1,0,0,-1,75,-1,-5,6,-6,0,-1,1,1,-1,-1,2,-1
KR_6703005963,420,1,-2,22,5,1,0,1,4,2,6,2,0,2,-4,6,2,2,2,4,1,3,85,-4,-3,7,1,0,0,-1,-1,1,1,3,-1
KR_6732735782,420,-1,-31,21,-6,-1,1,0,2,2,4,-2,5,3,-6,7,1,1,0,1,1,-6,127,4,-9,5,-7,0,0,1,1,0,1,6,-1
KR_6740640092,420,-5,-34,-1,-2,3,0,3,-1,3,2,3,1,4,-9,10,1,2,0,2,0,-5,-8,-3,-6,9,2,0,-1,-1,1,-1,-1,2,-1
KR_6770098389,420,-6,-27,-14,-15,-5,5,0,-5,6,1,1,1,2,-5,7,2,-1,2,1,-1,-11,-2,-3,-1,4,-1,0,-2,-1,-1,-1,-1,4,-1
KR_6751912191,420,0,-23,9,-3,0,2,2,0,1,1,1,1,2,-5,7,2,1,0,1,0,-3,-7,0,-4,4,-1,0,0,0,-1,0,-1,0,-1
KR_6768802108,420,-1,-22,-8,3,1,1,2,2,2,4,-1,2,1,-1,2,1,2,0,2,0,4,4,-3,-4,7,-3,0,0,-1,-1,0,-1,6,-1
KR_6739370225,440,-3,-63,-42,-9,-3,3,0,-5,7,2,-1,4,3,-1,1,0,1,0,1,0,-8,-106,2,-3,1,-4,0,-3,0,-1,-1,-1,0,-1
KR_6749695905,420,-1,-7,-47,-6,0,3,3,-4,4,0,-4,5,1,-1,3,2,3,0,3,0,-5,-1,-2,-2,4,-3,0,-2,-1,-1,-1,-1,2,-1
KR_6770656026,420,-2,-6,20,-5,-1,1,0,-4,4,0,1,1,2,-2,4,2,1,0,1,-1,-12,-1,0,-3,3,-4,0,0,-1,1,-1,-1,1,-1
KR_6768238350,420,2,59,-16,3,2,1,3,5,1,6,-1,4,3,-2,4,2,-1,1,0,0,-5,-5,-1,-4,5,4,0,3,-1,1,1,1,3,-1
KR_6757457516,420,-3,39,-27,-9,0,0,0,0,4,4,-3,4,1,-6,7,1,0,1,1,-1,-18,-64,1,-4,3,-3,0,-1,-1,-1,-1,-1,1,-1
KR_6758428043,420,2,65,4,3,3,0,3,-3,6,3,0,3,3,2,1,3,1,0,1,1,2,-14,-3,-2,5,5,0,0,1,1,0,1,1,-1
KR_6650098827,420,-3,-62,-16,-6,5,1,6,-5,8,3,-5,8,3,-3,4,1,2,0,2,0,-7,4,1,-5,4,4,0,-1,-1,-1,-1,-1,5,-1
KR_6764972052,420,-2,-94,-9,-1,0,1,1,0,6,6,0,1,1,-1,1,0,0,1,1,0,3,-2,3,-9,6,-1,0,0,0,-1,-1,1,0,-1
KR_6729901847,420,-1,10,-23,0,1,1,2,-3,4,1,0,1,1,1,5,6,1,0,1,0,-2,-31,-1,-5,6,3,0,1,-1,1,1,-1,1,-1
KR_6770598503,420,0,-18,8,3,-1,1,0,2,1,3,3,0,3,-1,1,0,0,2,2,0,1,-7,-3,-3,6,-1,0,0,-1,1,0,-1,2,-1
KR_6751228932,440,-1,-83,0,-1,-2,3,1,3,0,3,3,0,3,-3,4,1,-2,2,0,0,2,-13,1,-4,3,0,0,0,-1,0,0,1,5,-1
KR_6685886092,420,-5,-22,10,-13,-4,4,0,-4,6,2,-1,2,1,-3,5,2,-1,1,0,0,-16,-21,-7,-2,9,-2,0,-2,-1,-1,-1,-1,3,-1
KR_6750054663,420,-3,-14,9,-5,-1,2,1,3,0,3,-4,6,2,-3,4,1,0,0,0,0,2,-17,-4,-6,10,1,0,-1,1,-1,-1,-1,3,-1
KR_6606645167,420,-7,-66,-32,-13,-4,4,0,-3,3,0,-3,3,0,-1,2,1,-2,2,0,0,-13,0,-3,-3,6,-3,0,-2,-1,-1,-1,-1,1,-1
KR_6762590749,420,-1,3,4,-3,2,1,3,-4,4,0,0,1,1,1,0,1,-2,2,0,1,-9,2,-2,-3,5,1,0,-1,-1,-1,-1,1,4,-1
KR_6770560578,420,3,0,-14,7,-2,2,0,0,3,3,5,0,5,4,3,7,0,0,0,0,4,3,-1,-8,9,0,0,0,1,-1,1,1,2,-1
KR_6742170038,420,-5,-67,-16,-2,4,0,4,-4,5,1,0,2,2,-2,4,2,0,2,2,0,-4,-8,-2,-6,8,-3,0,-1,-1,-1,-1,-1,2,-1
KR_6724030908,420,-2,1,5,0,-2,2,0,-1,5,4,-2,4,2,4,1,5,1,0,1,0,-1,202,-1,-2,3,1,0,-1,1,-1,-1,-1,5,-1
KR_6757117219,420,0,17,-40,9,3,2,5,1,5,6,6,1,7,-1,1,0,0,3,3,1,13,1,4,-7,3,3,0,1,-1,1,1,1,4,-1
KR_6747485544,420,-3,27,-20,-3,-3,4,1,-2,6,4,-2,4,2,2,2,4,2,0,2,0,-3,17,9,-11,2,-3,0,0,1,-1,1,1,6,-1
KR_6700885223,420,-7,-34,-28,-13,-2,3,1,-2,4,2,-6,6,0,-2,5,3,-1,1,0,0,-10,-6,-1,-5,6,0,0,-3,1,-1,-1,-1,2,-1
KR_6765253870,420,-3,-20,-7,-2,-1,1,0,-4,5,1,0,1,1,0,1,1,3,0,3,0,-3,-2,1,-5,4,2,0,-1,1,-1,-1,-1,4,-1
KR_6757605022,420,-2,-27,-19,1,-3,5,2,1,0,1,-2,5,3,6,1,7,-1,3,2,0,4,13,0,-5,5,1,0,0,-1,-1,-1,-1,5,-1
KR_6724926507,420,-2,-43,11,-3,-5,5,0,-3,4,1,-2,3,1,5,0,5,2,1,3,0,-6,23,-2,-6,8,6,0,0,1,-1,1,1,1,-1
KR_6757828594,420,0,22,8,2,2,0,2,0,1,1,0,1,1,1,2,3,-1,1,0,0,4,4,1,-6,5,0,0,0,-1,1,0,1,3,-1
KR_6746801503,420,-3,16,-21,-6,-12,12,0,1,2,3,-1,4,3,6,0,6,0,2,2,0,16,-5,2,-8,6,-2,0,-1,0,-1,-1,-1,0,-1
KR_6741207422,420,-6,-66,-29,-14,-4,5,1,0,4,4,-1,6,5,-6,6,0,-3,3,0,-1,-23,-6,-4,-1,5,4,0,-2,1,-1,-1,-1,6,-1
KR_6729702060,420,1,-43,12,-2,0,3,3,-2,3,1,-1,3,2,3,1,4,-2,2,0,0,-3,-35,-1,-4,5,3,0,0,0,-1,0,-1,0,-1
KR_6742783107,420,-4,-68,-16,-9,3,0,3,-6,6,0,-1,1,0,-4,6,2,-1,2,1,-1,-19,-45,-6,0,6,1,0,-1,-1,-1,-1,-1,2,-1
KR_6740726994,420,-7,-71,17,-18,-6,7,1,-3,3,0,-4,7,3,-5,6,1,0,0,0,0,-26,14,1,-5,4,1,0,-2,0,-1,-1,-1,0,-1
KR_6722566261,420,-1,-12,-26,-11,-4,5,1,-5,8,3,-2,4,2,0,2,2,0,0,0,0,-8,-77,-1,-4,5,4,0,0,-1,-1,-1,-1,2,-1
KR_6733334490,420,-1,-61,12,2,1,2,3,1,2,3,1,4,5,-1,4,3,0,1,1,0,-2,-4,3,-6,3,-2,0,-1,-1,1,-1,1,4,-1
KR_6730606034,420,2,-10,-20,2,2,1,3,-4,6,2,2,1,3,1,2,3,1,1,2,0,0,-5,1,-7,6,-1,0,-1,-1,-1,-1,1,3,-1
KR_6733982908,420,-4,9,-4,-12,-6,7,1,-3,5,2,-1,3,2,1,2,3,-3,6,3,0,-9,5,4,-6,2,-2,0,-1,1,-1,-1,-1,3,-1
KR_6710523806,420,1,6,3,4,-1,3,2,4,1,5,4,0,4,-3,6,3,0,1,1,0,8,11,-1,-3,4,1,0,0,-1,1,1,1,2,-1
KR_6723077840,420,-1,2,-17,0,0,3,3,4,2,6,0,4,4,-3,4,1,-1,2,1,-1,-4,203,5,-8,3,2,0,1,-1,-1,1,-1,6,-1
KR_6739898124,420,0,-53,12,1,1,2,3,-3,4,1,-4,5,1,3,1,4,4,0,4,1,5,-21,-5,-4,9,2,0,0,-1,1,0,1,5,-1
KR_6762405858,420,2,-10,-12,-1,-1,4,3,1,1,2,3,2,5,-7,8,1,3,0,3,0,-5,-29,-5,-1,6,5,0,-1,0,-1,-1,-1,0,-1
KR_6747557482,420,-1,-23,3,-3,-1,1,0,-2,2,0,-1,5,4,0,3,3,1,1,2,0,-3,20,5,-7,2,-2,0,-1,-1,-1,-1,-1,6,-1
KR_6689624716,440,4,77,-19,13,3,0,3,1,3,4,2,2,4,1,3,4,6,1,7,2,15,-16,-4,-4,8,1,0,0,0,1,-1,1,0,-1
KR_6770277282,440,-3,-15,25,-10,-2,2,0,2,1,3,-2,4,2,-5,6,1,-3,5,2,0,-13,-17,-3,-5,8,-2,0,-1,-1,-1,-1,1,3,-1
KR_6696085899,420,0,-24,28,2,3,0,3,-1,5,4,4,0,4,-4,5,1,0,1,1,0,-4,0,2,-7,5,3,0,-1,-1,-1,1,1,5,-1
KR_6713811537,420,0,-13,28,-5,-1,3,2,-2,3,1,2,1,3,-3,3,0,-1,4,3,-2,-12,119,-2,-4,6,2,0,0,-1,1,-1,-1,1,-1
KR_6745185100,420,-3,-36,3,-6,-2,3,1,-3,4,1,0,3,3,0,5,5,-1,1,0,0,-3,3,-2,-5,7,-17,0,0,1,-1,-1,-1,1,-1
KR_6655779407,420,0,-45,16,4,5,2,7,-1,2,1,1,1,2,-1,3,2,0,1,1,0,2,-4,-3,-5,8,1,0,0,1,-1,-1,1,6,-1
KR_6749095551,420,-2,-88,1,-10,-3,4,1,-2,3,1,2,2,4,-3,3,0,-4,4,0,0,-8,-98,0,-2,2,-7,0,-2,-1,0,-1,-1,6,-1
KR_6762391212,420,0,20,3,-5,0,0,0,0,4,4,-1,3,2,-3,3,0,-1,2,1,0,-4,-2,-3,-4,7,8,0,0,-1,1,0,-1,5,-1
KR_6741824712,420,0,-49,-9,2,0,1,1,5,1,6,-3,3,0,-1,2,1,1,0,1,0,4,139,-2,-4,6,0,0,0,-1,-1,-1,1,2,-1
KR_6729585798,420,-2,0,0,-7,-1,3,2,-2,5,3,-3,3,0,-4,4,0,3,0,3,0,-3,-17,2,-7,5,-1,0,0,1,0,0,-1,6,-1
KR_6548373754,420,-5,-40,-8,-14,-4,5,1,-5,5,0,-2,5,3,-3,4,1,0,1,1,0,-11,-2,-2,-5,7,2,0,-2,-1,1,-1,-1,4,-1
KR_6724922373,420,-3,-2,-12,0,4,0,4,-5,6,1,0,2,2,0,1,1,1,0,1,0,-1,37,1,-7,6,-8,0,-1,-1,-1,-1,-1,6,-1
KR_6710590766,420,-6,-103,-16,-13,-5,5,0,3,1,4,-4,4,0,-4,5,1,-3,3,0,0,-6,11,0,-5,5,1,0,-2,-1,-1,-1,-1,4,-1
KR_6766588094,420,-1,15,-18,-3,1,3,4,0,2,2,-1,2,1,-1,2,1,-2,3,1,1,0,-4,0,-5,5,-1,0,0,-1,1,1,1,5,-1
KR_6754413232,420,-3,-42,-16,-7,0,3,3,1,0,1,-4,5,1,-3,7,4,-1,1,0,0,-13,2,2,-5,3,-2,0,-2,-1,1,-1,1,3,-1
KR_6734189816,420,-2,-15,-10,-8,-2,3,1,-2,5,3,0,1,1,-3,7,4,-1,3,2,3,-11,47,-1,-5,6,-3,0,-2,-1,-1,-1,1,4,-1
KR_6768497025,420,-3,-47,-16,-4,-1,4,3,-1,2,1,-2,5,3,-2,5,3,2,1,3,0,-3,-6,-1,-6,7,-1,0,0,-1,1,0,-1,4,-1
KR_6757656679,420,-3,-6,-40,-3,0,0,0,0,4,4,3,3,6,-7,7,0,1,0,1,0,-7,-35,-2,-5,7,0,0,0,-1,-1,0,1,3,-1
KR_6770360837,420,4,-10,14,13,5,0,5,-2,3,1,8,1,9,2,5,7,0,1,1,1,18,-2,2,-6,4,2,0,1,0,1,1,1,0,-1
KR_6764987901,420,-1,-4,2,-6,-6,8,2,0,2,2,-2,3,1,2,2,4,0,1,1,0,-8,2,-1,-5,6,2,0,1,1,-1,1,1,2,-1
KR_6763404231,420,-2,-66,-12,0,-2,2,0,4,0,4,-2,2,0,-1,4,3,1,0,1,0,6,-33,-2,-5,7,21,0,-2,-1,1,-1,1,6,-1
KR_6767312946,420,-2,4,1,-10,-4,4,0,-2,4,2,-6,7,1,2,2,4,0,1,1,0,-18,-10,-2,-5,7,-4,0,-2,-1,-1,-1,-1,2,-1
KR_6763377560,440,0,-3,27,0,0,1,1,-1,5,4,2,1,3,1,0,1,-2,3,1,0,-4,10,5,-6,1,-5,0,0,-1,1,0,1,5,-1
KR_6734845201,420,-4,-103,-8,-14,-1,2,1,-3,6,3,-3,3,0,-2,2,0,-5,5,0,0,-15,-5,1,-7,6,-5,0,-2,-1,-1,-1,-1,1,-1
KR_6740766752,420,-4,-44,18,-15,-5,6,1,-1,4,3,-5,5,0,-3,3,0,-1,2,1,-1,-25,-9,-5,-3,8,0,0,-1,-1,1,-1,-1,6,-1
KR_6740658752,420,2,-7,17,4,5,1,6,-2,6,4,4,0,4,0,1,1,-3,3,0,0,1,-15,4,-5,1,2,0,1,1,1,1,1,4,-1
KR_6738169748,420,-1,-26,-39,1,1,1,2,-1,4,3,7,2,9,-5,7,2,-1,1,0,0,3,178,1,-7,6,-1,0,0,-1,1,1,-1,5,-1
KR_6426072306,440,-2,4,-21,2,2,1,3,1,2,3,0,3,3,1,1,2,-2,3,1,0,-3,-2,1,-4,3,0,0,0,1,0,0,1,5,-1
KR_6745413566,420,-1,4,-8,-3,3,1,4,-2,2,0,0,2,2,-3,4,1,-1,1,0,0,-9,-50,2,-6,4,13,0,-1,-1,1,-1,-1,4,-1
KR_6688986535,420,1,42,24,-4,-1,2,1,2,2,4,-1,1,0,-3,3,0,-1,1,0,0,-7,3,1,-5,4,6,0,0,-1,-1,1,-1,5,-1
KR_6729308416,420,-3,-7,-3,-12,-5,5,0,-1,3,2,-5,5,0,-1,6,5,0,0,0,0,-6,24,-1,-5,6,-21,0,-1,-1,-1,1,-1,2,-1
KR_6750957342,420,-2,-14,17,-13,-1,3,2,-2,3,1,-5,7,2,-5,7,2,0,1,1,-2,-26,-12,-2,-4,6,1,0,-2,-1,1,-1,-1,3,-1
KR_6760414666,420,3,-38,-11,6,-3,3,0,4,2,6,2,3,5,1,9,10,2,0,2,-3,-3,1,0,-5,5,3,0,2,1,1,1,-1,1,-1
KR_6680016163,420,1,-19,4,4,-1,1,0,2,3,5,1,2,3,3,1,4,-1,2,1,0,-1,206,-3,-4,7,31,0,0,-1,-1,0,-1,1,-1
KR_6760017442,420,-1,2,-10,-4,-2,3,1,-4,8,4,-4,6,2,3,4,7,3,2,5,-1,-1,-7,-2,-3,5,1,0,1,-1,-1,-1,-1,2,-1
KR_6687375586,440,-1,-64,34,-2,0,2,2,2,1,3,-4,7,3,1,2,3,-1,2,1,0,2,-6,-3,-4,7,-1,0,0,0,1,1,1,0,-1
KR_6724679261,440,0,60,-1,-6,3,1,4,0,4,4,-3,7,4,-7,10,3,1,1,2,0,-14,-10,-1,-7,8,2,0,0,-1,1,-1,1,2,-1
KR_6710612763,420,0,10,10,1,1,3,4,-1,4,3,0,0,0,2,2,4,-1,1,0,0,6,1,-2,-3,5,-3,0,-1,-1,0,-1,1,6,-1
KR_6747503768,420,0,-26,5,0,0,1,1,1,1,2,0,1,1,1,1,2,-2,2,0,0,0,0,-2,-3,5,-4,0,0,1,-1,0,1,2,-1
KR_6729623551,420,-2,-22,1,-6,-5,5,0,2,4,6,0,2,2,-2,3,1,-1,2,1,0,-5,-5,1,-3,2,1,0,-1,1,-1,-1,-1,2,-1
KR_6769357571,420,0,-37,13,4,-1,3,2,4,0,4,-2,2,0,3,2,5,0,0,0,0,10,-24,4,-9,5,4,0,-1,-1,-1,-1,1,5,-1
KR_6712087288,420,-9,-83,-43,-22,-6,8,2,-2,4,2,-9,10,1,-3,4,1,-2,3,1,-1,-5,16,-1,-7,8,-3,0,-2,-1,-1,-1,-1,4,-1
KR_6753264401,420,-1,-70,-12,-3,-2,3,1,1,1,2,0,4,4,-2,3,1,0,0,0,0,-2,14,-1,-8,9,5,0,-2,1,-1,-1,-1,2,-1
KR_6744666110,420,-2,-39,-8,-4,0,3,3,-3,5,2,0,4,4,-1,3,2,0,0,0,0,-2,2,-1,-5,6,-4,0,-1,1,-1,-1,-1,4,-1
KR_6760183055,420,-3,24,-28,-6,0,1,1,-1,5,4,0,1,1,-1,2,1,-4,4,0,0,-14,25,-4,-2,6,-17,0,-3,-1,-1,-1,-1,2,-1
KR_6742937321,420,-5,-52,-8,-6,-1,3,2,-2,3,1,1,2,3,-3,3,0,-1,2,1,0,-4,3,3,-4,1,2,0,-2,1,-1,-1,1,6,-1
KR_6711311137,420,1,28,4,0,0,2,2,3,1,4,-4,4,0,2,0,2,-1,3,2,-1,2,-3,1,-6,5,3,0,0,-1,1,-1,-1,2,-1
KR_6770584357,420,-2,-38,-2,0,-4,5,1,1,4,5,2,3,5,-1,4,3,2,1,3,0,4,-4,-3,-4,7,3,0,0,-1,1,1,1,5,-1
KR_6765479584,420,-5,-89,-51,-1,-2,5,3,0,2,2,0,1,1,2,3,5,-1,3,2,-1,4,-4,1,-4,3,-2,0,-2,-1,-1,-1,-1,6,-1
KR_6749540701,420,-1,27,-21,-2,2,1,3,-8,8,0,3,0,3,3,4,7,-2,3,1,-1,-12,-1,-1,-4,5,-3,0,1,-1,1,1,-1,1,-1
KR_6684835249,420,-2,-34,-40,-3,-1,1,0,1,1,2,0,1,1,-2,3,1,-1,2,1,0,-2,-1,4,-11,7,-2,0,0,-1,0,-1,1,4,-1
KR_6761901292,420,-4,-73,-31,-1,2,2,4,0,6,6,-1,6,5,-1,2,1,-1,1,0,0,-4,-28,-2,-1,3,-1,0,-2,1,1,-1,-1,6,-1
KR_6676095257,420,-3,-33,-11,-6,-1,3,2,-4,5,1,0,2,2,-2,2,0,1,0,1,0,-2,1,-1,-5,6,-2,0,0,-1,1,0,-1,1,-1
KR_6628501531,420,-5,-84,3,-14,-7,7,0,-2,2,0,-1,1,0,-2,2,0,-2,3,1,0,-10,-10,0,-3,3,0,0,-1,-1,-1,-1,-1,3,-1
KR_6743230912,420,-4,-64,4,-12,-1,4,3,-3,3,0,-2,3,1,-3,4,1,-3,3,0,0,-10,-6,1,-3,2,-6,0,-1,0,1,1,-1,0,-1
KR_6768404156,420,-4,-11,-17,-5,-2,2,0,1,1,2,-1,3,2,0,1,1,-3,3,0,0,-7,-2,2,-5,3,-2,0,0,-1,1,0,1,2,-1
KR_6659062551,420,-1,54,-32,-4,4,0,4,-9,9,0,0,2,2,0,2,2,1,0,1,0,-6,6,-6,-5,11,6,0,0,-1,-1,-1,1,2,-1
KR_6740828163,420,-2,-67,4,-7,2,0,2,-1,4,3,-7,7,0,0,4,4,-1,1,0,0,-9,8,-5,-2,7,-2,0,-1,1,-1,-1,-1,5,-1
KR_6767732577,420,-1,-57,-4,2,-2,2,0,1,0,1,1,0,1,0,3,3,2,0,2,0,4,-4,3,-7,4,1,0,0,-1,-1,0,1,4,-1
KR_6765933727,420,-4,-41,-54,-14,1,0,1,-3,5,2,-2,3,1,-6,6,0,-4,4,0,-1,-7,-5,-2,-6,8,0,0,-2,1,-1,-1,-1,1,-1
KR_6750495952,420,-2,-61,-8,-4,0,5,5,0,3,3,1,0,1,-5,5,0,0,2,2,-1,-1,-1,-3,-3,6,0,0,-2,-1,-1,-1,-1,1,-1
KR_6769593418,420,-1,-40,-3,-3,-1,2,1,1,1,2,-3,4,1,-1,2,1,1,0,1,0,-5,4,0,-7,7,0,0,1,-1,1,1,-1,5,-1
KR_6730392845,420,-3,-71,-13,-4,-2,3,1,-1,2,1,-1,1,0,0,2,2,0,0,0,0,-13,2,2,-6,4,0,0,0,-1,1,-1,1,3,-1
KR_6738376715,420,-1,-29,-10,-3,1,2,3,-3,6,3,-7,7,0,3,7,10,3,0,3,0,-8,-17,-2,-8,10,3,0,-1,1,-1,-1,1,4,-1
KR_6750064065,420,-5,-132,2,-12,1,1,2,-2,2,0,-4,4,0,-9,11,2,2,0,2,0,-20,-15,-7,-4,11,2,0,-3,0,-1,-1,-1,0,-1
KR_6762701235,420,2,-2,20,6,0,1,1,3,5,8,0,2,2,0,3,3,3,2,5,0,9,-81,1,-5,4,5,0,2,-1,1,1,1,2,-1
KR_6748465287,440,-1,-34,-31,1,2,2,4,0,2,2,2,1,3,-2,2,0,-1,2,1,0,4,-2,1,-6,5,3,0,-1,-1,-1,-1,-1,5,-1
KR_6672102366,420,-2,-50,-16,-1,-3,4,1,2,2,4,0,1,1,-1,2,1,1,0,1,0,4,0,-1,-6,7,3,0,-1,1,-1,-1,1,6,-1
KR_6702789812,420,-1,-18,7,0,-1,3,2,-4,5,1,5,0,5,-3,5,2,3,1,4,-1,-7,1,2,-5,3,-9,0,0,-1,1,-1,-1,6,-1
KR_6756745629,420,1,40,-4,2,0,2,2,-2,4,2,1,2,3,1,1,2,2,0,2,0,1,12,-4,-3,7,4,0,0,1,-1,0,-1,6,-1
KR_6699825232,420,-3,-47,-6,-4,-1,3,2,-2,4,2,1,1,2,-2,3,1,0,0,0,0,-8,-43,-1,-4,5,-1,0,0,1,1,-1,1,3,-1
KR_6725428834,420,-1,-52,-10,-3,0,3,3,-4,5,1,4,2,6,-4,4,0,1,2,3,0,3,8,-3,-4,7,-3,0,0,-1,-1,0,1,3,-1
KR_6742107482,420,1,37,27,-5,1,2,3,2,3,5,-3,3,0,-4,6,2,-1,1,0,-1,-11,3,-1,-3,4,0,0,1,-1,1,1,-1,2,-1
KR_6734231217,420,-3,-77,16,-1,-1,2,1,1,2,3,-1,2,1,4,1,5,-4,4,0,0,1,-1,0,-7,7,-4,0,-1,1,1,-1,-1,5,-1
KR_6660728357,420,-3,-63,-19,-4,1,3,4,-1,5,4,-2,4,2,-2,2,0,0,1,1,-1,-6,-7,3,-7,4,2,0,-2,-1,-1,-1,-1,4,-1
KR_6770403896,420,-2,-90,14,-14,-2,4,2,-2,4,2,-3,4,1,-5,6,1,-2,3,1,-1,-18,39,0,-6,6,6,0,-1,1,-1,-1,-1,4,-1
KR_6754303542,420,-6,-153,-67,-10,-2,3,1,0,1,1,-2,2,0,-8,8,0,2,0,2,-1,-9,-4,-3,-2,5,-4,0,-4,-1,-1,-1,-1,6,-1
KR_6746311015,420,1,32,-31,2,2,2,4,-1,3,2,-3,3,0,4,1,5,0,1,1,0,4,13,0,-7,7,1,0,0,1,1,0,-1,1,-1
KR_6747621148,420,-9,-129,-45,-17,-4,4,0,-3,3,0,-7,8,1,-2,2,0,-1,1,0,0,-14,13,-3,-1,4,-1,0,-7,-1,-1,-1,-1,3,-1
KR_6595111075,420,1,9,-7,1,4,0,4,-3,8,5,-4,5,1,2,1,3,2,2,4,-1,-7,0,9,-12,3,0,0,1,1,1,1,-1,5,-1
KR_6754367126,440,-1,-47,-35,-2,-2,3,1,0,3,3,-3,6,3,3,1,4,0,0,0,0,5,-9,1,-6,5,0,0,-1,-1,0,-1,-1,2,-1
KR_6694932373,420,-3,-81,24,-9,-6,7,1,3,0,3,0,1,1,-1,4,3,-5,7,2,2,0,16,3,-4,1,1,0,-3,1,-1,-1,1,1,-1
KR_6732394646,420,-1,-58,4,5,1,2,3,5,5,10,4,1,5,-1,4,3,-4,4,0,4,18,-45,4,-9,5,13,0,-1,-1,1,-1,1,5,-1
KR_6737794992,420,-3,-34,8,-3,-2,3,1,0,2,2,-3,5,2,0,1,1,2,0,2,0,4,-3,-3,-4,7,-2,0,0,1,-1,0,-1,4,-1
KR_6768881284,420,-2,10,-45,0,0,2,2,1,4,5,2,1,3,0,3,3,-3,6,3,-1,-8,-17,1,-5,4,-1,0,0,-1,-1,0,-1,5,-1
KR_6762703016,420,-2,-9,0,-9,-2,5,3,-1,1,0,0,3,3,-3,4,1,-3,4,1,0,-7,0,1,-2,1,2,0,-1,-1,-1,-1,-1,1,-1
KR_6763126480,420,-2,25,-23,-3,1,1,2,0,4,4,-3,7,4,0,3,3,-1,1,0,0,-2,151,2,-10,8,-8,0,0,-1,-1,0,1,4,-1
KR_6650465843,420,-2,-40,-12,-3,-4,6,2,-3,4,1,5,1,6,-2,5,3,1,0,1,0,-10,8,2,-7,5,-1,0,-1,0,0,-1,1,0,-1
KR_6766374585,420,-1,-33,-12,-4,-3,4,1,-3,4,1,0,1,1,2,0,2,0,0,0,0,-3,-1,1,-8,7,-3,0,-1,1,-1,-1,1,1,-1
KR_6762364837,420,2,7,-24,5,2,1,3,0,1,1,2,1,3,0,1,1,1,0,1,-1,1,-40,2,-8,6,-2,0,2,-1,1,1,1,5,-1
KR_6701026832,420,-1,5,8,0,-1,2,1,2,2,4,-1,3,2,0,4,4,0,0,0,-1,-7,-7,-5,-1,6,0,0,0,-1,-1,-1,-1,1,-1
KR_6723116221,420,-5,-58,-35,-1,4,0,4,-1,3,2,-3,6,3,0,2,2,-1,1,0,0,-1,22,7,-12,5,-1,0,-2,1,1,-1,1,1,-1
KR_6745299734,440,-1,39,-4,-3,1,2,3,-1,4,3,-4,6,2,-1,3,2,2,0,2,0,-4,-3,-2,-3,5,-3,0,-1,-1,-1,-1,-1,2,-1
KR_6761719310,440,-1,63,-16,-3,-1,1,0,-6,6,0,0,0,0,0,1,1,4,1,5,0,-12,51,-1,-2,3,-23,0,0,1,1,0,1,1,-1
KR_6737096730,420,0,44,8,-8,-6,9,3,1,0,1,-2,3,1,0,1,1,-1,1,0,0,-18,26,0,-4,4,6,0,-1,-1,-1,1,-1,2,-1
KR_6764855387,420,-2,-57,-12,-5,0,2,2,-1,4,3,-7,7,0,0,3,3,3,1,4,0,1,-5,-1,-3,4,0,0,0,1,-1,-1,-1,6,-1
KR_6744141667,420,1,12,10,-1,2,0,2,-3,8,5,-2,2,0,0,2,2,2,1,3,0,-4,0,0,-6,6,1,0,0,1,-1,-1,-1,3,-1
KR_6574198970,420,-2,-30,-17,1,2,0,2,-2,5,3,3,1,4,1,3,4,-3,3,0,2,-3,27,1,-9,8,-4,0,-1,-1,1,-1,1,2,-1
KR_6692503029,420,-1,-34,4,-5,-2,2,0,-4,7,3,4,1,5,-3,7,4,0,1,1,0,-9,35,-6,-2,8,-11,0,1,1,1,1,-1,4,-1
KR_6565740903,420,0,12,-27,3,0,0,0,-3,7,4,2,3,5,3,1,4,1,0,1,0,2,-26,-2,-5,7,5,0,-1,-1,-1,-1,1,5,-1
KR_6727936154,420,-1,17,7,-6,2,0,2,1,0,1,1,1,2,-5,6,1,-5,5,0,0,-8,-9,-5,-6,11,-1,0,0,-1,0,1,1,6,-1
KR_6692090390,420,3,-20,-8,7,-1,1,0,5,1,6,-4,6,2,5,3,8,2,0,2,-1,16,75,1,-5,4,0,0,0,-1,1,1,-1,2,-1
KR_6764134217,420,-4,-41,-45,-8,-3,3,0,-1,4,3,-4,7,3,-2,5,3,2,0,2,1,-4,0,3,-9,6,3,0,-2,-1,-1,-1,-1,1,-1
KR_6738449230,420,-1,-46,-31,-2,0,3,3,4,2,6,-5,8,3,-2,4,2,1,0,1,0,0,14,-5,-5,10,3,0,0,-1,-1,1,1,5,-1
KR_6689874806,420,-3,21,4,-5,-3,4,1,0,2,2,-3,6,3,0,1,1,1,0,1,0,0,-2,-2,-4,6,0,0,0,0,0,0,-1,0,-1
KR_6751878053,420,-4,-36,-28,-12,-2,4,2,1,1,2,-5,8,3,-3,5,2,-3,3,0,1,-6,-4,-4,-2,6,-2,0,-3,-1,-1,-1,1,5,-1
KR_6754120137,420,-3,20,-28,-7,-4,5,1,-2,3,1,-4,4,0,0,3,3,3,0,3,0,-13,0,-1,-6,7,0,0,0,-1,1,1,1,6,-1
KR_6650156257,420,-2,-55,-20,-8,-1,2,1,0,5,5,-4,8,4,-2,2,0,-1,1,0,0,-5,4,-2,-3,5,4,0,-1,-1,-1,-1,-1,6,-1
KR_6737787340,420,1,16,6,-3,3,0,3,1,4,5,0,3,3,-6,7,1,-1,1,0,0,1,37,-4,-6,10,0,0,1,-1,-1,1,1,4,-1
KR_6734551605,420,-1,-27,0,0,-4,5,1,3,1,4,-1,2,1,-2,3,1,4,2,6,0,8,3,6,-9,3,-3,0,-1,-1,1,-1,-1,5,-1
KR_6664599402,420,-1,-31,-1,-2,-2,2,0,-3,5,2,1,0,1,2,0,2,0,0,0,0,0,-27,-1,-4,5,0,0,-1,0,-1,-1,-1,0,-1
KR_6650768745,420,-5,-108,-12,-6,-4,4,0,1,3,4,3,3,6,-6,6,0,0,0,0,-1,-7,-32,-7,-6,13,-6,0,-2,1,-1,-1,-1,6,-1
KR_6748433407,420,-4,-41,21,-13,-3,7,4,-8,9,1,-2,6,4,0,2,2,0,1,1,0,-11,26,-1,-4,5,2,0,0,-1,1,-1,-1,4,-1
KR_6759598756,420,-1,-57,-12,-3,0,2,2,0,5,5,3,1,4,-3,5,2,-3,4,1,0,1,-2,1,-4,3,-2,0,-2,-1,-1,-1,-1,1,-1
KR_6760930177,420,-2,50,8,0,-1,1,0,-3,6,3,1,0,1,2,3,5,1,1,2,0,-3,13,1,-4,3,1,0,-1,1,-1,-1,-1,6,-1
KR_6613987708,420,-2,-56,5,-7,-4,5,1,-3,4,1,-3,5,2,2,3,5,1,0,1,0,-9,-5,-1,-4,5,-2,0,0,1,-1,-1,-1,3,-1
KR_6728938650,440,2,25,28,0,-4,5,1,2,0,2,1,0,1,1,2,3,0,1,1,0,2,2,2,-9,7,0,0,-1,1,-1,-1,1,6,-1
KR_6732482589,420,-1,-6,-5,0,-1,2,1,-2,5,3,3,1,4,-2,4,2,2,1,3,0,-3,0,-3,-6,9,-3,0,0,-1,1,1,1,5,-1
KR_6757165150,420,-3,-95,-23,-7,-4,7,3,2,1,3,-6,8,2,-1,6,5,2,0,2,0,2,22,0,-4,4,-6,0,-2,-1,-1,-1,-1,3,-1
KR_6712795731,420,-10,-104,-51,-14,-9,9,0,-2,4,2,2,1,3,-3,4,1,-2,2,0,0,-4,-35,-5,-5,10,-2,0,-3,-1,-1,-1,-1,6,-1
KR_6763312637,420,-1,5,-15,-9,-3,5,2,1,1,2,-5,5,0,-1,2,1,-1,3,2,-1,-12,36,1,-6,5,-15,0,-1,1,1,-1,-1,5,-1
KR_6765005701,420,1,6,2,1,3,0,3,2,1,3,2,0,2,-5,6,1,-1,2,1,0,2,-6,-2,-6,8,5,0,0,-1,1,0,-1,2,-1
KR_6725822916,420,-2,10,-20,-3,4,0,4,-3,4,1,-3,4,1,0,4,4,-1,2,1,0,-6,20,2,-4,2,-2,0,-1,-1,-1,-1,-1,2,-1
KR_6759347895,440,-2,8,-4,-3,0,1,1,2,2,4,-6,7,1,2,3,5,-1,3,2,0,1,-4,3,-3,0,-2,0,-1,1,1,-1,1,2,-1
KR_6750593960,420,-2,3,-42,-1,1,1,2,-1,4,3,0,3,3,-1,4,3,0,1,1,0,3,-1,-6,-3,9,-3,0,-1,-1,-1,-1,1,5,-1
KR_6753290897,420,-2,-13,-56,-5,-4,4,0,-7,8,1,-1,6,5,7,3,10,0,0,0,-1,-4,88,0,-4,4,-3,0,0,1,-1,-1,-1,5,-1
KR_6767747481,420,-2,-15,-28,-5,-1,1,0,-2,4,2,-4,4,0,2,2,4,0,1,1,0,-9,4,1,-6,5,-1,0,-1,-1,-1,-1,-1,2,-1
KR_6730899892,440,-2,-27,-13,-9,3,1,4,-2,5,3,-6,10,4,0,0,0,-4,4,0,1,-12,1,-2,-6,8,-1,0,-1,-1,0,-1,1,5,-1
KR_6741349487,440,-3,-23,1,-8,-2,3,1,-3,4,1,0,3,3,-4,6,2,1,0,1,0,-6,-4,-2,-1,3,0,0,-1,1,-1,-1,1,1,-1
KR_6708224506,440,-5,-38,18,-15,2,2,4,-7,7,0,-5,9,4,-6,6,0,1,2,3,-1,-15,-4,-4,0,4,-1,0,0,-1,1,-1,-1,3,-1
KR_6738919591,420,-3,-12,-13,-8,-2,2,0,-4,8,4,2,0,2,-2,3,1,-2,2,0,0,-7,-11,1,-5,4,2,0,1,-1,1,1,1,6,-1
KR_6677005568,420,-3,0,0,-7,-5,5,0,-2,6,4,-1,2,1,0,5,5,1,2,3,0,-6,-5,-3,-7,10,-3,0,-1,-1,-1,-1,1,6,-1
KR_6671733263,420,-1,31,7,1,2,1,3,-1,5,4,2,4,6,1,1,2,-3,3,0,0,0,-8,-1,-5,6,4,0,1,1,1,1,1,4,-1
KR_6763588264,420,-4,-77,-27,-3,-3,4,1,-1,2,1,-1,2,1,0,2,2,2,0,2,0,6,0,0,-4,4,0,0,0,1,-1,0,-1,1,-1
KR_6749359859,420,0,-23,26,-5,-4,4,0,2,0,2,-5,5,0,0,3,3,2,1,3,0,-10,23,-3,-6,9,3,0,-1,1,-1,-1,1,2,-1
KR_6630377285,420,-5,-68,-22,-8,1,2,3,-5,7,2,-2,5,3,-2,5,3,0,0,0,0,-8,4,2,-4,2,-5,0,-3,-1,-1,-1,-1,2,-1
KR_6707709861,420,1,84,-20,1,2,1,3,4,5,9,-4,4,0,-4,4,0,3,0,3,0,2,-10,1,-6,5,-4,0,0,0,0,0,-1,0,-1
KR_6766933135,420,-1,-62,0,6,0,1,1,4,0,4,-3,6,3,4,0,4,1,1,2,0,7,-1,1,-5,4,1,0,-1,1,0,-1,1,3,-1
KR_6644772948,420,-3,48,0,-1,1,2,3,-6,7,1,-2,2,0,2,2,4,4,2,6,0,2,-2,-2,-4,6,-2,0,0,1,-1,0,1,4,-1
KR_6729579808,420,-6,-77,-10,-13,-4,6,2,-2,5,3,-3,3,0,-3,4,1,-1,2,1,1,-10,-28,1,-5,4,1,0,-1,-1,-1,-1,1,4,-1
KR_6767286593,420,-5,-62,-19,-8,-1,2,1,2,1,3,-7,9,2,-2,6,4,0,2,2,0,-12,-9,-1,-6,7,-6,0,-4,-1,1,-1,1,3,-1
KR_6758279570,420,-1,-57,-34,1,1,1,2,4,0,4,-1,7,6,-1,2,1,-2,4,2,0,8,5,3,-4,1,-1,0,0,1,1,1,-1,5,-1
KR_6770015827,420,2,45,31,7,2,0,2,0,2,2,0,4,4,4,3,7,1,0,1,0,4,0,0,-8,8,6,0,0,1,0,0,1,4,-1
KR_6667724769,420,1,34,9,7,8,0,8,-3,5,2,-6,6,0,4,2,6,4,0,4,-1,5,0,2,-7,5,0,0,1,-1,-1,1,-1,6,-1
KR_6740869310,420,0,-23,26,4,1,1,2,3,0,3,2,3,5,-1,2,1,-1,1,0,0,0,133,-4,-4,8,2,0,-1,1,1,-1,1,4,-1
KR_6758960442,420,-6,-79,-40,-18,-4,9,5,-1,2,1,-4,6,2,-8,8,0,-1,1,0,0,-13,-14,-8,0,8,-2,0,-3,-1,-1,-1,1,4,-1
KR_6738618648,440,-1,-18,-6,-6,0,2,2,-3,3,0,-3,5,2,1,3,4,-1,1,0,0,-1,0,-2,-4,6,4,0,-1,1,-1,-1,-1,4,-1
KR_6760946162,420,2,8,13,2,2,0,2,-1,3,2,0,2,2,1,0,1,0,1,1,0,0,6,0,-5,5,0,0,0,-1,1,0,1,3,-1
KR_6767453206,420,-3,-20,4,-12,-2,2,0,-3,3,0,-8,13,5,0,4,4,1,0,1,0,-10,-9,-6,0,6,-1,0,-2,1,1,-1,1,6,-1
KR_6747595960,420,-3,11,-12,-6,1,1,2,-4,4,0,-2,5,3,-1,5,4,0,1,1,0,-11,-26,-7,-2,9,-1,0,0,-1,-1,-1,1,2,-1
KR_6743609694,420,1,-43,24,-3,-1,3,2,-2,2,0,-1,2,1,1,2,3,0,2,2,0,-2,-1,0,-2,2,1,0,1,1,1,1,-1,2,-1
KR_6663480676,420,0,-14,9,0,5,0,5,0,4,4,-3,4,1,0,3,3,-2,2,0,0,-2,-41,-2,-2,4,10,0,0,1,1,0,1,4,-1
KR_6745106797,420,-5,-51,-9,-11,-3,3,0,-2,4,2,-4,5,1,-3,5,2,1,1,2,0,-12,-13,-1,-7,8,3,0,0,-1,1,-1,-1,5,-1
KR_6724564927,420,-1,-24,40,-6,0,1,1,-1,3,2,-1,1,0,-4,4,0,0,1,1,0,-7,11,-4,-5,9,1,0,0,1,-1,0,-1,2,-1
KR_6694260179,420,-5,-83,-39,-11,1,1,2,-2,6,4,-2,5,3,-7,8,1,-1,3,2,-1,-18,305,0,-4,4,-5,0,-3,-1,0,-1,-1,2,-1
KR_6744736322,420,2,31,-24,1,4,1,5,-6,7,1,0,3,3,3,2,5,0,1,1,0,1,3,-5,-2,7,4,0,0,-1,-1,0,-1,3,-1
KR_6734708588,420,-2,-82,-5,-7,-1,3,2,-3,5,2,5,1,6,-5,6,1,-3,3,0,1,-6,36,1,-5,4,-5,0,-2,1,-1,-1,1,2,-1
KR_6721772636,420,-1,-21,-7,5,2,1,3,2,5,7,-2,4,2,5,1,6,-2,3,1,0,10,-4,1,-6,5,0,0,0,1,1,-1,1,3,-1
KR_6737138490,420,-1,17,-1,-3,1,1,2,-2,2,0,-4,4,0,0,1,1,2,1,3,0,-6,-23,-1,-4,5,1,0,1,0,1,1,1,0,-1
KR_6749111803,420,-10,-121,-28,-23,-11,11,0,1,1,2,-10,10,0,-6,7,1,3,1,4,0,-14,23,-4,-3,7,-10,0,-5,-1,-1,-1,-1,6,-1
KR_6770267289,420,-1,8,9,-1,-3,4,1,0,2,2,2,3,5,1,4,5,-1,1,0,0,-1,5,2,-7,5,-2,0,0,0,0,-1,-1,0,-1
KR_6767165461,420,-5,-20,3,-4,1,2,3,-1,2,1,-1,1,0,-3,4,1,0,0,0,0,-9,2,-5,-2,7,-2,0,0,1,-1,0,1,6,-1
KR_6620291189,420,-1,22,8,-3,0,1,1,-3,4,1,0,1,1,-2,4,2,2,1,3,2,-5,40,1,-6,5,1,0,0,0,1,0,1,0,-1
KR_6770143665,420,-3,28,0,-8,-2,2,0,0,4,4,-1,2,1,-3,3,0,-2,2,0,0,-12,-75,-6,-4,10,-1,0,0,-1,1,0,1,3,-1
KR_6631346335,420,-3,-59,-22,-5,0,5,5,3,3,6,-3,3,0,-3,5,2,-2,2,0,1,0,-19,1,-11,10,5,0,0,-1,1,0,1,6,-1
KR_6770182731,420,2,12,27,1,0,1,1,0,5,5,-1,1,0,3,1,4,-1,1,0,0,1,13,-1,-6,7,-5,0,0,1,-1,0,1,4,-1
KR_6769130957,420,0,-24,-19,1,0,2,2,-1,2,1,5,2,7,-2,4,2,-1,3,2,0,-3,6,5,-7,2,-3,0,0,1,-1,-1,-1,3,-1
KR_6764204159,420,-6,-24,-1,-14,-3,3,0,-5,5,0,-2,4,2,-3,4,1,-1,3,2,0,-14,-9,-3,-2,5,3,0,0,-1,1,-1,-1,2,-1
KR_6770609801,420,0,-34,1,-1,0,1,1,0,4,4,-3,3,0,2,3,5,0,3,3,0,-2,5,3,-8,5,1,0,0,1,-1,-1,-1,5,-1
KR_6762448802,440,5,36,44,5,2,1,3,4,3,7,2,3,5,0,6,6,-3,5,2,2,8,22,-5,-3,8,2,0,2,1,0,1,1,5,-1
KR_6739258095,420,5,25,5,9,1,0,1,4,1,5,1,5,6,2,1,3,1,0,1,1,18,137,6,-7,1,-6,0,1,1,-1,1,1,6,-1
KR_6745971564,420,-3,-25,-36,-3,-3,3,0,-1,4,3,0,4,4,3,3,6,-2,2,0,0,3,24,6,-8,2,-4,0,-2,0,-1,-1,1,0,-1
KR_6763473018,440,0,0,-12,-1,2,1,3,-1,2,1,0,1,1,-1,3,2,-1,1,0,0,-1,5,-5,-2,7,-1,0,0,-1,-1,0,-1,2,-1
KR_6753248255,420,1,49,9,2,0,1,1,0,6,6,6,3,9,-5,8,3,1,2,3,0,-8,-3,0,-3,3,0,0,0,1,0,1,-1,1,-1
KR_6702656607,420,3,-5,32,12,-4,4,0,2,2,4,4,0,4,10,1,11,0,0,0,1,21,-2,-5,-2,7,3,0,-1,1,-1,-1,1,4,-1
KR_6757091626,420,-3,-12,15,-11,-1,1,0,-7,8,1,3,2,5,-6,6,0,0,0,0,0,-12,53,-2,-4,6,-2,0,-1,-1,-1,1,1,1,-1
KR_6769121114,420,5,119,-12,9,6,0,6,1,0,1,5,1,6,-3,6,3,0,2,2,0,1,41,-3,-4,7,-19,0,1,-1,-1,1,1,3,-1
KR_6755665333,440,-1,-110,-32,0,-3,3,0,-3,3,0,-1,1,0,6,0,6,1,0,1,0,5,-48,1,-4,3,31,0,-3,-1,-1,-1,-1,6,-1
KR_6728390543,420,1,6,8,0,5,0,5,-3,5,2,-3,5,2,1,1,2,0,3,3,0,10,9,2,-10,8,-1,0,0,-1,1,0,-1,5,-1
KR_6768641819,420,-3,15,-2,-1,4,1,5,-5,6,1,2,1,3,-1,2,1,-1,1,0,0,-10,8,3,-6,3,-4,0,0,-1,0,-1,1,6,-1
KR_6692966977,420,0,-46,15,-2,-2,5,3,2,2,4,-3,4,1,-2,5,3,3,0,3,-1,-4,-10,-5,-6,11,5,0,0,-1,1,0,-1,2,-1
KR_6768584962,420,1,-7,-3,-2,-2,2,0,-4,7,3,1,1,2,3,0,3,0,2,2,0,-3,3,-2,-4,6,4,0,-1,-1,1,-1,-1,2,-1
KR_6756707364,420,-1,19,-16,-7,3,0,3,-3,3,0,0,2,2,-5,6,1,-2,3,1,-1,-11,-15,1,-7,6,-4,0,0,-1,-1,0,-1,1,-1
KR_6746072411,420,-1,-31,15,-3,3,1,4,-1,2,1,-2,2,0,-3,3,0,0,0,0,0,-13,1,-2,-5,7,-3,0,0,0,1,0,1,0,-1
KR_6763620547,420,1,38,-6,-4,1,0,1,1,4,5,-1,2,1,-4,4,0,-1,3,2,0,-7,-6,0,-6,6,-1,0,0,-1,1,0,1,2,-1
KR_6702489639,420,-3,-24,-8,-13,-2,4,2,-8,8,0,3,2,5,-3,3,0,-3,3,0,0,-8,-29,-6,-3,9,6,0,-1,-1,-1,-1,-1,1,-1
KR_6767360252,420,2,-13,-16,5,0,1,1,3,1,4,-4,5,1,5,1,6,1,0,1,0,8,-28,-4,-5,9,3,0,0,0,-1,0,-1,0,-1
KR_6755828472,420,4,37,47,7,5,0,5,1,2,3,1,0,1,1,3,4,-1,2,1,0,2,113,-6,-3,9,6,0,3,1,1,1,-1,1,-1
KR_6755203334,440,-1,15,-15,-7,1,1,2,-2,6,4,1,1,2,-3,6,3,-4,8,4,-1,-5,3,1,-6,5,5,0,-2,1,-1,-1,1,6,-1
KR_6757312250,420,4,-11,9,4,3,0,3,5,1,6,-6,7,1,4,1,5,-2,2,0,0,3,-17,0,-4,4,8,0,1,1,1,1,1,6,-1
KR_6742588862,420,-2,-3,13,-2,-2,4,2,0,4,4,-1,2,1,0,2,2,1,1,2,2,7,-42,-3,-6,9,10,0,0,1,1,0,1,2,-1
KR_6757681925,420,-3,-19,-35,2,-1,3,2,3,0,3,2,4,6,-2,3,1,0,2,2,0,10,-10,7,-12,5,1,0,0,-1,-1,-1,-1,4,-1
KR_6680603783,420,-4,-41,-32,-8,-1,1,0,-5,8,3,-3,5,2,0,2,2,1,0,1,-3,-12,-14,1,-6,5,-1,0,-2,-1,-1,-1,-1,2,-1
KR_6722036820,420,2,5,9,0,0,2,2,2,3,5,-2,2,0,2,2,4,-2,2,0,0,-2,-11,2,-6,4,-1,0,0,-1,1,0,1,5,-1
KR_6768830670,420,-4,-72,-11,-8,-1,3,2,-5,5,0,-4,7,3,1,0,1,1,0,1,0,-8,50,-5,-4,9,-18,0,-1,-1,-1,-1,-1,4,-1
KR_6638958541,420,-6,-74,-20,-12,-5,6,1,-1,3,2,-2,2,0,-3,3,0,-1,2,1,0,-10,2,1,-3,2,0,0,-2,-1,-1,-1,-1,5,-1
KR_6759906537,420,0,-3,-18,3,-1,3,2,1,1,2,-2,4,2,3,2,5,2,1,3,0,11,3,1,-8,7,-7,0,0,1,1,1,1,2,-1
KR_6729016001,420,0,-79,-16,-3,2,3,5,2,2,4,-1,3,2,-5,8,3,-1,1,0,0,3,2,2,-4,2,0,0,-1,-1,1,1,-1,6,-1
KR_6768523182,420,-2,-4,-2,-7,-2,3,1,-3,3,0,4,2,6,-4,7,3,-2,2,0,0,-12,6,4,-10,6,-1,0,-3,1,-1,-1,-1,3,-1
KR_6769993317,440,1,28,-20,1,2,0,2,5,0,5,-2,2,0,-1,1,0,-3,4,1,0,-2,0,5,-8,3,1,0,1,-1,1,1,1,2,-1
KR_6758760576,420,0,-93,23,0,2,1,3,-1,2,1,0,1,1,0,1,1,-1,3,2,0,3,4,3,-6,3,-1,0,0,-1,0,0,1,4,-1
KR_6697583113,420,-4,-70,-8,-4,-1,2,1,2,1,3,1,4,5,-1,3,2,-5,6,1,0,-3,16,3,-8,5,-9,0,0,-1,1,0,1,4,-1
KR_6741907666,420,-1,20,-1,2,-1,1,0,1,4,5,1,3,4,2,3,5,-1,4,3,0,0,-188,-7,-4,11,-12,0,1,-1,1,1,1,6,-1
KR_6648813991,420,2,50,11,3,-2,3,1,-1,4,3,-1,2,1,5,0,5,2,1,3,0,4,-22,4,-6,2,4,0,-1,-1,1,-1,-1,1,-1
KR_6731625028,420,-2,-91,-24,-1,-2,2,0,-1,2,1,-1,2,1,3,0,3,0,0,0,0,4,3,2,-7,5,-4,0,-1,1,-1,-1,-1,5,-1
KR_6683285264,440,2,18,24,-3,5,2,7,6,1,7,-5,6,1,-7,8,1,-2,2,0,0,-11,-4,-1,-1,2,-1,0,-2,-1,-1,-1,-1,5,-1
KR_6753240414,420,0,112,-7,-2,-3,4,1,1,3,4,-2,4,2,5,0,5,-3,4,1,0,-5,1,0,-5,5,0,0,1,-1,-1,-1,-1,2,-1
KR_6767254321,440,-2,-13,-40,-1,0,2,2,-1,2,1,-2,2,0,1,1,2,1,3,4,0,2,1,-2,-3,5,0,0,0,-1,-1,0,-1,6,-1
KR_6680627639,420,-1,26,-12,-4,-1,1,0,-3,7,4,-1,1,0,1,0,1,0,0,0,0,4,-16,-1,-6,7,3,0,0,-1,1,0,-1,2,-1
KR_6770065278,440,-6,-73,-20,-14,-6,6,0,-6,7,1,-1,3,2,-1,3,2,0,0,0,0,-10,1,-1,-6,7,-2,0,-1,-1,1,-1,-1,6,-1
KR_6754780625,420,-3,0,-17,-11,-3,3,0,-2,6,4,1,3,4,-5,7,2,-2,2,0,-1,-9,-12,-8,-1,9,4,0,-2,-1,-1,-1,-1,3,-1
KR_6658562137,420,-1,-41,-14,-10,-1,2,1,-1,3,2,-1,1,0,-4,6,2,-3,3,0,0,-7,1,-2,-6,8,0,0,0,-1,-1,0,-1,6,-1
KR_6767442727,440,-2,-9,-35,-10,-9,11,2,0,2,2,-6,7,1,0,1,1,5,0,5,0,-9,0,-3,0,3,2,0,0,-1,-1,-1,1,6,-1
KR_6762015170,420,-1,-22,1,-1,3,0,3,2,4,6,-6,7,1,2,2,4,-2,3,1,-1,-8,8,5,-9,4,-3,0,0,1,1,0,-1,5,-1
KR_6755444618,420,1,4,26,-4,-2,3,1,-2,3,1,-3,3,0,4,5,9,-1,3,2,0,-6,-2,-2,-3,5,5,0,0,1,-1,0,1,4,-1
KR_6764970595,420,-4,-115,16,-5,-2,2,0,-3,3,0,-1,2,1,1,5,6,0,0,0,0,-15,-8,2,-5,3,-1,0,-3,-1,-1,-1,-1,4,-1
KR_6644003333,420,-3,-2,-10,-4,2,1,3,-2,4,2,1,0,1,1,2,3,-6,6,0,0,-5,3,4,-9,5,-4,0,-2,1,-1,-1,-1,4,-1
KR_6749700453,440,-2,0,4,2,2,2,4,-2,3,1,0,1,1,1,3,4,1,0,1,0,10,-7,2,-6,4,-4,0,-1,1,-1,-1,-1,4,-1
KR_6758531501,420,4,36,19,5,3,0,3,6,3,9,-3,6,3,0,2,2,-1,1,0,0,7,4,1,-8,7,5,0,1,1,-1,1,-1,6,-1
KR_6750310928,440,-4,-122,39,-14,-3,3,0,-1,4,3,-3,4,1,-9,10,1,2,1,3,-1,-12,-2,-3,-2,5,3,0,-1,1,-1,-1,-1,1,-1
KR_6760767005,420,3,43,24,-1,3,0,3,0,5,5,-2,3,1,-3,5,2,1,0,1,-1,-3,-5,4,-8,4,-2,0,0,1,-1,0,-1,4,-1
KR_6767907771,420,-4,-68,-12,-5,-3,3,0,-1,3,2,-1,3,2,0,2,2,0,1,1,-1,-1,-5,-1,-8,9,4,0,0,0,-1,0,-1,0,-1
KR_6767531083,420,0,64,-8,1,0,4,4,4,0,4,-1,3,2,1,3,4,-3,4,1,0,0,-1,0,-6,6,0,0,-1,-1,1,-1,-1,6,-1
KR_6735988009,420,-4,-62,-32,-8,-4,4,0,-2,2,0,2,0,2,-4,4,0,0,1,1,1,-7,86,-1,-3,4,1,0,-1,-1,-1,-1,1,4,-1
KR_6768008098,420,-1,-9,-11,-6,-2,3,1,6,3,9,-5,6,1,-1,3,2,-4,5,1,-1,-4,-10,-2,-7,9,0,0,-1,-1,-1,-1,-1,2,-1
KR_6766632616,420,-4,5,-11,-7,1,2,3,0,2,2,-3,3,0,-6,7,1,1,1,2,0,-9,-3,0,-5,5,-1,0,-1,1,-1,-1,-1,6,-1
KR_6764223820,420,-2,-34,-2,0,2,0,2,3,0,3,0,2,2,-4,5,1,-1,2,1,0,-1,-28,3,-9,6,10,0,-1,1,1,-1,1,6,-1
KR_6751304952,420,0,23,-4,-2,2,1,3,0,1,1,-1,1,0,0,3,3,-3,3,0,0,-6,-11,-3,-4,7,5,0,0,-1,1,1,-1,2,-1
KR_6762193419,420,0,32,23,-8,-2,3,1,1,2,3,2,1,3,-7,10,3,-2,3,1,-1,-13,3,1,-7,6,3,0,3,-1,1,1,-1,4,-1
KR_6768848447,420,1,12,-17,-2,-4,4,0,-2,6,4,2,1,3,3,0,3,-1,2,1,0,-5,0,1,-4,3,4,0,1,-1,-1,1,1,5,-1
KR_6768889516,420,-3,-15,-14,-11,-1,2,1,-6,7,1,-5,5,0,1,4,5,0,1,1,0,-9,-112,-3,-4,7,-1,0,0,1,-1,-1,1,3,-1
KR_6694369260,420,0,30,12,-3,3,1,4,-2,7,5,0,2,2,-4,5,1,0,3,3,0,-8,-8,0,-7,7,2,0,1,0,1,1,1,0,-1
KR_6759089490,440,-3,-102,-4,-9,-7,7,0,3,3,6,-1,1,0,-4,6,2,0,0,0,0,-4,-10,-3,-4,7,-3,0,-1,-1,-1,-1,1,5,-1
KR_6644823381,420,2,45,37,-2,0,5,5,-4,5,1,-1,1,0,2,1,3,1,2,3,0,-5,5,0,-7,7,4,0,1,1,1,1,1,3,-1
KR_6737764925,420,-7,-12,-3,-17,1,2,3,-6,9,3,-3,3,0,-6,6,0,-3,3,0,0,-16,-6,-1,-5,6,3,0,-3,-1,-1,-1,1,5,-1
KR_6749442032,440,2,-38,4,3,1,4,5,-1,2,1,4,1,5,-2,7,5,1,0,1,0,8,-1,-3,-3,6,-1,0,-2,-1,0,-1,-1,5,-1
KR_6767797711,420,0,28,-4,0,-1,2,1,1,1,2,-1,2,1,0,1,1,1,0,1,0,1,-10,-1,-4,5,0,0,2,1,-1,1,1,3,-1
KR_6733739965,420,5,64,40,3,2,2,4,-2,8,6,-3,6,3,6,0,6,0,0,0,0,8,2,2,-5,3,0,0,2,-1,-1,1,1,4,-1
KR_6750369587,420,-8,-86,-44,-20,-5,8,3,-3,6,3,-5,6,1,-6,8,2,-1,2,1,-4,-23,-176,-2,-5,7,-5,0,-1,-1,1,-1,-1,4,-1
KR_6753266707,420,-5,-108,-28,-15,-7,9,2,3,3,6,-2,5,3,-9,9,0,0,1,1,0,-11,-12,-4,-1,5,3,0,-2,1,-1,-1,1,2,-1
KR_6680265710,420,0,-10,-13,0,-2,2,0,0,2,2,-2,5,3,3,2,5,1,2,3,1,0,3,-5,-3,8,4,0,0,-1,1,1,1,6,-1
KR_6664550491,420,-7,-76,-8,-8,-2,4,2,-11,13,2,-3,4,1,4,1,5,4,3,7,1,-2,-1,-6,-4,10,0,0,0,1,-1,-1,1,6,-1
KR_6680343228,420,1,25,8,-2,-2,2,0,0,3,3,0,3,3,-1,4,3,1,0,1,0,3,0,-3,-5,8,-6,0,0,1,-1,-1,-1,2,-1
KR_6694320817,420,-2,39,-12,-4,-6,6,0,1,0,1,0,1,1,0,3,3,1,0,1,0,6,-8,1,-7,6,4,0,-1,1,-1,-1,-1,6,-1
KR_6558696494,420,-2,-47,7,-9,-2,2,0,5,2,7,-9,10,1,-3,4,1,0,1,1,0,-1,-32,5,-6,1,-4,0,-2,1,-1,-1,-1,1,-1
KR_6763540561,420,1,68,-8,0,-3,3,0,-1,2,1,3,0,3,-2,3,1,3,0,3,0,0,-2,1,-6,5,-2,0,-1,1,-1,-1,-1,4,-1
KR_6764910917,420,-5,-49,-44,-5,1,0,1,-1,4,3,-2,3,1,-1,2,1,-2,2,0,-1,-5,1,2,-7,5,3,0,0,-1,-1,-1,-1,4,-1
KR_6741732729,420,1,48,0,3,0,1,1,3,1,4,-2,2,0,2,1,3,0,1,1,0,5,-25,5,-11,6,11,0,0,-1,1,0,1,6,-1
KR_6762007308,420,-2,-48,-22,-2,7,0,7,2,1,3,-2,2,0,-9,10,1,0,0,0,0,-7,-4,1,-5,4,-1,0,1,1,1,-1,1,3,-1
KR_6728043362,420,0,16,-9,-1,-2,3,1,2,2,4,1,1,2,-1,3,2,-1,1,0,0,3,271,0,-9,9,-4,0,-1,-1,1,-1,1,2,-1
KR_6762513446,440,-4,-17,-8,-8,-1,2,1,0,4,4,3,0,3,-7,7,0,-3,3,0,3,-6,-2,-5,-5,10,7,0,-1,-1,0,-1,1,2,-1
KR_6742795871,420,-2,-65,41,-5,2,1,3,0,3,3,-2,4,2,-3,3,0,-2,2,0,0,-13,22,3,-7,4,-1,0,-1,1,-1,-1,-1,5,-1
KR_6698199908,420,1,34,-40,-1,3,0,3,-2,3,1,-3,4,1,0,3,3,1,0,1,0,-1,-36,4,-9,5,1,0,1,-1,1,1,1,5,-1
KR_6682851092,420,-3,27,19,-9,0,1,1,-8,9,1,3,0,3,-4,4,0,0,0,0,0,-15,3,1,-11,10,8,0,0,0,-1,0,-1,0,-1
KR_6769127492,420,-2,-41,3,-5,-5,6,1,1,4,5,0,1,1,-1,2,1,0,0,0,0,-4,118,1,-6,5,5,0,-1,-1,1,-1,1,6,-1
KR_6739722553,420,-4,-1,-43,-11,-2,3,1,-3,3,0,-4,4,0,1,3,4,-3,3,0,0,-9,23,-2,-7,9,-31,0,0,-1,-1,1,-1,2,-1
KR_6683520016,420,2,40,-9,5,1,0,1,3,0,3,-2,3,1,3,1,4,0,1,1,0,10,22,-3,-6,9,-2,0,1,-1,-1,1,1,5,-1
KR_6747201091,420,-1,18,4,-1,-4,6,2,1,1,2,-2,2,0,5,3,8,-1,2,1,1,2,3,1,-4,3,1,0,-2,1,-1,-1,1,1,-1
KR_6750417680,420,-5,-43,-28,-4,-3,6,3,-2,3,1,1,3,4,0,2,2,0,1,1,0,-4,4,3,-5,2,2,0,0,-1,0,0,1,1,-1
KR_6624309829,420,-1,-12,8,5,0,4,4,1,2,3,3,0,3,2,2,4,-1,2,1,1,4,4,-1,-6,7,3,0,-1,-1,1,-1,1,6,-1
KR_6736241618,420,4,29,-36,0,-3,5,2,0,1,1,3,1,4,-3,6,3,3,2,5,0,11,-9,1,-5,4,1,0,0,-1,-1,-1,1,2,-1
KR_6688610610,420,-3,-55,-36,-10,-4,5,1,-3,4,1,1,3,4,-1,2,1,-3,4,1,0,-5,-5,-1,-7,8,-2,0,-1,-1,-1,-1,-1,2,-1
KR_6767620414,420,-5,-88,16,-19,-3,7,4,-3,5,2,-4,6,2,-6,8,2,-3,3,0,-2,-21,-7,-2,-1,3,-1,-1,-5,-1,-1,-1,-1,3,-1
KR_6725473605,420,0,-3,17,0,-4,6,2,-1,3,2,7,0,7,-3,3,0,1,0,1,-3,-3,6,5,-9,4,-2,0,-1,1,1,-1,-1,1,-1
KR_6752857204,420,-1,18,-43,0,0,2,2,-2,4,2,-1,3,2,2,0,2,1,1,2,0,0,-6,-4,-4,8,-1,0,-1,1,-1,-1,1,1,-1
KR_6765517786,420,0,11,-29,-6,-2,2,0,2,2,4,-1,4,3,-5,7,2,0,2,2,0,-8,-66,1,-8,7,-1,0,0,1,1,1,1,1,-1
KR_6721280434,420,1,-63,-4,5,-1,2,1,9,3,12,-1,2,1,-3,5,2,1,1,2,-1,5,21,2,-6,4,-3,0,0,0,-1,0,-1,0,-1
KR_6735490134,420,-3,-42,13,-6,0,3,3,4,1,5,1,3,4,-7,8,1,-4,4,0,-1,-4,8,4,-10,6,-3,0,-1,0,-1,-1,-1,0,-1
KR_6682733536,420,-3,-111,20,-13,1,1,2,-3,6,3,-6,8,2,-4,6,2,-1,1,0,0,-11,-4,-5,-3,8,0,0,-2,1,-1,-1,-1,1,-1
KR_6767705179,420,-2,-15,-29,-6,0,2,2,-3,4,1,0,2,2,-1,3,2,-2,2,0,-1,-9,-17,0,-6,6,-6,0,0,-1,1,1,-1,4,-1
KR_6704692388,420,-6,-45,-1,-12,2,1,3,0,5,5,-7,9,2,-5,7,2,-2,3,1,0,-18,-19,-3,-2,5,-1,0,-2,0,-1,-1,-1,0,-1
KR_6715104755,420,-1,3,-17,-1,-2,4,2,2,1,3,-3,4,1,2,1,3,0,2,2,0,7,-113,1,-5,4,-3,0,-1,0,-1,-1,-1,0,-1
KR_6615642807,420,-4,-3,-11,-6,-6,6,0,-2,7,5,1,2,3,1,2,3,0,1,1,0,-10,11,0,-5,5,1,0,1,-1,-1,-1,-1,2,-1
KR_6722842847,420,-5,-116,24,-11,-3,4,1,-1,3,2,-3,4,1,-4,6,2,0,1,1,0,-13,-23,-4,-1,5,2,0,-1,-1,-1,-1,-1,2,-1
KR_6681277382,420,2,-11,13,3,2,2,4,3,4,7,2,1,3,-4,4,0,0,0,0,0,-2,1,2,-7,5,1,0,0,-1,1,1,1,2,-1
KR_6723781974,420,-2,-80,-23,-4,1,0,1,-4,4,0,-3,3,0,1,3,4,1,0,1,0,-6,140,-4,-4,8,1,0,-1,-1,-1,-1,1,6,-1
KR_6752068467,420,2,27,-24,6,-1,2,1,-1,3,2,4,2,6,0,2,2,4,0,4,0,12,-278,1,-5,4,4,0,1,1,-1,1,1,3,-1
KR_6756201954,420,-1,13,23,-9,3,0,3,-4,7,3,-2,3,1,-4,6,2,-2,5,3,1,-9,-10,-5,-5,10,-3,0,0,1,1,0,-1,3,-1
KR_6765768169,420,0,30,-43,-2,3,1,4,0,0,0,-2,3,1,-1,3,2,-2,2,0,0,-7,-1,4,-7,3,-3,0,1,-1,1,1,1,3,-1
KR_6761751419,440,-4,-92,-16,-9,-1,1,0,1,0,1,-1,3,2,-2,2,0,-6,6,0,0,-6,-2,-5,-2,7,4,0,0,-1,1,1,-1,5,-1
KR_6749598056,440,-1,-66,4,-2,0,1,1,-5,5,0,0,1,1,4,0,4,-1,1,0,0,-4,-3,-1,-4,5,2,0,0,0,1,0,1,0,-1
KR_6723447145,420,-1,15,-15,1,-5,6,1,5,0,5,1,2,3,1,2,3,-1,3,2,0,6,14,-1,-5,6,3,0,0,0,-1,0,-1,0,-1
KR_6767375005,420,-5,-67,19,-10,-4,5,1,-4,5,1,1,3,4,-4,5,1,1,0,1,1,0,-1,-5,-5,10,-8,0,0,1,-1,-1,-1,4,-1
KR_6759150585,420,-4,-39,-26,-13,1,3,4,-6,8,2,0,4,4,-7,8,1,-1,1,0,0,-13,-5,1,-5,4,-3,0,-2,-1,-1,-1,-1,4,-1
KR_6747638347,420,0,42,10,-13,-2,2,0,-3,3,0,1,2,3,-5,6,1,-4,4,0,0,-14,-29,-2,-5,7,0,0,-2,1,-1,-1,-1,1,-1
KR_6684771567,420,-3,-33,-5,-6,0,4,4,1,2,3,-2,5,3,-3,6,3,-2,3,1,0,-4,3,2,-6,4,-5,0,-2,-1,-1,-1,-1,2,-1
KR_6435636343,420,-3,-17,20,-6,-2,3,1,-3,4,1,-3,7,4,2,2,4,0,3,3,-1,-7,-6,-1,-5,6,-5,0,0,1,-1,-1,1,3,-1
KR_6766991990,420,-4,-14,-8,-12,-1,3,2,-8,9,1,-11,12,1,6,3,9,2,2,4,-1,-10,-11,-2,-3,5,0,0,-1,1,-1,-1,-1,5,-1
KR_6764919086,420,-7,-42,-12,-17,-7,7,0,-3,5,2,-8,10,2,3,2,5,-2,2,0,0,-18,1,1,-6,5,0,0,-4,-1,1,-1,1,3,-1
KR_6702900246,420,-3,-107,-9,-12,-3,4,1,-1,3,2,-2,6,4,-3,6,3,-3,6,3,0,-14,-2,-4,-3,7,-8,0,-2,0,1,-1,-1,0,-1
KR_6751468201,420,0,76,13,-2,3,0,3,-6,9,3,2,2,4,0,1,1,-1,1,0,0,-7,20,-1,-5,6,0,0,0,-1,-1,0,-1,3,-1
KR_6749755357,420,-2,-39,-12,0,-3,6,3,-1,3,2,1,0,1,4,1,5,-1,1,0,1,3,-4,-1,-4,5,2,0,-3,-1,-1,-1,1,6,-1
KR_6749535002,420,-2,-36,-35,0,-3,3,0,-2,5,3,5,1,6,1,4,5,-1,3,2,0,11,-73,-3,-4,7,-3,0,-2,1,-1,-1,1,4,-1
KR_6761822560,420,-4,-39,-34,-6,-2,4,2,-2,6,4,-1,3,2,1,2,3,-2,2,0,0,1,2,1,-7,6,-2,0,0,-1,1,0,1,1,-1
KR_6703763324,420,-8,-127,-34,-17,-3,4,1,0,3,3,-4,6,2,-7,7,0,-3,4,1,0,-20,5,0,-5,5,0,0,-5,-1,-1,-1,-1,6,-1
KR_6741326051,420,-1,-22,36,-2,-1,1,0,0,5,5,-3,4,1,0,0,0,2,0,2,0,0,13,0,-3,3,-1,0,-1,1,-1,-1,-1,3,-1
KR_6693763298,420,3,52,6,0,0,1,1,1,3,4,-3,4,1,3,0,3,-1,2,1,0,-3,-3,-4,-7,11,0,0,0,-1,-1,0,1,4,-1
KR_6761849452,440,6,-2,14,9,0,1,1,6,0,6,6,0,6,-2,5,3,-1,2,1,0,6,-3,-2,0,2,0,0,-2,0,0,-1,1,0,-1
KR_6682968187,420,-6,-50,7,-18,-5,5,0,-3,4,1,-3,3,0,-4,6,2,-3,4,1,0,-11,-5,-6,-1,7,0,0,-3,1,-1,-1,-1,3,-1
KR_6752196497,440,-1,-6,12,-9,-2,2,0,0,2,2,0,2,2,-10,11,1,3,3,6,0,-9,14,-1,-2,3,-3,0,0,-1,1,1,1,5,-1
KR_6653001333,420,-2,-54,5,-11,-6,6,0,-5,6,1,1,1,2,1,2,3,-2,4,2,0,-7,9,0,-7,7,-3,0,-1,1,-1,-1,-1,2,-1
KR_6764969020,420,0,-9,-12,11,1,1,2,1,3,4,0,2,2,5,2,7,4,1,5,0,12,199,1,-3,2,0,0,1,-1,1,1,1,1,-1
KR_6694422715,420,1,0,-16,2,-1,3,2,-2,4,2,1,1,2,4,0,4,0,0,0,0,4,-2,3,-8,5,5,0,0,-1,-1,0,-1,5,-1
KR_6745403320,440,-4,-49,-32,-4,1,2,3,-3,4,1,4,1,5,-3,5,2,-3,3,0,0,1,-10,-1,-4,5,0,0,-2,-1,-1,-1,1,3,-1
KR_6747446104,420,-3,-79,-11,-5,-6,6,0,0,2,2,0,5,5,0,2,2,1,0,1,0,-2,-1,1,-3,2,-2,0,-1,1,1,-1,-1,5,-1
KR_6762546785,420,1,22,8,1,2,0,2,-1,3,2,-2,2,0,1,2,3,1,0,1,0,-1,-13,-1,-3,4,-2,0,0,-1,1,0,-1,3,-1
KR_6647684678,420,-2,-58,-4,-2,-6,7,1,0,2,2,4,2,6,0,1,1,0,1,1,0,6,-46,1,-2,1,7,0,-1,1,-1,-1,-1,3,-1
KR_6557548481,420,-4,-65,11,-5,0,4,4,1,2,3,-7,8,1,1,1,2,0,0,0,-1,-14,-24,-6,-4,10,2,0,1,-1,1,1,-1,6,-1
KR_6770210518,440,2,5,7,5,-1,1,0,2,4,6,0,2,2,6,0,6,-2,3,1,0,8,-98,3,-6,3,-1,0,0,-1,-1,0,1,1,-1
KR_6638902218,420,1,13,0,0,-2,3,1,2,2,4,0,3,3,1,0,1,-1,1,0,0,-6,4,3,-7,4,-6,0,0,-1,1,1,1,3,-1
KR_6758297703,420,0,14,-3,0,-1,1,0,2,1,3,0,3,3,-1,1,0,0,0,0,0,5,-1,-2,-4,6,0,0,-1,-1,-1,-1,1,4,-1
KR_6759534143,420,1,53,-3,3,4,1,5,0,2,2,-1,5,4,5,1,6,-5,6,1,0,-2,-58,0,-3,3,19,0,0,-1,1,1,1,1,-1
KR_6677768532,420,1,33,-7,-5,-1,2,1,-1,2,1,-2,3,1,-1,3,2,0,3,3,0,-4,8,2,-3,1,-2,0,0,1,-1,-1,-1,4,-1
KR_6694165841,420,-3,-20,-10,-8,-1,1,0,-9,11,2,2,0,2,1,2,3,-1,1,0,1,-2,3,6,-11,5,-3,0,-1,1,-1,-1,1,6,-1
KR_6751086393,420,0,-34,-17,-4,-3,3,0,-2,4,2,0,4,4,1,1,2,0,0,0,0,-2,-118,2,-5,3,3,0,0,-1,1,0,-1,5,-1
KR_6764936650,420,-6,-74,-15,-8,-4,5,1,0,3,3,-6,9,3,-2,3,1,4,0,4,0,6,-36,3,-8,5,-5,0,-2,-1,-1,-1,-1,5,-1
KR_6762066079,420,-5,-112,-12,-7,-4,6,2,1,2,3,-4,5,1,0,5,5,0,0,0,0,3,3,0,-5,5,-2,0,-1,0,-1,-1,-1,0,-1
KR_6743159453,420,2,21,11,0,0,1,1,-2,4,2,2,0,2,1,3,4,-1,2,1,0,-6,10,7,-11,4,1,0,0,1,-1,0,1,6,-1
KR_6761781969,420,-8,-11,-39,-19,-6,6,0,-6,6,0,-2,2,0,-3,6,3,-2,2,0,0,-5,-1,3,-5,2,-4,0,-2,-1,1,-1,-1,3,-1
KR_6742143057,440,-1,-12,-8,-6,-2,4,2,-4,5,1,-2,4,2,1,0,1,1,1,2,0,-6,5,-4,-1,5,-3,0,0,-1,-1,-1,-1,1,-1
KR_6649557702,420,-1,-23,-20,1,5,1,6,1,2,3,-2,2,0,-2,3,1,-1,1,0,0,-7,321,-2,-2,4,0,0,0,-1,-1,0,1,1,-1
KR_6758431141,420,-1,-21,20,-1,-1,3,2,4,3,7,-1,1,0,-2,4,2,-1,1,0,0,-3,417,2,-6,4,-4,0,1,-1,1,1,1,6,-1
KR_6768665738,420,0,68,-28,-6,-4,4,0,-1,2,1,-4,5,1,2,3,5,1,2,3,0,-1,5,-2,-2,4,0,0,1,-1,-1,1,1,6,-1
KR_6746433829,440,-1,1,16,3,3,0,3,4,2,6,-8,9,1,-1,4,3,5,1,6,0,3,-59,-2,-5,7,-4,0,-1,1,-1,-1,1,6,-1
KR_6768026508,420,-1,19,-9,2,3,1,4,-2,3,1,-1,1,0,1,2,3,1,3,4,0,-5,114,-2,-4,6,-2,0,1,1,-1,-1,-1,6,-1
KR_6649067750,420,-2,-62,8,-4,2,0,2,-4,5,1,-2,5,3,0,1,1,0,1,1,1,-2,-2,-4,-2,6,-4,0,0,1,1,0,1,3,-1
KR_6718441973,440,-1,12,-22,-3,0,2,2,2,1,3,-4,4,0,-3,3,0,2,0,2,0,-1,-1,3,-6,3,3,0,-1,1,1,-1,1,1,-1
KR_6756857308,420,0,-47,-2,5,1,1,2,2,1,3,-2,6,4,3,2,5,1,0,1,0,4,-1,1,-8,7,-10,0,0,-1,1,0,-1,5,-1
KR_6720484663,420,-5,-69,-23,-17,-1,1,0,-5,6,1,-3,3,0,-6,9,3,-2,3,1,0,-21,-5,2,-5,3,-3,0,-1,0,1,-1,-1,0,-1
KR_6674387625,420,-2,9,4,-3,-1,4,3,-4,5,1,-1,4,3,3,3,6,0,0,0,0,-1,-36,1,-7,6,10,0,0,1,1,0,-1,6,-1
KR_6749089850,440,-6,-65,-31,-20,-5,5,0,-11,11,0,4,2,6,-6,8,2,-2,2,0,-1,-28,-1,-2,-3,5,-7,0,-3,-1,-1,-1,-1,3,-1
KR_6769932350,440,-1,10,9,-6,-2,4,2,0,1,1,0,1,1,-3,4,1,-1,1,0,0,-6,19,-4,-5,9,-2,0,-1,1,-1,-1,-1,1,-1
KR_6766523508,420,1,-13,5,10,0,1,1,4,6,10,6,1,7,0,2,2,0,1,1,1,7,-16,2,-7,5,-4,0,2,1,-1,1,1,4,-1
KR_6638819640,420,2,40,-16,0,-1,3,2,0,4,4,-1,1,0,3,0,3,-1,1,0,1,4,-12,-4,-2,6,2,0,0,-1,-1,0,1,4,-1
KR_6760866202,440,0,28,-2,1,4,1,5,-2,5,3,2,2,4,-3,3,0,0,1,1,0,-8,-22,0,-2,2,-2,0,0,1,0,-1,1,6,-1
KR_6767516930,420,-6,-74,-25,-10,-4,5,1,-4,5,1,-1,3,2,1,1,2,-2,2,0,0,-10,3,-5,-4,9,-3,0,-2,-1,-1,-1,-1,3,-1
KR_6758115999,420,0,-5,-23,1,-1,1,0,0,4,4,2,0,2,0,2,2,0,1,1,0,-1,3,1,-8,7,-4,0,0,-1,1,0,-1,5,-1
KR_6768823433,420,0,-16,12,0,2,2,4,0,3,3,1,3,4,0,4,4,-3,4,1,0,-1,0,0,-6,6,-2,0,0,-1,0,0,1,3,-1
