matchId,queueId,Diff_LV,Diff_CS,Diff_jglCS,Diff-K,Diff-K-top,K-WIN-top,K-LOSE-top,Diff-K-jug,K-WIN-jug,K-LOSE-jug,Diff-K-mid,K-WIN-mid,K-LOSE-mid,Diff-K-ad,K-WIN-ad,K-LOSE-ad,Diff-K-sup,K-WIN-sup,K-LOSE-sup,invadeKill,Diff-A,Diff_WARDplaced,Diff-ControlWARDplaced,LOSE_controlWARDPlaced,WIN_controlWARDPlaced,Diff_WARDkill,Diff_Inhibitor,Diff_TOWERkill,Diff_FirstDRAGON,Diff_FirstHERALD,Diff_Firsttower,Diff_FirstBLOOD,dragonType,result
KR_6690423531,420,2,70,7,6,0,3,3,4,1,5,5,7,12,-1,4,3,-2,2,0,0,7,-6,-2,-7,9,-4,0,1,1,1,-1,-1,4,-1
KR_6768882598,420,0,-5,-21,0,-2,2,0,-3,3,0,5,1,6,0,2,2,0,1,1,0,-4,-1,1,-4,3,-1,0,0,0,1,1,-1,0,-1
KR_6768051218,420,0,15,-4,2,0,0,0,0,3,3,0,2,2,2,0,2,0,1,1,0,4,37,-3,-2,5,-18,0,0,-1,1,0,-1,3,-1
KR_6750434504,420,-3,-79,5,-7,-5,6,1,-2,5,3,2,4,6,-1,4,3,-1,1,0,0,-1,8,9,-14,5,-1,0,-1,-1,-1,-1,1,1,-1
KR_6759472783,420,0,19,0,-6,-2,2,0,0,1,1,0,4,4,-3,4,1,-1,2,1,0,-4,-9,0,-7,7,-1,0,-1,-1,-1,-1,-1,2,-1
KR_6766631279,420,1,-33,5,-1,1,0,1,-3,6,3,1,0,1,0,2,2,0,0,0,0,4,0,-1,-4,5,5,0,0,1,-1,1,1,6,-1
KR_6762983429,440,0,-68,16,5,-2,4,2,2,0,2,0,1,1,7,0,7,-2,2,0,2,15,96,-1,-7,8,-3,0,0,1,1,1,1,4,-1
KR_6628032819,440,-6,-112,5,-24,-7,7,0,0,1,1,-5,6,1,-1,5,4,-11,11,0,-4,-33,32,-6,0,6,-23,0,-2,0,-1,-1,-1,0,-1
KR_6765602231,420,-1,-30,-7,-5,-1,1,0,2,4,6,-8,9,1,1,2,3,1,3,4,-1,5,-15,-3,-5,8,2,0,0,-1,-1,-1,-1,6,-1
KR_6762647029,420,1,0,24,2,-3,4,1,3,2,5,3,1,4,-3,7,4,2,1,3,0,6,26,-8,-1,9,6,0,1,-1,1,1,1,3,-1
KR_6732106928,420,-5,-10,-17,-6,3,3,6,-9,10,1,0,2,2,2,4,6,-2,2,0,0,-7,-10,-2,-4,6,2,0,-1,1,1,-1,1,4,-1
KR_6719857977,420,-2,2,20,-1,0,0,0,-1,2,1,-2,3,1,2,1,3,0,0,0,0,-3,118,-1,-5,6,0,0,0,-1,1,0,1,1,-1
KR_6681851805,420,-3,-67,38,-10,-3,3,0,3,0,3,-3,5,2,-5,7,2,-2,2,0,0,-9,14,1,-7,6,-5,0,-1,1,-1,-1,1,6,-1
KR_6724585119,420,1,46,-16,1,1,2,3,-1,2,1,-4,4,0,2,0,2,3,1,4,0,1,-2,1,-3,2,1,0,0,1,0,0,1,2,-1
KR_6768553542,420,-5,-52,-1,-8,0,1,1,-4,4,0,4,2,6,-8,8,0,0,3,3,0,-9,-2,6,-10,4,-3,0,-2,1,-1,-1,1,5,-1
KR_6637983881,420,-6,-115,-44,-13,-5,5,0,-2,4,2,0,4,4,-5,5,0,-1,1,0,-1,-9,6,-1,-4,5,-3,0,-3,-1,-1,-1,-1,3,-1
KR_6693042001,420,-4,-10,-12,-13,-4,4,0,-4,4,0,-1,1,0,-5,5,0,1,0,1,0,-15,-5,-6,-4,10,-6,0,1,-1,-1,1,-1,2,-1
KR_6725670352,440,0,-33,-32,6,-2,4,2,8,2,10,-1,1,0,-2,2,0,3,0,3,1,17,9,7,-9,2,-2,0,-1,1,-1,-1,1,1,-1
KR_6765828294,420,-8,-39,-24,-13,-5,6,1,-4,6,2,-3,5,2,-2,5,3,1,1,2,0,-5,-36,2,-5,3,11,0,-1,1,-1,-1,1,4,-1
KR_6760090936,420,-4,-37,-52,-7,1,2,3,-4,4,0,-1,1,0,-3,3,0,0,2,2,0,-8,-10,-1,-4,5,2,0,0,-1,-1,0,-1,6,-1
KR_6734130792,420,0,4,6,-6,2,1,3,-3,6,3,0,2,2,-4,6,2,-1,1,0,0,-8,-284,-3,-4,7,5,0,-1,1,1,-1,-1,6,-1
KR_6704339719,420,-1,20,0,3,-2,4,2,1,3,4,3,4,7,-2,7,5,3,0,3,1,3,-23,2,-6,4,0,0,0,1,1,1,1,3,-1
KR_6743721076,420,0,27,19,-5,-1,1,0,1,0,1,0,4,4,1,4,5,-6,7,1,0,-19,-51,-3,-4,7,4,0,0,-1,-1,-1,1,2,-1
KR_6726710495,440,-9,-63,-65,-15,-8,8,0,-12,12,0,0,1,1,1,2,3,4,0,4,-3,-18,-16,-2,-3,5,-2,0,-1,0,-1,-1,-1,0,-1
KR_6766885967,420,-3,-46,16,-9,-3,4,1,-3,4,1,-4,4,0,1,1,2,0,1,1,0,-11,-32,2,-7,5,-5,0,-1,1,1,-1,1,6,-1
KR_6762614610,420,-1,-40,22,-4,-1,3,2,1,1,2,2,3,5,-9,10,1,3,1,4,0,1,20,2,-6,4,-1,0,-1,-1,-1,-1,-1,4,-1
KR_6757505024,420,1,21,29,2,1,2,3,-5,7,2,8,2,10,-4,7,3,2,0,2,0,2,-1,-2,-8,10,-1,0,1,1,1,1,1,3,-1
KR_6736661467,440,-2,-11,-16,-3,0,2,2,-2,5,3,0,2,2,-2,2,0,1,0,1,0,-6,-30,6,-12,6,-3,0,-1,-1,-1,-1,1,3,-1
KR_6612143833,420,1,41,-10,3,-2,3,1,2,2,4,0,4,4,0,1,1,3,1,4,0,10,2,1,-7,6,1,0,1,-1,-1,1,1,2,-1
KR_6767811201,420,1,42,-17,1,-1,2,1,2,4,6,1,0,1,-1,1,0,0,2,2,-1,3,0,3,-9,6,-1,0,2,-1,1,1,-1,2,-1
KR_6734942369,420,-3,-88,-4,-9,-1,3,2,-1,4,3,-1,3,2,-5,5,0,-1,1,0,0,-14,8,-4,-5,9,-9,0,0,-1,-1,-1,-1,4,-1
KR_6755539835,420,-2,-17,-3,2,1,0,1,1,3,4,0,1,1,-1,3,2,1,0,1,0,6,8,-1,-5,6,-2,0,0,-1,-1,0,-1,3,-1
KR_6763330307,440,-1,-10,-12,-2,-4,5,1,0,0,0,2,0,2,0,2,2,0,2,2,0,-5,1,1,-4,3,1,0,0,-1,1,1,1,3,-1
KR_6743933462,420,-3,-25,-22,-8,-7,7,0,0,2,2,-4,5,1,4,2,6,-1,1,0,-1,-2,-7,3,-8,5,2,0,-3,-1,-1,-1,-1,6,-1
KR_6713957064,420,-1,-56,2,-7,-2,3,1,2,4,6,-3,4,1,-3,4,1,-1,1,0,0,-8,136,6,-10,4,-4,0,0,-1,-1,0,-1,6,-1
KR_6730578228,420,-1,-13,12,-7,1,0,1,-1,5,4,-1,2,1,-4,5,1,-2,2,0,0,-11,-9,-5,-7,12,-8,0,1,-1,-1,1,1,2,-1
KR_6748457571,440,0,51,-4,0,-1,1,0,3,3,6,-1,5,4,-2,3,1,1,0,1,0,-5,-33,2,-4,2,3,0,0,-1,1,1,-1,3,-1
KR_6758834955,420,-2,-38,-20,-1,1,4,5,3,1,4,-1,4,3,-4,7,3,0,2,2,0,-6,-134,0,-9,9,-10,0,0,1,-1,-1,1,6,-1
KR_6746210006,420,-1,4,13,-1,-1,1,0,1,1,2,-1,3,2,0,3,3,0,2,2,2,1,6,5,-14,9,-3,0,0,1,1,1,1,4,-1
KR_6751037076,440,-3,-55,4,-14,-8,9,1,1,1,2,-2,2,0,-1,3,2,-4,4,0,0,-14,-12,-5,-4,9,2,0,-2,-1,-1,-1,-1,1,-1
KR_6722553904,420,-3,54,-3,-5,-3,6,3,-2,7,5,-1,3,2,-1,3,2,2,0,2,0,-10,-6,-6,-1,7,0,0,0,-1,-1,-1,-1,3,-1
KR_6766048041,420,0,-19,-8,-4,1,1,2,-5,5,0,-2,3,1,2,0,2,0,0,0,0,-5,-7,-4,-2,6,0,0,-2,-1,-1,-1,-1,6,-1
KR_6716407861,420,-1,-39,1,-9,-3,3,0,0,3,3,-5,7,2,-1,5,4,0,2,2,-1,-5,-5,-4,-5,9,5,0,-1,1,-1,-1,-1,2,-1
KR_6745970875,420,-3,15,-35,-1,0,2,2,0,1,1,-2,3,1,2,2,4,-1,1,0,0,-5,-12,-1,-2,3,-2,0,0,-1,-1,-1,1,3,-1
KR_6752273846,420,-1,40,-12,-1,1,1,2,-3,3,0,-1,4,3,2,2,4,0,1,1,0,0,4,2,-5,3,0,0,-1,0,1,-1,1,0,-1
KR_6679036158,420,-3,34,-34,-4,2,0,2,-3,5,2,-4,4,0,2,0,2,-1,2,1,0,-3,-7,-4,-5,9,0,0,-1,-1,-1,-1,-1,1,-1
KR_6740102124,420,-4,-71,-36,-10,-4,5,1,4,3,7,0,3,3,-10,10,0,0,2,2,0,-8,-7,2,-5,3,-5,0,-1,-1,1,-1,1,2,-1
KR_6759698337,420,-2,-9,20,-6,-2,2,0,-3,3,0,1,2,3,-3,6,3,1,0,1,0,-12,-2,-3,-5,8,-3,0,0,-1,1,0,-1,3,-1
KR_6766850856,420,-2,-25,13,-5,0,1,1,-3,3,0,-1,1,0,-1,4,3,0,0,0,0,-6,-6,-1,-4,5,-1,0,0,1,-1,0,-1,5,-1
KR_6762507301,420,0,-1,-5,-7,-3,6,3,2,3,5,0,1,1,-5,7,2,-1,1,0,-1,-15,-6,3,-7,4,-6,0,0,1,1,1,-1,5,-1
KR_6749174322,420,-1,-27,-6,3,0,1,1,-2,4,2,0,1,1,4,3,7,1,0,1,1,12,-92,2,-3,1,-3,0,-1,1,-1,-1,1,2,-1
KR_6758197470,440,-4,-80,-30,-6,-1,1,0,-2,6,4,1,3,4,-4,4,0,0,0,0,-1,-9,-41,2,-11,9,-4,0,-2,-1,-1,-1,-1,5,-1
KR_6727956172,420,1,45,8,-4,-1,1,0,-2,5,3,1,1,2,-1,1,0,-1,1,0,0,-7,-11,2,-5,3,3,0,0,1,1,0,-1,4,-1
KR_6764440106,420,-2,-42,-18,1,0,2,2,-2,2,0,0,1,1,2,5,7,1,1,2,0,6,0,1,-6,5,2,0,-2,-1,-1,-1,-1,6,-1
KR_6739982806,420,-6,-35,-43,-8,2,1,3,-4,5,1,-3,4,1,0,4,4,-3,4,1,0,-7,12,3,-5,2,-3,0,0,-1,-1,-1,1,4,-1
KR_6724569684,420,-1,-34,-16,-4,0,1,1,5,0,5,-7,11,4,0,1,1,-2,2,0,-1,-4,-7,2,-6,4,1,0,-1,1,-1,-1,-1,4,-1
KR_6745062031,420,-1,-26,-28,-7,-3,3,0,1,4,5,-1,1,0,-4,7,3,0,1,1,-1,-9,-16,0,-3,3,-4,0,-1,0,-1,-1,-1,0,-1
KR_6763468038,440,0,39,32,1,3,1,4,1,1,2,-4,6,2,0,2,2,1,0,1,0,-1,-12,-5,-2,7,-1,0,0,-1,-1,0,-1,6,-1
KR_6767984910,420,-3,1,7,-9,0,2,2,-4,5,1,-2,3,1,-2,4,2,-1,2,1,0,-10,0,0,-9,9,4,0,1,-1,1,1,-1,5,-1
KR_6764076206,420,-2,-31,11,-4,-4,5,1,1,1,2,0,1,1,2,2,4,-3,3,0,0,6,-44,0,-5,5,20,0,0,-1,0,0,-1,1,-1
KR_6764752110,420,-5,-74,16,-13,-5,7,2,0,4,4,-7,7,0,1,2,3,-2,2,0,0,-1,7,-5,0,5,1,0,-1,-1,-1,-1,-1,5,-1
KR_6764199273,420,0,-8,-7,2,0,0,0,3,2,5,2,2,4,-2,5,3,-1,2,1,0,7,-305,-5,-2,7,3,0,-2,-1,-1,-1,1,6,-1
KR_6712760705,420,4,36,28,5,-2,5,3,2,3,5,1,2,3,4,3,7,0,0,0,0,7,-7,1,-5,4,4,0,1,1,-1,-1,-1,5,-1
KR_6766143924,420,2,15,-21,-1,-2,4,2,3,0,3,-1,3,2,-3,5,2,2,0,2,0,0,-1,-4,-4,8,0,0,1,1,1,1,-1,5,-1
KR_6749047685,420,-3,9,17,-11,-2,2,0,-4,5,1,-2,2,0,-3,6,3,0,1,1,0,-27,-12,1,-8,7,0,0,-1,1,1,-1,-1,4,-1
KR_6769199395,440,-4,-3,-39,-4,0,1,1,2,0,2,-3,3,0,-2,4,2,-1,1,0,0,-6,-59,-2,-5,7,-2,0,0,-1,1,0,-1,1,-1
KR_6759256550,420,1,30,21,4,4,0,4,-3,6,3,5,2,7,-2,3,1,0,2,2,0,9,-5,5,-10,5,-8,0,1,1,1,1,1,1,-1
KR_6761685111,440,4,-25,22,12,4,1,5,4,2,6,2,0,2,-1,2,1,3,2,5,1,14,-6,0,-3,3,-2,0,1,-1,-1,1,1,5,-1
KR_6761737786,420,-3,-10,-8,-2,-2,3,1,1,3,4,1,2,3,1,3,4,-3,3,0,0,0,0,0,-6,6,3,0,-1,-1,-1,-1,1,5,-1
KR_6768573997,440,-6,-16,-32,-16,-2,3,1,-8,9,1,-2,4,2,0,6,6,-4,7,3,0,-14,2,-1,-6,7,1,0,1,-1,1,1,-1,5,-1
KR_6689497412,420,1,44,17,-5,3,0,3,0,1,1,1,0,1,1,1,2,-10,12,2,0,-11,-111,-2,-5,7,5,0,-1,1,-1,-1,-1,2,-1
KR_6761706289,420,-6,-18,-17,-10,-3,4,1,0,2,2,-3,4,1,-3,3,0,-1,1,0,0,-11,-18,-4,-5,9,2,0,0,-1,-1,-1,-1,6,-1
KR_6725726245,420,-1,-90,18,-5,4,1,5,-3,8,5,-3,4,1,-2,3,1,-1,1,0,0,-4,1,2,-6,4,-5,0,0,1,-1,0,1,1,-1
KR_6497544515,420,-5,-78,-11,-12,-2,2,0,-1,5,4,-2,4,2,-5,6,1,-2,4,2,0,-25,-2,6,-8,2,-2,0,-1,-1,1,-1,-1,5,-1
KR_6754605556,420,-2,24,-2,-7,-1,2,1,-3,3,0,3,1,4,-3,4,1,-3,4,1,0,-9,1,1,-9,8,-2,0,0,-1,1,0,-1,3,-1
KR_6754587017,420,-2,-13,15,-10,-2,3,1,-1,3,2,-3,4,1,-2,7,5,-2,2,0,0,-13,-20,3,-6,3,1,0,-1,-1,-1,-1,-1,4,-1
KR_6693312150,420,-1,49,9,-7,-2,6,4,3,0,3,0,1,1,-9,9,0,1,0,1,0,-15,5,-7,-5,12,-3,0,0,-1,0,-1,-1,3,-1
KR_6738592437,420,1,-18,23,-4,0,0,0,3,5,8,-5,10,5,1,1,2,-3,7,4,-2,-4,-8,0,-8,8,3,0,0,1,-1,0,1,4,-1
KR_6694048323,420,-5,-89,-70,-9,-1,3,2,-3,5,2,-4,4,0,-1,1,0,0,0,0,-2,-2,-2,0,-6,6,-1,0,-4,-1,-1,-1,-1,6,-1
KR_6768995565,420,-1,-62,-13,-13,-1,3,2,0,2,2,-5,8,3,-4,7,3,-3,3,0,0,-4,-5,-1,-6,7,1,0,1,-1,1,1,1,4,-1
KR_6765858087,420,0,-6,0,3,4,2,6,5,2,7,0,2,2,-3,4,1,-3,4,1,2,-3,3,3,-11,8,2,0,0,1,1,1,1,5,-1
KR_6735230130,420,2,13,8,3,-4,5,1,3,0,3,0,3,3,2,2,4,2,1,3,-2,3,3,0,-5,5,5,0,0,-1,-1,0,-1,6,-1
KR_6764127620,420,0,-9,28,2,0,0,0,1,2,3,0,2,2,1,1,2,0,0,0,0,-1,-27,2,-6,4,-6,0,0,-1,1,0,1,1,-1
KR_6716492448,420,4,44,40,2,0,3,3,2,2,4,0,4,4,3,1,4,-3,4,1,0,-2,252,4,-7,3,2,0,0,1,1,-1,-1,3,-1
KR_6765670484,440,2,-29,48,5,0,1,1,9,2,11,-5,7,2,2,2,4,-1,1,0,2,4,-105,0,-5,5,5,0,-1,1,-1,-1,1,2,-1
KR_6768768704,420,-3,-32,-20,-14,0,3,3,-5,10,5,0,3,3,-8,8,0,-1,1,0,-3,-27,18,-11,-3,14,1,0,-3,-1,-1,-1,-1,2,-1
KR_6754574843,420,0,60,-12,2,0,1,1,3,1,4,4,1,5,-5,5,0,0,0,0,0,-3,-7,3,-9,6,1,0,0,-1,1,-1,1,4,-1
KR_6761796805,420,-1,-6,-9,-2,-7,9,2,1,1,2,0,2,2,4,1,5,0,0,0,0,3,-6,1,-8,7,2,0,1,1,-1,-1,-1,4,-1
KR_6767014453,420,-3,-7,-1,-7,-1,1,0,-1,4,3,-1,1,0,-3,5,2,-1,1,0,-1,-12,-14,-4,-4,8,3,0,-1,-1,-1,-1,-1,1,-1
KR_6753508771,420,-5,-90,-16,-8,-4,4,0,0,2,2,-2,4,2,-1,4,3,-1,1,0,0,-3,12,1,-6,5,-1,0,-1,-1,-1,-1,-1,6,-1
KR_6766863781,420,-1,-78,8,-7,0,2,2,-4,4,0,-2,3,1,-1,6,5,0,1,1,-1,-5,-4,-1,-4,5,-1,0,0,1,-1,-1,-1,2,-1
KR_6597526852,420,-4,-19,0,-13,1,1,2,-1,6,5,-2,2,0,-11,16,5,0,0,0,0,-21,-13,-5,-2,7,0,0,-2,-1,1,-1,1,5,-1
KR_6656614925,420,-1,-31,0,-2,-2,2,0,1,1,2,-3,6,3,0,3,3,2,2,4,0,2,8,2,-7,5,6,0,0,1,1,0,-1,6,-1
KR_6768571012,420,-3,-14,-40,-6,-1,2,1,0,1,1,-7,8,1,1,2,3,1,0,1,0,-6,-5,2,-3,1,-1,0,-1,-1,-1,-1,-1,1,-1
KR_6750466149,420,3,74,2,6,-3,5,2,5,0,5,-1,1,0,5,0,5,0,0,0,0,10,5,-4,-8,12,-2,0,1,-1,1,1,1,3,-1
KR_6767778121,420,-4,14,-9,-7,-1,2,1,-2,5,3,-1,1,0,-3,5,2,0,3,3,0,-6,18,5,-7,2,-2,0,-3,1,-1,-1,1,4,-1
KR_6705564660,420,0,-38,-5,-3,3,0,3,0,4,4,-3,4,1,-3,9,6,0,2,2,1,-11,6,-1,-2,3,-4,0,-1,-1,1,-1,1,4,-1
KR_6729886087,440,-2,-37,-5,-3,1,2,3,3,2,5,-3,3,0,-3,5,2,-1,1,0,0,-1,14,5,-6,1,-7,0,0,-1,1,0,-1,5,-1
KR_6689410272,420,-1,-47,-25,-1,0,4,4,-1,5,4,-3,5,2,2,3,5,1,0,1,-2,7,0,4,-9,5,-4,0,-2,1,-1,-1,-1,3,-1
KR_6734328422,420,-4,31,-5,-12,-5,5,0,-2,3,1,2,1,3,-8,11,3,1,0,1,0,-18,-3,-5,-5,10,7,0,0,-1,1,1,1,5,-1
KR_6762289121,420,-4,-46,24,-8,-5,6,1,1,0,1,0,1,1,-2,2,0,-2,3,1,1,-1,1,0,-6,6,1,0,-1,0,-1,-1,1,0,-1
KR_6767357132,420,2,50,-20,-2,-2,5,3,-3,4,1,2,1,3,1,0,1,0,0,0,-1,-6,6,0,-4,4,1,0,0,-1,-1,1,-1,3,-1
KR_6758753574,420,0,61,11,-2,-4,6,2,0,3,3,3,1,4,-1,4,3,0,2,2,0,-5,-5,-7,-5,12,3,0,1,1,-1,1,-1,3,-1
KR_6755763213,420,-1,-6,-2,-3,-4,4,0,3,1,4,-3,3,0,1,0,1,0,1,1,0,0,2,-2,-6,8,1,0,1,-1,1,1,1,3,-1
KR_6766141919,440,-1,-27,-8,5,-7,9,2,2,3,5,4,0,4,6,0,6,0,1,1,1,11,-7,-3,-7,10,-2,0,2,1,1,1,1,5,-1
KR_6741939644,420,-4,-66,-43,-4,-7,7,0,-4,6,2,3,1,4,4,2,6,0,2,2,1,0,-44,2,-8,6,12,0,-1,-1,1,-1,-1,6,-1
KR_6765506465,420,0,-8,3,2,1,2,3,2,1,3,-4,4,0,2,0,2,1,0,1,-1,9,8,2,-8,6,0,0,-2,1,-1,-1,-1,1,-1
KR_6694618230,420,-1,9,-4,-7,1,2,3,0,3,3,-3,5,2,-5,5,0,0,0,0,0,-8,1,5,-10,5,-1,0,0,-1,1,-1,-1,5,-1
KR_6749866961,420,1,26,0,-7,-2,3,1,0,2,2,-1,2,1,-2,5,3,-2,2,0,-2,-12,-4,-1,-5,6,1,0,0,0,1,0,1,0,-1
KR_6768987591,420,-1,-43,14,-4,-1,2,1,-3,4,1,-6,7,1,5,2,7,1,1,2,0,-5,2,2,-7,5,3,0,-1,-1,-1,1,-1,3,-1
KR_6611976269,420,0,14,26,-3,2,1,3,-1,6,5,0,1,1,-4,4,0,0,0,0,0,-2,7,0,-5,5,3,0,-1,-1,-1,-1,-1,2,-1
KR_6749369221,440,-3,-9,-12,-18,-2,2,0,-3,3,0,-6,9,3,-5,5,0,-2,3,1,0,-19,119,-2,0,2,1,0,-1,1,-1,-1,-1,3,-1
KR_6764042133,420,-5,-43,29,-7,-5,6,1,0,2,2,1,0,1,1,2,3,-4,5,1,0,-7,242,1,-6,5,-1,0,0,1,1,1,-1,3,-1
KR_6742302670,420,-2,-29,-23,5,7,0,7,2,1,3,1,3,4,-6,6,0,1,0,1,1,0,21,2,-7,5,-6,0,1,-1,-1,-1,1,4,-1
KR_6768687886,440,-5,28,-27,-8,-2,2,0,-2,5,3,-5,6,1,-1,2,1,2,0,2,0,-15,6,0,-6,6,-2,0,0,1,-1,-1,1,3,-1
KR_6761066183,420,-2,35,-25,-10,-2,4,2,-5,7,2,2,2,4,-5,6,1,0,0,0,0,-18,30,-3,-4,7,-9,0,0,-1,-1,0,-1,3,-1
KR_6755361832,420,-3,-30,0,-6,-1,1,0,3,1,4,-5,8,3,2,1,3,-5,6,1,0,-4,-8,1,-3,2,-2,0,-2,-1,-1,-1,-1,3,-1
KR_6768470091,420,0,37,-10,-1,1,3,4,-4,5,1,1,0,1,1,5,6,0,1,1,0,2,-3,2,-10,8,-2,0,1,-1,1,1,1,5,-1
KR_6643272852,420,-5,2,-8,-14,1,0,1,-5,6,1,-9,9,0,0,2,2,-1,1,0,0,-19,-199,0,-5,5,-1,0,-2,-1,-1,-1,-1,5,-1
KR_6765160803,420,-5,-91,-28,-8,-3,4,1,3,2,5,-2,4,2,-5,7,2,-1,1,0,0,-5,55,6,-8,2,-13,0,-2,-1,1,-1,1,3,-1
KR_6759961686,420,3,36,-6,2,-1,2,1,3,0,3,3,0,3,-1,1,0,-2,3,1,0,4,36,3,-8,5,-4,0,0,-1,-1,0,-1,3,-1
KR_6734803091,420,-5,-53,0,-16,-5,6,1,-3,6,3,1,1,2,-5,5,0,-4,4,0,0,-16,4,0,-5,5,-2,0,-1,0,1,-1,-1,0,-1
KR_6732602923,420,-7,-49,-16,-9,-1,1,0,-7,7,0,-1,3,2,-3,3,0,3,0,3,0,-6,-3,-1,-3,4,-1,0,-2,0,0,-1,1,0,-1
KR_6672305392,420,-5,-39,-28,-9,-2,2,0,-2,3,1,-5,6,1,0,2,2,0,2,2,0,-6,4,2,-7,5,-5,0,-1,-1,-1,-1,-1,4,-1
KR_6765654795,420,-4,-72,-5,-5,-2,4,2,-4,7,3,-3,5,2,4,0,4,0,0,0,0,1,0,1,-6,5,4,0,0,1,-1,-1,1,1,-1
KR_6759151965,420,-1,11,-8,-1,4,0,4,-2,5,3,-1,3,2,-1,3,2,-1,1,0,0,1,177,1,-5,4,-1,0,0,-1,-1,0,1,4,-1
KR_6766466409,440,-6,-125,-56,-19,-2,3,1,-4,4,0,-10,11,1,1,2,3,-4,4,0,0,-7,-7,-3,-2,5,-1,0,-1,-1,-1,-1,-1,6,-1
KR_6764971028,420,1,-62,-7,-2,-1,4,3,2,2,4,2,1,3,-3,3,0,-2,3,1,1,-2,72,-2,-5,7,-4,0,-1,1,-1,-1,1,1,-1
KR_6755624793,420,-4,-37,-45,-2,2,1,3,-2,5,3,-2,6,4,-1,4,3,1,1,2,1,0,1,-2,-6,8,1,0,1,-1,-1,1,1,1,-1
KR_6757425494,420,-2,-32,-24,-6,-3,4,1,-3,5,2,-4,5,1,5,1,6,-1,1,0,-1,-3,34,-5,-1,6,0,0,-1,-1,-1,-1,-1,2,-1
KR_6765596431,420,-3,-13,24,-7,2,1,3,1,3,4,-3,3,0,-5,6,1,-2,2,0,0,-13,1,-5,-3,8,-7,0,-1,-1,1,-1,-1,1,-1
KR_6764640975,420,4,5,-4,2,0,2,2,-1,2,1,0,2,2,3,2,5,0,0,0,0,4,11,4,-7,3,0,0,1,1,0,1,-1,5,-1
KR_6764391350,420,3,36,-1,4,-1,3,2,2,0,2,3,0,3,0,3,3,0,1,1,0,15,4,-2,-3,5,0,0,-2,-1,-1,-1,1,4,-1
KR_6746990920,420,-2,13,-9,-6,1,2,3,-3,6,3,2,1,3,-5,7,2,-1,1,0,0,-6,2,-2,-4,6,0,0,0,-1,0,0,-1,5,-1
KR_6768584176,420,0,-21,11,3,1,0,1,-4,5,1,-1,2,1,7,1,8,0,0,0,0,1,-4,-1,-5,6,-2,0,0,1,1,0,1,4,-1
KR_6730137799,420,-1,18,28,-3,-5,5,0,0,1,1,2,1,3,-2,2,0,2,0,2,0,-1,0,-2,-8,10,-2,0,0,-1,-1,-1,-1,2,-1
KR_6764780446,420,0,-15,13,4,0,3,3,3,1,4,0,1,1,-1,6,5,2,0,2,0,2,-8,-1,-4,5,14,0,-1,1,-1,-1,-1,1,-1
KR_6631804122,420,-1,27,-37,-7,0,2,2,-5,7,2,2,3,5,-3,4,1,-1,2,1,-1,-5,8,5,-9,4,0,0,-1,-1,1,-1,-1,3,-1
KR_6626300427,420,-2,28,-1,-10,-3,4,1,-2,5,3,-1,2,1,-3,4,1,-1,1,0,-1,-17,-2,-1,-6,7,3,0,0,1,1,-1,-1,5,-1
KR_6705210972,420,-2,-35,16,-9,-4,4,0,-5,8,3,-3,4,1,3,1,4,0,1,1,-2,-9,-8,-4,-6,10,5,0,-1,1,-1,-1,-1,4,-1
KR_6768026462,420,-4,-65,16,-5,0,1,1,-3,4,1,-2,2,0,0,4,4,0,1,1,0,-6,-17,2,-5,3,2,0,-1,1,-1,-1,1,3,-1
KR_6719028103,420,4,22,29,6,0,2,2,-5,9,4,1,2,3,8,3,11,2,2,4,2,2,-24,-3,-4,7,3,0,-1,1,1,-1,1,1,-1
KR_6762508857,420,4,43,28,4,2,0,2,0,1,1,1,0,1,3,3,6,-2,2,0,0,2,6,1,-5,4,3,0,0,-1,1,1,1,2,-1
KR_6693344712,420,-5,-83,14,-15,-5,6,1,-6,6,0,-4,4,0,-2,2,0,2,0,2,0,-13,-38,-4,-2,6,-1,0,-5,-1,-1,-1,-1,1,-1
KR_6768851615,420,2,50,-19,0,0,0,0,-2,2,0,-1,2,1,3,0,3,0,0,0,0,5,-42,-4,-3,7,22,0,0,-1,-1,0,-1,3,-1
KR_6764982504,420,-6,-89,-38,-7,0,0,0,0,1,1,-4,6,2,0,3,3,-3,3,0,0,-3,15,-1,-5,6,-6,0,-3,1,-1,-1,-1,2,-1
KR_6767493048,420,1,-7,-3,-5,-1,1,0,-3,6,3,1,3,4,-2,6,4,0,0,0,-1,-7,2,2,-7,5,-2,0,-1,-1,1,-1,-1,4,-1
KR_6764008351,420,1,91,-14,7,5,0,5,2,2,4,-2,5,3,1,2,3,1,0,1,0,5,-4,-1,-4,5,5,0,0,1,-1,0,1,3,-1
KR_6633236935,420,-5,-77,-40,-12,-4,5,1,-2,3,1,2,1,3,-5,8,3,-3,3,0,0,-6,4,3,-6,3,-2,0,-3,0,-1,-1,1,0,-1
KR_6765325104,420,-3,-25,-12,-7,-2,2,0,2,2,4,-1,2,1,-2,5,3,-4,4,0,0,-8,-28,-2,-6,8,4,0,1,-1,-1,1,1,3,-1
KR_6744134717,420,-4,-87,-56,-9,-3,4,1,0,5,5,1,1,2,-7,10,3,0,2,2,0,0,3,1,-7,6,-2,0,-3,-1,-1,-1,-1,6,-1
KR_6752760319,420,-1,-23,-15,-1,3,0,3,1,2,3,-1,6,5,-3,4,1,-1,1,0,0,-7,-284,-2,-5,7,-2,0,-1,-1,1,-1,-1,2,-1
KR_6744996501,420,-1,-4,-12,-1,-2,5,3,-2,3,1,-4,8,4,3,0,3,4,0,4,0,7,-10,-4,-4,8,1,0,-1,1,-1,-1,1,2,-1
KR_6647730467,420,-7,-127,-30,-15,-4,6,2,-3,6,3,0,2,2,-5,5,0,-3,5,2,-3,-22,7,1,-6,5,-5,0,-5,-1,-1,-1,-1,6,-1
KR_6756073854,420,-3,-5,-27,-5,1,0,1,2,1,3,-4,8,4,-3,5,2,-1,2,1,0,-1,1,5,-8,3,-5,0,0,-1,-1,0,1,3,-1
KR_6756585763,420,0,43,-27,3,0,3,3,2,1,3,0,3,3,1,0,1,0,1,1,0,1,-4,2,-4,2,8,0,1,0,1,1,1,0,-1
KR_6752545060,420,0,-17,-16,3,0,1,1,-1,2,1,4,0,4,1,1,2,-1,2,1,0,4,-29,0,-5,5,-1,0,-1,-1,-1,-1,-1,2,-1
KR_6762959060,420,0,12,8,13,2,3,5,-4,4,0,6,1,7,8,1,9,1,1,2,1,11,-3,2,-7,5,-1,0,0,1,-1,-1,1,2,-1
KR_6617010446,420,-5,-107,-12,-14,-3,3,0,-3,4,1,-2,5,3,-5,6,1,-1,2,1,0,-14,163,-1,-5,6,2,0,-4,-1,-1,-1,-1,3,-1
KR_6769094320,420,-5,-29,-3,-8,-2,4,2,-3,3,0,-1,3,2,0,4,4,-2,3,1,1,-10,11,-1,-3,4,-1,0,-2,1,-1,-1,1,5,-1
KR_6762936192,420,-1,-6,-4,3,-2,2,0,-1,3,2,3,3,6,1,2,3,2,1,3,0,-5,2,1,-5,4,0,0,1,1,1,1,1,6,-1
KR_6757580255,420,-2,-77,20,-10,-1,2,1,3,4,7,-7,8,1,-4,4,0,-1,1,0,0,2,6,-1,-2,3,0,0,0,-1,1,1,-1,6,-1
KR_6760998955,420,-4,-16,8,-13,-2,5,3,2,1,3,-4,5,1,-4,7,3,-5,5,0,0,-10,5,0,-5,5,-2,0,0,1,-1,-1,1,1,-1
KR_6765975559,420,-2,-38,-1,1,1,3,4,0,2,2,3,1,4,-2,6,4,-1,4,3,2,2,0,1,-8,7,7,0,-1,-1,1,-1,1,1,-1
KR_6768150134,420,-1,2,-22,-12,0,3,3,1,2,3,-4,6,2,-3,6,3,-6,7,1,0,-23,-15,2,-7,5,-11,0,0,-1,-1,-1,-1,6,-1
KR_6602473951,420,-2,-70,20,-7,-5,5,0,-2,5,3,-1,3,2,1,4,5,0,1,1,0,-5,-10,-4,-4,8,1,0,1,0,1,1,-1,0,-1
KR_6755748869,420,-4,-87,-4,-4,-11,12,1,5,2,7,2,2,4,0,2,2,0,1,1,-1,8,-112,-4,-2,6,-1,0,-1,1,-1,-1,-1,4,-1
KR_6736182101,420,3,64,26,8,2,0,2,5,0,5,-1,4,3,1,0,1,1,2,3,1,10,9,-2,-5,7,5,0,0,1,-1,1,1,3,-1
KR_6768847959,420,-2,16,1,-1,1,0,1,-3,5,2,2,8,10,2,2,4,-3,4,1,1,2,44,5,-8,3,-22,0,-1,1,-1,-1,1,1,-1
KR_6767115035,440,0,17,-8,1,0,1,1,0,1,1,1,2,3,1,4,5,-1,1,0,0,3,9,0,-6,6,-6,0,-1,-1,1,-1,-1,2,-1
KR_6716780182,420,-1,-99,28,-2,-2,3,1,4,2,6,0,0,0,-3,8,5,-1,1,0,0,-7,-12,-3,-4,7,2,0,-1,1,1,-1,1,3,-1
KR_6607294198,420,-5,-47,-32,-13,-4,5,1,-2,3,1,-6,6,0,2,2,4,-3,3,0,-1,-10,-13,-1,-7,8,-3,0,-1,-1,-1,-1,-1,3,-1
KR_6765391453,420,0,1,-11,-3,1,1,2,3,1,4,-3,6,3,1,7,8,-5,5,0,0,-8,-2,-1,-6,7,0,0,-1,-1,1,-1,-1,6,-1
KR_6701130427,420,-3,-18,-16,-6,-4,4,0,-1,5,4,2,1,3,-2,6,4,-1,1,0,0,-4,5,2,-6,4,-6,0,-1,-1,-1,-1,-1,6,-1
KR_6693175034,420,-3,-37,-11,-6,-2,4,2,1,2,3,-3,4,1,-2,3,1,0,1,1,0,-7,-1,0,-6,6,2,0,-1,1,-1,-1,-1,1,-1
KR_6735803474,420,-2,-41,39,-9,-2,2,0,1,3,4,-2,2,0,-6,6,0,0,0,0,0,-6,160,-4,-4,8,4,0,0,1,-1,0,-1,4,-1
KR_6768395537,420,-4,-60,-8,-22,-4,4,0,-3,5,2,-4,4,0,-9,10,1,-2,3,1,0,-24,8,0,-6,6,-3,0,-2,-1,-1,-1,-1,5,-1
KR_6701175057,440,0,-16,14,-2,0,2,2,-1,2,1,0,2,2,-2,3,1,1,5,6,0,2,6,-6,-4,10,-4,0,0,1,-1,0,1,5,-1
KR_6756133321,420,2,-50,4,7,1,0,1,1,5,6,0,4,4,1,3,4,4,0,4,0,8,7,-1,-4,5,1,0,0,-1,1,0,-1,6,-1
KR_6768877269,420,2,6,-43,6,2,1,3,-1,3,2,4,1,5,1,1,2,0,2,2,0,16,-170,-3,-4,7,16,0,-1,-1,-1,-1,1,5,-1
KR_6738668754,420,-2,-49,6,-6,-5,5,0,2,2,4,2,2,4,-1,2,1,-4,4,0,0,0,47,-3,-3,6,2,0,-1,-1,0,-1,-1,1,-1
KR_6766030049,420,-1,8,3,-3,0,4,4,-2,2,0,2,2,4,-1,2,1,-2,3,1,0,-2,-9,4,-6,2,-1,0,1,-1,1,1,-1,6,-1
KR_6764388336,420,-2,-14,13,-6,2,2,4,-2,6,4,-3,4,1,-2,5,3,-1,2,1,0,-10,7,3,-6,3,-1,0,0,-1,1,-1,1,5,-1
KR_6733302644,420,-2,-62,-28,1,-3,4,1,-2,6,4,2,1,3,3,1,4,1,2,3,2,4,-4,-1,-6,7,0,0,0,1,1,0,1,3,-1
KR_6755738866,420,-5,-56,-6,-13,-3,4,1,-5,5,0,-3,4,1,-2,2,0,0,0,0,0,-9,21,-1,-4,5,0,0,-2,-1,-1,-1,-1,6,-1
KR_6759912352,420,-2,9,19,-6,4,0,4,2,2,4,-3,3,0,-8,10,2,-1,1,0,0,-8,-59,1,-7,6,-2,0,1,-1,-1,1,1,1,-1
KR_6758157566,440,-4,-73,-8,-12,-7,9,2,-1,2,1,-1,4,3,-3,3,0,0,0,0,0,-3,-5,-3,-3,6,-4,0,-1,-1,-1,-1,-1,3,-1
KR_6686565323,420,-4,-52,4,-6,-4,6,2,1,3,4,-3,3,0,1,7,8,-1,2,1,0,-1,12,-2,-6,8,-2,0,-1,1,-1,-1,1,2,-1
KR_6688837722,420,-1,29,-1,-5,-7,8,1,0,3,3,-2,2,0,5,2,7,-1,2,1,0,1,7,3,-7,4,0,0,0,-1,-1,-1,-1,4,-1
KR_6713323307,420,-3,-17,-44,4,0,2,2,1,2,3,1,4,5,1,3,4,1,0,1,2,10,7,3,-6,3,-4,0,-2,-1,-1,-1,1,4,-1
KR_6766948571,420,-5,-26,-62,4,-2,2,0,-1,1,0,-2,2,0,8,1,9,1,0,1,0,5,-10,-5,-3,8,-1,0,-1,-1,-1,-1,1,2,-1
KR_6764507689,420,0,40,-25,-6,-1,2,1,-3,5,2,-1,2,1,-2,3,1,1,0,1,0,-8,-22,-3,-4,7,0,0,1,0,1,1,-1,0,-1
KR_6739315137,420,0,21,12,-4,-3,4,1,2,0,2,1,3,4,-4,6,2,0,1,1,0,-12,5,1,-7,6,1,0,1,-1,1,1,1,3,-1
KR_6563186854,420,2,62,-3,-7,2,3,5,-3,7,4,-4,5,1,-4,8,4,2,0,2,-1,-15,-8,-4,-7,11,6,0,-1,-1,-1,-1,-1,2,-1
KR_6760697446,420,3,112,29,3,3,0,3,0,1,1,0,1,1,0,1,1,0,1,1,0,-3,8,3,-4,1,2,0,2,1,1,1,1,1,-1
KR_6643149418,420,-8,-41,-21,-16,-5,6,1,0,1,1,-1,6,5,-8,9,1,-2,3,1,0,-16,8,-4,-3,7,-1,0,-1,-1,-1,-1,-1,5,-1
KR_6756105455,420,-1,-53,10,-6,-1,3,2,-5,5,0,2,3,5,1,2,3,-3,3,0,-1,-5,-13,-3,-4,7,3,0,-1,1,-1,-1,-1,2,-1
KR_6704403663,420,2,73,17,3,5,0,5,2,3,5,-3,6,3,1,2,3,-2,5,3,0,0,48,3,-8,5,-6,0,1,-1,1,1,1,6,-1
KR_6701863474,420,-5,-26,-3,-10,-2,2,0,-4,5,1,-4,5,1,0,2,2,0,0,0,1,-10,2,6,-9,3,0,0,0,1,-1,0,1,1,-1
KR_6675601430,440,-2,3,-10,-3,0,2,2,7,1,8,-2,3,1,-6,9,3,-2,3,1,0,2,-60,0,-3,3,1,0,-1,-1,0,-1,-1,1,-1
KR_6768431253,420,-4,-18,-12,-14,-4,5,1,-6,10,4,-4,5,1,3,2,5,-3,3,0,-4,-8,-37,-3,-3,6,0,0,-1,0,-1,-1,-1,0,-1
KR_6757827561,420,-6,-30,-18,-15,-6,7,1,-1,2,1,-2,4,2,-1,6,5,-5,5,0,0,0,-10,-1,-8,9,4,0,-1,-1,1,-1,-1,4,-1
KR_6764680602,420,-2,-50,-22,-7,1,0,1,0,6,6,-3,3,0,-6,8,2,1,0,1,0,-1,20,-2,-8,10,6,0,0,-1,-1,-1,-1,3,-1
KR_6676827734,420,-3,-45,-9,-14,-3,3,0,-7,9,2,-1,2,1,-6,7,1,3,1,4,0,-15,3,2,-11,9,-4,0,0,-1,-1,-1,-1,6,-1
KR_6766420770,420,-6,-6,3,-18,-4,5,1,-1,5,4,-4,4,0,-7,8,1,-2,2,0,-1,-22,-78,-7,-2,9,3,0,0,-1,-1,1,-1,2,-1
KR_6740026361,420,0,22,-17,-1,2,0,2,2,3,5,0,1,1,3,5,8,-8,9,1,0,-2,-120,0,-5,5,-2,0,0,-1,1,1,-1,2,-1
KR_6756513002,420,-4,-102,-20,-9,-5,5,0,-1,4,3,1,2,3,-5,10,5,1,1,2,0,7,6,2,-6,4,1,-1,-4,-1,-1,-1,-1,1,-1
KR_6637774646,420,-1,-50,-10,3,1,2,3,5,2,7,-3,5,2,-2,4,2,2,1,3,0,1,2,0,-7,7,-4,0,0,-1,-1,0,-1,1,-1
KR_6726782055,420,-9,-171,-53,-17,-5,6,1,-3,5,2,-4,4,0,-5,6,1,0,0,0,-1,-14,-4,-7,-2,9,-4,0,-4,-1,-1,-1,-1,4,-1
KR_6765828464,420,-1,-53,-24,-2,-1,1,0,-2,2,0,-2,3,1,2,1,3,1,1,2,0,-1,5,0,-7,7,-1,0,-1,1,-1,-1,1,1,-1
KR_6291761539,420,0,17,26,0,-5,6,1,2,3,5,4,1,5,-1,2,1,0,2,2,0,6,23,1,-7,6,-1,0,1,0,1,1,1,0,-1
KR_6740390213,440,0,-75,21,2,-3,3,0,2,3,5,-2,2,0,4,0,4,1,1,2,-2,-1,2,-4,-2,6,-3,0,0,1,0,0,-1,1,-1
KR_6738633233,420,-2,35,-32,-11,0,3,3,-3,3,0,-4,5,1,-3,6,3,-1,2,1,0,-8,2,-1,-6,7,2,0,-2,0,-1,-1,-1,0,-1
KR_6768876218,420,-3,-70,-19,-4,0,2,2,0,6,6,-4,6,2,1,0,1,-1,3,2,0,-5,14,-3,-6,9,22,0,-1,0,-1,-1,-1,0,-1
KR_6768402808,420,0,19,-37,0,-2,6,4,-2,2,0,-1,3,2,3,2,5,2,0,2,0,-5,-1,-2,-2,4,2,0,-1,-1,-1,-1,-1,5,-1
KR_6745976110,440,-5,-121,-9,-20,-2,2,0,-2,2,0,-7,7,0,-8,9,1,-1,1,0,0,-33,-24,-2,-7,9,-5,0,-2,-1,-1,-1,-1,1,-1
KR_6762531971,420,2,52,3,3,-1,2,1,4,1,5,2,3,5,-2,3,1,0,0,0,0,1,7,10,-16,6,1,0,1,1,1,1,-1,4,-1
KR_6747715914,420,-4,-18,-21,-2,0,2,2,-2,8,6,-3,4,1,1,3,4,2,1,3,1,-5,0,-4,-6,10,0,0,-1,1,1,1,1,1,-1
KR_6691671307,420,-1,-31,15,-3,-3,6,3,-3,5,2,-2,4,2,2,3,5,3,0,3,0,-6,-3,-2,-4,6,3,0,-2,1,-1,-1,1,1,-1
KR_6738879434,440,2,-40,19,5,0,2,2,4,1,5,-2,3,1,1,5,6,2,0,2,-1,5,20,6,-8,2,-5,0,1,1,0,1,-1,1,-1
KR_6701246927,420,-2,-65,14,-2,-3,3,0,-1,3,2,0,2,2,1,0,1,1,0,1,0,2,4,2,-5,3,-2,0,0,-1,1,-1,1,3,-1
KR_6755572317,440,0,-30,-8,-2,-1,5,4,-2,4,2,-2,5,3,-1,1,0,4,2,6,0,9,0,-3,-2,5,0,0,0,1,1,1,-1,5,-1
KR_6767843250,420,0,37,-8,-1,-1,3,2,-1,3,2,0,3,3,1,1,2,0,0,0,1,-1,0,-2,-4,6,-2,0,2,0,1,1,1,0,-1
KR_6723244409,420,2,9,33,-2,1,0,1,2,1,3,-1,3,2,-6,8,2,2,1,3,-1,-7,10,2,-7,5,1,0,0,-1,-1,0,-1,5,-1
KR_6768661948,420,0,-18,37,-7,-3,3,0,2,1,3,0,2,2,-6,10,4,0,2,2,-1,-22,-2,2,-7,5,-7,0,1,-1,1,1,-1,6,-1
KR_6713307366,420,-6,-115,5,-14,0,4,4,-5,6,1,-3,3,0,-4,4,0,-2,2,0,0,-23,-5,-3,-3,6,0,0,-2,-1,-1,-1,-1,1,-1
KR_6768763362,440,-1,-5,0,-10,-5,6,1,-5,6,1,1,5,6,-2,2,0,1,1,2,0,-4,-5,0,-5,5,0,0,-3,-1,1,-1,-1,2,-1
KR_6688051917,420,0,1,8,-1,0,1,1,2,1,3,-6,6,0,-3,7,4,6,0,6,0,-3,8,-6,-7,13,3,0,0,1,-1,0,-1,3,-1
KR_6754090339,420,-2,25,-14,7,0,1,1,2,2,4,3,2,5,-2,5,3,4,2,6,1,10,-71,3,-6,3,-1,0,0,1,-1,0,1,2,-1
KR_6768686272,420,0,-28,-16,0,-1,2,1,0,4,4,-1,4,3,0,1,1,2,0,2,0,6,-4,-2,-3,5,3,0,1,0,-1,1,1,0,-1
KR_6750041129,420,-4,-51,-4,-6,-2,2,0,-1,1,0,0,2,2,-2,2,0,-1,1,0,0,-7,8,-4,-3,7,1,0,-1,1,-1,-1,1,1,-1
KR_6764228533,420,-6,-82,-11,-10,-4,5,1,-5,7,2,2,2,4,-3,3,0,0,1,1,0,-4,8,0,-5,5,0,0,-3,-1,-1,-1,-1,5,-1
KR_6761986512,420,-1,-1,-23,-5,-4,5,1,-5,7,2,1,1,2,2,4,6,1,0,1,0,1,1,1,-5,4,-4,0,0,0,1,-1,1,0,-1
KR_6691373601,420,-6,9,-51,-19,-2,2,0,-8,8,0,-8,8,0,1,1,2,-2,2,0,-2,-29,-1,-1,-3,4,-4,0,0,-1,1,1,-1,3,-1
KR_6768579144,440,-2,-76,4,-2,-3,5,2,-1,7,6,2,0,2,0,1,1,0,0,0,0,6,-9,-2,-7,9,7,0,-1,1,1,-1,1,6,-1
KR_6764142089,440,-3,-24,3,-3,-2,2,0,-3,5,2,-1,4,3,3,0,3,0,3,3,0,-3,-17,0,-3,3,3,0,1,1,1,1,1,3,-1
KR_6757597634,420,1,57,19,0,2,1,3,-2,5,3,-2,3,1,1,2,3,1,0,1,0,-8,-8,-6,-4,10,4,0,0,-1,-1,0,1,1,-1
KR_6769160050,420,-2,-56,4,-4,-3,3,0,0,2,2,-2,3,1,0,5,5,1,0,1,0,-4,6,-2,-5,7,-2,0,0,1,0,-1,-1,6,-1
KR_6751032102,440,-5,-69,-3,-9,0,5,5,-2,3,1,3,1,4,3,6,9,-13,13,0,-2,-13,-201,-3,-2,5,0,0,1,1,0,-1,-1,3,-1
KR_6740115430,420,-3,-54,12,-4,-1,2,1,1,1,2,-4,5,1,0,1,1,0,0,0,0,-2,42,-1,-7,8,0,0,-1,-1,-1,-1,-1,5,-1
KR_6761313776,440,1,-6,22,-1,-5,7,2,-2,2,0,0,2,2,1,2,3,5,0,5,1,4,3,0,-6,6,2,0,0,-1,-1,0,1,5,-1
KR_6506786601,420,-1,-67,17,5,-1,2,1,1,2,3,1,3,4,3,2,5,1,1,2,1,10,-3,-1,-5,6,4,0,0,-1,1,1,1,4,-1
KR_6765955698,440,-2,35,-48,-8,0,2,2,-2,4,2,-3,5,2,-3,6,3,0,1,1,0,-4,-7,-3,-8,11,6,0,0,0,-1,0,-1,0,-1
KR_6741655914,420,-1,-64,27,-6,1,1,2,0,5,5,-1,2,1,-6,6,0,0,1,1,0,-7,12,1,-7,6,-1,0,-1,-1,1,-1,-1,2,-1
KR_6680141836,420,-2,-53,-3,-10,-2,2,0,0,3,3,-3,5,2,-4,7,3,-1,1,0,0,-9,142,-3,-5,8,4,0,-2,-1,1,-1,-1,6,-1
KR_6744694688,420,-2,2,5,-2,0,0,0,0,2,2,0,2,2,-3,3,0,1,0,1,0,3,-123,0,-6,6,2,0,0,1,0,0,-1,3,-1
KR_6766420308,420,0,12,1,-3,2,1,3,1,5,6,0,2,2,-6,10,4,0,0,0,-3,-18,117,0,-5,5,-4,0,0,-1,1,1,-1,4,-1
KR_6753249766,440,1,29,11,3,3,2,5,-1,1,0,2,0,2,-1,2,1,0,3,3,0,1,-4,-2,-4,6,3,0,0,-1,1,1,-1,6,-1
KR_6735406246,420,-5,-106,-35,-8,0,1,1,1,3,4,-8,9,1,-1,2,1,0,1,1,0,-9,3,-2,-5,7,-3,0,0,-1,-1,0,-1,6,-1
KR_6760938246,420,2,-20,-9,5,-1,3,2,2,0,2,3,0,3,1,1,2,0,0,0,0,8,-7,-5,0,5,1,0,0,-1,1,1,-1,5,-1
KR_6508338971,420,-2,-52,-19,-2,-1,2,1,-1,3,2,-2,5,3,2,2,4,0,0,0,0,-2,-68,-2,-4,6,26,0,0,0,-1,-1,-1,0,-1
KR_6747795107,420,3,26,-1,-1,0,1,1,3,3,6,-2,5,3,0,1,1,-2,2,0,0,0,45,-2,-3,5,-23,0,0,-1,-1,0,-1,5,-1
KR_6753637754,420,2,15,4,-1,1,0,1,-3,5,2,2,3,5,-1,8,7,0,0,0,0,-10,-10,-7,-1,8,4,0,-1,-1,-1,-1,-1,1,-1
KR_6760830229,420,-1,-64,-12,-6,-4,7,3,1,1,2,-2,4,2,-2,4,2,1,0,1,0,-10,2,3,-7,4,5,0,0,-1,1,-1,-1,4,-1
KR_6768957537,420,-6,-109,-21,-8,4,1,5,-1,2,1,-4,4,0,-7,7,0,0,1,1,-1,-9,10,3,-5,2,-3,0,1,-1,1,1,-1,3,-1
KR_6759615901,420,-8,-82,-31,-14,-7,8,1,-1,1,0,-2,2,0,-3,4,1,-1,1,0,0,-9,0,-2,-3,5,-6,0,0,-1,-1,-1,-1,5,-1
KR_6768871612,420,-6,-28,-13,-11,-2,3,1,-3,5,2,-2,4,2,-3,5,2,-1,2,1,0,-12,-123,7,-9,2,1,0,-1,-1,-1,-1,-1,3,-1
KR_6767310139,420,1,-62,-4,5,2,0,2,1,2,3,2,0,2,1,1,2,-1,2,1,0,4,116,-3,-2,5,0,0,-1,1,-1,-1,-1,2,-1
KR_6767295246,420,1,63,27,-1,3,0,3,-1,2,1,1,0,1,-4,7,3,0,0,0,0,-7,-4,0,-6,6,2,0,0,1,-1,0,1,2,-1
KR_6762700593,420,-1,-1,-8,0,5,0,5,-2,4,2,-2,3,1,-1,3,2,0,0,0,0,-10,-9,-5,-3,8,4,0,0,-1,1,-1,1,6,-1
KR_6758911862,420,-2,-102,-14,-4,1,1,2,-2,4,2,-1,2,1,-1,1,0,-1,1,0,0,-12,-12,-1,-9,10,6,0,0,1,1,0,-1,6,-1
KR_6730131420,420,-2,12,-22,-4,-3,5,2,0,2,2,-1,1,0,2,2,4,-2,2,0,-2,-8,-39,0,-9,9,1,0,1,-1,-1,1,-1,2,-1
KR_6767366473,440,-6,-66,-10,-7,-5,6,1,1,2,3,1,3,4,-5,6,1,1,1,2,1,0,-1,1,-4,3,1,0,-2,1,-1,-1,1,2,-1
KR_6713335777,420,2,52,-15,-2,1,0,1,-4,5,1,-1,5,4,2,2,4,0,1,1,0,-2,1,1,-6,5,-6,0,0,-1,1,1,1,6,-1
KR_6755809584,420,1,14,-19,1,1,1,2,-2,3,1,0,2,2,-2,2,0,4,0,4,0,3,24,-1,-8,9,-1,0,0,1,-1,0,1,1,-1
KR_6768759988,420,-1,-19,4,-4,-1,1,0,-2,5,3,1,2,3,-2,5,3,0,1,1,0,-2,120,1,-7,6,2,0,0,-1,1,0,-1,1,-1
KR_6756388704,420,-6,-28,-34,-10,-5,5,0,0,3,3,-7,7,0,2,1,3,0,1,1,0,0,-14,-4,-2,6,3,0,-1,-1,-1,-1,1,5,-1
KR_6602450638,420,-1,-26,13,-10,0,0,0,5,1,6,-4,4,0,-8,9,1,-3,3,0,-2,-14,-6,-6,-4,10,-1,0,-2,-1,-1,-1,-1,1,-1
KR_6763983775,420,-3,-19,1,-6,3,3,6,-3,3,0,-2,5,3,-5,5,0,1,0,1,0,-5,15,0,-7,7,-5,0,0,-1,1,0,1,5,-1
KR_6725004472,420,-2,-8,-19,3,-3,5,2,-1,5,4,4,1,5,3,1,4,0,0,0,0,5,-17,1,-7,6,-1,0,-1,-1,-1,-1,-1,1,-1
KR_6735122213,420,-8,-83,-2,-16,-2,2,0,-3,6,3,0,1,1,-8,9,1,-3,3,0,0,-15,17,-3,-4,7,6,0,-2,-1,1,-1,-1,6,-1
KR_6762021789,420,-3,-27,-10,-9,-2,5,3,-4,6,2,3,5,8,-2,2,0,-4,4,0,0,-19,7,-1,-6,7,1,0,-2,1,-1,-1,-1,5,-1
KR_6767678098,420,0,-34,-8,-4,2,0,2,6,0,6,-8,9,1,-3,6,3,-1,8,7,2,-3,11,5,-7,2,-2,0,-1,1,-1,-1,1,6,-1
KR_6737253280,440,-4,-37,0,-16,-2,2,0,-4,4,0,-1,2,1,-8,11,3,-1,2,1,-1,-14,40,-1,-4,5,2,0,-1,-1,-1,-1,-1,2,-1
KR_6726749801,440,-1,-14,16,-2,3,0,3,0,2,2,-3,7,4,-1,1,0,-1,3,2,-1,-7,-154,0,-3,3,0,0,0,-1,0,0,-1,1,-1
KR_6722705902,420,-5,-112,-27,-11,-2,3,1,-3,4,1,0,1,1,-4,5,1,-2,3,1,-1,-8,5,-4,-4,8,0,0,-2,-1,-1,-1,-1,6,-1
KR_6767086252,420,-5,-71,-5,-13,-2,2,0,3,1,4,-2,7,5,-11,11,0,-1,1,0,1,-8,-3,1,-8,7,-10,0,-2,-1,-1,-1,1,1,-1
KR_6765898429,440,0,-18,12,8,2,1,3,2,0,2,2,2,4,0,2,2,2,2,4,0,4,-25,-2,-3,5,-5,0,0,1,1,0,1,6,-1
KR_6660509100,420,4,11,24,13,2,0,2,6,3,9,4,1,5,1,2,3,0,1,1,1,14,36,-6,-6,12,-4,0,0,1,-1,0,1,3,-1
KR_6731234401,420,0,5,-2,-1,-2,3,1,0,2,2,-1,1,0,4,0,4,-2,2,0,-1,5,49,3,-5,2,0,0,-2,1,-1,-1,-1,3,-1
KR_6751206900,420,0,27,-9,5,-3,4,1,3,0,3,-1,4,3,3,1,4,3,0,3,0,6,7,1,-4,3,1,0,-1,1,-1,-1,1,4,-1
KR_6740563869,440,0,-35,-5,0,-1,2,1,3,2,5,1,1,2,-3,5,2,0,0,0,0,-1,4,3,-8,5,-5,0,0,-1,1,-1,1,5,-1
KR_6767662486,420,-1,-5,-7,-5,-2,3,1,-1,1,0,2,2,4,-2,4,2,-2,6,4,0,-4,-23,-1,-6,7,8,0,-1,-1,1,-1,-1,4,-1
KR_6723250650,420,-3,-21,-8,-6,-3,3,0,-2,4,2,0,1,1,2,1,3,-3,6,3,0,-14,0,1,-8,7,-6,0,-1,1,-1,-1,1,4,-1
KR_6768866882,420,1,-26,7,7,0,2,2,1,2,3,-1,1,0,6,1,7,1,0,1,0,9,102,-1,-7,8,0,0,0,1,0,1,1,2,-1
KR_6747394018,420,-4,-29,-39,-5,-1,1,0,3,2,5,-1,2,1,-2,4,2,-4,5,1,0,-5,19,0,-8,8,4,0,0,-1,-1,0,1,6,-1
KR_6728451053,420,0,-22,-19,6,0,1,1,-2,5,3,3,2,5,4,0,4,1,0,1,1,6,-38,-3,-6,9,-2,0,0,1,-1,1,1,6,-1
KR_6760853136,420,-3,13,4,-12,-5,5,0,-3,6,3,-4,4,0,1,1,2,-1,1,0,0,-13,2,1,-7,6,-4,0,-1,-1,-1,-1,-1,1,-1
KR_6764718599,440,-4,19,18,-4,1,1,2,1,2,3,-2,2,0,-3,8,5,-1,3,2,0,-2,-3,1,-6,5,-2,0,0,-1,1,0,-1,5,-1
KR_6739587128,440,2,21,-6,1,-2,6,4,0,3,3,-1,2,1,0,2,2,4,1,5,0,-3,398,3,-6,3,-1,0,1,1,0,1,-1,5,-1
KR_6764075098,420,-3,-16,-16,-5,-7,7,0,1,0,1,1,2,3,0,1,1,0,0,0,0,-6,-10,2,-5,3,3,0,0,-1,0,-1,-1,2,-1
KR_6761980668,420,0,56,-11,-5,1,1,2,0,0,0,-2,3,1,-1,5,4,-3,4,1,0,-16,-1,-2,-3,5,-2,0,-1,-1,-1,1,-1,6,-1
KR_6759126923,420,0,-24,16,-9,-4,6,2,-2,2,0,2,2,4,-3,6,3,-2,4,2,0,-4,1,-12,-4,16,0,0,0,1,-1,-1,-1,5,-1
KR_6692107334,420,-2,-33,13,-6,-2,3,1,1,2,3,-2,4,2,-2,5,3,-1,1,0,0,-8,6,-5,-5,10,2,0,0,-1,-1,-1,1,2,-1
KR_6758445358,420,-2,-33,-32,-2,4,0,4,6,3,9,-6,6,0,-4,8,4,-2,2,0,0,10,-9,-5,-2,7,1,0,0,-1,-1,-1,1,2,-1
KR_6764709923,420,-4,-45,-4,-8,-6,6,0,0,3,3,-2,2,0,-3,4,1,3,1,4,0,-5,0,-1,-6,7,4,0,0,1,-1,-1,-1,3,-1
KR_6760992805,420,-6,-64,-9,-11,0,1,1,-1,4,3,-9,11,2,-1,4,3,0,0,0,0,-8,-2,4,-7,3,-8,0,-2,1,1,-1,-1,1,-1
KR_6754512731,420,-1,-2,-22,-4,-2,2,0,-7,9,2,0,1,1,6,4,10,-1,2,1,-1,-4,-9,-1,-6,7,4,0,0,-1,-1,-1,-1,3,-1
KR_6764817444,420,-3,12,-36,-8,-3,3,0,0,2,2,-4,5,1,0,2,2,-1,1,0,0,-10,-7,-5,-2,7,4,0,0,-1,1,0,-1,2,-1
KR_6742255734,420,-3,-84,0,1,-1,1,0,4,1,5,-4,4,0,3,0,3,-1,1,0,0,13,8,0,-8,8,-7,0,-2,1,-1,-1,1,3,-1
KR_6762975731,420,-2,-3,-8,0,1,1,2,-1,2,1,0,1,1,0,3,3,0,1,1,0,-8,-18,-9,-3,12,7,0,0,-1,-1,0,1,2,-1
KR_6765440005,420,-1,-39,11,-4,2,0,2,0,3,3,-2,2,0,-4,7,3,0,1,1,0,3,-4,-1,-5,6,-2,0,-1,-1,1,-1,-1,2,-1
KR_6765128494,420,-4,-32,22,-3,2,1,3,-6,10,4,2,0,2,0,5,5,-1,2,1,1,2,1,-1,-3,4,-2,0,-1,1,1,-1,1,3,-1
KR_6674485364,420,1,-30,-20,-4,-2,2,0,2,3,5,1,0,1,-4,6,2,-1,1,0,0,-3,14,-4,-4,8,2,0,0,-1,-1,0,-1,3,-1
KR_6674682638,420,-5,-26,-25,-12,-9,9,0,0,1,1,-2,3,1,-2,3,1,1,0,1,-1,-12,-6,-2,-4,6,1,0,-1,-1,-1,-1,-1,6,-1
KR_6613794473,420,-6,-38,-25,-13,-6,6,0,-4,5,1,1,2,3,-3,4,1,-1,1,0,0,-7,-3,-1,-7,8,4,0,-2,-1,-1,-1,-1,4,-1
KR_6768971402,420,2,-52,-33,6,2,1,3,0,6,6,3,0,3,2,1,3,-1,2,1,0,10,12,2,-6,4,-4,0,0,0,-1,0,-1,0,-1
KR_6645359636,420,-1,17,-13,2,5,0,5,4,0,4,0,3,3,-5,8,3,-2,2,0,0,0,-156,1,-7,6,-1,0,1,-1,-1,1,1,1,-1
KR_6610728792,420,-4,-49,-28,-8,-5,6,1,0,4,4,-5,7,2,1,3,4,1,1,2,-1,0,17,2,-8,6,2,0,-2,-1,-1,-1,-1,4,-1
KR_6616772775,420,-2,15,-7,-5,-2,4,2,-1,1,0,2,1,3,-3,4,1,-1,1,0,0,-6,-4,3,-7,4,-1,0,0,-1,-1,0,-1,2,-1
KR_6762478192,420,-4,-79,3,-4,-2,2,0,-3,5,2,0,1,1,2,2,4,-1,1,0,0,-7,-19,-4,-4,8,0,0,-1,1,-1,-1,-1,5,-1
KR_6692918624,440,-5,-89,-7,-16,0,2,2,-6,8,2,-2,2,0,-8,9,1,0,0,0,0,-20,19,0,-6,6,0,0,0,-1,1,0,-1,5,-1
KR_6764756861,420,1,16,-8,-1,-1,2,1,2,1,3,0,2,2,-1,4,3,-1,2,1,-1,-3,-1,1,-6,5,-2,0,0,-1,1,0,-1,4,-1
KR_6745045850,420,-1,14,45,-7,-1,4,3,-1,2,1,-4,4,0,-1,1,0,0,0,0,0,-9,-2,-2,-5,7,-7,0,-1,1,1,-1,-1,3,-1
KR_6720348474,420,-2,-61,-27,5,2,1,3,0,2,2,0,0,0,2,0,2,1,0,1,0,6,50,1,-8,7,20,0,-3,1,1,-1,1,4,-1
KR_6752992844,440,-3,13,-11,-4,0,3,3,-1,5,4,-1,2,1,1,1,2,-3,4,1,0,-12,-2,2,-6,4,-2,0,0,-1,-1,-1,-1,2,-1
KR_6761285581,420,-3,-26,-19,-8,-3,3,0,2,3,5,-3,3,0,-3,3,0,-1,2,1,-1,-15,1,0,-6,6,-3,0,0,-1,-1,0,-1,3,-1
KR_6749780941,420,-2,-45,-4,-3,-3,3,0,0,2,2,-2,4,2,3,0,3,-1,1,0,0,5,-6,0,-5,5,1,0,1,1,1,-1,-1,2,-1
KR_6761616802,420,-3,-44,38,-6,1,1,2,-1,2,1,-1,4,3,-6,8,2,1,0,1,0,-9,1,0,-5,5,-2,0,-2,-1,1,-1,-1,6,-1
KR_6754919330,420,-3,-31,15,-9,-1,2,1,-5,7,2,2,1,3,-4,4,0,-1,2,1,-1,-4,-1,1,-5,4,-2,0,-1,-1,-1,-1,-1,5,-1
KR_6755194147,420,1,-3,-16,1,-1,1,0,0,4,4,1,2,3,0,1,1,1,4,5,0,-3,1,-3,-2,5,0,0,-1,1,-1,-1,-1,2,-1
KR_6678081954,420,-2,-44,5,-1,-3,4,1,3,2,5,-2,6,4,0,2,2,1,0,1,0,6,-37,1,-5,4,1,0,-2,-1,-1,-1,-1,1,-1
KR_6761900353,420,-2,-16,-13,-6,1,0,1,-3,6,3,-2,4,2,0,2,2,-2,3,1,0,-7,27,-1,-4,5,-2,0,0,1,-1,1,1,3,-1
KR_6763732500,420,0,-25,12,-6,3,1,4,-5,7,2,-4,5,1,1,1,2,-1,1,0,0,-1,-229,-1,-4,5,-1,0,-1,-1,-1,-1,-1,6,-1
KR_6654968846,420,-4,-25,-10,-18,0,1,1,-9,9,0,1,3,4,-9,10,1,-1,2,1,0,-22,7,3,-10,7,1,0,-2,-1,-1,-1,-1,3,-1
KR_6699649377,420,-2,-30,-12,-2,-6,7,1,-2,7,5,4,1,5,1,3,4,1,0,1,0,1,10,0,-8,8,-5,0,-2,1,-1,-1,-1,4,-1
KR_6760934391,420,-2,39,8,-5,-2,3,1,1,2,3,-3,3,0,-2,4,2,1,2,3,0,-5,6,10,-11,1,-4,0,0,-1,1,-1,1,5,-1
KR_6692123466,440,-2,-47,4,-8,-8,9,1,-1,4,3,0,2,2,-1,5,4,2,1,3,0,-9,1,-1,-5,6,-3,0,0,-1,-1,-1,-1,6,-1
KR_6706649394,420,-2,-62,5,-5,0,1,1,-3,5,2,1,1,2,-4,4,0,1,0,1,-1,-10,-17,-1,-5,6,-2,0,-1,-1,-1,-1,-1,4,-1
KR_6699562009,420,1,-25,5,-7,1,0,1,3,2,5,-5,7,2,-4,5,1,-2,2,0,1,-4,267,-3,-5,8,2,0,-2,1,-1,-1,1,4,-1
KR_6500398673,420,-3,-53,19,-6,-4,5,1,0,2,2,0,2,2,0,1,1,-2,2,0,0,-7,-17,-5,-3,8,0,0,-1,1,-1,-1,-1,6,-1
KR_6766111236,420,0,-15,13,-2,3,1,4,-1,1,0,-3,4,1,-1,3,2,0,0,0,0,-4,-2,-3,-5,8,-3,0,2,0,1,1,-1,0,-1
KR_6710735541,420,0,-43,3,-2,-1,4,3,4,1,5,0,3,3,-2,2,0,-3,3,0,0,8,-4,2,-6,4,-2,0,-1,-1,1,-1,-1,5,-1
KR_6763026096,420,-2,35,-16,-6,3,0,3,-5,7,2,-3,3,0,0,4,4,-1,2,1,0,-9,-7,0,-6,6,2,0,0,-1,-1,1,1,3,-1
KR_6760877005,440,-1,9,-9,-5,2,2,4,0,0,0,1,5,6,-6,6,0,-2,2,0,-1,-6,0,-3,-1,4,1,0,1,-1,0,1,-1,5,-1
KR_6768105795,420,-2,1,-11,-3,-3,3,0,-1,2,1,2,0,2,-1,1,0,0,0,0,0,-3,6,1,-6,5,-1,0,0,-1,1,0,-1,5,-1
KR_6729147919,420,2,-32,16,1,0,1,1,0,2,2,2,0,2,-3,3,0,2,0,2,0,6,-48,-1,-5,6,22,0,0,1,-1,0,1,2,-1
KR_6761590002,420,1,6,-11,-5,-4,5,1,-3,4,1,2,2,4,-1,2,1,1,0,1,0,-5,2,1,-6,5,2,0,-1,-1,-1,-1,-1,3,-1
KR_6749288813,420,-5,-56,-16,-10,2,1,3,0,2,2,-8,8,0,-2,3,1,-2,2,0,-1,-11,-6,-2,-3,5,1,0,-1,-1,-1,-1,-1,6,-1
KR_6760114932,420,-1,-31,-31,6,5,0,5,-3,4,1,-1,2,1,4,2,6,1,0,1,0,0,-48,0,-6,6,-1,0,1,-1,1,1,1,3,-1
KR_6763395285,440,5,33,41,2,-3,5,2,-2,3,1,3,2,5,3,1,4,1,1,2,0,5,-1,7,-9,2,2,0,-1,1,-1,-1,-1,2,-1
KR_6763181854,420,0,-16,-14,1,2,0,2,0,3,3,2,2,4,-4,4,0,1,0,1,0,-1,22,-5,-3,8,-4,0,0,-1,1,0,1,2,-1
KR_6761342540,420,0,18,-44,2,3,3,6,3,1,4,-7,8,1,1,0,1,2,1,3,0,9,-62,-2,-5,7,20,0,0,-1,-1,-1,-1,5,-1
KR_6742434039,420,-3,12,-10,-6,-1,3,2,0,1,1,1,3,4,-5,5,0,-1,1,0,0,-12,-11,-2,-7,9,-4,0,-1,-1,-1,-1,-1,4,-1
KR_6760007341,420,0,24,-6,-6,0,1,1,-3,4,1,0,3,3,-2,4,2,-1,2,1,-1,-12,0,-1,-4,5,-2,0,0,-1,-1,0,-1,3,-1
KR_6750718692,420,1,15,7,0,-2,3,1,4,1,5,-1,5,4,-1,2,1,0,0,0,0,-7,-38,1,-7,6,11,0,-1,-1,-1,-1,1,2,-1
KR_6547273090,420,-4,11,-13,-8,5,1,6,-4,4,0,-1,3,2,-4,4,0,-4,4,0,1,-10,7,-3,-2,5,-2,0,0,-1,-1,0,1,5,-1
KR_6764954177,420,-2,43,-13,-6,2,2,4,-5,5,0,-3,3,0,-2,2,0,2,1,3,-1,-8,-3,-3,-3,6,-2,0,-1,-1,-1,-1,-1,4,-1
KR_6763018969,420,2,26,-15,3,3,0,3,6,0,6,-2,6,4,-3,6,3,-1,2,1,0,5,4,1,-7,6,-2,0,1,-1,1,1,1,2,-1
KR_6729887403,420,-6,-8,-30,-11,-1,2,1,-4,4,0,0,2,2,-5,7,2,-1,5,4,0,-14,45,-1,-6,7,-24,0,-1,-1,1,-1,-1,4,-1
KR_6731249682,420,1,-9,20,-2,2,1,3,-1,5,4,-2,3,1,0,2,2,-1,2,1,0,9,27,1,-7,6,2,0,0,1,1,-1,-1,4,-1
KR_6761908847,420,-2,-66,15,-5,-3,4,1,1,1,2,-1,2,1,-2,4,2,0,2,2,1,4,1,0,-6,6,0,0,0,1,-1,-1,1,1,-1
KR_6688959195,420,-1,-19,4,-9,-1,1,0,-5,7,2,2,1,3,-3,7,4,-2,2,0,-1,-21,118,0,-9,9,-1,0,0,0,-1,0,-1,0,-1
KR_6723650847,420,-5,-36,1,-7,1,3,4,-2,4,2,-5,6,1,-2,5,3,1,0,1,0,-9,-6,4,-8,4,-4,0,0,1,1,0,1,4,-1
KR_6768794872,420,0,-31,9,1,-2,3,1,2,1,3,2,6,8,0,5,5,-1,2,1,0,-4,-21,5,-7,2,-3,0,-1,1,-1,-1,-1,1,-1
KR_6733753836,420,2,-18,0,-2,0,2,2,-1,4,3,-2,3,1,1,4,5,0,0,0,-1,-9,13,-4,-7,11,-1,0,1,-1,-1,1,-1,5,-1
KR_6616398925,420,-3,15,-8,-5,1,1,2,-4,7,3,1,1,2,-2,6,4,-1,1,0,0,-17,2,-2,-3,5,0,0,0,-1,-1,1,1,6,-1
KR_6759640184,420,0,8,14,0,3,0,3,-1,4,3,-2,4,2,-1,4,3,1,0,1,0,5,-9,-4,-4,8,8,0,0,1,1,0,-1,4,-1
KR_6754758989,420,-1,-25,-6,-2,1,1,2,0,1,1,-3,3,0,0,2,2,0,0,0,0,1,-22,-5,-4,9,6,0,0,-1,-1,0,-1,3,-1
KR_6712917928,420,0,-23,-2,-4,0,0,0,-1,6,5,2,2,4,-4,4,0,-1,1,0,0,-8,-2,-4,-1,5,-1,0,-1,-1,-1,-1,-1,1,-1
KR_6766817061,420,-5,-20,-1,-7,-2,3,1,-2,3,1,-3,3,0,2,5,7,-2,2,0,0,-8,9,2,-10,8,-7,0,-1,1,-1,-1,1,3,-1
KR_6731054974,420,-2,-16,-12,0,-4,5,1,2,2,4,-1,1,0,3,1,4,0,2,2,2,7,13,7,-12,5,-3,0,0,1,1,-1,1,5,-1
KR_6746557947,440,-4,-15,8,-11,1,2,3,1,3,4,2,0,2,-4,6,2,-11,11,0,0,-11,-18,-4,-2,6,1,0,-1,-1,-1,-1,-1,6,-1
KR_6768350174,420,-1,-9,18,-4,1,2,3,-1,2,1,-2,3,1,-3,9,6,1,1,2,0,0,-12,2,-6,4,0,0,1,-1,1,1,-1,2,-1
KR_6764605413,420,0,-98,-1,-6,-3,3,0,0,3,3,-1,6,5,-1,4,3,-1,1,0,0,3,3,-4,-5,9,1,0,-1,-1,-1,-1,-1,3,-1
KR_6568924092,420,2,67,37,-4,4,0,4,-1,4,3,-2,4,2,-6,7,1,1,2,3,1,-5,-3,0,-6,6,-2,0,0,1,-1,0,1,2,-1
KR_6764097050,420,-4,-33,-26,-10,1,0,1,-5,7,2,-3,3,0,-2,3,1,-1,1,0,0,-20,-4,3,-8,5,-1,0,-1,-1,-1,-1,-1,3,-1
KR_6745284277,420,-3,-18,3,-12,2,0,2,-1,4,3,-8,10,2,-4,6,2,-1,2,1,0,-8,1,2,-7,5,-4,0,-1,0,1,-1,-1,0,-1
KR_6766501561,420,0,-40,20,-2,-3,3,0,9,3,12,-2,3,1,-3,6,3,-3,3,0,0,-1,2,-5,-2,7,0,0,-1,1,-1,-1,1,2,-1
KR_6627777294,420,-2,10,19,-1,-3,3,0,1,0,1,-1,5,4,1,0,1,1,0,1,0,-2,14,-6,-2,8,-1,0,0,1,0,-1,-1,2,-1
KR_6767139360,420,0,-75,12,-2,-1,2,1,-1,1,0,0,0,0,1,2,3,-1,3,2,0,-2,-17,-3,-5,8,6,0,0,1,-1,-1,1,6,-1
KR_6752419677,420,0,-52,16,-6,-5,6,1,1,3,4,-2,5,3,3,4,7,-3,4,1,0,-1,-3,-6,-3,9,5,0,1,1,-1,1,1,6,-1
KR_6765754574,440,-2,-61,-20,0,-2,2,0,-1,2,1,-1,4,3,2,0,2,2,0,2,0,1,-113,-1,-6,7,-7,0,-3,1,-1,-1,1,2,-1
KR_6761583129,420,-2,15,0,-15,1,2,3,-12,13,1,-3,3,0,0,4,4,-1,1,0,-2,-25,-4,-4,-5,9,3,0,-2,1,-1,-1,-1,6,-1
KR_6766806898,420,-2,-63,-7,-3,5,0,5,-1,3,2,0,1,1,-4,5,1,-3,3,0,0,-7,-6,1,-6,5,-1,0,1,-1,1,1,-1,5,-1
KR_6760606194,420,-4,-4,-8,-17,-2,4,2,-14,14,0,-2,4,2,1,3,4,0,2,2,0,-21,14,-3,-4,7,-2,0,-1,1,-1,-1,1,3,-1
KR_6767983835,420,-3,-32,20,-6,-4,6,2,-3,4,1,3,2,5,-1,2,1,-1,2,1,0,-7,-19,-1,-7,8,5,0,-1,1,1,1,-1,6,-1
KR_6761487764,420,-2,-95,30,-7,-1,1,0,2,2,4,-5,5,0,-3,4,1,0,2,2,0,-10,4,2,-6,4,-1,0,0,1,1,0,1,6,-1
KR_6765405567,420,1,45,-2,2,3,1,4,1,3,4,2,2,4,-5,6,1,1,1,2,1,-5,0,-3,-3,6,2,0,1,1,-1,1,1,1,-1
KR_6749598658,420,-3,3,5,-4,0,0,0,-2,5,3,0,0,0,0,3,3,-2,2,0,0,-9,3,0,-7,7,-3,0,1,1,1,1,-1,6,-1
KR_6689952575,420,-1,-24,-5,-8,-2,3,1,0,5,5,-3,5,2,0,2,2,-3,3,0,-1,-13,1,-3,-5,8,-1,0,-1,0,-1,-1,-1,0,-1
KR_6729027693,420,-2,29,-48,-2,-1,1,0,0,0,0,-6,7,1,3,2,5,2,0,2,0,4,1,3,-4,1,1,0,0,1,-1,-1,1,2,-1
KR_6765942273,420,0,3,-1,-6,1,0,1,-3,5,2,-3,6,3,2,4,6,-3,4,1,0,-2,-8,-2,-4,6,0,0,-1,0,-1,-1,-1,0,-1
KR_6762671045,420,-5,-86,-12,-15,-7,9,2,-9,10,1,4,0,4,-4,4,0,1,1,2,0,-9,36,3,-6,3,-24,0,-1,1,-1,-1,-1,3,-1
KR_6764935617,420,1,-48,21,-1,0,2,2,4,1,5,2,1,3,-8,11,3,1,0,1,2,-10,-3,-1,-6,7,-4,0,-1,-1,1,-1,-1,1,-1
KR_6654818714,420,-4,-57,-20,-10,0,0,0,0,2,2,-5,5,0,-5,6,1,0,1,1,0,-13,-12,-3,-3,6,2,0,0,-1,1,-1,-1,4,-1
KR_6660289461,420,2,16,8,6,2,2,4,-1,2,1,7,1,8,-1,3,2,-1,3,2,0,13,4,2,-7,5,-2,0,1,-1,1,1,1,4,-1
KR_6650822686,420,0,-7,-1,-3,0,1,1,-3,4,1,1,1,2,-1,2,1,0,0,0,0,-6,-14,3,-9,6,-1,0,1,1,-1,1,-1,3,-1
KR_6729181176,420,-5,-7,-59,-11,-1,3,2,-3,3,0,2,0,2,-7,7,0,-2,2,0,0,-11,6,-1,-4,5,-2,0,-1,-1,-1,-1,-1,1,-1
KR_6741057039,420,3,2,30,3,0,2,2,1,4,5,-3,8,5,6,0,6,-1,2,1,0,0,-8,-3,-6,9,6,0,0,-1,-1,0,-1,1,-1
KR_6758517905,420,1,34,-4,-1,2,2,4,-1,4,3,-4,4,0,-1,3,2,3,0,3,-1,-1,-10,0,-6,6,4,0,-1,-1,-1,-1,-1,1,-1
KR_6765370295,420,-2,-49,20,-6,-2,4,2,-3,7,4,-1,2,1,0,1,1,0,0,0,0,-7,-2,0,-5,5,1,0,-1,1,-1,-1,-1,2,-1
KR_6761241422,440,1,53,-8,1,2,0,2,-1,6,5,1,2,3,-2,3,1,1,0,1,0,-4,42,-1,-2,3,-18,0,2,-1,1,1,1,4,-1
KR_6765301190,420,-3,-58,-15,-4,0,2,2,-5,5,0,-3,5,2,5,1,6,-1,1,0,0,-10,-41,-1,-6,7,2,0,-1,1,-1,-1,-1,5,-1
KR_6756446211,440,1,-5,8,-1,0,0,0,-3,5,2,0,3,3,0,2,2,2,0,2,0,-6,0,5,-8,3,-6,0,0,-1,1,0,1,5,-1
KR_6727375594,420,-5,-47,0,-4,3,0,3,-4,4,0,-1,1,0,-2,3,1,0,2,2,0,-2,20,0,-5,5,-6,0,-1,1,1,-1,1,1,-1
KR_6766752793,420,0,-45,36,-8,0,1,1,3,1,4,-4,5,1,-6,6,0,-1,1,0,0,-9,2,-2,-8,10,-6,0,0,0,1,0,-1,0,-1
KR_6758386340,420,2,54,-9,4,2,1,3,1,1,2,0,1,1,0,7,7,1,1,2,-1,5,-6,-1,-3,4,4,0,-1,-1,0,-1,-1,5,-1
KR_6768623673,420,-5,-87,-23,-12,-3,5,2,-5,6,1,0,2,2,-3,3,0,-1,1,0,0,-11,-22,-6,-1,7,0,0,-2,-1,-1,-1,1,4,-1
KR_6742344172,420,0,2,34,-11,-2,2,0,1,3,4,-2,2,0,-6,7,1,-2,2,0,-1,-15,3,-6,-1,7,1,0,0,-1,1,0,-1,3,-1
KR_6764389158,420,1,37,-12,-3,-1,1,0,0,4,4,-2,2,0,1,1,2,-1,3,2,0,-7,-10,-4,-6,10,5,0,1,-1,1,1,-1,2,-1
KR_6758477473,420,-1,-43,-23,0,-5,6,1,5,2,7,7,0,7,0,1,1,-7,8,1,-2,8,-2,-4,-5,9,0,0,-1,1,-1,-1,-1,3,-1
KR_6756618537,420,3,3,0,8,3,1,4,3,4,7,0,3,3,1,1,2,1,1,2,0,0,5,1,-6,5,3,0,0,-1,1,1,1,4,-1
KR_6746136977,420,-1,2,8,1,0,1,1,2,3,5,3,1,4,-3,4,1,-1,3,2,0,4,-11,0,-4,4,5,0,0,1,1,0,1,2,-1
KR_6743664832,420,-2,-3,-1,-14,0,2,2,-7,9,2,-3,3,0,-3,5,2,-1,1,0,0,-14,2,1,-8,7,1,0,-1,-1,-1,-1,-1,6,-1
KR_6732267113,420,-1,-25,-23,0,0,4,4,1,3,4,-1,1,0,1,2,3,-1,4,3,0,2,10,1,-8,7,-3,0,0,1,-1,-1,1,5,-1
KR_6753361279,420,-4,-30,26,-15,-2,3,1,-4,6,2,-5,5,0,-3,5,2,-1,2,1,0,-21,-79,0,-7,7,-3,0,-1,-1,1,-1,-1,2,-1
KR_6655063985,420,0,-67,-20,5,1,1,2,2,2,4,-3,3,0,5,0,5,0,0,0,0,-1,-42,-1,-7,8,20,0,1,1,-1,-1,-1,5,-1
KR_6659253671,420,-5,-90,-28,-3,5,0,5,-2,4,2,0,1,1,-5,7,2,-1,2,1,0,0,7,2,-6,4,-4,0,0,-1,-1,-1,-1,4,-1
KR_6674981016,420,-3,-50,-4,-9,-4,5,1,0,1,1,-2,5,3,-1,2,1,-2,2,0,0,-2,30,-1,-4,5,-5,0,-3,-1,-1,-1,-1,3,-1
KR_6737625723,420,0,21,36,-7,2,1,3,1,2,3,-3,4,1,-3,4,1,-4,5,1,-2,-7,1,0,-4,4,2,0,0,-1,1,-1,1,4,-1
KR_6749150005,420,-4,-10,-14,-8,-2,3,1,-3,3,0,3,1,4,-6,6,0,0,0,0,0,-6,-13,-8,-3,11,4,0,0,1,-1,-1,-1,6,-1
KR_6739327371,420,-1,-33,-15,-4,1,1,2,-5,6,1,-2,4,2,-1,2,1,3,1,4,0,-4,112,-3,-4,7,-4,0,0,1,1,0,-1,2,-1
KR_6748705165,420,-2,29,15,-9,-7,8,1,-1,3,2,-2,2,0,3,1,4,-2,3,1,0,-14,3,9,-13,4,-6,0,0,-1,-1,0,-1,3,-1
KR_6767339414,420,5,44,4,6,6,1,7,-2,3,1,-1,6,5,2,3,5,1,0,1,0,-2,339,-1,-5,6,-2,0,1,-1,-1,1,1,1,-1
KR_6698217373,440,0,-20,-29,-5,6,1,7,-4,6,2,0,2,2,-7,7,0,0,2,2,0,-11,-31,5,-8,3,0,0,1,-1,-1,1,-1,3,-1
KR_6657173745,420,-4,-17,-29,-12,1,0,1,-4,5,1,0,0,0,-3,3,0,-6,6,0,0,-16,1,0,-7,7,-1,0,0,-1,-1,-1,-1,3,-1
KR_6765428579,420,4,77,5,4,0,0,0,-1,2,1,1,2,3,2,3,5,2,0,2,0,10,-12,3,-7,4,-1,0,1,-1,-1,1,-1,3,-1
KR_6753807026,420,-1,22,-7,-1,-1,4,3,1,1,2,-1,2,1,0,5,5,0,0,0,0,0,-4,-1,-4,5,-4,0,0,-1,-1,-1,1,3,-1
KR_6675219104,420,0,47,8,0,0,2,2,2,1,3,0,2,2,-5,6,1,3,0,3,2,-1,6,8,-10,2,0,0,1,-1,1,1,1,3,-1
KR_6738917123,440,-1,-106,-2,-6,-3,3,0,-4,7,3,-1,2,1,0,3,3,2,2,4,-1,2,-9,0,-6,6,-1,0,-1,1,-1,-1,-1,1,-1
KR_6762286409,420,-5,-35,-49,-10,-5,6,1,0,1,1,2,3,5,-4,6,2,-3,4,1,0,-3,1,6,-8,2,3,0,-1,-1,-1,-1,1,3,-1
KR_6768744308,420,-2,-37,21,-5,-3,3,0,0,2,2,0,2,2,-3,6,3,1,0,1,-1,-6,-35,-3,-6,9,37,0,-1,1,-1,-1,-1,6,-1
KR_6729564076,420,-2,-25,4,-11,-4,4,0,-3,6,3,-5,6,1,1,3,4,0,0,0,-1,-10,-33,-1,-3,4,3,0,0,-1,1,0,-1,4,-1
KR_6734029136,420,-4,-73,-28,-12,-3,3,0,-10,11,1,-5,6,1,4,3,7,2,0,2,2,-7,-2,-8,-2,10,1,0,-1,-1,-1,-1,1,3,-1
KR_6764470432,420,-1,-4,-4,-8,7,0,7,1,2,3,-8,8,0,-6,7,1,-2,3,1,0,-7,-4,-1,-7,8,-2,0,0,-1,1,-1,-1,1,-1
KR_6720289483,420,-3,-45,-35,-6,-2,3,1,-5,10,5,0,2,2,1,3,4,0,0,0,0,-20,9,4,-7,3,-9,0,0,1,1,1,-1,4,-1
KR_6767463922,420,0,30,8,0,1,0,1,0,0,0,0,2,2,0,3,3,-1,1,0,0,-4,-34,3,-7,4,-5,0,0,-1,1,0,-1,3,-1
KR_6762510943,420,4,73,3,5,3,0,3,-1,3,2,3,4,7,0,4,4,0,1,1,0,0,4,2,-6,4,1,0,0,-1,0,1,1,4,-1
KR_6639582480,420,1,20,24,3,1,2,3,1,1,2,4,2,6,-1,3,2,-2,3,1,0,1,-5,-2,-4,6,-1,0,0,-1,-1,-1,-1,2,-1
KR_6621651433,420,0,32,9,7,2,2,4,5,2,7,-1,5,4,3,1,4,-2,2,0,0,8,-16,2,-5,3,2,0,1,-1,-1,1,1,4,-1
KR_6682003995,420,-8,-67,-20,-18,-6,6,0,-7,7,0,-3,4,1,-3,5,2,1,4,5,0,-13,-21,-1,-9,10,-5,0,-2,-1,-1,-1,-1,1,-1
KR_6765108576,420,-5,-39,26,-17,-1,1,0,-6,7,1,-7,7,0,-3,4,1,0,2,2,-1,-21,11,-4,-5,9,-1,0,-2,1,-1,-1,-1,6,-1
KR_6767703137,420,-4,-73,1,-17,-5,6,1,-6,7,1,-1,3,2,-3,5,2,-2,2,0,0,-21,-26,-4,-6,10,-2,0,-3,-1,-1,-1,-1,3,-1
KR_6767533317,420,-4,-31,-1,-13,-2,3,1,-6,7,1,-4,5,1,-1,1,0,0,1,1,0,-19,4,4,-9,5,-6,0,-2,-1,-1,-1,-1,4,-1
KR_6497565966,420,-1,-46,-12,-3,0,4,4,-5,9,4,-1,1,0,4,2,6,-1,1,0,-1,2,14,3,-6,3,-5,0,-3,1,-1,-1,-1,3,-1
KR_6667178232,420,-1,-51,6,-2,1,2,3,4,1,5,-2,2,0,-6,6,0,1,0,1,0,-9,-4,-1,-3,4,-3,0,0,-1,1,-1,-1,3,-1
KR_6689435552,420,-6,-77,-13,-5,5,0,5,-5,5,0,0,1,1,-2,3,1,-3,3,0,0,-8,-153,2,-5,3,-1,0,-2,-1,-1,-1,1,5,-1
KR_6765482191,420,-6,-48,0,-11,-1,2,1,1,2,3,-7,7,0,0,1,1,-4,5,1,0,-7,4,2,-6,4,-6,0,-2,-1,0,-1,1,1,-1
KR_6497505418,420,-3,-24,-3,-13,-3,4,1,-2,3,1,-5,6,1,-3,3,0,0,0,0,-1,-16,-2,1,-6,5,0,0,0,-1,-1,-1,-1,5,-1
KR_6740248151,420,-3,-68,-35,-7,-3,4,1,-2,5,3,-2,4,2,0,2,2,0,1,1,0,-5,129,-1,-7,8,-8,0,0,1,0,0,1,5,-1
KR_6752088718,420,-4,-36,-23,0,-5,7,2,1,4,5,-1,3,2,5,1,6,0,1,1,2,6,6,3,-9,6,3,0,-2,1,-1,-1,-1,4,-1
KR_6738139881,420,-1,-52,-17,-3,-1,1,0,1,1,2,-2,7,5,1,0,1,-2,3,1,0,-3,19,-1,-4,5,-4,0,-1,-1,-1,-1,-1,5,-1
KR_6756512103,420,-5,-18,15,-12,-9,9,0,-2,2,0,0,3,3,-3,5,2,2,1,3,-2,-12,6,-3,-2,5,0,0,-1,-1,-1,-1,-1,4,-1
KR_6769131687,440,0,-62,-19,8,5,0,5,2,2,4,-3,5,2,2,2,4,2,1,3,0,15,-16,2,-4,2,20,0,-1,-1,1,-1,1,4,-1
KR_6768537621,420,2,22,7,5,-7,7,0,1,0,1,2,2,4,7,0,7,2,0,2,1,10,0,-1,-6,7,4,0,0,1,-1,-1,1,5,-1
KR_6759803150,420,-1,-57,14,2,-1,1,0,0,5,5,-1,4,3,3,3,6,1,1,2,3,8,14,1,-9,8,1,0,1,1,1,1,1,6,-1
KR_6738896578,440,-5,-88,-15,-6,-1,2,1,-1,3,2,-2,3,1,-1,2,1,-1,2,1,0,1,-4,-3,-3,6,1,0,-2,-1,-1,-1,-1,5,-1
KR_6753690235,420,0,25,4,-3,0,1,1,0,3,3,-2,4,2,-1,3,2,0,0,0,0,-2,12,-1,-3,4,3,0,1,-1,-1,1,-1,4,-1
KR_6670038024,420,-3,-105,19,-2,-3,3,0,0,1,1,1,2,3,0,4,4,0,1,1,0,0,-16,2,-6,4,4,0,-2,0,-1,-1,1,0,-1
KR_6755570676,420,-3,-73,-1,-9,0,1,1,-1,1,0,-1,4,3,-2,2,0,-5,5,0,0,-5,-3,3,-7,4,-9,0,-1,-1,-1,-1,-1,5,-1
KR_6655418838,420,-2,-36,-8,-8,-2,2,0,0,1,1,-2,2,0,-3,4,1,-1,2,1,0,-4,74,-3,-3,6,-15,0,-2,-1,-1,-1,-1,5,-1
KR_6760177826,420,-1,-51,16,-6,-6,6,0,-2,4,2,-2,4,2,6,1,7,-2,3,1,0,1,-7,-1,-3,4,-2,0,-2,1,-1,-1,-1,3,-1
KR_6765606868,420,0,21,-7,2,-2,4,2,-1,2,1,0,2,2,2,5,7,3,0,3,3,6,8,3,-7,4,0,0,-1,1,-1,-1,1,6,-1
KR_6763969494,440,1,-3,-12,3,1,0,1,3,1,4,-3,4,1,2,2,4,0,0,0,0,3,0,7,-9,2,0,0,0,1,-1,0,-1,4,-1
KR_6762995864,440,-2,-25,-17,-6,-1,4,3,-5,7,2,-4,5,1,2,1,3,2,1,3,0,-5,-11,1,-3,2,0,0,1,-1,1,1,-1,4,-1
KR_6735416265,420,0,8,8,0,-2,2,0,-2,4,2,6,2,8,-2,2,0,0,1,1,1,-1,30,6,-8,2,3,0,0,-1,-1,0,1,5,-1
KR_6518867404,420,-1,-3,4,0,4,2,6,0,3,3,-2,7,5,-1,4,3,-1,3,2,1,-4,12,2,-9,7,-1,0,-1,1,-1,-1,1,3,-1
KR_6706357697,420,0,-30,-24,1,-2,3,1,1,7,8,-1,2,1,3,1,4,0,2,2,1,8,5,-5,-5,10,-3,0,1,-1,1,1,1,3,-1
KR_6753254009,420,2,27,-1,0,5,1,6,0,2,2,-2,2,0,-4,6,2,1,2,3,0,-8,5,2,-8,6,-5,0,0,0,-1,0,1,0,-1
KR_6697338804,420,-1,-65,24,-1,-6,7,1,2,1,3,-4,6,2,4,1,5,3,2,5,0,6,3,3,-6,3,0,0,-3,1,-1,-1,1,1,-1
KR_6765410531,420,-1,-1,-16,-10,-6,9,3,0,3,3,1,2,3,-6,7,1,1,2,3,0,-4,0,2,-7,5,-2,0,-1,-1,-1,-1,-1,1,-1
KR_6654347464,420,-3,-50,-16,-5,-1,1,0,-1,5,4,-3,6,3,-1,1,0,1,0,1,0,-2,-1,1,-7,6,-5,0,-1,-1,-1,-1,1,1,-1
KR_6762467810,420,-3,-73,-4,-7,-2,4,2,0,2,2,-6,7,1,-1,2,1,2,1,3,-1,-4,15,0,-4,4,-3,0,-2,-1,1,-1,-1,3,-1
KR_6740156947,420,-2,-18,-15,-8,-1,2,1,-1,2,1,-3,5,2,-2,4,2,-1,1,0,0,-9,-68,6,-12,6,-5,0,0,-1,-1,-1,1,6,-1
KR_6762750831,420,3,-1,5,8,3,0,3,0,1,1,2,0,2,1,0,1,2,0,2,0,5,-6,1,-4,3,-2,0,0,-1,1,1,1,2,-1
KR_6756929936,440,1,-26,19,-2,0,1,1,4,0,4,-3,4,1,-1,1,0,-2,3,1,0,-3,-130,-2,-4,6,2,0,0,1,1,0,-1,3,-1
KR_6765734902,420,2,-15,7,2,-1,1,0,0,2,2,2,0,2,0,1,1,1,0,1,0,6,-13,-1,-4,5,3,0,0,1,1,0,-1,2,-1
KR_6761802274,420,0,-21,8,0,-1,3,2,-1,5,4,-1,2,1,1,4,5,2,0,2,0,7,3,2,-10,8,-6,0,-1,1,-1,-1,1,6,-1
KR_6627102769,420,-11,-79,-40,-8,3,2,5,-1,2,1,-1,1,0,-6,6,0,-3,3,0,0,-8,-11,-4,0,4,2,0,-4,-1,-1,-1,1,5,-1
KR_6760053608,420,-1,-40,-17,-4,-1,3,2,-4,5,1,-2,4,2,5,6,11,-2,3,1,-1,-3,-17,-3,-7,10,5,0,0,0,-1,-1,-1,0,-1
KR_6733594989,420,-3,-54,-18,-9,-1,3,2,1,2,3,0,1,1,-7,7,0,-2,2,0,0,-5,-39,-3,-7,10,-7,0,-1,-1,1,-1,-1,1,-1
KR_6769129789,420,-2,-36,3,-7,-4,8,4,0,4,4,-2,4,2,-2,5,3,1,0,1,0,-7,-10,1,-3,2,1,0,-1,-1,1,-1,-1,4,-1
KR_6760057429,420,-6,-33,24,-12,0,2,2,-9,9,0,-1,2,1,-2,2,0,0,0,0,0,-15,-88,3,-6,3,-3,0,0,1,-1,0,-1,1,-1
KR_6643329891,420,0,-3,-24,5,-1,3,2,-2,9,7,3,0,3,3,0,3,2,0,2,2,11,8,1,-7,6,4,0,0,1,0,0,1,6,-1
KR_6723477408,420,-4,-45,-41,-12,-3,4,1,-2,3,1,3,0,3,-9,10,1,-1,3,2,0,-12,-5,-4,-4,8,3,0,-2,-1,-1,-1,-1,2,-1
KR_6720005193,420,1,-10,32,-1,0,0,0,-3,3,0,2,2,4,-3,5,2,3,1,4,0,-1,23,-2,-3,5,-5,0,1,0,1,1,1,0,-1
KR_6764045392,420,-2,-21,20,-10,-2,2,0,-5,6,1,-2,2,0,1,2,3,-2,2,0,-1,-14,-7,-4,-6,10,-2,0,-1,-1,1,-1,-1,4,-1
KR_6754421991,420,-3,-58,16,-11,-1,1,0,-2,4,2,-3,4,1,-5,6,1,0,0,0,0,-21,-7,-3,-5,8,2,0,0,-1,1,0,-1,2,-1
KR_6716570907,420,2,-16,-3,3,0,1,1,2,0,2,-3,5,2,2,1,3,2,0,2,0,11,35,3,-9,6,-2,0,0,1,-1,0,1,4,-1
KR_6754735143,420,0,-74,-14,0,-1,3,2,-1,6,5,-3,5,2,4,2,6,1,0,1,-1,3,40,4,-9,5,-3,0,-1,1,-1,1,-1,6,-1
KR_6745787013,420,-1,16,-20,-3,1,3,4,-1,2,1,0,2,2,-2,4,2,-1,2,1,0,-14,-5,2,-10,8,-2,0,4,-1,1,1,1,1,-1
KR_6750952037,420,-2,-21,4,-1,1,1,2,5,1,6,-2,3,1,-4,5,1,-1,2,1,0,2,46,-1,-4,5,-5,0,0,-1,1,-1,-1,3,-1
KR_6764489290,420,-4,-3,-36,0,-3,4,1,2,1,3,0,2,2,1,3,4,0,0,0,0,-2,1,0,-5,5,-3,0,0,-1,-1,0,1,3,-1
KR_6736885732,420,-1,-15,-5,-5,-3,5,2,2,4,6,-2,4,2,-5,5,0,3,0,3,-1,-4,43,-3,-5,8,-11,0,-1,0,-1,-1,-1,0,-1
KR_6659648551,420,-1,-32,16,-3,-5,6,1,1,3,4,-4,5,1,1,2,3,4,0,4,0,-1,-11,-2,-5,7,-2,0,-2,-1,-1,-1,1,4,-1
KR_6742528243,420,1,8,1,-3,3,0,3,-2,5,3,1,2,3,0,0,0,-5,6,1,0,-9,-14,5,-6,1,-2,0,0,-1,1,0,1,2,-1
KR_6769015693,420,-4,-103,-9,-5,-3,3,0,1,2,3,1,3,4,-5,6,1,1,0,1,0,1,-54,-6,-4,10,34,0,-1,-1,-1,-1,-1,1,-1
KR_6645434299,420,2,30,3,-2,3,1,4,-5,7,2,0,1,1,-1,4,3,1,0,1,0,-3,13,0,-5,5,2,0,0,1,1,1,-1,1,-1
KR_6597492919,420,2,41,-24,4,3,0,3,0,3,3,-3,5,2,1,1,2,3,1,4,0,1,8,1,-10,9,-1,0,-1,-1,-1,-1,1,4,-1
KR_6734932010,420,-1,-1,-10,-1,-1,2,1,1,2,3,-3,4,1,2,1,3,0,0,0,0,3,-18,0,-6,6,-4,0,0,1,-1,0,1,2,-1
KR_6633944797,420,-1,-3,15,-5,-1,2,1,0,2,2,0,1,1,-4,6,2,0,1,1,0,-8,112,0,-6,6,-4,0,0,-1,-1,-1,-1,4,-1
KR_6691362787,420,-3,-41,-24,-6,3,1,4,-4,5,1,-1,4,3,-3,4,1,-1,1,0,0,-6,-10,-1,-6,7,4,0,-2,-1,0,-1,-1,4,-1
KR_6767879012,420,-1,13,6,-1,-4,5,1,-3,3,0,2,0,2,3,0,3,1,0,1,0,-5,7,-5,-6,11,-3,0,0,-1,1,-1,1,2,-1
KR_6705206515,420,0,3,17,-1,2,3,5,-4,4,0,5,2,7,3,1,4,-7,8,1,0,4,2,-3,-5,8,5,0,0,-1,0,0,-1,5,-1
KR_6563273596,420,2,29,-18,-2,1,0,1,-2,4,2,-3,6,3,1,5,6,1,2,3,-1,-7,2,-3,-3,6,0,0,1,1,-1,1,1,5,-1
KR_6693861847,420,-3,-46,-36,-6,-3,4,1,0,2,2,-5,5,0,2,1,3,0,2,2,0,-2,-9,-3,-3,6,0,0,-1,-1,-1,-1,-1,2,-1
KR_6766968268,420,0,56,8,5,0,3,3,-1,5,4,1,1,2,0,0,0,5,0,5,0,6,6,4,-8,4,0,0,1,1,1,1,-1,5,-1
KR_6716515139,420,-1,31,-10,-10,-4,4,0,-5,7,2,-1,2,1,1,3,4,-1,1,0,0,-14,1,3,-8,5,0,0,-1,-1,-1,-1,-1,6,-1
KR_6753478713,420,-2,7,-27,1,2,0,2,5,1,6,-6,6,0,0,4,4,0,2,2,0,1,10,3,-9,6,-4,0,0,1,-1,1,-1,3,-1
KR_6626350325,420,-3,-7,0,-13,3,0,3,-6,7,1,3,1,4,-15,16,1,2,0,2,1,-18,-13,-4,-4,8,5,0,-1,-1,-1,-1,1,6,-1
KR_6757681775,420,-2,-23,-44,1,-1,2,1,-2,6,4,1,2,3,1,2,3,2,3,5,0,-8,31,0,-2,2,6,0,-1,0,-1,-1,1,0,-1
KR_6733356829,420,-4,11,-8,-10,-3,5,2,0,1,1,-4,4,0,-4,5,1,1,1,2,0,-12,2,2,-7,5,-5,0,-2,-1,-1,-1,-1,5,-1
KR_6740625642,420,-3,-132,-10,-9,-2,4,2,2,1,3,0,1,1,-8,11,3,-1,1,0,-1,-11,-5,-1,-4,5,-5,0,-3,1,-1,-1,-1,1,-1
KR_6740468553,440,-5,-57,8,-7,-5,5,0,0,0,0,-4,6,2,2,3,5,0,1,1,0,0,1,1,-4,3,-1,0,0,1,0,-1,-1,2,-1
KR_6752498388,420,-5,-70,-24,-10,-2,2,0,0,2,2,1,3,4,-1,2,1,-8,9,1,-1,-13,15,-5,-3,8,-7,0,0,-1,-1,0,-1,2,-1
KR_6728521139,440,-5,-51,12,-11,-5,5,0,2,5,7,-1,2,1,-7,7,0,0,1,1,0,-4,4,-4,-2,6,-1,0,-1,-1,-1,-1,1,6,-1
KR_6768865086,420,-1,-34,26,-7,-2,2,0,-1,2,1,0,4,4,-2,4,2,-2,3,1,0,-16,-4,-2,-6,8,-1,0,0,1,1,-1,-1,6,-1
KR_6730862452,420,-5,-70,-30,-7,-2,3,1,-1,2,1,-1,3,2,-3,4,1,0,0,0,-1,-8,-11,1,-7,6,-6,0,-2,-1,1,-1,-1,1,-1
KR_6637887832,420,0,58,-32,3,-4,4,0,10,4,14,-2,3,1,-2,3,1,1,1,2,1,8,35,2,-6,4,-3,0,1,1,-1,1,1,2,-1
KR_6767248286,420,-5,-25,-28,-10,-4,5,1,3,1,4,-5,5,0,-3,3,0,-1,1,0,0,-12,-16,-2,-3,5,5,0,-1,-1,1,-1,-1,4,-1
KR_6691243055,440,-3,-72,-4,3,0,1,1,-1,2,1,-5,5,0,6,6,12,3,1,4,0,3,6,1,-4,3,-5,0,0,0,-1,-1,1,0,-1
KR_6756499034,420,2,25,4,-4,2,2,4,-1,4,3,-7,8,1,1,4,5,1,0,1,0,-4,19,1,-5,4,-1,0,2,0,1,1,-1,0,-1
KR_6724495714,420,-3,-13,-20,-3,-2,3,1,0,2,2,5,0,5,-5,6,1,-1,1,0,2,3,-39,-1,-4,5,3,0,-1,-1,1,-1,1,3,-1
KR_6768816856,420,-4,26,-46,-2,0,3,3,-4,5,1,-1,5,4,4,1,5,-1,1,0,0,-4,-9,-3,-3,6,-8,0,-1,-1,-1,-1,1,4,-1
KR_6743657868,440,1,8,5,-5,-1,5,4,0,1,1,0,2,2,-4,5,1,0,0,0,0,1,-16,0,-6,6,-3,0,1,-1,0,1,-1,4,-1
KR_6734153820,420,1,30,-4,-2,0,0,0,-3,4,1,2,0,2,-1,1,0,0,1,1,0,-6,0,-3,-4,7,2,0,1,1,1,1,-1,2,-1
KR_6730376266,440,-1,0,3,-2,2,1,3,2,1,3,-5,6,1,-2,4,2,1,0,1,0,-13,3,3,-6,3,-8,0,3,-1,1,1,1,1,-1
KR_6768628714,420,0,-10,20,-6,-1,1,0,0,3,3,-1,1,0,-3,3,0,-1,3,2,0,-11,-3,-3,-3,6,2,0,0,-1,1,0,-1,6,-1
KR_6704150307,420,-8,-126,-24,-11,-3,3,0,-1,4,3,-3,5,2,-5,5,0,1,0,1,0,-11,-4,-2,-3,5,-4,0,-2,1,-1,-1,1,6,-1
KR_6707689952,420,0,-16,-14,-5,1,3,4,0,2,2,-3,6,3,-1,4,3,-2,2,0,-1,-3,-10,-3,-4,7,-2,0,-1,-1,-1,-1,-1,4,-1
KR_6720188764,420,1,-17,20,3,6,1,7,-1,2,1,1,2,3,-2,2,0,-1,1,0,0,4,3,0,-4,4,3,0,0,1,1,1,1,5,-1
KR_6728912315,420,-2,64,0,-3,0,1,1,-4,5,1,-2,2,0,2,2,4,1,2,3,0,-7,-54,-5,-5,10,4,0,0,1,-1,1,-1,1,-1
KR_6766513761,420,-4,-72,12,-5,0,2,2,5,0,5,-3,4,1,-8,9,1,1,0,1,0,4,26,-4,-3,7,3,0,-1,-1,0,-1,1,3,-1
KR_6747969323,420,-4,-44,-7,-7,1,2,3,-2,2,0,-3,6,3,-1,2,1,-2,2,0,0,-4,-5,-5,-3,8,-1,0,-2,1,-1,-1,-1,5,-1
KR_6697463715,420,-8,-60,-40,-11,0,0,0,-3,5,2,-2,2,0,-4,5,1,-2,3,1,-1,-10,-18,-5,-1,6,1,0,-4,-1,-1,-1,-1,5,-1
KR_6761033714,420,1,-44,-4,2,-2,4,2,0,4,4,0,1,1,2,1,3,2,1,3,0,9,6,-2,-4,6,-1,0,0,-1,-1,0,-1,6,-1
KR_6759371386,420,-3,-58,-19,-5,2,1,3,-6,7,1,5,2,7,-3,3,0,-3,4,1,0,0,38,1,-3,2,-2,0,-2,-1,1,-1,-1,2,-1
KR_6753582001,420,2,-4,43,0,-1,3,2,1,4,5,0,2,2,-1,1,0,1,0,1,0,1,2,0,-7,7,4,0,0,1,1,1,-1,1,-1
KR_6766691152,420,-3,-31,-16,-6,-2,4,2,-3,6,3,-3,3,0,-1,3,2,3,0,3,0,-10,208,-2,-5,7,-3,0,1,-1,1,1,1,3,-1
KR_6701943391,420,-4,-59,-12,-8,-1,5,4,-3,4,1,0,1,1,-1,2,1,-3,5,2,-1,-8,-15,-1,-3,4,-2,0,-1,-1,1,-1,-1,1,-1
KR_6756805208,420,-4,-26,-33,-4,-6,8,2,-1,3,2,-1,3,2,4,2,6,0,0,0,0,2,4,2,-7,5,-1,0,-1,-1,-1,-1,-1,2,-1
KR_6663121047,420,0,-54,12,-5,-1,2,1,-2,3,1,0,1,1,-2,4,2,0,1,1,0,-13,27,-2,-5,7,-2,0,0,-1,-1,0,-1,2,-1
KR_6762004355,420,2,8,20,-4,-2,3,1,0,3,3,3,3,6,-5,5,0,0,0,0,-3,-4,7,0,-6,6,-6,0,-1,0,1,-1,-1,0,-1
KR_6750857821,420,-1,-72,17,-6,-1,1,0,-2,4,2,0,2,2,-1,2,1,-2,3,1,0,-6,224,-3,-3,6,19,0,-1,-1,1,-1,-1,1,-1
KR_6743362935,440,0,68,-19,-5,2,1,3,1,1,2,0,1,1,-7,12,5,-1,4,3,-1,1,6,8,-12,4,-1,0,2,-1,1,1,-1,1,-1
KR_6759558907,420,-2,-3,-6,-7,1,1,2,-3,4,1,-1,2,1,-5,6,1,1,0,1,1,-10,-6,-7,-3,10,-1,0,0,-1,-1,0,1,5,-1
KR_6670825562,440,-5,-107,-35,-6,-6,8,2,-2,3,1,0,3,3,-2,2,0,4,1,5,-2,-5,-1,-3,-3,6,7,0,-1,-1,1,-1,-1,3,-1
KR_6763822608,420,-3,-13,-3,-6,4,1,5,0,1,1,1,1,2,-8,8,0,-3,4,1,-2,-5,15,-2,-2,4,-8,0,-1,-1,1,-1,-1,4,-1
KR_6767244865,420,-6,-94,20,-19,-8,8,0,-2,3,1,-9,11,2,2,0,2,-2,2,0,0,-20,22,-4,-5,9,-5,0,-4,-1,-1,-1,-1,2,-1
KR_6672985796,420,-3,-11,-9,-2,3,0,3,-6,7,1,1,0,1,-3,4,1,3,0,3,0,-15,-15,1,-6,5,-3,0,-1,-1,-1,-1,1,5,-1
KR_6763686849,420,-5,-57,17,-6,-1,1,0,1,1,2,-2,4,2,-1,2,1,-3,3,0,0,-10,40,-4,-3,7,-1,0,0,1,-1,0,-1,2,-1
KR_6740947623,440,-5,-47,-32,-1,-3,4,1,0,4,4,4,3,7,-3,4,1,1,1,2,0,5,8,0,-5,5,-1,0,-3,-1,1,-1,1,1,-1
KR_6754703330,420,-1,-35,-5,-10,-2,2,0,0,4,4,-1,4,3,-7,9,2,0,1,1,-2,-11,-3,-6,-4,10,-1,0,0,-1,1,0,-1,4,-1
KR_6757000081,420,-2,-25,-22,2,-3,5,2,3,0,3,2,1,3,1,3,4,-1,1,0,0,4,0,0,-6,6,4,0,0,-1,-1,0,1,2,-1
KR_6758809167,420,-1,-58,28,-11,-3,3,0,4,1,5,-4,5,1,-8,9,1,0,0,0,-2,-12,-9,-4,-4,8,-5,0,-1,1,-1,-1,-1,3,-1
KR_6723420367,420,-2,-19,-8,-6,-1,2,1,-7,8,1,-1,4,3,1,3,4,2,0,2,-1,-15,-1,4,-8,4,-1,0,1,-1,1,1,1,3,-1
KR_6736397540,420,-1,-93,11,-6,-1,2,1,-2,2,0,3,1,4,-4,4,0,-2,2,0,0,-5,-10,1,-6,5,0,0,-1,-1,1,-1,-1,2,-1
KR_6761152051,420,0,-54,-22,-1,0,1,1,-1,5,4,0,1,1,0,3,3,0,0,0,0,-1,1,-7,0,7,1,0,0,-1,1,0,1,5,-1
KR_6703901045,420,-1,-36,-29,-7,0,0,0,-3,6,3,-2,2,0,-1,4,3,-1,3,2,-1,-6,33,-2,-6,8,3,0,-1,-1,-1,-1,-1,5,-1
KR_6767689777,420,0,26,8,-11,-1,1,0,1,0,1,-6,6,0,-2,6,4,-3,3,0,0,-12,-41,-6,-1,7,1,0,0,0,-1,-1,-1,0,-1
KR_6742027662,420,3,43,52,2,1,1,2,-1,3,2,2,2,4,-1,4,3,1,1,2,0,-1,7,5,-9,4,6,0,1,-1,1,1,1,6,-1
KR_6652568181,420,-7,-1,-42,-20,-6,8,2,-6,10,4,-3,4,1,-4,6,2,-1,1,0,0,-13,-27,-3,-3,6,-2,0,-1,-1,-1,-1,-1,1,-1
KR_6737877860,420,-1,-35,11,-2,0,1,1,0,4,4,2,3,5,-5,6,1,1,0,1,0,-1,8,3,-6,3,0,0,0,-1,1,0,-1,3,-1
KR_6723602327,420,-1,-55,-2,-7,3,2,5,-5,7,2,-4,5,1,-2,3,1,1,0,1,0,-8,4,6,-9,3,0,0,-2,1,-1,-1,1,5,-1
KR_6730297524,440,-3,15,-3,-4,3,0,3,-6,6,0,2,1,3,-3,3,0,0,0,0,0,-10,-6,-6,-3,9,-5,0,-2,-1,-1,-1,-1,3,-1
KR_6755418152,440,2,-33,11,5,0,0,0,1,1,2,2,0,2,2,0,2,0,0,0,0,6,-3,4,-6,2,1,0,0,-1,1,0,1,6,-1
KR_6732703536,420,3,77,-9,3,2,1,3,-3,4,1,0,0,0,4,0,4,0,0,0,0,4,-9,-2,-5,7,2,0,1,-1,1,1,-1,3,-1
KR_6768743223,420,-2,-22,-11,-4,-1,2,1,1,2,3,-2,5,3,-2,2,0,0,1,1,0,-3,9,6,-8,2,-7,0,-2,1,1,-1,-1,2,-1
KR_6766552011,420,4,46,16,7,-1,4,3,2,1,3,0,1,1,4,4,8,2,0,2,0,11,-41,-2,-4,6,2,0,1,-1,-1,1,1,1,-1
KR_6660868808,420,2,55,-1,0,1,1,2,3,1,4,-2,5,3,-1,2,1,-1,2,1,0,4,0,-1,-4,5,2,0,0,-1,1,1,1,3,-1
KR_6768833181,420,-4,-85,0,-10,-3,3,0,-3,4,1,-2,3,1,1,8,9,-3,5,2,-1,-11,17,-2,-5,7,-2,0,0,-1,-1,-1,1,5,-1
KR_6705048698,420,0,-5,-8,3,0,2,2,2,2,4,1,2,3,-1,3,2,1,0,1,0,5,-44,-1,-5,6,21,0,1,1,1,1,1,5,-1
KR_6765200495,420,-2,-52,12,-5,-3,6,3,-4,4,0,-1,1,0,3,3,6,0,1,1,0,-6,0,5,-10,5,-1,0,-1,1,1,1,1,6,-1
KR_6766958730,420,-1,-25,-30,-1,1,2,3,-1,4,3,2,0,2,-2,4,2,-1,3,2,0,7,2,3,-6,3,0,0,-1,1,-1,-1,1,3,-1
KR_6701681145,420,1,27,-16,-5,2,0,2,-1,2,1,-3,3,0,-3,3,0,0,0,0,-1,-8,-11,-8,-2,10,8,0,0,-1,-1,-1,-1,6,-1
KR_6704568197,420,-1,-33,-4,-2,-1,2,1,-3,3,0,0,3,3,1,1,2,1,2,3,0,-3,-1,-1,-6,7,4,0,-1,0,-1,-1,1,0,-1
KR_6742097786,420,-1,-15,-16,-2,6,0,6,-2,4,2,-4,5,1,-1,1,0,-1,1,0,0,-6,-5,0,-3,3,2,0,1,-1,1,1,-1,2,-1
KR_6744661343,420,1,-17,-4,0,-3,5,2,4,2,6,4,3,7,-3,5,2,-2,2,0,0,-1,-2,-1,-6,7,5,0,0,1,0,0,-1,2,-1
KR_6750690862,420,0,-3,10,0,1,1,2,4,3,7,-1,2,1,-2,4,2,-2,3,1,1,-6,-5,-4,-8,12,-2,0,1,-1,1,1,1,6,-1
KR_6764482964,420,0,28,8,-1,-1,1,0,-1,3,2,3,0,3,-6,8,2,4,1,5,0,-7,-21,2,-7,5,-1,0,0,1,-1,0,-1,5,-1
KR_6767066649,420,-2,-28,31,-13,1,0,1,0,4,4,-3,8,5,-4,5,1,-7,7,0,-1,-15,-4,-1,-4,5,-7,0,-2,-1,-1,-1,-1,4,-1
KR_6759833527,420,-2,-19,-24,-12,0,2,2,-5,7,2,3,0,3,-2,2,0,-8,8,0,0,-9,-27,-3,-5,8,-7,0,-1,-1,-1,-1,1,3,-1
KR_6767517768,420,1,-33,1,4,1,1,2,3,2,5,4,1,5,-3,4,1,-1,1,0,0,5,-3,-2,-5,7,0,0,2,1,1,1,-1,6,-1
KR_6763346967,420,-3,-76,-4,-8,-2,3,1,-1,3,2,-1,1,0,-4,9,5,0,0,0,0,-7,7,-1,-6,7,3,0,-2,-1,-1,-1,1,2,-1
KR_6768699003,440,-1,46,-29,3,2,2,4,-1,5,4,3,4,7,2,0,2,-3,5,2,1,1,221,3,-5,2,-2,0,0,1,0,-1,1,3,-1
KR_6759196165,420,-6,-55,-14,-16,-2,3,1,-11,14,3,0,2,2,-2,5,3,-1,2,1,0,-20,-7,-2,-5,7,2,0,-1,0,-1,-1,-1,0,-1
KR_6761265874,440,-1,-21,-27,3,3,1,4,-1,4,3,1,1,2,1,1,2,-1,1,0,0,2,-12,3,-5,2,-3,0,0,-1,1,0,-1,1,-1
KR_6593401482,420,0,-11,0,2,-2,2,0,4,0,4,1,1,2,0,2,2,-1,1,0,0,-4,-3,4,-9,5,4,0,1,1,1,1,1,6,-1
KR_6766564450,420,0,-23,-8,-2,0,0,0,0,2,2,2,2,4,-3,5,2,-1,1,0,0,-1,-32,-3,-4,7,1,0,0,-1,-1,-1,-1,5,-1
KR_6764559132,420,-1,9,-28,-4,-4,5,1,0,2,2,1,2,3,0,2,2,-1,2,1,0,3,6,-1,-4,5,-2,0,-2,1,-1,-1,1,1,-1
KR_6762567613,420,-1,-45,6,2,-2,5,3,3,1,4,1,1,2,1,2,3,-1,1,0,0,4,0,0,-4,4,-4,0,-1,1,-1,-1,1,3,-1
KR_6752631819,420,0,-78,-16,-1,0,2,2,-2,2,0,0,3,3,1,0,1,0,0,0,0,1,-10,1,-6,5,9,0,-2,-1,-1,-1,1,6,-1
KR_6736767565,440,-3,-59,0,-5,1,1,2,-5,5,0,0,0,0,-1,2,1,0,0,0,0,-5,-103,-1,-5,6,1,0,0,-1,1,0,1,3,-1
KR_6765494096,420,-2,22,-18,-9,-1,1,0,-1,2,1,-6,8,2,1,2,3,-2,3,1,0,-1,35,-3,-3,6,-22,0,0,-1,1,1,1,5,-1
KR_6743618050,420,-1,-33,-6,-4,2,2,4,1,0,1,2,2,4,-5,6,1,-4,5,1,-1,-7,-1,2,-7,5,-7,0,-1,-1,-1,-1,-1,4,-1
KR_6761810512,420,1,13,1,6,-2,2,0,5,2,7,0,3,3,0,2,2,3,0,3,0,8,8,3,-11,8,-7,0,0,-1,1,0,1,3,-1
KR_6649843025,420,-3,-54,-13,-3,6,0,6,-3,5,2,-2,3,1,-3,4,1,-1,1,0,0,-3,-5,5,-10,5,-2,0,-1,1,-1,-1,-1,4,-1
KR_6762024014,420,-2,-59,-26,0,2,1,3,-4,7,3,1,2,3,0,3,3,1,0,1,0,-11,-2,4,-6,2,2,0,-2,1,1,-1,-1,4,-1
KR_6751203956,440,-7,-72,-15,-20,-8,8,0,-1,2,1,-3,3,0,1,1,2,-9,10,1,0,-16,-18,3,-11,8,-3,0,-3,-1,-1,-1,-1,2,-1
KR_6751805700,420,-3,-69,-7,-3,0,1,1,0,5,5,-3,4,1,0,1,1,0,0,0,0,-6,31,0,-5,5,2,0,0,-1,1,0,-1,2,-1
KR_6766705274,420,0,-49,23,-5,-3,5,2,-3,3,0,2,3,5,-2,2,0,1,1,2,0,-4,-2,2,-6,4,0,0,-1,1,-1,-1,1,1,-1
KR_6766891442,440,-5,-108,-60,-8,-3,4,1,-1,3,2,-2,2,0,-5,5,0,3,3,6,0,2,1,1,-4,3,-2,0,-1,-1,0,-1,-1,4,-1
KR_6742517919,420,-6,-93,-37,-10,-1,2,1,2,1,3,-1,3,2,-9,11,2,-1,2,1,0,-12,-3,-3,-3,6,-2,0,-2,-1,-1,-1,1,1,-1
KR_6748436448,420,-2,-54,-38,-7,-2,2,0,-2,4,2,-5,9,4,4,2,6,-2,2,0,2,-4,-4,1,-7,6,-2,0,0,-1,-1,1,1,6,-1
KR_6715900499,420,2,-20,50,-1,0,0,0,-3,5,2,-2,3,1,6,1,7,-2,2,0,-1,-4,11,-2,-5,7,-3,0,0,1,-1,1,-1,1,-1
KR_6743328737,420,-3,-36,-9,-1,-3,4,1,0,2,2,-2,2,0,4,1,5,0,0,0,0,7,7,5,-9,4,0,0,-1,1,-1,-1,-1,1,-1
KR_6728415319,420,1,-5,-19,2,0,0,0,1,5,6,1,1,2,2,1,3,-2,2,0,1,5,-6,2,-8,6,-2,0,0,-1,1,0,1,2,-1
KR_6768345841,420,-1,-6,-19,2,0,1,1,1,2,3,0,2,2,2,0,2,-1,1,0,0,5,2,6,-9,3,3,0,0,1,-1,0,-1,6,-1
KR_6763188845,440,-1,-19,4,-8,-2,5,3,-3,4,1,-1,1,0,-2,4,2,0,1,1,0,-5,19,5,-6,1,-2,0,1,-1,1,1,1,3,-1
KR_6698656094,440,-1,-7,-23,-9,-4,4,0,0,2,2,0,0,0,-2,6,4,-3,4,1,0,-5,-1,1,-6,5,-1,0,-1,-1,-1,-1,-1,2,-1
KR_6601679128,420,-3,-24,-28,-11,-2,2,0,-2,2,0,-2,2,0,-6,6,0,1,1,2,0,-21,-14,-6,-4,10,0,0,-1,-1,1,-1,-1,2,-1
KR_6687080534,420,-5,-57,-8,-13,0,2,2,-5,5,0,-6,7,1,1,3,4,-3,3,0,0,-11,229,-1,-4,5,-3,0,-2,-1,-1,-1,-1,2,-1
KR_6613148439,420,-6,-81,-41,-10,-6,6,0,-1,5,4,-1,3,2,-2,4,2,0,1,1,0,-16,-6,3,-10,7,-1,0,-3,-1,-1,-1,1,5,-1
KR_6644815518,420,-4,-75,-29,-10,1,0,1,-4,7,3,-8,8,0,1,1,2,0,0,0,0,-13,4,7,-10,3,-6,0,-1,-1,1,-1,-1,5,-1
KR_6504258503,440,-2,-63,-24,-9,-1,3,2,-2,4,2,1,0,1,-2,5,3,-5,5,0,-1,-13,-11,-3,-1,4,0,0,-1,-1,-1,-1,-1,3,-1
KR_6764857723,420,-2,3,12,-4,1,0,1,-1,2,1,-1,3,2,0,1,1,-3,4,1,0,-1,6,-1,-5,6,-1,0,0,1,1,0,-1,1,-1
KR_6647907494,420,-6,-59,-12,-12,-1,2,1,2,1,3,-9,10,1,-4,4,0,0,0,0,0,-18,-7,0,-6,6,-1,0,-2,-1,-1,-1,-1,1,-1
KR_6758968557,420,-6,-33,-1,-15,1,2,3,-7,9,2,-2,3,1,-3,4,1,-4,5,1,0,-20,-11,2,-8,6,-3,0,-3,1,-1,-1,-1,5,-1
KR_6752419722,440,-5,-4,18,-15,0,0,0,-2,5,3,-6,6,0,-6,6,0,-1,3,2,0,-11,17,-1,-4,5,-4,0,0,-1,-1,-1,-1,2,-1
KR_6736952609,420,-6,-84,-33,-10,-5,5,0,-6,9,3,-1,3,2,2,1,3,0,1,1,0,-6,-9,1,-6,5,0,0,-2,-1,1,-1,-1,4,-1
KR_6742205862,420,-3,-75,-47,-1,3,2,5,-1,5,4,0,2,2,-2,2,0,-1,2,1,0,-3,56,1,-5,4,4,0,-2,-1,-1,-1,1,2,-1
KR_6764909715,420,-2,-23,0,-3,2,2,4,0,3,3,0,3,3,-3,3,0,-2,4,2,0,0,-82,4,-7,3,0,0,0,-1,1,1,-1,4,-1
KR_6756592877,420,-2,-1,2,-6,-3,4,1,0,3,3,-2,4,2,-1,1,0,0,0,0,0,-2,181,-1,-7,8,3,0,0,-1,1,0,-1,5,-1
KR_6637353933,420,-1,-37,-8,-3,-1,1,0,2,1,3,-2,4,2,-2,6,4,0,2,2,0,1,2,0,-6,6,1,0,0,-1,-1,-1,-1,6,-1
KR_6757728340,420,-2,-40,-9,0,-3,6,3,2,0,2,0,0,0,1,1,2,0,0,0,0,5,1,-1,-3,4,0,0,0,-1,1,0,-1,6,-1
KR_6716069120,420,-4,-37,-33,-4,-5,6,1,4,0,4,-3,5,2,1,1,2,-1,1,0,0,-5,28,2,-6,4,-9,0,0,1,-1,-1,-1,4,-1
KR_6640403714,420,-4,-48,-9,-8,0,3,3,-2,4,2,-1,3,2,-5,7,2,0,0,0,-1,-7,0,5,-11,6,0,0,-2,0,-1,-1,-1,0,-1
KR_6619644521,420,-4,-35,-13,-6,-8,8,0,-1,4,3,0,1,1,3,2,5,0,1,1,0,6,3,-1,-3,4,2,0,-1,1,1,-1,-1,3,-1
KR_6762231963,420,-2,19,-24,-8,2,2,4,0,3,3,-12,14,2,1,2,3,1,0,1,0,-14,1,1,-4,3,-3,0,-2,-1,-1,-1,-1,1,-1
KR_6759713161,420,1,4,19,0,3,0,3,0,1,1,0,4,4,-5,6,1,2,0,2,0,-11,168,5,-7,2,-2,0,1,-1,1,1,1,2,-1
KR_6757266445,420,3,5,6,2,4,0,4,6,2,8,-7,8,1,-1,1,0,0,0,0,0,2,5,1,-4,3,-2,0,-1,1,-1,-1,1,2,-1
KR_6766009548,440,2,-1,23,3,-2,5,3,4,3,7,0,1,1,0,3,3,1,0,1,0,4,17,2,-8,6,-4,0,3,-1,1,1,1,4,-1
KR_6674727939,420,3,-56,0,2,5,1,6,-4,5,1,-3,4,1,1,1,2,3,1,4,0,3,-10,-4,-6,10,0,0,0,1,0,0,1,5,-1
KR_6756456019,420,-5,-42,-5,-10,4,0,4,1,1,2,-7,7,0,-5,5,0,-3,3,0,0,-18,-5,-2,-2,4,6,0,-1,-1,1,-1,1,5,-1
KR_6744026923,420,-5,-28,17,-18,-2,3,1,-7,7,0,-2,4,2,-5,6,1,-2,3,1,-1,-25,-31,-2,-3,5,-1,0,-2,-1,-1,-1,-1,4,-1
KR_6661862244,420,-1,22,-11,-1,-4,5,1,2,1,3,-2,2,0,0,2,2,3,1,4,0,0,-8,0,-4,4,2,0,-3,-1,-1,-1,1,6,-1
KR_6720267869,420,0,-25,1,-1,0,1,1,-1,2,1,-1,1,0,2,5,7,-1,1,0,0,-6,-6,-3,-3,6,1,0,-1,-1,-1,-1,-1,1,-1
KR_6721717971,420,-3,-14,1,-5,2,3,5,-3,4,1,4,1,5,-6,6,0,-2,2,0,0,-10,7,3,-9,6,-6,0,-1,-1,1,-1,1,3,-1
KR_6747919927,420,-2,3,-12,-5,3,1,4,-4,4,0,-5,5,0,0,2,2,1,0,1,0,-11,-27,-5,-4,9,4,0,0,-1,-1,1,-1,3,-1
KR_6676598568,440,-1,-14,-20,-3,-1,4,3,-5,7,2,-2,2,0,3,4,7,2,0,2,0,4,14,0,-8,8,3,0,0,-1,-1,-1,1,5,-1
KR_6674397770,420,1,2,5,-7,1,1,2,-3,4,1,1,0,1,-2,2,0,-4,4,0,-1,-12,-5,-3,-5,8,-2,0,-2,-1,-1,-1,-1,3,-1
KR_6767403446,420,-1,20,-9,0,-2,2,0,3,2,5,-2,5,3,1,4,5,0,0,0,0,3,-16,3,-7,4,1,0,0,-1,-1,0,-1,5,-1
KR_6763089982,420,-5,-38,-28,-8,-1,2,1,-7,9,2,2,2,4,-1,4,3,-1,2,1,0,-12,9,8,-11,3,-7,0,-2,-1,1,-1,-1,2,-1
KR_6731301410,420,-4,-16,6,-15,-1,2,1,-3,7,4,-5,6,1,-3,4,1,-3,3,0,0,-18,8,0,-9,9,-5,0,-1,-1,-1,-1,-1,3,-1
KR_6752061489,420,0,-68,16,1,-1,2,1,1,4,5,1,3,4,-1,2,1,1,0,1,0,-5,2,-1,-6,7,5,0,0,-1,1,-1,-1,3,-1
KR_6764666759,420,-5,-55,-48,-7,-2,4,2,-2,4,2,-3,3,0,-1,3,2,1,0,1,0,-2,0,-7,-4,11,1,0,-2,-1,-1,-1,-1,4,-1
KR_6694378208,420,-4,-53,-39,-6,1,2,3,-1,1,0,2,0,2,-9,10,1,1,0,1,0,-9,26,0,-7,7,-2,0,-2,-1,1,-1,-1,4,-1
KR_6749047900,420,-3,-56,11,-8,-2,3,1,0,2,2,-4,4,0,-1,6,5,-1,1,0,0,-19,10,1,-7,6,-5,0,-3,-1,-1,-1,-1,4,-1
KR_6676974274,420,0,-31,20,-6,-4,4,0,-4,8,4,5,1,6,-1,1,0,-2,3,1,0,-14,-8,-3,-2,5,4,0,1,1,1,1,-1,6,-1
KR_6757644415,420,0,-53,8,-2,1,2,3,-1,2,1,-1,2,1,1,0,1,-2,2,0,0,-5,5,1,-6,5,-5,0,0,-1,-1,0,-1,1,-1
KR_6749554051,420,-1,24,-20,-10,2,0,2,-1,1,0,0,3,3,-8,9,1,-3,3,0,0,-14,-7,1,-10,9,-7,0,-2,-1,-1,-1,-1,2,-1
KR_6628310220,420,-1,21,-3,0,-2,5,3,1,2,3,2,1,3,-1,5,4,0,0,0,0,-4,1,1,-6,5,2,0,0,1,-1,1,-1,1,-1
KR_6723235026,420,-6,-66,-1,-11,-4,4,0,-8,9,1,0,2,2,0,2,2,1,1,2,-1,-12,11,3,-9,6,-2,0,0,1,-1,-1,-1,1,-1
KR_6735701753,420,-1,-22,9,-5,2,1,3,-1,3,2,-3,3,0,-3,4,1,0,0,0,0,-6,-35,-5,-5,10,2,0,-1,-1,1,-1,-1,6,-1
KR_6679157217,420,3,61,11,6,3,1,4,3,0,3,1,2,3,4,1,5,-5,5,0,0,5,-4,0,-4,4,3,0,-1,-1,1,1,-1,4,-1
KR_6673957959,420,-2,2,5,-2,-1,2,1,1,1,2,-5,6,1,5,0,5,-2,3,1,1,11,-91,-2,-5,7,1,0,-1,1,-1,-1,1,6,-1
KR_6506730641,420,-6,-118,-26,-16,0,2,2,-2,4,2,-10,10,0,-3,4,1,-1,2,1,-1,-26,-7,-4,-4,8,0,0,-4,1,-1,-1,-1,1,-1
KR_6767751814,420,-3,37,-1,-10,-2,2,0,-6,6,0,-3,3,0,4,4,8,-3,3,0,0,-19,-5,-6,-3,9,4,0,1,1,-1,1,-1,5,-1
KR_6720991777,420,0,-20,6,-5,-1,3,2,0,1,1,-1,2,1,-2,4,2,-1,1,0,0,0,-31,0,-3,3,2,0,-1,-1,-1,-1,1,5,-1
KR_6753827589,420,2,7,-23,11,2,0,2,2,5,7,2,0,2,2,5,7,3,0,3,0,22,-18,-1,-4,5,13,0,0,-1,1,1,1,3,-1
KR_6679659172,420,-2,-8,-42,-5,-1,3,2,-7,7,0,2,1,3,5,1,6,-4,5,1,0,-6,-31,2,-5,3,3,0,0,-1,-1,-1,-1,2,-1
KR_6644826797,420,-1,-18,5,-4,-1,2,1,-1,4,3,0,2,2,-3,5,2,1,1,2,0,-2,-1,-7,-5,12,1,0,1,-1,-1,1,1,6,-1
KR_6671288723,420,-3,-60,-11,-7,-3,3,0,-3,4,1,-2,3,1,0,2,2,1,0,1,0,-6,-16,-2,-4,6,-4,0,-1,-1,-1,-1,-1,2,-1
KR_6616114989,420,-2,-42,-8,-3,1,1,2,1,0,1,0,1,1,-8,8,0,3,0,3,0,-2,7,0,-7,7,-9,0,1,-1,1,1,-1,2,-1
KR_6692649851,420,0,0,-24,4,3,0,3,-1,4,3,0,2,2,-1,4,3,3,0,3,0,3,1,-1,-8,9,6,0,0,-1,1,1,1,3,-1
KR_6764539923,440,0,2,11,-1,-3,3,0,0,0,0,2,1,3,1,1,2,-1,2,1,0,3,4,1,-6,5,0,0,0,1,-1,0,-1,1,-1
KR_6762652289,420,-1,0,27,-1,-1,2,1,2,4,6,-3,5,2,1,1,2,0,1,1,0,0,1,-1,-5,6,-1,0,0,0,0,0,-1,0,-1
KR_6766856253,420,1,38,8,-4,2,1,3,3,4,7,-2,4,2,-6,7,1,-1,3,2,1,-4,-3,-4,-4,8,3,0,1,0,-1,1,1,0,-1
KR_6627055272,420,-2,0,-7,-5,1,0,1,-1,3,2,-3,4,1,-2,4,2,0,0,0,0,-6,12,3,-7,4,-7,0,0,-1,-1,-1,1,2,-1
KR_6735138713,420,4,-1,23,7,3,1,4,0,3,3,-1,1,0,6,3,9,-1,2,1,0,4,-2,0,-3,3,7,0,1,1,1,1,-1,1,-1
KR_6719801924,420,-4,36,16,-12,-6,6,0,-1,3,2,-6,7,1,-1,2,1,2,0,2,0,-18,-25,-6,-3,9,5,0,-1,1,-1,-1,-1,6,-1
KR_6743434977,420,2,21,-30,4,4,0,4,0,3,3,-2,4,2,1,3,4,1,1,2,0,3,2,5,-6,1,0,0,0,1,1,0,-1,5,-1
KR_6754925117,420,-2,25,-41,-3,-6,6,0,0,1,1,0,1,1,2,1,3,1,1,2,2,0,1,0,-6,6,3,0,0,1,-1,1,1,5,-1
KR_6767249434,420,1,21,1,3,-2,3,1,0,2,2,2,0,2,2,1,3,1,0,1,0,5,9,5,-9,4,-1,0,0,1,1,1,1,4,-1
KR_6723135981,420,0,-19,9,-3,-2,3,1,-2,4,2,0,1,1,0,3,3,1,2,3,0,-6,-1,0,-9,9,1,0,-1,-1,-1,-1,-1,2,-1
KR_6766794545,420,-2,-63,-4,1,-1,3,2,4,2,6,5,1,6,-6,6,0,-1,2,1,-1,-4,5,-1,-4,5,-3,0,-1,-1,1,-1,-1,1,-1
KR_6764007045,420,-5,-56,-38,-8,0,0,0,4,0,4,-2,6,4,-7,10,3,-3,4,1,0,-2,-15,4,-10,6,-3,0,-1,-1,-1,-1,-1,2,-1
KR_6768819157,420,-2,0,-24,-5,-2,4,2,1,0,1,2,2,4,-1,2,1,-5,5,0,0,2,0,1,-5,4,-5,0,1,-1,1,1,1,4,-1
KR_6758824056,440,-3,-43,-3,-8,0,0,0,-8,9,1,-3,5,2,4,2,6,-1,2,1,-2,-12,0,-1,-2,3,2,0,1,-1,-1,-1,-1,5,-1
KR_6768907864,420,-4,-50,-41,-10,-1,3,2,0,2,2,-2,3,1,-3,3,0,-4,4,0,0,-14,-5,-2,-6,8,1,0,0,-1,1,-1,-1,4,-1
KR_6761859306,440,-2,18,-2,-8,3,3,6,-3,3,0,2,1,3,-1,2,1,-9,10,1,0,-12,7,3,-9,6,-5,0,0,-1,-1,1,-1,1,-1
KR_6766475530,420,-3,-39,4,-9,-7,8,1,-2,4,2,1,1,2,-2,2,0,1,3,4,0,-7,9,-1,-6,7,-2,0,-1,1,-1,-1,-1,1,-1
KR_6729141543,420,-2,-47,24,-10,1,1,2,-5,9,4,-5,8,3,-1,2,1,0,1,1,1,-6,-162,3,-10,7,-3,0,-1,-1,-1,-1,-1,4,-1
KR_6765418969,420,-1,-85,20,1,-1,1,0,-1,1,0,0,0,0,3,1,4,0,2,2,0,3,-24,-5,-2,7,-3,0,-1,1,-1,-1,1,5,-1
KR_6768329895,440,0,-69,18,6,2,1,3,0,1,1,5,2,7,-1,4,3,0,1,1,0,13,-2,7,-9,2,3,0,0,-1,1,0,-1,4,-1
KR_6662318934,420,-1,-77,-1,5,1,1,2,1,3,4,4,2,6,1,2,3,-2,4,2,0,3,30,-2,-5,7,4,0,-1,0,1,1,-1,0,-1
KR_6736161731,420,-3,-72,-26,-2,-5,6,1,-1,2,1,1,1,2,2,4,6,1,0,1,0,1,10,1,-4,3,-1,0,-3,1,-1,-1,-1,5,-1
KR_6727439519,420,-1,-11,31,-3,2,0,2,1,2,3,-2,3,1,-1,2,1,-3,4,1,0,-8,115,-4,-3,7,1,0,1,-1,1,1,-1,1,-1
KR_6756616352,420,1,28,-2,3,0,3,3,0,1,1,5,2,7,-2,3,1,0,1,1,0,-2,15,-5,-2,7,5,0,0,1,-1,-1,1,3,-1
KR_6726408552,420,-2,-73,13,-5,-1,2,1,-2,3,1,2,1,3,-2,2,0,-2,2,0,0,-9,-3,0,-5,5,0,0,0,-1,-1,-1,-1,6,-1
KR_6729046044,420,-1,-31,-48,-9,0,2,2,-4,6,2,-9,9,0,5,0,5,-1,1,0,0,-4,-40,-3,-5,8,-4,0,0,-1,1,0,1,6,-1
KR_6768071432,420,-1,-12,-3,-10,0,2,2,-5,5,0,-3,5,2,-2,2,0,0,1,1,-1,-15,1,0,-8,8,-8,0,-2,-1,-1,-1,-1,4,-1
KR_6765094431,420,-3,-63,-5,-3,-1,2,1,-2,3,1,0,0,0,0,0,0,0,0,0,0,2,48,1,-7,6,-15,0,0,1,1,0,-1,3,-1
KR_6738853469,420,-1,-8,-3,-8,-5,5,0,-6,8,2,0,0,0,5,1,6,-2,2,0,0,-12,8,-1,-2,3,-2,0,1,1,-1,1,-1,3,-1
KR_6765926684,420,-3,-4,-11,-4,2,0,2,-5,8,3,-1,2,1,-1,3,2,1,0,1,1,-3,-6,7,-8,1,-2,0,-1,-1,-1,-1,1,4,-1
KR_6692763481,420,-2,-64,-2,-9,-8,8,0,2,2,4,-2,3,1,0,3,3,-1,1,0,0,-8,105,4,-5,1,-1,0,-1,1,-1,-1,-1,6,-1
KR_6654103622,420,-3,-73,-17,-10,-5,5,0,-3,4,1,-1,3,2,1,3,4,-2,3,1,0,-6,3,0,-8,8,1,0,-2,-1,-1,-1,-1,3,-1
KR_6767429936,420,-2,-5,-26,-4,1,1,2,-3,4,1,-2,3,1,0,1,1,0,1,1,0,-4,0,0,-7,7,6,0,0,-1,-1,0,1,1,-1
KR_6745121676,420,0,-96,10,-5,-1,2,1,-3,4,1,-2,5,3,1,1,2,0,2,2,0,4,-48,-4,-5,9,16,0,0,-1,1,-1,-1,2,-1
KR_6758129659,440,-4,-92,-20,-3,-4,6,2,4,0,4,1,3,4,-4,4,0,0,1,1,0,6,-15,-1,-6,7,-2,0,1,-1,0,-1,-1,4,-1
KR_6742372527,420,4,56,34,2,0,1,1,0,5,5,0,3,3,0,5,5,2,0,2,3,3,-64,-6,-1,7,6,0,1,1,-1,1,1,6,-1
KR_6764892156,420,1,9,-1,-1,0,1,1,1,1,2,-1,4,3,0,4,4,-1,2,1,0,-8,-129,-4,-5,9,3,0,-1,1,-1,-1,-1,6,-1
KR_6767683388,420,2,19,23,13,2,1,3,5,0,5,2,6,8,4,1,5,0,2,2,1,11,-121,4,-10,6,1,0,1,1,1,1,1,1,-1
KR_6745881261,420,-4,-33,-35,-11,-4,5,1,-2,5,3,-1,2,1,-1,4,3,-3,4,1,-2,-16,-4,3,-7,4,-4,0,0,0,-1,0,-1,0,-1
KR_6728847163,420,-4,-43,-29,-7,4,2,6,-5,6,1,-5,6,1,-2,3,1,1,1,2,0,1,99,-2,-6,8,1,0,0,1,-1,0,-1,3,-1
KR_6766701588,420,-1,-50,-24,3,8,0,8,-2,4,2,3,0,3,-4,4,0,-2,2,0,1,-1,10,5,-10,5,-6,0,1,-1,1,1,1,4,-1
KR_6751427973,420,-3,-71,-20,-7,-3,4,1,-2,5,3,1,0,1,-1,1,0,-2,2,0,0,-7,-14,2,-9,7,3,0,-2,-1,-1,-1,1,4,-1
KR_6750279658,420,-4,-12,-27,-15,0,1,1,-11,12,1,0,1,1,-3,5,2,-1,2,1,0,-22,-23,0,-5,5,-1,0,-1,-1,-1,-1,-1,2,-1
KR_6695408834,420,-6,-79,-19,-10,-3,4,1,0,3,3,-4,5,1,1,2,3,-4,5,1,-1,-4,3,-7,-4,11,-1,0,-1,-1,1,-1,-1,3,-1
KR_6767579617,420,-1,-49,-8,-4,-3,5,2,-1,5,4,1,2,3,1,2,3,-2,4,2,0,1,-2,0,-4,4,-1,0,0,-1,1,0,-1,6,-1
KR_6718981722,420,-3,-107,20,-5,0,3,3,-1,7,6,-6,6,0,4,1,5,-2,2,0,0,-1,-4,-3,-4,7,4,0,-2,-1,1,-1,-1,2,-1
KR_6768705309,420,-2,-10,0,-6,-2,3,1,2,3,5,-3,5,2,-3,3,0,0,2,2,0,-8,28,-1,-6,7,3,0,-1,-1,-1,-1,-1,4,-1
KR_6755767077,420,-3,-56,-24,-1,-2,2,0,2,2,4,-3,3,0,2,3,5,0,2,2,0,5,35,10,-11,1,-4,0,0,1,-1,0,-1,3,-1
KR_6692907248,440,-4,38,-4,-13,-3,4,1,-4,7,3,2,0,2,-7,9,2,-1,1,0,0,-20,-4,-1,-8,9,-1,0,1,1,1,1,1,2,-1
KR_6730655755,420,-1,-41,0,-4,-2,3,1,1,1,2,-1,2,1,-2,2,0,0,0,0,0,-6,113,3,-6,3,5,0,0,-1,1,0,-1,5,-1
KR_6745365826,420,-1,-28,-9,-6,-1,2,1,-7,9,2,1,1,2,2,3,5,-1,1,0,0,-2,30,0,-5,5,-4,0,0,-1,-1,0,1,4,-1
KR_6768290850,420,-2,-27,-1,-6,-4,5,1,-3,3,0,0,0,0,0,1,1,1,0,1,-1,-8,6,5,-9,4,1,0,-1,1,-1,-1,-1,4,-1
KR_6710740951,420,-3,-45,4,-1,-3,4,1,-4,8,4,5,1,6,0,1,1,1,0,1,1,4,5,4,-8,4,-2,0,-1,-1,-1,-1,1,3,-1
KR_6758948388,440,0,-34,29,0,1,2,3,-1,2,1,-1,5,4,-1,4,3,2,1,3,2,-2,-9,-3,-4,7,0,0,0,1,-1,1,1,3,-1
KR_6765829678,440,5,-44,-5,12,2,2,4,1,3,4,0,2,2,7,0,7,2,2,4,1,20,4,3,-8,5,-6,0,0,-1,1,1,1,3,-1
KR_6757746214,420,-2,17,-24,-1,5,1,6,-3,3,0,-1,2,1,-3,3,0,1,1,2,1,-6,22,-4,-5,9,-6,0,0,-1,-1,0,1,4,-1
KR_6754737945,420,-1,-11,-3,-2,0,3,3,-4,4,0,3,0,3,1,2,3,-2,2,0,1,-6,6,-3,-6,9,2,0,0,0,1,1,1,0,-1
KR_6743145287,420,-4,-18,-29,1,1,3,4,0,1,1,3,2,5,-5,6,1,2,0,2,0,4,-70,-1,-5,6,2,0,0,0,1,1,-1,0,-1
KR_6764941256,420,-2,-50,-8,-7,2,2,4,0,1,1,1,2,3,-5,5,0,-5,7,2,0,-6,111,1,-7,6,1,0,-1,-1,-1,-1,-1,4,-1
KR_6762827292,420,0,-26,-15,-6,2,2,4,-1,4,3,-2,4,2,-3,6,3,-2,3,1,0,-9,2,5,-8,3,-5,0,0,1,-1,-1,-1,2,-1
KR_6749278315,420,-4,-26,-32,-12,0,1,1,1,5,6,-17,17,0,5,0,5,-1,2,1,0,-4,280,5,-12,7,-5,0,-1,-1,1,-1,1,2,-1
KR_6731359036,420,-1,33,16,-2,1,2,3,2,5,7,-1,2,1,-3,3,0,-1,1,0,0,0,1,-1,-6,7,3,0,0,1,1,0,1,3,-1
KR_6724243078,420,-3,-28,4,-10,-2,3,1,-5,6,1,-2,3,1,1,1,2,-2,2,0,0,-8,-271,-1,-2,3,-1,0,-2,-1,-1,-1,1,4,-1
KR_6762089745,420,0,-34,-19,5,0,0,0,1,1,2,-2,3,1,6,0,6,0,1,1,0,8,8,4,-10,6,-3,0,-1,-1,-1,-1,1,3,-1
KR_6750254052,420,-2,1,0,-10,-3,4,1,0,1,1,-5,6,1,-3,7,4,1,0,1,0,-3,2,-1,-5,6,-1,0,-1,-1,-1,-1,-1,6,-1
KR_6696450990,420,1,23,-6,1,2,0,2,1,1,2,2,1,3,-4,5,1,0,0,0,0,-3,-1,4,-9,5,0,0,0,1,-1,0,-1,3,-1
KR_6695934113,420,-5,-12,-20,-7,-2,2,0,2,2,4,-1,3,2,-5,5,0,-1,1,0,-1,-12,2,-2,-5,7,-1,0,0,-1,1,1,-1,5,-1
KR_6675465003,420,0,-17,43,-4,-4,5,1,5,1,6,1,2,3,-4,5,1,-2,2,0,0,-5,42,-2,-4,6,0,0,-1,1,1,-1,-1,2,-1
KR_6519102978,420,0,45,-41,1,2,1,3,-4,5,1,0,1,1,3,3,6,0,0,0,-1,0,-4,3,-7,4,-1,0,1,-1,-1,-1,-1,2,-1
KR_6745000939,420,0,-1,36,-2,-5,5,0,1,1,2,-1,2,1,2,1,3,1,1,2,1,0,35,-3,-4,7,2,0,-1,-1,1,-1,1,6,-1
KR_6768779899,420,3,62,16,8,-2,3,1,0,3,3,7,1,8,3,2,5,0,3,3,-1,0,12,2,-9,7,3,0,1,0,1,1,-1,0,-1
KR_6754958197,420,-1,-12,16,6,1,1,2,0,2,2,0,3,3,4,0,4,1,0,1,0,11,20,1,-4,3,0,0,0,-1,-1,-1,1,2,-1
KR_6761017689,420,-3,-12,16,-5,-2,2,0,0,3,3,-2,4,2,-1,2,1,0,0,0,0,-5,-25,-2,-7,9,-2,0,-1,1,1,-1,-1,6,-1
KR_6755470952,420,-2,-41,-32,-5,1,0,1,-4,6,2,-2,4,2,2,0,2,-2,2,0,0,-10,-8,3,-6,3,-6,0,0,-1,-1,0,1,4,-1
KR_6749071437,420,0,-22,-5,4,0,3,3,-1,4,3,5,0,5,0,3,3,0,0,0,1,11,1,0,-5,5,1,0,0,1,1,0,1,5,-1
KR_6764590316,420,1,27,-19,3,6,0,6,-4,6,2,2,0,2,-4,6,2,3,1,4,0,-7,12,1,-6,5,-1,0,0,0,0,0,1,0,-1
KR_6693585839,420,3,-7,-11,1,2,4,6,3,2,5,4,1,5,-2,3,1,-6,6,0,-1,-1,-18,0,-4,4,0,0,-1,-1,-1,-1,-1,5,-1
KR_6765427468,420,-3,-56,0,-10,0,0,0,5,0,5,-1,1,0,-9,9,0,-5,6,1,0,-17,85,-4,-2,6,-1,0,-1,-1,1,-1,-1,1,-1
KR_6739974128,420,-3,-41,17,-7,-3,4,1,1,3,4,-1,3,2,-2,3,1,-2,2,0,-1,-5,45,1,-6,5,-22,0,0,-1,1,1,-1,6,-1
KR_6699793322,420,0,-57,-35,4,4,1,5,0,1,1,-1,3,2,0,4,4,1,1,2,0,4,-1,1,-4,3,-6,0,2,-1,1,1,-1,5,-1
KR_6613316770,420,-5,-93,-20,-15,-8,8,0,-1,1,0,-1,2,1,-5,5,0,0,1,1,0,-13,-9,-3,-4,7,0,0,-1,-1,-1,-1,-1,1,-1
KR_6769150265,420,-3,-38,8,-17,-3,4,1,-3,5,2,-4,7,3,-6,8,2,-1,1,0,0,-19,-1,0,-4,4,0,0,-2,-1,-1,-1,-1,1,-1
KR_6759450060,440,0,20,24,-4,-5,5,0,0,1,1,-1,1,0,0,2,2,2,0,2,0,-1,42,1,-6,5,-4,0,1,1,1,1,1,4,-1
KR_6763796842,420,-2,-64,36,0,0,4,4,3,1,4,1,1,2,-4,4,0,0,0,0,-1,-3,31,4,-6,2,-2,0,0,1,1,0,-1,2,-1
KR_6761949815,420,0,-9,-3,2,6,1,7,-2,3,1,-3,4,1,6,0,6,-5,5,0,1,-5,-198,-3,-1,4,2,0,3,0,1,1,1,0,-1
KR_6767174850,420,-1,8,-1,-9,1,2,3,-4,4,0,0,3,3,-6,9,3,0,0,0,-4,-12,29,-2,-5,7,0,0,-1,-1,0,-1,-1,1,-1
KR_6658165025,420,-2,14,-15,-6,-1,2,1,1,5,6,-3,4,1,-1,3,2,-2,2,0,1,-6,-6,-1,-7,8,-3,0,-3,-1,-1,-1,1,1,-1
KR_6760576024,420,-2,-36,6,-5,0,1,1,1,3,4,-2,5,3,-5,8,3,1,0,1,0,-10,4,0,-6,6,-3,0,-1,-1,1,-1,1,2,-1
KR_6758200034,420,-1,-29,6,-4,0,2,2,-4,5,1,-1,3,2,0,3,3,1,0,1,0,-3,0,-4,-4,8,-6,0,0,0,-1,0,1,0,-1
KR_6672068621,420,0,-41,-8,2,0,2,2,-1,4,3,-5,5,0,8,0,8,0,1,1,0,8,2,4,-8,4,0,0,0,1,-1,-1,1,1,-1
KR_6742257504,420,1,6,0,3,0,1,1,3,0,3,4,0,4,-4,7,3,0,0,0,0,0,4,-1,-5,6,-3,0,0,-1,-1,-1,-1,2,-1
KR_6766937800,420,-3,-57,0,-4,1,0,1,-1,2,1,0,0,0,-5,5,0,1,2,3,0,-7,70,-1,-3,4,1,0,1,1,1,1,1,6,-1
KR_6598674881,420,-5,-31,16,-14,-1,4,3,-3,5,2,-2,3,1,-8,9,1,0,0,0,0,-16,0,-5,-5,10,2,0,-2,-1,-1,-1,-1,4,-1
KR_6760623312,420,-1,-14,-20,-4,0,2,2,2,2,4,0,1,1,-4,5,1,-2,2,0,0,-11,2,1,-6,5,-3,0,-1,-1,0,-1,1,6,-1
KR_6761796067,420,-5,-78,32,-7,-5,5,0,-1,3,2,0,2,2,-4,6,2,3,0,3,0,-5,-8,-3,-6,9,6,0,-2,-1,-1,-1,-1,5,-1
KR_6765161843,420,-4,-33,-4,-5,-6,7,1,1,1,2,-3,4,1,4,1,5,-1,2,1,0,-3,24,0,-7,7,-6,0,-1,1,-1,-1,-1,2,-1
KR_6765397159,420,-2,-11,-17,-3,0,0,0,-1,3,2,-1,2,1,0,1,1,-1,2,1,0,-5,-1,-6,-3,9,-4,0,-1,-1,-1,-1,1,2,-1
KR_6655143303,420,-6,-60,-25,-14,-2,3,1,-1,4,3,-10,10,0,0,1,1,-1,1,0,0,-10,77,-7,-3,10,3,0,-2,-1,-1,-1,-1,5,-1
KR_6635206661,420,-2,13,-3,-3,-5,5,0,0,3,3,-1,3,2,2,4,6,1,0,1,1,-5,-4,2,-8,6,0,0,-1,-1,-1,-1,1,1,-1
KR_6737382481,420,0,2,-11,2,-1,2,1,4,1,5,2,1,3,-2,4,2,-1,3,2,0,4,-16,3,-12,9,1,0,0,-1,1,1,-1,4,-1
KR_6765826773,440,-1,5,-4,-6,-1,3,2,0,2,2,-1,5,4,0,0,0,-4,4,0,0,0,2,-1,-2,3,-1,0,1,1,-1,-1,-1,3,-1
KR_6756484187,420,-3,-19,-36,0,1,2,3,-2,3,1,-1,4,3,2,0,2,0,0,0,0,0,-12,-1,-6,7,1,0,1,-1,1,1,1,1,-1
KR_6767850578,420,-3,-18,8,-1,3,1,4,1,3,4,-3,4,1,-2,2,0,0,2,2,0,-1,-1,-4,-6,10,4,0,0,-1,1,1,1,5,-1
KR_6311999075,420,-1,35,-11,0,-4,5,1,3,1,4,1,2,3,1,0,1,-1,1,0,1,4,-13,-1,-8,9,4,0,-1,1,-1,-1,1,3,-1
KR_6769192529,420,-2,-112,-19,-1,1,2,3,0,3,3,1,2,3,-3,4,1,0,0,0,0,3,25,-1,-5,6,-2,0,-1,-1,-1,-1,-1,4,-1
KR_6753828760,420,2,3,4,9,2,0,2,-1,3,2,2,2,4,0,2,2,6,0,6,0,10,3,-1,-7,8,1,0,2,-1,1,1,1,4,-1
KR_6765246203,420,-4,-80,4,-7,-3,3,0,-3,3,0,-3,5,2,-3,4,1,5,0,5,0,-9,-20,-4,-4,8,0,0,-3,-1,-1,-1,-1,4,-1
KR_6689921771,420,-2,-58,-22,-7,-1,2,1,-5,8,3,-2,3,1,1,2,3,0,0,0,-1,-3,10,0,-8,8,-10,0,-1,-1,-1,-1,-1,1,-1
KR_6766109100,420,0,-3,56,0,-3,5,2,-2,5,3,1,2,3,4,2,6,0,1,1,0,0,10,-1,-5,6,0,0,1,1,-1,1,1,5,-1
KR_6768797882,420,-2,10,-29,-6,-4,5,1,3,1,4,3,1,4,-7,9,2,-1,2,1,0,-1,-13,1,-6,5,3,0,-1,-1,1,1,-1,6,-1
KR_6739851445,420,0,-14,20,-3,-6,7,1,3,3,6,3,1,4,-1,4,3,-2,4,2,1,-2,17,3,-8,5,-10,0,0,1,1,0,1,4,-1
KR_6645597117,420,0,-2,-12,4,2,2,4,1,8,9,-2,4,2,2,2,4,1,0,1,0,2,-4,-1,-9,10,0,0,1,1,1,1,1,3,-1
KR_6755300921,420,-4,-43,12,-8,-2,3,1,-4,4,0,-1,3,2,-1,2,1,0,2,2,0,-9,-42,-2,-3,5,0,0,0,-1,0,0,-1,4,-1
KR_6730949263,420,-4,-17,-24,-6,0,1,1,-1,2,1,0,0,0,-3,3,0,-2,2,0,0,-7,19,1,-3,2,1,0,-2,-1,-1,-1,-1,1,-1
KR_6766630652,440,-3,17,20,-9,-1,3,2,-4,6,2,-2,2,0,0,4,4,-2,3,1,0,-4,-49,-1,-2,3,27,0,0,1,1,0,1,1,-1
KR_6695655557,420,-1,-28,-23,0,1,1,2,1,2,3,4,0,4,-4,5,1,-2,2,0,1,6,-8,-5,-2,7,7,0,-2,-1,-1,-1,1,1,-1
KR_6757950313,440,-4,77,24,-10,2,1,3,1,0,1,-7,9,2,-6,6,0,0,2,2,0,-19,-38,-7,-1,8,-8,0,-1,0,0,-1,-1,0,-1
KR_6749641022,420,0,12,4,-5,6,1,7,-3,4,1,-5,5,0,-2,2,0,-1,1,0,0,-9,4,-7,-2,9,4,0,2,-1,1,1,-1,1,-1
KR_6738865575,420,1,-12,4,-1,-1,3,2,0,1,1,0,4,4,0,3,3,0,1,1,0,-1,-1,-2,-5,7,-5,0,0,-1,1,0,-1,5,-1
KR_6734172937,440,1,49,0,2,0,0,0,-2,3,1,4,3,7,-1,1,0,1,0,1,0,1,3,-2,-5,7,-1,0,0,-1,-1,0,1,5,-1
KR_6762103770,420,0,15,4,9,7,0,7,-2,6,4,3,2,5,0,2,2,1,1,2,0,6,286,2,-6,4,2,0,2,-1,1,1,1,6,-1
KR_6764872142,420,-2,-20,-2,-1,-1,2,1,2,3,5,-1,2,1,-3,3,0,2,1,3,0,-6,3,3,-7,4,0,0,0,0,1,1,1,0,-1
KR_6649576866,420,-1,-45,20,-8,-2,3,1,-1,4,3,-3,3,0,-2,5,3,0,0,0,-1,-10,-3,-3,-4,7,6,0,-1,-1,1,-1,-1,3,-1
KR_6745543059,420,-1,29,-20,0,-5,5,0,-1,2,1,0,3,3,7,0,7,-1,3,2,0,13,-5,-5,-3,8,0,0,0,-1,-1,1,1,4,-1
KR_6764027861,440,2,42,-1,8,3,3,6,7,0,7,-2,3,1,1,2,3,-1,1,0,1,6,-2,0,-4,4,1,0,1,1,-1,1,1,5,-1
KR_6714671596,420,-4,-47,0,-11,-2,3,1,-3,6,3,-3,3,0,-3,6,3,0,1,1,0,-9,-202,-3,-2,5,-2,0,-1,1,1,-1,-1,3,-1
KR_6762610487,440,4,78,56,0,4,0,4,-8,8,0,2,1,3,1,2,3,1,3,4,1,-4,33,-3,-1,4,-28,0,1,1,-1,1,1,6,-1
KR_6624061561,440,-2,58,-5,-5,-2,2,0,-3,4,1,-3,5,2,3,1,4,0,0,0,0,-7,-4,-5,-6,11,0,0,0,1,-1,0,1,3,-1
KR_6680580907,420,-3,-33,-12,-6,2,0,2,-3,5,2,-3,3,0,-3,4,1,1,2,3,-1,-8,-6,-1,-6,7,1,0,0,-1,1,-1,-1,6,-1
KR_6764592360,420,0,-25,0,-5,1,1,2,-1,2,1,-1,2,1,-5,8,3,1,0,1,1,-8,180,2,-7,5,1,0,1,-1,1,1,1,6,-1
KR_6728864218,420,1,35,0,3,-1,1,0,6,4,10,-1,3,2,0,3,3,-1,1,0,0,1,-39,-1,-7,8,-1,0,1,1,-1,1,1,2,-1
KR_6741299741,420,-5,-59,-24,-9,1,1,2,-3,4,1,2,0,2,-5,6,1,-4,4,0,0,-16,-1,-2,-3,5,-2,0,-2,-1,1,-1,1,1,-1
KR_6762126876,420,-1,-18,-15,-1,3,2,5,-2,3,1,-2,2,0,1,1,2,-1,2,1,0,-6,-2,3,-5,2,3,0,0,-1,-1,0,-1,6,-1
KR_6707367622,420,-1,1,17,-2,3,1,4,-2,4,2,0,4,4,-2,6,4,-1,2,1,-2,-7,-2,-1,-5,6,2,0,0,-1,1,-1,-1,3,-1
KR_6722669200,420,-4,-46,-27,-6,-3,3,0,1,3,4,-1,4,3,-2,3,1,-1,1,0,-1,0,-5,2,-5,3,-1,0,0,-1,1,-1,-1,1,-1
KR_6652536102,420,-7,-86,-20,-17,-7,7,0,-2,5,3,1,1,2,-6,6,0,-3,3,0,-1,-17,-28,-1,-8,9,-3,0,0,-1,1,0,-1,1,-1
KR_6767075005,420,-1,-48,20,0,0,2,2,2,1,3,5,0,5,-6,7,1,-1,1,0,0,7,18,-2,-5,7,1,0,-2,1,-1,-1,-1,3,-1
KR_6764937629,420,-1,8,26,-6,-1,2,1,-2,6,4,2,1,3,-5,8,3,0,0,0,0,-9,-180,-2,-2,4,-4,0,-1,1,-1,-1,-1,5,-1
KR_6757355282,420,2,39,-10,2,0,1,1,-1,3,2,1,0,1,2,1,3,0,0,0,0,10,6,1,-7,6,-1,0,-1,1,-1,-1,-1,6,-1
KR_6764336626,420,-1,-20,0,-1,-2,3,1,0,2,2,-1,1,0,3,3,6,-1,1,0,0,2,-14,0,-5,5,1,0,0,-1,1,0,1,3,-1
KR_6719644985,420,-1,-9,-15,-3,0,2,2,-1,5,4,-3,5,2,4,0,4,-3,4,1,0,3,-6,0,-6,6,-1,0,0,1,-1,-1,-1,5,-1
KR_6763899432,420,-2,-51,-5,-2,-3,3,0,6,3,9,-2,4,2,-4,7,3,1,3,4,3,11,-129,3,-9,6,-2,0,-1,-1,-1,-1,1,6,-1
KR_6707457797,420,-4,-61,8,-8,0,2,2,-2,2,0,-5,7,2,1,1,2,-2,2,0,0,-20,6,-1,-5,6,-4,0,-1,1,1,1,-1,3,-1
KR_6690909769,420,-4,-55,-43,-5,-4,5,1,3,3,6,-3,4,1,-1,2,1,0,0,0,1,-7,-8,-5,-2,7,-2,0,0,-1,-1,-1,1,3,-1
KR_6769140103,420,-3,-46,-33,-10,1,2,3,-2,2,0,-8,8,0,-1,3,2,0,1,1,0,-11,-35,-6,-4,10,0,0,-1,1,-1,-1,1,1,-1
KR_6741423950,420,-2,-52,-21,-2,-3,5,2,1,1,2,3,1,4,-2,4,2,-1,1,0,0,-2,1,2,-7,5,-3,0,-1,1,-1,-1,1,3,-1
KR_6726946216,420,-2,-20,-13,-2,-2,3,1,-9,10,1,2,2,4,6,1,7,1,0,1,0,-2,-16,0,-5,5,-1,0,-1,1,-1,-1,-1,4,-1
KR_6767344408,420,-2,-75,-8,-3,3,4,7,0,2,2,-1,2,1,-5,9,4,0,0,0,0,-5,-11,-1,-8,9,-1,0,-1,-1,1,1,1,1,-1
KR_6768896735,420,3,53,12,3,4,0,4,-1,4,3,-1,2,1,0,2,2,1,0,1,0,1,-75,-1,-3,4,27,0,3,-1,1,1,1,3,-1
KR_6659188457,420,-3,-19,-10,-10,1,1,2,-4,5,1,-1,2,1,-6,8,2,0,3,3,0,-24,-25,-2,-6,8,0,0,-1,-1,1,-1,1,6,-1
KR_6672364167,420,-2,7,-11,-2,-5,6,1,1,2,3,2,3,5,1,5,6,-1,4,3,-2,-2,-7,-8,-3,11,7,0,0,-1,-1,0,-1,2,-1
KR_6766903086,420,2,16,4,-1,2,1,3,1,5,6,-3,3,0,-3,4,1,2,0,2,1,-2,-17,6,-9,3,-5,0,0,1,-1,0,1,3,-1
KR_6764957110,420,-4,12,-20,-9,-2,3,1,-6,6,0,2,1,3,-3,3,0,0,0,0,0,-16,-15,-1,-4,5,-6,0,-2,-1,-1,-1,-1,5,-1
KR_6762738842,420,-7,-158,-16,-10,-1,1,0,-2,3,1,2,2,4,-8,8,0,-1,1,0,-1,-15,-11,-6,0,6,2,0,-1,-1,-1,-1,-1,4,-1
KR_6710919721,420,-4,-69,-4,-13,-4,5,1,-3,6,3,1,1,2,-5,5,0,-2,2,0,0,-6,-1,-2,-4,6,-3,0,0,-1,-1,-1,-1,6,-1
KR_6707161327,420,-6,-21,-8,-12,3,1,4,-3,7,4,-1,5,4,-10,15,5,-1,2,1,1,-21,-6,-4,-4,8,-2,0,-2,-1,-1,-1,-1,1,-1
KR_6738571643,440,-1,-84,20,-1,-5,5,0,4,0,4,-2,4,2,1,3,4,1,1,2,0,1,6,4,-7,3,-6,0,-1,1,-1,-1,1,6,-1
KR_6699691523,420,-3,-110,-20,-5,1,0,1,-2,2,0,3,1,4,-6,7,1,-1,3,2,0,-1,65,1,-5,4,0,0,-2,-1,1,-1,1,1,-1
KR_6678992684,420,1,-21,31,0,0,1,1,0,3,3,-2,3,1,2,3,5,0,2,2,0,3,-1,-3,-6,9,1,0,0,-1,1,0,-1,5,-1
KR_6709425968,420,1,-22,16,-2,1,1,2,-1,4,3,0,1,1,-1,2,1,-1,1,0,1,-7,7,1,-5,4,0,0,0,-1,-1,0,1,4,-1
KR_6687180952,420,-4,-74,-31,-12,-2,2,0,-3,5,2,-4,4,0,-4,5,1,1,0,1,-3,-13,-2,-2,-2,4,3,0,-1,-1,1,-1,-1,6,-1
KR_6760511723,420,-2,-21,-7,-1,2,0,2,-1,3,2,1,0,1,-2,5,3,-1,2,1,0,-7,2,1,-7,6,-5,0,-1,1,1,-1,1,4,-1
KR_6685204072,420,-1,-33,16,-7,1,2,3,-2,6,4,-2,3,1,-4,7,3,0,1,1,0,-14,-8,-5,-6,11,-2,0,-2,-1,1,1,1,3,-1
KR_6337780031,420,-4,-4,-13,-8,-1,5,4,-10,11,1,1,1,2,3,1,4,-1,1,0,1,-5,-41,0,-7,7,-2,0,0,-1,-1,1,1,1,-1
KR_6767660263,420,-5,-53,1,-8,-5,5,0,-1,2,1,0,1,1,-2,5,3,0,1,1,-1,-9,-5,-7,-2,9,-7,0,-1,0,-1,-1,-1,0,-1
KR_6727725229,420,0,-41,-13,0,1,1,2,3,2,5,-1,2,1,-3,3,0,0,0,0,0,0,1,0,-3,3,-5,0,0,-1,-1,0,-1,5,-1
KR_6650080474,420,-4,-79,-7,-8,-1,1,0,-2,2,0,0,2,2,-5,6,1,0,1,1,0,-16,-41,0,-7,7,-4,0,-2,-1,1,-1,1,3,-1
KR_6761150386,420,4,26,14,4,3,0,3,0,1,1,0,5,5,1,0,1,0,1,1,0,-1,8,1,-5,4,-7,0,0,-1,-1,1,-1,5,-1
KR_6768710343,420,0,-50,12,-4,-8,8,0,-5,6,1,2,1,3,4,0,4,3,0,3,0,9,13,6,-9,3,0,0,-2,1,-1,-1,1,2,-1
KR_6765778336,420,2,-10,9,5,0,2,2,1,6,7,0,2,2,4,1,5,0,0,0,0,2,-5,-5,-4,9,1,0,1,0,-1,1,1,0,-1
KR_6765902758,420,0,-39,4,0,-1,2,1,-1,3,2,1,1,2,-1,1,0,2,0,2,0,5,-57,-1,-4,5,1,0,-3,-1,-1,-1,-1,2,-1
KR_6756761473,420,-4,-40,-16,-9,-2,2,0,-5,7,2,-2,4,2,-1,2,1,1,0,1,0,-8,-5,1,-7,6,5,0,-1,-1,-1,-1,-1,5,-1
KR_6757208263,420,-3,-11,-16,-3,2,0,2,-8,9,1,3,0,3,0,0,0,0,0,0,0,0,-1,1,-8,7,1,0,-1,1,-1,-1,-1,4,-1
KR_6759273463,420,0,-8,0,-6,-1,1,0,-2,3,1,-4,5,1,1,0,1,0,1,1,0,-6,3,1,-6,5,-3,0,0,1,-1,0,1,5,-1
KR_6611861327,420,-4,-85,-5,-19,-4,5,1,-8,9,1,-2,2,0,-3,4,1,-2,2,0,-1,-24,-3,-3,-3,6,-3,0,-2,-1,-1,-1,-1,2,-1
KR_6761387755,420,1,29,-6,1,0,0,0,0,1,1,0,1,1,1,0,1,0,0,0,0,1,32,3,-8,5,1,0,0,1,0,0,1,3,-1
KR_6725799828,420,-3,23,-8,-8,-2,2,0,-4,4,0,0,1,1,-3,5,2,1,0,1,0,-15,8,3,-7,4,-5,0,0,-1,-1,1,1,3,-1
KR_6760614573,420,0,-43,18,-6,-1,5,4,-2,3,1,0,2,2,-2,3,1,-1,2,1,-1,-8,30,2,-6,4,1,0,0,1,-1,0,-1,1,-1
KR_6597348618,420,-3,-69,-17,-12,-1,3,2,-1,4,3,-3,3,0,-6,9,3,-1,1,0,-1,-10,-6,-2,-3,5,-2,0,-2,-1,-1,-1,-1,4,-1
KR_6727683554,420,1,7,-14,0,-2,3,1,4,1,5,3,0,3,-5,7,2,0,0,0,0,-2,-26,2,-12,10,11,0,0,-1,1,0,-1,4,-1
KR_6764121274,420,-4,-62,-4,-9,-7,7,0,-5,6,1,-1,2,1,5,3,8,-1,1,0,0,-6,30,-5,-2,7,-10,0,0,-1,-1,0,1,4,-1
KR_6742176008,420,2,-6,16,1,-2,2,0,-1,4,3,0,4,4,3,2,5,1,0,1,0,4,14,-4,-4,8,1,0,0,0,1,1,-1,0,-1
KR_6764716843,420,0,73,0,-1,1,0,1,-1,3,2,-1,3,2,1,0,1,-1,3,2,0,0,-10,-1,-6,7,8,0,-1,1,-1,-1,-1,6,-1
KR_6707844678,440,1,-71,8,-1,-4,6,2,1,3,4,0,1,1,1,1,2,1,0,1,0,3,-8,-3,-5,8,4,0,0,-1,-1,-1,-1,3,-1
KR_6673047995,420,-1,-60,5,-7,-3,4,1,-3,4,1,1,4,5,0,1,1,-2,2,0,0,-7,7,-4,-5,9,-3,0,0,-1,-1,1,-1,5,-1
KR_6758740536,420,-5,-49,-5,-12,-8,8,0,2,1,3,-2,3,1,-1,2,1,-3,4,1,-1,-4,1,0,-6,6,-1,0,-2,-1,-1,-1,-1,5,-1
KR_6750520604,420,-1,-64,-16,-1,0,2,2,-2,3,1,-1,3,2,1,0,1,1,1,2,0,4,3,0,-4,4,-2,0,0,-1,-1,0,1,5,-1
KR_6760265761,420,0,24,-19,-4,0,0,0,3,0,3,0,2,2,-6,6,0,-1,1,0,-1,-1,13,-3,-7,10,1,0,0,-1,1,0,-1,4,-1
KR_6753065345,420,2,49,-10,3,3,0,3,3,1,4,-3,4,1,0,6,6,0,2,2,0,5,-119,-6,-6,12,2,0,1,1,1,1,1,2,-1
KR_6651759204,420,-5,-15,3,-9,2,1,3,-4,5,1,0,1,1,-8,10,2,1,0,1,0,-17,2,-1,-6,7,0,0,-1,-1,-1,-1,1,1,-1
KR_6754379621,420,-5,-30,-14,-13,2,0,2,-3,6,3,-3,5,2,-7,10,3,-2,2,0,-1,-21,338,-4,-4,8,0,0,-2,-1,-1,-1,-1,2,-1
KR_6740017485,420,-5,-5,-23,-12,-1,3,2,-3,4,1,1,3,4,-1,1,0,-8,10,2,0,-13,-98,-1,-6,7,-6,0,-1,-1,1,-1,-1,4,-1
KR_6614310600,420,-6,-64,-6,-4,-6,6,0,1,1,2,0,4,4,0,2,2,1,0,1,0,2,-6,-2,-5,7,-4,0,0,1,1,1,1,6,-1
KR_6735983735,420,-5,-3,-20,-11,-4,6,2,-5,5,0,-1,2,1,0,3,3,-1,4,3,0,-12,-9,-1,-5,6,1,0,-1,-1,1,-1,-1,5,-1
KR_6755611481,440,-4,-73,-8,-4,2,0,2,-5,5,0,-3,4,1,0,0,0,2,0,2,0,-6,-13,0,-6,6,-1,0,0,-1,1,0,1,2,-1
KR_6756014023,420,0,11,5,-6,-2,2,0,-2,8,6,0,0,0,0,1,1,-2,3,1,-2,-10,-26,-1,-7,8,5,0,0,-1,1,0,-1,4,-1
KR_6419973353,440,-2,-66,7,-1,0,2,2,2,2,4,-6,7,1,0,5,5,3,0,3,3,4,14,0,-6,6,-6,0,-1,1,-1,-1,1,1,-1
KR_6734683157,420,2,5,5,-1,-2,5,3,2,3,5,3,0,3,-3,5,2,-1,1,0,-1,-3,5,-1,-7,8,1,0,1,-1,-1,1,-1,5,-1
KR_6761533492,420,0,-10,-12,2,-2,3,1,1,2,3,-1,3,2,3,2,5,1,0,1,0,4,-2,-5,-4,9,5,0,-1,-1,1,-1,-1,3,-1
KR_6730128082,420,-1,-9,0,-6,2,1,3,-1,3,2,3,1,4,-7,7,0,-3,4,1,0,-11,-18,-3,-4,7,0,0,0,-1,1,1,-1,6,-1
KR_6718161235,420,-3,-53,27,-12,-4,5,1,-4,5,1,0,2,2,-2,6,4,-2,5,3,0,-13,11,1,-5,4,1,0,0,1,1,1,-1,4,-1
KR_6767159529,420,-2,-49,8,-3,-2,4,2,-1,4,3,2,2,4,-1,5,4,-1,1,0,0,0,18,-3,-3,6,-1,0,1,1,1,1,-1,6,-1
KR_6761348237,420,-5,-77,-19,-14,-2,2,0,0,2,2,-8,8,0,-3,6,3,-1,2,1,-1,-7,7,2,-5,3,-4,0,-2,-1,-1,-1,-1,5,-1
KR_6727640711,420,-6,-117,-41,-16,-9,9,0,-5,6,1,-1,1,0,-2,2,0,1,0,1,0,-7,192,-4,-3,7,4,0,-2,-1,-1,-1,1,5,-1
KR_6765362960,420,0,-20,8,0,1,1,2,-1,3,2,3,1,4,-4,7,3,1,1,2,-1,-2,4,-3,-4,7,-2,0,0,1,1,-1,-1,2,-1
KR_6758118917,420,-3,-63,-6,-5,-2,4,2,-1,3,2,-2,3,1,0,4,4,0,1,1,0,-6,5,-8,-4,12,0,0,-2,-1,-1,-1,-1,6,-1
KR_6766582898,420,-1,-11,22,-2,0,2,2,1,3,4,-2,4,2,0,1,1,-1,1,0,0,-7,2,2,-10,8,-4,0,0,1,-1,0,-1,4,-1
KR_6660668105,420,-1,-30,-27,-2,0,0,0,-6,8,2,-2,3,1,5,4,9,1,2,3,-3,1,8,1,-6,5,3,0,-1,0,-1,-1,-1,0,-1
KR_6761615427,420,-1,-3,-32,-1,0,3,3,0,1,1,-1,2,1,-2,2,0,2,0,2,0,3,-1,3,-8,5,0,0,-1,-1,-1,-1,-1,4,-1
KR_6763033073,420,-4,-18,16,-7,-1,3,2,4,1,5,-4,5,1,1,2,3,-7,7,0,1,-4,-5,-3,-7,10,1,0,-2,1,1,-1,1,2,-1
KR_6750071488,420,-4,-23,-56,1,-3,5,2,4,2,6,-1,3,2,0,3,3,1,1,2,1,3,13,2,-5,3,-2,0,0,-1,-1,-1,1,2,-1
KR_6744627540,440,-2,-69,8,-7,-2,4,2,-3,6,3,-3,5,2,-1,5,4,2,1,3,-1,-10,5,1,-6,5,-1,0,1,1,0,1,-1,2,-1
KR_6693257372,420,2,-10,-20,5,1,1,2,2,6,8,-2,6,4,1,2,3,3,0,3,0,13,-1,1,-10,9,0,0,-1,-1,-1,-1,1,1,-1
KR_6756900310,440,-6,-97,0,-19,-14,16,2,0,4,4,-6,7,1,-1,6,5,2,1,3,-1,-20,-6,1,-2,1,2,0,-1,1,-1,-1,-1,3,-1
KR_6727636995,440,1,-35,-24,7,-2,3,1,6,2,8,0,1,1,3,2,5,0,3,3,0,12,11,-4,-1,5,-1,0,-2,1,-1,-1,1,6,-1
KR_6753596821,420,-4,-32,-16,-8,-2,2,0,-4,4,0,2,2,4,-6,6,0,2,0,2,0,0,5,2,-4,2,0,0,1,0,1,1,-1,0,-1
KR_6584017737,420,-6,-53,-22,-17,-2,6,4,-6,8,2,0,2,2,-8,8,0,-1,2,1,-1,-24,282,-1,-3,4,0,0,-2,-1,-1,-1,-1,2,-1
KR_6755831731,420,-7,-84,-33,-20,-9,9,0,-7,8,1,-1,1,0,-6,8,2,3,0,3,-2,-18,13,-3,-4,7,-2,0,-3,-1,-1,-1,-1,6,-1
KR_6692426649,420,1,46,-33,-3,-2,3,1,-5,7,2,1,1,2,3,1,4,0,1,1,1,2,-111,2,-4,2,-3,0,0,-1,-1,-1,1,4,-1
KR_6764643452,420,2,31,-20,9,0,2,2,7,0,7,2,2,4,0,2,2,0,1,1,0,4,64,7,-9,2,-19,0,0,1,-1,0,1,5,-1
KR_6754140258,420,3,33,-3,4,3,1,4,1,0,1,1,1,2,0,2,2,-1,1,0,0,4,32,-5,-5,10,1,0,1,-1,1,1,-1,4,-1
KR_6632440035,420,0,-38,6,-5,-5,5,0,0,7,7,1,4,5,-1,5,4,0,0,0,-2,2,51,1,-7,6,-17,0,-1,-1,-1,-1,-1,2,-1
KR_6757760514,420,-6,-61,-13,-8,-3,4,1,-3,3,0,0,3,3,-1,2,1,-1,1,0,0,-11,-4,-2,-6,8,1,0,-2,-1,-1,-1,1,4,-1
KR_6726475548,420,-1,0,8,2,1,0,1,-3,7,4,-1,1,0,6,2,8,-1,2,1,0,9,6,2,-8,6,-2,0,-1,1,-1,-1,1,2,-1
KR_6728853228,420,-4,-43,43,-10,-3,4,1,-2,2,0,-1,2,1,-4,4,0,0,0,0,0,-16,-18,2,-5,3,3,0,0,1,1,-1,-1,4,-1
KR_6766076704,420,-4,-27,-35,-10,0,1,1,-1,4,3,-2,2,0,-4,9,5,-3,4,1,0,-13,-14,-7,-6,13,6,0,-1,1,-1,-1,-1,1,-1
KR_6738375681,440,1,24,8,8,2,1,3,-2,4,2,0,2,2,7,0,7,1,0,1,1,5,7,7,-9,2,-1,0,0,1,1,1,1,6,-1
KR_6757151035,420,-2,-75,0,-8,3,2,5,1,1,2,-5,5,0,-6,7,1,-1,3,2,0,-4,-17,0,-5,5,23,0,0,-1,1,-1,-1,4,-1
KR_6763195796,440,-5,4,-8,-24,-3,6,3,-2,4,2,-6,7,1,-7,8,1,-6,6,0,0,-28,-6,-4,-4,8,-1,0,-1,-1,-1,-1,-1,2,-1
KR_6709495875,420,0,-8,-15,3,0,2,2,1,0,1,-1,3,2,4,0,4,-1,3,2,0,3,13,6,-8,2,-5,0,0,1,-1,-1,1,5,-1
KR_6697039997,420,-3,-31,-4,-5,0,1,1,-3,6,3,0,0,0,-1,3,2,-1,3,2,-1,-5,0,-5,-2,7,1,0,0,-1,-1,0,-1,5,-1
KR_6650139632,420,-1,17,-13,-8,-1,2,1,1,3,4,-10,10,0,0,4,4,2,0,2,0,-8,2,-3,-5,8,-3,0,0,1,-1,-1,1,2,-1
KR_6738183449,440,0,-10,-9,-6,3,0,3,-1,1,0,-9,11,2,0,1,1,1,1,2,-3,-10,1,-3,-5,8,0,0,0,-1,-1,1,1,4,-1
KR_6759126877,420,-1,-21,-23,-13,-4,5,1,-5,8,3,-2,3,1,0,5,5,-2,3,1,0,-6,36,-1,-4,5,-4,0,0,1,1,-1,-1,1,-1
KR_6741093105,440,-6,-84,-3,-7,-7,8,1,-2,3,1,2,0,2,1,2,3,-1,1,0,0,-4,-131,1,-7,6,0,0,0,-1,1,-1,1,6,-1
KR_6728365132,420,-1,-66,28,-9,-5,6,1,0,3,3,0,1,1,-4,6,2,0,0,0,0,-5,0,-6,-3,9,-2,0,-3,1,-1,-1,1,3,-1
KR_6736899461,420,-1,-64,8,-10,-1,2,1,-4,5,1,2,0,2,-5,10,5,-2,3,1,0,-14,38,-6,-4,10,-7,0,0,-1,1,-1,-1,3,-1
KR_6758719910,440,-1,7,-15,-1,5,1,6,0,2,2,-4,5,1,-2,2,0,0,1,1,-1,-1,42,2,-5,3,-19,0,1,1,1,1,-1,1,-1
KR_6763062789,420,-1,-32,3,-1,-1,5,4,5,0,5,0,3,3,-4,6,2,-1,2,1,0,0,9,-3,-2,5,-3,0,-1,0,1,-1,1,0,-1
KR_6733973281,420,-1,-35,11,-7,0,0,0,-1,2,1,-6,6,0,0,1,1,0,0,0,0,-4,-96,-5,-2,7,-4,0,-1,-1,1,-1,-1,3,-1
KR_6761479583,420,0,26,-16,0,1,1,2,0,4,4,-3,4,1,4,1,5,-2,2,0,1,3,-22,0,-8,8,4,0,0,-1,-1,0,1,3,-1
KR_6750946348,420,-1,14,-23,-7,-1,2,1,-1,2,1,1,1,2,-3,5,2,-3,3,0,1,-14,-3,-1,-5,6,-3,0,-1,-1,-1,-1,1,1,-1
KR_6621233997,420,0,-27,15,4,0,2,2,2,1,3,5,1,6,-3,7,4,0,1,1,1,10,4,1,-6,5,4,0,1,1,1,1,-1,2,-1
KR_6739034821,420,1,40,5,0,-2,2,0,3,0,3,3,3,6,-4,5,1,0,2,2,0,-5,31,-1,-7,8,0,0,0,-1,-1,0,-1,5,-1
KR_6767582410,420,-1,28,-4,-4,-2,3,1,0,3,3,4,1,5,-5,5,0,-1,1,0,0,-16,10,0,-5,5,1,0,1,1,1,1,1,6,-1
KR_6769188038,420,0,-55,4,5,2,2,4,0,2,2,2,0,2,-1,2,1,2,0,2,0,2,-4,2,-8,6,1,0,-1,1,-1,-1,1,1,-1
KR_6702985649,420,1,25,-12,3,4,2,6,1,2,3,2,0,2,-6,7,1,2,0,2,1,-2,-5,-1,-6,7,2,0,-1,1,1,-1,1,3,-1
KR_6637807073,420,2,-61,29,2,0,2,2,-1,6,5,1,0,1,2,4,6,0,2,2,0,4,-4,0,-4,4,1,0,0,-1,-1,-1,-1,1,-1
KR_6765041547,420,-6,-55,-47,-11,-5,5,0,-3,5,2,-3,5,2,-1,2,1,1,0,1,-1,1,0,-1,-4,5,6,0,-2,1,-1,-1,-1,2,-1
KR_6686510484,420,-3,5,5,-14,-4,6,2,-9,10,1,1,3,4,-2,4,2,0,1,1,-1,-25,-3,0,-5,5,-5,0,-1,-1,-1,-1,1,2,-1
KR_6762389596,420,4,2,52,2,-1,2,1,0,2,2,3,0,3,0,2,2,0,0,0,0,-1,12,4,-9,5,1,0,0,-1,1,-1,-1,1,-1
KR_6637535356,420,-3,-58,-25,-10,-2,2,0,2,1,3,-8,11,3,0,2,2,-2,2,0,-3,-9,0,-3,-3,6,2,0,-1,-1,1,-1,-1,3,-1
KR_6629496511,420,-5,-33,-9,-9,-1,1,0,0,3,3,0,1,1,-7,7,0,-1,2,1,1,-5,118,0,-5,5,5,0,-1,1,-1,-1,1,2,-1
KR_6764457356,420,-1,-16,-16,-2,-3,3,0,5,2,7,-4,8,4,2,1,3,-2,4,2,0,-3,115,1,-4,3,2,0,-1,1,1,-1,1,4,-1
KR_6755659671,420,-6,-22,-10,-15,2,2,4,-4,5,1,-5,7,2,-7,7,0,-1,1,0,0,-19,17,1,-4,3,-1,0,0,-1,1,-1,-1,1,-1
KR_6766785553,420,-1,-76,-9,0,-2,3,1,-2,4,2,5,1,6,0,3,3,-1,3,2,1,9,-28,1,-5,4,-5,0,-1,-1,-1,-1,1,1,-1
KR_6768611836,420,1,-28,16,-1,0,2,2,1,2,3,3,1,4,-6,8,2,1,0,1,0,-5,6,-5,-4,9,2,0,-1,1,-1,-1,1,2,-1
KR_6766152521,420,-3,-49,-25,-5,-5,6,1,-1,6,5,1,2,3,0,2,2,0,1,1,-1,-1,45,3,-6,3,-30,0,-2,1,-1,-1,-1,4,-1
KR_6750976646,440,-5,-35,-3,-12,-6,8,2,-4,4,0,-3,6,3,1,0,1,0,1,1,0,-18,10,-7,-3,10,1,0,-1,-1,1,-1,-1,3,-1
KR_6724616572,420,-3,-81,-4,-9,-6,6,0,-2,4,2,1,2,3,-3,4,1,1,1,2,0,-9,28,-4,0,4,0,0,-2,-1,-1,-1,-1,4,-1
KR_6724331617,420,1,0,10,-3,-6,6,0,-3,5,2,1,2,3,3,2,5,2,0,2,1,-2,0,-3,-5,8,6,0,-1,-1,-1,-1,-1,3,-1
KR_6751855925,420,-4,-28,5,1,2,2,4,-2,3,1,-1,4,3,3,1,4,-1,1,0,2,4,8,0,-10,10,-8,0,0,-1,1,1,1,3,-1
KR_6765728306,440,-1,-34,32,-6,-2,3,1,-2,2,0,0,2,2,-3,4,1,1,1,2,0,-7,4,-2,-5,7,-2,0,1,-1,1,1,1,2,-1
KR_6767705455,420,-6,-48,-14,-7,-4,4,0,-1,4,3,-4,6,2,1,3,4,1,1,2,-1,-3,1,-2,-5,7,-5,0,-2,1,1,-1,-1,5,-1
KR_6722821836,420,2,48,-3,1,-4,5,1,3,0,3,2,1,3,1,0,1,-1,1,0,0,3,26,4,-6,2,2,0,0,1,-1,1,-1,5,-1
KR_6743573804,420,-1,-25,-25,0,-2,4,2,-2,2,0,0,1,1,3,0,3,1,0,1,-1,-1,-181,3,-6,3,-3,0,1,0,0,1,-1,0,-1
KR_6751774536,420,1,21,-36,6,2,2,4,4,2,6,-1,3,2,2,0,2,-1,1,0,0,12,12,3,-8,5,0,0,1,-1,1,1,1,3,-1
KR_6756597105,420,-2,8,4,4,-1,1,0,-7,7,0,4,0,4,3,1,4,5,1,6,2,3,-23,3,-8,5,3,0,2,1,1,1,1,1,-1
KR_6744204199,420,-2,44,11,-9,0,3,3,-7,9,2,0,1,1,-3,3,0,1,0,1,0,-14,1,0,-7,7,2,0,1,-1,1,-1,-1,2,-1
KR_6660297604,420,-2,-58,-15,-2,-2,3,1,5,0,5,-2,3,1,1,4,5,-4,7,3,0,-1,217,-4,-4,8,-3,0,0,1,-1,-1,-1,3,-1
KR_6768117286,420,0,20,15,-2,-3,3,0,4,0,4,-3,3,0,0,1,1,0,0,0,0,4,25,-1,-4,5,0,0,0,1,-1,-1,1,1,-1
KR_6764779078,420,-2,-49,8,-1,-2,3,1,3,3,6,-1,1,0,-1,3,2,0,1,1,0,3,2,3,-6,3,0,0,0,1,-1,1,-1,2,-1
KR_6706320157,440,-1,3,-11,-5,3,1,4,-7,7,0,0,1,1,-2,4,2,1,0,1,0,-5,-4,4,-7,3,-7,0,0,-1,-1,0,-1,2,-1
KR_6738937068,440,-3,10,-40,-2,-8,9,1,0,4,4,1,0,1,6,0,6,-1,2,1,0,-1,1,-1,-6,7,3,0,0,-1,0,0,1,2,-1
KR_6604286485,420,-2,-16,-9,-12,-3,3,0,-1,2,1,1,1,2,-7,8,1,-2,2,0,0,-15,3,-4,-3,7,-1,0,-1,-1,1,-1,1,1,-1
KR_6733780178,420,0,11,4,1,0,1,1,1,2,3,3,0,3,-4,4,0,1,0,1,0,2,-18,-1,-6,7,9,0,0,1,1,0,1,6,-1
KR_6638236646,420,0,-13,12,-3,-3,3,0,-3,5,2,2,2,4,2,1,3,-1,3,2,0,-7,-5,2,-8,6,7,0,0,-1,-1,-1,1,6,-1
KR_6766835250,420,-1,-33,-23,-7,-5,8,3,0,4,4,-3,6,3,1,3,4,0,0,0,-2,2,6,-2,-7,9,6,0,-1,-1,0,-1,1,1,-1
KR_6750454816,420,-2,-21,-35,-1,-1,2,1,5,2,7,-2,8,6,-5,7,2,2,0,2,0,2,6,4,-7,3,1,0,0,1,-1,0,-1,6,-1
KR_6755689161,420,0,-10,-5,-1,-3,4,1,1,1,2,0,2,2,1,1,2,0,0,0,0,2,-2,2,-4,2,-1,0,-1,1,-1,-1,-1,4,-1
KR_6751283963,420,-5,-99,16,-8,-3,3,0,1,3,4,-2,3,1,-4,4,0,0,0,0,0,-6,-5,1,-4,3,-2,0,-1,1,1,-1,-1,5,-1
KR_6726432662,420,0,-31,-13,3,0,0,0,0,1,1,2,3,5,0,1,1,1,1,2,0,7,-34,-3,-6,9,2,0,0,1,1,0,1,4,-1
KR_6736373015,420,1,1,-19,7,3,2,5,3,5,8,0,1,1,0,1,1,1,0,1,-2,2,-8,-3,-3,6,2,0,1,-1,1,1,-1,4,-1
KR_6767107372,420,-6,-43,-16,-16,3,0,3,-9,12,3,-5,6,1,-2,2,0,-3,3,0,0,-16,7,3,-7,4,-12,0,-1,-1,1,-1,-1,1,-1
KR_6756696884,420,-3,-52,-49,-5,-1,3,2,-6,6,0,3,0,3,-1,2,1,0,1,1,0,-4,20,-2,-3,5,1,0,0,-1,1,1,1,3,-1
KR_6764175591,420,-4,-40,-59,-4,0,0,0,-8,9,1,0,1,1,3,2,5,1,0,1,0,-2,-4,0,-7,7,4,0,1,1,-1,1,-1,4,-1
KR_6734433059,420,-6,-57,-24,-11,-5,6,1,-5,5,0,1,1,2,0,2,2,-2,3,1,0,-11,-261,-2,-3,5,1,0,0,1,1,-1,-1,5,-1
KR_6764960808,420,0,2,-15,-4,-3,3,0,1,2,3,-3,5,2,1,2,3,0,1,1,0,-5,10,4,-6,2,-3,0,1,1,-1,1,-1,4,-1
KR_6751723265,420,-1,-65,12,0,-2,3,1,3,3,6,-1,3,2,-1,1,0,1,1,2,0,2,6,2,-6,4,-5,0,-1,1,-1,-1,1,6,-1
KR_6519037923,420,-1,0,-32,-3,1,0,1,-2,3,1,-1,2,1,0,0,0,-1,1,0,-1,-4,-104,-1,-5,6,-3,0,0,-1,-1,0,-1,5,-1
KR_6741206950,420,-6,-43,-41,-14,-5,5,0,-3,5,2,1,1,2,-2,6,4,-5,5,0,0,-5,-23,-4,-2,6,6,0,-1,-1,-1,-1,-1,3,-1
KR_6766914401,420,1,-59,11,4,-2,4,2,2,2,4,6,2,8,-1,4,3,-1,2,1,1,11,12,8,-13,5,-5,0,0,1,-1,0,-1,4,-1
KR_6679279177,420,-5,-55,1,-7,-2,4,2,-4,7,3,-1,3,2,0,2,2,0,0,0,0,-6,-3,4,-6,2,-1,0,-1,-1,-1,-1,-1,6,-1
KR_6760449741,420,-5,-88,-28,-11,-3,4,1,-2,7,5,-3,4,1,-4,7,3,1,0,1,-2,-14,34,1,-5,4,-2,0,0,-1,1,-1,-1,5,-1
KR_6766923088,440,-6,-99,-2,-21,-5,5,0,-2,4,2,-5,7,2,0,3,3,-9,10,1,-2,-21,14,-7,-2,9,3,0,-1,1,1,-1,-1,6,-1
KR_6763742372,420,-1,-45,11,-4,-3,3,0,4,2,6,0,1,1,-2,5,3,-3,4,1,0,-7,-2,-5,-5,10,0,0,-1,-1,-1,-1,-1,5,-1
KR_6691428603,420,2,-37,-8,5,0,4,4,0,1,1,6,2,8,-3,4,1,2,0,2,-1,10,34,0,-4,4,0,0,-2,-1,-1,-1,-1,4,-1
KR_6710881801,420,-3,-18,-19,-10,1,4,5,-3,6,3,1,3,4,-9,10,1,0,0,0,-1,-8,-40,0,-5,5,-1,0,-3,-1,-1,-1,-1,5,-1
KR_6766743777,420,-4,-28,5,-8,-1,3,2,-1,2,1,-2,3,1,-4,5,1,0,0,0,0,-13,-8,-4,-3,7,7,0,0,1,1,0,-1,1,-1
KR_6701978311,420,0,-25,8,-7,2,3,5,-3,5,2,1,0,1,-7,8,1,0,0,0,0,-9,10,0,-5,5,-4,0,1,-1,-1,1,-1,6,-1
KR_6766977169,420,0,-5,15,-1,1,1,2,-3,5,2,2,0,2,-2,3,1,1,0,1,0,-5,-6,0,-6,6,2,0,0,-1,-1,0,-1,2,-1
KR_6750069930,420,-1,-82,-3,-3,-2,5,3,-3,6,3,4,2,6,-2,6,4,0,2,2,0,-5,-9,-1,-7,8,0,0,-3,-1,-1,-1,1,5,-1
KR_6761505149,420,1,6,2,0,-2,4,2,2,3,5,1,0,1,-1,3,2,0,0,0,0,-1,9,3,-7,4,-2,0,0,-1,1,1,-1,2,-1
KR_6761692994,440,1,-23,-8,0,2,1,3,-6,6,0,2,2,4,0,2,2,2,0,2,0,3,-13,-3,-5,8,-4,0,-1,1,1,-1,1,6,-1
KR_6691422359,420,-3,-59,-23,-7,2,1,3,0,3,3,-3,5,2,-4,5,1,-2,3,1,0,0,0,0,-5,5,-4,0,-1,-1,1,-1,1,2,-1
KR_6696228315,420,-1,22,-31,-3,-2,5,3,-2,5,3,1,1,2,0,6,6,0,1,1,0,-17,1,-7,-3,10,5,0,0,-1,-1,1,-1,4,-1
KR_6768728703,420,-5,-37,1,-12,-5,5,0,-1,3,2,0,2,2,-5,5,0,-1,2,1,0,-13,-3,-2,-6,8,4,0,0,-1,1,0,-1,4,-1
KR_6763586525,440,-4,-114,-12,-8,-3,4,1,0,1,1,2,2,4,-1,5,4,-6,6,0,0,-5,20,-1,-5,6,-1,0,0,0,0,-1,-1,0,-1
KR_6769044848,420,2,29,-20,-8,-1,2,1,-1,3,2,-2,5,3,-1,3,2,-3,3,0,0,-14,-8,-5,-3,8,2,0,0,-1,-1,0,-1,2,-1
KR_6724171647,420,-1,-41,8,-5,-1,1,0,-2,2,0,0,2,2,-4,5,1,2,1,3,-3,-6,0,-2,-4,6,-3,0,0,-1,1,0,-1,3,-1
KR_6730274002,420,-2,5,-13,-2,0,0,0,-4,5,1,-1,3,2,4,0,4,-1,2,1,0,1,40,2,-9,7,-11,0,0,1,-1,-1,-1,1,-1
KR_6758999216,420,-1,-48,16,-7,-5,6,1,0,3,3,-1,2,1,-3,6,3,2,1,3,0,1,3,-5,-3,8,-6,0,-1,0,-1,-1,-1,0,-1
KR_6751921283,420,-3,-28,0,-4,-2,4,2,-1,3,2,1,3,4,-1,1,0,-1,2,1,0,-5,0,-3,-2,5,1,0,-1,1,-1,-1,-1,2,-1
KR_6564255511,420,-3,-66,3,-3,2,0,2,2,0,2,-4,5,1,-3,4,1,0,0,0,0,-8,-15,-3,-6,9,-4,0,-1,-1,-1,1,1,3,-1
KR_6764858314,420,-2,-31,-12,-11,-4,6,2,-2,2,0,-5,6,1,-2,4,2,2,0,2,0,-11,0,-5,-5,10,-16,0,1,-1,1,1,-1,3,-1
KR_6753276367,420,-2,23,3,-1,0,1,1,2,1,3,-1,2,1,1,1,2,-3,3,0,1,-3,121,0,-5,5,5,0,0,-1,-1,0,1,4,-1
KR_6748985332,420,-1,-50,12,-2,0,2,2,1,2,3,0,1,1,-3,4,1,0,0,0,0,-9,33,-3,-5,8,-4,0,0,-1,1,0,1,3,-1
KR_6766740945,420,-2,-38,4,-6,-2,3,1,0,2,2,1,2,3,-1,4,3,-4,5,1,0,-7,-13,-2,-5,7,5,0,0,0,-1,0,-1,0,-1
KR_6695467698,420,-1,-2,19,-6,3,2,5,-3,4,1,-2,5,3,1,0,1,-5,5,0,0,-7,-166,-5,-5,10,13,0,0,-1,1,1,-1,3,-1
KR_6769156463,420,2,-38,-2,0,-1,1,0,0,3,3,1,1,2,-1,1,0,1,2,3,0,-4,-136,-2,-6,8,1,0,-1,-1,-1,-1,-1,3,-1
KR_6696906393,420,-1,-48,-42,-3,-6,8,2,7,2,9,-2,6,4,-2,4,2,0,0,0,0,5,-23,-7,-4,11,-3,0,-1,-1,1,-1,-1,4,-1
KR_6767095290,420,0,-7,14,-6,2,1,3,-2,2,0,-2,3,1,-4,5,1,0,1,1,0,-6,1,0,-7,7,0,0,0,-1,0,-1,-1,4,-1
KR_6763386759,420,-9,-79,-56,-13,-5,6,1,-4,5,1,-4,4,0,0,1,1,0,0,0,0,-5,-22,-3,-3,6,-3,0,-4,-1,-1,-1,-1,1,-1
KR_6758492448,420,-2,-16,-20,-11,-2,4,2,2,2,4,-8,10,2,0,1,1,-3,3,0,0,-8,9,2,-5,3,0,0,-2,-1,-1,-1,-1,1,-1
KR_6740724652,420,-4,-84,10,-5,-1,2,1,-3,4,1,-1,2,1,1,2,3,-1,1,0,0,-2,-39,3,-8,5,13,0,0,-1,0,-1,-1,4,-1
KR_6762036571,420,-2,-76,-28,0,0,3,3,3,0,3,2,0,2,-5,5,0,0,0,0,0,5,-14,2,-4,2,1,0,-2,-1,-1,-1,-1,2,-1
KR_6743596058,420,-5,-131,-4,-7,-1,2,1,-6,8,2,-1,1,0,-2,5,3,3,0,3,0,-7,30,-3,-7,10,-6,0,-1,-1,-1,-1,-1,4,-1
KR_6761254310,420,1,19,43,-2,1,1,2,-2,6,4,-1,3,2,-1,2,1,1,1,2,0,-5,-1,0,-4,4,2,0,1,1,1,1,-1,6,-1
KR_6716555639,420,-1,-1,-20,-6,0,0,0,-8,8,0,-6,8,2,9,0,9,-1,2,1,-2,-16,-12,-2,-3,5,3,0,-1,-1,-1,-1,1,1,-1
KR_6749685958,420,-4,6,0,-12,-5,5,0,-7,7,0,-3,5,2,3,0,3,0,0,0,0,-10,-3,-2,-3,5,1,0,-2,1,-1,-1,-1,5,-1
KR_6764336012,440,-3,-72,-1,-3,-3,3,0,-4,6,2,0,1,1,2,3,5,2,0,2,0,-2,-133,-1,-5,6,5,0,-1,-1,-1,-1,1,4,-1
KR_6743663601,420,0,7,-5,3,-2,3,1,2,1,3,-1,2,1,4,2,6,0,3,3,0,10,33,2,-6,4,-18,0,-1,1,-1,-1,-1,2,-1
KR_6701663840,420,-2,9,-32,-6,-2,2,0,-1,4,3,-1,2,1,0,0,0,-2,2,0,0,0,-14,-1,-6,7,-9,0,-2,1,-1,-1,1,6,-1
KR_6760827749,440,-7,-154,-4,-18,-7,8,1,3,0,3,-3,6,3,-11,13,2,0,2,2,0,-9,-1,0,-1,1,0,0,-1,-1,0,-1,-1,6,-1
KR_6767154170,420,-1,-22,-11,-9,2,0,2,-8,11,3,1,2,3,-2,3,1,-2,2,0,-1,-5,1,4,-8,4,-6,0,0,-1,1,1,-1,6,-1
KR_6724933060,420,0,-49,32,-2,-1,1,0,-2,4,2,1,1,2,2,2,4,-2,2,0,0,-6,-49,0,-5,5,14,0,1,-1,1,1,1,2,-1
KR_6761586999,420,2,44,14,-2,5,0,5,-3,3,0,-1,1,0,-1,2,1,-2,2,0,0,-11,-42,2,-7,5,8,0,2,0,1,1,-1,0,-1
KR_6733430163,420,-3,-35,-13,-13,-1,2,1,-3,5,2,-1,3,2,-5,9,4,-3,3,0,0,-14,32,-2,-5,7,-14,0,0,-1,1,-1,-1,6,-1
KR_6755106139,420,-4,-39,5,-6,-2,2,0,2,0,2,-2,3,1,-4,4,0,0,0,0,-1,-6,30,0,-4,4,-2,0,0,-1,1,0,-1,3,-1
KR_6762682576,420,1,-6,-39,2,0,1,1,1,1,2,-3,4,1,0,0,0,4,1,5,0,2,10,1,-5,4,0,0,1,1,-1,1,-1,2,-1
KR_6754371977,420,-5,-75,-25,-11,-1,2,1,-6,6,0,-2,2,0,-1,2,1,-1,1,0,0,-12,-21,-4,-3,7,-2,0,-2,-1,-1,-1,-1,2,-1
KR_6763567931,420,-4,-43,-16,-11,-1,1,0,1,3,4,-6,9,3,-3,5,2,-2,2,0,0,-9,-3,-1,-3,4,-3,0,1,-1,1,1,-1,2,-1
KR_6710203466,440,2,14,0,7,1,1,2,2,1,3,5,0,5,-1,3,2,0,0,0,0,3,-18,0,-5,5,6,0,2,1,1,1,1,6,-1
KR_6730051049,420,0,-35,4,-4,1,0,1,-1,3,2,0,3,3,-4,7,3,0,0,0,1,1,28,4,-10,6,-5,0,-2,-1,1,-1,1,4,-1
KR_6766721340,440,-5,24,-40,-7,-3,4,1,-3,3,0,-2,3,1,0,3,3,1,1,2,-1,-12,-6,-4,-2,6,-1,0,-1,-1,-1,-1,-1,4,-1
KR_6732263817,420,-8,-70,23,-22,0,3,3,-4,4,0,-10,10,0,-6,7,1,-2,3,1,0,-20,0,2,-6,4,-1,0,-2,-1,0,-1,1,1,-1
KR_6728272252,420,1,11,-6,5,0,1,1,6,1,7,-3,4,1,3,0,3,-1,1,0,0,17,2,0,-7,7,3,0,0,-1,-1,0,1,2,-1
KR_6606315726,420,2,50,0,8,-4,4,0,3,1,4,5,2,7,4,1,5,0,2,2,0,14,-2,0,-9,9,3,0,-1,-1,-1,1,1,6,-1
KR_6764880388,420,-4,-14,-20,-5,0,3,3,-5,5,0,-1,1,0,1,3,4,0,0,0,0,-8,17,-2,-4,6,-4,0,-1,1,1,-1,1,2,-1
KR_6761761810,420,-7,-104,-4,-5,-1,1,0,-3,5,2,-2,3,1,2,0,2,-1,1,0,-1,-5,-4,-2,-3,5,-4,0,-4,-1,-1,-1,-1,2,-1
KR_6741568966,420,-2,-62,-4,-5,-2,3,1,0,5,5,-3,4,1,-1,1,0,1,0,1,0,-10,13,6,-10,4,-5,0,-1,1,1,-1,1,2,-1
KR_6764303307,440,-2,36,-20,-11,-3,5,2,-2,3,1,-5,5,0,0,4,4,-1,2,1,-3,-15,-37,-6,-5,11,3,0,-1,-1,-1,-1,-1,1,-1
KR_6768885020,420,-1,-4,12,-4,0,0,0,3,0,3,-5,5,0,-1,3,2,-1,1,0,0,-1,-5,-1,-3,4,4,0,-2,1,-1,-1,-1,1,-1
KR_6756981679,440,-2,-91,24,-5,-1,3,2,2,1,3,-5,8,3,-3,4,1,2,0,2,0,-5,-128,-3,-5,8,1,0,-2,-1,-1,-1,1,4,-1
KR_6653682083,420,-2,-51,-5,-5,-2,2,0,-4,5,1,2,2,4,-2,4,2,1,0,1,-1,-5,1,0,-5,5,-2,0,-1,-1,-1,-1,-1,2,-1
KR_6747243899,420,0,12,-2,-7,-7,7,0,1,1,2,1,0,1,-3,4,1,1,0,1,1,-4,7,3,-9,6,1,0,1,1,-1,-1,1,1,-1
KR_6765669805,440,-2,-95,-8,-6,-1,2,1,1,0,1,-4,6,2,0,4,4,-2,6,4,-1,3,4,1,-7,6,0,0,-3,1,-1,-1,-1,5,-1
KR_6694513233,420,-4,-7,4,-14,-5,5,0,2,0,2,-9,9,0,-2,2,0,0,0,0,0,-12,-5,-4,-5,9,1,0,0,-1,-1,1,1,6,-1
KR_6764675319,420,3,109,64,3,3,0,3,0,6,6,-1,1,0,2,2,4,-1,2,1,0,-3,21,0,-6,6,4,0,1,0,1,1,-1,0,-1
KR_6697001390,420,-5,-63,20,-10,-3,3,0,-5,5,0,0,4,4,-1,2,1,-1,1,0,0,-7,0,-4,-3,7,0,0,-2,1,-1,-1,-1,6,-1
KR_6754607094,420,-4,-79,4,-8,-4,6,2,1,2,3,-2,3,1,-2,4,2,-1,1,0,0,-5,-11,-1,-6,7,2,0,-3,-1,-1,-1,-1,3,-1
KR_6764036196,420,0,-47,-1,2,2,0,2,1,1,2,1,3,4,-2,5,3,0,2,2,0,5,4,2,-5,3,-2,0,-1,-1,-1,-1,-1,1,-1
KR_6768857367,420,-4,1,-29,-5,-2,2,0,-9,9,0,8,2,10,-2,5,3,0,0,0,0,3,6,3,-10,7,-8,0,2,-1,1,1,1,5,-1
KR_6763773423,420,0,-39,0,-1,2,0,2,1,3,4,-4,4,0,-1,3,2,1,0,1,0,0,2,0,-5,5,-1,0,0,1,1,-1,1,4,-1
KR_6705161742,440,-4,-39,-28,-8,-1,2,1,0,6,6,2,1,3,-5,7,2,-4,5,1,1,-3,15,-1,-4,5,3,0,-3,-1,-1,-1,1,4,-1
KR_6765513175,440,-4,-85,23,-9,-1,2,1,0,3,3,-6,7,1,-3,11,8,1,0,1,0,2,-4,-2,-5,7,1,0,0,1,1,1,1,2,-1
KR_6764897738,420,-4,-38,16,-7,-4,5,1,-1,2,1,-1,4,3,0,0,0,-1,1,0,0,-4,13,0,-8,8,-4,0,-1,-1,-1,-1,-1,4,-1
KR_6718763169,420,-5,-56,-20,-15,2,3,5,-7,9,2,-7,7,0,-3,4,1,0,1,1,-1,-10,1,-4,-1,5,-1,-1,-2,-1,-1,-1,-1,5,-1
KR_6687070709,420,-3,-58,-32,-5,-6,6,0,-1,1,0,3,3,6,-4,5,1,3,0,3,0,-2,3,2,-5,3,-7,0,0,1,-1,-1,1,4,-1
KR_6712491817,420,-2,-26,-17,-10,-3,4,1,1,2,3,-8,8,0,1,5,6,-1,2,1,0,-8,0,5,-9,4,-4,0,-2,-1,-1,-1,1,1,-1
KR_6687601418,420,-2,-17,-8,0,-2,3,1,-1,2,1,-2,4,2,5,3,8,0,1,1,1,1,12,-5,-5,10,3,0,0,-1,-1,1,1,5,-1
KR_6754031647,420,1,-5,-32,0,5,1,6,-1,3,2,1,1,2,-5,6,1,0,0,0,0,-4,2,2,-6,4,-1,0,-1,0,-1,-1,1,0,-1
KR_6766640126,420,2,7,-32,3,3,2,5,1,4,5,-2,2,0,1,1,2,0,0,0,0,5,9,6,-10,4,-1,0,0,1,1,1,1,2,-1
KR_6762002510,420,-5,-46,-11,-14,-1,2,1,-5,5,0,-5,5,0,-3,4,1,0,0,0,-1,-12,89,-6,-1,7,0,0,-4,-1,-1,-1,-1,4,-1
KR_6760992721,420,-4,-97,0,-10,-2,3,1,-1,2,1,-1,2,1,-5,6,1,-1,3,2,0,-13,3,-1,-3,4,-9,0,-1,1,-1,-1,-1,1,-1
KR_6763941214,420,-2,-45,7,-5,-3,3,0,-3,4,1,0,1,1,3,1,4,-2,4,2,0,-4,-3,-3,-5,8,2,0,0,1,1,0,-1,3,-1
KR_6768916688,420,-2,-16,-14,-3,-4,5,1,-2,4,2,0,2,2,-1,5,4,4,0,4,0,-3,3,1,-8,7,3,0,0,1,-1,-1,-1,3,-1
KR_6735533846,420,2,11,-3,1,2,1,3,3,3,6,-2,4,2,-1,2,1,-1,1,0,0,3,-11,0,-6,6,0,0,1,-1,-1,-1,-1,5,-1
KR_6736287252,420,-1,51,1,2,-1,1,0,-2,4,2,-1,2,1,4,1,5,2,0,2,0,5,13,2,-8,6,-2,0,0,-1,1,1,-1,3,-1
KR_6754349995,420,0,-22,-21,-6,1,1,2,-1,2,1,-4,6,2,-3,4,1,1,1,2,1,-12,-188,0,-3,3,5,0,-3,-1,1,-1,1,2,-1
KR_6764903208,420,-4,-41,-9,-12,-1,2,1,-5,7,2,-7,7,0,0,3,3,1,1,2,-2,-13,-16,-2,-7,9,3,0,0,-1,1,-1,-1,1,-1
KR_6767485700,420,0,22,-11,-9,0,2,2,-1,3,2,-5,5,0,-2,2,0,-1,1,0,0,-7,445,0,-3,3,-5,0,0,-1,-1,0,-1,3,-1
KR_6730300103,420,-4,-92,-12,-5,-3,3,0,0,6,6,-1,1,0,-1,3,2,0,2,2,0,-5,146,1,-7,6,3,0,0,-1,-1,0,1,1,-1
KR_6761842550,440,-2,-12,16,-11,-1,2,1,0,0,0,-3,3,0,-1,1,0,-6,6,0,0,-19,-3,1,-5,4,-4,0,1,-1,-1,1,-1,3,-1
KR_6766785914,420,2,96,-4,3,1,0,1,-2,4,2,0,2,2,4,0,4,0,0,0,0,5,13,2,-7,5,4,0,1,-1,1,1,-1,5,-1
KR_6760749512,420,4,25,-4,3,2,0,2,3,2,5,-2,5,3,1,2,3,-1,1,0,-1,3,22,0,-3,3,1,0,0,1,1,-1,-1,5,-1
KR_6757634358,420,0,27,-21,0,0,2,2,1,1,2,-1,3,2,2,2,4,-2,2,0,0,-1,9,-1,-8,9,-4,0,-1,-1,-1,-1,-1,4,-1
KR_6761115373,420,-2,-33,-2,-8,1,1,2,-3,4,1,-2,5,3,-2,3,1,-2,4,2,0,-8,0,1,-8,7,-1,0,1,-1,1,1,1,2,-1
KR_6762102771,420,-1,-12,-32,2,0,2,2,-1,5,4,2,0,2,0,3,3,1,0,1,0,0,-4,-1,-3,4,2,0,0,1,-1,0,1,6,-1
KR_6768964991,420,-1,-62,0,-1,-1,2,1,0,1,1,-2,4,2,2,1,3,0,0,0,0,-5,112,-3,-4,7,4,0,0,-1,-1,0,-1,3,-1
KR_6745343205,440,0,24,20,-3,-2,7,5,0,3,3,-1,3,2,0,1,1,0,0,0,0,1,-8,3,-4,1,1,0,1,1,1,1,-1,3,-1
KR_6766174857,440,-2,21,-44,-7,0,0,0,1,0,1,1,0,1,-3,8,5,-6,6,0,0,2,3,0,-9,9,-6,0,0,1,-1,-1,-1,5,-1
KR_6676794757,420,-3,-2,1,-14,-2,4,2,2,1,3,-5,7,2,-9,10,1,0,2,2,-3,-19,-25,-6,-2,8,-5,0,0,1,-1,-1,-1,6,-1
KR_6662161682,420,-4,4,-32,-4,-1,2,1,3,1,4,-6,6,0,1,2,3,-1,1,0,1,3,-7,-4,-2,6,5,0,-1,-1,1,-1,1,1,-1
KR_6765104634,420,-1,29,-10,-12,0,0,0,-4,7,3,-5,6,1,-2,5,3,-1,1,0,0,-12,-44,-4,-1,5,3,0,-2,-1,-1,-1,1,5,-1
KR_6734790190,420,-1,1,28,-4,-2,3,1,2,0,2,-4,4,0,-1,5,4,1,0,1,0,-7,-2,1,-5,4,6,0,1,0,1,1,1,0,-1
KR_6624305487,440,-2,13,-27,-7,0,0,0,-1,3,2,-5,7,2,-2,5,3,1,2,3,-2,-6,-70,-11,-3,14,3,0,0,-1,-1,0,-1,1,-1
KR_6757130263,420,4,48,-12,8,2,0,2,-1,5,4,3,1,4,2,2,4,2,1,3,0,6,0,8,-10,2,-3,0,1,1,1,1,1,5,-1
KR_6722067006,420,-1,-10,-23,3,-1,1,0,5,1,6,2,4,6,-3,6,3,0,3,3,0,-1,-12,2,-5,3,0,0,0,-1,1,0,1,3,-1
KR_6698920987,420,1,-8,-13,5,3,0,3,-1,4,3,1,1,2,1,0,1,1,0,1,0,2,-3,0,-7,7,-1,0,0,-1,-1,0,-1,2,-1
KR_6751118669,420,-1,54,-23,0,0,1,1,2,1,3,-1,3,2,-2,2,0,1,1,2,0,4,-18,-3,-3,6,5,0,1,-1,1,1,1,5,-1
KR_6759534952,420,-1,-30,-1,-3,-1,3,2,3,2,5,0,1,1,-5,7,2,0,1,1,0,1,2,0,-6,6,-1,0,-1,1,1,-1,-1,5,-1
KR_6759362741,440,0,-47,12,-4,1,0,1,-1,3,2,0,2,2,-4,4,0,0,0,0,0,-5,-16,-1,-8,9,-2,0,0,-1,-1,0,-1,5,-1
KR_6768720082,440,-2,3,13,-12,-6,6,0,-2,4,2,-2,4,2,0,3,3,-2,2,0,0,-17,-7,-9,-3,12,-3,0,-2,1,-1,-1,-1,5,-1
KR_6745589911,420,1,26,10,-6,1,1,2,-1,2,1,0,2,2,-6,6,0,0,0,0,0,-8,-3,-3,-2,5,1,0,1,-1,1,1,-1,3,-1
KR_6767630772,420,-2,33,-20,-3,-3,3,0,-4,5,1,3,1,4,-1,3,2,2,0,2,0,-3,-89,4,-9,5,-1,0,-1,1,-1,-1,-1,2,-1
KR_6768114556,420,-1,19,-11,3,0,3,3,8,0,8,1,1,2,-2,4,2,-4,5,1,0,-1,-2,-1,-6,7,2,0,0,0,1,0,-1,0,-1
KR_6757356013,420,-5,-62,-9,-9,1,2,3,-5,5,0,-4,4,0,-2,2,0,1,0,1,0,-16,-4,-1,-3,4,-4,0,-2,-1,-1,-1,-1,6,-1
KR_6754907149,420,-3,-82,0,-9,-2,3,1,1,0,1,-5,6,1,-3,3,0,0,1,1,0,-11,15,-3,-5,8,-5,0,-1,-1,1,-1,-1,1,-1
KR_6768893196,420,-1,-25,52,-12,-5,6,1,-2,3,1,2,2,4,-5,7,2,-2,2,0,0,-11,4,-1,-4,5,4,0,-1,-1,1,-1,-1,2,-1
KR_6740452745,420,-4,-48,12,-11,-3,4,1,0,4,4,-3,5,2,-5,6,1,0,1,1,-1,-10,-35,-6,-3,9,-4,0,-2,-1,-1,-1,-1,1,-1
KR_6765592232,420,1,30,-5,-1,2,2,4,0,3,3,0,1,1,-1,3,2,-2,2,0,0,-1,8,-1,-4,5,-2,0,1,-1,1,-1,-1,6,-1
KR_6746328022,420,-1,-37,-8,-4,0,1,1,1,1,2,1,3,4,-4,5,1,-2,3,1,0,-3,32,3,-6,3,-2,0,0,-1,1,-1,-1,3,-1
KR_6765400351,420,1,-40,3,-2,2,0,2,-2,4,2,-1,1,0,1,2,3,-2,2,0,0,-6,3,-2,-9,11,-4,0,-1,1,1,-1,-1,1,-1
KR_6741691978,420,-5,-14,-54,-7,-4,4,0,-4,7,3,-1,2,1,3,1,4,-1,2,1,0,-8,25,3,-6,3,1,0,-1,-1,1,-1,1,2,-1
KR_6765793842,420,-1,34,-18,-4,-2,4,2,2,1,3,-3,4,1,-2,2,0,1,0,1,0,-8,-4,1,-7,6,-1,0,-1,1,-1,-1,1,3,-1
KR_6765394616,420,-2,-58,8,-2,-4,5,1,3,1,4,-2,3,1,1,1,2,0,0,0,-1,1,-17,-4,-5,9,1,0,-1,-1,1,-1,-1,5,-1
KR_6751350903,420,-3,-30,-9,-12,-1,2,1,1,3,4,-7,8,1,-4,5,1,-1,2,1,0,-6,-28,4,-8,4,-5,0,0,-1,1,-1,1,6,-1
KR_6741230840,420,-1,-21,10,-7,-3,3,0,-4,6,2,3,1,4,-4,6,2,1,1,2,0,2,10,-3,-6,9,5,0,-2,1,-1,-1,-1,2,-1
KR_6765857079,420,-4,-57,-1,-6,-2,2,0,-2,3,1,1,1,2,-2,2,0,-1,1,0,0,-13,-1,-3,-4,7,-3,0,-1,-1,1,-1,1,4,-1
KR_6768866350,420,-3,6,31,-4,-2,3,1,-2,4,2,6,0,6,-2,6,4,-4,5,1,3,-4,-8,-5,-4,9,1,0,0,-1,1,0,1,4,-1
KR_6745537847,420,0,-26,-6,-2,2,0,2,1,0,1,-3,5,2,-2,6,4,0,1,1,0,-2,-213,-2,-4,6,-3,0,0,-1,-1,-1,1,4,-1
KR_6767587614,420,4,-5,16,1,2,0,2,1,2,3,5,0,5,-5,5,0,-2,2,0,0,6,-1,0,-8,8,4,0,0,-1,-1,-1,-1,6,-1
KR_6701720656,420,2,52,2,-4,3,3,6,-9,9,0,-1,4,3,2,1,3,1,0,1,0,-9,3,2,-8,6,1,0,0,-1,-1,1,-1,4,-1
KR_6758693875,420,-2,-72,0,-6,3,0,3,3,0,3,-2,2,0,-10,13,3,0,2,2,0,-5,8,2,-6,4,-5,0,-2,1,-1,-1,-1,4,-1
KR_6750853774,440,-4,27,-32,-6,0,1,1,1,0,1,2,1,3,-2,2,0,-7,8,1,0,-6,21,4,-11,7,3,0,-1,1,-1,-1,1,3,-1
KR_6769037320,420,2,27,12,-5,-1,1,0,3,3,6,-4,6,2,-4,7,3,1,1,2,0,-2,-10,-4,-4,8,5,0,1,-1,1,1,-1,3,-1
KR_6731346104,420,-1,-11,-24,-4,1,2,3,-3,4,1,3,0,3,-2,2,0,-3,3,0,0,-1,6,0,-10,10,-3,0,1,-1,1,-1,-1,1,-1
KR_6724872798,420,-4,-24,-45,-10,-6,6,0,-6,7,1,1,1,2,1,3,4,0,1,1,0,-11,-3,0,-6,6,1,0,0,-1,-1,-1,-1,3,-1
KR_6720609532,420,-4,-19,-8,-5,0,2,2,-5,8,3,-2,4,2,2,1,3,0,0,0,0,0,-9,1,-5,4,7,0,-1,1,1,-1,-1,5,-1
KR_6753101457,440,-1,-20,-16,-3,0,3,3,3,2,5,2,1,3,-5,6,1,-3,3,0,0,-5,-7,7,-9,2,-1,0,0,1,-1,0,-1,1,-1
KR_6643270984,420,-7,-98,6,-14,-1,2,1,2,2,4,-6,7,1,-9,9,0,0,1,1,0,-20,-7,1,-4,3,-3,0,-3,-1,-1,-1,-1,2,-1
KR_6664536483,420,-1,-57,-14,-5,1,1,2,-2,5,3,1,1,2,-8,8,0,3,0,3,-1,-11,6,1,-8,7,-5,0,-1,-1,1,-1,-1,3,-1
KR_6733651118,420,2,-11,8,-2,-6,6,0,4,1,5,-1,3,2,1,3,4,0,0,0,0,-5,23,-2,-4,6,-1,0,1,-1,1,1,-1,6,-1
KR_6763410016,420,3,38,-9,4,2,3,5,-1,4,3,-1,4,3,0,2,2,4,1,5,0,-5,-25,-2,-3,5,1,0,1,-1,1,1,-1,4,-1
KR_6768816848,420,-4,-39,-4,0,1,1,2,2,1,3,0,2,2,-3,4,1,0,0,0,1,-6,25,-5,-3,8,-28,0,-1,1,-1,-1,1,3,-1
KR_6762032804,420,0,-44,-24,0,0,2,2,-2,3,1,2,3,5,0,1,1,0,0,0,0,-3,-81,-1,-3,4,3,0,0,-1,1,1,1,2,-1
KR_6745863083,420,0,18,13,-4,0,1,1,-2,5,3,2,1,3,-3,6,3,-1,1,0,0,-10,-3,0,-7,7,4,0,1,-1,1,1,1,1,-1
KR_6720423389,420,-1,-45,-24,-4,1,1,2,-9,9,0,3,1,4,1,1,2,0,0,0,0,-4,2,-4,-4,8,-1,0,0,-1,1,0,-1,6,-1
KR_6768548791,440,0,-35,0,1,1,0,1,-1,2,1,-1,3,2,1,0,1,1,4,5,0,1,31,4,-7,3,-2,0,-2,-1,1,-1,1,6,-1
KR_6758760687,420,-5,-128,17,-7,-1,3,2,0,1,1,-4,5,1,-2,2,0,0,0,0,0,-6,5,3,-5,2,0,0,0,1,1,0,-1,6,-1
KR_6763978391,420,1,-36,-25,1,0,2,2,4,1,5,-3,3,0,-1,4,3,1,0,1,-1,-2,41,0,-6,6,3,0,-1,-1,-1,-1,-1,4,-1
KR_6639681138,420,3,33,9,3,2,2,4,-1,3,2,1,2,3,0,5,5,1,2,3,1,1,2,0,-6,6,1,0,0,1,-1,-1,1,5,-1
KR_6756850542,420,2,41,4,0,-3,4,1,-2,6,4,3,2,5,0,2,2,2,2,4,2,5,9,3,-8,5,-3,0,1,1,1,1,1,1,-1
KR_6619844029,420,-3,-69,6,-12,-10,10,0,-1,5,4,1,3,4,-2,2,0,0,0,0,0,-7,-15,-9,-3,12,4,0,-3,1,-1,-1,-1,4,-1
KR_6764809522,420,-3,-52,-23,-6,-3,4,1,-1,5,4,-4,6,2,3,5,8,-1,2,1,1,-3,-10,-3,-5,8,-3,0,-1,-1,-1,-1,1,6,-1
KR_6744746016,440,-4,-80,-36,-11,-1,3,2,-7,7,0,-2,7,5,-1,1,0,0,0,0,-2,-11,-13,4,-9,5,-5,0,-1,-1,1,-1,-1,1,-1
KR_6765339893,420,-2,-21,-15,-5,-1,3,2,-1,3,2,2,1,3,-4,5,1,-1,2,1,-3,-17,-10,4,-6,2,-2,0,0,-1,-1,0,-1,2,-1
KR_6736169241,420,1,29,-11,-3,-3,4,1,0,1,1,0,1,1,0,1,1,0,1,1,0,-1,-8,-2,-5,7,-2,0,0,1,-1,0,-1,4,-1
KR_6726334822,420,0,-16,0,5,2,1,3,1,4,5,-2,5,3,2,1,3,2,0,2,0,12,-29,-1,-8,9,21,0,0,1,0,1,1,3,-1
KR_6768348284,420,1,60,25,1,0,2,2,-5,6,1,1,1,2,5,0,5,0,1,1,0,3,209,2,-7,5,2,0,0,1,-1,0,-1,2,-1
KR_6768900778,420,1,-41,0,3,3,0,3,-5,7,2,2,1,3,1,0,1,2,1,3,0,-1,30,5,-10,5,1,0,0,-1,-1,0,-1,5,-1
KR_6766551062,420,-1,18,0,-2,-3,4,1,0,5,5,-4,6,2,-1,3,2,6,1,7,0,-8,-10,-2,-4,6,1,0,0,-1,-1,1,1,6,-1
KR_6741204891,420,-1,15,-25,-7,-1,1,0,-2,4,2,-2,2,0,-2,5,3,0,1,1,0,-8,-34,2,-7,5,2,0,0,1,-1,0,-1,5,-1
KR_6764104870,420,-1,23,2,5,-2,3,1,2,2,4,2,0,2,1,1,2,2,0,2,0,9,-4,-2,-5,7,9,0,0,1,1,-1,1,3,-1
KR_6758533193,420,-6,-104,-38,-13,-2,4,2,-7,9,2,1,2,3,-4,4,0,-1,1,0,1,-11,-25,1,-10,9,-9,0,-2,0,-1,-1,1,0,-1
KR_6713346353,420,-1,-21,-24,-7,0,2,2,1,0,1,-5,5,0,-2,3,1,-1,3,2,0,-7,-8,-3,-6,9,2,0,0,1,1,0,-1,4,-1
KR_6745364903,420,-5,27,-32,-11,0,2,2,-2,5,3,-7,7,0,-1,5,4,-1,2,1,0,-12,10,6,-9,3,-3,0,2,-1,1,1,-1,6,-1
KR_6667884343,420,-4,-51,-16,-12,-5,6,1,0,3,3,-2,3,1,-3,4,1,-2,2,0,0,-10,6,0,-5,5,2,0,-1,-1,-1,-1,-1,2,-1
KR_6753153187,440,-1,-48,-35,-5,-2,3,1,-2,5,3,3,0,3,0,1,1,-4,4,0,-2,-7,-3,-4,-3,7,0,0,-2,-1,-1,-1,-1,3,-1
KR_6765671547,420,-3,-38,-31,-2,-6,6,0,0,2,2,0,3,3,6,1,7,-2,2,0,0,3,8,6,-9,3,0,0,-2,-1,1,-1,1,3,-1
KR_6765739486,420,-2,-4,20,-7,-3,3,0,-1,2,1,-3,3,0,-1,3,2,1,1,2,0,-6,2,5,-7,2,-1,0,0,1,1,0,1,5,-1
KR_6732617548,440,-1,1,28,-1,0,1,1,1,5,6,-2,3,1,0,2,2,0,1,1,0,-2,-92,0,-4,4,-1,0,0,1,1,0,1,1,-1
KR_6715148490,420,2,11,-12,6,4,0,4,2,4,6,0,2,2,1,0,1,-1,2,1,0,7,-13,-3,-4,7,7,0,1,1,-1,1,1,6,-1
KR_6675817598,440,-1,10,21,-8,-5,5,0,1,0,1,2,2,4,-1,3,2,-5,6,1,0,-5,2,1,-3,2,0,0,-1,-1,0,-1,1,1,-1
KR_6764134723,420,-3,-139,-19,-4,0,2,2,-1,2,1,0,3,3,-1,9,8,-2,2,0,0,-6,136,-2,-8,10,-8,0,-1,-1,1,-1,1,2,-1
KR_6762149177,420,2,-58,4,7,-5,7,2,3,2,5,4,0,4,4,1,5,1,1,2,1,20,-130,-7,-3,10,2,0,-1,1,-1,-1,1,3,-1
KR_6743525671,420,-4,-59,-33,-11,-4,5,1,-1,3,2,-2,2,0,-2,4,2,-2,3,1,-2,-15,-3,-2,-6,8,2,0,-1,-1,-1,-1,-1,5,-1
KR_6764640834,440,-4,25,-8,-3,-3,3,0,-1,3,2,0,2,2,-1,1,0,2,1,3,0,-11,-1,2,-7,5,1,0,0,1,-1,0,-1,3,-1
KR_6721128488,420,3,105,-14,0,2,2,4,-1,4,3,3,1,4,-4,6,2,0,2,2,0,-2,-12,-4,-3,7,4,0,1,1,-1,1,-1,4,-1
KR_6767023595,420,1,4,-23,-2,1,0,1,-2,3,1,0,3,3,0,0,0,-1,2,1,0,-3,-11,3,-6,3,5,0,0,1,-1,0,-1,1,-1
KR_6763337568,420,-6,-8,-12,-15,0,2,2,5,1,6,-17,18,1,-1,2,1,-2,2,0,0,-17,3,1,-6,5,-2,0,-2,1,-1,-1,-1,1,-1
KR_6743451035,420,-2,-60,-24,-4,-6,8,2,9,1,10,-5,5,0,0,1,1,-2,2,0,0,-1,-23,-5,-1,6,-4,0,0,1,0,0,1,6,-1
KR_6765596333,420,2,40,11,6,3,1,4,-3,3,0,4,0,4,1,4,5,1,0,1,-1,-3,-7,-4,-6,10,2,0,1,-1,1,1,-1,6,-1
KR_6768487055,420,-5,-58,-4,-11,-3,3,0,-2,5,3,-1,3,2,-4,4,0,-1,1,0,-1,-9,-2,-7,-1,8,0,0,-1,-1,-1,-1,-1,4,-1
KR_6764919681,420,3,25,11,10,2,4,6,2,1,3,1,1,2,6,0,6,-1,1,0,0,13,-8,1,-5,4,6,0,0,-1,1,-1,1,3,-1
KR_6711649288,420,3,1,23,5,0,1,1,1,5,6,2,0,2,2,2,4,0,2,2,0,4,3,0,-4,4,6,0,1,-1,1,1,-1,2,-1
KR_6734541373,440,1,-22,-9,-2,3,2,5,-2,2,0,-1,3,2,-1,3,2,-1,3,2,0,9,-17,0,-6,6,-3,0,-1,0,1,-1,1,0,-1
KR_6744972080,420,0,-57,5,-5,-2,3,1,-5,7,2,1,3,4,1,1,2,0,1,1,0,-4,12,0,-5,5,0,0,0,1,1,0,-1,2,-1
KR_6755141996,420,-5,-47,3,-11,-1,4,3,-5,6,1,1,5,6,-5,6,1,-1,1,0,-1,-6,37,2,-5,3,-6,0,0,-1,1,-1,-1,5,-1
KR_6698172971,440,-4,-62,-4,-10,0,0,0,-8,11,3,-1,2,1,-4,5,1,3,1,4,0,-4,-5,1,-6,5,-5,0,-1,-1,-1,-1,-1,3,-1
KR_6667285399,420,-1,-33,12,-3,-1,2,1,0,6,6,-1,3,2,0,2,2,-1,1,0,0,-14,-28,4,-7,3,-5,0,-1,1,-1,-1,1,3,-1
KR_6754569262,420,-1,-45,48,4,-2,2,0,0,1,1,1,2,3,2,3,5,3,0,3,-1,-5,-1,-3,-4,7,-2,0,-4,-1,-1,-1,-1,2,-1
KR_6743688231,420,3,1,4,7,0,1,1,3,3,6,0,2,2,2,0,2,2,2,4,0,18,-6,1,-8,7,1,0,3,1,1,1,1,4,-1
KR_6755227992,420,-2,-1,6,-3,-4,4,0,4,1,5,-4,8,4,0,3,3,1,0,1,0,3,-24,-4,-4,8,2,0,0,-1,1,-1,1,1,-1
KR_6761937793,420,1,51,-22,-5,2,0,2,-1,2,1,-2,5,3,-1,2,1,-3,3,0,0,-17,-49,3,-7,4,23,0,0,-1,-1,1,1,5,-1
KR_6672844128,420,0,20,0,-5,1,1,2,-5,6,1,-1,1,0,0,2,2,0,1,1,1,-12,-2,-3,-3,6,1,0,1,-1,0,1,-1,5,-1
KR_6728649342,420,0,26,-1,1,3,1,4,-3,4,1,1,1,2,0,0,0,0,0,0,0,-3,-43,-2,-5,7,-2,0,1,1,-1,1,1,5,-1
KR_6575532573,420,-1,-24,-13,-8,-3,3,0,-1,5,4,-5,8,3,1,3,4,0,1,1,0,-14,-5,-2,-3,5,-4,0,0,-1,-1,-1,-1,3,-1
KR_6660531081,420,0,13,2,-4,-2,2,0,1,4,5,0,3,3,-4,5,1,1,3,4,0,-11,37,7,-11,4,-7,0,0,-1,1,1,1,5,-1
KR_6695150681,420,-4,-50,-32,-5,-5,5,0,3,2,5,-2,2,0,-3,4,1,2,0,2,0,-5,-21,6,-12,6,-3,0,-1,1,-1,-1,1,2,-1
KR_6749198590,420,0,0,22,-4,2,0,2,-4,8,4,-1,2,1,-1,6,5,0,0,0,-2,-8,0,-6,-4,10,-4,0,0,1,0,0,-1,1,-1
KR_6760449186,420,-5,-73,-18,-7,-4,4,0,0,1,1,-2,3,1,1,1,2,-2,4,2,0,-1,-3,-2,-2,4,4,0,-1,-1,-1,-1,1,1,-1
KR_6754760094,420,-1,-20,7,-3,2,0,2,-1,3,2,1,0,1,-2,2,0,-3,4,1,0,0,17,1,-7,6,3,0,0,-1,1,-1,-1,1,-1
KR_6508516095,420,-3,-47,7,-2,-1,1,0,3,2,5,-4,4,0,-1,3,2,1,0,1,0,1,-12,0,-7,7,5,0,-1,-1,1,-1,1,5,-1
KR_6758483410,420,-1,-22,23,-7,-5,5,0,2,1,3,2,0,2,-6,6,0,0,0,0,-1,-4,-3,0,-9,9,1,0,-2,-1,-1,-1,-1,1,-1
KR_6725859255,420,-4,-71,-16,-12,-2,2,0,-2,3,1,-3,4,1,-1,4,3,-4,6,2,-1,-14,-282,2,-8,6,-1,0,-1,1,-1,-1,-1,1,-1
KR_6764278534,420,-1,-108,10,-4,-3,3,0,2,3,5,-1,1,0,-2,5,3,0,0,0,0,-4,-3,3,-8,5,2,0,0,1,1,0,1,3,-1
KR_6767546638,420,2,53,8,7,5,0,5,1,3,4,-2,5,3,-5,10,5,8,1,9,1,2,-1,0,-8,8,4,0,0,1,-1,0,1,2,-1
KR_6645233009,420,-2,-8,-12,-4,0,3,3,0,6,6,-5,6,1,0,2,2,1,0,1,0,-6,5,-3,-5,8,-4,0,1,-1,1,1,-1,3,-1
KR_6748623935,420,-2,-13,8,-4,0,3,3,-3,3,0,-1,3,2,0,2,2,0,1,1,0,-3,8,1,-8,7,3,0,0,1,1,0,-1,1,-1
KR_6690025006,420,-3,-20,-41,-6,3,0,3,-5,5,0,-1,3,2,-2,2,0,-1,2,1,-1,-12,-10,1,-5,4,-5,0,-1,-1,-1,-1,-1,4,-1
KR_6768399269,420,5,11,11,10,0,2,2,1,1,2,0,0,0,11,1,12,-2,2,0,0,9,23,-1,-5,6,3,0,1,1,-1,1,1,5,-1
KR_6762671634,420,-5,-64,-8,-14,-3,3,0,-3,6,3,-1,4,3,-6,6,0,-1,2,1,0,-12,-1,-2,-2,4,-1,0,-3,0,-1,-1,-1,0,-1
KR_6760123171,420,-2,-17,-20,-1,0,2,2,2,2,4,-1,2,1,-1,5,4,-1,1,0,0,0,-22,-4,-3,7,5,0,-1,-1,0,-1,1,4,-1
KR_6740772098,420,-2,-9,-12,-6,-2,2,0,1,5,6,-9,11,2,4,1,5,0,0,0,-1,-2,-61,3,-6,3,-2,0,0,-1,1,-1,-1,5,-1
KR_6763550005,440,3,20,21,21,7,1,8,-2,2,0,5,2,7,7,4,11,4,0,4,4,22,-344,2,-2,0,0,0,1,0,0,1,1,0,-1
KR_6764754661,420,-4,-51,-28,-6,-2,3,1,1,6,7,-2,5,3,-4,4,0,1,0,1,0,-5,10,3,-6,3,-6,0,-1,-1,-1,-1,-1,3,-1
KR_6659196164,420,-1,-37,-12,-3,2,3,5,0,3,3,-1,3,2,-4,7,3,0,0,0,1,0,-7,2,-7,5,-3,0,-1,-1,1,-1,1,6,-1
KR_6761668205,420,0,-55,0,0,-1,2,1,1,2,3,-1,2,1,2,2,4,-1,1,0,0,10,10,1,-6,5,1,0,0,-1,1,0,-1,4,-1
KR_6755138864,420,-2,15,-21,-1,1,1,2,-1,1,0,-4,4,0,1,1,2,2,0,2,0,-3,-18,-2,-6,8,10,0,0,-1,1,0,-1,6,-1
KR_6764052469,420,0,7,-28,-9,-1,2,1,-3,6,3,0,2,2,-4,5,1,-1,3,2,0,-8,1,1,-5,4,-1,0,-2,-1,-1,-1,1,2,-1
KR_6730055217,420,-7,-76,12,-19,-6,6,0,-8,9,1,-3,3,0,-2,2,0,0,2,2,-1,-16,34,-5,-4,9,-19,0,-3,-1,-1,-1,-1,5,-1
KR_6747787658,420,-3,-1,-13,0,-1,4,3,1,1,2,6,1,7,-3,3,0,-3,4,1,0,-6,3,1,-7,6,1,0,-1,-1,-1,1,-1,4,-1
KR_6765047062,420,-1,45,17,-3,-2,2,0,4,3,7,-2,4,2,-3,5,2,0,0,0,0,-5,0,-4,-3,7,-7,0,-1,-1,1,-1,-1,3,-1
KR_6761791119,420,0,-23,26,-8,-1,3,2,-6,8,2,1,1,2,-2,5,3,0,1,1,-2,-23,-3,-4,-4,8,-2,0,-1,-1,1,1,-1,3,-1
KR_6765975842,420,1,-4,7,2,-2,3,1,2,3,5,6,1,7,-4,4,0,0,1,1,-2,-7,-7,-2,-3,5,3,0,0,1,-1,1,-1,6,-1
KR_6767492302,420,1,-25,-38,1,0,3,3,5,1,6,1,2,3,-4,5,1,-1,1,0,-1,-4,-3,1,-5,4,2,0,1,1,1,1,-1,1,-1
KR_6749455029,420,-2,-41,41,-12,0,2,2,0,1,1,-3,3,0,-8,10,2,-1,1,0,0,-21,-9,-3,-3,6,-3,0,-1,1,1,-1,-1,3,-1
KR_6761997395,420,-5,-55,-33,-9,-4,5,1,-2,6,4,-4,5,1,1,4,5,0,0,0,3,-3,-4,5,-11,6,-3,0,-2,1,-1,-1,1,4,-1
KR_6768810360,420,0,-55,29,1,0,1,1,2,2,4,0,2,2,-1,3,2,0,0,0,-1,4,3,0,-4,4,-4,0,1,1,1,-1,-1,4,-1
KR_6720010275,420,0,-2,1,3,-4,5,1,6,3,9,1,4,5,1,1,2,-1,1,0,1,7,-4,-1,-5,6,4,0,-2,1,-1,-1,1,5,-1
KR_6769093980,440,-3,17,0,-13,0,1,1,-5,10,5,-2,4,2,-3,5,2,-3,4,1,0,-21,-3,-3,-4,7,4,0,0,1,0,1,-1,1,-1
KR_6768825034,420,-4,-9,6,-11,-4,4,0,0,2,2,0,2,2,-7,9,2,0,2,2,0,-9,44,0,-4,4,-22,0,0,-1,-1,-1,-1,6,-1
KR_6765303954,420,-1,-21,22,-10,-2,3,1,1,3,4,-3,4,1,-7,7,0,1,0,1,0,-5,1,-7,-2,9,6,0,0,-1,1,-1,1,5,-1
KR_6760604080,420,1,-1,15,8,3,0,3,3,5,8,-1,3,2,6,0,6,-3,3,0,0,4,12,6,-9,3,-1,0,2,0,-1,1,-1,0,-1
KR_6758736543,420,-1,17,26,-2,0,1,1,2,2,4,0,3,3,-2,5,3,-2,3,1,0,2,-9,-1,-6,7,0,0,-1,1,0,-1,1,3,-1
KR_6766645026,420,1,42,-6,3,0,2,2,0,2,2,-2,5,3,-1,3,2,6,0,6,1,10,10,1,-7,6,-1,0,0,-1,-1,0,1,5,-1
KR_6732507946,420,-5,-28,-20,-11,-2,2,0,-1,2,1,-7,7,0,-2,2,0,1,0,1,0,-7,-8,-7,-1,8,3,0,-2,-1,0,-1,-1,1,-1
KR_6762679812,420,-2,-59,-79,1,1,2,3,-2,3,1,-2,3,1,3,2,5,1,1,2,-1,11,6,4,-7,3,2,0,-1,-1,-1,-1,-1,1,-1
KR_6765237408,420,0,-31,3,4,-1,2,1,-4,4,0,1,1,2,7,0,7,1,1,2,-2,-3,19,3,-10,7,-9,0,0,-1,1,0,-1,6,-1
KR_6684276678,420,-1,-8,12,1,2,0,2,1,2,3,-1,2,1,-1,3,2,0,1,1,0,-3,-4,-2,-5,7,0,0,-2,1,1,-1,1,2,-1
KR_6760070528,420,-2,4,-36,6,2,1,3,-2,3,1,2,2,4,2,6,8,2,1,3,1,6,2,-1,-7,8,-6,0,1,1,0,1,-1,2,-1
KR_6747337840,420,-2,-74,-44,-5,0,1,1,-2,6,4,1,1,2,-3,4,1,-1,2,1,0,-7,5,3,-6,3,2,0,-1,-1,-1,-1,1,3,-1
KR_6760090526,420,-1,22,-8,-2,0,1,1,-1,3,2,0,1,1,1,0,1,-2,2,0,0,-3,-21,0,-7,7,-1,0,0,-1,1,0,-1,5,-1
KR_6643144962,420,-1,-38,-22,4,0,0,0,3,3,6,2,1,3,-1,4,3,0,1,1,0,13,169,1,-8,7,0,0,-1,1,-1,-1,1,4,-1
KR_6748938871,420,-3,-55,19,-3,1,2,3,0,7,7,0,4,4,-4,6,2,0,2,2,0,-4,22,-2,-6,8,-2,0,-1,-1,1,1,-1,2,-1
KR_6755848898,420,2,28,19,-8,-5,5,0,-5,7,2,3,1,4,-3,5,2,2,1,3,0,-3,-2,-7,-2,9,1,0,0,-1,-1,-1,-1,4,-1
KR_6763294770,420,-1,-24,28,-7,-8,8,0,-1,1,0,1,3,4,0,2,2,1,1,2,0,-7,9,2,-6,4,-6,0,0,1,-1,-1,-1,5,-1
KR_6755100993,420,-3,-60,-53,-7,-1,1,0,-7,7,0,1,1,2,2,1,3,-2,2,0,0,-4,-1,-1,-4,5,0,0,-2,-1,-1,-1,-1,6,-1
KR_6764770596,420,0,31,1,2,2,1,3,-5,7,2,0,1,1,4,0,4,1,0,1,0,-4,4,-2,-5,7,-3,0,0,1,-1,0,1,3,-1
KR_6750305677,420,0,9,-1,-4,-2,3,1,-2,4,2,1,3,4,-1,1,0,0,0,0,0,-6,-11,2,-6,4,1,0,0,-1,1,0,-1,3,-1
KR_6747046421,420,-1,-52,-12,3,-1,3,2,1,1,2,2,0,2,1,3,4,0,1,1,0,12,-2,2,-7,5,-3,0,0,1,1,-1,-1,4,-1
KR_6604210566,420,-5,-100,-36,-9,-3,3,0,-3,4,1,-2,3,1,-1,2,1,0,0,0,0,-8,0,5,-9,4,-4,0,0,-1,1,-1,-1,4,-1
KR_6766850659,420,0,-11,29,-7,-1,2,1,-1,2,1,-4,5,1,2,1,3,-3,3,0,0,-12,2,-4,-3,7,-2,0,0,-1,0,0,-1,5,-1
KR_6754581611,420,-6,-86,-14,-19,-7,7,0,0,2,2,-3,5,2,-9,9,0,0,2,2,0,-11,13,3,-9,6,-5,0,-3,-1,1,-1,-1,3,-1
KR_6698047032,420,-3,-105,12,-6,3,0,3,2,1,3,-8,9,1,-1,4,3,-2,2,0,0,-10,-1,-3,-3,6,-3,0,-2,-1,-1,-1,1,1,-1
KR_6765749578,420,-1,4,-50,-1,5,0,5,-5,6,1,0,1,1,0,2,2,-1,1,0,0,-8,-13,-6,-2,8,2,0,0,-1,-1,1,-1,2,-1
KR_6762631818,420,-2,-10,0,-4,-3,3,0,-4,6,2,1,1,2,2,0,2,0,3,3,0,-4,-1,1,-5,4,1,0,-1,-1,1,-1,1,5,-1
KR_6616199678,420,-3,-14,-15,-2,-1,4,3,5,1,6,0,1,1,-2,5,3,-4,5,1,-1,7,-8,4,-11,7,-4,0,-1,-1,1,-1,-1,5,-1
KR_6691998635,440,1,23,-20,12,2,1,3,2,2,4,4,1,5,4,1,5,0,2,2,1,12,-3,8,-9,1,0,0,2,0,1,1,1,0,-1
KR_6720170415,420,-8,-113,-18,-13,0,2,2,-3,7,4,1,1,2,-1,2,1,-10,10,0,-1,-5,-335,1,-3,2,-3,0,-6,-1,-1,-1,-1,3,-1
KR_6757748937,420,-3,-97,-7,-3,-1,4,3,2,1,3,-1,4,3,-2,2,0,-1,3,2,0,-3,23,1,-5,4,-5,0,-1,1,-1,-1,-1,2,-1
KR_6759801539,420,-2,-45,15,-6,-3,3,0,-4,4,0,-2,3,1,-1,3,2,4,0,4,0,-2,-17,-8,-6,14,2,0,-2,1,1,-1,-1,5,-1
KR_6766166227,420,-2,51,-12,-11,-1,1,0,-1,3,2,1,2,3,-3,5,2,-7,8,1,0,-16,8,2,-7,5,-5,0,-2,-1,-1,-1,-1,1,-1
KR_6722507235,440,-2,-62,6,-10,-6,7,1,1,2,3,-2,3,1,-1,2,1,-2,2,0,0,-15,-163,0,-4,4,-2,0,-2,-1,0,-1,1,6,-1
KR_6746275969,420,-2,-77,-32,-3,-2,3,1,2,0,2,3,0,3,-6,6,0,0,0,0,0,-6,-8,-3,-3,6,-1,0,0,-1,-1,-1,-1,2,-1
KR_6655807793,440,-3,-47,16,-1,0,3,3,-3,7,4,-2,4,2,6,0,6,-2,3,1,-1,-1,4,-2,-6,8,-2,0,1,-1,1,1,-1,3,-1
KR_6722345155,420,1,71,-29,-2,1,2,3,1,4,5,0,4,4,-3,4,1,-1,2,1,-1,-8,9,4,-7,3,2,0,0,1,-1,-1,-1,2,-1
KR_6765749217,420,-1,-13,-25,1,-1,1,0,0,5,5,1,2,3,-1,3,2,2,0,2,0,-8,2,0,-2,2,-1,0,1,-1,1,1,1,4,-1
KR_6766943651,440,-5,-114,-34,-8,0,3,3,2,1,3,-3,4,1,-4,4,0,-3,4,1,0,-13,-16,-3,0,3,1,0,-2,1,0,-1,-1,5,-1
KR_6743337793,420,-1,-21,-9,-2,0,1,1,-3,4,1,-2,2,0,1,2,3,2,0,2,-1,1,-2,0,-7,7,-4,0,-1,-1,-1,-1,-1,4,-1
KR_6708492604,420,-4,-109,4,-6,-2,3,1,-2,4,2,-1,3,2,-1,2,1,0,2,2,0,-7,132,2,-7,5,-4,0,-1,1,-1,-1,-1,1,-1
KR_6634137189,420,0,-102,11,3,1,1,2,0,1,1,4,1,5,-1,2,1,-1,2,1,0,2,5,3,-11,8,-4,0,-1,1,-1,-1,1,2,-1
KR_6757202262,420,2,13,23,7,0,3,3,5,0,5,3,1,4,-1,4,3,0,1,1,0,8,-5,3,-10,7,-2,0,1,1,1,1,-1,4,-1
KR_6752779715,420,2,-37,10,7,-3,3,0,0,3,3,2,0,2,7,2,9,1,1,2,0,9,21,0,-4,4,-5,0,0,1,1,0,1,2,-1
KR_6674956996,420,-1,10,-16,-7,2,0,2,-3,3,0,-4,4,0,-2,6,4,0,1,1,0,-11,8,1,-8,7,-4,0,0,-1,-1,-1,-1,2,-1
KR_6734594872,420,1,-9,-8,3,4,1,5,0,3,3,-4,4,0,2,2,4,1,1,2,-3,2,12,3,-7,4,-1,0,2,-1,1,1,-1,3,-1
KR_6736085833,420,1,-18,0,-3,-1,1,0,-1,7,6,-2,2,0,-3,4,1,4,0,4,-1,2,1,-2,-2,4,-2,0,-1,1,-1,-1,1,4,-1
KR_6732023693,420,-2,-65,-3,-2,0,0,0,2,3,5,-1,4,3,-2,7,5,-1,1,0,-1,-4,-17,-3,-7,10,1,0,-1,1,-1,-1,-1,6,-1
KR_6724942850,420,-2,-51,-23,-4,2,0,2,0,3,3,-1,1,0,-5,6,1,0,1,1,0,-4,-6,1,-6,5,-2,0,0,-1,1,-1,1,2,-1
KR_6695341991,420,0,-6,4,-5,0,1,1,-1,2,1,-3,5,2,-4,5,1,3,0,3,-3,-7,-16,3,-6,3,-2,0,0,-1,1,-1,-1,6,-1
KR_6768265778,420,1,5,8,-7,0,0,0,-5,7,2,-1,2,1,-1,1,0,0,0,0,1,-5,312,-3,-4,7,-4,0,0,-1,-1,-1,1,5,-1
KR_6754305121,420,-2,-36,43,-7,-3,3,0,0,2,2,0,2,2,-4,5,1,0,0,0,0,-7,0,2,-5,3,-2,0,-2,1,0,-1,-1,3,-1
KR_6762177529,420,1,46,4,-2,-4,5,1,1,3,4,3,2,5,-2,3,1,0,1,1,0,-11,3,-1,-4,5,2,0,0,1,1,1,-1,2,-1
KR_6762217223,420,-2,-45,0,-4,-2,4,2,-2,3,1,1,0,1,-1,1,0,0,0,0,0,-7,-19,-2,-3,5,-1,0,0,1,1,0,-1,1,-1
KR_6765513119,420,-3,-17,0,-6,-1,3,2,1,3,4,-4,6,2,-2,5,3,0,0,0,0,-7,-22,-4,-4,8,2,0,-1,-1,1,-1,-1,3,-1
KR_6756049334,420,2,42,-7,-4,0,0,0,4,0,4,-7,7,0,-1,1,0,0,0,0,0,-9,2,-3,-7,10,-2,0,0,-1,-1,0,1,1,-1
KR_6719949755,420,-3,-24,16,-6,-3,6,3,0,2,2,-4,4,0,-1,4,3,2,0,2,1,-3,16,3,-6,3,-7,0,1,1,-1,1,1,5,-1
KR_6768016827,420,0,42,21,-1,-3,5,2,-1,3,2,6,0,6,-4,4,0,1,0,1,0,-2,36,1,-4,3,-2,0,-1,1,-1,-1,1,3,-1
KR_6748267214,420,-5,-66,-6,-8,0,1,1,1,2,3,-1,3,2,-7,10,3,-1,2,1,-2,-13,34,-3,-4,7,-5,0,-2,-1,1,-1,1,1,-1
KR_6757635095,420,0,-3,-6,3,4,1,5,-1,2,1,0,2,2,3,2,5,-3,3,0,-1,-2,-10,2,-5,3,0,0,0,-1,1,0,-1,3,-1
KR_6765032855,420,-3,-38,-4,-2,0,1,1,-1,2,1,-5,5,0,4,0,4,0,1,1,0,2,-7,0,-5,5,1,0,-2,1,-1,-1,1,5,-1
KR_6731191042,420,-3,-19,-20,-14,0,0,0,-2,2,0,-5,6,1,-6,6,0,-1,2,1,0,-22,-3,-3,-4,7,-6,0,-2,-1,-1,-1,-1,4,-1
KR_6746018608,420,-2,-30,-19,-2,-1,1,0,1,0,1,0,1,1,1,0,1,-3,3,0,0,-3,101,0,-5,5,-1,0,-1,1,-1,-1,-1,6,-1
KR_6496227972,420,-1,-34,-11,-2,-2,4,2,4,2,6,-5,7,2,1,2,3,0,0,0,-1,-5,5,4,-8,4,-7,0,0,1,1,0,-1,4,-1
KR_6765147715,420,-2,-42,-28,-2,2,0,2,-1,2,1,-1,5,4,-4,7,3,2,0,2,-1,-1,26,-7,-7,14,6,0,-1,-1,-1,-1,-1,2,-1
KR_6765276686,420,-1,-40,4,1,2,0,2,-1,1,0,2,3,5,-2,7,5,0,0,0,0,2,2,0,-6,6,-3,0,-1,-1,1,-1,1,6,-1
KR_6762047842,420,-3,9,-10,-12,1,0,1,-2,5,3,-6,8,2,-4,4,0,-1,2,1,0,-14,-7,0,-4,4,-4,0,-1,1,1,-1,-1,6,-1
KR_6761950141,420,-2,-114,4,-5,-2,4,2,-2,4,2,-2,5,3,1,2,3,0,2,2,0,-3,-2,-4,-4,8,-1,0,0,-1,1,-1,1,1,-1
KR_6729840276,420,-2,-20,-19,-3,1,2,3,-1,4,3,0,1,1,-3,6,3,0,1,1,0,-4,-128,-4,-3,7,-1,0,-1,-1,1,-1,-1,2,-1
KR_6766751361,420,-3,-15,-34,3,-1,2,1,-1,2,1,1,1,2,1,2,3,3,0,3,0,8,5,4,-6,2,-3,0,-2,-1,-1,-1,1,3,-1
KR_6724723512,440,2,147,-8,6,4,0,4,2,1,3,1,0,1,-1,3,2,0,0,0,0,6,-42,-3,-6,9,0,0,1,-1,1,1,1,6,-1
KR_6756562113,420,-1,33,0,-7,0,2,2,0,5,5,1,2,3,-5,6,1,-3,4,1,0,-1,1,-1,-6,7,1,0,2,1,1,1,1,3,-1
KR_6728801794,440,-1,35,0,2,2,1,3,0,1,1,-3,4,1,3,2,5,0,2,2,0,2,-1,0,-2,2,-1,0,0,-1,-1,0,1,4,-1
KR_6766666826,420,-3,-81,-3,-5,-1,3,2,2,2,4,-2,3,1,-2,6,4,-2,2,0,1,-6,33,-7,-3,10,-1,0,0,1,1,0,1,2,-1
KR_6748414485,440,-4,-71,-21,-12,-8,8,0,2,0,2,0,1,1,-5,8,3,-1,1,0,0,-13,8,1,-7,6,1,0,-1,-1,1,-1,-1,2,-1
KR_6767046483,420,1,-14,10,4,-3,6,3,4,2,6,1,0,1,4,0,4,-2,3,1,0,8,146,4,-9,5,-2,0,0,1,-1,1,-1,3,-1
KR_6735874841,420,1,-5,13,6,4,0,4,0,0,0,2,2,4,-2,3,1,2,1,3,0,7,17,1,-6,5,-4,0,1,1,1,1,-1,4,-1
KR_6620134144,420,-2,-11,20,-3,1,3,4,-1,5,4,-1,3,2,-2,3,1,0,2,2,-1,-11,-8,-2,-5,7,0,0,-1,1,-1,-1,-1,5,-1
KR_6708587341,420,-1,-36,-29,1,0,2,2,-1,4,3,-1,5,4,2,1,3,1,0,1,0,9,37,2,-4,2,-3,0,1,-1,1,1,1,4,-1
KR_6733954749,420,-4,-19,5,-13,-2,3,1,-6,7,1,1,2,3,1,1,2,-7,8,1,0,-20,-2,-2,-4,6,-1,0,-2,-1,-1,-1,-1,5,-1
KR_6670455092,420,0,-33,40,-2,0,3,3,1,2,3,3,2,5,-6,7,1,0,0,0,0,2,10,4,-9,5,-7,0,0,-1,1,-1,-1,2,-1
KR_6726928016,420,-2,-44,-3,-7,-3,3,0,-1,6,5,-1,1,0,-3,3,0,1,0,1,-1,-7,21,-1,-5,6,-19,0,-1,-1,1,-1,-1,3,-1
KR_6751127174,440,-1,-88,52,8,-3,5,2,2,3,5,1,1,2,3,0,3,5,2,7,0,14,260,1,-4,3,-1,0,-1,1,1,1,1,2,-1
KR_6763469584,420,-3,-31,-11,-2,2,0,2,-2,3,1,-3,3,0,4,0,4,-3,4,1,0,-4,-27,1,-4,3,-8,0,0,-1,-1,0,1,2,-1
KR_6742208821,420,2,25,1,2,-1,2,1,-2,5,3,0,4,4,1,5,6,4,1,5,-1,-5,24,-4,-4,8,-18,0,1,-1,1,1,-1,5,-1
KR_6612735842,420,-4,-21,19,-13,1,0,1,-7,8,1,-3,5,2,-4,6,2,0,0,0,-1,-25,-18,-2,-6,8,-4,0,-2,-1,1,-1,-1,2,-1
KR_6764153022,420,0,31,17,1,-1,1,0,0,1,1,-1,5,4,1,1,2,2,1,3,0,2,4,5,-7,2,-2,0,-1,1,-1,-1,1,5,-1
KR_6754608903,420,-3,-29,-12,-6,0,2,2,1,2,3,0,0,0,-5,6,1,-2,3,1,0,-6,5,6,-9,3,-3,0,-1,-1,1,-1,-1,6,-1
KR_6754506960,420,-3,5,-3,-9,-4,8,4,0,4,4,0,4,4,-5,5,0,0,0,0,1,-13,2,0,-8,8,1,0,0,-1,1,1,1,5,-1
KR_6697175317,420,-2,46,-22,1,-1,2,1,-3,6,3,1,3,4,3,0,3,1,1,2,1,4,-12,-5,-4,9,9,0,1,1,-1,1,1,6,-1
KR_6655725061,440,-4,-28,-16,-5,-3,3,0,-2,3,1,4,3,7,-2,6,4,-2,3,1,0,-6,-4,-3,-4,7,0,0,1,-1,1,-1,1,4,-1
KR_6705941183,420,-1,27,4,-11,-10,10,0,-5,5,0,0,2,2,-1,4,3,5,0,5,0,-13,3,-3,-2,5,0,0,-1,1,-1,-1,-1,2,-1
KR_6697320324,440,1,-34,28,0,-1,1,0,1,0,1,0,1,1,1,0,1,-1,1,0,0,1,7,-1,-5,6,2,0,0,1,-1,-1,-1,3,-1
KR_6717466081,420,-3,-32,-31,-5,-5,6,1,-4,4,0,3,0,3,0,4,4,1,1,2,0,-1,5,1,-5,4,-6,0,0,-1,1,1,-1,5,-1
KR_6757413211,420,-2,-56,1,-5,1,0,1,-3,6,3,5,2,7,-8,8,0,0,0,0,0,-6,-18,-3,-5,8,-2,0,-1,-1,1,-1,1,3,-1
KR_6767457686,420,-5,-25,-5,-15,-4,4,0,-4,4,0,-3,3,0,-1,5,4,-3,3,0,0,-13,-21,-5,-2,7,-1,0,-2,0,-1,-1,-1,0,-1
KR_6766384975,420,-2,-27,1,-6,-1,4,3,0,3,3,-5,5,0,0,2,2,0,1,1,0,-4,-2,-4,-3,7,-5,0,0,1,-1,-1,-1,2,-1
KR_6738833671,420,-1,9,-24,-6,-2,2,0,-4,7,3,-6,7,1,6,0,6,0,4,4,-1,1,-2,-2,-3,5,0,0,-1,-1,1,-1,-1,5,-1
KR_6609440445,420,-4,-54,-25,-8,-1,2,1,-4,7,3,-4,6,2,0,4,4,1,2,3,-1,-10,2,-1,-6,7,2,-1,-1,-1,-1,-1,-1,4,-1
KR_6664635010,420,-2,41,8,-10,-2,4,2,-6,7,1,-1,4,3,-1,4,3,0,2,2,-1,-11,41,-4,-3,7,-26,0,0,-1,-1,-1,-1,2,-1
KR_6767655322,420,-5,-90,6,-1,-3,5,2,-3,3,0,1,3,4,4,3,7,0,0,0,0,4,-7,1,-8,7,-2,0,0,1,-1,-1,-1,4,-1
KR_6762622978,420,0,48,0,-4,3,0,3,-1,7,6,1,0,1,-5,7,2,-2,3,1,0,-6,4,3,-4,1,1,0,-2,1,-1,-1,-1,3,-1
KR_6759189268,420,-1,16,-12,-4,-1,4,3,1,1,2,1,3,4,-5,9,4,0,1,1,0,-6,156,0,-3,3,-2,0,0,-1,1,-1,-1,5,-1
KR_6758795018,420,2,35,2,5,1,1,2,4,1,5,0,2,2,0,3,3,0,2,2,0,9,-3,-2,-5,7,5,0,-1,0,-1,1,1,0,-1
KR_6755303458,420,1,-12,4,-2,1,1,2,2,1,3,0,3,3,-5,6,1,0,2,2,0,-2,212,-4,-5,9,0,0,0,1,1,1,-1,6,-1
KR_6743290243,420,-6,-28,9,-12,-3,4,1,-4,6,2,-1,2,1,-2,2,0,-2,2,0,0,-17,-21,3,-10,7,-1,0,-3,-1,-1,-1,1,4,-1
KR_6553704302,420,-3,-76,-22,-21,-5,5,0,-1,4,3,-2,6,4,-14,14,0,1,0,1,-4,-33,301,-2,-7,9,-2,0,-2,-1,-1,-1,-1,5,-1
KR_6763168106,420,-4,-69,-12,-17,-2,2,0,-7,7,0,-2,3,1,-4,4,0,-2,2,0,-1,-25,-51,-3,-4,7,-5,0,-4,0,-1,-1,-1,0,-1
KR_6768088724,420,0,-7,20,-2,-3,3,0,-1,5,4,4,3,7,-2,5,3,0,1,1,0,-7,-20,-2,-3,5,0,0,-3,0,1,-1,1,0,-1
KR_6761703313,420,0,-18,-36,3,-1,1,0,1,4,5,4,0,4,-2,4,2,1,1,2,0,5,12,7,-9,2,-6,0,-1,-1,-1,1,-1,5,-1
KR_6727435146,420,0,-31,4,-9,-3,3,0,0,3,3,-1,2,1,-5,6,1,0,1,1,0,-11,-1,1,-10,9,-2,0,0,0,1,0,-1,0,-1
KR_6756737231,420,-6,-65,-14,-13,-2,4,2,-6,9,3,-1,1,0,-6,7,1,2,0,2,0,-10,-14,0,-6,6,-5,0,-2,-1,-1,-1,1,5,-1
KR_6758545228,420,-2,-40,-11,-4,-1,2,1,1,4,5,2,2,4,-4,5,1,-2,4,2,0,-2,-18,0,-6,6,-1,0,0,-1,1,0,-1,3,-1
KR_6757573054,420,-3,-28,9,-7,-2,3,1,-3,4,1,0,1,1,-1,4,3,-1,1,0,0,-8,71,-3,-5,8,0,0,-1,-1,-1,-1,-1,5,-1
KR_6750229636,420,2,17,-9,6,-2,3,1,4,3,7,-3,6,3,7,1,8,0,2,2,0,11,130,3,-7,4,3,0,3,-1,1,1,1,3,-1
KR_6746452858,420,-2,-51,-11,-2,1,1,2,-1,9,8,2,0,2,2,0,2,-6,6,0,0,-4,15,4,-7,3,-5,0,-1,-1,-1,-1,1,2,-1
KR_6749620111,420,-1,-63,36,-3,-6,6,0,3,0,3,3,1,4,-2,4,2,-1,1,0,0,3,-112,0,-6,6,-5,0,-1,-1,1,-1,-1,3,-1
KR_6760866461,440,1,-44,8,-4,-1,3,2,-3,4,1,-1,4,3,0,4,4,1,1,2,0,-1,-4,-3,-1,4,5,0,-2,0,-1,-1,-1,0,-1
KR_6519174199,420,-6,-54,-38,-12,-3,3,0,0,4,4,1,1,2,-5,6,1,-5,7,2,0,-15,1,0,-2,2,3,0,-3,-1,-1,-1,1,4,-1
KR_6693897198,420,-3,-58,-3,-5,-4,5,1,2,0,2,-7,8,1,2,3,5,2,0,2,0,-8,1,2,-6,4,-7,0,-2,1,-1,-1,-1,2,-1
KR_6697080842,420,3,3,25,3,-1,4,3,3,3,6,-2,3,1,6,0,6,-3,3,0,0,3,-7,-3,-1,4,4,0,0,1,-1,-1,-1,6,-1
KR_6748344176,440,-4,-102,-12,-9,-3,5,2,-8,11,3,4,3,7,-4,7,3,2,1,3,1,-2,-3,-2,-5,7,1,0,-3,1,-1,-1,1,4,-1
KR_6755765128,440,-5,-53,-35,-8,-4,4,0,0,1,1,-5,6,1,6,1,7,-5,6,1,-2,-5,-6,-4,-3,7,5,0,1,0,-1,-1,-1,0,-1
KR_6760256766,420,-2,-74,13,-5,-4,4,0,3,0,3,1,1,2,-3,4,1,-2,2,0,0,-9,-3,-2,-3,5,0,0,-1,-1,1,-1,-1,5,-1
KR_6764251517,420,2,-27,0,9,2,2,4,4,3,7,1,2,3,3,0,3,-1,3,2,0,13,3,5,-11,6,-2,0,-1,-1,1,-1,-1,6,-1
KR_6761972152,420,-1,-41,-30,-1,-2,2,0,5,2,7,0,1,1,-8,9,1,4,1,5,0,1,-16,5,-9,4,2,0,-1,1,-1,-1,-1,3,-1
KR_6767759589,420,-3,0,-4,-7,-4,4,0,1,1,2,2,1,3,-5,7,2,-1,2,1,-2,-3,-5,2,-7,5,0,0,0,-1,1,-1,-1,6,-1
KR_6752556722,420,-4,-85,7,-11,0,3,3,3,2,5,-5,8,3,-6,7,1,-3,3,0,0,-13,-6,0,-4,4,-2,0,-2,-1,-1,-1,1,2,-1
KR_6765474432,420,-4,-57,-14,-3,0,3,3,-2,4,2,-1,3,2,-1,3,2,1,1,2,0,-3,9,-2,-4,6,1,0,-2,-1,1,-1,1,5,-1
KR_6757838365,420,3,-10,24,3,0,3,3,3,1,4,0,2,2,0,3,3,0,1,1,0,2,7,-1,-5,6,0,0,-1,1,-1,-1,1,3,-1
KR_6766986556,420,0,-3,-1,5,0,2,2,-1,2,1,4,1,5,2,1,3,0,1,1,0,9,6,1,-4,3,-1,0,0,-1,-1,1,-1,4,-1
KR_6758969663,420,-2,6,0,1,-1,2,1,1,3,4,2,0,2,0,4,4,-1,2,1,0,-2,30,4,-6,2,-3,0,0,-1,1,0,-1,6,-1
KR_6768271994,440,0,19,20,-2,1,0,1,-3,3,0,2,0,2,1,0,1,-3,3,0,0,0,45,6,-11,5,-12,0,0,1,0,0,-1,4,-1
KR_6749394929,420,-4,3,-45,-4,-2,3,1,-2,5,3,1,1,2,-1,3,2,0,1,1,0,-3,-20,0,-6,6,1,0,0,1,-1,0,1,4,-1
KR_6756816936,420,-2,41,-7,-4,1,3,4,3,0,3,-3,5,2,-5,7,2,0,1,1,0,-6,-4,-6,-1,7,2,0,-1,-1,1,1,1,6,-1
KR_6767096348,420,-2,-19,-31,-7,1,1,2,-2,3,1,0,3,3,-7,8,1,1,1,2,1,-9,250,-7,-2,9,26,0,0,-1,1,1,1,2,-1
KR_6729000259,420,-2,-58,-6,-7,-1,3,2,-5,8,3,-1,3,2,0,4,4,0,2,2,0,-2,-19,1,-7,6,-5,0,-3,-1,-1,-1,-1,4,-1
KR_6504145345,440,-3,-80,1,-7,-2,3,1,0,8,8,-2,4,2,-3,3,0,0,0,0,0,-10,-12,1,-5,4,-1,0,-1,-1,1,-1,-1,5,-1
KR_6768435118,440,-1,-1,-4,-4,5,0,5,1,1,2,-10,10,0,1,0,1,-1,2,1,0,-2,7,0,-3,3,-4,0,0,0,-1,0,-1,0,-1
KR_6762421584,420,-4,-38,5,-20,-3,5,2,-10,11,1,0,2,2,-3,4,1,-4,4,0,-1,-19,-14,-2,-5,7,1,0,-4,-1,-1,-1,-1,1,-1
KR_6729068761,420,-4,-52,-16,-2,3,0,3,1,1,2,-4,7,3,-3,4,1,1,0,1,0,-1,1,3,-6,3,1,0,0,-1,1,0,1,4,-1
KR_6767350312,420,-2,-13,5,1,-2,4,2,2,4,6,-1,3,2,2,2,4,0,1,1,0,2,1,-2,-4,6,2,0,-1,-1,1,1,1,2,-1
KR_6768319478,420,-5,-124,0,-5,-4,7,3,1,5,6,-3,5,2,1,2,3,0,1,1,0,-7,2,7,-10,3,-5,0,0,-1,1,-1,-1,6,-1
KR_6638161123,420,3,75,28,1,-1,2,1,-1,2,1,2,1,3,1,0,1,0,1,1,0,2,-66,-1,-3,4,0,0,2,1,-1,1,1,5,-1
KR_6764727011,440,-2,2,0,-5,2,0,2,-5,7,2,-4,4,0,2,2,4,0,1,1,-1,-7,-8,-1,-3,4,1,0,0,-1,1,0,-1,3,-1
KR_6728857504,440,-4,-26,3,-13,-4,4,0,-6,6,0,0,3,3,-1,4,3,-2,2,0,0,-8,-18,1,-2,1,0,0,-2,-1,-1,-1,-1,3,-1
KR_6661182202,420,-2,12,-25,-9,-1,1,0,-3,4,1,-3,3,0,-2,2,0,0,0,0,0,-10,10,3,-9,6,-9,0,0,1,1,0,-1,1,-1
KR_6755291891,420,-4,6,1,-10,-1,2,1,-2,7,5,-2,2,0,-3,3,0,-2,2,0,0,-3,-7,-4,-4,8,5,0,-1,-1,-1,-1,-1,4,-1
KR_6768755436,440,0,6,21,4,2,0,2,-1,2,1,1,1,2,1,0,1,1,0,1,0,3,18,-2,-3,5,2,0,0,1,-1,0,1,4,-1
KR_6720141394,420,-4,-33,-19,-9,1,3,4,-3,5,2,-3,6,3,-5,6,1,1,0,1,0,-7,98,3,-4,1,0,0,-2,-1,-1,-1,-1,2,-1
KR_6760030515,440,-4,-15,-68,-9,-2,2,0,-1,3,2,-4,4,0,2,0,2,-4,4,0,0,-10,-2,-2,-3,5,-4,0,0,0,0,0,1,0,-1
KR_6767491975,420,0,-19,-7,4,1,2,3,-2,3,1,0,4,4,3,2,5,2,1,3,0,12,-2,3,-7,4,-1,0,0,-1,1,0,1,4,-1
KR_6764727207,440,-2,-44,-34,-1,0,1,1,-2,5,3,1,2,3,2,0,2,-2,2,0,0,-1,-164,-3,-4,7,-2,0,-1,-1,1,-1,1,5,-1
KR_6758752844,420,0,-19,24,-2,-1,2,1,-3,3,0,1,0,1,1,2,3,0,0,0,0,-2,17,7,-8,1,-1,0,1,-1,1,1,1,4,-1
KR_6764007445,440,-2,-55,38,-4,-6,7,1,-1,4,3,1,1,2,2,1,3,0,0,0,-1,-8,0,-2,-6,8,1,0,-1,-1,1,-1,-1,4,-1
KR_6722581817,420,1,-22,24,0,-1,5,4,0,2,2,2,3,5,-1,4,3,0,0,0,0,7,-1,-1,-9,10,-1,0,-1,-1,1,-1,-1,2,-1
KR_6601612581,420,-5,-40,16,-6,-1,4,3,0,2,2,0,1,1,-4,4,0,-1,1,0,0,-15,11,2,-6,4,-7,0,0,1,1,-1,1,4,-1
KR_6689997574,420,4,51,-4,10,4,1,5,4,2,6,1,3,4,1,3,4,0,2,2,1,4,-52,1,-7,6,15,0,1,1,1,1,1,4,-1
KR_6758844508,420,0,48,-4,4,-5,6,1,2,2,4,3,0,3,3,2,5,1,1,2,0,8,44,-1,-4,5,4,0,-2,1,-1,-1,-1,5,-1
KR_6718561940,440,-2,-94,12,-5,-1,1,0,1,2,3,-2,4,2,-3,4,1,0,1,1,0,-4,6,-2,-4,6,-4,0,0,1,1,0,-1,1,-1
KR_6756421519,420,1,-27,0,-4,-2,3,1,-6,6,0,2,2,4,1,1,2,1,2,3,-1,0,-41,-5,-4,9,5,0,1,1,1,1,-1,5,-1
KR_6768989523,420,-1,-32,36,-10,1,3,4,-6,6,0,1,0,1,-7,7,0,1,1,2,0,-17,-12,-3,-7,10,2,0,0,-1,1,-1,1,4,-1
KR_6758095130,440,-1,11,16,-10,-2,3,1,-6,9,3,2,1,3,-6,7,1,2,0,2,0,-15,18,-4,-1,5,-4,0,-1,0,0,-1,-1,0,-1
KR_6768870855,420,-5,-58,-42,-4,-2,3,1,-4,9,5,1,2,3,2,6,8,-1,2,1,-1,-1,15,-3,-5,8,-5,0,0,1,-1,-1,-1,6,-1
KR_6750444262,420,1,21,4,2,1,2,3,2,4,6,-2,3,1,1,3,4,0,0,0,0,4,-4,-2,-3,5,0,0,-1,-1,1,-1,1,2,-1
KR_6749192778,420,1,31,27,2,5,1,6,1,2,3,-1,3,2,-3,3,0,0,0,0,0,-6,29,1,-7,6,-2,0,0,-1,-1,1,-1,3,-1
KR_6764248316,440,-3,-42,-12,-10,1,0,1,-4,4,0,-3,8,5,-5,5,0,1,0,1,0,-11,-6,-1,-3,4,-2,0,-2,0,-1,-1,-1,0,-1
KR_6764796244,420,0,23,6,2,-2,4,2,0,4,4,-1,3,2,5,0,5,0,1,1,0,-1,4,-9,-3,12,3,0,2,-1,1,1,-1,1,-1
KR_6722649094,420,-3,18,-35,-6,-5,5,0,-1,1,0,0,2,2,3,2,5,-3,3,0,0,-1,-5,-1,-3,4,2,0,-1,1,-1,-1,1,4,-1
KR_6758999712,420,0,-37,23,-3,0,1,1,-4,5,1,0,2,2,-1,4,3,2,0,2,1,-8,6,-3,-6,9,-5,0,0,-1,1,0,-1,4,-1
KR_6740154125,420,-5,-42,-9,-10,1,0,1,-5,5,0,2,3,5,-4,5,1,-4,4,0,0,-13,4,5,-10,5,1,0,0,-1,0,0,1,4,-1
KR_6713438212,420,1,-11,-3,1,3,2,5,2,1,3,-1,4,3,-4,5,1,1,1,2,0,-5,-23,-1,-5,6,-1,0,0,1,-1,-1,1,6,-1
KR_6720528537,420,-1,35,28,1,1,0,1,-3,3,0,1,2,3,2,3,5,0,0,0,0,2,1,1,-7,6,1,0,0,-1,-1,0,1,4,-1
KR_6763254688,420,-1,6,-12,-5,-3,3,0,-1,2,1,3,1,4,-4,5,1,0,1,1,0,-8,-22,1,-9,8,0,0,-1,-1,0,-1,1,5,-1
KR_6761790493,420,0,-13,-7,-1,-1,2,1,-2,4,2,2,2,4,0,1,1,0,0,0,0,3,-34,-1,-3,4,18,0,-1,-1,-1,-1,-1,6,-1
KR_6765348640,420,-1,-6,-27,1,3,0,3,1,3,4,-4,4,0,3,3,6,-2,5,3,2,4,9,3,-8,5,-5,0,0,-1,-1,-1,1,1,-1
KR_6686482234,420,1,23,-45,4,-1,2,1,0,3,3,-1,5,4,1,2,3,5,0,5,1,5,-8,1,-7,6,-2,0,1,1,-1,-1,1,4,-1
KR_6760554099,420,0,-10,16,4,-4,4,0,4,0,4,5,0,5,-2,3,1,1,0,1,0,3,22,1,-5,4,-3,0,1,-1,1,1,-1,3,-1
KR_6761524760,420,-2,-9,-15,3,0,1,1,2,2,4,0,3,3,-1,2,1,2,0,2,1,9,-7,-1,-4,5,3,0,1,-1,1,1,1,2,-1
KR_6742131544,420,-4,-24,-53,-10,1,0,1,-9,11,2,-1,5,4,0,4,4,-1,1,0,-3,-10,-18,2,-5,3,2,0,-2,-1,-1,-1,1,3,-1
KR_6727723147,420,-4,-28,9,-10,0,1,1,-6,6,0,0,0,0,-3,4,1,-1,1,0,0,-15,-1,1,-8,7,-1,0,-2,1,-1,-1,-1,1,-1
KR_6599892931,420,1,74,-25,6,4,0,4,2,2,4,1,4,5,0,0,0,-1,1,0,1,0,0,3,-7,4,2,0,1,-1,1,1,1,5,-1
KR_6760022350,420,-2,-24,-5,-4,-4,4,0,4,1,5,-1,2,1,-5,7,2,2,1,3,0,2,-14,1,-5,4,-4,0,-2,0,-1,-1,-1,0,-1
KR_6654839440,420,-3,-95,-8,-14,-3,4,1,-4,4,0,0,2,2,-4,6,2,-3,4,1,0,-9,0,-2,-1,3,-2,0,-4,-1,-1,-1,-1,4,-1
KR_6757531614,420,-7,-81,-53,-12,-5,5,0,-2,2,0,-4,4,0,-4,6,2,3,1,4,0,-11,-2,-1,-4,5,-2,0,-3,-1,-1,-1,-1,5,-1
KR_6764782052,420,-6,-98,-6,-15,1,2,3,-6,7,1,-10,10,0,0,1,1,0,2,2,-1,-5,-115,-2,-6,8,0,0,-2,-1,-1,-1,-1,4,-1
KR_6751335977,440,-3,44,-12,-16,0,1,1,-3,4,1,-4,4,0,-10,11,1,1,1,2,0,-20,0,-2,-4,6,0,0,-2,-1,-1,-1,-1,4,-1
KR_6764949694,420,-1,-1,-7,-1,-2,2,0,0,2,2,0,3,3,0,2,2,1,3,4,0,-3,-5,0,-7,7,1,0,-1,1,-1,-1,1,2,-1
KR_6730909083,420,-2,-62,-10,2,-3,6,3,8,0,8,-1,3,2,2,1,3,-4,4,0,-1,4,16,4,-8,4,-4,0,0,-1,-1,-1,-1,2,-1
KR_6735176942,420,4,48,20,7,8,0,8,1,2,3,2,3,5,-3,7,4,-1,2,1,0,5,9,7,-14,7,0,0,1,-1,1,1,1,2,-1
KR_6754055529,420,-1,-23,-9,2,0,1,1,3,0,3,0,4,4,-1,1,0,0,0,0,0,3,-20,-4,-3,7,-1,0,-1,1,1,-1,1,4,-1
KR_6754459231,420,-1,1,-32,3,-6,7,1,0,3,3,0,1,1,7,1,8,2,0,2,0,3,7,-2,0,2,-2,0,-1,-1,-1,-1,1,6,-1
KR_6767637692,420,1,14,-4,-3,0,1,1,-3,5,2,2,1,3,-1,3,2,-1,2,1,-1,-9,-121,-3,-3,6,-1,0,-1,-1,-1,-1,-1,6,-1
KR_6763739067,420,3,27,3,2,2,0,2,-3,4,1,4,2,6,0,3,3,-1,4,3,1,0,-11,3,-10,7,-5,0,0,1,1,0,1,6,-1
KR_6761070898,420,-2,-32,-4,-4,2,0,2,1,1,2,-1,3,2,-3,4,1,-3,5,2,0,-7,-9,0,-8,8,-2,0,-2,1,-1,-1,1,3,-1
KR_6768065526,420,-2,-43,1,-12,0,1,1,-2,5,3,-2,3,1,-7,7,0,-1,1,0,0,-13,4,1,-6,5,-4,0,-1,-1,-1,-1,-1,2,-1
KR_6583952147,420,5,17,-8,7,5,1,6,2,2,4,-3,6,3,3,2,5,0,1,1,0,7,287,-2,-3,5,0,0,0,-1,-1,1,1,1,-1
KR_6752303433,420,-1,12,-2,8,2,0,2,0,2,2,3,3,6,2,3,5,1,1,2,1,7,14,1,-9,8,1,0,0,1,0,0,1,2,-1
KR_6766120354,420,1,-28,-11,2,0,3,3,0,3,3,-1,4,3,1,1,2,2,0,2,0,2,-3,-1,-5,6,0,0,1,-1,-1,1,1,2,-1
KR_6767350923,440,-3,-66,-34,-5,-2,4,2,3,4,7,1,1,2,-4,5,1,-3,3,0,0,-4,-2,5,-9,4,-9,0,-1,-1,-1,-1,-1,4,-1
KR_6760051208,420,-1,81,-3,-5,0,1,1,-1,4,3,-2,4,2,0,4,4,-2,2,0,1,-8,1,2,-6,4,7,0,1,-1,-1,1,1,6,-1
KR_6765326786,440,-1,-23,21,-8,-3,3,0,0,2,2,-5,7,2,2,2,4,-2,4,2,0,-6,0,-8,0,8,4,0,0,0,-1,0,-1,0,-1
KR_6743914356,420,-1,-7,-29,-6,0,1,1,-10,10,0,-1,2,1,4,1,5,1,0,1,0,-9,-4,-5,-2,7,4,0,0,-1,-1,-1,1,4,-1
KR_6765451845,420,-3,1,8,-10,1,2,3,-3,4,1,0,2,2,0,2,2,-8,8,0,0,-12,-25,0,-9,9,0,0,0,-1,-1,-1,-1,4,-1
KR_6713295030,420,-2,-21,41,-10,0,2,2,-6,8,2,-4,5,1,0,1,1,0,0,0,0,-15,-8,-1,-7,8,5,0,0,1,1,1,-1,6,-1
KR_6701771271,420,-1,9,-4,-5,-1,1,0,2,2,4,0,1,1,-4,6,2,-2,2,0,-1,-12,-5,-3,-6,9,1,0,0,-1,-1,-1,-1,2,-1
KR_6762404915,420,-1,-22,9,1,0,2,2,1,2,3,-1,5,4,2,2,4,-1,2,1,0,4,11,3,-7,4,-4,0,-1,-1,1,-1,-1,3,-1
KR_6754940494,420,-3,-74,-24,-4,-5,5,0,3,0,3,1,3,4,-1,2,1,-2,4,2,0,5,-28,-1,-6,7,2,0,-1,-1,-1,-1,-1,3,-1
KR_6754654530,420,-2,-44,4,-5,-3,4,1,-1,3,2,-4,6,2,3,2,5,0,0,0,0,4,7,3,-7,4,-2,0,-3,0,-1,-1,-1,0,-1
KR_6768766885,420,-1,-6,28,-6,-6,7,1,0,1,1,1,3,4,-2,2,0,1,0,1,0,-10,-11,-2,-2,4,0,0,-1,0,-1,-1,-1,0,-1
KR_6760874418,420,-3,-56,-18,-1,-1,3,2,3,1,4,1,0,1,0,2,2,-4,6,2,0,4,4,2,-6,4,0,0,-1,-1,-1,-1,-1,3,-1
KR_6759345054,420,-2,-1,8,-1,-1,3,2,-2,5,3,0,2,2,3,1,4,-1,3,2,0,-4,-4,-1,-3,4,5,0,0,0,-1,-1,1,0,-1
KR_6717080182,420,0,-16,16,5,-3,4,1,1,3,4,2,0,2,5,2,7,0,0,0,0,12,2,-3,-4,7,2,0,-1,1,-1,-1,1,5,-1
KR_6721689856,420,-4,-43,-9,-10,1,0,1,-1,4,3,-3,4,1,-6,6,0,-1,2,1,1,-8,-11,-6,-4,10,3,0,-1,-1,-1,-1,1,3,-1
KR_6766193124,420,-2,-51,4,-5,-2,3,1,0,1,1,0,1,1,-3,3,0,0,0,0,-1,-10,-3,1,-7,6,-2,0,-3,-1,-1,-1,-1,5,-1
KR_6766903174,420,-1,-66,24,4,0,2,2,2,0,2,1,4,5,1,1,2,0,0,0,0,9,-11,2,-6,4,2,0,0,1,1,0,1,6,-1
KR_6689873706,420,0,-2,-9,7,3,0,3,1,6,7,2,0,2,2,2,4,-1,1,0,0,1,2,-4,-3,7,3,0,2,1,-1,1,1,1,-1
KR_6767564172,420,0,-25,-16,-1,2,1,3,-4,4,0,1,1,2,-1,6,5,1,1,2,-1,-4,-10,3,-8,5,-3,0,-2,-1,-1,-1,-1,3,-1
KR_6753960938,420,-5,-106,-8,-4,1,1,2,0,3,3,0,2,2,-5,5,0,0,0,0,0,-7,6,3,-5,2,-5,0,-1,-1,1,-1,-1,4,-1
KR_6761923383,420,0,26,4,-2,1,0,1,-5,6,1,1,1,2,2,3,5,-1,2,1,0,-2,-1,-2,-4,6,-1,0,0,1,-1,0,-1,6,-1
KR_6767931954,440,0,-3,20,3,2,0,2,0,1,1,-4,6,2,4,0,4,1,0,1,0,-3,11,3,-6,3,-2,0,1,-1,1,1,-1,4,-1
KR_6726708681,420,0,-62,4,5,0,1,1,-2,3,1,8,2,10,-2,4,2,1,1,2,0,11,25,6,-9,3,3,0,0,0,1,0,-1,0,-1
KR_6737941638,420,-2,-46,-30,3,-1,2,1,3,3,6,2,1,3,-1,5,4,0,0,0,0,-1,-26,-1,-4,5,3,0,-1,1,-1,-1,1,4,-1
KR_6760036239,420,0,-76,36,-9,-1,5,4,-4,6,2,-4,4,0,0,2,2,0,1,1,0,-18,-5,-1,-3,4,1,0,0,-1,-1,0,-1,4,-1
KR_6749704275,420,0,-24,-22,-2,2,0,2,-1,2,1,0,2,2,-2,2,0,-1,1,0,0,-4,5,0,-5,5,-4,0,-2,-1,-1,-1,-1,5,-1
KR_6726767258,420,0,-19,-16,1,1,0,1,3,2,5,0,2,2,-3,5,2,0,1,1,0,8,0,-3,-4,7,-2,0,0,1,1,0,1,6,-1
KR_6768436857,420,-4,-12,1,-7,-2,2,0,-1,1,0,-1,2,1,-3,3,0,0,1,1,0,-7,-1,-1,-6,7,-4,0,-1,-1,1,-1,-1,6,-1
KR_6702630006,440,-3,-64,-20,-8,-4,4,0,-1,2,1,1,1,2,-4,6,2,0,0,0,0,-4,-16,-2,-4,6,3,0,0,1,-1,-1,1,1,-1
KR_6758058322,420,-4,-64,27,-4,2,0,2,-1,3,2,-11,11,0,7,1,8,-1,1,0,0,5,-1,-1,-5,6,2,0,-2,0,1,-1,1,0,-1
KR_6760375918,420,-5,19,-11,-10,1,3,4,-2,3,1,-5,6,1,-1,1,0,-3,3,0,0,-16,-5,1,-6,5,0,0,-1,1,1,-1,1,5,-1
KR_6699468855,420,-4,-76,-15,-9,-2,3,1,-2,4,2,-1,2,1,-2,4,2,-2,4,2,-3,-18,-9,-7,-1,8,5,0,-2,-1,1,-1,-1,4,-1
KR_6497518635,420,-2,-39,-28,-1,-2,4,2,2,1,3,5,1,6,-6,7,1,0,1,1,0,-1,26,-1,-3,4,1,0,-1,-1,1,-1,-1,2,-1
KR_6703182690,420,-1,6,-12,-2,1,1,2,-3,5,2,-3,3,0,3,0,3,0,0,0,0,-3,3,-7,-4,11,-1,0,0,0,-1,-1,-1,0,-1
KR_6746064778,420,-2,-5,8,-6,1,2,3,-2,5,3,-3,3,0,-1,4,3,-1,2,1,0,-10,19,-3,-2,5,0,0,0,1,1,1,1,5,-1
KR_6761772399,440,-2,-21,-13,-5,1,0,1,2,5,7,-3,3,0,-4,4,0,-1,1,0,0,0,6,3,-7,4,-2,0,-1,1,-1,-1,-1,6,-1
KR_6756851744,420,-2,0,-34,-6,-4,4,0,-3,3,0,-1,3,2,3,0,3,-1,2,1,0,-3,13,0,-7,7,0,0,0,-1,-1,1,-1,5,-1
KR_6763264733,420,4,2,9,8,4,1,5,-1,2,1,2,0,2,1,4,5,2,0,2,0,8,2,0,-6,6,-2,0,0,1,1,1,-1,4,-1
KR_6760102923,420,-3,-28,1,-3,3,1,4,3,1,4,6,1,7,-14,14,0,-1,2,1,4,-1,-12,-3,-5,8,2,0,-3,-1,-1,-1,1,3,-1
KR_6738051382,420,-5,-70,-18,-4,0,2,2,-5,7,2,-3,4,1,3,1,4,1,0,1,0,-5,5,1,-11,10,-4,0,0,-1,-1,-1,1,3,-1
KR_6768756077,420,-1,-33,-27,-4,2,1,3,0,2,2,1,2,3,-7,8,1,0,2,2,0,-2,3,4,-7,3,-2,0,-1,-1,-1,-1,1,6,-1
KR_6747022821,420,-1,-26,-22,0,-4,6,2,1,6,7,-1,1,0,0,3,3,4,1,5,-1,-1,-1,-1,-7,8,1,0,-1,-1,-1,-1,-1,5,-1
KR_6593427214,420,1,85,26,1,0,1,1,-2,6,4,-1,3,2,2,0,2,2,0,2,0,-2,12,0,-9,9,4,0,0,-1,1,1,1,3,-1
KR_6641659035,420,-1,-60,9,1,2,0,2,3,1,4,-7,8,1,2,0,2,1,0,1,0,9,1,0,-3,3,-1,0,-1,1,-1,-1,-1,3,-1
KR_6767742867,420,-4,-13,-17,-5,-1,2,1,1,0,1,-3,4,1,-2,6,4,0,0,0,0,-12,-8,0,-5,5,-6,0,-2,-1,-1,-1,1,1,-1
KR_6765030799,420,5,-23,42,11,-3,4,1,4,2,6,3,0,3,7,1,8,0,0,0,0,8,3,5,-11,6,-6,0,1,1,1,1,1,2,-1
KR_6691514325,420,-2,39,-18,1,-1,1,0,-1,4,3,2,0,2,-1,2,1,2,0,2,0,1,-115,4,-10,6,-1,0,0,1,-1,0,1,2,-1
KR_6713151546,420,-3,-21,-5,-12,-2,3,1,-5,5,0,-6,7,1,0,3,3,1,0,1,0,-19,-8,-3,-2,5,0,0,-3,-1,-1,-1,1,5,-1
KR_6743262853,420,4,-13,26,3,-1,2,1,7,4,11,0,2,2,-2,2,0,-1,1,0,0,1,-1,1,-4,3,2,0,0,1,1,0,1,4,-1
KR_6748821985,420,-2,-35,0,-5,5,1,6,-3,3,0,-2,4,2,-4,4,0,-1,1,0,0,-7,42,1,-4,3,-31,0,0,-1,1,1,-1,3,-1
KR_6764244050,420,-3,-79,6,-13,-2,2,0,-5,6,1,-4,5,1,-4,5,1,2,1,3,0,-19,-6,-5,-2,7,0,0,-1,-1,1,-1,-1,1,-1
KR_6740007491,420,0,25,19,-1,-1,1,0,-5,6,1,3,0,3,2,4,6,0,1,1,0,3,-9,2,-7,5,0,0,-1,-1,-1,-1,1,2,-1
KR_6757214939,420,-4,-83,-36,-6,-4,5,1,-1,1,0,1,2,3,-2,4,2,0,0,0,0,-6,-385,-1,-4,5,3,0,-2,0,-1,-1,-1,0,-1
KR_6766770521,420,-9,-104,-19,-25,-13,13,0,0,1,1,-4,7,3,-8,9,1,0,3,3,-1,-13,-13,-9,-1,10,4,0,-3,1,-1,-1,1,5,-1
KR_6723713117,420,-6,-77,-12,-15,-3,4,1,-4,5,1,-6,6,0,-1,3,2,-1,2,1,0,-20,0,-3,-2,5,-1,0,-1,-1,-1,-1,1,6,-1
KR_6741861154,420,-1,48,-23,-5,-2,3,1,-4,5,1,-1,4,3,2,4,6,0,0,0,0,-3,22,3,-7,4,1,0,0,0,-1,0,-1,0,-1
KR_6761075625,420,-3,-34,-12,-5,-1,3,2,0,5,5,-3,5,2,0,1,1,-1,1,0,0,-2,-6,-2,-4,6,-2,0,-1,-1,1,-1,1,2,-1
KR_6765493746,420,-2,-25,-3,0,0,0,0,0,1,1,2,0,2,1,0,1,-3,3,0,0,2,3,0,-7,7,2,0,0,-1,-1,0,1,6,-1
KR_6740798292,420,-2,-18,-16,-6,-1,2,1,-1,6,5,-1,1,0,-3,3,0,0,0,0,0,-6,-6,-3,-7,10,-1,0,0,-1,-1,0,1,6,-1
KR_6620408685,420,-5,-64,5,-11,-5,5,0,-1,4,3,-1,3,2,-4,4,0,0,0,0,0,-10,-17,0,-4,4,4,0,0,-1,-1,0,-1,1,-1
KR_6764196445,420,-2,4,26,-7,0,1,1,-2,4,2,0,2,2,-2,5,3,-3,3,0,0,-2,51,7,-10,3,-34,0,-1,1,-1,-1,-1,1,-1
KR_6766195150,420,-3,-33,-30,-10,-5,6,1,-4,6,2,0,1,1,0,4,4,-1,2,1,0,-9,-29,-6,-2,8,3,0,-1,-1,-1,-1,1,4,-1
KR_6613102691,420,-4,-32,-30,-9,-2,4,2,-4,5,1,-3,6,3,-2,4,2,2,1,3,0,-8,-1,-2,-6,8,-2,0,-2,-1,-1,-1,1,2,-1
KR_6737158626,420,-2,-63,-9,-9,-4,4,0,3,2,5,-3,4,1,-4,6,2,-1,1,0,0,-6,-1,1,-8,7,-5,0,0,-1,-1,0,-1,6,-1
KR_6746500872,420,2,-5,13,2,4,2,6,-2,4,2,-3,4,1,1,3,4,2,0,2,-2,-1,-88,-1,-4,5,-5,0,2,1,1,1,-1,3,-1
KR_6742090562,420,-7,-102,12,-11,2,0,2,-4,5,1,-1,2,1,-9,11,2,1,1,2,0,-24,1,-4,-3,7,-5,0,-1,-1,-1,-1,1,2,-1
KR_6659404825,420,-6,-69,-44,-6,0,2,2,0,4,4,-6,7,1,2,1,3,-2,2,0,0,-4,-21,0,-7,7,-7,0,-1,-1,1,-1,-1,3,-1
KR_6660232808,420,-1,-43,4,6,10,0,10,0,1,1,-7,7,0,2,8,10,1,0,1,1,5,-4,-1,-6,7,-2,0,-1,-1,1,1,1,1,-1
KR_6748282296,420,0,9,-2,-1,0,2,2,2,0,2,-3,4,1,1,0,1,-1,1,0,1,2,7,2,-6,4,-3,0,0,-1,-1,0,1,6,-1
KR_6752974172,420,-1,-26,24,-4,-3,5,2,1,1,2,0,1,1,1,2,3,-3,3,0,0,-5,-7,4,-8,4,2,0,0,1,0,-1,1,1,-1
KR_6759375150,420,-5,-15,-8,-13,1,1,2,-7,7,0,-5,9,4,1,2,3,-3,3,0,0,-26,11,3,-5,2,-4,0,-1,-1,-1,-1,-1,3,-1
KR_6674596110,440,-1,-19,-4,-3,1,6,7,1,2,3,2,0,2,-7,7,0,0,1,1,0,-4,27,2,-7,5,-4,0,-2,0,-1,-1,-1,0,-1
KR_6616331251,420,1,22,23,-2,-5,7,2,4,4,8,0,1,1,-5,6,1,4,0,4,0,-4,1,-5,-7,12,4,0,-1,-1,-1,-1,-1,2,-1
KR_6559795761,420,-1,-67,-40,-1,2,3,5,3,5,8,0,2,2,-5,6,1,-1,1,0,0,6,44,1,-7,6,-2,0,-2,-1,-1,-1,-1,1,-1
KR_6758147608,420,0,-1,-13,0,0,1,1,1,1,2,0,4,4,0,2,2,-1,1,0,-1,-3,-69,5,-11,6,0,0,0,-1,-1,0,-1,2,-1
KR_6726841826,420,0,-59,-28,5,-2,3,1,9,1,10,1,1,2,-1,3,2,-2,2,0,0,10,37,0,-7,7,1,0,0,-1,-1,-1,-1,1,-1
KR_6758121411,420,-1,-54,7,2,2,1,3,1,1,2,0,0,0,1,1,2,-2,2,0,0,5,40,-1,-4,5,0,0,1,-1,1,1,-1,1,-1
KR_6761921583,420,-1,60,19,-2,4,2,6,-1,1,0,1,3,4,-5,6,1,-1,2,1,0,-14,0,-4,-2,6,0,0,1,-1,1,1,1,1,-1
KR_6763682053,420,-2,-15,8,-1,-1,2,1,2,2,4,0,2,2,-1,4,3,-1,2,1,-1,-6,-70,-2,-8,10,4,0,0,1,-1,1,-1,6,-1
KR_6762840620,420,1,15,-30,-6,-1,1,0,-2,3,1,-4,6,2,1,2,3,0,1,1,-1,-9,2,-1,-6,7,-2,0,1,-1,1,1,-1,5,-1
KR_6734940253,420,-3,-29,-19,-1,2,0,2,1,7,8,2,0,2,-3,3,0,-3,3,0,0,-9,-19,-1,-7,8,1,0,0,-1,1,-1,-1,5,-1
KR_6768812703,420,-6,-34,-24,-12,0,1,1,-4,6,2,-4,5,1,-3,3,0,-1,1,0,0,-8,-9,2,-8,6,0,0,-2,-1,-1,-1,-1,5,-1
KR_6699817576,420,-2,-27,-34,-7,-1,3,2,-4,5,1,1,0,1,-2,6,4,-1,2,1,1,-10,-34,-2,-7,9,-4,0,0,1,-1,0,1,3,-1
KR_6762690738,420,-2,-20,-16,-3,-4,5,1,4,2,6,-3,4,1,3,3,6,-3,3,0,0,8,-102,4,-9,5,-2,0,2,-1,1,1,1,6,-1
KR_6761506846,440,-1,-23,-19,-4,3,1,4,1,3,4,-6,8,2,-1,2,1,-1,1,0,-1,-6,-36,-1,-4,5,4,0,-1,1,-1,-1,-1,5,-1
KR_6631524520,440,0,-17,12,0,-2,2,0,2,2,4,-1,5,4,1,5,6,0,2,2,-1,-6,4,-1,-7,8,-3,0,0,-1,-1,0,-1,5,-1
KR_6674352034,440,0,13,-36,-2,1,2,3,-2,2,0,-2,4,2,1,2,3,0,0,0,0,-4,2,-3,-3,6,-7,0,1,-1,1,1,1,6,-1
KR_6570418967,420,0,22,-29,4,1,1,2,2,3,5,1,2,3,0,2,2,0,1,1,0,6,-46,0,-8,8,1,0,1,-1,-1,-1,1,6,-1
KR_6764676975,420,1,-41,5,-2,3,1,4,2,2,4,-2,4,2,0,3,3,-5,5,0,0,-5,-115,2,-7,5,-3,0,0,-1,1,-1,-1,2,-1
KR_6620981651,420,-4,-43,-12,-12,-5,5,0,0,1,1,-2,3,1,-2,5,3,-3,3,0,0,-17,-14,0,-5,5,-2,0,0,-1,1,-1,-1,4,-1
KR_6745440243,420,0,-26,1,-6,1,1,2,-7,8,1,-1,4,3,0,2,2,1,0,1,-1,-11,-22,-4,-6,10,-1,0,-1,1,1,-1,-1,3,-1
KR_6722795071,420,-1,8,19,-3,-4,4,0,4,1,5,-4,5,1,1,2,3,0,0,0,1,-2,-20,2,-7,5,8,0,0,1,-1,0,1,6,-1
KR_6756850334,440,-2,13,13,-7,3,1,4,-4,6,2,-4,6,2,-1,2,1,-1,1,0,0,-13,6,2,-7,5,-5,0,-1,-1,-1,-1,-1,1,-1
KR_6753741056,420,-3,-99,-8,-13,-5,6,1,2,3,5,-1,3,2,-9,13,4,0,1,1,-1,-20,14,3,-9,6,-4,0,-3,-1,-1,-1,-1,3,-1
KR_6749515458,440,0,-29,11,-5,-2,3,1,3,1,4,2,0,2,-3,3,0,-5,8,3,-1,-8,-14,-1,-2,3,2,0,-1,-1,1,-1,-1,1,-1
KR_6718627509,420,-8,-78,1,-15,-1,1,0,0,2,2,-3,3,0,-9,12,3,-2,3,1,0,-15,-7,-1,-4,5,-1,0,-1,-1,-1,-1,-1,6,-1
KR_6742157179,420,-3,-13,-4,-7,-3,3,0,-2,3,1,-4,4,0,1,0,1,1,1,2,0,-3,0,-2,-4,6,-2,0,-1,1,-1,-1,-1,6,-1
KR_6752347449,420,0,-8,-15,-8,2,0,2,-7,7,0,-6,7,1,2,0,2,1,0,1,1,1,-28,-2,-4,6,2,0,0,-1,-1,-1,1,6,-1
KR_6768271662,420,-2,6,-6,-14,-1,1,0,-3,3,0,-5,5,0,-2,5,3,-3,5,2,0,-17,-132,-6,-5,11,-9,0,-3,-1,-1,-1,-1,1,-1
KR_6734580968,440,-3,-59,-12,-2,3,0,3,-3,3,0,3,5,8,-5,6,1,0,0,0,0,1,34,10,-10,0,-10,0,0,-1,1,0,-1,4,-1
KR_6763567472,420,0,-27,24,-4,-3,3,0,2,3,5,-2,3,1,-1,2,1,0,1,1,0,-3,-3,-7,-3,10,-5,0,-1,-1,-1,-1,1,4,-1
KR_6765683828,420,1,-7,25,0,1,5,6,1,1,2,-3,3,0,-2,4,2,3,2,5,-1,-3,2,-3,-6,9,2,0,2,-1,1,1,-1,1,-1
KR_6701153806,420,0,-37,15,0,-3,5,2,2,1,3,1,1,2,0,1,1,0,1,1,0,1,4,6,-8,2,0,0,0,1,1,-1,-1,2,-1
KR_6763833077,420,3,42,-20,3,4,0,4,-2,2,0,1,2,3,0,3,3,0,1,1,0,-2,8,0,-8,8,7,0,0,0,1,1,-1,0,-1
KR_6745363215,420,-1,22,-28,-2,-3,3,0,1,6,7,1,3,4,-1,2,1,0,0,0,0,2,-11,-5,-3,8,4,0,-1,-1,-1,-1,1,5,-1
KR_6765800219,420,-3,13,-1,-6,1,2,3,-4,6,2,1,2,3,-4,4,0,0,0,0,0,-5,1,1,-7,6,-3,0,1,-1,1,1,1,3,-1
KR_6766667667,420,-4,-40,-22,-3,-1,2,1,-1,5,4,1,0,1,1,4,5,-3,4,1,0,-4,-1,-1,-5,6,-5,0,0,1,1,-1,1,2,-1
KR_6765578420,420,-3,-11,-16,-9,1,2,3,0,2,2,-3,5,2,-6,6,0,-1,1,0,0,-12,65,-5,-3,8,0,0,0,-1,1,0,-1,4,-1
KR_6707228174,420,-1,-5,5,-2,-1,4,3,3,0,3,-1,1,0,-2,4,2,-1,1,0,0,-6,102,4,-8,4,1,0,0,1,1,0,1,3,-1
KR_6759456566,420,-1,26,0,-1,-1,1,0,1,1,2,-1,5,4,3,1,4,-3,4,1,0,-2,-1,-1,-4,5,2,0,-1,-1,-1,1,1,3,-1
KR_6743752848,420,6,-4,56,5,1,3,4,-2,3,1,0,6,6,5,2,7,1,0,1,0,6,-41,6,-7,1,19,0,-1,-1,-1,-1,1,3,-1
KR_6753886517,420,3,76,-26,9,1,1,2,-1,3,2,2,4,6,1,1,2,6,0,6,0,6,-24,0,-6,6,7,0,1,1,-1,1,1,2,-1
KR_6724683157,420,-2,-6,-31,-2,-1,2,1,2,4,6,-1,3,2,-1,3,2,-1,2,1,0,-7,-13,-2,-7,9,-2,0,-1,1,-1,-1,1,6,-1
KR_6729467947,440,-2,-25,-12,-8,1,3,4,-4,5,1,-1,2,1,5,1,6,-9,10,1,1,-6,-27,-5,-4,9,2,0,-1,1,-1,-1,1,4,-1
KR_6692812741,420,0,13,4,0,5,0,5,-5,7,2,-2,3,1,1,4,5,1,0,1,0,-5,-2,-2,-4,6,-4,0,0,0,1,0,-1,0,-1
KR_6768138395,420,0,-7,27,-4,0,2,2,0,4,4,1,3,4,-6,7,1,1,0,1,0,0,30,-3,-3,6,-20,0,0,-1,1,-1,-1,4,-1
KR_6741661280,420,-2,-61,-24,-3,0,2,2,2,0,2,-4,6,2,-1,2,1,0,0,0,0,-4,-14,1,-3,2,2,0,-2,-1,-1,-1,1,6,-1
KR_6765251149,420,2,31,4,8,1,0,1,1,3,4,3,0,3,2,0,2,1,1,2,0,5,-3,-2,-6,8,9,0,0,-1,-1,0,-1,1,-1
KR_6721067802,420,-1,-13,-4,-5,-4,4,0,3,1,4,-4,5,1,1,2,3,-1,1,0,0,1,-2,7,-11,4,-8,0,-1,0,-1,-1,-1,0,-1
KR_6763610321,420,-2,-30,12,-7,-3,5,2,0,4,4,0,1,1,-4,4,0,0,0,0,0,-7,2,6,-8,2,-2,0,0,1,1,0,1,1,-1
KR_6738416112,440,-6,-100,-28,-11,0,2,2,-4,5,1,-1,3,2,-2,8,6,-4,5,1,0,-16,-2,-2,-2,4,0,0,-2,-1,-1,-1,-1,6,-1
KR_6728479796,420,-1,-34,1,-12,1,0,1,-8,12,4,-4,5,1,-2,4,2,1,0,1,0,-24,-1,-2,-3,5,-2,0,-1,1,1,-1,1,6,-1
KR_6734738299,420,0,-42,7,-1,0,2,2,1,4,5,-3,5,2,2,2,4,-1,1,0,1,0,-7,-2,-5,7,0,0,-1,1,-1,-1,1,6,-1
KR_6748203818,420,-2,-27,7,-4,3,1,4,1,1,2,1,0,1,-8,8,0,-1,1,0,0,-8,-13,-7,-2,9,4,0,1,-1,1,-1,-1,1,-1
KR_6753809401,420,0,30,2,2,2,0,2,1,4,5,0,5,5,-2,3,1,1,0,1,0,-11,-113,2,-6,4,0,0,0,1,1,0,-1,5,-1
KR_6701309313,420,-6,-66,-5,-11,-6,6,0,-1,4,3,-1,2,1,-3,4,1,0,0,0,0,-10,39,-4,-3,7,-12,0,-2,-1,1,-1,1,3,-1
KR_6750576648,420,-3,11,-26,3,-2,3,1,0,1,1,6,2,8,0,2,2,-1,3,2,0,2,2,0,-3,3,5,0,0,-1,1,-1,1,6,-1
KR_6670105027,420,0,-1,-17,-3,-1,3,2,2,0,2,-1,2,1,-4,6,2,1,0,1,0,-3,-21,1,-5,4,10,0,0,1,-1,0,-1,4,-1
KR_6759787730,420,-3,-16,-20,0,-3,5,2,4,1,5,1,0,1,0,4,4,-2,2,0,0,3,-2,7,-12,5,-6,0,0,-1,1,-1,1,4,-1
KR_6767707162,420,-1,-33,-7,0,2,1,3,4,0,4,-4,4,0,-1,2,1,-1,1,0,0,1,23,2,-8,6,-3,0,0,-1,1,0,1,5,-1
KR_6761453075,420,-1,-81,-16,-3,-4,4,0,0,2,2,-1,2,1,0,1,1,2,0,2,0,2,16,2,-5,3,0,0,0,-1,1,0,1,6,-1
KR_6754481151,420,-4,-105,18,-8,-4,5,1,0,2,2,-2,2,0,-2,2,0,0,0,0,0,-6,211,0,-5,5,-1,0,-1,-1,1,-1,-1,2,-1
KR_6745172663,420,-1,-57,-5,1,-2,3,1,1,1,2,-2,3,1,5,1,6,-1,2,1,0,7,-13,-2,-4,6,5,0,0,-1,-1,-1,1,3,-1
KR_6759661715,440,-2,-72,-1,-11,-6,7,1,1,0,1,-8,8,0,3,0,3,-1,1,0,-1,-10,-100,4,-8,4,-4,0,-3,-1,1,-1,-1,6,-1
KR_6730825100,420,-2,7,24,-1,-5,5,0,3,4,7,0,0,0,-3,5,2,4,0,4,0,3,-2,1,-7,6,3,0,0,0,-1,0,1,0,-1
KR_6758793664,420,-3,-93,1,-10,1,2,3,-6,7,1,0,2,2,-2,4,2,-3,3,0,0,-14,4,4,-9,5,-3,0,1,-1,1,1,-1,4,-1
KR_6667414690,420,-3,-4,0,-11,-1,1,0,-5,6,1,-1,3,2,-2,3,1,-2,2,0,0,-17,-3,-1,-3,4,1,0,0,0,-1,-1,1,0,-1
KR_6743667370,420,-2,-2,-24,-5,-2,4,2,-5,6,1,0,2,2,2,0,2,0,2,2,0,-1,14,-3,-3,6,-4,0,0,-1,-1,-1,1,5,-1
KR_6692983033,420,-5,-45,-34,-11,-5,8,3,-2,5,3,-8,11,3,1,3,4,3,0,3,0,-7,1,-2,-5,7,0,0,2,-1,-1,1,1,5,-1
KR_6767783707,420,2,21,-10,2,2,2,4,1,0,1,2,6,8,-3,7,4,0,1,1,0,2,8,-2,-6,8,-2,0,2,1,1,1,1,5,-1
KR_6724314436,420,-2,2,-13,-8,-1,2,1,-1,3,2,-1,3,2,0,1,1,-5,5,0,0,-14,3,3,-8,5,-4,0,0,-1,-1,-1,1,3,-1
KR_6767126417,420,-6,-6,-36,-7,-3,5,2,-2,4,2,2,2,4,-4,4,0,0,2,2,0,-3,-127,2,-9,7,-5,0,-1,-1,1,-1,-1,2,-1
KR_6768618988,440,4,63,13,9,0,1,1,6,1,7,-3,4,1,5,2,7,1,0,1,0,16,15,4,-8,4,1,0,0,1,-1,1,-1,3,-1
KR_6739116451,420,-1,-47,-36,0,1,1,2,3,2,5,3,1,4,-6,7,1,-1,1,0,-1,4,3,-3,-7,10,-6,0,-1,-1,-1,-1,-1,2,-1
KR_6765337979,420,-7,-71,-22,-22,-2,2,0,-5,6,1,-5,5,0,-6,8,2,-4,6,2,-1,-26,-19,-7,-2,9,-9,0,-1,-1,-1,-1,-1,4,-1
KR_6762527647,420,-4,-57,-45,-8,-3,3,0,0,3,3,-2,5,3,-2,7,5,-1,3,2,0,-2,16,-2,-7,9,1,0,1,1,1,1,1,4,-1
KR_6767543917,420,-4,-45,-44,-10,0,0,0,0,0,0,-2,3,1,-4,5,1,-4,4,0,0,-11,-4,1,-5,4,-1,0,0,0,-1,-1,-1,0,-1
KR_6646031838,420,-1,12,11,-6,0,1,1,-5,6,1,2,0,2,-3,3,0,0,0,0,0,-10,101,1,-4,3,0,0,0,1,-1,0,-1,4,-1
KR_6593474936,420,-3,-50,-16,-3,-1,3,2,-1,3,2,-3,4,1,2,1,3,0,0,0,0,-2,-41,-4,-7,11,0,0,-2,1,-1,-1,-1,5,-1
KR_6761870240,420,-1,-52,-29,-1,3,0,3,1,3,4,-1,3,2,-5,6,1,1,1,2,0,-2,-2,4,-8,4,-3,0,-3,0,-1,-1,-1,0,-1
KR_6731085350,420,-1,-47,-10,2,1,3,4,1,2,3,2,0,2,-1,5,4,-1,1,0,0,7,11,3,-10,7,-4,0,1,1,1,1,1,2,-1
KR_6763907747,420,-4,-89,-29,-2,0,3,3,1,1,2,-3,4,1,0,3,3,0,1,1,1,6,-1,4,-5,1,-2,0,-2,-1,-1,-1,1,4,-1
KR_6756305663,420,-3,-2,-19,-5,2,2,4,-2,2,0,0,2,2,-1,1,0,-4,4,0,0,-8,-1,-3,-4,7,-1,0,0,1,-1,0,-1,2,-1
KR_6769096662,420,0,-24,-36,2,0,2,2,4,3,7,0,1,1,0,2,2,-2,2,0,0,-1,-2,-2,-2,4,0,0,0,-1,1,-1,-1,2,-1
KR_6691185289,440,-2,-20,4,-1,0,5,5,-1,2,1,1,0,1,-3,4,1,2,0,2,1,4,0,0,-5,5,-2,0,0,0,0,0,1,0,-1
KR_6719791895,420,2,41,-13,2,-2,3,1,2,1,3,2,0,2,2,1,3,-2,3,1,1,10,-16,3,-9,6,3,0,0,1,-1,-1,1,6,-1
KR_6732953425,420,-1,-55,-1,3,-3,3,0,0,4,4,-3,4,1,8,2,10,1,0,1,0,10,17,-2,-8,10,-10,0,0,-1,-1,0,-1,2,-1
KR_6759351208,420,-5,-58,-4,-13,-3,4,1,-2,2,0,3,4,7,-9,9,0,-2,3,1,-1,-18,-15,2,-4,2,-1,0,-3,-1,0,-1,-1,6,-1
KR_6738906689,420,1,-28,26,-9,-5,5,0,0,3,3,0,0,0,-4,5,1,0,2,2,0,-8,6,1,-5,4,-8,0,0,1,-1,1,-1,4,-1
KR_6763093248,420,-1,-25,31,-7,-5,5,0,4,1,5,-2,2,0,-2,4,2,-2,3,1,0,-10,-5,-1,-2,3,-4,0,0,0,1,0,1,0,-1
KR_6688601549,420,-4,-116,18,-7,2,1,3,-1,2,1,-3,5,2,-3,3,0,-2,3,1,0,-10,-172,-1,-5,6,-3,0,-4,-1,-1,-1,-1,4,-1
KR_6739296732,420,0,-18,4,-3,3,0,3,-6,8,2,1,1,2,1,0,1,-2,2,0,0,-8,-34,5,-9,4,-4,0,0,-1,1,1,-1,1,-1
KR_6598532978,420,-2,19,-27,-10,3,2,5,-8,9,1,-7,7,0,2,2,4,0,0,0,-1,-6,-62,-1,-5,6,39,0,0,-1,-1,-1,-1,3,-1
KR_6607353886,420,2,18,16,2,2,2,4,-1,2,1,-1,1,0,3,2,5,-1,3,2,0,0,4,-2,-6,8,-5,0,1,-1,-1,1,-1,3,-1
KR_6761838931,420,-8,-97,-1,-15,-2,5,3,-1,2,1,-1,3,2,-8,9,1,-3,4,1,0,-12,-8,2,-8,6,1,0,-4,1,-1,-1,-1,4,-1
KR_6766053538,420,-1,-21,-43,0,0,1,1,-1,3,2,2,3,5,-1,7,6,0,3,3,2,7,-37,4,-7,3,1,0,0,1,0,0,1,4,-1
KR_6767068056,420,-3,-14,3,-1,-1,2,1,0,4,4,1,1,2,-2,4,2,1,0,1,0,-2,-3,-2,-4,6,8,0,-1,1,-1,-1,1,4,-1
KR_6767408173,440,-1,-40,-14,0,-4,4,0,0,4,4,1,0,1,2,1,3,1,0,1,0,4,-6,3,-8,5,2,0,0,-1,1,0,1,2,-1
KR_6765017190,420,0,-79,43,-1,-5,6,1,6,0,6,0,3,3,-2,4,2,0,1,1,0,4,5,1,-10,9,4,0,-2,1,1,-1,-1,4,-1
KR_6761606976,420,-2,-4,-24,-6,0,1,1,-1,5,4,1,0,1,-4,4,0,-2,2,0,0,-11,-54,4,-11,7,-5,0,0,-1,1,0,-1,6,-1
KR_6745120370,420,3,103,-12,9,-5,5,0,1,2,3,7,0,7,5,1,6,1,0,1,1,8,-21,0,-7,7,5,0,1,1,-1,1,1,2,-1
KR_6756920668,420,-2,-21,-11,-8,0,2,2,-3,4,1,0,1,1,-3,5,2,-2,2,0,0,-16,-3,0,-5,5,-1,0,0,-1,1,0,1,4,-1
KR_6661114465,420,-1,-4,-6,1,-3,4,1,0,2,2,-2,3,1,6,0,6,0,0,0,0,4,26,4,-7,3,0,0,0,1,-1,0,1,5,-1
KR_6768324310,420,-2,-53,0,0,0,0,0,1,3,4,-2,3,1,0,3,3,1,0,1,0,6,-141,-1,-7,8,-2,0,-1,1,-1,-1,1,4,-1
KR_6765300521,420,-3,-53,-9,-11,-1,3,2,-2,5,3,-5,6,1,-3,5,2,0,0,0,0,-4,-18,-2,-4,6,-3,0,-1,-1,-1,1,-1,1,-1
KR_6766489361,420,-3,-50,-19,-5,0,2,2,-1,4,3,-4,5,1,1,2,3,-1,1,0,0,2,0,0,-3,3,-3,0,-1,-1,-1,-1,1,4,-1
KR_6765224997,420,-1,-47,0,1,-2,3,1,1,3,4,3,2,5,-1,3,2,0,1,1,0,2,-125,0,-7,7,3,0,-1,1,1,-1,1,2,-1
KR_6765031087,420,-1,-76,7,-4,1,2,3,-6,6,0,-1,2,1,1,1,2,1,1,2,1,-6,-292,-8,-3,11,1,0,0,-1,-1,-1,1,6,-1
KR_6725334571,420,-1,9,-36,4,1,1,2,-1,4,3,-1,3,2,2,1,3,3,0,3,3,14,7,2,-9,7,0,0,-1,-1,-1,-1,1,4,-1
KR_6764787510,420,1,12,-4,6,5,1,6,3,2,5,-1,4,3,-1,2,1,0,2,2,0,5,-10,-1,-4,5,3,0,1,-1,1,1,1,3,-1
KR_6743576155,440,-2,-13,-24,1,-2,2,0,0,1,1,4,1,5,1,2,3,-2,3,1,0,5,-4,2,-6,4,2,0,0,-1,-1,0,-1,6,-1
KR_6766929721,420,-1,30,-31,-3,2,0,2,-3,6,3,-3,5,2,3,1,4,-2,4,2,0,-4,16,5,-9,4,-3,0,1,-1,0,1,-1,2,-1
KR_6653119176,420,-5,-69,8,-10,-2,5,3,-2,6,4,-1,2,1,-3,5,2,-2,3,1,1,-19,-15,1,-5,4,4,0,-2,1,-1,-1,1,2,-1
KR_6761912026,420,1,-13,-30,3,4,2,6,1,4,5,3,1,4,-4,5,1,-1,2,1,0,-6,4,1,-6,5,0,0,1,-1,1,1,1,2,-1
KR_6765572813,420,0,-3,-3,-1,-1,3,2,2,2,4,-1,3,2,-2,2,0,1,1,2,0,-10,-16,-2,-5,7,-2,0,-1,-1,-1,-1,1,1,-1
KR_6633879334,420,-5,-124,2,-17,-2,2,0,0,3,3,-5,7,2,-9,9,0,-1,1,0,0,-15,14,0,-3,3,-4,0,-4,-1,-1,-1,-1,6,-1
KR_6765515788,420,1,65,21,2,0,0,0,-4,5,1,2,0,2,3,1,4,1,0,1,0,0,10,4,-6,2,0,0,0,1,-1,0,-1,6,-1
KR_6768726812,420,-3,-20,-28,-7,-3,3,0,-2,3,1,-2,2,0,0,1,1,0,2,2,0,-7,-34,0,-6,6,5,0,0,1,-1,0,-1,5,-1
KR_6766391769,440,-3,7,-28,-1,1,0,1,-2,3,1,-3,3,0,2,0,2,1,0,1,0,1,-12,-3,-2,5,4,0,-1,1,-1,-1,1,3,-1
KR_6751106654,440,1,34,-1,-1,2,2,4,-2,2,0,1,0,1,1,1,2,-3,3,0,0,-3,-3,-4,-3,7,4,0,0,-1,1,0,-1,5,-1
KR_6704387468,420,-3,-104,32,-11,1,1,2,-6,7,1,-3,4,1,-1,3,2,-2,2,0,0,-15,30,0,-6,6,-2,0,-1,1,1,-1,-1,3,-1
KR_6757016491,420,2,31,-22,10,-1,3,2,0,4,4,2,4,6,9,0,9,0,0,0,0,15,4,1,-4,3,-2,0,0,-1,1,0,1,3,-1
KR_6732505563,420,-11,-136,-70,-19,-5,6,1,-3,5,2,-3,4,1,-6,6,0,-2,2,0,-2,-24,-9,-5,-3,8,-1,0,-2,-1,-1,-1,-1,2,-1
KR_6766767339,420,-2,-56,60,-7,-1,3,2,-3,3,0,-1,1,0,-1,3,2,-1,1,0,0,-11,-38,2,-7,5,12,0,-1,-1,-1,-1,-1,1,-1
KR_6761524849,420,-4,-59,-10,-3,-1,2,1,-5,7,2,-1,1,0,4,3,7,0,0,0,-1,-5,7,2,-8,6,-3,0,-3,1,-1,-1,-1,5,-1
KR_6768764427,420,1,-8,31,-2,2,0,2,-3,5,2,1,1,2,-1,4,3,-1,2,1,0,-3,-68,-5,-3,8,0,0,0,1,1,0,-1,6,-1
KR_6760952734,420,1,-46,8,10,3,1,4,6,1,7,6,3,9,-2,3,1,-3,6,3,0,13,11,1,-8,7,0,0,-1,1,-1,1,1,6,-1
KR_6767787290,420,0,-8,-17,3,1,2,3,-3,4,1,2,3,5,3,0,3,0,0,0,0,1,32,-1,-5,6,3,0,-2,1,-1,-1,-1,2,-1
KR_6750542087,420,-1,-22,-4,-1,1,2,3,-3,3,0,1,1,2,0,5,5,0,1,1,0,-6,-4,7,-10,3,-6,0,0,-1,-1,0,-1,5,-1
KR_6756562851,420,-2,6,-12,-5,1,1,2,-1,2,1,2,1,3,-6,6,0,-1,1,0,0,-4,-157,-9,-5,14,-2,0,1,-1,-1,1,-1,2,-1
KR_6766980200,420,-1,19,-20,-6,-1,2,1,-4,9,5,3,2,5,1,2,3,-5,6,1,0,-3,114,4,-8,4,-1,0,-1,0,-1,-1,-1,0,-1
KR_6744018254,420,3,55,28,3,1,1,2,5,4,9,-3,7,4,0,4,4,0,4,4,-1,-2,4,-1,-6,7,2,0,0,-1,1,1,-1,5,-1
KR_6764262434,420,-4,-93,-20,-11,-3,4,1,-2,4,2,-2,5,3,-3,6,3,-1,1,0,0,-9,-8,-1,-5,6,3,0,0,-1,1,-1,-1,6,-1
KR_6711857382,420,-2,-25,-17,-5,-3,4,1,3,3,6,1,1,2,-5,6,1,-1,2,1,1,-5,-4,-2,-5,7,-4,0,0,-1,1,1,1,1,-1
KR_6729932996,420,0,-29,-24,-2,1,1,2,-2,7,5,4,1,5,-6,8,2,1,0,1,0,-2,-8,1,-5,4,5,0,0,-1,1,1,-1,1,-1
KR_6766851415,420,-4,14,-56,1,3,0,3,1,5,6,-2,4,2,-1,6,5,0,2,2,3,12,8,1,-7,6,-4,0,0,-1,-1,1,1,5,-1
KR_6761559099,420,-3,-37,-5,-14,-2,3,1,-2,4,2,0,6,6,-9,9,0,-1,3,2,0,-17,1,-1,-5,6,-6,0,0,-1,-1,-1,-1,4,-1
KR_6767561446,420,-3,-26,-4,-6,-1,2,1,2,1,3,-1,1,0,-5,5,0,-1,1,0,0,-10,-2,0,-5,5,1,0,0,-1,1,0,-1,2,-1
KR_6590649410,420,1,12,24,1,0,1,1,3,2,5,1,1,2,-3,4,1,0,0,0,0,-4,-9,-4,-4,8,4,0,0,-1,1,0,-1,5,-1
KR_6761927213,420,-2,-50,11,-9,1,1,2,-3,4,1,-2,3,1,-4,4,0,-1,1,0,0,-13,24,1,-7,6,-1,0,0,-1,1,0,-1,1,-1
KR_6766794648,420,-6,15,-7,-12,-4,4,0,0,4,4,1,1,2,-6,8,2,-3,3,0,0,-19,9,-1,-2,3,5,0,-3,-1,-1,-1,-1,4,-1
KR_6731203755,420,-1,-60,-5,-8,-6,7,1,-4,5,1,0,3,3,-1,5,4,3,0,3,0,0,3,1,-6,5,0,0,-1,1,-1,-1,-1,5,-1
KR_6760562993,420,0,10,23,2,-1,2,1,-1,6,5,-1,1,0,6,0,6,-1,4,3,0,10,5,3,-5,2,1,0,0,-1,-1,0,-1,1,-1
KR_6755777704,420,-1,-8,-32,-12,1,2,3,-1,4,3,-7,7,0,-3,5,2,-2,2,0,0,-12,-29,-1,-8,9,1,0,0,-1,1,1,-1,1,-1
KR_6768549511,420,-5,-62,17,-7,-3,3,0,-1,4,3,0,1,1,-5,5,0,2,1,3,0,-7,-47,-6,-3,9,6,0,-2,1,0,-1,-1,6,-1
KR_6653231779,420,1,54,-8,3,2,1,3,1,2,3,-2,3,1,2,2,4,0,0,0,0,7,24,-2,-7,9,-4,0,0,-1,1,0,-1,1,-1
KR_6754722610,420,1,5,-13,6,1,0,1,-2,3,1,0,1,1,6,2,8,1,2,3,0,11,2,4,-10,6,6,0,0,1,-1,0,-1,2,-1
KR_6763961773,420,-2,36,1,-7,1,0,1,-2,2,0,1,1,2,-6,6,0,-1,1,0,0,-13,4,0,-7,7,-8,0,1,-1,1,1,-1,6,-1
KR_6764649589,420,-4,2,-35,-13,-1,3,2,-4,6,2,-3,3,0,-2,4,2,-3,4,1,0,-24,-20,1,-7,6,-2,0,0,-1,-1,-1,-1,5,-1
KR_6728627322,420,-5,3,-24,-7,0,1,1,-2,4,2,-5,7,2,-1,3,2,1,0,1,0,-5,-96,1,-7,6,-3,0,-1,-1,-1,-1,-1,5,-1
KR_6741947588,420,0,-53,-49,8,3,0,3,1,0,1,-1,3,2,4,0,4,1,1,2,0,9,-3,2,-6,4,4,0,-1,1,-1,-1,1,4,-1
KR_6761338886,420,-6,-110,-49,-12,-1,1,0,-6,7,1,-1,1,0,-5,7,2,1,1,2,0,-14,0,2,-4,2,3,0,-1,-1,1,-1,-1,6,-1
KR_6651540332,420,-3,-39,-29,-8,-3,5,2,-1,3,2,1,2,3,-4,4,0,-1,3,2,0,-9,4,3,-8,5,-5,0,0,-1,1,1,-1,5,-1
KR_6767149750,420,-4,-44,-11,-11,-1,3,2,-6,8,2,-5,6,1,0,1,1,1,1,2,-2,-12,-4,0,-5,5,-2,0,-1,-1,1,1,-1,4,-1
KR_6757785859,420,0,-51,-13,1,1,0,1,2,2,4,-2,3,1,0,5,5,0,0,0,0,4,-3,-7,-5,12,-3,0,-1,-1,-1,-1,-1,3,-1
KR_6754584107,420,0,46,8,-3,-2,3,1,0,3,3,-2,2,0,4,1,5,-3,3,0,0,-4,-6,-6,-5,11,6,0,0,-1,1,0,-1,2,-1
KR_6766199278,420,1,17,14,-2,-4,5,1,4,0,4,0,1,1,-1,2,1,-1,1,0,0,-1,-5,1,-8,7,-1,0,1,1,-1,1,-1,3,-1
KR_6765347205,420,-1,37,20,-8,-2,5,3,-3,6,3,-8,8,0,2,2,4,3,1,4,0,2,4,-4,-3,7,-8,0,-1,-1,-1,-1,-1,3,-1
KR_6764979108,420,1,-5,-8,-1,-1,4,3,-1,5,4,2,1,3,-1,5,4,0,1,1,-1,-7,-65,-1,-10,11,0,0,-1,0,-1,-1,-1,0,-1
KR_6753247025,420,1,-38,4,6,0,2,2,5,1,6,0,1,1,2,0,2,-1,2,1,0,11,84,3,-7,4,0,0,-1,-1,-1,-1,1,3,-1
KR_6732708981,440,-5,-116,9,-19,-2,3,1,-12,13,1,0,1,1,-4,6,2,-1,1,0,0,-20,22,-4,-3,7,-19,0,-1,-1,0,-1,-1,6,-1
KR_6764205568,420,0,42,0,-8,-1,3,2,-3,7,4,2,2,4,-6,6,0,0,0,0,0,-9,33,1,-8,7,-20,0,0,-1,1,-1,1,3,-1
KR_6679484078,420,-1,3,13,-2,3,1,4,0,2,2,1,0,1,-4,6,2,-2,2,0,0,-9,-4,-1,-5,6,1,0,-1,1,-1,-1,-1,4,-1
KR_6742841968,420,-1,19,-16,5,3,0,3,3,2,5,-3,5,2,1,1,2,1,0,1,0,10,32,3,-7,4,-4,0,-1,-1,1,-1,1,4,-1
KR_6699799172,420,0,-15,-24,3,1,2,3,2,2,4,6,1,7,-2,4,2,-4,4,0,0,-2,15,3,-7,4,-3,0,0,1,-1,0,1,3,-1
KR_6767536908,420,2,48,11,5,4,2,6,-1,2,1,0,2,2,4,2,6,-2,4,2,0,5,3,5,-7,2,-2,0,0,1,-1,0,1,5,-1
KR_6760590947,440,-2,-12,-16,-7,0,3,3,-4,4,0,-4,4,0,3,0,3,-2,5,3,0,-9,-6,-3,-3,6,4,0,-1,-1,1,-1,-1,5,-1
KR_6734726732,420,0,-28,-16,0,-1,1,0,5,3,8,0,0,0,0,3,3,-4,5,1,0,1,4,1,-8,7,-4,0,0,-1,1,-1,-1,4,-1
KR_6763376676,420,1,27,17,0,-1,2,1,-1,4,3,4,0,4,1,1,2,-3,4,1,0,-1,17,-2,-4,6,1,0,2,-1,1,1,-1,1,-1
KR_6733811422,420,-2,-8,-20,-6,0,1,1,0,2,2,-1,2,1,-4,6,2,-1,1,0,0,-11,-1,-2,-5,7,-2,0,0,-1,-1,0,1,4,-1
KR_6761610962,440,1,-56,-15,-2,1,1,2,2,2,4,-5,8,3,0,3,3,0,1,1,0,-1,-7,0,-8,8,3,0,0,-1,1,0,1,4,-1
KR_6691311357,420,-7,-73,-1,-12,-1,3,2,-8,10,2,-1,4,3,-3,5,2,1,0,1,0,-18,-36,-2,-3,5,1,0,-1,1,-1,-1,-1,6,-1
KR_6754616422,420,-4,39,-40,-7,5,0,5,-1,2,1,-4,4,0,-6,6,0,-1,2,1,0,-11,-10,1,-3,2,3,0,0,-1,-1,1,-1,4,-1
KR_6767857422,420,-2,-86,-45,-1,-4,5,1,4,0,4,-1,1,0,1,1,2,-1,3,2,-1,-3,-24,1,-8,7,-3,0,-2,-1,-1,-1,-1,3,-1
KR_6739741500,420,0,-94,25,-4,-6,6,0,1,4,5,2,2,4,-1,3,2,0,3,3,0,-1,2,-2,-3,5,0,0,-2,1,1,-1,-1,1,-1
KR_6728463452,420,-1,-16,-10,-1,-3,6,3,1,3,4,-1,5,4,2,2,4,0,0,0,0,0,1,-2,-5,7,-1,0,0,0,1,0,-1,0,-1
KR_6733410204,420,-1,65,-61,4,-1,2,1,-2,4,2,1,0,1,5,1,6,1,0,1,0,11,-11,5,-8,3,4,0,1,1,1,1,1,4,-1
KR_6761571060,440,-1,-29,4,2,-5,8,3,2,3,5,0,0,0,7,0,7,-2,3,1,0,-7,3,0,-6,6,-3,0,0,1,-1,0,-1,2,-1
KR_6769075711,420,4,30,32,4,1,0,1,3,1,4,2,2,4,-2,5,3,0,1,1,0,2,4,3,-6,3,4,0,2,1,1,1,1,5,-1
KR_6614395172,420,1,-7,-4,-3,0,2,2,1,0,1,0,2,2,-3,4,1,-1,1,0,0,-3,-9,-7,-7,14,0,0,-1,1,-1,-1,-1,3,-1
KR_6767819002,420,-3,-32,3,-11,2,0,2,-5,7,2,-1,1,0,-5,6,1,-2,2,0,0,-21,-29,-8,-4,12,0,0,-2,-1,1,-1,1,6,-1
KR_6719065340,420,1,4,25,-1,0,2,2,-1,6,5,-5,7,2,7,0,7,-2,2,0,0,9,8,3,-6,3,-5,0,0,-1,0,1,1,5,-1
KR_6734766581,420,3,80,-14,4,5,0,5,3,3,6,-1,2,1,-3,6,3,0,1,1,0,3,16,2,-5,3,2,0,1,-1,-1,1,1,5,-1
KR_6765382293,420,-10,-127,4,-21,-1,1,0,0,0,0,-9,10,1,-7,8,1,-4,5,1,-1,-16,2,-7,-4,11,-7,0,-3,-1,-1,-1,-1,1,-1
KR_6761697105,420,0,12,-23,6,-4,4,0,1,3,4,4,1,5,5,3,8,0,1,1,0,15,-1,-1,-6,7,-1,0,0,1,-1,0,1,3,-1
KR_6767129233,420,0,-55,-3,-8,0,1,1,-6,7,1,-2,3,1,-1,1,0,1,1,2,0,-4,54,-3,-7,10,-3,0,-1,-1,-1,-1,-1,3,-1
KR_6756910881,420,-4,-52,14,-12,-2,2,0,0,4,4,-2,2,0,-8,9,1,0,1,1,0,-21,-16,-3,-3,6,-1,0,-2,1,-1,-1,-1,2,-1
KR_6761810391,420,-6,-109,2,-11,-2,2,0,1,1,2,-10,10,0,-1,2,1,1,0,1,0,-11,-13,-3,-4,7,-2,0,-3,-1,0,-1,-1,3,-1
KR_6651503192,420,1,-56,-14,7,1,1,2,4,1,5,-3,4,1,1,4,5,4,0,4,0,15,-8,1,-8,7,-5,0,0,-1,-1,-1,-1,3,-1
KR_6719986198,420,-7,-79,-31,-10,1,2,3,-2,4,2,-4,5,1,-2,4,2,-3,3,0,0,1,-32,2,-7,5,-3,0,-3,-1,1,-1,-1,5,-1
KR_6732192765,420,-6,-94,-8,-9,-2,2,0,-3,4,1,-2,5,3,-1,3,2,-1,3,2,-1,-9,28,0,-6,6,-4,0,-1,0,-1,-1,-1,0,-1
KR_6696244284,440,0,-47,1,1,0,1,1,-2,4,2,3,1,4,-1,2,1,1,0,1,0,1,0,2,-6,4,0,0,-1,1,-1,-1,1,4,-1
KR_6759195357,420,-4,28,3,-7,2,0,2,-1,4,3,-2,4,2,-5,5,0,-1,1,0,0,-9,-7,-3,-4,7,-1,0,-1,1,1,-1,1,6,-1
KR_6767325351,420,-2,54,-15,-7,1,2,3,-2,5,3,-4,5,1,-3,5,2,1,2,3,-1,-11,-10,-1,-6,7,-2,0,1,-1,1,1,1,2,-1
KR_6710725531,420,-4,-85,-5,-13,-6,7,1,-2,3,1,-2,3,1,-4,6,2,1,0,1,0,-10,-23,-1,-4,5,-4,0,-2,-1,-1,-1,-1,2,-1
KR_6768432809,420,-6,-48,-23,-10,-1,2,1,-1,3,2,-3,4,1,-5,6,1,0,1,1,0,-9,-16,-3,-3,6,2,0,-2,1,-1,-1,-1,5,-1
KR_6765326029,420,1,20,-8,3,2,2,4,2,2,4,2,2,4,-3,4,1,0,1,1,0,9,-30,0,-7,7,-4,0,0,-1,1,1,-1,3,-1
KR_6767410747,420,1,47,5,-8,3,1,4,-1,3,2,-2,3,1,-2,5,3,-6,6,0,0,-18,19,-4,-6,10,1,0,0,1,-1,-1,-1,6,-1
KR_6753534775,420,3,32,0,1,0,3,3,-4,7,3,-1,2,1,7,1,8,-1,1,0,0,6,5,-1,-7,8,2,0,0,1,1,0,1,4,-1
KR_6743237479,420,-5,-96,10,-12,-5,5,0,-3,5,2,-1,2,1,-3,3,0,0,1,1,0,-8,-11,-5,-6,11,1,0,-2,-1,-1,-1,-1,6,-1
KR_6767562668,420,-4,-73,-11,-8,0,2,2,-1,3,2,1,0,1,-9,11,2,1,2,3,0,-4,-7,-5,-5,10,-1,0,0,-1,1,-1,1,5,-1
KR_6674879422,420,2,71,-44,0,3,0,3,0,3,3,2,2,4,-6,6,0,1,1,2,0,-2,7,-3,-7,10,-1,0,0,-1,-1,0,-1,2,-1
KR_6754841850,440,0,-8,5,8,1,1,2,1,3,4,2,0,2,7,1,8,-3,6,3,2,14,-25,6,-7,1,17,0,0,-1,1,1,1,2,-1
KR_6709076146,420,1,-5,19,-5,1,0,1,-4,6,2,-2,2,0,-5,7,2,5,0,5,0,-8,-88,2,-5,3,0,0,1,-1,1,1,1,2,-1
KR_6768378215,440,-3,-81,-23,-8,-2,6,4,-2,5,3,-1,1,0,-1,2,1,-2,4,2,1,-4,21,5,-7,2,-8,0,-1,-1,-1,-1,1,2,-1
KR_6764012102,420,-2,3,-13,-11,3,1,4,0,2,2,-1,2,1,-11,14,3,-2,2,0,0,-17,-10,-1,-4,5,2,0,0,-1,1,-1,1,5,-1
KR_6736253368,420,-2,-43,25,-11,0,3,3,-2,4,2,-3,5,2,-6,6,0,0,1,1,0,-17,2,-4,-2,6,-8,0,-1,-1,1,-1,-1,4,-1
KR_6746978379,420,-1,-11,-24,-7,-3,4,1,-1,5,4,-1,1,0,-1,6,5,-1,3,2,-1,-7,22,-1,-5,6,-1,0,1,-1,-1,1,-1,5,-1
KR_6766731248,420,-1,-27,-8,0,0,5,5,3,0,3,-2,2,0,1,2,3,-2,2,0,1,-5,-1,-5,-1,6,1,0,1,1,1,1,1,3,-1
KR_6742402167,420,-2,-24,9,-9,0,2,2,-5,7,2,4,0,4,-8,9,1,0,0,0,0,-15,-27,3,-7,4,3,0,1,-1,1,-1,-1,2,-1
KR_6768056108,420,0,5,36,1,0,0,0,-3,7,4,4,1,5,-1,4,3,1,1,2,0,-7,-40,-2,-5,7,10,0,-1,1,-1,-1,1,2,-1
KR_6758845836,420,-4,-31,-48,-7,1,1,2,-4,8,4,-4,5,1,1,1,2,-1,1,0,0,-9,4,-1,-4,5,-4,0,0,1,-1,-1,1,1,-1
KR_6763915789,420,-3,28,-17,-2,-4,4,0,-1,4,3,3,2,5,1,2,3,-1,5,4,0,2,-169,-6,-4,10,-1,0,0,1,-1,1,1,1,-1
KR_6714188168,420,-5,-40,-44,-12,2,1,3,-6,8,2,-4,4,0,-3,3,0,-1,2,1,-2,-8,1,-6,-2,8,2,0,0,-1,1,-1,-1,2,-1
KR_6673825740,420,1,-17,46,-1,2,1,3,-2,6,4,0,1,1,-1,3,2,0,0,0,0,-4,-36,-4,-3,7,-2,0,1,1,1,1,-1,5,-1
KR_6762575182,420,-4,-13,18,-5,-6,7,1,-2,3,1,1,0,1,-3,6,3,5,0,5,0,-5,37,-2,-2,4,-12,0,0,1,-1,-1,-1,4,-1
KR_6744649047,420,-2,9,-21,-1,-2,4,2,-3,3,0,3,1,4,2,1,3,-1,1,0,0,-3,37,-1,-8,9,-2,0,0,-1,1,0,1,1,-1
KR_6765032078,420,2,-41,8,2,0,3,3,5,0,5,-2,2,0,-4,5,1,3,0,3,0,10,6,3,-7,4,-4,0,1,-1,1,1,1,4,-1
KR_6729773584,420,0,-11,-41,-8,-4,4,0,0,4,4,-1,3,2,-3,6,3,0,1,1,1,-3,-7,-1,-7,8,-2,0,-1,-1,1,-1,1,3,-1
KR_6293139079,420,-3,-30,-3,-1,-6,6,0,2,0,2,1,1,2,2,4,6,0,1,1,0,0,-10,-3,-9,12,5,0,0,1,-1,0,1,6,-1
KR_6759617172,420,-3,-60,-8,-8,0,2,2,-5,7,2,-1,3,2,0,3,3,-2,3,1,0,-9,6,1,-7,6,-8,0,-3,-1,-1,-1,1,6,-1
KR_6768865270,420,0,-20,-6,-2,-4,4,0,2,1,3,1,2,3,2,3,5,-3,6,3,-1,-3,-6,3,-5,2,-4,0,0,-1,1,0,-1,1,-1
KR_6763158196,420,-3,-39,18,-8,-7,7,0,-2,7,5,1,3,4,0,3,3,0,2,2,0,-5,-3,-1,-6,7,4,0,-1,1,-1,-1,-1,1,-1
KR_6763455942,440,-8,-50,16,-19,-5,7,2,1,0,1,-8,9,1,-11,12,1,4,0,4,0,-14,43,-2,-4,6,-17,0,-3,1,-1,-1,-1,2,-1
KR_6714730139,420,3,-23,-2,7,1,1,2,2,2,4,-3,4,1,7,2,9,0,0,0,1,8,7,7,-10,3,-3,0,0,1,0,0,1,2,-1
KR_6768372941,420,1,63,3,2,1,2,3,2,4,6,0,4,4,-1,2,1,0,0,0,0,5,25,-1,-5,6,-1,0,1,-1,-1,1,1,3,-1
KR_6757103885,420,0,-12,21,0,3,1,4,-2,4,2,-2,7,5,1,4,5,0,0,0,0,-2,-17,0,-4,4,1,0,1,0,-1,1,1,0,-1
KR_6749972369,420,-2,36,12,-4,0,2,2,-1,4,3,2,1,3,-5,6,1,0,0,0,0,-5,-8,-3,-4,7,1,0,1,-1,1,1,-1,3,-1
KR_6757939592,420,1,25,7,0,0,1,1,0,3,3,-1,2,1,2,2,4,-1,3,2,0,-8,7,-3,-4,7,0,0,0,-1,-1,0,1,3,-1
KR_6759082195,420,2,60,-10,4,3,0,3,-4,6,2,1,0,1,3,1,4,1,0,1,0,4,-4,-3,-5,8,6,0,1,-1,1,1,1,3,-1
KR_6769007380,420,-1,-29,3,-10,-3,4,1,-3,6,3,-5,7,2,0,1,1,1,2,3,0,-11,4,-1,-3,4,-2,0,-1,-1,1,-1,-1,3,-1
KR_6740827485,420,1,-31,19,-7,-5,6,1,0,1,1,-1,5,4,0,3,3,-1,3,2,-1,-5,-4,-2,-3,5,1,0,-1,1,1,-1,-1,6,-1
KR_6755685291,440,-6,-59,-21,-9,-3,5,2,-2,4,2,-1,3,2,-1,3,2,-2,2,0,0,-3,16,0,-7,7,-3,0,-1,-1,1,-1,-1,2,-1
KR_6643243286,420,-3,-19,-16,-1,1,0,1,1,1,2,0,4,4,-3,3,0,0,1,1,0,-4,4,0,-10,10,-5,0,0,-1,1,0,1,5,-1
KR_6759583496,420,-5,-55,-29,-13,-4,7,3,-3,4,1,-3,5,2,-1,5,4,-2,4,2,1,-4,-4,3,-7,4,0,0,-2,1,-1,-1,1,1,-1
KR_6739987056,440,-4,-37,-34,-8,-1,4,3,-6,8,2,-4,4,0,0,4,4,3,1,4,0,-5,-4,-1,-4,5,0,0,0,1,-1,0,-1,4,-1
KR_6749709554,420,-2,-103,4,1,0,0,0,-1,5,4,4,1,5,-2,5,3,0,1,1,2,1,-16,-2,-2,4,0,0,-1,-1,1,-1,1,2,-1
KR_6767919208,420,-3,-80,-17,-10,1,1,2,-5,6,1,-1,2,1,-6,6,0,1,1,2,0,-12,-7,-2,-5,7,-2,0,0,-1,1,-1,-1,1,-1
KR_6753618479,420,0,7,-16,5,0,1,1,3,0,3,-1,3,2,5,3,8,-2,5,3,0,4,-101,6,-9,3,3,0,-1,-1,1,-1,1,3,-1
KR_6698490986,440,-2,-37,14,-6,0,1,1,-2,6,4,-3,6,3,2,2,4,-3,5,2,-1,-1,-19,1,-6,5,-6,0,-1,1,-1,-1,-1,1,-1
KR_6696945309,420,-3,-86,-54,-11,0,1,1,-5,6,1,-4,6,2,-1,2,1,-1,1,0,0,-18,-30,-1,-6,7,-1,0,-2,1,-1,-1,-1,4,-1
KR_6719237670,440,-1,-49,-4,-8,1,1,2,0,4,4,-2,2,0,-7,8,1,0,2,2,-1,-11,-274,-2,-2,4,1,0,0,-1,0,-1,-1,3,-1
KR_6750442110,420,-3,1,-7,-7,-4,5,1,0,3,3,1,2,3,-2,2,0,-2,3,1,0,-4,-6,-1,-7,8,4,0,0,1,-1,0,-1,6,-1
KR_6762573308,420,3,33,4,-1,1,0,1,-8,8,0,2,2,4,2,0,2,2,0,2,0,-4,-3,1,-7,6,7,0,0,-1,-1,0,1,2,-1
KR_6767035803,420,-1,-60,-25,-5,-4,4,0,-2,5,3,2,1,3,2,4,6,-3,3,0,0,4,-19,-6,-4,10,6,0,-1,0,-1,-1,-1,0,-1
KR_6764838406,420,-1,-30,-15,-4,-3,3,0,1,2,3,0,1,1,0,4,4,-2,2,0,0,-5,3,2,-6,4,-2,0,-1,-1,-1,-1,1,5,-1
KR_6751259170,440,-4,-14,-30,-2,4,0,4,-5,5,0,-2,2,0,-1,2,1,2,1,3,0,-6,1,4,-8,4,-2,0,0,-1,-1,0,1,4,-1
KR_6725416312,420,-1,-1,12,0,-2,5,3,4,1,5,2,1,3,-5,5,0,1,0,1,0,-3,3,-2,-4,6,3,0,-1,1,-1,-1,1,3,-1
KR_6745666763,420,-1,-70,25,-4,0,2,2,-1,2,1,-1,2,1,-2,3,1,0,2,2,0,0,9,0,-5,5,0,0,0,1,1,0,1,6,-1
KR_6739934235,420,-5,-137,-28,-9,-2,2,0,4,1,5,-1,2,1,-9,9,0,-1,1,0,-1,-7,57,3,-6,3,-6,0,-3,-1,-1,-1,-1,3,-1
KR_6720434747,420,-1,-29,-14,-8,-4,4,0,-3,4,1,0,2,2,0,4,4,-1,1,0,0,-9,-6,-6,-4,10,-3,0,0,-1,-1,0,-1,4,-1
KR_6764435918,420,-3,19,-17,-3,4,0,4,-5,8,3,0,2,2,0,2,2,-2,2,0,-1,-13,21,2,-9,7,-2,0,0,-1,1,0,-1,4,-1
KR_6759724665,420,-7,-73,-13,-13,2,3,5,-7,9,2,1,1,2,-4,5,1,-5,6,1,0,-18,-1,-1,-6,7,-1,0,-3,-1,1,-1,1,4,-1
KR_6734530545,420,-1,-24,4,-4,-2,4,2,1,3,4,-5,5,0,2,3,5,0,0,0,-1,-7,-22,-1,-4,5,-2,0,0,1,-1,0,-1,3,-1
KR_6540053324,420,-1,-2,-20,-5,-2,3,1,0,2,2,0,3,3,-4,4,0,1,0,1,0,-4,-6,0,-5,5,-3,0,0,-1,1,0,-1,6,-1
KR_6755501827,440,3,48,0,5,0,1,1,0,4,4,2,3,5,4,1,5,-1,1,0,0,2,15,5,-9,4,-5,0,0,-1,1,0,-1,2,-1
KR_6744694777,420,-2,-35,-1,-2,-1,1,0,-1,2,1,3,5,8,-4,5,1,1,2,3,0,3,-2,-1,-4,5,-5,0,0,-1,-1,-1,1,4,-1
KR_6646741135,420,0,-23,-12,-5,-1,3,2,2,4,6,-2,3,1,-2,3,1,-2,2,0,0,-3,13,5,-8,3,-1,0,-1,-1,-1,-1,-1,5,-1
KR_6760834110,420,2,38,22,3,1,1,2,-6,6,0,3,1,4,3,1,4,2,1,3,0,4,-41,-6,-7,13,4,0,0,-1,-1,1,1,1,-1
KR_6768207978,420,-5,-11,-4,-12,0,1,1,-4,4,0,-4,6,2,-2,3,1,-2,2,0,0,-13,-6,-3,-4,7,-4,0,-1,-1,-1,-1,-1,4,-1
KR_6724768565,420,-2,-39,-48,-2,-2,2,0,2,2,4,0,4,4,-2,4,2,0,2,2,-1,7,3,4,-10,6,2,0,-1,1,-1,-1,-1,4,-1
KR_6745548532,420,-3,-63,12,-8,-4,5,1,-2,4,2,-1,2,1,0,2,2,-1,1,0,0,-8,-2,-2,-4,6,0,0,-1,-1,1,-1,-1,3,-1
KR_6762953971,440,-1,-50,-12,0,-2,4,2,-4,4,0,0,2,2,2,2,4,4,3,7,0,-1,-4,0,-5,5,0,0,-2,0,-1,-1,1,0,-1
KR_6763969890,420,-3,-5,4,-5,0,2,2,-4,4,0,-1,2,1,2,0,2,-2,2,0,0,-12,-20,5,-7,2,-8,0,-1,-1,-1,-1,1,1,-1
KR_6766586064,420,-3,-12,-4,6,6,0,6,-3,6,3,-2,4,2,7,2,9,-2,2,0,3,6,3,5,-8,3,-6,0,2,1,-1,1,1,1,-1
KR_6698217876,420,-7,-12,-9,-7,-1,2,1,1,3,4,-3,3,0,3,4,7,-7,7,0,1,0,6,7,-9,2,-7,0,-1,-1,1,-1,1,3,-1
KR_6766735338,420,-2,-21,-29,-2,4,0,4,4,0,4,0,2,2,-4,4,0,-6,6,0,2,-2,-51,2,-9,7,0,0,1,-1,-1,1,1,6,-1
KR_6699877594,420,-2,23,-19,-2,1,3,4,-4,5,1,-3,5,2,4,0,4,0,0,0,0,0,7,1,-8,7,-2,0,0,-1,1,0,1,4,-1
KR_6769058848,420,2,-35,-32,1,5,0,5,-2,6,4,0,0,0,0,3,3,-2,3,1,0,-3,-29,-1,-7,8,3,0,-3,-1,-1,-1,-1,1,-1
KR_6762024347,420,0,-20,-13,2,0,2,2,0,4,4,0,3,3,1,1,2,1,2,3,0,-2,4,1,-5,4,-1,0,-1,1,-1,-1,-1,6,-1
KR_6738003314,420,0,-31,-4,3,-1,2,1,1,3,4,1,2,3,0,3,3,2,1,3,2,7,1,1,-5,4,-2,0,0,-1,-1,0,1,4,-1
KR_6767375848,420,-4,-41,-13,-10,-4,4,0,-6,7,1,0,2,2,-2,4,2,2,0,2,0,-15,16,-3,-5,8,1,0,-1,-1,-1,-1,1,2,-1
KR_6631099820,420,-5,-126,4,-14,0,1,1,2,4,6,-7,8,1,-5,5,0,-4,4,0,0,-14,-11,-5,-2,7,4,0,-4,-1,-1,-1,1,3,-1
KR_6762976991,420,0,3,0,0,1,1,2,-1,3,2,-1,3,2,2,0,2,-1,4,3,0,-7,7,6,-10,4,-5,0,0,1,-1,-1,1,4,-1
KR_6661261048,420,1,39,3,7,-3,3,0,3,3,6,2,2,4,6,1,7,-1,3,2,0,16,-1,-2,-3,5,3,0,2,-1,1,1,1,6,-1
KR_6573184498,420,-3,-6,-10,-9,0,2,2,-4,6,2,-3,6,3,0,1,1,-2,2,0,0,-12,44,2,-8,6,2,0,-2,1,0,-1,-1,4,-1
KR_6766832012,420,-2,-48,-6,1,0,1,1,3,2,5,0,2,2,-1,5,4,-1,1,0,0,-4,-22,2,-7,5,2,0,0,-1,1,0,1,2,-1
KR_6634691454,420,0,0,-11,-1,-1,2,1,3,2,5,-9,11,2,5,0,5,1,0,1,0,7,44,1,-6,5,1,0,-1,-1,-1,-1,1,3,-1
KR_6767001158,420,0,-11,39,3,1,2,3,0,2,2,4,0,4,1,2,3,-3,4,1,0,10,1,1,-6,5,2,0,0,1,-1,-1,-1,2,-1
KR_6716224319,420,0,38,-13,0,-2,4,2,0,4,4,-4,7,3,7,0,7,-1,2,1,0,-5,-8,-6,-4,10,1,0,0,-1,1,0,1,4,-1
KR_6753582781,420,0,-21,10,-2,-4,5,1,2,0,2,-4,4,0,2,0,2,2,0,2,0,8,5,0,-5,5,-1,0,-2,1,-1,-1,-1,5,-1
KR_6737425911,420,-6,-100,-35,-14,-2,5,3,-10,11,1,1,1,2,3,4,7,-6,10,4,0,-18,-3,2,-6,4,-4,0,-2,-1,-1,-1,1,5,-1
KR_6763563419,420,-3,-53,8,-5,-7,7,0,-2,3,1,8,0,8,-2,2,0,-2,3,1,1,2,37,-4,-5,9,-5,0,-1,-1,1,1,1,5,-1
KR_6763846698,420,-4,-29,-4,-10,0,1,1,-2,2,0,-2,2,0,-3,6,3,-3,3,0,0,-12,6,4,-7,3,-4,0,-1,0,-1,-1,-1,0,-1
KR_6764404588,420,-6,-59,-31,-7,-7,7,0,-1,3,2,0,1,1,0,5,5,1,2,3,0,-4,-9,-1,-9,10,-2,0,-1,-1,-1,-1,-1,5,-1
KR_6759597719,420,0,-7,20,-2,2,0,2,-1,2,1,-4,5,1,0,1,1,1,0,1,-1,-7,-8,-1,-7,8,4,0,-1,1,1,-1,-1,3,-1
KR_6700965343,420,3,71,21,6,1,1,2,2,0,2,0,3,3,3,4,7,0,0,0,0,12,4,4,-5,1,0,0,2,1,1,1,1,1,-1
KR_6768720935,420,0,54,1,-1,1,0,1,-4,6,2,-1,3,2,2,1,3,1,0,1,0,-1,-3,1,-6,5,7,0,0,1,1,0,1,6,-1
KR_6766807999,420,-4,-80,-13,-9,-2,3,1,0,4,4,1,0,1,-6,7,1,-2,2,0,0,-4,-18,-3,-5,8,2,0,-1,-1,1,-1,1,2,-1
KR_6671001748,440,2,22,37,1,2,2,4,1,2,3,-2,2,0,-1,2,1,1,0,1,0,-5,-8,-1,-3,4,-1,0,1,-1,1,1,-1,3,-1
KR_6768773931,440,-5,-40,-6,-9,-1,1,0,-2,3,1,-3,3,0,0,4,4,-3,4,1,0,-6,-1,0,-5,5,-1,0,-1,1,-1,-1,1,3,-1
KR_6679318986,420,-3,-23,-24,-7,1,1,2,-2,5,3,-3,6,3,-1,7,6,-2,3,1,0,-15,0,2,-5,3,0,0,-1,-1,-1,-1,-1,1,-1
KR_6660591872,420,-5,-38,-29,-3,2,4,6,-1,3,2,-4,5,1,0,2,2,0,0,0,0,-1,9,3,-7,4,0,0,-1,-1,-1,-1,-1,1,-1
KR_6766981926,420,-2,-63,18,-9,0,2,2,-1,2,1,-2,3,1,-5,5,0,-1,1,0,0,-6,2,-2,-6,8,1,0,0,1,1,0,-1,5,-1
KR_6766512072,420,-2,-27,-4,-7,1,0,1,-3,4,1,-1,2,1,-2,5,3,-2,3,1,-1,-8,-91,2,-7,5,-1,0,-1,-1,1,-1,-1,6,-1
KR_6760624705,420,1,20,-3,2,-3,4,1,-2,3,1,4,1,5,1,2,3,2,2,4,0,0,9,-1,-6,7,-1,0,0,0,1,-1,-1,0,-1
KR_6710959241,420,-4,-53,-35,-6,1,1,2,-3,8,5,-4,4,0,1,0,1,-1,2,1,0,-6,3,-1,-4,5,-1,0,-2,-1,-1,-1,1,2,-1
KR_6699952986,420,-3,-67,-15,-6,-1,2,1,-4,5,1,-2,3,1,3,3,6,-2,3,1,-2,-5,-4,-1,-6,7,-6,0,-1,-1,-1,-1,-1,3,-1
KR_6768985613,420,1,24,3,0,-2,4,2,3,0,3,0,1,1,-2,4,2,1,2,3,-1,3,-6,-1,-7,8,6,0,1,1,1,1,-1,6,-1
KR_6761953367,420,-3,-38,20,-9,-4,4,0,2,0,2,-3,3,0,-4,4,0,0,1,1,0,-12,115,-2,-3,5,0,0,-2,1,1,-1,-1,3,-1
KR_6759810115,440,-3,-38,-13,-9,-4,5,1,1,1,2,-3,3,0,-4,5,1,1,1,2,0,-9,-4,-1,-9,10,0,0,-1,-1,-1,-1,-1,3,-1
KR_6744253112,440,-4,-82,1,-10,-1,3,2,1,2,3,-5,6,1,-5,5,0,0,1,1,-1,-11,2,0,-2,2,-3,0,-1,-1,-1,-1,-1,1,-1
KR_6767885813,440,2,36,-9,2,0,3,3,3,0,3,-1,1,0,2,2,4,-2,2,0,0,2,2,-3,-4,7,0,0,0,-1,-1,0,1,1,-1
KR_6768626321,420,1,3,20,-2,-2,3,1,2,2,4,-1,2,1,-1,3,2,0,0,0,0,-5,24,-1,-6,7,3,0,0,-1,0,0,1,5,-1
KR_6675286023,420,0,-58,-11,-4,-3,3,0,0,3,3,-1,2,1,1,1,2,-1,1,0,0,-4,-30,3,-5,2,-5,0,0,1,-1,-1,1,6,-1
KR_6750825623,420,-4,-37,-3,-9,1,3,4,-3,4,1,-2,4,2,-6,7,1,1,0,1,0,-10,2,-3,-5,8,2,0,0,-1,1,-1,-1,4,-1
KR_6723610976,420,-2,-4,28,-8,-2,2,0,0,0,0,-2,3,1,-6,7,1,2,1,3,-1,-14,3,3,-8,5,0,0,-2,-1,-1,-1,-1,1,-1
KR_6719671903,420,-1,-30,-12,1,1,1,2,-2,3,1,2,2,4,0,4,4,0,0,0,0,-1,10,3,-9,6,-2,0,0,-1,-1,0,-1,4,-1
KR_6693582284,420,-5,-108,-43,-7,-6,6,0,0,2,2,1,1,2,-2,2,0,0,1,1,0,-5,81,-6,-4,10,-25,0,-2,-1,-1,-1,-1,2,-1
KR_6659385937,420,2,-4,16,4,2,0,2,0,5,5,2,2,4,-1,4,3,1,2,3,0,1,-3,5,-9,4,-4,0,-1,-1,1,-1,-1,1,-1
KR_6717320964,420,-3,29,-10,0,-2,2,0,5,3,8,4,1,5,-7,8,1,0,3,3,1,-7,1,-4,-5,9,-2,0,-1,-1,-1,-1,1,5,-1
KR_6737738704,420,1,14,16,1,2,1,3,0,1,1,-1,3,2,2,2,4,-2,2,0,0,-5,8,3,-7,4,0,0,0,-1,1,1,-1,3,-1
KR_6742123479,420,-1,-51,-3,6,5,0,5,-1,1,0,2,1,3,-2,6,4,2,0,2,0,3,-47,-3,-2,5,28,0,1,-1,1,1,1,1,-1
KR_6716586228,420,-2,-16,-36,-1,1,0,1,-4,7,3,-1,1,0,3,2,5,0,0,0,0,3,-2,2,-8,6,0,0,-1,-1,-1,-1,1,2,-1
KR_6768737534,440,-1,-17,16,1,2,0,2,-1,4,3,-6,7,1,3,2,5,3,1,4,0,-6,-9,-1,-8,9,6,0,0,-1,1,0,1,1,-1
KR_6758794823,420,-4,-73,-12,-8,-8,8,0,-3,5,2,-3,3,0,5,2,7,1,0,1,0,6,-6,-4,-4,8,-1,0,0,0,-1,-1,-1,0,-1
KR_6655864557,420,-2,-32,28,-10,-3,4,1,2,1,3,-6,7,1,-3,4,1,0,3,3,0,-10,6,3,-6,3,-5,0,-2,-1,-1,-1,-1,5,-1
KR_6765962886,420,1,50,20,3,2,1,3,2,3,5,1,3,4,-1,1,0,-1,1,0,-1,0,7,1,-5,4,2,0,1,-1,1,1,-1,5,-1
KR_6691291268,420,-1,-60,16,-3,0,0,0,-1,2,1,-2,6,4,1,1,2,-1,1,0,0,5,-17,3,-9,6,0,0,-1,1,-1,-1,-1,1,-1
KR_6729786871,420,-3,-57,3,-11,-1,3,2,-2,5,3,-1,2,1,-4,6,2,-3,4,1,-2,-17,35,1,-6,5,-2,0,-1,1,-1,-1,-1,4,-1
KR_6735550153,420,-3,-6,23,-9,-2,4,2,-1,5,4,-4,5,1,-2,2,0,0,1,1,0,-6,-9,-3,-4,7,0,0,0,0,-1,0,-1,0,-1
KR_6756846474,420,1,1,25,-1,0,3,3,0,4,4,-3,5,2,3,0,3,-1,2,1,0,2,-250,3,-4,1,3,0,-1,1,-1,-1,-1,2,-1
KR_6765519504,420,-1,20,-6,-8,-1,4,3,-3,4,1,-1,3,2,-2,2,0,-1,4,3,-1,-16,0,-2,-4,6,3,0,0,-1,1,-1,-1,6,-1
KR_6759054555,420,-3,23,4,-6,-1,3,2,-2,4,2,-1,3,2,-4,6,2,2,0,2,0,-3,4,-4,-2,6,6,0,0,-1,1,0,1,5,-1
KR_6767428993,420,-4,-23,-14,-6,2,1,3,2,0,2,-3,6,3,-4,6,2,-3,3,0,-1,-11,-21,-4,-5,9,-1,0,0,-1,-1,-1,-1,1,-1
KR_6743515599,420,-6,-64,-11,-12,0,2,2,-5,6,1,1,2,3,-8,9,1,0,2,2,0,-16,3,3,-8,5,-3,0,0,1,-1,-1,1,6,-1
KR_6767522059,420,-1,4,-19,0,1,1,2,-2,5,3,-1,2,1,1,2,3,1,0,1,0,3,7,1,-5,4,-6,0,0,-1,1,0,-1,1,-1
KR_6688911323,440,-3,-52,-38,-5,-1,1,0,-4,5,1,-2,5,3,1,2,3,1,0,1,-2,-2,-2,-2,-5,7,2,0,-4,-1,0,-1,-1,5,-1
KR_6754402605,420,-3,-74,1,-8,0,1,1,-6,7,1,-3,4,1,-3,4,1,4,0,4,-1,-13,-35,2,-6,4,22,0,-2,-1,-1,-1,1,5,-1
KR_6765559407,420,1,-1,19,-1,0,1,1,1,1,2,-2,3,1,0,4,4,0,0,0,0,-2,-6,-6,-1,7,0,0,0,-1,-1,-1,-1,4,-1
KR_6760710402,420,-4,-16,12,-9,-1,5,4,-2,4,2,1,2,3,-5,6,1,-2,2,0,0,-11,-6,-6,-3,9,0,0,-2,-1,-1,-1,-1,2,-1
KR_6762475330,420,-5,-73,9,-6,-4,5,1,0,3,3,-1,1,0,-1,3,2,0,2,2,-1,-13,-13,3,-8,5,-3,0,-2,-1,-1,-1,-1,2,-1
KR_6745144515,420,0,-30,34,-7,-5,5,0,1,2,3,-1,2,1,-1,3,2,-1,2,1,-1,-7,0,-5,-6,11,-2,0,0,1,-1,-1,-1,1,-1
KR_6763505547,420,1,-28,-20,4,-1,1,0,3,0,3,1,1,2,-1,5,4,2,0,2,-1,-1,20,0,-3,3,0,0,-1,-1,1,-1,-1,1,-1
KR_6759885234,420,-5,-45,30,-8,-1,2,1,-4,5,1,-3,7,4,1,5,6,-1,1,0,0,-4,-1,-2,-6,8,-1,0,-2,1,-1,-1,-1,6,-1
KR_6749413984,420,-2,7,-12,-3,2,0,2,-1,2,1,-4,4,0,0,0,0,0,0,0,0,1,0,1,-5,4,-2,0,0,-1,1,0,-1,2,-1
KR_6754932316,420,-4,-74,-26,-11,-7,9,2,-3,5,2,1,1,2,-2,4,2,0,1,1,0,-4,-10,0,-9,9,-4,0,0,-1,-1,-1,-1,3,-1
KR_6749617946,420,1,-3,-6,0,-6,6,0,3,2,5,4,1,5,0,2,2,-1,2,1,0,5,27,-4,-2,6,-3,0,1,0,-1,-1,-1,0,-1
KR_6760542913,420,-1,22,-14,-2,-4,4,0,-3,5,2,0,4,4,5,0,5,0,2,2,1,-17,101,1,-8,7,0,0,1,1,-1,1,1,3,-1
KR_6691269554,420,-7,-123,-49,-13,-2,3,1,-2,3,1,-5,5,0,0,1,1,-4,4,0,-2,-12,12,-3,-3,6,-3,0,-5,-1,-1,-1,-1,3,-1
KR_6659360677,420,-1,-77,7,-9,-1,1,0,-3,3,0,-1,4,3,-1,2,1,-3,3,0,0,-11,27,-2,0,2,1,0,-3,0,-1,-1,-1,0,-1
KR_6762676355,420,-5,-60,-32,-5,-3,3,0,-11,12,1,5,4,9,1,5,6,3,0,3,2,0,31,3,-5,2,2,0,0,1,-1,0,1,6,-1
KR_6767723156,420,-4,-40,9,-11,-8,8,0,2,1,3,-6,6,0,0,3,3,1,0,1,0,-9,-46,-6,-3,9,13,0,0,-1,1,-1,1,2,-1
KR_6698670498,420,-5,-93,-16,-11,-1,3,2,-2,3,1,-3,4,1,-4,4,0,-1,1,0,0,-9,-3,-3,-6,9,-2,0,-1,-1,-1,-1,-1,1,-1
KR_6768713387,420,0,-7,0,-3,1,0,1,-5,6,1,0,3,3,2,2,4,-1,3,2,-2,0,8,3,-6,3,-2,0,1,-1,-1,1,-1,3,-1
KR_6768623731,420,1,16,10,1,1,0,1,-2,4,2,-1,3,2,0,3,3,3,2,5,0,-1,-5,4,-9,5,-4,0,0,1,-1,1,-1,3,-1
KR_6768896439,420,-2,-7,-10,4,1,2,3,3,0,3,-1,1,0,2,1,3,-1,1,0,0,5,236,-1,-4,5,3,0,0,-1,1,1,1,3,-1
KR_6765022092,420,0,30,1,0,-1,4,3,0,4,4,-1,2,1,6,0,6,-4,5,1,0,-4,-26,0,-5,5,-3,0,0,1,-1,1,1,4,-1
KR_6762674738,420,-4,-7,-44,-10,-1,2,1,-1,3,2,-5,7,2,-2,4,2,-1,2,1,0,-4,2,1,-6,5,-2,0,-1,1,1,-1,-1,3,-1
KR_6635114725,420,-1,-6,22,-8,-2,3,1,3,4,7,-6,6,0,-3,3,0,0,2,2,0,-8,26,-7,-5,12,4,0,-2,-1,0,-1,1,4,-1
KR_6758975808,420,3,8,6,1,0,4,4,0,4,4,1,5,6,-2,5,3,2,0,2,0,2,-7,0,-6,6,-3,0,-1,-1,-1,-1,-1,6,-1
KR_6763385558,420,-4,-55,-7,-1,0,0,0,-3,3,0,3,2,5,-1,3,2,0,2,2,0,0,-1,-1,-4,5,3,0,0,-1,-1,0,-1,2,-1
KR_6617080686,420,-1,-41,-20,-6,3,1,4,0,1,1,2,2,4,-10,11,1,-1,2,1,-2,-1,1,2,-6,4,-3,0,0,-1,-1,-1,-1,4,-1
KR_6616713324,420,-5,-49,43,-11,-3,6,3,-2,2,0,-4,6,2,-2,6,4,0,3,3,0,-9,35,-2,-2,4,-20,0,-2,-1,-1,-1,-1,5,-1
KR_6695221574,440,-2,14,12,-6,0,1,1,-1,2,1,-2,5,3,-4,5,1,1,0,1,-1,-15,47,1,-5,4,-28,0,1,-1,1,1,-1,1,-1
KR_6764221480,440,1,-55,4,-2,-2,7,5,-5,8,3,0,2,2,2,4,6,3,1,4,0,-15,13,2,-4,2,-3,0,0,0,1,1,-1,0,-1
KR_6718788875,420,-4,-50,-23,-7,1,1,2,2,4,6,-5,6,1,-4,5,1,-1,1,0,0,-8,-8,4,-9,5,2,0,0,1,1,-1,1,2,-1
KR_6768512573,440,-4,-76,-12,-13,-8,9,1,0,3,3,-1,3,2,-3,6,3,-1,1,0,0,-7,-10,0,-5,5,4,0,-3,0,0,-1,-1,0,-1
KR_6704253215,420,0,-11,1,5,-1,2,1,1,2,3,2,2,4,2,2,4,1,0,1,0,15,-24,2,-9,7,-5,0,-1,1,-1,-1,1,4,-1
KR_6766103734,420,-1,-3,-8,1,-6,8,2,1,2,3,2,2,4,2,1,3,2,1,3,-1,16,24,3,-5,2,-1,0,0,1,-1,1,-1,3,-1
KR_6768510373,440,-5,-91,17,-13,2,1,3,-2,4,2,-4,5,1,-9,9,0,0,0,0,0,-16,-2,-4,-3,7,-2,0,-1,-1,1,-1,-1,2,-1
KR_6754821427,420,-3,-32,7,-13,-1,3,2,-2,5,3,-3,4,1,-5,6,1,-2,3,1,-2,-21,8,-2,-3,5,-4,0,-2,-1,-1,-1,-1,6,-1
KR_6746950998,420,-2,43,-10,2,-2,3,1,2,2,4,4,0,4,0,3,3,-2,3,1,0,7,-23,1,-5,4,4,0,-1,-1,-1,-1,-1,4,-1
KR_6732832666,440,0,46,-32,-3,2,1,3,0,4,4,0,1,1,-2,4,2,-3,3,0,0,-4,-24,-4,-4,8,-8,0,0,-1,-1,1,-1,1,-1
KR_6765189813,420,-3,6,1,-8,-2,2,0,0,2,2,-1,1,0,-4,4,0,-1,3,2,0,-9,-20,-2,-3,5,9,0,-2,-1,-1,-1,1,4,-1
KR_6763859912,420,1,8,35,0,-1,1,0,-4,5,1,4,2,6,-2,4,2,3,0,3,0,0,-7,-3,-5,8,-3,0,1,-1,1,1,1,5,-1
KR_6766806363,440,1,2,32,-5,0,1,1,-1,3,2,0,0,0,-3,3,0,-1,1,0,0,-7,1,0,-10,10,-1,0,0,-1,1,0,-1,2,-1
KR_6766810770,420,-2,-3,-24,-4,1,0,1,-4,5,1,1,0,1,-2,4,2,0,0,0,0,-6,-2,1,-4,3,-4,0,1,-1,1,1,-1,5,-1
KR_6715414822,420,-6,-70,-1,-12,2,2,4,-4,5,1,-5,5,0,-4,4,0,-1,1,0,0,-18,-1,0,-5,5,-7,0,-1,-1,-1,-1,1,3,-1
KR_6738254662,420,0,-44,-20,-2,2,3,5,-8,9,1,0,2,2,5,1,6,-1,1,0,0,-4,5,0,-4,4,0,0,0,-1,-1,-1,1,4,-1
KR_6723133687,420,-4,-12,-3,-8,-2,2,0,-4,4,0,-7,8,1,5,0,5,0,0,0,0,-2,1,-4,-3,7,-4,0,-1,0,-1,-1,-1,0,-1
KR_6724969380,420,2,33,4,1,0,3,3,2,3,5,-1,2,1,-1,5,4,1,0,1,1,7,-21,-5,-1,6,5,0,0,-1,-1,0,1,2,-1
KR_6756692027,420,-3,2,-9,-14,0,1,1,-4,7,3,-1,4,3,-9,10,1,0,1,1,0,-10,2,-2,-3,5,-1,0,0,-1,-1,0,-1,4,-1
KR_6743971250,420,2,-29,22,-2,-1,1,0,-3,5,2,1,2,3,0,0,0,1,0,1,0,-4,-1,0,-6,6,3,0,0,1,1,0,-1,4,-1
KR_6705349584,420,-3,-19,-32,-5,-3,5,2,-2,4,2,-1,2,1,0,2,2,1,0,1,0,-4,8,4,-8,4,-2,0,-1,1,-1,-1,-1,2,-1
KR_6725430055,420,0,-8,-1,-3,-5,6,1,-1,7,6,0,3,3,2,3,5,1,0,1,0,2,13,0,-7,7,0,0,2,1,-1,1,1,4,-1
KR_6768063044,420,-3,-27,23,-1,-4,6,2,3,2,5,1,2,3,-2,6,4,1,0,1,1,6,-59,4,-8,4,-2,0,-1,0,1,-1,1,0,-1
KR_6730973213,420,1,-58,13,2,-1,2,1,3,3,6,1,3,4,-3,6,3,2,3,5,1,1,2,-2,-5,7,1,0,0,-1,-1,0,1,4,-1
KR_6732780166,420,-1,-11,15,-5,1,0,1,0,3,3,-2,2,0,-4,7,3,0,0,0,-1,-2,-76,-1,-6,7,-5,0,-1,-1,1,-1,-1,6,-1
KR_6728101007,420,-3,-59,-36,-8,-3,3,0,-4,7,3,-2,2,0,1,3,4,0,1,1,0,-6,-8,-2,-1,3,-2,0,0,1,1,0,1,6,-1
KR_6763550924,420,1,30,-11,-7,1,0,1,2,3,5,-10,12,2,-1,3,2,1,1,2,-1,-4,29,0,-3,3,-4,0,-1,-1,0,-1,-1,3,-1
KR_6767215596,420,1,4,38,3,0,1,1,1,1,2,0,3,3,3,2,5,-1,1,0,0,0,-199,-3,-6,9,-2,0,2,0,1,1,1,0,-1
KR_6761735733,420,-3,-49,13,-3,-1,2,1,-1,2,1,2,3,5,0,2,2,-3,5,2,0,0,0,-7,-2,9,4,0,1,-1,1,1,-1,4,-1
KR_6761821381,420,-2,-46,0,-3,-1,1,0,-1,2,1,1,1,2,-1,6,5,-1,2,1,1,-10,1,0,-7,7,3,0,0,-1,-1,-1,1,2,-1
KR_6688923051,420,4,46,12,7,1,1,2,4,2,6,1,3,4,2,0,2,-1,2,1,0,12,-88,3,-8,5,1,0,-1,-1,-1,-1,-1,4,-1
KR_6723678077,420,-2,-27,-8,-6,-3,3,0,-5,7,2,3,0,3,0,2,2,-1,2,1,0,2,-18,4,-7,3,-2,0,0,1,-1,-1,-1,5,-1
KR_6764377850,420,-1,-25,20,-10,-2,2,0,-2,3,1,-1,3,2,-5,6,1,0,2,2,0,-11,1,-3,-8,11,-2,0,-2,-1,-1,-1,1,4,-1
KR_6768699621,420,-2,-67,-11,-4,1,2,3,-1,1,0,0,3,3,-4,5,1,0,0,0,0,-11,21,1,-4,3,-3,0,-1,-1,1,-1,-1,2,-1
KR_6737341771,420,0,-1,24,-4,-3,4,1,-1,5,4,-3,4,1,2,3,5,1,0,1,0,-1,-3,1,-5,4,4,0,1,1,1,1,1,1,-1
KR_6726879755,420,-3,-64,-3,-7,4,0,4,-4,7,3,-4,4,0,-6,7,1,3,0,3,-1,-9,45,3,-8,5,-4,0,0,-1,1,1,-1,6,-1
KR_6768708226,420,-3,-39,1,4,-2,2,0,0,1,1,5,3,8,2,7,9,-1,1,0,0,6,-5,-1,-6,7,-3,0,-1,-1,-1,-1,1,5,-1
KR_6679192626,420,-2,0,-5,-7,-4,4,0,-3,4,1,-2,6,4,1,2,3,1,0,1,-1,-7,3,2,-5,3,0,0,1,-1,1,1,-1,1,-1
KR_6706400255,420,2,1,36,0,4,1,5,2,1,3,-4,7,3,-2,2,0,0,3,3,0,6,-4,6,-10,4,-5,0,0,-1,1,-1,-1,5,-1
KR_6734272198,440,-6,-30,-18,-17,0,0,0,-7,7,0,-5,7,2,-2,4,2,-3,3,0,0,-15,-2,-4,0,4,1,0,-2,-1,-1,-1,-1,4,-1
KR_6744069184,420,-2,25,-4,-10,-3,3,0,-2,2,0,-5,5,0,-2,2,0,2,0,2,-2,-17,-9,0,-4,4,-3,0,-1,-1,-1,-1,-1,4,-1
KR_6720368930,420,0,21,-17,-4,-1,2,1,-1,6,5,-4,4,0,0,1,1,2,0,2,-1,-4,-1,1,-7,6,1,0,0,-1,-1,-1,-1,1,-1
KR_6745932073,420,-2,-62,-8,1,2,0,2,-5,5,0,1,2,3,2,2,4,1,0,1,0,3,-38,4,-10,6,5,0,0,0,1,-1,-1,0,-1
KR_6762770805,420,-2,-37,-27,2,3,2,5,-1,7,6,2,2,4,-2,4,2,0,0,0,0,-6,19,4,-7,3,1,0,1,-1,1,1,1,6,-1
KR_6758166100,420,1,35,-8,3,5,1,6,1,1,2,-2,3,1,-1,2,1,0,0,0,0,-5,6,-1,-3,4,-5,0,1,1,1,1,1,4,-1
KR_6291842292,420,-4,-36,9,-1,0,1,1,-2,3,1,-2,3,1,4,3,7,-1,2,1,0,5,18,1,-7,6,1,0,-1,1,1,-1,1,5,-1
KR_6698099476,420,-2,-11,-6,-6,2,2,4,-3,4,1,-5,9,4,-1,3,2,1,1,2,0,-8,-11,-2,-4,6,-2,0,0,-1,1,-1,1,1,-1
KR_6767642799,420,-2,-12,-1,0,-1,1,0,0,5,5,0,1,1,1,0,1,0,0,0,0,5,-1,4,-7,3,3,0,-1,1,-1,-1,1,6,-1
KR_6746530875,420,0,39,32,-2,0,2,2,-3,3,0,-1,3,2,1,0,1,1,1,2,0,1,-11,-4,-2,6,1,0,0,1,-1,0,1,5,-1
KR_6664006209,420,-3,-48,-39,-5,-1,2,1,-1,4,3,-1,2,1,-1,4,3,-1,1,0,0,-9,-7,1,-6,5,0,0,-2,-1,-1,-1,1,2,-1
KR_6766460387,420,-2,-40,20,-7,-1,3,2,2,1,3,-4,4,0,-4,5,1,0,2,2,0,-10,363,1,-8,7,-4,0,1,-1,1,1,1,5,-1
KR_6764796659,440,-7,-80,-56,-15,1,3,4,1,1,2,-5,5,0,-9,10,1,-3,3,0,-2,-17,34,5,-8,3,-26,0,0,-1,-1,1,-1,2,-1
KR_6728282256,420,-4,-10,-11,-7,0,0,0,-4,5,1,0,2,2,-2,2,0,-1,1,0,0,-10,9,-2,-5,7,1,0,1,-1,1,1,-1,4,-1
KR_6753438018,440,2,88,-16,3,3,0,3,-3,5,2,0,1,1,4,1,5,-1,2,1,1,2,-15,1,-6,5,1,0,2,-1,1,1,1,6,-1
KR_6761679386,420,-3,-15,-18,-8,-2,6,4,-5,6,1,-2,4,2,1,2,3,0,1,1,0,-5,-1,0,-5,5,-1,0,0,1,-1,-1,1,2,-1
KR_6658504810,420,-2,-6,-15,-8,0,4,4,-7,8,1,1,1,2,0,3,3,-2,2,0,0,-15,-1,-3,-5,8,-3,0,0,-1,-1,-1,-1,3,-1
KR_6765883779,420,-5,-97,-24,-13,-5,5,0,1,2,3,-2,4,2,-8,10,2,1,1,2,-1,-11,-10,-2,-3,5,4,0,-3,-1,-1,-1,-1,5,-1
KR_6719635537,420,-3,-63,4,2,1,1,2,0,3,3,1,2,3,-1,3,2,1,1,2,0,6,0,0,-7,7,4,0,-1,-1,1,-1,-1,4,-1
KR_6767444812,440,-1,-45,40,-1,-3,3,0,1,2,3,-2,2,0,3,0,3,0,0,0,0,0,4,-2,-2,4,-2,0,0,1,0,0,-1,5,-1
KR_6761734250,420,0,-6,-16,3,0,3,3,0,2,2,1,0,1,2,1,3,0,2,2,0,1,-29,-1,-6,7,3,0,1,0,1,1,-1,0,-1
KR_6768934454,420,-2,-106,-19,-6,1,0,1,0,3,3,-2,3,1,-5,5,0,0,0,0,0,-9,56,-3,-3,6,-1,0,-1,-1,1,-1,1,1,-1
KR_6734807383,420,-2,-41,36,-7,-5,5,0,-2,3,1,-1,1,0,1,1,2,0,2,2,0,-10,15,1,-3,2,-5,0,0,1,-1,-1,-1,3,-1
KR_6756481207,420,-1,2,-10,-5,-1,1,0,-2,4,2,-5,5,0,2,2,4,1,1,2,0,-10,0,-1,-4,5,6,0,0,-1,-1,0,1,6,-1
KR_6754435284,420,0,9,1,6,1,1,2,0,2,2,2,0,2,2,2,4,1,0,1,0,15,20,1,-5,4,2,0,0,1,1,1,1,4,-1
KR_6734052824,420,0,-23,-56,1,3,0,3,1,2,3,-4,8,4,1,3,4,0,1,1,0,0,0,3,-6,3,6,0,-1,-1,-1,-1,-1,4,-1
KR_6746652602,420,-1,54,-12,-2,-4,6,2,0,3,3,1,0,1,2,3,5,-1,2,1,0,-6,-6,-4,-2,6,3,0,-1,-1,-1,-1,1,5,-1
KR_6741659269,440,0,-14,36,-3,3,0,3,1,0,1,-4,7,3,-2,5,3,-1,1,0,0,-16,65,2,-6,4,-22,0,1,1,1,1,-1,3,-1
KR_6649936857,420,1,53,-17,2,1,2,3,2,3,5,-1,1,0,0,1,1,0,1,1,0,1,-6,-2,-5,7,8,0,2,-1,1,1,1,3,-1
KR_6755325581,420,-2,-60,-5,-16,1,0,1,-2,3,1,-6,6,0,-9,12,3,0,3,3,0,-14,-103,0,-6,6,-5,0,-1,0,0,-1,-1,0,-1
KR_6720554351,420,-2,-53,1,-1,3,1,4,-2,6,4,-1,2,1,0,1,1,-1,1,0,1,-10,-39,3,-7,4,2,0,2,1,1,1,1,1,-1
KR_6767005827,440,-7,-74,-35,-14,1,1,2,-6,7,1,0,2,2,-3,4,1,-6,8,2,0,-18,0,2,-4,2,-3,0,-1,-1,1,-1,-1,5,-1
KR_6693196316,420,-2,-57,8,-1,-1,2,1,-2,3,1,1,0,1,1,1,2,0,1,1,0,2,10,2,-7,5,-5,0,-1,-1,1,-1,-1,1,-1
KR_6759917536,420,-2,-31,-22,-11,-5,5,0,-5,8,3,1,5,6,1,2,3,-3,4,1,-3,-10,-4,-1,-8,9,0,0,-1,1,-1,-1,-1,6,-1
KR_6765841030,420,-2,-21,-33,1,6,0,6,0,4,4,2,2,4,-6,6,0,-1,1,0,0,-10,3,5,-8,3,-3,0,-1,1,1,-1,1,1,-1
KR_6744223793,440,0,-59,-41,-4,-1,1,0,-3,3,0,-9,10,1,10,2,12,-1,1,0,0,2,-41,1,-4,3,19,0,-1,-1,-1,-1,-1,3,-1
KR_6766627218,420,0,-31,4,-4,-3,7,4,2,4,6,-2,5,3,-1,3,2,0,0,0,-2,-8,13,-1,-4,5,-2,0,0,1,1,0,-1,4,-1
KR_6766483207,420,0,-48,-8,4,0,1,1,2,3,5,-1,3,2,5,1,6,-2,2,0,0,9,15,-1,-4,5,0,0,0,1,-1,-1,-1,1,-1
KR_6637944427,420,-10,-56,-47,-23,-4,6,2,-5,6,1,-4,5,1,-7,8,1,-3,3,0,-1,-19,-1,2,-6,4,-2,0,-2,0,1,-1,-1,0,-1
KR_6740373995,420,-1,-34,-10,-3,0,0,0,-8,10,2,2,0,2,1,1,2,2,2,4,0,-6,-3,-2,-7,9,0,0,-1,-1,-1,-1,1,3,-1
KR_6754384545,420,-3,-20,28,-9,0,2,2,4,1,5,-12,13,1,-3,4,1,2,0,2,0,-6,25,-3,-2,5,-14,0,-1,-1,1,-1,-1,5,-1
KR_6757528684,420,-5,-65,-22,0,0,0,0,1,2,3,1,2,3,0,3,3,-2,3,1,0,4,-2,7,-8,1,-4,0,-1,1,1,-1,1,6,-1
KR_6768834678,420,-1,-25,-1,-4,-2,2,0,2,1,3,0,0,0,0,0,0,-4,6,2,0,-4,-1,-5,-4,9,0,0,0,-1,-1,-1,-1,4,-1
KR_6759860093,440,1,-7,0,5,0,0,0,4,1,5,2,1,3,-2,2,0,1,0,1,0,5,1,1,-6,5,-5,0,1,-1,1,1,1,5,-1
KR_6763355621,440,-4,-59,-8,-8,-1,1,0,-2,3,1,0,3,3,-6,6,0,1,0,1,0,-13,-4,-1,-5,6,-4,0,-1,-1,1,-1,-1,1,-1
KR_6761396768,420,2,-2,-5,2,2,2,4,-1,2,1,-2,3,1,3,1,4,0,2,2,0,0,-9,1,-8,7,3,0,0,0,1,0,-1,0,-1
KR_6765641032,440,0,31,14,1,-1,2,1,-3,3,0,-1,3,2,2,1,3,4,0,4,0,2,-65,-3,-7,10,23,0,1,-1,1,1,-1,6,-1
KR_6762359407,420,-5,-34,-5,-7,-5,6,1,-3,4,1,4,0,4,-2,2,0,-1,2,1,0,-1,0,-1,-5,6,-2,0,-1,-1,-1,-1,-1,3,-1
KR_6623477147,420,0,80,11,-3,-8,8,0,-2,4,2,0,1,1,2,1,3,5,0,5,1,-5,56,4,-7,3,-27,0,1,-1,-1,1,1,5,-1
KR_6703585003,420,0,-64,15,-5,2,0,2,-3,5,2,-1,1,0,-1,4,3,-2,5,3,-1,-11,-35,3,-8,5,35,0,-1,-1,1,-1,-1,3,-1
KR_6762084386,420,3,-11,14,11,0,0,0,3,1,4,3,1,4,6,1,7,-1,1,0,0,11,-51,-3,-6,9,3,0,-1,1,-1,-1,1,1,-1
KR_6768306552,440,2,-46,-9,2,5,0,5,2,5,7,1,1,2,-7,7,0,1,1,2,0,0,-18,-2,-4,6,17,0,0,-1,1,-1,-1,4,-1
KR_6767179982,420,-5,-15,-10,-11,1,2,3,-3,3,0,-6,6,0,0,3,3,-3,4,1,1,-16,4,3,-9,6,-6,0,-1,-1,-1,-1,1,6,-1
KR_6768732455,420,0,0,-6,0,-1,4,3,0,3,3,-2,2,0,1,0,1,2,0,2,2,-1,3,3,-7,4,-9,0,-1,1,0,-1,1,3,-1
KR_6724543004,420,0,7,-15,-2,-1,2,1,-1,2,1,0,2,2,0,1,1,0,0,0,0,-4,139,-2,-6,8,4,0,1,-1,1,1,1,3,-1
KR_6765153959,420,-1,1,-14,2,-1,1,0,-2,3,1,3,3,6,1,5,6,1,1,2,-1,8,-27,-2,-4,6,3,0,0,-1,-1,0,-1,2,-1
KR_6765699193,420,2,-38,16,2,-1,1,0,1,2,3,6,0,6,-4,4,0,0,0,0,0,3,-10,1,-6,5,0,0,1,-1,1,1,1,6,-1
KR_6763084910,420,-2,18,-21,-9,2,0,2,-3,6,3,2,0,2,-9,12,3,-1,2,1,-1,-18,11,-2,-2,4,-2,0,-1,0,-1,-1,-1,0,-1
KR_6754630767,420,-4,-30,-18,-9,-2,2,0,-6,7,1,0,6,6,0,3,3,-1,1,0,0,-3,-10,-3,-7,10,-1,0,1,-1,1,1,-1,4,-1
KR_6760468371,420,-1,-46,9,-2,-2,4,2,3,1,4,2,0,2,-3,4,1,-2,2,0,0,0,-11,-4,-3,7,1,0,-1,1,-1,-1,1,3,-1
KR_6762973211,420,-4,8,-71,-10,0,2,2,-8,8,0,-2,5,3,1,4,5,-1,3,2,0,-9,19,-1,-2,3,-3,0,0,-1,-1,0,-1,4,-1
KR_6743147764,420,1,83,8,1,2,0,2,3,2,5,-6,7,1,0,3,3,2,0,2,0,-3,86,2,-8,6,-21,0,2,-1,-1,1,-1,2,-1
KR_6688058630,420,1,10,-8,2,0,1,1,-2,5,3,3,1,4,0,2,2,1,1,2,0,0,-24,-3,-1,4,-1,0,1,1,1,1,1,5,-1
KR_6769121978,420,-4,-67,-4,-9,-4,4,0,2,2,4,3,1,4,-9,9,0,-1,1,0,0,-9,-16,-2,-5,7,-1,0,-1,0,-1,-1,-1,0,-1
KR_6698307826,420,0,-17,8,-1,-1,2,1,-1,4,3,-1,1,0,3,1,4,-1,1,0,0,-2,-6,-3,-2,5,0,0,-1,-1,1,-1,-1,5,-1
KR_6689993168,420,-1,-58,-9,-7,-3,5,2,-3,7,4,0,2,2,-3,6,3,2,2,4,-1,-5,-380,0,-7,7,1,0,0,-1,1,-1,-1,2,-1
KR_6767990188,420,4,-24,24,8,-3,3,0,-1,4,3,8,0,8,4,1,5,0,1,1,0,19,12,3,-7,4,-5,0,0,-1,0,-1,-1,3,-1
KR_6762004211,420,-3,-24,7,-4,-3,4,1,-1,2,1,-1,2,1,1,4,5,0,2,2,0,-3,4,5,-10,5,-5,0,-1,-1,1,-1,-1,1,-1
KR_6765885055,420,2,-4,38,2,0,2,2,1,1,2,-1,2,1,1,1,2,1,0,1,1,9,4,5,-9,4,0,0,1,1,1,1,1,4,-1
KR_6768429215,420,-1,-56,12,-8,-1,2,1,-4,6,2,-2,4,2,-1,2,1,0,0,0,0,-13,88,-3,-4,7,-3,0,1,-1,1,1,-1,6,-1
KR_6762924514,420,-3,-1,-8,-8,-2,2,0,-5,7,2,0,3,3,0,2,2,-1,2,1,0,-14,-215,0,-8,8,-4,0,-1,1,-1,-1,1,5,-1
KR_6767188901,420,-2,2,-20,-11,-2,4,2,-4,6,2,-1,3,2,-3,6,3,-1,1,0,-1,-11,9,-6,-3,9,-6,0,0,-1,-1,0,-1,3,-1
KR_6764953419,420,-4,-30,-31,-7,-2,3,1,-1,4,3,1,2,3,1,2,3,-6,7,1,0,-7,60,5,-8,3,-20,0,-1,-1,1,1,-1,1,-1
KR_6723461328,420,0,25,9,1,-3,5,2,-6,7,1,6,1,7,1,2,3,3,0,3,-1,3,6,2,-11,9,5,0,-1,-1,-1,-1,-1,6,-1
KR_6751756321,420,1,43,-8,-6,1,0,1,0,2,2,-5,5,0,-4,4,0,2,1,3,-1,-9,-10,-3,-3,6,6,0,0,-1,-1,-1,-1,1,-1
KR_6719108714,420,-2,-21,0,-6,0,1,1,-1,5,4,-2,2,0,0,1,1,-3,5,2,0,-11,-1,-5,-5,10,-7,0,-2,-1,-1,-1,-1,5,-1
KR_6765069000,420,-5,-31,-10,-7,-2,3,1,2,5,7,-3,4,1,-4,6,2,0,0,0,-1,-5,-23,-1,-4,5,-4,0,-1,1,-1,-1,-1,2,-1
KR_6745054704,420,0,-26,-12,-6,-2,3,1,-2,4,2,1,2,3,-3,3,0,0,2,2,-1,-8,14,2,-7,5,4,0,-1,1,1,-1,1,5,-1
KR_6761733560,420,-2,-25,31,-3,3,0,3,0,3,3,1,0,1,-2,2,0,-5,6,1,0,-9,-19,0,-5,5,-2,0,0,-1,1,0,-1,2,-1
KR_6726069142,420,-4,-107,13,-18,-4,4,0,-5,8,3,-7,8,1,0,5,5,-2,2,0,0,-15,-3,-5,-2,7,2,0,-1,-1,-1,-1,-1,1,-1
KR_6727749710,420,2,-6,-7,-1,-1,3,2,1,2,3,7,0,7,-6,6,0,-2,3,1,0,6,24,4,-6,2,4,0,-2,-1,-1,-1,1,4,-1
KR_6692610467,420,-1,17,-17,0,0,2,2,-2,4,2,1,5,6,1,1,2,0,0,0,0,0,18,-1,-8,9,-1,0,1,1,1,1,-1,6,-1
KR_6717955522,420,-4,9,-32,-6,-2,4,2,-1,5,4,-5,8,3,1,2,3,1,0,1,0,-4,-36,5,-8,3,-2,0,-2,-1,-1,-1,-1,5,-1
KR_6768333521,420,-1,25,-11,-5,1,1,2,-1,2,1,-2,2,0,-1,3,2,-2,2,0,0,-2,2,-7,-5,12,-2,0,0,1,-1,0,-1,4,-1
KR_6726416064,420,-5,16,13,-6,4,0,4,-6,8,2,0,3,3,-5,6,1,1,2,3,3,-13,-10,2,-8,6,-1,0,1,-1,1,1,-1,1,-1
KR_6701968848,420,1,-43,4,1,-2,3,1,-1,3,2,0,1,1,3,1,4,1,0,1,0,0,-14,4,-10,6,-2,0,-1,1,-1,-1,1,5,-1
KR_6761706229,420,-2,9,8,-4,1,2,3,-4,4,0,1,1,2,-2,2,0,0,1,1,0,-12,-2,3,-6,3,-1,0,0,-1,-1,-1,1,6,-1
KR_6700145201,420,-1,2,-39,-5,0,2,2,-7,9,2,2,2,4,0,3,3,0,2,2,0,-3,-2,-2,-5,7,1,0,-1,-1,-1,-1,-1,2,-1
KR_6765034915,420,-4,-153,-16,-14,-4,5,1,-3,3,0,-1,4,3,-7,9,2,1,1,2,-2,-20,117,-1,-4,5,0,0,-4,-1,-1,-1,-1,3,-1
KR_6655441262,420,-1,-10,-37,-2,4,1,5,0,4,4,0,3,3,-8,9,1,2,0,2,0,-5,-5,2,-8,6,-5,0,-1,1,-1,-1,-1,4,-1
KR_6762883245,420,1,82,8,2,5,2,7,0,2,2,-1,4,3,0,0,0,-2,2,0,1,1,146,-1,-4,5,4,0,1,-1,-1,1,1,2,-1
KR_6753959844,420,-2,-62,4,-2,-1,3,2,-1,3,2,-4,5,1,1,2,3,3,0,3,0,4,4,0,-7,7,-5,0,-2,1,-1,-1,-1,6,-1
KR_6768110189,420,-7,-112,-61,-14,1,1,2,-5,6,1,-8,10,2,0,1,1,-2,3,1,0,-2,0,0,-6,6,-1,0,-3,-1,-1,-1,-1,2,-1
KR_6740624819,420,-2,-33,0,-13,-2,3,1,-3,5,2,2,0,2,-10,10,0,0,0,0,0,-18,-7,1,-11,10,2,0,0,-1,1,-1,1,5,-1
KR_6508414857,420,1,7,6,-1,-1,4,3,-6,7,1,-3,3,0,3,0,3,6,0,6,0,2,3,3,-8,5,3,0,-1,-1,-1,-1,-1,1,-1
KR_6768689715,420,-1,-15,-12,-10,-4,4,0,-2,6,4,3,1,4,-5,9,4,-2,4,2,-1,-13,4,0,-6,6,-5,0,-1,-1,-1,-1,-1,2,-1
KR_6761478059,420,1,-81,19,-3,0,1,1,4,2,6,-2,3,1,-4,5,1,-1,2,1,0,-8,-2,-2,-6,8,-2,0,0,-1,1,0,-1,1,-1
KR_6760391801,420,-1,-15,-33,2,3,1,4,-1,3,2,-1,2,1,0,3,3,1,1,2,0,2,-5,-5,-2,7,3,0,-1,1,-1,-1,1,4,-1
KR_6702469678,420,0,-13,-10,-5,-3,4,1,-3,5,2,-2,2,0,1,2,3,2,1,3,0,-2,1,-2,-4,6,3,0,1,-1,-1,1,-1,4,-1
KR_6769049830,420,-3,-28,-23,-5,-2,3,1,2,3,5,-4,5,1,-5,7,2,4,1,5,0,-2,4,5,-9,4,0,0,0,-1,1,0,-1,3,-1
KR_6696388193,420,0,2,-14,-3,-4,4,0,-2,2,0,2,2,4,1,2,3,0,2,2,0,-5,100,-6,-5,11,2,0,0,1,-1,-1,1,1,-1
KR_6766219882,420,3,20,34,9,1,0,1,6,0,6,2,1,3,-1,4,3,1,0,1,1,15,-4,0,-8,8,5,0,1,1,1,1,1,6,-1
KR_6704612551,420,-3,-26,-48,-2,3,1,4,-4,5,1,-1,4,3,-1,6,5,1,0,1,-2,-5,4,3,-6,3,2,0,1,-1,-1,1,-1,5,-1
KR_6697674911,420,1,-23,19,-2,0,4,4,0,2,2,0,1,1,-2,3,1,0,1,1,0,-2,28,2,-9,7,-5,0,0,1,1,-1,1,6,-1
KR_6764777485,420,-1,35,-6,-2,-1,3,2,-3,5,2,-1,1,0,4,0,4,-1,3,2,0,-5,0,7,-9,2,0,0,0,0,-1,0,1,0,-1
KR_6765592727,420,-3,-36,-8,-9,-6,6,0,1,4,5,-2,3,1,0,2,2,-2,2,0,-1,-6,-17,-4,-3,7,-3,0,-3,-1,-1,-1,-1,3,-1
KR_6706223263,440,1,82,6,-2,-1,4,3,0,1,1,1,1,2,1,1,2,-3,4,1,-1,0,9,1,-6,5,-2,0,1,-1,1,1,-1,6,-1
KR_6730829526,440,1,41,-15,1,2,2,4,-1,3,2,-1,3,2,2,1,3,-1,2,1,1,2,-1,6,-11,5,-3,0,1,1,-1,-1,1,1,-1
KR_6704318199,420,-2,-27,0,-4,-2,3,1,-1,2,1,-1,2,1,1,4,5,-1,1,0,0,-7,-5,-5,-5,10,1,0,-2,1,-1,-1,1,6,-1
KR_6763788779,420,-1,-49,-20,0,-2,5,3,1,1,2,1,4,5,-1,5,4,1,1,2,0,2,5,1,-6,5,-1,0,-1,-1,-1,-1,1,1,-1
KR_6723683801,420,-4,-163,-24,-13,-4,5,1,1,1,2,-3,3,0,-7,9,2,0,1,1,-1,-6,1,1,-6,5,-4,0,-3,0,-1,-1,-1,0,-1
KR_6761611971,440,-1,-8,-4,-2,-4,5,1,4,0,4,1,0,1,-1,5,4,-2,6,4,0,2,-5,7,-12,5,2,0,-1,-1,-1,-1,-1,1,-1
KR_6753367205,420,-4,-62,11,-7,3,1,4,-3,3,0,-1,4,3,-7,9,2,1,0,1,-2,-12,-2,-2,-4,6,0,0,-1,-1,1,-1,-1,5,-1
KR_6758352539,420,0,-18,-8,1,1,2,3,-3,3,0,0,3,3,0,1,1,3,1,4,1,-1,1,-4,-5,9,8,0,-1,-1,-1,-1,1,1,-1
KR_6768680893,420,-1,-18,0,-1,-1,1,0,-1,2,1,0,3,3,5,2,7,-4,4,0,0,4,3,-5,-3,8,-4,0,1,1,-1,-1,-1,5,-1
KR_6758541344,420,-3,-67,-19,1,1,0,1,-1,3,2,0,0,0,1,2,3,0,0,0,0,-1,-2,-1,-4,5,-3,0,-2,-1,1,-1,-1,2,-1
KR_6756426011,420,-1,-39,-27,-8,2,1,3,-3,3,0,-7,9,2,1,3,4,-1,2,1,0,-6,1,-1,-7,8,-7,0,-1,1,-1,1,1,3,-1
KR_6761750545,420,-2,-79,-6,-3,0,2,2,-3,4,1,-1,1,0,1,0,1,0,1,1,0,-4,-1,1,-7,6,-2,0,-1,1,1,-1,-1,6,-1
KR_6674173988,420,-1,-50,16,-11,1,1,2,-3,3,0,-6,6,0,-4,5,1,1,1,2,0,-14,13,-3,-3,6,-2,0,-1,1,-1,-1,1,4,-1
KR_6719739076,420,0,-1,-2,1,-3,4,1,2,0,2,2,0,2,0,3,3,0,0,0,0,-3,20,-2,-4,6,-3,0,0,1,-1,-1,1,6,-1
KR_6764553539,420,-1,-35,22,2,-2,2,0,-1,5,4,4,1,5,-1,5,4,2,0,2,0,1,19,-4,-5,9,-2,0,-3,1,-1,-1,-1,1,-1
KR_6723211306,420,-1,1,1,2,1,0,1,0,3,3,-1,4,3,-1,1,0,3,2,5,0,5,-4,1,-10,9,-2,0,1,-1,1,1,1,2,-1
KR_6753936164,420,-3,11,-22,-6,-3,4,1,0,1,1,-2,2,0,-3,3,0,2,0,2,0,-7,0,-2,-7,9,-3,0,0,-1,-1,1,1,5,-1
KR_6763041620,420,-8,-108,-20,-24,-4,4,0,-10,10,0,-4,6,2,-6,7,1,0,0,0,1,-28,-9,-5,-2,7,2,0,-3,-1,-1,-1,1,2,-1
KR_6745891941,420,-4,-46,-40,-9,-2,3,1,-3,4,1,-2,3,1,-3,5,2,1,0,1,0,-4,-66,-6,-6,12,14,0,-3,-1,-1,-1,-1,3,-1
KR_6735023323,420,-1,37,4,-1,0,1,1,-3,6,3,0,1,1,0,1,1,2,1,3,0,-2,10,2,-6,4,-4,0,1,-1,1,1,-1,1,-1
KR_6755777343,420,-2,-44,8,-10,-1,2,1,-6,7,1,-6,8,2,2,0,2,1,1,2,0,-4,18,0,-5,5,3,0,1,-1,-1,-1,-1,1,-1
KR_6765578465,420,1,42,-3,10,-1,3,2,5,2,7,-3,5,2,10,5,15,-1,2,1,0,19,47,1,-5,4,-14,0,1,-1,1,1,1,3,-1
KR_6692061422,440,3,1,48,7,-2,3,1,1,4,5,4,0,4,3,3,6,1,1,2,-1,13,4,-1,-3,4,3,0,-1,1,-1,-1,-1,1,-1
KR_6747292327,420,-2,-41,4,3,1,5,6,2,3,5,5,0,5,-5,5,0,0,1,1,-1,-5,-34,-2,-6,8,7,0,-1,-1,-1,1,-1,1,-1
KR_6762500851,420,-2,-70,-24,-9,1,2,3,2,1,3,-3,6,3,-7,8,1,-2,3,1,-2,-23,-8,-3,-2,5,-5,0,0,-1,0,-1,-1,3,-1
KR_6732388569,420,-3,-25,-12,-9,-4,5,1,-2,2,0,-2,3,1,1,1,2,-2,2,0,0,-10,15,-1,-6,7,4,0,0,-1,0,0,-1,3,-1
KR_6764516918,420,-2,-27,-15,1,0,2,2,4,2,6,2,2,4,-5,7,2,0,0,0,0,4,6,2,-8,6,-6,0,0,1,-1,0,-1,6,-1
KR_6756189405,420,-3,-23,-46,-4,1,1,2,1,2,3,-1,1,0,-5,5,0,0,0,0,0,-7,0,-1,-2,3,-2,0,-1,-1,-1,-1,-1,4,-1
KR_6732372774,420,-6,30,0,-7,4,1,5,-4,4,0,-6,12,6,1,2,3,-2,2,0,1,-18,5,3,-8,5,-4,0,-1,-1,-1,-1,1,5,-1
KR_6617418319,420,-4,-78,3,-10,0,1,1,-5,7,2,-1,2,1,-5,9,4,1,1,2,-1,-15,2,1,-7,6,-7,0,-1,-1,1,-1,-1,6,-1
KR_6739769024,420,-1,-2,-26,-5,0,2,2,-7,8,1,0,1,1,1,2,3,1,1,2,0,-6,32,-2,-6,8,-5,0,-1,1,-1,-1,-1,6,-1
KR_6753991438,420,3,27,-4,9,0,4,4,7,3,10,-1,3,2,2,0,2,1,0,1,0,14,-6,4,-8,4,-1,0,1,1,1,1,-1,6,-1
KR_6763908209,420,-5,-36,-36,-7,-2,3,1,-2,2,0,2,5,7,-4,4,0,-1,1,0,0,-14,6,-7,-2,9,1,0,-1,-1,-1,-1,-1,5,-1
KR_6679257366,420,-4,-63,-15,-5,1,2,3,0,1,1,0,3,3,-5,5,0,-1,1,0,0,-2,-113,-3,-6,9,-5,0,-1,-1,1,-1,1,4,-1
KR_6667180316,420,-2,-6,-33,0,1,4,5,-3,5,2,-3,3,0,6,0,6,-1,1,0,0,4,-90,3,-11,8,-3,0,-1,1,-1,-1,1,2,-1
KR_6753000796,420,-4,-50,-7,-4,0,0,0,0,0,0,-3,3,0,-2,2,0,1,0,1,0,-5,-20,2,-7,5,-10,0,0,-1,1,1,-1,4,-1
KR_6762704184,420,-3,-40,-52,-4,1,2,3,-2,3,1,-3,3,0,-1,4,3,1,0,1,1,5,-10,-3,-2,5,2,0,-1,-1,-1,-1,1,5,-1
KR_6723550451,420,0,-12,-7,-5,-2,2,0,3,6,9,-3,6,3,-6,6,0,3,0,3,0,-12,-1,-2,-7,9,-1,0,-1,-1,-1,-1,-1,5,-1
KR_6759821359,420,-2,-51,-2,-2,0,2,2,-1,1,0,-5,6,1,3,0,3,1,0,1,-1,-1,3,6,-9,3,-2,0,0,1,-1,0,-1,4,-1
KR_6631777763,420,-1,-55,-28,-6,3,1,4,0,3,3,-6,6,0,-4,4,0,1,0,1,0,-11,-7,-7,-3,10,1,0,0,-1,-1,-1,1,4,-1
KR_6761442552,420,-3,-59,-16,6,-2,2,0,5,1,6,4,2,6,0,2,2,-1,1,0,0,7,-7,2,-7,5,4,0,0,1,1,0,-1,3,-1
KR_6765141647,420,-1,-57,-39,-4,-5,6,1,1,1,2,1,7,8,1,3,4,-2,3,1,-2,-5,1,-3,-5,8,6,0,-2,-1,-1,-1,-1,1,-1
KR_6768851008,420,-3,-83,1,-11,0,1,1,0,3,3,-2,3,1,-4,4,0,-5,6,1,0,-14,-4,1,-3,2,-3,0,-2,-1,-1,-1,-1,6,-1
KR_6768184216,420,5,23,38,-3,0,0,0,-3,4,1,0,2,2,-1,5,4,1,0,1,0,-7,10,-1,-5,6,2,0,1,1,-1,-1,-1,1,-1
KR_6763150978,420,0,-58,-24,1,0,2,2,1,2,3,0,2,2,0,2,2,0,0,0,0,0,0,0,-6,6,2,0,-1,-1,1,-1,-1,6,-1
KR_6756490420,420,-2,-77,-36,-9,0,3,3,-2,2,0,-2,5,3,-2,6,4,-3,4,1,0,-1,-4,5,-8,3,-2,0,-2,1,-1,-1,-1,1,-1
KR_6768353886,420,-4,-30,-47,-4,-5,5,0,0,3,3,1,2,3,-1,4,3,1,1,2,-1,-1,-6,2,-6,4,-2,0,-1,1,-1,-1,-1,5,-1
KR_6740456936,440,-6,-107,-25,-14,-1,1,0,-5,5,0,-3,3,0,-3,3,0,-2,4,2,0,-13,-21,2,-5,3,8,0,-1,-1,-1,-1,-1,4,-1
KR_6767176461,420,-1,-14,12,-3,-4,5,1,-2,5,3,1,1,2,2,2,4,0,0,0,0,2,-48,0,-7,7,21,0,-1,-1,1,-1,-1,6,-1
KR_6759263508,420,-6,-93,-24,-11,-4,5,1,-3,6,3,-1,2,1,-2,4,2,-1,2,1,1,-4,-37,-1,-6,7,28,0,-3,-1,-1,-1,1,3,-1
KR_6416886059,420,-3,-22,-25,-6,1,1,2,1,3,4,2,1,3,-9,10,1,-1,1,0,2,-5,-1,-5,-3,8,-3,0,-1,-1,-1,-1,1,3,-1
KR_6751216071,420,-1,-7,4,-2,1,1,2,-6,6,0,0,3,3,1,0,1,2,0,2,0,-2,-1,-4,-2,6,2,0,0,1,0,0,-1,1,-1
KR_6759241023,420,-5,-40,-5,-8,1,1,2,2,1,3,-4,4,0,-6,9,3,-1,3,2,0,-15,3,1,-4,3,2,0,0,-1,-1,-1,-1,4,-1
KR_6683052422,420,3,0,-3,4,-5,6,1,4,2,6,2,3,5,2,5,7,1,2,3,0,6,1,-5,-4,9,4,0,-2,1,-1,-1,-1,6,-1
KR_6766137272,420,-3,-16,-12,-4,1,3,4,-1,5,4,0,0,0,-2,2,0,-2,3,1,0,-7,-3,0,-6,6,4,0,0,-1,-1,0,-1,6,-1
KR_6758932097,420,-3,-56,-19,-8,1,1,2,-10,14,4,0,2,2,0,0,0,1,0,1,0,-5,40,-3,-4,7,-6,0,-1,-1,1,-1,1,3,-1
KR_6701039226,420,-1,-14,2,2,1,3,4,-3,3,0,4,1,5,0,3,3,0,2,2,0,-10,0,5,-12,7,-4,0,1,1,1,1,-1,6,-1
KR_6763989980,420,-4,-33,-20,-15,-3,6,3,-6,6,0,2,1,3,-4,5,1,-4,4,0,0,-24,-25,-1,-6,7,-1,0,-2,-1,-1,-1,-1,1,-1
KR_6753556392,420,-1,-13,-20,0,-3,3,0,2,2,4,3,3,6,-1,3,2,-1,4,3,0,12,-5,-2,-2,4,-3,0,0,-1,-1,0,1,2,-1
KR_6767118641,420,0,-1,-20,8,-2,7,5,1,2,3,3,3,6,6,0,6,0,0,0,0,11,5,9,-10,1,0,0,0,1,1,1,1,3,-1
KR_6766915502,420,-3,-63,24,-5,1,2,3,-7,8,1,-1,5,4,3,0,3,-1,2,1,0,-6,-8,1,-2,1,1,0,-2,-1,1,-1,1,5,-1
KR_6725894907,420,-3,-14,1,-5,2,0,2,-4,5,1,-3,4,1,-3,5,2,3,2,5,0,-9,-3,-1,-9,10,-3,0,0,-1,-1,-1,-1,5,-1
KR_6714819637,420,0,21,24,-7,2,2,4,-2,2,0,2,1,3,-11,14,3,2,0,2,-1,-11,12,2,-8,6,-1,0,0,1,1,1,-1,6,-1
KR_6621018844,420,-4,0,-13,-6,-1,2,1,-3,5,2,-2,6,4,0,4,4,0,0,0,1,-6,2,-1,-4,5,3,0,0,1,-1,0,1,3,-1
KR_6767613251,420,-2,-73,18,-6,-4,4,0,-2,4,2,0,1,1,-1,2,1,1,0,1,0,-5,-12,2,-6,4,1,0,-2,1,-1,-1,-1,4,-1
KR_6763315507,420,-2,-44,-4,-6,0,2,2,-1,2,1,-4,6,2,-1,2,1,0,4,4,0,-8,-1,2,-7,5,0,0,0,-1,1,1,1,3,-1
KR_6758718789,420,-3,-92,-10,-6,1,0,1,-5,6,1,-3,4,1,-1,5,4,2,0,2,0,-10,8,5,-10,5,-12,0,-1,1,-1,-1,1,3,-1
KR_6727594274,420,-3,-48,-26,-11,-7,10,3,-5,5,0,6,1,7,-4,4,0,-1,1,0,-1,-7,8,-2,-1,3,-10,0,-1,-1,-1,-1,-1,5,-1
KR_6768682238,440,-5,-79,-4,-6,0,1,1,1,1,2,-1,2,1,0,2,2,-6,6,0,0,-6,-36,2,-7,5,-3,0,-1,0,-1,-1,-1,0,-1
KR_6766425554,420,0,-2,1,1,-1,1,0,1,3,4,-1,1,0,2,0,2,0,1,1,0,2,11,-1,-6,7,0,0,0,1,-1,0,-1,3,-1
KR_6756609897,420,-4,31,-23,-11,1,3,4,-5,6,1,-4,7,3,-2,3,1,-1,3,2,-2,-20,-16,2,-6,4,0,0,-1,1,-1,-1,-1,1,-1
KR_6738961282,440,-1,-21,-40,6,4,2,6,0,4,4,3,1,4,-1,2,1,0,2,2,0,5,5,0,-3,3,-2,0,-1,0,-1,-1,1,0,-1
KR_6680010409,420,-1,-21,4,-6,-2,2,0,2,1,3,-2,2,0,-1,1,0,-3,3,0,0,-10,-6,-3,-5,8,0,0,-1,1,-1,-1,-1,2,-1
KR_6767033098,420,-3,-13,-3,-7,-2,4,2,0,4,4,1,0,1,-5,10,5,-1,1,0,0,-4,8,4,-7,3,0,0,0,-1,-1,-1,-1,1,-1
KR_6762462311,420,-3,-79,-4,-8,-4,5,1,0,4,4,2,2,4,-3,4,1,-3,4,1,-2,-10,2,1,-8,7,0,0,-1,1,-1,-1,-1,6,-1
KR_6718674451,420,-3,-116,-4,-9,-1,3,2,-6,7,1,-3,5,2,1,2,3,0,1,1,-1,-2,37,4,-7,3,0,0,-3,0,-1,-1,-1,0,-1
KR_6753269228,420,-3,-18,5,-8,0,1,1,0,1,1,-3,3,0,-5,5,0,0,1,1,0,-11,-45,-3,-6,9,-3,0,-1,-1,1,-1,-1,1,-1
KR_6769188679,420,-4,-33,-28,-11,-12,13,1,0,2,2,0,0,0,1,0,1,0,0,0,0,4,-20,1,-5,4,-4,0,-2,1,-1,-1,-1,4,-1
KR_6750371995,420,0,4,-16,2,0,0,0,3,3,6,-6,7,1,4,4,8,1,3,4,0,4,0,1,-8,7,1,0,0,1,-1,0,1,4,-1
KR_6660613963,420,-1,38,11,2,-1,2,1,2,1,3,3,2,5,-4,6,2,2,0,2,0,8,-45,9,-10,1,0,0,0,-1,-1,0,1,2,-1
KR_6762841247,420,2,19,16,-4,3,0,3,1,3,4,-4,4,0,-3,3,0,-1,1,0,0,-8,2,-3,-5,8,0,0,0,-1,1,1,1,4,-1
KR_6752206924,420,0,-71,-29,-2,1,1,2,-1,2,1,-3,3,0,1,2,3,0,0,0,0,-1,3,-3,-3,6,-1,0,0,1,0,0,1,2,-1
KR_6731637231,420,0,-55,-11,-3,0,1,1,-2,6,4,0,3,3,-1,3,2,0,1,1,0,1,3,4,-9,5,0,0,-1,1,1,-1,-1,5,-1
KR_6758057774,420,0,12,22,-4,2,1,3,1,0,1,0,2,2,-6,7,1,-1,2,1,0,-11,-5,-4,-2,6,1,0,-1,-1,1,1,-1,4,-1
KR_6631761034,420,1,7,36,-3,1,1,2,-1,3,2,1,0,1,-4,5,1,0,0,0,0,-7,-14,0,-6,6,0,0,-1,1,1,-1,-1,3,-1
KR_6593358500,420,1,47,-12,12,-1,2,1,7,0,7,-6,6,0,10,1,11,2,0,2,0,11,2,-3,-7,10,2,0,3,1,1,1,1,4,-1
KR_6399885873,420,-1,35,-44,-8,-3,3,0,-4,4,0,1,2,3,-2,3,1,0,1,1,0,-26,-73,1,-7,6,2,0,1,1,-1,1,-1,2,-1
KR_6760076838,420,2,-43,-8,0,0,0,0,4,2,6,1,1,2,-3,6,3,-2,4,2,0,-1,19,4,-7,3,-2,0,0,-1,-1,0,-1,6,-1
KR_6627002659,420,-5,-11,-23,-11,1,1,2,-3,4,1,2,3,5,-8,8,0,-3,3,0,-1,-21,345,0,-7,7,-3,0,-2,-1,1,-1,-1,2,-1
KR_6767759496,440,-2,-65,-28,-10,-5,7,2,-2,5,3,1,2,3,-5,7,2,1,1,2,-3,-20,203,-2,-7,9,0,0,-1,-1,1,-1,-1,3,-1
KR_6768533804,420,0,-15,0,-1,2,0,2,0,1,1,-5,5,0,1,7,8,1,1,2,-1,-1,-45,-5,-8,13,25,0,0,1,-1,0,-1,3,-1
KR_6755351850,420,-5,-24,-18,-15,0,1,1,-4,5,1,-3,3,0,-8,8,0,0,1,1,0,-14,-9,-1,-4,5,2,0,0,-1,1,1,-1,3,-1
KR_6764932948,420,-3,-81,1,-8,1,1,2,-3,4,1,-3,4,1,-3,3,0,0,1,1,0,-14,-28,2,-7,5,-3,0,1,-1,1,1,-1,4,-1
KR_6614376327,420,-4,-85,2,-10,-2,3,1,-2,3,1,0,1,1,-6,6,0,0,0,0,-1,-15,-5,-4,-4,8,3,0,-1,-1,-1,-1,-1,3,-1
KR_6768689420,440,0,-49,28,-5,3,2,5,-1,3,2,1,0,1,-5,6,1,-3,3,0,0,-6,-2,1,-4,3,2,0,1,-1,1,1,-1,5,-1
KR_6767228735,420,-1,-14,-11,-7,-2,4,2,-2,6,4,-1,3,2,0,4,4,-2,2,0,0,-3,4,-4,-2,6,-1,0,0,-1,-1,0,-1,2,-1
KR_6623606021,420,0,-77,20,2,-2,2,0,3,2,5,4,2,6,-1,1,0,-2,3,1,0,-3,-34,-1,-3,4,-3,0,0,-1,-1,0,1,2,-1
KR_6743821990,440,-5,-127,-25,-8,0,4,4,-1,4,3,-3,3,0,-6,6,0,2,1,3,0,-6,3,-2,-1,3,-3,0,-2,-1,-1,-1,1,5,-1
KR_6696920880,420,-8,-158,-65,-20,-4,5,1,-6,6,0,-4,6,2,-3,5,2,-3,4,1,1,-8,-41,-3,-6,9,-9,0,-4,-1,-1,-1,-1,5,-1
KR_6768500734,420,-3,-3,-25,-11,-8,9,1,3,2,5,-1,3,2,-4,4,0,-1,5,4,-1,-6,-4,-1,-5,6,1,0,-1,-1,-1,-1,-1,3,-1
KR_6728958550,440,-3,-54,13,-6,2,0,2,-8,9,1,-2,2,0,-3,4,1,5,6,11,0,-3,4,-3,-2,5,-5,0,-1,-1,-1,-1,-1,1,-1
KR_6696098010,440,-5,-76,4,-14,-6,8,2,-4,4,0,0,2,2,-1,4,3,-3,4,1,0,-16,-21,-4,-4,8,3,0,0,-1,0,-1,-1,3,-1
KR_6728357445,420,0,-18,11,1,2,2,4,-1,4,3,-1,3,2,0,4,4,1,0,1,0,-2,31,-3,-5,8,6,0,1,-1,-1,1,-1,6,-1
KR_6674422536,440,-4,-66,-15,-10,-2,4,2,-2,2,0,-5,7,2,-3,3,0,2,1,3,0,-5,-1,-4,-2,6,-5,0,-1,-1,1,-1,-1,5,-1
KR_6652858400,420,2,-25,9,3,1,1,2,5,1,6,-1,2,1,0,2,2,-2,3,1,0,3,38,0,-5,5,2,0,-1,-1,-1,-1,1,6,-1
KR_6759218880,420,-5,-52,-17,-4,1,1,2,0,1,1,-4,7,3,-2,4,2,1,0,1,0,-1,5,3,-7,4,1,0,-2,0,-1,-1,-1,0,-1
KR_6764143866,440,-2,-73,3,-3,2,1,3,-2,2,0,-3,6,3,1,1,2,-1,3,2,0,-1,-1,-1,-4,5,2,0,-2,-1,-1,-1,-1,3,-1
KR_6748397541,420,-1,-49,-28,0,0,1,1,-1,3,2,-2,4,2,3,1,4,0,3,3,0,3,101,5,-9,4,1,0,-2,1,-1,-1,-1,3,-1
KR_6764076454,420,-2,-49,-20,-13,-2,3,1,-2,5,3,-11,12,1,4,3,7,-2,2,0,0,-6,-120,0,-5,5,-6,0,-1,-1,1,-1,1,1,-1
KR_6760934232,420,0,14,9,3,0,1,1,2,2,4,-3,3,0,5,0,5,-1,1,0,0,4,-35,5,-6,1,2,0,-1,-1,-1,-1,-1,6,-1
KR_6760780629,420,0,30,-22,0,0,1,1,-2,5,3,2,5,7,-1,4,3,1,1,2,0,2,-24,-2,-1,3,5,0,0,1,-1,0,1,6,-1
KR_6767480078,440,-1,40,-20,1,1,0,1,0,4,4,-3,4,1,3,2,5,0,1,1,1,9,4,0,-4,4,0,0,2,-1,-1,1,1,2,-1
KR_6764814894,420,-2,19,5,-8,0,0,0,-6,6,0,-4,5,1,1,3,4,1,0,1,0,-14,-124,-2,-4,6,-4,0,1,-1,1,1,-1,5,-1
KR_6752637871,420,-9,-94,-45,-21,-4,4,0,-10,12,2,-5,6,1,0,6,6,-2,2,0,-2,-17,-13,-2,-6,8,-5,0,-1,-1,1,-1,-1,6,-1
KR_6757964066,440,2,55,12,2,-1,7,6,-3,4,1,3,1,4,5,1,6,-2,2,0,1,-2,-5,-2,-1,3,-1,0,0,0,1,1,1,0,-1
KR_6768111946,420,-3,-30,-23,2,0,2,2,-4,6,2,-2,2,0,6,1,7,2,1,3,0,-1,5,-4,-2,6,2,0,-1,-1,-1,-1,-1,6,-1
KR_6767754944,420,-6,-36,-19,-11,-3,4,1,-6,6,0,0,1,1,0,0,0,-2,2,0,0,-10,-10,-4,-5,9,-4,0,-1,-1,-1,-1,-1,2,-1
KR_6724279514,420,-6,-188,-18,-12,-4,5,1,-8,8,0,2,0,2,-3,3,0,1,1,2,0,-14,0,-2,-2,4,-4,0,-3,-1,-1,-1,-1,3,-1
KR_6621159690,420,-1,19,11,3,-2,3,1,2,3,5,4,1,5,-2,3,1,1,0,1,0,9,46,2,-9,7,-17,0,0,1,-1,-1,1,6,-1
KR_6724879649,420,-2,-34,-5,-5,-2,2,0,-3,4,1,2,0,2,-3,5,2,1,0,1,0,-9,-38,-1,-4,5,13,0,-1,-1,1,-1,-1,4,-1
KR_6769107655,420,-6,-85,-28,-12,-5,5,0,-3,4,1,2,0,2,-6,7,1,0,1,1,0,-10,-31,1,-4,3,-4,0,-2,-1,-1,-1,1,1,-1
KR_6744211052,440,2,-50,38,-2,-5,5,0,2,4,6,-4,5,1,4,0,4,1,0,1,0,-2,-4,-6,-5,11,-2,0,-1,1,-1,1,1,3,-1
KR_6765631800,420,5,-25,44,2,2,3,5,-1,1,0,-2,4,2,4,1,5,-1,1,0,0,-4,5,3,-4,1,1,0,0,1,1,1,-1,6,-1
KR_6715840721,420,1,-37,-41,5,5,1,6,0,3,3,1,3,4,-2,3,1,1,2,3,0,3,-10,2,-4,2,0,0,-2,1,-1,-1,-1,4,-1
KR_6767116727,420,1,49,8,3,0,3,3,2,2,4,3,0,3,-2,3,1,0,1,1,0,-2,17,1,-5,4,1,0,1,-1,1,1,1,4,-1
KR_6626238953,420,-2,-67,1,-14,-1,1,0,-4,4,0,-4,5,1,-5,5,0,0,2,2,-2,-17,5,1,-7,6,-5,0,-2,1,-1,-1,-1,3,-1
KR_6764001659,440,2,45,11,3,-2,5,3,-1,3,2,2,0,2,1,2,3,3,1,4,0,6,3,-2,-4,6,-4,0,1,-1,-1,1,1,6,-1
KR_6728566478,420,-4,-19,-28,-13,1,3,4,-4,4,0,0,1,1,-7,8,1,-3,3,0,0,-14,-7,-4,-2,6,2,0,0,-1,-1,0,-1,1,-1
KR_6757497073,420,0,-39,-21,5,2,0,2,5,2,7,0,4,4,-2,3,1,0,2,2,0,9,-5,0,-6,6,-2,0,0,-1,1,-1,-1,5,-1
KR_6697236738,420,-4,-68,-14,-10,0,2,2,-5,6,1,-4,6,2,-1,4,3,0,2,2,0,-8,-6,4,-7,3,-3,0,-2,-1,-1,-1,-1,4,-1
KR_6760004445,440,2,23,29,-4,-4,5,1,0,1,1,0,2,2,0,0,0,0,5,5,-1,-12,-8,-2,-4,6,-2,0,-1,1,1,-1,-1,2,-1
KR_6768441413,420,-2,-56,-6,-13,-5,6,1,-7,7,0,0,2,2,0,2,2,-1,4,3,0,-7,-3,-2,-2,4,3,0,-2,-1,-1,-1,1,2,-1
KR_6768126225,420,4,-2,-29,4,-1,3,2,-2,3,1,6,1,7,0,1,1,1,0,1,-1,7,44,0,-5,5,-3,0,-1,-1,-1,-1,-1,1,-1
KR_6764302143,420,-3,-21,12,-7,1,4,5,-3,6,3,-3,5,2,-1,1,0,-1,1,0,0,-13,19,1,-6,5,-1,0,-2,-1,-1,-1,-1,1,-1
KR_6743542623,420,-1,-14,15,0,4,1,5,1,0,1,2,0,2,-4,5,1,-3,5,2,0,-5,-49,0,-7,7,26,0,0,-1,1,-1,1,6,-1
KR_6689909006,420,0,-12,22,-7,-1,2,1,1,4,5,0,1,1,-7,7,0,0,0,0,0,-7,-46,1,-11,10,2,0,1,-1,1,1,-1,3,-1
KR_6759774913,420,-1,-42,-3,1,-1,1,0,1,1,2,2,5,7,-1,2,1,0,0,0,0,-2,1,3,-8,5,-4,0,-1,1,-1,-1,-1,2,-1
KR_6769130547,420,-1,-32,9,1,3,1,4,1,5,6,0,2,2,-1,3,2,-2,3,1,0,-3,135,-3,-9,12,0,0,0,1,-1,-1,-1,3,-1
KR_6721090412,420,4,75,8,5,-3,4,1,0,3,3,2,1,3,2,1,3,4,0,4,1,9,-45,-2,-6,8,16,0,-2,1,-1,-1,1,6,-1
KR_6736499456,420,-6,-112,-2,-11,-1,2,1,-3,3,0,0,1,1,-5,7,2,-2,3,1,0,-9,-3,4,-6,2,-4,0,-3,-1,-1,-1,-1,3,-1
KR_6744776010,440,-1,-43,4,-8,2,0,2,-8,8,0,-4,5,1,1,2,3,1,0,1,0,-8,-4,-4,-6,10,-1,0,-1,-1,-1,-1,-1,2,-1
KR_6741678199,420,-5,-85,-24,-9,-1,1,0,-5,6,1,-2,5,3,0,1,1,-1,1,0,0,-5,-18,-2,-6,8,1,0,-2,1,-1,-1,-1,1,-1
KR_6767456220,420,-1,-43,-7,4,-6,6,0,4,2,6,1,3,4,6,1,7,-1,2,1,0,5,-1,2,-5,3,-3,0,0,-1,1,0,1,2,-1
KR_6754654118,420,-11,-21,-128,-19,-4,5,1,-6,7,1,-7,8,1,-2,3,1,0,0,0,-1,-5,-2,-3,-1,4,-6,-1,-4,-1,-1,-1,-1,1,-1
KR_6757399068,420,-2,1,-35,-6,2,2,4,-4,7,3,-4,5,1,1,0,1,-1,3,2,-3,-12,-23,2,-6,4,-1,0,0,-1,-1,-1,-1,3,-1
KR_6760886663,420,-1,-22,-10,0,1,1,2,0,2,2,0,3,3,-1,2,1,0,1,1,0,3,-2,-3,-5,8,2,0,1,-1,1,1,-1,4,-1
KR_6764244015,420,-3,-24,-1,-7,-2,3,1,-1,2,1,-4,5,1,2,2,4,-2,3,1,0,-8,5,3,-7,4,-3,0,-1,-1,1,-1,1,4,-1
KR_6762451205,420,-3,-66,4,1,0,2,2,1,1,2,0,1,1,-1,4,3,1,0,1,0,0,-114,-1,-6,7,-6,0,0,1,1,-1,1,4,-1
KR_6739321259,420,-2,-54,-24,-6,-7,7,0,0,3,3,1,1,2,-1,3,2,1,0,1,0,1,23,0,-6,6,1,0,-2,1,-1,-1,-1,2,-1
KR_6759485121,420,-1,23,-20,-3,2,3,5,-1,7,6,0,1,1,-2,2,0,-2,4,2,-1,-5,1,-1,-5,6,3,0,0,-1,1,0,-1,3,-1
KR_6665627639,420,-4,-30,-15,-9,-3,4,1,-1,3,2,-1,7,6,-2,3,1,-2,3,1,1,-17,14,-2,-4,6,-2,0,-3,1,-1,-1,1,4,-1
KR_6749670447,420,-2,-22,4,-4,2,3,5,-3,6,3,-1,1,0,-2,3,1,0,2,2,0,-4,2,-2,-4,6,2,0,-2,-1,-1,-1,1,4,-1
KR_6766965654,420,-2,-38,0,-6,-1,3,2,-3,3,0,0,3,3,-1,5,4,-1,1,0,0,-12,-34,2,-7,5,-6,0,-3,1,-1,-1,1,5,-1
KR_6759762954,440,0,37,-23,4,-1,1,0,4,2,6,-3,4,1,2,3,5,2,0,2,0,1,4,0,-5,5,-1,0,1,-1,1,1,1,2,-1
KR_6760533830,420,1,50,5,1,-2,3,1,5,3,8,-2,2,0,0,1,1,0,0,0,0,1,126,-6,-5,11,-8,0,0,-1,-1,0,-1,3,-1
KR_6768455302,420,-2,-19,-3,-5,-1,2,1,1,4,5,1,2,3,-7,7,0,1,2,3,-1,-7,-242,2,-7,5,4,0,1,-1,1,1,-1,6,-1
KR_6764410387,420,1,45,0,-1,-1,2,1,0,3,3,2,2,4,-2,3,1,0,0,0,0,3,-1,0,-5,5,1,0,0,-1,1,0,-1,6,-1
KR_6768688206,420,-5,-39,-8,-9,1,3,4,-5,8,3,-4,4,0,-1,2,1,0,0,0,-2,-8,-10,0,-7,7,6,0,-2,1,-1,-1,-1,3,-1
KR_6754007200,420,-2,0,28,-11,-2,4,2,-1,5,4,-3,5,2,-2,5,3,-3,3,0,-1,-11,-14,-5,-2,7,0,0,-1,-1,1,-1,-1,1,-1
KR_6698712410,420,-2,31,-16,-5,3,1,4,-7,8,1,1,2,3,0,4,4,-2,2,0,0,-13,1,-1,-5,6,5,0,0,-1,-1,1,1,4,-1
KR_6745393692,420,-1,-80,2,4,3,0,3,2,3,5,-1,1,0,0,2,2,0,2,2,0,4,-44,-4,-3,7,1,0,0,1,-1,0,-1,6,-1
KR_6769205513,420,-3,-57,-20,-8,3,0,3,-1,1,0,-2,2,0,-3,5,2,-5,5,0,0,-9,-15,-3,-3,6,-1,0,-1,-1,-1,-1,1,5,-1
KR_6769214164,420,-2,-88,-27,-3,-2,3,1,-1,4,3,2,1,3,0,3,3,-2,2,0,0,-2,18,4,-9,5,-7,0,0,-1,-1,-1,-1,2,-1
KR_6764248039,420,-4,-37,-29,-10,-4,6,2,0,4,4,-4,5,1,0,1,1,-2,2,0,0,-7,-31,-4,-3,7,-2,0,-2,1,-1,-1,-1,2,-1
KR_6760055688,420,-1,-40,10,-5,1,0,1,-2,2,0,1,3,4,-5,6,1,0,0,0,0,0,14,0,-6,6,-2,0,0,-1,-1,-1,-1,2,-1
KR_6769172276,420,2,-41,7,5,5,0,5,1,3,4,1,2,3,-5,8,3,3,0,3,0,6,1,2,-6,4,-1,0,0,-1,1,1,-1,3,-1
KR_6764221566,420,-4,-39,-21,-11,-3,4,1,0,1,1,-4,5,1,-3,3,0,-1,1,0,-1,-10,-8,-3,-4,7,-3,0,0,-1,-1,0,-1,2,-1
KR_6766374363,420,-5,-63,9,-17,0,1,1,-2,2,0,-9,9,0,-3,4,1,-3,4,1,-2,-20,-19,-4,-5,9,3,-1,-6,1,-1,-1,-1,6,-1
KR_6611070572,420,-4,26,-7,-11,-4,4,0,-6,6,0,-1,3,2,2,3,5,-2,3,1,0,-10,-9,-4,-5,9,-1,0,-2,1,-1,-1,-1,1,-1
KR_6762487413,420,0,40,5,3,3,0,3,-2,5,3,-1,4,3,3,1,4,0,1,1,1,-6,-5,1,-6,5,-3,0,1,1,1,1,1,2,-1
KR_6766907922,420,2,-28,1,2,0,2,2,3,1,4,0,3,3,1,0,1,-2,4,2,-1,0,9,0,-4,4,-1,0,2,1,-1,1,-1,1,-1
KR_6768075003,420,-2,5,4,-4,2,0,2,-6,6,0,3,3,6,-2,3,1,-1,4,3,0,-5,15,1,-7,6,-3,0,0,-1,1,0,1,2,-1
KR_6717815595,420,0,36,24,0,2,1,3,1,7,8,0,2,2,-2,5,3,-1,1,0,0,-7,-138,0,-4,4,-5,0,-1,-1,1,-1,1,4,-1
KR_6764786490,420,1,-12,29,-2,-1,2,1,3,1,4,-2,3,1,1,3,4,-3,3,0,0,-7,-13,-4,-4,8,6,0,0,-1,1,0,1,4,-1
KR_6761998801,420,1,11,8,-1,0,3,3,4,0,4,-2,4,2,-2,5,3,-1,3,2,0,-1,3,0,-5,5,-2,0,-1,-1,1,-1,1,5,-1
KR_6737479133,420,-2,15,4,1,-3,4,1,2,2,4,1,2,3,2,1,3,-1,1,0,0,0,-10,-4,-4,8,2,0,1,1,-1,-1,1,3,-1
KR_6752319210,440,-7,-81,-12,-17,-7,7,0,-6,8,2,-3,5,2,-1,2,1,0,0,0,1,-12,0,-3,-1,4,-1,0,-1,1,-1,-1,1,6,-1
KR_6764850917,420,0,-45,6,-3,-2,4,2,-1,3,2,0,5,5,-1,3,2,1,1,2,-1,-4,6,3,-8,5,-1,0,0,1,-1,-1,-1,4,-1
KR_6764040560,420,-3,2,-15,-8,0,0,0,2,3,5,-4,6,2,-6,6,0,0,2,2,-1,-17,2,-3,-5,8,17,0,-1,-1,1,-1,-1,4,-1
KR_6758207267,420,-2,-4,4,-10,-4,4,0,-4,4,0,-5,7,2,2,3,5,1,0,1,0,-9,18,0,-5,5,-7,0,0,-1,-1,-1,1,2,-1
KR_6730254471,420,-3,-95,-24,-6,-6,7,1,-2,6,4,2,1,3,1,2,3,-1,1,0,0,-8,-10,2,-8,6,2,0,-1,-1,1,-1,-1,1,-1
KR_6766887178,420,-3,-28,4,-8,2,3,5,-1,2,1,-1,2,1,-6,6,0,-2,2,0,1,-11,-9,2,-7,5,3,0,-1,1,-1,-1,1,5,-1
KR_6754408204,420,-2,14,-10,-5,4,0,4,0,1,1,-5,7,2,-4,5,1,0,0,0,0,-6,10,-3,-4,7,1,0,-1,-1,-1,-1,1,1,-1
KR_6756483649,420,-2,6,-20,0,0,3,3,1,0,1,0,2,2,1,4,5,-2,5,3,0,0,-6,-2,-4,6,-1,0,2,-1,0,1,1,3,-1
KR_6678066241,420,0,-46,26,-5,1,0,1,-1,1,0,1,2,3,-5,6,1,-1,1,0,0,-14,112,0,-6,6,1,0,0,1,1,1,-1,6,-1
KR_6709610792,420,-7,-115,-5,-3,-4,4,0,3,2,5,-6,6,0,5,1,6,-1,2,1,0,-11,-8,-2,-5,7,-4,0,-4,1,-1,-1,1,1,-1
KR_6688186102,420,1,15,22,2,2,2,4,2,0,2,0,2,2,-1,5,4,-1,1,0,0,-9,2,3,-9,6,0,0,0,1,-1,1,-1,5,-1
KR_6748552240,420,-2,-54,-13,-2,-3,4,1,0,4,4,2,2,4,3,1,4,-4,4,0,0,-1,-1,-1,-8,9,4,0,-1,1,-1,-1,-1,4,-1
KR_6679298310,420,1,-23,4,0,0,0,0,-5,6,1,4,1,5,0,2,2,1,1,2,0,-2,-7,1,-6,5,1,0,-1,1,1,-1,1,3,-1
KR_6767359009,420,-4,52,-8,-6,-2,3,1,-2,4,2,1,4,5,-4,7,3,1,0,1,0,-11,3,1,-7,6,5,0,-1,1,-1,-1,1,3,-1
KR_6664796569,420,3,9,17,6,4,0,4,1,1,2,0,3,3,-1,10,9,2,1,3,0,7,-1,3,-6,3,-1,0,3,1,1,1,1,1,-1
KR_6749272244,420,-4,-43,-16,1,-1,2,1,-4,5,1,0,3,3,4,2,6,2,0,2,0,5,-9,1,-8,7,-4,0,0,-1,1,-1,1,2,-1
KR_6738316663,440,0,19,24,1,-4,4,0,2,2,4,-5,6,1,2,1,3,6,1,7,1,7,0,3,-6,3,2,0,0,1,-1,1,1,6,-1
KR_6767720747,420,-1,-58,34,-9,2,1,3,-2,7,5,1,1,2,-10,10,0,0,1,1,0,-13,-4,-4,-6,10,-5,0,0,0,1,-1,1,0,-1
KR_6745167540,420,-4,-75,-27,-4,-5,5,0,2,4,6,2,1,3,-4,4,0,1,0,1,0,0,-8,-5,-2,7,1,0,-2,-1,-1,-1,-1,4,-1
KR_6768186886,420,-2,-18,-18,-10,0,2,2,-1,2,1,-8,10,2,0,1,1,-1,1,0,0,-12,3,2,-5,3,-2,0,0,-1,-1,0,-1,5,-1
KR_6674177288,420,-2,12,-22,-2,-2,5,3,0,1,1,1,0,1,0,1,1,-1,1,0,0,-7,-14,-1,-6,7,6,0,1,-1,-1,1,1,2,-1
KR_6764205914,420,-2,-48,12,-7,-3,5,2,1,5,6,3,1,4,-5,5,0,-3,3,0,0,-11,5,0,-6,6,-2,0,-1,-1,-1,-1,1,3,-1
KR_6766275349,420,0,26,-11,3,-2,3,1,-1,2,1,3,1,4,2,0,2,1,0,1,1,3,-2,3,-5,2,0,0,-1,-1,-1,-1,1,1,-1
KR_6768739676,420,3,18,0,11,3,3,6,1,0,1,3,2,5,3,1,4,1,0,1,-1,15,0,3,-10,7,0,0,0,-1,1,0,-1,4,-1
KR_6728330654,420,-4,-29,11,-4,-3,3,0,-2,3,1,-1,4,3,3,1,4,-1,2,1,0,1,4,0,-3,3,-3,0,-1,1,-1,-1,1,4,-1
KR_6759326769,420,1,4,0,0,4,0,4,3,1,4,-4,5,1,-3,4,1,0,1,1,0,-9,-2,0,-7,7,1,0,-1,1,-1,-1,1,1,-1
KR_6768539918,420,-4,16,8,-8,-2,3,1,1,2,3,-1,2,1,-6,8,2,0,1,1,-1,-16,0,0,-6,6,-7,0,0,-1,-1,0,-1,4,-1
KR_6733013156,420,-6,-65,-15,-14,0,2,2,-2,4,2,-2,4,2,-7,7,0,-3,3,0,0,-29,14,-5,-2,7,-6,0,-1,-1,-1,-1,1,2,-1
KR_6757901286,420,-1,16,28,-4,1,1,2,-2,4,2,-2,3,1,0,3,3,-1,2,1,0,-5,-10,2,-6,4,-1,0,-1,-1,-1,-1,-1,6,-1
KR_6759451236,420,-2,-11,0,-2,2,1,3,-1,3,2,-3,3,0,1,2,3,-1,1,0,0,-10,-3,3,-11,8,0,0,0,-1,1,0,1,5,-1
KR_6728029076,440,4,8,28,9,2,1,3,7,0,7,4,0,4,-5,6,1,1,0,1,-1,3,-10,-2,-5,7,2,0,1,1,-1,-1,-1,1,-1
KR_6745340370,420,1,28,-49,-5,-3,5,2,-1,2,1,2,0,2,-2,4,2,-1,1,0,-1,-2,-5,2,-4,2,1,0,0,-1,-1,-1,1,1,-1
KR_6763404276,420,-2,48,2,1,1,3,4,-1,2,1,-3,3,0,4,1,5,0,1,1,0,-2,1,1,-4,3,3,0,0,-1,-1,0,1,6,-1
KR_6679799250,420,1,-47,-14,1,4,0,4,5,0,5,-2,2,0,-5,5,0,-1,1,0,0,-1,-4,-2,-4,6,-4,0,0,-1,1,1,-1,6,-1
KR_6768455703,440,-3,-25,8,-4,-2,3,1,2,2,4,-4,5,1,-1,2,1,1,2,3,0,-5,-88,-1,-2,3,-2,0,0,1,-1,1,-1,2,-1
KR_6768779623,420,-1,-20,17,0,-3,4,1,-4,7,3,5,0,5,2,1,3,0,2,2,0,-4,-8,-3,-5,8,6,0,-1,1,1,-1,-1,1,-1
KR_6758340576,420,-2,-58,-8,2,1,0,1,2,5,7,0,3,3,-1,4,3,0,0,0,0,-1,-166,-3,-3,6,39,0,-1,1,-1,-1,1,5,-1
KR_6768635028,440,-2,45,3,-3,-4,5,1,1,2,3,1,3,4,4,1,5,-5,6,1,0,-6,-26,1,-7,6,0,0,-1,0,-1,-1,1,0,-1
KR_6728678961,420,1,-30,9,2,0,3,3,1,6,7,1,2,3,-3,4,1,3,0,3,0,-4,33,1,-7,6,-1,0,0,-1,1,-1,1,6,-1
KR_6745924226,420,0,23,16,1,-1,2,1,-5,7,2,0,2,2,5,1,6,2,3,5,1,-7,-7,-2,-7,9,2,0,0,1,-1,0,1,4,-1
KR_6646730265,420,0,21,-42,-3,2,0,2,-1,4,3,-1,2,1,-2,5,3,-1,1,0,0,3,-4,4,-6,2,-2,0,-1,-1,-1,-1,1,6,-1
KR_6726934782,420,-2,-65,28,-2,-3,5,2,0,1,1,5,3,8,-3,3,0,-1,1,0,-1,-5,-8,2,-8,6,4,0,0,1,1,1,-1,2,-1
KR_6650256746,420,-1,-35,40,-5,0,2,2,0,2,2,-1,7,6,-5,7,2,1,1,2,-3,-11,42,1,-10,9,-5,0,-2,1,1,-1,-1,3,-1
KR_6760395872,420,-3,-72,-8,-15,-5,8,3,-4,5,1,2,4,6,-8,9,1,0,3,3,-2,-18,-8,-5,-4,9,-2,0,-2,1,1,-1,-1,6,-1
KR_6767962161,420,-4,-61,-9,-6,-3,3,0,-3,3,0,-1,4,3,3,2,5,-2,3,1,0,-3,-3,-1,-6,7,2,0,-2,-1,1,1,-1,1,-1
KR_6718542395,420,-2,4,-37,-4,-2,2,0,-2,5,3,1,0,1,0,2,2,-1,2,1,0,-6,-4,1,-8,7,0,0,-1,-1,0,-1,1,1,-1
KR_6721379874,420,-6,-34,10,-18,-3,3,0,-3,6,3,-1,3,2,-6,8,2,-5,5,0,0,-18,-8,0,-9,9,-8,0,-2,-1,1,-1,-1,2,-1
KR_6763904395,420,-7,-21,-39,-16,-4,4,0,1,0,1,-8,9,1,-5,7,2,0,0,0,-1,-20,-4,0,-3,3,1,0,-1,-1,-1,-1,-1,3,-1
KR_6752222594,420,1,-51,0,2,-1,2,1,1,2,3,3,1,4,3,0,3,-4,5,1,0,12,3,3,-6,3,-4,0,-1,1,1,-1,-1,4,-1
KR_6764380857,420,1,-22,-5,3,0,1,1,2,2,4,0,3,3,3,2,5,-2,4,2,0,5,1,6,-12,6,-7,0,0,1,1,0,1,5,-1
KR_6760655576,420,1,26,23,3,-2,2,0,4,1,5,1,1,2,0,1,1,0,0,0,0,2,19,0,-4,4,2,0,2,1,-1,1,1,6,-1
KR_6729199735,420,2,73,1,2,-1,1,0,-1,4,3,0,1,1,5,0,5,-1,2,1,0,2,-123,1,-8,7,4,0,0,1,1,0,1,3,-1
KR_6739697823,420,-2,-26,-27,-6,0,1,1,0,3,3,-2,3,1,-4,4,0,0,0,0,0,-10,-18,0,-7,7,-4,0,0,-1,0,0,1,6,-1
KR_6737079950,440,-3,-72,-31,-8,-1,2,1,-4,6,2,-2,6,4,-4,5,1,3,1,4,0,-3,-3,-2,-5,7,4,0,-1,1,-1,-1,-1,2,-1
KR_6757452990,420,1,-33,-30,4,-2,2,0,4,2,6,0,1,1,4,2,6,-2,5,3,1,8,20,-3,-5,8,0,0,-1,-1,-1,-1,1,5,-1
KR_6639639310,420,-2,-13,-27,1,-2,5,3,2,2,4,-1,3,2,4,2,6,-2,3,1,0,-1,1,3,-9,6,-1,0,0,1,1,0,1,2,-1
KR_6765568060,440,-2,-87,17,4,-3,4,1,0,2,2,-1,2,1,6,1,7,2,0,2,0,4,-2,-2,-4,6,1,0,1,1,1,1,1,3,-1
KR_6702575962,420,-2,-16,-12,-3,-1,3,2,1,2,3,5,0,5,-6,6,0,-2,3,1,0,-9,1,-2,-4,6,-2,0,0,-1,1,-1,-1,5,-1
KR_6668067742,420,-3,17,-8,-4,-2,3,1,3,1,4,-2,2,0,-3,4,1,0,2,2,-2,-3,165,-3,-4,7,-6,0,-1,1,-1,-1,-1,6,-1
KR_6768033535,420,-1,-67,32,0,1,3,4,-1,3,2,1,2,3,-1,2,1,0,0,0,0,2,-15,-4,-4,8,7,0,-1,1,1,-1,-1,3,-1
KR_6732067645,420,-1,-39,-15,0,0,3,3,-1,4,3,0,3,3,0,3,3,1,1,2,2,8,7,5,-11,6,-4,0,1,-1,1,1,1,5,-1
KR_6760602126,420,1,17,27,-2,-1,3,2,3,3,6,-3,3,0,-2,2,0,1,1,2,0,-1,-3,-4,-3,7,3,0,0,-1,-1,0,-1,6,-1
KR_6559860327,420,3,63,-16,5,0,1,1,1,1,2,0,3,3,2,3,5,2,0,2,0,4,-176,0,-6,6,1,0,0,1,-1,0,1,3,-1
KR_6716723956,420,-1,-17,21,-5,1,1,2,-1,4,3,-2,2,0,-1,1,0,-2,2,0,0,-4,1,-7,-4,11,-3,0,1,-1,1,1,-1,4,-1
KR_6747288090,440,1,14,0,-3,-2,3,1,1,5,6,0,1,1,-3,5,2,1,1,2,0,-8,320,-1,-2,3,-1,0,2,1,1,1,1,1,-1
KR_6712692282,420,-1,33,4,-2,2,3,5,-4,5,1,0,2,2,-3,3,0,3,1,4,0,-6,-8,4,-5,1,0,0,2,1,-1,1,1,2,-1
KR_6767188222,420,3,-3,-6,5,3,0,3,3,0,3,0,1,1,-1,4,3,0,0,0,0,5,13,2,-7,5,-3,0,1,-1,1,1,1,6,-1
KR_6719433598,440,-5,14,-28,-6,-6,8,2,0,4,4,-3,7,4,4,2,6,-1,1,0,1,7,19,-7,-1,8,2,0,-1,0,-1,-1,-1,0,-1
KR_6736820349,420,-3,-30,-36,-6,2,1,3,0,5,5,-4,4,0,-3,5,2,-1,1,0,0,-2,-26,-4,-1,5,-2,0,-2,-1,-1,-1,-1,3,-1
KR_6754951707,420,-1,52,-5,-2,0,2,2,-3,3,0,-4,5,1,5,1,6,0,1,1,1,2,-5,5,-9,4,3,0,0,0,-1,0,1,0,-1
KR_6769082423,420,-6,-55,-12,-13,0,2,2,-6,6,0,1,3,4,-3,3,0,-5,5,0,-1,-18,-16,-5,-5,10,-1,0,-2,-1,-1,-1,-1,5,-1
KR_6760337841,420,-1,89,-6,-7,-2,3,1,3,2,5,-6,8,2,0,0,0,-2,2,0,0,-19,0,-2,-4,6,-7,0,0,-1,1,1,1,3,-1
KR_6768579758,420,-3,17,-31,-1,1,1,2,-4,7,3,0,2,2,-1,3,2,3,1,4,0,8,-17,-1,-3,4,3,0,0,-1,-1,1,-1,1,-1
KR_6768225929,420,-3,-45,-38,-2,-1,3,2,-1,2,1,-1,1,0,0,0,0,1,0,1,0,-5,-57,-1,-5,6,-3,0,0,-1,-1,-1,-1,5,-1
KR_6657149516,420,-1,46,5,-1,1,1,2,-3,5,2,6,0,6,-3,3,0,-2,4,2,0,-5,-118,-2,-7,9,0,0,1,-1,1,1,1,1,-1
KR_6761971685,420,-1,-30,-6,-9,-4,5,1,-1,1,0,1,2,3,-6,7,1,1,0,1,0,-8,5,2,-6,4,-2,0,-2,1,-1,-1,1,6,-1
KR_6748546511,420,1,30,-21,-5,-3,3,0,-1,2,1,-5,9,4,1,1,2,3,0,3,0,0,-167,-5,-4,9,6,0,0,1,-1,-1,-1,5,-1
KR_6750269166,420,-2,-85,8,-8,-2,5,3,-1,4,3,-6,8,2,0,1,1,1,0,1,0,-12,-1,-2,-4,6,0,0,0,0,1,-1,1,0,-1
KR_6761300424,420,0,80,-42,4,4,0,4,-1,3,2,1,4,5,-1,2,1,1,0,1,0,4,-14,4,-5,1,1,0,-1,-1,-1,1,1,4,-1
KR_6768730355,420,-1,16,-19,-3,-4,4,0,-2,6,4,1,2,3,1,1,2,1,0,1,0,-4,19,1,-4,3,1,0,0,-1,-1,1,1,2,-1
KR_6756420358,420,0,-49,5,-5,2,0,2,-3,4,1,0,4,4,0,0,0,-4,6,2,0,-13,6,3,-8,5,-4,0,-2,-1,1,-1,1,6,-1
KR_6711697448,440,3,28,52,2,4,1,5,-3,3,0,1,2,3,-1,3,2,1,0,1,0,-12,44,-1,-2,3,-8,0,1,-1,1,1,1,4,-1
KR_6742306062,420,6,15,55,1,-2,2,0,5,3,8,-3,5,2,0,3,3,1,0,1,0,2,75,-1,-6,7,2,0,0,1,1,1,-1,2,-1
KR_6754737066,420,-5,34,-12,-10,0,5,5,1,5,6,-2,3,1,-6,7,1,-3,3,0,1,-9,-15,-7,-1,8,7,0,0,1,-1,-1,1,3,-1
KR_6769109806,420,-5,-49,-20,-13,0,2,2,-5,5,0,-5,7,2,-2,3,1,-1,1,0,0,-12,-10,-2,-3,5,-5,0,-2,-1,0,-1,-1,6,-1
KR_6768771946,420,2,35,4,-1,5,2,7,-6,8,2,1,1,2,1,4,5,-2,2,0,0,1,44,2,-7,5,-12,0,0,-1,-1,0,1,4,-1
KR_6765836200,420,1,8,13,7,-1,3,2,3,3,6,1,2,3,3,1,4,1,1,2,0,4,-46,-2,-6,8,21,0,0,-1,1,1,1,1,-1
KR_6759190909,420,4,6,0,7,1,2,3,0,6,6,3,0,3,2,3,5,1,1,2,0,13,-3,0,-5,5,5,0,1,1,1,1,-1,1,-1
KR_6760648915,420,1,25,4,-8,-8,8,0,-3,5,2,1,2,3,1,2,3,1,1,2,0,-1,-3,2,-4,2,-3,0,-1,1,-1,-1,-1,3,-1
KR_6556916516,420,0,39,7,-4,1,2,3,1,0,1,2,1,3,0,0,0,-8,8,0,0,-6,2,1,-7,6,-3,0,0,1,1,0,1,1,-1
KR_6767637908,420,-5,-21,13,-18,-1,3,2,-10,10,0,-4,6,2,-1,4,3,-2,2,0,0,-22,-9,-8,-4,12,3,0,-2,1,-1,-1,-1,6,-1
KR_6764609745,420,-3,0,-28,-7,-3,5,2,3,2,5,0,2,2,-4,4,0,-3,6,3,0,-8,-7,1,-5,4,0,0,0,-1,-1,-1,-1,1,-1
KR_6759915678,440,-2,-40,17,-4,-1,1,0,-2,4,2,0,1,1,1,0,1,-2,2,0,0,-6,4,0,-5,5,2,0,0,1,1,0,1,1,-1
KR_6693696148,420,-2,-105,-6,-4,-3,3,0,5,2,7,-3,4,1,-3,5,2,0,2,2,0,3,-28,-1,-5,6,3,0,-2,-1,-1,-1,-1,1,-1
KR_6766823691,420,-7,-67,-14,-19,1,1,2,-7,7,0,-7,7,0,-7,8,1,1,1,2,-1,-30,-2,-2,-5,7,-10,0,-1,-1,-1,-1,-1,5,-1
KR_6601550118,420,-4,-25,-32,-6,-1,1,0,-4,4,0,0,0,0,-1,1,0,0,0,0,0,-6,-2,-1,-4,5,-7,0,-1,1,-1,-1,-1,6,-1
KR_6768839782,420,-2,36,-24,2,-2,4,2,3,0,3,2,4,6,-1,1,0,0,1,1,1,5,-64,0,-5,5,23,0,0,-1,0,0,1,3,-1
KR_6764725140,440,1,24,-5,-3,0,1,1,-2,3,1,-2,4,2,2,0,2,-1,1,0,0,0,31,1,-4,3,2,0,0,-1,1,0,1,2,-1
KR_6291644611,420,-5,-65,-2,-9,-3,5,2,2,2,4,-4,6,2,-3,6,3,-1,1,0,-1,-9,2,-1,-6,7,-2,0,-1,-1,-1,-1,-1,2,-1
KR_6753374580,420,-3,-35,-29,-8,-11,11,0,1,3,4,4,3,7,-3,7,4,1,0,1,-4,-8,17,-5,-5,10,-1,0,0,-1,1,1,-1,3,-1
KR_6675563542,440,-2,-78,16,-6,3,1,4,-3,4,1,-3,4,1,-3,3,0,0,1,1,0,-12,8,-1,-3,4,2,0,0,1,-1,-1,1,6,-1
KR_6762343179,420,-1,-71,1,-3,1,3,4,0,4,4,-2,3,1,-2,4,2,0,1,1,-1,-4,0,1,-7,6,2,0,-1,-1,-1,-1,-1,1,-1
KR_6761963904,420,-2,-5,-1,-4,-2,5,3,0,5,5,-2,2,0,0,1,1,0,1,1,0,-4,-9,0,-2,2,1,0,-1,1,1,-1,1,6,-1
KR_6759739018,420,5,69,4,8,4,1,5,-1,5,4,3,1,4,2,5,7,0,0,0,0,7,-5,1,-9,8,-5,0,2,-1,1,1,1,6,-1
KR_6750117191,420,-1,39,8,0,2,0,2,1,0,1,0,7,7,-3,5,2,0,0,0,-1,1,9,4,-8,4,-7,0,0,1,1,0,-1,4,-1
KR_6720796786,420,-1,39,-2,-8,0,3,3,-8,10,2,1,0,1,3,1,4,-4,4,0,-1,-8,0,3,-7,4,-5,0,-1,1,-1,-1,-1,3,-1
KR_6716387428,420,-1,-71,3,0,-3,4,1,-2,5,3,3,0,3,0,2,2,2,0,2,-1,1,6,3,-7,4,-7,0,0,-1,1,-1,-1,5,-1
KR_6712639450,420,-4,-37,3,-13,-4,4,0,-2,3,1,-3,3,0,-3,5,2,-1,3,2,0,-10,-6,-6,-3,9,4,0,-1,-1,1,-1,-1,2,-1
KR_6767416641,420,-2,-57,-16,-4,-2,3,1,4,2,6,-1,1,0,-4,5,1,-1,1,0,0,-9,14,-7,-2,9,0,0,-1,-1,-1,-1,-1,2,-1
KR_6719788755,420,-2,9,-70,-1,0,0,0,-2,7,5,1,2,3,1,4,5,-1,1,0,-1,-3,1,2,-7,5,-1,0,-1,1,-1,-1,-1,5,-1
KR_6726594759,420,-2,-3,0,-2,2,0,2,-1,6,5,-3,3,0,0,2,2,0,1,1,0,1,14,-5,-5,10,-1,0,1,-1,0,1,1,5,-1
KR_6733890176,440,1,20,-9,5,-2,3,1,0,1,1,-1,1,0,4,0,4,4,0,4,0,8,11,3,-5,2,-6,0,0,1,-1,1,1,3,-1
KR_6622702189,420,-2,3,-15,-1,-2,2,0,-4,5,1,1,0,1,2,2,4,2,0,2,0,-9,147,-1,-4,5,-3,0,0,-1,1,1,1,2,-1
KR_6766917540,420,-4,-6,-32,-10,-2,2,0,-3,4,1,-1,2,1,-5,6,1,1,0,1,0,-11,0,-1,-5,6,-3,0,0,-1,1,0,-1,5,-1
KR_6534098241,420,-6,19,-16,-11,1,0,1,-5,6,1,-2,3,1,-4,5,1,-1,2,1,0,-16,-25,-4,-4,8,5,0,0,-1,-1,-1,-1,1,-1
KR_6689407298,420,-2,-83,-10,-4,-6,7,1,1,0,1,2,1,3,-1,3,2,0,3,3,1,4,-4,3,-8,5,3,0,-1,-1,1,-1,1,5,-1
KR_6759857738,440,0,-46,12,0,-2,3,1,1,5,6,1,7,8,1,0,1,-1,1,0,0,6,-1,-4,-5,9,-3,0,1,0,1,1,1,0,-1
KR_6753450733,420,-1,-37,-21,-10,-1,2,1,-3,4,1,1,2,3,-3,6,3,-4,4,0,-1,-8,8,5,-9,4,-3,0,-1,-1,1,-1,-1,3,-1
KR_6763660103,420,-1,24,23,-6,-2,2,0,-3,4,1,-5,7,2,4,4,8,0,1,1,-3,-8,-4,3,-7,4,2,0,-1,0,-1,-1,-1,0,-1
KR_6766207340,420,0,-16,-4,-3,-1,1,0,-1,4,3,-1,3,2,-1,4,3,1,0,1,0,3,5,-7,-5,12,-1,0,0,1,-1,-1,1,3,-1
KR_6767350589,420,-1,18,-24,-2,-5,5,0,2,1,3,7,0,7,-5,9,4,-1,1,0,0,-2,47,-2,-6,8,-18,0,0,1,-1,-1,1,4,-1
KR_6749658606,420,-3,-28,-16,-8,0,3,3,-3,4,1,-6,8,2,2,3,5,-1,1,0,-2,-11,-22,-2,-4,6,-4,0,-1,-1,-1,1,-1,2,-1
KR_6762033306,420,-1,-38,30,-3,6,0,6,-3,3,0,-5,6,1,-2,2,0,1,0,1,-1,-5,-12,-5,-1,6,3,0,0,1,-1,0,-1,5,-1
KR_6761549406,440,-1,23,3,-5,2,0,2,-1,3,2,-1,4,3,-4,7,3,-1,2,1,0,-12,-1,-5,-2,7,0,0,0,0,1,1,-1,0,-1
KR_6741401354,420,-1,7,-4,-8,0,1,1,-7,7,0,0,1,1,1,1,2,-2,4,2,0,-6,3,2,-9,7,1,0,-1,1,-1,-1,1,2,-1
KR_6764806508,440,-1,-48,-9,1,-2,4,2,-2,2,0,0,0,0,1,1,2,4,2,6,0,0,4,0,-6,6,-1,0,0,1,-1,0,-1,1,-1
KR_6765818105,420,-2,-15,-19,-6,-8,8,0,2,1,3,-1,2,1,0,2,2,1,1,2,0,-8,6,4,-7,3,-1,0,-3,-1,-1,-1,1,4,-1
KR_6744572192,420,-4,-99,43,-12,-3,3,0,-2,3,1,-5,5,0,-3,6,3,1,0,1,0,-13,2,-6,-3,9,-4,0,-1,-1,1,-1,-1,5,-1
KR_6735491709,420,-3,-43,12,-4,-7,7,0,-2,4,2,2,1,3,1,3,4,2,1,3,0,1,-2,-1,-5,6,5,0,-1,-1,-1,-1,-1,6,-1
KR_6769181929,420,-2,42,0,0,-3,5,2,0,2,2,0,0,0,3,4,7,0,0,0,0,4,-102,2,-4,2,2,0,2,1,-1,1,1,6,-1
KR_6734750453,420,-5,-44,-32,-14,-8,8,0,-4,5,1,-1,1,0,-2,4,2,1,1,2,0,-10,-6,-2,-3,5,-4,0,-3,-1,-1,-1,-1,2,-1
KR_6743231464,420,-4,-62,1,-18,-5,5,0,-6,9,3,-3,4,1,-4,6,2,0,0,0,-1,-20,-3,-5,-3,8,-4,0,-2,-1,-1,-1,-1,5,-1
KR_6767861385,420,-5,12,-6,-13,-2,2,0,2,2,4,-6,8,2,-5,6,1,-2,2,0,0,-15,0,2,-6,4,-5,0,1,-1,1,1,-1,3,-1
KR_6768894753,420,4,25,34,5,2,1,3,3,1,4,-1,2,1,-1,2,1,2,1,3,0,4,49,4,-7,3,-5,0,2,-1,1,1,1,3,-1
KR_6762927440,420,1,4,-1,5,3,1,4,0,4,4,-3,3,0,2,0,2,3,0,3,2,9,-8,-2,-8,10,-3,0,1,-1,-1,1,1,5,-1
KR_6547331118,420,-3,-14,7,-8,0,1,1,-1,3,2,-6,6,0,0,3,3,-1,1,0,0,-5,-41,-1,-7,8,3,0,-1,-1,-1,-1,-1,1,-1
KR_6766635417,420,0,-4,-6,-1,-1,2,1,-3,6,3,2,0,2,2,2,4,-1,2,1,-1,-2,7,5,-9,4,-4,0,0,-1,0,0,-1,2,-1
KR_6754256462,420,-1,8,-21,1,-1,2,1,3,2,5,1,3,4,-2,4,2,0,2,2,0,3,-4,0,-5,5,4,0,1,-1,-1,-1,1,2,-1
KR_6734508682,440,1,37,25,-3,-2,3,1,-4,4,0,2,3,5,-5,6,1,6,0,6,-3,-10,4,-6,-5,11,-1,0,0,1,1,0,-1,1,-1
KR_6672023628,420,-6,-104,-24,-9,-6,7,1,0,4,4,-1,2,1,-1,3,2,-1,1,0,0,2,8,-5,-3,8,1,0,0,1,-1,-1,1,3,-1
KR_6764378163,420,2,-1,21,1,0,3,3,1,1,2,2,1,3,-2,3,1,0,1,1,0,-6,3,0,-8,8,-2,0,0,-1,-1,0,1,1,-1
KR_6762158850,420,0,-11,-12,-3,2,1,3,-2,3,1,-7,7,0,3,0,3,1,0,1,0,-9,0,1,-6,5,1,0,0,1,0,0,-1,2,-1
KR_6645093716,420,1,-48,-10,3,0,1,1,1,4,5,-2,3,1,0,1,1,4,1,5,0,7,0,0,-6,6,2,0,0,1,-1,-1,1,5,-1
KR_6761314023,420,-2,-59,-24,-7,-2,5,3,3,0,3,-4,4,0,-6,7,1,2,4,6,1,-2,9,-2,-1,3,-1,0,-1,0,-1,-1,1,0,-1
KR_6763444582,420,-3,-78,-17,-5,-5,6,1,-4,4,0,-1,4,3,2,1,3,3,1,4,0,0,59,-2,-5,7,0,0,-1,1,-1,-1,1,3,-1
KR_6753101595,420,0,-20,10,-6,0,4,4,0,2,2,-3,4,1,-3,4,1,0,0,0,0,-8,5,5,-9,4,0,0,0,1,1,0,-1,5,-1
KR_6761496991,420,-1,-62,-28,8,1,1,2,0,2,2,4,0,4,4,4,8,-1,3,2,0,21,27,0,-6,6,18,0,-2,1,-1,1,-1,6,-1
KR_6767512191,420,-6,-28,-54,-12,-3,5,2,-3,5,2,-2,2,0,-4,10,6,0,1,1,0,-5,-6,-1,-6,7,5,0,-1,-1,-1,-1,1,6,-1
KR_6752989965,420,-4,-58,0,0,2,1,3,1,0,1,-5,7,2,3,2,5,-1,1,0,-3,-2,-4,-3,-2,5,2,0,-2,-1,-1,-1,-1,2,-1
KR_6731817811,420,-2,6,-20,-8,-1,4,3,-4,5,1,-5,6,1,2,2,4,0,1,1,0,-11,-7,-5,-4,9,-1,0,0,0,-1,0,-1,0,-1
KR_6631578636,440,-1,8,-40,-2,0,2,2,-2,3,1,-2,6,4,5,3,8,-3,5,2,0,-4,-19,3,-9,6,-4,0,0,0,1,0,-1,0,-1
KR_6753285236,440,2,28,-24,2,0,2,2,-1,3,2,-2,6,4,4,2,6,1,1,2,-1,0,-25,4,-9,5,-1,0,1,0,-1,1,-1,0,-1
KR_6765325066,420,-3,-41,-11,-10,-1,1,0,-6,7,1,-5,5,0,2,6,8,0,0,0,0,-7,15,-3,-6,9,4,0,-1,-1,-1,-1,-1,4,-1
KR_6725932716,420,-2,-17,-3,-5,-3,4,1,-4,4,0,5,3,8,-1,2,1,-2,2,0,0,-3,-14,-4,-3,7,1,0,-2,1,-1,-1,-1,2,-1
KR_6729289368,420,-4,-48,0,-11,-6,6,0,3,4,7,-2,5,3,-6,9,3,0,1,1,0,-14,4,-6,-5,11,-8,0,-2,-1,-1,-1,-1,1,-1
KR_6756665231,420,-2,8,-12,-10,-3,3,0,-5,5,0,-1,2,1,0,2,2,-1,1,0,0,-16,-2,3,-9,6,0,0,0,1,1,0,1,3,-1
KR_6757454386,420,-1,17,-9,-4,-1,1,0,-1,3,2,-2,3,1,-1,4,3,1,0,1,0,-6,15,2,-4,2,4,0,1,-1,1,1,-1,3,-1
KR_6767458738,420,-1,-7,16,0,2,0,2,-2,3,1,2,1,3,-3,8,5,1,3,4,0,-5,5,1,-8,7,-2,0,1,-1,1,1,1,1,-1
KR_6766511363,420,-3,-60,-15,-2,1,0,1,0,3,3,-3,4,1,0,3,3,0,2,2,0,-1,-2,-7,-3,10,-3,0,0,-1,-1,0,1,6,-1
KR_6752706353,420,-2,0,-4,-5,0,0,0,-2,2,0,2,1,3,-5,5,0,0,0,0,0,-11,-34,-3,-3,6,4,0,-1,1,-1,-1,-1,2,-1
KR_6762829544,420,-3,-31,20,-8,-3,4,1,2,3,5,-1,1,0,-5,6,1,-1,1,0,0,-10,-8,-3,-5,8,-7,0,-3,1,-1,-1,-1,6,-1
KR_6721340329,420,-4,-51,-29,0,-4,4,0,0,5,5,-1,6,5,3,2,5,2,2,4,-1,-3,-17,2,-8,6,3,0,-2,1,-1,-1,-1,6,-1
KR_6766176139,420,1,-31,-19,0,-1,1,0,-2,5,3,0,3,3,6,2,8,-3,4,1,0,2,12,4,-10,6,-5,0,0,-1,1,1,1,3,-1
KR_6761529367,420,5,18,-8,14,4,0,4,5,2,7,3,2,5,0,6,6,2,0,2,1,22,-4,-4,-3,7,6,0,2,-1,1,1,1,4,-1
KR_6759286197,420,1,14,16,2,2,0,2,1,2,3,0,2,2,-1,4,3,0,1,1,0,3,213,1,-4,3,-4,0,0,1,-1,0,-1,5,-1
KR_6738996933,420,-1,-4,3,-2,2,1,3,2,1,3,-1,2,1,-3,3,0,-2,5,3,-1,-10,-1,1,-5,4,-1,0,-2,-1,1,-1,-1,3,-1
KR_6761357380,440,0,-19,4,-10,-4,5,1,-8,9,1,-2,3,1,2,1,3,2,1,3,-1,-4,-30,2,-5,3,-2,0,-2,1,-1,-1,1,3,-1
KR_6763466089,440,0,9,-6,-2,-1,2,1,-4,4,0,1,0,1,1,3,4,1,0,1,-1,-4,4,3,-9,6,-8,0,-1,-1,-1,-1,-1,1,-1
KR_6727874991,420,-5,-109,-7,-5,-1,3,2,5,4,9,-2,4,2,-2,2,0,-5,5,0,0,-8,-4,-4,-3,7,3,0,-1,-1,1,1,1,1,-1
KR_6767433683,420,-2,-32,6,0,-2,3,1,0,3,3,0,2,2,2,3,5,0,1,1,1,-6,-1,1,-8,7,2,0,0,1,1,-1,-1,6,-1
KR_6420038826,420,-2,-20,-1,-6,-1,2,1,1,2,3,-7,10,3,-2,3,1,3,0,3,0,2,17,1,-5,4,0,0,-2,1,-1,-1,-1,4,-1
KR_6758977809,420,-1,16,-12,-6,-2,3,1,-3,6,3,0,3,3,2,3,5,-3,4,1,0,-6,-27,-2,-4,6,4,0,0,-1,-1,0,1,1,-1
KR_6667230193,420,-4,-12,-20,-9,0,2,2,-4,4,0,-5,7,2,1,1,2,-1,2,1,2,-7,5,2,-5,3,-3,0,1,-1,1,-1,1,3,-1
KR_6704967241,420,-3,-66,-6,0,0,2,2,3,4,7,-3,4,1,-1,1,0,1,0,1,0,4,7,3,-6,3,-2,0,-1,-1,-1,-1,1,5,-1
KR_6758249505,420,0,30,-4,4,3,0,3,0,1,1,0,2,2,1,0,1,0,0,0,0,-1,69,1,-5,4,0,0,0,1,-1,0,1,1,-1
KR_6759329461,420,0,-24,-22,-5,-1,2,1,-7,7,0,-2,4,2,2,0,2,3,0,3,0,-5,-4,1,-6,5,2,0,-1,-1,-1,-1,1,2,-1
KR_6759894790,420,-3,22,17,-11,1,1,2,-2,5,3,-2,3,1,-6,6,0,-2,3,1,0,-11,-5,-5,-4,9,-2,0,0,-1,-1,-1,-1,6,-1
KR_6760829307,420,6,44,7,12,4,2,6,4,2,6,6,1,7,-1,7,6,-1,1,0,0,6,47,1,-4,3,-21,0,2,-1,1,1,-1,1,-1
KR_6749109929,420,-3,-87,-35,1,1,3,4,-3,6,3,1,2,3,-3,5,2,5,0,5,0,11,-10,0,-6,6,4,0,-1,-1,1,-1,-1,3,-1
KR_6756022994,420,-4,-49,-6,-7,-1,3,2,-1,1,0,-5,6,1,-2,4,2,2,0,2,0,-6,15,1,-5,4,-7,0,-2,-1,-1,-1,-1,2,-1
KR_6638672340,420,0,-5,8,-4,1,2,3,1,3,4,-1,2,1,-5,5,0,0,0,0,0,-10,-6,-2,-5,7,5,0,0,-1,1,-1,1,3,-1
KR_6726869259,440,-2,-3,-18,-5,1,0,1,0,0,0,0,3,3,-4,7,3,-2,2,0,0,0,-12,-2,-5,7,3,0,-1,1,0,-1,-1,1,-1
KR_6723022226,420,-3,5,-20,-5,0,2,2,-4,5,1,2,1,3,-1,4,3,-2,2,0,0,-5,-42,-2,-5,7,4,0,-1,1,-1,-1,-1,6,-1
KR_6761586448,420,-2,-22,-2,-5,3,0,3,-2,5,3,-6,8,2,0,0,0,0,0,0,0,-7,-1,-4,-3,7,-2,0,0,0,-1,-1,-1,0,-1
KR_6729828476,420,-1,-53,-4,-2,-2,2,0,0,3,3,2,1,3,-2,2,0,0,0,0,0,2,27,-5,-9,14,-2,0,0,1,-1,0,-1,2,-1
KR_6768587203,420,-6,-106,-32,-11,0,2,2,-1,6,5,-4,4,0,-6,6,0,0,0,0,0,-5,-12,-6,-1,7,3,0,0,-1,-1,-1,1,4,-1
KR_6754999078,420,-1,60,-34,-3,-2,3,1,-6,8,2,-1,2,1,2,0,2,4,0,4,0,-3,-28,-2,-4,6,1,0,0,-1,-1,0,1,2,-1
KR_6755326751,420,-6,-62,-30,-16,-6,6,0,-4,5,1,-3,3,0,1,5,6,-4,4,0,-2,-19,-5,-5,-2,7,2,0,-3,-1,-1,-1,-1,1,-1
KR_6726213646,420,-2,-83,-16,-8,-4,8,4,2,1,3,0,1,1,-2,2,0,-4,4,0,0,-3,39,0,-3,3,-4,0,-4,1,-1,-1,-1,1,-1
KR_6764742458,420,-4,-31,-7,-16,-1,2,1,-4,6,2,-8,10,2,-2,4,2,-1,1,0,0,-12,3,-1,-5,6,2,0,-1,-1,-1,-1,-1,4,-1
KR_6761628523,420,2,-133,14,2,-1,1,0,5,2,7,1,1,2,-3,4,1,0,1,1,0,3,10,-4,-2,6,2,0,-1,-1,1,-1,-1,6,-1
KR_6766992518,420,-3,-10,-1,-7,-2,2,0,-2,6,4,-3,4,1,2,3,5,-2,4,2,1,-6,10,-4,-5,9,2,0,-2,1,-1,-1,1,5,-1
KR_6607777784,420,-5,-57,-27,-8,-2,2,0,0,3,3,-8,8,0,2,3,5,0,2,2,-1,-8,-26,1,-6,5,3,0,-2,-1,1,1,-1,4,-1
KR_6764107078,420,-4,-87,17,-17,-4,6,2,-8,8,0,-2,2,0,-3,4,1,0,0,0,0,-17,-6,-2,-4,6,-1,0,-4,0,-1,-1,1,0,-1
KR_6767585226,420,1,38,-23,-1,2,3,5,-6,9,3,-1,1,0,3,1,4,1,1,2,1,-2,-37,3,-6,3,-2,0,1,-1,1,1,1,2,-1
KR_6717113537,420,-5,-110,-16,-5,0,3,3,-5,6,1,0,3,3,1,0,1,-1,1,0,0,-14,4,3,-7,4,-4,0,-1,1,1,-1,-1,2,-1
KR_6768771751,420,-2,-40,-17,-9,2,1,3,-5,7,2,-3,5,2,-2,3,1,-1,2,1,1,-14,7,-3,-2,5,-7,0,-1,-1,-1,-1,1,2,-1
KR_6763693403,420,-2,-55,-11,0,0,2,2,-3,5,2,4,0,4,-1,2,1,0,1,1,0,-4,-64,1,-7,6,19,0,-1,-1,0,-1,-1,1,-1
KR_6707530521,420,-1,-20,-8,0,0,1,1,-1,4,3,-5,8,3,6,1,7,0,0,0,0,2,41,1,-5,4,-20,0,0,-1,1,1,-1,6,-1
KR_6759880460,440,1,-34,-2,3,1,3,4,6,2,8,1,0,1,-4,7,3,-1,1,0,0,0,-17,0,-4,4,-3,0,0,1,1,0,-1,6,-1
KR_6755839299,420,0,-23,-11,6,-1,1,0,3,2,5,3,1,4,3,5,8,-2,2,0,-1,5,12,6,-9,3,-1,0,0,1,-1,-1,1,1,-1
KR_6766147898,440,1,-19,15,0,-1,2,1,-1,4,3,-2,4,2,3,2,5,1,0,1,-1,0,-4,-2,-4,6,-2,0,0,1,-1,0,-1,1,-1
KR_6761970040,420,-2,-31,0,-4,0,0,0,-4,4,0,-1,2,1,1,4,5,0,1,1,0,-5,-3,-2,-3,5,-6,0,0,-1,-1,0,-1,5,-1
KR_6663249555,420,-2,-17,-28,0,4,0,4,-2,4,2,-2,5,3,0,5,5,0,1,1,2,-1,-8,-2,-6,8,2,0,-1,1,1,-1,1,2,-1
KR_6744542762,420,1,52,-1,-2,1,1,2,2,2,4,0,4,4,-3,5,2,-2,2,0,0,-10,2,1,-5,4,3,0,0,-1,-1,1,-1,3,-1
KR_6763152479,420,5,18,-43,2,1,2,3,2,2,4,3,1,4,-1,2,1,-3,4,1,0,1,-3,-2,-6,8,-4,0,3,-1,1,1,-1,6,-1
KR_6759261914,420,1,16,13,2,3,2,5,2,2,4,4,0,4,-5,9,4,-2,2,0,0,-5,3,2,-8,6,2,0,3,-1,1,1,-1,2,-1
KR_6708066668,420,-2,-10,-12,-2,-5,6,1,4,2,6,-1,2,1,1,1,2,-1,1,0,0,0,-2,2,-5,3,0,0,-1,-1,1,-1,-1,4,-1
KR_6768178553,420,-4,-52,-4,-7,-1,1,0,-2,8,6,-2,4,2,-1,4,3,-1,1,0,0,-14,17,5,-8,3,-14,0,-1,1,-1,-1,-1,4,-1
KR_6607586932,420,-3,-37,-40,-4,0,1,1,-2,5,3,0,4,4,-2,3,1,0,2,2,0,-2,0,2,-7,5,3,0,-1,1,1,-1,1,2,-1
KR_6643592291,420,-2,-15,26,-5,-1,1,0,-2,4,2,-2,4,2,-2,3,1,2,0,2,0,-4,-17,-2,-6,8,3,0,-1,1,-1,-1,-1,2,-1
KR_6759921055,440,1,-43,-11,1,-3,4,1,1,5,6,-1,2,1,3,3,6,1,2,3,2,3,4,0,-5,5,-4,0,0,1,1,1,1,2,-1
KR_6725350682,420,-1,23,-12,-7,-4,6,2,-3,6,3,2,0,2,-2,4,2,0,1,1,0,-9,78,3,-7,4,7,0,-1,0,-1,1,-1,0,-1
KR_6748402902,420,-3,-16,20,-10,-1,1,0,-2,3,1,-4,5,1,-3,4,1,0,0,0,0,-15,-5,-3,-4,7,2,0,0,1,-1,0,-1,2,-1
KR_6768555388,440,-5,-46,-9,-7,-1,3,2,-6,6,0,4,2,6,-2,4,2,-2,3,1,0,-8,-8,1,-9,8,3,0,0,-1,1,0,-1,1,-1
KR_6707202175,440,-4,-47,-16,-9,-1,2,1,-1,6,5,-4,6,2,-4,4,0,1,1,2,0,-9,-2,-1,-6,7,-3,0,0,-1,1,0,-1,3,-1
KR_6764879005,420,3,40,7,4,0,2,2,0,1,1,1,0,1,2,8,10,1,0,1,0,4,-4,1,-3,2,1,0,-2,1,-1,-1,-1,3,-1
KR_6767395913,420,-1,21,-9,1,3,1,4,-2,3,1,-2,6,4,1,1,2,1,0,1,0,3,-32,6,-7,1,-1,0,0,-1,-1,1,-1,6,-1
KR_6732444061,420,-4,-23,-8,-13,-1,2,1,-7,7,0,-4,7,3,-1,1,0,0,0,0,-2,-12,-38,0,-5,5,-4,0,0,-1,-1,-1,-1,5,-1
KR_6654476198,420,1,10,28,2,1,1,2,-3,3,0,3,1,4,0,2,2,1,1,2,0,-2,-7,-3,-3,6,5,0,0,1,1,0,1,6,-1
KR_6764907385,420,2,-16,-17,4,-2,3,1,3,1,4,3,0,3,1,2,3,-1,2,1,0,3,-3,-2,-4,6,3,0,-2,1,-1,-1,1,2,-1
KR_6742540341,420,-2,-39,-40,-6,-2,2,0,-3,4,1,2,2,4,-4,5,1,1,0,1,0,-5,-18,2,-8,6,1,0,-1,-1,-1,-1,-1,3,-1
KR_6764105028,420,2,68,-8,4,-4,4,0,4,2,6,-3,4,1,5,1,6,2,0,2,0,11,18,-1,-4,5,1,0,0,1,1,1,-1,1,-1
KR_6759962370,420,-1,-60,4,-8,-1,1,0,-2,3,1,4,0,4,-6,6,0,-3,4,1,0,-10,0,3,-8,5,-6,0,0,-1,1,1,-1,3,-1
KR_6767430240,440,0,-1,24,-2,-5,5,0,2,1,3,0,1,1,1,7,8,0,0,0,3,5,6,-1,-5,6,3,0,-1,1,0,-1,1,1,-1
KR_6552200282,420,-1,-31,-4,0,-2,3,1,3,0,3,-3,3,0,4,0,4,-2,2,0,-1,4,-8,-4,-6,10,0,0,0,-1,1,0,-1,3,-1
KR_6761106709,420,-2,-37,-11,1,0,3,3,3,1,4,-2,3,1,-5,7,2,5,0,5,1,0,10,0,-5,5,5,0,0,1,1,-1,1,3,-1
KR_6768877796,420,-2,-13,10,-4,2,3,5,-10,13,3,-1,3,2,5,1,6,0,1,1,2,5,12,-3,-4,7,-7,0,0,1,-1,1,1,2,-1
KR_6693813963,420,2,-20,16,4,2,1,3,-1,3,2,5,1,6,-2,5,3,0,1,1,0,-4,-7,-4,-4,8,3,0,-1,1,-1,-1,1,3,-1
KR_6765469278,420,5,11,9,7,-1,2,1,1,1,2,3,3,6,2,4,6,2,0,2,-1,11,6,2,-7,5,0,0,-1,1,-1,-1,-1,5,-1
KR_6755228497,420,0,-6,20,-4,0,0,0,0,1,1,-2,3,1,-2,4,2,0,0,0,0,-1,7,1,-5,4,-4,0,0,-1,1,0,-1,2,-1
KR_6754352001,420,-4,-68,-13,-8,-2,5,3,-5,6,1,0,3,3,1,0,1,-2,2,0,0,-15,12,-1,-3,4,-3,0,-3,-1,-1,-1,1,3,-1
KR_6667205138,420,-6,-69,-7,-8,1,1,2,-2,5,3,0,3,3,-7,7,0,0,1,1,0,-13,-26,-1,-7,8,-3,0,-1,-1,1,-1,-1,4,-1
KR_6624853483,420,-5,7,-12,-3,0,1,1,-7,7,0,-1,3,2,1,2,3,4,0,4,1,-1,70,0,-4,4,3,0,-1,-1,-1,-1,1,3,-1
KR_6751139606,440,4,56,27,4,-1,2,1,0,7,7,3,2,5,2,7,9,0,3,3,0,-7,0,-4,-2,6,0,0,1,0,0,1,-1,0,-1
KR_6755141289,420,-1,16,23,-9,0,5,5,-3,4,1,-1,2,1,-4,7,3,-1,1,0,-1,-2,8,8,-14,6,-4,0,-1,1,1,-1,1,3,-1
KR_6619757897,420,-1,37,-11,-6,0,0,0,-3,6,3,-3,5,2,0,2,2,0,2,2,0,-12,-4,-5,-6,11,3,0,0,-1,-1,0,-1,4,-1
KR_6768314604,420,-1,-8,-13,-4,4,2,6,0,3,3,-5,7,2,-4,4,0,1,0,1,-1,-9,-5,-8,-3,11,-4,0,0,-1,-1,-1,-1,4,-1
KR_6761710295,420,-4,-19,-44,-6,0,1,1,0,2,2,-2,4,2,-4,5,1,0,2,2,0,-10,18,1,-7,6,2,0,-2,1,-1,-1,1,3,-1
KR_6720603138,420,-3,-7,2,-4,0,2,2,0,2,2,-2,3,1,-2,4,2,0,2,2,0,-11,137,-3,-2,5,2,0,-1,-1,-1,-1,-1,1,-1
KR_6761375875,420,-2,11,-4,-2,0,3,3,-1,2,1,-1,1,0,1,1,2,-1,2,1,0,-5,1,-1,-5,6,-3,0,-1,1,-1,-1,1,2,-1
KR_6753462293,420,-1,-62,-16,-9,-2,4,2,-8,10,2,1,2,3,1,0,1,-1,1,0,0,-7,38,7,-9,2,-6,0,-1,0,-1,-1,-1,0,-1
KR_6749112145,420,1,-2,12,-7,1,2,3,-2,4,2,-4,5,1,-1,3,2,-1,1,0,0,-7,-52,2,-7,5,17,0,1,1,-1,1,-1,2,-1
KR_6629299557,420,-4,-42,-24,-5,-2,3,1,-2,4,2,-2,2,0,2,2,4,-1,1,0,0,3,-133,-3,-10,13,0,0,-1,-1,-1,-1,-1,3,-1
KR_6743828004,420,-1,-12,8,-4,0,1,1,-6,6,0,-3,5,2,3,3,6,2,0,2,-1,2,-2,-1,-7,8,2,0,-1,1,-1,1,-1,4,-1
KR_6725090872,440,0,48,-20,1,0,1,1,-6,6,0,2,2,4,3,0,3,2,1,3,0,0,11,3,-6,3,3,0,1,0,-1,1,1,0,-1
KR_6740754449,420,-1,24,-12,1,-1,1,0,2,2,4,-1,1,0,0,3,3,1,2,3,0,5,-20,-4,-6,10,8,0,1,-1,1,1,1,5,-1
KR_6729912260,420,0,-59,-31,4,0,2,2,3,3,6,2,3,5,-1,3,2,0,0,0,-3,-2,46,6,-11,5,-5,0,0,-1,1,0,-1,1,-1
KR_6757674233,420,-2,-61,5,-7,-1,4,3,-1,2,1,3,0,3,-6,6,0,-2,2,0,0,-10,-7,-4,-2,6,-1,0,-1,-1,-1,-1,-1,4,-1
KR_6714781400,420,-1,14,-50,-6,1,1,2,-1,4,3,2,0,2,-7,7,0,-1,2,1,0,-4,8,0,-4,4,-1,0,1,-1,1,1,-1,5,-1
KR_6768975102,420,-1,-16,-1,-3,-1,1,0,-4,4,0,0,2,2,3,0,3,-1,3,2,0,-2,-3,-4,-2,6,1,0,0,-1,-1,-1,-1,2,-1
KR_6768740947,440,4,17,3,6,3,0,3,0,3,3,-3,3,0,2,2,4,4,2,6,0,6,6,7,-12,5,-2,0,0,1,-1,0,1,4,-1
KR_6759445712,420,-2,45,-48,0,1,0,1,2,1,3,-1,2,1,4,2,6,-6,6,0,1,-2,9,3,-8,5,-5,0,0,0,-1,0,1,0,-1
KR_6762836420,420,-2,-47,28,-2,0,3,3,-3,3,0,0,2,2,-3,3,0,4,0,4,1,-2,4,0,-6,6,4,0,1,-1,1,1,1,2,-1
KR_6699131400,420,-2,-30,2,-6,-5,5,0,-2,3,1,3,4,7,-3,4,1,1,1,2,0,-4,3,-6,-2,8,1,0,-1,0,-1,-1,-1,0,-1
KR_6508559934,420,-3,24,-16,-8,0,1,1,-1,2,1,-6,7,1,-1,1,0,0,0,0,0,-4,-8,-1,-7,8,3,0,-1,-1,-1,-1,-1,5,-1
KR_6686800548,420,0,42,-12,4,4,0,4,2,1,3,-2,4,2,-1,1,0,1,0,1,0,4,9,0,-5,5,4,0,1,-1,-1,1,-1,6,-1
KR_6764231798,420,1,-25,12,-5,-7,7,0,3,2,5,0,5,5,1,4,5,-2,2,0,0,4,-1,-7,-3,10,-1,0,-2,1,-1,-1,1,4,-1
KR_6716068693,420,2,37,8,-4,-2,2,0,-1,3,2,-2,2,0,1,1,2,0,1,1,0,-12,-35,-1,-6,7,2,0,0,-1,-1,0,1,5,-1
KR_6757896396,420,0,21,-20,2,-3,6,3,0,0,0,-1,1,0,4,2,6,2,0,2,0,11,-9,0,-5,5,4,0,-1,-1,-1,-1,-1,1,-1
KR_6768732251,420,4,112,0,4,-3,4,1,2,2,4,-2,3,1,7,3,10,0,1,1,0,-5,25,1,-10,9,-6,0,1,1,-1,1,-1,3,-1
KR_6756912631,420,-1,4,16,-4,3,1,4,1,5,6,-4,5,1,-4,6,2,0,1,1,0,-10,-215,3,-6,3,-3,0,1,-1,1,1,-1,4,-1
KR_6761747898,440,1,-36,10,1,6,1,7,-2,5,3,1,3,4,-1,2,1,-3,4,1,1,2,21,3,-5,2,0,0,-1,-1,-1,-1,1,1,-1
KR_6769196855,420,0,3,4,-1,0,1,1,0,3,3,-1,2,1,0,2,2,0,0,0,0,-2,-32,-1,-6,7,-1,0,0,1,-1,1,1,2,-1
KR_6687683996,420,6,88,-4,-1,1,0,1,-1,2,1,-2,2,0,2,0,2,-1,1,0,0,0,-27,0,-3,3,2,0,2,1,-1,1,1,1,-1
KR_6742219045,420,-1,30,12,-2,-2,2,0,-5,6,1,3,3,6,3,1,4,-1,3,2,0,0,-11,0,-8,8,3,0,1,1,1,1,1,1,-1
KR_6747899580,420,-5,-67,-35,-15,-3,4,1,-4,6,2,0,1,1,-7,10,3,-1,2,1,-1,-14,4,4,-9,5,1,0,-2,-1,1,-1,-1,5,-1
KR_6768050000,420,-4,-68,-10,-12,-3,3,0,-3,5,2,-3,6,3,-3,3,0,0,0,0,0,-11,41,1,-9,8,-9,0,-1,-1,-1,-1,-1,1,-1
KR_6681320544,420,-5,-33,-51,-14,-1,1,0,-7,7,0,-1,2,1,-8,11,3,3,1,4,-1,-15,7,-5,-3,8,1,0,-1,-1,-1,-1,-1,6,-1
KR_6758809197,420,-4,-41,-10,-7,-5,5,0,0,2,2,-3,5,2,2,0,2,-1,3,2,0,2,24,-2,-6,8,-1,0,-1,1,-1,-1,-1,6,-1
KR_6757702177,420,-1,-21,-1,-5,1,0,1,-5,8,3,0,4,4,0,4,4,-1,1,0,0,-8,-30,-3,-3,6,2,0,0,1,1,-1,-1,1,-1
KR_6755435048,420,-1,-92,6,-2,-6,8,2,3,2,5,3,1,4,-3,4,1,1,0,1,-1,6,-2,-2,-4,6,-3,0,-2,-1,1,-1,-1,5,-1
KR_6751630525,420,3,-27,1,5,1,1,2,2,2,4,0,3,3,-1,2,1,3,0,3,0,2,-34,-1,-4,5,2,0,1,1,-1,1,-1,5,-1
KR_6760791132,420,-2,-27,-1,0,1,1,2,1,1,2,-2,2,0,3,1,4,-3,3,0,0,0,24,0,-6,6,0,0,0,-1,-1,0,1,6,-1
KR_6756370941,420,1,-19,-5,-2,0,2,2,0,4,4,1,0,1,-2,9,7,-1,3,2,0,2,-2,-1,-4,5,-8,0,0,1,-1,-1,1,2,-1
KR_6767682451,420,-2,3,-9,0,1,2,3,2,1,3,-2,5,3,1,4,5,-2,2,0,0,-4,48,1,-7,6,-18,0,3,1,1,1,1,3,-1
KR_6768130248,420,-5,-21,-32,-9,0,3,3,-3,4,1,-3,3,0,-2,4,2,-1,1,0,0,-8,-51,-1,-4,5,31,0,-1,-1,1,-1,1,2,-1
KR_6741766666,440,-6,-40,-10,-5,5,0,5,-2,3,1,-2,2,0,-5,6,1,-1,1,0,0,7,-6,1,-7,6,-2,0,-1,-1,-1,-1,1,5,-1
KR_6689887181,420,1,-24,-16,-6,0,3,3,3,1,4,-2,5,3,-7,9,2,0,2,2,0,-7,1,-6,-2,8,-1,0,-1,-1,1,-1,1,3,-1
KR_6758350654,420,0,-52,-14,-1,2,0,2,1,1,2,-2,2,0,-2,2,0,0,0,0,0,-4,41,4,-8,4,-15,0,-1,1,-1,-1,1,5,-1
KR_6756951763,420,-3,-51,-12,-2,-4,4,0,-5,6,1,1,5,6,1,2,3,5,1,6,1,9,4,0,-5,5,-3,0,-1,1,-1,-1,1,4,-1
KR_6757907061,440,0,-43,32,-5,1,1,2,-1,5,4,2,1,3,-8,9,1,1,0,1,0,-11,-5,2,-5,3,-1,0,-1,-1,1,-1,-1,3,-1
KR_6766300556,420,-2,31,-47,-1,6,0,6,-2,2,0,-1,4,3,-4,4,0,0,0,0,0,-9,5,1,-6,5,0,0,0,-1,-1,-1,1,5,-1
KR_6759172091,420,-4,-85,1,-4,0,1,1,-4,4,0,-7,7,0,6,0,6,1,1,2,-1,-2,1,2,-7,5,-5,0,-1,0,-1,-1,-1,0,-1
KR_6766230635,420,-6,-100,-49,-12,1,2,3,-3,3,0,-1,1,0,-9,9,0,0,1,1,0,-14,-7,-6,-3,9,0,0,0,-1,-1,-1,-1,4,-1
KR_6763966844,420,-1,-16,-8,2,-5,5,0,7,1,8,1,1,2,-1,3,2,0,1,1,0,8,-3,5,-8,3,2,0,-1,-1,-1,-1,-1,4,-1
KR_6713132488,420,-4,-66,-47,-12,1,3,4,-1,2,1,-9,11,2,-2,4,2,-1,3,2,1,-10,-36,-8,-2,10,4,0,-3,-1,-1,-1,-1,5,-1
KR_6688888114,420,-5,-80,8,-8,-4,5,1,-2,4,2,0,2,2,0,0,0,-2,2,0,-1,-6,-1,0,-3,3,-5,0,-1,-1,1,-1,-1,1,-1
KR_6737038751,440,-3,37,-20,-5,-1,2,1,-1,6,5,-1,3,2,-2,5,3,0,1,1,0,-1,-54,-6,-2,8,28,0,-1,-1,-1,-1,-1,2,-1
KR_6762014033,420,-4,-72,3,-10,-8,9,1,0,2,2,-1,3,2,-7,8,1,6,1,7,0,-11,0,-7,-3,10,-2,0,-1,1,1,-1,-1,2,-1
KR_6766982190,420,-4,-43,-8,-1,-1,3,2,3,1,4,1,1,2,-2,3,1,-2,2,0,0,-1,23,5,-8,3,-4,0,0,-1,1,0,-1,2,-1
KR_6575917563,420,-2,-39,1,-5,2,0,2,-3,4,1,-5,7,2,1,2,3,0,1,1,0,-2,16,0,-5,5,-8,0,0,-1,-1,-1,-1,1,-1
KR_6759918246,420,2,7,-24,5,6,0,6,7,1,8,-5,7,2,-3,4,1,0,2,2,0,7,311,0,-3,3,2,0,0,1,1,1,1,5,-1
KR_6763746132,420,-2,-20,12,-1,-2,3,1,0,2,2,2,1,3,-2,3,1,1,0,1,0,1,29,1,-4,3,0,0,-1,-1,-1,-1,1,4,-1
KR_6758195897,440,-2,-71,-20,1,3,3,6,3,3,6,0,1,1,-2,5,3,-3,3,0,1,8,4,-5,-5,10,-7,0,-1,1,-1,-1,1,4,-1
KR_6763092161,420,-4,-35,4,-11,-5,5,0,-2,4,2,-2,4,2,-1,2,1,-1,1,0,0,-4,-1,0,-6,6,2,0,-1,-1,-1,-1,-1,3,-1
KR_6764487575,440,-4,-18,19,-10,0,1,1,0,1,1,0,0,0,0,4,4,-10,10,0,0,-3,-8,-3,-5,8,-1,0,0,1,0,0,1,3,-1
KR_6744294471,420,0,23,-17,-2,0,1,1,1,4,5,2,0,2,-4,6,2,-1,4,3,0,9,12,0,-4,4,-4,0,0,-1,1,0,-1,5,-1
KR_6755078343,420,-5,-19,0,-18,-7,8,1,-2,3,1,-1,2,1,-7,7,0,-1,1,0,0,-18,-14,-6,0,6,4,0,-1,-1,-1,-1,-1,5,-1
KR_6766803607,420,3,44,0,3,-2,2,0,1,0,1,0,2,2,4,1,5,0,1,1,0,3,13,5,-9,4,-4,0,0,1,1,0,-1,1,-1
KR_6747599005,420,-3,-26,25,-5,0,1,1,-6,12,6,0,0,0,3,4,7,-2,2,0,-1,-3,-16,2,-9,7,-1,0,0,1,-1,0,-1,5,-1
KR_6768884817,420,-3,-27,-4,-11,-2,2,0,-6,6,0,1,1,2,-4,5,1,0,2,2,0,-11,22,5,-9,4,-3,0,-1,-1,-1,-1,-1,1,-1
KR_6748348540,440,2,16,-16,10,4,0,4,1,4,5,1,3,4,0,1,1,4,2,6,1,6,13,4,-7,3,-5,0,0,0,1,0,1,0,-1
KR_6762826588,420,-4,-65,1,-2,-2,2,0,-4,8,4,5,2,7,-1,2,1,0,0,0,0,-12,-36,3,-7,4,-4,0,-2,-1,1,-1,1,6,-1
KR_6758342296,420,0,-37,-8,1,1,2,3,0,2,2,-3,4,1,3,2,5,0,1,1,0,7,2,4,-8,4,4,0,-1,-1,1,-1,-1,4,-1
KR_6711708438,420,-1,-52,13,-4,-4,5,1,1,3,4,2,1,3,-3,5,2,0,2,2,-1,-2,188,-1,-5,6,0,0,-1,1,-1,-1,-1,6,-1
KR_6745222410,420,0,18,-12,2,3,1,4,4,2,6,0,0,0,-3,7,4,-2,2,0,0,7,-156,3,-7,4,2,0,0,-1,1,1,-1,3,-1
KR_6765689170,420,-7,-61,-15,-15,-7,8,1,-6,7,1,-3,3,0,1,3,4,0,2,2,-1,-13,0,-1,-5,6,1,-1,-6,-1,-1,-1,-1,2,-1
KR_6763707612,420,-4,-5,32,-9,-3,6,3,-4,5,1,1,2,3,-2,7,5,-1,1,0,1,-7,-16,-6,-4,10,6,0,-1,1,-1,-1,1,3,-1
KR_6760381507,420,-4,-32,-5,-5,1,1,2,-2,5,3,3,3,6,-5,5,0,-2,2,0,0,-15,10,3,-10,7,-4,0,-1,1,-1,-1,1,4,-1
KR_6760340238,420,-2,-53,-17,-6,-1,2,1,0,4,4,-2,3,1,-1,2,1,-2,2,0,0,-8,-3,3,-9,6,-4,0,0,-1,-1,-1,-1,6,-1
KR_6732505976,420,-3,-18,-18,-3,-4,5,1,0,0,0,-1,2,1,1,3,4,1,0,1,0,2,9,3,-6,3,-7,0,-1,-1,-1,-1,-1,5,-1
KR_6768274358,420,-4,-39,-4,-16,-4,4,0,-4,5,1,-2,2,0,-2,3,1,-4,4,0,0,-10,-7,-7,-2,9,2,0,-1,-1,-1,-1,-1,1,-1
KR_6761626187,440,-1,-2,-8,6,-1,3,2,2,2,4,3,3,6,0,1,1,2,1,3,1,5,-6,2,-9,7,3,0,0,1,1,0,1,4,-1
KR_6761325585,420,-2,-30,9,-7,-1,2,1,1,1,2,-3,3,0,-5,6,1,1,2,3,0,-10,0,-2,-4,6,-4,0,0,1,-1,-1,-1,6,-1
KR_6763605522,420,-5,-16,-1,-11,-4,5,1,-2,3,1,-1,2,1,-3,5,2,-1,2,1,0,-17,247,-4,-1,5,0,0,-2,0,-1,-1,-1,0,-1
KR_6767669240,420,-2,-32,21,-9,0,3,3,-3,4,1,-3,5,2,-2,3,1,-1,2,1,0,-16,-24,-5,-1,6,3,0,0,-1,0,-1,1,3,-1
KR_6768859273,420,-5,-32,-25,-7,-1,2,1,-1,2,1,-2,3,1,-4,4,0,1,0,1,0,-8,-8,-1,-4,5,6,0,0,-1,1,0,1,4,-1
KR_6765422163,420,-1,-6,-13,-4,1,0,1,-2,4,2,0,1,1,-4,5,1,1,0,1,0,-9,10,-2,-6,8,6,0,-1,-1,-1,-1,-1,4,-1
KR_6645552104,420,-2,44,-10,-16,-2,3,1,-2,2,0,-1,4,3,-8,8,0,-3,4,1,-1,-28,-1,-2,-7,9,-1,0,-1,-1,-1,-1,-1,3,-1
KR_6763221677,420,0,5,41,-1,4,2,6,0,1,1,1,1,2,2,0,2,-8,8,0,0,5,-26,-4,-2,6,0,0,0,1,-1,-1,-1,5,-1
KR_6502771507,440,-3,-20,-18,-16,-6,7,1,-4,4,0,-3,3,0,-3,3,0,0,0,0,0,-22,-3,-4,-4,8,1,0,-2,-1,-1,-1,-1,2,-1
KR_6765905016,420,0,-11,-13,-4,0,3,3,0,1,1,-2,2,0,1,1,2,-3,3,0,-1,-4,113,0,-5,5,-1,0,0,-1,1,0,-1,4,-1
KR_6718587156,440,0,-30,-16,0,-3,4,1,-2,2,0,-1,5,4,7,2,9,-1,1,0,0,5,7,3,-4,1,1,0,0,1,-1,0,-1,6,-1
KR_6768818355,420,-2,-38,10,-5,-2,3,1,0,7,7,-3,4,1,0,2,2,0,0,0,0,-14,147,-1,-3,4,-7,0,-1,1,-1,-1,-1,5,-1
KR_6767331188,420,-6,-109,11,-10,0,4,4,-3,4,1,-1,2,1,-5,6,1,-1,1,0,0,-6,-3,-4,-5,9,-2,0,-2,-1,-1,-1,-1,3,-1
KR_6768436101,420,-3,-67,-5,-8,-2,2,0,-7,7,0,-2,2,0,1,3,4,2,0,2,-1,-9,-3,-5,-2,7,1,0,-1,-1,-1,-1,-1,1,-1
KR_6753787999,420,0,-23,13,2,5,0,5,-1,3,2,-1,2,1,0,1,1,-1,1,0,0,-6,268,2,-6,4,-1,0,0,1,1,1,-1,5,-1
KR_6763200061,420,-4,-55,-13,-5,-4,6,2,-2,3,1,-2,3,1,3,2,5,0,1,1,-1,0,-188,0,-5,5,3,0,1,-1,-1,-1,-1,6,-1
KR_6754642602,420,-2,-26,54,-15,-5,5,0,2,2,4,-2,4,2,-6,9,3,-4,6,2,0,-23,-3,-5,-4,9,-2,0,1,1,1,1,-1,5,-1
KR_6765907771,420,-4,-82,-13,-5,3,0,3,-3,5,2,0,7,7,-7,7,0,2,3,5,0,-13,13,8,-11,3,-4,0,-1,1,1,-1,-1,5,-1
KR_6722962100,420,-4,-40,6,-7,1,1,2,-2,5,3,-1,3,2,-5,7,2,0,0,0,0,-4,-8,0,-6,6,-3,0,-1,-1,1,-1,1,5,-1
KR_6761984266,420,0,-47,26,0,0,2,2,6,3,9,-4,5,1,-2,4,2,0,2,2,0,2,16,-3,-4,7,2,0,-2,1,-1,-1,-1,6,-1
KR_6768274970,420,-1,-39,-1,-2,0,2,2,0,3,3,-4,4,0,0,3,3,2,0,2,0,-2,-1,-4,-5,9,-3,0,-1,1,1,-1,-1,3,-1
KR_6741063011,420,-2,39,-20,-1,-1,1,0,-3,3,0,-2,4,2,7,1,8,-2,2,0,2,2,5,2,-9,7,-2,0,0,-1,0,1,1,5,-1
KR_6736324289,420,-1,18,24,-7,-3,5,2,0,3,3,0,2,2,-3,5,2,-1,2,1,0,-5,-18,3,-5,2,0,0,0,-1,1,-1,-1,2,-1
KR_6728988179,420,0,10,-5,3,2,0,2,4,2,6,-2,5,3,0,2,2,-1,5,4,-1,13,0,-1,-3,4,0,0,0,1,-1,0,-1,6,-1
KR_6765857018,440,-1,-11,-58,-4,-6,7,1,-1,1,0,-2,3,1,2,1,3,3,0,3,0,-1,10,1,-5,4,0,0,-1,-1,-1,-1,-1,4,-1
KR_6754623123,420,1,71,20,0,0,1,1,2,2,4,0,3,3,0,4,4,-2,4,2,0,-3,-133,-6,-5,11,1,0,0,-1,1,0,-1,4,-1
KR_6766776887,420,1,97,-1,7,0,2,2,-2,5,3,1,0,1,4,1,5,4,0,4,1,7,-10,4,-8,4,6,0,2,1,-1,1,1,3,-1
KR_6765738588,440,1,4,4,7,0,2,2,6,0,6,-2,2,0,0,2,2,3,0,3,0,12,140,-5,-1,6,0,0,1,-1,1,1,1,3,-1
KR_6652930299,420,-4,-124,-8,-6,-4,4,0,0,3,3,-1,4,3,-1,4,3,0,1,1,-1,-4,-46,-3,-4,7,18,0,-2,-1,-1,-1,-1,1,-1
KR_6662311922,420,0,-10,9,0,1,3,4,0,1,1,-1,3,2,-2,5,3,2,0,2,0,0,-1,0,-4,4,4,0,0,1,1,1,-1,3,-1
KR_6737495722,420,0,-88,21,4,0,0,0,-3,5,2,5,0,5,1,1,2,1,0,1,-1,-2,-17,0,-6,6,1,0,-1,-1,1,-1,-1,2,-1
KR_6763641901,420,-2,-45,-41,-3,-2,5,3,-1,2,1,-2,2,0,1,3,4,1,3,4,0,-8,-4,-2,-5,7,-3,0,-2,1,-1,-1,1,6,-1
KR_6737201039,420,-3,-34,-13,-9,1,1,2,-5,6,1,-4,6,2,-1,1,0,0,1,1,0,-11,96,1,-9,8,1,0,-1,-1,0,-1,-1,2,-1
KR_6733902165,420,-9,-108,-18,-26,0,0,0,-5,6,1,-5,9,4,-7,10,3,-9,9,0,-2,-28,327,-4,-5,9,-6,0,-1,-1,-1,-1,-1,2,-1
KR_6759854456,420,-3,-47,-3,-12,-1,1,0,-4,4,0,1,3,4,-3,4,1,-5,5,0,-1,-21,-30,-2,-4,6,-4,0,-3,1,-1,-1,-1,3,-1
KR_6756118268,420,-1,13,-31,0,0,4,4,0,3,3,-1,2,1,1,3,4,0,2,2,0,4,-321,5,-7,2,-2,0,1,1,-1,-1,1,3,-1
KR_6718556428,420,-6,-52,-20,-13,-5,7,2,-5,7,2,2,4,6,-4,6,2,-1,4,3,1,-2,0,-1,-3,4,-1,0,-1,-1,-1,-1,1,2,-1
KR_6679239416,420,1,19,11,-3,3,0,3,-4,7,3,0,1,1,-5,6,1,3,1,4,0,-11,4,-2,-7,9,-3,0,1,1,-1,1,-1,3,-1
KR_6759990770,420,-2,-23,-35,-10,1,1,2,-1,1,0,-4,4,0,-7,7,0,1,0,1,0,-13,8,-6,-1,7,-4,0,-1,-1,-1,-1,-1,2,-1
KR_6759578638,420,-6,-59,-19,-16,-2,2,0,-1,3,2,-1,3,2,-8,8,0,-4,6,2,0,-11,-11,-3,-4,7,3,0,-3,-1,-1,-1,-1,3,-1
KR_6758359688,420,-1,-19,-16,-1,-1,3,2,3,3,6,1,2,3,-1,5,4,-3,3,0,-1,1,-10,3,-5,2,1,0,-1,-1,0,-1,-1,5,-1
KR_6606297787,420,-7,-32,-35,-17,-8,8,0,-4,5,1,-4,4,0,-2,3,1,1,0,1,0,-12,-39,-3,-5,8,1,0,-2,-1,1,-1,-1,2,-1
KR_6761690556,420,2,-21,7,7,0,1,1,4,1,5,0,3,3,0,0,0,3,0,3,0,12,4,-2,-5,7,5,0,-2,1,-1,-1,-1,1,-1
KR_6767341862,420,-1,21,-20,1,-2,2,0,1,1,2,-4,6,2,1,2,3,5,2,7,2,8,-27,-4,-3,7,0,0,0,1,-1,0,1,5,-1
KR_6759399031,420,-7,-91,-25,-15,-1,4,3,-7,8,1,0,3,3,-3,6,3,-4,4,0,0,-7,-20,2,-6,4,-3,0,-3,-1,-1,-1,-1,4,-1
KR_6692262153,440,-2,5,-28,-4,-1,4,3,-2,2,0,0,1,1,-1,4,3,0,0,0,0,-4,4,0,-4,4,-1,0,-1,0,1,-1,1,0,-1
KR_6660473823,420,-3,-3,-29,-7,0,2,2,-3,3,0,-2,5,3,0,2,2,-2,2,0,0,-7,7,-3,-6,9,2,0,0,-1,-1,0,-1,4,-1
KR_6754323191,420,-1,-21,-12,-2,2,2,4,0,2,2,-2,3,1,-2,7,5,0,1,1,0,0,-1,-2,-6,8,4,0,1,-1,1,1,-1,2,-1
KR_6764950030,420,-4,-29,-23,-15,-1,4,3,-3,4,1,-6,6,0,-3,6,3,-2,3,1,-1,-10,-2,0,-4,4,-2,0,-2,-1,1,-1,-1,6,-1
KR_6730933101,420,1,35,3,1,0,0,0,-2,4,2,1,1,2,1,1,2,1,2,3,0,5,51,-1,-7,8,-2,0,1,1,-1,1,-1,2,-1
KR_6746380463,420,0,31,17,0,0,0,0,1,1,2,-2,2,0,3,0,3,-2,2,0,0,-4,-118,-1,-4,5,-3,0,-1,-1,-1,-1,1,4,-1
KR_6689060072,420,-3,-41,-12,-2,4,1,5,-2,3,1,-2,3,1,-2,2,0,0,0,0,-1,-7,54,3,-3,0,-20,0,-1,-1,-1,-1,-1,4,-1
KR_6749547825,420,0,49,-16,-5,-3,7,4,-5,5,0,-2,3,1,4,0,4,1,0,1,0,-4,4,2,-6,4,-6,0,0,-1,-1,0,1,3,-1
KR_6599972628,420,-1,26,-3,-5,-1,5,4,2,1,3,-5,6,1,2,4,6,-3,4,1,0,-4,12,0,-6,6,-2,0,1,-1,-1,1,-1,3,-1
KR_6604642522,420,0,-4,15,3,2,2,4,1,3,4,0,1,1,-1,4,3,1,0,1,0,3,-5,1,-6,5,4,0,-2,1,-1,-1,1,6,-1
KR_6763897226,420,1,-33,6,0,-4,5,1,3,0,3,2,1,3,-1,1,0,0,3,3,0,3,-50,1,-4,3,0,0,-1,1,-1,-1,-1,5,-1
KR_6768706276,420,-3,-10,4,-9,-1,2,1,1,0,1,-1,2,1,-6,6,0,-2,2,0,-1,-17,8,6,-10,4,-3,0,-1,-1,-1,-1,-1,2,-1
KR_6756527732,420,1,4,-15,4,1,1,2,3,1,4,0,1,1,3,0,3,-3,3,0,0,2,2,-1,-6,7,5,0,0,-1,1,0,-1,6,-1
KR_6765068027,420,-6,-73,8,-8,2,2,4,-2,3,1,-2,2,0,-2,2,0,-4,4,0,0,-13,-43,0,-8,8,17,0,-1,-1,-1,-1,-1,1,-1
KR_6768734460,420,0,-65,-4,-5,1,1,2,-3,7,4,0,1,1,-3,7,4,0,1,1,0,-12,-4,-2,-2,4,3,0,2,-1,1,1,1,2,-1
KR_6737004558,420,-1,-79,59,-7,-4,5,1,-1,3,2,-2,3,1,-4,5,1,4,0,4,-1,-14,-2,4,-6,2,-2,0,0,-1,1,-1,-1,2,-1
KR_6678817051,420,0,18,7,4,0,2,2,5,3,8,0,3,3,-2,5,3,1,0,1,1,6,-264,0,-11,11,2,0,0,-1,-1,-1,1,4,-1
KR_6768503494,420,-1,49,-3,-7,2,1,3,-3,4,1,-3,3,0,-1,2,1,-2,2,0,0,-14,7,-4,-1,5,-3,0,1,-1,1,1,1,5,-1
KR_6756897013,420,-3,10,19,-7,-3,3,0,1,1,2,-4,4,0,0,0,0,-1,1,0,0,-7,21,-7,-4,11,-1,0,0,-1,-1,0,-1,4,-1
KR_6721340539,440,0,5,-13,0,-2,3,1,2,2,4,1,1,2,-2,4,2,1,0,1,0,-5,-15,1,-7,6,-4,0,1,0,0,1,-1,0,-1
KR_6766034530,420,-4,-49,12,-4,1,0,1,-3,3,0,-3,4,1,1,4,5,0,1,1,0,-2,-20,1,-5,4,-2,0,0,-1,1,0,-1,2,-1
KR_6721293935,440,1,30,18,3,2,1,3,3,1,4,2,2,4,-2,4,2,-2,3,1,0,1,-3,-3,-2,5,7,0,0,1,1,0,1,3,-1
KR_6750374148,420,2,32,-5,1,-1,2,1,-1,1,0,2,0,2,1,0,1,0,0,0,0,0,7,2,-5,3,4,0,0,1,1,0,1,2,-1
KR_6749207902,420,2,65,-12,12,5,0,5,3,0,3,0,1,1,1,3,4,3,0,3,1,9,13,3,-4,1,-2,0,1,1,1,1,1,3,-1
KR_6745067392,420,-3,-27,-7,-11,1,0,1,-3,3,0,-1,1,0,-3,4,1,-5,5,0,0,-19,-28,-6,-1,7,3,0,-1,-1,1,-1,-1,1,-1
KR_6713421002,420,-1,-15,-40,4,2,1,3,1,4,5,3,2,5,-2,3,1,0,1,1,1,7,-3,-1,-4,5,3,0,1,1,-1,1,1,2,-1
KR_6767818286,420,-2,-54,-50,-3,2,1,3,-1,2,1,-1,1,0,-2,4,2,-1,1,0,0,-8,3,1,-6,5,-3,0,0,-1,1,0,-1,6,-1
KR_6759092188,420,-3,-39,-19,-6,2,2,4,-6,9,3,1,1,2,-2,2,0,-1,1,0,0,-9,-34,-4,-3,7,1,0,0,-1,1,-1,1,5,-1
KR_6696131922,440,5,22,5,4,2,1,3,1,0,1,-4,4,0,3,4,7,2,1,3,0,6,223,0,-7,7,2,0,1,-1,1,1,-1,5,-1
KR_6768910009,420,-3,-14,-16,-9,-4,4,0,-5,5,0,0,2,2,-1,2,1,1,0,1,0,-11,-39,2,-8,6,-4,0,-1,-1,-1,-1,1,6,-1
KR_6722845805,420,-3,-66,-3,-7,-1,3,2,3,0,3,-1,2,1,-1,4,3,-7,7,0,-1,-8,-13,-4,-5,9,4,0,-1,1,-1,-1,-1,5,-1
KR_6764173692,420,0,-5,-3,-4,-1,5,4,-1,1,0,3,1,4,-4,6,2,-1,1,0,1,1,17,1,-5,4,-4,0,-1,-1,1,-1,1,6,-1
KR_6756894889,420,-2,-61,-45,3,-2,3,1,5,2,7,2,4,6,-3,6,3,1,1,2,-1,-2,-41,1,-5,4,22,0,1,1,1,1,-1,4,-1
KR_6762903248,420,-1,-58,-11,-5,-3,3,0,-2,4,2,-2,5,3,2,2,4,0,0,0,1,3,9,5,-11,6,4,0,0,-1,1,0,1,1,-1
KR_6761384239,420,-1,-14,2,-6,0,2,2,2,7,9,-1,5,4,-5,6,1,-2,2,0,0,-12,-2,-3,-6,9,2,0,-1,-1,-1,-1,-1,6,-1
KR_6731238558,420,0,-7,-31,-5,-1,3,2,2,1,3,-2,3,1,-1,4,3,-3,3,0,0,-1,2,2,-4,2,1,0,-2,-1,-1,-1,1,2,-1
KR_6746602984,440,-2,-73,8,0,-1,3,2,2,1,3,-2,2,0,-1,6,5,2,0,2,0,0,141,1,-6,5,2,0,-1,0,-1,-1,1,0,-1
KR_6767168090,420,-4,-48,-21,-2,2,1,3,2,2,4,2,0,2,-6,6,0,-2,2,0,0,-3,-3,1,-7,6,2,0,-1,-1,1,-1,-1,1,-1
KR_6744031145,440,-2,-4,3,-4,0,2,2,0,0,0,-2,3,1,-3,4,1,1,0,1,0,-9,-57,1,-5,4,0,0,1,-1,1,1,1,1,-1
KR_6764230280,420,0,1,12,-3,-2,3,1,-6,7,1,0,1,1,4,2,6,1,0,1,0,0,7,0,-6,6,2,0,0,-1,0,0,1,2,-1
KR_6765695439,420,-1,-15,-28,0,0,2,2,3,2,5,2,2,4,-2,2,0,-3,3,0,0,-1,16,0,-8,8,-3,0,-1,0,-1,-1,1,0,-1
KR_6757730611,420,-2,-24,5,-8,0,3,3,0,4,4,-4,4,0,-4,5,1,0,0,0,0,-3,24,-5,-5,10,2,0,-1,-1,-1,-1,-1,6,-1
KR_6759953276,420,3,32,0,8,-3,3,0,4,0,4,5,0,5,2,1,3,0,2,2,0,17,25,5,-8,3,-2,0,0,1,1,0,1,4,-1
KR_6694861811,420,-4,29,-17,-8,-1,3,2,-4,7,3,-2,2,0,0,2,2,-1,1,0,0,-7,1,1,-8,7,6,0,-1,1,1,-1,1,2,-1
KR_6768107306,420,-4,-82,-31,-12,-3,4,1,-5,5,0,4,0,4,-7,9,2,-1,1,0,-1,-21,-3,-5,-2,7,2,0,-1,-1,1,-1,-1,3,-1
KR_6761786048,420,-4,-22,-40,-7,-2,2,0,-3,5,2,1,2,3,-1,3,2,-2,2,0,0,-12,-6,6,-10,4,-10,0,0,-1,-1,0,-1,2,-1
KR_6767407277,420,0,-19,19,1,-1,1,0,-1,3,2,2,1,3,2,0,2,-1,1,0,0,0,-39,3,-9,6,-8,0,0,1,1,0,1,6,-1
KR_6676090683,420,1,-7,-16,6,6,1,7,1,7,8,0,2,2,0,1,1,-1,1,0,0,8,-1,2,-6,4,-1,0,0,-1,1,-1,-1,6,-1
KR_6705749814,420,-2,35,-12,-6,-4,5,1,-2,4,2,-1,1,0,1,2,3,0,0,0,0,-7,7,-2,-7,9,3,0,-1,1,1,1,1,1,-1
KR_6765227597,420,-1,-13,3,-12,0,2,2,-3,3,0,-6,6,0,-3,3,0,0,0,0,0,-13,-18,2,-5,3,6,0,-1,-1,-1,-1,-1,1,-1
KR_6767413852,440,0,-10,20,-2,3,0,3,0,3,3,-5,5,0,3,1,4,-3,4,1,0,-1,-5,-1,-1,2,1,0,0,1,-1,-1,-1,4,-1
KR_6765266475,420,2,48,29,-6,6,1,7,0,0,0,-3,3,0,-4,8,4,-5,7,2,0,-19,-12,-4,-3,7,2,0,2,0,1,1,1,0,-1
KR_6728882364,440,1,10,29,5,0,0,0,2,3,5,-2,4,2,1,0,1,4,0,4,0,9,21,-1,-2,3,5,0,-1,1,1,-1,-1,5,-1
KR_6652491130,420,-3,48,-13,-10,-3,4,1,1,2,3,-5,5,0,-3,5,2,0,4,4,0,-11,-1,-4,-7,11,-3,0,0,-1,-1,0,-1,5,-1
KR_6690088906,420,-2,-38,-12,-4,-2,2,0,-3,6,3,-4,5,1,4,1,5,1,0,1,0,5,8,3,-11,8,-1,0,0,-1,-1,-1,1,5,-1
KR_6764643136,440,1,35,-11,4,4,2,6,2,1,3,0,2,2,-2,2,0,0,3,3,0,1,4,2,-5,3,-4,0,0,0,-1,-1,-1,0,-1
KR_6728802293,420,-2,-11,2,-3,2,0,2,-3,4,1,-2,4,2,-2,4,2,2,0,2,-1,-5,-22,0,-6,6,1,0,0,-1,1,0,-1,4,-1
KR_6753196255,420,-1,4,-10,-4,2,0,2,1,2,3,-3,7,4,-3,5,2,-1,1,0,0,-6,110,4,-5,1,5,0,0,-1,1,1,1,6,-1
KR_6766997344,420,-1,21,1,0,2,0,2,-7,10,3,4,0,4,-3,7,4,4,0,4,0,-8,0,-2,-3,5,-2,0,2,-1,-1,1,1,5,-1
KR_6766859974,440,-3,-48,-33,-9,0,4,4,-3,4,1,0,2,2,3,1,4,-9,9,0,0,-15,-17,-8,-3,11,-1,0,-1,-1,-1,-1,-1,5,-1
KR_6768298491,420,1,15,12,2,1,1,2,2,4,6,-3,6,3,1,3,4,1,0,1,0,-5,19,-4,-5,9,0,0,0,1,-1,1,1,3,-1
KR_6759631415,420,0,7,-8,-2,-2,3,1,-4,5,1,0,1,1,1,3,4,3,0,3,0,-6,47,-1,-3,4,-20,0,0,1,-1,0,-1,2,-1
KR_6763968113,440,1,57,11,-5,-4,5,1,4,2,6,-5,7,2,2,0,2,-2,2,0,0,-4,17,-3,-4,7,-2,0,0,1,-1,0,-1,4,-1
KR_6765646082,420,4,19,37,9,4,1,5,-1,5,4,-1,3,2,7,0,7,0,0,0,0,12,7,1,-6,5,1,0,1,1,1,1,1,3,-1
KR_6765170471,420,2,63,25,7,2,0,2,-1,2,1,1,4,5,5,2,7,0,1,1,0,5,-12,5,-7,2,-5,0,1,-1,-1,1,1,1,-1
KR_6662390596,420,-3,-1,4,-11,2,2,4,-2,2,0,-2,3,1,-5,7,2,-4,4,0,0,-17,-9,-4,-3,7,3,0,-3,-1,-1,-1,1,3,-1
KR_6758775124,420,-3,-26,-9,-2,1,3,4,-5,7,2,2,4,6,1,2,3,-1,3,2,-1,-6,-51,-2,-7,9,22,0,-1,-1,-1,-1,1,6,-1
KR_6612080410,420,-2,6,11,-5,1,0,1,-1,6,5,-1,5,4,-3,3,0,-1,1,0,0,-12,-6,-1,-3,4,1,0,-1,1,1,-1,-1,3,-1
KR_6735749685,420,-2,4,-36,0,0,2,2,-1,5,4,-2,3,1,-1,5,4,4,1,5,-1,-4,53,2,-6,4,-19,0,-1,-1,-1,-1,-1,6,-1
KR_6711324415,420,-2,23,-16,-6,-4,4,0,-4,5,1,-2,3,1,3,0,3,1,1,2,0,-5,-20,6,-12,6,1,0,-1,-1,-1,-1,1,6,-1
KR_6767320294,420,-3,-99,-5,-7,-5,6,1,-2,5,3,-1,4,3,-1,4,3,2,1,3,0,-4,-21,1,-5,4,0,0,-3,1,-1,-1,-1,5,-1
KR_6734641607,420,-3,-19,-8,-10,-1,2,1,-1,3,2,-3,5,2,-2,4,2,-3,4,1,0,-10,6,0,-8,8,-8,0,0,-1,1,-1,-1,3,-1
KR_6766859358,420,-4,-6,18,-12,-5,5,0,-3,4,1,-2,2,0,-3,6,3,1,2,3,-2,-21,3,2,-9,7,0,0,-1,-1,-1,-1,-1,4,-1
KR_6730936137,420,-2,-11,-34,-4,-2,4,2,-3,5,2,-1,4,3,1,3,4,1,0,1,0,-8,-5,-1,-3,4,2,0,1,-1,-1,1,-1,2,-1
KR_6763716398,420,-1,-15,-3,-7,2,0,2,-1,3,2,-4,5,1,-4,5,1,0,0,0,0,-7,19,-1,-2,3,-2,0,0,-1,1,1,1,4,-1
KR_6763978296,420,-3,-90,0,-8,-6,6,0,3,1,4,-6,6,0,0,3,3,1,0,1,1,-1,60,1,-5,4,-1,0,-1,1,1,-1,1,2,-1
KR_6769170983,420,-4,0,-10,-12,-4,5,1,-2,2,0,-2,2,0,-4,5,1,0,0,0,-1,-12,-200,-2,-3,5,-5,0,-1,-1,-1,-1,-1,5,-1
KR_6649780025,420,-4,-89,4,-8,-6,7,1,-1,1,0,1,0,1,0,4,4,-2,2,0,0,-3,112,1,-7,6,-6,0,-2,-1,-1,-1,-1,5,-1
KR_6729972194,420,-1,38,-12,-1,-1,2,1,1,4,5,-3,6,3,3,2,5,-1,1,0,-1,-3,8,-2,-4,6,-5,0,0,-1,-1,-1,-1,2,-1
KR_6729867948,420,-3,9,-16,-5,-2,4,2,-6,9,3,2,2,4,1,3,4,0,1,1,1,-10,-4,-4,-1,5,-2,0,-1,1,-1,-1,1,1,-1
KR_6767670859,420,-2,-13,-6,-3,-1,4,3,-2,3,1,7,3,10,-4,5,1,-3,3,0,-1,-3,-47,-2,-7,9,28,0,-2,-1,-1,-1,-1,5,-1
KR_6766028583,420,-3,-38,-11,-11,-1,4,3,-6,8,2,-6,6,0,2,2,4,0,0,0,-1,-12,-31,2,-6,4,-5,0,-2,-1,-1,-1,-1,2,-1
KR_6639906152,420,-7,-30,-14,-19,2,0,2,-7,7,0,-5,7,2,-7,8,1,-2,3,1,-1,-15,0,-3,-3,6,1,0,-4,-1,-1,-1,-1,2,-1
KR_6668126916,420,-2,-53,-32,-7,-4,4,0,-5,6,1,0,2,2,3,1,4,-1,1,0,0,-10,13,-5,-2,7,3,0,-1,-1,-1,-1,-1,6,-1
KR_6754993970,420,-3,-56,-2,-4,0,1,1,0,1,1,-7,8,1,2,2,4,1,0,1,0,-1,4,-1,-6,7,-2,0,-1,-1,-1,-1,-1,4,-1
KR_6743931220,420,-8,-86,4,-18,0,0,0,0,1,1,-4,4,0,-12,13,1,-2,4,2,0,-22,44,1,-5,4,-26,0,-1,-1,-1,-1,-1,2,-1
KR_6768479670,420,-4,-52,8,-11,0,3,3,-5,6,1,-2,3,1,-2,2,0,-2,2,0,0,-11,-5,-4,-2,6,2,0,-1,-1,-1,-1,-1,4,-1
KR_6748862631,420,-1,-8,-15,-4,-1,3,2,-3,5,2,-2,3,1,2,2,4,0,0,0,0,-5,0,0,-3,3,-5,0,0,1,-1,0,1,6,-1
KR_6762190983,420,2,74,-13,5,1,3,4,3,1,4,-2,2,0,-1,2,1,4,1,5,0,5,7,0,-5,5,-3,0,2,-1,0,1,1,3,-1
KR_6699735952,420,1,11,44,-6,0,0,0,2,1,3,-3,6,3,-4,6,2,-1,3,2,0,-5,8,2,-6,4,0,0,0,1,-1,1,-1,1,-1
KR_6744992406,420,-1,-18,12,-2,-4,4,0,-2,5,3,4,0,4,2,2,4,-2,3,1,0,-3,4,-1,-7,8,-6,0,-1,1,1,-1,1,3,-1
KR_6682568193,420,0,-61,0,0,0,1,1,3,5,8,-4,5,1,0,1,1,1,1,2,0,6,-12,-2,-8,10,-3,0,0,-1,1,0,-1,1,-1
KR_6739070967,420,-3,-54,1,-2,-1,2,1,0,3,3,-2,3,1,2,1,3,-1,1,0,0,-7,248,0,-5,5,-3,0,0,1,1,0,1,3,-1
KR_6744020047,420,0,-47,-4,-1,-2,3,1,5,1,6,4,0,4,-6,8,2,-2,2,0,0,5,-3,-4,-6,10,-6,0,0,-1,-1,0,1,4,-1
KR_6767862049,420,-3,-72,-20,-9,-2,2,0,1,2,3,-1,1,0,-5,6,1,-2,2,0,0,-9,-16,-3,-3,6,-4,0,-1,-1,-1,-1,-1,4,-1
KR_6754096051,420,-2,-57,-2,1,-2,3,1,-1,2,1,3,0,3,1,2,3,0,2,2,0,9,35,0,-6,6,-4,0,0,1,-1,-1,1,3,-1
KR_6761049590,440,-4,-25,-21,-9,-1,2,1,1,0,1,-1,2,1,-4,4,0,-4,5,1,0,-6,376,-1,-1,2,-1,0,-1,0,1,-1,-1,0,-1
KR_6762015430,420,-1,31,7,-6,-2,3,1,2,1,3,-4,6,2,-2,2,0,0,1,1,-1,-7,-26,3,-9,6,2,0,1,0,1,1,-1,0,-1
KR_6628320101,420,-1,3,-3,2,4,1,5,-6,6,0,-2,5,3,3,4,7,3,0,3,-1,-2,-13,1,-8,7,-1,0,0,-1,1,0,-1,5,-1
KR_6741269841,420,-4,41,-28,-4,2,0,2,-1,3,2,0,2,2,-6,7,1,1,1,2,0,-11,23,-2,-6,8,-25,0,-1,-1,1,-1,-1,5,-1
KR_6699740614,420,-2,-70,-17,-7,-4,4,0,-1,4,3,2,3,5,0,2,2,-4,4,0,0,-3,-1,-2,-8,10,-4,0,-2,-1,1,-1,1,4,-1
KR_6769158959,420,-3,-44,-24,0,3,0,3,0,2,2,-5,6,1,0,2,2,2,1,3,0,-3,22,1,-4,3,2,0,-1,-1,1,-1,1,1,-1
KR_6753439462,420,0,49,3,-6,2,0,2,-5,6,1,-4,7,3,-1,4,3,2,0,2,0,-9,0,3,-8,5,-2,0,1,-1,-1,1,-1,1,-1
KR_6758705092,420,-4,-17,-22,-5,4,0,4,-2,2,0,2,1,3,-7,8,1,-2,2,0,0,-2,54,-4,-1,5,16,0,-1,-1,-1,1,-1,6,-1
KR_6767808312,440,2,65,-18,7,-5,8,3,2,0,2,4,1,5,4,1,5,2,0,2,1,-3,17,-1,-5,6,-3,0,0,1,1,1,1,2,-1
KR_6750187174,420,3,-62,90,1,-4,5,1,1,0,1,0,2,2,1,2,3,3,1,4,0,9,8,-3,-3,6,0,0,1,1,-1,-1,-1,3,-1
KR_6769184212,420,-1,-22,-8,2,0,1,1,-4,4,0,2,1,3,3,2,5,1,0,1,-1,6,-154,3,-8,5,-3,0,-1,1,-1,-1,-1,3,-1
KR_6760786308,420,2,-11,51,5,3,1,4,-1,2,1,3,1,4,-1,2,1,1,1,2,0,3,10,1,-7,6,-2,0,0,1,1,-1,-1,1,-1
KR_6767904890,420,-1,-25,-27,-3,2,0,2,-2,2,0,-1,2,1,-3,6,3,1,0,1,0,-2,-6,1,-4,3,-2,0,-1,-1,1,-1,1,4,-1
KR_6765437253,420,-3,-30,-16,-19,1,2,3,-6,8,2,-7,9,2,-7,9,2,0,1,1,-4,-19,1,-4,-4,8,1,0,-2,-1,-1,-1,-1,3,-1
KR_6738384925,440,3,42,25,2,-4,4,0,0,2,2,1,1,2,4,3,7,1,5,6,-1,0,-6,4,-10,6,4,0,1,-1,1,1,-1,3,-1
KR_6762783644,420,-3,-9,-31,-6,1,3,4,-4,6,2,4,0,4,-6,6,0,-1,2,1,-2,-11,-3,0,-4,4,3,0,-1,-1,-1,-1,-1,6,-1
KR_6764108098,420,-1,40,-8,0,0,0,0,-1,2,1,-4,4,0,3,4,7,2,1,3,0,1,-12,-1,-7,8,-1,0,-2,-1,-1,-1,-1,3,-1
KR_6748187865,420,-3,21,-58,-4,-4,5,1,1,1,2,0,1,1,-2,3,1,1,0,1,0,-9,-1,1,-5,4,-4,0,0,-1,-1,-1,-1,6,-1
KR_6750412001,420,-5,-104,-75,-8,0,4,4,-3,5,2,1,0,1,-3,3,0,-3,4,1,-1,-11,0,-2,-4,6,-6,0,-1,1,-1,-1,-1,1,-1
KR_6461593215,420,-5,-56,-38,-9,0,2,2,-9,10,1,0,3,3,0,4,4,0,3,3,0,-15,6,2,-7,5,-8,0,-2,-1,1,-1,-1,3,-1
KR_6763847143,420,-2,-5,1,-5,-7,7,0,-2,3,1,-2,5,3,5,1,6,1,1,2,0,1,-2,-3,-4,7,6,0,-1,1,-1,-1,-1,6,-1
KR_6718639758,420,-5,-85,-32,-7,-1,2,1,-1,2,1,-2,4,2,-2,2,0,-1,1,0,0,-6,-38,2,-8,6,-3,0,-1,-1,-1,-1,-1,2,-1
KR_6664072779,420,-1,-41,-19,-3,1,0,1,-2,4,2,-3,3,0,0,1,1,1,1,2,0,1,28,1,-6,5,-3,0,-1,1,1,-1,-1,3,-1
KR_6765300216,420,0,-63,4,2,0,1,1,5,0,5,-1,2,1,-1,2,1,-1,1,0,0,8,-9,2,-8,6,6,0,0,1,-1,-1,1,1,-1
KR_6718043309,420,-3,-38,-13,-4,0,1,1,0,2,2,-2,3,1,0,1,1,-2,2,0,0,-5,22,3,-10,7,0,0,-1,-1,1,-1,-1,1,-1
KR_6757064246,420,-3,1,7,-10,-3,5,2,3,1,4,-1,2,1,-6,8,2,-3,3,0,0,-7,2,3,-6,3,2,0,1,-1,-1,-1,-1,1,-1
KR_6766766512,420,-2,3,10,-7,-2,5,3,-3,3,0,-2,4,2,1,2,3,-1,1,0,0,-7,-8,-2,-3,5,-2,0,-1,1,-1,-1,-1,3,-1
KR_6721372594,440,0,44,-16,3,-3,3,0,1,1,2,2,1,3,1,3,4,2,0,2,1,3,-4,-1,-4,5,-2,0,0,0,-1,-1,1,0,-1
KR_6687658147,420,-2,-10,-4,-5,-1,3,2,0,4,4,1,1,2,-6,6,0,1,0,1,-1,-7,-13,0,-5,5,-4,0,-2,1,-1,-1,-1,1,-1
KR_6673070597,420,-1,-103,-18,-3,-4,5,1,0,2,2,1,0,1,0,2,2,0,1,1,0,-1,-2,3,-7,4,-5,0,-2,-1,-1,-1,-1,3,-1
KR_6702675399,440,-2,-112,-21,-4,2,0,2,-2,4,2,-1,1,0,-1,2,1,-2,3,1,-1,-2,-19,1,-7,6,4,0,0,-1,-1,0,-1,3,-1
KR_6761878942,420,0,-18,-13,-2,-2,3,1,1,1,2,1,2,3,-1,2,1,-1,1,0,0,5,-122,-3,-2,5,0,0,-1,1,-1,-1,-1,1,-1
KR_6768162002,420,1,0,19,-1,0,5,5,-5,6,1,2,1,3,1,1,2,1,1,2,0,-4,30,-6,-4,10,5,0,1,1,-1,-1,-1,5,-1
KR_6732777678,440,-5,-78,-26,-4,-4,5,1,-1,1,0,-2,3,1,1,1,2,2,3,5,0,4,1,0,-7,7,0,0,1,-1,1,1,-1,2,-1
KR_6745539370,420,-5,-71,-32,-7,-2,3,1,-1,3,2,-1,4,3,-2,4,2,-1,3,2,0,3,18,-1,-6,7,-3,0,0,-1,-1,0,1,4,-1
KR_6625061621,420,-6,-9,-29,-8,-1,3,2,-3,4,1,1,1,2,-4,6,2,-1,1,0,0,-14,-1,-3,-5,8,0,0,0,1,1,1,1,1,-1
KR_6732635975,420,-3,-33,-5,-7,3,0,3,-1,3,2,0,3,3,-8,10,2,-1,3,2,1,-21,2,0,-6,6,-2,0,0,-1,1,-1,-1,2,-1
KR_6767362284,420,-1,-9,0,3,-5,5,0,3,1,4,6,3,9,-1,1,0,0,2,2,0,3,-5,-2,-3,5,1,0,0,1,-1,1,1,6,-1
KR_6761399464,420,-5,-42,0,-3,-1,2,1,0,2,2,2,3,5,-7,8,1,3,0,3,0,-4,-9,-4,-6,10,-2,0,-1,-1,-1,-1,-1,4,-1
KR_6766904918,420,-2,-53,4,-3,-1,1,0,3,1,4,0,1,1,-7,7,0,2,3,5,0,4,0,4,-10,6,-5,0,0,1,1,0,-1,2,-1
KR_6763284555,420,-4,3,-15,-10,-4,5,1,-2,9,7,-2,2,0,-1,2,1,-1,1,0,0,1,5,-3,-5,8,3,0,0,1,1,-1,-1,3,-1
KR_6720744644,420,-4,3,5,-6,-2,4,2,-7,7,0,0,1,1,3,0,3,0,0,0,0,-4,-6,-1,-6,7,0,0,-1,1,0,-1,1,1,-1
KR_6715595601,420,0,-44,13,-4,0,2,2,-3,4,1,1,1,2,-4,7,3,2,1,3,0,-6,16,4,-8,4,0,0,0,-1,-1,0,1,1,-1
KR_6713197057,420,-3,-20,7,-2,1,2,3,-3,7,4,-1,5,4,-1,2,1,2,0,2,0,-7,0,-2,-6,8,3,0,0,1,-1,0,-1,5,-1
KR_6699520374,420,-2,-47,-1,0,-2,4,2,2,1,3,1,2,3,-2,5,3,1,0,1,0,8,2,2,-5,3,-1,0,0,1,1,-1,-1,3,-1
KR_6748699633,440,0,-7,10,-2,0,4,4,0,2,2,-2,3,1,1,2,3,-1,2,1,0,-1,-4,-1,-3,4,-2,0,0,-1,1,-1,1,5,-1
KR_6716712676,420,-3,-33,12,-4,-5,7,2,3,1,4,2,2,4,-2,3,1,-2,2,0,-2,-6,4,4,-5,1,0,0,-2,1,1,-1,-1,3,-1
KR_6740636568,420,-1,35,-12,1,-1,1,0,0,1,1,-2,5,3,4,0,4,0,0,0,0,-3,5,2,-6,4,1,0,0,1,-1,0,1,3,-1
KR_6740072747,420,-4,-60,-8,-13,-7,7,0,0,1,1,-2,2,0,-4,5,1,0,0,0,-1,-17,-26,-1,-6,7,-1,0,0,-1,1,-1,-1,2,-1
KR_6743649872,420,1,-21,33,6,1,4,5,6,1,7,0,2,2,-2,3,1,1,1,2,0,2,-16,-3,-6,9,7,0,1,1,1,1,-1,3,-1
KR_6756693899,420,1,-21,-2,3,-2,5,3,1,0,1,-2,4,2,5,3,8,1,3,4,0,4,-12,-1,-4,5,3,0,0,-1,-1,0,1,5,-1
KR_6752913472,440,0,28,-13,-5,-2,5,3,-7,9,2,1,2,3,1,2,3,2,0,2,0,-9,-10,-2,-4,6,3,0,1,0,-1,1,-1,0,-1
KR_6768494235,420,-3,-28,12,-10,-2,4,2,-1,6,5,2,2,4,-7,9,2,-2,2,0,-3,-19,23,-7,-5,12,2,0,-1,-1,1,1,-1,2,-1
KR_6665835182,420,-3,-70,8,-2,-3,4,1,4,0,4,-3,4,1,-1,3,2,1,2,3,0,3,3,-1,-6,7,-2,0,-1,-1,-1,-1,-1,1,-1
KR_6768661552,420,-1,-13,-28,-6,-3,4,1,0,5,5,-4,5,1,-2,3,1,3,2,5,0,-2,-43,0,-10,10,3,0,-1,1,-1,-1,-1,3,-1
KR_6759433100,420,-3,-53,22,-9,-2,2,0,-1,3,2,-1,2,1,-2,5,3,-3,3,0,0,-13,-1,1,-8,7,-4,0,-2,-1,-1,-1,-1,2,-1
KR_6755688012,420,-4,-23,3,-23,0,1,1,-5,6,1,-2,4,2,-16,16,0,0,1,1,0,-25,-16,1,-5,4,-1,0,-3,-1,-1,-1,-1,3,-1
KR_6719654215,420,-3,-48,0,-1,3,1,4,0,3,3,0,3,3,-4,5,1,0,1,1,0,-12,10,5,-12,7,-5,0,-1,-1,1,-1,-1,4,-1
KR_6683705195,420,1,15,8,0,0,2,2,0,2,2,2,2,4,-3,3,0,1,0,1,0,-3,-10,2,-7,5,-2,0,0,-1,1,-1,1,1,-1
KR_6760538306,420,-2,-37,-21,-7,-3,4,1,-4,6,2,0,1,1,0,2,2,0,3,3,0,-9,0,-5,-4,9,-3,0,1,-1,-1,1,-1,6,-1
KR_6759845168,440,-6,-89,-16,-17,0,9,9,-2,4,2,-5,7,2,-4,5,1,-6,6,0,0,1,5,-1,-5,6,1,0,-2,1,-1,-1,-1,1,-1
KR_6755715912,440,0,-11,-9,-4,-3,5,2,2,0,2,0,2,2,-3,6,3,0,1,1,0,-2,2,6,-9,3,-4,0,0,-1,1,0,-1,4,-1
KR_6716630929,420,-3,-35,-31,-5,-2,3,1,0,6,6,1,3,4,-2,2,0,-2,2,0,3,-3,3,3,-10,7,-8,0,-2,-1,-1,-1,1,2,-1
KR_6709017226,420,0,9,-19,-3,-3,3,0,-1,3,2,0,0,0,1,0,1,0,0,0,0,0,-152,-3,-1,4,4,0,0,-1,-1,-1,-1,4,-1
KR_6720465962,420,-4,-17,-20,-9,-2,3,1,-5,8,3,-2,5,3,-2,3,1,2,0,2,0,-7,-6,-2,-2,4,-3,0,0,-1,1,1,1,6,-1
KR_6759388977,420,-1,28,-26,3,-3,4,1,2,3,5,-1,3,2,5,1,6,0,1,1,0,5,4,3,-6,3,-3,0,-1,-1,-1,-1,1,4,-1
KR_6768838756,420,2,57,16,0,0,1,1,2,2,4,-1,2,1,-4,5,1,3,0,3,0,-6,7,2,-8,6,-3,0,2,-1,0,1,1,5,-1
KR_6765873653,420,-1,15,30,-5,0,1,1,-1,4,3,-1,3,2,-3,4,1,0,0,0,0,-11,5,1,-2,1,3,0,0,-1,1,0,1,1,-1
KR_6768834303,420,-9,-145,-4,-25,-4,5,1,-5,5,0,-9,10,1,-7,8,1,0,4,4,-1,-19,-11,-1,-3,4,1,0,0,-1,-1,-1,-1,2,-1
KR_6729942719,420,-3,-51,4,-10,-8,8,0,-1,6,5,0,2,2,-1,2,1,0,0,0,0,-5,-2,-3,-3,6,-2,0,-1,-1,-1,-1,-1,2,-1
KR_6756591460,420,-2,50,-23,1,1,1,2,2,5,7,-3,3,0,1,1,2,0,0,0,0,-10,9,6,-7,1,5,0,1,1,1,1,1,4,-1
KR_6728315183,420,2,4,-17,2,1,2,3,-1,2,1,3,0,3,-1,4,3,0,0,0,0,1,3,4,-6,2,-6,0,0,-1,1,0,-1,5,-1
KR_6769067774,440,-6,-79,-40,-9,0,0,0,0,2,2,-4,5,1,-7,8,1,2,0,2,0,-13,4,1,-8,7,-2,0,-3,1,-1,-1,-1,1,-1
KR_6671761195,420,-2,-32,8,-6,3,0,3,-7,8,1,1,3,4,-4,5,1,1,0,1,0,-8,-29,0,-8,8,0,0,1,1,1,1,-1,4,-1
KR_6749671964,420,-5,21,-21,-12,-4,4,0,-2,3,1,-6,7,1,0,2,2,0,1,1,0,-7,5,2,-5,3,-2,0,0,0,-1,0,-1,0,-1
KR_6716297783,420,3,31,13,1,6,1,7,-5,7,2,-1,5,4,0,4,4,1,1,2,0,-7,4,-4,-4,8,1,0,2,-1,1,1,1,5,-1
KR_6737052222,440,-5,-32,-38,-10,-2,4,2,-4,4,0,-1,3,2,2,2,4,-5,5,0,0,-13,-6,0,-3,3,-3,0,-2,-1,-1,-1,-1,2,-1
KR_6766778447,420,2,-29,20,8,0,3,3,3,4,7,-2,4,2,3,1,4,4,1,5,3,13,2,2,-8,6,2,0,-1,-1,1,-1,1,2,-1
KR_6760151795,420,1,-19,23,-5,-4,5,1,-5,6,1,0,0,0,3,1,4,1,1,2,0,-1,19,-5,-7,12,7,0,1,-1,-1,1,1,2,-1
KR_6738989723,440,2,33,11,-4,2,2,4,-5,6,1,-4,7,3,-1,3,2,4,0,4,0,-7,-60,-6,-3,9,7,0,0,0,-1,1,1,0,-1
KR_6766897208,420,-5,-70,-8,-12,-1,1,0,-5,6,1,-4,5,1,-3,5,2,1,1,2,-1,-15,-8,-2,-4,6,-2,0,-1,-1,1,-1,-1,4,-1
KR_6761094206,420,2,-5,3,4,2,0,2,3,1,4,1,0,1,-2,2,0,0,2,2,-1,-2,5,-4,-4,8,0,0,1,1,-1,1,-1,3,-1
KR_6769175740,440,0,19,-1,-5,0,4,4,-4,5,1,-4,5,1,2,1,3,1,1,2,2,-7,-5,-4,-5,9,0,0,0,-1,1,0,1,3,-1
KR_6768161267,420,-2,-47,-33,-5,-1,4,3,-2,6,4,-1,1,0,1,3,4,-2,2,0,-1,-2,-8,-3,-5,8,0,0,-1,-1,-1,-1,-1,6,-1
KR_6745625042,420,2,-17,-52,3,0,1,1,1,5,6,-1,4,3,3,1,4,0,2,2,0,11,24,2,-6,4,3,0,-1,-1,1,-1,-1,3,-1
KR_6748158518,420,0,-9,-4,2,1,0,1,-2,2,0,0,4,4,3,0,3,0,1,1,0,2,36,6,-11,5,-5,0,0,-1,1,0,1,4,-1
KR_6640631712,420,0,-107,-14,2,0,1,1,4,3,7,1,2,3,-3,4,1,0,0,0,0,-1,91,-6,-3,9,1,0,-1,1,-1,-1,-1,5,-1
KR_6709028171,420,-4,-23,12,-13,-1,2,1,-5,5,0,-2,2,0,-4,7,3,-1,1,0,-1,-15,3,-2,-6,8,-5,0,-2,1,-1,-1,-1,4,-1
KR_6761937880,420,-1,-35,-16,-5,-3,3,0,1,1,2,-1,1,0,-3,3,0,1,0,1,0,-6,-2,-1,-7,8,5,0,0,1,-1,1,1,3,-1
KR_6728573717,420,-6,-18,-14,-16,-1,2,1,-7,7,0,-3,5,2,-3,4,1,-2,2,0,0,-18,-10,-4,-2,6,-3,0,-2,-1,-1,-1,-1,3,-1
KR_6766422817,420,-2,31,-8,-7,2,0,2,-4,6,2,-2,3,1,-4,4,0,1,1,2,0,-15,3,-3,-5,8,-2,0,0,-1,-1,-1,-1,3,-1
KR_6763414058,440,-1,61,17,0,4,0,4,-1,1,0,-6,6,0,-3,4,1,6,1,7,1,-2,-21,-4,-3,7,1,0,1,0,1,1,1,0,-1
KR_6661992831,420,1,-24,-8,-1,2,1,3,2,1,3,2,2,4,-6,7,1,-1,2,1,0,-9,-10,-2,-4,6,3,0,-1,-1,1,-1,1,5,-1
KR_6756726633,420,-4,-116,-11,-9,-2,5,3,-5,6,1,-3,7,4,3,2,5,-2,3,1,0,0,-8,-1,-4,5,-5,0,-3,-1,-1,-1,-1,3,-1
KR_6767296024,420,-1,-17,12,1,4,2,6,-1,3,2,1,1,2,-6,8,2,3,0,3,1,-4,9,-2,-3,5,2,0,-1,1,-1,-1,-1,3,-1
KR_6762712894,420,-5,-96,24,-14,-4,6,2,-4,6,2,-5,5,0,1,3,4,-2,3,1,0,-10,11,3,-8,5,-3,0,-2,-1,-1,-1,1,1,-1
KR_6731823053,420,3,-2,-1,4,2,0,2,3,5,8,2,0,2,-3,3,0,0,0,0,0,3,-3,0,-5,5,0,0,0,-1,1,0,-1,2,-1
KR_6763413775,420,-7,-80,3,-14,-1,3,2,-2,2,0,-6,6,0,-5,5,0,0,0,0,0,-26,-23,-2,-4,6,-5,0,-2,-1,-1,-1,-1,4,-1
KR_6755712986,420,0,55,-24,-5,-4,4,0,-4,7,3,1,2,3,2,3,5,0,0,0,-1,-9,-55,0,-6,6,3,0,0,-1,1,0,-1,5,-1
KR_6728331423,420,-4,-37,-19,2,-2,2,0,-1,2,1,3,2,5,0,3,3,2,1,3,1,-6,-3,0,-7,7,-3,0,-1,-1,1,1,1,5,-1
KR_6716453351,440,-3,-3,-63,-6,-1,1,0,-2,3,1,-7,7,0,5,2,7,-1,1,0,0,0,-7,3,-8,5,8,0,-1,0,-1,-1,-1,0,-1
KR_6768767898,420,-1,42,-8,-5,0,4,4,-1,4,3,-6,7,1,1,2,3,1,1,2,1,-2,16,-2,-5,7,1,0,0,1,-1,0,1,4,-1
KR_6763871127,420,1,-10,-10,-1,2,2,4,1,1,2,-2,4,2,-3,5,2,1,1,2,0,-3,-6,0,-8,8,-3,0,0,-1,1,0,1,5,-1
KR_6761420156,420,2,-1,17,9,1,0,1,2,0,2,-1,1,0,2,4,6,5,0,5,0,15,8,1,-5,4,1,0,0,1,1,0,1,6,-1
KR_6764242888,420,0,-10,7,-2,3,0,3,-2,6,4,-1,2,1,0,3,3,-2,2,0,0,-8,-6,-3,-6,9,-1,0,-1,1,-1,-1,1,5,-1
KR_6688849927,420,-3,-56,-24,-12,-5,5,0,-5,5,0,0,8,8,-2,2,0,0,0,0,0,-19,-4,2,-8,6,-4,0,-1,-1,-1,-1,-1,1,-1
KR_6764948090,420,-2,1,-21,-14,5,1,6,-7,7,0,-9,9,0,0,3,3,-3,3,0,-1,-26,8,-2,-5,7,-3,0,-1,-1,-1,-1,-1,3,-1
KR_6763100983,440,-4,-71,5,-9,-8,9,1,0,1,1,-1,2,1,-1,5,4,1,1,2,0,-2,-22,-1,-2,3,-1,0,-1,1,-1,-1,-1,5,-1
KR_6741862819,440,-2,-23,-26,-1,0,1,1,0,2,2,-4,4,0,2,0,2,1,0,1,0,-7,-3,2,-6,4,-3,0,0,-1,-1,0,1,5,-1
KR_6697066034,440,-3,-25,0,-9,-1,2,1,-3,4,1,0,1,1,0,1,1,-5,7,2,0,-17,-54,-3,-3,6,1,0,0,-1,1,1,-1,4,-1
KR_6635292093,420,0,50,-24,-2,-1,1,0,1,6,7,1,1,2,-1,3,2,-2,2,0,-1,-6,0,-3,-4,7,1,0,0,-1,-1,1,-1,6,-1
KR_6754764727,420,1,55,16,0,8,0,8,-8,10,2,1,3,4,-2,2,0,1,0,1,0,-11,-34,-4,-3,7,4,0,0,-1,1,0,-1,5,-1
KR_6766775441,420,-3,-40,-11,-5,1,2,3,-2,3,1,2,3,5,-6,8,2,0,4,4,1,-7,-280,0,-8,8,-7,0,-3,-1,-1,-1,1,5,-1
KR_6752496669,420,1,-32,7,5,0,2,2,-3,5,2,1,0,1,9,2,11,-2,4,2,1,4,0,-1,-6,7,-4,0,0,1,1,1,1,1,-1
KR_6724474774,420,-3,-68,9,0,-1,1,0,-4,6,2,0,1,1,0,1,1,5,0,5,0,4,-6,-4,-2,6,2,0,-1,1,-1,-1,1,2,-1
KR_6751665968,420,-4,-53,-1,-12,-3,5,2,-4,7,3,1,1,2,-4,4,0,-2,3,1,0,-9,-24,-2,-4,6,7,0,-1,-1,-1,-1,1,6,-1
KR_6698008644,420,-4,-58,-13,-8,-2,2,0,0,2,2,-4,5,1,-3,4,1,1,1,2,0,-6,22,8,-11,3,1,0,-1,-1,-1,-1,1,5,-1
KR_6758887081,420,-2,-44,-8,-12,0,1,1,-8,8,0,-1,2,1,-2,2,0,-1,1,0,0,-15,-1,-2,-4,6,-3,0,0,1,-1,-1,-1,6,-1
KR_6708383842,420,-6,-78,-40,-12,-2,2,0,-5,5,0,2,0,2,-5,5,0,-2,2,0,0,-12,0,3,-7,4,-10,0,-3,-1,-1,-1,-1,1,-1
KR_6763804720,420,0,-25,-44,-1,-1,1,0,-2,3,1,3,3,6,0,2,2,-1,2,1,0,-7,3,0,-5,5,1,0,-1,-1,1,1,1,5,-1
KR_6624220744,440,-3,-69,-4,-6,3,1,4,-2,3,1,-5,6,1,-2,2,0,0,0,0,0,-8,-4,1,-8,7,4,0,0,-1,-1,-1,-1,1,-1
KR_6727493520,420,0,26,12,0,1,0,1,1,3,4,0,2,2,-2,3,1,0,1,1,2,2,0,1,-5,4,0,0,0,1,1,0,1,2,-1
KR_6767196108,420,-2,-13,2,-12,-3,4,1,-4,6,2,0,5,5,-3,4,1,-2,2,0,0,-5,10,0,-9,9,-8,0,-2,-1,-1,-1,-1,4,-1
KR_6706732859,420,-6,-25,-23,-8,0,2,2,-5,7,2,-2,2,0,-1,2,1,0,0,0,-1,-16,0,-4,-4,8,0,0,-3,1,-1,-1,-1,3,-1
KR_6766474925,420,-4,-33,-8,-12,0,4,4,-7,7,0,-5,6,1,1,2,3,-1,1,0,0,-12,9,-1,-2,3,-1,0,-2,1,-1,-1,-1,5,-1
KR_6705332464,420,-2,10,-17,-2,-4,4,0,1,2,3,-1,4,3,0,1,1,2,1,3,-1,-6,-10,-2,-4,6,5,0,-1,1,-1,-1,-1,3,-1
KR_6763020061,420,-5,-113,-17,-15,-3,5,2,-6,6,0,-3,6,3,-3,3,0,0,1,1,0,-14,2,-2,-5,7,-4,0,-3,-1,-1,-1,-1,1,-1
KR_6754974431,420,-2,-6,-8,5,-2,5,3,3,2,5,4,1,5,1,0,1,-1,1,0,0,3,3,1,-8,7,0,0,0,-1,1,0,1,3,-1
KR_6767878983,420,3,-28,-25,-6,0,2,2,-1,4,3,-2,5,3,0,5,5,-3,3,0,0,-10,-40,-6,-2,8,-4,0,0,-1,-1,0,-1,2,-1
KR_6761758637,420,-3,-29,12,-12,-6,6,0,-1,3,2,-3,3,0,-2,5,3,0,0,0,0,-8,2,2,-5,3,2,0,-2,-1,1,-1,-1,5,-1
KR_6720999760,440,3,50,-17,12,2,2,4,2,2,4,2,1,3,4,0,4,2,1,3,0,10,11,6,-6,0,-2,0,0,-1,-1,0,1,3,-1
KR_6768955860,420,-1,-76,-39,-2,1,2,3,-2,3,1,1,3,4,-2,3,1,0,1,1,0,0,1,2,-7,5,1,0,0,-1,1,0,-1,6,-1
KR_6762377302,420,-6,-64,-25,-13,-8,8,0,-1,2,1,-2,3,1,-2,4,2,0,0,0,0,-3,-10,-2,-5,7,0,0,-3,-1,-1,-1,-1,4,-1
KR_6762790571,440,-2,3,-11,-10,-10,10,0,2,1,3,0,2,2,1,1,2,-3,3,0,0,-6,2,2,-6,4,2,0,-1,-1,-1,-1,-1,5,-1
KR_6764878517,440,0,4,8,0,-1,2,1,2,1,3,-3,4,1,2,1,3,0,0,0,0,-4,10,1,-7,6,-2,0,1,1,1,1,1,2,-1
KR_6748025850,420,-6,-5,-2,-11,1,2,3,-1,1,0,-8,9,1,-2,6,4,-1,2,1,0,-10,9,4,-8,4,0,0,-1,-1,1,-1,-1,5,-1
KR_6461558155,420,-5,-37,-38,-18,-3,3,0,-6,6,0,0,1,1,-8,9,1,-1,1,0,-1,-20,-29,-2,-6,8,0,0,-3,-1,-1,-1,-1,2,-1
KR_6744907759,420,1,103,31,-6,2,0,2,0,3,3,1,1,2,-7,7,0,-2,5,3,0,-19,-20,-6,-4,10,-2,0,0,-1,1,1,1,5,-1
KR_6751652327,420,0,-18,17,-3,-3,4,1,-1,5,4,1,1,2,-1,4,3,1,0,1,0,-9,-3,-3,-2,5,-4,0,-1,1,-1,-1,-1,6,-1
KR_6768654627,420,-7,-63,-20,-15,-4,5,1,-1,5,4,-4,7,3,-5,6,1,-1,1,0,0,-3,-25,-4,-3,7,0,0,0,-1,-1,-1,-1,6,-1
KR_6767825381,420,-6,-13,-23,-20,-2,2,0,-4,8,4,-8,9,1,-2,2,0,-4,4,0,-1,-16,-8,-9,-1,10,0,0,-1,-1,-1,-1,-1,5,-1
KR_6763907617,420,-6,-20,11,-18,-10,10,0,0,4,4,-4,5,1,-4,5,1,0,0,0,0,-17,-79,-5,-3,8,5,0,-2,1,-1,-1,-1,3,-1
KR_6769007887,420,0,78,24,-6,-4,4,0,0,2,2,-4,4,0,3,2,5,-1,3,2,0,-4,10,0,-5,5,-1,0,0,1,-1,1,-1,2,-1
KR_6768415482,420,-1,-51,25,-9,-1,3,2,-1,4,3,-3,3,0,-4,4,0,0,2,2,0,-15,-46,-3,-7,10,17,0,-2,-1,1,-1,-1,3,-1
KR_6730148288,420,-1,-14,-8,-12,2,0,2,-1,3,2,-4,5,1,-9,9,0,0,0,0,0,-18,-9,-3,-5,8,1,0,-1,-1,1,-1,1,2,-1
KR_6744144932,420,1,56,7,-10,-2,5,3,-4,4,0,-4,4,0,-1,6,5,1,3,4,0,-21,-13,-6,-4,10,5,0,2,-1,-1,1,1,3,-1
KR_6674091523,420,2,62,-15,0,-2,4,2,-3,6,3,0,2,2,0,5,5,5,0,5,0,-6,2,-1,-7,8,-3,0,1,-1,-1,1,-1,6,-1
KR_6732430737,420,-3,-61,17,-9,0,4,4,-3,6,3,-5,7,2,-1,1,0,0,0,0,0,-9,-11,-1,-5,6,-1,0,-1,0,-1,-1,-1,0,-1
KR_6766411780,420,-3,-103,4,-12,-3,4,1,0,5,5,-4,5,1,-6,6,0,1,0,1,0,-13,-16,2,-4,2,-3,0,-2,-1,-1,-1,1,4,-1
KR_6749255678,420,-2,42,-4,-6,0,3,3,-6,7,1,-1,3,2,0,1,1,1,0,1,0,-12,3,2,-8,6,0,0,-2,-1,1,-1,-1,2,-1
KR_6506770525,420,0,1,1,3,2,2,4,-3,5,2,0,3,3,3,2,5,1,0,1,0,-3,10,2,-5,3,-5,0,0,-1,-1,-1,1,3,-1
KR_6761099221,420,-3,-17,0,-9,-2,3,1,-1,4,3,-2,4,2,-4,4,0,0,3,3,0,-3,-1,-3,-2,5,-1,0,-2,-1,1,-1,-1,2,-1
KR_6757736973,420,-4,-32,-34,-11,-6,6,0,-1,3,2,-1,4,3,-5,5,0,2,2,4,0,-8,-41,0,-5,5,-2,0,-2,0,-1,-1,-1,0,-1
KR_6762907228,420,1,-22,-12,6,-4,4,0,1,1,2,0,1,1,8,0,8,1,0,1,0,12,-2,-3,-4,7,1,0,1,1,1,1,-1,4,-1
KR_6745817800,420,-2,-48,-23,-1,-4,5,1,0,2,2,4,2,6,-2,3,1,1,0,1,0,5,-107,0,-5,5,-1,0,-1,1,-1,-1,-1,4,-1
KR_6760838823,420,-4,-12,-14,-4,-1,3,2,-2,2,0,1,2,3,2,0,2,-4,4,0,0,-6,-121,5,-9,4,3,0,0,-1,1,-1,-1,2,-1
KR_6701019418,420,-5,-141,-35,-6,-2,4,2,-3,5,2,1,1,2,-1,2,1,-1,2,1,1,3,3,-3,-6,9,3,0,-2,-1,-1,-1,1,2,-1
KR_6694896213,420,-9,-5,-132,-8,-4,4,0,-4,4,0,-1,2,1,1,3,4,0,1,1,0,-8,-36,-3,-5,8,0,0,-3,-1,-1,-1,-1,6,-1
KR_6762349992,420,-4,-26,-21,-17,-4,5,1,-3,4,1,0,4,4,-6,8,2,-4,4,0,-4,-26,-4,1,-6,5,-2,0,-3,-1,-1,-1,-1,2,-1
KR_6768800624,420,0,-17,25,-7,1,0,1,-3,3,0,0,2,2,-5,7,2,0,1,1,0,-12,-7,-5,-6,11,-2,0,0,-1,-1,-1,-1,3,-1
KR_6553839984,420,-1,-27,2,-1,-1,1,0,1,2,3,-1,3,2,-2,4,2,2,1,3,0,-3,-6,-3,-7,10,3,0,0,-1,1,-1,1,1,-1
KR_6768447791,420,-2,23,15,0,2,0,2,2,3,5,-3,3,0,-1,2,1,0,0,0,0,-3,-170,-3,-6,9,16,0,3,-1,1,1,1,5,-1
KR_6756419152,440,-7,-54,-28,-20,-9,9,0,-5,5,0,-1,3,2,-2,3,1,-3,3,0,-5,-29,-9,-4,-6,10,-1,0,-1,-1,-1,-1,-1,2,-1
KR_6687888319,420,0,-2,32,-1,0,2,2,-3,4,1,-1,2,1,3,1,4,0,0,0,0,-2,5,1,-8,7,-2,0,-1,1,-1,-1,-1,1,-1
KR_6757182289,420,-2,32,-23,1,3,1,4,0,2,2,-3,4,1,1,0,1,0,0,0,0,3,43,-4,-3,7,-15,0,0,-1,-1,1,1,1,-1
KR_6768577659,420,-1,-23,-8,-3,-4,5,1,-4,8,4,4,3,7,2,3,5,-1,1,0,-2,-8,3,-1,-4,5,-4,0,1,-1,1,1,-1,2,-1
KR_6691948946,420,-1,21,12,-7,-1,5,4,-5,7,2,-2,4,2,1,1,2,0,1,1,1,-12,6,2,-7,5,-3,0,0,-1,-1,0,1,4,-1
KR_6750493178,420,-3,17,16,-5,-1,3,2,-4,6,2,3,2,5,0,5,5,-3,3,0,0,-7,1,-2,-6,8,-2,0,0,1,-1,-1,1,6,-1
KR_6768853007,420,-2,-2,5,-8,-5,6,1,-1,3,2,0,2,2,1,0,1,-3,4,1,0,-7,-8,0,-5,5,1,0,-2,1,-1,-1,-1,4,-1
KR_6506683010,420,1,27,-12,1,2,0,2,1,0,1,-1,2,1,-2,4,2,1,0,1,0,-1,-8,0,-3,3,3,0,0,1,1,0,1,6,-1
KR_6731917804,420,-3,20,-43,-10,-1,3,2,-7,7,0,-1,2,1,0,5,5,-1,1,0,0,-10,5,-2,-4,6,-4,0,-2,-1,-1,-1,1,2,-1
KR_6691021605,420,0,0,-43,-6,-8,9,1,0,3,3,6,0,6,-6,6,0,2,0,2,-1,-10,3,0,-4,4,-1,0,-1,-1,-1,-1,-1,5,-1
KR_6755173678,420,1,68,3,0,1,2,3,-1,2,1,0,1,1,-4,4,0,4,4,8,0,0,-12,2,-5,3,6,0,0,1,-1,0,1,6,-1
KR_6768764329,420,-7,-94,-5,-10,-2,3,1,0,3,3,-8,8,0,1,1,2,-1,2,1,0,-4,-25,-1,-4,5,-2,0,-2,-1,-1,-1,1,1,-1
KR_6647833217,420,-2,-26,-15,2,0,0,0,-1,3,2,-2,2,0,0,2,2,5,1,6,0,5,-1,0,-6,6,-1,0,0,-1,-1,0,-1,3,-1
KR_6719500567,420,0,38,3,0,-1,2,1,-2,3,1,1,2,3,2,2,4,0,0,0,0,-1,2,5,-9,4,2,0,0,1,-1,0,1,4,-1
KR_6768638172,420,-2,-11,-4,-8,2,0,2,1,2,3,-2,5,3,-6,7,1,-3,4,1,0,-11,-42,-3,-5,8,17,0,0,-1,-1,0,-1,1,-1
KR_6765633950,420,-2,-47,-13,-3,1,1,2,1,1,2,-2,4,2,-3,5,2,0,2,2,0,-5,2,1,-6,5,-2,0,-1,1,-1,-1,1,2,-1
KR_6764211694,420,0,30,9,4,7,0,7,-2,4,2,0,2,2,-2,5,3,1,0,1,1,2,-4,-1,-4,5,-3,0,0,-1,1,-1,1,5,-1
KR_6732355279,420,-4,-87,12,-11,-4,4,0,2,3,5,-9,10,1,0,4,4,0,1,1,0,-17,-4,3,-7,4,-2,0,-3,1,1,-1,1,3,-1
KR_6720047594,420,-4,26,4,-9,0,2,2,-3,3,0,-7,7,0,1,2,3,0,0,0,0,-6,-3,-4,-4,8,-3,0,0,-1,-1,0,1,5,-1
KR_6732560290,420,-2,-28,-11,-13,-1,4,3,-4,5,1,0,2,2,-8,10,2,0,3,3,-2,-20,-1,-1,-8,9,0,0,0,-1,1,-1,-1,6,-1
KR_6688937927,420,2,40,4,4,3,1,4,2,1,3,-2,2,0,1,0,1,0,0,0,0,2,115,0,-6,6,5,0,1,1,-1,1,1,2,-1
KR_6643153441,420,2,31,-11,7,5,0,5,5,1,6,0,2,2,-2,4,2,-1,1,0,0,8,-31,2,-8,6,1,0,1,-1,1,1,-1,2,-1
KR_6736354014,420,-4,-29,-10,-9,-5,5,0,-5,9,4,-3,3,0,1,0,1,3,0,3,0,-4,23,0,-4,4,-3,0,-1,0,1,-1,-1,0,-1
KR_6749679514,420,0,-28,10,3,0,0,0,-1,2,1,-1,2,1,4,1,5,1,1,2,0,6,-9,2,-5,3,-1,0,0,1,-1,-1,1,3,-1
KR_6760624205,420,1,-10,-24,-3,-4,5,1,-1,3,2,0,5,5,2,1,3,0,1,1,0,1,-25,2,-4,2,4,0,-1,0,-1,-1,-1,0,-1
KR_6736106821,420,-2,5,-8,-3,-1,1,0,-1,2,1,-1,1,0,0,1,1,0,0,0,0,-3,0,4,-8,4,1,0,0,-1,1,0,-1,2,-1
KR_6743486707,420,-3,-48,3,-1,3,0,3,0,2,2,0,1,1,-3,3,0,-1,1,0,0,0,8,6,-12,6,2,0,0,1,1,0,1,5,-1
KR_6675201019,420,-1,-48,8,1,-1,2,1,0,1,1,-2,5,3,-1,1,0,5,0,5,0,-2,-1,1,-7,6,-1,0,0,1,-1,0,1,2,-1
KR_6750663642,420,-4,-40,-24,-2,-1,6,5,4,1,5,-3,5,2,-1,4,3,-1,1,0,0,-9,-28,1,-4,3,-2,0,1,-1,1,1,1,1,-1
KR_6706083366,420,-2,-12,-39,-3,1,1,2,-1,6,5,0,3,3,-3,4,1,0,1,1,1,0,-13,1,-5,4,2,0,0,-1,-1,-1,1,4,-1
KR_6608723309,420,-9,-108,-31,-15,0,2,2,-11,11,0,-2,3,1,-2,6,4,0,0,0,0,-13,10,3,-5,2,-7,0,-1,1,-1,-1,-1,4,-1
KR_6730071795,420,-5,-82,-24,-11,-2,2,0,-3,4,1,1,3,4,-6,7,1,-1,4,3,-1,-10,17,-3,-5,8,-1,0,-2,-1,-1,-1,-1,5,-1
KR_6757721377,420,-1,41,4,-8,1,0,1,-2,5,3,-6,7,1,-1,1,0,0,1,1,0,-15,-8,0,-3,3,0,0,0,0,1,0,1,0,-1
KR_6660601741,420,-2,5,27,-13,2,2,4,-1,3,2,-5,5,0,-8,8,0,-1,2,1,0,-21,-172,-3,-3,6,-8,0,-1,-1,1,-1,-1,5,-1
KR_6723265146,420,-3,-21,-31,-7,-4,5,1,-2,9,7,-1,1,0,0,1,1,0,0,0,-1,-6,-1,-2,-6,8,1,0,-2,-1,-1,-1,-1,1,-1
KR_6761251960,420,0,44,0,-1,-2,3,1,-3,5,2,-1,2,1,6,0,6,-1,1,0,0,-5,4,4,-9,5,0,0,1,1,1,1,-1,5,-1
KR_6749025185,420,-1,-13,-12,9,-1,4,3,3,2,5,0,5,5,5,2,7,2,1,3,1,13,5,5,-11,6,-6,0,0,-1,1,0,1,6,-1
KR_6763254291,440,-1,-17,20,-5,-5,6,1,4,2,6,1,2,3,-1,6,5,-4,4,0,2,-3,10,-1,-3,4,2,0,1,-1,-1,-1,1,2,-1
KR_6691371912,420,-4,-61,23,-7,-1,4,3,-4,10,6,-2,3,1,0,3,3,0,1,1,0,0,-11,-5,-3,8,3,0,0,-1,1,-1,-1,5,-1
KR_6745073383,420,1,54,-32,2,1,1,2,2,1,3,2,0,2,1,2,3,-4,4,0,-1,-3,-9,-4,-3,7,7,0,-1,-1,-1,-1,-1,4,-1
KR_6764207764,420,-3,7,-7,-9,1,0,1,-8,8,0,-3,4,1,-2,2,0,3,0,3,0,-6,-13,-5,-1,6,0,0,0,-1,-1,-1,-1,3,-1
KR_6767073041,420,-4,-70,-4,-9,-3,5,2,-3,4,1,-1,1,0,-4,6,2,2,1,3,0,-6,31,-1,-7,8,-11,0,0,1,1,0,-1,2,-1
KR_6746548199,440,0,-41,-3,7,0,2,2,6,0,6,2,4,6,-1,1,0,0,1,1,0,3,27,3,-8,5,1,0,2,-1,1,1,1,1,-1
KR_6654301667,420,-4,3,-18,-11,-1,2,1,-6,6,0,0,2,2,-3,4,1,-1,3,2,0,-12,7,1,-6,5,2,0,0,-1,-1,-1,-1,2,-1
KR_6762832646,440,-2,27,4,-4,-3,3,0,0,2,2,1,1,2,-1,3,2,-1,1,0,-1,-6,12,2,-6,4,-5,0,0,1,-1,1,-1,2,-1
KR_6701900235,420,1,12,33,2,2,0,2,1,2,3,0,1,1,-1,3,2,0,1,1,1,1,-8,0,-5,5,0,0,1,-1,1,1,-1,2,-1
KR_6758118696,420,-6,-52,-17,-12,-4,5,1,-1,3,2,-3,4,1,-4,5,1,0,1,1,1,-12,93,-3,-7,10,-1,0,-1,-1,-1,-1,1,1,-1
KR_6752873031,420,1,-44,0,6,2,2,4,2,1,3,5,2,7,-2,3,1,-1,1,0,-1,0,-26,-2,-3,5,-5,0,1,1,1,1,-1,3,-1
KR_6768930459,420,-2,-53,7,-4,-2,2,0,-2,6,4,-3,5,2,1,5,6,2,0,2,0,2,-10,-1,-4,5,-1,0,-1,-1,1,-1,1,2,-1
KR_6764837156,420,-8,-84,-20,-16,-1,2,1,0,1,1,-4,4,0,-9,9,0,-2,2,0,0,-22,-30,-6,-4,10,-2,-1,-5,-1,1,-1,-1,1,-1
KR_6766115485,420,5,-47,26,5,3,3,6,0,3,3,-2,3,1,4,0,4,0,1,1,-1,-1,19,-2,-9,11,3,0,3,-1,1,1,-1,4,-1
KR_6650533404,420,-3,-77,11,-5,-2,2,0,-3,3,0,3,0,3,-3,3,0,0,0,0,0,-5,-34,1,-6,5,-5,0,-1,-1,1,-1,-1,4,-1
KR_6718657750,420,0,-3,9,6,0,1,1,6,1,7,1,1,2,1,2,3,-2,4,2,0,13,9,7,-10,3,-7,0,-1,-1,1,-1,1,2,-1
KR_6736843013,420,-4,-51,3,-11,-3,3,0,-7,10,3,-1,1,0,1,5,6,-1,1,0,-1,-8,-147,-2,-3,5,4,0,0,-1,1,-1,-1,6,-1
KR_6729428309,420,0,-35,-27,-1,-2,4,2,1,5,6,-4,6,2,3,1,4,1,0,1,-1,-1,-20,-2,-4,6,2,0,0,-1,1,1,-1,6,-1
KR_6672881593,420,-1,-79,4,-2,-4,6,2,-1,4,3,1,2,3,0,2,2,2,0,2,0,3,0,3,-8,5,-5,0,0,-1,1,0,-1,3,-1
KR_6764320427,420,-3,-26,-18,-7,3,0,3,-1,4,3,-6,6,0,-3,6,3,0,0,0,0,-7,-7,3,-7,4,-2,0,0,-1,1,0,-1,3,-1
KR_6701182648,420,0,-12,-41,-7,-2,3,1,-3,6,3,3,2,5,-5,8,3,0,0,0,-1,-14,-17,2,-9,7,5,0,0,-1,-1,-1,-1,5,-1
KR_6725411492,420,-6,0,-16,-11,-2,2,0,-1,3,2,-3,4,1,-3,4,1,-2,2,0,0,-13,-2,-2,-3,5,2,0,-1,-1,-1,-1,-1,5,-1
KR_6767027162,420,0,3,-21,-1,-1,2,1,-1,4,3,2,0,2,0,1,1,-1,1,0,1,4,-48,-5,-3,8,18,0,0,-1,-1,0,1,2,-1
KR_6706468496,420,-2,-32,8,-15,-2,2,0,3,0,3,-5,12,7,-7,8,1,-4,4,0,0,-14,-4,-1,-6,7,-3,0,-1,-1,1,-1,-1,1,-1
KR_6720320624,420,-7,-84,-20,-16,-5,5,0,-5,5,0,-7,7,0,-1,3,2,2,0,2,0,-11,-12,-7,-3,10,6,0,-4,-1,1,-1,-1,4,-1
KR_6701346110,420,-2,-33,-23,-7,-2,3,1,0,4,4,-5,6,1,0,4,4,0,1,1,0,1,6,0,-6,6,-2,0,-1,-1,-1,-1,-1,2,-1
KR_6762742166,420,-5,-27,-43,-3,-5,6,1,2,1,3,0,1,1,0,3,3,0,0,0,1,6,6,3,-5,2,-2,0,-1,1,1,-1,1,1,-1
KR_6736955825,420,-4,-43,-20,-11,-1,2,1,-3,5,2,-5,5,0,-5,5,0,3,1,4,0,-11,2,0,-5,5,-5,0,-2,-1,-1,-1,1,1,-1
KR_6764447235,420,0,20,12,-2,0,3,3,-1,2,1,0,1,1,-3,4,1,2,0,2,0,-2,5,-3,-3,6,-3,0,0,-1,-1,0,1,2,-1
KR_6762636707,420,-6,-42,-35,-10,-8,9,1,-3,4,1,4,0,4,-3,6,3,0,1,1,0,-7,0,4,-7,3,-1,0,1,-1,1,1,-1,5,-1
KR_6745212077,420,-1,30,-3,2,1,1,2,4,3,7,-3,3,0,0,1,1,0,0,0,1,3,-1,10,-12,2,4,0,0,-1,1,0,1,3,-1
KR_6763836250,420,1,18,0,0,-2,2,0,0,3,3,-1,1,0,3,1,4,0,0,0,1,2,12,-1,-7,8,-6,0,-1,-1,-1,-1,1,4,-1
KR_6768545580,420,-4,4,-36,-2,1,0,1,-1,2,1,-2,3,1,0,4,4,0,1,1,0,-1,-5,4,-7,3,1,0,0,1,1,0,-1,3,-1
KR_6723729168,420,-5,-5,-33,-13,0,0,0,-6,9,3,-3,3,0,-3,4,1,-1,2,1,-1,-8,8,3,-8,5,-3,0,-1,-1,-1,-1,-1,4,-1
KR_6768409585,420,1,4,4,2,3,0,3,-1,4,3,-5,6,1,1,3,4,4,1,5,-1,-1,-43,2,-6,4,-4,0,1,1,0,1,-1,4,-1
KR_6644823439,420,-5,-25,-33,-8,-1,2,1,-9,9,0,0,1,1,1,4,5,1,0,1,0,-10,8,1,-7,6,-3,0,0,-1,-1,1,-1,4,-1
KR_6766833238,420,0,30,23,-9,-3,6,3,-1,4,3,3,0,3,0,2,2,-8,9,1,0,-13,-8,-1,-4,5,1,0,0,0,-1,0,-1,0,-1
KR_6689383184,420,-1,37,-2,1,0,1,1,5,1,6,-6,7,1,3,0,3,-1,1,0,0,-2,183,1,-7,6,-1,0,-1,1,-1,-1,1,4,-1
KR_6759193529,420,-4,-25,-23,-11,-4,5,1,-5,7,2,1,1,2,0,2,2,-3,3,0,0,-11,2,1,-3,2,1,0,-1,1,1,-1,-1,6,-1
KR_6696331255,440,-1,-39,-8,1,3,0,3,-1,1,0,2,1,3,-2,2,0,-1,6,5,0,5,31,4,-9,5,1,0,-1,1,-1,-1,1,3,-1
KR_6490711731,440,-5,-81,-53,-13,0,1,1,2,3,5,1,1,2,-5,6,1,-11,12,1,0,3,0,-1,-4,5,-1,0,-3,-1,-1,-1,-1,5,-1
KR_6728980008,420,-5,-81,22,-16,-3,3,0,-6,9,3,0,3,3,-6,7,1,-1,2,1,0,-28,0,-4,-3,7,-4,0,-2,-1,-1,-1,1,6,-1
KR_6765262826,420,-1,16,-16,-1,0,1,1,-4,5,1,4,0,4,0,0,0,-1,2,1,-1,-2,73,2,-8,6,-1,0,0,-1,-1,0,-1,5,-1
KR_6732040519,420,-3,-45,-1,-7,-3,5,2,-3,4,1,-1,4,3,-1,1,0,1,0,1,0,-10,-2,-3,-4,7,-3,0,-1,-1,-1,-1,1,6,-1
KR_6762501894,420,-3,-70,-4,-7,-5,8,3,2,0,2,1,0,1,-4,7,3,-1,1,0,0,-8,3,-4,-3,7,-2,0,-1,-1,1,-1,-1,6,-1
KR_6639814064,420,-1,-9,24,-2,1,0,1,1,1,2,-2,4,2,0,2,2,-2,3,1,0,-6,-12,1,-6,5,-2,0,1,-1,-1,1,1,6,-1
KR_6665734204,420,3,30,9,-6,-3,7,4,-2,2,0,4,5,9,-8,8,0,3,2,5,0,-14,-9,1,-5,4,-2,0,-1,0,1,-1,-1,0,-1
KR_6768945566,420,0,23,12,-1,-1,2,1,1,3,4,0,3,3,0,0,0,-1,3,2,0,1,-8,-1,-4,5,4,0,1,1,1,1,-1,2,-1
KR_6729015688,420,-3,-18,-92,-6,2,1,3,-2,3,1,-2,5,3,-5,5,0,1,2,3,0,-11,-8,-6,0,6,-2,0,0,-1,-1,-1,-1,6,-1
KR_6748011333,420,-1,-41,28,-1,2,0,2,1,3,4,-3,4,1,1,0,1,-2,3,1,1,-4,-9,-6,0,6,1,0,0,-1,-1,-1,1,1,-1
KR_6761433232,440,-1,-6,-4,-5,-1,2,1,0,1,1,0,6,6,1,1,2,-5,5,0,0,-4,0,-6,-1,7,2,0,0,-1,-1,0,1,1,-1
KR_6754951224,420,-6,-60,-24,-9,-4,4,0,0,4,4,-6,7,1,0,3,3,1,0,1,0,-15,22,3,-9,6,2,0,-3,1,-1,-1,1,6,-1
KR_6734999311,420,-2,3,-4,-5,4,0,4,-5,5,0,-2,2,0,-1,3,2,-1,2,1,0,-13,17,1,-6,5,-3,0,0,-1,1,0,1,2,-1
KR_6734228715,440,-2,28,18,-8,2,1,3,-3,4,1,0,1,1,-8,11,3,1,0,1,0,-10,8,0,-4,4,0,0,0,-1,-1,0,-1,3,-1
KR_6754593350,420,-4,-79,-21,-15,-1,2,1,-6,7,1,2,3,5,-10,11,1,0,1,1,0,-16,32,-6,-6,12,5,0,-1,-1,-1,-1,-1,2,-1
KR_6661891753,420,0,-19,-14,-7,-4,4,0,-2,3,1,-2,2,0,4,1,5,-3,4,1,0,-7,129,2,-6,4,-3,0,0,-1,-1,-1,-1,4,-1
KR_6688134367,420,-3,-61,12,-7,2,1,3,-1,2,1,-1,4,3,-7,8,1,0,0,0,0,-21,-40,-4,-10,14,19,0,-1,-1,1,-1,1,3,-1
KR_6768036045,420,-5,-60,-52,-7,-6,7,1,0,4,4,1,0,1,0,5,5,-2,2,0,0,3,10,2,-4,2,0,0,0,1,-1,-1,-1,2,-1
KR_6767649292,420,-1,34,27,-5,-1,2,1,-4,5,1,-1,5,4,4,0,4,-3,3,0,1,-12,5,0,-6,6,6,0,0,-1,1,-1,1,1,-1
KR_6681383578,420,-1,8,-32,-3,-1,6,5,5,1,6,0,2,2,-8,9,1,1,0,1,0,-5,7,3,-8,5,-3,0,-2,1,-1,-1,1,6,-1
KR_6568810074,420,-2,-17,-12,-3,0,1,1,-4,5,1,0,3,3,0,1,1,1,0,1,0,-3,-1,-1,-9,10,0,0,0,-1,1,-1,-1,6,-1
KR_6763847581,420,-8,-83,-24,-16,-9,9,0,-3,4,1,-3,4,1,-1,3,2,0,1,1,1,-7,-4,-1,-4,5,-4,0,-4,-1,-1,-1,1,3,-1
KR_6761511200,440,-6,-47,-16,-11,-5,6,1,-3,3,0,0,2,2,-3,4,1,0,1,1,1,-5,-5,4,-6,2,-5,0,-2,-1,-1,-1,1,3,-1
KR_6759713332,420,2,4,13,5,1,0,1,2,2,4,-1,2,1,2,1,3,1,1,2,0,2,4,-6,-8,14,-2,0,1,1,1,1,1,5,-1
KR_6760927922,420,0,-23,10,1,4,0,4,1,3,4,-2,4,2,-3,4,1,1,0,1,0,-2,0,-6,-3,9,1,0,0,-1,-1,0,1,3,-1
KR_6749915324,420,-5,-43,-17,-12,-3,4,1,-6,7,1,2,1,3,-4,5,1,-1,1,0,0,-7,1,-2,-5,7,-2,0,-1,1,-1,-1,-1,6,-1
KR_6712261242,420,-4,-81,16,-9,-6,7,1,-6,8,2,-2,2,0,3,1,4,2,1,3,0,-6,1,-3,-3,6,1,0,0,-1,-1,-1,1,2,-1
KR_6746953381,420,-2,3,22,-2,-1,2,1,2,6,8,-2,2,0,-2,4,2,1,1,2,1,-8,-313,-2,-7,9,0,0,0,1,1,-1,1,5,-1
KR_6744615089,440,-5,-84,-10,-16,2,0,2,-8,9,1,-6,7,1,-4,5,1,0,1,1,0,-18,10,-3,-3,6,-6,0,-2,-1,-1,-1,-1,6,-1
KR_6725052688,420,-2,-35,-12,-8,1,1,2,-4,5,1,-1,3,2,-4,8,4,0,1,1,0,-10,-3,-5,-6,11,-2,0,1,-1,1,1,-1,3,-1
KR_6764087075,420,-3,-81,-24,-2,-2,2,0,1,1,2,-1,2,1,-1,3,2,1,1,2,0,0,-7,-1,-5,6,1,0,-1,1,-1,-1,-1,1,-1
KR_6764138728,420,-2,-13,-33,-8,-2,2,0,1,3,4,-1,2,1,-5,8,3,-1,1,0,1,-8,-11,-3,-7,10,8,0,-1,1,-1,-1,1,4,-1
KR_6763699800,420,1,-5,-26,-2,-2,4,2,-1,1,0,-3,4,1,3,0,3,1,0,1,0,2,7,-3,-6,9,-6,0,0,1,-1,-1,1,3,-1
KR_6732162395,420,1,-5,-8,1,0,1,1,-1,3,2,5,1,6,-3,4,1,0,0,0,0,-4,-5,-2,-4,6,0,0,0,1,1,0,-1,4,-1
KR_6719038146,420,1,117,27,-6,-1,2,1,-1,3,2,-3,4,1,-2,4,2,1,1,2,-1,-12,-70,-1,-6,7,6,0,1,1,-1,1,-1,1,-1
KR_6715458315,420,1,-2,-8,2,1,0,1,1,3,4,-2,5,3,-2,4,2,4,1,5,0,2,27,-3,-4,7,-18,0,0,-1,-1,1,-1,2,-1
KR_6767390600,440,-3,-42,-24,-4,-7,7,0,6,1,7,-1,3,2,-4,5,1,2,0,2,0,7,7,2,-4,2,-3,0,1,-1,-1,1,-1,6,-1
KR_6767722263,420,0,-9,4,0,-3,3,0,-5,6,1,3,0,3,1,1,2,4,2,6,0,0,0,-8,-2,10,5,0,0,1,-1,0,1,2,-1
KR_6752959864,420,0,3,0,6,2,2,4,-5,8,3,3,1,4,1,2,3,5,0,5,1,12,-24,-4,-2,6,3,0,2,-1,1,1,1,4,-1
KR_6746548938,420,-3,-15,0,-6,1,2,3,-4,4,0,-3,4,1,0,2,2,0,0,0,-1,-5,55,3,-7,4,3,0,1,-1,1,1,-1,4,-1
KR_6693296972,420,1,-20,-7,0,-3,3,0,3,2,5,1,1,2,-3,5,2,2,0,2,0,3,-1,2,-8,6,-5,0,-2,-1,-1,-1,-1,2,-1
KR_6769156020,420,1,34,-36,-2,-1,2,1,0,2,2,0,3,3,-1,3,2,0,1,1,1,-11,0,-2,-4,6,2,0,1,1,1,1,1,2,-1
KR_6760423086,420,-5,-35,-47,-15,-4,4,0,-8,8,0,-1,6,5,-3,9,6,1,0,1,-1,-9,-4,1,-5,4,-5,0,-1,0,-1,-1,-1,0,-1
KR_6723728816,420,2,24,-4,5,0,2,2,-1,2,1,3,0,3,1,2,3,2,0,2,0,1,-1,0,-5,5,6,0,0,-1,-1,0,-1,6,-1
KR_6757197170,420,-3,-48,-8,-8,1,1,2,-7,7,0,-2,2,0,-1,2,1,1,1,2,0,-13,-4,0,-9,9,-1,0,1,1,-1,1,-1,5,-1
KR_6763987715,420,0,32,-9,-6,-3,3,0,-2,2,0,0,3,3,-1,1,0,0,0,0,0,-7,-76,0,-4,4,4,0,1,1,-1,1,-1,1,-1
KR_6742129053,420,-3,-29,-14,0,-4,4,0,-2,7,5,1,3,4,3,5,8,2,0,2,0,2,-27,-5,-5,10,7,0,1,1,1,1,-1,6,-1
KR_6768796551,420,1,-22,-30,-4,2,1,3,6,0,6,-4,4,0,-7,8,1,-1,1,0,0,-2,38,5,-7,2,0,0,1,-1,-1,1,-1,6,-1
KR_6730575264,420,1,40,-11,5,1,1,2,-3,5,2,2,1,3,4,0,4,1,1,2,0,7,-12,-2,-7,9,3,0,-1,1,-1,-1,1,2,-1
KR_6760464264,420,-4,-28,-5,-11,-4,5,1,0,1,1,-4,6,2,-2,2,0,-1,1,0,0,-8,2,5,-10,5,-4,0,-2,-1,-1,-1,-1,1,-1
KR_6737701831,440,-6,-29,-30,-15,-3,3,0,-1,3,2,-3,4,1,-4,7,3,-4,5,1,0,-23,-15,1,-3,2,-3,0,-2,-1,0,-1,-1,3,-1
KR_6759681941,440,0,12,-17,2,3,1,4,1,4,5,-1,4,3,1,1,2,-2,4,2,0,5,-1,-6,-5,11,-2,0,1,-1,1,1,-1,4,-1
KR_6767615944,420,0,-76,-12,0,-3,4,1,0,0,0,3,1,4,0,0,0,0,0,0,0,4,-20,1,-9,8,7,0,0,1,-1,0,-1,4,-1
KR_6750558993,420,3,40,0,3,-4,5,1,7,0,7,0,4,4,0,3,3,0,3,3,0,2,-108,-2,-9,11,1,0,1,1,-1,1,-1,5,-1
KR_6758198434,420,-4,-82,-27,-9,-2,3,1,-3,4,1,-3,3,0,-1,1,0,0,0,0,0,-4,-19,1,-5,4,2,0,0,-1,-1,0,-1,3,-1
KR_6752760800,420,-3,-59,-17,-9,-3,4,1,-3,7,4,-4,5,1,2,1,3,-1,1,0,-1,-4,-5,0,-9,9,-2,0,-1,1,1,-1,1,4,-1
KR_6763183857,420,-1,-79,-9,-1,1,3,4,0,3,3,1,0,1,-4,5,1,1,0,1,-2,-2,-18,-2,-3,5,3,0,1,-1,1,1,-1,6,-1
KR_6714039896,420,0,-19,-16,3,-3,3,0,2,3,5,3,0,3,-1,3,2,2,3,5,0,5,2,1,-7,6,0,0,0,-1,-1,0,-1,1,-1
KR_6768652091,420,2,46,-24,3,1,1,2,1,1,2,-1,2,1,0,1,1,2,3,5,0,7,1,3,-8,5,2,0,1,-1,1,1,1,1,-1
KR_6704196011,420,3,42,-14,6,5,3,8,-3,6,3,1,2,3,2,2,4,1,0,1,0,4,36,1,-4,3,3,0,0,-1,1,1,1,4,-1
KR_6768486513,420,-9,-127,-4,-14,-2,3,1,-3,3,0,-7,8,1,-1,4,3,-1,1,0,0,-9,6,0,-8,8,-9,0,-4,-1,-1,-1,1,4,-1
KR_6746683886,420,-5,16,3,-16,-1,2,1,-4,6,2,-1,4,3,-7,9,2,-3,3,0,0,-23,-13,-1,-5,6,-1,0,0,1,-1,-1,-1,6,-1
KR_6767251067,420,1,17,-4,-4,0,4,4,0,2,2,-2,4,2,-3,3,0,1,0,1,0,-5,209,0,-5,5,1,0,1,-1,-1,1,1,4,-1
KR_6755379128,420,-2,-64,-8,-4,-3,4,1,3,1,4,1,2,3,-2,4,2,-3,4,1,0,-6,-28,-2,-5,7,1,0,-2,-1,-1,-1,-1,4,-1
KR_6753043818,420,-2,-27,-28,-8,-6,6,0,-1,3,2,1,2,3,1,3,4,-3,4,1,0,-7,-10,-7,-3,10,4,0,-2,0,-1,-1,-1,0,-1
KR_6766715057,420,-2,-23,-4,-3,2,0,2,-1,1,0,2,1,3,-4,4,0,-2,2,0,0,-5,31,-1,-5,6,-26,0,0,-1,1,-1,-1,6,-1
KR_6761041865,420,-5,-22,2,-8,0,0,0,-1,2,1,-3,3,0,-3,7,4,-1,1,0,0,-9,-2,-4,-6,10,-5,0,0,1,-1,0,1,5,-1
KR_6691308646,420,-1,7,20,-7,-3,4,1,1,2,3,-6,6,0,-1,1,0,2,0,2,0,-9,-1,2,-8,6,-3,0,-1,-1,-1,-1,-1,2,-1
KR_6740750727,440,-1,58,-1,-4,0,2,2,0,1,1,1,3,4,-5,8,3,0,0,0,0,-11,-41,1,-8,7,0,0,0,-1,-1,1,-1,2,-1
KR_6734358467,420,-4,-21,-12,-9,-2,3,1,0,3,3,-4,4,0,0,1,1,-3,3,0,0,-2,-49,0,-5,5,17,0,0,-1,-1,-1,-1,2,-1
KR_6689846754,420,-1,-38,-27,-1,-2,3,1,-1,1,0,0,1,1,3,2,5,-1,1,0,0,-3,-6,-1,-6,7,1,0,-1,-1,-1,-1,-1,2,-1
KR_6761759557,420,3,18,-1,-2,3,0,3,-2,4,2,-5,5,0,1,5,6,1,1,2,-1,-10,5,0,-10,10,-5,0,3,-1,1,1,-1,4,-1
KR_6767268138,440,-1,-30,20,-6,-2,3,1,3,2,5,-2,3,1,-4,5,1,-1,2,1,1,-4,-6,-3,-2,5,1,0,-1,-1,-1,-1,1,3,-1
KR_6750328846,420,4,53,21,8,1,1,2,0,1,1,4,0,4,3,2,5,0,0,0,0,7,28,0,-6,6,4,0,1,-1,0,1,1,4,-1
KR_6738046084,420,-3,-14,2,-3,0,0,0,-1,4,3,-1,3,2,-1,1,0,0,0,0,0,-1,-6,-4,-3,7,-5,0,-1,-1,-1,-1,-1,6,-1
KR_6683107511,420,-2,-3,-16,-1,-1,2,1,-2,5,3,-1,3,2,2,2,4,1,0,1,-1,1,133,3,-7,4,-7,0,0,1,-1,0,-1,2,-1
KR_6708372865,420,-3,-13,-2,-12,0,3,3,0,3,3,-3,7,4,-1,1,0,-8,9,1,0,-22,320,-4,-4,8,-2,0,1,-1,1,1,-1,5,-1
KR_6765606179,440,-3,-87,-17,-7,-1,2,1,1,3,4,-5,5,0,0,8,8,-2,2,0,-2,-6,-6,0,-4,4,-3,0,-1,-1,-1,-1,-1,4,-1
KR_6769180826,420,0,-20,-14,0,1,0,1,-3,8,5,-1,5,4,-1,5,4,4,1,5,1,-7,6,-3,-4,7,-6,0,0,-1,1,1,-1,3,-1
KR_6769078628,420,-1,-28,-32,-5,-3,3,0,-4,5,1,-2,4,2,0,2,2,4,0,4,0,-13,5,0,-5,5,0,0,0,-1,-1,-1,1,5,-1
KR_6683249111,420,1,-32,2,-2,-2,4,2,-2,3,1,3,2,5,1,1,2,-2,3,1,2,-2,-3,2,-7,5,4,0,0,1,-1,-1,1,6,-1
KR_6762912200,440,-8,-78,-89,-20,0,5,5,-6,9,3,0,0,0,-7,8,1,-7,8,1,0,-17,3,3,-4,1,2,0,-3,-1,-1,-1,-1,6,-1
KR_6752042167,420,-2,-65,-8,-10,-6,7,1,2,5,7,-5,6,1,-2,3,1,1,1,2,0,-8,3,3,-7,4,-7,0,-3,0,-1,-1,-1,0,-1
KR_6766434902,420,1,-40,-19,-1,-2,2,0,-4,7,3,0,3,3,1,1,2,4,0,4,0,0,-29,5,-8,3,-1,0,0,1,-1,0,-1,5,-1
KR_6764535374,420,1,-66,76,5,0,3,3,2,1,3,-2,3,1,5,1,6,0,2,2,0,3,6,4,-9,5,3,0,0,1,0,1,-1,4,-1
KR_6763731361,420,-3,-84,-4,-9,-1,2,1,2,3,5,-5,5,0,-3,4,1,-2,2,0,0,-8,-203,-2,-3,5,0,0,-1,-1,1,-1,-1,3,-1
KR_6731287130,420,0,-45,-25,-4,-4,4,0,0,3,3,0,3,3,1,0,1,-1,1,0,0,-1,-4,-1,-5,6,3,0,-1,-1,-1,-1,1,6,-1
KR_6768549793,420,-3,-25,-10,-7,0,2,2,-1,3,2,-1,4,3,-2,2,0,-3,5,2,0,-8,-4,-1,-7,8,-1,0,-1,-1,-1,-1,-1,5,-1
KR_6764839148,440,1,33,24,8,0,1,1,0,2,2,1,1,2,6,0,6,1,0,1,0,11,10,2,-7,5,-1,0,-1,1,1,1,1,5,-1
KR_6758296383,420,-1,-53,-1,-4,-1,3,2,1,3,4,-1,4,3,-4,4,0,1,2,3,0,-7,19,-4,-4,8,3,0,0,-1,-1,-1,-1,6,-1
KR_6768706954,440,2,-1,0,2,0,2,2,2,1,3,-1,1,0,1,0,1,0,0,0,0,1,-19,0,-5,5,-2,0,1,1,1,1,-1,6,-1
KR_6620316371,420,0,-20,-4,-3,-5,6,1,0,2,2,2,1,3,0,1,1,0,0,0,1,-7,-1,-7,-4,11,0,0,0,1,0,0,1,5,-1
KR_6765675800,420,-6,-61,-24,-12,-4,4,0,-2,3,1,-1,4,3,-6,9,3,1,0,1,0,-13,22,1,-4,3,3,0,-1,-1,1,-1,1,5,-1
KR_6756518141,420,0,-9,32,2,-3,3,0,3,3,6,0,2,2,6,2,8,-4,4,0,2,2,-6,0,-3,3,1,0,0,1,1,1,1,1,-1
KR_6691353478,420,-2,-33,-19,3,1,2,3,4,1,5,-5,5,0,1,2,3,2,0,2,0,8,4,3,-8,5,1,0,-3,1,-1,-1,-1,3,-1
KR_6734713418,420,-4,-51,3,-5,-9,9,0,1,4,5,0,2,2,4,2,6,-1,2,1,-1,-9,-280,1,-6,5,-1,0,-1,1,-1,-1,-1,1,-1
KR_6766680953,420,-4,-46,-14,-14,-3,4,1,1,0,1,-4,7,3,-6,8,2,-2,3,1,0,-9,-4,1,-2,1,0,0,-2,-1,-1,-1,-1,3,-1
KR_6709532433,420,-2,-109,4,-7,-3,3,0,3,3,6,0,1,1,-6,9,3,-1,3,2,0,-4,1,1,-7,6,0,0,0,1,-1,-1,1,2,-1
KR_6762063718,420,-8,-70,-28,-18,-4,5,1,-5,6,1,-7,9,2,0,4,4,-2,2,0,-2,-23,-8,-4,-2,6,4,0,-2,1,-1,-1,-1,3,-1
KR_6732577611,420,-3,-54,-5,-4,-1,2,1,-1,2,1,-4,5,1,3,0,3,-1,1,0,0,-2,47,-4,-4,8,-14,0,-1,0,-1,-1,-1,0,-1
KR_6737915056,420,-8,-76,-12,-27,-5,7,2,-4,4,0,-4,7,3,-10,10,0,-4,4,0,0,-13,4,-2,-3,5,-3,0,-4,-1,-1,-1,-1,3,-1
KR_6656623096,420,-4,-42,-26,-13,0,1,1,0,2,2,-5,5,0,-5,7,2,-3,3,0,0,-23,-67,4,-5,1,-2,0,-1,1,-1,-1,-1,6,-1
KR_6633806154,420,-6,-75,5,-10,-1,3,2,-7,9,2,-4,4,0,3,0,3,-1,1,0,0,-4,102,2,-5,3,-2,0,-2,1,-1,-1,-1,4,-1
KR_6765772322,440,-3,26,-8,-14,-8,8,0,-1,4,3,-4,4,0,0,1,1,-1,1,0,0,-6,-9,-1,-4,5,0,0,-2,-1,-1,-1,-1,2,-1
KR_6764170074,440,-2,-91,-9,-4,0,4,4,-2,3,1,-1,6,5,-1,1,0,0,1,1,1,-9,9,5,-8,3,-6,0,-1,1,-1,-1,1,5,-1
KR_6614274737,420,-4,-26,-6,-13,-5,7,2,-3,3,0,-4,5,1,0,3,3,-1,2,1,-1,-11,-31,-4,-3,7,0,0,-1,-1,-1,-1,-1,6,-1
KR_6723051625,420,0,21,-6,-4,1,2,3,0,2,2,-5,5,0,1,1,2,-1,2,1,0,-7,3,1,-9,8,2,0,0,-1,1,0,1,2,-1
KR_6763148781,420,-5,-15,-1,-15,-3,4,1,2,2,4,-1,2,1,-14,15,1,1,0,1,0,-23,-10,-4,-3,7,-2,0,-2,-1,-1,-1,1,3,-1
KR_6763844428,420,0,-15,12,1,0,1,1,2,2,4,-2,2,0,0,2,2,1,0,1,0,-1,7,4,-7,3,-7,0,-1,-1,-1,-1,-1,6,-1
KR_6759459920,420,-3,-24,-24,-8,0,2,2,-2,5,3,-6,10,4,1,2,3,-1,2,1,0,-6,-1,-3,-3,6,3,0,0,-1,1,1,1,6,-1
KR_6763622308,420,-1,-11,24,-1,3,1,4,-1,6,5,0,2,2,-2,4,2,-1,1,0,0,-3,-9,0,-6,6,2,0,1,1,1,1,1,5,-1
KR_6752715346,420,-4,-43,20,-8,-1,1,0,-1,4,3,-1,3,2,-5,6,1,0,1,1,0,-6,6,-6,-2,8,-7,0,-2,1,-1,-1,-1,1,-1
KR_6760990034,420,0,-32,-3,-5,-5,7,2,0,1,1,0,3,3,0,4,4,0,1,1,-1,-3,-5,-1,-5,6,-1,0,-2,-1,-1,-1,-1,3,-1
KR_6749145379,420,-1,-22,-15,-5,0,1,1,7,2,9,-5,7,2,-3,4,1,-4,5,1,0,4,-3,5,-9,4,-3,0,-2,-1,1,-1,-1,6,-1
KR_6764600145,420,3,65,40,2,-1,2,1,-2,4,2,1,1,2,3,5,8,1,0,1,0,3,-6,0,-7,7,-2,0,1,1,1,1,-1,5,-1
KR_6766578561,440,0,14,8,-3,0,1,1,-2,2,0,-4,4,0,3,0,3,0,2,2,0,-10,8,-3,-2,5,0,0,0,0,-1,0,-1,0,-1
KR_6762167200,420,2,71,-9,-2,-1,2,1,-4,5,1,1,2,3,1,1,2,1,2,3,0,-7,-17,2,-7,5,6,0,0,-1,-1,0,-1,1,-1
KR_6761066724,420,-2,-71,17,-2,-3,4,1,0,1,1,-1,2,1,0,3,3,2,0,2,1,2,-309,3,-7,4,-1,0,-2,1,1,-1,1,5,-1
KR_6768834407,420,-2,-6,8,0,-1,2,1,7,0,7,1,2,3,-3,4,1,-4,4,0,0,-3,0,1,-8,7,-5,0,-1,-1,1,-1,-1,6,-1
KR_6749972550,420,-3,6,-7,-9,-2,4,2,1,2,3,0,3,3,-6,6,0,-2,2,0,0,-9,-4,-2,-5,7,-3,0,-1,-1,-1,-1,1,4,-1
KR_6694710908,420,-3,-99,-19,-13,-1,2,1,0,0,0,3,3,6,-8,9,1,-7,7,0,0,-4,0,2,-6,4,-2,0,-1,-1,1,-1,1,4,-1
KR_6724805325,420,-4,-20,-20,-2,1,1,2,-2,4,2,0,1,1,1,1,2,-2,2,0,0,-1,-44,0,-7,7,24,0,-1,1,-1,-1,-1,5,-1
KR_6765338790,420,0,-33,23,-5,-3,3,0,0,1,1,3,2,5,-6,8,2,1,0,1,0,-5,-53,-1,-6,7,25,0,-2,1,-1,-1,1,1,-1
KR_6743414597,420,-2,-36,5,-4,0,1,1,0,2,2,-2,4,2,-1,5,4,-1,2,1,0,1,-3,-1,-3,4,0,0,-1,-1,-1,-1,-1,2,-1
KR_6768269537,440,-1,-41,-1,0,0,2,2,0,1,1,2,0,2,-4,7,3,2,3,5,-1,14,-1,0,-3,3,-1,0,-2,1,-1,-1,-1,3,-1
KR_6762838920,440,-1,-93,-8,-1,-1,1,0,0,1,1,-2,5,3,2,2,4,0,0,0,0,6,52,-2,-4,6,-1,0,-1,-1,-1,-1,-1,4,-1
KR_6653420458,420,-3,-41,8,-4,-5,6,1,-1,3,2,-1,1,0,3,1,4,0,0,0,0,1,-26,3,-6,3,-2,0,0,-1,1,1,1,4,-1
KR_6766673806,420,-6,-35,-56,-9,3,0,3,-5,5,0,-5,6,1,0,1,1,-2,2,0,0,-9,-5,-6,-2,8,-3,0,-1,-1,-1,-1,1,1,-1
KR_6748044115,420,0,-9,-20,0,0,0,0,2,4,6,0,3,3,-2,5,3,0,1,1,1,-1,-198,0,-7,7,-4,0,-1,-1,-1,-1,1,5,-1
KR_6686300377,420,2,-1,17,-3,1,1,2,1,2,3,0,0,0,-5,7,2,0,2,2,-1,-5,-1,-4,-3,7,0,0,1,1,1,1,-1,1,-1
KR_6764823249,440,1,-7,15,1,-1,3,2,2,0,2,-1,1,0,2,0,2,-1,1,0,0,1,9,6,-7,1,5,0,-1,1,1,-1,1,6,-1
KR_6768847046,420,2,114,12,0,-1,3,2,-3,8,5,0,3,3,2,1,3,2,2,4,-1,1,-2,-4,-5,9,-2,0,0,1,-1,0,-1,1,-1
KR_6768926102,420,0,-49,12,4,2,0,2,2,4,6,1,1,2,-1,2,1,0,0,0,0,-2,-1,-2,-5,7,3,0,-1,-1,1,-1,1,3,-1
KR_6728950136,420,2,53,-6,5,-1,2,1,4,1,5,1,2,3,2,1,3,-1,1,0,0,10,-3,1,-4,3,1,0,0,1,-1,0,1,6,-1
KR_6678126243,420,-4,-47,-23,-6,-1,3,2,2,2,4,-3,4,1,-6,8,2,2,0,2,0,-4,-3,0,-10,10,1,0,-3,1,-1,-1,-1,1,-1
KR_6756528582,420,-2,-23,10,-5,-1,2,1,0,0,0,1,1,2,-5,7,2,0,0,0,0,-10,3,2,-7,5,0,0,-1,-1,-1,-1,1,2,-1
KR_6762872445,420,0,14,20,2,-1,1,0,-2,2,0,-1,2,1,5,3,8,1,1,2,0,10,-2,1,-7,6,3,0,1,-1,1,1,-1,4,-1
KR_6767065028,420,1,33,10,2,-1,1,0,-1,4,3,5,2,7,1,3,4,-2,2,0,0,2,406,3,-8,5,1,0,0,1,-1,0,-1,1,-1
KR_6718606373,420,-2,35,-37,-4,-3,3,0,1,4,5,-1,1,0,0,1,1,-1,2,1,0,-7,4,-2,-7,9,-1,0,0,-1,1,0,1,5,-1
KR_6647778353,420,1,34,0,0,-2,2,0,1,4,5,3,1,4,-1,3,2,-1,2,1,2,-10,-1,-2,-5,7,-2,0,-1,1,-1,-1,1,1,-1
KR_6765258271,440,-3,81,-21,-3,0,1,1,-1,4,3,1,1,2,-3,5,2,0,0,0,-1,-3,-3,-4,-3,7,0,0,-1,-1,-1,-1,-1,5,-1
KR_6766917346,420,0,-23,-20,2,-1,2,1,-1,1,0,0,4,4,2,2,4,2,1,3,-1,1,-3,0,-5,5,6,0,0,1,-1,1,-1,6,-1
KR_6711464410,420,-5,-48,12,-14,-3,6,3,-8,11,3,-1,3,2,-3,4,1,1,0,1,-2,-11,-11,-4,-4,8,6,0,-2,-1,-1,-1,-1,3,-1
KR_6698775782,420,-1,-64,24,-2,1,2,3,2,1,3,-3,4,1,-3,5,2,1,1,2,0,0,-11,-2,-4,6,-5,0,-1,-1,1,-1,-1,4,-1
KR_6738721005,420,-1,-42,25,-3,-1,3,2,-1,3,2,-6,6,0,7,2,9,-2,5,3,0,-7,11,0,-3,3,-1,0,1,1,-1,1,1,4,-1
KR_6672172956,420,-3,-23,6,-11,0,1,1,-2,3,1,0,3,3,-7,9,2,-2,2,0,0,-7,-50,-3,-5,8,20,0,-2,-1,-1,-1,-1,4,-1
KR_6766169133,420,3,56,-18,6,0,0,0,1,2,3,3,0,3,1,3,4,1,1,2,0,5,-106,2,-5,3,3,0,-1,0,-1,-1,-1,0,-1
KR_6768180494,420,-5,16,-2,-7,-3,6,3,0,2,2,-1,2,1,-1,3,2,-2,2,0,1,-11,-42,4,-10,6,1,0,-1,-1,-1,-1,1,1,-1
KR_6670739942,440,-4,-68,-8,-8,-2,4,2,-1,1,0,-5,6,1,1,1,2,-1,2,1,0,-8,-2,1,-3,2,-1,0,-2,-1,-1,-1,-1,6,-1
KR_6764203136,420,-5,-51,-28,-13,-7,7,0,-2,3,1,-3,3,0,0,2,2,-1,1,0,0,-10,-36,-1,-2,3,-4,0,-1,-1,-1,-1,-1,1,-1
KR_6703436010,420,-1,-18,-10,-7,-4,5,1,0,4,4,-3,5,2,1,0,1,-1,2,1,0,-4,-19,-4,-1,5,0,0,0,-1,-1,0,-1,6,-1
KR_6766060320,420,-4,-49,-8,-12,-6,6,0,-3,7,4,-3,4,1,0,4,4,0,0,0,0,-18,53,-6,-3,9,0,0,-1,1,-1,-1,-1,1,-1
KR_6705139326,420,-4,-67,-9,-10,0,1,1,-2,5,3,-6,6,0,-1,5,4,-1,1,0,-1,-16,-1,-4,-5,9,-6,0,-1,-1,-1,-1,-1,4,-1
KR_6738499818,420,-2,-13,3,-6,-4,6,2,-7,9,2,3,3,6,7,1,8,-5,5,0,0,0,-8,-5,-3,8,1,0,0,-1,-1,-1,1,5,-1
KR_6759459754,420,0,8,19,1,-2,3,1,1,4,5,-1,3,2,3,2,5,0,1,1,1,12,13,-3,-8,11,-12,0,0,1,-1,1,1,2,-1
KR_6759385072,420,1,-21,1,4,2,1,3,-3,6,3,3,1,4,4,0,4,-2,3,1,0,4,8,6,-11,5,1,0,0,-1,1,1,-1,4,-1
KR_6768456953,420,2,7,8,-3,2,0,2,-2,4,2,-1,3,2,-4,5,1,2,1,3,0,-10,-74,6,-10,4,0,0,0,-1,-1,-1,-1,1,-1
KR_6768265572,420,-2,-55,8,2,0,1,1,-1,5,4,1,1,2,2,2,4,0,0,0,0,6,1,-1,-4,5,2,0,-2,1,-1,-1,-1,1,-1
KR_6755251389,420,2,78,-12,5,9,0,9,-5,5,0,0,1,1,2,2,4,-1,1,0,1,-3,8,6,-8,2,1,0,0,1,-1,1,1,1,-1
KR_6761805918,420,-4,-69,-8,-2,0,2,2,-1,3,2,-3,5,2,1,2,3,1,1,2,0,1,3,-2,-4,6,-1,0,0,-1,0,0,1,6,-1
KR_6729095149,420,-2,-93,15,-10,-4,4,0,3,7,10,-7,8,1,-2,3,1,0,2,2,0,-7,36,3,-5,2,-13,0,-1,1,1,-1,-1,6,-1
KR_6762636620,420,-3,-32,-23,-1,0,3,3,1,2,3,-2,4,2,-1,5,4,1,0,1,0,1,-29,0,-4,4,4,0,0,-1,1,-1,1,4,-1
KR_6765984828,420,-3,-5,-20,1,-2,2,0,2,0,2,2,0,2,-2,2,0,1,1,2,0,3,-7,1,-7,6,6,0,1,-1,1,1,1,5,-1
KR_6611120016,420,-1,-27,-7,-7,2,1,3,-5,8,3,-7,7,0,2,2,4,1,0,1,0,-7,2,-3,-3,6,1,0,-2,1,-1,-1,-1,5,-1
KR_6767249363,420,-5,-44,-2,-13,3,1,4,-6,8,2,-3,5,2,-3,4,1,-4,5,1,0,-14,15,2,-4,2,-3,0,0,-1,1,-1,1,6,-1
KR_6737053736,420,0,-70,12,5,1,3,4,1,2,3,5,0,5,-2,3,1,0,1,1,0,-2,25,-1,-5,6,-1,0,0,1,1,0,-1,5,-1
KR_6717538094,420,-2,18,1,-12,1,1,2,-2,4,2,-5,6,1,-6,7,1,0,2,2,0,-9,-6,-5,-5,10,-5,0,0,1,-1,0,-1,2,-1
KR_6675131704,420,-2,-49,13,-7,-4,4,0,-2,3,1,-2,3,1,1,1,2,0,0,0,0,-3,31,0,-6,6,-7,0,-1,-1,1,-1,-1,2,-1
KR_6758127023,420,-2,83,0,-11,-3,3,0,-8,8,0,0,1,1,-1,2,1,1,0,1,0,-17,-8,-2,-5,7,-1,0,0,-1,-1,0,-1,5,-1
KR_6757404998,420,-1,-56,-8,0,-3,4,1,1,3,4,1,3,4,1,4,5,0,3,3,0,3,-9,-1,-6,7,0,0,-2,1,1,-1,-1,1,-1
KR_6754383141,420,-2,-2,-4,-9,-2,2,0,-8,9,1,0,1,1,2,1,3,-1,2,1,0,-12,-12,-5,-4,9,3,0,1,1,1,1,-1,5,-1
KR_6725479653,420,-2,16,1,-4,4,0,4,-4,8,4,-8,8,0,4,3,7,0,2,2,0,-5,-314,2,-6,4,-15,0,0,-1,1,0,1,1,-1
KR_6757949981,420,-2,3,0,2,-2,2,0,0,4,4,-2,3,1,6,1,7,0,1,1,0,1,9,3,-5,2,-3,0,0,0,1,0,1,0,-1
KR_6649518065,420,3,38,-3,5,2,1,3,-3,4,1,1,2,3,4,1,5,1,0,1,-1,2,2,-2,-7,9,-1,0,-1,-1,-1,-1,-1,2,-1
KR_6743276907,420,-4,-61,-8,-4,-1,3,2,4,1,5,-5,7,2,-2,4,2,0,0,0,-1,6,-6,-6,-5,11,-6,0,-2,-1,-1,-1,-1,5,-1
KR_6661941133,420,-3,-48,-8,-9,-3,3,0,-3,4,1,2,3,5,-6,8,2,1,0,1,0,-13,17,-4,-6,10,-1,0,-2,-1,-1,-1,-1,6,-1
KR_6765813871,420,-4,-61,8,0,0,1,1,1,1,2,-1,2,1,0,3,3,0,0,0,0,1,-5,4,-9,5,-4,0,0,1,1,0,1,6,-1
KR_6637434521,420,-2,-17,-16,-4,1,0,1,-4,8,4,-2,2,0,0,3,3,1,0,1,0,-6,11,2,-6,4,-2,0,-1,-1,-1,-1,-1,4,-1
KR_6769163720,420,-5,-76,40,-11,1,1,2,-3,4,1,-5,9,4,-6,8,2,2,0,2,0,-13,-22,-1,-7,8,-3,0,-3,1,-1,-1,1,1,-1
KR_6760511029,420,-4,-99,-36,-11,1,0,1,-3,5,2,-5,5,0,-2,2,0,-2,5,3,0,-13,5,0,-5,5,-1,0,-1,1,-1,-1,-1,2,-1
KR_6750073947,420,-1,-21,16,-4,-1,2,1,1,3,4,-1,5,4,-2,6,4,-1,2,1,0,1,1,0,-12,12,-6,0,-1,1,-1,-1,-1,4,-1
KR_6762903660,440,1,-3,19,3,0,1,1,2,1,3,5,0,5,0,0,0,-4,5,1,-2,-7,-2,-2,-5,7,-4,0,-1,1,1,-1,-1,5,-1
KR_6760547218,420,-3,-22,-30,-3,4,0,4,-1,3,2,1,4,5,-3,4,1,-4,4,0,0,-4,4,2,-6,4,-3,0,1,-1,1,1,-1,4,-1
KR_6757363835,420,-2,-15,-15,-3,-2,3,1,-2,7,5,-3,3,0,3,3,6,1,1,2,0,-2,19,5,-9,4,-1,0,-1,-1,-1,-1,-1,4,-1
KR_6768618854,420,0,-39,2,3,-1,1,0,4,3,7,-1,2,1,0,4,4,1,2,3,0,5,91,2,-9,7,-5,0,-1,-1,1,-1,1,3,-1
KR_6765186346,420,-4,-41,-8,-3,-3,6,3,-2,3,1,3,0,3,-2,3,1,1,2,3,-1,-4,-46,0,-5,5,14,0,-2,-1,-1,-1,-1,6,-1
KR_6756857770,420,0,-11,5,6,1,4,5,5,1,6,7,0,7,-7,9,2,0,1,1,0,2,-2,6,-9,3,2,0,-2,1,-1,-1,1,4,-1
KR_6692125753,420,1,4,4,-3,0,2,2,0,4,4,1,2,3,-1,2,1,-3,5,2,-1,-8,-4,-3,-5,8,10,0,0,-1,-1,0,-1,1,-1
KR_6720007100,420,-2,-2,-8,5,-1,1,0,-1,1,0,3,0,3,5,2,7,-1,1,0,0,4,-3,1,-6,5,-3,0,-2,-1,-1,-1,1,5,-1
KR_6748314032,420,3,-30,-12,1,-4,6,2,2,0,2,0,4,4,4,1,5,-1,1,0,-1,-1,-52,1,-4,3,18,0,0,1,-1,-1,-1,1,-1
KR_6760102616,420,0,-18,9,-1,-2,3,1,3,0,3,0,1,1,-2,3,1,0,0,0,0,-3,3,0,-6,6,7,0,-1,1,-1,-1,1,4,-1
KR_6762806789,420,0,-19,-25,0,0,1,1,0,2,2,1,1,2,0,2,2,-1,1,0,0,1,-3,-2,-5,7,-1,0,0,-1,1,0,-1,4,-1
KR_6752342179,420,-5,-36,-20,-10,-4,4,0,2,1,3,-1,2,1,0,3,3,-7,8,1,0,-10,1,-1,-6,7,-8,0,-1,-1,-1,-1,-1,2,-1
KR_6756065140,420,-2,-93,-9,-5,3,2,5,-3,5,2,-3,4,1,-2,2,0,0,0,0,-1,-3,-1,-5,-1,6,-5,0,-3,-1,-1,-1,-1,3,-1
KR_6713117628,420,1,-25,24,-5,3,0,3,-2,2,0,-5,6,1,-2,5,3,1,0,1,-1,-7,22,-1,-6,7,-3,0,0,-1,0,0,-1,1,-1
KR_6768260740,420,-4,-53,-19,-1,-2,4,2,1,2,3,-3,5,2,1,5,6,2,0,2,0,5,7,2,-10,8,3,0,0,-1,-1,1,-1,4,-1
KR_6761312748,420,-5,-106,-37,-16,-4,7,3,-10,15,5,-1,3,2,-3,4,1,2,0,2,-1,-16,-9,-1,-4,5,2,0,-1,-1,-1,-1,1,1,-1
KR_6768678285,420,-3,-84,-4,-2,-3,4,1,-1,4,3,2,2,4,-2,3,1,2,0,2,0,5,7,3,-10,7,-1,0,-2,-1,-1,-1,-1,2,-1
KR_6759224878,420,-2,-24,8,-5,2,0,2,0,3,3,2,2,4,-7,9,2,-2,2,0,0,-5,-14,3,-8,5,2,0,-1,-1,1,-1,-1,6,-1
KR_6734389310,440,-2,22,-23,-7,2,0,2,-2,2,0,1,0,1,-1,3,2,-7,8,1,0,-7,3,3,-7,4,0,0,-1,-1,-1,-1,1,2,-1
KR_6707098671,440,1,-7,-11,-9,1,1,2,-5,6,1,2,3,5,-4,5,1,-3,3,0,0,-17,7,1,-6,5,-9,0,0,-1,1,-1,-1,3,-1
KR_6755177637,420,1,-72,0,2,2,1,3,2,2,4,1,1,2,-3,3,0,0,0,0,0,5,24,-4,-5,9,-1,0,0,-1,1,-1,-1,5,-1
KR_6761809246,420,-2,9,13,-11,1,1,2,-3,3,0,0,2,2,-6,7,1,-3,4,1,-1,-16,16,-3,-5,8,-20,0,-1,-1,1,-1,-1,3,-1
KR_6754925019,420,-3,-1,-12,-9,0,0,0,-2,3,1,0,3,3,-8,10,2,1,0,1,0,-10,183,8,-12,4,-10,0,-1,-1,-1,-1,-1,2,-1
KR_6761913874,420,0,13,24,-3,-1,2,1,-2,5,3,-2,2,0,1,1,2,1,1,2,0,-3,-12,2,-7,5,5,0,0,0,-1,0,-1,0,-1
KR_6762377121,420,1,-11,-4,2,4,0,4,-1,1,0,0,2,2,-1,3,2,0,0,0,0,0,19,3,-6,3,-1,0,0,-1,1,0,-1,4,-1
KR_6747846329,420,-5,-6,-44,-6,-2,2,0,1,2,3,3,1,4,-6,6,0,-2,2,0,0,-2,4,6,-10,4,-6,0,0,-1,1,-1,-1,3,-1
KR_6765454708,420,-4,-57,-1,-12,-2,5,3,0,3,3,-1,3,2,-5,6,1,-4,4,0,0,-10,-151,-2,-8,10,-4,0,-1,-1,1,-1,1,2,-1
KR_6755730261,420,-3,1,-26,-6,3,1,4,-1,3,2,2,3,5,-9,11,2,-1,2,1,0,-7,-176,-1,-3,4,-5,0,-1,-1,-1,-1,-1,5,-1
KR_6660734587,420,-1,-19,-13,-2,-3,4,1,2,2,4,4,0,4,-4,7,3,-1,1,0,-2,3,-5,-3,-4,7,4,0,0,1,-1,-1,-1,6,-1
KR_6767535522,420,-2,-14,-23,-4,-1,3,2,3,2,5,-3,4,1,-2,2,0,-1,1,0,0,-7,-17,1,-7,6,-5,0,0,-1,1,0,1,6,-1
KR_6748763614,420,-3,13,-64,2,0,1,1,1,2,3,0,1,1,2,0,2,-1,1,0,1,2,1,3,-7,4,5,0,-1,-1,-1,-1,1,6,-1
KR_6704320053,420,-3,-4,11,-5,-2,2,0,-3,5,2,-3,4,1,0,1,1,3,0,3,0,2,38,-2,-6,8,-22,0,-1,-1,1,-1,-1,5,-1
KR_6659039712,420,-4,-99,-8,-6,-5,7,2,-2,3,1,3,0,3,-1,3,2,-1,2,1,0,5,-111,3,-6,3,-5,0,0,1,-1,-1,-1,6,-1
KR_6694442979,420,-1,-32,-4,1,-1,4,3,4,2,6,-1,3,2,-2,4,2,1,0,1,-1,0,-5,-1,-5,6,-1,0,0,1,-1,0,-1,4,-1
KR_6750212174,420,-2,-26,3,-4,1,1,2,-6,7,1,2,1,3,-1,2,1,0,1,1,0,-11,4,-3,-3,6,1,0,0,1,-1,-1,-1,6,-1
KR_6762331345,420,-4,-65,24,-10,-4,4,0,1,2,3,-4,5,1,-2,5,3,-1,1,0,0,-9,12,-4,-1,5,0,0,-4,1,-1,-1,-1,6,-1
KR_6757556611,420,4,26,-2,6,5,0,5,1,1,2,0,1,1,-1,1,0,1,1,2,1,2,63,-1,-7,8,-13,0,1,-1,1,1,1,4,-1
KR_6757536375,420,1,42,20,-6,0,1,1,0,3,3,-8,9,1,1,1,2,1,1,2,0,-10,-18,-5,-3,8,0,0,2,1,1,1,-1,6,-1
KR_6761545618,420,-2,-36,9,-7,-2,4,2,-2,3,1,-3,7,4,0,1,1,0,0,0,0,-10,54,1,-6,5,-7,0,0,-1,-1,1,-1,6,-1
KR_6764129623,420,-1,-67,-28,2,0,2,2,0,2,2,-5,6,1,6,2,8,1,0,1,0,10,-38,-1,-6,7,7,0,-1,1,-1,-1,1,5,-1
KR_6738659295,420,2,-10,9,1,-1,2,1,2,2,4,-1,3,2,2,1,3,-1,1,0,0,7,-7,1,-5,4,0,0,0,1,-1,0,-1,5,-1
KR_6757687517,420,-4,-70,16,-11,-5,5,0,1,1,2,-6,6,0,0,1,1,-1,1,0,0,-1,3,-1,-3,4,-2,0,1,-1,1,-1,-1,4,-1
KR_6722695371,420,-2,-22,-9,-9,-1,2,1,-3,6,3,-3,4,1,-2,3,1,0,2,2,-1,-8,-8,4,-8,4,2,0,0,-1,1,1,-1,1,-1
KR_6698198534,420,-1,-28,24,-1,2,1,3,-2,2,0,-6,6,0,3,1,4,2,0,2,0,0,-10,3,-8,5,-3,0,-2,-1,-1,-1,-1,1,-1
KR_6755240503,420,-1,34,-35,-8,1,1,2,-4,4,0,-1,3,2,-4,4,0,0,1,1,0,-14,18,-1,-7,8,0,0,-2,-1,-1,-1,-1,4,-1
KR_6767525421,420,3,-38,20,4,2,0,2,-1,2,1,2,2,4,0,2,2,1,0,1,0,-3,4,1,-5,4,0,0,-1,1,1,-1,-1,2,-1
KR_6765466612,420,0,-32,-15,1,1,1,2,-2,4,2,-1,3,2,3,1,4,0,0,0,-1,-4,22,-1,-5,6,0,0,-2,-1,1,-1,-1,3,-1
KR_6741751018,420,-5,-75,-17,-9,-4,6,2,-3,3,0,-1,3,2,-1,3,2,0,0,0,0,-2,-66,-1,-4,5,7,0,-1,1,-1,-1,-1,1,-1
KR_6765167802,420,-3,-73,-26,-5,-4,4,0,-1,2,1,-1,4,3,2,0,2,-1,1,0,1,-3,-11,2,-5,3,4,0,-1,1,-1,-1,1,2,-1
KR_6766513437,420,2,-28,-1,-2,2,1,3,6,1,7,-2,5,3,-5,6,1,-3,3,0,0,2,32,1,-6,5,2,0,0,1,-1,-1,-1,4,-1
KR_6768893586,420,-1,-5,-35,-4,-1,3,2,-1,3,2,-3,7,4,0,1,1,1,0,1,0,2,-8,-1,-3,4,2,0,-2,1,-1,-1,1,4,-1
KR_6764138618,420,-1,-52,11,-3,-4,4,0,4,1,5,-1,2,1,-1,1,0,-1,1,0,0,1,0,-2,-3,5,-4,0,0,-1,1,0,-1,2,-1
KR_6752157492,420,0,-13,-25,-1,3,2,5,-3,6,3,2,1,3,-3,5,2,0,2,2,-1,-11,-10,2,-9,7,-3,0,-1,0,0,-1,-1,0,-1
KR_6542372710,420,-7,-94,-16,-14,-2,3,1,-3,3,0,-5,5,0,-3,5,2,-1,2,1,0,-11,-16,-1,-5,6,0,0,-2,1,-1,-1,-1,2,-1
KR_6761994636,420,-8,-78,-45,-17,1,2,3,-4,5,1,-4,4,0,-6,7,1,-4,4,0,0,-17,47,5,-11,6,-30,0,-3,0,-1,-1,-1,0,-1
KR_6729831140,420,-1,-27,-1,-3,-1,2,1,-1,6,5,2,2,4,1,0,1,-4,5,1,0,-2,5,7,-10,3,-1,0,0,-1,1,1,-1,4,-1
KR_6751071373,440,-2,-54,-17,2,-3,5,2,3,4,7,0,3,3,1,5,6,1,1,2,2,3,80,10,-12,2,-21,0,1,-1,1,1,1,6,-1
KR_6751770564,420,-2,-67,-6,-7,-8,9,1,-6,6,0,3,2,5,1,1,2,3,1,4,0,-4,13,-1,-6,7,-5,0,-1,-1,-1,-1,1,1,-1
KR_6740332390,440,-4,-56,-6,0,-1,2,1,8,1,9,0,0,0,-8,8,0,1,2,3,2,7,-9,5,-6,1,-2,0,1,-1,1,1,1,3,-1
KR_6761982928,420,-3,-56,-7,-7,-3,3,0,5,1,6,0,3,3,-5,7,2,-4,4,0,0,-8,196,-4,-6,10,3,0,-2,1,-1,-1,-1,5,-1
KR_6743174030,440,0,11,-12,2,-3,3,0,0,0,0,-1,1,0,3,1,4,3,2,5,0,-1,1,0,-6,6,-2,0,0,-1,1,1,1,2,-1
KR_6769154861,420,-1,-50,-12,2,1,0,1,1,2,3,1,1,2,0,3,3,-1,1,0,0,4,-14,5,-12,7,10,0,0,1,-1,0,1,1,-1
KR_6763949883,420,-6,-93,-3,-11,-4,4,0,-4,5,1,-4,4,0,1,4,5,0,0,0,0,-9,-110,-1,-5,6,-9,0,-1,-1,1,-1,-1,4,-1
KR_6749736727,420,-4,8,-29,-4,-1,1,0,-5,8,3,1,0,1,2,0,2,-1,2,1,0,-11,-12,-2,-3,5,5,0,-4,-1,-1,-1,-1,2,-1
KR_6726819223,440,0,-33,19,-1,3,2,5,-5,5,0,5,2,7,-2,2,0,-2,5,3,-2,0,-6,-2,-3,5,-1,0,-1,-1,1,-1,-1,3,-1
KR_6767998359,420,-4,-79,-18,-8,-2,2,0,-1,4,3,-3,4,1,-1,2,1,-1,3,2,0,-2,-31,-5,-4,9,15,0,-1,-1,-1,-1,-1,6,-1
KR_6683961372,440,-3,5,-23,-8,-2,2,0,-1,3,2,-3,6,3,-1,1,0,-1,1,0,0,-10,-56,-1,-2,3,-3,0,-1,-1,1,-1,1,2,-1
KR_6733732746,420,-1,-50,-8,-1,-2,2,0,3,1,4,-1,4,3,-2,5,3,1,0,1,0,10,13,4,-9,5,-1,0,-1,1,-1,-1,-1,1,-1
KR_6720395063,420,0,30,-9,3,-1,1,0,6,0,6,0,3,3,-2,3,1,0,0,0,0,-2,-1,3,-4,1,3,0,1,-1,-1,1,1,5,-1
KR_6762589176,420,0,12,-45,-8,-1,2,1,-1,3,2,-1,5,4,-3,4,1,-2,5,3,-1,-6,56,0,-5,5,-5,0,0,-1,-1,0,-1,3,-1
KR_6719844934,420,3,-2,26,-2,1,1,2,-3,5,2,0,2,2,1,4,5,-1,1,0,2,-5,-22,-4,-7,11,-7,0,0,1,-1,0,1,4,-1
KR_6623545385,420,-3,-25,16,-11,-2,3,1,-3,6,3,1,4,5,-5,6,1,-2,2,0,0,-16,-1,-4,-5,9,-2,0,-2,-1,-1,-1,1,6,-1
KR_6764914134,420,-1,27,-16,-2,1,1,2,-4,6,2,1,1,2,2,6,8,-2,2,0,0,-8,-4,4,-7,3,-4,0,-1,-1,-1,-1,1,4,-1
KR_6736828932,440,0,73,8,-1,1,1,2,4,2,6,0,3,3,-1,2,1,-5,5,0,-1,-2,-2,-2,-6,8,1,0,1,-1,1,1,-1,1,-1
KR_6749714245,420,-3,-49,-10,-8,-6,6,0,-1,3,2,0,2,2,-1,1,0,0,1,1,-1,-6,0,2,-6,4,-3,0,0,-1,-1,-1,-1,2,-1
KR_6675650900,440,1,3,4,-2,-4,6,2,5,0,5,2,3,5,-5,7,2,0,1,1,1,0,2,3,-5,2,2,0,-1,-1,-1,-1,1,2,-1
KR_6759426485,420,-4,-72,-22,-8,3,0,3,-1,2,1,-6,8,2,-3,6,3,-1,1,0,0,-7,-7,0,-3,3,-6,0,-1,-1,-1,-1,-1,6,-1
KR_6765421031,420,2,2,7,4,2,1,3,-1,3,2,-2,5,3,1,2,3,4,1,5,1,13,28,2,-8,6,-2,0,-1,-1,-1,1,1,4,-1
KR_6745570158,420,1,-27,4,2,2,0,2,-1,4,3,-1,2,1,2,2,4,0,1,1,0,2,6,3,-7,4,-2,0,-2,1,1,-1,1,3,-1
KR_6761674316,420,-6,-11,-43,-13,-4,5,1,-3,5,2,-2,3,1,-3,5,2,-1,2,1,0,-7,3,2,-6,4,-2,0,-2,1,-1,-1,-1,1,-1
KR_6700041982,420,-3,-99,38,-14,-2,4,2,-2,3,1,-4,4,0,-3,7,4,-3,3,0,0,-14,-4,2,-5,3,0,0,-1,1,1,-1,-1,1,-1
KR_6745213190,420,-3,-14,-4,-9,-1,2,1,0,0,0,0,1,1,-7,9,2,-1,2,1,0,-15,-3,1,-5,4,-2,0,-3,-1,-1,-1,-1,1,-1
KR_6728029550,420,-3,-46,8,-13,0,2,2,-7,7,0,-2,2,0,-2,3,1,-2,2,0,0,-12,-23,-5,-3,8,-1,0,-1,1,-1,-1,1,3,-1
KR_6729929040,420,-4,-40,12,-13,-4,4,0,-1,6,5,-2,4,2,-5,5,0,-1,3,2,0,-14,-13,-1,-4,5,2,0,-3,-1,-1,-1,-1,1,-1
KR_6728458057,420,-4,-29,-12,-12,-1,1,0,-6,8,2,-2,3,1,-3,3,0,0,2,2,0,-13,-6,0,-3,3,-1,0,0,-1,1,-1,-1,5,-1
KR_6749195938,420,2,23,4,-2,-1,2,1,-6,9,3,5,0,5,-1,2,1,1,0,1,0,-17,-14,-5,-4,9,1,0,0,1,-1,0,1,5,-1
KR_6720306129,420,-2,-20,-13,-2,-4,5,1,1,1,2,1,0,1,1,2,3,-1,4,3,0,-8,-5,-8,-1,9,-4,0,0,-1,-1,-1,1,1,-1
KR_6734594718,420,1,-20,20,0,2,0,2,2,2,4,-6,6,0,1,1,2,1,1,2,0,-2,-5,1,-7,6,3,0,0,-1,-1,-1,1,2,-1
KR_6725119190,440,-3,-105,37,-8,-4,4,0,-1,2,1,0,3,3,-3,5,2,0,0,0,0,-7,-1,0,-4,4,-2,0,-2,0,1,-1,-1,0,-1
KR_6672465146,420,-2,16,8,-1,0,1,1,0,3,3,-2,5,3,1,4,5,0,1,1,0,-1,6,2,-7,5,-3,0,-1,1,-1,-1,1,2,-1
KR_6768843762,420,-4,-46,-8,-3,-1,1,0,-2,5,3,2,2,4,-3,6,3,1,0,1,0,1,-11,-2,-4,6,-1,0,-1,1,-1,-1,-1,6,-1
KR_6760772182,420,2,6,4,-1,1,3,4,3,0,3,-2,5,3,-4,8,4,1,1,2,0,-9,13,4,-6,2,-3,0,0,-1,1,1,1,4,-1
KR_6749864969,420,3,-10,31,12,4,0,4,5,1,6,5,2,7,-2,5,3,0,0,0,0,4,218,-3,-4,7,1,0,1,1,1,1,-1,1,-1
KR_6765384900,420,-1,-24,8,2,-1,2,1,3,2,5,0,1,1,0,1,1,0,1,1,0,5,-46,-3,-5,8,25,0,0,1,1,-1,1,3,-1
KR_6718526613,420,-5,-54,-26,-10,-3,4,1,-2,2,0,-1,2,1,-1,3,2,-3,4,1,0,-10,2,2,-6,4,-6,0,-1,-1,-1,-1,-1,2,-1
KR_6756723098,420,-2,-34,-4,-7,-2,3,1,-3,5,2,-3,4,1,-2,2,0,3,1,4,0,-9,-6,-7,-2,9,-3,0,-1,-1,-1,-1,-1,1,-1
KR_6733939961,420,3,41,60,3,0,1,1,5,1,6,0,3,3,-1,6,5,-1,2,1,0,-3,-11,-2,-5,7,15,0,2,1,1,1,1,5,-1
KR_6753244515,420,2,19,-9,3,2,2,4,-3,3,0,2,2,4,-2,2,0,4,0,4,0,-1,6,-5,-3,8,2,0,0,-1,1,0,1,3,-1
KR_6740292925,420,-3,-83,-52,-6,-4,5,1,-1,4,3,-6,8,2,4,1,5,1,2,3,0,4,13,-6,-3,9,0,0,-2,-1,-1,-1,-1,6,-1
KR_6755180022,420,1,-43,32,2,-1,1,0,0,2,2,6,0,6,0,1,1,-3,3,0,0,2,5,3,-6,3,-1,0,0,1,1,0,-1,3,-1
KR_6768551049,420,-7,-24,-24,-10,-2,2,0,0,1,1,-5,5,0,-2,2,0,-1,2,1,-1,-14,2,2,-7,5,-10,0,-2,-1,-1,-1,-1,4,-1
KR_6760717654,420,-4,-27,-32,-10,-3,3,0,-4,6,2,0,1,1,-2,2,0,-1,1,0,0,-4,38,-4,-2,6,-27,0,0,-1,1,0,-1,4,-1
KR_6723644472,420,-2,8,-40,-5,-3,4,1,-2,6,4,-1,2,1,0,1,1,1,1,2,0,-5,-2,1,-7,6,-1,0,-1,-1,-1,-1,1,6,-1
KR_6728828813,420,-4,-74,-17,-6,0,3,3,-1,2,1,0,2,2,0,1,1,-5,5,0,-1,-8,20,0,-5,5,0,0,-2,-1,-1,-1,-1,3,-1
KR_6728950672,420,-1,-76,16,-6,-3,4,1,-4,5,1,0,3,3,0,3,3,1,0,1,0,-3,32,0,-6,6,-7,0,0,1,-1,-1,-1,4,-1
KR_6730040076,440,0,9,-4,-3,0,0,0,0,1,1,2,2,4,-4,4,0,-1,1,0,0,-8,-3,2,-4,2,3,0,1,1,1,1,-1,3,-1
KR_6760813798,420,0,-8,-4,2,0,1,1,4,2,6,0,2,2,-2,4,2,0,0,0,-1,2,-3,5,-7,2,0,0,0,-1,1,0,-1,5,-1
KR_6761103593,420,-5,-30,-20,-12,-2,3,1,-7,10,3,-3,5,2,-1,3,2,1,0,1,-3,-18,-36,0,-5,5,6,0,-2,1,-1,-1,-1,6,-1
KR_6745318586,420,-2,-33,-16,-10,-3,3,0,0,3,3,-2,3,1,-1,2,1,-4,5,1,0,-9,12,-2,-2,4,-5,0,0,-1,-1,-1,-1,3,-1
KR_6497487925,420,0,-40,-8,-9,2,3,5,0,2,2,-2,5,3,-8,9,1,-1,2,1,0,-10,87,3,-7,4,-15,0,-1,-1,1,-1,-1,2,-1
KR_6759364246,420,-2,-4,12,-5,0,1,1,2,1,3,1,2,3,-8,9,1,0,2,2,1,-2,43,2,-8,6,-8,0,-2,1,-1,-1,-1,4,-1
KR_6653399322,420,2,13,-1,-1,-6,6,0,-1,2,1,1,1,2,5,2,7,0,0,0,0,-1,2,0,-5,5,1,0,0,1,-1,1,1,4,-1
KR_6768180405,420,4,22,19,9,1,2,3,4,1,5,-2,6,4,7,0,7,-1,2,1,0,23,-3,-2,-2,4,3,0,1,1,-1,1,1,5,-1
KR_6754589926,420,0,-17,-17,4,-1,3,2,2,3,5,1,2,3,0,2,2,2,0,2,2,8,-5,3,-10,7,2,0,0,0,-1,-1,1,0,-1
KR_6768170066,420,-2,-14,2,-8,-1,2,1,3,0,3,-2,3,1,-7,8,1,-1,1,0,0,-13,-2,-2,-4,6,-4,0,-2,-1,1,-1,-1,5,-1
KR_6701313827,420,-3,-34,8,-5,-5,5,0,-1,5,4,-1,4,3,1,2,3,1,0,1,0,5,-5,0,-5,5,3,0,-1,-1,1,-1,1,3,-1
KR_6757979283,420,0,-24,-6,-5,1,1,2,4,1,5,1,2,3,-5,5,0,-6,6,0,0,-8,2,1,-6,5,-7,0,0,-1,1,0,-1,1,-1
KR_6764511667,420,-3,-25,-32,-6,-1,2,1,-3,3,0,-1,2,1,1,2,3,-2,3,1,0,-3,-13,6,-11,5,-7,0,0,-1,0,-1,1,1,-1
KR_6767614245,420,0,14,-7,-2,-3,10,7,1,2,3,-3,4,1,3,4,7,0,1,1,0,-7,3,0,-4,4,0,0,-2,-1,-1,1,-1,5,-1
KR_6673906628,420,-4,-31,2,-10,-7,7,0,-3,3,0,3,3,6,-3,4,1,0,1,1,0,-15,6,-2,-5,7,0,0,-2,-1,1,-1,-1,4,-1
KR_6768196978,420,-2,-23,-21,-10,0,2,2,-2,5,3,-5,7,2,-1,4,3,-2,3,1,-1,-12,1,1,-8,7,-2,0,-2,-1,-1,-1,-1,5,-1
KR_6767175881,420,0,-23,28,-4,-1,1,0,0,3,3,-4,5,1,0,4,4,1,1,2,0,-3,-3,1,-8,7,-4,0,-1,1,1,-1,-1,2,-1
KR_6754710685,420,-1,-23,1,2,0,0,0,-1,4,3,6,0,6,-2,2,0,-1,1,0,0,2,0,3,-7,4,1,0,0,1,1,0,1,5,-1
KR_6686631463,420,-1,-33,4,-9,-2,4,2,-2,2,0,1,1,2,-6,7,1,0,1,1,0,-14,0,1,-7,6,1,0,0,1,1,1,-1,3,-1
KR_6632350441,420,-1,-52,5,-8,-6,7,1,4,1,5,3,3,6,-6,6,0,-3,4,1,-2,-15,20,-1,-6,7,6,0,-1,-1,-1,-1,-1,6,-1
KR_6693269582,420,1,-24,-18,1,-6,7,1,2,1,3,3,1,4,1,2,3,1,0,1,-1,1,8,5,-10,5,-2,0,-1,-1,1,-1,-1,2,-1
KR_6743505316,420,-4,-53,-28,1,-7,7,0,5,1,6,2,0,2,0,2,2,1,0,1,1,13,29,5,-7,2,0,0,-1,-1,-1,-1,1,3,-1
KR_6644399711,440,0,-24,-28,-1,-2,2,0,-3,5,2,2,1,3,1,1,2,1,0,1,0,5,11,2,-5,3,-2,0,0,1,-1,0,1,3,-1
KR_6763087324,420,0,-17,60,-1,0,0,0,-5,5,0,-1,3,2,4,4,8,1,0,1,0,3,-4,-4,-7,11,-4,0,0,1,0,0,1,2,-1
KR_6757520434,420,0,3,-17,-2,2,2,4,-1,3,2,-3,3,0,0,5,5,0,2,2,0,-2,-43,-1,-4,5,23,0,-1,0,-1,-1,-1,0,-1
KR_6748375053,420,-6,-49,-18,-14,0,0,0,-9,10,1,-2,5,3,-3,5,2,0,1,1,0,-22,-12,3,-9,6,-1,0,-1,-1,1,-1,1,3,-1
KR_6767217776,420,-2,13,-2,-5,0,0,0,0,3,3,-2,2,0,0,0,0,-3,4,1,0,-6,3,-2,-5,7,6,0,1,1,1,1,-1,3,-1
KR_6764606862,420,-5,-43,-24,-7,-5,5,0,-3,4,1,-1,3,2,2,3,5,0,0,0,0,-8,-24,1,-5,4,-4,0,-1,-1,1,-1,-1,4,-1
KR_6764503566,420,-4,-36,-22,-8,-4,5,1,-1,3,2,3,0,3,-6,8,2,0,0,0,0,-8,3,4,-8,4,2,0,-3,-1,-1,-1,-1,6,-1
KR_6647782479,420,-1,-8,8,-1,-2,2,0,0,4,4,0,2,2,1,1,2,0,0,0,0,-2,-5,-5,-3,8,6,0,-1,-1,-1,-1,-1,3,-1
KR_6748719739,420,-3,-6,-19,-5,2,0,2,-6,7,1,-3,3,0,1,1,2,1,0,1,0,-6,-48,0,-7,7,-1,0,0,1,-1,0,1,3,-1
KR_6758219234,420,-6,-79,-10,-10,-5,5,0,-5,8,3,-2,5,3,2,3,5,0,2,2,1,-4,-18,2,-7,5,-2,0,-1,-1,0,-1,1,4,-1
KR_6741590666,420,-1,-52,8,3,4,1,5,-1,3,2,-1,2,1,4,4,8,-3,3,0,0,2,0,-1,-5,6,0,0,0,-1,-1,0,-1,6,-1
KR_6761627816,420,-4,28,-8,-11,-3,6,3,0,3,3,-2,3,1,-3,3,0,-3,3,0,0,-15,7,-2,-4,6,3,0,0,-1,1,-1,-1,1,-1
KR_6731523516,420,1,-59,-28,3,-1,1,0,4,3,7,-1,2,1,1,0,1,0,0,0,1,5,-36,-1,-3,4,2,0,-1,1,-1,-1,1,1,-1
KR_6758256590,440,-3,-68,1,-1,0,1,1,4,0,4,-4,7,3,-3,3,0,2,2,4,0,-6,9,2,-11,9,-11,0,1,1,-1,1,-1,2,-1
KR_6739247569,420,-4,2,16,-5,3,0,3,-1,2,1,-8,8,0,1,4,5,0,1,1,1,2,-3,4,-8,4,-2,0,-2,0,1,1,1,0,-1
KR_6751816126,420,2,115,-9,-3,2,0,2,-6,7,1,-1,3,2,3,3,6,-1,1,0,0,-8,-9,-2,-6,8,8,0,1,1,1,1,1,3,-1
KR_6754612434,420,-3,-27,-17,-2,2,4,6,-1,6,5,-2,4,2,-2,4,2,1,0,1,2,-2,18,6,-8,2,-7,0,-1,1,1,1,1,1,-1
KR_6663199731,420,0,20,-5,1,3,1,4,1,2,3,-5,5,0,1,2,3,1,0,1,0,-3,-3,-1,-5,6,0,0,1,-1,1,1,1,2,-1
KR_6746609814,420,0,-37,23,5,2,2,4,2,4,6,-3,4,1,4,0,4,0,1,1,0,3,-4,-1,-5,6,2,0,0,-1,1,1,1,2,-1
KR_6754121433,420,-3,64,-32,-6,1,1,2,0,5,5,1,3,4,-5,6,1,-3,4,1,0,-13,0,-1,-5,6,-4,0,1,-1,1,1,-1,3,-1
KR_6738638624,440,-4,-29,-58,-12,-4,5,1,-8,10,2,7,0,7,-6,9,3,-1,3,2,-2,-11,19,2,-5,3,-6,0,0,1,-1,0,-1,3,-1
KR_6763806302,420,-4,-49,-5,-6,-1,1,0,-2,7,5,-1,1,0,0,2,2,-2,2,0,0,-11,3,-1,-5,6,-3,0,-1,1,-1,-1,-1,1,-1
KR_6764078985,420,3,35,26,7,6,1,7,2,3,5,1,3,4,-4,6,2,2,2,4,0,-8,23,0,-5,5,5,0,2,-1,1,1,-1,4,-1
KR_6728041881,420,0,-37,-31,-2,3,0,3,-5,6,1,0,1,1,0,2,2,0,1,1,0,-2,-7,-6,-4,10,2,0,0,-1,1,0,1,2,-1
KR_6604611179,420,-3,-17,0,-6,1,4,5,-7,7,0,0,1,1,-2,3,1,2,1,3,0,-7,9,1,-6,5,1,0,-2,-1,-1,-1,1,2,-1
KR_6763704332,420,-3,-47,-21,-5,1,2,3,-4,4,0,-3,4,1,0,1,1,1,3,4,0,-3,-4,-3,-4,7,-2,0,-1,1,-1,-1,-1,1,-1
KR_6733462429,420,1,31,-32,3,2,2,4,-4,7,3,1,4,5,4,1,5,0,1,1,0,-4,21,2,-5,3,-1,0,2,-1,1,1,1,5,-1
KR_6497626726,420,2,16,8,-1,-4,4,0,-1,2,1,1,0,1,2,1,3,1,0,1,0,-1,-4,-2,-6,8,1,0,0,1,1,1,-1,3,-1
KR_6760994423,420,2,19,-3,5,2,1,3,-1,2,1,5,0,5,-3,4,1,2,2,4,0,5,22,-4,-6,10,0,0,2,1,1,-1,1,4,-1
KR_6766600064,420,-1,24,0,0,0,3,3,3,0,3,-3,6,3,0,2,2,0,1,1,1,-3,-36,1,-5,4,15,0,0,-1,0,0,1,3,-1
KR_6735691342,420,-4,-100,9,-13,-4,6,2,-2,5,3,-2,3,1,-4,4,0,-1,3,2,1,0,-169,1,-3,2,2,0,-2,-1,-1,-1,1,4,-1
KR_6768147111,420,2,36,7,3,4,2,6,0,3,3,-5,9,4,5,1,6,-1,3,2,0,-2,-203,2,-5,3,-2,0,1,-1,1,1,-1,5,-1
KR_6758009871,440,2,-101,40,7,2,0,2,-2,5,3,-1,6,5,6,4,10,2,0,2,0,23,56,4,-5,1,-2,0,-1,0,1,1,-1,0,-1
KR_6756373400,420,0,57,16,-2,0,2,2,-4,5,1,-1,2,1,3,2,5,0,2,2,0,-1,4,3,-7,4,-4,0,0,-1,-1,1,-1,2,-1
KR_6721363545,420,-3,-5,-22,-4,-3,3,0,0,4,4,1,1,2,-2,4,2,0,2,2,0,-5,12,5,-7,2,-2,0,0,-1,1,0,1,3,-1
KR_6745408060,420,-4,-30,-21,-8,2,0,2,-6,7,1,-1,3,2,-6,8,2,3,0,3,-2,-8,-28,-1,-5,6,-2,0,0,1,-1,1,-1,5,-1
KR_6728507715,420,-1,-36,28,-5,-4,4,0,1,1,2,-1,3,2,1,1,2,-2,2,0,0,-7,0,-2,-4,6,0,0,0,-1,-1,-1,-1,5,-1
KR_6765694927,420,-1,-25,26,-5,-3,5,2,-2,4,2,-2,3,1,2,0,2,0,0,0,0,0,-2,-1,-4,5,1,0,0,1,1,-1,-1,6,-1
KR_6751929971,420,2,46,4,4,6,0,6,3,0,3,0,2,2,-5,5,0,0,0,0,0,0,-5,2,-6,4,0,0,0,1,0,0,1,6,-1
KR_6762843903,420,3,-20,-35,4,-4,6,2,0,4,4,5,3,8,1,4,5,2,4,6,0,3,205,4,-9,5,-17,0,-2,-1,-1,-1,-1,3,-1
KR_6767436932,420,-5,-70,-6,-11,-2,2,0,-5,9,4,-5,6,1,-1,2,1,2,0,2,0,-6,-21,-4,-5,9,-7,0,-4,1,-1,-1,-1,5,-1
KR_6754286008,420,-1,-19,15,-4,-2,4,2,-6,9,3,4,0,4,-1,3,2,1,2,3,0,-4,90,2,-8,6,2,0,0,-1,-1,-1,-1,4,-1
KR_6758825559,420,-2,-34,-28,-1,0,2,2,0,2,2,-2,3,1,2,3,5,-1,2,1,0,1,-7,-2,-4,6,3,0,-1,1,1,-1,-1,2,-1
KR_6753626694,420,-7,-78,5,-19,-4,5,1,-3,4,1,-3,4,1,-9,11,2,0,5,5,0,-11,-4,-4,0,4,-2,0,-2,1,1,-1,-1,3,-1
KR_6765604535,420,-1,7,-8,-4,0,2,2,-2,3,1,1,1,2,-2,2,0,-1,3,2,0,-11,139,0,-7,7,2,0,-1,-1,1,-1,-1,3,-1
KR_6765980921,440,-1,11,-20,-4,4,1,5,-4,5,1,-1,3,2,-4,9,5,1,0,1,0,-10,11,2,-8,6,-7,0,-1,-1,-1,1,1,1,-1
KR_6755014119,420,-1,-8,46,-7,1,0,1,-3,4,1,-1,2,1,-4,7,3,0,1,1,0,-12,-9,0,-4,4,2,0,-1,1,-1,-1,-1,5,-1
KR_6653266408,420,-7,-86,3,-10,-2,2,0,0,1,1,-4,5,1,-3,3,0,-1,1,0,0,-9,-41,-8,-2,10,1,0,-3,-1,-1,-1,1,5,-1
KR_6761757521,440,-4,-14,-19,-9,-2,2,0,2,1,3,-2,2,0,-2,5,3,-5,6,1,0,-5,-1,-5,-3,8,2,0,-2,-1,-1,-1,-1,3,-1
KR_6755000726,420,-1,-39,17,-7,0,1,1,-6,7,1,3,3,6,-4,4,0,0,1,1,-1,-14,143,3,-6,3,-5,0,0,1,-1,0,-1,3,-1
KR_6768610640,420,0,20,21,-4,-2,3,1,3,1,4,0,1,1,-3,6,3,-2,3,1,0,-6,5,1,-9,8,-2,0,0,-1,0,0,1,5,-1
KR_6640344284,420,-5,-133,3,-12,-4,5,1,-4,7,3,-3,5,2,-1,2,1,0,0,0,0,-10,-8,-3,-7,10,0,0,-2,-1,-1,-1,-1,5,-1
KR_6768552349,420,-3,-32,-28,-4,1,5,6,0,3,3,1,1,2,-4,5,1,-2,3,1,-1,-7,-5,-2,-4,6,0,0,-2,-1,-1,-1,-1,1,-1
KR_6768104352,420,-4,-5,0,-19,-1,2,1,-8,10,2,-5,8,3,-4,5,1,-1,2,1,0,-17,-10,-5,-2,7,7,0,-1,-1,-1,-1,-1,6,-1
KR_6763998469,420,-2,-101,10,-12,-1,2,1,-2,2,0,-1,1,0,-4,4,0,-4,4,0,0,-15,0,-6,-6,12,-5,0,-2,-1,-1,-1,-1,3,-1
KR_6765844015,420,-2,-24,-34,-1,1,0,1,-1,5,4,3,2,5,-4,9,5,0,1,1,-1,4,-8,-4,-7,11,4,0,0,-1,1,0,-1,2,-1
KR_6730420693,420,-2,22,-19,-2,1,1,2,1,1,2,-2,2,0,-1,3,2,-1,1,0,0,1,-11,-2,-2,4,2,0,1,-1,1,1,1,2,-1
KR_6757316418,420,-2,-32,7,-8,-4,4,0,-4,9,5,-1,1,0,1,4,5,0,2,2,-1,-7,-12,2,-8,6,-1,0,0,1,-1,-1,-1,5,-1
KR_6734446841,420,-4,-70,0,-16,3,2,5,-3,5,2,-2,4,2,-13,18,5,-1,1,0,-1,-26,-222,2,-4,2,3,0,-2,-1,-1,-1,-1,1,-1
KR_6757684032,420,-2,-56,24,-6,-2,4,2,0,1,1,-3,5,2,1,4,5,-2,2,0,-1,-19,-7,-5,-3,8,-3,0,-1,-1,-1,-1,-1,5,-1
KR_6764595370,420,-2,9,-24,-8,-3,5,2,-5,7,2,1,2,3,0,2,2,-1,1,0,0,-16,-7,-6,-2,8,1,0,1,1,1,1,1,2,-1
KR_6713159689,420,0,10,-37,4,5,1,6,0,2,2,-3,3,0,2,3,5,0,0,0,-2,-2,2,2,-6,4,-3,0,1,1,1,1,-1,5,-1
KR_6768417866,420,-1,-19,20,-8,-2,2,0,-7,9,2,2,2,4,0,2,2,-1,1,0,0,-8,-3,-3,-5,8,0,0,0,-1,-1,0,-1,4,-1
KR_6699868144,420,-5,-93,-46,-12,-1,1,0,-5,5,0,-2,3,1,-2,6,4,-2,2,0,0,-9,-36,-1,-5,6,-6,0,-3,1,-1,-1,-1,6,-1
KR_6721772148,420,-1,-5,-12,-6,-2,3,1,-8,9,1,1,0,1,2,0,2,1,2,3,0,-9,-12,0,-7,7,2,0,0,-1,1,0,1,6,-1
KR_6751283240,440,-1,8,-25,6,3,1,4,2,0,2,-4,4,0,2,2,4,3,0,3,0,16,59,-1,-9,10,4,0,0,-1,-1,0,1,5,-1
KR_6738124323,440,3,15,-12,7,7,0,7,0,4,4,1,1,2,0,0,0,-1,2,1,0,6,166,1,-2,1,4,0,0,1,-1,0,1,2,-1
KR_6708018786,420,-2,-21,16,-2,-1,3,2,-1,3,2,-1,4,3,0,3,3,1,1,2,0,-7,-5,0,-8,8,-2,0,-1,1,1,-1,-1,6,-1
KR_6755299866,420,0,14,3,-6,-4,5,1,-8,9,1,9,1,10,-1,2,1,-2,2,0,-1,-5,-6,-5,-4,9,1,0,0,-1,1,0,-1,4,-1
KR_6762250053,420,-1,19,-1,-4,1,4,5,-2,5,3,3,1,4,-3,4,1,-3,3,0,0,-2,8,3,-6,3,-8,0,-1,-1,1,-1,-1,2,-1
KR_6752017006,420,-2,-12,16,-5,0,5,5,2,0,2,-2,2,0,-4,7,3,-1,1,0,0,0,-21,2,-5,3,5,0,1,-1,1,1,1,6,-1
KR_6761734865,420,3,22,0,-2,0,2,2,0,5,5,-2,3,1,-1,8,7,1,2,3,0,-1,-23,-6,-1,7,8,0,-1,-1,1,-1,-1,1,-1
KR_6764598405,420,-8,-119,27,-15,-2,3,1,-3,4,1,-7,10,3,-1,3,2,-2,5,3,0,-12,11,-1,-2,3,-1,0,-2,1,1,-1,-1,6,-1
KR_6765499100,420,-9,-10,-36,-18,-3,4,1,-7,8,1,-1,1,0,-4,7,3,-3,4,1,0,-20,-15,-8,0,8,3,0,-1,-1,-1,-1,1,1,-1
KR_6704253330,420,-4,0,-11,-5,0,3,3,2,2,4,-6,7,1,-2,4,2,1,0,1,0,-12,1,1,-7,6,0,0,-1,1,1,-1,1,2,-1
KR_6656010099,420,0,-2,-11,-3,-4,5,1,-3,3,0,-1,6,5,6,3,9,-1,3,2,0,1,12,2,-8,6,-2,0,-1,-1,-1,-1,1,5,-1
KR_6743338566,420,-1,-30,-7,-4,-1,2,1,3,6,9,-3,4,1,-3,4,1,0,0,0,0,3,-5,-2,-2,4,2,0,1,-1,-1,-1,-1,1,-1
KR_6764557460,420,-2,-9,-34,2,0,3,3,1,1,2,-1,1,0,0,2,2,2,1,3,0,3,132,-1,-7,8,7,0,1,-1,1,1,1,6,-1
KR_6766008669,420,1,52,16,5,3,1,4,1,4,5,1,0,1,0,3,3,0,0,0,0,6,-2,-1,-8,9,-1,0,-1,-1,1,-1,-1,3,-1
KR_6754912554,420,-5,-100,-41,-12,-2,2,0,-3,5,2,-3,7,4,-2,4,2,-2,2,0,-1,-12,-3,-4,-8,12,7,0,-1,-1,-1,-1,-1,1,-1
KR_6647979278,420,0,-1,-2,-11,1,3,4,-1,4,3,-5,7,2,-1,6,5,-5,5,0,-1,-7,-27,2,-7,5,-1,0,-2,1,-1,-1,-1,4,-1
KR_6730015563,420,1,38,25,-4,1,0,1,2,2,4,-1,2,1,-7,7,0,1,0,1,0,-6,-9,-6,-5,11,2,0,-1,-1,1,1,-1,2,-1
KR_6754231860,420,2,-24,9,2,-2,2,0,6,3,9,-2,2,0,0,1,1,0,0,0,0,11,4,1,-4,3,-1,0,0,-1,-1,1,1,3,-1
KR_6684304393,420,-4,-54,7,-2,-5,5,0,4,1,5,-3,3,0,2,4,6,0,1,1,0,1,57,3,-5,2,-23,0,0,-1,1,0,-1,4,-1
KR_6725754979,420,-3,23,-32,0,1,1,2,-1,2,1,-4,4,0,3,7,10,1,3,4,0,-6,69,1,-3,2,-3,0,-1,-1,1,-1,-1,6,-1
KR_6637493783,420,-4,-59,-17,-5,4,1,5,-4,4,0,-3,5,2,-3,4,1,1,1,2,-1,-10,16,3,-9,6,0,0,0,-1,1,0,1,2,-1
KR_6748938718,420,1,-21,16,-4,-4,7,3,-2,3,1,0,5,5,1,2,3,1,0,1,1,-1,-1,-2,-3,5,2,0,0,1,-1,-1,1,4,-1
KR_6763121152,420,-1,-17,-4,4,5,0,5,0,1,1,-1,1,0,1,1,2,-1,1,0,0,6,2,2,-8,6,2,0,0,-1,1,0,1,4,-1
KR_6764692123,420,-1,23,-8,3,4,0,4,2,4,6,2,0,2,-3,3,0,-2,2,0,0,-6,-37,1,-5,4,23,0,1,-1,1,1,1,3,-1
KR_6647277795,420,-3,-98,-12,-1,1,0,1,1,2,3,-1,2,1,2,0,2,-4,4,0,0,2,43,-2,-7,9,-1,0,-1,-1,1,-1,1,5,-1
KR_6645078501,420,-1,-36,-16,-2,-1,1,0,-5,5,0,1,2,3,2,1,3,1,0,1,0,-2,6,2,-8,6,-4,0,0,1,-1,0,1,2,-1
KR_6762782494,420,2,-92,7,10,2,0,2,4,2,6,2,5,7,-1,4,3,3,1,4,1,24,-120,-1,-5,6,7,0,0,1,1,-1,1,3,-1
KR_6681922776,420,0,-20,1,-2,1,1,2,-2,3,1,2,0,2,-1,4,3,-2,2,0,0,-12,31,3,-11,8,-6,0,-1,1,-1,-1,-1,5,-1
KR_6680057901,420,-2,4,-7,-6,2,0,2,-3,4,1,0,2,2,-5,5,0,0,1,1,0,-14,-116,3,-7,4,3,0,-1,1,-1,-1,1,6,-1
KR_6769158316,420,5,54,16,7,1,1,2,-2,3,1,5,0,5,4,4,8,-1,2,1,0,8,11,1,-7,6,7,0,-1,1,-1,-1,-1,4,-1
KR_6764751707,420,-6,-105,-15,-15,-6,8,2,-6,8,2,5,4,9,-4,5,1,-4,6,2,-2,-10,-4,-10,-1,11,0,0,-1,-1,-1,-1,-1,2,-1
KR_6760771349,420,-1,-40,16,-10,-1,3,2,-5,7,2,-2,5,3,-4,6,2,2,0,2,0,-6,2,1,-9,8,-6,0,-1,0,0,-1,1,0,-1
KR_6718093242,420,-3,-3,0,-4,0,1,1,2,4,6,-2,3,1,-5,5,0,1,0,1,0,-8,-1,2,-11,9,2,0,0,1,0,0,-1,2,-1
KR_6753558496,420,0,-27,-17,-1,1,2,3,0,2,2,1,1,2,-3,6,3,0,1,1,0,-1,-5,-1,-4,5,4,0,0,0,0,0,1,0,-1
KR_6764149222,420,-5,-28,-9,-16,3,1,4,-5,5,0,-8,9,1,-6,6,0,0,1,1,0,-14,-7,-5,-1,6,-2,0,-2,-1,-1,-1,1,1,-1
KR_6728274563,420,-7,-156,-12,-15,-5,6,1,-2,3,1,-5,5,0,-5,8,3,2,2,4,-1,-9,2,-4,-5,9,-9,0,-3,-1,-1,-1,-1,6,-1
KR_6767948827,420,-1,58,-22,-5,2,3,5,-3,4,1,-4,6,2,0,2,2,0,1,1,0,-21,-3,4,-5,1,-1,0,3,-1,1,1,1,1,-1
KR_6764044965,420,-4,-53,-18,-8,-1,1,0,-2,5,3,0,3,3,-3,4,1,-2,2,0,0,-13,-128,-6,-4,10,6,0,-1,-1,-1,-1,-1,5,-1
KR_6760374280,420,-6,-53,8,-13,-4,4,0,-5,5,0,1,0,1,-4,6,2,-1,3,2,0,-15,-5,-6,-1,7,-1,0,-2,-1,-1,-1,-1,6,-1
KR_6761607892,420,-4,-71,-2,-7,-1,2,1,-3,5,2,-4,7,3,1,0,1,0,2,2,-2,-18,49,0,-5,5,1,0,-1,-1,-1,-1,-1,1,-1
KR_6768606015,440,3,47,10,3,0,2,2,7,2,9,-4,4,0,0,6,6,0,0,0,0,2,-45,0,-6,6,4,0,1,-1,-1,1,-1,4,-1
KR_6756344524,420,-4,-9,-28,-1,0,2,2,1,3,4,3,1,4,-5,7,2,0,3,3,0,4,-8,3,-8,5,-6,0,0,-1,1,1,-1,4,-1
KR_6758222783,440,-4,-22,-20,-2,0,2,2,0,4,4,-3,3,0,4,0,4,-3,5,2,0,-2,8,0,-7,7,-1,0,-2,1,-1,-1,-1,2,-1
KR_6757212596,420,1,65,13,3,-2,3,1,3,2,5,-2,4,2,5,1,6,-1,3,2,1,7,-2,-4,-8,12,4,0,-1,-1,-1,-1,1,3,-1
KR_6649996598,420,-7,-20,-25,-17,-4,4,0,-5,5,0,-7,8,1,-1,3,2,0,0,0,0,-15,-3,2,-7,5,4,0,-1,-1,1,-1,-1,5,-1
KR_6759760917,420,-4,-55,4,-9,-2,3,1,-4,5,1,-1,1,0,-2,5,3,0,1,1,0,-19,-2,2,-4,2,-2,0,-1,-1,1,-1,-1,1,-1
KR_6752507104,420,-1,-67,-4,-8,0,1,1,2,1,3,-2,3,1,-6,6,0,-2,3,1,0,-10,-10,1,-5,4,0,0,-1,-1,1,-1,-1,4,-1
KR_6730194033,420,2,16,3,0,-3,3,0,-2,4,2,6,0,6,-1,3,2,0,1,1,2,3,0,0,-5,5,-3,0,1,-1,-1,1,1,6,-1
KR_6724888885,420,-5,-55,-30,-6,-6,6,0,0,1,1,-2,3,1,2,1,3,0,1,1,-1,2,-1,0,-5,5,3,0,-1,1,-1,-1,-1,5,-1
KR_6557579778,420,2,30,17,3,1,1,2,2,0,2,2,2,4,-3,9,6,1,1,2,0,5,2,1,-9,8,3,0,1,1,-1,1,1,3,-1
KR_6728176622,420,0,-28,-3,1,-4,5,1,2,2,4,1,2,3,0,1,1,2,0,2,0,-2,6,2,-4,2,-5,0,0,1,1,0,1,3,-1
KR_6705380854,420,-4,21,-27,0,-2,6,4,0,2,2,0,1,1,0,1,1,2,0,2,0,4,-4,-1,-5,6,-4,0,0,-1,-1,0,1,2,-1
KR_6763880926,420,-1,24,-15,-2,0,2,2,-2,4,2,-1,1,0,4,0,4,-3,3,0,0,0,-4,-3,-5,8,7,0,0,-1,-1,-1,-1,6,-1
KR_6767055405,420,-1,-19,16,-5,0,0,0,-1,2,1,4,1,5,-6,6,0,-2,5,3,1,-9,-5,0,-6,6,-2,0,0,-1,1,-1,1,2,-1
KR_6746479185,440,2,72,0,2,1,2,3,-1,5,4,4,0,4,0,1,1,-2,2,0,0,2,4,6,-8,2,2,0,-1,1,-1,-1,-1,6,-1
KR_6763034070,440,-2,10,-20,-3,-1,2,1,5,2,7,0,0,0,-5,6,1,-2,3,1,0,-4,6,2,-5,3,1,0,0,1,-1,0,1,1,-1
KR_6765152334,420,-1,-23,39,-1,-1,4,3,-2,4,2,-3,3,0,3,0,3,2,0,2,0,1,-6,-6,-3,9,3,0,0,-1,-1,-1,1,3,-1
KR_6682230657,420,-6,-70,-18,-15,-2,4,2,-7,8,1,1,0,1,0,3,3,-7,8,1,0,-14,-10,-2,-6,8,0,0,-3,-1,-1,-1,1,4,-1
KR_6763607962,420,-2,61,-36,-13,-4,4,0,-5,5,0,-5,6,1,1,2,3,0,0,0,0,-9,-46,-1,-4,5,22,0,-1,1,-1,-1,-1,1,-1
KR_6731687743,420,-1,-44,22,1,-1,2,1,3,3,6,2,0,2,-3,4,1,0,1,1,0,1,16,4,-11,7,-2,0,-1,-1,1,-1,1,3,-1
KR_6768494928,420,-3,-57,24,-9,-5,5,0,6,2,8,-4,5,1,-5,7,2,-1,2,1,0,-11,-19,-4,-5,9,-1,0,-1,-1,-1,-1,-1,3,-1
KR_6659397560,420,-3,9,-24,-2,0,1,1,-3,5,2,-3,3,0,4,1,5,0,0,0,0,3,-4,0,-6,6,0,0,0,1,1,0,1,3,-1
KR_6668520408,420,-4,-18,-2,-13,-2,3,1,-5,10,5,0,2,2,-3,3,0,-3,4,1,0,-14,20,3,-8,5,-4,0,-1,0,1,-1,-1,0,-1
KR_6769087712,420,-1,-2,16,-3,-1,1,0,2,2,4,-4,5,1,0,2,2,0,2,2,0,-4,8,5,-11,6,-4,0,1,1,-1,1,1,1,-1
KR_6750326029,420,2,-22,16,5,4,0,4,0,0,0,-2,3,1,3,2,5,0,1,1,0,3,7,2,-6,4,-3,0,2,1,1,1,1,4,-1
KR_6768675868,420,0,-56,-10,-4,1,2,3,1,4,5,-4,7,3,-2,3,1,0,1,1,0,4,-295,1,-5,4,-1,0,-1,-1,-1,-1,1,2,-1
KR_6768473864,440,2,1,24,-4,-1,2,1,-5,5,0,-4,5,1,4,3,7,2,0,2,-2,-8,2,-3,-3,6,-4,0,0,1,0,0,-1,5,-1
KR_6762210470,420,-4,-26,-28,-14,1,3,4,-5,6,1,-5,5,0,-5,6,1,0,0,0,0,-24,5,0,-5,5,-6,0,1,-1,-1,1,-1,4,-1
KR_6767849259,420,2,-41,12,6,-2,3,1,4,3,7,5,1,6,3,2,5,-4,5,1,-1,8,12,6,-8,2,-5,0,0,-1,0,0,-1,4,-1
KR_6765005594,420,-4,2,-41,-4,3,0,3,-6,8,2,2,1,3,-3,3,0,0,3,3,0,-4,-10,-2,-5,7,4,0,-1,-1,-1,-1,-1,5,-1
KR_6650873260,420,-2,-59,7,-6,-4,4,0,-3,3,0,3,1,4,-1,2,1,-1,2,1,-1,-7,25,-1,-6,7,0,0,0,-1,1,0,-1,2,-1
KR_6767066443,440,-1,2,6,-2,-3,3,0,3,2,5,-2,4,2,0,2,2,0,1,1,0,-3,1,2,-7,5,-4,0,0,-1,1,-1,1,4,-1
KR_6768331699,440,-1,-47,-12,-7,1,1,2,-2,6,4,-6,6,0,0,1,1,0,3,3,0,-16,-2,-1,-4,5,-5,0,-2,1,-1,-1,1,6,-1
KR_6763042798,440,2,58,-22,5,2,0,2,4,3,7,-1,3,2,-2,6,4,2,1,3,0,8,-35,-1,-4,5,9,0,-1,0,-1,1,-1,0,-1
KR_6755244979,420,-1,-29,-11,0,-3,3,0,5,2,7,-2,4,2,0,3,3,0,3,3,0,8,-1,3,-8,5,-5,0,-1,-1,-1,-1,1,5,-1
KR_6690471364,420,-4,-33,-9,-2,0,1,1,-1,5,4,1,3,4,0,6,6,-2,3,1,4,8,-8,4,-9,5,1,0,0,-1,1,0,1,1,-1
KR_6698840524,440,-3,-38,-11,-8,-2,3,1,-5,6,1,-1,3,2,-1,3,2,1,0,1,0,-12,5,0,-6,6,1,0,-1,-1,-1,-1,-1,3,-1
KR_6728228164,420,-2,-63,-19,-10,0,1,1,-3,7,4,-5,7,2,-3,4,1,1,0,1,-2,-3,-20,4,-9,5,5,0,-1,-1,-1,-1,-1,5,-1
KR_6761655270,420,-3,16,20,-10,-1,3,2,-2,2,0,-4,4,0,-2,3,1,-1,2,1,-1,-13,-5,-4,-1,5,0,0,0,-1,1,0,-1,2,-1
KR_6765442906,420,-1,-17,27,-2,-1,2,1,-8,8,0,4,0,4,2,3,5,1,0,1,0,-3,3,4,-8,4,-2,0,-1,-1,1,-1,1,5,-1
KR_6745125069,440,0,19,-1,2,2,0,2,-3,7,4,0,1,1,3,3,6,0,0,0,0,0,0,2,-8,6,4,0,1,-1,1,1,1,6,-1
KR_6734960522,420,1,37,-30,5,5,1,6,1,2,3,-2,5,3,-1,2,1,2,0,2,0,19,5,-1,-6,7,2,0,0,-1,1,1,1,2,-1
KR_6754000539,420,-4,-66,-1,-9,-2,3,1,0,2,2,-6,8,2,-1,3,2,0,0,0,0,-10,-7,-3,-3,6,4,0,-1,-1,0,-1,1,1,-1
KR_6763656406,420,0,14,-7,2,2,0,2,-2,3,1,0,2,2,2,2,4,0,0,0,0,5,-5,3,-6,3,1,0,-1,1,-1,-1,1,2,-1
KR_6768625041,420,0,6,25,-3,0,0,0,0,0,0,-3,4,1,0,2,2,0,1,1,1,0,-29,-4,-5,9,4,0,0,-1,-1,0,1,5,-1
KR_6750267575,420,-3,-26,-3,-11,0,0,0,0,2,2,0,2,2,-6,7,1,-5,5,0,1,-6,-12,2,-7,5,-2,0,-2,-1,-1,-1,1,6,-1
KR_6763735479,420,2,0,5,4,0,0,0,4,1,5,1,0,1,0,2,2,-1,1,0,0,2,-2,-4,-3,7,-5,0,0,-1,-1,-1,-1,4,-1
KR_6764034652,420,-5,-98,16,-15,-3,4,1,-4,4,0,-6,6,0,-1,4,3,-1,2,1,0,-19,-6,-1,-5,6,-4,0,-1,-1,1,-1,1,6,-1
KR_6740607339,420,3,10,19,2,-3,4,1,-1,3,2,5,3,8,2,0,2,-1,1,0,0,3,5,-1,-6,7,5,0,0,-1,-1,1,-1,4,-1
KR_6686944855,420,-4,-32,-16,-9,0,1,1,-5,7,2,-2,5,3,-3,5,2,1,0,1,0,-11,-133,-3,-6,9,-6,0,-1,-1,1,-1,-1,1,-1
KR_6612038429,420,-1,-52,-6,-4,2,1,3,-6,9,3,-3,4,1,2,0,2,1,0,1,0,-12,-2,-1,-3,4,-3,0,0,1,1,-1,1,5,-1
KR_6752152240,420,-4,54,0,-9,-3,3,0,-5,6,1,-1,1,0,-1,1,0,1,0,1,0,-5,-169,-3,-6,9,0,0,0,-1,1,1,-1,4,-1
KR_6624383108,440,1,-58,12,4,2,0,2,-1,2,1,2,2,4,1,1,2,0,1,1,0,3,6,3,-10,7,5,0,1,1,-1,-1,1,4,-1
KR_6637825328,420,1,40,28,-4,-3,5,2,2,3,5,0,1,1,-4,4,0,1,2,3,0,1,2,-3,-5,8,0,0,0,1,-1,0,-1,5,-1
KR_6706112130,420,-5,-106,-21,-1,3,2,5,-4,4,0,4,4,8,-5,7,2,1,0,1,-2,1,0,-2,-7,9,7,0,0,-1,1,-1,-1,4,-1
KR_6768954020,420,3,-57,3,5,0,2,2,0,3,3,-3,6,3,-2,4,2,10,0,10,2,-2,-187,0,-5,5,1,0,0,1,-1,-1,1,1,-1
KR_6746229973,440,1,66,8,-3,-4,5,1,1,0,1,1,1,2,-1,3,2,0,0,0,0,-3,-12,-2,-5,7,-2,0,0,-1,1,0,1,6,-1
KR_6732663660,420,-3,-3,-20,-2,3,2,5,-3,5,2,1,2,3,-4,4,0,1,0,1,0,-13,-115,2,-6,4,4,0,1,-1,1,1,1,5,-1
KR_6767437917,420,-4,-127,7,-5,-2,2,0,-2,2,0,1,0,1,0,0,0,-2,2,0,0,-8,-10,-1,-3,4,1,0,-1,-1,1,-1,-1,4,-1
KR_6766728046,420,-3,-57,8,-2,0,1,1,-2,4,2,3,0,3,-5,5,0,2,0,2,-1,-3,-3,1,-5,4,2,0,0,1,-1,-1,-1,5,-1
KR_6761826700,420,-3,-5,-11,-15,-4,6,2,-6,7,1,-2,2,0,-1,1,0,-2,2,0,0,-17,-24,-4,-5,9,0,0,-1,-1,1,-1,-1,4,-1
KR_6761657149,420,-3,-115,1,-11,-1,4,3,-5,5,0,-2,2,0,-6,6,0,3,0,3,-1,-11,-299,-2,-2,4,-2,0,0,-1,1,-1,-1,4,-1
KR_6750453481,420,0,-45,4,1,0,1,1,-1,2,1,1,3,4,0,2,2,1,0,1,0,2,3,-4,-2,6,5,0,-1,1,-1,-1,-1,1,-1
KR_6748295300,420,1,-55,-8,-6,1,2,3,0,2,2,-3,7,4,-1,2,1,-3,3,0,0,8,112,1,-6,5,1,0,-3,1,-1,-1,-1,6,-1
KR_6756953381,420,-1,-34,25,-1,1,2,3,4,0,4,-2,2,0,-4,5,1,0,1,1,0,-3,14,2,-5,3,0,0,0,-1,1,0,1,4,-1
KR_6769131838,420,-3,0,-28,-13,1,1,2,1,3,4,-4,5,1,-10,14,4,-1,2,1,-4,-22,-67,1,-6,5,1,0,-1,-1,-1,-1,-1,5,-1
KR_6767509482,420,-2,-70,0,-6,2,1,3,-2,5,3,-3,5,2,-3,5,2,0,1,1,0,-5,26,0,-5,5,-3,0,-3,-1,-1,-1,-1,5,-1
KR_6747399005,420,-1,-1,-12,-7,1,0,1,-5,7,2,-3,3,0,-3,3,0,3,0,3,0,-12,-9,-5,-2,7,4,0,0,1,-1,-1,-1,6,-1
KR_6768494882,420,0,1,-8,-4,1,1,2,-2,4,2,-4,4,0,1,4,5,0,2,2,0,-8,-211,4,-8,4,-2,0,-1,1,-1,-1,-1,6,-1
KR_6749947745,420,-2,-32,-12,-8,0,4,4,-3,5,2,-1,3,2,-1,2,1,-3,3,0,0,-2,13,1,-4,3,-2,0,-1,-1,-1,-1,1,4,-1
KR_6767357908,420,1,-33,37,-2,0,2,2,1,0,1,2,0,2,-4,4,0,-1,1,0,0,-3,5,-1,-5,6,-4,0,0,-1,1,0,1,1,-1
KR_6768603172,420,-4,-52,13,-16,-7,7,0,-5,7,2,-7,8,1,1,3,4,2,1,3,0,-10,-5,0,-7,7,6,0,-3,-1,-1,-1,-1,5,-1
KR_6767088495,420,0,58,-8,5,0,2,2,-3,5,2,5,1,6,0,1,1,3,0,3,0,2,11,6,-10,4,0,0,1,1,1,1,1,3,-1
KR_6737950789,420,-6,-20,-76,-12,2,0,2,-5,6,1,0,1,1,-7,7,0,-2,2,0,0,-15,-6,-6,-4,10,-3,0,-2,1,-1,-1,1,6,-1
KR_6737832438,420,-5,-68,-4,-15,-1,1,0,-6,6,0,-3,5,2,-3,3,0,-2,2,0,-1,-16,-6,-1,-4,5,2,0,-1,-1,-1,-1,-1,1,-1
KR_6768820243,420,-6,-43,-23,-11,0,1,1,1,3,4,-3,4,1,-8,8,0,-1,4,3,0,-14,-13,-6,-2,8,-1,0,-3,-1,-1,-1,-1,2,-1
KR_6767418881,420,-3,-39,4,-7,3,1,4,-4,5,1,-2,5,3,-4,5,1,0,0,0,0,-15,-3,2,-3,1,-1,0,-2,-1,-1,-1,-1,5,-1
KR_6766981536,420,-3,-30,-8,-3,-1,1,0,-1,3,2,-1,2,1,3,1,4,-3,3,0,0,5,-3,2,-8,6,6,0,-1,1,-1,-1,1,2,-1
KR_6649657007,420,-2,-39,-5,-11,-8,8,0,-2,4,2,-1,2,1,0,2,2,0,1,1,0,-5,1,1,-8,7,-5,0,-2,1,-1,-1,-1,1,-1
KR_6752597960,420,-2,-25,18,-7,0,3,3,0,2,2,-2,4,2,-1,1,0,-4,4,0,0,-4,-1,-5,-2,7,-3,0,-1,-1,-1,-1,1,2,-1
KR_6764267447,420,-2,-34,-8,2,1,3,4,-1,5,4,2,1,3,-2,2,0,2,1,3,0,-2,-2,1,-5,4,5,0,2,-1,1,1,1,2,-1
KR_6765891817,420,-1,-2,5,-8,-7,7,0,0,1,1,0,3,3,-1,4,3,0,1,1,0,-5,1,3,-7,4,0,0,-1,-1,-1,-1,-1,3,-1
KR_6759065065,420,-1,-46,0,2,1,2,3,0,5,5,-1,3,2,2,2,4,0,0,0,0,1,-11,-1,-6,7,4,0,-1,-1,1,-1,1,3,-1
KR_6763461341,420,-2,28,4,1,-1,1,0,5,1,6,-6,8,2,0,0,0,3,0,3,0,-4,-44,-8,-1,9,7,0,0,-1,1,-1,-1,4,-1
KR_6757372149,420,-2,-16,17,-2,2,6,8,0,1,1,0,1,1,-7,7,0,3,3,6,1,-1,7,-2,-2,4,-3,0,0,1,1,-1,1,4,-1
KR_6762696973,420,-3,7,1,-12,-3,3,0,-1,4,3,-5,6,1,-4,4,0,1,0,1,0,-10,-4,0,-7,7,0,0,0,1,-1,0,1,6,-1
KR_6764271907,420,1,-33,-2,1,3,0,3,-1,4,3,-1,2,1,1,2,3,-1,1,0,0,-2,-8,-1,-9,10,8,0,1,1,1,1,1,5,-1
KR_6768384022,420,0,-15,-9,2,2,1,3,0,2,2,0,3,3,-1,4,3,1,0,1,2,9,-3,-1,-7,8,-7,0,0,-1,1,0,1,1,-1
KR_6704259633,420,-1,-18,17,-4,3,0,3,-3,4,1,-1,2,1,-3,5,2,0,0,0,0,-11,-6,4,-12,8,-2,0,0,-1,-1,0,1,6,-1
KR_6689992368,420,-3,-53,16,-5,-3,5,2,-1,2,1,-4,5,1,3,0,3,0,0,0,0,2,3,3,-10,7,-1,0,0,-1,-1,0,1,6,-1
KR_6767977496,420,0,78,-3,4,0,2,2,0,4,4,2,1,3,1,0,1,1,0,1,0,4,4,0,-9,9,-6,0,0,1,-1,0,-1,6,-1
KR_6768760461,420,1,7,-56,0,1,1,2,-3,4,1,3,0,3,-2,4,2,1,0,1,0,1,-5,-2,-3,5,-1,0,-1,1,-1,-1,-1,2,-1
KR_6759084351,420,-1,-19,-32,-4,2,2,4,2,1,3,-3,3,0,-3,4,1,-2,3,1,0,-11,9,0,-8,8,4,0,0,-1,-1,1,-1,1,-1
KR_6718012137,420,-4,-38,-8,-1,1,0,1,0,5,5,-1,1,0,0,2,2,-1,1,0,0,-2,-34,-1,-4,5,22,0,-1,-1,1,-1,-1,4,-1
KR_6763938966,420,1,63,-8,0,2,4,6,-5,5,0,3,2,5,2,2,4,-2,2,0,1,5,173,2,-6,4,4,0,4,-1,1,1,1,1,-1
KR_6758063290,420,-4,-54,-40,-5,2,1,3,-3,6,3,-3,4,1,0,2,2,-1,1,0,0,-10,68,-1,-4,5,-5,0,-1,1,-1,-1,-1,3,-1
KR_6597557714,420,0,-55,-12,2,-1,6,5,2,2,4,-6,6,0,5,0,5,2,0,2,0,8,6,5,-9,4,0,0,0,-1,-1,1,1,5,-1
KR_6618817866,420,-3,-19,-24,-5,-2,3,1,-2,4,2,-3,3,0,2,2,4,0,1,1,2,-4,-76,-1,-6,7,-1,0,1,-1,-1,1,1,4,-1
KR_6763951707,420,-4,-3,-32,-5,3,0,3,-4,5,1,-3,3,0,0,2,2,-1,2,1,1,-7,5,0,-4,4,-2,0,0,-1,1,1,1,4,-1
KR_6686043644,440,-3,-3,-40,-10,1,2,3,-3,3,0,-9,10,1,-2,3,1,3,1,4,0,-3,-8,-6,-3,9,2,0,0,-1,1,-1,-1,2,-1
KR_6762394661,420,-3,4,-6,2,-2,3,1,1,2,3,-2,5,3,5,0,5,0,1,1,0,7,15,9,-11,2,1,0,1,1,1,1,1,5,-1
KR_6741537354,420,-3,-42,-12,-8,-4,4,0,2,2,4,1,1,2,-6,9,3,-1,1,0,-3,-4,-6,-4,-4,8,5,0,-2,-1,-1,-1,-1,1,-1
KR_6762002112,420,-1,-66,-3,-7,1,3,4,-2,4,2,-7,8,1,0,4,4,1,2,3,-2,-12,-1,0,-6,6,-3,0,1,-1,1,1,-1,4,-1
KR_6754072580,420,-1,-55,-5,-6,-6,6,0,2,3,5,-2,3,1,0,2,2,0,0,0,0,-8,5,0,-6,6,1,0,-1,-1,-1,-1,1,1,-1
KR_6754444041,420,-3,9,-15,-17,-2,3,1,-4,4,0,-3,3,0,-5,6,1,-3,3,0,0,-27,-5,-2,-5,7,-5,0,0,-1,-1,0,-1,5,-1
KR_6732781569,440,5,-61,28,9,2,0,2,4,3,7,1,1,2,-1,2,1,3,0,3,0,10,6,5,-7,2,-1,0,1,-1,-1,1,1,3,-1
KR_6759251343,420,3,76,38,5,1,0,1,4,2,6,1,0,1,1,3,4,-2,3,1,0,4,-7,2,-5,3,1,0,1,1,1,1,1,6,-1
KR_6764472201,420,-6,-86,-12,-11,-2,3,1,-2,3,1,-6,6,0,-1,3,2,0,1,1,0,-12,-136,-5,-2,7,4,0,-2,-1,-1,-1,-1,3,-1
KR_6764447800,440,-1,-12,7,-3,2,0,2,2,1,3,-2,3,1,-4,6,2,-1,1,0,0,-2,-5,-2,-4,6,0,0,0,-1,1,0,-1,4,-1
KR_6759249019,420,-1,-39,19,-7,0,1,1,0,6,6,0,4,4,-6,7,1,-1,2,1,0,-5,-4,-2,-4,6,-2,0,-2,-1,-1,-1,-1,4,-1
KR_6763520610,420,-2,79,-24,-8,0,1,1,-2,2,0,-8,8,0,2,0,2,0,0,0,0,-8,1,-1,-4,5,0,0,1,-1,-1,1,1,4,-1
KR_6766611682,420,1,28,13,7,5,1,6,1,2,3,-4,7,3,5,0,5,0,2,2,0,-3,-8,1,-5,4,-5,0,0,-1,1,-1,1,4,-1
KR_6694580259,420,-4,-24,-23,-8,-2,3,1,-3,3,0,-2,2,0,-1,1,0,0,1,1,0,-8,-24,-1,-2,3,1,0,0,1,1,0,-1,1,-1
KR_6758744691,420,-2,23,7,-3,3,2,5,-5,7,2,-1,2,1,-1,3,2,1,2,3,0,-3,-2,2,-8,6,1,0,0,1,-1,0,1,2,-1
KR_6645276146,420,-3,-61,-11,-3,-4,7,3,0,3,3,2,2,4,-2,2,0,1,1,2,0,-3,0,0,-5,5,3,0,-1,1,-1,-1,1,5,-1
KR_6755081760,420,-2,2,-14,-6,2,1,3,-2,4,2,2,0,2,-4,5,1,-4,4,0,-2,-10,6,2,-8,6,-2,0,-1,-1,1,-1,-1,5,-1
KR_6768646739,420,-7,-75,-79,-24,0,2,2,-13,15,2,-3,4,1,-5,6,1,-3,3,0,-2,-27,-87,-4,-4,8,28,0,-2,-1,-1,-1,-1,5,-1
KR_6759555703,420,-4,-39,-9,-6,-4,6,2,-1,4,3,-2,2,0,-1,2,1,2,0,2,0,3,-7,0,-8,8,5,0,-2,1,1,-1,1,1,-1
KR_6737920983,420,-5,-37,-21,-12,-2,3,1,-1,2,1,-6,6,0,-2,5,3,-1,2,1,0,-10,-4,-4,-5,9,5,0,0,-1,1,0,-1,5,-1
KR_6762912564,420,-1,-40,5,-2,0,4,4,0,0,0,0,4,4,-4,5,1,2,0,2,0,-10,-6,-6,-1,7,0,0,-1,1,0,-1,1,2,-1
KR_6681112731,420,0,-5,19,3,-1,3,2,1,2,3,-3,3,0,5,3,8,1,0,1,0,10,1,5,-9,4,0,0,2,1,1,1,1,6,-1
KR_6768767710,420,-8,-58,-49,-13,1,1,2,-3,3,0,-8,9,1,-6,6,0,3,0,3,0,1,-131,-1,-5,6,0,0,-3,-1,-1,-1,-1,5,-1
KR_6761919752,440,-1,-16,25,-6,5,0,5,-3,3,0,0,1,1,-7,7,0,-1,2,1,1,-11,5,-1,-1,2,-4,0,0,1,1,1,1,1,-1
KR_6659078542,420,-5,-32,-23,-10,-1,3,2,-4,4,0,-1,3,2,-5,6,1,1,0,1,0,-7,-8,-2,-3,5,-4,0,-3,-1,1,-1,-1,2,-1
KR_6739976052,420,1,31,-8,-5,1,2,3,-10,10,0,8,1,9,-2,5,3,-2,2,0,1,-12,-30,1,-10,9,5,0,-1,-1,-1,-1,1,6,-1
KR_6730564535,420,0,-12,-8,10,-1,3,2,4,1,5,6,0,6,-1,1,0,2,4,6,0,15,11,1,-3,2,-3,0,0,1,-1,0,1,6,-1
KR_6759032400,420,-1,-61,21,-4,0,1,1,-1,2,1,1,1,2,-4,5,1,0,0,0,0,-9,31,4,-6,2,-7,0,-1,1,-1,-1,1,5,-1
KR_6691163849,420,0,1,4,-3,2,2,4,-1,4,3,-2,4,2,-1,3,2,-1,2,1,-1,-16,-1,1,-6,5,5,0,0,-1,1,0,-1,2,-1
KR_6741375587,420,-2,-45,-12,-8,-2,5,3,-1,6,5,-6,6,0,-2,5,3,3,0,3,1,3,5,-2,-3,5,-1,0,-1,-1,-1,-1,1,6,-1
KR_6767985669,420,-2,-25,16,1,-1,3,2,-2,4,2,2,2,4,2,5,7,0,0,0,1,3,6,1,-10,9,-1,0,1,-1,1,1,1,3,-1
KR_6767539102,420,1,1,-5,-1,-2,4,2,3,2,5,-1,3,2,-1,1,0,0,2,2,1,10,13,0,-6,6,-3,0,0,-1,-1,0,1,3,-1
KR_6744102067,420,-2,-70,13,-1,-2,2,0,-1,5,4,1,1,2,-2,4,2,3,1,4,0,1,23,-1,-6,7,-1,0,-1,-1,-1,-1,-1,4,-1
KR_6763559046,440,2,29,44,-1,-7,9,2,7,0,7,-3,4,1,4,1,5,-2,3,1,0,-2,4,3,-9,6,0,0,-1,1,1,-1,1,6,-1
KR_6768951059,420,-2,20,20,-4,0,1,1,-2,2,0,-1,2,1,-2,2,0,1,0,1,0,-9,-9,-7,-3,10,1,0,-1,1,-1,-1,-1,1,-1
KR_6753593239,420,2,43,8,4,2,1,3,2,3,5,-2,2,0,2,2,4,0,3,3,1,2,-1,-3,-4,7,3,0,1,-1,1,1,1,1,-1
KR_6764131025,420,-6,-26,-36,-8,0,2,2,-2,3,1,-4,5,1,-2,4,2,0,1,1,0,-9,104,-1,-4,5,0,0,1,-1,1,1,1,3,-1
KR_6759161168,420,-2,7,-9,0,-2,2,0,-5,6,1,2,3,5,4,2,6,1,1,2,1,2,3,2,-6,4,6,0,-2,1,-1,-1,1,4,-1
KR_6766844385,420,-4,-31,-7,-3,2,1,3,-6,6,0,1,2,3,4,0,4,-4,4,0,0,-8,11,3,-7,4,-5,0,-1,-1,1,-1,1,4,-1
KR_6506665455,420,-1,-19,0,3,2,1,3,0,3,3,0,3,3,3,0,3,-2,2,0,0,6,20,2,-3,1,-5,0,-1,1,-1,-1,1,5,-1
KR_6752504370,420,-2,1,12,-7,2,1,3,4,0,4,-4,7,3,-3,4,1,-6,6,0,0,-17,1,2,-7,5,0,0,0,-1,0,0,1,2,-1
KR_6725780081,420,-5,-73,-17,-14,-6,7,1,-4,5,1,-2,2,0,-4,8,4,2,0,2,-1,-10,-50,0,-4,4,-4,0,-1,-1,-1,-1,-1,3,-1
KR_6733748089,420,-2,-6,66,-8,-1,2,1,-4,7,3,0,2,2,-1,4,3,-2,2,0,0,-7,-80,-1,-6,7,-1,0,0,1,-1,0,-1,6,-1
KR_6760481322,420,-4,-27,-8,-9,-2,2,0,0,2,2,2,2,4,-4,6,2,-5,5,0,-1,-7,-3,0,-5,5,1,0,-1,-1,1,-1,-1,3,-1
KR_6768051084,420,2,35,12,2,0,2,2,-2,4,2,-5,6,1,3,2,5,6,0,6,0,0,-10,1,-5,4,4,0,2,1,0,1,1,3,-1
KR_6756876346,440,-3,-49,24,-1,0,2,2,0,1,1,3,2,5,-3,4,1,-1,1,0,0,-5,2,0,-4,4,5,0,0,0,0,0,1,0,-1
KR_6768349619,420,-2,-81,-8,-7,-1,1,0,-1,1,0,-4,4,0,1,2,3,-2,2,0,0,-4,-28,1,-6,5,1,0,0,-1,-1,0,-1,2,-1
KR_6749344980,420,-4,-33,-23,-4,1,1,2,3,1,4,-11,12,1,2,0,2,1,0,1,1,8,19,4,-6,2,-4,0,0,1,-1,-1,1,2,-1
KR_6762273895,420,0,35,19,-10,-1,4,3,0,1,1,0,0,0,-9,9,0,0,0,0,0,-10,12,-4,-1,5,1,0,1,-1,1,1,1,1,-1
KR_6735329869,420,-3,-67,-1,-7,-5,6,1,-5,6,1,5,2,7,-2,6,4,0,1,1,0,-4,38,-2,-6,8,-1,0,0,-1,1,-1,-1,2,-1
KR_6764269025,420,0,-9,-8,2,-3,6,3,5,0,5,-3,3,0,3,1,4,0,0,0,0,1,-11,0,-5,5,-6,0,-1,-1,-1,-1,1,6,-1
KR_6745272556,420,-3,50,-17,-4,-2,4,2,-8,10,2,-2,3,1,7,3,10,1,0,1,0,-10,9,5,-8,3,2,0,1,1,-1,1,-1,2,-1
KR_6767136118,420,-3,-92,-22,-6,-6,6,0,0,5,5,-3,6,3,4,4,8,-1,1,0,0,-10,0,-2,-6,8,-1,0,-1,-1,-1,-1,1,2,-1
KR_6763140833,420,-1,-61,-4,-6,-4,5,1,-3,6,3,-1,2,1,2,3,5,0,2,2,-1,-7,-38,-1,-4,5,16,0,-1,-1,-1,-1,-1,4,-1
KR_6728553170,420,-4,-53,-21,-6,-3,3,0,-4,5,1,3,1,4,1,6,7,-3,4,1,0,-9,-4,-4,-6,10,-6,0,-1,-1,-1,-1,-1,5,-1
KR_6768298840,420,-2,-85,16,-5,-1,2,1,-2,3,1,1,1,2,-3,4,1,0,3,3,0,-6,-38,-5,-4,9,15,0,0,-1,1,0,-1,2,-1
KR_6765789887,420,-4,-86,24,-13,-3,4,1,-3,4,1,-1,1,0,-5,5,0,-1,2,1,0,-15,130,-3,-4,7,-7,0,-3,1,-1,-1,1,6,-1
KR_6767561403,420,-1,-45,24,-10,-1,2,1,-1,2,1,1,0,1,-4,5,1,-5,5,0,-3,-19,-5,2,-6,4,-5,0,-1,-1,1,-1,-1,6,-1
KR_6725948409,420,-5,-18,17,-13,-2,3,1,-3,5,2,0,1,1,-8,10,2,0,1,1,0,-18,-1,-6,-2,8,-3,0,-1,1,-1,-1,-1,4,-1
KR_6736984011,440,3,110,-24,1,-2,4,2,6,1,7,-2,5,3,2,9,11,-3,3,0,0,-4,-8,-7,-2,9,-1,0,0,-1,-1,1,1,1,-1
KR_6711434521,420,2,54,-11,6,1,0,1,0,4,4,2,3,5,1,2,3,2,0,2,0,3,-103,4,-8,4,-2,0,0,-1,1,1,1,2,-1
KR_6760545128,420,0,16,3,1,0,2,2,2,2,4,-1,3,2,0,1,1,0,0,0,0,1,-48,-4,-3,7,0,0,0,-1,-1,1,1,4,-1
KR_6741525076,420,-5,-96,-16,-9,-1,3,2,-4,4,0,-3,5,2,-3,7,4,2,0,2,1,-11,1,4,-6,2,-3,0,-2,-1,-1,-1,1,2,-1
KR_6749017749,420,-2,26,4,-3,2,1,3,-6,7,1,1,0,1,0,3,3,0,2,2,2,-1,22,2,-8,6,0,0,0,-1,1,0,1,2,-1
KR_6750428844,420,3,34,20,6,1,1,2,3,2,5,0,3,3,0,3,3,2,0,2,-1,3,5,1,-7,6,-2,0,-1,-1,1,-1,-1,5,-1
KR_6720204324,420,0,-46,0,-2,3,0,3,4,1,5,-5,6,1,-5,7,2,1,0,1,0,-3,3,0,-4,4,-4,0,0,-1,-1,0,1,4,-1
KR_6761036839,420,-4,-92,-6,-8,-1,2,1,0,1,1,-2,4,2,-5,6,1,0,1,1,0,-7,7,2,-6,4,-8,0,-2,-1,-1,-1,-1,4,-1
KR_6764067721,420,-4,-65,0,-9,2,1,3,-3,3,0,-5,5,0,-2,5,3,-1,1,0,0,-13,-20,3,-5,2,-1,0,0,-1,1,-1,1,1,-1
KR_6756358300,420,1,-37,-2,2,-1,2,1,4,1,5,-3,4,1,3,6,9,-1,1,0,0,-5,19,2,-8,6,2,0,-1,-1,1,-1,1,6,-1
KR_6716374276,440,0,5,4,-3,-2,2,0,1,0,1,-2,6,4,0,2,2,0,0,0,0,-4,181,3,-4,1,4,0,-1,-1,1,-1,1,1,-1
KR_6767499192,440,0,-10,9,-8,-2,3,1,-2,4,2,-4,4,0,0,3,3,0,1,1,0,-11,-9,-2,-5,7,-3,0,0,-1,-1,0,-1,5,-1
KR_6766122099,440,0,3,4,-6,1,1,2,-2,3,1,3,0,3,-8,9,1,0,1,1,0,-7,-5,-3,-7,10,2,0,-1,-1,0,-1,-1,2,-1
KR_6730989339,420,-2,-66,-11,4,3,1,4,0,6,6,3,2,5,0,1,1,-2,2,0,0,5,7,2,-6,4,7,0,-1,1,1,1,-1,5,-1
KR_6614646615,440,-5,-38,-24,-14,-3,3,0,0,2,2,-6,7,1,-5,6,1,0,0,0,0,-15,-7,-4,-2,6,0,0,-2,1,-1,-1,-1,5,-1
KR_6763182261,420,-3,-37,7,-13,-1,2,1,-6,6,0,-3,6,3,-4,4,0,1,1,2,0,-13,-22,-1,-5,6,-2,0,0,-1,-1,-1,-1,2,-1
KR_6760720639,420,-2,72,-31,-2,1,1,2,-3,5,2,-2,4,2,3,1,4,-1,1,0,0,-11,2,6,-8,2,2,0,0,-1,-1,-1,1,5,-1
KR_6769100921,420,1,-59,-13,4,2,1,3,1,5,6,1,1,2,0,2,2,0,4,4,1,4,-12,0,-7,7,4,0,0,-1,-1,-1,1,1,-1
KR_6757810863,440,0,45,7,0,-2,5,3,2,2,4,-2,4,2,5,1,6,-3,3,0,0,7,2,-3,-3,6,0,0,1,-1,1,1,-1,3,-1
KR_6661844244,420,1,-50,0,-5,-2,3,1,-1,2,1,0,0,0,-2,3,1,0,0,0,0,-6,-4,1,-6,5,4,0,0,-1,-1,0,-1,5,-1
KR_6748758220,420,-6,-19,-20,-16,-5,6,1,-5,5,0,-4,6,2,-2,5,3,0,3,3,-1,-14,17,4,-8,4,-6,0,-1,-1,1,-1,-1,3,-1
KR_6762883703,420,-1,-38,-38,7,5,3,8,0,3,3,-2,4,2,3,2,5,1,0,1,0,17,3,2,-5,3,5,0,0,0,-1,-1,-1,0,-1
KR_6728793769,420,0,56,-40,1,1,0,1,3,2,5,-4,5,1,2,1,3,-1,1,0,0,5,3,-6,-3,9,0,0,-1,1,-1,-1,1,6,-1
KR_6733801483,420,-4,-39,-34,-4,-5,5,0,0,2,2,-2,3,1,1,2,3,2,0,2,0,-6,4,-2,-7,9,-4,0,0,-1,-1,-1,-1,3,-1
KR_6768498330,420,1,24,0,-3,1,1,2,-5,7,2,1,2,3,1,4,5,-1,2,1,0,-5,-21,-4,-2,6,3,0,1,1,1,1,-1,4,-1
KR_6708315110,420,1,-6,3,-2,1,2,3,1,2,3,0,2,2,-3,6,3,-1,1,0,0,-4,-4,-1,-6,7,0,0,1,-1,1,-1,-1,4,-1
KR_6635752000,420,0,32,-32,-3,1,3,4,-2,6,4,-5,7,2,3,0,3,0,2,2,0,0,21,0,-5,5,-1,0,1,-1,-1,1,-1,6,-1
KR_6673686189,420,-8,-96,-47,-13,-5,5,0,-4,4,0,-1,6,5,-3,4,1,0,1,1,-1,-14,-34,0,-5,5,0,0,-2,-1,-1,-1,-1,4,-1
KR_6762960669,440,-1,-78,12,-11,0,3,3,-3,3,0,-3,3,0,-5,5,0,0,2,2,0,-8,-2,-1,-2,3,3,0,-2,-1,0,-1,-1,2,-1
KR_6766914839,420,-1,-49,14,-2,0,3,3,2,1,3,1,1,2,-5,5,0,0,0,0,0,-1,-4,-1,-4,5,-3,0,-1,-1,1,-1,-1,3,-1
KR_6730330162,420,-7,-142,-12,-15,-5,5,0,-3,7,4,-1,3,2,-5,8,3,-1,2,1,0,-12,19,0,-5,5,0,0,-3,-1,-1,-1,-1,4,-1
KR_6768051549,420,-8,-130,4,-20,-6,6,0,-3,5,2,-7,7,0,-6,7,1,2,0,2,0,-20,-10,-8,-2,10,1,0,-3,-1,-1,-1,-1,1,-1
KR_6768389813,420,0,67,-12,-1,1,0,1,-1,3,2,0,3,3,0,1,1,-1,1,0,0,1,30,3,-10,7,-9,0,0,-1,-1,0,-1,5,-1
KR_6755434184,420,-4,-67,-5,-4,-1,4,3,7,0,7,-2,3,1,-6,6,0,-2,2,0,0,-1,24,-7,-5,12,-3,0,0,-1,0,0,1,4,-1
KR_6769118848,420,2,-58,16,5,1,2,3,3,5,8,0,2,2,1,0,1,0,0,0,0,7,69,1,-7,6,-3,0,1,1,-1,1,-1,4,-1
KR_6766509186,420,-1,-26,-5,-4,-4,4,0,0,2,2,-2,3,1,0,4,4,2,2,4,-1,5,-4,-4,-5,9,1,0,-1,1,-1,-1,-1,3,-1
KR_6768237821,420,-1,-58,26,-6,-3,3,0,1,2,3,-2,4,2,-2,3,1,0,1,1,0,4,34,-4,-5,9,-2,0,-1,1,-1,-1,1,2,-1
KR_6626520473,420,0,-33,11,0,-2,4,2,4,2,6,2,3,5,2,0,2,-6,6,0,0,2,-2,0,-7,7,2,0,1,-1,-1,1,-1,1,-1
KR_6632400658,420,-3,-35,8,-7,1,0,1,-3,4,1,-1,4,3,-3,3,0,-1,2,1,0,-7,-5,-6,-1,7,0,0,1,-1,1,1,-1,1,-1
KR_6736406418,420,-4,-53,-4,-9,0,2,2,-1,4,3,-4,6,2,-5,8,3,1,0,1,0,-3,-5,-3,-5,8,-2,0,-3,1,-1,-1,1,1,-1
KR_6759045725,420,-1,-31,16,0,-2,3,1,6,1,7,-1,4,3,-1,3,2,-2,6,4,0,3,8,-2,-3,5,1,0,-2,1,-1,-1,-1,2,-1
KR_6744044131,420,0,-21,-4,-3,0,1,1,-1,4,3,-1,3,2,1,1,2,-2,2,0,0,-2,-4,-1,-3,4,4,0,0,-1,1,-1,1,5,-1
KR_6768723972,420,-2,-1,3,-4,2,1,3,1,3,4,0,3,3,-5,7,2,-2,2,0,0,-6,2,1,-5,4,0,0,-1,-1,-1,1,-1,3,-1
KR_6737017430,420,0,40,6,-3,-3,3,0,7,0,7,-4,4,0,-3,3,0,0,1,1,0,-3,-188,-6,-1,7,-1,0,0,-1,1,0,1,1,-1
KR_6759693258,420,-1,-10,-7,-5,-1,1,0,-1,2,1,-5,6,1,1,1,2,1,0,1,0,-7,11,1,-7,6,-2,0,-1,1,1,-1,-1,4,-1
KR_6744703412,440,-4,-58,-15,-13,-2,4,2,-3,3,0,-4,4,0,-5,5,0,1,1,2,0,-6,-4,-2,-6,8,-2,0,-2,-1,-1,-1,-1,6,-1
KR_6728686823,420,-1,-70,-8,1,5,3,8,-3,5,2,-1,3,2,1,0,1,-1,2,1,0,5,5,1,-4,3,-10,0,0,1,1,0,1,1,-1
KR_6754463042,420,1,-16,4,4,1,2,3,4,4,8,3,0,3,-2,6,4,-2,3,1,1,1,5,-1,-4,5,4,0,-1,0,-1,-1,1,0,-1
KR_6747656758,420,-3,-42,5,-8,3,0,3,-3,6,3,0,2,2,-9,9,0,1,2,3,-1,-17,8,-4,-7,11,-5,0,-1,-1,1,-1,-1,5,-1
KR_6713233324,420,-4,-29,4,-9,-2,4,2,-6,9,3,-2,4,2,-3,5,2,4,0,4,-1,-9,-10,-6,-4,10,6,0,-1,-1,-1,-1,-1,2,-1
KR_6701745692,420,1,-6,3,0,-2,3,1,0,2,2,2,2,4,1,1,2,-1,1,0,0,0,7,5,-10,5,0,0,0,-1,1,0,1,2,-1
KR_6740987921,420,-2,-17,-20,-6,2,0,2,-1,3,2,-3,4,1,-4,6,2,0,2,2,0,-12,6,2,-7,5,-4,0,0,1,1,-1,-1,3,-1
KR_6763716260,420,1,-7,21,2,2,1,3,1,1,2,-3,6,3,3,2,5,-1,2,1,0,7,-39,4,-7,3,26,0,0,1,-1,0,-1,5,-1
KR_6609302429,420,-1,-31,13,4,-6,7,1,2,1,3,4,0,4,1,3,4,3,0,3,0,6,-6,1,-4,3,5,0,-1,1,1,-1,1,6,-1
KR_6637943976,420,1,-16,3,5,1,0,1,-1,3,2,2,0,2,3,5,8,0,1,1,0,3,2,2,-9,7,-2,0,0,1,1,1,1,6,-1
KR_6766955063,420,0,32,-6,4,0,0,0,0,6,6,-1,1,0,4,4,8,1,0,1,0,12,0,-1,-5,6,4,0,0,1,-1,0,1,4,-1
KR_6759847374,420,-5,-28,-2,-3,-5,5,0,-2,4,2,1,3,4,0,4,4,3,0,3,0,-3,-3,1,-6,5,2,0,-1,-1,1,-1,1,4,-1
KR_6767241881,420,1,-30,-12,6,1,1,2,5,0,5,-2,4,2,2,4,6,0,2,2,0,13,40,2,-7,5,-3,0,1,-1,1,1,1,2,-1
KR_6654857772,420,-3,-105,-12,-12,-5,5,0,1,0,1,0,2,2,-7,8,1,-1,2,1,0,-12,-4,-3,-3,6,-1,0,-2,-1,-1,-1,-1,4,-1
KR_6754953807,420,-1,-14,6,-6,-1,3,2,-5,5,0,-4,4,0,2,0,2,2,0,2,0,-11,-5,-1,-7,8,0,0,0,-1,1,0,1,5,-1
KR_6764959296,420,-7,-93,-14,-20,-6,8,2,2,0,2,-8,9,1,-6,7,1,-2,3,1,-1,-19,12,-1,-5,6,-6,0,-3,-1,1,-1,-1,1,-1
KR_6757465076,420,-1,44,-22,-5,2,1,3,-1,1,0,-4,4,0,-2,2,0,0,1,1,0,-12,30,-3,-5,8,-1,0,-1,-1,-1,-1,1,5,-1
KR_6739933615,420,-6,-81,-5,-10,-1,2,1,1,1,2,-5,7,2,-4,6,2,-1,3,2,0,2,-38,-1,-4,5,2,0,-3,0,-1,-1,-1,0,-1
KR_6768252743,420,1,16,12,3,4,0,4,-2,5,3,3,2,5,-2,3,1,0,1,1,0,-4,-7,-1,-5,6,5,0,0,-1,1,0,-1,5,-1
KR_6730864593,420,0,-41,-7,3,0,2,2,1,7,8,1,4,5,1,2,3,0,0,0,1,13,0,2,-3,1,2,0,1,1,1,1,1,1,-1
KR_6763602933,420,1,73,17,-2,0,1,1,-2,6,4,2,2,4,-3,7,4,1,2,3,2,-2,-2,3,-7,4,0,0,0,-1,1,1,1,2,-1
KR_6758285026,420,-5,-94,-32,-10,-2,2,0,-1,2,1,-3,4,1,1,1,2,-5,6,1,0,-4,-1,-1,-3,4,1,0,-2,-1,-1,-1,-1,6,-1
KR_6758197921,420,-4,-64,1,-4,-2,3,1,2,1,3,-5,6,1,2,3,5,-1,1,0,0,-6,2,1,-6,5,0,0,0,-1,1,-1,-1,6,-1
KR_6729787777,420,-6,-102,-5,-10,2,2,4,1,1,2,-1,1,0,-7,8,1,-5,5,0,0,-12,-11,0,-5,5,4,0,-2,-1,-1,-1,-1,4,-1
KR_6764087491,420,0,22,4,-7,-3,4,1,-3,4,1,0,4,4,2,2,4,-3,3,0,0,-7,-5,-4,-3,7,0,0,0,0,-1,-1,-1,0,-1
KR_6713097162,420,1,-45,-20,4,0,1,1,5,2,7,-3,5,2,1,4,5,1,1,2,0,2,-2,3,-7,4,0,0,0,1,1,-1,1,3,-1
KR_6681236226,420,-6,-63,29,-18,-2,3,1,-2,4,2,-4,6,2,-7,7,0,-3,4,1,0,-21,-10,0,-6,6,2,0,-4,-1,-1,-1,-1,2,-1
KR_6762773058,420,-9,-104,3,-20,-6,6,0,-6,6,0,-8,8,0,-2,3,1,2,0,2,0,-16,-14,-2,-5,7,-2,0,-2,-1,-1,-1,-1,6,-1
KR_6755460645,420,0,46,20,-6,-5,5,0,0,0,0,-1,4,3,0,0,0,0,4,4,0,-11,-2,0,-2,2,0,0,0,1,-1,0,1,6,-1
KR_6765120231,420,-6,-119,-28,-13,-2,3,1,-4,6,2,-2,3,1,-6,6,0,1,0,1,0,-19,36,1,-9,8,-11,0,-2,-1,-1,-1,-1,5,-1
KR_6709477331,420,-3,-21,5,-4,0,1,1,0,2,2,1,0,1,-4,5,1,-1,1,0,0,-9,-7,1,-7,6,-3,0,-1,-1,1,-1,-1,3,-1
KR_6571743018,420,-4,-26,-59,-10,-1,2,1,-8,10,2,-3,4,1,-3,6,3,5,1,6,0,1,3,-2,-7,9,-4,0,-2,-1,-1,-1,-1,1,-1
KR_6712122803,420,-1,24,-8,-1,-2,4,2,2,1,3,0,0,0,-1,2,1,0,0,0,0,1,-36,-2,-3,5,0,0,-2,1,-1,-1,1,1,-1
KR_6761981194,420,-3,-30,-25,-5,0,2,2,-4,4,0,0,4,4,2,0,2,-3,3,0,0,-5,8,-6,-3,9,-4,0,-2,0,-1,-1,-1,0,-1
KR_6762658911,420,-1,-24,-31,-4,2,1,3,1,2,3,-1,2,1,-4,4,0,-2,2,0,-1,-9,-6,0,-6,6,-1,0,1,-1,-1,-1,-1,5,-1
KR_6767733844,420,-7,-85,-38,-23,-6,6,0,-3,6,3,-2,2,0,-4,7,3,-8,10,2,-1,-15,-35,-5,-2,7,-4,0,-2,0,-1,-1,-1,0,-1
KR_6744189099,420,0,-64,-40,-1,2,1,3,-1,2,1,0,3,3,-1,2,1,-1,1,0,0,-2,20,2,-6,4,2,0,0,-1,-1,0,1,4,-1
KR_6767536229,420,3,40,0,6,6,0,6,-2,2,0,1,0,1,-1,4,3,2,0,2,0,-7,-41,3,-4,1,11,0,1,-1,-1,1,1,4,-1
KR_6766714973,420,-2,-20,8,-4,1,1,2,-3,4,1,0,1,1,-4,4,0,2,1,3,0,0,0,-2,-4,6,-1,0,-1,-1,1,-1,-1,5,-1
KR_6676790418,420,1,-18,22,-2,-2,4,2,-2,3,1,-1,5,4,2,0,2,1,2,3,0,-4,4,2,-6,4,-4,0,0,1,1,0,-1,1,-1
KR_6736913882,420,-2,-49,-27,0,0,1,1,1,4,5,-1,2,1,0,2,2,0,2,2,0,8,12,2,-7,5,-3,0,-1,-1,1,-1,1,2,-1
KR_6666166348,420,0,-27,-24,-1,-2,4,2,-2,4,2,0,4,4,3,0,3,0,1,1,0,-7,13,5,-9,4,-6,0,0,1,-1,1,1,6,-1
KR_6726312915,440,0,48,-11,0,4,0,4,-4,8,4,0,4,4,0,2,2,0,2,2,1,5,8,9,-10,1,-6,0,0,1,-1,1,1,1,-1
KR_6766463860,420,0,4,1,-1,-6,7,1,6,0,6,-3,9,6,-2,2,0,4,0,4,0,5,-20,1,-6,5,8,0,-1,1,-1,-1,-1,4,-1
KR_6716138559,420,-3,-70,-3,-6,-3,5,2,1,1,2,-3,4,1,-2,3,1,1,0,1,0,-14,9,-4,-2,6,0,0,0,-1,1,0,-1,1,-1
KR_6762910634,420,-4,9,-15,-2,-5,5,0,-1,3,2,2,1,3,2,0,2,0,3,3,0,-2,110,-4,-5,9,7,0,-2,-1,1,-1,1,2,-1
KR_6654998698,420,-3,-61,-10,-12,3,0,3,-5,9,4,-3,5,2,-6,6,0,-1,1,0,0,-12,2,-1,-4,5,0,0,0,-1,1,-1,-1,1,-1
KR_6616290070,420,-5,-48,-31,-17,-4,6,2,-4,6,2,-6,8,2,-3,10,7,0,2,2,-1,-12,2,1,-4,3,-6,0,-5,-1,-1,-1,-1,2,-1
KR_6651338690,420,-4,-2,-8,-8,1,2,3,-1,5,4,-2,3,1,-5,7,2,-1,1,0,0,-17,-2,-1,-5,6,-4,0,-1,1,-1,-1,1,3,-1
KR_6672930288,420,-6,-50,-1,-9,-4,4,0,-2,3,1,-1,1,0,-2,4,2,0,1,1,0,-9,60,-3,-3,6,2,0,-2,1,-1,-1,-1,2,-1
KR_6767332214,420,-3,-74,-24,-5,-1,3,2,-4,6,2,-1,7,6,1,0,1,0,0,0,0,-5,-1,2,-6,4,-2,0,-1,-1,-1,-1,1,2,-1
KR_6764474777,420,-1,-35,-1,-6,-1,1,0,4,1,5,0,1,1,-7,8,1,-2,3,1,-1,-6,-79,4,-8,4,-9,0,-2,-1,-1,-1,-1,3,-1
KR_6671022403,440,-1,17,-17,-3,-4,4,0,4,0,4,1,0,1,-1,2,1,-3,10,7,0,-4,-11,1,-4,3,4,0,0,1,-1,-1,-1,5,-1
KR_6738090905,440,3,29,23,-2,-1,4,3,6,1,7,-2,2,0,-7,9,2,2,0,2,0,0,-11,-5,-5,10,6,0,-1,-1,-1,-1,1,1,-1
KR_6699149638,420,0,-108,17,-5,-4,5,1,7,0,7,-1,4,3,-7,8,1,0,1,1,0,-6,-14,-1,-4,5,-1,0,-3,1,-1,-1,-1,3,-1
KR_6745531951,420,-8,-78,-57,-9,1,2,3,0,3,3,-3,4,1,-7,8,1,0,0,0,0,-6,1,1,-4,3,-2,0,-2,-1,1,-1,1,3,-1
KR_6768208320,420,-2,-2,-28,-8,-2,6,4,-2,4,2,-1,2,1,-3,4,1,0,4,4,1,-4,-35,2,-7,5,2,0,0,-1,-1,0,1,4,-1
KR_6695081696,420,-5,-82,26,-9,-3,3,0,-1,1,0,-5,6,1,3,2,5,-3,3,0,0,-13,-11,-3,-6,9,-4,0,-2,1,-1,-1,-1,6,-1
KR_6763604708,440,1,28,-40,5,-2,3,1,2,0,2,3,0,3,-1,2,1,3,1,4,0,5,-80,-3,-5,8,3,0,0,-1,-1,1,-1,2,-1
KR_6649759364,420,-4,-94,-62,-3,-4,6,2,0,5,5,-1,4,3,1,0,1,1,0,1,0,7,-21,-1,-4,5,-1,0,-3,-1,-1,-1,-1,2,-1
KR_6701818449,420,-1,-30,-5,3,-1,4,3,-2,5,3,1,1,2,3,1,4,2,2,4,0,3,-4,0,-8,8,-6,0,0,1,1,0,-1,2,-1
KR_6764768466,440,-2,15,21,-2,-2,4,2,-5,6,1,2,1,3,1,0,1,2,1,3,0,-4,30,2,-7,5,-3,0,1,-1,1,1,1,5,-1
KR_6727981252,420,-1,-3,-15,-6,-4,5,1,0,5,5,-3,5,2,1,2,3,0,0,0,0,-4,-29,0,-3,3,11,0,-1,-1,1,-1,1,2,-1
KR_6694671044,420,2,-17,-8,6,-4,5,1,1,6,7,4,4,8,4,0,4,1,0,1,0,13,93,0,-6,6,5,0,0,-1,1,1,-1,4,-1
KR_6732767979,420,1,-49,1,9,0,1,1,1,4,5,1,0,1,6,0,6,1,1,2,0,13,19,-7,-5,12,-4,0,-1,1,-1,-1,-1,6,-1
KR_6721345967,420,-1,-13,-9,-3,2,0,2,-3,6,3,2,3,5,-4,5,1,0,1,1,0,-12,-9,-5,-2,7,2,0,-1,0,-1,-1,-1,0,-1
KR_6768589553,420,1,-11,8,2,1,3,4,4,0,4,-4,5,1,1,3,4,0,0,0,0,7,-19,1,-3,2,4,0,0,-1,1,1,1,3,-1
KR_6709568766,420,-3,-54,-7,3,-3,5,2,5,0,5,1,0,1,0,1,1,0,0,0,0,4,-40,-1,-5,6,16,0,-1,1,-1,-1,1,4,-1
KR_6742462721,420,-5,-52,-34,-9,-6,9,3,1,5,6,-1,3,2,-3,8,5,0,0,0,0,0,-13,4,-10,6,-10,0,-3,-1,-1,-1,1,4,-1
KR_6759287517,420,-2,14,17,-3,2,3,5,2,3,5,-2,5,3,-1,3,2,-4,4,0,-1,4,4,2,-7,5,-4,0,1,-1,-1,1,-1,5,-1
KR_6761781812,420,-1,-18,4,-4,2,2,4,-2,3,1,0,0,0,-5,5,0,1,0,1,-1,-11,-2,-1,-6,7,4,0,0,-1,1,1,-1,5,-1
KR_6754866978,420,-3,-63,-14,-8,-1,3,2,-1,4,3,1,0,1,-3,6,3,-4,5,1,0,-10,-7,-3,-1,4,-6,0,-4,-1,-1,-1,1,1,-1
KR_6761970231,420,-1,-45,-3,2,1,3,4,-2,3,1,-2,7,5,5,4,9,0,0,0,0,4,-15,3,-7,4,2,0,0,1,1,1,1,4,-1
KR_6769052292,420,-2,-23,-6,-9,2,1,3,-2,7,5,0,2,2,-6,7,1,-3,4,1,0,-2,-12,0,-5,5,1,0,-2,1,1,-1,-1,2,-1
KR_6756974396,420,-5,-61,-34,-7,1,0,1,8,0,8,-7,7,0,-8,9,1,-1,1,0,-1,-14,-15,0,-4,4,-1,0,-2,-1,-1,-1,-1,6,-1
KR_6743994490,420,-2,14,-5,-8,0,2,2,-5,6,1,-3,6,3,0,1,1,0,1,1,0,-11,-1,-2,-3,5,-14,0,0,1,-1,-1,1,6,-1
KR_6767512244,420,-2,7,-11,0,-4,4,0,-1,3,2,3,2,5,4,2,6,-2,2,0,0,8,-1,-2,-6,8,3,0,0,1,-1,0,-1,4,-1
KR_6756062595,420,-3,-6,-16,-2,-3,5,2,-3,5,2,4,1,5,1,1,2,-1,1,0,0,4,-1,4,-6,2,-5,0,-2,-1,1,-1,1,4,-1
KR_6635116476,420,2,4,12,-2,6,0,6,2,3,5,-1,4,3,-4,6,2,-5,5,0,0,-9,-7,3,-8,5,3,0,1,1,1,1,-1,4,-1
KR_6737942166,420,-1,-23,38,-13,1,2,3,-8,8,0,-5,5,0,-2,3,1,1,0,1,0,-14,1,2,-5,3,-6,0,-1,1,-1,-1,1,2,-1
KR_6768868621,420,-4,27,-36,-8,-1,1,0,-1,5,4,-4,4,0,0,1,1,-2,2,0,0,-3,-31,3,-8,5,-6,0,-1,-1,-1,-1,-1,2,-1
KR_6762853450,420,-4,-21,-48,-3,1,1,2,-1,2,1,-4,6,2,3,0,3,-2,4,2,0,-2,-16,-2,-1,3,-1,0,-1,-1,-1,-1,-1,3,-1
KR_6759286329,420,-4,23,-9,-12,1,0,1,-6,8,2,-1,1,0,-3,4,1,-3,4,1,0,-21,-23,4,-9,5,-1,0,-1,1,-1,-1,1,4,-1
KR_6758874012,420,0,7,-24,-3,3,0,3,-7,7,0,0,1,1,-1,4,3,2,3,5,0,-5,112,-4,-4,8,1,0,0,-1,-1,1,1,5,-1
KR_6617038454,420,-4,2,-14,1,0,1,1,1,3,4,-5,9,4,5,3,8,0,1,1,1,10,77,6,-11,5,-3,0,-1,-1,1,-1,1,6,-1
KR_6749761018,420,-1,-48,23,-5,-3,4,1,-4,6,2,2,0,2,1,1,2,-1,1,0,0,-3,-1,-1,-5,6,-2,0,-1,-1,-1,-1,1,6,-1
KR_6764492674,420,-1,35,-36,1,-1,3,2,0,1,1,2,0,2,-3,3,0,3,0,3,0,6,-105,3,-5,2,-2,0,-2,-1,-1,-1,1,1,-1
KR_6768607264,420,-2,-36,-20,-10,-2,2,0,-1,3,2,-1,4,3,-3,6,3,-3,4,1,0,-8,19,5,-8,3,-4,0,1,-1,-1,-1,-1,3,-1
KR_6686870811,420,0,12,-10,-3,-2,9,7,-1,2,1,-1,3,2,0,3,3,1,0,1,0,1,-10,-1,-4,5,3,0,-1,1,-1,-1,-1,5,-1
KR_6768186150,420,-2,-18,-3,-4,-2,3,1,-1,2,1,-2,7,5,2,2,4,-1,4,3,0,-6,-7,2,-7,5,0,0,-1,-1,1,-1,-1,2,-1
KR_6765101447,420,-4,-14,-18,-7,0,2,2,-2,2,0,-7,8,1,1,1,2,1,2,3,0,-3,7,2,-5,3,-1,0,0,-1,1,0,1,1,-1
KR_6758736998,420,-4,-34,8,-3,-2,2,0,-2,5,3,6,1,7,-3,5,2,-2,3,1,-1,6,1,-4,-4,8,-2,0,-1,-1,1,-1,-1,1,-1
KR_6726743077,420,-2,-85,-48,2,1,2,3,0,2,2,5,0,5,-3,4,1,-1,2,1,0,9,48,0,-7,7,3,0,-3,-1,-1,-1,-1,1,-1
KR_6743396386,420,-2,6,12,-9,1,3,4,-1,1,0,-1,3,2,-5,6,1,-3,3,0,0,-17,-12,-2,-5,7,1,0,-2,-1,-1,-1,-1,6,-1
KR_6743784845,420,0,9,-20,-5,-5,6,1,0,6,6,-2,2,0,1,2,3,1,1,2,0,1,27,0,-7,7,-3,0,-1,-1,-1,-1,-1,2,-1
KR_6496253238,420,2,6,32,6,-6,7,1,2,1,3,2,1,3,7,0,7,1,0,1,0,15,-60,-6,-1,7,8,0,-1,-1,-1,-1,-1,1,-1
KR_6768656961,420,-1,-58,22,-4,2,0,2,-1,5,4,-2,3,1,-2,4,2,-1,1,0,0,-11,3,-1,-5,6,3,0,1,-1,1,1,1,2,-1
KR_6762355895,420,-4,9,-28,-12,2,1,3,-5,6,1,-2,2,0,-5,6,1,-2,2,0,0,-17,109,3,-9,6,-9,0,0,-1,0,0,1,5,-1
KR_6768960068,420,3,27,-25,6,0,3,3,0,2,2,6,0,6,2,0,2,-2,2,0,0,3,-3,5,-8,3,6,0,0,1,-1,0,-1,1,-1
KR_6715204023,420,2,14,-8,-1,3,0,3,-4,4,0,-4,6,2,4,0,4,0,0,0,-1,-2,0,1,-7,6,-3,0,0,1,-1,0,-1,2,-1
KR_6768672649,420,-2,-30,12,-8,1,2,3,-1,4,3,0,3,3,-6,8,2,-2,3,1,-1,-17,-79,2,-6,4,16,0,-1,1,-1,-1,-1,2,-1
KR_6757557380,420,-4,22,-17,-11,-1,2,1,-7,7,0,-4,5,1,0,3,3,1,1,2,1,-21,1,2,-7,5,-2,0,0,-1,-1,1,1,3,-1
KR_6754923524,420,1,22,36,4,1,3,4,0,4,4,-2,3,1,4,2,6,1,1,2,0,0,-14,-1,-5,6,5,0,1,1,1,1,1,3,-1
KR_6706055699,420,-7,-49,0,-18,-2,5,3,-4,6,2,1,1,2,-7,7,0,-6,6,0,-1,-18,-5,1,-7,6,-5,0,0,1,-1,-1,-1,3,-1
KR_6752338970,420,0,12,-4,-2,-4,4,0,3,0,3,-1,2,1,0,4,4,0,0,0,0,-5,-4,2,-6,4,0,0,0,-1,0,0,-1,6,-1
KR_6747433754,420,-3,-39,-31,0,-3,5,2,1,4,5,0,4,4,3,1,4,-1,1,0,0,6,11,-2,-4,6,2,0,-1,-1,-1,-1,1,5,-1
KR_6760070180,420,0,-1,28,-3,-2,2,0,0,2,2,2,2,4,-2,5,3,-1,2,1,0,3,1,2,-5,3,-3,0,0,0,1,1,-1,0,-1
KR_6613292753,420,-2,-109,-57,0,-3,3,0,-5,9,4,-4,5,1,4,0,4,8,0,8,-1,2,-35,-2,-4,6,-1,0,-3,1,-1,-1,-1,3,-1
KR_6683309986,420,-3,-30,-20,-3,-1,3,2,1,5,6,-1,1,0,-1,2,1,-1,1,0,0,-5,-7,-3,-3,6,1,0,0,1,-1,-1,1,4,-1
KR_6616282592,420,-2,-9,13,-1,-4,5,1,-2,3,1,0,1,1,5,0,5,0,1,1,0,-5,-27,0,-9,9,1,0,1,1,-1,1,-1,1,-1
KR_6764334616,420,-3,-48,-4,-13,-4,5,1,2,1,3,2,0,2,-10,12,2,-3,3,0,0,-8,4,2,-8,6,-8,0,-1,-1,-1,-1,-1,3,-1
KR_6759949593,420,1,-18,-48,5,5,0,5,-2,5,3,0,4,4,4,0,4,-2,5,3,1,-2,6,8,-8,0,-7,0,0,-1,1,0,1,6,-1
KR_6751061891,420,-6,-122,13,-16,-8,8,0,-4,4,0,0,1,1,-4,5,1,0,1,1,-1,-12,5,-2,-6,8,-1,0,-1,0,1,-1,-1,0,-1
KR_6718691302,420,-1,-24,3,-3,-5,7,2,5,3,8,-6,7,1,4,0,4,-1,2,1,0,2,-9,-1,-6,7,2,0,-2,1,-1,-1,1,1,-1
KR_6689564901,420,-1,-59,-6,-7,-1,2,1,3,1,4,-4,4,0,-4,4,0,-1,2,1,0,-6,-6,-1,-3,4,0,0,-1,1,-1,-1,1,1,-1
KR_6618360928,420,1,80,14,-1,4,1,5,-1,3,2,-1,3,2,1,7,8,-4,4,0,0,-11,37,-1,-8,9,-9,0,1,-1,1,1,-1,1,-1
KR_6721994137,420,-2,5,12,-11,0,1,1,-1,2,1,-6,6,0,-2,3,1,-2,3,1,0,-14,-3,-3,-3,6,-2,0,-1,-1,1,-1,-1,2,-1
KR_6749349154,420,-4,-36,-3,-11,-4,4,0,-6,7,1,1,5,6,-1,1,0,-1,1,0,0,-5,1,0,-4,4,1,0,1,-1,1,1,-1,6,-1
KR_6738839566,420,0,-44,8,7,0,0,0,5,3,8,0,2,2,-3,6,3,5,1,6,4,13,-68,-2,-4,6,-1,0,-2,1,-1,-1,1,3,-1
KR_6732402203,420,-1,31,4,-5,3,1,4,0,3,3,2,1,3,-4,8,4,-6,6,0,0,-8,-2,1,-9,8,-6,0,1,-1,1,1,1,4,-1
KR_6768328340,420,2,-10,3,8,7,0,7,4,2,6,0,3,3,-3,4,1,0,0,0,-2,2,3,2,-6,4,-4,0,1,1,1,1,-1,6,-1
KR_6764079853,420,2,39,13,10,5,2,7,1,5,6,5,1,6,0,5,5,-1,2,1,3,10,-11,6,-12,6,3,0,0,1,1,1,1,1,-1
KR_6763901003,420,-4,-29,-24,-6,-3,3,0,1,3,4,2,0,2,-6,6,0,0,0,0,0,-10,18,-1,-4,5,-12,0,-1,-1,-1,-1,-1,5,-1
KR_6734229848,420,-2,-2,-16,0,-3,3,0,1,2,3,2,2,4,0,4,4,0,0,0,0,0,-42,2,-5,3,-1,0,-1,-1,-1,-1,1,3,-1
KR_6735376026,420,-4,-91,-21,-13,-1,2,1,0,3,3,-5,6,1,-4,4,0,-3,4,1,0,-9,0,0,-6,6,0,0,0,-1,1,-1,-1,4,-1
KR_6763676257,420,-3,-36,24,-7,-4,5,1,0,3,3,-2,10,8,-2,4,2,1,2,3,1,3,-51,-8,-3,11,22,0,-1,-1,0,-1,1,2,-1
KR_6767518067,420,1,10,8,6,5,0,5,-3,5,2,2,1,3,2,0,2,0,1,1,0,11,-9,-2,-3,5,3,0,0,1,-1,0,1,5,-1
KR_6763033689,420,-3,21,-20,0,-1,3,2,0,5,5,3,0,3,-2,5,3,0,2,2,0,0,-1,3,-7,4,0,0,0,-1,1,-1,1,2,-1
KR_6744467012,420,-5,1,-67,-10,0,3,3,4,1,5,-9,9,0,-4,5,1,-1,3,2,0,-12,-10,-3,-4,7,-1,0,-1,1,-1,-1,1,5,-1
KR_6765174380,420,-1,19,-3,1,0,1,1,-2,4,2,-2,2,0,3,0,3,2,0,2,0,-5,12,7,-10,3,-6,0,0,1,1,0,1,3,-1
KR_6746847276,420,-2,-5,-1,-1,-2,5,3,-1,4,3,1,3,4,2,3,5,-1,1,0,0,-13,5,1,-8,7,-2,0,-1,1,-1,-1,1,3,-1
KR_6767471903,420,-3,3,13,-5,-1,2,1,1,3,4,0,1,1,-6,11,5,1,0,1,0,-6,25,6,-12,6,-3,0,-1,-1,-1,-1,1,5,-1
KR_6758435146,420,-6,-46,-13,-13,-1,4,3,-9,10,1,0,2,2,-2,3,1,-1,1,0,-1,-16,-3,-3,-2,5,-3,0,-2,-1,1,-1,-1,5,-1
KR_6725628273,440,-3,-75,-5,2,1,0,1,3,2,5,-3,3,0,-1,6,5,2,0,2,2,4,-9,-4,-4,8,0,0,0,-1,1,-1,1,4,-1
KR_6758194591,420,-3,-27,-1,-12,-1,2,1,-1,2,1,-1,3,2,-7,8,1,-2,2,0,1,-17,5,-3,-2,5,-3,0,-1,-1,-1,-1,1,3,-1
KR_6695406447,420,-7,-82,-77,-5,-3,4,1,-4,5,1,-2,2,0,4,1,5,0,1,1,0,-1,-14,-5,-5,10,4,0,-3,0,-1,-1,-1,0,-1
KR_6745324346,420,-2,-51,-17,-2,1,1,2,1,1,2,-4,5,1,-1,4,3,1,0,1,0,2,-5,-3,-4,7,-1,0,0,1,-1,0,1,4,-1
KR_6741672271,420,-3,-8,-23,-1,0,2,2,0,4,4,0,1,1,-3,5,2,2,2,4,0,0,1,1,-6,5,-3,0,0,1,1,0,1,1,-1
KR_6666112540,420,-1,-19,-5,-1,1,1,2,-2,2,0,0,1,1,0,1,1,0,1,1,0,5,9,-1,-4,5,1,0,0,-1,-1,-1,-1,6,-1
KR_6762621714,420,1,21,-20,9,0,2,2,6,1,7,3,2,5,0,3,3,0,0,0,0,1,-4,-4,-5,9,7,0,0,-1,1,1,1,5,-1
KR_6714607013,420,2,-12,33,5,1,1,2,-5,7,2,2,0,2,6,1,7,1,0,1,1,5,21,-1,-8,9,29,0,2,-1,1,1,1,2,-1
KR_6763129224,420,-5,-2,-25,-10,-7,8,1,0,2,2,-4,4,0,-1,1,0,2,1,3,0,-7,3,1,-6,5,0,0,0,-1,-1,0,-1,2,-1
KR_6738832351,420,-2,1,-8,-10,1,1,2,-1,3,2,0,1,1,-11,12,1,1,1,2,0,-12,-42,1,-5,4,11,0,-1,0,-1,-1,-1,0,-1
KR_6762868335,420,-4,-51,11,-13,-2,3,1,-3,4,1,0,0,0,-8,8,0,0,1,1,0,-19,-12,-4,-3,7,1,0,0,-1,0,0,-1,1,-1
KR_6765190927,420,1,-13,-2,1,-6,6,0,-2,3,1,2,4,6,3,3,6,4,3,7,0,5,-5,-5,-3,8,-1,0,1,-1,1,1,-1,6,-1
KR_6765160006,420,1,26,-23,-2,4,0,4,-1,3,2,-3,4,1,0,4,4,-2,2,0,0,-4,-2,0,-3,3,0,0,0,-1,-1,-1,-1,4,-1
KR_6701255967,420,-4,-42,-19,-14,-2,4,2,-2,6,4,-3,5,2,-5,5,0,-2,2,0,-3,-20,-15,-8,-3,11,3,0,-1,-1,0,-1,-1,5,-1
KR_6765760319,420,-4,-61,-5,-6,0,2,2,-1,4,3,-2,2,0,-3,7,4,0,1,1,0,1,4,8,-11,3,-1,0,-1,-1,0,-1,-1,3,-1
KR_6758915617,440,-4,-2,-19,-18,-1,3,2,0,1,1,-5,7,2,-5,6,1,-7,9,2,1,-19,-6,-2,-3,5,0,0,-1,-1,1,-1,1,1,-1
KR_6764886603,420,-1,-34,-4,-6,-2,3,1,-4,5,1,1,3,4,-1,1,0,0,0,0,0,-13,-10,-4,-3,7,0,0,0,-1,-1,0,1,3,-1
KR_6649287016,420,-1,6,-36,-3,-2,2,0,3,2,5,-4,4,0,-1,3,2,1,0,1,0,3,-5,-5,-5,10,3,0,0,-1,1,-1,-1,4,-1
KR_6740995987,420,-3,-19,-32,-9,-2,5,3,-4,6,2,1,2,3,-3,5,2,-1,1,0,0,-4,-39,1,-9,8,3,0,-1,-1,-1,-1,-1,5,-1
KR_6768575698,420,-4,-15,-9,-13,-3,4,1,-7,8,1,-6,6,0,3,1,4,0,2,2,-2,-15,1,-1,-3,4,5,0,1,-1,-1,1,-1,2,-1
KR_6749026316,420,7,-26,42,12,-1,4,3,7,3,10,4,0,4,2,1,3,0,2,2,1,15,46,-3,-4,7,-1,0,0,1,1,-1,1,4,-1
KR_6762438580,420,1,-11,16,2,-1,2,1,4,1,5,0,2,2,1,3,4,-2,4,2,1,13,57,2,-4,2,-21,0,1,1,1,1,1,2,-1
KR_6768423538,420,-2,8,-12,-1,-2,6,4,-3,4,1,3,1,4,0,3,3,1,1,2,0,1,-10,0,-7,7,5,0,0,1,-1,-1,-1,5,-1
KR_6753866639,420,-2,55,16,-11,-6,6,0,-4,4,0,-3,4,1,3,1,4,-1,1,0,0,-15,-7,-10,0,10,3,0,1,-1,-1,1,-1,4,-1
KR_6729544627,420,0,-7,-8,0,-1,1,0,-7,8,1,2,0,2,7,0,7,-1,2,1,0,-3,-1,3,-7,4,-2,0,0,-1,1,0,-1,1,-1
KR_6743285463,420,0,-11,-1,-3,3,0,3,-3,5,2,-1,2,1,-1,4,3,-1,1,0,0,-3,-33,-1,-7,8,3,0,0,-1,-1,1,1,3,-1
KR_6730275242,420,-4,-49,-46,-15,-7,10,3,0,4,4,-4,5,1,-1,2,1,-3,4,1,-1,-12,44,1,-6,5,0,0,-1,-1,-1,-1,-1,2,-1
KR_6764272093,440,-4,-30,-10,-7,-1,3,2,3,1,4,0,3,3,-6,6,0,-3,4,1,0,-8,1,-3,-2,5,0,0,-3,1,-1,-1,-1,3,-1
KR_6761992324,420,-2,30,-5,-7,-1,3,2,2,0,2,-4,7,3,-4,6,2,0,1,1,0,-4,4,2,-6,4,-6,0,0,1,-1,1,-1,5,-1
KR_6745159611,420,0,57,4,-2,-5,5,0,2,1,3,0,3,3,1,2,3,0,1,1,0,-7,-39,2,-6,4,1,0,1,-1,1,-1,-1,4,-1
KR_6755784342,420,-2,-38,10,-5,-6,6,0,-3,4,1,2,3,5,0,1,1,2,0,2,0,2,9,1,-8,7,-1,0,-1,1,1,-1,-1,1,-1
KR_6765460136,420,-2,-66,-8,-8,-3,4,1,-1,2,1,-1,3,2,-2,4,2,-1,1,0,-1,-9,42,0,-6,6,-19,0,0,-1,-1,-1,-1,6,-1
KR_6764276420,420,-3,-58,-16,-8,0,1,1,-2,5,3,-2,4,2,-6,8,2,2,0,2,0,-10,11,0,-6,6,-6,0,0,-1,1,0,-1,6,-1
KR_6697570984,420,0,-81,-8,-1,2,0,2,-5,8,3,-1,4,3,-1,5,4,4,0,4,-1,0,4,-2,-1,3,3,0,-2,-1,-1,-1,-1,2,-1
KR_6708301040,420,-1,-5,-27,-1,-1,3,2,-3,5,2,1,3,4,0,5,5,2,0,2,-1,2,-19,-1,-3,4,2,0,-1,-1,-1,-1,-1,5,-1
KR_6768293699,420,1,-21,26,1,-3,3,0,2,0,2,0,1,1,1,6,7,1,2,3,2,4,-5,0,-7,7,-3,0,0,1,1,0,1,2,-1
KR_6655936694,440,-6,-58,-25,-16,-7,7,0,0,3,3,-3,3,0,-5,6,1,-1,5,4,-1,-8,-13,-2,-2,4,-3,0,-4,-1,-1,-1,-1,5,-1
KR_6765400069,420,-4,-47,25,-4,1,0,1,-6,7,1,-1,3,2,-1,5,4,3,0,3,1,-4,-4,-4,-6,10,-2,0,-1,-1,1,-1,1,6,-1
KR_6730711310,420,-1,0,-7,-6,0,0,0,-4,6,2,1,0,1,-1,3,2,-2,3,1,-1,-7,99,-1,-5,6,-1,0,0,-1,1,0,-1,6,-1
KR_6616469792,420,2,51,20,-2,-1,3,2,3,0,3,-2,3,1,-1,2,1,-1,1,0,0,-9,-1,2,-6,4,-1,0,0,-1,1,0,1,2,-1
KR_6759138574,420,-5,-23,-4,-6,-2,5,3,-1,2,1,-4,6,2,1,0,1,0,0,0,0,0,4,0,-6,6,2,0,1,-1,1,1,-1,1,-1
KR_6760929889,420,-4,-33,-11,-9,-1,1,0,-1,3,2,-5,7,2,-2,6,4,0,0,0,0,-19,-34,2,-6,4,4,0,0,1,-1,0,1,3,-1
KR_6695884682,420,-7,-66,1,-13,-2,2,0,1,2,3,-6,7,1,-5,6,1,-1,4,3,0,-10,23,-2,-5,7,-4,0,-1,-1,-1,-1,-1,2,-1
KR_6745244643,420,-3,24,-47,-4,0,2,2,-2,3,1,2,3,5,-3,4,1,-1,1,0,0,-5,7,5,-7,2,-5,0,0,-1,-1,0,1,2,-1
KR_6744067608,420,-3,-85,7,-8,2,0,2,-4,5,1,-2,3,1,-4,4,0,0,0,0,0,-11,-9,-2,-6,8,5,0,-2,-1,-1,-1,-1,5,-1
KR_6763096180,420,-4,-18,-19,-6,-2,3,1,0,4,4,-3,4,1,-1,1,0,0,0,0,0,5,161,2,-7,5,3,0,-1,1,-1,-1,-1,6,-1
KR_6640479832,420,0,-41,-24,0,-4,6,2,2,3,5,-2,3,1,4,2,6,0,0,0,0,-2,1,-5,-5,10,5,0,0,1,-1,0,1,5,-1
KR_6751561044,420,-5,17,3,-13,-1,3,2,-6,10,4,-3,4,1,-4,6,2,1,0,1,-1,-16,-6,0,-5,5,2,0,-1,-1,-1,-1,-1,3,-1
KR_6767791141,420,0,-39,-17,-2,-3,3,0,2,3,5,1,4,5,1,3,4,-3,3,0,0,8,-3,-3,-6,9,2,0,0,-1,1,0,1,1,-1
KR_6687332308,420,-1,-52,-20,-4,1,0,1,2,2,4,1,2,3,-7,8,1,-1,2,1,-2,-6,-20,4,-6,2,-1,0,-1,-1,-1,-1,-1,5,-1
KR_6635045534,420,-1,18,7,-5,3,0,3,-4,5,1,-2,4,2,-3,4,1,1,2,3,1,-11,-4,1,-7,6,-6,0,-1,-1,-1,-1,1,5,-1
KR_6761427475,420,-5,-95,12,-9,-2,2,0,-1,3,2,1,1,2,-5,8,3,-2,3,1,0,-1,11,3,-6,3,2,0,-3,0,-1,-1,-1,0,-1
KR_6768882028,420,3,82,-3,-2,0,4,4,-3,4,1,-1,4,3,2,1,3,0,1,1,0,-7,45,-4,-2,6,-17,0,0,-1,0,0,-1,6,-1
KR_6651988824,420,-1,11,-4,-3,-1,3,2,3,0,3,-2,2,0,-4,7,3,1,0,1,0,-1,51,-2,-5,7,-23,0,0,-1,-1,-1,-1,3,-1
KR_6766493139,440,1,-20,9,7,-2,3,1,0,4,4,2,1,3,5,0,5,2,0,2,0,12,-7,-4,-2,6,1,0,0,-1,1,-1,1,2,-1
KR_6726350830,440,-1,39,-31,-5,-3,4,1,-3,4,1,0,2,2,1,4,5,0,0,0,-1,-6,-17,-1,-2,3,4,0,0,-1,-1,0,-1,6,-1
KR_6633379042,420,-1,-90,20,-4,1,1,2,0,2,2,-1,2,1,-4,6,2,0,0,0,0,-7,-3,-1,-5,6,-3,0,-1,1,1,-1,1,5,-1
KR_6724564545,420,2,3,-3,3,4,1,5,3,1,4,-1,3,2,-6,7,1,3,0,3,-1,-2,-9,4,-5,1,-5,0,-1,0,1,-1,-1,0,-1
KR_6696958464,420,-4,-6,-56,-12,-1,4,3,-4,6,2,-5,6,1,-3,6,3,1,4,5,-2,-7,-11,-4,-5,9,1,0,0,-1,-1,1,-1,2,-1
KR_6748919244,420,-2,-26,8,-1,0,4,4,-3,3,0,5,0,5,-2,2,0,-1,1,0,0,-1,2,-1,-5,6,2,0,1,-1,1,1,1,1,-1
KR_6769094405,420,-2,5,-15,0,3,2,5,-6,7,1,-1,4,3,2,1,3,2,1,3,-1,-6,-12,3,-8,5,1,0,0,-1,1,-1,-1,2,-1
KR_6767537055,440,-6,-48,-11,-11,0,1,1,-3,3,0,-2,6,4,-1,3,2,-5,6,1,0,-8,-2,-3,-1,4,-3,0,0,0,-1,-1,-1,0,-1
KR_6767817784,420,0,24,12,1,1,0,1,-1,2,1,3,0,3,-2,4,2,0,1,1,0,0,6,5,-11,6,-3,0,0,-1,-1,0,-1,3,-1
KR_6768679900,420,-3,-72,-37,-2,-1,2,1,-2,2,0,3,1,4,-2,3,1,0,1,1,0,4,-5,-1,-3,4,-1,0,-1,-1,-1,-1,-1,2,-1
KR_6763868027,420,-4,-20,-32,-9,-3,7,4,-3,4,1,-8,9,1,2,4,6,3,1,4,0,2,5,-7,-3,10,0,0,-2,1,-1,-1,-1,1,-1
KR_6767482398,420,1,44,1,0,2,1,3,5,0,5,1,3,4,-7,8,1,-1,1,0,-1,-4,-9,-5,-5,10,0,0,-1,1,-1,-1,-1,6,-1
KR_6731481482,420,-6,-64,-17,-7,-3,4,1,-1,3,2,-4,4,0,1,1,2,0,0,0,0,-1,15,-3,-3,6,-4,0,-2,1,-1,-1,-1,6,-1
KR_6704437339,420,-1,-40,-10,-8,1,1,2,-5,7,2,-5,5,0,0,3,3,1,0,1,0,-5,-3,-1,-6,7,-2,0,-2,-1,-1,-1,1,3,-1
KR_6752923604,420,-2,-10,4,-7,1,0,1,-6,7,1,1,1,2,-3,5,2,0,4,4,0,-5,7,-1,-5,6,4,0,-1,-1,1,1,-1,2,-1
KR_6767127020,420,-1,8,-16,-4,2,1,3,-4,6,2,0,1,1,-2,3,1,0,0,0,0,-5,5,-1,-3,4,-4,0,1,1,-1,1,-1,5,-1
KR_6764929138,420,-2,-6,-44,-2,0,2,2,0,1,1,2,3,5,-2,3,1,-2,2,0,0,1,-13,2,-5,3,1,0,-1,-1,1,-1,1,3,-1
KR_6735164927,420,-2,13,-16,-7,-2,4,2,1,2,3,-3,3,0,-3,4,1,0,2,2,0,-3,-8,-7,-6,13,1,0,0,-1,-1,0,-1,5,-1
KR_6754844406,420,1,40,16,-1,1,0,1,-2,3,1,2,1,3,-2,2,0,0,2,2,0,-6,7,3,-6,3,-3,0,1,-1,-1,-1,-1,6,-1
KR_6769071296,420,0,-24,21,-8,2,2,4,-3,4,1,-1,5,4,-4,7,3,-2,3,1,0,-20,-6,-5,-2,7,-2,0,-1,-1,1,1,-1,1,-1
KR_6694559209,420,-2,12,-4,-2,-5,5,0,0,4,4,2,1,3,0,0,0,1,0,1,0,-1,11,-4,-5,9,4,0,0,-1,1,0,-1,6,-1
KR_6766354178,420,0,-44,8,-4,-2,3,1,-2,5,3,-4,5,1,2,2,4,2,0,2,0,-3,-24,-1,-6,7,-1,0,-1,1,-1,-1,-1,6,-1
KR_6754605634,420,-5,-78,9,-17,-3,4,1,-10,10,0,-1,1,0,-2,8,6,-1,2,1,0,-21,-3,-6,-3,9,-2,0,-2,-1,-1,-1,-1,3,-1
KR_6767366568,420,-2,-16,-22,0,-1,1,0,-4,6,2,0,4,4,3,2,5,2,1,3,-1,3,10,-2,-6,8,1,0,-2,-1,-1,-1,-1,1,-1
KR_6761390316,420,2,-44,34,6,2,1,3,6,1,7,-3,3,0,1,3,4,0,2,2,0,10,-6,0,-5,5,-1,0,-1,-1,1,-1,1,2,-1
KR_6735647739,420,-2,-12,-12,-12,-1,3,2,-5,6,1,-1,1,0,-5,6,1,0,1,1,0,-16,-4,1,-7,6,-4,0,0,1,-1,0,-1,4,-1
KR_6655027261,420,1,-40,7,0,0,1,1,1,2,3,-3,5,2,3,1,4,-1,2,1,0,3,68,-2,-5,7,-5,0,-1,1,-1,-1,-1,6,-1
KR_6716421072,420,2,68,31,0,0,1,1,0,1,1,-1,2,1,1,2,3,0,0,0,0,-1,13,4,-7,3,3,0,1,1,-1,1,-1,2,-1
KR_6757603154,420,-1,-14,-19,1,-1,1,0,5,2,7,-2,3,1,-4,5,1,3,0,3,0,11,9,7,-13,6,1,0,0,1,-1,0,1,3,-1
KR_6686928481,420,-3,33,-12,-11,-1,1,0,-4,5,1,-2,4,2,-2,4,2,-2,2,0,0,-23,-48,-5,-6,11,-4,0,0,-1,-1,-1,1,1,-1
KR_6675728621,440,-1,47,-9,-2,3,3,6,0,4,4,-2,3,1,-3,4,1,0,0,0,0,-4,-9,-3,-4,7,-3,0,1,-1,-1,1,-1,5,-1
KR_6715188028,420,0,17,6,-2,-2,6,4,-2,4,2,-1,2,1,1,3,4,2,0,2,2,0,5,6,-10,4,-2,0,-1,1,-1,-1,1,5,-1
KR_6654915174,420,-1,4,-5,-1,2,0,2,-6,9,3,0,3,3,1,3,4,2,0,2,0,-8,-12,-4,-4,8,7,0,0,-1,-1,-1,-1,1,-1
KR_6633381733,420,1,3,15,1,0,0,0,4,3,7,0,1,1,-3,5,2,0,1,1,1,9,3,2,-11,9,-1,0,-1,1,1,-1,1,4,-1
KR_6762603062,420,-2,-26,1,-7,-3,4,1,2,2,4,-2,3,1,-5,6,1,1,2,3,0,-6,-40,-1,-5,6,-1,0,1,-1,1,1,-1,5,-1
KR_6767832567,440,-1,-62,12,-7,-4,4,0,-3,6,3,-3,5,2,2,3,5,1,0,1,-1,-4,52,-3,-6,9,-2,0,0,-1,0,0,1,5,-1
KR_6763160074,440,-3,-76,14,-10,-2,3,1,-5,5,0,-1,2,1,-1,1,0,-1,3,2,0,-8,35,2,-6,4,-1,0,0,-1,-1,0,-1,6,-1
KR_6764920995,420,-3,6,3,-2,3,1,4,-8,9,1,1,1,2,1,1,2,1,0,1,0,-5,13,3,-7,4,-3,0,0,-1,-1,0,-1,6,-1
KR_6740886859,420,0,9,16,-2,-2,4,2,1,1,2,-3,4,1,1,3,4,1,0,1,0,0,130,2,-6,4,-2,0,0,-1,1,1,-1,4,-1
KR_6768202319,420,0,41,-12,1,-1,3,2,2,4,6,-2,4,2,1,1,2,1,2,3,0,6,2,3,-7,4,-2,0,0,1,-1,-1,-1,1,-1
KR_6682515391,420,1,-3,20,-3,1,1,2,0,3,3,-4,4,0,-1,1,0,1,1,2,0,-2,-3,-3,-3,6,0,0,-1,-1,-1,-1,1,4,-1
KR_6767470426,420,0,-18,18,-2,4,0,4,1,4,5,-2,5,3,-4,4,0,-1,3,2,0,0,4,1,-4,3,-4,0,0,-1,1,1,-1,6,-1
KR_6768598149,420,-4,-84,8,-8,-5,5,0,-2,5,3,3,1,4,-2,3,1,-2,2,0,0,-3,-1,-7,-2,9,-1,0,-2,1,-1,-1,-1,6,-1
KR_6705452356,420,-4,-60,15,-9,-3,3,0,-3,4,1,-2,3,1,1,1,2,-2,2,0,-1,-6,-5,1,-7,6,2,0,-1,1,-1,-1,-1,5,-1
KR_6749464590,420,-4,-27,-6,-15,-4,6,2,-8,9,1,-1,1,0,-2,2,0,0,0,0,0,-30,9,1,-8,7,-5,0,0,-1,1,-1,-1,2,-1
KR_6768244515,420,0,-29,32,-4,-3,4,1,1,4,5,-1,4,3,-2,3,1,1,1,2,0,-6,-12,-6,-3,9,0,0,0,1,1,-1,-1,4,-1
KR_6737598506,420,-3,-59,4,-5,-1,2,1,-3,5,2,-1,1,0,-2,6,4,2,0,2,0,0,31,-6,-3,9,-19,0,-1,-1,0,-1,-1,4,-1
KR_6765399854,420,-3,-105,-28,1,-2,3,1,-3,5,2,3,1,4,4,1,5,-1,1,0,0,1,1,2,-6,4,2,0,0,-1,1,-1,-1,1,-1
KR_6768625106,420,2,-7,0,0,-1,4,3,-2,3,1,2,0,2,1,1,2,0,0,0,0,-3,-28,4,-8,4,-5,0,-2,1,-1,-1,1,5,-1
KR_6687799434,420,0,4,-3,-6,1,1,2,-4,6,2,-2,3,1,-1,3,2,0,2,2,-2,-3,-10,-6,-3,9,0,0,0,-1,0,0,1,6,-1
KR_6689953685,420,-2,-31,-9,-4,-3,3,0,-4,7,3,1,4,5,-1,1,0,3,0,3,0,-2,-14,-7,-2,9,1,0,-3,-1,-1,-1,-1,2,-1
KR_6768532217,420,0,-23,14,1,-4,5,1,0,7,7,3,1,4,1,0,1,1,3,4,0,7,-49,0,-7,7,2,0,1,1,-1,1,1,6,-1
KR_6695743697,420,-4,-26,-25,-11,-2,3,1,0,1,1,-5,6,1,1,1,2,-5,5,0,1,-8,-2,-2,-7,9,2,0,-3,-1,-1,-1,1,3,-1
KR_6595523637,420,-8,-104,-64,-23,-5,6,1,-10,10,0,-5,8,3,0,3,3,-3,4,1,-5,-23,64,0,-3,3,-5,0,-3,-1,-1,-1,-1,1,-1
KR_6729962363,420,-2,23,-16,-5,0,2,2,-3,3,0,4,0,4,-5,7,2,-1,3,2,0,-2,34,-3,-3,6,-18,0,0,1,-1,0,-1,3,-1
KR_6557647675,420,2,14,19,-2,3,0,3,-1,2,1,-3,3,0,-3,5,2,2,1,3,0,-2,-113,-4,-6,10,2,0,2,-1,1,1,-1,5,-1
KR_6715385546,420,-1,-29,20,-3,-2,4,2,-2,4,2,-1,5,4,5,0,5,-3,3,0,0,-7,29,4,-6,2,-3,0,-1,1,-1,-1,-1,4,-1
KR_6760697994,420,0,-7,-5,-3,4,2,6,0,0,0,2,0,2,-8,10,2,-1,1,0,0,-7,-9,-3,-4,7,0,0,-1,-1,1,-1,-1,4,-1
KR_6764718124,420,-4,-58,4,-10,-3,6,3,-1,2,1,-5,6,1,-1,4,3,0,0,0,0,-4,-2,1,-7,6,-5,0,-2,1,-1,-1,-1,5,-1
KR_6768886322,420,-1,48,15,-3,1,1,2,-4,5,1,1,3,4,1,1,2,-2,3,1,0,-10,-3,0,-3,3,2,0,1,1,-1,1,-1,6,-1
KR_6759158582,420,4,45,-14,4,-1,3,2,4,2,6,2,4,6,-1,6,5,0,1,1,0,7,17,2,-7,5,2,0,-1,-1,-1,-1,-1,3,-1
KR_6766090696,440,-1,-2,0,-5,-3,4,1,0,0,0,0,2,2,-2,4,2,0,1,1,0,-7,26,-2,-4,6,-8,0,0,-1,-1,-1,1,2,-1
KR_6764512834,420,-1,-5,13,2,2,2,4,2,1,3,0,1,1,-1,1,0,-1,1,0,0,2,2,3,-6,3,2,0,0,1,1,-1,1,1,-1
KR_6767267214,440,2,-44,9,2,0,2,2,-3,3,0,5,1,6,-1,2,1,1,0,1,0,8,-7,-1,-3,4,-1,0,-1,1,-1,-1,-1,4,-1
KR_6767079947,420,2,-34,42,0,-2,4,2,4,1,5,-3,6,3,-1,2,1,2,0,2,0,-4,4,4,-5,1,-1,0,-1,1,1,-1,-1,4,-1
KR_6751385746,420,1,-27,6,-2,-2,3,1,-2,4,2,-1,3,2,4,0,4,-1,1,0,0,1,13,-1,-6,7,0,0,-1,1,-1,-1,-1,1,-1
KR_6723230965,440,-5,-11,-20,-8,-3,5,2,-2,5,3,-4,4,0,1,3,4,0,0,0,0,-7,28,-2,-6,8,-2,0,-1,-1,-1,-1,1,4,-1
KR_6734435782,440,-1,-74,-4,-1,4,1,5,-1,3,2,0,3,3,-2,2,0,-2,2,0,0,5,-48,-3,-8,11,27,0,0,1,1,-1,1,5,-1
KR_6763622460,420,-1,-2,-7,-7,2,2,4,-3,7,4,-6,8,2,-2,2,0,2,0,2,1,-3,-26,-2,-4,6,3,0,0,-1,1,0,1,6,-1
KR_6761686844,420,-1,-21,0,0,-5,6,1,-1,2,1,2,2,4,4,3,7,0,0,0,0,-2,2,-1,-4,5,1,0,-1,1,-1,-1,-1,6,-1
KR_6767509146,420,-2,-63,-29,0,1,1,2,1,2,3,-1,1,0,0,3,3,-1,1,0,0,3,-4,-4,-4,8,0,0,0,-1,1,0,-1,3,-1
KR_6751048541,420,1,-58,22,-2,2,1,3,-6,6,0,-4,4,0,7,0,7,-1,3,2,0,-9,-13,1,-7,6,-2,0,0,-1,-1,1,-1,1,-1
KR_6740779284,420,-4,-131,-4,-9,-4,5,1,1,2,3,-2,4,2,-3,3,0,-1,1,0,0,-5,-53,1,-7,6,24,0,-2,-1,1,-1,1,4,-1
KR_6767989112,420,-3,-82,7,-8,-1,2,1,-1,2,1,0,4,4,-5,6,1,-1,1,0,0,-7,3,3,-9,6,-5,0,0,-1,-1,-1,-1,2,-1
KR_6758129578,420,1,8,-13,-5,2,1,3,-3,4,1,1,2,3,-6,7,1,1,0,1,0,-15,-37,-4,-4,8,0,0,-1,-1,-1,-1,1,5,-1
KR_6768739322,420,0,-17,40,5,-4,5,1,8,0,8,-2,2,0,4,2,6,-1,1,0,1,13,9,0,-4,4,-1,0,0,-1,1,0,1,4,-1
KR_6758870464,420,1,-32,2,-5,-1,3,2,0,1,1,3,3,6,-5,6,1,-2,2,0,0,-7,10,-4,-2,6,-1,0,-1,-1,-1,-1,1,4,-1
KR_6762568449,420,-1,-27,-21,-6,-4,6,2,0,5,5,-2,4,2,0,1,1,0,0,0,-1,-5,33,2,-6,4,-3,0,-1,-1,-1,-1,-1,1,-1
KR_6653171592,420,0,61,-6,0,1,2,3,1,2,3,2,3,5,-2,6,4,-2,3,1,0,-6,-6,-1,-3,4,-2,0,2,1,1,1,1,2,-1
KR_6755376034,420,-6,-133,-4,-16,-3,4,1,-4,6,2,-6,8,2,-3,5,2,0,0,0,0,-16,-5,-2,-1,3,-1,0,-3,-1,-1,-1,-1,5,-1
KR_6761206287,420,1,56,31,8,-4,4,0,1,1,2,1,1,2,7,0,7,3,0,3,0,12,9,4,-6,2,0,0,-1,0,1,-1,1,0,-1
KR_6768440505,420,-4,-38,12,-19,-2,4,2,-4,4,0,0,2,2,-12,13,1,-1,1,0,0,-30,-2,6,-8,2,-6,0,-1,-1,1,-1,-1,1,-1
KR_6765558078,420,1,7,-25,-2,2,1,3,1,2,3,-1,4,3,0,4,4,-4,5,1,0,-5,-121,-1,-5,6,2,0,0,0,0,0,-1,0,-1
KR_6755237593,420,-1,-16,-20,-1,2,0,2,-3,3,0,0,1,1,-2,3,1,2,0,2,0,-5,17,5,-8,3,-4,0,-1,-1,-1,-1,-1,4,-1
KR_6633993219,420,-5,6,2,-11,-2,2,0,-5,6,1,-1,3,2,-3,4,1,0,2,2,0,-5,117,-2,-6,8,5,0,1,-1,-1,-1,-1,3,-1
KR_6685134864,420,1,34,7,0,-1,3,2,-4,6,2,3,1,4,1,3,4,1,2,3,0,0,-12,1,-9,8,-6,0,1,1,-1,1,-1,6,-1
KR_6658589257,420,-1,-25,40,-9,-4,5,1,-3,8,5,2,1,3,-2,4,2,-2,2,0,0,-13,-1,-6,-5,11,4,0,-1,-1,1,-1,1,1,-1
KR_6768052017,420,-1,-48,31,-4,-1,3,2,3,3,6,2,1,3,-8,11,3,0,2,2,0,-2,4,-1,-3,4,-6,0,-1,-1,-1,-1,-1,1,-1
KR_6768887590,420,-1,36,8,-10,-5,7,2,-1,4,3,-4,4,0,1,2,3,-1,1,0,0,-18,1,-1,-5,6,-3,0,-1,1,-1,-1,-1,1,-1
KR_6764918787,420,-3,-18,13,0,4,0,4,3,1,4,0,3,3,-8,9,1,1,0,1,0,-11,39,7,-10,3,-31,0,-1,-1,1,-1,-1,5,-1
KR_6706342188,420,0,56,12,-1,1,1,2,0,5,5,2,3,5,-5,6,1,1,0,1,0,-7,6,4,-8,4,-1,0,2,1,1,1,1,5,-1
KR_6763033859,420,-1,10,-20,-5,-1,3,2,-1,5,4,-6,6,0,0,4,4,3,2,5,0,-5,-12,-3,-3,6,-1,0,1,-1,-1,1,1,5,-1
KR_6762486949,420,-1,-34,-6,0,1,1,2,-1,6,5,-2,3,1,2,2,4,0,3,3,0,-6,-3,-1,-6,7,-1,0,0,1,1,1,-1,6,-1
KR_6762695187,420,-3,-25,-28,-2,1,1,2,0,2,2,-3,3,0,-1,5,4,1,1,2,0,-1,-1,0,-5,5,-3,0,-1,-1,-1,-1,1,3,-1
KR_6730361121,420,2,7,11,5,1,1,2,2,2,4,1,2,3,1,1,2,0,0,0,0,11,-10,2,-6,4,1,0,1,1,1,1,1,5,-1
KR_6768547758,420,2,0,-28,7,4,1,5,-2,3,1,7,0,7,1,4,5,-3,3,0,-1,2,-25,4,-7,3,0,0,0,-1,1,0,-1,4,-1
KR_6762213789,420,1,-42,-10,6,3,0,3,3,1,4,1,1,2,2,6,8,-3,4,1,0,15,-9,2,-5,3,4,0,0,1,1,0,1,1,-1
KR_6684008866,420,-3,-40,4,-4,1,1,2,0,2,2,-4,4,0,-2,3,1,1,0,1,1,-9,38,4,-9,5,-7,0,-3,-1,-1,-1,1,3,-1
KR_6704258880,420,0,42,7,0,4,1,5,-2,5,3,0,3,3,-1,5,4,-1,1,0,0,0,-23,-2,-7,9,0,0,1,-1,1,1,1,6,-1
KR_6727883142,420,-1,-41,-5,4,-1,4,3,4,2,6,-1,4,3,1,3,4,1,0,1,2,8,57,5,-10,5,0,0,1,1,1,1,1,4,-1
KR_6762084488,420,-6,-74,1,-11,-1,1,0,-1,5,4,-4,7,3,-1,3,2,-4,7,3,-1,-8,1,2,-9,7,-3,0,1,-1,-1,-1,-1,5,-1
KR_6704691048,420,-1,-69,15,-3,2,0,2,-1,2,1,1,2,3,-5,8,3,0,1,1,1,-3,-15,-7,-4,11,4,0,-2,1,-1,-1,1,3,-1
KR_6758746482,420,0,5,36,1,1,1,2,-1,2,1,3,3,6,-1,6,5,-1,1,0,1,6,70,-1,-5,6,-37,0,0,-1,1,0,1,2,-1
KR_6654950347,420,-2,-49,6,-10,-1,2,1,-2,3,1,1,0,1,-9,9,0,1,0,1,0,-5,-4,-2,-6,8,-1,0,-2,-1,1,-1,-1,2,-1
KR_6732491276,420,-3,-76,16,-15,-10,10,0,-3,4,1,2,1,3,0,2,2,-4,4,0,0,-18,-1,1,-4,3,-2,0,-1,-1,-1,-1,-1,6,-1
KR_6767862976,420,-1,7,-14,5,0,2,2,1,4,5,1,2,3,4,0,4,-1,3,2,0,7,-13,-3,-3,6,4,0,0,-1,-1,0,-1,3,-1
KR_6746061049,420,1,1,-40,-1,1,1,2,1,4,5,0,1,1,-4,4,0,1,1,2,1,-3,-12,-1,-3,4,4,0,0,-1,1,0,1,5,-1
KR_6750395846,420,-3,-52,-6,-7,0,1,1,0,3,3,0,1,1,-4,6,2,-3,3,0,0,-9,-3,2,-6,4,1,0,0,1,-1,1,1,5,-1
KR_6766915226,420,3,35,21,4,-2,5,3,6,3,9,0,1,1,-2,6,4,2,1,3,0,1,-3,1,-6,5,5,0,0,1,-1,0,1,3,-1
KR_6761362748,420,-1,-10,-16,-8,-2,4,2,-1,2,1,0,2,2,-4,7,3,-1,1,0,-3,-14,-6,4,-7,3,-2,0,-1,-1,-1,-1,-1,5,-1
KR_6769138465,420,-3,-49,-4,-9,-4,4,0,1,3,4,-2,2,0,-6,7,1,2,1,3,0,-3,-7,-3,-5,8,-5,0,-1,-1,1,-1,-1,5,-1
KR_6707846078,440,-3,-23,3,-6,-1,3,2,-2,3,1,-1,3,2,-1,3,2,-1,1,0,0,-7,2,-5,-2,7,0,0,1,-1,-1,1,-1,4,-1
KR_6750766125,420,-3,-46,-19,-6,-5,7,2,-1,3,2,1,2,3,-2,4,2,1,1,2,0,-1,-12,-2,-4,6,1,0,-1,-1,0,-1,-1,2,-1
KR_6717884934,420,-2,2,14,-11,0,2,2,-1,1,0,-3,4,1,-4,5,1,-3,3,0,-1,-13,-2,-1,-6,7,-4,0,0,-1,1,-1,-1,5,-1
KR_6752979506,440,1,-12,-16,-3,2,1,3,-3,4,1,2,1,3,2,0,2,-6,6,0,0,-1,-42,-1,-4,5,13,0,-1,-1,0,-1,1,6,-1
KR_6766976924,420,-2,-35,-31,-6,1,3,4,-1,8,7,-3,5,2,-5,5,0,2,1,3,0,4,0,-1,-3,4,1,0,-1,-1,-1,-1,1,3,-1
KR_6710816670,420,-5,-87,-24,-6,-1,5,4,0,2,2,0,0,0,-3,3,0,-2,2,0,-1,-10,31,-4,-5,9,-1,0,-2,-1,-1,-1,-1,1,-1
KR_6762002777,420,-2,-7,14,-4,-1,2,1,3,3,6,-8,8,0,3,0,3,-1,3,2,0,-7,-1,0,-4,4,1,0,0,-1,-1,-1,-1,1,-1
KR_6760668803,420,1,67,0,-2,4,2,6,-5,7,2,1,1,2,-1,2,1,-1,1,0,0,-6,-11,-6,-3,9,7,0,-1,-1,-1,1,1,3,-1
KR_6761342421,420,-6,-92,-18,-15,-2,2,0,-1,3,2,0,2,2,-9,10,1,-3,4,1,-1,-16,-17,-6,-2,8,0,0,-2,1,-1,-1,-1,1,-1
KR_6764920215,420,2,61,-6,3,1,0,1,0,2,2,3,0,3,-2,3,1,1,0,1,0,3,3,-2,-4,6,3,0,0,1,1,1,-1,5,-1
KR_6768966710,420,-2,21,-7,-3,-2,3,1,-1,2,1,-1,2,1,0,1,1,1,1,2,0,-3,-34,2,-4,2,-3,0,0,1,-1,-1,1,2,-1
KR_6761311313,420,-3,-56,12,-9,0,1,1,-5,7,2,-2,5,3,-2,2,0,0,1,1,0,3,-2,-2,-1,3,-3,0,-1,1,-1,-1,-1,2,-1
KR_6761207777,420,-3,41,-25,-11,-1,1,0,-10,12,2,-1,2,1,1,0,1,0,2,2,0,-16,-22,2,-5,3,4,0,0,-1,1,0,-1,3,-1
KR_6745821221,420,-1,-46,-3,-2,0,1,1,-4,5,1,0,0,0,4,0,4,-2,2,0,0,-2,1,2,-6,4,-2,0,0,-1,-1,-1,1,6,-1
KR_6769104718,420,2,6,0,3,-1,1,0,1,5,6,3,3,6,2,1,3,-2,3,1,0,3,5,5,-10,5,-1,0,0,-1,1,0,-1,5,-1
KR_6769198086,420,1,39,31,2,1,2,3,2,2,4,2,1,3,-1,2,1,-2,2,0,0,1,5,2,-6,4,2,0,0,0,1,1,-1,0,-1
KR_6768641931,420,-5,-83,-20,-2,4,2,6,-1,4,3,2,1,3,-4,4,0,-3,3,0,0,-13,-100,4,-9,5,-5,0,0,-1,1,-1,-1,6,-1
KR_6723605568,420,-5,0,-25,-5,4,0,4,-4,6,2,-2,3,1,-3,5,2,0,0,0,0,-5,-6,-4,-3,7,-4,0,-1,-1,-1,-1,-1,5,-1
KR_6675857840,440,-1,-48,-5,-1,-4,4,0,2,0,2,-1,3,2,2,2,4,0,2,2,0,3,-9,-3,0,3,1,0,0,-1,-1,-1,1,2,-1
KR_6679628224,420,1,-33,-15,-2,0,2,2,4,3,7,3,3,6,-8,12,4,-1,2,1,-2,-3,287,7,-9,2,1,0,-1,-1,1,-1,-1,5,-1
KR_6764540444,420,-1,-73,28,-5,-1,3,2,3,2,5,-1,4,3,-5,7,2,-1,2,1,-1,0,-3,-2,-4,6,1,0,0,-1,-1,-1,-1,1,-1
KR_6765688720,420,-1,-6,32,-5,-4,5,1,-1,3,2,0,5,5,0,5,5,0,1,1,0,-5,-3,2,-5,3,4,0,0,1,-1,0,-1,2,-1
KR_6768879586,420,-1,-27,-4,-4,0,2,2,-3,6,3,0,0,0,-1,2,1,0,0,0,0,-4,-3,-2,-6,8,-1,0,1,1,-1,1,1,1,-1
KR_6608657233,420,0,-29,3,2,4,0,4,-5,6,1,1,0,1,3,0,3,-1,1,0,1,1,-2,-3,-6,9,-1,0,0,-1,1,0,1,1,-1
KR_6706952842,420,-2,-51,12,-4,-2,3,1,0,2,2,-2,3,1,1,1,2,-1,2,1,0,-6,4,-3,-5,8,1,0,0,-1,-1,-1,-1,2,-1
KR_6755753656,420,-2,-48,24,-6,2,3,5,0,2,2,2,2,4,-10,11,1,0,1,1,-2,-7,3,3,-8,5,-1,0,-1,-1,1,-1,-1,2,-1
KR_6753282427,420,-3,-36,23,-1,-1,1,0,1,2,3,1,1,2,-1,3,2,-1,1,0,0,-2,-15,4,-9,5,-8,0,0,-1,1,0,1,1,-1
KR_6748243810,420,0,37,23,-4,1,0,1,-3,4,1,4,2,6,-3,3,0,-3,3,0,0,-5,48,5,-7,2,-3,0,-1,1,-1,-1,-1,5,-1
KR_6768402834,420,3,-6,-7,0,4,0,4,-2,4,2,-4,6,2,2,2,4,0,0,0,0,-3,21,1,-6,5,-16,0,2,1,1,1,-1,4,-1
KR_6721403252,420,-1,27,-3,-4,-1,2,1,0,3,3,1,2,3,-4,5,1,0,0,0,0,-19,19,0,-4,4,-3,0,1,-1,1,1,1,1,-1
KR_6759863977,420,-5,-40,7,-14,1,0,1,-4,4,0,-5,7,2,-5,7,2,-1,3,2,0,-4,-8,-2,-5,7,0,0,-2,-1,-1,-1,-1,3,-1
KR_6696041538,420,0,41,-12,6,0,6,6,1,1,2,-3,3,0,6,2,8,2,0,2,-2,9,-11,-2,-8,10,-1,0,-1,-1,-1,-1,1,4,-1
KR_6758840470,440,-1,46,8,-2,0,3,3,1,1,2,-5,7,2,-1,2,1,3,1,4,0,-1,37,-2,-4,6,2,0,0,-1,0,1,-1,3,-1
KR_6760228467,420,0,47,-2,-2,0,1,1,-2,4,2,4,3,7,-5,6,1,1,0,1,-2,-12,19,-9,-3,12,4,0,-1,1,-1,-1,-1,3,-1
KR_6767497525,420,-3,-29,-19,-4,2,1,3,-1,4,3,2,1,3,-5,6,1,-2,2,0,-1,-2,4,-4,-2,6,0,0,-3,-1,-1,-1,-1,4,-1
KR_6755861394,420,-1,-46,17,6,3,0,3,2,3,5,3,3,6,-1,3,2,-1,3,2,0,4,18,-6,-4,10,-2,0,-1,1,1,-1,1,5,-1
KR_6765296661,420,1,-25,12,3,1,1,2,2,1,3,1,2,3,-2,4,2,1,0,1,0,5,-1,-1,-5,6,-1,0,0,-1,-1,0,-1,5,-1
KR_6760595406,420,-2,-22,-24,-3,1,2,3,-4,5,1,0,1,1,0,1,1,0,0,0,0,-1,7,3,-9,6,-2,0,1,-1,1,1,-1,2,-1
KR_6643199373,420,1,-38,8,-3,-1,1,0,0,4,4,-1,3,2,4,1,5,-5,5,0,-1,-4,1,3,-7,4,-1,0,-1,1,1,-1,-1,3,-1
KR_6761673321,420,2,-12,24,4,0,3,3,2,3,5,-1,1,0,0,1,1,3,0,3,0,-1,-1,-3,-7,10,0,0,1,1,-1,1,-1,3,-1
KR_6756079563,420,0,-23,-56,-3,-1,2,1,0,3,3,-3,7,4,2,3,5,-1,2,1,-1,-3,-27,-3,-6,9,-1,0,-2,1,-1,-1,-1,1,-1
KR_6668569837,420,2,82,8,6,3,1,4,1,2,3,1,2,3,-1,3,2,2,0,2,0,3,112,0,-7,7,2,0,0,1,-1,-1,1,1,-1
KR_6766736904,420,2,42,-4,-1,-2,3,1,3,2,5,0,0,0,-1,2,1,-1,1,0,-1,-5,-12,-2,-4,6,4,0,-1,-1,-1,-1,-1,1,-1
KR_6764434286,420,-5,-143,-8,-10,-3,4,1,0,3,3,-2,3,1,-3,3,0,-2,2,0,0,-9,-1,3,-6,3,-3,0,-2,-1,-1,-1,-1,1,-1
KR_6697023340,420,-6,-107,-50,-25,-4,4,0,-3,5,2,-7,10,3,-4,8,4,-7,9,2,-2,-12,90,-3,-2,5,4,-1,-7,-1,-1,-1,-1,4,-1
KR_6764535838,420,-3,-97,-5,-10,-1,1,0,-3,6,3,-2,3,1,-3,3,0,-1,1,0,0,-5,11,11,-13,2,-4,0,-3,-1,-1,-1,-1,6,-1
KR_6667104003,420,-1,-59,20,1,0,2,2,-3,6,3,1,2,3,3,3,6,0,1,1,0,2,8,-1,-5,6,0,0,-1,1,1,-1,1,6,-1
KR_6750724706,420,-3,-25,-40,-7,0,1,1,-5,6,1,0,4,4,-2,6,4,0,2,2,-1,-7,2,2,-6,4,-2,0,0,0,1,-1,-1,0,-1
KR_6734172756,420,4,75,15,4,-1,4,3,2,2,4,-2,5,3,3,4,7,2,2,4,-2,-6,8,2,-6,4,1,0,2,-1,-1,1,1,2,-1
KR_6767939614,420,-5,-40,-52,-6,2,0,2,-2,3,1,-5,5,0,-1,1,0,0,0,0,-2,-10,-43,2,-6,4,1,0,0,-1,1,0,-1,3,-1
KR_6760956340,420,-2,-57,-22,1,-6,6,0,1,0,1,1,0,1,5,3,8,0,1,1,0,4,26,1,-7,6,-3,0,-1,-1,-1,-1,1,1,-1
KR_6761668701,420,-1,-54,-20,-6,-4,6,2,-2,3,1,1,0,1,-1,3,2,0,1,1,0,-4,-11,-2,-4,6,-1,0,-1,1,-1,-1,-1,2,-1
KR_6750625841,420,-3,-33,1,-10,-5,6,1,2,4,6,-1,6,5,-5,6,1,-1,1,0,0,-5,-12,-8,-1,9,3,0,-3,1,-1,-1,1,3,-1
KR_6760323243,440,-1,5,-12,3,-1,3,2,1,2,3,1,3,4,-1,2,1,3,0,3,1,-1,-13,-1,-5,6,-7,0,1,-1,1,1,1,2,-1
KR_6751954594,420,-2,2,4,-4,3,1,4,-4,5,1,-2,3,1,-1,3,2,0,4,4,-1,-18,1,-2,-5,7,-3,0,1,-1,0,1,-1,6,-1
KR_6753123167,420,-1,-24,-25,-3,-2,2,0,-1,3,2,3,0,3,-5,6,1,2,0,2,0,-3,6,1,-6,5,-9,0,2,-1,-1,1,-1,2,-1
KR_6679723340,420,-1,-10,-36,1,-4,4,0,6,1,7,1,2,3,-3,6,3,1,1,2,1,9,5,1,-8,7,6,0,0,-1,-1,-1,1,2,-1
KR_6748029800,420,-1,-31,4,-7,-1,2,1,2,2,4,-1,5,4,-6,6,0,-1,1,0,0,-9,50,3,-5,2,-9,0,1,-1,1,1,1,4,-1
KR_6746576028,420,-2,-35,-8,-6,-2,3,1,-1,1,0,0,4,4,-4,7,3,1,0,1,0,-7,1,4,-6,2,3,0,0,1,1,0,-1,4,-1
KR_6669692698,420,-6,-70,-6,-6,-2,3,1,1,1,2,-1,3,2,-1,3,2,-3,3,0,0,-9,19,-2,-5,7,-3,0,-2,-1,1,-1,1,4,-1
KR_6724417066,420,-2,0,-16,-2,0,2,2,-2,5,3,2,3,5,0,2,2,-2,2,0,1,4,22,4,-9,5,0,0,1,-1,1,1,1,5,-1
KR_6756485417,420,-1,-12,6,-3,1,1,2,0,4,4,-1,2,1,-1,2,1,-2,2,0,0,-9,-2,0,-6,6,1,0,-2,-1,1,1,-1,4,-1
KR_6750596390,420,-5,-7,-20,-4,1,2,3,-2,4,2,-3,7,4,-1,1,0,1,1,2,0,-8,16,0,-7,7,-5,0,0,0,1,0,1,0,-1
KR_6761937460,420,0,-19,43,-3,3,1,4,2,2,4,1,1,2,-8,10,2,-1,1,0,0,-10,13,-1,-2,3,0,0,1,-1,1,1,1,6,-1
KR_6692990906,420,-3,-69,-15,-4,-1,1,0,2,4,6,-4,5,1,2,1,3,-3,3,0,0,-7,-215,-1,-6,7,4,0,-1,1,-1,-1,-1,1,-1
KR_6767592804,420,-3,-38,4,-6,1,0,1,-3,3,0,2,0,2,-3,6,3,-3,3,0,0,-2,-14,-1,-8,9,2,0,0,-1,1,-1,-1,5,-1
KR_6764621923,420,0,30,-8,5,3,0,3,-1,3,2,0,2,2,0,2,2,3,1,4,0,-5,-32,1,-5,4,-6,0,0,-1,0,0,1,2,-1
KR_6608805888,420,-11,-224,-32,-15,0,1,1,-6,7,1,-3,4,1,-7,8,1,1,0,1,0,-14,-5,1,-4,3,1,-1,-8,-1,-1,-1,1,6,-1
KR_6597481004,420,-4,-43,-19,-10,0,1,1,-3,5,2,0,0,0,-5,6,1,-2,2,0,0,-9,2,1,-4,3,-5,0,-2,1,1,-1,-1,2,-1
KR_6761818447,420,-2,5,1,-8,-1,1,0,0,2,2,-1,7,6,-4,6,2,-2,2,0,0,-7,0,-1,0,1,-4,0,-1,1,-1,1,1,2,-1
KR_6643299104,420,-3,-31,8,-5,-3,4,1,1,5,6,-2,4,2,-1,3,2,0,1,1,0,-4,-7,-3,-7,10,3,0,1,1,1,1,-1,3,-1
KR_6716635983,420,-2,-31,-32,-5,-2,5,3,3,2,5,-2,2,0,-3,4,1,-1,1,0,0,-13,155,-4,-4,8,-2,0,-1,-1,-1,-1,-1,3,-1
KR_6712640890,420,-5,-72,-30,-10,-3,4,1,-3,5,2,1,1,2,-3,4,1,-2,3,1,-1,-8,2,4,-8,4,0,0,-2,-1,1,-1,-1,6,-1
KR_6763639442,440,-3,-106,-14,-9,2,1,3,1,2,3,-3,4,1,-5,6,1,-4,5,1,0,-4,-3,4,-8,4,-1,0,-1,0,-1,-1,-1,0,-1
KR_6744489028,420,-6,-77,-11,-17,-5,5,0,-5,5,0,1,2,3,-7,9,2,-1,3,2,0,-22,-9,4,-9,5,-3,0,-1,-1,1,-1,-1,1,-1
KR_6765494409,420,-4,17,0,-10,-4,4,0,-3,6,3,-3,6,3,0,3,3,0,1,1,0,-3,6,3,-5,2,3,0,-1,1,-1,1,1,2,-1
KR_6681028161,420,-2,-62,-24,-3,0,4,4,2,5,7,1,2,3,-5,6,1,-1,1,0,-1,-13,-2,-3,-6,9,-1,0,1,-1,1,1,1,1,-1
KR_6727774946,420,-5,-78,-9,-13,0,1,1,-5,6,1,-1,5,4,-7,9,2,0,0,0,-1,-20,-37,-2,-3,5,4,0,-2,1,1,-1,-1,2,-1
KR_6735078447,420,1,1,-36,-4,-1,3,2,-3,5,2,-1,2,1,-1,2,1,2,1,3,0,2,-13,1,-8,7,3,0,0,1,1,0,-1,6,-1
KR_6745713047,420,-4,-4,1,-4,1,1,2,-5,6,1,1,1,2,0,2,2,-1,1,0,0,-7,-21,-2,-4,6,-1,0,0,-1,-1,0,1,4,-1
KR_6767570320,420,-3,0,-23,-15,-5,6,1,-6,7,1,0,3,3,-2,6,4,-2,3,1,-4,-14,1,0,-5,5,-2,0,-1,-1,-1,-1,-1,2,-1
KR_6762490162,420,-1,-38,-12,-3,-3,3,0,0,3,3,0,1,1,0,0,0,0,0,0,0,-7,12,-4,-3,7,3,0,-1,-1,-1,-1,1,3,-1
KR_6762709480,420,2,53,16,2,5,1,6,4,0,4,-6,8,2,-1,2,1,0,0,0,0,0,-23,-4,-2,6,2,0,1,-1,1,1,-1,6,-1
KR_6768258249,420,3,82,5,3,3,0,3,-5,8,3,3,2,5,1,6,7,1,0,1,-2,-3,-25,1,-9,8,-2,0,0,1,-1,-1,-1,1,-1
KR_6766839636,420,-1,5,-4,-9,-2,2,0,0,5,5,-1,6,5,-5,6,1,-1,1,0,0,-12,-24,-1,-5,6,4,0,0,1,-1,0,-1,5,-1
KR_6759736896,420,-3,-41,-2,-7,-1,4,3,-4,5,1,3,1,4,-3,4,1,-2,3,1,0,0,-30,-7,-3,10,2,0,-3,-1,-1,-1,1,3,-1
KR_6759848662,420,0,57,0,-1,1,2,3,0,4,4,-3,4,1,3,4,7,-2,2,0,0,-7,16,5,-7,2,3,0,0,-1,1,1,1,2,-1
KR_6732542343,440,-2,-51,17,-7,-2,6,4,-1,2,1,-1,1,0,-3,4,1,0,1,1,0,-7,6,2,-2,0,0,0,-1,1,-1,-1,-1,2,-1
KR_6745718667,420,2,61,19,-1,3,0,3,-7,7,0,-1,2,1,-2,3,1,6,0,6,0,-3,15,5,-9,4,2,0,1,-1,1,1,1,1,-1
KR_6766277901,420,-5,-56,4,-11,-1,2,1,0,5,5,-8,11,3,-5,5,0,3,0,3,0,-7,-51,-3,-3,6,15,0,0,-1,-1,-1,1,1,-1
KR_6754511406,420,-2,-45,0,-9,-2,2,0,0,1,1,-4,4,0,-2,4,2,-1,1,0,0,-8,2,-5,-4,9,1,0,0,-1,-1,-1,-1,6,-1
KR_6679752758,420,2,50,17,0,-4,4,0,3,1,4,-1,1,0,1,0,1,1,0,1,0,2,16,4,-6,2,-2,0,1,-1,1,1,-1,1,-1
KR_6749127291,420,-1,-36,-13,0,-5,8,3,-1,2,1,0,4,4,3,3,6,3,0,3,-1,9,-7,-1,-7,8,-3,0,0,1,-1,-1,-1,2,-1
KR_6733255786,420,-1,26,-7,-8,5,0,5,-6,6,0,-5,5,0,0,0,0,-2,2,0,0,-12,160,-5,-5,10,0,0,1,1,-1,1,1,1,-1
KR_6625017072,420,0,7,9,-1,3,0,3,-1,5,4,1,4,5,-3,5,2,-1,1,0,0,-3,24,-2,-5,7,-2,0,1,1,0,1,1,6,-1
KR_6760721486,420,0,41,4,-3,1,1,2,0,0,0,-4,6,2,1,2,3,-1,1,0,0,-3,-36,3,-9,6,2,0,1,1,-1,-1,-1,6,-1
KR_6645645512,420,-3,-23,-26,-14,-4,6,2,-6,7,1,-4,4,0,-2,5,3,2,0,2,0,-6,5,-2,-3,5,-1,0,0,-1,1,-1,-1,2,-1
KR_6742760078,420,-7,3,-47,-22,-7,8,1,-5,5,0,-5,7,2,-6,6,0,1,0,1,0,-20,-34,-3,-4,7,2,0,-1,-1,-1,-1,-1,5,-1
KR_6749337737,420,-6,-75,-44,-15,-6,6,0,-2,6,4,-5,5,0,-6,7,1,4,1,5,-4,-11,-36,6,-9,3,3,0,-4,-1,-1,-1,-1,3,-1
KR_6768978487,420,-5,-47,-16,-14,0,1,1,-7,8,1,-2,4,2,-4,4,0,-1,1,0,0,-9,2,2,-5,3,-1,0,-1,-1,-1,-1,-1,4,-1
KR_6723089535,420,-4,10,-20,-5,-4,6,2,1,3,4,2,0,2,-4,4,0,0,0,0,0,-7,-12,-1,-5,6,-5,0,-1,1,1,-1,1,6,-1
KR_6719151336,420,-4,-77,-23,-5,-2,3,1,1,2,3,0,5,5,-5,9,4,1,0,1,0,-9,-3,0,-8,8,0,0,-1,-1,-1,-1,1,4,-1
KR_6755666094,440,-3,-72,-7,-3,1,3,4,4,1,5,-1,2,1,-5,7,2,-2,4,2,0,-5,2,-8,-3,11,0,0,-1,1,1,-1,1,6,-1
KR_6752831100,420,-5,-14,-26,-4,0,3,3,-6,6,0,0,2,2,0,3,3,2,0,2,1,-2,186,-5,-1,6,-2,0,-2,-1,-1,-1,1,3,-1
KR_6765076638,420,-2,-24,-21,-4,0,1,1,-3,4,1,-4,5,1,4,3,7,-1,2,1,0,-6,286,-3,-4,7,-9,0,-1,-1,-1,-1,-1,4,-1
KR_6730969865,420,3,12,11,10,-3,5,2,7,0,7,5,1,6,-1,3,2,2,0,2,0,17,-51,-4,-2,6,35,0,-1,-1,1,-1,1,1,-1
KR_6593452040,420,-2,-12,31,-11,-2,3,1,-8,10,2,-1,1,0,1,1,2,-1,1,0,0,-8,0,0,-7,7,-1,0,-2,-1,-1,-1,-1,4,-1
KR_6762434332,420,-2,-9,4,-8,1,2,3,-5,8,3,-1,3,2,0,5,5,-3,3,0,0,-5,-1,-1,-3,4,3,0,-1,1,1,-1,1,4,-1
KR_6752933310,440,-3,1,-3,-4,-3,3,0,6,1,7,-2,6,4,-2,3,1,-3,5,2,-2,-12,-14,-7,-1,8,2,0,-1,-1,-1,-1,-1,1,-1
KR_6747427764,420,-1,-51,-4,1,-1,2,1,-2,5,3,1,3,4,2,1,3,1,1,2,0,7,-56,-1,-4,5,2,0,0,-1,-1,0,-1,6,-1
KR_6748124985,420,5,3,48,4,1,0,1,8,1,9,-2,6,4,-4,5,1,1,0,1,-1,3,-23,-6,-2,8,0,0,1,1,1,1,-1,4,-1
KR_6759467091,420,-1,-43,-24,3,-3,3,0,4,1,5,4,1,5,-1,4,3,-1,2,1,1,11,1,6,-9,3,1,0,1,-1,1,1,1,2,-1
KR_6759834258,420,-5,-73,-20,-4,-4,4,0,0,0,0,4,1,5,-3,4,1,-1,1,0,0,-2,73,0,-4,4,2,0,-2,-1,-1,-1,-1,1,-1
KR_6761884525,420,-2,21,-37,1,-4,4,0,2,2,4,-2,5,3,2,2,4,3,1,4,0,8,6,1,-5,4,0,0,0,-1,1,1,1,3,-1
KR_6768606621,420,0,-72,-3,-5,1,3,4,-4,7,3,1,3,4,-1,2,1,-2,2,0,0,-6,-1,-2,-5,7,-2,0,-1,1,-1,-1,-1,6,-1
KR_6713205472,420,-1,-8,5,-4,0,1,1,2,2,4,3,0,3,-9,9,0,0,1,1,0,-7,-2,0,-4,4,0,0,-1,-1,1,-1,1,2,-1
KR_6727637417,420,1,-39,12,7,1,0,1,2,3,5,-1,1,0,0,1,1,5,0,5,0,10,7,1,-5,4,-1,0,0,-1,1,0,-1,4,-1
KR_6760977322,420,-3,-66,-16,-12,1,1,2,-4,5,1,-5,6,1,-2,3,1,-2,3,1,0,-16,12,0,-4,4,-2,0,-1,1,-1,-1,-1,3,-1
KR_6745297181,420,0,-18,-36,-1,1,0,1,-2,3,1,0,3,3,-1,3,2,1,1,2,0,-5,0,-4,-4,8,3,0,0,-1,-1,0,-1,3,-1
KR_6762386027,420,0,-37,11,3,1,0,1,-4,6,2,3,0,3,1,2,3,2,3,5,0,-4,-1,2,-3,1,-5,0,0,0,1,1,-1,0,-1
KR_6767599620,420,-1,35,-28,-4,1,2,3,-2,4,2,0,0,0,-4,4,0,1,2,3,-1,-8,77,-2,-5,7,-41,0,-2,-1,-1,-1,-1,1,-1
KR_6756778459,420,4,-2,-16,10,2,2,4,3,0,3,5,0,5,-2,4,2,2,1,3,4,11,-13,-1,-6,7,3,0,1,1,-1,1,1,5,-1
KR_6752555082,420,1,60,6,-3,1,0,1,-3,3,0,0,1,1,2,1,3,-3,3,0,0,-7,-24,-1,-7,8,7,0,0,1,1,1,1,5,-1
KR_6668627386,420,-4,-46,-28,-9,-3,7,4,-1,3,2,-8,10,2,1,3,4,2,0,2,0,-6,-9,3,-6,3,0,0,-1,-1,1,1,1,5,-1
KR_6715294431,420,0,22,0,-5,-1,2,1,-6,6,0,-1,3,2,-1,3,2,4,0,4,0,-1,-6,-1,-4,5,-4,0,0,-1,0,0,1,1,-1
KR_6706572707,420,2,10,13,8,1,2,3,1,1,2,2,1,3,-2,6,4,6,0,6,1,7,9,-4,-5,9,-2,0,1,1,-1,1,-1,3,-1
KR_6769124907,420,-1,76,-45,-7,0,1,1,-4,9,5,0,1,1,-3,6,3,0,2,2,0,-6,9,-1,-4,5,-3,0,-2,-1,-1,-1,-1,4,-1
KR_6765579077,420,-2,-10,-28,-6,2,1,3,-4,5,1,-1,4,3,-3,3,0,0,0,0,0,-6,7,1,-8,7,-1,0,0,-1,-1,0,-1,2,-1
KR_6768909530,420,-5,-59,-29,-4,-1,3,2,2,1,3,0,1,1,-2,4,2,-3,3,0,0,-1,11,1,-6,5,-6,0,-1,-1,1,-1,1,3,-1
KR_6694658855,420,-2,27,-18,-6,1,2,3,-4,6,2,-2,2,0,-2,4,2,1,3,4,0,-6,2,-2,-4,6,-7,0,-1,1,-1,-1,-1,3,-1
KR_6761388188,420,-3,-38,-24,-11,-1,1,0,-8,8,0,1,3,4,-5,9,4,2,0,2,0,-12,-23,1,-8,7,0,0,-1,-1,-1,-1,-1,5,-1
KR_6758661911,420,-4,-93,16,-4,-1,4,3,0,2,2,2,0,2,-5,7,2,0,0,0,0,7,84,-4,-5,9,-1,0,-1,1,-1,-1,1,6,-1
KR_6717961328,420,3,17,-1,-1,3,1,4,1,2,3,-3,5,2,-2,4,2,0,1,1,0,-7,10,-2,-4,6,-4,0,0,-1,1,-1,-1,3,-1
KR_6695269267,420,-3,-35,-8,-9,-7,7,0,-6,7,1,4,0,4,-3,3,0,3,0,3,0,-10,-208,0,-2,2,1,0,-1,1,-1,-1,-1,1,-1
KR_6763011793,420,-3,-3,-22,-12,0,0,0,-3,6,3,0,1,1,-8,9,1,-1,4,3,0,-14,1,-1,-6,7,-3,0,0,-1,-1,-1,1,4,-1
KR_6753366269,420,0,-21,-6,4,2,1,3,2,2,4,3,2,5,-1,3,2,-2,2,0,0,3,-12,-3,-2,5,0,0,-1,-1,0,-1,1,4,-1
KR_6766223856,420,-6,-116,-16,-17,-2,2,0,-4,5,1,-4,5,1,-2,5,3,-5,5,0,0,-15,-18,-4,-5,9,2,0,-1,1,1,-1,-1,2,-1
KR_6761092069,420,-2,49,-19,-3,3,0,3,-4,4,0,0,2,2,-3,4,1,1,0,1,0,-9,-7,6,-9,3,6,0,1,-1,1,1,-1,5,-1
KR_6570363457,420,1,8,17,3,4,2,6,2,5,7,0,1,1,-3,7,4,0,1,1,0,3,46,-5,-4,9,4,0,2,1,1,-1,1,4,-1
KR_6701994045,420,3,-12,-2,-3,1,0,1,0,6,6,-1,5,4,-2,5,3,-1,1,0,-2,0,2,-1,-4,5,-2,0,0,1,-1,-1,-1,5,-1
KR_6768660183,420,-2,-65,-30,0,0,1,1,2,1,3,-1,3,2,-4,10,6,3,2,5,0,1,46,3,-6,3,-2,0,-2,1,-1,-1,-1,2,-1
KR_6768347924,420,-6,-127,-7,-14,-6,6,0,-2,3,1,0,1,1,-7,7,0,1,1,2,0,-9,-1,6,-11,5,-9,0,-1,-1,1,-1,-1,1,-1
KR_6745686726,420,-2,-29,-24,1,2,1,3,-1,2,1,0,1,1,0,2,2,0,0,0,0,4,-25,4,-9,5,0,0,0,1,-1,-1,-1,5,-1
KR_6765065474,420,1,-11,24,1,-1,3,2,-1,4,3,0,0,0,3,0,3,0,1,1,0,1,-1,-1,-4,5,3,0,-1,1,-1,-1,1,2,-1
KR_6769101979,440,0,-59,28,-5,-1,3,2,2,0,2,-1,5,4,-4,7,3,-1,1,0,-1,-8,3,2,-4,2,-1,0,0,1,1,-1,-1,6,-1
KR_6724800447,440,-3,49,8,-13,-2,3,1,-2,3,1,1,0,1,-11,11,0,1,0,1,0,-20,-137,-4,-4,8,5,0,0,1,-1,-1,-1,2,-1
KR_6661929945,420,-5,-76,-48,-13,0,3,3,-2,3,1,-5,6,1,-6,6,0,0,1,1,0,-20,-7,-1,-5,6,-1,0,0,-1,-1,-1,1,2,-1
KR_6736918544,440,0,-27,0,-5,0,0,0,-1,3,2,-2,5,3,-1,3,2,-1,1,0,0,-8,8,-2,-4,6,9,0,0,-1,0,0,-1,5,-1
KR_6736184480,420,2,38,22,0,3,0,3,-6,8,2,1,0,1,1,1,2,1,0,1,0,-6,0,-1,-6,7,-3,0,0,1,-1,0,-1,5,-1
KR_6766787296,420,-1,-58,7,-3,0,1,1,-2,2,0,-1,5,4,0,0,0,0,0,0,0,1,-29,0,-5,5,2,0,0,1,-1,-1,-1,2,-1
KR_6756551595,420,-2,-36,4,1,-1,2,1,-1,4,3,0,3,3,2,1,3,1,0,1,0,5,-19,-2,-5,7,8,0,-1,0,-1,-1,1,0,-1
KR_6747420085,420,0,-9,-9,-2,2,2,4,-5,5,0,0,3,3,-1,4,3,2,2,4,2,-8,-3,3,-8,5,0,0,-1,-1,-1,-1,1,5,-1
KR_6759345437,420,-4,-24,-30,-8,-4,6,2,1,1,2,-1,2,1,-2,2,0,-2,2,0,0,0,1,-3,-3,6,0,0,0,-1,-1,-1,-1,4,-1
KR_6692899620,440,0,25,-41,-1,-5,5,0,5,2,7,0,1,1,-1,5,4,0,2,2,0,-4,4,-5,-3,8,1,0,1,-1,0,1,1,2,-1
KR_6753670083,420,0,-20,17,2,-2,2,0,-2,4,2,2,2,4,3,1,4,1,0,1,0,0,17,1,-6,5,-2,0,0,-1,-1,0,-1,6,-1
KR_6730308757,420,1,-28,34,0,2,0,2,1,4,5,3,0,3,0,2,2,-6,7,1,-1,-10,0,7,-9,2,-4,0,0,1,1,0,-1,6,-1
KR_6753213406,420,1,-5,5,-7,0,1,1,-4,4,0,-4,4,0,2,1,3,-1,1,0,0,-9,-63,-4,-5,9,0,0,1,-1,1,1,-1,3,-1
KR_6704066178,420,-5,-80,-19,-13,-2,5,3,-2,3,1,0,2,2,-4,4,0,-5,5,0,-1,-8,9,-3,0,3,-4,0,-3,1,-1,-1,-1,1,-1
KR_6727105759,420,-2,1,-20,-5,-9,9,0,-1,5,4,-3,3,0,2,3,5,6,0,6,0,-11,-10,0,-7,7,-1,0,-1,-1,-1,-1,-1,5,-1
KR_6767388130,420,-1,25,24,-1,-3,3,0,2,1,3,2,2,4,-1,1,0,-1,1,0,1,4,7,1,-8,7,-3,0,0,1,0,-1,1,1,-1
KR_6767515970,420,-2,-60,-24,0,-2,2,0,9,0,9,-4,4,0,-3,5,2,0,1,1,1,4,1,-2,-4,6,2,0,-1,-1,0,-1,-1,6,-1
KR_6713307816,420,-1,-73,-9,-5,-2,2,0,0,4,4,-1,1,0,-2,2,0,0,0,0,0,-1,-16,-2,-6,8,3,0,-2,-1,-1,-1,-1,5,-1
KR_6750421173,420,-4,-28,-16,-16,-1,4,3,-5,5,0,0,1,1,-7,7,0,-3,3,0,-3,-20,5,-1,-7,8,-7,0,-2,-1,-1,-1,-1,4,-1
KR_6595015464,420,-2,-5,14,-10,-1,3,2,-1,5,4,-5,5,0,-3,3,0,0,1,1,0,-18,-11,-4,-5,9,1,0,-1,-1,-1,-1,-1,2,-1
KR_6763277728,420,-1,-52,8,5,2,2,4,1,3,4,0,1,1,0,1,1,2,0,2,0,-3,3,0,-4,4,-4,0,-1,1,1,-1,1,4,-1
KR_6767136588,420,-4,-21,-2,-4,-1,1,0,-2,4,2,-1,2,1,1,2,3,-1,1,0,0,-5,-6,4,-8,4,-6,0,0,1,-1,0,1,3,-1
KR_6767280946,420,-1,15,-33,-2,3,1,4,-2,5,3,-2,3,1,-1,6,5,0,0,0,1,-2,48,6,-9,3,-22,0,0,-1,1,1,1,4,-1
KR_6767791298,420,-1,-28,-10,-9,0,2,2,-1,3,2,-4,6,2,-3,5,2,-1,1,0,0,-15,-8,-4,-4,8,-4,0,-1,-1,1,-1,1,6,-1
KR_6767374146,420,-2,-22,7,-3,-2,3,1,2,3,5,2,2,4,-5,10,5,0,0,0,-2,-1,-3,1,-7,6,-1,0,1,1,-1,1,-1,4,-1
KR_6646901990,420,2,-40,-3,4,-1,2,1,1,0,1,5,0,5,2,4,6,-3,4,1,1,5,5,2,-8,6,2,0,0,0,-1,0,1,0,-1
KR_6754669087,420,-2,-56,-36,-2,-5,6,1,3,2,5,2,1,3,-2,4,2,0,1,1,0,-6,-3,-2,-2,4,-4,0,0,-1,1,-1,-1,2,-1
KR_6740355280,420,0,-17,-10,-5,-3,3,0,1,2,3,0,1,1,-4,5,1,1,0,1,0,2,-3,-2,-5,7,1,0,-1,-1,1,-1,-1,5,-1
KR_6762908340,420,-2,-86,-3,-1,1,0,1,-1,5,4,-4,5,1,2,3,5,1,0,1,0,-6,-7,-2,-4,6,0,0,0,-1,1,0,1,4,-1
KR_6603147288,420,-1,-42,20,3,1,0,1,1,4,5,1,3,4,-1,3,2,1,0,1,0,3,0,0,-5,5,-6,0,0,1,-1,-1,1,6,-1
KR_6745783379,420,-6,-35,-24,-14,-2,4,2,0,3,3,-5,6,1,-3,6,3,-4,5,1,0,-15,-12,0,-4,4,6,0,-1,-1,1,-1,-1,4,-1
KR_6757643323,420,-3,30,-8,-3,2,0,2,0,3,3,0,2,2,-2,4,2,-3,4,1,0,-5,-31,-1,-3,4,12,0,1,1,1,1,1,3,-1
KR_6745727451,420,-2,16,-20,-10,0,1,1,-2,5,3,-4,6,2,-2,6,4,-2,3,1,-3,-2,-11,-1,-5,6,-2,0,-2,-1,-1,-1,-1,6,-1
KR_6734501466,420,-3,-4,-3,-14,-2,3,1,-1,4,3,0,5,5,-5,8,3,-6,8,2,-1,-4,26,3,-10,7,-4,0,1,-1,1,1,1,6,-1
KR_6731732380,420,0,30,25,-3,0,3,3,-1,2,1,4,1,5,-5,6,1,-1,1,0,0,-8,18,3,-9,6,-6,0,0,-1,1,-1,1,3,-1
KR_6732833748,440,-1,-30,-11,-9,-2,7,5,0,2,2,2,2,4,-7,7,0,-2,2,0,0,-7,-3,1,-4,3,1,0,0,-1,-1,-1,1,6,-1
KR_6745123659,420,-1,-30,24,-8,-6,6,0,-2,5,3,-1,1,0,1,3,4,0,0,0,-3,-10,-45,-2,-2,4,-2,0,-2,-1,-1,-1,-1,2,-1
KR_6706279687,440,-5,-120,-32,-13,0,2,2,0,2,2,-4,4,0,-2,4,2,-7,7,0,-1,-17,5,-3,-3,6,1,0,-1,-1,-1,-1,-1,4,-1
KR_6754911974,420,-4,-32,-28,-6,3,1,4,-5,7,2,-2,2,0,-2,3,1,0,1,1,0,-10,2,-3,-4,7,-6,0,0,-1,-1,0,-1,2,-1
KR_6768878361,420,-4,-61,-29,-8,-1,3,2,-2,3,1,-2,4,2,-4,7,3,1,1,2,-1,-12,-20,-5,-4,9,4,0,-4,-1,-1,-1,-1,5,-1
KR_6761208046,420,0,-31,34,2,-1,1,0,-2,4,2,1,0,1,2,4,6,2,1,3,0,4,-16,6,-10,4,-2,0,0,0,1,0,-1,0,-1
KR_6761475936,420,-2,-45,0,-2,0,2,2,0,2,2,-1,4,3,-2,4,2,1,0,1,0,-2,-2,1,-6,5,3,0,-1,1,-1,-1,1,3,-1
KR_6645486024,420,3,30,8,5,-5,5,0,0,5,5,5,1,6,6,1,7,-1,3,2,0,10,3,6,-11,5,-6,0,2,-1,1,1,1,6,-1
KR_6651659764,420,-2,-45,-30,5,-2,4,2,3,0,3,-1,2,1,4,1,5,1,1,2,0,11,17,6,-8,2,5,0,2,-1,1,1,1,1,-1
KR_6732183912,420,-5,16,-16,-6,-2,3,1,0,5,5,-2,3,1,-1,2,1,-1,1,0,0,-1,-3,-7,-3,10,0,0,-1,1,-1,-1,-1,4,-1
KR_6753095838,420,-1,5,19,-5,-2,3,1,3,0,3,-3,3,0,-3,4,1,0,0,0,0,-8,-2,-1,-4,5,-8,0,0,1,-1,0,-1,5,-1
KR_6759795017,420,2,-24,27,0,1,1,2,0,5,5,0,3,3,-2,4,2,1,2,3,-1,2,-11,-2,-4,6,5,0,-1,-1,-1,-1,-1,3,-1
KR_6752619893,420,-6,-46,-11,-7,1,2,3,-4,5,1,-2,4,2,-3,4,1,1,1,2,0,-7,-18,1,-7,6,-1,0,-1,1,-1,-1,1,3,-1
KR_6753984339,420,-3,-38,1,-10,-3,4,1,-2,4,2,-4,6,2,-3,6,3,2,1,3,-1,-8,7,-1,-3,4,-4,0,0,1,-1,0,-1,3,-1
KR_6734544199,420,-3,-64,-9,-3,-1,3,2,0,2,2,-2,4,2,0,7,7,0,1,1,-1,4,7,-2,-5,7,1,0,0,0,1,0,-1,0,-1
KR_6763836574,420,0,-11,0,0,3,1,4,4,3,7,-3,3,0,-4,6,2,0,0,0,0,-5,-5,-3,-4,7,2,0,-1,-1,1,-1,1,1,-1
KR_6741818595,420,-5,20,-24,-4,1,0,1,-5,5,0,1,1,2,-2,4,2,1,0,1,0,-12,-3,1,-4,3,-4,0,0,-1,1,0,1,5,-1
KR_6759562581,420,0,50,-12,-1,1,1,2,-1,3,2,-1,1,0,0,3,3,0,0,0,0,2,5,2,-6,4,2,0,0,-1,-1,0,-1,4,-1
KR_6757778970,420,-2,-40,-12,-5,-2,3,1,0,3,3,-1,3,2,-4,6,2,2,0,2,0,-10,-43,-1,-4,5,26,0,0,1,-1,-1,-1,6,-1
KR_6757709220,420,0,15,-13,3,-2,6,4,2,1,3,5,0,5,-3,4,1,1,1,2,0,11,7,3,-7,4,-3,0,-2,0,-1,-1,-1,0,-1
KR_6763522050,440,-3,-10,-22,-3,-1,1,0,0,1,1,3,3,6,-5,5,0,0,4,4,0,3,-128,-2,-3,5,-1,0,-1,-1,-1,-1,1,2,-1
KR_6675914577,420,-5,-111,-23,-3,-2,3,1,3,1,4,-1,1,0,1,0,1,-4,4,0,1,3,-12,-3,-4,7,4,0,-1,-1,0,-1,1,2,-1
KR_6762492168,420,-3,-26,-6,-7,-6,6,0,1,2,3,-6,6,0,4,1,5,0,0,0,0,-4,-21,-3,-4,7,2,0,0,-1,-1,-1,1,1,-1
KR_6726672764,420,0,-27,-12,-3,0,1,1,-6,8,2,-3,3,0,3,2,5,3,1,4,0,-7,-9,-2,-2,4,6,0,-1,1,-1,-1,-1,5,-1
KR_6611163402,420,-1,-32,-5,0,-2,2,0,4,0,4,-2,2,0,0,1,1,0,0,0,0,3,9,-2,-4,6,-1,0,0,1,-1,0,-1,3,-1
KR_6764948883,420,0,4,-28,0,-3,4,1,-3,4,1,4,0,4,1,2,3,1,1,2,0,4,-18,-2,-2,4,3,0,-1,0,-1,-1,1,0,-1
KR_6767279797,420,-3,-49,-17,-4,0,2,2,-4,6,2,-3,4,1,2,2,4,1,0,1,0,3,12,4,-10,6,-2,0,0,-1,-1,0,-1,3,-1
KR_6659348235,420,-3,-8,-4,-9,-4,4,0,2,2,4,-6,7,1,0,4,4,-1,1,0,0,-6,296,-3,-6,9,0,0,-1,-1,-1,-1,1,6,-1
KR_6749866579,420,1,6,-27,5,2,0,2,2,0,2,-1,4,3,1,5,6,1,2,3,0,4,-113,5,-9,4,3,0,0,1,0,0,-1,1,-1
KR_6767113422,420,1,4,3,3,4,1,5,-1,5,4,-2,4,2,1,2,3,1,1,2,0,-5,11,0,-6,6,-2,0,1,-1,1,-1,-1,4,-1
KR_6762690818,420,2,-2,32,6,4,0,4,2,2,4,4,0,4,-5,7,2,1,3,4,0,-3,9,3,-9,6,3,0,1,1,1,1,-1,4,-1
KR_6762185820,440,-3,-28,-37,-11,-4,5,1,0,0,0,-4,6,2,0,6,6,-3,3,0,-1,-10,-4,-2,-7,9,5,0,0,-1,-1,-1,-1,2,-1
KR_6657324072,420,0,22,-1,1,2,1,3,-1,5,4,-4,4,0,4,1,5,0,1,1,2,2,-103,2,-9,7,4,0,1,1,1,1,1,4,-1
KR_6731504423,420,-1,-16,-15,-14,-2,3,1,-1,6,5,-6,7,1,-2,4,2,-3,4,1,0,-17,-35,-2,-4,6,-1,0,-1,-1,-1,-1,1,1,-1
KR_6693968899,420,-3,-55,-32,-3,3,2,5,-4,4,0,-3,5,2,3,7,10,-2,2,0,-1,-1,-7,-2,-5,7,-2,0,-1,1,-1,-1,-1,1,-1
KR_6768232872,420,1,75,16,-5,2,2,4,1,3,4,0,1,1,-7,9,2,-1,2,1,0,-17,14,0,-6,6,4,0,1,-1,-1,1,1,3,-1
KR_6753048194,420,1,-11,-20,-1,2,2,4,1,1,2,-1,4,3,-1,5,4,-2,6,4,0,6,47,0,-8,8,-14,0,0,0,-1,1,1,0,-1
KR_6664359453,420,-3,-59,8,-5,-3,5,2,-1,4,3,-1,3,2,0,1,1,0,1,1,0,2,1,-6,-4,10,0,0,-1,-1,-1,-1,-1,4,-1
KR_6763739433,420,-3,-18,-10,-6,-4,4,0,3,2,5,-1,3,2,-3,5,2,-1,1,0,0,-12,-232,-1,-3,4,-1,0,-1,-1,-1,1,1,5,-1
KR_6765959644,420,-1,-45,-16,-4,-2,2,0,0,2,2,1,4,5,-1,4,3,-2,2,0,-1,-12,36,1,-6,5,0,0,0,1,1,-1,-1,3,-1
KR_6747591933,420,-2,-28,-2,-7,-1,2,1,-5,7,2,-2,5,3,3,0,3,-2,3,1,2,6,53,-5,-8,13,5,0,-1,-1,-1,-1,1,5,-1
KR_6694564308,420,-8,-115,-12,-23,-2,2,0,-9,9,0,-4,5,1,-6,6,0,-2,3,1,-1,-19,-4,-1,-3,4,0,0,-6,0,-1,-1,-1,0,-1
KR_6756720014,420,-4,-38,-1,-10,-3,4,1,1,3,4,-7,10,3,-1,4,3,0,1,1,0,-3,17,-1,-4,5,-2,0,0,-1,-1,-1,1,6,-1
KR_6681260996,420,2,22,-25,2,1,0,1,2,3,5,-1,3,2,-1,1,0,1,0,1,0,-1,6,1,-5,4,0,0,0,-1,1,0,1,4,-1
KR_6764526826,420,-3,-59,-28,-8,-4,5,1,0,3,3,-5,8,3,0,1,1,1,0,1,0,-1,14,0,-4,4,2,0,-1,1,-1,-1,-1,1,-1
KR_6767937808,420,-1,12,-17,-6,2,0,2,-2,4,2,-7,7,0,1,2,3,0,1,1,0,-8,13,1,-8,7,-3,0,-1,1,1,-1,-1,5,-1
KR_6768445655,420,1,59,-20,0,0,0,0,-1,6,5,2,1,3,-1,5,4,0,2,2,0,2,-1,2,-7,5,0,0,2,-1,1,1,1,4,-1
KR_6686880598,420,-5,17,-23,-14,1,1,2,-9,10,1,-1,1,0,-4,7,3,-1,1,0,0,-13,-178,-4,-2,6,-1,0,-1,-1,-1,-1,-1,4,-1
KR_6765043047,420,-2,-25,-6,-1,-2,3,1,0,5,5,2,3,5,0,2,2,-1,1,0,0,3,-21,-6,-1,7,3,0,-1,0,-1,-1,-1,0,-1
KR_6750226592,420,-4,-40,-6,-6,0,3,3,-11,11,0,3,2,5,-2,3,1,4,1,5,-1,-4,22,-5,-6,11,0,0,0,-1,1,0,-1,5,-1
KR_6751217501,440,-3,-99,0,-1,-3,4,1,-1,5,4,4,1,5,5,2,7,-6,7,1,0,6,7,3,-6,3,3,0,-1,-1,1,-1,-1,6,-1
KR_6752388082,420,-3,-65,10,-9,-2,2,0,-4,7,3,-5,5,0,1,3,4,1,1,2,0,-12,12,6,-11,5,-6,0,-1,-1,-1,-1,1,3,-1
KR_6760510349,420,2,28,4,8,5,0,5,-1,4,3,2,3,5,3,3,6,-1,2,1,1,12,-5,4,-8,4,1,0,0,0,1,0,1,0,-1
KR_6753903126,420,-3,-96,8,-7,2,1,3,-1,2,1,-4,4,0,-4,5,1,0,1,1,0,-10,-6,-3,-9,12,-3,0,1,-1,1,-1,-1,4,-1
KR_6634258908,420,-4,-90,-40,-11,0,2,2,-2,3,1,-10,11,1,1,2,3,0,0,0,-1,-13,-14,0,-5,5,-2,0,-2,-1,-1,-1,-1,4,-1
KR_6762578041,420,-2,-46,-25,-3,0,2,2,-2,4,2,-4,6,2,3,0,3,0,0,0,0,-5,2,-3,-4,7,0,0,-1,-1,-1,-1,-1,2,-1
KR_6337750620,420,-2,-21,-4,-10,-5,6,1,2,1,3,1,5,6,-6,10,4,-2,2,0,0,-5,-15,-8,-3,11,0,0,0,-1,-1,-1,-1,3,-1
KR_6765369850,420,-2,-65,12,-1,-3,7,4,-4,5,1,3,0,3,3,1,4,0,0,0,0,-1,1,-5,-4,9,5,0,-1,1,1,-1,-1,3,-1
KR_6766995805,420,2,-6,27,1,-1,1,0,6,0,6,0,3,3,-2,4,2,-2,2,0,0,0,-6,-4,-3,7,1,0,1,1,1,1,1,6,-1
KR_6552116702,420,-1,-55,-3,-8,-4,4,0,-3,3,0,0,2,2,-1,4,3,0,2,2,0,-10,-3,-4,-3,7,0,0,-1,-1,-1,-1,-1,4,-1
KR_6764372639,420,-4,-15,-36,-5,-2,2,0,-1,4,3,-1,2,1,-3,6,3,2,0,2,0,-8,5,4,-7,3,-3,0,0,-1,-1,-1,1,4,-1
KR_6757203865,420,-2,-14,0,5,0,2,2,-3,4,1,7,4,11,1,1,2,0,3,3,1,7,2,-3,-5,8,2,0,0,1,-1,0,1,2,-1
KR_6734753147,420,-1,-46,8,-6,-3,3,0,1,3,4,-4,6,2,1,1,2,-1,2,1,0,-1,-13,1,-7,6,5,0,-1,1,1,-1,-1,5,-1
KR_6763475274,420,-3,-58,-18,-4,1,0,1,0,6,6,0,1,1,-6,9,3,1,1,2,1,0,5,1,-6,5,0,0,1,-1,1,1,1,2,-1
KR_6759785610,420,2,14,21,6,-5,6,1,5,3,8,3,0,3,2,4,6,1,1,2,-1,8,-8,-3,-5,8,-3,0,-1,1,-1,-1,-1,5,-1
KR_6761486769,420,-8,-18,-24,-16,0,2,2,-8,13,5,-6,7,1,-2,2,0,0,0,0,0,-20,-6,1,-6,5,-6,0,-2,-1,-1,-1,-1,6,-1
KR_6767343346,420,3,-17,0,6,0,1,1,1,2,3,0,2,2,3,2,5,2,0,2,0,8,-19,3,-10,7,2,0,1,1,-1,1,1,2,-1
KR_6734587619,420,2,-6,-1,6,0,1,1,2,1,3,1,1,2,2,1,3,1,0,1,0,10,0,1,-7,6,2,0,0,-1,1,0,1,5,-1
KR_6767569657,420,0,-83,-12,2,4,2,6,4,2,6,1,1,2,-7,7,0,0,0,0,0,-2,-55,-2,-3,5,18,0,-2,-1,1,-1,1,5,-1
KR_6758276140,440,-2,-43,-32,-7,-2,6,4,2,2,4,1,1,2,-3,5,2,-5,6,1,0,-4,-4,0,-5,5,-5,0,1,-1,-1,1,-1,6,-1
KR_6708533333,420,-3,-67,20,-5,1,2,3,1,2,3,-6,8,2,-1,3,2,0,0,0,1,0,6,0,-6,6,0,0,0,1,1,0,1,3,-1
KR_6732528949,420,0,0,-1,0,2,0,2,-4,6,2,2,1,3,0,1,1,0,1,1,0,-3,29,-1,-5,6,-2,0,0,1,0,0,1,3,-1
KR_6746892863,420,1,46,-34,-3,1,1,2,-2,6,4,-2,5,3,-1,4,3,1,2,3,-3,-9,25,1,-5,4,-4,0,0,-1,-1,0,-1,2,-1
KR_6768922211,420,-1,-16,1,0,0,3,3,-1,3,2,1,1,2,0,3,3,0,1,1,0,-4,-4,-1,-3,4,-2,0,0,1,-1,0,-1,3,-1
KR_6740155882,420,1,-56,15,3,1,2,3,2,2,4,1,1,2,-3,5,2,2,1,3,0,6,78,1,-6,5,4,0,0,1,1,0,1,3,-1
KR_6764038747,440,-3,-60,2,-6,0,1,1,-8,9,1,-1,3,2,3,1,4,0,0,0,0,-1,1,2,-6,4,5,0,-1,-1,1,-1,-1,5,-1
KR_6719902821,420,-5,-94,-25,-9,-3,4,1,-2,4,2,1,2,3,-3,4,1,-2,2,0,0,-8,-2,4,-8,4,-3,0,-2,-1,-1,-1,1,5,-1
KR_6762782764,420,1,29,-24,6,-4,4,0,1,3,4,3,0,3,4,3,7,2,0,2,0,17,8,1,-5,4,-5,0,0,1,-1,-1,-1,5,-1
KR_6653309768,420,-2,-77,11,-4,-2,2,0,-2,6,4,0,0,0,-1,3,2,1,1,2,-1,-4,68,-2,-5,7,-4,0,0,1,-1,0,-1,1,-1
KR_6764016423,420,-5,-61,-11,-5,-2,3,1,-2,3,1,-2,3,1,3,1,4,-2,3,1,0,-5,2,-5,-4,9,-3,0,0,-1,1,-1,-1,4,-1
KR_6728306064,420,0,24,-2,2,-1,2,1,-2,6,4,0,2,2,0,2,2,5,0,5,1,0,76,1,-9,8,-2,0,-2,1,-1,-1,1,4,-1
KR_6759151290,420,-6,-35,-35,-12,-2,3,1,-8,8,0,-1,4,3,-1,3,2,0,2,2,1,-4,8,4,-7,3,-6,0,-1,-1,1,-1,1,3,-1
KR_6762979922,420,-5,-89,-33,-14,-2,5,3,-8,8,0,0,3,3,-2,4,2,-2,3,1,0,-12,-238,-2,0,2,-1,0,-5,-1,-1,-1,-1,1,-1
KR_6765261859,420,-1,-16,8,-3,-5,6,1,6,1,7,-2,3,1,-2,4,2,0,1,1,0,-10,16,1,-9,8,-9,0,0,1,0,0,-1,4,-1
KR_6622721049,420,4,46,24,9,2,2,4,0,3,3,2,2,4,4,3,7,1,0,1,0,4,5,1,-2,1,2,0,2,1,-1,1,1,6,-1
KR_6702193606,420,-1,18,-4,-7,1,0,1,-3,4,1,2,0,2,-6,7,1,-1,1,0,-1,-14,-11,-2,-5,7,1,0,0,-1,1,1,-1,3,-1
KR_6768262515,420,0,13,25,-3,-2,2,0,-1,7,6,2,0,2,-2,4,2,0,1,1,-1,-12,0,-1,-8,9,2,0,2,-1,1,1,-1,1,-1
KR_6756062081,420,1,-10,16,7,3,0,3,3,2,5,1,0,1,-1,2,1,1,0,1,0,6,-7,2,-4,2,-2,0,1,1,1,1,1,2,-1
KR_6648226094,440,-6,-69,-47,-7,-2,2,0,-3,4,1,-3,4,1,-1,2,1,2,0,2,0,-7,3,4,-8,4,-4,0,-1,-1,-1,-1,-1,6,-1
KR_6746078435,420,0,-43,-4,-8,0,1,1,-4,4,0,1,1,2,-5,7,2,0,0,0,-1,-7,-10,-3,-2,5,1,0,-1,1,1,-1,-1,1,-1
KR_6416870944,420,-3,10,-12,-5,-2,6,4,4,2,6,0,2,2,-6,7,1,-1,2,1,0,-13,9,4,-9,5,-1,0,-1,1,-1,-1,-1,5,-1
KR_6768890744,420,2,-69,33,0,1,3,4,-4,6,2,3,0,3,-1,3,2,1,0,1,0,-1,-221,-3,-2,5,0,0,-2,-1,-1,-1,-1,5,-1
KR_6764342577,420,-1,3,11,-6,0,2,2,-2,5,3,-1,2,1,-4,7,3,1,1,2,0,-10,25,5,-10,5,0,0,0,0,-1,-1,1,0,-1
KR_6767548909,420,-3,-65,-16,-8,-2,2,0,-4,4,0,-1,2,1,-4,7,3,3,0,3,0,-13,-10,-4,-4,8,-1,0,-1,-1,-1,-1,-1,3,-1
KR_6767132881,420,-1,-11,-4,-1,1,0,1,-2,2,0,0,4,4,2,1,3,-2,4,2,0,2,6,-3,-2,5,1,0,0,1,1,0,-1,5,-1
KR_6764867344,420,1,44,13,3,0,2,2,2,1,3,4,2,6,-2,6,4,-1,1,0,0,0,10,-1,-3,4,0,0,1,1,-1,1,1,4,-1
KR_6768938018,420,1,-33,7,4,-2,4,2,1,0,1,3,0,3,2,1,3,0,1,1,0,9,-15,-1,-5,6,-7,0,-1,1,-1,1,1,1,-1
KR_6759177324,420,1,-38,34,5,-1,3,2,0,1,1,2,3,5,2,2,4,2,1,3,0,10,-7,-2,-4,6,0,0,-1,1,0,-1,1,3,-1
KR_6726911345,420,-1,23,-11,0,0,3,3,-5,7,2,7,0,7,-2,5,3,0,0,0,0,-3,45,4,-7,3,-21,0,0,-1,-1,-1,-1,3,-1
KR_6768546883,420,3,61,-2,3,5,0,5,0,3,3,3,1,4,-3,4,1,-2,2,0,0,-4,5,3,-7,4,-1,0,2,1,1,1,1,3,-1
KR_6660988261,420,3,-2,-9,7,1,1,2,0,3,3,2,3,5,4,0,4,0,0,0,0,11,46,2,-8,6,-1,0,0,-1,1,-1,1,1,-1
KR_6765103021,420,-1,-74,1,0,-2,3,1,-1,2,1,5,0,5,-2,7,5,0,2,2,0,10,17,0,-2,2,5,0,0,-1,-1,-1,1,4,-1
KR_6698836114,420,-3,-44,6,-4,-1,3,2,0,4,4,2,3,5,-3,4,1,-2,2,0,-2,-8,5,1,-8,7,-4,0,-1,-1,1,-1,-1,5,-1
KR_6672605687,440,-3,-54,20,-10,0,3,3,-4,4,0,-2,2,0,-4,6,2,0,3,3,0,-8,12,0,-3,3,-4,0,0,-1,0,-1,-1,3,-1
KR_6766745149,420,0,-5,25,-6,-1,1,0,0,2,2,0,0,0,-4,4,0,-1,2,1,1,-8,-8,-1,-4,5,-4,0,0,1,-1,-1,1,2,-1
KR_6767593251,420,-3,1,0,-5,4,0,4,-3,5,2,-2,4,2,-5,5,0,1,2,3,0,-8,16,0,-8,8,-2,0,-1,-1,1,-1,-1,1,-1
KR_6755538297,420,-3,11,-24,-4,2,1,3,-2,5,3,0,4,4,-3,4,1,-1,2,1,0,-6,7,-1,-7,8,-2,0,-1,-1,-1,-1,-1,6,-1
KR_6748710386,420,-3,-104,6,-7,-1,2,1,0,3,3,2,2,4,-6,6,0,-2,2,0,0,-3,1,3,-8,5,-3,0,0,-1,1,0,1,3,-1
KR_6724844252,420,-3,-63,-13,-5,-1,4,3,2,1,3,-2,4,2,0,5,5,-4,5,1,0,-8,-1,0,-4,4,1,0,0,-1,-1,-1,-1,4,-1
KR_6768735049,420,-1,13,-1,-2,1,1,2,0,4,4,-7,9,2,4,3,7,0,0,0,1,-4,0,0,-2,2,-1,0,0,-1,-1,1,1,4,-1
KR_6755002594,420,1,-89,20,-1,-4,5,1,4,2,6,-1,4,3,-1,5,4,1,0,1,-1,6,108,-1,-6,7,-1,0,-1,0,-1,-1,-1,0,-1
KR_6767313609,420,-1,-5,-7,4,1,3,4,4,1,5,2,1,3,-1,2,1,-2,2,0,0,3,-7,1,-4,3,3,0,0,1,1,0,1,5,-1
KR_6740800397,420,-3,-73,-4,-3,5,2,7,-3,5,2,0,1,1,-3,3,0,-2,2,0,0,-7,2,0,-8,8,-7,0,-1,-1,1,-1,1,1,-1
KR_6640697821,420,1,-32,46,-1,0,3,3,-1,6,5,0,4,4,1,2,3,-1,3,2,0,1,5,3,-10,7,8,0,-1,1,-1,-1,1,1,-1
KR_6764268445,420,1,24,4,0,-1,2,1,-1,4,3,-1,3,2,5,3,8,-2,2,0,0,8,1,2,-7,5,-4,0,0,-1,1,1,-1,4,-1
KR_6755983459,440,0,-18,-32,-4,1,1,2,-7,7,0,2,1,3,-3,9,6,3,2,5,-1,-4,0,-4,-1,5,2,0,1,-1,-1,1,1,1,-1
KR_6673040681,420,-4,-71,21,-8,3,2,5,-2,4,2,1,1,2,-7,8,1,-3,3,0,0,-17,-44,-2,-2,4,-3,0,-3,1,-1,-1,-1,6,-1
KR_6697076650,420,-2,-51,-35,-1,-2,2,0,2,1,3,-5,7,2,4,4,8,0,0,0,0,6,-3,2,-5,3,2,0,-1,1,-1,-1,1,6,-1
KR_6746517447,420,-2,-15,32,-10,2,1,3,-2,2,0,-6,6,0,-4,5,1,0,2,2,0,-13,-4,0,-5,5,-6,0,-2,-1,-1,-1,1,5,-1
KR_6760988142,420,-2,-60,-2,-6,5,0,5,-3,4,1,-6,7,1,-3,3,0,1,1,2,0,-9,-3,-4,-3,7,-3,0,0,1,-1,-1,1,6,-1
KR_6766714212,420,1,28,4,-6,3,0,3,-5,7,2,-1,2,1,-3,3,0,0,0,0,0,-11,5,2,-7,5,4,0,-1,1,1,-1,-1,2,-1
KR_6727473443,420,-1,1,3,0,-2,5,3,0,3,3,1,0,1,1,1,2,0,1,1,0,3,-123,0,-5,5,-23,0,0,1,1,0,-1,2,-1
KR_6746486665,440,-2,-36,-19,1,2,0,2,-2,3,1,3,1,4,-1,1,0,-1,2,1,0,-5,-20,-5,-5,10,0,0,0,-1,1,0,-1,1,-1
KR_6601464549,420,-3,-26,-13,-9,-4,4,0,-4,6,2,-3,5,2,3,0,3,-1,1,0,0,-4,3,-3,-6,9,0,0,-1,1,-1,-1,-1,4,-1
KR_6765293060,420,-5,-118,-9,-14,-5,5,0,-1,2,1,2,0,2,-10,10,0,0,2,2,-3,-20,0,3,-11,8,-2,0,0,-1,-1,-1,-1,4,-1
KR_6728485600,420,-1,-71,4,0,-2,4,2,-1,2,1,0,1,1,2,0,2,1,0,1,0,4,-42,-1,-2,3,-4,0,-1,-1,-1,-1,-1,5,-1
KR_6746002979,420,-2,-100,14,-7,-2,3,1,-3,4,1,4,0,4,-8,8,0,2,2,4,0,-7,-51,2,-6,4,25,0,-1,-1,1,-1,-1,1,-1
KR_6765933490,420,-4,-40,8,-6,-1,3,2,-1,4,3,-1,2,1,-1,2,1,-2,2,0,0,-5,-2,-2,-4,6,-3,0,-1,-1,-1,-1,1,2,-1
KR_6753892845,420,3,29,23,2,-2,6,4,4,0,4,-2,2,0,1,5,6,1,2,3,0,7,4,-1,-5,6,4,0,1,1,-1,1,1,5,-1
KR_6745773576,420,-3,15,-8,-5,3,0,3,-1,1,0,-5,5,0,-2,2,0,0,2,2,0,-6,6,7,-9,2,-3,0,-1,1,-1,-1,1,3,-1
KR_6756546007,420,-3,-30,-30,-6,-2,3,1,-1,4,3,2,1,3,-4,7,3,-1,2,1,0,-5,4,2,-6,4,2,0,-2,-1,1,-1,-1,1,-1
KR_6768703360,420,-1,-32,21,-4,3,2,5,-1,3,2,-1,3,2,-3,4,1,-2,4,2,0,-3,3,-2,-4,6,-6,0,-1,1,1,-1,1,2,-1
KR_6765277031,420,-2,6,-4,-12,3,2,5,-9,10,1,0,0,0,-6,7,1,0,1,1,0,-13,3,2,-7,5,-4,0,-2,-1,-1,-1,-1,2,-1
KR_6762571642,420,2,-13,22,5,2,0,2,0,2,2,3,3,6,1,6,7,-1,2,1,1,2,-4,2,-5,3,0,0,1,1,-1,1,1,6,-1
KR_6643318432,420,-3,-37,-13,-9,-1,1,0,0,5,5,-2,3,1,-5,6,1,-1,1,0,-2,-6,1,-1,-6,7,1,0,-1,-1,-1,-1,-1,4,-1
KR_6769110121,420,0,-20,-12,-4,-1,2,1,0,4,4,1,2,3,0,5,5,-4,5,1,-1,-7,-4,-3,-4,7,0,0,-2,1,-1,-1,-1,3,-1
KR_6762752888,420,1,-7,-7,-2,3,2,5,-2,3,1,-1,1,0,-3,4,1,1,2,3,0,1,-53,-5,-4,9,23,0,0,-1,-1,-1,-1,4,-1
KR_6765636629,420,-6,-54,-40,-8,0,3,3,-3,3,0,-2,5,3,-4,5,1,1,1,2,0,-10,-13,-6,-5,11,-2,0,-2,-1,-1,-1,1,5,-1
KR_6674087314,420,1,36,-23,-1,1,3,4,1,2,3,1,3,4,-3,3,0,-1,1,0,0,0,-15,-5,-4,9,-2,0,-1,-1,1,-1,-1,1,-1
KR_6765390180,420,-4,-74,16,-9,-1,2,1,-5,6,1,-2,2,0,0,3,3,-1,2,1,0,-9,48,1,-6,5,-22,0,-2,-1,-1,-1,-1,5,-1
KR_6743206620,420,0,-60,1,-1,2,1,3,2,0,2,1,2,3,-5,5,0,-1,1,0,1,0,9,2,-8,6,-2,0,-1,1,-1,-1,1,6,-1
KR_6753955856,420,5,31,-4,10,1,2,3,2,0,2,2,2,4,3,0,3,2,1,3,0,7,-23,1,-6,5,2,0,0,-1,1,1,-1,1,-1
KR_6653715681,420,0,-51,24,-4,3,3,6,-2,4,2,-5,6,1,0,3,3,0,1,1,-1,-14,-6,0,-4,4,-4,0,0,0,1,1,-1,0,-1
KR_6763344700,440,-5,-88,-28,-11,-4,5,1,1,2,3,-2,4,2,-5,7,2,-1,1,0,0,-7,-15,-5,-2,7,6,0,-2,-1,1,-1,-1,2,-1
KR_6647693212,420,-3,-10,-20,-4,-2,2,0,-4,4,0,-3,5,2,4,0,4,1,0,1,2,-3,4,-4,-6,10,-3,0,0,-1,-1,0,1,5,-1
KR_6635285989,420,-3,2,-39,0,-1,3,2,-1,6,5,-1,3,2,2,2,4,1,3,4,0,3,2,2,-6,4,-4,0,-1,1,-1,-1,1,1,-1
KR_6594916007,420,2,-35,25,0,-3,4,1,5,1,6,2,0,2,-3,4,1,-1,2,1,0,2,21,1,-8,7,-7,0,-1,1,-1,-1,-1,6,-1
KR_6765344022,420,-1,-65,3,3,4,0,4,0,3,3,-1,2,1,0,0,0,0,1,1,0,1,1,0,-6,6,-4,0,0,-1,-1,-1,1,3,-1
KR_6727554748,420,3,24,-1,12,0,2,2,3,0,3,4,2,6,3,1,4,2,0,2,0,19,28,0,-4,4,-1,0,1,1,-1,1,1,3,-1
KR_6502682229,440,4,41,12,-1,3,0,3,-1,3,2,2,1,3,-6,6,0,1,2,3,0,-5,18,0,-11,11,-2,0,1,1,1,1,1,1,-1
KR_6726896647,440,-1,65,-16,0,1,2,3,-3,3,0,6,1,7,-3,4,1,-1,3,2,0,3,17,0,-6,6,1,0,0,1,-1,0,1,5,-1
KR_6754593365,420,-8,-36,-12,-18,-2,3,1,-3,3,0,-5,7,2,-5,5,0,-3,3,0,0,-20,-10,-4,-2,6,-1,0,-2,-1,-1,-1,-1,1,-1
KR_6702730342,440,0,49,-5,4,3,2,5,0,3,3,3,4,7,0,1,1,-2,2,0,0,9,33,3,-7,4,1,0,0,-1,-1,0,1,4,-1
KR_6768623757,440,3,36,0,2,-1,4,3,-2,4,2,4,1,5,0,5,5,1,1,2,0,5,3,5,-8,3,3,0,2,-1,-1,1,-1,2,-1
KR_6745190144,440,0,-19,4,1,-1,1,0,2,5,7,1,3,4,2,1,3,-3,3,0,0,-4,-4,1,-4,3,2,0,0,-1,-1,-1,1,1,-1
KR_6768471842,420,-1,1,12,-2,0,2,2,-2,5,3,2,0,2,-3,4,1,1,0,1,0,1,-5,-1,-6,7,-2,0,0,1,-1,-1,-1,5,-1
KR_6748991872,420,-1,-19,-8,1,-4,6,2,-1,1,0,4,2,6,1,4,5,1,0,1,1,6,1,2,-4,2,0,0,-1,1,1,-1,1,4,-1
KR_6766782979,420,-2,8,-8,-2,-3,5,2,-3,5,2,5,1,6,-1,5,4,0,0,0,-2,-3,1,-6,-3,9,3,0,-1,0,-1,-1,-1,0,-1
KR_6768766375,420,-1,-39,22,-2,2,1,3,-2,5,3,1,0,1,-2,3,1,-1,1,0,0,-3,-77,-3,-5,8,-10,0,-1,-1,-1,-1,1,2,-1
KR_6653663803,420,-4,-54,-20,-8,-6,7,1,-2,5,3,3,0,3,-1,1,0,-2,2,0,-2,-5,-8,-3,-4,7,0,0,-1,1,-1,-1,-1,5,-1
KR_6652877911,420,-4,-85,-4,-7,-8,9,1,2,1,3,0,3,3,1,1,2,-2,3,1,-1,3,-14,-3,-4,7,-5,0,0,-1,1,-1,-1,1,-1
KR_6768515547,420,-4,-74,-8,-12,-2,3,1,-3,3,0,-2,3,1,-4,4,0,-1,1,0,-3,-19,30,2,-7,5,-5,0,-1,-1,-1,-1,-1,5,-1
KR_6762828690,420,0,27,17,-3,-1,1,0,-1,1,0,1,1,2,1,1,2,-3,3,0,0,1,6,5,-11,6,1,0,2,1,1,1,-1,4,-1
KR_6753701420,420,1,0,0,-4,-1,1,0,2,5,7,-1,2,1,-2,4,2,-2,2,0,0,0,-5,-5,-4,9,4,0,0,-1,-1,0,1,6,-1
KR_6750495431,420,-4,-30,-40,-6,-1,1,0,-3,4,1,2,0,2,-4,5,1,0,1,1,0,-5,1,-2,-4,6,-1,0,-2,-1,-1,-1,1,4,-1
KR_6763683391,420,-1,4,-13,-6,5,1,6,-5,6,1,-4,4,0,-2,4,2,0,2,2,0,-13,-192,0,-5,5,-6,0,2,-1,1,1,-1,1,-1
KR_6765516155,420,-2,-14,-11,-10,-3,4,1,0,5,5,-2,4,2,0,2,2,-5,6,1,0,-7,1,3,-9,6,-2,0,0,-1,-1,-1,1,1,-1
KR_6735611992,420,2,-7,0,6,1,0,1,2,4,6,4,0,4,-1,5,4,0,1,1,0,11,5,5,-6,1,-1,0,-1,-1,-1,-1,1,5,-1
KR_6761360947,440,2,45,12,4,6,0,6,3,1,4,-4,5,1,-1,2,1,0,0,0,0,-2,38,2,-7,5,-2,0,0,1,1,1,1,6,-1
KR_6768166633,420,-4,-7,-35,-6,0,0,0,-5,6,1,-1,1,0,-4,4,0,4,1,5,1,-15,2,-2,-4,6,1,0,1,1,1,1,1,4,-1
KR_6729979991,420,-4,-46,-11,-10,-4,5,1,4,0,4,-5,5,0,-5,6,1,0,2,2,0,-7,31,-1,-7,8,-1,0,-1,-1,1,-1,-1,6,-1
KR_6763245789,420,-1,-66,-19,-5,-1,2,1,-3,5,2,2,2,4,-4,6,2,1,1,2,1,1,-2,-1,-3,4,-6,0,-1,-1,-1,-1,1,3,-1
KR_6745045395,420,-4,-38,-38,-2,-1,2,1,-2,2,0,-5,7,2,6,4,10,0,1,1,-1,3,-8,0,-2,2,-2,0,-1,-1,-1,-1,-1,4,-1
KR_6767494160,420,-2,-29,0,-3,1,2,3,-3,6,3,-2,3,1,-1,2,1,2,0,2,0,-6,-40,-7,-1,8,3,0,-1,1,-1,-1,-1,1,-1
KR_6768954116,420,-4,-53,-9,-9,-1,2,1,-6,8,2,0,1,1,1,2,3,-3,5,2,0,-10,-4,-2,-3,5,-1,0,-1,-1,-1,-1,-1,5,-1
KR_6687129493,420,1,-22,7,-1,-5,7,2,2,3,5,5,0,5,-3,6,3,0,1,1,0,3,-2,1,-6,5,1,0,-2,-1,-1,-1,1,1,-1
KR_6758255754,420,-3,-62,-12,-6,-2,2,0,-2,3,1,2,3,5,-1,6,5,-3,3,0,0,-7,-5,2,-6,4,1,0,0,1,1,0,-1,5,-1
KR_6705895358,420,-5,-40,-31,-15,-2,3,1,-5,6,1,-3,5,2,-3,5,2,-2,2,0,0,-18,-7,0,-3,3,-3,0,-1,-1,1,-1,-1,6,-1
KR_6758321566,420,-4,-23,-6,-11,4,1,5,-12,13,1,1,1,2,-3,4,1,-1,1,0,0,-13,-6,-2,-2,4,5,0,0,0,0,0,-1,0,-1
KR_6755153201,420,-4,-1,-19,-8,8,0,8,-4,4,0,-5,5,0,-7,10,3,0,0,0,0,-11,24,1,-6,5,-3,0,1,-1,1,1,1,4,-1
KR_6679688525,420,-3,-15,-27,-3,3,1,4,-1,3,2,-1,2,1,-5,5,0,1,0,1,0,-5,2,-2,-8,10,-5,0,0,-1,0,0,1,6,-1
KR_6744865424,440,-2,20,-8,-3,-8,8,0,3,2,5,1,1,2,-2,3,1,3,0,3,0,-1,1,-1,-3,4,-5,0,1,-1,1,1,-1,6,-1
KR_6716692077,420,-2,-11,-26,2,-1,2,1,0,4,4,0,0,0,3,1,4,0,0,0,0,3,2,3,-7,4,2,0,-1,-1,-1,-1,1,5,-1
KR_6729979906,420,-4,-13,-29,-3,0,2,2,2,5,7,1,1,2,-2,4,2,-4,4,0,0,0,38,0,-8,8,-7,0,0,-1,-1,0,1,2,-1
KR_6765055179,420,-1,9,5,-10,0,1,1,1,1,2,-1,3,2,-8,9,1,-2,2,0,0,-21,-28,-4,-2,6,-1,0,-1,-1,-1,-1,-1,3,-1
KR_6761226542,420,-5,-68,-32,-7,-3,3,0,1,2,3,-7,8,1,2,2,4,0,1,1,-1,-2,9,1,-4,3,-9,0,-3,-1,-1,-1,-1,2,-1
KR_6604239347,420,-4,-70,-8,-14,-1,3,2,-4,6,2,0,1,1,-9,10,1,0,1,1,-1,-14,9,8,-11,3,-1,0,-1,-1,-1,-1,-1,1,-1
KR_6754336827,420,-6,-55,-29,-13,-2,3,1,-3,4,1,-4,5,1,-3,3,0,-1,2,1,0,-9,13,1,-6,5,2,0,-2,-1,-1,-1,-1,2,-1
KR_6746997974,420,0,-70,44,0,0,2,2,0,2,2,-1,2,1,-2,4,2,3,0,3,0,-3,0,0,-6,6,1,0,-1,1,-1,-1,1,1,-1
KR_6731444487,420,-6,-101,-43,-14,-1,3,2,-1,4,3,-7,8,1,-2,3,1,-3,3,0,0,-13,-43,0,-10,10,1,0,-1,1,1,-1,-1,6,-1
KR_6734126881,420,2,14,16,-2,4,0,4,-3,4,1,0,6,6,-3,3,0,0,1,1,0,-6,9,5,-8,3,-1,0,0,-1,1,0,-1,3,-1
KR_6765183853,420,-4,-14,-36,-6,-1,3,2,-1,2,1,-1,3,2,-2,3,1,-1,1,0,-1,-10,-3,-3,-4,7,1,0,0,-1,1,0,-1,6,-1
KR_6761200587,420,-2,-69,2,-10,-3,3,0,-2,4,2,-2,5,3,-3,3,0,0,0,0,0,-4,-39,2,-5,3,38,0,-1,-1,1,-1,-1,6,-1
KR_6760877900,420,-3,20,7,-4,-3,4,1,1,2,3,0,3,3,-3,5,2,1,0,1,-1,-3,-4,-4,-3,7,0,0,-1,-1,1,-1,-1,2,-1
KR_6760037038,420,-4,-87,-26,-10,-4,6,2,-6,6,0,0,3,3,-1,1,0,1,0,1,0,-10,-2,-3,-2,5,-2,0,-1,1,-1,-1,-1,1,-1
KR_6653078142,420,-2,-14,-30,-6,0,2,2,0,3,3,-2,4,2,-5,8,3,1,0,1,0,-6,13,5,-9,4,-12,0,-1,-1,-1,-1,1,3,-1
KR_6497599756,420,-1,60,-12,0,2,3,5,0,2,2,2,4,6,-3,4,1,-1,1,0,-1,4,-1,-1,-9,10,1,0,2,-1,-1,1,-1,3,-1
KR_6649928176,420,-2,-30,13,-10,0,0,0,-5,8,3,0,3,3,-3,3,0,-2,2,0,0,-11,-12,-6,-4,10,6,0,1,-1,1,1,1,6,-1
KR_6496220191,420,-1,-25,6,1,-3,4,1,0,3,3,3,1,4,1,1,2,0,0,0,0,4,79,5,-11,6,-1,0,0,-1,1,0,-1,4,-1
KR_6756985492,420,-7,-116,5,-16,-1,2,1,-3,5,2,-5,6,1,-9,10,1,2,0,2,0,-11,3,-2,-4,6,-3,0,-1,-1,1,-1,-1,3,-1
KR_6759606353,440,2,-27,54,0,-5,5,0,3,0,3,-2,3,1,4,2,6,0,1,1,0,6,37,5,-9,4,0,0,0,1,-1,0,-1,5,-1
KR_6670596812,420,-1,-52,13,0,3,2,5,1,0,1,5,1,6,-10,11,1,1,1,2,1,-8,3,1,-6,5,-2,0,-1,-1,1,1,1,5,-1
KR_6720180309,420,-4,-45,-4,-8,-2,2,0,-3,5,2,-1,5,4,-3,3,0,1,1,2,0,-6,3,-1,-6,7,-2,0,0,-1,-1,0,1,4,-1
KR_6768834413,420,-6,-46,-21,-13,1,1,2,0,5,5,-3,5,2,-8,8,0,-3,4,1,0,-12,-5,-1,-7,8,1,0,-1,1,-1,-1,-1,1,-1
KR_6691305580,420,-1,-6,1,-8,0,1,1,-3,4,1,2,1,3,-4,7,3,-3,3,0,0,-5,-9,-3,-5,8,0,0,-1,-1,-1,-1,-1,6,-1
KR_6695535783,420,-3,-13,16,-11,-4,5,1,-1,3,2,-1,4,3,-7,9,2,2,1,3,-1,-17,-9,-4,-6,10,4,0,-1,1,1,-1,-1,1,-1
KR_6753996540,420,-6,-96,-27,-9,0,1,1,3,0,3,-2,4,2,-6,6,0,-4,7,3,0,-8,0,2,-5,3,-2,0,-3,-1,-1,-1,-1,6,-1
KR_6766203369,440,3,-6,-18,3,0,2,2,3,2,5,-2,2,0,0,4,4,2,1,3,0,2,-4,-3,-6,9,-2,0,1,-1,1,-1,1,3,-1
KR_6768017754,420,-3,-80,5,-6,-3,4,1,3,2,5,-4,4,0,-2,2,0,0,0,0,0,-1,8,-4,-5,9,-5,0,-2,-1,-1,-1,-1,4,-1
KR_6709454744,420,-5,-15,-36,-5,-1,2,1,-2,5,3,-3,6,3,1,1,2,0,1,1,0,3,-8,-3,-5,8,2,0,-1,-1,-1,-1,-1,5,-1
KR_6751051023,420,1,6,24,5,-2,5,3,6,0,6,7,1,8,-9,9,0,3,0,3,-2,0,-5,1,-4,3,-1,0,0,1,-1,0,-1,2,-1
KR_6749101966,420,0,40,12,1,-2,3,1,1,5,6,-1,4,3,1,2,3,2,4,6,-1,-6,-2,2,-6,4,1,0,0,1,1,1,-1,2,-1
KR_6742418823,420,-1,-60,-3,-8,-1,2,1,-1,2,1,-2,5,3,-4,5,1,0,0,0,0,-5,-5,-5,-3,8,-5,0,-1,-1,1,-1,1,1,-1
KR_6756688267,420,-2,-32,-21,-7,-4,4,0,-3,5,2,-2,3,1,2,3,5,0,2,2,-1,-10,3,0,-6,6,1,0,0,-1,1,0,-1,2,-1
KR_6701460608,420,-3,-67,-34,-2,-6,7,1,5,0,5,2,2,4,-3,3,0,0,0,0,0,0,-81,1,-4,3,12,0,-1,-1,1,-1,-1,3,-1
KR_6746983628,420,-4,-53,-20,-6,-4,4,0,-2,3,1,1,1,2,-1,3,2,0,0,0,0,-8,-32,-2,-5,7,6,0,0,-1,1,0,1,6,-1
KR_6726917040,420,-2,-28,13,-6,0,3,3,1,2,3,0,2,2,-2,8,6,-5,5,0,0,-3,3,7,-12,5,-3,0,-2,1,-1,-1,-1,4,-1
KR_6735470563,420,0,-77,13,-1,-2,4,2,1,4,5,-1,2,1,1,3,4,0,1,1,0,1,-223,-3,-6,9,-2,0,0,-1,-1,0,-1,2,-1
KR_6765904819,420,-1,19,-28,5,-2,2,0,5,1,6,0,4,4,1,2,3,1,2,3,0,6,-2,3,-6,3,1,0,1,-1,1,1,1,5,-1
KR_6698280334,420,-1,14,3,-4,-1,4,3,5,3,8,-3,4,1,-1,4,3,-4,5,1,0,-3,-2,3,-10,7,0,0,0,-1,-1,0,1,1,-1
KR_6692654617,440,-2,-111,19,-5,-1,3,2,-2,5,3,3,2,5,-3,7,4,-2,2,0,-1,-8,-10,-5,-4,9,3,0,-1,-1,1,-1,-1,2,-1
KR_6719581659,420,-1,13,23,-1,0,2,2,-1,2,1,0,0,0,0,1,1,0,0,0,0,-6,-7,-4,-2,6,0,0,1,1,1,1,1,5,-1
KR_6739030185,440,1,-56,12,3,-4,5,1,-7,9,2,-2,2,0,5,0,5,11,0,11,-1,6,0,3,-4,1,-1,0,1,-1,1,-1,-1,4,-1
KR_6768111260,420,1,-9,-17,8,3,0,3,-1,4,3,2,1,3,4,1,5,0,1,1,0,12,35,5,-7,2,-11,0,-1,1,-1,-1,1,2,-1
KR_6751872693,420,-5,-25,-20,-4,2,1,3,2,1,3,0,3,3,-3,5,2,-5,5,0,0,-3,-1,-3,-5,8,-10,0,-1,-1,-1,-1,-1,6,-1
KR_6745576235,420,0,-16,29,-1,-1,2,1,5,0,5,-5,7,2,-1,2,1,1,1,2,-1,-9,-8,-2,-6,8,-1,0,-1,1,-1,-1,-1,6,-1
KR_6699164449,420,2,34,1,0,-3,4,1,0,3,3,3,2,5,-1,1,0,1,0,1,0,3,-35,-3,-4,7,-2,0,-2,1,1,-1,-1,1,-1
KR_6768511027,420,-2,-100,-8,-2,-3,3,0,-3,4,1,-2,3,1,2,1,3,4,0,4,0,0,8,5,-9,4,-7,0,-1,1,-1,-1,1,6,-1
KR_6756319555,420,-2,32,-55,3,1,0,1,-1,2,1,1,2,3,2,1,3,0,0,0,0,9,-12,-2,-5,7,-1,0,0,-1,-1,-1,-1,2,-1
KR_6686720748,420,1,-4,-16,0,2,1,3,1,0,1,-1,1,0,-2,2,0,0,0,0,0,0,-7,-4,-2,6,0,0,0,-1,1,-1,1,3,-1
KR_6768830870,420,0,-13,-12,1,6,0,6,-6,7,1,1,0,1,1,2,3,-1,1,0,0,-5,-47,-1,-4,5,-3,0,0,-1,-1,0,1,2,-1
KR_6769129692,420,-3,-56,16,-8,0,1,1,0,2,2,-3,3,0,-4,6,2,-1,1,0,-1,-7,8,0,-5,5,-5,0,0,-1,1,0,-1,1,-1
KR_6768061289,420,1,-11,-12,0,1,3,4,1,1,2,-4,4,0,-1,4,3,3,0,3,0,-8,7,-1,-8,9,-2,0,1,-1,1,1,1,3,-1
KR_6764601970,420,-1,-10,-3,-1,-1,3,2,-8,8,0,5,1,6,2,1,3,1,3,4,0,-2,5,1,-6,5,-2,0,0,1,1,-1,-1,3,-1
KR_6758894171,420,-5,-109,-32,-11,0,0,0,-6,6,0,-5,6,1,0,0,0,0,0,0,0,-9,1,-4,-2,6,-4,0,-1,-1,1,-1,-1,6,-1
KR_6762755370,420,-2,-33,-13,6,-3,4,1,5,0,5,5,1,6,1,2,3,-2,2,0,0,14,-3,7,-9,2,0,0,0,1,1,-1,1,5,-1
KR_6636598936,420,-3,-83,-12,-2,-2,3,1,1,2,3,-2,2,0,3,2,5,-2,3,1,0,-4,-6,-5,-6,11,3,0,-1,-1,-1,-1,-1,2,-1
KR_6748372645,440,2,-129,-1,-1,2,0,2,4,2,6,-4,4,0,-3,4,1,0,1,1,0,1,-10,-1,-4,5,-2,0,-4,-1,-1,-1,-1,3,-1
KR_6616832662,420,-4,-29,-20,-11,-4,6,2,-3,5,2,-2,4,2,-1,2,1,-1,1,0,0,-15,27,-2,-6,8,-1,0,-1,-1,-1,-1,-1,2,-1
KR_6755031312,420,2,84,-28,3,2,1,3,0,3,3,-1,4,3,4,2,6,-2,2,0,0,2,5,8,-11,3,4,0,1,1,-1,1,1,5,-1
KR_6741920885,420,-3,-66,-40,-10,-8,8,0,-3,4,1,1,2,3,0,2,2,0,0,0,0,-9,14,2,-6,4,-2,0,-1,1,-1,-1,-1,4,-1
KR_6760880343,420,-2,-89,-4,-2,0,1,1,0,4,4,-3,5,2,-1,4,3,2,2,4,0,5,-11,-1,-5,6,2,0,-1,-1,-1,-1,-1,3,-1
KR_6663289424,420,-4,-82,-1,-11,-4,4,0,-2,6,4,-3,4,1,-1,3,2,-1,1,0,0,-9,-10,-2,-3,5,2,0,0,-1,-1,-1,-1,1,-1
KR_6758209092,420,-5,-121,-47,-7,-2,3,1,-1,4,3,-3,8,5,-4,6,2,3,1,4,2,5,12,8,-11,3,-1,0,-2,-1,-1,-1,1,1,-1
KR_6620409845,420,-5,-84,-24,-11,-5,6,1,-4,5,1,-5,5,0,4,3,7,-1,3,2,0,3,-23,1,-3,2,-3,0,-4,1,-1,-1,-1,6,-1
KR_6745539442,420,0,2,30,-3,2,0,2,-7,9,2,-2,3,1,3,2,5,1,0,1,0,-6,4,2,-5,3,2,0,0,1,1,-1,-1,4,-1
KR_6759138602,420,-4,-68,6,-6,-3,3,0,0,4,4,-3,5,2,1,3,4,-1,1,0,-1,0,-6,5,-8,3,-3,0,0,1,1,0,-1,3,-1
KR_6762542404,420,-11,-95,-16,-9,-2,4,2,1,2,3,-5,5,0,1,5,6,-4,5,1,0,-9,-1,-6,-1,7,3,0,-4,-1,-1,-1,1,5,-1
KR_6664681158,420,0,-12,-20,1,-1,2,1,-4,5,1,1,1,2,2,0,2,3,1,4,0,-1,15,6,-10,4,-1,0,-1,1,-1,1,-1,2,-1
KR_6765077054,420,-1,-20,-5,-2,0,1,1,1,1,2,-5,6,1,-1,2,1,3,3,6,0,-10,-6,2,-8,6,-1,0,-2,0,1,-1,1,0,-1
KR_6764271462,420,-1,0,-4,-7,1,1,2,-3,3,0,-7,7,0,3,2,5,-1,1,0,0,-7,-41,-5,-4,9,0,0,0,-1,-1,-1,1,5,-1
KR_6740840309,420,3,36,20,3,3,1,4,-3,4,1,3,0,3,-2,2,0,2,1,3,0,1,-20,-2,-6,8,-1,0,1,1,-1,-1,-1,3,-1
KR_6711002015,420,-2,-17,-4,-5,-1,1,0,-5,6,1,-1,3,2,0,3,3,2,1,3,0,-7,3,0,-7,7,-6,0,0,1,-1,0,1,1,-1
KR_6763558184,420,0,-45,-17,-4,2,0,2,1,1,2,1,2,3,-8,9,1,0,1,1,0,-11,2,3,-7,4,1,0,0,-1,1,-1,-1,1,-1
KR_6687135404,420,-3,28,-39,-4,1,2,3,-3,4,1,-2,3,1,2,1,3,-2,3,1,0,-3,-10,4,-7,3,-2,0,0,-1,1,1,1,5,-1
KR_6665417693,420,-4,-76,23,-3,1,4,5,-8,12,4,3,2,5,2,2,4,-1,2,1,1,7,7,-3,-7,10,-6,0,-3,-1,-1,-1,1,3,-1
KR_6742368582,420,-5,-20,12,-12,-2,3,1,-2,5,3,-3,6,3,-5,5,0,0,0,0,0,-12,94,-3,-7,10,-2,0,-2,1,-1,-1,-1,3,-1
KR_6766221756,420,-4,14,2,-11,5,1,6,-7,9,2,-7,8,1,-2,2,0,0,0,0,-1,-17,-1,-3,-4,7,-4,0,-1,0,-1,-1,-1,0,-1
KR_6757671635,420,0,1,-1,7,1,0,1,1,2,3,3,0,3,2,3,5,0,1,1,0,10,-4,3,-7,4,2,0,-1,-1,1,-1,1,3,-1
KR_6696406981,440,1,4,-8,-2,3,1,4,-1,3,2,-3,4,1,2,2,4,-3,6,3,1,-4,-2,2,-7,5,0,0,0,0,1,0,1,0,-1
KR_6762575423,420,1,47,25,5,6,0,6,-1,1,0,-5,7,2,3,1,4,2,0,2,1,4,7,2,-7,5,-11,0,2,1,1,1,1,5,-1
KR_6750816927,420,-1,-10,-8,1,-5,6,1,3,0,3,2,3,5,1,2,3,0,1,1,0,4,-5,1,-4,3,2,0,-4,1,-1,-1,1,6,-1
KR_6716893061,420,1,-3,32,-6,-5,5,0,-3,5,2,0,2,2,-1,2,1,3,0,3,0,-7,-2,-1,-5,6,1,0,0,1,-1,0,-1,1,-1
KR_6752687552,440,-1,-2,13,-3,-2,3,1,-1,2,1,-3,5,2,3,0,3,0,0,0,0,-7,-33,-3,-5,8,-4,0,-1,1,1,-1,-1,4,-1
KR_6766189279,420,0,-38,-16,0,5,0,5,2,1,3,0,2,2,-1,6,5,-6,6,0,0,-2,-2,3,-8,5,-4,0,-1,-1,-1,-1,-1,1,-1
KR_6758757868,420,0,5,40,-5,-2,3,1,-2,4,2,-3,5,2,2,0,2,0,0,0,0,-5,-5,2,-8,6,-3,0,-1,1,-1,-1,-1,2,-1
KR_6764960449,420,-1,-14,36,-4,2,2,4,1,6,7,-1,2,1,-1,2,1,-5,5,0,0,-5,-142,-4,-4,8,-4,0,0,-1,1,-1,-1,2,-1
KR_6767260407,420,-2,9,-4,-1,1,1,2,-5,7,2,0,2,2,4,1,5,-1,3,2,1,-3,5,5,-6,1,-2,0,-2,-1,-1,-1,1,1,-1
KR_6712001741,440,0,36,8,2,1,3,4,-1,2,1,1,1,2,-1,1,0,2,1,3,-1,-2,3,0,-4,4,3,0,1,-1,1,1,-1,5,-1
KR_6724644912,440,0,38,-19,-3,2,1,3,1,2,3,0,1,1,-7,9,2,1,0,1,0,-11,-265,-4,-5,9,2,0,0,-1,-1,-1,-1,2,-1
KR_6712318720,420,1,-7,25,3,-1,1,0,0,2,2,4,0,4,-1,1,0,1,1,2,0,0,-37,-6,-6,12,25,0,-1,1,-1,-1,1,3,-1
KR_6728129509,420,0,-56,-4,-3,0,1,1,-5,5,0,2,1,3,1,5,6,-1,2,1,0,-9,31,3,-12,9,-11,0,-1,-1,1,-1,-1,5,-1
KR_6762267066,420,1,-36,-4,-2,-3,5,2,1,4,5,0,4,4,2,4,6,-2,2,0,-2,9,-8,0,-5,5,3,0,-1,-1,-1,-1,-1,5,-1
KR_6740326540,420,-2,-71,-12,-2,2,1,3,-1,3,2,1,0,1,-1,4,3,-3,3,0,-1,-6,-1,-7,-2,9,-6,0,0,-1,-1,-1,-1,2,-1
KR_6759305159,420,0,-59,-36,-7,-5,8,3,-1,3,2,-2,3,1,4,4,8,-3,4,1,0,5,-6,0,-4,4,-4,0,-1,-1,1,-1,1,5,-1
KR_6743481813,420,-1,-45,5,-6,-1,2,1,-1,3,2,-5,6,1,1,3,4,0,1,1,0,-3,-61,-2,-6,8,-27,0,-1,-1,-1,-1,-1,6,-1
KR_6700920915,440,4,12,36,7,-1,3,2,2,3,5,1,0,1,4,1,5,1,0,1,0,8,0,1,-6,5,4,0,1,1,-1,1,1,2,-1
KR_6716553240,420,-6,-93,-16,-5,1,1,2,-1,4,3,-2,4,2,-3,4,1,0,1,1,0,-4,7,2,-6,4,0,0,-1,1,-1,-1,-1,1,-1
KR_6753704980,420,-3,-39,-44,-10,-5,6,1,-6,8,2,0,2,2,1,2,3,0,0,0,0,-6,-40,-4,-3,7,22,0,-1,-1,1,-1,1,5,-1
KR_6763257202,440,-1,-83,9,4,3,0,3,4,1,5,1,3,4,-3,3,0,-1,1,0,0,10,12,1,-9,8,-8,0,1,1,-1,1,-1,4,-1
KR_6726303303,420,-1,-63,2,0,-4,4,0,0,1,1,5,1,6,0,4,4,-1,1,0,1,3,-5,2,-8,6,-3,0,-1,-1,-1,-1,1,4,-1
KR_6767772080,420,3,88,2,2,0,1,1,-1,4,3,0,1,1,1,4,5,2,1,3,0,-3,-6,-1,-7,8,5,0,2,-1,1,1,-1,1,-1
KR_6607469026,420,-5,-70,12,-14,0,1,1,1,2,3,-5,6,1,-8,8,0,-2,2,0,0,-22,1,-1,-7,8,-4,0,-1,-1,1,-1,1,3,-1
KR_6745261959,420,-5,-13,-4,-10,1,0,1,0,2,2,-7,7,0,-5,7,2,1,3,4,0,-11,-112,1,-5,4,-4,0,-1,-1,-1,-1,-1,5,-1
KR_6728212794,420,-2,-33,9,2,-1,1,0,2,3,5,-1,3,2,4,1,5,-2,3,1,0,0,63,0,-8,8,-19,0,1,1,1,1,1,4,-1
KR_6696990133,420,-1,-105,-15,-1,-1,2,1,0,2,2,-3,4,1,-1,7,6,4,0,4,0,6,-34,-2,-5,7,11,0,-2,1,-1,-1,-1,2,-1
KR_6676755969,420,-4,-71,4,-3,1,5,6,1,2,3,2,2,4,-6,6,0,-1,1,0,0,-11,-1,4,-7,3,2,0,0,1,1,-1,-1,5,-1
KR_6761800948,440,2,18,-8,5,3,1,4,2,0,2,0,2,2,1,1,2,-1,1,0,0,7,4,3,-7,4,-3,0,0,-1,1,1,1,5,-1
KR_6756016089,420,0,-54,5,3,2,1,3,8,1,9,3,2,5,-10,10,0,0,2,2,0,1,0,1,-8,7,-1,0,-1,1,1,-1,-1,6,-1
KR_6765508038,420,1,-25,16,7,-1,3,2,4,2,6,1,0,1,1,3,4,2,1,3,-1,3,14,-1,-7,8,5,0,1,1,-1,1,-1,4,-1
KR_6736970880,420,-1,12,12,2,0,3,3,0,0,0,-2,3,1,3,1,4,1,0,1,0,-1,-2,1,-4,3,-8,0,0,0,-1,-1,1,0,-1
KR_6758298164,420,-3,-46,-12,-6,-5,5,0,-3,6,3,0,1,1,4,0,4,-2,3,1,0,-1,12,1,-4,3,-1,0,0,1,-1,1,-1,3,-1
KR_6765329571,420,-1,-9,-35,0,-1,3,2,1,1,2,-1,3,2,1,1,2,0,1,1,0,9,-13,5,-10,5,2,0,0,1,-1,0,-1,3,-1
KR_6730889208,440,-2,-118,-3,-10,-3,5,2,-4,5,1,2,1,3,-6,6,0,1,1,2,0,-10,-10,-2,-4,6,-4,0,-2,-1,-1,-1,-1,4,-1
KR_6767160473,420,1,30,-50,5,1,0,1,7,2,9,-3,6,3,1,4,5,-1,2,1,-1,2,-19,6,-9,3,-4,0,1,1,1,1,-1,2,-1
KR_6721063950,420,-2,1,-21,-8,1,1,2,-3,4,1,0,1,1,-5,8,3,-1,2,1,0,-9,-5,-1,-9,10,1,0,0,-1,-1,-1,-1,3,-1
KR_6762472422,420,-2,25,-4,-7,-3,4,1,-5,7,2,1,2,3,1,4,5,-1,2,1,-1,-13,-8,-5,-1,6,-1,0,-1,-1,-1,1,-1,2,-1
KR_6753485606,420,-1,-42,-22,-5,4,0,4,-3,4,1,-2,3,1,-4,5,1,0,0,0,0,-8,-5,-2,-4,6,2,0,-1,-1,1,-1,1,1,-1
KR_6747043244,420,2,43,-16,11,0,0,0,0,2,2,2,0,2,9,1,10,0,1,1,1,15,9,2,-9,7,1,0,2,-1,1,1,1,5,-1
KR_6726094272,420,-6,-98,-35,-11,-3,3,0,-5,6,1,3,1,4,-2,3,1,-4,4,0,0,-1,-21,0,-6,6,-5,0,0,-1,-1,0,-1,1,-1
KR_6748782827,420,-4,-33,-13,-5,-6,6,0,-3,4,1,0,5,5,1,2,3,3,0,3,2,-8,-2,0,-4,4,-3,0,-1,-1,-1,-1,1,5,-1
KR_6763513765,420,-2,21,-23,-2,-2,3,1,2,2,4,-2,4,2,2,2,4,-2,2,0,0,-1,-14,3,-6,3,-7,0,0,1,-1,-1,-1,3,-1
KR_6750038676,420,-6,-73,-16,-4,0,2,2,-3,4,1,1,0,1,-2,4,2,0,0,0,0,4,-14,-3,-2,5,2,0,-3,-1,-1,-1,1,1,-1
KR_6746113453,420,-1,-37,-5,-4,-3,3,0,2,1,3,-2,4,2,0,1,1,-1,1,0,0,2,3,3,-7,4,-2,0,-2,-1,-1,-1,1,5,-1
KR_6741519060,420,-1,-19,3,-6,-3,3,0,4,2,6,-4,5,1,-1,3,2,-2,3,1,1,1,18,3,-6,3,-5,0,0,-1,1,-1,1,3,-1
KR_6637880032,420,-5,-54,-21,-13,-6,6,0,-5,9,4,1,2,3,-5,5,0,2,3,5,0,-12,-23,1,-7,6,1,0,-2,-1,-1,-1,1,4,-1
KR_6764163974,420,-4,-25,5,-8,-3,3,0,-3,5,2,-2,3,1,0,0,0,0,1,1,0,-4,-9,-1,-4,5,0,0,-1,-1,-1,-1,1,4,-1
KR_6758943078,420,1,-4,-16,2,5,1,6,-5,7,2,5,1,6,-3,3,0,0,0,0,0,0,1,0,-4,4,-2,0,0,-1,-1,1,1,2,-1
KR_6745318830,420,-2,-49,-5,-6,-3,4,1,-5,9,4,-2,2,0,1,0,1,3,0,3,0,0,14,-5,-2,7,3,0,0,-1,1,0,-1,5,-1
KR_6552266986,420,-1,-37,17,-4,-4,5,1,2,2,4,-1,3,2,0,1,1,-1,1,0,0,1,-9,-6,-2,8,4,0,1,-1,1,1,-1,1,-1
KR_6764467396,420,-2,9,-3,-5,-5,7,2,-1,3,2,0,2,2,2,1,3,-1,1,0,1,-7,-6,-3,-3,6,7,0,-1,1,-1,-1,1,4,-1
KR_6761512676,420,-9,-128,-61,-14,-3,6,3,0,4,4,-10,10,0,-2,3,1,1,0,1,-1,-7,28,2,-6,4,-4,0,-2,-1,-1,-1,-1,3,-1
KR_6730205207,420,-1,-66,-18,-1,-2,3,1,2,1,3,2,1,3,2,2,4,-5,5,0,0,2,31,0,-5,5,-4,0,1,-1,1,1,-1,4,-1
KR_6740785254,420,-1,15,4,2,2,2,4,-2,5,3,1,1,2,1,1,2,0,2,2,1,4,-1,0,-5,5,2,0,0,1,-1,-1,1,2,-1
KR_6749221533,420,0,-10,-12,0,3,1,4,1,3,4,-5,6,1,-1,2,1,2,2,4,0,-1,2,-2,-4,6,-1,0,0,-1,-1,1,-1,5,-1
KR_6674321026,420,0,-12,-12,-1,1,0,1,-4,8,4,1,4,5,4,6,10,-3,5,2,-1,-5,1,1,-4,3,0,0,1,-1,1,1,1,3,-1
KR_6674242627,420,3,33,20,7,1,2,3,4,2,6,1,3,4,2,2,4,-1,3,2,0,2,-102,4,-10,6,-3,0,1,0,1,1,1,0,-1
KR_6633305029,420,0,-2,13,-1,0,3,3,0,3,3,1,2,3,-3,6,3,1,0,1,1,-3,8,-4,-3,7,1,0,-1,1,1,-1,1,4,-1
KR_6766096107,420,1,45,-4,0,2,2,4,-1,1,0,-1,2,1,0,0,0,0,0,0,0,-1,7,2,-6,4,-2,0,1,1,-1,-1,-1,6,-1
KR_6765738123,420,0,-35,-16,-2,-3,4,1,0,3,3,5,2,7,0,4,4,-4,4,0,0,-4,3,5,-8,3,-1,0,-2,0,-1,-1,-1,0,-1
KR_6506741744,420,-2,62,-10,-8,1,1,2,0,3,3,-5,6,1,-4,6,2,0,0,0,0,-15,-2,3,-6,3,3,0,-1,-1,1,-1,1,2,-1
KR_6768341412,420,1,-38,-2,5,2,2,4,0,4,4,0,3,3,1,1,2,2,0,2,0,2,5,-2,-7,9,-3,0,-1,1,-1,1,-1,3,-1
KR_6763106934,420,-5,-27,-1,-8,-3,5,2,-2,5,3,-4,5,1,1,3,4,0,1,1,2,-11,3,6,-9,3,2,0,1,-1,-1,-1,1,5,-1
KR_6764718383,420,1,-30,15,2,-2,2,0,1,2,3,-1,3,2,1,1,2,3,1,4,0,8,-47,-1,-6,7,24,0,0,-1,0,1,1,3,-1
KR_6692818565,420,1,-12,-25,2,2,2,4,-3,4,1,2,5,7,0,2,2,1,1,2,0,1,-4,-2,-2,4,2,0,0,-1,1,1,-1,3,-1
KR_6739533464,420,2,2,20,1,-4,4,0,7,0,7,-1,2,1,1,3,4,-2,2,0,0,7,15,-2,-5,7,3,0,0,0,1,-1,-1,0,-1
KR_6604255829,420,-2,-24,10,-4,-3,4,1,0,3,3,0,0,0,0,2,2,-1,2,1,-1,-11,6,-1,-8,9,-1,0,0,-1,1,1,-1,2,-1
KR_6765299306,440,1,-20,-17,-2,0,3,3,-1,7,6,-1,1,0,0,1,1,0,0,0,0,0,2,2,-4,2,3,0,0,0,-1,0,-1,0,-1
KR_6508679967,420,-4,-6,-19,-16,-1,3,2,-5,9,4,-5,6,1,-5,5,0,0,1,1,0,-5,-13,-2,-7,9,-2,0,0,1,1,1,-1,3,-1
KR_6768413629,440,-2,-12,4,-6,-2,4,2,2,5,7,-1,3,2,-1,3,2,-4,4,0,-1,-13,4,3,-6,3,-1,0,-2,1,-1,-1,-1,2,-1
KR_6763265451,440,-2,1,-33,-1,-5,5,0,6,2,8,4,1,5,-4,6,2,-2,2,0,0,4,-113,-7,-1,8,-2,0,-1,-1,-1,-1,-1,6,-1
KR_6763145734,440,0,4,-8,4,3,2,5,-1,6,5,-4,5,1,8,0,8,-2,3,1,0,13,6,4,-6,2,-5,0,0,0,0,0,1,0,-1
KR_6617305670,420,-1,-24,-3,2,3,2,5,3,1,4,1,2,3,-4,4,0,-1,2,1,0,1,8,-3,-5,8,-3,0,1,-1,1,1,-1,4,-1
KR_6748339857,420,-2,-6,0,-7,-4,5,1,0,3,3,-3,4,1,1,4,5,-1,2,1,0,-15,2,-9,-4,13,1,0,-1,-1,1,-1,-1,1,-1
KR_6761333310,420,-4,-101,-13,-6,-3,4,1,-3,7,4,-3,3,0,3,1,4,0,1,1,0,-6,21,1,-8,7,-7,0,-1,1,-1,-1,-1,4,-1
KR_6758433989,420,0,64,1,1,0,3,3,-2,4,2,0,4,4,4,2,6,-1,1,0,0,-7,-14,0,-5,5,2,0,2,1,1,1,-1,3,-1
KR_6765136483,420,2,-59,39,1,-1,2,1,6,1,7,-2,2,0,-2,4,2,0,0,0,0,-7,8,-1,-6,7,-2,0,0,1,1,0,-1,5,-1
KR_6762004990,420,-1,-33,-12,3,-5,5,0,2,4,6,-1,4,3,4,3,7,3,0,3,0,2,18,1,-4,3,0,0,-1,-1,1,-1,1,3,-1
KR_6766712587,420,-1,68,-24,-3,-1,4,3,2,1,3,-5,5,0,2,0,2,-1,1,0,0,2,7,5,-9,4,-5,0,-1,-1,-1,-1,-1,1,-1
KR_6755798798,420,-3,29,-4,-8,-3,3,0,1,2,3,-9,9,0,3,1,4,0,1,1,0,-5,4,-4,-5,9,0,0,0,1,-1,0,-1,6,-1
KR_6717735524,420,-3,-49,-27,-2,-1,2,1,0,2,2,0,3,3,-1,3,2,0,1,1,0,0,-3,6,-10,4,-4,0,0,-1,1,0,-1,6,-1
KR_6743429403,440,0,-37,-12,-8,5,2,7,-2,5,3,1,3,4,-1,1,0,-11,11,0,-1,-14,16,1,-6,5,-3,0,-2,-1,-1,-1,-1,6,-1
KR_6730847569,420,0,-10,-12,-2,1,1,2,-2,4,2,-1,1,0,0,1,1,0,0,0,0,-7,25,-2,-4,6,-4,0,0,-1,0,0,1,2,-1
KR_6767264942,420,-3,-58,16,-11,-2,2,0,-4,4,0,-2,4,2,-3,3,0,0,1,1,0,-6,-28,-7,-3,10,2,0,-1,1,-1,-1,-1,5,-1
KR_6761957074,440,-3,-44,4,-7,-3,4,1,-3,3,0,3,1,4,-7,7,0,3,0,3,0,-4,9,4,-5,1,-3,0,-3,1,-1,-1,-1,4,-1
KR_6765204292,420,-1,3,6,4,1,1,2,0,2,2,-2,5,3,8,1,9,-3,3,0,0,4,-3,-4,-3,7,2,0,-2,1,-1,-1,1,5,-1
KR_6717936353,420,-3,-35,-17,-13,3,1,4,-10,11,1,-1,1,0,-3,3,0,-2,4,2,-2,-16,-32,-5,-3,8,-8,0,-1,-1,-1,-1,-1,2,-1
KR_6767037327,420,3,19,10,9,3,1,4,0,3,3,2,2,4,2,2,4,2,0,2,-1,1,-3,2,-4,2,1,0,0,-1,1,1,-1,1,-1
KR_6747421746,420,-4,-39,-48,-7,-2,3,1,2,2,4,-6,8,2,3,2,5,-4,4,0,-2,-3,-6,-2,-5,7,1,0,-1,-1,-1,-1,-1,6,-1
KR_6768415987,420,1,-21,53,0,-2,3,1,1,6,7,4,2,6,-1,4,3,-2,3,1,0,-2,0,1,-5,4,2,0,-2,1,1,-1,-1,1,-1
KR_6758991114,440,0,21,22,0,-2,3,1,-1,2,1,1,0,1,0,4,4,2,1,3,1,1,-15,3,-7,4,-2,0,1,1,1,1,1,3,-1
KR_6768958243,420,-1,-34,-17,-7,-1,1,0,-3,6,3,0,1,1,-1,4,3,-2,2,0,0,-6,-4,2,-6,4,2,0,-1,-1,-1,-1,-1,6,-1
KR_6764384076,420,-5,13,-57,-13,4,0,4,-4,6,2,-1,2,1,-5,5,0,-7,7,0,0,-23,-6,3,-8,5,-4,0,0,-1,1,0,-1,4,-1
KR_6766624522,440,0,8,-11,0,-1,3,2,0,0,0,0,1,1,1,1,2,0,0,0,0,5,240,2,-9,7,-8,0,-1,1,-1,-1,1,6,-1
KR_6739598179,420,-8,-64,-26,-17,-4,5,1,-4,6,2,-5,5,0,-3,3,0,-1,1,0,0,-21,-13,0,-5,5,0,0,-2,1,0,-1,1,3,-1
KR_6746952202,420,0,11,-5,0,1,0,1,2,1,3,3,2,5,-6,12,6,0,1,1,0,0,-34,-1,-4,5,4,0,-1,1,-1,-1,1,2,-1
KR_6738180921,440,0,-16,-12,0,3,1,4,-3,3,0,5,1,6,1,3,4,-6,7,1,0,-7,-1,-2,-4,6,1,0,0,-1,1,0,1,2,-1
KR_6751153183,440,4,98,12,3,1,1,2,2,1,3,1,1,2,-1,1,0,0,0,0,0,-1,0,5,-9,4,1,0,1,0,-1,1,1,0,-1
KR_6767995512,420,0,-57,12,-3,-3,3,0,5,1,6,-7,8,1,1,6,7,1,1,2,-4,11,-20,-1,-4,5,6,0,-2,1,-1,-1,1,2,-1
KR_6720478795,420,2,16,-24,0,2,0,2,-1,1,0,0,2,2,-1,4,3,0,2,2,0,0,8,-1,-5,6,3,0,1,-1,1,1,-1,2,-1
KR_6744056912,440,-2,-77,-13,-3,1,2,3,-6,6,0,-3,4,1,0,5,5,5,0,5,0,1,-7,-1,-4,5,2,0,-3,1,-1,-1,-1,4,-1
KR_6767267721,420,-7,-28,-22,-15,-3,4,1,-5,7,2,-1,5,4,-2,4,2,-4,4,0,1,-13,-25,-6,-4,10,-2,0,-1,1,-1,-1,1,4,-1
KR_6652973209,420,0,33,12,-7,-4,5,1,-1,1,0,-2,7,5,-1,3,2,1,1,2,-1,-13,41,0,-5,5,-7,0,1,-1,-1,-1,-1,4,-1
KR_6721999312,420,-3,-41,-5,-1,1,2,3,3,0,3,0,0,0,-2,5,3,-3,3,0,0,-1,6,6,-10,4,-9,0,0,1,1,0,1,3,-1
KR_6655680775,420,-5,-59,-27,-11,2,1,3,-5,6,1,-3,3,0,-2,2,0,-3,3,0,0,-10,2,-1,-7,8,-5,0,-3,1,-1,-1,-1,1,-1
KR_6675499907,420,0,-108,16,-3,-5,5,0,0,1,1,3,2,5,0,1,1,-1,2,1,0,3,2,-4,-3,7,1,0,-1,-1,-1,-1,-1,5,-1
KR_6764163105,420,1,-29,3,-4,0,0,0,0,3,3,-3,4,1,1,3,4,-2,2,0,0,0,6,2,-7,5,-5,0,0,-1,1,-1,-1,2,-1
KR_6743329647,420,0,22,26,4,5,0,5,-2,3,1,0,1,1,2,2,4,-1,1,0,0,2,-7,-7,-2,9,6,0,0,-1,1,1,1,6,-1
KR_6743580334,420,-3,-20,-7,-8,-2,3,1,0,4,4,-4,5,1,-3,4,1,1,1,2,-1,-7,-6,0,-8,8,-6,0,0,1,0,0,-1,1,-1
KR_6735564089,420,-1,22,-15,3,2,0,2,0,3,3,-1,3,2,0,6,6,2,0,2,0,9,-23,-1,-8,9,1,0,-1,1,-1,-1,-1,1,-1
KR_6703674148,420,-6,-68,4,-12,-6,6,0,-1,3,2,0,1,1,-5,5,0,0,0,0,0,-18,19,-2,-5,7,-3,0,0,-1,1,-1,-1,2,-1
KR_6768491280,420,0,15,-4,-6,3,0,3,-2,6,4,-3,4,1,-3,5,2,-1,2,1,0,-16,3,-1,-5,6,-1,0,0,-1,-1,1,-1,5,-1
KR_6689577770,420,0,39,1,0,1,0,1,-1,4,3,0,3,3,-1,5,4,1,0,1,0,1,-184,-5,-3,8,2,0,0,1,-1,0,-1,2,-1
KR_6722586820,420,-2,-19,-14,-3,3,0,3,-2,4,2,-4,4,0,2,2,4,-2,2,0,-2,-6,-21,-2,-6,8,0,0,0,-1,1,1,-1,1,-1
KR_6758294985,420,-4,-98,-7,-7,-2,5,3,-5,5,0,2,1,3,-4,6,2,2,2,4,0,-8,1,0,-6,6,-3,0,0,0,1,-1,-1,0,-1
KR_6756277425,420,0,-27,-32,3,3,1,4,-5,7,2,3,0,3,1,2,3,1,1,2,0,5,24,1,-5,4,-1,0,-1,-1,-1,-1,1,2,-1
KR_6768861121,420,-1,3,-24,-4,-2,2,0,-4,4,0,0,1,1,2,0,2,0,1,1,0,-3,-3,-4,-5,9,5,0,0,-1,1,0,-1,3,-1
KR_6715238020,420,-2,7,-18,-1,2,3,5,3,0,3,-3,6,3,1,3,4,-4,6,2,-1,-2,0,2,-6,4,-3,0,0,-1,1,1,1,2,-1
KR_6693949194,420,-2,6,8,-9,-2,3,1,1,3,4,-3,5,2,-2,3,1,-3,3,0,0,-11,-13,-1,-2,3,-1,0,-1,-1,-1,-1,-1,5,-1
KR_6687442080,420,-1,61,10,-9,-7,7,0,-1,5,4,1,1,2,-2,2,0,0,0,0,-1,-11,22,-3,-5,8,5,0,0,1,-1,1,-1,6,-1
KR_6689209462,420,-8,-87,-4,-12,-6,7,1,-3,8,5,1,1,2,-4,6,2,0,1,1,1,-15,2,5,-7,2,-1,0,-1,1,-1,-1,1,2,-1
KR_6682202991,420,-2,-24,-16,-12,2,3,5,-7,9,2,0,2,2,-6,7,1,-1,2,1,0,-23,31,-6,-5,11,-14,0,0,-1,1,-1,1,2,-1
KR_6762244091,420,-3,-32,-12,-5,1,1,2,1,1,2,-3,4,1,-1,1,0,-3,3,0,0,-14,-9,-4,-4,8,6,0,-1,1,-1,-1,-1,2,-1
KR_6706804876,420,-2,-11,-20,-6,-1,2,1,0,5,5,-6,7,1,1,2,3,0,1,1,1,7,-4,-1,-6,7,-1,0,-2,1,-1,-1,1,2,-1
KR_6734773122,420,-4,-61,-26,-15,-3,3,0,-1,2,1,-6,6,0,-2,3,1,-3,5,2,0,-17,-10,-2,-5,7,-6,0,-2,1,-1,-1,-1,2,-1
KR_6758828266,420,-2,-2,-16,-3,0,1,1,0,4,4,1,3,4,-3,4,1,-1,3,2,0,-3,-2,2,-5,3,-1,0,-1,-1,-1,-1,1,1,-1
KR_6751329624,420,-1,0,-9,-1,-1,6,5,-1,4,3,0,2,2,0,3,3,1,0,1,1,1,22,-3,-5,8,-4,0,-1,0,-1,-1,1,0,-1
KR_6739272092,420,-3,18,-20,-7,-1,3,2,-6,6,0,-2,2,0,1,2,3,1,0,1,1,-9,320,0,-5,5,0,0,-2,1,-1,-1,1,4,-1
KR_6763420735,440,0,5,-18,3,0,1,1,0,0,0,0,3,3,4,2,6,-1,1,0,-1,5,-6,2,-7,5,6,0,0,1,-1,0,-1,2,-1
KR_6766726774,420,0,-32,-7,-2,0,1,1,-1,2,1,1,1,2,1,6,7,-3,6,3,0,1,-12,0,-4,4,-5,0,0,-1,-1,0,-1,5,-1
KR_6649768106,420,0,47,-9,1,2,1,3,1,4,5,1,1,2,-4,4,0,1,1,2,-1,-3,-94,0,-8,8,25,0,-1,-1,-1,-1,-1,5,-1
KR_6765003826,420,-1,-49,-26,1,-2,3,1,4,2,6,0,2,2,-1,3,2,0,0,0,0,3,-16,2,-5,3,2,0,-2,-1,-1,-1,1,4,-1
KR_6765658774,420,-3,-38,0,-1,0,0,0,1,4,5,-4,5,1,1,1,2,1,2,3,1,4,-6,-5,-4,9,9,0,1,1,-1,1,1,6,-1
KR_6729811814,420,-3,-42,-30,-10,-3,5,2,-4,6,2,0,5,5,-3,5,2,0,1,1,0,-6,-13,-1,-5,6,0,0,-2,-1,-1,-1,-1,3,-1
KR_6687575405,420,-4,-8,-35,-5,1,1,2,-2,2,0,-1,2,1,-3,4,1,0,2,2,0,-6,-111,0,-4,4,-1,0,-1,-1,-1,-1,-1,5,-1
KR_6750867192,420,4,25,43,8,-1,1,0,3,0,3,-2,5,3,1,3,4,7,0,7,-1,9,13,2,-8,6,-2,0,0,1,1,1,-1,5,-1
KR_6764887629,420,-5,7,-35,-2,-8,8,0,-1,1,0,5,3,8,3,2,5,-1,3,2,-1,-4,-6,-1,-2,3,6,0,-1,1,-1,-1,-1,4,-1
KR_6768376463,420,5,2,29,6,-2,2,0,5,0,5,3,0,3,1,2,3,-1,2,1,1,13,4,2,-7,5,3,0,1,-1,1,1,1,5,-1
KR_6691117143,420,0,19,-13,1,-1,2,1,5,4,9,-2,2,0,0,3,3,-1,2,1,0,7,5,-1,-5,6,-4,0,1,-1,1,-1,1,4,-1
KR_6768985817,420,0,-33,-8,-1,0,1,1,0,4,4,-1,5,4,0,4,4,0,1,1,0,-1,7,-1,-4,5,0,0,-1,-1,-1,-1,-1,6,-1
KR_6761633081,420,-3,-50,-12,-5,-5,5,0,-4,5,1,-2,2,0,4,0,4,2,1,3,1,-1,8,3,-8,5,-1,0,-2,1,-1,-1,1,6,-1
KR_6742505370,420,-3,-101,-5,-6,0,2,2,-3,4,1,2,1,3,-5,7,2,0,0,0,0,-6,0,-2,-5,7,-5,0,-1,-1,-1,-1,-1,4,-1
KR_6755999932,420,1,0,15,-3,-2,5,3,2,1,3,-2,2,0,0,2,2,-1,2,1,0,3,-5,1,-7,6,0,0,0,-1,-1,0,1,1,-1
KR_6718781382,420,1,33,36,-5,0,1,1,-5,8,3,0,4,4,1,3,4,-1,2,1,0,-3,52,-6,-1,7,2,0,0,-1,-1,-1,-1,6,-1
KR_6727831585,420,0,28,-9,-2,0,2,2,2,2,4,-1,6,5,-1,3,2,-2,2,0,0,-6,-16,-5,-3,8,5,0,1,1,1,1,1,3,-1
KR_6742058178,420,1,-27,36,-5,-5,5,0,-8,9,1,5,2,7,-1,2,1,4,1,5,0,-5,1,-3,-4,7,0,0,-1,-1,-1,-1,-1,6,-1
KR_6747500627,440,3,-34,43,-2,2,0,2,0,0,0,1,2,3,-3,5,2,-2,2,0,0,-4,-1,-2,-1,3,-1,0,0,-1,-1,0,-1,4,-1
KR_6746512544,420,-8,-75,-61,-10,-3,3,0,0,3,3,-3,3,0,-5,5,0,1,0,1,-1,-15,15,-2,-1,3,0,0,-1,-1,-1,-1,-1,4,-1
KR_6766049290,420,-7,-129,4,-15,-4,6,2,3,0,3,-4,4,0,-9,9,0,-1,1,0,0,-9,-5,-3,-2,5,-2,0,-3,-1,-1,-1,-1,2,-1
KR_6759674578,420,-4,-91,2,-6,-1,3,2,1,0,1,-1,1,0,-5,5,0,0,0,0,0,-11,-91,-1,-6,7,-9,0,0,-1,1,-1,-1,4,-1
KR_6768943016,420,0,-58,-11,-7,-1,3,2,0,2,2,0,2,2,-4,6,2,-2,2,0,-1,-2,-4,-3,-2,5,1,0,-1,-1,-1,-1,-1,2,-1
KR_6730564845,420,0,66,8,-4,6,0,6,-5,7,2,-5,6,1,0,1,1,0,1,1,0,-11,11,5,-6,1,-8,0,0,-1,1,1,1,6,-1
KR_6756254533,420,1,35,-17,3,0,0,0,1,2,3,-2,3,1,4,2,6,0,0,0,0,4,-12,0,-5,5,3,0,0,1,-1,-1,-1,6,-1
KR_6689015653,420,-1,2,-6,-5,-1,4,3,0,5,5,4,1,5,-3,7,4,-5,5,0,0,-10,4,4,-6,2,-3,0,-1,-1,-1,-1,1,3,-1
KR_6730124619,420,-4,-58,-48,-12,-1,2,1,-2,3,1,-1,4,3,-8,10,2,0,1,1,0,-9,-2,-1,-3,4,2,0,-1,-1,-1,-1,-1,5,-1
KR_6745390772,440,-1,3,7,-4,-1,1,0,-4,4,0,1,0,1,-4,5,1,4,0,4,1,3,-1,0,-6,6,1,0,0,1,-1,0,1,4,-1
KR_6740735871,420,0,-61,16,4,2,2,4,2,1,3,-2,2,0,2,1,3,0,1,1,0,4,-2,1,-5,4,-1,0,-1,1,1,-1,1,1,-1
KR_6763486459,420,-5,-69,-9,-8,-1,1,0,-1,2,1,-2,4,2,-3,5,2,-1,1,0,0,-5,-129,2,-7,5,1,0,0,-1,-1,0,-1,2,-1
KR_6601743244,420,1,-9,8,1,1,1,2,-2,7,5,-1,6,5,2,2,4,1,0,1,-2,3,68,-4,-3,7,-24,0,0,1,-1,0,-1,6,-1
KR_6760971118,420,-2,39,-18,-5,1,0,1,1,4,5,0,1,1,-6,7,1,-1,2,1,0,-7,-29,-2,-6,8,2,0,0,1,-1,0,1,5,-1
KR_6761824050,440,-5,-67,-19,-12,-1,1,0,-2,3,1,-1,2,1,0,2,2,-8,8,0,-1,-18,6,2,-7,5,4,0,-2,-1,0,-1,-1,4,-1
KR_6674026937,420,-4,-47,-16,-6,-7,8,1,0,1,1,0,1,1,1,5,6,0,0,0,-1,-7,-3,-3,-4,7,1,0,-1,-1,-1,-1,-1,5,-1
KR_6633309859,420,-2,-7,-5,-10,-1,3,2,-3,7,4,-3,4,1,-2,4,2,-1,2,1,0,-10,-9,-6,-2,8,-2,0,-3,-1,-1,-1,-1,5,-1
KR_6763455122,420,-1,25,8,-4,-4,4,0,2,1,3,1,2,3,-1,4,3,-2,2,0,-1,-8,4,2,-5,3,0,0,0,1,-1,-1,-1,2,-1
KR_6700654810,440,0,-64,0,-6,2,1,3,0,2,2,-7,7,0,0,1,1,-1,3,2,0,-7,-8,-2,-4,6,-1,0,-2,-1,-1,-1,-1,5,-1
KR_6731588214,420,-2,-28,9,0,-2,2,0,1,5,6,1,2,3,-1,4,3,1,0,1,3,8,33,2,-8,6,3,0,-1,1,1,-1,1,6,-1
KR_6762598979,420,-8,-93,-14,-16,-10,10,0,-2,4,2,-3,3,0,-1,4,3,0,1,1,-1,-11,-19,-7,0,7,1,0,-3,-1,1,-1,-1,6,-1
KR_6716483121,420,-3,-67,-10,-11,-5,6,1,2,1,3,-4,5,1,-2,3,1,-2,2,0,0,-10,-5,4,-10,6,-4,0,0,-1,1,0,1,3,-1
KR_6754679042,420,1,19,16,0,0,3,3,-2,3,1,-2,4,2,3,3,6,1,2,3,0,-14,-3,4,-7,3,0,0,-1,-1,-1,-1,-1,2,-1
KR_6731392659,420,-3,1,-16,-10,-4,5,1,-1,3,2,-1,5,4,-5,8,3,1,0,1,0,-13,10,1,-5,4,-5,0,-1,-1,-1,-1,-1,4,-1
KR_6731551730,420,3,-21,-19,8,0,1,1,-1,5,4,1,3,4,6,1,7,2,1,3,3,15,7,4,-8,4,-1,0,-1,1,-1,-1,-1,1,-1
KR_6762843764,420,-4,-41,3,-11,-1,2,1,-3,3,0,-4,5,1,-2,6,4,-1,1,0,0,-23,-34,-6,-3,9,-2,0,-2,-1,-1,-1,1,2,-1
KR_6737210327,420,0,-50,4,-8,-4,5,1,-3,4,1,-3,5,2,3,4,7,-1,1,0,0,-9,1,-3,-6,9,-1,0,-3,1,-1,-1,-1,2,-1
KR_6766387815,420,-1,-10,9,-4,4,1,5,-2,6,4,0,5,5,-5,5,0,-1,1,0,3,-2,16,-3,-6,9,4,0,0,0,-1,0,-1,0,-1
KR_6694379506,420,-1,-24,5,-12,2,1,3,-4,7,3,-11,12,1,4,2,6,-3,5,2,0,-13,4,2,-4,2,-2,0,0,-1,1,-1,-1,6,-1
KR_6745296797,420,-3,-7,-23,-1,-2,2,0,1,1,2,1,2,3,0,5,5,-1,1,0,-1,-1,-6,-3,-7,10,-4,0,-1,1,-1,-1,-1,6,-1
KR_6763605365,440,0,35,16,-4,1,2,3,-1,3,2,1,1,2,-4,4,0,-1,1,0,0,-9,-35,0,-6,6,9,0,1,-1,1,1,-1,3,-1
KR_6749488436,440,-4,38,-13,-12,-1,2,1,-4,4,0,-4,5,1,-4,5,1,1,1,2,1,-11,-20,3,-3,0,0,0,0,0,1,-1,1,0,-1
KR_6767150542,420,-2,13,13,-3,-1,3,2,2,0,2,2,0,2,-2,5,3,-4,4,0,0,-9,7,1,-7,6,-2,0,-2,1,-1,-1,-1,1,-1
KR_6765086176,420,2,34,-7,9,0,0,0,4,4,8,4,1,5,1,1,2,0,0,0,0,9,2,1,-5,4,2,0,0,1,1,1,1,6,-1
KR_6660830123,420,-2,-2,8,-7,0,2,2,-1,3,2,-3,5,2,-1,3,2,-2,4,2,0,-8,-36,-2,-2,4,2,0,0,-1,0,0,1,4,-1
KR_6697172942,420,-2,-57,-2,-8,-3,4,1,-5,7,2,-3,5,2,0,2,2,3,0,3,0,-11,-10,-2,-7,9,1,0,0,-1,-1,0,-1,2,-1
KR_6745580066,420,-2,-72,8,-6,3,0,3,-4,5,1,-2,2,0,-4,6,2,1,0,1,0,-8,3,-4,-1,5,-3,0,-3,-1,1,-1,-1,4,-1
KR_6573128050,420,3,33,46,1,3,3,6,0,4,4,0,1,1,-1,3,2,-1,1,0,1,-8,-67,2,-8,6,-1,0,1,-1,-1,1,1,4,-1
KR_6754375951,420,5,-18,7,2,-1,1,0,3,3,6,-3,6,3,1,5,6,2,0,2,0,4,119,5,-7,2,0,0,1,1,-1,1,1,6,-1
KR_6768073671,420,1,-11,33,-5,-1,3,2,-1,2,1,2,1,3,-4,5,1,-1,1,0,-1,-9,7,2,-4,2,0,0,0,0,1,1,-1,0,-1
KR_6597396424,420,1,1,-12,-1,1,1,2,1,2,3,-1,1,0,-1,4,3,-1,1,0,0,-1,10,3,-7,4,-3,0,-1,-1,1,-1,-1,2,-1
KR_6740546444,440,-4,-35,15,-5,-2,3,1,-1,3,2,-4,6,2,2,2,4,0,0,0,0,-10,4,2,-7,5,-6,0,0,1,-1,-1,-1,4,-1
KR_6755629955,420,-6,-73,-32,-14,-3,4,1,0,4,4,-4,6,2,-4,8,4,-3,3,0,0,-8,8,5,-9,4,0,0,-1,-1,-1,-1,-1,5,-1
KR_6765615387,420,-4,-22,-8,-8,-2,3,1,-1,2,1,-1,1,0,-4,5,1,0,0,0,0,-11,2,4,-10,6,-2,0,0,-1,0,0,-1,2,-1
KR_6763881532,420,-3,-37,12,1,-1,2,1,2,1,3,6,1,7,-3,4,1,-3,4,1,-1,-9,18,3,-7,4,-2,0,-1,-1,1,-1,1,2,-1
KR_6689951503,420,-2,-47,-26,1,-1,4,3,0,2,2,4,2,6,-2,2,0,0,0,0,0,3,-15,1,-9,8,-1,0,0,0,0,0,-1,0,-1
KR_6743970445,420,1,3,1,3,0,1,1,0,2,2,1,1,2,2,3,5,0,0,0,0,11,2,0,-7,7,-6,0,-1,-1,-1,-1,-1,5,-1
KR_6758533430,420,1,-42,-25,4,0,2,2,0,3,3,2,1,3,0,3,3,2,0,2,0,3,-54,-8,-4,12,19,0,0,-1,1,1,1,3,-1
KR_6766116206,420,-3,-29,-15,-4,-4,5,1,3,0,3,1,3,4,-3,4,1,-1,2,1,-1,0,6,1,-5,4,-1,0,0,-1,-1,-1,-1,1,-1
KR_6754635238,420,-3,16,-29,-11,0,2,2,0,3,3,-3,4,1,-6,6,0,-2,2,0,-1,-13,-2,-1,-4,5,2,0,-1,-1,1,-1,-1,6,-1
KR_6765761712,420,3,-65,32,-3,1,0,1,-1,1,0,-1,3,2,-3,3,0,1,0,1,0,-10,31,-1,-5,6,4,0,-1,-1,-1,-1,1,4,-1
KR_6660651972,420,-1,-15,-8,2,-2,2,0,5,2,7,1,3,4,0,1,1,-2,2,0,0,-6,2,3,-6,3,-3,0,1,0,1,1,1,0,-1
KR_6754688940,420,0,12,10,2,-1,3,2,0,4,4,5,1,6,-1,1,0,-1,1,0,0,7,-6,1,-3,2,0,0,0,0,-1,0,1,0,-1
KR_6757692700,420,0,60,47,-5,1,4,5,-1,3,2,-3,6,3,-3,8,5,1,0,1,0,-29,4,-1,-8,9,-2,0,3,1,1,1,-1,2,-1
KR_6686601985,420,0,-75,13,-1,2,0,2,0,7,7,0,5,5,-3,3,0,0,2,2,0,1,-42,2,-8,6,19,0,-3,-1,-1,-1,-1,1,-1
KR_6767452181,420,-2,-54,-32,0,-4,5,1,-1,3,2,2,1,3,2,2,4,1,0,1,0,4,5,-3,-4,7,-4,0,-2,1,-1,-1,1,5,-1
KR_6768092318,420,-3,-20,-10,-10,-3,3,0,-5,8,3,-1,2,1,2,3,5,-3,5,2,0,-6,40,1,-4,3,-4,0,0,1,-1,0,-1,6,-1
KR_6671571105,420,-5,-61,1,-7,-1,4,3,-6,8,2,0,3,3,0,5,5,0,0,0,0,-9,-26,-1,-7,8,-9,0,-1,1,-1,-1,-1,5,-1
KR_6752343668,420,-1,26,40,-6,1,3,4,0,3,3,0,4,4,-6,9,3,-1,1,0,0,-7,0,-2,-3,5,-2,0,1,-1,-1,1,-1,5,-1
KR_6707585349,420,2,-39,-13,1,-5,7,2,-2,3,1,7,3,10,2,1,3,-1,1,0,1,-2,8,1,-4,3,-1,0,1,-1,-1,-1,1,4,-1
KR_6696121705,420,-2,-52,-3,-1,-4,5,1,2,4,6,2,1,3,-2,4,2,1,2,3,0,3,2,4,-8,4,-1,0,0,1,1,0,1,5,-1
KR_6754630167,420,0,19,-19,-2,-1,2,1,0,3,3,-2,4,2,2,1,3,-1,1,0,0,3,-2,-4,-2,6,1,0,1,-1,-1,1,1,1,-1
KR_6745744547,420,-4,-69,0,-8,-3,4,1,-1,2,1,1,3,4,-3,6,3,-2,2,0,3,-3,24,-2,-4,6,-1,0,0,1,1,-1,1,4,-1
KR_6767112196,420,-5,-18,-20,-13,-2,2,0,-8,9,1,-4,4,0,-1,8,7,2,1,3,-1,-21,-12,-3,-3,6,3,0,-1,-1,-1,-1,-1,5,-1
KR_6768246107,420,0,-31,12,-9,-1,2,1,-4,6,2,-4,8,4,2,1,3,-2,2,0,0,-9,-4,-4,-4,8,-2,0,-1,1,-1,-1,-1,3,-1
KR_6697113947,420,1,43,-3,8,-1,4,3,3,1,4,-1,2,1,0,1,1,7,1,8,0,13,-29,-1,-5,6,19,0,0,1,-1,1,1,5,-1
KR_6735508400,420,-5,-55,-17,-16,-7,9,2,-9,10,1,1,2,3,-3,5,2,2,1,3,0,-22,11,-4,-2,6,-5,0,-1,-1,-1,-1,1,1,-1
KR_6661012766,420,0,6,-12,-4,-2,4,2,-3,5,2,0,2,2,2,1,3,-1,3,2,-1,-1,-5,-1,-4,5,4,0,0,1,-1,-1,-1,4,-1
KR_6753033373,420,-1,-12,5,-3,-2,5,3,-2,2,0,1,0,1,2,1,3,-2,2,0,-1,-11,-67,2,-7,5,-3,0,-1,-1,-1,-1,-1,5,-1
KR_6758839900,420,1,-23,17,5,0,2,2,5,1,6,3,2,5,0,0,0,-3,5,2,0,5,-1,-1,-4,5,3,0,1,-1,1,1,1,1,-1
KR_6644150300,420,-8,-104,-59,-12,-3,4,1,1,2,3,-7,8,1,-2,2,0,-1,1,0,0,-17,-1,1,-6,5,-4,0,-2,1,1,-1,1,5,-1
KR_6613013771,420,-1,11,5,-4,1,4,5,-4,6,2,-5,5,0,3,2,5,1,1,2,0,-13,0,0,-6,6,2,0,1,1,-1,1,1,6,-1
KR_6760099996,420,4,41,12,10,8,0,8,0,2,2,2,0,2,-1,4,3,1,1,2,0,1,11,4,-6,2,1,0,2,1,-1,1,1,6,-1
KR_6738758568,420,3,75,-23,2,4,0,4,0,2,2,-2,4,2,1,4,5,-1,1,0,1,3,-6,2,-6,4,-4,0,1,-1,-1,1,1,6,-1
KR_6753273884,420,1,5,-29,-1,-1,2,1,-3,4,1,2,2,4,2,1,3,-1,1,0,0,2,-69,4,-7,3,-1,0,0,-1,-1,0,-1,3,-1
KR_6687618161,420,1,30,-17,-6,-1,2,1,-7,10,3,-3,5,2,6,0,6,-1,1,0,-1,-12,1,0,-7,7,-2,0,1,1,-1,-1,1,5,-1
KR_6763479178,440,-2,0,-55,-13,1,1,2,-1,4,3,1,1,2,-14,17,3,0,4,4,-1,-12,-2,3,-8,5,-6,0,-1,-1,-1,-1,-1,5,-1
KR_6752431032,420,-5,-68,-32,-9,0,1,1,1,2,3,-8,8,0,-2,5,3,0,0,0,1,-2,-6,0,-4,4,-1,0,-2,1,-1,-1,1,4,-1
KR_6617161765,420,-5,6,-29,-11,-5,5,0,1,6,7,-1,2,1,-6,8,2,0,2,2,1,-11,-1,-5,-7,12,-1,0,0,-1,-1,-1,1,3,-1
KR_6721216920,420,-5,-81,-16,-16,-2,4,2,-2,3,1,-6,8,2,-3,6,3,-3,3,0,0,-15,-60,-6,-1,7,3,0,0,-1,1,-1,-1,3,-1
KR_6732833043,420,-2,-7,5,-7,-3,4,1,0,2,2,-2,2,0,-3,3,0,1,0,1,0,-13,15,-1,-9,10,-7,0,0,-1,1,-1,-1,1,-1
KR_6698203043,440,-3,-73,4,-5,-1,1,0,-4,5,1,-1,3,2,-3,5,2,4,1,5,0,-2,235,-1,-3,4,-1,0,-1,1,-1,-1,-1,2,-1
KR_6764659723,420,-3,-58,-11,-8,3,3,6,-5,9,4,-3,6,3,-1,4,3,-2,3,1,1,-11,4,-5,-5,10,2,0,-1,1,-1,-1,1,3,-1
KR_6703065524,420,-3,-80,-15,-13,0,3,3,-2,3,1,-2,4,2,-3,4,1,-6,6,0,-1,-14,-8,2,-7,5,-2,0,-1,-1,1,-1,-1,1,-1
KR_6743442133,420,-3,0,-4,-7,-2,3,1,-4,8,4,2,3,5,-3,4,1,0,0,0,0,-12,-3,-1,-3,4,6,0,0,-1,-1,-1,-1,3,-1
KR_6768729067,420,0,-19,4,-5,0,4,4,-1,3,2,1,2,3,-1,6,5,-4,6,2,0,-8,-4,1,-5,4,-3,0,1,-1,1,1,-1,2,-1
KR_6743281361,420,-3,-33,3,-4,0,1,1,1,0,1,-1,2,1,-2,4,2,-2,2,0,-1,-7,-30,0,-7,7,-3,0,0,0,-1,0,-1,0,-1
KR_6579102066,420,-2,44,-33,-6,-1,2,1,-1,1,0,-3,3,0,-3,3,0,2,0,2,0,-4,-5,0,-8,8,0,0,0,-1,1,1,-1,6,-1
KR_6713036420,420,1,-16,0,-1,2,1,3,0,5,5,-1,4,3,-3,3,0,1,1,2,0,-2,-1,1,-5,4,-2,0,0,1,-1,0,1,1,-1
KR_6767872018,420,-2,-132,16,-4,-4,5,1,-1,2,1,1,2,3,2,0,2,-2,3,1,0,0,-5,-1,-7,8,-5,0,0,1,1,-1,-1,2,-1
KR_6768458395,420,0,-9,-24,4,-2,3,1,1,1,2,6,1,7,-1,2,1,0,2,2,0,8,-44,-3,-5,8,6,0,1,-1,1,1,1,2,-1
KR_6761745221,420,-2,-51,1,1,0,2,2,-2,3,1,4,0,4,0,0,0,-1,1,0,0,5,-7,-1,-3,4,0,0,-2,1,-1,-1,1,5,-1
KR_6727656196,420,-2,-8,14,-7,-1,4,3,-5,7,2,3,2,5,0,3,3,-4,5,1,0,-10,-25,-2,-5,7,2,0,-1,-1,-1,-1,-1,1,-1
KR_6617442828,420,1,-31,9,0,3,1,4,0,4,4,-2,2,0,-2,4,2,1,1,2,0,7,9,-3,-6,9,2,0,0,-1,-1,0,-1,3,-1
KR_6714461637,440,-2,64,-30,-7,2,3,5,-4,4,0,-4,4,0,-2,2,0,1,1,2,0,-7,11,1,-4,3,-2,0,1,-1,-1,1,-1,2,-1
KR_6760047252,440,1,-27,-10,1,2,1,3,0,2,2,-1,1,0,0,1,1,0,0,0,0,4,-4,-3,-5,8,-1,0,-1,-1,-1,-1,1,4,-1
KR_6761969246,420,0,0,17,-4,1,1,2,-4,4,0,0,2,2,-3,4,1,2,1,3,0,0,8,3,-6,3,-3,0,0,1,1,0,-1,1,-1
KR_6759863332,440,-3,-55,-12,-3,0,2,2,0,5,5,-4,5,1,2,0,2,-1,1,0,-1,-2,-13,1,-7,6,0,0,0,0,0,0,-1,0,-1
KR_6755051406,420,0,-29,-11,-6,1,2,3,0,3,3,0,1,1,-4,4,0,-3,4,1,0,-10,-6,-4,-2,6,-5,0,0,-1,-1,-1,-1,1,-1
KR_6761994118,420,-4,-98,-25,-5,-2,3,1,-1,2,1,-2,3,1,-2,3,1,2,0,2,-1,-5,-1,0,-2,2,-2,0,-4,-1,-1,-1,-1,1,-1
KR_6766714106,420,-2,-61,28,-10,-1,2,1,-3,4,1,-4,4,0,2,0,2,-4,5,1,-1,-10,-2,6,-8,2,-1,0,-1,-1,1,-1,-1,1,-1
KR_6754605792,420,-2,-34,1,-7,-6,6,0,-2,3,1,1,2,3,0,2,2,0,0,0,-1,-9,3,1,-9,8,0,0,0,1,-1,-1,-1,3,-1
KR_6733844409,420,-2,-19,12,-4,0,3,3,0,2,2,-2,2,0,-2,4,2,0,0,0,-1,-6,251,1,-6,5,-3,0,0,1,-1,0,-1,3,-1
KR_6742328656,420,-6,-59,-17,-22,-3,4,1,-5,5,0,-9,13,4,-2,6,4,-3,4,1,-3,-22,-6,-1,-4,5,2,0,-2,-1,-1,-1,-1,4,-1
KR_6623308360,420,0,-23,-20,-3,3,1,4,-3,4,1,0,5,5,2,2,4,-5,6,1,1,3,-1,4,-6,2,-2,0,-1,-1,-1,-1,1,6,-1
KR_6737303082,440,2,0,20,2,3,1,4,-2,8,6,-3,5,2,2,3,5,2,1,3,0,2,2,-1,-3,4,2,0,1,0,1,1,-1,0,-1
KR_6744795874,440,-4,-46,-10,-13,-4,5,1,2,0,2,-5,5,0,-5,5,0,-1,1,0,-1,-14,-20,-5,-3,8,-4,0,0,-1,-1,0,-1,5,-1
KR_6762466013,420,-4,-83,17,-12,2,4,6,-4,5,1,-3,4,1,-5,7,2,-2,3,1,0,-9,295,-1,-2,3,-1,0,-2,-1,-1,-1,-1,4,-1
KR_6607197439,420,1,-5,12,4,1,1,2,4,0,4,-4,4,0,3,1,4,0,1,1,0,8,8,3,-7,4,-1,0,1,1,1,1,1,4,-1
KR_6726103823,420,-3,-35,-2,-3,-4,5,1,4,2,6,1,1,2,-3,4,1,-1,2,1,0,-8,-141,-4,-2,6,2,0,0,-1,1,0,1,3,-1
KR_6767201602,420,-1,38,-8,2,-3,5,2,5,2,7,0,1,1,1,2,3,-1,2,1,0,7,-3,-3,-4,7,2,0,-1,1,-1,-1,1,2,-1
KR_6741903066,420,-2,-21,-7,-2,0,1,1,-3,4,1,-1,3,2,3,0,3,-1,1,0,0,1,-29,-1,-4,5,6,0,0,-1,-1,-1,-1,1,-1
KR_6761973422,420,-3,-55,-13,-1,-2,3,1,-1,3,2,2,0,2,0,3,3,0,1,1,0,-1,4,3,-8,5,-5,0,-2,-1,-1,-1,1,1,-1
KR_6733866973,420,-3,-24,-19,-6,-1,1,0,1,2,3,1,1,2,-6,7,1,-1,2,1,0,-8,32,1,-7,6,-39,0,0,1,1,0,1,4,-1
KR_6719994521,420,-4,-14,13,-17,0,2,2,-4,5,1,-6,6,0,-5,8,3,-2,3,1,0,-18,-14,0,-5,5,-1,0,-2,0,-1,-1,-1,0,-1
KR_6692069214,420,-2,-40,-3,1,-3,3,0,6,2,8,-5,5,0,2,1,3,1,0,1,0,10,-6,-4,-4,8,2,0,-1,1,-1,-1,-1,6,-1
KR_6755296380,420,-1,-18,24,-2,-1,2,1,2,1,3,-2,5,3,-3,5,2,2,1,3,0,7,-3,-1,-5,6,-2,0,2,1,1,1,-1,4,-1
KR_6706952923,420,-1,-16,3,-5,0,3,3,-2,3,1,0,1,1,-3,3,0,0,0,0,0,-10,-1,-1,-5,6,-5,0,1,-1,-1,1,-1,5,-1
KR_6723518503,420,-4,-68,16,-17,-10,10,0,-5,5,0,0,0,0,0,2,2,-2,2,0,0,-11,28,-5,-3,8,-6,0,-2,-1,-1,-1,-1,2,-1
KR_6767640098,440,0,-21,-13,-2,-2,2,0,-3,3,0,1,2,3,3,2,5,-1,3,2,0,-8,4,-1,-3,4,-2,0,-1,-1,-1,-1,1,1,-1
KR_6612078793,420,-3,-37,9,-10,1,4,5,-1,3,2,-6,9,3,-6,7,1,2,1,3,-4,-30,-5,-2,-3,5,0,0,-1,-1,1,1,-1,1,-1
KR_6727746981,420,1,-11,-40,-3,3,0,3,-1,3,2,-2,5,3,-3,4,1,0,0,0,-1,-12,7,2,-6,4,-4,0,0,1,-1,0,-1,2,-1
KR_6766925217,420,1,4,35,8,3,1,4,-2,4,2,2,1,3,2,3,5,3,2,5,1,9,2,-3,-3,6,-1,0,1,1,1,1,1,6,-1
KR_6767194774,440,-2,-3,-4,-9,-1,2,1,-4,5,1,-4,6,2,0,4,4,0,1,1,0,-2,-1,1,-5,4,-4,0,1,1,-1,1,-1,1,-1
KR_6768859317,420,-1,-42,15,2,0,1,1,3,0,3,-3,4,1,2,2,4,0,1,1,0,6,-6,-1,-3,4,5,0,-1,1,-1,-1,1,4,-1
KR_6766550199,420,-1,-46,11,-6,-3,5,2,-2,4,2,-1,2,1,0,0,0,0,0,0,0,-5,-4,-1,-6,7,-1,0,0,-1,1,0,-1,3,-1
KR_6749653939,420,0,28,4,4,2,1,3,-1,3,2,0,1,1,3,0,3,0,0,0,0,-2,-5,-4,-4,8,-2,0,0,1,0,0,1,3,-1
KR_6757748955,420,4,0,4,5,-1,2,1,3,0,3,1,3,4,1,1,2,1,0,1,0,7,-20,-1,-3,4,3,0,0,1,-1,0,1,4,-1
KR_6678035886,440,-2,-27,-19,1,-4,6,2,-1,3,2,1,3,4,3,2,5,2,0,2,0,-1,5,0,-3,3,1,0,1,-1,1,1,1,2,-1
KR_6686997988,420,0,10,4,-3,1,0,1,-2,4,2,-3,4,1,1,5,6,0,1,1,0,-10,0,-6,-6,12,-3,0,-1,0,1,-1,1,0,-1
KR_6765887177,420,0,10,-23,-7,0,2,2,-1,3,2,-2,6,4,-4,6,2,0,1,1,1,-16,-8,-1,-4,5,2,0,-1,-1,-1,-1,1,2,-1
KR_6756473630,420,-3,1,-12,-7,0,0,0,2,3,5,-1,4,3,-7,9,2,-1,2,1,0,-2,-36,3,-7,4,-4,0,0,1,-1,0,-1,2,-1
KR_6761990147,420,3,-35,32,0,4,1,5,1,3,4,-4,5,1,-1,3,2,0,1,1,0,10,5,2,-6,4,3,0,-2,-1,-1,-1,-1,5,-1
KR_6766419448,420,2,27,-3,5,1,0,1,-2,3,1,2,0,2,2,1,3,2,0,2,0,2,5,3,-4,1,0,0,0,1,-1,0,-1,4,-1
KR_6719752333,420,-1,17,9,-4,4,0,4,3,2,5,-3,4,1,-9,10,1,1,1,2,0,-12,-1,1,-8,7,-9,0,-1,-1,1,-1,1,4,-1
KR_6650186783,420,-5,-53,-5,-11,-2,2,0,-1,2,1,2,0,2,-4,4,0,-6,6,0,0,-18,117,3,-9,6,-2,0,-2,1,-1,-1,-1,3,-1
KR_6762458646,420,-1,-49,-5,-1,0,4,4,1,4,5,-2,3,1,1,2,3,-1,4,3,0,6,-8,0,-6,6,2,0,-2,-1,1,-1,-1,6,-1
KR_6758359298,420,4,19,14,10,2,3,5,3,2,5,1,0,1,3,3,6,1,0,1,0,22,-8,0,-10,10,-3,0,0,1,-1,0,1,5,-1
KR_6688619644,420,-4,-30,-6,-20,-3,3,0,-1,2,1,-10,10,0,-6,10,4,0,0,0,0,-25,-2,2,-9,7,-5,0,0,-1,1,0,-1,3,-1
KR_6758876405,420,-3,-34,-25,-3,2,0,2,-3,4,1,1,1,2,-3,3,0,0,1,1,-1,-1,-2,-3,-4,7,-2,0,-1,-1,-1,-1,-1,3,-1
KR_6648546249,420,-1,7,-24,3,-2,2,0,1,5,6,3,4,7,1,3,4,0,0,0,0,3,-9,-4,-3,7,-2,0,0,-1,1,0,1,2,-1
KR_6767154296,420,-1,-12,-8,-1,2,1,3,1,2,3,-2,4,2,-2,4,2,0,1,1,0,-2,7,1,-4,3,-6,0,1,-1,1,1,-1,2,-1
KR_6763442130,420,0,-19,16,2,1,2,3,1,6,7,0,2,2,0,1,1,0,1,1,0,-1,124,4,-6,2,-2,0,1,1,1,1,-1,5,-1
KR_6763165721,420,1,15,2,7,4,1,5,5,1,6,-2,5,3,-1,8,7,1,1,2,0,6,-7,-1,-3,4,4,0,1,1,1,1,1,2,-1
KR_6762751284,420,-2,-23,-30,-6,-2,4,2,-3,5,2,-1,3,2,-1,6,5,1,1,2,0,-7,4,-1,-5,6,-3,0,1,1,1,1,-1,5,-1
KR_6765478430,420,-4,-68,-24,-16,-4,5,1,-6,7,1,-8,8,0,-1,3,2,3,0,3,0,-6,-3,-5,-2,7,1,0,-1,0,-1,-1,-1,0,-1
KR_6720893467,420,1,-35,8,3,-2,3,1,3,2,5,1,0,1,0,2,2,1,0,1,2,5,-6,-2,-8,10,2,0,0,-1,1,1,1,5,-1
KR_6761785987,420,1,-52,28,6,-2,3,1,-2,5,3,0,1,1,8,0,8,2,2,4,0,7,-3,-2,-5,7,4,0,0,1,1,0,1,4,-1
KR_6650474632,420,2,-15,14,0,0,4,4,3,2,5,2,0,2,-5,5,0,0,0,0,0,-2,24,-4,-8,12,3,0,-1,-1,1,1,-1,2,-1
KR_6760787641,420,1,4,13,5,-1,3,2,3,2,5,-1,2,1,2,1,3,2,0,2,0,20,10,6,-10,4,-1,0,1,1,1,1,-1,3,-1
KR_6567695783,420,-2,22,-19,-1,4,0,4,-1,3,2,-2,5,3,-2,3,1,0,1,1,0,-8,42,-3,-5,8,-1,0,-1,1,1,1,-1,5,-1
KR_6757722205,420,-2,42,-11,-6,-2,3,1,-2,3,1,-2,2,0,0,2,2,0,1,1,0,1,-30,-1,-2,3,-1,0,-1,-1,-1,-1,-1,5,-1
KR_6686657594,420,-7,-83,-12,-10,-4,4,0,-1,3,2,-2,3,1,-4,7,3,1,0,1,-1,-6,-28,-3,-5,8,4,0,-1,-1,-1,-1,-1,3,-1
KR_6750185874,420,-3,-33,7,-4,2,1,3,-3,4,1,-2,4,2,0,1,1,-1,1,0,1,-13,4,1,-5,4,-3,0,-1,-1,-1,-1,1,6,-1
KR_6761202072,420,1,124,-20,5,3,1,4,-3,5,2,0,3,3,2,1,3,3,0,3,0,7,1,4,-8,4,3,0,0,-1,-1,0,1,6,-1
KR_6712196277,420,-2,-31,0,-6,0,2,2,-6,10,4,-1,1,0,1,1,2,0,1,1,0,-7,-7,-3,-6,9,-1,0,-1,1,1,-1,-1,3,-1
KR_6762136052,420,-2,35,4,-5,-4,6,2,2,0,2,-2,4,2,2,3,5,-3,3,0,0,-14,1,4,-8,4,1,0,1,1,-1,-1,1,2,-1
KR_6680621493,420,-7,-37,-61,-8,0,1,1,-3,4,1,-1,3,2,0,1,1,-4,4,0,0,-9,-10,-1,-4,5,-5,0,-1,-1,-1,-1,1,6,-1
KR_6763322702,440,0,5,-16,6,4,1,5,-1,1,0,6,0,6,-3,5,2,0,0,0,1,0,27,4,-8,4,-2,0,1,-1,-1,1,1,4,-1
KR_6749479535,420,-1,-46,-1,2,1,2,3,2,3,5,-1,3,2,0,1,1,0,1,1,0,2,-9,0,-6,6,0,0,0,1,1,0,1,5,-1
KR_6506761116,420,0,-49,32,0,0,2,2,-4,5,1,3,1,4,1,2,3,0,0,0,0,3,-1,5,-7,2,-2,0,0,-1,1,-1,1,6,-1
KR_6698915643,440,-2,-64,-8,-3,-3,3,0,-5,5,0,4,2,6,-3,5,2,4,0,4,0,-2,-2,-4,-3,7,-3,0,0,1,1,-1,-1,4,-1
KR_6767323653,420,0,7,16,-6,-1,3,2,2,4,6,0,0,0,-5,7,2,-2,4,2,0,-1,-7,-4,-5,9,-2,0,-1,-1,-1,-1,1,2,-1
KR_6720338414,420,2,64,-20,7,5,0,5,1,5,6,2,4,6,1,3,4,-2,3,1,1,2,1,3,-8,5,4,0,1,-1,1,1,1,6,-1
KR_6734277702,420,-5,-52,-13,-8,-4,7,3,-2,2,0,0,1,1,0,0,0,-2,2,0,0,0,3,4,-8,4,-11,0,-1,-1,1,-1,-1,2,-1
KR_6703064839,420,-5,-43,-16,-10,0,2,2,-2,3,1,-5,8,3,2,2,4,-5,6,1,0,-6,-6,-5,-7,12,3,0,-1,1,1,-1,1,2,-1
KR_6765473988,420,-6,-69,-8,-12,-4,4,0,-2,3,1,1,3,4,-6,7,1,-1,1,0,0,-9,-13,-5,-3,8,5,0,-2,-1,-1,-1,-1,4,-1
KR_6692608643,420,0,-94,-22,-2,0,3,3,-3,6,3,2,1,3,-1,1,0,0,1,1,-3,-10,7,5,-10,5,-6,0,0,-1,1,-1,-1,1,-1
KR_6399931678,420,-1,-3,40,-2,-3,4,1,1,7,8,1,0,1,-2,3,1,1,2,3,0,-1,-16,-3,-5,8,4,0,-1,1,1,-1,1,2,-1
KR_6749307826,420,-4,-68,-3,-14,2,1,3,-3,5,2,-5,6,1,-7,11,4,-1,1,0,0,-26,-23,3,-6,3,1,0,-2,-1,-1,-1,1,2,-1
KR_6766490619,420,-6,-96,-20,-11,-4,4,0,-1,4,3,-1,1,0,-6,7,1,1,2,3,0,-9,-10,-6,-4,10,-6,0,-2,-1,0,-1,-1,1,-1
KR_6740324767,420,2,10,16,6,1,4,5,5,3,8,6,0,6,-9,10,1,3,2,5,1,8,-10,-5,-4,9,-2,0,0,-1,0,-1,1,2,-1
KR_6690895352,420,-4,-80,3,-13,-1,1,0,-3,4,1,-7,7,0,-2,5,3,0,2,2,-1,-16,-153,-2,-4,6,-1,0,0,-1,1,-1,-1,6,-1
KR_6750017346,420,1,59,11,-6,0,2,2,0,1,1,-1,4,3,-3,6,3,-2,2,0,-3,-22,-4,1,-4,3,-1,0,-1,-1,-1,-1,-1,4,-1
KR_6764967217,420,-6,-90,18,-11,-1,2,1,-4,5,1,-4,4,0,-3,7,4,1,0,1,0,-6,6,-5,-3,8,1,0,-1,-1,1,-1,-1,2,-1
KR_6698144454,420,-4,-60,-23,-7,3,0,3,-4,5,1,-2,2,0,-4,4,0,0,1,1,-1,-11,-45,-5,-6,11,4,0,-2,-1,-1,-1,-1,4,-1
KR_6736007307,420,-3,-18,-36,-1,-1,2,1,2,0,2,-3,4,1,1,0,1,0,0,0,0,0,1,0,-4,4,-2,0,0,-1,-1,0,1,1,-1
KR_6728935153,420,0,2,6,3,-1,2,1,4,3,7,-2,5,3,1,0,1,1,1,2,-1,-3,-37,0,-8,8,0,0,1,-1,1,1,-1,5,-1
KR_6761591859,420,-1,-23,16,-5,-5,6,1,1,4,5,4,0,4,-4,6,2,-1,2,1,0,2,-77,-1,-5,6,-1,0,0,-1,1,0,-1,6,-1
KR_6674977918,420,-2,25,-8,2,-3,4,1,4,3,7,2,0,2,0,3,3,-1,2,1,-1,4,11,-4,-5,9,-1,0,2,1,1,1,-1,6,-1
KR_6768528525,420,-1,-28,-59,-6,-4,5,1,0,2,2,3,2,5,-3,3,0,-2,2,0,0,-6,0,-3,-2,5,-4,0,-3,-1,-1,-1,1,6,-1
KR_6768823513,420,0,3,-4,2,0,1,1,1,4,5,-4,5,1,3,1,4,2,0,2,0,4,28,-3,-5,8,-6,0,0,1,1,0,1,5,-1
KR_6732818879,420,-2,-59,16,-3,-3,3,0,0,3,3,-2,4,2,0,3,3,2,1,3,0,1,100,1,-5,4,-3,0,0,1,-1,0,-1,5,-1
KR_6755104242,420,3,9,-13,4,-1,3,2,4,4,8,-3,5,2,5,3,8,-1,3,2,0,3,4,-3,-4,7,-2,0,1,-1,1,1,1,5,-1
KR_6762060154,420,-3,-35,-23,-16,-3,3,0,-1,3,2,-7,7,0,-3,3,0,-2,2,0,0,-18,-16,-3,-5,8,-9,0,-1,-1,-1,-1,-1,2,-1
KR_6692631648,420,-1,-33,-1,-1,-2,3,1,4,1,5,-1,3,2,-1,3,2,-1,1,0,1,3,32,2,-8,6,-1,0,0,-1,-1,-1,1,6,-1
KR_6765730998,420,2,-5,13,-2,2,2,4,1,3,4,-4,6,2,0,1,1,-1,1,0,0,-1,-3,1,-4,3,1,0,1,0,1,1,-1,0,-1
KR_6744038262,420,-2,-13,24,-7,0,0,0,-1,3,2,3,0,3,-7,9,2,-2,2,0,0,-13,-221,2,-7,5,-4,0,-2,1,-1,-1,1,6,-1
KR_6769089566,420,-5,-67,-11,-14,-3,3,0,-2,3,1,4,1,5,-9,9,0,-4,4,0,-1,-18,-14,-6,-2,8,1,0,-1,-1,-1,-1,-1,5,-1
KR_6753865291,420,-4,-21,5,-13,-1,1,0,-4,4,0,0,1,1,-6,8,2,-2,3,1,0,-10,46,-3,-6,9,-1,0,-1,-1,1,-1,-1,2,-1
KR_6744522021,420,1,-47,-4,1,4,1,5,-2,4,2,2,3,5,-3,3,0,0,3,3,0,0,-9,-3,-4,7,1,0,-2,-1,1,-1,1,2,-1
KR_6631772126,420,-2,-15,32,-12,-5,5,0,-5,9,4,1,0,1,-2,5,3,-1,1,0,0,-17,-12,-4,-5,9,-2,0,-3,-1,-1,-1,-1,5,-1
KR_6755052950,420,-4,-27,9,-7,-3,3,0,3,2,5,-3,4,1,-1,1,0,-3,4,1,0,-2,18,1,-5,4,3,0,-2,-1,-1,-1,-1,5,-1
KR_6749825300,420,2,47,18,3,-1,2,1,4,0,4,-2,3,1,1,2,3,1,1,2,0,3,22,-1,-4,5,3,0,0,-1,-1,0,1,5,-1
KR_6616569447,420,2,38,-9,12,4,0,4,2,2,4,1,2,3,4,1,5,1,0,1,0,8,4,1,-7,6,4,0,0,-1,-1,1,1,4,-1
KR_6725382940,420,-6,-142,16,-17,0,0,0,-1,3,2,-1,2,1,-14,15,1,-1,1,0,0,-28,6,0,-5,5,-2,0,-1,-1,1,-1,-1,2,-1
KR_6761447073,440,-4,-31,12,-14,0,1,1,-4,5,1,0,1,1,-2,3,1,-8,10,2,0,-13,-9,-2,-5,7,2,0,-1,1,-1,-1,-1,1,-1
KR_6608787020,420,0,31,-32,1,2,0,2,-1,1,0,-2,5,3,1,3,4,1,1,2,0,2,-2,-1,-5,6,-5,0,0,-1,-1,-1,-1,1,-1
KR_6753234235,440,0,78,7,-14,-4,4,0,-4,6,2,0,2,2,-4,5,1,-2,3,1,0,-23,-51,0,-3,3,0,0,-1,-1,-1,-1,-1,5,-1
KR_6764219237,420,2,9,16,-3,0,2,2,-3,4,1,1,2,3,0,3,3,-1,1,0,0,-7,-33,0,-8,8,2,0,0,0,1,0,1,0,-1
KR_6751994743,420,1,23,3,-2,-3,3,0,1,3,4,4,2,6,-3,4,1,-1,2,1,0,1,0,-3,-3,6,1,0,-1,-1,-1,-1,-1,1,-1
KR_6597561011,420,-5,-78,-8,-12,-5,6,1,-5,9,4,2,2,4,-4,7,3,0,1,1,0,-13,-14,-10,-1,11,0,0,-2,-1,1,-1,-1,5,-1
KR_6767709833,420,-3,-6,-32,-2,3,0,3,-3,4,1,-1,4,3,0,4,4,-1,1,0,0,7,-2,-4,-1,5,-4,0,0,-1,-1,0,-1,4,-1
KR_6768406409,420,-2,-45,8,-8,-1,2,1,2,2,4,-5,5,0,-4,5,1,0,1,1,0,-3,7,0,-6,6,-4,0,0,-1,1,0,-1,1,-1
KR_6761990748,420,2,60,-8,1,1,2,3,3,1,4,-2,3,1,-3,5,2,2,0,2,0,-2,22,3,-10,7,2,0,1,-1,1,1,1,5,-1
KR_6762702576,420,-2,5,4,-8,-4,5,1,0,1,1,4,2,6,-5,7,2,-3,3,0,0,-10,-9,2,-4,2,3,0,0,1,-1,-1,-1,4,-1
KR_6750029743,420,1,-28,9,-6,-1,2,1,2,1,3,-1,3,2,-6,10,4,0,1,1,-1,5,-8,-8,-3,11,5,0,0,-1,-1,0,-1,4,-1
KR_6730891805,420,-3,-11,-28,-5,0,2,2,-2,8,6,2,1,3,-4,6,2,-1,1,0,0,-2,1,3,-7,4,-5,0,-1,-1,1,-1,-1,6,-1
KR_6764757029,420,-2,-22,23,1,-2,2,0,3,1,4,-1,3,2,1,2,3,0,0,0,1,4,4,3,-6,3,-1,0,-1,-1,1,-1,1,3,-1
KR_6764818262,420,-6,-101,-24,-14,-3,3,0,-3,3,0,-3,5,2,-4,4,0,-1,2,1,0,-7,-13,0,-4,4,0,0,-3,-1,-1,-1,-1,1,-1
KR_6763706919,420,-2,-19,-9,-7,-2,2,0,1,4,5,2,1,3,-3,5,2,-5,6,1,0,-5,3,-1,-9,10,5,0,-1,1,1,-1,-1,3,-1
KR_6755974002,420,-2,6,-9,-6,-1,3,2,-11,11,0,3,4,7,2,4,6,1,0,1,0,-8,119,-7,-4,11,-2,0,1,-1,-1,1,-1,5,-1
KR_6692907221,420,1,40,33,-3,0,2,2,0,2,2,2,0,2,-1,6,5,-4,4,0,0,-2,-9,-5,-5,10,2,0,2,-1,1,1,-1,6,-1
KR_6747841726,420,0,17,8,-1,0,0,0,2,2,4,-6,7,1,1,0,1,2,0,2,0,-1,-7,1,-4,3,0,0,0,-1,0,-1,-1,5,-1
KR_6658968512,420,-3,-31,7,-9,-1,2,1,-4,5,1,0,1,1,-4,6,2,0,0,0,0,-5,-1,-1,-4,5,0,0,-1,-1,1,-1,1,4,-1
KR_6768489913,420,-3,-85,-31,-6,2,0,2,-2,4,2,-4,4,0,-2,4,2,0,2,2,1,-6,-45,-1,-4,5,23,0,-1,-1,-1,-1,1,5,-1
KR_6767685792,420,1,20,-8,-3,-4,4,0,-2,6,4,0,2,2,-4,8,4,7,0,7,0,-15,30,-2,-5,7,-5,0,1,1,-1,1,-1,6,-1
KR_6737797151,420,-3,25,-25,-6,1,1,2,2,2,4,0,2,2,-6,7,1,-3,3,0,0,-8,13,-2,-2,4,0,0,-2,1,1,-1,1,4,-1
KR_6760829590,420,-4,-14,4,-9,2,1,3,1,3,4,-3,4,1,-4,6,2,-5,5,0,0,-7,-31,-4,-6,10,1,0,-1,-1,-1,-1,-1,5,-1
KR_6762532250,420,0,-4,-4,-13,-1,3,2,0,1,1,-8,9,1,-4,4,0,0,0,0,0,-15,2,-1,-4,5,0,0,0,-1,-1,-1,1,3,-1
KR_6768115925,420,-4,-51,-20,-5,2,1,3,0,3,3,3,1,4,-5,8,3,-5,5,0,1,-9,2,1,-10,9,-2,0,-2,-1,1,-1,1,6,-1
KR_6692226418,420,2,11,-35,3,-1,2,1,6,1,7,-2,4,2,2,1,3,-2,3,1,0,5,1,0,-6,6,3,0,0,1,1,1,1,5,-1
KR_6741155641,440,-3,4,0,-1,-8,8,0,-4,4,0,-2,3,1,11,2,13,2,2,4,-1,8,-14,-3,-5,8,2,0,-2,-1,-1,-1,-1,3,-1
KR_6637795013,420,-6,-31,-31,-16,-8,8,0,-5,5,0,1,2,3,2,5,7,-6,6,0,0,-6,-5,1,-5,4,1,0,-3,1,-1,-1,-1,1,-1
KR_6765431603,420,-6,-73,-44,-12,3,2,5,-5,5,0,-5,6,1,-3,7,4,-2,3,1,1,-10,-12,-5,-1,6,4,0,-1,-1,-1,-1,-1,2,-1
KR_6763170741,420,0,71,16,-12,6,0,6,-7,7,0,-7,8,1,-5,5,0,1,1,2,-2,-19,-25,-4,-3,7,2,0,0,-1,-1,-1,-1,2,-1
KR_6769161863,420,-3,-44,-27,-14,2,1,3,-2,2,0,-6,7,1,-5,6,1,-3,4,1,0,-15,0,2,-5,3,-9,0,-1,-1,-1,-1,-1,2,-1
KR_6502726717,440,3,-3,3,-2,-4,4,0,-3,5,2,3,0,3,2,3,5,0,2,2,0,-3,-10,-2,-6,8,-2,0,0,-1,1,0,-1,5,-1
KR_6764717488,420,-2,-12,27,-12,-2,3,1,-2,2,0,-3,3,0,-5,6,1,0,0,0,0,-20,17,-2,-6,8,-1,0,0,-1,-1,0,-1,2,-1
KR_6712048601,420,-3,-73,0,-1,-2,3,1,-4,5,1,3,0,3,2,1,3,0,0,0,0,-4,43,1,-6,5,-4,0,0,1,-1,-1,-1,5,-1
KR_6718840351,420,-3,-48,-39,-11,-1,3,2,-8,8,0,4,0,4,-5,5,0,-1,2,1,0,-16,0,0,-7,7,3,0,0,-1,1,-1,-1,2,-1
KR_6758048224,420,-6,-24,-40,-8,2,3,5,0,1,1,-1,2,1,-6,6,0,-3,5,2,0,-8,-5,4,-8,4,-4,0,-2,-1,-1,-1,-1,5,-1
KR_6748946081,420,0,-73,9,3,-2,6,4,-2,3,1,2,2,4,5,1,6,0,3,3,0,12,-17,-9,-4,13,3,0,-1,1,0,-1,-1,2,-1
KR_6639865369,420,-6,-84,-31,-15,-5,6,1,-6,8,2,1,2,3,-1,5,4,-4,4,0,0,-14,-4,-1,-6,7,1,0,-1,-1,1,-1,1,3,-1
KR_6732485931,420,-4,17,-1,-13,0,1,1,-3,7,4,-4,7,3,-3,5,2,-3,3,0,0,-18,-4,0,-4,4,-5,0,-1,1,-1,-1,-1,1,-1
KR_6726841538,420,-2,-37,-28,3,0,3,3,1,5,6,-1,3,2,3,2,5,0,1,1,1,10,3,2,-7,5,-3,0,-1,-1,-1,-1,1,6,-1
KR_6703517357,420,1,56,1,3,-2,6,4,0,2,2,-6,6,0,11,0,11,0,0,0,0,-1,6,-2,-2,4,0,0,1,1,-1,1,1,3,-1
KR_6767893668,420,1,74,4,3,0,3,3,3,2,5,5,0,5,-4,7,3,-1,4,3,1,-7,6,0,-7,7,-7,0,-1,-1,1,1,-1,1,-1
KR_6638282874,420,-4,-37,-29,-7,-3,3,0,2,1,3,1,2,3,-5,8,3,-2,2,0,0,-12,-15,0,-3,3,3,0,-2,-1,1,-1,-1,1,-1
KR_6768690026,420,-2,-62,-11,-12,1,2,3,-5,5,0,-8,9,1,-3,8,5,3,0,3,0,-7,-3,-11,0,11,0,0,-2,-1,-1,-1,-1,5,-1
KR_6720435200,420,-1,16,-8,-4,4,0,4,-2,3,1,-6,9,3,-1,4,3,1,1,2,0,-4,-16,0,-6,6,-6,0,1,1,-1,1,1,5,-1
KR_6754304729,420,-1,20,4,-1,-1,1,0,-2,3,1,4,1,5,-1,4,3,-1,1,0,0,-2,-12,-4,-4,8,5,0,1,-1,1,1,1,1,-1
KR_6766560223,420,-4,-25,3,-12,-2,2,0,-3,4,1,-4,5,1,-5,6,1,2,0,2,0,-10,-7,-5,-2,7,0,0,0,-1,-1,0,-1,2,-1
KR_6638200947,420,-5,-35,12,-15,-6,7,1,-8,10,2,-1,1,0,0,1,1,0,2,2,0,-12,-23,1,-10,9,-2,0,-3,-1,-1,-1,-1,4,-1
KR_6749691270,420,-1,6,-5,-4,-1,3,2,6,1,7,0,3,3,-5,6,1,-4,4,0,-1,-9,13,1,-4,3,-1,0,1,1,1,1,-1,6,-1
KR_6753511104,420,-3,-49,-14,-6,-2,2,0,1,2,3,-3,5,2,5,6,11,-7,7,0,0,-10,9,1,-5,4,-4,0,-1,1,-1,-1,-1,4,-1
KR_6765202759,420,1,16,12,-2,1,1,2,-1,1,0,1,0,1,-4,8,4,1,0,1,0,-5,4,1,-7,6,2,0,-1,-1,-1,-1,-1,2,-1
KR_6728393775,420,-4,-111,-17,0,0,0,0,4,0,4,-1,3,2,-2,3,1,-1,1,0,0,1,68,-2,-4,6,0,0,-1,-1,-1,-1,1,2,-1
KR_6763766133,420,0,-37,0,-7,2,1,3,-1,2,1,-2,3,1,-4,4,0,-2,2,0,0,-9,-3,4,-7,3,-4,0,0,-1,1,-1,-1,5,-1
KR_6751741898,420,-3,-33,-8,-10,-6,8,2,1,1,2,-4,6,2,1,4,5,-2,2,0,0,-11,-5,-3,-3,6,4,0,-2,-1,-1,-1,-1,6,-1
KR_6752902571,420,-3,4,-16,-12,-3,6,3,0,1,1,-10,10,0,0,4,4,1,0,1,0,-7,-1,-1,-3,4,-2,0,-2,1,-1,-1,-1,2,-1
KR_6724675310,420,-2,-38,20,-4,0,1,1,3,3,6,-2,4,2,-5,6,1,0,3,3,0,-12,-66,0,-7,7,-1,0,-1,0,-1,-1,-1,0,-1
KR_6751790648,420,0,43,-10,-2,4,1,5,-3,7,4,-5,6,1,2,2,4,0,3,3,0,3,-4,-2,-2,4,0,0,0,-1,0,0,-1,5,-1
KR_6740024757,420,-11,-108,-99,-20,-1,1,0,-5,6,1,-8,8,0,-5,5,0,-1,1,0,-3,-21,-44,-7,-3,10,15,0,-2,-1,-1,-1,-1,4,-1
KR_6754072780,420,-2,-42,-6,-3,-3,5,2,4,0,4,-2,3,1,-1,1,0,-1,1,0,0,-3,-10,0,-4,4,-1,0,-1,-1,-1,-1,1,4,-1
KR_6761862178,420,-5,-84,4,-11,-5,5,0,-3,4,1,-1,1,0,-1,4,3,-1,1,0,0,-4,-9,-3,-2,5,3,0,-1,-1,-1,-1,-1,3,-1
KR_6766941569,420,0,47,3,5,0,2,2,-2,4,2,1,2,3,5,0,5,1,2,3,0,0,0,2,-5,3,3,0,1,-1,1,1,1,2,-1
KR_6699743832,420,-2,2,-25,4,-2,3,1,5,1,6,4,1,5,0,2,2,-3,3,0,-1,5,6,-1,-5,6,2,0,2,1,1,1,-1,1,-1
KR_6762476492,420,-1,18,17,-2,1,0,1,3,2,5,-4,5,1,0,2,2,-2,2,0,0,2,53,8,-8,0,-26,0,0,1,-1,0,1,2,-1
KR_6726457207,440,-4,-13,32,-6,-5,6,1,-5,5,0,3,0,3,0,4,4,1,0,1,0,-2,5,4,-7,3,-4,0,2,1,1,1,1,3,-1
KR_6766846546,420,-3,-2,-1,-8,-2,3,1,-6,6,0,1,3,4,-2,3,1,1,0,1,0,-8,-24,-4,-5,9,-1,0,-1,-1,1,-1,1,4,-1
KR_6661973631,420,-2,-8,-28,-4,2,0,2,-2,3,1,-4,4,0,-1,5,4,1,1,2,0,-8,8,-1,-6,7,-6,0,0,-1,1,0,-1,5,-1
KR_6768731448,420,-4,-42,-32,-6,-1,2,1,-5,6,1,-2,4,2,2,3,5,0,1,1,0,-11,-6,-3,-6,9,1,0,1,-1,1,-1,-1,3,-1
KR_6764011920,420,1,40,36,-4,-1,2,1,-2,4,2,0,4,4,-2,3,1,1,1,2,0,-3,-3,-3,-4,7,0,0,0,-1,1,0,-1,3,-1
KR_6759171690,420,-1,17,-1,-1,-1,2,1,0,1,1,-2,2,0,1,1,2,1,1,2,0,1,-4,-3,-2,5,2,0,0,-1,1,0,1,1,-1
KR_6708408965,420,-2,-72,5,-4,0,1,1,4,0,4,-4,6,2,-1,4,3,-3,7,4,-1,-7,231,-4,-3,7,-2,0,0,1,1,1,-1,5,-1
KR_6748111905,420,-2,34,-8,-9,-2,2,0,0,2,2,-3,4,1,-3,3,0,-1,1,0,0,-14,-5,-1,-4,5,1,0,-1,-1,-1,-1,-1,4,-1
KR_6756773642,420,0,-33,26,-7,-5,5,0,3,2,5,-3,4,1,-2,5,3,0,0,0,0,-7,-7,-4,-3,7,0,0,-1,-1,-1,-1,-1,4,-1
KR_6755998735,420,0,50,4,1,-5,6,1,0,1,1,0,1,1,4,1,5,2,0,2,1,1,-18,-2,-5,7,-2,0,0,1,-1,1,1,5,-1
KR_6769186237,420,-2,-7,-8,-3,-4,5,1,-1,3,2,5,0,5,-3,3,0,0,1,1,0,-5,1,3,-9,6,-3,0,-1,1,-1,-1,1,5,-1
KR_6653595580,420,1,60,-8,-2,2,1,3,1,3,4,-1,1,0,0,3,3,-4,4,0,0,-5,5,4,-10,6,-1,0,0,-1,1,0,-1,4,-1
KR_6764860023,440,-2,-62,4,-1,-3,3,0,-1,4,3,1,1,2,1,1,2,1,0,1,0,8,7,0,-7,7,2,0,-2,-1,-1,-1,-1,3,-1
KR_6694537643,420,1,-25,19,3,-3,5,2,1,1,2,-3,3,0,4,0,4,4,0,4,0,7,6,2,-5,3,1,0,-2,1,-1,-1,1,1,-1
KR_6739741299,420,-7,-98,-28,-18,-3,3,0,-4,6,2,-2,2,0,-5,6,1,-4,5,1,0,-15,103,1,-8,7,-6,0,-2,-1,-1,-1,-1,3,-1
KR_6657255146,420,-2,47,0,-7,0,1,1,-1,3,2,2,0,2,-6,6,0,-2,3,1,0,-13,-119,1,-6,5,1,0,-1,-1,-1,-1,-1,5,-1
KR_6765030441,420,-2,-19,35,-9,0,1,1,-2,2,0,-6,6,0,-2,2,0,1,0,1,0,-10,37,1,-5,4,-4,0,-1,1,-1,-1,-1,5,-1
KR_6756531413,420,-1,-3,20,-2,-1,2,1,1,3,4,-4,5,1,2,1,3,0,1,1,0,-2,-2,-1,-7,8,-1,0,1,1,1,1,1,3,-1
KR_6632453043,420,-3,-59,-7,-9,-5,5,0,-3,7,4,1,3,4,-3,5,2,1,0,1,0,3,2,-3,-3,6,1,0,-1,-1,-1,-1,-1,4,-1
KR_6751858650,420,0,22,-32,2,1,2,3,0,2,2,-4,4,0,4,3,7,1,0,1,0,9,0,-1,-6,7,0,0,-2,1,-1,-1,1,4,-1
KR_6766283389,420,-4,-46,0,-11,-1,2,1,-3,3,0,-1,3,2,-4,5,1,-2,3,1,0,-14,-32,3,-9,6,-4,0,-2,-1,-1,-1,-1,3,-1
KR_6728390602,440,-1,7,-20,-3,-1,3,2,-4,4,0,1,1,2,-2,4,2,3,1,4,0,-5,8,0,-5,5,1,0,-1,-1,1,-1,-1,2,-1
KR_6758058056,420,-1,23,25,-4,4,1,5,-3,4,1,3,0,3,-3,7,4,-5,6,1,-1,-1,-10,0,-6,6,0,0,0,-1,1,1,1,2,-1
KR_6674494453,440,0,26,-12,-6,4,0,4,-5,6,1,-4,4,0,0,1,1,-1,1,0,0,-11,-44,-7,-1,8,3,0,-2,0,-1,-1,1,0,-1
KR_6766787788,420,-4,-23,-43,-9,1,1,2,-4,7,3,-1,3,2,-2,6,4,-3,3,0,0,-15,-36,5,-8,3,-3,0,-4,-1,-1,-1,-1,5,-1
KR_6755508055,440,5,68,8,16,5,0,5,3,0,3,3,2,5,0,2,2,5,0,5,0,20,-17,0,-8,8,27,0,0,1,0,1,1,3,-1
KR_6721208190,420,-1,-13,-7,2,1,3,4,4,0,4,-5,7,2,-1,4,3,3,0,3,0,-1,-11,-3,-4,7,4,0,-1,-1,-1,-1,1,6,-1
KR_6768754068,420,1,-17,45,2,-2,4,2,2,2,4,-2,3,1,2,2,4,2,0,2,1,-3,-2,-4,-5,9,3,0,0,1,1,0,1,4,-1
KR_6739227481,420,-1,8,-36,-9,0,1,1,-3,4,1,1,0,1,-4,5,1,-3,4,1,0,-11,-19,-11,-2,13,4,0,-1,-1,-1,-1,-1,6,-1
KR_6745317267,420,0,-13,-16,4,-1,2,1,1,1,2,-2,4,2,4,1,5,2,1,3,0,4,2,1,-8,7,2,0,2,1,-1,1,1,3,-1
KR_6767028721,420,-3,24,-9,-10,-3,3,0,-5,5,0,-6,9,3,1,0,1,3,0,3,0,-11,-23,-7,-6,13,-3,0,-1,1,-1,-1,-1,6,-1
KR_6738358467,440,1,72,-13,8,2,2,4,-1,3,2,3,2,5,2,1,3,2,0,2,1,4,0,2,-7,5,0,0,1,1,-1,1,-1,2,-1
KR_6756783444,420,-2,-57,48,-7,-2,3,1,-2,4,2,0,3,3,1,1,2,-4,4,0,0,-5,128,-1,-2,3,0,0,0,1,1,0,1,4,-1
KR_6756538443,420,0,-23,21,-4,2,1,3,-3,4,1,-2,5,3,0,2,2,-1,1,0,-1,0,-9,-2,-6,8,5,0,0,-1,-1,0,-1,6,-1
KR_6690655710,420,-1,-58,0,-1,3,2,5,0,1,1,0,1,1,-4,4,0,0,0,0,0,-4,-4,-4,-4,8,-2,0,0,1,-1,0,1,6,-1
KR_6767130859,420,-2,-61,6,-5,2,3,5,-4,7,3,-1,3,2,-1,1,0,-1,1,0,0,-9,-2,1,-7,6,-12,0,-1,-1,-1,-1,-1,4,-1
KR_6752284998,420,-7,-38,-28,-20,-1,2,1,-1,4,3,-8,11,3,-10,10,0,0,0,0,0,-20,302,-2,-3,5,0,0,-2,1,-1,-1,-1,1,-1
KR_6764941432,420,-1,-7,-9,3,2,0,2,3,1,4,0,0,0,-4,5,1,2,2,4,1,5,7,2,-8,6,-2,0,2,1,1,1,1,4,-1
KR_6754109961,420,-1,29,-8,-3,-3,3,0,-3,4,1,1,5,6,2,0,2,0,2,2,0,-7,8,3,-5,2,0,0,0,1,-1,0,1,6,-1
KR_6679181639,420,-5,-79,-36,-8,0,1,1,0,6,6,-6,8,2,-3,3,0,1,0,1,0,-9,14,0,-9,9,-13,0,-1,-1,1,-1,-1,3,-1
KR_6766978132,420,-1,-32,-5,-5,0,2,2,-2,2,0,0,4,4,-4,5,1,1,0,1,0,-4,8,3,-7,4,2,0,0,-1,1,-1,-1,3,-1
KR_6721184166,420,0,-8,13,-2,-6,6,0,-3,3,0,0,2,2,2,3,5,5,0,5,1,0,10,1,-5,4,1,0,-2,0,0,-1,1,0,-1
KR_6764625798,420,-2,-30,-8,-5,0,0,0,2,1,3,1,0,1,-2,4,2,-6,6,0,0,-4,-121,1,-8,7,-3,0,-3,-1,-1,-1,-1,5,-1
KR_6763598363,420,-2,-8,-3,-2,-1,3,2,-2,5,3,2,1,3,-2,3,1,1,0,1,0,2,-5,3,-7,4,6,0,-2,-1,-1,-1,1,4,-1
KR_6691709903,420,1,41,3,-3,1,0,1,1,3,4,-5,6,1,1,2,3,-1,2,1,0,3,3,5,-11,6,0,0,-2,1,-1,-1,-1,3,-1
KR_6767097011,440,-2,-77,-1,4,3,1,4,1,0,1,1,1,2,3,4,7,-4,6,2,1,14,2,7,-9,2,1,0,0,1,-1,-1,1,4,-1
KR_6767086788,420,-2,-27,-13,-7,0,1,1,-3,3,0,-1,3,2,-3,3,0,0,0,0,0,-14,-1,2,-8,6,0,0,-2,-1,1,1,1,1,-1
KR_6730058041,420,2,-35,21,5,-2,4,2,2,1,3,1,1,2,3,0,3,1,0,1,0,8,143,-4,-3,7,7,0,0,0,-1,-1,-1,0,-1
KR_6765547585,420,1,20,1,5,-3,3,0,6,0,6,3,2,5,-3,3,0,2,0,2,0,5,-3,-2,-4,6,-2,0,0,1,1,0,-1,1,-1
KR_6753244785,420,-1,-17,-3,-3,-1,1,0,-5,5,0,3,1,4,0,4,4,0,0,0,0,-8,-31,0,-9,9,1,0,0,0,1,0,1,0,-1
KR_6734775552,420,-1,-15,8,-4,-1,3,2,-4,6,2,4,1,5,-2,3,1,-1,1,0,0,-14,1,2,-6,4,0,0,-1,-1,-1,-1,1,1,-1
KR_6746372260,420,-1,-21,-6,0,-1,2,1,-1,3,2,-1,2,1,2,3,5,1,1,2,0,1,106,-9,-2,11,9,0,-1,-1,0,-1,1,5,-1
KR_6693917485,420,-5,-29,-5,-9,-3,3,0,3,1,4,1,0,1,-9,9,0,-1,1,0,0,-7,-5,5,-8,3,1,0,-2,1,1,-1,-1,2,-1
KR_6704183586,420,1,-48,20,4,3,0,3,0,3,3,-1,2,1,1,1,2,1,0,1,0,8,-342,-1,-5,6,23,0,0,1,-1,0,-1,2,-1
KR_6739220501,420,-7,-118,16,-8,-6,6,0,-3,3,0,1,4,5,-2,3,1,2,0,2,0,-1,10,-6,-2,8,-2,0,-3,-1,-1,-1,-1,4,-1
KR_6738183348,420,2,-23,8,1,-2,5,3,0,1,1,0,4,4,3,3,6,0,1,1,-1,5,5,2,-5,3,0,0,-1,1,1,-1,-1,3,-1
KR_6690045825,420,-2,-40,14,-1,-3,5,2,0,1,1,-3,5,2,3,1,4,2,1,3,0,-4,-2,1,-7,6,-2,0,0,-1,1,-1,1,4,-1
KR_6750268029,420,0,-25,-8,-7,2,0,2,-1,1,0,-2,6,4,-6,7,1,0,1,1,0,-1,-46,2,-8,6,-9,0,-1,-1,-1,-1,-1,2,-1
KR_6735491647,420,-4,-87,35,-12,-2,2,0,1,5,6,-2,3,1,-6,6,0,-3,3,0,-1,-24,-7,-4,-8,12,-2,0,-2,-1,1,-1,-1,2,-1
KR_6661304942,420,-6,-56,1,-11,1,2,3,-9,11,2,0,2,2,-4,5,1,1,0,1,0,-15,-350,1,-7,6,-1,0,-2,-1,-1,-1,-1,4,-1
KR_6683184306,420,-7,-113,-43,-11,-1,3,2,-1,8,7,-3,4,1,-2,5,3,-4,5,1,0,-3,-45,3,-6,3,-3,0,-3,-1,-1,-1,-1,3,-1
KR_6750798810,420,-4,-61,1,-4,-4,4,0,0,3,3,2,1,3,3,3,6,-5,5,0,1,-1,-3,4,-8,4,-4,0,-2,0,-1,-1,-1,0,-1
KR_6724399379,420,-1,19,24,0,5,0,5,-5,6,1,6,0,6,-2,3,1,-4,6,2,-2,-9,-11,-6,-6,12,3,0,0,1,-1,1,-1,1,-1
KR_6629385690,420,3,52,-16,7,-1,2,1,2,2,4,3,1,4,2,2,4,1,0,1,0,6,-78,5,-8,3,-6,0,0,-1,1,1,-1,1,-1
KR_6602807228,420,-3,-89,13,-10,-4,4,0,-2,2,0,-4,5,1,2,1,3,-2,2,0,0,-11,-8,-2,-6,8,1,0,-2,1,-1,-1,-1,2,-1
KR_6768650935,440,2,0,-31,6,2,0,2,3,0,3,0,0,0,-3,6,3,4,0,4,0,13,8,-2,-3,5,2,0,0,1,-1,-1,1,4,-1
KR_6768635467,420,0,65,-31,3,1,0,1,2,1,3,1,1,2,-2,4,2,1,0,1,0,0,-5,4,-10,6,-1,0,0,1,-1,1,1,2,-1
KR_6728500303,440,-2,-49,-38,-6,0,3,3,-3,6,3,-1,4,3,0,1,1,-2,3,1,-1,-8,-9,-2,-4,6,-2,0,1,-1,1,1,-1,1,-1
KR_6765120986,420,0,-9,0,3,3,1,4,0,1,1,-2,3,1,3,2,5,-1,1,0,1,7,14,-2,-2,4,-1,0,0,-1,-1,0,1,5,-1
KR_6765661799,420,4,76,8,3,-1,3,2,-2,4,2,3,3,6,4,2,6,-1,1,0,0,3,-5,-3,-5,8,6,0,2,0,1,1,1,0,-1
KR_6761133126,420,-2,-14,21,-5,-2,2,0,1,2,3,-5,7,2,-1,2,1,2,0,2,0,-5,6,-3,-6,9,-4,0,0,-1,-1,0,-1,4,-1
KR_6763581230,420,-2,-13,9,-4,2,0,2,4,5,9,-10,11,1,-1,2,1,1,0,1,0,-1,-22,2,-6,4,-1,0,0,1,-1,-1,-1,4,-1
KR_6734481906,420,-2,5,10,-9,-1,4,3,-2,4,2,-4,6,2,-1,2,1,-1,1,0,0,-16,2,-1,-4,5,-4,0,0,1,1,1,-1,4,-1
KR_6762411417,420,1,-63,-8,-3,0,1,1,1,3,4,-1,4,3,-3,4,1,0,0,0,0,-1,3,-7,-2,9,-5,0,-1,-1,-1,-1,-1,5,-1
KR_6653599432,420,0,29,-16,4,1,1,2,0,1,1,0,5,5,2,1,3,1,0,1,0,9,-104,-2,-5,7,8,0,-1,1,-1,-1,1,6,-1
KR_6768300993,420,-2,-66,17,-9,-1,2,1,-1,1,0,-6,6,0,-1,2,1,0,0,0,0,-12,-2,-2,-5,7,0,0,-2,-1,-1,-1,1,6,-1
KR_6766242010,420,0,-37,3,-5,7,0,7,-6,6,0,-2,4,2,-4,4,0,0,1,1,0,-13,-28,-1,-3,4,-3,0,0,-1,1,1,-1,2,-1
KR_6766445255,420,-2,-43,-7,-10,-3,4,1,-1,3,2,-6,9,3,0,3,3,0,1,1,1,-5,-2,-4,-3,7,2,0,-1,-1,0,-1,1,3,-1
KR_6739850225,420,0,-29,13,-1,0,1,1,3,0,3,2,3,5,-1,5,4,-5,5,0,-1,-3,21,0,-8,8,-9,0,1,-1,1,1,-1,5,-1
KR_6734394561,420,-1,-43,24,-10,2,1,3,-2,5,3,-1,1,0,-3,4,1,-6,6,0,0,-18,7,-1,-6,7,-4,0,-1,-1,-1,-1,-1,6,-1
KR_6675006053,420,-2,-107,-14,-7,-2,3,1,-3,5,2,5,1,6,-6,7,1,-1,1,0,-1,-9,52,-2,-3,5,2,0,-3,-1,1,-1,-1,1,-1
KR_6761685804,440,-2,-53,22,-8,-2,3,1,-4,8,4,4,2,6,-5,6,1,-1,1,0,0,-8,-1,-1,-7,8,-1,0,-2,1,-1,-1,-1,3,-1
KR_6753092583,420,3,24,-5,5,0,2,2,2,1,3,1,2,3,0,2,2,2,1,3,0,2,63,1,-7,6,2,0,0,1,1,1,1,5,-1
KR_6723577033,420,-1,2,3,-12,3,1,4,-7,7,0,-3,3,0,-3,6,3,-2,2,0,-5,-26,-6,4,-6,2,-5,0,-2,-1,-1,-1,-1,2,-1
KR_6763517763,420,-1,-2,-32,0,-2,2,0,7,1,8,3,2,5,-5,8,3,-3,3,0,0,1,-4,-8,-3,11,2,0,0,1,1,-1,-1,2,-1
KR_6732402696,420,-1,-10,-3,-8,-8,10,2,1,1,2,-2,3,1,1,2,3,0,1,1,-1,-8,-8,0,-5,5,3,0,-1,-1,0,-1,-1,6,-1
KR_6766912084,420,-1,30,-11,-5,-2,2,0,0,5,5,-8,9,1,5,2,7,0,1,1,-1,5,0,0,-11,11,-6,0,0,-1,-1,0,-1,1,-1
KR_6728912960,420,-4,-42,-17,-8,2,0,2,1,3,4,-3,7,4,-7,9,2,-1,1,0,0,-9,-15,-3,-6,9,-2,0,0,-1,1,1,1,2,-1
KR_6761188541,440,0,-29,-4,-1,1,1,2,-2,2,0,-2,2,0,1,1,2,1,0,1,0,-1,3,5,-11,6,2,0,0,1,-1,0,-1,4,-1
KR_6696627188,420,-4,-62,-16,-10,-2,3,1,2,2,4,-5,6,1,-5,5,0,0,2,2,0,-5,0,-3,-4,7,-2,0,0,-1,1,0,-1,4,-1
KR_6750174124,420,-4,-53,-47,-3,-2,2,0,3,3,6,-2,3,1,-2,4,2,0,1,1,0,-2,-9,3,-6,3,1,0,-2,1,1,-1,1,2,-1
KR_6764107822,420,-2,21,23,-5,-2,4,2,-3,3,0,2,3,5,-3,3,0,1,0,1,0,-9,10,-3,-9,12,-7,0,-1,-1,-1,-1,-1,1,-1
KR_6765138641,420,0,22,15,1,-1,2,1,4,1,5,-3,6,3,2,1,3,-1,2,1,0,-4,-19,0,-6,6,4,0,-1,-1,1,-1,-1,1,-1
KR_6767489243,420,0,26,-22,4,2,2,4,0,1,1,1,2,3,0,1,1,1,0,1,0,3,-4,5,-9,4,0,0,1,1,-1,1,1,1,-1
KR_6740645482,420,-4,-111,-4,-10,1,2,3,-4,6,2,-3,5,2,-4,4,0,0,2,2,0,-5,31,-1,-3,4,4,0,-2,1,-1,-1,-1,5,-1
KR_6759265401,420,-1,16,-20,-2,-1,1,0,-2,3,1,1,6,7,-2,4,2,2,1,3,1,8,80,-3,-1,4,-21,0,-1,1,1,-1,1,5,-1
KR_6763560572,420,-2,73,-8,-4,-1,5,4,-1,2,1,-2,6,4,0,4,4,0,1,1,0,0,-4,1,-4,3,0,0,1,-1,1,1,1,2,-1
KR_6758314044,420,-2,-48,29,4,-2,5,3,-1,3,2,0,2,2,5,0,5,2,0,2,0,7,-2,-3,-1,4,3,0,1,1,1,1,-1,4,-1
KR_6749307205,420,1,44,-8,-1,-1,4,3,-2,2,0,1,3,4,-2,7,5,3,1,4,0,-7,0,1,-8,7,1,0,0,1,1,0,-1,5,-1
KR_6729046634,420,-5,-70,-21,-15,-4,7,3,1,7,8,-9,9,0,-1,2,1,-2,2,0,-1,-10,1,1,-3,2,-6,0,-3,1,-1,-1,-1,1,-1
KR_6764644978,440,-1,-33,13,-1,0,1,1,1,2,3,0,1,1,-3,5,2,1,2,3,-3,-2,-23,-4,-5,9,0,0,1,-1,1,1,1,5,-1
KR_6748897261,420,1,51,-45,7,2,1,3,4,3,7,1,1,2,-2,5,3,2,0,2,0,7,39,3,-7,4,-21,0,2,-1,1,1,1,6,-1
KR_6729112787,420,1,-54,-10,-1,-2,4,2,0,6,6,0,5,5,0,2,2,1,1,2,-3,0,-12,0,-6,6,5,0,-2,-1,-1,-1,-1,6,-1
KR_6747510488,420,0,7,20,-7,0,0,0,-3,4,1,0,2,2,-3,3,0,-1,1,0,0,-10,2,-3,-3,6,-4,0,0,1,-1,-1,-1,6,-1
KR_6746150293,420,-5,-46,10,-10,-1,2,1,-3,5,2,-3,6,3,-1,2,1,-2,2,0,0,-9,41,5,-12,7,-10,0,-1,-1,-1,-1,-1,3,-1
KR_6730764251,440,-1,12,-14,-2,5,1,6,-4,4,0,-2,4,2,-2,6,4,1,0,1,0,-4,2,1,-9,8,-2,0,1,0,1,1,1,0,-1
KR_6725387133,420,1,4,-14,0,1,1,2,2,1,3,-9,10,1,4,0,4,2,0,2,0,1,67,0,-2,2,-4,0,-1,-1,1,-1,-1,5,-1
KR_6765675536,420,-4,23,-29,-9,-1,2,1,-7,7,0,-1,3,2,1,1,2,-1,1,0,0,-5,-32,3,-5,2,27,0,0,-1,-1,0,1,3,-1
KR_6727504416,420,-1,-56,-37,-5,0,2,2,-5,6,1,4,1,5,-2,5,3,-2,2,0,0,-12,-3,2,-5,3,0,0,-1,-1,1,-1,1,5,-1
KR_6757361610,420,-3,-18,-13,-4,-2,3,1,2,1,3,-5,5,0,2,4,6,-1,1,0,0,3,-37,-1,-5,6,3,0,-1,-1,1,1,-1,4,-1
KR_6761392232,440,5,17,16,12,1,2,3,0,4,4,7,0,7,0,4,4,4,2,6,1,6,4,-1,-3,4,-3,0,2,1,-1,1,1,1,-1
KR_6683959728,420,-2,10,-15,-8,-1,1,0,-5,8,3,-1,1,0,0,4,4,-1,2,1,0,-13,-9,-7,-4,11,6,0,0,-1,-1,0,-1,3,-1
KR_6761823294,420,-4,-49,3,-17,-2,4,2,1,1,2,-3,4,1,-11,11,0,-2,2,0,0,-25,4,-2,-4,6,1,0,-2,-1,-1,-1,-1,3,-1
KR_6732552555,420,2,10,8,2,-1,3,2,-1,4,3,-1,3,2,3,1,4,2,0,2,4,12,25,-1,-6,7,0,0,1,1,1,1,1,5,-1
KR_6763662417,440,-4,-65,-21,-5,-3,3,0,3,2,5,-4,5,1,-1,4,3,0,0,0,0,2,-5,-5,-3,8,5,0,0,-1,-1,0,1,2,-1
KR_6766635483,420,-4,-15,-45,-6,-3,5,2,-3,5,2,-2,2,0,-1,1,0,3,0,3,0,-5,6,-3,-4,7,3,0,-3,1,-1,-1,-1,5,-1
KR_6743277372,420,4,41,18,2,0,1,1,3,1,4,0,3,3,-1,2,1,0,1,1,0,3,44,5,-11,6,0,0,1,1,1,1,1,3,-1
KR_6763745915,420,-2,-12,-25,3,0,1,1,1,4,5,-2,7,5,5,1,6,-1,2,1,0,0,18,4,-8,4,0,0,3,1,1,1,1,4,-1
KR_6766443441,420,-1,28,-28,-7,0,3,3,3,1,4,-5,8,3,-2,4,2,-3,5,2,1,-5,11,5,-10,5,0,0,0,1,1,0,1,6,-1
KR_6738512631,440,-3,-83,-41,-5,-2,5,3,3,1,4,-1,3,2,-5,7,2,0,1,1,1,3,-5,0,-2,2,-5,0,-1,-1,1,-1,1,3,-1
KR_6762263252,420,0,-7,0,-3,-3,3,0,4,1,5,-3,4,1,-2,3,1,1,1,2,-1,0,-20,-2,-5,7,3,0,0,0,-1,0,-1,0,-1
KR_6763720791,420,4,-6,8,3,1,3,4,4,2,6,1,2,3,-3,4,1,0,1,1,1,0,2,-7,-6,13,3,0,0,-1,1,1,1,2,-1
KR_6767194296,420,-3,-5,-8,-6,-2,2,0,-2,4,2,-1,2,1,-1,2,1,0,1,1,0,-2,-110,4,-6,2,-3,0,-2,-1,-1,-1,-1,4,-1
KR_6765324841,420,-2,16,-13,-11,-6,8,2,-3,4,1,0,1,1,-1,1,0,-1,1,0,0,-17,-6,-2,-6,8,1,0,-1,1,-1,-1,-1,4,-1
KR_6759576296,420,-1,55,12,-3,2,2,4,-1,2,1,0,2,2,-4,4,0,0,0,0,0,-7,-1,-1,-8,9,3,0,-1,1,-1,-1,1,6,-1
KR_6708338625,420,-4,-8,-33,-10,-1,1,0,-4,5,1,-3,4,1,-1,3,2,-1,1,0,0,-18,6,3,-10,7,-3,0,0,-1,1,0,-1,6,-1
KR_6757073821,420,0,65,-13,-6,1,1,2,-8,10,2,1,1,2,-1,5,4,1,0,1,0,-9,-8,1,-8,7,2,0,0,1,-1,-1,-1,3,-1
KR_6767225185,420,-4,-25,-1,-10,-4,5,1,-3,4,1,-7,8,1,4,3,7,0,0,0,0,-9,4,1,-6,5,2,0,-1,1,-1,-1,-1,2,-1
KR_6768732372,420,-2,-17,-1,-6,-3,6,3,-2,7,5,-1,1,0,-1,1,0,1,0,1,0,-2,-17,-7,-5,12,5,0,-2,-1,-1,-1,1,6,-1
KR_6694875699,420,-3,-8,1,-6,0,1,1,1,3,4,-3,4,1,-4,5,1,0,1,1,0,-6,28,-1,-9,10,1,0,0,-1,1,-1,-1,2,-1
KR_6763620094,420,0,-11,2,0,-2,2,0,1,1,2,1,0,1,0,2,2,0,2,2,0,2,-9,-2,-5,7,-1,0,-1,1,-1,-1,-1,2,-1
KR_6763695781,420,-5,-97,-13,-10,-2,2,0,-2,3,1,-6,7,1,-1,2,1,1,1,2,0,-7,5,1,-7,6,-3,0,0,-1,1,-1,-1,5,-1
KR_6757656168,420,-4,-2,-13,-4,-2,5,3,-2,3,1,0,3,3,3,3,6,-3,6,3,-2,-12,-6,0,-6,6,3,0,0,-1,1,1,-1,1,-1
KR_6753511385,420,-5,-15,-49,-2,1,1,2,-2,2,0,-2,3,1,1,8,9,0,0,0,-1,-2,20,1,-7,6,0,0,-1,0,-1,-1,-1,0,-1
KR_6766376432,420,-3,-37,13,-4,-1,3,2,1,4,5,-3,3,0,-3,5,2,2,1,3,0,-2,4,1,-5,4,-4,0,-1,1,-1,-1,1,6,-1
KR_6768169934,420,1,-36,0,-4,0,2,2,-4,7,3,-2,4,2,2,1,3,0,1,1,0,-3,-2,-3,-4,7,1,0,-2,1,0,-1,-1,4,-1
KR_6745372933,420,1,-3,-28,1,1,0,1,-2,5,3,-2,3,1,4,1,5,0,2,2,0,3,9,-2,-5,7,2,0,0,-1,1,-1,-1,4,-1
KR_6727499659,420,-2,-1,-8,-7,2,0,2,-2,3,1,-3,4,1,-3,3,0,-1,2,1,0,-6,-26,-2,-4,6,-2,0,-1,1,1,1,-1,4,-1
KR_6767021136,420,-2,36,-28,-9,0,2,2,-3,3,0,-5,6,1,0,1,1,-1,1,0,0,-12,-50,0,-4,4,22,0,0,-1,-1,0,1,5,-1
KR_6744896650,420,2,25,-4,-4,0,1,1,0,2,2,-3,3,0,-2,4,2,1,1,2,0,-5,10,-2,-6,8,2,0,1,1,-1,1,-1,2,-1
KR_6767792778,420,-3,-65,-20,-4,-2,2,0,2,1,3,-3,6,3,1,2,3,-2,2,0,0,0,5,-2,-7,9,0,0,-1,-1,-1,-1,1,5,-1
KR_6734340090,440,-4,-51,-39,-7,-1,1,0,-4,6,2,-3,3,0,2,0,2,-1,1,0,0,-1,-105,0,-6,6,1,0,0,0,-1,0,1,0,-1
KR_6765048506,420,-7,-41,-37,-14,-5,5,0,-2,5,3,-4,5,1,-2,4,2,-1,1,0,0,-2,31,4,-8,4,-6,0,-1,-1,-1,-1,-1,3,-1
KR_6759657048,420,1,-59,24,2,-2,4,2,3,0,3,0,1,1,-1,2,1,2,1,3,0,4,4,4,-7,3,-4,0,-1,1,-1,-1,-1,4,-1
KR_6718193627,420,-3,24,-18,-8,-1,2,1,-3,7,4,-1,3,2,0,3,3,-3,5,2,0,-4,16,0,-7,7,3,0,1,-1,1,1,-1,4,-1
KR_6762866509,420,-4,-20,-5,-12,-3,3,0,-1,4,3,-2,3,1,-5,9,4,-1,3,2,0,-11,-122,-1,-7,8,-1,0,-1,-1,-1,-1,-1,6,-1
KR_6767567375,420,2,-21,-4,8,2,1,3,-1,4,3,0,1,1,4,2,6,3,0,3,0,6,-8,0,-4,4,4,0,1,-1,-1,1,1,2,-1
KR_6762251805,440,-2,-8,-24,-6,-2,4,2,-4,5,1,0,2,2,-1,4,3,1,0,1,-1,-8,-3,-2,-4,6,-1,0,0,-1,-1,-1,-1,4,-1
KR_6768054762,420,-2,-31,0,-5,2,0,2,0,5,5,-4,5,1,-1,2,1,-2,2,0,0,-2,-21,6,-8,2,-3,0,0,-1,1,0,-1,3,-1
KR_6617114863,420,0,-1,4,5,-1,2,1,6,0,6,1,1,2,-2,5,3,1,0,1,0,9,6,2,-6,4,-1,0,0,-1,1,0,1,3,-1
KR_6704309547,420,-3,-31,-6,-7,0,3,3,-6,6,0,1,3,4,1,4,5,-3,3,0,0,-12,5,1,-5,4,-3,0,-1,1,-1,-1,1,2,-1
KR_6729954115,440,0,-65,-19,0,-6,7,1,2,2,4,3,1,4,1,2,3,0,0,0,-1,11,50,1,-7,6,-14,0,-1,1,-1,-1,-1,1,-1
KR_6749599811,420,0,-36,-7,-4,0,2,2,-5,6,1,3,3,6,-1,4,3,-1,2,1,0,-8,9,-2,-2,4,-3,0,0,-1,-1,0,1,5,-1
KR_6728547057,420,0,-47,-4,-4,0,1,1,-2,5,3,1,2,3,-2,3,1,-1,2,1,0,-6,12,4,-12,8,2,0,-1,-1,-1,-1,-1,1,-1
KR_6681889951,420,-1,-66,-22,-4,-3,3,0,-2,5,3,4,0,4,-2,4,2,-1,2,1,0,-7,-44,-6,-3,9,-5,0,-2,-1,-1,-1,-1,1,-1
KR_6762389389,420,0,27,2,-3,-1,2,1,-1,6,5,-1,2,1,-2,6,4,2,0,2,1,-7,8,-3,-2,5,3,0,0,-1,-1,-1,1,3,-1
KR_6755846601,420,4,32,39,11,0,3,3,6,2,8,1,1,2,0,6,6,4,0,4,1,10,-3,0,-5,5,-3,0,-2,-1,-1,-1,1,2,-1
KR_6614698512,440,-3,-29,-16,-4,0,1,1,2,4,6,-1,3,2,-5,5,0,0,1,1,0,-1,-3,2,-7,5,-2,0,0,-1,1,-1,-1,2,-1
KR_6726801585,420,-6,-38,-7,-9,-5,6,1,-2,4,2,1,3,4,-4,5,1,1,1,2,-1,-16,212,1,-5,4,-4,0,-2,-1,-1,-1,-1,4,-1
KR_6696970507,420,0,69,-12,3,1,3,4,-2,5,3,3,3,6,4,1,5,-3,3,0,0,0,-10,1,-7,6,6,0,0,1,-1,-1,1,1,-1
KR_6732998660,420,-4,-38,5,-3,1,2,3,-4,5,1,0,1,1,1,4,5,-1,2,1,0,-6,7,3,-7,4,1,0,0,1,-1,0,1,4,-1
KR_6759116692,420,-4,-58,-3,-12,-6,7,1,0,1,1,0,2,2,-3,3,0,-3,3,0,-1,-5,-7,-5,-3,8,0,0,-1,-1,-1,-1,-1,4,-1
KR_6727527239,420,2,30,0,5,3,1,4,1,3,4,-1,3,2,1,2,3,1,0,1,0,15,12,-1,-5,6,0,0,0,-1,-1,0,1,5,-1
KR_6743484187,420,-4,19,-33,-8,-2,4,2,-1,2,1,-4,5,1,-2,5,3,1,0,1,0,-2,-2,2,-4,2,4,0,0,-1,1,0,-1,6,-1
KR_6654802166,420,-2,27,28,-2,3,3,6,3,3,6,-2,3,1,-1,3,2,-5,5,0,0,-10,32,2,-7,5,1,0,0,1,-1,-1,1,6,-1
KR_6767422983,420,0,3,-24,-7,0,1,1,-4,4,0,-5,6,1,3,2,5,-1,1,0,0,-1,-37,0,-4,4,-2,0,0,-1,1,0,1,2,-1
KR_6751822633,420,-2,-108,-6,-5,0,1,1,-1,3,2,-1,3,2,-1,3,2,-2,3,1,0,-6,2,3,-11,8,-2,0,1,-1,1,-1,-1,4,-1
KR_6764329667,420,-1,-29,15,2,-2,4,2,-2,2,0,1,1,2,4,2,6,1,0,1,0,3,39,0,-7,7,1,0,0,1,-1,-1,1,3,-1
KR_6765339460,420,-4,-78,-21,-3,-5,6,1,4,5,9,1,2,3,-4,4,0,1,3,4,1,2,5,2,-8,6,-7,0,-1,1,-1,-1,1,6,-1
KR_6745216703,420,-2,-27,-10,-8,0,1,1,-8,8,0,0,5,5,-2,2,0,2,1,3,1,-13,10,-8,-3,11,0,0,-1,-1,-1,-1,1,2,-1
KR_6730859809,420,-1,18,-11,-9,-4,4,0,-2,4,2,0,2,2,-2,3,1,-1,2,1,0,-12,1,-1,-6,7,1,0,-1,-1,-1,-1,-1,4,-1
KR_6764895123,420,-2,-1,-19,-3,-1,2,1,0,1,1,-1,2,1,0,4,4,-1,1,0,-1,-6,3,1,-7,6,-7,0,-1,-1,-1,-1,-1,4,-1
KR_6746966088,420,-5,-32,-2,-8,-1,2,1,-6,6,0,3,0,3,-1,3,2,-3,3,0,0,-10,-3,2,-5,3,1,0,-1,-1,1,-1,1,6,-1
KR_6757282376,420,-4,-39,-41,-8,-3,4,1,-1,6,5,-1,2,1,-3,5,2,0,0,0,0,-9,1,-1,-4,5,-1,0,-1,-1,-1,-1,1,5,-1
KR_6753208165,440,-5,-23,-20,-9,-4,4,0,-6,7,1,1,2,3,-3,5,2,3,1,4,0,-13,-8,-2,-6,8,-2,0,-1,-1,-1,-1,1,1,-1
KR_6726158872,420,-8,-88,-31,-21,-10,10,0,-2,4,2,-4,4,0,-5,5,0,0,1,1,0,-14,-1,-3,-2,5,4,0,-2,-1,0,-1,-1,6,-1
KR_6727565665,420,2,-72,-16,6,5,0,5,2,2,4,5,1,6,-6,7,1,0,0,0,0,3,-1,2,-4,2,-1,0,1,1,1,1,1,6,-1
KR_6735235981,420,-2,-28,8,-1,-1,3,2,3,4,7,2,1,3,-3,4,1,-2,2,0,0,-4,-20,-2,-3,5,-3,0,0,-1,1,-1,-1,6,-1
KR_6750881765,420,-7,-104,-30,-6,3,1,4,-5,5,0,1,0,1,-4,4,0,-1,2,1,0,-12,-6,-5,-3,8,1,0,-4,-1,-1,-1,-1,6,-1
KR_6650057681,420,-4,-38,-11,-12,1,2,3,-7,7,0,-4,5,1,-3,4,1,1,1,2,1,-13,-16,-2,-7,9,0,0,-1,-1,-1,-1,1,6,-1
KR_6766129188,420,2,0,5,-2,0,0,0,-2,4,2,-2,2,0,2,6,8,0,1,1,0,-5,-13,1,-6,5,-2,0,0,-1,-1,-1,-1,4,-1
KR_6758242297,420,-2,-33,-13,-7,-1,2,1,0,1,1,0,1,1,-7,7,0,1,0,1,0,-3,18,-2,-5,7,-2,0,0,-1,-1,0,-1,6,-1
KR_6743503458,440,1,-9,-8,4,-3,3,0,11,0,11,2,1,3,1,1,2,-7,7,0,0,9,-27,3,-7,4,-3,0,-2,1,1,-1,-1,2,-1
KR_6686328782,420,-2,2,16,-5,1,3,4,-6,7,1,-4,6,2,4,0,4,0,0,0,0,-5,-3,-4,-6,10,2,0,2,-1,1,1,-1,6,-1
KR_6742053976,420,-1,-57,-16,-1,-1,1,0,0,1,1,2,3,5,1,0,1,-3,3,0,1,5,37,4,-11,7,-4,0,0,-1,-1,0,1,4,-1
KR_6763358193,440,-2,-58,-21,-4,1,1,2,1,2,3,-5,11,6,-2,4,2,1,0,1,-1,4,1,2,-7,5,-5,0,-2,0,-1,-1,-1,0,-1
KR_6616650734,420,-2,-34,-19,-5,1,1,2,2,1,3,-5,6,1,-2,3,1,-1,1,0,0,-10,-42,-3,-3,6,-5,0,0,-1,1,0,1,2,-1
KR_6598618195,420,-2,-26,0,-6,2,3,5,-3,4,1,-1,5,4,-3,4,1,-1,2,1,0,-7,1,2,-8,6,-2,0,-1,-1,1,1,1,3,-1
KR_6763225816,420,-4,-31,-10,-8,1,0,1,-2,4,2,-4,4,0,-1,3,2,-2,4,2,0,-10,-13,-9,-2,11,4,0,-2,-1,1,-1,-1,3,-1
KR_6727536139,420,-7,-110,-32,-15,-4,4,0,-2,4,2,-5,7,2,-4,6,2,0,1,1,-2,-9,-6,1,-6,5,-1,0,-1,1,-1,-1,-1,6,-1
KR_6701746661,420,-3,-23,-23,-2,-1,2,1,3,3,6,4,2,6,-5,7,2,-3,3,0,1,0,69,3,-7,4,0,0,-1,-1,-1,-1,1,1,-1
KR_6728592680,440,1,-12,24,-6,-1,3,2,-3,5,2,7,0,7,-1,2,1,-8,10,2,0,-7,4,0,-2,2,-3,0,0,-1,0,-1,-1,2,-1
KR_6719752052,420,-4,-20,-30,-9,-4,4,0,1,0,1,-3,4,1,-5,5,0,2,0,2,0,-8,-13,3,-8,5,3,0,-1,-1,-1,-1,-1,6,-1
KR_6768124365,420,-2,7,-38,-5,3,1,4,-4,6,2,-2,3,1,-3,4,1,1,0,1,0,-7,2,4,-6,2,-1,0,0,-1,-1,0,-1,4,-1
KR_6752231219,420,-1,-17,38,-4,-1,1,0,1,3,4,1,2,3,-2,4,2,-3,4,1,-3,-17,0,2,-7,5,1,0,0,-1,-1,-1,-1,3,-1
KR_6765230594,420,1,-58,24,-1,3,1,4,1,1,2,2,1,3,-6,7,1,-1,1,0,0,-6,-28,2,-8,6,1,0,0,-1,1,0,-1,1,-1
KR_6768011690,420,-3,-36,-29,1,-2,3,1,0,4,4,0,0,0,1,2,3,2,3,5,0,9,-33,1,-4,3,0,0,0,1,-1,-1,1,5,-1
KR_6621316264,420,0,-24,14,-3,-1,2,1,-3,4,1,0,2,2,1,2,3,0,1,1,0,-1,-5,-4,-4,8,1,0,-1,-1,1,-1,-1,2,-1
KR_6753172235,420,2,-16,-19,-5,-1,1,0,-5,6,1,3,0,3,-2,5,3,0,0,0,0,-12,-53,1,-9,8,-3,0,1,-1,1,1,1,1,-1
KR_6756146885,420,2,-29,-48,3,-2,3,1,2,4,6,-3,6,3,5,1,6,1,1,2,0,7,-1,0,-6,6,-2,0,0,1,-1,1,-1,5,-1
KR_6768806971,420,2,-11,8,3,5,1,6,1,2,3,-1,4,3,-2,3,1,0,1,1,0,-3,-1,-2,-5,7,-1,0,0,-1,1,0,-1,6,-1
KR_6745180699,420,1,-10,4,6,0,3,3,5,2,7,-1,2,1,6,2,8,-4,5,1,0,8,18,-2,-5,7,0,0,0,-1,1,1,1,5,-1
KR_6768846500,420,-4,-14,9,-7,-3,3,0,1,1,2,0,3,3,-4,6,2,-1,2,1,-1,-4,-5,1,-7,6,0,0,0,-1,-1,-1,-1,1,-1
KR_6767567833,420,1,-24,24,-8,-5,5,0,-2,4,2,4,1,5,-1,6,5,-4,5,1,0,-7,-1,0,-5,5,-6,0,-1,1,-1,-1,-1,3,-1
KR_6622305701,420,-3,-21,-1,-8,-3,3,0,-6,11,5,0,2,2,2,1,3,-1,2,1,0,-16,46,2,-10,8,-6,0,0,-1,-1,0,1,1,-1
KR_6702462786,420,1,0,3,-2,-2,3,1,1,4,5,0,2,2,-2,3,1,1,2,3,0,-5,-5,0,-8,8,-2,0,2,-1,1,1,-1,6,-1
KR_6737442926,420,1,-4,-23,1,1,1,2,1,2,3,0,2,2,-4,4,0,3,0,3,0,2,2,-1,-5,6,-4,0,0,-1,1,0,-1,3,-1
KR_6730098670,420,-5,-54,-12,-12,0,2,2,-4,6,2,-2,3,1,-3,6,3,-3,4,1,-2,-9,-2,0,-5,5,0,0,-1,-1,-1,-1,-1,4,-1
KR_6760183635,420,-4,-28,15,-8,-1,1,0,-5,5,0,-3,3,0,1,0,1,0,2,2,1,-10,3,2,-7,5,-3,0,-1,1,-1,-1,1,3,-1
KR_6639620066,420,-1,-10,17,-4,-1,2,1,1,5,6,0,1,1,-1,1,0,-3,4,1,0,-10,24,-8,-2,10,-2,0,-1,1,-1,-1,-1,4,-1
KR_6766076806,420,2,-68,4,2,-1,4,3,10,0,10,-5,6,1,-1,1,0,-1,2,1,-2,8,-1,2,-6,4,0,0,-1,-1,1,-1,-1,2,-1
KR_6763053851,420,1,-35,-31,1,0,4,4,1,2,3,-1,1,0,1,3,4,0,1,1,1,5,-11,3,-8,5,-1,0,-2,-1,-1,-1,1,5,-1
KR_6769188844,420,0,-24,-32,3,-1,2,1,2,2,4,-2,4,2,1,2,3,3,0,3,0,12,1,-2,-5,7,-3,0,-1,1,-1,-1,1,3,-1
KR_6769066550,420,1,67,8,-10,-3,4,1,-3,3,0,1,2,3,-3,6,3,-2,3,1,0,-14,36,-1,-3,4,0,0,1,-1,1,1,-1,2,-1
KR_6723286556,420,-2,-82,-19,0,2,0,2,1,3,4,-3,3,0,-2,6,4,2,0,2,0,-2,-48,-6,-1,7,20,0,-3,1,-1,-1,-1,5,-1
KR_6766705491,420,2,32,0,0,4,0,4,0,2,2,2,0,2,-6,7,1,0,0,0,0,4,19,-1,-5,6,2,0,2,-1,1,1,1,6,-1
KR_6768571397,420,-3,-7,-4,-10,-6,6,0,0,2,2,-1,3,2,-2,3,1,-1,2,1,0,-8,103,1,-6,5,-2,0,-1,-1,-1,-1,1,5,-1
KR_6738458301,440,0,61,-21,2,-1,1,0,0,1,1,0,1,1,2,3,5,1,0,1,0,8,-3,-4,-5,9,1,0,2,1,-1,1,1,3,-1
KR_6741448582,420,2,15,12,5,-3,3,0,3,2,5,2,2,4,3,1,4,0,1,1,0,9,-7,2,-6,4,-4,0,0,1,-1,1,-1,5,-1
KR_6750635764,420,-4,11,-24,-1,2,2,4,-5,5,0,0,0,0,3,0,3,-1,1,0,-1,-8,6,2,-7,5,-3,0,0,1,-1,0,-1,3,-1
KR_6768315605,420,-2,3,-14,-9,0,3,3,-1,3,2,-1,5,4,-5,9,4,-2,3,1,2,-2,-1,1,-7,6,-5,0,1,-1,-1,-1,1,5,-1
KR_6759970491,440,-4,23,2,-17,-5,7,2,-5,5,0,-2,3,1,-4,6,2,-1,1,0,0,-18,-12,-8,-2,10,1,0,0,-1,0,0,-1,3,-1
KR_6768124460,420,-2,2,-20,-12,-3,5,2,-1,3,2,-2,5,3,-3,4,1,-3,3,0,0,0,-49,1,-5,4,14,0,-1,-1,0,-1,1,4,-1
KR_6766058542,420,-1,20,-16,-5,0,2,2,0,2,2,1,6,7,-5,6,1,-1,2,1,0,-5,0,0,-6,6,3,0,-1,-1,-1,-1,-1,3,-1
KR_6732270349,420,-3,-85,-28,-5,-1,3,2,-1,5,4,-4,5,1,1,4,5,0,0,0,0,-5,4,3,-9,6,2,0,0,-1,-1,0,-1,5,-1
KR_6748423553,420,-4,10,-20,-6,1,1,2,3,2,5,-3,4,1,-6,6,0,-1,2,1,0,-8,-6,4,-5,1,-5,0,-1,-1,-1,-1,-1,2,-1
KR_6602759901,420,3,-11,-6,3,-1,3,2,1,0,1,2,5,7,0,5,5,1,0,1,0,3,45,2,-8,6,-2,0,-1,-1,1,-1,1,1,-1
KR_6761522855,420,0,42,-29,-2,-3,4,1,0,3,3,-3,4,1,5,1,6,-1,2,1,0,-2,3,0,-6,6,1,0,-1,1,-1,-1,-1,2,-1
KR_6716279585,440,-1,-66,-28,6,-1,1,0,0,0,0,4,1,5,4,0,4,-1,1,0,0,13,1,-3,-4,7,-3,0,-3,1,-1,-1,-1,1,-1
KR_6748513403,440,-2,-49,3,-5,1,1,2,0,3,3,-2,5,3,-3,4,1,-1,4,3,0,-5,33,0,-4,4,-4,0,0,-1,1,1,1,6,-1
KR_6583877788,420,-2,45,35,-8,-4,5,1,-1,5,4,4,1,5,-5,5,0,-2,2,0,0,-14,-19,1,-7,6,-2,0,0,-1,1,0,1,3,-1
KR_6763713495,420,-2,-46,-49,5,1,0,1,-2,4,2,5,1,6,-2,5,3,3,0,3,0,9,-33,4,-9,5,31,0,0,1,0,0,1,4,-1
KR_6750393300,420,-3,-67,19,-10,2,1,3,-1,3,2,-5,5,0,-3,4,1,-3,3,0,-1,-15,-9,-8,-2,10,1,0,-3,-1,-1,-1,-1,4,-1
KR_6761437716,420,1,14,-30,1,-1,3,2,-1,4,3,7,1,8,-4,6,2,0,1,1,-2,-2,-2,1,-7,6,0,0,0,1,0,0,-1,2,-1
KR_6677570363,420,-1,13,-40,-1,6,1,7,-4,5,1,0,2,2,1,1,2,-4,4,0,1,0,-7,-5,-1,6,2,0,0,-1,-1,1,1,2,-1
KR_6652930823,420,-3,-44,5,-10,-1,2,1,0,0,0,-1,1,0,-6,6,0,-2,3,1,0,-14,150,-4,-2,6,-29,0,0,1,-1,-1,-1,5,-1
KR_6741722713,440,6,75,32,12,3,0,3,6,2,8,-3,5,2,5,0,5,1,1,2,1,7,22,-3,-3,6,4,0,2,-1,-1,1,1,3,-1
KR_6638003869,420,-2,-14,-36,-2,4,1,5,-1,4,3,-4,5,1,0,5,5,-1,2,1,0,6,2,-2,-5,7,-4,0,0,-1,-1,-1,1,1,-1
KR_6719990324,420,-2,-54,-7,-3,-2,2,0,4,1,5,-1,1,0,-4,9,5,0,1,1,0,-6,116,1,-8,7,-6,0,0,-1,1,1,-1,5,-1
KR_6720573810,420,-2,-77,-47,-6,-4,5,1,1,3,4,-2,3,1,0,0,0,-1,1,0,0,-1,-4,-4,-3,7,1,0,-1,-1,1,-1,-1,2,-1
KR_6742492943,420,1,37,32,-8,-2,6,4,-8,9,1,6,0,6,-4,4,0,0,1,1,-1,-6,-1,3,-8,5,2,0,-2,1,-1,-1,-1,3,-1
KR_6767554559,420,-3,-65,-16,-6,-2,2,0,0,1,1,-3,4,1,-1,2,1,0,1,1,0,-11,186,0,-7,7,-9,0,-1,1,-1,-1,-1,2,-1
KR_6763043762,420,-9,-97,0,-19,-1,4,3,-4,6,2,-6,8,2,-8,8,0,0,0,0,0,-19,-11,-3,-5,8,-3,0,-2,-1,-1,-1,-1,3,-1
KR_6695054079,420,-3,-55,-56,-2,-2,3,1,-2,5,3,0,3,3,1,1,2,1,0,1,0,0,4,-2,-4,6,-1,0,-1,-1,-1,-1,-1,1,-1
KR_6726019989,420,-2,-76,3,-8,-1,3,2,-2,3,1,0,3,3,-3,3,0,-2,2,0,0,-8,0,-4,-2,6,1,0,-2,-1,1,1,-1,5,-1
KR_6750220752,420,-3,-28,11,-12,-1,1,0,-4,6,2,-2,3,1,-4,4,0,-1,1,0,0,-18,-3,-3,-3,6,-1,0,-1,1,-1,-1,1,4,-1
KR_6765964279,420,0,-53,3,-4,-2,2,0,-1,3,2,0,4,4,-2,5,3,1,1,2,2,4,-301,3,-7,4,14,0,-1,1,-1,-1,1,2,-1
KR_6643137081,420,-3,-26,-17,-4,2,1,3,-2,3,1,4,1,5,-6,6,0,-2,2,0,-1,-16,-7,0,-5,5,-3,0,-1,-1,1,-1,-1,1,-1
KR_6651465396,420,2,46,-8,8,3,1,4,5,4,9,0,1,1,1,1,2,-1,3,2,1,3,10,0,-5,5,-2,0,2,1,1,1,1,3,-1
KR_6760535497,420,2,-12,-17,7,-2,3,1,-5,5,0,8,3,11,2,2,4,4,0,4,0,11,19,2,-6,4,0,0,-1,1,-1,1,1,5,-1
KR_6706299897,420,-3,-30,19,-8,1,4,5,0,4,4,-5,7,2,-2,5,3,-2,2,0,-1,-14,1,4,-8,4,-1,0,-1,-1,-1,-1,-1,6,-1
KR_6670299286,420,1,-39,-11,-1,0,0,0,4,1,5,-1,1,0,-3,3,0,-1,1,0,0,-4,-4,2,-10,8,5,0,0,-1,0,0,-1,1,-1
KR_6645136657,420,-1,33,-15,-7,1,1,2,-6,7,1,-9,9,0,7,0,7,0,1,1,0,-7,-9,-3,-7,10,-3,0,-2,-1,-1,-1,1,5,-1
KR_6765014967,420,-4,-12,-6,-7,-10,11,1,-3,3,0,2,4,6,4,0,4,0,0,0,-1,-2,2,4,-7,3,-3,0,-2,-1,1,-1,-1,1,-1
KR_6759622278,420,1,-12,0,1,1,0,1,0,2,2,1,1,2,-3,6,3,2,0,2,0,4,0,6,-9,3,-6,0,0,1,-1,0,-1,4,-1
KR_6731762137,420,3,91,-15,8,-3,3,0,1,2,3,6,0,6,4,1,5,0,2,2,0,14,5,2,-7,5,3,0,1,1,-1,1,1,6,-1
KR_6762976006,420,0,16,8,2,2,0,2,2,0,2,-1,4,3,1,1,2,-2,2,0,1,4,143,-1,-5,6,-1,0,0,-1,1,0,1,4,-1
KR_6764447812,420,-1,-33,-2,-4,0,1,1,0,4,4,-5,5,0,-1,6,5,2,1,3,0,-1,-287,-1,-5,6,1,0,2,1,-1,1,-1,5,-1
KR_6687819058,420,4,35,44,5,-1,2,1,0,1,1,2,4,6,5,2,7,-1,3,2,0,0,-61,2,-6,4,7,0,2,-1,1,1,1,3,-1
KR_6722354626,440,-5,-68,-15,-10,-2,7,5,-4,5,1,0,1,1,-2,3,1,-2,2,0,0,-10,-5,0,-3,3,-7,0,-1,-1,1,-1,1,5,-1
KR_6760500689,420,-5,-57,-8,-16,-1,1,0,0,1,1,-9,10,1,-5,5,0,-1,2,1,0,-9,10,-1,-2,3,-1,0,-1,1,-1,-1,-1,5,-1
KR_6732572660,420,2,47,7,-4,2,1,3,1,2,3,0,1,1,-5,7,2,-2,2,0,1,-7,-24,-3,-2,5,3,0,-1,-1,-1,-1,1,6,-1
KR_6677995196,440,1,-6,-5,5,4,1,5,1,3,4,4,2,6,-4,7,3,0,0,0,0,5,-8,-3,-5,8,0,0,0,1,1,-1,-1,4,-1
KR_6768576062,420,-2,-56,-8,-6,1,1,2,-1,1,0,-2,3,1,-4,6,2,0,0,0,0,-9,3,3,-9,6,-4,0,0,1,-1,0,1,2,-1
KR_6697289297,440,-4,-12,-23,-11,-4,4,0,-5,6,1,-2,2,0,0,1,1,0,0,0,0,-11,-29,0,-5,5,-2,0,-1,-1,-1,-1,-1,6,-1
KR_6654777526,420,-3,-33,-38,-11,-5,5,0,-4,5,1,-6,9,3,2,1,3,2,0,2,0,-11,-2,-1,-7,8,-2,0,-1,-1,1,-1,-1,3,-1
KR_6759422712,420,0,31,-3,-2,-1,2,1,1,2,3,-1,3,2,1,1,2,-2,2,0,0,-7,-20,3,-9,6,6,0,1,0,1,1,1,0,-1
KR_6753354804,420,-6,-93,-20,-9,-6,6,0,4,0,4,0,2,2,-6,6,0,-1,1,0,0,-7,-15,-4,-3,7,2,0,-4,-1,-1,-1,1,4,-1
KR_6765685843,420,-2,-20,-24,-1,0,4,4,-2,3,1,2,3,5,-5,8,3,4,0,4,1,-4,2,-2,-4,6,1,0,0,-1,1,-1,-1,2,-1
KR_6758937153,420,-6,19,-49,-16,1,0,1,-6,6,0,-6,7,1,-1,4,3,-4,5,1,0,-11,2,-2,-3,5,-3,0,-2,-1,-1,-1,1,2,-1
KR_6762857711,420,1,20,-3,8,1,2,3,1,1,2,3,1,4,3,2,5,0,1,1,0,3,-21,-2,-8,10,2,0,0,1,-1,1,1,2,-1
KR_6750877327,440,0,31,3,1,-1,4,3,-6,7,1,-1,1,0,6,4,10,3,0,3,0,-17,-6,-5,-5,10,1,0,0,-1,1,1,1,4,-1
KR_6764787811,420,-3,39,-2,-4,-1,1,0,0,2,2,-4,9,5,0,2,2,1,1,2,0,-8,304,-3,-4,7,-14,0,1,1,-1,1,1,1,-1
KR_6737859677,420,-2,-6,-11,-1,2,1,3,4,2,6,-6,8,2,0,1,1,-1,1,0,0,5,4,1,-7,6,1,0,-1,1,-1,-1,1,3,-1
KR_6764154600,420,-1,74,3,-6,0,2,2,-5,5,0,-2,4,2,1,3,4,0,0,0,0,-18,-8,1,-5,4,-3,0,0,1,-1,-1,-1,3,-1
KR_6739550162,420,-6,-63,-17,-11,-1,3,2,-5,7,2,0,1,1,-5,5,0,0,1,1,0,-24,-4,-3,-5,8,-3,0,0,-1,-1,0,-1,5,-1
KR_6765368899,420,-3,14,-56,1,3,1,4,-4,4,0,3,1,4,0,5,5,-1,1,0,0,-13,-75,1,-7,6,-1,0,-2,1,-1,-1,1,4,-1
KR_6767189162,440,-2,70,-26,-5,1,0,1,-5,5,0,0,0,0,-3,5,2,2,0,2,0,-12,-2,-3,-4,7,0,0,1,1,-1,1,-1,6,-1
KR_6763705551,420,-5,-63,-13,-15,-1,1,0,-1,3,2,-6,7,1,-9,9,0,2,1,3,-2,-22,-13,-4,-1,5,1,0,-1,-1,-1,-1,-1,1,-1
KR_6764023446,420,2,-21,38,-6,1,1,2,0,2,2,0,5,5,-8,10,2,1,1,2,-1,-8,5,5,-8,3,-2,0,-1,1,-1,-1,-1,2,-1
KR_6673128169,420,-6,-121,-29,-14,-1,1,0,-3,3,0,-9,9,0,-2,3,1,1,0,1,-3,-16,1,0,-6,6,-8,0,-4,-1,-1,-1,-1,6,-1
KR_6768890023,420,-5,-56,14,-7,-6,8,2,-2,7,5,1,1,2,1,3,4,-1,3,2,0,-3,173,-4,-2,6,-3,0,-2,-1,1,-1,1,2,-1
KR_6768406814,440,-2,1,-24,-7,0,1,1,-1,3,2,0,3,3,0,2,2,-6,7,1,-1,0,-9,-5,-3,8,3,0,-1,-1,-1,-1,-1,4,-1
KR_6708619321,440,-3,13,-6,-8,3,1,4,-5,7,2,1,1,2,-5,6,1,-2,3,1,0,-18,-15,2,-11,9,3,0,0,0,-1,-1,-1,0,-1
KR_6750136227,420,-6,-4,-19,-12,0,2,2,-8,8,0,6,0,6,-7,9,2,-3,3,0,0,-18,8,2,-4,2,-9,0,1,-1,1,1,-1,6,-1
KR_6760946186,420,-1,-35,0,-9,0,1,1,-7,8,1,1,4,5,-4,5,1,1,1,2,-1,-13,-3,2,-6,4,1,0,-1,-1,1,-1,-1,2,-1
KR_6766676403,420,-4,-48,-3,-4,-1,2,1,-2,2,0,1,1,2,-1,3,2,-1,1,0,0,-6,-257,1,-5,4,-7,0,-1,-1,-1,-1,1,4,-1
KR_6690749694,420,-5,-16,-19,-6,2,0,2,-5,6,1,0,0,0,-3,5,2,0,1,1,0,-13,-22,-1,-4,5,-5,0,0,-1,1,-1,1,4,-1
KR_6760830935,420,-2,-28,-38,-3,1,1,2,-4,5,1,-4,7,3,4,2,6,0,1,1,0,-2,-5,-1,-4,5,-2,0,-1,-1,-1,-1,-1,6,-1
KR_6764831158,440,2,-7,12,-3,2,3,5,4,3,7,-1,4,3,-11,11,0,3,0,3,-3,-17,6,2,-5,3,1,0,-1,1,-1,-1,-1,1,-1
KR_6732713927,440,-2,28,-20,-6,-1,5,4,-7,7,0,0,0,0,3,4,7,-1,1,0,0,-9,-2,-3,-2,5,0,0,-1,-1,-1,-1,-1,1,-1
KR_6761115515,420,2,19,-24,8,-2,3,1,7,0,7,3,0,3,1,5,6,-1,1,0,-1,13,-30,6,-7,1,0,0,0,-1,-1,1,-1,1,-1
KR_6508264601,420,-2,-61,-12,-9,-2,4,2,-1,3,2,0,0,0,-5,6,1,-1,1,0,0,-9,44,-1,-10,11,1,0,-1,1,1,-1,1,1,-1
KR_6759022039,420,-3,-27,-31,0,2,0,2,2,2,4,-2,3,1,-1,5,4,-1,2,1,1,3,-8,-1,-6,7,5,0,-2,1,-1,-1,1,1,-1
KR_6688924737,440,-1,3,-16,-7,-1,1,0,-1,5,4,-5,5,0,-1,4,3,1,0,1,-1,-10,-132,1,-6,5,-3,0,-1,-1,-1,-1,-1,5,-1
KR_6741470172,420,-4,-54,-35,-7,-1,3,2,-2,4,2,-3,4,1,-3,3,0,2,0,2,0,-8,-7,-1,-4,5,2,0,0,-1,1,1,-1,1,-1
KR_6672237325,420,-5,-78,-4,-14,-2,4,2,0,4,4,-6,6,0,-5,7,2,-1,1,0,1,-14,-7,-4,-9,13,-8,0,-1,-1,1,-1,1,2,-1
KR_6758425220,420,-3,-23,-8,-4,0,2,2,1,0,1,2,1,3,-6,7,1,-1,1,0,0,-1,3,0,-3,3,-5,0,0,-1,1,0,1,2,-1
KR_6766866059,420,1,70,8,-2,1,2,3,0,1,1,2,1,3,0,2,2,-5,5,0,-1,-9,-1,4,-8,4,0,0,0,-1,1,0,-1,6,-1
KR_6769158439,420,-1,8,27,-7,-2,6,4,0,2,2,-2,2,0,-2,6,4,-1,1,0,0,-3,-3,-2,-5,7,2,0,-2,-1,-1,-1,-1,5,-1
KR_6767439463,420,-5,-87,7,-10,-3,4,1,0,3,3,0,1,1,-3,4,1,-4,6,2,0,-15,-8,-3,-2,5,-2,0,0,-1,1,-1,-1,4,-1
KR_6758062433,440,-1,17,-16,-3,0,0,0,-2,2,0,-1,2,1,0,1,1,0,2,2,1,0,6,-2,-4,6,2,0,-1,-1,-1,-1,1,6,-1
KR_6765639000,420,1,-45,4,0,-5,8,3,9,1,10,-5,5,0,0,0,0,1,2,3,0,1,-108,1,-8,7,-2,0,-2,-1,1,-1,-1,4,-1
KR_6698252089,420,5,56,16,9,3,0,3,0,2,2,2,1,3,2,2,4,2,1,3,0,0,7,2,-7,5,-3,0,0,1,1,1,1,6,-1
KR_6743742531,440,-3,1,-12,-10,-6,6,0,0,1,1,0,0,0,-5,7,2,1,0,1,1,-5,-22,1,-6,5,-1,0,-2,1,-1,-1,1,6,-1
KR_6710711071,420,2,-46,22,1,-3,4,1,3,2,5,0,0,0,0,0,0,1,0,1,-1,0,-4,3,-5,2,0,0,-3,1,-1,-1,-1,3,-1
KR_6617373238,420,0,2,21,5,2,0,2,3,1,4,-1,2,1,2,0,2,-1,1,0,0,4,-33,3,-9,6,7,0,0,-1,1,0,1,1,-1
KR_6722097406,420,0,-25,18,3,-7,8,1,2,2,4,3,0,3,5,2,7,0,0,0,-1,10,-14,-3,-6,9,4,0,-1,1,-1,-1,-1,6,-1
KR_6759840127,420,-6,-75,-59,1,-1,3,2,-3,3,0,4,1,5,1,3,4,0,0,0,0,4,-7,-3,-1,4,-1,0,0,-1,-1,0,-1,2,-1
KR_6766675398,420,-5,-78,-44,-15,4,1,5,-6,7,1,-7,7,0,-6,7,1,0,1,1,0,-21,16,-1,-4,5,-1,0,-1,-1,-1,-1,1,4,-1
KR_6762006967,420,0,-81,-40,-1,-4,5,1,-1,1,0,1,1,2,3,0,3,0,0,0,0,7,4,4,-9,5,-1,0,0,1,1,-1,-1,4,-1
KR_6762247711,420,2,85,-28,3,3,1,4,-1,4,3,-2,3,1,1,0,1,2,1,3,0,7,14,2,-5,3,-2,0,0,-1,-1,0,1,4,-1
KR_6620919017,420,0,-18,-20,3,5,1,6,0,1,1,-3,5,2,1,0,1,0,0,0,0,7,4,-2,-4,6,-6,0,0,-1,1,0,1,3,-1
KR_6751684425,420,0,-16,16,-11,-6,7,1,-2,2,0,-1,3,2,-1,4,3,-1,1,0,0,-11,4,-2,-6,8,6,0,0,1,-1,-1,-1,1,-1
KR_6767691980,420,-1,5,-16,-3,0,1,1,1,2,3,0,2,2,-4,4,0,0,1,1,0,-2,-6,0,-6,6,1,0,0,1,-1,-1,-1,3,-1
KR_6749375297,420,4,55,-6,2,3,0,3,4,4,8,-1,2,1,-3,6,3,-1,3,2,-1,7,-2,-2,-4,6,4,0,2,-1,1,1,-1,6,-1
KR_6761360896,440,-7,-49,-26,-8,-3,3,0,-3,6,3,-1,3,2,-1,8,7,0,2,2,0,-3,-60,2,-7,5,24,0,-1,-1,1,-1,1,6,-1
KR_6764277883,420,2,-39,23,6,-1,2,1,-1,3,2,4,1,5,5,1,6,-1,2,1,0,10,6,2,-7,5,-2,0,0,1,-1,0,1,5,-1
KR_6767121764,440,-4,-54,-12,-11,-1,2,1,3,1,4,-2,5,3,-8,10,2,-3,4,1,-1,-11,-23,-5,0,5,1,0,0,1,-1,-1,-1,1,-1
KR_6765770360,420,0,-2,-1,-3,0,1,1,1,1,2,1,1,2,-1,3,2,-4,4,0,0,-1,-12,-2,-4,6,4,0,0,-1,-1,0,-1,3,-1
KR_6766198629,420,-2,-10,0,-7,-1,3,2,2,2,4,-4,5,1,-2,2,0,-2,2,0,0,-16,4,-2,-4,6,-5,0,1,-1,1,1,-1,3,-1
KR_6698696942,440,-1,-12,6,-4,1,0,1,0,1,1,-1,2,1,-3,5,2,-1,1,0,0,-4,-5,0,-5,5,0,0,-1,1,-1,-1,-1,6,-1
KR_6659577983,420,0,60,-46,1,5,0,5,-3,4,1,-1,2,1,-1,2,1,1,1,2,0,0,8,4,-7,3,-4,0,0,-1,-1,0,-1,6,-1
KR_6765060222,420,2,23,17,4,0,0,0,0,3,3,5,3,8,1,3,4,-2,4,2,0,2,8,-3,-5,8,0,0,0,-1,1,1,-1,3,-1
KR_6766539650,440,0,-16,-8,-4,-2,4,2,-4,5,1,0,2,2,-1,2,1,3,2,5,0,2,-3,1,-4,3,1,0,0,0,1,0,-1,0,-1
KR_6708349809,420,-2,3,-4,-10,1,3,4,-9,12,3,-1,3,2,0,3,3,-1,1,0,1,-15,5,0,-10,10,-5,0,2,-1,1,1,-1,5,-1
KR_6754801108,420,-3,-49,6,-1,-2,3,1,1,0,1,2,2,4,-2,6,4,0,1,1,0,0,17,-3,-6,9,-9,0,0,1,-1,0,1,4,-1
KR_6646746764,420,-1,60,-24,-2,0,1,1,-1,3,2,0,1,1,1,0,1,-2,2,0,0,-4,-5,-6,-1,7,5,0,0,-1,0,0,1,6,-1
KR_6747669703,420,-5,-21,-47,-5,-6,7,1,5,0,5,-4,4,0,1,5,6,-1,1,0,0,1,2,4,-10,6,1,0,0,1,1,0,1,6,-1
KR_6763237916,420,3,28,9,0,2,1,3,-3,4,1,-1,3,2,3,1,4,-1,1,0,0,-12,-52,-2,-1,3,19,0,0,1,-1,0,1,1,-1
KR_6727234891,440,-5,-119,0,-12,0,0,0,1,1,2,-3,4,1,-10,10,0,0,0,0,0,-16,-185,2,-6,4,-6,0,-3,-1,-1,-1,-1,6,-1
KR_6767618344,420,0,-3,-24,-1,-1,1,0,1,1,2,0,2,2,-1,1,0,0,0,0,0,-2,84,-1,-3,4,36,0,0,1,-1,0,-1,4,-1
KR_6729004592,420,1,24,-13,1,0,2,2,-1,6,5,-1,2,1,2,1,3,1,0,1,0,-1,-113,0,-7,7,-1,0,0,-1,-1,1,-1,4,-1
KR_6755375792,420,2,35,-21,6,1,0,1,2,2,4,-2,3,1,4,1,5,1,0,1,0,6,5,4,-9,5,-8,0,1,-1,1,1,1,6,-1
KR_6760119734,420,2,56,19,9,3,2,5,3,1,4,1,3,4,0,6,6,2,0,2,0,8,-24,4,-10,6,-1,0,1,1,-1,-1,-1,5,-1
KR_6640489914,420,-2,-59,-20,2,-7,7,0,5,2,7,2,3,5,1,3,4,1,1,2,0,6,15,-1,-8,9,2,0,-1,1,-1,1,-1,6,-1
KR_6765355702,420,-2,-31,-25,-4,-1,1,0,0,1,1,3,1,4,-1,6,5,-5,5,0,0,-9,1,1,-5,4,-3,0,0,1,-1,1,-1,1,-1
KR_6759766011,420,0,60,33,7,2,4,6,0,3,3,1,5,6,5,1,6,-1,1,0,0,-7,-90,1,-8,7,0,0,2,-1,1,1,1,6,-1
KR_6593376919,420,0,-27,-3,-1,1,0,1,0,0,0,-1,4,3,-2,6,4,1,0,1,0,-1,-80,1,-6,5,-7,0,-1,-1,-1,-1,1,3,-1
KR_6693692175,420,-1,39,-11,-4,0,1,1,0,3,3,0,1,1,-1,4,3,-3,3,0,1,1,-8,-3,-4,7,3,0,0,-1,-1,0,1,3,-1
KR_6740864825,420,-3,-61,5,-6,-2,3,1,2,0,2,-2,2,0,-2,2,0,-2,4,2,0,-4,-14,-5,-3,8,1,0,-2,1,1,-1,-1,5,-1
KR_6750775302,440,-4,-179,-17,-3,-2,4,2,-4,7,3,0,1,1,-3,4,1,6,0,6,0,1,1,-1,-6,7,5,0,0,-1,1,-1,-1,6,-1
KR_6757391535,420,-7,-25,-20,-14,-5,5,0,-1,1,0,-3,5,2,-3,4,1,-2,2,0,0,-12,7,-3,-4,7,-6,0,-2,-1,-1,-1,-1,1,-1
KR_6578888906,420,-2,-11,-23,-3,3,0,3,-2,4,2,-1,1,0,-3,5,2,0,0,0,0,-11,-5,-4,-5,9,5,0,0,-1,1,0,1,2,-1
KR_6764004158,420,-2,5,1,-1,-2,2,0,-2,4,2,2,1,3,1,1,2,0,0,0,0,2,0,-2,-4,6,3,0,0,-1,1,0,-1,1,-1
KR_6762525323,420,-6,-60,-40,-8,-3,5,2,-7,8,1,3,1,4,1,1,2,-2,2,0,0,-8,1,1,-4,3,-4,0,0,-1,1,0,1,6,-1
KR_6756432022,420,-3,-36,-10,0,2,3,5,1,3,4,0,1,1,-2,9,7,-1,1,0,-1,1,-2,0,-6,6,5,0,0,-1,1,0,-1,3,-1
KR_6756682191,420,2,-2,-1,4,4,2,6,-1,4,3,1,0,1,1,2,3,-1,4,3,0,1,-3,1,-5,4,2,0,0,0,-1,0,1,0,-1
KR_6710663796,420,-2,-31,4,-2,-1,5,4,2,3,5,-4,5,1,4,2,6,-3,4,1,0,-5,2,0,-3,3,0,0,-1,-1,-1,-1,-1,2,-1
KR_6764322162,420,0,-8,3,1,-1,3,2,1,2,3,-2,3,1,3,3,6,0,2,2,0,3,-13,2,-5,3,0,0,0,-1,1,-1,-1,6,-1
KR_6767779761,440,0,-31,20,-3,-3,3,0,1,3,4,3,0,3,-2,5,3,-2,4,2,0,-3,-4,-2,-4,6,0,0,0,-1,1,-1,-1,1,-1
KR_6712827386,420,-4,-53,-48,-9,-1,1,0,-5,5,0,1,1,2,-4,4,0,0,0,0,0,-11,3,1,-4,3,-4,0,-1,0,-1,-1,-1,0,-1
KR_6724064840,420,-3,-39,-24,-7,-2,3,1,-1,2,1,-1,3,2,-3,5,2,0,2,2,0,-4,9,3,-5,2,-4,0,-1,1,1,-1,-1,2,-1
KR_6758791959,420,-1,-26,23,7,-2,5,3,1,2,3,7,1,8,2,0,2,-1,2,1,0,6,-4,-4,-3,7,4,0,0,1,1,1,1,2,-1
KR_6716263571,420,3,99,36,15,11,0,11,2,0,2,-1,4,3,1,2,3,2,0,2,1,10,24,1,-7,6,0,0,2,1,1,1,1,6,-1
KR_6753910458,420,-2,18,20,-3,-2,2,0,-9,9,0,-2,4,2,5,2,7,5,0,5,-1,-7,-26,-4,-8,12,1,0,0,-1,-1,1,-1,1,-1
KR_6736086307,420,-1,-16,-16,2,6,1,7,0,3,3,2,2,4,-5,5,0,-1,1,0,0,-3,-5,1,-6,5,-1,0,0,1,-1,1,-1,3,-1
KR_6766933437,420,2,-60,32,-1,1,4,5,1,4,5,-3,4,1,-2,3,1,2,0,2,0,2,1,0,-3,3,2,0,1,-1,1,1,-1,3,-1
KR_6634964610,420,0,-68,-37,3,2,1,3,-1,8,7,2,3,5,-1,3,2,1,0,1,-1,-2,0,1,-8,7,0,0,0,1,-1,-1,-1,3,-1
KR_6542306161,420,0,-22,28,1,-1,3,2,0,2,2,4,4,8,0,2,2,-2,2,0,0,5,14,-2,-8,10,-4,0,0,1,1,1,-1,2,-1
KR_6697750852,420,3,56,36,-3,0,3,3,0,2,2,-6,7,1,2,1,3,1,0,1,0,-16,7,-1,-4,5,-2,0,0,-1,-1,1,-1,5,-1
KR_6697836482,420,1,5,-14,7,4,0,4,1,1,2,0,2,2,2,2,4,0,0,0,0,10,2,7,-9,2,-2,0,1,1,1,1,1,2,-1
KR_6755316246,440,-2,21,11,-8,2,2,4,-3,4,1,-4,4,0,-2,2,0,-1,1,0,1,-11,-25,-1,-5,6,3,0,0,1,-1,0,1,3,-1
KR_6760991906,420,-1,-107,-21,0,-1,3,2,3,1,4,1,2,3,-1,1,0,-2,2,0,-1,-3,-34,4,-8,4,33,0,-1,-1,-1,-1,-1,3,-1
KR_6508460886,420,-1,21,-6,-1,-2,2,0,2,2,4,0,3,3,0,2,2,-1,1,0,0,3,0,2,-11,9,6,0,1,1,-1,-1,-1,3,-1
KR_6556810621,420,4,-35,29,5,1,0,1,0,4,4,2,0,2,2,2,4,0,0,0,0,5,-3,-4,-5,9,1,0,0,-1,-1,1,-1,5,-1
KR_6765358605,420,-8,-154,-26,-12,-3,6,3,-9,9,0,1,1,2,-5,6,1,4,0,4,0,-9,-6,-5,-2,7,-1,-1,-6,-1,-1,-1,-1,3,-1
KR_6767502753,420,4,-5,17,10,-2,5,3,1,1,2,-1,2,1,10,1,11,2,0,2,0,12,3,4,-7,3,-4,0,2,-1,1,1,1,3,-1
KR_6656908661,420,-1,82,-14,-6,-3,3,0,2,2,4,1,2,3,-5,5,0,-1,1,0,-2,-14,1,-3,-3,6,1,0,0,-1,-1,0,-1,1,-1
KR_6765547955,420,-2,-69,-9,-6,0,3,3,-4,4,0,-3,3,0,1,1,2,0,1,1,0,-10,-4,-4,-2,6,-4,0,-1,-1,-1,-1,-1,3,-1
KR_6704645222,420,1,13,21,-3,-1,4,3,1,2,3,2,3,5,-1,1,0,-4,4,0,0,-6,10,2,-7,5,-2,0,3,-1,1,1,-1,5,-1
KR_6681759547,420,1,-24,13,-3,0,1,1,0,3,3,-4,8,4,2,4,6,-1,2,1,0,-7,1,2,-6,4,1,0,0,1,-1,1,1,3,-1
KR_6752911879,420,-6,-70,-36,-5,-1,2,1,-2,3,1,-2,2,0,2,2,4,-2,2,0,0,-5,30,2,-9,7,-2,0,0,1,-1,-1,1,6,-1
KR_6700892068,440,1,57,31,1,-1,1,0,1,3,4,-1,2,1,2,0,2,0,0,0,1,4,87,0,-3,3,2,0,0,1,1,1,1,4,-1
KR_6766588404,420,-7,-53,-37,-13,-6,7,1,-7,7,0,0,2,2,-3,3,0,3,1,4,0,-10,1,1,-5,4,-2,0,-1,0,-1,-1,1,0,-1
KR_6736025134,420,-3,-5,-17,-6,1,2,3,-1,2,1,-3,5,2,-2,4,2,-1,2,1,0,-2,2,1,-4,3,0,0,-3,1,-1,-1,1,6,-1
KR_6752981313,420,-4,-63,13,-3,-4,5,1,-2,6,4,0,5,5,2,3,5,1,1,2,1,2,-1,-4,-4,8,4,0,0,-1,1,-1,1,5,-1
KR_6648132854,440,3,-51,-2,1,-2,3,1,-2,3,1,2,1,3,1,1,2,2,2,4,-3,-4,-3,-5,-1,6,-2,0,0,-1,-1,0,-1,5,-1
KR_6758327720,420,1,-35,-21,-1,0,1,1,-1,2,1,0,2,2,0,1,1,0,0,0,0,-3,-3,-2,-5,7,0,0,-1,-1,-1,-1,-1,4,-1
KR_6759225915,420,-3,-57,-10,-11,1,1,2,-4,5,1,-4,5,1,-1,3,2,-3,3,0,0,-8,-1,-4,-2,6,-6,0,-1,-1,-1,-1,-1,5,-1
KR_6763425000,420,-1,37,9,-3,-1,2,1,-4,5,1,3,2,5,0,1,1,-1,1,0,0,-6,-14,-5,-6,11,-2,0,-2,1,-1,-1,1,3,-1
KR_6730885787,420,1,56,-13,-4,-1,2,1,-1,3,2,0,5,5,0,1,1,-2,2,0,0,-3,52,-1,-4,5,0,0,0,-1,-1,0,-1,1,-1
KR_6765528163,420,-1,-5,17,-6,2,1,3,-6,6,0,-2,4,2,0,7,7,0,0,0,0,-9,2,-6,-5,11,-2,0,-1,-1,-1,-1,1,5,-1
KR_6764530751,420,0,-30,15,-5,-2,6,4,3,1,4,-1,3,2,-4,5,1,-1,1,0,0,-7,-7,-7,0,7,2,0,-1,-1,-1,-1,-1,6,-1
KR_6719187899,420,0,-32,7,-2,1,2,3,0,3,3,-1,3,2,-3,3,0,1,0,1,0,0,29,-1,-4,5,-6,0,-1,1,-1,-1,-1,5,-1
KR_6767207061,420,5,10,16,6,4,1,5,0,4,4,-1,3,2,-2,3,1,5,1,6,1,4,16,6,-7,1,-5,0,2,1,-1,1,1,1,-1
KR_6655029334,420,-6,-56,-12,-21,-1,2,1,-2,5,3,-2,3,1,-15,17,2,-1,3,2,-3,-26,-39,-4,-4,8,-9,0,-2,-1,-1,-1,-1,4,-1
KR_6754059907,420,-3,-21,44,-7,-6,6,0,-1,3,2,0,0,0,-1,1,0,1,1,2,0,-5,-5,-1,-5,6,1,0,-2,1,1,-1,-1,6,-1
KR_6766657872,420,0,-20,1,-11,-3,4,1,4,1,5,0,1,1,-11,11,0,-1,1,0,0,-14,-6,-4,-2,6,0,0,0,-1,1,0,-1,4,-1
KR_6689938029,420,-3,32,-20,-12,-1,2,1,-6,7,1,-6,8,2,0,2,2,1,0,1,-2,-12,10,6,-13,7,0,0,0,0,-1,-1,-1,0,-1
KR_6735258027,420,4,-6,3,10,-3,3,0,7,3,10,4,2,6,0,2,2,2,2,4,0,21,1,-5,-6,11,0,0,0,-1,-1,1,-1,3,-1
KR_6758761860,420,-2,-22,18,-2,1,3,4,0,1,1,-4,4,0,-1,2,1,2,1,3,0,-4,3,-1,-5,6,1,0,1,-1,1,1,1,6,-1
KR_6753386629,420,-5,-89,-16,-8,2,1,3,-2,2,0,-4,6,2,-4,4,0,0,1,1,0,-10,6,1,-5,4,-4,0,-1,-1,1,-1,-1,6,-1
KR_6656871772,420,-4,26,14,-15,0,0,0,-8,9,1,-6,6,0,-2,2,0,1,1,2,0,-13,6,-1,-5,6,-3,0,0,-1,-1,0,-1,6,-1
KR_6724266951,420,-2,-16,0,-8,3,1,4,-2,6,4,-2,3,1,-3,4,1,-4,4,0,-1,-11,-14,-1,-3,4,-2,0,0,-1,1,-1,-1,3,-1
KR_6744505350,420,-1,-3,-8,0,-1,1,0,1,5,6,3,1,4,-2,3,1,-1,3,2,1,4,-3,-2,-7,9,2,0,0,1,-1,0,1,1,-1
KR_6762777601,420,1,-11,10,2,-2,3,1,2,4,6,0,2,2,0,2,2,2,0,2,0,2,11,1,-8,7,1,0,0,-1,1,0,-1,6,-1
KR_6758769130,440,2,11,-8,1,2,0,2,-3,4,1,0,3,3,2,4,6,0,1,1,0,-4,-21,-2,-2,4,2,0,0,-1,-1,0,1,3,-1
KR_6668494856,420,-5,-52,-36,-17,-12,13,1,-1,4,3,-3,3,0,-2,2,0,1,0,1,-1,-13,-1,-3,-5,8,-1,0,-2,-1,-1,-1,-1,1,-1
KR_6691342114,420,-1,-25,25,-6,-2,2,0,-3,3,0,-6,7,1,3,2,5,2,1,3,0,-6,1,1,-6,5,-2,0,-1,1,-1,-1,-1,6,-1
KR_6768083963,420,-2,35,-24,-9,2,0,2,-1,3,2,-4,6,2,-7,7,0,1,0,1,1,-14,-1,-2,-7,9,0,0,0,-1,1,-1,1,3,-1
KR_6747071233,420,-1,-46,27,-4,3,1,4,-3,5,2,0,2,2,-5,6,1,1,0,1,0,-13,-12,-2,-4,6,1,0,-1,-1,1,-1,-1,6,-1
KR_6675248168,420,-4,2,31,-10,0,0,0,-2,4,2,2,0,2,-6,7,1,-4,5,1,0,-18,-9,1,-8,7,4,0,-1,0,1,-1,-1,0,-1
KR_6765062028,420,-2,-18,10,-2,-2,3,1,0,1,1,0,3,3,1,2,3,-1,2,1,0,-7,127,-2,-6,8,5,0,0,1,-1,-1,1,4,-1
KR_6742965463,420,0,21,13,-8,-1,2,1,4,2,6,-4,5,1,-1,2,1,-6,6,0,-4,-23,-48,6,-7,1,-4,0,-1,1,-1,-1,-1,2,-1
KR_6758673368,420,1,7,1,-3,-3,3,0,0,6,6,6,1,7,-4,5,1,-2,4,2,0,-10,-234,-7,-1,8,3,0,-1,-1,-1,-1,1,1,-1
KR_6660420371,420,-2,-27,-31,2,0,2,2,0,2,2,4,7,11,-1,2,1,-1,3,2,0,4,2,-2,-3,5,1,0,0,-1,1,0,1,2,-1
KR_6531478238,420,-2,-59,12,-4,-1,2,1,0,3,3,-2,3,1,0,1,1,-1,1,0,0,-3,4,-3,-7,10,-1,0,-1,1,-1,-1,-1,5,-1
KR_6758979745,420,0,18,21,2,-1,5,4,-1,4,3,2,4,6,1,3,4,1,0,1,1,10,-3,-6,-3,9,1,0,1,1,1,1,1,2,-1
KR_6762435326,420,-1,-95,43,-7,0,1,1,-5,6,1,0,3,3,-3,7,4,1,0,1,0,-18,34,-2,-4,6,-5,0,-1,1,1,-1,1,3,-1
KR_6760146263,420,-1,18,15,-4,-1,1,0,2,2,4,-3,4,1,0,3,3,-2,2,0,0,-1,-22,3,-7,4,6,0,0,1,-1,0,1,6,-1
KR_6762257245,420,-3,-3,-2,-14,-2,3,1,-2,3,1,-4,5,1,-1,4,3,-5,7,2,0,-14,53,-5,-3,8,-22,0,-2,-1,-1,-1,-1,6,-1
KR_6648030217,440,2,-30,4,8,0,1,1,5,2,7,3,1,4,4,0,4,-4,6,2,0,-1,218,3,-6,3,1,0,-1,1,0,-1,-1,6,-1
KR_6768686357,420,5,80,33,8,2,0,2,2,5,7,3,1,4,0,2,2,1,0,1,0,1,0,1,-6,5,6,0,1,1,1,1,-1,6,-1
KR_6762620958,420,2,-28,32,0,-3,3,0,2,3,5,1,0,1,1,2,3,-1,1,0,0,1,74,4,-8,4,-4,0,-1,0,-1,1,-1,0,-1
KR_6730319903,420,-2,-3,-12,0,-3,5,2,0,2,2,1,3,4,1,1,2,1,0,1,0,7,-37,1,-6,5,-1,0,-1,-1,1,-1,1,5,-1
KR_6758856187,420,-3,0,-8,-11,-4,4,0,-4,6,2,-3,4,1,-2,4,2,2,0,2,0,-8,-16,-1,-2,3,5,0,0,1,-1,0,-1,4,-1
KR_6730818990,420,-5,-7,10,-5,-4,4,0,5,2,7,-4,4,0,-2,4,2,0,2,2,0,0,39,2,-8,6,-14,0,1,-1,1,1,-1,1,-1
KR_6767545151,420,1,20,-3,-1,-1,2,1,-3,4,1,1,2,3,1,0,1,1,0,1,0,4,-39,3,-9,6,-9,0,0,1,-1,0,-1,3,-1
KR_6756758884,420,-1,-24,-28,-4,-2,4,2,-3,5,2,1,2,3,-1,1,0,1,0,1,0,-2,-33,1,-7,6,-1,0,1,-1,-1,1,1,6,-1
KR_6708872165,420,1,35,-23,3,2,0,2,2,1,3,0,4,4,-1,2,1,0,1,1,0,0,-12,5,-7,2,-1,0,0,1,1,0,-1,1,-1
KR_6749521529,420,-3,-62,21,-8,-2,3,1,-6,7,1,0,1,1,0,2,2,0,0,0,0,-15,4,5,-10,5,-7,0,0,-1,1,0,-1,5,-1
KR_6727582803,420,-2,-50,-24,-7,2,1,3,-2,3,1,1,0,1,-7,9,2,-1,1,0,0,-8,-21,-1,-5,6,-1,0,-1,1,-1,-1,-1,3,-1
KR_6746912843,420,-1,-37,-29,4,-3,3,0,4,2,6,1,3,4,2,3,5,0,1,1,0,20,-7,1,-10,9,2,0,0,-1,-1,-1,1,5,-1
KR_6635220567,420,1,-15,-20,7,-2,6,4,1,0,1,6,4,10,2,1,3,0,0,0,0,13,-148,1,-5,4,0,0,-1,-1,1,-1,1,5,-1
KR_6758798489,420,1,30,21,-9,0,2,2,-2,5,3,1,1,2,-6,11,5,-2,3,1,2,-4,4,1,-6,5,-5,0,0,-1,-1,0,1,2,-1
KR_6734513837,420,-2,-122,22,-9,3,0,3,3,1,4,1,1,2,-16,16,0,0,1,1,0,-18,102,-8,-3,11,4,0,-2,-1,1,-1,1,2,-1
KR_6658111892,420,2,-19,12,-3,-1,4,3,-2,6,4,-1,2,1,1,1,2,0,1,1,0,-5,42,-2,-5,7,-2,0,1,1,1,1,-1,3,-1
KR_6755545946,420,-3,12,-25,-1,-2,2,0,2,2,4,-2,2,0,1,0,1,0,1,1,-1,-9,-1,-1,-5,6,-6,0,0,1,-1,0,-1,2,-1
KR_6670388442,420,-4,-71,16,-18,-1,1,0,-5,7,2,-3,5,2,-7,10,3,-2,3,1,0,-15,-11,-7,-4,11,-2,0,-1,-1,1,-1,-1,3,-1
KR_6730950685,420,-4,-33,-3,-11,-1,2,1,-2,5,3,-3,4,1,-4,4,0,-1,2,1,-2,-15,-2,-4,-3,7,-2,0,-2,-1,-1,-1,-1,4,-1
KR_6701819375,420,0,21,7,9,0,3,3,-1,3,2,2,2,4,6,0,6,2,1,3,0,11,-2,0,-5,5,0,0,2,1,-1,1,1,5,-1
KR_6719837697,420,-3,-54,-11,-4,-2,2,0,-1,5,4,-2,6,4,0,4,4,1,1,2,0,4,16,3,-8,5,-8,0,-1,1,-1,-1,-1,2,-1
KR_6767485675,420,1,20,2,-3,-3,4,1,-2,4,2,4,1,5,-2,3,1,0,2,2,0,0,-10,-2,-4,6,5,0,0,1,0,-1,1,3,-1
KR_6749742084,420,0,-17,-11,-1,0,2,2,3,1,4,8,0,8,-12,14,2,0,1,1,-3,-13,26,-1,-3,4,6,0,2,-1,1,-1,-1,2,-1
KR_6736328513,420,-3,2,4,-7,1,1,2,-2,3,1,-2,3,1,-5,5,0,1,3,4,0,-9,-2,-3,-3,6,-5,0,-2,1,-1,-1,-1,1,-1
KR_6680073933,420,-2,-22,21,-5,-1,4,3,-1,3,2,-5,7,2,1,1,2,1,0,1,0,-2,105,-1,-9,10,-5,0,0,-1,-1,0,-1,2,-1
KR_6750494263,420,-10,-156,-56,-15,0,0,0,4,5,9,-1,3,2,-14,14,0,-4,4,0,-1,-16,-8,-1,-2,3,-3,0,-6,-1,-1,-1,-1,6,-1
KR_6664438168,420,-2,-44,-11,-8,0,2,2,-2,2,0,-2,2,0,-3,6,3,-1,1,0,0,-9,0,1,-8,7,-2,0,-1,-1,-1,-1,-1,1,-1
KR_6767765914,420,3,42,-4,12,1,0,1,9,1,10,5,2,7,-1,4,3,-2,2,0,3,19,24,3,-5,2,-5,0,1,1,-1,-1,1,2,-1
KR_6736722933,440,-6,-90,-52,-12,-6,10,4,-3,5,2,1,0,1,-1,2,1,-3,5,2,-2,-2,4,-1,-5,6,-4,0,-2,-1,-1,-1,1,5,-1
KR_6746916627,420,-6,-87,4,-13,-1,3,2,-6,7,1,-3,3,0,-6,7,1,3,2,5,-2,-14,0,-1,-5,6,-5,0,-3,-1,-1,-1,-1,2,-1
KR_6743364677,420,3,82,3,7,6,0,6,-1,3,2,1,2,3,2,1,3,-1,2,1,0,2,9,-1,-7,8,1,0,1,1,1,1,1,6,-1
KR_6762489127,420,-3,-52,-53,-5,4,1,5,-3,3,0,-1,3,2,-4,4,0,-1,2,1,0,-3,-3,0,-3,3,0,0,-1,-1,-1,-1,1,6,-1
KR_6737996386,420,-6,8,10,-13,-3,3,0,0,3,3,-2,4,2,-6,6,0,-2,2,0,0,-8,-18,-2,-6,8,-1,0,-1,1,1,-1,-1,6,-1
KR_6720157533,420,0,-1,-14,0,2,2,4,0,4,4,-1,3,2,-3,4,1,2,0,2,0,-4,10,1,-5,4,0,0,-1,0,1,1,1,0,-1
KR_6763956590,420,-1,25,32,-2,0,5,5,-1,2,1,-5,9,4,3,1,4,1,1,2,0,-1,-37,4,-8,4,-1,0,2,0,1,1,1,0,-1
KR_6740782513,440,-4,31,-24,0,1,0,1,-3,3,0,1,0,1,1,3,4,0,1,1,0,2,11,-1,-5,6,-3,0,-1,1,-1,-1,1,2,-1
KR_6768281345,420,-4,-54,-20,-3,-2,2,0,-1,4,3,-5,7,2,4,2,6,1,0,1,0,-1,3,2,-5,3,2,0,-3,1,-1,-1,1,3,-1
KR_6760919955,420,2,11,24,3,-1,1,0,2,1,3,0,1,1,3,2,5,-1,1,0,0,5,-3,3,-6,3,-2,0,0,1,1,0,-1,1,-1
KR_6765961754,420,-1,-46,4,-3,0,2,2,-4,5,1,4,0,4,-3,5,2,0,3,3,0,-3,0,-1,-5,6,0,0,0,1,-1,-1,-1,5,-1
KR_6751616638,420,5,61,7,3,2,1,3,5,0,5,0,3,3,-4,5,1,0,1,1,0,-3,4,1,-5,4,-3,0,1,-1,1,1,1,1,-1
KR_6765903985,420,-3,-71,4,-2,0,1,1,-2,5,3,-3,4,1,2,2,4,1,1,2,0,3,-20,0,-8,8,2,0,-2,-1,-1,-1,1,6,-1
KR_6753094066,420,-1,38,-9,1,-2,4,2,0,3,3,1,2,3,1,2,3,1,0,1,1,4,-126,2,-9,7,0,0,1,-1,-1,1,1,1,-1
KR_6616825487,420,-1,-70,-19,-9,-2,3,1,-1,4,3,0,4,4,-2,3,1,-4,5,1,0,-15,13,2,-9,7,-2,0,-1,-1,-1,-1,-1,2,-1
KR_6736290582,420,-4,-79,-11,-10,-2,3,1,-4,7,3,-1,1,0,-3,4,1,0,4,4,0,-6,-5,-1,-6,7,3,0,0,-1,-1,-1,-1,1,-1
KR_6749722896,420,-1,51,-11,-8,3,0,3,-4,5,1,-3,4,1,1,3,4,-5,5,0,0,-15,-27,2,-7,5,-6,0,-1,-1,-1,-1,-1,3,-1
KR_6649732445,420,-7,-73,-79,-8,-4,5,1,-2,7,5,1,2,3,-1,2,1,-2,2,0,0,-8,-132,2,-10,8,3,0,-2,-1,-1,-1,-1,2,-1
KR_6734613002,420,1,-3,34,-9,-5,5,0,1,2,3,2,0,2,-6,6,0,-1,1,0,0,-11,-7,-6,-3,9,0,0,-1,-1,-1,-1,-1,1,-1
KR_6765598912,420,1,21,20,-4,1,1,2,-1,2,1,-6,7,1,0,2,2,2,0,2,0,7,-1,-2,-3,5,0,0,0,-1,1,1,1,2,-1
KR_6764107600,420,1,-28,26,-1,3,0,3,-2,4,2,-1,4,3,-4,5,1,3,1,4,0,-4,-105,-2,-4,6,0,0,-3,-1,-1,-1,-1,2,-1
KR_6763408653,440,0,-31,-20,-7,-3,3,0,4,0,4,-1,1,0,-3,8,5,-4,4,0,0,1,1,-1,-4,5,-1,0,-3,-1,-1,-1,-1,3,-1
KR_6764269874,440,-3,-18,-8,-6,1,1,2,-2,3,1,-2,4,2,-2,9,7,-1,1,0,0,-12,0,0,-3,3,0,0,-1,1,-1,-1,-1,5,-1
KR_6768063259,420,-1,9,-3,-8,2,2,4,0,2,2,-4,4,0,-7,7,0,1,0,1,0,-14,2,2,-6,4,-2,0,1,-1,1,1,-1,5,-1
KR_6768023426,420,-3,-35,-32,-1,0,0,0,-1,2,1,-1,4,3,-3,3,0,4,1,5,1,-4,5,-1,-5,6,2,0,-1,1,-1,-1,1,6,-1
KR_6748920503,420,3,-51,16,2,-3,4,1,1,1,2,1,2,3,1,3,4,2,0,2,0,5,0,2,-6,4,3,0,1,1,-1,1,1,5,-1
KR_6760925263,420,-1,26,0,-2,3,1,4,1,1,2,-3,5,2,-4,5,1,1,2,3,0,-11,6,3,-6,3,-3,0,1,1,1,1,1,6,-1
KR_6692199822,420,-2,-40,-11,-4,-4,5,1,1,3,4,-1,2,1,0,3,3,0,0,0,1,3,-12,-1,-5,6,5,0,-2,1,1,-1,1,3,-1
KR_6743385428,420,4,51,-8,3,3,2,5,0,2,2,4,2,6,-4,5,1,0,0,0,0,10,3,-2,-4,6,4,0,0,1,1,1,-1,2,-1
KR_6736429386,420,-2,-34,15,-7,-10,10,0,0,3,3,-1,2,1,3,2,5,1,0,1,0,-2,-15,3,-4,1,0,0,-1,1,-1,-1,-1,6,-1
KR_6747761885,420,-3,-75,13,-7,0,3,3,0,3,3,-2,4,2,-2,4,2,-3,3,0,0,-10,13,1,-7,6,-9,0,-2,1,-1,-1,1,2,-1
KR_6760896397,420,0,-5,-7,-4,-3,3,0,-1,3,2,-1,3,2,0,3,3,1,0,1,-2,-7,-12,-2,-4,6,4,0,0,1,-1,0,-1,6,-1
KR_6755726160,420,-2,-34,-5,-5,-6,7,1,5,0,5,-1,1,0,-3,4,1,0,3,3,0,1,-7,-2,-5,7,-6,0,-2,-1,-1,-1,-1,1,-1
KR_6754207087,420,-2,-63,-32,-7,2,1,3,-1,2,1,1,0,1,-6,7,1,-3,3,0,-1,-14,1,-3,-5,8,-2,0,0,-1,1,1,-1,1,-1
KR_6707648374,420,-4,-71,-5,1,-1,3,2,-1,5,4,-1,4,3,3,0,3,1,0,1,0,8,-1,0,-7,7,-5,0,-3,-1,-1,-1,-1,1,-1
KR_6745691567,420,-1,-37,-1,-10,-5,6,1,1,1,2,-1,3,2,-7,9,2,2,0,2,0,-7,-223,-3,-5,8,3,0,-3,-1,-1,-1,1,3,-1
KR_6760419281,420,-4,-41,-12,-1,-2,4,2,-1,2,1,1,1,2,0,0,0,1,0,1,0,3,24,6,-8,2,-7,0,-1,-1,-1,-1,1,5,-1
KR_6767333032,420,-2,-27,-24,-6,-1,1,0,-2,4,2,1,1,2,-2,3,1,-2,2,0,0,-8,0,-4,-6,10,1,0,0,-1,1,-1,-1,4,-1
KR_6738848408,420,-1,-107,-7,-11,-1,4,3,-7,9,2,4,2,6,-7,10,3,0,0,0,0,-8,-225,1,-8,7,2,0,-2,1,-1,-1,-1,2,-1
KR_6751672100,420,-3,-71,-24,-7,-1,1,0,1,2,3,-5,6,1,-1,5,4,-1,2,1,0,-5,-26,0,-6,6,-4,0,-1,-1,-1,-1,-1,4,-1
KR_6758988581,440,-2,-28,-6,-10,-1,1,0,-10,11,1,-2,4,2,3,0,3,0,0,0,0,-15,-6,1,-2,1,-3,0,-1,-1,1,-1,-1,4,-1
KR_6740457097,420,-6,-17,-8,-1,2,0,2,-3,6,3,1,2,3,0,2,2,-1,2,1,0,-4,-73,-2,-3,5,-2,0,0,-1,1,1,1,1,-1
KR_6677448397,420,2,-3,-17,9,1,3,4,8,0,8,0,3,3,-1,2,1,1,0,1,0,17,1,2,-6,4,-1,0,2,-1,1,1,-1,2,-1
KR_6766302460,420,0,-23,-22,0,2,2,4,-2,3,1,4,2,6,-4,5,1,0,0,0,0,1,155,-2,-1,3,6,0,-1,-1,-1,-1,1,2,-1
KR_6758952425,420,-1,-38,12,-2,0,0,0,1,2,3,-2,3,1,-1,5,4,0,1,1,-1,-3,10,-6,-1,7,2,0,0,-1,1,-1,-1,6,-1
KR_6694572801,420,0,12,-5,-1,2,2,4,0,1,1,8,1,9,-7,8,1,-4,4,0,0,0,15,-3,-4,7,-1,0,2,-1,-1,1,-1,6,-1
KR_6767752549,420,0,49,-1,-4,1,1,2,-4,8,4,-2,7,5,0,3,3,1,1,2,-1,-8,4,3,-5,2,1,0,1,1,1,1,-1,4,-1
KR_6764509557,420,2,-34,19,3,-4,5,1,0,3,3,1,2,3,5,2,7,1,0,1,0,12,26,-2,-6,8,3,0,0,1,-1,-1,-1,6,-1
KR_6705603610,420,0,54,-15,-8,3,0,3,-3,4,1,-2,3,1,-4,5,1,-2,2,0,0,-11,14,-2,-5,7,1,0,1,-1,1,1,1,1,-1
KR_6765546863,420,2,24,-41,-3,-3,4,1,2,2,4,-2,4,2,0,1,1,0,1,1,0,4,43,-1,-4,5,-25,0,0,-1,1,0,-1,3,-1
KR_6757318235,420,-1,-23,-8,-1,0,1,1,-1,2,1,3,0,3,-4,6,2,1,1,2,1,4,3,1,-7,6,0,0,0,-1,1,0,1,2,-1
KR_6766870090,420,-3,0,-11,-2,2,1,3,0,4,4,-2,9,7,-1,2,1,-1,1,0,1,-4,-2,-4,-3,7,-1,0,0,-1,1,0,1,6,-1
KR_6766989933,420,-1,27,-28,-10,2,1,3,0,2,2,-2,2,0,-10,13,3,0,2,2,0,-14,-8,-9,-5,14,7,0,2,-1,1,1,1,1,-1
KR_6758712784,420,4,39,-5,2,0,1,1,1,4,5,-1,2,1,5,1,6,-3,3,0,0,3,-11,-5,-4,9,5,0,1,-1,1,1,1,5,-1
KR_6698119976,420,-4,-18,-12,-8,-1,2,1,0,1,1,-3,3,0,-3,4,1,-1,1,0,0,-15,-9,0,-8,8,-1,0,0,1,-1,1,-1,2,-1
KR_6719067506,420,0,35,-32,4,0,3,3,-1,5,4,0,2,2,5,1,6,0,0,0,0,-4,-36,-2,-5,7,-4,0,0,1,-1,-1,1,6,-1
KR_6752407365,420,-1,-37,27,-3,-1,2,1,0,1,1,3,0,3,0,1,1,-5,5,0,-1,-3,-1,3,-8,5,5,0,0,1,-1,0,-1,2,-1
KR_6723720869,420,-5,-87,-8,-12,-3,3,0,-4,6,2,-1,1,0,-3,3,0,-1,3,2,0,-13,-1,-4,-3,7,-2,0,-2,0,-1,-1,-1,0,-1
KR_6759890147,420,0,-11,11,-2,0,2,2,-2,3,1,2,0,2,-2,2,0,0,0,0,0,-8,-135,-1,-6,7,-6,0,0,1,-1,0,-1,5,-1
KR_6720013264,420,-7,-87,-21,-17,-7,7,0,-6,8,2,-2,3,1,-1,2,1,-1,1,0,0,-15,-4,-1,-3,4,-2,0,-2,-1,-1,-1,-1,6,-1
KR_6762297263,420,-2,-9,-18,-1,-5,6,1,-1,3,2,4,3,7,0,1,1,1,0,1,-1,-2,0,-2,-4,6,-2,0,0,-1,-1,-1,-1,2,-1
KR_6762923572,440,1,-1,16,6,-7,9,2,3,2,5,5,1,6,2,3,5,3,1,4,0,4,-345,-1,-3,4,-2,0,-1,1,1,1,-1,3,-1
KR_6767674029,420,-5,-3,-21,-9,-3,3,0,-4,5,1,-1,3,2,-1,2,1,0,0,0,0,-16,-18,0,-6,6,2,0,-2,1,-1,-1,-1,2,-1
KR_6597517280,420,-1,-15,22,-3,-1,3,2,-1,2,1,-1,2,1,1,0,1,-1,1,0,0,-2,294,2,-7,5,-2,0,0,1,-1,0,-1,2,-1
KR_6724658878,420,-1,31,-8,-1,3,2,5,-3,8,5,0,4,4,0,1,1,-1,1,0,0,-7,1,-2,-2,4,2,0,0,1,1,1,-1,1,-1
KR_6768975566,420,-1,-104,-1,-15,-7,7,0,1,2,3,-6,6,0,-3,4,1,0,2,2,0,-8,-4,-5,-1,6,-2,0,-3,-1,-1,-1,-1,4,-1
KR_6746292356,420,0,6,-4,-2,3,1,4,1,2,3,1,1,2,-7,9,2,0,1,1,0,-8,-21,1,-5,4,1,0,2,-1,1,1,1,2,-1
KR_6756224947,420,-4,-22,8,-6,-4,7,3,-2,4,2,3,1,4,-4,5,1,1,2,3,-1,-12,-7,-8,-3,11,1,0,-1,-1,1,-1,-1,6,-1
KR_6689956350,420,-2,-15,-40,-3,1,3,4,-3,6,3,2,1,3,1,2,3,-4,5,1,-3,-2,2,-2,-5,7,-1,0,1,-1,-1,1,-1,3,-1
KR_6740032768,440,1,32,24,1,1,2,3,-1,3,2,-5,5,0,2,3,5,4,1,5,0,-8,0,3,-9,6,-8,0,0,-1,1,1,-1,2,-1
KR_6768265077,420,-3,16,-7,-4,0,2,2,-1,5,4,0,3,3,-2,4,2,-1,1,0,0,-7,-20,2,-7,5,6,0,0,-1,1,1,-1,2,-1
KR_6766022959,420,-2,-72,-3,-9,-2,3,1,0,1,1,0,2,2,-4,6,2,-3,3,0,-4,-9,-12,2,-9,7,-7,0,-1,-1,-1,-1,-1,4,-1
KR_6604245648,420,2,24,12,-2,-3,3,0,-1,4,3,0,0,0,3,2,5,-1,2,1,0,-4,-6,-3,-4,7,1,0,0,-1,-1,-1,-1,1,-1
KR_6758231895,420,0,-49,-8,-4,1,0,1,-2,4,2,-3,4,1,-1,4,3,1,0,1,0,-4,-3,-7,-4,11,4,0,0,-1,1,0,-1,3,-1
KR_6745260618,420,1,14,8,-2,-1,4,3,0,3,3,0,0,0,-2,4,2,1,1,2,0,0,-5,-4,-1,5,4,0,-1,-1,-1,-1,-1,1,-1
KR_6761246877,420,-1,15,-1,-5,2,0,2,-5,5,0,0,3,3,-3,5,2,1,0,1,0,-9,6,-8,-2,10,-5,0,-2,-1,-1,-1,-1,3,-1
KR_6750308432,420,-1,1,17,6,0,3,3,-2,3,1,3,3,6,5,1,6,0,1,1,0,13,-10,-5,-6,11,0,0,-1,-1,1,-1,1,4,-1
KR_6758966765,420,2,22,5,4,0,2,2,1,3,4,-4,6,2,7,1,8,0,1,1,0,4,28,5,-10,5,2,0,0,-1,-1,1,1,5,-1
KR_6613339484,420,-2,1,-13,-7,0,5,5,-4,6,2,2,1,3,-5,5,0,0,1,1,-5,-17,-1,3,-10,7,-5,0,-1,1,-1,-1,-1,1,-1
KR_6713279404,420,4,34,20,-3,1,0,1,2,3,5,-6,7,1,-1,4,3,1,1,2,0,-11,-8,0,-8,8,-1,0,0,-1,-1,-1,-1,1,-1
KR_6719897742,420,0,12,-20,8,2,1,3,-3,4,1,4,1,5,5,2,7,0,0,0,4,13,25,3,-10,7,1,0,1,1,1,1,1,2,-1
KR_6759619516,420,-4,-4,-6,-11,-2,3,1,3,1,4,-1,2,1,-4,5,1,-7,8,1,0,-15,-6,3,-9,6,2,0,-1,-1,1,-1,-1,6,-1
KR_6767276299,420,-3,-65,-24,-7,-2,5,3,-2,7,5,-3,3,0,0,1,1,0,1,1,0,-1,-8,2,-8,6,2,0,-1,-1,-1,-1,-1,6,-1
KR_6769153347,420,0,3,10,-2,2,0,2,-1,5,4,-1,4,3,-2,3,1,0,0,0,-1,-1,133,-3,-4,7,-7,0,0,-1,-1,0,-1,6,-1
KR_6685260443,420,-4,-33,-16,-12,-1,3,2,-3,4,1,-1,2,1,-6,7,1,-1,1,0,0,-18,8,-2,-3,5,-1,0,-2,-1,-1,-1,-1,5,-1
KR_6620451441,420,0,32,22,0,2,1,3,-1,4,3,-3,5,2,0,4,4,2,0,2,1,10,-7,-2,-2,4,5,0,-2,1,-1,-1,1,3,-1
KR_6734465624,440,3,63,14,8,1,1,2,4,1,5,-2,3,1,5,0,5,0,2,2,0,9,6,6,-7,1,0,0,3,1,1,1,-1,3,-1
KR_6761972147,420,1,-4,43,-1,5,0,5,-3,3,0,-2,5,3,-1,4,3,0,1,1,0,-9,0,-2,-5,7,0,0,1,1,1,1,-1,5,-1
KR_6761986593,420,-1,2,-19,-1,-1,1,0,-1,4,3,-2,5,3,4,2,6,-1,1,0,0,3,-46,-1,-5,6,4,0,-1,1,-1,-1,1,5,-1
KR_6766085485,420,-2,-47,16,-3,-1,2,1,4,0,4,-1,1,0,-5,9,4,0,0,0,0,-5,25,2,-5,3,-2,0,-1,-1,1,-1,-1,1,-1
KR_6735594057,420,-3,-37,-32,-3,-3,5,2,0,3,3,2,0,2,-4,5,1,2,1,3,0,-3,-52,-4,-1,5,23,0,0,-1,-1,-1,1,4,-1
KR_6743766367,420,1,-3,8,0,0,1,1,-3,4,1,1,3,4,1,2,3,1,1,2,0,-1,1,0,-7,7,4,0,0,-1,1,-1,1,4,-1
KR_6753378648,420,-1,32,-32,-1,-4,6,2,0,3,3,1,2,3,1,2,3,1,0,1,0,-2,-8,-1,-5,6,3,0,-1,-1,-1,-1,-1,2,-1
KR_6672103200,420,2,-22,7,-4,0,2,2,2,0,2,-3,5,2,-3,4,1,0,0,0,0,0,-2,1,-9,8,-2,0,0,-1,1,0,-1,6,-1
KR_6753534486,420,-2,-12,27,-10,0,1,1,-1,5,4,-2,5,3,-4,5,1,-3,7,4,-1,-21,-11,0,-7,7,-2,0,-3,-1,-1,-1,-1,3,-1
KR_6765619533,420,-1,-42,27,-6,2,0,2,-13,14,1,4,2,6,-3,5,2,4,0,4,0,-18,21,0,-6,6,-4,0,0,-1,1,0,-1,2,-1
KR_6756850974,420,4,33,24,8,-2,5,3,2,1,3,-5,5,0,12,1,13,1,0,1,-1,8,31,6,-10,4,-6,0,0,1,-1,1,-1,5,-1
KR_6720986261,440,-3,-50,-26,0,1,1,2,0,1,1,-2,3,1,2,0,2,-1,1,0,0,-3,-2,1,-9,8,-2,0,0,-1,-1,-1,1,2,-1
KR_6768121537,420,-4,-30,4,-3,0,1,1,0,3,3,-7,9,2,4,4,8,0,2,2,0,-11,15,0,-5,5,2,0,1,-1,1,1,1,5,-1
KR_6765228377,440,-10,-122,-19,-5,-2,2,0,-1,6,5,0,3,3,1,0,1,-3,3,0,1,-3,-6,-4,0,4,1,0,-4,-1,-1,-1,1,3,-1
KR_6764214204,420,4,-9,12,11,1,2,3,5,1,6,2,0,2,2,1,3,1,0,1,1,20,2,2,-7,5,3,0,0,1,-1,0,1,4,-1
KR_6636907750,420,-1,-22,-20,-3,0,2,2,-3,4,1,-2,4,2,-1,4,3,3,0,3,0,0,-16,4,-9,5,-4,0,1,-1,1,1,-1,2,-1
KR_6724488177,420,2,53,-19,-6,-3,3,0,-1,5,4,-5,5,0,3,1,4,0,0,0,0,2,-4,1,-6,5,2,0,0,-1,-1,0,-1,5,-1
KR_6761625764,420,-5,-85,-4,-10,-2,2,0,5,0,5,-6,6,0,-5,6,1,-2,2,0,0,-1,40,3,-9,6,-2,0,-1,1,-1,-1,-1,1,-1
KR_6730892376,420,-1,-33,22,-5,-6,8,2,0,2,2,0,1,1,6,0,6,-5,5,0,0,-3,-9,0,-7,7,4,0,0,1,1,-1,-1,1,-1
KR_6759394406,420,2,-12,16,-1,1,0,1,-1,1,0,0,3,3,2,1,3,-3,4,1,0,1,-112,2,-9,7,-8,0,0,1,-1,0,1,6,-1
KR_6764930282,420,5,31,31,4,0,0,0,3,3,6,3,2,5,-3,7,4,1,0,1,1,17,-1,-1,-4,5,1,0,-1,1,-1,-1,-1,6,-1
KR_6768873209,420,-5,-42,0,-6,-2,4,2,1,0,1,1,2,3,1,2,3,-7,7,0,0,2,11,3,-8,5,0,0,-2,1,-1,-1,1,4,-1
KR_6651066280,420,2,33,12,6,-2,3,1,2,2,4,3,1,4,-1,2,1,4,0,4,0,6,98,-3,-2,5,-5,0,2,1,1,1,1,6,-1
KR_6757685483,420,-3,-41,-12,-8,-3,6,3,-2,3,1,-1,1,0,0,5,5,-2,3,1,1,-3,-172,0,-6,6,-1,0,-1,1,-1,-1,1,3,-1
KR_6728939068,440,-1,-28,-3,-2,-5,6,1,-3,6,3,-1,4,3,7,0,7,0,0,0,0,11,0,3,-7,4,6,0,-2,0,-1,-1,-1,0,-1
KR_6762564564,420,-5,-124,-3,-14,3,0,3,0,2,2,-9,9,0,-7,9,2,-1,1,0,0,-12,-19,-13,0,13,0,0,-2,-1,1,-1,-1,2,-1
KR_6768514163,420,-1,-2,0,-7,-3,5,2,-1,3,2,-1,1,0,-3,4,1,1,0,1,0,-8,8,2,-6,4,-2,0,-1,1,-1,-1,1,4,-1
KR_6768489328,420,-4,-67,-28,1,0,1,1,-3,5,2,1,1,2,3,1,4,0,0,0,0,0,20,0,-6,6,-6,0,-1,-1,-1,-1,1,3,-1
KR_6638045738,420,0,16,24,-8,-6,6,0,0,2,2,-3,3,0,2,4,6,-1,4,3,0,-4,-4,-3,-4,7,2,0,-2,1,1,-1,-1,5,-1
KR_6706503831,420,2,18,-8,7,0,1,1,-1,2,1,2,1,3,5,0,5,1,1,2,0,4,1,5,-8,3,-2,0,0,1,-1,-1,1,1,-1
KR_6760536343,420,2,50,6,-1,5,0,5,-2,4,2,-1,2,1,-3,5,2,0,2,2,-1,-10,-1,-1,-7,8,7,0,0,1,-1,1,-1,1,-1
KR_6730842469,420,-2,-46,3,-4,-2,5,3,-6,6,0,3,2,5,0,1,1,1,0,1,0,3,-2,4,-7,3,-3,0,0,1,1,0,1,5,-1
KR_6734239220,420,-2,-49,4,1,1,0,1,0,2,2,4,1,5,-4,5,1,0,1,1,0,-1,-19,2,-5,3,-3,0,-1,1,-1,-1,1,2,-1
KR_6737261849,440,-2,-23,-1,-3,-2,2,0,-1,2,1,-2,3,1,4,4,8,-2,3,1,0,-2,-9,0,-5,5,3,0,-1,1,-1,-1,-1,5,-1
KR_6723187836,420,2,66,-3,2,-3,4,1,4,1,5,3,1,4,1,4,5,-3,3,0,-1,4,-5,1,-9,8,-2,0,-1,1,-1,-1,-1,6,-1
KR_6767461584,420,-3,-12,-8,-9,-3,3,0,-5,6,1,-4,6,2,-4,6,2,7,0,7,-1,-13,13,1,-6,5,-2,0,0,-1,-1,0,-1,6,-1
KR_6765539688,420,-3,-67,-8,-8,-1,3,2,-3,4,1,3,3,6,-4,5,1,-3,3,0,0,-2,7,-2,-5,7,1,0,-1,-1,1,-1,-1,2,-1
KR_6753920865,420,0,-11,-21,-2,3,1,4,2,2,4,-1,1,0,-5,5,0,-1,1,0,0,-7,5,-1,-8,9,-3,0,0,-1,-1,1,1,3,-1
KR_6767185058,420,3,69,38,4,1,3,4,0,4,4,1,2,3,3,1,4,-1,2,1,0,0,1,0,-6,6,-4,0,0,-1,1,0,1,6,-1
KR_6755658308,420,-1,-51,-3,-4,-2,4,2,0,5,5,-1,2,1,1,1,2,-2,2,0,-1,-1,1,0,-8,8,3,0,0,1,-1,0,-1,2,-1
KR_6768443164,420,1,-13,28,-3,-3,4,1,-4,4,0,-2,3,1,4,3,7,2,0,2,0,-12,3,4,-10,6,-2,0,0,-1,1,1,-1,2,-1
KR_6765431742,420,-2,18,6,-3,1,0,1,-2,4,2,-1,3,2,-2,4,2,1,1,2,1,-11,-29,3,-9,6,-6,0,0,1,1,0,1,3,-1
KR_6759663814,440,-2,9,-23,-3,0,0,0,0,3,3,-3,3,0,-2,2,0,2,1,3,0,-5,3,6,-6,0,-3,0,-1,-1,1,1,1,2,-1
KR_6765616555,420,-1,20,-14,-8,-2,2,0,-1,2,1,-2,3,1,-4,5,1,1,0,1,-1,-11,-113,-3,0,3,-2,0,0,-1,-1,1,-1,1,-1
KR_6762273435,420,-2,-5,-24,-5,0,3,3,0,2,2,-1,2,1,-4,6,2,0,0,0,0,-2,-6,-3,-4,7,1,0,-1,1,-1,-1,-1,1,-1
KR_6764340210,440,3,-48,0,6,-2,3,1,4,0,4,2,2,4,4,2,6,-2,4,2,0,2,2,2,-3,1,-5,0,1,0,0,1,-1,0,-1
KR_6621087826,420,-2,-1,10,-2,-2,2,0,0,2,2,-3,4,1,4,0,4,-1,2,1,0,1,1,0,-7,7,1,0,0,1,-1,1,-1,1,-1
KR_6767689771,420,0,-47,-16,-5,-5,6,1,-1,4,3,0,5,5,0,3,3,1,1,2,0,9,-15,2,-6,4,-4,0,-2,-1,-1,-1,-1,2,-1
KR_6761457096,440,0,-20,4,-3,1,1,2,-1,2,1,-2,3,1,-1,3,2,0,0,0,0,-7,-24,-5,-2,7,-26,0,0,-1,-1,0,-1,2,-1
KR_6597546197,420,-1,-19,-15,0,0,3,3,-3,5,2,-1,1,0,2,1,3,2,0,2,0,-2,-6,6,-11,5,-4,0,0,1,-1,0,-1,1,-1
KR_6762252696,420,-2,22,-13,-6,-5,6,1,0,3,3,1,1,2,-1,5,4,-1,1,0,0,-1,-7,-2,-5,7,-5,0,-1,-1,-1,-1,-1,3,-1
KR_6763803721,420,-2,-77,-17,-10,2,1,3,-1,4,3,-10,13,3,-1,3,2,0,0,0,0,0,-39,3,-6,3,-2,0,-1,1,1,-1,-1,2,-1
KR_6717031040,420,-3,-40,48,-8,-1,3,2,-1,5,4,-2,3,1,-4,6,2,0,3,3,-1,-14,-9,-6,-3,9,-4,0,-1,-1,1,-1,1,5,-1
KR_6734651364,420,-1,-56,-21,-1,-3,3,0,1,2,3,-2,8,6,2,1,3,1,1,2,2,12,4,1,-8,7,7,0,-1,1,-1,-1,1,2,-1
KR_6672678270,440,-2,-29,12,-5,3,4,7,0,2,2,-4,5,1,2,4,6,-6,7,1,2,8,11,5,-7,2,-2,0,0,-1,1,-1,1,2,-1
KR_6733013536,420,-3,-12,-4,-1,1,2,3,0,3,3,0,1,1,-3,4,1,1,0,1,0,-1,-2,2,-7,5,4,0,0,1,-1,1,1,2,-1
KR_6721267241,420,1,11,17,-5,0,2,2,1,4,5,0,1,1,-3,4,1,-3,3,0,1,-5,40,-5,-2,7,3,0,1,-1,1,1,1,2,-1
KR_6693164123,420,-4,-94,-36,-16,-3,5,2,-5,7,2,1,2,3,-5,7,2,-4,4,0,-1,-7,105,0,-10,10,2,0,-3,1,-1,-1,1,6,-1
KR_6759224779,420,0,-61,-7,2,-1,1,0,2,0,2,1,2,3,1,3,4,-1,2,1,-1,-1,6,1,-6,5,-2,0,0,-1,1,0,-1,5,-1
KR_6768888955,420,0,-22,-32,-3,3,1,4,-4,5,1,-6,9,3,1,3,4,3,1,4,0,-2,13,-2,-3,5,5,0,-1,-1,-1,-1,1,6,-1
KR_6735053800,420,2,46,26,13,2,2,4,4,2,6,1,1,2,3,1,4,3,0,3,0,14,-5,-4,-3,7,3,0,1,1,1,1,1,6,-1
KR_6752809808,420,-1,19,20,-2,-2,2,0,1,3,4,-1,1,0,-1,3,2,1,2,3,0,-5,-40,0,-6,6,-2,0,0,1,0,0,-1,1,-1
KR_6760543680,420,0,-17,-8,-5,-1,1,0,-2,3,1,0,2,2,-3,6,3,1,0,1,0,-2,41,1,-6,5,-2,0,0,-1,-1,0,-1,1,-1
KR_6768657702,420,5,57,28,6,5,0,5,-1,2,1,1,0,1,-1,4,3,2,0,2,0,1,2,-1,-1,2,-3,0,2,1,1,1,1,5,-1
KR_6763496739,440,-3,8,3,-12,-3,4,1,-2,8,6,-11,12,1,4,4,8,0,1,1,-3,-13,-1,2,-5,3,1,0,0,-1,0,1,1,4,-1
KR_6758289437,420,0,54,-55,4,0,0,0,4,1,5,-2,4,2,2,5,7,0,3,3,0,10,-16,2,-5,3,1,0,1,1,-1,1,-1,6,-1
KR_6769108559,420,1,-29,15,3,-2,2,0,3,0,3,2,3,5,1,4,5,-1,1,0,0,1,36,-5,-1,6,-1,0,0,-1,1,1,-1,6,-1
KR_6763132508,420,0,-29,-1,-8,-1,4,3,-3,5,2,-3,4,1,-1,7,6,0,0,0,0,-10,-8,-8,-4,12,4,0,-1,-1,-1,-1,-1,3,-1
KR_6637846589,420,2,14,-24,7,1,0,1,0,3,3,3,1,4,1,3,4,2,1,3,0,11,-26,-1,-5,6,1,0,1,1,-1,1,1,6,-1
KR_6764726727,420,0,-17,2,-1,-1,3,2,2,2,4,-4,4,0,3,2,5,-1,3,2,0,-1,58,1,-7,6,-2,0,-1,1,-1,-1,1,3,-1
KR_6767356850,420,-1,48,0,5,3,3,6,-2,2,0,3,2,5,3,1,4,-2,2,0,-1,-8,10,0,-3,3,-4,0,-1,0,-1,-1,-1,0,-1
KR_6708030924,420,-2,-26,-16,-3,2,1,3,-2,5,3,0,1,1,-3,5,2,0,0,0,0,-16,4,4,-8,4,1,0,0,-1,1,0,-1,3,-1
KR_6652905124,420,-6,-40,-63,-8,-1,1,0,-6,7,1,-3,3,0,3,1,4,-1,2,1,-1,-12,-7,-2,-6,8,2,0,-3,-1,-1,-1,-1,1,-1
KR_6760743044,420,-4,-45,3,-9,-1,1,0,-3,4,1,3,1,4,-7,8,1,-1,1,0,0,-19,-74,-5,-3,8,0,0,-1,-1,-1,-1,-1,6,-1
KR_6761345384,420,-4,-24,-16,-11,3,2,5,-6,6,0,-2,4,2,-6,6,0,0,1,1,0,-9,-4,1,-10,9,-3,0,-1,-1,-1,-1,1,1,-1
KR_6763858889,420,2,-26,4,-5,1,2,3,-6,7,1,2,1,3,-2,6,4,0,2,2,0,-6,36,-4,-1,5,-1,0,-1,-1,-1,-1,-1,2,-1
KR_6695197700,420,-2,-37,-12,-3,2,2,4,4,3,7,-6,6,0,1,3,4,-4,4,0,-2,-3,-10,0,-7,7,-2,0,-1,-1,1,-1,-1,2,-1
KR_6761321123,420,2,-18,-10,8,3,0,3,1,4,5,3,3,6,2,2,4,-1,2,1,2,6,49,0,-5,5,5,0,1,1,1,1,1,4,-1
KR_6768227633,420,-5,-42,-16,-14,-4,4,0,-1,3,2,-2,4,2,-6,6,0,-1,1,0,0,-13,12,-3,-5,8,-3,0,-1,-1,-1,-1,-1,6,-1
KR_6741782098,420,-3,-50,-12,-6,-1,1,0,-5,8,3,1,2,3,0,2,2,-1,2,1,0,-1,56,0,-6,6,-3,0,-3,-1,-1,-1,-1,3,-1
KR_6768227929,420,-7,-97,-24,-14,0,5,5,-9,9,0,-4,6,2,0,0,0,-1,1,0,0,-14,-9,-6,-3,9,0,0,-2,-1,-1,-1,-1,3,-1
KR_6743523081,420,0,3,-10,4,-2,3,1,2,2,4,1,1,2,3,0,3,0,0,0,0,10,12,-1,-7,8,6,0,0,1,-1,0,1,6,-1
KR_6751210075,440,-1,-12,-27,3,2,1,3,0,3,3,0,1,1,-1,2,1,2,0,2,0,6,-39,-2,-7,9,3,0,1,0,1,1,-1,0,-1
KR_6732787571,440,-2,-90,-4,-6,3,2,5,-9,10,1,1,1,2,-2,4,2,1,1,2,0,-9,0,5,-10,5,4,0,-2,-1,0,-1,1,3,-1
KR_6763630346,420,1,1,24,0,0,2,2,2,4,6,-1,1,0,1,2,3,-2,2,0,0,2,-17,-1,-4,5,6,0,0,-1,1,0,1,2,-1
KR_6757423752,420,3,-13,-14,2,5,0,5,1,4,5,1,0,1,-6,7,1,1,1,2,0,12,-2,3,-4,1,4,0,0,1,-1,1,1,4,-1
KR_6659128259,420,-3,-32,3,0,-1,2,1,1,3,4,-4,5,1,3,1,4,1,0,1,0,3,11,4,-10,6,-5,0,0,1,-1,-1,-1,1,-1
KR_6749097442,420,-6,-94,3,-12,0,2,2,1,3,4,-5,5,0,-6,7,1,-2,4,2,0,-9,4,3,-8,5,-4,0,0,1,1,1,-1,6,-1
KR_6715534133,420,0,-81,-24,-5,-1,3,2,-7,7,0,0,4,4,2,0,2,1,1,2,0,-2,0,-1,-5,6,0,0,-2,-1,-1,-1,-1,5,-1
KR_6762346274,420,6,39,-4,9,0,2,2,5,1,6,3,1,4,3,0,3,-2,3,1,0,10,-2,-1,-5,6,2,0,1,0,1,1,1,0,-1
KR_6713238969,420,1,-47,-22,9,3,0,3,6,3,9,0,2,2,-3,6,3,3,0,3,0,5,-5,-2,-5,7,0,0,2,-1,1,1,-1,3,-1
KR_6730458077,440,-2,49,-16,4,3,0,3,-5,5,0,3,0,3,2,5,7,1,1,2,3,-5,269,5,-7,2,3,0,0,-1,1,0,1,1,-1
KR_6732338406,420,-7,-109,-33,-19,-4,4,0,-5,5,0,-1,3,2,-7,8,1,-2,2,0,0,-9,-6,-3,-3,6,-3,0,-2,-1,-1,-1,-1,4,-1
KR_6767095921,420,-2,-57,-24,-4,2,0,2,-1,3,2,-2,4,2,-4,5,1,1,0,1,0,-7,21,-9,-2,11,-2,0,0,1,-1,0,1,6,-1
KR_6767558333,420,-3,-16,-25,-6,-4,4,0,-1,1,0,0,1,1,2,4,6,-3,3,0,0,-9,-10,3,-5,2,-3,0,0,1,-1,-1,1,2,-1
KR_6732943657,420,-5,-124,-20,-4,-2,3,1,0,1,1,-4,5,1,2,0,2,0,0,0,0,1,4,-1,-2,3,-4,0,-2,-1,-1,-1,-1,1,-1
KR_6754483689,420,-4,-70,-16,-5,2,0,2,1,2,3,-4,7,3,-4,6,2,0,0,0,0,-7,1,-3,-3,6,4,0,-1,-1,1,-1,1,2,-1
KR_6729038397,420,-2,44,-4,-9,1,3,4,3,2,5,-5,7,2,-4,6,2,-4,4,0,0,-3,-2,3,-8,5,-1,0,0,-1,1,-1,1,1,-1
KR_6748396301,440,1,44,-45,9,6,1,7,-3,3,0,5,2,7,0,2,2,1,0,1,0,3,-169,-5,-1,6,2,0,1,1,1,1,1,3,-1
KR_6765046958,420,-1,-82,13,-4,0,1,1,-2,4,2,1,2,3,-3,4,1,0,1,1,0,-9,-2,0,-7,7,0,0,0,1,-1,0,-1,4,-1
KR_6708059156,420,-2,-46,30,-9,-1,1,0,-4,7,3,-3,3,0,0,3,3,-1,1,0,0,-10,-5,0,-9,9,-11,0,-2,1,-1,-1,-1,6,-1
KR_6754611871,420,0,6,-5,-4,1,2,3,0,1,1,-5,6,1,1,4,5,-1,2,1,-1,0,-7,-4,-4,8,0,0,-1,-1,1,-1,-1,2,-1
KR_6740795487,420,-3,0,18,-6,-1,1,0,-3,3,0,-1,2,1,-1,2,1,0,2,2,0,-6,-5,-7,-3,10,1,0,-1,1,-1,-1,-1,6,-1
KR_6768806563,420,0,-19,12,2,6,2,8,0,2,2,-2,4,2,-1,3,2,-1,1,0,0,0,-7,-3,-4,7,5,0,-1,-1,1,-1,1,4,-1
KR_6755859086,420,-1,23,-8,-4,-1,5,4,1,0,1,-1,3,2,-2,3,1,-1,1,0,0,-1,8,5,-8,3,-3,0,0,-1,-1,0,1,2,-1
KR_6667089853,420,-1,51,-20,4,2,2,4,1,2,3,-1,4,3,2,0,2,0,0,0,1,11,-2,0,-6,6,2,0,-1,-1,1,-1,1,6,-1
KR_6744909721,420,-3,-20,-7,2,1,1,2,2,4,6,-1,5,4,0,4,4,0,2,2,1,4,13,5,-10,5,-8,0,0,1,-1,0,1,6,-1
KR_6623386211,420,-3,-63,0,-12,-3,6,3,-4,6,2,0,1,1,-4,4,0,-1,2,1,0,-13,44,0,-5,5,-17,0,-1,-1,1,-1,-1,5,-1
KR_6690010596,420,0,-3,-33,0,0,3,3,-1,4,3,-1,2,1,2,0,2,0,0,0,-1,1,-22,3,-8,5,5,0,0,1,-1,1,-1,1,-1
KR_6763509876,420,-1,-41,-8,-7,0,2,2,-1,6,5,2,1,3,-7,8,1,-1,1,0,0,-15,16,4,-7,3,-4,0,0,-1,1,1,-1,2,-1
KR_6723676836,420,1,-40,8,-5,1,1,2,-1,2,1,-1,4,3,-5,7,2,1,2,3,-3,-5,168,-2,-6,8,2,0,-1,-1,1,-1,-1,2,-1
KR_6762939927,420,3,53,-24,10,0,1,1,8,2,10,-1,3,2,-1,1,0,4,0,4,0,10,19,0,-7,7,0,0,1,-1,0,1,1,3,-1
KR_6727821524,420,0,2,-59,-5,-4,5,1,2,2,4,-3,4,1,-3,6,3,3,0,3,-1,-8,10,0,-3,3,0,0,0,-1,1,1,-1,5,-1
KR_6650108802,420,-3,-53,-18,-5,1,1,2,1,2,3,-8,11,3,4,2,6,-3,3,0,0,1,-6,0,-4,4,-4,0,-2,0,-1,-1,-1,0,-1
KR_6767717275,420,-2,17,-11,1,4,0,4,0,2,2,-4,7,3,2,1,3,-1,2,1,0,-5,3,-1,-6,7,-8,0,2,-1,1,1,1,1,-1
KR_6767545401,420,-1,-69,27,3,-1,1,0,-3,4,1,4,1,5,2,1,3,1,0,1,0,13,0,-1,-5,6,-2,0,-1,-1,-1,-1,1,4,-1
KR_6769085235,420,1,17,-15,1,7,1,8,-3,5,2,-4,4,0,0,1,1,1,2,3,0,6,0,-5,-4,9,2,0,-1,1,-1,-1,-1,3,-1
KR_6762588493,420,-6,-78,-4,-8,-3,4,1,-1,4,3,-5,5,0,-1,2,1,2,2,4,0,-10,-52,3,-6,3,16,0,-3,-1,-1,-1,-1,4,-1
KR_6667834091,420,-5,29,21,-5,-2,2,0,-2,6,4,0,1,1,-2,2,0,1,1,2,0,-1,41,4,-7,3,-5,0,0,1,-1,0,-1,2,-1
KR_6768728188,420,1,-42,-7,-1,1,1,2,0,4,4,1,1,2,-1,7,6,-2,2,0,0,0,8,1,-4,3,-3,0,-1,-1,1,-1,-1,2,-1
KR_6717882980,420,-3,-60,-45,2,-1,1,0,-1,6,5,5,1,6,0,2,2,-1,3,2,0,-1,2,6,-11,5,-3,0,-1,1,1,-1,-1,3,-1
KR_6751259373,440,0,7,4,-7,-5,7,2,2,0,2,-1,3,2,-4,6,2,1,0,1,0,-4,3,0,-5,5,1,0,-1,-1,-1,-1,-1,6,-1
KR_6766242063,420,1,23,-14,14,1,0,1,2,2,4,2,3,5,7,0,7,2,0,2,1,17,-1,3,-9,6,1,0,1,1,0,1,1,2,-1
KR_6768796889,420,-3,-66,0,-3,-2,2,0,-1,4,3,2,1,3,-1,3,2,-1,2,1,-1,-3,62,-4,-3,7,-2,0,-2,-1,1,-1,-1,6,-1
KR_6762158090,420,-1,-10,-12,1,1,3,4,0,2,2,3,3,6,0,0,0,-3,3,0,-2,-2,9,6,-12,6,-2,0,0,1,0,0,-1,1,-1
KR_6753711275,420,0,25,-15,-1,2,1,3,-7,9,2,2,0,2,3,1,4,-1,1,0,0,-2,0,-4,-2,6,1,0,1,-1,1,1,1,1,-1
KR_6765235792,420,1,33,-16,-4,2,0,2,-3,4,1,-1,1,0,1,6,7,-3,3,0,1,-7,-134,3,-8,5,3,0,0,-1,1,-1,1,3,-1
KR_6647215770,420,0,-76,-39,2,0,2,2,3,2,5,1,0,1,0,2,2,-2,2,0,0,6,4,0,-8,8,-6,0,-1,-1,-1,-1,-1,5,-1
KR_6766155883,420,0,2,-12,6,6,1,7,0,2,2,0,1,1,-3,6,3,3,0,3,0,-1,3,2,-6,4,1,0,-1,1,-1,1,1,4,-1
KR_6745042217,440,-1,-74,11,-2,-3,4,1,5,2,7,-3,3,0,2,2,4,-3,3,0,2,9,14,1,-5,4,3,0,-2,0,0,-1,1,0,-1
KR_6640259317,420,-5,-9,-7,-7,-2,3,1,-3,5,2,1,2,3,-2,6,4,-1,1,0,0,-7,3,-3,-5,8,-3,0,0,1,1,0,1,6,-1
KR_6760034300,420,1,54,4,-4,1,0,1,-3,5,2,-1,5,4,-1,2,1,0,2,2,0,-6,-32,4,-5,1,-3,0,0,-1,-1,1,1,5,-1
KR_6768031098,420,-3,-10,-4,-6,-1,2,1,-3,5,2,-2,2,0,2,2,4,-2,2,0,0,-8,19,-1,-5,6,2,0,-1,1,-1,-1,1,2,-1
KR_6749986906,420,-7,-65,-4,-18,1,4,5,-8,11,3,-5,5,0,-5,5,0,-1,1,0,0,-17,-25,-2,-4,6,-3,0,-1,1,-1,-1,-1,4,-1
KR_6763349325,420,0,-20,49,-4,2,1,3,-7,9,2,0,5,5,-2,3,1,3,0,3,0,-6,1,-2,-5,7,0,0,-1,-1,1,-1,-1,6,-1
KR_6759626591,420,-2,-29,17,-9,-7,8,1,-1,2,1,3,0,3,-4,5,1,0,0,0,0,-10,0,1,-6,5,-4,0,-1,-1,-1,-1,-1,2,-1
KR_6752937920,420,-3,7,-35,-6,0,2,2,-1,3,2,-4,6,2,0,1,1,-1,1,0,0,-8,-23,0,-5,5,-4,0,-1,-1,-1,-1,1,3,-1
KR_6762830373,420,-2,-52,-12,-5,2,3,5,-1,3,2,-6,7,1,2,2,4,-2,5,3,0,-6,-29,-5,-7,12,-3,0,-1,-1,-1,-1,-1,3,-1
KR_6750504791,420,0,32,-9,-2,5,0,5,-3,6,3,-5,9,4,1,0,1,0,0,0,0,0,10,1,-5,4,-1,0,0,-1,-1,0,-1,6,-1
KR_6760367358,420,-3,-10,-20,-5,2,0,2,-2,2,0,-2,3,1,-3,3,0,0,0,0,0,-6,59,6,-9,3,-25,0,-2,-1,-1,-1,-1,5,-1
KR_6708908655,420,0,54,-19,1,2,2,4,1,3,4,0,1,1,-2,2,0,0,0,0,0,1,7,4,-7,3,-4,0,1,1,1,1,-1,4,-1
KR_6764399756,440,-1,36,8,-5,-5,5,0,-1,6,5,-2,7,5,2,2,4,1,1,2,-1,-12,4,-1,-3,4,-1,0,-1,-1,1,-1,-1,3,-1
KR_6624135962,440,-2,-56,3,-4,-2,3,1,1,2,3,-2,4,2,-1,1,0,0,4,4,-1,0,-4,2,-8,6,1,0,0,1,-1,-1,-1,1,-1
KR_6769158103,420,2,20,-9,7,6,2,8,-4,6,2,-1,3,2,5,0,5,1,0,1,2,10,10,3,-5,2,-1,0,3,-1,1,1,1,3,-1
KR_6768939521,420,-2,97,8,-1,3,1,4,0,2,2,-4,5,1,0,1,1,0,1,1,0,0,-5,-2,-5,7,4,0,1,-1,-1,1,1,6,-1
KR_6765523085,420,-4,-22,8,-9,-4,4,0,-2,2,0,0,2,2,-2,4,2,-1,1,0,0,-8,-5,-4,-3,7,-1,0,0,-1,-1,0,-1,4,-1
KR_6755787594,420,3,43,-25,7,2,1,3,2,2,4,1,1,2,-1,2,1,3,0,3,0,9,8,1,-6,5,2,0,0,-1,1,0,1,6,-1
KR_6731710834,420,-4,-30,-13,-10,-2,2,0,0,2,2,-4,4,0,-4,4,0,0,0,0,0,-3,-5,-2,-5,7,-5,0,0,-1,-1,-1,-1,1,-1
KR_6768168735,420,0,2,0,-4,-3,4,1,-2,3,1,-1,3,2,1,5,6,1,1,2,-2,-15,-14,-6,-3,9,1,0,0,-1,1,-1,-1,5,-1
KR_6765919025,420,-4,-54,-4,-10,-3,5,2,-3,4,1,-3,4,1,-5,6,1,4,0,4,-1,-6,-13,-1,-7,8,-7,0,-2,0,-1,-1,-1,0,-1
KR_6738258117,440,-2,-95,-20,-10,-3,3,0,-1,1,0,-3,5,2,-6,9,3,3,0,3,-1,-11,14,-4,-3,7,2,0,0,-1,-1,-1,-1,4,-1
KR_6764749805,420,2,21,2,3,-2,2,0,0,2,2,3,2,5,1,1,2,1,0,1,0,0,10,-4,-1,5,4,0,0,-1,0,1,1,4,-1
KR_6768516678,440,-3,-25,-20,-2,-1,3,2,0,5,5,-1,2,1,-1,4,3,1,1,2,0,7,2,2,-8,6,2,0,0,-1,1,0,-1,4,-1
KR_6762580449,420,-5,-75,-32,-17,-2,4,2,-6,6,0,-8,9,1,-2,4,2,1,1,2,0,-16,12,5,-8,3,-4,0,0,-1,-1,0,1,1,-1
KR_6739624859,420,1,-27,-4,12,1,3,4,7,1,8,0,1,1,2,5,7,2,1,3,0,25,-38,2,-5,3,18,0,-1,1,-1,-1,-1,1,-1
KR_6728469454,440,-3,-56,-16,-5,1,1,2,0,2,2,-3,4,1,0,3,3,-3,3,0,0,-11,-13,-3,-6,9,-2,0,0,0,1,0,1,0,-1
KR_6734439395,420,1,77,-35,5,0,0,0,-2,4,2,1,1,2,5,0,5,1,0,1,1,10,10,5,-10,5,0,0,0,1,1,1,1,6,-1
KR_6761506099,440,-3,-41,-13,-7,-1,2,1,1,0,1,-8,9,1,0,5,5,1,0,1,0,0,-12,-1,-4,5,7,0,0,-1,1,0,-1,1,-1
KR_6754853015,420,-2,-35,26,-5,1,2,3,-2,4,2,0,4,4,-4,4,0,0,1,1,0,-10,7,2,-6,4,-3,0,-1,1,1,-1,-1,2,-1
KR_6722509428,420,-2,8,0,-1,1,1,2,0,4,4,-2,4,2,0,1,1,0,3,3,1,6,6,-2,-5,7,-4,0,0,-1,-1,0,1,1,-1
KR_6762209035,420,-3,-16,0,-1,2,1,3,-2,2,0,-1,3,2,0,2,2,0,1,1,0,-6,130,-4,-4,8,1,0,0,-1,1,0,-1,5,-1
KR_6726522363,420,-1,-36,0,-3,-1,1,0,2,2,4,-2,3,1,-3,4,1,1,1,2,0,-3,10,-2,-5,7,-2,0,-1,-1,1,-1,-1,3,-1
KR_6768805975,420,-3,9,-28,-6,-1,3,2,1,3,4,-2,3,1,0,2,2,-4,4,0,0,-11,-34,-4,-2,6,2,0,0,-1,-1,-1,-1,1,-1
KR_6767762553,420,-1,50,-22,2,4,1,5,0,2,2,-2,4,2,1,1,2,-1,1,0,0,3,12,-1,-4,5,1,0,0,1,-1,0,1,2,-1
KR_6650791357,440,-4,-49,-12,-7,-2,2,0,-2,6,4,3,3,6,-3,6,3,-3,5,2,0,-13,-21,-6,-2,8,0,0,-1,1,-1,-1,-1,1,-1
KR_6729856882,420,-5,-88,-40,-14,-3,6,3,-8,8,0,-7,7,0,3,3,6,1,2,3,-1,-8,12,-2,-2,4,-3,0,-1,-1,-1,-1,-1,6,-1
KR_6654414007,420,1,43,15,4,1,1,2,1,3,4,3,3,6,-2,5,3,1,3,4,1,5,15,-1,-7,8,4,0,0,-1,1,-1,1,5,-1
KR_6735665179,420,0,-2,7,-1,-2,3,1,1,3,4,-4,5,1,1,2,3,3,0,3,0,-2,17,-1,-5,6,-1,0,-1,1,-1,-1,1,5,-1
KR_6732657602,440,-3,-90,-26,-2,3,1,4,2,2,4,5,2,7,0,2,2,-12,13,1,2,0,-3,-1,-3,4,0,0,-1,1,-1,-1,1,2,-1
KR_6726273787,420,0,-24,-4,-6,-2,3,1,-1,2,1,1,0,1,-3,3,0,-1,1,0,0,-10,9,1,-5,4,-1,0,0,1,-1,0,-1,2,-1
KR_6768853587,420,3,-12,-1,-1,4,1,5,-4,4,0,1,2,3,0,1,1,-2,3,1,1,-4,0,-3,-4,7,1,0,0,-1,-1,1,1,1,-1
KR_6764318498,420,-1,-50,35,-3,4,2,6,0,1,1,-4,4,0,-3,3,0,0,1,1,0,-2,18,0,-5,5,-3,0,-1,1,1,-1,-1,2,-1
KR_6764452827,420,0,31,3,2,3,1,4,-3,4,1,-1,3,2,4,0,4,-1,1,0,0,-4,-1,3,-7,4,-4,0,1,1,1,-1,1,5,-1
KR_6756936804,440,1,-41,-12,8,0,2,2,-2,4,2,6,1,7,3,1,4,1,2,3,0,0,-1,0,-4,4,4,0,0,-1,-1,-1,1,1,-1
KR_6727578090,420,-3,-72,-9,-7,-1,3,2,0,3,3,0,3,3,-5,6,1,-1,1,0,0,-6,1,1,-7,6,-8,0,0,-1,1,-1,1,2,-1
KR_6719094933,420,-4,-79,-3,-19,-1,1,0,-6,9,3,-3,4,1,-7,10,3,-2,4,2,0,-20,34,-2,-8,10,3,0,-1,-1,1,-1,-1,3,-1
KR_6751098870,420,2,26,16,-2,2,1,3,0,3,3,-2,3,1,-2,5,3,0,0,0,-2,-7,-6,-1,-7,8,-2,0,1,-1,1,1,-1,4,-1
KR_6767376088,420,-3,-22,3,-11,-5,6,1,-1,4,3,2,3,5,-8,8,0,1,1,2,-1,-11,-13,-4,-4,8,5,0,-2,-1,-1,-1,-1,1,-1
KR_6764761185,420,0,-47,-26,0,0,1,1,-1,3,2,3,0,3,-3,5,2,1,3,4,1,1,6,-5,-5,10,-2,0,1,-1,-1,1,1,3,-1
KR_6660551983,420,-1,-57,19,-5,-3,3,0,-6,6,0,3,3,6,3,2,5,-2,2,0,0,8,-2,1,-9,8,-1,0,-1,-1,-1,-1,-1,4,-1
KR_6758882823,440,-6,-27,-32,-7,-1,4,3,0,1,1,-6,6,0,-1,4,3,1,2,3,0,-10,5,0,-6,6,-4,0,-1,-1,1,-1,1,5,-1
KR_6768971682,420,-5,-79,-11,-8,0,1,1,-4,6,2,0,1,1,-4,4,0,0,1,1,0,-7,-6,-1,-5,6,-1,0,-1,1,-1,-1,-1,6,-1
KR_6752073366,420,-2,-1,4,1,-1,2,1,-1,5,4,5,3,8,-2,7,5,0,1,1,0,-7,-5,-1,-4,5,1,0,0,1,-1,0,1,4,-1
KR_6769003350,420,5,66,9,4,-1,3,2,3,1,4,2,3,5,0,2,2,0,0,0,0,-1,-3,-5,-2,7,6,0,0,1,-1,0,-1,2,-1
KR_6743564731,420,1,1,4,2,3,0,3,-6,6,0,0,2,2,5,0,5,0,2,2,0,-3,1,0,-7,7,-1,0,0,-1,1,0,1,3,-1
KR_6754875334,420,3,-14,7,8,-5,7,2,3,1,4,7,3,10,1,2,3,2,0,2,0,14,-6,0,-5,5,2,0,1,1,-1,-1,1,2,-1
KR_6762620257,420,-5,-15,-10,-7,0,3,3,-5,5,0,-2,2,0,-1,1,0,1,1,2,0,-11,-8,-4,-2,6,1,0,-2,-1,-1,-1,1,6,-1
KR_6696817817,420,0,-64,4,-2,-3,4,1,8,3,11,-3,3,0,-4,5,1,0,1,1,0,2,-3,-4,-4,8,2,0,0,1,-1,-1,1,6,-1
KR_6673765086,420,-2,-28,-39,-6,0,1,1,-1,2,1,-1,1,0,-2,4,2,-2,2,0,-1,-7,2,3,-6,3,-10,0,0,-1,1,1,-1,1,-1
KR_6763357813,420,-3,-66,-23,-6,-3,4,1,-3,7,4,-4,5,1,2,2,4,2,0,2,0,0,-1,1,-5,4,1,0,-2,-1,-1,-1,-1,3,-1
KR_6766152534,420,3,73,12,3,1,1,2,1,1,2,0,2,2,0,1,1,1,1,2,0,2,8,4,-7,3,-3,0,0,-1,-1,1,-1,5,-1
KR_6763938530,420,-2,-35,5,-2,-3,3,0,0,4,4,4,1,5,-2,2,0,-1,2,1,0,6,32,2,-9,7,-5,0,-1,-1,-1,-1,-1,4,-1
KR_6712993061,420,-3,-42,-4,-4,1,2,3,-3,6,3,1,2,3,-1,3,2,-2,4,2,1,-7,3,3,-7,4,-2,0,-2,1,-1,-1,1,3,-1
KR_6680284594,420,-1,-22,-13,3,-2,5,3,3,2,5,4,3,7,-1,2,1,-1,1,0,0,13,15,4,-8,4,-1,0,0,-1,1,1,1,4,-1
KR_6767677327,420,-3,-37,-39,-3,-3,4,1,1,2,3,4,0,4,-3,7,4,-2,3,1,0,-1,0,2,-6,4,-1,0,0,-1,1,0,-1,5,-1
KR_6730793957,420,-4,-34,8,-8,-5,6,1,-2,7,5,0,2,2,-1,2,1,0,0,0,0,-19,-19,-5,-6,11,-3,0,-1,1,-1,-1,-1,4,-1
KR_6743295677,440,0,-65,-1,-2,-2,3,1,-4,6,2,1,1,2,3,3,6,0,1,1,3,6,25,-1,-4,5,0,0,-2,-1,-1,-1,1,2,-1
KR_6751399931,420,-5,-21,-21,-19,-4,5,1,-3,7,4,-6,6,0,-3,6,3,-3,3,0,0,-22,-8,-3,-8,11,-3,0,0,-1,-1,1,-1,6,-1
KR_6757618755,420,0,-69,15,-6,-3,3,0,-1,3,2,1,4,5,-2,3,1,-1,1,0,0,-5,-7,-1,-5,6,-4,0,0,-1,1,0,-1,3,-1
KR_6705086097,420,4,-27,0,0,4,3,7,1,2,3,2,0,2,0,1,1,-7,8,1,0,7,13,2,-7,5,-3,0,1,1,1,1,-1,3,-1
KR_6746336550,420,-4,-79,-17,-10,1,1,2,0,3,3,-4,5,1,-5,5,0,-2,2,0,0,-9,9,2,-6,4,-11,0,0,-1,1,0,-1,4,-1
KR_6767393146,420,1,4,32,-2,-3,3,0,0,2,2,4,1,5,-1,1,0,-2,2,0,0,-10,143,3,-8,5,-26,0,2,-1,1,1,1,4,-1
KR_6731345364,420,-5,-81,20,-9,-6,7,1,2,2,4,0,2,2,4,0,4,-9,10,1,0,-13,0,0,-4,4,-1,0,-3,-1,1,-1,-1,2,-1
KR_6692868815,420,-1,11,9,-3,4,0,4,-6,6,0,-1,4,3,1,0,1,-1,1,0,0,-9,-5,-3,-4,7,1,0,1,1,1,1,1,6,-1
KR_6673080927,420,0,-10,-9,1,-3,3,0,0,3,3,-2,2,0,4,1,5,2,1,3,0,-3,1,1,-5,4,-2,0,0,1,-1,-1,1,1,-1
KR_6766219954,420,-4,14,20,-13,-5,5,0,0,0,0,-5,6,1,0,5,5,-3,4,1,0,-14,-57,1,-5,4,-5,0,-1,-1,-1,-1,-1,5,-1
KR_6766882883,420,-2,-62,30,-6,-2,2,0,-2,2,0,2,3,5,-4,5,1,0,0,0,-1,-7,-15,-4,-2,6,3,0,-1,-1,-1,-1,-1,4,-1
KR_6763285207,420,1,28,0,5,-3,3,0,1,2,3,-3,6,3,8,0,8,2,2,4,0,-3,6,2,-8,6,-1,0,1,-1,1,1,1,1,-1
KR_6742469196,420,-1,-16,0,-4,-2,5,3,0,2,2,-4,5,1,0,1,1,2,0,2,0,-9,1,-4,-7,11,0,0,0,-1,-1,0,1,2,-1
KR_6767191915,420,-2,-28,5,0,-2,4,2,2,1,3,0,3,3,2,1,3,-2,3,1,0,4,-3,-2,-7,9,-3,0,-1,0,1,-1,-1,0,-1
KR_6722865000,420,-3,-52,24,-13,2,0,2,-9,9,0,-1,4,3,1,2,3,-6,8,2,1,-12,7,3,-5,2,-2,0,0,-1,1,1,1,4,-1
KR_6768481691,420,-1,28,22,-7,1,2,3,-7,8,1,-4,5,1,1,3,4,2,0,2,0,-15,4,5,-7,2,-4,0,0,1,-1,0,-1,4,-1
KR_6734037652,420,-2,-2,-44,-5,-3,4,1,0,2,2,-1,2,1,1,3,4,-2,3,1,0,-7,-5,1,-7,6,3,0,-1,1,-1,-1,1,3,-1
KR_6759117197,420,-2,-23,1,-6,0,0,0,-5,6,1,2,0,2,-3,6,3,0,2,2,0,-10,40,1,-7,6,-6,0,0,-1,1,1,-1,5,-1
KR_6765539565,420,-5,-22,-27,-13,-2,6,4,-10,12,2,1,2,3,0,4,4,-2,2,0,0,-10,7,1,-5,4,-1,0,-1,-1,1,-1,1,6,-1
KR_6748948702,420,3,26,-4,3,-3,3,0,-3,3,0,7,2,9,2,2,4,0,0,0,0,4,-10,-5,-5,10,6,0,1,-1,1,1,-1,1,-1
KR_6721072954,440,1,60,-27,6,4,2,6,0,1,1,-1,3,2,2,1,3,1,0,1,0,0,-62,0,-4,4,0,0,0,1,1,1,1,6,-1
KR_6766681916,420,0,0,-8,-2,-1,3,2,-3,5,2,0,3,3,3,2,5,-1,1,0,0,-10,-4,4,-9,5,4,0,1,-1,1,1,-1,1,-1
KR_6751434742,440,-2,-10,11,-7,1,3,4,-6,8,2,-1,1,0,-1,1,0,0,0,0,-1,-10,-3,4,-8,4,-5,0,-1,1,-1,-1,-1,1,-1
KR_6766835558,420,0,-22,22,5,5,2,7,1,0,1,0,1,1,-1,3,2,0,0,0,0,6,7,2,-9,7,-3,0,0,-1,-1,0,1,3,-1
KR_6620228737,420,0,31,3,5,2,0,2,2,1,3,0,3,3,0,1,1,1,1,2,0,7,23,0,-6,6,1,0,0,-1,1,0,1,4,-1
KR_6695196825,420,-2,-64,13,-4,-2,2,0,2,4,6,0,3,3,2,0,2,-6,6,0,0,-6,94,-1,-4,5,4,0,-1,0,1,-1,-1,0,-1
KR_6708466712,420,-4,-11,-5,-5,-6,6,0,2,3,5,-3,3,0,1,1,2,1,1,2,0,-2,4,-6,-2,8,-1,0,-1,-1,-1,-1,-1,6,-1
KR_6747507648,420,-5,-27,6,-10,-3,3,0,2,2,4,-7,7,0,-2,8,6,0,1,1,0,-14,-32,-1,-6,7,-1,0,-1,-1,-1,-1,1,1,-1
KR_6764668931,420,-8,-109,-31,-8,-5,8,3,0,1,1,-2,3,1,-1,4,3,0,1,1,0,-7,3,4,-8,4,-2,0,-2,-1,-1,-1,1,2,-1
KR_6735291222,420,-2,42,-24,-8,0,1,1,-2,5,3,1,1,2,-6,6,0,-1,1,0,0,-14,-4,1,-5,4,-2,0,1,-1,1,-1,-1,4,-1
KR_6763827460,420,0,30,-31,8,2,1,3,-6,9,3,5,0,5,3,2,5,4,0,4,0,3,0,-2,-4,6,-1,0,0,-1,-1,0,1,2,-1
KR_6755816556,420,0,-58,-40,6,-2,4,2,-1,5,4,-1,2,1,3,1,4,7,1,8,-2,8,0,-2,-5,7,1,0,-1,1,1,-1,-1,1,-1
KR_6714081230,420,0,-74,-13,3,-4,5,1,3,0,3,1,1,2,0,0,0,3,0,3,0,7,1,2,-4,2,-1,0,1,1,1,1,-1,3,-1
KR_6679315189,420,-3,7,8,-8,1,1,2,-4,5,1,-7,8,1,3,2,5,-1,2,1,-1,-5,2,-5,-2,7,2,0,0,1,-1,0,-1,5,-1
KR_6734089905,440,0,3,9,-4,0,2,2,-2,3,1,0,0,0,-2,3,1,0,0,0,0,-1,-113,6,-9,3,-4,0,0,-1,-1,0,1,1,-1
KR_6764088437,420,-5,-100,-19,-11,-4,4,0,-3,4,1,-3,4,1,0,5,5,-1,2,1,0,-7,43,-1,-5,6,-33,0,-1,-1,1,-1,1,4,-1
KR_6750344200,420,-4,-84,-21,-11,-5,6,1,-3,7,4,6,0,6,-5,7,2,-4,5,1,0,-1,-7,8,-10,2,0,0,0,-1,1,1,1,4,-1
KR_6745006171,420,-3,-97,4,-3,-6,7,1,-2,4,2,1,2,3,4,2,6,0,1,1,0,8,-4,1,-8,7,5,0,-1,-1,1,-1,1,2,-1
KR_6747843391,420,0,-33,19,2,-1,3,2,0,3,3,-1,3,2,3,1,4,1,2,3,0,4,-2,1,-7,6,1,0,0,1,1,0,-1,2,-1
KR_6689706636,420,1,-14,4,3,2,0,2,0,2,2,1,1,2,-2,3,1,2,0,2,0,2,111,0,-5,5,1,0,0,1,-1,0,-1,3,-1
KR_6762803262,420,0,-34,-15,3,0,2,2,-1,7,6,-1,2,1,4,2,6,1,1,2,0,8,-1,-2,-4,6,-2,0,0,-1,-1,-1,-1,4,-1
KR_6767477018,420,-3,-8,-1,-17,-1,1,0,-5,8,3,-5,6,1,-2,3,1,-4,6,2,-2,-18,-3,1,-10,9,-6,0,-2,1,-1,-1,-1,3,-1
KR_6766233760,420,-1,11,20,-1,4,2,6,0,3,3,1,0,1,-5,6,1,-1,1,0,0,-7,1,3,-6,3,4,0,1,-1,1,1,1,3,-1
KR_6750145705,420,-7,-136,-9,-16,-2,4,2,-2,4,2,-8,9,1,-4,5,1,0,0,0,-1,-20,-7,-2,-4,6,0,0,-3,-1,-1,-1,-1,4,-1
KR_6761375455,420,3,-30,0,6,4,2,6,-2,5,3,-2,3,1,4,0,4,2,3,5,0,19,22,-1,-8,9,4,0,0,-1,1,0,-1,5,-1
KR_6758631928,420,0,21,-28,5,1,2,3,2,3,5,1,0,1,-2,4,2,3,1,4,1,3,0,1,-6,5,-5,0,0,1,1,1,1,6,-1
KR_6768954756,420,0,10,-8,1,2,0,2,2,1,3,1,4,5,-3,3,0,-1,1,0,0,0,10,0,-5,5,-1,0,0,-1,1,0,1,5,-1
KR_6735442838,420,-3,-26,32,-14,4,1,5,-10,10,0,-2,5,3,-4,5,1,-2,2,0,0,-15,16,-2,-3,5,-4,0,0,-1,-1,-1,-1,1,-1
KR_6754878432,420,-2,-8,4,-15,0,1,1,1,0,1,0,3,3,-15,17,2,-1,2,1,-1,-19,-5,-2,-2,4,3,0,0,-1,1,0,-1,1,-1
KR_6761298184,420,-1,-4,-23,-4,1,0,1,1,6,7,-6,7,1,-1,2,1,1,2,3,0,-1,-4,1,-6,5,0,0,-1,-1,1,-1,1,5,-1
KR_6760572903,420,-5,-17,-23,-5,-1,2,1,2,2,4,-4,4,0,0,3,3,-2,3,1,0,-2,0,-1,-5,6,-2,0,0,1,-1,-1,-1,5,-1
KR_6669955085,420,-1,-27,-32,-2,2,0,2,-2,4,2,-1,1,0,0,3,3,-1,4,3,0,-2,17,7,-9,2,-3,0,-1,-1,-1,-1,-1,2,-1
KR_6749507176,420,3,-34,16,3,4,0,4,0,0,0,2,1,3,-5,8,3,2,0,2,1,5,-16,-6,-4,10,2,0,0,0,1,0,1,0,-1
KR_6759134666,420,-3,-34,-44,-10,2,1,3,-4,6,2,-2,5,3,-4,6,2,-2,2,0,0,-12,-1,2,-9,7,-3,0,-2,-1,1,-1,-1,4,-1
KR_6625098895,420,-5,-62,-7,-7,-6,7,1,-2,3,1,4,0,4,-3,3,0,0,1,1,1,-5,26,-1,-8,9,0,0,1,-1,1,1,1,5,-1
KR_6645056069,420,-5,-16,-4,-7,-5,5,0,2,3,5,-8,9,1,4,2,6,0,1,1,0,-2,-2,-1,-5,6,-8,0,-2,-1,-1,-1,1,4,-1
KR_6754620884,420,1,45,5,-1,0,3,3,-2,3,1,-1,4,3,1,2,3,1,2,3,0,-3,17,-2,-3,5,0,0,1,-1,-1,1,-1,5,-1
KR_6768573712,420,-2,-40,-7,-4,-5,6,1,0,5,5,-3,3,0,-3,4,1,7,0,7,0,3,-46,-2,-5,7,11,0,-2,0,-1,-1,-1,0,-1
KR_6746236788,420,-4,26,-23,-5,-1,1,0,2,1,3,-6,10,4,0,5,5,0,1,1,0,-12,18,-2,-3,5,-2,0,-1,-1,1,-1,1,5,-1
KR_6715653429,420,-2,-82,-21,-8,-2,4,2,-1,6,5,1,3,4,-5,7,2,-1,2,1,0,-1,-5,1,-10,9,5,0,-2,1,-1,-1,-1,4,-1
KR_6768487474,420,-3,-76,1,-4,0,2,2,-4,4,0,1,3,4,-2,4,2,1,4,5,3,-1,20,-1,-6,7,-2,0,-2,1,0,-1,-1,4,-1
KR_6740377382,420,-6,-99,-31,-9,-4,4,0,-1,5,4,-2,3,1,0,4,4,-2,2,0,-1,-12,-5,-2,0,2,1,0,-2,-1,-1,-1,-1,1,-1
KR_6743054287,420,-6,-98,-2,-4,-2,3,1,-2,3,1,0,2,2,-2,3,1,2,2,4,0,1,21,-2,-7,9,-5,0,-1,-1,1,-1,-1,4,-1
KR_6722398698,420,-2,-15,-13,-2,-2,3,1,4,1,5,-2,4,2,-3,3,0,1,1,2,0,-2,9,4,-10,6,-2,0,1,-1,1,-1,-1,3,-1
KR_6756481493,420,-9,-62,-77,-14,-1,1,0,-5,5,0,-1,2,1,-5,6,1,-2,2,0,0,-9,-9,-1,-2,3,1,0,-6,-1,-1,-1,-1,1,-1
KR_6681064401,420,3,-3,32,4,3,3,6,-1,4,3,3,1,4,-1,1,0,0,0,0,0,10,25,-3,-5,8,2,0,-2,1,1,-1,1,2,-1
KR_6769112197,420,-3,-61,12,-5,-3,4,1,2,1,3,-3,3,0,-1,1,0,0,1,1,0,-2,-3,-2,-5,7,-4,0,-1,1,-1,-1,-1,5,-1
KR_6618241376,420,-3,32,-36,-10,0,0,0,-6,7,1,0,2,2,-5,6,1,1,2,3,0,-12,-15,-4,-4,8,0,0,-2,-1,-1,-1,-1,2,-1
KR_6723915822,420,-1,36,9,-8,-3,4,1,-3,5,2,2,3,5,-1,2,1,-3,5,2,0,-17,-10,-5,-3,8,0,0,-1,-1,1,-1,-1,3,-1
KR_6769016503,420,-2,0,-17,-7,1,0,1,-4,4,0,-1,2,1,3,0,3,-6,8,2,0,-12,6,1,-5,4,-2,0,1,0,-1,1,-1,0,-1
KR_6751733321,440,2,14,-10,8,5,1,6,1,1,2,4,0,4,0,0,0,-2,4,2,0,2,-38,0,-4,4,20,0,0,-1,0,-1,1,4,-1
KR_6760675284,420,-1,30,-6,4,3,3,6,2,3,5,-1,3,2,-2,5,3,2,0,2,0,3,10,0,-4,4,-7,0,0,-1,-1,0,1,6,-1
KR_6757562201,420,-1,21,-3,-4,1,1,2,0,2,2,-1,1,0,-1,3,2,-3,3,0,0,-5,-31,0,-4,4,-3,0,1,-1,-1,1,1,3,-1
KR_6768021572,420,-1,84,39,-13,0,1,1,-4,5,1,0,3,3,-7,7,0,-2,2,0,0,-8,-12,-1,-8,9,1,0,-1,-1,1,-1,1,5,-1
KR_6752417592,440,-2,12,0,-3,-4,5,1,-6,8,2,0,3,3,0,7,7,7,0,7,1,-3,-80,-1,-3,4,0,0,-1,-1,-1,-1,1,5,-1
KR_6730214159,420,1,-9,41,-7,-2,3,1,0,2,2,-1,2,1,-3,4,1,-1,2,1,0,-6,-2,2,-6,4,2,0,0,-1,1,1,-1,3,-1
KR_6748246353,420,-1,-35,1,-11,0,3,3,0,3,3,-2,2,0,-8,9,1,-1,2,1,-1,-12,31,-6,-5,11,3,0,-1,-1,-1,-1,-1,3,-1
KR_6508392094,420,-1,11,-21,0,4,0,4,-2,3,1,1,0,1,-3,3,0,0,0,0,0,-6,-14,-3,-5,8,1,0,-2,-1,-1,-1,-1,4,-1
KR_6768732961,440,-1,-6,5,-3,1,0,1,2,3,5,-1,2,1,-4,8,4,-1,3,2,0,-5,-6,0,-5,5,-5,0,-2,1,-1,-1,-1,3,-1
KR_6760762504,420,-2,-9,-12,-6,-4,5,1,-1,3,2,3,2,5,-5,6,1,1,2,3,-1,-17,-40,0,-6,6,0,0,-1,1,1,-1,-1,2,-1
KR_6765203177,420,-2,-97,18,-12,-1,2,1,-6,8,2,-4,5,1,-1,3,2,0,3,3,0,-14,284,0,-3,3,2,0,-3,0,-1,-1,-1,0,-1
KR_6593392313,420,-3,-48,20,-10,0,0,0,2,0,2,-3,3,0,-9,10,1,0,0,0,0,-13,-3,-6,-2,8,-1,0,-1,-1,-1,-1,1,5,-1
KR_6759219424,420,-1,-13,-14,0,-4,4,0,0,2,2,0,1,1,1,3,4,3,0,3,0,4,-6,0,-5,5,3,0,-2,-1,-1,-1,-1,2,-1
KR_6769199113,420,1,6,8,-10,-6,8,2,-3,5,2,-4,5,1,4,1,5,-1,1,0,1,-13,7,5,-9,4,-7,0,0,1,1,0,1,1,-1
KR_6747891332,440,-1,-1,-24,10,2,1,3,0,2,2,0,10,10,5,0,5,3,0,3,0,12,-2,4,-7,3,1,0,0,-1,1,0,-1,5,-1
KR_6701388683,420,-4,-28,-2,-8,-6,6,0,-6,8,2,-3,4,1,6,2,8,1,0,1,0,-13,2,5,-8,3,-3,0,-4,0,-1,-1,1,0,-1
KR_6765470693,420,0,-21,-20,-8,-3,4,1,-7,8,1,3,0,3,0,0,0,-1,2,1,0,-5,2,1,-6,5,0,0,-2,1,-1,-1,1,3,-1
KR_6714494843,420,2,31,10,3,1,2,3,-1,4,3,0,2,2,2,1,3,1,1,2,0,7,118,-2,-4,6,5,0,0,-1,1,1,-1,5,-1
KR_6692190046,440,-2,2,-32,-6,-1,1,0,-2,5,3,0,4,4,-3,3,0,0,1,1,0,1,0,2,-5,3,1,0,0,-1,-1,-1,1,4,-1
KR_6758838087,420,-1,-32,23,-11,1,0,1,-6,7,1,-4,5,1,-3,3,0,1,1,2,-1,-11,-66,-7,-3,10,2,0,0,-1,-1,-1,-1,3,-1
KR_6647901756,420,-4,-62,-20,-7,-2,2,0,-3,3,0,2,0,2,-1,3,2,-3,3,0,0,-6,141,0,-4,4,-4,0,-2,-1,-1,-1,-1,3,-1
KR_6706406193,420,-3,-35,-4,-6,3,1,4,-1,6,5,-3,6,3,0,1,1,-5,6,1,1,4,-7,-2,-3,5,3,0,0,-1,-1,-1,1,4,-1
KR_6660928404,420,-4,-69,-15,-5,-4,4,0,5,3,8,1,2,3,-5,8,3,-2,3,1,-1,-3,4,-4,-3,7,1,0,-1,-1,0,-1,-1,1,-1
KR_6726635820,420,0,-39,9,-3,-4,4,0,4,3,7,-5,6,1,4,1,5,-2,5,3,0,4,23,3,-8,5,-4,0,-1,1,1,-1,1,2,-1
KR_6733727017,420,-3,-63,-7,-7,3,0,3,-3,6,3,-1,1,0,-5,5,0,-1,1,0,-1,-8,41,0,-4,4,-25,0,-3,-1,-1,-1,-1,1,-1
KR_6758786899,420,-1,-19,4,-4,0,1,1,-5,6,1,-3,4,1,2,1,3,2,0,2,1,3,-14,-2,-3,5,2,0,0,-1,-1,0,1,2,-1
KR_6647153622,420,2,-32,13,3,1,0,1,1,4,5,2,0,2,-2,4,2,1,0,1,0,-2,-7,-3,-3,6,2,0,0,1,1,0,-1,2,-1
KR_6683168821,420,2,-8,6,-2,3,1,4,-7,8,1,1,2,3,2,5,7,-1,2,1,0,-1,-8,-1,-3,4,4,0,-1,1,1,-1,-1,6,-1
KR_6757166874,420,-2,-81,12,-4,-4,5,1,3,1,4,-2,4,2,-1,1,0,0,2,2,0,-3,-1,-1,-5,6,-5,0,-1,-1,1,-1,1,4,-1
KR_6767293951,420,-2,-19,-28,-2,-3,3,0,3,1,4,-1,2,1,1,2,3,-2,3,1,0,6,-1,5,-6,1,-2,0,-1,-1,1,-1,1,1,-1
KR_6769184847,420,-1,-10,-15,-3,-1,2,1,3,5,8,1,0,1,-6,6,0,0,0,0,0,0,7,-2,-5,7,-1,0,-1,1,-1,-1,-1,1,-1
KR_6765896214,420,-1,-37,-1,5,-3,3,0,-1,3,2,5,2,7,4,0,4,0,0,0,0,2,-2,-2,-5,7,2,0,0,-1,1,1,1,5,-1
KR_6750469470,420,-4,-61,-16,-5,-1,1,0,-2,3,1,0,1,1,-2,6,4,0,2,2,0,-7,10,2,-9,7,-12,0,-2,1,1,-1,-1,5,-1
KR_6726820470,420,-3,-86,4,-6,2,1,3,-4,5,1,-3,3,0,0,2,2,-1,1,0,0,-7,4,1,-5,4,-7,0,-1,1,-1,-1,-1,1,-1
KR_6743748221,420,-4,-67,-3,-11,2,1,3,-2,5,3,-4,4,0,-6,8,2,-1,1,0,0,-17,-2,2,-6,4,-3,0,0,-1,1,-1,-1,2,-1
KR_6651809773,420,0,-2,1,-2,-4,5,1,8,1,9,-1,2,1,-3,6,3,-2,4,2,0,2,-2,2,-7,5,-3,0,0,-1,1,0,1,5,-1
KR_6748902718,420,-1,-1,2,-4,-2,4,2,2,4,6,-3,3,0,1,2,3,-2,2,0,0,1,-37,1,-5,4,2,0,0,-1,-1,1,-1,3,-1
KR_6767869206,420,1,-72,11,-3,0,2,2,-2,4,2,2,1,3,2,0,2,-5,5,0,0,-5,-18,1,-6,5,0,0,-1,1,-1,-1,-1,3,-1
KR_6765205474,420,-3,-5,-53,-9,0,0,0,-9,9,0,5,2,7,-4,6,2,-1,1,0,0,-6,-5,0,-4,4,-3,0,-3,-1,-1,-1,-1,2,-1
KR_6767430805,420,-3,-31,-23,-5,-5,6,1,-1,2,1,-3,4,1,4,1,5,0,0,0,0,4,-4,-3,-4,7,1,0,-1,0,0,-1,-1,0,-1
KR_6768240874,420,-2,-88,31,-12,-2,4,2,-1,2,1,1,3,4,-9,9,0,-1,2,1,0,-8,3,0,-6,6,-4,0,-1,-1,1,-1,-1,4,-1
KR_6701528906,420,-2,-21,-8,0,-2,2,0,-1,5,4,2,0,2,1,0,1,0,0,0,0,6,36,-3,-3,6,2,0,-1,-1,1,-1,-1,1,-1
KR_6754421919,420,-1,9,0,-2,-2,5,3,-1,2,1,2,4,6,-1,2,1,0,1,1,1,0,-121,6,-8,2,-3,0,-2,-1,-1,-1,1,6,-1
KR_6737485892,420,0,-20,-19,6,2,0,2,5,2,7,2,1,3,-3,3,0,0,0,0,0,8,-1,6,-9,3,-8,0,2,1,1,1,1,4,-1
KR_6754950771,420,0,-16,-2,2,-1,4,3,0,1,1,-3,3,0,4,0,4,2,0,2,0,3,0,-7,-5,12,0,0,0,-1,-1,0,1,4,-1
KR_6568874048,420,-1,7,7,-1,-1,3,2,2,3,5,1,0,1,-4,4,0,1,0,1,0,-4,-2,-2,-3,5,1,0,0,-1,1,0,-1,6,-1
KR_6756411007,420,-2,-98,28,-12,-3,4,1,1,3,4,0,2,2,-11,14,3,1,1,2,0,-9,-3,2,-9,7,-5,0,-2,-1,1,-1,1,2,-1
KR_6699596638,420,-3,29,-6,-8,-1,3,2,-3,4,1,0,3,3,-4,6,2,0,1,1,0,-7,2,-1,-5,6,-2,0,-1,1,-1,-1,-1,5,-1
KR_6760782656,420,2,24,20,5,1,1,2,-6,8,2,6,0,6,3,2,5,1,1,2,0,5,15,-3,-3,6,7,0,0,1,1,0,-1,2,-1
KR_6725648832,420,-2,-10,-25,-17,0,2,2,-3,4,1,-1,2,1,-7,7,0,-6,6,0,0,-21,-136,-1,-5,6,1,0,-1,-1,-1,-1,-1,3,-1
KR_6767412101,420,0,-18,0,-4,1,2,3,-6,6,0,0,1,1,-1,7,6,2,3,5,0,-6,-170,1,-3,2,14,0,0,-1,-1,0,-1,3,-1
KR_6643394779,420,-1,25,-11,-5,0,1,1,-7,7,0,2,1,3,-1,4,3,1,1,2,1,-1,-2,1,-8,7,-7,0,-1,-1,0,-1,1,4,-1
KR_6718824408,420,-4,-67,-15,-7,2,3,5,-2,2,0,-7,9,2,5,3,8,-5,7,2,2,0,-6,-1,-4,5,-4,0,0,-1,-1,-1,-1,1,-1
KR_6767988923,420,-2,-53,-37,-5,5,0,5,2,2,4,-1,1,0,-10,10,0,-1,2,1,0,-9,1,3,-8,5,-3,0,0,-1,1,1,-1,4,-1
KR_6759469273,420,1,-50,28,-3,1,1,2,1,0,1,4,0,4,-1,3,2,-8,8,0,0,-4,13,-7,-3,10,1,0,0,1,1,-1,1,2,-1
KR_6579043930,420,-6,-84,-45,-4,-1,3,2,-3,4,1,-1,2,1,0,3,3,1,1,2,0,-4,9,1,-6,5,-6,0,-1,-1,-1,-1,1,1,-1
KR_6756062881,420,-3,-65,-3,-3,0,0,0,0,3,3,0,2,2,-2,3,1,-1,1,0,-2,-12,16,1,-5,4,-3,0,0,1,-1,0,-1,6,-1
KR_6768499473,420,-1,28,-45,-2,2,1,3,2,5,7,-1,2,1,-1,1,0,-4,5,1,1,0,-10,-1,-4,5,2,0,1,1,-1,1,1,5,-1
KR_6715710654,420,3,21,-8,8,-3,5,2,3,2,5,3,5,8,3,2,5,2,0,2,-1,8,-42,0,-4,4,12,0,2,1,1,1,-1,6,-1
KR_6767911990,420,-6,-64,-28,-9,-5,5,0,1,0,1,-5,8,3,1,3,4,-1,1,0,0,-1,9,-1,-4,5,-2,0,-1,1,1,-1,-1,6,-1
KR_6741867248,420,1,48,-32,11,3,2,5,1,2,3,3,1,4,4,4,8,0,0,0,0,6,20,-3,-4,7,6,0,2,0,1,1,1,0,-1
KR_6755662810,420,-3,-10,-1,1,-4,4,0,1,1,2,-1,3,2,4,0,4,1,2,3,0,2,-4,-3,-2,5,7,0,1,-1,-1,-1,-1,2,-1
KR_6764017248,420,2,34,-29,3,-2,2,0,3,3,6,2,0,2,2,0,2,-2,2,0,0,2,6,3,-7,4,-4,0,-1,1,-1,-1,1,3,-1
KR_6754640412,420,-2,-78,-28,-7,5,1,6,0,5,5,-4,8,4,-5,7,2,-3,4,1,1,-7,3,-1,-2,3,-2,0,-2,0,1,-1,1,0,-1
KR_6688560955,420,-5,-127,-32,-10,-2,3,1,-7,9,2,-2,3,1,0,4,4,1,0,1,-2,-8,-26,-3,-4,7,-4,0,-3,-1,-1,-1,-1,5,-1
KR_6762520674,420,-2,-27,-27,7,-1,4,3,5,0,5,4,2,6,0,2,2,-1,1,0,2,12,1,-2,-3,5,-4,0,-2,-1,-1,-1,1,2,-1
KR_6746419213,420,1,8,16,-1,-2,2,0,4,1,5,0,5,5,-1,2,1,-2,2,0,1,0,5,5,-9,4,-6,0,1,-1,1,1,1,1,-1
KR_6674231713,420,-4,-37,0,-8,-4,5,1,3,3,6,-1,1,0,-1,1,0,-5,5,0,0,7,-26,-1,-3,4,0,0,-4,1,-1,-1,-1,5,-1
KR_6766571881,420,-2,29,16,-14,-1,3,2,-6,6,0,-6,9,3,-1,3,2,0,2,2,-1,-20,-5,0,-6,6,1,0,0,1,1,0,-1,5,-1
KR_6653132133,420,-5,-70,7,-10,-2,6,4,-4,4,0,0,3,3,-4,5,1,0,0,0,0,-14,12,-2,-5,7,-2,0,-1,0,1,-1,1,0,-1
KR_6767261243,420,-2,-36,5,-6,-3,4,1,3,3,6,-1,2,1,-1,2,1,-4,5,1,0,-12,7,1,-8,7,-2,0,0,-1,-1,0,-1,5,-1
KR_6766141022,420,1,-6,20,3,-4,4,0,3,1,4,4,1,5,-1,2,1,1,0,1,0,3,-4,3,-6,3,-4,0,-1,1,-1,-1,1,5,-1
KR_6768613462,420,-1,14,-16,-6,-1,2,1,-3,6,3,1,2,3,-3,5,2,0,0,0,0,-6,11,5,-10,5,-4,0,-1,1,-1,-1,1,6,-1
KR_6746339548,440,-1,-30,6,-1,-1,3,2,1,2,3,-2,3,1,0,1,1,1,0,1,0,4,2,1,-8,7,-1,0,-1,1,-1,-1,1,1,-1
KR_6763747321,420,-3,-72,1,0,1,0,1,-7,8,1,1,1,2,3,0,3,2,0,2,1,-5,-15,3,-6,3,-3,0,0,1,-1,0,1,4,-1
KR_6762617837,420,2,-54,1,4,-1,1,0,0,3,3,0,1,1,0,1,1,5,2,7,0,4,1,1,-7,6,-4,0,0,1,-1,0,-1,4,-1
KR_6695167378,420,-3,0,-12,-10,1,1,2,-3,7,4,-2,2,0,-4,7,3,-2,3,1,0,-17,3,6,-12,6,-9,0,-1,-1,-1,-1,1,6,-1
KR_6746430529,440,-2,-19,4,-9,1,2,3,-2,5,3,-4,7,3,-6,9,3,2,2,4,-1,-17,-9,1,-7,6,-8,0,1,-1,-1,1,-1,5,-1
KR_6650902956,420,-3,-67,-29,-3,2,2,4,2,4,6,0,2,2,-7,8,1,0,1,1,0,-3,147,-4,-3,7,22,0,-2,-1,-1,-1,1,2,-1
KR_6715096456,420,2,-10,17,-1,6,0,6,-5,6,1,4,0,4,-3,4,1,-3,3,0,0,-2,-37,0,-6,6,-2,0,-1,-1,1,-1,-1,5,-1
KR_6768403819,420,0,-22,-19,4,-6,6,0,0,4,4,4,0,4,2,1,3,4,2,6,1,14,2,-1,-6,7,-3,0,-1,0,-1,-1,1,0,-1
KR_6745650017,420,-2,-126,-13,-1,-1,1,0,2,1,3,-2,7,5,0,0,0,0,0,0,0,14,-22,0,-9,9,5,0,-4,1,-1,-1,1,5,-1
KR_6700024634,420,-2,32,-42,-3,-3,4,1,-4,8,4,1,3,4,1,0,1,2,1,3,0,-7,-1,-2,-7,9,4,0,0,-1,-1,-1,1,4,-1
KR_6579010164,420,-2,-14,-12,-10,1,0,1,0,2,2,-14,14,0,-1,3,2,4,0,4,0,-6,3,-1,-6,7,2,0,-3,1,-1,-1,-1,1,-1
KR_6762231126,440,2,72,-6,3,-4,5,1,-2,2,0,-1,5,4,5,2,7,5,0,5,-1,-1,-7,4,-11,7,5,0,1,1,-1,-1,-1,1,-1
KR_6767547006,420,2,-11,4,1,-2,3,1,6,1,7,-2,4,2,0,2,2,-1,2,1,0,7,-14,3,-10,7,0,0,1,1,-1,1,-1,6,-1
KR_6768587553,420,-5,-68,-8,-14,-1,4,3,-2,4,2,0,3,3,-5,7,2,-6,7,1,0,-19,-4,1,-8,7,-5,0,-2,1,1,-1,1,1,-1
KR_6762492377,420,1,50,9,3,1,1,2,0,4,4,3,0,3,-1,4,3,0,1,1,1,8,-76,-1,-5,6,-1,0,2,1,1,1,1,4,-1
KR_6751727878,420,-1,-13,20,-2,-4,4,0,0,1,1,4,0,4,-2,3,1,0,1,1,0,-1,-5,1,-5,4,-2,0,0,1,1,1,-1,3,-1
KR_6704099822,420,-2,13,-16,-1,-4,4,0,1,2,3,1,1,2,2,4,6,-1,2,1,0,4,-2,-3,-4,7,-1,0,-1,-1,-1,-1,-1,2,-1
KR_6714303027,420,-2,71,-16,-1,-1,6,5,-4,7,3,4,0,4,2,4,6,-2,2,0,2,0,-12,-4,-5,9,4,0,0,1,-1,-1,1,5,-1
KR_6679057763,420,0,-3,16,-6,-2,2,0,-3,3,0,0,2,2,0,3,3,-1,1,0,0,-4,0,1,-5,4,-6,0,0,-1,0,0,-1,4,-1
KR_6764741458,420,-3,-25,-21,-10,1,2,3,-2,5,3,-6,6,0,-3,4,1,0,1,1,0,-7,-4,-2,-5,7,4,0,0,-1,1,0,-1,3,-1
KR_6765970249,420,-4,-14,-29,-7,0,1,1,-7,7,0,2,1,3,-3,4,1,1,0,1,0,-11,-3,0,-6,6,-2,0,-1,-1,-1,-1,1,6,-1
KR_6717395077,420,0,16,4,-4,2,2,4,-2,8,6,0,1,1,-4,6,2,0,1,1,0,0,-8,-2,-5,7,2,0,0,-1,0,0,-1,1,-1
KR_6697612504,420,1,12,-16,-5,-1,5,4,4,3,7,1,0,1,-9,9,0,0,3,3,0,4,-93,1,-6,5,5,0,-1,1,-1,-1,-1,1,-1
KR_6765386160,420,-2,-12,-3,-6,-5,7,2,1,2,3,-1,2,1,0,2,2,-1,2,1,0,-3,-36,1,-7,6,-1,0,0,-1,1,0,1,6,-1
KR_6685856646,420,-2,-66,4,-5,-1,2,1,-2,2,0,-3,6,3,1,3,4,0,1,1,0,-9,-77,-2,-4,6,1,0,-1,-1,1,-1,-1,3,-1
KR_6747196808,420,2,19,-6,-3,1,2,3,4,1,5,0,3,3,-12,13,1,4,0,4,0,0,28,-2,-2,4,1,0,1,-1,1,1,1,2,-1
KR_6767284663,420,-1,-18,-6,1,6,0,6,-1,4,3,-4,4,0,2,2,4,-2,2,0,1,-5,-1,3,-10,7,-6,0,-1,-1,1,1,1,4,-1
KR_6765669039,420,-3,-20,-8,-11,-2,3,1,-7,8,1,-2,4,2,1,3,4,-1,1,0,0,-1,18,-5,-4,9,-4,0,-2,-1,-1,-1,-1,6,-1
KR_6743624354,420,2,13,-12,1,2,1,3,-2,3,1,3,2,5,-4,4,0,2,0,2,0,1,-27,-4,-4,8,1,0,-1,1,-1,-1,1,2,-1
KR_6730090986,420,-3,10,-15,-2,1,2,3,1,3,4,-2,4,2,-1,4,3,-1,1,0,0,-3,-80,5,-11,6,1,0,0,1,1,1,1,5,-1
KR_6654948106,420,-2,-27,11,-8,-5,8,3,1,5,6,-4,6,2,-5,5,0,5,0,5,0,-9,-10,-3,-3,6,2,0,0,1,-1,1,-1,5,-1
KR_6756855182,440,-2,-25,-44,4,-4,5,1,2,1,3,9,1,10,-1,5,4,-2,2,0,0,6,-124,-2,-2,4,2,0,1,-1,1,-1,-1,3,-1
KR_6734643641,420,-4,-35,20,-16,-2,2,0,-4,4,0,-1,2,1,-9,9,0,0,1,1,0,-18,5,1,-7,6,0,0,-1,-1,1,-1,-1,4,-1
KR_6749647568,420,-2,-1,-12,-6,-3,3,0,-3,4,1,0,3,3,0,1,1,0,1,1,-1,-2,5,1,-5,4,1,0,-1,1,-1,-1,-1,5,-1
KR_6764861179,420,0,77,-14,-5,-2,2,0,-5,8,3,1,1,2,1,1,2,0,3,3,0,-14,-1,1,-6,5,-4,0,0,-1,1,0,1,5,-1
KR_6763249957,440,0,18,0,0,-6,6,0,0,2,2,-1,3,2,5,3,8,2,0,2,0,-2,-6,-1,-4,5,0,0,0,0,0,1,1,0,-1
KR_6661325746,420,-5,-44,-2,-10,-2,2,0,-6,7,1,1,2,3,-3,3,0,0,0,0,0,-20,1,-2,-3,5,5,0,-1,-1,1,-1,-1,5,-1
KR_6746218112,420,0,-2,1,5,1,0,1,3,1,4,0,1,1,3,1,4,-2,4,2,0,6,-28,0,-5,5,0,0,0,-1,0,0,-1,5,-1
KR_6735045949,420,1,-18,-20,5,-3,4,1,3,1,4,5,1,6,2,1,3,-2,2,0,0,8,-12,0,-5,5,4,0,-1,-1,-1,-1,1,1,-1
KR_6767541079,420,-3,-25,20,-14,1,1,2,-5,5,0,-2,3,1,-8,8,0,0,0,0,0,-15,-243,-1,-4,5,2,0,-1,-1,1,-1,-1,4,-1
KR_6761855446,440,-4,-7,-10,-12,1,2,3,-6,6,0,-1,3,2,-4,4,0,-2,5,3,0,-8,-105,2,-5,3,-4,0,0,-1,-1,-1,-1,4,-1
KR_6767260231,420,-4,14,-38,-9,-5,5,0,-2,2,0,-1,1,0,0,1,1,-1,1,0,0,-9,-3,-1,-2,3,0,0,0,-1,-1,-1,-1,2,-1
KR_6760756007,440,-2,-4,-18,-1,3,4,7,-4,7,3,2,0,2,0,4,4,-2,3,1,1,1,26,4,-7,3,-5,0,1,-1,0,1,1,2,-1
KR_6755542358,420,0,12,-22,1,-2,3,1,-3,3,0,3,0,3,2,1,3,1,0,1,0,1,17,-6,-5,11,7,0,0,1,1,0,1,4,-1
KR_6767981632,420,-2,34,-36,-2,1,2,3,-2,3,1,-4,4,0,2,0,2,1,1,2,0,0,17,-1,-7,8,-6,0,0,-1,1,0,1,1,-1
KR_6761883326,420,-3,-63,19,-8,-4,5,1,-2,4,2,-1,2,1,0,3,3,-1,3,2,0,-4,-2,1,-7,6,-2,0,0,1,1,-1,-1,1,-1
KR_6753457441,420,1,0,-13,1,1,2,3,1,3,4,-3,3,0,3,2,5,-1,1,0,2,4,33,-4,-2,6,-10,0,1,-1,-1,1,1,6,-1
KR_6768257620,420,-1,8,12,-7,2,1,3,2,0,2,-8,8,0,0,4,4,-3,4,1,0,0,-19,-1,-3,4,-1,0,-2,-1,-1,-1,-1,1,-1
KR_6679592591,420,-1,-44,27,0,-3,3,0,-4,6,2,3,2,5,4,3,7,0,1,1,0,-4,43,6,-11,5,-17,0,0,1,1,0,-1,5,-1
KR_6766155111,420,-2,-77,0,-3,-1,1,0,1,4,5,-3,6,3,2,4,6,-2,2,0,0,1,73,4,-7,3,-37,0,-1,-1,1,-1,-1,4,-1
KR_6289019547,420,-4,-48,25,-6,2,2,4,0,2,2,2,1,3,-9,10,1,-1,1,0,0,-21,51,2,-7,5,-3,0,-1,-1,1,-1,-1,4,-1
KR_6768189985,420,-3,-14,0,-7,-1,2,1,-3,4,1,-6,8,2,3,1,4,0,1,1,0,-1,12,1,-6,5,-1,0,0,-1,-1,-1,1,6,-1
KR_6763748009,420,1,103,7,2,-1,2,1,0,4,4,-2,3,1,6,2,8,-1,1,0,0,3,-26,1,-9,8,-1,0,3,1,1,1,-1,5,-1
KR_6746897270,420,1,-5,4,2,1,4,5,2,1,3,-3,3,0,-1,4,3,3,0,3,0,-1,-6,-1,-3,4,3,0,1,-1,1,1,1,5,-1
KR_6461638041,420,-2,-62,16,2,1,2,3,1,2,3,-1,5,4,1,1,2,0,0,0,0,2,-46,2,-9,7,14,0,0,1,1,0,-1,1,-1
KR_6763921320,420,-5,-44,-22,-11,-1,5,4,0,1,1,0,2,2,-9,9,0,-1,1,0,0,-7,0,-3,-2,5,-2,0,-2,-1,1,-1,-1,5,-1
KR_6723173033,420,-1,-49,14,5,1,1,2,-5,5,0,-1,2,1,5,0,5,5,0,5,0,7,-29,1,-7,6,1,0,0,1,-1,-1,-1,1,-1
KR_6614176195,420,-4,-29,-24,-10,0,1,1,0,4,4,-4,7,3,-1,3,2,-5,5,0,0,-9,-35,-5,-2,7,-3,0,-1,-1,-1,-1,-1,2,-1
KR_6720346205,420,-3,-40,6,-2,-1,2,1,3,1,4,-3,4,1,0,2,2,-1,1,0,0,0,-117,0,-6,6,-3,0,-1,-1,-1,-1,-1,1,-1
KR_6761481474,420,-2,-37,8,-3,-5,6,1,4,1,5,-2,4,2,-1,3,2,1,0,1,0,2,2,-4,-4,8,-4,0,0,1,-1,0,-1,6,-1
KR_6716535110,420,-5,9,-50,-11,2,0,2,-5,6,1,-2,2,0,-3,4,1,-3,4,1,0,-15,-3,-2,-2,4,-2,0,0,-1,0,0,1,5,-1
KR_6737469116,420,-4,-49,-1,-3,1,1,2,-2,2,0,-1,4,3,-1,2,1,0,1,1,0,-11,-9,1,-6,5,4,0,0,-1,1,0,1,1,-1
KR_6704060852,420,-2,-25,-25,-11,-4,5,1,-1,3,2,3,3,6,-8,10,2,-1,2,1,0,-11,12,4,-8,4,-1,0,-1,-1,-1,-1,1,2,-1
KR_6759917896,440,-2,-18,-12,-5,-3,3,0,1,2,3,-4,5,1,-1,5,4,2,1,3,0,-4,2,6,-6,0,1,0,-1,1,1,-1,-1,4,-1
KR_6666922402,420,1,-3,24,-4,3,0,3,-3,5,2,1,2,3,-5,5,0,0,0,0,1,-10,3,-1,-6,7,-5,0,0,-1,1,-1,1,5,-1
KR_6697030402,420,1,-28,-1,4,-1,3,2,0,4,4,2,0,2,-2,3,1,5,2,7,1,8,-1,-1,-8,9,4,0,-2,-1,1,-1,1,4,-1
KR_6739105928,420,-2,3,4,-14,3,0,3,-10,10,0,-4,4,0,-2,3,1,-1,1,0,0,-22,1,2,-6,4,-2,0,-1,-1,-1,1,-1,1,-1
KR_6701685728,420,-4,-47,-32,-3,-5,6,1,4,4,8,-1,2,1,-1,2,1,0,0,0,0,3,-9,-2,-2,4,-2,0,-1,-1,-1,-1,-1,3,-1
KR_6761865811,420,-2,76,-16,-2,0,2,2,-4,4,0,1,2,3,3,1,4,-2,2,0,0,-4,5,-6,-4,10,1,0,2,-1,-1,1,-1,1,-1
KR_6689354332,420,-3,-78,-29,0,0,2,2,-1,4,3,0,4,4,1,5,6,0,1,1,-1,-5,-9,2,-8,6,0,0,-1,-1,1,-1,-1,1,-1
KR_6760416970,420,-1,10,-18,-3,1,1,2,-2,3,1,-2,6,4,1,1,2,-1,3,2,0,-5,-27,0,-5,5,0,0,0,1,-1,0,-1,5,-1
KR_6707538472,420,-1,-3,16,-3,2,0,2,3,3,6,-4,5,1,-4,6,2,0,1,1,0,-11,30,-2,-6,8,-2,0,0,1,1,0,1,2,-1
KR_6767555198,420,-3,-29,-26,-8,-2,3,1,-2,3,1,-2,6,4,-3,3,0,1,0,1,0,-11,-9,-6,-5,11,4,0,0,-1,-1,0,-1,2,-1
KR_6762618837,420,1,-8,-23,5,-1,3,2,4,3,7,-4,7,3,2,2,4,4,1,5,0,8,5,-1,-8,9,3,0,0,-1,1,0,1,1,-1
KR_6759727675,420,0,14,-15,1,3,1,4,1,3,4,3,1,4,-3,4,1,-3,3,0,0,-2,1,-4,-2,6,1,0,0,-1,-1,-1,1,3,-1
KR_6734283582,420,2,-12,24,0,1,1,2,4,0,4,-2,3,1,-4,6,2,1,0,1,0,-2,27,0,-5,5,-4,0,0,-1,1,1,1,2,-1
KR_6761850375,420,1,-60,16,-3,1,0,1,4,1,5,-1,2,1,-8,9,1,1,0,1,0,-8,0,-1,-7,8,-7,0,1,-1,1,1,-1,6,-1
KR_6767454736,440,-4,-40,4,-1,-2,3,1,0,2,2,0,1,1,0,4,4,1,0,1,0,-2,3,-3,-3,6,-1,0,-1,-1,-1,-1,-1,3,-1
KR_6731752861,420,-3,-74,-19,-8,1,3,4,0,0,0,0,1,1,-5,5,0,-4,4,0,0,-8,4,-4,-3,7,-4,0,-1,-1,-1,-1,-1,4,-1
KR_6757234195,420,2,9,10,5,1,2,3,-2,3,1,4,1,5,-1,2,1,3,0,3,0,-2,119,1,-4,3,-4,0,0,-1,1,0,1,1,-1
KR_6767229821,420,-1,-24,7,4,1,1,2,-2,6,4,3,1,4,3,2,5,-1,1,0,0,4,-4,3,-10,7,-3,0,0,-1,1,0,1,4,-1
KR_6760550186,440,-5,-60,-4,-5,-4,7,3,-1,1,0,1,0,1,1,3,4,-2,2,0,1,-3,-5,5,-6,1,3,0,-1,0,-1,-1,1,0,-1
KR_6768795950,420,-2,18,30,-3,-2,3,1,2,6,8,-2,3,1,0,1,1,-1,3,2,0,-5,7,3,-6,3,-5,0,0,1,1,1,-1,1,-1
KR_6706879702,420,-3,-40,-26,-2,0,3,3,-2,3,1,-2,5,3,-3,4,1,5,0,5,1,12,3,1,-7,6,-2,0,-2,-1,-1,-1,1,5,-1
KR_6763396729,440,4,3,52,11,-1,1,0,0,2,2,4,2,6,3,2,5,5,2,7,-1,7,1,1,-4,3,3,0,2,0,1,-1,-1,0,-1
KR_6698576097,440,1,11,7,-2,4,1,5,-1,2,1,0,0,0,-4,5,1,-1,1,0,0,0,4,4,-7,3,-7,0,1,-1,1,1,1,4,-1
KR_6762449280,420,0,-25,5,-3,-2,2,0,-3,4,1,-3,4,1,3,0,3,2,0,2,-1,-3,7,3,-9,6,7,0,0,1,1,1,-1,5,-1
KR_6629226062,420,-1,-34,5,-7,2,0,2,-4,5,1,2,0,2,-6,7,1,-1,2,1,0,-17,-6,-5,-4,9,-8,0,-2,-1,-1,-1,-1,1,-1
KR_6761431120,420,0,-22,-4,-3,2,1,3,0,2,2,2,0,2,-7,8,1,0,0,0,0,-9,6,0,-4,4,-2,0,0,0,-1,-1,-1,0,-1
KR_6759558454,420,-2,-13,10,1,-1,1,0,3,1,4,-2,2,0,1,5,6,0,0,0,0,2,6,8,-12,4,-5,0,0,1,-1,-1,1,6,-1
KR_6757587612,420,-1,-50,-1,-3,0,1,1,-2,4,2,-2,4,2,0,2,2,1,1,2,0,-1,-6,-4,-3,7,4,0,-1,-1,-1,-1,-1,1,-1
KR_6766443586,420,1,27,28,-4,-2,5,3,0,4,4,0,1,1,0,1,1,-2,2,0,0,-4,-4,-1,-3,4,-1,0,-1,1,-1,-1,-1,4,-1
KR_6739761128,420,-2,56,-9,-9,-2,2,0,-4,6,2,-1,3,2,-1,2,1,-1,3,2,0,-11,-16,1,-5,4,-2,0,-2,-1,1,-1,1,6,-1
KR_6759397279,420,1,7,-1,-1,0,0,0,-1,3,2,0,1,1,4,2,6,-4,4,0,0,-3,5,-6,-4,10,3,0,0,1,-1,0,-1,3,-1
KR_6766122215,420,-4,-49,-23,-7,0,1,1,-1,4,3,-4,4,0,-2,3,1,0,1,1,0,-13,-136,-4,-2,6,-1,0,-1,1,1,-1,1,2,-1
KR_6666327844,420,-3,33,12,-9,-5,5,0,-1,5,4,-2,3,1,0,4,4,-1,2,1,0,-7,-11,-4,-4,8,5,0,2,1,1,1,1,2,-1
KR_6730661360,420,-1,-7,-12,-11,0,1,1,-1,2,1,-4,4,0,-4,4,0,-2,2,0,0,-20,-71,-2,-3,5,1,0,-1,1,-1,-1,-1,2,-1
KR_6759883823,420,0,8,9,7,2,0,2,2,0,2,-2,2,0,4,1,5,1,1,2,1,8,32,-7,-4,11,9,0,0,1,-1,-1,1,4,-1
KR_6767263797,420,-1,-27,8,-4,-3,3,0,-3,4,1,1,1,2,1,3,4,0,0,0,-1,-11,-15,-4,-5,9,5,0,1,-1,1,1,-1,4,-1
KR_6759752195,440,-1,-65,-1,3,-4,6,2,1,0,1,-1,2,1,7,1,8,0,1,1,0,6,9,3,-5,2,-6,0,-1,1,-1,-1,-1,6,-1
KR_6749921503,420,-3,-36,-24,-4,-4,4,0,0,1,1,-1,3,2,-1,1,0,2,1,3,0,4,5,2,-11,9,-2,0,-1,1,-1,-1,-1,3,-1
KR_6764264827,420,3,-26,13,-2,1,3,4,-3,4,1,1,2,3,0,3,3,-1,2,1,-1,-8,14,-5,-4,9,-4,0,0,-1,-1,1,-1,1,-1
KR_6731304543,420,-5,-19,-29,-11,0,1,1,-3,7,4,-4,5,1,-4,5,1,0,0,0,0,-9,-7,-3,-2,5,0,0,-1,-1,1,-1,-1,4,-1
KR_6768771218,420,-4,-59,-7,-2,0,2,2,-1,2,1,2,2,4,-1,1,0,-2,2,0,0,-3,1,1,-6,5,-7,0,0,-1,-1,0,1,6,-1
KR_6760890250,420,-3,-23,11,-7,3,1,4,-1,2,1,-2,2,0,-7,8,1,0,0,0,-2,-15,-15,2,-12,10,-6,0,0,-1,1,0,-1,2,-1
KR_6764434574,420,-4,11,1,-8,-6,6,0,-3,4,1,-1,2,1,2,1,3,0,3,3,-2,-6,1,-4,-4,8,2,0,-1,-1,-1,-1,-1,6,-1
KR_6719708604,420,-4,-14,-55,-9,-1,2,1,-9,10,1,-1,1,0,1,4,5,1,0,1,0,1,-3,1,-9,8,7,0,-1,-1,1,-1,1,4,-1
KR_6767688156,420,-4,-7,-45,-12,1,2,3,-5,6,1,-2,2,0,-4,6,2,-2,3,1,0,-15,-3,-2,-2,4,-1,0,-1,-1,-1,-1,-1,6,-1
KR_6694271150,420,2,1,37,3,0,1,1,4,1,5,2,2,4,-4,5,1,1,2,3,0,6,-13,2,-6,4,4,0,0,1,1,0,1,6,-1
KR_6756866861,420,-6,-28,-5,-7,0,1,1,-3,5,2,2,2,4,-2,3,1,-4,4,0,0,-4,-20,-1,-2,3,2,0,-2,1,0,-1,-1,2,-1
KR_6768153522,420,-2,10,-10,1,5,1,6,-1,1,0,1,1,2,-4,5,1,0,1,1,0,1,30,3,-9,6,2,0,0,1,1,-1,-1,3,-1
KR_6761595599,420,1,6,11,-1,-1,1,0,-1,3,2,5,2,7,-4,5,1,0,1,1,0,-3,6,3,-7,4,-2,0,2,-1,1,1,-1,4,-1
KR_6531399836,420,-3,-7,-20,-9,-6,8,2,1,2,3,2,1,3,-2,4,2,-4,4,0,-1,-12,-3,-3,-6,9,5,0,0,-1,-1,-1,-1,2,-1
KR_6694454069,420,-6,-43,-16,-13,-10,10,0,1,3,4,-3,5,2,1,3,4,-2,2,0,0,-7,2,4,-7,3,-4,0,-1,1,-1,-1,-1,3,-1
KR_6667496394,420,-2,-47,28,-3,3,0,3,-1,1,0,-3,5,2,-2,3,1,0,0,0,-1,-3,11,-2,-4,6,1,0,-1,1,1,-1,-1,5,-1
KR_6759779728,420,0,3,16,3,0,1,1,-1,3,2,-3,3,0,5,2,7,2,0,2,0,5,-1,0,-5,5,-2,0,0,1,-1,-1,-1,2,-1
KR_6689154598,420,-3,-53,-32,-7,-2,3,1,-3,6,3,1,1,2,-2,2,0,-1,1,0,0,-7,-2,1,-7,6,-1,0,0,-1,-1,-1,-1,6,-1
KR_6765028224,420,-3,-39,10,-6,-5,6,1,0,3,3,-1,5,4,1,2,3,-1,2,1,-1,-3,-1,1,-6,5,-9,0,0,-1,-1,-1,-1,5,-1
KR_6756114021,420,-1,-17,-13,-4,2,1,3,-1,3,2,-2,5,3,-4,7,3,1,1,2,-3,-7,-1,-1,-6,7,-2,0,0,-1,-1,-1,-1,1,-1
KR_6767289661,420,-4,21,30,-10,-1,2,1,1,0,1,-3,6,3,-1,5,4,-6,6,0,0,-11,4,0,-4,4,-4,0,0,-1,1,1,-1,2,-1
KR_6756044047,420,-3,-3,-22,-5,1,3,4,-4,5,1,-1,2,1,-1,3,2,0,1,1,0,1,3,1,-5,4,-1,0,-2,-1,-1,-1,-1,5,-1
KR_6766586241,440,-1,-1,-7,-2,-2,3,1,0,2,2,0,1,1,1,3,4,-1,2,1,0,-2,10,0,-4,4,-1,0,0,-1,0,-1,-1,2,-1
KR_6703099128,420,-1,-1,29,-3,0,1,1,0,2,2,1,4,5,-4,5,1,0,1,1,-1,-13,2,2,-8,6,-3,0,0,-1,1,0,-1,2,-1
KR_6765986561,420,-3,-33,-54,-8,0,0,0,-2,4,2,-7,7,0,1,1,2,0,0,0,0,-6,12,-1,-4,5,3,0,-2,-1,-1,-1,-1,3,-1
KR_6754192231,420,2,-26,6,-6,-3,3,0,0,4,4,-2,4,2,-1,3,2,0,0,0,0,-2,-2,-1,-4,5,1,0,0,-1,1,1,-1,2,-1
KR_6761423817,420,-2,-27,8,-6,-3,3,0,0,1,1,-3,4,1,0,1,1,0,0,0,0,-12,-23,3,-7,4,-9,0,-1,-1,-1,-1,1,5,-1
KR_6686678309,420,-2,-29,-12,-2,1,1,2,0,5,5,-1,2,1,-2,2,0,0,1,1,0,-10,14,5,-10,5,-7,0,-1,-1,1,-1,1,6,-1
KR_6761472253,420,-2,-15,17,-5,-1,7,6,-1,5,4,-1,2,1,-3,5,2,1,1,2,-3,-5,-1,-7,-3,10,0,0,-1,-1,-1,-1,-1,4,-1
KR_6637279537,420,-5,-63,-43,-10,-2,3,1,-1,1,0,2,2,4,-10,14,4,1,2,3,-2,-19,-3,-1,-6,7,-2,0,-4,-1,-1,-1,-1,4,-1
KR_6767279572,420,-2,-17,17,-6,-3,3,0,-2,7,5,-2,5,3,3,1,4,-2,2,0,0,-11,0,0,-4,4,-3,0,0,-1,0,1,1,3,-1
KR_6760137724,420,-1,10,-22,-5,-2,2,0,-1,2,1,1,2,3,-1,4,3,-2,2,0,0,-17,3,0,-8,8,5,0,-1,-1,-1,-1,1,4,-1
KR_6763869265,420,-1,-32,-4,-6,-9,10,1,2,0,2,-2,2,0,3,1,4,0,0,0,0,-18,38,-3,-4,7,1,0,0,-1,-1,0,1,3,-1
KR_6764767432,440,-3,13,0,-11,2,1,3,-5,8,3,-6,7,1,0,2,2,-2,4,2,0,-16,-3,-3,-2,5,1,0,0,1,1,0,-1,6,-1
KR_6761000788,420,-1,1,-22,2,-3,3,0,1,0,1,2,2,4,3,3,6,-1,1,0,0,2,9,3,-6,3,-3,0,0,1,1,1,1,5,-1
KR_6751831803,420,-3,-87,24,-3,-5,7,2,3,3,6,6,0,6,-6,8,2,-1,2,1,-1,-8,-286,-1,-3,4,-6,0,-1,-1,1,-1,-1,6,-1
KR_6762331711,420,-2,22,-23,-7,1,1,2,-3,4,1,1,3,4,-5,6,1,-1,1,0,0,-10,6,-1,-6,7,-2,0,-2,-1,-1,-1,-1,3,-1
KR_6685490840,420,0,-25,-4,3,-1,3,2,3,3,6,1,1,2,1,2,3,-1,1,0,0,2,4,3,-9,6,-2,0,-2,-1,1,-1,1,2,-1
KR_6690968751,420,-4,-14,-59,-4,1,0,1,-1,3,2,-5,5,0,1,2,3,0,1,1,0,3,-66,-5,-1,6,2,0,0,-1,-1,1,-1,5,-1
KR_6764926293,420,0,0,2,-1,-2,3,1,1,3,4,-1,2,1,3,1,4,-2,2,0,1,3,-4,5,-7,2,1,0,0,1,-1,-1,1,3,-1
KR_6674185080,420,0,-67,-8,-1,-3,4,1,2,0,2,-1,2,1,0,2,2,1,0,1,0,4,18,-2,-8,10,-1,0,0,-1,1,0,-1,5,-1
KR_6751386429,440,3,12,23,1,1,2,3,-5,5,0,2,2,4,0,4,4,3,4,7,-3,-4,-114,-1,-5,6,-2,0,1,1,1,1,-1,1,-1
KR_6756889623,420,1,22,18,-2,0,1,1,0,1,1,-4,5,1,2,0,2,0,0,0,0,-3,6,-3,-4,7,2,0,1,1,-1,1,-1,1,-1
KR_6740674111,420,-7,-100,-19,-19,-2,5,3,-2,4,2,-5,8,3,-9,10,1,-1,1,0,0,-16,-54,-5,-2,7,10,0,-2,-1,0,-1,1,5,-1
KR_6767299706,420,1,-42,-10,4,0,2,2,2,2,4,4,1,5,-3,5,2,1,1,2,0,2,-10,1,-5,4,0,0,-1,0,1,-1,-1,0,-1
KR_6757007411,420,-1,9,-15,-2,1,2,3,0,3,3,0,3,3,-2,2,0,-1,1,0,-1,1,9,1,-5,4,-3,0,0,1,1,0,-1,6,-1
KR_6762419389,420,-5,-84,-22,-8,2,0,2,-4,5,1,0,4,4,-3,5,2,-3,3,0,0,-5,-10,-7,-2,9,0,0,-2,-1,-1,-1,-1,3,-1
KR_6758864413,420,2,18,33,0,5,0,5,-1,5,4,0,3,3,-4,5,1,0,2,2,0,0,4,-2,-6,8,-4,0,1,-1,1,1,-1,3,-1
KR_6740256076,420,2,-45,28,5,0,2,2,2,3,5,2,0,2,2,0,2,-1,1,0,0,9,4,4,-7,3,3,0,0,1,1,0,-1,1,-1
KR_6752397992,420,-4,-49,-13,-9,1,0,1,-2,3,1,1,4,5,-7,9,2,-2,2,0,0,-16,-3,-2,-5,7,-1,0,-2,0,-1,-1,-1,0,-1
KR_6764810541,420,-1,11,0,-4,1,3,4,-3,6,3,4,2,6,-7,12,5,1,0,1,0,-12,-2,0,-5,5,-2,0,-1,0,-1,-1,-1,0,-1
KR_6746174487,420,-1,15,14,-3,-1,2,1,0,1,1,-3,5,2,2,0,2,-1,1,0,0,1,0,0,-7,7,0,0,0,1,-1,0,-1,6,-1
KR_6737248560,420,-2,8,-6,-7,-1,2,1,-3,3,0,-2,4,2,1,2,3,-2,2,0,0,-4,35,-2,-5,7,-21,0,0,0,-1,0,1,0,-1
KR_6766792951,420,-3,-37,-39,-8,0,0,0,-4,7,3,-2,4,2,-3,6,3,1,0,1,0,1,0,0,-6,6,-4,0,-1,-1,-1,-1,-1,5,-1
KR_6758248682,420,-1,10,-9,-6,-2,2,0,-1,5,4,-3,3,0,-2,5,3,2,1,3,0,-7,-53,-5,-6,11,0,0,0,-1,-1,0,-1,5,-1
KR_6718806636,420,-1,3,13,-6,1,4,5,-1,1,0,1,3,4,-7,8,1,0,1,1,0,-6,-2,1,-4,3,1,0,0,0,1,0,-1,0,-1
KR_6752892572,420,-6,-115,-10,-17,-5,7,2,-6,7,1,-6,7,1,-2,3,1,2,1,3,0,-14,-14,1,-7,6,-7,0,0,-1,1,-1,-1,4,-1
KR_6719832993,420,0,2,-2,-1,-1,3,2,-2,5,3,4,0,4,0,2,2,-2,2,0,0,6,-14,2,-7,5,1,0,1,-1,1,1,1,5,-1
KR_6693454133,420,1,49,5,0,7,1,8,-1,4,3,-3,3,0,-2,2,0,-1,2,1,0,5,-1,-2,-4,6,2,0,0,1,-1,1,1,6,-1
KR_6768117781,420,-3,-50,-27,-3,-3,5,2,0,4,4,1,2,3,0,5,5,-1,2,1,-1,-1,134,2,-7,5,-5,0,-1,1,-1,-1,-1,2,-1
KR_6767781443,420,2,-20,2,3,2,3,5,3,2,5,5,0,5,-7,8,1,0,2,2,-1,-8,1,0,-8,8,-2,0,1,-1,1,1,-1,3,-1
KR_6738210408,440,-3,-17,-17,1,-1,1,0,-2,2,0,-3,4,1,6,2,8,1,0,1,0,-4,0,-2,-1,3,1,0,1,0,1,-1,-1,0,-1
KR_6747938194,420,-2,-55,-5,-12,-10,11,1,-1,3,2,2,1,3,-2,5,3,-1,1,0,-1,-12,-5,1,-9,8,-4,0,-1,-1,-1,-1,-1,2,-1
KR_6750638918,420,1,-70,10,-1,-2,2,0,0,1,1,1,7,8,-4,4,0,4,3,7,-1,-2,10,0,-7,7,-2,0,-1,-1,1,1,-1,3,-1
KR_6735656176,420,-5,-77,12,-9,0,0,0,-3,3,0,1,3,4,-7,8,1,0,0,0,0,-17,4,5,-9,4,-4,0,-1,1,-1,-1,1,2,-1
KR_6768572049,420,1,-4,-28,9,0,0,0,3,0,3,2,0,2,4,1,5,0,1,1,0,15,-7,-5,-3,8,2,0,-1,-1,1,-1,1,6,-1
KR_6763112043,420,-2,-38,5,-1,-1,2,1,-1,3,2,-1,2,1,2,5,7,0,0,0,0,5,0,2,-5,3,-5,0,-1,-1,1,-1,-1,4,-1
KR_6652593043,420,-2,-78,34,-7,-1,1,0,-1,3,2,-6,7,1,2,1,3,-1,1,0,0,3,0,3,-7,4,-3,0,-3,1,-1,-1,-1,3,-1
KR_6764950728,420,1,29,32,2,5,0,5,-3,3,0,2,0,2,-2,3,1,0,0,0,0,-3,-46,0,-3,3,13,0,0,-1,1,1,1,3,-1
KR_6715784059,420,-2,-57,23,1,-1,3,2,9,0,9,0,1,1,-7,8,1,0,2,2,0,7,-11,0,-4,4,0,0,-1,-1,1,-1,-1,3,-1
KR_6768162522,420,-3,-59,-16,-9,-1,1,0,1,2,3,-7,8,1,-3,4,1,1,2,3,0,-13,-27,4,-8,4,-10,0,0,-1,1,0,-1,6,-1
KR_6715990529,420,-3,-5,28,-8,0,1,1,-6,10,4,-2,3,1,0,4,4,0,2,2,2,-17,-113,-2,-4,6,-4,0,0,1,0,0,1,4,-1
KR_6758467419,420,-2,12,4,-1,-3,3,0,0,2,2,0,1,1,1,3,4,1,1,2,0,-2,9,1,-7,6,-1,0,0,1,0,-1,1,2,-1
KR_6756317655,420,-2,25,16,2,-1,2,1,0,3,3,1,2,3,-3,6,3,5,0,5,0,-2,1,-2,-4,6,3,0,0,1,0,-1,-1,3,-1
KR_6745130511,420,-1,-13,-5,-5,1,2,3,-6,9,3,0,1,1,-1,1,0,1,1,2,0,-6,-44,-1,-7,8,2,0,0,1,1,1,1,5,-1
KR_6730413475,420,0,-7,-2,5,4,1,5,2,1,3,-3,4,1,0,4,4,2,1,3,0,-3,42,0,-8,8,-1,0,0,1,1,0,-1,3,-1
KR_6762963759,420,-1,-52,20,1,-2,2,0,0,0,0,0,3,3,4,2,6,-1,4,3,-1,8,12,2,-7,5,-1,0,-2,1,-1,-1,1,5,-1
KR_6680399493,420,-2,-5,8,-6,2,0,2,-3,5,2,-1,2,1,-2,2,0,-2,2,0,0,-16,-1,-9,-4,13,-2,0,0,-1,-1,0,1,3,-1
KR_6690000617,420,-1,-11,50,2,4,0,4,2,3,5,1,1,2,-1,3,2,-4,5,1,0,-9,5,-1,-5,6,-1,0,-1,1,1,-1,-1,1,-1
KR_6643087006,420,-1,37,-16,-1,-1,2,1,-2,4,2,0,2,2,4,2,6,-2,6,4,0,0,4,3,-9,6,2,0,1,1,-1,1,1,3,-1
KR_6764560198,420,-1,-12,8,-3,1,0,1,0,2,2,-3,3,0,-1,3,2,0,2,2,0,-6,5,4,-8,4,-1,0,0,-1,1,0,1,3,-1
KR_6720245126,420,4,-15,4,5,2,1,3,-1,3,2,3,2,5,1,1,2,0,0,0,-1,6,4,-1,-3,4,-2,0,1,-1,1,1,-1,5,-1
KR_6745596030,420,-2,-55,-13,-4,-1,2,1,1,2,3,0,2,2,-3,5,2,-1,3,2,0,-6,45,5,-6,1,-29,0,-1,-1,-1,-1,1,4,-1
KR_6635049848,420,-9,-93,-43,-19,-4,5,1,-11,11,0,-2,4,2,0,2,2,-2,2,0,1,-18,-48,1,-6,5,1,0,-2,-1,-1,-1,1,2,-1
KR_6730773802,420,-3,-44,-2,-4,-1,1,0,-3,4,1,1,0,1,-3,4,1,2,0,2,0,-3,2,-1,-8,9,-5,0,-1,-1,1,-1,-1,6,-1
KR_6704102909,420,-6,-49,-47,-10,-7,7,0,-3,3,0,-3,5,2,2,5,7,1,1,2,0,-11,-39,-2,-4,6,0,0,-1,-1,-1,-1,-1,3,-1
KR_6737678329,420,-2,-13,0,-7,2,2,4,-1,4,3,-2,3,1,0,3,3,-6,6,0,0,-12,12,-2,-8,10,-2,0,0,-1,-1,0,-1,1,-1
KR_6739916130,420,-4,3,5,-11,-1,2,1,-4,5,1,-5,6,1,0,3,3,-1,1,0,0,-16,-29,-4,-3,7,5,0,0,0,1,0,-1,0,-1
KR_6753047268,420,-1,-33,12,-5,0,1,1,0,2,2,1,1,2,-7,12,5,1,0,1,0,-10,7,-2,-2,4,-5,0,-1,1,-1,-1,-1,5,-1
KR_6642097788,420,-5,-125,-46,-11,0,1,1,-8,11,3,-6,9,3,1,2,3,2,0,2,-2,-29,0,8,-11,3,-1,0,-2,1,-1,-1,1,5,-1
KR_6755411170,420,-4,-58,-37,-14,-6,6,0,-4,5,1,-3,4,1,-2,5,3,1,1,2,0,-13,-10,-8,-1,9,-1,0,-1,-1,-1,-1,1,6,-1
KR_6765277235,420,0,-45,-4,0,-6,6,0,3,0,3,3,5,8,2,1,3,-2,3,1,0,11,6,-1,-6,7,2,0,-1,-1,-1,-1,-1,6,-1
KR_6767558156,420,-1,-49,8,-7,-1,2,1,-3,5,2,-1,2,1,-3,5,2,1,2,3,0,-7,34,0,-3,3,-2,0,-1,0,1,-1,1,0,-1
KR_6769050536,420,-2,-13,-22,-3,-1,1,0,-3,4,1,0,0,0,1,1,2,0,1,1,0,-5,-2,-4,-6,10,-4,0,-1,-1,-1,-1,-1,5,-1
KR_6698032373,420,-7,-145,11,-16,-2,3,1,-3,5,2,-3,4,1,-4,8,4,-4,4,0,0,-20,-8,-4,-2,6,-1,0,-4,-1,-1,-1,-1,6,-1
KR_6741806827,440,-4,27,-50,-10,0,1,1,-2,4,2,-1,4,3,0,0,0,-7,8,1,0,-7,-180,-1,-5,6,-4,0,-2,-1,-1,-1,-1,5,-1
KR_6523983145,420,2,12,45,-2,-2,2,0,4,3,7,2,3,5,-4,7,3,-2,3,1,0,-15,-14,-7,-4,11,11,0,0,1,-1,0,-1,2,-1
KR_6756870097,420,-6,-144,-9,-13,3,1,4,-1,4,3,-7,9,2,-7,8,1,-1,3,2,-2,-7,25,-2,-4,6,0,0,-3,-1,-1,-1,-1,1,-1
KR_6755097441,420,0,63,-17,0,-1,3,2,2,2,4,-2,3,1,1,1,2,0,0,0,0,-1,14,3,-10,7,4,0,1,-1,1,1,-1,2,-1
KR_6768175011,420,-3,52,5,-8,4,0,4,-3,5,2,-3,5,2,-2,3,1,-4,4,0,-1,-3,-9,0,-1,1,0,0,1,-1,-1,-1,-1,4,-1
KR_6737974576,420,-2,40,-9,-5,-1,6,5,-3,7,4,-1,2,1,-3,5,2,3,1,4,1,-10,-3,2,-5,3,10,0,-1,1,1,1,1,4,-1
KR_6768748801,420,-5,-24,-7,-9,-2,3,1,-2,3,1,-1,2,1,-4,6,2,0,1,1,0,-8,-67,2,-5,3,-1,0,0,-1,-1,0,-1,5,-1
KR_6686010483,440,5,121,12,8,-4,5,1,3,1,4,7,0,7,2,2,4,0,1,1,0,15,-2,-1,-4,5,3,0,0,-1,-1,-1,1,6,-1
KR_6755037601,420,0,27,2,-1,3,1,4,-3,4,1,1,3,4,2,1,3,-4,5,1,0,-7,-135,1,-6,5,-5,0,0,-1,-1,-1,-1,3,-1
KR_6704125409,420,0,-17,11,0,-3,6,3,2,3,5,0,4,4,0,4,4,1,3,4,1,4,-4,-4,-6,10,0,0,0,1,-1,0,-1,3,-1
KR_6767723544,420,-1,-19,25,-12,-4,4,0,2,4,6,-2,5,3,-6,9,3,-2,3,1,-2,-14,-2,-5,-5,10,2,0,-1,-1,-1,-1,-1,1,-1
KR_6732650256,420,-2,-25,-32,-7,0,2,2,1,2,3,0,1,1,-7,7,0,-1,1,0,-2,-10,-5,-5,-6,11,4,0,0,-1,1,-1,-1,5,-1
KR_6758386429,420,-2,-26,-47,2,0,1,1,-1,2,1,3,1,4,0,5,5,0,2,2,0,-2,3,4,-10,6,5,0,-1,1,-1,-1,1,5,-1
KR_6748949727,420,-3,-44,-16,-10,-4,5,1,-2,2,0,-1,3,2,-3,4,1,0,0,0,0,-16,-50,-2,-4,6,0,0,-2,-1,-1,-1,-1,1,-1
KR_6759530475,420,1,17,24,-6,-2,3,1,-1,2,1,-7,9,2,3,1,4,1,0,1,0,-2,-27,0,-4,4,-4,0,-1,1,-1,-1,-1,6,-1
KR_6736290857,420,0,-74,-13,-5,1,2,3,3,3,6,-8,11,3,-2,2,0,1,0,1,0,2,-5,-6,-6,12,-4,0,-1,-1,1,-1,1,3,-1
KR_6758224257,420,-5,-83,-5,-5,0,0,0,-2,2,0,-1,2,1,-1,4,3,-1,1,0,0,-8,-6,-1,-8,9,0,0,-3,-1,-1,-1,-1,2,-1
KR_6768857510,420,1,-41,-6,2,0,2,2,3,3,6,-2,3,1,1,2,3,0,0,0,0,4,-3,0,-8,8,-9,0,-1,-1,-1,-1,1,1,-1
KR_6740234533,420,0,-3,-11,-2,1,2,3,0,3,3,-3,3,0,0,2,2,0,1,1,0,-10,-11,-4,-5,9,2,0,1,1,1,1,1,4,-1
KR_6762392645,420,1,1,-12,2,-2,3,1,4,1,5,1,1,2,-2,7,5,1,0,1,0,1,-1,-3,-4,7,2,0,0,1,1,0,1,1,-1
KR_6727952093,440,0,87,2,3,-1,3,2,1,0,1,0,2,2,3,3,6,0,0,0,0,2,2,0,-7,7,2,0,2,-1,-1,1,1,2,-1
KR_6757297197,420,1,-20,25,-5,-6,7,1,2,1,3,1,0,1,-3,3,0,1,0,1,0,-2,-15,-1,-3,4,2,0,-1,-1,-1,-1,-1,6,-1
KR_6657233728,420,-4,-15,-5,-7,-5,5,0,-1,4,3,-1,2,1,1,1,2,-1,1,0,0,-3,11,0,-7,7,-7,0,-2,1,-1,-1,-1,1,-1
KR_6768910131,420,-2,-29,6,-5,-1,3,2,-2,7,5,-2,4,2,0,1,1,0,0,0,0,-10,4,0,-5,5,0,0,0,-1,-1,0,-1,2,-1
KR_6742162843,420,-3,30,0,-3,1,2,3,-2,4,2,-3,3,0,2,1,3,-1,3,2,-1,-5,-1,2,-5,3,-2,0,1,-1,1,1,-1,2,-1
KR_6759235249,420,-3,-23,-12,6,-3,4,1,-1,2,1,4,0,4,5,6,11,1,0,1,0,1,1,0,-4,4,-1,0,-2,1,1,-1,1,6,-1
KR_6759513016,420,-2,1,0,-3,3,0,3,-2,2,0,-4,4,0,-2,2,0,2,0,2,0,-5,-23,-1,-2,3,3,0,-1,-1,-1,-1,-1,1,-1
KR_6763830406,420,3,13,20,3,-1,1,0,4,0,4,0,2,2,-1,4,3,1,1,2,0,1,5,-1,-7,8,2,0,0,-1,-1,0,-1,6,-1
KR_6765260491,420,-4,-41,-23,-3,0,1,1,-2,3,1,0,3,3,-3,4,1,2,0,2,0,6,55,0,-4,4,-28,0,-2,-1,1,-1,-1,6,-1
KR_6759292188,420,-1,-72,-4,-2,-7,10,3,3,0,3,0,1,1,-1,2,1,3,0,3,0,6,1,-3,-3,6,-1,0,-2,1,-1,-1,1,3,-1
KR_6766128702,440,-5,-71,6,-13,-4,7,3,-3,4,1,1,0,1,-1,5,4,-6,8,2,0,-17,18,-2,-2,4,-1,0,-2,-1,-1,-1,1,1,-1
KR_6763644486,420,-5,-78,-12,-12,-1,2,1,-6,8,2,-4,4,0,-1,4,3,0,0,0,-2,-16,7,-3,-4,7,1,0,-1,-1,-1,-1,-1,6,-1
KR_6759608938,420,0,6,-44,4,4,4,8,-4,4,0,0,2,2,2,0,2,2,1,3,0,8,0,-2,-2,4,1,0,-2,-1,-1,-1,-1,6,-1
KR_6733238224,420,-7,-71,-51,-11,-1,1,0,-7,7,0,-1,2,1,-3,5,2,1,0,1,0,-9,54,-4,-3,7,5,0,0,-1,-1,-1,-1,1,-1
KR_6760968564,420,-1,-68,-17,-5,0,2,2,-1,3,2,0,2,2,-3,4,1,-1,2,1,0,-5,-4,1,-8,7,10,0,-1,-1,1,-1,-1,2,-1
KR_6763966257,420,-5,-29,-39,-4,-1,1,0,-2,4,2,-1,1,0,0,2,2,0,1,1,0,-13,-4,-2,-5,7,4,0,-1,-1,-1,-1,1,6,-1
KR_6764246722,420,-2,-125,-6,-8,0,4,4,1,2,3,0,1,1,-8,8,0,-1,2,1,-1,-8,-1,-2,-5,7,-1,0,-1,-1,-1,-1,-1,2,-1
KR_6612805108,420,-3,-6,8,-9,-2,3,1,-1,2,1,-4,4,0,-1,3,2,-1,1,0,0,-13,4,1,-6,5,-4,0,-1,-1,-1,-1,1,3,-1
KR_6736459336,420,-3,-46,9,-6,-4,6,2,-2,4,2,1,3,4,0,1,1,-1,1,0,1,-7,-3,6,-12,6,2,0,-1,-1,-1,-1,1,1,-1
KR_6766518445,420,0,19,-8,0,-2,3,1,0,2,2,1,1,2,-1,1,0,2,1,3,0,2,19,-1,-6,7,2,0,-1,-1,1,-1,-1,4,-1
KR_6754093922,440,-2,48,-16,5,-3,4,1,4,0,4,0,2,2,3,0,3,1,1,2,0,14,7,6,-9,3,1,0,0,-1,-1,0,1,3,-1
KR_6689096888,420,-1,8,14,3,2,2,4,5,1,6,-4,4,0,-2,6,4,2,0,2,0,2,-5,-3,-4,7,-3,0,0,1,1,-1,1,3,-1
KR_6763834186,420,-4,-69,-5,-7,0,0,0,0,2,2,0,1,1,-6,6,0,-1,1,0,-1,-6,-7,-5,-3,8,-3,0,-1,1,-1,-1,-1,2,-1
KR_6763964497,420,-3,-13,29,-8,-5,5,0,0,1,1,-3,3,0,-2,5,3,2,0,2,0,-13,-27,2,-9,7,2,0,0,1,1,1,-1,1,-1
KR_6712928423,420,-3,-20,-45,-5,-1,1,0,-1,1,0,1,1,2,-3,4,1,-1,2,1,-1,3,7,-1,-5,6,-7,0,0,-1,-1,0,-1,5,-1
KR_6762454417,420,0,-17,28,-4,-5,5,0,0,1,1,2,1,3,-1,3,2,0,0,0,0,-3,-4,-3,-4,7,-3,0,-1,-1,-1,-1,1,3,-1
KR_6715236671,420,2,-29,13,7,2,2,4,3,2,5,4,1,5,-2,3,1,0,0,0,-1,-3,3,1,-4,3,4,0,1,-1,1,1,-1,3,-1
KR_6720503779,420,-1,-37,3,-4,-3,5,2,0,1,1,-3,4,1,0,1,1,2,1,3,0,0,35,2,-6,4,-9,0,-1,-1,-1,-1,-1,4,-1
KR_6735577323,420,-4,10,-16,-10,-4,4,0,-2,6,4,-1,4,3,-1,2,1,-2,2,0,0,-8,-17,0,-5,5,2,0,-1,1,-1,-1,-1,3,-1
KR_6760682059,420,-1,-23,0,3,2,0,2,-1,3,2,1,2,3,1,2,3,0,0,0,0,-1,-3,-1,-6,7,3,0,0,1,-1,-1,1,5,-1
KR_6755621978,420,-2,-12,-37,2,-2,5,3,0,2,2,1,1,2,3,0,3,0,2,2,0,3,-9,-2,-3,5,4,0,0,-1,-1,0,-1,2,-1
KR_6691942054,440,0,-60,-11,0,4,0,4,-1,5,4,1,1,2,-4,7,3,0,1,1,-1,-11,0,1,-3,2,0,0,1,-1,1,-1,-1,3,-1
KR_6629618000,420,-9,-121,-43,-23,-4,8,4,-12,13,1,-4,4,0,-4,6,2,1,2,3,-2,-23,-11,-3,-4,7,3,0,-3,-1,1,-1,-1,4,-1
KR_6768288395,420,-2,-76,-30,-8,-5,6,1,1,3,4,0,4,4,-3,7,4,-1,2,1,0,-4,4,4,-8,4,-2,0,-2,1,-1,-1,1,6,-1
KR_6765793685,420,-2,-72,-20,-4,1,1,2,-5,5,0,-1,3,2,-1,3,2,2,1,3,-1,-2,-2,-2,-3,5,0,0,0,-1,1,0,-1,5,-1
KR_6699897950,420,2,-57,8,-3,2,1,3,1,2,3,1,4,5,-6,6,0,-1,1,0,0,0,3,2,-10,8,-5,0,0,-1,1,0,-1,2,-1
KR_6704159846,420,0,-55,1,5,3,2,5,2,1,3,2,2,4,-2,2,0,0,0,0,0,-2,27,7,-9,2,-3,0,-1,-1,1,-1,1,6,-1
KR_6763176674,420,-2,-11,-27,0,0,1,1,2,1,3,0,0,0,-1,4,3,-1,1,0,0,2,-58,-1,-3,4,30,0,-1,0,-1,-1,-1,0,-1
KR_6705907772,420,-2,1,-21,-3,3,1,4,-1,3,2,0,1,1,-3,4,1,-2,2,0,0,-6,-6,-1,-4,5,-4,0,-1,-1,1,-1,1,3,-1
KR_6762523081,420,-4,-32,-34,-9,0,1,1,-1,1,0,-4,4,0,-5,6,1,1,0,1,-1,-3,0,4,-6,2,-8,0,0,-1,1,0,-1,3,-1
KR_6741132852,420,-1,-31,3,-8,0,2,2,0,3,3,-4,5,1,-5,6,1,1,0,1,1,-11,27,4,-7,3,-1,0,-2,1,-1,-1,1,2,-1
KR_6753937614,420,0,-33,-8,-6,1,2,3,1,1,2,-1,3,2,-5,7,2,-2,2,0,-1,-9,14,-1,-4,5,-7,0,-1,-1,1,1,-1,5,-1
KR_6743635310,420,0,25,-19,6,-1,2,1,1,3,4,1,1,2,4,2,6,1,2,3,0,12,4,-2,-4,6,3,0,-2,-1,-1,-1,1,6,-1
KR_6768880837,420,-2,-3,-29,-5,-1,2,1,0,4,4,0,2,2,-2,3,1,-2,5,3,-1,1,2,8,-11,3,-6,0,-1,-1,-1,-1,-1,1,-1
KR_6763070060,420,-3,-2,-28,-4,-2,3,1,-5,6,1,0,0,0,1,1,2,2,5,7,0,-8,0,-1,-5,6,0,0,0,-1,-1,0,-1,5,-1
KR_6748993171,420,-2,-55,26,-7,0,2,2,-7,7,0,1,1,2,-2,3,1,1,0,1,0,-12,5,0,-7,7,-4,0,-2,-1,-1,-1,-1,6,-1
KR_6693521384,420,-3,18,-51,-4,2,0,2,1,1,2,-6,6,0,-2,4,2,1,0,1,0,-7,-3,-1,-6,7,-4,0,0,-1,-1,-1,-1,4,-1
KR_6766822468,420,-1,10,-5,-1,2,0,2,0,4,4,0,1,1,-3,7,4,0,1,1,0,-2,-14,1,-8,7,0,0,-1,-1,1,-1,-1,2,-1
KR_6766290644,420,1,46,30,-3,0,1,1,-3,7,4,1,5,6,0,1,1,-1,1,0,0,-7,-5,-1,-3,4,3,0,0,-1,-1,1,-1,5,-1
KR_6688882837,440,-3,-33,16,-13,0,0,0,-5,7,2,-3,3,0,-2,3,1,-3,3,0,0,-13,11,0,-5,5,-5,0,0,-1,0,0,-1,6,-1
KR_6759545199,420,-2,-18,-7,-11,1,1,2,-4,4,0,-3,5,2,-4,7,3,-1,2,1,0,-20,-48,-1,-4,5,3,0,-1,-1,-1,-1,1,3,-1
KR_6755766329,420,-4,-56,2,-6,-3,3,0,-5,7,2,0,1,1,3,3,6,-1,1,0,-1,-2,-119,1,-8,7,-4,0,1,-1,1,1,-1,3,-1
KR_6736895570,420,-1,-61,13,-3,-1,2,1,-2,4,2,0,2,2,0,2,2,0,0,0,0,-6,2,-1,-9,10,-2,0,-1,-1,1,-1,-1,3,-1
KR_6651556667,420,0,-37,-18,-2,0,2,2,0,2,2,6,0,6,-7,8,1,-1,1,0,0,2,-26,2,-9,7,-4,0,0,-1,-1,-1,-1,1,-1
KR_6700895774,420,-1,-30,-28,5,1,0,1,-2,2,0,2,1,3,1,3,4,3,0,3,1,5,7,3,-7,4,-2,0,0,1,-1,0,1,3,-1
KR_6739253404,420,-2,2,-5,-6,-1,2,1,-11,14,3,0,2,2,1,2,3,5,1,6,0,-12,-29,-2,-4,6,-6,0,0,-1,-1,0,1,6,-1
KR_6396360442,420,3,27,4,3,0,2,2,-1,3,2,2,0,2,2,1,3,0,1,1,0,0,-4,-4,-5,9,4,0,0,-1,-1,0,-1,2,-1
KR_6765445716,420,-1,-40,0,-1,-3,3,0,2,1,3,3,1,4,-3,5,2,0,2,2,0,-7,5,-5,-5,10,4,0,1,-1,1,1,1,5,-1
KR_6603100222,420,-6,-107,8,-13,-6,8,2,-2,4,2,-7,9,2,1,0,1,1,0,1,-1,-14,-3,-2,-4,6,-1,0,-2,1,-1,-1,-1,1,-1
KR_6764459193,420,1,25,5,4,-1,3,2,2,2,4,0,1,1,1,3,4,2,1,3,0,2,19,4,-8,4,-6,0,-1,1,-1,-1,-1,6,-1
KR_6767521017,420,-3,-25,-4,-7,0,2,2,-2,6,4,-4,5,1,0,5,5,-1,2,1,0,-7,7,3,-7,4,-6,0,0,-1,1,0,1,4,-1
KR_6766948658,420,0,35,0,5,2,2,4,1,0,1,9,2,11,-2,4,2,-5,5,0,0,-6,15,-2,-5,7,2,0,1,1,1,1,1,1,-1
KR_6765199385,420,-1,14,16,-3,-1,8,7,3,1,4,-3,4,1,-1,2,1,-1,2,1,0,-6,7,-2,-5,7,4,0,0,-1,1,0,1,3,-1
KR_6766805054,420,-1,8,-2,-5,2,1,3,-1,3,2,-10,10,0,3,3,6,1,1,2,1,-5,-113,5,-6,1,-4,0,-2,-1,-1,-1,1,1,-1
KR_6753367789,420,-2,-35,-31,-8,0,2,2,-4,5,1,-2,5,3,-9,10,1,7,0,7,0,-2,-4,-1,-6,7,0,0,-3,-1,-1,-1,-1,4,-1
KR_6758323055,420,1,-58,14,3,-4,5,1,-2,6,4,2,1,3,1,1,2,6,1,7,0,15,-3,1,-7,6,0,0,-1,1,-1,1,1,6,-1
KR_6765166361,420,3,2,32,0,-3,3,0,2,3,5,0,1,1,3,0,3,-2,2,0,0,3,7,-2,-7,9,3,0,0,1,-1,-1,1,3,-1
KR_6752563947,420,-4,-55,15,-4,-1,2,1,0,3,3,2,2,4,-5,5,0,0,1,1,0,-8,113,-2,-7,9,-1,0,-1,-1,1,-1,-1,6,-1
KR_6768925960,420,-4,-26,-4,-12,0,1,1,-8,9,1,3,1,4,-5,7,2,-2,2,0,0,-14,135,-2,-4,6,-9,0,0,-1,1,1,1,5,-1
KR_6767395092,420,2,39,-8,4,2,1,3,-1,4,3,2,2,4,0,2,2,1,1,2,0,2,-35,4,-7,3,1,0,0,-1,1,0,1,4,-1
KR_6755810833,420,-4,-15,-24,-7,1,0,1,-2,3,1,-3,4,1,-4,4,0,1,0,1,0,-5,1,2,-5,3,0,0,0,-1,1,0,1,4,-1
KR_6679225051,420,-5,-45,-21,-12,-1,2,1,-1,3,2,-6,7,1,-3,6,3,-1,1,0,0,-8,178,-2,-6,8,-1,0,-2,-1,-1,-1,-1,3,-1
KR_6740929386,420,-4,-43,-40,-8,-6,6,0,-3,7,4,-2,9,7,4,1,5,-1,2,1,-4,5,-10,-4,-4,8,7,0,-1,1,-1,-1,-1,3,-1
KR_6760897343,420,1,-16,10,0,-2,2,0,6,0,6,-2,2,0,1,3,4,-3,4,1,0,3,-23,-1,-6,7,-1,0,-1,1,-1,-1,-1,6,-1
KR_6766751933,420,3,21,-10,1,2,1,3,2,3,5,-6,6,0,1,3,4,2,0,2,-2,2,7,0,-5,5,5,0,0,1,1,1,-1,5,-1
KR_6769193988,420,-6,-24,-20,-3,-3,3,0,-1,7,6,-1,2,1,2,2,4,0,1,1,1,4,-13,-1,-2,3,3,0,0,1,-1,0,1,2,-1
KR_6715180694,440,-3,-22,-61,-4,2,1,3,-1,5,4,-4,6,2,4,1,5,-5,6,1,0,-8,-2,-3,-3,6,0,0,0,-1,-1,-1,-1,4,-1
KR_6692335490,420,-3,24,-7,-6,-1,1,0,-4,5,1,0,3,3,-3,3,0,2,0,2,0,-14,-26,-3,-7,10,1,0,1,-1,0,1,-1,4,-1
KR_6655594810,420,0,-20,-11,-1,0,2,2,1,2,3,-1,2,1,-1,2,1,0,0,0,0,0,6,4,-8,4,-6,0,0,-1,-1,0,-1,1,-1
KR_6759207054,440,0,9,2,-2,0,1,1,-2,3,1,0,5,5,2,3,5,-2,2,0,1,3,2,3,-7,4,0,0,0,1,1,0,1,2,-1
KR_6728247743,420,-2,-51,-10,-3,-3,4,1,2,3,5,1,0,1,-2,3,1,-1,2,1,0,1,-107,4,-9,5,-5,0,0,-1,1,1,-1,4,-1
KR_6762064853,420,-5,-49,-24,-14,-1,1,0,-3,4,1,-2,3,1,-8,10,2,0,0,0,0,-12,0,3,-7,4,-5,0,-1,1,-1,-1,-1,6,-1
KR_6744823980,440,-1,12,-15,-1,-1,3,2,6,0,6,0,4,4,-5,6,1,-1,1,0,0,3,-1,-1,-8,9,0,0,0,-1,1,-1,1,1,-1
KR_6761441676,440,-7,-56,6,-14,-1,3,2,-6,6,0,-10,10,0,-3,4,1,6,0,6,-1,-12,-6,-1,-6,7,0,0,-1,-1,-1,-1,-1,3,-1
KR_6623409343,420,-6,-104,-30,-6,-3,5,2,-4,4,0,-4,7,3,4,1,5,1,1,2,0,5,-13,-4,-4,8,3,0,0,-1,-1,-1,1,5,-1
KR_6755543979,420,-2,-30,0,-6,-3,3,0,-4,6,2,0,1,1,1,2,3,0,0,0,0,-3,-2,-4,-3,7,-3,0,-2,-1,-1,-1,-1,5,-1
KR_6685447168,420,-3,-34,-5,-14,-5,5,0,-5,8,3,-5,5,0,2,1,3,-1,1,0,0,-11,-14,-4,-5,9,4,0,-2,-1,1,-1,1,3,-1
KR_6761862087,420,-5,-34,-11,-10,-7,7,0,-4,7,3,-1,3,2,3,3,6,-1,2,1,0,-8,-12,-1,-10,11,5,0,-3,1,-1,-1,1,6,-1
KR_6644222579,420,-2,10,12,-6,0,0,0,3,1,4,-7,8,1,1,1,2,-3,3,0,0,1,147,0,-3,3,-1,0,0,1,1,1,1,1,-1
KR_6765642867,420,1,8,-3,2,4,0,4,-2,4,2,-2,5,3,-1,4,3,3,1,4,0,1,3,7,-9,2,0,0,1,1,1,1,1,1,-1
KR_6707009002,420,3,-17,7,8,0,2,2,5,2,7,-3,7,4,4,2,6,2,0,2,1,-7,-21,-4,-1,5,7,0,-2,1,-1,-1,1,6,-1
KR_6650208721,420,0,-11,-6,2,2,2,4,4,2,6,-2,3,1,-3,5,2,1,0,1,1,4,11,4,-8,4,-6,0,0,-1,-1,0,1,1,-1
KR_6732565977,420,-1,-31,-23,-7,1,1,2,-3,6,3,-1,2,1,-3,5,2,-1,1,0,-3,-13,-53,-1,-6,7,-5,0,0,-1,1,-1,-1,4,-1
KR_6736567490,420,-2,-51,28,-6,-4,4,0,-2,4,2,-1,3,2,0,0,0,1,0,1,0,-2,8,2,-5,3,-6,0,-1,-1,1,-1,1,4,-1
KR_6755729548,420,-1,-32,-7,0,5,0,5,-3,5,2,0,1,1,-3,4,1,1,1,2,0,-2,-21,-1,-8,9,3,0,-1,1,-1,-1,-1,1,-1
KR_6750901184,440,1,61,-1,-1,3,3,6,5,1,6,-8,8,0,-1,2,1,0,0,0,0,-10,19,-10,0,10,5,0,0,1,1,1,-1,6,-1
KR_6766876677,420,2,32,36,5,-3,3,0,2,3,5,2,1,3,1,2,3,3,1,4,0,9,3,-4,-5,9,5,0,2,1,1,1,1,1,-1
KR_6767598783,420,-1,-31,-17,4,-1,2,1,5,4,9,-2,5,3,2,3,5,0,3,3,-2,7,-1,3,-8,5,2,0,0,1,-1,-1,-1,5,-1
KR_6766441656,420,-4,-1,28,-6,-4,4,0,-1,1,0,-2,2,0,0,0,0,1,0,1,0,-4,-9,-2,-4,6,5,0,0,1,1,0,-1,5,-1
KR_6620365824,420,-1,-21,28,-7,-9,9,0,2,1,3,0,2,2,-2,5,3,2,1,3,0,-1,109,2,-6,4,3,0,0,-1,1,-1,-1,1,-1
KR_6749404238,420,-4,-53,-4,-6,0,2,2,-2,5,3,-7,9,2,3,4,7,0,0,0,0,-5,-4,-1,-8,9,-1,0,0,-1,0,-1,-1,5,-1
KR_6626195912,420,-3,-45,5,-12,-2,3,1,-6,7,1,1,1,2,-4,6,2,-1,1,0,0,-14,-12,-1,-7,8,2,0,-3,-1,-1,-1,1,2,-1
KR_6686565329,420,-5,-85,-4,-11,-1,1,0,-2,5,3,-1,3,2,-7,8,1,0,0,0,0,-19,193,-3,-4,7,1,0,-2,-1,1,-1,-1,5,-1
KR_6672532216,440,-3,-27,-13,-9,-6,7,1,4,4,8,-2,7,5,-1,4,3,-4,5,1,-1,-4,-17,-2,-2,4,2,0,-3,-1,-1,-1,-1,6,-1
KR_6761551637,420,0,-67,-20,6,0,2,2,7,0,7,-3,4,1,1,2,3,1,1,2,0,12,9,9,-10,1,2,0,-1,1,-1,-1,1,2,-1
KR_6738268433,440,2,63,1,4,4,1,5,-1,5,4,-2,3,1,1,2,3,2,0,2,0,4,-1,4,-7,3,1,0,0,1,1,0,1,2,-1
KR_6707616262,420,-1,23,-12,0,0,0,0,-1,3,2,1,0,1,1,2,3,-1,3,2,0,-1,3,4,-8,4,1,0,0,-1,1,0,-1,3,-1
KR_6756233328,420,-1,12,-18,-4,4,3,7,1,2,3,-2,4,2,-3,3,0,-4,4,0,0,-7,-12,-1,-6,7,-2,0,0,0,1,1,-1,0,-1
KR_6757673401,420,-1,2,-25,-3,8,0,8,-3,4,1,-1,1,0,-4,5,1,-3,3,0,0,-9,-9,-3,-4,7,-2,0,0,-1,-1,-1,1,1,-1
KR_6743656269,420,-5,-63,-15,-9,-4,4,0,0,2,2,-3,4,1,-4,5,1,2,0,2,-1,-5,-1,-3,-7,10,-4,0,-1,-1,-1,-1,-1,2,-1
KR_6758265216,420,0,21,-20,6,-1,1,0,0,3,3,5,0,5,1,1,2,1,0,1,0,-2,1,0,-3,3,4,0,0,0,1,1,-1,0,-1
KR_6768613800,420,1,39,12,10,6,0,6,6,0,6,2,2,4,-4,8,4,0,0,0,0,3,5,1,-7,6,1,0,-1,1,-1,-1,1,6,-1
KR_6753466346,420,-1,-41,26,-1,0,1,1,3,1,4,-10,14,4,1,4,5,5,0,5,1,6,16,4,-10,6,-4,0,1,1,1,1,1,3,-1
KR_6755987446,420,-1,-13,-40,-3,2,0,2,0,3,3,-3,4,1,-3,7,4,1,2,3,0,-15,3,0,-5,5,-6,0,-1,-1,1,-1,-1,1,-1
KR_6611908209,420,-2,-104,20,-2,-5,6,1,2,0,2,3,1,4,-3,4,1,1,0,1,0,5,-2,2,-7,5,3,0,0,-1,1,-1,-1,1,-1
KR_6649068872,420,-4,-6,-25,-10,-5,5,0,-1,3,2,-3,3,0,-1,3,2,0,1,1,0,-9,9,5,-8,3,-5,0,-2,-1,-1,-1,1,4,-1
KR_6759268011,420,-5,-63,-69,-10,-6,9,3,-3,9,6,-5,5,0,4,1,5,0,2,2,0,4,-17,-2,-4,6,-1,0,-2,-1,-1,-1,-1,1,-1
KR_6674841815,420,-6,-44,-49,-13,-6,6,0,-3,5,2,-2,4,2,-2,3,1,0,0,0,0,-5,-7,1,-6,5,-1,0,-1,-1,-1,-1,1,5,-1
KR_6687640381,420,-5,-77,-14,-16,-2,5,3,-6,6,0,-3,5,2,-4,4,0,-1,1,0,0,-11,-2,-2,-3,5,-4,0,-2,-1,-1,-1,1,6,-1
KR_6704495096,420,3,28,14,3,-3,4,1,3,2,5,1,2,3,5,1,6,-3,3,0,0,5,-10,-2,-3,5,2,0,0,1,-1,-1,-1,1,-1
KR_6741575305,420,1,-5,25,2,0,1,1,3,2,5,-5,5,0,3,4,7,1,1,2,-2,1,-5,-2,-4,6,5,0,1,1,1,1,-1,5,-1
KR_6759953561,420,-1,-46,0,-3,1,2,3,3,2,5,-3,5,2,-4,4,0,0,1,1,0,-6,-16,0,-5,5,2,0,2,-1,1,1,-1,6,-1
KR_6767168395,420,0,-35,-4,0,-1,1,0,-4,5,1,3,0,3,2,0,2,0,1,1,1,0,6,-3,-4,7,-6,0,0,-1,0,0,1,3,-1
KR_6753937493,420,2,61,-14,3,-1,3,2,0,3,3,2,1,3,2,3,5,0,2,2,0,4,9,2,-8,6,-4,0,-1,-1,-1,-1,1,2,-1
KR_6764570338,440,0,1,-24,2,0,2,2,-1,3,2,-1,1,0,3,2,5,1,0,1,0,-2,4,-4,0,4,-5,0,-1,-1,-1,1,1,6,-1
KR_6768872860,420,-3,-44,-14,-6,-2,4,2,-1,3,2,-2,3,1,-1,3,2,0,1,1,0,-7,0,1,-7,6,2,0,0,1,1,-1,1,1,-1
KR_6767277841,420,-4,-51,9,-9,1,0,1,0,2,2,0,2,2,-5,5,0,-5,5,0,0,-9,-4,-3,-5,8,-4,0,-1,-1,-1,-1,-1,4,-1
KR_6732943793,420,-6,-83,-8,-19,-2,4,2,-7,9,2,-3,5,2,-5,5,0,-2,2,0,0,-22,137,-8,-3,11,0,0,-1,-1,-1,-1,1,3,-1
KR_6728399659,420,-1,9,4,3,3,0,3,2,3,5,0,5,5,-2,3,1,0,0,0,0,6,0,3,-11,8,-3,0,1,1,-1,1,1,3,-1
KR_6761194312,420,0,12,-5,-2,2,0,2,-5,5,0,5,2,7,-3,4,1,-1,1,0,0,-5,1,1,-9,8,-1,0,-2,1,-1,-1,1,1,-1
KR_6742898244,420,0,-10,-31,3,-1,2,1,1,0,1,4,2,6,4,0,4,-5,5,0,0,17,1,2,-9,7,-6,0,-1,1,-1,-1,-1,5,-1
KR_6768351833,420,-2,-56,-20,-3,-2,3,1,4,1,5,0,0,0,1,3,4,-6,6,0,0,-1,11,5,-8,3,-2,0,0,-1,1,-1,-1,2,-1
KR_6763045222,420,-1,29,-4,0,1,0,1,-1,5,4,-3,5,2,3,1,4,0,0,0,0,-4,-13,-1,-5,6,-6,0,0,-1,1,0,1,4,-1
KR_6767407429,420,-2,4,-4,-8,0,2,2,-8,9,1,-2,2,0,3,2,5,-1,2,1,-1,-9,-7,1,-6,5,5,0,0,1,-1,0,-1,1,-1
KR_6758240518,420,-2,-37,-12,-3,2,2,4,-4,4,0,0,4,4,-2,2,0,1,2,3,1,0,-4,-4,-6,10,-2,0,-1,-1,1,-1,1,5,-1
KR_6699739813,420,-6,-29,-5,-12,3,1,4,-5,6,1,-2,4,2,-11,11,0,3,0,3,0,-15,10,3,-7,4,-4,0,-2,-1,1,-1,-1,3,-1
KR_6758794431,420,-2,-17,-4,-4,-3,3,0,6,1,7,-4,4,0,-3,4,1,0,0,0,-1,3,-2,5,-9,4,-1,0,-2,1,-1,-1,-1,4,-1
KR_6752698893,420,-4,-96,-14,-6,-7,7,0,0,0,0,2,0,2,-2,2,0,1,0,1,-1,2,-2,0,-6,6,0,0,-2,-1,-1,-1,-1,2,-1
KR_6675310403,420,0,-16,-2,1,-1,2,1,3,1,4,-1,3,2,-1,4,3,1,0,1,0,5,-6,-4,-2,6,1,0,-1,-1,-1,-1,1,4,-1
KR_6766123829,420,0,9,24,1,4,1,5,-3,5,2,-3,4,1,4,2,6,-1,2,1,1,-6,-8,1,-8,7,3,0,0,1,-1,-1,1,3,-1
KR_6721307813,420,-2,-39,-8,-4,1,0,1,0,3,3,0,0,0,-6,6,0,1,0,1,0,-7,0,-3,-3,6,1,0,0,-1,1,0,1,5,-1
KR_6755307058,420,1,-27,-4,-3,2,0,2,-5,6,1,-5,5,0,1,2,3,4,0,4,0,2,28,-3,-2,5,-5,0,-1,-1,-1,-1,1,6,-1
KR_6764067552,420,-1,-52,1,-5,-2,2,0,-3,3,0,0,1,1,-2,7,5,2,0,2,0,-1,-5,-4,-4,8,3,0,-1,1,1,-1,-1,2,-1
KR_6684283829,420,0,8,-11,0,1,1,2,2,3,5,3,2,5,-4,4,0,-2,2,0,0,1,-1,-1,-5,6,0,0,-1,-1,-1,-1,-1,5,-1
KR_6678955583,420,-3,-9,-4,-5,1,0,1,-2,3,1,0,3,3,-3,3,0,-1,1,0,0,-9,-40,-4,-6,10,0,0,-1,-1,-1,-1,1,6,-1
KR_6736305927,420,-4,12,-20,-4,-1,2,1,0,4,4,-8,8,0,6,0,6,-1,1,0,0,0,0,-6,-4,10,5,0,0,-1,-1,1,1,4,-1
KR_6745226174,420,-2,-53,-12,-7,0,0,0,-2,2,0,-3,4,1,0,1,1,-2,2,0,0,-5,-34,-2,-4,6,-1,0,0,-1,-1,-1,1,2,-1
KR_6676734550,420,-5,-39,-58,-1,2,2,4,-6,8,2,4,1,5,-2,4,2,1,0,1,0,-3,9,-1,-5,6,-1,0,1,-1,1,1,1,6,-1
KR_6655972581,440,-3,63,-61,-11,3,0,3,-8,10,2,-5,6,1,-1,2,1,0,2,2,0,-10,5,0,-2,2,-2,0,0,-1,-1,-1,-1,1,-1
KR_6724694308,420,-1,29,13,-3,2,1,3,-3,3,0,1,2,3,-2,3,1,-1,2,1,0,-5,44,2,-6,4,-34,0,0,-1,1,-1,1,6,-1
KR_6616200176,420,-3,-107,-27,-12,-3,4,1,-5,5,0,-1,2,1,-3,3,0,0,0,0,0,-15,1,0,-6,6,1,0,-2,-1,1,-1,1,5,-1
KR_6291693719,420,-4,-53,-11,-13,-11,11,0,0,2,2,-1,3,2,1,3,4,-2,2,0,-1,-12,-44,-5,-4,9,3,0,-2,-1,-1,-1,-1,3,-1
KR_6713255303,420,2,-3,15,-2,0,0,0,6,1,7,-3,3,0,-3,7,4,-2,4,2,0,8,16,3,-9,6,-8,0,0,-1,1,0,-1,4,-1
KR_6763028716,440,0,66,-20,2,2,1,3,-2,3,1,-1,4,3,2,0,2,1,0,1,0,2,15,-2,-2,4,-4,0,0,-1,1,1,1,4,-1
KR_6767950455,420,-1,-21,2,-1,0,1,1,2,1,3,0,1,1,-3,7,4,0,0,0,0,2,-12,-4,-8,12,5,0,1,1,-1,-1,-1,2,-1
KR_6766706724,440,-1,45,-16,2,1,1,2,1,3,4,1,3,4,-1,4,3,0,1,1,0,10,-3,2,-6,4,1,0,0,-1,1,1,-1,2,-1
KR_6760674097,420,2,80,15,-1,1,2,3,1,3,4,2,2,4,-3,3,0,-2,2,0,0,-5,-1,-1,-4,5,4,0,1,1,-1,1,-1,3,-1
KR_6634771475,420,0,-12,-17,10,-1,2,1,7,0,7,3,2,5,1,2,3,0,1,1,0,12,24,0,-7,7,-1,0,1,-1,1,1,1,5,-1
KR_6758953173,420,-13,-167,28,-9,-4,4,0,-6,6,0,-4,4,0,4,1,5,1,1,2,0,-6,-16,-2,-2,4,-3,0,-4,-1,1,-1,-1,1,-1
KR_6765601442,420,-5,-56,3,-6,3,0,3,-4,5,1,-2,4,2,-3,7,4,0,0,0,0,-7,-8,-2,-7,9,2,0,-1,-1,1,-1,-1,3,-1
KR_6767468215,420,0,-38,2,-1,0,1,1,-2,5,3,-2,5,3,1,3,4,2,1,3,0,13,4,5,-9,4,-2,0,0,0,0,-1,-1,0,-1
KR_6754884716,420,-3,-29,-7,-4,2,0,2,-2,3,1,-1,3,2,-1,1,0,-2,3,1,-1,-10,-25,-4,-6,10,-6,0,-1,-1,-1,-1,-1,1,-1
KR_6573095789,420,-3,-49,-7,-2,-4,4,0,1,3,4,2,0,2,-2,7,5,1,0,1,-2,2,-54,-7,-5,12,47,0,0,1,1,1,-1,5,-1
KR_6758263642,420,-2,-10,-5,-9,-1,2,1,-5,8,3,-1,2,1,-3,3,0,1,0,1,0,-15,-47,2,-4,2,3,0,0,-1,1,1,-1,1,-1
KR_6751009878,440,-2,-8,21,-3,-3,4,1,-1,5,4,0,2,2,1,0,1,0,6,6,-1,-9,11,5,-7,2,-5,0,-1,1,0,-1,-1,1,-1
KR_6765981482,420,-3,-71,-7,-7,-3,3,0,3,0,3,-7,7,0,0,3,3,0,1,1,0,-3,-23,1,-4,3,0,0,0,-1,1,-1,-1,6,-1
KR_6759453572,420,1,-72,12,-2,-6,9,3,3,0,3,4,0,4,-3,3,0,0,1,1,0,-1,-15,-10,-1,11,1,0,1,-1,1,1,-1,1,-1
KR_6767805367,420,3,67,39,1,1,2,3,0,2,2,5,3,8,-3,5,2,-2,2,0,1,8,4,-2,-6,8,0,0,-2,1,-1,-1,1,4,-1
KR_6761257743,420,-4,-31,-32,-5,-1,2,1,-5,7,2,2,1,3,-2,4,2,1,0,1,0,-3,1,-2,-6,8,2,0,-2,-1,1,-1,-1,1,-1
KR_6767366019,420,-3,-25,-5,2,-1,2,1,0,1,1,3,1,4,0,0,0,0,0,0,0,4,3,5,-8,3,2,0,0,-1,1,0,1,4,-1
KR_6768342608,420,0,-3,-22,-7,-4,4,0,-3,5,2,-3,4,1,5,3,8,-2,2,0,-1,-5,-4,-3,-3,6,3,0,-1,-1,-1,-1,-1,2,-1
KR_6747969972,420,-2,-38,-23,-3,-2,4,2,-5,6,1,-3,3,0,4,2,6,3,2,5,-1,-11,0,3,-10,7,1,0,0,-1,1,1,-1,1,-1
KR_6762729178,420,0,-22,8,0,0,2,2,-1,3,2,2,1,3,-2,4,2,1,0,1,0,-3,-10,-5,-4,9,4,0,0,-1,1,0,1,5,-1
KR_6741995917,420,-6,-70,5,-5,-1,3,2,3,2,5,-1,2,1,-4,6,2,-2,2,0,0,-5,-4,0,-9,9,-2,0,-3,-1,-1,-1,1,2,-1
KR_6763857639,420,-5,-37,-30,-6,-1,1,0,0,3,3,-1,1,0,-4,8,4,0,1,1,0,-1,2,0,-6,6,-7,0,0,-1,1,0,-1,6,-1
KR_6762315763,420,-3,-28,-15,-10,-3,3,0,1,0,1,-2,4,2,-5,7,2,-1,3,2,0,-7,-39,1,-5,4,3,0,0,-1,-1,-1,1,2,-1
KR_6765730915,420,2,96,8,1,-1,1,0,-2,3,1,2,1,3,4,2,6,-2,2,0,0,3,6,0,-6,6,-8,0,0,1,0,0,1,5,-1
KR_6668090795,420,-1,-39,10,-2,2,1,3,-1,2,1,0,3,3,-5,6,1,2,0,2,0,-16,-47,-2,-5,7,24,0,0,-1,1,1,-1,6,-1
KR_6703704148,420,-3,-1,-20,0,-2,4,2,-2,4,2,-1,1,0,2,1,3,3,0,3,1,8,3,2,-6,4,3,0,0,-1,-1,1,1,5,-1
KR_6734964063,420,-4,-47,15,-5,-2,5,3,-1,6,5,-1,2,1,0,3,3,-1,2,1,0,-8,259,-3,-2,5,-3,0,-2,1,-1,-1,-1,3,-1
KR_6758806861,420,-1,4,-20,-4,-3,4,1,2,1,3,-3,5,2,-1,2,1,1,0,1,0,-7,-2,-3,-6,9,3,0,-2,-1,-1,-1,-1,2,-1
KR_6727403203,420,-4,-20,-35,-9,0,1,1,-5,7,2,-1,2,1,-1,2,1,-2,2,0,0,-19,-54,-2,-5,7,29,0,0,-1,-1,-1,1,1,-1
KR_6764512505,420,-2,-37,-17,-4,-2,3,1,-3,3,0,1,4,5,1,1,2,-1,4,3,-1,5,-40,-3,-5,8,2,0,0,0,-1,0,-1,0,-1
KR_6769051422,440,-1,29,-16,-3,0,1,1,-5,6,1,-1,2,1,3,2,5,0,3,3,0,4,3,2,-5,3,4,0,-1,1,-1,-1,1,5,-1
KR_6728043149,420,-2,-18,6,-4,-1,2,1,-1,2,1,0,1,1,-3,5,2,1,1,2,0,-6,27,0,-5,5,-5,0,-1,-1,-1,-1,-1,1,-1
KR_6698780372,440,-1,-47,-17,-4,3,0,3,-2,5,3,0,1,1,-1,2,1,-4,4,0,0,-2,-15,1,-5,4,-1,0,-3,-1,-1,-1,-1,3,-1
KR_6768116494,420,0,33,-23,1,1,0,1,-3,7,4,2,1,3,1,0,1,0,3,3,0,9,2,-2,-4,6,-1,0,-1,-1,-1,-1,1,2,-1
KR_6762040101,420,0,63,-27,-6,-1,2,1,1,3,4,-2,3,1,0,0,0,-4,4,0,0,-8,12,3,-9,6,-3,0,-1,-1,-1,-1,1,4,-1
KR_6738583572,440,1,-28,21,1,1,0,1,-3,4,1,1,0,1,2,4,6,0,3,3,0,6,-1,-1,-5,6,4,0,0,1,-1,1,-1,1,-1
KR_6664066170,420,0,32,-15,-2,-1,3,2,-4,5,1,5,0,5,-2,3,1,0,0,0,0,-5,98,-6,-2,8,2,0,0,-1,-1,0,1,2,-1
KR_6768853030,420,1,-21,-8,-1,5,0,5,-2,4,2,1,1,2,-7,7,0,2,0,2,0,-8,-5,0,-5,5,-2,0,1,-1,-1,1,-1,3,-1
KR_6598064825,420,-2,-74,17,-6,1,2,3,0,5,5,-3,3,0,-2,4,2,-2,4,2,-1,-6,-14,-10,-3,13,2,0,0,-1,1,0,-1,3,-1
KR_6715281302,420,-5,-43,-59,-11,-1,2,1,0,0,0,-4,6,2,-5,7,2,-1,4,3,1,-17,0,-1,-6,7,-2,0,-2,-1,-1,-1,1,1,-1
KR_6764846052,420,0,40,-6,0,0,1,1,-4,6,2,0,2,2,0,4,4,4,0,4,0,4,-3,1,-8,7,-1,0,0,-1,-1,0,-1,6,-1
KR_6764657941,420,-2,-24,-21,1,1,3,4,-3,3,0,3,0,3,-2,3,1,2,0,2,0,1,7,6,-9,3,-6,0,-3,1,-1,-1,-1,6,-1
KR_6666334943,420,-2,-15,12,-9,1,1,2,-4,4,0,-5,6,1,1,1,2,-2,2,0,0,-7,-13,-1,-8,9,3,0,-1,-1,-1,-1,1,1,-1
KR_6718860457,420,-2,-36,-18,-7,-1,4,3,-3,5,2,0,3,3,-3,5,2,0,1,1,-1,-7,-8,0,-6,6,0,0,0,1,-1,-1,-1,2,-1
KR_6697287111,420,-1,-20,-8,0,1,2,3,-3,3,0,-1,1,0,4,1,5,-1,1,0,0,-6,50,-2,-8,10,0,0,-1,-1,1,-1,1,2,-1
KR_6751699753,420,0,-21,-16,-6,-1,3,2,-2,5,3,1,1,2,-3,5,2,-1,1,0,0,-13,-4,-1,-3,4,-6,0,-4,-1,-1,-1,1,1,-1
KR_6698789710,420,-4,-13,-20,-10,-5,5,0,-2,4,2,-1,2,1,-1,4,3,-1,1,0,0,-9,-5,-4,-2,6,-1,0,-1,-1,-1,-1,1,4,-1
KR_6765889420,420,0,-36,12,-2,1,1,2,-3,5,2,-1,3,2,1,2,3,0,1,1,0,-10,0,-1,-6,7,-4,0,0,1,-1,0,-1,1,-1
KR_6757115077,420,-1,-70,-20,3,0,2,2,-1,2,1,0,3,3,3,1,4,1,0,1,0,10,-225,5,-8,3,5,0,0,-1,1,-1,1,4,-1
KR_6751136563,420,1,24,-2,0,0,1,1,0,2,2,-1,1,0,1,0,1,0,1,1,0,0,11,6,-8,2,-3,0,0,0,1,0,-1,0,-1
KR_6740198032,420,1,-36,8,4,-3,4,1,-2,3,1,1,3,4,8,1,9,0,0,0,0,13,39,0,-6,6,-17,0,-1,-1,-1,-1,1,4,-1
KR_6712384400,420,-2,-49,-9,-6,2,1,3,-2,4,2,-4,4,0,0,1,1,-2,3,1,-2,-3,60,-5,-2,7,0,0,-2,-1,-1,-1,-1,6,-1
KR_6689641484,420,-2,-60,24,-6,1,2,3,-1,2,1,-4,4,0,-2,3,1,0,0,0,0,-3,11,0,-5,5,1,0,0,-1,1,0,1,3,-1
KR_6748312314,420,3,60,-7,7,5,0,5,-2,3,1,0,2,2,2,4,6,2,2,4,0,8,6,-2,-2,4,0,0,2,1,-1,1,1,6,-1
KR_6767075599,420,-5,17,-24,-13,-3,3,0,-1,4,3,-5,5,0,-5,5,0,1,0,1,0,-12,0,1,-4,3,-2,0,1,-1,-1,1,-1,6,-1
KR_6720835421,420,4,12,26,2,-1,2,1,2,1,3,-2,3,1,2,3,5,1,0,1,0,4,116,-5,-4,9,6,0,1,1,-1,-1,-1,6,-1
KR_6740659218,420,-2,-11,-12,0,2,0,2,-3,4,1,-2,3,1,0,1,1,3,1,4,0,-4,-34,2,-6,4,0,0,0,-1,1,-1,-1,3,-1
KR_6613368844,420,-2,30,0,0,-3,4,1,2,0,2,1,2,3,0,1,1,0,0,0,0,2,-43,-1,-5,6,6,0,-1,1,-1,-1,-1,4,-1
KR_6768780399,420,-4,-52,-8,-7,-5,5,0,-3,3,0,1,2,3,1,0,1,-1,1,0,0,-8,-5,-2,-6,8,1,0,-1,-1,-1,-1,-1,6,-1
KR_6750190369,420,3,24,33,0,2,1,3,0,3,3,-3,6,3,1,2,3,0,1,1,0,8,-184,1,-4,3,-3,0,1,-1,-1,1,-1,2,-1
KR_6629557101,420,-3,-48,-31,-3,2,2,4,-5,9,4,0,3,3,0,1,1,0,0,0,0,-3,-9,0,-7,7,1,0,0,-1,1,0,1,5,-1
KR_6761440845,420,-1,-27,3,-3,-6,6,0,2,3,5,0,2,2,1,1,2,0,1,1,0,-9,37,0,-3,3,-4,0,0,1,-1,-1,1,3,-1
KR_6688747431,440,2,43,2,-3,1,2,3,-3,3,0,2,0,2,-4,5,1,1,0,1,0,-10,6,3,-7,4,4,0,0,-1,1,-1,1,4,-1
KR_6748307495,440,-1,43,-24,1,2,1,3,-3,4,1,-2,2,0,3,5,8,1,1,2,-1,-2,3,6,-7,1,-2,0,1,-1,0,1,-1,1,-1
KR_6732717548,420,-2,-30,-1,-6,-2,3,1,2,2,4,-3,4,1,-2,5,3,-1,1,0,0,-2,9,4,-10,6,0,0,0,-1,-1,1,-1,4,-1
KR_6767810705,420,-3,-32,-32,-9,-1,1,0,0,4,4,-2,4,2,-7,10,3,1,0,1,0,-8,4,3,-8,5,-6,0,-1,-1,-1,-1,1,3,-1
KR_6616195530,420,-2,-55,-25,0,-3,5,2,1,4,5,0,1,1,2,2,4,0,1,1,0,6,-4,-5,-1,6,1,0,-1,-1,-1,-1,-1,3,-1
KR_6742393231,420,-5,-61,16,-13,2,1,3,-7,9,2,-2,3,1,-3,6,3,-3,3,0,0,-20,26,1,-6,5,-4,0,0,-1,1,1,-1,1,-1
KR_6751474807,440,-2,-39,-5,-3,-2,2,0,-4,7,3,3,1,4,1,0,1,-1,2,1,0,6,7,1,-6,5,1,0,-1,1,-1,-1,-1,6,-1
KR_6734707222,420,-3,-21,-37,-7,-2,2,0,-1,4,3,-1,3,2,-4,7,3,1,0,1,0,-11,-106,-1,-5,6,-4,0,0,-1,1,1,-1,3,-1
KR_6768344435,420,-2,-4,-14,-6,0,2,2,0,4,4,-3,4,1,-3,3,0,0,0,0,0,-6,28,0,-5,5,-3,0,0,-1,1,0,1,4,-1
KR_6690032223,420,-3,29,0,-2,-1,3,2,-5,7,2,6,1,7,0,1,1,-2,3,1,0,2,-6,-1,-7,8,4,0,-1,1,-1,-1,-1,1,-1
KR_6760111107,420,-3,-59,-6,0,-2,2,0,-3,4,1,4,0,4,0,4,4,1,0,1,2,2,-30,-5,-3,8,3,0,0,-1,1,0,1,6,-1
KR_6762062766,420,-1,-38,-19,-2,1,1,2,-10,11,1,7,0,7,-1,1,0,1,0,1,0,4,-198,3,-6,3,2,0,0,-1,1,0,-1,4,-1
KR_6756036222,420,1,41,-16,1,1,1,2,1,7,8,0,3,3,2,2,4,-3,4,1,0,11,-9,3,-7,4,0,0,1,-1,1,1,-1,3,-1
KR_6692935211,440,1,-63,-7,8,-2,3,1,6,5,11,0,4,4,4,0,4,0,0,0,0,13,1,6,-7,1,0,0,-1,-1,1,-1,1,1,-1
KR_6748181205,420,1,1,15,2,2,2,4,4,2,6,-1,1,0,-3,3,0,0,2,2,-2,0,52,5,-6,1,-2,0,-1,-1,0,-1,-1,6,-1
KR_6642940886,420,-3,-27,9,-11,1,0,1,1,2,3,-4,5,1,-9,10,1,0,1,1,0,-13,-12,-6,-4,10,2,0,-3,-1,-1,-1,-1,3,-1
KR_6672753111,440,-2,-39,-12,-5,-2,4,2,-3,3,0,-4,5,1,3,5,8,1,5,6,0,-7,8,2,-3,1,-3,0,0,1,1,-1,-1,3,-1
KR_6634206880,420,-8,-60,-5,-14,-6,6,0,-1,2,1,0,2,2,-6,7,1,-1,1,0,0,-10,20,-3,-5,8,-2,0,-1,-1,1,-1,-1,2,-1
KR_6616851514,420,1,8,49,-4,-1,5,4,1,0,1,-2,3,1,-2,3,1,0,0,0,0,0,4,0,-5,5,-3,0,0,1,1,0,-1,3,-1
KR_6712591482,420,-2,-29,2,-6,0,3,3,-4,4,0,-2,3,1,-1,3,2,1,0,1,0,-7,-3,0,-6,6,-5,0,-1,-1,-1,-1,-1,4,-1
KR_6749432585,440,1,-11,-20,-6,0,4,4,2,1,3,1,3,4,0,1,1,-9,9,0,-1,-13,246,-1,-3,4,21,0,0,-1,1,-1,1,4,-1
KR_6767942528,420,-5,-45,-23,-4,-5,5,0,-1,2,1,3,0,3,1,1,2,-2,2,0,0,-1,-47,-2,-4,6,-1,0,0,-1,0,-1,-1,2,-1
KR_6399920135,420,0,-39,1,0,-1,1,0,1,4,5,0,0,0,0,0,0,0,0,0,0,0,-3,1,-10,9,1,0,0,1,1,0,1,1,-1
KR_6758900982,420,-1,-7,0,4,-2,2,0,0,2,2,0,3,3,0,5,5,6,0,6,0,7,13,4,-7,3,-3,0,1,1,1,1,1,3,-1
KR_6688644992,420,-1,6,1,-8,0,3,3,-1,2,1,-5,7,2,-2,2,0,0,1,1,-1,-10,-9,-6,-5,11,-1,0,-3,0,-1,-1,-1,0,-1
KR_6700652141,420,0,40,-13,-2,4,1,5,-2,5,3,-3,4,1,-1,4,3,0,2,2,0,-1,5,2,-5,3,0,0,-2,-1,-1,-1,1,2,-1
KR_6761764606,420,-5,-92,-31,-14,-1,1,0,-4,6,2,1,3,4,-7,8,1,-3,4,1,0,-17,5,0,-8,8,-6,0,-1,-1,-1,-1,-1,1,-1
KR_6737988198,420,1,23,3,-4,-3,3,0,-2,2,0,1,0,1,-1,1,0,1,1,2,-1,-6,-2,-1,-7,8,7,0,1,-1,1,1,-1,2,-1
KR_6766159996,420,0,-48,-20,1,0,2,2,1,4,5,0,4,4,0,3,3,0,0,0,0,-5,121,1,-3,2,-1,0,1,-1,1,1,1,4,-1
KR_6728889639,420,-1,-51,-12,-5,-1,5,4,-3,5,2,-2,4,2,2,4,6,-1,1,0,-1,0,15,-4,-4,8,3,0,0,-1,-1,-1,-1,1,-1
KR_6758223054,420,-1,-70,12,-3,-3,5,2,1,2,3,0,4,4,0,2,2,-1,1,0,0,-8,5,-3,-4,7,2,0,0,-1,-1,-1,1,4,-1
KR_6757991016,420,0,-14,-3,-3,-3,4,1,1,2,3,2,0,2,-1,5,4,-2,2,0,0,2,-11,5,-10,5,5,0,-1,-1,-1,-1,-1,4,-1
KR_6766212614,420,-2,-21,2,-4,-1,4,3,2,2,4,-2,2,0,-2,3,1,-1,3,2,-1,-4,-25,-3,-3,6,8,0,-2,-1,1,-1,-1,1,-1
KR_6742543725,420,-3,4,-19,-9,1,2,3,-7,7,0,-4,4,0,-1,7,6,2,0,2,0,-12,-31,-7,-2,9,3,0,0,0,-1,1,-1,0,-1
KR_6743853376,420,-2,-62,-20,-7,-2,2,0,0,4,4,0,2,2,-4,6,2,-1,1,0,-2,-14,-47,-4,-5,9,32,0,-1,-1,1,-1,-1,1,-1
KR_6761985371,420,-4,-37,-1,-14,-1,2,1,4,2,6,-3,5,2,-11,12,1,-3,4,1,-1,-17,-6,-2,-3,5,-1,0,-3,-1,-1,-1,-1,6,-1
KR_6763519441,420,0,-86,-19,-8,-1,3,2,-7,7,0,-1,3,2,1,2,3,0,0,0,-1,-6,-22,-5,-5,10,-2,0,0,-1,1,0,-1,3,-1
KR_6728745694,420,-4,-43,-2,-5,0,2,2,-2,4,2,-3,3,0,1,3,4,-1,1,0,0,-4,-4,-2,-4,6,9,0,0,-1,1,-1,1,2,-1
KR_6759912017,420,2,-77,24,-2,-1,2,1,1,3,4,-2,2,0,-2,2,0,2,1,3,0,-7,-11,-1,-5,6,-2,0,-1,-1,1,-1,-1,3,-1
KR_6737220018,420,1,-35,19,3,0,2,2,4,1,5,-2,3,1,0,3,3,1,0,1,0,1,12,-3,-6,9,-10,0,-1,-1,-1,-1,1,2,-1
KR_6768893470,420,-1,29,9,1,9,0,9,-3,3,0,-3,6,3,-3,6,3,1,0,1,1,-12,2,-1,-5,6,-2,0,2,1,1,1,1,4,-1
KR_6768788484,420,0,-12,2,-2,0,3,3,-2,6,4,0,3,3,0,5,5,0,2,2,-1,-9,-5,-6,-4,10,-5,0,0,-1,-1,0,-1,2,-1
KR_6764707462,420,-1,-25,0,-8,1,0,1,-6,6,0,0,3,3,-2,4,2,-1,3,2,-2,-6,-7,-1,-6,7,-3,0,-1,-1,-1,-1,-1,5,-1
KR_6762335374,420,2,6,-19,4,3,0,3,-4,5,1,3,2,5,1,1,2,1,1,2,-1,-1,-2,1,-4,3,-1,0,1,-1,-1,1,-1,6,-1
KR_6740236480,440,1,7,-36,4,1,2,3,1,0,1,2,3,5,2,3,5,-2,2,0,0,6,0,-1,-2,3,-1,0,2,0,-1,1,-1,0,-1
KR_6759182801,420,-1,-20,-23,-6,1,0,1,-5,5,0,0,2,2,-3,10,7,1,1,2,0,-1,6,-4,-3,7,0,0,0,-1,-1,0,-1,6,-1
KR_6746367926,420,-2,-86,24,-5,-3,4,1,-2,2,0,-1,2,1,1,0,1,0,0,0,0,1,37,-3,-3,6,-6,0,-1,-1,-1,-1,-1,5,-1
KR_6727671194,420,1,22,-5,6,1,0,1,3,1,4,-2,3,1,4,0,4,0,1,1,0,15,10,0,-6,6,-3,0,1,1,-1,1,1,2,-1
KR_6701966279,420,-4,-60,-17,-9,4,0,4,-7,8,1,-3,5,2,0,2,2,-3,4,1,0,-13,-7,-7,-1,8,-2,0,-2,-1,-1,-1,-1,3,-1
KR_6767945720,420,0,53,-15,-1,-1,3,2,2,0,2,-5,5,0,2,1,3,1,1,2,0,-12,-16,-4,-2,6,0,0,2,-1,1,1,1,5,-1
KR_6761589559,420,-9,-95,-40,-18,-3,4,1,-7,8,1,-1,2,1,-5,5,0,-2,2,0,0,-20,2,6,-8,2,-4,0,-3,-1,-1,-1,-1,5,-1
KR_6678014844,440,-1,-27,0,-3,3,1,4,-3,5,2,-1,1,0,-2,3,1,0,0,0,0,-11,-17,-1,-3,4,4,0,1,-1,-1,1,-1,4,-1
KR_6652955654,420,-8,-103,-3,-17,-4,4,0,-7,7,0,-3,5,2,-4,4,0,1,0,1,0,-31,20,2,-6,4,1,0,-2,-1,-1,-1,-1,6,-1
KR_6704059381,420,2,-8,4,11,1,1,2,2,0,2,2,1,3,6,2,8,0,1,1,0,10,-29,-1,-5,6,3,0,1,1,1,1,1,5,-1
KR_6766771242,420,1,29,0,0,1,0,1,0,1,1,1,1,2,-2,2,0,0,0,0,1,-2,-1,2,-7,5,-2,0,0,-1,-1,0,1,6,-1
KR_6732959953,420,-4,15,12,-8,-4,4,0,-4,4,0,5,2,7,-5,5,0,0,1,1,0,-16,-100,-2,-1,3,1,0,1,-1,1,1,-1,2,-1
KR_6758795110,420,2,29,4,5,1,1,2,3,0,3,0,1,1,0,3,3,1,1,2,1,7,9,6,-11,5,-6,0,1,-1,1,1,1,1,-1
KR_6740195607,420,-7,-129,-21,-17,3,0,3,-6,6,0,-4,7,3,-5,6,1,-5,5,0,0,-14,108,-2,-4,6,-5,0,-2,-1,-1,-1,-1,3,-1
KR_6749935193,420,-1,-34,-6,-3,-3,3,0,2,1,3,-6,11,5,3,1,4,1,0,1,0,0,-104,-1,-6,7,1,0,-2,1,-1,-1,1,5,-1
KR_6760972466,420,1,9,12,4,1,2,3,0,2,2,1,3,4,3,1,4,-1,4,3,0,10,1,5,-7,2,2,0,1,-1,1,1,-1,2,-1
KR_6759022366,420,-9,-73,-33,-16,-1,2,1,-4,4,0,0,4,4,-7,8,1,-4,4,0,0,-15,-8,-5,-2,7,1,0,-1,-1,-1,-1,-1,5,-1
KR_6762543280,420,0,-68,11,-5,1,1,2,-2,6,4,-2,5,3,-2,2,0,0,0,0,-2,-10,0,-3,-3,6,-2,0,-1,1,-1,-1,-1,4,-1
KR_6753057690,440,-5,-45,-28,-10,-5,6,1,-1,6,5,-2,3,1,2,3,5,-4,4,0,-1,-6,8,2,-5,3,-1,0,-1,-1,0,-1,-1,6,-1
KR_6764313735,420,-1,2,12,-4,-2,2,0,-2,3,1,-3,3,0,0,3,3,3,0,3,0,-7,1,-5,-2,7,-4,0,0,-1,-1,-1,1,5,-1
KR_6746255100,420,1,-7,-27,13,3,3,6,4,3,7,0,2,2,5,2,7,1,0,1,4,27,11,4,-8,4,2,0,1,-1,-1,1,1,5,-1
KR_6764648803,420,-4,-61,-17,-9,0,0,0,1,0,1,-6,7,1,-3,5,2,-1,2,1,0,-13,8,-1,-3,4,2,0,0,-1,-1,0,-1,4,-1
KR_6754193566,420,0,-36,12,-1,1,0,1,0,3,3,-2,5,3,0,2,2,0,0,0,0,-5,216,-6,-5,11,0,0,0,-1,1,0,-1,3,-1
KR_6755929902,420,3,42,-3,0,0,2,2,1,3,4,-2,2,0,2,0,2,-1,2,1,0,0,29,-1,-2,3,0,0,-1,-1,-1,-1,-1,3,-1
KR_6616339718,420,-6,-90,0,-11,-7,8,1,-1,4,3,2,3,5,-5,7,2,0,0,0,0,-12,34,3,-11,8,2,0,-2,1,-1,-1,1,5,-1
KR_6759356467,420,-2,-24,1,-3,-5,6,1,-2,3,1,3,2,5,4,2,6,-3,3,0,0,-3,30,3,-8,5,1,0,-1,-1,1,-1,-1,4,-1
KR_6655874417,440,1,11,-2,-1,3,1,4,-2,6,4,-3,5,2,-2,3,1,3,0,3,0,-3,59,3,-9,6,-28,0,0,1,1,1,1,5,-1
KR_6768665245,420,0,61,2,-4,-2,2,0,0,1,1,0,1,1,-2,2,0,0,4,4,0,-3,-13,-1,-7,8,4,0,1,-1,-1,1,-1,5,-1
KR_6760329261,420,-2,19,0,-12,2,2,4,-3,4,1,0,1,1,-9,10,1,-2,2,0,0,-16,3,3,-9,6,-4,0,0,-1,-1,-1,1,3,-1
KR_6764544668,420,-3,-38,-4,-12,-7,9,2,-4,4,0,-1,3,2,-2,3,1,2,1,3,0,-4,-152,-1,-4,5,0,0,-1,-1,-1,-1,-1,2,-1
KR_6767727733,420,2,2,19,1,0,0,0,-1,5,4,2,1,3,1,6,7,-1,1,0,0,-4,29,4,-7,3,-1,0,0,-1,1,1,-1,4,-1
KR_6738062392,420,1,6,8,1,2,0,2,1,2,3,-2,3,1,2,0,2,-2,2,0,0,0,-3,-1,-4,5,6,0,0,1,-1,-1,1,4,-1
KR_6768819818,420,0,-28,21,-6,-2,5,3,3,3,6,-3,3,0,-4,5,1,0,0,0,0,-4,-6,-1,-6,7,2,0,-1,1,-1,-1,1,4,-1
KR_6704337822,420,1,0,13,3,2,0,2,0,1,1,1,2,3,1,0,1,-1,1,0,0,2,-19,2,-6,4,-3,0,0,-1,1,1,-1,6,-1
KR_6755470430,440,2,-63,12,15,-1,4,3,0,3,3,-2,2,0,7,1,8,11,3,14,3,16,-12,-5,-3,8,3,0,0,1,1,0,1,1,-1
KR_6763793308,420,3,48,28,10,4,1,5,1,5,6,1,2,3,5,1,6,-1,3,2,0,12,22,-2,-7,9,-1,0,-1,0,-1,-1,-1,0,-1
KR_6622687293,420,-3,-51,-4,-4,-3,3,0,-1,3,2,3,1,4,0,1,1,-3,3,0,0,4,-10,-1,-7,8,4,0,-2,-1,1,-1,1,4,-1
KR_6749472031,420,-1,50,-55,7,3,2,5,2,2,4,2,0,2,0,3,3,0,0,0,0,9,7,11,-12,1,-2,0,2,1,-1,1,-1,3,-1
KR_6748198282,420,-2,-81,8,-7,-2,2,0,1,3,4,-2,2,0,-3,4,1,-1,1,0,0,-12,-13,1,-8,7,-1,0,-1,-1,1,-1,-1,1,-1
KR_6651606859,420,-2,-47,10,-7,-5,6,1,1,5,6,-1,5,4,-1,3,2,-1,1,0,2,-8,15,-2,-9,11,-3,0,0,-1,1,-1,-1,4,-1
KR_6757160652,420,-3,-75,-4,-13,-5,5,0,-1,2,1,-3,6,3,-5,5,0,1,1,2,0,-10,-10,-4,-3,7,-1,0,-3,1,-1,-1,1,2,-1
KR_6750370286,420,-4,-43,7,-12,-2,3,1,-8,9,1,0,4,4,-3,4,1,1,0,1,-1,-13,6,0,-4,4,-5,0,-2,1,-1,-1,-1,2,-1
KR_6761192859,420,0,4,15,-2,-1,4,3,1,3,4,1,0,1,-2,4,2,-1,1,0,0,1,1,4,-7,3,-5,0,-1,1,-1,-1,-1,5,-1
KR_6762920103,420,-4,27,-19,-6,4,1,5,-5,6,1,-3,6,3,-2,5,3,0,0,0,1,-15,15,-2,-6,8,-1,0,1,-1,1,1,1,3,-1
KR_6755858643,420,-3,39,4,-7,-6,7,1,-3,4,1,3,0,3,-1,3,2,0,1,1,0,-1,-9,-4,-2,6,5,0,0,-1,1,-1,1,5,-1
KR_6732404113,420,-1,-32,-9,-4,0,2,2,-4,5,1,-1,2,1,1,3,4,0,2,2,0,-9,27,2,-7,5,2,0,-1,-1,-1,-1,1,2,-1
KR_6733524666,420,-4,-10,3,-9,-1,1,0,-1,6,5,-4,5,1,-4,4,0,1,0,1,0,-19,-7,-4,-4,8,-5,0,-1,-1,1,-1,1,2,-1
KR_6715871233,440,-3,4,-11,-2,-1,1,0,3,0,3,-5,5,0,2,3,5,-1,1,0,0,-4,-7,-9,-2,11,1,0,-1,1,-1,-1,1,4,-1
KR_6741014364,440,-4,8,0,-5,3,1,4,2,3,5,-2,3,1,-6,6,0,-2,3,1,0,-1,-27,2,-5,3,32,0,0,1,-1,-1,-1,6,-1
KR_6654880842,420,0,10,-48,-2,-1,2,1,2,3,5,1,1,2,-3,5,2,-1,1,0,0,0,-5,-2,-5,7,2,0,0,-1,1,0,1,5,-1
KR_6768504727,440,-1,-30,-10,-6,2,0,2,-3,4,1,0,3,3,-5,6,1,0,3,3,-2,-12,-2,-4,-6,10,1,0,0,1,-1,0,-1,4,-1
KR_6762170579,420,-4,-18,8,-12,-1,3,2,-3,6,3,-4,7,3,-2,5,3,-2,3,1,-2,-22,0,-7,-3,10,-3,0,-2,1,-1,-1,-1,5,-1
KR_6768692002,420,1,22,2,2,0,2,2,0,2,2,0,4,4,2,1,3,0,0,0,0,2,4,1,-5,4,4,0,-2,1,-1,-1,1,5,-1
KR_6714109326,420,-3,-21,-4,-8,-1,2,1,-4,6,2,-5,5,0,3,3,6,-1,2,1,0,-10,54,-1,-5,6,1,0,-1,-1,-1,-1,-1,5,-1
KR_6762139731,420,0,3,8,-4,-1,1,0,-2,2,0,-3,4,1,-1,1,0,3,0,3,0,-3,10,4,-9,5,5,0,0,1,-1,0,-1,1,-1
KR_6676330960,440,-2,-20,0,3,-2,6,4,2,0,2,-3,4,1,6,1,7,0,1,1,0,3,14,2,-7,5,0,0,-1,1,-1,-1,1,5,-1
KR_6765505660,440,-3,-51,-33,-9,-4,5,1,-2,3,1,3,4,7,-3,5,2,-3,3,0,0,-1,13,6,-10,4,-8,0,-1,0,1,-1,-1,0,-1
KR_6761893272,420,-1,-1,-32,-2,1,2,3,-3,4,1,-3,4,1,3,4,7,0,1,1,0,-6,-6,3,-7,4,1,0,0,1,-1,-1,-1,1,-1
KR_6764948517,420,-2,21,-24,-1,1,3,4,-2,4,2,-2,2,0,1,3,4,1,0,1,0,0,2,3,-7,4,2,0,1,-1,1,1,-1,2,-1
KR_6616925516,420,-3,-44,-36,-7,6,0,6,-11,11,0,-4,6,2,3,1,4,-1,2,1,-1,-5,102,4,-9,5,-3,0,-3,-1,-1,-1,-1,3,-1
KR_6688892980,420,-6,-86,-42,-11,-2,4,2,-4,6,2,0,1,1,-3,3,0,-2,5,3,0,-8,102,-6,-2,8,-1,0,-1,-1,1,-1,-1,3,-1
KR_6616427861,420,1,62,-1,-4,-3,4,1,1,0,1,1,1,2,-3,3,0,0,1,1,0,-5,2,1,-10,9,-1,0,2,1,1,1,1,1,-1
KR_6746179761,440,-5,-31,-8,-12,0,1,1,-4,4,0,-4,4,0,-2,2,0,-2,3,1,0,-11,-8,-6,0,6,3,0,0,-1,1,-1,-1,4,-1
KR_6761960882,420,0,-15,4,-1,-3,3,0,2,2,4,0,4,4,-1,3,2,1,2,3,0,-5,-135,0,-8,8,-3,0,0,-1,1,-1,-1,3,-1
KR_6768832396,420,-1,-29,4,-5,2,0,2,1,2,3,-3,5,2,-4,8,4,-1,1,0,-1,-9,0,0,-5,5,-3,0,0,-1,1,-1,-1,4,-1
KR_6742020421,420,-7,-62,-35,-10,-3,5,2,-6,6,0,-3,3,0,2,1,3,0,1,1,0,-6,3,3,-9,6,-1,0,-1,-1,-1,-1,-1,5,-1
KR_6760681442,420,-1,-59,21,-10,-5,6,1,0,2,2,1,0,1,-3,3,0,-3,3,0,0,-9,-3,-2,-2,4,0,0,-1,0,-1,-1,-1,0,-1
KR_6762493296,420,-6,-44,-34,-11,0,3,3,-2,3,1,-5,5,0,-5,6,1,1,3,4,0,-14,6,-1,-5,6,-9,0,-1,-1,-1,-1,1,5,-1
KR_6744908115,420,-3,-16,-10,-10,-5,5,0,2,1,3,-3,3,0,-5,9,4,1,2,3,-1,-6,14,-5,-1,6,1,0,1,-1,1,1,-1,1,-1
KR_6763517778,420,-2,-34,4,-6,0,1,1,-4,6,2,-1,3,2,-4,10,6,3,1,4,0,-19,44,-1,-4,5,-21,0,1,1,1,1,1,5,-1
KR_6734031319,420,-4,-75,-3,-6,1,2,3,-1,5,4,-5,7,2,-2,4,2,1,0,1,0,1,-1,-1,-3,4,1,0,-3,-1,-1,-1,1,4,-1
KR_6761913776,420,-1,11,-41,0,0,2,2,4,1,5,0,2,2,-1,7,6,-3,3,0,0,4,-6,-2,-3,5,3,0,0,-1,-1,-1,1,5,-1
KR_6696658028,420,0,-58,7,1,1,5,6,-2,3,1,-3,6,3,5,2,7,0,0,0,0,5,6,0,-6,6,-1,0,-1,-1,1,-1,1,4,-1
KR_6740832408,420,3,-48,16,3,-2,3,1,-2,6,4,2,0,2,2,4,6,3,1,4,0,-3,-1,-2,-6,8,0,0,1,1,-1,1,-1,6,-1
KR_6755630212,440,-1,78,-6,4,-2,5,3,0,1,1,2,3,5,1,0,1,3,0,3,0,3,5,0,-3,3,-2,0,3,0,1,1,1,0,-1
KR_6723849003,440,0,5,-8,1,-6,6,0,-3,3,0,5,0,5,4,1,5,1,0,1,1,5,4,4,-7,3,3,0,2,1,1,1,1,6,-1
KR_6761700588,420,-1,-5,3,1,-6,6,0,-1,3,2,-1,3,2,5,2,7,4,0,4,0,-3,-14,1,-6,5,-3,0,0,1,-1,1,1,5,-1
KR_6765655894,420,-1,23,-31,0,-3,3,0,-2,2,0,1,0,1,2,0,2,2,1,3,0,-2,-6,-3,-5,8,2,0,0,1,-1,0,-1,4,-1
KR_6752834701,420,-2,-125,32,2,0,2,2,3,1,4,-1,1,0,-1,3,2,1,0,1,1,5,59,-2,-4,6,-5,0,-1,0,1,-1,1,0,-1
KR_6766415295,440,-4,-28,-12,-6,-3,6,3,-3,3,0,3,2,5,-3,3,0,0,0,0,0,-6,6,0,-5,5,3,0,-2,-1,-1,-1,-1,2,-1
KR_6767233224,420,-3,-54,-4,-6,-1,2,1,0,4,4,4,1,5,-7,8,1,-2,4,2,1,-1,-8,-2,-5,7,0,0,-3,1,1,-1,1,4,-1
KR_6763425291,420,-4,-85,-29,-13,-6,8,2,-2,3,1,-2,5,3,-6,12,6,3,1,4,0,-9,-38,-1,-7,8,-1,0,-1,-1,-1,-1,-1,1,-1
KR_6759909319,420,-1,-39,-8,4,0,1,1,1,2,3,-1,2,1,3,3,6,1,1,2,0,2,-1,2,-5,3,0,0,1,1,1,1,-1,3,-1
KR_6635780874,420,-3,-7,-21,-13,1,3,4,-5,8,3,0,3,3,-3,5,2,-6,6,0,0,-24,-31,-1,-3,4,2,0,-3,-1,-1,1,-1,1,-1
KR_6653971997,420,-3,17,-20,-9,-1,1,0,-1,3,2,-4,5,1,-4,6,2,1,1,2,-3,-23,-71,2,-7,5,-5,0,-1,-1,-1,-1,-1,5,-1
KR_6768008656,420,-1,-4,4,0,-4,6,2,-1,2,1,0,1,1,-2,4,2,7,0,7,-1,-1,100,0,-7,7,2,0,1,-1,1,1,-1,3,-1
KR_6746598029,420,-3,8,-2,-7,3,1,4,-6,7,1,-3,3,0,-1,1,0,0,0,0,0,-13,3,-4,-6,10,1,0,2,1,-1,1,-1,3,-1
KR_6676693556,420,-2,-8,-29,-7,-3,4,1,-2,4,2,-2,3,1,1,1,2,-1,3,2,0,2,-38,-2,-4,6,-2,0,0,-1,-1,-1,-1,4,-1
KR_6755369082,420,-3,-94,-19,-5,-3,5,2,-2,3,1,-3,4,1,7,1,8,-4,6,2,-1,-2,12,-2,-4,6,0,0,-2,-1,-1,-1,-1,1,-1
KR_6766411511,420,-7,-79,-40,-8,-3,3,0,0,1,1,-6,6,0,3,1,4,-2,2,0,0,-1,7,5,-7,2,-5,0,-4,1,-1,-1,1,4,-1
KR_6723968815,420,0,39,-1,-3,3,1,4,-1,3,2,-1,2,1,-3,3,0,-1,1,0,0,-7,-3,-5,-5,10,1,0,1,1,-1,1,-1,3,-1
KR_6765132155,420,-2,-36,-9,-4,-3,3,0,-2,5,3,2,1,3,0,3,3,-1,1,0,1,-3,-4,2,-4,2,1,0,-2,-1,-1,-1,1,4,-1
KR_6769198682,420,2,15,-9,4,1,3,4,-1,1,0,3,1,4,0,1,1,1,0,1,0,1,233,3,-8,5,-1,0,1,1,-1,1,-1,6,-1
KR_6767812600,440,-4,-62,-39,-8,-6,7,1,2,0,2,-3,4,1,-1,4,3,0,1,1,0,0,319,-2,-4,6,-5,0,0,0,0,-1,-1,0,-1
KR_6758856764,420,1,-35,-25,4,0,3,3,-3,7,4,4,1,5,5,1,6,-2,3,1,0,11,15,-1,-6,7,3,0,0,0,1,1,1,0,-1
KR_6769044462,420,1,14,-30,-1,-1,2,1,4,1,5,0,0,0,0,2,2,-4,4,0,0,-5,173,2,-5,3,-3,0,0,1,-1,0,-1,4,-1
KR_6749061043,420,-2,-30,5,-16,-4,5,1,-7,7,0,-1,4,3,-4,5,1,0,0,0,-1,-11,-334,-4,-1,5,-4,0,-2,-1,1,-1,-1,2,-1
KR_6737121132,440,-1,-9,28,-4,2,7,9,-3,3,0,0,1,1,-2,4,2,-1,2,1,0,-5,-117,-3,-1,4,2,0,0,1,1,-1,-1,2,-1
KR_6738961099,440,0,33,-1,1,6,0,6,-4,7,3,5,0,5,-5,5,0,-1,1,0,-1,-5,10,-1,-3,4,1,0,2,-1,1,1,-1,6,-1
KR_6749707034,420,-3,5,5,-9,-1,1,0,-3,4,1,-1,6,5,-1,2,1,-3,3,0,-1,-20,12,-2,-7,9,24,0,0,-1,1,0,-1,4,-1
KR_6690961836,420,-4,-49,-9,-12,-6,6,0,-7,7,0,0,2,2,0,2,2,1,0,1,0,-26,110,-7,-3,10,3,0,0,-1,1,-1,1,6,-1
KR_6765703920,420,-3,-23,-44,-6,-2,3,1,-4,5,1,-3,5,2,-1,3,2,4,1,5,0,-8,-10,-2,-5,7,5,0,1,1,-1,1,1,1,-1
KR_6748049679,420,-1,-95,-32,3,-2,3,1,0,2,2,0,1,1,3,1,4,2,1,3,0,4,10,3,-8,5,-6,0,0,1,1,0,1,4,-1
KR_6752441337,420,-3,-36,-8,-2,1,0,1,-2,4,2,-1,4,3,0,3,3,0,2,2,0,-12,-1,-1,-5,6,-3,0,0,1,1,1,-1,4,-1
KR_6650605581,420,-2,-17,3,0,2,1,3,-6,7,1,-1,1,0,6,0,6,-1,1,0,0,-6,-32,-1,-7,8,1,0,0,1,-1,0,1,5,-1
KR_6745631680,420,0,-32,-17,7,3,0,3,4,6,10,1,4,5,-1,3,2,0,1,1,0,9,17,1,-7,6,-1,0,1,1,1,1,-1,5,-1
KR_6659134499,420,0,-45,12,-4,-2,2,0,-1,4,3,0,3,3,-3,4,1,2,1,3,0,-4,-4,-3,-4,7,1,0,1,-1,1,1,-1,4,-1
KR_6753152469,420,4,39,43,13,-1,3,2,9,0,9,3,2,5,0,3,3,2,0,2,3,18,-25,2,-3,1,4,0,1,0,-1,1,1,0,-1
KR_6753670630,420,1,33,6,5,1,2,3,2,1,3,-3,7,4,5,1,6,0,1,1,0,11,-3,-3,-5,8,0,0,1,1,1,1,1,5,-1
KR_6766803407,420,1,31,-2,-3,2,0,2,-2,2,0,1,3,4,-3,5,2,-1,1,0,0,-8,3,1,-7,6,-7,0,0,1,-1,0,-1,1,-1
KR_6706709271,420,-1,6,3,1,-2,4,2,5,1,6,1,1,2,0,1,1,-3,4,1,0,-5,0,-2,-4,6,-4,0,1,1,-1,1,-1,1,-1
KR_6668550489,420,1,-3,-55,6,4,0,4,-3,5,2,2,0,2,2,2,4,1,1,2,1,7,4,2,-6,4,-2,0,1,-1,1,1,1,3,-1
KR_6732482070,420,-1,30,5,-11,-1,3,2,0,4,4,-2,2,0,-7,7,0,-1,1,0,1,-9,-15,0,-8,8,5,0,0,-1,-1,-1,1,4,-1
KR_6764878214,440,-4,-21,-44,-3,0,2,2,-2,4,2,2,2,4,-1,3,2,-2,2,0,1,5,-32,2,-4,2,3,0,2,-1,1,1,1,1,-1
KR_6737990594,420,-1,-40,-31,-4,-2,3,1,-2,3,1,-1,1,0,0,6,6,1,0,1,0,-4,17,3,-8,5,-8,0,0,-1,1,0,1,4,-1
KR_6749516521,420,0,-13,33,-5,-4,5,1,2,2,4,1,1,2,-4,4,0,0,1,1,0,-6,-5,-7,-3,10,-2,0,0,-1,1,-1,-1,6,-1
KR_6765092480,420,-3,-52,28,-7,-1,2,1,-2,5,3,-4,4,0,-2,6,4,2,1,3,0,-14,-276,3,-7,4,-5,0,-1,-1,-1,-1,-1,1,-1
KR_6762947499,420,0,19,-28,-2,1,1,2,1,1,2,-3,4,1,-1,4,3,0,0,0,0,-1,-8,-5,-2,7,4,0,0,1,-1,0,1,1,-1
KR_6756481107,420,-6,-58,-3,-14,-2,2,0,-4,4,0,-2,2,0,-4,5,1,-2,2,0,-1,-15,-4,-3,-6,9,-3,0,0,0,-1,0,-1,0,-1
KR_6728134232,420,0,64,24,0,-1,3,2,2,1,3,-2,6,4,-3,5,2,4,0,4,0,0,2,0,-5,5,2,0,-1,-1,-1,-1,1,5,-1
KR_6628110182,440,-3,-3,10,-10,2,3,5,-2,2,0,-1,2,1,-6,6,0,-3,3,0,0,-9,285,0,-10,10,-2,0,-1,-1,0,-1,-1,2,-1
KR_6757977052,440,0,4,17,-1,-6,6,0,9,2,11,2,3,5,-3,6,3,-3,5,2,0,3,33,2,-5,3,3,0,-1,-1,-1,-1,-1,4,-1
KR_6767269417,420,-1,-16,-1,-3,-2,2,0,-2,2,0,1,2,3,0,2,2,0,0,0,0,0,-6,3,-5,2,3,0,-1,-1,-1,-1,-1,1,-1
KR_6728755496,440,-9,-130,-20,-21,-5,7,2,-6,8,2,-5,6,1,-1,2,1,-4,4,0,-1,-12,-8,-3,-1,4,-1,0,-4,-1,-1,-1,-1,4,-1
KR_6744848016,420,-2,-39,12,-7,0,0,0,-1,1,0,-4,7,3,2,3,5,-4,5,1,-2,-11,15,3,-9,6,-5,0,-1,0,-1,-1,-1,0,-1
KR_6726895117,420,-7,-92,-9,-11,-3,3,0,-7,9,2,5,2,7,-5,8,3,-1,3,2,0,-5,2,0,-5,5,-6,0,-2,-1,-1,-1,1,3,-1
KR_6634907280,420,-4,-39,-4,-9,-4,4,0,-9,14,5,6,1,7,-1,1,0,-1,1,0,-1,-4,-47,5,-9,4,-7,0,-1,-1,1,-1,-1,3,-1
KR_6740004134,420,-2,-71,-9,-11,1,0,1,-3,5,2,-5,6,1,-3,6,3,-1,2,1,0,-9,1,-5,-4,9,1,0,-1,1,-1,-1,-1,5,-1
KR_6737699922,420,-3,-42,-11,-5,0,1,1,-3,5,2,-3,3,0,0,2,2,1,1,2,0,-7,-2,1,-5,4,3,0,0,1,1,0,-1,6,-1
KR_6762551619,420,-2,-11,-2,-3,-1,1,0,1,6,7,0,1,1,-2,6,4,-1,1,0,0,-6,-1,1,-6,5,-4,0,-1,1,-1,-1,1,5,-1
KR_6762019310,420,-3,-17,-32,-7,1,0,1,-1,4,3,-4,5,1,-4,5,1,1,1,2,0,-7,-12,-7,-1,8,5,0,-1,-1,0,-1,-1,3,-1
KR_6765934236,440,-1,-1,12,-4,-1,3,2,2,1,3,0,5,5,-2,2,0,-3,5,2,0,-3,6,0,-5,5,0,0,0,0,1,0,1,0,-1
KR_6753295960,420,-2,54,-16,-6,-1,3,2,1,5,6,0,2,2,-4,5,1,-2,2,0,-1,-6,-61,0,-6,6,-2,0,0,-1,1,1,-1,1,-1
KR_6741821884,420,-3,-42,-44,6,3,2,5,0,1,1,1,1,2,2,2,4,0,1,1,-1,7,7,-5,-3,8,-7,0,-1,-1,-1,-1,-1,3,-1
KR_6768154384,420,0,30,-11,5,0,2,2,3,4,7,-1,2,1,3,4,7,0,0,0,1,10,6,8,-11,3,0,0,2,1,-1,1,1,4,-1
KR_6768078629,420,-1,-40,1,-6,-2,3,1,2,1,3,-4,7,3,0,1,1,-2,2,0,0,-3,10,-1,-6,7,2,0,0,1,1,1,-1,2,-1
KR_6761742841,420,-1,0,-5,0,-1,3,2,1,1,2,3,3,6,-4,6,2,1,0,1,0,3,5,0,-5,5,2,0,0,1,-1,0,-1,5,-1
KR_6767162380,420,-3,-15,-21,-3,5,0,5,-1,3,2,-7,8,1,2,3,5,-2,3,1,0,-2,-201,1,-6,5,3,0,0,1,0,0,1,3,-1
KR_6765545210,420,-6,-115,-26,-11,-9,9,0,-3,4,1,-1,3,2,1,1,2,1,1,2,0,3,-1,-3,-2,5,0,0,-3,-1,-1,-1,-1,3,-1
KR_6688861511,420,-4,-10,-12,-7,1,0,1,-8,8,0,-3,3,0,0,3,3,3,0,3,0,-8,-314,-5,-3,8,0,0,-3,-1,-1,-1,1,4,-1
KR_6760695397,420,0,-27,31,-8,-2,2,0,-2,2,0,1,2,3,-4,4,0,-1,2,1,-2,-20,-14,-9,-6,15,-5,0,0,-1,1,-1,-1,3,-1
KR_6768731531,420,-2,-24,16,-6,-2,4,2,-2,6,4,0,2,2,-2,2,0,0,1,1,0,-10,-29,0,-5,5,3,0,1,-1,1,1,-1,3,-1
KR_6768779347,420,-2,-46,-19,-5,-2,2,0,2,3,5,-1,2,1,-5,5,0,1,2,3,0,1,0,1,-5,4,-4,0,0,-1,1,0,-1,5,-1
KR_6768776701,440,-1,28,-12,3,3,2,5,1,2,3,-3,3,0,2,0,2,0,2,2,-1,2,-1,-6,-1,7,-2,0,1,-1,1,1,-1,2,-1
KR_6761494389,420,0,6,-20,1,1,2,3,-1,3,2,-1,3,2,3,0,3,-1,2,1,0,0,19,-4,-3,7,1,0,-1,1,-1,-1,-1,3,-1
KR_6764064953,420,-4,-22,-24,-5,4,1,5,-5,6,1,-1,2,1,1,0,1,-4,5,1,0,-11,-49,0,-7,7,11,0,-1,-1,1,-1,1,3,-1
KR_6750099430,420,-4,-26,-55,-4,0,2,2,-4,4,0,-2,6,4,2,0,2,0,0,0,0,0,3,0,-5,5,0,0,-2,-1,-1,-1,1,3,-1
KR_6731966266,420,3,29,8,-4,-2,3,1,-5,5,0,-3,6,3,6,1,7,0,0,0,-1,-5,29,2,-8,6,-1,0,1,-1,1,1,-1,5,-1
KR_6680634681,420,0,12,9,1,0,2,2,2,1,3,-3,3,0,2,4,6,0,0,0,1,-5,161,7,-12,5,-4,0,0,-1,1,0,1,5,-1
KR_6754817735,440,-2,-78,-29,-14,5,0,5,-2,4,2,-10,11,1,-6,10,4,-1,4,3,-2,-10,-5,-6,-1,7,4,0,-2,0,-1,-1,-1,0,-1
KR_6765277230,420,-2,-88,7,-7,-2,5,3,1,0,1,-2,3,1,-4,5,1,0,2,2,0,-3,-62,-8,0,8,21,0,-4,-1,-1,-1,-1,2,-1
KR_6663310872,420,-3,-14,-6,-6,-4,5,1,1,3,4,-3,4,1,0,3,3,0,1,1,0,-2,37,-2,-7,9,-3,0,-1,1,-1,-1,-1,6,-1
KR_6768198890,420,-4,-190,-7,-9,-2,4,2,-6,9,3,0,0,0,-1,3,2,0,1,1,-1,-7,-18,1,-7,6,0,0,-2,-1,-1,-1,-1,4,-1
KR_6679663509,420,1,69,8,3,0,1,1,0,1,1,2,0,2,2,0,2,-1,2,1,0,4,-185,1,-9,8,-6,0,0,-1,-1,0,1,1,-1
KR_6745560608,420,-2,-10,-24,-5,0,0,0,-2,4,2,1,4,5,-4,4,0,0,0,0,0,-8,-3,1,-4,3,3,0,-1,1,1,-1,-1,4,-1
KR_6619582899,420,0,-58,0,-5,-3,3,0,4,0,4,0,3,3,-7,10,3,1,1,2,0,-5,12,1,-4,3,0,0,-2,-1,-1,-1,-1,4,-1
KR_6767001982,440,-3,-72,4,-4,-2,2,0,-6,7,1,-2,2,0,1,3,4,5,0,5,0,-4,-22,-1,-4,5,3,0,-2,1,1,-1,-1,6,-1
KR_6762404607,420,-1,-47,-24,-7,-5,7,2,2,1,3,-3,5,2,0,6,6,-1,3,2,0,-8,-4,-1,-4,5,-2,0,-2,1,-1,-1,1,5,-1
KR_6758524229,420,-2,55,-5,-9,-1,2,1,-3,5,2,-3,4,1,-1,2,1,-1,2,1,0,-10,-2,3,-10,7,-3,0,2,-1,-1,1,-1,1,-1
KR_6754305252,420,1,-36,7,-3,-1,2,1,-2,4,2,3,1,4,-2,5,3,-1,1,0,-1,-1,-5,1,-6,5,0,0,-1,-1,-1,-1,-1,3,-1
KR_6689982131,420,-1,45,-13,-3,-4,6,2,-2,3,1,-1,3,2,3,0,3,1,0,1,0,3,-6,6,-7,1,-1,0,-1,-1,-1,-1,-1,5,-1
KR_6639933840,420,2,18,4,-9,0,3,3,-7,7,0,-1,2,1,-1,1,0,0,3,3,0,-11,5,0,-4,4,-8,0,-2,-1,-1,-1,1,3,-1
KR_6756276292,420,0,9,3,5,-3,3,0,-3,6,3,10,0,10,2,2,4,-1,3,2,-1,6,-7,0,-6,6,4,0,2,1,1,1,-1,1,-1
KR_6750168880,420,-2,4,-10,2,4,1,5,-4,4,0,-3,4,1,1,1,2,4,0,4,0,1,5,0,-6,6,3,0,1,1,1,1,1,2,-1
KR_6675523791,440,-5,-59,7,-11,-1,3,2,-3,5,2,-1,1,0,-1,3,2,-5,6,1,0,-10,-27,1,-5,4,3,0,-1,-1,-1,-1,-1,1,-1
KR_6746650682,420,2,13,-17,3,1,1,2,-1,4,3,-2,3,1,3,3,6,2,1,3,0,10,-29,4,-8,4,-1,0,-2,0,-1,-1,1,0,-1
KR_6764963357,420,-3,-71,-8,-8,0,2,2,0,0,0,-2,2,0,-5,6,1,-1,2,1,0,-8,-27,3,-5,2,20,0,-2,0,-1,-1,-1,0,-1
KR_6689321464,420,-6,-18,-46,-17,-4,4,0,-6,6,0,-5,7,2,-1,2,1,-1,1,0,0,-14,41,-2,-5,7,-20,0,-1,-1,-1,-1,1,1,-1
KR_6744486539,420,-1,-26,-11,-8,-1,3,2,-3,6,3,1,2,3,-1,4,3,-4,5,1,-1,-13,6,1,-7,6,-6,0,0,-1,0,-1,-1,1,-1
KR_6736347470,420,2,29,6,8,4,1,5,-2,4,2,2,1,3,1,2,3,3,1,4,0,1,12,3,-7,4,-1,0,1,-1,1,1,1,4,-1
KR_6721114268,420,-4,1,-20,-10,-6,7,1,2,2,4,-2,3,1,-2,4,2,-2,2,0,0,-10,-7,1,-7,6,-3,0,-1,-1,-1,-1,1,4,-1
KR_6763937086,420,0,50,-15,-1,-2,3,1,3,1,4,0,0,0,-2,6,4,0,0,0,-2,1,-16,-1,-2,3,3,0,0,1,0,-1,-1,4,-1
KR_6734566483,420,-5,-10,12,-11,-2,2,0,-4,5,1,-5,7,2,-1,2,1,1,1,2,1,-11,34,-5,-4,9,-3,0,-1,-1,-1,-1,-1,6,-1
KR_6695114573,420,5,38,5,5,4,1,5,0,2,2,1,4,5,2,0,2,-2,2,0,0,5,-7,4,-8,4,-2,0,0,-1,1,1,-1,6,-1
KR_6699174640,420,-1,-17,8,-5,5,1,6,-3,4,1,-5,6,1,-3,4,1,1,2,3,0,-18,-5,2,-8,6,-5,0,1,-1,1,1,-1,2,-1
KR_6687326085,420,-2,-14,12,-2,-2,2,0,-1,2,1,2,4,6,-1,3,2,0,0,0,-1,-5,11,4,-8,4,-2,0,0,-1,1,-1,-1,6,-1
KR_6745550376,420,-1,-92,-12,5,1,0,1,2,1,3,3,1,4,-1,5,4,0,0,0,-1,9,12,2,-7,5,-5,0,0,1,0,-1,-1,2,-1
KR_6757352925,420,-3,-49,-24,-14,-1,6,5,-2,2,0,-5,8,3,-6,8,2,0,0,0,0,-5,-175,2,-7,5,-6,0,0,-1,1,0,1,5,-1
KR_6766745159,420,-3,-54,-10,-5,1,2,3,-4,5,1,-2,2,0,2,1,3,-2,2,0,0,-7,-14,-4,-4,8,2,0,0,-1,-1,1,-1,1,-1
KR_6767175870,420,-2,-40,7,0,-1,1,0,2,1,3,-2,7,5,-1,5,4,2,0,2,0,-6,6,2,-8,6,-7,0,0,-1,1,0,1,2,-1
KR_6718876087,420,0,-40,-21,3,1,2,3,-3,8,5,1,3,4,4,2,6,0,3,3,-1,3,-9,-1,-5,6,-2,0,-2,1,-1,-1,-1,3,-1
KR_6755263516,420,-4,-33,-48,0,-2,2,0,2,2,4,2,0,2,-2,2,0,0,1,1,0,-2,113,-2,-5,7,1,0,0,-1,-1,0,1,4,-1
KR_6739776013,420,-2,18,-8,-5,2,1,3,-2,6,4,-2,3,1,-1,2,1,-2,2,0,0,-11,-5,4,-12,8,2,0,-1,-1,1,-1,-1,1,-1
KR_6767255720,420,-4,-51,-20,-9,2,2,4,-5,5,0,-3,4,1,-5,7,2,2,0,2,-2,-14,1,3,-9,6,-5,0,-1,-1,-1,-1,-1,4,-1
KR_6761860785,420,1,2,4,1,2,1,3,-3,4,1,0,1,1,0,1,1,2,1,3,1,1,38,0,-4,4,-18,0,1,-1,-1,-1,1,2,-1
KR_6760784137,420,-2,-8,12,-10,-1,4,3,0,1,1,-7,8,1,1,1,2,-3,4,1,0,-9,18,3,-6,3,-2,0,0,-1,-1,-1,-1,1,-1
KR_6754002975,420,0,36,-19,-6,-2,2,0,-2,3,1,0,0,0,-2,2,0,0,1,1,0,-8,-2,-1,-6,7,2,0,-1,1,-1,-1,-1,2,-1
KR_6744493530,420,-5,-57,-23,-10,-1,2,1,3,4,7,-3,5,2,-3,3,0,-6,6,0,0,-11,2,-2,-2,4,-5,0,-2,-1,1,-1,-1,1,-1
KR_6715327882,420,1,41,11,2,0,4,4,3,1,4,1,2,3,0,1,1,-2,2,0,1,1,-10,-5,-1,6,-3,0,0,1,-1,-1,1,4,-1
KR_6766446372,440,-5,-133,-16,-6,0,2,2,4,3,7,-1,3,2,-10,13,3,1,2,3,2,-1,-15,0,-4,4,-2,0,-2,-1,1,-1,1,5,-1
KR_6757504151,420,-5,-65,20,-13,-8,8,0,0,1,1,0,3,3,-5,6,1,0,0,0,-1,-10,8,-3,-2,5,-2,0,-3,-1,-1,-1,-1,5,-1
KR_6758381871,420,-3,30,-20,-2,0,1,1,-4,4,0,2,0,2,-2,4,2,2,0,2,0,0,1,-3,-5,8,2,0,0,-1,1,0,-1,6,-1
KR_6615060437,420,1,-30,12,0,-2,3,1,1,1,2,2,1,3,0,0,0,-1,1,0,0,3,-26,2,-8,6,-1,0,0,1,1,0,-1,2,-1
KR_6766229060,420,0,-2,-19,3,0,0,0,4,4,8,-3,3,0,3,0,3,-1,1,0,0,11,8,4,-7,3,-3,0,0,-1,-1,0,1,6,-1
KR_6679454815,420,0,50,-40,1,-1,1,0,0,4,4,2,1,3,-1,1,0,1,2,3,0,7,11,5,-9,4,-5,0,0,-1,1,1,-1,5,-1
KR_6732724729,440,0,-23,6,4,3,0,3,-5,5,0,1,3,4,2,3,5,3,1,4,1,1,-2,-2,-4,6,0,0,1,0,1,1,1,0,-1
KR_6761438949,420,-5,-36,-12,-5,-1,2,1,2,4,6,-4,6,2,-3,3,0,1,1,2,0,-9,-12,2,-8,6,-5,0,0,1,-1,-1,1,5,-1
KR_6749589045,420,0,46,11,3,7,0,7,1,4,5,4,3,7,-6,7,1,-3,5,2,1,6,-50,8,-11,3,-2,0,0,-1,0,1,-1,6,-1
KR_6693644200,420,-4,-83,0,-6,-5,5,0,0,1,1,2,0,2,0,2,2,-3,3,0,0,-3,184,-3,-5,8,-3,0,-2,-1,-1,-1,-1,5,-1
KR_6734086030,420,3,102,9,4,0,4,4,-3,6,3,3,6,9,2,0,2,2,0,2,-1,-1,-3,-2,-5,7,1,0,3,-1,1,1,1,3,-1
KR_6734084350,420,-2,-74,-24,2,1,0,1,-1,3,2,1,0,1,3,1,4,-2,3,1,1,4,-46,3,-6,3,12,0,-1,-1,1,-1,1,5,-1
KR_6722765381,420,-7,-17,-29,-10,-2,3,1,-4,4,0,-2,3,1,-3,4,1,1,0,1,0,-2,3,9,-10,1,-3,0,-3,-1,-1,-1,-1,5,-1
KR_6478855991,420,1,-23,3,-4,-2,3,1,0,5,5,2,1,3,-4,4,0,0,0,0,0,-1,-3,0,-6,6,-3,0,1,-1,1,1,-1,5,-1
KR_6769217584,420,1,49,16,-2,-2,4,2,-2,4,2,2,1,3,0,2,2,0,0,0,0,-4,4,0,-4,4,-1,0,1,1,-1,-1,-1,6,-1
KR_6735518993,420,-4,-60,-51,-8,-2,3,1,-2,6,4,-2,4,2,-2,2,0,0,0,0,0,-14,1,4,-7,3,1,0,-1,-1,-1,-1,1,2,-1
KR_6701600626,420,0,-32,0,1,2,1,3,-5,6,1,-1,1,0,7,0,7,-2,2,0,0,-3,4,6,-9,3,-5,0,0,-1,1,-1,1,4,-1
KR_6602516525,420,0,-54,-8,-11,-3,6,3,2,1,3,-5,7,2,-3,3,0,-2,2,0,0,-9,-1,-1,-7,8,1,0,-1,-1,1,-1,-1,2,-1
KR_6756178730,420,1,-61,26,-8,4,0,4,-2,3,1,-5,7,2,-6,9,3,1,1,2,-2,-13,-2,1,-6,5,-6,0,-1,-1,1,-1,1,3,-1
KR_6761111189,420,-4,21,-3,-6,0,1,1,-1,2,1,-4,5,1,-1,2,1,0,0,0,0,-7,13,0,-5,5,-2,0,0,0,-1,0,-1,0,-1
KR_6760874568,420,1,-7,-19,1,0,0,0,-2,4,2,3,1,4,-1,2,1,1,1,2,0,3,5,0,-7,7,-3,0,0,-1,1,0,1,4,-1
KR_6653415260,420,-2,-51,24,-9,-4,5,1,-3,6,3,2,2,4,-3,4,1,-1,2,1,0,-2,101,-3,-4,7,-4,0,-1,-1,-1,-1,-1,4,-1
KR_6761838879,420,-3,15,-56,-2,2,2,4,1,3,4,-2,3,1,-2,3,1,-1,1,0,0,-10,-7,-1,-5,6,-1,0,0,-1,1,0,1,2,-1
KR_6743054285,420,-2,-36,-4,-4,1,2,3,3,2,5,-1,2,1,-5,5,0,-2,3,1,0,0,2,-1,-6,7,-5,0,0,-1,-1,0,-1,6,-1
KR_6730267099,420,-1,-9,-32,-4,-5,6,1,0,5,5,-5,6,1,6,0,6,0,1,1,0,5,-12,-2,-2,4,2,0,-1,1,-1,-1,-1,1,-1
KR_6768335361,420,-4,-64,8,-19,-7,7,0,-4,4,0,-5,6,1,-3,3,0,0,2,2,0,-20,-3,-1,-5,6,3,0,-1,-1,-1,-1,-1,6,-1
KR_6764264683,420,-2,-25,2,-2,0,1,1,0,2,2,-4,5,1,0,3,3,2,0,2,0,0,-8,-2,-3,5,-3,0,-1,-1,-1,-1,-1,6,-1
KR_6768320683,420,-1,4,-24,0,-3,3,0,1,5,6,1,0,1,1,2,3,0,0,0,0,6,5,2,-6,4,-3,0,-2,-1,-1,-1,-1,4,-1
KR_6743968163,420,2,92,23,3,-2,5,3,4,2,6,-3,4,1,1,1,2,3,0,3,0,0,2,0,-8,8,-2,0,0,1,-1,0,1,4,-1
KR_6765236514,420,-1,24,-19,-1,2,0,2,-3,3,0,0,4,4,0,0,0,0,2,2,0,-9,-7,1,-8,7,4,0,-2,-1,-1,-1,1,1,-1
KR_6745543766,420,-2,3,8,-7,-5,6,1,0,4,4,2,2,4,-6,6,0,2,1,3,0,-5,51,-3,-4,7,-21,0,1,0,-1,1,1,0,-1
KR_6761099974,420,2,62,-25,3,-3,3,0,-3,5,2,0,2,2,6,0,6,3,0,3,0,8,-37,6,-11,5,-1,0,0,-1,-1,0,-1,4,-1
KR_6767060755,420,-5,-47,9,-13,-1,3,2,-8,11,3,-6,7,1,2,1,3,0,0,0,0,-7,17,4,-5,1,-1,0,0,1,-1,1,1,5,-1
KR_6763946040,420,0,23,-12,-2,0,1,1,4,3,7,-1,2,1,-4,5,1,-1,2,1,0,4,9,5,-10,5,-1,0,1,-1,-1,1,1,4,-1
KR_6744125109,420,-6,-67,-56,-6,-8,8,0,2,1,3,1,1,2,-1,2,1,0,0,0,1,8,3,-2,-6,8,-6,0,-1,-1,-1,-1,1,4,-1
KR_6655741493,420,-1,-51,11,-4,-2,4,2,-2,5,3,3,0,3,-2,2,0,-1,1,0,0,-6,-12,-3,-5,8,2,0,0,-1,1,1,1,6,-1
KR_6748216211,420,1,29,-5,1,1,1,2,2,1,3,-4,6,2,2,0,2,0,0,0,0,3,25,0,-6,6,5,0,1,-1,1,1,1,5,-1
KR_6759328364,420,0,-8,0,1,-1,1,0,1,4,5,-2,3,1,3,4,7,0,1,1,0,0,60,-2,-5,7,-31,0,-1,1,-1,-1,-1,1,-1
KR_6693241452,420,-1,-2,0,-2,4,0,4,0,5,5,-3,3,0,-1,3,2,-2,3,1,0,-6,-39,1,-7,6,13,0,1,-1,1,1,-1,5,-1
KR_6764920638,420,-3,-79,-4,-9,-3,4,1,1,2,3,-2,5,3,-4,6,2,-1,2,1,-1,6,-19,-1,-7,8,-4,0,-1,-1,1,-1,-1,5,-1
KR_6628077234,440,-7,-89,-14,-19,-10,11,1,2,3,5,-1,5,4,1,1,2,-11,11,0,0,-29,52,-8,-1,9,1,0,-2,-1,0,-1,-1,6,-1
KR_6692708948,420,-2,-85,-7,0,2,0,2,-1,4,3,1,4,5,-4,7,3,2,0,2,1,-1,-12,-6,-5,11,1,0,-1,1,0,-1,1,4,-1
KR_6751148952,420,-3,-35,-16,-6,-4,4,0,-4,7,3,-3,3,0,4,2,6,1,2,3,1,-3,203,3,-6,3,-20,0,0,-1,-1,-1,1,5,-1
KR_6676183414,420,-4,-22,-17,-7,-4,4,0,-5,5,0,0,0,0,1,0,1,1,1,2,0,-6,-36,3,-8,5,-2,0,-1,-1,-1,-1,-1,1,-1
KR_6698173529,420,-3,-82,-38,-4,-3,4,1,-5,6,1,-1,1,0,4,2,6,1,0,1,-1,-6,-144,3,-8,5,-2,0,-3,1,-1,-1,-1,2,-1
KR_6764976123,420,3,4,31,0,0,3,3,0,1,1,-2,3,1,2,0,2,0,1,1,0,1,-6,-10,-2,12,1,0,-1,-1,-1,-1,1,6,-1
KR_6754545725,420,-1,-33,15,-3,0,1,1,6,2,8,-6,6,0,-2,8,6,-1,1,0,0,-4,1,1,-11,10,3,0,0,-1,-1,-1,-1,5,-1
KR_6767041139,440,-5,-117,-13,-14,0,4,4,1,0,1,-12,13,1,-3,5,2,0,1,1,-1,-6,-4,4,-7,3,1,0,-2,-1,1,-1,-1,4,-1
KR_6692532938,420,0,-5,-13,-5,-1,1,0,-1,2,1,-6,7,1,3,2,5,0,1,1,0,-11,8,2,-7,5,1,0,1,-1,-1,1,1,5,-1
KR_6693386730,420,-3,-44,-16,-7,1,0,1,-2,2,0,1,1,2,-5,6,1,-2,3,1,0,-12,6,4,-7,3,-5,0,-1,-1,1,-1,1,4,-1
KR_6766471873,420,-2,-18,-20,-6,-2,4,2,-3,5,2,-1,2,1,-1,3,2,1,1,2,0,-8,-1,-1,-6,7,-3,0,0,-1,1,0,-1,2,-1
KR_6719980181,420,-1,-24,-41,-5,2,1,3,1,4,5,-4,4,0,-2,5,3,-2,2,0,-2,-8,-4,-3,-5,8,-1,0,0,-1,-1,-1,-1,1,-1
KR_6760000407,420,-4,-55,-25,-11,0,2,2,0,1,1,-4,8,4,-3,6,3,-4,4,0,0,-3,4,-1,-6,7,-8,0,-1,1,-1,-1,1,1,-1
KR_6697221319,420,-5,6,-50,-18,-3,4,1,-3,6,3,-5,8,3,-5,5,0,-2,2,0,0,-12,53,0,-5,5,-18,0,-2,-1,-1,-1,-1,2,-1
KR_6764055668,420,-4,-77,-2,-2,1,1,2,-4,6,2,0,2,2,2,1,3,-1,1,0,0,-4,8,2,-6,4,-4,0,-2,1,-1,-1,-1,3,-1
KR_6766061590,420,0,-50,3,8,7,3,10,0,2,2,-2,5,3,2,0,2,1,0,1,-1,18,2,4,-8,4,-1,0,0,-1,1,0,-1,5,-1
KR_6749808254,440,-2,-11,12,-3,-2,2,0,1,4,5,2,0,2,-5,7,2,1,3,4,0,-1,33,0,-3,3,1,0,-1,-1,-1,-1,-1,2,-1
KR_6768192735,420,-5,-48,-19,-11,-1,4,3,1,1,2,-2,4,2,-4,6,2,-5,5,0,0,-10,17,5,-7,2,-1,0,-1,-1,1,-1,-1,5,-1
KR_6756224085,420,-1,69,-26,-9,1,0,1,3,1,4,-8,8,0,-3,8,5,-2,2,0,-2,-12,-6,-1,-5,6,0,0,0,-1,1,0,-1,4,-1
KR_6692924240,420,-5,-136,7,-7,-3,5,2,0,3,3,1,1,2,0,2,2,-5,7,2,0,-3,2,-1,-4,5,-4,0,-1,-1,1,-1,1,1,-1
KR_6593335820,420,-4,-108,-4,-6,1,3,4,-4,5,1,0,2,2,1,0,1,-4,4,0,0,2,-5,-8,-3,11,-2,0,-1,-1,-1,-1,-1,5,-1
KR_6766397433,420,-2,45,4,-5,0,1,1,0,3,3,-1,5,4,-4,5,1,0,0,0,0,-12,-3,-3,-3,6,4,0,1,1,1,1,1,6,-1
KR_6697741321,420,0,-23,19,-4,2,1,3,-1,4,3,-2,2,0,-5,11,6,2,0,2,0,-9,-46,-5,-5,10,31,0,1,-1,1,1,-1,5,-1
KR_6768363630,420,-5,-32,19,-9,-3,3,0,-1,1,0,1,1,2,-4,4,0,-2,2,0,0,-15,0,3,-6,3,-3,0,0,-1,1,-1,-1,3,-1
KR_6597418988,420,-2,23,13,-6,0,1,1,-1,5,4,0,3,3,-5,5,0,0,0,0,0,-11,-43,-6,-6,12,-3,0,-1,-1,1,-1,-1,6,-1
KR_6765861115,420,-2,4,27,-5,-3,3,0,1,3,4,-3,3,0,1,1,2,-1,1,0,0,-2,-45,-1,-3,4,22,0,0,1,1,-1,1,6,-1
KR_6768984701,420,0,-4,-23,0,1,1,2,0,3,3,1,1,2,-4,5,1,2,1,3,0,-9,-3,4,-4,0,1,0,0,1,-1,1,-1,2,-1
KR_6694639494,420,-6,-97,-21,-11,-4,5,1,-4,5,1,0,4,4,-4,5,1,1,0,1,-1,-6,-9,-2,-4,6,-2,0,-2,-1,-1,-1,-1,3,-1
KR_6737931892,440,-7,-75,-13,-14,-3,5,2,0,2,2,-8,9,1,-1,4,3,-2,3,1,-1,0,-30,-1,-3,4,-7,0,-4,-1,-1,-1,-1,1,-1
