matchId,queueId,Diff_LV,Diff_CS,Diff_jglCS,Diff-K,Diff-K-top,K-WIN-top,K-LOSE-top,Diff-K-jug,K-WIN-jug,K-LOSE-jug,Diff-K-mid,K-WIN-mid,K-LOSE-mid,Diff-K-ad,K-WIN-ad,K-LOSE-ad,Diff-K-sup,K-WIN-sup,K-LOSE-sup,invadeKill,Diff-A,Diff_WARDplaced,Diff-ControlWARDplaced,LOSE_controlWARDPlaced,WIN_controlWARDPlaced,Diff_WARDkill,Diff_Inhibitor,Diff_TOWERkill,Diff_FirstDRAGON,Diff_FirstHERALD,Diff_Firsttower,Diff_FirstBLOOD,dragonType,result
KR_6762820767,440,2,13,15,4,-1,3,2,3,0,3,0,1,1,2,1,3,0,1,1,0,1,13,1,-7,6,0,0,-1,-1,1,-1,1,6,-1
KR_6476650038,420,1,15,-4,1,1,1,2,-3,4,1,2,0,2,0,0,0,1,0,1,0,-1,-3,2,-6,4,2,0,0,-1,-1,0,-1,5,-1
KR_6768372799,420,-1,-53,11,-1,-4,7,3,1,2,3,3,3,6,1,3,4,-2,2,0,0,-12,2,3,-11,8,1,0,-1,1,-1,-1,1,6,-1
KR_6762310870,420,-4,-4,-7,-15,-1,3,2,-1,4,3,-4,5,1,-9,10,1,0,1,1,0,-18,13,2,-4,2,-3,0,-1,-1,-1,-1,-1,1,-1
KR_6765937806,420,0,36,16,8,1,2,3,2,1,3,0,5,5,1,1,2,4,0,4,0,8,-11,4,-6,2,-7,0,0,1,-1,0,1,1,-1
KR_6747974964,420,1,34,28,0,3,1,4,1,1,2,-1,1,0,-4,4,0,1,1,2,0,-8,3,-1,-3,4,3,0,1,1,1,1,1,4,-1
KR_6723818934,420,-4,-83,-7,-7,-2,2,0,-1,4,3,1,4,5,-3,5,2,-2,2,0,-1,-14,-4,0,-5,5,1,0,0,-1,-1,-1,-1,6,-1
KR_6693223886,420,-7,-88,-8,-13,-1,4,3,5,2,7,-11,12,1,-1,1,0,-5,6,1,-1,-8,11,-4,-3,7,5,0,-2,-1,1,-1,-1,4,-1
KR_6769843074,420,1,-8,44,8,-4,4,0,5,1,6,3,3,6,4,1,5,0,3,3,1,21,0,0,-2,2,5,0,0,1,-1,1,1,6,-1
KR_6757219003,420,-4,-33,-4,-4,-2,2,0,-3,3,0,0,2,2,1,1,2,0,0,0,0,-5,-90,3,-7,4,-2,0,-2,-1,1,-1,1,6,-1
KR_6716569460,420,-4,-107,5,-5,-1,2,1,-3,4,1,2,0,2,-3,3,0,0,0,0,0,-6,12,3,-5,2,-5,0,-2,0,1,-1,-1,0,-1
KR_6695894581,420,-2,-22,30,-3,-3,3,0,-1,2,1,0,3,3,1,3,4,0,1,1,0,-6,10,2,-8,6,-8,0,1,1,-1,1,-1,3,-1
KR_6753616667,440,-2,5,22,-12,-1,3,2,-1,3,2,0,1,1,-6,6,0,-4,5,1,0,-12,-12,0,-4,4,-4,0,0,-1,-1,0,-1,5,-1
KR_6683812328,420,1,4,-4,5,2,2,4,4,3,7,0,1,1,-1,2,1,0,2,2,0,-1,-19,8,-9,1,16,0,1,-1,1,1,1,4,-1
KR_6746316707,420,-3,10,-12,-11,-1,3,2,-6,7,1,0,4,4,0,2,2,-4,6,2,0,-8,4,4,-7,3,0,0,-2,-1,-1,-1,1,1,-1
KR_6750331187,420,-1,54,23,2,-4,5,1,2,2,4,5,0,5,0,3,3,-1,2,1,0,-2,1,1,-5,4,1,0,1,1,1,1,1,3,-1
KR_6766490270,440,-4,-101,-14,-14,0,0,0,0,0,0,-5,5,0,-6,6,0,-3,3,0,0,-5,-2,2,-4,2,-1,-1,-4,0,-1,-1,-1,0,-1
KR_6747724632,420,2,-31,12,4,1,1,2,0,1,1,2,2,4,2,1,3,-1,1,0,0,7,3,2,-5,3,-3,0,0,1,1,-1,-1,2,-1
KR_6757997195,420,-4,-27,8,-6,0,0,0,-1,4,3,-1,2,1,-3,4,1,-1,1,0,0,-8,3,4,-7,3,-1,0,0,-1,1,0,-1,5,-1
KR_6650606063,420,-4,-12,-35,0,1,3,4,5,0,5,-8,9,1,0,1,1,2,0,2,1,0,7,5,-8,3,0,0,0,1,-1,-1,1,5,-1
KR_6715923017,420,-1,4,-19,0,0,1,1,2,0,2,1,2,3,-3,5,2,0,2,2,1,2,30,1,-8,7,3,0,0,1,-1,0,1,1,-1
KR_6525691454,420,-1,31,-7,-5,1,0,1,-2,5,3,-2,3,1,-1,3,2,-1,2,1,0,-13,-50,6,-10,4,-3,0,1,-1,0,1,-1,6,-1
KR_6701894298,420,-1,-12,12,-2,2,1,3,3,1,4,-1,6,5,-4,5,1,-2,2,0,0,-2,-6,-3,-4,7,-1,0,1,1,0,1,-1,1,-1
KR_6768649280,420,-1,-17,20,-9,-2,3,1,0,1,1,-6,7,1,0,5,5,-1,1,0,-2,-10,-2,2,-10,8,-1,0,-1,-1,1,-1,-1,6,-1
KR_6771074496,440,-2,52,-48,3,1,0,1,-1,7,6,2,1,3,4,2,6,-3,3,0,1,5,-11,5,-7,2,-3,0,0,0,0,0,1,0,-1
KR_6735280582,420,-1,41,6,-9,-2,2,0,0,2,2,0,4,4,-7,9,2,0,1,1,0,-3,0,-5,-2,7,-2,0,1,-1,1,1,-1,4,-1
KR_6751067047,420,1,-25,-10,1,-5,6,1,3,2,5,0,2,2,1,2,3,2,0,2,0,1,-107,-3,-3,6,-1,0,-2,1,-1,-1,1,4,-1
KR_6770345892,420,-4,-76,-1,-4,-3,3,0,1,1,2,-1,2,1,-1,2,1,0,0,0,0,1,-6,0,-6,6,-2,0,-1,-1,-1,-1,1,1,-1
KR_6740225824,420,-3,-24,-2,-12,-6,6,0,0,2,2,-3,4,1,-1,3,2,-2,3,1,0,-8,3,1,-4,3,-4,0,-1,-1,-1,-1,1,4,-1
KR_6517357382,420,-2,-30,-15,-2,1,3,4,-1,4,3,-1,4,3,-1,5,4,0,0,0,0,0,-9,-1,-3,4,2,0,0,-1,-1,1,-1,6,-1
KR_6686036281,420,-1,-51,7,-4,-3,4,1,2,3,5,1,3,4,-4,6,2,0,1,1,0,2,-46,-1,-2,3,8,0,0,1,0,1,-1,6,-1
KR_6740898089,440,3,16,8,6,-4,4,0,-3,4,1,3,0,3,4,0,4,6,0,6,1,12,-10,-3,-2,5,5,0,-1,0,0,-1,1,0,-1
KR_6708593568,420,-2,-34,44,-14,-2,2,0,-4,4,0,1,3,4,-10,10,0,1,0,1,-1,-19,-12,-4,-4,8,-4,0,-2,-1,1,-1,-1,5,-1
KR_6673682805,420,-7,-49,-28,-18,-4,4,0,-5,7,2,-6,7,1,-1,3,2,-2,2,0,0,-18,-2,-5,-1,6,-1,0,-3,-1,-1,-1,-1,4,-1
KR_6608777268,420,0,-70,-8,1,-2,6,4,0,1,1,0,2,2,3,0,3,0,1,1,-1,6,-322,1,-5,4,3,0,1,1,0,1,-1,2,-1
KR_6544389165,420,-4,-32,-11,-5,-5,5,0,0,3,3,-1,1,0,0,2,2,1,0,1,0,-6,12,0,-7,7,-3,0,0,-1,1,0,-1,5,-1
KR_6675322623,440,-5,-62,-6,-12,-2,4,2,-1,3,2,-7,7,0,-1,2,1,-1,2,1,-3,-12,-1,-3,-2,5,1,0,-2,-1,-1,-1,-1,5,-1
KR_6762074202,420,-4,-18,-5,-8,-1,3,2,1,4,5,-4,4,0,-5,6,1,1,0,1,0,-8,-13,2,-7,5,2,0,0,-1,1,0,1,4,-1
KR_6640148396,420,-1,-6,16,-1,2,1,3,4,2,6,0,1,1,-6,8,2,-1,1,0,0,-1,-8,0,-6,6,2,0,-1,-1,-1,-1,-1,3,-1
KR_6691289150,420,-3,-61,-29,-10,-1,1,0,-6,8,2,-1,1,0,-4,6,2,2,1,3,0,-11,10,-8,-3,11,0,0,-1,-1,1,-1,-1,4,-1
KR_6662366788,420,-4,-76,-22,-3,-1,2,1,-3,6,3,1,4,5,2,0,2,-2,3,1,0,0,-5,-6,-2,8,-4,0,-1,-1,1,-1,-1,2,-1
KR_6735866994,420,-5,-72,-42,-12,-4,5,1,0,3,3,0,4,4,-1,2,1,-7,8,1,-3,-6,278,0,-3,3,-1,0,-2,1,-1,-1,-1,4,-1
KR_6647389230,420,1,36,-24,3,-1,5,4,1,4,5,-3,3,0,5,3,8,1,0,1,2,13,3,-2,-6,8,3,0,-1,0,-1,1,1,0,-1
KR_6729198682,420,1,20,-8,3,-3,3,0,0,5,5,4,2,6,2,0,2,0,0,0,0,2,-34,4,-7,3,14,0,-1,-1,1,-1,1,6,-1
KR_6768938767,420,2,-17,-20,2,0,1,1,2,2,4,1,5,6,-2,3,1,1,0,1,0,7,9,4,-6,2,1,0,-1,1,-1,-1,1,2,-1
KR_6747406047,420,-2,-36,4,-9,-1,3,2,-1,5,4,-4,4,0,0,3,3,-3,4,1,0,-9,-156,4,-8,4,0,0,-2,-1,1,-1,-1,6,-1
KR_6763730114,420,4,20,-16,7,3,1,4,3,3,6,6,0,6,-3,6,3,-2,2,0,0,6,11,3,-7,4,-5,0,3,-1,-1,1,1,5,-1
KR_6725673198,420,-3,-106,-11,-12,-1,3,2,-8,8,0,0,3,3,-1,3,2,-2,3,1,-1,-10,-1,-3,-2,5,-5,0,-2,-1,-1,-1,-1,6,-1
KR_6768449969,420,-2,19,-24,-11,-1,1,0,-7,8,1,0,2,2,-3,5,2,0,1,1,-2,-16,-3,-2,-1,3,3,0,-1,-1,-1,-1,-1,5,-1
KR_6761899407,420,0,27,-30,3,3,0,3,6,1,7,0,1,1,-3,4,1,-3,3,0,0,2,-8,0,-6,6,1,0,1,-1,1,1,-1,3,-1
KR_6768452163,440,-4,-41,-24,-9,-7,7,0,-1,4,3,0,2,2,2,1,3,-3,3,0,0,-7,-3,0,-5,5,2,0,-1,1,-1,-1,-1,3,-1
KR_6683280174,420,-7,-50,-6,-21,-5,5,0,-3,4,1,-2,3,1,-9,10,1,-2,2,0,0,-19,-10,-1,-7,8,-4,0,-2,-1,-1,-1,-1,2,-1
KR_6676736836,420,-3,-68,-24,-6,1,0,1,-2,5,3,1,2,3,-7,11,4,1,1,2,-1,-8,-9,0,-4,4,-3,0,0,-1,0,-1,-1,6,-1
KR_6684612323,420,0,-12,-24,-1,4,0,4,-1,3,2,-3,8,5,-3,7,4,2,0,2,0,-3,-32,4,-6,2,16,0,0,1,-1,1,-1,4,-1
KR_6484213803,420,1,18,20,-1,-1,3,2,-3,6,3,-2,3,1,3,1,4,2,0,2,0,-1,-7,2,-7,5,5,0,1,1,-1,1,1,1,-1
KR_6663824224,420,0,-4,-7,3,-1,2,1,2,2,4,-3,5,2,5,0,5,0,1,1,1,4,-1,3,-7,4,1,0,-1,1,-1,-1,1,5,-1
KR_6603825833,420,-4,11,-33,-4,-1,2,1,0,3,3,-1,2,1,-2,4,2,0,0,0,0,-2,-3,-3,-3,6,-1,0,-1,1,-1,-1,1,2,-1
KR_6759285700,420,-1,-13,8,-8,1,3,4,-3,4,1,-5,6,1,1,3,4,-2,2,0,0,-3,0,-1,-1,2,2,0,-2,-1,-1,-1,-1,5,-1
KR_6766729469,420,-1,-98,17,-11,-3,4,1,-6,8,2,-1,3,2,0,1,1,-1,2,1,0,-11,-12,-1,-5,6,1,0,-2,1,1,-1,-1,3,-1
KR_6728408256,420,-1,-37,-27,-5,2,0,2,-1,3,2,-1,2,1,-3,4,1,-2,2,0,1,-5,1,1,-9,8,0,0,-1,-1,1,1,1,4,-1
KR_6766071027,420,2,16,25,0,-1,2,1,1,2,3,-1,4,3,-2,4,2,3,2,5,0,-4,19,-4,-2,6,2,0,-1,0,-1,-1,1,0,-1
KR_6765292873,420,2,27,-3,9,4,2,6,-1,2,1,3,0,3,1,6,7,2,1,3,0,7,14,0,-5,5,0,0,0,-1,1,1,-1,2,-1
KR_6738757017,420,-1,-7,4,-2,-2,2,0,4,2,6,-4,4,0,4,0,4,-4,5,1,0,2,138,0,-6,6,3,0,-1,-1,1,1,1,4,-1
KR_6759833705,420,-3,8,-23,-9,1,1,2,-1,4,3,-3,5,2,-2,4,2,-4,5,1,0,-13,-10,1,-6,5,-1,0,-2,1,-1,-1,-1,4,-1
KR_6770731229,420,-5,-3,4,-8,3,1,4,-3,4,1,-2,2,0,-5,7,2,-1,2,1,0,-10,1,0,-4,4,-1,0,-1,1,1,-1,1,4,-1
KR_6768092344,420,1,19,32,6,-1,4,3,0,1,1,1,1,2,5,1,6,1,1,2,0,1,-4,-3,-3,6,0,0,1,1,-1,1,-1,4,-1
KR_6672676517,420,-7,-84,-20,-15,-2,4,2,-2,2,0,-7,7,0,-3,4,1,-1,1,0,0,-11,-6,-2,-3,5,-1,0,-3,-1,-1,-1,-1,5,-1
KR_6767123748,420,1,11,10,-3,3,2,5,-5,5,0,-1,3,2,0,3,3,0,2,2,0,-8,10,2,-5,3,-4,0,0,0,-1,1,1,0,-1
KR_6605453189,420,-2,1,-23,-3,0,0,0,1,1,2,-5,6,1,2,1,3,-1,1,0,0,7,16,1,-4,3,-2,0,0,-1,-1,0,-1,3,-1
KR_6768605819,420,-2,-38,-7,1,-1,3,2,2,1,3,-1,5,4,3,1,4,-2,3,1,0,4,7,4,-6,2,-1,0,1,1,0,1,1,6,-1
KR_6758154443,420,-2,-2,-32,-6,-1,2,1,1,0,1,-4,7,3,1,4,5,-3,4,1,0,-5,-3,-1,-7,8,-3,0,0,-1,-1,-1,-1,4,-1
KR_6760933609,420,1,69,0,-2,-5,6,1,-3,4,1,0,0,0,2,1,3,4,0,4,0,0,-50,3,-7,4,26,0,0,1,-1,-1,1,1,-1
KR_6768042554,420,-1,-38,4,2,2,1,3,1,1,2,0,2,2,-1,5,4,0,2,2,-1,-2,-1,-2,-3,5,0,0,0,-1,0,-1,-1,1,-1
KR_6713928510,420,0,-16,-7,-3,2,1,3,-3,7,4,-2,3,1,2,4,6,-2,2,0,0,-1,-9,0,-8,8,4,0,-1,-1,1,-1,-1,5,-1
KR_6681169684,420,-5,3,-12,-12,0,0,0,-5,7,2,-4,4,0,-4,4,0,1,0,1,-1,-17,5,3,-5,2,0,0,0,-1,1,0,-1,5,-1
KR_6752892037,420,-3,-59,-9,-7,-1,3,2,-1,1,0,-5,6,1,1,2,3,-1,2,1,0,-7,6,-1,-3,4,-4,0,-1,-1,-1,-1,-1,4,-1
KR_6749107881,420,-5,-102,-24,-9,-4,4,0,-2,2,0,0,3,3,-1,1,0,-2,2,0,0,-12,0,0,-5,5,-8,0,-3,-1,1,-1,1,1,-1
KR_6603607214,420,0,-10,-11,3,-4,4,0,0,3,3,6,1,7,0,1,1,1,0,1,0,10,22,2,-4,2,8,0,0,1,-1,0,-1,3,-1
KR_6634949233,420,-2,-56,-24,-2,-2,3,1,-1,2,1,4,4,8,-2,4,2,-1,1,0,0,2,7,0,-4,4,0,0,-1,-1,0,-1,1,4,-1
KR_6723556648,420,-3,1,-16,-5,0,1,1,-4,6,2,0,2,2,2,2,4,-3,4,1,-1,-7,43,1,-6,5,-29,0,0,-1,-1,0,-1,5,-1
KR_6771165254,420,-3,-16,11,-5,-1,3,2,-7,8,1,3,0,3,-1,5,4,1,1,2,-1,-5,-40,4,-8,4,24,0,-1,1,-1,-1,-1,5,-1
KR_6728384587,420,-4,-51,-12,-6,-3,3,0,-3,4,1,5,1,6,0,2,2,-5,5,0,0,-5,40,0,-5,5,-17,0,0,-1,-1,0,-1,4,-1
KR_6739577172,420,0,-36,4,3,-1,3,2,-1,4,3,2,2,4,2,2,4,1,2,3,1,11,0,1,-6,5,3,0,0,1,-1,0,1,4,-1
KR_6678672053,420,-1,-58,30,-6,-5,6,1,1,2,3,1,1,2,-3,3,0,0,0,0,-1,0,-6,-2,-4,6,2,0,0,-1,0,0,-1,4,-1
KR_6761763502,420,0,-13,1,-5,-3,4,1,-2,2,0,4,0,4,-3,6,3,-1,2,1,0,-4,42,-3,-5,8,-9,0,-1,-1,1,-1,-1,5,-1
KR_6747923230,440,-1,-8,-9,1,-1,1,0,2,3,5,1,4,5,-3,6,3,2,1,3,1,15,39,-1,-5,6,6,0,-1,0,-1,-1,-1,0,-1
KR_6765687446,420,1,27,12,0,4,0,4,-3,5,2,-2,2,0,1,0,1,0,2,2,0,-1,-10,-1,-4,5,2,0,0,-1,-1,0,-1,5,-1
KR_6663858859,420,0,36,-26,-9,0,3,3,-6,8,2,-3,3,0,-1,2,1,1,0,1,0,-12,-6,-2,-3,5,4,0,0,1,-1,0,1,6,-1
KR_6749453176,420,0,-31,27,-1,-4,6,2,0,3,3,2,2,4,1,1,2,0,0,0,0,4,-3,0,-7,7,-2,0,0,0,1,0,-1,0,-1
KR_6732072665,420,-4,-81,12,-6,-1,1,0,-3,3,0,-1,2,1,0,4,4,-1,2,1,0,-5,1,0,-4,4,-6,0,0,-1,-1,0,-1,5,-1
KR_6765316453,420,-2,-27,-16,-4,-1,2,1,2,2,4,-4,6,2,1,0,1,-2,2,0,0,4,-38,-5,-3,8,-6,0,0,-1,-1,1,1,6,-1
KR_6738803498,420,-2,-30,-4,-4,-2,2,0,2,0,2,0,0,0,-2,8,6,-2,3,1,0,-5,1,0,-5,5,-4,0,0,-1,-1,-1,-1,1,-1
KR_6726157221,420,-1,20,-5,3,6,0,6,-4,6,2,1,2,3,-1,2,1,1,5,6,0,-5,-46,2,-7,5,16,0,2,-1,1,1,1,5,-1
KR_6733438464,420,0,-15,-7,-3,-1,1,0,-1,3,2,-1,2,1,1,0,1,-1,1,0,0,-5,-4,-2,-4,6,6,0,0,0,1,0,-1,0,-1
KR_6745251390,420,1,-43,14,0,2,1,3,2,5,7,2,0,2,-1,1,0,-5,5,0,-1,0,18,5,-7,2,-5,0,1,-1,1,1,-1,5,-1
KR_6767841309,420,-3,-37,-28,-8,4,0,4,-6,8,2,-6,6,0,1,3,4,-1,2,1,-1,-14,-3,-3,-3,6,-2,0,-1,-1,1,-1,-1,4,-1
KR_6605726890,420,0,-19,13,0,-3,4,1,4,0,4,0,2,2,-1,2,1,0,1,1,0,-1,9,6,-9,3,0,0,-2,1,1,-1,1,2,-1
KR_6770409063,420,-3,-22,-25,-4,-5,6,1,-9,12,3,4,1,5,4,1,5,2,1,3,0,1,-29,-5,-3,8,2,0,-1,1,-1,-1,-1,1,-1
KR_6768715876,420,3,-19,-12,8,-2,2,0,0,3,3,2,4,6,1,2,3,7,0,7,0,10,4,2,-7,5,-3,0,-1,-1,-1,-1,-1,3,-1
KR_6765567686,420,1,12,8,1,1,1,2,1,4,5,-1,3,2,1,2,3,-1,1,0,0,-4,-10,-3,-3,6,2,0,1,1,1,1,-1,2,-1
KR_6741350649,440,2,30,24,0,4,0,4,2,2,4,-7,8,1,1,3,4,0,1,1,0,-6,6,-1,-3,4,2,0,-1,0,1,-1,1,0,-1
KR_6683510772,420,-3,-67,-14,-1,0,1,1,-3,3,0,0,3,3,4,1,5,-2,3,1,0,5,-1,-2,-5,7,-1,0,0,1,-1,0,1,3,-1
KR_6771115044,420,-6,-53,-12,-13,0,2,2,-5,5,0,-11,11,0,2,1,3,1,0,1,0,-13,-9,-3,-4,7,0,0,0,-1,-1,-1,-1,1,-1
KR_6738602734,420,-1,-60,-42,-4,0,2,2,1,1,2,-1,3,2,-2,4,2,-2,4,2,0,-9,231,4,-4,0,-5,0,0,-1,1,-1,-1,5,-1
KR_6764381755,420,-4,-61,-4,-7,3,0,3,0,3,3,-4,4,0,-9,9,0,3,1,4,-2,-9,2,-1,-8,9,-5,0,0,-1,1,-1,-1,5,-1
KR_6627013933,420,-7,-90,-32,-18,-1,2,1,-6,7,1,-5,6,1,-5,6,1,-1,2,1,-2,-20,73,0,-2,2,1,0,-1,1,-1,-1,-1,3,-1
KR_6624053997,420,-1,3,21,-3,1,1,2,-5,5,0,4,0,4,1,1,2,-4,4,0,0,-3,28,4,-6,2,2,0,0,-1,-1,0,-1,3,-1
KR_6730403564,420,-1,-44,16,-2,-3,4,1,-1,5,4,3,2,5,-3,6,3,2,0,2,1,1,3,2,-5,3,-1,0,0,1,-1,-1,1,6,-1
KR_6624097632,440,4,45,-12,1,-4,4,0,-2,3,1,3,2,5,1,1,2,3,2,5,0,6,-34,-7,-7,14,5,0,0,1,-1,-1,-1,1,-1
KR_6745100780,420,-2,-4,-9,-5,-2,3,1,4,2,6,-4,4,0,-1,3,2,-2,2,0,0,-3,-8,-8,-2,10,2,0,1,-1,1,1,1,6,-1
KR_6682891472,420,-7,-78,-27,-13,1,1,2,-5,6,1,-5,7,2,-3,3,0,-1,1,0,0,-13,-11,-5,-2,7,-3,0,-1,-1,-1,-1,-1,3,-1
KR_6727886602,420,-5,-81,-16,-14,-5,5,0,-1,3,2,-2,4,2,-5,5,0,-1,2,1,0,-15,-3,-2,-2,4,1,0,0,-1,-1,0,-1,6,-1
KR_6734257894,420,3,8,-32,5,6,0,6,-5,7,2,3,4,7,3,2,5,-2,3,1,0,-3,-2,0,-3,3,-1,0,1,-1,-1,1,1,4,-1
KR_6762684648,440,-1,-13,-1,-1,-2,4,2,-2,2,0,-1,5,4,1,1,2,3,0,3,0,-6,-3,1,-9,8,2,0,-1,1,-1,-1,-1,5,-1
KR_6739334025,420,-1,-22,-12,-3,2,1,3,0,3,3,-3,6,3,-2,3,1,0,1,1,0,-6,1,0,-5,5,-4,0,1,-1,1,1,-1,6,-1
KR_6755770934,440,-1,12,12,-10,-4,5,1,-1,4,3,-3,5,2,1,2,3,-3,3,0,0,-2,7,0,-3,3,-5,0,0,-1,0,0,-1,5,-1
KR_6677322940,420,-2,5,9,-5,1,3,4,1,2,3,-2,3,1,-6,7,1,1,0,1,0,-9,-13,-4,-3,7,0,0,0,-1,1,1,-1,2,-1
KR_6716097086,420,2,-25,-23,-2,2,2,4,-2,3,1,-1,3,2,0,2,2,-1,1,0,-2,-6,-1,0,-7,7,-1,0,1,-1,1,1,-1,2,-1
KR_6629922034,420,-2,-26,0,-8,-3,3,0,-4,5,1,1,2,3,2,1,3,-4,5,1,0,-5,24,-2,-3,5,4,0,1,-1,-1,1,-1,1,-1
KR_6743070973,420,4,48,14,4,-1,2,1,-1,2,1,4,1,5,0,3,3,2,0,2,1,7,124,6,-7,1,1,0,2,1,1,1,1,2,-1
KR_6614681921,420,-5,-37,-21,-9,-3,4,1,0,2,2,-5,6,1,0,3,3,-1,2,1,-1,-6,102,-1,-5,6,-1,0,-2,-1,-1,-1,-1,6,-1
KR_6565376573,420,-2,1,14,-1,2,0,2,2,2,4,-5,5,0,-1,3,2,1,2,3,1,-1,181,6,-10,4,3,0,0,1,1,1,1,6,-1
KR_6761916639,420,-4,-39,25,-7,1,0,1,-4,8,4,-3,3,0,1,1,2,-2,2,0,0,-7,-112,0,-4,4,6,0,0,-1,1,-1,-1,5,-1
KR_6771017549,420,4,31,-6,9,2,1,3,5,1,6,1,3,4,2,4,6,-1,2,1,2,13,-2,5,-5,0,2,0,0,1,1,1,1,3,-1
KR_6572664445,440,-2,11,-24,-10,-2,2,0,-4,6,2,-1,1,0,-3,4,1,0,1,1,0,-13,2,-1,-8,9,2,0,1,-1,1,1,-1,2,-1
KR_6758353259,420,0,1,25,2,6,0,6,-2,3,1,-6,7,1,2,5,7,2,2,4,0,-3,-50,2,-4,2,-1,0,1,1,1,1,-1,3,-1
KR_6753758482,420,2,-40,1,1,3,1,4,3,0,3,2,1,3,-3,3,0,-4,4,0,0,-2,-449,5,-8,3,-2,0,0,-1,-1,0,-1,1,-1
KR_6489081215,420,-2,-84,-8,-6,-3,3,0,-3,5,2,-1,2,1,1,0,1,0,1,1,0,-7,-7,2,-6,4,0,0,-1,-1,-1,-1,-1,5,-1
KR_6758515810,440,0,-27,-17,-4,-4,5,1,1,2,3,-4,5,1,4,0,4,-1,1,0,1,5,0,1,-4,3,-1,0,-1,1,-1,-1,1,2,-1
KR_6771184644,440,-6,-90,-63,-2,-3,4,1,1,0,1,0,3,3,2,1,3,-2,2,0,0,5,3,1,-5,4,-5,0,-1,-1,1,-1,-1,4,-1
KR_6761815323,440,-1,30,-20,1,2,0,2,-3,3,0,0,1,1,-1,3,2,3,1,4,0,1,9,4,-7,3,-3,0,0,1,1,0,-1,3,-1
KR_6534055608,420,-1,-72,3,-7,-1,3,2,-4,7,3,2,3,5,-3,5,2,-1,2,1,-1,-9,11,-2,-4,6,3,0,-1,-1,1,-1,-1,6,-1
KR_6695502252,420,-1,0,16,1,-2,3,1,-4,6,2,0,1,1,5,0,5,2,0,2,0,0,-10,-3,-4,7,3,0,0,1,-1,0,1,2,-1
KR_6762130560,420,-1,-42,4,-6,1,0,1,-4,4,0,-2,5,3,-4,5,1,3,0,3,-1,-3,9,2,-6,4,-2,0,2,1,-1,-1,-1,4,-1
KR_6759560125,420,-2,6,-22,-5,-1,1,0,0,4,4,1,1,2,-2,4,2,-3,4,1,-1,-9,-12,-1,-4,5,-3,0,1,1,1,1,-1,5,-1
KR_6736376085,420,-1,-8,15,-3,-4,5,1,-3,5,2,1,2,3,2,2,4,1,0,1,0,-5,-20,0,-3,3,1,0,-2,-1,-1,-1,1,5,-1
KR_6696509496,420,1,13,0,0,-3,6,3,1,3,4,1,1,2,-1,5,4,2,1,3,0,3,5,6,-9,3,-4,0,-1,-1,-1,-1,-1,6,-1
KR_6752442432,420,-2,-50,10,-6,-2,3,1,0,3,3,3,2,5,-7,8,1,0,2,2,0,-11,-8,-8,-5,13,-2,0,-1,1,-1,-1,-1,4,-1
KR_6741187713,440,0,-12,-17,9,5,0,5,3,5,8,-2,4,2,3,1,4,0,0,0,-1,1,3,3,-7,4,3,0,3,-1,1,1,-1,6,-1
KR_6768703615,420,-2,-84,-30,-6,3,1,4,0,1,1,-5,5,0,-2,4,2,-2,2,0,0,-8,-26,-4,-5,9,23,0,-2,-1,1,1,1,5,-1
KR_6759234395,420,-2,-55,-19,-4,1,2,3,1,4,5,-3,3,0,-2,5,3,-1,1,0,-2,-4,268,0,-4,4,1,0,0,1,1,0,-1,4,-1
KR_6650569717,420,-2,-77,-10,-8,-2,2,0,-3,6,3,5,0,5,-8,9,1,0,0,0,0,-11,1,0,-7,7,-5,0,-1,-1,-1,-1,-1,5,-1
KR_6768374553,420,-2,-20,0,-9,-2,2,0,-2,3,1,-3,3,0,-1,1,0,-1,1,0,0,-7,0,3,-9,6,-1,0,1,1,-1,1,-1,1,-1
KR_6663870313,420,4,22,23,4,-3,4,1,-2,5,3,4,0,4,3,1,4,2,0,2,0,6,11,-1,-4,5,-2,0,-1,1,-1,1,-1,4,-1
KR_6430645694,420,-1,-30,-4,1,-1,3,2,-1,3,2,2,2,4,1,3,4,0,0,0,0,5,-216,0,-2,2,-3,0,0,-1,1,0,1,1,-1
KR_6667754314,420,-3,-106,-4,-9,2,0,2,-2,2,0,-3,5,2,-6,9,3,0,3,3,0,-9,99,-2,-2,4,5,0,-2,-1,-1,-1,-1,1,-1
KR_6758207160,420,-1,-39,4,-5,-1,2,1,-3,3,0,-1,1,0,-3,5,2,3,0,3,0,-5,17,-3,-3,6,2,0,0,-1,-1,0,-1,6,-1
KR_6760473387,420,-2,-32,-15,-7,1,0,1,-2,2,0,-2,5,3,-3,6,3,-1,2,1,-1,-9,-29,-6,-4,10,0,0,-1,1,1,-1,-1,3,-1
KR_6640664414,420,-2,-1,36,1,-2,2,0,3,2,5,1,2,3,-1,1,0,0,0,0,0,-3,-1,2,-5,3,-3,0,-1,-1,1,1,1,3,-1
KR_6731837743,420,-1,-35,-3,-4,2,0,2,-2,6,4,-1,4,3,-2,4,2,-1,1,0,-1,-8,9,3,-7,4,1,0,0,1,1,0,-1,4,-1
KR_6627583930,420,-4,-47,-16,-6,-3,3,0,0,3,3,1,1,2,1,3,4,-5,5,0,0,-2,4,7,-11,4,-4,0,-1,-1,-1,-1,1,6,-1
KR_6762291781,420,1,28,-16,12,0,2,2,4,3,7,1,1,2,7,1,8,0,0,0,3,17,-3,1,-6,5,-1,0,2,1,1,1,1,6,-1
KR_6683886146,420,-3,-97,0,-8,-2,2,0,0,4,4,-3,4,1,-2,2,0,-1,2,1,0,0,47,-1,-6,7,-5,0,-1,-1,-1,-1,-1,5,-1
KR_6693587656,420,-3,-111,18,-2,-1,2,1,-4,8,4,1,3,4,0,1,1,2,1,3,0,-3,-7,-4,-3,7,1,0,-1,-1,0,-1,-1,1,-1
KR_6686738156,420,0,-29,15,-3,0,0,0,-5,7,2,1,1,2,-2,3,1,3,0,3,-1,-14,-6,-5,-2,7,5,0,0,-1,0,0,-1,2,-1
KR_6703699772,420,0,5,12,-4,1,0,1,-4,4,0,1,3,4,-2,2,0,0,0,0,1,-9,18,-5,-4,9,-2,0,0,-1,-1,-1,1,6,-1
KR_6666715361,420,1,3,-28,7,1,1,2,2,2,4,-1,1,0,4,0,4,1,0,1,0,12,-9,-4,-5,9,7,0,2,1,1,1,1,3,-1
KR_6537265845,420,-5,-66,-27,-12,-4,6,2,-6,7,1,-1,3,2,0,1,1,-1,1,0,0,-14,-16,2,-5,3,-5,0,-2,-1,-1,-1,-1,4,-1
KR_6700856227,420,-3,-22,-15,-12,-1,2,1,-5,6,1,0,1,1,-7,7,0,1,1,2,-1,-17,-3,-4,-2,6,-2,0,-2,-1,1,-1,-1,3,-1
KR_6535039376,420,-1,13,-8,-10,0,2,2,-1,3,2,0,2,2,-9,9,0,0,2,2,0,-19,-21,-1,-4,5,0,0,0,-1,1,1,-1,6,-1
KR_6770276022,420,2,32,-24,-1,3,2,5,5,4,9,-3,5,2,-4,7,3,-2,3,1,0,-5,11,2,-9,7,-3,0,1,-1,1,1,1,6,-1
KR_6763282176,420,-1,-68,-16,3,-5,5,0,0,1,1,-1,3,2,4,1,5,5,1,6,0,6,276,-3,-4,7,-2,0,0,0,-1,-1,1,0,-1
KR_6719920245,420,2,-19,0,-7,-3,4,1,0,2,2,0,4,4,-3,3,0,-1,1,0,0,-12,-2,-1,-5,6,0,0,-2,0,-1,-1,-1,0,-1
KR_6768638232,420,-3,-40,-8,-3,-2,4,2,4,2,6,-5,6,1,1,1,2,-1,4,3,0,2,4,-1,-4,5,-2,0,-1,1,-1,-1,-1,5,-1
KR_6768908358,420,0,-5,-24,0,4,1,5,0,1,1,-4,5,1,-2,2,0,2,0,2,0,-4,35,4,-4,0,1,0,-1,1,-1,-1,1,3,-1
KR_6536094943,440,-1,-32,2,0,-2,4,2,1,1,2,-3,3,0,3,3,6,1,1,2,0,3,9,-2,-3,5,-2,0,0,0,-1,0,1,0,-1
KR_6767355439,420,1,-19,-8,-1,-3,3,0,0,5,5,1,1,2,0,2,2,1,0,1,0,4,-2,1,-6,5,-2,0,1,-1,1,1,-1,5,-1
KR_6771102034,420,0,-20,16,0,3,1,4,1,3,4,-3,6,3,-1,3,2,0,1,1,0,-6,2,0,-6,6,-3,0,1,-1,1,1,1,4,-1
KR_6744238176,420,-4,-6,-18,-10,0,1,1,-6,7,1,-3,3,0,0,4,4,-1,2,1,0,-13,6,5,-8,3,-5,0,-1,-1,-1,-1,-1,3,-1
KR_6770781705,420,-4,-81,-5,-7,4,2,6,-2,4,2,-5,6,1,-4,13,9,0,0,0,-1,-13,0,1,-6,5,1,0,-1,1,-1,-1,-1,4,-1
KR_6734923847,420,-1,-49,-31,1,0,1,1,0,3,3,2,2,4,0,2,2,-1,2,1,0,8,-2,2,-7,5,3,0,0,-1,-1,-1,-1,4,-1
KR_6607193814,420,-2,-68,-35,-8,-5,6,1,-2,5,3,0,4,4,-1,2,1,0,2,2,0,-12,-114,-5,-1,6,-1,0,-3,-1,-1,-1,1,2,-1
KR_6770438447,420,-4,-98,-12,-5,-2,2,0,0,1,1,-3,4,1,0,1,1,0,0,0,0,0,-3,-4,-1,5,-1,0,-2,-1,-1,-1,-1,2,-1
KR_6738092603,420,-3,-5,-16,-8,0,4,4,-2,8,6,-2,4,2,-2,3,1,-2,4,2,0,-9,9,1,-5,4,-4,0,0,1,1,1,-1,6,-1
KR_6525385700,420,-1,-51,28,2,4,1,5,-5,5,0,2,1,3,2,3,5,-1,2,1,0,-5,-4,4,-7,3,-2,0,-1,1,1,-1,-1,4,-1
KR_6749450954,420,-2,-20,-24,-5,-2,5,3,-2,4,2,2,3,5,-1,4,3,-2,2,0,-1,-8,-5,0,-2,2,-5,0,-2,-1,-1,-1,-1,4,-1
KR_6756934121,420,0,7,20,-7,6,2,8,1,2,3,-5,5,0,-8,9,1,-1,1,0,0,-14,36,-4,-3,7,3,0,0,-1,1,1,-1,5,-1
KR_6713227555,420,0,-8,4,6,3,0,3,4,1,5,3,2,5,0,2,2,-4,4,0,0,0,-10,0,-6,6,0,0,1,-1,1,-1,-1,3,-1
KR_6738558324,420,-6,-110,-31,-7,1,1,2,-3,4,1,-3,4,1,-3,3,0,1,0,1,0,2,-7,-1,-4,5,1,0,-1,-1,-1,-1,-1,1,-1
KR_6755531728,420,-1,-23,43,-1,0,0,0,-2,2,0,-1,4,3,1,2,3,1,1,2,0,-7,11,-2,-2,4,21,0,0,0,1,0,1,0,-1
KR_6768408282,420,-2,-25,-14,-6,-3,4,1,0,1,1,-1,3,2,-1,3,2,-1,1,0,0,-4,6,3,-6,3,-1,0,-1,-1,-1,-1,-1,4,-1
KR_6718665690,420,0,-5,21,-6,0,3,3,0,4,4,-3,3,0,-1,4,3,-2,4,2,0,-10,20,-1,-7,8,1,0,1,-1,-1,-1,1,6,-1
KR_6727236495,440,7,54,24,3,4,0,4,2,0,2,0,0,0,-1,2,1,-2,3,1,0,-1,-1,-1,-1,2,3,0,1,1,-1,1,-1,3,-1
KR_6566618006,420,-1,42,35,-1,-2,6,4,2,3,5,1,2,3,-1,2,1,-1,1,0,-1,-2,1,-1,-4,5,4,0,-1,-1,-1,-1,-1,1,-1
KR_6535925855,440,1,-36,32,3,0,1,1,4,1,5,0,1,1,-1,2,1,0,0,0,0,1,-27,0,-5,5,-3,0,0,-1,1,0,1,4,-1
KR_6669789383,420,-7,-40,-44,-14,-1,1,0,-6,8,2,3,0,3,-7,7,0,-3,3,0,-1,-20,-39,0,-5,5,-1,0,-4,-1,-1,-1,-1,1,-1
KR_6684044078,420,-2,3,0,-7,-4,4,0,-1,2,1,-2,4,2,1,2,3,-1,1,0,0,-4,-11,-5,-3,8,4,0,0,-1,-1,0,-1,6,-1
KR_6679886739,420,-1,-39,27,-5,-6,8,2,-2,6,4,-1,3,2,1,2,3,3,1,4,0,2,-8,-6,-4,10,-3,0,0,1,0,0,1,4,-1
KR_6693948260,420,-2,-44,-12,-4,-7,7,0,2,2,4,1,1,2,0,1,1,0,1,1,0,7,-2,-4,-3,7,2,0,0,1,0,-1,1,3,-1
KR_6703839935,440,0,-46,-12,4,0,1,1,4,2,6,0,1,1,-1,5,4,1,0,1,0,-2,0,-1,-4,5,-1,0,-1,-1,-1,-1,-1,5,-1
KR_6706187785,420,-3,1,11,-2,0,1,1,0,2,2,-3,5,2,2,2,4,-1,3,2,0,-5,25,-5,-3,8,-3,0,0,1,-1,0,-1,5,-1
KR_6727307105,440,3,70,28,-2,0,1,1,2,1,3,-3,4,1,-1,3,2,0,0,0,0,-7,2,-1,-3,4,-2,0,1,0,1,1,-1,0,-1
KR_6693707940,420,-5,-68,-16,-11,-1,3,2,-3,7,4,-2,5,3,-1,2,1,-4,4,0,-1,-9,-4,-5,-3,8,-1,0,-2,-1,-1,-1,-1,5,-1
KR_6769953841,420,-3,-1,-10,-11,-4,4,0,-6,6,0,0,3,3,1,0,1,-2,3,1,-2,-15,39,-2,-6,8,-33,0,-1,1,-1,-1,-1,6,-1
KR_6604059454,420,-1,-45,-16,2,-3,4,1,9,0,9,-4,4,0,0,2,2,0,0,0,0,2,12,-4,-5,9,-5,0,0,-1,0,0,-1,2,-1
KR_6751647802,420,-1,2,14,-8,-4,5,1,2,1,3,-1,5,4,-4,5,1,-1,1,0,-1,-12,-3,-3,-5,8,-4,0,0,0,1,1,-1,0,-1
KR_6726585983,420,4,107,-9,5,0,3,3,0,1,1,7,0,7,-1,6,5,-1,1,0,0,1,-10,-3,-5,8,1,0,-1,-1,1,-1,-1,6,-1
KR_6739889306,420,-2,-24,-20,-3,-4,4,0,0,5,5,1,1,2,0,1,1,0,0,0,0,0,-12,-1,-3,4,1,0,-1,-1,-1,-1,-1,4,-1
KR_6767063037,420,-5,-44,-20,-4,-1,1,0,1,2,3,3,0,3,-6,8,2,-1,1,0,0,3,-198,2,-6,4,0,0,-1,1,-1,-1,-1,4,-1
KR_6768786926,420,-1,33,16,-5,-1,2,1,-1,2,1,-3,3,0,0,0,0,0,0,0,0,-4,4,0,-6,6,-3,0,0,-1,-1,1,-1,5,-1
KR_6653456786,420,-3,-71,32,-8,-3,3,0,-1,6,5,-5,6,1,-1,3,2,2,2,4,0,-7,-4,0,-4,4,-3,0,-1,1,0,-1,1,3,-1
KR_6726022086,420,-5,13,-40,-10,-1,2,1,-3,6,3,-7,7,0,3,0,3,-2,4,2,2,-8,1,-1,-2,3,-1,0,0,-1,-1,0,1,6,-1
KR_6647258550,420,-7,-104,0,-8,-4,5,1,-3,3,0,0,1,1,-1,5,4,0,2,2,-1,-8,6,-1,-3,4,-3,0,-2,0,-1,-1,-1,0,-1
KR_6275888596,420,1,-23,4,1,1,2,3,-1,4,3,0,4,4,4,1,5,-3,3,0,0,-5,-2,0,-5,5,0,0,-1,1,-1,-1,-1,1,-1
KR_6718701518,420,1,-28,21,4,-3,4,1,2,2,4,2,0,2,0,3,3,3,1,4,0,3,-1,0,-5,5,3,0,-1,1,1,-1,-1,2,-1
KR_6746507240,440,-5,-115,-21,-6,-6,6,0,7,2,9,-1,2,1,-3,6,3,-3,3,0,-1,-6,-37,-3,-2,5,24,0,-1,1,0,-1,-1,2,-1
KR_6770110107,420,-1,-25,-18,-1,-5,5,0,2,2,4,0,2,2,0,2,2,2,0,2,-1,1,3,-5,-4,9,1,0,0,-1,1,0,-1,6,-1
KR_6765615841,420,4,10,-3,9,0,1,1,2,2,4,3,1,4,3,1,4,1,1,2,0,12,1,1,-5,4,1,0,-1,-1,1,-1,1,3,-1
KR_6743598304,420,-2,-14,-18,-2,0,3,3,-5,6,1,-1,1,0,4,1,5,0,0,0,0,0,-20,-5,-4,9,3,0,0,1,-1,1,-1,6,-1
KR_6720565738,420,-1,-39,-24,-3,-2,3,1,-1,3,2,3,1,4,-4,7,3,1,0,1,0,1,137,0,-4,4,0,0,-1,1,-1,-1,1,6,-1
KR_6728137365,420,-2,20,-12,-9,0,2,2,-4,6,2,0,3,3,-5,5,0,0,2,2,0,-15,0,-2,-4,6,1,0,0,-1,1,-1,1,4,-1
KR_6675745258,420,-5,-27,16,-12,-4,5,1,-5,6,1,2,1,3,-1,5,4,-4,4,0,-1,-14,-8,-7,-3,10,6,0,0,-1,1,0,-1,3,-1
KR_6740218706,420,0,-38,40,-6,-1,1,0,2,2,4,-6,8,2,-2,3,1,1,0,1,2,-12,-1,3,-5,2,-1,0,0,-1,1,0,1,6,-1
KR_6715278483,420,-2,-6,-8,-7,-4,5,1,-2,5,3,-2,3,1,3,4,7,-2,2,0,0,-7,5,-3,-2,5,0,0,0,1,-1,-1,1,3,-1
KR_6770625819,420,0,-4,-12,3,-1,1,0,3,1,4,8,0,8,-5,5,0,-2,2,0,0,2,58,6,-8,2,2,0,0,-1,-1,0,1,4,-1
KR_6768608941,420,2,13,-4,0,1,1,2,3,0,3,0,4,4,-4,4,0,0,0,0,0,4,7,3,-7,4,-9,0,-1,-1,-1,-1,-1,2,-1
KR_6770492874,420,1,19,-18,1,-1,3,2,0,1,1,0,4,4,1,2,3,1,2,3,0,-1,13,3,-5,2,2,0,0,-1,-1,0,1,6,-1
KR_6603824476,420,2,-46,30,-3,8,1,9,-5,6,1,-1,1,0,-6,10,4,1,2,3,-3,-18,-3,-1,-3,4,0,0,0,-1,1,1,-1,4,-1
KR_6739188040,420,-5,-36,8,-17,-4,4,0,-3,4,1,-3,4,1,-9,9,0,2,0,2,0,-14,40,1,-5,4,-22,0,-1,-1,1,-1,-1,1,-1
KR_6767411339,420,-2,-88,0,-15,-2,3,1,-7,8,1,-3,4,1,-5,7,2,2,1,3,0,-23,-9,-1,-2,3,1,0,-2,-1,-1,-1,-1,5,-1
KR_6761722229,440,0,-44,7,6,-6,6,0,6,0,6,5,2,7,3,0,3,-2,3,1,0,13,-4,-4,-3,7,4,0,2,-1,-1,1,-1,1,-1
KR_6748250029,420,-2,-45,-15,0,-6,7,1,-1,4,3,2,2,4,4,0,4,1,1,2,-2,-3,0,-3,-5,8,2,0,-1,0,-1,-1,-1,0,-1
KR_6731163480,420,-5,-51,-23,-13,-5,6,1,-3,3,0,1,1,2,-4,4,0,-2,2,0,0,-13,-1,-5,-2,7,1,0,-1,-1,0,-1,-1,4,-1
KR_6767425352,420,2,-9,-1,5,1,0,1,3,0,3,-1,3,2,2,2,4,0,2,2,0,14,5,3,-6,3,2,0,1,1,-1,-1,-1,1,-1
KR_6726099290,420,-4,-43,-46,-4,-1,4,3,-3,5,2,0,3,3,0,3,3,0,0,0,0,-4,1,-4,-1,5,-1,0,0,1,-1,0,-1,6,-1
KR_6731090689,420,1,-38,9,-4,1,0,1,-1,3,2,-2,3,1,-2,3,1,0,0,0,0,-2,1,0,-5,5,3,0,0,1,-1,-1,-1,1,-1
KR_6719467796,440,-1,14,4,-4,3,1,4,-5,6,1,-3,3,0,1,1,2,0,0,0,0,-5,-262,5,-5,0,-2,0,1,-1,1,1,1,5,-1
KR_6590684854,420,-2,5,-7,5,0,2,2,2,3,5,-2,5,3,3,1,4,2,1,3,0,0,1,2,-6,4,2,0,0,1,1,0,1,2,-1
KR_6683504663,420,-2,-30,-1,0,0,3,3,2,5,7,1,2,3,-1,2,1,-2,5,3,-1,1,24,0,-3,3,1,0,1,-1,1,1,-1,2,-1
KR_6733677923,440,-1,26,19,-8,-4,4,0,-2,4,2,-1,2,1,-1,6,5,0,1,1,0,-10,21,-2,-7,9,-5,0,-2,-1,-1,-1,-1,3,-1
KR_6669235941,440,0,1,-15,-9,-1,7,6,-1,3,2,0,1,1,-2,4,2,-5,7,2,-3,-8,2,-2,-4,6,0,0,-1,-1,1,-1,-1,3,-1
KR_6767222568,420,0,-8,-12,-1,2,0,2,2,1,3,2,1,3,-4,4,0,-3,5,2,0,-4,-2,0,-3,3,-5,0,-1,-1,-1,-1,-1,6,-1
KR_6667762946,420,-4,-37,-52,-5,5,1,6,-7,7,0,0,2,2,-2,3,1,-1,1,0,-2,-4,11,5,-8,3,-4,0,-1,-1,-1,-1,-1,2,-1
KR_6764855355,440,-11,-99,-4,-22,-3,3,0,-2,3,1,-7,10,3,-7,11,4,-3,3,0,0,-38,-7,2,-4,2,0,0,-2,-1,0,-1,-1,5,-1
KR_6754176572,420,0,-35,-4,2,-1,1,0,-4,5,1,3,1,4,3,3,6,1,1,2,1,-2,13,-4,-1,5,1,0,0,-1,1,0,-1,4,-1
KR_6750414156,420,2,31,36,-4,0,2,2,-1,2,1,0,4,4,-2,6,4,-1,2,1,0,-6,-14,-3,-5,8,-1,0,1,-1,1,1,1,2,-1
KR_6750948244,420,0,-14,8,5,-5,5,0,6,1,7,2,3,5,2,1,3,0,1,1,0,15,10,3,-5,2,-2,0,0,1,1,0,-1,2,-1
KR_6672961647,420,-4,-14,8,-3,-1,1,0,0,5,5,-1,4,3,-2,3,1,1,1,2,0,-5,3,3,-8,5,-7,0,-1,-1,1,-1,-1,4,-1
KR_6732534899,420,7,73,24,11,1,1,2,2,2,4,2,2,4,3,1,4,3,0,3,0,10,-1,0,-4,4,-1,0,1,-1,1,1,-1,2,-1
KR_6747449523,420,-4,-109,-17,-17,-6,8,2,-8,8,0,1,3,4,-5,8,3,1,0,1,-2,-10,247,0,-1,1,1,-1,-2,-1,-1,-1,-1,3,-1
KR_6622475833,420,-9,-135,-35,-14,-1,2,1,-1,1,0,-5,5,0,-4,5,1,-3,3,0,-2,-13,-6,-4,-3,7,-1,0,-1,-1,-1,-1,-1,5,-1
KR_6752152244,420,2,-31,32,-4,-4,6,2,-2,2,0,2,1,3,0,1,1,0,2,2,-1,-4,15,2,-6,4,-1,0,-1,1,-1,-1,-1,1,-1
KR_6765371294,420,1,-29,27,2,-1,2,1,-1,5,4,-2,3,1,3,0,3,3,2,5,0,4,-265,-2,-2,4,9,0,1,0,1,1,1,0,-1
KR_6734210905,420,-3,-70,-21,-5,3,0,3,1,0,1,-3,5,2,-1,2,1,-5,5,0,0,-7,-8,-2,-2,4,-2,0,-1,-1,1,-1,1,4,-1
KR_6685741701,420,0,-41,-5,2,4,2,6,2,1,3,-2,3,1,0,1,1,-2,2,0,0,-4,-28,-2,-4,6,1,0,-1,1,-1,-1,-1,6,-1
KR_6763253790,420,-3,3,9,-9,-1,3,2,-1,7,6,-2,2,0,-3,7,4,-2,2,0,1,-15,-3,-2,-2,4,0,0,0,1,1,1,1,2,-1
KR_6715176363,420,-3,28,15,-6,-1,2,1,-4,5,1,-3,5,2,2,1,3,0,2,2,0,0,-2,-2,-3,5,-1,0,-1,-1,-1,-1,1,1,-1
KR_6743972668,420,-4,-80,-28,-5,2,1,3,2,3,5,-1,2,1,-2,4,2,-6,6,0,0,-4,96,1,-6,5,-6,0,-3,-1,-1,-1,1,5,-1
KR_6718641045,420,1,-11,-8,-1,1,0,1,0,3,3,-1,4,3,-2,3,1,1,1,2,-1,2,6,-2,-3,5,-2,0,0,-1,-1,0,-1,4,-1
KR_6669820731,420,-3,-12,-24,-4,0,1,1,-3,4,1,-2,2,0,3,1,4,-2,2,0,-1,-3,0,0,-7,7,-4,0,0,-1,-1,-1,-1,2,-1
KR_6675817216,420,-1,4,-16,6,0,1,1,-4,10,6,10,1,11,-1,2,1,1,0,1,0,1,-16,3,-7,4,4,0,1,-1,-1,1,1,3,-1
KR_6653365037,420,-1,-62,-11,-2,-2,3,1,-3,4,1,2,2,4,1,1,2,0,0,0,0,2,0,1,-5,4,-1,0,0,1,1,-1,1,2,-1
KR_6607419669,440,-4,-6,-24,-9,-4,4,0,-5,5,0,-3,8,5,3,0,3,0,1,1,0,-11,-3,4,-7,3,3,0,0,0,1,0,1,0,-1
KR_6671368974,420,1,29,-8,4,-4,4,0,7,0,7,1,1,2,2,2,4,-2,2,0,0,9,-25,2,-6,4,22,0,0,-1,-1,0,-1,3,-1
KR_6758171962,420,0,-121,9,-2,-4,4,0,-1,3,2,3,4,7,1,2,3,-1,2,1,0,5,10,-2,-4,6,-5,0,0,0,1,0,-1,0,-1
KR_6753009034,420,-3,-116,17,-6,-4,4,0,-1,4,3,-3,4,1,-2,3,1,4,0,4,0,-7,5,3,-8,5,2,0,-3,-1,-1,-1,1,3,-1
KR_6489644026,420,3,34,0,2,1,4,5,-2,4,2,2,2,4,2,6,8,-1,1,0,1,3,-4,3,-8,5,1,0,1,1,1,1,1,5,-1
KR_6756412792,440,-2,30,-18,-9,-3,5,2,-7,7,0,3,2,5,-3,5,2,1,0,1,-1,-15,-17,0,-4,4,-3,0,-1,0,-1,-1,-1,0,-1
KR_6708774345,440,0,-33,-4,4,0,2,2,1,1,2,-2,3,1,5,3,8,0,1,1,0,7,-235,-5,-2,7,3,0,0,0,1,1,1,0,-1
KR_6667719419,420,0,17,3,-3,0,2,2,-2,5,3,-4,7,3,2,2,4,1,1,2,0,-2,6,-1,-5,6,-2,0,1,0,1,1,-1,0,-1
KR_6715979915,420,-6,-80,3,-16,-3,5,2,-3,4,1,-3,3,0,-3,4,1,-4,5,1,0,-19,-95,-4,-1,5,1,0,-1,-1,-1,-1,-1,1,-1
KR_6768327298,420,0,27,-25,-4,3,2,5,-1,4,3,-3,6,3,-2,6,4,-1,4,3,0,-13,-54,0,-7,7,4,0,1,-1,1,1,-1,5,-1
KR_6737337495,420,-3,-9,-24,-9,2,0,2,-2,3,1,0,2,2,-7,8,1,-2,2,0,0,-12,5,3,-7,4,1,0,0,-1,1,-1,-1,4,-1
KR_6715550662,420,-2,29,-9,-5,0,2,2,0,2,2,-1,4,3,-2,4,2,-2,2,0,-1,-8,-4,2,-5,3,1,0,-1,1,1,-1,-1,1,-1
KR_6674926608,440,-2,-93,32,-6,-1,2,1,1,0,1,1,2,3,-4,5,1,-3,4,1,0,-5,-2,0,-3,3,2,0,0,-1,1,0,1,3,-1
KR_6770588896,420,0,-21,-1,-3,-1,3,2,-2,4,2,3,3,6,-5,7,2,2,1,3,0,-4,55,-1,-5,6,-20,0,0,-1,-1,-1,-1,5,-1
KR_6767842612,420,-3,-67,0,-4,-1,3,2,0,3,3,-1,2,1,-1,3,2,-1,1,0,0,-4,4,5,-9,4,2,0,-1,-1,-1,-1,-1,6,-1
KR_6770480380,420,0,-47,16,5,-3,4,1,0,1,1,2,1,3,4,0,4,2,0,2,0,15,-2,2,-5,3,6,0,-1,1,-1,-1,-1,6,-1
KR_6730715033,420,3,-22,35,2,-1,4,3,-4,8,4,4,3,7,4,2,6,-1,1,0,0,-7,9,2,-7,5,3,0,3,1,1,1,1,5,-1
KR_6499719217,440,2,-26,4,8,0,4,4,2,4,6,6,2,8,-2,6,4,2,3,5,0,12,0,1,-2,1,0,0,1,1,1,-1,-1,4,-1
KR_6769618330,420,-3,13,6,-7,-2,3,1,-2,4,2,3,1,4,-5,6,1,-1,2,1,1,-9,-6,-9,-2,11,4,0,-1,-1,1,-1,1,5,-1
KR_6769290554,420,0,-25,-3,-1,-1,4,3,1,0,1,3,0,3,-2,5,3,-2,3,1,0,-6,-8,0,-7,7,5,0,-1,1,0,1,-1,1,-1
KR_6767439315,420,-3,-140,18,-3,-3,6,3,0,1,1,1,2,3,-2,5,3,1,3,4,0,1,-7,0,-6,6,0,0,-2,0,1,-1,-1,0,-1
KR_6770054705,420,-2,-70,-4,-5,0,2,2,1,1,2,2,3,5,-5,5,0,-3,3,0,0,-10,3,1,-6,5,-2,0,0,0,1,-1,1,0,-1
KR_6685878614,420,-3,-45,-24,-3,0,3,3,-4,5,1,2,4,6,-3,5,2,2,1,3,0,-2,-8,-4,-2,6,3,0,0,-1,1,0,1,5,-1
KR_6746435259,420,-5,-78,8,-8,-3,3,0,1,0,1,-3,3,0,-4,6,2,1,1,2,0,-6,-2,1,-6,5,-1,0,-2,1,-1,-1,1,1,-1
KR_6484133532,420,2,12,20,1,0,0,0,3,3,6,-3,3,0,-1,1,0,2,1,3,0,0,-3,-2,-5,7,-5,0,-1,1,-1,-1,1,1,-1
KR_6747564185,420,6,-29,41,10,4,1,5,0,1,1,0,0,0,3,2,5,3,1,4,0,11,9,-2,-5,7,0,0,2,0,1,1,1,0,-1
KR_6691310740,420,-3,-63,-16,-3,0,2,2,-1,3,2,-2,5,3,0,2,2,0,0,0,0,-4,0,1,-6,5,-2,0,-2,1,1,-1,-1,4,-1
KR_6733995797,420,1,-21,3,3,1,2,3,1,2,3,2,1,3,-1,5,4,0,0,0,-1,-6,-10,-5,-1,6,-1,0,1,-1,1,1,-1,2,-1
KR_6722741260,420,0,-13,32,-3,-2,2,0,2,3,5,-3,6,3,-1,1,0,1,1,2,0,3,-305,1,-5,4,-6,0,0,-1,-1,0,-1,6,-1
KR_6725969865,420,-5,-54,-4,-6,2,2,4,-3,6,3,-3,4,1,-1,1,0,-1,2,1,0,-3,-3,3,-5,2,-5,0,-2,-1,-1,-1,-1,6,-1
KR_6770945550,420,-1,-2,24,-4,-1,5,4,-1,3,2,1,1,2,0,3,3,-3,4,1,-1,-6,-21,4,-8,4,-2,0,-1,-1,-1,-1,-1,5,-1
KR_6769880745,420,3,8,0,5,6,0,6,0,4,4,-1,2,1,1,3,4,-1,1,0,0,2,-17,-1,-4,5,4,0,-1,1,-1,-1,1,3,-1
KR_6730931882,440,0,-24,-17,6,3,2,5,1,1,2,-2,3,1,3,1,4,1,0,1,0,9,-42,-1,-1,2,-3,0,0,-1,1,0,1,2,-1
KR_6754550113,420,-2,6,1,-11,1,1,2,0,1,1,-10,10,0,-2,3,1,0,2,2,-1,-16,2,-1,-3,4,-3,0,0,-1,-1,-1,-1,4,-1
KR_6542232192,420,0,-43,-8,1,0,2,2,-4,5,1,6,2,8,-1,1,0,0,2,2,0,2,3,1,-7,6,4,0,1,1,1,1,1,6,-1
KR_6758813746,420,-6,-69,-20,-15,-1,2,1,-1,3,2,-9,9,0,-1,3,2,-3,3,0,0,-10,377,-1,-4,5,1,0,0,1,1,0,-1,3,-1
KR_6749564500,420,-4,-54,0,-16,-4,7,3,0,2,2,-8,8,0,-4,5,1,0,0,0,0,-14,4,-3,-4,7,-4,0,-4,0,-1,-1,-1,0,-1
KR_6770992004,420,1,-38,-44,-3,2,1,3,1,1,2,2,1,3,-7,7,0,-1,2,1,0,-7,-11,3,-6,3,-1,0,-2,-1,-1,-1,-1,2,-1
KR_6653467468,420,-3,-32,4,-6,-1,3,2,1,1,2,-1,1,0,-6,6,0,1,0,1,0,-4,-9,4,-6,2,-2,0,-3,-1,-1,-1,1,3,-1
KR_6756201097,420,-2,-68,8,-4,0,2,2,-5,9,4,-3,4,1,4,0,4,0,1,1,0,-5,-5,3,-7,4,-1,0,0,1,1,0,1,5,-1
KR_6734223002,440,-2,-85,-19,3,4,0,4,1,2,3,0,1,1,-1,2,1,-1,1,0,0,-2,-17,-3,0,3,3,0,0,0,0,0,1,0,-1
KR_6506271850,420,-2,-23,-4,-3,-2,4,2,0,2,2,3,0,3,-3,4,1,-1,1,0,0,-4,-250,-3,-3,6,-4,0,-2,-1,1,-1,-1,1,-1
KR_6681533184,420,-3,-9,-8,-9,2,1,3,-1,4,3,-4,5,1,-2,5,3,-4,4,0,0,-14,-1,1,-5,4,-7,0,-1,0,-1,-1,1,0,-1
KR_6753459741,420,2,0,18,0,-1,2,1,-3,6,3,0,0,0,0,1,1,4,0,4,0,-4,22,5,-7,2,-13,0,0,-1,-1,0,-1,6,-1
KR_6770905817,420,0,-12,-7,1,1,1,2,-1,2,1,1,3,4,-1,1,0,1,0,1,0,6,-26,-2,-3,5,4,0,1,0,0,1,-1,0,-1
KR_6766628003,420,2,16,5,7,2,1,3,2,3,5,1,1,2,2,1,3,0,1,1,0,5,8,-2,-5,7,3,0,2,-1,1,1,1,4,-1
KR_6747231524,420,-2,-41,12,-4,2,0,2,-2,4,2,-5,5,0,4,1,5,-3,3,0,0,-6,0,4,-9,5,-5,0,0,-1,-1,0,1,6,-1
KR_6767951428,420,-7,-99,-50,-16,0,1,1,-7,7,0,-3,6,3,-7,9,2,1,0,1,0,-6,29,-2,-4,6,-2,0,-3,-1,1,-1,1,5,-1
KR_6647289242,420,0,53,-10,2,0,3,3,-4,5,1,0,3,3,4,0,4,2,2,4,0,-3,6,3,-5,2,-2,0,0,1,-1,1,1,4,-1
KR_6769201662,420,-5,-45,-38,-5,0,2,2,-1,2,1,0,2,2,-2,3,1,-2,3,1,0,-1,19,-2,-2,4,-7,0,-3,-1,-1,-1,-1,6,-1
KR_6591284184,420,-3,36,9,-4,2,2,4,-5,5,0,2,0,2,-2,4,2,-1,2,1,0,-8,0,0,-3,3,0,0,1,-1,1,1,1,6,-1
KR_6424643643,420,-3,-41,8,-9,-3,5,2,-1,5,4,-1,4,3,-4,6,2,0,0,0,0,-9,4,-2,-7,9,1,0,0,-1,0,0,1,3,-1
KR_6766607573,420,-7,-51,-31,-6,-3,6,3,0,3,3,-2,3,1,0,0,0,-1,2,1,0,0,-10,0,-5,5,3,0,0,1,-1,-1,1,5,-1
KR_6766291219,420,-5,33,-64,-7,6,0,6,-7,7,0,-2,3,1,-2,5,3,-2,2,0,0,-16,-6,-2,-1,3,-3,0,1,-1,-1,-1,1,1,-1
KR_6718817555,420,0,26,-15,-3,4,0,4,-1,1,0,2,4,6,-8,8,0,0,3,3,0,-9,-7,-2,-5,7,0,0,-1,1,1,-1,1,5,-1
KR_6767167609,420,-4,-73,-14,-4,0,2,2,1,2,3,-4,5,1,-2,4,2,1,0,1,0,-5,49,1,-5,4,2,0,-2,-1,-1,-1,-1,3,-1
KR_6723488735,440,-4,-42,9,-8,2,1,3,-2,3,1,-7,7,0,-1,2,1,0,2,2,0,-5,4,7,-8,1,-5,0,-1,0,-1,-1,-1,0,-1
KR_6769353539,420,0,29,16,6,6,0,6,1,2,3,-1,4,3,2,1,3,-2,2,0,0,8,0,1,-4,3,0,0,0,0,-1,0,1,0,-1
KR_6758922343,420,0,13,15,-1,4,0,4,3,0,3,-1,4,3,-8,9,1,1,0,1,0,-5,-14,-4,-5,9,9,0,0,1,-1,-1,-1,5,-1
KR_6626328422,440,1,-74,-3,7,2,0,2,7,0,7,2,0,2,-4,5,1,0,1,1,0,7,26,2,-4,2,-3,0,1,-1,1,1,-1,5,-1
KR_6763200529,420,-3,-17,3,-10,-2,3,1,1,4,5,-1,1,0,-7,8,1,-1,1,0,0,-4,3,2,-6,4,0,0,-1,-1,-1,-1,-1,6,-1
KR_6647567223,420,-1,-50,15,1,-4,5,1,2,1,3,2,1,3,0,1,1,1,0,1,0,8,1,1,-3,2,-1,0,0,-1,1,-1,-1,2,-1
KR_6747397825,420,5,83,-3,7,6,1,7,3,1,4,-4,5,1,1,1,2,1,1,2,0,7,-1,-2,-4,6,2,0,1,1,-1,1,1,4,-1
KR_6766189891,420,-3,-14,-1,-11,-4,5,1,-2,4,2,-3,5,2,-2,3,1,0,1,1,-1,-11,-184,-3,-6,9,-1,0,0,-1,1,0,-1,5,-1
KR_6762779990,420,1,57,4,0,0,2,2,2,1,3,1,3,4,-1,3,2,-2,2,0,0,-4,5,5,-7,2,-4,0,1,-1,1,1,1,1,-1
KR_6756288574,440,0,-14,-4,-4,0,1,1,-4,6,2,1,3,4,-1,2,1,0,3,3,0,-7,-2,-3,-5,8,1,0,0,-1,0,0,-1,2,-1
KR_6750695298,420,4,34,3,12,2,0,2,5,3,8,3,3,6,-1,3,2,3,0,3,0,4,0,-1,-6,7,1,0,0,-1,1,1,1,1,-1
KR_6627408577,420,-1,-26,8,2,1,2,3,-7,9,2,3,0,3,5,2,7,0,1,1,-2,8,0,0,-5,5,3,0,-1,-1,1,-1,-1,1,-1
KR_6627555467,420,0,-14,-5,1,-2,2,0,0,4,4,1,3,4,3,0,3,-1,1,0,1,-1,258,2,-8,6,0,0,0,1,1,1,1,2,-1
KR_6767705849,420,1,-35,14,-8,3,1,4,-1,3,2,-1,5,4,-7,8,1,-2,4,2,-1,-6,-8,5,-5,0,0,0,0,1,1,-1,-1,6,-1
KR_6767458542,420,1,-44,17,-7,-2,4,2,0,2,2,0,2,2,-5,6,1,0,1,1,-1,-12,-7,6,-9,3,-3,0,0,1,0,-1,-1,5,-1
KR_6768164738,420,-4,-65,-4,-11,-6,6,0,0,2,2,-2,3,1,-2,5,3,-1,1,0,0,-7,8,3,-9,6,-4,0,0,1,-1,1,1,1,-1
KR_6607683075,420,0,-10,31,0,4,1,5,-1,2,1,3,4,7,-3,8,5,-3,3,0,0,-6,-30,1,-6,5,-2,0,1,-1,1,1,1,4,-1
KR_6646192858,420,-1,-47,6,-1,-2,5,3,5,1,6,1,2,3,-4,4,0,-1,1,0,0,3,5,0,-8,8,-3,0,0,-1,0,-1,-1,4,-1
KR_6638457287,440,-6,-26,-8,-15,-2,3,1,1,5,6,-4,5,1,-8,8,0,-2,2,0,0,-12,-9,-6,-2,8,2,0,-1,-1,-1,-1,1,4,-1
KR_6755053488,420,-1,-9,14,-6,2,1,3,-1,3,2,-7,7,0,2,2,4,-2,2,0,0,-19,-9,-6,-4,10,1,0,0,-1,0,1,1,4,-1
KR_6752200181,420,-2,-27,-33,-11,2,0,2,-3,4,1,-3,4,1,-5,5,0,-2,2,0,0,-11,-1,0,-6,6,0,0,-2,1,-1,-1,-1,2,-1
KR_6771150833,420,-1,-64,8,-5,-2,3,1,-2,5,3,-5,5,0,1,4,5,3,0,3,0,-1,-1,-3,-4,7,2,0,1,-1,-1,1,-1,4,-1
KR_6583387842,420,1,61,4,5,4,0,4,-1,2,1,5,3,8,-5,6,1,2,0,2,0,-4,35,-3,-5,8,-26,0,2,-1,1,1,1,2,-1
KR_6770112800,440,-1,6,4,1,0,1,1,0,1,1,1,3,4,0,2,2,0,0,0,0,4,3,2,-4,2,-2,0,0,-1,0,0,1,2,-1
KR_6756174938,420,-2,-42,-15,-8,1,0,1,-5,6,1,-4,6,2,-1,5,4,1,2,3,-1,-4,104,1,-6,5,3,0,0,0,-1,-1,-1,0,-1
KR_6703735070,420,-2,-16,-48,2,3,0,3,-1,3,2,0,1,1,1,3,4,-1,1,0,0,5,-11,-2,-6,8,3,0,0,-1,1,0,-1,1,-1
KR_6673960094,420,1,43,-12,-3,4,3,7,-3,6,3,0,1,1,-3,5,2,-1,2,1,-2,-6,0,-4,-4,8,6,0,0,-1,-1,1,-1,4,-1
KR_6719757211,420,0,25,10,-4,0,1,1,-1,4,3,-3,5,2,2,2,4,-2,2,0,2,1,-44,0,-6,6,-2,0,0,-1,-1,-1,1,4,-1
KR_6730967857,440,0,-42,38,0,1,1,2,-4,6,2,-1,1,0,4,0,4,0,1,1,0,4,7,2,-5,3,-1,0,0,-1,0,0,-1,2,-1
KR_6767206223,420,-3,-103,12,-8,-3,4,1,1,0,1,-2,2,0,-1,4,3,-3,3,0,1,-9,-3,0,-4,4,5,0,-1,1,-1,-1,1,1,-1
KR_6727843974,420,-3,-55,-1,-16,-12,12,0,-3,6,3,2,2,4,-1,3,2,-2,3,1,-1,-7,-12,-6,-2,8,0,0,0,-1,-1,-1,-1,1,-1
KR_6683445551,420,-2,-77,-16,-7,-6,7,1,-5,6,1,3,0,3,1,0,1,0,0,0,0,1,1,1,-6,5,-4,0,0,-1,-1,-1,-1,3,-1
KR_6610687888,420,-4,-20,-12,-9,-6,7,1,0,4,4,-2,3,1,0,0,0,-1,2,1,-1,-7,-4,0,-3,3,-4,0,0,-1,1,0,-1,6,-1
KR_6743887445,420,-2,-20,-4,-4,3,0,3,-1,1,0,-5,5,0,1,0,1,-2,2,0,0,-5,0,1,-6,5,0,0,0,1,0,0,-1,4,-1
KR_6603211848,420,-1,-31,8,-3,-2,2,0,-2,4,2,4,1,5,-3,3,0,0,0,0,0,1,-58,2,-8,6,-1,0,-1,1,0,-1,-1,1,-1
KR_6770369246,420,1,28,-8,-6,-1,4,3,1,5,6,0,2,2,-5,5,0,-1,2,1,0,-7,37,2,-6,4,-13,0,0,-1,1,-1,-1,3,-1
KR_6732018515,440,-8,-92,-1,-9,-5,5,0,-1,3,2,-3,3,0,2,0,2,-2,4,2,0,-6,-1,-4,-4,8,-3,0,1,1,-1,1,-1,6,-1
KR_6713066333,420,-4,-52,15,-13,-1,1,0,-2,2,0,-4,4,0,-1,2,1,-5,5,0,0,-14,-47,-2,-3,5,15,0,-2,0,1,-1,-1,0,-1
KR_6769149188,420,-1,-6,8,0,0,0,0,0,1,1,0,1,1,-2,5,3,2,1,3,0,-2,2,0,-3,3,1,0,0,-1,1,1,-1,3,-1
KR_6758181190,420,-6,-24,-28,-14,0,3,3,-5,6,1,-7,7,0,0,2,2,-2,2,0,0,-22,-1,-1,-3,4,-3,0,-1,1,1,-1,-1,4,-1
KR_6764677427,440,-5,-41,-16,-9,1,6,7,2,2,4,-4,6,2,-7,8,1,-1,2,1,-2,-21,11,4,-7,3,-4,0,0,-1,1,1,-1,6,-1
KR_6753944627,420,-1,11,4,7,1,1,2,2,2,4,2,1,3,4,3,7,-2,2,0,3,15,-3,0,-5,5,-1,0,1,1,1,1,1,4,-1
KR_6750862557,420,-3,-27,-16,-6,-5,6,1,0,2,2,1,1,2,-3,4,1,1,0,1,0,-2,105,2,-7,5,-5,0,-1,-1,-1,-1,-1,4,-1
KR_6740755960,420,-2,74,9,-3,1,2,3,-7,8,1,3,2,5,0,2,2,0,3,3,1,-9,10,2,-5,3,-1,0,-1,1,1,1,1,2,-1
KR_6662306119,420,-2,-43,-2,-3,-4,4,0,0,1,1,1,0,1,-1,3,2,1,0,1,0,4,38,-1,-3,4,0,0,0,1,1,0,-1,4,-1
KR_6751208154,420,-5,-32,-12,-3,3,3,6,0,4,4,-2,5,3,2,5,7,-6,6,0,3,-5,-24,-3,-4,7,0,0,-1,-1,1,-1,1,1,-1
KR_6696719247,420,-4,-81,-8,-11,-1,2,1,2,1,3,-7,8,1,-4,4,0,-1,2,1,-1,-11,-6,-4,-5,9,-6,0,-2,-1,1,-1,-1,3,-1
KR_6750998521,420,-4,-94,35,-9,-4,4,0,-6,7,1,3,1,4,3,1,4,-5,7,2,0,-4,-2,1,-7,6,-2,0,-2,1,-1,-1,-1,5,-1
KR_6759811750,420,3,28,12,8,4,0,4,1,0,1,-1,4,3,-5,6,1,9,0,9,2,-1,-9,1,-9,8,12,0,1,0,1,1,1,0,-1
KR_6765293305,420,-3,-78,1,-7,-3,3,0,0,5,5,-1,6,5,-2,6,4,-1,4,3,0,-9,24,0,-5,5,-3,0,0,0,1,-1,-1,0,-1
KR_6759718787,420,-4,-44,-21,-4,0,1,1,-4,5,1,-4,6,2,1,4,5,3,0,3,0,2,58,1,-4,3,-1,0,-3,-1,1,-1,-1,6,-1
KR_6144791718,420,-3,-9,-38,-8,3,1,4,-2,4,2,-5,6,1,-1,5,4,-3,3,0,0,-11,-19,-5,-4,9,6,0,0,0,0,-1,1,0,-1
KR_6763604573,420,1,-6,-21,3,1,2,3,-1,4,3,2,0,2,3,2,5,-2,4,2,0,-3,-2,6,-12,6,3,0,0,-1,1,0,1,6,-1
KR_6635341605,420,-9,-76,-50,-15,-2,3,1,-9,9,0,-4,6,2,-1,2,1,1,1,2,0,-13,-25,2,-8,6,-2,0,-4,-1,-1,-1,1,3,-1
KR_6769373846,420,-3,-83,-8,-9,-7,8,1,-2,5,3,1,2,3,-1,2,1,0,1,1,0,-5,8,1,-6,5,-2,0,-1,-1,1,-1,-1,1,-1
KR_6653682241,420,-1,-20,-1,-7,-1,3,2,-4,5,1,-2,2,0,-1,4,3,1,1,2,-1,-10,-26,0,-4,4,-4,0,-1,1,-1,-1,-1,6,-1
KR_6671829211,440,1,-11,-8,2,3,0,3,0,2,2,0,1,1,0,1,1,-1,4,3,-1,9,-5,-4,-3,7,0,0,-1,-1,-1,-1,-1,6,-1
KR_6719571315,420,-1,-31,-19,9,4,3,7,1,1,2,4,0,4,-1,2,1,1,0,1,1,8,-95,4,-7,3,-1,0,-1,-1,1,-1,1,4,-1
KR_6741399424,420,0,26,-4,-2,1,1,2,0,0,0,1,4,5,-4,4,0,0,1,1,0,-7,-17,-1,-3,4,4,0,-1,-1,-1,-1,-1,6,-1
KR_6622177844,420,-2,-69,-3,-3,0,1,1,-3,3,0,1,2,3,0,2,2,-1,1,0,0,-2,-314,2,-7,5,-5,0,0,-1,-1,0,-1,3,-1
KR_6771185913,420,-1,-13,3,-2,-2,2,0,0,1,1,2,0,2,-1,2,1,-1,1,0,0,0,7,3,-5,2,-4,0,-1,1,-1,-1,1,5,-1
KR_6770010218,420,-1,-20,-4,6,-1,2,1,3,4,7,3,1,4,0,2,2,1,2,3,0,4,2,2,-7,5,0,0,0,-1,1,0,-1,2,-1
KR_6761237559,420,-4,-32,-29,-4,-1,2,1,-2,4,2,-2,2,0,1,3,4,0,2,2,0,-2,13,0,-4,4,0,0,0,0,1,0,-1,0,-1
KR_6726288167,420,-2,16,-4,-3,-1,3,2,1,2,3,-5,6,1,1,1,2,1,2,3,0,-8,-7,-3,-2,5,2,0,0,-1,1,-1,1,1,-1
KR_6741336262,420,2,33,-5,2,1,1,2,-1,5,4,-4,5,1,2,4,6,4,0,4,-1,-8,16,0,-4,4,-5,0,-1,1,-1,-1,-1,1,-1
KR_6770406242,440,2,19,-10,1,2,0,2,2,2,4,2,0,2,-5,8,3,0,1,1,0,-3,8,-1,-5,6,0,0,0,-1,1,1,-1,4,-1
KR_6750249656,420,3,39,-25,10,0,0,0,3,0,3,5,2,7,-2,4,2,4,0,4,0,4,-41,-7,-1,8,6,0,2,-1,1,1,1,6,-1
KR_6688028142,420,0,2,-7,-5,5,0,5,1,2,3,-1,3,2,-11,11,0,1,0,1,0,-16,1,3,-8,5,-2,0,0,-1,1,1,-1,1,-1
KR_6741545186,420,-2,-41,37,-9,-3,4,1,-4,5,1,2,0,2,-4,4,0,0,0,0,0,-14,0,-4,-2,6,2,0,0,1,1,1,1,2,-1
KR_6750767112,440,-2,-80,-16,-6,-3,5,2,1,1,2,1,1,2,-3,3,0,-2,2,0,0,-1,-72,-1,-5,6,-3,0,0,-1,0,0,-1,4,-1
KR_6743110681,420,0,14,36,-7,-6,6,0,2,5,7,-1,3,2,0,2,2,-2,2,0,0,-8,16,-1,-2,3,-9,0,-2,1,-1,-1,-1,6,-1
KR_6739459912,420,-3,-70,20,-8,0,2,2,-2,5,3,0,2,2,-4,4,0,-2,2,0,0,-4,-5,1,-3,2,2,0,-1,-1,1,-1,-1,1,-1
KR_6667786636,440,2,26,5,4,-2,4,2,-1,2,1,-2,3,1,5,2,7,4,0,4,0,1,-46,0,-4,4,21,0,1,1,1,1,1,3,-1
KR_6769087998,420,-1,-21,44,-5,0,1,1,0,4,4,-2,3,1,-2,4,2,-1,1,0,0,-5,-106,4,-6,2,-4,0,0,1,-1,0,1,5,-1
KR_6769749911,420,0,11,-5,-4,2,1,3,4,1,5,-1,2,1,-8,11,3,-1,1,0,-1,-10,-46,3,-8,5,25,0,0,-1,-1,0,-1,2,-1
KR_6748896683,440,-1,-18,0,0,-5,6,1,-4,7,3,-2,3,1,5,1,6,6,1,7,1,5,3,-2,-2,4,-3,0,0,-1,1,1,1,4,-1
KR_6765000433,420,0,32,3,-1,2,0,2,1,1,2,-4,4,0,2,2,4,-2,2,0,0,0,-3,1,-5,4,-1,0,1,-1,1,1,-1,1,-1
KR_6741824817,440,-4,86,-12,-8,-1,2,1,-10,13,3,2,0,2,2,3,5,-1,2,1,0,-6,-37,-1,-2,3,-4,0,0,-1,0,0,-1,4,-1
KR_6769529942,420,2,53,0,2,6,0,6,0,1,1,1,0,1,-2,4,2,-3,3,0,0,-1,-5,-3,-2,5,-3,0,1,-1,1,-1,1,3,-1
KR_6759621833,420,-3,-54,-4,-5,-1,1,0,0,2,2,-1,1,0,-4,4,0,1,0,1,0,-5,-7,-5,-4,9,5,0,-1,-1,1,-1,1,2,-1
KR_6696264150,440,1,22,14,-2,1,2,3,-2,5,3,3,0,3,-2,5,3,-2,2,0,0,-8,6,0,-3,3,-1,0,0,-1,1,0,1,5,-1
KR_6725912418,420,-3,1,-27,-11,1,2,3,-2,4,2,-5,6,1,-2,5,3,-3,4,1,0,-18,5,-2,-5,7,-8,0,-1,-1,1,-1,-1,4,-1
KR_6727942039,420,-2,-33,0,-9,-3,5,2,0,6,6,-3,3,0,-3,5,2,0,2,2,-1,-3,32,1,-6,5,-4,0,0,1,1,-1,-1,3,-1
KR_6758771510,420,0,37,0,0,-1,2,1,-2,3,1,3,3,6,1,2,3,-1,2,1,0,3,-5,0,-4,4,1,0,-1,-1,1,-1,1,4,-1
KR_6731246351,420,-3,-53,-11,-9,-1,2,1,-7,7,0,0,4,4,2,2,4,-3,4,1,0,-10,88,-1,-3,4,4,0,-2,-1,-1,-1,-1,1,-1
KR_6768352750,420,-7,-88,-39,-13,-6,6,0,-2,4,2,-1,1,0,-4,5,1,0,1,1,-1,-10,-10,-4,-4,8,4,0,-1,-1,1,-1,-1,6,-1
KR_6727867070,420,-1,-13,-16,-5,-1,1,0,1,1,2,1,1,2,-4,5,1,-2,2,0,0,-4,1,1,-6,5,3,0,-1,-1,1,-1,1,6,-1
KR_6691630309,420,-5,-80,-28,-16,-2,4,2,-2,4,2,-8,9,1,-3,4,1,-1,2,1,-2,-19,-21,-8,-1,9,3,0,-2,-1,-1,-1,-1,1,-1
KR_6756716950,420,0,40,20,0,-1,1,0,1,2,3,-8,9,1,9,1,10,-1,2,1,0,2,90,0,-6,6,-1,0,0,0,1,0,-1,0,-1
KR_6752277230,420,-3,-35,21,-7,4,0,4,-11,13,2,-4,5,1,3,0,3,1,3,4,0,0,-2,-2,-4,6,-4,0,-2,-1,-1,-1,-1,2,-1
KR_6761484986,420,1,30,20,-2,-5,6,1,3,1,4,4,1,5,-2,2,0,-2,2,0,0,-2,-18,-2,-3,5,2,0,0,-1,-1,1,-1,3,-1
KR_6758880376,420,-1,-1,-33,-1,-3,4,1,3,3,6,-2,4,2,2,2,4,-1,3,2,0,2,-124,-1,-6,7,-4,0,0,-1,-1,0,1,5,-1
KR_6717391583,440,-5,-27,-40,-13,-7,11,4,-4,7,3,-1,1,0,0,2,2,-1,2,1,-2,-17,-214,-3,-3,6,0,0,-1,-1,-1,-1,-1,2,-1
KR_6764353394,420,-3,-51,-24,-1,0,3,3,2,1,3,0,5,5,-2,4,2,-1,1,0,0,-6,-18,-2,-6,8,0,0,-1,-1,0,-1,1,1,-1
KR_6764415328,420,1,-48,-10,0,0,1,1,-2,4,2,0,1,1,0,3,3,2,0,2,1,0,230,2,-8,6,-3,0,0,-1,1,0,1,6,-1
KR_6761413748,420,-3,-32,2,-3,-3,4,1,0,4,4,4,2,6,-4,5,1,0,0,0,0,-10,10,2,-6,4,-1,0,-1,1,-1,-1,1,5,-1
KR_6749634242,440,-1,10,16,-10,-1,1,0,-3,6,3,-2,4,2,-4,5,1,0,1,1,0,-11,3,1,-6,5,1,0,-2,-1,-1,-1,-1,3,-1
KR_6760738181,420,-1,-8,4,0,0,0,0,3,1,4,-5,5,0,1,1,2,1,1,2,0,0,-119,0,-6,6,2,0,0,1,-1,0,-1,4,-1
KR_6751663180,420,-2,15,4,-4,3,0,3,-3,4,1,-3,6,3,-1,3,2,0,0,0,0,-16,58,-2,-3,5,2,0,1,1,1,1,1,2,-1
KR_6723615933,420,1,25,-12,-2,1,3,4,3,0,3,-2,4,2,-3,4,1,-1,1,0,0,3,5,4,-7,3,0,0,1,-1,1,1,-1,1,-1
KR_6625374450,420,-7,-30,-23,-17,-3,3,0,-10,12,2,-1,3,2,-2,4,2,-1,1,0,0,-25,-3,3,-8,5,-1,0,0,-1,1,-1,-1,5,-1
KR_6630291192,420,-3,-4,-12,-4,1,1,2,3,2,5,-3,5,2,-4,6,2,-1,1,0,0,-6,-10,-2,-4,6,0,0,-1,-1,-1,-1,1,2,-1
KR_6676084024,440,-3,-68,-31,3,4,0,4,-1,2,1,1,0,1,-1,2,1,0,0,0,0,-1,-17,0,-3,3,4,0,0,-1,-1,-1,1,3,-1
KR_6751804966,420,-4,-82,-19,-1,1,1,2,1,5,6,1,2,3,-2,5,3,-2,2,0,0,0,-10,0,-4,4,0,0,-1,-1,-1,-1,-1,5,-1
KR_6727406867,420,-1,21,24,-3,-1,1,0,4,1,5,2,1,3,-6,8,2,-2,4,2,0,-10,-182,2,-6,4,-1,0,-1,-1,-1,-1,1,5,-1
KR_6699944336,420,1,-3,7,9,0,3,3,-1,4,3,-3,3,0,12,1,13,1,3,4,1,13,-5,0,-6,6,-3,0,0,-1,0,1,1,4,-1
KR_6742305926,420,-7,-50,-24,-11,1,1,2,-1,2,1,-3,3,0,-10,10,0,2,0,2,0,-5,14,2,-5,3,-5,0,0,-1,-1,1,1,1,-1
KR_6702611368,420,0,23,0,5,-5,5,0,0,2,2,5,3,8,2,2,4,3,1,4,1,9,-3,4,-5,1,0,0,-1,1,-1,-1,1,5,-1
KR_6763040474,420,-3,-10,4,-13,-4,5,1,-1,3,2,-1,4,3,-7,9,2,0,1,1,0,-15,-50,-4,-4,8,-2,0,-2,1,-1,-1,1,4,-1
KR_6730138408,420,-5,-105,11,-20,-1,2,1,-7,9,2,-4,8,4,-6,6,0,-2,3,1,0,-21,29,5,-8,3,-2,0,-2,0,1,-1,-1,0,-1
KR_6739483980,420,-2,-28,-4,-14,-8,9,1,-1,2,1,-5,7,2,-1,2,1,1,0,1,0,-6,-5,-3,-1,4,-2,0,-1,1,0,-1,-1,4,-1
KR_6647336689,420,-1,1,-35,-5,1,1,2,1,0,1,-4,4,0,-1,3,2,-2,2,0,0,-6,11,3,-6,3,-2,0,-1,-1,-1,-1,-1,4,-1
KR_6766219222,420,-4,-86,-11,-12,3,2,5,-2,3,1,1,1,2,-11,11,0,-3,3,0,0,-9,0,0,-3,3,-2,0,-2,-1,0,-1,-1,6,-1
KR_6766531839,420,-3,-69,19,-4,0,1,1,4,1,5,-5,9,4,-2,5,3,-1,1,0,0,-6,-30,2,-7,5,21,0,-1,-1,-1,-1,-1,3,-1
KR_6761597227,420,-6,-78,-5,-6,0,0,0,3,1,4,-6,6,0,-1,1,0,-2,2,0,0,1,-4,1,-5,4,-3,0,-3,-1,-1,-1,-1,5,-1
KR_6742212626,420,-6,-111,-14,-13,-1,2,1,-6,7,1,5,0,5,-5,7,2,-6,6,0,0,-7,-230,-5,-2,7,1,0,-4,1,-1,-1,-1,5,-1
KR_6743640330,420,-2,-39,-24,-6,0,1,1,0,1,1,1,0,1,-6,6,0,-1,3,2,0,-3,-9,-1,-5,6,0,0,-1,-1,-1,-1,-1,1,-1
KR_6658718631,420,-8,-52,-15,-14,-3,3,0,2,3,5,-3,5,2,-5,6,1,-5,5,0,0,-5,-7,-3,-2,5,-3,0,-2,-1,-1,-1,-1,6,-1
KR_6729996674,420,-5,-51,18,-13,0,3,3,-5,5,0,-4,5,1,-3,4,1,-1,1,0,0,-19,133,2,-8,6,-4,0,1,-1,1,1,-1,5,-1
KR_6608488602,420,-1,-24,3,-6,-2,2,0,-3,4,1,0,2,2,-2,2,0,1,0,1,-1,-11,-24,-7,-3,10,5,0,0,1,1,0,-1,3,-1
KR_6727234603,420,-2,24,-40,-2,2,2,4,0,1,1,-5,5,0,1,3,4,0,1,1,0,-4,7,2,-3,1,-3,0,0,-1,1,0,-1,3,-1
KR_6759838815,440,0,-53,-6,5,0,2,2,1,1,2,6,1,7,0,2,2,-2,2,0,0,12,-8,0,-4,4,0,0,-1,1,1,-1,1,6,-1
KR_6769891347,420,-3,-70,-27,-3,-2,3,1,-1,3,2,5,0,5,-5,8,3,0,0,0,0,-7,0,-1,-3,4,-5,0,0,-1,-1,-1,1,2,-1
KR_6762604546,440,2,-19,9,5,0,0,0,3,0,3,2,0,2,-1,2,1,1,0,1,0,10,0,-4,-4,8,1,0,0,1,1,0,-1,3,-1
KR_6608267039,420,2,-54,9,1,1,1,2,0,2,2,2,0,2,-1,5,4,-1,2,1,0,-3,0,-2,-6,8,-3,0,0,-1,-1,0,1,6,-1
KR_6762269949,420,0,16,-23,-2,-1,1,0,-1,2,1,0,4,4,1,2,3,-1,1,0,0,3,8,-3,-3,6,5,0,2,-1,-1,1,-1,3,-1
KR_6757969533,440,3,-19,23,-1,0,0,0,0,2,2,1,0,1,-1,1,0,-1,2,1,0,-4,-3,-3,-4,7,1,0,1,1,1,1,-1,1,-1
KR_6698440892,420,-4,-36,-9,-16,-5,6,1,-2,3,1,-2,3,1,-8,8,0,1,0,1,-1,-21,-7,-2,-2,4,-4,0,-2,-1,-1,-1,-1,1,-1
KR_6527296144,420,-2,11,-16,-2,0,1,1,3,2,5,1,0,1,-4,5,1,-2,2,0,0,-11,-8,0,-7,7,-6,0,-1,-1,1,-1,-1,1,-1
KR_6698407212,420,-4,-50,-15,-6,4,3,7,1,2,3,-5,6,1,-7,7,0,1,0,1,-2,-9,101,-4,-2,6,-2,0,-1,1,-1,-1,-1,5,-1
KR_6757858953,420,0,33,-11,3,1,0,1,-1,1,0,0,1,1,0,2,2,3,0,3,0,5,1,-2,-5,7,-8,0,0,-1,1,0,1,6,-1
KR_6517153608,420,-2,-38,14,-9,1,2,3,-7,7,0,-4,5,1,-1,2,1,2,0,2,0,-10,-16,3,-6,3,2,0,0,-1,0,0,-1,5,-1
KR_6690877791,420,-4,13,-21,-3,0,4,4,-1,2,1,-3,5,2,-4,5,1,5,0,5,1,2,4,-2,-3,5,-1,0,0,-1,-1,-1,1,6,-1
KR_6770192459,420,-2,-38,7,-4,-10,12,2,0,3,3,3,0,3,3,2,5,0,1,1,0,-8,-1,0,-6,6,-4,0,-2,1,-1,-1,-1,5,-1
KR_6764833036,420,-5,-31,-100,-7,7,0,7,-7,7,0,-3,3,0,0,0,0,-4,4,0,-1,-17,1,1,-2,1,0,0,-1,-1,-1,1,-1,3,-1
KR_6728828182,420,-1,-5,-10,-5,3,3,6,-5,9,4,1,0,1,-3,6,3,-1,1,0,-1,-1,10,1,-5,4,-3,0,-1,0,-1,-1,-1,0,-1
KR_6701644241,420,-2,-14,-12,-7,-1,2,1,-7,8,1,-5,5,0,4,1,5,2,0,2,0,-3,13,-5,-2,7,-6,0,0,-1,-1,0,1,3,-1
KR_6627256859,420,-2,-35,-32,-3,-4,5,1,-1,3,2,3,2,5,0,1,1,-1,1,0,0,0,-3,-2,-3,5,4,0,0,-1,-1,0,-1,3,-1
KR_6763942466,420,-4,-69,-15,-9,0,3,3,-2,5,3,0,3,3,-6,8,2,-1,2,1,0,-3,7,-1,-7,8,1,0,0,-1,1,0,1,5,-1
KR_6767484704,420,-6,-73,7,-20,-2,3,1,-5,5,0,1,2,3,-5,5,0,-9,12,3,0,-17,-35,5,-8,3,10,0,-2,-1,-1,-1,-1,2,-1
KR_6768308783,440,-4,3,0,-2,0,2,2,-1,2,1,1,1,2,-2,2,0,0,1,1,0,-4,-3,5,-7,2,1,0,0,-1,-1,0,1,1,-1
KR_6759636985,420,2,95,21,-3,-1,2,1,0,2,2,-3,7,4,2,0,2,-1,3,2,0,-4,-12,-3,0,3,4,0,2,1,1,1,1,4,-1
KR_6702146447,420,2,65,-19,4,4,1,5,-2,2,0,2,2,4,2,0,2,-2,4,2,0,-3,10,3,-6,3,0,0,2,1,1,1,1,2,-1
KR_6720508321,420,3,64,8,1,2,1,3,0,4,4,3,2,5,-1,1,0,-3,4,1,0,-15,-2,-3,-2,5,1,0,1,1,-1,1,1,5,-1
KR_6548777861,440,0,-25,13,1,3,1,4,-1,3,2,0,1,1,-2,6,4,1,0,1,-1,-1,-4,3,-4,1,1,0,0,-1,-1,0,-1,4,-1
KR_6671290129,420,1,23,0,2,6,0,6,-5,7,2,1,1,2,0,1,1,0,2,2,0,-5,18,8,-9,1,-3,0,1,1,1,1,1,4,-1
KR_6721428083,420,-6,-35,-2,-16,-2,3,1,-6,7,1,-2,7,5,-6,6,0,0,1,1,0,-18,-5,0,-5,5,0,0,-1,-1,-1,-1,-1,5,-1
KR_6763534213,420,-3,-94,-17,-10,0,1,1,0,4,4,2,3,5,-10,11,1,-2,2,0,0,-10,3,-1,-4,5,-3,0,0,-1,-1,-1,-1,1,-1
KR_6542092635,420,-2,-49,28,-7,-2,4,2,-3,4,1,-3,4,1,1,2,3,0,2,2,0,-9,24,-3,-2,5,1,0,-1,1,-1,-1,-1,6,-1
KR_6754486166,420,-2,-52,-33,-5,-4,6,2,3,2,5,-3,4,1,-3,3,0,2,0,2,0,3,-4,-4,-6,10,0,0,0,-1,1,0,-1,3,-1
KR_6769527325,420,3,18,12,-3,0,2,2,-2,6,4,0,0,0,-1,4,3,0,0,0,0,-7,-23,-1,-3,4,-2,0,0,0,-1,-1,-1,0,-1
KR_6681129908,420,-3,-2,4,-15,-3,4,1,-2,3,1,-5,8,3,-4,4,0,-1,1,0,0,-11,6,2,-5,3,2,0,-2,-1,0,1,-1,6,-1
KR_6501083673,440,-1,-5,12,2,-1,3,2,-3,3,0,7,0,7,-1,1,0,0,1,1,0,4,-59,-3,-4,7,2,0,-2,-1,1,-1,-1,6,-1
KR_6728869268,420,-4,-45,-29,-5,0,2,2,-2,6,4,-1,3,2,-3,4,1,1,0,1,0,-1,-7,0,-10,10,-1,0,-1,-1,-1,-1,1,4,-1
KR_6680458669,420,-2,-40,-8,-4,-1,4,3,-2,2,0,1,1,2,-2,3,1,0,2,2,0,-2,0,2,-8,6,3,0,0,-1,-1,0,1,4,-1
KR_6762349309,420,-5,-32,-20,-12,-2,2,0,-3,3,0,-4,4,0,-1,2,1,-2,2,0,0,-13,-7,-1,-4,5,4,0,0,-1,-1,1,-1,5,-1
KR_6740371597,420,0,-49,-12,-3,0,1,1,-3,3,0,-1,2,1,1,0,1,0,0,0,0,-3,-95,1,-2,1,0,0,0,-1,-1,-1,-1,4,-1
KR_6757005435,420,-3,3,-24,-3,-2,3,1,-4,5,1,3,2,5,-1,6,5,1,1,2,0,8,-7,-3,-3,6,-1,0,-2,-1,-1,-1,-1,3,-1
KR_6721861391,420,-8,-122,-71,-20,0,3,3,-3,3,0,-1,3,2,-6,11,5,-10,10,0,-1,-17,24,3,-6,3,-13,0,-2,0,-1,-1,-1,0,-1
KR_6760295315,420,0,-53,24,3,-2,2,0,3,1,4,0,2,2,2,1,3,0,0,0,0,1,-5,-3,-4,7,-5,0,0,1,1,1,1,4,-1
KR_6646408468,420,2,-16,3,6,1,1,2,-1,1,0,3,3,6,1,1,2,2,0,2,0,6,69,-4,-3,7,-28,0,0,-1,1,1,1,1,-1
KR_6634857965,420,1,3,24,2,-2,3,1,0,2,2,8,1,9,-2,3,1,-2,4,2,1,5,-7,0,-5,5,4,0,0,0,1,0,1,0,-1
KR_6770120460,420,-2,-34,4,-5,-2,3,1,-1,4,3,2,1,3,-3,5,2,-1,3,2,0,-8,-2,0,-2,2,-2,0,-1,1,1,-1,1,3,-1
KR_6769595777,440,-2,-47,4,-6,-5,6,1,1,1,2,-4,7,3,1,2,3,1,0,1,0,-3,20,-2,-2,4,-24,0,-1,-1,-1,-1,1,2,-1
KR_6635022670,420,-6,-84,-8,-9,1,0,1,-1,4,3,0,3,3,-8,8,0,-1,2,1,0,-18,-2,0,-8,8,4,0,0,-1,1,1,-1,1,-1
KR_6747458626,420,-6,18,12,-14,-2,5,3,-4,6,2,-2,4,2,-6,6,0,0,1,1,0,-15,-15,-6,-1,7,3,0,0,-1,-1,0,-1,3,-1
KR_6759499763,440,2,-48,-26,10,0,2,2,1,3,4,1,1,2,7,1,8,1,2,3,0,17,-3,5,-8,3,-3,0,-1,1,0,-1,-1,3,-1
KR_6752960879,420,-3,25,-21,-7,-1,1,0,-4,7,3,-4,4,0,3,0,3,-1,1,0,0,-13,15,-5,-3,8,-3,0,-1,-1,-1,-1,1,4,-1
KR_6742439248,440,-2,-29,-6,-2,-2,3,1,-3,5,2,1,1,2,3,0,3,-1,1,0,0,4,11,-1,-5,6,2,0,-1,1,-1,-1,-1,6,-1
KR_6762011158,420,-2,-41,37,-7,2,0,2,1,3,4,-2,3,1,-4,5,1,-4,4,0,0,-2,2,-2,-1,3,1,0,0,-1,0,-1,-1,4,-1
KR_6689517752,420,0,-7,44,2,0,1,1,1,1,2,1,3,4,-1,2,1,1,0,1,0,1,18,0,-7,7,-2,0,0,1,1,0,1,6,-1
KR_6769938861,420,0,40,4,-7,1,0,1,-1,2,1,0,5,5,-6,6,0,-1,2,1,0,-12,-4,-1,-3,4,2,0,0,1,1,1,-1,1,-1
KR_6531765614,420,1,4,14,0,1,1,2,0,4,4,-7,7,0,4,1,5,2,1,3,0,0,7,-4,-3,7,1,0,0,1,-1,1,-1,2,-1
KR_6761448751,420,-2,-32,-29,-4,0,0,0,2,1,3,-2,6,4,-2,4,2,-2,2,0,0,-1,9,4,-11,7,1,0,0,-1,1,0,-1,1,-1
KR_6768592439,420,-1,-23,0,-13,-2,3,1,-5,6,1,-1,4,3,-3,3,0,-2,3,1,0,-20,0,-4,-2,6,-2,0,0,-1,1,0,-1,3,-1
KR_6605362856,420,1,15,3,0,0,2,2,1,2,3,1,1,2,0,3,3,-2,2,0,0,5,43,0,-7,7,-22,0,0,-1,-1,-1,-1,3,-1
KR_6615696167,420,-2,11,-12,-12,-4,4,0,-1,2,1,-3,5,2,-2,2,0,-2,2,0,0,-8,0,-5,-2,7,-3,0,-1,-1,-1,-1,1,2,-1
KR_6699862486,420,-2,-32,-16,4,-1,3,2,-1,4,3,2,4,6,4,1,5,0,1,1,0,3,4,-2,-4,6,0,0,-1,1,-1,-1,-1,5,-1
KR_6718172062,420,-1,8,-4,0,1,1,2,-1,4,3,1,2,3,0,1,1,-1,2,1,0,-1,-32,-4,-6,10,5,0,0,1,-1,0,-1,3,-1
KR_6769893284,420,-3,6,-12,5,5,1,6,2,7,9,-5,6,1,2,1,3,1,1,2,0,-2,-4,2,-5,3,1,0,0,-1,-1,1,-1,4,-1
KR_6720634485,420,0,38,28,0,0,1,1,4,0,4,-2,2,0,-1,3,2,-1,2,1,0,3,-1,3,-10,7,0,0,0,-1,1,0,-1,4,-1
KR_6757333989,420,0,49,0,-6,-1,3,2,-4,7,3,1,2,3,-1,1,0,-1,1,0,0,-12,0,0,-4,4,-3,0,0,1,1,1,1,5,-1
KR_6713340850,420,0,-22,22,-2,-2,4,2,-1,3,2,-5,5,0,3,2,5,3,2,5,-1,3,-24,-4,-2,6,0,0,-1,1,-1,-1,-1,6,-1
KR_6768758107,420,3,-6,24,7,4,1,5,1,4,5,0,4,4,1,3,4,1,2,3,0,7,0,6,-8,2,-3,0,0,-1,1,1,-1,2,-1
KR_6728716798,440,-1,-83,-4,-4,2,0,2,0,2,2,-2,4,2,-4,4,0,0,0,0,-1,-8,-3,2,-7,5,-1,0,-1,-1,1,-1,-1,2,-1
KR_6728474034,420,-1,2,-6,-6,-2,4,2,-2,3,1,0,1,1,-2,3,1,0,1,1,-3,-15,-35,4,-9,5,-1,0,0,-1,1,-1,-1,5,-1
KR_6735227712,420,4,25,26,-1,3,0,3,1,4,5,-1,3,2,-2,3,1,-2,4,2,0,2,5,4,-8,4,7,0,0,-1,1,0,1,1,-1
KR_6504024154,420,-2,-77,-28,-2,0,2,2,0,4,4,-5,5,0,3,3,6,0,0,0,0,-5,-37,0,-5,5,3,0,-1,-1,-1,-1,1,1,-1
KR_6651393561,420,-5,-45,-19,-11,-1,2,1,-6,7,1,-3,4,1,-1,1,0,0,0,0,0,-16,0,-1,-3,4,-1,0,-2,-1,-1,-1,1,1,-1
KR_6741828542,440,3,38,-3,15,11,0,11,-1,2,1,1,3,4,-1,1,0,5,0,5,1,18,14,3,-4,1,2,0,1,0,1,1,1,0,-1
KR_6649929865,420,0,3,4,-1,-1,2,1,1,3,4,3,2,5,-2,4,2,-2,2,0,0,-1,0,5,-9,4,1,0,1,1,1,1,1,1,-1
KR_6590870290,440,-2,-27,-27,-9,0,2,2,0,2,2,-6,9,3,-3,3,0,0,0,0,0,-11,-3,2,-6,4,-1,0,-1,1,-1,-1,-1,4,-1
KR_6768330131,420,-4,-28,-27,-10,-2,5,3,1,2,3,-3,5,2,-4,6,2,-2,2,0,-1,-2,96,-3,-3,6,-3,0,-1,-1,1,1,-1,2,-1
KR_6765618867,420,1,-6,9,4,4,0,4,1,0,1,-1,3,2,0,4,4,0,1,1,0,10,-13,4,-9,5,-2,0,1,1,1,1,1,6,-1
KR_6749563397,420,-1,-69,1,-4,-1,3,2,-1,4,3,-1,2,1,-1,1,0,0,1,1,0,-9,6,3,-7,4,-2,0,0,1,1,0,1,6,-1
KR_6647125322,420,-3,-72,40,-5,-5,5,0,-1,2,1,3,2,5,0,4,4,-2,5,3,0,-8,-18,2,-5,3,0,0,1,1,1,-1,1,1,-1
KR_6694316654,420,-3,-35,9,-8,-1,2,1,-1,4,3,0,1,1,-5,5,0,-1,2,1,0,-15,-6,-6,0,6,6,0,-1,-1,1,-1,1,3,-1
KR_6753052832,420,-4,-15,0,-10,4,0,4,-5,6,1,-4,4,0,-4,5,1,-1,2,1,0,-11,-1,-3,-7,10,5,0,-1,-1,-1,-1,-1,5,-1
KR_6667904822,420,-3,-6,36,-5,0,2,2,-2,5,3,-3,5,2,0,3,3,0,1,1,0,-10,-4,-3,-1,4,1,0,2,-1,1,1,1,6,-1
KR_6716836224,420,-4,-30,-35,-6,0,1,1,1,0,1,-3,3,0,-3,6,3,-1,2,1,0,-9,-13,-5,-1,6,2,0,-1,-1,-1,-1,1,1,-1
KR_6738628020,420,-2,0,-4,-11,-4,4,0,0,1,1,-1,1,0,-7,10,3,1,1,2,-1,-14,-21,-4,-4,8,5,0,-2,-1,1,-1,-1,2,-1
KR_6672052044,420,-5,-46,-8,-7,-2,2,0,-3,6,3,-5,5,0,2,2,4,1,1,2,0,-6,1,-2,-4,6,-3,0,-3,-1,-1,-1,-1,3,-1
KR_6640855235,420,1,-68,-34,1,-2,4,2,4,1,5,0,2,2,0,2,2,-1,2,1,-3,-6,-4,-2,-4,6,3,0,-1,-1,-1,-1,-1,6,-1
KR_6756455155,420,-3,55,-37,-8,1,3,4,-2,5,3,-1,3,2,-6,6,0,0,1,1,0,-12,16,-3,-6,9,-4,0,-1,-1,-1,-1,1,3,-1
KR_6768511608,420,3,21,28,-1,0,3,3,2,3,5,4,2,6,-6,8,2,-1,2,1,0,4,-224,-4,-2,6,5,0,0,1,1,0,-1,1,-1
KR_6712158345,420,-1,43,-25,-1,-1,1,0,-3,4,1,-1,3,2,2,1,3,2,1,3,0,-4,10,3,-4,1,-3,0,1,1,-1,1,1,6,-1
KR_6770697860,420,-2,-85,-27,-1,1,0,1,-5,8,3,1,1,2,3,1,4,-1,1,0,0,-3,-21,0,-3,3,2,0,0,-1,1,-1,-1,2,-1
KR_6740235125,420,-6,-63,-58,-20,-1,2,1,-5,5,0,-2,4,2,-6,6,0,-6,6,0,0,-11,-32,5,-7,2,3,0,-4,1,-1,-1,-1,3,-1
KR_6723908671,420,-5,-67,-21,-6,-3,4,1,2,0,2,-5,6,1,-1,3,2,1,1,2,0,0,-21,-3,-2,5,0,0,-2,-1,-1,-1,-1,5,-1
KR_6768450425,420,-3,-90,27,-9,0,1,1,-2,2,0,-1,2,1,-7,7,0,1,1,2,-1,-16,-2,-2,-6,8,-4,0,-1,-1,-1,-1,-1,1,-1
KR_6768898399,420,-4,-59,-16,-9,3,1,4,-3,5,2,0,1,1,-7,9,2,-2,2,0,0,-11,2,1,-6,5,-1,0,-1,-1,1,-1,-1,3,-1
KR_6753170469,420,-6,-9,8,-13,-3,4,1,-4,5,1,1,4,5,-5,8,3,-2,3,1,0,-18,-26,-2,-1,3,-2,0,0,-1,1,0,1,2,-1
KR_6759031104,420,0,-16,32,3,3,2,5,0,2,2,0,0,0,0,3,3,0,1,1,0,3,1,-1,-7,8,0,0,0,-1,1,0,-1,5,-1
KR_6770357957,440,-2,-38,-20,-5,0,2,2,0,1,1,-1,2,1,-5,6,1,1,0,1,0,-4,8,0,-4,4,-3,0,0,1,-1,-1,1,2,-1
KR_6738580457,420,-1,-7,-4,1,-7,8,1,3,2,5,5,3,8,-1,3,2,1,2,3,0,10,-2,7,-9,2,3,0,-2,1,-1,-1,1,3,-1
KR_6769456942,420,-5,-69,1,-8,2,2,4,-2,3,1,-2,2,0,-4,4,0,-2,2,0,0,-12,4,4,-7,3,-1,0,-3,1,-1,-1,-1,3,-1
KR_6763947172,420,0,-57,9,-4,0,1,1,0,2,2,3,1,4,-6,6,0,-1,1,0,0,-8,134,6,-9,3,-6,0,-1,-1,0,-1,-1,3,-1
KR_6750097451,420,-8,-94,-10,-17,-5,6,1,-5,6,1,3,0,3,-8,9,1,-2,2,0,-1,-20,-5,0,-2,2,1,0,-4,-1,-1,-1,-1,1,-1
KR_6724924061,440,-2,16,-7,-3,-2,2,0,-1,4,3,1,2,3,-1,1,0,0,1,1,0,-5,4,0,-4,4,0,0,1,0,1,1,1,0,-1
KR_6685442644,420,1,44,-13,2,-1,1,0,-4,6,2,-1,3,2,6,0,6,2,0,2,1,6,12,-1,-6,7,3,0,1,1,-1,1,1,5,-1
KR_6691012896,420,-1,-56,-9,0,-2,4,2,-1,5,4,4,5,9,0,3,3,-1,3,2,0,-2,-2,3,-7,4,-1,0,-1,0,-1,-1,1,0,-1
KR_6503956655,420,-2,-5,-32,-9,-2,3,1,2,5,7,1,1,2,-8,10,2,-2,3,1,0,-9,3,0,-5,5,0,0,0,-1,1,1,-1,3,-1
KR_6750846450,420,-2,-11,-18,-2,-1,1,0,0,5,5,0,3,3,-1,1,0,0,1,1,0,-4,2,0,-3,3,1,0,0,-1,0,1,1,1,-1
KR_6708439474,420,-4,-23,9,-14,-1,2,1,-2,3,1,-3,6,3,-6,7,1,-2,4,2,0,-10,-2,-4,-3,7,0,0,-2,-1,-1,-1,-1,5,-1
KR_6615639313,420,-1,40,21,-5,1,1,2,3,2,5,-3,5,2,-5,7,2,-1,1,0,0,-8,-3,-1,-9,10,5,0,0,-1,-1,0,1,1,-1
KR_6630339422,420,-6,-40,-35,-6,-1,1,0,-3,4,1,-3,3,0,2,4,6,-1,2,1,1,-1,3,-1,-5,6,4,0,-2,-1,-1,-1,1,6,-1
KR_6751381406,440,-2,-43,-40,0,3,0,3,-1,3,2,-2,3,1,-1,2,1,1,0,1,0,0,-10,3,-11,8,-1,0,-2,1,-1,-1,-1,4,-1
KR_6764476750,420,2,-48,8,4,-1,1,0,1,2,3,-2,2,0,-1,2,1,7,1,8,0,6,-2,-1,-2,3,7,0,0,-1,-1,-1,-1,6,-1
KR_6757203239,420,-3,-85,39,-11,-6,6,0,-6,7,1,5,2,7,-2,2,0,-2,3,1,-2,-6,-9,-4,-2,6,-2,0,-2,-1,-1,-1,-1,5,-1
KR_6768461717,420,-6,-25,-23,-14,-4,4,0,-3,5,2,-2,4,2,-3,8,5,-2,3,1,0,-3,-4,3,-7,4,-5,0,-1,-1,-1,-1,-1,6,-1
KR_6657447204,420,-2,-4,-16,-7,-4,5,1,-3,5,2,-2,7,5,1,5,6,1,0,1,0,-12,-2,-1,-3,4,3,0,-1,-1,-1,-1,-1,4,-1
KR_6724125730,420,-5,-100,-20,-10,2,0,2,-9,10,1,-2,2,0,-2,3,1,1,0,1,0,-14,23,-2,-3,5,-10,0,0,-1,-1,-1,-1,4,-1
KR_6676035250,440,-6,-125,-41,-14,-7,7,0,-2,3,1,0,2,2,-5,6,1,0,0,0,-1,-18,30,4,-7,3,-3,0,-3,-1,-1,-1,-1,2,-1
KR_6739553563,420,-3,-60,-22,-2,-3,4,1,-2,3,1,0,1,1,2,0,2,1,0,1,0,5,123,5,-9,4,6,0,0,1,-1,-1,-1,2,-1
KR_6647308966,420,-1,-31,-4,-7,0,1,1,0,3,3,-1,1,0,-7,7,0,1,0,1,0,-8,5,2,-5,3,-4,0,0,-1,1,0,1,6,-1
KR_6758912966,440,-1,1,20,1,1,1,2,-3,5,2,2,2,4,2,3,5,-1,2,1,0,-3,-5,-6,-5,11,2,0,0,1,1,0,-1,3,-1
KR_6769122808,420,1,-26,4,3,0,1,1,2,1,3,-1,4,3,2,1,3,0,2,2,-1,4,-23,-3,-6,9,-2,0,1,-1,1,1,-1,6,-1
KR_6720832822,420,0,32,36,-3,0,1,1,0,3,3,-3,6,3,-2,3,1,2,0,2,-1,-2,6,0,-5,5,2,0,0,1,-1,0,-1,5,-1
KR_6729503730,420,-2,13,-20,0,1,1,2,1,2,3,-4,5,1,2,3,5,0,2,2,1,0,5,5,-10,5,2,0,0,-1,1,-1,1,2,-1
KR_6750335956,420,0,-17,0,-3,-3,3,0,2,1,3,-1,3,2,1,5,6,-2,3,1,0,-3,8,-2,-1,3,3,0,-1,1,0,-1,-1,1,-1
KR_6770470272,420,-2,54,-27,-1,-2,2,0,2,3,5,3,0,3,-4,4,0,0,0,0,0,0,-7,1,-3,2,-3,0,1,-1,1,1,1,6,-1
KR_6737804721,440,-3,-46,15,-3,4,5,9,-4,5,1,-3,4,1,-5,6,1,5,1,6,4,14,-10,2,-4,2,-1,0,-1,-1,-1,-1,1,2,-1
KR_6704989925,420,0,-1,12,0,4,0,4,-2,6,4,-3,6,3,-1,5,4,2,0,2,-1,-9,-9,0,-6,6,4,0,0,0,1,0,-1,0,-1
KR_6685308213,420,-3,-21,-44,-6,-3,3,0,0,0,0,-2,2,0,0,6,6,-1,1,0,0,-4,-5,-2,-7,9,1,0,-1,-1,-1,-1,-1,2,-1
KR_6718390284,420,-3,-27,-38,-10,1,2,3,-4,5,1,-3,4,1,-3,4,1,-1,2,1,-1,-8,-8,-4,-4,8,3,0,-2,-1,-1,-1,-1,4,-1
KR_6752960094,420,-4,-75,-24,-5,-6,6,0,-1,1,0,-4,5,1,2,1,3,4,0,4,0,2,-4,1,-6,5,-4,0,-1,1,1,-1,1,2,-1
KR_6758458147,420,-1,-17,-21,2,1,3,4,2,2,4,4,1,5,-4,7,3,-1,2,1,2,-3,-20,3,-8,5,0,0,-1,1,1,-1,-1,2,-1
KR_6741330930,420,-8,-73,-17,-19,-9,9,0,1,2,3,-4,6,2,-3,4,1,-4,6,2,0,-7,1,-2,-2,4,2,0,-2,1,-1,-1,1,1,-1
KR_6742237541,420,0,7,-23,-2,0,1,1,-3,7,4,-1,4,3,2,2,4,0,1,1,-4,-12,-5,-6,-3,9,0,0,0,1,-1,0,-1,6,-1
KR_6729656564,420,-1,-57,-4,-5,-1,1,0,-5,7,2,0,1,1,1,1,2,0,0,0,0,-2,1,1,-5,4,-6,0,-1,-1,-1,-1,1,3,-1
KR_6671500810,420,-2,-23,12,-5,-3,3,0,-1,1,0,-1,4,3,0,2,2,0,1,1,0,-2,-4,2,-8,6,5,0,0,1,1,0,-1,5,-1
KR_6770499492,420,-2,-22,-2,-3,-1,3,2,-4,5,1,-2,4,2,3,2,5,1,1,2,0,-2,6,3,-4,1,0,0,0,-1,1,1,1,1,-1
KR_6747797962,420,-2,-105,12,-7,-3,3,0,1,2,3,0,2,2,-6,6,0,1,0,1,0,-7,-61,-1,-7,8,19,0,-2,1,-1,-1,1,1,-1
KR_6762812817,440,0,-30,-15,1,-1,3,2,6,1,7,0,3,3,-1,2,1,-3,4,1,0,0,-6,-3,-2,5,-2,0,0,-1,0,0,1,2,-1
KR_6668713329,420,-5,-95,-5,-14,-11,12,1,2,2,4,-3,4,1,-3,4,1,1,0,1,-2,-4,0,5,-7,2,-2,0,-4,-1,-1,-1,-1,2,-1
KR_6650636768,420,-1,42,-45,3,-1,2,1,6,1,7,-1,2,1,0,2,2,-1,2,1,0,8,2,3,-3,0,-1,0,0,-1,-1,-1,-1,6,-1
KR_6761568450,420,3,85,8,2,1,3,4,1,3,4,-3,4,1,5,0,5,-2,2,0,0,0,-1,-7,-4,11,2,0,3,1,1,1,1,2,-1
KR_6770021937,440,-4,-2,8,-11,-8,13,5,1,2,3,-2,3,1,1,1,2,-3,4,1,-2,-18,-3,-2,-3,5,3,0,0,-1,1,0,-1,6,-1
KR_6697922012,420,-2,-23,-11,-9,0,2,2,-1,2,1,-6,7,1,-3,4,1,1,0,1,0,-8,-4,2,-4,2,-1,0,-1,-1,-1,-1,-1,2,-1
KR_6762585618,420,1,-8,4,3,-4,4,0,2,0,2,2,1,3,-1,2,1,4,0,4,0,2,-5,0,-3,3,6,0,0,1,-1,0,-1,4,-1
KR_6741730515,420,-2,-1,-4,1,3,1,4,-2,6,4,-2,3,1,0,2,2,2,1,3,0,-11,-4,3,-9,6,2,0,0,0,1,0,1,0,-1
KR_6743187632,420,0,-63,8,3,3,0,3,2,0,2,1,0,1,-3,3,0,0,0,0,0,1,-1,3,-7,4,-2,0,1,-1,1,1,1,3,-1
KR_6755343213,440,-4,0,-36,-6,0,1,1,-2,3,1,-4,4,0,-1,5,4,1,1,2,0,-1,8,1,-3,2,-2,0,-2,-1,-1,-1,-1,1,-1
KR_6766230477,420,-2,29,-28,0,0,2,2,0,2,2,-2,3,1,1,2,3,1,1,2,1,1,-4,-1,-6,7,4,0,1,-1,1,1,1,4,-1
KR_6673418436,420,0,-30,1,4,1,1,2,2,3,5,4,0,4,-2,2,0,-1,3,2,-1,0,29,-1,-3,4,-1,0,0,0,0,-1,-1,0,-1
KR_6739034245,420,0,37,17,5,-1,3,2,8,0,8,0,3,3,-2,4,2,0,0,0,0,-2,-15,6,-9,3,-4,0,-1,-1,-1,-1,1,1,-1
KR_6684713256,420,1,-1,1,1,5,1,6,-2,5,3,-5,5,0,1,1,2,2,0,2,0,2,113,-2,-5,7,7,0,0,1,-1,1,1,5,-1
KR_6624477885,420,-2,-24,-12,2,1,2,3,1,0,1,0,1,1,0,2,2,0,0,0,0,2,2,4,-7,3,-5,0,-2,1,-1,-1,1,6,-1
KR_6732027047,420,-6,-5,-40,-10,1,1,2,-1,1,0,-5,5,0,-5,7,2,0,0,0,0,-13,-6,-4,-2,6,0,0,-2,-1,-1,-1,1,1,-1
KR_6731427033,420,-2,11,-20,-3,-10,11,1,2,1,3,3,1,4,2,2,4,0,1,1,0,8,-1,2,-6,4,4,0,0,-1,1,-1,1,2,-1
KR_6770037595,440,0,-46,6,-4,-3,4,1,5,3,8,4,2,6,-4,5,1,-6,7,1,-1,-6,8,6,-8,2,-9,0,1,1,1,1,-1,6,-1
KR_6714766140,420,-6,-31,-15,-14,-2,3,1,-2,2,0,-5,7,2,-1,4,3,-4,4,0,0,-10,2,4,-6,2,-1,0,-2,1,1,-1,1,5,-1
KR_6646474717,440,-1,-60,110,0,0,2,2,2,0,2,0,4,4,-1,1,0,-1,4,3,0,-3,-3,-1,-3,4,2,0,-1,1,-1,-1,1,3,-1
KR_6566959415,420,-4,-70,8,-6,0,3,3,2,2,4,-9,9,0,0,3,3,1,1,2,0,-1,-23,-3,-5,8,-7,0,0,-1,-1,-1,-1,2,-1
KR_6760332085,420,-1,-45,9,6,3,3,6,7,0,7,-1,6,5,-2,3,1,-1,2,1,0,13,3,2,-5,3,-3,0,0,0,1,-1,1,0,-1
KR_6747335438,420,0,-2,-20,2,1,1,2,-2,4,2,5,0,5,-1,2,1,-1,1,0,0,2,3,2,-6,4,-3,0,-1,-1,1,-1,1,5,-1
KR_6751056525,420,-5,-110,-8,-16,-4,5,1,-7,10,3,-4,6,2,-1,4,3,0,1,1,-2,-14,0,-1,-4,5,-2,0,-1,1,-1,-1,-1,4,-1
KR_6769862886,420,-5,-60,-9,-6,-2,5,3,1,5,6,-10,11,1,4,2,6,1,0,1,1,-6,-46,-2,-4,6,17,0,-3,-1,-1,-1,1,2,-1
KR_6760436800,420,-2,-16,32,1,-1,1,0,-2,3,1,2,0,2,0,4,4,2,2,4,0,1,3,1,-5,4,-2,0,-1,1,-1,-1,1,1,-1
KR_6749538768,420,1,-32,32,0,-1,2,1,2,2,4,1,3,4,0,2,2,-2,4,2,0,-1,-9,-3,-4,7,2,0,0,-1,1,0,-1,2,-1
KR_6760548064,420,-2,-76,-8,-7,-3,3,0,-4,5,1,-1,2,1,0,2,2,1,0,1,0,-2,33,-7,0,7,-4,0,-2,1,-1,-1,-1,1,-1
KR_6769681692,420,0,-5,13,0,0,1,1,0,2,2,2,2,4,-1,1,0,-1,2,1,0,-2,-424,2,-5,3,0,0,1,-1,1,1,-1,3,-1
KR_6756723602,420,-1,-51,24,-2,2,0,2,-2,2,0,3,1,4,-5,7,2,0,2,2,0,-4,3,-1,-5,6,-2,0,0,-1,-1,-1,-1,2,-1
KR_6275829356,420,-1,22,15,-4,-1,1,0,-1,4,3,0,1,1,-2,2,0,0,0,0,0,-3,-17,1,-6,5,1,0,1,1,1,1,-1,2,-1
KR_6770495165,420,1,13,-8,-1,-2,2,0,0,5,5,-2,3,1,2,1,3,1,1,2,0,1,-3,-2,-2,4,3,0,-1,1,-1,-1,-1,5,-1
KR_6692957129,440,-2,-8,-16,-6,-5,5,0,-1,2,1,0,2,2,2,4,6,-2,3,1,0,-6,-2,-1,-7,8,0,0,-1,-1,-1,-1,-1,1,-1
KR_6746245922,440,-2,-58,20,-9,1,0,1,-3,4,1,-3,3,0,1,1,2,-5,6,1,0,-13,-9,-2,-3,5,1,0,-1,-1,-1,-1,-1,5,-1
KR_6731598003,420,1,55,8,3,-1,1,0,-2,3,1,1,2,3,5,1,6,0,0,0,0,2,29,-2,-1,3,-3,0,1,-1,-1,1,1,4,-1
KR_6758228002,420,1,-14,-14,2,-4,4,0,2,1,3,-1,3,2,2,4,6,3,1,4,0,10,5,5,-9,4,5,0,0,1,-1,0,1,1,-1
KR_6765226912,420,-4,-63,11,-14,-8,8,0,-2,5,3,-1,4,3,-5,5,0,2,2,4,0,-14,5,3,-11,8,-1,0,0,-1,1,-1,-1,6,-1
KR_6751741529,420,-2,-59,10,-1,-1,2,1,-1,1,0,0,2,2,0,2,2,1,1,2,0,0,5,0,-6,6,-1,0,0,-1,1,0,-1,3,-1
KR_6726200445,420,-6,-54,-55,-9,-3,3,0,-4,5,1,-1,2,1,-1,2,1,0,0,0,0,-7,9,-1,-3,4,-5,0,-1,-1,1,-1,-1,2,-1
KR_6728536808,420,-1,-58,-33,-7,0,2,2,0,1,1,1,3,4,-3,3,0,-5,6,1,-1,-11,-20,-2,-2,4,-4,0,-1,0,-1,-1,-1,0,-1
KR_6757503063,420,-3,-2,-45,-6,-2,4,2,1,5,6,-2,3,1,-3,5,2,0,1,1,0,-3,358,-2,-5,7,-3,0,0,-1,1,0,-1,6,-1
KR_6719564974,440,-2,26,-28,-1,-6,6,0,1,0,1,2,1,3,2,0,2,0,0,0,0,3,6,3,-9,6,5,0,-1,-1,-1,-1,1,6,-1
KR_6744533249,420,1,-28,-1,1,-2,3,1,1,1,2,0,5,5,1,0,1,1,1,2,0,8,-4,3,-5,2,5,0,-1,1,-1,-1,-1,1,-1
KR_6757821404,420,0,27,-2,-4,1,2,3,-3,4,1,0,2,2,-1,3,2,-1,1,0,0,-8,-1,-3,-3,6,-3,0,0,-1,1,1,-1,2,-1
KR_6705054250,440,-5,-65,-15,-15,-1,2,1,-2,2,0,-4,4,0,-7,9,2,-1,2,1,0,-14,2,2,-4,2,0,0,-1,-1,-1,-1,-1,1,-1
KR_6765718241,420,-1,-24,13,-1,0,3,3,1,3,4,-1,3,2,-2,5,3,1,1,2,0,1,110,0,-4,4,-2,0,0,-1,1,0,1,2,-1
KR_6711330704,420,-3,-17,23,-6,0,0,0,2,0,2,-2,3,1,-5,6,1,-1,1,0,0,-3,-1,-3,-4,7,1,0,0,-1,-1,0,-1,2,-1
KR_6738079072,420,-1,-4,32,-1,0,3,3,-2,3,1,0,2,2,-1,3,2,2,0,2,0,-5,-1,1,-5,4,1,0,1,1,-1,-1,1,6,-1
KR_6731300583,420,0,12,-20,2,-3,4,1,-3,6,3,2,0,2,8,1,9,-2,2,0,0,8,-5,-2,-4,6,7,0,-1,-1,-1,-1,-1,1,-1
KR_6583447173,420,0,-14,-2,2,-3,5,2,7,0,7,1,6,7,1,2,3,-4,4,0,1,5,-11,-5,0,5,1,0,0,1,-1,0,1,2,-1
KR_6713164065,420,-3,-27,-10,-8,-2,2,0,0,3,3,-1,1,0,-2,6,4,-3,4,1,0,-3,-4,-2,-2,4,-1,0,0,0,-1,0,-1,0,-1
KR_6761083221,420,-2,17,-25,-6,0,2,2,-2,6,4,-6,6,0,0,1,1,2,2,4,0,-4,-10,-2,-4,6,0,0,-1,0,1,-1,-1,0,-1
KR_6701600900,420,-3,2,-32,-4,-3,4,1,-1,2,1,-5,5,0,5,0,5,0,0,0,0,-1,5,4,-6,2,-1,0,0,1,-1,0,-1,5,-1
KR_6771027826,420,-3,7,-4,-17,-5,7,2,-1,5,4,-3,3,0,0,3,3,-8,8,0,-1,-18,-16,3,-7,4,2,0,1,-1,1,1,-1,5,-1
KR_6724259349,420,-3,-26,16,-9,0,2,2,1,2,3,0,2,2,-9,9,0,-1,2,1,0,-8,1,-2,-3,5,-3,0,0,-1,1,-1,-1,1,-1
KR_6766692146,440,-2,9,-27,-4,0,3,3,1,2,3,-2,4,2,-1,3,2,-2,2,0,0,-1,20,-4,-5,9,-3,0,0,-1,1,-1,-1,1,-1
KR_6670714903,420,-3,-53,-7,-9,-3,3,0,-4,5,1,-1,2,1,-2,4,2,1,2,3,0,-10,-4,1,-6,5,3,0,-1,-1,-1,-1,-1,4,-1
KR_6748828189,420,-1,20,9,-4,0,0,0,-2,4,2,-1,4,3,-1,5,4,0,2,2,0,-8,5,-2,-6,8,-3,0,1,-1,1,1,-1,2,-1
KR_6767741626,420,2,0,4,6,-1,3,2,2,0,2,1,1,2,5,1,6,-1,1,0,0,12,4,1,-4,3,-2,0,0,1,-1,1,1,2,-1
KR_6755407225,440,1,-27,0,0,0,2,2,0,2,2,-2,3,1,3,1,4,-1,1,0,0,-1,13,-1,-2,3,1,0,0,-1,1,1,1,3,-1
KR_6763538509,440,-2,11,-5,-5,0,3,3,2,2,4,-5,6,1,-1,2,1,-1,3,2,0,1,-111,0,-7,7,-2,0,0,1,-1,0,1,6,-1
KR_6730187268,420,3,-28,9,4,2,0,2,0,3,3,3,0,3,-1,3,2,0,0,0,0,6,-5,3,-4,1,2,0,0,-1,-1,0,-1,3,-1
KR_6768818795,420,-2,-80,16,-4,1,2,3,-5,5,0,-4,4,0,4,0,4,0,2,2,0,-6,-24,-4,-3,7,-2,0,0,-1,1,1,1,2,-1
KR_6526223725,420,-2,-21,-24,-6,-3,4,1,-3,4,1,1,4,5,1,0,1,-2,2,0,0,-11,-9,-1,-6,7,3,0,-1,-1,-1,-1,1,3,-1
KR_6730836021,420,-1,-20,-8,-4,-3,4,1,3,2,5,-3,4,1,0,2,2,-1,2,1,0,-6,11,2,-4,2,-3,0,-1,1,-1,-1,-1,4,-1
KR_6770300677,440,-1,-3,-8,-9,2,0,2,2,0,2,-4,4,0,-11,12,1,2,0,2,0,-10,-14,0,-3,3,-1,0,0,-1,1,1,1,2,-1
KR_6769050129,420,-1,-56,-5,-6,2,1,3,-1,3,2,-5,7,2,-2,3,1,0,2,2,0,-8,-2,-2,-2,4,2,0,0,-1,1,-1,1,2,-1
KR_6720960952,420,0,-51,12,3,2,1,3,1,4,5,1,1,2,-1,4,3,0,1,1,0,10,-21,-1,-7,8,2,0,1,-1,-1,-1,1,1,-1
KR_6766844399,420,0,-34,22,-2,4,0,4,0,3,3,1,3,4,-6,7,1,-1,2,1,0,-2,-269,-5,-2,7,3,0,-2,1,-1,-1,1,1,-1
KR_6745807749,420,0,52,2,-2,2,3,5,4,1,5,-3,5,2,-2,5,3,-3,5,2,2,3,20,-2,-4,6,1,0,0,1,-1,-1,1,4,-1
KR_6307046143,420,1,5,-8,1,1,2,3,-3,4,1,2,2,4,0,0,0,1,0,1,0,-7,-5,0,-6,6,-2,0,0,-1,-1,0,-1,6,-1
KR_6746461381,420,-3,-39,-39,-4,-2,3,1,1,0,1,-2,2,0,-1,4,3,0,0,0,0,-1,-6,2,-2,0,3,0,-1,-1,-1,-1,1,1,-1
KR_6719477469,420,-1,-49,24,1,-4,5,1,1,2,3,-2,3,1,1,1,2,5,1,6,0,8,-3,-2,-5,7,1,0,-1,1,-1,-1,-1,1,-1
KR_6763741991,420,-6,-55,0,-13,3,1,4,-1,4,3,-5,5,0,-12,12,0,2,1,3,0,-19,3,0,-2,2,-3,0,1,-1,1,1,1,4,-1
KR_6744225471,420,-2,-9,-39,-6,-4,4,0,-7,9,2,-1,2,1,3,2,5,3,2,5,0,-5,24,-2,-9,11,-1,0,0,-1,-1,-1,-1,4,-1
KR_6605603423,420,0,-6,24,5,0,0,0,5,1,6,0,3,3,-2,4,2,2,0,2,0,2,14,3,-9,6,-7,0,0,1,-1,0,1,6,-1
KR_6765983091,420,-4,-18,2,-9,-2,4,2,-1,3,2,0,2,2,-6,7,1,0,0,0,0,-10,-3,-1,-6,7,1,0,-2,-1,-1,-1,-1,5,-1
KR_6756741410,420,-1,-18,-20,-5,-3,4,1,0,3,3,2,1,3,-4,4,0,0,2,2,1,-2,104,1,-5,4,-5,0,0,-1,0,1,1,5,-1
KR_6744154953,420,-6,-118,12,-2,2,2,4,-1,1,0,2,2,4,-5,5,0,0,2,2,0,1,-3,2,-6,4,-5,0,-2,-1,-1,-1,-1,5,-1
KR_6627532696,420,-3,-4,-43,-9,0,3,3,-6,6,0,0,4,4,-3,4,1,0,1,1,1,-5,-13,-4,-8,12,4,0,-1,-1,-1,-1,1,2,-1
KR_6728932666,420,-2,-37,-5,-4,0,2,2,-3,5,2,-2,3,1,0,1,1,1,0,1,-1,-2,-44,-2,-6,8,1,0,-1,1,-1,-1,-1,3,-1
KR_6770188704,420,-4,-43,-20,-2,2,1,3,-2,5,3,-2,4,2,3,2,5,-3,3,0,4,-2,-30,-7,-4,11,-5,0,0,0,-1,-1,-1,0,-1
KR_6754442735,420,-4,-74,-16,-6,0,2,2,-6,7,1,-2,3,1,3,3,6,-1,2,1,1,-4,-3,-3,-3,6,-1,0,-1,-1,-1,-1,1,4,-1
KR_6626416246,440,-3,-7,-17,-9,-1,3,2,-6,7,1,-3,4,1,1,4,5,0,1,1,-1,0,0,-1,-9,10,4,0,-1,1,-1,-1,-1,1,-1
KR_6625895811,420,-3,-4,-30,-6,0,1,1,-1,3,2,1,0,1,0,1,1,-6,6,0,1,0,1,4,-10,6,-8,0,-3,-1,-1,-1,-1,1,-1
KR_6620072528,420,-1,2,-28,1,1,3,4,1,2,3,-3,3,0,1,1,2,1,0,1,0,7,-6,-2,-4,6,-1,0,-1,1,-1,-1,1,3,-1
KR_6716421384,420,-2,-85,-29,-8,-4,5,1,-8,9,1,1,0,1,1,0,1,2,0,2,0,-2,-12,-3,-8,11,-3,0,-2,1,-1,-1,-1,2,-1
KR_6735306546,440,-3,-60,-1,-10,-1,2,1,0,3,3,0,4,4,-7,11,4,-2,2,0,0,-3,-258,-1,-2,3,-5,0,-1,-1,-1,-1,1,5,-1
KR_6768231584,420,0,9,-1,0,1,2,3,3,1,4,0,2,2,-3,3,0,-1,1,0,0,-6,6,-1,-2,3,-2,0,1,-1,1,-1,1,5,-1
KR_6620162329,420,-1,-22,-36,0,0,2,2,-1,3,2,0,1,1,0,3,3,1,0,1,0,0,0,-1,-7,8,0,0,0,1,-1,-1,1,5,-1
KR_6757551899,420,-2,-10,4,-1,1,0,1,-2,5,3,0,1,1,1,2,3,-1,3,2,0,-7,12,0,-2,2,-4,0,1,-1,1,1,1,2,-1
KR_6768787625,420,3,51,10,2,2,0,2,2,0,2,-2,2,0,-1,3,2,1,1,2,0,-2,2,-1,-6,7,2,0,0,1,1,1,1,3,-1
KR_6720379332,420,1,78,28,3,4,1,5,0,2,2,2,2,4,-2,2,0,-1,1,0,1,1,-8,-1,-3,4,1,0,1,1,1,1,1,1,-1
KR_6653516852,420,-2,-64,-11,3,6,0,6,-2,3,1,-3,5,2,3,1,4,-1,1,0,0,2,0,-1,-7,8,-1,0,0,-1,1,1,1,5,-1
KR_6756645323,420,-3,-6,-4,-4,-3,3,0,-4,7,3,-1,2,1,3,1,4,1,0,1,0,-7,-27,-1,-6,7,2,0,0,-1,1,0,-1,6,-1
KR_6699089939,420,-5,-50,-33,-4,3,1,4,-2,5,3,-3,4,1,0,3,3,-2,2,0,0,-4,209,2,-5,3,14,0,0,0,-1,1,1,0,-1
KR_6502291836,420,-4,-56,-16,-15,-2,2,0,-7,10,3,-3,3,0,-3,4,1,0,0,0,-1,-11,-6,-3,-2,5,-2,0,-2,-1,1,-1,-1,6,-1
KR_6756151416,420,3,77,12,7,4,1,5,2,3,5,-1,2,1,5,2,7,-3,4,1,0,4,5,-4,-3,7,4,0,0,-1,-1,-1,-1,6,-1
KR_6767816632,420,-4,93,-24,-8,-3,4,1,-7,7,0,2,4,6,0,4,4,0,0,0,0,-6,22,-3,-4,7,-24,0,1,-1,1,1,-1,1,-1
KR_6749044129,420,-3,-51,-6,-8,1,1,2,0,0,0,-3,3,0,-5,6,1,-1,2,1,0,-7,-14,2,-4,2,-5,0,-2,-1,-1,-1,1,4,-1
KR_6766141847,440,-2,17,-18,5,3,2,5,4,1,5,1,1,2,-3,4,1,0,2,2,0,5,-6,-6,-5,11,7,0,-1,-1,-1,-1,1,1,-1
KR_6598174992,420,-4,-64,-20,-6,0,1,1,-3,4,1,-4,7,3,-1,3,2,2,0,2,0,-9,-11,-5,-5,10,4,0,-1,1,1,-1,1,5,-1
KR_6757851000,420,-4,-6,12,-11,-1,3,2,3,1,4,-8,8,0,-5,7,2,0,0,0,1,-7,-20,-4,-5,9,5,0,-2,-1,1,-1,-1,5,-1
KR_6763296808,440,-6,-68,-35,-11,-3,3,0,1,0,1,1,0,1,1,1,2,-11,13,2,-1,-5,8,-6,-2,8,6,0,-1,-1,-1,-1,-1,2,-1
KR_6642240430,420,-1,-88,-4,0,-1,2,1,0,2,2,1,1,2,1,3,4,-1,1,0,0,4,-2,2,-4,2,-4,0,0,-1,-1,-1,-1,2,-1
KR_6601216849,420,-1,9,24,-7,-1,3,2,-3,7,4,-2,2,0,0,4,4,-1,1,0,-2,-2,-169,1,-5,4,-5,0,1,-1,1,1,-1,1,-1
KR_6761613874,440,1,-24,4,-7,0,2,2,-1,3,2,-1,2,1,-5,6,1,0,2,2,0,-12,211,1,-5,4,1,0,-1,-1,1,-1,1,4,-1
KR_6717007074,420,-3,-31,-16,-7,-4,5,1,0,1,1,-2,3,1,-2,4,2,1,1,2,0,-4,2,-2,-4,6,-3,0,-2,1,-1,-1,-1,6,-1
KR_6768319495,420,-3,72,0,-5,5,0,5,-3,4,1,-6,8,2,-1,4,3,0,1,1,0,-7,-114,0,-3,3,-3,0,0,-1,1,1,1,4,-1
KR_6660971460,420,1,38,34,2,3,1,4,-8,11,3,6,0,6,0,2,2,1,1,2,0,1,19,-2,-1,3,2,0,2,-1,1,1,-1,4,-1
KR_6714807015,420,-3,-23,24,-5,0,1,1,-6,6,0,-2,4,2,2,3,5,1,0,1,0,-8,-5,3,-7,4,-3,0,0,-1,0,0,-1,4,-1
KR_6719208025,440,-3,-16,26,-4,2,1,3,-2,5,3,5,2,7,-6,6,0,-3,4,1,0,-7,-6,12,-14,2,-1,0,-1,-1,1,-1,1,3,-1
KR_6730225650,420,-2,-74,-3,-6,-2,3,1,0,4,4,-1,3,2,-2,2,0,-1,2,1,2,-3,-267,2,-4,2,1,0,-1,-1,-1,-1,1,4,-1
KR_6744944444,440,-2,4,-23,-2,4,0,4,-1,5,4,0,1,1,-4,7,3,-1,2,1,0,-6,1,0,-4,4,-2,0,0,-1,1,-1,1,5,-1
KR_6768499827,420,-1,33,-4,-15,4,0,4,-7,8,1,-6,6,0,-6,7,1,0,0,0,-4,-25,-13,-6,-1,7,1,0,1,-1,1,1,-1,6,-1
KR_6759692987,440,-2,19,4,-3,-2,2,0,-1,1,0,4,2,6,0,0,0,-4,5,1,0,6,-10,-3,-9,12,2,0,-1,-1,-1,-1,-1,5,-1
KR_6528209134,440,-4,-4,12,-7,-3,5,2,3,1,4,-2,3,1,-4,5,1,-1,1,0,1,-8,-5,-1,-5,6,1,0,0,-1,-1,-1,1,5,-1
KR_6740015687,420,-7,-76,-32,-4,0,1,1,-5,6,1,3,0,3,-1,3,2,-1,1,0,0,-6,21,3,-5,2,-2,0,0,1,-1,-1,-1,4,-1
KR_6739985315,420,1,18,6,5,7,1,8,1,1,2,-1,1,0,-2,6,4,0,2,2,-1,3,8,-1,-4,5,-2,0,-1,-1,1,-1,-1,2,-1
KR_6766484423,420,0,-2,4,1,-1,1,0,5,0,5,-1,3,2,0,2,2,-2,3,1,0,1,-31,-4,-4,8,5,0,0,1,-1,0,-1,6,-1
KR_6725255457,420,-3,-38,-25,-3,0,1,1,-4,5,1,1,2,3,1,2,3,-1,1,0,-1,-3,-2,2,-6,4,-5,0,-2,-1,-1,-1,-1,2,-1
KR_6515218230,420,-3,-64,-5,-8,-1,3,2,-2,4,2,-1,2,1,0,2,2,-4,4,0,0,-13,-11,1,-8,7,-3,0,-2,-1,-1,-1,1,1,-1
KR_6767836277,440,0,-68,16,-7,-1,5,4,1,2,3,-3,5,2,-3,6,3,-1,2,1,0,-6,21,0,-2,2,-1,0,-1,-1,1,-1,-1,3,-1
KR_6748594906,420,2,34,0,-8,-1,4,3,-1,2,1,4,2,6,-9,9,0,-1,1,0,0,-12,-33,-4,-2,6,1,0,0,-1,-1,-1,-1,6,-1
KR_6683604126,420,-4,-44,-47,-1,-1,4,3,2,0,2,-3,5,2,1,2,3,0,0,0,-1,10,-15,-3,-4,7,0,0,-3,-1,-1,-1,-1,2,-1
KR_6581276630,420,-3,-68,1,-13,0,2,2,2,1,3,-7,7,0,-6,7,1,-2,2,0,0,-8,3,-3,-3,6,-5,0,0,-1,-1,-1,-1,1,-1
KR_6731525416,420,-2,14,0,-9,1,2,3,-5,6,1,0,5,5,-4,4,0,-1,1,0,0,-16,19,1,-3,2,2,0,0,-1,-1,-1,-1,6,-1
KR_6724276797,420,-6,-62,-3,-11,-2,2,0,5,0,5,-7,8,1,-5,7,2,-2,2,0,0,-3,-9,-4,-2,6,2,0,-1,-1,-1,-1,-1,6,-1
KR_6742378440,420,-5,-109,-10,-12,-3,3,0,-9,10,1,2,1,3,0,4,4,-2,2,0,-1,-11,-6,2,-7,5,-2,0,-2,-1,-1,-1,-1,5,-1
KR_6736479231,420,2,-14,92,11,-2,4,2,-1,3,2,6,4,10,5,2,7,3,2,5,1,2,-5,-6,-1,7,3,0,2,1,1,1,1,5,-1
KR_6694604038,420,1,-46,-7,-1,1,2,3,7,1,8,-5,8,3,-4,5,1,0,2,2,-2,8,-1,0,-5,5,2,0,-1,1,1,-1,-1,4,-1
KR_6766023472,420,0,-27,0,-4,-2,3,1,2,1,3,4,4,8,-4,7,3,-4,4,0,0,-3,0,-1,-4,5,0,0,0,1,-1,-1,-1,5,-1
KR_6764727662,420,4,-71,3,9,6,1,7,-4,4,0,4,1,5,1,3,4,2,0,2,0,10,36,4,-12,8,1,0,0,1,1,-1,-1,5,-1
KR_6707111582,420,-5,-47,-23,-17,-2,2,0,-5,6,1,0,1,1,-8,8,0,-2,3,1,0,-20,-4,0,-5,5,-2,0,-1,0,-1,-1,-1,0,-1
KR_6764017255,420,1,-46,-25,7,7,1,8,0,2,2,1,1,2,1,1,2,-2,2,0,0,9,4,-5,-2,7,0,0,-1,-1,-1,-1,-1,5,-1
KR_6750716257,420,-2,76,-17,-9,0,1,1,-4,4,0,-2,5,3,-1,3,2,-2,4,2,0,-10,42,-3,-2,5,-1,0,0,1,-1,1,-1,3,-1
KR_6604408442,420,-1,-3,20,0,2,0,2,3,3,6,0,2,2,-6,10,4,1,1,2,0,-3,-2,-3,-5,8,0,0,0,-1,-1,-1,1,1,-1
KR_6743428588,420,-2,27,-2,-8,-1,3,2,-1,2,1,-5,6,1,0,6,6,-1,1,0,0,-16,71,-3,-4,7,-10,0,0,-1,-1,-1,1,4,-1
KR_6743107759,420,5,51,4,1,-1,2,1,3,1,4,-5,7,2,3,3,6,1,0,1,0,1,-2,-1,-3,4,-4,0,1,-1,-1,1,-1,2,-1
KR_6672724568,420,-4,-77,-28,-13,2,1,3,-6,6,0,-2,4,2,-6,6,0,-1,2,1,-2,-19,-8,0,-5,5,-3,0,-1,-1,-1,-1,-1,6,-1
KR_6712523953,420,-1,-4,-6,-2,2,3,5,2,3,5,0,0,0,-7,8,1,1,0,1,-1,-9,7,-1,-5,6,-4,0,1,-1,1,1,-1,4,-1
KR_6746865819,420,-2,-2,16,-13,-1,3,2,-10,11,1,-4,5,1,0,3,3,2,0,2,0,-11,1,-1,-6,7,-5,0,-1,-1,-1,-1,-1,5,-1
KR_6765446362,420,-2,20,8,-4,1,2,3,-1,1,0,-5,8,3,0,4,4,1,0,1,0,-7,-13,-2,-4,6,1,0,0,0,0,0,1,0,-1
KR_6745957068,420,-3,-20,4,-1,1,1,2,-1,2,1,-1,3,2,-1,6,5,1,0,1,2,1,-35,1,-5,4,1,0,0,-1,1,0,1,4,-1
KR_6754628107,420,-1,-23,25,-3,-1,2,1,-2,3,1,1,0,1,-3,4,1,2,0,2,0,-5,28,4,-6,2,3,0,0,-1,1,0,1,1,-1
KR_6673496190,420,-3,-55,-41,-7,-1,2,1,-4,5,1,-3,3,0,2,1,3,-1,2,1,-1,1,2,-3,-2,5,2,0,-1,-1,-1,-1,-1,1,-1
KR_6751031152,420,-6,-28,-27,-10,1,1,2,-10,10,0,-1,1,0,-2,4,2,2,1,3,-2,-18,-2,-3,-2,5,-2,0,0,-1,-1,-1,-1,4,-1
KR_6757040463,420,-6,-55,-12,-13,-4,4,0,-1,2,1,-5,6,1,-3,4,1,0,1,1,0,-6,35,-4,-5,9,-26,0,-2,-1,-1,-1,-1,6,-1
KR_6733272540,420,0,-30,-1,3,-4,6,2,8,1,9,2,0,2,-3,7,4,0,0,0,0,6,2,2,-6,4,-2,0,-1,-1,-1,-1,1,3,-1
KR_6740169005,420,1,41,8,7,1,1,2,0,4,4,-3,4,1,1,1,2,8,0,8,0,7,-2,-2,-2,4,5,0,0,-1,-1,-1,1,6,-1
KR_6767344578,420,0,2,16,-3,1,0,1,-1,3,2,0,2,2,-4,8,4,1,2,3,0,0,-5,-5,0,5,-1,0,0,1,1,0,-1,4,-1
KR_6767939592,420,-2,-31,-3,-3,1,0,1,-2,3,1,-1,3,2,-2,3,1,1,0,1,-1,-3,-22,0,-5,5,-1,0,-1,-1,1,-1,-1,1,-1
KR_6767856862,420,-2,-29,-27,-2,-2,3,1,4,2,6,1,4,5,-3,7,4,-2,2,0,0,-2,-115,-3,-5,8,1,0,-1,-1,-1,-1,1,3,-1
KR_6764932298,420,-1,19,-2,-5,0,1,1,-2,3,1,2,2,4,-7,9,2,2,1,3,-2,-8,-4,-3,-3,6,-1,0,0,0,-1,-1,-1,0,-1
KR_6675506155,420,-3,-22,-7,-5,-1,3,2,0,3,3,-2,2,0,-1,1,0,-1,1,0,-1,-4,21,-1,-7,8,-3,0,0,-1,1,0,-1,5,-1
KR_6758567242,420,-2,-31,0,-2,-2,5,3,0,2,2,3,6,9,2,0,2,-5,6,1,0,-1,33,2,-6,4,0,0,0,1,1,-1,1,5,-1
KR_6766621699,440,-3,-102,-2,-5,2,3,5,-2,4,2,-5,8,3,-2,4,2,2,0,2,-1,3,-2,-3,-4,7,-5,0,-2,-1,-1,-1,-1,2,-1
KR_6657562946,420,-3,-25,-53,-6,1,1,2,-6,8,2,-3,5,2,2,0,2,0,0,0,0,-5,-5,-3,-4,7,-1,0,0,-1,1,-1,-1,1,-1
KR_6706555822,420,-1,-55,-8,5,-1,2,1,3,2,5,1,0,1,3,1,4,-1,4,3,0,4,2,-2,-6,8,-3,0,-1,-1,1,-1,1,3,-1
KR_6760481971,420,0,28,7,-1,5,0,5,1,1,2,-2,4,2,-6,6,0,1,0,1,-1,-6,-10,0,-4,4,1,0,-1,1,-1,-1,-1,4,-1
KR_6715827866,440,-2,-12,-10,-2,1,3,4,-1,2,1,-3,4,1,2,2,4,-1,1,0,0,2,-38,1,-5,4,3,0,-1,1,1,-1,-1,2,-1
KR_6752325093,420,-3,-32,20,-3,-3,3,0,5,2,7,-6,6,0,3,3,6,-2,2,0,-1,-2,18,-2,-4,6,0,0,-1,-1,1,-1,-1,4,-1
KR_6768774417,440,-2,-55,2,-1,-4,4,0,3,5,8,2,1,3,-4,4,0,2,1,3,0,-2,-6,-7,-5,12,5,0,-1,-1,1,-1,-1,5,-1
KR_6768937860,420,-1,-35,-20,-4,-6,6,0,-4,6,2,1,1,2,6,1,7,-1,2,1,0,7,17,0,-5,5,-2,0,-1,-1,-1,-1,-1,6,-1
KR_6734907157,420,-7,-120,-18,-18,-4,4,0,-4,6,2,-5,9,4,-3,5,2,-2,2,0,0,-10,-15,-7,-1,8,0,0,-1,-1,-1,-1,-1,4,-1
KR_6685202929,420,-2,-54,-12,-2,-2,2,0,-1,4,3,1,4,5,-1,4,3,1,3,4,0,5,3,1,-5,4,-1,0,-1,-1,1,-1,1,4,-1
KR_6691939256,420,0,-2,8,1,0,2,2,-5,6,1,1,1,2,3,1,4,2,0,2,0,-2,7,-6,-1,7,1,0,1,0,-1,1,-1,0,-1
KR_6622231061,420,-6,-111,16,-18,-6,7,1,-4,4,0,-5,6,1,-4,6,2,1,1,2,0,-16,34,2,-4,2,-3,0,-1,-1,1,-1,-1,4,-1
KR_6769114011,420,0,28,12,1,-3,3,0,2,4,6,1,1,2,1,2,3,0,1,1,0,-4,10,0,-3,3,-4,0,-1,1,-1,-1,1,2,-1
KR_6752870877,420,-3,-112,-24,-7,-3,5,2,5,2,7,0,3,3,-8,8,0,-1,4,3,0,6,10,0,-2,2,0,0,-2,-1,1,-1,-1,1,-1
KR_6756743522,440,-6,-23,-3,-17,-7,8,1,1,4,5,-7,8,1,0,2,2,-4,4,0,-2,-12,-5,-3,-3,6,-5,0,-3,-1,-1,-1,-1,5,-1
KR_6765087271,420,-1,34,-4,-4,1,1,2,0,4,4,-2,2,0,-3,4,1,0,0,0,0,-3,-13,7,-9,2,-6,0,0,1,-1,0,1,1,-1
KR_6759064878,420,-1,-9,-12,4,0,0,0,1,1,2,2,4,6,3,3,6,-2,2,0,-1,-1,-116,-4,-3,7,3,0,0,-1,-1,0,-1,1,-1
KR_6769518309,420,-3,-4,-3,-10,2,1,3,-8,8,0,-2,3,1,-3,3,0,1,3,4,0,-8,31,1,-7,6,-2,0,-2,-1,-1,-1,-1,5,-1
KR_6761994306,420,-1,14,4,-1,-1,5,4,0,1,1,1,2,3,3,5,8,-4,5,1,0,-7,-2,0,-2,2,1,0,0,-1,1,0,1,1,-1
KR_6736422775,420,1,48,-1,5,-1,2,1,1,4,5,-1,4,3,3,0,3,3,0,3,0,6,6,-1,-3,4,-2,0,1,-1,1,1,-1,5,-1
KR_6763508269,420,-1,23,-24,-1,4,0,4,-3,4,1,0,4,4,-3,3,0,1,2,3,-1,-1,4,-2,-4,6,-1,0,0,-1,0,0,-1,3,-1
KR_6757883516,440,-5,-34,4,-14,-1,1,0,-7,9,2,-6,6,0,1,0,1,-1,1,0,0,-9,-8,-4,-3,7,3,0,0,-1,-1,0,-1,3,-1
KR_6553782745,420,0,-51,13,-3,-4,5,1,-5,7,2,7,2,9,0,3,3,-1,2,1,0,-2,-12,-3,-5,8,2,0,0,1,-1,-1,-1,6,-1
KR_6767989090,420,1,34,-4,-8,0,2,2,-4,5,1,-1,3,2,-2,4,2,-1,1,0,0,-8,2,3,-7,4,-4,0,0,1,0,0,1,1,-1
KR_6767670286,420,-1,-21,-22,-4,-2,2,0,-1,5,4,5,0,5,-4,5,1,-2,5,3,0,1,2,3,-5,2,-2,0,0,-1,1,0,-1,4,-1
KR_6769034968,420,-2,-10,-5,-5,-5,8,3,2,1,3,-3,5,2,1,1,2,0,0,0,0,3,-8,0,-3,3,-1,0,1,-1,1,1,-1,5,-1
KR_6759505901,440,0,7,0,2,1,0,1,1,3,4,1,0,1,1,2,3,-2,2,0,1,10,-2,-2,-5,7,-6,0,0,0,-1,0,1,0,-1
KR_6566897902,420,-3,-42,-7,-10,-7,9,2,0,7,7,-1,3,2,-4,6,2,2,1,3,-1,-5,-7,-4,-3,7,-7,0,-2,1,-1,-1,-1,3,-1
KR_6769885658,420,3,-52,-1,10,0,3,3,4,2,6,3,0,3,3,2,5,0,2,2,0,12,229,5,-5,0,-2,0,1,1,-1,1,-1,6,-1
KR_6749327504,420,-3,-62,-12,-14,-5,5,0,1,1,2,-5,6,1,-6,7,1,1,0,1,-2,-22,-4,-3,-3,6,-4,0,-2,-1,-1,-1,-1,6,-1
KR_6766904536,420,-1,47,-32,1,2,0,2,-2,5,3,-3,6,3,3,3,6,1,1,2,0,9,5,3,-6,3,3,0,0,-1,-1,0,1,4,-1
KR_6598347600,420,3,-28,21,6,7,0,7,-6,6,0,2,1,3,0,1,1,3,0,3,0,0,-13,-4,-5,9,1,0,1,-1,1,1,-1,6,-1
KR_6761958104,420,-3,-74,-12,-3,0,1,1,-1,3,2,-2,2,0,0,2,2,0,0,0,0,-2,3,1,-5,4,-3,0,0,-1,1,0,1,3,-1
KR_6753114878,420,0,20,0,2,4,0,4,2,1,3,2,1,3,-5,7,2,-1,1,0,0,1,-25,1,-6,5,-7,0,-1,-1,1,-1,1,3,-1
KR_6764552766,420,-1,-29,-4,-2,-2,3,1,-1,3,2,5,0,5,-1,3,2,-3,3,0,0,-6,36,-2,-1,3,0,0,0,0,-1,-1,-1,0,-1
KR_6761659469,420,0,21,13,-3,1,2,3,-7,9,2,-1,2,1,2,2,4,2,2,4,0,-10,2,-3,-1,4,0,0,1,-1,-1,1,-1,3,-1
KR_6768802305,420,0,-1,-26,-11,-1,2,1,-1,3,2,-2,4,2,-6,9,3,-1,2,1,0,-15,-4,-1,-3,4,0,0,0,-1,1,0,-1,4,-1
KR_6587001795,420,0,-48,28,2,3,2,5,-2,5,3,4,0,4,-2,3,1,-1,1,0,0,-1,-7,1,-4,3,0,0,0,1,1,-1,-1,5,-1
KR_6768715475,420,-2,-14,-53,-7,-1,3,2,2,2,4,-4,4,0,-3,6,3,-1,4,3,0,0,106,1,-2,1,-3,0,-2,1,-1,-1,1,6,-1
KR_6765769439,420,-3,3,-4,-1,-3,4,1,-1,4,3,1,2,3,1,2,3,1,0,1,1,8,-10,-3,-3,6,2,0,-1,-1,-1,-1,1,3,-1
KR_6768184869,420,0,-87,-5,-4,-2,4,2,0,2,2,-2,2,0,-1,2,1,1,0,1,-1,-3,-3,1,-7,6,4,0,-1,-1,-1,-1,-1,6,-1
KR_6756981582,420,-6,-56,-112,0,1,0,1,-3,3,0,0,2,2,4,0,4,-2,4,2,0,-3,3,1,-2,1,-2,0,1,-1,1,-1,1,6,-1
KR_6751085161,420,-2,6,-23,-4,3,3,6,-1,6,5,-2,2,0,1,6,7,-5,6,1,-1,-2,3,2,-6,4,-4,0,0,-1,-1,-1,-1,3,-1
KR_6756471038,420,-5,-92,-23,-14,-1,3,2,1,2,3,-11,12,1,-3,8,5,0,1,1,-5,-20,-20,-11,-3,14,-2,0,-2,-1,1,-1,-1,1,-1
KR_6761472593,420,-8,-92,-16,-20,-3,3,0,-4,5,1,-4,4,0,-9,9,0,0,1,1,-1,-19,17,-1,-2,3,2,0,-1,-1,1,-1,-1,5,-1
KR_6767238618,440,-2,-9,-15,-4,-3,4,1,0,1,1,3,0,3,-3,4,1,-1,1,0,0,1,86,1,-6,5,-3,0,1,-1,1,1,1,6,-1
KR_6767065080,420,2,-5,32,3,2,0,2,-4,5,1,3,1,4,2,0,2,0,1,1,0,3,-2,0,-4,4,-1,0,0,-1,1,-1,1,5,-1
KR_6744441512,420,-5,-77,-25,-6,-3,3,0,6,0,6,-5,6,1,-4,6,2,0,0,0,0,-7,6,3,-8,5,1,0,-2,-1,1,-1,-1,4,-1
KR_6762357339,420,-5,-42,-15,-11,-5,5,0,-1,3,2,1,2,3,-3,8,5,-3,4,1,-1,-3,-2,5,-8,3,-5,0,-2,-1,-1,-1,-1,6,-1
KR_6618106375,420,-2,-64,-29,4,0,2,2,1,3,4,4,1,5,0,5,5,-1,3,2,0,5,-1,0,-2,2,1,0,0,1,1,-1,1,4,-1
KR_6760912571,440,-1,-4,-22,-10,-2,3,1,-2,3,1,-2,2,0,-3,6,3,-1,1,0,0,-13,-6,-2,-3,5,1,0,0,-1,-1,0,-1,3,-1
KR_6611105115,420,1,20,48,-4,0,1,1,-3,4,1,0,3,3,-3,7,4,2,0,2,-1,-10,-12,-2,-3,5,-2,0,0,-1,1,0,-1,6,-1
KR_6722542404,420,-3,-83,-12,-6,-1,2,1,-3,5,2,4,3,7,-8,9,1,2,1,3,0,-4,-7,0,-5,5,3,0,-2,-1,-1,-1,-1,1,-1
KR_6671342244,420,-3,-68,-36,-8,0,1,1,-8,9,1,-1,2,1,-1,2,1,2,0,2,0,-13,2,-6,-5,11,-3,0,0,-1,-1,0,1,2,-1
KR_6768280322,420,0,-73,-32,8,2,1,3,-5,7,2,1,0,1,4,1,5,6,1,7,0,15,-7,10,-13,3,-9,0,-1,1,1,-1,1,6,-1
KR_6676376232,420,0,-20,13,-2,1,1,2,-3,3,0,-2,5,3,1,3,4,1,1,2,0,-4,23,4,-6,2,-3,0,-1,1,-1,-1,1,2,-1
KR_6707315824,420,0,-72,-5,-1,-4,4,0,1,1,2,-2,4,2,1,2,3,3,2,5,0,7,13,2,-5,3,0,0,-2,-1,1,-1,-1,3,-1
KR_6751053943,420,-3,-44,-16,-3,-1,2,1,-3,4,1,1,2,3,1,2,3,-1,1,0,0,0,2,4,-7,3,-1,0,-1,0,0,-1,-1,0,-1
KR_6730395745,420,-6,-36,4,-6,-4,4,0,-1,3,2,3,1,4,-3,3,0,-1,1,0,-1,-10,3,-9,-4,13,-3,0,-1,1,-1,-1,-1,6,-1
KR_6746474581,420,-4,-85,-19,-1,-5,6,1,7,0,7,2,0,2,-5,5,0,0,0,0,0,2,150,5,-7,2,2,0,-1,-1,-1,-1,-1,4,-1
KR_6753129383,420,-1,-27,0,-1,3,1,4,-5,6,1,-1,4,3,2,0,2,0,0,0,0,-3,-9,1,-4,3,2,0,0,-1,-1,-1,1,4,-1
KR_6729890086,420,1,55,-12,4,6,1,7,2,1,3,-1,2,1,-3,5,2,0,1,1,0,4,-30,2,-6,4,16,0,0,1,1,1,-1,2,-1
KR_6697845809,420,-3,-35,-25,-5,-1,3,2,3,0,3,0,4,4,-5,7,2,-2,2,0,0,-2,-1,3,-8,5,-3,0,0,0,-1,1,1,0,-1
KR_6762301924,420,-2,-80,18,-6,-1,5,4,0,4,4,-4,4,0,1,2,3,-2,3,1,0,-8,-235,1,-4,3,-6,0,-1,-1,-1,-1,1,3,-1
KR_6728812091,420,-7,-92,-18,-14,-9,9,0,1,4,5,0,2,2,-3,5,2,-3,4,1,0,-5,-11,-3,-5,8,-2,0,-3,-1,-1,-1,1,1,-1
KR_6698147765,420,-6,-89,-11,-5,1,2,3,-3,4,1,1,2,3,0,3,3,-4,6,2,0,-4,-12,2,-8,6,-2,0,-1,-1,1,-1,-1,6,-1
KR_6768731977,420,-3,-12,-41,-8,1,1,2,-2,3,1,-1,1,0,-4,5,1,-2,2,0,0,-11,-24,6,-10,4,-1,0,-2,-1,-1,-1,1,2,-1
KR_6697894685,420,-2,-29,-4,-2,0,1,1,-1,3,2,-3,3,0,0,1,1,2,0,2,0,1,-3,2,-5,3,1,0,-1,1,-1,-1,-1,1,-1
KR_6751923914,440,-1,-35,26,0,3,1,4,0,2,2,3,2,5,-1,1,0,-5,7,2,0,-8,-4,0,-2,2,-1,0,0,0,1,0,1,0,-1
KR_6770451016,420,-2,-31,-3,-3,0,2,2,-1,4,3,-2,2,0,2,1,3,-2,2,0,0,-2,27,0,-4,4,-9,0,-2,-1,1,-1,1,4,-1
KR_6734326577,420,-2,15,6,-7,-3,4,1,2,0,2,0,3,3,-5,6,1,-1,2,1,1,-6,-5,0,-4,4,5,0,-2,0,1,-1,1,0,-1
KR_6730842756,420,-4,-22,-24,-5,-1,2,1,-4,6,2,2,0,2,0,2,2,-2,2,0,0,-6,-9,-2,-4,6,9,0,0,-1,-1,-1,-1,1,-1
KR_6708867247,420,-1,-8,0,-4,1,1,2,-1,3,2,0,3,3,-2,5,3,-2,2,0,0,-9,6,1,-5,4,-4,0,-1,-1,1,-1,-1,5,-1
KR_6767183990,420,-1,25,-16,-6,1,1,2,2,2,4,-7,8,1,-1,5,4,-1,1,0,0,-5,-25,-4,-2,6,3,0,1,-1,-1,-1,-1,1,-1
KR_6724119380,420,-6,-42,12,-17,-9,9,0,-6,7,1,-2,3,1,0,4,4,0,0,0,-2,-9,14,-2,-1,3,5,0,-2,1,1,-1,-1,4,-1
KR_6683641488,420,-2,10,3,-6,1,2,3,1,3,4,-2,4,2,-4,4,0,-2,2,0,0,-9,-12,-1,-2,3,-2,0,0,1,1,1,1,4,-1
KR_6589369171,420,3,35,0,7,2,2,4,-5,10,5,4,1,5,6,0,6,0,0,0,0,-2,3,5,-8,3,-1,0,4,1,0,1,1,4,-1
KR_6606932939,420,-2,24,-32,-7,0,0,0,1,7,8,-5,7,2,-2,3,1,-1,1,0,0,-1,-107,4,-8,4,0,0,0,-1,-1,-1,-1,6,-1
KR_6719370541,420,-4,-53,-64,-6,-5,8,3,-2,5,3,-1,4,3,1,1,2,1,1,2,-1,4,-4,2,-8,6,4,0,0,-1,1,0,-1,3,-1
KR_6683468459,420,1,58,-10,0,4,1,5,-6,6,0,3,0,3,1,0,1,-2,2,0,0,-4,-29,0,-4,4,22,0,2,1,1,1,1,5,-1
KR_6756228240,420,-3,-47,-35,-2,-6,6,0,0,2,2,2,1,3,4,4,8,-2,2,0,0,8,4,-3,-4,7,0,0,1,1,-1,1,-1,1,-1
KR_6685390401,420,-1,-77,0,0,2,0,2,6,2,8,-5,6,1,-4,4,0,1,1,2,-1,-3,-140,2,-5,3,-2,0,-1,1,1,-1,-1,6,-1
KR_6741844804,440,0,68,11,-3,-1,2,1,1,1,2,-2,3,1,-2,2,0,1,0,1,0,6,-8,2,-9,7,-2,0,0,-1,-1,0,1,4,-1
KR_6764670435,420,-6,-90,-19,-12,0,3,3,-7,8,1,-2,2,0,-2,2,0,-1,1,0,0,-6,-9,-1,-4,5,0,0,0,1,1,1,-1,4,-1
KR_6714545617,420,-3,-44,-24,-2,5,0,5,0,2,2,-4,7,3,-1,3,2,-2,2,0,0,-2,12,4,-9,5,-8,0,-1,0,1,-1,1,0,-1
KR_6661336277,420,-8,-99,-36,-18,-3,3,0,-7,7,0,-6,6,0,-1,2,1,-1,1,0,0,-14,-2,1,-6,5,-5,0,-2,-1,-1,-1,-1,6,-1
KR_6673940713,420,-3,-24,-12,0,-1,4,3,1,4,5,4,2,6,-4,6,2,0,0,0,0,-12,2,1,-4,3,-3,0,0,-1,-1,-1,1,3,-1
KR_6760313728,440,4,83,21,8,5,0,5,-2,3,1,-2,5,3,7,0,7,0,0,0,0,5,8,6,-8,2,-1,0,3,1,1,1,1,6,-1
KR_6767210010,420,3,23,8,0,-3,4,1,3,1,4,1,0,1,-2,4,2,1,0,1,0,2,41,-3,-3,6,-11,0,0,-1,-1,0,1,3,-1
KR_6714835870,420,-6,-76,-19,-10,-2,2,0,-5,7,2,-2,2,0,0,3,3,-1,2,1,0,-7,18,-2,-3,5,-3,0,-3,-1,-1,-1,-1,3,-1
KR_6760920070,420,-1,-52,16,-3,0,2,2,5,2,7,-1,2,1,-7,8,1,0,0,0,0,-2,5,4,-8,4,-2,0,-1,0,0,-1,1,0,-1
KR_6755549042,420,-9,-81,-18,-17,-6,8,2,1,2,3,-5,6,1,-4,5,1,-3,4,1,0,-5,2,-1,-6,7,-1,0,-2,1,-1,-1,-1,6,-1
KR_6764571855,420,2,26,12,1,-4,4,0,2,1,3,-1,1,0,2,5,7,2,3,5,-1,1,4,-1,-1,2,1,0,-1,1,-1,-1,-1,1,-1
KR_6728438706,420,-3,-57,-29,-3,2,0,2,1,3,4,-1,3,2,-5,5,0,0,1,1,0,-9,8,5,-12,7,-5,0,-2,-1,1,-1,-1,5,-1
KR_6749248474,420,1,-38,20,-4,-6,6,0,0,2,2,1,2,3,2,1,3,-1,1,0,0,2,-287,1,-4,3,-2,0,-1,-1,-1,-1,1,5,-1
KR_6725247657,420,-1,35,-32,-1,2,1,3,2,2,4,-1,2,1,-3,4,1,-1,1,0,0,2,-36,-1,-3,4,-3,0,0,1,1,0,-1,6,-1
KR_6700498703,420,-4,-51,20,-7,-5,5,0,-1,3,2,-2,2,0,1,1,2,0,0,0,0,-3,-3,-2,-5,7,-7,0,-1,-1,-1,-1,1,2,-1
KR_6688506858,420,-1,-45,-5,-7,-4,4,0,-4,4,0,-1,2,1,-2,3,1,4,0,4,0,-10,-44,-2,-7,9,15,0,0,-1,1,-1,-1,3,-1
KR_6620037431,420,-1,-5,-10,-3,0,2,2,-5,7,2,-1,4,3,3,0,3,0,1,1,1,0,2,-2,-8,10,2,0,1,-1,-1,-1,1,5,-1
KR_6579254720,420,-1,41,0,-5,-2,2,0,-2,3,1,0,1,1,2,3,5,-3,3,0,0,-6,-62,1,-7,6,0,0,0,1,1,0,-1,2,-1
KR_6640098674,420,-4,-36,5,-8,-1,2,1,-1,1,0,0,2,2,-5,5,0,-1,1,0,0,-2,2,-2,-3,5,-3,0,-2,-1,1,-1,-1,3,-1
KR_6443103108,420,-5,-75,-28,-2,-1,4,3,0,3,3,-2,6,4,2,0,2,-1,1,0,1,3,82,-5,-7,12,0,0,0,1,-1,-1,1,5,-1
KR_6752300694,420,-3,8,-27,1,0,2,2,-1,3,2,-3,3,0,4,4,8,1,2,3,0,0,7,1,-2,1,-7,0,0,-1,-1,-1,1,3,-1
KR_6649940770,420,2,1,7,6,4,1,5,0,2,2,0,4,4,1,2,3,1,0,1,1,6,-2,5,-7,2,2,0,1,-1,1,1,1,2,-1
KR_6750566086,420,-5,-54,12,-11,-2,2,0,3,2,5,-5,5,0,-4,5,1,-3,3,0,0,-14,-31,-1,-4,5,0,0,0,-1,-1,0,-1,1,-1
KR_6722529304,420,1,7,40,3,0,2,2,4,2,6,-1,1,0,1,3,4,-1,1,0,0,3,-1,-5,-3,8,4,0,0,1,-1,0,1,2,-1
KR_6682194983,420,0,-42,39,-4,-6,6,0,3,1,4,0,4,4,1,1,2,-2,2,0,0,1,2,-1,-6,7,1,0,0,1,-1,0,-1,4,-1
KR_6728388499,420,2,81,-26,8,0,1,1,2,1,3,2,1,3,4,1,5,0,1,1,0,13,4,5,-8,3,1,0,0,0,1,1,-1,0,-1
KR_6756037838,420,-1,30,-8,0,-4,5,1,-1,2,1,2,0,2,3,1,4,0,1,1,-1,-4,4,2,-6,4,-4,0,1,-1,1,1,-1,1,-1
KR_6771027311,420,0,29,0,-1,0,1,1,3,1,4,-1,2,1,-1,5,4,-2,3,1,0,-4,-1,1,-4,3,-1,0,-2,1,-1,-1,-1,2,-1
KR_6739757340,420,0,-28,-24,0,2,3,5,-6,7,1,-2,6,4,1,2,3,5,1,6,0,4,21,-1,-3,4,-4,0,-1,-1,-1,-1,-1,1,-1
KR_6540399916,420,-5,-50,-28,-7,0,1,1,-3,9,6,-1,4,3,-3,4,1,0,0,0,0,-7,-12,1,-5,4,1,0,-1,0,0,-1,-1,0,-1
KR_6767910921,420,-4,-69,16,-6,-2,2,0,3,3,6,-11,11,0,5,0,5,-1,1,0,0,-1,-12,-2,-1,3,4,0,-2,1,-1,-1,1,4,-1
KR_6750504298,420,-2,33,-24,-8,0,1,1,-4,6,2,5,1,6,-6,8,2,-3,3,0,-3,-14,-10,-6,-3,9,0,0,-2,1,-1,-1,1,4,-1
KR_6718690443,420,-1,-25,8,-7,0,1,1,-1,4,3,-5,6,1,1,1,2,-2,2,0,0,-6,-8,-3,-6,9,-2,0,0,-1,1,-1,-1,3,-1
KR_6768128362,440,1,-24,9,2,-1,1,0,3,2,5,-2,4,2,0,1,1,2,0,2,0,1,-2,2,-7,5,-3,0,-1,1,-1,-1,-1,1,-1
KR_6765107751,420,-1,10,-32,-3,1,1,2,0,1,1,-4,4,0,1,4,5,-1,1,0,-1,-4,-30,4,-9,5,2,0,1,-1,-1,1,-1,2,-1
KR_6758133212,440,-1,-48,18,-5,-7,8,1,-1,2,1,-1,2,1,2,5,7,2,0,2,1,1,174,-3,-2,5,4,0,-2,-1,0,-1,1,5,-1
KR_6741034352,420,-4,-42,-20,-7,-2,2,0,-5,7,2,-5,5,0,5,4,9,0,0,0,0,2,7,-7,-3,10,-6,0,1,1,-1,1,-1,2,-1
KR_6724675845,420,-2,-1,12,-6,-1,1,0,1,2,3,-2,2,0,-2,3,1,-2,3,1,0,-3,6,5,-8,3,-2,0,-1,-1,1,-1,1,2,-1
KR_6759211364,420,2,31,61,-6,4,0,4,-4,5,1,-2,2,0,-3,3,0,-1,2,1,-1,-16,-1,-4,-5,9,-2,0,-3,-1,-1,-1,-1,2,-1
KR_6664042079,420,0,-11,-49,3,-2,4,2,1,1,2,0,3,3,3,2,5,1,0,1,0,8,0,2,-7,5,0,0,-1,1,-1,-1,1,1,-1
KR_6769441551,420,0,19,15,-2,5,1,6,1,3,4,-7,7,0,-2,4,2,1,2,3,0,6,-15,-2,-2,4,4,0,1,0,0,1,1,0,-1
KR_6768747346,420,-2,-99,11,4,-2,4,2,3,3,6,4,1,5,1,2,3,-2,2,0,0,3,6,5,-7,2,0,0,-2,-1,0,-1,1,1,-1
KR_6713653391,420,-2,-32,21,-9,-5,5,0,-1,6,5,1,2,3,-3,4,1,-1,1,0,0,-7,-5,-2,-8,10,-4,0,0,-1,-1,0,1,3,-1
KR_6709579671,420,-5,-62,-6,-11,-3,4,1,-8,9,1,2,1,3,-3,4,1,1,0,1,0,-13,1,3,-5,2,-7,0,-3,1,-1,-1,-1,5,-1
KR_6768322333,420,0,-46,24,-11,-2,3,1,-1,3,2,0,4,4,-8,8,0,0,0,0,0,-11,-9,-4,-5,9,2,0,-1,-1,1,-1,-1,5,-1
KR_6624349260,420,-1,80,-36,8,2,0,2,0,1,1,-2,5,3,8,1,9,0,1,1,1,10,7,2,-5,3,-1,0,1,1,-1,1,1,6,-1
KR_6758972035,420,1,-36,16,-3,1,3,4,-1,1,0,0,1,1,-1,1,0,-2,3,1,-1,-8,0,0,-4,4,-4,0,1,-1,1,1,-1,6,-1
KR_6770160313,420,-2,-44,16,-8,1,1,2,-4,7,3,0,4,4,-6,8,2,1,1,2,0,-11,6,-2,-4,6,-7,0,-1,-1,-1,-1,-1,1,-1
KR_6605576208,420,1,21,23,0,1,1,2,1,0,1,1,2,3,-2,4,2,-1,2,1,0,-3,2,2,-6,4,1,0,0,1,1,0,-1,1,-1
KR_6676983888,440,0,-5,16,-3,-3,5,2,-3,3,0,1,1,2,5,0,5,-3,4,1,0,1,6,0,-3,3,-1,0,-1,1,-1,-1,-1,1,-1
KR_6524293602,420,0,-12,12,1,-1,3,2,5,2,7,0,0,0,0,1,1,-3,3,0,0,2,-84,-3,-2,5,3,0,1,1,-1,1,-1,1,-1
KR_6695599658,420,-1,-51,28,-4,0,2,2,-2,4,2,0,3,3,-2,4,2,0,1,1,0,-2,6,1,-5,4,-3,0,-1,1,-1,-1,1,6,-1
KR_6750496697,420,-3,-121,-8,-4,-5,5,0,5,0,5,1,2,3,-3,5,2,-2,3,1,0,3,3,6,-13,7,-3,0,0,1,1,-1,-1,2,-1
KR_6761742945,440,0,5,11,-5,2,0,2,-6,7,1,-1,4,3,-1,2,1,1,3,4,0,-1,-3,0,-3,3,-2,0,0,-1,1,-1,-1,6,-1
KR_6534105561,420,2,-2,-1,-1,-3,4,1,6,3,9,-3,4,1,0,2,2,-1,1,0,0,2,14,5,-9,4,-3,0,-1,1,-1,-1,1,6,-1
KR_6683716973,420,2,12,-4,2,1,2,3,0,1,1,1,2,3,-3,4,1,3,2,5,0,-1,9,2,-3,1,1,0,0,-1,-1,0,-1,3,-1
KR_6759518949,440,0,72,40,-5,4,0,4,-3,3,0,0,0,0,-6,6,0,0,0,0,0,-15,4,1,-8,7,7,0,0,-1,1,0,1,1,-1
KR_6761162411,420,1,-27,18,-2,-2,3,1,5,1,6,-2,3,1,-1,6,5,-2,2,0,0,-2,6,-3,-5,8,-3,0,-2,-1,-1,-1,-1,6,-1
KR_6669106138,420,-3,-42,-10,-5,0,0,0,-2,3,1,3,0,3,-3,3,0,-3,3,0,0,-6,-24,2,-4,2,-3,0,-1,-1,1,-1,-1,3,-1
KR_6747422168,420,1,54,-51,-3,2,1,3,6,5,11,-7,10,3,-2,3,1,-2,3,1,-3,-13,-4,-1,-3,4,-3,0,-1,1,1,-1,-1,4,-1
KR_6702918264,420,1,58,12,-2,-2,3,1,-4,7,3,3,2,5,1,0,1,0,0,0,0,-9,-22,0,-4,4,2,0,0,1,0,0,-1,5,-1
KR_6761750981,440,-1,-34,14,-2,-2,3,1,2,3,5,3,2,5,-6,9,3,1,2,3,0,-2,12,-1,-1,2,-2,0,-2,-1,-1,-1,-1,2,-1
KR_6746684688,420,-2,-28,-6,-4,-1,2,1,-6,8,2,-1,3,2,4,0,4,0,1,1,-1,-5,130,-1,-3,4,3,0,-1,-1,-1,-1,-1,2,-1
KR_6681149713,420,-2,-78,-23,-4,1,0,1,-2,3,1,4,0,4,-6,6,0,-1,1,0,0,-6,11,-2,-3,5,-2,0,-1,-1,1,-1,-1,1,-1
KR_6768789603,420,2,1,-12,1,-1,1,0,0,1,1,0,3,3,1,0,1,1,0,1,0,3,-2,-3,-3,6,4,0,0,1,1,1,-1,3,-1
KR_6542684379,420,0,37,-10,-6,-1,1,0,-9,9,0,0,1,1,4,4,8,0,0,0,0,-11,23,-2,-6,8,-1,0,0,-1,-1,1,-1,3,-1
KR_6683149995,420,2,44,-30,6,3,0,3,-4,5,1,3,1,4,1,2,3,3,0,3,0,6,-1,3,-9,6,1,0,0,-1,-1,-1,1,5,-1
KR_6632749016,420,-4,-61,-52,-8,-3,3,0,-2,4,2,-2,2,0,-2,3,1,1,0,1,0,2,-7,-4,-4,8,0,0,-2,-1,-1,-1,-1,6,-1
KR_6651894186,420,1,29,12,2,6,0,6,2,3,5,-6,6,0,2,0,2,-2,2,0,0,-1,14,5,-9,4,-1,0,1,-1,1,1,1,5,-1
KR_6601921548,420,-1,-14,-20,-10,0,2,2,-2,2,0,-4,4,0,-5,5,0,1,0,1,0,-9,-14,-7,-1,8,3,0,1,-1,1,1,-1,3,-1
KR_6735323057,420,1,4,-13,0,0,2,2,0,2,2,-2,4,2,0,4,4,2,0,2,0,2,75,3,-5,2,-20,0,0,1,1,0,-1,2,-1
KR_6768530021,440,-3,7,-24,-1,-1,2,1,-2,3,1,1,2,3,1,1,2,0,0,0,0,-5,3,3,-6,3,-3,0,0,-1,-1,0,1,1,-1
KR_6624242248,420,-1,-9,3,-3,1,0,1,-6,9,3,0,1,1,0,4,4,2,2,4,0,-9,0,-1,-5,6,-1,0,1,-1,1,1,1,4,-1
KR_6742803344,420,-1,-17,24,0,1,0,1,-2,3,1,1,2,3,-1,3,2,1,0,1,0,-2,8,4,-7,3,5,0,-1,1,1,-1,-1,1,-1
KR_6768299562,440,-2,-59,-20,-12,-5,5,0,3,0,3,-1,4,3,-8,8,0,-1,1,0,0,-11,0,6,-7,1,-2,0,-2,1,-1,-1,-1,6,-1
KR_6675908205,420,0,5,14,-5,0,4,4,1,7,8,-3,6,3,1,2,3,-4,4,0,0,4,-38,-2,-8,10,4,0,0,1,-1,-1,-1,1,-1
KR_6408108227,420,-3,-30,12,-2,-2,3,1,0,1,1,1,4,5,-1,2,1,0,0,0,0,-4,21,5,-10,5,22,0,0,1,0,-1,1,2,-1
KR_6757078573,440,0,-37,-5,2,4,0,4,-1,1,0,0,3,3,-2,4,2,1,0,1,0,-3,19,2,-6,4,-2,0,2,1,1,1,1,5,-1
KR_6726271151,420,-2,22,-32,-4,-3,3,0,0,3,3,-2,2,0,1,2,3,0,1,1,0,1,-213,5,-8,3,1,0,0,-1,0,0,-1,3,-1
KR_6643815017,420,-4,-15,9,-3,-3,4,1,-2,2,0,3,1,4,-1,2,1,0,1,1,1,0,-5,0,-2,2,-1,0,-2,1,-1,-1,1,2,-1
KR_6687379863,420,-2,3,-16,-4,1,3,4,-1,2,1,0,3,3,-3,7,4,-1,2,1,0,-13,7,-2,-2,4,-2,0,1,-1,1,1,-1,4,-1
KR_6742217266,440,-3,0,6,-10,0,1,1,-2,3,1,-3,7,4,-3,5,2,-2,2,0,0,-20,0,-3,-4,7,-1,0,0,-1,1,1,-1,3,-1
KR_6753880957,420,1,-58,1,-4,-5,6,1,0,1,1,-2,2,0,2,1,3,1,0,1,0,2,-6,-3,-4,7,0,0,0,-1,1,1,1,5,-1
KR_6604027978,420,-2,-28,-15,-4,-3,5,2,2,2,4,-4,5,1,0,0,0,1,0,1,0,1,58,0,-5,5,-1,0,-1,-1,-1,-1,-1,3,-1
KR_6716742082,420,0,57,16,-4,-2,2,0,-4,7,3,-4,5,1,4,6,10,2,1,3,-3,-12,-2,-4,-2,6,7,0,0,1,-1,-1,-1,3,-1
KR_6743131101,420,0,-45,15,0,1,0,1,-1,2,1,0,3,3,-1,4,3,1,2,3,0,5,-43,0,-3,3,19,0,-1,1,-1,-1,-1,5,-1
KR_6770277617,420,-5,-58,-15,-10,-2,4,2,-7,9,2,-2,2,0,-2,2,0,3,0,3,-2,-11,-38,-3,-3,6,8,0,-1,-1,1,-1,-1,2,-1
KR_6684755677,420,-3,-79,-35,-13,-7,7,0,2,3,5,1,2,3,-7,8,1,-2,2,0,0,-2,-3,0,-4,4,2,0,-2,-1,-1,-1,1,3,-1
KR_6666288083,420,-1,-5,-23,0,7,1,8,1,0,1,6,1,7,-13,15,2,-1,2,1,1,0,-5,-3,0,3,-2,0,-1,-1,-1,-1,-1,6,-1
KR_6768712493,420,-2,-48,-34,-8,0,0,0,-2,3,1,0,1,1,-4,7,3,-2,3,1,-1,-5,-7,-1,-2,3,1,0,0,-1,1,0,-1,6,-1
KR_6733218801,420,-7,-104,-16,-9,-3,5,2,5,0,5,-5,5,0,-3,3,0,-3,3,0,-1,-2,-29,-3,-3,6,-4,0,-2,-1,-1,-1,-1,5,-1
KR_6635269339,420,-2,42,16,1,0,1,1,-3,6,3,-1,3,2,3,1,4,2,1,3,1,8,16,-2,-3,5,1,0,0,-1,0,-1,1,4,-1
KR_6727505703,440,-6,-59,-64,-6,-5,6,1,0,4,4,-1,3,2,1,1,2,-1,4,3,0,8,0,4,-9,5,1,0,-2,-1,-1,-1,-1,2,-1
KR_6715615524,420,-2,-37,-8,-2,-1,2,1,-3,5,2,1,0,1,2,1,3,-1,2,1,0,-4,-16,2,-9,7,-3,0,1,-1,-1,1,1,6,-1
KR_6664673810,420,5,10,4,11,1,2,3,7,1,8,0,3,3,1,3,4,2,1,3,0,15,-8,1,-4,3,2,0,1,-1,1,-1,1,4,-1
KR_6762010537,420,0,11,-9,3,0,1,1,-1,2,1,3,3,6,2,0,2,-1,2,1,0,4,24,2,-6,4,-5,0,0,-1,-1,0,1,4,-1
KR_6542671346,420,1,-32,37,2,1,2,3,0,5,5,0,1,1,1,2,3,0,1,1,0,1,-10,-1,-6,7,-3,0,0,1,-1,0,-1,2,-1
KR_6768729111,420,-3,-66,40,-10,-1,2,1,-3,3,0,-4,6,2,1,2,3,-3,3,0,0,-3,-13,-4,-6,10,-3,0,-1,1,-1,-1,-1,4,-1
KR_6623906243,420,-4,-22,-9,-7,-2,4,2,-5,8,3,-2,3,1,2,2,4,0,0,0,0,-4,4,3,-8,5,6,0,-1,1,-1,-1,-1,6,-1
KR_6765257477,420,-4,0,-28,-4,-4,4,0,-3,4,1,5,0,5,-1,2,1,-1,1,0,0,-4,-40,-3,-2,5,-2,0,0,-1,1,0,1,1,-1
KR_6757697170,420,0,-40,9,0,-5,5,0,4,1,5,1,1,2,0,4,4,0,1,1,-1,-1,-2,0,-6,6,-1,0,0,1,1,1,-1,6,-1
KR_6768862298,420,0,-49,29,-5,-3,7,4,-1,2,1,-2,5,3,1,3,4,0,1,1,-1,-13,24,-1,-5,6,4,0,0,0,1,-1,-1,0,-1
KR_6720592345,420,-9,-47,-33,-17,0,1,1,-3,3,0,-5,8,3,-6,6,0,-3,4,1,0,-22,-3,1,-6,5,-3,0,-4,-1,-1,-1,-1,4,-1
KR_6770602334,420,-6,-54,4,-9,-4,4,0,-2,3,1,-2,2,0,-1,3,2,0,0,0,0,-11,5,-2,-3,5,-1,0,0,-1,0,0,-1,2,-1
KR_6769779748,420,-2,29,16,-5,6,1,7,-1,2,1,-1,3,2,-6,6,0,-3,4,1,1,-17,11,-6,-4,10,2,0,1,1,1,1,1,2,-1
KR_6740737520,420,-2,-13,16,-7,0,1,1,0,4,4,-1,2,1,-3,3,0,-3,4,1,0,-10,4,-2,-2,4,2,0,-3,1,-1,-1,-1,4,-1
KR_6756159240,420,-2,23,-13,-6,0,2,2,-1,3,2,-2,3,1,0,1,1,-3,3,0,0,-3,-41,3,-8,5,-5,0,1,1,-1,1,-1,3,-1
KR_6618979247,420,0,7,-17,-3,-1,3,2,-3,5,2,0,1,1,2,2,4,-1,2,1,0,-6,14,-2,-5,7,4,0,-1,-1,-1,-1,-1,3,-1
KR_6760626236,420,-2,-22,-8,-9,3,1,4,-2,4,2,-10,10,0,1,2,3,-1,1,0,-2,-7,21,0,-6,6,-3,0,-2,-1,-1,-1,-1,3,-1
KR_6722266039,420,-2,-82,12,-2,-4,5,1,-2,3,1,1,3,4,6,2,8,-3,4,1,0,-1,-108,4,-8,4,-5,0,-1,-1,-1,-1,1,4,-1
KR_6417713369,420,0,-48,12,-2,1,2,3,-1,2,1,-1,2,1,0,3,3,-1,1,0,0,-6,9,0,-7,7,-5,0,0,-1,1,-1,1,1,-1
KR_6760125224,420,3,8,6,5,-3,3,0,3,2,5,2,1,3,3,0,3,0,0,0,0,14,15,3,-8,5,-3,0,-1,-1,-1,-1,1,3,-1
KR_6760165078,440,1,8,-8,-2,-3,4,1,-2,3,1,4,0,4,-2,5,3,1,2,3,2,4,0,-1,-1,2,0,0,1,-1,1,1,1,3,-1
KR_6769833871,420,-2,-32,-46,3,0,0,0,-1,2,1,-1,3,2,6,0,6,-1,1,0,0,2,10,1,-6,5,-2,0,0,1,1,1,1,5,-1
KR_6141951763,420,-9,-129,-15,-15,-9,9,0,-4,8,4,-1,3,2,-1,2,1,0,0,0,0,-16,-280,4,-8,4,-4,0,-2,-1,-1,-1,-1,5,-1
KR_6711275659,420,0,-16,-28,-1,-2,3,1,-1,3,2,10,0,10,-2,5,3,-6,6,0,-1,-8,6,-1,-4,5,-7,0,0,-1,1,0,-1,3,-1
KR_6766979422,420,-1,-72,-5,0,0,1,1,-1,1,0,0,0,0,0,4,4,1,0,1,0,3,-3,0,-6,6,-3,0,-2,-1,-1,-1,-1,6,-1
KR_6696851426,420,-1,-2,0,-4,-1,2,1,-1,3,2,-3,3,0,1,0,1,0,1,1,0,-5,318,-1,-6,7,1,0,0,1,1,0,1,5,-1
KR_6770527729,420,0,-23,-4,-1,3,0,3,1,1,2,-6,9,3,1,2,3,0,0,0,0,2,5,-2,-4,6,2,0,0,-1,-1,0,-1,3,-1
KR_6764608240,420,1,2,-12,-7,-1,3,2,-2,5,3,0,3,3,-3,4,1,-1,2,1,0,-2,-31,-6,-3,9,4,0,1,0,1,1,-1,0,-1
KR_6745752805,420,-1,-5,11,-1,4,0,4,-1,1,0,1,3,4,-4,8,4,-1,1,0,0,-3,12,3,-5,2,-3,0,1,1,1,1,1,2,-1
KR_6694494649,440,-3,-3,-6,-11,-1,2,1,-1,5,4,0,2,2,-6,8,2,-3,3,0,0,-8,29,2,-5,3,-29,0,1,-1,1,1,-1,2,-1
KR_6647355501,420,-2,15,-13,2,0,1,1,1,2,3,3,0,3,-3,3,0,1,0,1,0,-3,-9,4,-10,6,-1,0,0,-1,-1,0,1,4,-1
KR_6685365699,420,-3,14,9,-5,0,4,4,0,2,2,-2,5,3,-2,5,3,-1,1,0,3,-10,0,-3,-8,11,-1,0,1,-1,1,1,1,1,-1
KR_6497237026,420,1,53,4,-6,1,1,2,-3,6,3,-7,8,1,2,3,5,1,2,3,0,-11,13,-1,-6,7,-6,0,-2,-1,-1,-1,1,4,-1
KR_6495696061,420,-4,-39,-13,-13,-3,5,2,-1,5,4,-6,6,0,-3,6,3,0,0,0,-1,-5,48,-1,-3,4,-21,0,-1,1,-1,-1,-1,6,-1
KR_6769552161,420,-4,-18,-52,-7,-1,2,1,-3,7,4,-4,4,0,-1,3,2,2,0,2,1,-5,1,3,-6,3,-3,0,-1,-1,1,-1,1,4,-1
KR_6768813865,420,-1,-70,12,-8,3,3,6,-1,2,1,-4,4,0,-5,7,2,-1,2,1,0,-9,7,1,-6,5,-4,0,-2,1,-1,-1,-1,1,-1
KR_6365057365,420,0,64,-15,0,3,1,4,-1,3,2,1,2,3,-4,5,1,1,0,1,1,-5,0,0,0,0,2,0,-1,-1,-1,-1,1,2,-1
KR_6771017776,420,-5,-89,-32,-12,-5,6,1,0,1,1,-4,4,0,-3,5,2,0,0,0,-2,-3,11,2,-6,4,-2,0,-1,0,-1,-1,-1,0,-1
KR_6757163163,420,-4,-55,-63,-13,0,1,1,-5,8,3,-5,5,0,-3,6,3,0,2,2,-1,-7,-2,2,-5,3,-5,0,-2,-1,-1,-1,-1,6,-1
KR_6510296906,420,-2,-5,-27,-3,3,1,4,-5,6,1,1,2,3,-1,3,2,-1,1,0,0,-4,4,-2,-2,4,3,0,-1,-1,-1,-1,-1,4,-1
KR_6745190601,420,-2,-23,29,-2,0,3,3,-5,6,1,4,1,5,-2,3,1,1,3,4,0,-8,-5,1,-7,6,1,0,-3,0,1,-1,1,0,-1
KR_6716768985,420,1,-64,2,4,2,0,2,-1,3,2,1,2,3,2,0,2,0,2,2,0,-2,3,-1,-2,3,-1,0,0,1,-1,0,1,3,-1
KR_6770695065,420,-3,-34,-60,-3,1,1,2,-1,3,2,-3,5,2,1,1,2,-1,3,2,0,-2,-481,-1,-4,5,-3,0,-1,-1,-1,-1,1,5,-1
KR_6637701608,420,0,-40,-6,1,0,2,2,-1,2,1,0,1,1,1,0,1,1,0,1,0,6,1,5,-7,2,-2,0,0,-1,1,0,-1,3,-1
KR_6727951028,420,-4,-18,-8,-11,1,0,1,-7,7,0,-1,5,4,-3,4,1,-1,3,2,0,-17,-11,-3,-3,6,5,0,0,-1,-1,0,-1,2,-1
KR_6747185398,420,-6,-81,-25,-14,-1,5,4,2,1,3,-12,13,1,-3,6,3,0,1,1,-3,-19,135,-8,-4,12,6,0,-5,-1,-1,-1,-1,5,-1
KR_6724097473,420,-4,-77,-15,-7,-5,6,1,0,1,1,-4,5,1,1,3,4,1,0,1,0,-4,-1,-3,-4,7,-4,0,-2,-1,1,-1,-1,5,-1
KR_6757701666,420,-4,-99,-4,-12,3,1,4,-2,4,2,-3,6,3,-9,10,1,-1,1,0,0,-6,-10,-5,-1,6,3,0,-2,-1,-1,-1,1,6,-1
KR_6760329637,420,0,9,-32,-10,-4,5,1,0,1,1,-3,5,2,-3,5,2,0,1,1,0,-8,25,-1,-4,5,-19,0,-1,-1,-1,1,-1,5,-1
KR_6770849565,420,-1,-27,-20,-4,0,3,3,1,2,3,1,3,4,-5,5,0,-1,2,1,0,-1,7,1,-4,3,-1,0,-1,-1,-1,-1,-1,4,-1
KR_6763565832,420,-3,12,-12,-12,-6,6,0,-1,2,1,-4,4,0,2,1,3,-3,3,0,0,-9,-9,-3,-2,5,-2,0,0,-1,-1,0,1,4,-1
KR_6528126578,440,-1,-28,-26,-2,-5,5,0,-2,4,2,-3,4,1,4,2,6,4,0,4,0,12,-15,-5,-3,8,2,0,-1,1,-1,-1,-1,1,-1
KR_6767892915,420,2,56,-47,5,1,3,4,3,3,6,-3,4,1,5,4,9,-1,1,0,0,5,99,-1,-6,7,3,0,1,-1,0,1,1,6,-1
KR_6751796126,440,2,21,8,2,3,3,6,-2,2,0,0,2,2,-2,7,5,3,0,3,0,8,6,2,-7,5,3,0,0,1,1,0,1,6,-1
KR_6708641122,420,-6,-65,-11,-12,-1,2,1,-8,8,0,1,2,3,-4,4,0,0,0,0,-1,-8,-17,0,-6,6,-3,0,0,-1,1,0,-1,2,-1
KR_6770197707,420,-3,-13,-4,-3,-3,3,0,2,2,4,1,1,2,-3,4,1,0,1,1,0,-4,17,1,-8,7,0,0,0,-1,1,1,1,5,-1
KR_6768911610,420,3,2,19,3,-1,1,0,-2,4,2,1,3,4,3,1,4,2,1,3,0,2,-8,-1,-4,5,4,0,1,-1,-1,1,1,5,-1
KR_6725492367,420,-3,51,-39,-4,1,1,2,-2,4,2,-1,3,2,0,6,6,-2,3,1,0,-12,-13,2,-8,6,-2,0,0,-1,1,0,1,6,-1
KR_6701464861,420,-6,-45,-8,-16,-3,3,0,-6,6,0,3,0,3,-2,4,2,-8,9,1,0,-12,-289,-3,-1,4,-1,0,-1,0,-1,-1,-1,0,-1
KR_6684900707,420,1,-34,24,0,-2,3,1,1,3,4,2,0,2,1,1,2,-2,4,2,0,3,-25,2,-5,3,2,0,-1,1,-1,-1,-1,2,-1
KR_6696563118,420,-3,-98,-13,-5,-1,1,0,-2,4,2,-2,4,2,-1,4,3,1,1,2,0,-3,4,2,-6,4,-3,0,0,1,-1,0,1,3,-1
KR_6726805770,420,2,10,17,3,2,2,4,2,1,3,0,2,2,-1,1,0,0,1,1,0,2,-18,-6,-2,8,7,0,0,-1,1,0,1,4,-1
KR_6766829835,420,-3,-42,-4,-9,-1,1,0,2,0,2,1,1,2,-9,9,0,-2,4,2,0,-13,-225,5,-6,1,-7,0,0,0,1,0,-1,0,-1
KR_6768669542,420,-2,15,-8,-4,1,1,2,-2,5,3,0,2,2,-3,6,3,0,1,1,0,-4,-1,-5,-2,7,2,0,1,1,1,-1,-1,6,-1
KR_6757459669,420,1,-34,7,-2,5,0,5,-6,7,1,-2,3,1,0,0,0,1,0,1,0,-11,-5,1,-4,3,-5,0,-1,-1,1,-1,1,4,-1
KR_6768430402,420,2,100,24,0,0,1,1,1,2,3,3,0,3,-3,4,1,-1,2,1,0,-3,-110,1,-7,6,0,0,0,-1,-1,1,-1,1,-1
KR_6683126204,420,-2,10,-11,-7,-4,4,0,-4,5,1,-5,6,1,5,2,7,1,1,2,0,-7,-3,0,-5,5,1,0,0,1,-1,0,-1,2,-1
KR_6695324091,420,3,27,12,2,0,2,2,-5,7,2,-1,3,2,-1,2,1,9,0,9,0,0,41,-1,-6,7,-11,0,0,-1,1,0,1,6,-1
KR_6767486043,420,-1,14,-12,3,2,2,4,0,3,3,0,2,2,2,5,7,-1,1,0,0,3,23,0,-8,8,-1,0,0,-1,-1,-1,1,1,-1
KR_6750491326,420,-5,-75,-23,-11,3,2,5,-5,6,1,-7,7,0,-2,6,4,0,0,0,0,-11,87,-5,-3,8,-1,0,1,-1,-1,-1,-1,4,-1
KR_6738873297,420,-5,-88,-43,-11,0,2,2,1,4,5,-1,4,3,-10,13,3,-1,1,0,0,-11,470,-1,-4,5,-8,0,-1,-1,-1,-1,-1,2,-1
KR_6751214442,440,0,22,9,2,0,1,1,3,1,4,-1,4,3,0,2,2,0,0,0,2,4,6,3,-11,8,2,0,-1,-1,-1,-1,-1,2,-1
KR_6749888750,420,1,-4,-12,-3,-1,4,3,-4,8,4,-1,3,2,2,1,3,1,2,3,0,1,3,0,-4,4,1,0,1,1,-1,1,1,2,-1
KR_6712301692,420,-1,-30,15,-3,-1,2,1,3,1,4,-2,7,5,-1,1,0,-2,2,0,0,-3,-44,1,-3,2,16,0,1,-1,-1,1,-1,5,-1
KR_6618875437,420,1,-36,8,5,-3,4,1,3,2,5,-2,4,2,6,2,8,1,1,2,1,6,-41,1,-4,3,25,0,-1,-1,-1,-1,1,2,-1
KR_6750880990,420,1,-44,-8,1,1,1,2,-2,5,3,-1,2,1,2,0,2,1,0,1,-1,1,4,3,-9,6,0,0,-1,1,1,-1,-1,5,-1
KR_6743235714,420,1,-37,-3,-4,1,0,1,-1,6,5,-1,2,1,-3,3,0,0,0,0,0,2,23,-2,-4,6,0,0,0,1,-1,0,-1,6,-1
KR_6740918881,420,-1,29,8,-5,1,0,1,-1,1,0,-4,5,1,1,1,2,-2,3,1,0,-8,-40,-1,-6,7,-2,0,0,0,0,1,-1,0,-1
KR_6763981189,420,4,81,-28,15,-1,3,2,0,2,2,6,2,8,10,3,13,0,0,0,-2,10,80,0,-5,5,4,0,3,1,-1,1,-1,2,-1
KR_6723623251,440,-1,-20,-20,1,4,1,5,2,3,5,1,1,2,-5,6,1,-1,2,1,0,-3,16,4,-8,4,-2,0,0,0,0,0,1,0,-1
KR_6658940276,420,-6,-19,-13,-8,-8,8,0,-3,5,2,2,2,4,-1,4,3,2,0,2,0,-3,7,4,-6,2,2,0,0,-1,-1,1,-1,2,-1
KR_6758043566,440,-3,-89,-16,-1,-4,6,2,2,1,3,0,3,3,1,0,1,0,0,0,0,6,-7,0,-7,7,6,0,0,0,-1,0,-1,0,-1
KR_6739520502,420,-2,25,-13,-7,2,0,2,-4,4,0,-2,3,1,-2,4,2,-1,2,1,0,-8,326,-5,0,5,2,0,0,0,-1,-1,-1,0,-1
KR_6737370853,420,-4,-111,-8,-6,0,1,1,3,1,4,0,4,4,-8,11,3,-1,1,0,-1,2,-6,-3,-5,8,1,0,-2,-1,1,-1,-1,6,-1
KR_6754268057,440,-4,-58,1,-7,-2,4,2,-8,8,0,-2,4,2,4,2,6,1,1,2,0,1,17,1,-4,3,-3,0,-1,0,0,-1,-1,0,-1
KR_6753519489,420,0,-44,14,-4,-2,4,2,-1,3,2,0,3,3,1,1,2,-2,2,0,0,-1,-57,-1,-2,3,28,0,-3,-1,-1,-1,-1,3,-1
KR_6769645982,420,0,-26,1,0,-1,3,2,2,1,3,0,3,3,1,2,3,-2,2,0,0,2,79,-3,-4,7,-1,0,1,1,-1,-1,1,3,-1
KR_6745176712,420,1,12,28,-6,3,0,3,-4,4,0,5,1,6,-8,11,3,-2,2,0,-3,-11,1,-3,-1,4,-1,0,2,-1,1,1,-1,6,-1
KR_6742924011,420,2,-14,26,10,1,0,1,5,2,7,2,0,2,-1,2,1,3,0,3,0,6,103,6,-12,6,-4,0,0,-1,1,0,1,3,-1
KR_6714555555,420,-2,1,-23,-8,3,1,4,-7,7,0,0,3,3,-4,6,2,0,0,0,0,-12,-41,-6,-1,7,3,0,-1,-1,1,-1,-1,1,-1
KR_6766171736,420,4,12,16,10,4,1,5,4,0,4,2,3,5,0,3,3,0,1,1,0,9,18,-4,-4,8,-2,0,0,-1,1,1,-1,1,-1
KR_6701090725,420,2,-19,8,3,-2,3,1,0,2,2,3,0,3,1,0,1,1,0,1,0,4,-151,-4,-3,7,5,0,-2,1,-1,-1,1,1,-1
KR_6736409222,420,0,42,-16,-1,-1,1,0,1,1,2,0,3,3,-2,2,0,1,0,1,0,1,-31,-2,-4,6,2,0,0,-1,1,-1,-1,1,-1
KR_6743853500,420,1,61,0,-1,-3,5,2,0,1,1,-1,2,1,4,1,5,-1,2,1,0,5,-2,4,-8,4,-1,0,1,-1,1,1,1,6,-1
KR_6747737025,420,-2,-24,20,-4,2,2,4,2,0,2,-3,6,3,-3,4,1,-2,2,0,0,-13,2,1,-6,5,1,0,1,-1,1,1,1,1,-1
KR_6770569088,420,-1,46,8,-2,-2,2,0,2,2,4,0,1,1,-2,3,1,0,1,1,0,-3,-2,1,-5,4,1,0,1,1,1,1,-1,6,-1
KR_6745996549,440,-2,25,-14,-1,-2,2,0,3,2,5,-3,4,1,1,0,1,0,0,0,0,6,-3,-2,-2,4,-6,0,1,1,1,1,-1,4,-1
KR_6767826158,440,1,58,-13,2,3,0,3,-1,2,1,3,1,4,-4,4,0,1,2,3,0,-3,-19,-4,-1,5,-1,0,1,1,-1,1,1,4,-1
KR_6653782752,420,-1,-36,-8,-2,1,2,3,0,4,4,1,2,3,-2,3,1,-2,3,1,0,-11,12,-3,-2,5,-3,0,0,-1,1,0,1,3,-1
KR_6740140429,420,0,-54,-36,-6,-1,4,3,0,7,7,0,2,2,-3,4,1,-2,2,0,-2,-12,1,-1,-6,7,-2,0,0,-1,1,1,-1,2,-1
KR_6761519136,420,-3,-25,-23,-10,0,3,3,-4,6,2,-4,5,1,0,2,2,-2,5,3,0,-6,-8,0,-2,2,-1,0,-1,-1,1,1,-1,2,-1
KR_6738725480,440,-3,-11,-47,1,-3,4,1,-1,3,2,-1,2,1,1,0,1,5,1,6,0,2,10,1,-7,6,-10,0,0,-1,1,0,1,4,-1
KR_6741807397,420,-2,-52,-40,1,-1,4,3,2,1,3,0,0,0,0,1,1,0,1,1,0,3,28,1,-4,3,-1,0,-1,-1,1,-1,-1,1,-1
KR_6766161148,420,-2,-2,-4,0,-1,2,1,0,4,4,3,0,3,-4,8,4,2,1,3,0,6,-4,-1,-4,5,-2,0,-2,-1,-1,-1,1,4,-1
KR_6730672532,420,-1,-5,15,3,-2,2,0,1,1,2,3,1,4,1,2,3,0,1,1,1,2,-4,-4,-2,6,-2,0,0,1,1,0,1,3,-1
KR_6605156008,440,-1,-109,20,-3,-4,5,1,2,2,4,-5,5,0,2,2,4,2,0,2,0,8,-2,-1,-1,2,2,0,-1,-1,0,-1,-1,5,-1
KR_6640614030,420,1,-24,-13,0,-4,4,0,6,1,7,-1,1,0,-1,3,2,0,0,0,-2,1,30,0,-8,8,4,0,0,1,1,0,-1,4,-1
KR_6725686486,440,1,-24,-38,1,1,5,6,2,2,4,-1,1,0,1,2,3,-2,4,2,-1,5,-8,-2,-4,6,4,0,0,1,-1,0,-1,6,-1
KR_6638031734,420,0,-17,-18,-3,-1,2,1,-1,6,5,-2,4,2,2,0,2,-1,2,1,0,-4,4,5,-8,3,0,0,0,-1,-1,0,-1,2,-1
KR_6771126955,420,-1,-49,8,-9,0,2,2,-6,7,1,-1,4,3,-2,4,2,0,1,1,0,-5,12,-1,-7,8,-2,0,-1,-1,-1,-1,-1,5,-1
KR_6731107857,420,-3,-62,-23,-7,2,1,3,1,3,4,-3,4,1,-2,3,1,-5,6,1,0,-9,-73,-1,-7,8,19,0,-1,-1,1,-1,1,2,-1
KR_6763455195,420,-2,-2,-24,-10,-4,5,1,-5,7,2,-2,2,0,1,0,1,0,2,2,0,-8,294,2,-4,2,-7,0,0,0,-1,0,-1,0,-1
KR_6697978961,420,-3,-97,-29,-9,0,4,4,0,3,3,-4,5,1,-3,3,0,-2,3,1,0,-9,45,1,-7,6,2,0,-1,-1,1,-1,-1,6,-1
KR_6642333844,420,-1,-23,4,-8,-6,6,0,0,2,2,-4,4,0,2,0,2,0,1,1,0,-7,11,3,-7,4,-4,0,-2,-1,-1,-1,-1,6,-1
KR_6771240484,440,3,-2,40,0,-1,2,1,-2,4,2,-1,2,1,5,0,5,-1,1,0,0,6,1,1,-7,6,3,0,0,-1,-1,-1,1,5,-1
KR_6747071886,420,2,-23,-23,5,-2,2,0,3,0,3,0,3,3,5,0,5,-1,2,1,0,8,9,4,-8,4,-2,0,0,1,0,-1,-1,2,-1
KR_6726280479,420,-1,-2,2,0,-3,6,3,-1,1,0,0,3,3,4,1,5,0,3,3,0,-3,-2,1,-8,7,-9,0,-1,1,1,-1,1,6,-1
KR_6656900210,420,-6,-40,9,-19,1,1,2,-8,8,0,-2,2,0,-5,8,3,-5,5,0,-2,-20,-10,-5,-3,8,1,0,-2,-1,-1,-1,-1,4,-1
KR_6719523005,420,-3,-2,0,-2,0,2,2,-3,3,0,2,0,2,0,7,7,-1,2,1,0,-4,0,-3,-2,5,1,0,0,-1,0,1,1,3,-1
KR_6759758816,420,-2,-27,-8,-3,4,0,4,-1,3,2,-5,5,0,-3,5,2,2,0,2,0,-8,-9,0,-5,5,-1,0,0,-1,0,-1,-1,4,-1
KR_6753938091,420,-1,-34,16,-1,2,0,2,-4,4,0,2,2,4,-2,3,1,1,0,1,0,-1,-28,2,-5,3,7,0,0,0,-1,0,1,0,-1
KR_6768748631,420,-4,-33,-28,3,-1,5,4,0,2,2,2,4,6,1,1,2,1,0,1,0,5,-37,0,-4,4,1,0,0,-1,0,0,1,1,-1
KR_6761861621,440,-6,-31,-28,-10,0,3,3,0,2,2,-3,3,0,-5,9,4,-2,4,2,-1,-7,-25,2,-3,1,-2,0,0,1,-1,-1,-1,2,-1
KR_6766631825,420,-3,36,-9,-7,4,0,4,-4,4,0,-2,5,3,-4,4,0,-1,1,0,0,-8,-3,-3,-5,8,2,0,1,-1,1,1,-1,6,-1
KR_6769925937,420,-2,19,-11,-9,-6,8,2,-1,2,1,-1,1,0,0,2,2,-1,1,0,0,-14,-1,-2,-3,5,0,0,-2,1,-1,-1,-1,2,-1
KR_6758743847,420,0,26,-4,4,1,2,3,3,3,6,-2,3,1,0,5,5,2,0,2,-1,2,-31,-1,-5,6,24,0,0,-1,1,0,-1,4,-1
KR_6694883041,420,-3,47,-15,-7,1,1,2,0,0,0,-3,5,2,-4,4,0,-1,3,2,0,-13,-179,-1,-4,5,-2,0,0,-1,1,1,-1,3,-1
KR_6623320743,420,0,-20,6,5,4,1,5,0,3,3,1,1,2,-1,3,2,1,0,1,0,1,6,9,-13,4,-4,0,0,1,1,0,1,6,-1
KR_6718310744,420,-3,-13,8,-4,-2,3,1,0,2,2,-2,5,3,1,1,2,-1,1,0,0,1,-6,0,-3,3,-1,0,0,0,-1,0,1,0,-1
KR_6710628819,420,-5,-104,-36,-8,-3,4,1,-5,6,1,3,0,3,0,1,1,-3,4,1,0,-9,-23,2,-5,3,1,0,-2,-1,-1,-1,-1,2,-1
KR_6769186171,420,-2,-31,-3,-2,1,1,2,-1,3,2,-1,3,2,0,1,1,-1,2,1,0,-1,-6,4,-6,2,1,0,1,1,1,1,-1,1,-1
KR_6695287250,420,-3,-89,-36,-1,-2,2,0,3,1,4,-2,3,1,-1,4,3,1,1,2,0,7,10,3,-7,4,-9,0,-2,1,1,-1,-1,5,-1
KR_6762975724,420,-6,-30,-41,-9,-5,8,3,-4,5,1,-4,4,0,6,1,7,-2,2,0,0,-7,157,4,-7,3,-3,0,0,-1,-1,-1,-1,4,-1
KR_6750181563,420,-4,-7,-33,-2,-3,3,0,-3,4,1,-1,2,1,4,1,5,1,1,2,0,1,-70,2,-3,1,23,0,0,0,-1,1,1,0,-1
KR_6735160547,420,-4,-73,-5,-5,3,2,5,-1,3,2,-3,6,3,-3,6,3,-1,3,2,-1,-4,-8,0,-5,5,-6,0,-2,-1,-1,-1,-1,5,-1
KR_6659284427,420,-2,-45,-4,-4,-2,2,0,-2,4,2,2,1,3,-2,4,2,0,0,0,0,-5,3,-5,-2,7,0,0,-1,1,-1,-1,1,6,-1
KR_6607717742,420,0,-70,19,-2,-1,1,0,-1,3,2,0,2,2,1,3,4,-1,2,1,0,-4,-24,0,-5,5,0,0,-1,1,-1,-1,-1,2,-1
KR_6705811622,420,-2,-32,-24,-6,-6,7,1,0,6,6,1,2,3,0,2,2,-1,1,0,-1,1,7,-2,-4,6,-5,0,-1,1,-1,-1,-1,4,-1
KR_6742193120,420,-3,28,29,-2,3,1,4,-3,5,2,-1,3,2,-1,2,1,0,0,0,0,-9,47,-2,-4,6,-20,0,2,1,1,1,1,2,-1
KR_6430613495,420,2,-57,21,-3,-6,7,1,4,2,6,3,0,3,-3,5,2,-1,2,1,0,-3,-8,-1,-3,4,-1,0,-1,-1,1,-1,-1,1,-1
KR_6768660702,420,-8,-106,-46,-16,2,2,4,0,1,1,-1,2,1,-13,13,0,-4,5,1,0,-6,4,-4,-7,11,-4,0,-2,-1,1,-1,-1,5,-1
KR_6706581155,420,0,5,-9,-5,-3,3,0,-1,3,2,2,2,4,1,2,3,-4,5,1,0,-6,23,2,-6,4,-2,0,-1,1,-1,-1,-1,2,-1
KR_6764883505,420,0,-10,26,-4,1,2,3,-1,2,1,0,1,1,-2,3,1,-2,2,0,1,-7,-14,-8,-1,9,5,0,1,-1,1,1,1,6,-1
KR_6765815494,420,1,44,19,-4,-1,1,0,0,0,0,-1,3,2,-2,5,3,0,0,0,0,-4,21,5,-11,6,-4,0,-1,-1,0,-1,1,4,-1
KR_6742495890,440,0,-54,16,-3,1,1,2,-7,8,1,0,1,1,-2,3,1,5,0,5,0,-6,4,3,-8,5,-6,0,-1,1,-1,-1,-1,3,-1
KR_6767123187,420,-3,-44,0,-10,1,0,1,0,2,2,-7,7,0,-3,5,2,-1,1,0,-2,-6,4,0,-7,7,-1,0,-1,0,-1,-1,-1,0,-1
KR_6769784660,420,0,-46,5,3,0,1,1,4,1,5,1,4,5,-2,4,2,0,2,2,0,3,2,2,-5,3,2,0,-2,-1,-1,-1,1,5,-1
KR_6759674402,420,0,-21,8,2,-3,3,0,5,1,6,-1,3,2,-1,3,2,2,0,2,0,6,2,0,-2,2,-4,0,0,1,-1,0,1,1,-1
KR_6683956193,420,-5,-45,-32,-8,-1,1,0,-6,7,1,-1,3,2,0,1,1,0,1,1,0,-4,2,-1,-5,6,-6,0,0,-1,1,0,-1,2,-1
KR_6766617032,420,1,29,18,1,-2,3,1,0,3,3,2,1,3,1,2,3,0,2,2,0,0,119,-2,-8,10,3,0,0,1,-1,0,-1,6,-1
KR_6767998597,420,-1,-23,0,-5,0,3,3,-1,4,3,-4,5,1,0,1,1,0,1,1,0,5,21,-1,-2,3,0,0,-1,1,-1,-1,-1,5,-1
KR_6770619552,420,1,8,-10,-2,-7,8,1,0,3,3,1,1,2,4,2,6,0,1,1,0,-3,-1,-1,-3,4,-2,0,1,1,-1,-1,-1,2,-1
KR_6699101557,420,-1,-137,33,-3,-4,5,1,2,3,5,3,1,4,-3,3,0,-1,1,0,0,-4,-2,-1,-4,5,-1,0,0,-1,1,0,1,2,-1
KR_6694571622,420,0,-32,0,-3,4,1,5,-2,5,3,-4,4,0,0,2,2,-1,1,0,0,-4,-3,0,-3,3,-2,0,-1,-1,-1,-1,-1,2,-1
KR_6739380183,420,-3,4,-8,-5,-1,3,2,2,1,3,-7,12,5,3,1,4,-2,2,0,0,0,186,-2,-4,6,-1,0,-1,1,-1,-1,-1,1,-1
KR_6330032948,420,-5,-75,4,-11,0,2,2,1,3,4,-2,2,0,-8,8,0,-2,3,1,0,-8,-3,-4,-2,6,0,0,-2,-1,-1,-1,1,1,-1
KR_6739410350,420,0,-8,-28,-3,-2,2,0,1,0,1,0,1,1,0,1,1,-2,2,0,0,-4,-7,1,-4,3,1,0,0,-1,-1,0,1,5,-1
KR_6636293181,420,-2,-31,-19,-6,0,2,2,-2,2,0,-3,4,1,-1,5,4,0,1,1,0,-13,1,-1,-8,9,-7,0,0,-1,1,0,-1,6,-1
KR_6770674875,420,1,30,21,-2,-4,4,0,-2,5,3,5,0,5,-2,7,5,1,1,2,0,0,-11,0,-3,3,1,0,0,-1,1,1,1,4,-1
KR_6637689345,420,-2,-30,26,-11,-7,7,0,0,2,2,0,0,0,-3,4,1,-1,2,1,0,-10,-17,-7,-1,8,3,0,-1,-1,-1,-1,-1,4,-1
KR_6731355240,420,-2,32,8,-8,-1,1,0,-4,4,0,-2,3,1,-1,3,2,0,1,1,0,-15,17,3,-5,2,3,0,0,1,1,0,1,6,-1
KR_6757171086,420,-4,-54,-11,-10,-2,2,0,-6,7,1,0,2,2,-2,3,1,0,1,1,0,-9,4,2,-6,4,-1,0,-2,-1,-1,-1,1,6,-1
KR_6764976846,420,0,-53,15,-3,1,1,2,0,2,2,0,5,5,-5,7,2,1,0,1,-1,0,2,-5,-2,7,-7,0,0,-1,-1,-1,-1,5,-1
KR_6745155074,420,0,-15,4,0,1,0,1,0,4,4,-4,6,2,2,1,3,1,1,2,1,5,3,1,-3,2,-2,0,-1,1,-1,-1,1,1,-1
KR_6740862048,420,0,-76,8,5,1,0,1,-1,3,2,-2,2,0,6,1,7,1,0,1,0,13,-9,-3,-4,7,2,0,-1,-1,-1,-1,-1,6,-1
KR_6763049973,420,3,20,0,-2,1,1,2,4,1,5,-5,5,0,-3,4,1,1,0,1,0,-4,-4,-5,-4,9,1,0,-2,-1,-1,-1,-1,5,-1
KR_6768887049,420,-7,-73,8,-13,-1,2,1,-1,3,2,-8,11,3,-3,5,2,0,2,2,-1,-3,-3,1,-6,5,-4,0,-3,-1,-1,-1,1,6,-1
KR_6528204263,420,3,45,-20,5,-3,6,3,6,3,9,0,1,1,2,1,3,0,0,0,0,2,2,2,-6,4,1,0,1,-1,-1,1,-1,5,-1
KR_6754006297,420,-3,17,-10,-6,-5,5,0,-1,1,0,-2,2,0,2,1,3,0,0,0,0,1,86,1,-4,3,0,0,0,1,-1,-1,-1,6,-1
KR_6395539398,420,0,-41,-11,-1,-4,4,0,5,4,9,-2,3,1,-1,3,2,1,3,4,0,1,-5,-3,-7,10,8,0,0,1,-1,0,1,5,-1
KR_6575307632,420,3,-19,36,3,0,1,1,4,0,4,-3,5,2,1,2,3,1,1,2,2,10,-34,3,-5,2,-3,0,-1,-1,1,-1,1,2,-1
KR_6683362339,420,1,23,-18,1,3,2,5,2,1,3,-2,2,0,-3,3,0,1,0,1,0,-3,0,3,-10,7,1,0,0,1,1,0,1,6,-1
KR_6747164936,420,-1,-59,2,-2,-1,2,1,-1,2,1,1,2,3,2,3,5,-3,5,2,0,3,2,1,-5,4,-3,0,-2,1,1,-1,-1,5,-1
KR_6713005141,440,-3,-50,20,-7,-3,5,2,0,1,1,0,1,1,-1,3,2,-3,4,1,0,-8,12,-2,-3,5,0,0,-1,1,-1,-1,-1,6,-1
KR_6768927137,420,1,-55,12,2,4,0,4,6,1,7,-3,7,4,-2,3,1,-3,5,2,0,2,12,3,-8,5,0,0,1,-1,1,1,1,4,-1
KR_6747985318,420,-2,-39,-8,-5,-1,3,2,0,0,0,-2,4,2,-4,5,1,2,0,2,-3,-10,-8,-2,-1,3,-1,0,-1,-1,-1,-1,-1,4,-1
KR_6534078645,420,-3,2,-15,-13,-8,8,0,0,1,1,-4,5,1,0,2,2,-1,3,2,0,-11,-51,-2,-4,6,17,0,-1,1,-1,-1,-1,1,-1
KR_6731264007,420,-7,-58,-1,-20,-8,9,1,-5,6,1,-3,4,1,-1,2,1,-3,4,1,-2,-17,9,-3,-5,8,1,0,-1,-1,1,-1,1,6,-1
KR_6747887487,440,-7,-147,-6,-12,-3,3,0,-3,3,0,-4,5,1,-2,2,0,0,1,1,0,-7,-9,-1,-3,4,1,0,-2,-1,-1,-1,-1,6,-1
KR_6579315022,420,1,3,16,1,0,1,1,-1,4,3,3,0,3,-2,3,1,1,1,2,0,6,-201,1,-5,4,0,0,0,1,0,1,-1,4,-1
KR_6766190373,420,-4,-26,0,-4,1,1,2,-2,5,3,-3,7,4,-1,4,3,1,1,2,0,4,-6,1,-4,3,1,0,0,-1,1,0,1,6,-1
KR_6768053234,440,-3,-79,17,-6,-1,1,0,5,0,5,-9,9,0,-1,2,1,0,0,0,0,2,-1,3,-7,4,-4,0,0,-1,1,0,-1,2,-1
KR_6724023768,420,-1,-24,22,-4,-2,5,3,-2,2,0,3,2,5,-2,4,2,-1,1,0,0,-7,-7,-1,-2,3,-1,0,-2,1,-1,-1,1,5,-1
KR_6673286658,420,-4,-11,-20,-8,5,3,8,-1,3,2,-5,7,2,-3,3,0,-4,4,0,1,-3,-6,-4,-3,7,-1,0,-3,1,-1,-1,1,1,-1
KR_6755519133,420,-3,11,-37,-9,-3,5,2,-3,6,3,-3,4,1,1,2,3,-1,2,1,0,-19,8,0,-7,7,-1,0,1,-1,1,1,1,2,-1
KR_6767064812,420,0,-33,-28,3,-2,2,0,2,2,4,-1,1,0,4,0,4,0,1,1,0,5,3,3,-6,3,1,0,0,-1,-1,0,1,6,-1
KR_6762331173,420,-3,-59,-12,0,0,4,4,4,0,4,-2,2,0,1,0,1,-3,3,0,0,2,-7,-3,0,3,3,0,-1,-1,-1,-1,1,4,-1
KR_6702834640,420,1,3,-1,0,-1,3,2,3,1,4,-2,5,3,-1,1,0,1,3,4,0,2,-342,-1,-4,5,3,0,-1,-1,-1,-1,1,5,-1
KR_6655780202,420,-4,6,-1,-8,-2,2,0,1,4,5,0,0,0,-4,4,0,-3,4,1,-2,-8,-18,-4,-3,7,-3,0,-2,-1,1,-1,-1,6,-1
KR_6754453847,420,-4,13,-28,-8,0,1,1,-2,4,2,-2,3,1,-3,5,2,-1,2,1,0,-10,-1,0,-4,4,0,0,0,0,-1,1,-1,0,-1
KR_6744460044,420,-2,-50,-12,5,-2,3,1,3,5,8,4,1,5,-1,4,3,1,0,1,1,9,-20,-5,-2,7,1,0,0,1,-1,-1,1,4,-1
KR_6751695269,420,-2,-30,-27,-1,0,1,1,0,1,1,-2,5,3,0,2,2,1,1,2,0,-4,-290,-1,-6,7,-5,0,0,-1,1,0,1,6,-1
KR_6762000222,420,2,19,0,-2,1,2,3,-1,3,2,0,2,2,-1,5,4,-1,2,1,0,-5,354,-6,-1,7,2,0,0,-1,1,0,1,4,-1
KR_6711742783,420,0,58,-6,-3,0,2,2,-4,5,1,-5,6,1,2,2,4,4,0,4,2,-3,-4,1,-4,3,2,0,0,-1,1,1,1,1,-1
KR_6767312374,420,-4,-21,-20,-9,-2,2,0,1,2,3,-2,2,0,-4,5,1,-2,2,0,0,-11,9,0,-5,5,1,0,0,1,-1,0,-1,1,-1
KR_6762022226,420,2,90,15,2,0,2,2,0,1,1,-2,2,0,4,0,4,0,0,0,0,0,34,1,-3,2,-37,0,0,1,-1,0,1,5,-1
KR_6769597159,420,-1,29,10,-7,1,0,1,-1,6,5,-7,9,2,1,3,4,-1,1,0,2,-10,-7,-3,-3,6,-4,0,0,1,-1,0,1,2,-1
KR_6730443172,420,-3,-87,-12,-5,-1,2,1,-3,6,3,-2,2,0,1,3,4,0,0,0,-1,-6,-1,-2,-6,8,0,0,-1,1,-1,-1,-1,1,-1
KR_6770892347,420,0,-17,-23,-2,-2,3,1,-4,5,1,-2,2,0,7,1,8,-1,2,1,0,-5,1,-1,-6,7,4,0,1,1,1,1,1,3,-1
KR_6678514054,420,0,-28,23,-2,-1,2,1,0,2,2,4,1,5,-6,6,0,1,0,1,0,-6,21,-2,-3,5,-6,0,0,-1,0,-1,-1,3,-1
KR_6747236831,420,-2,9,27,-4,-2,2,0,-3,5,2,-2,3,1,1,4,5,2,1,3,0,-14,-144,3,-9,6,1,0,0,-1,-1,0,1,4,-1
KR_6752202436,420,1,24,4,2,2,1,3,1,2,3,1,2,3,-2,3,1,0,0,0,0,-2,21,-2,-3,5,-4,0,1,1,-1,1,1,3,-1
KR_6760787822,420,1,-39,16,4,0,0,0,3,1,4,-1,4,3,1,3,4,1,1,2,0,-1,21,1,-3,2,-2,0,0,0,1,-1,1,0,-1
KR_6637667242,420,-2,42,-3,-8,0,1,1,-1,4,3,0,3,3,-6,6,0,-1,2,1,0,-11,-2,2,-10,8,-2,0,-1,-1,-1,-1,1,3,-1
KR_6768788719,420,-4,-68,-33,-7,-3,4,1,2,0,2,-3,6,3,-3,4,1,0,2,2,0,-1,-6,-4,-3,7,0,0,-1,-1,-1,-1,1,2,-1
KR_6611366661,420,3,76,31,4,3,3,6,3,1,4,-1,2,1,-1,1,0,0,2,2,0,0,45,1,-5,4,-7,0,1,-1,1,1,-1,6,-1
KR_6771169203,420,2,-9,-12,1,0,1,1,2,1,3,-2,4,2,-1,1,0,2,0,2,0,2,125,3,-6,3,-1,0,0,0,-1,0,1,0,-1
KR_6742094604,420,-2,2,3,-4,1,3,4,-4,4,0,3,1,4,-6,6,0,2,0,2,-1,-13,-4,0,-4,4,-1,0,-1,-1,1,-1,-1,3,-1
KR_6505131948,440,-3,37,-3,-5,-1,1,0,-1,4,3,2,3,5,0,3,3,-5,5,0,0,-7,-34,4,-7,3,-1,0,0,0,0,1,-1,0,-1
KR_6769341847,420,0,-30,-7,-7,1,2,3,-7,7,0,-1,4,3,-1,4,3,1,0,1,0,-7,0,-1,-4,5,-4,0,-1,1,-1,-1,-1,5,-1
KR_6768250997,420,-5,-47,-9,-17,0,3,3,-3,3,0,-7,7,0,-7,9,2,0,1,1,-1,-29,6,0,-4,4,-9,0,-1,-1,-1,-1,-1,4,-1
KR_6767671774,420,2,-37,17,2,3,0,3,-1,1,0,-5,5,0,2,0,2,3,0,3,0,6,3,2,-4,2,-1,0,0,-1,0,0,-1,2,-1
KR_6683159505,420,6,115,9,8,-3,4,1,3,2,5,2,2,4,6,0,6,0,2,2,-1,6,-8,-3,-4,7,4,0,2,-1,-1,1,-1,4,-1
KR_6597938408,420,-2,-51,-33,-7,0,1,1,3,2,5,-7,7,0,-4,7,3,1,1,2,0,-15,-1,-3,-2,5,0,0,-4,1,-1,-1,1,4,-1
KR_6756362831,420,-1,34,-2,0,0,1,1,2,0,2,-4,4,0,3,3,6,-1,3,2,0,4,135,5,-11,6,1,0,2,-1,-1,1,1,4,-1
KR_6640236773,420,-3,-44,-27,-3,-2,2,0,1,2,3,-3,6,3,2,2,4,-1,2,1,0,-1,-7,-4,-4,8,3,0,-1,1,-1,-1,1,4,-1
KR_6762244626,420,1,-51,-12,4,1,3,4,6,1,7,-3,3,0,-2,4,2,2,2,4,0,3,301,-5,-1,6,-5,0,1,1,1,1,-1,3,-1
KR_6767774419,420,-1,36,21,-3,-1,1,0,0,3,3,-2,3,1,-2,5,3,2,0,2,0,0,13,4,-6,2,1,0,1,1,-1,1,1,3,-1
KR_6603825145,420,-1,-54,12,-5,3,0,3,0,2,2,1,2,3,-8,8,0,-1,1,0,0,-7,32,1,-5,4,-7,0,0,-1,1,1,-1,4,-1
KR_6759786611,440,-3,-41,-6,-11,-1,1,0,-5,6,1,-5,6,1,0,5,5,0,3,3,0,1,-5,-3,-3,6,-1,0,-1,-1,-1,-1,-1,2,-1
KR_6734153564,420,-1,-15,-18,1,0,1,1,3,2,5,-1,2,1,-1,4,3,0,2,2,0,3,-114,0,-4,4,0,0,-2,-1,1,-1,-1,3,-1
KR_6747465827,440,0,8,4,-3,2,1,3,-7,7,0,1,2,3,-2,4,2,3,0,3,0,-16,-9,-2,-3,5,2,0,0,-1,-1,-1,1,1,-1
KR_6743099660,420,0,-9,-36,3,0,3,3,-2,4,2,2,0,2,1,1,2,2,1,3,0,3,2,1,-8,7,1,0,0,-1,-1,-1,-1,2,-1
KR_6762474704,420,0,31,-8,-4,2,1,3,-5,6,1,1,2,3,-2,2,0,0,1,1,1,-8,88,-4,-4,8,-3,0,1,-1,-1,1,1,4,-1
KR_6770275239,420,-2,-29,-8,-10,-4,5,1,-4,5,1,-1,1,0,0,0,0,-1,1,0,0,-10,-10,-4,-3,7,-2,0,-1,1,0,-1,-1,3,-1
KR_6760416479,440,0,-14,-6,-3,1,0,1,-1,2,1,-1,4,3,-3,5,2,1,0,1,0,-5,-12,3,-4,1,-3,0,0,1,0,0,-1,2,-1
KR_6661837771,420,-7,-65,-40,-9,-1,5,4,-4,4,0,-3,3,0,4,1,5,-5,7,2,0,-1,1,3,-5,2,-5,0,-1,-1,-1,-1,1,4,-1
KR_6653730823,420,-2,-31,4,1,0,0,0,-2,3,1,4,0,4,1,1,2,-2,2,0,1,0,5,2,-6,4,0,0,-1,0,-1,-1,1,0,-1
KR_6669635710,420,3,11,27,1,0,1,1,1,2,3,3,1,4,-3,5,2,0,1,1,0,-3,-1,3,-6,3,0,0,0,1,-1,0,-1,5,-1
KR_6621593971,420,0,-33,-9,2,3,1,4,-3,6,3,-5,7,2,3,1,4,4,0,4,0,-3,2,1,-8,7,-3,0,-1,-1,1,-1,1,2,-1
KR_6767347653,420,0,-30,-4,-1,-2,3,1,-2,4,2,-2,2,0,4,0,4,1,0,1,0,5,-24,1,-8,7,0,0,-1,1,-1,-1,1,2,-1
KR_6595863190,420,-4,-63,-6,-14,-4,4,0,1,2,3,-1,5,4,-8,8,0,-2,2,0,0,-20,-6,-6,-3,9,-4,0,-2,-1,-1,-1,-1,5,-1
KR_6685262783,420,-2,-33,-24,-1,1,0,1,-3,4,1,2,1,3,-1,1,0,0,0,0,0,2,267,-2,-2,4,0,0,0,-1,-1,0,1,5,-1
KR_6769775590,420,-2,39,-19,-1,0,3,3,-2,4,2,0,3,3,1,3,4,0,2,2,0,-1,19,0,-3,3,-5,0,-1,1,-1,-1,-1,2,-1
KR_6760975990,420,0,59,0,6,8,1,9,-5,8,3,0,1,1,6,0,6,-3,4,1,0,3,-40,-1,-4,5,13,0,0,1,1,1,1,1,-1
KR_6768041533,420,-3,71,-16,-11,-1,1,0,-2,3,1,-3,6,3,-3,3,0,-2,2,0,0,-13,-8,-5,-3,8,0,0,0,-1,-1,1,-1,6,-1
KR_6766884444,440,-1,-9,-23,-11,-2,5,3,-7,7,0,3,1,4,-3,4,1,-2,2,0,0,-6,28,4,-8,4,-8,0,0,-1,-1,-1,-1,1,-1
KR_6715285693,420,-5,-33,-16,-10,0,0,0,-6,7,1,-4,6,2,0,1,1,0,3,3,-1,-9,-139,-7,-3,10,3,0,0,1,-1,-1,-1,6,-1
KR_6758868004,420,-3,-42,-4,-14,-2,3,1,-2,5,3,-1,2,1,-2,3,1,-7,8,1,0,-10,-8,-1,-4,5,-2,0,0,0,-1,0,-1,0,-1
KR_6756412873,420,-2,5,12,-3,0,1,1,-3,4,1,0,4,4,0,5,5,0,0,0,0,3,-198,-4,-2,6,3,0,0,1,-1,0,-1,4,-1
KR_6743497410,420,-1,14,-12,0,-3,3,0,4,0,4,0,1,1,0,1,1,-1,1,0,0,0,-9,-3,-2,5,1,0,0,0,1,0,1,0,-1
KR_6768749727,420,-4,-6,-14,-4,1,0,1,0,0,0,-2,5,3,-2,2,0,-1,2,1,0,-5,-8,-5,-6,11,3,0,-1,-1,1,-1,1,6,-1
KR_6711930429,420,-5,-35,-12,-11,1,2,3,2,0,2,-4,6,2,-4,6,2,-6,6,0,0,-18,-18,1,-7,6,11,0,-2,-1,0,-1,-1,2,-1
KR_6724689666,420,-1,-32,32,-3,-2,3,1,-1,4,3,-1,4,3,2,1,3,-1,1,0,0,-6,-26,-5,-4,9,4,0,0,-1,-1,-1,1,2,-1
KR_6332503964,440,-2,-43,-12,-6,-4,5,1,-1,5,4,2,1,3,-3,5,2,0,1,1,0,-13,11,-3,-3,6,3,0,-3,1,-1,-1,-1,3,-1
KR_6762604578,420,-3,-33,-12,-9,-7,8,1,-1,5,4,0,2,2,-3,5,2,2,0,2,-2,-14,109,4,-9,5,-7,0,-1,-1,-1,-1,-1,4,-1
KR_6681209412,420,-6,-77,-12,-10,-2,3,1,-3,5,2,-1,5,4,-4,5,1,0,0,0,0,-8,-9,2,-6,4,5,0,-2,1,1,-1,1,4,-1
KR_6516815655,420,-2,-37,12,-3,1,0,1,-1,6,5,2,2,4,-3,5,2,-2,3,1,1,-10,-392,-3,-2,5,0,0,0,-1,-1,-1,1,1,-1
KR_6744050963,420,-5,-57,-1,-18,-5,7,2,2,2,4,-10,11,1,-1,2,1,-4,4,0,0,-18,-1,-4,-3,7,-1,0,-3,-1,1,-1,-1,6,-1
KR_6625894557,420,1,-37,-4,5,1,1,2,-1,4,3,3,2,5,1,4,5,1,1,2,0,6,146,-2,-4,6,2,0,-1,1,-1,-1,1,4,-1
KR_6770946738,420,-4,-5,-35,-13,-1,2,1,0,3,3,-3,6,3,-7,9,2,-2,2,0,0,-17,-130,-4,-1,5,-3,0,-3,-1,-1,-1,-1,1,-1
KR_6752383708,420,0,-9,-16,-5,-8,10,2,0,2,2,1,5,6,4,1,5,-2,5,3,1,-2,-2,-4,-5,9,1,0,-1,-1,-1,-1,-1,5,-1
KR_6739488653,420,2,35,-16,-2,3,0,3,0,4,4,-3,4,1,-1,5,4,-1,1,0,0,-10,5,3,-5,2,0,0,1,-1,1,1,-1,2,-1
KR_6719122059,420,-2,-1,16,-5,4,2,6,-1,3,2,-7,8,1,-3,3,0,2,0,2,0,0,-1,4,-9,5,-6,0,-1,0,0,-1,-1,0,-1
KR_6768489448,420,-2,-27,-31,-5,2,0,2,0,3,3,-6,7,1,-1,3,2,0,0,0,0,-11,-8,-3,-2,5,0,0,-1,-1,-1,-1,1,6,-1
KR_6733851972,420,0,26,-20,2,-1,4,3,2,2,4,4,2,6,-2,4,2,-1,2,1,1,-3,-21,2,-6,4,-2,0,1,-1,1,1,1,4,-1
KR_6758505797,420,-3,-69,-23,-3,-2,3,1,0,1,1,0,1,1,-2,4,2,1,0,1,0,3,5,2,-7,5,-3,0,-1,-1,-1,-1,-1,1,-1
KR_6769695836,420,0,52,12,-5,3,0,3,-3,4,1,-4,4,0,-1,2,1,0,0,0,0,-9,-6,0,-3,3,-2,0,1,1,-1,-1,1,3,-1
KR_6706728043,420,-3,-40,-17,-5,-7,7,0,2,3,5,0,1,1,0,4,4,0,1,1,0,-5,9,9,-12,3,-3,0,-1,1,1,-1,1,5,-1
KR_6767050799,420,-3,-7,-28,0,-3,4,1,0,0,0,-2,3,1,4,0,4,1,0,1,0,-2,-7,-10,-2,12,0,0,-1,1,-1,-1,1,1,-1
KR_6657060753,420,0,-55,-12,12,1,1,2,3,2,5,7,0,7,-1,3,2,2,1,3,1,8,22,4,-7,3,5,0,1,1,1,1,1,5,-1
KR_6723679898,440,-2,-5,1,-4,2,0,2,1,0,1,-2,4,2,-3,4,1,-2,2,0,0,-6,1,-3,-4,7,-3,0,-2,1,-1,-1,1,2,-1
KR_6748007581,440,-7,-168,10,-12,-2,2,0,1,2,3,-5,7,2,-5,7,2,-1,1,0,-2,-10,2,0,-4,4,-1,0,-3,-1,-1,-1,-1,4,-1
KR_6744460839,420,0,-26,5,5,3,2,5,6,1,7,-1,1,0,0,3,3,-3,5,2,0,9,-3,-2,-4,6,1,0,-3,1,1,-1,1,5,-1
KR_6740553601,440,0,24,-28,-6,2,0,2,-2,3,1,-1,1,0,-5,5,0,0,1,1,0,-9,-27,-3,-3,6,1,0,0,-1,1,-1,-1,6,-1
KR_6722641230,420,1,20,35,3,4,1,5,2,1,3,1,0,1,-5,7,2,1,0,1,0,2,-54,3,-7,4,0,0,-1,1,-1,-1,-1,6,-1
KR_6764332151,420,-2,-26,-2,-12,-1,3,2,1,3,4,-3,3,0,-7,7,0,-2,2,0,0,-21,-4,-5,-3,8,0,0,-1,-1,1,-1,-1,6,-1
KR_6597585214,420,0,-18,20,7,1,3,4,0,4,4,4,2,6,-1,2,1,3,1,4,0,12,8,3,-9,6,3,0,1,1,1,1,1,2,-1
KR_6672742828,420,-3,-12,-3,-5,-3,3,0,-2,3,1,-1,2,1,4,2,6,-3,4,1,1,-2,-8,-3,-5,8,4,0,-1,1,-1,-1,1,5,-1
KR_6769117170,420,-4,-13,-16,-16,-2,3,1,-5,6,1,-2,4,2,-5,5,0,-2,2,0,0,-21,6,-3,-5,8,4,0,-1,1,-1,-1,-1,6,-1
KR_6749426270,420,-1,-11,4,-1,3,1,4,-1,3,2,2,0,2,-4,4,0,-1,3,2,0,-7,6,0,-7,7,-3,0,-1,-1,1,-1,1,4,-1
KR_6750969821,420,-5,-65,-28,-10,-4,5,1,0,1,1,-7,8,1,1,3,4,0,2,2,0,-8,-31,1,-9,8,3,0,-2,0,-1,-1,-1,0,-1
KR_6695138999,420,0,-7,13,-2,1,2,3,-3,5,2,-1,2,1,0,1,1,1,0,1,0,6,27,-1,-5,6,-3,0,0,1,0,0,-1,6,-1
KR_6754058750,420,-7,-85,-12,-13,-1,2,1,-5,5,0,-2,3,1,0,2,2,-5,7,2,1,-6,-3,0,-6,6,2,0,-1,0,-1,-1,1,0,-1
KR_6746451385,440,-4,-86,0,-5,-7,7,0,7,0,7,-2,2,0,1,1,2,-4,7,3,0,-5,173,-7,-2,9,0,0,-2,-1,-1,-1,-1,6,-1
KR_6734893154,420,2,53,0,6,0,0,0,-1,5,4,3,0,3,0,2,2,4,0,4,0,7,15,-6,-1,7,5,0,-1,1,-1,-1,1,4,-1
KR_6658863050,420,0,2,7,-1,-7,7,0,-1,5,4,1,1,2,5,0,5,1,1,2,-1,-3,-2,4,-10,6,3,0,-1,-1,1,-1,-1,4,-1
KR_6729999938,420,-3,-33,-19,-6,0,2,2,-3,5,2,-1,2,1,-5,5,0,3,0,3,0,-15,2,4,-5,1,-1,0,-1,-1,1,-1,1,6,-1
KR_6738714917,420,-5,-12,-36,-8,-1,2,1,-1,2,1,-1,2,1,-4,8,4,-1,1,0,-1,-15,-11,-2,-6,8,3,0,0,1,1,0,-1,1,-1
KR_6630731001,420,-1,-70,-12,0,1,2,3,2,4,6,-1,3,2,-3,4,1,1,2,3,0,3,-50,0,-5,5,20,0,-2,1,1,-1,-1,4,-1
KR_6748520498,420,0,-22,4,0,-2,2,0,2,1,3,1,2,3,-1,4,3,0,0,0,0,0,-8,-9,-2,11,-2,0,0,-1,1,0,-1,2,-1
KR_6761455031,420,4,59,31,10,2,2,4,3,1,4,0,2,2,3,1,4,2,2,4,0,5,9,0,-5,5,0,0,1,1,1,1,1,5,-1
KR_6766194508,420,-8,-89,-49,-17,-4,4,0,-7,9,2,-3,5,2,1,1,2,-4,4,0,0,-9,23,2,-2,0,0,0,-2,0,-1,-1,-1,0,-1
KR_6709606636,420,-3,-28,1,-5,1,1,2,0,4,4,-4,4,0,-2,2,0,0,1,1,0,-9,-2,3,-7,4,-1,0,-3,-1,-1,-1,-1,3,-1
KR_6640537302,420,-3,-58,-28,-8,-3,5,2,-1,2,1,-2,2,0,-1,2,1,-1,1,0,0,-3,4,2,-8,6,-3,0,0,1,-1,0,-1,6,-1
KR_6727210021,420,-4,-58,10,-10,-4,6,2,-3,7,4,1,5,6,-3,7,4,-1,2,1,0,-8,-2,-6,-3,9,-1,0,-4,1,-1,-1,1,5,-1
KR_6614760382,420,-2,-29,4,-5,-4,4,0,-3,6,3,-2,3,1,2,1,3,2,0,2,0,4,-115,-1,-4,5,0,0,0,1,-1,0,1,5,-1
KR_6633090806,420,0,41,16,5,2,1,3,2,2,4,-2,3,1,0,3,3,3,0,3,0,-4,-9,-3,-4,7,2,0,1,1,-1,1,1,5,-1
KR_6730657922,420,-4,-46,-11,-8,1,2,3,-5,5,0,-2,2,0,-2,4,2,0,0,0,-1,-11,-8,-5,-2,7,1,0,-2,-1,-1,-1,-1,4,-1
KR_6757115592,420,-6,-55,-5,-11,-4,4,0,-5,7,2,-2,2,0,3,1,4,-3,3,0,1,-4,1,2,-6,4,-4,0,-1,-1,-1,-1,1,5,-1
KR_6729777630,420,-4,36,-3,-13,-4,6,2,-4,7,3,0,3,3,-2,2,0,-3,3,0,0,-25,-10,-8,-3,11,5,0,0,-1,-1,-1,-1,2,-1
KR_6724977707,420,1,40,4,5,0,1,1,1,4,5,1,2,3,3,1,4,0,1,1,0,11,9,3,-5,2,4,0,0,1,-1,-1,-1,6,-1
KR_6768225849,420,0,14,0,-1,0,3,3,-1,2,1,1,0,1,-2,2,0,1,1,2,0,0,7,0,-3,3,4,0,0,-1,1,0,-1,6,-1
KR_6759908630,420,-1,-9,5,-2,1,1,2,1,2,3,-2,2,0,4,1,5,-6,9,3,0,7,1,2,-8,6,-4,0,-1,-1,1,-1,1,5,-1
KR_6726224992,420,2,44,-21,1,2,1,3,-5,5,0,-1,3,2,6,5,11,-1,3,2,0,1,-3,5,-9,4,0,0,0,-1,-1,0,-1,5,-1
KR_6665708962,420,-3,-95,-2,-7,0,2,2,1,1,2,-2,3,1,-1,3,2,-5,6,1,0,-11,1,3,-10,7,-3,0,0,1,1,0,-1,4,-1
KR_6767909532,420,2,1,-7,1,0,1,1,-1,4,3,1,0,1,2,0,2,-1,1,0,0,0,9,-1,-3,4,-2,0,0,-1,-1,0,-1,3,-1
KR_6598256461,420,-6,-59,-29,-18,-6,6,0,0,2,2,-3,5,2,-8,8,0,-1,2,1,0,-22,-19,3,-7,4,0,-1,-4,-1,-1,-1,-1,1,-1
KR_6760573401,420,0,23,0,1,-3,5,2,1,0,1,-5,6,1,1,2,3,7,0,7,0,4,4,6,-10,4,-1,0,0,1,-1,1,1,3,-1
KR_6757822344,440,-2,-1,9,-10,-2,2,0,-1,3,2,0,4,4,-6,9,3,-1,2,1,-1,-10,0,-2,-4,6,2,0,-1,1,-1,-1,-1,6,-1
KR_6627137506,420,-1,-23,-1,2,-1,2,1,-1,1,0,-2,4,2,1,1,2,5,1,6,1,4,7,6,-8,2,1,0,1,1,1,1,-1,3,-1
KR_6672851193,420,1,1,20,-3,-1,3,2,-5,8,3,1,0,1,2,1,3,0,3,3,0,-4,-4,-3,-4,7,10,0,1,1,1,1,-1,1,-1
KR_6744233001,440,-6,-113,0,-11,-7,8,1,1,3,4,3,2,5,-6,10,4,-2,2,0,1,-12,-1,-2,-3,5,1,0,-3,-1,-1,-1,-1,1,-1
KR_6746297820,420,0,30,7,-2,2,0,2,2,2,4,1,1,2,-6,7,1,-1,3,2,0,-1,-12,-2,-4,6,1,0,0,-1,-1,0,-1,5,-1
KR_6739052505,420,1,17,-12,-2,3,1,4,1,3,4,-4,6,2,-1,3,2,-1,1,0,0,-2,14,7,-10,3,-1,0,-1,-1,-1,-1,-1,6,-1
KR_6717674491,420,-2,-3,19,-10,-1,2,1,-4,5,1,-4,6,2,0,1,1,-1,1,0,0,-13,0,3,-6,3,3,0,1,-1,-1,1,-1,1,-1
KR_6715129499,420,1,-8,-4,7,0,1,1,2,2,4,5,1,6,0,4,4,0,2,2,0,8,8,-1,-4,5,5,0,-1,1,-1,-1,-1,2,-1
KR_6609539244,420,1,11,-4,3,7,0,7,0,2,2,-2,2,0,1,2,3,-3,3,0,0,-2,8,4,-6,2,-6,0,1,1,1,1,1,6,-1
KR_6769914861,440,2,-60,8,5,-2,4,2,2,1,3,3,0,3,1,2,3,1,0,1,0,10,-7,0,-4,4,0,0,0,1,0,0,-1,4,-1
KR_6505220301,440,5,88,18,7,3,5,8,1,1,2,-2,3,1,1,0,1,4,0,4,0,10,-9,1,-3,2,-2,0,1,1,-1,-1,1,4,-1
KR_6769218786,420,-3,-19,-20,-9,0,3,3,-1,3,2,-1,2,1,-5,6,1,-2,3,1,-1,-14,3,-2,-6,8,1,0,0,0,1,1,-1,0,-1
KR_6693428377,420,-2,13,4,-4,-3,3,0,-2,5,3,6,2,8,-6,8,2,1,0,1,-2,-8,-14,-7,-2,9,1,0,0,-1,-1,-1,-1,6,-1
KR_6762186806,420,2,-20,23,-5,2,1,3,2,1,3,-2,5,3,-5,7,2,-2,2,0,-1,-11,8,1,-4,3,-1,0,1,1,1,1,-1,3,-1
KR_6763161814,420,-3,-38,-8,0,-1,3,2,-2,3,1,-1,4,3,3,0,3,1,0,1,1,1,-2,2,-4,2,-6,0,-1,1,1,-1,1,1,-1
KR_6712407587,420,-2,-63,0,-7,-3,4,1,-3,3,0,-2,3,1,3,2,5,-2,2,0,0,-6,7,1,-6,5,1,0,-1,1,-1,-1,-1,1,-1
KR_6602099648,420,-3,-68,-47,1,-1,3,2,2,0,2,4,0,4,-3,6,3,-1,1,0,0,1,10,6,-10,4,1,0,-3,-1,-1,-1,-1,3,-1
KR_6768168471,420,-3,24,-4,-9,-4,5,1,-5,7,2,1,1,2,-1,1,0,0,1,1,0,-16,-2,-1,-4,5,2,0,-1,-1,1,-1,-1,5,-1
KR_6495961218,420,-2,10,2,1,-5,5,0,2,3,5,0,5,5,2,0,2,2,0,2,-1,0,268,3,-7,4,-1,0,-1,1,-1,1,-1,6,-1
KR_6770470814,420,-6,-103,-33,-15,-3,4,1,-3,4,1,-6,6,0,-6,9,3,3,1,4,0,-15,-9,-5,-2,7,1,0,-2,-1,-1,-1,1,1,-1
KR_6746142576,420,2,62,18,0,-2,2,0,1,1,2,1,5,6,-1,2,1,1,0,1,0,3,-12,2,-3,1,-2,0,1,0,0,1,-1,0,-1
KR_6767110186,420,-2,-44,-45,-2,1,0,1,-1,2,1,0,1,1,0,3,3,-2,2,0,0,1,0,-1,-6,7,-1,0,0,-1,-1,0,1,2,-1
KR_6666756591,420,-4,-75,-4,-10,-4,4,0,-1,3,2,-2,6,4,-1,4,3,-2,2,0,0,-3,46,-1,-7,8,6,0,-2,-1,1,-1,-1,5,-1
KR_6755019844,420,-7,-94,8,-9,-5,5,0,-4,5,1,-2,2,0,0,3,3,2,0,2,0,-7,6,-3,-3,6,-5,0,-2,-1,-1,-1,-1,4,-1
KR_6733220415,420,1,-7,21,-4,-1,2,1,5,0,5,1,1,2,-8,8,0,-1,1,0,0,2,4,-1,-6,7,-4,0,-1,-1,-1,-1,1,5,-1
KR_6759492825,420,1,38,-53,0,-5,7,2,-2,4,2,2,1,3,3,2,5,2,0,2,0,3,-3,0,-6,6,6,0,1,-1,-1,1,-1,3,-1
KR_6756862385,420,-4,-16,-32,-6,-3,5,2,-1,5,4,-4,6,2,3,2,5,-1,1,0,0,2,275,4,-6,2,6,0,-1,-1,-1,-1,1,2,-1
KR_6744014392,420,-1,-61,14,-5,-1,2,1,0,2,2,-1,3,2,-1,2,1,-2,2,0,0,-9,7,-3,-1,4,2,0,0,0,1,0,1,0,-1
KR_6753959489,420,-2,42,-16,1,-1,2,1,5,3,8,3,0,3,-5,7,2,-1,1,0,0,-1,1,0,-6,6,-1,0,1,1,-1,1,1,4,-1
KR_6724429212,420,2,26,32,3,4,1,5,3,0,3,0,4,4,-2,2,0,-2,2,0,1,0,8,3,-6,3,2,0,0,-1,1,1,1,4,-1
KR_6619939333,420,-5,-41,16,-10,-2,2,0,-4,5,1,0,1,1,0,3,3,-4,4,0,0,-13,-2,-1,-6,7,1,0,0,1,-1,0,-1,4,-1
KR_6692661260,420,-5,-25,-24,-10,-1,1,0,-1,4,3,-2,2,0,-5,8,3,-1,2,1,0,-22,-7,4,-6,2,-1,0,-2,-1,-1,-1,-1,5,-1
KR_6621740734,420,-8,-43,-4,-12,-2,2,0,-1,2,1,-5,6,1,-1,2,1,-3,3,0,0,-14,-15,-4,-1,5,2,-1,-4,-1,-1,-1,1,5,-1
KR_6651735742,420,-6,-49,-12,-8,-1,1,0,-5,6,1,1,2,3,-1,4,3,-2,2,0,0,-12,-5,-7,-1,8,-5,0,0,-1,-1,-1,-1,3,-1
KR_6751075176,420,-6,-52,-33,-8,0,2,2,-8,8,0,3,2,5,-2,2,0,-1,1,0,0,-7,51,-1,-5,6,-30,0,-1,-1,-1,-1,-1,1,-1
KR_6746251511,420,-1,-23,0,-4,-3,5,2,-2,3,1,-4,6,2,3,1,4,2,2,4,0,2,1,2,-7,5,-3,0,-1,0,0,-1,1,0,-1
KR_6769384570,420,-2,-18,-7,0,-1,1,0,2,3,5,2,4,6,1,3,4,-4,5,1,0,6,-23,-2,-5,7,1,0,0,-1,-1,-1,1,5,-1
KR_6769103129,420,-5,-78,-31,-9,-1,1,0,-1,1,0,0,2,2,-7,8,1,0,2,2,-1,-3,7,1,-4,3,0,0,-2,-1,-1,-1,-1,5,-1
KR_6746720764,420,-3,-17,-15,1,0,2,2,0,2,2,6,2,8,-6,6,0,1,1,2,0,-3,-105,2,-6,4,-2,0,1,0,1,1,1,0,-1
KR_6754594405,420,-2,15,-8,-10,-1,3,2,0,3,3,-2,3,1,-7,8,1,0,1,1,0,-7,4,-3,-6,9,-6,0,-2,-1,-1,-1,-1,4,-1
KR_6728633457,420,-1,-6,-4,-3,-1,3,2,-5,6,1,0,1,1,4,1,5,-1,1,0,0,-6,20,0,-5,5,3,0,1,1,1,1,1,3,-1
KR_6726051874,420,-2,-70,29,-8,-6,7,1,0,4,4,-2,4,2,-1,1,0,1,1,2,0,0,-2,3,-7,4,1,0,-2,-1,1,-1,-1,1,-1
KR_6720697000,420,2,-34,3,6,-3,3,0,2,2,4,3,1,4,4,1,5,0,2,2,0,9,21,0,-6,6,-3,0,1,1,-1,1,1,6,-1
KR_6768210616,420,-6,-93,-40,-9,0,3,3,-4,6,2,2,1,3,-2,2,0,-5,5,0,0,-14,-7,-4,-5,9,1,0,-1,-1,-1,-1,-1,5,-1
KR_6709029559,440,2,46,4,-1,-1,2,1,-2,2,0,2,0,2,1,2,3,-1,1,0,0,0,1,0,-5,5,0,0,0,-1,0,1,1,1,-1
KR_6756337580,420,-4,-49,-37,-7,-3,4,1,3,0,3,-3,3,0,-4,4,0,0,0,0,-1,-5,23,3,-8,5,3,0,-2,-1,1,-1,-1,2,-1
KR_6757044907,420,-3,-30,-28,-7,0,0,0,-2,5,3,-3,4,1,-2,4,2,0,1,1,0,-5,11,-3,-2,5,0,0,0,-1,-1,0,-1,6,-1
KR_6763335131,440,-1,-23,-19,3,-2,3,1,2,2,4,2,4,6,3,1,4,-2,5,3,-1,4,-10,-1,-3,4,3,0,1,-1,-1,1,-1,2,-1
KR_6764092296,420,-2,-20,-48,-2,-4,4,0,-6,7,1,0,1,1,7,4,11,1,0,1,-1,-7,-19,2,-6,4,-9,0,1,1,0,1,-1,6,-1
KR_6687186375,420,-2,8,0,-13,2,0,2,-6,8,2,-1,2,1,-1,2,1,-7,7,0,0,-23,33,0,-5,5,-19,0,1,-1,-1,-1,1,6,-1
KR_6751073049,420,0,44,4,1,1,1,2,-2,2,0,0,4,4,-1,2,1,3,0,3,1,1,-2,1,-5,4,-4,0,-1,1,1,-1,1,3,-1
KR_6682507780,420,-8,-43,-41,-9,-3,3,0,-2,6,4,-1,3,2,-1,3,2,-2,3,1,1,-2,163,2,-9,7,-2,0,-1,1,-1,-1,1,4,-1
KR_6625331383,420,-3,-43,-3,-5,-1,1,0,0,2,2,-3,4,1,-1,2,1,0,0,0,0,-5,2,3,-8,5,1,0,0,-1,1,-1,-1,3,-1
KR_6660693740,420,2,14,12,3,-1,2,1,1,3,4,1,3,4,1,0,1,1,0,1,0,0,-4,-4,-1,5,2,0,0,1,-1,0,1,4,-1
KR_6744314773,420,-5,-63,-16,-13,-4,5,1,0,3,3,-8,10,2,-1,5,4,0,0,0,-1,-16,0,2,-9,7,-2,0,-1,1,-1,-1,-1,5,-1
KR_6427087870,420,0,-1,27,3,3,0,3,5,3,8,-2,4,2,-2,4,2,-1,1,0,0,-3,37,2,-6,4,-22,0,1,-1,0,1,1,3,-1
KR_6637518026,420,3,20,12,1,0,0,0,-2,5,3,0,3,3,1,2,3,2,0,2,0,-5,-91,-3,-4,7,-13,0,0,1,-1,1,-1,6,-1
KR_6743623540,420,-2,5,16,-3,1,0,1,3,5,8,0,1,1,-4,4,0,-3,3,0,-1,-9,8,2,-7,5,-7,0,-1,1,1,-1,-1,3,-1
KR_6726683385,440,-2,-53,-20,3,-2,2,0,0,1,1,1,1,2,2,1,3,2,1,3,0,6,17,-4,-2,6,3,0,-1,1,-1,-1,-1,2,-1
KR_6769361442,420,-4,2,-16,-8,-3,3,0,-3,5,2,0,4,4,-4,5,1,2,0,2,-1,-9,11,2,-4,2,-3,0,-1,-1,1,-1,-1,2,-1
KR_6756497245,420,-8,-85,-87,-9,0,3,3,-2,6,4,3,2,5,-7,10,3,-3,3,0,0,-14,-27,-2,-7,9,8,0,-3,-1,-1,-1,1,1,-1
KR_6758473168,420,-2,-15,7,-2,2,1,3,4,2,6,0,4,4,-5,8,3,-3,3,0,1,-3,3,1,-10,9,5,0,1,1,1,1,1,3,-1
KR_6746407863,420,-2,-61,-4,-6,-2,5,3,1,2,3,-2,2,0,-2,2,0,-1,1,0,0,-4,2,0,-2,2,-1,0,-1,1,-1,-1,-1,2,-1
KR_6488939487,420,2,40,7,2,-1,2,1,-5,7,2,4,1,5,4,2,6,0,3,3,0,7,-3,2,-8,6,-4,0,1,1,1,1,1,4,-1
KR_6762364194,420,0,27,-9,1,0,0,0,2,2,4,-5,8,3,2,0,2,2,0,2,0,7,4,5,-7,2,-1,0,-1,0,-1,-1,1,0,-1
KR_6761691520,420,-4,-56,30,-8,1,1,2,0,3,3,-2,8,6,-5,6,1,-2,2,0,-2,-14,-10,-3,-4,7,-4,0,-1,1,1,-1,-1,6,-1
KR_6742380992,440,-1,-62,12,-4,-4,6,2,-1,3,2,2,2,4,3,1,4,-4,4,0,0,-1,-1,-4,0,4,-3,0,-2,-1,0,-1,-1,1,-1
KR_6698605926,420,-7,-95,-28,-11,0,2,2,-3,5,2,-3,5,2,-6,8,2,1,0,1,0,-6,-10,-2,-6,8,-3,0,-3,-1,-1,-1,1,4,-1
KR_6767346853,440,-1,10,-27,-6,-4,4,0,0,1,1,3,0,3,-3,5,2,-2,4,2,1,-6,2,2,-3,1,-1,0,-1,-1,-1,-1,1,1,-1
KR_6744614596,420,-5,-57,-5,-15,-6,6,0,-6,6,0,-3,4,1,0,0,0,0,1,1,-1,-16,1,-4,-4,8,-4,0,-1,-1,-1,-1,-1,6,-1
KR_6679686411,420,-2,-9,-7,-9,-1,1,0,-2,6,4,-3,4,1,-2,2,0,-1,2,1,0,-15,11,4,-8,4,-1,0,-2,1,-1,-1,1,1,-1
KR_6730422068,440,2,10,3,2,0,1,1,2,2,4,0,3,3,0,4,4,0,1,1,0,-1,1,-7,-2,9,-2,0,2,1,1,1,-1,4,-1
KR_6712237496,420,-1,-8,-24,-14,2,0,2,-5,6,1,-8,10,2,-2,6,4,-1,1,0,0,-18,-14,-1,-2,3,2,0,-1,-1,-1,-1,-1,1,-1
KR_6724174872,420,3,-7,-27,11,0,2,2,2,3,5,1,7,8,4,0,4,4,0,4,0,-2,-8,1,-8,7,2,0,0,0,-1,1,1,0,-1
KR_6761495100,420,0,-11,-14,-9,-2,3,1,-2,6,4,-2,3,1,0,3,3,-3,6,3,0,-2,-13,-3,-4,7,-4,0,-1,0,-1,-1,-1,0,-1
KR_6770204244,420,-3,-27,8,-12,-1,2,1,-1,4,3,-1,2,1,-7,9,2,-2,2,0,0,-15,-198,-2,-4,6,-4,0,-1,-1,1,1,-1,1,-1
KR_6769160688,420,-4,-16,-39,-9,-3,3,0,-1,4,3,2,0,2,-6,8,2,-1,2,1,0,-11,31,-3,0,3,-15,0,0,-1,-1,-1,1,5,-1
KR_6742393720,440,-1,-22,-29,-1,0,2,2,-1,1,0,-1,2,1,0,1,1,1,2,3,0,0,-126,-5,-5,10,4,0,0,-1,-1,0,-1,2,-1
KR_6764571947,420,-1,-21,-20,0,1,0,1,2,0,2,-1,2,1,-3,4,1,1,0,1,0,1,-4,-1,-3,4,-1,0,-1,-1,-1,-1,1,1,-1
KR_6762766934,420,-2,-102,-24,-1,0,1,1,3,3,6,-1,3,2,-5,5,0,2,0,2,0,1,-8,0,-3,3,-3,0,-3,-1,0,-1,-1,6,-1
KR_6768759983,420,-4,13,-24,-10,-5,5,0,-5,6,1,3,0,3,-3,4,1,0,0,0,1,-10,-13,-1,-1,2,1,0,-1,-1,0,-1,-1,4,-1
KR_6695435709,420,-4,-113,-16,-2,-4,4,0,4,1,5,2,3,5,-4,6,2,0,2,2,1,-4,-5,-1,-3,4,0,0,-1,1,0,-1,1,6,-1
KR_6762442867,420,-3,-32,0,-10,-1,2,1,0,4,4,-3,3,0,-4,5,1,-2,2,0,1,-8,-21,-3,-4,7,2,0,0,-1,-1,-1,1,5,-1
KR_6739757511,420,1,91,0,4,-5,6,1,0,8,8,-1,1,0,6,1,7,4,0,4,1,3,-245,-2,-2,4,-2,0,1,-1,1,1,-1,6,-1
KR_6755264916,440,-4,-21,-24,-7,-2,2,0,-1,3,2,-4,4,0,0,5,5,0,4,4,0,-6,-13,4,-8,4,1,0,0,-1,1,-1,-1,3,-1
KR_6769830854,420,-4,-62,-11,-5,0,0,0,0,2,2,-3,5,2,1,1,2,-3,4,1,0,1,4,6,-9,3,6,0,-2,0,-1,-1,1,0,-1
KR_6685140936,420,-5,3,1,-10,-2,6,4,-1,3,2,-4,6,2,-1,4,3,-2,2,0,0,-9,0,0,-5,5,-1,0,0,-1,1,0,1,6,-1
KR_6754516064,420,1,-12,-8,1,0,1,1,4,1,5,-2,4,2,-2,3,1,1,0,1,0,0,-22,-1,-5,6,3,0,0,1,1,0,1,6,-1
KR_6711812608,420,-2,10,-40,-6,0,1,1,-5,6,1,0,0,0,-1,2,1,0,2,2,0,-6,-2,0,-8,8,0,0,-1,-1,0,-1,1,5,-1
KR_6623820496,420,1,36,16,4,-1,5,4,1,1,2,1,5,6,4,2,6,-1,1,0,-2,1,2,1,-8,7,1,0,1,1,1,1,-1,5,-1
KR_6590836239,420,-3,-97,-12,-6,-3,3,0,0,6,6,-4,5,1,0,2,2,1,1,2,0,0,-14,-7,-2,9,2,0,-1,-1,-1,-1,-1,2,-1
KR_6758776109,420,-1,-94,-4,-7,1,1,2,1,1,2,0,1,1,-5,8,3,-4,4,0,-1,-6,30,0,-4,4,-3,0,-1,-1,1,-1,-1,2,-1
KR_6403637383,420,-1,9,20,-5,-2,4,2,2,3,5,-3,4,1,-3,4,1,1,3,4,0,-16,-4,6,-10,4,-2,0,0,-1,1,1,1,4,-1
KR_6761060202,420,1,-27,-9,2,0,1,1,1,3,4,0,1,1,-2,9,7,3,0,3,-2,10,-34,2,-5,3,11,0,0,-1,-1,0,-1,3,-1
KR_6761715715,420,-2,-68,-10,-8,-4,5,1,-1,3,2,3,0,3,-6,6,0,0,0,0,-1,-10,34,-2,-4,6,0,0,0,-1,0,0,-1,2,-1
KR_6756983584,420,0,-16,31,2,4,0,4,-2,3,1,-3,4,1,1,1,2,2,1,3,1,-6,38,-1,-5,6,2,0,1,-1,0,1,1,2,-1
KR_6522882814,420,0,26,0,0,-2,3,1,-2,4,2,-2,6,4,3,0,3,3,0,3,0,2,5,2,-4,2,0,0,1,1,1,1,1,4,-1
KR_6493914649,420,-1,-64,-16,4,-3,3,0,1,2,3,0,0,0,6,1,7,0,0,0,0,13,-1,-1,-7,8,6,0,0,1,-1,-1,-1,2,-1
KR_6767327726,420,3,18,22,1,4,0,4,1,2,3,-3,4,1,-1,3,2,0,1,1,0,-1,1,1,-6,5,0,0,0,-1,0,-1,-1,2,-1
KR_6763395445,440,2,83,47,-3,-3,8,5,1,0,1,0,2,2,-4,4,0,3,0,3,1,-9,0,0,-3,3,4,0,2,0,1,1,1,0,-1
KR_6755506478,420,0,-41,-12,0,2,1,3,-2,3,1,-4,5,1,2,2,4,2,0,2,0,9,-2,0,-5,5,0,0,-1,0,-1,-1,-1,0,-1
KR_6665313105,440,-6,-77,-16,-8,-4,4,0,4,2,6,-3,6,3,-3,4,1,-2,2,0,0,-10,372,-3,-2,5,-2,0,-2,1,0,-1,1,6,-1
KR_6705811953,440,-3,-53,-20,3,-1,1,0,1,4,5,0,1,1,1,4,5,2,0,2,0,6,9,0,-3,3,-2,0,-1,-1,0,1,1,1,-1
KR_6762221344,420,-2,44,-5,-2,2,2,4,1,1,2,-2,4,2,-3,3,0,0,1,1,0,0,-18,-3,-4,7,1,0,1,0,-1,1,-1,0,-1
KR_6758080102,420,-2,-65,8,1,-1,1,0,-2,5,3,4,0,4,1,3,4,-1,2,1,0,8,-2,-5,-6,11,2,0,0,1,-1,0,-1,4,-1
KR_6598202795,420,2,-9,7,5,-6,7,1,-1,2,1,0,3,3,7,0,7,5,1,6,0,8,-21,-5,-4,9,2,0,-1,1,-1,1,-1,2,-1
KR_6427052392,420,-1,12,9,-3,-1,1,0,-3,5,2,2,4,6,-2,7,5,1,0,1,-1,-8,1,8,-8,0,-4,0,-1,-1,-1,-1,-1,5,-1
KR_6767383262,420,-4,-55,-42,-6,-1,1,0,-1,4,3,0,2,2,-3,3,0,-1,1,0,-1,-10,-4,1,-6,5,3,0,-2,-1,1,-1,-1,2,-1
KR_6736276396,420,0,-6,-13,8,2,1,3,4,3,7,-2,3,1,1,1,2,3,0,3,0,7,7,4,-6,2,-3,0,0,1,1,0,1,4,-1
KR_6732919176,420,-2,17,4,3,-1,2,1,3,1,4,-1,4,3,0,3,3,2,1,3,0,0,51,-2,-6,8,-18,0,0,1,-1,-1,-1,6,-1
KR_6757807967,440,0,-17,-24,-3,2,0,2,0,0,0,-1,2,1,-4,5,1,0,1,1,-1,-10,-5,2,-5,3,-5,0,0,-1,1,1,-1,6,-1
KR_6761785386,420,-2,-44,-8,-6,-1,1,0,2,3,5,0,3,3,-4,5,1,-3,3,0,-1,-2,-1,4,-7,3,1,0,1,-1,1,1,-1,6,-1
KR_6751389792,440,-2,-13,-10,-3,0,1,1,0,3,3,-2,2,0,0,1,1,-1,1,0,0,-5,-30,4,-9,5,5,0,0,-1,1,-1,-1,6,-1
KR_6719468243,420,-4,4,-13,0,0,2,2,-4,6,2,0,0,0,1,1,2,3,1,4,0,9,-2,-3,-5,8,3,0,0,1,-1,0,1,4,-1
KR_6764586755,420,1,17,4,1,-1,1,0,-1,3,2,1,2,3,3,0,3,-1,1,0,0,4,6,4,-7,3,0,0,0,1,1,0,-1,5,-1
KR_6746426659,420,-4,-65,-12,-11,-4,5,1,-7,7,0,-1,3,2,0,4,4,1,0,1,0,-6,11,-5,-1,6,1,0,-2,1,-1,-1,-1,5,-1
KR_6758061346,440,1,112,1,-3,1,0,1,0,1,1,1,1,2,0,1,1,-5,5,0,0,-5,3,5,-8,3,-2,0,0,1,-1,0,1,4,-1
KR_6724761256,420,-4,-15,-20,-7,-1,2,1,-2,3,1,-6,7,1,3,1,4,-1,3,2,0,-5,9,6,-7,1,-6,0,-2,-1,-1,-1,-1,2,-1
KR_6689442492,420,-1,-13,-16,-6,1,0,1,-1,4,3,-3,6,3,-2,4,2,-1,1,0,-2,-8,19,-3,-2,5,6,0,0,-1,-1,0,-1,5,-1
KR_6767226731,420,-2,-18,-27,-3,-1,3,2,-2,2,0,0,3,3,-1,4,3,1,4,5,0,-4,-129,-6,-3,9,4,0,-1,1,-1,-1,-1,2,-1
KR_6628236712,420,2,-26,12,3,6,0,6,-2,6,4,0,1,1,3,3,6,-4,4,0,1,3,6,7,-10,3,2,0,1,-1,-1,1,1,6,-1
KR_6749750575,420,-3,-21,-42,-12,2,1,3,-5,9,4,-4,4,0,0,2,2,-5,6,1,0,-15,-143,-1,-4,5,-4,0,0,-1,-1,0,-1,4,-1
KR_6727343241,420,-3,-59,16,-6,-2,3,1,-4,6,2,-1,2,1,1,0,1,0,0,0,0,-2,-10,1,-6,5,-1,0,0,0,1,0,-1,0,-1
KR_6767973306,420,-3,19,-1,-10,0,1,1,-1,3,2,-7,8,1,-1,5,4,-1,1,0,0,-12,-5,1,-6,5,-1,0,0,-1,-1,0,-1,6,-1
KR_6656789395,420,-2,-27,-5,-6,-3,4,1,2,3,5,0,2,2,-4,7,3,-1,1,0,0,-5,-103,-2,-3,5,2,0,-1,-1,1,-1,1,4,-1
KR_6657441392,440,-4,-40,-28,0,0,2,2,1,3,4,2,2,4,-2,6,4,-1,1,0,0,-2,-1,2,-5,3,-2,0,-1,1,-1,-1,1,5,-1
KR_6759720998,420,-3,-34,-4,-2,-2,2,0,3,2,5,0,3,3,-3,6,3,0,2,2,0,0,-8,-3,-6,9,-3,0,-1,1,-1,-1,-1,4,-1
KR_6752505234,420,2,2,1,0,-1,1,0,-4,4,0,4,1,5,-2,3,1,3,1,4,0,-3,10,2,-6,4,1,0,0,-1,1,0,-1,5,-1
KR_6762851521,420,0,15,-6,0,-3,4,1,-1,5,4,1,0,1,2,2,4,1,0,1,0,2,2,1,-9,8,-5,0,0,1,-1,1,-1,2,-1
KR_6733372746,420,-2,-56,5,-11,-7,7,0,1,2,3,2,1,3,-6,6,0,-1,1,0,0,-6,-3,-3,-2,5,-3,0,-2,-1,-1,-1,-1,1,-1
KR_6720446792,420,0,-7,40,1,-1,2,1,3,1,4,2,0,2,-2,4,2,-1,2,1,2,10,-2,1,-6,5,1,0,-1,0,1,-1,1,0,-1
KR_6752553976,420,0,22,3,1,1,1,2,2,1,3,-4,4,0,1,2,3,1,0,1,2,-5,-11,0,-6,6,-3,0,-1,-1,0,-1,1,1,-1
KR_6756556535,420,-1,-54,-24,1,4,0,4,-2,4,2,2,1,3,-4,5,1,1,2,3,0,-4,-19,3,-6,3,2,0,1,-1,1,1,1,3,-1
KR_6616720833,420,0,47,-15,-2,-5,5,0,2,2,4,0,0,0,-1,3,2,2,1,3,0,-2,24,0,-5,5,1,0,1,-1,1,1,-1,6,-1
KR_6722451906,420,-3,-89,-28,-5,2,2,4,0,0,0,-1,3,2,-4,5,1,-2,2,0,0,-14,-5,-1,-2,3,-2,0,-1,1,1,-1,-1,6,-1
KR_6766575438,420,-3,-47,-15,1,3,1,4,3,0,3,1,0,1,-5,9,4,-1,3,2,0,-9,-13,-5,-1,6,3,0,-2,-1,1,-1,1,2,-1
KR_6721211813,420,-3,-87,-8,-13,-5,5,0,2,1,3,-3,3,0,-8,9,1,1,0,1,0,-9,1,-6,-1,7,0,0,-2,-1,-1,-1,-1,5,-1
KR_6762878159,420,-5,-27,-23,-10,-1,3,2,-1,4,3,2,3,5,-8,8,0,-2,2,0,0,-7,-3,-6,-2,8,4,0,-1,-1,1,1,-1,5,-1
KR_6732890104,420,-2,-27,-8,-8,-1,3,2,0,4,4,3,1,4,-6,6,0,-4,5,1,0,-8,5,0,-7,7,-2,0,-2,-1,-1,-1,-1,1,-1
KR_6761677263,420,-1,-8,29,0,1,2,3,2,3,5,-3,3,0,-3,5,2,3,1,4,0,-7,-3,0,-5,5,4,0,-1,0,-1,-1,1,0,-1
KR_6691925528,420,3,81,16,6,-2,2,0,6,1,7,4,1,5,-3,4,1,1,2,3,0,5,-1,1,-4,3,1,0,3,-1,1,1,-1,5,-1
KR_6767903846,420,-2,-21,-24,-4,-4,4,0,0,2,2,4,3,7,-3,4,1,-1,2,1,0,1,1,3,-7,4,-4,0,-1,-1,-1,-1,1,2,-1
KR_6666224994,420,2,31,2,7,3,0,3,3,1,4,0,1,1,-2,3,1,3,1,4,0,7,148,5,-8,3,0,0,-1,1,1,-1,1,2,-1
KR_6596517644,420,2,8,16,5,2,0,2,3,1,4,0,3,3,0,4,4,0,2,2,0,0,-7,1,-5,4,1,0,-1,-1,1,-1,-1,6,-1
KR_6462409603,420,-4,-19,8,-7,-1,3,2,2,1,3,-4,4,0,-5,7,2,1,1,2,0,-7,40,-6,-2,8,-18,0,-2,-1,1,-1,-1,4,-1
KR_6763369875,420,-2,-6,-19,0,-5,5,0,2,1,3,7,1,8,-1,2,1,-3,3,0,0,4,0,-3,-4,7,5,0,0,1,1,-1,1,5,-1
KR_6729936783,420,-1,-67,-9,-4,4,0,4,2,1,3,-6,7,1,-6,7,1,2,2,4,0,3,6,1,-5,4,-6,0,-1,1,1,-1,1,1,-1
KR_6622414197,420,-5,-26,6,-7,4,0,4,-8,10,2,-2,6,4,-1,5,4,0,1,1,0,-15,-49,4,-9,5,2,0,-1,-1,1,-1,1,1,-1
KR_6770221472,420,1,50,7,3,1,1,2,1,0,1,-5,8,3,7,0,7,-1,1,0,0,7,3,1,-4,3,-2,0,1,1,-1,1,1,2,-1
KR_6763863055,420,-1,-8,-14,3,1,1,2,-1,1,0,-1,3,2,5,2,7,-1,2,1,0,-1,-9,-6,-4,10,-1,0,0,1,-1,0,-1,1,-1
KR_6737346936,420,-1,-53,0,-5,-1,1,0,3,2,5,0,1,1,-6,9,3,-1,1,0,0,2,-15,2,-5,3,1,0,0,-1,-1,0,-1,6,-1
KR_6763995015,420,-3,-50,7,-8,-1,1,0,2,0,2,1,2,3,-6,8,2,-4,4,0,2,-6,-9,-7,-2,9,0,0,-2,1,-1,-1,-1,6,-1
KR_6665335454,440,-6,-55,0,-15,-4,6,2,2,3,5,-6,8,2,-1,3,2,-6,6,0,-1,-13,-6,-1,-4,5,-2,0,-3,-1,-1,-1,-1,3,-1
KR_6651831731,420,0,-29,-14,0,-1,1,0,3,4,7,-3,4,1,1,3,4,0,2,2,0,2,7,2,-6,4,-4,0,0,-1,1,1,1,3,-1
KR_6745442626,420,0,-18,1,1,-1,4,3,3,0,3,-1,4,3,0,1,1,0,0,0,0,3,-41,3,-8,5,25,0,-1,1,-1,-1,-1,4,-1
KR_6737484679,420,1,52,-5,2,2,0,2,-3,5,2,0,4,4,4,2,6,-1,1,0,0,7,4,4,-6,2,6,0,1,1,-1,1,-1,6,-1
KR_6751131241,420,0,-4,-1,-1,-3,4,1,-1,2,1,2,2,4,1,2,3,0,2,2,0,4,0,2,-8,6,-1,0,-2,1,1,-1,-1,6,-1
KR_6716630759,420,2,26,-1,4,0,1,1,-6,7,1,2,1,3,6,2,8,2,0,2,0,5,6,5,-9,4,-4,0,0,1,-1,-1,-1,2,-1
KR_6768920690,420,-3,8,22,-1,0,0,0,8,2,10,-2,5,3,-7,7,0,0,0,0,0,-5,0,1,-7,6,3,0,-1,-1,1,-1,1,1,-1
KR_6421725582,420,-4,-63,-20,-7,-3,3,0,-5,7,2,1,0,1,1,1,2,-1,1,0,0,-7,-7,-1,-3,4,-2,0,-1,1,1,-1,1,4,-1
KR_6742184718,440,-1,-17,-8,-4,-1,1,0,1,0,1,1,1,2,2,0,2,-7,11,4,0,0,21,1,-5,4,-5,0,-1,-1,-1,-1,-1,3,-1
KR_6760064678,420,1,-8,17,4,-5,5,0,1,1,2,5,2,7,2,3,5,1,0,1,1,2,26,-2,-3,5,1,0,1,-1,1,1,1,3,-1
KR_6753723077,420,0,-2,-4,-1,-1,1,0,-1,2,1,0,0,0,1,1,2,0,1,1,1,1,0,1,-4,3,2,0,-1,0,-1,-1,1,0,-1
KR_6677309262,420,-3,-59,-59,-5,-2,2,0,1,4,5,-5,7,2,2,1,3,-1,1,0,0,4,4,0,-5,5,1,0,0,-1,1,0,1,5,-1
KR_6771105860,420,1,8,-6,1,-3,3,0,-1,4,3,1,4,5,1,1,2,3,0,3,1,7,-11,-1,-3,4,4,0,1,1,1,1,1,5,-1
KR_6685401092,420,-5,-51,34,-8,0,2,2,-1,3,2,-5,5,0,-3,4,1,1,1,2,0,-13,-1,1,-5,4,-1,0,-1,1,1,-1,-1,1,-1
KR_6740485372,420,1,67,0,2,2,2,4,-7,8,1,1,1,2,5,0,5,1,1,2,0,2,3,-1,-4,5,4,0,1,1,1,1,-1,6,-1
KR_6676684175,420,-3,-24,-24,-4,-1,1,0,1,4,5,0,2,2,-5,5,0,1,1,2,0,-5,3,4,-5,1,-2,0,-3,-1,-1,-1,1,2,-1
KR_6683234137,420,-3,-45,0,0,1,0,1,1,0,1,-4,7,3,1,2,3,1,0,1,1,-2,-114,2,-9,7,-1,0,0,1,1,0,1,5,-1
KR_6720496425,420,3,24,0,10,2,1,3,3,0,3,2,2,4,5,1,6,-2,3,1,0,21,2,5,-10,5,-2,0,1,-1,1,1,-1,1,-1
KR_6662092646,420,-2,-29,-44,-1,-1,1,0,1,4,5,0,3,3,0,4,4,-1,1,0,0,1,-5,-2,-5,7,0,0,0,-1,1,1,1,1,-1
KR_6517051710,420,0,5,-60,3,2,1,3,2,3,5,0,4,4,0,2,2,-1,2,1,0,3,-5,-2,-5,7,-1,0,0,1,1,0,1,4,-1
KR_6605472053,420,-8,-92,-4,-13,-4,6,2,-3,4,1,-4,4,0,-1,5,4,-1,1,0,0,-4,72,-3,-5,8,-2,0,-2,1,-1,-1,-1,6,-1
KR_6763153795,420,-3,-13,-27,-5,0,2,2,-5,6,1,0,2,2,0,1,1,0,2,2,0,-6,-40,0,-6,6,19,0,1,-1,1,1,1,3,-1
KR_6600093014,420,-1,2,-31,-1,-3,4,1,1,4,5,1,4,5,0,2,2,0,2,2,2,3,-3,-1,-3,4,-4,0,-1,-1,-1,-1,1,1,-1
KR_6715909476,440,-3,-24,-12,-8,2,1,3,-5,7,2,-2,2,0,-2,4,2,-1,1,0,0,-23,6,6,-9,3,-4,0,1,-1,1,1,-1,6,-1
KR_6769426782,420,-5,-23,-32,-8,-2,2,0,-3,3,0,0,5,5,-1,3,2,-2,4,2,0,-10,227,2,-4,2,-4,0,0,-1,-1,-1,-1,3,-1
KR_6754609021,420,0,-22,-3,-9,0,1,1,-3,5,2,-1,2,1,-1,4,3,-4,4,0,0,-14,-6,-4,-3,7,-4,0,1,-1,1,1,1,1,-1
KR_6766168498,420,-1,-64,18,-17,-7,8,1,-1,6,5,-2,3,1,-6,8,2,-1,2,1,-2,-19,5,-3,-4,7,2,0,1,1,1,1,-1,1,-1
KR_6770452378,420,1,-76,-52,0,-2,2,0,4,3,7,-1,2,1,0,4,4,-1,2,1,0,17,0,-2,0,2,1,0,-2,-1,-1,-1,-1,5,-1
KR_6771217126,420,-2,-44,8,0,-1,3,2,3,3,6,-2,3,1,2,1,3,-2,3,1,0,6,18,-3,-2,5,-5,0,0,-1,1,0,-1,4,-1
KR_6750404723,440,-1,-17,-14,-1,2,0,2,-2,4,2,1,2,3,1,1,2,-3,3,0,0,-1,0,3,-6,3,1,0,0,-1,1,0,1,2,-1
KR_6747587789,420,-2,39,0,-8,-1,2,1,0,3,3,-2,2,0,-4,6,2,-1,1,0,0,-15,-1,2,-6,4,-5,0,1,-1,-1,1,-1,5,-1
KR_6502352250,420,-2,-27,23,-3,-1,4,3,-1,2,1,-2,4,2,1,1,2,0,1,1,0,8,-34,2,-3,1,2,0,-2,1,1,-1,-1,4,-1
KR_6699471154,420,3,16,3,5,-1,2,1,0,4,4,4,1,5,2,0,2,0,0,0,0,10,5,1,-7,6,2,0,0,1,-1,0,-1,3,-1
KR_6720536983,420,-1,11,-10,0,1,1,2,-1,1,0,-1,2,1,1,1,2,0,1,1,0,-1,2,2,-6,4,-6,0,1,-1,1,1,1,2,-1
KR_6768080018,420,-1,-9,-19,-3,-4,5,1,0,3,3,-2,3,1,4,0,4,-1,1,0,0,4,-1,-1,-5,6,0,0,0,-1,1,-1,1,3,-1
KR_6601123423,420,1,68,-4,-7,-4,5,1,-1,1,0,-5,9,4,3,0,3,0,0,0,0,-5,-11,-2,-4,6,3,0,-2,-1,-1,-1,-1,1,-1
KR_6415963005,420,-1,2,-12,-6,3,1,4,0,2,2,-4,4,0,-4,5,1,-1,1,0,-1,-8,47,-6,-2,8,3,0,0,-1,-1,-1,-1,4,-1
KR_6769126897,420,-2,4,-16,-5,-2,2,0,-2,4,2,1,1,2,0,1,1,-2,2,0,0,-7,-120,4,-9,5,0,0,-1,1,-1,-1,1,1,-1
KR_6726682016,420,-5,-12,-23,-5,1,1,2,0,2,2,-8,8,0,1,3,4,1,1,2,1,1,-406,6,-7,1,1,0,0,1,-1,-1,-1,3,-1
KR_6767472814,420,1,58,4,0,2,1,3,1,0,1,-1,3,2,-2,2,0,0,0,0,0,3,366,0,-4,4,-1,0,0,1,-1,-1,1,5,-1
KR_6607585807,420,-4,-19,-15,-7,-1,2,1,2,0,2,-6,7,1,-1,2,1,-1,2,1,0,-3,-4,-2,-5,7,-3,0,-2,-1,1,-1,-1,4,-1
KR_6730631319,420,-1,-43,-8,-1,3,0,3,2,3,5,-4,4,0,0,1,1,-2,3,1,0,-2,-2,2,-5,3,-5,0,0,-1,-1,0,-1,3,-1
KR_6734151550,440,-1,-42,-40,-4,-1,2,1,-1,2,1,1,1,2,-3,5,2,0,1,1,0,-11,-27,2,-7,5,3,0,-1,-1,1,-1,-1,2,-1
KR_6757850451,420,-2,-47,-6,-3,1,1,2,-2,4,2,4,1,5,-1,1,0,-5,5,0,0,-10,-11,-3,-2,5,0,0,-1,1,-1,-1,-1,6,-1
KR_6719665907,420,1,-38,-36,3,1,1,2,3,2,5,-3,7,4,-1,3,2,3,0,3,0,8,77,-2,-3,5,-1,0,0,-1,-1,-1,-1,1,-1
KR_6762935698,420,2,-5,-9,5,3,0,3,0,2,2,-1,4,3,0,3,3,3,0,3,0,5,-103,2,-6,4,-4,0,0,-1,-1,0,-1,5,-1
KR_6751985542,420,-1,-45,-18,-4,-2,2,0,2,2,4,1,1,2,-3,4,1,-2,2,0,0,-1,2,2,-8,6,-1,0,0,-1,1,0,-1,1,-1
KR_6765880648,420,-6,-107,-28,-10,-2,4,2,-3,6,3,1,0,1,-3,4,1,-3,3,0,0,-2,-3,-3,-5,8,-1,0,-3,-1,1,-1,-1,1,-1
KR_6752009039,420,-2,-21,8,-9,-2,3,1,-2,4,2,-2,3,1,-1,2,1,-2,2,0,0,-5,-21,-1,-3,4,0,0,0,-1,1,0,-1,4,-1
KR_6760295280,420,-2,-64,-16,-10,-1,2,1,2,0,2,-2,3,1,-8,9,1,-1,1,0,0,-6,-9,-2,-5,7,4,0,0,-1,1,-1,1,6,-1
KR_6770067183,440,-4,-91,28,-21,-3,5,2,-9,12,3,0,4,4,-5,7,2,-4,7,3,-5,-17,-11,0,-3,3,-2,0,-3,0,0,-1,-1,0,-1
KR_6607265491,420,0,-51,23,1,4,0,4,6,1,7,-8,9,1,-1,4,3,0,2,2,-1,0,-11,4,-9,5,-7,0,-1,-1,-1,-1,-1,1,-1
KR_6701702195,420,-4,-19,0,-7,-2,3,1,3,0,3,-6,7,1,-1,2,1,-1,5,4,0,-3,-82,1,-4,3,-1,0,0,-1,-1,0,-1,6,-1
KR_6695219735,420,-2,-1,4,-6,-1,1,0,-1,3,2,-1,3,2,-2,2,0,-1,1,0,0,-6,-3,-4,0,4,-1,0,-1,-1,-1,-1,1,4,-1
KR_6759003923,420,-4,-52,-25,-6,-2,4,2,-1,1,0,-1,1,0,-2,4,2,0,1,1,-1,0,-15,-3,-2,5,-3,0,-5,-1,-1,-1,-1,2,-1
KR_6683797666,420,0,41,-19,-5,1,2,3,-5,5,0,0,0,0,0,3,3,-1,1,0,0,-11,-6,-4,-6,10,1,0,1,-1,-1,1,-1,6,-1
KR_6541810895,420,-1,12,-8,-2,1,1,2,0,5,5,2,0,2,-4,4,0,-1,1,0,0,1,-102,-2,-8,10,-4,0,0,1,-1,0,1,4,-1
KR_6753712107,420,2,51,-5,0,1,1,2,-1,4,3,1,1,2,-2,3,1,1,1,2,0,-6,10,5,-10,5,1,0,0,1,-1,0,-1,4,-1
KR_6766388949,420,1,-72,3,6,0,1,1,-1,3,2,-1,1,0,8,0,8,0,1,1,0,13,0,6,-7,1,1,0,0,1,-1,1,1,1,-1
KR_6653672395,420,-3,-93,-11,-7,-3,4,1,2,0,2,-3,3,0,1,1,2,-4,5,1,0,-5,2,1,-5,4,0,0,-1,-1,-1,1,-1,5,-1
KR_6768804710,420,2,-4,-21,1,-5,8,3,0,0,0,4,1,5,3,2,5,-1,1,0,0,1,-10,2,-4,2,0,0,-1,-1,1,-1,-1,4,-1
KR_6554790536,420,-3,-54,-7,-8,0,3,3,-2,4,2,-1,3,2,-3,5,2,-2,4,2,0,-1,-208,-4,-1,5,1,0,-1,1,1,-1,1,1,-1
KR_6735682428,420,-1,-55,-7,-1,-7,7,0,1,1,2,3,0,3,2,1,3,0,0,0,0,0,5,1,-9,8,1,0,0,1,1,-1,-1,2,-1
KR_6749407269,420,-2,-62,-40,-1,-3,5,2,-1,2,1,-1,1,0,3,1,4,1,0,1,0,4,-39,-9,0,9,-1,0,-1,-1,-1,-1,-1,3,-1
KR_6732767550,420,-3,-10,-8,-7,-5,5,0,-2,2,0,-1,3,2,1,3,4,0,0,0,0,-6,3,-2,-5,7,3,0,1,-1,1,1,-1,5,-1
KR_6649735030,420,-6,-100,-29,-6,-3,4,1,3,0,3,-5,5,0,-1,3,2,0,3,3,0,3,-35,-2,-3,5,7,0,-1,-1,1,-1,-1,5,-1
KR_6438399791,420,-3,11,-32,-4,1,2,3,1,1,2,-8,10,2,-2,4,2,4,0,4,0,-2,-2,2,-7,5,-3,0,1,1,1,1,-1,4,-1
KR_6768709459,420,0,-73,-2,-5,-1,1,0,-3,4,1,-4,4,0,2,0,2,1,0,1,0,-4,122,-1,-2,3,2,0,-1,1,-1,1,-1,1,-1
KR_6762164795,420,-1,19,-4,-4,0,0,0,-3,8,5,0,3,3,0,1,1,-1,1,0,0,-2,132,5,-6,1,-7,0,0,1,-1,0,-1,3,-1
KR_6609826887,420,-2,-68,7,-11,-4,5,1,-1,4,3,-4,6,2,-1,3,2,-1,1,0,-1,-13,9,8,-9,1,-4,0,-1,1,0,-1,-1,6,-1
KR_6623484212,420,-1,-7,-27,3,-1,1,0,1,4,5,-2,2,0,5,1,6,0,4,4,0,5,-8,-4,-4,8,2,0,1,1,-1,1,1,5,-1
KR_6725229266,420,1,-71,-14,-2,1,0,1,3,1,4,-2,6,4,-5,5,0,1,0,1,0,-1,15,-6,-2,8,-6,0,-1,0,-1,-1,1,0,-1
KR_6624353596,420,-3,-58,9,-12,-3,3,0,0,5,5,0,1,1,-8,9,1,-1,1,0,1,-10,-6,-2,-2,4,1,0,-2,-1,-1,-1,1,2,-1
KR_6682771053,420,-2,-10,-52,0,-1,1,0,-4,6,2,-3,4,1,8,1,9,0,0,0,0,7,0,0,-10,10,-1,0,0,-1,1,1,-1,4,-1
KR_6583109092,420,1,-6,24,-5,-1,4,3,0,6,6,-2,3,1,-1,3,2,-1,1,0,0,-5,0,-3,-5,8,1,0,0,-1,1,1,-1,5,-1
KR_6608218633,420,-3,-103,-28,-3,-8,8,0,1,0,1,1,1,2,2,0,2,1,0,1,0,3,2,-2,-5,7,-2,0,-3,1,-1,-1,-1,6,-1
KR_6763835011,420,-5,-31,-25,-11,-3,3,0,4,4,8,-3,3,0,-5,5,0,-4,4,0,0,-9,-44,-1,-2,3,18,0,-3,-1,-1,-1,-1,3,-1
KR_6741195276,420,-2,-63,-11,-3,-3,3,0,2,3,5,4,1,5,-4,6,2,-2,3,1,0,0,-7,0,-3,3,4,0,0,1,0,0,1,3,-1
KR_6752764820,420,-3,-50,4,-4,2,1,3,-2,3,1,-3,3,0,-4,7,3,3,0,3,0,-3,1,-3,-2,5,3,0,-1,0,1,-1,-1,0,-1
KR_6760668527,420,2,14,3,7,-1,2,1,0,3,3,5,0,5,2,1,3,1,0,1,2,12,36,4,-6,2,-14,0,-1,-1,-1,-1,1,3,-1
KR_6640307288,420,0,-71,25,-1,-3,6,3,1,2,3,1,2,3,-2,4,2,2,0,2,0,-3,33,1,-7,6,-6,0,-1,0,0,-1,-1,0,-1
KR_6765309528,420,-1,-3,12,-1,-3,4,1,-1,3,2,7,1,8,-6,6,0,2,0,2,0,-8,-1,-5,-4,9,-8,0,-1,-1,0,-1,-1,4,-1
KR_6711551962,420,-4,-35,-8,-9,-2,2,0,-1,4,3,-5,7,2,1,1,2,-2,2,0,1,-7,-6,6,-12,6,-5,0,0,-1,-1,-1,1,6,-1
KR_6658710818,420,-4,-62,4,-8,-2,2,0,-2,2,0,-1,2,1,-3,3,0,0,1,1,0,-8,2,-5,-3,8,-5,0,-1,-1,-1,-1,-1,1,-1
KR_6717515191,440,-1,30,8,1,0,3,3,4,4,8,1,0,1,-2,2,0,-2,2,0,0,-1,1,3,-8,5,-4,0,0,-1,1,0,-1,3,-1
KR_6755557378,420,-3,-61,-28,-3,-2,2,0,-3,4,1,0,2,2,2,0,2,0,0,0,0,-2,5,2,-6,4,-1,0,-1,1,-1,-1,-1,3,-1
KR_6685761933,440,1,34,-16,2,-2,5,3,0,1,1,7,1,8,-2,3,1,-1,1,0,0,3,5,6,-7,1,1,0,0,1,-1,1,1,3,-1
KR_6387133160,420,-1,-23,8,-3,0,0,0,-1,2,1,3,0,3,-3,4,1,-2,2,0,0,-3,5,3,-6,3,-4,0,0,1,1,0,1,6,-1
KR_6766075789,420,-1,31,-1,1,5,0,5,0,1,1,-2,2,0,3,1,4,-5,5,0,0,0,-43,-3,-4,7,22,0,-1,1,-1,-1,1,2,-1
KR_6766396786,420,3,20,17,4,-1,3,2,4,2,6,2,1,3,1,4,5,-2,2,0,0,3,-20,-4,-3,7,0,0,-1,1,-1,-1,1,5,-1
KR_6718891349,420,-2,-1,-7,-4,-1,3,2,-2,4,2,-4,5,1,4,2,6,-1,1,0,0,-1,0,2,-7,5,-4,0,0,-1,-1,0,-1,4,-1
KR_6739758437,420,-2,-22,16,-10,0,0,0,-2,5,3,-2,3,1,-4,5,1,-2,2,0,0,-9,133,-1,-3,4,0,0,-1,-1,-1,-1,-1,3,-1
KR_6765941844,420,1,-4,-12,0,2,1,3,-2,4,2,3,1,4,-3,4,1,0,1,1,1,-6,-1,0,-4,4,-3,0,-1,1,-1,-1,1,5,-1
KR_6733165327,420,-2,-15,-15,-7,-1,3,2,-2,5,3,-6,6,0,1,1,2,1,0,1,0,-1,12,3,-7,4,-5,0,0,-1,1,0,1,2,-1
KR_6770515051,420,0,3,-20,1,-2,5,3,0,2,2,1,1,2,1,2,3,1,1,2,0,0,-8,-4,-1,5,2,0,-1,1,0,-1,1,3,-1
KR_6751822383,420,-2,-41,-40,-2,-2,3,1,0,5,5,1,1,2,-1,2,1,0,2,2,0,0,-23,1,-2,1,3,0,-1,-1,-1,-1,-1,1,-1
KR_6144910305,420,-4,-76,8,-11,-2,2,0,-1,3,2,-4,4,0,0,1,1,-4,5,1,-1,-13,48,-6,-4,10,2,0,-1,-1,-1,-1,-1,2,-1
KR_6664208990,420,0,-47,-13,-6,-1,1,0,-6,7,1,-1,1,0,1,2,3,1,0,1,0,-5,35,1,-6,5,0,0,1,1,-1,1,-1,2,-1
KR_6724492568,440,-3,-34,-40,-5,-4,5,1,-4,4,0,-3,3,0,9,1,10,-3,3,0,0,0,5,3,-7,4,-2,0,-1,-1,-1,-1,1,5,-1
KR_6761401083,440,-2,-22,-21,-6,-3,5,2,1,1,2,-3,7,4,-2,6,4,1,0,1,1,8,4,-4,-1,5,-1,0,0,1,-1,0,1,2,-1
KR_6758542537,420,-6,-74,-20,-12,0,3,3,-3,3,0,2,1,3,-7,8,1,-4,5,1,0,-8,-5,-1,-6,7,-1,0,-1,-1,1,-1,1,3,-1
KR_6697943061,420,-3,-35,12,-6,-2,4,2,-5,6,1,0,3,3,-1,3,2,2,2,4,-1,-8,5,2,-6,4,4,0,-1,1,1,-1,-1,6,-1
KR_6752160233,420,-1,17,16,4,2,3,5,-2,5,3,1,2,3,-1,4,3,4,0,4,0,0,8,0,-3,3,-2,0,0,1,1,0,1,2,-1
KR_6759816572,420,2,88,0,-3,1,1,2,-1,4,3,-4,5,1,-1,5,4,2,0,2,-1,-6,5,-2,-2,4,-3,0,0,-1,1,0,-1,5,-1
KR_6447999944,420,2,-1,9,-1,0,1,1,2,1,3,3,1,4,-6,7,1,0,1,1,-1,-6,1,-2,-6,8,-3,0,0,-1,1,0,-1,4,-1
KR_6732605621,420,-5,-12,-33,-11,0,0,0,-4,4,0,-2,3,1,-4,5,1,-1,3,2,0,-8,5,0,-4,4,3,0,-2,-1,1,-1,-1,3,-1
KR_6768507233,420,-5,-71,-4,-9,-2,2,0,-5,5,0,2,0,2,-3,4,1,-1,1,0,0,-11,-7,-3,-4,7,-5,0,0,0,1,-1,-1,0,-1
KR_6762550295,440,-1,-17,3,3,4,1,5,0,5,5,3,0,3,1,2,3,-5,6,1,0,1,-27,-1,-7,8,13,0,-3,-1,-1,-1,1,5,-1
KR_6763012441,420,1,-26,5,-6,-1,1,0,-4,5,1,0,3,3,1,8,9,-2,3,1,-1,-3,-25,-2,-1,3,27,0,0,-1,-1,1,-1,4,-1
KR_6770056483,420,2,40,16,1,2,3,5,-3,4,1,2,3,5,1,4,5,-1,2,1,1,-7,-33,-3,-5,8,-3,0,1,1,1,1,1,3,-1
KR_6596861339,420,-4,-79,-15,-13,-9,10,1,-2,2,0,-2,3,1,0,1,1,0,2,2,-1,-11,3,-3,-5,8,-3,0,-2,1,-1,-1,-1,3,-1
KR_6635178898,420,-2,3,0,-3,1,2,3,-3,4,1,0,1,1,1,2,3,-2,3,1,1,0,-40,-3,-4,7,1,0,0,-1,1,1,1,2,-1
KR_6744193255,420,-1,-61,3,-7,-2,2,0,-3,4,1,-4,5,1,3,0,3,-1,1,0,0,2,-3,0,-6,6,-1,0,0,1,-1,-1,1,2,-1
KR_6753575331,420,0,-33,0,0,-1,1,0,-1,4,3,1,5,6,0,2,2,1,2,3,-1,-2,26,6,-8,2,-1,0,1,1,1,1,-1,6,-1
KR_6768748438,420,-2,-33,10,-8,-5,5,0,1,0,1,1,3,4,-5,6,1,0,3,3,0,-3,0,5,-9,4,5,0,0,-1,1,0,1,1,-1
KR_6730724613,420,1,-2,25,-3,0,0,0,-2,4,2,1,0,1,-4,7,3,2,0,2,0,-3,11,7,-12,5,-2,0,0,1,1,0,-1,6,-1
KR_6763044488,420,0,-63,8,3,0,2,2,-1,1,0,-2,4,2,4,1,5,2,1,3,0,6,-349,1,-2,1,-2,0,0,-1,-1,0,-1,2,-1
KR_6766209676,420,-3,-51,-16,-2,-1,1,0,-2,5,3,1,3,4,1,2,3,-1,1,0,0,0,163,-7,-3,10,0,0,0,0,-1,0,-1,0,-1
KR_6686599145,420,2,21,28,5,2,0,2,2,3,5,1,4,5,1,1,2,-1,1,0,0,-2,1,1,-9,8,-2,0,0,1,1,1,1,1,-1
KR_6730749441,420,-3,-26,-8,-11,-3,4,1,-1,5,4,1,0,1,-2,6,4,-6,6,0,1,-3,54,0,-4,4,-1,0,-1,-1,-1,-1,1,2,-1
KR_6680261584,420,-3,5,-19,-4,-1,3,2,1,2,3,4,0,4,-7,8,1,-1,1,0,-1,-12,-1,0,-5,5,1,0,-1,-1,1,-1,-1,2,-1
KR_6625167790,420,-8,-166,12,-18,-1,1,0,-4,5,1,-8,8,0,-4,4,0,-1,1,0,-1,-21,68,-1,-3,4,-4,0,-2,-1,0,-1,-1,3,-1
KR_6608382298,420,-5,-25,-20,-14,-3,3,0,-3,3,0,-6,7,1,-6,8,2,4,0,4,0,-8,6,1,-7,6,-10,0,-3,-1,-1,-1,-1,5,-1
KR_6713542530,420,0,-16,24,0,4,1,5,-1,4,3,-1,1,0,-1,2,1,-1,1,0,-1,-1,19,-4,-4,8,-1,0,0,-1,1,1,-1,1,-1
KR_6415873571,420,-2,18,-5,-5,-3,4,1,0,0,0,0,2,2,-1,3,2,-1,1,0,0,-4,145,2,-6,4,-6,0,0,-1,-1,0,-1,5,-1
KR_6761744670,420,0,-41,-20,1,0,0,0,2,1,3,1,3,4,-1,2,1,-1,1,0,0,11,-6,0,-2,2,-2,0,0,-1,-1,-1,1,4,-1
KR_6713608370,440,-2,-39,-23,-9,-2,3,1,2,0,2,-3,4,1,-3,6,3,-3,4,1,-2,-6,1,-4,-1,5,3,0,-1,1,-1,-1,-1,1,-1
KR_6733283741,420,-2,27,-19,-8,2,1,3,-1,1,0,-4,5,1,-6,8,2,1,1,2,0,-13,0,-1,-4,5,1,0,-1,-1,-1,-1,-1,1,-1
KR_6760128753,420,1,26,15,-6,-3,3,0,0,3,3,1,2,3,-4,7,3,0,1,1,0,1,4,2,-4,2,0,0,0,1,-1,0,-1,6,-1
KR_6706832299,420,-3,-67,-4,-13,0,2,2,-5,8,3,0,1,1,-8,8,0,0,0,0,0,-8,4,0,-8,8,-4,0,-1,-1,-1,-1,-1,5,-1
KR_6756779850,440,-1,17,0,-2,2,1,3,1,2,3,0,2,2,-4,6,2,-1,2,1,0,-7,3,-1,-6,7,-1,0,0,-1,1,-1,1,3,-1
KR_6757191550,420,-5,-112,10,-6,-2,2,0,1,1,2,-2,3,1,-2,2,0,-1,1,0,0,-6,-3,-3,-4,7,-7,0,0,-1,-1,0,-1,4,-1
KR_6757958058,420,-2,-59,-24,-6,1,1,2,-1,2,1,-3,3,0,-1,4,3,-2,5,3,0,-5,-3,0,-5,5,-1,0,-2,-1,-1,-1,1,4,-1
KR_6726741165,420,-3,-24,-15,-10,-4,6,2,-3,5,2,-2,7,5,-2,3,1,1,1,2,0,-15,-232,2,-7,5,-4,0,-2,-1,-1,-1,1,3,-1
KR_6753860432,420,0,-25,17,0,1,1,2,1,1,2,3,0,3,-3,3,0,-2,2,0,1,-2,-117,-5,-2,7,2,0,-1,-1,1,-1,1,2,-1
KR_6758166327,420,-5,-68,-48,-12,-1,3,2,0,2,2,-2,3,1,-5,5,0,-4,6,2,0,-13,-1,-2,-6,8,1,0,-1,-1,-1,-1,-1,1,-1
KR_6750568431,420,-2,-52,-18,-2,-5,5,0,1,4,5,2,0,2,2,3,5,-2,3,1,0,8,8,3,-8,5,-4,0,0,1,-1,0,1,3,-1
KR_6756722925,420,0,10,9,-3,1,1,2,0,4,4,1,2,3,-5,5,0,0,1,1,0,-4,-33,-2,-5,7,1,0,-1,1,-1,-1,-1,4,-1
KR_6757393514,420,0,6,11,2,-3,3,0,-2,3,1,1,0,1,0,1,1,6,1,7,0,-6,-4,-2,-8,10,0,0,1,1,1,1,-1,3,-1
KR_6751781574,420,-4,-58,-8,-13,-1,2,1,-1,3,2,-2,4,2,-4,6,2,-5,5,0,0,-5,-12,2,-4,2,1,0,-4,-1,-1,-1,-1,5,-1
KR_6736471879,420,-7,-92,-8,-18,-3,3,0,-2,3,1,-7,7,0,-7,10,3,1,0,1,0,-12,-11,-1,-3,4,1,0,-1,-1,-1,-1,-1,4,-1
KR_6665602219,420,1,-18,-4,3,1,2,3,1,4,5,-2,7,5,1,3,4,2,1,3,0,7,69,2,-6,4,2,0,1,1,-1,1,1,1,-1
KR_6741358190,420,0,-11,-13,-4,0,1,1,1,3,4,-4,5,1,-1,1,0,0,0,0,0,3,6,-1,-6,7,-5,0,0,1,-1,0,-1,1,-1
KR_6762227646,420,0,2,11,-9,-2,4,2,-1,2,1,-3,5,2,-1,2,1,-2,2,0,0,-5,39,-3,-2,5,-25,0,0,-1,-1,-1,-1,6,-1
KR_6728689621,420,-1,11,13,-4,-1,2,1,-3,6,3,0,2,2,0,2,2,0,1,1,0,-3,0,0,-3,3,-4,0,1,1,1,1,-1,5,-1
KR_6753028354,420,0,11,12,-6,1,0,1,-5,7,2,-3,3,0,-2,3,1,3,0,3,0,-6,4,-2,-2,4,0,0,0,1,-1,0,-1,1,-1
KR_6614570895,420,-1,-47,-6,1,0,1,1,3,2,5,-1,3,2,-1,2,1,0,2,2,1,9,-5,-7,-2,9,0,0,0,-1,-1,0,1,3,-1
KR_6572589307,440,-3,-34,12,-2,-1,1,0,1,1,2,-6,6,0,4,0,4,0,1,1,0,3,6,-1,-6,7,-6,0,0,-1,1,0,1,2,-1
KR_6680237018,420,3,74,12,7,-2,4,2,-2,3,1,-3,3,0,7,0,7,7,1,8,1,5,-9,1,-7,6,0,0,1,1,1,1,1,6,-1
KR_6768310425,420,-4,-49,-8,-8,-1,1,0,-2,3,1,-7,8,1,2,1,3,0,0,0,0,1,-9,-5,0,5,0,0,-1,-1,-1,-1,-1,3,-1
KR_6761389055,420,-6,-59,-89,-8,2,2,4,0,2,2,-8,9,1,-2,4,2,0,2,2,0,-4,-114,3,-5,2,-5,0,-1,-1,-1,-1,1,5,-1
KR_6679243469,420,-2,38,16,-13,-1,3,2,-4,6,2,1,0,1,-2,5,3,-7,7,0,-1,-14,-4,-4,-2,6,0,0,0,1,-1,0,-1,5,-1
KR_6695698691,420,0,9,5,-4,1,2,3,-1,4,3,0,2,2,-1,1,0,-3,3,0,0,-8,-3,-3,-3,6,1,0,-1,-1,1,-1,-1,4,-1
KR_6690419405,420,-3,-62,-12,2,3,1,4,-3,3,0,0,4,4,1,2,3,1,0,1,1,0,-19,2,-4,2,4,0,-1,1,1,-1,1,4,-1
KR_6713208111,420,-5,3,2,-10,-2,4,2,-1,3,2,-4,5,1,1,2,3,-4,5,1,-1,-9,-3,1,-4,3,-1,0,-1,-1,1,-1,-1,5,-1
KR_6734288550,420,-2,52,-33,-4,3,2,5,-1,1,0,-1,1,0,-3,4,1,-2,2,0,1,-14,-7,-4,-2,6,2,0,0,-1,-1,-1,1,6,-1
KR_6760868574,420,-1,-24,-22,1,-2,4,2,-1,4,3,1,2,3,2,3,5,1,0,1,0,4,3,0,-3,3,-6,0,0,-1,1,0,-1,4,-1
KR_6757072627,420,-1,-10,-12,-1,2,1,3,1,1,2,-2,4,2,-2,2,0,0,0,0,0,-5,-4,3,-6,3,0,0,0,-1,1,0,-1,3,-1
KR_6767044085,420,1,72,-6,0,2,2,4,4,1,5,-1,1,0,-5,5,0,0,1,1,0,2,9,-2,-5,7,-3,0,1,1,1,1,-1,2,-1
KR_6753770640,440,-4,-58,-23,-5,-2,4,2,1,2,3,-6,7,1,1,1,2,1,0,1,0,4,39,-1,-2,3,-19,0,-1,-1,0,-1,-1,4,-1
KR_6759876375,420,-10,-100,-20,-12,-3,4,1,2,0,2,-2,2,0,-6,7,1,-3,5,2,-1,-15,-17,-2,-2,4,0,0,-5,1,-1,-1,1,6,-1
KR_6750969627,440,-4,-49,-34,-3,-2,3,1,-3,4,1,4,3,7,1,2,3,-3,5,2,-1,1,-4,0,-3,3,-3,0,-1,-1,1,-1,-1,2,-1
KR_6767965114,420,1,-16,-12,3,-2,2,0,0,3,3,4,2,6,2,2,4,-1,1,0,0,2,184,0,-4,4,30,0,0,1,1,-1,1,3,-1
KR_6752095657,420,-4,-30,-19,-1,-4,4,0,1,0,1,3,0,3,1,3,4,-2,2,0,0,1,-30,0,-7,7,-1,0,-1,-1,0,-1,-1,2,-1
KR_6732449637,420,-2,13,-20,-5,0,2,2,-8,9,1,-3,7,4,2,0,2,4,1,5,0,-1,-12,-1,-4,5,-4,0,-1,-1,-1,-1,1,6,-1
KR_6765823071,420,1,10,-4,4,-1,1,0,1,0,1,2,1,3,2,0,2,0,0,0,0,2,20,-2,-3,5,-1,0,0,-1,1,1,-1,4,-1
KR_6764453138,420,-3,-8,-20,-10,1,0,1,-10,10,0,-1,2,1,1,1,2,-1,2,1,0,-10,111,-7,0,7,-1,0,0,-1,1,0,-1,5,-1
KR_6754788460,420,-3,-28,-36,-10,3,0,3,-4,9,5,-5,7,2,-2,3,1,-2,3,1,-2,-11,-1,-2,-5,7,4,0,0,-1,1,0,-1,1,-1
KR_6768982307,420,-4,-51,-15,-9,0,2,2,-7,7,0,2,0,2,-4,6,2,0,1,1,0,-10,-109,-2,-2,4,-2,0,-1,-1,1,-1,1,4,-1
KR_6741567833,440,2,-42,24,2,-1,3,2,4,2,6,-2,3,1,1,0,1,0,0,0,-1,4,-19,-9,-2,11,4,0,1,-1,1,1,-1,5,-1
KR_6618342832,420,-3,-67,-16,-8,-1,2,1,-1,3,2,-2,3,1,-3,3,0,-1,1,0,-2,-12,-6,-4,-3,7,3,0,0,-1,1,0,-1,4,-1
KR_6769900718,440,0,-18,-16,2,-2,8,6,3,2,5,0,1,1,0,2,2,1,0,1,-1,-1,-13,-2,-4,6,1,0,0,-1,1,-1,-1,4,-1
KR_6747724871,440,4,-3,-10,6,-2,4,2,6,3,9,2,0,2,-2,4,2,2,0,2,0,10,-25,-2,-3,5,0,0,-2,0,1,-1,-1,0,-1
KR_6753528236,420,-1,-41,-32,-6,1,1,2,0,5,5,-5,7,2,-1,3,2,-1,1,0,0,-7,9,9,-10,1,1,0,0,-1,1,0,-1,6,-1
KR_6751831033,420,-2,-24,-19,-5,1,0,1,-1,3,2,-3,3,0,-2,3,1,0,0,0,0,-7,-57,-3,-5,8,-3,0,1,-1,1,1,-1,1,-1
KR_6543937096,420,-1,0,-20,-7,-3,4,1,-1,3,2,-2,2,0,-1,2,1,0,1,1,0,-15,227,-6,0,6,3,0,-1,-1,1,-1,1,4,-1
KR_6650501724,420,-1,-28,-8,-7,-2,3,1,-1,3,2,3,4,7,-6,6,0,-1,1,0,0,-7,7,-5,-2,7,-1,0,-1,-1,1,-1,1,1,-1
KR_6730902113,420,0,64,-24,1,-4,5,1,-2,8,6,-1,2,1,10,2,12,-2,2,0,1,13,-1,-3,-5,8,1,0,1,1,-1,1,1,2,-1
KR_6764886891,420,0,8,8,6,-1,2,1,1,1,2,3,0,3,2,3,5,1,1,2,0,8,4,1,-3,2,-2,0,0,1,1,0,1,1,-1
KR_6757927853,420,-1,-21,5,-1,-4,4,0,8,0,8,-3,5,2,-1,2,1,-1,1,0,1,9,-1,3,-5,2,1,0,0,1,-1,0,1,4,-1
KR_6681302359,420,-1,-10,-2,-6,-6,6,0,5,1,6,-3,4,1,-1,2,1,-1,1,0,0,-4,3,4,-7,3,-3,0,-3,-1,-1,-1,-1,1,-1
KR_6711485119,420,-1,18,7,-4,-2,3,1,3,0,3,-2,3,1,-1,4,3,-2,2,0,-1,-6,-9,6,-11,5,-4,0,0,-1,1,-1,-1,5,-1
KR_6672984959,420,0,-38,19,-5,-3,3,0,0,4,4,-3,4,1,4,2,6,-3,6,3,-1,-2,-17,-3,-4,7,-3,0,-1,1,-1,-1,-1,5,-1
KR_6595798773,420,2,-5,-22,5,0,2,2,-1,3,2,7,1,8,-2,4,2,1,0,1,0,6,-55,0,-5,5,4,0,0,1,-1,0,1,5,-1
KR_6735621536,420,-2,17,-15,-4,-1,1,0,1,0,1,3,0,3,-5,5,0,-2,2,0,0,-5,15,3,-7,4,-5,0,0,-1,1,-1,1,4,-1
KR_6761396347,420,-6,-45,-3,-11,-1,1,0,-4,5,1,0,2,2,-4,4,0,-2,2,0,0,-9,-3,-2,-5,7,-1,0,0,1,-1,-1,1,1,-1
KR_6727359423,420,-5,-7,-19,-2,-8,8,0,1,0,1,2,0,2,-1,4,3,4,1,5,-2,-5,-382,-2,-1,3,-2,0,0,1,-1,-1,-1,5,-1
KR_6725931874,420,-5,-101,9,-11,-4,4,0,-2,3,1,-4,4,0,-3,4,1,2,0,2,0,-8,-39,-2,-2,4,4,0,-2,-1,-1,-1,-1,5,-1
KR_6144877922,420,-5,-97,-29,-9,-1,1,0,-5,6,1,-2,2,0,-3,3,0,2,0,2,0,-8,16,6,-10,4,-7,0,-2,1,-1,-1,-1,5,-1
KR_6770024716,420,2,-2,7,0,2,0,2,3,3,6,-5,6,1,-1,3,2,1,1,2,0,-5,109,1,-4,3,2,0,0,1,-1,1,-1,4,-1
KR_6738422985,420,2,-8,-16,0,3,3,6,2,2,4,-3,4,1,-1,2,1,-1,2,1,-1,-2,-1,1,-5,4,-4,0,0,-1,-1,0,-1,3,-1
KR_6757121737,420,-2,-16,19,-10,-2,4,2,0,3,3,-1,1,0,-6,8,2,-1,3,2,0,-9,-5,-4,-7,11,-2,0,-1,1,-1,-1,1,4,-1
KR_6765517410,420,-1,21,-28,-4,4,1,5,-10,12,2,-1,4,3,3,2,5,0,0,0,2,-8,-33,3,-7,4,6,0,0,-1,1,0,1,3,-1
KR_6769778747,420,-3,-21,4,-11,0,4,4,1,1,2,-6,7,1,-3,3,0,-3,3,0,0,-24,-5,-2,-3,5,1,0,-1,-1,0,-1,-1,6,-1
KR_6765791532,420,-2,24,-12,-6,-2,2,0,0,3,3,-3,3,0,1,2,3,-2,2,0,0,0,16,0,-7,7,-4,0,0,-1,1,0,1,4,-1
KR_6619039114,420,-1,-34,-13,-2,-3,4,1,3,4,7,0,2,2,-2,3,1,0,0,0,0,-2,4,3,-6,3,0,0,0,1,-1,-1,-1,6,-1
KR_6770189291,420,0,57,11,-4,-2,4,2,0,2,2,-4,6,2,1,1,2,1,1,2,0,-3,201,-2,-2,4,0,0,2,0,0,1,1,0,-1
KR_6403543284,420,1,-5,32,0,2,0,2,-1,4,3,-2,4,2,4,1,5,-3,3,0,0,-1,-16,-1,-3,4,-3,0,-1,1,-1,-1,-1,2,-1
KR_6692009390,420,2,31,19,2,3,1,4,1,3,4,0,1,1,-2,7,5,0,1,1,0,7,-2,-1,-2,3,3,0,0,-1,0,0,1,1,-1
KR_6711714434,420,-4,-42,-13,-1,-2,2,0,4,3,7,1,2,3,-4,5,1,0,0,0,0,-1,2,1,-4,3,1,0,0,0,-1,0,-1,0,-1
KR_6648355605,420,-4,-43,9,-5,-3,4,1,0,1,1,1,1,2,-4,5,1,1,1,2,0,-6,3,1,-3,2,-3,0,0,0,0,0,1,0,-1
KR_6769676794,420,1,55,20,-2,0,2,2,4,0,4,-6,7,1,2,2,4,-2,2,0,0,-1,-122,-1,-3,4,2,0,2,1,-1,1,-1,5,-1
KR_6736753040,420,-4,-49,21,-7,4,0,4,4,1,5,-2,4,2,-6,8,2,-7,8,1,0,-9,-23,2,-4,2,2,0,-1,1,1,-1,-1,6,-1
KR_6600409081,420,0,23,12,-4,-1,2,1,-6,9,3,6,2,8,-1,1,0,-2,2,0,0,-7,2,-3,-2,5,-1,0,1,1,-1,1,-1,4,-1
KR_6764767646,440,-2,-14,-4,-7,2,2,4,2,3,5,1,0,1,-10,10,0,-2,3,1,0,-14,-15,3,-5,2,-4,0,1,-1,1,-1,-1,2,-1
KR_6750611585,420,0,25,-8,-4,-1,2,1,-4,6,2,4,1,5,-2,3,1,-1,1,0,1,-6,-268,6,-10,4,-3,0,-1,-1,1,-1,1,1,-1
KR_6679824955,420,1,-20,0,1,0,2,2,1,1,2,2,0,2,-2,6,4,0,4,4,-1,-5,26,2,-6,4,0,0,0,-1,1,-1,-1,5,-1
KR_6757242219,420,-2,-59,20,-7,-2,4,2,1,0,1,0,1,1,-6,6,0,0,0,0,0,-9,-9,-1,-4,5,-3,0,-2,-1,1,-1,-1,3,-1
KR_6611253406,420,6,98,-5,14,1,0,1,4,2,6,1,1,2,8,0,8,0,0,0,1,16,13,3,-5,2,4,0,1,-1,-1,1,1,5,-1
KR_6533258869,420,-2,53,15,-5,-2,3,1,-4,7,3,0,0,0,2,1,3,-1,1,0,0,-7,-8,-5,-2,7,2,0,0,-1,-1,-1,1,4,-1
KR_6700930672,420,-3,-27,-26,-3,-2,5,3,-2,5,3,-2,4,2,0,1,1,3,0,3,0,-1,16,6,-8,2,-3,0,0,-1,1,0,1,6,-1
KR_6766797621,420,-4,-95,-15,-4,-3,5,2,3,1,4,-1,1,0,-4,5,1,1,1,2,-1,-4,-37,1,-7,6,-3,0,-2,-1,-1,-1,-1,4,-1
KR_6515160044,420,-1,39,-1,-8,-1,1,0,0,1,1,-3,4,1,-3,5,2,-1,1,0,-1,-14,2,-4,-4,8,0,0,0,-1,-1,1,-1,6,-1
KR_6736897741,420,-4,-79,8,-7,-5,5,0,-1,2,1,1,1,2,-3,4,1,1,1,2,0,-6,33,8,-11,3,-1,0,-2,1,-1,-1,-1,2,-1
KR_6732813178,420,-2,-10,-8,-9,0,1,1,-8,10,2,-1,3,2,0,2,2,0,0,0,0,-17,20,-6,-2,8,0,0,0,-1,-1,0,1,2,-1
KR_6750651014,420,-2,-47,-24,-5,-3,3,0,3,0,3,-3,4,1,-2,3,1,0,0,0,0,-4,25,-5,-3,8,0,0,-1,-1,1,-1,-1,5,-1
KR_6767591787,420,-2,-20,-28,3,2,1,3,1,1,2,2,0,2,-4,5,1,2,0,2,0,3,21,2,-3,1,-2,0,-1,-1,0,-1,-1,1,-1
KR_6711641696,420,-1,-13,-2,1,0,3,3,2,3,5,0,2,2,1,5,6,-2,2,0,0,-4,-4,-5,-4,9,-1,0,0,0,1,0,-1,0,-1
KR_6748800367,440,-1,6,-16,-1,-1,1,0,-2,6,4,0,3,3,-1,3,2,3,0,3,1,0,-25,-3,-3,6,2,0,0,-1,1,0,1,5,-1
KR_6713613812,420,2,4,14,10,1,2,3,0,0,0,10,0,10,0,2,2,-1,2,1,0,10,32,-3,-2,5,3,0,1,1,1,1,-1,5,-1
KR_6760160980,420,0,-9,16,-5,-1,2,1,4,1,5,-4,5,1,-5,7,2,1,0,1,0,0,1,1,-8,7,3,0,0,-1,0,0,-1,2,-1
KR_6467942714,420,-2,-25,-25,-6,2,1,3,-4,6,2,1,1,2,-5,5,0,0,0,0,0,-4,-128,-4,-2,6,5,0,0,-1,-1,0,-1,4,-1
KR_6761946865,420,-2,-40,31,-7,-2,4,2,-2,3,1,2,0,2,1,2,3,-6,6,0,0,-6,-28,1,-4,3,14,0,-1,-1,-1,-1,-1,5,-1
KR_6739062466,420,3,28,-4,8,5,2,7,0,3,3,-2,5,3,3,2,5,2,1,3,0,9,-46,2,-6,4,17,0,2,1,1,1,1,6,-1
KR_6658989712,420,1,-43,-8,-4,4,1,5,2,3,5,-4,5,1,-8,8,0,2,1,3,0,-5,25,-2,-2,4,-4,0,-1,-1,-1,-1,-1,3,-1
KR_6689404661,420,-2,-77,-48,-4,-1,1,0,-2,4,2,-1,4,3,1,1,2,-1,1,0,0,-2,-9,-3,-2,5,-1,0,-1,-1,1,-1,-1,3,-1
KR_6743726875,420,1,30,6,-1,0,6,6,1,0,1,-2,3,1,3,0,3,-3,3,0,0,-10,-9,0,-5,5,-4,0,0,1,0,0,-1,1,-1
KR_6750375236,420,-5,-21,-35,-7,-2,4,2,-3,3,0,-5,5,0,2,0,2,1,0,1,0,-4,-15,5,-6,1,-2,0,0,1,1,-1,-1,2,-1
KR_6675906602,420,-2,19,4,-7,1,0,1,-2,4,2,0,2,2,-3,3,0,-3,3,0,0,-15,36,-2,-5,7,-28,0,0,1,0,1,1,1,-1
KR_6718711350,420,1,-29,52,3,0,1,1,3,2,5,-2,4,2,-1,1,0,3,0,3,-1,-2,-5,-3,-2,5,4,0,0,1,1,0,-1,3,-1
KR_6732266118,420,-5,-114,-20,-12,-2,3,1,-6,6,0,3,4,7,-3,5,2,-4,4,0,3,-8,-5,-7,-5,12,9,0,-2,-1,-1,-1,1,4,-1
KR_6759638931,420,-1,8,-16,-4,1,0,1,0,2,2,-7,9,2,1,2,3,1,0,1,0,-8,1,1,-5,4,-7,0,1,1,-1,-1,-1,5,-1
KR_6756306923,420,-4,-33,-49,-7,-3,4,1,1,2,3,0,2,2,-1,3,2,-4,4,0,0,-2,3,1,-6,5,-9,0,-1,1,-1,-1,1,1,-1
KR_6744514633,420,-1,-18,4,0,-5,5,0,1,3,4,2,3,5,2,1,3,0,1,1,1,5,229,2,-4,2,1,0,0,-1,-1,0,1,1,-1
KR_6683648975,420,-3,-52,-11,-6,-1,1,0,-9,9,0,3,2,5,0,3,3,1,1,2,2,-10,3,-3,-4,7,2,0,0,-1,-1,-1,1,4,-1
KR_6695738877,420,1,13,24,-2,-1,3,2,1,1,2,-2,4,2,-3,3,0,3,0,3,0,-2,17,2,-5,3,-2,0,-1,1,-1,-1,1,2,-1
KR_6746121240,420,-3,-50,4,-4,2,1,3,-2,6,4,3,1,4,-4,5,1,-3,3,0,0,-9,52,2,-5,3,-25,0,1,-1,1,-1,-1,1,-1
KR_6766207642,420,1,49,-26,2,2,0,2,-1,3,2,1,2,3,2,3,5,-2,3,1,1,11,20,1,-4,3,0,0,1,0,0,1,1,0,-1
KR_6770770149,440,-2,-82,-4,-5,-3,4,1,-4,6,2,3,3,6,-2,4,2,1,1,2,0,-4,-5,-4,0,4,1,0,-1,1,-1,-1,1,1,-1
KR_6719773620,440,1,-94,-16,-5,-2,2,0,0,2,2,-3,5,2,-2,3,1,2,3,5,0,1,0,2,-6,4,-2,0,-1,-1,-1,-1,-1,6,-1
KR_6729553107,440,-5,-50,-24,-10,-4,5,1,-4,4,0,-1,2,1,-8,9,1,7,1,8,1,-11,5,1,-6,5,-1,0,-1,-1,-1,-1,1,5,-1
KR_6743190546,420,-6,-66,-11,-6,-4,5,1,-2,2,0,-1,1,0,2,2,4,-1,1,0,0,-6,-4,-5,-2,7,3,0,1,0,1,1,-1,0,-1
KR_6730773270,420,2,-2,-8,7,1,1,2,-4,4,0,2,2,4,7,0,7,1,2,3,0,3,-11,5,-9,4,1,0,0,-1,-1,0,1,3,-1
KR_6754191330,440,-1,-36,32,-2,0,1,1,-2,6,4,-1,1,0,2,0,2,-1,1,0,0,-4,12,1,-6,5,2,0,0,1,1,0,1,5,-1
KR_6763284916,440,-4,28,-11,-16,-2,3,1,-1,4,3,-12,13,1,-2,3,1,1,0,1,0,-13,2,-4,-1,5,-2,0,-1,-1,-1,-1,1,1,-1
KR_6764828098,440,-2,-5,1,-5,-4,5,1,0,0,0,2,0,2,-1,3,2,-2,3,1,-1,-6,3,1,-5,4,6,0,-1,-1,1,-1,-1,2,-1
KR_6636215376,440,2,45,8,8,-3,4,1,3,3,6,2,3,5,4,1,5,2,0,2,0,5,-7,2,-5,3,2,0,1,1,-1,-1,1,6,-1
KR_6768617707,420,-3,39,-44,-3,0,1,1,4,1,5,-4,5,1,-4,6,2,1,0,1,1,-7,-38,-2,-3,5,1,0,0,-1,0,0,1,5,-1
KR_6757803855,420,-4,-102,-16,-5,0,2,2,-3,7,4,-1,2,1,0,1,1,-1,2,1,0,-10,-2,-3,-5,8,-1,0,-2,-1,-1,-1,-1,5,-1
KR_6761898470,420,-3,-82,-36,-5,-2,3,1,4,1,5,-1,1,0,-5,7,2,-1,1,0,0,-1,14,-4,-3,7,-4,0,-1,-1,0,-1,1,1,-1
KR_6673023083,420,-2,-84,1,-13,-2,3,1,-3,5,2,-1,3,2,-4,6,2,-3,4,1,0,-8,5,-6,-2,8,-3,0,0,0,0,-1,-1,0,-1
KR_6753383612,420,2,30,-4,0,2,1,3,2,5,7,0,3,3,1,3,4,-5,7,2,0,10,59,2,-5,3,-4,0,0,1,-1,1,1,4,-1
KR_6711050747,420,0,-10,-8,1,4,2,6,-2,3,1,-1,2,1,-1,1,0,1,0,1,0,0,-9,-1,-7,8,-2,0,0,-1,1,0,-1,5,-1
KR_6700973753,420,-1,4,10,-1,-1,2,1,-5,8,3,-1,2,1,5,2,7,1,2,3,0,0,139,2,-5,3,3,0,-1,1,-1,-1,1,5,-1
KR_6735032610,420,2,31,-4,3,-2,3,1,0,1,1,2,1,3,3,0,3,0,0,0,0,6,29,-3,-3,6,1,0,-2,-1,-1,-1,-1,1,-1
KR_6767335912,440,-2,-53,12,-9,1,0,1,-3,4,1,-3,4,1,0,1,1,-4,6,2,0,-8,-2,-2,-3,5,-3,0,-1,1,1,1,-1,1,-1
KR_6732418962,420,1,52,22,-2,-1,1,0,-4,5,1,1,0,1,4,1,5,-2,2,0,0,-2,-5,3,-6,3,6,0,1,1,1,1,-1,6,-1
KR_6660818339,420,-3,-49,-25,-4,2,0,2,0,2,2,-6,6,0,-1,2,1,1,1,2,0,-5,-48,4,-7,3,29,0,-2,1,-1,-1,-1,3,-1
KR_6759442325,420,4,28,4,6,2,2,4,6,1,7,1,1,2,-5,6,1,2,0,2,0,-2,124,9,-12,3,-1,0,2,-1,1,1,1,5,-1
KR_6654094578,420,-3,-62,16,-12,-1,2,1,-2,3,1,-3,3,0,-6,6,0,0,0,0,0,-14,-6,-1,-5,6,1,0,-1,1,1,-1,-1,1,-1
KR_6770984808,420,-1,-66,-15,1,-3,3,0,3,3,6,-3,3,0,4,2,6,0,1,1,0,6,6,-2,-5,7,2,0,0,-1,1,0,-1,3,-1
KR_6769521715,420,-2,-37,22,-2,-1,3,2,-3,3,0,-2,3,1,2,5,7,2,1,3,1,3,2,3,-5,2,-2,0,-1,-1,1,1,1,2,-1
KR_6756391364,420,-5,-84,-15,-10,-7,8,1,-2,5,3,-2,3,1,-2,5,3,3,0,3,0,-1,-7,-6,-7,13,2,0,-1,-1,1,-1,-1,6,-1
KR_6752050102,420,-2,4,-48,-6,2,0,2,-6,7,1,-5,5,0,0,2,2,3,0,3,0,-7,4,0,-7,7,1,0,1,-1,1,1,-1,4,-1
KR_6771076907,420,-4,-54,3,-10,-2,3,1,-3,6,3,0,3,3,-5,10,5,0,0,0,0,-23,-4,1,-5,4,-3,0,-2,1,-1,-1,-1,6,-1
KR_6603271184,420,-3,1,3,-3,0,1,1,-2,5,3,-1,2,1,2,2,4,-2,2,0,0,0,401,-4,-1,5,-4,0,0,-1,1,1,1,6,-1
KR_6765625134,420,-6,-91,-4,-11,-2,4,2,-1,2,1,-2,3,1,-5,8,3,-1,2,1,0,-10,15,-4,-3,7,-4,0,-3,1,-1,-1,-1,2,-1
KR_6768045131,420,-2,-39,-11,-1,2,0,2,3,0,3,0,1,1,-5,8,3,-1,1,0,0,2,1,1,-2,1,-2,0,-1,-1,0,-1,1,4,-1
KR_6582837238,420,-1,-16,-16,-3,1,1,2,-4,5,1,2,1,3,-2,2,0,0,1,1,0,-5,11,0,-5,5,-5,0,-1,0,-1,-1,1,0,-1
KR_6760456855,420,-2,-32,-8,-1,-4,4,0,0,1,1,-1,1,0,4,2,6,0,0,0,0,5,-6,-2,-5,7,7,0,-2,1,-1,-1,1,4,-1
KR_6715390253,420,-1,-10,0,-2,1,1,2,-4,6,2,2,1,3,0,4,4,-1,1,0,0,-8,-6,0,-5,5,4,0,-2,1,-1,-1,1,6,-1
KR_6765186264,420,1,6,-15,2,4,1,5,3,1,4,3,1,4,1,1,2,-9,10,1,0,-2,-2,3,-5,2,0,0,1,1,-1,1,-1,3,-1
KR_6693995593,420,-4,-41,9,-9,2,1,3,0,1,1,-4,6,2,-6,8,2,-1,2,1,0,-12,10,1,-7,6,-6,0,-2,-1,-1,-1,-1,5,-1
KR_6723929473,420,-4,-56,-16,-9,-1,3,2,1,4,5,0,2,2,-7,8,1,-2,2,0,0,-12,-2,-1,-6,7,4,0,-1,-1,1,-1,-1,6,-1
KR_6762329728,420,0,11,-17,3,-3,5,2,3,5,8,4,3,7,-2,4,2,1,1,2,-4,-9,-3,-3,-5,8,4,0,-1,-1,-1,-1,-1,2,-1
KR_6534094410,420,-1,-26,-12,-3,2,1,3,-3,5,2,-1,1,0,-3,4,1,2,0,2,1,-5,-10,2,-5,3,-2,0,0,-1,1,0,1,1,-1
KR_6762925649,420,0,-12,-1,-2,0,3,3,4,0,4,-2,4,2,-2,5,3,-2,2,0,0,3,-119,-2,-2,4,0,0,0,-1,-1,-1,1,6,-1
KR_6759907832,440,-1,9,-12,-9,-4,4,0,3,0,3,-5,6,1,0,5,5,-3,4,1,0,-11,-15,-1,-3,4,-1,0,-1,0,-1,1,-1,0,-1
KR_6710118849,420,-2,-36,12,-12,-1,2,1,1,2,3,-9,10,1,-3,4,1,0,0,0,0,-12,-175,-4,-4,8,1,0,-1,-1,1,-1,-1,6,-1
KR_6767121599,420,5,0,-4,8,1,1,2,4,1,5,2,2,4,1,0,1,0,0,0,0,12,-49,-4,-5,9,26,0,0,1,-1,-1,1,3,-1
KR_6637562391,420,-3,-79,-27,-3,-4,4,0,0,3,3,0,2,2,0,1,1,1,0,1,0,3,2,0,-5,5,4,0,-1,-1,-1,-1,1,2,-1
KR_6735194842,420,0,11,-1,-1,3,2,5,-2,3,1,-3,3,0,0,1,1,1,1,2,1,-2,33,-4,-1,5,-24,0,-1,-1,-1,-1,1,2,-1
KR_6676707736,420,-3,-13,-32,-6,-1,3,2,0,4,4,1,4,5,-5,7,2,-1,3,2,0,-8,29,-1,-5,6,-1,0,0,-1,1,0,-1,6,-1
KR_6730431524,420,-1,18,-20,0,6,0,6,-5,5,0,-2,5,3,0,4,4,1,1,2,0,-2,-33,-4,-3,7,5,0,0,0,1,1,-1,0,-1
KR_6752218605,420,-2,-20,-4,-1,-1,1,0,0,6,6,-2,4,2,0,1,1,2,0,2,0,-4,-10,-2,-2,4,3,0,-1,1,-1,-1,1,4,-1
KR_6714021443,420,-2,-69,16,-1,-2,3,1,1,2,3,0,2,2,1,0,1,-1,3,2,0,1,-1,1,-5,4,2,0,0,-1,1,-1,-1,1,-1
KR_6635292907,420,1,58,46,1,-1,2,1,-2,3,1,3,0,3,1,2,3,0,0,0,0,4,2,3,-10,7,-3,0,0,1,1,1,1,4,-1
KR_6768168713,420,-2,5,12,-3,-2,3,1,-4,5,1,-4,5,1,4,2,6,3,0,3,0,-1,8,3,-8,5,3,0,0,-1,1,1,1,4,-1
KR_6738283161,420,-2,7,0,-3,2,3,5,5,0,5,-6,6,0,-1,3,2,-3,3,0,0,-3,8,1,-7,6,-2,0,-1,0,-1,-1,1,0,-1
KR_6740947908,420,2,-28,44,5,2,0,2,10,2,12,-2,2,0,-2,2,0,-3,3,0,0,0,-20,-1,-2,3,5,0,-1,-1,1,-1,-1,6,-1
KR_6765137070,420,-3,-86,17,-9,0,2,2,-4,7,3,-1,4,3,-2,3,1,-2,2,0,0,-6,-6,-5,-1,6,4,0,-1,-1,-1,-1,-1,3,-1
KR_6655418147,420,-5,-49,-37,-4,-5,5,0,-4,5,1,1,2,3,4,0,4,0,0,0,0,-4,-9,3,-4,1,3,0,-1,1,-1,-1,-1,2,-1
KR_6740743341,440,-4,-72,-22,-15,-3,4,1,1,3,4,-2,3,1,-10,12,2,-1,2,1,-1,-21,-4,3,-8,5,-1,0,-3,-1,-1,-1,-1,6,-1
KR_6762262311,420,2,11,0,-1,6,1,7,-7,9,2,-2,3,1,1,0,1,1,0,1,0,-10,1,-3,-6,9,-4,0,0,1,0,1,1,4,-1
KR_6722807537,420,-4,-52,-7,-8,0,0,0,-2,2,0,1,1,2,-6,6,0,-1,2,1,-1,-13,-11,-4,-3,7,2,0,-1,-1,-1,-1,-1,6,-1
KR_6751487503,420,-2,21,7,-5,5,1,6,-3,3,0,-6,6,0,-1,2,1,0,1,1,0,-7,0,0,-3,3,-2,0,0,-1,1,1,1,3,-1
KR_6746372305,420,-3,-93,12,-12,-6,6,0,-2,3,1,-3,3,0,-1,5,4,0,2,2,0,-9,-13,1,-8,7,-1,0,-1,1,-1,-1,1,5,-1
KR_6687237919,420,-4,-61,-23,-15,1,1,2,-5,5,0,-4,4,0,-8,9,1,1,0,1,-1,-13,-5,-8,-5,13,-6,0,-1,1,-1,-1,-1,2,-1
KR_6769064924,420,0,41,13,-3,2,0,2,-5,6,1,2,2,4,0,2,2,-2,2,0,-1,-7,0,1,-7,6,-3,0,1,1,1,1,-1,2,-1
KR_6552861505,420,0,48,12,3,-3,4,1,5,2,7,-2,3,1,1,2,3,2,0,2,0,14,22,4,-9,5,3,0,1,1,1,1,1,1,-1
KR_6733840080,420,1,-36,-4,-2,-1,4,3,0,2,2,-4,5,1,5,1,6,-2,2,0,0,4,38,2,-8,6,-1,0,-2,1,-1,-1,-1,6,-1
KR_6744897435,420,-2,-50,-16,-5,-2,3,1,-3,6,3,-1,3,2,1,1,2,0,0,0,0,0,-10,-2,-6,8,-1,0,-2,1,-1,-1,-1,4,-1
KR_6748387385,420,-4,-42,-14,-11,-2,3,1,-8,10,2,-1,4,3,2,1,3,-2,2,0,-1,-3,-2,1,-6,5,3,0,-1,-1,-1,-1,-1,6,-1
KR_6737282143,420,-1,32,-5,0,0,2,2,-2,3,1,0,2,2,3,1,4,-1,1,0,0,-1,-7,0,-4,4,1,0,0,-1,0,0,-1,2,-1
KR_6716689773,420,-3,-75,4,-13,1,2,3,-3,4,1,-1,4,3,-11,14,3,1,0,1,0,-13,5,-1,-4,5,-2,0,-2,-1,0,-1,-1,2,-1
KR_6756018132,420,4,49,0,4,5,0,5,1,3,4,-1,3,2,0,0,0,-1,1,0,0,7,13,0,-8,8,-1,0,1,-1,0,1,-1,3,-1
KR_6757889784,420,-1,24,15,-3,5,0,5,-1,3,2,-2,5,3,2,2,4,-7,7,0,-1,-16,-7,-1,-3,4,-4,0,-1,0,-1,-1,-1,0,-1
KR_6768682987,420,1,51,-6,10,11,0,11,0,2,2,-1,3,2,-1,3,2,1,1,2,1,-1,-41,5,-6,1,9,0,0,-1,-1,1,1,2,-1
KR_6769085550,420,-2,69,-8,-2,0,1,1,2,6,8,-1,1,0,-1,4,3,-2,3,1,0,-3,11,2,-5,3,-4,0,-1,-1,-1,-1,1,2,-1
KR_6624243588,440,0,24,1,-1,-1,1,0,0,3,3,2,0,2,-5,8,3,3,0,3,0,0,18,0,-6,6,2,0,1,1,-1,1,1,3,-1
KR_6757142101,420,-2,-27,9,-10,-1,2,1,-1,4,3,-11,11,0,3,3,6,0,1,1,0,-3,-9,-2,-5,7,-1,0,-1,-1,1,-1,-1,1,-1
KR_6731686593,440,-2,6,-10,1,6,1,7,-1,2,1,1,1,2,-3,3,0,-2,2,0,0,-7,23,2,-7,5,-6,0,0,-1,1,-1,1,5,-1
KR_6726877890,420,0,-42,16,4,-2,4,2,2,1,3,5,3,8,0,2,2,-1,1,0,0,6,2,3,-5,2,4,0,1,1,1,1,1,4,-1
KR_6738598387,420,-2,33,-36,-8,-2,3,1,1,3,4,-2,4,2,0,4,4,-5,5,0,0,-12,-212,1,-6,5,-31,0,-3,-1,-1,-1,-1,1,-1
KR_6768678983,420,-7,-71,6,-9,-1,6,5,0,5,5,-1,2,1,-7,7,0,0,0,0,0,-9,-151,2,-7,5,-5,0,-2,-1,-1,-1,-1,2,-1
KR_6750082156,420,1,52,48,-1,3,2,5,-6,9,3,1,2,3,-2,3,1,3,0,3,0,-7,-5,1,-6,5,-2,0,0,1,-1,1,-1,6,-1
KR_6763124663,420,-1,-9,24,4,-1,1,0,2,1,3,2,1,3,0,0,0,1,0,1,0,2,13,3,-6,3,-4,0,0,1,1,0,1,1,-1
KR_6768838308,420,-3,-57,-25,-10,0,3,3,1,4,5,-3,4,1,-5,7,2,-3,4,1,-1,-4,128,-2,-6,8,-3,0,-1,-1,-1,-1,-1,4,-1
KR_6681093173,420,4,50,19,6,1,1,2,-1,2,1,3,0,3,0,1,1,3,0,3,0,2,8,1,-5,4,2,0,0,0,0,1,1,0,-1
KR_6546159026,420,2,20,19,4,0,0,0,-4,9,5,0,2,2,8,2,10,0,0,0,0,-3,73,0,-5,5,-1,0,0,1,1,1,1,1,-1
KR_6760534612,420,0,-41,-2,-3,-1,2,1,2,1,3,1,1,2,-2,3,1,-3,3,0,0,-4,4,0,-5,5,-3,0,-1,1,-1,-1,-1,6,-1
KR_6731220235,420,-4,-79,-3,-12,-6,6,0,-3,5,2,-3,4,1,0,5,5,0,2,2,-1,-14,21,-2,-6,8,-1,0,0,-1,-1,-1,-1,2,-1
KR_6713337516,420,2,11,-30,6,1,0,1,1,3,4,0,1,1,5,0,5,-1,1,0,0,11,31,10,-11,1,-4,0,1,1,1,1,1,3,-1
KR_6694211321,420,-1,-25,-3,-11,-2,2,0,-4,4,0,-4,5,1,-2,2,0,1,0,1,0,-15,74,3,-6,3,-3,0,-1,-1,-1,-1,-1,3,-1
KR_6763214730,440,-1,22,-35,5,0,4,4,0,4,4,-1,2,1,4,1,5,2,0,2,1,18,-7,-5,-4,9,-2,0,0,-1,1,0,1,6,-1
KR_6590302986,420,0,15,-8,4,-2,4,2,-2,3,1,4,1,5,-1,6,5,5,0,5,0,4,2,2,-7,5,-2,0,1,1,0,1,1,1,-1
KR_6595891836,420,-5,-47,-2,-2,-2,3,1,-3,4,1,-7,8,1,7,3,10,3,2,5,1,3,13,-5,-4,9,2,0,-1,0,-1,-1,1,0,-1
KR_6760135897,440,-2,-76,-8,-7,1,1,2,-5,5,0,1,1,2,-4,4,0,0,0,0,0,-8,-41,1,-3,2,-5,0,0,0,0,0,1,0,-1
KR_6767163761,420,-2,-49,40,-1,-2,2,0,-1,4,3,3,3,6,0,0,0,-1,2,1,-1,-3,-7,-4,-3,7,0,0,0,-1,-1,0,-1,5,-1
KR_6725979547,420,2,61,24,-4,-5,7,2,0,3,3,-1,6,5,1,0,1,1,0,1,0,-12,118,-2,-4,6,-1,0,0,1,-1,-1,1,6,-1
KR_6717187335,420,-1,-42,-14,-1,0,2,2,-1,4,3,2,1,3,-2,2,0,0,1,1,0,5,3,1,-6,5,2,0,-1,-1,1,-1,-1,2,-1
KR_6730144723,420,0,-56,26,0,0,1,1,1,2,3,-1,7,6,0,4,4,0,2,2,0,-6,42,2,-5,3,-1,0,-2,-1,1,1,-1,1,-1
KR_6603423344,420,-1,-30,-8,-9,-7,7,0,5,1,6,0,3,3,-5,6,1,-2,4,2,-2,-3,-7,-8,-2,10,3,0,-1,-1,-1,-1,-1,6,-1
KR_6760045584,420,-2,-51,0,-4,0,0,0,2,2,4,-5,6,1,-1,3,2,0,1,1,0,-4,-7,-3,-1,4,5,0,0,-1,1,1,1,6,-1
KR_6741368377,420,0,-56,13,-4,0,2,2,-6,6,0,-3,5,2,2,7,9,3,1,4,0,4,-31,-3,-4,7,4,0,-2,1,-1,-1,1,1,-1
KR_6681287865,420,-2,25,-7,-5,1,0,1,1,2,3,0,1,1,-5,7,2,-2,2,0,0,-8,2,2,-8,6,1,0,0,-1,-1,0,-1,4,-1
KR_6766176390,420,1,-29,4,0,-1,3,2,-5,6,1,-2,3,1,8,2,10,0,0,0,0,1,9,2,-5,3,-1,0,1,1,-1,1,-1,4,-1
KR_6760767066,420,-5,-33,-3,-8,-1,4,3,-2,3,1,-5,5,0,0,2,2,0,0,0,0,-18,4,-5,-1,6,1,0,0,-1,1,0,1,6,-1
KR_6752369062,420,-5,-45,10,-7,-1,4,3,-3,5,2,1,2,3,-2,3,1,-2,2,0,0,-7,-14,-4,-4,8,5,0,-1,-1,0,-1,1,1,-1
KR_6632030114,420,0,-43,-9,4,0,3,3,4,0,4,0,2,2,-2,3,1,2,0,2,0,9,69,-1,-4,5,2,0,-1,-1,-1,-1,-1,5,-1
KR_6634787485,420,0,-29,-18,-3,2,0,2,-3,6,3,-5,5,0,2,0,2,1,0,1,0,-10,-14,1,-6,5,-1,0,1,-1,-1,1,1,1,-1
KR_6748922178,420,-3,39,-11,-8,1,2,3,-7,8,1,-2,3,1,2,1,3,-2,4,2,1,-10,-11,-6,-5,11,7,0,-1,-1,-1,-1,1,3,-1
KR_6703797184,420,0,-71,-9,1,-1,4,3,4,1,5,0,2,2,-2,4,2,0,2,2,0,9,0,2,-4,2,0,0,-2,-1,-1,-1,-1,6,-1
KR_6717583987,420,-1,-31,-1,0,3,3,6,-1,5,4,0,1,1,-3,5,2,1,0,1,0,-4,-40,4,-5,1,15,0,0,-1,0,-1,1,6,-1
KR_6768763378,420,-5,-17,-16,-5,1,0,1,0,2,2,-4,7,3,-1,3,2,-1,1,0,0,-4,22,-1,-4,5,-2,0,-1,-1,-1,-1,-1,6,-1
KR_6753242090,420,-3,-13,-24,-12,2,1,3,1,1,2,-3,4,1,-8,8,0,-4,4,0,0,-5,0,-1,-3,4,0,0,-3,-1,-1,-1,-1,4,-1
KR_6735933387,420,-3,12,-8,-6,1,1,2,1,1,2,-3,5,2,-6,7,1,1,0,1,0,-8,3,2,-4,2,2,0,0,1,0,-1,-1,2,-1
KR_6724899087,420,0,-30,-16,-2,1,0,1,-7,8,1,2,1,3,2,2,4,0,0,0,0,-11,-37,-2,-5,7,6,0,1,-1,0,1,1,5,-1
KR_6738123228,440,1,11,31,-4,1,0,1,-7,7,0,7,0,7,1,6,7,-6,6,0,-1,-13,-10,1,-5,4,4,0,-1,1,-1,-1,-1,5,-1
KR_6765349445,420,3,66,-20,5,4,3,7,-1,1,0,-2,4,2,3,1,4,1,0,1,0,0,3,-1,-4,5,1,0,0,-1,-1,0,1,6,-1
KR_6692460193,420,-2,56,-1,-6,0,1,1,-4,7,3,1,4,5,-2,3,1,-1,1,0,0,-2,7,-3,-5,8,-1,0,-2,-1,-1,-1,1,6,-1
KR_6770622632,420,1,-54,19,1,0,1,1,5,0,5,4,0,4,-7,8,1,-1,1,0,0,4,36,-7,-2,9,-13,0,0,1,-1,0,-1,4,-1
KR_6768185173,420,-5,-54,0,-9,-3,3,0,-2,2,0,-2,2,0,-1,4,3,-1,1,0,0,-4,-58,-5,-3,8,34,0,0,-1,-1,-1,1,4,-1
KR_6608335157,420,-2,-2,9,-3,-4,4,0,2,1,3,0,0,0,0,3,3,-1,1,0,0,-1,-2,-1,-4,5,3,0,0,1,-1,0,1,2,-1
KR_6764994701,420,0,-44,-57,4,-4,6,2,0,1,1,6,1,7,2,2,4,0,1,1,0,7,16,1,-4,3,4,0,-1,1,-1,-1,1,2,-1
KR_6681159954,420,-4,-27,0,-12,-6,9,3,4,2,6,-3,6,3,-3,5,2,-4,5,1,1,-4,-3,0,-3,3,-4,0,-2,-1,0,-1,1,3,-1
KR_6757729515,420,1,27,8,-3,2,1,3,-3,4,1,0,1,1,-1,2,1,-1,1,0,0,-9,-8,-1,-5,6,5,0,-1,-1,1,-1,1,6,-1
KR_6768648610,420,3,37,12,5,0,3,3,-3,6,3,1,2,3,5,2,7,2,0,2,0,8,280,0,-4,4,1,0,2,-1,1,1,-1,4,-1
KR_6659247650,420,1,-56,15,-5,2,1,3,-5,6,1,-1,2,1,-2,5,3,1,1,2,-1,-10,-2,-4,-5,9,1,0,-2,-1,-1,-1,-1,5,-1
KR_6653806097,420,-2,-2,9,-1,0,2,2,1,1,2,0,2,2,-1,2,1,-1,1,0,0,4,-3,3,-7,4,5,0,1,1,1,1,-1,2,-1
KR_6726477953,440,-4,-20,-30,-6,1,1,2,3,0,3,-2,3,1,-1,4,3,-7,7,0,-2,-5,9,-1,-9,10,-7,0,-1,-1,-1,-1,-1,2,-1
KR_6594465324,420,-1,15,-24,2,1,0,1,0,4,4,3,1,4,-3,3,0,1,0,1,0,1,-10,0,-5,5,1,0,0,-1,0,0,1,1,-1
KR_6616666456,420,1,19,0,1,-1,4,3,1,2,3,0,2,2,0,2,2,1,0,1,0,4,313,-3,-4,7,5,0,1,1,1,1,-1,5,-1
KR_6764969867,420,1,25,13,2,1,0,1,2,1,3,-2,3,1,3,1,4,-2,2,0,0,0,-11,2,-4,2,-2,0,-1,1,-1,-1,-1,1,-1
KR_6766612481,420,-5,-31,-6,-10,-2,2,0,-2,2,0,0,3,3,-7,9,2,1,0,1,0,-9,-67,-1,-2,3,2,0,0,0,-1,0,-1,0,-1
KR_6661309282,420,-5,-75,-60,-8,2,1,3,-5,7,2,-2,3,1,-2,6,4,-1,1,0,0,-3,-2,-1,-5,6,1,0,-2,0,0,-1,1,0,-1
KR_6765146915,420,-4,-29,-14,-6,1,3,4,-4,5,1,-1,4,3,1,3,4,-3,3,0,0,-13,3,-1,-4,5,1,0,0,-1,1,1,-1,5,-1
KR_6717198130,420,-1,5,-12,-7,-2,3,1,-2,4,2,-3,6,3,1,1,2,-1,1,0,0,-5,13,3,-7,4,0,0,0,0,1,1,-1,0,-1
KR_6579744090,420,-5,-63,-28,-10,0,1,1,-4,6,2,-5,6,1,1,3,4,-2,4,2,-1,-14,13,-3,-3,6,-1,0,-2,-1,1,-1,-1,3,-1
KR_6754023404,420,-6,-68,-24,-17,-4,5,1,-1,2,1,-4,4,0,-6,10,4,-2,2,0,0,-7,-46,-3,-3,6,-3,0,-3,-1,-1,-1,-1,1,-1
KR_6760520218,420,-1,-54,-7,-6,0,1,1,-1,3,2,-2,6,4,-4,5,1,1,0,1,0,-1,24,-2,-4,6,-21,0,0,-1,0,0,-1,4,-1
KR_6734431870,420,1,9,39,-3,-3,3,0,-3,3,0,0,0,0,-1,5,4,4,0,4,0,-3,16,-2,-2,4,4,0,0,-1,1,0,-1,1,-1
KR_6726277069,420,-1,-23,-28,-1,-1,1,0,4,5,9,-1,3,2,2,1,3,-5,6,1,0,1,6,-1,-3,4,1,0,0,1,-1,0,1,4,-1
KR_6757314173,440,2,32,24,2,1,1,2,2,0,2,-3,4,1,-6,7,1,8,2,10,-1,0,-5,0,-3,3,0,0,1,1,-1,1,-1,2,-1
KR_6723862742,420,0,22,4,-3,1,2,3,-2,4,2,-3,5,2,-1,1,0,2,0,2,0,1,11,0,-5,5,0,0,0,1,-1,0,-1,2,-1
KR_6701056225,420,-3,-52,-4,-10,-4,7,3,-4,5,1,-3,4,1,0,6,6,1,0,1,0,-15,-6,0,-4,4,1,0,-2,-1,-1,-1,-1,3,-1
KR_6760649054,420,0,-4,-26,0,-1,2,1,3,3,6,2,1,3,-3,6,3,-1,2,1,0,6,4,1,-6,5,1,0,-1,-1,-1,-1,-1,2,-1
KR_6662785515,420,3,20,8,4,-1,2,1,3,1,4,1,1,2,2,1,3,-1,1,0,0,5,123,-7,-3,10,7,0,0,1,-1,0,-1,5,-1
KR_6745940406,420,2,55,13,-2,0,1,1,0,3,3,0,0,0,2,1,3,-4,5,1,1,0,-5,-4,-1,5,1,0,-1,-1,-1,-1,1,4,-1
KR_6769039003,420,1,-80,-4,4,2,1,3,5,1,6,-2,5,3,-2,2,0,1,0,1,0,7,-4,-2,-2,4,0,0,-1,1,-1,-1,1,1,-1
KR_6763324255,440,-2,-60,-27,-3,3,2,5,2,2,4,-4,7,3,-4,4,0,0,1,1,1,-2,353,3,-5,2,-1,0,-1,-1,0,-1,1,5,-1
KR_6762902349,420,4,107,6,6,0,3,3,0,1,1,1,1,2,5,2,7,0,1,1,1,-3,-10,4,-6,2,3,0,2,1,1,1,1,6,-1
KR_6756443797,420,0,10,12,6,-2,3,1,7,1,8,-2,3,1,4,0,4,-1,2,1,0,4,-40,-3,-3,6,12,0,0,1,-1,1,1,5,-1
KR_6731728679,440,-8,-116,-48,-22,-4,7,3,-7,7,0,-2,4,2,-8,10,2,-1,2,1,0,-13,5,5,-6,1,-3,0,-3,0,0,-1,-1,0,-1
KR_6666793439,420,-4,-88,-16,-9,0,2,2,-4,4,0,-1,3,2,-3,5,2,-1,2,1,0,-4,-92,3,-6,3,-3,0,-2,-1,-1,-1,-1,6,-1
KR_6683303290,420,-2,-29,-8,-4,0,3,3,0,3,3,2,1,3,-5,6,1,-1,1,0,0,1,-9,0,-5,5,1,0,0,1,-1,0,1,5,-1
KR_6664159418,420,-1,-18,-19,-10,-5,6,1,-1,2,1,-6,6,0,3,0,3,-1,1,0,0,-2,-14,-2,-1,3,0,0,-1,-1,1,-1,-1,1,-1
KR_6760639962,420,0,38,18,5,0,1,1,3,0,3,2,3,5,-1,3,2,1,1,2,0,6,-11,-2,-5,7,1,0,0,-1,1,0,1,1,-1
KR_6689773566,420,-1,-25,-38,3,4,0,4,0,2,2,0,1,1,-3,4,1,2,2,4,0,-1,-1,0,-5,5,0,0,0,-1,0,1,1,6,-1
KR_6579617293,420,1,-8,38,3,4,0,4,3,1,4,0,2,2,-5,5,0,1,0,1,0,0,0,1,-4,3,2,0,1,-1,1,1,1,2,-1
KR_6605607998,420,-1,12,-20,-7,2,0,2,0,4,4,-2,3,1,-6,8,2,-1,3,2,0,-9,-9,1,-5,4,0,0,-1,-1,0,-1,-1,5,-1
KR_6701697778,420,-3,-50,-41,-8,-1,2,1,-6,6,0,0,4,4,1,3,4,-2,3,1,0,-3,-8,0,-5,5,2,0,-2,-1,-1,-1,-1,3,-1
KR_6736268750,420,-1,-25,12,-5,0,1,1,0,4,4,3,2,5,-7,8,1,-1,2,1,0,-3,-8,-2,-1,3,-2,0,-1,-1,1,-1,-1,5,-1
KR_6739612768,420,-2,-33,16,-3,0,2,2,-3,5,2,1,3,4,0,1,1,-1,2,1,0,-9,-21,2,-4,2,-2,0,0,1,-1,-1,-1,4,-1
KR_6766908963,420,-2,-27,-24,3,1,0,1,-2,3,1,5,0,5,-2,4,2,1,1,2,0,5,4,-1,-2,3,0,0,-1,-1,-1,-1,-1,4,-1
KR_6765690956,420,-2,-3,-16,-4,1,1,2,-2,5,3,-3,4,1,-3,5,2,3,0,3,1,-5,29,0,-4,4,-16,0,-2,-1,-1,-1,1,5,-1
KR_6759096337,420,0,57,-11,5,0,2,2,0,3,3,3,0,3,1,1,2,1,0,1,0,7,3,0,-5,5,-2,0,0,0,1,1,1,0,-1
KR_6770961022,420,-5,-87,-28,-10,-5,5,0,1,2,3,1,0,1,-6,6,0,-1,1,0,0,-6,17,-5,-4,9,-1,0,-1,-1,-1,-1,-1,6,-1
KR_6753943165,420,2,-19,-7,9,1,0,1,2,1,3,2,1,3,2,3,5,2,0,2,0,12,2,-1,-5,6,-1,0,0,-1,1,0,1,6,-1
KR_6582872796,420,-6,-80,15,-4,0,1,1,-3,4,1,0,6,6,-4,7,3,3,2,5,1,-10,-9,-2,-4,6,5,0,-1,1,1,-1,1,1,-1
KR_6755256165,440,-7,-76,-36,-15,-3,3,0,0,2,2,-7,9,2,-5,6,1,0,1,1,-1,-6,215,1,-3,2,0,0,-1,-1,-1,-1,-1,4,-1
KR_6764811464,440,2,-42,-4,4,-4,5,1,3,2,5,1,1,2,5,0,5,-1,1,0,0,7,13,-2,-4,6,2,0,-2,-1,-1,-1,1,2,-1
KR_6731602012,440,-2,-44,2,-10,0,1,1,-4,5,1,-4,5,1,-3,3,0,1,0,1,0,-14,11,3,-7,4,-5,0,0,0,0,0,-1,0,-1
KR_6764885867,420,-1,5,4,-4,-1,1,0,1,1,2,1,2,3,-3,5,2,-2,3,1,-1,-11,-27,5,-5,0,-4,0,-1,-1,1,-1,-1,6,-1
KR_6699113841,420,-1,-19,12,-5,-1,1,0,-5,8,3,0,2,2,1,2,3,0,0,0,0,-3,5,-2,-3,5,-3,0,0,-1,1,0,1,3,-1
KR_6768138216,420,-2,-17,-12,-5,0,2,2,0,0,0,-5,6,1,0,3,3,0,0,0,0,5,-2,2,-6,4,2,0,-1,-1,-1,-1,-1,2,-1
KR_6752201767,420,-2,-13,-13,-6,4,1,5,0,1,1,-6,6,0,-4,5,1,0,2,2,0,-3,15,10,-11,1,-9,0,0,-1,1,0,-1,2,-1
KR_6769914699,440,-3,-44,-11,1,-4,4,0,1,3,4,1,3,4,2,3,5,1,0,1,1,12,114,-2,-5,7,4,0,0,-1,-1,0,1,5,-1
KR_6769000050,420,-4,-79,-14,0,1,0,1,3,1,4,-2,2,0,-3,6,3,1,0,1,-1,-2,16,1,-7,6,-1,0,-1,1,-1,-1,-1,3,-1
KR_6630407289,420,-4,-7,2,-9,-5,6,1,-2,4,2,0,1,1,-3,4,1,1,0,1,0,-8,0,0,-6,6,-2,0,-1,-1,-1,-1,1,3,-1
KR_6708903665,420,1,-1,-28,0,2,0,2,0,4,4,0,2,2,-2,3,1,0,1,1,0,5,-8,0,-4,4,0,0,-1,1,-1,-1,-1,5,-1
KR_6680267164,420,0,27,6,-1,0,3,3,-3,3,0,0,2,2,-1,1,0,3,1,4,0,0,0,2,-4,2,2,0,-1,1,-1,-1,-1,3,-1
KR_6686263162,420,-4,-78,3,-10,-3,3,0,-1,2,1,3,1,4,-10,10,0,1,2,3,-1,-13,-178,-9,-1,10,3,0,-1,-1,1,-1,-1,1,-1
KR_6764391091,420,-1,-23,-12,-4,-3,4,1,3,1,4,0,2,2,-4,6,2,0,1,1,0,-2,162,2,-7,5,0,0,0,-1,1,0,-1,6,-1
KR_6602204746,420,-8,-102,-28,-18,-2,5,3,0,2,2,-3,4,1,-12,12,0,-1,2,1,0,-20,333,-2,-6,8,-5,0,-2,-1,1,-1,1,1,-1
KR_6753996962,420,-2,-57,28,-1,-3,3,0,2,2,4,-1,2,1,1,5,6,0,1,1,1,-3,2,-3,-2,5,17,0,-1,-1,1,-1,1,3,-1
KR_6746163497,440,1,6,-7,10,2,0,2,5,0,5,0,1,1,2,4,6,1,0,1,0,13,-6,0,-5,5,5,0,0,1,1,0,-1,6,-1
KR_6728629334,420,-1,33,-32,-3,2,0,2,-7,7,0,-1,5,4,2,0,2,1,0,1,0,-2,16,2,-6,4,2,0,0,1,-1,-1,1,1,-1
KR_6729956017,420,-2,-25,-20,-3,-2,2,0,-4,6,2,0,2,2,3,0,3,0,0,0,0,1,-25,3,-5,2,8,0,0,1,-1,0,-1,2,-1
KR_6728987535,420,-3,5,-24,-7,3,3,6,1,1,2,-3,4,1,-7,8,1,-1,1,0,1,-9,-51,-1,-4,5,-8,0,1,-1,-1,-1,-1,2,-1
KR_6717271021,420,-3,-21,-21,1,3,0,3,-4,6,2,1,1,2,0,3,3,1,0,1,-1,2,421,0,-5,5,0,0,0,-1,1,1,-1,5,-1
KR_6762153431,420,1,15,14,-1,1,1,2,-2,4,2,1,1,2,0,5,5,-1,1,0,0,-2,4,-1,-1,2,-7,0,2,-1,1,1,-1,1,-1
KR_6764578855,420,-1,-1,16,0,1,2,3,-2,4,2,1,1,2,1,1,2,-1,2,1,0,-5,4,0,-6,6,-6,0,0,-1,1,0,-1,1,-1
KR_6753965808,420,0,-15,-15,3,0,1,1,-4,5,1,1,4,5,5,1,6,1,1,2,1,-1,5,1,-4,3,-1,0,0,-1,-1,1,1,2,-1
KR_6733325596,420,-2,-44,-7,-8,3,2,5,-2,3,1,-4,4,0,-1,1,0,-4,4,0,-1,-8,-9,-4,-2,6,5,0,0,-1,1,1,-1,1,-1
KR_6533980298,420,-2,-28,-12,-2,-4,5,1,2,3,5,-1,1,0,2,4,6,-1,2,1,-2,-1,-5,4,-8,4,0,0,-1,1,-1,-1,-1,3,-1
KR_6630300522,420,-2,-19,-25,2,-2,2,0,4,2,6,0,1,1,0,2,2,0,0,0,0,6,16,3,-5,2,-5,0,-1,1,-1,-1,-1,4,-1
KR_6517295421,420,-5,-65,-30,-2,-2,4,2,1,2,3,-1,2,1,1,0,1,-1,1,0,0,2,-9,-7,-6,13,7,0,-1,-1,1,-1,1,5,-1
KR_6611354530,420,-2,14,4,-4,2,0,2,-5,5,0,-3,4,1,1,3,4,1,0,1,1,-7,-1,-5,-3,8,-5,0,-1,-1,-1,-1,1,4,-1
KR_6683708804,420,0,-37,-4,-1,-3,3,0,-2,5,3,1,1,2,4,1,5,-1,3,2,0,-4,0,5,-8,3,-2,0,0,-1,-1,1,-1,6,-1
KR_6720520446,420,0,-56,16,1,2,0,2,1,1,2,0,2,2,0,1,1,-2,2,0,0,1,1,-5,-1,6,-2,0,0,1,1,0,1,5,-1
KR_6770345549,420,2,42,-18,3,-1,2,1,1,1,2,2,1,3,2,1,3,-1,1,0,0,5,1,6,-8,2,2,0,0,-1,-1,0,-1,2,-1
KR_6760374637,420,0,34,15,-3,-3,4,1,0,3,3,-1,2,1,1,2,3,0,0,0,0,3,-11,0,-5,5,2,0,1,1,1,1,-1,1,-1
KR_6662169883,420,-5,-116,-37,-6,-1,2,1,1,0,1,-2,3,1,-3,3,0,-1,2,1,0,-6,-13,-4,-3,7,1,0,-3,-1,-1,-1,-1,5,-1
KR_6767372656,420,-4,-55,-20,-14,-1,2,1,-2,7,5,-4,4,0,-7,10,3,0,1,1,-2,-18,-8,-1,-4,5,3,0,-1,-1,-1,-1,-1,1,-1
KR_6767264495,420,1,26,-30,4,2,1,3,-2,3,1,3,1,4,3,1,4,-2,2,0,0,7,-6,-3,-4,7,4,0,-1,1,-1,-1,-1,2,-1
KR_6761751632,420,3,17,8,0,1,3,4,4,1,5,-2,5,3,1,1,2,-4,4,0,0,0,3,3,-6,3,4,0,1,-1,0,1,-1,5,-1
KR_6506383137,440,-1,34,-16,-3,2,1,3,2,6,8,-2,3,1,-4,5,1,-1,1,0,0,-1,30,0,-7,7,1,0,0,-1,-1,0,1,3,-1
KR_6704926839,420,-4,-66,-27,-6,-2,4,2,2,5,7,1,4,5,-5,5,0,-2,2,0,0,-4,-9,2,-7,5,-4,0,-2,1,-1,-1,-1,6,-1
KR_6688091991,420,-3,-62,36,-4,0,3,3,2,0,2,-2,3,1,-5,5,0,1,1,2,1,0,-48,0,-6,6,11,0,-3,1,1,-1,1,4,-1
KR_6738232068,420,-5,-47,-24,-8,-4,4,0,0,2,2,-2,5,3,-1,1,0,-1,1,0,0,-5,-145,-2,-4,6,-3,0,0,1,1,-1,-1,2,-1
KR_6755422866,420,-3,-42,-40,-7,-1,3,2,-2,4,2,3,4,7,-5,8,3,-2,2,0,-1,-7,-5,-2,-3,5,-1,0,-1,1,-1,-1,-1,6,-1
KR_6707570892,420,1,-51,23,-3,-1,4,3,-1,4,3,3,1,4,-3,6,3,-1,3,2,0,0,5,-6,-6,12,3,0,-1,-1,1,-1,-1,4,-1
KR_6763245751,420,0,13,3,-10,1,1,2,-4,4,0,-5,7,2,-1,4,3,-1,3,2,-1,-14,40,-2,-3,5,-7,0,-1,-1,1,-1,-1,6,-1
KR_6744188972,420,-6,-41,-38,-11,-5,5,0,-3,4,1,2,1,3,-4,9,5,-1,1,0,0,-16,9,2,-4,2,2,0,-1,-1,1,-1,1,3,-1
KR_6438355488,420,0,-33,23,3,1,2,3,0,6,6,-1,6,5,3,1,4,0,1,1,-1,11,-4,2,-9,7,-1,0,-1,1,1,-1,-1,1,-1
KR_6764825026,420,1,-92,11,3,-2,2,0,-3,5,2,9,0,9,-1,2,1,0,0,0,0,3,-12,2,-6,4,3,0,0,1,1,1,-1,4,-1
KR_6700902498,420,-2,-93,10,-5,-3,3,0,-3,4,1,4,1,5,2,1,3,-5,5,0,0,3,7,3,-8,5,-7,0,-2,-1,-1,-1,-1,6,-1
KR_6709844132,420,2,16,-4,0,1,1,2,-1,1,0,-2,4,2,1,4,5,1,0,1,-1,0,20,0,-3,3,-2,0,0,-1,1,1,-1,1,-1
KR_6387222026,420,-2,-56,-29,-1,-1,2,1,0,4,4,0,1,1,1,2,3,-1,1,0,0,1,-6,-3,-4,7,-1,0,-1,-1,1,-1,1,3,-1
KR_6675970049,420,-2,19,-28,-5,3,1,4,-5,6,1,0,1,1,-3,4,1,0,0,0,0,-10,-28,-4,-3,7,-2,0,0,-1,-1,0,1,1,-1
KR_6679734455,420,0,-60,32,-4,0,1,1,-1,1,0,-4,6,2,1,1,2,0,0,0,0,-3,20,1,-6,5,-5,0,0,1,-1,-1,1,2,-1
KR_6600482010,420,-1,1,24,-1,1,1,2,-2,3,1,4,2,6,-5,8,3,1,0,1,2,0,-30,2,-4,2,20,0,0,1,-1,0,1,3,-1
KR_6768996943,420,1,9,-24,6,1,2,3,2,1,3,1,5,6,0,1,1,2,0,2,0,5,-1,-1,-2,3,-2,0,0,1,1,1,1,6,-1
KR_5833441132,420,-1,-17,13,-8,5,0,5,-2,3,1,-3,3,0,-7,7,0,-1,1,0,0,-15,6,-3,-7,10,8,0,0,-1,1,1,1,3,-1
KR_6730787887,420,1,-23,8,1,1,2,3,-2,6,4,1,2,3,0,2,2,1,0,1,0,3,136,8,-9,1,-3,0,1,1,1,1,-1,1,-1
KR_6767775842,420,-1,-24,-16,0,-1,1,0,-1,3,2,3,1,4,0,6,6,-1,1,0,1,8,114,0,-6,6,-5,0,0,-1,1,0,1,5,-1
KR_6737328734,420,-2,-33,-46,-9,1,0,1,2,2,4,-5,8,3,-5,8,3,-2,3,1,-1,-11,-2,-6,-2,8,1,0,-1,0,1,1,-1,0,-1
KR_6624585469,420,-4,-52,-16,-6,0,0,0,1,2,3,-3,3,0,-7,7,0,3,2,5,0,-4,7,3,-8,5,-6,0,-3,-1,-1,-1,-1,1,-1
KR_6766612186,420,-4,-98,-24,-3,-2,2,0,0,3,3,0,2,2,-2,5,3,1,1,2,0,-4,31,-4,-5,9,3,0,0,-1,-1,0,-1,6,-1
KR_6751872303,420,1,10,28,-3,-1,1,0,-3,5,2,3,1,4,-2,6,4,0,0,0,0,-5,1,1,-6,5,2,0,-2,-1,1,-1,1,3,-1
KR_6759675364,420,-1,23,8,-7,0,2,2,-7,7,0,2,2,4,-1,3,2,-1,1,0,0,-19,-14,-3,-4,7,-3,0,0,-1,1,0,1,5,-1
KR_6696690022,420,-6,-66,-40,-14,-6,7,1,1,4,5,-2,3,1,-4,7,3,-3,3,0,0,-10,168,-1,-2,3,-2,0,-2,-1,-1,-1,-1,5,-1
KR_6641800705,420,3,-5,16,11,4,0,4,0,2,2,2,0,2,5,2,7,0,0,0,0,12,6,7,-10,3,-1,0,1,-1,1,1,1,6,-1
KR_6757461218,420,-1,-40,-5,-12,-4,6,2,-2,5,3,0,2,2,-5,5,0,-1,1,0,0,-18,-8,-1,-3,4,-4,0,-1,-1,-1,-1,1,3,-1
KR_6738359114,420,0,17,-20,-6,-5,6,1,-2,3,1,-1,3,2,1,3,4,1,1,2,0,1,-5,-4,-5,9,-2,0,0,-1,-1,-1,1,2,-1
KR_6751466329,420,-2,-35,-9,-12,0,1,1,-2,4,2,-1,5,4,-11,13,2,2,0,2,-1,-9,41,2,-6,4,-26,0,-1,1,-1,-1,-1,2,-1
KR_6576889396,420,-1,17,8,-1,4,1,5,-6,7,1,3,0,3,0,4,4,-2,3,1,0,-7,-2,-2,-2,4,-3,0,0,-1,1,1,1,4,-1
KR_6730322503,420,-4,12,-36,-8,2,1,3,-6,7,1,0,1,1,-1,4,3,-3,5,2,0,-8,-7,1,-3,2,0,0,-2,0,1,-1,-1,0,-1
KR_6647161092,420,-4,-20,0,-10,-1,1,0,-5,6,1,-1,1,0,-4,8,4,1,1,2,0,-6,-3,-9,-2,11,-1,0,-1,-1,-1,-1,-1,6,-1
KR_6691663167,420,-1,-1,-12,-2,2,2,4,-2,4,2,-4,5,1,-2,2,0,4,0,4,2,-6,-3,1,-5,4,-2,0,-1,-1,1,1,1,2,-1
KR_6747275314,420,-4,5,-9,-8,0,1,1,-3,8,5,-1,1,0,-3,3,0,-1,2,1,0,-8,-1,-1,-3,4,-2,0,-2,-1,-1,-1,-1,3,-1
KR_6752327886,420,-2,-44,-13,1,2,0,2,1,3,4,0,3,3,-2,6,4,0,0,0,1,2,-20,-2,-2,4,1,0,-1,1,-1,-1,1,2,-1
KR_6709817457,440,-1,9,-32,-2,3,1,4,-5,6,1,1,1,2,0,2,2,-1,1,0,0,-5,-17,-1,-3,4,-2,0,-2,-1,-1,-1,1,2,-1
KR_6744150689,420,-1,-9,-19,-1,-6,6,0,3,1,4,-1,2,1,2,3,5,1,0,1,1,-2,4,-6,0,6,1,0,0,1,-1,-1,1,6,-1
KR_6751581045,420,-3,26,-16,-5,-2,3,1,2,1,3,2,0,2,-6,7,1,-1,2,1,0,-6,-11,-6,-2,8,5,0,-1,-1,-1,-1,-1,5,-1
KR_6717882937,420,1,-18,3,2,-4,5,1,-1,3,2,7,1,8,0,1,1,0,0,0,1,6,-11,-2,-5,7,2,0,-2,1,1,-1,1,4,-1
KR_6766742987,420,-3,-13,-16,-7,-1,1,0,-2,4,2,0,1,1,0,3,3,-4,4,0,0,-4,22,3,-7,4,-3,0,-2,-1,-1,-1,-1,4,-1
KR_6746383643,420,-7,-77,-12,-19,-2,2,0,-4,4,0,-4,6,2,-3,3,0,-6,7,1,0,-14,9,-1,-3,4,0,0,-3,-1,-1,-1,-1,2,-1
KR_6755734484,420,-1,-18,16,-2,-2,2,0,-1,3,2,-1,4,3,0,3,3,2,0,2,0,0,0,-1,-6,7,0,0,0,1,-1,0,-1,5,-1
KR_6727358014,440,-3,-20,-25,-1,-2,5,3,-5,7,2,-1,2,1,7,1,8,0,1,1,0,3,2,3,-4,1,2,0,-1,-1,0,-1,-1,5,-1
KR_6741157708,420,-3,-63,-16,-3,-4,4,0,2,0,2,-2,2,0,1,4,5,0,2,2,0,3,-4,-1,-3,4,2,0,-3,-1,-1,-1,-1,5,-1
KR_6736819712,420,3,40,4,5,1,2,3,4,1,5,0,1,1,1,2,3,-1,2,1,0,3,-9,-2,-6,8,5,0,-1,-1,1,-1,1,3,-1
KR_6683397626,420,-5,-59,-20,-5,2,0,2,0,3,3,-3,6,3,-2,5,3,-2,3,1,0,-7,-39,-2,-3,5,-2,0,-2,1,1,-1,1,3,-1
KR_6766698216,420,-4,44,10,-6,0,1,1,-1,6,5,-1,2,1,-4,7,3,0,1,1,0,-7,-516,-1,-4,5,-1,0,-1,-1,-1,-1,1,2,-1
KR_6756891211,420,-1,5,4,-4,-2,3,1,-2,4,2,-1,1,0,-2,4,2,3,0,3,0,-5,11,4,-12,8,-16,0,-1,-1,-1,-1,1,4,-1
KR_6757099097,420,-2,-49,9,-4,0,0,0,-3,4,1,1,1,2,0,3,3,-2,2,0,0,-1,-34,-4,-2,6,1,0,0,1,1,-1,1,4,-1
KR_6766018997,440,-8,-57,-14,-16,-2,3,1,-5,5,0,-5,5,0,-4,5,1,0,1,1,0,-15,1,1,-5,4,-2,0,-1,-1,-1,-1,-1,4,-1
KR_6754978173,420,0,3,-9,1,0,2,2,-1,2,1,2,2,4,0,3,3,0,0,0,0,0,190,3,-7,4,3,0,1,1,1,1,-1,6,-1
KR_6616630737,420,-1,-24,-11,-1,0,2,2,0,3,3,-3,3,0,1,3,4,1,0,1,0,-3,0,0,-7,7,4,0,0,-1,-1,0,-1,1,-1
KR_6733568327,420,-2,-61,-39,2,-1,1,0,-2,6,4,6,0,6,-1,1,0,0,0,0,0,8,45,-1,-4,5,5,0,0,-1,-1,-1,-1,5,-1
KR_6725540618,420,1,26,-6,0,-1,2,1,-4,6,2,4,0,4,-3,4,1,4,1,5,0,1,2,1,-5,4,-2,0,-1,-1,-1,-1,-1,3,-1
KR_6703650072,420,0,-3,-1,0,-1,2,1,3,1,4,3,1,4,-2,3,1,-3,3,0,0,-3,1,2,-6,4,6,0,0,-1,1,0,1,5,-1
KR_6648664678,420,1,13,43,-1,-2,3,1,-3,5,2,0,4,4,3,1,4,1,2,3,0,-1,6,7,-9,2,-1,0,0,0,-1,0,1,0,-1
KR_6636747245,440,-3,-36,41,-13,-1,3,2,-8,9,1,-1,2,1,-3,3,0,0,0,0,0,-6,116,-2,-6,8,-1,0,-1,0,-1,-1,-1,0,-1
KR_6757116559,440,0,8,-12,-8,-2,4,2,-2,3,1,4,0,4,-9,9,0,1,0,1,0,-9,1,3,-8,5,1,0,0,-1,-1,0,1,4,-1
KR_6667946374,420,-3,-62,-1,-18,-5,5,0,-4,5,1,0,1,1,-3,6,3,-6,6,0,0,-19,-12,0,-4,4,1,0,-2,-1,1,-1,-1,5,-1
KR_6651503872,420,2,34,-60,0,0,3,3,-3,8,5,2,1,3,2,0,2,-1,1,0,0,-5,82,-2,-5,7,-3,0,-1,-1,-1,-1,-1,1,-1
KR_6682288483,420,1,12,36,-1,-6,6,0,0,1,1,2,1,3,6,3,9,-3,5,2,1,1,-11,-7,-2,9,4,0,-1,-1,0,-1,-1,6,-1
KR_6768647058,420,2,-10,20,4,1,0,1,2,4,6,2,1,3,-1,4,3,0,0,0,0,0,8,3,-6,3,-4,0,-1,1,-1,-1,-1,6,-1
KR_6714439538,420,0,-19,10,4,3,1,4,2,0,2,-1,2,1,-2,6,4,2,0,2,0,5,-7,-2,-2,4,6,0,-1,-1,1,-1,1,4,-1
KR_6742546459,420,-4,-9,-4,-8,-3,3,0,-4,6,2,1,2,3,-2,3,1,0,1,1,0,-5,2,0,-6,6,-4,0,0,-1,-1,-1,1,6,-1
KR_6757250663,420,0,-4,5,-2,3,1,4,-4,4,0,-2,2,0,0,1,1,1,0,1,1,-1,-8,-3,-3,6,-2,0,1,-1,-1,1,1,4,-1
KR_6750655608,420,1,52,-6,-7,-1,4,3,-1,2,1,1,3,4,-5,6,1,-1,1,0,0,-12,-3,1,-4,3,0,0,0,-1,-1,1,-1,4,-1
KR_6554694796,420,-4,-53,-13,-9,-1,1,0,-1,1,0,-5,5,0,-4,5,1,2,0,2,0,-11,11,3,-9,6,-4,0,-2,-1,-1,-1,-1,3,-1
KR_6752298207,420,-2,-32,-40,-7,-1,4,3,-6,6,0,-4,4,0,3,1,4,1,0,1,0,-3,-10,-3,-5,8,-1,0,-1,-1,-1,-1,-1,4,-1
KR_6746800261,420,-4,-52,1,-9,-8,8,0,2,1,3,-3,3,0,-1,2,1,1,2,3,1,-7,2,0,-6,6,-4,0,-2,1,-1,-1,1,4,-1
KR_6762928576,420,1,31,-8,2,2,1,3,0,1,1,3,1,4,0,1,1,-3,3,0,0,-1,-7,-3,-4,7,0,0,0,1,-1,1,-1,3,-1
KR_6756406396,440,-4,-43,3,-11,-1,1,0,-3,5,2,0,1,1,-3,7,4,-4,4,0,1,-12,0,-3,-3,6,3,0,-2,-1,1,-1,1,2,-1
KR_6740196437,420,-1,16,-5,-6,-2,3,1,-1,2,1,3,1,4,-2,3,1,-4,5,1,0,-1,-1,3,-7,4,4,0,-1,1,-1,-1,1,5,-1
KR_6758102389,420,-2,12,41,-6,-1,2,1,-2,4,2,-1,2,1,-1,5,4,-1,2,1,0,-9,4,0,-4,4,-3,0,0,-1,-1,0,1,2,-1
KR_6505989334,420,2,81,-1,2,0,2,2,0,2,2,2,0,2,1,3,4,-1,1,0,1,3,4,2,-8,6,2,0,1,1,1,1,1,5,-1
KR_6604965610,420,0,-45,-27,-1,1,2,3,0,5,5,0,1,1,-3,4,1,1,0,1,0,4,-186,4,-9,5,-5,0,0,-1,-1,0,-1,5,-1
KR_6762052791,420,-5,-38,-40,-8,-2,5,3,1,0,1,-5,7,2,-3,6,3,1,2,3,0,-1,-246,-2,-4,6,0,0,0,1,-1,0,-1,5,-1
KR_6732360097,440,2,39,-5,-4,4,1,5,-5,7,2,-5,7,2,-5,7,2,7,0,7,0,-12,-122,-5,-2,7,4,0,0,-1,1,-1,-1,5,-1
KR_6744972899,420,-4,-35,-15,-8,-1,1,0,-1,3,2,-6,10,4,0,3,3,0,1,1,-1,-1,-53,1,-5,4,-3,0,-2,1,-1,-1,-1,6,-1
KR_6767395641,420,-3,-8,8,0,3,1,4,-1,3,2,-3,4,1,1,3,4,0,0,0,0,-3,-3,0,-7,7,-1,0,1,-1,1,1,1,1,-1
KR_6656134544,420,2,-14,4,1,-3,4,1,5,2,7,-2,2,0,-1,1,0,2,2,4,0,-3,4,6,-9,3,1,0,-1,-1,-1,-1,-1,2,-1
KR_6767639466,420,-5,-97,-16,-5,-1,4,3,2,3,5,1,2,3,-4,5,1,-3,6,3,0,0,180,-2,-2,4,2,0,0,0,0,-1,1,0,-1
KR_6572723790,420,-5,-64,-12,-14,-3,3,0,-2,5,3,-7,8,1,-1,4,3,-1,1,0,0,-13,-2,-1,-2,3,2,0,-2,-1,1,-1,-1,3,-1
KR_6751494571,420,-2,23,-28,-1,2,1,3,1,3,4,1,1,2,-3,6,3,-2,2,0,0,-5,5,7,-8,1,-7,0,-1,-1,-1,-1,-1,2,-1
KR_6666935373,420,-2,25,8,-3,-2,3,1,-2,5,3,1,1,2,-1,3,2,1,0,1,0,1,-6,-6,-4,10,5,0,0,1,-1,0,1,1,-1
KR_6762241952,420,-4,-27,24,-9,-4,4,0,-2,3,1,2,3,5,-6,7,1,1,3,4,0,-17,-6,-1,-4,5,-6,0,-1,1,1,-1,1,6,-1
KR_6748861999,420,-4,-93,-4,-13,3,1,4,-2,5,3,-5,6,1,-6,10,4,-3,7,4,0,-7,-12,-4,-3,7,-1,0,-2,-1,-1,-1,1,6,-1
KR_6768323421,420,-6,-45,-4,-19,-5,7,2,-4,4,0,-7,7,0,-2,2,0,-1,1,0,0,-15,-207,0,-6,6,-3,0,-1,-1,-1,-1,-1,5,-1
KR_6664721133,420,-4,-100,-5,-8,-3,3,0,3,1,4,2,1,3,-10,10,0,0,0,0,0,-8,340,-1,-2,3,-1,0,-1,-1,1,1,-1,3,-1
KR_6714459017,420,1,-44,-8,4,2,2,4,0,6,6,0,1,1,-1,3,2,3,0,3,0,2,7,3,-6,3,-2,0,0,0,1,1,-1,0,-1
KR_6763385488,440,4,100,26,5,-1,1,0,-3,3,0,1,1,2,4,3,7,4,1,5,0,5,11,1,-5,4,-4,0,0,1,0,0,1,6,-1
KR_6592894453,420,-2,26,32,-6,-3,3,0,-2,5,3,-1,4,3,3,5,8,-3,4,1,0,-6,-3,1,-6,5,-3,0,1,-1,1,1,-1,6,-1
KR_6627598195,420,-3,-26,-36,-4,0,1,1,0,7,7,-1,3,2,-3,3,0,0,0,0,0,-8,-18,-6,-3,9,6,0,-3,1,-1,-1,1,5,-1
KR_6724018861,420,-6,-45,-28,-18,-2,4,2,-5,8,3,-1,2,1,-4,4,0,-6,6,0,-3,-21,-23,-4,-1,5,-2,0,0,0,0,0,-1,0,-1
KR_6733179837,420,-3,-38,-16,-7,0,2,2,-6,7,1,3,0,3,-5,7,2,1,0,1,0,0,0,0,-4,4,-2,0,0,-1,-1,0,-1,4,-1
KR_6768464445,420,1,-22,32,1,-2,2,0,-2,2,0,4,1,5,1,0,1,0,0,0,0,-2,-3,0,-7,7,4,0,0,1,1,1,-1,3,-1
KR_6720498895,420,4,11,16,5,5,1,6,0,4,4,1,4,5,0,3,3,-1,2,1,-2,-6,-1,-5,-3,8,2,0,0,1,1,0,-1,6,-1
KR_6729987859,420,2,44,-23,3,2,2,4,1,1,2,1,1,2,-1,3,2,0,2,2,0,1,-51,2,-6,4,12,0,1,-1,-1,1,-1,1,-1
KR_6709464519,420,-2,28,5,-4,-1,2,1,-6,7,1,-1,1,0,4,1,5,0,2,2,0,-10,2,2,-5,3,0,0,0,1,-1,0,-1,6,-1
KR_6719931223,420,0,-33,-12,-1,-3,5,2,0,3,3,-1,2,1,2,1,3,1,0,1,1,9,7,3,-3,0,0,0,1,1,-1,1,1,4,-1
KR_6763467959,440,1,10,-28,7,4,0,4,3,1,4,0,3,3,-1,2,1,1,0,1,1,9,-10,6,-8,2,-4,0,2,-1,1,1,1,3,-1
KR_6748779088,440,-3,-47,-8,-11,-3,3,0,3,0,3,5,1,6,-15,15,0,-1,1,0,0,-15,-4,1,-5,4,3,0,0,-1,1,0,-1,2,-1
KR_6742811631,420,-1,-53,-15,2,3,1,4,-1,4,3,1,1,2,-2,2,0,1,1,2,0,7,-98,-4,-5,9,1,0,-1,0,1,-1,-1,0,-1
KR_6767738078,440,-4,-107,-24,-9,1,0,1,0,3,3,-2,3,1,-4,6,2,-4,4,0,0,-7,-4,1,-2,1,0,0,0,-1,-1,-1,-1,2,-1
KR_6752929875,420,-5,13,-28,-9,0,2,2,-4,5,1,-2,2,0,-1,1,0,-2,3,1,0,-12,1,2,-4,2,2,0,-1,-1,1,-1,-1,2,-1
KR_6724124445,420,-1,-20,13,-7,-6,6,0,0,4,4,-2,2,0,-1,1,0,2,0,2,0,-4,-9,-3,-3,6,7,0,0,1,-1,0,1,2,-1
KR_6732496296,420,0,18,4,-1,2,1,3,0,1,1,0,2,2,-3,3,0,0,0,0,0,2,-1,0,-7,7,-7,0,-1,-1,1,-1,-1,1,-1
KR_6624942497,420,1,32,-16,-4,-5,5,0,5,2,7,-2,5,3,0,3,3,-2,2,0,0,-4,-11,-2,-3,5,-1,0,0,1,-1,-1,-1,4,-1
KR_6699136105,420,-1,0,5,-3,5,0,5,-3,4,1,-2,4,2,-3,6,3,0,1,1,-1,-6,-13,6,-10,4,1,0,-1,-1,-1,-1,-1,2,-1
KR_6692561314,420,3,4,20,4,3,1,4,-4,4,0,1,1,2,3,0,3,1,1,2,0,10,-6,0,-4,4,5,0,1,1,-1,1,-1,3,-1
KR_6763070820,440,1,4,10,2,-4,4,0,2,1,3,-2,3,1,3,0,3,3,0,3,0,5,7,-2,-3,5,1,0,-1,-1,-1,-1,-1,4,-1
KR_6723955872,420,-4,-33,-12,-6,-7,7,0,-4,4,0,-2,2,0,6,1,7,1,0,1,1,-2,5,-5,-4,9,-5,0,-1,-1,-1,-1,1,2,-1
KR_6695317466,420,-1,8,-8,1,-5,5,0,3,0,3,-2,3,1,5,3,8,0,0,0,0,11,-13,4,-9,5,2,0,0,1,-1,0,-1,6,-1
KR_6768188531,420,-1,-12,-31,4,3,1,4,2,2,4,-4,4,0,2,5,7,1,1,2,-1,4,-66,7,-8,1,-24,0,1,-1,1,1,-1,1,-1
KR_6729624715,440,-3,-59,-28,-7,2,1,3,-4,7,3,-6,8,2,1,1,2,0,0,0,0,-2,-3,-7,-2,9,-4,0,0,-1,1,0,-1,2,-1
KR_6768236458,440,0,-53,-16,4,1,0,1,-3,3,0,1,1,2,2,1,3,3,2,5,1,6,-3,1,-9,8,5,0,0,-1,1,0,-1,2,-1
KR_6759828084,420,2,23,-20,9,1,1,2,7,2,9,-1,7,6,1,6,7,1,0,1,0,10,14,1,-4,3,-6,0,1,1,0,1,-1,4,-1
KR_6769371842,420,-5,-53,8,-11,-3,3,0,-3,4,1,-2,3,1,1,2,3,-4,4,0,0,-13,-14,3,-6,3,-2,0,-1,-1,1,-1,1,4,-1
KR_6640363503,420,-3,-36,-23,-1,1,2,3,-2,5,3,0,2,2,0,1,1,0,0,0,0,-2,6,-3,-4,7,3,0,-1,-1,0,-1,-1,1,-1
KR_6768759398,440,1,-33,8,1,-1,2,1,-2,2,0,2,5,7,3,1,4,-1,2,1,0,7,50,3,-5,2,-11,0,-2,1,-1,-1,-1,6,-1
KR_6767945846,420,0,-58,9,1,-4,5,1,0,3,3,2,1,3,1,4,5,2,2,4,0,6,0,-4,-1,5,-2,0,-2,0,-1,-1,-1,0,-1
KR_6731551460,420,-1,58,7,1,-1,1,0,-3,3,0,-2,2,0,6,0,6,1,0,1,0,5,-1,2,-3,1,-1,0,1,1,1,1,1,1,-1
KR_6763846258,420,-3,-42,-8,-6,-2,2,0,3,1,4,-1,2,1,-4,7,3,-2,5,3,0,-4,38,-2,-4,6,-2,0,-2,-1,1,-1,-1,1,-1
KR_6725594536,440,-1,-24,-18,-8,0,3,3,-2,4,2,1,1,2,-5,5,0,-2,3,1,0,-3,-12,-4,-2,6,2,0,0,-1,-1,-1,-1,5,-1
KR_6528029375,420,-1,-28,-44,0,-2,3,1,0,3,3,-2,2,0,2,3,5,2,0,2,0,3,5,-1,-4,5,1,0,-2,-1,-1,-1,1,3,-1
KR_6760557194,420,-1,-58,1,-1,2,2,4,2,3,5,-3,4,1,-1,4,3,-1,3,2,0,1,1,-2,-3,5,4,0,-1,1,1,-1,-1,6,-1
KR_6759233537,420,0,-45,4,5,1,0,1,0,4,4,-4,6,2,6,1,7,2,2,4,0,7,2,-10,-3,13,2,0,0,1,-1,0,-1,6,-1
KR_6764207609,420,2,88,-4,-1,0,1,1,-2,4,2,4,0,4,-2,5,3,-1,1,0,1,1,-10,0,-5,5,3,0,0,-1,-1,0,1,4,-1
KR_6758895721,420,-1,-11,0,-2,-4,5,1,1,0,1,-4,4,0,2,3,5,3,3,6,0,-1,-2,-1,-4,5,-1,0,-1,1,-1,-1,-1,3,-1
KR_6582915553,420,-5,-103,-38,-11,-4,6,2,5,1,6,-1,3,2,-7,9,2,-4,5,1,0,1,-7,1,-6,5,7,0,-2,1,-1,-1,-1,5,-1
KR_6767418028,420,-1,30,15,-10,-1,3,2,-5,5,0,1,3,4,-3,6,3,-2,2,0,0,-14,-11,-3,-5,8,1,0,-1,-1,0,-1,-1,4,-1
KR_6763226431,420,-3,-50,-12,-10,-2,3,1,0,2,2,-1,1,0,-3,4,1,-4,5,1,0,-17,-2,0,-4,4,-5,0,-3,-1,-1,-1,1,3,-1
KR_6728375051,440,4,26,-8,9,3,1,4,5,2,7,-1,1,0,6,1,7,-4,6,2,0,12,17,0,-5,5,-3,0,0,-1,-1,0,-1,3,-1
KR_6694534058,420,-5,-44,-44,0,1,2,3,-1,2,1,-1,2,1,2,0,2,-1,1,0,0,0,-8,1,-7,6,-3,0,0,-1,1,0,1,5,-1
KR_6762099633,420,-4,-43,13,-8,-1,3,2,-5,8,3,-2,2,0,-2,6,4,2,3,5,1,-9,-4,-7,-1,8,4,0,0,-1,-1,-1,1,2,-1
KR_6758086084,420,-3,-19,22,-13,-5,6,1,-1,3,2,2,1,3,-5,12,7,-4,4,0,0,-9,-58,2,-4,2,1,0,-2,0,1,-1,-1,0,-1
KR_6757041485,420,-4,-32,-20,-6,-2,2,0,-2,4,2,-2,3,1,-2,4,2,2,0,2,0,-6,6,0,-2,2,-6,0,-1,1,-1,-1,1,5,-1
KR_6728680794,420,-1,-21,-4,-1,3,0,3,0,3,3,-2,2,0,-2,2,0,0,0,0,0,-8,-4,-5,-2,7,-4,0,0,-1,1,0,-1,3,-1
KR_6767689226,440,-2,5,-12,-7,-1,2,1,-1,2,1,1,1,2,-6,8,2,0,5,5,0,-11,-3,2,-6,4,-3,0,0,-1,1,1,1,1,-1
KR_6768345005,420,0,5,-1,-3,-3,6,3,1,2,3,-4,5,1,2,1,3,1,0,1,0,2,-10,-5,0,5,5,0,3,-1,-1,1,-1,1,-1
KR_6497261910,420,-3,-32,10,-6,0,0,0,0,5,5,-3,5,2,-2,4,2,-1,2,1,-1,-12,0,2,-6,4,-9,0,-1,-1,1,-1,-1,3,-1
KR_6725291628,420,-3,-15,-16,-7,-2,3,1,-1,1,0,-2,4,2,1,4,5,-3,3,0,-1,-8,-2,-3,-3,6,-1,0,0,-1,-1,0,-1,3,-1
KR_6676626248,420,0,59,-25,-2,4,0,4,-1,5,4,-4,5,1,0,1,1,-1,1,0,0,-10,11,7,-10,3,-2,0,-1,-1,-1,-1,-1,1,-1
KR_6750132715,420,-3,-34,3,-4,-2,3,1,-2,2,0,-2,4,2,0,3,3,2,1,3,0,-8,-7,-3,-2,5,0,0,-1,-1,-1,-1,1,1,-1
KR_6490341345,420,-10,-81,-68,-16,1,3,4,-8,9,1,-8,9,1,-1,4,3,0,0,0,-1,-9,-1,1,-3,2,-5,0,-2,-1,-1,-1,-1,6,-1
KR_6609864240,420,-1,21,4,-1,3,0,3,-5,6,1,-1,3,2,0,1,1,2,0,2,0,-2,-3,-1,-3,4,2,0,1,-1,0,1,-1,3,-1
KR_6768482684,440,-2,12,-28,-1,-3,5,2,-2,5,3,3,0,3,0,1,1,1,2,3,0,0,0,2,-5,3,2,0,0,-1,-1,0,1,1,-1
KR_6748206974,420,2,-3,2,5,1,1,2,3,1,4,3,1,4,-3,6,3,1,2,3,1,2,10,1,-7,6,-8,0,1,-1,-1,1,1,6,-1
KR_6769839469,440,-1,-59,-13,-8,-7,7,0,2,2,4,-4,4,0,1,0,1,0,3,3,1,-3,7,3,-7,4,-5,0,-2,-1,-1,-1,1,1,-1
KR_6761606735,420,-1,-74,-18,1,-1,1,0,5,1,6,-3,5,2,4,2,6,-4,6,2,0,4,-1,-1,-2,3,3,0,-2,1,-1,-1,-1,1,-1
KR_6729649790,420,-2,5,-16,-4,0,1,1,1,0,1,-1,3,2,-4,6,2,0,0,0,0,-1,226,-2,-2,4,0,0,0,-1,-1,0,-1,4,-1
KR_6762824490,420,-2,-32,17,-1,-4,6,2,2,1,3,2,0,2,-1,4,3,0,1,1,0,1,33,-5,-2,7,-1,0,-1,1,-1,1,1,4,-1
KR_6768291531,420,-1,-55,-1,-6,-2,4,2,0,0,0,-5,9,4,2,0,2,-1,3,2,0,-3,-10,3,-6,3,1,0,-1,0,1,-1,-1,0,-1
KR_6497322813,440,-1,-28,-38,-1,-2,3,1,6,0,6,-10,14,4,6,3,9,-1,3,2,0,9,-3,1,-4,3,-3,0,-1,0,-1,-1,1,0,-1
KR_6662292219,420,-4,-43,-22,-7,-3,4,1,-3,5,2,0,3,3,-1,3,2,0,1,1,0,-5,-13,-7,-2,9,6,0,-2,-1,-1,-1,-1,2,-1
KR_6683841040,420,-2,5,0,-11,0,2,2,0,3,3,-5,6,1,-3,5,2,-3,4,1,0,-11,-59,-7,-2,9,28,0,-1,1,1,-1,-1,5,-1
KR_6715836817,420,-3,-100,0,-2,1,0,1,0,2,2,-3,6,3,-1,2,1,1,0,1,0,-4,183,-2,-6,8,-2,0,-2,-1,-1,-1,-1,5,-1
KR_6767890230,420,-5,-137,-1,-5,-2,3,1,0,1,1,-2,4,2,-2,4,2,1,0,1,0,-3,6,3,-6,3,-5,0,-2,1,0,-1,-1,1,-1
KR_6710035184,420,-2,34,24,-5,-1,2,1,-2,4,2,-2,3,1,0,1,1,0,1,1,0,-4,-2,-1,-5,6,-3,0,0,-1,-1,-1,1,1,-1
KR_6751116876,420,-2,1,40,5,-2,3,1,1,6,7,0,2,2,4,0,4,2,3,5,2,16,10,1,-8,7,-4,0,1,1,1,1,1,6,-1
KR_6734783898,420,-1,-44,8,-2,-4,4,0,0,0,0,1,3,4,1,1,2,0,2,2,0,5,-13,-8,-1,9,0,0,0,-1,-1,0,-1,3,-1
KR_6763422850,420,2,65,24,4,-1,2,1,3,4,7,4,1,5,-1,3,2,-1,3,2,0,1,-3,4,-5,1,-3,0,-2,1,-1,-1,1,2,-1
KR_6768022084,420,0,-83,16,-3,-4,4,0,2,2,4,1,1,2,-1,4,3,-1,1,0,0,-3,-3,-3,-6,9,-1,0,0,-1,1,1,-1,6,-1
KR_6655361442,420,-5,-89,-53,-8,-2,2,0,-1,3,2,-10,12,2,4,1,5,1,0,1,0,9,-105,0,-6,6,-2,0,-1,-1,-1,-1,-1,3,-1
KR_6756917583,420,1,-3,13,2,2,0,2,4,0,4,-5,5,0,0,2,2,1,2,3,0,6,3,-1,-4,5,-3,0,1,1,0,1,-1,3,-1
KR_6759418555,440,-1,7,-6,-4,2,1,3,-4,5,1,0,1,1,-2,5,3,0,1,1,1,-8,-7,-2,-5,7,0,0,0,-1,1,1,1,3,-1
KR_6769866364,420,-3,-37,-35,-2,-2,2,0,-2,3,1,2,1,3,2,1,3,-2,2,0,2,-8,4,0,-7,7,-7,0,0,-1,-1,-1,1,2,-1
KR_6672251659,420,0,-13,36,-8,-6,6,0,-3,5,2,0,2,2,-1,4,3,2,0,2,0,-14,-5,0,-5,5,2,0,-1,1,-1,-1,-1,4,-1
KR_6767955596,420,-5,-55,-5,-10,-4,5,1,1,2,3,-2,6,4,-4,6,2,-1,1,0,0,-9,2,-2,-3,5,-4,0,-1,1,-1,-1,1,4,-1
KR_6729997836,420,-3,-19,1,-11,0,3,3,-2,3,1,0,0,0,-5,6,1,-4,4,0,0,-14,-29,1,-7,6,-5,0,-1,1,-1,-1,-1,1,-1
KR_6738362431,440,1,-31,20,0,-3,3,0,1,3,4,-1,5,4,1,1,2,2,0,2,0,9,4,-2,-5,7,1,0,0,-1,1,0,1,3,-1
KR_6524577790,420,-2,33,8,-6,1,0,1,-1,1,0,-1,2,1,-5,5,0,0,1,1,0,-9,6,4,-7,3,0,0,1,-1,1,-1,-1,6,-1
KR_6768392714,420,-1,-24,-16,1,-6,6,0,1,1,2,5,0,5,0,6,6,1,1,2,0,-1,11,-4,-4,8,2,0,0,0,1,-1,1,0,-1
KR_6718790067,420,-3,-56,0,-9,-2,3,1,-4,7,3,-1,2,1,1,1,2,-3,3,0,0,-9,-14,4,-11,7,-9,0,-1,0,1,-1,-1,0,-1
KR_6759932529,420,-3,-23,-16,-8,-2,2,0,-2,4,2,1,2,3,-2,4,2,-3,3,0,-2,-9,21,3,-6,3,-1,0,0,-1,-1,0,-1,2,-1
KR_6682631313,420,0,63,7,2,4,1,5,0,2,2,0,2,2,-3,6,3,1,0,1,1,-6,2,-2,-6,8,-3,0,0,-1,1,-1,1,6,-1
KR_6729253168,420,-8,-44,-12,-12,0,2,2,-6,12,6,4,1,5,-7,10,3,-3,4,1,0,-12,-7,1,-3,2,-2,0,-1,1,-1,-1,-1,3,-1
KR_6768733719,420,-2,-29,20,-8,-3,5,2,-7,8,1,3,2,5,-5,6,1,4,0,4,0,-10,-3,-1,-6,7,-1,0,0,-1,1,1,1,2,-1
KR_6758298050,420,1,-14,-8,3,-3,5,2,-2,3,1,3,2,5,4,0,4,1,1,2,0,1,4,2,-6,4,-3,0,-1,1,-1,-1,1,4,-1
KR_6760522237,420,-2,-29,-32,-8,3,2,5,-4,5,1,0,1,1,-6,7,1,-1,1,0,0,-12,0,-2,-4,6,0,0,0,-1,-1,1,-1,4,-1
KR_6760969342,420,-2,-7,-14,-7,3,1,4,-7,8,1,0,2,2,1,6,7,-4,4,0,-1,-17,3,-3,-4,7,-6,0,1,-1,1,1,-1,3,-1
KR_6421417449,420,1,33,-35,0,0,1,1,1,2,3,-4,5,1,3,1,4,0,1,1,0,2,-12,3,-7,4,1,0,1,-1,-1,1,-1,3,-1
KR_6758297548,420,0,-31,4,8,-3,3,0,4,2,6,0,1,1,5,2,7,2,1,3,1,13,7,-4,-3,7,2,0,0,1,-1,-1,1,6,-1
KR_6756965553,420,-1,-87,-13,-2,-1,3,2,3,2,5,1,4,5,1,2,3,-6,6,0,0,4,-1,2,-5,3,2,0,-2,1,-1,-1,-1,2,-1
KR_6769465725,420,1,-17,4,1,-1,1,0,1,0,1,2,4,6,-1,2,1,0,2,2,0,8,-9,-5,-2,7,-2,0,0,1,-1,0,-1,4,-1
KR_6720824809,420,-4,-32,-12,-7,-4,5,1,-6,11,5,2,0,2,1,1,2,0,1,1,0,-3,5,1,-5,4,-3,0,0,1,-1,0,1,5,-1
KR_6715901064,420,1,-60,32,-3,1,4,5,-3,10,7,-2,3,1,0,1,1,1,1,2,0,-7,1,-5,-1,6,1,0,1,-1,0,-1,-1,5,-1
KR_6749679793,420,-2,-31,8,-5,-7,7,0,1,1,2,-4,7,3,2,1,3,3,0,3,0,5,-5,-3,-2,5,0,0,-1,-1,1,-1,1,3,-1
KR_6225673238,420,-1,50,-9,-2,0,0,0,-1,1,0,0,0,0,-1,3,2,0,0,0,0,0,-5,-6,-2,8,0,0,0,-1,-1,-1,-1,2,-1
KR_6764803135,420,-6,-103,-25,-14,-3,4,1,-6,7,1,-2,2,0,-3,5,2,0,1,1,0,-15,-32,0,-3,3,-2,0,-3,-1,-1,-1,-1,3,-1
KR_6680423770,420,-2,-22,4,1,3,1,4,-3,3,0,2,1,3,0,1,1,-1,1,0,0,1,-54,-1,-5,6,33,0,-1,-1,-1,-1,1,1,-1
KR_6768914933,420,3,51,-4,13,-3,4,1,5,0,5,2,1,3,8,0,8,1,1,2,1,14,267,3,-6,3,0,0,0,-1,1,1,1,5,-1
KR_6718800651,420,-1,-16,-7,3,-2,3,1,4,1,5,0,5,5,0,0,0,1,0,1,0,1,-8,4,-6,2,-2,0,0,-1,1,0,1,5,-1
KR_6763549358,440,1,-7,-19,4,3,3,6,1,0,1,-2,3,1,2,4,6,0,1,1,0,1,0,2,-4,2,3,0,0,-1,0,0,1,4,-1
KR_6731781909,420,1,-65,-9,-1,-3,3,0,3,2,5,2,3,5,-2,2,0,-1,3,2,0,1,8,3,-4,1,-4,0,-1,-1,-1,-1,1,6,-1
KR_6495997981,420,-2,-17,-28,-3,1,0,1,0,5,5,-4,5,1,-1,1,0,1,0,1,0,2,82,1,-5,4,-2,0,1,-1,1,1,-1,6,-1
KR_6752236214,420,-5,-68,-9,-11,0,0,0,0,2,2,-5,7,2,-3,3,0,-3,3,0,0,-5,-9,-4,-2,6,-2,0,-2,-1,-1,-1,-1,2,-1
KR_6763251353,440,-3,-72,17,2,3,0,3,2,2,4,-7,9,2,3,0,3,1,1,2,0,4,10,3,-4,1,-4,0,0,1,0,-1,-1,6,-1
KR_6750242338,420,0,10,19,0,3,0,3,-3,4,1,0,1,1,0,1,1,0,0,0,0,-4,7,-1,-3,4,0,0,1,-1,1,1,1,3,-1
KR_6753651649,420,0,35,4,-5,-1,1,0,-3,4,1,1,1,2,2,0,2,-4,4,0,0,-6,46,9,-12,3,-36,0,0,-1,-1,0,-1,1,-1
KR_6761194691,420,0,-10,-24,-2,-5,5,0,1,1,2,-3,6,3,5,1,6,0,0,0,0,9,1,-1,-6,7,5,0,0,1,1,-1,-1,1,-1
KR_6741857110,420,-3,-53,1,-8,-2,4,2,-1,1,0,-3,4,1,-2,2,0,0,0,0,0,-3,5,-2,-6,8,-1,0,-1,-1,1,-1,-1,1,-1
KR_6747751406,420,-2,22,3,-5,-2,3,1,0,4,4,-2,3,1,0,1,1,-1,1,0,1,1,-106,-4,-3,7,2,0,1,1,1,1,1,6,-1
KR_6742352550,420,-7,-44,-20,-8,-3,7,4,-5,6,1,0,1,1,1,0,1,-1,1,0,0,-2,5,4,-8,4,-5,0,0,-1,-1,0,1,1,-1
KR_6709107174,420,2,31,-14,-2,-1,2,1,3,3,6,-1,3,2,-1,3,2,-2,2,0,0,1,-41,-4,-3,7,20,0,1,-1,-1,1,-1,3,-1
KR_6767185141,420,-8,-114,-12,-10,-1,1,0,-8,8,0,-2,3,1,3,1,4,-2,3,1,0,-4,-8,-2,-3,5,-2,0,-3,-1,-1,-1,-1,1,-1
KR_6638274568,420,-2,-57,-16,-6,-1,1,0,4,2,6,-3,4,1,-3,5,2,-3,3,0,1,-1,-18,-6,-1,7,1,0,-1,1,1,-1,1,5,-1
KR_6603984529,420,-3,-16,4,-7,-3,3,0,4,2,6,-3,4,1,-6,7,1,1,1,2,-1,-7,98,-1,-3,4,1,0,-2,-1,1,-1,-1,5,-1
KR_6758848621,420,-2,16,-24,-7,-4,5,1,0,1,1,-6,8,2,-1,3,2,4,2,6,1,-6,5,-1,-5,6,0,0,-1,1,-1,-1,1,2,-1
KR_6545385832,420,2,-8,12,-3,0,1,1,-3,5,2,-2,3,1,0,2,2,2,2,4,0,-7,11,-2,-2,4,-1,0,0,1,-1,0,-1,4,-1
KR_6754607296,420,-1,24,33,-5,-4,4,0,1,3,4,3,0,3,-3,3,0,-2,2,0,0,-1,21,-2,-3,5,1,0,0,1,-1,0,-1,6,-1
KR_6771044651,420,-1,-1,12,-7,-6,7,1,1,2,3,2,1,3,-4,4,0,0,1,1,0,-8,0,0,-6,6,-3,0,-1,-1,-1,-1,-1,5,-1
KR_6683853345,420,0,-22,8,-1,1,0,1,-2,4,2,0,1,1,3,1,4,-3,3,0,0,-2,-3,5,-11,6,-5,0,0,1,-1,0,-1,3,-1
KR_6687134611,440,5,15,27,6,3,0,3,-2,2,0,0,1,1,3,0,3,2,5,7,0,15,-7,-2,-4,6,3,0,0,1,1,0,1,5,-1
KR_6700039963,420,0,20,-10,1,0,3,3,1,0,1,-3,3,0,4,0,4,-1,1,0,0,-3,24,-2,-2,4,1,0,1,1,1,1,-1,2,-1
KR_6726136290,440,-3,-19,-4,-12,-3,4,1,2,0,2,2,1,3,-9,10,1,-4,4,0,0,-9,33,-2,-5,7,2,0,-2,-1,1,-1,-1,3,-1
KR_6746377808,420,-5,-27,-28,-10,-2,2,0,-4,5,1,0,2,2,-4,5,1,0,1,1,-1,-21,-24,-1,-2,3,-2,0,-2,0,-1,-1,-1,0,-1
KR_6754996882,420,-4,21,-14,-5,-4,4,0,-2,3,1,-6,6,0,6,2,8,1,0,1,0,6,-9,1,-5,4,-8,0,-2,-1,1,-1,1,3,-1
KR_6756330463,440,-2,-43,-5,1,-1,1,0,-1,6,5,4,0,4,3,1,4,-4,4,0,0,-8,351,-3,-4,7,6,0,-1,-1,1,-1,1,6,-1
KR_6765266983,420,2,1,-14,-1,0,3,3,4,0,4,-2,5,3,-2,5,3,-1,1,0,-1,2,114,5,-7,2,-1,0,1,1,1,1,-1,3,-1
KR_6700875716,420,0,-25,5,-3,0,0,0,2,1,3,-3,5,2,-1,7,6,-1,1,0,0,-6,223,3,-5,2,-3,0,0,0,1,0,1,0,-1
KR_6762405232,420,4,63,15,3,3,1,4,-3,6,3,1,1,2,0,2,2,2,0,2,0,-4,-3,-6,-1,7,2,0,1,1,-1,1,-1,1,-1
KR_6724136639,420,0,-36,-25,-1,-3,4,1,2,3,5,-1,3,2,-2,5,3,3,0,3,0,-2,-1,-2,-6,8,0,0,-1,-1,-1,-1,-1,6,-1
KR_6745928789,440,-2,45,-14,-5,3,0,3,1,0,1,-2,3,1,-6,10,4,-1,1,0,0,-10,-6,-5,0,5,6,0,-1,-1,0,-1,-1,2,-1
KR_6533941211,420,-2,-7,12,-2,-4,5,1,2,0,2,2,0,2,-3,4,1,1,1,2,1,0,-2,-3,-4,7,-2,0,-2,-1,-1,-1,1,3,-1
KR_6770107756,440,-2,-34,-48,-3,-3,4,1,3,2,5,1,3,4,-5,5,0,1,5,6,0,-2,-4,-3,-3,6,2,0,0,0,0,-1,1,0,-1
KR_6753286857,420,-1,18,5,4,2,2,4,-4,5,1,3,1,4,1,1,2,2,0,2,2,4,-35,0,-4,4,0,0,0,1,-1,0,1,2,-1
KR_6769373721,420,-5,-109,-1,-7,-8,8,0,0,2,2,-3,4,1,3,1,4,1,0,1,0,-3,8,0,-4,4,-6,0,-2,0,-1,-1,1,0,-1
KR_6756247281,440,-7,-57,-8,-20,-5,6,1,-3,7,4,-2,3,1,-7,9,2,-3,7,4,-1,-11,34,-2,-1,3,3,0,-3,-1,-1,-1,-1,1,-1
KR_6771054238,420,-3,-28,4,-7,-1,1,0,2,1,3,-2,4,2,-5,7,2,-1,1,0,0,-3,-4,-1,-4,5,3,0,1,-1,1,1,1,2,-1
KR_6605297373,420,-3,-58,-26,-5,-4,4,0,-3,6,3,1,1,2,1,1,2,0,0,0,0,4,11,0,-8,8,-4,0,-2,-1,-1,-1,1,4,-1
KR_6769495678,420,-3,24,-4,-7,1,1,2,-1,1,0,-6,7,1,-1,3,2,0,1,1,0,-5,-46,-4,-3,7,37,0,1,-1,1,1,-1,1,-1
KR_6684984879,420,1,-23,24,1,-3,4,1,-2,4,2,5,1,6,5,2,7,-4,4,0,0,2,19,2,-10,8,3,0,-1,1,-1,-1,1,1,-1
KR_6659954802,420,0,-85,15,-3,2,1,3,0,3,3,-3,3,0,-3,4,1,1,1,2,0,-7,50,-6,-1,7,-1,0,0,-1,-1,-1,1,1,-1
KR_6625717406,420,-1,-35,36,1,0,2,2,2,2,4,1,2,3,-2,2,0,0,0,0,0,-2,14,3,-6,3,1,0,2,-1,-1,1,-1,2,-1
KR_6764877945,420,-4,-16,20,-7,-3,4,1,-4,6,2,-1,1,0,1,5,6,0,2,2,0,-7,3,0,-5,5,0,0,0,1,-1,0,-1,1,-1
KR_6597906101,420,-2,-30,23,-7,-1,1,0,-2,6,4,-9,9,0,4,1,5,1,1,2,0,-2,-3,-3,-4,7,1,0,0,0,-1,1,-1,0,-1
KR_6696508759,420,1,-18,8,4,1,0,1,-1,3,2,5,2,7,-2,3,1,1,0,1,0,7,-2,0,-7,7,7,0,0,-1,0,1,-1,2,-1
KR_6762377596,440,-3,-65,28,-11,-7,8,1,2,2,4,-6,8,2,1,5,6,-1,2,1,-1,-3,-1,1,-4,3,-1,0,0,-1,1,-1,-1,1,-1
KR_6762061952,420,1,31,-28,-7,0,2,2,-4,4,0,1,2,3,-4,5,1,0,0,0,0,-6,-5,7,-9,2,4,0,1,-1,-1,1,-1,1,-1
KR_6658331310,420,-1,-36,12,-1,3,0,3,-1,4,3,1,1,2,-2,5,3,-2,2,0,0,-4,-5,1,-7,6,0,0,-1,-1,0,-1,1,2,-1
KR_6759313384,440,-1,67,-4,-6,2,4,6,-2,2,0,2,0,2,-5,6,1,-3,3,0,0,-12,-4,-3,0,3,0,0,-1,-1,0,-1,1,1,-1
KR_6686579138,420,2,-30,18,-4,-1,1,0,0,3,3,3,2,5,-4,6,2,-2,2,0,-2,-14,-6,-1,-5,6,-1,0,1,-1,1,1,-1,6,-1
KR_6737624009,420,-3,-38,4,-5,-3,4,1,-4,7,3,0,2,2,3,1,4,-1,3,2,0,-1,483,2,-4,2,-2,0,-1,1,1,1,1,3,-1
KR_6601969393,420,1,-14,-1,-1,-4,4,0,0,4,4,0,3,3,4,4,8,-1,3,2,0,5,-39,-1,-4,5,19,0,-2,-1,-1,-1,1,4,-1
KR_6653641299,420,-2,-42,-35,-2,-1,2,1,-2,6,4,-1,2,1,1,2,3,1,1,2,0,-3,-3,-3,-2,5,-3,0,-2,1,-1,-1,-1,5,-1
KR_6653756318,420,-3,-40,-16,-4,2,0,2,-1,2,1,-2,6,4,-4,8,4,1,0,1,2,3,-3,-3,-6,9,2,0,-1,-1,1,1,1,3,-1
KR_6757554455,420,-1,75,-1,-4,2,2,4,-3,5,2,-2,3,1,-2,9,7,1,2,3,0,-7,-3,-1,-7,8,1,0,0,1,-1,1,1,2,-1
KR_6730462419,440,2,68,4,4,4,1,5,-5,6,1,3,1,4,2,2,4,0,0,0,0,5,21,-4,-4,8,-2,0,0,1,1,0,1,2,-1
KR_6751299362,440,-5,-48,-16,-9,-8,9,1,-2,2,0,0,1,1,-2,3,1,3,0,3,0,0,-2,-2,-4,6,2,0,0,1,0,-1,-1,1,-1
KR_6768392342,420,0,-6,12,4,0,1,1,2,2,4,0,3,3,2,2,4,0,0,0,0,4,13,2,-6,4,1,0,0,1,-1,0,-1,3,-1
KR_6717651957,440,0,34,8,1,-3,5,2,0,3,3,-1,2,1,3,4,7,2,0,2,0,-5,0,3,-11,8,1,0,1,1,0,1,-1,5,-1
KR_6724331578,420,1,-44,40,3,0,0,0,-3,8,5,4,3,7,-2,4,2,4,1,5,0,-5,24,0,-4,4,-3,0,0,-1,-1,0,1,2,-1
KR_6765252594,420,-2,-49,0,-4,2,0,2,0,1,1,-6,7,1,4,0,4,-4,5,1,0,-1,21,3,-6,3,0,0,1,1,1,-1,-1,1,-1
KR_6723963146,420,-5,-83,-9,-14,-5,6,1,-4,4,0,-2,3,1,-2,3,1,-1,1,0,0,-22,-1,0,-2,2,1,0,-3,-1,-1,-1,-1,5,-1
KR_6760669663,440,-1,-69,-43,-3,-2,2,0,-1,6,5,1,2,3,-3,3,0,2,0,2,1,-5,203,3,-9,6,0,0,-1,0,-1,-1,1,0,-1
KR_6763215421,420,-2,-9,13,-7,1,2,3,4,3,7,-3,4,1,-6,7,1,-3,4,1,-1,-4,8,-2,-4,6,1,0,0,-1,1,0,-1,4,-1
KR_6770947868,420,-2,-28,5,-6,-4,5,1,1,4,5,4,1,5,-3,6,3,-4,4,0,0,-9,2,0,-1,1,-5,0,0,-1,1,0,-1,2,-1
KR_6599936712,420,-2,-45,23,2,-5,6,1,1,3,4,3,0,3,-1,5,4,4,0,4,0,3,1,4,-8,4,-1,0,0,1,1,-1,1,3,-1
KR_6737386531,420,-8,-16,-28,-15,-5,8,3,0,2,2,1,0,1,-10,12,2,-1,2,1,-1,-8,1,2,-5,3,-4,0,-2,-1,-1,-1,-1,4,-1
KR_6687259597,420,3,78,-20,5,3,0,3,-1,5,4,2,0,2,0,1,1,1,1,2,0,2,1,1,-5,4,-3,0,1,-1,1,1,1,5,-1
KR_6623449550,420,-4,-15,-12,-7,-2,3,1,-3,5,2,-1,3,2,-1,4,3,0,1,1,0,-1,-5,1,-7,6,-7,0,0,-1,-1,-1,-1,4,-1
KR_6730029064,420,-3,41,-12,-7,-5,6,1,-7,7,0,3,1,4,0,2,2,2,0,2,0,-9,11,4,-5,1,-3,0,0,1,1,1,1,6,-1
KR_6763619258,420,-3,-83,20,-2,0,3,3,3,0,3,0,2,2,-4,7,3,-1,1,0,0,4,2,3,-8,5,-2,0,-1,1,1,-1,1,6,-1
KR_6760940907,440,-1,46,-15,-8,-4,6,2,-4,4,0,1,1,2,0,1,1,-1,2,1,-1,-9,-2,2,-5,3,0,0,1,1,-1,-1,-1,5,-1
KR_6560596996,420,1,7,8,-9,1,0,1,-3,6,3,-3,4,1,-2,3,1,-2,2,0,-1,-17,0,-4,-4,8,-6,0,1,-1,1,1,-1,4,-1
KR_6636273781,440,0,-67,-6,5,-1,2,1,-3,4,1,6,1,7,2,0,2,1,0,1,0,4,8,0,-2,2,-1,0,0,-1,1,0,1,5,-1
KR_6751355884,440,-6,-16,-28,-9,-1,1,0,1,3,4,2,1,3,-6,7,1,-5,5,0,0,-15,-8,4,-7,3,-4,0,-1,0,1,-1,1,0,-1
KR_6728684268,440,-2,-34,-8,-7,-1,1,0,-5,5,0,-3,5,2,-2,2,0,4,0,4,0,-10,-1,0,-6,6,-2,0,-1,0,-1,-1,-1,0,-1
KR_6726184071,420,-5,-25,10,-16,4,1,5,-12,15,3,2,0,2,-4,4,0,-6,6,0,-2,-25,174,-2,-3,5,-6,0,-1,-1,-1,-1,-1,2,-1
KR_6747752488,420,-1,-29,-28,0,-2,4,2,0,4,4,2,1,3,-1,2,1,1,0,1,0,-1,-27,-5,-3,8,3,0,-1,1,1,-1,-1,4,-1
KR_6627146314,420,-4,-19,-17,-8,4,0,4,-3,6,3,-7,8,1,-2,5,3,0,2,2,0,-3,4,1,-7,6,-4,0,-1,-1,-1,-1,1,1,-1
KR_6764650908,420,1,23,17,1,-4,6,2,2,3,5,-1,3,2,4,2,6,0,0,0,1,6,11,-1,-3,4,-3,0,-1,1,-1,-1,1,6,-1
KR_6684559686,420,1,-15,-6,8,1,2,3,3,0,3,3,1,4,-1,4,3,2,0,2,-1,8,16,2,-6,4,2,0,1,1,1,1,-1,1,-1
KR_6769277101,420,0,-34,2,-1,-1,2,1,0,3,3,-1,3,2,-1,4,3,2,0,2,0,9,-13,1,-7,6,5,0,-1,-1,-1,-1,-1,6,-1
KR_6741763447,420,-2,-41,-4,-2,2,1,3,0,3,3,-3,3,0,0,1,1,-1,2,1,0,-6,-46,-1,-1,2,14,0,-1,-1,-1,-1,-1,6,-1
KR_6732206050,420,1,-19,-8,0,3,1,4,-1,2,1,2,1,3,-4,10,6,0,0,0,-2,-10,3,3,-5,2,-2,0,0,1,-1,0,-1,5,-1
KR_6762410962,420,0,-28,8,-7,-3,3,0,-5,5,0,0,2,2,1,1,2,0,0,0,0,-8,2,-1,-2,3,1,0,0,-1,0,0,-1,6,-1
KR_6765674108,420,0,-36,-9,-6,-1,1,0,-4,7,3,2,3,5,-3,5,2,0,0,0,0,8,-10,1,-8,7,0,0,0,1,-1,0,-1,5,-1
KR_6636368160,420,2,-20,37,7,1,1,2,1,2,3,3,1,4,0,4,4,2,0,2,0,2,-70,2,-5,3,6,0,0,1,1,0,-1,2,-1
KR_6738655530,420,-2,8,-1,-10,1,0,1,-8,8,0,0,1,1,-1,2,1,-2,3,1,0,-18,-18,3,-8,5,0,0,-1,-1,-1,-1,1,4,-1
KR_6769768204,420,-2,4,-21,-4,-2,3,1,1,2,3,-1,2,1,-2,5,3,0,2,2,1,0,-9,2,-4,2,-1,0,-2,0,1,-1,1,0,-1
KR_6706654772,420,-3,-47,-23,-11,1,2,3,-7,7,0,-4,5,1,0,3,3,-1,2,1,0,-23,-8,-11,-4,15,-5,0,0,-1,-1,-1,1,4,-1
KR_6703804405,420,1,133,-5,-3,1,0,1,-3,8,5,-1,3,2,-1,3,2,1,1,2,0,-5,8,2,-6,4,3,0,0,-1,1,0,-1,6,-1
KR_6648394666,440,-2,6,-26,-10,-3,4,1,-1,3,2,-8,8,0,1,4,5,1,1,2,0,-13,117,2,-5,3,4,0,0,-1,-1,0,1,3,-1
KR_6768752422,420,-3,-54,-20,-6,1,0,1,0,3,3,-5,8,3,-3,6,3,1,1,2,0,-4,10,-2,-5,7,-5,0,0,-1,1,0,-1,6,-1
KR_6760865726,420,0,-44,-5,3,0,0,0,3,0,3,1,3,4,-2,3,1,1,0,1,0,2,-5,2,-4,2,-1,0,-1,0,-1,-1,1,0,-1
KR_6748488649,420,-2,-17,7,-9,-2,3,1,0,3,3,-3,3,0,-5,8,3,1,1,2,-3,-12,118,-1,-7,8,-4,0,-1,1,-1,-1,-1,4,-1
KR_6749210111,440,-2,6,-9,-11,-10,10,0,1,4,5,-2,3,1,-1,1,0,1,0,1,0,-10,-4,0,-7,7,-3,0,1,-1,1,1,1,3,-1
KR_6613772313,420,-3,-45,12,-15,1,0,1,-8,8,0,-8,8,0,-1,3,2,1,1,2,-1,-12,-2,-3,-4,7,3,0,-1,1,1,-1,-1,1,-1
KR_6755764639,420,-1,-30,32,-2,4,0,4,-6,6,0,-4,9,5,0,1,1,4,4,8,1,-6,-12,-3,-3,6,1,0,-1,-1,1,-1,1,1,-1
KR_6668687104,420,0,-21,32,-7,3,3,6,-7,9,2,-4,5,1,2,3,5,-1,1,0,1,-10,-26,0,-4,4,1,0,-1,0,-1,-1,1,0,-1
KR_6695922473,420,1,-2,5,-1,-2,3,1,1,0,1,-1,2,1,-1,3,2,2,1,3,0,3,23,0,-9,9,2,0,0,-1,-1,0,1,4,-1
KR_6692857458,420,0,5,42,-2,1,0,1,0,4,4,5,2,7,-7,7,0,-1,1,0,0,-4,-7,-1,-3,4,-3,0,-1,-1,1,-1,-1,4,-1
KR_6660254768,420,-3,-9,-21,-6,-3,4,1,1,2,3,-4,6,2,1,1,2,-1,2,1,0,1,5,5,-6,1,-5,0,0,-1,-1,1,1,5,-1
KR_6719670565,420,-1,-58,9,1,1,0,1,-2,3,1,-3,5,2,2,1,3,3,0,3,0,6,19,-3,-2,5,-2,0,0,-1,1,1,1,3,-1
KR_6771136263,420,-5,3,-28,-4,-4,4,0,0,2,2,-5,5,0,0,1,1,5,1,6,1,3,-1,-2,-1,3,2,0,0,1,-1,1,1,5,-1
KR_6761434275,420,-2,-94,-8,-10,-1,2,1,-6,10,4,-1,3,2,-1,2,1,-1,2,1,-1,-10,45,0,-4,4,-25,0,0,-1,1,0,-1,3,-1
KR_6756405984,440,-1,-49,-9,0,1,1,2,1,5,6,3,0,3,-6,7,1,1,1,2,0,-10,-145,-5,-3,8,-1,0,-1,1,-1,-1,-1,4,-1
KR_6759789405,440,-1,-20,-2,1,2,0,2,0,0,0,-2,2,0,0,1,1,1,1,2,0,0,-13,0,-5,5,-1,0,0,-1,-1,0,1,6,-1
KR_6735101960,420,-6,-91,-46,-18,3,0,3,-11,13,2,-8,8,0,-3,5,2,1,1,2,-1,-28,-6,-2,-3,5,1,0,-3,1,-1,-1,-1,6,-1
KR_6769950858,420,-2,-60,-6,-9,2,1,3,-2,3,1,3,0,3,-12,17,5,0,2,2,-1,-9,-2,-5,0,5,-3,0,0,-1,1,-1,-1,2,-1
KR_6765394779,420,-5,-72,-4,-9,-4,5,1,1,2,3,-1,3,2,-4,5,1,-1,3,2,0,-5,43,-1,-2,3,-19,0,-1,-1,-1,-1,1,4,-1
KR_6767083264,420,-1,-65,-7,-2,0,3,3,-1,4,3,-2,5,3,2,1,3,-1,1,0,-1,-4,15,-2,-3,5,1,0,0,-1,1,0,-1,6,-1
KR_6769970335,420,1,-63,-21,4,-1,2,1,3,1,4,2,1,3,-4,6,2,4,2,6,0,3,-9,1,-5,4,3,0,-1,-1,-1,-1,-1,4,-1
KR_6756243195,420,-1,-33,1,0,4,1,5,0,4,4,0,2,2,-1,2,1,-3,3,0,0,-6,-8,-3,-5,8,2,0,-1,1,-1,-1,1,5,-1
KR_6767473552,420,-4,-108,-20,-9,-4,4,0,-2,3,1,0,2,2,-4,4,0,1,0,1,0,-6,-8,-1,-1,2,-2,0,-1,-1,-1,-1,-1,6,-1
KR_6579777442,420,0,31,3,-5,-2,2,0,0,3,3,-2,4,2,-1,6,5,0,1,1,0,-12,46,-2,-3,5,-27,0,0,-1,1,1,-1,2,-1
KR_6768935180,420,-4,-10,24,-10,-1,3,2,-2,4,2,0,2,2,-5,6,1,-2,3,1,0,-16,-5,-2,-4,6,4,0,-2,-1,1,-1,-1,1,-1
KR_6703815266,420,3,52,3,3,6,0,6,2,1,3,-2,3,1,1,4,5,-4,5,1,0,-4,-12,-1,-8,9,2,0,0,0,1,1,1,0,-1
KR_6726693049,440,-3,7,-56,-7,4,0,4,-6,7,1,-3,4,1,-3,4,1,1,1,2,-1,-7,-8,-4,-1,5,-1,0,-2,-1,-1,-1,-1,3,-1
KR_6759379892,420,1,5,-5,7,1,1,2,-3,3,0,3,0,3,7,3,10,-1,2,1,0,8,13,3,-7,4,-1,0,1,0,1,1,-1,0,-1
KR_6768307232,440,-2,-109,-28,1,-2,4,2,-2,5,3,-1,2,1,3,0,3,3,0,3,0,4,3,6,-10,4,1,0,1,-1,1,1,1,2,-1
KR_6744285576,420,2,29,-32,-1,1,1,2,3,0,3,2,2,4,-9,11,2,2,0,2,0,0,3,9,-11,2,1,0,-1,0,0,-1,-1,0,-1
KR_6750815731,420,-3,-34,8,-19,-1,3,2,-11,11,0,-2,3,1,-3,3,0,-2,2,0,0,-17,-4,-2,-5,7,4,0,-1,-1,-1,-1,-1,6,-1
KR_6734916491,420,-4,-45,-8,-6,-6,7,1,-4,6,2,6,1,7,-2,6,4,0,0,0,0,-6,-3,1,-5,4,-2,0,-1,-1,-1,-1,-1,2,-1
KR_6624333722,420,1,32,17,-2,0,2,2,-3,4,1,3,0,3,-2,2,0,0,0,0,0,-6,3,0,-6,6,-1,0,1,-1,1,1,-1,6,-1
KR_6739483436,420,-3,-40,-18,-11,-10,10,0,0,3,3,1,4,5,-2,3,1,0,2,2,0,-5,-229,-6,-1,7,3,0,-1,-1,-1,-1,-1,5,-1
KR_6767318671,420,-2,-18,0,-4,-2,3,1,3,0,3,-6,6,0,3,3,6,-2,2,0,0,1,-2,0,-4,4,0,0,-1,-1,0,-1,-1,1,-1
KR_6655713784,440,-1,-30,-16,3,-2,3,1,5,1,6,2,1,3,-1,4,3,-1,1,0,0,-1,36,-5,-2,7,-19,0,-1,-1,-1,-1,1,3,-1
KR_6750780013,420,-2,-84,-44,3,-2,4,2,-1,3,2,7,0,7,0,1,1,-1,2,1,0,6,24,-1,-2,3,2,0,-1,0,0,-1,1,0,-1
KR_6710208572,420,3,28,-5,2,0,1,1,-1,2,1,0,1,1,3,0,3,0,0,0,0,8,-1,-3,-3,6,0,0,0,1,-1,0,-1,5,-1
KR_6630350612,420,1,-14,27,1,0,0,0,1,3,4,-2,3,1,2,1,3,0,0,0,0,4,7,5,-6,1,0,0,0,-1,-1,0,-1,4,-1
KR_6756342660,420,-3,-71,4,-4,-4,4,0,-4,6,2,3,2,5,1,2,3,0,1,1,0,6,-2,4,-6,2,-1,0,-1,0,-1,-1,1,0,-1
KR_6740984227,420,-5,9,-36,-4,-1,3,2,2,3,5,-3,4,1,0,2,2,-2,3,1,2,-6,-3,-2,-2,4,3,0,-1,-1,1,-1,1,4,-1
KR_6770793391,420,1,2,21,-7,2,0,2,-5,6,1,0,1,1,-4,5,1,0,0,0,0,-7,-138,-3,-3,6,-4,0,0,1,-1,0,-1,2,-1
KR_6767364911,420,-2,-37,-16,1,-1,1,0,-1,3,2,5,2,7,-2,4,2,0,2,2,1,-3,2,0,-4,4,-2,0,0,-1,1,0,1,1,-1
KR_6764724285,420,-1,-45,-8,-1,1,0,1,-3,4,1,-3,5,2,2,1,3,2,1,3,0,3,-135,-3,-1,4,-1,0,0,-1,-1,-1,-1,3,-1
KR_6769866781,420,-4,-59,-12,-1,-3,3,0,1,3,4,2,0,2,-1,2,1,0,1,1,0,-1,15,2,-6,4,-3,0,-1,-1,-1,-1,-1,3,-1
KR_6679037661,420,3,51,-5,2,1,2,3,1,3,4,4,1,5,-4,5,1,0,1,1,0,-9,-3,3,-8,5,4,0,2,1,1,1,1,6,-1
KR_6748350823,420,-4,-75,-16,-5,1,1,2,1,3,4,2,1,3,-6,6,0,-3,3,0,0,-1,5,-1,-4,5,0,0,1,-1,1,1,-1,4,-1
KR_6732542467,420,-4,-126,-32,-7,-3,3,0,-5,5,0,0,2,2,0,0,0,1,0,1,0,-9,-22,1,-3,2,-3,0,-1,-1,-1,-1,1,3,-1
KR_6739677741,420,-1,67,-16,-6,2,1,3,-8,10,2,-3,5,2,2,1,3,1,1,2,0,-8,5,-2,-4,6,2,0,2,-1,-1,1,-1,2,-1
KR_6542696610,420,-1,-1,53,-7,-5,5,0,-1,4,3,0,3,3,-2,2,0,1,0,1,0,-8,-244,-6,-3,9,5,0,-1,-1,1,-1,-1,6,-1
KR_6744315238,420,-1,-31,8,-1,0,1,1,3,3,6,-2,2,0,-2,3,1,0,1,1,0,-4,6,3,-6,3,-5,0,0,-1,1,0,-1,4,-1
KR_6757753662,440,-4,-23,-25,-11,-1,2,1,-3,6,3,-3,5,2,-4,4,0,0,1,1,0,-9,264,-1,-3,4,-9,0,0,-1,-1,0,-1,6,-1
KR_6758890998,420,-2,-1,12,-12,0,3,3,-7,8,1,0,2,2,-1,5,4,-4,4,0,-1,-20,-6,-2,-3,5,0,0,-2,-1,1,-1,1,4,-1
KR_6701039957,420,0,-40,14,-11,-2,3,1,-7,9,2,-4,5,1,2,4,6,0,1,1,0,-4,2,0,-3,3,-3,0,-4,1,-1,-1,-1,4,-1
KR_6766616146,420,-1,-84,7,-5,-5,7,2,1,3,4,3,0,3,0,0,0,-4,5,1,0,0,-7,3,-4,1,-2,0,-1,-1,0,-1,1,4,-1
KR_6768341287,420,-1,-73,4,-4,-6,6,0,-2,2,0,4,1,5,3,4,7,-3,5,2,0,1,9,4,-8,4,-1,0,-1,1,0,-1,-1,2,-1
KR_6767614951,420,-2,26,0,-2,-1,1,0,1,0,1,-1,3,2,1,0,1,-2,2,0,0,-6,10,0,-4,4,-9,0,0,-1,1,0,-1,5,-1
KR_6740132592,440,0,-81,12,0,1,0,1,-3,5,2,0,3,3,-1,3,2,3,0,3,2,2,-11,-3,-4,7,4,0,0,-1,1,0,1,2,-1
KR_6770153939,440,-1,-78,-13,-5,1,1,2,-8,8,0,4,0,4,-2,4,2,0,1,1,0,-9,4,4,-10,6,-1,0,0,0,0,0,1,0,-1
KR_6695825194,420,-4,-41,0,-7,-1,3,2,-4,5,1,-2,3,1,0,5,5,0,1,1,-1,-6,-8,1,-5,4,-3,0,-2,-1,-1,-1,-1,5,-1
KR_6739480319,420,-4,-68,-18,-4,-3,3,0,0,4,4,3,1,4,-4,9,5,0,0,0,-1,-3,-6,-2,-2,4,2,0,-2,-1,-1,-1,-1,3,-1
KR_6713239262,420,-3,-21,8,-14,-2,2,0,-5,5,0,-2,3,1,-2,2,0,-3,3,0,0,-10,-271,0,-4,4,0,0,-1,-1,-1,-1,-1,4,-1
KR_6723311958,420,-2,-51,-7,2,-2,2,0,1,3,4,-4,5,1,5,2,7,2,0,2,0,2,263,1,-10,9,-4,0,1,-1,-1,1,-1,5,-1
KR_6768362844,420,-3,-16,4,-6,-5,6,1,-3,4,1,1,3,4,0,3,3,1,0,1,0,1,-344,-3,-3,6,-3,0,-1,-1,-1,-1,-1,4,-1
KR_6730310077,420,-3,0,-4,-4,0,2,2,-3,3,0,-3,5,2,2,0,2,0,2,2,0,0,5,1,-4,3,2,0,0,-1,-1,0,-1,5,-1
KR_6714909854,420,-2,-34,-29,-5,-1,2,1,2,2,4,-2,3,1,-1,1,0,-3,3,0,0,-4,-1,-3,-5,8,-2,0,-1,-1,0,-1,-1,6,-1
KR_6749796407,420,-6,-91,-34,-13,-8,8,0,-3,3,0,0,0,0,-1,3,2,-1,3,2,0,-5,0,3,-5,2,-2,0,-3,-1,-1,-1,-1,6,-1
KR_6770440259,420,-4,-65,0,-12,-5,6,1,8,0,8,-4,6,2,-9,9,0,-2,5,3,1,-14,-7,4,-6,2,-4,0,-1,1,1,-1,1,5,-1
KR_6766630642,420,-1,3,0,-12,-1,3,2,-4,5,1,-7,7,0,2,1,3,-2,2,0,0,-11,0,2,-8,6,0,0,-1,-1,-1,-1,-1,5,-1
KR_6734422339,420,-2,-25,5,-6,0,2,2,-3,7,4,0,1,1,-2,2,0,-1,1,0,0,-7,21,-1,-3,4,5,0,-1,-1,1,-1,-1,1,-1
KR_6622068183,420,-4,-57,44,-12,-5,5,0,-2,3,1,1,1,2,-3,3,0,-3,3,0,0,-14,9,1,-6,5,-2,0,0,1,-1,-1,-1,3,-1
KR_6746296679,420,-2,-33,-16,-3,-3,5,2,3,1,4,-2,5,3,-2,3,1,1,2,3,0,5,-3,0,-2,2,0,0,-1,-1,-1,-1,1,1,-1
KR_6624439310,420,0,-7,-3,0,3,2,5,-1,2,1,-1,4,3,1,3,4,-2,2,0,0,-4,-4,-3,-6,9,2,0,-1,-1,-1,-1,-1,4,-1
KR_6629402560,420,2,-14,-13,-2,0,3,3,-2,3,1,2,2,4,-1,4,3,-1,1,0,1,8,-1,-3,-3,6,6,0,0,1,-1,1,1,3,-1
KR_6741930765,440,-2,-35,2,0,-3,3,0,-3,5,2,1,2,3,1,2,3,4,0,4,0,-5,9,0,-4,4,0,0,0,1,1,1,1,3,-1
KR_6745840401,420,-1,-37,-29,-3,-7,9,2,5,1,6,-2,3,1,-1,3,2,2,0,2,0,3,328,-5,-1,6,2,0,-1,1,-1,-1,-1,2,-1
KR_6768733477,420,-3,-49,-21,-15,0,2,2,-6,8,2,2,0,2,-10,11,1,-1,1,0,-1,-20,-5,-1,-8,9,-1,0,-1,-1,-1,-1,-1,2,-1
KR_6651344208,420,1,52,29,-3,2,1,3,-2,3,1,-4,7,3,1,4,5,0,0,0,0,-4,-11,-6,-5,11,3,0,1,1,1,1,1,1,-1
KR_6765737088,420,-2,-7,-33,-2,0,0,0,-3,4,1,2,0,2,-3,4,1,2,2,4,0,-4,0,2,-6,4,-2,0,0,0,1,0,-1,0,-1
KR_6742869466,420,-1,22,-19,2,7,0,7,0,1,1,-6,7,1,0,0,0,1,1,2,0,5,-130,-1,-3,4,1,0,0,-1,1,1,1,1,-1
KR_6675017008,420,-1,-126,8,-5,-1,3,2,-4,4,0,-1,3,2,1,0,1,0,1,1,0,-1,-14,2,-5,3,-3,0,-1,-1,1,-1,-1,3,-1
KR_6767099613,420,-2,7,4,-1,-3,5,2,-1,2,1,-1,1,0,4,0,4,0,1,1,0,-1,2,4,-6,2,-4,0,0,0,1,-1,1,0,-1
KR_6731900595,420,-2,-34,-17,-9,-6,6,0,-5,7,2,-1,3,2,1,1,2,2,0,2,-1,-5,2,-1,-2,3,-5,0,0,-1,-1,-1,-1,3,-1
KR_6746846807,420,-1,50,19,-1,4,2,6,2,1,3,-5,7,2,-1,2,1,-1,2,1,1,-9,-9,-2,-4,6,0,0,1,1,1,1,1,2,-1
KR_6769601064,420,2,-31,-18,-3,1,1,2,0,4,4,-5,6,1,-1,1,0,2,1,3,1,-2,-3,-3,-2,5,-4,0,2,-1,1,1,1,4,-1
KR_6757288781,420,-1,13,13,-1,-3,3,0,2,1,3,-1,1,0,1,2,3,0,0,0,0,3,-98,3,-6,3,-1,0,0,0,-1,0,-1,0,-1
KR_6767461171,420,-4,-20,-24,-2,-1,2,1,-3,4,1,1,2,3,-1,5,4,2,0,2,0,-3,-23,-5,-4,9,0,0,0,-1,-1,-1,-1,4,-1
KR_6653568870,420,-4,-42,0,-6,-8,9,1,-4,5,1,3,0,3,4,0,4,-1,1,0,0,-7,35,-5,-3,8,-9,0,-1,-1,0,-1,1,6,-1
KR_6750035276,420,1,15,-2,3,-1,2,1,-1,3,2,2,0,2,1,2,3,2,1,3,0,1,-3,4,-6,2,1,0,-1,-1,-1,-1,1,3,-1
KR_6734938110,420,-2,-51,-13,-1,1,1,2,-3,4,1,-1,3,2,0,0,0,2,0,2,0,-6,-22,5,-8,3,0,0,0,-1,1,-1,1,5,-1
KR_6767364365,420,3,65,7,-2,0,0,0,-6,6,0,2,2,4,2,3,5,0,1,1,0,-1,23,-2,-3,5,2,0,0,1,-1,0,-1,3,-1
KR_6711394528,420,1,32,14,8,-1,4,3,-1,2,1,2,3,5,4,1,5,4,0,4,0,18,2,1,-5,4,1,0,1,0,0,1,-1,0,-1
KR_6768090942,420,-2,-72,-19,-1,1,2,3,-3,4,1,-5,6,1,0,2,2,6,1,7,-1,-7,-17,0,-4,4,-6,0,0,-1,-1,0,-1,4,-1
KR_6720771339,420,2,27,-29,5,0,1,1,1,7,8,-1,2,1,5,2,7,0,0,0,-1,-5,9,-5,-4,9,2,0,0,-1,1,0,-1,2,-1
KR_6760829178,420,-2,-18,8,-8,-4,4,0,4,7,11,-3,4,1,-1,4,3,-4,4,0,0,-2,-10,-1,-2,3,1,0,-1,-1,-1,-1,-1,6,-1
KR_6766662246,420,0,-38,2,-4,2,1,3,-4,8,4,-2,3,1,1,3,4,-1,3,2,-1,-9,3,1,-6,5,-1,0,1,-1,-1,1,-1,5,-1
KR_6761143299,420,-1,-35,12,-8,1,2,3,0,1,1,-2,5,3,-4,6,2,-3,3,0,0,-6,0,-6,-3,9,0,0,-3,-1,-1,-1,-1,6,-1
KR_6704764527,420,-3,-72,-17,3,-1,2,1,-5,7,2,3,2,5,4,2,6,2,0,2,0,6,-1,3,-9,6,0,0,-1,1,-1,-1,1,5,-1
KR_6607821654,420,1,-47,-9,-1,5,0,5,2,1,3,-2,4,2,-1,2,1,-5,5,0,0,-9,-8,-2,-4,6,1,0,1,-1,-1,1,1,6,-1
KR_6769009781,420,-4,-23,-5,-12,1,1,2,-2,4,2,-5,6,1,-3,8,5,-3,3,0,0,-15,-45,0,-1,1,-3,0,0,-1,1,-1,1,3,-1
KR_6766165591,420,-1,-45,4,-1,2,1,3,1,2,3,-1,4,3,-2,6,4,-1,3,2,0,-2,-33,8,-9,1,10,0,-1,-1,-1,-1,1,1,-1
KR_6696537879,420,-1,-20,-7,0,2,1,3,-2,2,0,0,2,2,0,0,0,0,0,0,0,0,-132,2,-5,3,-1,0,0,-1,-1,-1,-1,3,-1
KR_6761645611,420,-6,-109,-43,-8,1,2,3,3,4,7,-9,11,2,-3,3,0,0,2,2,1,2,-3,-2,-3,5,-2,0,0,-1,-1,-1,1,4,-1
KR_6727434899,420,-8,-145,-44,-18,-7,8,1,-3,8,5,-1,2,1,-4,4,0,-3,3,0,0,-7,7,1,-3,2,-4,0,-1,-1,1,-1,-1,5,-1
KR_6422358391,420,2,-15,8,2,2,1,3,6,0,6,1,1,2,-8,9,1,1,1,2,0,-3,-9,-8,-2,10,0,0,0,-1,1,-1,-1,5,-1
KR_6761527151,420,-2,-1,-20,3,0,2,2,-2,4,2,4,0,4,4,2,6,-3,3,0,0,1,-4,3,-7,4,0,0,1,-1,1,1,1,4,-1
KR_6703864652,440,-4,-28,-8,-10,-2,3,1,-7,8,1,-2,3,1,2,1,3,-1,2,1,0,-4,25,-4,-1,5,-7,0,0,-1,-1,0,-1,4,-1
KR_6768070564,420,0,13,-48,-2,1,0,1,-2,2,0,2,3,5,-1,3,2,-2,2,0,0,-5,-2,-2,-4,6,-1,0,1,-1,1,1,-1,4,-1
KR_6687210574,420,-1,10,-32,-2,2,1,3,-4,6,2,2,1,3,-2,3,1,0,0,0,0,-3,-4,2,-6,4,2,0,0,-1,-1,0,-1,6,-1
KR_6755196461,440,2,-40,32,1,3,1,4,-2,3,1,-1,1,0,-1,1,0,2,2,4,0,-3,-2,2,-5,3,-3,0,-1,1,1,-1,1,5,-1
KR_6760067522,420,-2,-18,8,0,-1,2,1,-3,5,2,1,3,4,3,2,5,0,0,0,0,-3,-2,-1,-3,4,0,0,0,1,-1,-1,1,6,-1
KR_6769016239,420,0,41,0,-2,4,0,4,-5,6,1,-3,3,0,1,0,1,1,1,2,0,-4,-12,-2,-4,6,0,0,-1,1,-1,-1,-1,1,-1
KR_6747211100,420,-7,-42,-32,-7,-2,2,0,1,0,1,2,1,3,-6,6,0,-2,2,0,0,-5,-5,-1,-3,4,-1,0,-3,-1,-1,-1,-1,5,-1
KR_6719900459,420,-4,24,-16,-6,-2,4,2,-3,3,0,1,6,7,-2,4,2,0,0,0,0,-10,-1,0,-8,8,-1,0,0,-1,-1,-1,1,2,-1
KR_6713135479,440,-1,-3,44,-3,0,2,2,0,1,1,-6,7,1,4,0,4,-1,2,1,0,-4,-5,-2,-4,6,-1,0,0,1,-1,-1,-1,6,-1
KR_6710015857,420,-1,-20,-28,-8,-5,5,0,-4,5,1,-2,4,2,2,3,5,1,1,2,0,-11,4,5,-8,3,2,0,0,-1,-1,-1,-1,6,-1
KR_6755339949,420,-1,-24,0,-13,-2,2,0,-7,10,3,2,1,3,-3,3,0,-3,3,0,-1,-34,366,-2,-7,9,1,0,0,-1,1,-1,-1,3,-1
KR_6709529172,420,-6,-81,-12,-10,-4,4,0,-3,3,0,-4,7,3,0,2,2,1,0,1,-1,-11,6,0,-2,2,-1,0,-1,0,-1,-1,-1,0,-1
KR_6736687027,420,2,61,16,6,-1,3,2,5,2,7,-3,4,1,5,1,6,0,1,1,0,4,-54,-3,-5,8,16,0,0,1,-1,1,1,2,-1
KR_6762654064,420,2,-5,17,-5,-4,4,0,-3,4,1,2,0,2,1,0,1,-1,1,0,-1,-2,-13,-2,-4,6,3,0,0,-1,-1,-1,-1,6,-1
KR_6749052902,420,2,13,11,3,3,0,3,0,4,4,-1,3,2,1,4,5,0,0,0,-2,-5,-10,-5,-2,7,4,0,0,-1,1,1,-1,5,-1
KR_6770284033,420,-5,-40,-36,-9,-1,1,0,-5,6,1,0,3,3,-3,5,2,0,0,0,-1,-5,7,6,-9,3,-3,0,0,1,-1,0,-1,3,-1
KR_6716099402,420,-3,4,-19,-4,2,0,2,-2,3,1,-1,4,3,-1,4,3,-2,4,2,0,-7,-2,0,-5,5,-1,0,0,0,0,0,-1,0,-1
KR_6685456490,420,0,-25,0,-3,-2,2,0,-1,3,2,-5,5,0,1,2,3,4,2,6,-1,-4,6,2,-6,4,0,0,0,-1,0,0,-1,5,-1
KR_6725853968,420,-3,18,-5,-7,-3,4,1,-7,10,3,2,2,4,0,2,2,1,0,1,0,-10,9,-1,-3,4,-4,0,-1,-1,-1,-1,-1,2,-1
KR_6306984856,420,0,-68,16,-6,-3,3,0,1,5,6,0,3,3,-5,8,3,1,1,2,0,6,-2,-7,-1,8,-2,0,-1,1,-1,-1,-1,4,-1
KR_6708965740,440,1,-10,20,-3,-4,6,2,3,2,5,1,2,3,-3,5,2,0,2,2,1,-3,15,-7,-3,10,0,0,-1,-1,1,-1,1,3,-1
KR_6767021053,420,-3,-28,8,0,4,1,5,-1,2,1,-3,6,3,-2,4,2,2,1,3,0,1,-34,1,-3,2,0,0,-1,-1,-1,-1,-1,5,-1
KR_6576841355,420,-2,-24,-8,-6,-2,2,0,-3,3,0,-1,5,4,1,4,5,-1,2,1,0,-8,-5,-1,-5,6,4,0,1,1,0,1,-1,3,-1
KR_6671445631,420,-1,-22,-4,-2,4,0,4,0,3,3,-5,6,1,-1,2,1,0,0,0,0,1,0,0,-5,5,-1,0,-1,-1,-1,-1,-1,5,-1
KR_6541058392,420,-5,-48,-7,-15,-5,7,2,-4,5,1,-3,4,1,-4,5,1,1,0,1,0,-14,9,3,-8,5,-2,0,0,1,-1,-1,1,4,-1
KR_6749906350,420,-2,-102,-21,-8,-2,3,1,-1,1,0,2,0,2,-6,7,1,-1,3,2,0,-3,2,0,-5,5,-4,0,0,-1,-1,-1,-1,1,-1
KR_6733338224,420,-5,-52,-36,-12,-5,6,1,-6,7,1,2,1,3,-2,4,2,-1,2,1,0,-18,-41,0,-7,7,1,0,-1,1,-1,-1,1,4,-1
KR_6766424103,420,-3,-47,-52,-11,-1,1,0,-4,5,1,0,3,3,-4,6,2,-2,6,4,0,-6,-102,-1,-3,4,-2,0,0,-1,-1,0,-1,5,-1
KR_6767185463,420,-1,-6,-4,-2,-1,2,1,-2,3,1,-2,5,3,3,0,3,0,0,0,0,-7,-18,0,-3,3,3,0,0,1,1,0,-1,4,-1
KR_6704907569,440,0,-33,8,-2,4,0,4,0,3,3,-1,2,1,-1,7,6,-4,4,0,0,-3,28,2,-5,3,1,0,0,1,-1,0,1,1,-1
KR_6718872560,420,4,-19,1,1,-1,3,2,-2,7,5,-1,3,2,-1,4,3,6,0,6,-3,-3,35,-1,-8,9,-19,0,1,-1,-1,1,-1,1,-1
KR_6637634665,420,0,-17,11,0,1,0,1,-2,5,3,0,2,2,5,0,5,-4,5,1,0,6,93,5,-8,3,-4,0,-1,-1,-1,1,-1,1,-1
KR_6758737722,440,-3,-87,7,-2,-3,5,2,2,2,4,-3,4,1,-1,2,1,3,0,3,-2,-1,7,-5,0,5,1,0,-1,0,0,-1,-1,0,-1
KR_6647068265,420,-2,-23,-8,-6,-2,2,0,0,2,2,-1,3,2,-1,3,2,-2,3,1,0,-7,58,-3,-4,7,2,0,-2,1,-1,-1,-1,2,-1
KR_6753762397,420,-3,-10,-5,-8,-2,5,3,-4,6,2,0,3,3,-1,5,4,-1,2,1,-1,-5,-52,-3,-4,7,6,0,0,0,1,-1,-1,0,-1
KR_6685082641,420,0,46,-28,0,2,3,5,2,4,6,3,2,5,0,2,2,-7,9,2,2,-3,-15,0,-7,7,4,0,0,-1,-1,-1,1,1,-1
KR_6769417320,420,-5,-51,-4,-13,5,2,7,-3,4,1,-3,3,0,-12,12,0,0,2,2,0,-14,-145,-7,0,7,2,0,0,-1,1,1,-1,1,-1
KR_6763912565,420,1,-39,16,4,1,2,3,1,3,4,4,1,5,-2,3,1,0,1,1,1,11,27,1,-5,4,-3,0,-1,-1,0,-1,1,5,-1
KR_6640593863,420,-1,-47,-9,-4,-2,4,2,0,2,2,-1,6,5,-1,2,1,0,0,0,0,-1,-84,0,-4,4,-20,0,-1,1,-1,-1,-1,3,-1
KR_6762026785,420,-3,-46,-40,0,2,0,2,-3,4,1,-3,3,0,2,1,3,2,1,3,0,0,-8,-5,-1,6,-4,0,0,-1,0,0,1,4,-1
KR_6756306024,420,-4,-15,-53,-7,-3,4,1,-5,7,2,-2,2,0,3,2,5,0,1,1,-4,-11,-29,-4,-9,13,7,0,-1,1,-1,-1,-1,4,-1
KR_6762884497,420,-3,-78,8,-5,-2,2,0,-6,7,1,-1,2,1,2,3,5,2,0,2,0,-9,5,-1,-4,5,-5,0,-2,0,1,-1,-1,0,-1
KR_6725624938,420,-3,-43,-21,-18,-4,4,0,-1,3,2,-7,9,2,-2,7,5,-4,4,0,1,-17,4,-7,-1,8,3,0,-1,-1,-1,-1,1,2,-1
KR_6669535805,420,0,-31,12,-3,-5,6,1,1,2,3,1,1,2,-1,4,3,1,0,1,0,-7,-11,-7,-4,11,1,0,-1,1,-1,-1,-1,6,-1
KR_6764795786,420,-2,-28,-30,-8,-2,2,0,0,2,2,-4,4,0,-4,5,1,2,0,2,0,-9,2,-1,-3,4,-7,0,-2,0,-1,-1,-1,0,-1
KR_6753957525,420,1,-5,-15,-1,1,2,3,-3,3,0,1,0,1,-2,3,1,2,1,3,-1,-1,3,0,-7,7,-1,0,0,1,1,1,-1,1,-1
KR_6765613775,420,-5,-39,-20,-9,-3,4,1,1,2,3,-2,4,2,0,3,3,-5,5,0,0,-7,28,-4,-3,7,-27,0,-1,-1,-1,-1,1,6,-1
KR_6616778417,420,-2,-4,0,-8,-1,3,2,-1,3,2,-4,6,2,-1,3,2,-1,1,0,0,-10,-3,0,-5,5,2,0,-1,-1,1,-1,-1,3,-1
KR_6718527950,420,-2,1,25,-1,-3,4,1,2,2,4,-2,3,1,3,0,3,-1,1,0,0,12,-49,0,-3,3,12,0,-3,1,-1,-1,1,3,-1
KR_6693473019,420,2,15,-12,1,1,1,2,-3,6,3,1,1,2,3,3,6,-1,2,1,0,-5,0,-2,-5,7,1,0,0,1,-1,0,1,3,-1
KR_6732570432,420,-4,-45,-7,-7,-2,2,0,-1,4,3,-6,6,0,0,2,2,2,0,2,1,-1,144,-3,-1,4,1,0,0,1,-1,-1,1,5,-1
KR_6729686609,440,-1,-26,0,-1,1,0,1,2,2,4,4,1,5,-8,9,1,0,1,1,-1,-4,-9,-2,-3,5,0,0,-1,-1,-1,-1,-1,6,-1
KR_6749257536,440,-7,-69,-48,-17,-6,7,1,-5,7,2,-2,4,2,-2,6,4,-2,4,2,0,-2,-12,-2,-3,5,-1,0,-3,-1,-1,-1,-1,5,-1
KR_6766473866,440,-2,-32,4,-5,1,1,2,1,3,4,-7,10,3,0,2,2,0,1,1,0,-5,5,6,-11,5,-2,0,0,-1,1,0,1,3,-1
KR_6743640854,420,0,45,22,4,4,1,5,2,0,2,2,1,3,-3,5,2,-1,2,1,0,-2,-5,3,-5,2,3,0,1,1,1,1,1,1,-1
KR_6769088311,420,-7,-102,-41,-13,1,2,3,-5,9,4,-3,3,0,0,4,4,-6,6,0,0,-12,-6,-1,-2,3,1,0,-3,-1,-1,-1,1,3,-1
KR_6765519901,420,-1,-70,-15,-6,0,3,3,-4,6,2,3,2,5,-3,5,2,-2,3,1,0,-7,-2,1,-6,5,-2,0,-2,-1,1,-1,1,2,-1
KR_6746482789,440,-2,23,-24,-9,0,2,2,-3,5,2,-2,5,3,-2,2,0,-2,2,0,-1,-9,7,1,-6,5,0,0,-2,1,-1,-1,-1,2,-1
KR_6640235718,420,-5,-39,-36,-9,-4,5,1,-5,5,0,1,3,4,0,0,0,-1,1,0,1,-7,7,-1,-4,5,-1,0,-4,-1,-1,-1,1,6,-1
KR_6684647943,420,-1,-11,5,-4,3,0,3,-4,5,1,-3,4,1,0,3,3,0,1,1,1,-13,1,0,-6,6,-3,0,-1,-1,-1,-1,1,1,-1
KR_6589397160,420,-2,10,-12,-4,-1,1,0,-2,3,1,3,1,4,-4,4,0,0,0,0,0,-7,2,0,-4,4,5,0,0,-1,-1,-1,-1,6,-1
KR_6742025308,420,1,26,-12,5,4,1,5,-1,6,5,2,0,2,2,0,2,-2,3,1,0,-2,13,0,-4,4,2,0,1,1,1,1,1,3,-1
KR_6656190399,440,-4,-45,-45,-7,2,1,3,0,6,6,-7,7,0,-4,5,1,2,0,2,0,-2,-43,6,-9,3,7,0,0,-1,1,-1,1,2,-1
KR_6685421124,420,-2,-30,28,-3,1,1,2,3,2,5,-3,6,3,-6,9,3,2,1,3,0,-6,-3,-3,-8,11,-1,0,-2,1,1,-1,-1,6,-1
KR_6755938104,420,-10,-153,-39,-25,-4,6,2,-3,4,1,-9,9,0,-6,7,1,-3,3,0,-2,-27,-8,-3,-3,6,0,0,-3,-1,-1,-1,-1,2,-1
KR_6739421746,420,-1,17,3,-11,2,1,3,-6,6,0,-3,4,1,-3,4,1,-1,1,0,0,-15,23,-4,0,4,0,0,0,1,-1,1,1,1,-1
KR_6706231272,440,-4,-20,1,-13,-5,5,0,-2,3,1,0,2,2,-6,6,0,0,0,0,0,-5,-7,1,-6,5,-2,0,0,-1,-1,0,-1,6,-1
KR_6740092900,420,-3,-26,4,-10,-5,7,2,-3,4,1,0,1,1,-2,5,3,0,1,1,0,-11,125,0,-3,3,-3,0,-1,0,0,-1,-1,0,-1
KR_6766878732,420,0,23,-12,-4,-2,3,1,-4,4,0,-1,2,1,-1,3,2,4,0,4,0,-8,31,-5,0,5,0,0,-1,-1,-1,1,-1,2,-1
KR_6743810120,420,-4,-36,-8,-9,-1,4,3,-5,6,1,1,1,2,-2,3,1,-2,2,0,0,-7,4,-3,-3,6,-4,0,-1,-1,-1,-1,-1,3,-1
KR_6771195016,420,0,-67,11,0,-5,6,1,1,4,5,4,2,6,1,1,2,-1,2,1,0,5,1,3,-7,4,-3,0,-1,-1,-1,-1,-1,3,-1
KR_6647393605,420,-2,-32,16,-10,3,1,4,-2,2,0,-3,3,0,-7,9,2,-1,1,0,0,-11,-9,-2,-3,5,5,0,-1,-1,-1,-1,-1,3,-1
KR_6755730274,420,-1,-21,3,-7,-1,3,2,-4,4,0,-2,4,2,2,1,3,-2,3,1,0,-9,12,3,-7,4,-1,0,1,0,0,1,1,0,-1
KR_6770895023,420,0,48,5,5,3,2,5,-4,7,3,3,0,3,4,1,5,-1,1,0,0,8,-4,5,-8,3,2,0,0,1,-1,0,1,4,-1
KR_6769075765,420,-2,-51,-33,-3,-2,4,2,-4,5,1,0,0,0,5,1,6,-2,4,2,0,5,-109,1,-6,5,-1,0,-2,-1,-1,-1,-1,6,-1
KR_6665309885,420,0,-16,4,0,-2,3,1,4,0,4,1,0,1,-3,4,1,0,2,2,0,0,-7,-1,-6,7,0,0,0,1,-1,-1,-1,4,-1
KR_6751401873,420,1,-12,-8,7,0,2,2,1,2,3,2,4,6,1,1,2,3,0,3,0,21,-11,4,-9,5,1,0,0,1,-1,-1,-1,4,-1
KR_6742911184,420,-4,-37,-24,-5,3,2,5,-4,8,4,-3,7,4,-1,3,2,0,1,1,0,0,-228,2,-7,5,-16,0,-1,-1,-1,-1,1,4,-1
KR_6759986201,420,0,52,-4,-4,2,0,2,-3,5,2,0,0,0,-3,4,1,0,2,2,-1,-5,27,-2,-3,5,-16,0,1,-1,-1,1,-1,6,-1
KR_6759160264,440,0,-9,0,0,1,2,3,2,1,3,-1,3,2,-3,8,5,1,2,3,0,-5,4,-2,-4,6,1,0,1,1,0,1,1,4,-1
KR_6750841859,440,-1,-35,3,-3,-6,6,0,1,2,3,1,0,1,2,4,6,-1,2,1,0,-5,3,-4,-2,6,-2,0,-1,1,-1,-1,-1,4,-1
KR_6730793483,420,-5,-119,8,-17,-4,5,1,-2,4,2,-2,2,0,-8,8,0,-1,1,0,0,-18,65,-1,-2,3,-1,0,-4,0,0,-1,-1,0,-1
KR_6709720356,420,-2,-76,6,-3,-2,4,2,4,2,6,0,1,1,-6,8,2,1,1,2,-1,-4,37,5,-9,4,-2,0,1,-1,1,1,-1,5,-1
KR_6747386341,420,-1,40,-15,-4,0,1,1,4,2,6,-4,6,2,-4,4,0,0,0,0,0,-1,-4,-1,-5,6,3,0,0,1,-1,0,-1,1,-1
KR_6709354634,420,-1,-39,-61,1,1,1,2,4,0,4,1,0,1,-4,4,0,-1,1,0,0,2,-5,3,-6,3,-5,0,-1,-1,1,-1,-1,1,-1
KR_6770564828,420,-4,-95,-35,-9,2,2,4,0,1,1,-6,8,2,-5,6,1,0,0,0,-1,-15,-6,-2,-3,5,-1,0,-2,-1,-1,-1,-1,6,-1
KR_6753808683,420,-2,-47,4,-12,-1,1,0,-4,4,0,0,3,3,-7,9,2,0,0,0,-2,-23,-15,-5,-2,7,2,0,0,-1,1,-1,-1,4,-1
KR_6647178770,420,-4,-62,-36,-8,-4,4,0,-3,3,0,-3,4,1,2,3,5,0,4,4,-2,-3,-2,1,-5,4,3,0,-2,1,-1,-1,-1,2,-1
KR_6647385773,420,0,-54,14,-2,-5,6,1,3,2,5,-2,6,4,0,2,2,2,0,2,0,3,-7,-4,-1,5,0,0,-2,-1,1,-1,1,5,-1
KR_6753090771,420,-1,18,-8,-5,2,4,6,-2,2,0,1,1,2,-4,6,2,-2,2,0,0,-7,32,0,-5,5,-10,0,0,-1,1,1,-1,3,-1
KR_6769998356,420,3,25,11,8,0,0,0,1,3,4,4,0,4,3,1,4,0,1,1,1,13,20,1,-4,3,-3,0,-1,1,-1,-1,-1,5,-1
KR_6674543362,420,-1,8,-28,-5,1,0,1,-3,4,1,0,0,0,-2,3,1,-1,1,0,0,-6,-10,-1,-5,6,0,0,1,-1,1,-1,1,6,-1
KR_6141893442,420,-3,-25,3,0,0,1,1,-1,5,4,6,1,7,-1,2,1,-4,4,0,3,5,-8,-1,-4,5,1,0,1,-1,1,1,1,5,-1
KR_6760529046,420,1,25,11,8,-2,3,1,5,0,5,-1,1,0,9,1,10,-3,3,0,0,11,27,5,-6,1,1,0,1,1,1,1,1,5,-1
KR_6675786338,420,-3,-15,-19,1,-2,2,0,4,0,4,0,2,2,0,4,4,-1,1,0,0,1,4,3,-6,3,-2,0,0,1,1,1,-1,2,-1
KR_6732148419,440,2,23,16,-1,0,1,1,2,0,2,3,1,4,-5,5,0,-1,2,1,0,-4,-127,1,-7,6,4,0,0,1,-1,-1,1,3,-1
KR_6756174324,440,-3,-30,-27,-12,-3,5,2,-3,5,2,-1,3,2,-1,5,4,-4,4,0,-1,-12,-37,-2,0,2,-2,0,1,0,0,1,-1,0,-1
KR_6704984132,440,-2,-90,24,-5,-3,5,2,1,2,3,-8,11,3,-1,2,1,6,2,8,0,-3,4,-2,-3,5,1,0,1,1,-1,1,1,4,-1
KR_6608693247,420,-1,17,-21,1,-2,3,1,3,4,7,2,3,5,0,0,0,-2,2,0,0,-1,-3,1,-8,7,2,0,-1,1,-1,-1,1,2,-1
KR_6686925231,420,2,-88,24,-2,-2,2,0,0,3,3,0,2,2,0,3,3,0,0,0,0,4,56,0,-3,3,-3,0,0,1,-1,0,-1,5,-1
KR_6759727615,420,-1,-90,0,-9,-1,3,2,-6,7,1,3,2,5,-2,5,3,-3,4,1,1,-5,-5,4,-7,3,-4,0,-3,-1,-1,-1,1,6,-1
KR_6770032585,420,-1,-45,-14,-10,-2,3,1,-3,5,2,1,1,2,-6,8,2,0,0,0,-2,-18,-7,-6,-1,7,6,0,-1,-1,-1,-1,-1,6,-1
KR_6759618256,440,-3,-29,4,-1,-3,3,0,-4,4,0,1,5,6,3,3,6,2,0,2,-1,-7,9,1,-4,3,0,0,-1,-1,-1,-1,-1,3,-1
KR_6747803908,420,0,-18,-9,1,6,3,9,0,1,1,-1,1,0,0,3,3,-4,4,0,0,-1,1,-1,-8,9,4,0,-1,-1,1,1,1,1,-1
KR_6583378304,420,-3,-7,-10,-5,-1,3,2,-2,2,0,0,2,2,-3,3,0,1,0,1,1,-2,5,4,-8,4,-2,0,1,1,0,1,1,1,-1
KR_6764274712,420,-3,-18,-29,-1,1,2,3,-2,4,2,2,0,2,-3,5,2,1,1,2,0,4,43,3,-4,1,-19,0,0,1,-1,0,-1,3,-1
KR_6768448244,420,-3,24,4,-11,-5,6,1,-3,5,2,-1,4,3,-1,2,1,-1,1,0,0,-13,-4,-2,-4,6,3,0,-1,-1,1,-1,1,2,-1
KR_6718580046,420,-4,-20,-10,-10,-2,3,1,-5,7,2,2,1,3,-2,6,4,-3,3,0,0,-18,-1,2,-4,2,-3,0,-1,-1,-1,-1,-1,2,-1
KR_6728164803,420,2,67,-38,-1,3,1,4,0,0,0,1,2,3,-3,3,0,-2,2,0,0,-8,-13,-4,-2,6,4,0,0,-1,-1,1,-1,4,-1
KR_6734960586,420,0,-41,4,-3,-2,3,1,2,0,2,-1,5,4,-1,2,1,-1,1,0,0,-3,6,1,-5,4,-1,0,1,1,-1,-1,1,1,-1
KR_6759453650,440,-4,-11,-35,-2,-4,4,0,1,2,3,-2,3,1,1,2,3,2,3,5,0,-7,-4,6,-8,2,-7,0,-1,-1,1,-1,1,1,-1
KR_6750656025,420,0,9,4,4,-1,1,0,0,1,1,3,0,3,2,2,4,0,0,0,0,6,2,-2,-5,7,1,0,-1,1,1,-1,1,2,-1
KR_6747489094,420,-1,4,-47,0,1,2,3,-2,3,1,2,4,6,-4,9,5,3,4,7,2,12,114,1,-7,6,-5,0,0,0,-1,1,1,0,-1
KR_6648327347,440,-1,-98,-18,-3,-5,7,2,-3,3,0,3,3,6,3,0,3,-1,2,1,1,14,147,2,-5,3,-2,0,-2,-1,-1,-1,1,5,-1
KR_6751191515,420,-3,-46,-12,-8,-4,5,1,-6,7,1,1,2,3,1,1,2,0,0,0,0,-7,-12,-3,-1,4,2,0,-1,-1,-1,-1,-1,4,-1
KR_6603967127,420,-3,-45,1,-14,2,1,3,-3,6,3,-2,2,0,-11,11,0,0,1,1,0,-15,-3,-5,-2,7,-1,0,0,-1,1,-1,-1,5,-1
KR_6756651501,420,3,-24,-7,5,1,0,1,0,4,4,-2,5,3,4,1,5,2,2,4,0,4,1,2,-8,6,-3,0,0,1,1,-1,1,3,-1
KR_6723826632,420,-1,45,-14,-6,-1,2,1,-3,7,4,-3,5,2,1,4,5,0,0,0,0,0,46,6,-9,3,-24,0,0,1,1,1,1,6,-1
KR_6739128497,420,1,43,-1,-6,1,3,4,-1,4,3,-1,1,0,-2,3,1,-3,4,1,0,-4,52,-3,-2,5,-9,0,1,-1,-1,1,-1,5,-1
KR_6752686626,440,-2,-16,24,1,1,2,3,-1,4,3,-2,2,0,3,5,8,0,2,2,1,-7,-38,-2,-2,4,26,0,0,-1,-1,0,1,6,-1
KR_6650540127,420,0,-7,1,-3,1,3,4,2,1,3,-2,3,1,-3,5,2,-1,2,1,0,0,-5,-3,-2,5,-2,0,0,-1,1,-1,-1,2,-1
KR_6653889070,420,1,27,-24,-4,-3,3,0,-1,3,2,1,1,2,1,1,2,-2,2,0,-1,-12,4,-5,-2,7,-8,0,0,-1,-1,0,-1,1,-1
KR_6750239958,420,-5,-152,-32,-15,-13,15,2,-2,3,1,-1,5,4,1,1,2,0,1,1,0,-8,-31,1,-4,3,-3,0,-3,1,-1,-1,-1,3,-1
KR_6740954947,440,-4,-49,16,-6,2,1,3,-3,3,0,-6,6,0,1,3,4,0,2,2,0,-6,-47,-3,-4,7,23,0,-1,-1,-1,-1,1,4,-1
KR_6609074017,420,-5,-52,-25,-2,-4,5,1,6,1,7,1,3,4,-2,3,1,-3,3,0,0,0,60,1,-6,5,1,0,-1,0,1,-1,1,0,-1
KR_6759747309,420,-2,-33,28,-5,2,1,3,-2,4,2,-1,2,1,-5,6,1,1,0,1,0,-14,-5,0,-7,7,0,0,0,-1,-1,-1,-1,5,-1
KR_6770396138,420,0,50,-4,5,-2,2,0,-2,3,1,6,0,6,4,2,6,-1,1,0,0,7,-14,-5,-4,9,5,0,0,0,1,0,1,0,-1
KR_6723979572,420,1,-9,5,-4,0,3,3,1,1,2,0,3,3,-5,6,1,0,1,1,0,-3,-7,-5,-3,8,-6,0,0,0,0,-1,1,0,-1
KR_6733250938,420,0,-58,8,-3,-4,4,0,-3,3,0,-4,4,0,5,0,5,3,1,4,0,2,-1,0,-4,4,7,0,-2,1,-1,-1,1,6,-1
KR_6768184467,420,-2,-13,30,-4,4,0,4,0,1,1,-4,5,1,-5,7,2,1,2,3,3,-1,-4,-7,0,7,9,0,1,1,1,1,1,2,-1
KR_6607897873,420,0,-6,0,-7,1,2,3,-4,4,0,-3,4,1,0,3,3,-1,1,0,0,-10,44,-2,-5,7,-18,0,1,-1,-1,1,-1,5,-1
KR_6754053263,420,-5,-26,-20,-12,-4,6,2,-9,10,1,2,2,4,-1,2,1,0,0,0,0,-13,511,1,-6,5,-2,0,-1,-1,1,-1,-1,5,-1
KR_6605367406,420,-1,4,8,-6,-1,2,1,-1,1,0,-2,3,1,1,2,3,-3,3,0,0,-16,33,-2,-6,8,7,0,0,-1,1,0,-1,4,-1
KR_6711516490,420,-3,-60,-32,-5,4,1,5,-6,7,1,-4,5,1,2,1,3,-1,2,1,0,-11,1,-4,-1,5,-2,0,-1,-1,0,-1,-1,3,-1
KR_6690406310,420,-6,-113,16,-17,-5,6,1,-4,6,2,0,3,3,-4,8,4,-4,4,0,0,-12,2,1,-5,4,-5,0,-2,-1,-1,-1,-1,2,-1
KR_6750990603,420,-2,7,7,-9,-5,5,0,-1,4,3,0,3,3,-3,4,1,0,0,0,0,-8,196,3,-10,7,-6,0,-3,-1,-1,-1,-1,2,-1
KR_6761316513,440,-1,18,1,-6,0,0,0,-2,3,1,-2,2,0,-2,2,0,0,0,0,0,-8,8,1,-7,6,-6,0,0,1,1,0,-1,2,-1
KR_6769152364,420,1,25,-20,5,2,0,2,-6,6,0,4,0,4,5,0,5,0,2,2,0,0,0,-3,-3,6,1,0,0,-1,1,0,1,6,-1
KR_6659142481,420,-6,-36,-32,-18,-1,3,2,-6,6,0,-9,9,0,-1,2,1,-1,2,1,0,-9,-123,-4,-4,8,-4,0,-1,-1,1,-1,-1,5,-1
KR_6738642665,420,0,-84,-22,2,0,2,2,3,1,4,0,5,5,-1,1,0,0,1,1,0,5,-29,5,-6,1,20,0,-1,1,0,-1,-1,4,-1
KR_6664313829,420,1,19,-16,-1,4,1,5,-7,7,0,0,2,2,3,2,5,-1,1,0,0,-11,-11,-2,-3,5,-2,0,0,1,-1,0,-1,5,-1
KR_6663960002,420,-4,-55,9,-13,-4,4,0,0,3,3,-2,3,1,-7,8,1,0,0,0,0,-22,7,0,-4,4,-2,0,0,-1,1,-1,-1,2,-1
KR_6760905840,420,-3,-56,-4,-11,1,2,3,-3,4,1,-2,2,0,-6,8,2,-1,3,2,0,-10,-32,-9,-2,11,-1,0,-1,-1,-1,-1,1,1,-1
KR_6606002208,420,1,-4,8,1,0,1,1,-1,4,3,0,2,2,1,3,4,1,1,2,0,-9,289,-1,-3,4,0,0,-1,1,-1,-1,-1,5,-1
KR_6735817072,420,-1,-36,25,-5,0,0,0,-1,3,2,-2,2,0,-2,4,2,0,2,2,0,-4,133,4,-10,6,-2,0,0,-1,-1,-1,-1,3,-1
KR_6758516847,420,-3,-10,-12,-6,-2,3,1,1,1,2,-1,5,4,-4,5,1,0,1,1,0,1,-35,-2,-6,8,3,0,0,-1,-1,-1,1,3,-1
KR_6666828174,420,1,-9,44,0,1,1,2,0,2,2,-4,6,2,2,2,4,1,1,2,0,5,0,-3,-4,7,4,0,1,1,1,1,1,5,-1
KR_6438391348,420,0,-91,-17,-2,2,2,4,-2,3,1,-2,3,1,1,0,1,-1,2,1,0,-1,-2,0,-6,6,-3,0,-1,-1,1,-1,-1,2,-1
KR_6768116582,420,0,2,-4,-4,-2,3,1,-1,2,1,1,2,3,-3,5,2,1,1,2,0,-10,3,1,-8,7,-5,0,-1,-1,-1,-1,1,1,-1
KR_6727886356,420,-1,88,-9,1,2,1,3,3,1,4,-2,4,2,0,1,1,-2,2,0,2,-8,-6,-2,-4,6,4,0,1,-1,0,1,1,5,-1
KR_6768583024,420,1,-43,6,-3,2,1,3,0,1,1,0,4,4,-2,3,1,-3,3,0,0,-7,-3,-5,-1,6,0,0,0,1,-1,0,-1,4,-1
KR_6748699687,420,-3,-8,4,-6,7,0,7,-2,6,4,-3,3,0,-3,6,3,-5,6,1,1,-3,-58,-4,0,4,23,0,-1,-1,1,-1,1,5,-1
KR_6765900588,420,-2,8,-13,-8,-2,4,2,-3,5,2,0,1,1,-2,4,2,-1,2,1,0,-14,-1,0,-6,6,0,0,-1,0,-1,-1,-1,0,-1
KR_6727889277,420,-3,-61,-22,-3,2,0,2,4,3,7,-1,2,1,-7,8,1,-1,1,0,-1,-8,-9,-7,-3,10,0,0,-1,-1,1,-1,-1,1,-1
KR_6771145606,420,1,-8,28,-2,1,2,3,1,1,2,-3,4,1,1,2,3,-2,3,1,0,-3,-3,-2,-4,6,1,0,0,1,0,0,-1,6,-1
KR_6743061350,420,0,-29,-25,-3,-2,3,1,-1,2,1,4,3,7,-5,6,1,1,2,3,-2,-8,90,-1,-2,3,0,0,-1,0,0,-1,-1,0,-1
KR_6771228913,420,-4,-10,0,-2,-1,3,2,-4,6,2,-1,2,1,5,1,6,-1,1,0,0,-10,9,0,-3,3,-1,0,0,-1,-1,1,1,3,-1
KR_6770500966,420,0,-15,-19,-3,2,1,3,0,3,3,-2,2,0,-3,4,1,0,0,0,0,-2,1,1,-4,3,-2,0,0,-1,-1,-1,1,6,-1
KR_6769989525,420,2,-34,0,2,-2,4,2,3,1,4,0,2,2,-2,5,3,3,0,3,1,10,2,1,-6,5,-4,0,0,-1,0,0,1,6,-1
KR_6765546269,420,-5,-79,-11,-10,-4,5,1,-1,2,1,-2,3,1,-1,2,1,-2,2,0,1,-4,10,4,-7,3,2,0,-1,0,0,-1,1,0,-1
KR_6527188217,420,-7,-16,-48,-6,1,3,4,-4,5,1,-2,3,1,-1,2,1,0,1,1,-1,-4,4,0,-5,5,-4,0,-1,-1,1,-1,-1,6,-1
KR_6542642498,420,1,32,-31,4,0,0,0,-1,4,3,0,1,1,4,2,6,1,1,2,0,5,-42,-1,-4,5,0,0,0,-1,0,0,1,4,-1
KR_6770414222,440,-5,-107,-38,-11,-6,7,1,-2,4,2,1,3,4,-4,5,1,0,1,1,-3,-17,-3,-2,-4,6,4,0,-2,-1,-1,-1,-1,6,-1
KR_6726755417,420,0,-16,0,-7,-2,2,0,-4,6,2,-1,4,3,0,1,1,0,0,0,0,-10,-135,3,-6,3,-3,0,0,-1,1,-1,1,4,-1
KR_6745882980,420,2,24,-12,7,8,2,10,-8,9,1,2,1,3,2,2,4,3,0,3,1,-5,-18,-1,-4,5,-2,0,3,1,0,1,1,5,-1
KR_6763517964,420,0,-46,8,-1,0,2,2,-3,3,0,-1,3,2,1,6,7,2,0,2,0,-1,-10,-7,-1,8,-2,0,1,-1,0,1,1,3,-1
KR_6762237245,420,0,-54,52,2,-2,2,0,3,2,5,-1,3,2,3,2,5,-1,1,0,0,0,25,1,-3,2,-6,0,0,1,-1,0,1,6,-1
KR_6729285816,420,-7,-90,-23,-12,-2,4,2,-6,7,1,0,1,1,-3,6,3,-1,3,2,0,-9,2,0,-5,5,-1,0,-1,-1,-1,-1,-1,1,-1
KR_6675776860,420,0,-58,4,2,-2,3,1,-1,5,4,2,3,5,2,0,2,1,1,2,0,4,11,-3,-4,7,-6,0,1,-1,-1,1,-1,4,-1
KR_6761720650,420,-1,-17,-12,-12,0,1,1,-5,5,0,-4,4,0,-5,5,0,2,0,2,-1,-12,-5,-4,0,4,4,0,-1,-1,-1,-1,1,2,-1
KR_6722602671,420,-2,-41,-12,-2,0,3,3,1,2,3,0,5,5,-3,4,1,0,1,1,2,12,2,-2,-4,6,1,0,-2,-1,-1,-1,1,4,-1
KR_6751945659,420,-6,-102,0,-18,1,1,2,1,1,2,-10,10,0,-4,6,2,-6,7,1,0,-13,10,0,-3,3,-4,0,-1,-1,1,-1,-1,1,-1
KR_6742398226,420,-2,-74,-29,-2,-4,5,1,2,1,3,2,3,5,-1,4,3,-1,3,2,2,12,-11,-2,-1,3,-1,0,-1,1,-1,-1,1,3,-1
KR_6744588426,420,-4,-73,-32,-15,-2,3,1,-5,8,3,-3,5,2,-4,8,4,-1,1,0,3,-5,-10,1,-6,5,-2,0,-1,-1,1,1,1,6,-1
KR_6759348400,420,0,-32,-4,-6,-4,5,1,0,1,1,1,2,3,-2,2,0,-1,2,1,-1,-7,4,3,-6,3,1,0,0,-1,0,0,-1,5,-1
KR_6545514620,420,-4,-37,-5,-9,0,2,2,-7,9,2,-2,3,1,0,4,4,0,1,1,0,-10,12,0,-4,4,-3,0,0,-1,1,0,-1,2,-1
KR_6768093362,420,1,60,-28,0,0,3,3,3,2,5,-3,4,1,-1,4,3,1,1,2,1,-1,5,1,-4,3,-1,0,0,-1,1,1,1,1,-1
KR_6738756470,440,-1,-67,0,0,1,0,1,-3,4,1,2,1,3,1,1,2,-1,1,0,0,0,5,-4,-6,10,4,0,0,1,1,0,1,5,-1
KR_6748009313,420,0,12,-12,4,2,0,2,-1,5,4,2,2,4,3,1,4,-2,4,2,0,2,-9,-1,-7,8,8,0,1,-1,1,1,1,6,-1
KR_6649627592,420,-1,12,-24,-3,1,1,2,-2,5,3,-4,6,2,2,2,4,0,2,2,0,-8,5,6,-7,1,-2,0,-2,-1,-1,-1,1,2,-1
KR_6766851050,420,3,75,10,2,-1,2,1,-1,2,1,-1,3,2,1,0,1,4,4,8,0,-1,-11,-1,-5,6,2,0,0,1,1,1,-1,3,-1
KR_6769557360,420,-2,-36,4,-4,1,2,3,-4,5,1,2,2,4,-3,4,1,0,1,1,0,-4,251,0,-2,2,-4,0,1,-1,1,1,1,1,-1
KR_6768583110,420,-3,-27,-23,-2,0,2,2,0,2,2,-1,2,1,-2,2,0,1,0,1,0,2,-42,2,-5,3,15,0,-1,1,0,-1,1,3,-1
KR_6717376965,420,-1,-3,12,-2,0,2,2,0,3,3,-1,1,0,-1,2,1,0,0,0,0,3,-3,1,-5,4,-4,0,1,-1,1,1,-1,5,-1
KR_6768311994,420,-3,-32,25,-14,1,1,2,-5,5,0,-3,3,0,-5,6,1,-2,2,0,0,-14,-3,-4,-2,6,1,0,-1,-1,1,-1,-1,3,-1
KR_6741073074,420,0,-24,4,-6,-3,4,1,-4,4,0,-1,4,3,-1,1,0,3,0,3,-1,-4,11,2,-6,4,-4,0,0,1,-1,0,-1,3,-1
KR_6624179145,420,-2,22,-19,3,5,0,5,-7,8,1,2,2,4,3,3,6,0,1,1,0,-9,-9,4,-6,2,0,0,2,-1,1,1,1,6,-1
KR_6761310784,420,-4,-72,-36,-15,0,3,3,-5,5,0,1,1,2,-6,8,2,-5,5,0,-1,-13,17,-2,-4,6,1,0,-1,-1,-1,-1,-1,5,-1
KR_6755442502,420,1,-16,12,0,0,4,4,1,0,1,1,0,1,1,2,3,-3,3,0,0,1,-5,1,-4,3,1,0,0,-1,1,0,-1,2,-1
KR_6762660122,420,-3,-45,-22,-5,-2,4,2,4,3,7,-2,5,3,-4,4,0,-1,2,1,-1,-5,10,-5,-3,8,-3,0,0,0,0,-1,-1,0,-1
KR_6661292590,420,3,-5,28,5,-1,2,1,3,2,5,6,0,6,-4,4,0,1,1,2,0,0,-7,-5,-3,8,2,0,0,1,-1,0,1,3,-1
KR_6753406940,420,-3,-55,8,-8,4,1,5,-2,4,2,-1,6,5,-8,8,0,-1,1,0,0,-11,5,3,-7,4,-4,0,1,-1,1,1,-1,3,-1
KR_6768256400,420,-3,-9,-12,-2,-4,5,1,-1,1,0,3,0,3,-1,3,2,1,0,1,0,-1,-1,-1,-8,9,-20,0,0,-1,1,-1,1,5,-1
KR_6704263369,420,2,24,32,-4,2,3,5,-3,4,1,-2,4,2,0,1,1,-1,2,1,0,-7,-5,0,-5,5,1,0,1,-1,1,1,-1,3,-1
KR_6713599958,440,-2,-92,-16,-4,3,4,7,-3,5,2,-4,6,2,2,1,3,-2,4,2,-1,-5,16,5,-7,2,-4,0,-1,0,1,-1,1,0,-1
KR_6760466573,420,-4,-75,-33,-10,-4,4,0,0,1,1,-1,6,5,-6,9,3,1,0,1,0,-6,-5,-1,-3,4,-3,0,-1,-1,-1,-1,1,4,-1
KR_6771163615,420,-1,-89,36,-8,1,1,2,1,2,3,-5,6,1,-5,6,1,0,0,0,0,-6,5,0,-4,4,-2,0,-1,-1,-1,-1,-1,5,-1
KR_6628253965,420,-1,52,21,-1,-2,3,1,-3,4,1,2,3,5,3,0,3,-1,1,0,0,-8,18,-4,-4,8,2,0,2,-1,1,1,-1,3,-1
KR_6766106516,420,1,-45,-2,1,2,0,2,-6,6,0,1,1,2,0,1,1,4,1,5,0,3,-7,-1,-4,5,-1,0,0,1,1,0,-1,2,-1
KR_6723802837,440,-1,-107,-4,1,-3,3,0,2,1,3,4,0,4,-3,6,3,1,1,2,0,3,4,-2,-5,7,-1,0,-2,1,-1,-1,1,6,-1
KR_6769158937,420,-3,-6,-34,-2,0,0,0,1,2,3,-3,4,1,3,1,4,-3,3,0,0,0,1,0,-6,6,-2,0,1,-1,-1,1,1,6,-1
KR_6365107014,420,-2,6,20,-4,3,1,4,1,2,3,0,3,3,-3,5,2,-5,6,1,0,-4,0,0,0,0,-6,0,0,-1,1,1,-1,5,-1
KR_6761980412,420,2,-40,6,3,4,2,6,-8,8,0,0,1,1,6,0,6,1,0,1,0,8,-40,-2,-4,6,1,0,1,0,-1,-1,-1,0,-1
KR_6753722255,420,-2,-28,-8,-10,0,1,1,-2,3,1,-2,2,0,-2,6,4,-4,4,0,0,-10,33,-3,-4,7,-27,0,1,-1,1,-1,-1,6,-1
KR_6590660918,420,-2,-64,-8,-10,-4,4,0,0,4,4,-1,3,2,-8,10,2,3,0,3,-4,-20,17,1,-4,3,0,0,-1,-1,-1,-1,-1,1,-1
KR_6724504621,420,-3,-22,-8,-11,1,1,2,-5,7,2,-1,2,1,-3,3,0,-3,4,1,0,-15,-6,-5,-2,7,-1,0,0,-1,1,-1,1,1,-1
KR_6767688945,420,-2,-27,-48,-5,-4,5,1,-5,8,3,0,0,0,3,1,4,1,0,1,0,-2,-3,1,-4,3,-2,0,-1,1,-1,-1,-1,6,-1
KR_6724186006,420,-1,1,11,-12,-7,8,1,0,3,3,0,1,1,-3,5,2,-2,3,1,-1,-13,-2,-4,-1,5,-5,0,0,-1,1,1,-1,3,-1
KR_6598672154,420,-4,-66,-32,-8,-1,2,1,-5,7,2,0,7,7,0,2,2,-2,3,1,1,-5,-8,-3,-4,7,4,0,-2,-1,-1,-1,1,1,-1
KR_6755493935,420,-1,37,-12,5,-4,4,0,2,1,3,2,4,6,5,3,8,0,1,1,0,14,-1,-2,-3,5,-5,0,0,1,0,1,1,3,-1
KR_6770461379,420,-2,-104,4,-8,-2,2,0,-2,3,1,0,1,1,-4,7,3,0,0,0,0,-6,-4,0,-5,5,-3,0,0,1,-1,0,-1,3,-1
KR_6761993304,420,-6,-71,-21,-10,-6,7,1,-4,4,0,0,2,2,0,0,0,0,1,1,-1,-7,143,3,-4,1,-3,0,-2,-1,-1,-1,-1,3,-1
KR_6736120978,420,-2,-11,-12,-4,0,1,1,-6,7,1,2,2,4,1,2,3,-1,2,1,0,-4,-5,5,-8,3,0,0,0,-1,1,1,-1,5,-1
KR_6756879153,440,3,24,-4,8,0,2,2,0,5,5,0,1,1,6,1,7,2,1,3,0,2,7,2,-5,3,5,0,1,1,-1,1,-1,5,-1
KR_6730871837,420,-3,-16,-30,-6,-3,5,2,0,2,2,1,1,2,-4,6,2,0,1,1,0,-13,238,-2,-1,3,-24,0,-1,-1,-1,-1,-1,6,-1
KR_6719651642,440,-5,-58,-40,-9,-1,1,0,-1,4,3,-2,3,1,-5,6,1,0,1,1,0,-15,201,2,-7,5,-9,0,0,-1,-1,0,-1,4,-1
KR_6740761390,440,2,-17,0,1,-3,5,2,2,2,4,-1,3,2,1,0,1,2,1,3,0,5,5,-4,-2,6,-3,0,0,1,1,0,-1,6,-1
KR_6738836436,420,-2,-1,-19,-4,-5,5,0,1,2,3,-5,6,1,5,0,5,0,2,2,4,7,-33,1,-7,6,4,0,-1,1,-1,-1,1,1,-1
KR_6761820721,420,-4,-88,-6,-7,-1,5,4,0,4,4,-6,6,0,-1,3,2,1,0,1,0,-4,-8,-2,-4,6,4,0,-1,0,-1,-1,1,0,-1
KR_6764365471,420,-3,25,-4,-4,0,0,0,3,1,4,-3,4,1,-4,4,0,0,1,1,0,-4,48,-6,-3,9,1,0,0,1,-1,0,-1,2,-1
KR_6767934636,420,-3,70,-21,-9,1,0,1,-7,8,1,-3,3,0,2,0,2,-2,3,1,0,-20,-14,-3,-4,7,-1,0,0,-1,1,-1,-1,1,-1
KR_6739125277,440,4,24,4,1,2,2,4,-2,3,1,-1,1,0,-1,2,1,3,0,3,0,-1,-9,0,-4,4,-3,0,0,0,0,0,-1,0,-1
KR_6650051784,420,-2,-60,-24,-5,-3,3,0,-2,4,2,-3,3,0,3,0,3,0,1,1,0,-1,4,1,-7,6,-4,0,-1,0,-1,-1,-1,0,-1
KR_6694423550,420,-2,-86,5,-5,0,3,3,-1,3,2,-1,4,3,-3,4,1,0,0,0,0,0,2,-1,-4,5,-4,0,-3,1,-1,-1,-1,6,-1
KR_6608000514,420,-4,-33,18,-7,-2,2,0,2,1,3,-2,3,1,-4,4,0,-1,1,0,0,-9,-22,1,-8,7,-4,0,0,1,1,-1,1,2,-1
KR_6768832800,420,-4,9,-40,-12,2,0,2,-3,5,2,-2,3,1,-5,7,2,-4,5,1,0,-12,38,-1,-4,5,-27,0,0,1,1,0,1,3,-1
KR_6752299082,420,3,30,20,6,1,2,3,1,2,3,1,1,2,3,1,4,0,1,1,0,0,4,4,-6,2,-2,0,0,1,-1,1,1,3,-1
KR_6762316738,420,-3,-35,-12,-4,-3,5,2,-2,3,1,2,1,3,-1,1,0,0,1,1,0,-4,60,1,-7,6,-10,0,-1,1,-1,-1,-1,5,-1
KR_6769958453,440,-5,16,-20,-4,1,0,1,1,1,2,-2,2,0,-3,3,0,-1,3,2,1,-3,-8,0,-3,3,-1,0,-2,-1,-1,-1,1,4,-1
KR_6662878051,420,-4,-15,-3,-2,-4,4,0,0,3,3,3,1,4,2,5,7,-3,4,1,-1,10,-30,4,-8,4,1,0,0,-1,1,0,-1,5,-1
KR_6764459026,420,-6,-54,-20,-9,1,1,2,0,2,2,-2,3,1,-9,9,0,1,0,1,0,-7,-21,3,-8,5,1,0,0,-1,0,0,-1,4,-1
KR_6740838351,440,-3,7,-28,-8,1,2,3,-1,2,1,-2,4,2,-2,5,3,-4,4,0,0,-10,-17,-5,-2,7,1,0,-1,-1,-1,-1,-1,5,-1
KR_6552307803,420,-3,-31,1,-11,-2,4,2,-3,4,1,0,1,1,-3,3,0,-3,3,0,0,-15,6,5,-11,6,-1,0,0,-1,1,0,-1,6,-1
KR_6504103714,420,-6,47,-59,-12,-4,4,0,-7,7,0,-1,2,1,1,1,2,-1,1,0,0,-5,3,7,-9,2,-1,0,0,-1,-1,0,-1,4,-1
KR_6655844519,420,-4,-6,-11,-10,1,0,1,-7,9,2,0,2,2,1,0,1,-5,8,3,0,-16,0,-5,-3,8,-2,0,0,-1,-1,-1,-1,4,-1
KR_6756000401,420,-6,-79,3,-14,0,1,1,-4,8,4,-4,5,1,-6,6,0,0,0,0,0,-23,-1,2,-8,6,0,0,0,-1,-1,-1,-1,4,-1
KR_6656149619,420,2,-48,-24,3,-2,3,1,-1,3,2,6,0,6,-1,6,5,1,3,4,0,0,-41,-3,-2,5,27,0,-2,-1,-1,-1,-1,5,-1
KR_6769241550,420,1,39,-1,5,1,3,4,-1,1,0,3,1,4,0,3,3,2,3,5,1,-2,3,4,-5,1,-5,0,1,-1,1,1,-1,6,-1
KR_6730522124,440,-3,-14,12,-12,-2,3,1,-7,9,2,2,0,2,-4,4,0,-1,2,1,0,-10,294,-2,-6,8,-3,0,-1,1,1,-1,-1,5,-1
KR_6771187434,420,-4,2,20,-15,1,1,2,-3,5,2,-6,7,1,-9,10,1,2,3,5,0,-23,-4,-3,-5,8,-1,0,-2,1,-1,-1,-1,5,-1
KR_6761779372,440,0,-6,35,-3,1,2,3,-1,5,4,1,4,5,-1,4,3,-3,4,1,-1,-4,0,-3,-6,9,6,0,-1,-1,1,-1,-1,1,-1
KR_6723791704,420,-2,-9,-27,12,0,1,1,-3,3,0,2,1,3,11,1,12,2,0,2,0,11,5,0,-4,4,2,0,-1,-1,1,-1,1,4,-1
KR_6749063483,420,3,45,-5,8,-1,1,0,0,3,3,3,1,4,1,4,5,5,1,6,1,10,-4,1,-11,10,3,0,0,-1,1,0,1,5,-1
KR_6735498369,420,-3,-13,-41,-7,2,1,3,0,3,3,-3,5,2,-4,6,2,-2,4,2,-1,-14,14,-1,-4,5,0,0,-2,-1,-1,-1,-1,6,-1
KR_6758897461,420,-2,-23,-16,-6,-2,3,1,3,1,4,-2,8,6,-5,9,4,0,0,0,0,-10,-275,2,-6,4,-3,0,0,-1,1,0,1,1,-1
KR_6729324486,420,1,35,8,5,0,1,1,3,1,4,0,1,1,2,4,6,0,1,1,1,7,-8,0,-6,6,2,0,1,-1,1,1,1,5,-1
KR_6749301152,440,-4,-18,5,-13,-5,5,0,-1,3,2,-6,6,0,-1,4,3,0,4,4,0,-18,-5,-4,-4,8,4,0,-1,1,0,-1,-1,3,-1
KR_6739278970,420,4,-42,12,2,2,2,4,1,2,3,1,3,4,-1,2,1,-1,2,1,0,-1,-44,2,-6,4,21,0,1,-1,1,1,1,6,-1
KR_6755300004,440,-1,-39,7,-7,1,1,2,-3,3,0,-1,1,0,-4,4,0,0,0,0,0,-8,-4,3,-8,5,2,0,-2,0,-1,-1,-1,0,-1
KR_6762433128,420,-2,66,20,-6,-2,2,0,-3,5,2,0,4,4,1,1,2,-2,2,0,1,-10,-7,-3,-1,4,0,0,-1,-1,1,-1,1,5,-1
KR_6748549756,420,-6,-72,-25,-15,0,2,2,-4,5,1,-4,5,1,-1,3,2,-6,7,1,0,-5,-9,-1,-3,4,-4,0,-2,-1,-1,-1,-1,3,-1
KR_6758217958,420,1,13,-6,-3,2,0,2,-2,2,0,0,2,2,1,1,2,-4,4,0,-3,-13,11,-1,-3,4,-4,0,1,-1,1,1,-1,1,-1
KR_6718910147,420,-2,-44,24,-7,-2,3,1,-4,4,0,-4,4,0,2,0,2,1,0,1,0,-2,-1,-2,-2,4,0,0,-1,1,-1,-1,1,2,-1
KR_6655416663,420,-4,-44,-36,-10,1,0,1,-7,8,1,-1,4,3,-1,1,0,-2,5,3,-1,-12,-14,-3,-4,7,1,0,-1,-1,-1,-1,-1,1,-1
KR_6743868991,440,-4,-37,-37,-11,-5,5,0,0,1,1,-4,5,1,-3,3,0,1,0,1,0,-2,9,1,-4,3,-3,0,0,-1,-1,0,-1,4,-1
KR_6757712495,420,2,8,10,-3,-3,5,2,-6,6,0,3,2,5,2,1,3,1,0,1,0,0,-369,-4,-5,9,-1,0,-3,-1,-1,-1,-1,5,-1
KR_6768740172,420,1,3,7,3,3,1,4,-8,8,0,4,0,4,3,0,3,1,0,1,0,0,200,0,-3,3,2,0,0,-1,1,0,1,4,-1
KR_6750024902,420,-4,-29,-15,-6,-5,6,1,-1,5,4,-2,4,2,-1,3,2,3,0,3,2,-7,-1,-4,-2,6,-1,0,-1,-1,-1,-1,1,2,-1
KR_6743392542,420,-3,-108,7,-5,3,0,3,1,2,3,-3,5,2,-6,7,1,0,1,1,0,-4,-93,1,-6,5,-3,0,-2,-1,1,-1,1,1,-1
KR_6739673939,420,-6,-53,-32,-6,-6,7,1,-2,4,2,4,0,4,0,1,1,-2,2,0,0,-6,-11,-1,-4,5,0,0,-2,1,-1,-1,-1,6,-1
KR_6713977553,420,-5,-64,-12,-8,-3,3,0,0,3,3,1,0,1,-5,5,0,-1,1,0,0,-10,-12,-3,-4,7,-1,0,-2,-1,1,-1,-1,4,-1
KR_6753615657,440,-2,11,1,-6,-3,3,0,-3,7,4,1,1,2,1,2,3,-2,3,1,0,-12,-9,-1,-4,5,-1,0,0,-1,-1,-1,-1,1,-1
KR_6764605302,420,-1,7,4,5,3,0,3,5,0,5,-5,5,0,1,1,2,1,0,1,0,9,6,0,-5,5,9,0,-1,1,-1,-1,1,2,-1
KR_6747313529,420,-4,-67,-37,-4,-6,7,1,1,1,2,-1,1,0,1,1,2,1,0,1,0,-3,-6,-2,-3,5,-4,0,0,-1,-1,0,1,6,-1
KR_6701378509,420,-5,-50,8,-8,-7,7,0,0,2,2,1,1,2,-2,3,1,0,3,3,0,-2,0,-1,-4,5,-4,0,0,-1,1,-1,1,4,-1
KR_6641987452,420,-4,-75,-20,-5,0,1,1,-4,5,1,1,2,3,-2,8,6,0,2,2,0,-8,1,-2,-4,6,-2,0,-1,1,1,1,-1,4,-1
KR_6676794738,420,-3,1,-1,-3,3,0,3,-3,6,3,1,1,2,-3,6,3,-1,2,1,0,-4,0,2,-9,7,-6,0,0,-1,1,0,-1,2,-1
KR_6750352358,420,0,54,-28,-1,1,2,3,0,1,1,0,3,3,-4,5,1,2,0,2,0,-4,8,-1,-3,4,3,0,-1,-1,-1,-1,-1,4,-1
KR_6767403781,420,-7,-54,-57,-14,-5,6,1,-4,6,2,-7,7,0,2,3,5,0,0,0,-2,-7,7,2,-9,7,-9,0,-2,-1,-1,-1,-1,3,-1
KR_6716419153,420,-5,-30,-37,-9,-1,3,2,-4,5,1,-5,5,0,1,2,3,0,1,1,0,-6,-4,3,-3,0,-2,0,-1,1,1,-1,1,4,-1
KR_6707382141,420,-1,-69,-20,0,1,2,3,-2,3,1,3,1,4,-5,5,0,3,0,3,-1,1,-1,-3,-2,5,-1,0,0,-1,1,-1,-1,2,-1
KR_6762439285,420,-1,-47,12,-5,2,2,4,3,1,4,-4,6,2,-3,5,2,-3,5,2,0,-4,17,1,-5,4,-5,0,-1,-1,-1,-1,-1,3,-1
KR_6736379040,420,-2,21,-10,-3,-4,6,2,2,1,3,1,1,2,-3,3,0,1,0,1,0,-3,2,2,-6,4,2,0,0,-1,-1,0,1,3,-1
KR_6726775833,420,1,47,2,0,-4,4,0,0,5,5,-1,4,3,4,2,6,1,1,2,0,11,-4,-2,-2,4,-2,0,0,-1,-1,0,1,2,-1
KR_6760217173,420,-2,-13,-8,-9,-2,3,1,0,4,4,-2,4,2,-5,6,1,0,0,0,0,-8,4,5,-8,3,-1,0,-1,-1,-1,-1,-1,1,-1
KR_6762633759,420,3,-7,-3,7,4,0,4,4,0,4,-1,1,0,0,0,0,0,0,0,0,4,-11,0,-4,4,2,0,0,1,-1,0,1,1,-1
KR_6698994183,420,-2,-43,-4,1,-1,1,0,2,5,7,-1,1,0,0,0,0,1,0,1,1,3,7,0,-5,5,3,0,0,-1,1,0,1,3,-1
KR_6759594894,440,-1,-5,32,-3,1,3,4,1,1,2,0,3,3,-5,8,3,0,2,2,0,1,-3,2,-8,6,5,0,0,-1,-1,0,1,4,-1
KR_6762459107,420,-2,-8,-43,-6,1,2,3,-1,2,1,-3,3,0,-1,4,3,-2,3,1,0,-5,5,4,-7,3,-9,0,0,-1,1,1,1,6,-1
KR_6754092189,420,3,4,-8,7,2,0,2,2,1,3,3,4,7,0,3,3,0,0,0,0,5,-5,-1,-5,6,1,0,0,-1,-1,0,-1,2,-1
KR_6748845560,420,-4,-53,-12,-5,-1,1,0,0,1,1,-2,4,2,-1,4,3,-1,2,1,0,-10,8,-1,-1,2,-1,0,0,-1,-1,0,1,3,-1
KR_6764528840,420,-3,-15,4,-13,1,1,2,-7,8,1,2,2,4,-8,9,1,-1,3,2,-3,-16,-2,-2,-2,4,-5,0,-1,-1,0,-1,-1,1,-1
KR_6760159475,420,1,16,-3,4,0,0,0,1,2,3,2,2,4,3,1,4,-2,2,0,0,7,-20,0,-5,5,1,0,0,0,-1,0,1,0,-1
KR_6759304244,420,0,-12,-10,0,0,2,2,0,6,6,-2,2,0,3,2,5,-1,2,1,0,7,-2,-4,-7,11,1,0,1,-1,1,1,-1,3,-1
KR_6739161791,420,-4,-58,-12,-8,0,0,0,-2,3,1,0,1,1,-4,5,1,-2,2,0,0,-5,-13,2,-7,5,-3,0,0,-1,-1,0,-1,4,-1
KR_6756553268,420,-1,-24,8,-1,1,0,1,-1,3,2,-3,5,2,4,1,5,-2,5,3,0,0,-21,2,-6,4,-3,0,-1,-1,-1,-1,-1,5,-1
KR_6729128520,420,0,-9,-17,3,3,0,3,1,4,5,-5,6,1,4,2,6,0,0,0,0,0,148,2,-6,4,-4,0,1,-1,1,1,1,3,-1
KR_6749786415,420,-1,-23,-8,1,-1,2,1,3,2,5,1,0,1,-3,3,0,1,1,2,0,4,5,0,-4,4,-4,0,0,-1,0,0,1,3,-1
KR_6767252891,420,-2,-11,16,-7,-4,5,1,0,1,1,6,1,7,-9,13,4,0,0,0,1,-9,2,-1,-3,4,-4,0,0,-1,1,1,1,6,-1
KR_6767240230,440,2,25,21,1,-1,2,1,8,2,10,0,1,1,-2,4,2,-4,6,2,1,3,4,-1,-5,6,-2,0,-1,0,-1,-1,1,0,-1
KR_6697878489,420,-1,-66,12,-1,-2,3,1,2,2,4,-6,6,0,5,0,5,0,1,1,0,5,-9,-3,-3,6,0,0,-1,1,-1,-1,1,2,-1
KR_6740164710,420,-8,-94,-19,-13,-4,4,0,-2,5,3,-3,3,0,-2,4,2,-2,2,0,0,-12,-11,-1,-4,5,-5,0,-3,-1,-1,-1,-1,4,-1
KR_6683482895,420,-4,-43,5,-10,-2,3,1,-2,3,1,-2,3,1,-3,5,2,-1,2,1,0,-8,0,-3,-5,8,0,0,-1,1,-1,-1,-1,1,-1
KR_6768809319,420,-3,-12,-30,-4,-1,2,1,-6,8,2,0,2,2,2,2,4,1,1,2,2,-5,27,8,-12,4,-3,0,-1,-1,-1,-1,1,2,-1
KR_6741326514,420,-1,8,-4,0,-1,2,1,-3,6,3,-1,3,2,5,0,5,0,1,1,1,1,10,2,-8,6,0,0,0,1,-1,-1,1,3,-1
KR_6749362606,420,-3,-18,-23,-4,-4,6,2,6,1,7,-4,5,1,-1,5,4,-1,1,0,0,2,-51,-3,-5,8,22,0,-1,0,-1,-1,-1,0,-1
KR_6761684788,420,2,83,4,3,0,1,1,-5,6,1,-1,3,2,7,5,12,2,1,3,0,-10,-12,-2,-3,5,7,0,1,1,1,1,-1,1,-1
KR_6732317064,420,2,18,-20,7,0,4,4,4,3,7,2,1,3,1,1,2,0,0,0,0,0,8,1,-4,3,1,0,0,-1,-1,0,-1,4,-1
KR_6753647030,440,-1,8,-24,1,-1,4,3,0,3,3,3,1,4,0,4,4,-1,3,2,0,5,36,-3,0,3,-13,0,0,-1,0,0,1,3,-1
KR_6742647810,420,2,9,22,-1,5,2,7,-3,4,1,-3,3,0,-1,1,0,1,2,3,-1,-6,-46,4,-6,2,1,0,1,-1,-1,1,-1,4,-1
KR_6757323689,420,1,-58,1,11,2,0,2,6,1,7,2,0,2,0,2,2,1,2,3,-1,8,-1,5,-6,1,2,0,-1,-1,1,-1,-1,5,-1
KR_6728060647,420,0,65,12,-2,0,0,0,0,1,1,0,4,4,-5,5,0,3,0,3,0,-6,9,4,-7,3,-5,0,0,0,1,0,1,0,-1
KR_6668080545,420,-4,10,8,-9,-2,5,3,-2,3,1,3,2,5,-7,7,0,-1,1,0,-1,-21,5,-1,-3,4,-2,0,0,-1,1,-1,1,4,-1
KR_6646401825,420,-2,-3,-32,-7,0,2,2,-5,5,0,-4,6,2,3,4,7,-1,1,0,0,-6,0,0,-5,5,-3,0,-1,-1,-1,-1,1,2,-1
KR_6582979111,420,2,-16,-4,3,9,0,9,-3,3,0,-1,2,1,-5,7,2,3,0,3,0,9,5,-5,-1,6,0,0,1,1,-1,1,1,5,-1
KR_6766638171,420,1,5,3,1,1,1,2,-1,5,4,-4,6,2,4,3,7,1,1,2,0,-6,-2,-2,-6,8,3,0,-1,1,1,-1,-1,1,-1
KR_6760903450,420,-2,-28,-16,-4,-1,2,1,-2,2,0,3,1,4,-5,7,2,1,0,1,1,-3,-43,3,-6,3,-2,0,-1,1,1,-1,1,2,-1
KR_6769506905,440,-2,-6,12,-6,1,1,2,2,1,3,-4,4,0,3,1,4,-8,10,2,0,-6,-4,-4,-4,8,-4,0,0,-1,0,0,1,4,-1
KR_6761007961,420,-4,-48,4,-12,-1,1,0,-1,1,0,-3,4,1,-1,1,0,-6,6,0,-1,-16,-9,-3,-4,7,-3,0,-2,-1,-1,-1,-1,2,-1
KR_6762877082,420,-1,26,4,3,0,1,1,-4,5,1,0,1,1,1,3,4,6,1,7,0,6,-10,2,-3,1,0,0,1,-1,-1,1,1,6,-1
KR_6739551403,420,-1,-20,-40,-4,1,1,2,-1,4,3,-4,6,2,0,4,4,0,4,4,0,4,5,2,-6,4,-4,0,0,-1,0,0,1,1,-1
KR_6768873883,420,-1,36,-2,-3,1,2,3,0,3,3,-2,3,1,-6,7,1,4,0,4,1,-8,-3,-3,-5,8,0,0,1,1,-1,-1,1,4,-1
KR_6684853130,420,-1,66,-26,2,1,1,2,3,2,5,-3,3,0,-2,6,4,3,0,3,0,3,-40,-3,-5,8,8,0,-1,-1,-1,-1,-1,1,-1
KR_6747274347,420,1,27,0,-4,3,1,4,-1,1,0,-5,6,1,-1,1,0,0,1,1,0,-7,-2,-1,-5,6,-1,0,-1,-1,-1,-1,-1,4,-1
KR_6608434724,420,-3,-1,7,-8,-3,3,0,0,0,0,-2,3,1,-2,3,1,-1,1,0,0,-9,107,-2,-5,7,-4,0,-1,-1,-1,-1,-1,1,-1
KR_6761860519,420,1,12,-16,1,3,1,4,0,6,6,-2,6,4,0,2,2,0,1,1,1,4,-18,1,-5,4,2,0,0,1,0,0,1,6,-1
KR_6762430369,420,-4,-44,-45,-5,-4,6,2,-2,3,1,-2,4,2,1,3,4,2,2,4,-1,-4,-1,4,-9,5,-1,0,-2,-1,-1,-1,-1,3,-1
KR_6763494647,440,1,-15,44,0,-10,10,0,0,3,3,-1,1,0,9,1,10,2,1,3,4,14,26,4,-7,3,-5,0,0,1,1,0,1,1,-1
KR_6762254026,440,-4,-112,-29,-10,3,0,3,1,2,3,-3,3,0,-8,8,0,-3,5,2,0,-11,17,3,-7,4,-3,0,-2,-1,-1,-1,1,2,-1
KR_6517200791,420,-5,-62,-16,-8,-8,9,1,-1,7,6,0,2,2,1,3,4,0,0,0,0,2,6,2,-6,4,-2,0,-1,-1,1,-1,1,6,-1
KR_6767952438,420,-4,-85,4,-7,-3,3,0,-5,8,3,-2,2,0,4,3,7,-1,2,1,0,1,-4,-1,-4,5,-5,0,-1,1,1,-1,-1,2,-1
KR_6767917676,420,-2,-20,12,0,-2,2,0,3,1,4,-5,7,2,3,0,3,1,0,1,0,7,22,-3,-2,5,3,0,-1,-1,1,-1,-1,4,-1
KR_6756523009,420,-4,-20,-11,-1,1,0,1,2,1,3,-1,1,0,-3,3,0,0,0,0,0,-4,0,2,-6,4,-3,0,-1,-1,-1,-1,1,6,-1
KR_6686221568,420,1,-40,28,-1,-3,5,2,0,3,3,1,0,1,0,0,0,1,0,1,1,3,-83,1,-6,5,-2,0,-1,0,1,-1,1,0,-1
KR_6719745440,420,-7,-100,-27,-10,-2,2,0,-5,6,1,-3,7,4,0,2,2,0,1,1,-1,-10,-26,3,-7,4,-31,0,-4,-1,-1,-1,-1,2,-1
KR_6737944865,420,-2,-56,-13,-3,-2,3,1,-3,6,3,0,1,1,0,3,3,2,0,2,0,6,2,4,-5,1,-3,0,0,1,-1,0,-1,6,-1
KR_6760529419,420,0,-39,16,0,-1,1,0,-2,3,1,0,1,1,3,6,9,0,0,0,0,-2,22,-2,-7,9,-4,0,-1,1,-1,-1,-1,4,-1
KR_6726508303,420,-2,-36,-36,-4,0,2,2,1,1,2,-3,4,1,-3,4,1,1,0,1,-2,-8,14,0,-5,5,2,0,-3,-1,-1,-1,-1,5,-1
KR_6769486672,420,-7,-97,-40,-16,-3,3,0,-1,4,3,-7,8,1,-2,3,1,-3,4,1,-2,-8,-6,-3,-2,5,-8,0,-3,-1,-1,-1,-1,2,-1
KR_6768404555,440,2,23,-8,8,-3,5,2,4,2,6,1,0,1,7,2,9,-1,2,1,0,12,1,2,-3,1,-3,0,0,-1,1,1,1,4,-1
KR_6769983791,420,1,18,11,4,-2,3,1,0,3,3,1,1,2,3,0,3,2,0,2,0,9,-4,0,-6,6,1,0,-1,1,-1,-1,1,1,-1
KR_6694008891,440,1,34,-3,-5,-5,5,0,-2,4,2,4,2,6,-2,4,2,0,0,0,0,0,1,-2,-4,6,1,0,0,0,-1,0,1,0,-1
KR_6762389947,420,0,-72,12,3,-1,2,1,2,1,3,0,0,0,0,2,2,2,0,2,0,3,15,-1,-2,3,0,0,-1,1,1,-1,-1,1,-1
KR_6753105331,420,0,-19,-1,-3,1,0,1,-7,8,1,0,2,2,3,0,3,0,0,0,-1,3,0,2,-6,4,-2,0,0,0,-1,0,-1,0,-1
KR_6598245080,420,-1,-74,17,5,-1,2,1,1,3,4,0,3,3,4,3,7,1,1,2,0,4,36,6,-8,2,0,0,1,1,1,1,1,4,-1
KR_6765534134,420,0,-50,10,-3,-4,6,2,-4,5,1,-2,2,0,6,1,7,1,1,2,0,-7,-6,1,-5,4,1,0,0,-1,-1,0,1,2,-1
KR_6760687465,420,3,38,17,5,0,2,2,0,1,1,5,3,8,0,3,3,0,1,1,0,-1,4,0,-2,2,-2,0,0,-1,-1,1,-1,1,-1
KR_6689744296,420,-7,-71,-1,-14,-1,3,2,-2,2,0,-4,4,0,-3,4,1,-4,4,0,0,-17,-8,1,-5,4,-4,0,-2,-1,-1,-1,-1,1,-1
KR_6683184778,420,-2,-46,-10,-2,-3,3,0,5,2,7,-2,4,2,-2,4,2,0,2,2,0,-3,-10,3,-8,5,-4,0,-1,-1,1,-1,-1,6,-1
KR_6753539887,420,3,-5,11,8,2,2,4,-1,5,4,5,1,6,4,1,5,-2,2,0,0,6,8,0,-5,5,-1,0,2,1,1,1,-1,3,-1
KR_6698363597,420,2,22,57,-2,-2,3,1,-3,5,2,2,4,6,1,3,4,0,1,1,1,-2,155,-2,-4,6,3,0,1,-1,-1,1,1,5,-1
KR_6726202726,440,-1,23,-20,1,2,2,4,-1,4,3,-1,2,1,-1,5,4,2,0,2,1,7,1,3,-7,4,3,0,0,1,1,1,1,5,-1
KR_6770000479,420,-5,-26,-26,-4,-1,4,3,0,1,1,-3,3,0,0,4,4,0,0,0,0,1,4,0,-6,6,-2,0,-3,0,-1,-1,1,0,-1
KR_6739343493,420,0,3,-8,1,-1,4,3,-1,4,3,-1,2,1,6,1,7,-2,2,0,0,2,-3,1,-5,4,0,0,0,1,0,-1,1,2,-1
KR_6663141038,420,-2,-24,-1,-6,1,0,1,-3,4,1,0,2,2,-3,3,0,-1,2,1,0,-4,-10,0,-4,4,-3,0,-2,-1,1,-1,-1,6,-1
KR_6767016592,420,0,-15,-7,2,-2,2,0,1,4,5,-1,3,2,3,1,4,1,0,1,0,6,-120,1,-7,6,-2,0,0,-1,1,0,-1,3,-1
KR_6764467727,420,0,-4,-1,-5,-4,7,3,-5,6,1,4,0,4,2,2,4,-2,2,0,-1,-1,0,-3,-1,4,5,0,-2,1,-1,-1,-1,1,-1
KR_6432125059,420,0,-94,0,2,0,1,1,-1,3,2,3,1,4,-2,2,0,2,1,3,0,0,-31,-2,-3,5,22,0,0,-1,1,-1,-1,3,-1
KR_6595877265,420,-1,71,-16,-11,-7,8,1,2,2,4,1,1,2,-7,9,2,0,2,2,-2,-12,-9,6,-11,5,-2,0,0,0,-1,0,1,0,-1
KR_6601314723,420,-3,-55,-16,-4,2,0,2,1,3,4,-2,3,1,-4,5,1,-1,1,0,0,-8,-11,-1,-4,5,3,0,0,-1,1,0,1,6,-1
KR_6746088426,420,-1,27,12,4,1,1,2,-1,2,1,-1,2,1,6,1,7,-1,2,1,0,-1,-7,-4,-2,6,7,0,0,1,1,0,1,4,-1
KR_6769456353,420,-3,-43,12,-9,-5,5,0,-6,9,3,0,1,1,-1,3,2,3,0,3,0,-9,49,4,-7,3,-29,0,-1,-1,-1,-1,1,2,-1
KR_6630480651,420,-1,-7,12,-2,-1,1,0,-2,5,3,1,4,5,2,1,3,-2,2,0,0,0,-13,-2,-8,10,0,0,0,1,-1,0,-1,3,-1
KR_6761172278,420,0,-18,-4,5,-3,3,0,1,2,3,5,1,6,2,0,2,0,1,1,0,9,-109,-1,-4,5,5,0,0,1,1,-1,-1,6,-1
KR_6663907817,420,2,47,-7,-3,-1,3,2,0,1,1,-3,4,1,-1,2,1,2,0,2,0,-3,-1,-6,-3,9,3,0,-1,1,-1,-1,-1,6,-1
KR_6626335414,420,-1,-28,-28,3,-3,3,0,3,2,5,1,2,3,2,2,4,0,0,0,0,2,-1,3,-4,1,-3,0,0,1,0,0,1,5,-1
KR_6738781190,420,-1,-24,-4,-3,1,0,1,-1,4,3,-3,3,0,1,3,4,-1,3,2,0,1,1,2,-4,2,-3,0,0,-1,1,-1,-1,5,-1
KR_6757863461,440,-3,-48,-21,-4,-1,2,1,0,1,1,1,0,1,-3,6,3,-1,2,1,0,0,-6,-1,-5,6,-4,0,0,-1,1,0,-1,5,-1
KR_6740040327,420,1,-74,24,-1,0,0,0,0,2,2,0,1,1,0,2,2,-1,1,0,0,-4,4,0,-3,3,5,0,0,0,0,0,-1,0,-1
KR_6762244594,420,-6,-87,-12,-18,2,0,2,-5,5,0,-11,11,0,-2,3,1,-2,2,0,-1,-16,-4,-3,-1,4,-4,0,-3,0,-1,-1,-1,0,-1
KR_6769494357,420,-2,11,-13,-1,-3,3,0,3,3,6,2,2,4,0,3,3,-3,4,1,0,13,3,3,-8,5,-2,0,1,1,1,1,-1,3,-1
KR_6754827424,420,3,28,6,3,-1,1,0,3,0,3,3,1,4,1,2,3,-3,5,2,0,7,-4,-3,-4,7,1,0,0,-1,-1,-1,1,3,-1
KR_6758996185,440,-1,8,-16,-3,-4,5,1,0,4,4,0,3,3,1,2,3,0,1,1,0,-4,2,1,-7,6,-3,0,1,1,1,1,-1,3,-1
KR_6760747166,420,-3,-9,-8,-7,-1,2,1,-5,6,1,2,1,3,-2,3,1,-1,2,1,0,-7,-2,-1,-5,6,-3,0,-1,-1,-1,-1,-1,3,-1
KR_6771230187,420,-2,-72,-8,-7,-3,5,2,1,0,1,-2,2,0,-3,5,2,0,0,0,0,-5,7,2,-5,3,1,0,-1,1,-1,-1,-1,2,-1
KR_6767180817,420,0,-18,-12,2,2,2,4,2,1,3,-2,2,0,1,2,3,-1,1,0,0,4,8,-2,-5,7,-4,0,-1,-1,1,-1,1,2,-1
KR_6760369231,420,0,-13,-5,-1,-1,2,1,2,4,6,1,1,2,-3,6,3,0,1,1,1,3,-10,1,-3,2,-3,0,0,1,-1,0,-1,3,-1
KR_6690442078,420,-1,13,-8,-4,4,0,4,-3,3,0,1,3,4,-1,2,1,-5,5,0,0,-7,9,4,-9,5,-3,0,-1,-1,-1,-1,-1,5,-1
KR_6752297018,420,-5,-52,-40,-5,-4,4,0,0,4,4,6,1,7,-5,7,2,-2,2,0,0,-7,22,7,-10,3,-4,0,-1,-1,1,-1,1,6,-1
KR_6728322716,420,-3,12,16,-10,-2,3,1,-3,5,2,0,1,1,-4,7,3,-1,2,1,0,-9,36,5,-8,3,-14,0,-1,1,1,-1,-1,5,-1
KR_6751221843,420,-2,-37,-16,-6,-5,5,0,1,3,4,1,2,3,-5,6,1,2,0,2,0,-7,-1,-3,-4,7,1,0,-1,-1,-1,-1,-1,2,-1
KR_6644399877,420,-1,34,9,1,-2,2,0,1,3,4,2,2,4,-1,1,0,1,0,1,0,-8,-5,0,-3,3,1,0,2,1,1,1,-1,2,-1
KR_6731500301,440,-4,-37,-55,-8,-1,1,0,-2,3,1,-3,5,2,-1,6,5,-1,3,2,0,2,6,5,-8,3,-2,0,-2,-1,-1,-1,-1,3,-1
KR_6607539133,420,-6,-89,-8,-11,-2,3,1,0,1,1,-6,7,1,-2,2,0,-1,2,1,1,-12,0,0,-7,7,-6,0,-3,-1,-1,-1,1,4,-1
KR_6747131490,420,-1,55,-36,8,0,1,1,2,1,3,-1,3,2,6,1,7,1,4,5,1,6,3,6,-7,1,-5,0,1,-1,-1,1,1,4,-1
KR_6760667743,420,0,25,-27,-8,4,1,5,-2,2,0,-6,6,0,-4,4,0,0,1,1,0,-6,3,-1,-5,6,4,0,0,-1,1,-1,-1,6,-1
KR_6721217208,420,0,24,17,-3,-3,4,1,-5,7,2,0,2,2,4,0,4,1,1,2,1,0,41,0,-4,4,-16,0,-1,1,-1,-1,1,4,-1
KR_6766439189,420,-3,9,-31,-10,0,2,2,-5,5,0,-4,6,2,-1,2,1,0,0,0,0,-7,7,-5,-2,7,-3,0,-1,1,-1,-1,1,5,-1
KR_6769899392,420,-4,-17,-16,-9,-6,6,0,-6,6,0,0,2,2,-1,2,1,4,0,4,0,-3,-1,-4,-4,8,3,0,-1,0,-1,-1,-1,0,-1
KR_6760500153,440,-5,-56,-9,-11,-1,4,3,-4,6,2,-3,5,2,-2,2,0,-1,1,0,0,-8,11,6,-7,1,-6,0,0,0,1,-1,-1,0,-1
KR_6766432129,420,-3,-25,-4,-6,1,0,1,-1,2,1,1,1,2,-4,5,1,-3,4,1,0,-11,-15,6,-6,0,-5,0,-1,-1,0,-1,-1,5,-1
KR_6766801929,420,-4,-56,12,-7,-1,5,4,-4,4,0,-1,1,0,1,4,5,-2,2,0,0,-9,116,-2,-6,8,-2,0,-1,-1,1,-1,-1,6,-1
KR_6721528592,420,2,14,-6,1,-2,5,3,0,7,7,-2,3,1,0,3,3,5,0,5,0,12,7,3,-5,2,-2,0,-1,1,-1,-1,-1,6,-1
KR_6737846346,420,3,4,47,7,0,2,2,2,3,5,5,0,5,0,3,3,0,0,0,0,9,-8,-7,-4,11,1,0,1,1,-1,1,1,6,-1
KR_6769667190,420,-3,32,-16,-9,-1,3,2,-3,4,1,-2,3,1,-6,6,0,3,0,3,0,-10,-5,-5,-3,8,2,0,-1,-1,-1,-1,1,1,-1
KR_6749766951,420,-2,-29,6,-9,1,1,2,-2,2,0,-2,3,1,-6,6,0,0,1,1,-1,-18,307,0,-3,3,-3,0,-1,-1,1,-1,-1,3,-1
KR_6728221536,440,-5,44,-40,-6,2,0,2,-1,1,0,-3,5,2,-5,6,1,1,1,2,0,-5,27,4,-7,3,-2,0,0,-1,-1,-1,1,1,-1
KR_6728598252,420,-2,-77,-13,-2,-1,2,1,2,2,4,0,2,2,-2,3,1,-1,1,0,0,3,-49,0,-7,7,20,0,-3,-1,-1,-1,1,3,-1
KR_6765718125,420,1,27,12,0,0,3,3,0,5,5,-1,3,2,0,2,2,1,0,1,-1,-2,-257,3,-6,3,-1,0,0,0,-1,0,-1,0,-1
KR_6758833259,420,0,44,24,5,-3,3,0,3,1,4,3,0,3,3,7,10,-1,1,0,-1,5,-3,4,-7,3,5,0,2,1,1,1,-1,6,-1
KR_6759312240,420,-2,-33,-5,-7,-1,3,2,-1,3,2,-5,6,1,0,3,3,0,1,1,0,-16,1,-2,-3,5,-1,0,0,-1,-1,-1,-1,6,-1
KR_6756281826,420,-2,14,1,-5,4,1,5,-5,5,0,-3,3,0,-1,2,1,0,0,0,0,-6,6,4,-6,2,0,0,3,1,1,1,1,3,-1
KR_6683691615,440,-2,-63,-4,-2,-3,3,0,-2,4,2,1,3,4,0,1,1,2,0,2,0,0,-6,-4,-3,7,-2,0,-1,-1,0,-1,-1,3,-1
KR_6627646554,420,-4,-62,-7,-17,-7,8,1,-5,8,3,-4,5,1,-1,5,4,0,1,1,0,-11,-22,0,-6,6,-1,0,-2,-1,-1,-1,-1,5,-1
KR_6690744813,420,-1,-51,0,-2,-1,4,3,-4,5,1,5,1,6,-2,2,0,0,0,0,0,1,-4,3,-5,2,0,0,0,-1,1,0,-1,3,-1
KR_6743164367,420,-4,-8,-17,-8,-2,4,2,-2,2,0,5,0,5,-1,2,1,-8,8,0,-1,-14,-1,4,-8,4,-1,0,0,-1,-1,1,-1,3,-1
KR_6579169342,420,1,-3,0,0,0,1,1,7,2,9,-1,2,1,-5,6,1,-1,1,0,-1,-6,12,1,-7,6,5,0,0,1,0,0,-1,5,-1
KR_6770096292,440,-1,-18,13,-4,-2,4,2,-3,4,1,4,1,5,-3,7,4,0,1,1,1,-6,98,-8,0,8,0,0,1,1,0,-1,1,1,-1
KR_6764389973,420,0,-16,-8,6,2,0,2,1,0,1,2,0,2,5,1,6,-4,4,0,0,3,2,0,-5,5,1,0,-2,1,-1,-1,1,2,-1
KR_6758760436,420,-4,-75,-23,-12,-1,2,1,-1,2,1,-6,10,4,-3,4,1,-1,1,0,0,-17,23,-5,-1,6,-2,0,-2,-1,-1,-1,-1,4,-1
KR_6747963047,440,-3,-25,-25,-7,1,1,2,-4,6,2,-2,2,0,-1,3,2,-1,1,0,0,-9,-9,-1,-4,5,-1,0,-2,-1,-1,-1,1,6,-1
KR_6742531639,420,-3,13,9,-9,5,0,5,-5,7,2,-8,8,0,-1,1,0,0,1,1,0,-13,6,-1,-2,3,-2,0,0,-1,-1,1,1,3,-1
KR_6765855039,420,1,-25,-12,-5,4,0,4,0,2,2,-1,3,2,-4,4,0,-4,7,3,0,-5,-29,-4,-3,7,1,0,0,-1,1,1,-1,2,-1
KR_6757099922,420,-4,19,-26,-4,-1,3,2,3,2,5,-1,4,3,-5,6,1,0,1,1,0,-7,15,4,-8,4,-3,0,-1,1,1,1,-1,1,-1
