matchId,queueId,Diff_LV,Diff_CS,Diff_jglCS,Diff-K,Diff-K-top,K-WIN-top,K-LOSE-top,Diff-K-jug,K-WIN-jug,K-LOSE-jug,Diff-K-mid,K-WIN-mid,K-LOSE-mid,Diff-K-ad,K-WIN-ad,K-LOSE-ad,Diff-K-sup,K-WIN-sup,K-LOSE-sup,invadeKill,Diff-A,Diff_WARDplaced,Diff-ControlWARDplaced,LOSE_controlWARDPlaced,WIN_controlWARDPlaced,Diff_WARDkill,Diff_Inhibitor,Diff_TOWERkill,Diff_FirstDRAGON,Diff_FirstHERALD,Diff_Firsttower,Diff_FirstBLOOD,dragonType,result
KR_6730710938,420,-2,-33,8,-5,0,1,1,-3,4,1,0,3,3,-2,2,0,0,1,1,0,-12,6,0,-6,6,-3,0,0,-1,-1,-1,1,4,-1
KR_6683981697,420,0,-12,16,-4,3,0,3,-1,4,3,-4,4,0,-2,3,1,0,0,0,0,-7,5,0,-4,4,-3,0,0,1,-1,0,1,3,-1
KR_6766548469,440,-3,-65,-4,-7,-1,3,2,-2,2,0,-1,3,2,3,1,4,-6,6,0,0,-7,-2,-1,-2,3,-1,0,-2,-1,-1,-1,-1,3,-1
KR_6731880744,420,1,37,-14,0,0,0,0,-3,6,3,0,2,2,3,0,3,0,1,1,0,0,3,2,-5,3,4,0,0,1,-1,0,1,3,-1
KR_6768370589,420,-4,11,12,-11,0,1,1,-3,3,0,-4,6,2,-3,3,0,-1,2,1,0,-14,2,-3,-6,9,-3,0,-1,-1,1,-1,-1,3,-1
KR_6680741395,420,-6,-69,-28,-13,-5,5,0,-4,4,0,-4,4,0,-1,3,2,1,1,2,0,-7,-182,3,-4,1,-1,0,-1,-1,-1,-1,-1,5,-1
KR_6683059674,420,-3,-59,-52,-5,-6,6,0,-2,5,3,1,2,3,3,0,3,-1,3,2,0,-6,-219,-1,-3,4,1,0,-1,1,-1,-1,1,6,-1
KR_6671770719,420,-5,-107,-11,-10,-4,4,0,-2,3,1,-3,4,1,2,0,2,-3,3,0,0,-15,-38,-3,-6,9,0,0,-1,-1,-1,-1,-1,4,-1
KR_6665364804,420,0,48,20,2,3,1,4,0,1,1,-4,5,1,2,2,4,1,0,1,0,0,8,8,-9,1,0,0,0,1,1,0,1,4,-1
KR_6718454776,420,1,18,-19,-1,-1,2,1,-1,3,2,4,0,4,-2,6,4,-1,2,1,0,-3,-6,-2,-4,6,-4,0,-1,-1,-1,-1,-1,6,-1
KR_6743732471,420,1,59,-8,-1,-4,5,1,2,1,3,2,1,3,-1,3,2,0,1,1,0,1,6,3,-7,4,4,0,-1,-1,-1,-1,1,1,-1
KR_6694339689,420,2,12,-10,8,-3,6,3,0,5,5,4,0,4,3,0,3,4,0,4,0,10,16,2,-6,4,-1,0,-1,1,-1,1,-1,1,-1
KR_6601316137,440,3,-5,-12,-2,0,1,1,-1,7,6,2,1,3,-2,4,2,-1,2,1,0,-2,18,-1,-3,4,-29,0,-1,-1,-1,-1,1,1,-1
KR_6756404401,420,1,-33,10,7,-5,5,0,4,4,8,5,0,5,2,2,4,1,2,3,2,10,19,3,-5,2,2,0,0,1,-1,-1,1,3,-1
KR_6659685819,420,3,3,-20,10,1,0,1,1,3,4,2,0,2,4,0,4,2,0,2,0,15,-2,-6,-2,8,3,0,-1,-1,-1,-1,-1,3,-1
KR_6768476432,420,-3,-60,-34,-8,-3,6,3,-4,5,1,0,2,2,-3,5,2,2,1,3,-1,-13,-32,-2,-4,6,-1,0,0,-1,-1,0,-1,4,-1
KR_6768998130,420,-2,10,-34,-2,2,0,2,-1,3,2,-2,5,3,-3,4,1,2,0,2,0,4,217,-5,-1,6,4,0,0,-1,-1,-1,-1,1,-1
KR_6759866684,440,0,-5,4,3,0,2,2,1,1,2,-1,3,2,3,2,5,0,0,0,0,2,-3,-3,-4,7,-3,0,-1,1,-1,-1,1,3,-1
KR_6743103916,420,-3,-32,10,-6,-4,4,0,0,1,1,1,2,3,-4,4,0,1,0,1,0,-2,7,1,-5,4,0,0,0,-1,-1,-1,-1,4,-1
KR_6764510016,420,-2,14,-24,-5,3,0,3,0,5,5,-2,4,2,-6,9,3,0,2,2,0,-12,0,0,-8,8,-3,0,-2,1,-1,-1,-1,6,-1
KR_6700067444,420,-3,-58,32,-9,-5,6,1,0,1,1,0,2,2,0,1,1,-4,4,0,0,-3,4,4,-6,2,-3,0,-1,1,1,-1,-1,4,-1
KR_6765076054,420,-1,5,-11,4,2,1,3,1,2,3,-3,3,0,3,0,3,1,0,1,0,7,-4,1,-8,7,-2,0,1,-1,1,1,-1,1,-1
KR_6767517756,420,-4,-11,-16,-7,-5,5,0,4,0,4,-1,1,0,-4,4,0,-1,2,1,0,-3,-2,-3,-5,8,-1,0,0,-1,-1,0,-1,1,-1
KR_6730413600,420,-1,0,-8,-6,-2,2,0,-7,8,1,1,1,2,1,2,3,1,0,1,0,-7,94,-1,-3,4,-1,0,-1,0,-1,-1,-1,0,-1
KR_6768850430,420,-1,-46,20,4,-3,4,1,0,3,3,3,1,4,4,1,5,0,1,1,0,7,64,2,-7,5,0,0,-1,1,1,-1,1,1,-1
KR_6745586170,420,-2,-2,-10,-12,1,0,1,-1,2,1,-6,7,1,-5,7,2,-1,1,0,0,-21,-28,-1,-5,6,-1,0,-1,-1,-1,-1,-1,1,-1
KR_6753825650,420,3,74,10,2,-1,2,1,1,1,2,-1,2,1,0,2,2,3,1,4,0,0,-5,1,-5,4,3,0,1,1,0,1,1,6,-1
KR_6768502221,420,-1,20,-32,-3,1,2,3,-5,6,1,-3,5,2,3,2,5,1,0,1,-2,-7,-14,-3,-2,5,6,0,0,-1,-1,-1,1,1,-1
KR_6768930473,420,0,29,-8,5,2,0,2,-3,7,4,3,2,5,3,1,4,0,0,0,0,7,-34,-1,-2,3,21,0,-1,1,-1,-1,-1,4,-1
KR_6752317497,420,2,-2,32,3,3,0,3,-2,3,1,0,1,1,2,3,5,0,0,0,0,0,-1,-3,-4,7,1,0,0,1,1,0,-1,3,-1
KR_6680519754,420,0,11,2,5,1,2,3,6,2,8,-1,1,0,0,4,4,-1,2,1,0,9,-1,2,-7,5,9,0,0,0,1,0,1,0,-1
KR_6499338891,420,-1,4,-46,-4,-6,6,0,0,1,1,2,0,2,0,0,0,0,2,2,0,1,5,3,-5,2,-2,0,0,-1,-1,-1,1,4,-1
KR_6660300569,440,0,-85,16,-2,5,0,5,-3,4,1,-2,5,3,-2,2,0,0,0,0,-1,-2,95,-2,-3,5,1,0,1,-1,-1,1,-1,5,-1
KR_6438848118,420,-2,-39,24,-4,-1,3,2,-2,3,1,-1,3,2,-1,2,1,1,0,1,0,-9,-4,1,-5,4,1,0,-1,-1,1,-1,-1,2,-1
KR_6750171559,420,-2,-80,-19,-3,-2,3,1,2,0,2,1,1,2,-3,4,1,-1,1,0,0,-4,-150,1,-3,2,2,0,0,-1,0,-1,1,3,-1
KR_6766594747,420,1,34,-76,3,0,1,1,-1,2,1,4,1,5,1,0,1,-1,4,3,0,2,0,0,-3,3,2,0,0,0,-1,-1,-1,0,-1
KR_6746817966,420,-3,9,-9,-5,3,1,4,-3,4,1,1,1,2,-6,8,2,0,1,1,0,-8,118,4,-10,6,0,0,0,-1,1,1,1,6,-1
KR_6748704545,420,0,7,4,2,3,1,4,-6,7,1,3,0,3,0,1,1,2,2,4,-1,-3,-106,3,-7,4,0,0,2,-1,1,1,-1,4,-1
KR_6711038109,420,-1,0,20,-8,-1,2,1,-1,2,1,-4,7,3,-2,5,3,0,4,4,0,-14,3,-2,-4,6,1,0,0,-1,-1,-1,1,6,-1
KR_6759540809,440,-2,10,-4,-7,1,2,3,-3,3,0,3,1,4,-1,2,1,-7,7,0,0,-6,-1,4,-10,6,-6,0,-1,-1,1,-1,-1,5,-1
KR_6622321956,420,-4,10,-13,-6,-2,4,2,0,2,2,-4,4,0,-2,2,0,2,1,3,0,-5,-1,5,-7,2,-3,0,0,-1,1,0,-1,3,-1
KR_6698384115,420,-1,-7,-11,-2,0,2,2,-3,5,2,-3,3,0,4,0,4,0,0,0,1,6,40,2,-5,3,-2,0,-2,1,-1,-1,1,2,-1
KR_6636533773,420,-2,-16,-16,-4,-1,3,2,0,4,4,-1,1,0,-2,2,0,0,0,0,0,-7,-7,-1,-5,6,-1,0,0,1,-1,0,1,3,-1
KR_6732912973,420,-2,-2,-1,-11,-2,2,0,3,5,8,-3,3,0,-8,8,0,-1,1,0,0,-12,-6,-6,-2,8,1,0,0,-1,1,-1,-1,5,-1
KR_6747780436,420,-1,13,-6,-2,-3,3,0,2,0,2,-1,1,0,-1,2,1,1,0,1,0,-1,120,4,-8,4,3,0,0,-1,-1,0,1,6,-1
KR_6643513999,420,-5,-54,-11,-4,-2,2,0,-2,6,4,4,2,6,-2,3,1,-2,5,3,0,-13,-5,1,-9,8,2,0,-1,1,1,-1,-1,5,-1
KR_6768489580,420,-5,-39,-27,-11,-3,6,3,-1,3,2,-4,4,0,-2,4,2,-1,1,0,0,-2,2,0,-3,3,1,0,-1,0,-1,-1,1,0,-1
KR_6732488758,420,-4,-8,-10,-7,1,0,1,-4,6,2,-2,3,1,-1,2,1,-1,2,1,0,-1,36,-2,-2,4,-2,0,-1,-1,-1,-1,-1,1,-1
KR_6657132365,420,-4,-17,-25,-8,-3,4,1,2,2,4,-2,3,1,-5,5,0,0,0,0,0,-3,0,2,-8,6,-4,0,-1,1,0,-1,1,2,-1
KR_6442691873,420,0,-15,-21,-8,-5,6,1,-1,3,2,4,0,4,-4,4,0,-2,3,1,-1,2,-26,-4,-5,9,0,0,-1,1,-1,-1,-1,3,-1
KR_6768489950,420,-4,-18,8,-6,-5,6,1,0,2,2,3,4,7,-3,3,0,-1,1,0,0,-4,1,4,-8,4,-6,0,1,1,1,-1,1,1,-1
KR_6651727903,420,-7,-8,-21,-17,-3,3,0,-9,10,1,-6,7,1,-1,2,1,2,1,3,0,-11,-110,0,-5,5,2,0,-1,-1,-1,-1,-1,6,-1
KR_6739603337,420,-3,-15,-16,-6,-1,3,2,1,5,6,0,3,3,-2,4,2,-4,5,1,0,-2,240,-5,0,5,23,0,0,1,0,0,-1,1,-1
KR_6736659803,420,-4,-45,-10,-8,-2,3,1,-1,5,4,-1,6,5,-4,6,2,0,1,1,1,-2,-8,-1,-2,3,1,0,-1,1,0,-1,1,2,-1
KR_6679061859,420,-6,-58,-28,-19,-5,5,0,-1,3,2,-4,5,1,-10,11,1,1,0,1,-1,-17,42,-1,-3,4,-31,0,-2,-1,0,-1,-1,2,-1
KR_6573478776,420,-3,-65,-52,-9,-1,1,0,-2,4,2,-1,2,1,-4,4,0,-1,1,0,0,-8,4,1,-4,3,2,0,-1,-1,1,-1,-1,4,-1
KR_6768048190,420,-1,-3,17,-2,-2,4,2,0,2,2,3,2,5,0,4,4,-3,3,0,0,3,-199,-1,-4,5,-1,0,-2,1,-1,-1,-1,3,-1
KR_6744222535,420,0,1,-35,0,-1,3,2,2,1,3,-5,5,0,1,1,2,3,1,4,1,-1,3,3,-5,2,-4,0,0,-1,-1,0,1,5,-1
KR_6763034783,420,-3,-7,-8,-4,3,3,6,-4,5,1,-2,2,0,-1,1,0,0,0,0,0,-2,-2,-2,-1,3,-4,0,0,-1,1,1,1,3,-1
KR_6603525765,420,-4,-45,-47,-5,0,1,1,-3,6,3,1,2,3,-2,2,0,-1,1,0,0,-5,-2,-2,-5,7,1,0,0,-1,0,0,-1,1,-1
KR_6748589592,440,-3,-29,-4,0,-2,2,0,0,3,3,1,3,4,-1,1,0,2,4,6,1,12,214,-6,-2,8,0,0,0,1,1,-1,1,5,-1
KR_6749825573,420,-3,-84,-9,-3,-3,5,2,3,0,3,-5,7,2,1,5,6,1,0,1,-2,6,-3,-3,-3,6,-1,0,-3,1,-1,-1,-1,3,-1
KR_6726185799,420,-3,-64,-12,-1,-1,1,0,3,2,5,1,0,1,-3,6,3,-1,4,3,0,4,1,1,-5,4,2,0,0,1,1,-1,-1,4,-1
KR_6743739236,420,-9,-115,13,-16,-5,5,0,1,3,4,-4,4,0,-8,9,1,0,0,0,0,-23,-6,-3,-3,6,0,0,-3,-1,-1,-1,-1,2,-1
KR_6762014512,420,0,-20,-20,1,4,1,5,1,2,3,-3,5,2,0,2,2,-1,1,0,0,4,104,2,-5,3,-5,0,0,-1,-1,0,1,2,-1
KR_6209545153,420,-4,-15,-44,-9,-4,5,1,-4,5,1,5,0,5,-5,10,5,-1,3,2,0,-8,-14,-3,-7,10,-5,0,-3,-1,-1,-1,-1,3,-1
KR_6679931893,440,0,-69,12,-7,-1,3,2,0,1,1,2,0,2,-7,7,0,-1,2,1,0,-12,40,-1,-5,6,-5,0,-2,-1,1,-1,-1,2,-1
KR_6489767124,420,-1,-4,20,-4,0,0,0,-1,1,0,-4,5,1,-1,4,3,2,0,2,0,-5,-2,-3,-3,6,0,0,0,-1,1,0,-1,4,-1
KR_6751664838,420,-1,-28,-22,2,-3,3,0,2,0,2,5,3,8,-2,2,0,0,2,2,0,2,-13,1,-5,4,0,0,-1,-1,-1,1,1,2,-1
KR_6734654425,420,2,-32,4,2,1,1,2,3,0,3,2,1,3,-1,3,2,-3,3,0,-1,3,9,1,-4,3,-2,0,0,-1,1,-1,1,4,-1
KR_6704227253,420,-1,8,-19,-1,-5,6,1,-1,4,3,3,2,5,3,3,6,-1,1,0,-1,6,5,9,-11,2,-2,0,0,-1,0,0,-1,4,-1
KR_6457590991,420,1,25,3,-3,-2,4,2,-1,2,1,1,1,2,-2,3,1,1,0,1,-1,-5,1,-1,-4,5,2,0,0,0,1,-1,-1,0,-1
KR_6766181593,420,-2,-39,-3,-6,1,2,3,0,3,3,0,3,3,-5,5,0,-2,3,1,0,-9,172,-4,-3,7,3,0,-2,-1,-1,-1,1,5,-1
KR_6754078069,440,-3,-21,-5,-5,-1,3,2,-6,7,1,0,3,3,2,2,4,0,3,3,0,-1,11,1,-7,6,2,0,0,-1,-1,-1,-1,6,-1
KR_6641608943,420,-3,-44,-17,-8,-5,6,1,3,3,6,-4,5,1,0,0,0,-2,2,0,0,-8,267,-5,-6,11,-8,0,-1,-1,-1,-1,-1,1,-1
KR_6755962668,420,-5,-39,-31,-12,-4,4,0,-6,6,0,0,0,0,-2,2,0,0,0,0,0,-15,12,0,-5,5,0,0,-1,-1,-1,-1,1,1,-1
KR_6743370408,420,-2,-18,-20,-4,-2,4,2,1,4,5,0,3,3,-2,4,2,-1,2,1,-1,-9,2,4,-6,2,-3,0,0,-1,-1,-1,-1,4,-1
KR_6768958799,420,-2,-16,-16,-6,0,2,2,0,1,1,1,1,2,-5,5,0,-2,2,0,0,-6,33,2,-3,1,-15,0,-1,-1,1,-1,1,3,-1
KR_6683593155,420,-3,-37,40,-4,-1,2,1,-1,2,1,-6,6,0,0,1,1,4,0,4,0,-8,0,-1,-5,6,-3,0,0,1,1,1,-1,5,-1
KR_6722916672,420,-2,-46,28,-6,0,3,3,-4,8,4,-3,7,4,3,3,6,-2,2,0,0,-5,-183,-4,-4,8,-1,0,-1,-1,1,1,1,5,-1
KR_6630524362,420,-2,-17,-20,-11,3,0,3,1,4,5,-2,2,0,-7,11,4,-6,6,0,0,-17,-1,-2,-5,7,-2,0,-2,-1,1,-1,-1,4,-1
KR_6608999215,420,-1,25,-17,-4,5,0,5,-1,4,3,-1,2,1,-4,7,3,-3,4,1,0,-2,-11,-6,-2,8,5,0,-1,-1,-1,-1,-1,6,-1
KR_6741333347,420,-2,-45,-8,-8,3,0,3,-1,4,3,-6,7,1,-6,6,0,2,1,3,0,-4,-167,3,-7,4,-6,0,-2,-1,-1,-1,-1,5,-1
KR_6653878613,440,-3,-76,-17,-10,-2,4,2,0,3,3,1,1,2,-7,7,0,-2,2,0,-2,-21,-24,0,-3,3,-4,0,-1,0,0,-1,-1,0,-1
KR_6715230133,420,0,-10,23,-4,1,1,2,-6,7,1,-1,3,2,1,5,6,1,2,3,0,-17,-13,-3,-4,7,-2,0,0,1,-1,-1,-1,4,-1
KR_6742244742,440,-3,-62,12,-2,4,2,6,1,2,3,-1,4,3,-1,3,2,-5,6,1,1,-14,-5,-4,-1,5,2,0,-1,-1,0,-1,1,6,-1
KR_6753675773,420,-1,-25,-4,5,0,1,1,-2,4,2,-3,4,1,8,0,8,2,1,3,0,15,-3,2,-6,4,-3,0,0,-1,1,-1,-1,1,-1
KR_6750351195,420,-1,-23,14,-1,1,1,2,0,5,5,-3,4,1,2,3,5,-1,1,0,0,10,-25,5,-6,1,3,0,1,1,1,1,-1,6,-1
KR_6699546510,420,3,40,-5,9,0,1,1,4,2,6,0,4,4,5,2,7,0,2,2,0,5,2,1,-7,6,1,0,1,1,1,1,1,5,-1
KR_6740390338,420,-3,-78,15,-9,-3,4,1,-1,3,2,-2,4,2,-3,5,2,0,2,2,-1,-10,-1,3,-8,5,-3,0,0,0,-1,-1,-1,0,-1
KR_6683911315,420,-2,-79,-6,-3,2,0,2,-2,3,1,0,4,4,-2,5,3,-1,2,1,0,3,9,5,-9,4,0,0,-2,-1,1,-1,1,4,-1
KR_6766826738,420,-3,-59,-26,-2,0,3,3,-3,3,0,-1,3,2,1,0,1,1,0,1,0,1,110,4,-7,3,-2,0,-1,0,1,-1,-1,0,-1
KR_6637255678,420,-1,16,17,-9,4,0,4,-5,6,1,-2,2,0,-2,3,1,-4,4,0,0,-15,-12,-6,-2,8,2,0,0,1,-1,0,-1,5,-1
KR_6635680871,420,-3,-7,-64,0,-4,5,1,1,3,4,1,1,2,1,2,3,1,0,1,1,2,20,-2,-3,5,1,0,0,1,1,-1,1,4,-1
KR_6729874377,420,-6,-36,-44,-22,-13,13,0,-7,8,1,-1,2,1,-2,4,2,1,1,2,0,-11,6,2,-5,3,-1,0,-2,-1,-1,-1,-1,1,-1
KR_6630283915,420,-7,-84,-36,-15,3,0,3,-1,6,5,-4,5,1,-10,10,0,-3,3,0,0,-17,2,-1,-4,5,-3,0,-2,-1,-1,-1,1,2,-1
KR_6764428873,440,2,-6,-8,4,2,1,3,1,3,4,0,5,5,1,4,5,0,0,0,0,18,-9,4,-4,0,-1,0,1,-1,1,1,-1,3,-1
KR_6754816949,420,-2,-57,-4,-2,-1,2,1,1,2,3,0,3,3,1,1,2,-3,3,0,0,4,-14,-3,-4,7,1,0,-2,1,-1,-1,1,2,-1
KR_6691961463,440,-2,-11,4,2,-4,4,0,3,4,7,3,0,3,2,4,6,-2,3,1,1,11,7,1,-5,4,3,0,1,1,1,1,1,5,-1
KR_6729441653,420,-5,-64,-4,-17,-2,4,2,-3,7,4,-3,4,1,-7,7,0,-2,4,2,-1,-18,32,-3,-2,5,-20,0,-2,-1,1,-1,-1,3,-1
KR_6595638659,420,-1,66,-13,6,5,1,6,-3,5,2,0,2,2,2,0,2,2,0,2,0,5,17,0,-2,2,-4,0,0,1,-1,1,1,1,-1
KR_6694599293,420,-1,5,-16,0,-3,4,1,-1,2,1,-1,2,1,4,1,5,1,2,3,1,7,6,6,-7,1,-1,0,0,-1,1,0,1,6,-1
KR_6696857849,420,-2,-83,9,-1,-4,7,3,0,1,1,0,3,3,4,1,5,-1,3,2,2,-10,1,0,-4,4,-4,0,-1,-1,-1,-1,1,5,-1
KR_6720215373,420,-2,-16,18,0,1,0,1,0,0,0,-2,5,3,3,0,3,-2,2,0,0,2,-13,-4,-3,7,6,0,-2,-1,1,-1,1,3,-1
KR_6764483451,420,-1,-20,11,-2,0,1,1,-2,3,1,2,2,4,-1,1,0,-1,1,0,0,-6,-16,0,-5,5,4,0,0,1,-1,0,-1,1,-1
KR_6717737322,420,2,56,-19,1,0,2,2,-1,1,0,-2,3,1,-4,4,0,8,1,9,0,-4,-7,-1,-3,4,0,0,0,-1,1,1,1,3,-1
KR_6566166783,420,1,36,7,1,-6,6,0,1,3,4,2,2,4,4,6,10,0,0,0,0,0,0,-3,-4,7,-5,0,0,-1,1,0,-1,4,-1
KR_6757451712,420,1,2,0,-2,-3,3,0,-2,4,2,0,1,1,3,1,4,0,1,1,0,-5,4,-1,-8,9,-4,0,1,-1,1,1,1,1,-1
KR_6750032469,420,-4,-42,-17,-10,1,0,1,-4,5,1,-6,7,1,-2,3,1,1,2,3,1,-3,-101,1,-4,3,1,0,0,1,1,0,1,4,-1
KR_6729562336,420,-2,-48,19,-3,-3,7,4,1,3,4,0,4,4,-2,6,4,1,1,2,0,-4,-3,0,-7,7,-3,0,-1,1,1,-1,1,6,-1
KR_6429344064,420,-1,-16,-14,-1,-2,2,0,-3,4,1,-1,5,4,2,1,3,3,1,4,-1,-4,13,0,-7,7,1,0,0,1,-1,-1,-1,4,-1
KR_6745923077,420,4,34,-8,6,-1,2,1,4,1,5,3,1,4,-1,3,2,1,0,1,0,3,-23,4,-6,2,3,0,0,1,0,0,1,5,-1
KR_6726636824,440,1,-12,-34,-7,2,0,2,-2,5,3,-1,4,3,1,4,5,-7,7,0,-3,-16,6,-1,-5,6,1,0,-1,-1,0,-1,-1,6,-1
KR_6736310657,420,0,-19,16,1,-2,4,2,2,0,2,-3,4,1,3,0,3,1,0,1,0,4,66,2,-6,4,-18,0,-1,1,-1,-1,1,4,-1
KR_6404416510,420,-3,-45,-16,-12,-1,3,2,-1,5,4,-6,7,1,-2,4,2,-2,2,0,0,-10,-4,2,-4,2,1,0,-2,1,-1,-1,-1,3,-1
KR_6737984845,420,-5,-95,10,-2,-4,5,1,2,4,6,2,2,4,0,2,2,-2,2,0,0,0,-36,4,-6,2,13,0,-1,1,-1,-1,-1,6,-1
KR_6651370299,420,-6,-94,-40,-12,-3,3,0,-4,6,2,1,1,2,-4,6,2,-2,3,1,-1,-15,-13,0,-6,6,-2,0,-1,-1,1,-1,-1,2,-1
KR_6611871607,420,-1,-5,-26,-1,0,2,2,0,3,3,-1,4,3,-1,3,2,1,2,3,0,2,1,-2,-3,5,2,0,0,-1,1,1,-1,5,-1
KR_6609181085,420,-3,-10,16,-1,0,0,0,-2,6,4,1,4,5,0,5,5,0,2,2,0,-1,-29,-6,-6,12,4,0,0,-1,1,-1,1,4,-1
KR_6738261156,420,-3,-55,-2,-13,2,0,2,-7,7,0,-3,4,1,-5,6,1,0,2,2,0,-15,-9,-2,-3,5,1,0,-1,-1,1,-1,-1,1,-1
KR_6627845259,420,-3,33,-27,-2,-4,4,0,2,3,5,0,0,0,0,3,3,0,1,1,0,0,0,4,-7,3,-1,0,-1,-1,-1,-1,1,2,-1
KR_6765859966,420,-1,-3,0,-6,0,1,1,-1,4,3,-6,7,1,-2,4,2,3,0,3,0,-4,73,-1,-5,6,-5,0,1,1,-1,1,1,6,-1
KR_6710344382,420,-3,-20,16,-6,-8,8,0,-1,3,2,-2,5,3,3,2,5,2,1,3,-1,-1,0,4,-9,5,-10,0,-1,-1,-1,-1,-1,1,-1
KR_6766540331,420,-1,-9,16,-6,-3,3,0,0,2,2,-2,4,2,0,1,1,-1,1,0,0,-6,3,2,-7,5,-1,0,0,1,-1,0,-1,6,-1
KR_6712937763,420,-7,-44,-41,-17,-9,9,0,-2,3,1,1,1,2,-4,4,0,-3,3,0,0,-13,-161,4,-8,4,-1,0,-2,-1,-1,-1,-1,2,-1
KR_6762683876,420,0,-67,-5,-8,-3,3,0,-3,9,6,0,2,2,1,3,4,-3,3,0,0,-3,-23,1,-6,5,0,0,0,1,1,-1,1,3,-1
KR_6686320803,420,0,6,9,0,1,1,2,-1,3,2,1,1,2,-1,1,0,0,1,1,0,2,-11,2,-5,3,1,0,-1,1,-1,-1,1,6,-1
KR_6668031257,420,-1,-80,6,-1,-2,3,1,-1,3,2,0,3,3,2,1,3,0,0,0,-1,0,-7,-2,-5,7,0,0,0,-1,0,0,-1,1,-1
KR_6350173097,420,-9,-49,-8,-12,-4,6,2,0,1,1,-2,3,1,2,1,3,-8,8,0,-1,-16,6,0,-5,5,-6,0,-1,-1,1,-1,-1,3,-1
KR_6754959727,420,-3,-9,-20,-5,0,3,3,-2,4,2,1,0,1,-1,1,0,-3,5,2,0,-8,2,1,-6,5,-1,0,0,-1,1,0,-1,2,-1
KR_6748005500,420,-4,-47,-11,-5,2,2,4,-3,3,0,-1,3,2,-1,5,4,-2,3,1,0,-3,-4,-2,-2,4,-3,0,-1,-1,-1,-1,1,6,-1
KR_6487576533,420,-2,16,4,-8,-2,3,1,-1,9,8,-7,9,2,1,2,3,1,0,1,-3,-15,-28,-1,-4,5,-3,0,-1,-1,1,-1,-1,2,-1
KR_6703824768,420,-4,10,-32,-4,0,1,1,-2,4,2,-2,4,2,-1,2,1,1,0,1,0,-3,-15,-1,-4,5,2,0,0,-1,-1,0,1,2,-1
KR_6603058370,420,-2,-27,-21,-1,2,0,2,-1,2,1,0,2,2,-7,8,1,5,1,6,0,2,1,1,-4,3,0,0,-1,-1,-1,-1,-1,3,-1
KR_6740753813,420,-2,-2,6,-2,3,1,4,2,0,2,-4,4,0,-3,3,0,0,0,0,1,-2,-4,2,-5,3,1,0,0,-1,1,0,1,3,-1
KR_6729192852,420,-1,-75,20,0,0,3,3,-1,3,2,-1,4,3,2,1,3,0,0,0,0,-3,-40,1,-4,3,15,0,0,1,1,0,-1,5,-1
KR_6769673309,420,2,-7,-4,2,1,2,3,3,3,6,-5,6,1,2,1,3,1,1,2,-1,-1,-23,-4,-2,6,0,0,1,-1,1,1,-1,2,-1
KR_6766716365,420,2,38,-1,2,4,1,5,2,3,5,-1,3,2,-3,4,1,0,1,1,0,-2,-40,0,-2,2,14,0,-1,1,-1,-1,1,4,-1
KR_6634545790,420,-3,-89,-8,-11,-2,2,0,0,3,3,-5,5,0,3,2,5,-7,8,1,0,-9,-7,2,-4,2,-5,0,-2,-1,-1,-1,-1,4,-1
KR_6739472184,420,-7,-112,-1,-19,-5,6,1,-2,5,3,-3,3,0,-8,8,0,-1,2,1,0,-17,-8,-5,-1,6,1,0,-1,-1,-1,-1,1,3,-1
KR_6768381356,420,0,-36,-3,4,2,0,2,1,1,2,2,2,4,-1,1,0,0,0,0,0,3,1,-3,-1,4,2,0,0,0,0,0,1,0,-1
KR_6646045192,420,-2,-18,-12,-8,-4,4,0,-4,6,2,0,1,1,0,1,1,0,1,1,0,-10,30,-4,-2,6,0,0,-3,-1,-1,-1,-1,4,-1
KR_6755115254,420,0,-6,-40,-4,-3,4,1,-1,2,1,0,2,2,2,4,6,-2,2,0,-2,-3,3,-1,-3,4,2,0,0,-1,-1,0,-1,6,-1
KR_6742946111,440,-1,2,-3,-6,0,1,1,-4,4,0,-3,4,1,-3,4,1,4,1,5,-1,-5,-3,-2,-1,3,0,0,-1,1,-1,-1,-1,1,-1
KR_6769078278,420,-2,-69,7,-3,-3,6,3,-1,3,2,2,2,4,-2,4,2,1,0,1,1,-3,183,4,-6,2,-3,0,-1,-1,1,-1,1,1,-1
KR_6700682797,420,-2,-32,-6,4,0,3,3,3,3,6,-1,1,0,1,0,1,1,0,1,0,15,-66,2,-7,5,22,0,0,-1,-1,-1,1,2,-1
KR_6740614817,440,-4,-2,-9,-15,-2,6,4,1,1,2,-7,9,2,-1,2,1,-6,7,1,0,-21,1,3,-7,4,-4,0,-1,-1,1,-1,-1,4,-1
KR_6751339715,420,-4,-117,-24,-6,-2,2,0,1,3,4,-1,3,2,-5,6,1,1,2,3,0,1,-6,-5,-2,7,3,0,-2,1,1,-1,-1,5,-1
KR_6757992038,420,-1,-109,17,-2,-2,3,1,2,2,4,-2,3,1,-1,1,0,1,1,2,0,-1,-11,-2,-3,5,-2,0,-1,0,1,-1,-1,0,-1
KR_6560882213,420,-4,-25,-12,-6,2,0,2,1,2,3,-7,7,0,-1,2,1,-1,2,1,0,-8,6,4,-7,3,-5,0,0,-1,0,0,-1,1,-1
KR_6704817191,420,-3,-12,-34,-4,0,2,2,2,1,3,-3,5,2,-6,8,2,3,0,3,0,-5,8,5,-9,4,-5,0,1,-1,1,1,1,1,-1
KR_6759808923,440,-4,0,-2,-5,-5,6,1,2,4,6,2,0,2,-3,4,1,-1,1,0,-1,-4,14,1,-5,4,-4,0,-2,-1,-1,-1,-1,2,-1
KR_6750286771,420,0,-74,12,-1,0,1,1,-1,1,0,2,1,3,0,2,2,-2,2,0,0,-2,-46,-2,-3,5,0,0,-1,0,-1,-1,1,0,-1
KR_6757109671,420,-1,14,-4,-2,5,1,6,1,0,1,-4,5,1,-5,5,0,1,1,2,0,-2,300,-2,-1,3,-3,0,0,0,1,0,1,0,-1
KR_6743263949,440,-2,-70,-4,2,0,2,2,3,3,6,-3,3,0,3,4,7,-1,1,0,0,8,1,-3,-1,4,6,0,0,1,0,-1,1,2,-1
KR_6745954448,420,2,76,-5,3,5,0,5,0,2,2,-2,4,2,1,0,1,-1,1,0,0,1,127,2,-5,3,0,0,1,-1,1,1,1,6,-1
KR_6768327524,420,0,-7,-40,1,2,1,3,-1,5,4,2,1,3,-1,1,0,-1,1,0,0,-1,-133,1,-10,9,1,0,-1,1,-1,-1,1,2,-1
KR_6737261278,420,-3,-19,-4,-9,-1,2,1,-2,4,2,-3,5,2,-1,3,2,-2,3,1,0,-13,-6,-2,-5,7,-2,0,-2,-1,-1,-1,-1,2,-1
KR_6739504636,420,-1,3,-27,-4,1,2,3,-3,4,1,-6,7,1,3,3,6,1,0,1,0,-5,-2,2,-7,5,2,0,-1,-1,-1,-1,1,2,-1
KR_6622505099,420,-2,-47,-2,-3,-1,2,1,4,0,4,-5,8,3,-1,4,3,0,1,1,0,-4,-7,3,-7,4,1,0,-1,1,-1,-1,1,1,-1
KR_6736349334,420,2,30,1,-3,4,0,4,-4,4,0,0,2,2,-2,2,0,-1,1,0,-1,-3,-2,-7,-1,8,3,0,-1,1,-1,-1,-1,3,-1
KR_6767206600,420,-3,-16,20,-9,0,1,1,-1,2,1,-2,3,1,2,3,5,-8,9,1,-3,-7,-5,0,-5,5,1,0,0,1,1,0,-1,2,-1
KR_6759815375,420,-4,-5,-36,-14,-4,4,0,-2,3,1,-2,3,1,-3,6,3,-3,3,0,0,-9,15,1,-3,2,-1,0,-1,-1,1,-1,-1,1,-1
KR_6575244838,420,-1,8,11,-4,0,3,3,-1,4,3,-7,9,2,2,2,4,2,1,3,0,1,-57,3,-4,1,0,0,0,0,-1,-1,-1,0,-1
KR_6753704674,420,-1,-14,-12,-4,0,0,0,0,3,3,0,1,1,-5,6,1,1,1,2,0,0,28,0,-4,4,-24,0,0,0,1,1,-1,0,-1
KR_6660597780,420,-5,-46,-24,-6,-3,4,1,-3,4,1,-2,4,2,2,2,4,0,0,0,0,-1,30,-3,-3,6,-1,0,0,1,-1,0,-1,1,-1
KR_6660993079,420,-3,-22,-4,-2,-3,3,0,3,3,6,-3,5,2,2,3,5,-1,2,1,1,-4,-1,3,-6,3,4,0,-1,-1,-1,-1,1,6,-1
KR_6700902459,420,-3,-47,-8,-5,-2,2,0,0,2,2,1,0,1,-2,5,3,-2,2,0,0,-4,0,-1,-7,8,1,0,-1,-1,-1,-1,-1,5,-1
KR_6759867652,440,-3,17,4,-10,-5,5,0,-1,1,0,2,1,3,-3,5,2,-3,3,0,0,-11,-24,2,-4,2,-1,0,0,-1,1,-1,-1,2,-1
KR_6727407181,420,-2,-36,-27,-5,-2,4,2,-1,3,2,-1,3,2,-2,2,0,1,1,2,0,-1,30,-1,-4,5,-12,0,0,1,1,0,-1,3,-1
KR_6305805088,420,-4,-25,14,-4,8,1,9,-2,5,3,-2,3,1,-7,9,2,-1,3,2,2,-11,18,4,-6,2,0,0,1,-1,1,1,1,2,-1
KR_6666712465,420,1,44,8,4,5,1,6,3,1,4,1,2,3,-6,6,0,1,0,1,1,4,-5,-1,-4,5,-3,0,0,-1,1,1,1,6,-1
KR_6762473595,420,3,5,9,8,1,1,2,1,2,3,3,1,4,4,0,4,-1,2,1,0,8,-30,0,-5,5,4,0,0,1,-1,-1,-1,5,-1
KR_6741869160,420,-1,41,0,-6,0,0,0,-3,8,5,-2,3,1,-1,4,3,0,2,2,0,-7,-8,-3,-4,7,1,0,0,1,-1,0,1,2,-1
KR_6664899896,420,-3,-2,0,-5,-4,5,1,0,2,2,3,1,4,-2,3,1,-2,2,0,0,2,-3,1,-6,5,-4,0,0,-1,0,0,-1,5,-1
KR_6749306948,440,0,-43,-11,-8,-1,2,1,-3,5,2,0,2,2,-3,5,2,-1,2,1,0,-18,8,-1,-6,7,2,0,-1,-1,0,-1,-1,3,-1
KR_6764270897,420,1,51,19,-4,3,2,5,-4,5,1,2,1,3,-2,3,1,-3,3,0,0,-16,-1,-5,-2,7,10,0,1,-1,1,1,1,2,-1
KR_6714116059,440,-3,-84,11,-13,-8,8,0,-4,4,0,-1,1,0,-2,4,2,2,2,4,0,-10,-13,-3,-2,5,-1,0,-2,0,1,-1,-1,0,-1
KR_6693735613,420,-2,-6,-14,-5,-1,3,2,-4,4,0,2,0,2,-2,2,0,0,0,0,0,-3,14,-2,-4,6,-2,0,-2,1,-1,-1,1,1,-1
KR_6745475436,420,1,-41,-3,-1,1,2,3,-1,3,2,0,1,1,-2,4,2,1,1,2,-2,-9,97,-1,-7,8,0,0,0,1,0,0,-1,4,-1
KR_6667172113,420,0,-23,15,2,-5,5,0,3,1,4,3,1,4,0,0,0,1,0,1,0,8,0,-1,-4,5,-1,0,-2,1,-1,-1,1,6,-1
KR_6767089299,420,-1,-52,35,-5,-4,5,1,0,1,1,-1,3,2,0,2,2,0,1,1,0,-1,15,1,-3,2,0,0,1,1,1,1,-1,3,-1
KR_6764246790,420,0,0,26,-5,-1,2,1,0,2,2,4,1,5,-5,6,1,-3,3,0,-1,-5,-32,-3,-3,6,7,0,-1,-1,-1,-1,-1,3,-1
KR_6707088709,420,-3,-17,-20,-5,-4,6,2,-1,3,2,4,0,4,-2,2,0,-2,3,1,0,-11,9,3,-5,2,-2,0,1,-1,1,1,-1,2,-1
KR_6703153115,440,0,8,-4,5,4,0,4,0,2,2,5,0,5,0,4,4,-4,4,0,1,-1,-2,-2,-6,8,6,0,0,1,-1,0,1,6,-1
KR_6757424005,420,0,51,3,-1,2,1,3,-1,1,0,0,2,2,-2,6,4,0,1,1,1,5,-4,0,-5,5,1,0,0,-1,1,1,1,3,-1
KR_6442882810,420,3,5,24,2,-1,1,0,2,1,3,2,0,2,-1,3,2,0,1,1,0,1,-73,-7,-3,10,4,0,0,1,-1,0,-1,2,-1
KR_6616405775,420,-3,-74,-26,0,-6,6,0,-1,3,2,3,2,5,2,0,2,2,0,2,-1,5,13,-3,-2,5,-1,0,-2,1,-1,-1,-1,3,-1
KR_6736103133,420,-2,-37,-37,-4,2,2,4,-1,3,2,0,3,3,-4,5,1,-1,1,0,0,-6,-11,1,-5,4,-7,0,0,-1,1,0,-1,4,-1
KR_6766591885,420,-1,-31,-9,-5,2,1,3,3,1,4,-1,3,2,-3,5,2,-6,6,0,-1,-2,1,2,-6,4,-1,0,0,-1,1,0,-1,1,-1
KR_6622389262,420,-5,-33,-16,-5,-2,4,2,-5,8,3,-2,2,0,3,4,7,1,0,1,0,-6,0,2,-5,3,-1,0,1,0,1,1,1,0,-1
KR_5739008080,420,-3,-46,8,-12,-1,1,0,-2,3,1,-5,5,0,-2,3,1,-2,3,1,0,-15,-7,-3,-5,8,1,0,-2,-1,-1,-1,1,5,-1
KR_6749011690,420,2,-15,-24,5,1,1,2,3,0,3,-3,5,2,7,0,7,-3,4,1,2,10,-70,3,-7,4,3,0,0,-1,1,0,1,1,-1
KR_6760537719,420,-3,4,3,-3,-2,2,0,-1,2,1,0,1,1,0,7,7,0,1,1,0,-5,3,-4,-3,7,-1,0,-1,-1,-1,-1,1,1,-1
KR_6624112833,420,1,25,12,-1,-2,2,0,-1,2,1,0,2,2,-1,2,1,3,0,3,0,-2,-1,1,-6,5,1,0,0,-1,-1,0,-1,4,-1
KR_6763562706,420,-1,-21,3,-7,1,0,1,-2,5,3,3,1,4,-8,11,3,-1,2,1,0,1,0,2,-8,6,3,0,0,-1,1,-1,-1,3,-1
KR_6562345198,420,3,-12,-19,5,0,2,2,6,3,9,2,1,3,-4,6,2,1,0,1,0,9,2,2,-6,4,4,0,-1,1,-1,-1,-1,3,-1
KR_6740936449,420,-1,-10,9,0,-3,6,3,1,3,4,2,2,4,2,5,7,-2,2,0,3,1,107,2,-5,3,-1,0,2,1,0,1,1,3,-1
KR_6676925368,420,-1,-49,10,0,1,1,2,-3,4,1,-2,3,1,3,0,3,1,0,1,0,-4,-4,0,-7,7,-2,0,-1,-1,-1,-1,1,3,-1
KR_6751962938,420,-1,-11,1,-1,-3,3,0,-6,6,0,0,2,2,3,0,3,5,0,5,0,0,-6,-4,-5,9,-3,0,0,1,-1,-1,1,3,-1
KR_6711247410,420,-4,26,-24,3,3,2,5,-1,3,2,1,1,2,1,3,4,-1,2,1,0,-6,-23,5,-5,0,-1,0,0,1,1,-1,1,2,-1
KR_6519026509,440,-3,15,-44,-6,-1,1,0,0,1,1,-5,5,0,1,0,1,-1,1,0,0,-6,106,4,-8,4,-5,0,-1,-1,-1,-1,-1,1,-1
KR_6643318276,420,-3,-27,0,-5,-1,3,2,3,1,4,-2,2,0,-3,3,0,-2,4,2,0,-8,-5,3,-8,5,0,0,0,-1,-1,0,-1,6,-1
KR_6584894312,420,-3,-42,-6,-3,3,0,3,-6,7,1,2,4,6,-3,3,0,1,2,3,0,1,-33,0,-4,4,-2,0,0,0,-1,0,-1,0,-1
KR_6741983478,440,0,-19,4,-2,-3,5,2,0,1,1,3,1,4,0,1,1,-2,2,0,0,2,-1,1,-5,4,-4,0,-1,-1,1,-1,-1,3,-1
KR_6751233326,420,-1,22,-1,-3,-3,4,1,6,4,10,-2,5,3,-1,2,1,-3,3,0,-1,-7,24,3,-10,7,-5,0,1,1,1,1,-1,4,-1
KR_6752183951,420,-2,-27,-14,-6,-2,3,1,-4,5,1,0,2,2,0,4,4,0,1,1,0,-13,5,2,-4,2,-1,0,-1,1,-1,-1,1,1,-1
KR_6746852071,420,-4,4,9,-8,-2,3,1,-5,6,1,-1,1,0,-1,5,4,1,1,2,1,-6,-5,-3,-2,5,2,0,0,-1,1,-1,1,2,-1
KR_6767861888,420,-5,2,1,-11,-3,4,1,-5,5,0,-2,3,1,-2,5,3,1,1,2,0,-13,7,0,-4,4,-2,0,-2,-1,1,-1,1,2,-1
KR_6716393336,420,1,-56,-34,0,-1,1,0,1,2,3,0,2,2,0,1,1,0,1,1,0,-1,-8,-6,-4,10,0,0,0,-1,-1,0,-1,2,-1
KR_6768524543,420,-4,-89,-12,-13,-3,3,0,0,3,3,1,2,3,-2,3,1,-9,10,1,0,-7,-9,-4,-3,7,-2,0,-2,-1,1,-1,1,3,-1
KR_6731448730,420,-6,-35,-36,-15,-2,3,1,-6,7,1,-3,3,0,-4,4,0,0,1,1,0,-12,-5,-4,-4,8,-2,0,0,1,-1,-1,-1,4,-1
KR_6600323842,420,-3,-18,-20,-10,-5,5,0,-4,6,2,-2,3,1,2,2,4,-1,3,2,0,-8,-4,0,-3,3,2,0,-2,-1,-1,-1,-1,5,-1
KR_6768449903,420,-4,-56,-19,-6,-6,6,0,-2,4,2,0,1,1,1,1,2,1,1,2,0,0,-4,0,-7,7,1,0,0,1,-1,-1,-1,2,-1
KR_6683071891,420,0,-48,8,-9,0,1,1,-4,6,2,-5,6,1,-1,3,2,1,1,2,0,-8,4,-2,-5,7,-7,0,0,1,-1,0,-1,1,-1
KR_6742414999,420,4,6,8,3,-2,3,1,-1,1,0,2,3,5,3,0,3,1,0,1,0,-1,47,0,-5,5,-1,0,0,-1,1,0,1,5,-1
KR_6767418807,420,-3,1,5,-4,-6,7,1,-5,6,1,-1,4,3,4,3,7,4,2,6,0,4,15,-2,-3,5,6,0,0,1,-1,1,1,1,-1
KR_6747914090,440,-2,52,18,-8,-1,2,1,3,1,4,-7,8,1,1,0,1,-4,4,0,0,-6,0,-8,-3,11,3,0,1,1,0,1,-1,5,-1
KR_6716932709,420,0,-3,28,0,1,1,2,2,3,5,0,1,1,-3,10,7,0,2,2,-1,3,3,2,-4,2,-2,0,0,1,1,0,1,1,-1
KR_6688420871,420,2,-27,8,1,0,0,0,0,1,1,2,2,4,-1,4,3,0,0,0,0,1,-26,4,-8,4,20,0,-1,-1,-1,-1,-1,4,-1
KR_6758690727,420,2,54,15,2,3,2,5,0,1,1,3,1,4,-3,6,3,-1,2,1,0,0,-9,-3,-3,6,3,0,0,1,-1,0,1,2,-1
KR_6754760269,420,-4,-78,-34,-14,-1,2,1,-9,9,0,-1,4,3,-1,1,0,-2,2,0,0,-15,0,-2,-6,8,0,0,-2,-1,-1,-1,-1,5,-1
KR_6766461550,420,-3,-22,-24,-6,2,1,3,-5,6,1,1,3,4,-4,4,0,0,0,0,0,-7,-183,1,-4,3,23,0,-3,-1,1,-1,1,2,-1
KR_6669040600,420,1,36,8,-7,1,2,3,-1,4,3,-3,4,1,-5,9,4,1,1,2,1,-6,16,3,-7,4,-6,0,-1,1,-1,1,1,2,-1
KR_6666776091,420,-5,-92,-7,-17,-4,7,3,-4,5,1,-6,7,1,-4,4,0,1,0,1,0,-17,54,2,-6,4,-8,0,-1,1,1,-1,-1,2,-1
KR_6603612872,420,1,-31,-3,-5,-1,2,1,-3,6,3,-2,4,2,0,2,2,1,1,2,0,-6,0,-4,-4,8,-6,0,-2,-1,-1,-1,-1,1,-1
KR_6768379241,440,1,-16,-3,5,2,0,2,4,2,6,0,1,1,-2,3,1,1,0,1,0,4,-5,0,-8,8,4,0,0,0,-1,1,1,0,-1
KR_6761237073,420,0,-64,8,-4,-2,3,1,0,3,3,0,2,2,-2,2,0,0,1,1,0,-3,-20,0,-4,4,0,0,-1,0,-1,-1,-1,0,-1
KR_6350078181,420,0,-10,-20,-2,-1,4,3,-2,3,1,0,4,4,0,2,2,1,1,2,-1,0,-20,0,-5,5,2,0,0,-1,1,-1,-1,3,-1
KR_6562878006,420,-6,-88,4,-11,0,2,2,0,3,3,-1,4,3,-8,9,1,-2,2,0,-1,-10,-24,3,-6,3,-4,0,-3,0,0,-1,-1,0,-1
KR_6663044709,420,-1,7,27,-7,-2,3,1,-5,5,0,-1,1,0,3,3,6,-2,2,0,-1,-7,-3,-3,-5,8,-3,0,-3,1,-1,-1,-1,4,-1
KR_6653296748,420,-2,-13,2,-7,0,5,5,-4,5,1,1,0,1,-5,6,1,1,1,2,0,-8,28,-1,-2,3,-3,0,-1,-1,-1,-1,-1,6,-1
KR_6727870873,420,-4,-73,-39,-5,-4,5,1,-1,2,1,0,3,3,-2,5,3,2,0,2,-2,-6,4,3,-5,2,2,0,-1,1,-1,-1,-1,1,-1
KR_6767509832,420,-5,-7,-22,-5,0,2,2,-1,2,1,-2,3,1,-2,3,1,0,1,1,0,-6,-2,-1,-5,6,0,0,-1,-1,1,-1,-1,1,-1
KR_6764304069,440,-1,-31,0,4,-6,7,1,1,1,2,0,2,2,3,3,6,6,1,7,3,13,2,-1,-3,4,5,0,-1,1,0,-1,1,1,-1
KR_6737284659,420,-1,5,-16,-3,-6,7,1,-5,6,1,3,1,4,4,0,4,1,0,1,0,0,-13,3,-6,3,7,0,-1,-1,1,-1,1,2,-1
KR_6733251977,420,-2,-125,8,2,-1,2,1,0,8,8,0,1,1,4,3,7,-1,2,1,0,1,-3,-2,0,2,1,0,0,-1,1,0,-1,6,-1
KR_6227449274,420,-3,-13,-16,-2,1,1,2,-7,7,0,2,0,2,-1,3,2,3,0,3,0,-5,-7,-5,-2,7,4,0,-1,-1,-1,-1,1,1,-1
KR_6707540920,420,-4,-30,-31,-11,2,3,5,-1,3,2,-1,2,1,-8,10,2,-3,3,0,0,-20,-4,-3,-4,7,1,0,-1,-1,1,-1,-1,4,-1
KR_6749027270,420,2,-34,12,-3,2,2,4,2,3,5,-4,4,0,-1,3,2,-2,2,0,-1,-3,60,-4,-6,10,5,0,1,-1,1,1,-1,2,-1
KR_6698538553,420,-5,5,-4,-12,2,1,3,-6,7,1,-10,10,0,1,1,2,1,1,2,0,-10,-1,0,-4,4,-2,0,-1,-1,-1,-1,-1,1,-1
KR_6757284044,420,0,-75,39,-2,-2,3,1,-6,6,0,2,2,4,2,1,3,2,0,2,-1,-2,-2,-2,-5,7,-4,0,-1,1,-1,-1,-1,2,-1
KR_6728093695,440,-2,-21,-46,-7,-4,5,1,-4,6,2,3,4,7,-5,5,0,3,0,3,0,-3,1,1,-6,5,-6,0,0,-1,1,-1,-1,3,-1
KR_6719635780,420,1,-30,52,-2,-4,5,1,3,2,5,0,2,2,0,2,2,-1,3,2,-1,-7,1,2,-7,5,0,0,0,-1,-1,0,-1,2,-1
KR_6767757033,420,0,32,-4,-3,-1,2,1,4,2,6,0,0,0,-3,5,2,-3,3,0,0,-8,-9,4,-9,5,1,0,0,-1,1,-1,-1,4,-1
KR_6375305654,420,0,-43,-1,-9,-3,4,1,-5,5,0,1,2,3,4,4,8,-6,6,0,-1,-7,0,0,0,0,-5,0,0,-1,-1,-1,-1,3,-1
KR_6630392831,420,-4,-20,-28,-10,5,1,6,-1,3,2,-4,6,2,-9,13,4,-1,2,1,-4,-29,-4,-2,-1,3,1,0,-1,-1,1,-1,-1,4,-1
KR_6615674724,420,1,-6,-13,3,0,2,2,1,2,3,1,2,3,1,2,3,0,0,0,0,6,-15,2,-6,4,-3,0,0,-1,-1,0,1,4,-1
KR_6740883644,420,-1,13,0,-3,0,3,3,-1,5,4,-1,2,1,-3,4,1,2,0,2,0,-6,118,1,-7,6,-2,0,0,1,-1,0,-1,4,-1
KR_6768408062,420,-2,-40,10,-3,0,4,4,-4,5,1,1,2,3,0,3,3,0,1,1,1,3,2,-2,-3,5,0,0,-1,-1,-1,-1,1,2,-1
KR_6764837206,420,0,-18,-32,3,0,3,3,4,0,4,-2,6,4,0,4,4,1,0,1,-2,9,122,-2,-4,6,-2,0,0,-1,-1,-1,-1,1,-1
KR_6679894674,420,-3,3,-17,-10,0,0,0,-1,1,0,-1,1,0,-5,5,0,-3,6,3,0,-9,-6,-3,-2,5,0,0,0,0,1,-1,-1,0,-1
KR_6616645245,440,-2,-30,-8,-2,0,0,0,-7,9,2,1,2,3,6,0,6,-2,2,0,0,-1,4,-1,-6,7,-4,0,-2,-1,-1,-1,-1,1,-1
KR_6760357669,420,0,-82,17,-3,-2,3,1,-1,2,1,1,2,3,-3,4,1,2,2,4,-4,-8,-34,-2,-3,5,17,0,-1,0,1,-1,1,0,-1
KR_6642624503,420,-1,-81,-20,-4,1,2,3,-4,4,0,-3,3,0,4,2,6,-2,2,0,0,0,-35,3,-5,2,-1,0,-2,1,-1,-1,-1,4,-1
KR_6737942267,420,-4,-83,-3,-8,3,2,5,0,3,3,-2,3,1,-7,11,4,-2,3,1,-1,-7,3,-1,-1,2,-1,0,-2,-1,-1,-1,1,4,-1
KR_6768788082,420,1,-22,19,-2,0,2,2,-3,5,2,-1,4,3,2,0,2,0,1,1,0,-4,8,-7,-2,9,2,0,-1,1,-1,-1,1,4,-1
KR_6743635504,420,-3,-14,-17,0,2,2,4,2,1,3,-1,2,1,0,3,3,-3,4,1,0,4,10,-2,-8,10,0,0,0,0,-1,0,-1,0,-1
KR_6451769073,420,-1,-88,-8,-2,1,1,2,-4,4,0,1,1,2,0,0,0,0,1,1,0,-6,26,2,-6,4,-7,0,0,1,0,0,-1,5,-1
KR_6765312110,420,0,-45,40,-3,-3,3,0,2,0,2,2,4,6,-2,3,1,-2,3,1,2,-5,-51,0,-4,4,25,0,0,-1,1,0,1,3,-1
KR_6763483627,440,0,26,-2,-6,6,0,6,2,3,5,-4,7,3,-13,13,0,3,1,4,-4,-24,-30,-2,-1,3,-1,0,0,-1,0,1,-1,6,-1
KR_6609554863,420,0,-16,0,-6,1,1,2,-5,7,2,-4,5,1,4,7,11,-2,2,0,2,-5,-3,-1,-2,3,-2,0,-1,-1,1,1,1,4,-1
KR_6603008088,420,-4,-18,16,-4,-1,1,0,3,1,4,0,2,2,-7,8,1,1,2,3,1,7,-4,0,-5,5,3,0,0,1,1,0,1,6,-1
KR_6765922963,420,0,9,-7,-6,3,1,4,-1,1,0,0,2,2,-5,7,2,-3,5,2,0,-10,6,0,-5,5,-3,0,-1,-1,-1,-1,-1,1,-1
KR_6752096185,420,3,-30,4,3,4,0,4,-1,3,2,-2,4,2,0,1,1,2,0,2,0,-3,-5,-2,-5,7,5,0,0,-1,1,0,1,2,-1
KR_6769325995,420,-5,-81,-25,-8,-3,5,2,0,2,2,-1,4,3,-1,1,0,-3,3,0,0,-12,6,0,-3,3,-1,0,-1,-1,-1,-1,-1,3,-1
KR_6756087760,420,-2,-9,11,-4,-3,3,0,-1,4,3,0,2,2,1,2,3,-1,2,1,0,-3,2,4,-5,1,1,0,0,1,-1,-1,-1,2,-1
KR_6737238739,420,0,-29,26,0,2,1,3,-2,4,2,1,1,2,-1,2,1,0,0,0,0,-6,3,2,-5,3,-6,0,0,-1,1,0,1,2,-1
KR_6660389619,420,-1,-95,32,2,0,1,1,2,3,5,1,0,1,0,2,2,-1,1,0,0,-2,-37,4,-5,1,19,0,0,1,1,0,1,4,-1
KR_6688438155,420,-6,-77,9,-17,-1,2,1,-6,6,0,0,2,2,-9,10,1,-1,1,0,0,-21,50,-2,-4,6,-16,0,-3,0,-1,-1,-1,0,-1
KR_6742413744,420,0,-20,28,-3,-2,3,1,-1,6,5,0,2,2,0,4,4,0,1,1,0,4,14,0,-5,5,3,0,-2,-1,-1,-1,-1,6,-1
KR_6750166191,420,-1,21,-31,-3,0,0,0,-3,4,1,0,1,1,1,1,2,-1,1,0,0,-6,-18,0,-5,5,2,0,0,-1,-1,0,-1,4,-1
KR_6734235952,420,3,35,40,1,0,1,1,0,4,4,0,2,2,0,2,2,1,1,2,0,1,-5,3,-9,6,9,0,2,-1,1,1,1,5,-1
KR_6760953592,440,-2,-33,16,-4,0,1,1,-1,3,2,0,0,0,-8,10,2,5,0,5,0,-6,-13,3,-5,2,0,0,0,1,-1,0,-1,1,-1
KR_6769716915,440,-2,-9,-35,-4,-2,3,1,0,3,3,-7,7,0,3,4,7,2,0,2,0,-5,4,-4,0,4,1,0,0,1,-1,1,1,2,-1
KR_6719354849,420,-3,-58,-12,-12,1,2,3,-4,7,3,0,3,3,-5,6,1,-4,4,0,-1,-10,-2,3,-9,6,-2,0,-2,0,-1,-1,-1,0,-1
KR_6759500143,440,-2,-8,-30,-3,-6,8,2,-1,3,2,-1,2,1,4,3,7,1,3,4,1,6,6,0,-5,5,-1,0,-1,0,-1,-1,1,0,-1
KR_6675134141,420,1,-5,3,-4,0,1,1,2,2,4,1,1,2,0,4,4,-7,9,2,-1,-7,321,-4,-5,9,-4,0,0,1,-1,0,-1,1,-1
KR_6748949069,420,-5,-34,-33,-11,-2,2,0,1,4,5,-8,8,0,0,3,3,-2,2,0,0,4,-149,2,-4,2,-5,0,-2,-1,-1,-1,-1,1,-1
KR_6757201682,420,-6,-155,-36,-3,-2,2,0,-1,2,1,-4,4,0,4,2,6,0,0,0,0,4,105,4,-7,3,2,0,0,0,-1,-1,-1,0,-1
KR_6763208024,440,1,48,2,-2,2,0,2,-1,1,0,0,1,1,6,0,6,-9,9,0,0,3,40,-5,-3,8,-20,0,2,-1,0,1,-1,1,-1
KR_6768816650,420,-4,-61,5,-5,-2,2,0,-3,3,0,2,2,4,-1,1,0,-1,4,3,0,-1,-37,2,-6,4,14,0,-1,-1,1,-1,-1,6,-1
KR_6713822682,440,-5,-72,1,-8,-1,3,2,-7,9,2,-2,2,0,2,1,3,0,0,0,0,-10,-37,-4,-3,7,22,0,1,0,-1,1,1,0,-1
KR_6704063560,420,-7,-49,-16,-15,-3,3,0,-3,4,1,-11,12,1,2,3,5,0,0,0,1,-10,1,0,-3,3,1,0,-1,1,-1,1,1,6,-1
KR_6765370502,420,-1,-46,-8,-2,2,1,3,-1,2,1,0,2,2,0,1,1,-3,4,1,0,1,3,-1,-3,4,0,0,-1,1,-1,-1,-1,5,-1
KR_6740566404,440,-1,-7,24,-7,0,0,0,1,0,1,-1,1,0,-1,3,2,-6,8,2,1,-7,-38,1,-5,4,-1,0,-2,0,1,-1,1,0,-1
KR_6763467347,440,-1,-43,32,-9,0,3,3,-2,3,1,0,2,2,1,0,1,-8,9,1,-1,-10,4,0,-3,3,3,0,2,0,1,1,-1,0,-1
KR_6739330450,440,5,9,12,12,11,0,11,2,0,2,0,3,3,-3,5,2,2,1,3,2,15,-4,-2,-2,4,4,0,1,1,1,1,1,4,-1
KR_6697217467,420,-5,-92,-9,-11,-3,3,0,1,1,2,-1,3,2,-6,6,0,-2,2,0,0,-13,-15,-4,-3,7,4,0,0,-1,1,1,-1,4,-1
KR_6507685409,420,-4,-63,-9,-3,-1,2,1,-3,6,3,0,3,3,-1,2,1,2,0,2,0,-3,-18,6,-7,1,3,0,0,-1,-1,-1,-1,3,-1
KR_6766144642,420,0,-29,-4,3,3,0,3,1,1,2,0,3,3,0,0,0,-1,1,0,0,10,4,1,-5,4,4,0,0,0,-1,0,-1,0,-1
KR_6769429719,420,-2,-21,-9,-4,1,1,2,-1,5,4,1,1,2,-3,3,0,-2,3,1,0,-6,0,-1,-5,6,0,0,-2,-1,1,-1,1,4,-1
KR_6688465999,420,-2,-1,-12,-2,0,1,1,2,1,3,0,2,2,-2,9,7,-2,3,1,0,0,-161,-6,-2,8,2,0,-2,1,-1,-1,1,5,-1
KR_6607825982,420,-2,-19,12,0,3,5,8,3,1,4,-2,4,2,-3,3,0,-1,1,0,0,-4,180,0,-6,6,0,0,0,1,-1,-1,1,6,-1
KR_6729611788,420,1,2,24,-4,-1,1,0,2,2,4,1,5,6,-6,6,0,0,0,0,0,-7,7,1,-6,5,0,0,0,1,1,0,-1,3,-1
KR_6597051678,420,-1,-51,10,-1,-5,6,1,-6,11,5,3,1,4,6,0,6,1,0,1,2,7,-11,0,-7,7,-1,0,-1,1,-1,-1,1,4,-1
KR_6457768862,420,-3,9,-19,-4,-3,4,1,-1,3,2,-3,5,2,1,2,3,2,0,2,0,-4,6,-9,0,9,1,0,0,-1,-1,-1,1,5,-1
KR_6707431587,420,2,78,6,-3,0,1,1,0,3,3,0,0,0,0,1,1,-3,3,0,0,-3,-3,-2,-2,4,3,0,1,1,-1,1,-1,2,-1
KR_6759085944,420,-3,11,-19,-6,3,1,4,-5,5,0,-3,5,2,1,0,1,-2,2,0,0,-19,-1,-2,-5,7,1,0,0,-1,1,-1,-1,2,-1
KR_6621908626,420,-6,-86,-47,-17,-3,3,0,-2,4,2,-6,10,4,-5,9,4,-1,1,0,0,-10,8,0,-8,8,-1,0,-3,-1,-1,-1,1,3,-1
KR_6721935894,420,-1,13,-16,-3,0,0,0,2,2,4,-6,7,1,0,1,1,1,0,1,0,0,5,9,-10,1,2,0,0,-1,-1,0,-1,5,-1
KR_6765525720,440,-6,-10,-37,-9,-1,3,2,1,3,4,-9,9,0,0,6,6,0,1,1,0,-12,8,-3,-1,4,-3,0,-2,0,-1,-1,-1,0,-1
KR_6681028228,420,-2,39,-1,-4,2,2,4,0,3,3,-2,6,4,-1,3,2,-3,3,0,0,-12,60,4,-7,3,-24,0,0,-1,1,1,-1,2,-1
KR_6769249893,420,-1,-42,28,-8,-4,4,0,-2,4,2,4,1,5,-6,7,1,0,0,0,-1,-12,7,4,-8,4,-5,0,0,1,-1,-1,-1,1,-1
KR_6685769441,420,-1,-26,-55,1,3,0,3,-1,3,2,-4,5,1,3,0,3,0,1,1,0,2,-98,1,-5,4,0,0,-1,1,-1,-1,1,3,-1
KR_6733482594,420,3,-54,34,-1,-1,3,2,3,1,4,3,2,5,-5,5,0,-1,1,0,0,-6,6,-2,-6,8,-1,0,-1,0,1,-1,1,0,-1
KR_6367729180,420,4,12,-24,1,3,0,3,-4,6,2,0,2,2,-2,4,2,4,3,7,0,-2,0,0,0,0,-4,0,1,-1,0,1,1,2,-1
KR_6742127949,440,-1,41,8,-9,0,1,1,-4,4,0,-2,4,2,-3,3,0,0,0,0,0,-9,0,2,-5,3,-1,0,-1,1,-1,-1,-1,2,-1
KR_6616016298,420,-4,-40,4,-7,-3,5,2,-2,4,2,-2,4,2,1,0,1,-1,1,0,0,-4,14,0,-5,5,-4,0,-3,1,-1,-1,-1,6,-1
KR_6741865760,420,2,-9,5,6,-1,2,1,-1,2,1,6,0,6,1,1,2,1,2,3,0,3,13,0,-4,4,-8,0,0,1,-1,0,-1,3,-1
KR_6769262497,420,-1,-22,-1,2,-1,3,2,-2,5,3,0,2,2,5,3,8,0,2,2,0,-3,4,4,-6,2,-2,0,1,-1,1,1,-1,1,-1
KR_6747862385,440,1,-44,5,2,2,2,4,2,0,2,0,1,1,-3,7,4,1,0,1,0,-5,0,2,-7,5,-3,0,0,1,-1,1,-1,6,-1
KR_6728091464,420,2,-9,-16,5,-4,5,1,-2,3,1,3,2,5,3,2,5,5,0,5,0,13,6,-3,-3,6,3,0,-1,-1,1,1,-1,1,-1
KR_6759922231,440,3,-9,0,3,0,1,1,-3,5,2,3,1,4,2,2,4,1,0,1,1,3,-8,-5,-4,9,4,0,0,1,0,0,1,4,-1
KR_6768297529,420,-2,-36,8,4,-1,2,1,2,1,3,-1,2,1,5,0,5,-1,1,0,0,2,-189,2,-4,2,-2,0,0,-1,-1,1,1,4,-1
KR_6751750704,420,-3,-40,-28,3,1,1,2,-2,5,3,-6,6,0,8,3,11,2,1,3,0,10,-199,1,-5,4,3,0,-2,-1,-1,-1,-1,2,-1
KR_6761624426,420,-2,-6,-60,-8,-1,2,1,-2,6,4,1,2,3,-7,10,3,1,0,1,0,-7,11,-6,-1,7,3,0,-3,-1,-1,-1,-1,6,-1
KR_6678567664,420,-3,-33,8,-7,-8,8,0,1,0,1,1,1,2,-2,2,0,1,0,1,0,-7,-16,-9,-2,11,2,0,-4,-1,-1,-1,-1,6,-1
KR_6460652018,420,0,38,19,2,1,1,2,2,0,2,0,2,2,-3,4,1,2,0,2,0,0,-13,-8,-3,11,3,0,-1,1,1,-1,1,2,-1
KR_6752082966,420,-2,-59,13,-8,-3,3,0,0,5,5,-2,2,0,-2,2,0,-1,2,1,0,-5,-15,-1,-1,2,-2,0,1,-1,1,1,1,4,-1
KR_6767000532,440,-2,29,-4,-3,2,3,5,3,1,4,-5,5,0,-4,5,1,1,0,1,0,2,-8,-1,-6,7,-3,0,0,1,1,0,1,6,-1
KR_6665481351,420,1,19,20,3,4,0,4,-3,5,2,0,1,1,2,1,3,0,2,2,0,-1,217,-1,-3,4,1,0,2,1,-1,1,-1,6,-1
KR_6552974482,420,0,9,-33,-6,-2,5,3,-4,4,0,-2,4,2,2,1,3,0,0,0,-1,-8,-20,-4,-5,9,2,0,1,-1,1,1,-1,2,-1
KR_6677031092,420,-2,-76,8,-5,-3,5,2,-5,8,3,2,3,5,0,7,7,1,0,1,-1,-2,36,3,-7,4,-29,0,-1,-1,1,-1,-1,2,-1
KR_6569579814,420,-2,20,28,-4,2,5,7,-1,1,0,-2,2,0,-5,5,0,2,0,2,0,-6,-8,7,-7,0,-4,0,1,1,1,1,1,6,-1
KR_6752333552,420,0,-21,-8,-2,0,2,2,-2,6,4,0,2,2,0,6,6,0,2,2,-2,2,4,3,-9,6,-7,0,-1,1,1,-1,1,6,-1
KR_6658304148,420,1,-8,40,-3,1,0,1,2,2,4,2,3,5,-6,10,4,-2,3,1,-1,-3,8,1,-10,9,-5,0,-1,0,0,-1,-1,0,-1
KR_6749382227,420,0,15,12,1,-1,4,3,2,0,2,3,1,4,-3,3,0,0,2,2,3,5,-4,2,-5,3,2,0,0,1,1,0,1,2,-1
KR_6702904990,420,-2,-23,-11,-5,-2,3,1,2,2,4,2,0,2,-5,6,1,-2,2,0,0,-5,-7,4,-8,4,3,0,0,1,-1,-1,-1,5,-1
KR_6642684087,440,-1,-3,-16,-2,1,0,1,-4,4,0,-3,3,0,2,4,6,2,0,2,0,-4,7,-4,-6,10,-2,0,-1,1,-1,-1,1,2,-1
KR_6715252674,440,-1,-40,-1,2,2,2,4,-1,3,2,-2,2,0,1,0,1,2,3,5,0,7,3,0,-4,4,0,0,0,-1,1,-1,1,2,-1
KR_6636013966,420,1,-14,-3,5,1,1,2,-6,8,2,-4,4,0,8,1,9,6,1,7,0,0,-11,2,-5,3,2,0,1,-1,1,1,1,6,-1
KR_6736687383,440,4,73,23,5,4,0,4,1,2,3,-1,1,0,2,2,4,-1,1,0,0,8,8,-7,-3,10,-4,0,1,1,-1,1,1,2,-1
KR_6756313156,440,3,54,5,3,3,1,4,3,2,5,3,1,4,-7,7,0,1,0,1,-1,0,2,-2,-1,3,1,0,1,1,-1,-1,-1,6,-1
KR_6607721729,420,-1,-14,12,-6,1,0,1,-2,7,5,0,1,1,-4,5,1,-1,1,0,0,-6,11,1,-8,7,-8,0,0,1,-1,0,1,6,-1
KR_6695712889,420,-2,-87,-27,-7,-3,4,1,-2,2,0,0,2,2,-2,7,5,0,1,1,-1,-4,-23,-7,-4,11,1,0,-2,-1,-1,-1,-1,1,-1
KR_6729661702,420,0,15,16,-8,-2,3,1,1,2,3,-3,3,0,0,4,4,-4,4,0,-1,-16,-10,-2,-5,7,-1,0,-4,-1,-1,-1,-1,2,-1
KR_6760932946,420,-4,-21,-16,-3,-4,4,0,3,1,4,-2,5,3,4,2,6,-4,5,1,0,6,2,7,-8,1,-2,0,-1,0,1,-1,1,0,-1
KR_6682937211,420,0,-31,-13,5,-4,5,1,6,2,8,5,1,6,-3,4,1,1,0,1,0,-4,-6,-4,-2,6,4,0,0,1,-1,1,1,2,-1
KR_6729609623,420,-4,-74,-28,-15,-4,4,0,-2,3,1,-2,2,0,-6,8,2,-1,3,2,-1,-21,-11,-5,-3,8,1,0,-2,-1,-1,-1,-1,6,-1
KR_6672046771,420,-2,-50,24,-5,-1,2,1,-5,6,1,5,1,6,-4,5,1,0,0,0,0,-10,22,-1,-5,6,-8,0,0,1,1,0,1,1,-1
KR_6636981187,420,-4,-33,-60,-11,-2,4,2,-4,7,3,1,3,4,-6,7,1,0,0,0,-3,-17,-7,-1,-2,3,3,0,0,-1,1,-1,-1,6,-1
KR_6670322365,420,-3,-69,-39,-13,-2,2,0,-7,7,0,-3,4,1,-2,3,1,1,0,1,0,-11,-92,-1,-4,5,1,0,-1,1,1,-1,-1,3,-1
KR_6751031618,420,1,0,-9,4,-4,4,0,0,3,3,2,3,5,3,2,5,3,0,3,1,10,-2,1,-4,3,2,0,2,1,0,1,1,4,-1
KR_6709908242,420,-5,-138,12,-13,0,2,2,-5,6,1,-1,3,2,-6,9,3,-1,1,0,0,-17,2,-4,-4,8,-3,0,-2,-1,-1,-1,-1,5,-1
KR_6704877809,420,-1,15,-28,-6,-3,3,0,4,2,6,-1,2,1,-6,6,0,0,2,2,-1,-1,0,1,-7,6,3,0,0,0,-1,-1,-1,0,-1
KR_6766878691,420,-2,-14,-5,-8,-1,2,1,1,0,1,-4,7,3,-3,3,0,-1,1,0,0,-5,188,0,-2,2,19,0,-1,-1,1,-1,-1,3,-1
KR_6768578234,420,-2,-1,-21,1,0,2,2,1,2,3,3,3,6,-2,5,3,-1,4,3,0,-8,12,2,-5,3,-5,0,-1,1,1,-1,-1,3,-1
KR_6663118910,420,-4,-50,-40,-10,2,0,2,-7,7,0,-4,5,1,-1,3,2,0,1,1,0,-11,7,3,-6,3,0,0,-1,-1,-1,-1,-1,6,-1
KR_6609791631,420,-1,-45,-27,-1,-1,3,2,2,2,4,-1,1,0,-1,2,1,0,0,0,-3,-7,-3,-2,-3,5,4,0,-1,-1,-1,-1,-1,4,-1
KR_6760904273,420,-2,15,-9,-2,2,4,6,2,2,4,-1,3,2,-2,2,0,-3,3,0,0,-3,-3,-2,-2,4,0,0,0,1,0,0,-1,2,-1
KR_6767856794,440,-1,-22,16,-7,-10,11,1,0,1,1,-3,3,0,8,1,9,-2,5,3,-4,-9,-2,3,-6,3,-4,0,0,1,-1,-1,-1,4,-1
KR_6740557992,440,-3,-79,-30,-4,1,0,1,1,2,3,1,3,4,-3,6,3,-4,4,0,0,-4,4,-3,-1,4,-3,0,-2,1,-1,-1,1,6,-1
KR_6757530412,420,2,-5,12,2,-1,1,0,-1,3,2,5,0,5,-3,3,0,2,0,2,-1,-5,9,1,-5,4,-4,0,0,1,1,0,-1,6,-1
KR_6701827119,440,1,56,-4,1,2,1,3,-4,7,3,1,1,2,2,5,7,0,1,1,0,0,-50,-3,-3,6,-1,0,3,1,1,1,1,5,-1
KR_6666713037,420,-1,-29,9,-8,-4,4,0,1,2,3,0,1,1,-3,3,0,-2,3,1,0,-11,-6,-7,-2,9,3,0,0,-1,1,0,-1,3,-1
KR_6634262475,420,-4,-41,-4,-15,-5,6,1,1,1,2,-9,10,1,-2,2,0,0,0,0,0,-5,-4,1,-6,5,-4,0,2,-1,1,1,-1,6,-1
KR_6769220867,420,-4,-19,0,-12,-7,7,0,1,1,2,0,3,3,-5,6,1,-1,1,0,0,-6,-4,-2,-2,4,1,0,0,0,0,0,-1,0,-1
KR_6731735108,440,-2,-12,-20,-8,-2,2,0,2,3,5,-2,2,0,-6,6,0,0,0,0,0,-12,53,-4,-4,8,-30,0,-2,-1,-1,-1,-1,4,-1
KR_6711527578,440,-2,-5,-16,-10,0,0,0,-5,5,0,-9,12,3,-1,2,1,5,1,6,0,-10,13,7,-11,4,-3,0,-1,-1,0,-1,-1,6,-1
KR_6519101583,440,-2,-24,21,-7,-5,5,0,-3,5,2,1,3,4,0,4,4,0,1,1,0,-12,54,-1,-6,7,-6,0,-1,-1,-1,-1,-1,3,-1
KR_6738590665,420,-1,-28,-16,-6,2,3,5,-3,4,1,0,4,4,-5,7,2,0,1,1,-2,-12,0,1,-3,2,-5,0,0,-1,1,0,1,4,-1
KR_6654363241,440,5,67,30,5,0,1,1,0,4,4,1,4,5,4,0,4,0,0,0,0,3,6,5,-8,3,0,0,1,1,0,1,-1,5,-1
KR_6763645332,420,1,30,-4,-4,0,3,3,-2,2,0,-1,2,1,0,1,1,-1,1,0,-1,-5,1,-3,-5,8,-2,0,0,-1,1,1,-1,3,-1
KR_6762785797,420,-4,-18,17,-10,-5,5,0,1,1,2,-1,1,0,-4,5,1,-1,1,0,0,-10,-7,-1,-5,6,-1,0,-1,-1,-1,-1,-1,4,-1
KR_6767385084,420,4,26,11,4,2,1,3,2,2,4,4,0,4,-5,5,0,1,0,1,0,-2,51,5,-6,1,-29,0,0,1,1,1,1,4,-1
KR_6680505338,420,0,-53,28,3,-2,2,0,5,0,5,0,1,1,0,2,2,0,1,1,0,3,-19,2,-5,3,0,0,0,1,1,1,1,5,-1
KR_6769424971,420,-3,-54,-21,-13,-2,3,1,-11,11,0,1,1,2,-1,1,0,0,2,2,0,-13,-24,-1,-6,7,-3,0,0,-1,-1,0,1,5,-1
KR_6678850217,420,-3,-42,1,-3,-3,4,1,-3,5,2,7,1,8,-2,6,4,-2,3,1,0,-8,56,1,-4,3,-25,0,-1,1,0,-1,-1,1,-1
KR_6727642243,440,2,-19,5,2,4,2,6,-4,6,2,5,1,6,-6,9,3,3,0,3,0,-12,13,0,-1,1,1,0,0,-1,1,1,1,1,-1
KR_6756672898,420,-4,-62,-18,-14,-8,8,0,-5,5,0,-1,5,4,-2,3,1,2,1,3,0,0,8,-5,-2,7,0,0,-2,1,-1,-1,1,3,-1
KR_6754948531,420,2,39,-28,4,1,2,3,1,4,5,-2,3,1,3,1,4,1,0,1,0,13,6,-1,-3,4,5,0,3,-1,1,1,1,4,-1
KR_6741133357,420,1,-7,6,-5,-1,3,2,-3,4,1,1,2,3,-2,3,1,0,1,1,0,-7,-82,1,-3,2,-2,0,0,-1,-1,0,1,1,-1
KR_6727703566,440,-2,-65,-3,-7,-1,2,1,-2,3,1,-2,4,2,-1,4,3,-1,1,0,0,-9,8,-2,-2,4,-1,0,-1,1,1,-1,-1,4,-1
KR_6739473106,420,1,-33,18,-1,-3,4,1,2,1,3,0,3,3,0,4,4,0,0,0,0,-3,-23,0,-5,5,0,0,-1,1,-1,-1,-1,4,-1
KR_6744203581,420,0,27,12,-2,1,2,3,0,2,2,-3,3,0,1,0,1,-1,1,0,0,-7,-53,-3,-2,5,0,0,-1,1,1,-1,1,6,-1
KR_6740318494,420,-3,-60,4,-3,-2,2,0,1,2,3,-4,6,2,0,4,4,2,0,2,0,3,-386,2,-5,3,1,0,-1,-1,-1,-1,1,4,-1
KR_6751009797,420,0,-10,10,-1,0,4,4,1,2,3,-1,2,1,-1,1,0,0,1,1,0,-4,-19,1,-3,2,-1,0,1,0,1,1,1,0,-1
KR_6671982813,420,-1,27,4,-1,1,1,2,-1,6,5,0,3,3,0,1,1,-1,2,1,0,5,59,3,-8,5,-20,0,0,-1,-1,0,-1,6,-1
KR_6729493455,420,-1,-8,4,-3,4,0,4,-6,7,1,2,4,6,-3,3,0,0,1,1,-1,-8,-3,-2,-3,5,-3,0,1,1,-1,1,-1,1,-1
KR_6738438281,440,0,39,-24,2,0,2,2,-2,3,1,-1,3,2,3,3,6,2,0,2,0,-2,3,8,-10,2,4,0,1,-1,1,1,1,5,-1
KR_6762182935,420,-4,-136,-1,-10,-2,2,0,-2,5,3,-4,5,1,-3,3,0,1,0,1,0,-11,2,-1,-3,4,-1,0,-1,-1,-1,-1,-1,3,-1
KR_6762316738,420,-3,-35,-12,-4,-3,5,2,-2,3,1,2,1,3,-1,1,0,0,1,1,0,-4,60,1,-7,6,-10,0,-1,1,-1,-1,-1,5,-1
KR_6768346782,420,1,14,-40,-3,3,1,4,0,1,1,-2,3,1,-4,4,0,0,2,2,0,-5,0,0,-5,5,1,0,0,1,1,0,-1,2,-1
KR_6190399747,420,-5,-79,-20,-9,-2,5,3,2,0,2,-1,2,1,-5,5,0,-3,3,0,-1,-5,-4,-1,-4,5,0,0,-2,0,-1,-1,-1,0,-1
KR_6766530580,440,-4,-45,28,-3,-2,5,3,1,1,2,-2,6,4,-2,3,1,2,0,2,1,-2,0,1,-6,5,3,0,-1,-1,-1,-1,1,5,-1
KR_6721894229,420,-3,-33,-6,-4,0,1,1,-2,6,4,-5,5,0,2,2,4,1,1,2,0,-5,-1,5,-8,3,-1,0,1,1,1,1,-1,3,-1
KR_6707585494,440,3,-20,-8,5,2,3,5,0,0,0,4,0,4,0,1,1,-1,1,0,0,2,-15,0,-5,5,2,0,0,-1,1,0,1,4,-1
KR_6746835337,420,-2,29,-7,-7,-1,3,2,-2,4,2,2,1,3,-4,4,0,-2,3,1,0,-10,-26,-2,-4,6,-1,0,-1,1,-1,-1,-1,4,-1
KR_6760665283,440,0,-26,0,-1,-2,2,0,1,0,1,-1,2,1,0,3,3,1,0,1,-1,-3,-5,-3,-3,6,-2,0,2,-1,1,1,-1,1,-1
KR_6743926619,420,2,-10,13,3,-2,3,1,-1,3,2,2,0,2,0,1,1,4,0,4,0,7,171,1,-3,2,-30,0,-1,0,-1,-1,1,0,-1
KR_6661790063,420,1,46,0,3,2,2,4,-1,3,2,1,1,2,1,5,6,0,2,2,0,0,0,2,-7,5,-2,0,1,-1,1,1,1,2,-1
KR_6402293858,420,-4,17,-2,-8,1,0,1,-4,5,1,-4,5,1,-1,2,1,0,2,2,0,-13,4,2,-7,5,-4,0,0,-1,1,1,-1,1,-1
KR_6227382523,420,1,61,16,-5,-3,3,0,2,1,3,-5,9,4,-2,3,1,3,0,3,0,-7,4,2,-8,6,3,0,0,1,-1,-1,1,2,-1
KR_6759171443,420,-1,-39,20,2,7,1,8,-1,3,2,0,2,2,0,4,4,-4,4,0,2,3,2,-1,-3,4,-5,0,-1,1,1,-1,1,6,-1
KR_6615006747,420,-5,-30,-13,-9,-3,4,1,-7,8,1,2,1,3,-5,6,1,4,0,4,-1,-4,6,4,-7,3,-1,0,-1,-1,1,-1,-1,2,-1
KR_6746243979,420,-6,-141,-27,-1,-1,1,0,1,1,2,2,0,2,-5,7,2,2,0,2,0,-4,-22,-1,-4,5,0,0,-2,-1,-1,-1,-1,1,-1
KR_6768647058,420,2,-10,20,4,1,0,1,2,4,6,2,1,3,-1,4,3,0,0,0,0,0,8,3,-6,3,-4,0,-1,1,-1,-1,-1,6,-1
KR_6573485109,420,3,13,-17,10,4,0,4,2,0,2,3,0,3,0,2,2,1,2,3,0,9,25,2,-7,5,0,0,0,1,-1,0,1,6,-1
KR_6729296342,420,-6,-32,-4,-11,-3,4,1,-4,4,0,-1,4,3,-2,3,1,-1,2,1,0,-12,85,2,-3,1,-2,0,-2,-1,0,-1,1,5,-1
KR_6650825933,420,-3,-17,3,-9,-5,5,0,-1,2,1,0,2,2,0,5,5,-3,4,1,0,-4,-5,-2,-3,5,0,0,-2,-1,-1,-1,1,3,-1
KR_6719600286,420,-3,-11,-1,-4,-1,2,1,-1,3,2,-1,1,0,-3,6,3,2,1,3,-1,-1,-1,0,-5,5,0,0,-2,1,-1,-1,-1,6,-1
KR_6758313550,420,-3,57,-17,-8,1,2,3,-2,3,1,-5,5,0,-3,5,2,1,1,2,-1,-14,42,2,-4,2,-21,0,-1,-1,1,-1,-1,5,-1
KR_6755665185,420,-6,-94,-24,-17,-5,5,0,-1,3,2,-4,6,2,-7,8,1,0,1,1,0,-3,-27,-5,-3,8,11,0,-1,-1,1,-1,-1,6,-1
KR_6359683907,420,-2,-20,-28,-1,-2,5,3,1,1,2,0,4,4,1,2,3,-1,2,1,0,1,0,0,0,0,2,0,-2,-1,-1,-1,1,2,-1
KR_6761764651,420,-2,-13,-8,-3,-3,4,1,-4,4,0,1,0,1,4,1,5,-1,1,0,0,2,-37,-1,-3,4,34,0,0,-1,1,0,1,3,-1
KR_6768552604,420,-1,-69,33,-1,1,1,2,1,3,4,-2,2,0,0,0,0,-1,1,0,0,0,-158,-3,-3,6,-3,0,0,1,1,0,-1,6,-1
KR_6760299258,420,-4,-31,17,-10,1,1,2,-2,3,1,-2,4,2,-6,6,0,-1,3,2,-2,-6,34,-4,-2,6,-32,0,-1,-1,-1,-1,-1,2,-1
KR_6763560752,420,-8,-45,-18,-25,-1,1,0,-3,5,2,-4,6,2,-17,18,1,0,1,1,-1,-18,113,-1,-4,5,3,0,-3,-1,-1,-1,-1,6,-1
KR_6722959663,420,-4,-24,-9,-8,-2,2,0,-6,6,0,1,2,3,-1,3,2,0,3,3,0,-7,-49,-3,-3,6,1,0,-1,-1,-1,-1,1,4,-1
KR_6627438329,420,-2,-93,-20,1,-1,2,1,2,1,3,-4,4,0,4,2,6,0,1,1,0,12,37,1,-7,6,-1,0,0,-1,-1,0,1,2,-1
KR_6769487823,420,-4,26,15,-6,-2,2,0,-12,12,0,3,1,4,4,1,5,1,0,1,0,-13,-7,-2,-2,4,1,0,0,-1,0,0,1,6,-1
KR_6764311672,420,-2,-29,-1,-9,-1,1,0,-3,5,2,0,3,3,0,1,1,-5,5,0,0,-12,-9,-1,-5,6,1,0,0,-1,0,-1,-1,3,-1
KR_6638183590,420,-3,-1,-8,-7,-1,4,3,-2,3,1,1,4,5,-4,5,1,-1,5,4,0,-14,9,-2,-4,6,-1,0,0,-1,-1,-1,-1,1,-1
KR_6712791508,420,-1,11,16,-6,0,4,4,-4,7,3,1,2,3,-3,6,3,0,0,0,0,-15,-8,-5,-3,8,4,0,0,1,0,0,1,3,-1
KR_6761710720,420,0,-12,28,-3,1,2,3,-4,5,1,-2,2,0,2,2,4,0,0,0,-2,-14,-6,1,-7,6,0,0,-1,-1,-1,-1,-1,1,-1
KR_6737117746,420,1,0,-44,2,2,1,3,4,2,6,4,1,5,-6,6,0,-2,4,2,0,0,20,0,-8,8,-5,0,0,0,-1,0,1,0,-1
KR_6724519054,420,0,-78,26,-3,2,1,3,0,4,4,-6,7,1,1,5,6,0,2,2,0,-9,1,-5,-3,8,-3,0,1,1,0,1,1,1,-1
KR_6722486570,420,1,25,0,-2,-1,1,0,-5,5,0,2,2,4,1,2,3,1,1,2,-1,-1,-5,-4,-4,8,3,0,3,-1,1,1,-1,4,-1
KR_6758364659,420,2,45,-4,1,3,2,5,1,0,1,3,0,3,-5,6,1,-1,3,2,0,-3,-4,3,-3,0,-2,0,0,-1,0,0,1,3,-1
KR_6550267940,420,2,54,-21,1,-1,3,2,4,2,6,-1,2,1,-2,4,2,1,0,1,0,1,-1,1,-4,3,1,0,-1,1,-1,-1,1,2,-1
KR_6753407482,420,1,-43,-28,0,1,0,1,-2,4,2,2,2,4,-2,2,0,1,1,2,0,0,203,-4,-2,6,-2,0,-2,1,-1,-1,-1,3,-1
KR_6717344439,420,-3,-40,-9,-8,-5,5,0,-4,4,0,-2,5,3,3,1,4,0,1,1,0,-7,41,0,-4,4,-19,0,-1,1,-1,1,1,6,-1
KR_6694831962,420,0,-7,-33,3,1,1,2,2,3,5,0,2,2,-1,2,1,1,1,2,0,0,-1,4,-9,5,-1,0,0,-1,1,0,-1,3,-1
KR_6720923175,420,-5,-99,-4,-15,-4,5,1,-3,4,1,-4,6,2,-4,5,1,0,0,0,-2,-23,1,0,-4,4,6,0,-1,-1,-1,-1,-1,6,-1
KR_6740305277,420,-4,-71,6,-7,-2,3,1,1,0,1,-1,1,0,-5,6,1,0,2,2,0,-6,-3,0,-4,4,0,0,-1,0,1,-1,-1,0,-1
KR_6755531222,420,-3,-33,-4,-8,1,0,1,-3,4,1,-6,6,0,-2,3,1,2,0,2,0,-7,-6,2,-5,3,2,0,0,-1,-1,-1,-1,3,-1
KR_6743118071,420,-2,15,-5,-5,-4,5,1,-2,5,3,1,1,2,-2,2,0,2,0,2,0,-5,-4,0,-5,5,0,0,0,-1,-1,0,-1,1,-1
KR_6647198652,420,3,-38,15,10,3,0,3,0,3,3,0,1,1,7,0,7,0,0,0,0,12,0,1,-5,4,3,0,1,1,1,1,1,6,-1
KR_6768524855,420,-5,-15,4,-15,-4,5,1,2,5,7,-6,6,0,-6,6,0,-1,2,1,0,-14,-5,-6,-3,9,-4,0,0,-1,0,1,-1,3,-1
KR_6761444668,420,-5,-101,-32,-4,2,0,2,-1,3,2,-4,4,0,0,3,3,-1,2,1,0,0,11,1,-7,6,-4,0,0,-1,1,0,-1,1,-1
KR_6623806027,420,-5,-57,-20,-18,-4,5,1,-1,1,0,-3,6,3,-9,9,0,-1,1,0,-1,-10,4,-2,-2,4,-2,0,0,-1,0,0,-1,4,-1
KR_6759215369,440,-3,-81,-13,-2,2,0,2,-1,2,1,1,2,3,-5,5,0,1,1,2,1,-3,-10,2,-6,4,-4,0,0,1,-1,-1,1,4,-1
KR_6762553569,420,-6,-111,-23,-18,-4,6,2,-8,9,1,-2,3,1,-9,10,1,5,0,5,-1,-5,-5,-2,-6,8,1,0,-1,-1,-1,-1,-1,1,-1
KR_6677826649,420,-1,-8,-17,-6,-1,2,1,-1,5,4,-5,5,0,0,0,0,1,0,1,0,-7,-1,2,-5,3,-2,0,-1,-1,-1,-1,-1,2,-1
KR_6739883512,420,-3,-116,-16,-4,-2,4,2,1,1,2,-3,4,1,-2,5,3,2,0,2,0,1,19,-1,-4,5,-17,0,1,-1,-1,1,-1,4,-1
KR_6633140531,420,0,-44,-24,-3,-5,6,1,4,1,5,1,2,3,-4,5,1,1,2,3,0,1,-3,0,-4,4,0,0,-1,-1,-1,-1,-1,5,-1
KR_6739337015,420,-2,-19,-42,-3,4,0,4,1,2,3,-3,3,0,-3,3,0,-2,3,1,0,-10,-5,-3,-4,7,-3,0,1,-1,1,1,1,1,-1
KR_6761755767,420,-2,-79,-9,0,4,0,4,0,1,1,-2,2,0,-3,3,0,1,0,1,0,-3,-102,0,-4,4,-6,0,-1,1,-1,-1,1,3,-1
KR_6635980195,420,-4,-26,-8,-8,0,4,4,-1,4,3,-5,6,1,-4,4,0,2,1,3,0,-1,8,4,-10,6,-1,0,-2,-1,-1,-1,1,1,-1
KR_6759407757,440,-1,-12,-27,-11,-2,2,0,-5,7,2,-1,2,1,1,0,1,-4,5,1,0,-14,-16,-6,-3,9,1,0,0,-1,0,0,1,1,-1
KR_6634464234,420,-3,-90,12,-5,-5,5,0,-1,3,2,1,6,7,0,3,3,0,0,0,0,-4,-7,-7,-3,10,2,0,-1,-1,1,-1,-1,3,-1
KR_6375587710,420,-5,-136,-20,-11,1,1,2,1,0,1,-5,7,2,-8,9,1,0,2,2,0,-1,0,0,0,0,-1,0,-2,-1,1,-1,-1,5,-1
KR_6761036001,420,-2,8,-3,-7,0,0,0,-5,6,1,0,3,3,0,2,2,-2,6,4,0,-8,-32,-3,-2,5,1,0,-1,1,-1,-1,-1,6,-1
KR_6712604724,420,-3,-6,-12,-10,0,3,3,-2,3,1,-6,6,0,-1,3,2,-1,1,0,0,-6,-2,0,-5,5,-2,0,-1,-1,1,-1,-1,4,-1
KR_6470870856,420,-15,-188,-121,-14,1,2,3,-9,9,0,-1,4,3,-4,4,0,-1,2,1,-3,-8,33,-2,-2,4,-24,0,-7,-1,-1,-1,-1,3,-1
KR_6736413099,420,-2,-29,-6,-3,-7,7,0,1,3,4,4,1,5,-2,3,1,1,1,2,0,2,25,-4,-3,7,-1,0,-1,-1,-1,1,-1,3,-1
KR_6760413667,420,2,-1,27,-1,2,2,4,-2,3,1,0,2,2,-2,4,2,1,0,1,-1,-9,-2,1,-4,3,0,0,0,-1,1,0,-1,1,-1
KR_6665524448,420,-4,-100,-15,-11,-1,1,0,3,2,5,-2,3,1,-11,11,0,0,0,0,0,-10,-5,-3,-2,5,2,0,-2,-1,1,-1,-1,2,-1
KR_6569072964,440,0,-10,16,1,-3,3,0,4,0,4,-2,3,1,4,0,4,-2,3,1,0,2,-4,3,-7,4,-3,0,0,-1,1,0,1,3,-1
KR_6761819987,420,-2,-28,-13,-5,2,1,3,0,1,1,1,1,2,-4,6,2,-4,4,0,0,-13,4,3,-8,5,-3,0,0,-1,-1,0,-1,4,-1
KR_6760798100,420,1,-10,23,5,2,1,3,2,1,3,-4,5,1,4,1,5,1,0,1,1,9,316,4,-5,1,3,0,0,1,1,1,1,2,-1
KR_6689081904,420,-2,-69,-27,-2,0,3,3,-1,3,2,-5,6,1,2,1,3,2,1,3,0,7,9,4,-8,4,-5,0,-2,1,-1,-1,-1,5,-1
KR_6603325252,420,-2,-23,-10,-1,-1,2,1,-1,4,3,-4,5,1,3,2,5,2,3,5,0,5,2,0,-3,3,2,0,0,1,-1,-1,-1,3,-1
KR_6752465015,420,-3,-13,-16,-8,-2,4,2,-1,1,0,-3,5,2,0,3,3,-2,3,1,0,1,-3,-2,-5,7,-3,0,-1,1,-1,-1,-1,2,-1
KR_6647586035,420,-9,-96,-24,-15,-7,7,0,-2,4,2,-5,5,0,-2,5,3,1,0,1,0,-4,1,0,-3,3,0,0,-2,-1,-1,-1,-1,1,-1
KR_6740453629,420,6,75,23,11,5,2,7,3,1,4,3,3,6,-1,5,4,1,2,3,-1,3,3,6,-8,2,0,1,3,1,1,1,-1,3,-1
KR_6759341804,440,-3,-63,-12,-13,3,1,4,-6,7,1,-10,10,0,0,2,2,0,1,1,0,-18,-64,-1,-6,7,5,0,0,0,0,-1,-1,0,-1
KR_6769509126,420,0,-93,22,5,1,0,1,4,0,4,3,3,6,-1,2,1,-2,6,4,0,8,-3,0,-6,6,0,0,0,-1,1,0,1,5,-1
KR_6741220865,420,-3,-22,0,-11,-1,2,1,-4,4,0,-4,5,1,-1,4,3,-1,3,2,-1,-21,-4,-2,-5,7,0,0,0,1,1,0,-1,2,-1
KR_6755000194,420,0,-61,-19,-4,-1,4,3,-2,3,1,0,1,1,-1,3,2,0,1,1,0,-5,-2,-5,-2,7,-2,0,-1,-1,-1,-1,-1,3,-1
KR_6768413305,420,-2,-49,4,-3,-3,3,0,-1,2,1,0,2,2,1,2,3,0,2,2,1,2,1,-2,-5,7,0,0,0,-1,1,-1,1,6,-1
KR_6523389047,420,0,30,1,6,1,1,2,0,2,2,7,2,9,-2,4,2,0,2,2,0,-2,3,-3,-5,8,-6,0,0,-1,0,0,1,3,-1
KR_6701038329,420,-11,-44,-71,-20,-6,7,1,-1,1,0,-7,9,2,-2,4,2,-4,4,0,0,-17,135,-2,-5,7,-3,0,0,-1,-1,-1,-1,5,-1
KR_6730734932,440,1,-37,-15,5,-2,4,2,0,5,5,2,4,6,5,1,6,0,1,1,1,10,-1,-3,-4,7,2,0,1,0,1,1,1,0,-1
KR_6753913806,420,-1,44,-8,-6,0,1,1,0,1,1,-2,2,0,-4,4,0,0,2,2,0,-4,-113,0,-7,7,1,0,0,1,-1,0,-1,1,-1
KR_6674456579,420,3,42,20,8,4,2,6,-1,1,0,0,3,3,5,1,6,0,2,2,1,4,233,0,-3,3,5,0,0,1,1,1,1,2,-1
KR_6759811403,420,-5,-53,8,-12,-4,5,1,-1,3,2,-1,2,1,-5,8,3,-1,2,1,-1,-13,0,-6,-3,9,-2,0,-1,1,-1,-1,-1,4,-1
KR_6755530849,420,-4,-22,-8,-3,-4,4,0,-1,1,0,-1,3,2,1,1,2,2,0,2,0,1,7,3,-8,5,-2,0,0,1,-1,0,1,1,-1
KR_6751857479,420,0,-57,32,-8,-2,2,0,0,2,2,0,2,2,-2,3,1,-4,4,0,0,-6,210,-1,-2,3,-4,0,0,-1,1,1,-1,4,-1
KR_6768403381,420,-4,-51,-20,-6,0,2,2,-4,5,1,-2,2,0,0,0,0,0,0,0,0,-4,-4,-2,-1,3,1,0,0,-1,1,0,-1,4,-1
KR_6704890726,420,0,-8,20,-4,-2,2,0,-2,5,3,0,2,2,0,4,4,0,1,1,0,-6,-4,-2,-5,7,2,0,-1,-1,1,-1,1,5,-1
KR_6766207642,420,1,49,-26,2,2,0,2,-1,3,2,1,2,3,2,3,5,-2,3,1,1,11,20,1,-4,3,0,0,1,0,0,1,1,0,-1
KR_6769612597,420,-1,-1,12,-5,-1,3,2,-1,2,1,-1,5,4,-3,5,2,1,0,1,0,5,4,4,-6,2,-2,0,-1,-1,-1,-1,-1,1,-1
KR_6755569603,440,-3,-26,35,-9,-2,2,0,0,2,2,-7,7,0,0,2,2,0,0,0,0,-6,0,-1,-4,5,1,0,-1,0,-1,-1,-1,0,-1
KR_6689149817,420,-2,68,-20,-11,1,2,3,-2,3,1,-2,4,2,-5,5,0,-3,4,1,0,-20,32,-2,-2,4,1,0,-2,-1,-1,-1,1,3,-1
KR_6598347642,420,-3,-29,-39,-7,1,2,3,-6,7,1,3,0,3,-4,6,2,-1,1,0,0,-12,9,6,-9,3,-5,0,-2,-1,1,-1,-1,1,-1
KR_6732812073,420,-1,-27,0,-2,1,3,4,-2,3,1,-2,2,0,0,3,3,1,1,2,0,-2,-5,2,-5,3,-1,0,-1,0,-1,-1,-1,0,-1
KR_6769531121,440,-5,-22,23,-14,-2,3,1,-3,3,0,-9,10,1,0,3,3,0,0,0,0,-14,-15,-2,-3,5,-2,0,-1,-1,1,-1,-1,1,-1
KR_6701058348,420,-3,81,-20,-5,1,3,4,-1,3,2,-3,4,1,-2,2,0,0,0,0,0,-10,-12,4,-7,3,-7,0,1,-1,-1,1,1,5,-1
KR_6625996898,420,-3,-95,-28,-6,-1,3,2,-2,3,1,0,2,2,-4,7,3,1,0,1,0,-1,-2,2,-7,5,1,0,-2,-1,-1,-1,1,2,-1
KR_6755215906,420,0,104,3,8,-1,1,0,6,0,6,3,4,7,1,0,1,-1,2,1,0,10,3,-2,-3,5,4,0,2,1,0,1,1,1,-1
KR_6650427120,420,3,66,4,7,2,3,5,-1,5,4,6,1,7,-1,6,5,1,3,4,1,8,8,1,-4,3,-4,0,3,-1,0,1,1,5,-1
KR_6716994540,420,-7,-57,5,-9,-5,5,0,-4,6,2,-3,4,1,1,2,3,2,0,2,0,-5,-107,-1,-5,6,0,0,-1,1,-1,-1,-1,3,-1
KR_6762762288,420,-2,-4,19,-4,-2,4,2,1,1,2,0,0,0,-4,6,2,1,0,1,-1,-7,0,-1,-5,6,-6,0,-2,-1,-1,-1,-1,5,-1
KR_6747887030,420,-2,80,-10,1,-2,3,1,1,5,6,6,0,6,-3,4,1,-1,3,2,-1,-4,5,3,-5,2,1,0,1,-1,1,1,-1,4,-1
KR_6530373509,420,0,-2,3,-3,-1,4,3,1,2,3,3,1,4,-4,4,0,-2,2,0,0,-3,35,-3,-3,6,0,0,-1,-1,-1,-1,-1,6,-1
KR_6698469853,440,-5,-54,-12,-14,-4,7,3,-2,3,1,-8,8,0,-1,4,3,1,0,1,0,-11,4,-2,-5,7,-2,0,-2,1,-1,-1,-1,3,-1
KR_6727416324,420,-8,-154,8,-5,-2,2,0,-1,2,1,0,3,3,-1,2,1,-1,1,0,0,-10,5,3,-6,3,-6,0,-2,-1,1,-1,1,1,-1
KR_6643374793,420,-1,7,-28,0,2,1,3,-6,7,1,0,3,3,0,2,2,4,1,5,0,-1,1,1,-3,2,2,0,-1,1,-1,-1,1,4,-1
KR_6694595739,420,0,-51,-24,-6,3,0,3,-4,7,3,-1,4,3,-4,7,3,0,0,0,0,-8,23,-2,-3,5,-4,0,-1,0,-1,-1,1,0,-1
KR_6751199392,420,-2,-79,-21,-3,0,2,2,6,0,6,1,2,3,-8,8,0,-2,2,0,0,-2,-1,0,-4,4,1,0,-3,-1,1,-1,-1,3,-1
KR_6638535373,420,0,-59,-20,1,-1,2,1,2,1,3,3,2,5,-2,7,5,-1,3,2,1,7,4,-2,-6,8,-3,0,0,-1,-1,1,1,4,-1
KR_6751668971,420,4,72,-23,5,6,0,6,-1,3,2,5,2,7,-4,6,2,-1,2,1,0,-1,2,0,-6,6,0,0,1,-1,1,1,-1,1,-1
KR_6764685140,420,1,-9,-20,-8,-1,1,0,0,2,2,0,2,2,-8,8,0,1,0,1,0,-9,-176,-5,-2,7,-1,0,0,-1,-1,0,-1,4,-1
KR_6589264554,420,0,10,40,3,-3,3,0,-1,2,1,3,3,6,5,0,5,-1,1,0,4,6,4,4,-9,5,3,0,0,1,1,0,1,3,-1
KR_6680128321,420,0,-10,4,0,5,0,5,-2,6,4,-2,3,1,-1,2,1,0,0,0,0,0,-6,-3,-4,7,3,0,0,-1,-1,0,1,4,-1
KR_6755067704,420,0,5,-6,4,3,3,6,-6,8,2,2,0,2,1,4,5,4,1,5,0,-6,76,3,-8,5,0,0,-1,-1,1,1,-1,6,-1
KR_6598833947,420,-1,-20,-34,-3,-2,2,0,0,3,3,-3,4,1,2,2,4,0,0,0,0,-2,6,0,-7,7,-3,0,-1,1,-1,-1,-1,4,-1
KR_6490598416,420,0,-61,-31,-3,-4,5,1,-1,5,4,-2,3,1,5,3,8,-1,1,0,-1,7,-2,-1,-8,9,-2,0,-1,0,1,-1,-1,0,-1
KR_6665628733,420,-3,-28,-8,-9,1,3,4,-1,1,0,-2,3,1,-4,5,1,-3,3,0,0,-12,-215,0,-5,5,-2,0,-1,-1,1,1,-1,2,-1
KR_6679565701,420,0,9,12,2,-2,3,1,2,2,4,-2,4,2,-3,4,1,7,1,8,0,10,-42,-1,-4,5,18,0,-1,-1,-1,-1,1,5,-1
KR_6763231352,420,0,-54,-28,2,0,2,2,3,1,4,-3,7,4,3,0,3,-1,2,1,0,7,-1,-4,0,4,5,0,0,1,-1,-1,1,6,-1
KR_6741871031,420,0,-1,0,0,0,1,1,-1,4,3,2,0,2,0,2,2,-1,2,1,-1,-5,11,0,-3,3,4,0,0,0,1,-1,-1,0,-1
KR_6759077373,440,-3,-74,-15,-5,-1,1,0,1,3,4,-1,5,4,-3,4,1,-1,1,0,0,-5,-24,2,-7,5,1,0,-1,-1,1,-1,-1,6,-1
KR_6653856754,440,0,9,4,-4,1,1,2,1,1,2,-1,2,1,-4,4,0,-1,1,0,0,-8,1,1,-5,4,-1,0,0,1,-1,1,1,6,-1
KR_6742300284,440,1,67,0,-1,1,1,2,0,2,2,1,3,4,-1,5,4,-2,3,1,0,-4,-1,0,-9,9,1,0,0,-1,1,0,1,5,-1
KR_6552871564,420,0,-28,-8,-3,-7,8,1,0,2,2,-4,4,0,6,3,9,2,0,2,0,4,17,0,-8,8,-3,0,-2,-1,-1,1,1,3,-1
KR_6740060647,440,-11,-96,-64,-28,-3,3,0,-6,6,0,-19,19,0,2,0,2,-2,2,0,0,-11,9,0,-3,3,0,0,-1,-1,-1,-1,-1,1,-1
KR_6756366716,440,-3,-30,-34,-3,5,0,5,-4,5,1,1,2,3,1,2,3,-6,9,3,-1,-1,-12,-3,0,3,1,0,0,0,0,-1,-1,0,-1
KR_6758067495,420,1,1,-23,8,2,1,3,0,3,3,1,4,5,-1,3,2,6,0,6,1,9,17,0,-3,3,2,0,1,0,-1,1,1,0,-1
KR_6707441172,440,0,16,-36,-1,-2,3,1,4,1,5,3,1,4,-6,7,1,0,2,2,0,1,-4,-2,-4,6,1,0,-1,-1,-1,-1,-1,3,-1
KR_6729800156,420,1,-24,-20,2,2,2,4,2,0,2,-4,4,0,0,2,2,2,0,2,0,0,-4,3,-7,4,-2,0,0,-1,1,0,-1,6,-1
KR_6718555894,420,-1,-40,-15,-1,-4,5,1,0,1,1,1,3,4,4,0,4,-2,2,0,0,5,-12,2,-5,3,-1,0,-2,-1,1,-1,-1,5,-1
KR_6733188821,440,0,13,-14,3,-2,2,0,-5,6,1,5,1,6,3,1,4,2,0,2,0,6,4,1,-4,3,3,0,0,-1,-1,1,-1,4,-1
KR_6757084562,420,2,-8,7,1,-1,2,1,3,0,3,-3,8,5,1,3,4,1,1,2,0,15,6,-3,-2,5,-4,0,1,1,0,1,-1,2,-1
KR_6742056672,440,-2,-6,8,-9,-6,6,0,-1,3,2,-3,5,2,0,4,4,1,0,1,0,-13,-2,-6,-6,12,-2,0,0,-1,1,-1,-1,4,-1
KR_6692192956,420,-2,3,-32,-3,-1,1,0,1,4,5,0,1,1,-2,2,0,-1,1,0,0,-3,-5,-1,-5,6,-2,0,0,-1,-1,0,1,4,-1
KR_6671689206,420,-1,39,4,-4,-1,2,1,0,1,1,-2,3,1,0,2,2,-1,2,1,0,-6,9,3,-8,5,1,0,0,-1,-1,0,1,2,-1
KR_6764235973,440,-1,1,16,0,-5,5,0,8,0,8,-4,4,0,1,3,4,0,1,1,0,1,-20,0,-1,1,2,0,-1,1,-1,-1,-1,4,-1
KR_6700113016,440,0,-39,5,0,-4,5,1,4,0,4,2,0,2,0,1,1,-2,3,1,0,1,3,3,-6,3,-1,0,0,1,1,1,1,6,-1
KR_6743224206,440,2,78,-42,4,4,1,5,2,1,3,5,0,5,-6,7,1,-1,2,1,0,-7,9,7,-9,2,-1,0,1,-1,1,1,1,5,-1
KR_6765493214,420,1,0,-4,3,3,1,4,-2,4,2,1,5,6,2,0,2,-1,3,2,1,-5,-5,-2,-3,5,1,0,0,1,-1,0,1,2,-1
KR_6741399284,420,3,4,44,13,5,1,6,5,0,5,4,2,6,-1,2,1,0,0,0,1,9,24,2,-4,2,1,0,-1,0,1,1,1,0,-1
KR_6621917033,420,0,-13,2,-1,-3,3,0,0,1,1,2,2,4,2,0,2,-2,3,1,0,-5,18,-5,-2,7,5,0,-1,-1,-1,-1,-1,3,-1
KR_6743004012,420,-3,-22,-7,-9,-6,6,0,-3,3,0,-1,1,0,1,0,1,0,0,0,0,-3,-33,0,-3,3,-6,0,-2,1,-1,-1,-1,6,-1
KR_6450830698,420,0,8,11,-3,0,1,1,-4,7,3,1,0,1,2,1,3,-2,2,0,1,0,18,1,-6,5,-2,0,0,1,-1,-1,1,2,-1
KR_6738206999,440,-8,-120,-50,-11,-6,7,1,1,2,3,-1,4,3,-7,8,1,2,2,4,0,1,11,-2,-2,4,4,0,-2,-1,1,-1,1,4,-1
KR_6697027799,420,1,-21,0,6,0,2,2,4,1,5,4,1,5,-2,3,1,0,0,0,0,1,-1,0,-4,4,1,0,0,-1,-1,1,1,5,-1
KR_6688199077,420,3,6,-10,9,0,2,2,0,2,2,8,2,10,2,0,2,-1,1,0,0,8,-7,4,-8,4,-1,0,0,1,-1,0,1,3,-1
KR_6768971366,420,-4,18,-5,-5,-4,4,0,-2,3,1,2,1,3,-2,5,3,1,1,2,1,-5,-85,-2,-6,8,2,0,0,-1,1,1,1,3,-1
KR_6762531575,440,-2,-18,16,-4,-1,2,1,0,1,1,-1,3,2,-3,6,3,1,0,1,0,-2,6,7,-9,2,-3,0,0,-1,-1,0,1,6,-1
KR_6755594099,420,-2,-41,-4,-11,1,0,1,-3,5,2,-2,4,2,-5,5,0,-2,3,1,-2,-8,-2,2,-5,3,1,0,-1,1,1,-1,-1,5,-1
KR_6704712850,420,-1,31,-12,-5,4,1,5,-3,4,1,-2,3,1,-2,3,1,-2,2,0,0,-5,-39,1,-5,4,1,0,0,-1,-1,0,-1,2,-1
KR_6721194658,420,-3,-38,13,-5,0,2,2,-7,7,0,2,2,4,-3,5,2,3,0,3,0,-8,-44,-1,-5,6,-4,0,-3,-1,0,-1,-1,5,-1
KR_6678109878,420,-2,-43,7,-3,-4,5,1,0,6,6,-4,6,2,4,1,5,1,0,1,0,10,2,1,-7,6,2,0,-1,1,1,-1,-1,5,-1
KR_6687532319,420,-5,-50,-14,-13,-3,5,2,-1,3,2,-4,5,1,-4,4,0,-1,1,0,-1,-14,-10,-2,-2,4,1,0,-2,-1,-1,-1,-1,1,-1
KR_6762217107,420,0,-4,5,-7,-4,5,1,-1,1,0,0,2,2,-3,7,4,1,1,2,0,-2,0,0,-3,3,-3,0,0,0,-1,0,-1,0,-1
KR_6674586939,420,2,3,-1,0,2,1,3,-2,2,0,2,1,3,-1,4,3,-1,2,1,0,-3,23,-7,-3,10,-1,0,-1,0,-1,-1,-1,0,-1
KR_6753892275,420,1,31,12,1,0,1,1,1,3,4,-1,1,0,0,1,1,1,0,1,0,2,142,1,-3,2,4,0,1,1,1,1,-1,4,-1
KR_6755640430,420,-5,-83,-12,-9,-1,2,1,-1,2,1,1,3,4,-7,7,0,-1,1,0,0,-12,2,5,-8,3,-4,0,-1,-1,1,-1,1,1,-1
KR_6528254261,420,-1,-75,25,-4,1,0,1,-4,7,3,0,2,2,0,1,1,-1,2,1,0,-4,16,-5,-5,10,-5,0,-1,0,-1,-1,-1,0,-1
KR_6721164317,420,0,39,2,1,0,3,3,4,0,4,-2,3,1,0,1,1,-1,2,1,0,7,38,1,-5,4,1,0,1,1,-1,1,-1,5,-1
KR_6760497381,420,-1,-52,2,-7,0,2,2,-6,6,0,2,2,4,0,4,4,-3,4,1,1,-12,-9,3,-9,6,-5,0,-1,-1,-1,-1,1,5,-1
KR_6461688984,420,1,1,20,0,-2,2,0,1,3,4,0,2,2,1,0,1,0,0,0,0,1,-1,1,-5,4,-4,0,0,1,0,0,-1,3,-1
KR_6754158736,440,-5,-81,1,-11,1,0,1,0,2,2,-7,7,0,-4,5,1,-1,1,0,0,-18,-20,1,-3,2,6,0,-3,-1,-1,-1,-1,2,-1
KR_6765372499,420,-1,29,16,-9,1,1,2,-2,5,3,-3,4,1,-3,4,1,-2,2,0,0,-18,-123,-3,-4,7,1,0,-1,-1,1,-1,-1,1,-1
KR_6769211574,420,-3,31,-16,-6,-2,3,1,-3,4,1,4,1,5,-4,4,0,-1,2,1,0,-8,-115,2,-6,4,-4,0,-1,-1,1,-1,1,6,-1
KR_6726200720,420,-4,-35,-12,-2,-2,6,4,1,1,2,-1,3,2,3,3,6,-3,3,0,1,-1,8,7,-9,2,-2,0,1,-1,-1,-1,1,3,-1
KR_6764397240,420,-2,11,21,-10,0,0,0,0,2,2,-3,6,3,-4,5,1,-3,4,1,0,-3,-12,-2,-1,3,1,0,0,-1,1,-1,-1,6,-1
KR_6554474154,420,0,48,-34,6,1,3,4,-6,8,2,6,0,6,4,0,4,1,0,1,0,5,30,5,-6,1,2,0,0,1,0,-1,-1,4,-1
KR_6767894493,420,-9,-11,-40,-15,-2,2,0,-2,6,4,-4,5,1,-1,3,2,-6,6,0,0,-10,11,-2,-4,6,1,0,0,-1,1,0,1,2,-1
KR_6763885414,440,-2,-38,-4,2,-1,1,0,-4,5,1,1,2,3,6,1,7,0,0,0,0,9,-3,-1,-2,3,1,0,1,1,-1,1,1,4,-1
KR_6700686820,420,0,21,23,-5,-2,3,1,2,0,2,-4,7,3,-1,2,1,0,0,0,0,-8,-123,-4,-5,9,-4,0,-2,-1,-1,-1,-1,3,-1
KR_6769546475,420,-1,-44,1,0,-2,3,1,5,1,6,1,2,3,-2,2,0,-2,3,1,-1,0,9,4,-7,3,0,0,0,1,-1,0,-1,1,-1
KR_6554560803,440,-3,-67,3,-7,-1,2,1,5,1,6,3,1,4,-15,15,0,1,0,1,1,-8,-14,-4,-2,6,1,0,-1,1,0,-1,1,1,-1
KR_6761560436,420,0,72,-8,-6,-1,2,1,-6,11,5,0,1,1,0,4,4,1,0,1,0,-1,9,6,-7,1,2,0,2,-1,-1,1,1,1,-1
KR_6721223647,420,0,109,4,-3,3,1,4,0,2,2,-1,3,2,-2,4,2,-3,4,1,1,-11,-14,1,-5,4,-2,0,1,-1,-1,1,1,2,-1
KR_6765613562,420,-2,-46,-19,-3,0,2,2,-4,5,1,3,2,5,0,1,1,-2,2,0,0,-6,6,2,-7,5,-6,0,-1,-1,-1,-1,1,4,-1
KR_6752667778,420,-4,-74,-14,-17,-5,6,1,-4,4,0,-2,4,2,-7,7,0,1,0,1,0,-18,-51,-5,-2,7,12,0,-2,1,1,-1,-1,2,-1
KR_6763048458,420,-2,39,0,-6,-3,4,1,-3,6,3,-1,3,2,0,6,6,1,1,2,0,-9,1,0,-2,2,0,0,0,-1,0,0,-1,2,-1
KR_6603507258,420,1,21,0,0,1,0,1,-2,2,0,0,2,2,4,3,7,-3,3,0,0,-2,-39,-1,-7,8,-1,0,0,-1,1,0,1,6,-1
KR_6313860605,420,-4,-84,-31,-11,4,1,5,-2,3,1,-4,5,1,-6,7,1,-3,3,0,0,-10,-22,-6,0,6,0,0,-3,-1,-1,-1,-1,6,-1
KR_6437176716,420,-2,47,-17,-11,-4,4,0,1,4,5,-2,2,0,-6,6,0,0,2,2,-1,-9,8,-1,-7,8,3,0,-1,-1,-1,-1,-1,5,-1
KR_6561627705,420,2,-39,56,5,1,2,3,0,1,1,0,1,1,1,3,4,3,0,3,0,6,-9,-2,-4,6,0,0,-1,1,-1,-1,-1,6,-1
KR_6750003285,420,-2,-10,0,-2,2,1,3,-2,5,3,-6,6,0,-2,3,1,6,1,7,1,0,-1,0,-4,4,2,0,0,-1,-1,-1,1,1,-1
KR_6764112036,420,-3,-55,-1,1,-1,3,2,3,1,4,-1,1,0,1,2,3,-1,2,1,-1,-4,-164,2,-5,3,0,0,-1,-1,-1,-1,-1,4,-1
KR_6659130237,420,1,49,20,3,5,0,5,1,7,8,0,2,2,-3,5,2,0,1,1,0,-1,5,2,-8,6,1,0,0,-1,-1,0,1,4,-1
KR_6711166318,420,2,-31,12,5,-2,2,0,3,3,6,1,1,2,2,1,3,1,0,1,0,12,4,-2,-6,8,-5,0,-1,-1,-1,-1,1,5,-1
KR_6754078828,440,-4,-30,-12,-8,-1,2,1,1,1,2,0,2,2,-7,7,0,-1,1,0,0,-7,3,1,-3,2,1,0,-1,-1,-1,-1,-1,3,-1
KR_6760295229,420,2,27,-7,5,8,0,8,-3,4,1,-2,3,1,0,4,4,2,0,2,0,1,-1,4,-6,2,0,0,0,-1,1,1,-1,6,-1
KR_6766204638,420,0,-66,-20,-5,-1,3,2,0,3,3,-2,6,4,-3,7,4,1,1,2,0,-2,-20,0,-4,4,6,0,0,-1,0,0,1,2,-1
KR_6734883257,420,-1,4,-4,-2,1,0,1,-2,4,2,0,2,2,2,1,3,-3,4,1,1,3,9,-1,-5,6,0,0,0,-1,-1,0,1,2,-1
KR_6596684085,420,1,-21,-13,3,4,4,8,-4,5,1,5,2,7,-3,4,1,1,0,1,0,-2,-16,0,-4,4,0,0,0,-1,1,1,-1,2,-1
KR_6727514191,420,-1,9,-30,-5,-3,3,0,4,2,6,2,3,5,-3,3,0,-5,6,1,0,-4,-6,4,-8,4,-1,0,-2,-1,1,-1,-1,3,-1
KR_6743890411,420,-4,-45,-24,-7,3,1,4,-6,7,1,-2,2,0,-1,1,0,-1,1,0,0,-10,-139,0,-4,4,-6,0,-1,-1,-1,-1,-1,1,-1
KR_6755527757,420,-4,-85,18,-8,-5,6,1,0,4,4,-2,3,1,-4,6,2,3,2,5,0,-1,10,-1,-3,4,-3,0,1,-1,-1,-1,1,4,-1
KR_6693512301,420,2,-53,29,0,-1,3,2,1,1,2,0,4,4,0,6,6,0,0,0,0,3,5,4,-9,5,-5,0,-1,1,1,-1,-1,1,-1
KR_6768569404,420,2,37,-8,8,4,0,4,2,0,2,0,2,2,2,2,4,0,1,1,0,1,0,2,-7,5,2,0,0,1,-1,0,1,3,-1
KR_6763065936,420,-4,-81,2,-15,-2,2,0,2,0,2,-7,7,0,-1,3,2,-7,9,2,0,-15,-9,-3,-4,7,1,0,-2,1,0,-1,-1,4,-1
KR_6762829274,420,-3,-96,-28,-1,-5,6,1,3,3,6,-1,4,3,-2,2,0,4,2,6,2,10,-70,4,-6,2,10,0,-1,-1,-1,-1,1,5,-1
KR_6714264750,440,-6,-110,-24,-18,-3,3,0,-2,3,1,-8,8,0,-6,7,1,1,0,1,0,-17,5,0,-4,4,-6,0,-1,-1,1,-1,-1,2,-1
KR_6768568822,420,-4,-68,0,-5,-2,5,3,1,2,3,0,2,2,-2,4,2,-2,2,0,0,-11,-3,-1,-5,6,0,0,-1,1,-1,-1,1,6,-1
KR_6752954376,440,-1,-37,2,-3,-1,3,2,1,2,3,-5,5,0,1,2,3,1,0,1,0,5,-10,-6,-2,8,1,0,0,1,-1,0,-1,4,-1
KR_6741783780,420,-5,-4,1,-10,-5,5,0,-2,6,4,0,1,1,-2,4,2,-1,1,0,0,-12,-3,0,-2,2,0,0,-1,-1,0,-1,-1,4,-1
KR_6754055996,420,-1,40,12,-10,-1,2,1,-4,4,0,0,3,3,-4,4,0,-1,1,0,0,-8,7,-2,-3,5,-1,0,0,-1,-1,-1,-1,6,-1
KR_6685266506,420,-2,-47,-4,-4,1,2,3,2,1,3,-2,3,1,-1,7,6,-4,5,1,0,-9,2,1,-4,3,0,0,0,-1,1,0,1,2,-1
KR_6768496116,440,-2,-62,0,3,0,3,3,-1,4,3,0,9,9,4,0,4,0,1,1,0,-1,15,-1,-1,2,3,0,0,1,-1,-1,-1,3,-1
KR_6729608122,440,-1,8,24,-4,0,2,2,-1,2,1,-4,4,0,2,0,2,-1,1,0,0,3,6,0,-3,3,-1,0,-2,-1,-1,-1,-1,2,-1
KR_6764467952,420,-1,-48,31,-6,2,2,4,0,2,2,-6,6,0,-3,5,2,1,1,2,0,-7,-7,0,-3,3,-3,0,-1,-1,1,-1,-1,6,-1
KR_6768544268,420,-3,44,-20,-6,2,1,3,-5,7,2,2,1,3,-6,8,2,1,0,1,-1,-12,5,2,-6,4,2,0,2,-1,1,1,-1,6,-1
KR_6756435080,440,-3,-16,-12,-9,-2,3,1,-3,8,5,0,0,0,-3,10,7,-1,2,1,1,-8,-6,1,-3,2,-5,0,0,0,-1,-1,1,0,-1
KR_6762815068,420,-2,7,-13,-2,0,2,2,-2,2,0,0,5,5,0,1,1,0,0,0,0,-4,-26,-3,-2,5,5,0,-1,1,-1,-1,-1,6,-1
KR_6732391818,420,-1,-68,12,-1,-1,2,1,-2,4,2,-2,3,1,3,0,3,1,0,1,1,2,-32,-2,-2,4,20,0,-1,-1,-1,1,1,6,-1
KR_6692447936,420,-1,-63,-16,-1,1,2,3,0,1,1,3,1,4,-7,8,1,2,0,2,0,5,-33,0,-3,3,14,0,0,-1,1,-1,-1,1,-1
KR_6769549179,420,0,8,1,-6,-2,2,0,-4,7,3,-1,4,3,-2,4,2,3,0,3,0,-8,-2,-2,-5,7,-3,0,-1,-1,1,-1,-1,6,-1
KR_6736699503,420,-2,-49,-20,-6,1,3,4,0,5,5,-8,8,0,1,3,4,0,0,0,1,0,6,4,-8,4,-1,0,-1,-1,-1,-1,1,5,-1
KR_6767874316,420,-2,-18,8,-11,0,2,2,-3,6,3,-2,6,4,-5,8,3,-1,1,0,0,-11,-37,-3,-3,6,17,0,-1,-1,1,-1,-1,3,-1
KR_6753716038,420,-3,-37,-20,-14,-4,4,0,-3,5,2,-1,2,1,-5,5,0,-1,1,0,0,-18,-8,-2,-6,8,-1,0,0,-1,0,0,1,6,-1
KR_6638286828,420,-4,-27,0,-14,-3,4,1,-5,5,0,-3,5,2,-3,5,2,0,2,2,-1,-14,-12,-5,0,5,3,0,-1,-1,-1,-1,-1,5,-1
KR_6759997246,420,-3,-12,-10,-11,-1,2,1,-4,5,1,-4,6,2,0,2,2,-2,3,1,0,-9,-16,-5,-5,10,-1,0,-2,1,-1,-1,-1,3,-1
KR_6753938416,420,-1,-44,-2,-8,-7,7,0,2,1,3,-2,2,0,-2,6,4,1,0,1,0,-5,-8,-4,-2,6,0,0,-1,1,-1,-1,-1,1,-1
KR_6653554303,420,-3,-26,-43,-8,-1,1,0,-3,9,6,-3,6,3,-1,3,2,0,1,1,-2,-12,2,5,-10,5,-6,0,-1,1,-1,-1,-1,3,-1
KR_6749119211,420,-3,-7,-39,-4,1,1,2,0,4,4,0,2,2,-4,4,0,-1,1,0,0,-12,-16,1,-5,4,-2,0,0,-1,-1,1,-1,6,-1
KR_6709413827,420,-3,-58,8,-12,1,1,2,-11,11,0,-2,4,2,1,1,2,-1,1,0,0,-18,-11,-4,-1,5,1,0,0,0,-1,0,-1,0,-1
KR_6754436439,420,-4,-17,-19,-8,-2,2,0,-1,3,2,0,1,1,-6,7,1,1,0,1,0,-5,6,0,-3,3,-2,0,0,1,-1,-1,-1,3,-1
KR_6739630127,440,-1,11,-11,-1,0,2,2,-2,6,4,-1,1,0,2,0,2,0,2,2,0,-2,-3,-3,-6,9,4,0,0,-1,1,-1,1,5,-1
KR_6557425032,420,-2,-27,-5,-2,1,1,2,1,4,5,-1,3,2,-4,4,0,1,2,3,0,-8,-2,1,-3,2,5,0,1,-1,1,1,-1,5,-1
KR_6455214917,420,0,31,12,-4,1,1,2,-6,7,1,2,4,6,-1,3,2,0,0,0,0,1,-7,0,-2,2,-2,0,0,1,1,0,-1,6,-1
KR_6722162294,440,0,65,-17,1,-2,3,1,0,4,4,0,2,2,1,4,5,2,1,3,0,3,1,-3,-6,9,4,0,0,1,-1,1,1,3,-1
KR_6609130248,420,-5,-70,-20,-10,-5,5,0,-2,2,0,1,2,3,-4,5,1,0,2,2,0,-13,86,-2,-4,6,-1,0,-1,-1,-1,-1,1,4,-1
KR_6764899739,420,-4,-6,2,-8,1,1,2,-5,6,1,-7,7,0,3,2,5,0,0,0,0,-9,5,-1,-5,6,-5,0,0,1,-1,-1,1,2,-1
KR_6738146229,420,3,-66,0,7,-1,3,2,0,1,1,6,4,10,-1,4,3,3,0,3,0,6,-7,-8,-1,9,4,0,0,-1,1,1,-1,6,-1
KR_6767066823,420,1,-10,49,0,1,1,2,-2,4,2,1,3,4,0,2,2,0,2,2,0,0,-2,-2,-3,5,-1,0,0,1,1,0,1,3,-1
KR_6497002350,420,-5,-72,-4,-6,-4,4,0,-1,3,2,-4,5,1,2,2,4,1,2,3,0,-2,-1,2,-9,7,-5,0,-1,-1,1,-1,1,5,-1
KR_6749982561,420,0,-12,-7,-2,2,2,4,-2,3,1,-4,4,0,3,1,4,-1,2,1,0,-1,-3,0,-7,7,-2,0,-1,-1,0,-1,-1,3,-1
KR_6768723424,440,-1,-63,-8,8,2,0,2,2,2,4,3,0,3,0,3,3,1,1,2,0,15,98,6,-9,3,2,0,0,-1,1,0,1,3,-1
KR_6755478010,420,-4,-63,-11,-6,2,1,3,0,3,3,-1,2,1,-5,7,2,-2,2,0,0,-1,0,6,-7,1,1,0,-2,-1,1,-1,-1,1,-1
KR_6674343134,420,-2,-13,-20,-2,1,1,2,1,1,2,-1,2,1,-4,4,0,1,1,2,0,-6,34,-4,-5,9,-6,0,1,1,1,1,1,3,-1
KR_6706739001,420,0,33,10,-12,-1,3,2,-3,4,1,-4,7,3,-1,2,1,-3,3,0,0,-22,-8,-2,-3,5,5,0,-1,1,-1,-1,-1,4,-1
KR_6633842846,420,1,4,8,3,1,0,1,-4,4,0,3,2,5,2,1,3,1,0,1,0,0,61,-1,-4,5,1,0,1,1,1,1,1,5,-1
KR_6760355819,420,-3,-35,18,-8,2,1,3,-4,4,0,-2,3,1,-3,4,1,-1,2,1,0,-8,-11,-3,-3,6,4,0,-1,-1,-1,-1,-1,2,-1
KR_6726934837,420,-1,29,-39,7,-2,2,0,2,5,7,0,3,3,7,1,8,0,1,1,0,14,6,2,-6,4,-1,0,-1,-1,-1,-1,-1,6,-1
KR_6761190778,420,1,-37,-4,-3,0,1,1,0,3,3,-3,5,2,-1,4,3,1,2,3,0,-4,1,-3,-2,5,2,0,-1,-1,-1,-1,-1,1,-1
KR_6768210366,440,-2,-73,-19,-9,0,1,1,-2,3,1,-5,6,1,-1,3,2,-1,2,1,0,-5,-108,3,-7,4,1,0,-1,-1,-1,-1,1,5,-1
KR_6767473552,420,-4,-108,-20,-9,-4,4,0,-2,3,1,0,2,2,-4,4,0,1,0,1,0,-6,-8,-1,-1,2,-2,0,-1,-1,-1,-1,-1,6,-1
KR_6767646608,420,-3,-33,-19,0,3,2,5,2,3,5,-5,5,0,-1,4,3,1,0,1,0,1,3,0,-4,4,2,0,-1,-1,-1,-1,1,5,-1
KR_6714763984,420,1,27,-8,3,1,3,4,0,1,1,4,1,5,1,0,1,-3,3,0,0,2,-2,-3,-4,7,-2,0,-2,-1,-1,-1,1,2,-1
KR_6756911159,420,1,-22,2,3,5,0,5,-5,5,0,-3,3,0,6,1,7,0,0,0,1,3,2,3,-8,5,-5,0,0,1,-1,0,1,1,-1
KR_6762119834,420,-3,-98,-23,1,0,1,1,-2,6,4,1,1,2,0,4,4,2,0,2,3,4,9,0,-5,5,-5,0,0,1,1,0,1,1,-1
KR_6546724311,420,-4,-2,-12,-8,-6,6,0,2,2,4,-2,6,4,0,2,2,-2,2,0,0,-8,311,1,-6,5,1,0,-1,1,-1,-1,-1,1,-1
KR_6758766035,420,-3,-53,4,-6,0,3,3,-3,6,3,-1,1,0,-1,4,3,-1,1,0,0,-11,12,-7,-3,10,-2,0,-1,0,-1,-1,1,0,-1
KR_6730513436,420,0,18,-9,0,-3,3,0,0,1,1,0,2,2,3,1,4,0,0,0,0,8,54,0,-5,5,6,0,1,1,-1,-1,-1,1,-1
KR_6756169766,440,-3,-39,8,-12,-3,5,2,-3,5,2,0,2,2,-6,9,3,0,0,0,0,-3,-2,-2,-4,6,-5,0,0,-1,1,0,-1,4,-1
KR_6650888012,420,-2,-16,-35,-6,4,1,5,-5,6,1,1,1,2,-6,7,1,0,1,1,2,-4,-4,-3,-1,4,-1,0,-2,0,-1,-1,1,0,-1
KR_6767486043,420,-1,14,-12,3,2,2,4,0,3,3,0,2,2,2,5,7,-1,1,0,0,3,23,0,-8,8,-1,0,0,-1,-1,-1,1,1,-1
KR_6760949433,420,-4,-41,-8,-14,-3,3,0,-9,9,0,-1,4,3,-2,4,2,1,0,1,1,-14,-44,-2,-4,6,16,0,-2,-1,-1,-1,1,1,-1
KR_6641752878,420,0,-62,-15,-5,-1,4,3,3,5,8,-4,4,0,-3,4,1,0,2,2,0,-6,-1,2,-6,4,0,0,-1,-1,0,-1,-1,4,-1
KR_6727634321,420,-2,33,-38,-2,5,2,7,-1,2,1,1,2,3,-5,6,1,-2,2,0,0,-8,-1,0,-4,4,0,0,1,-1,-1,-1,1,1,-1
KR_6499394202,420,2,12,-18,6,1,3,4,2,2,4,4,3,7,0,4,4,-1,4,3,-1,5,-15,-6,-7,13,7,0,2,-1,1,1,-1,6,-1
KR_6758141171,420,-2,-12,4,-1,-3,7,4,-1,1,0,3,0,3,0,2,2,0,0,0,0,0,-6,-1,-6,7,0,0,0,-1,1,-1,-1,5,-1
KR_6689735406,440,-3,-59,14,-2,-4,4,0,1,0,1,-4,5,1,3,0,3,2,3,5,0,-4,125,-2,-2,4,-4,0,1,-1,1,1,1,5,-1
KR_6755325542,420,-2,-63,-8,0,-2,2,0,2,0,2,-1,3,2,1,2,3,0,0,0,0,-4,-14,-1,-6,7,2,0,0,-1,-1,0,1,3,-1
KR_6730758756,420,-6,-145,-5,-17,-8,8,0,-2,3,1,-5,5,0,0,4,4,-2,4,2,0,-9,13,2,-5,3,-7,0,-2,-1,-1,-1,1,4,-1
KR_6487147450,420,2,-2,-10,-6,0,0,0,-6,8,2,0,1,1,0,5,5,0,1,1,0,-6,-2,-2,-5,7,-3,0,0,1,-1,0,-1,5,-1
KR_6474736877,420,2,2,-12,0,1,2,3,-7,7,0,0,2,2,6,3,9,0,1,1,0,-3,4,-3,-5,8,5,0,-1,-1,-1,-1,1,6,-1
KR_6695206786,420,-6,-90,-58,-10,-1,2,1,-6,6,0,-1,1,0,1,3,4,-3,5,2,0,-5,2,0,-5,5,-5,0,-2,-1,-1,-1,-1,1,-1
KR_6769015721,420,-3,-112,-28,-3,-3,5,2,-2,4,2,1,2,3,0,1,1,1,1,2,0,2,-2,2,-7,5,-5,0,-1,1,-1,-1,-1,4,-1
KR_6575196750,420,-5,-46,-22,-10,-2,3,1,-1,3,2,-3,6,3,-2,3,1,-2,2,0,0,-5,-5,-3,-4,7,0,0,-1,-1,-1,-1,-1,3,-1
KR_6740961169,420,1,50,-4,-2,1,2,3,1,1,2,-5,7,2,-2,4,2,3,0,3,-3,-7,7,-2,-7,9,-1,0,0,1,-1,0,-1,2,-1
KR_6754188357,420,-2,-27,-8,-3,2,1,3,0,3,3,-3,4,1,-3,4,1,1,0,1,0,2,118,-3,-4,7,-2,0,-1,-1,1,-1,-1,1,-1
KR_6755398700,420,-2,-29,0,-2,-1,1,0,-2,2,0,6,2,8,-6,10,4,1,0,1,1,-2,-128,2,-7,5,-4,0,0,-1,1,-1,1,1,-1
KR_6723160549,440,-3,-62,-23,-4,-2,4,2,-2,3,1,1,4,5,2,1,3,-3,3,0,1,-6,0,-1,-5,6,-1,0,0,1,-1,0,1,4,-1
KR_6578954080,420,-2,-35,-5,-9,-5,6,1,-4,5,1,-3,4,1,3,6,9,0,3,3,-1,-11,-4,-1,-6,7,-2,0,-1,-1,-1,-1,-1,5,-1
KR_6752840082,440,0,51,8,0,1,0,1,-4,4,0,2,1,3,1,1,2,0,1,1,0,-4,-15,0,-5,5,3,0,0,1,1,0,1,3,-1
KR_6760859458,420,-4,-22,-13,-14,1,2,3,-4,4,0,-11,12,1,-2,3,1,2,1,3,-1,-13,-240,2,-7,5,-3,0,-2,1,-1,-1,-1,1,-1
KR_6305744020,420,-5,-72,8,-13,-3,6,3,-2,4,2,-2,2,0,-5,5,0,-1,1,0,0,-9,12,0,-4,4,-10,0,-3,-1,-1,-1,-1,4,-1
KR_6706969067,420,2,-28,0,7,0,0,0,4,2,6,3,0,3,0,2,2,0,0,0,0,7,277,2,-4,2,-2,0,0,-1,1,0,1,5,-1
KR_6760875336,420,0,12,-16,2,-1,2,1,-3,4,1,6,0,6,-1,2,1,1,0,1,0,-2,2,6,-7,1,-1,0,0,-1,0,0,-1,5,-1
KR_6768206710,420,1,23,4,4,0,0,0,5,1,6,-3,5,2,1,1,2,1,2,3,-1,12,-98,0,-5,5,0,0,-1,1,1,-1,-1,5,-1
KR_6769377939,420,-2,-9,-24,-1,1,2,3,1,4,5,1,0,1,-4,7,3,0,1,1,0,-11,-5,0,-5,5,-1,0,0,-1,0,-1,1,1,-1
KR_6700099696,420,-3,-54,-19,-7,-5,5,0,3,1,4,-1,2,1,-2,5,3,-2,2,0,0,-2,-1,-1,-4,5,-2,0,-2,-1,-1,-1,-1,2,-1
KR_6763585692,420,0,-35,-8,-7,-2,4,2,0,3,3,-2,3,1,-2,4,2,-1,1,0,0,-3,-4,-1,-3,4,1,0,0,-1,1,1,1,1,-1
KR_6737909026,420,-5,-49,-16,-11,-4,4,0,-4,4,0,1,2,3,-4,5,1,0,0,0,0,-9,-12,-5,-1,6,1,0,0,1,-1,-1,-1,3,-1
KR_6748811062,420,-1,10,8,-8,-1,1,0,-3,5,2,-3,4,1,-2,3,1,1,3,4,1,-8,16,-2,-4,6,1,0,0,0,-1,0,1,0,-1
KR_6756149041,420,-4,-13,-12,-1,4,0,4,-6,9,3,-3,3,0,3,1,4,1,3,4,0,2,-3,1,-5,4,2,0,0,1,1,-1,1,3,-1
KR_6762072727,420,-3,-17,-1,-2,0,4,4,-5,8,3,6,1,7,-3,3,0,0,1,1,-1,-2,-1,2,-7,5,-3,0,-1,-1,-1,-1,1,5,-1
KR_6757891607,420,1,29,0,4,0,3,3,1,3,4,0,5,5,2,1,3,1,3,4,0,-2,-22,-4,-5,9,5,0,0,1,-1,0,1,5,-1
KR_6761174515,420,2,25,21,1,3,0,3,1,2,3,-2,2,0,0,2,2,-1,1,0,0,-3,-3,1,-9,8,4,0,0,-1,-1,1,-1,4,-1
KR_6761519959,420,2,-71,32,-7,-4,4,0,1,4,5,-2,4,2,-3,6,3,1,1,2,0,-9,-43,-3,-4,7,32,0,0,1,1,0,-1,5,-1
KR_6688025418,420,-2,1,-5,-6,2,1,3,-6,6,0,1,0,1,-3,3,0,0,1,1,0,-5,1,-2,-5,7,0,0,-1,-1,-1,-1,-1,1,-1
KR_6515258125,420,1,-78,-20,0,-1,3,2,5,1,6,2,0,2,-3,4,1,-3,3,0,0,5,1,0,-11,11,3,0,-1,1,1,-1,-1,3,-1
KR_6767844108,420,1,32,8,1,0,1,1,-2,3,1,-3,3,0,6,4,10,0,1,1,0,5,1,5,-7,2,0,0,0,1,0,-1,1,6,-1
KR_6763330703,440,0,25,4,-4,1,1,2,0,2,2,-5,5,0,0,3,3,0,0,0,0,-3,-3,2,-5,3,3,0,1,1,-1,1,-1,2,-1
KR_6696465343,420,0,66,4,3,3,0,3,0,5,5,-5,8,3,4,4,8,1,0,1,0,0,-14,3,-6,3,-2,0,0,-1,-1,1,-1,5,-1
KR_6749892110,420,-5,-86,-22,-4,-3,9,6,2,1,3,-5,8,3,4,5,9,-2,2,0,-3,5,306,4,-7,3,-4,0,-2,-1,1,-1,-1,1,-1
KR_6762860272,420,-4,-86,4,-9,2,3,5,1,0,1,-4,4,0,-4,5,1,-4,4,0,-1,-9,75,1,-6,5,1,0,-1,1,-1,-1,-1,1,-1
KR_6765296431,420,-4,-66,-32,-8,-2,3,1,3,1,4,0,1,1,-9,10,1,0,0,0,0,-2,1,4,-7,3,-6,0,-1,-1,0,-1,-1,6,-1
KR_6768800037,420,-2,35,-9,-7,-1,2,1,1,2,3,-4,8,4,0,2,2,-3,4,1,1,-5,-244,3,-8,5,-2,0,-1,-1,1,-1,1,1,-1
KR_6715685742,420,-1,-34,1,0,2,0,2,-5,6,1,3,3,6,1,1,2,-1,3,2,0,2,99,-1,-6,7,1,0,-1,1,-1,-1,-1,5,-1
KR_6754698221,420,0,1,4,-1,-1,2,1,-2,4,2,-2,3,1,4,2,6,0,0,0,1,3,333,3,-7,4,1,0,0,1,0,0,1,5,-1
KR_6697744057,420,-9,-60,-55,-11,-8,9,1,-1,3,2,0,2,2,-1,5,4,-1,1,0,0,2,1,-3,-1,4,0,0,-2,-1,-1,-1,-1,2,-1
KR_6753749090,440,-4,23,12,-6,-2,2,0,-1,2,1,1,2,3,-2,3,1,-2,3,1,0,-5,-8,-3,-3,6,-2,0,-1,-1,-1,-1,-1,6,-1
KR_6719634977,440,3,45,24,8,0,3,3,4,2,6,2,2,4,-1,1,0,3,1,4,0,11,-8,-2,-2,4,-1,0,0,1,-1,1,-1,1,-1
KR_6769400613,420,-1,21,4,-7,2,0,2,-7,7,0,1,3,4,-3,5,2,0,0,0,0,-16,0,1,-5,4,2,0,0,1,-1,-1,1,5,-1
KR_6736122118,420,3,-25,12,-1,1,4,5,0,2,2,-6,6,0,3,1,4,1,2,3,0,6,41,0,-4,4,1,0,1,-1,1,1,-1,5,-1
KR_6486997561,420,-1,-28,-17,1,1,1,2,3,1,4,-1,5,4,0,2,2,-2,2,0,0,-5,7,-3,-3,6,-4,0,0,-1,1,1,1,3,-1
KR_6760170659,420,-3,-8,-17,-2,3,1,4,0,1,1,-4,5,1,-1,3,2,0,0,0,0,0,0,7,-10,3,-4,0,-1,-1,-1,-1,-1,5,-1
KR_6729667632,420,0,19,39,-6,1,0,1,3,0,3,1,2,3,-9,9,0,-2,2,0,0,-9,-5,2,-7,5,-4,0,1,-1,1,1,-1,3,-1
KR_6759497491,420,3,18,-18,6,-1,1,0,7,0,7,-1,3,2,3,1,4,-2,2,0,0,8,-43,2,-9,7,19,0,0,-1,0,0,1,3,-1
KR_6753006984,420,-2,-64,-34,-2,0,1,1,-4,6,2,-2,2,0,1,5,6,3,2,5,0,-4,-8,-1,-3,4,4,0,-1,0,-1,-1,-1,0,-1
KR_6765828083,440,-2,24,10,-2,0,0,0,-4,7,3,1,2,3,2,1,3,-1,2,1,0,-6,-77,-1,-4,5,3,0,-1,-1,0,-1,-1,3,-1
KR_6763577103,420,-3,-126,-8,-7,-4,5,1,-1,2,1,1,1,2,1,2,3,-4,5,1,0,-1,-10,-2,-4,6,-5,0,-2,-1,-1,-1,-1,4,-1
KR_6688936646,420,0,-29,-12,4,1,3,4,3,1,4,2,0,2,0,4,4,-2,3,1,1,9,-3,0,-4,4,3,0,-1,1,1,-1,1,2,-1
KR_6733354677,420,-4,-35,-28,-5,-4,5,1,-3,7,4,4,1,5,-2,2,0,0,1,1,1,-3,5,-2,-5,7,0,0,0,-1,1,0,1,4,-1
KR_6762954467,420,-3,16,-16,-8,2,1,3,-5,5,0,-3,3,0,0,3,3,-2,2,0,0,-8,47,1,-2,1,-15,0,0,-1,1,1,-1,3,-1
KR_6683337045,440,2,5,-1,2,-4,4,0,3,3,6,1,2,3,-1,4,3,3,0,3,-1,8,0,-3,-7,10,4,0,-1,-1,1,-1,-1,2,-1
KR_6751726541,420,-4,-59,-17,-20,-2,3,1,-3,3,0,-7,9,2,-10,10,0,2,2,4,-2,-17,348,-4,-1,5,2,0,-2,-1,-1,-1,-1,3,-1
KR_6622063577,420,1,37,-8,1,6,0,6,-2,2,0,1,0,1,-6,6,0,2,2,4,0,-6,-21,0,-5,5,5,0,4,1,-1,1,1,5,-1
KR_6750761871,420,-3,-79,-32,-9,-4,4,0,0,3,3,-4,5,1,0,3,3,-1,1,0,0,-4,5,-1,-4,5,-7,0,-1,-1,1,-1,-1,5,-1
KR_6708503200,420,-3,-12,-19,-5,0,0,0,0,1,1,0,1,1,-3,4,1,-2,2,0,0,-7,-2,1,-3,2,2,0,-1,-1,-1,-1,-1,5,-1
KR_6761102314,440,-2,-60,1,1,-3,3,0,1,2,3,-2,2,0,4,3,7,1,1,2,2,6,-2,2,-5,3,1,0,-3,0,-1,-1,1,0,-1
KR_6665460254,420,-1,-8,9,-1,-3,6,3,3,0,3,-4,4,0,-1,1,0,4,1,5,0,0,0,0,-5,5,-4,0,1,-1,-1,1,-1,2,-1
KR_6590130312,420,0,39,-4,-7,3,1,4,-8,10,2,1,1,2,-3,3,0,0,0,0,0,-11,1,4,-7,3,2,0,0,-1,-1,1,-1,3,-1
KR_6744566098,420,-4,-42,-30,-4,1,0,1,4,2,6,-1,5,4,-3,7,4,-5,5,0,-2,0,7,3,-5,2,-6,0,-1,-1,-1,-1,1,2,-1
KR_6723099757,440,-4,-21,-9,-15,0,2,2,-4,4,0,-8,10,2,-2,3,1,-1,2,1,0,-16,4,6,-8,2,-2,0,-1,1,-1,-1,1,4,-1
KR_6769134906,420,-3,-62,16,-15,0,3,3,-3,3,0,1,3,4,-9,9,0,-4,5,1,-4,-24,-10,-7,0,7,-1,0,-4,-1,1,-1,-1,3,-1
KR_6768289094,420,-3,-38,0,-8,-5,5,0,1,2,3,-5,7,2,-1,1,0,2,1,3,0,-9,6,1,-3,2,1,0,0,0,1,0,-1,0,-1
KR_6718126869,440,-4,-3,17,-2,-4,5,1,-3,5,2,2,1,3,3,2,5,0,0,0,0,-6,1,0,-1,1,1,0,0,1,1,0,1,3,-1
KR_6684098696,420,-1,-53,0,0,-3,3,0,1,3,4,0,5,5,2,1,3,0,0,0,-1,0,-10,-1,-3,4,-2,0,-1,0,0,-1,-1,0,-1
KR_6756139710,440,-1,-27,4,-4,1,4,5,-5,6,1,0,1,1,-1,4,3,1,0,1,0,2,1,1,-4,3,2,0,0,-1,-1,0,-1,4,-1
KR_6759840071,420,0,-19,21,-3,-5,6,1,-5,9,4,3,2,5,4,4,8,0,1,1,0,-2,-3,-1,-5,6,-1,0,2,-1,1,1,1,6,-1
KR_6736081618,420,0,-45,-3,-1,0,2,2,1,4,5,-1,4,3,-3,7,4,2,0,2,0,-1,-18,2,-6,4,11,0,-1,0,-1,-1,1,0,-1
KR_6766999165,420,-1,-11,32,-4,0,1,1,2,1,3,-2,3,1,-5,5,0,1,1,2,0,-8,3,-5,-1,6,-1,0,-2,1,-1,-1,1,2,-1
KR_6602920386,420,-3,-12,-8,-19,0,1,1,0,2,2,-8,10,2,-11,11,0,0,0,0,-2,-24,-15,-8,0,8,-2,0,0,-1,-1,1,-1,1,-1
KR_6757965575,420,-1,-60,25,-5,0,1,1,-2,4,2,2,3,5,-3,6,3,-2,6,4,0,-2,8,4,-8,4,-4,0,0,0,1,0,-1,0,-1
KR_6761167549,420,-1,41,13,-14,-2,3,1,-2,4,2,-7,9,2,0,1,1,-3,4,1,0,-12,2,1,-7,6,3,0,0,1,-1,0,-1,6,-1
KR_6730835088,440,-8,-108,-47,-20,-2,3,1,-4,5,1,-5,5,0,-8,8,0,-1,3,2,0,-17,0,9,-9,0,-2,0,-2,-1,-1,-1,-1,5,-1
KR_6696757541,440,1,3,4,-3,-1,2,1,5,3,8,0,2,2,-7,8,1,0,1,1,-1,-9,-2,1,-8,7,-6,0,0,-1,1,1,-1,3,-1
KR_6741085935,420,-2,-9,-19,-1,0,1,1,-5,6,1,-3,8,5,3,2,5,4,0,4,2,2,2,0,-6,6,-4,0,2,-1,1,1,1,2,-1
KR_6607705512,420,-2,-47,1,-1,-2,3,1,-2,6,4,1,0,1,1,4,5,1,0,1,0,5,-18,4,-10,6,3,0,-1,1,1,-1,1,3,-1
KR_6730352470,420,-3,-79,-17,-7,-3,4,1,-5,5,0,0,3,3,1,1,2,0,0,0,0,-7,277,-1,-2,3,-4,0,-2,-1,-1,-1,-1,5,-1
KR_6648417111,440,0,48,-12,3,-2,3,1,-5,7,2,11,0,11,-2,2,0,1,2,3,0,8,-2,1,-5,4,0,0,0,-1,1,1,-1,4,-1
KR_6719456799,420,-3,-44,2,-10,1,0,1,0,1,1,-6,7,1,-4,5,1,-1,2,1,0,-5,-5,1,-5,4,-3,0,-1,-1,-1,-1,-1,2,-1
KR_6764549451,420,0,-27,24,-2,0,2,2,-5,6,1,2,2,4,0,3,3,1,1,2,0,-4,4,0,-3,3,-1,0,1,1,1,-1,-1,4,-1
KR_6756310342,420,0,-25,-7,-4,0,2,2,-6,7,1,2,0,2,1,0,1,-1,2,1,0,-9,-22,2,-3,1,4,0,-1,1,-1,-1,-1,1,-1
KR_6769514163,420,-4,-76,-21,-5,-5,5,0,2,0,2,2,3,5,-6,7,1,2,0,2,0,-3,-118,-1,-5,6,-4,0,0,-1,1,-1,-1,3,-1
KR_6305920509,420,-2,4,20,-13,-2,2,0,-3,4,1,-2,4,2,-6,8,2,0,2,2,-1,-13,-10,-4,-1,5,2,0,-3,-1,-1,-1,-1,4,-1
KR_6752722675,420,0,1,1,-5,-1,2,1,-2,4,2,-3,6,3,2,3,5,-1,1,0,-1,-2,1,-5,-5,10,-1,0,1,-1,1,1,-1,1,-1
KR_6767383267,420,-5,-49,-36,-13,-4,4,0,-3,5,2,-3,3,0,-5,8,3,2,1,3,-1,-17,-27,0,-4,4,-1,0,-1,-1,1,-1,-1,3,-1
KR_6687191072,420,-1,3,-22,-2,3,1,4,-2,3,1,-1,3,2,-4,4,0,2,0,2,0,-12,-13,-3,-6,9,5,0,1,-1,1,-1,1,1,-1
KR_6633171034,420,-1,-47,-3,1,-1,2,1,1,1,2,2,0,2,-1,3,2,0,1,1,0,6,2,3,-7,4,2,0,0,1,-1,0,-1,4,-1
KR_6714132216,440,0,6,8,-1,-4,5,1,0,4,4,3,2,5,-2,2,0,2,0,2,0,6,0,-1,-5,6,-2,0,0,1,1,0,1,3,-1
KR_6680102234,420,0,0,7,-4,-4,5,1,4,0,4,-3,4,1,0,1,1,-1,1,0,-1,-1,-97,0,-6,6,0,0,-1,0,-1,-1,-1,0,-1
KR_6701746920,440,3,49,-12,8,0,0,0,0,1,1,1,2,3,4,0,4,3,1,4,0,11,2,1,-5,4,6,0,1,1,-1,1,-1,2,-1
KR_6738344613,420,-1,-76,16,-2,0,0,0,-4,8,4,-2,3,1,2,0,2,2,2,4,0,1,-8,-2,-3,5,1,0,-1,1,-1,-1,1,1,-1
KR_6661938815,420,-3,-20,-6,-12,-4,4,0,-5,6,1,-1,2,1,0,2,2,-2,2,0,0,-11,-37,0,-4,4,17,0,-1,-1,-1,-1,1,1,-1
KR_6760482566,420,-3,48,-29,-3,-3,4,1,1,2,3,1,4,5,-2,5,3,0,2,2,0,1,-29,-3,-2,5,-1,0,0,1,-1,0,-1,1,-1
KR_6768344641,420,-5,-49,-20,-14,-4,5,1,-6,7,1,0,5,5,-4,7,3,0,1,1,-1,-15,6,2,-8,6,-1,0,-1,1,-1,-1,-1,6,-1
KR_6740370778,420,-3,-9,-6,-6,6,0,6,-2,3,1,1,1,2,-8,8,0,-3,4,1,0,-11,6,1,-6,5,-4,0,0,-1,1,-1,1,2,-1
KR_6761955881,420,0,-85,16,2,0,2,2,-2,2,0,1,2,3,3,2,5,0,2,2,0,6,-7,2,-5,3,-2,0,-1,1,-1,-1,1,4,-1
KR_6642860507,420,1,-23,13,5,-1,3,2,0,3,3,0,2,2,5,2,7,1,0,1,0,6,3,-4,-4,8,-1,0,-1,-1,-1,-1,1,5,-1
KR_6714188762,440,2,-8,6,-8,-3,5,2,-2,2,0,-3,8,5,1,1,2,-1,2,1,0,6,25,0,-6,6,-11,0,-1,-1,-1,-1,1,3,-1
KR_6741283080,420,-7,-53,-18,-11,-1,3,2,1,1,2,-1,3,2,-8,8,0,-2,2,0,0,-10,5,-1,-4,5,-2,0,-2,0,-1,-1,1,0,-1
KR_6756484111,440,2,3,12,3,2,1,3,1,0,1,1,0,1,1,2,3,-2,2,0,0,4,13,-1,-2,3,1,0,1,-1,1,1,1,6,-1
KR_6714607720,440,2,-12,19,3,2,2,4,3,1,4,-6,6,0,5,0,5,-1,2,1,1,-2,1,-1,-3,4,-1,0,-1,-1,1,-1,1,2,-1
KR_6711440471,440,-2,-55,-31,-4,-1,2,1,1,4,5,-5,7,2,-1,3,2,2,0,2,0,-2,-5,2,-5,3,-1,0,-1,1,0,-1,-1,2,-1
KR_6744597122,420,0,3,5,-3,2,1,3,-3,7,4,3,0,3,-5,7,2,0,0,0,1,-3,57,2,-6,4,-3,0,0,1,0,0,1,3,-1
KR_6768353338,420,-8,-108,-29,-15,-7,8,1,-2,2,0,-2,3,1,-3,4,1,-1,1,0,0,-11,10,-2,-3,5,3,0,-1,-1,-1,-1,-1,6,-1
KR_6684692223,420,-2,-28,3,-4,-5,7,2,0,3,3,-2,4,2,1,1,2,2,0,2,-1,6,191,-1,-3,4,3,0,-2,1,1,-1,-1,1,-1
KR_6761086802,420,1,37,-2,9,0,2,2,1,4,5,3,1,4,3,1,4,2,0,2,0,9,7,2,-6,4,0,0,0,-1,1,1,-1,6,-1
KR_6768235367,420,1,59,-34,0,1,1,2,0,3,3,-5,6,1,4,1,5,0,0,0,0,6,-16,-4,-4,8,-5,0,0,1,-1,0,1,3,-1
KR_6661257254,420,-7,-56,-26,-13,-3,3,0,-1,6,5,-5,5,0,-2,3,1,-2,2,0,0,-6,14,-4,-5,9,3,0,-1,-1,-1,-1,-1,6,-1
KR_6762179985,420,-7,-79,-4,-20,-2,2,0,0,0,0,-5,5,0,-9,9,0,-4,5,1,-1,-21,13,-4,-2,6,-2,0,-1,0,-1,-1,-1,0,-1
KR_6765653283,420,2,-44,-20,2,2,1,3,-1,3,2,1,1,2,0,2,2,0,0,0,0,4,5,-5,-3,8,1,0,0,-1,-1,0,1,3,-1
KR_6735529078,420,-6,-22,-40,-11,-3,3,0,-1,2,1,1,1,2,-4,6,2,-4,4,0,0,-15,-33,0,-5,5,-2,0,0,0,-1,0,1,0,-1
KR_6667111433,420,1,-11,16,1,3,0,3,-3,5,2,0,3,3,0,3,3,1,0,1,0,-4,-4,-4,-3,7,-3,0,0,1,1,0,1,1,-1
KR_6763015441,420,-5,-92,-29,-7,-3,3,0,-1,1,0,2,3,5,1,2,3,-6,6,0,0,-5,5,1,-4,3,-4,0,-3,-1,-1,-1,-1,5,-1
KR_6767414328,440,1,1,16,3,-1,3,2,2,2,4,-1,2,1,0,2,2,3,3,6,0,-4,-1,2,-6,4,-5,0,0,1,0,0,-1,5,-1
KR_6758877007,420,-3,-36,-16,-6,-2,4,2,0,2,2,0,0,0,-4,4,0,0,1,1,0,-2,-11,0,-6,6,2,0,-2,-1,0,-1,-1,3,-1
KR_6634568607,420,0,-16,24,3,5,0,5,1,1,2,-2,3,1,-2,4,2,1,3,4,1,-4,-8,-5,-3,8,2,0,1,1,-1,1,1,6,-1
KR_6720369352,420,-3,-75,-11,-4,0,2,2,-5,6,1,-2,2,0,1,1,2,2,0,2,0,-9,86,-5,-5,10,3,0,0,1,1,1,-1,6,-1
KR_6765414868,420,1,0,-23,-6,-1,1,0,0,2,2,0,6,6,-5,7,2,0,2,2,0,2,-3,2,-4,2,3,0,0,1,-1,-1,1,6,-1
KR_6753469341,420,-1,79,-27,-1,1,0,1,0,0,0,-5,5,0,-2,3,1,5,0,5,3,4,39,-2,-4,6,-18,0,0,-1,-1,0,1,1,-1
KR_6755181342,420,1,-7,18,-9,0,2,2,-3,5,2,-4,6,2,-2,4,2,0,1,1,0,-7,4,-6,-1,7,2,0,0,-1,1,1,-1,5,-1
KR_6756492708,440,-1,-10,-6,-10,-3,4,1,0,2,2,2,4,6,-9,9,0,0,0,0,0,-3,41,1,-7,6,2,0,-2,1,-1,-1,-1,3,-1
KR_6720506241,420,-4,-47,-1,-8,-1,3,2,2,2,4,-1,4,3,-8,9,1,0,0,0,-1,-19,-1,-2,-6,8,-2,0,-1,-1,1,-1,-1,2,-1
KR_6762709793,420,1,-40,16,1,-2,2,0,1,1,2,0,2,2,1,2,3,1,0,1,0,1,-9,0,-5,5,0,0,0,1,-1,-1,-1,5,-1
KR_6763120967,420,-1,18,-16,-3,0,0,0,5,1,6,-2,2,0,-3,4,1,-3,5,2,0,1,18,1,-5,4,-2,0,0,0,-1,0,-1,0,-1
KR_6755994428,420,-5,-80,-39,-5,-3,3,0,3,3,6,-4,5,1,0,6,6,-1,2,1,1,-4,6,2,-5,3,-3,0,0,-1,1,0,1,4,-1
KR_6746849496,420,-1,-1,-16,3,-1,1,0,5,1,6,2,2,4,-4,4,0,1,0,1,0,8,113,-3,-6,9,-1,0,0,1,1,0,1,1,-1
KR_6647260834,440,1,25,12,3,-1,3,2,1,2,3,3,3,6,1,0,1,-1,1,0,2,9,8,4,-4,0,-1,0,1,1,0,1,1,6,-1
KR_6759646314,420,-1,-23,16,-3,2,2,4,-1,2,1,-1,4,3,-5,5,0,2,1,3,0,0,-19,-7,-2,9,1,0,-1,-1,1,-1,-1,2,-1
KR_6680052664,420,-1,-14,-1,3,3,0,3,0,2,2,2,0,2,-1,1,0,-1,2,1,0,3,62,1,-3,2,3,0,-1,1,-1,-1,1,6,-1
KR_6738240663,420,-1,-26,9,-8,-1,2,1,-6,11,5,2,2,4,-3,3,0,0,1,1,0,-16,3,0,-5,5,-1,0,-1,-1,-1,-1,-1,6,-1
KR_6688371080,420,-5,-78,-8,-11,-1,3,2,-3,6,3,-1,2,1,-3,4,1,-3,3,0,1,-8,-44,-1,-2,3,16,0,-2,-1,1,-1,1,2,-1
KR_6766842883,420,0,10,20,-1,0,2,2,-2,4,2,4,1,5,-3,3,0,0,0,0,0,-5,-29,2,-3,1,3,0,1,1,1,1,-1,6,-1
KR_6738865503,420,0,-37,46,-8,-4,5,1,-5,11,6,-3,4,1,4,2,6,0,0,0,0,-11,3,-1,-6,7,-4,0,-2,1,-1,-1,-1,1,-1
KR_6750832509,420,-5,-98,-5,-9,-6,6,0,-6,8,2,1,2,3,-1,3,2,3,0,3,0,-2,1,4,-6,2,1,0,-1,1,-1,-1,-1,1,-1
KR_6725408909,420,-4,-93,15,-8,1,2,3,0,1,1,-4,5,1,-4,8,4,-1,1,0,-1,-12,-8,-1,-3,4,-6,0,-1,1,-1,-1,-1,4,-1
KR_6603677659,420,-3,23,-17,-3,1,0,1,-4,4,0,0,1,1,-1,3,2,1,2,3,0,-4,35,0,-4,4,-11,0,0,-1,-1,0,-1,5,-1
KR_6743817728,420,2,3,-8,2,1,1,2,1,1,2,2,1,3,-2,3,1,0,0,0,-1,0,-2,3,-7,4,-5,0,0,0,0,0,-1,0,-1
KR_6764060157,420,-6,-97,-8,-11,-3,4,1,-2,2,0,-2,8,6,-2,5,3,-2,2,0,0,-4,-30,-4,-3,7,27,0,-3,-1,-1,-1,-1,5,-1
KR_6638271450,420,-2,-49,-9,-6,-2,4,2,-1,4,3,-2,2,0,-1,4,3,0,1,1,-1,-1,-4,-1,-2,3,-3,0,0,1,-1,0,-1,1,-1
KR_6700258274,440,-6,-103,-8,-9,-2,2,0,-5,6,1,-1,2,1,2,0,2,-3,3,0,0,-4,2,1,-5,4,0,0,-3,1,-1,-1,-1,5,-1
KR_6748228566,420,2,-45,2,-7,-5,6,1,-1,3,2,2,3,5,-1,1,0,-2,2,0,-1,-9,3,2,-6,4,-4,0,-1,1,-1,-1,-1,2,-1
KR_6751083818,440,-2,-56,-8,2,-1,1,0,1,2,3,-3,3,0,6,0,6,-1,2,1,0,9,57,2,-5,3,0,0,-1,1,-1,-1,1,1,-1
KR_6765962263,420,-4,-40,-16,-11,2,2,4,-3,3,0,0,2,2,-9,9,0,-1,1,0,0,-14,3,1,-4,3,-1,0,-1,-1,1,-1,-1,4,-1
KR_6727759967,420,-2,-15,-25,2,-3,3,0,2,2,4,-1,2,1,3,3,6,1,0,1,0,10,1,-2,-5,7,8,0,-3,-1,-1,-1,1,5,-1
KR_6735612690,420,-6,-13,7,-10,0,2,2,-6,7,1,-5,5,0,2,1,3,-1,3,2,0,-9,6,-2,-4,6,-1,0,0,-1,1,0,-1,2,-1
KR_6759340860,420,-1,-65,-39,-2,0,0,0,-2,4,2,1,2,3,-3,3,0,2,0,2,0,2,42,-1,-7,8,-3,0,-2,1,-1,-1,-1,3,-1
KR_6645963754,440,-1,-58,-4,3,-4,7,3,1,1,2,-4,5,1,4,2,6,6,4,10,-1,-3,-7,-6,-3,9,-3,0,0,-1,-1,1,-1,3,-1
KR_6582553267,420,-4,-50,28,-7,-5,5,0,-3,4,1,-2,4,2,3,3,6,0,2,2,0,-1,3,-2,-3,5,-2,0,-1,-1,-1,-1,-1,4,-1
KR_6757922835,420,4,18,30,4,0,3,3,0,2,2,5,0,5,0,0,0,-1,1,0,0,-3,4,-1,-5,6,4,0,2,1,1,1,1,4,-1
KR_6749116123,440,-2,-61,12,-5,-3,7,4,2,1,3,-1,3,2,-2,4,2,-1,2,1,0,-3,10,6,-9,3,-9,0,0,-1,1,0,-1,3,-1
KR_6739451658,420,-3,-35,-31,-6,-9,9,0,5,6,11,-5,6,1,2,1,3,1,1,2,-2,-3,33,5,-8,3,-9,0,-2,1,-1,-1,-1,2,-1
KR_6704876247,420,0,14,0,-4,1,1,2,-2,4,2,-2,3,1,-1,2,1,0,1,1,0,-7,23,-1,-5,6,-4,0,0,1,-1,0,1,3,-1
KR_6738395524,420,0,-59,8,-6,-2,3,1,-4,8,4,6,1,7,-3,3,0,-3,3,0,1,-9,39,-4,-4,8,-20,0,0,0,0,-1,1,0,-1
KR_6765105352,420,-5,-98,-17,-12,-4,4,0,-3,5,2,-3,5,2,-3,5,2,1,1,2,1,-12,-5,0,-4,4,-2,0,-2,-1,-1,-1,1,6,-1
KR_6736368907,420,-1,-30,-16,0,2,3,5,-3,4,1,3,0,3,-3,5,2,1,2,3,1,0,9,4,-8,4,-1,0,-2,1,-1,-1,1,1,-1
KR_6662097940,420,-4,-5,-2,-8,3,1,4,-3,4,1,-2,5,3,-4,7,3,-2,5,3,1,-10,0,-1,-3,4,-1,0,-1,-1,-1,-1,-1,1,-1
KR_6710122644,420,-1,-35,-5,1,0,0,0,2,3,5,-1,2,1,-1,3,2,1,1,2,0,3,7,3,-6,3,-3,0,0,-1,1,0,-1,2,-1
KR_6757786010,420,-1,-29,-7,-6,1,1,2,-3,3,0,-2,5,3,-5,5,0,3,0,3,0,-8,8,2,-8,6,-7,0,-1,-1,-1,-1,-1,6,-1
KR_6766660678,440,-1,-17,8,-13,2,0,2,-9,15,6,-6,8,2,2,1,3,-2,2,0,-1,-12,-1,0,-1,1,1,0,0,0,1,-1,-1,0,-1
KR_6755332018,420,-3,-40,3,-5,-2,5,3,4,3,7,-3,5,2,-4,5,1,0,1,1,0,8,1,2,-4,2,-3,0,0,-1,0,0,1,2,-1
KR_6684812101,420,-3,-38,-16,-9,1,0,1,-1,3,2,-4,6,2,-3,5,2,-2,3,1,1,-9,0,-3,-4,7,-2,0,0,-1,1,1,1,6,-1
KR_6756236580,420,4,22,-8,2,4,3,7,-3,5,2,4,0,4,-1,2,1,-2,2,0,0,-8,10,1,-6,5,-3,0,0,1,1,1,1,2,-1
KR_6763329546,440,3,68,-6,11,0,3,3,6,2,8,6,1,7,-1,1,0,0,2,2,0,6,-104,5,-8,3,-8,0,1,-1,1,1,1,2,-1
KR_6767334506,420,-3,-44,1,-11,-2,4,2,-2,2,0,0,1,1,-8,9,1,1,0,1,0,-13,-6,-2,-2,4,0,0,0,-1,-1,-1,-1,6,-1
KR_6657853397,420,1,52,1,2,2,3,5,2,2,4,3,2,5,-3,4,1,-2,2,0,0,-3,-118,-3,-4,7,-4,0,0,-1,-1,0,-1,3,-1
KR_6196437657,440,2,0,-10,0,-2,4,2,0,0,0,-1,4,3,4,3,7,-1,3,2,0,1,-3,-3,-4,7,2,0,0,-1,-1,0,-1,2,-1
KR_6740315767,420,3,93,32,1,4,0,4,-3,5,2,1,2,3,1,3,4,-2,2,0,0,-4,193,3,-6,3,-1,0,0,1,1,1,1,5,-1
KR_6765488208,420,-2,-74,-35,-7,2,1,3,-6,7,1,-1,4,3,-1,5,4,-1,1,0,-2,-11,18,-3,-4,7,-3,0,-2,0,0,-1,-1,0,-1
KR_6729149575,420,-4,-43,-4,-18,-1,1,0,-11,12,1,-2,4,2,-1,2,1,-3,3,0,0,-29,-23,0,-2,2,-2,0,-3,-1,-1,-1,-1,6,-1
KR_6740072639,420,-2,-120,-13,-3,-3,4,1,-3,4,1,4,1,5,0,3,3,-1,1,0,0,-1,-25,-3,-2,5,0,0,-3,1,-1,-1,-1,3,-1
KR_6633365664,420,-1,26,-15,-3,-4,5,1,-1,2,1,-4,4,0,4,2,6,2,0,2,0,-3,-27,1,-5,4,1,0,-1,-1,-1,-1,1,6,-1
KR_6738068274,420,3,17,9,0,0,0,0,1,4,5,0,2,2,-1,2,1,0,1,1,0,5,-35,1,-8,7,33,0,-1,-1,-1,1,-1,4,-1
KR_6671533919,420,-4,-20,17,-18,-2,3,1,1,4,5,-7,7,0,-9,10,1,-1,4,3,-2,-33,-5,-5,-2,7,-2,0,-1,-1,1,-1,-1,1,-1
KR_6740199979,420,-5,-31,-40,-12,-4,4,0,-4,5,1,3,1,4,-1,3,2,-6,6,0,1,-8,7,-1,-3,4,-4,0,0,-1,1,-1,1,5,-1
KR_6607917566,420,-1,-24,-8,-2,-2,3,1,-4,6,2,7,1,8,-3,3,0,0,0,0,0,-10,-7,0,-7,7,2,0,1,1,1,1,1,6,-1
KR_6745254368,420,-4,-88,13,-14,-4,4,0,0,1,1,-6,8,2,-2,3,1,-2,2,0,-2,-23,0,1,-4,3,-3,0,-2,-1,-1,-1,-1,1,-1
KR_6764965922,420,2,62,-14,4,2,1,3,-6,6,0,3,0,3,4,3,7,1,3,4,0,5,8,2,-4,2,-1,0,3,1,1,1,1,5,-1
KR_6746644698,420,1,18,34,-1,0,1,1,-1,4,3,2,2,4,-1,2,1,-1,1,0,0,-4,22,-6,-3,9,2,0,0,0,-1,0,-1,0,-1
KR_6764202491,420,-2,-43,-3,-4,-6,8,2,0,2,2,3,1,4,-4,5,1,3,0,3,0,4,3,2,-5,3,-1,0,1,1,1,1,-1,1,-1
KR_6767542207,420,-4,-37,-25,-9,-1,5,4,-2,3,1,-6,6,0,0,2,2,0,1,1,0,-6,-49,5,-11,6,18,0,-1,-1,-1,-1,-1,1,-1
KR_6480186042,420,-5,-75,-21,-8,-2,5,3,-5,7,2,0,1,1,1,0,1,-2,4,2,-1,5,-10,0,-3,3,-1,0,-2,0,-1,-1,-1,0,-1
KR_6768756434,420,-2,-91,31,-9,0,1,1,-2,2,0,-3,3,0,1,0,1,-5,7,2,0,-8,1,-4,-2,6,-4,0,-1,-1,1,-1,-1,1,-1
KR_6769068917,420,-1,6,-24,1,4,0,4,-1,1,0,-8,8,0,6,1,7,0,2,2,0,3,-3,0,-3,3,-1,0,-1,-1,-1,-1,1,1,-1
KR_6730859698,420,-3,-132,-8,-6,-4,5,1,2,4,6,-1,4,3,-2,2,0,-1,3,2,0,-2,-150,1,-4,3,-2,0,-3,-1,0,-1,1,6,-1
KR_6702818219,420,-8,-116,-54,-12,-4,4,0,-1,4,3,-5,6,1,-4,6,2,2,0,2,0,-11,8,-1,-4,5,-7,0,-2,-1,-1,-1,-1,5,-1
KR_6765243622,420,-2,25,-3,-2,0,2,2,-1,2,1,-1,2,1,3,2,5,-3,4,1,0,3,0,3,-6,3,-1,0,-1,-1,-1,-1,1,4,-1
KR_6760191813,420,1,-92,29,-8,-2,2,0,-1,1,0,1,0,1,-3,4,1,-3,4,1,-1,-14,0,-3,-4,7,-3,0,0,-1,1,0,-1,5,-1
KR_6767193883,420,1,-6,6,3,-1,3,2,5,3,8,0,1,1,-2,4,2,1,0,1,1,5,24,2,-7,5,4,0,0,1,1,0,1,1,-1
KR_6767077424,420,-1,-16,26,-3,-1,2,1,-5,5,0,1,5,6,1,1,2,1,1,2,0,-10,-52,3,-9,6,21,0,-2,0,-1,-1,-1,0,-1
KR_6086975937,420,-4,-19,-16,-11,-3,3,0,-1,3,2,-1,2,1,-5,6,1,-1,3,2,0,-9,-12,-5,-5,10,-1,0,-1,-1,-1,-1,-1,4,-1
KR_6678049346,420,-6,-45,16,-15,0,1,1,-3,4,1,-3,3,0,-7,8,1,-2,2,0,0,-13,-23,-2,-3,5,-3,0,-1,1,-1,-1,-1,3,-1
KR_6711329991,420,-2,8,25,1,0,2,2,-4,4,0,4,2,6,-1,4,3,2,1,3,1,-5,0,-5,-4,9,3,0,0,0,0,0,1,0,-1
KR_6586588052,420,0,47,8,2,-2,3,1,0,7,7,3,2,5,1,4,5,0,1,1,1,-1,2,-4,-5,9,-1,0,1,-1,1,1,-1,3,-1
KR_6756154521,420,-6,-67,-14,-16,-4,4,0,-4,4,0,0,3,3,-8,9,1,0,0,0,0,-20,48,1,-5,4,-17,0,-2,-1,-1,-1,-1,3,-1
KR_6688900829,420,-2,-25,-18,-4,-6,6,0,1,0,1,0,2,2,-2,5,3,3,0,3,0,-1,-4,1,-5,4,3,0,-1,-1,-1,-1,-1,6,-1
KR_6643931803,420,-7,-37,-40,-10,-3,3,0,-3,4,1,0,3,3,-2,2,0,-2,2,0,0,-13,-12,-4,-8,12,-2,0,-1,-1,-1,-1,-1,5,-1
KR_6553874826,420,-1,-21,18,-6,2,1,3,-2,4,2,2,2,4,-4,4,0,-4,4,0,0,-7,22,-1,-5,6,-16,0,-1,-1,1,1,-1,4,-1
KR_6757899893,420,0,56,8,-3,0,0,0,0,3,3,0,1,1,-1,4,3,-2,3,1,0,-9,-8,-6,-2,8,8,0,0,1,-1,0,1,2,-1
KR_6733536600,420,2,0,2,6,3,0,3,-1,3,2,0,2,2,3,0,3,1,0,1,0,9,12,0,-3,3,0,0,-2,-1,-1,-1,1,5,-1
KR_6716209192,420,4,15,6,6,1,1,2,2,3,5,-1,5,4,4,1,5,0,3,3,0,6,7,2,-7,5,-3,0,0,-1,1,1,-1,4,-1
KR_6743490541,420,-1,-5,-16,-1,-2,2,0,-1,3,2,-2,3,1,1,3,4,3,0,3,0,-1,1,-1,-5,6,1,0,0,-1,-1,-1,1,6,-1
KR_6768018217,420,3,41,-4,7,-1,1,0,-1,3,2,0,1,1,7,1,8,2,0,2,0,8,121,1,-6,5,1,0,0,1,-1,1,1,2,-1
KR_6743217331,420,-2,12,-17,-6,2,1,3,-3,4,1,0,2,2,-3,6,3,-2,2,0,0,-11,3,-3,-3,6,-2,0,0,-1,1,0,1,6,-1
KR_6763675887,420,0,-5,-15,-4,1,3,4,0,2,2,-2,2,0,0,3,3,-3,3,0,0,-10,8,0,-6,6,0,0,1,-1,1,1,1,3,-1
KR_6690973296,420,0,-50,2,-3,-5,5,0,-1,4,3,-2,3,1,4,0,4,1,1,2,0,3,-17,-4,-2,6,-1,0,0,-1,-1,-1,1,1,-1
KR_6746040788,420,-3,-95,-8,-1,-2,2,0,2,0,2,4,1,5,-3,4,1,-2,2,0,0,1,-5,3,-7,4,-3,0,0,-1,-1,-1,-1,1,-1
KR_6759925889,420,0,14,-26,-2,-1,3,2,-2,2,0,1,0,1,1,1,2,-1,1,0,0,-3,-8,-4,-3,7,-1,0,0,0,-1,0,-1,0,-1
KR_6769101542,420,-2,-36,-28,-5,1,2,3,-2,2,0,-7,8,1,2,2,4,1,0,1,0,-3,3,4,-5,1,-3,0,0,-1,-1,1,1,4,-1
KR_6697420462,440,-5,1,-28,-8,1,1,2,-3,4,1,1,2,3,-4,6,2,-3,3,0,0,-17,-30,-1,-1,2,-4,0,0,-1,-1,0,-1,4,-1
KR_6740523922,440,0,-4,5,0,-3,3,0,0,1,1,0,1,1,2,0,2,1,1,2,0,5,-1,-1,-2,3,-4,0,1,1,-1,1,-1,4,-1
KR_6749443836,420,3,22,-4,8,-1,1,0,2,1,3,-1,1,0,7,2,9,1,0,1,0,5,-14,4,-6,2,-4,0,0,-1,1,1,1,6,-1
KR_6664919558,420,-1,-33,-12,2,-1,4,3,0,5,5,0,1,1,3,1,4,0,0,0,0,3,-3,0,-7,7,-4,0,-1,1,-1,-1,1,1,-1
KR_6757918076,420,0,-2,12,6,0,1,1,4,1,5,0,3,3,2,3,5,0,1,1,0,8,1,-1,-5,6,1,0,1,1,1,1,1,5,-1
KR_6740839947,420,-1,11,4,8,1,0,1,6,0,6,1,4,5,0,1,1,0,0,0,3,8,-1,3,-6,3,4,0,-1,1,1,-1,1,1,-1
KR_6605687555,420,-2,-28,-6,-9,0,2,2,2,3,5,-6,7,1,-4,7,3,-1,1,0,0,-6,4,-1,-5,6,-6,0,0,0,1,0,-1,0,-1
KR_6767537850,420,-1,37,-24,2,-1,2,1,3,1,4,-1,4,3,1,2,3,0,1,1,0,5,-2,3,-5,2,-1,0,0,-1,-1,-1,1,1,-1
KR_6742728423,420,-2,-6,-29,-11,0,0,0,-4,5,1,-4,6,2,-3,4,1,0,0,0,0,-9,-20,-4,-3,7,4,0,-1,-1,-1,-1,-1,5,-1
KR_6675014661,440,0,17,-8,-8,-2,4,2,-2,3,1,-4,5,1,2,3,5,-2,2,0,1,-6,1,-5,-1,6,0,0,0,-1,-1,-1,1,6,-1
KR_6769125899,420,-2,-8,-8,-2,-3,4,1,4,4,8,3,0,3,-5,6,1,-1,1,0,-3,7,23,2,-6,4,4,0,-1,1,-1,-1,-1,4,-1
KR_6764364819,440,-5,-102,4,-11,-2,3,1,-2,2,0,-6,6,0,-2,3,1,1,1,2,0,-15,-4,-2,-2,4,-3,0,-3,-1,-1,-1,-1,2,-1
KR_6763489495,440,2,51,7,2,3,0,3,1,1,2,-4,4,0,1,4,5,1,1,2,0,3,43,2,-7,5,-11,0,0,1,-1,-1,-1,5,-1
KR_6566194850,420,-2,-47,-16,-5,0,2,2,-6,7,1,1,4,5,1,6,7,-1,3,2,0,-3,-2,-2,-3,5,-4,0,-1,1,-1,-1,-1,6,-1
KR_6673885947,420,-4,-92,-35,-7,2,0,2,-3,4,1,0,1,1,-7,9,2,1,1,2,0,-18,35,-3,-7,10,-33,0,-1,-1,-1,-1,-1,2,-1
KR_6752672559,420,-7,-63,1,-15,-2,5,3,-5,6,1,-1,2,1,-3,5,2,-4,4,0,0,-18,-224,-1,-4,5,-3,0,-2,-1,1,-1,1,5,-1
KR_6697374177,440,-4,-97,-36,-7,-1,3,2,1,3,4,-6,7,1,-2,2,0,1,1,2,1,2,11,-5,-1,6,-1,0,0,0,0,-1,1,0,-1
KR_6733423696,420,-2,-56,3,-6,-5,5,0,1,0,1,0,6,6,-2,4,2,0,0,0,0,1,15,-3,-2,5,3,0,-2,-1,-1,-1,-1,6,-1
KR_6684091493,420,2,-36,15,-2,0,2,2,5,1,6,0,3,3,-5,5,0,-2,2,0,0,-5,1,1,-8,7,-2,0,-1,1,-1,-1,-1,6,-1
KR_6769105921,420,1,-25,4,4,0,2,2,1,1,2,0,2,2,3,1,4,0,0,0,0,7,2,2,-5,3,3,0,0,-1,1,0,-1,1,-1
KR_6762485536,440,-3,-83,-35,-7,4,1,5,-2,4,2,0,2,2,-10,16,6,1,2,3,-1,4,-9,-4,0,4,2,0,-3,-1,0,-1,-1,2,-1
KR_6738323455,420,-6,-144,20,-19,-3,5,2,-5,8,3,0,2,2,-9,9,0,-2,2,0,1,-26,-5,-3,-3,6,-3,0,-3,1,1,-1,1,4,-1
KR_6769089160,420,1,-35,15,0,-4,5,1,4,1,5,1,3,4,-3,4,1,2,1,3,0,9,-14,3,-5,2,0,0,-1,1,1,-1,1,6,-1
KR_6685180441,420,-3,26,-47,-9,-6,6,0,-2,2,0,-2,2,0,1,0,1,0,1,1,0,-7,-134,2,-4,2,0,0,-1,-1,-1,-1,-1,4,-1
KR_6732708362,420,0,56,16,-7,0,0,0,-2,4,2,-3,5,2,-1,6,5,-1,1,0,0,-9,-3,-5,-1,6,-2,0,-1,-1,-1,1,-1,3,-1
KR_6698992486,420,-5,-25,-63,-16,0,0,0,-9,10,1,-6,6,0,-3,6,3,2,0,2,0,-10,1,-1,-3,4,-6,0,-3,-1,-1,-1,-1,4,-1
KR_6754223816,420,2,38,4,2,3,0,3,0,1,1,-1,2,1,-2,2,0,2,0,2,0,2,22,5,-5,0,-2,0,0,1,-1,0,1,2,-1
KR_6763261016,420,2,40,0,4,7,0,7,0,4,4,1,1,2,-2,3,1,-2,2,0,0,5,-8,-2,-6,8,4,0,0,-1,1,1,-1,3,-1
KR_6726750973,420,-1,26,-5,-6,0,4,4,-2,3,1,-4,7,3,-1,4,3,1,1,2,0,-7,-53,2,-4,2,0,0,2,-1,-1,1,1,2,-1
KR_6711433305,420,-3,-70,9,-1,0,2,2,2,1,3,-3,4,1,3,2,5,-3,4,1,0,4,8,0,-2,2,-3,0,0,1,1,-1,-1,2,-1
KR_6632660736,420,2,23,21,-1,-1,1,0,-3,4,1,0,3,3,3,0,3,0,1,1,0,6,-5,1,-5,4,-5,0,1,-1,1,1,-1,2,-1
KR_6509641593,420,-1,-25,-17,0,-5,7,2,-1,1,0,-4,5,1,1,1,2,9,0,9,0,3,12,0,-4,4,-1,0,-1,1,-1,-1,-1,4,-1
KR_6764421296,420,-1,20,-27,-5,0,1,1,1,1,2,-6,7,1,0,4,4,0,1,1,0,-6,-12,-3,-3,6,7,0,0,-1,-1,0,-1,5,-1
KR_6769696457,420,3,-15,-4,8,6,1,7,2,4,6,3,1,4,-3,4,1,0,3,3,0,3,-16,-4,-4,8,0,0,0,1,-1,0,1,3,-1
KR_6761146282,420,-2,50,8,-12,-2,3,1,-3,8,5,-4,4,0,-4,5,1,1,2,3,0,-18,-2,2,-3,1,-2,0,0,1,-1,1,-1,2,-1
KR_6738940123,420,-2,33,-2,-1,-3,5,2,-2,4,2,-2,3,1,5,3,8,1,1,2,1,6,-2,4,-6,2,6,0,-1,1,-1,-1,1,6,-1
KR_6769260414,420,1,-42,-8,6,3,0,3,-1,1,0,2,2,4,3,1,4,-1,3,2,0,5,-10,-2,-4,6,3,0,0,0,-1,0,1,0,-1
KR_6688335347,440,-3,-52,-16,-1,4,0,4,-5,6,1,-5,8,3,3,2,5,2,0,2,-1,0,-39,2,-6,4,-4,0,-2,1,-1,-1,-1,3,-1
KR_6677723471,420,2,-2,4,2,2,1,3,6,3,9,1,0,1,-7,7,0,0,0,0,0,-1,-4,1,-5,4,1,0,1,-1,-1,-1,-1,1,-1
KR_6766641423,420,-4,-26,-1,-9,1,0,1,-2,5,3,-2,6,4,-4,7,3,-2,2,0,0,-7,-189,1,-2,1,-3,0,-1,-1,-1,-1,-1,5,-1
KR_6724623315,420,-3,-66,18,-4,0,1,1,-1,3,2,2,1,3,-6,7,1,1,0,1,0,-6,8,0,-4,4,-5,0,0,-1,1,-1,1,1,-1
KR_6679806890,420,-2,-37,-16,-7,-1,2,1,1,4,5,-3,3,0,-7,11,4,3,0,3,0,-11,-45,5,-7,2,11,0,-2,-1,-1,-1,-1,1,-1
KR_6681515770,420,-1,-6,20,-10,2,2,4,-2,4,2,0,2,2,-6,9,3,-4,5,1,-1,-19,14,1,-4,3,0,0,-1,-1,-1,-1,-1,1,-1
KR_6404622028,420,-2,-56,28,-4,-1,2,1,-4,4,0,0,3,3,-1,4,3,2,1,3,-1,-6,0,2,-6,4,-1,0,0,-1,-1,-1,-1,6,-1
KR_6734443033,420,-1,3,-21,-5,-2,2,0,-3,6,3,-1,2,1,1,1,2,0,1,1,0,-13,-66,0,-2,2,-1,0,0,-1,-1,0,-1,6,-1
KR_6748285166,420,2,56,8,3,1,1,2,0,0,0,1,3,4,2,0,2,-1,2,1,1,2,9,5,-7,2,-2,0,-1,1,-1,1,1,2,-1
KR_6730158785,420,-4,-38,20,-12,-9,10,1,2,3,5,-1,2,1,-3,4,1,-1,1,0,0,-10,0,7,-10,3,2,0,0,1,1,-1,1,1,-1
KR_6761368711,440,-2,11,0,-6,1,0,1,1,3,4,-6,6,0,-2,5,3,0,0,0,0,-12,-21,9,-11,2,2,0,-1,1,-1,-1,-1,1,-1
KR_6725926829,420,-9,-31,-44,-17,-1,2,1,-2,3,1,-7,7,0,-1,1,0,-6,6,0,0,-24,-23,5,-6,1,-5,0,-1,-1,-1,-1,1,3,-1
KR_6752618255,420,-2,-44,23,-8,-1,1,0,-4,7,3,-1,2,1,-3,3,0,1,0,1,0,-10,5,-3,-3,6,4,0,0,-1,-1,0,-1,4,-1
KR_6723001062,420,1,28,17,3,-1,1,0,3,0,3,2,1,3,-2,2,0,1,1,2,0,-1,4,-6,-4,10,-5,0,0,1,-1,0,1,1,-1
KR_6381808702,420,-5,-108,-20,-14,-1,2,1,-4,5,1,-2,4,2,-2,4,2,-5,5,0,0,-13,-9,-4,-2,6,-3,0,-1,-1,-1,-1,-1,2,-1
KR_6759505991,420,-2,-73,-41,-4,3,1,4,-2,7,5,-2,4,2,-4,4,0,1,0,1,0,-4,8,-1,-5,6,-1,0,1,-1,1,1,1,4,-1
KR_6741912046,420,-5,-53,-16,-6,1,3,4,1,3,4,-3,4,1,-4,6,2,-1,1,0,0,-5,295,0,-2,2,-2,0,-1,-1,1,-1,-1,2,-1
KR_6767179793,420,0,-3,-12,7,-2,3,1,0,4,4,6,0,6,0,2,2,3,2,5,0,4,12,0,-4,4,4,0,0,1,-1,1,-1,2,-1
KR_6733625250,420,-4,-56,-26,-6,-2,2,0,-3,3,0,-1,2,1,0,1,1,0,1,1,0,-1,264,-1,-3,4,2,0,-2,-1,-1,-1,-1,5,-1
KR_6703295307,420,-1,-36,9,-7,-4,5,1,-4,4,0,1,2,3,1,2,3,-1,2,1,0,-11,-2,-2,-4,6,-4,0,0,-1,1,0,-1,2,-1
KR_6694219333,420,2,-44,-4,4,-1,2,1,3,1,4,2,3,5,-1,6,5,1,0,1,0,10,0,0,-5,5,-1,0,0,-1,1,1,-1,1,-1
KR_6601564519,420,-1,-5,-13,-2,-2,5,3,1,4,5,2,0,2,-6,7,1,3,1,4,0,3,2,4,-6,2,4,0,-1,0,-1,-1,-1,0,-1
KR_6754844512,420,-2,-32,-5,0,-1,2,1,2,3,5,0,1,1,-1,3,2,0,1,1,0,0,295,-3,-4,7,-2,0,1,-1,1,1,1,6,-1
KR_6631552502,420,-4,-78,4,0,-4,4,0,2,3,5,2,3,5,1,3,4,-1,2,1,0,4,5,1,-6,5,-4,0,1,-1,1,1,-1,3,-1
KR_6374195270,420,1,-24,20,6,-1,2,1,3,0,3,2,2,4,2,1,3,0,2,2,0,7,0,0,0,0,0,0,0,1,0,0,-1,3,-1
KR_6722054023,420,-6,-106,-8,-7,-6,6,0,-1,2,1,1,2,3,0,4,4,-1,1,0,0,-3,-19,3,-7,4,-3,0,0,1,-1,-1,-1,3,-1
KR_6768518764,420,-3,0,-45,-2,1,2,3,1,2,3,-1,2,1,-1,3,2,-2,2,0,0,0,-234,2,-7,5,-2,0,-1,-1,-1,-1,-1,6,-1
KR_6715456853,440,-5,-97,-40,-9,-4,7,3,-5,5,0,1,1,2,-1,1,0,0,1,1,0,0,-16,-2,-3,5,0,0,-3,-1,1,-1,-1,3,-1
KR_6765302805,440,1,-48,-15,-2,0,2,2,-3,3,0,1,0,1,0,2,2,0,3,3,0,0,12,-2,-6,8,1,0,0,-1,1,0,-1,5,-1
KR_6759876155,440,-1,-90,12,-2,-1,2,1,1,1,2,-1,4,3,1,1,2,-2,2,0,0,-7,-9,-5,-2,7,1,0,0,1,-1,0,-1,2,-1
KR_6769605284,420,0,-58,22,-5,-2,2,0,2,0,2,-1,4,3,-3,5,2,-1,1,0,0,-6,-5,2,-8,6,-1,0,-2,1,-1,-1,-1,1,-1
KR_6769839715,420,-2,-56,-12,-7,5,1,6,0,2,2,-5,7,2,-7,7,0,0,1,1,0,-16,104,-1,-7,8,-5,0,1,-1,1,1,-1,1,-1
KR_6670711929,420,0,-24,18,-2,1,1,2,4,2,6,-9,11,2,-1,5,4,3,1,4,0,4,2,2,-5,3,-3,0,-2,1,-1,-1,1,1,-1
KR_6674539747,420,-1,33,20,1,-1,1,0,0,6,6,-1,3,2,3,0,3,0,1,1,0,-5,39,0,-2,2,0,0,2,0,1,1,1,0,-1
KR_6679901298,420,-3,-87,-8,-5,-4,5,1,0,1,1,-1,5,4,-1,2,1,1,1,2,0,3,-3,-2,-2,4,0,0,-1,-1,-1,-1,1,1,-1
KR_6749714130,420,2,-5,46,-1,-1,2,1,3,2,5,0,5,5,-3,6,3,0,2,2,0,1,354,-1,-5,6,0,0,0,1,1,0,-1,3,-1
KR_6748765742,420,-2,-7,-8,-6,-1,4,3,-6,8,2,2,1,3,-1,2,1,0,0,0,0,0,2,4,-5,1,-4,0,-1,-1,1,-1,-1,2,-1
KR_6209554819,420,0,24,25,-1,-1,1,0,-1,2,1,2,2,4,-3,4,1,2,0,2,0,-3,3,2,-6,4,-1,0,-1,-1,1,-1,-1,1,-1
KR_6570004271,420,-1,-53,12,-4,-8,8,0,-3,5,2,1,1,2,4,1,5,2,0,2,-1,-3,10,-3,-2,5,-3,0,-2,-1,-1,-1,-1,5,-1
KR_6768493182,440,-2,-78,-4,-9,0,1,1,2,0,2,-6,8,2,-4,5,1,-1,3,2,0,5,118,3,-5,2,1,0,-1,-1,1,-1,1,1,-1
KR_6767858899,420,1,11,20,5,-1,3,2,2,3,5,-4,4,0,5,3,8,3,0,3,-1,10,-6,0,-5,5,6,0,1,1,1,1,1,4,-1
KR_6761695899,440,2,7,28,5,3,0,3,1,1,2,0,1,1,-2,2,0,3,0,3,0,3,-148,5,-7,2,4,0,0,-1,1,1,1,1,-1
KR_6760351954,420,1,6,18,-6,-1,2,1,-1,4,3,1,1,2,-2,4,2,-3,3,0,0,-9,-9,-1,-4,5,1,0,-1,1,-1,-1,-1,6,-1
KR_6746882370,420,-2,70,-18,-5,1,1,2,-2,7,5,3,1,4,-7,8,1,0,1,1,-2,-8,-3,3,-5,2,7,0,1,-1,1,1,1,6,-1
KR_6747680455,420,2,-23,-4,10,0,1,1,3,1,4,1,0,1,4,0,4,2,3,5,0,12,-58,-4,-2,6,2,0,1,-1,-1,-1,1,4,-1
KR_6768542109,420,-2,-23,1,2,1,0,1,-2,4,2,-1,3,2,1,1,2,3,0,3,0,1,6,1,-7,6,1,0,0,1,-1,0,-1,5,-1
KR_6764712933,420,3,19,-51,7,5,0,5,3,2,5,-1,4,3,2,1,3,-2,3,1,0,7,2,2,-4,2,0,0,1,-1,1,1,-1,5,-1
KR_6196566667,440,0,44,48,-6,1,0,1,1,2,3,-3,5,2,-3,6,3,-2,2,0,1,4,11,2,-5,3,-2,0,0,1,1,0,-1,5,-1
KR_6767511341,440,-2,-3,-3,-4,1,3,4,2,3,5,0,2,2,-6,7,1,-1,1,0,0,-7,34,0,-2,2,-12,0,-1,1,1,-1,-1,4,-1
KR_6763175733,420,1,14,32,-2,0,1,1,-3,5,2,6,2,8,-4,4,0,-1,2,1,-2,-13,-1,-1,-5,6,-1,0,1,1,1,1,-1,3,-1
KR_6749322857,420,0,-22,20,0,2,1,3,0,2,2,-4,5,1,2,3,5,0,0,0,0,2,6,3,-6,3,-5,0,1,-1,1,1,1,2,-1
KR_6723052893,420,1,67,-10,2,-1,1,0,-5,7,2,5,0,5,4,2,6,-1,1,0,1,7,37,1,-5,4,-18,0,0,1,-1,1,1,2,-1
KR_6752731715,440,1,1,4,-8,-3,3,0,-1,2,1,-1,4,3,0,3,3,-3,3,0,-1,-7,-125,-2,-6,8,5,0,0,0,0,0,-1,0,-1
KR_6761084135,420,-2,23,-12,-4,-3,3,0,7,1,8,-2,5,3,-2,4,2,-4,4,0,0,0,-20,-3,-4,7,4,0,-1,-1,-1,-1,-1,2,-1
KR_6764126815,420,0,-77,9,-4,-3,3,0,0,2,2,-2,2,0,0,1,1,1,2,3,0,-4,-6,0,-4,4,0,0,-2,1,-1,-1,-1,4,-1
KR_6746063773,420,-4,27,-35,-8,-3,4,1,-1,3,2,-4,5,1,2,1,3,-2,2,0,0,-4,-23,-1,-2,3,1,0,-2,-1,-1,-1,-1,6,-1
KR_6643534970,420,-2,-32,16,-6,1,0,1,-5,9,4,-1,2,1,-1,3,2,0,0,0,0,-5,-5,-3,-4,7,-1,0,-2,0,-1,-1,1,0,-1
KR_6703363012,420,-1,-29,30,0,3,1,4,1,1,2,-4,4,0,0,2,2,0,1,1,1,2,-16,-1,-5,6,-3,0,0,-1,1,1,1,4,-1
KR_6625153987,420,3,-45,4,6,1,2,3,3,1,4,4,1,5,-4,6,2,2,1,3,0,8,-1,-2,-7,9,2,0,0,-1,1,1,-1,3,-1
KR_6721917596,420,1,6,-20,1,1,0,1,2,2,4,2,1,3,-4,4,0,0,0,0,0,-1,-2,-5,-4,9,6,0,1,1,1,1,1,5,-1
KR_6712710982,420,0,56,-12,-3,2,0,2,1,5,6,1,4,5,-7,8,1,0,0,0,-1,1,-2,1,-6,5,5,0,0,-1,-1,0,-1,4,-1
KR_6722964520,420,-2,-10,7,-4,-3,3,0,-3,5,2,0,0,0,2,1,3,0,1,1,1,-1,117,-1,-2,3,-2,0,-1,1,-1,1,1,4,-1
KR_6624197306,420,0,24,-8,-2,0,2,2,-5,8,3,0,1,1,2,2,4,1,1,2,-1,-3,7,-3,-5,8,-1,0,0,-1,-1,0,-1,2,-1
KR_6765941774,420,-2,-55,0,-8,1,2,3,-4,4,0,-5,5,0,1,1,2,-1,1,0,0,-11,8,3,-8,5,-1,0,0,-1,1,0,1,4,-1
KR_6764748792,420,-1,-24,-5,2,0,2,2,1,2,3,-1,4,3,2,3,5,0,3,3,0,0,-3,2,-8,6,-5,0,-1,1,-1,-1,1,6,-1
KR_6576196255,440,0,29,0,-10,3,2,5,-8,8,0,-1,5,4,-1,2,1,-3,3,0,0,-25,6,2,-5,3,0,0,1,-1,0,1,1,5,-1
KR_6735810310,420,-2,-16,33,-11,-4,4,0,-2,3,1,-1,4,3,-2,2,0,-2,4,2,0,-15,-62,-3,0,3,19,0,-1,1,1,-1,-1,1,-1
KR_6720896055,420,-7,-102,-30,-16,-8,10,2,-1,3,2,-3,4,1,-1,2,1,-3,3,0,-1,-14,10,1,-4,3,-2,0,-2,-1,-1,-1,-1,4,-1
KR_6730652461,440,-1,6,-16,-7,1,2,3,-3,7,4,0,1,1,-2,4,2,-3,5,2,1,0,-124,0,-5,5,1,0,-1,1,-1,-1,1,2,-1
KR_6768091664,420,1,-21,3,2,-1,2,1,1,2,3,-1,2,1,3,4,7,0,0,0,0,1,-7,4,-7,3,-1,0,1,1,1,1,1,5,-1
KR_6734348160,420,-3,-51,-29,-4,0,2,2,-3,4,1,-1,3,2,0,2,2,0,0,0,0,-3,8,3,-5,2,5,0,2,1,1,1,1,3,-1
KR_6651265845,420,-1,21,16,-2,-4,5,1,4,2,6,0,2,2,-1,3,2,-1,1,0,0,1,1,2,-3,1,-1,0,1,1,-1,-1,-1,6,-1
KR_6761257954,420,-3,-24,-3,-9,-7,7,0,2,0,2,0,2,2,-4,4,0,0,0,0,0,-5,22,-6,-1,7,2,0,-1,-1,1,-1,-1,1,-1
KR_6726868954,420,1,-30,-16,-1,1,3,4,-1,1,0,1,0,1,0,1,1,-2,2,0,-1,-4,-6,1,-5,4,-3,0,1,-1,1,1,-1,3,-1
KR_6769160688,420,-4,-16,-39,-9,-3,3,0,-1,4,3,2,0,2,-6,8,2,-1,2,1,0,-11,31,-3,0,3,-15,0,0,-1,-1,-1,1,5,-1
KR_6732857060,420,1,-2,3,4,5,1,6,2,5,7,0,2,2,-3,5,2,0,3,3,0,1,-37,2,-5,3,24,0,0,-1,-1,1,1,3,-1
KR_6753597899,420,0,8,-1,-7,4,0,4,-6,7,1,5,0,5,-9,9,0,-1,3,2,1,-10,-269,2,-6,4,-2,0,-2,-1,0,-1,1,3,-1
KR_6740956818,420,-1,-14,-1,3,4,0,4,2,2,4,-1,1,0,-2,4,2,0,1,1,0,-1,6,2,-5,3,-3,0,0,-1,1,-1,-1,3,-1
KR_6704660007,420,3,79,11,0,2,0,2,-4,5,1,2,1,3,0,3,3,0,0,0,0,-7,35,-4,-1,5,-2,0,0,1,1,0,1,2,-1
KR_6602891366,420,-4,-33,-43,-4,-3,4,1,-3,4,1,-2,2,0,2,1,3,2,2,4,0,3,-30,-4,-2,6,4,0,-1,1,-1,-1,-1,6,-1
KR_6685883993,420,-1,-23,-21,-3,-2,3,1,1,1,2,0,0,0,-3,3,0,1,1,2,1,-4,-3,2,-6,4,5,0,-1,-1,1,1,1,3,-1
KR_6690521238,420,-1,-48,-24,-5,-7,11,4,5,1,6,-5,6,1,2,0,2,0,0,0,-1,2,-3,-1,-4,5,-6,0,-1,1,1,-1,-1,4,-1
KR_6737316089,420,-5,-71,-2,-13,-7,8,1,1,1,2,-2,3,1,-3,6,3,-2,3,1,0,-1,-4,-1,-2,3,-2,0,-1,1,-1,-1,1,1,-1
KR_6722055763,420,-1,9,-28,-3,0,2,2,-6,7,1,2,1,3,1,3,4,0,2,2,1,-3,-64,-4,-5,9,5,0,-1,-1,-1,-1,1,5,-1
KR_6769852184,420,-3,17,-12,-13,1,1,2,-5,6,1,-3,7,4,-4,4,0,-2,2,0,-1,-26,-7,-1,-6,7,7,0,-1,-1,-1,-1,-1,5,-1
KR_6768083144,420,0,-35,-7,1,4,1,5,1,1,2,1,2,3,-3,5,2,-2,3,1,0,-6,-13,0,-3,3,1,0,-1,1,-1,-1,-1,6,-1
KR_6762604984,440,2,0,16,1,-1,2,1,0,0,0,1,3,4,0,2,2,1,1,2,1,4,28,6,-8,2,-31,0,-1,1,-1,1,1,1,-1
KR_6697631451,420,-6,-88,-28,-10,-4,6,2,3,3,6,-5,5,0,-5,5,0,1,0,1,-2,-9,41,0,-5,5,-14,0,-2,-1,-1,-1,-1,2,-1
KR_6566104599,420,-3,30,-36,-7,-1,2,1,-1,2,1,-7,10,3,0,3,3,2,2,4,-1,0,194,-6,-4,10,4,0,0,-1,-1,-1,-1,5,-1
KR_6629692342,420,-4,-100,-31,-7,0,0,0,-1,4,3,-2,2,0,0,5,5,-4,5,1,1,-2,4,4,-8,4,0,0,0,-1,1,0,1,1,-1
KR_6749181987,420,-3,-68,2,-4,-1,1,0,5,1,6,-1,2,1,-4,6,2,-3,3,0,0,1,-121,6,-9,3,-5,0,0,-1,1,1,1,5,-1
KR_6766717022,420,3,27,56,2,-2,3,1,0,3,3,2,3,5,1,3,4,1,0,1,0,-4,-8,0,-5,5,25,0,0,0,1,1,-1,0,-1
KR_6744604637,440,-1,-22,-16,-5,0,2,2,-3,5,2,-3,4,1,0,3,3,1,2,3,0,-6,-4,0,-2,2,-1,0,-1,-1,0,-1,1,1,-1
KR_6637042920,420,-3,-86,22,-5,0,1,1,0,1,1,-3,4,1,-3,4,1,1,0,1,0,-8,6,-2,-7,9,-4,0,-1,-1,-1,-1,1,3,-1
KR_6757135092,420,0,37,-15,5,0,1,1,0,2,2,2,1,3,2,2,4,1,0,1,0,3,-120,2,-5,3,0,0,0,1,-1,0,1,5,-1
KR_6763856189,420,1,26,-30,-2,1,2,3,-2,5,3,5,0,5,-3,8,5,-3,4,1,0,1,-37,-5,-2,7,0,0,-1,-1,-1,-1,-1,2,-1
KR_6761348517,420,-5,-56,0,-9,1,2,3,2,3,5,-3,6,3,-10,10,0,1,0,1,0,-9,3,-2,-4,6,-1,0,-1,-1,0,-1,-1,1,-1
KR_6768102971,420,-3,-20,-16,-15,-4,6,2,-6,7,1,0,5,5,-4,5,1,-1,3,2,-1,-12,1,1,-3,2,-6,0,0,-1,-1,0,-1,2,-1
KR_6720386508,440,1,-57,8,1,1,2,3,-1,2,1,-1,4,3,3,1,4,-1,1,0,0,0,18,-6,-1,7,6,0,0,0,-1,-1,-1,0,-1
KR_6765571300,420,0,54,44,-4,-5,5,0,-1,2,1,4,1,5,-2,3,1,0,1,1,0,-3,45,5,-8,3,-27,0,0,1,1,1,-1,6,-1
KR_6765018341,420,-1,-88,4,-4,-3,4,1,0,1,1,-2,3,1,1,1,2,0,1,1,0,-3,17,1,-2,1,-1,0,-1,-1,-1,-1,-1,6,-1
KR_6712170051,420,-3,-81,-29,-3,-3,3,0,-1,5,4,0,1,1,-2,4,2,3,0,3,0,-4,11,4,-7,3,-1,0,-1,0,1,-1,-1,0,-1
KR_6724131919,440,0,-22,8,-3,3,0,3,4,0,4,-5,5,0,-5,5,0,0,0,0,0,-2,-2,-2,-3,5,-4,0,1,-1,-1,1,1,4,-1
KR_6751494571,420,-2,23,-28,-1,2,1,3,1,3,4,1,1,2,-3,6,3,-2,2,0,0,-5,5,7,-8,1,-7,0,-1,-1,-1,-1,-1,2,-1
KR_6680829330,420,-3,42,5,-2,0,1,1,0,5,5,-2,3,1,-2,5,3,2,0,2,2,-5,11,-1,-6,7,-1,0,-1,1,-1,-1,1,4,-1
KR_6769506905,440,-2,-6,12,-6,1,1,2,2,1,3,-4,4,0,3,1,4,-8,10,2,0,-6,-4,-4,-4,8,-4,0,0,-1,0,0,1,4,-1
KR_6741085495,420,-8,-3,-39,-17,-3,3,0,5,2,7,-7,7,0,-10,12,2,-2,2,0,-2,-21,-22,-9,-4,13,-4,0,0,-1,-1,-1,-1,3,-1
KR_6683385281,420,-4,-96,-17,-7,1,1,2,-1,4,3,-1,3,2,-1,1,0,-5,6,1,0,-15,-8,-10,-2,12,0,0,-1,-1,0,-1,1,2,-1
KR_6766592773,420,2,17,27,1,1,2,3,2,0,2,4,1,5,-6,8,2,0,1,1,0,-7,11,-3,-1,4,0,0,1,0,1,1,-1,0,-1
KR_6715886924,440,-1,-72,6,-3,-5,5,0,0,2,2,1,0,1,0,3,3,1,0,1,0,-1,-7,-3,-2,5,2,0,-1,-1,-1,-1,1,5,-1
KR_6681090145,420,-4,-92,12,-11,0,2,2,-4,6,2,-1,2,1,-4,5,1,-2,3,1,0,-7,70,0,-8,8,2,0,-3,1,-1,-1,1,2,-1
KR_6769563138,420,-2,9,-24,-7,2,0,2,-7,8,1,-3,3,0,4,2,6,-3,3,0,0,-4,-20,-3,-5,8,2,0,-1,-1,-1,-1,-1,2,-1
KR_6704572969,420,0,-13,-13,1,4,1,5,-1,4,3,-1,2,1,1,1,2,-2,4,2,0,-1,-2,0,-3,3,1,0,1,1,-1,1,1,3,-1
KR_6730283127,420,1,15,-4,3,0,3,3,2,3,5,2,1,3,0,3,3,-1,2,1,0,2,50,6,-8,2,-22,0,3,1,1,1,1,6,-1
KR_6646376597,440,-3,11,-60,-7,1,1,2,4,0,4,-9,10,1,-1,3,2,-2,4,2,0,-6,0,1,-8,7,-2,0,-1,-1,-1,-1,-1,1,-1
KR_6761059503,420,-3,0,40,-9,-3,3,0,-5,5,0,-1,1,0,0,2,2,0,0,0,0,-11,-21,-3,-3,6,-4,0,0,1,0,0,-1,6,-1
KR_6767299776,420,-1,-52,4,1,0,1,1,3,0,3,-1,6,5,-2,4,2,1,2,3,0,2,3,2,-6,4,1,0,-1,0,-1,-1,-1,0,-1
KR_6636427171,420,-5,-12,-23,-13,-6,6,0,-7,8,1,1,1,2,0,4,4,-1,1,0,0,-14,4,1,-3,2,-1,0,-1,1,-1,-1,-1,4,-1
KR_6673734468,420,-1,-39,-16,1,-2,3,1,4,0,4,-1,3,2,0,1,1,0,0,0,0,6,1,4,-9,5,1,0,0,-1,1,0,-1,4,-1
KR_6623867265,420,0,8,-28,-3,0,1,1,-4,4,0,1,2,3,-3,4,1,3,2,5,0,-10,-1,3,-8,5,2,0,0,-1,-1,0,1,3,-1
KR_6756348445,420,-2,15,-36,2,-6,7,1,1,4,5,3,0,3,4,1,5,0,1,1,0,7,-1,1,-4,3,-3,0,-1,0,-1,-1,1,0,-1
KR_6769359202,420,-1,-1,22,-4,1,0,1,-3,3,0,-4,5,1,1,2,3,1,1,2,0,-1,6,-2,-4,6,0,0,2,1,1,1,1,3,-1
KR_6755977522,420,-2,-89,-6,-3,-4,4,0,-3,4,1,2,6,8,2,2,4,0,2,2,0,-1,6,-1,-3,4,-6,0,0,1,-1,1,-1,4,-1
KR_6764970062,420,-3,-64,8,-12,-1,4,3,-2,3,1,-5,7,2,-5,5,0,1,0,1,0,-10,-4,-2,-5,7,-1,0,-1,-1,-1,-1,-1,4,-1
KR_6349416157,420,-2,-56,0,-2,0,2,2,5,4,9,-2,6,4,-4,4,0,-1,1,0,0,-10,-22,2,-5,3,21,0,-2,1,-1,-1,-1,4,-1
KR_6760865577,420,-1,-58,12,-5,-1,3,2,2,0,2,-5,7,2,3,2,5,-4,4,0,0,1,4,-1,-5,6,-1,0,0,-1,1,-1,-1,4,-1
KR_6615638937,420,-5,-116,-5,-13,-3,3,0,-6,6,0,1,2,3,-4,4,0,-1,1,0,0,-14,-6,-1,-2,3,2,0,-2,-1,0,-1,-1,3,-1
KR_6712130443,420,-5,-18,-19,-9,-2,3,1,-1,1,0,-2,3,1,-3,3,0,-1,2,1,0,-10,-65,3,-7,4,6,0,0,-1,1,0,-1,2,-1
KR_6690708582,420,1,40,-12,5,0,3,3,-4,5,1,4,1,5,1,3,4,4,0,4,0,9,-8,-2,-1,3,1,0,1,1,-1,1,1,4,-1
KR_6766443724,420,-1,33,-19,1,2,1,3,0,3,3,3,0,3,-4,5,1,0,3,3,0,1,-7,1,-6,5,1,0,-1,1,-1,-1,-1,3,-1
KR_6196494690,440,-1,0,-13,-6,-1,1,0,-2,3,1,-1,3,2,-2,4,2,0,1,1,0,-8,114,-3,-4,7,3,0,0,1,0,0,1,3,-1
KR_6755028903,420,-5,-7,-36,-11,0,0,0,-2,2,0,-3,4,1,-4,5,1,-2,2,0,0,-8,126,2,-10,8,-4,0,0,-1,-1,0,-1,5,-1
KR_6643391990,420,-1,-34,-12,3,0,2,2,2,0,2,4,0,4,3,0,3,-6,8,2,0,2,-11,1,-3,2,-1,0,0,-1,1,1,1,1,-1
KR_6756301980,420,-5,-19,16,-15,-3,5,2,-3,5,2,-4,4,0,-6,7,1,1,0,1,0,-9,10,-3,-3,6,-3,0,0,-1,1,-1,-1,5,-1
KR_6760080482,440,-1,3,8,-10,-1,3,2,0,3,3,-2,2,0,1,2,3,-8,8,0,-1,-16,-49,-3,-2,5,0,0,0,0,-1,0,-1,0,-1
KR_6765420411,420,-2,24,-23,0,-5,10,5,3,0,3,4,0,4,7,3,10,-9,9,0,0,2,-2,3,-6,3,7,0,-1,-1,-1,-1,1,2,-1
KR_6699525263,420,-4,-49,16,-12,-5,6,1,0,3,3,-5,6,1,-3,4,1,1,0,1,0,-8,-2,-5,-3,8,0,0,-2,1,-1,-1,-1,2,-1
KR_6678092092,420,-1,-14,22,-1,-2,3,1,-3,5,2,6,1,7,0,2,2,-2,2,0,-1,-13,0,0,-4,4,0,0,0,-1,-1,0,-1,5,-1
KR_6766887271,420,1,23,-4,3,4,2,6,2,0,2,-1,5,4,0,4,4,-2,2,0,0,2,-19,-5,-1,6,-2,0,-1,1,-1,-1,1,1,-1
KR_6760437432,420,2,-4,-16,3,-6,7,1,-1,2,1,2,2,4,5,1,6,3,1,4,0,3,8,-1,-4,5,2,0,0,-1,0,-1,-1,6,-1
KR_6698671690,420,-3,-39,-8,-1,1,1,2,-6,6,0,0,0,0,0,3,3,4,0,4,0,-2,0,0,-8,8,2,0,0,-1,1,1,-1,5,-1
KR_6757795686,420,-3,-120,-10,-5,-3,3,0,-2,3,1,-1,1,0,1,0,1,0,0,0,0,0,-421,-1,-4,5,-2,0,-1,-1,-1,-1,-1,3,-1
KR_6718226044,420,1,-74,8,3,3,1,4,-1,3,2,0,3,3,1,1,2,0,0,0,0,7,-44,-2,-2,4,19,0,-1,1,-1,-1,1,2,-1
KR_6768905986,420,-1,-19,-8,-3,0,1,1,0,2,2,1,1,2,-2,6,4,-2,4,2,0,-2,10,1,-4,3,-2,0,-1,0,-1,-1,1,0,-1
KR_6642807728,420,-3,-1,-43,-4,3,1,4,-4,4,0,-1,1,0,0,2,2,-2,2,0,0,-11,45,-1,-6,7,-12,0,0,-1,-1,0,-1,4,-1
KR_6753210132,420,1,-65,28,-1,0,1,1,6,1,7,4,3,7,-8,11,3,-3,4,1,-1,-12,50,0,-11,11,-5,0,0,-1,1,1,-1,5,-1
KR_6768773383,420,-2,-4,-5,4,2,5,7,1,5,6,2,1,3,-1,4,3,0,1,1,0,6,-24,-8,-4,12,3,0,0,-1,1,1,-1,2,-1
KR_6767366224,420,-1,-41,-32,4,-1,2,1,1,1,2,1,0,1,3,1,4,0,0,0,0,6,16,5,-7,2,-5,0,-1,-1,-1,-1,1,4,-1
KR_6763138800,420,2,10,11,9,-4,6,2,4,2,6,6,0,6,2,3,5,1,0,1,0,18,2,1,-4,3,1,0,-1,1,-1,-1,1,5,-1
KR_6724180742,420,-4,-94,-27,-2,0,2,2,-3,6,3,4,4,8,-3,4,1,0,0,0,0,-1,48,-1,-5,6,1,0,-3,-1,-1,-1,1,2,-1
KR_6760257512,420,4,-30,8,9,-1,3,2,3,0,3,3,1,4,4,1,5,0,1,1,0,12,0,-1,-3,4,0,0,0,1,-1,1,1,3,-1
KR_6573390158,420,3,1,9,11,1,4,5,-1,5,4,2,0,2,10,1,11,-1,2,1,0,14,1,4,-5,1,-1,0,1,-1,-1,-1,1,3,-1
KR_6758280356,440,-5,-100,-10,-8,-2,2,0,2,0,2,-7,9,2,0,2,2,-1,1,0,0,0,6,3,-5,2,-1,0,-2,1,-1,-1,-1,3,-1
KR_6724934393,420,-5,-58,-24,-6,0,2,2,-6,8,2,-5,7,2,3,3,6,2,1,3,-1,-8,8,1,-5,4,-9,0,0,-1,1,1,-1,3,-1
KR_6768582497,420,-2,0,-32,-8,0,1,1,-3,6,3,-2,3,1,-2,4,2,-1,1,0,0,-10,-5,0,-6,6,-1,0,-1,1,-1,-1,-1,5,-1
KR_6569505462,420,0,-40,-3,-3,-2,3,1,-2,4,2,4,0,4,-3,4,1,0,2,2,0,1,-424,4,-6,2,-1,0,-2,1,1,-1,-1,1,-1
KR_6754984236,420,-3,-19,-18,-8,-1,1,0,0,4,4,1,1,2,-6,8,2,-2,3,1,0,-14,-7,-3,-6,9,1,0,-1,-1,-1,-1,1,2,-1
KR_6680365122,420,-2,-16,12,-7,-3,3,0,0,2,2,-2,4,2,-1,4,3,-1,2,1,0,-6,322,7,-8,1,0,0,1,-1,1,1,-1,4,-1
KR_6712744088,420,-5,-70,-20,-8,-4,6,2,-5,5,0,6,1,7,-2,5,3,-3,5,2,2,-1,-10,-4,-3,7,5,0,-1,-1,-1,-1,1,6,-1
KR_6760379915,420,0,-45,0,2,0,1,1,-4,6,2,1,0,1,3,1,4,2,0,2,1,6,2,1,-5,4,-3,0,0,-1,1,0,1,1,-1
KR_6759186354,420,-2,11,-16,-3,-1,2,1,-1,2,1,-1,2,1,1,1,2,-1,1,0,-2,-4,3,-4,-1,5,-4,0,-2,-1,1,-1,-1,6,-1
KR_6698255897,420,0,52,6,-7,3,1,4,-8,11,3,1,2,3,-2,3,1,-1,1,0,-1,-17,-62,3,-8,5,1,0,-1,-1,1,-1,-1,5,-1
KR_6711127023,420,-2,-24,-15,0,-1,1,0,-5,6,1,4,3,7,2,3,5,0,1,1,0,4,39,-2,-5,7,-22,0,-1,1,-1,-1,1,3,-1
KR_6685159802,420,0,9,-1,-2,-1,1,0,-1,3,2,0,2,2,-2,3,1,2,0,2,-1,-1,2,-1,-3,4,-5,0,0,1,0,0,-1,6,-1
KR_6736795159,420,1,32,21,1,4,1,5,5,1,6,1,1,2,-10,10,0,1,1,2,0,-4,-1,-2,-5,7,-4,0,-1,1,1,-1,-1,5,-1
KR_6618400426,420,0,40,18,-6,0,0,0,-3,4,1,-1,1,0,-1,2,1,-1,1,0,0,-6,4,-3,-6,9,-4,0,0,1,0,0,1,5,-1
KR_6622037790,420,-2,-37,-16,-6,-1,1,0,-4,5,1,0,3,3,-2,2,0,1,0,1,0,1,-6,0,-6,6,-3,0,-1,1,-1,-1,-1,3,-1
KR_6719387655,420,1,16,11,-9,-2,2,0,-5,10,5,1,1,2,0,3,3,-3,3,0,0,-16,-2,-3,-4,7,-1,0,-1,-1,1,-1,-1,1,-1
KR_6758772839,420,-4,-40,-12,-7,0,2,2,0,2,2,-6,8,2,-1,3,2,0,0,0,0,-10,49,1,-6,5,0,0,0,1,-1,-1,1,4,-1
KR_6672143436,420,-4,-43,-8,-6,-3,6,3,-2,3,1,-1,2,1,0,0,0,0,0,0,-1,-4,-5,-3,-2,5,-1,0,-2,-1,-1,-1,-1,2,-1
KR_6762463717,420,-1,22,-40,-2,-1,2,1,-3,3,0,-1,4,3,2,5,7,1,2,3,1,6,-1,0,-7,7,2,0,1,-1,1,1,1,2,-1
KR_6600168087,420,-2,-21,-13,-6,-4,4,0,0,4,4,-1,2,1,-1,2,1,0,1,1,0,0,12,1,-7,6,-5,0,-1,-1,-1,-1,-1,2,-1
KR_6695430789,420,-2,31,-8,-6,-2,5,3,-1,1,0,-1,2,1,-2,2,0,0,0,0,0,-5,-112,-4,-6,10,0,0,0,-1,-1,0,-1,2,-1
KR_6755595368,440,1,23,-24,-6,-1,2,1,1,3,4,1,3,4,-6,7,1,-1,1,0,0,-18,2,0,-5,5,0,0,1,-1,1,1,1,2,-1
KR_6715687750,440,-1,29,24,-1,-1,1,0,0,0,0,-2,3,1,1,2,3,1,2,3,0,-2,-2,2,-4,2,1,0,0,1,1,0,1,4,-1
KR_6750753827,420,-4,-76,-20,-9,-1,3,2,1,3,4,1,2,3,-7,12,5,-3,4,1,0,-8,1,-2,-2,4,-7,0,-1,-1,1,-1,-1,2,-1
KR_6769143335,420,0,5,3,0,0,1,1,1,3,4,-1,2,1,0,0,0,0,0,0,0,1,-5,3,-6,3,-3,0,0,-1,-1,1,-1,4,-1
KR_6741501333,420,-2,-4,-35,0,2,1,3,0,0,0,-4,4,0,2,0,2,0,1,1,0,3,13,1,-3,2,0,0,-1,-1,1,-1,-1,5,-1
KR_6754914302,420,0,-20,-13,-3,1,2,3,-3,5,2,1,1,2,-3,7,4,1,1,2,0,-6,-35,-9,-5,14,0,0,1,-1,-1,1,1,6,-1
KR_6753795413,420,-5,-64,-20,-3,-3,5,2,1,2,3,-3,4,1,3,0,3,-1,1,0,0,7,4,-3,-3,6,-1,0,-2,0,-1,-1,-1,0,-1
KR_6754078356,420,-3,-24,-40,-6,-3,3,0,-2,5,3,2,2,4,-3,3,0,0,1,1,0,-7,-1,0,-4,4,-5,0,0,-1,1,0,1,6,-1
KR_6711090273,420,-5,-86,4,-15,-3,6,3,-4,5,1,-4,5,1,-1,1,0,-3,4,1,0,-12,-144,-2,-4,6,0,0,-1,-1,1,-1,-1,3,-1
KR_6736122373,420,-7,-48,-7,-14,-1,3,2,-4,5,1,-7,8,1,-1,1,0,-1,2,1,-2,-4,-77,0,-4,4,-25,0,-3,-1,-1,-1,-1,2,-1
KR_6759139325,420,-3,-8,-12,0,-3,4,1,2,5,7,-4,5,1,0,3,3,5,0,5,0,2,129,8,-9,1,-2,0,0,1,-1,0,1,2,-1
KR_6617848131,420,-2,-26,7,-9,-4,4,0,-3,4,1,0,1,1,-1,3,2,-1,3,2,0,-9,38,-5,-4,9,-19,0,-1,1,-1,-1,-1,6,-1
KR_6617297405,420,1,-56,28,6,0,1,1,3,3,6,8,0,8,-5,6,1,0,1,1,0,-3,-4,0,-4,4,-1,0,-2,1,1,-1,1,2,-1
KR_6757091762,420,-1,-47,-12,-4,-4,5,1,-2,3,1,5,1,6,-3,7,4,0,0,0,0,-1,9,-1,-4,5,-5,0,0,-1,0,0,1,4,-1
KR_6766723812,420,-2,-7,5,-7,2,1,3,-1,4,3,-5,6,1,1,2,3,-4,5,1,0,-1,-13,-5,-3,8,-4,0,0,-1,-1,-1,1,3,-1
KR_6757569447,420,-1,-72,-39,-5,-3,5,2,1,2,3,-1,5,4,-3,4,1,1,1,2,0,4,36,3,-8,5,-5,0,0,-1,1,0,-1,3,-1
KR_6733415374,420,-6,-36,-8,-16,-2,4,2,-2,3,1,0,1,1,-11,12,1,-1,1,0,0,-21,-107,-1,-2,3,-4,0,-2,-1,-1,-1,-1,3,-1
KR_6765275708,420,-2,13,0,-4,2,1,3,-2,3,1,-2,7,5,-2,2,0,0,0,0,0,2,86,5,-9,4,-2,0,1,0,1,1,-1,0,-1
KR_6767475465,420,-2,-68,0,3,-2,3,1,-1,6,5,6,0,6,-1,1,0,1,1,2,0,13,-6,-1,-4,5,3,0,-1,1,1,-1,1,1,-1
KR_6767198060,440,-4,9,-36,-2,-2,2,0,-3,5,2,4,0,4,2,1,3,-3,5,2,0,-4,-8,-3,-1,4,2,0,0,-1,0,-1,1,1,-1
KR_6767849435,420,3,65,8,-5,-1,3,2,-2,3,1,5,0,5,-6,6,0,-1,2,1,0,-13,49,1,-6,5,-21,0,0,-1,1,1,1,4,-1
KR_6690407037,420,-3,-55,-3,-9,-1,3,2,0,1,1,-5,7,2,-2,3,1,-1,1,0,0,-8,131,-4,-4,8,0,0,-2,-1,-1,-1,1,6,-1
KR_6757936600,420,0,-7,5,3,-2,4,2,4,1,5,1,3,4,-4,4,0,4,0,4,0,-2,-11,-6,-4,10,7,0,0,-1,1,-1,1,3,-1
KR_6766701274,420,-5,-67,16,-6,0,0,0,-1,1,0,-2,4,2,1,2,3,-4,4,0,0,-1,-3,0,-4,4,-1,0,-1,1,1,-1,1,5,-1
KR_6765881425,420,-1,-36,-32,-2,-4,4,0,-4,4,0,7,0,7,-1,6,5,0,0,0,-2,-1,14,4,-6,2,-5,0,0,-1,-1,0,-1,1,-1
KR_6688498643,420,1,-9,-7,6,2,1,3,0,3,3,3,0,3,2,0,2,-1,1,0,0,1,5,5,-7,2,2,0,1,1,-1,1,-1,4,-1
KR_6701879608,440,0,41,24,-9,-8,8,0,4,0,4,-1,4,3,-2,4,2,-2,2,0,0,-8,-161,-3,-3,6,0,0,1,1,-1,1,-1,4,-1
KR_6651300469,420,-1,37,15,-1,0,0,0,1,2,3,-1,2,1,0,4,4,-1,2,1,0,-5,-21,-4,-4,8,-1,0,0,-1,1,0,-1,3,-1
KR_6762754541,420,-5,-43,-33,-11,-4,5,1,-1,3,2,-1,3,2,-5,5,0,0,0,0,-1,-11,-194,5,-6,1,-2,0,-3,-1,0,-1,-1,6,-1
KR_6675346078,420,-1,-23,12,-7,0,0,0,3,1,4,-6,7,1,-2,4,2,-2,2,0,0,-2,1,0,-4,4,-3,0,-2,-1,-1,-1,-1,3,-1
KR_6767158051,420,-3,-71,-40,-11,1,2,3,1,1,2,-8,10,2,-4,7,3,-1,1,0,0,-3,-61,0,-2,2,0,0,-2,-1,-1,-1,-1,5,-1
KR_6601682923,420,2,78,9,-4,2,0,2,-3,5,2,-2,4,2,-1,5,4,0,0,0,-1,-14,1,1,-8,7,3,0,1,-1,1,1,-1,2,-1
KR_6758666891,420,-4,-74,24,-13,-2,2,0,2,3,5,-5,5,0,-7,9,2,-1,1,0,-1,-15,-6,-1,-4,5,-2,0,-1,0,1,-1,-1,0,-1
KR_6533008230,420,-13,-111,-83,-15,-3,4,1,-5,5,0,-1,3,2,-6,8,2,0,2,2,0,-18,14,-6,-5,11,-1,0,-4,-1,-1,-1,-1,5,-1
KR_6678075367,420,-3,-73,1,-6,-3,4,1,-1,2,1,3,0,3,-4,4,0,-1,1,0,0,-7,-8,3,-8,5,-4,0,-2,-1,-1,-1,1,4,-1
KR_6761336831,420,-7,-45,-17,-17,-7,8,1,0,2,2,-2,3,1,-3,3,0,-5,5,0,0,-18,-249,1,-7,6,-2,0,0,0,-1,-1,-1,0,-1
KR_6619123623,420,-4,-66,-8,-10,-1,2,1,-6,6,0,-1,2,1,-2,4,2,0,1,1,0,-10,-12,-9,-1,10,1,0,-2,1,-1,-1,-1,2,-1
KR_6768788256,420,0,45,7,4,1,3,4,-1,5,4,1,1,2,-1,4,3,4,0,4,0,4,-5,1,-3,2,6,0,0,1,-1,-1,1,1,-1
KR_6647392657,420,-4,-36,-9,-6,0,3,3,-3,6,3,0,2,2,-5,6,1,2,0,2,0,-10,-5,-2,-2,4,-2,0,-1,1,1,-1,-1,5,-1
KR_6732571314,420,1,-8,5,3,-2,4,2,1,1,2,3,1,4,2,2,4,-1,1,0,0,3,0,0,-4,4,2,0,1,1,0,1,-1,6,-1
KR_6704373906,420,1,6,-22,-3,1,2,3,-1,1,0,-1,3,2,0,1,1,-2,3,1,0,-2,-1,0,-3,3,0,0,0,-1,-1,0,-1,6,-1
KR_6748416013,420,-1,6,-19,-3,2,0,2,0,2,2,-2,2,0,-2,6,4,-1,1,0,0,3,68,-2,-4,6,-3,0,-1,1,-1,-1,-1,1,-1
KR_6743824138,420,-5,-36,-12,-14,-6,6,0,1,1,2,-1,2,1,-7,7,0,-1,1,0,0,-21,-10,-3,-3,6,0,0,-1,-1,-1,-1,-1,2,-1
KR_6620566349,420,1,97,-20,8,5,1,6,-4,5,1,9,1,10,0,3,3,-2,2,0,0,5,-124,0,-4,4,-3,0,2,-1,1,1,1,5,-1
KR_6768578716,420,-1,43,-24,1,1,0,1,-4,5,1,5,1,6,-1,2,1,0,1,1,0,2,7,2,-4,2,2,0,0,1,-1,0,-1,3,-1
KR_6767430763,440,1,-32,12,-6,2,0,2,-2,4,2,-2,3,1,0,3,3,-4,4,0,0,-3,-3,-3,-4,7,-5,0,0,0,-1,0,-1,0,-1
KR_6754238413,420,1,1,8,-4,2,0,2,-3,3,0,0,2,2,-3,6,3,0,1,1,0,-9,5,-1,-4,5,-2,0,1,1,1,1,-1,5,-1
KR_6756176652,420,1,-8,8,-9,2,0,2,-2,4,2,-5,5,0,3,0,3,-7,8,1,0,-8,-77,1,-5,4,-3,0,0,-1,0,-1,-1,6,-1
KR_6754436823,420,0,23,-24,1,0,0,0,-3,4,1,0,1,1,3,1,4,1,1,2,0,5,28,-4,-3,7,-2,0,0,1,-1,0,-1,6,-1
KR_6756182413,440,-2,-75,-10,-4,-1,3,2,2,1,3,-1,4,3,-2,3,1,-2,2,0,0,6,-5,-1,-4,5,1,0,0,-1,1,0,1,2,-1
KR_6367695624,420,-9,-115,-60,-17,1,2,3,-6,7,1,-3,3,0,-10,13,3,1,0,1,0,-16,0,0,0,0,0,0,-3,-1,0,-1,-1,4,-1
KR_6741644305,420,0,35,21,-4,5,0,5,-3,5,2,1,1,2,-2,3,1,-5,6,1,-1,-11,-8,-2,-1,3,0,0,1,1,1,-1,-1,6,-1
KR_6767897858,440,-5,-15,-24,-11,-3,3,0,-2,3,1,-3,6,3,-1,2,1,-2,3,1,0,-13,-2,0,0,0,0,0,0,-1,-1,-1,-1,6,-1
KR_6745499632,420,-1,14,-8,-4,3,1,4,0,0,0,1,2,3,-6,6,0,-2,3,1,0,-11,-2,4,-7,3,-2,0,-1,-1,-1,-1,-1,6,-1
KR_6710274558,420,-2,-10,10,-8,-1,3,2,-1,2,1,-2,4,2,-1,1,0,-3,5,2,0,-5,-26,1,-7,6,1,0,-1,0,-1,-1,-1,0,-1
KR_6661663470,420,0,-2,-32,1,2,1,3,1,2,3,-3,5,2,1,5,6,0,1,1,0,-2,-4,-3,-3,6,-21,0,0,-1,-1,1,1,6,-1
KR_6478249101,420,0,23,-32,-2,-2,3,1,-1,1,0,-1,2,1,2,2,4,0,0,0,-1,-2,4,-1,-5,6,4,0,0,-1,-1,0,-1,5,-1
KR_6746643189,420,-1,1,-8,-4,0,2,2,-2,2,0,-3,4,1,0,0,0,1,0,1,0,-7,15,0,-4,4,-5,0,2,-1,-1,1,1,3,-1
KR_6631400122,420,-2,-44,5,-7,1,0,1,-5,6,1,-2,2,0,0,1,1,-1,1,0,0,-9,-3,0,-4,4,5,0,-1,1,-1,-1,-1,2,-1
KR_6766707193,440,-5,6,-18,-9,-1,2,1,-3,4,1,-1,4,3,-3,6,3,-1,2,1,0,-7,91,0,-4,4,-4,0,-1,1,0,-1,-1,1,-1
KR_6607923598,420,-1,-35,-10,-2,4,0,4,-2,2,0,-5,6,1,1,0,1,0,2,2,0,0,10,-4,-5,9,2,0,0,-1,-1,1,1,2,-1
KR_6766553929,440,-2,-95,-4,0,6,1,7,0,1,1,-2,3,1,3,1,4,-7,8,1,0,-2,3,3,-4,1,-1,0,-1,-1,1,1,1,4,-1
KR_6695972503,420,0,-42,-2,1,0,1,1,3,1,4,0,2,2,-2,3,1,0,2,2,-2,-3,-19,1,-7,6,7,0,0,0,-1,0,-1,0,-1
KR_6768271011,420,-2,-9,26,-7,-4,6,2,-2,3,1,-1,4,3,2,0,2,-2,3,1,0,-3,-36,-3,-6,9,1,0,-2,-1,1,-1,1,3,-1
KR_6766654664,420,-1,-35,26,-9,1,3,4,1,2,3,0,2,2,-1,3,2,-10,11,1,0,-1,-35,1,-3,2,14,0,-1,-1,-1,-1,-1,3,-1
KR_6754742305,420,-2,-17,-1,-1,-2,4,2,0,2,2,-2,3,1,0,2,2,3,1,4,0,2,-2,1,-4,3,3,0,-1,1,1,-1,-1,6,-1
KR_6767108246,440,-2,40,-2,-6,-3,4,1,-2,2,0,-3,4,1,-1,2,1,3,3,6,-2,-8,34,-4,-2,6,-4,0,-1,1,-1,-1,-1,1,-1
KR_6750630354,420,1,-27,20,-4,4,0,4,-1,2,1,2,1,3,-7,7,0,-2,2,0,0,-13,-28,-2,-6,8,-3,0,0,1,1,-1,-1,2,-1
KR_6764961997,420,0,-34,-3,-2,0,3,3,-2,3,1,-2,4,2,1,1,2,1,1,2,0,0,-17,2,-3,1,0,0,-1,1,-1,-1,-1,6,-1
KR_6761491842,420,-1,-53,16,-11,-4,4,0,3,1,4,-2,3,1,-6,9,3,-2,3,1,-2,-16,5,-7,-3,10,-5,0,0,1,1,0,-1,6,-1
KR_6766995481,420,-3,-3,-19,-7,1,0,1,1,1,2,-3,4,1,-4,6,2,-2,4,2,0,-10,3,5,-8,3,-3,0,0,1,1,-1,-1,6,-1
KR_6756157176,440,-9,-85,-36,-26,-10,10,0,-4,6,2,2,1,3,-12,13,1,-2,3,1,1,-25,3,-1,-1,2,-2,0,-1,0,1,-1,1,0,-1
KR_6763350132,420,1,17,0,-4,2,0,2,-5,6,1,-1,1,0,3,0,3,-3,4,1,0,-7,6,-3,-1,4,-1,0,0,1,-1,0,-1,1,-1
KR_6718148685,420,-2,12,-63,-1,-8,10,2,-2,3,1,4,1,5,5,1,6,0,1,1,-1,-7,-17,-5,-1,6,2,0,-2,-1,-1,-1,-1,5,-1
KR_6753611617,420,-1,15,22,7,-2,2,0,2,1,3,-4,4,0,7,1,8,4,0,4,0,6,3,2,-7,5,-3,0,0,1,-1,1,1,2,-1
KR_6764348003,420,-2,3,-17,2,-1,2,1,1,2,3,-1,1,0,3,0,3,0,0,0,0,5,38,0,-8,8,-21,0,-1,-1,-1,-1,1,5,-1
KR_6759220523,440,-5,-100,5,-12,-7,7,0,-2,4,2,-1,4,3,-2,3,1,0,1,1,0,-4,29,0,-3,3,-1,0,0,1,1,0,-1,2,-1
KR_6750106096,420,-2,-44,-4,-9,-2,3,1,-3,5,2,3,2,5,-3,4,1,-4,8,4,0,-10,0,-3,-2,5,2,0,-1,1,-1,-1,-1,2,-1
KR_6622192970,420,1,-29,-28,-6,2,0,2,-3,3,0,-4,6,2,-2,4,2,1,0,1,0,-15,92,-6,-3,9,-1,0,1,0,1,1,1,0,-1
KR_6681035048,420,-4,-37,-10,-12,1,2,3,-4,5,1,-2,2,0,-3,5,2,-4,6,2,1,-10,-6,0,-3,3,1,0,-4,-1,-1,-1,1,3,-1
KR_6761620371,420,-5,-68,0,-11,-2,2,0,1,0,1,-6,6,0,-4,7,3,0,3,3,0,-10,179,2,-6,4,-1,0,-3,-1,1,-1,-1,4,-1
KR_6718308780,420,2,20,28,-2,1,3,4,-6,6,0,-1,2,1,2,2,4,2,0,2,-1,-9,-11,0,-2,2,0,0,2,1,-1,1,-1,6,-1
KR_6712747504,420,2,3,-2,-2,0,1,1,3,0,3,0,0,0,-5,7,2,0,0,0,0,-2,0,0,-3,3,-4,0,-1,-1,-1,-1,1,6,-1
KR_6731161215,420,-3,-109,12,-14,-3,4,1,-4,5,1,-3,3,0,1,5,6,-5,6,1,0,-11,-190,1,-6,5,-1,0,-3,-1,-1,-1,-1,4,-1
KR_6762011031,420,0,-33,15,4,0,4,4,0,2,2,-2,3,1,5,0,5,1,0,1,1,11,-6,-2,-3,5,5,0,0,1,-1,-1,1,4,-1
KR_6343074585,420,-5,-86,-4,-10,-2,2,0,-3,7,4,2,2,4,-4,4,0,-3,3,0,0,-6,6,4,-7,3,-4,0,0,1,0,-1,-1,3,-1
KR_6748706203,440,-1,-9,-12,-6,1,0,1,2,4,6,-4,5,1,-4,4,0,-1,4,3,0,6,2,2,-3,1,0,0,-1,-1,-1,-1,-1,6,-1
KR_6725685165,420,-4,-89,-3,-16,-2,3,1,-4,4,0,-2,3,1,-7,9,2,-1,3,2,-2,-18,-1,-5,-1,6,-3,0,-1,-1,-1,-1,-1,5,-1
KR_6733828518,420,3,25,8,7,4,0,4,0,1,1,1,3,4,3,1,4,-1,1,0,1,3,-10,-2,-6,8,8,0,1,1,-1,1,1,2,-1
KR_6680574656,440,-6,-81,9,-14,-6,6,0,0,3,3,-2,4,2,-3,3,0,-3,5,2,-1,-14,11,3,-6,3,-7,0,-3,1,-1,-1,-1,5,-1
KR_6752031109,420,-3,-8,-5,-1,-4,4,0,1,3,4,-2,3,1,2,3,5,2,1,3,0,7,-1,-3,-2,5,4,0,-1,1,-1,-1,1,5,-1
KR_6766923215,420,-3,-8,-30,-9,-1,3,2,-2,5,3,-5,6,1,1,2,3,-2,2,0,1,0,-8,-3,-4,7,0,0,-2,-1,-1,-1,1,4,-1
KR_6765787384,440,-1,17,-12,0,1,2,3,1,1,2,1,1,2,-2,2,0,-1,2,1,0,0,7,3,-9,6,-2,0,-1,-1,0,-1,1,6,-1
KR_6763083090,420,1,54,-30,4,1,2,3,-5,6,1,-1,1,0,7,2,9,2,0,2,0,9,10,0,-5,5,6,0,0,1,-1,-1,1,3,-1
KR_6611318386,420,-3,-88,16,-8,-5,5,0,-2,5,3,-1,2,1,0,1,1,0,1,1,0,-3,-9,-6,-1,7,9,0,-2,1,-1,-1,-1,4,-1
KR_6753280328,420,0,-68,3,0,-2,4,2,1,4,5,-1,2,1,2,2,4,0,1,1,0,5,216,-5,-3,8,3,0,0,1,-1,0,-1,3,-1
KR_6691667870,420,-4,-86,-2,-10,-1,3,2,0,5,5,-4,6,2,-4,5,1,-1,1,0,-2,-10,-2,1,-5,4,-2,0,-3,1,-1,-1,-1,4,-1
KR_6748640646,440,0,-49,0,3,2,1,3,1,3,4,3,0,3,-4,5,1,1,6,7,2,9,5,1,-2,1,0,0,0,1,-1,0,1,5,-1
KR_6734088299,420,-3,-75,-8,-3,-1,3,2,-5,8,3,1,1,2,1,3,4,1,1,2,0,0,10,2,-7,5,-2,0,0,-1,1,-1,-1,2,-1
KR_6536062509,420,-1,-62,-16,-2,2,1,3,5,1,6,-4,5,1,1,0,1,-6,6,0,0,-3,7,4,-8,4,-8,0,-1,-1,1,-1,1,3,-1
KR_6707459790,420,-4,-49,-14,-5,1,2,3,4,2,6,-2,4,2,-5,5,0,-3,5,2,1,1,8,3,-8,5,-2,0,-2,-1,0,-1,1,3,-1
KR_6723578861,420,1,28,23,-2,4,0,4,-9,9,0,5,1,6,-4,4,0,2,0,2,0,-7,106,-4,-3,7,6,0,0,-1,0,0,1,1,-1
KR_6683198065,420,1,-23,0,-2,-3,3,0,-1,5,4,-1,3,2,-1,3,2,4,0,4,0,7,2,2,-7,5,-1,0,0,-1,-1,0,-1,5,-1
KR_6755239223,420,-7,-116,-16,-13,-6,6,0,-3,5,2,-2,2,0,-2,6,4,0,1,1,0,-12,-4,-6,-2,8,-8,0,-1,-1,-1,-1,-1,6,-1
KR_6767912581,420,1,35,28,-5,-1,1,0,-3,3,0,-5,5,0,3,1,4,1,1,2,0,-8,0,-6,-4,10,-3,0,0,1,0,0,1,1,-1
KR_6730809448,420,-6,-23,-52,-10,1,1,2,-6,6,0,-1,2,1,-3,3,0,-1,1,0,0,-6,-8,-4,0,4,0,0,-1,1,-1,-1,-1,5,-1
KR_6767973204,420,-1,-31,-6,-6,-1,1,0,-5,7,2,3,1,4,-2,4,2,-1,2,1,0,-7,5,0,-5,5,-2,0,0,1,1,0,-1,1,-1
KR_6764798953,420,0,1,2,-2,-1,5,4,1,4,5,-1,4,3,-1,2,1,0,0,0,0,-5,4,-2,-2,4,1,0,-1,1,-1,-1,1,3,-1
KR_6740694787,420,1,-51,-23,6,4,1,5,0,3,3,-1,4,3,2,1,3,1,0,1,0,6,15,3,-8,5,-4,0,0,1,1,1,1,3,-1
KR_6754453487,420,-2,-77,3,-6,-1,4,3,1,1,2,-4,5,1,1,0,1,-3,3,0,0,2,-3,-6,-3,9,-1,0,-1,-1,1,-1,-1,3,-1
KR_6566221842,420,-2,-40,0,-7,-2,7,5,-2,4,2,-2,6,4,-2,4,2,1,1,2,-3,-18,8,-3,-4,7,3,0,-3,-1,-1,-1,-1,1,-1
KR_6766674971,420,-5,-24,-15,-10,-1,1,0,-6,6,0,0,1,1,-1,2,1,-2,2,0,0,-10,-290,-6,-2,8,1,0,-1,-1,-1,-1,1,2,-1
KR_6766885011,420,-6,-67,-8,-16,-8,8,0,-3,5,2,-1,1,0,-4,4,0,0,1,1,-1,-11,1,-3,-3,6,-4,0,-1,-1,-1,-1,-1,5,-1
KR_6701520514,420,-1,28,-17,-1,-1,2,1,0,2,2,0,3,3,1,2,3,-1,1,0,0,4,7,5,-9,4,-9,0,0,1,-1,0,-1,6,-1
KR_6762868444,420,-3,3,7,-4,-3,3,0,-1,3,2,0,2,2,0,1,1,0,0,0,0,-5,-21,2,-6,4,1,0,-1,1,1,-1,-1,4,-1
KR_6768509839,420,1,0,11,2,0,1,1,0,1,1,0,1,1,0,1,1,2,0,2,0,3,0,3,-4,1,1,0,0,-1,-1,0,1,6,-1
KR_6768591635,420,-1,2,-7,-6,4,2,6,-2,7,5,-1,2,1,0,4,4,-7,7,0,0,-13,-8,1,-4,3,0,0,0,-1,0,-1,1,1,-1
KR_6404527900,420,-1,25,-39,2,2,1,3,0,2,2,-4,5,1,3,2,5,1,0,1,0,4,12,2,-5,3,-2,0,-1,1,-1,-1,-1,2,-1
KR_6629594173,420,-3,-41,-28,-12,-1,3,2,2,2,4,-6,7,1,-7,8,1,0,1,1,0,-8,17,-2,-7,9,-19,0,1,-1,1,-1,-1,6,-1
KR_6732201663,440,-5,-66,-32,-4,-1,2,1,0,3,3,-1,4,3,-1,1,0,-1,1,0,-1,-9,-7,1,-7,6,0,0,0,1,-1,-1,-1,4,-1
KR_6746160713,420,-1,27,-79,0,3,2,5,-5,5,0,-2,9,7,5,1,6,-1,1,0,0,-6,7,0,-2,2,-2,0,0,-1,1,1,-1,6,-1
KR_6678766210,420,-2,-24,19,-1,-1,1,0,3,4,7,1,1,2,-5,5,0,1,1,2,0,2,43,0,-5,5,-17,0,-1,1,-1,-1,1,4,-1
KR_6695907114,420,0,-11,11,-2,-1,2,1,-2,8,6,-5,7,2,-1,3,2,7,1,8,-3,-1,2,1,-5,4,-1,0,-1,1,-1,-1,1,5,-1
KR_6727643420,420,-3,-114,23,-11,-4,4,0,-6,8,2,-1,2,1,-1,4,3,1,0,1,0,-10,0,-5,0,5,3,0,-3,1,-1,-1,-1,5,-1
KR_6760599693,420,0,18,-27,-7,0,3,3,-5,5,0,2,2,4,-3,4,1,-1,2,1,0,-8,-11,1,-5,4,1,0,-1,1,-1,-1,-1,3,-1
KR_6765337958,440,-1,-9,2,-3,1,1,2,-6,8,2,-2,3,1,2,2,4,2,1,3,0,-10,7,4,-9,5,3,0,0,-1,1,0,1,3,-1
KR_6735926736,420,-1,-37,9,-9,-8,8,0,2,3,5,-2,4,2,-2,4,2,1,1,2,0,-16,-8,2,-9,7,-1,0,0,1,-1,-1,1,4,-1
KR_6375535452,420,0,-24,16,-2,-1,1,0,2,2,4,-3,4,1,-2,6,4,2,0,2,0,5,0,0,0,0,-3,0,0,1,-1,0,-1,1,-1
KR_6686603576,420,-1,-54,-6,-2,-1,3,2,0,3,3,3,1,4,-4,5,1,0,1,1,-3,-5,-3,-1,-3,4,3,0,0,-1,-1,0,-1,1,-1
KR_6765206647,440,-1,-42,0,-4,3,0,3,3,2,5,-1,3,2,-4,7,3,-5,6,1,0,-7,-6,0,-2,2,1,0,-1,-1,1,-1,1,4,-1
KR_6624161279,420,-1,30,5,1,4,0,4,-2,3,1,-5,5,0,1,1,2,3,0,3,0,1,-366,1,-3,2,-5,0,-1,-1,0,-1,-1,2,-1
KR_6623793742,420,0,47,11,3,5,1,6,1,3,4,-2,2,0,-1,1,0,0,1,1,0,2,7,8,-9,1,1,0,0,-1,1,1,1,3,-1
KR_6763273472,420,-2,-14,-27,0,1,0,1,0,3,3,2,4,6,0,5,5,-3,3,0,0,-5,-7,4,-7,3,-5,0,0,-1,1,-1,-1,1,-1
KR_6706124676,420,-2,-4,-44,4,-3,4,1,-1,2,1,1,1,2,6,0,6,1,2,3,0,6,1,2,-6,4,-4,0,-2,-1,-1,-1,1,2,-1
KR_6759738329,420,-3,-9,-42,0,1,1,2,-1,2,1,-1,5,4,1,3,4,0,2,2,0,-1,-4,0,-3,3,1,0,0,-1,0,0,1,3,-1
KR_6719438154,440,-4,-74,-4,-8,0,0,0,-5,6,1,-2,2,0,-3,4,1,2,0,2,1,-8,-6,-4,-2,6,-7,0,0,-1,-1,0,1,5,-1
KR_6761825904,420,2,-34,0,6,1,3,4,5,1,6,-4,4,0,1,2,3,3,0,3,0,4,-37,-6,-1,7,4,0,0,1,-1,-1,-1,3,-1
KR_6765263101,420,-3,-67,-5,-9,-2,3,1,-3,4,1,0,1,1,-4,4,0,0,1,1,0,-9,12,2,-4,2,0,0,-1,-1,1,-1,-1,3,-1
KR_6759724686,420,-4,-88,4,-18,-1,2,1,-9,10,1,-2,5,3,-8,9,1,2,0,2,-1,-13,133,4,-8,4,-7,0,-2,0,1,-1,-1,0,-1
KR_6601638449,420,-6,-96,-23,-15,-4,4,0,-5,6,1,-4,6,2,2,3,5,-4,4,0,0,-8,7,-6,-3,9,2,0,-2,-1,-1,-1,-1,3,-1
KR_6740414814,420,-1,-14,8,-3,0,0,0,0,3,3,0,2,2,-2,3,1,-1,2,1,1,-1,11,3,-4,1,-1,0,-1,1,-1,-1,1,5,-1
KR_6712618732,420,-1,32,-7,-1,-3,4,1,-7,8,1,4,0,4,4,2,6,1,0,1,0,-4,12,-6,-4,10,2,0,-1,-1,-1,-1,-1,2,-1
KR_6768059721,420,-2,-80,-15,-3,0,1,1,-2,4,2,0,3,3,-1,2,1,0,1,1,0,-2,-14,-5,-3,8,-3,0,-2,-1,-1,-1,-1,1,-1
KR_6761489742,420,-4,-6,-22,-12,0,2,2,-6,6,0,-3,5,2,-3,5,2,0,0,0,0,-12,6,1,-4,3,-2,0,0,-1,-1,-1,-1,4,-1
KR_6496745419,420,0,48,17,-1,3,0,3,0,2,2,0,3,3,-3,3,0,-1,1,0,0,-11,22,0,-7,7,1,0,2,-1,1,1,1,3,-1
KR_6698732824,420,-3,95,-15,-8,-1,3,2,-4,7,3,0,3,3,5,0,5,-8,9,1,1,-5,-2,2,-6,4,1,0,2,-1,-1,1,1,2,-1
KR_6745807489,420,-3,-59,-8,-4,0,1,1,-4,4,0,-5,6,1,4,0,4,1,0,1,0,-2,-162,-5,-2,7,-3,0,-1,-1,-1,-1,-1,1,-1
KR_6763233707,420,-4,-11,-40,-3,-3,4,1,3,1,4,1,2,3,-3,5,2,-1,1,0,0,1,-114,9,-11,2,-9,0,0,0,0,0,-1,0,-1
KR_6765144598,420,-6,-102,-32,-12,-4,7,3,-3,4,1,-4,5,1,-1,5,4,0,1,1,0,-8,0,0,-6,6,-2,0,-1,-1,-1,-1,-1,4,-1
KR_6747739345,440,-4,-95,16,-11,-4,4,0,-2,2,0,-1,5,4,-2,3,1,-2,2,0,0,-3,8,1,-4,3,-5,0,-1,-1,-1,-1,-1,4,-1
KR_6727917748,420,2,20,27,0,2,1,3,3,2,5,-5,5,0,-2,5,3,2,1,3,0,-2,-7,0,-2,2,-1,0,0,-1,1,1,-1,4,-1
KR_6745256268,420,-2,-25,-12,-9,-3,4,1,1,4,5,-5,6,1,-1,3,2,-1,1,0,0,-12,54,-1,-6,7,-25,0,1,1,-1,1,-1,6,-1
KR_6734541158,420,-5,-88,-20,-11,-2,3,1,-2,3,1,0,3,3,-7,8,1,0,1,1,0,-12,0,-3,-2,5,-5,0,-2,-1,1,-1,-1,3,-1
KR_6696358028,420,-7,-89,-19,-14,1,0,1,-4,5,1,-5,5,0,-5,6,1,-1,1,0,0,-18,-25,-7,-3,10,-4,0,-2,-1,-1,-1,-1,4,-1
KR_6761319421,420,-2,8,-16,-4,-1,3,2,-2,2,0,0,3,3,2,2,4,-3,4,1,-1,-2,-2,-3,-3,6,6,0,0,-1,1,0,-1,1,-1
KR_6755604655,420,0,6,8,2,2,2,4,0,2,2,2,0,2,-1,4,3,-1,1,0,0,3,12,5,-9,4,-5,0,0,1,0,0,1,4,-1
KR_6758988392,420,-3,-41,-16,-10,-1,3,2,-6,9,3,-2,4,2,-5,7,2,4,0,4,-2,-17,-1,-1,-5,6,-3,0,-2,1,1,-1,-1,3,-1
KR_6660238092,440,0,9,-12,4,-1,2,1,1,1,2,6,0,6,-1,3,2,-1,1,0,0,-1,2,1,-6,5,-6,0,0,-1,1,1,1,5,-1
KR_6725455632,420,0,-7,6,1,0,1,1,-2,3,1,0,3,3,1,4,5,2,0,2,-1,1,-2,-5,-3,8,3,0,0,0,1,1,-1,0,-1
KR_6759617825,420,-1,6,4,-3,3,3,6,4,1,5,-4,5,1,-6,8,2,0,0,0,1,1,-8,2,-5,3,-2,0,0,1,-1,1,1,4,-1
KR_6751715718,420,-6,-46,-39,-5,-4,5,1,-3,3,0,-2,3,1,2,2,4,2,0,2,0,-1,5,6,-6,0,-3,0,-1,1,-1,-1,1,6,-1
KR_6716269094,420,0,-53,-8,6,1,0,1,5,3,8,-2,4,2,-1,2,1,3,0,3,0,6,-19,-3,-2,5,0,0,0,0,-1,0,-1,0,-1
KR_6730863041,420,-4,-42,-15,-12,-2,3,1,-1,3,2,-4,6,2,-6,9,3,1,1,2,-1,-23,192,0,-6,6,3,0,-2,-1,1,-1,-1,1,-1
KR_6580164486,420,-1,-43,17,-5,-1,2,1,-4,6,2,0,2,2,-2,4,2,2,0,2,0,-9,-224,-3,-2,5,0,0,0,-1,-1,-1,-1,5,-1
KR_6760922996,440,-2,58,9,-3,-2,4,2,0,2,2,-1,2,1,-1,6,5,1,0,1,-1,-8,1,-3,-2,5,0,0,0,-1,1,0,-1,3,-1
KR_6714418887,440,-2,-19,-4,-8,0,1,1,0,1,1,-1,2,1,-6,7,1,-1,1,0,0,-3,-10,-1,-2,3,2,0,0,-1,1,0,-1,6,-1
KR_6592959166,420,-1,-82,-5,-1,3,0,3,0,2,2,-3,3,0,0,2,2,-1,5,4,0,0,13,4,-5,1,-5,0,0,-1,1,1,1,1,-1
KR_6752237411,420,0,35,14,3,0,1,1,1,3,4,1,1,2,1,0,1,0,1,1,1,0,-3,2,-8,6,0,0,2,1,1,1,1,2,-1
KR_6735652493,420,-4,-61,-16,-6,-4,5,1,-2,3,1,-1,3,2,2,6,8,-1,1,0,0,-3,-22,5,-9,4,-4,0,0,-1,-1,0,1,4,-1
KR_6755377005,420,0,23,-18,-2,5,0,5,-1,2,1,1,3,4,-6,9,3,-1,2,1,-3,-12,22,-2,-5,7,-12,0,1,-1,1,1,-1,1,-1
KR_6747307515,420,3,-33,-11,8,-1,3,2,1,3,4,5,4,9,4,1,5,-1,2,1,0,13,-35,-3,-1,4,4,0,1,1,0,1,1,2,-1
KR_6678098314,420,-4,-20,-33,-1,0,3,3,-2,3,1,1,0,1,-1,2,1,1,2,3,0,-3,9,3,-9,6,-4,0,0,-1,1,1,-1,1,-1
KR_6674867563,440,-1,6,-49,-10,-3,5,2,-15,15,0,2,0,2,5,0,5,1,0,1,0,-13,1,1,-5,4,3,0,0,1,-1,0,1,3,-1
KR_6767151138,420,1,19,-8,-1,0,2,2,0,1,1,1,2,3,-3,6,3,1,2,3,0,2,-4,2,-5,3,2,0,0,-1,-1,0,-1,1,-1
KR_6762343264,420,-1,34,-9,0,5,0,5,-2,3,1,0,3,3,-2,4,2,-1,1,0,1,-6,-6,-2,-2,4,4,0,1,-1,1,1,1,3,-1
KR_6658387168,420,4,22,-19,-2,1,0,1,-3,5,2,1,3,4,-1,7,6,0,1,1,0,-10,-5,-3,-4,7,-1,0,-1,-1,1,1,-1,2,-1
KR_6703018694,440,0,-13,-12,3,-3,3,0,3,0,3,0,2,2,1,3,4,2,0,2,0,-2,3,0,-4,4,3,0,0,-1,1,0,1,2,-1
KR_6611680812,420,-2,-10,-3,0,-1,2,1,4,2,6,-3,4,1,3,0,3,-3,3,0,0,3,-3,0,-8,8,9,0,0,1,1,0,-1,4,-1
KR_6685150411,420,3,26,14,-1,1,1,2,0,1,1,2,0,2,-5,7,2,1,0,1,0,-7,-8,2,-5,3,3,0,-1,1,1,-1,-1,3,-1
KR_6753673034,420,-1,48,-5,0,0,1,1,-2,3,1,-1,1,0,3,2,5,0,3,3,0,-1,-12,-1,-3,4,4,0,2,1,1,1,1,5,-1
KR_6728171049,440,-1,-28,-9,2,1,2,3,3,1,4,-3,6,3,0,6,6,1,0,1,0,4,-15,-7,-1,8,6,0,-1,0,1,-1,-1,0,-1
KR_6721993338,420,-4,4,-52,-2,4,3,7,-3,5,2,-1,7,6,0,4,4,-2,2,0,-1,-13,-5,-4,-1,5,1,0,-1,0,1,-1,1,0,-1
KR_6698822130,420,-1,-78,-1,-5,-3,5,2,-4,5,1,0,1,1,1,3,4,1,1,2,0,2,7,-3,-3,6,-3,0,0,1,-1,-1,1,3,-1
KR_6767994715,420,-1,16,8,-3,-2,3,1,-3,3,0,4,0,4,-2,2,0,0,0,0,0,-7,0,-1,-5,6,-6,0,0,-1,-1,0,1,1,-1
KR_6449093282,420,-2,37,-38,-3,2,1,3,0,3,3,-3,3,0,-1,5,4,-1,1,0,-1,-2,13,-1,-6,7,2,0,0,1,-1,-1,-1,4,-1
KR_6622251448,420,-2,-45,-11,2,-1,2,1,2,1,3,1,1,2,0,2,2,0,1,1,0,6,-102,0,-5,5,-2,0,-2,1,-1,-1,1,2,-1
KR_6740214611,420,1,60,20,3,2,1,3,-3,4,1,1,0,1,2,0,2,1,0,1,0,-1,-14,-2,-2,4,0,0,1,1,-1,1,1,6,-1
KR_6697775960,420,-3,-34,12,-8,-1,3,2,-6,6,0,-4,4,0,1,2,3,2,0,2,0,-3,6,0,-4,4,-3,0,0,1,-1,1,-1,1,-1
KR_6686344996,420,-2,9,12,-12,-2,4,2,-6,7,1,-2,2,0,-2,6,4,0,3,3,0,-17,8,0,-7,7,3,0,-1,1,-1,-1,-1,4,-1
KR_6766023702,440,-4,-109,0,-11,1,2,3,2,0,2,-5,9,4,-7,9,2,-2,2,0,-2,-8,-10,-3,-1,4,-1,0,-2,1,1,-1,-1,4,-1
KR_6664875305,420,1,-12,-15,5,2,0,2,3,1,4,1,2,3,0,2,2,-1,3,2,0,8,0,-1,-5,6,-2,0,0,1,-1,0,1,5,-1
KR_6758452267,420,2,44,-8,2,1,1,2,0,1,1,1,2,3,1,2,3,-1,1,0,0,3,-113,1,-4,3,2,0,0,-1,-1,0,1,1,-1
KR_6764149072,420,-3,-81,-10,-5,0,2,2,0,3,3,-2,4,2,-2,7,5,-1,1,0,0,-4,49,1,-3,2,-15,0,-1,-1,0,-1,1,6,-1
KR_6764168553,420,-1,-85,24,2,-2,3,1,3,2,5,4,1,5,-3,5,2,0,0,0,0,7,399,5,-8,3,-5,0,-1,1,1,-1,1,4,-1
KR_6657349893,420,-1,4,-20,-3,-2,3,1,2,0,2,-6,6,0,2,0,2,1,1,2,0,-5,2,2,-5,3,-1,0,0,1,-1,-1,-1,2,-1
KR_6683140178,420,-1,35,-23,0,2,1,3,1,1,2,2,0,2,-6,13,7,1,1,2,2,9,1,3,-5,2,-1,0,1,1,1,1,1,1,-1
KR_6716500018,420,-5,-21,-28,-10,-1,1,0,-2,4,2,1,2,3,-2,4,2,-6,6,0,0,-14,-6,0,-4,4,-1,0,-2,-1,-1,-1,1,2,-1
KR_6711140033,420,0,-24,12,-1,-2,3,1,0,2,2,3,2,5,-1,2,1,-1,1,0,0,0,-5,3,-9,6,-2,0,-1,-1,1,-1,-1,2,-1
KR_6691414438,420,-2,-34,24,-8,-1,1,0,-2,4,2,-6,6,0,1,1,2,0,2,2,-1,-13,-14,0,-5,5,-1,0,0,1,-1,0,-1,3,-1
KR_6704384854,420,0,-25,25,-6,0,3,3,-6,7,1,1,1,2,0,0,0,-1,1,0,0,-7,114,-1,-4,5,-2,0,-1,1,1,-1,1,6,-1
KR_6749360361,440,7,70,68,12,1,2,3,4,2,6,-2,5,3,2,3,5,7,1,8,0,5,5,0,-2,2,2,0,3,1,1,1,1,1,-1
KR_6726000188,420,0,-37,-20,6,-1,4,3,2,3,5,1,1,2,4,0,4,0,0,0,-1,12,-310,-2,-2,4,-2,0,-2,-1,-1,-1,-1,4,-1
KR_6768837242,420,-3,-7,-36,-2,-1,2,1,0,3,3,-4,6,2,1,2,3,2,1,3,-1,2,2,1,-2,1,-3,0,0,1,-1,0,-1,5,-1
KR_6695551714,420,-2,5,-50,-6,-3,3,0,0,3,3,-1,4,3,-2,2,0,0,1,1,0,-4,-30,2,-6,4,24,0,0,-1,-1,0,-1,6,-1
KR_6740355893,420,-1,-32,-11,-1,-4,4,0,0,4,4,0,2,2,2,5,7,1,0,1,0,3,-47,2,-4,2,-9,0,0,1,1,-1,-1,4,-1
KR_6719190898,420,-2,-48,-52,1,0,1,1,-1,2,1,0,2,2,2,2,4,0,2,2,0,5,-40,1,-5,4,25,0,-1,-1,-1,-1,-1,5,-1
KR_6767670236,420,-5,-17,-16,-13,1,3,4,-3,5,2,1,2,3,-7,7,0,-5,5,0,0,-18,-34,-5,-4,9,-4,0,0,-1,-1,-1,-1,1,-1
KR_6760224351,420,-2,-1,5,-3,-2,3,1,-5,6,1,-4,5,1,5,0,5,3,0,3,0,1,116,1,-4,3,-4,0,0,-1,-1,-1,-1,1,-1
KR_6617872017,440,1,-16,-11,-6,-4,5,1,2,0,2,-4,6,2,-1,1,0,1,0,1,-3,-8,-10,-4,-3,7,1,0,-1,1,-1,-1,-1,6,-1
KR_6736069327,420,-4,9,-21,-16,-3,3,0,0,2,2,-11,11,0,-1,2,1,-1,1,0,0,-19,-16,-4,0,4,2,0,-3,-1,-1,-1,-1,2,-1
KR_6683155715,420,-4,-67,-29,-12,-8,8,0,-2,5,3,-4,5,1,4,1,5,-2,3,1,-1,-6,-22,1,-6,5,19,0,-4,-1,-1,-1,-1,3,-1
KR_6762620405,420,2,45,26,9,1,0,1,7,0,7,-3,5,2,3,0,3,1,0,1,0,7,12,1,-5,4,0,0,0,0,1,0,1,0,-1
KR_6634787485,420,0,-29,-18,-3,2,0,2,-3,6,3,-5,5,0,2,0,2,1,0,1,0,-10,-14,1,-6,5,-1,0,1,-1,-1,1,1,1,-1
KR_6715143049,420,-3,4,12,-14,-1,3,2,-2,3,1,-2,2,0,-4,5,1,-5,5,0,0,-13,5,-3,-2,5,-1,0,0,1,1,-1,1,6,-1
KR_6738123469,420,-1,-27,-5,-3,1,3,4,1,1,2,-2,4,2,-4,4,0,1,0,1,0,4,21,4,-6,2,0,0,-1,-1,-1,-1,-1,6,-1
KR_6705839741,420,-1,-38,16,-6,-1,1,0,-1,5,4,-2,3,1,-1,4,3,-1,3,2,0,-5,4,2,-6,4,-7,0,-2,-1,-1,-1,-1,3,-1
KR_6470833357,420,0,-8,12,2,1,1,2,-3,4,1,2,1,3,2,0,2,0,3,3,1,5,5,3,-5,2,4,0,0,1,1,0,1,3,-1
KR_6769688536,420,0,20,-12,-3,-3,5,2,1,0,1,-2,3,1,1,2,3,0,0,0,0,0,6,2,-5,3,6,0,0,1,1,0,-1,1,-1
KR_6751223041,420,1,-38,-23,-6,0,3,3,-3,4,1,-2,5,3,-1,5,4,0,1,1,-1,-3,2,0,-4,4,4,0,0,1,-1,0,-1,6,-1
KR_6744603950,420,1,-11,13,4,0,3,3,0,3,3,0,2,2,2,3,5,2,0,2,2,14,2,-3,-5,8,-1,0,0,1,-1,1,1,2,-1
KR_6730415878,420,0,10,10,-5,2,0,2,-1,4,3,0,2,2,-4,4,0,-2,2,0,0,-5,-130,-7,0,7,-1,0,-3,-1,-1,-1,-1,4,-1
KR_6523465485,420,1,-8,-19,-2,-1,1,0,3,2,5,0,4,4,-2,5,3,-2,2,0,-1,7,-12,-3,-5,8,3,0,0,-1,-1,-1,-1,4,-1
KR_6627690879,420,1,-35,8,5,0,2,2,1,1,2,1,2,3,2,0,2,1,0,1,0,3,74,-2,-3,5,0,0,0,-1,1,0,1,1,-1
KR_6636582275,420,-5,-22,-29,-7,0,2,2,0,2,2,-7,9,2,2,2,4,-2,2,0,1,-8,-3,3,-6,3,-3,0,-1,1,-1,-1,1,5,-1
KR_6765161942,420,-2,-71,1,-5,-2,3,1,-3,8,5,-1,2,1,2,2,4,-1,3,2,1,-3,-5,-1,-3,4,-3,0,0,0,-1,0,1,0,-1
KR_6748388117,420,-2,4,-4,-2,1,0,1,1,2,3,0,2,2,-2,4,2,-2,2,0,0,-2,10,5,-8,3,2,0,0,-1,1,0,1,2,-1
KR_6769755595,420,-2,-60,11,-6,0,3,3,0,3,3,0,3,3,-4,5,1,-2,2,0,-1,-11,-6,-7,-2,9,3,0,-3,-1,-1,-1,-1,3,-1
KR_6745911873,420,-2,9,10,-9,1,1,2,-4,6,2,2,2,4,-6,8,2,-2,6,4,0,-14,25,-4,-4,8,-5,0,-2,-1,-1,-1,-1,6,-1
KR_6687036386,420,-1,-7,8,3,1,3,4,-1,2,1,0,1,1,3,2,5,0,1,1,0,-1,-2,1,-6,5,0,0,2,0,1,1,1,0,-1
KR_6748025966,420,0,25,11,-8,-2,2,0,1,2,3,-2,4,2,-6,6,0,1,0,1,0,-5,492,0,-3,3,-2,0,0,-1,-1,0,1,6,-1
KR_6767343547,420,-2,23,0,-9,-2,2,0,0,2,2,-3,7,4,-3,4,1,-1,1,0,0,-9,0,2,-7,5,-4,0,-1,1,-1,-1,-1,2,-1
KR_6727945623,420,-4,-84,-24,-8,1,1,2,0,2,2,1,1,2,-6,7,1,-4,5,1,-1,-12,19,-1,-2,3,2,0,-1,1,-1,-1,-1,2,-1
KR_6725619687,420,2,39,-22,3,3,1,4,-3,5,2,0,1,1,3,1,4,0,0,0,0,-2,-8,0,-4,4,1,0,1,-1,1,-1,1,5,-1
KR_6767720480,420,2,-11,12,10,-2,3,1,4,0,4,2,1,3,4,4,8,2,2,4,2,14,-18,2,-4,2,1,0,0,1,-1,-1,1,6,-1
KR_6688969568,420,0,-42,20,8,3,0,3,3,2,5,0,1,1,1,3,4,1,1,2,0,8,117,2,-5,3,-1,0,0,-1,1,-1,1,1,-1
KR_6749793386,420,-2,-20,-12,0,4,0,4,0,1,1,-2,3,1,-3,6,3,1,0,1,0,-4,-128,3,-4,1,-2,0,-1,-1,1,-1,1,2,-1
KR_6704126716,420,-1,-13,1,-7,0,1,1,-7,7,0,-2,3,1,1,2,3,1,0,1,-2,-15,-82,-2,-5,7,1,0,-1,1,-1,-1,-1,1,-1
KR_6612098437,420,-6,-64,-31,-11,0,1,1,-3,9,6,-1,5,4,0,2,2,-7,8,1,0,-24,-14,-4,-5,9,-2,0,-1,-1,-1,-1,1,1,-1
KR_6640470772,420,-3,13,-7,-13,-1,3,2,-6,7,1,-3,5,2,-2,4,2,-1,3,2,-2,-21,-41,-1,-5,6,2,0,-1,-1,-1,-1,-1,2,-1
KR_6743947559,420,2,-11,8,6,3,2,5,-1,3,2,0,2,2,2,2,4,2,0,2,0,10,-103,1,-5,4,-1,0,0,-1,0,0,-1,6,-1
KR_6682705176,420,-3,26,-4,-2,0,1,1,0,1,1,0,1,1,-3,3,0,1,0,1,0,-4,2,-1,-6,7,-2,0,0,-1,0,0,-1,3,-1
KR_6758572663,420,0,31,-43,-6,1,3,4,-2,4,2,-4,6,2,2,5,7,-3,4,1,-1,-6,25,-2,-4,6,-16,0,-1,1,-1,-1,-1,1,-1
KR_6758154473,420,-2,-72,-26,-9,-5,5,0,-1,2,1,-4,6,2,-2,3,1,3,1,4,0,-2,-4,-4,-4,8,-3,0,0,-1,0,-1,-1,2,-1
KR_6741121677,420,-3,-43,6,-6,-2,2,0,3,2,5,-4,5,1,-2,2,0,-1,3,2,0,-7,-37,0,-3,3,20,0,-2,0,1,-1,1,0,-1
KR_6747428159,420,-4,-24,-4,-11,-2,4,2,2,3,5,0,1,1,-7,7,0,-4,4,0,-1,-17,20,-5,-3,8,-1,0,-1,0,0,-1,-1,0,-1
KR_6768116582,420,0,2,-4,-4,-2,3,1,-1,2,1,1,2,3,-3,5,2,1,1,2,0,-10,3,1,-8,7,-5,0,-1,-1,-1,-1,1,1,-1
KR_6754814553,440,-1,-14,-12,-1,-1,2,1,-1,1,0,-1,5,4,2,2,4,0,2,2,0,1,-12,-3,-1,4,5,0,-1,1,-1,-1,1,1,-1
KR_6698339468,420,2,7,17,5,4,2,6,3,2,5,4,2,6,-6,7,1,0,1,1,1,13,-4,2,-6,4,0,0,1,-1,-1,1,1,1,-1
KR_6632073277,420,-2,-60,-16,-8,-1,3,2,2,2,4,-8,8,0,-1,2,1,0,0,0,0,-13,235,-1,-6,7,-5,0,0,-1,1,1,-1,1,-1
KR_6696922190,420,0,-11,16,-3,-1,2,1,-2,4,2,1,1,2,1,2,3,-2,2,0,0,-9,131,-1,-3,4,-2,0,0,-1,1,1,-1,1,-1
KR_6744532354,420,-1,31,8,-7,0,4,4,-4,5,1,-1,3,2,-1,2,1,-1,1,0,-1,-8,7,1,-3,2,-6,0,0,1,-1,-1,-1,3,-1
KR_6769794743,420,-1,-65,-8,-6,-3,4,1,3,0,3,-3,4,1,-3,3,0,0,1,1,0,-3,191,0,-4,4,2,0,-1,-1,-1,-1,-1,4,-1
KR_6667314013,420,-3,-76,55,-8,-1,4,3,-2,2,0,-3,3,0,-4,4,0,2,1,3,0,-16,-2,1,-3,2,-1,0,1,-1,1,-1,-1,5,-1
KR_6753542599,420,-11,-33,-36,-20,-4,4,0,-3,4,1,-3,3,0,-4,5,1,-6,6,0,0,-22,-3,2,-4,2,-3,-1,-4,1,1,-1,-1,5,-1
KR_6725131188,420,-5,-114,-8,-5,-10,11,1,1,2,3,-1,1,0,3,6,9,2,1,3,0,-6,-23,2,-5,3,3,0,0,1,-1,-1,-1,1,-1
KR_6672101297,420,-4,-48,-24,-8,5,0,5,0,1,1,-2,4,2,-4,5,1,-7,7,0,0,-15,-12,1,-5,4,-5,0,-3,-1,1,-1,1,4,-1
KR_6765268131,420,-2,-83,-11,-4,-2,4,2,-1,2,1,2,0,2,-2,3,1,-1,1,0,0,-1,0,-1,-5,6,-4,0,-1,1,-1,-1,-1,1,-1
KR_6755433506,420,-4,-141,5,-6,-2,2,0,0,3,3,-3,3,0,-1,6,5,0,1,1,0,-4,-16,-1,-3,4,1,0,0,1,-1,-1,-1,2,-1
KR_6742756531,440,-1,45,0,2,0,2,2,-1,4,3,1,2,3,2,2,4,0,0,0,1,-2,7,-1,-2,3,-1,0,1,1,0,1,1,1,-1
KR_6758716891,420,-2,-15,15,-7,0,1,1,2,1,3,-5,5,0,-4,4,0,0,0,0,0,-5,0,-5,-1,6,-6,0,0,0,0,-1,-1,0,-1
KR_6710385997,420,-1,29,-19,-1,-1,2,1,1,2,3,0,2,2,1,3,4,-2,2,0,0,3,-16,-11,-2,13,1,0,-1,1,-1,-1,1,1,-1
KR_6755284991,420,-4,-60,-5,-8,-1,2,1,-1,3,2,-1,2,1,-2,5,3,-3,5,2,0,-12,-1,-1,-5,6,-1,0,0,-1,1,0,-1,1,-1
KR_6635725291,420,-2,-21,-28,1,-3,3,0,3,2,5,-3,4,1,5,3,8,-1,3,2,2,4,-1,-1,-3,4,-1,0,0,-1,-1,-1,1,1,-1
KR_6757555401,420,1,1,0,3,0,2,2,-4,6,2,4,1,5,3,1,4,0,1,1,0,1,-1,-5,-1,6,6,0,0,0,0,0,1,0,-1
KR_6769435808,420,0,-83,-4,-6,-6,6,0,3,1,4,-1,4,3,-3,4,1,1,2,3,0,3,42,-4,-2,6,-3,0,-2,1,-1,-1,1,4,-1
KR_6723015873,440,0,-36,28,-5,1,3,4,-2,6,4,1,5,6,-3,3,0,-2,3,1,0,-10,2,-1,-2,3,0,0,2,1,1,1,1,1,-1
KR_6750847491,420,1,47,-4,-5,6,0,6,-3,7,4,-1,1,0,-6,6,0,-1,1,0,0,-10,4,-1,-3,4,3,0,0,-1,1,-1,1,1,-1
KR_6768686889,420,3,-19,12,4,2,0,2,0,2,2,0,3,3,-1,6,5,3,2,5,1,-3,4,-1,-4,5,6,0,0,-1,1,1,1,2,-1
KR_6768788608,420,0,-9,17,-8,1,0,1,-2,2,0,-6,8,2,-2,4,2,1,3,4,0,-4,25,2,-7,5,-8,0,0,0,0,0,-1,0,-1
KR_6518971645,440,-2,-18,8,-9,-10,11,1,2,0,2,4,0,4,-4,6,2,-1,1,0,0,-8,12,-5,-5,10,-16,0,1,1,-1,-1,-1,3,-1
KR_6766174805,420,0,10,-8,0,-2,4,2,5,0,5,-3,5,2,0,1,1,0,0,0,0,3,7,0,-6,6,-1,0,1,-1,1,1,1,5,-1
KR_6760359142,420,-2,38,3,-7,0,1,1,-2,4,2,-3,4,1,0,2,2,-2,2,0,0,-12,-5,-2,-2,4,-1,0,0,-1,-1,1,1,1,-1
KR_6743276791,420,-2,-17,-1,-6,-3,4,1,0,5,5,1,0,1,-4,6,2,0,1,1,0,-9,1,3,-9,6,-3,0,-1,1,-1,-1,1,6,-1
KR_6761550229,420,0,53,4,-5,-2,3,1,1,2,3,-1,2,1,-2,2,0,-1,1,0,0,-6,1,3,-5,2,0,0,-1,-1,-1,-1,1,4,-1
KR_6746687728,420,2,15,-19,5,3,0,3,0,6,6,3,0,3,0,2,2,-1,1,0,0,0,-38,-1,-3,4,12,0,0,-1,-1,0,-1,1,-1
KR_6754095706,420,0,-17,-16,4,-3,4,1,8,0,8,-1,1,0,1,1,2,-1,1,0,0,12,9,1,-8,7,-1,0,0,1,-1,0,1,2,-1
KR_6743901127,420,-1,-56,26,-1,1,0,1,0,4,4,2,1,3,-3,6,3,-1,1,0,-1,-1,6,5,-11,6,-6,0,0,1,1,0,-1,5,-1
KR_6523629605,420,-2,-27,-4,-1,-4,4,0,0,3,3,1,3,4,4,0,4,-2,2,0,0,5,11,0,-5,5,-1,0,0,1,-1,-1,1,3,-1
KR_6754901935,440,-5,-59,-23,-9,-1,1,0,-6,8,2,-1,3,2,0,1,1,-1,1,0,0,-12,-1,2,-3,1,0,0,0,1,1,1,-1,6,-1
KR_6753866005,420,-2,30,20,-7,1,4,5,0,1,1,-6,6,0,-3,7,4,1,0,1,0,-9,-3,1,-5,4,0,0,-1,0,0,1,-1,0,-1
KR_6759203881,420,-3,-85,4,-9,-1,2,1,2,3,5,-2,4,2,-7,8,1,-1,3,2,0,-6,5,-2,-3,5,-3,0,-2,-1,-1,-1,-1,1,-1
KR_6763388246,420,1,-23,56,-2,1,1,2,-3,4,1,-2,2,0,3,0,3,-1,1,0,0,3,8,8,-11,3,-2,0,1,1,1,1,-1,2,-1
KR_6740036687,420,5,-45,16,7,0,2,2,0,2,2,0,1,1,2,1,3,5,0,5,0,7,18,0,-4,4,-3,0,0,1,1,1,-1,2,-1
KR_6752783226,440,-2,13,-2,-7,0,2,2,3,1,4,-5,5,0,-1,6,5,-4,6,2,2,-7,-36,4,-8,4,15,0,-1,1,-1,-1,1,2,-1
KR_6701364495,420,2,48,-20,1,1,0,1,-3,4,1,3,1,4,0,2,2,0,1,1,0,1,-209,-2,-3,5,6,0,0,-1,-1,0,1,3,-1
KR_6640098421,420,-1,38,-1,-6,-1,3,2,-3,7,4,0,4,4,-1,6,5,-1,5,4,0,-12,-1,-1,-4,5,-2,0,-2,-1,-1,-1,-1,5,-1
KR_6767976658,440,-1,-19,-64,7,-1,2,1,-4,7,3,3,2,5,8,0,8,1,1,2,0,14,-5,2,-5,3,-1,0,1,-1,-1,1,1,5,-1
KR_6721906213,420,-6,-108,-4,-13,-6,6,0,1,3,4,-3,5,2,-5,6,1,0,2,2,0,-12,10,3,-5,2,-5,0,-1,1,1,-1,1,2,-1
KR_6715005764,420,2,55,20,2,-1,2,1,-1,5,4,2,2,4,-2,3,1,4,0,4,0,4,-6,-3,-4,7,4,0,0,1,-1,0,-1,1,-1
KR_6111481254,420,-1,-43,-12,2,0,3,3,0,3,3,4,2,6,-2,5,3,0,1,1,0,8,5,-4,-4,8,3,0,-1,1,0,-1,1,2,-1
KR_6732636773,420,-3,-40,-34,0,0,3,3,-1,2,1,-2,4,2,1,3,4,2,0,2,0,5,1,0,-5,5,5,0,-1,1,-1,-1,-1,5,-1
KR_6610117018,420,-4,-49,-4,-11,-3,3,0,-3,3,0,0,2,2,-4,5,1,-1,2,1,1,-9,-145,-2,-2,4,-6,0,-3,-1,1,-1,1,4,-1
KR_6574147489,420,-3,-12,-2,-4,0,3,3,-4,5,1,3,3,6,0,1,1,-3,3,0,0,-8,-4,1,-7,6,0,0,1,0,1,1,1,0,-1
KR_6707284025,440,-1,-53,4,2,2,2,4,-2,2,0,1,2,3,-2,4,2,3,1,4,0,1,2,-3,-2,5,-7,0,0,-1,1,0,-1,1,-1
KR_6736766247,420,0,-18,-9,5,-3,5,2,6,1,7,0,1,1,0,2,2,2,0,2,0,9,30,-8,-1,9,-12,0,-1,1,-1,-1,1,1,-1
KR_6706435708,420,-1,-59,-10,-5,3,1,4,-2,2,0,-1,1,0,-5,5,0,0,1,1,0,-3,-7,1,-9,8,2,0,-2,-1,-1,-1,-1,1,-1
KR_6732664729,440,0,-5,24,4,2,2,4,0,4,4,4,3,7,-2,4,2,0,1,1,0,0,10,1,-6,5,4,0,0,0,0,-1,-1,0,-1
KR_6686742889,420,0,-17,-32,8,1,1,2,0,2,2,-1,2,1,10,1,11,-2,3,1,0,7,-6,-2,-4,6,5,0,0,1,1,-1,1,3,-1
KR_6631619067,420,2,37,9,6,1,2,3,-1,2,1,6,0,6,0,2,2,0,2,2,0,11,9,4,-6,2,2,0,0,1,0,0,-1,6,-1
KR_6767174110,420,-2,48,-8,-2,3,0,3,-5,5,0,2,0,2,0,3,3,-2,3,1,0,-7,5,1,-7,6,1,0,0,-1,-1,0,1,5,-1
KR_6678638450,420,-4,-7,-24,-2,1,2,3,0,5,5,-1,2,1,-3,3,0,1,0,1,0,0,9,2,-5,3,-3,0,1,1,1,1,-1,3,-1
KR_6731322827,420,1,-7,-11,-5,1,0,1,2,4,6,4,1,5,-11,11,0,-1,4,3,0,-6,-7,4,-8,4,-5,0,-1,-1,1,-1,-1,2,-1
KR_6760804157,420,-5,-60,-6,-11,-5,9,4,-3,5,2,-4,4,0,1,3,4,0,1,1,0,-3,-7,-5,0,5,1,0,-1,1,-1,-1,-1,4,-1
KR_6757882466,420,-2,-114,-12,-9,-7,8,1,0,3,3,2,2,4,-3,4,1,-1,2,1,0,4,-16,-5,-2,7,-5,0,-4,-1,-1,-1,-1,2,-1
KR_6679668884,420,-2,-10,-4,-11,-6,6,0,2,2,4,-3,5,2,-1,3,2,-3,3,0,0,-12,95,-4,-7,11,-2,0,0,-1,-1,0,-1,3,-1
KR_6754993981,440,1,-32,-38,4,0,3,3,0,1,1,0,4,4,4,2,6,0,1,1,0,9,-2,3,-6,3,-5,0,0,-1,-1,0,-1,1,-1
KR_6727357145,420,-5,-27,-28,-5,0,3,3,-2,2,0,-1,3,2,-2,3,1,0,0,0,0,-1,40,1,-2,1,-23,0,-1,1,-1,-1,1,5,-1
KR_6745873904,420,-6,-35,-8,-17,-4,6,2,-6,7,1,-2,3,1,0,2,2,-5,7,2,-1,-16,-24,-1,-6,7,-6,0,0,0,1,-1,-1,0,-1
KR_6760542712,440,-3,-59,-22,-3,0,5,5,1,2,3,1,2,3,-4,6,2,-1,1,0,-2,-4,126,2,-3,1,22,0,-2,0,1,-1,-1,0,-1
KR_6743998374,440,-4,-59,16,-6,-1,2,1,-3,5,2,-3,7,4,1,2,3,0,0,0,0,-2,-5,-1,-4,5,-4,0,0,-1,-1,-1,1,2,-1
KR_6757636026,420,0,-46,0,2,2,1,3,1,2,3,2,2,4,-4,5,1,1,0,1,0,1,-19,1,-5,4,3,0,0,-1,1,0,1,1,-1
KR_6761010852,420,1,31,-28,-1,0,2,2,0,4,4,-1,1,0,1,7,8,-1,1,0,0,-6,-8,-3,-6,9,2,0,0,1,-1,0,1,3,-1
KR_6670256833,420,-3,31,-5,-12,0,1,1,-3,5,2,-6,6,0,2,2,4,-5,7,2,0,-10,-3,-5,-2,7,6,0,-1,-1,-1,-1,1,5,-1
KR_6712489610,420,-2,-44,-12,-6,0,1,1,0,3,3,0,2,2,-7,8,1,1,1,2,0,-6,-165,-1,-6,7,1,0,0,-1,1,0,-1,3,-1
KR_6730706183,440,-6,-49,-18,-16,-4,6,2,-7,8,1,-2,4,2,0,1,1,-3,3,0,0,-24,-9,-4,-4,8,-2,0,-2,-1,-1,-1,-1,4,-1
KR_6751415247,420,3,-11,20,13,4,1,5,2,2,4,3,2,5,2,2,4,2,2,4,0,7,-13,0,-4,4,-1,0,-1,0,-1,-1,1,0,-1
KR_6769779748,420,-2,29,16,-5,6,1,7,-1,2,1,-1,3,2,-6,6,0,-3,4,1,1,-17,11,-6,-4,10,2,0,1,1,1,1,1,2,-1
KR_6762855044,420,-2,-72,-32,0,-2,6,4,2,1,3,0,3,3,2,0,2,-2,5,3,0,3,39,-2,-2,4,25,0,0,1,-1,-1,-1,1,-1
KR_6763958638,420,3,-17,0,9,3,1,4,0,2,2,0,1,1,3,1,4,3,0,3,0,17,127,0,-5,5,0,0,1,1,0,1,-1,1,-1
KR_6765803937,440,-1,-24,-17,-4,1,0,1,-1,3,2,-2,4,2,-4,4,0,2,0,2,0,-6,-7,0,-3,3,-3,0,0,-1,1,0,-1,5,-1
KR_6624300274,420,-4,-57,12,-8,-3,6,3,2,3,5,-4,5,1,-1,2,1,-2,3,1,-1,4,15,4,-10,6,1,0,-2,-1,-1,-1,-1,4,-1
KR_6766418169,420,-1,-63,8,-3,-1,1,0,-5,7,2,2,1,3,0,2,2,1,1,2,1,0,3,-3,-3,6,2,0,-1,1,1,-1,1,6,-1
KR_6621736662,420,-3,-13,-4,-5,-7,7,0,-2,4,2,1,3,4,7,2,9,-4,4,0,1,-6,-9,1,-3,2,0,0,0,-1,-1,-1,-1,3,-1
KR_6760949683,420,0,-20,-13,3,4,1,5,2,1,3,1,1,2,0,1,1,-4,5,1,-1,4,-265,-2,-3,5,5,0,1,-1,1,1,-1,6,-1
KR_6618518773,420,1,-36,-8,4,-1,1,0,2,1,3,1,4,5,3,3,6,-1,1,0,0,1,1,-3,-6,9,4,0,0,-1,0,0,1,2,-1
KR_6698592196,420,-2,-13,21,-8,-2,2,0,-2,3,1,0,2,2,-3,7,4,-1,1,0,0,-4,-5,-4,-3,7,-3,0,-2,-1,-1,-1,1,4,-1
KR_6713233175,420,-1,-25,7,-9,-1,3,2,-1,6,5,-3,4,1,-4,6,2,0,0,0,0,-6,-8,-6,-1,7,1,0,-1,-1,-1,-1,-1,2,-1
KR_6748202539,420,1,-61,8,3,0,1,1,1,2,3,3,0,3,-2,4,2,1,0,1,-2,2,12,0,-6,6,-4,0,-1,-1,1,-1,-1,1,-1
KR_6769455151,420,-3,-63,-18,-6,0,1,1,-1,3,2,-1,3,2,-4,5,1,0,0,0,0,-6,-31,1,-6,5,7,0,0,-1,-1,1,1,2,-1
KR_6734068468,420,-1,-62,-16,2,0,0,0,1,3,4,1,0,1,-6,10,4,6,0,6,0,6,-2,2,-7,5,-4,0,-1,-1,-1,-1,-1,6,-1
KR_6700988690,420,-1,-13,0,0,-1,3,2,2,2,4,2,2,4,-3,4,1,0,0,0,0,-1,-2,2,-4,2,3,0,0,-1,1,1,-1,4,-1
KR_6728027289,420,-1,-58,-28,-5,-1,3,2,-1,3,2,-2,6,4,-1,5,4,0,1,1,-2,-1,13,-4,-3,7,-1,0,0,-1,1,1,1,2,-1
KR_5738843104,420,1,-8,0,-10,2,2,4,-5,10,5,-3,4,1,-3,6,3,-1,1,0,-3,-7,-2,-5,-6,11,-2,0,-2,-1,-1,-1,-1,4,-1
KR_6656250167,420,0,-23,0,3,3,1,4,-1,2,1,1,2,3,0,1,1,0,1,1,0,0,-333,1,-7,6,-4,0,-1,-1,-1,-1,-1,1,-1
KR_6647442047,420,-2,15,-6,-4,3,2,5,-4,7,3,0,2,2,-3,4,1,0,3,3,-3,-13,-7,-3,-4,7,-4,0,0,-1,1,1,-1,3,-1
KR_6704280117,420,-6,-78,-12,-10,-2,3,1,0,3,3,-1,2,1,-3,3,0,-4,4,0,0,-3,-4,1,-8,7,-5,0,-2,-1,-1,-1,-1,4,-1
KR_6737293192,420,-2,39,-33,-10,5,1,6,-3,3,0,0,1,1,-11,11,0,-1,1,0,0,-16,-43,3,-6,3,35,0,-1,1,-1,-1,-1,1,-1
KR_6759408185,420,-5,-104,10,-10,1,0,1,-4,5,1,-3,4,1,-1,2,1,-3,3,0,0,-10,-198,-1,-3,4,1,0,-1,1,-1,-1,-1,6,-1
KR_6679110447,420,1,-6,-20,2,0,4,4,-3,5,2,4,1,5,-1,2,1,2,2,4,0,2,-26,-1,-5,6,-4,0,-1,-1,-1,-1,1,3,-1
KR_6722986542,440,3,-37,-4,10,3,0,3,1,1,2,3,2,5,1,1,2,2,0,2,0,10,8,2,-4,2,-2,0,0,1,-1,0,1,4,-1
KR_6437214662,420,0,-43,-5,4,1,3,4,2,0,2,1,2,3,1,1,2,-1,3,2,0,11,3,2,-6,4,-4,0,-1,1,-1,-1,-1,1,-1
KR_6725472894,420,-1,-3,6,1,-1,2,1,0,5,5,2,1,3,-2,3,1,2,0,2,1,-1,2,-2,-3,5,-2,0,0,1,0,0,1,4,-1
KR_6760060807,440,-2,-23,3,-3,-2,4,2,-2,2,0,3,0,3,0,0,0,-2,2,0,-1,-8,-4,-2,-1,3,-1,0,0,-1,0,0,-1,1,-1
KR_6752026520,420,-7,-12,-12,-9,-4,4,0,-1,2,1,1,2,3,-3,3,0,-2,3,1,0,-12,-70,0,-4,4,-29,0,0,1,1,0,1,2,-1
KR_6608123137,420,-1,-36,-25,0,1,1,2,2,1,3,0,2,2,-3,4,1,0,0,0,0,-3,2,-2,-3,5,-3,0,-1,-1,1,1,1,4,-1
KR_6749370568,440,-4,20,4,-10,-4,6,2,-3,3,0,4,1,5,-5,7,2,-2,2,0,2,-11,-16,-1,-3,4,1,0,-1,-1,1,-1,1,4,-1
KR_6646428318,440,-1,7,-25,-7,2,0,2,-4,6,2,0,1,1,-2,3,1,-3,3,0,0,-16,-2,0,-5,5,-5,0,0,1,-1,-1,-1,5,-1
KR_6734407619,420,1,13,-4,4,4,2,6,2,0,2,1,3,4,-2,2,0,-1,1,0,0,-4,-26,2,-5,3,1,0,2,-1,1,1,-1,5,-1
KR_6655601379,440,-2,-79,-15,-4,-4,4,0,-2,4,2,1,3,4,1,1,2,0,1,1,1,4,-6,1,-1,0,0,0,0,1,1,-1,1,6,-1
KR_6711903375,420,-2,-20,5,0,1,2,3,-1,6,5,0,2,2,0,2,2,0,0,0,0,4,4,-3,-5,8,-4,0,0,0,1,0,-1,0,-1
KR_6760609147,420,1,-46,20,-9,-2,3,1,0,1,1,-2,3,1,-5,5,0,0,0,0,0,-10,141,-2,-2,4,-24,0,0,1,-1,-1,-1,6,-1
KR_6745838616,420,1,10,22,1,2,0,2,2,1,3,2,2,4,-3,4,1,-2,3,1,0,-7,114,-2,-4,6,2,0,2,0,1,1,-1,0,-1
KR_6736007716,420,-7,-143,-40,-10,-3,6,3,-3,6,3,-1,6,5,-2,4,2,-1,2,1,0,0,-17,4,-8,4,-1,0,-1,1,-1,-1,-1,1,-1
KR_6675001403,440,-3,-35,-16,-7,1,1,2,0,2,2,2,0,2,-12,12,0,2,0,2,0,-5,-4,4,-6,2,0,0,-1,0,1,-1,-1,0,-1
KR_6740488270,440,-2,16,3,-7,-1,1,0,-3,6,3,-2,3,1,-2,4,2,1,2,3,-2,-13,-11,-6,-3,9,2,0,0,0,-1,0,-1,0,-1
KR_6487590540,420,-1,43,-20,-8,0,0,0,-5,5,0,0,1,1,0,2,2,-3,4,1,0,-9,-1,-2,-2,4,-3,0,1,-1,-1,1,1,3,-1
KR_6726214580,440,-6,-98,12,-13,-1,1,0,-2,2,0,-10,10,0,2,2,4,-2,2,0,0,-9,3,-1,-3,4,3,0,-3,1,-1,-1,1,6,-1
KR_6767401655,440,-4,-47,-28,-9,-1,1,0,-4,5,1,-3,4,1,-1,1,0,0,0,0,0,-6,400,-1,-1,2,-1,0,-1,0,0,-1,-1,0,-1
KR_6765373903,420,-5,-80,-16,-8,-4,5,1,0,1,1,-4,5,1,0,3,3,0,3,3,0,-2,-30,2,-4,2,-1,0,-2,-1,-1,-1,-1,6,-1
KR_6657435240,420,-2,-8,-5,-3,3,1,4,-1,3,2,2,1,3,0,2,2,-7,7,0,0,-8,13,-6,-3,9,-5,0,1,-1,0,1,-1,5,-1
KR_6753642702,420,2,-49,-4,-3,0,2,2,0,8,8,1,3,4,-4,8,4,0,3,3,3,0,-30,-1,-7,8,0,0,-1,0,-1,-1,1,0,-1
KR_6743473096,420,0,0,7,-2,-1,2,1,-1,3,2,0,0,0,0,2,2,0,1,1,0,-3,-14,-3,-3,6,2,0,-1,1,-1,-1,1,1,-1
KR_6763510527,420,0,-37,-8,2,1,1,2,1,3,4,1,2,3,0,4,4,-1,1,0,-3,0,4,-2,-4,6,4,0,-1,-1,1,-1,-1,5,-1
KR_6759507783,420,-3,-50,-36,-7,-3,3,0,-2,4,2,-3,5,2,-3,4,1,4,0,4,0,-3,9,2,-5,3,-4,0,0,1,-1,-1,-1,5,-1
KR_6730339089,420,-5,-88,1,-9,-4,4,0,-2,5,3,-2,2,0,0,1,1,-1,1,0,0,-5,-7,0,-4,4,4,0,-1,1,-1,-1,-1,6,-1
KR_6680383428,420,-1,-24,12,-1,0,2,2,2,0,2,0,1,1,-2,2,0,-1,1,0,-1,-6,-3,-1,-5,6,0,0,0,-1,1,-1,-1,2,-1
KR_6764893550,420,0,-35,28,1,0,1,1,1,4,5,2,0,2,-1,1,0,-1,2,1,0,2,38,-2,-4,6,1,0,0,-1,0,-1,-1,3,-1
KR_6759488272,420,-1,20,-40,-2,5,0,5,-8,8,0,2,1,3,0,0,0,-1,1,0,-1,-6,3,-1,-3,4,-1,0,0,-1,-1,0,-1,6,-1
KR_6756226199,440,-3,-21,-36,-5,-6,8,2,0,0,0,3,0,3,-1,5,4,-1,1,0,-2,-5,1,0,-4,4,-4,0,-2,1,-1,-1,-1,6,-1
KR_6706017102,420,0,2,-10,-2,2,0,2,-3,5,2,1,3,4,0,0,0,-2,2,0,0,5,-9,-1,-6,7,2,0,-1,-1,-1,-1,-1,6,-1
KR_6749122324,420,-5,-78,-12,-9,-1,3,2,-4,5,1,0,3,3,1,2,3,-5,5,0,-1,-16,-36,2,-5,3,3,0,-3,-1,-1,-1,-1,1,-1
KR_6708732455,420,-1,-31,0,-10,-3,4,1,-2,3,1,1,2,3,-5,5,0,-1,1,0,0,-11,-2,0,-5,5,-2,0,0,1,-1,0,1,3,-1
KR_6718231363,420,-3,-28,-29,-7,-1,2,1,-4,4,0,-2,3,1,0,5,5,0,2,2,-1,-12,4,-2,-3,5,0,0,0,-1,1,0,-1,6,-1
KR_6767497951,420,-5,-140,-28,-9,0,0,0,0,1,1,0,3,3,-9,12,3,0,0,0,0,-2,-7,3,-6,3,3,0,-2,-1,0,-1,1,6,-1
KR_6763086448,420,0,4,-1,3,4,0,4,0,3,3,0,1,1,-2,4,2,1,0,1,1,7,-357,5,-10,5,2,0,0,0,-1,1,1,0,-1
KR_6769240130,420,-2,2,-19,-2,-2,2,0,0,3,3,0,2,2,-2,3,1,2,1,3,0,3,-48,-1,-4,5,3,0,-2,1,-1,-1,1,6,-1
KR_6763875070,420,1,-25,-12,1,-1,2,1,2,1,3,-1,4,3,2,0,2,-1,2,1,0,-2,-3,1,-5,4,1,0,-1,-1,0,-1,-1,1,-1
KR_6631156791,420,-2,-16,6,-3,-1,1,0,-5,5,0,2,1,3,-4,4,0,5,0,5,0,-1,10,1,-8,7,-9,0,0,-1,-1,-1,1,2,-1
KR_6769583369,420,-2,-33,-5,-4,1,1,2,0,3,3,-2,4,2,-2,5,3,-1,2,1,-1,-8,6,-1,-2,3,1,0,0,-1,-1,0,-1,1,-1
KR_6731889681,420,-3,-33,0,-11,0,2,2,-3,5,2,-6,7,1,-2,2,0,0,1,1,0,-6,5,3,-8,5,2,0,0,-1,-1,0,1,5,-1
KR_6768750447,420,-2,-50,24,-3,-2,3,1,-2,2,0,4,0,4,-2,5,3,-1,2,1,0,-7,-64,-1,-2,3,26,0,-1,-1,1,-1,-1,2,-1
KR_6753332064,420,4,17,-4,11,0,2,2,6,1,7,-2,2,0,6,1,7,1,0,1,0,16,-6,3,-7,4,6,0,-1,-1,-1,-1,1,2,-1
KR_6751794924,420,2,37,12,5,0,3,3,1,1,2,2,3,5,2,0,2,0,2,2,0,6,-4,-2,-3,5,3,0,0,-1,1,-1,1,3,-1
KR_6693657527,420,0,26,12,-3,3,1,4,3,3,6,-1,4,3,-3,5,2,-5,5,0,0,-9,5,-2,-6,8,-5,0,-1,0,1,-1,1,0,-1
KR_6768706549,420,1,23,-24,-1,1,1,2,-2,3,1,-4,6,2,4,1,5,0,1,1,0,-5,4,5,-6,1,-2,0,1,-1,-1,1,-1,3,-1
KR_6760944152,420,-1,4,4,-5,0,1,1,-4,4,0,2,3,5,-2,3,1,-1,1,0,-1,-16,93,4,-7,3,-3,0,2,1,1,1,-1,4,-1
KR_6722468295,440,-1,46,-6,-1,1,1,2,0,4,4,0,0,0,1,0,1,-3,8,5,0,2,-7,-2,-1,3,4,0,1,0,1,1,-1,0,-1
KR_6726168872,420,1,32,-28,0,2,0,2,3,4,7,-2,2,0,-2,3,1,-1,1,0,-1,-3,-1,0,-6,6,-4,0,1,-1,-1,1,-1,1,-1
KR_6746152309,420,-2,-25,17,-10,-2,4,2,-2,3,1,0,4,4,-4,6,2,-2,2,0,0,-2,-8,-3,-2,5,1,0,-1,-1,1,-1,-1,4,-1
KR_6757201057,420,-5,-93,2,-9,0,2,2,-4,4,0,-4,4,0,-2,6,4,1,0,1,-1,-14,2,-1,-7,8,-1,0,-4,-1,-1,-1,-1,1,-1
KR_6764040683,420,-1,-5,-11,2,0,0,0,1,3,4,0,4,4,3,3,6,-2,2,0,0,0,5,3,-7,4,1,0,0,0,1,0,-1,0,-1
KR_6730094700,420,2,-56,9,10,3,1,4,-1,3,2,-1,4,3,5,0,5,4,0,4,0,15,8,-2,-3,5,0,0,0,1,1,-1,1,5,-1
KR_6737778395,420,-1,-11,3,-14,1,0,1,-5,6,1,-4,5,1,-6,7,1,0,0,0,0,-12,-2,-1,-7,8,-1,0,-1,-1,0,-1,-1,1,-1
KR_6646388886,420,3,4,1,0,-1,3,2,2,1,3,0,2,2,0,3,3,-1,1,0,0,4,9,-1,-4,5,2,0,0,1,-1,-1,-1,2,-1
KR_6751412116,420,0,-11,-32,-1,3,1,4,-3,3,0,1,0,1,-2,6,4,0,1,1,0,-4,7,4,-8,4,-4,0,0,-1,-1,-1,1,5,-1
KR_6755385896,420,0,37,-34,4,0,1,1,4,0,4,2,2,4,-1,4,3,-1,2,1,0,8,251,2,-6,4,2,0,-1,-1,-1,-1,-1,4,-1
KR_6729682614,420,1,9,-16,2,1,1,2,2,2,4,-1,4,3,2,0,2,-2,3,1,0,0,-107,0,-2,2,-2,0,0,-1,-1,0,1,1,-1
KR_6743848338,420,-4,-40,24,-11,-2,3,1,-6,6,0,-3,5,2,0,3,3,0,0,0,0,-5,-34,-1,-5,6,-2,0,-1,-1,-1,-1,-1,1,-1
KR_6729613148,420,1,-34,13,-4,-4,4,0,0,3,3,0,3,3,-2,4,2,2,2,4,-1,4,28,-1,-1,2,4,0,0,1,-1,-1,-1,5,-1
KR_6638039087,420,-1,-23,8,-5,-1,2,1,2,3,5,-1,3,2,-5,6,1,0,2,2,-1,-13,0,-6,-1,7,1,0,-1,-1,0,-1,-1,3,-1
KR_6760298448,420,-5,-16,-2,-17,-4,5,1,1,1,2,-6,6,0,-7,9,2,-1,1,0,-1,-26,-6,-3,-2,5,1,0,-2,1,-1,-1,-1,6,-1
KR_6693942055,420,-7,-68,-4,-18,-2,4,2,-9,12,3,-2,2,0,-4,4,0,-1,1,0,0,-22,11,6,-10,4,-4,0,-2,-1,-1,-1,-1,4,-1
KR_6450563030,440,-2,7,0,-3,-5,7,2,0,1,1,-2,3,1,1,0,1,3,0,3,0,3,40,-5,-2,7,-12,0,-1,-1,-1,-1,1,6,-1
KR_6748080508,420,-2,-35,11,-4,-1,3,2,-6,7,1,3,2,5,1,1,2,-1,2,1,0,-4,179,0,-3,3,0,0,-1,-1,-1,-1,1,5,-1
KR_6682831249,420,-1,11,0,-1,-3,5,2,2,2,4,2,3,5,-3,3,0,1,0,1,0,2,1,-3,-5,8,3,0,-1,1,-1,-1,1,5,-1
KR_6763341363,420,2,9,12,5,0,2,2,1,3,4,-3,3,0,4,0,4,3,0,3,0,0,-9,-1,-3,4,0,0,1,-1,1,1,1,6,-1
KR_6764369391,420,3,26,-10,-4,-1,2,1,1,1,2,3,0,3,-3,4,1,-4,6,2,-1,-4,-24,-7,-1,8,-1,0,0,-1,1,-1,-1,5,-1
KR_6749944450,420,-3,-40,-6,-3,-2,3,1,-2,4,2,-1,3,2,1,1,2,1,1,2,0,-5,-40,-4,-2,6,20,0,-1,-1,1,-1,-1,1,-1
KR_6762452786,420,3,-24,30,2,1,1,2,1,1,2,-1,3,2,1,3,4,0,0,0,0,-3,-3,1,-4,3,-4,0,-1,1,-1,-1,1,6,-1
KR_6705631105,420,-4,-41,11,-10,0,1,1,0,2,2,-3,3,0,-7,11,4,0,1,1,0,-7,12,-2,-2,4,-3,0,0,0,0,0,-1,0,-1
KR_6713195242,420,-2,-47,35,-9,0,1,1,-2,6,4,-1,3,2,-4,7,3,-2,2,0,0,-14,45,-1,-3,4,-27,0,-1,0,-1,-1,1,0,-1
KR_6735307640,420,0,28,9,1,-2,3,1,-2,3,1,0,3,3,1,1,2,4,0,4,-1,4,-92,3,-5,2,-1,0,0,1,-1,-1,-1,6,-1
KR_6765232388,420,0,-55,1,-1,3,2,5,-2,3,1,-2,3,1,-1,2,1,1,1,2,-1,2,-7,-2,-3,5,-2,0,0,-1,1,-1,-1,2,-1
KR_6762850992,420,-1,-14,-9,1,3,0,3,1,2,3,-2,5,3,-2,2,0,1,1,2,0,1,-3,2,-6,4,0,0,-1,-1,1,-1,1,4,-1
KR_6630484494,420,0,-51,-4,-7,-1,2,1,-1,3,2,-1,3,2,-5,5,0,1,2,3,0,-8,-321,0,-4,4,7,0,0,-1,-1,0,-1,1,-1
KR_6734553753,420,-3,0,-44,-2,-3,5,2,-5,6,1,1,1,2,5,0,5,0,1,1,1,-8,-6,5,-9,4,1,0,1,-1,-1,-1,1,1,-1
KR_6696713062,420,0,6,-11,-5,-3,5,2,4,4,8,-2,2,0,-4,5,1,0,0,0,0,3,8,-1,-9,10,-5,0,-2,1,-1,-1,-1,2,-1
KR_6692655456,440,-2,-21,-32,0,4,0,4,1,3,4,-3,4,1,-1,4,3,-1,1,0,-1,1,-6,-3,-5,8,3,0,-1,-1,-1,-1,-1,4,-1
KR_6762401908,420,0,2,-13,0,1,1,2,-1,5,4,2,0,2,-1,2,1,-1,1,0,0,3,-43,-2,-5,7,35,0,-1,-1,1,-1,1,4,-1
KR_6734794249,420,-5,-38,-9,-14,-4,4,0,-7,7,0,1,2,3,-3,7,4,-1,3,2,0,-8,108,-1,-4,5,0,0,-1,-1,1,-1,-1,5,-1
KR_6744588623,420,-3,-4,2,-6,4,0,4,-5,7,2,-3,3,0,1,0,1,-3,3,0,-1,-7,-3,-2,-5,7,-3,0,-1,-1,-1,-1,-1,6,-1
KR_6698148797,420,-3,-11,-48,-4,-2,3,1,1,0,1,-4,4,0,1,0,1,0,0,0,0,2,1,3,-5,2,1,0,-1,-1,-1,-1,-1,5,-1
KR_6670393891,420,-1,-43,-32,-2,-3,5,2,3,0,3,-2,3,1,0,4,4,0,3,3,0,1,-251,-3,-2,5,-1,0,0,-1,-1,1,-1,3,-1
KR_5736167277,420,-1,-64,-55,5,1,3,4,2,3,5,-2,4,2,3,0,3,1,0,1,-1,11,-7,0,-9,9,2,0,-1,1,-1,-1,-1,4,-1
KR_6667288560,440,1,15,12,13,-2,2,0,3,2,5,1,1,2,8,1,9,3,0,3,0,26,-8,1,-5,4,-1,0,1,0,0,1,1,0,-1
KR_6766190373,420,-4,-26,0,-4,1,1,2,-2,5,3,-3,7,4,-1,4,3,1,1,2,0,4,-6,1,-4,3,1,0,0,-1,1,0,1,6,-1
KR_6768211695,440,-1,-75,-3,-2,2,2,4,1,4,5,-4,7,3,1,3,4,-2,3,1,0,0,352,-6,-2,8,-1,0,-2,1,-1,-1,1,2,-1
KR_6596108894,420,-4,-66,-19,-4,-2,3,1,1,1,2,0,2,2,-6,6,0,3,0,3,0,-3,20,3,-7,4,1,0,-3,-1,-1,-1,1,1,-1
KR_6713211537,420,-4,-31,6,-11,-3,4,1,-2,6,4,0,5,5,2,4,6,-8,8,0,0,-10,-7,1,-7,6,-2,0,-4,1,-1,-1,1,6,-1
KR_6750936536,420,1,-33,-7,9,0,2,2,7,1,8,3,2,5,0,1,1,-1,1,0,0,5,-1,1,-5,4,-2,0,0,-1,1,1,-1,1,-1
KR_6740529495,420,0,-3,2,-5,5,1,6,-6,8,2,-3,6,3,-2,4,2,1,2,3,0,0,-33,-4,-4,8,3,0,-2,0,-1,-1,-1,0,-1
KR_6749688761,420,-3,7,-36,-8,-1,1,0,-5,6,1,4,1,5,-5,5,0,-1,1,0,0,-11,-19,-2,-4,6,2,0,-1,-1,-1,-1,1,2,-1
KR_6709226483,420,-4,-71,-29,-4,-1,4,3,-1,6,5,0,1,1,-3,7,4,1,0,1,0,-6,-2,-3,-1,4,0,0,-1,-1,-1,-1,1,2,-1
KR_6746392507,420,0,-26,14,3,2,1,3,-1,4,3,2,0,2,-2,7,5,2,2,4,0,2,144,-1,-4,5,2,0,0,-1,1,0,1,1,-1
KR_6674579299,420,-6,-30,-32,-16,-2,2,0,-3,5,2,-1,2,1,-3,6,3,-7,7,0,-1,-25,-35,-2,-2,4,-5,0,-1,-1,-1,-1,-1,4,-1
KR_6659022354,420,-3,-72,5,-12,-1,2,1,-2,4,2,-3,4,1,2,3,5,-8,9,1,1,-14,-56,-9,-1,10,18,0,-2,-1,-1,-1,1,6,-1
KR_6764510565,420,-6,-24,-4,-11,-5,6,1,-1,2,1,0,1,1,-5,5,0,0,0,0,-1,-11,-9,0,-6,6,0,0,-1,-1,-1,-1,-1,5,-1
KR_6764919526,420,-5,-85,0,-9,-8,8,0,0,1,1,1,1,2,-2,2,0,0,1,1,0,-8,-3,1,-7,6,-2,0,-2,1,-1,-1,-1,5,-1
KR_6737527533,440,-1,-87,25,-3,-4,4,0,6,4,10,0,4,4,-4,5,1,-1,3,2,0,-3,4,-5,-2,7,0,0,-2,1,-1,-1,-1,4,-1
KR_6593882278,420,1,10,4,-6,2,1,3,-4,6,2,-2,4,2,1,5,6,-3,3,0,0,-10,-11,-3,-4,7,5,0,0,1,-1,-1,1,1,-1
KR_6739140282,420,1,-16,-4,-1,2,1,3,-1,8,7,-1,3,2,1,0,1,-2,2,0,0,1,-7,-1,-4,5,-1,0,-1,-1,-1,-1,1,5,-1
KR_6760752225,420,-2,-5,-16,-3,-2,3,1,0,2,2,4,3,7,0,4,4,-5,5,0,-1,-3,6,3,-5,2,-3,0,-2,-1,-1,-1,-1,5,-1
KR_6769704303,420,-2,-15,-28,3,2,0,2,0,1,1,-1,4,3,-1,2,1,3,0,3,0,8,547,1,-5,4,-2,0,0,1,1,0,1,1,-1
KR_6590152963,420,-2,-42,6,-8,-6,6,0,-1,2,1,1,1,2,-2,6,4,0,1,1,1,-1,-12,-1,-7,8,4,0,-2,-1,1,-1,1,5,-1
KR_6725025788,440,-2,-37,11,-2,1,0,1,0,6,6,1,3,4,-4,7,3,0,0,0,0,2,-9,7,-8,1,-2,0,-1,1,-1,-1,-1,5,-1
KR_6683835424,420,-3,-34,-20,-4,2,2,4,-4,6,2,0,1,1,-1,5,4,-1,1,0,0,0,-183,-4,-5,9,0,0,-3,1,-1,-1,1,6,-1
KR_6673660307,420,-1,18,5,-5,1,1,2,1,2,3,0,1,1,-7,9,2,0,1,1,0,-10,19,4,-7,3,-2,0,-1,-1,1,-1,-1,2,-1
KR_6743154938,420,-4,15,20,-10,-4,4,0,1,2,3,-1,2,1,-2,2,0,-4,4,0,0,-9,-10,-3,-3,6,0,0,-2,1,-1,-1,-1,5,-1
KR_6752538837,420,-5,-66,-32,-9,-1,1,0,-4,6,2,-1,3,2,-2,5,3,-1,1,0,0,-9,-4,-2,-4,6,0,0,0,-1,-1,-1,-1,1,-1
KR_6755352179,420,2,29,-4,8,3,2,5,0,2,2,1,3,4,0,4,4,4,1,5,0,2,7,7,-9,2,-3,0,-2,0,1,1,1,0,-1
KR_6713700286,420,-3,1,-42,-10,6,0,6,-4,5,1,-6,7,1,-3,4,1,-3,4,1,0,-16,-8,0,-3,3,7,0,0,-1,1,-1,1,5,-1
KR_6729549727,420,-6,-48,-14,-15,-4,4,0,-6,6,0,1,0,1,-5,6,1,-1,3,2,0,-9,-224,1,-4,3,-1,0,-1,-1,-1,-1,-1,1,-1
KR_6695043083,420,-1,-22,-22,-2,0,3,3,-2,7,5,0,2,2,0,2,2,0,4,4,0,-2,-1,-1,-5,6,-5,0,-1,-1,-1,-1,-1,6,-1
KR_6684979291,420,-3,-49,-28,-9,0,2,2,1,3,4,-5,6,1,-6,6,0,1,0,1,-1,-1,-113,-1,-6,7,-3,0,-1,-1,-1,-1,-1,3,-1
KR_6769383679,420,-1,-21,-30,-5,-1,5,4,0,2,2,1,3,4,-5,5,0,0,3,3,-1,-13,15,7,-9,2,-3,0,-1,-1,1,-1,-1,2,-1
KR_6749392652,420,-2,-66,-15,-16,1,0,1,-2,8,6,-2,3,1,-13,13,0,0,2,2,0,-12,-19,1,-3,2,-2,0,-3,1,1,-1,-1,1,-1
KR_6730091633,420,-6,-137,-12,-13,-5,5,0,0,0,0,-4,4,0,-7,7,0,3,0,3,0,-9,2,2,-6,4,-5,0,-4,-1,-1,-1,-1,4,-1
KR_6765665796,420,-2,-34,-16,-7,1,1,2,-8,11,3,1,1,2,-1,6,5,0,0,0,1,-8,27,-2,-3,5,-2,0,-1,-1,-1,-1,1,6,-1
KR_6729169693,420,-3,-52,-20,-12,-1,1,0,-3,3,0,-5,5,0,-6,10,4,3,0,3,0,-12,-141,-1,-5,6,-2,0,0,1,-1,-1,-1,4,-1
KR_6752964539,440,-4,-47,-5,-12,2,0,2,-3,3,0,-2,2,0,-9,11,2,0,3,3,0,-15,4,2,-7,5,-3,0,-2,-1,-1,-1,-1,5,-1
KR_6756534559,420,-5,-119,-28,-14,-3,5,2,-1,1,0,-6,6,0,-4,11,7,0,0,0,1,-11,-4,-5,-2,7,0,0,-2,-1,-1,-1,1,6,-1
KR_6763530904,420,-2,-80,7,-7,-2,5,3,-1,3,2,-1,5,4,-3,3,0,0,2,2,0,-3,-15,-1,-4,5,-2,0,-2,1,-1,-1,-1,6,-1
KR_6680050806,420,-4,-13,-16,-25,-2,4,2,-10,11,1,-5,7,2,-7,9,2,-1,2,1,-1,-32,15,2,-6,4,0,0,-1,-1,1,-1,-1,1,-1
KR_6717396380,420,-2,-50,-37,0,0,2,2,4,1,5,0,1,1,-4,5,1,0,1,1,0,0,-15,2,-10,8,-2,0,-1,-1,-1,-1,-1,6,-1
KR_6617689026,420,-1,-19,-17,-1,-3,5,2,0,1,1,1,1,2,1,3,4,0,0,0,0,1,-12,2,-5,3,2,0,0,1,-1,0,1,4,-1
KR_6608950409,420,0,-28,-3,-1,2,0,2,-7,9,2,3,0,3,0,3,3,1,2,3,0,-4,12,0,-4,4,-3,0,0,-1,-1,-1,1,2,-1
KR_6590064706,420,-1,-65,-9,1,-5,6,1,3,1,4,3,0,3,0,0,0,0,0,0,0,5,-20,3,-7,4,0,0,0,-1,-1,-1,1,3,-1
KR_6754328809,420,-1,-42,-4,-6,-3,4,1,-1,1,0,2,4,6,-1,2,1,-3,3,0,-1,-4,-9,0,-3,3,0,0,-1,-1,-1,-1,-1,6,-1
KR_6736346598,420,-3,-46,-16,-15,-2,3,1,-5,5,0,-1,4,3,-6,7,1,-1,1,0,-1,-21,-136,-5,-3,8,0,0,-3,-1,-1,-1,-1,1,-1
KR_6717193872,420,-2,-50,15,-6,0,2,2,-1,3,2,-1,1,0,-3,5,2,-1,3,2,0,-4,-3,-4,-4,8,3,0,1,-1,1,1,-1,3,-1
KR_6746016151,420,-6,-63,12,-14,-4,4,0,-4,4,0,2,2,4,-5,6,1,-3,5,2,0,-14,-23,2,-4,2,3,0,-1,-1,-1,-1,-1,4,-1
KR_6714374118,440,-5,-88,-8,-11,-5,6,1,-5,7,2,-3,3,0,1,4,5,1,0,1,0,-7,8,2,-7,5,-1,0,0,-1,0,-1,-1,6,-1
KR_6768333670,440,-3,-113,-34,-3,0,3,3,-1,1,0,-1,5,4,1,1,2,-2,2,0,0,3,2,6,-7,1,-4,0,-1,-1,0,-1,-1,3,-1
KR_6368728011,420,1,32,0,1,-2,3,1,2,5,7,0,2,2,2,1,3,-1,1,0,0,1,0,0,0,0,-1,0,1,1,1,1,1,6,-1
KR_6455269379,420,-1,-53,19,-4,-2,3,1,0,2,2,0,3,3,-2,4,2,0,0,0,0,0,-3,-1,-4,5,-4,0,-2,-1,-1,-1,-1,6,-1
KR_6698582164,420,-2,-35,-36,2,-1,4,3,-2,3,1,1,3,4,0,1,1,4,0,4,0,6,0,3,-5,2,-3,0,1,-1,1,1,-1,2,-1
KR_6759671999,420,-1,-37,-16,1,-3,3,0,3,2,5,1,4,5,0,1,1,0,1,1,0,-4,-39,1,-4,3,19,0,1,-1,-1,1,1,1,-1
KR_6740520596,440,-1,-58,24,0,4,3,7,3,0,3,-7,10,3,-1,1,0,1,0,1,0,2,-5,-3,-1,4,0,0,-1,0,1,-1,-1,0,-1
KR_6641624282,420,-3,-49,12,-5,-1,2,1,2,2,4,-1,2,1,-4,5,1,-1,3,2,0,-5,23,0,-6,6,-1,0,0,-1,1,0,1,2,-1
KR_6736112484,420,-3,-6,2,-14,-4,4,0,-4,5,1,-3,3,0,-3,5,2,0,4,4,0,-5,-150,2,-5,3,-5,0,-1,-1,-1,-1,-1,6,-1
KR_6608368664,420,-4,-61,11,-12,-2,3,1,-4,4,0,-3,3,0,0,2,2,-3,3,0,0,-14,4,5,-7,2,-4,0,0,1,-1,0,-1,3,-1
KR_6756166996,420,2,37,32,0,1,4,5,3,0,3,-2,4,2,-1,3,2,-1,2,1,0,-6,-5,-2,-4,6,3,0,1,0,1,1,1,0,-1
KR_6765623796,420,-4,18,-1,-11,-4,4,0,-3,3,0,-1,3,2,-3,3,0,0,1,1,0,-7,14,-6,-1,7,2,0,0,-1,-1,-1,-1,4,-1
KR_6643201705,420,-7,11,2,-10,3,2,5,-3,5,2,-6,6,0,-4,6,2,0,2,2,0,-12,8,3,-7,4,-7,0,0,-1,1,1,-1,6,-1
KR_6743310665,420,1,53,0,0,-2,2,0,0,3,3,-1,4,3,3,0,3,0,0,0,0,-5,-48,0,-6,6,2,0,0,1,-1,0,-1,2,-1
KR_6616729338,420,0,3,-6,1,3,4,7,1,0,1,-5,5,0,2,1,3,0,1,1,1,-8,7,-7,-4,11,3,0,-1,-1,-1,-1,1,3,-1
KR_6765766278,440,0,-1,8,-3,-2,3,1,2,0,2,-1,3,2,-1,1,0,-1,1,0,0,-3,-4,-5,-5,10,1,0,0,1,-1,-1,-1,3,-1
KR_6601634059,420,-2,9,-12,-3,-4,6,2,1,3,4,-1,2,1,0,4,4,1,0,1,2,-7,-2,3,-7,4,-3,0,-2,0,-1,-1,1,0,-1
KR_6698388934,440,-5,-22,-8,-14,0,1,1,-2,5,3,-1,2,1,-9,9,0,-2,3,1,0,-12,-10,0,-5,5,-4,0,0,-1,1,1,-1,5,-1
KR_6755054590,420,-1,-34,-20,-9,1,1,2,-6,6,0,3,0,3,-7,8,1,0,2,2,-1,-21,-2,0,-5,5,4,0,0,-1,-1,-1,-1,2,-1
KR_6695248273,420,-2,13,-12,-2,0,1,1,0,2,2,-1,2,1,0,4,4,-1,2,1,1,4,-2,6,-8,2,-1,0,-1,-1,1,-1,1,6,-1
KR_6693473019,420,2,15,-12,1,1,1,2,-3,6,3,1,1,2,3,3,6,-1,2,1,0,-5,0,-2,-5,7,1,0,0,1,-1,0,1,3,-1
KR_6764283860,420,3,-7,-8,6,0,1,1,5,0,5,4,2,6,-2,3,1,-1,1,0,0,2,11,2,-6,4,-1,0,0,-1,1,-1,-1,1,-1
KR_6757412626,420,1,49,34,-6,1,1,2,-3,5,2,-4,5,1,-1,4,3,1,3,4,0,-16,3,1,-5,4,-4,0,2,-1,-1,-1,-1,2,-1
KR_6765671617,420,-2,-39,-22,-1,3,1,4,-7,9,2,3,0,3,0,4,4,0,2,2,0,-1,2,-2,-5,7,-4,0,0,-1,0,0,-1,1,-1
KR_6759013766,420,-4,-63,8,-5,-2,4,2,0,0,0,-1,3,2,-1,1,0,-1,1,0,0,-4,18,-4,-2,6,1,0,0,-1,1,0,1,6,-1
KR_6769656856,440,2,38,47,4,2,0,2,1,4,5,4,2,6,-4,5,1,1,1,2,0,-13,-51,2,-6,4,1,0,1,-1,1,1,1,3,-1
KR_6733225582,420,1,10,-16,2,1,2,3,1,1,2,-2,2,0,2,1,3,0,0,0,0,0,-4,-1,-5,6,0,0,1,1,-1,1,1,6,-1
KR_6486720846,420,-3,-63,18,-5,-1,1,0,0,3,3,-1,3,2,-3,5,2,0,2,2,0,-10,-5,0,-4,4,4,0,0,1,1,-1,-1,6,-1
KR_6764019457,420,1,-70,8,4,-2,3,1,-3,3,0,2,4,6,3,1,4,4,0,4,0,11,1,3,-7,4,3,0,-2,1,1,-1,1,3,-1
KR_6727000112,420,3,34,19,4,4,1,5,-2,5,3,-2,3,1,7,1,8,-3,3,0,0,-1,6,-1,-4,5,-4,0,2,-1,1,1,1,1,-1
KR_6747521350,420,0,-22,20,-5,1,2,3,-2,3,1,-4,4,0,0,2,2,0,3,3,-1,-3,5,1,-4,3,-1,0,0,-1,-1,0,-1,5,-1
KR_6744178665,420,-6,-26,1,-15,3,0,3,-9,10,1,0,4,4,-7,8,1,-2,3,1,-1,-18,207,-2,-4,6,3,0,-2,1,-1,-1,-1,3,-1
KR_6764480745,420,-3,-76,24,-7,0,1,1,-3,3,0,-4,6,2,1,2,3,-1,1,0,-1,-9,-11,2,-6,4,-3,0,0,-1,1,-1,-1,6,-1
KR_6690082913,420,-4,54,-36,-6,0,0,0,-1,2,1,0,1,1,-4,5,1,-1,1,0,0,-6,26,3,-8,5,-6,0,0,-1,-1,0,-1,3,-1
KR_6693256315,420,-4,-35,-28,-14,-12,12,0,-1,1,0,3,1,4,-3,3,0,-1,1,0,-1,-6,3,-1,-6,7,-7,0,-2,-1,-1,-1,-1,1,-1
KR_6703281558,440,-1,-19,-8,-1,-2,2,0,3,1,4,-3,6,3,1,2,3,0,0,0,0,4,1,-4,-1,5,-1,0,0,-1,1,0,-1,1,-1
KR_6751820589,420,2,-28,4,7,-1,2,1,3,0,3,7,2,9,-1,4,3,-1,1,0,0,5,-1,0,-3,3,-2,0,2,-1,1,1,1,4,-1
KR_6718284610,420,-1,15,-45,5,0,3,3,1,1,2,-3,4,1,4,2,6,3,0,3,0,8,24,3,-4,1,-1,0,-1,-1,-1,-1,1,3,-1
KR_6679115499,420,-2,-33,22,-8,-3,4,1,1,4,5,0,2,2,-6,9,3,0,1,1,1,-10,-6,0,-4,4,1,0,-1,1,1,-1,1,3,-1
KR_6763996679,440,0,-21,12,1,1,1,2,0,2,2,2,2,4,-5,5,0,3,0,3,0,-4,-50,-2,-3,5,30,0,1,-1,1,1,1,2,-1
KR_6734361108,420,-3,-44,-1,-6,-7,7,0,-3,3,0,-1,4,3,5,3,8,0,1,1,0,-3,4,2,-11,9,3,0,-1,1,-1,-1,1,1,-1
KR_6651409701,420,-1,-7,16,-2,-4,5,1,-1,1,0,-2,3,1,4,4,8,1,0,1,0,1,-3,0,-7,7,1,0,0,-1,-1,-1,-1,1,-1
KR_6744145432,420,0,40,27,-9,-1,1,0,-5,5,0,-1,2,1,0,3,3,-2,3,1,0,-12,-1,2,-6,4,-1,0,0,1,1,0,1,4,-1
KR_6718004112,420,-3,-7,-11,-7,1,1,2,-1,1,0,0,1,1,-7,7,0,0,1,1,0,-10,-6,-2,-2,4,-3,0,0,-1,1,-1,-1,3,-1
KR_6756101879,440,1,-18,15,-5,-3,4,1,-1,3,2,2,1,3,-3,4,1,0,1,1,0,-15,-53,2,-5,3,-3,0,0,-1,1,1,-1,1,-1
KR_6666744214,420,-2,8,-20,-7,-3,4,1,-1,4,3,2,0,2,-2,4,2,-3,4,1,0,-9,-6,-6,-2,8,-1,0,0,1,1,-1,-1,2,-1
KR_6754984913,420,2,54,4,-9,-2,6,4,2,1,3,-7,8,1,-7,9,2,5,1,6,-1,-6,-6,-6,0,6,2,0,-2,-1,-1,-1,-1,5,-1
KR_6756771814,420,-2,-45,-1,-11,-3,3,0,-4,5,1,-4,5,1,-1,3,2,1,0,1,-1,-17,-40,-2,-5,7,0,0,-2,1,-1,-1,-1,3,-1
KR_6523358263,420,-7,-50,-16,-11,2,1,3,0,2,2,-8,8,0,-2,5,3,-3,3,0,0,-16,-20,2,-8,6,0,0,0,-1,-1,-1,-1,1,-1
KR_6769117873,420,-3,-27,-8,-15,-2,5,3,-4,5,1,-3,3,0,-7,8,1,1,1,2,0,-22,-2,-5,-3,8,2,0,0,-1,-1,-1,1,1,-1
KR_6455065110,420,-3,-40,-4,-14,2,1,3,-7,7,0,0,3,3,-5,5,0,-4,5,1,-1,-15,3,0,-6,6,-2,0,0,0,1,1,-1,0,-1
KR_6698934882,420,-3,33,-1,-10,-1,2,1,-8,10,2,-5,5,0,4,0,4,0,0,0,0,-14,1,3,-5,2,-1,0,-2,-1,-1,-1,-1,6,-1
KR_6717310927,420,-1,23,4,-4,1,2,3,-2,2,0,-5,6,1,-1,2,1,3,3,6,0,-3,-138,-2,-4,6,1,0,0,-1,0,1,1,5,-1
KR_6699389580,420,-2,-17,0,-6,-4,5,1,0,3,3,0,3,3,-3,5,2,1,1,2,0,-4,-1,-3,-5,8,6,0,0,0,0,0,-1,0,-1
KR_6763269598,420,2,44,8,8,1,3,4,1,4,5,-2,2,0,1,3,4,7,1,8,2,14,-6,5,-6,1,1,0,0,1,1,1,1,6,-1
KR_6650862335,420,-3,-47,-36,1,1,3,4,0,3,3,1,2,3,-2,3,1,1,0,1,0,0,5,1,-3,2,1,0,-1,-1,-1,-1,1,4,-1
KR_6633909427,420,-4,-28,-35,-10,-3,3,0,-3,8,5,0,2,2,-1,3,2,-3,3,0,-1,-7,-24,0,-8,8,2,0,0,-1,1,-1,-1,3,-1
KR_6718635834,420,-3,-29,-24,3,-1,4,3,2,1,3,0,3,3,1,4,5,1,0,1,0,6,23,3,-8,5,0,0,-1,-1,0,-1,1,6,-1
KR_6767311895,420,0,8,4,-7,0,2,2,-1,1,0,-1,3,2,-4,6,2,-1,1,0,-1,-17,-2,-1,-7,8,-3,0,-1,1,-1,-1,-1,4,-1
KR_6747509360,420,0,-26,32,-5,2,2,4,-4,5,1,-1,1,0,-4,6,2,2,0,2,0,-16,-53,0,-7,7,-1,0,0,1,1,1,1,2,-1
KR_6622304215,420,1,-3,-32,1,-6,6,0,2,1,3,-1,4,3,7,3,10,-1,2,1,1,2,-22,1,-6,5,-5,0,0,-1,-1,-1,1,3,-1
KR_6643585538,420,-2,-47,-4,-7,0,4,4,-6,7,1,1,3,4,-2,7,5,0,0,0,-1,1,-255,0,-7,7,-2,0,-2,-1,-1,-1,-1,3,-1
KR_6761659469,420,0,21,13,-3,1,2,3,-7,9,2,-1,2,1,2,2,4,2,2,4,0,-10,2,-3,-1,4,0,0,1,-1,-1,1,-1,3,-1
KR_6675102187,420,1,-11,-7,0,-2,2,0,-5,5,0,7,1,8,-1,2,1,1,1,2,0,1,10,8,-10,2,-3,0,0,0,-1,-1,-1,0,-1
KR_6758777008,420,-1,-67,31,-8,-3,3,0,-1,5,4,2,2,4,-5,5,0,-1,1,0,0,-9,-4,2,-5,3,-5,0,-1,-1,-1,-1,-1,6,-1
KR_6755648941,420,0,-33,8,-8,-8,8,0,-2,4,2,3,4,7,0,3,3,-1,2,1,-1,-10,9,4,-5,1,-2,0,1,1,1,1,-1,5,-1
KR_6685044261,420,-1,-77,16,-6,1,1,2,-4,5,1,-1,5,4,-1,1,0,-1,1,0,0,-3,12,7,-9,2,-3,0,-1,-1,1,-1,-1,2,-1
KR_6507551837,420,0,10,1,1,3,0,3,-2,3,1,2,1,3,-2,6,4,0,0,0,0,-2,0,2,-4,2,1,0,0,-1,1,0,1,2,-1
KR_6655566706,440,1,11,-39,-1,1,1,2,-5,6,1,5,0,5,-1,4,3,-1,1,0,0,4,-11,-4,-1,5,4,0,0,0,0,0,-1,0,-1
KR_6741203418,420,1,-48,24,5,-1,3,2,8,1,9,0,3,3,0,1,1,-2,2,0,1,9,-34,-1,-3,4,17,0,-1,1,1,-1,1,3,-1
KR_6740488508,420,-3,-42,-10,-13,-2,3,1,-3,5,2,0,2,2,-7,7,0,-1,1,0,0,-13,35,2,-6,4,-22,0,0,-1,-1,0,1,2,-1
KR_6631580332,420,1,37,-31,-1,2,0,2,-5,5,0,0,2,2,2,0,2,0,0,0,0,-2,9,1,-5,4,-1,0,1,-1,1,1,-1,6,-1
KR_6729527391,420,0,-10,0,-1,-2,4,2,0,3,3,-3,5,2,4,1,5,0,3,3,0,-5,22,-4,-4,8,-4,0,-1,-1,-1,-1,1,2,-1
KR_6556785751,420,-5,-44,26,-15,-1,3,2,0,2,2,-5,6,1,-7,11,4,-2,2,0,0,-12,0,3,-7,4,1,0,0,1,-1,-1,1,1,-1
KR_6745195462,420,-1,11,-20,-6,-2,3,1,-1,2,1,3,1,4,-4,5,1,-2,3,1,-1,-6,-65,3,-6,3,-3,0,0,-1,1,0,-1,1,-1
KR_6566128888,420,-3,-49,4,-11,-3,3,0,-3,5,2,-1,5,4,-2,4,2,-2,2,0,0,-12,5,0,-5,5,-6,0,-2,-1,-1,-1,-1,1,-1
KR_6617566430,420,2,6,0,-2,0,2,2,-4,5,1,1,1,2,4,1,5,-3,3,0,0,-5,-4,-1,-5,6,-2,0,0,1,1,0,1,4,-1
KR_6474213309,420,-4,-59,0,-9,-5,5,0,-4,4,0,3,1,4,-2,6,4,-1,2,1,0,0,-4,-6,-3,9,1,0,0,-1,-1,1,-1,2,-1
KR_6768019880,440,1,-75,16,4,-3,4,1,-2,2,0,-2,4,2,2,1,3,9,2,11,0,7,-37,-3,-1,4,3,0,0,1,1,1,-1,6,-1
KR_6732643057,420,0,-1,5,3,5,1,6,3,3,6,2,2,4,-7,9,2,0,1,1,0,4,114,5,-7,2,3,0,0,-1,-1,1,1,3,-1
KR_6757107195,420,-3,-43,-13,4,4,0,4,2,0,2,-1,2,1,-1,5,4,0,2,2,0,2,-1,-2,-4,6,4,0,1,1,-1,1,1,6,-1
KR_6375445532,420,1,36,-17,-4,3,2,5,-4,4,0,-4,4,0,1,7,8,0,0,0,-3,-13,0,0,0,0,1,0,0,-1,-1,0,1,2,-1
KR_6694856051,420,-3,-44,-16,3,0,2,2,2,2,4,0,2,2,0,2,2,1,1,2,0,4,-105,5,-9,4,-3,0,0,-1,-1,0,1,1,-1
KR_6734023065,440,2,45,-15,2,3,0,3,4,0,4,-1,1,0,-7,8,1,3,4,7,0,2,-1,7,-11,4,-1,0,0,-1,1,-1,1,5,-1
KR_6649545943,420,-3,-18,1,-7,0,0,0,0,4,4,-4,5,1,-3,4,1,0,0,0,0,-6,-3,1,-8,7,2,0,-2,-1,-1,-1,-1,4,-1
KR_6752908807,420,-3,-59,-8,1,0,3,3,3,1,4,3,0,3,-4,5,1,-1,3,2,0,-1,-1,1,-5,4,2,0,0,-1,1,-1,-1,2,-1
KR_6712631020,420,-1,-2,39,-6,1,0,1,-7,8,1,-1,4,3,-1,2,1,2,1,3,0,-7,-148,-1,-3,4,-2,0,-1,-1,-1,-1,-1,2,-1
KR_6684600685,420,-6,-19,-4,-13,2,0,2,-4,5,1,-3,4,1,-1,3,2,-7,8,1,0,-10,7,-3,-3,6,-2,0,0,-1,-1,-1,1,3,-1
KR_6608918764,420,-3,-31,-12,-6,-1,2,1,-2,6,4,-4,5,1,2,4,6,-1,1,0,0,-2,-84,0,-5,5,-1,0,-2,1,-1,-1,-1,1,-1
KR_6753751641,420,0,-13,4,5,1,0,1,0,3,3,2,1,3,2,2,4,0,0,0,0,3,0,4,-6,2,-3,0,1,1,1,1,1,5,-1
KR_6680299939,420,-2,-104,-3,-3,-1,1,0,-5,6,1,2,0,2,1,1,2,0,0,0,0,-1,-39,-1,-3,4,13,0,-1,-1,-1,-1,1,3,-1
KR_6759394034,420,-7,-99,-44,-15,-5,6,1,-5,5,0,-7,8,1,2,1,3,0,1,1,-2,-19,-5,-5,-2,7,2,0,-1,-1,-1,-1,-1,5,-1
KR_6758020185,420,3,-57,12,7,1,2,3,7,0,7,2,2,4,-1,2,1,-2,2,0,0,0,13,-3,-3,6,-1,0,-1,-1,-1,-1,1,1,-1
KR_6719238418,420,-3,-29,-24,-7,0,1,1,-1,3,2,0,1,1,-5,7,2,-1,1,0,0,-5,-18,-6,-2,8,5,0,-2,0,-1,-1,1,0,-1
KR_6753964457,420,-2,-54,-20,-6,1,0,1,0,0,0,-8,9,1,1,3,4,0,1,1,0,-4,4,1,-6,5,-1,0,-2,0,-1,-1,-1,0,-1
KR_6660443320,420,0,-36,-6,-1,-3,4,1,-3,4,1,2,2,4,2,2,4,1,1,2,-2,3,-1,-3,-5,8,2,0,-1,0,-1,-1,-1,0,-1
KR_6757260162,420,-2,-63,-11,1,1,1,2,1,5,6,0,2,2,4,1,5,-5,5,0,2,6,9,3,-7,4,-6,0,-1,-1,1,-1,1,5,-1
KR_6684311352,420,1,23,-16,0,6,0,6,-1,3,2,1,2,3,-2,3,1,-4,4,0,0,-2,-42,4,-6,2,-1,0,1,0,-1,1,-1,0,-1
KR_6762106157,420,-1,-22,-33,3,4,1,5,1,5,6,-3,4,1,0,0,0,1,0,1,0,5,2,0,-5,5,-5,0,-1,0,1,-1,1,0,-1
KR_6646603479,420,-3,-31,-22,-9,-4,4,0,0,2,2,-3,5,2,3,3,6,-5,6,1,0,-8,-2,-4,-4,8,2,0,-1,1,0,-1,1,6,-1
KR_6454440981,420,1,13,-34,0,3,1,4,0,3,3,-4,4,0,0,2,2,1,0,1,0,-1,-11,-3,-5,8,4,0,0,-1,1,0,1,1,-1
KR_6731607370,440,-3,-48,-4,-8,-3,4,1,-3,4,1,-1,2,1,1,3,4,-2,2,0,0,-9,-26,-7,-3,10,0,0,-1,-1,-1,-1,-1,4,-1
KR_6727574331,420,-4,-50,-23,-9,-4,5,1,-1,1,0,-1,6,5,-3,3,0,0,0,0,0,-6,-190,-1,-3,4,4,0,-1,-1,-1,-1,-1,6,-1
KR_6602956155,420,-1,-10,30,1,-4,6,2,11,0,11,-3,4,1,-4,5,1,1,1,2,-1,1,-8,-2,-6,8,-1,0,0,-1,-1,-1,-1,6,-1
KR_6749683367,420,-2,-1,-9,-5,1,2,3,2,3,5,-2,6,4,-3,3,0,-3,3,0,0,-3,-1,0,-3,3,0,0,0,0,0,-1,1,0,-1
KR_6751065470,440,1,-45,4,0,-1,3,2,-1,1,0,-4,6,2,0,1,1,6,0,6,0,4,20,-5,-4,9,-5,0,-2,1,-1,-1,1,6,-1
KR_6706927818,420,-2,81,-12,-4,1,1,2,-2,7,5,-2,2,0,-2,7,5,1,0,1,0,-15,29,8,-12,4,-5,0,-1,-1,1,-1,-1,3,-1
KR_6755564423,420,-1,99,-24,-2,0,1,1,-3,5,2,-1,1,0,2,0,2,0,0,0,0,-5,-2,-1,-2,3,4,0,1,1,1,1,1,4,-1
KR_6704782137,420,-1,1,-34,6,-3,3,0,5,4,9,1,3,4,-2,2,0,5,0,5,0,6,-148,-1,-4,5,2,0,0,1,-1,-1,-1,2,-1
KR_6714993681,420,1,4,9,0,-3,4,1,1,3,4,1,1,2,0,2,2,1,0,1,0,4,100,2,-7,5,3,0,-1,0,-1,-1,-1,0,-1
KR_6689800837,440,0,12,16,0,1,1,2,-2,2,0,3,1,4,1,1,2,-3,6,3,0,-2,221,0,-4,4,2,0,0,0,-1,1,-1,0,-1
KR_6753801958,420,-4,-40,-15,1,-2,2,0,1,3,4,0,4,4,2,2,4,0,0,0,0,7,37,2,-6,4,0,0,-1,1,-1,-1,1,2,-1
KR_6720908780,420,-5,-65,-4,-10,-3,4,1,-1,1,0,-8,9,1,0,2,2,2,0,2,0,-6,11,-4,-3,7,-6,0,-1,-1,-1,-1,-1,1,-1
KR_6712787248,420,-1,-72,8,-6,-2,2,0,3,2,5,-5,5,0,-1,2,1,-1,2,1,0,-9,7,-3,-7,10,-5,0,-1,1,-1,-1,1,4,-1
KR_6128999302,420,-7,-29,-38,-13,-2,2,0,2,3,5,-7,7,0,-4,6,2,-2,3,1,0,-12,15,3,-8,5,1,0,-2,-1,-1,-1,1,4,-1
KR_6768960252,420,-6,-73,7,-11,-4,6,2,-3,4,1,-4,6,2,0,3,3,0,1,1,1,2,6,4,-8,4,-2,0,-2,1,-1,-1,1,1,-1
KR_6767510854,420,3,23,10,4,3,2,5,2,2,4,-3,3,0,2,0,2,0,1,1,0,3,9,5,-8,3,-1,0,1,1,1,1,-1,4,-1
KR_6753784001,440,-1,51,-20,2,1,1,2,-1,1,0,1,3,4,2,0,2,-1,1,0,0,-2,-6,-1,-2,3,1,0,0,1,-1,1,-1,1,-1
KR_6630359331,420,-2,11,-24,-9,1,1,2,0,1,1,-6,8,2,-2,4,2,-2,2,0,0,-11,6,4,-6,2,-3,0,0,-1,-1,0,-1,5,-1
KR_6739537908,420,0,-49,-12,3,-2,4,2,0,1,1,3,0,3,0,5,5,2,1,3,0,7,-2,-1,-4,5,0,0,0,-1,1,0,-1,3,-1
KR_6661030231,420,-11,-187,-87,-9,-2,3,1,-2,2,0,-4,4,0,0,0,0,-1,1,0,0,-4,4,-1,-5,6,-3,0,-5,-1,-1,-1,-1,3,-1
KR_6763479994,440,3,47,16,7,0,0,0,7,0,7,-1,3,2,1,1,2,0,4,4,0,4,2,3,-5,2,4,0,0,1,1,0,1,2,-1
KR_6769335463,420,0,12,0,-3,0,3,3,-4,5,1,-1,2,1,0,3,3,2,1,3,0,-9,-135,-3,-4,7,4,0,-1,-1,1,-1,-1,3,-1
KR_6761082674,420,-2,-39,3,0,2,1,3,1,3,4,-3,4,1,1,2,3,-1,1,0,0,1,-10,1,-5,4,1,0,-1,-1,1,1,1,6,-1
KR_6734191030,420,-1,-17,6,0,-3,4,1,3,3,6,-2,2,0,2,1,3,0,3,3,0,5,-7,-1,-4,5,5,0,-1,1,-1,-1,-1,6,-1
KR_6767814166,420,-2,-34,-11,-11,-4,4,0,1,3,4,-2,5,3,-6,6,0,0,3,3,-1,-17,-9,-3,-2,5,5,0,-2,-1,-1,-1,-1,6,-1
KR_6765000455,420,0,-14,-15,-2,7,0,7,2,1,3,-7,8,1,-3,3,0,-1,1,0,-1,-6,2,-2,-3,5,3,0,-1,-1,0,-1,-1,5,-1
KR_6454182878,420,-6,-14,-19,-13,-1,2,1,-5,7,2,-6,8,2,0,2,2,-1,1,0,1,-10,11,6,-9,3,-3,0,-2,-1,1,-1,1,2,-1
KR_6730281957,420,-4,-132,-6,-13,-4,5,1,0,3,3,-2,2,0,-8,10,2,1,0,1,-1,-16,-5,-1,-2,3,-1,0,-2,-1,-1,-1,-1,2,-1
KR_6737948472,440,-7,-93,-24,-12,0,2,2,-6,6,0,-2,5,3,-3,4,1,-1,4,3,0,0,28,-3,0,3,0,0,-2,-1,0,-1,1,4,-1
KR_6741716407,420,-3,-56,-8,-2,-1,2,1,1,1,2,0,0,0,-3,4,1,1,1,2,0,-3,-5,-2,-4,6,5,0,0,1,1,1,1,3,-1
KR_6749978489,440,-7,-64,-18,-7,1,2,3,-3,4,1,-1,2,1,0,4,4,-4,5,1,0,-9,11,1,-4,3,-5,0,0,-1,-1,-1,1,3,-1
KR_6569553239,420,-7,-115,-31,-18,0,3,3,-1,4,3,-7,7,0,-9,11,2,-1,1,0,0,-15,17,-6,-3,9,-2,0,-4,-1,-1,-1,-1,4,-1
KR_6766502197,420,0,-11,-16,-1,0,1,1,-2,6,4,1,2,3,1,1,2,-1,1,0,0,-3,4,-2,-1,3,-1,0,0,-1,-1,0,1,5,-1
KR_6701601191,420,1,3,12,-2,1,1,2,-1,4,3,-5,5,0,0,6,6,3,1,4,-1,-9,-36,-3,-3,6,0,0,0,-1,-1,0,-1,5,-1
KR_6733230230,440,0,-13,-13,-1,-2,5,3,1,1,2,2,0,2,-2,2,0,0,1,1,0,0,249,-1,-3,4,1,0,-1,1,-1,-1,1,1,-1
KR_6684380677,420,1,-15,-28,5,1,3,4,0,2,2,-3,3,0,7,0,7,0,2,2,1,0,-10,0,-4,4,3,0,-1,-1,-1,-1,1,5,-1
KR_6759448643,420,-3,24,-22,-8,1,2,3,-6,7,1,1,1,2,-3,3,0,-1,3,2,0,-11,342,-3,-2,5,-3,0,-1,-1,-1,-1,-1,4,-1
KR_6756055789,420,7,68,24,21,2,1,3,2,1,3,6,1,7,6,7,13,5,0,5,0,15,-4,2,-4,2,0,0,1,0,1,1,-1,0,-1
KR_6741692904,420,0,-16,-22,5,-2,2,0,3,0,3,3,4,7,0,1,1,1,0,1,0,9,-1,1,-4,3,1,0,0,-1,-1,-1,-1,5,-1
KR_6761238745,420,-1,0,-30,0,3,0,3,-1,6,5,1,2,3,-3,4,1,0,0,0,0,1,4,-4,-3,7,0,0,1,-1,1,1,1,2,-1
KR_6756261126,440,0,2,-35,2,-1,1,0,-2,3,1,-3,9,6,3,2,5,5,0,5,0,13,-43,1,-4,3,-4,0,-1,1,-1,-1,-1,4,-1
KR_6742296998,440,-3,-54,8,-8,-2,2,0,3,0,3,-5,5,0,-2,4,2,-2,4,2,0,-5,1,-2,-3,5,0,0,0,-1,-1,-1,-1,4,-1
KR_6726819728,420,-1,-35,14,2,0,2,2,0,2,2,2,0,2,0,3,3,0,1,1,1,5,52,1,-6,5,0,0,-1,1,1,-1,1,2,-1
KR_6742313291,420,2,54,20,4,0,2,2,6,1,7,0,2,2,0,2,2,-2,2,0,0,1,-6,-2,-1,3,3,0,1,-1,1,1,-1,2,-1
KR_6766858380,420,-6,19,-34,-8,-5,5,0,-1,4,3,-2,4,2,1,5,6,-1,2,1,0,-8,5,5,-14,9,-1,0,-1,-1,1,-1,1,5,-1
KR_6751276085,420,-4,-140,4,-9,-2,3,1,-3,4,1,-2,3,1,-2,2,0,0,1,1,0,-3,-8,-1,-2,3,1,0,-2,0,-1,-1,-1,0,-1
KR_6672863929,440,-3,-45,12,-10,-11,11,0,1,0,1,2,3,5,-1,3,2,-1,2,1,0,-8,-3,0,-5,5,0,0,-4,-1,-1,-1,-1,6,-1
KR_6601801553,420,2,5,-12,7,-5,6,1,5,2,7,3,2,5,2,2,4,2,0,2,0,14,-1,0,-5,5,4,0,0,1,-1,-1,1,4,-1
KR_6721040414,420,-5,-62,-4,-7,-3,3,0,2,1,3,-1,3,2,-4,6,2,-1,5,4,1,-8,28,1,-6,5,3,0,0,0,1,-1,1,0,-1
KR_6766955504,420,0,-33,8,1,-3,4,1,1,2,3,0,1,1,0,2,2,3,0,3,0,-2,-7,-1,-5,6,4,0,0,-1,1,0,-1,5,-1
KR_6570184004,420,-2,17,0,-8,-2,3,1,-3,5,2,-1,1,0,-2,3,1,0,2,2,-1,-13,4,2,-6,4,-1,0,0,1,-1,0,-1,2,-1
KR_6762021925,420,-4,-117,-6,-4,0,1,1,-1,4,3,-3,4,1,1,5,6,-1,1,0,0,0,8,-4,-4,8,2,0,0,-1,1,0,-1,1,-1
KR_6753769202,420,1,7,-7,-2,-2,2,0,-1,3,2,-4,6,2,4,0,4,1,0,1,0,1,44,0,-5,5,-26,0,0,1,-1,-1,1,5,-1
KR_6588278783,420,2,-4,-16,0,0,3,3,0,5,5,0,1,1,4,4,8,-4,5,1,0,1,13,8,-11,3,-5,0,-1,1,-1,-1,-1,3,-1
KR_6733205372,420,-1,-51,-14,-1,-5,6,1,0,1,1,2,1,3,1,2,3,1,0,1,0,9,5,0,-4,4,0,0,-1,-1,-1,-1,1,5,-1
KR_6763058044,420,-1,-11,-14,-5,-2,2,0,-5,7,2,0,2,2,1,2,3,1,1,2,1,-9,9,3,-8,5,0,0,-1,-1,-1,-1,1,3,-1
KR_6762754448,420,-1,45,-52,-3,1,1,2,-3,3,0,-4,6,2,1,1,2,2,0,2,0,-3,49,0,-2,2,-41,0,0,-1,0,1,-1,5,-1
KR_6700262718,440,-2,-24,16,1,-2,2,0,1,4,5,-3,4,1,1,0,1,4,1,5,0,4,25,0,-4,4,-14,0,-1,1,-1,-1,-1,2,-1
KR_6589208112,420,0,-33,17,-2,-1,1,0,-7,7,0,0,1,1,1,2,3,5,0,5,0,-4,1,1,-2,1,2,0,-1,-1,-1,-1,-1,2,-1
KR_6736034923,420,-2,2,16,-7,-6,7,1,1,3,4,2,1,3,-5,6,1,1,1,2,0,1,11,-3,-2,5,1,0,-2,1,0,-1,-1,2,-1
KR_6659738978,420,-4,16,-9,-7,0,2,2,1,2,3,-1,5,4,-10,10,0,3,1,4,0,-11,20,-8,0,8,3,0,-1,-1,0,-1,-1,5,-1
KR_6713136843,420,4,55,28,9,2,0,2,1,2,3,0,1,1,5,1,6,1,1,2,0,7,-1,-3,-5,8,0,0,1,-1,1,1,1,2,-1
KR_6636432263,420,0,-13,37,-1,-2,4,2,-1,3,2,3,0,3,-2,5,3,1,1,2,-1,-5,191,0,-7,7,3,0,1,-1,1,1,-1,5,-1
KR_6729858912,420,0,-10,-24,2,-1,3,2,-2,3,1,6,0,6,-1,2,1,0,1,1,1,3,-19,-4,-3,7,-7,0,1,1,-1,1,1,1,-1
KR_6692371853,420,-2,8,-15,-16,1,3,4,-4,5,1,1,4,5,-9,9,0,-5,5,0,0,-19,-11,0,-4,4,5,0,0,-1,-1,-1,1,2,-1
KR_6695605956,420,0,-7,5,-1,-2,2,0,4,1,5,-3,3,0,2,2,4,-2,3,1,0,1,9,-2,-8,10,6,0,0,1,-1,0,-1,5,-1
KR_6756166784,420,-2,-19,0,-7,-4,7,3,-2,2,0,2,2,4,-4,4,0,1,0,1,0,-10,-9,-1,-4,5,6,0,-1,-1,-1,-1,-1,4,-1
KR_6756359654,420,0,15,6,-1,4,1,5,-1,1,0,0,2,2,-2,3,1,-2,3,1,0,-7,95,-3,-2,5,3,0,2,-1,1,1,-1,1,-1
KR_6593815251,420,0,-46,-4,-5,1,1,2,-3,4,1,3,2,5,-5,6,1,-1,1,0,0,-11,-31,0,-4,4,20,0,0,1,-1,0,1,6,-1
KR_6747960074,440,-2,-27,16,-8,1,2,3,-2,2,0,0,0,0,1,0,1,-8,8,0,0,-14,4,-2,-4,6,-3,0,0,-1,0,0,-1,5,-1
KR_6722759564,440,-2,18,-2,-4,0,3,3,2,1,3,-5,5,0,-1,5,4,0,1,1,0,1,28,6,-10,4,2,0,0,0,1,1,-1,0,-1
KR_6765733900,440,-3,-1,20,-11,-2,5,3,-5,6,1,-1,6,5,-1,1,0,-2,2,0,0,-6,-16,-2,-3,5,2,0,-1,0,1,-1,-1,0,-1
KR_6618343301,420,-5,-44,-16,-11,-2,2,0,1,4,5,-1,3,2,-5,6,1,-4,4,0,0,-7,30,2,-7,5,2,0,-1,1,-1,-1,-1,2,-1
KR_6609996308,420,-1,24,-8,-5,-5,5,0,3,2,5,-1,2,1,0,1,1,-2,2,0,0,-5,-4,-3,-4,7,-1,0,0,-1,1,0,-1,2,-1
KR_6729754552,420,-3,-19,-36,-8,-2,2,0,0,2,2,-3,3,0,-2,3,1,-1,2,1,-3,-11,-3,1,-4,3,5,0,0,1,-1,-1,-1,5,-1
KR_6509734065,420,-3,-55,17,-12,-2,2,0,1,2,3,-5,5,0,-6,9,3,0,1,1,0,-5,98,1,-6,5,22,0,0,-1,1,1,-1,3,-1
KR_6741930259,440,-5,-24,-14,-8,1,2,3,-4,5,1,-2,4,2,-2,2,0,-1,2,1,0,-7,-25,-1,-2,3,-1,0,0,-1,-1,0,1,6,-1
KR_6683300716,420,-2,-34,14,-15,1,1,2,-4,9,5,-4,6,2,-7,10,3,-1,4,3,-3,-21,-8,-3,-2,5,5,0,-3,-1,-1,-1,-1,1,-1
KR_6768801122,420,-1,7,10,-5,3,1,4,-6,6,0,-1,3,2,-2,3,1,1,0,1,0,-6,223,-4,-2,6,1,0,1,-1,1,1,-1,5,-1
KR_6682870393,420,0,40,9,-4,0,3,3,-4,7,3,-1,2,1,3,1,4,-2,3,1,0,6,163,4,-8,4,-5,0,1,-1,1,1,1,5,-1
KR_6767509658,420,-8,-153,-24,-5,0,1,1,2,1,3,-5,6,1,-2,2,0,0,0,0,0,-3,4,4,-6,2,-4,0,1,-1,1,1,-1,3,-1
KR_6743682316,420,-4,-73,4,-7,-3,4,1,-1,5,4,-2,3,1,-1,4,3,0,0,0,0,4,1,-4,-3,7,-1,0,-2,-1,-1,-1,-1,5,-1
KR_6733572111,420,-2,-2,6,-7,-4,4,0,-1,3,2,0,2,2,-1,1,0,-1,1,0,-2,-13,321,-4,-2,6,-4,0,0,1,-1,-1,-1,2,-1
KR_6669605072,420,-3,-70,-16,2,-1,3,2,-2,2,0,4,2,6,1,0,1,0,0,0,0,0,12,-1,-4,5,-2,0,-1,1,-1,-1,1,5,-1
KR_6766768965,420,0,-82,28,2,-3,3,0,2,1,3,0,3,3,1,0,1,2,0,2,-2,5,-2,1,-5,4,-3,0,-1,-1,-1,-1,-1,5,-1
KR_6684016580,420,-1,-33,8,-3,0,4,4,-3,4,1,-4,6,2,1,2,3,3,1,4,0,1,3,3,-6,3,-1,0,-1,-1,-1,-1,-1,5,-1
KR_6638621070,420,1,-22,16,2,1,1,2,-5,5,0,4,2,6,2,2,4,0,1,1,0,-6,-9,1,-7,6,-4,0,-2,1,-1,-1,-1,5,-1
KR_5739188047,420,0,6,25,1,-1,4,3,1,2,3,3,1,4,-3,6,3,1,0,1,0,1,7,4,-7,3,-2,0,0,1,-1,1,1,3,-1
KR_6666743211,420,1,-20,-7,-1,0,2,2,1,1,2,1,4,5,-5,6,1,2,0,2,0,5,1,3,-7,4,-1,0,0,-1,-1,0,-1,5,-1
KR_6449017509,420,-2,-13,20,-5,-2,5,3,-2,2,0,-4,5,1,3,0,3,0,3,3,0,-1,-236,0,-4,4,0,0,-1,-1,-1,-1,-1,2,-1
KR_6765185597,440,-2,-6,-14,-6,1,1,2,-6,7,1,0,2,2,0,2,2,-1,2,1,0,-5,-7,-5,-2,7,1,0,-1,-1,1,-1,1,1,-1
KR_6457368088,420,-1,-39,0,-5,0,0,0,-1,3,2,1,2,3,-5,6,1,0,0,0,0,-8,22,0,-5,5,-4,0,-1,1,-1,-1,-1,2,-1
KR_6707539136,420,0,33,-8,7,1,3,4,-2,4,2,-3,7,4,7,0,7,4,0,4,2,18,-329,4,-6,2,11,0,0,1,-1,1,1,1,-1
KR_5734209539,420,-3,13,-28,-2,3,0,3,-3,5,2,2,3,5,-3,4,1,-1,3,2,-1,-4,-13,1,-5,4,3,0,0,-1,-1,1,-1,4,-1
KR_6530407801,420,-1,-51,-32,-1,-4,5,1,1,1,2,-4,5,1,3,2,5,3,0,3,0,6,3,-2,-5,7,2,0,-1,-1,-1,-1,-1,3,-1
KR_6724789371,420,-4,5,12,-9,-2,3,1,-3,5,2,0,3,3,-1,5,4,-3,5,2,0,-10,9,3,-9,6,-5,0,0,1,-1,0,-1,3,-1
KR_6767928202,420,-3,-48,-4,1,-3,3,0,1,3,4,4,0,4,0,2,2,-1,3,2,0,3,1,-6,-1,7,1,0,-1,1,-1,-1,1,3,-1
KR_6686656539,420,1,0,-13,2,1,4,5,0,1,1,8,2,10,-4,7,3,-3,3,0,0,7,-3,0,-3,3,1,0,0,-1,0,-1,-1,2,-1
KR_6726291803,420,-2,-35,-8,-6,-4,4,0,-5,6,1,0,1,1,-1,1,0,4,2,6,0,-5,-6,-2,-2,4,2,0,0,-1,-1,-1,1,1,-1
KR_6725029274,420,-5,-62,9,-14,-1,2,1,-11,12,1,1,3,4,-1,1,0,-2,3,1,0,-15,-7,-1,-4,5,-2,0,0,-1,-1,0,-1,2,-1
KR_6769270761,420,-2,-48,1,0,1,3,4,0,0,0,0,1,1,0,1,1,-1,1,0,0,-4,0,0,-3,3,1,0,1,-1,-1,1,1,3,-1
KR_6753178447,420,1,-10,19,-3,-2,3,1,-1,2,1,0,3,3,0,2,2,0,0,0,0,-4,232,3,-6,3,4,0,0,-1,1,0,1,4,-1
KR_6529981194,420,0,-1,4,-7,-3,3,0,0,2,2,-3,5,2,-1,1,0,0,2,2,0,-1,36,0,-4,4,-13,0,-1,-1,-1,-1,1,3,-1
KR_6766938103,420,-2,28,-12,0,-4,4,0,-4,5,1,2,1,3,2,2,4,4,0,4,0,1,0,6,-7,1,-3,0,1,1,-1,1,1,2,-1
KR_6724181179,440,-3,-71,-8,-3,-3,4,1,1,1,2,-2,3,1,1,2,3,0,1,1,0,0,33,2,-4,2,0,0,-1,0,-1,-1,1,0,-1
KR_6762636574,420,1,-12,-8,-2,4,0,4,2,0,2,-1,5,4,-5,5,0,-2,2,0,0,-4,-95,-6,0,6,-2,0,0,-1,-1,1,-1,1,-1
KR_6683144154,420,1,40,-12,-4,-1,1,0,0,4,4,-2,5,3,-4,5,1,3,1,4,0,-8,-3,-2,-6,8,-2,0,0,-1,1,-1,1,3,-1
KR_6606814200,420,-2,-95,-16,-3,-6,6,0,1,1,2,-1,3,2,3,1,4,0,0,0,0,6,7,1,-5,4,6,0,-1,-1,-1,-1,1,4,-1
KR_6656398323,420,4,5,-7,7,5,0,5,1,3,4,-2,4,2,1,2,3,2,0,2,0,2,15,4,-7,3,4,0,0,0,1,-1,1,0,-1
KR_6758462722,420,-3,-51,12,-9,-5,5,0,-2,2,0,-3,4,1,1,1,2,0,1,1,0,-7,30,0,-5,5,-4,0,0,0,1,-1,-1,0,-1
KR_6767932677,420,-4,0,-41,-14,-1,1,0,-6,7,1,-7,7,0,4,3,7,-4,4,0,0,-9,-141,-4,-3,7,-1,0,0,1,1,1,1,6,-1
KR_6760651603,420,4,74,12,7,0,1,1,0,4,4,-4,6,2,7,2,9,4,1,5,-1,11,-45,-3,-3,6,0,0,3,0,1,1,-1,0,-1
KR_6698157781,420,0,-22,-7,-6,1,1,2,-4,4,0,-1,2,1,-2,4,2,0,1,1,0,-11,5,2,-6,4,-3,0,0,0,-1,0,-1,0,-1
KR_6761905197,440,-2,-26,-27,-7,0,4,4,-4,5,1,-3,4,1,-1,2,1,1,1,2,0,-1,-5,1,-5,4,-2,0,0,1,1,0,-1,1,-1
KR_6728904257,440,0,-62,-3,-2,1,1,2,4,0,4,-4,5,1,-7,7,0,4,3,7,-1,-1,-3,1,-6,5,-4,0,0,-1,1,1,-1,5,-1
KR_6741980199,440,2,22,24,0,-2,3,1,6,0,6,-2,2,0,-2,4,2,0,3,3,-1,-1,0,-3,-6,9,3,0,0,1,-1,0,-1,1,-1
KR_6732568632,420,-5,-123,3,-13,-2,4,2,-2,3,1,-3,4,1,-3,3,0,-3,4,1,0,-15,-15,0,-3,3,-1,0,-3,-1,1,-1,-1,2,-1
KR_6690784194,420,-2,-14,-36,-3,-2,2,0,-4,9,5,2,0,2,2,0,2,-1,1,0,0,-8,-21,-2,-3,5,3,0,-1,1,1,1,-1,3,-1
KR_6742461533,420,2,47,8,0,1,2,3,0,5,5,-4,6,2,0,2,2,3,0,3,1,5,-1,0,-4,4,-2,0,-1,-1,1,-1,1,5,-1
KR_6700355342,420,4,40,-8,8,-1,2,1,3,0,3,6,0,6,1,3,4,-1,1,0,0,1,-1,-2,-2,4,5,0,0,1,1,1,1,3,-1
KR_6633319636,420,-2,-23,5,-12,-2,5,3,1,1,2,0,1,1,-11,11,0,0,1,1,0,-13,-18,-1,-5,6,1,0,0,-1,1,-1,-1,2,-1
KR_6750699605,420,0,-16,8,-3,1,2,3,-3,5,2,-6,6,0,3,1,4,2,1,3,0,3,-10,1,-7,6,-2,0,-1,-1,-1,-1,-1,4,-1
KR_6694248588,420,-1,-19,-3,-4,0,0,0,-1,2,1,0,3,3,-4,4,0,1,0,1,0,-5,-2,-2,-5,7,1,0,0,0,0,0,-1,0,-1
KR_6767466713,420,0,-52,6,5,0,2,2,2,1,3,0,2,2,2,1,3,1,1,2,0,7,-72,1,-4,3,20,0,-1,1,1,1,-1,2,-1
KR_6757573669,420,1,12,20,-2,-3,3,0,0,1,1,-3,3,0,3,0,3,1,1,2,0,-2,10,-2,-4,6,-1,0,0,1,1,0,-1,6,-1
KR_6707993528,420,3,40,16,2,0,1,1,-1,2,1,3,1,4,1,2,3,-1,2,1,0,3,-62,-3,-2,5,-1,0,1,1,1,1,1,4,-1
KR_6698906777,420,-3,-82,-1,-7,2,0,2,-3,6,3,-3,6,3,-2,2,0,-1,2,1,0,-17,4,-3,-2,5,0,0,-1,1,-1,-1,-1,6,-1
KR_6742676073,420,-2,-53,-10,-3,0,1,1,0,2,2,0,2,2,-3,4,1,0,0,0,0,1,214,5,-8,3,1,0,1,0,1,-1,1,0,-1
KR_6428691300,420,-3,-35,-40,-4,-2,3,1,3,2,5,-1,2,1,-4,5,1,0,1,1,0,-12,-22,0,-5,5,-1,0,-1,-1,1,-1,-1,3,-1
KR_6769505053,420,-2,20,20,-6,3,1,4,0,3,3,-5,5,0,-1,4,3,-3,3,0,0,-4,0,-4,-4,8,-1,0,1,-1,-1,1,-1,1,-1
KR_6614390473,420,-2,29,0,-5,-1,2,1,3,1,4,-2,6,4,1,2,3,-6,6,0,0,-13,-2,-1,-1,2,1,0,-1,-1,-1,-1,1,2,-1
KR_6730623446,420,-1,37,23,-1,-1,3,2,3,0,3,-1,3,2,-1,2,1,-1,1,0,0,4,-19,-4,-3,7,-2,0,0,1,1,0,-1,1,-1
KR_6566596244,440,-3,-70,-4,-9,-5,5,0,1,2,3,0,4,4,-6,9,3,1,1,2,0,-7,21,0,-3,3,-1,0,-3,-1,-1,-1,1,4,-1
KR_6722947419,440,-7,-56,3,-15,-4,5,1,-3,4,1,-4,6,2,-4,4,0,0,1,1,0,-20,-30,-1,-2,3,-1,0,-1,-1,-1,-1,-1,3,-1
KR_6766598524,440,-4,33,-72,-4,-8,8,0,-1,2,1,0,2,2,1,3,4,4,0,4,0,-3,4,-2,-3,5,2,0,0,-1,-1,-1,-1,1,-1
KR_6638330668,420,-1,-54,-12,0,1,1,2,2,1,3,3,2,5,-4,5,1,-2,2,0,0,-2,8,1,-5,4,-3,0,0,-1,1,1,1,1,-1
KR_6718604723,420,-1,16,7,-3,-4,4,0,0,1,1,0,4,4,0,4,4,1,0,1,0,-1,-11,0,-5,5,5,0,0,0,-1,0,-1,0,-1
KR_6606731540,420,0,6,-28,4,-4,4,0,5,0,5,-1,1,0,3,2,5,1,0,1,0,10,8,3,-7,4,0,0,0,-1,1,0,-1,1,-1
KR_6743669896,420,-3,-18,-16,-8,0,1,1,-1,3,2,-3,7,4,-6,7,1,2,0,2,1,-7,-4,5,-7,2,-2,0,-1,-1,-1,-1,-1,6,-1
KR_6658624086,420,-6,-43,-8,-4,-1,2,1,1,2,3,-4,6,2,0,2,2,0,0,0,0,1,-1,-2,-6,8,-4,0,-1,1,0,-1,-1,3,-1
KR_6766493233,420,1,-35,4,-1,2,1,3,2,1,3,-5,5,0,2,1,3,-2,3,1,0,-2,0,0,-4,4,-1,0,0,-1,0,0,-1,5,-1
KR_6752173258,420,-1,-34,4,-9,2,2,4,0,3,3,-5,5,0,-4,4,0,-2,2,0,0,-16,-3,-4,-4,8,-4,0,-2,-1,-1,-1,-1,3,-1
KR_6715779491,420,-6,-84,-4,-12,-2,2,0,-3,4,1,-2,3,1,-2,3,1,-3,3,0,0,-15,35,4,-7,3,-6,0,-2,-1,-1,-1,-1,1,-1
KR_6681392700,440,-6,-106,24,-12,-5,7,2,1,2,3,-2,2,0,-3,6,3,-3,4,1,0,-13,-16,-2,-2,4,4,0,-1,1,-1,-1,1,3,-1
KR_6766970239,420,0,-35,5,-7,1,3,4,-2,4,2,-1,4,3,-4,4,0,-1,1,0,0,-7,-235,-6,-2,8,2,0,-1,-1,-1,-1,1,2,-1
KR_6769186581,420,-5,-76,-10,-3,-3,6,3,2,3,5,-4,6,2,2,8,10,0,0,0,-1,-6,-8,-4,-4,8,-2,0,-1,-1,-1,-1,-1,5,-1
KR_6767047763,420,1,48,5,2,5,0,5,2,0,2,1,3,4,-6,7,1,0,0,0,0,3,-11,2,-4,2,2,0,0,1,1,1,-1,2,-1
KR_6759970635,420,1,-52,-14,0,-4,4,0,1,1,2,2,3,5,4,1,5,-3,4,1,0,11,70,5,-7,2,-21,0,-2,1,-1,-1,-1,1,-1
KR_6762417156,420,-4,5,-40,-3,1,2,3,1,0,1,2,2,4,-3,6,3,-4,4,0,0,-3,-9,6,-10,4,-1,0,-3,-1,-1,-1,1,2,-1
KR_6685222911,420,-1,-44,0,1,-2,6,4,1,1,2,3,2,5,1,3,4,-2,6,4,2,6,-3,-1,-2,3,1,0,-2,0,-1,-1,1,0,-1
KR_6720954884,420,-4,-134,-4,-8,-1,2,1,-2,4,2,-3,3,0,-2,8,6,0,1,1,-1,-11,-16,0,-7,7,-2,0,-2,1,-1,-1,1,5,-1
KR_6758266470,420,-2,-34,8,-8,-3,4,1,2,6,8,-3,4,1,-3,4,1,-1,2,1,-1,-4,-20,-3,-4,7,-4,0,-1,1,-1,-1,-1,6,-1
KR_6766645730,420,3,17,-2,8,5,0,5,2,4,6,2,3,5,-1,6,5,0,1,1,1,3,6,2,-8,6,1,0,2,1,1,1,1,2,-1
KR_6552972225,420,-6,-22,-5,-5,2,0,2,-4,5,1,-2,4,2,0,2,2,-1,2,1,0,-9,-96,-3,-3,6,-1,0,-1,-1,-1,-1,1,1,-1
KR_6575200050,420,1,5,21,-3,1,0,1,0,1,1,-1,2,1,-1,4,3,-2,3,1,0,-8,13,2,-7,5,-6,0,-1,-1,1,-1,-1,6,-1
KR_6734495799,420,1,42,4,2,1,1,2,2,1,3,2,1,3,-3,5,2,0,0,0,0,-7,-5,0,-4,4,1,0,1,-1,1,1,1,3,-1
KR_6623185534,420,1,38,16,-5,1,0,1,0,2,2,2,2,4,-6,11,5,-2,3,1,1,-11,-41,-3,-6,9,-2,0,1,-1,1,-1,1,2,-1
KR_6769130029,420,1,66,-5,2,-2,5,3,0,3,3,3,3,6,1,1,2,0,0,0,0,-3,0,3,-7,4,-4,0,2,-1,1,1,-1,3,-1
KR_6756562173,440,-2,-58,-12,-9,-4,4,0,0,1,1,-1,1,0,-2,2,0,-2,3,1,0,-6,0,-2,-3,5,1,0,0,-1,-1,0,-1,5,-1
KR_6087692516,420,5,16,34,5,-3,3,0,3,4,7,1,1,2,4,0,4,0,1,1,0,5,26,2,-5,3,-2,0,0,1,-1,1,1,3,-1
KR_6529901900,420,-3,-54,-8,0,-2,3,1,0,2,2,2,2,4,0,2,2,0,1,1,0,-2,4,-4,-3,7,-2,0,-1,0,-1,-1,-1,0,-1
KR_6759096462,420,-4,-24,5,-5,-2,2,0,1,2,3,-1,2,1,0,2,2,-3,3,0,0,-3,2,2,-10,8,-8,0,-1,-1,1,-1,-1,6,-1
KR_6721446207,420,-1,-34,-6,-6,-1,4,3,-1,4,3,3,1,4,-8,9,1,1,0,1,2,0,-32,-9,-1,10,7,0,-2,-1,-1,-1,1,2,-1
KR_6761226875,440,-2,-4,4,-3,0,1,1,0,4,4,1,0,1,-3,5,2,-1,1,0,0,1,-2,3,-4,1,2,0,-1,1,-1,-1,-1,6,-1
KR_6689329631,420,-5,-38,-25,-9,0,1,1,-4,4,0,-4,4,0,0,4,4,-1,3,2,0,-7,-3,0,-10,10,-8,0,-2,-1,1,-1,-1,3,-1
KR_6684485162,420,-3,4,-39,1,-5,7,2,0,4,4,3,0,3,1,3,4,2,0,2,1,6,14,-3,-4,7,0,0,-1,0,-1,-1,1,0,-1
KR_6593636726,420,-5,19,-28,-6,-2,4,2,3,2,5,0,2,2,-5,6,1,-2,3,1,0,-2,-28,4,-9,5,-2,0,-1,-1,1,-1,-1,5,-1
KR_6762946310,420,-2,-13,-9,-3,-3,3,0,0,4,4,-1,3,2,0,0,0,1,0,1,0,-3,-7,-4,-3,7,2,0,0,-1,0,0,1,3,-1
KR_6718013236,420,2,41,21,3,-2,4,2,0,1,1,2,1,3,4,0,4,-1,1,0,0,2,1,1,-3,2,3,0,-1,1,-1,-1,-1,3,-1
KR_6760371869,420,2,-17,-4,2,0,1,1,0,2,2,-1,4,3,2,2,4,1,5,6,-1,-2,4,-4,-3,7,2,0,-1,0,-1,-1,-1,0,-1
KR_6729824496,420,-3,23,-4,-6,-1,3,2,1,1,2,-3,5,2,0,3,3,-3,3,0,0,-6,2,-2,-3,5,6,0,-1,-1,-1,-1,-1,4,-1
KR_6761932584,420,-3,-5,-23,-11,0,2,2,-4,5,1,0,2,2,-3,4,1,-4,4,0,0,-12,11,-1,-4,5,-2,0,0,-1,-1,-1,-1,2,-1
KR_6760011095,420,-4,-31,-4,-13,-3,4,1,-5,7,2,-4,7,3,-1,2,1,0,0,0,0,-11,4,1,-3,2,-3,0,-1,1,1,-1,-1,2,-1
KR_6753116176,420,1,57,-35,-5,0,1,1,1,1,2,-3,6,3,-1,4,3,-2,3,1,0,-5,-7,3,-6,3,-3,0,-1,-1,-1,-1,-1,3,-1
KR_6749230557,440,-3,-53,0,-7,-3,4,1,-2,4,2,0,2,2,-2,3,1,0,0,0,0,-11,2,2,-6,4,2,0,1,1,1,1,-1,3,-1
KR_6747941145,420,-4,-98,-15,-6,-2,3,1,2,4,6,-3,4,1,0,3,3,-3,4,1,0,8,-28,-3,-5,8,17,0,-1,-1,-1,-1,-1,4,-1
KR_6769026752,420,-2,-97,-25,-5,-2,2,0,-1,3,2,-6,7,1,0,3,3,4,0,4,-1,2,-30,2,-5,3,6,0,-1,-1,1,-1,-1,4,-1
KR_6647036145,420,-4,9,-15,-7,-5,5,0,5,0,5,1,2,3,-5,5,0,-3,3,0,0,-5,-171,2,-6,4,-2,0,-1,0,-1,-1,1,0,-1
KR_6508528699,420,-1,6,14,-1,1,1,2,-3,6,3,2,1,3,-1,4,3,0,1,1,0,-13,-11,2,-7,5,-2,0,0,-1,1,1,1,5,-1
KR_6760293504,420,-3,-60,-3,-11,-3,3,0,0,1,1,-7,9,2,-5,5,0,4,1,5,0,-9,-3,-1,-5,6,-4,0,0,1,0,0,1,3,-1
KR_6741574663,420,0,42,11,-2,2,2,4,-1,5,4,-1,6,5,-1,3,2,-1,1,0,-3,-11,38,1,-7,6,5,0,0,1,-1,1,-1,1,-1
KR_6708544395,420,0,-32,3,-2,0,2,2,0,1,1,-1,1,0,1,0,1,-2,3,1,-1,-4,-2,2,-7,5,-6,0,0,-1,0,0,-1,1,-1
KR_6675110356,420,-1,-14,8,-3,-1,2,1,-5,6,1,1,2,3,0,1,1,2,0,2,-1,-9,15,1,-4,3,-2,0,0,1,1,1,-1,3,-1
KR_6760604785,420,2,-7,20,5,3,0,3,7,1,8,0,3,3,-3,5,2,-2,4,2,0,13,274,4,-8,4,-6,0,0,-1,1,-1,1,4,-1
KR_6768591269,420,2,42,-21,-5,1,1,2,-5,6,1,-2,3,1,1,2,3,0,1,1,-1,-14,-4,-1,-4,5,3,0,0,0,-1,1,-1,0,-1
KR_6724527806,420,-2,0,3,-1,-1,1,0,1,1,2,0,3,3,1,2,3,-2,2,0,0,1,-1,3,-6,3,-1,0,0,-1,1,0,-1,3,-1
KR_6761759910,420,-1,-10,12,-8,-2,2,0,-3,4,1,-1,1,0,-3,7,4,1,0,1,-1,-7,14,1,-3,2,-3,0,0,1,-1,0,-1,5,-1
KR_6762206858,420,-2,-34,-20,-5,2,1,3,-2,3,1,3,2,5,-7,7,0,-1,2,1,0,-9,1,-1,-2,3,0,0,1,-1,0,1,1,4,-1
KR_6754388059,420,0,1,-20,3,2,1,3,1,0,1,1,2,3,-2,5,3,1,4,5,0,2,-206,2,-5,3,-1,0,-1,-1,1,-1,1,5,-1
KR_6674821340,420,-2,0,8,-16,1,0,1,-3,3,0,-6,6,0,-6,7,1,-2,2,0,0,-20,-3,-7,-2,9,0,0,-1,1,-1,-1,-1,1,-1
KR_6749194464,420,-5,4,-12,-7,-12,13,1,5,2,7,-1,3,2,1,0,1,0,0,0,0,0,-6,-5,-2,7,4,0,-1,0,1,-1,-1,0,-1
KR_6760400764,420,1,-34,-28,-2,1,1,2,0,2,2,4,3,7,-3,7,4,-4,7,3,-1,7,3,0,-3,3,-3,0,-1,1,-1,-1,-1,2,-1
KR_6769003934,420,-1,-31,0,0,5,2,7,-1,5,4,-3,5,2,-2,7,5,1,0,1,-1,0,-7,7,-10,3,-4,0,-1,-1,1,-1,-1,5,-1
KR_6636077236,420,0,62,4,5,5,2,7,0,1,1,-4,7,3,3,1,4,1,0,1,0,3,-4,-1,-5,6,-1,0,-1,-1,1,-1,1,3,-1
KR_6643218965,420,-1,-92,-20,-5,5,1,6,-2,4,2,-3,6,3,-5,7,2,0,2,2,-2,-9,-34,1,-6,5,-4,0,-2,-1,-1,-1,-1,2,-1
KR_6741752540,420,-4,-97,-1,-7,-1,2,1,1,2,3,0,3,3,-8,9,1,1,1,2,0,-3,26,1,-3,2,0,0,-4,-1,-1,-1,1,3,-1
KR_6769407026,420,-2,5,19,-5,0,3,3,-9,12,3,2,1,3,1,1,2,1,1,2,0,-12,-2,1,-4,3,-4,0,2,-1,1,1,-1,6,-1
KR_6741960849,420,-2,18,4,2,1,1,2,0,3,3,0,4,4,3,1,4,-2,2,0,0,3,-1,-3,-5,8,2,0,0,0,-1,-1,1,0,-1
KR_6604748278,420,3,-8,16,6,1,0,1,-1,5,4,3,1,4,3,2,5,0,0,0,0,-3,6,0,-6,6,-3,0,1,1,1,1,1,5,-1
KR_6737245652,420,0,-58,-23,-5,2,0,2,-3,4,1,-5,9,4,1,2,3,0,2,2,0,-8,-2,-3,-4,7,-1,-1,-3,1,-1,-1,-1,6,-1
KR_6692721230,440,-4,-11,-24,-4,0,2,2,0,2,2,-2,3,1,-4,7,3,2,4,6,-1,-2,257,3,-5,2,-2,0,1,0,1,1,-1,0,-1
KR_6742485206,420,1,-31,0,1,-3,3,0,-2,4,2,0,2,2,5,3,8,1,1,2,-1,4,-47,5,-6,1,0,0,-1,1,0,-1,-1,2,-1
KR_6703230323,440,-7,-57,-28,-13,-1,3,2,-5,6,1,-4,4,0,-4,4,0,1,0,1,0,-9,-3,-2,-6,8,-1,0,-1,-1,-1,-1,-1,5,-1
KR_6721732075,420,-2,-22,3,-5,-2,2,0,3,1,4,-1,2,1,-4,5,1,-1,1,0,0,-8,-21,-1,-6,7,-2,0,-1,1,-1,-1,-1,4,-1
KR_6763596393,420,2,73,29,6,-3,3,0,5,0,5,2,0,2,4,0,4,-2,2,0,0,7,-1,-2,-4,6,-1,0,0,-1,1,0,1,5,-1
KR_6768437765,420,-2,-11,-40,-3,-4,5,1,1,2,3,0,3,3,2,1,3,-2,2,0,1,-5,-77,-2,-8,10,0,0,0,-1,-1,0,1,5,-1
KR_6767245005,420,-3,-90,-21,-10,-2,3,1,-1,3,2,-6,6,0,2,4,6,-3,3,0,0,0,7,-3,-2,5,-4,0,-2,-1,1,1,1,3,-1
KR_6760227923,420,1,1,-16,-1,-3,3,0,-1,1,0,1,1,2,3,0,3,-1,1,0,0,0,-11,-3,-2,5,2,0,0,1,-1,-1,1,6,-1
KR_6763952422,420,-6,-118,17,-9,1,2,3,-4,4,0,-4,5,1,-3,5,2,1,2,3,0,-4,87,2,-4,2,-4,0,0,1,1,-1,1,1,-1
KR_6743294653,420,1,-11,16,3,-3,4,1,2,3,5,1,2,3,2,3,5,1,1,2,0,3,-21,2,-4,2,-1,0,-2,-1,-1,-1,1,5,-1
KR_6714283441,440,-2,-12,8,-4,1,1,2,-4,4,0,1,1,2,0,2,2,-2,2,0,0,-3,-11,-8,-4,12,-2,0,0,-1,1,0,-1,5,-1
KR_6729843949,420,-1,-21,-16,6,1,1,2,2,3,5,-2,3,1,0,0,0,5,1,6,0,11,-16,0,-6,6,-1,0,1,1,1,1,-1,2,-1
KR_6717405081,420,-3,11,-12,3,0,2,2,2,2,4,-3,3,0,1,1,2,3,0,3,0,-3,-9,-2,-3,5,-3,0,0,-1,1,0,-1,6,-1
KR_6766622679,420,0,-1,-30,-5,2,1,3,0,2,2,-2,6,4,-5,9,4,0,1,1,0,-7,41,0,-5,5,-16,0,0,1,-1,-1,-1,2,-1
KR_6724336908,440,1,16,5,-2,-2,2,0,0,2,2,2,0,2,2,0,2,-4,4,0,0,-4,-16,1,-4,3,2,0,0,-1,1,0,1,2,-1
KR_6691176907,420,-2,-40,-14,-2,-3,4,1,0,2,2,-2,5,3,1,2,3,2,0,2,0,5,20,2,-6,4,-10,0,-2,1,1,-1,1,6,-1
KR_6531893690,420,-1,-39,44,-3,0,2,2,-3,7,4,1,1,2,1,1,2,-2,2,0,0,-2,6,-3,-4,7,3,0,-1,-1,0,-1,-1,2,-1
KR_6692379122,420,-3,-2,-29,-4,1,1,2,-5,6,1,-5,6,1,3,3,6,2,0,2,-1,-3,9,-9,-3,12,-3,0,-2,-1,-1,-1,1,2,-1
KR_6768986689,420,-1,41,-20,-1,5,1,6,1,2,3,-1,5,4,-4,4,0,-2,2,0,0,-8,-22,0,-4,4,0,0,1,-1,1,1,-1,5,-1
KR_6755617878,420,-1,-64,23,-5,3,2,5,-2,5,3,-4,4,0,-2,3,1,0,0,0,0,-9,35,0,-4,4,0,0,0,-1,-1,1,1,6,-1
KR_6698776336,420,-5,-39,4,-19,-1,3,2,-4,5,1,-10,10,0,-2,4,2,-2,4,2,0,-16,-150,-3,-3,6,1,0,-1,-1,-1,-1,-1,2,-1
KR_6705632587,420,-2,14,13,-2,-3,3,0,3,2,5,0,3,3,-2,5,3,0,0,0,-1,3,-48,-4,-4,8,41,0,0,-1,-1,-1,-1,4,-1
KR_6666627153,440,-1,54,-4,-7,-1,2,1,-5,7,2,-2,4,2,2,1,3,-1,2,1,-1,-12,6,-4,-1,5,-1,0,0,0,-1,0,-1,0,-1
KR_6754925334,420,0,95,-3,-1,5,0,5,-4,4,0,4,1,5,-5,6,1,-1,1,0,0,-10,-160,-3,-4,7,0,0,2,-1,1,1,1,6,-1
KR_6729095153,420,-3,-29,5,-13,-4,5,1,-5,8,3,0,1,1,-5,7,2,1,0,1,-3,-17,6,-4,0,4,1,0,-2,-1,-1,-1,-1,3,-1
KR_6685183231,420,-2,-21,7,1,-4,4,0,2,3,5,-4,6,2,7,2,9,0,1,1,0,4,4,-4,-4,8,1,0,-1,1,-1,-1,1,2,-1
KR_6765248261,420,-5,-70,-7,-13,0,2,2,-3,3,0,-6,6,0,-4,6,2,0,3,3,0,-8,107,0,-6,6,-1,0,-1,-1,1,-1,-1,3,-1
KR_6769448324,420,1,12,-12,-1,-2,4,2,-3,4,1,1,1,2,2,1,3,1,1,2,0,1,19,-3,-6,9,-5,0,0,1,1,1,1,1,-1
KR_6387238290,420,2,-35,0,0,0,2,2,0,3,3,1,3,4,0,2,2,-1,2,1,0,-5,-3,-1,-4,5,5,0,-1,1,1,-1,-1,3,-1
KR_6764615342,420,3,-15,19,5,4,3,7,-2,4,2,-2,5,3,4,6,10,1,1,2,-2,1,-3,1,-4,3,4,0,0,-1,-1,-1,1,4,-1
KR_6753563088,420,-2,-77,4,-6,-6,7,1,2,0,2,-3,3,0,0,5,5,1,2,3,-1,-8,-8,-5,-5,10,6,0,-2,1,-1,-1,-1,4,-1
KR_6739750707,420,-1,5,4,-3,-4,4,0,-1,3,2,1,2,3,1,2,3,0,1,1,0,-5,0,-2,-1,3,2,0,0,1,-1,1,1,4,-1
KR_6758722929,420,-1,-3,4,-1,0,3,3,-2,3,1,-4,4,0,5,2,7,0,1,1,0,1,16,2,-4,2,-2,0,-1,1,-1,-1,-1,4,-1
KR_6577432556,420,-1,-57,31,-3,-4,5,1,6,0,6,-3,5,2,0,1,1,-2,2,0,0,0,21,2,-6,4,-1,0,-1,-1,-1,-1,-1,2,-1
KR_6733767161,420,-4,21,-16,-7,-2,4,2,-2,3,1,-4,5,1,0,2,2,1,0,1,0,-3,-36,2,-7,5,-2,0,-2,-1,-1,-1,1,6,-1
KR_6743848414,420,1,-52,-28,-2,0,1,1,-3,3,0,4,0,4,1,3,4,-4,6,2,0,-1,2,2,-7,5,-4,0,0,-1,1,1,1,3,-1
KR_6759552909,420,0,49,-16,-5,2,1,3,-4,5,1,0,3,3,0,0,0,-3,3,0,0,-7,-2,3,-6,3,1,0,0,1,-1,-1,-1,5,-1
KR_6760315599,420,-2,-69,16,-8,1,0,1,-4,5,1,-9,9,0,4,0,4,0,0,0,1,-7,-44,-2,-3,5,2,0,-1,-1,-1,-1,1,5,-1
KR_6727771126,440,3,-7,11,3,3,0,3,0,1,1,2,1,3,-1,1,0,-1,1,0,0,-1,5,8,-9,1,-3,0,1,-1,1,-1,1,6,-1
KR_6679758347,420,2,-49,-4,10,4,0,4,-3,5,2,2,1,3,7,0,7,0,1,1,0,17,29,0,-6,6,-5,0,0,-1,-1,-1,-1,5,-1
KR_6753340938,440,-2,13,30,-7,-2,3,1,-2,3,1,3,2,5,-5,8,3,-1,1,0,0,-9,41,-2,-2,4,-31,0,-1,0,-1,-1,1,0,-1
KR_6768112948,420,3,-10,-31,3,0,2,2,-1,4,3,2,4,6,-2,4,2,4,3,7,-1,9,-2,0,-7,7,11,0,-1,1,-1,-1,-1,1,-1
KR_6764505759,420,5,-28,12,7,0,1,1,3,2,5,3,0,3,2,2,4,-1,3,2,0,4,37,-1,-7,8,-27,0,0,-1,1,0,1,1,-1
KR_6725938758,420,-3,-26,12,-4,-1,1,0,-10,10,0,6,0,6,1,1,2,0,0,0,0,-6,14,-1,-4,5,-3,0,1,-1,1,1,-1,4,-1
KR_6619679766,420,2,40,-40,7,0,1,1,-3,7,4,3,0,3,0,4,4,7,1,8,1,13,-11,4,-8,4,1,0,0,-1,1,1,-1,1,-1
KR_6762135433,420,-1,-27,45,-6,0,2,2,1,3,4,-3,4,1,-3,3,0,-1,1,0,0,-11,-4,1,-4,3,-6,0,0,0,0,0,-1,0,-1
KR_6734578211,420,4,39,6,9,1,2,3,-2,4,2,6,1,7,0,2,2,4,0,4,0,6,-9,-2,-7,9,-2,0,1,-1,1,1,1,1,-1
KR_6624658549,420,-3,-9,-10,-8,-2,2,0,1,2,3,2,0,2,-7,8,1,-2,2,0,0,-18,-4,0,-7,7,-5,0,1,-1,1,1,-1,5,-1
KR_6701452962,440,0,5,-4,5,-1,2,1,4,3,7,2,0,2,2,0,2,-2,2,0,0,-4,-14,1,-3,2,2,0,0,1,0,0,1,6,-1
KR_6753138806,420,-3,-41,-4,-13,3,3,6,-4,4,0,1,5,6,-13,13,0,0,0,0,-2,-28,-1,-7,-1,8,1,0,0,-1,1,0,-1,3,-1
KR_6745941390,420,-1,-36,0,-2,-3,4,1,-1,2,1,2,0,2,2,4,6,-2,3,1,0,0,0,0,-2,2,-1,0,0,1,1,1,1,1,-1
KR_6566269573,420,0,-27,-35,5,-1,3,2,-1,3,2,4,2,6,3,3,6,0,0,0,0,4,-174,-5,-6,11,-6,0,-1,1,-1,-1,-1,4,-1
KR_6744314996,420,2,23,6,-4,1,0,1,1,2,3,0,2,2,-3,4,1,-3,3,0,0,-2,-18,4,-8,4,-1,0,-1,-1,-1,-1,-1,5,-1
KR_6767972818,420,-2,-28,4,-1,3,1,4,-2,4,2,-3,5,2,1,2,3,0,0,0,0,-5,1,1,-6,5,-5,0,0,-1,0,0,1,5,-1
KR_6764947293,420,3,41,22,-2,-1,1,0,-1,1,0,0,4,4,2,1,3,-2,2,0,0,0,42,1,-6,5,-24,0,0,1,-1,-1,-1,6,-1
KR_6635617593,420,-3,-11,-3,-10,-3,3,0,4,0,4,-7,9,2,-5,6,1,1,0,1,-1,-7,3,1,-3,2,-6,0,0,-1,-1,0,-1,6,-1
KR_6767009423,420,-1,-28,-17,3,0,1,1,0,1,1,4,2,6,-1,4,3,0,0,0,0,-1,-9,-2,-3,5,4,0,-1,-1,1,-1,1,6,-1
KR_6359824104,420,0,-44,-16,4,-3,4,1,0,2,2,4,1,5,2,0,2,1,0,1,0,14,0,0,0,0,0,0,0,-1,1,-1,1,3,-1
KR_6765151100,420,0,7,16,-1,2,1,3,1,1,2,-2,3,1,-2,2,0,0,0,0,0,-6,2,-1,-6,7,-5,0,0,-1,0,0,1,4,-1
KR_6702862437,420,0,34,26,1,0,1,1,0,4,4,4,1,5,-3,3,0,0,0,0,0,1,10,4,-5,1,2,0,0,-1,1,0,1,1,-1
KR_6623888742,420,-1,1,-19,-3,2,1,3,-1,1,0,-1,2,1,-2,4,2,-1,1,0,0,-2,-17,-3,-5,8,-2,0,-1,-1,-1,-1,-1,1,-1
KR_6722801987,420,-3,-23,-4,-8,-8,8,0,-3,8,5,0,2,2,4,1,5,-1,2,1,0,0,11,0,-5,5,-9,0,1,-1,-1,-1,-1,6,-1
KR_6735728934,420,3,-24,-18,7,1,2,3,0,3,3,1,1,2,6,1,7,-1,1,0,0,12,6,3,-6,3,-5,0,0,1,-1,0,1,5,-1
KR_6713255540,420,-3,-123,7,-11,-1,2,1,-5,9,4,-4,4,0,2,1,3,-3,4,1,0,-15,24,1,-7,6,2,0,0,-1,-1,-1,1,3,-1
KR_6724678177,420,2,-16,44,-6,-3,3,0,2,1,3,-1,1,0,1,4,5,-5,7,2,-1,-12,-45,-6,-1,7,27,0,-1,-1,-1,-1,-1,2,-1
KR_6714608844,420,-3,-31,4,-8,-1,2,1,-2,5,3,0,2,2,-1,4,3,-4,4,0,0,-10,-36,-2,-2,4,-2,0,0,-1,1,1,1,1,-1
KR_6737993414,440,-1,-96,11,3,-1,1,0,3,0,3,3,2,5,-1,3,2,-1,2,1,0,1,-226,3,-6,3,0,0,-1,1,1,-1,-1,4,-1
KR_6769650000,440,-1,-87,0,-10,-4,6,2,2,2,4,-3,3,0,-2,5,3,-3,4,1,0,-9,1,0,-2,2,0,0,-3,1,-1,-1,-1,2,-1
KR_6653132412,420,-2,-18,-5,4,-1,1,0,-2,9,7,5,2,7,3,1,4,-1,2,1,0,13,0,2,-9,7,-3,0,-1,-1,-1,-1,-1,4,-1
KR_6611619548,420,-2,23,12,-1,0,0,0,-7,8,1,1,1,2,4,0,4,1,0,1,0,5,5,1,-6,5,3,0,0,1,-1,0,-1,6,-1
KR_6768359768,420,-1,-38,-13,-4,-2,2,0,2,1,3,-4,5,1,0,0,0,0,0,0,0,0,-1,0,-1,1,1,0,-1,0,-1,-1,-1,0,-1
KR_6661075734,420,3,-4,32,4,0,2,2,3,2,5,-2,2,0,1,0,1,2,1,3,0,7,-23,-2,-1,3,1,0,0,1,-1,0,-1,1,-1
KR_6720499993,420,-4,-64,-1,-8,-4,4,0,5,1,6,1,1,2,-12,15,3,2,0,2,2,-12,-1,-3,-5,8,-1,0,-2,-1,1,-1,-1,6,-1
KR_6754233449,420,-2,-14,-10,-11,-1,1,0,-5,8,3,0,1,1,-6,7,1,1,0,1,0,-17,93,2,-7,5,0,0,0,0,1,0,-1,0,-1
KR_6742219527,440,-3,-4,-5,-5,1,1,2,-1,1,0,-4,5,1,0,3,3,-1,1,0,0,-9,4,3,-8,5,2,0,-1,-1,-1,-1,-1,4,-1
KR_6762971339,420,-1,-23,3,-4,0,2,2,-2,2,0,-2,2,0,-1,3,2,1,0,1,0,-6,-112,0,-3,3,-5,0,0,1,1,0,-1,4,-1
KR_6668054670,420,0,-63,-16,-5,-1,3,2,-2,7,5,0,1,1,-1,2,1,-1,1,0,0,-6,-5,-2,-4,6,-3,0,-1,-1,1,-1,-1,5,-1
KR_6768848370,420,0,5,-20,2,-2,3,1,1,2,3,-2,4,2,6,0,6,-1,1,0,0,3,-111,-3,-3,6,3,0,0,1,0,0,-1,2,-1
KR_6754797102,420,0,0,11,2,1,0,1,4,1,5,-4,5,1,-2,4,2,3,0,3,0,2,-2,3,-7,4,2,0,0,1,1,1,1,4,-1
KR_6745495172,420,0,-40,10,-4,-2,3,1,-2,4,2,1,1,2,-1,3,2,0,1,1,0,-4,27,1,-3,2,-1,0,-2,1,-1,-1,-1,6,-1
KR_6734641834,420,0,-17,-18,5,1,0,1,2,2,4,-3,4,1,1,3,4,4,1,5,0,8,43,8,-10,2,-8,0,0,-1,1,0,1,2,-1
KR_6767521704,420,-4,-16,14,-8,1,0,1,2,3,5,-4,4,0,-4,4,0,-3,4,1,0,-12,2,-2,-4,6,0,0,0,-1,-1,0,-1,6,-1
KR_6645870018,440,2,-1,-16,6,2,1,3,-2,6,4,1,1,2,7,2,9,-2,5,3,-1,11,-27,2,-6,4,-4,0,1,1,1,1,-1,2,-1
KR_6763012408,420,-1,-19,12,-10,-4,4,0,-1,1,0,-3,3,0,-2,4,2,0,0,0,0,-11,10,2,-6,4,-4,0,0,0,1,0,-1,0,-1
KR_6768121362,420,-8,-108,-22,-18,-1,1,0,-3,3,0,-9,9,0,-2,2,0,-3,4,1,0,-18,-35,2,-8,6,-6,0,-1,-1,1,-1,-1,6,-1
KR_6762586527,420,-1,-31,19,0,-2,3,1,1,0,1,3,2,5,-4,6,2,2,1,3,0,6,-1,-2,-6,8,-5,0,1,-1,1,1,-1,1,-1
KR_6745463823,420,-2,-67,20,-4,-5,8,3,-2,3,1,2,2,4,3,0,3,-2,3,1,2,5,4,2,-4,2,4,0,-1,0,-1,-1,1,0,-1
KR_6755102380,440,-7,-32,-44,-15,-1,2,1,-7,8,1,-4,5,1,-3,3,0,0,0,0,0,-12,-4,-5,-1,6,1,0,0,-1,-1,0,-1,6,-1
KR_6748930882,420,-4,-49,27,-16,-5,5,0,-4,6,2,-3,4,1,-1,3,2,-3,3,0,-2,-17,-5,-7,-1,8,-4,0,-2,-1,-1,-1,-1,3,-1
KR_6767780565,420,0,-23,-19,-3,0,0,0,-4,4,0,5,1,6,-4,5,1,0,1,1,0,-6,9,10,-13,3,-1,0,-1,1,1,-1,-1,1,-1
KR_6721021538,440,-4,-32,-16,-8,0,0,0,-5,5,0,2,0,2,-3,4,1,-2,4,2,0,-4,4,0,-8,8,-1,0,-1,0,1,-1,-1,0,-1
KR_6640524615,420,2,-16,16,6,0,0,0,3,0,3,3,2,5,-1,5,4,1,0,1,0,7,-3,1,-6,5,5,0,1,1,1,1,1,3,-1
KR_6754036628,420,-2,60,5,-5,1,1,2,-2,5,3,-1,2,1,-1,2,1,-2,2,0,0,-15,2,-2,-3,5,1,0,0,-1,-1,-1,1,5,-1
KR_6631068281,420,-2,-27,-2,-1,-6,6,0,1,3,4,-2,3,1,5,0,5,1,1,2,0,-4,14,-2,-6,8,-15,0,-1,1,-1,-1,-1,5,-1
KR_6643091881,420,-3,-80,-35,-7,1,1,2,0,1,1,-3,3,0,-4,4,0,-1,1,0,-1,-11,-12,2,-5,3,-1,0,-3,-1,-1,-1,-1,2,-1
KR_6660768723,440,-3,-13,4,2,1,1,2,0,2,2,-1,1,0,-1,3,2,3,0,3,0,4,2,3,-6,3,-5,0,0,-1,0,0,1,4,-1
KR_6732078345,420,-4,-11,-47,1,-2,3,1,-1,1,0,3,1,4,1,0,1,0,1,1,0,3,7,1,-4,3,-3,0,0,0,-1,-1,-1,0,-1
KR_6718380692,420,-4,30,-16,-3,-2,3,1,1,1,2,0,4,4,0,0,0,-2,2,0,0,-6,-2,1,-2,1,1,0,0,-1,-1,0,1,6,-1
KR_6754150252,420,-4,9,-21,-9,-5,7,2,-4,7,3,2,4,6,-3,4,1,1,1,2,1,-10,-23,1,-5,4,-1,0,0,-1,1,-1,1,1,-1
KR_6671816189,420,-5,-107,-16,-16,-2,3,1,-3,3,0,-9,10,1,-2,7,5,0,1,1,-1,-7,-5,-1,-7,8,-4,0,-1,-1,-1,-1,-1,3,-1
KR_6737277266,420,2,-45,36,3,-1,4,3,-1,2,1,-1,4,3,6,3,9,0,1,1,0,14,-7,0,-3,3,0,0,-1,1,0,-1,-1,4,-1
KR_6687463189,420,-3,-76,3,-2,-5,5,0,2,0,2,3,0,3,-2,4,2,0,1,1,0,6,2,-2,-2,4,-1,0,-2,1,-1,-1,1,3,-1
KR_6769675709,420,-3,-1,-28,0,-1,2,1,4,3,7,1,1,2,-2,4,2,-2,2,0,0,-1,8,3,-3,0,0,0,0,1,-1,-1,1,3,-1
KR_6381707051,420,1,-19,-15,2,1,1,2,0,2,2,2,2,4,-1,2,1,0,0,0,0,3,287,-3,-2,5,6,0,-1,-1,1,-1,1,6,-1
KR_6717073571,420,3,8,0,5,2,1,3,1,4,5,0,3,3,1,1,2,1,0,1,0,2,2,1,-3,2,2,0,0,-1,-1,0,1,2,-1
KR_6769426180,420,-5,-105,-12,-19,-2,3,1,-4,7,3,-4,4,0,-5,5,0,-4,5,1,0,-20,-15,-1,-6,7,1,0,-2,-1,1,-1,-1,1,-1
KR_6754024237,420,3,49,0,5,0,1,1,-2,2,0,6,1,7,0,1,1,1,1,2,0,3,114,1,-5,4,1,0,0,1,1,0,1,6,-1
KR_6743591354,420,-5,-111,-24,-14,0,1,1,-2,4,2,-3,3,0,-7,8,1,-2,3,1,0,-17,-104,-4,-3,7,-5,0,-1,-1,0,-1,-1,2,-1
KR_6759722313,420,0,24,8,6,1,1,2,6,1,7,1,0,1,-2,3,1,0,2,2,0,7,-2,-2,-4,6,1,0,1,-1,1,1,-1,6,-1
KR_6480223006,420,1,-3,-4,2,1,2,3,2,1,3,-2,4,2,0,3,3,1,0,1,0,-1,14,0,-2,2,0,0,0,-1,-1,0,1,6,-1
KR_6743079901,420,-1,-65,-12,-3,-2,2,0,2,4,6,-1,3,2,-2,4,2,0,1,1,0,1,16,0,-3,3,4,0,-1,1,0,-1,-1,2,-1
KR_6761578089,420,0,41,6,0,0,0,0,0,4,4,-5,6,1,3,3,6,2,1,3,0,-3,2,-2,-5,7,4,0,0,1,-1,0,-1,6,-1
KR_6759710426,420,-2,-42,-8,-6,-2,3,1,0,2,2,-2,2,0,-1,3,2,-1,1,0,-2,-11,-5,-1,-4,5,-3,0,0,0,1,0,-1,0,-1
KR_6562267823,420,-6,-58,4,-15,-5,7,2,-3,4,1,2,1,3,-9,10,1,0,1,1,0,-11,0,-1,-5,6,1,0,-2,-1,-1,-1,-1,5,-1
KR_6760086324,440,-2,-7,-5,-4,1,0,1,-1,2,1,-4,5,1,-1,1,0,1,1,2,1,-3,-2,2,-5,3,2,0,0,-1,0,0,1,2,-1
KR_6751175158,420,-5,-11,-12,-6,2,0,2,-7,7,0,-3,4,1,0,1,1,2,0,2,0,-6,-3,-2,-4,6,0,0,-1,1,-1,-1,-1,1,-1
KR_6617630073,420,-4,-30,-6,-11,-1,3,2,-8,9,1,4,3,7,-3,7,4,-3,3,0,1,-13,-3,0,-5,5,-2,0,-1,-1,-1,-1,1,6,-1
KR_6499263689,420,0,43,-20,-4,3,2,5,-2,4,2,-5,6,1,0,1,1,0,1,1,0,-5,13,-4,-1,5,-3,0,0,-1,-1,-1,1,3,-1
KR_6764240376,420,3,10,-1,10,-2,4,2,6,1,7,-2,3,1,6,2,8,2,1,3,-2,15,13,6,-8,2,-2,0,1,0,1,1,-1,0,-1
KR_6678186452,420,-3,7,-34,-3,-1,3,2,1,4,5,0,2,2,-2,4,2,-1,1,0,-1,-12,-25,1,-7,6,2,0,1,-1,1,1,-1,2,-1
KR_6743746973,420,-5,-139,-8,-7,-3,3,0,1,2,3,-1,3,2,-3,4,1,-1,1,0,0,-5,156,1,-8,7,-3,0,0,-1,-1,0,-1,3,-1
KR_6603183447,420,-2,-14,-12,-5,-2,2,0,0,2,2,-3,5,2,1,3,4,-1,1,0,0,-1,-149,-8,-1,9,-1,0,-2,-1,-1,-1,1,3,-1
KR_6755435446,420,-1,7,0,-4,-5,6,1,0,2,2,2,1,3,-2,3,1,1,0,1,0,-2,1,1,-7,6,5,0,0,1,0,0,-1,4,-1
KR_6736699905,420,-1,-2,18,-5,-4,5,1,-2,3,1,6,2,8,-5,5,0,0,1,1,1,-8,-24,3,-7,4,6,0,-2,0,-1,-1,1,0,-1
KR_6738863096,420,-1,58,12,-1,7,0,7,-4,9,5,-1,5,4,0,3,3,-3,4,1,3,3,302,4,-11,7,1,0,1,-1,-1,1,1,3,-1
KR_6729420958,420,-3,40,10,-7,-4,6,2,-2,2,0,-2,3,1,4,0,4,-3,3,0,0,-10,-2,-5,-2,7,0,0,-1,-1,0,1,-1,5,-1
KR_6640074444,420,-5,-11,-20,-14,-2,5,3,-2,3,1,-1,2,1,-4,5,1,-5,6,1,0,-17,-9,-2,-2,4,-1,0,-2,-1,-1,-1,-1,2,-1
KR_6769598367,420,-2,-22,23,-1,3,1,4,6,1,7,-8,9,1,0,4,4,-2,3,1,-1,0,-15,-2,-2,4,-1,0,1,-1,1,1,-1,5,-1
KR_6686222077,420,0,-19,-14,3,-1,1,0,4,2,6,-2,3,1,0,2,2,2,0,2,0,0,21,1,-4,3,2,0,0,1,0,0,1,3,-1
KR_6750787684,420,-2,-49,-39,-4,-2,4,2,-1,3,2,-3,6,3,2,1,3,0,2,2,0,1,332,-5,-2,7,-1,0,0,1,-1,0,-1,5,-1
KR_6536923235,420,2,-73,20,7,-1,2,1,2,1,3,-2,3,1,3,0,3,5,2,7,0,5,8,2,-5,3,1,0,0,1,1,0,-1,1,-1
KR_6726689127,420,-4,-91,-32,-5,0,1,1,2,2,4,-2,4,2,-2,3,1,-3,3,0,0,-3,42,0,-3,3,-25,0,0,-1,-1,0,1,5,-1
KR_6752633734,420,-2,-40,36,-4,-2,3,1,1,1,2,1,2,3,-4,7,3,0,1,1,0,-6,-2,-2,-5,7,-4,0,-1,0,1,-1,1,0,-1
KR_6714695164,440,-1,-38,20,-2,-1,2,1,-4,6,2,4,1,5,0,1,1,-1,1,0,1,-3,-44,-1,-5,6,8,0,-1,-1,-1,-1,1,5,-1
KR_6744937437,420,0,-17,34,-5,2,0,2,-7,7,0,3,2,5,-2,2,0,-1,2,1,0,-7,-2,-4,-3,7,4,0,1,1,1,1,1,5,-1
KR_6704599370,420,-6,-98,-12,-8,-2,2,0,-2,3,1,-4,6,2,1,2,3,-1,1,0,0,0,-5,-1,-3,4,-2,0,-4,-1,-1,-1,-1,2,-1
KR_6716987081,420,-3,-74,-8,-7,-5,6,1,0,6,6,-3,4,1,1,2,3,0,0,0,-1,1,-3,-5,-3,8,0,0,1,-1,-1,-1,-1,5,-1
KR_6546984527,420,-6,-70,-46,-8,-3,3,0,-5,6,1,0,2,2,-1,3,2,1,1,2,2,-6,44,-4,-3,7,-2,0,-1,-1,-1,-1,1,6,-1
KR_6743998698,420,-2,5,12,-4,-4,4,0,5,1,6,3,2,5,-5,5,0,-3,3,0,0,-2,5,-1,-4,5,-3,0,0,1,-1,-1,-1,6,-1
KR_6758688324,420,-1,23,-3,-4,-1,1,0,-2,3,1,3,0,3,-2,3,1,-2,3,1,0,-6,-68,-2,-5,7,4,0,0,-1,1,1,1,6,-1
KR_6645275758,440,-4,-117,-5,-7,-5,5,0,4,0,4,-6,6,0,-4,4,0,4,0,4,0,-1,-6,1,-2,1,1,0,-1,0,-1,-1,-1,0,-1
KR_6735403900,420,2,20,4,-1,0,1,1,0,2,2,-1,2,1,-3,4,1,3,0,3,-1,-2,-43,-5,0,5,4,0,0,1,0,1,-1,4,-1
KR_6750739812,420,-1,3,-12,-4,-1,3,2,-3,7,4,-3,5,2,5,1,6,-2,2,0,-1,-1,0,-1,-4,5,0,0,0,-1,-1,0,-1,2,-1
KR_6714196612,440,-3,0,-38,-5,-4,4,0,-3,6,3,3,0,3,0,1,1,-1,1,0,0,1,18,3,-7,4,3,0,0,-1,-1,0,-1,2,-1
KR_6759607296,420,0,70,-8,12,1,2,3,2,3,5,2,4,6,7,1,8,0,0,0,1,15,10,9,-10,1,1,0,2,1,1,1,1,4,-1
KR_6760322292,420,0,30,6,-4,4,0,4,-7,8,1,2,3,5,-5,8,3,2,1,3,0,-15,-15,-1,-8,9,7,0,1,1,1,1,1,1,-1
KR_6712151687,420,-4,-23,-13,-10,-4,5,1,-2,2,0,-3,5,2,-2,6,4,1,2,3,0,-13,-5,0,-4,4,-1,0,-1,-1,-1,-1,-1,1,-1
KR_6694762976,420,-6,-17,-32,-11,-5,6,1,-2,4,2,-2,4,2,-3,5,2,1,0,1,0,-8,-6,0,-5,5,4,0,-1,-1,1,-1,1,5,-1
KR_6759136074,440,-1,41,-17,-1,-7,7,0,2,1,3,-2,3,1,4,1,5,2,0,2,0,-3,-33,4,-8,4,-3,0,2,-1,-1,1,1,1,-1
KR_6704647378,420,-2,-78,17,-1,0,0,0,1,2,3,0,2,2,-2,4,2,0,0,0,0,-2,5,1,-4,3,0,0,1,1,1,1,1,5,-1
KR_6665753274,420,1,23,-4,-3,-1,2,1,1,2,3,-1,4,3,-1,1,0,-1,1,0,0,-4,-10,-4,-4,8,11,0,0,-1,0,0,1,3,-1
KR_6636494940,420,-1,13,-28,-4,1,2,3,-2,8,6,1,1,2,-4,5,1,0,1,1,-1,-15,-9,0,-2,2,-1,0,0,-1,-1,-1,-1,5,-1
KR_6680225168,420,-1,-37,-20,-11,0,1,1,-3,3,0,-4,5,1,-8,8,0,4,2,6,0,-13,12,1,-4,3,2,0,0,1,-1,-1,-1,4,-1
KR_6460707536,420,-2,-31,-3,-6,-2,2,0,-5,6,1,-1,1,0,-1,3,2,3,1,4,0,-4,-16,-5,-3,8,2,0,-1,-1,-1,-1,1,3,-1
KR_6687854321,420,-1,9,-3,0,5,1,6,0,1,1,-3,6,3,-3,5,2,1,1,2,0,-4,-9,-1,-3,4,2,0,0,-1,1,1,1,6,-1
KR_6764169543,420,1,-3,5,-2,1,1,2,-2,4,2,-2,3,1,1,1,2,0,1,1,0,2,-3,1,-7,6,-3,0,0,1,-1,0,-1,2,-1
KR_6730177469,440,1,-2,-15,2,2,6,8,7,4,11,-3,3,0,-4,4,0,0,5,5,-1,4,-7,-2,-4,6,5,0,2,-1,1,1,-1,2,-1
KR_6595951069,420,0,-15,41,0,0,1,1,6,2,8,-5,6,1,0,3,3,-1,1,0,-1,0,-61,2,-5,3,1,0,-1,1,1,-1,-1,2,-1
KR_6742552468,420,-1,21,0,9,-3,3,0,2,2,4,5,0,5,3,3,6,2,1,3,0,9,5,1,-6,5,3,0,2,1,-1,1,1,6,-1
KR_6769395610,420,-2,-1,-27,-5,-1,1,0,-2,5,3,-2,5,3,0,0,0,0,0,0,1,-2,41,-2,-1,3,-26,0,1,-1,1,1,1,2,-1
KR_6749796103,440,-4,58,7,-9,1,1,2,-4,4,0,-4,7,3,-1,2,1,-1,1,0,0,-13,0,-3,-2,5,0,0,-1,-1,-1,-1,1,1,-1
KR_6759720313,440,-5,-85,-44,-10,-1,2,1,3,1,4,1,4,5,-3,5,2,-10,10,0,0,-4,-15,-3,0,3,1,0,-2,-1,-1,-1,-1,5,-1
KR_6707292398,420,-3,-63,10,-9,-3,3,0,0,2,2,-2,2,0,-2,3,1,-2,2,0,0,-6,-20,-5,-1,6,-3,0,-4,-1,1,-1,1,3,-1
KR_6531978015,420,3,20,-15,9,1,2,3,4,0,4,-3,4,1,7,0,7,0,0,0,0,9,-9,-1,-5,6,2,0,0,1,1,0,1,1,-1
KR_6740420787,420,1,43,4,-8,-3,4,1,-3,6,3,5,3,8,-5,5,0,-2,2,0,-1,-10,0,-2,-4,6,3,0,-1,-1,1,-1,-1,1,-1
KR_6742085514,420,1,74,3,-2,-1,2,1,0,1,1,-1,3,2,1,0,1,-1,1,0,0,4,9,2,-7,5,-5,0,0,1,-1,0,1,6,-1
KR_6762633477,440,-2,26,-8,-2,-2,2,0,-1,2,1,0,2,2,1,2,3,0,1,1,-1,-5,-13,2,-6,4,0,0,-1,1,-1,-1,-1,4,-1
KR_6768643542,420,0,-12,4,-6,1,0,1,-1,2,1,-3,6,3,-1,3,2,-2,2,0,0,-5,25,-1,-4,5,-3,0,-2,-1,-1,-1,-1,5,-1
KR_6640564237,420,-1,-33,-18,-3,-2,2,0,0,5,5,-2,4,2,1,6,7,0,1,1,1,-12,-13,-2,-1,3,-2,0,-2,-1,-1,-1,-1,3,-1
KR_6598738816,420,-2,-45,55,-12,-2,3,1,-2,6,4,-4,4,0,-3,6,3,-1,2,1,0,-12,0,0,-5,5,-4,0,-2,-1,1,-1,-1,3,-1
KR_6658786961,420,-2,0,-8,-3,-4,6,2,-2,5,3,-1,3,2,3,2,5,1,4,5,0,-10,-215,3,-6,3,0,0,-1,1,-1,-1,1,2,-1
KR_6404330452,420,-2,-106,9,-3,-4,5,1,2,4,6,-1,2,1,-1,5,4,1,1,2,0,1,6,1,-5,4,-2,0,-1,1,0,-1,-1,2,-1
KR_6751156334,420,1,13,13,-2,-2,2,0,0,3,3,1,1,2,-1,5,4,0,3,3,0,-9,-174,-4,-5,9,3,0,1,-1,-1,-1,1,5,-1
KR_6748641774,420,-3,-85,-20,-9,-1,6,5,-3,5,2,0,3,3,0,3,3,-5,7,2,1,-5,17,-1,-2,3,-2,0,-4,-1,1,-1,1,4,-1
KR_6763423543,420,-7,-123,-9,-8,-1,3,2,-3,4,1,1,0,1,-6,8,2,1,3,4,-1,-10,-31,0,-5,5,-1,0,-3,0,1,-1,-1,0,-1
KR_6741262140,420,-3,-50,-18,-6,-1,3,2,0,2,2,4,0,4,-8,8,0,-1,4,3,-1,-7,-3,1,-2,1,-2,0,-3,-1,1,-1,-1,6,-1
KR_6638154794,420,1,42,12,0,2,1,3,4,3,7,1,1,2,-3,5,2,-4,4,0,0,-3,8,-4,-2,6,2,0,0,-1,1,1,1,2,-1
KR_6768740172,420,1,3,7,3,3,1,4,-8,8,0,4,0,4,3,0,3,1,0,1,0,0,200,0,-3,3,2,0,0,-1,1,0,1,4,-1
KR_6763827543,420,-4,-49,-26,-10,-2,2,0,0,1,1,-5,5,0,-2,3,1,-1,1,0,0,-5,-2,-2,-4,6,-1,0,-1,-1,-1,-1,-1,3,-1
KR_6726591895,440,-2,-15,-22,-9,0,3,3,-6,8,2,-1,2,1,0,1,1,-2,2,0,0,-9,234,2,-5,3,1,0,-1,-1,1,-1,1,4,-1
KR_6566475570,420,-4,-67,-5,-10,3,0,3,-3,6,3,-1,3,2,-9,9,0,0,1,1,0,-20,10,0,-8,8,-10,0,0,-1,-1,-1,-1,6,-1
KR_6624049050,420,-3,8,-15,-10,0,0,0,-6,11,5,1,5,6,-3,4,1,-2,2,0,0,-18,13,5,-7,2,0,0,-1,0,-1,-1,-1,0,-1
KR_6769660185,440,-6,-75,12,-8,-7,7,0,4,0,4,2,2,4,-2,2,0,-5,5,0,0,-6,21,0,-2,2,-1,0,-1,0,1,-1,-1,0,-1
KR_6704751415,420,2,21,8,7,5,0,5,-1,2,1,7,0,7,-3,4,1,-1,3,2,-1,9,2,3,-7,4,4,0,-1,-1,-1,-1,-1,5,-1
KR_6734788668,420,-3,-75,26,-12,-6,6,0,-1,3,2,1,2,3,-3,3,0,-3,3,0,0,-13,-3,0,-3,3,-4,0,-1,-1,-1,-1,-1,3,-1
KR_6768070564,420,0,13,-48,-2,1,0,1,-2,2,0,2,3,5,-1,3,2,-2,2,0,0,-5,-2,-2,-4,6,-1,0,1,-1,1,1,-1,4,-1
KR_6750129775,420,-3,40,-28,-8,1,1,2,-4,4,0,-8,8,0,3,1,4,0,1,1,0,-4,-26,2,-5,3,1,0,0,-1,1,0,-1,1,-1
KR_6722688949,420,0,-22,-4,3,-2,2,0,4,2,6,-2,2,0,3,0,3,0,0,0,0,6,-10,-2,-2,4,3,0,0,0,-1,-1,1,0,-1
KR_6729805120,420,0,18,16,-1,-1,2,1,-2,4,2,4,0,4,-1,2,1,-1,1,0,0,-4,0,0,-8,8,-1,0,0,0,1,0,-1,0,-1
KR_6580228297,420,2,23,31,7,-2,3,1,3,2,5,6,1,7,2,4,6,-2,2,0,0,0,297,5,-7,2,1,0,0,1,1,-1,1,3,-1
KR_6748732283,420,-5,-70,-13,-20,-8,11,3,-5,6,1,-3,3,0,-4,4,0,0,0,0,0,-10,1,0,-5,5,-1,0,-2,-1,-1,-1,1,5,-1
KR_6720976854,440,-9,-92,-51,-13,-5,5,0,-4,4,0,-1,2,1,-1,1,0,-2,2,0,0,-10,-10,-3,-6,9,-3,0,-2,-1,-1,-1,-1,1,-1
KR_6754268700,420,-1,6,-5,0,4,1,5,-3,3,0,-2,3,1,0,3,3,1,0,1,0,-1,-108,2,-9,7,0,0,0,-1,1,1,1,2,-1
KR_6766835994,420,-1,1,4,-6,2,1,3,0,1,1,-5,6,1,-4,5,1,1,1,2,0,-12,165,2,-6,4,-22,0,0,-1,1,1,-1,5,-1
KR_6755581944,420,0,-23,-25,-2,-2,3,1,1,2,3,0,1,1,-2,4,2,1,0,1,-1,-1,-173,3,-5,2,0,0,-1,-1,-1,-1,-1,1,-1
KR_6760330014,420,-1,-15,0,-4,-1,3,2,-2,4,2,-2,3,1,1,1,2,0,1,1,0,-2,-38,0,-6,6,-3,0,0,-1,-1,0,1,6,-1
KR_6760709667,420,-6,-69,-12,-18,-2,2,0,0,0,0,-6,8,2,-6,8,2,-4,4,0,-1,-25,14,-3,-4,7,-7,0,-2,-1,-1,-1,-1,2,-1
KR_6760635641,420,-2,-52,-25,1,-7,9,2,2,1,3,1,1,2,5,4,9,0,0,0,-1,13,4,-2,-2,4,-2,0,-1,-1,-1,-1,1,4,-1
KR_6744878765,420,-1,-2,-4,-5,2,1,3,-2,4,2,2,1,3,-5,6,1,-2,2,0,0,-2,-12,-1,-3,4,3,0,-1,1,1,-1,1,1,-1
KR_6761271518,420,-5,-45,-24,-15,-3,3,0,-3,3,0,-8,8,0,1,2,3,-2,2,0,0,-19,23,2,-8,6,-4,0,-4,-1,-1,-1,1,3,-1
KR_6595821532,420,1,-11,16,8,-2,4,2,-1,4,3,1,0,1,5,2,7,5,0,5,-1,10,-26,-4,-3,7,14,0,1,1,-1,1,-1,6,-1
KR_6766684626,420,3,38,14,-3,-2,2,0,-1,1,0,4,4,8,-3,5,2,-1,2,1,-1,-4,29,-2,-5,7,1,0,1,1,1,1,-1,1,-1
KR_6738531609,440,3,80,16,1,2,5,7,-1,2,1,1,2,3,1,2,3,-2,5,3,0,2,7,0,-4,4,2,0,1,1,0,1,-1,6,-1
KR_6641719937,420,-6,-79,-2,-7,0,1,1,0,3,3,-3,5,2,-2,3,1,-2,3,1,0,0,-52,0,-4,4,18,0,-2,-1,-1,-1,1,6,-1
KR_6766778742,420,-1,-32,-22,-4,3,2,5,-1,2,1,-3,5,2,-1,5,4,-2,2,0,0,3,-13,1,-4,3,2,0,1,-1,1,1,-1,2,-1
KR_6766785560,420,4,57,22,7,0,1,1,1,1,2,-2,2,0,6,1,7,2,1,3,0,5,-10,-1,-3,4,0,0,0,1,1,1,1,6,-1
KR_6692649452,420,4,22,8,4,2,0,2,5,1,6,-1,2,1,-1,2,1,-1,3,2,0,3,1,6,-9,3,2,0,1,-1,1,1,-1,2,-1
KR_6116566558,420,-5,12,-32,-12,-1,5,4,-2,8,6,-4,5,1,-1,2,1,-4,5,1,0,-8,6,1,-3,2,-1,0,-1,-1,-1,-1,1,5,-1
KR_6768164733,440,-2,-1,-31,-4,0,1,1,-2,3,1,0,4,4,-4,5,1,2,1,3,0,-6,-21,-1,-5,6,3,0,0,1,-1,-1,-1,6,-1
KR_6727449553,420,1,-31,8,0,0,1,1,6,0,6,2,2,4,-7,8,1,-1,1,0,0,-2,11,-1,-5,6,2,0,0,1,1,1,1,5,-1
KR_6759744790,420,-1,-40,12,-2,1,2,3,-3,3,0,3,1,4,-3,3,0,0,1,1,0,-2,-2,4,-8,4,-4,0,0,0,-1,0,-1,0,-1
KR_6740692389,420,-2,-30,4,-1,-2,3,1,1,2,3,1,3,4,0,1,1,-1,3,2,0,0,-3,0,-5,5,0,0,1,1,1,1,-1,5,-1
KR_6667342047,420,3,-16,28,1,-1,1,0,0,1,1,4,2,6,1,0,1,-3,4,1,-1,-4,31,1,-5,4,0,0,1,0,1,1,-1,0,-1
KR_6766018158,420,-5,-43,-24,-13,-1,1,0,-3,3,0,-2,2,0,-4,5,1,-3,3,0,0,-15,4,1,-3,2,-2,0,-1,-1,-1,-1,-1,5,-1
KR_6694527900,420,-5,-110,21,-14,-1,3,2,-4,5,1,-8,9,1,-2,4,2,1,0,1,-3,-20,-1,5,-6,1,-7,0,-3,1,-1,-1,-1,1,-1
KR_6730227771,440,-3,-7,12,-2,2,0,2,1,8,9,1,1,2,-6,8,2,0,1,1,0,-6,-10,-4,-2,6,-1,0,0,-1,-1,-1,-1,3,-1
KR_6729434458,420,-6,-57,-48,-10,2,1,3,-8,8,0,2,1,3,-2,4,2,-4,5,1,0,-16,103,-1,-4,5,-7,0,0,-1,-1,-1,-1,4,-1
KR_6762806484,420,-4,4,9,-13,-2,2,0,-7,8,1,0,2,2,-2,3,1,-2,3,1,0,-15,2,0,-3,3,1,0,1,-1,1,1,-1,3,-1
KR_6768063936,420,-2,-7,-14,-6,-3,3,0,-1,2,1,0,3,3,-3,5,2,1,0,1,3,0,-3,-2,-4,6,1,0,-1,-1,-1,-1,1,6,-1
KR_6604975315,420,5,55,19,2,0,4,4,1,5,6,2,1,3,0,1,1,-1,2,1,0,-3,0,-3,-4,7,2,0,2,-1,1,1,-1,4,-1
KR_6635593562,420,2,-21,16,2,1,1,2,1,3,4,0,0,0,0,2,2,0,0,0,0,2,-41,1,-3,2,3,0,0,-1,1,1,-1,3,-1
KR_6747964041,440,3,61,20,8,2,1,3,3,1,4,2,1,3,-2,4,2,3,0,3,0,1,-311,-3,-2,5,0,0,0,1,1,0,1,2,-1
KR_6766559405,420,-4,-4,-26,-10,-3,3,0,-1,4,3,-2,3,1,1,1,2,-5,6,1,1,-7,2,-1,-6,7,-2,0,-1,-1,-1,-1,1,4,-1
KR_6703587397,440,-1,-28,-22,0,0,0,0,0,2,2,2,2,4,-2,2,0,0,1,1,0,0,6,1,-3,2,-3,0,0,-1,-1,0,-1,2,-1
KR_6566655714,440,0,48,2,-5,3,0,3,-2,4,2,-4,5,1,-3,6,3,1,1,2,0,-11,-2,0,-3,3,-1,0,0,1,-1,0,1,5,-1
KR_6768792988,440,-1,-22,0,-6,0,3,3,0,3,3,-6,7,1,0,4,4,0,2,2,1,-8,9,5,-10,5,-1,0,-2,-1,-1,-1,1,3,-1
KR_6738568814,440,0,-28,-8,-3,5,1,6,-6,11,5,0,2,2,0,2,2,-2,3,1,-2,-18,23,-3,-4,7,1,0,0,-1,-1,1,-1,4,-1
KR_6700025468,420,-6,-80,-8,-14,-1,1,0,-6,8,2,-5,6,1,1,4,5,-3,3,0,0,-6,17,1,-5,4,-4,0,0,-1,-1,-1,-1,4,-1
KR_6617936636,440,0,-23,28,2,0,1,1,-3,6,3,-2,5,3,3,1,4,4,0,4,0,6,-9,0,-3,3,1,0,0,-1,0,0,1,5,-1
KR_6741651733,420,-1,0,-14,3,-1,3,2,-1,1,0,-3,5,2,10,1,11,-2,4,2,0,6,-20,0,-5,5,-3,0,-1,1,-1,-1,1,2,-1
KR_6764058477,420,-4,-69,-36,-5,-8,9,1,-2,2,0,-5,5,0,2,2,4,8,0,8,-2,-6,-12,-3,-2,5,5,0,-1,-1,1,-1,1,6,-1
KR_6570333779,420,0,-142,39,1,-1,2,1,10,0,10,-2,3,1,-5,5,0,-1,1,0,0,-1,-2,-1,-3,4,0,0,0,-1,1,-1,1,5,-1
KR_6751040983,420,-3,-23,-24,-7,4,1,5,3,1,4,-8,10,2,-6,9,3,0,2,2,-2,-9,3,1,-4,3,-1,0,-2,-1,-1,-1,-1,4,-1
KR_6759270337,440,0,-21,28,-10,-2,2,0,0,2,2,-3,4,1,-4,7,3,-1,1,0,0,-7,5,1,-6,5,-2,0,0,1,1,0,1,1,-1
KR_6704241426,420,-6,-62,-9,-14,-7,7,0,-2,6,4,2,2,4,-5,7,2,-2,2,0,0,-22,0,3,-6,3,-9,0,-2,-1,-1,-1,1,4,-1
KR_6674518106,420,-1,65,-12,-6,0,4,4,0,2,2,-4,6,2,-3,6,3,1,0,1,-1,-9,-6,-2,-6,8,4,0,0,-1,-1,-1,-1,2,-1
KR_6743733778,420,1,25,8,-6,2,1,3,1,5,6,-1,2,1,-8,9,1,0,0,0,1,-10,-11,-1,-4,5,2,0,0,-1,1,0,1,1,-1
KR_6730408093,420,-3,-18,-11,-6,-1,2,1,-1,2,1,-1,2,1,-3,5,2,0,1,1,0,-11,49,0,-4,4,-26,0,0,-1,-1,0,-1,4,-1
KR_6635484670,420,-2,-38,-42,-7,-2,4,2,-2,5,3,-1,3,2,-1,2,1,-1,1,0,1,1,2,3,-6,3,1,0,-1,-1,-1,-1,1,3,-1
KR_6760824771,440,-1,2,13,-4,2,2,4,0,6,6,-7,8,1,1,1,2,0,0,0,-1,4,7,2,-6,4,-2,0,-1,1,-1,-1,-1,1,-1
KR_6751043351,420,-2,-17,-8,-3,-5,5,0,-2,5,3,1,2,3,1,1,2,2,2,4,0,2,-109,1,-4,3,4,0,0,1,1,1,-1,2,-1
KR_6482430946,420,4,66,-36,2,0,0,0,0,3,3,-2,3,1,3,1,4,1,0,1,1,5,-69,3,-7,4,2,0,0,1,-1,0,1,2,-1
KR_6752509504,420,2,17,8,-1,3,1,4,1,1,2,-1,3,2,-5,5,0,1,3,4,0,-7,-10,-1,-3,4,0,0,0,-1,1,-1,1,5,-1
KR_6729294830,420,1,93,-10,-1,3,2,5,-4,6,2,-5,5,0,4,1,5,1,3,4,0,-7,-14,-2,-2,4,-2,0,0,-1,1,-1,1,3,-1
KR_6632144896,420,-3,-102,-11,-5,-2,2,0,-3,5,2,4,1,5,-1,3,2,-3,5,2,0,-2,6,2,-5,3,-2,0,0,-1,-1,-1,-1,5,-1
KR_6615274217,420,-3,-11,5,-5,0,3,3,-2,3,1,0,2,2,1,1,2,-4,4,0,-1,-15,4,1,-3,2,-2,0,0,-1,1,0,-1,3,-1
KR_6769234131,420,-3,-1,-21,-8,3,0,3,-5,8,3,-3,4,1,-2,4,2,-1,1,0,0,-4,4,-1,-4,5,-5,0,-1,-1,-1,-1,-1,1,-1
KR_6738080770,420,1,0,32,0,1,1,2,5,3,8,0,1,1,-3,4,1,-3,3,0,0,0,-1,1,-5,4,2,0,1,-1,1,-1,-1,5,-1
KR_6623797547,420,-2,-61,4,0,-4,4,0,3,0,3,4,2,6,-3,3,0,0,2,2,0,-1,55,0,-4,4,1,0,-1,1,0,-1,1,2,-1
KR_6719370202,420,-5,-46,-20,-5,1,3,4,-5,5,0,-1,2,1,-2,2,0,2,1,3,1,-5,-27,3,-7,4,-1,0,-2,1,1,-1,-1,1,-1
KR_6755006927,420,-4,-38,-16,-4,-1,2,1,0,4,4,-2,3,1,-2,3,1,1,1,2,0,-5,291,-4,-1,5,3,0,0,0,-1,0,1,0,-1
KR_6751634605,420,1,76,-4,3,0,3,3,4,1,5,0,3,3,0,5,5,-1,1,0,0,4,269,-2,-3,5,2,0,0,1,-1,-1,-1,5,-1
KR_6704276714,420,4,75,23,9,0,3,3,6,0,6,3,1,4,1,5,6,-1,2,1,1,11,7,5,-8,3,-2,0,2,1,1,1,1,4,-1
KR_6552521916,420,-7,-38,-27,-24,-5,6,1,-2,4,2,-10,10,0,-2,5,3,-5,6,1,-1,-32,-25,1,-4,3,-2,0,-3,-1,-1,-1,-1,3,-1
KR_6768194500,420,1,1,20,1,-2,3,1,-2,4,2,-1,4,3,1,3,4,5,2,7,0,-2,-56,4,-6,2,-3,0,1,1,1,1,1,6,-1
KR_6767123187,420,-3,-44,0,-10,1,0,1,0,2,2,-7,7,0,-3,5,2,-1,1,0,-2,-6,4,0,-7,7,-1,0,-1,0,-1,-1,-1,0,-1
KR_6663768454,420,-4,-29,-16,-3,0,0,0,1,0,1,0,1,1,-5,5,0,1,0,1,0,-3,-23,-3,-6,9,0,0,-2,-1,-1,-1,-1,1,-1
KR_6742726324,420,0,-81,12,3,-2,2,0,-2,4,2,2,3,5,3,1,4,2,1,3,0,4,4,-4,-1,5,-1,0,0,0,-1,1,1,0,-1
KR_6742504157,420,-4,-3,3,-9,-7,8,1,2,1,3,-2,2,0,-3,3,0,1,1,2,0,-10,-4,-1,-5,6,-1,0,-3,-1,-1,-1,-1,6,-1
KR_6755264776,440,-3,-33,36,-13,-3,4,1,0,1,1,-2,3,1,-2,2,0,-6,7,1,0,-10,-30,3,-7,4,-1,0,-2,1,-1,-1,-1,5,-1
KR_6643438688,420,-1,-39,-27,-6,-1,2,1,0,3,3,-1,3,2,-3,4,1,-1,1,0,0,-10,100,-1,-2,3,-1,0,-2,1,-1,-1,-1,5,-1
KR_6600383819,420,-4,-58,-16,-9,1,1,2,-4,6,2,0,3,3,-5,5,0,-1,2,1,0,-19,2,0,-5,5,-2,0,-2,-1,1,-1,-1,5,-1
KR_6768472328,420,-3,-60,6,-4,-1,1,0,-3,5,2,0,3,3,1,4,5,-1,5,4,-1,-9,11,-4,-3,7,-2,0,-1,1,-1,-1,-1,5,-1
KR_6768064970,420,-2,27,-16,-11,0,1,1,-1,3,2,0,3,3,-1,3,2,-9,9,0,0,-6,1,4,-7,3,-3,0,0,-1,-1,0,-1,6,-1
KR_6757840362,420,-1,1,-16,-5,1,0,1,-1,1,0,-9,9,0,-1,3,2,5,0,5,0,0,-2,5,-9,4,2,0,0,0,-1,0,-1,0,-1
KR_6700720354,420,3,29,-7,2,0,2,2,-3,6,3,1,3,4,4,1,5,0,1,1,0,6,-2,3,-6,3,6,0,0,-1,-1,1,-1,2,-1
KR_6574032150,420,-3,-38,-11,-8,-2,2,0,1,5,6,0,4,4,-4,5,1,-3,4,1,0,-6,-13,2,-8,6,3,0,-1,-1,-1,-1,-1,6,-1
KR_6672228367,420,0,-32,-1,-2,2,1,3,-4,5,1,0,4,4,-1,3,2,1,0,1,1,3,-1,-1,-6,7,-4,0,1,1,-1,1,1,2,-1
KR_6762990641,420,-4,-27,11,-5,0,0,0,2,2,4,-1,3,2,-6,6,0,0,1,1,0,-7,-221,0,-5,5,-1,0,-1,-1,1,-1,-1,1,-1
KR_6713343359,420,-2,-80,-16,-3,-1,2,1,-1,2,1,-4,4,0,0,2,2,3,1,4,-1,2,-2,-1,-6,7,-6,0,-3,-1,1,-1,-1,2,-1
KR_6766515498,420,-3,-61,-11,-4,-1,2,1,1,3,4,-3,5,2,1,0,1,-2,2,0,0,-7,3,2,-8,6,-3,0,0,1,1,0,1,6,-1
KR_6769537513,420,2,-46,1,9,2,0,2,-1,3,2,1,3,4,4,0,4,3,0,3,0,14,3,0,-4,4,2,0,-1,1,-1,-1,1,2,-1
KR_6733441088,420,0,-31,-16,-1,2,0,2,0,3,3,-1,1,0,-3,5,2,1,0,1,0,4,-37,2,-6,4,17,0,-1,-1,1,-1,1,5,-1
KR_6740374828,420,-2,-69,2,-4,-2,2,0,3,1,4,-4,7,3,0,4,4,-1,2,1,0,2,-2,1,-5,4,-1,0,-1,-1,-1,-1,1,2,-1
KR_6718670971,420,-5,-65,-32,-6,-3,4,1,-2,4,2,-3,3,0,1,1,2,1,0,1,0,-8,-2,0,-4,4,1,0,-1,-1,-1,-1,-1,5,-1
KR_6614582083,420,1,-55,11,0,-1,1,0,2,2,4,0,3,3,-1,3,2,0,1,1,0,5,0,0,-6,6,0,0,-2,-1,-1,-1,-1,4,-1
KR_6714556921,440,-2,24,-12,-6,1,0,1,1,0,1,-7,7,0,1,3,4,-2,3,1,0,-7,27,0,-3,3,2,0,-1,-1,-1,-1,-1,2,-1
KR_6722926504,420,-3,-45,-8,-10,1,0,1,-4,4,0,-4,6,2,-3,3,0,0,0,0,0,-8,-44,-1,-6,7,24,0,-1,1,1,-1,-1,4,-1
KR_6762017797,420,-2,-60,4,2,-2,3,1,2,1,3,0,2,2,3,1,4,-1,2,1,0,2,8,2,-3,1,0,0,0,1,1,0,-1,2,-1
KR_6611637360,420,1,69,13,-3,0,2,2,-2,3,1,-3,3,0,1,1,2,1,0,1,-1,-9,0,-1,-3,4,-2,0,1,-1,1,1,-1,1,-1
KR_6679036882,420,-1,13,22,-8,1,1,2,-4,5,1,-4,4,0,0,3,3,-1,1,0,0,-12,172,-4,-6,10,-1,0,0,1,-1,0,-1,6,-1
KR_6751078791,420,0,-25,-18,-2,0,1,1,0,2,2,-1,2,1,1,0,1,-2,2,0,0,3,8,-1,-3,4,1,0,0,-1,1,0,-1,4,-1
KR_6419359305,420,-6,-91,-20,-18,1,0,1,-6,7,1,-4,8,4,-9,9,0,0,1,1,-2,-13,2,-2,-3,5,-5,0,-2,-1,1,-1,-1,5,-1
KR_6749874312,420,-3,-65,12,-3,-1,1,0,-2,4,2,-2,4,2,2,1,3,0,1,1,-2,-2,-162,1,-4,3,0,0,-2,0,-1,-1,-1,0,-1
KR_6769842282,420,-3,-41,-1,-9,-1,1,0,-3,5,2,0,1,1,-3,3,0,-2,3,1,0,-6,-353,-1,-6,7,8,0,-2,-1,-1,-1,1,4,-1
KR_6759261355,420,-3,-50,-28,-10,0,1,1,-4,5,1,-5,5,0,-3,5,2,2,0,2,0,-1,0,2,-3,1,-2,0,0,-1,1,1,-1,3,-1
KR_6597076291,420,-1,39,20,1,-2,3,1,0,3,3,1,2,3,2,1,3,0,1,1,0,1,5,2,-5,3,-2,0,-1,1,-1,-1,1,4,-1
KR_6651849639,420,-4,-35,-40,-2,-6,8,2,2,0,2,-3,4,1,2,2,4,3,0,3,1,1,0,4,-9,5,1,0,-2,-1,1,-1,-1,1,-1
KR_6694149341,440,-1,28,-4,-2,-2,6,4,-3,3,0,-1,2,1,-1,1,0,5,2,7,0,-7,8,0,-5,5,-3,0,0,-1,1,0,1,2,-1
KR_6499561749,420,-3,-2,-14,-9,-3,3,0,0,4,4,0,2,2,-4,5,1,-2,2,0,1,-4,-7,-1,-4,5,0,0,-1,-1,1,-1,1,5,-1
KR_6442784552,420,-5,-38,-33,-11,-3,3,0,-3,5,2,-5,5,0,-1,1,0,1,1,2,-1,-14,213,-2,-6,8,-2,0,-1,-1,-1,-1,-1,6,-1
KR_6768376854,420,-2,-47,-19,-2,-2,4,2,0,1,1,0,2,2,0,2,2,0,0,0,0,-5,-41,-1,-6,7,-4,0,-1,1,1,-1,1,1,-1
KR_6684870954,420,1,-29,16,1,-2,3,1,1,3,4,4,0,4,-2,2,0,0,1,1,0,0,-13,-8,-1,9,4,0,-1,1,-1,-1,-1,3,-1
KR_6765920957,440,-1,-50,-9,-9,-1,1,0,-3,7,4,-10,10,0,6,0,6,-1,2,1,0,-5,-3,-2,-2,4,-3,0,-1,-1,1,-1,1,5,-1
KR_6762451135,440,-1,-2,4,-1,-2,4,2,3,1,4,-3,4,1,1,2,3,0,0,0,0,-2,-46,-1,-3,4,3,0,0,-1,0,0,-1,3,-1
KR_6608120261,420,-2,-64,17,0,-1,1,0,0,2,2,-1,1,0,1,4,5,1,3,4,-1,1,107,-1,-2,3,-2,0,-1,-1,1,-1,-1,3,-1
KR_6457644500,420,-6,-39,-11,-11,-2,4,2,-3,4,1,0,0,0,-1,2,1,-5,7,2,0,-11,4,0,-6,6,-6,0,-1,1,1,-1,1,6,-1
KR_6473264119,420,1,8,-5,13,3,3,6,11,2,13,2,4,6,-3,4,1,0,4,4,2,11,-1,0,-6,6,4,0,3,-1,1,1,1,3,-1
KR_6753137556,420,-2,-51,9,-8,-1,1,0,-5,6,1,-1,2,1,1,2,3,-2,2,0,0,-8,-4,-1,-7,8,1,0,-1,1,-1,-1,1,1,-1
KR_6653062907,420,1,-5,21,-4,0,3,3,-3,4,1,2,0,2,-4,4,0,1,1,2,0,-8,-1,3,-4,1,-1,0,0,-1,1,1,-1,5,-1
KR_6665038726,420,-4,-63,1,-7,-5,7,2,0,0,0,2,3,5,-3,4,1,-1,1,0,0,-11,4,1,-5,4,-3,0,0,-1,1,-1,-1,4,-1
KR_6569653223,420,0,6,19,-5,-2,2,0,0,4,4,-2,3,1,-2,6,4,1,1,2,0,-8,-85,1,-4,3,0,0,0,0,-1,0,-1,0,-1
KR_6745972008,440,-2,-27,0,1,0,2,2,2,4,6,-1,3,2,0,0,0,0,0,0,0,-1,-11,0,-2,2,-1,0,-1,1,0,-1,1,5,-1
KR_6742321546,420,-5,-72,-8,-6,-3,4,1,-1,3,2,0,3,3,-1,3,2,-1,1,0,0,-8,-126,-2,-5,7,3,0,-1,-1,1,-1,-1,5,-1
KR_6681207110,420,2,-1,0,-4,-1,2,1,2,0,2,-5,9,4,1,3,4,-1,2,1,-1,-8,19,-3,-3,6,-4,0,0,1,-1,-1,-1,4,-1
KR_6764971439,420,-4,-26,-31,-5,4,2,6,-3,7,4,-1,1,0,-4,6,2,-1,1,0,-1,-14,-4,-1,-5,6,0,0,1,1,1,-1,-1,1,-1
KR_6766502203,420,0,-72,-18,-3,-1,2,1,0,5,5,1,2,3,-1,2,1,-2,3,1,0,2,-19,0,-6,6,-1,0,0,0,1,1,1,0,-1
KR_6755026152,420,-2,-25,-4,-3,-2,5,3,0,4,4,2,2,4,-4,4,0,1,0,1,0,1,-23,6,-7,1,-1,0,-1,0,0,-1,-1,0,-1
KR_6595888693,420,-2,-34,-20,-7,2,1,3,-3,5,2,-3,7,4,-3,8,5,0,2,2,0,-3,-191,-2,-3,5,-3,0,-1,-1,-1,-1,1,5,-1
KR_6767282078,420,-1,-11,-16,-2,4,0,4,-2,3,1,2,1,3,-2,3,1,-4,4,0,-1,0,4,4,-8,4,2,0,0,0,-1,0,-1,0,-1
KR_6740003115,420,-2,-37,-7,-8,0,1,1,-3,7,4,-1,4,3,-5,7,2,1,0,1,0,-12,-308,0,-5,5,13,0,-1,-1,1,-1,-1,2,-1
KR_6611751556,420,-4,-24,-12,-8,-2,3,1,1,5,6,-7,7,0,0,2,2,0,1,1,0,-6,28,-2,-4,6,-3,0,0,-1,-1,-1,1,5,-1
KR_6642733433,420,-1,-34,-53,-2,-2,2,0,-2,6,4,5,0,5,-2,2,0,-1,1,0,1,3,38,-2,-5,7,-2,0,0,-1,1,-1,1,4,-1
KR_6189431805,440,-2,-38,-26,2,0,0,0,-2,3,1,-2,3,1,4,2,6,2,0,2,1,4,9,4,-6,2,2,0,-1,-1,1,-1,1,5,-1
KR_6761546423,420,-3,-50,-23,-7,0,1,1,-5,7,2,2,4,6,-3,3,0,-1,1,0,0,-2,-44,2,-4,2,11,0,-2,1,-1,-1,1,6,-1
KR_6661327158,420,1,15,10,-2,1,0,1,-4,6,2,-2,4,2,2,0,2,1,0,1,0,2,12,5,-8,3,0,0,-1,1,-1,-1,1,4,-1
KR_6761271575,420,1,28,-29,-1,-1,5,4,-5,6,1,0,0,0,7,0,7,-2,2,0,0,2,0,3,-7,4,0,0,0,-1,-1,0,-1,1,-1
KR_6749975418,420,1,18,19,2,2,0,2,2,2,4,-1,4,3,0,1,1,-1,1,0,0,4,-212,1,-3,2,1,0,2,1,1,1,-1,2,-1
KR_6766459880,420,0,-12,4,2,-5,6,1,4,1,5,2,7,9,1,3,4,0,1,1,0,4,-1,-6,0,6,2,0,1,0,1,1,-1,0,-1
KR_6695865719,420,2,41,-24,-4,-1,2,1,1,0,1,0,5,5,-4,7,3,0,0,0,-3,-10,1,2,-5,3,4,0,1,-1,1,1,-1,6,-1
KR_6744577023,420,0,7,16,-14,2,2,4,-5,9,4,-9,9,0,-2,2,0,0,2,2,0,-23,-9,-8,-4,12,0,0,-3,1,-1,-1,-1,6,-1
KR_6769050350,420,1,34,-16,7,4,2,6,7,0,7,0,2,2,-4,5,1,0,3,3,0,9,-2,-1,-4,5,3,0,2,0,1,1,-1,0,-1
KR_6726516365,440,-3,-13,-16,-8,0,1,1,0,3,3,-1,2,1,-5,5,0,-2,7,5,-2,-9,-27,-1,-4,5,1,0,0,1,1,0,-1,2,-1
KR_6724798540,420,3,31,28,8,3,1,4,1,0,1,4,2,6,1,2,3,-1,2,1,0,5,78,1,-6,5,4,0,1,1,1,1,1,1,-1
KR_6617487669,420,-4,-30,-25,1,-1,2,1,-1,2,1,0,3,3,1,1,2,2,2,4,0,4,3,2,-7,5,-3,0,-2,1,-1,-1,-1,5,-1
KR_6769078546,420,2,25,12,4,4,0,4,2,3,5,-3,4,1,1,1,2,0,3,3,0,-4,-131,0,-3,3,-2,0,0,-1,-1,1,1,6,-1
KR_6660587524,420,-2,-1,2,-10,-6,7,1,-3,6,3,0,3,3,-1,2,1,0,2,2,0,-5,2,2,-7,5,2,0,0,1,-1,-1,-1,5,-1
KR_6761435338,420,2,39,32,-3,-1,3,2,1,2,3,1,1,2,-4,5,1,0,0,0,0,-5,1,1,-5,4,-1,0,0,0,1,0,-1,0,-1
KR_6684333321,420,-1,-40,-1,0,3,2,5,-4,6,2,2,1,3,-1,3,2,0,0,0,0,-3,-3,-2,-3,5,2,0,-1,1,-1,-1,1,6,-1
KR_6660549548,420,-6,-28,8,-16,-4,4,0,-1,2,1,0,0,0,-8,9,1,-3,3,0,0,-15,-212,-6,-2,8,0,0,-1,-1,-1,-1,-1,1,-1
KR_6745486640,420,-5,-38,-14,-4,-3,4,1,1,2,3,2,1,3,-4,4,0,0,0,0,0,-1,-102,-1,-6,7,-1,0,-2,1,-1,-1,1,1,-1
KR_6722404694,420,-1,2,-33,2,1,1,2,0,1,1,4,1,5,-4,4,0,1,0,1,0,-2,-2,-1,-3,4,1,0,0,-1,1,-1,1,1,-1
KR_6762095697,420,-1,18,-8,-5,-1,3,2,0,4,4,0,3,3,-5,7,2,1,1,2,0,-3,5,1,-7,6,2,0,0,0,-1,0,-1,0,-1
KR_6743175200,440,1,22,1,-2,-2,3,1,-3,4,1,2,2,4,-1,3,2,2,0,2,0,-5,-4,-4,-5,9,-1,0,-2,-1,-1,-1,-1,1,-1
KR_6647140656,420,-3,42,-13,-13,0,1,1,3,1,4,-4,7,3,-7,8,1,-5,5,0,-1,-22,-68,-6,-2,8,-5,0,0,-1,-1,-1,-1,1,-1
KR_6762458189,420,-4,-8,-8,0,2,1,3,-5,8,3,-3,4,1,7,0,7,-1,1,0,-2,0,-36,3,-4,1,4,0,-2,1,-1,-1,-1,1,-1
KR_6769108139,420,0,-13,-4,-2,-2,2,0,-1,4,3,1,0,1,0,6,6,0,1,1,0,2,1,-2,-4,6,0,0,-1,-1,-1,-1,1,4,-1
KR_6580282678,420,-5,-72,-3,-10,0,0,0,-2,3,1,-3,5,2,-2,2,0,-3,4,1,-2,-15,-6,5,-10,5,-9,0,-2,1,1,-1,-1,6,-1
KR_6714584496,420,3,-11,8,6,2,2,4,-3,5,2,5,2,7,2,1,3,0,1,1,0,3,1,4,-8,4,5,0,0,1,-1,0,1,4,-1
KR_6749627681,420,-2,-91,39,-6,-3,6,3,3,0,3,-1,2,1,-5,5,0,0,2,2,-1,-7,-4,-2,-3,5,-1,0,-1,0,-1,-1,-1,0,-1
KR_6708954306,420,-2,-48,-4,-7,-3,3,0,-5,5,0,-1,4,3,1,1,2,1,0,1,0,-7,-7,-1,-6,7,3,0,0,-1,-1,0,-1,2,-1
KR_6640734367,420,0,-5,-3,1,-1,3,2,0,4,4,-1,3,2,2,1,3,1,2,3,-1,-2,4,4,-9,5,-1,0,0,1,-1,-1,-1,6,-1
KR_6757117144,420,0,-6,6,-4,-3,3,0,-4,8,4,1,1,2,1,4,5,1,0,1,-2,-10,22,1,-6,5,-1,0,-1,-1,-1,-1,-1,3,-1
KR_6621651170,420,-5,-100,-12,-13,-4,6,2,-4,6,2,-2,2,0,2,1,3,-5,5,0,-1,-11,-9,-1,-3,4,0,0,0,-1,-1,0,-1,1,-1
KR_6698206718,420,2,37,8,-1,1,2,3,2,1,3,3,1,4,-5,8,3,-2,2,0,0,1,35,0,-8,8,-27,0,0,0,-1,1,-1,0,-1
KR_6707201624,440,-3,-63,-20,-13,-3,4,1,-1,1,0,-2,3,1,-6,6,0,-1,5,4,-1,-13,-31,-2,-4,6,22,0,-1,0,-1,1,-1,0,-1
KR_6734005454,420,-2,-4,4,-2,3,1,4,1,2,3,-1,3,2,-2,4,2,-3,3,0,0,2,-4,-2,-6,8,4,0,0,1,1,0,-1,5,-1
KR_6769032778,420,-6,-115,4,-17,-2,5,3,-2,3,1,-4,8,4,-5,7,2,-4,5,1,-2,-16,-11,-3,-3,6,2,0,-3,-1,1,-1,-1,6,-1
KR_6766517019,440,-1,13,8,-4,-1,1,0,0,3,3,-4,7,3,0,2,2,1,1,2,0,-6,-1,0,-5,5,-1,0,-2,-1,0,-1,-1,6,-1
KR_6751416889,420,0,-71,4,6,-2,2,0,3,1,4,1,3,4,3,1,4,1,3,4,0,13,13,0,-4,4,-1,0,1,1,0,1,1,3,-1
KR_6760165674,420,1,-78,-12,-4,-5,6,1,0,2,2,-1,3,2,2,2,4,0,0,0,-1,1,-24,-3,-1,4,4,0,0,-1,1,0,-1,2,-1
KR_6717380255,420,-4,-23,-26,-10,-8,9,1,-3,5,2,-4,5,1,4,1,5,1,0,1,0,-8,1,2,-7,5,-4,0,-2,-1,-1,-1,1,1,-1
KR_6768112180,420,2,9,-17,7,-2,2,0,3,1,4,-1,3,2,5,1,6,2,0,2,0,14,6,3,-9,6,-2,0,0,1,0,0,1,5,-1
KR_6634583717,420,-6,-51,-2,-17,0,0,0,-7,7,0,-2,4,2,-5,6,1,-3,3,0,0,-29,-18,0,-3,3,2,0,-1,-1,1,-1,1,1,-1
KR_6729357866,420,-2,21,-21,-5,-2,3,1,0,3,3,0,2,2,2,3,5,-5,5,0,2,-7,-242,2,-6,4,7,0,0,-1,-1,0,1,6,-1
KR_6422874370,420,2,4,34,6,-2,3,1,0,2,2,5,1,6,2,1,3,1,0,1,0,11,0,3,-5,2,1,0,0,1,0,0,-1,2,-1
KR_6694565407,440,1,2,0,-3,0,3,3,0,1,1,0,0,0,0,2,2,-3,3,0,0,-3,52,4,-6,2,-28,0,0,-1,-1,0,1,4,-1
KR_6762191620,420,-2,-62,-11,-8,-6,6,0,-2,5,3,3,1,4,-2,4,2,-1,3,2,0,-5,-9,-2,-3,5,1,0,-1,-1,-1,-1,-1,5,-1
KR_6752599840,420,-1,17,-20,-4,1,1,2,1,1,2,-5,6,1,2,3,5,-3,3,0,0,-9,-24,-1,-6,7,-4,0,-1,-1,-1,-1,-1,6,-1
KR_6615570185,420,2,23,14,4,1,1,2,2,2,4,-2,4,2,4,3,7,-1,1,0,1,10,3,-1,-4,5,2,0,-1,1,-1,-1,1,1,-1
KR_6647217112,440,-5,-65,21,-10,0,2,2,-3,6,3,-3,3,0,-1,1,0,-3,4,1,-1,-9,-8,-5,0,5,2,0,-1,-1,-1,-1,-1,2,-1
KR_6633056242,420,-1,38,0,0,2,2,4,1,1,2,-2,2,0,0,1,1,-1,2,1,0,1,-5,-8,-1,9,2,0,1,0,-1,1,1,0,-1
KR_6755254098,440,-4,-64,-8,-1,0,3,3,-2,3,1,-1,3,2,-1,4,3,3,1,4,0,0,40,0,-5,5,2,0,0,1,1,-1,-1,2,-1
KR_6685036449,420,-3,7,-32,-2,-1,2,1,2,4,6,-1,3,2,0,3,3,-2,2,0,0,-3,-7,1,-4,3,2,0,0,0,-1,0,1,0,-1
KR_6486772418,420,-2,-38,-29,-5,-3,4,1,-2,5,3,2,1,3,1,2,3,-3,3,0,-3,-6,-11,-7,-3,10,0,0,-1,-1,-1,-1,-1,3,-1
KR_6768634190,420,2,18,31,0,0,0,0,1,3,4,2,1,3,-3,3,0,0,1,1,0,-5,7,-2,-5,7,1,0,0,1,-1,-1,-1,4,-1
KR_6768682459,420,1,-28,18,-4,0,2,2,1,3,4,-2,4,2,-4,4,0,1,0,1,0,-6,-4,-3,-1,4,4,0,0,-1,-1,-1,-1,3,-1
KR_6636688746,420,0,13,8,-3,0,0,0,1,3,4,1,2,3,-5,5,0,0,1,1,0,-5,6,-1,-4,5,-6,0,0,1,-1,0,-1,2,-1
KR_6767902136,420,-2,14,-16,-5,-4,4,0,1,1,2,3,1,4,-4,4,0,-1,1,0,0,-4,-5,2,-5,3,-3,0,0,-1,1,-1,-1,1,-1
KR_6674980109,440,0,-9,29,-9,-9,11,2,-2,2,0,5,1,6,-1,2,1,-2,4,2,-1,-11,-10,-5,-3,8,1,0,-1,0,0,-1,-1,0,-1
KR_6768938954,420,3,27,11,-2,-1,2,1,1,2,3,-1,3,2,-2,2,0,1,1,2,1,-8,32,1,-6,5,0,0,0,1,1,0,1,4,-1
KR_6733804343,420,-2,-116,-15,-3,-1,3,2,-1,3,2,0,2,2,-2,3,1,1,1,2,0,2,-22,2,-4,2,9,0,-3,-1,1,-1,1,1,-1
KR_6741296641,420,3,61,4,1,-2,3,1,4,1,5,4,1,5,-3,6,3,-2,3,1,0,-3,0,-3,-8,11,3,0,2,1,1,1,1,5,-1
KR_6753959065,420,2,21,1,2,-5,5,0,0,1,1,0,3,3,3,1,4,4,0,4,0,-1,112,-2,-3,5,-1,0,2,1,-1,1,1,4,-1
KR_6721942894,420,-3,-13,-8,-3,-1,2,1,-7,7,0,2,0,2,0,1,1,3,0,3,0,-3,-31,-1,-4,5,12,0,-1,0,-1,-1,1,0,-1
KR_6733020954,420,-3,-10,-17,-5,-7,8,1,0,2,2,-3,3,0,4,0,4,1,0,1,0,5,2,-2,-4,6,6,0,-2,0,-1,-1,-1,0,-1
KR_6761335964,420,0,3,-40,1,2,0,2,-3,5,2,-2,2,0,2,1,3,2,1,3,1,3,-10,4,-6,2,-3,0,2,-1,-1,1,1,2,-1
KR_6650797174,420,-1,-42,24,-5,3,0,3,-1,2,1,-8,9,1,1,3,4,0,0,0,0,-12,-2,-4,-3,7,-3,0,0,-1,-1,-1,-1,5,-1
KR_6745843005,440,0,-85,8,0,1,1,2,-1,4,3,1,1,2,2,3,5,-3,4,1,0,1,16,-1,-3,4,-1,0,-1,0,0,-1,1,0,-1
KR_6725676710,420,2,22,-10,6,-2,3,1,10,0,10,2,5,7,-4,7,3,0,1,1,-1,8,1,5,-7,2,-1,0,1,-1,1,1,-1,2,-1
KR_6749585385,420,-1,-31,-40,3,1,2,3,-2,2,0,5,0,5,-1,3,2,0,0,0,0,2,18,3,-7,4,-4,0,0,-1,-1,0,1,4,-1
KR_6765764361,420,2,19,2,3,-1,3,2,-1,5,4,-3,3,0,8,1,9,0,1,1,0,9,2,0,-6,6,-1,0,0,0,-1,1,1,0,-1
KR_6741983237,440,0,-46,-13,2,1,3,4,-4,6,2,4,2,6,0,3,3,1,1,2,0,-3,2,-5,-3,8,-3,0,0,-1,-1,0,-1,2,-1
KR_6738010511,420,-2,34,-40,-3,-6,6,0,-1,3,2,-1,4,3,7,2,9,-2,4,2,1,4,7,2,-3,1,4,0,1,-1,-1,1,1,1,-1
KR_6767758190,420,-1,-27,-12,-3,1,1,2,2,2,4,-3,3,0,-2,3,1,-1,4,3,0,1,-25,-3,-2,5,-2,0,1,-1,1,1,1,4,-1
KR_6747584388,420,-1,-78,16,-4,1,0,1,-2,3,1,0,3,3,0,3,3,-3,3,0,0,-6,36,0,-5,5,-2,0,0,-1,1,-1,-1,6,-1
KR_6749428799,420,0,-49,19,3,-4,4,0,4,1,5,-3,4,1,2,0,2,4,1,5,0,5,9,0,-3,3,-1,0,0,1,1,1,1,2,-1
KR_6196345913,440,-4,-13,12,-10,-3,3,0,-2,2,0,-3,5,2,-2,4,2,0,0,0,0,-12,3,0,-8,8,-1,0,-1,-1,1,-1,-1,1,-1
KR_6766032198,420,0,-53,12,4,1,1,2,-3,4,1,-2,4,2,6,2,8,2,0,2,0,7,7,4,-10,6,0,0,2,1,-1,1,1,3,-1
KR_6686527405,420,2,43,38,0,-2,3,1,4,2,6,2,2,4,0,2,2,-4,4,0,-1,-4,-6,-3,-3,6,-2,0,0,-1,-1,1,-1,5,-1
KR_6749282812,420,3,10,32,1,4,0,4,-4,10,6,1,4,5,0,5,5,0,0,0,-1,1,-14,0,-5,5,0,0,0,-1,-1,0,1,2,-1
KR_6759576555,420,1,59,-24,7,-1,1,0,2,0,2,2,2,4,4,3,7,0,1,1,0,7,-110,-3,-2,5,4,0,0,0,1,0,1,0,-1
KR_6736505742,440,1,14,12,4,1,2,3,1,1,2,5,1,6,-1,1,0,-2,6,4,-1,6,18,4,-7,3,-5,0,-1,1,-1,-1,-1,4,-1
KR_6744079037,420,-1,-17,-12,-4,2,1,3,-2,5,3,-3,3,0,-1,1,0,0,0,0,0,-4,-53,-5,-2,7,17,0,0,-1,-1,0,1,4,-1
KR_6757849138,420,-1,6,-2,5,1,2,3,6,1,7,-1,3,2,-1,3,2,0,1,1,0,2,6,0,-7,7,3,0,-1,0,-1,-1,-1,0,-1
KR_6765049248,420,1,1,-1,4,6,0,6,3,0,3,-4,6,2,-2,5,3,1,0,1,0,2,39,3,-5,2,-10,0,1,1,-1,1,-1,3,-1
KR_6751366726,420,-2,-32,4,-5,-6,7,1,-3,7,4,3,4,7,3,0,3,-2,3,1,0,-8,20,2,-4,2,0,0,-1,1,1,-1,-1,1,-1
KR_6725917545,420,-4,-97,4,-1,-2,2,0,0,0,0,3,0,3,-3,3,0,1,0,1,0,-1,-4,-4,-3,7,-1,0,-1,-1,-1,-1,1,1,-1
KR_6608291230,420,-1,-9,-8,-5,-1,2,1,2,2,4,0,0,0,-5,6,1,-1,2,1,0,-1,-17,-2,-5,7,6,0,-1,-1,-1,-1,-1,6,-1
KR_6759021024,420,0,-15,19,-6,3,1,4,2,2,4,-3,4,1,-3,6,3,-5,5,0,0,-15,4,0,-6,6,-1,0,-2,-1,-1,-1,1,3,-1
KR_6651252640,420,-2,-4,-5,-5,-2,2,0,-6,8,2,2,2,4,-1,1,0,2,3,5,-1,-7,9,3,-7,4,-5,0,0,-1,0,0,-1,4,-1
KR_6523425189,420,2,29,12,2,2,1,3,2,0,2,2,1,3,-4,4,0,0,0,0,-1,-5,146,1,-8,7,-5,0,0,1,-1,0,-1,6,-1
KR_6762430369,420,-4,-44,-45,-5,-4,6,2,-2,3,1,-2,4,2,1,3,4,2,2,4,-1,-4,-1,4,-9,5,-1,0,-2,-1,-1,-1,-1,3,-1
KR_6662981286,420,-2,24,-23,-3,1,3,4,-2,4,2,-1,3,2,0,1,1,-1,5,4,0,4,-7,1,-6,5,0,0,0,1,-1,-1,-1,1,-1
KR_6730742219,440,-1,34,5,-4,0,1,1,3,3,6,-4,4,0,-2,5,3,-1,1,0,-1,-6,24,-2,-2,4,5,0,1,-1,1,1,-1,5,-1
KR_6759638104,420,0,5,12,2,3,1,4,0,3,3,1,1,2,-1,2,1,-1,1,0,0,3,-60,-5,-2,7,21,0,0,1,-1,-1,-1,1,-1
KR_6696840048,420,-3,6,-27,-5,2,0,2,-5,7,2,3,2,5,-3,6,3,-2,2,0,1,-11,3,2,-6,4,0,0,-3,1,1,-1,1,2,-1
KR_6767837464,420,-4,-75,0,-10,-5,5,0,-3,4,1,-1,3,2,0,1,1,-1,1,0,0,-9,-5,-3,-3,6,1,0,-1,1,1,-1,-1,3,-1
KR_6758126473,420,-1,23,-16,3,-1,2,1,3,3,6,1,2,3,3,0,3,-3,3,0,-1,-2,-5,0,-3,3,-1,0,-2,-1,-1,-1,1,6,-1
KR_6573966327,420,-1,3,4,2,3,1,4,-2,4,2,0,3,3,1,1,2,0,1,1,0,-8,139,3,-6,3,0,0,0,-1,1,0,1,3,-1
KR_6677753315,420,0,17,-15,-3,-7,7,0,1,0,1,1,2,3,3,3,6,-1,1,0,0,-3,-2,-1,-6,7,0,0,-1,-1,-1,-1,1,4,-1
KR_6768763519,440,-1,-46,16,-3,0,1,1,-2,3,1,4,4,8,-2,2,0,-3,5,2,0,-5,25,0,-3,3,2,0,0,1,1,-1,1,3,-1
KR_6716161236,420,0,33,11,6,1,3,4,3,0,3,4,1,5,-2,3,1,0,1,1,0,3,0,0,-3,3,2,0,0,1,0,0,-1,3,-1
KR_6701923054,440,-9,-113,-27,-20,-6,6,0,-2,6,4,-3,7,4,-7,7,0,-2,2,0,0,-20,3,0,-5,5,-2,0,-1,-1,1,-1,1,5,-1
KR_6759109123,420,0,-6,-28,3,-6,6,0,6,0,6,0,1,1,3,2,5,0,1,1,1,11,-22,3,-8,5,1,0,-1,1,-1,1,1,2,-1
KR_6719516071,420,1,9,15,3,2,1,3,2,3,5,1,2,3,-2,3,1,0,0,0,-1,-6,230,2,-6,4,-1,0,-1,1,1,-1,-1,5,-1
KR_6760133802,420,-1,-109,-28,1,0,3,3,3,5,8,-2,3,1,0,7,7,0,1,1,0,8,119,-2,-7,9,-3,0,-2,1,-1,1,1,2,-1
KR_6769776603,420,-2,12,-20,-11,-1,3,2,-4,4,0,-1,7,6,-2,3,1,-3,5,2,0,-15,-1,2,-6,4,-2,0,-1,-1,-1,-1,1,3,-1
KR_6350119386,420,-3,-1,-24,-5,-2,3,1,-3,4,1,2,1,3,-4,4,0,2,0,2,0,-9,11,-5,-3,8,5,0,-1,1,-1,-1,1,4,-1
KR_6429939497,420,2,1,79,1,-3,3,0,0,0,0,-1,3,2,2,2,4,3,0,3,0,3,2,5,-7,2,0,0,0,1,1,0,-1,4,-1
KR_6769525445,420,-5,-72,-28,-18,-4,4,0,-2,5,3,-2,5,3,-12,12,0,2,0,2,0,-16,-3,-1,-2,3,3,0,-2,1,1,-1,1,5,-1
KR_6674408914,420,0,2,-16,-3,-2,2,0,1,1,2,1,3,4,-1,4,3,-2,3,1,0,-2,-107,-1,-3,4,-2,0,0,1,-1,-1,1,3,-1
KR_6711359699,420,-1,11,-46,-4,-1,3,2,3,1,4,-5,7,2,-2,3,1,1,2,3,0,-6,-14,-5,-2,7,-1,0,0,-1,-1,-1,-1,1,-1
KR_6683396736,440,-2,36,-5,-8,3,0,3,-5,6,1,-4,5,1,-2,2,0,0,0,0,-1,0,5,5,-6,1,-4,0,-1,0,-1,-1,-1,0,-1
KR_6667089616,420,0,-39,29,-6,-2,3,1,0,2,2,-2,4,2,-2,4,2,0,1,1,0,-5,12,-1,-5,6,-4,0,-1,1,1,-1,-1,3,-1
KR_6611994898,420,-1,-34,31,-4,2,1,3,0,6,6,-2,3,1,-2,5,3,-2,6,4,-1,-6,-112,-2,-4,6,-5,0,-2,1,-1,-1,-1,5,-1
KR_6745375066,440,1,83,3,1,2,1,3,-4,7,3,5,2,7,-1,4,3,-1,3,2,-1,-7,-2,-4,0,4,-1,0,1,-1,1,1,1,1,-1
KR_6747910621,440,0,25,6,-1,4,4,8,-2,2,0,-1,2,1,-1,1,0,-1,2,1,0,-3,-9,-3,-2,5,3,0,0,1,-1,0,1,2,-1
KR_6766641182,440,-1,16,-12,-6,-3,3,0,-5,6,1,-1,1,0,4,1,5,-1,1,0,0,-5,14,2,-4,2,2,0,0,1,-1,0,-1,4,-1
KR_6763065969,420,-4,-21,8,-11,-1,2,1,-9,11,2,-3,3,0,0,3,3,2,0,2,-1,-17,0,-2,-4,6,1,0,-1,1,-1,-1,-1,4,-1
KR_6749269240,420,1,-30,-12,-3,1,2,3,3,2,5,3,2,5,-11,12,1,1,1,2,0,-2,7,1,-3,2,-5,0,0,-1,-1,-1,-1,3,-1
KR_6730685038,440,1,-24,4,5,1,0,1,1,3,4,0,1,1,-1,1,0,4,0,4,1,3,-92,0,-4,4,2,0,1,-1,1,1,1,5,-1
KR_6627345563,420,0,45,-16,-4,4,1,5,1,1,2,-7,8,1,-2,3,1,0,0,0,0,-15,-165,-4,-3,7,3,0,0,-1,-1,-1,1,2,-1
KR_6718062622,420,1,-16,17,-5,-4,5,1,0,3,3,-4,5,1,1,1,2,2,2,4,-1,-5,-3,1,-3,2,-2,0,0,-1,-1,-1,-1,1,-1
KR_6763302221,420,-1,-51,12,-8,-2,3,1,-3,9,6,-3,4,1,2,1,3,-2,3,1,0,-3,83,-1,-5,6,4,0,0,1,1,-1,1,5,-1
KR_6746405587,420,1,-7,-6,1,-1,1,0,2,2,4,0,0,0,1,1,2,-1,1,0,0,6,158,-8,-2,10,-22,0,0,1,-1,0,-1,4,-1
KR_6647150529,440,2,58,9,1,-3,5,2,2,0,2,-3,4,1,4,3,7,1,1,2,1,6,-8,0,-3,3,-2,0,0,1,1,0,1,6,-1
KR_6768069877,420,3,17,8,5,2,1,3,-3,5,2,1,1,2,4,0,4,1,0,1,0,7,-8,-2,-5,7,3,0,-1,1,-1,-1,1,3,-1
KR_6759956032,420,2,0,16,0,4,1,5,2,1,3,0,1,1,-3,5,2,-3,5,2,1,-4,-5,0,-3,3,-1,0,1,-1,1,-1,1,5,-1
KR_6758798855,420,3,65,-19,6,-3,7,4,-2,2,0,1,1,2,2,3,5,8,1,9,0,-3,-7,1,-2,1,4,0,-1,-1,-1,1,-1,3,-1
KR_6627903813,420,-4,29,-19,-6,-6,6,0,6,2,8,-3,3,0,-2,4,2,-1,1,0,-1,-5,-3,2,-5,3,-3,0,0,-1,-1,-1,-1,1,-1
KR_5739180523,420,-2,53,3,3,7,0,7,1,7,8,-7,11,4,0,2,2,2,2,4,1,-8,2,7,-11,4,1,0,0,-1,1,1,1,1,-1
KR_6756207784,420,-4,-57,-8,-1,-4,5,1,2,4,6,-2,3,1,0,2,2,3,0,3,2,7,-42,4,-5,1,18,0,-2,-1,1,-1,1,1,-1
KR_6758935751,420,0,15,0,-3,-2,3,1,1,1,2,2,0,2,-3,6,3,-1,1,0,0,-9,0,-4,-2,6,0,0,0,-1,-1,0,1,5,-1
KR_6749839387,420,0,15,16,0,-1,2,1,0,3,3,3,1,4,-3,7,4,1,1,2,0,1,32,4,-6,2,-15,0,0,-1,1,1,1,3,-1
KR_6678761050,420,0,-29,4,-1,-3,5,2,1,4,5,-1,3,2,-2,4,2,4,0,4,-1,0,-3,-3,-6,9,5,0,0,-1,0,-1,-1,5,-1
KR_6761193298,420,-4,-31,-16,-8,-2,2,0,-3,4,1,-2,3,1,-2,3,1,1,0,1,0,-9,6,-1,-6,7,-7,0,0,-1,1,-1,1,2,-1
KR_6731351403,420,-1,-2,-7,-7,1,0,1,-4,4,0,0,3,3,0,1,1,-4,4,0,0,-8,12,-3,-4,7,-4,0,-1,-1,-1,-1,-1,5,-1
KR_6757611569,420,-3,-56,16,-9,-4,4,0,-1,1,0,-2,3,1,-4,4,0,2,1,3,-1,-13,-9,0,-5,5,-6,0,-2,-1,-1,-1,-1,3,-1
KR_6763336870,420,-2,-18,-3,-2,2,0,2,-2,2,0,3,2,5,-4,5,1,-1,1,0,0,-2,8,-2,-5,7,-1,0,0,-1,-1,0,-1,3,-1
KR_6708810579,420,-1,-38,3,-6,0,2,2,1,0,1,-2,6,4,-4,4,0,-1,2,1,0,-12,20,0,-6,6,-5,0,-1,-1,-1,-1,-1,6,-1
KR_6606053049,420,0,-28,5,-4,-5,6,1,0,2,2,1,2,3,-2,2,0,2,1,3,0,-5,2,-1,-4,5,0,0,1,1,-1,-1,-1,5,-1
KR_6762676718,420,-2,-1,32,-8,0,1,1,0,3,3,0,2,2,-5,5,0,-3,3,0,-1,-18,9,0,-5,5,-1,0,0,-1,1,-1,-1,3,-1
KR_6759725518,420,-1,-25,0,-7,1,0,1,-4,5,1,3,1,4,-3,6,3,-4,5,1,-2,-12,-3,3,-7,4,-1,0,-1,-1,0,-1,-1,1,-1
KR_6660524823,420,-5,-86,-3,-10,-6,6,0,3,2,5,-5,9,4,-1,5,4,-1,3,2,-1,-11,-5,0,-5,5,3,0,-1,1,-1,-1,-1,6,-1
KR_6677880521,420,-3,-75,-1,-3,0,2,2,-3,8,5,-1,3,2,1,1,2,0,0,0,0,1,-19,3,-5,2,15,0,-1,-1,-1,-1,-1,6,-1
KR_6733301492,420,0,-16,17,-7,1,2,3,1,3,4,-3,4,1,-5,6,1,-1,2,1,0,-9,288,1,-6,5,-3,0,-1,1,1,-1,1,2,-1
KR_6761945165,440,-2,-60,16,-8,-5,6,1,-4,6,2,1,2,3,-2,2,0,2,1,3,-3,-20,5,-1,-1,2,0,0,-2,0,-1,-1,-1,0,-1
KR_6763984249,420,-3,-20,-37,-11,1,2,3,0,1,1,-9,9,0,-2,3,1,-1,1,0,-1,-12,-49,0,-3,3,27,0,0,-1,-1,0,-1,4,-1
KR_6584770296,420,1,32,-8,-1,-1,1,0,-1,1,0,2,3,5,-1,4,3,0,2,2,-1,-4,-4,-2,-2,4,-2,0,1,-1,1,1,-1,5,-1
KR_6714496891,420,-1,26,-18,2,1,2,3,1,4,5,-7,7,0,6,3,9,1,1,2,-1,6,2,0,-5,5,4,0,1,1,1,1,-1,3,-1
KR_6764389655,420,-5,-40,-13,-8,-3,4,1,1,1,2,-1,1,0,-4,5,1,-1,1,0,0,-5,-58,0,-6,6,2,0,-1,1,-1,-1,-1,3,-1
KR_6766428119,420,-6,-47,-41,-17,-8,8,0,-2,4,2,-1,4,3,-2,2,0,-4,4,0,-1,-3,55,1,-8,7,-14,0,-1,-1,-1,-1,-1,6,-1
KR_6754105836,420,0,47,17,8,0,1,1,-5,5,0,7,0,7,4,1,5,2,0,2,1,1,10,0,-2,2,-2,0,0,-1,1,1,1,4,-1
KR_6763121982,440,-3,-77,4,3,-6,7,1,-1,2,1,6,3,9,2,1,3,2,2,4,2,17,21,2,-6,4,-2,0,1,1,1,1,1,2,-1
KR_6632135681,420,2,-13,27,4,3,1,4,6,2,8,-1,4,3,-7,7,0,3,0,3,0,-4,15,4,-10,6,-3,0,2,-1,1,1,1,1,-1
KR_6723199905,420,-2,-20,-11,-1,1,0,1,2,2,4,4,2,6,-5,6,1,-3,4,1,0,-11,2,3,-5,2,-1,0,0,-1,1,-1,1,1,-1
KR_6707622001,440,1,43,-20,0,1,4,5,-1,2,1,-4,7,3,3,1,4,1,0,1,1,-2,-5,1,-4,3,-2,0,-1,1,-1,-1,1,4,-1
KR_6728119657,420,-2,-52,-18,-8,-2,3,1,-2,4,2,1,2,3,-6,6,0,1,0,1,0,-4,20,-3,-2,5,0,0,1,-1,1,-1,-1,4,-1
KR_6617579343,420,-4,-74,4,-4,-6,6,0,2,4,6,0,1,1,-4,5,1,4,0,4,1,-1,0,-1,-3,4,-5,0,-2,-1,-1,-1,1,2,-1
KR_6764671299,420,-1,53,6,-4,1,0,1,-2,5,3,-2,4,2,-2,8,6,1,0,1,1,-7,12,4,-7,3,-3,0,2,0,1,1,1,0,-1
KR_6769337200,420,1,19,20,-2,-6,6,0,1,1,2,2,3,5,1,3,4,0,1,1,0,0,8,1,-8,7,-1,0,2,-1,-1,1,1,3,-1
KR_6769739704,420,-6,-9,-8,-14,-2,2,0,-5,6,1,-5,7,2,-2,2,0,0,1,1,0,-12,7,1,-5,4,-10,0,-1,-1,-1,-1,-1,1,-1
KR_6685397861,420,-2,-2,-4,-10,-7,8,1,2,2,4,-2,4,2,-3,5,2,0,1,1,-4,-19,-32,-3,-6,9,-2,0,-2,-1,-1,-1,-1,1,-1
KR_6716162225,420,-2,5,13,-2,0,0,0,-5,7,2,4,0,4,-2,4,2,1,0,1,0,1,-26,3,-6,3,20,0,0,1,-1,-1,-1,1,-1
KR_6429478641,420,3,1,0,9,2,0,2,4,1,5,3,1,4,2,0,2,-2,4,2,0,4,25,0,-4,4,0,0,0,0,-1,1,1,0,-1
KR_6741161504,420,-3,32,3,0,2,1,3,3,3,6,0,1,1,-3,7,4,-2,3,1,1,2,-165,0,-7,7,-1,0,-2,-1,-1,-1,1,1,-1
KR_6764407211,420,-2,-36,-12,-4,-2,2,0,3,4,7,-1,2,1,-6,9,3,2,1,3,0,-1,24,-4,-2,6,-23,0,-1,-1,1,-1,1,3,-1
KR_6684861592,420,0,-22,-39,-3,4,0,4,1,2,3,-3,4,1,-2,3,1,-3,3,0,0,0,-1,-2,-5,7,-4,0,-1,-1,1,1,-1,2,-1
KR_6768169754,420,2,-67,-8,7,4,0,4,1,2,3,-1,2,1,1,1,2,2,0,2,0,11,-14,-2,-1,3,0,0,-2,-1,1,-1,1,2,-1
KR_6718528101,420,-5,-104,4,-10,-4,4,0,-4,10,6,1,0,1,-4,4,0,1,1,2,-1,-15,0,-1,-2,3,0,0,-3,-1,-1,-1,-1,3,-1
KR_6726955955,420,2,-46,-2,4,-4,5,1,4,0,4,5,1,6,1,2,3,-2,2,0,0,9,-3,0,-7,7,-2,0,-2,-1,-1,-1,1,3,-1
KR_6638232004,420,-4,-20,-36,-13,0,3,3,-3,7,4,-3,3,0,-5,6,1,-2,5,3,0,-11,-22,-4,-2,6,-1,0,0,-1,-1,-1,-1,1,-1
KR_6554517638,420,3,-26,22,1,-1,2,1,1,3,4,0,0,0,2,1,3,-1,1,0,0,5,142,1,-5,4,4,0,1,-1,-1,1,-1,6,-1
KR_6640534766,420,1,-39,-15,2,0,2,2,0,3,3,-1,2,1,1,2,3,2,0,2,0,3,-2,-1,-5,6,-2,0,-1,1,-1,-1,-1,1,-1
KR_6757610008,420,-6,-60,-44,-14,1,2,3,-8,8,0,-4,4,0,-3,4,1,0,2,2,2,-5,22,4,-6,2,-2,0,-1,-1,-1,-1,1,4,-1
KR_6752041209,420,4,23,22,6,3,2,5,2,4,6,0,3,3,-1,2,1,2,0,2,0,-4,-2,0,-3,3,3,0,1,1,1,1,1,3,-1
KR_6768265779,420,-3,-19,-12,-3,-2,5,3,-4,7,3,1,3,4,1,1,2,1,1,2,0,-3,107,-3,-4,7,1,0,-2,1,-1,-1,-1,2,-1
KR_6731196281,440,-1,-2,39,-2,-1,2,1,2,2,4,-3,5,2,1,2,3,-1,1,0,0,-10,4,2,-5,3,0,0,1,1,-1,1,-1,5,-1
KR_6768156342,420,0,-7,-20,2,-3,3,0,1,1,2,1,0,1,1,0,1,2,0,2,0,2,9,-4,-1,5,1,0,-1,-1,-1,-1,1,1,-1
KR_6753433094,420,-2,4,28,-9,1,1,2,-3,4,1,-7,7,0,1,0,1,-1,4,3,0,-5,2,0,-5,5,-1,0,0,1,-1,0,1,5,-1
KR_6625931271,420,-6,-30,-24,-11,-2,5,3,0,3,3,-4,7,3,-3,5,2,-2,2,0,0,-12,-3,0,-5,5,-1,0,-1,1,-1,-1,1,3,-1
KR_6769754041,420,1,8,-9,-1,0,2,2,-4,4,0,-2,6,4,2,0,2,3,2,5,0,-6,16,-1,-5,6,-3,0,3,-1,1,1,1,1,-1
KR_6764142593,420,0,-21,15,-2,-2,3,1,3,4,7,2,1,3,-3,4,1,-2,5,3,-1,8,133,3,-7,4,-3,0,0,-1,1,-1,-1,5,-1
KR_6688371592,420,0,42,12,7,4,1,5,4,0,4,0,2,2,2,6,8,-3,4,1,1,5,7,1,-4,3,0,0,3,0,0,1,-1,0,-1
KR_6669837938,420,-2,-31,-19,-4,-1,1,0,0,4,4,-3,5,2,0,3,3,0,4,4,0,6,6,0,-3,3,-1,0,0,-1,1,-1,-1,2,-1
KR_6735889720,420,-1,-11,-16,-3,-1,1,0,1,4,5,-4,5,1,-2,7,5,3,2,5,0,-2,-8,-6,-6,12,3,0,-1,-1,-1,-1,-1,2,-1
KR_6766797068,420,-3,-72,11,-1,-2,3,1,-2,4,2,1,3,4,1,3,4,1,3,4,0,7,-45,1,-4,3,18,0,-1,0,1,-1,1,0,-1
KR_6698508729,440,-3,-19,8,-2,1,0,1,1,3,4,0,2,2,-4,4,0,0,2,2,0,-2,-7,2,-6,4,-2,0,0,0,1,-1,-1,0,-1
KR_6700846681,420,-1,-51,-36,5,-4,5,1,1,0,1,0,4,4,5,2,7,3,0,3,0,15,-2,0,-5,5,-6,0,0,-1,-1,-1,-1,3,-1
KR_6769117272,420,-7,-114,-4,-13,-2,3,1,-4,4,0,-6,6,0,-3,4,1,2,1,3,0,-8,0,-1,-3,4,-2,0,-2,-1,0,-1,-1,4,-1
KR_6755926474,420,-1,28,16,-1,0,1,1,-2,3,1,3,2,5,1,2,3,-3,5,2,2,-9,-20,-1,-4,5,-3,0,-3,-1,1,-1,-1,5,-1
KR_6752780705,420,-2,-41,24,-10,-1,1,0,-3,5,2,-2,2,0,-4,5,1,0,2,2,0,-16,22,-5,-1,6,1,0,-1,-1,1,-1,-1,4,-1
KR_6664513899,420,-1,-47,-20,0,-1,3,2,3,3,6,4,0,4,-7,10,3,1,1,2,1,8,76,1,-7,6,-1,0,0,1,-1,-1,1,4,-1
KR_6675010210,440,-2,-87,-5,-12,1,1,2,-5,9,4,0,2,2,-7,7,0,-1,3,2,-2,-14,-11,-7,-3,10,2,0,-1,-1,1,-1,-1,1,-1
KR_6766932207,420,-1,-21,-13,0,2,1,3,-5,5,0,0,2,2,2,1,3,1,0,1,1,0,0,1,-7,6,1,0,0,-1,-1,-1,-1,1,-1
KR_6765365792,440,-2,-51,-22,-4,1,1,2,2,2,4,-7,7,0,0,1,1,0,0,0,0,0,13,3,-6,3,-2,0,0,1,1,0,-1,2,-1
KR_6685751694,420,-2,2,-9,-2,-1,2,1,1,1,2,8,1,9,-9,9,0,-1,1,0,0,-2,1,0,-2,2,4,0,-1,1,-1,-1,1,6,-1
KR_6641636019,420,-2,4,8,-5,1,0,1,-4,5,1,1,1,2,-4,4,0,1,0,1,0,-12,20,1,-6,5,-3,0,-2,-1,-1,-1,-1,4,-1
KR_6660997154,440,-1,23,-2,-4,0,0,0,-4,5,1,-1,1,0,1,0,1,0,0,0,-1,-1,6,-1,-6,7,-2,0,0,1,-1,0,-1,1,-1
KR_6704810826,420,-2,-58,-36,4,0,1,1,1,2,3,3,0,3,0,1,1,0,1,1,0,10,-4,3,-8,5,2,0,-1,-1,-1,-1,1,6,-1
KR_6769570246,440,4,67,36,16,-1,2,1,-4,4,0,7,1,8,7,0,7,7,1,8,0,6,3,1,-4,3,-1,0,0,1,0,1,1,4,-1
KR_6664847769,420,-12,-86,-81,-4,4,0,4,-1,1,0,-1,1,0,-2,4,2,-4,6,2,-1,-7,5,-1,-4,5,-4,0,-4,-1,-1,-1,-1,2,-1
KR_6670349457,420,-4,-25,-15,-9,-2,2,0,3,5,8,-8,10,2,-2,3,1,0,0,0,0,-7,-5,0,-4,4,1,0,-1,-1,-1,-1,1,4,-1
KR_6764372977,420,0,4,-8,-1,-2,2,0,1,2,3,0,0,0,-1,5,4,1,0,1,-1,2,37,-1,-6,7,0,0,0,1,-1,-1,-1,6,-1
KR_6746593664,420,2,-7,11,-9,0,2,2,-2,3,1,-1,3,2,-5,6,1,-1,1,0,-2,-12,-13,-1,-3,4,0,0,0,1,-1,0,-1,3,-1
KR_6765422152,440,-1,-36,16,-3,-2,3,1,-2,2,0,3,3,6,0,3,3,-2,5,3,2,1,-6,0,-2,2,2,0,0,0,0,-1,1,0,-1
KR_6744201505,420,1,51,-11,1,-1,1,0,2,3,5,2,1,3,-2,2,0,0,0,0,0,5,0,5,-7,2,-6,0,0,1,-1,0,1,5,-1
KR_6709674531,420,-4,-74,12,-8,-1,2,1,-1,2,1,-4,5,1,2,2,4,-4,6,2,0,-7,-2,-2,-4,6,-2,0,-1,-1,-1,-1,-1,1,-1
KR_6627975625,440,-1,-46,-11,-4,2,1,3,-5,8,3,-1,4,3,1,2,3,-1,1,0,-1,-8,-18,3,-5,2,-3,0,0,0,1,0,-1,0,-1
KR_6760749343,420,-1,-58,-12,1,-3,4,1,0,2,2,2,3,5,4,3,7,-2,4,2,0,5,-5,-1,-5,6,2,0,-1,-1,1,-1,1,6,-1
KR_6759649133,420,1,7,33,-5,4,0,4,2,0,2,-7,8,1,-4,5,1,0,1,1,0,-6,2,7,-10,3,2,0,-1,1,1,-1,1,4,-1
KR_6762692814,420,-5,-97,-32,-7,-3,5,2,-3,7,4,-1,1,0,-2,6,4,2,0,2,0,-6,0,-1,-4,5,-4,0,-1,1,-1,-1,1,6,-1
KR_6769454548,420,-5,-37,-66,-16,-3,3,0,-3,4,1,-2,4,2,-3,6,3,-5,7,2,0,-9,1,5,-11,6,-5,0,-3,-1,-1,-1,-1,3,-1
KR_6764894634,420,1,-43,12,6,0,2,2,2,1,3,4,1,5,-4,6,2,4,0,4,1,12,-1,-4,-5,9,-4,0,0,1,-1,0,1,1,-1
KR_6757505422,420,-1,-22,8,0,2,1,3,1,0,1,-2,5,3,-2,2,0,1,0,1,0,-1,5,0,-5,5,-3,0,-1,-1,-1,-1,1,3,-1
KR_6729312714,420,-4,-2,-34,-7,-1,1,0,0,4,4,0,5,5,-3,4,1,-3,4,1,0,-13,7,0,-5,5,-7,0,-1,-1,0,-1,-1,2,-1
KR_6759658973,420,-4,-49,-14,-9,-3,4,1,-2,2,0,-4,5,1,-3,4,1,3,2,5,0,-3,7,-2,-5,7,1,0,-1,-1,0,-1,-1,4,-1
KR_6721960631,420,-4,-43,-22,-5,-2,2,0,1,3,4,-2,4,2,-2,2,0,0,0,0,0,-9,-9,-6,-3,9,2,0,0,1,-1,0,1,2,-1
KR_6763007842,440,0,-38,1,-5,0,0,0,1,1,2,-4,4,0,2,1,3,-4,6,2,0,-1,0,5,-6,1,0,0,0,1,-1,0,-1,1,-1
KR_6736078096,420,-2,-38,-13,-3,8,0,8,-6,7,1,-3,4,1,-2,2,0,0,0,0,-1,-11,-5,3,-5,2,3,0,-2,-1,-1,-1,-1,5,-1
KR_6689146978,420,6,5,62,5,0,1,1,2,3,5,2,2,4,-5,6,1,6,1,7,0,-5,0,-1,-3,4,1,0,1,0,0,-1,-1,0,-1
KR_6762510386,420,-2,13,-16,-5,3,0,3,1,1,2,1,2,3,-2,2,0,-8,8,0,0,-16,4,6,-9,3,-2,0,-1,-1,-1,-1,-1,2,-1
KR_6765771311,420,0,30,-24,-1,-1,1,0,1,1,2,1,0,1,-3,3,0,1,1,2,0,-3,-3,2,-7,5,-1,0,-1,-1,1,-1,-1,2,-1
KR_6754925321,420,-2,4,16,-11,-2,3,1,-3,3,0,0,2,2,-7,8,1,1,0,1,0,-12,15,4,-7,3,-1,0,0,1,1,-1,-1,3,-1
KR_6696314780,440,-3,-29,8,-10,-5,5,0,1,3,4,-1,2,1,-6,7,1,1,1,2,0,-15,-3,-6,-4,10,-1,0,0,0,1,0,1,0,-1
KR_6700969868,420,-4,-11,-11,-17,-3,3,0,-3,6,3,1,2,3,-3,4,1,-9,10,1,0,-17,-6,-3,-5,8,-2,0,-2,-1,-1,-1,1,5,-1
KR_6683281666,420,-1,-58,5,-4,4,0,4,-1,2,1,-1,1,0,-1,3,2,-5,7,2,-1,-9,-15,1,-6,5,5,0,0,-1,1,-1,-1,3,-1
KR_6602242883,420,0,-47,16,-6,-2,4,2,0,1,1,0,1,1,-5,5,0,1,1,2,0,-8,9,1,-7,6,-4,0,-2,0,-1,-1,1,0,-1
KR_6729707784,420,-2,5,-14,-5,-1,1,0,0,3,3,0,1,1,2,1,3,-6,6,0,0,-11,-3,3,-8,5,-4,0,-2,-1,1,-1,-1,1,-1
KR_6768875909,420,-4,-45,-15,-10,-4,6,2,-5,9,4,1,2,3,-2,3,1,0,1,1,0,3,-5,5,-9,4,1,0,-3,-1,-1,-1,1,1,-1
KR_6740811226,420,1,-9,12,8,-5,6,1,3,2,5,2,1,3,3,0,3,5,0,5,1,10,14,-1,-6,7,-2,0,0,0,-1,0,1,0,-1
KR_6598188144,420,-2,8,-35,1,-3,3,0,-1,6,5,2,2,4,1,3,4,2,3,5,-1,-6,6,4,-8,4,2,0,0,-1,-1,0,-1,1,-1
KR_6750969044,420,0,30,-23,2,-3,3,0,1,5,6,6,0,6,-2,3,1,0,1,1,0,1,0,4,-5,1,-2,0,0,1,-1,-1,1,2,-1
KR_6769481532,420,-2,-83,-25,-8,-5,5,0,-2,3,1,1,2,3,-1,4,3,-1,2,1,0,-1,5,-1,-5,6,1,0,-1,-1,0,-1,-1,5,-1
KR_6722139634,420,-4,-10,-1,-3,1,0,1,-2,5,3,-1,3,2,-1,3,2,0,0,0,0,-13,-1,3,-7,4,-4,0,-2,-1,-1,-1,1,1,-1
KR_6664093451,420,-1,-2,-29,1,2,0,2,2,2,4,-5,6,1,0,4,4,2,1,3,-1,-3,-9,0,-10,10,0,0,1,1,-1,1,-1,2,-1
KR_6769543946,420,-2,-49,-8,-10,-2,3,1,-4,8,4,2,1,3,-4,7,3,-2,4,2,-1,-5,63,0,-5,5,-14,0,0,-1,1,0,1,1,-1
KR_5739073735,420,0,-40,-1,-3,-2,3,1,3,2,5,-4,4,0,2,1,3,-2,2,0,0,0,35,-2,-6,8,4,0,1,-1,0,1,1,5,-1
KR_6762523483,420,2,-50,24,5,2,1,3,4,1,5,-1,2,1,0,4,4,0,1,1,0,3,-29,-2,-1,3,-2,0,0,-1,1,1,1,3,-1
KR_6728488129,420,-1,-86,4,2,1,1,2,-1,4,3,3,0,3,2,1,3,-3,3,0,2,1,-8,1,-5,4,-1,0,-1,1,1,-1,1,1,-1
KR_6747894521,420,-1,-73,12,-6,2,3,5,1,1,2,-1,2,1,-5,6,1,-3,3,0,0,-5,-10,-1,-5,6,-1,0,0,-1,1,0,-1,6,-1
KR_6751270713,420,-1,-16,-36,2,6,0,6,-3,4,1,1,2,3,-2,3,1,0,0,0,1,-1,-6,0,-5,5,1,0,0,-1,1,0,1,3,-1
KR_6761439471,420,-4,19,2,-5,1,4,5,1,0,1,0,2,2,-8,9,1,1,1,2,0,-8,-4,1,-6,5,2,0,0,1,1,0,-1,6,-1
KR_6734737747,420,-3,-59,-6,-3,-1,2,1,-1,1,0,1,3,4,-1,4,3,-1,1,0,0,-1,4,0,-3,3,-1,0,0,-1,1,0,1,2,-1
KR_6769214987,420,-2,28,-24,3,1,0,1,1,1,2,6,0,6,-4,5,1,-1,1,0,0,-1,-23,6,-7,1,-3,0,0,1,-1,0,-1,6,-1
KR_6734382131,420,-6,-58,-39,-9,-2,2,0,-2,6,4,-1,5,4,-3,7,4,-1,1,0,0,-6,52,1,-5,4,-19,0,-1,-1,-1,-1,1,4,-1
KR_6764436697,420,-4,5,-23,4,4,0,4,-3,4,1,0,3,3,3,0,3,0,1,1,1,9,-18,2,-6,4,-7,0,0,-1,-1,1,1,4,-1
KR_6769569325,420,-1,-33,-16,-2,-2,2,0,0,1,1,-1,1,0,1,1,2,0,0,0,0,1,-178,4,-4,0,-2,0,1,1,-1,1,-1,1,-1
KR_6755165904,440,-3,-48,14,-1,-3,4,1,5,0,5,-1,2,1,2,0,2,-4,4,0,0,-1,-13,-2,-4,6,1,0,-1,1,1,-1,1,3,-1
KR_6698176908,420,-2,-20,-31,-3,0,2,2,1,2,3,-2,2,0,-2,3,1,0,0,0,0,-2,15,1,-5,4,-8,0,0,-1,1,0,1,2,-1
KR_6749596628,420,-1,-1,-4,0,3,2,5,-1,4,3,0,4,4,-2,2,0,0,1,1,0,2,-38,-1,-4,5,14,0,0,-1,-1,0,1,2,-1
KR_6758574811,420,0,15,-27,7,-1,2,1,3,1,4,1,2,3,1,0,1,3,0,3,0,6,-26,2,-6,4,18,0,1,1,1,1,1,6,-1
KR_6375658190,420,-1,-18,4,-4,-1,1,0,2,2,4,-1,2,1,-2,2,0,-2,2,0,0,-2,0,0,0,0,-1,0,-1,-1,-1,-1,-1,5,-1
KR_6753260639,420,-3,-107,-26,1,-2,3,1,-3,7,4,3,2,5,0,3,3,3,1,4,0,1,121,-2,-5,7,0,0,-1,-1,1,-1,1,5,-1
KR_6755318641,440,-5,-63,-17,-6,-6,6,0,-2,4,2,0,4,4,1,2,3,1,1,2,0,-6,8,-1,-4,5,-2,0,-1,0,-1,-1,1,0,-1
KR_6685954144,420,-1,11,-16,7,-3,3,0,7,3,10,0,1,1,3,2,5,0,2,2,0,10,0,0,-6,6,0,0,1,-1,1,1,1,2,-1
KR_6725543842,420,-3,-9,-7,-3,-1,3,2,-10,10,0,0,1,1,5,2,7,3,1,4,0,0,7,1,-6,5,-1,0,0,-1,-1,-1,1,2,-1
KR_6753365774,420,-4,-47,-24,-11,-1,1,0,-3,7,4,1,1,2,-5,6,1,-3,3,0,1,-8,-6,-1,-5,6,2,0,-2,-1,-1,-1,1,4,-1
KR_6725997569,440,2,-73,-8,-1,-3,3,0,3,0,3,-2,5,3,-1,1,0,2,1,3,0,9,-9,2,-3,1,-2,0,-1,-1,0,-1,-1,1,-1
KR_6660880309,420,4,56,-16,4,1,3,4,-1,2,1,-1,4,3,2,0,2,3,0,3,0,2,-9,2,-6,4,6,0,0,1,-1,-1,-1,4,-1
KR_6727497271,420,-1,-36,21,-16,-7,7,0,-5,8,3,3,0,3,-7,7,0,0,1,1,-3,-27,5,6,-8,2,-6,0,0,-1,1,0,-1,5,-1
KR_6619803997,420,-3,-25,4,-8,0,2,2,-10,11,1,2,1,3,-1,4,3,1,2,3,0,-12,-20,1,-7,6,-1,0,0,1,-1,-1,-1,6,-1
KR_6699001031,440,-4,-71,-9,0,-3,5,2,-1,5,4,-2,5,3,5,2,7,1,2,3,2,11,8,2,-8,6,-3,0,-1,0,0,-1,1,0,-1
KR_6761184269,420,-2,-20,-17,-4,1,0,1,1,2,3,-2,3,1,-7,7,0,3,0,3,0,-4,-1,0,-7,7,1,0,0,-1,1,1,1,1,-1
KR_6755500623,420,-1,31,-4,-3,0,3,3,-2,2,0,-2,2,0,1,0,1,0,0,0,0,0,3,0,-5,5,5,0,0,-1,1,0,1,3,-1
KR_6768623723,440,0,-19,3,9,-3,5,2,1,6,7,1,2,3,7,0,7,3,0,3,0,12,1,0,-6,6,1,0,1,1,1,1,1,6,-1
KR_6756857033,420,0,-22,-4,1,-4,4,0,0,4,4,-1,1,0,6,0,6,0,1,1,0,4,127,-1,-1,2,-1,0,1,-1,1,1,1,1,-1
KR_6767704503,420,-5,-33,-24,4,-3,3,0,0,2,2,0,4,4,2,1,3,5,0,5,0,6,26,3,-4,1,-3,0,-3,-1,-1,-1,-1,3,-1
KR_6769661730,420,-1,10,0,-1,-3,4,1,-1,2,1,0,1,1,1,1,2,2,0,2,0,3,212,-2,-3,5,4,0,-2,0,-1,-1,-1,0,-1
KR_6660990059,420,-1,36,-16,4,3,3,6,0,1,1,3,0,3,-2,2,0,0,1,1,2,1,1,0,-6,6,-1,0,0,-1,-1,-1,1,4,-1
KR_6731500119,420,1,10,-22,3,1,2,3,-4,6,2,4,1,5,-1,3,2,3,1,4,0,-3,10,-2,-4,6,-1,0,1,-1,1,1,-1,1,-1
KR_6685335845,420,-3,-27,1,-4,-4,4,0,-2,3,1,-1,4,3,3,0,3,0,1,1,0,9,1,-1,-2,3,-2,0,-1,1,-1,-1,-1,4,-1
KR_6729364908,420,-2,18,-32,-5,-2,4,2,-3,5,2,1,1,2,2,0,2,-3,4,1,0,-7,5,-3,-4,7,-6,0,0,1,-1,0,-1,1,-1
KR_6766098253,420,4,61,5,0,5,0,5,3,3,6,-5,5,0,-3,7,4,0,1,1,-1,-10,1,-4,-3,7,4,0,1,-1,1,1,-1,1,-1
KR_6726992395,420,-2,-31,-4,-5,0,2,2,-5,7,2,-3,5,2,0,2,2,3,0,3,0,-8,-3,-1,-2,3,0,0,-2,-1,-1,-1,-1,1,-1
KR_6704478585,420,-5,-64,4,-14,-4,4,0,-4,5,1,-6,6,0,-1,5,4,1,2,3,1,-17,3,-4,-2,6,-1,0,-1,-1,-1,-1,-1,6,-1
KR_6744103105,420,-4,7,-37,-10,-2,2,0,-1,1,0,-4,6,2,2,4,6,-5,5,0,-1,-13,-25,0,-9,9,2,0,-1,-1,1,-1,-1,4,-1
KR_6730581435,420,-7,-85,-36,-13,-6,6,0,0,3,3,-5,7,2,-2,3,1,0,1,1,0,-9,2,-2,-3,5,-1,0,-4,-1,-1,-1,-1,4,-1
KR_6755534318,420,-4,-9,-47,-4,4,0,4,-3,3,0,-1,2,1,-3,4,1,-1,1,0,0,-9,-246,-1,-5,6,1,0,1,-1,1,1,1,5,-1
KR_6727938978,420,-1,-70,-4,0,1,0,1,1,4,5,4,0,4,-6,7,1,0,1,1,0,-7,-1,4,-4,0,1,0,1,1,1,1,-1,6,-1
KR_6743540288,420,-3,-37,-1,-15,-2,2,0,-4,5,1,-3,4,1,-5,6,1,-1,2,1,0,-13,-321,-4,-1,5,0,0,-1,-1,-1,-1,-1,4,-1
KR_6694431219,420,-2,18,-13,-12,-5,7,2,-1,3,2,-1,4,3,-1,2,1,-4,4,0,1,-4,-7,-1,-4,5,-3,0,0,-1,0,-1,1,3,-1
KR_6752906076,440,-2,-29,-8,-4,1,0,1,-1,2,1,0,1,1,-3,6,3,-1,2,1,0,-6,5,2,-5,3,2,0,0,0,-1,0,-1,0,-1
KR_6737201724,420,-1,-25,-12,-1,1,0,1,-2,6,4,-1,2,1,1,0,1,0,0,0,0,-2,-18,-1,-5,6,1,0,0,-1,-1,0,-1,1,-1
KR_6753862338,420,-1,21,4,8,1,1,2,0,3,3,0,4,4,5,2,7,2,0,2,1,15,-1,5,-6,1,5,0,0,1,-1,1,1,4,-1
KR_6588243070,420,-5,-61,8,-10,1,1,2,-1,3,2,0,1,1,-2,6,4,-8,9,1,1,-12,-4,-1,-5,6,-2,0,-4,1,-1,-1,1,3,-1
KR_6731541864,420,-1,-6,9,-5,-2,3,1,1,1,2,0,2,2,-4,4,0,0,0,0,0,-9,135,4,-5,1,4,0,-1,1,-1,-1,1,1,-1
KR_6768534956,420,3,19,23,3,-6,6,0,1,0,1,4,0,4,3,1,4,1,0,1,0,11,3,2,-5,3,4,0,-1,-1,-1,-1,-1,4,-1
KR_6769754509,440,-1,-47,22,-3,1,1,2,1,3,4,4,0,4,-8,8,0,-1,1,0,0,-7,-9,-4,-3,7,0,0,-2,1,-1,-1,-1,1,-1
KR_6741193518,420,-1,12,-11,-2,3,3,6,-4,7,3,0,1,1,-2,3,1,1,0,1,0,-5,1,2,-4,2,1,0,1,1,1,1,1,6,-1
KR_6722362859,420,-1,49,0,-5,-2,3,1,7,5,12,-5,7,2,-6,6,0,1,0,1,1,6,4,6,-10,4,3,0,0,0,-1,0,1,0,-1
KR_6738704638,440,1,-19,23,1,1,1,2,-1,1,0,4,2,6,-1,3,2,-2,3,1,0,-1,-5,-3,-2,5,1,0,1,1,1,1,-1,2,-1
KR_6672123347,420,-2,-67,-20,-4,5,2,7,-1,2,1,-1,1,0,-3,4,1,-4,5,1,0,-2,0,1,-3,2,4,0,-1,-1,-1,1,-1,2,-1
KR_6736026684,440,-3,-116,-16,-8,-6,6,0,-2,2,0,2,0,2,-3,6,3,1,1,2,0,-6,21,0,-5,5,3,0,-2,-1,-1,-1,-1,2,-1
KR_6755470878,420,-4,20,-51,-18,-5,5,0,0,1,1,-13,13,0,1,0,1,-1,1,0,0,-17,128,-3,-5,8,-23,0,-1,-1,-1,1,-1,5,-1
KR_6708298943,420,-2,-34,-19,4,1,1,2,-2,7,5,4,1,5,0,3,3,1,1,2,-1,2,13,6,-11,5,-6,0,1,1,1,1,-1,3,-1
KR_6754391257,420,-1,-30,6,4,-2,3,1,4,0,4,-2,5,3,5,3,8,-1,1,0,1,17,0,4,-7,3,-4,0,0,-1,-1,-1,-1,4,-1
KR_6741760523,420,-3,-16,16,-4,-3,4,1,0,4,4,2,1,3,-1,1,0,-2,2,0,0,0,6,2,-4,2,-2,0,0,1,0,-1,1,3,-1
KR_6566060390,420,-3,-68,-20,-13,1,1,2,-1,4,3,-5,5,0,2,5,7,-10,11,1,0,-16,-9,-3,-3,6,-2,0,-2,-1,-1,-1,-1,5,-1
KR_6705698904,420,-2,-38,-4,-2,-3,5,2,-2,5,3,-1,2,1,2,1,3,2,0,2,0,2,4,0,-1,1,0,0,-1,1,-1,-1,-1,1,-1
KR_6762589499,420,-7,-20,-64,-17,-4,4,0,-3,3,0,-2,2,0,-5,6,1,-3,3,0,0,-18,-14,-3,0,3,1,0,-1,-1,-1,-1,-1,1,-1
KR_6690641309,420,1,-18,24,3,-2,2,0,-2,4,2,-1,2,1,7,0,7,1,0,1,0,9,-1,2,-7,5,1,0,0,1,-1,-1,1,2,-1
KR_6763445473,420,0,70,-18,-1,3,1,4,-3,4,1,-1,2,1,1,0,1,-1,1,0,1,-8,302,-1,-3,4,5,0,1,1,-1,1,1,5,-1
KR_6717834356,420,1,12,-12,1,2,1,3,-3,4,1,2,5,7,1,0,1,-1,1,0,-2,-5,20,2,-4,2,4,0,1,-1,1,1,-1,5,-1
KR_6693776739,420,0,66,-17,-3,1,3,4,-6,10,4,2,0,2,1,1,2,-1,2,1,0,0,4,4,-7,3,1,0,0,1,-1,0,-1,6,-1
KR_6719482025,440,0,-1,8,-4,-1,4,3,-3,3,0,0,1,1,-2,5,3,2,1,3,0,1,6,1,-4,3,-2,0,0,-1,-1,0,-1,5,-1
KR_6762820331,420,-4,-70,-32,-12,-5,6,1,-1,2,1,0,2,2,-5,5,0,-1,2,1,-1,-13,-4,-3,-4,7,-2,0,-3,-1,-1,-1,-1,5,-1
KR_6702977467,440,-3,4,-17,-11,3,0,3,0,2,2,-3,6,3,-7,7,0,-4,4,0,0,-12,9,2,-8,6,-7,0,0,-1,1,-1,-1,2,-1
KR_6731403858,420,-4,15,-24,-7,0,3,3,-2,3,1,-8,10,2,5,0,5,-2,3,1,0,-12,-10,-1,-5,6,2,0,-1,-1,-1,-1,-1,4,-1
KR_6765486670,420,-1,6,12,-5,2,0,2,-5,7,2,1,0,1,-2,5,3,-1,1,0,-1,-4,-9,-3,-4,7,9,0,-2,1,-1,-1,-1,3,-1
KR_6739389760,420,2,10,43,5,-1,1,0,0,4,4,5,1,6,1,2,3,0,1,1,0,11,7,-5,-3,8,-5,0,2,1,1,1,-1,3,-1
KR_6688625190,440,-2,-4,3,-6,4,2,6,-2,3,1,-2,5,3,-3,4,1,-3,8,5,0,-14,-8,-7,-2,9,4,0,0,0,-1,-1,1,0,-1
KR_6759580162,420,-4,-36,-13,-11,-2,3,1,-1,2,1,-6,6,0,-3,4,1,1,0,1,0,-11,-24,-4,-1,5,-2,0,0,-1,-1,0,-1,5,-1
KR_6738650266,440,3,19,23,8,1,2,3,2,2,4,3,2,5,2,0,2,0,0,0,0,8,-26,0,-1,1,0,0,2,1,1,1,1,1,-1
KR_6671881991,420,1,-16,16,-6,1,0,1,0,4,4,2,2,4,-8,9,1,-1,1,0,0,-13,3,5,-10,5,-1,0,0,-1,1,-1,-1,6,-1
KR_6744520891,420,-4,-45,-19,-6,1,0,1,-3,5,2,-1,3,2,-3,6,3,0,2,2,-1,-8,45,2,-5,3,-4,0,-1,-1,-1,-1,-1,1,-1
KR_6406083524,440,-1,-5,15,-2,-4,5,1,0,1,1,2,2,4,1,3,4,-1,1,0,0,-1,-9,1,-3,2,1,0,0,-1,0,-1,1,6,-1
KR_6619978634,420,-2,30,-28,-9,-2,2,0,-3,6,3,-1,2,1,0,4,4,-3,3,0,0,-7,4,1,-6,5,-1,0,0,-1,-1,-1,-1,1,-1
KR_6734578701,420,1,33,-5,-4,-1,2,1,3,0,3,-1,2,1,-3,5,2,-2,2,0,0,-6,43,-7,-1,8,-41,0,0,1,-1,0,-1,1,-1
KR_6734450621,420,0,-33,-12,-2,-1,4,3,-1,2,1,2,3,5,0,2,2,-2,3,1,0,2,-8,-1,-4,5,-2,0,-1,-1,0,-1,-1,5,-1
KR_6722515215,420,-6,-67,-4,-7,-4,6,2,1,2,3,-1,2,1,-1,6,5,-2,2,0,0,-14,-8,4,-7,3,-1,0,-2,-1,-1,-1,-1,3,-1
KR_6754777210,440,-1,-54,28,-3,1,0,1,0,0,0,2,2,4,-6,8,2,0,1,1,0,-5,-5,-1,-4,5,-3,0,-2,-1,1,-1,-1,2,-1
KR_6719321150,420,0,-27,12,2,-1,1,0,4,1,5,4,1,5,-3,5,2,-2,3,1,0,-13,3,3,-8,5,-2,0,-2,-1,1,-1,1,5,-1
KR_6680562979,440,0,54,2,-4,0,0,0,1,1,2,-4,5,1,-2,7,5,1,0,1,0,-2,6,6,-10,4,-5,0,-2,1,-1,-1,-1,4,-1
KR_6755060948,420,-3,-12,4,-3,-1,3,2,-3,4,1,4,0,4,-2,5,3,-1,1,0,0,-11,0,-1,-3,4,-2,0,0,-1,1,0,-1,3,-1
KR_6411380168,420,4,76,8,9,0,2,2,2,2,4,7,3,10,0,4,4,0,3,3,0,8,2,0,-4,4,-4,0,1,-1,1,1,1,1,-1
KR_6769136791,420,-2,-51,0,0,-1,3,2,0,1,1,-3,4,1,4,0,4,0,0,0,0,11,11,5,-6,1,-3,0,-1,1,-1,1,-1,2,-1
KR_6748291558,420,-1,-74,-5,-3,-1,1,0,1,0,1,3,1,4,-5,6,1,-1,1,0,0,-3,47,-3,-6,9,5,0,-1,-1,-1,-1,1,2,-1
KR_6723132507,420,-3,-45,-4,-9,2,2,4,-1,3,2,-4,4,0,-5,7,2,-1,2,1,0,-15,139,1,-7,6,-6,0,-1,-1,1,1,1,5,-1
KR_6723083005,440,-1,-98,9,-6,-2,2,0,-8,12,4,4,5,9,1,2,3,-1,1,0,0,-7,15,-1,-4,5,6,0,-1,1,-1,-1,-1,5,-1
KR_6656435445,420,-7,-91,-48,-14,-8,9,1,5,0,5,-6,7,1,-3,5,2,-2,2,0,0,-8,11,-2,-5,7,0,0,-1,-1,-1,-1,-1,1,-1
KR_6677852271,420,-2,22,22,-13,-3,3,0,-1,3,2,0,3,3,-4,5,1,-5,7,2,0,-12,-19,0,-5,5,4,0,0,-1,1,-1,-1,5,-1
KR_6768810540,420,-1,-1,4,-1,-4,5,1,1,0,1,-1,4,3,2,1,3,1,0,1,0,0,-1,0,-4,4,8,0,-1,1,1,-1,-1,2,-1
KR_6750231122,420,0,-43,20,-5,-5,5,0,-1,1,0,-2,4,2,3,2,5,0,3,3,0,3,-28,1,-5,4,-4,0,0,1,-1,-1,-1,2,-1
KR_6694629774,420,-3,-41,-11,-6,1,0,1,-4,6,2,-4,4,0,1,6,7,0,1,1,0,2,2,0,-5,5,-2,0,0,-1,1,0,-1,2,-1
KR_6691060219,420,0,-38,8,4,3,0,3,2,1,3,-7,8,1,3,2,5,3,0,3,0,2,2,1,-5,4,2,0,-1,1,-1,-1,-1,4,-1
KR_6700824411,420,-5,-95,-4,-7,-2,3,1,-3,3,0,-1,4,3,0,2,2,-1,1,0,0,-14,-25,6,-8,2,-1,0,0,0,-1,-1,1,0,-1
KR_6761310784,420,-4,-72,-36,-15,0,3,3,-5,5,0,1,1,2,-6,8,2,-5,5,0,-1,-13,17,-2,-4,6,1,0,-1,-1,-1,-1,-1,5,-1
KR_6588465468,420,-3,-90,-11,1,1,0,1,1,4,5,-2,4,2,1,4,5,0,1,1,1,-7,13,-3,-2,5,2,0,2,0,1,1,1,0,-1
KR_6758234139,420,-2,-50,-20,3,-1,3,2,-1,6,5,-3,6,3,5,0,5,3,0,3,0,9,-10,0,-6,6,2,0,0,-1,-1,0,1,3,-1
KR_6744330839,420,1,-4,12,-3,-6,6,0,2,2,4,0,4,4,0,6,6,1,1,2,0,-5,3,1,-6,5,-7,0,0,-1,-1,-1,1,5,-1
KR_6758861773,420,-5,-41,7,-9,1,1,2,3,2,5,-2,6,4,-6,7,1,-5,5,0,-1,-7,38,1,-4,3,-40,0,1,-1,1,1,-1,2,-1
KR_6765096024,420,-2,-20,-35,3,0,2,2,1,3,4,0,0,0,3,0,3,-1,1,0,0,5,127,10,-11,1,0,0,1,0,1,1,1,0,-1
KR_6749405556,440,0,24,-20,0,1,3,4,-2,4,2,1,1,2,2,1,3,-2,2,0,2,1,23,5,-7,2,-2,0,0,-1,1,0,1,4,-1
KR_6755108139,420,-3,-69,-2,-8,-4,5,1,-4,4,0,-1,1,0,-2,4,2,3,0,3,0,-2,-237,-2,-1,3,4,0,1,-1,1,1,-1,2,-1
KR_6755174722,440,0,-49,8,-4,-2,5,3,1,0,1,1,0,1,-2,5,3,-2,3,1,0,-5,-6,1,-4,3,4,0,-1,0,1,-1,-1,0,-1
KR_6768858797,420,-3,24,18,0,-1,2,1,-1,2,1,1,2,3,1,4,5,0,2,2,1,3,-7,-3,-5,8,5,0,0,-1,-1,0,1,5,-1
KR_6758975546,420,0,-1,16,-7,-5,5,0,0,4,4,-1,1,0,2,4,6,-3,4,1,0,-19,11,-5,-1,6,0,0,0,-1,0,0,-1,6,-1
KR_6442539966,420,3,-1,-7,0,-1,3,2,1,1,2,5,1,6,-4,5,1,-1,2,1,0,-2,-507,-2,-3,5,-3,0,1,-1,0,1,-1,5,-1
KR_6767212747,420,3,-1,36,1,-1,2,1,-2,4,2,1,2,3,3,3,6,0,1,1,0,0,-11,-2,-6,8,0,0,0,1,0,0,-1,4,-1
KR_6765239603,420,-1,-48,24,1,-3,3,0,2,3,5,1,1,2,2,0,2,-1,1,0,0,2,-41,-3,-2,5,30,0,-1,-1,1,-1,1,4,-1
KR_6769564795,440,-2,-28,-36,1,0,1,1,-2,3,1,4,0,4,0,3,3,-1,2,1,0,3,0,1,-4,3,1,0,0,1,0,0,1,2,-1
KR_6631224696,420,0,-41,-8,-5,-3,4,1,0,2,2,-1,4,3,-1,3,2,0,4,4,0,-1,-3,-2,-5,7,-4,0,-1,-1,1,-1,-1,2,-1
KR_6687921682,420,-3,-12,3,-10,-1,1,0,0,1,1,-4,6,2,-3,6,3,-2,2,0,0,-9,-1,-5,-6,11,-10,0,0,-1,1,0,1,4,-1
KR_6761729161,440,1,80,0,-2,4,1,5,1,5,6,-2,3,1,-1,3,2,-4,4,0,0,-3,4,1,-3,2,-3,0,2,0,1,1,1,0,-1
KR_6684754480,420,2,23,20,-1,2,1,3,1,4,5,-6,6,0,3,1,4,-1,1,0,0,7,14,-4,-6,10,-6,0,-1,1,-1,-1,1,6,-1
KR_6750013630,440,-1,48,-1,5,1,0,1,-2,3,1,0,2,2,2,6,8,4,0,4,1,13,41,4,-7,3,-17,0,1,1,-1,1,1,1,-1
KR_6715303249,440,2,56,11,6,3,2,5,0,1,1,2,1,3,2,1,3,-1,2,1,0,6,3,3,-6,3,3,0,0,1,-1,1,1,3,-1
KR_6769618806,440,0,-33,-15,-3,0,1,1,0,1,1,4,2,6,-2,3,1,-5,7,2,0,-5,-9,-2,-5,7,1,0,1,-1,-1,1,-1,5,-1
KR_6686658903,420,-1,34,9,-4,-1,2,1,2,2,4,-1,3,2,-4,4,0,0,1,1,0,-2,-2,-2,-1,3,-1,0,1,0,1,-1,1,0,-1
KR_6723171140,420,-1,-23,-24,-2,-1,3,2,3,3,6,3,2,5,-11,13,2,4,0,4,0,-4,24,1,-5,4,-5,0,-1,0,-1,1,-1,0,-1
KR_6571599899,420,0,22,-27,-1,-2,5,3,6,0,6,-2,5,3,-4,7,3,1,1,2,1,13,7,-3,-4,7,1,0,0,1,-1,1,1,2,-1
KR_6736389197,420,1,-22,24,0,0,2,2,4,0,4,-1,2,1,-2,4,2,-1,1,0,0,-2,5,-2,-3,5,5,0,1,-1,-1,1,-1,6,-1
KR_6591811063,420,-2,15,-15,-4,3,3,6,-4,4,0,1,1,2,-3,5,2,-1,1,0,0,2,31,0,-4,4,-14,0,-1,1,-1,-1,-1,5,-1
KR_6677704491,420,-2,-26,24,-2,0,1,1,-3,3,0,-3,3,0,3,0,3,1,0,1,0,0,-3,1,-5,4,2,0,-2,1,-1,-1,-1,5,-1
KR_6640272732,420,0,0,-13,-1,-2,2,0,-3,4,1,3,3,6,1,2,3,0,1,1,0,-6,8,2,-6,4,1,0,-2,1,1,-1,1,5,-1
KR_6715829584,440,0,-25,-12,3,1,3,4,2,1,3,2,2,4,-2,4,2,0,0,0,-1,6,3,3,-7,4,2,0,-1,1,-1,-1,-1,1,-1
KR_6497050380,420,-5,-66,-23,-9,-3,4,1,-1,2,1,0,3,3,-1,2,1,-4,5,1,0,-5,-7,-2,-4,6,-1,0,0,1,1,0,1,6,-1
KR_6768808861,420,2,-8,4,2,0,1,1,2,2,4,2,0,2,0,2,2,-2,2,0,0,-2,-6,-2,-2,4,3,0,0,1,-1,0,1,2,-1
KR_6616069915,420,-6,-89,-26,-7,1,3,4,-3,4,1,-1,3,2,-4,4,0,0,0,0,0,-12,2,1,-3,2,-2,0,-1,-1,-1,-1,1,2,-1
KR_6762822799,420,-1,-36,3,-5,3,0,3,0,2,2,-2,2,0,-4,5,1,-2,2,0,1,-10,-8,-2,-3,5,-1,0,-1,0,0,-1,1,0,-1
KR_6713181996,420,-1,-30,1,-5,-3,3,0,1,2,3,0,0,0,-4,7,3,1,0,1,0,-4,-5,2,-8,6,-1,0,0,-1,-1,-1,-1,2,-1
KR_6747621949,420,-8,-107,-33,-15,-4,4,0,-5,6,1,-2,6,4,-1,3,2,-3,5,2,0,-10,14,-4,-4,8,-5,0,-2,0,-1,-1,-1,0,-1
KR_6754957574,420,-3,-40,-4,-8,-6,6,0,-1,3,2,0,3,3,-2,3,1,1,1,2,0,-2,24,-1,-5,6,-5,0,-1,1,0,-1,-1,2,-1
KR_6457845527,420,-6,-69,-1,-11,-5,5,0,0,2,2,-2,4,2,-2,2,0,-2,3,1,2,-12,-16,-2,-4,6,0,0,0,-1,1,0,-1,4,-1
KR_6691125720,420,-2,-52,8,-5,1,2,3,-3,4,1,-2,3,1,3,3,6,-4,4,0,-1,-5,115,0,-7,7,1,0,0,-1,-1,0,-1,5,-1
KR_6678959914,420,-2,-74,28,-8,1,3,4,-2,7,5,-2,2,0,-4,4,0,-1,1,0,0,-10,-5,-4,-4,8,5,0,0,1,1,0,-1,5,-1
KR_6746157045,420,1,-32,-14,10,3,2,5,6,2,8,4,2,6,-2,3,1,-1,2,1,1,6,2,3,-6,3,0,0,0,-1,1,1,1,6,-1
KR_6736057410,420,-6,-56,-24,-15,-2,2,0,-3,4,1,-3,3,0,-6,6,0,-1,2,1,0,-13,71,-7,-2,9,1,0,-3,-1,-1,-1,-1,3,-1
KR_6661823554,420,2,-65,45,2,9,0,9,-3,3,0,-3,4,1,-4,4,0,3,0,3,0,2,-1,0,-5,5,-6,0,1,-1,1,1,1,3,-1
KR_6743734033,420,-1,7,-20,2,-2,4,2,3,1,4,-1,4,3,0,2,2,2,0,2,-1,8,-30,1,-8,7,0,0,-1,1,-1,-1,1,1,-1
KR_6598785588,420,-2,5,-18,-3,-5,7,2,0,1,1,-1,1,0,3,2,5,0,0,0,0,3,5,3,-7,4,-5,0,1,1,-1,-1,1,3,-1
KR_6754713471,420,-1,-27,-32,-1,4,1,5,-4,5,1,1,1,2,-5,7,2,3,0,3,0,-2,-27,3,-6,3,2,0,0,-1,-1,0,1,1,-1
KR_6751318515,440,0,19,21,-8,-8,9,1,2,0,2,3,0,3,-5,6,1,0,3,3,0,-6,-3,-1,-5,6,1,0,0,0,-1,0,1,0,-1
KR_6753587603,420,-2,1,9,-6,-7,8,1,1,3,4,1,3,4,2,1,3,-3,3,0,0,4,18,7,-8,1,1,0,1,1,1,1,1,2,-1
KR_6765335108,420,1,17,32,3,-3,6,3,0,3,3,1,1,2,5,0,5,0,1,1,0,0,-3,-1,-5,6,0,0,0,1,-1,1,1,5,-1
KR_6760532671,420,1,-40,0,-3,0,1,1,1,4,5,-3,5,2,-1,1,0,0,2,2,0,-2,-300,0,-5,5,-3,0,0,-1,-1,0,-1,1,-1
KR_6743904087,420,-2,-49,-8,-4,-2,2,0,-3,5,2,1,0,1,0,2,2,0,0,0,0,0,19,3,-4,1,1,0,0,1,0,0,1,5,-1
KR_6766921287,420,-2,10,-52,0,2,0,2,2,1,3,-4,5,1,1,1,2,-1,1,0,0,4,0,1,-6,5,2,0,-1,-1,-1,-1,-1,6,-1
KR_6746007441,440,2,-5,45,-3,0,1,1,-4,4,0,3,0,3,0,3,3,-2,2,0,0,-6,62,0,-3,3,0,0,0,1,0,0,-1,1,-1
KR_6678608754,420,-6,-81,-12,-8,-6,8,2,-1,2,1,-4,4,0,-1,3,2,4,0,4,0,-2,0,-2,-4,6,-6,0,-1,-1,-1,-1,-1,3,-1
KR_6699845765,440,3,14,24,5,-1,2,1,0,3,3,0,3,3,3,2,5,3,0,3,-4,-9,6,-3,-4,7,6,0,1,-1,1,-1,-1,3,-1
KR_6748706705,420,0,48,-16,-5,3,0,3,1,2,3,-4,6,2,-4,6,2,-1,3,2,-2,-1,6,5,-6,1,0,0,2,-1,1,1,-1,4,-1
KR_6767029228,440,4,39,20,-1,-4,4,0,6,0,6,-1,2,1,-2,4,2,0,0,0,0,-2,47,0,-4,4,-22,0,2,-1,1,1,-1,5,-1
KR_6761034511,440,-8,-96,-22,-9,2,1,3,-4,6,2,0,2,2,-5,5,0,-2,2,0,0,-4,1,-1,-3,4,-2,0,-2,-1,1,-1,1,3,-1
KR_6677076488,420,-1,7,-5,-7,-2,3,1,-2,4,2,2,2,4,-7,9,2,2,1,3,0,-11,3,1,-4,3,-3,0,1,-1,1,1,1,5,-1
KR_6683109407,420,-3,-17,-23,-3,-3,4,1,-1,3,2,-2,4,2,4,0,4,-1,1,0,0,2,63,1,-4,3,-16,0,2,-1,1,1,1,6,-1
KR_6733344307,420,0,16,-27,2,3,0,3,-2,3,1,0,2,2,-1,2,1,2,0,2,0,-2,13,4,-6,2,-2,0,1,-1,0,1,1,2,-1
KR_6630343863,420,-1,-89,-16,1,1,1,2,4,2,6,-2,5,3,-3,4,1,1,0,1,0,4,-2,-3,0,3,0,0,-1,-1,-1,-1,1,4,-1
KR_6765051620,420,1,21,-11,0,3,0,3,-1,3,2,-1,1,0,-1,4,3,0,0,0,0,-5,14,4,-8,4,-6,0,-1,-1,1,-1,-1,6,-1
KR_6753999549,440,3,43,20,3,-2,5,3,5,1,6,-1,3,2,-1,2,1,2,1,3,0,1,-1,5,-5,0,0,0,0,1,1,1,1,2,-1
KR_6734306913,420,1,-17,-31,0,1,0,1,4,1,5,-4,5,1,0,2,2,-1,1,0,0,3,11,0,-4,4,0,0,-1,-1,-1,-1,-1,4,-1
KR_6688402067,440,-1,-38,4,-1,-3,5,2,7,0,7,1,1,2,-5,6,1,-1,1,0,0,8,23,0,-4,4,5,0,1,0,-1,-1,-1,0,-1
KR_6725688002,420,-1,-4,-8,-3,2,2,4,0,4,4,0,3,3,-3,5,2,-2,4,2,0,-6,1,1,-6,5,4,0,0,1,-1,0,-1,4,-1
KR_6576159714,440,-1,-21,5,5,4,3,7,1,2,3,-6,6,0,4,2,6,2,1,3,0,-2,-5,-4,-3,7,0,0,-1,-1,-1,-1,-1,5,-1
KR_6684762687,420,0,18,-24,-1,3,1,4,-3,4,1,-2,3,1,0,2,2,1,0,1,1,0,8,2,-5,3,-2,0,2,0,1,1,1,0,-1
KR_6722630561,420,-3,-69,-12,-11,-2,2,0,-1,3,2,-4,7,3,-2,7,5,-2,2,0,0,-7,0,1,-5,4,1,0,-1,-1,-1,-1,-1,6,-1
KR_6129151029,420,-6,-18,-12,-7,2,0,2,2,5,7,-5,7,2,-3,3,0,-3,3,0,0,-4,0,-1,-10,11,-3,0,-2,-1,-1,-1,1,5,-1
KR_6718659302,420,1,10,28,0,-2,2,0,0,0,0,-2,2,0,1,3,4,3,1,4,-2,-3,-2,-2,-6,8,2,0,1,1,1,1,1,2,-1
KR_6743160970,420,0,-37,5,4,-2,2,0,3,0,3,4,2,6,-1,5,4,0,0,0,0,1,171,3,-4,1,-3,0,0,0,1,-1,1,0,-1
KR_6767280345,420,-2,-9,-30,-1,5,1,6,-3,4,1,-3,7,4,2,0,2,-2,3,1,0,0,1,2,-7,5,0,0,-1,0,1,1,-1,0,-1
KR_6765203920,420,0,12,7,-7,-3,3,0,0,2,2,-1,3,2,-2,3,1,-1,2,1,0,-16,-11,-4,-5,9,8,0,0,-1,-1,-1,1,5,-1
KR_6647798577,440,-2,-64,28,-9,0,1,1,4,0,4,-2,2,0,-11,11,0,0,0,0,-1,-20,-2,0,-5,5,-2,0,-1,-1,1,1,-1,5,-1
KR_6760049782,440,2,30,-19,2,3,0,3,1,3,4,-2,4,2,1,3,4,-1,2,1,0,-2,-11,-2,-3,5,0,0,1,-1,0,1,-1,4,-1
KR_6715624858,420,-7,-101,-14,-15,3,1,4,-2,3,1,-4,6,2,-9,9,0,-3,3,0,2,-17,3,-4,-4,8,-7,0,-2,-1,-1,-1,1,6,-1
KR_6744471060,420,-2,-82,-24,-10,-6,8,2,0,4,4,1,3,4,-4,4,0,-1,1,0,-1,-22,165,-4,-7,11,-1,0,-1,1,1,-1,-1,3,-1
KR_6767028616,420,-5,-12,18,-9,-2,2,0,-2,4,2,-5,7,2,1,3,4,-1,2,1,0,-3,0,-1,-5,6,-3,0,-2,1,-1,-1,1,6,-1
KR_6696690474,420,-7,-86,-32,-10,-4,6,2,0,1,1,-1,1,0,-2,3,1,-3,3,0,0,-5,-119,2,-4,2,-1,0,-1,-1,1,-1,-1,3,-1
KR_6740664822,420,-3,-32,-14,-3,3,2,5,-1,2,1,-2,3,1,-4,7,3,1,2,3,0,-8,-134,-3,-6,9,3,0,-2,-1,-1,-1,-1,5,-1
KR_6729730171,420,-4,-24,3,-4,1,2,3,-1,2,1,-2,2,0,0,2,2,-2,4,2,1,-6,-5,-1,-5,6,3,0,-2,-1,1,-1,1,2,-1
KR_6717409027,420,-7,-85,22,-29,-4,4,0,-4,6,2,-5,8,3,-10,11,1,-6,6,0,0,-22,-13,-5,0,5,-4,0,-3,-1,-1,-1,-1,4,-1
KR_6683200254,420,-4,-27,-40,-3,-1,2,1,0,2,2,-2,4,2,-2,5,3,2,0,2,1,1,0,0,-5,5,-4,0,1,-1,-1,1,1,4,-1
KR_6571714223,420,-3,-46,-1,-7,0,2,2,-5,5,0,1,2,3,-4,6,2,1,2,3,0,-7,-13,0,-8,8,6,0,-1,-1,-1,-1,1,4,-1
KR_6741773661,420,-2,-13,-27,-9,-5,5,0,-2,3,1,0,5,5,-2,2,0,0,0,0,-1,-2,39,-4,-3,7,-4,0,0,-1,-1,-1,-1,2,-1
KR_6769603465,420,-2,38,-13,2,3,1,4,-1,1,0,-7,8,1,5,0,5,2,1,3,1,8,-14,-1,-4,5,-2,0,0,-1,-1,-1,1,1,-1
KR_6766928083,420,1,-7,-3,1,2,1,3,0,1,1,4,2,6,-6,7,1,1,0,1,-1,-4,-26,-5,-2,7,-1,0,0,1,-1,-1,-1,1,-1
KR_6742924820,420,-4,-1,-5,-14,-1,3,2,-4,4,0,-1,2,1,-4,6,2,-4,4,0,0,-16,-2,0,-5,5,1,0,-3,-1,1,-1,-1,5,-1
KR_6762348528,420,0,-34,-4,1,1,3,4,-3,5,2,7,1,8,-3,7,4,-1,2,1,0,-4,-7,-4,-2,6,-3,0,-1,-1,1,-1,1,2,-1
KR_6525335989,420,-2,-32,-37,-6,1,3,4,-4,6,2,-1,3,2,0,3,3,-2,3,1,0,1,-7,-5,-5,10,2,0,-1,-1,-1,-1,-1,1,-1
KR_6754707175,420,1,-75,23,-4,-2,3,1,1,2,3,-1,1,0,-2,5,3,0,0,0,0,-1,1,0,-5,5,-4,0,-2,-1,-1,-1,-1,5,-1
KR_6685355012,420,-2,-80,12,-7,1,0,1,-2,2,0,-5,8,3,-3,4,1,2,0,2,-1,-5,-113,1,-6,5,-1,0,-2,0,-1,-1,-1,0,-1
KR_6690553906,420,-3,-116,14,-7,4,1,5,4,1,5,-4,5,1,-12,13,1,1,0,1,0,-10,-7,2,-4,2,-2,0,-1,1,-1,-1,-1,6,-1
KR_6764570325,420,-3,34,-21,-4,3,2,5,-2,2,0,-3,4,1,-1,1,0,-1,2,1,0,-3,-3,-1,-4,5,0,0,0,0,-1,0,-1,0,-1
KR_6736012382,440,-1,2,12,-7,4,2,6,-3,5,2,-3,5,2,-3,4,1,-2,4,2,0,-4,4,-7,-1,8,-2,0,-1,0,-1,-1,1,0,-1
KR_6724761260,420,0,-37,-2,-1,1,1,2,-2,3,1,-4,6,2,4,1,5,0,0,0,0,3,8,4,-6,2,1,0,0,-1,-1,-1,-1,1,-1
KR_6763172289,420,-1,50,-9,-8,-3,3,0,-3,5,2,-1,3,2,-2,2,0,1,2,3,0,-9,0,2,-7,5,-10,0,1,1,-1,-1,-1,3,-1
KR_6687439996,420,-2,-43,-1,-5,-3,3,0,-1,2,1,-6,7,1,4,1,5,1,1,2,-1,1,-13,7,-11,4,-2,0,0,-1,-1,-1,-1,5,-1
KR_6716734331,420,-5,2,-28,-10,0,2,2,0,2,2,-7,9,2,-2,3,1,-1,2,1,-2,-8,-11,-3,-2,5,2,0,-1,1,-1,-1,-1,3,-1
KR_6759588401,440,-7,-80,-28,-14,3,1,4,0,1,1,-2,5,3,-12,14,2,-3,3,0,0,-17,3,5,-9,4,-5,0,-2,-1,-1,-1,-1,3,-1
KR_6725740446,420,0,6,-13,0,0,3,3,-3,5,2,-1,4,3,4,4,8,0,0,0,0,10,0,1,-4,3,-1,0,0,1,-1,-1,-1,2,-1
KR_6670897860,420,-5,-33,4,-4,1,2,3,0,4,4,-4,4,0,-3,4,1,2,0,2,0,-12,-58,2,-6,4,-5,0,0,-1,-1,-1,-1,5,-1
KR_6760750421,420,-1,-29,-20,-2,-1,2,1,3,5,8,0,1,1,-2,5,3,-2,5,3,2,1,4,-1,-4,5,-3,0,1,-1,-1,-1,1,5,-1
KR_6742161807,440,-2,-13,-4,-6,1,1,2,4,1,5,-2,3,1,-4,4,0,-5,9,4,0,-9,0,-2,-3,5,-1,0,-2,-1,0,-1,-1,1,-1
KR_6638389918,420,-2,27,-4,2,1,2,3,3,1,4,1,3,4,-3,5,2,0,1,1,0,-2,3,2,-6,4,-3,0,1,1,1,-1,1,5,-1
KR_6706998719,420,0,-76,32,-3,-1,1,0,-2,3,1,4,3,7,-4,5,1,0,0,0,0,-13,-2,4,-8,4,-1,0,0,0,1,1,-1,0,-1
KR_6699289696,420,0,3,17,-6,-2,4,2,-1,5,4,1,4,5,-2,2,0,-2,2,0,0,-4,-9,-5,-3,8,-2,0,1,1,-1,-1,1,4,-1
KR_6737987876,420,-5,-1,-11,-5,1,2,3,-2,2,0,0,0,0,-3,5,2,-1,2,1,0,-8,2,-1,-3,4,-2,0,-1,-1,1,-1,1,3,-1
KR_6716281841,420,-1,-6,31,-3,4,0,4,-2,2,0,-4,5,1,-1,4,3,0,1,1,-1,-11,34,-2,-1,3,-1,0,1,-1,0,1,-1,5,-1
KR_6753367127,420,-6,-80,2,-13,0,1,1,-5,6,1,-10,11,1,3,2,5,-1,4,3,1,-6,-48,-3,0,3,22,0,-3,-1,-1,-1,1,6,-1
KR_6769755427,420,0,21,-29,6,3,1,4,1,1,2,1,3,4,0,0,0,1,0,1,0,3,1,0,-3,3,0,0,1,-1,-1,1,1,1,-1
KR_6696694700,420,-3,20,-28,-11,-2,3,1,-2,8,6,-2,3,1,-4,7,3,-1,2,1,1,-13,-267,-1,-7,8,3,0,-4,1,-1,-1,-1,4,-1
KR_6764112749,420,1,12,20,4,4,0,4,4,1,5,1,4,5,-4,7,3,-1,1,0,0,0,6,0,-7,7,-1,0,2,1,1,1,1,3,-1
KR_6753295626,420,-1,-10,-22,4,3,1,4,-4,4,0,4,0,4,2,2,4,-1,1,0,0,1,1,3,-8,5,-2,0,0,-1,0,-1,1,5,-1
KR_6648310175,440,3,12,24,3,0,2,2,2,4,6,-4,9,5,1,0,1,4,1,5,-1,5,30,-1,-7,8,6,0,0,1,-1,0,-1,6,-1
KR_6411785710,420,-1,-38,-5,5,-2,4,2,2,0,2,2,2,4,0,3,3,3,0,3,0,12,8,7,-7,0,-2,0,-2,1,-1,-1,1,1,-1
KR_6742396497,420,2,6,-3,2,2,0,2,3,3,6,3,1,4,-7,9,2,1,1,2,0,-11,161,-3,-3,6,4,0,1,1,1,1,1,3,-1
KR_6370467893,420,1,-7,32,1,-3,4,1,1,1,2,3,5,8,1,1,2,-1,1,0,-1,5,0,0,0,0,-2,0,1,-1,1,-1,-1,1,-1
KR_6727994968,420,-3,-25,-31,0,1,0,1,3,1,4,1,1,2,-3,4,1,-2,2,0,0,-5,35,0,-4,4,-24,0,2,-1,1,1,-1,2,-1
KR_6609052092,420,2,-5,-16,7,-3,3,0,2,3,5,-1,5,4,7,0,7,2,0,2,0,14,1,0,-5,5,-3,0,0,1,-1,-1,-1,3,-1
KR_6763990423,420,-3,-49,-15,-5,1,1,2,-4,4,0,-4,9,5,3,0,3,-1,2,1,1,-6,158,-2,-4,6,-8,0,0,1,-1,0,-1,3,-1
KR_6649325940,420,1,-28,-1,4,-1,4,3,3,1,4,-1,3,2,2,1,3,1,0,1,0,5,3,-2,-3,5,-1,0,0,-1,-1,-1,1,3,-1
KR_6630984233,420,3,29,12,9,-1,2,1,6,1,7,1,0,1,2,0,2,1,0,1,0,10,5,10,-11,1,2,0,1,1,-1,1,1,4,-1
KR_6668091341,420,-5,-86,-4,-13,-2,4,2,-2,3,1,-3,3,0,-5,7,2,-1,1,0,0,-25,-4,-1,-5,6,-1,0,0,-1,1,-1,-1,6,-1
KR_6658703979,420,0,-32,24,1,-4,6,2,2,2,4,1,1,2,4,2,6,-2,3,1,4,-1,-2,-8,-4,12,0,0,-1,1,-1,-1,1,4,-1
KR_6768566707,420,1,61,8,-1,3,0,3,-3,3,0,-2,2,0,3,2,5,-2,2,0,1,-5,14,0,-5,5,0,0,0,1,0,0,1,6,-1
KR_6745471824,420,-3,-84,-12,-4,-2,2,0,1,1,2,-5,5,0,2,1,3,0,1,1,0,0,6,-3,-3,6,-3,0,-2,-1,1,-1,1,6,-1
KR_6546757677,420,-2,-33,-12,-7,-2,2,0,2,0,2,-4,9,5,0,2,2,-3,3,0,0,0,9,3,-7,4,-4,0,0,-1,-1,-1,1,1,-1
KR_6745493570,420,-1,-52,22,-2,2,3,5,-2,4,2,0,1,1,-2,5,3,0,2,2,0,-4,5,1,-7,6,-4,0,1,1,-1,1,1,3,-1
KR_6696747491,440,0,-32,0,0,-4,5,1,6,3,9,-4,4,0,-1,3,2,3,0,3,0,-5,-16,6,-12,6,2,0,-1,-1,1,-1,-1,6,-1
KR_6640216204,420,2,-36,-2,7,4,1,5,0,1,1,5,0,5,-6,6,0,4,0,4,1,4,-2,3,-7,4,6,0,-1,-1,1,-1,1,2,-1
KR_6730808256,440,0,56,6,-9,1,2,3,-3,3,0,-8,8,0,0,0,0,1,0,1,0,-14,-68,-5,-2,7,-2,0,-1,-1,-1,-1,-1,2,-1
KR_6715181026,420,-1,9,40,-5,1,0,1,-7,9,2,0,4,4,1,1,2,0,1,1,0,-16,12,-3,-3,6,-1,0,0,-1,1,0,-1,4,-1
KR_6762132392,420,-2,0,16,-3,2,0,2,-3,3,0,0,1,1,0,2,2,-2,2,0,0,-8,-6,-5,-2,7,1,0,0,1,0,0,1,3,-1
KR_6628454650,420,0,-55,16,1,3,2,5,2,0,2,-1,2,1,-4,5,1,1,0,1,-1,-6,32,-4,-1,5,-22,0,1,-1,1,1,-1,6,-1
KR_6752886272,420,-2,16,-5,-10,1,4,5,-4,4,0,-6,6,0,2,0,2,-3,3,0,0,-15,6,-3,-1,4,-3,0,-2,1,-1,-1,-1,1,-1
KR_6744739068,420,-3,-30,-12,-2,1,0,1,-3,5,2,1,3,4,0,1,1,-1,4,3,0,-6,22,3,-9,6,-1,0,-1,-1,1,-1,-1,6,-1
KR_6660678552,420,-1,-52,6,-1,3,0,3,3,0,3,0,0,0,-5,5,0,-2,2,0,0,-3,-9,-3,-5,8,-2,0,-1,-1,1,-1,1,5,-1
KR_6615421940,420,1,-10,8,6,1,1,2,-1,4,3,4,1,5,-1,2,1,3,1,4,0,0,2,1,-3,2,2,0,1,1,-1,1,1,6,-1
KR_6769399175,420,0,8,-17,-6,-1,3,2,-2,3,1,0,3,3,-1,6,5,-2,3,1,-2,-1,-15,0,-6,6,-2,0,0,-1,0,-1,-1,5,-1
KR_6766493754,420,-1,-26,-19,-6,-4,4,0,-3,7,4,2,0,2,-3,4,1,2,0,2,0,-10,15,2,-4,2,2,0,-1,-1,-1,-1,1,4,-1
KR_6759928209,420,0,-29,-6,-7,-11,11,0,5,1,6,2,1,3,-1,6,5,-2,2,0,0,2,-8,-1,-3,4,2,0,-3,-1,-1,-1,-1,3,-1
KR_6696393999,420,-2,-33,-36,-8,3,1,4,0,1,1,0,2,2,-8,9,1,-3,3,0,0,-11,-233,-2,-4,6,0,0,-2,-1,-1,-1,-1,6,-1
KR_6643906916,420,-1,23,21,-8,-1,4,3,1,3,4,-9,9,0,0,1,1,1,0,1,-2,-14,45,1,-4,3,-25,0,2,-1,1,1,-1,1,-1
KR_6754515312,440,-1,-12,-4,-6,0,3,3,-2,4,2,-4,6,2,-1,4,3,1,1,2,0,2,25,-7,-2,9,0,0,0,0,0,0,-1,0,-1
KR_6738201357,420,-2,-15,-4,4,1,0,1,2,1,3,1,0,1,-2,3,1,2,1,3,0,-1,14,4,-6,2,-4,0,0,-1,1,0,1,2,-1
KR_6769060554,420,-2,11,-37,-6,-1,1,0,-2,2,0,1,2,3,-2,4,2,-2,2,0,0,-6,15,-5,0,5,0,0,-1,-1,-1,-1,1,1,-1
KR_6732717966,420,-1,-33,-18,-2,2,1,3,-3,4,1,0,1,1,-1,5,4,0,1,1,0,-1,-124,6,-7,1,-3,0,-1,-1,1,-1,-1,4,-1
KR_6764688522,420,-2,0,-21,-4,0,2,2,1,1,2,2,6,8,-6,7,1,-1,1,0,1,0,-8,6,-9,3,-1,0,0,-1,-1,0,1,4,-1
KR_6743010103,420,-1,-27,20,-6,-3,4,1,-4,5,1,0,2,2,-1,5,4,2,1,3,0,-12,3,-3,-3,6,-2,0,1,-1,1,1,-1,2,-1
KR_6690427201,420,2,15,8,-4,0,3,3,1,2,3,0,2,2,-5,5,0,0,1,1,0,-7,2,-5,-2,7,-1,0,-1,1,-1,-1,1,5,-1
KR_6638951180,420,-3,-75,0,-2,1,2,3,0,5,5,0,3,3,-4,4,0,1,1,2,0,0,-13,-5,-7,12,-2,0,-2,1,-1,-1,1,6,-1
KR_6763037492,420,2,-5,0,0,0,3,3,0,1,1,2,1,3,-2,2,0,0,1,1,0,1,5,1,-7,6,2,0,0,1,0,0,-1,4,-1
KR_6630676382,440,1,-31,19,-1,1,1,2,3,1,4,2,2,4,-2,2,0,-5,5,0,0,-2,3,-1,-4,5,-1,0,1,-1,-1,1,1,1,-1
KR_6768514508,420,3,-18,-7,-3,2,0,2,3,2,5,2,2,4,-9,11,2,-1,1,0,0,-10,10,1,-6,5,-4,0,-1,-1,1,-1,1,5,-1
KR_6765855039,420,1,-25,-12,-5,4,0,4,0,2,2,-1,3,2,-4,4,0,-4,7,3,0,-5,-29,-4,-3,7,1,0,0,-1,1,1,-1,2,-1
KR_6733914693,420,1,-39,-28,-9,-1,4,3,-4,5,1,-4,6,2,2,3,5,-2,2,0,-3,-13,4,-2,-2,4,-6,0,-1,-1,-1,-1,-1,4,-1
KR_6760803795,420,-4,-44,-11,-12,-4,5,1,0,2,2,-3,4,1,-4,7,3,-1,1,0,0,-11,-167,-4,-3,7,-27,0,-1,0,1,-1,1,0,-1
KR_6733034436,420,-2,-27,-23,-10,-6,6,0,-4,7,3,3,0,3,-3,5,2,0,1,1,0,-9,-2,2,-7,5,-4,0,-1,-1,-1,-1,-1,1,-1
KR_6765451188,420,-2,-41,-35,-2,1,0,1,-2,3,1,0,2,2,-1,4,3,0,0,0,0,-3,44,4,-6,2,-38,0,1,1,1,1,-1,4,-1
KR_6755954342,420,2,15,11,3,2,0,2,1,1,2,2,3,5,-1,2,1,-1,1,0,0,0,29,-6,-4,10,-3,0,0,0,-1,0,1,0,-1
KR_6766290489,420,0,-16,-4,5,1,3,4,-1,3,2,0,1,1,3,0,3,2,1,3,0,6,12,-3,-4,7,-1,0,-1,0,1,-1,-1,0,-1
KR_6764883389,420,-2,-3,-18,-2,-2,2,0,-1,3,2,0,2,2,1,2,3,0,1,1,0,-3,13,0,-5,5,-4,0,-1,-1,1,1,-1,4,-1
KR_6712558283,420,1,5,12,2,-1,2,1,-4,5,1,3,1,4,3,1,4,1,1,2,0,4,3,0,-5,5,3,0,0,-1,1,1,-1,3,-1
KR_6703044674,440,-1,-47,-24,1,2,2,4,-1,2,1,1,2,3,-1,3,2,0,0,0,0,-5,-5,-1,-7,8,5,0,0,1,-1,0,-1,2,-1
KR_6769491728,420,-1,7,-20,-1,0,3,3,1,2,3,-3,4,1,0,3,3,1,1,2,0,-4,-19,-1,-4,5,23,0,0,0,-1,0,-1,0,-1
KR_6622537035,420,-1,2,10,-8,-1,2,1,-3,5,2,0,0,0,-3,5,2,-1,2,1,0,-8,-7,2,-9,7,-4,0,-1,-1,-1,-1,-1,4,-1
KR_6765319060,420,-5,0,-29,-13,-1,1,0,-4,4,0,1,1,2,-10,12,2,1,1,2,0,-14,-66,4,-7,3,0,0,0,-1,-1,-1,-1,1,-1
KR_6766838960,420,3,-7,-20,6,7,1,8,-2,2,0,0,1,1,-1,2,1,2,1,3,-1,3,15,9,-12,3,2,0,1,0,0,1,-1,0,-1
KR_6698057200,420,1,11,32,-4,-2,4,2,0,2,2,2,0,2,-2,2,0,-2,2,0,0,-3,-263,-3,-6,9,-16,0,0,-1,1,0,-1,4,-1
KR_6722478551,420,-1,26,-14,-1,2,0,2,-2,4,2,-2,7,5,1,0,1,0,0,0,0,4,6,5,-9,4,3,0,-1,1,-1,-1,-1,1,-1
KR_6768351893,440,-1,-41,-24,-9,0,0,0,-5,8,3,-1,2,1,-3,5,2,0,1,1,0,-12,-1,0,-5,5,-5,0,-1,-1,-1,-1,-1,4,-1
KR_6760366857,420,-3,-39,-10,-7,-1,1,0,2,1,3,-2,5,3,-6,7,1,0,1,1,0,-3,-7,-4,-3,7,-5,0,-3,-1,-1,-1,1,2,-1
KR_6672151003,420,-4,-82,-14,-14,-5,6,1,-3,4,1,-3,4,1,-6,6,0,3,0,3,-1,-20,6,-3,-7,10,2,0,-1,-1,-1,-1,-1,5,-1
KR_6665143554,420,-7,-98,-44,-13,-5,5,0,-4,8,4,0,1,1,-2,3,1,-2,2,0,0,-12,254,0,-4,4,-5,0,-2,-1,-1,-1,-1,1,-1
KR_6769807210,420,-3,-127,4,-8,-9,9,0,-1,2,1,0,5,5,1,0,1,1,1,2,0,-1,-43,-2,-4,6,17,0,-2,-1,-1,-1,-1,5,-1
KR_6717681720,420,-7,-98,-31,-7,-3,5,2,0,3,3,-2,2,0,1,1,2,-3,4,1,0,-6,-3,-4,-4,8,-1,0,-1,1,-1,-1,1,6,-1
KR_6672909485,440,-1,-39,24,-2,-3,4,1,-3,4,1,-1,2,1,2,0,2,3,1,4,0,-3,-174,2,-5,3,1,0,1,1,1,1,-1,2,-1
KR_6669110553,420,-2,-4,4,-1,2,1,3,2,1,3,0,2,2,-3,4,1,-2,2,0,0,-5,-9,-1,-5,6,5,0,1,-1,1,1,1,2,-1
KR_6766112382,420,-3,4,-1,-4,-1,2,1,-5,6,1,6,1,7,-2,4,2,-2,4,2,0,-10,-166,0,-5,5,3,0,-1,1,-1,-1,-1,6,-1
KR_6691161210,420,-3,47,28,-7,-1,3,2,-1,3,2,1,2,3,-4,4,0,-2,4,2,0,-15,-3,2,-6,4,-1,0,0,1,1,0,1,1,-1
KR_6759993717,420,-1,-65,1,-1,-3,3,0,4,2,6,1,2,3,-2,2,0,-1,1,0,0,2,2,-3,-3,6,-4,0,1,-1,1,1,-1,5,-1
KR_6731540678,440,-1,22,-4,-5,-4,4,0,-1,4,3,0,1,1,-2,3,1,2,2,4,0,-4,3,6,-8,2,-1,0,0,0,-1,0,-1,0,-1
KR_6764412426,420,-6,-29,-27,-13,4,1,5,-4,5,1,1,2,3,-11,12,1,-3,3,0,0,-11,23,2,-5,3,-8,0,0,-1,0,-1,-1,4,-1
KR_6720182709,420,-2,47,-43,-10,0,1,1,0,3,3,-12,13,1,5,0,5,-3,3,0,-1,-6,2,6,-7,1,1,0,0,-1,-1,1,-1,4,-1
KR_6768718826,440,-2,-43,15,6,-1,1,0,5,0,5,0,4,4,-1,2,1,3,2,5,-1,10,-202,3,-6,3,-1,0,0,-1,1,0,-1,5,-1
KR_6764629391,420,-2,-56,-28,-4,6,0,6,-5,7,2,-3,5,2,-2,5,3,0,1,1,0,0,70,0,-2,2,-4,0,0,-1,-1,-1,-1,1,-1
KR_6724342109,420,-4,-65,-3,-10,-6,7,1,-2,5,3,4,2,6,-9,12,3,3,3,6,-2,-19,15,1,-7,6,-7,0,-1,-1,1,-1,1,1,-1
KR_6758810983,420,-3,-51,-37,-3,-2,2,0,2,0,2,2,2,4,-4,5,1,-1,1,0,0,-4,-1,0,-6,6,-3,0,0,-1,-1,0,1,1,-1
KR_6760534227,420,-4,19,-12,-4,0,2,2,0,1,1,-2,3,1,-1,6,5,-1,1,0,2,4,-18,-9,-2,11,7,0,0,0,1,0,1,0,-1
KR_6708615154,420,-1,31,13,-5,-5,6,1,-5,5,0,1,3,4,1,1,2,3,0,3,3,0,59,6,-10,4,-15,0,0,-1,1,1,1,2,-1
KR_6745170001,420,-2,-78,11,6,0,4,4,2,2,4,1,0,1,0,1,1,3,0,3,0,8,145,4,-11,7,-1,0,-1,1,-1,-1,1,1,-1
KR_6761877196,440,-3,-52,-16,0,-2,2,0,1,2,3,-2,5,3,4,4,8,-1,2,1,2,5,-2,3,-5,2,1,0,-1,0,0,-1,1,0,-1
KR_6743839645,420,-5,-25,-23,-13,-12,13,1,2,2,4,1,3,4,-6,6,0,2,1,3,2,-7,-15,1,-1,0,3,0,-3,-1,-1,-1,1,4,-1
KR_6766433378,420,1,-16,2,-1,2,0,2,-1,6,5,1,2,3,-1,2,1,-2,2,0,0,3,22,-2,-2,4,2,0,-1,1,-1,-1,-1,2,-1
KR_6754026033,420,-6,-31,-40,-10,0,4,4,-3,4,1,-2,3,1,-6,11,5,1,0,1,0,-6,1,1,-8,7,-2,0,0,-1,-1,-1,1,1,-1
KR_6754435745,420,-6,-32,-13,-11,-5,5,0,-3,4,1,-2,3,1,0,2,2,-1,1,0,0,-5,-5,-7,-1,8,3,0,-1,-1,1,-1,-1,2,-1
KR_6706306362,420,2,47,16,-1,-1,1,0,2,1,3,-1,2,1,-1,2,1,0,1,1,0,0,113,1,-6,5,1,0,0,1,1,1,1,4,-1
KR_6725450237,420,-5,-36,-28,-2,-2,2,0,-5,5,0,4,0,4,1,3,4,0,1,1,0,-1,-4,0,-5,5,-3,0,-2,-1,-1,-1,1,2,-1
KR_6764686918,420,-3,-67,9,-4,1,2,3,-1,1,0,-3,3,0,-2,2,0,1,1,2,-1,-10,9,-3,-3,6,0,0,-1,-1,-1,-1,-1,1,-1
KR_6752395855,420,-2,-57,-18,-1,1,1,2,5,1,6,-5,7,2,-3,3,0,1,1,2,0,1,-8,0,-2,2,-3,0,-2,-1,-1,-1,-1,5,-1
KR_6744449064,420,1,52,33,-6,0,3,3,-4,4,0,1,2,3,-3,3,0,0,0,0,0,-7,-6,-8,-1,9,-4,0,-2,-1,1,-1,-1,5,-1
KR_6768762740,420,-3,-15,-23,-3,-1,2,1,-2,4,2,2,1,3,-3,7,4,1,1,2,0,-4,6,2,-6,4,1,0,1,-1,1,1,-1,3,-1
KR_6729850627,420,1,20,1,1,2,1,3,1,1,2,-2,4,2,1,4,5,-1,2,1,0,-4,3,4,-7,3,-3,0,-1,-1,1,-1,1,5,-1
KR_6664854490,420,0,-54,-11,1,-1,5,4,-1,3,2,4,0,4,-1,1,0,0,1,1,-1,7,-2,0,-8,8,0,0,-1,-1,1,-1,-1,5,-1
KR_6762965555,420,0,31,-24,-7,-2,4,2,-5,7,2,0,0,0,0,6,6,0,0,0,0,-10,1,-2,-2,4,7,0,0,-1,0,0,-1,6,-1
KR_6753230956,420,-3,-4,2,-5,-3,3,0,5,0,5,-7,8,1,-1,6,5,1,0,1,0,9,57,1,-8,7,-5,0,0,1,-1,-1,-1,2,-1
KR_6760877837,420,2,-19,8,6,4,1,5,3,0,3,-3,4,1,2,0,2,0,1,1,0,6,10,-1,-5,6,6,0,1,1,-1,1,1,2,-1
KR_6740645907,420,3,65,40,3,4,0,4,2,2,4,1,1,2,-4,5,1,0,2,2,0,-3,-8,1,-5,4,-1,0,0,0,0,1,-1,0,-1
KR_6755591962,420,-1,9,8,0,-5,5,0,0,2,2,4,3,7,2,1,3,-1,2,1,0,8,17,0,-3,3,-1,0,-1,1,-1,-1,-1,6,-1
KR_6750213890,420,-4,-70,1,-12,1,1,2,-5,6,1,-3,3,0,-4,4,0,-1,1,0,0,-18,9,2,-6,4,-6,0,-1,-1,1,-1,-1,1,-1
KR_6742508995,420,3,19,31,4,-4,5,1,5,0,5,-2,2,0,1,3,4,4,0,4,0,8,-8,-3,-2,5,7,0,0,-1,-1,-1,1,5,-1
KR_6751074749,420,1,45,-3,1,0,1,1,0,0,0,0,1,1,0,3,3,1,2,3,0,-4,-7,-4,-4,8,5,0,1,-1,-1,1,1,4,-1
KR_6751602614,420,1,-42,-56,2,-4,6,2,-1,2,1,4,1,5,0,1,1,3,0,3,0,3,7,-4,-4,8,-2,0,1,-1,-1,1,-1,2,-1
KR_6743804632,440,-2,-5,-4,-4,-2,2,0,0,5,5,-1,3,2,-1,5,4,0,2,2,-1,-8,-10,3,-6,3,-1,0,1,1,1,1,-1,4,-1
KR_6762880719,420,-1,-84,-4,-4,0,2,2,-3,3,0,-3,3,0,1,1,2,1,0,1,0,-4,-59,0,-4,4,23,0,-2,1,-1,-1,-1,5,-1
KR_6741013524,420,3,28,32,2,-3,4,1,6,0,6,2,2,4,-2,4,2,-1,1,0,0,1,-1,2,-8,6,3,0,1,0,1,1,1,0,-1
KR_6742383445,420,-5,-72,-69,-8,1,1,2,2,4,6,-3,6,3,-8,8,0,0,1,1,-1,-6,-7,0,-3,3,-2,0,-5,-1,-1,-1,-1,6,-1
KR_6755163353,420,-1,-31,-32,-8,0,1,1,-6,6,0,-4,4,0,2,2,4,0,1,1,-1,-4,13,-3,-3,6,3,0,0,1,-1,0,-1,2,-1
KR_6704353142,420,-1,43,9,-3,3,0,3,-1,3,2,-1,1,0,-3,4,1,-1,2,1,-1,-9,12,-2,-3,5,1,0,0,-1,-1,0,-1,3,-1
KR_6665906435,420,0,80,-28,-2,1,3,4,3,0,3,-10,12,2,2,1,3,2,1,3,0,4,6,1,-4,3,7,0,0,-1,1,0,-1,5,-1
KR_6769383373,420,-2,-47,-19,0,-2,3,1,-2,4,2,1,2,3,1,2,3,2,2,4,0,7,9,5,-6,1,-4,0,-1,1,-1,-1,-1,5,-1
KR_6641766234,420,1,-20,-5,1,-1,3,2,2,2,4,3,0,3,-3,3,0,0,1,1,0,1,-159,-3,-2,5,26,0,-1,-1,-1,-1,1,1,-1
KR_6566024853,420,-5,-79,-9,-5,0,0,0,2,3,5,0,0,0,-6,10,4,-1,1,0,-1,-7,-4,1,-7,6,-2,0,0,1,1,-1,-1,4,-1
KR_6735949323,440,-5,-30,20,-11,-2,4,2,-4,5,1,-2,6,4,0,4,4,-3,3,0,0,-5,-2,-4,-2,6,1,0,-1,-1,-1,-1,1,3,-1
KR_6683286549,440,1,-61,53,2,-1,3,2,5,1,6,0,2,2,-2,5,3,0,2,2,0,-5,-2,2,-4,2,-1,0,1,-1,1,1,-1,6,-1
KR_6761410373,420,-2,-33,0,-8,-1,2,1,1,3,4,-3,3,0,-2,3,1,-3,3,0,-1,-2,-32,-6,-2,8,1,0,-2,0,1,-1,-1,0,-1
KR_6757632968,420,-3,-44,-12,-10,-2,3,1,-2,2,0,-1,5,4,-5,7,2,0,1,1,-2,-13,-5,-3,-3,6,0,0,-1,-1,-1,-1,-1,4,-1
KR_6768892071,420,-2,-55,4,-5,-1,2,1,1,0,1,-7,8,1,1,1,2,1,0,1,0,6,-1,-5,-3,8,-2,0,-2,0,-1,-1,-1,0,-1
KR_6693105390,420,3,10,38,6,4,0,4,1,1,2,4,1,5,-1,2,1,-2,2,0,1,4,32,4,-8,4,-1,0,1,1,1,1,1,4,-1
KR_6758225019,420,0,-31,36,-4,3,0,3,-3,4,1,-2,4,2,-1,1,0,-1,4,3,0,-9,-1,-1,-7,8,2,0,1,1,1,1,-1,4,-1
KR_6767962107,420,-2,-66,5,1,2,1,3,-2,3,1,0,1,1,0,1,1,1,1,2,0,4,49,2,-4,2,-20,0,-1,-1,-1,-1,1,5,-1
KR_6751668876,420,-3,-47,-8,-2,0,2,2,0,4,4,-6,8,2,4,0,4,0,0,0,0,4,-7,1,-6,5,2,0,-2,-1,-1,-1,-1,5,-1
KR_6696808278,420,-3,-21,-12,-7,0,1,1,-5,6,1,-4,4,0,1,1,2,1,0,1,0,-2,-13,-7,-3,10,0,0,0,-1,0,0,-1,2,-1
KR_6755670260,420,-2,0,0,-11,-1,1,0,-8,9,1,-2,2,0,-1,3,2,1,2,3,-1,-8,-102,-5,-3,8,2,0,0,1,0,1,-1,3,-1
KR_6768621288,420,-4,-14,-22,-6,2,0,2,0,2,2,0,1,1,-3,5,2,-5,7,2,0,-6,-163,4,-7,3,28,0,-1,-1,1,-1,1,4,-1
KR_6768045612,420,-3,27,-12,-9,1,2,3,-2,5,3,-5,5,0,0,4,4,-3,3,0,-2,-19,-6,4,-7,3,-1,0,-1,-1,0,-1,-1,3,-1
KR_6754004913,420,-3,-11,-22,-10,-9,9,0,3,1,4,-1,7,6,-3,6,3,0,1,1,-4,-5,133,0,-4,4,-4,0,-1,0,-1,-1,-1,0,-1
KR_6568967037,420,-10,-107,-28,-26,-6,8,2,-10,11,1,-6,8,2,-1,5,4,-3,3,0,-1,-27,-5,3,-6,3,-2,0,-4,-1,-1,-1,-1,1,-1
KR_6761547503,420,0,-33,-19,5,1,1,2,4,0,4,0,4,4,1,3,4,-1,2,1,0,5,98,2,-5,3,-2,0,-1,1,-1,-1,1,4,-1
KR_6764456655,420,-6,-89,-16,-9,-8,8,0,-2,3,1,0,1,1,2,1,3,-1,1,0,0,-6,3,4,-10,6,-8,0,-4,-1,-1,-1,-1,5,-1
KR_6692530886,420,-2,-22,7,-3,-1,1,0,-2,4,2,1,2,3,-2,2,0,1,0,1,-1,-4,-3,1,-4,3,2,0,1,1,-1,-1,-1,2,-1
KR_6750736177,440,-1,-52,15,-3,-3,6,3,1,2,3,-2,4,2,0,0,0,1,0,1,0,1,-297,0,-4,4,-3,0,0,-1,1,0,1,3,-1
KR_6749218370,420,2,48,37,3,1,0,1,3,2,5,5,0,5,-8,9,1,2,0,2,0,0,-1,-4,-3,7,2,0,1,-1,1,1,1,1,-1
KR_6679012555,420,-2,-79,-31,-4,-1,1,0,-1,2,1,-2,4,2,-1,3,2,1,0,1,0,-2,-140,-5,-2,7,4,0,-3,1,1,1,-1,3,-1
KR_6769158681,420,0,-100,-36,-6,-1,3,2,3,2,5,-4,4,0,-2,4,2,-2,2,0,-1,-2,54,0,-6,6,1,0,-1,-1,-1,-1,-1,2,-1
KR_6759783003,420,-5,2,7,-9,-1,1,0,-4,6,2,-3,5,2,-3,4,1,2,0,2,0,-13,358,0,-3,3,0,0,0,-1,1,0,-1,2,-1
KR_6485572144,420,0,-59,7,-2,-1,2,1,-3,4,1,1,1,2,2,0,2,-1,1,0,-1,-1,-10,2,-3,1,0,0,0,-1,1,0,-1,4,-1
KR_6682769249,420,-3,-77,-16,-4,1,0,1,1,3,4,-3,3,0,-2,4,2,-1,1,0,0,0,28,0,-5,5,-27,0,0,-1,-1,-1,-1,1,-1
KR_6758279819,420,-6,-83,-3,-9,-3,6,3,0,2,2,-4,5,1,-1,3,2,-1,4,3,1,-5,9,-4,-5,9,4,0,0,1,-1,-1,1,6,-1
KR_6763988686,420,-1,-67,3,-4,-4,4,0,3,1,4,3,3,6,-4,5,1,-2,3,1,0,-6,-12,-1,-6,7,-1,0,-1,0,0,-1,-1,0,-1
KR_6765867693,440,-5,-81,-28,-9,-2,3,1,-2,3,1,0,2,2,-9,11,2,4,0,4,0,-7,25,0,-5,5,1,0,-2,1,-1,-1,-1,5,-1
KR_6707188168,420,0,-8,-16,0,-3,5,2,2,2,4,2,2,4,-1,6,5,0,3,3,0,0,104,-2,-2,4,0,0,-1,1,-1,-1,1,1,-1
KR_6619661102,420,-1,-8,19,-1,-1,1,0,0,4,4,-1,5,4,0,1,1,1,0,1,0,-7,-13,1,-5,4,1,0,0,-1,0,0,1,3,-1
KR_6703550024,440,0,37,-3,-1,-1,2,1,1,5,6,0,1,1,-3,5,2,2,0,2,0,5,-8,-4,-1,5,2,0,-1,1,-1,-1,1,2,-1
KR_6601760747,420,1,23,-14,1,3,2,5,1,3,4,-1,4,3,-1,3,2,-1,1,0,0,1,2,3,-6,3,-2,0,-1,-1,-1,-1,1,5,-1
KR_6747684132,420,-3,-43,-7,-10,2,0,2,-1,3,2,-3,4,1,-7,8,1,-1,2,1,0,-6,-84,0,-8,8,-6,0,-1,1,1,-1,-1,1,-1
KR_6474756802,420,0,-42,19,0,-1,1,0,-1,2,1,3,3,6,-1,1,0,0,0,0,0,-3,-3,-6,-2,8,-1,0,0,-1,1,-1,-1,2,-1
KR_6656739954,420,-4,-55,0,-6,-4,4,0,-2,3,1,-2,4,2,0,1,1,2,0,2,0,-3,0,-2,-4,6,-2,0,-2,-1,-1,-1,-1,2,-1
KR_6750945125,420,-2,-58,-19,-9,-5,8,3,-5,6,1,-3,4,1,4,3,7,0,0,0,0,-5,-1,-1,-3,4,0,0,-1,-1,1,-1,-1,1,-1
KR_6756410982,440,-3,-92,-29,-8,-2,2,0,-3,3,0,0,0,0,-2,4,2,-1,2,1,0,-6,-3,0,-2,2,1,0,0,0,-1,-1,-1,0,-1
KR_6680003602,420,-1,-21,12,-5,0,3,3,-3,4,1,-4,4,0,-4,4,0,6,0,6,0,-6,11,-3,-5,8,-2,0,-1,-1,1,-1,-1,1,-1
KR_6756426632,440,0,-21,-39,2,1,1,2,-2,4,2,-2,2,0,3,2,5,2,1,3,0,1,16,-1,-6,7,-1,0,0,-1,-1,0,-1,5,-1
KR_6654060064,440,3,5,16,3,1,2,3,4,1,5,1,1,2,-4,4,0,1,0,1,0,3,6,2,-5,3,1,0,0,-1,-1,-1,-1,6,-1
KR_6672315851,440,-4,-50,20,-4,-2,2,0,-2,2,0,2,2,4,0,4,4,-2,2,0,0,-4,5,2,-5,3,-6,0,-1,1,-1,-1,1,6,-1
KR_6698133078,420,1,117,-4,-1,1,0,1,-1,3,2,-2,2,0,0,1,1,1,1,2,0,1,-39,4,-7,3,0,0,0,-1,1,1,-1,1,-1
KR_6757502891,420,-4,-34,24,-9,-2,2,0,-5,8,3,-1,1,0,0,4,4,-1,1,0,0,-8,-4,3,-6,3,1,0,0,-1,0,-1,-1,1,-1
KR_6769843917,420,-5,-48,-8,-14,-4,4,0,-2,4,2,-1,3,2,-5,5,0,-2,2,0,0,-11,3,-5,-7,12,-7,0,-1,1,-1,-1,-1,1,-1
KR_6758249447,420,1,13,16,4,7,1,8,0,1,1,-1,3,2,-3,4,1,1,0,1,1,-4,-4,1,-4,3,-1,0,1,-1,1,1,1,4,-1
KR_6734614979,420,-3,-96,-13,-7,-3,3,0,-3,4,1,-5,6,1,-2,2,0,6,0,6,0,-3,-3,-5,-3,8,-2,0,0,-1,-1,-1,-1,4,-1
KR_6766971125,420,-6,-49,-38,-12,-4,4,0,-1,3,2,-1,2,1,-1,4,3,-5,6,1,0,1,-118,1,-7,6,0,0,0,-1,1,0,-1,5,-1
KR_6760660585,420,-1,-2,28,-4,-1,3,2,3,1,4,-6,6,0,1,1,2,-1,1,0,0,3,28,4,-4,0,2,0,0,-1,1,1,-1,3,-1
KR_6732257060,420,1,8,36,-3,-2,2,0,0,1,1,-2,2,0,0,5,5,1,1,2,0,-4,-3,2,-8,6,7,0,0,1,-1,0,-1,1,-1
KR_6557399078,420,-2,17,-7,-14,-3,4,1,0,2,2,-3,6,3,-5,5,0,-3,4,1,-1,-15,-73,-4,-2,6,0,0,-1,-1,-1,-1,-1,2,-1
KR_6767455653,420,-2,-63,-3,-10,-3,4,1,-1,1,0,-1,2,1,-4,6,2,-1,2,1,0,-9,2,0,-4,4,-3,0,-2,-1,-1,-1,-1,3,-1
KR_6696466939,440,1,28,6,2,0,4,4,2,1,3,-2,3,1,3,1,4,-1,1,0,1,1,5,-1,-6,7,-1,0,-1,1,-1,-1,1,1,-1
KR_6761238189,420,-1,-51,-17,-6,0,1,1,0,2,2,-1,2,1,-2,2,0,-3,4,1,0,1,-23,3,-8,5,13,0,-2,-1,-1,-1,-1,2,-1
KR_6519148801,440,-1,-51,17,-3,-1,1,0,-1,6,5,-2,5,3,1,3,4,0,1,1,0,-5,44,4,-9,5,-13,0,-2,-1,-1,-1,1,4,-1
KR_6751565452,440,-2,-44,20,-2,-2,3,1,1,2,3,1,4,5,1,2,3,-3,5,2,0,-1,4,2,-4,2,-2,0,0,0,1,-1,1,0,-1
KR_6678860409,420,1,73,20,-5,-2,2,0,3,2,5,-8,9,1,1,2,3,1,0,1,0,-2,2,-2,-5,7,-2,0,0,1,-1,1,-1,2,-1
KR_6763695530,420,1,-31,8,3,-3,5,2,3,0,3,-1,2,1,4,0,4,0,0,0,0,7,-4,-3,-4,7,0,0,0,-1,-1,0,1,1,-1
KR_6682964514,420,-2,-59,23,-8,-1,2,1,-3,4,1,0,1,1,-3,3,0,-1,1,0,0,-14,-4,2,-5,3,-2,0,0,1,0,0,-1,4,-1
KR_6768647288,420,-2,-10,10,-2,3,2,5,-4,4,0,-2,5,3,4,4,8,-3,4,1,-3,-12,13,1,-7,6,-3,0,1,1,-1,1,-1,4,-1
KR_6764104231,420,-1,33,-12,1,-1,5,4,-2,3,1,0,1,1,6,0,6,-2,2,0,1,11,1,-2,-2,4,-3,0,-1,-1,-1,-1,1,3,-1
KR_6729412882,420,-6,-85,-16,-2,-2,2,0,3,6,9,-6,6,0,1,2,3,2,2,4,0,-6,29,0,-5,5,-1,-1,-3,-1,-1,-1,1,3,-1
KR_6643740820,420,0,-1,53,0,3,1,4,0,1,1,0,0,0,-1,2,1,-2,2,0,1,1,10,2,-7,5,-8,0,-1,0,1,-1,1,0,-1
KR_6643504547,420,-2,-63,0,-6,-2,4,2,2,1,3,-1,3,2,-5,6,1,0,0,0,0,-5,-36,-1,-3,4,5,0,-2,-1,-1,-1,-1,2,-1
KR_6750975167,420,-3,-35,11,-8,0,3,3,-1,2,1,-3,4,1,-2,2,0,-2,2,0,1,-2,4,-1,-5,6,0,0,0,-1,1,0,1,6,-1
KR_6685914700,420,-2,9,-12,0,2,0,2,-3,6,3,-1,3,2,2,2,4,0,1,1,1,2,-2,3,-11,8,11,0,0,0,-1,-1,1,0,-1
KR_6738854765,420,-2,-23,0,-2,1,3,4,5,0,5,2,3,5,-5,5,0,-5,5,0,0,-2,-58,4,-9,5,-2,0,-1,1,-1,-1,1,1,-1
KR_6734605391,420,1,6,4,-1,-1,1,0,-6,6,0,2,2,4,5,1,6,-1,3,2,2,1,-37,1,-3,2,25,0,1,-1,1,1,1,6,-1
KR_5736817423,420,-4,-26,11,-8,-3,3,0,0,6,6,-4,5,1,-1,3,2,0,1,1,0,-12,51,3,-11,8,-12,0,-1,1,-1,-1,1,4,-1
KR_6641469361,420,-3,-56,-8,-9,-3,4,1,2,1,3,-6,6,0,0,5,5,-2,3,1,0,-5,-9,-3,-6,9,3,0,-2,1,1,-1,-1,5,-1
KR_6761550273,420,0,-37,1,7,1,1,2,4,0,4,2,2,4,0,1,1,0,2,2,0,8,-2,2,-4,2,0,0,0,-1,1,0,-1,3,-1
KR_6761621252,420,-1,32,11,-5,-1,1,0,-2,2,0,-6,6,0,4,2,6,0,2,2,0,-8,1,1,-4,3,-2,0,0,0,-1,0,1,0,-1
KR_6751937050,420,-1,-92,-27,2,-1,3,2,0,2,2,-2,2,0,5,2,7,0,0,0,0,7,-5,-7,-2,9,5,0,-2,1,-1,-1,1,6,-1
KR_6766580144,420,-6,-42,-44,-13,-6,7,1,-5,6,1,2,1,3,-2,4,2,-2,2,0,0,-13,-16,-1,-4,5,-4,0,-1,-1,-1,-1,-1,2,-1
KR_6750035250,420,-5,10,20,-14,-4,4,0,-9,9,0,0,2,2,0,3,3,-1,2,1,0,-13,547,0,-3,3,-4,0,-1,1,-1,-1,1,6,-1
KR_6706517789,420,2,11,0,3,-3,4,1,-1,3,2,-1,2,1,2,2,4,6,1,7,1,7,-318,2,-4,2,-1,0,-1,-1,-1,-1,1,1,-1
KR_6714488358,440,-5,-78,-16,-11,-3,4,1,-4,6,2,0,1,1,0,1,1,-4,5,1,-1,-6,6,0,-2,2,0,0,-3,-1,1,-1,-1,5,-1
KR_6689591481,420,0,-52,-20,-7,0,2,2,-5,5,0,-2,2,0,2,2,4,-2,2,0,0,-11,11,1,-7,6,-8,0,-1,-1,-1,-1,-1,5,-1
KR_6753950674,420,-2,-24,8,-4,-1,1,0,-2,7,5,-2,5,3,1,4,5,0,0,0,0,-4,-9,3,-6,3,20,0,0,-1,1,1,-1,6,-1
KR_6766428822,420,-2,-81,0,-5,-4,4,0,2,1,3,0,3,3,-2,4,2,-1,2,1,-2,0,4,1,-7,6,-1,0,-1,0,1,-1,-1,0,-1
KR_6765184740,420,0,-7,-9,-2,5,4,9,-2,6,4,1,3,4,-4,8,4,-2,3,1,-3,-5,81,-4,-4,8,0,0,0,1,1,1,1,5,-1
KR_6728054685,420,-3,-34,-9,-5,0,2,2,-1,3,2,-3,3,0,-1,5,4,0,1,1,0,-2,-344,0,-5,5,-3,0,-1,-1,1,-1,-1,3,-1
KR_6768292836,440,-2,-40,-11,-11,-1,3,2,-4,6,2,-3,3,0,-4,6,2,1,0,1,0,-9,-5,-1,-4,5,2,0,-1,1,-1,-1,-1,2,-1
KR_6570616181,420,-1,34,-1,-5,-2,3,1,-1,2,1,-1,1,0,-1,3,2,0,0,0,0,-3,40,3,-6,3,-21,0,1,-1,1,1,-1,4,-1
KR_6767085871,420,-1,7,-8,-1,-4,5,1,3,3,6,1,3,4,0,3,3,-1,2,1,0,9,-178,0,-6,6,30,0,-1,-1,1,-1,1,3,-1
KR_6760272502,440,1,49,48,-3,6,0,6,2,0,2,-1,2,1,-9,12,3,-1,2,1,0,-13,11,-2,-4,6,-6,0,1,-1,1,1,-1,4,-1
KR_6769176439,420,-1,-27,16,3,1,3,4,1,2,3,3,1,4,0,2,2,-2,2,0,0,19,3,5,-6,1,-4,0,0,0,-1,0,1,0,-1
KR_6734216691,420,-2,31,-10,-5,0,3,3,-2,4,2,-3,5,2,-1,5,4,1,1,2,0,2,-268,2,-3,1,0,0,0,-1,1,-1,1,6,-1
KR_6566428998,420,0,-20,25,0,-2,3,1,-1,7,6,-1,5,4,2,4,6,2,0,2,1,1,-8,-5,-5,10,4,0,0,1,-1,0,1,5,-1
KR_6693811222,420,-2,-36,-2,-8,-1,1,0,-4,5,1,-1,2,1,-3,5,2,1,0,1,0,-15,0,-3,-4,7,3,0,1,-1,-1,1,-1,6,-1
KR_6758043033,420,2,-25,-18,6,5,0,5,-2,3,1,5,1,6,-2,2,0,0,0,0,0,1,6,1,-7,6,-4,0,0,1,1,1,1,3,-1
KR_6757858541,420,-3,-31,11,-14,4,0,4,-8,11,3,-3,4,1,-2,4,2,-5,6,1,0,-17,-3,2,-6,4,-6,0,-1,-1,1,-1,-1,3,-1
KR_6649394675,420,-1,-22,0,3,0,4,4,1,6,7,2,2,4,0,2,2,0,1,1,0,5,-229,0,-3,3,5,0,0,1,1,0,1,6,-1
KR_6760448141,420,-2,-52,-41,1,0,4,4,3,4,7,-1,5,4,-1,4,3,0,0,0,-1,-2,53,6,-11,5,-1,0,0,-1,-1,-1,-1,2,-1
KR_6596893471,440,-3,-48,-20,-4,2,0,2,-1,3,2,0,3,3,-1,3,2,-4,4,0,-1,-5,-8,1,-3,2,-2,0,0,1,0,0,-1,5,-1
KR_6750911433,420,0,-38,-12,4,0,1,1,-2,3,1,-7,8,1,5,2,7,8,0,8,0,6,-5,0,-7,7,1,0,-1,0,-1,-1,-1,0,-1
KR_6618564169,420,-4,-52,-48,-11,-7,7,0,-5,6,1,4,2,6,0,4,4,-3,4,1,0,-6,2,-3,-3,6,0,0,-1,0,-1,-1,-1,0,-1
KR_6544446771,420,-5,-29,-21,-12,-1,1,0,-7,7,0,-2,3,1,0,4,4,-2,3,1,-2,-19,8,-3,-1,4,-5,0,0,-1,-1,-1,-1,4,-1
KR_6744657751,420,-2,-85,-52,-4,4,1,5,-4,8,4,-2,3,1,-1,4,3,-1,3,2,0,-8,-2,-1,-5,6,3,0,-1,-1,1,1,-1,2,-1
KR_6686291814,420,-1,65,32,-5,-2,2,0,-2,4,2,0,3,3,2,2,4,-3,3,0,2,-3,-102,-2,-2,4,2,0,0,1,1,1,1,6,-1
KR_6739091314,420,3,99,25,6,6,0,6,3,3,6,2,1,3,-4,7,3,-1,1,0,0,4,-1,2,-5,3,-3,0,0,1,1,1,-1,3,-1
KR_6660378708,420,-4,-159,20,-9,-5,5,0,1,3,4,-4,5,1,-3,6,3,2,0,2,0,-7,-6,-4,-3,7,0,0,-2,1,-1,-1,-1,4,-1
KR_6616250321,420,4,52,20,1,-2,3,1,2,1,3,-1,4,3,1,2,3,1,0,1,0,10,6,-6,-4,10,3,0,0,1,-1,0,-1,1,-1
KR_6768849554,440,1,-24,12,-1,4,0,4,-4,5,1,-2,5,3,-1,6,5,2,4,6,-1,-6,2,0,-3,3,0,0,0,0,1,0,-1,0,-1
KR_6768250693,420,-2,-57,-16,1,-2,2,0,0,3,3,-3,5,2,6,0,6,0,1,1,0,6,48,0,-4,4,-3,0,-1,1,-1,-1,1,3,-1
KR_6700141156,420,0,-13,16,-1,2,1,3,-4,5,1,-2,3,1,4,1,5,-1,2,1,0,0,11,-1,-3,4,-3,0,0,-1,-1,0,-1,1,-1
KR_6764934533,420,-2,-52,3,-3,-2,3,1,1,3,4,-7,10,3,3,0,3,2,0,2,0,0,-39,-1,-4,5,22,0,0,1,-1,-1,1,1,-1
KR_6762299250,420,3,107,0,7,1,1,2,2,0,2,4,0,4,1,2,3,-1,2,1,0,2,239,5,-10,5,0,0,2,1,1,1,1,2,-1
KR_6735992203,440,0,-1,32,3,4,0,4,-1,2,1,-2,4,2,2,5,7,0,0,0,0,6,-26,-4,-4,8,2,0,1,1,1,1,1,6,-1
KR_6695134664,420,-6,1,9,-2,-2,2,0,-1,2,1,1,1,2,-1,4,3,1,0,1,-1,2,0,1,-7,6,-2,0,1,-1,1,1,-1,4,-1
KR_6762749283,420,-2,0,-16,-7,0,2,2,1,4,5,-3,5,2,-4,5,1,-1,1,0,-1,-9,-7,-5,-2,7,-1,0,-2,-1,1,-1,-1,5,-1
KR_6623287047,420,-3,-99,3,-8,-6,6,0,0,4,4,-1,4,3,-2,3,1,1,0,1,-2,-9,10,-2,-2,4,-6,0,-1,1,-1,-1,-1,4,-1
KR_6687271743,420,-1,33,-21,4,6,0,6,2,3,5,-4,4,0,0,2,2,0,0,0,1,9,2,-1,-6,7,-3,0,0,-1,1,0,1,2,-1
KR_6758357975,420,-3,-79,-33,-6,0,0,0,2,1,3,3,1,4,-7,7,0,-4,4,0,0,-9,-4,-4,-2,6,-1,0,-1,-1,1,-1,-1,1,-1
KR_6765600111,420,-2,-39,-31,-8,-2,6,4,-2,4,2,-4,8,4,1,3,4,-1,1,0,-1,-3,79,0,-2,2,-3,0,-1,-1,-1,-1,-1,1,-1
KR_6755518409,420,2,-20,29,-2,2,0,2,-2,4,2,1,0,1,-3,4,1,0,1,1,0,0,-2,0,-7,7,-3,0,-1,-1,1,-1,-1,4,-1
KR_6750278547,420,-5,-29,-19,-8,-3,4,1,0,3,3,0,3,3,-6,7,1,1,0,1,0,-5,-19,-4,-6,10,-3,0,-2,-1,-1,-1,-1,1,-1
KR_6729487155,420,1,22,-5,2,1,2,3,5,2,7,-1,1,0,-1,2,1,-2,4,2,-2,4,4,-2,-2,4,-1,0,2,1,1,1,-1,6,-1
KR_6662627158,420,0,-37,-13,-8,-1,1,0,-5,5,0,-2,3,1,-2,4,2,2,0,2,0,-9,1,-2,-4,6,3,0,-1,1,-1,-1,-1,1,-1
KR_6736453428,440,-3,-9,-4,-7,-3,4,1,-1,2,1,-2,5,3,-1,1,0,0,2,2,0,-2,7,4,-6,2,-2,0,-1,-1,-1,-1,-1,4,-1
KR_6765389439,420,0,-14,5,1,-1,2,1,1,2,3,0,2,2,1,2,3,0,1,1,1,1,3,3,-8,5,-3,0,1,1,0,1,1,6,-1
KR_6672398622,420,1,15,4,2,-1,1,0,0,2,2,0,2,2,5,1,6,-2,3,1,0,5,210,0,-3,3,-2,0,1,-1,1,1,1,1,-1
KR_6608994172,420,1,47,7,4,1,0,1,6,1,7,-4,5,1,2,2,4,-1,1,0,0,4,9,0,-6,6,4,0,-1,1,-1,-1,-1,5,-1
KR_6759594151,420,2,13,8,2,-4,5,1,5,0,5,2,1,3,1,1,2,-2,2,0,0,3,-34,0,-5,5,13,0,0,1,-1,0,1,3,-1
KR_6683209432,420,4,-18,6,9,0,1,1,0,3,3,3,2,5,6,2,8,0,0,0,0,6,-27,0,-4,4,0,0,0,1,-1,0,1,4,-1
KR_6733045281,420,2,49,0,6,7,1,8,1,0,1,-1,3,2,-2,5,3,1,0,1,2,3,26,0,-3,3,-4,0,2,-1,1,1,1,4,-1
KR_6686592994,420,2,31,12,4,-4,4,0,-1,3,2,4,0,4,7,3,10,-2,2,0,0,14,4,2,-3,1,-1,0,1,1,-1,1,1,3,-1
KR_6722483608,420,-4,-48,-14,-9,-3,4,1,-5,5,0,-1,4,3,-1,4,3,1,0,1,0,-9,8,3,-7,4,-1,0,0,-1,0,-1,-1,6,-1
KR_6764510091,420,-3,6,-60,-2,-4,4,0,1,0,1,1,2,3,-1,4,3,1,1,2,3,5,2,-3,-3,6,1,0,1,1,1,1,1,6,-1
KR_6646315823,420,-2,19,-21,-2,-1,1,0,0,4,4,-1,2,1,-2,2,0,2,1,3,0,2,105,-5,-3,8,-4,0,0,-1,1,1,-1,4,-1
KR_6739545657,420,-2,-55,4,-1,5,1,6,0,1,1,-2,3,1,0,4,4,-4,5,1,-1,-4,-8,-1,-5,6,12,0,1,-1,1,1,-1,4,-1
KR_6751141327,420,-4,-56,-16,-12,-2,3,1,-5,5,0,1,1,2,-5,7,2,-1,1,0,0,-16,2,-2,-3,5,1,0,-1,0,0,-1,-1,0,-1
KR_6606131283,420,-5,-91,-33,-5,1,2,3,0,1,1,0,3,3,-3,3,0,-3,3,0,0,-3,6,-1,-6,7,-5,0,-1,-1,1,-1,-1,3,-1
KR_6406061379,440,1,40,10,-5,1,3,4,0,4,4,-2,7,5,-3,3,0,-1,1,0,0,-10,181,3,-9,6,-2,0,-1,0,0,-1,-1,0,-1
KR_6748181664,420,-2,0,7,-4,-2,2,0,-2,2,0,-1,2,1,1,3,4,0,0,0,0,-4,10,3,-4,1,-5,0,0,-1,1,1,-1,3,-1
KR_6615247613,420,0,36,4,0,4,1,5,-4,7,3,-2,3,1,2,2,4,0,0,0,-1,-4,-4,-3,-2,5,0,0,1,1,1,1,-1,3,-1
KR_6732453997,440,-3,-16,-16,-9,-1,3,2,-2,5,3,-3,3,0,1,2,3,-4,4,0,2,-11,3,1,-4,3,-3,0,0,1,-1,-1,1,6,-1
KR_6769729972,440,0,-2,-4,-2,-1,2,1,-2,3,1,2,0,2,-3,7,4,2,1,3,0,-1,37,3,-5,2,-28,0,-2,1,-1,1,-1,5,-1
KR_6683355938,420,-3,-26,-27,-5,-1,2,1,-1,4,3,-1,5,4,2,3,5,-4,5,1,0,2,1,3,-7,4,-7,0,0,0,-1,0,1,0,-1
KR_6651101301,420,-4,-12,-24,-12,0,1,1,-4,4,0,-3,5,2,-3,5,2,-2,4,2,0,-9,-16,-3,-3,6,-3,0,0,-1,-1,0,-1,1,-1
KR_6764694300,420,-1,-12,12,1,0,1,1,2,0,2,-2,4,2,1,1,2,0,0,0,0,8,5,0,-6,6,-1,0,0,1,1,0,1,5,-1
KR_6718345655,420,-1,41,-8,3,-2,3,1,2,1,3,-1,4,3,6,1,7,-2,2,0,0,1,9,0,-3,3,0,0,0,-1,1,0,1,4,-1
KR_6642828971,420,1,38,-4,-3,3,1,4,-2,5,3,2,0,2,-5,6,1,-1,1,0,-1,-13,10,0,-4,4,0,0,1,-1,0,1,-1,6,-1
KR_6609082331,420,0,-86,4,3,2,0,2,-3,5,2,4,2,6,-3,4,1,3,0,3,0,4,4,6,-10,4,-4,0,-2,1,1,-1,-1,5,-1
KR_6628045221,440,1,9,13,-8,-1,3,2,-3,6,3,-3,6,3,-2,4,2,1,3,4,1,-6,0,-1,-4,5,0,0,1,1,-1,1,-1,3,-1
KR_6346572155,420,-1,-26,-24,1,-4,4,0,1,5,6,2,0,2,-2,3,1,4,0,4,0,12,3,-1,-6,7,-1,0,0,1,-1,1,1,5,-1
KR_6769692945,440,-5,16,-16,-5,-5,6,1,0,1,1,1,4,5,0,2,2,-1,1,0,0,-3,4,1,-4,3,0,0,0,1,0,0,-1,6,-1
KR_6726868855,420,0,40,-22,-2,-2,2,0,7,0,7,-2,3,1,-4,6,2,-1,3,2,0,-4,-61,-4,-7,11,32,0,0,-1,1,0,1,5,-1
KR_6761890460,420,-3,74,17,1,-1,3,2,2,2,4,-2,4,2,2,5,7,0,1,1,0,5,6,4,-6,2,-3,0,0,0,1,1,1,0,-1
KR_6769136249,420,0,-14,24,-3,0,1,1,0,4,4,-2,3,1,-2,3,1,1,1,2,0,-7,-1,2,-6,4,0,0,-2,1,0,-1,-1,3,-1
KR_6752855655,440,-1,-54,16,0,3,0,3,6,0,6,-1,3,2,-8,8,0,0,3,3,0,-3,-11,-2,-1,3,0,0,-2,-1,-1,-1,-1,2,-1
KR_6768983029,420,-3,-16,-23,-11,-3,3,0,-1,4,3,-6,6,0,-1,2,1,0,2,2,0,-11,-2,-11,-3,14,1,0,-2,1,-1,-1,-1,4,-1
KR_6761389055,420,-6,-59,-89,-8,2,2,4,0,2,2,-8,9,1,-2,4,2,0,2,2,0,-4,-114,3,-5,2,-5,0,-1,-1,-1,-1,1,5,-1
KR_6698979773,440,-4,-88,-28,-12,-1,4,3,-3,5,2,-4,6,2,-2,6,4,-2,3,1,0,-10,20,7,-12,5,-5,0,-2,1,-1,-1,-1,5,-1
KR_6751657173,420,-1,-79,-8,-9,4,0,4,-2,4,2,1,3,4,-8,8,0,-4,6,2,0,-9,6,-4,-1,5,-2,0,0,-1,-1,0,-1,3,-1
KR_6654287767,440,-1,17,-8,-7,4,2,6,0,1,1,2,1,3,-8,10,2,-5,5,0,0,-9,0,3,-5,2,-3,0,-1,1,1,-1,-1,1,-1
KR_6677866840,420,-4,26,-28,-13,-2,2,0,-2,3,1,-2,4,2,-7,7,0,0,0,0,0,-18,20,1,-4,3,0,0,0,-1,0,0,1,6,-1
KR_6634867102,420,0,-39,7,-1,-2,3,1,2,1,3,1,1,2,-3,6,3,1,1,2,0,-5,-3,-1,-7,8,2,0,0,1,0,-1,1,5,-1
KR_6653943109,440,2,35,17,4,2,0,2,-3,5,2,2,1,3,3,1,4,0,0,0,0,-1,-3,0,-6,6,2,0,1,-1,1,1,-1,3,-1
KR_6766822869,420,-1,-5,-2,-3,-5,5,0,3,0,3,2,1,3,0,4,4,-3,3,0,0,-5,-23,-2,-4,6,-6,0,0,-1,1,0,-1,4,-1
KR_6767924254,420,-1,-9,24,5,0,3,3,3,0,3,0,3,3,1,2,3,1,2,3,0,1,120,-1,-2,3,21,0,0,1,1,1,1,1,-1
KR_6766065834,420,-1,-30,-13,-3,0,1,1,-1,3,2,-2,3,1,1,4,5,-1,1,0,0,-5,4,0,-4,4,-1,0,1,-1,-1,1,1,2,-1
KR_6763100410,420,-2,-39,-11,3,2,2,4,1,2,3,0,1,1,-1,5,4,1,3,4,0,4,109,-5,-1,6,1,0,1,-1,1,1,1,6,-1
KR_6727973677,420,-4,-58,-16,-7,0,1,1,-2,4,2,-2,3,1,-4,4,0,1,0,1,0,-9,-24,-2,-5,7,-1,0,-1,-1,-1,-1,1,4,-1
KR_6637052417,420,-1,10,0,5,0,2,2,0,1,1,3,2,5,2,3,5,0,1,1,0,6,13,1,-3,2,0,0,1,-1,0,1,1,4,-1
KR_6714695853,420,-1,-47,8,3,0,3,3,-1,2,1,2,1,3,1,2,3,1,1,2,0,1,-5,0,-4,4,1,0,0,1,1,-1,-1,5,-1
KR_6752054278,440,-1,-30,-8,2,3,0,3,0,1,1,0,3,3,-1,1,0,0,0,0,0,5,30,3,-8,5,4,0,-1,1,1,-1,1,1,-1
KR_6766279269,420,-2,-8,-44,0,1,1,2,1,2,3,1,1,2,2,4,6,-5,5,0,0,-4,9,1,-3,2,2,0,-1,0,-1,-1,-1,0,-1
KR_6756713329,420,-2,-25,-40,-7,-2,4,2,-4,9,5,0,3,3,-1,3,2,0,1,1,0,-4,177,-1,-4,5,1,0,-1,-1,-1,-1,1,2,-1
KR_6693845037,420,-1,-28,-3,-8,-4,4,0,-4,5,1,0,1,1,1,1,2,-1,1,0,0,-6,-9,-4,-1,5,3,0,0,-1,-1,-1,1,1,-1
KR_6657275740,420,1,-23,20,0,-2,4,2,3,4,7,-3,5,2,-2,4,2,4,2,6,1,11,21,-5,-5,10,2,0,-1,1,-1,-1,1,5,-1
KR_6758322425,420,1,-22,36,-1,1,2,3,-3,4,1,0,1,1,2,5,7,-1,3,2,1,-4,-19,-1,-4,5,-2,0,0,1,1,0,1,3,-1
KR_6729456546,420,-2,19,-18,-8,1,0,1,-3,5,2,-1,2,1,-3,4,1,-2,2,0,0,-10,11,-4,-2,6,-1,0,1,-1,1,1,-1,6,-1
KR_6734514665,420,-4,-14,-4,-14,-4,4,0,-1,3,2,-4,4,0,-4,5,1,-1,2,1,-4,-20,1,-6,-3,9,1,0,-1,1,1,-1,-1,6,-1
KR_6749253592,440,-2,-14,-56,-3,4,0,4,-6,8,2,-1,1,0,1,1,2,-1,1,0,0,-1,-6,0,-5,5,-2,0,-2,-1,-1,-1,-1,4,-1
KR_6768037306,440,-3,-43,-20,-13,-1,2,1,-1,2,1,-5,6,1,-4,5,1,-2,3,1,-1,-11,-8,-3,-6,9,5,0,0,1,1,-1,-1,6,-1
KR_6769358789,420,0,26,23,3,0,2,2,-2,5,3,1,1,2,2,3,5,2,0,2,0,1,-52,-2,-4,6,4,0,0,-1,1,-1,1,1,-1
KR_6725078445,420,-5,19,-31,-15,1,0,1,-6,7,1,-5,6,1,-3,4,1,-2,2,0,-1,-20,-49,-1,-5,6,-4,0,0,-1,-1,0,-1,6,-1
KR_6638700065,420,0,12,4,-1,0,1,1,-6,6,0,1,1,2,2,0,2,2,0,2,0,-3,271,-7,-1,8,0,0,-1,1,1,-1,1,6,-1
KR_6680060946,420,-2,-5,-9,-8,-2,2,0,-3,9,6,-3,5,2,-1,3,2,1,0,1,0,-10,5,3,-7,4,-4,0,0,-1,1,1,1,2,-1
KR_6731114591,420,-3,-14,0,1,-2,3,1,1,1,2,1,1,2,0,3,3,1,1,2,0,-1,-1,-2,0,2,1,0,-1,1,1,-1,1,2,-1
KR_6661526284,420,1,-20,7,2,0,0,0,1,0,1,4,0,4,-3,4,1,0,0,0,0,2,-9,4,-7,3,-3,0,-1,-1,1,-1,-1,4,-1
KR_6761758348,420,0,-65,-9,-3,-1,2,1,-4,5,1,0,2,2,2,2,4,0,2,2,0,-7,2,4,-7,3,-4,0,0,-1,1,-1,-1,1,-1
KR_6769261353,420,-1,17,10,-10,-1,1,0,-4,5,1,-2,3,1,-3,4,1,0,1,1,0,-15,-3,-4,-7,11,1,0,-1,-1,-1,-1,-1,6,-1
KR_6552912252,420,-2,-61,-1,-2,2,0,2,0,3,3,1,0,1,-1,1,0,-4,4,0,-1,-3,1,0,-5,5,-1,0,-1,-1,-1,-1,-1,3,-1
KR_6536107506,420,0,22,-44,4,3,2,5,-1,3,2,-1,2,1,3,1,4,0,1,1,-1,7,1,-6,-3,9,1,0,0,-1,-1,-1,-1,3,-1
KR_6765564294,420,0,-32,8,-8,-5,7,2,-4,5,1,1,2,3,2,4,6,-2,2,0,-2,-14,-8,-5,-3,8,-4,0,0,-1,1,0,-1,2,-1
KR_6769685311,420,0,-53,15,1,-3,3,0,1,4,5,2,3,5,2,3,5,-1,3,2,0,1,-4,-1,-6,7,-2,0,-1,-1,-1,-1,-1,1,-1
KR_6690708418,420,-3,-97,-1,-7,-4,4,0,-3,8,5,0,2,2,1,1,2,-1,1,0,0,-4,9,-2,-4,6,1,0,-1,1,-1,-1,-1,3,-1
KR_6727397159,420,-1,12,-29,-2,1,1,2,-5,6,1,1,2,3,1,2,3,0,3,3,0,-4,-4,0,-6,6,-1,0,0,-1,1,0,-1,1,-1
KR_6765905187,420,-1,-47,6,-1,0,1,1,-4,5,1,2,0,2,0,3,3,1,0,1,0,-6,2,3,-6,3,-6,0,0,-1,1,0,1,3,-1
KR_6650483287,420,2,-31,40,7,2,0,2,1,6,7,5,0,5,-1,3,2,0,0,0,0,4,6,3,-6,3,-6,0,0,1,1,0,1,3,-1
KR_6635669104,420,5,6,-17,3,9,1,10,-4,6,2,-3,5,2,0,3,3,1,0,1,-2,0,33,0,-6,6,1,0,2,-1,-1,-1,-1,5,-1
KR_6764922626,420,-1,39,-39,0,0,1,1,-1,2,1,1,1,2,3,3,6,-3,4,1,0,7,-11,-2,-4,6,-1,0,-1,-1,1,-1,-1,5,-1
KR_6675381643,420,1,37,6,2,3,0,3,-1,2,1,2,4,6,0,2,2,-2,2,0,0,-1,9,4,-7,3,0,0,1,1,1,1,-1,1,-1
KR_6727433256,420,-5,-58,-28,-6,0,2,2,2,2,4,-7,7,0,0,1,1,-1,4,3,0,-8,-3,-6,-3,9,-2,0,-1,-1,-1,-1,1,4,-1
KR_6768325655,420,-2,-27,-8,-3,-2,2,0,-5,5,0,1,3,4,2,0,2,1,2,3,1,1,17,-1,-2,3,-3,0,-1,0,1,-1,1,0,-1
KR_6685996033,440,-2,-46,-20,-4,-4,4,0,-3,3,0,1,3,4,4,0,4,-2,2,0,0,2,34,2,-7,5,-4,0,0,1,-1,-1,-1,4,-1
KR_6761670784,420,2,15,4,-2,-1,2,1,-5,5,0,2,1,3,1,1,2,1,1,2,0,-5,20,3,-6,3,-3,0,1,-1,1,1,-1,1,-1
KR_6765296517,420,-1,-20,30,-11,-1,4,3,-7,9,2,0,4,4,-2,3,1,-1,1,0,0,-11,-11,-3,-3,6,-1,0,-2,1,-1,-1,1,2,-1
KR_6769684515,420,-3,-4,-3,-4,0,2,2,-1,4,3,-2,2,0,-1,1,0,0,0,0,0,-5,-7,1,-6,5,2,0,0,-1,1,-1,-1,5,-1
KR_6713097054,420,-3,-42,24,-7,4,0,4,-3,7,4,-3,5,2,-7,7,0,2,2,4,0,-9,2,4,-7,3,-1,0,-3,-1,-1,-1,1,2,-1
KR_6749380591,420,-1,23,-8,-2,-1,2,1,-1,1,0,-2,6,4,3,3,6,-1,1,0,0,7,34,2,-6,4,-18,0,-1,-1,-1,-1,-1,6,-1
KR_6727300335,420,-3,-8,32,-10,-3,4,1,-3,3,0,-2,6,4,2,1,3,-4,5,1,-3,-22,45,-4,-2,6,-33,0,0,1,-1,-1,-1,2,-1
