matchId,queueId,Diff_LV,Diff_CS,Diff_jglCS,Diff-K,Diff-K-top,K-WIN-top,K-LOSE-top,Diff-K-jug,K-WIN-jug,K-LOSE-jug,Diff-K-mid,K-WIN-mid,K-LOSE-mid,Diff-K-ad,K-WIN-ad,K-LOSE-ad,Diff-K-sup,K-WIN-sup,K-LOSE-sup,invadeKill,Diff-A,Diff_WARDplaced,Diff-ControlWARDplaced,LOSE_controlWARDPlaced,WIN_controlWARDPlaced,Diff_WARDkill,Diff_Inhibitor,Diff_TOWERkill,Diff_FirstDRAGON,Diff_FirstHERALD,Diff_Firsttower,Diff_FirstBLOOD,dragonType,result
KR_6758225719,420,-3,-75,-4,-5,-1,4,3,-6,7,1,6,0,6,-3,5,2,-1,3,2,0,-6,2,-1,-7,8,-4,0,0,0,-1,-1,1,0,-1
KR_6625191930,420,-1,-20,5,-6,3,2,5,-2,5,3,-6,6,0,-1,2,1,0,0,0,0,-9,308,-2,-3,5,-1,0,-1,1,-1,-1,-1,1,-1
KR_6717958296,440,3,25,2,9,0,2,2,1,2,3,-2,4,2,9,2,11,1,0,1,0,13,301,-2,-4,6,-3,0,2,1,-1,1,1,5,-1
KR_6687978851,420,-6,-86,-40,-14,-2,2,0,-2,2,0,-9,9,0,-3,4,1,2,0,2,0,-8,36,0,-2,2,-19,0,-1,0,-1,-1,-1,0,-1
KR_6359794387,420,3,9,4,6,3,4,7,-3,5,2,3,1,4,1,3,4,2,1,3,0,12,0,0,0,0,-3,0,2,1,1,1,1,1,-1
KR_6733443249,420,-5,-99,4,-6,1,3,4,2,3,5,-3,3,0,-3,3,0,-3,3,0,-2,-6,-1,-2,-3,5,-4,0,-2,-1,-1,-1,-1,1,-1
KR_6758547509,420,2,-40,-5,6,0,2,2,1,2,3,-4,6,2,9,0,9,0,0,0,1,7,-11,2,-3,1,1,0,1,-1,-1,1,1,5,-1
KR_6692511705,420,0,52,26,-6,1,3,4,-6,9,3,0,2,2,-1,2,1,0,3,3,-1,-19,-229,-4,-2,6,-1,0,0,0,0,0,-1,0,-1
KR_6139634382,420,-3,-37,12,-10,0,2,2,-3,3,0,1,1,2,-6,6,0,-2,3,1,0,-15,54,3,-5,2,0,0,-2,-1,-1,-1,-1,1,-1
KR_6623452338,420,-2,29,-1,1,1,1,2,-2,6,4,1,5,6,0,2,2,1,0,1,0,-1,8,4,-7,3,-1,0,0,1,-1,0,1,5,-1
KR_6677828019,420,3,-22,24,6,-1,5,4,2,2,4,4,0,4,2,0,2,-1,2,1,-1,7,12,1,-4,3,-7,0,0,1,1,0,-1,4,-1
KR_6703336389,420,1,8,12,-5,-2,10,8,2,1,3,-1,4,3,-2,2,0,-2,2,0,0,-1,3,2,-3,1,-1,0,-1,-1,-1,-1,-1,6,-1
KR_6687319527,420,-2,-72,4,-8,-3,3,0,1,1,2,-1,2,1,-4,7,3,-1,2,1,-2,-11,-8,-1,0,1,5,0,-3,1,-1,-1,-1,3,-1
KR_6734264357,420,-9,-110,-48,-16,-3,3,0,-6,6,0,-3,4,1,-1,1,0,-3,4,1,0,-12,70,-5,-1,6,-3,0,-2,-1,-1,-1,-1,5,-1
KR_6706986745,440,2,-35,-20,-3,-8,8,0,-5,7,2,4,2,6,5,3,8,1,0,1,0,3,-8,0,-4,4,-1,0,1,1,0,1,1,5,-1
KR_6634093217,420,-3,10,-9,-14,-4,6,2,6,1,7,-6,6,0,-7,8,1,-3,3,0,0,-3,5,0,0,0,1,0,1,-1,0,1,-1,2,-1
KR_6483910914,420,-7,-55,-52,-10,-2,2,0,-4,5,1,-6,6,0,-1,5,4,3,2,5,0,-7,1,3,-4,1,-3,0,-2,-1,-1,-1,-1,2,-1
KR_6712772659,420,-2,-48,-40,-5,-5,7,2,1,0,1,-2,5,3,1,0,1,0,2,2,0,-1,4,-1,-1,2,-7,0,-2,-1,-1,-1,-1,5,-1
KR_6764092522,440,-4,11,-57,-10,-3,5,2,-7,7,0,0,1,1,0,2,2,0,0,0,0,-1,34,-9,0,9,3,0,-1,1,-1,-1,-1,2,-1
KR_6643584228,420,2,27,0,3,-4,4,0,2,2,4,2,0,2,0,2,2,3,1,4,0,2,-5,0,-1,1,0,0,1,-1,0,1,1,5,-1
KR_6738343424,420,-1,2,26,-1,1,2,3,0,1,1,0,2,2,-1,2,1,-1,1,0,1,-3,283,-2,-2,4,-2,0,0,1,-1,0,1,6,-1
KR_6739294664,420,-2,12,-8,-9,0,1,1,-4,5,1,0,2,2,1,1,2,-6,6,0,0,-11,2,-1,-5,6,-7,0,0,1,-1,0,-1,3,-1
KR_6738370563,440,-1,-37,-22,-4,4,1,5,1,2,3,0,1,1,-8,9,1,-1,2,1,0,-7,0,-3,-2,5,0,0,0,-1,-1,1,1,1,-1
KR_6617285286,420,-1,-43,-16,-1,4,0,4,0,2,2,-6,6,0,2,3,5,-1,1,0,0,2,-2,3,-4,1,-1,0,0,-1,1,0,-1,4,-1
KR_6737742529,420,4,30,-4,4,1,2,3,1,8,9,-3,4,1,5,3,8,0,0,0,-2,9,5,0,-2,2,3,0,1,-1,-1,1,-1,5,-1
KR_6733605937,420,-3,-64,-20,-6,4,2,6,-2,3,1,-8,8,0,6,3,9,-6,7,1,-1,-4,-5,0,0,0,0,0,-1,-1,-1,-1,-1,5,-1
KR_6754934373,440,2,-10,7,6,5,0,5,4,0,4,2,6,8,-5,7,2,0,1,1,0,5,-40,-2,-2,4,19,0,1,-1,0,-1,1,5,-1
KR_6628994663,420,-3,-34,0,-9,-1,3,2,-4,4,0,3,0,3,-5,5,0,-2,2,0,0,-12,20,3,-6,3,-4,0,-1,-1,1,-1,-1,4,-1
KR_6701974909,440,2,4,10,6,1,3,4,4,5,9,1,0,1,-1,1,0,1,2,3,0,4,1,0,-4,4,1,0,-1,0,0,-1,1,0,-1
KR_6697273448,420,-5,-38,-35,0,-1,3,2,0,1,1,4,0,4,0,1,1,-3,4,1,0,2,0,3,-4,1,-1,0,0,-1,0,0,1,6,-1
KR_6623683037,420,-3,-85,-24,-13,-1,1,0,-8,9,1,-5,5,0,-4,5,1,5,0,5,-3,-23,-32,-3,-2,5,-1,0,-2,-1,0,-1,-1,2,-1
KR_6756483297,440,0,15,8,-3,-1,2,1,0,1,1,2,1,3,-2,4,2,-2,2,0,0,-5,-7,-6,-2,8,-3,0,1,1,1,1,-1,3,-1
KR_6595765107,420,1,-63,-7,-2,-1,3,2,-6,7,1,2,1,3,1,3,4,2,1,3,0,-3,-9,0,-2,2,0,0,0,0,1,0,1,0,-1
KR_6761588133,440,1,-21,0,5,3,2,5,1,2,3,5,0,5,-4,4,0,0,3,3,0,-2,26,1,-6,5,-5,0,0,1,0,-1,-1,6,-1
KR_6682933126,420,-6,-79,24,-17,-8,8,0,-4,4,0,-3,3,0,-3,5,2,1,0,1,0,-8,-5,-3,-3,6,2,0,-3,-1,-1,-1,-1,3,-1
KR_6626084320,420,1,-18,-4,0,1,2,3,-2,2,0,0,1,1,0,2,2,1,0,1,0,-3,3,1,-5,4,-5,0,0,-1,-1,0,-1,2,-1
KR_6742960333,420,-4,-51,8,-7,-3,4,1,-1,4,3,-3,3,0,1,3,4,-1,3,2,0,-1,-7,-1,-6,7,2,0,-1,-1,1,-1,-1,3,-1
KR_6759997683,420,-5,-94,-4,-19,-2,4,2,-4,4,0,-8,9,1,-4,7,3,-1,2,1,0,-14,-2,-1,-1,2,-1,0,-2,-1,-1,-1,-1,5,-1
KR_6739626589,420,0,-69,0,5,-6,7,1,0,1,1,1,4,5,8,0,8,2,0,2,0,12,-2,1,-3,2,3,0,-1,1,-1,-1,-1,4,-1
KR_6649910307,420,2,5,12,6,-3,4,1,1,1,2,6,0,6,1,2,3,1,0,1,0,10,10,6,-10,4,-10,0,0,1,1,-1,1,2,-1
KR_6751145088,420,4,49,8,7,-3,4,1,-1,3,2,5,0,5,5,1,6,1,0,1,0,9,-16,1,-3,2,2,0,0,0,0,1,-1,0,-1
KR_6717458196,420,-1,-22,-44,6,0,2,2,1,4,5,-3,5,2,6,0,6,2,2,4,0,8,-3,2,-2,0,-2,0,0,0,0,-1,1,0,-1
KR_6764042256,420,-1,15,-32,-3,0,0,0,-1,1,0,-1,2,1,-2,5,3,1,2,3,0,-4,0,2,-5,3,-4,0,1,-1,1,1,1,1,-1
KR_6762009338,420,-2,-14,0,-4,2,0,2,2,1,3,-4,5,1,-2,4,2,-2,5,3,0,-5,35,-1,-4,5,-24,0,-1,0,0,-1,-1,0,-1
KR_6735847633,420,2,-24,-20,7,-2,2,0,3,1,4,5,0,5,1,2,3,0,1,1,0,9,-3,-1,-5,6,-2,0,-1,-1,-1,-1,-1,2,-1
KR_6699690490,440,4,80,17,3,-4,6,2,4,3,7,2,2,4,0,4,4,1,0,1,0,0,0,1,-4,3,3,0,2,1,1,1,-1,3,-1
KR_6747081270,440,-2,-112,-28,0,-4,6,2,6,0,6,-6,7,1,3,0,3,1,1,2,0,8,14,-1,-2,3,-1,0,-3,1,0,-1,1,2,-1
KR_6713610750,440,-1,-33,-12,-2,-4,6,2,1,1,2,9,1,10,-2,3,1,-6,6,0,0,1,360,0,-2,2,0,0,-1,-1,0,-1,-1,3,-1
KR_5929329911,420,1,9,15,2,1,2,3,0,4,4,2,0,2,-1,3,2,0,1,1,1,-6,-2,1,-6,5,-1,0,0,1,-1,0,1,2,-1
KR_6749186022,420,-5,-131,-22,-13,-3,4,1,-6,7,1,-2,4,2,-3,4,1,1,4,5,0,-11,234,1,-6,5,-3,0,-1,-1,1,-1,-1,2,-1
KR_6644753013,420,0,-13,-32,4,3,1,4,0,1,1,0,1,1,-1,1,0,2,1,3,0,1,5,1,-6,5,-6,0,0,1,0,0,1,4,-1
KR_6764330582,440,2,-43,36,10,2,0,2,1,1,2,4,0,4,2,1,3,1,2,3,0,17,-44,-3,0,3,2,0,0,1,-1,1,1,5,-1
KR_6737964660,420,-4,-77,-31,-9,2,0,2,0,1,1,-5,5,0,-5,6,1,-1,2,1,1,-3,146,1,-2,1,1,0,-4,-1,-1,-1,1,5,-1
KR_6606570032,420,-2,-23,20,-6,0,1,1,-1,2,1,-2,4,2,0,3,3,-3,3,0,0,-2,-10,-2,0,2,1,0,0,1,-1,0,-1,5,-1
KR_6634410674,420,-5,-62,-4,-9,-1,1,0,-2,4,2,-3,4,1,-2,2,0,-1,1,0,0,-7,0,-1,-2,3,-1,0,-1,-1,-1,-1,1,2,-1
KR_6701704768,420,-3,-54,-14,-4,2,0,2,-4,4,0,0,3,3,-5,8,3,3,2,5,1,4,-5,0,-2,2,-1,0,-2,0,-1,-1,1,0,-1
KR_6740524324,420,-5,-65,-52,-10,-2,2,0,0,3,3,-4,5,1,2,1,3,-6,9,3,-1,-10,-1,0,-2,2,-1,0,0,-1,-1,-1,-1,5,-1
KR_6609763325,420,0,11,0,-2,2,0,2,0,2,2,0,2,2,1,2,3,-5,6,1,0,5,1,4,-4,0,-1,0,0,0,0,0,1,0,-1
KR_6603629197,420,-5,-18,-40,-10,-9,9,0,-3,3,0,0,1,1,2,0,2,0,0,0,0,-8,16,-1,-2,3,0,0,-2,-1,-1,-1,-1,5,-1
KR_6644608315,420,0,33,28,0,-2,2,0,0,4,4,2,4,6,-2,5,3,2,2,4,0,-1,126,-4,-1,5,2,0,0,-1,0,0,1,1,-1
KR_6750124810,420,-1,-58,12,-5,0,0,0,1,1,2,-3,6,3,-3,3,0,0,0,0,0,-4,117,-1,-1,2,3,0,-1,1,-1,-1,-1,1,-1
KR_6720596477,440,-3,27,-32,-3,-1,3,2,-1,3,2,0,2,2,-1,6,5,0,0,0,1,-3,-22,0,-4,4,6,0,1,-1,-1,1,1,6,-1
KR_6711481772,420,-2,-50,0,-2,2,0,2,4,1,5,-3,5,2,-5,5,0,0,1,1,0,-7,-6,-6,0,6,5,0,-1,1,1,-1,1,2,-1
KR_6722657179,440,-4,-20,-40,-8,-4,4,0,-1,2,1,-5,6,1,1,4,5,1,2,3,0,-5,-5,-2,-7,9,2,0,-1,-1,-1,-1,-1,4,-1
KR_6594056732,420,6,-3,31,9,4,1,5,3,0,3,-1,2,1,1,2,3,2,0,2,0,9,19,4,-5,1,-2,0,1,1,1,1,1,5,-1
KR_6632187688,420,-8,-112,4,-15,-8,9,1,-1,2,1,-4,4,0,-2,3,1,0,0,0,0,-6,4,-6,0,6,-1,0,-2,-1,1,-1,-1,3,-1
KR_6756294077,420,1,-37,28,5,0,2,2,-1,2,1,2,0,2,1,0,1,3,1,4,0,6,-28,-3,-2,5,1,0,0,1,1,-1,-1,4,-1
KR_6678902250,420,0,-10,-16,1,1,1,2,-1,2,1,1,1,2,1,1,2,-1,1,0,0,-1,4,-2,0,2,1,0,0,-1,-1,0,-1,4,-1
KR_6751475070,420,-1,-46,12,-7,3,1,4,-1,2,1,-8,8,0,-3,4,1,2,0,2,-2,-4,-1,1,-4,3,-2,0,0,1,1,0,1,3,-1
KR_6644715093,420,-3,4,-17,-9,-3,3,0,-1,3,2,1,1,2,-4,4,0,-2,2,0,0,-7,6,1,-4,3,2,0,-1,0,-1,-1,-1,0,-1
KR_6661172556,420,-2,20,4,-14,-4,4,0,-4,9,5,-4,5,1,-3,4,1,1,2,3,0,-13,-109,-3,-1,4,2,0,-1,-1,-1,-1,-1,2,-1
KR_6751539375,420,-3,-59,4,0,0,1,1,6,1,7,-5,8,3,1,3,4,-2,5,3,1,11,3,0,-3,3,0,0,0,0,0,0,1,0,-1
KR_6762487296,420,1,49,-28,2,5,1,6,-3,3,0,1,4,5,-1,5,4,0,2,2,0,3,-301,0,-1,1,-1,0,1,-1,1,1,-1,4,-1
KR_6550473019,420,-1,-36,-4,-3,1,1,2,0,4,4,2,1,3,-6,8,2,0,0,0,0,2,-4,2,-4,2,2,0,-1,-1,-1,-1,1,5,-1
KR_6735295836,420,-2,-28,0,0,-8,8,0,-1,2,1,3,1,4,5,2,7,1,0,1,-1,2,7,-3,0,3,0,0,1,1,-1,1,-1,3,-1
KR_6753620227,420,-3,-97,-32,-5,1,4,5,2,1,3,-3,7,4,-5,5,0,0,1,1,0,-4,343,-3,-1,4,0,0,1,-1,1,1,-1,1,-1
KR_6646714199,420,-1,3,-4,1,-1,2,1,6,1,7,-1,2,1,-2,2,0,-1,1,0,0,-2,30,1,-2,1,-24,0,0,1,1,-1,1,5,-1
KR_6736751121,420,2,-32,-16,10,1,1,2,2,1,3,1,2,3,2,2,4,4,1,5,0,10,-6,2,-4,2,-1,0,-1,1,1,-1,1,5,-1
KR_6729774248,420,0,-81,12,-4,3,1,4,-2,3,1,-2,3,1,-3,4,1,0,1,1,0,1,8,1,-4,3,-1,0,0,-1,1,1,-1,2,-1
KR_6567005096,420,-6,-99,-16,-6,-1,2,1,0,2,2,-2,4,2,-2,4,2,-1,1,0,0,3,-4,-2,-2,4,-4,0,-2,-1,-1,-1,-1,1,-1
KR_6748316620,420,0,62,12,-7,1,2,3,-2,2,0,-1,3,2,-5,5,0,0,0,0,0,-16,-9,-4,0,4,-2,0,0,-1,1,1,1,5,-1
KR_6646454970,420,3,5,-16,-2,2,1,3,1,2,3,-7,8,1,2,3,5,0,0,0,0,0,-2,-1,-5,6,1,0,0,1,0,0,-1,2,-1
KR_6721121993,420,-2,33,-37,0,5,0,5,2,0,2,-4,7,3,0,2,2,-3,3,0,0,0,-202,-2,-3,5,-2,0,0,0,-1,-1,1,0,-1
KR_6728354120,420,-2,21,-24,-5,2,2,4,-1,3,2,-1,3,2,-4,5,1,-1,2,1,0,-11,-92,3,-6,3,21,0,0,-1,-1,0,1,4,-1
KR_6732324053,420,-4,-106,-39,-2,-1,1,0,2,1,3,-1,3,2,-1,2,1,-1,2,1,0,4,41,0,-2,2,1,0,-1,-1,1,-1,1,4,-1
KR_6745660271,420,-1,-36,15,-11,-1,2,1,-10,11,1,-1,1,0,0,4,4,1,1,2,0,-15,14,2,-6,4,-10,0,-1,-1,-1,-1,-1,5,-1
KR_6653793214,420,0,-31,-10,-1,0,1,1,3,0,3,-1,4,3,-5,5,0,2,0,2,0,2,-3,-1,0,1,0,0,0,1,1,0,-1,2,-1
KR_6724701030,420,-5,-55,-56,-10,1,0,1,-2,5,3,-9,10,1,3,1,4,-3,3,0,0,-3,-8,-1,-4,5,1,0,-2,-1,-1,-1,1,6,-1
KR_6676145178,420,-7,-43,-32,-17,-7,8,1,-6,6,0,-5,5,0,0,1,1,1,2,3,0,-13,47,4,-5,1,-20,0,-3,-1,-1,-1,-1,2,-1
KR_6621318650,440,-9,50,-56,-12,-1,2,1,-5,6,1,-3,3,0,-3,3,0,0,1,1,0,-8,-26,-3,-1,4,0,0,0,-1,-1,0,-1,6,-1
KR_6551966727,420,-1,11,-8,-4,-1,3,2,-2,3,1,-2,6,4,-1,2,1,2,0,2,0,-5,-32,3,-5,2,1,0,-1,-1,-1,-1,-1,6,-1
KR_6728747953,440,-5,-38,-7,-10,0,1,1,-4,6,2,-2,4,2,-4,4,0,0,2,2,0,-6,-17,0,-3,3,-2,0,-1,1,1,-1,-1,5,-1
KR_6757986607,440,-3,-65,-16,-2,-2,3,1,4,2,6,-4,4,0,1,2,3,-1,2,1,0,3,16,1,-2,1,0,0,-1,-1,-1,-1,-1,3,-1
KR_6631654067,420,-2,-5,28,-7,-1,1,0,6,2,8,-1,1,0,-11,13,2,0,0,0,0,-8,-3,0,-6,6,6,0,0,-1,0,0,-1,3,-1
KR_6715541093,420,1,-21,-51,0,-1,2,1,-3,3,0,2,2,4,0,0,0,2,1,3,0,-2,-44,-3,-1,4,25,0,0,-1,0,-1,1,3,-1
KR_6711387467,420,0,23,12,-4,-5,5,0,1,1,2,-1,3,2,1,2,3,0,0,0,0,-2,-8,-5,-1,6,-2,0,0,-1,-1,-1,-1,6,-1
KR_6701954925,440,-4,-30,-10,-16,-6,7,1,-6,9,3,3,0,3,-4,4,0,-3,5,2,1,-14,-5,3,-4,1,-3,0,-1,-1,-1,-1,1,4,-1
KR_6724195726,440,-2,-33,-25,-2,-2,3,1,-2,4,2,-1,3,2,3,2,5,0,2,2,0,2,-2,-6,-2,8,-5,0,0,0,0,0,-1,0,-1
KR_6744799288,440,-4,-98,0,-7,-4,6,2,2,1,3,-3,5,2,1,0,1,-3,4,1,0,-1,-3,1,-1,0,1,0,-1,-1,-1,-1,1,2,-1
KR_6660074143,440,-1,5,-12,-6,-3,3,0,-1,3,2,1,1,2,-4,4,0,1,0,1,-1,-2,-4,3,-7,4,-2,0,0,-1,0,0,-1,2,-1
KR_6605279372,420,-2,22,-8,-1,1,1,2,0,1,1,1,2,3,-3,3,0,0,0,0,0,-5,-53,-2,0,2,29,0,-1,1,-1,-1,-1,6,-1
KR_6614538144,420,2,67,53,4,1,0,1,3,1,4,-2,4,2,2,1,3,0,3,3,0,7,9,-3,-1,4,2,0,0,-1,1,0,1,3,-1
KR_6759185849,420,-2,-91,1,-6,-2,4,2,3,0,3,-1,1,0,-6,8,2,0,3,3,0,-8,-2,-2,0,2,-1,0,0,-1,-1,-1,-1,4,-1
KR_6726379517,420,-1,21,4,0,-4,5,1,2,3,5,2,2,4,0,0,0,0,0,0,0,0,-38,-3,-2,5,8,0,0,1,1,1,-1,6,-1
KR_6603526911,420,-3,-26,-30,-6,1,0,1,-5,5,0,1,3,4,-2,4,2,-1,1,0,0,-8,8,-6,0,6,-1,0,1,-1,-1,-1,1,4,-1
KR_6594125486,420,-1,-32,-4,0,0,1,1,-3,3,0,2,1,3,2,1,3,-1,1,0,0,-2,-2,-1,-3,4,-1,0,0,-1,1,0,1,5,-1
KR_6741149506,420,-7,-106,-26,-4,-2,4,2,-1,1,0,-1,5,4,0,3,3,0,2,2,0,-1,15,2,-5,3,-2,0,-1,-1,0,-1,1,3,-1
KR_6578740302,420,5,67,16,7,6,1,7,-1,5,4,0,2,2,-1,1,0,3,0,3,0,3,-3,-2,-1,3,4,0,0,-1,0,1,1,4,-1
KR_6762972636,440,-4,-60,-16,-8,1,2,3,-1,3,2,-11,11,0,-1,3,2,4,0,4,-1,-11,-6,1,-1,0,0,0,-2,-1,1,-1,-1,4,-1
KR_6695651558,420,0,-68,21,1,-6,6,0,2,2,4,5,2,7,1,2,3,-1,2,1,0,-1,8,2,-6,4,1,0,-3,1,-1,-1,-1,1,-1
KR_6144122888,420,-4,10,-20,-9,1,3,4,-1,4,3,-6,6,0,-2,3,1,-1,1,0,-1,-12,223,0,-4,4,-4,0,0,-1,1,0,-1,4,-1
KR_6699966467,440,1,4,25,1,-3,5,2,3,3,6,1,2,3,3,4,7,-3,4,1,-2,-2,7,6,-6,0,0,0,0,-1,1,1,-1,4,-1
KR_6694609753,440,-3,-69,-32,-8,-6,6,0,5,1,6,2,1,3,-11,11,0,2,2,4,0,1,41,-5,-3,8,-16,0,-2,1,1,-1,1,1,-1
KR_6645179850,420,0,-50,1,-8,2,0,2,0,1,1,-6,7,1,-2,3,1,-2,2,0,0,-10,-5,2,-4,2,-2,0,-1,-1,1,-1,-1,3,-1
KR_6747711902,420,-1,-58,-4,-1,3,2,5,-1,2,1,-4,4,0,1,2,3,0,1,1,1,0,-53,3,-4,1,22,0,0,-1,1,0,1,5,-1
KR_6749070610,420,0,20,-4,6,-1,2,1,-2,4,2,7,0,7,1,1,2,1,0,1,1,14,2,0,-3,3,-3,0,0,1,0,0,1,4,-1
KR_6616799749,420,-1,11,-28,-4,-1,1,0,-4,4,0,1,1,2,0,1,1,0,0,0,0,-5,4,-2,0,2,-1,0,0,1,0,0,-1,1,-1
KR_6662789918,440,-2,-49,4,-15,-4,4,0,-1,2,1,-1,3,2,-7,9,2,-2,3,1,0,-11,0,4,-7,3,-3,0,-1,-1,1,-1,-1,1,-1
KR_6689819177,420,0,41,20,0,-1,2,1,1,1,2,2,2,4,-1,2,1,-1,1,0,0,0,19,-3,-2,5,1,0,0,-1,1,0,-1,6,-1
KR_6530914753,420,0,43,24,3,2,2,4,3,3,6,-1,6,5,1,2,3,-2,2,0,-2,-10,307,-1,0,1,-2,0,1,-1,-1,-1,-1,5,-1
KR_6668451169,420,1,23,-3,2,-1,1,0,-2,2,0,4,1,5,1,1,2,0,1,1,-1,-1,13,1,-3,2,-1,0,0,1,0,1,-1,5,-1
KR_6731326545,420,1,22,4,-1,6,1,7,-6,6,0,-3,5,2,1,1,2,1,0,1,0,1,3,3,-4,1,0,0,1,1,-1,1,1,1,-1
KR_6725610357,420,0,5,-8,-7,-3,4,1,0,4,4,-2,5,3,-1,2,1,-1,1,0,-1,-11,-242,2,-5,3,-1,0,0,-1,-1,0,-1,4,-1
KR_6728596885,420,1,-49,-16,1,-2,4,2,2,1,3,2,1,3,-2,5,3,1,4,5,0,-3,-2,-3,0,3,3,0,0,-1,0,-1,-1,1,-1
KR_6726435682,420,-1,-27,11,-7,0,1,1,-1,1,0,-4,6,2,-5,7,2,3,0,3,0,-6,57,-2,-2,4,-14,0,-1,-1,-1,-1,1,4,-1
KR_6763146357,420,1,14,-13,7,8,0,8,1,0,1,-1,1,0,0,0,0,-1,1,0,0,5,27,5,-7,2,0,0,0,1,1,1,1,5,-1
KR_6538125218,420,-4,-58,-16,-7,-4,4,0,1,0,1,-3,5,2,-1,2,1,0,0,0,0,1,26,1,-1,0,-29,0,-1,-1,0,-1,1,5,-1
KR_6658747241,440,-6,-159,-55,-10,-5,5,0,0,1,1,-5,6,1,3,1,4,-3,3,0,0,-5,8,0,-1,1,1,0,-1,1,0,-1,-1,5,-1
KR_6649790437,420,2,67,0,0,-1,5,4,0,3,3,1,2,3,2,1,3,-2,3,1,0,-8,0,-1,-4,5,-4,0,1,-1,-1,1,-1,5,-1
KR_6759129404,420,1,20,-24,3,2,0,2,2,2,4,4,2,6,-5,9,4,0,2,2,0,-3,38,-5,-1,6,-18,0,0,1,-1,0,-1,4,-1
KR_6752108362,420,-5,-97,4,-11,-8,8,0,2,2,4,-2,2,0,-1,1,0,-2,2,0,0,-6,-1,0,-6,6,2,0,-1,1,-1,-1,-1,3,-1
KR_6735972520,440,-2,-71,-4,-3,0,1,1,1,2,3,1,4,5,-4,5,1,-1,1,0,0,8,-8,2,-4,2,3,0,-1,-1,1,-1,-1,6,-1
KR_6610585966,440,-4,-7,5,-13,-2,4,2,-5,6,1,-2,2,0,-6,8,2,2,1,3,0,-10,-1,-2,-3,5,-1,0,0,-1,1,-1,-1,4,-1
KR_6722155267,420,0,3,0,1,0,1,1,2,2,4,4,1,5,-2,3,1,-3,4,1,0,-7,26,-2,-3,5,-16,0,0,-1,0,1,-1,1,-1
KR_6591860732,420,-3,-9,-20,-1,-1,5,4,-2,2,0,1,0,1,0,4,4,1,1,2,1,0,-3,-1,0,1,2,0,-1,-1,-1,-1,1,1,-1
KR_6141624094,420,3,21,10,-1,3,1,4,-3,6,3,-2,5,3,1,5,6,0,1,1,0,1,-5,-1,-3,4,1,0,1,-1,1,1,1,3,-1
KR_6746440629,440,-2,-13,-17,1,0,3,3,3,1,4,-6,7,1,5,0,5,-1,2,1,-1,5,-28,-1,-1,2,5,0,-1,-1,-1,-1,-1,1,-1
KR_6753980161,440,-4,-25,-20,-4,0,4,4,-2,3,1,-2,3,1,3,0,3,-3,3,0,0,-3,11,2,-7,5,-3,0,0,0,0,0,1,0,-1
KR_6431016569,420,-3,-7,-33,-9,-1,2,1,1,0,1,-2,4,2,-5,7,2,-2,3,1,-2,-9,-2,-1,-5,6,2,0,-2,-1,0,-1,1,1,-1
KR_6688731931,420,3,26,56,4,1,0,1,-2,2,0,-2,4,2,6,0,6,1,0,1,0,1,-1,-4,-2,6,1,0,1,-1,-1,1,-1,3,-1
KR_6601110816,420,-6,-81,-23,-14,-3,4,1,-1,1,0,-4,4,0,-5,5,0,-1,1,0,0,-9,-1,1,-3,2,-2,0,-2,0,1,-1,-1,0,-1
KR_6538453078,420,-5,-96,-28,-8,-2,3,1,3,3,6,-2,4,2,-5,6,1,-2,2,0,0,0,114,-2,0,2,-1,0,-1,-1,-1,-1,-1,6,-1
KR_6633815557,420,-2,29,16,-5,-2,4,2,0,4,4,0,3,3,-2,3,1,-1,3,2,0,-4,31,1,-6,5,-5,0,1,0,1,1,-1,0,-1
KR_6744584747,420,-7,-111,8,-15,-2,4,2,-6,6,0,-5,7,2,-2,7,5,0,1,1,0,-10,0,-3,-4,7,-3,0,-2,1,-1,-1,-1,6,-1
KR_6683215083,420,-4,-29,-20,-7,3,1,4,-2,4,2,-5,6,1,-2,4,2,-1,1,0,1,-6,-1,-3,0,3,0,0,-2,1,0,-1,1,2,-1
KR_6712776221,440,-3,-42,8,-19,-4,4,0,-2,6,4,0,3,3,-7,7,0,-6,7,1,-2,-19,-21,2,-3,1,2,0,-2,1,1,-1,-1,5,-1
KR_6679673021,420,-2,-50,2,-6,2,1,3,-3,4,1,-2,3,1,-1,5,4,-2,2,0,0,-11,-2,4,-6,2,-2,0,-1,-1,1,-1,-1,1,-1
KR_6684244829,420,-4,-123,18,-13,-5,5,0,1,2,3,-3,4,1,-2,2,0,-4,5,1,0,-2,10,-3,0,3,-5,0,-1,-1,0,-1,-1,2,-1
KR_6385493452,440,-2,-28,-24,-2,-1,2,1,-2,5,3,-1,1,0,3,1,4,-1,1,0,-1,3,-11,0,-3,3,8,0,-1,-1,-1,-1,-1,4,-1
KR_6763231778,440,-3,-87,4,-3,-1,2,1,0,0,0,-7,13,6,-2,5,3,7,1,8,3,13,-17,0,-6,6,-3,0,-3,-1,-1,-1,1,4,-1
KR_6241758216,420,-3,-32,-15,1,0,2,2,-3,4,1,1,3,4,2,0,2,1,1,2,0,2,-13,-6,0,6,3,0,-1,-1,-1,-1,1,4,-1
KR_6750198646,420,-2,98,-36,-11,0,0,0,-4,5,1,-2,4,2,-3,6,3,-2,4,2,0,-4,33,0,-5,5,-31,0,-1,0,-1,-1,-1,0,-1
KR_6138044661,420,4,-1,-12,7,1,0,1,2,2,4,2,1,3,5,1,6,-3,3,0,1,8,-2,-1,-2,3,2,0,0,1,1,1,1,3,-1
KR_6475403496,420,-1,81,-16,-1,-4,5,1,1,0,1,0,1,1,0,1,1,2,0,2,0,1,7,1,-3,2,-3,0,0,1,-1,0,1,3,-1
KR_6713545853,440,-2,25,-27,-5,-1,3,2,-2,2,0,2,1,3,-3,9,6,-1,5,4,-1,-5,342,-3,-1,4,0,0,-1,-1,0,-1,-1,1,-1
KR_6734431242,440,-2,-66,-16,0,0,4,4,-2,4,2,2,1,3,1,3,4,-1,1,0,-1,8,7,9,-9,0,-2,0,0,-1,-1,-1,1,3,-1
KR_6745808216,420,4,-28,12,7,4,3,7,0,3,3,0,0,0,0,0,0,3,0,3,-1,6,24,0,-2,2,-2,0,0,-1,-1,0,-1,1,-1
KR_6762347082,420,-2,-52,-21,1,5,0,5,0,0,0,-3,4,1,-1,1,0,0,0,0,0,0,-2,0,-2,2,-1,0,1,-1,0,1,1,4,-1
KR_6669158385,420,-1,-44,4,3,-4,6,2,1,0,1,2,3,5,6,1,7,-2,4,2,-1,4,3,0,-5,5,0,0,1,-1,1,-1,-1,4,-1
KR_6724179945,440,3,1,4,-1,2,2,4,3,0,3,-1,1,0,-3,3,0,-2,2,0,0,-1,4,3,-4,1,-2,0,2,-1,1,1,1,1,-1
KR_6744929083,420,2,50,28,2,4,4,8,2,0,2,-1,1,0,-4,4,0,1,1,2,-3,-6,123,4,-5,1,0,0,0,1,1,-1,-1,6,-1
KR_6635978948,420,-1,-26,-15,0,-4,4,0,3,0,3,2,0,2,-1,4,3,0,1,1,0,4,140,1,-2,1,-3,0,-1,1,-1,-1,1,2,-1
KR_6665057217,420,0,-11,-32,-1,-1,2,1,1,2,3,5,1,6,-6,6,0,0,1,1,0,-4,20,2,-3,1,-3,0,-1,-1,-1,-1,-1,6,-1
KR_6525363540,420,-2,-113,3,9,1,1,2,2,5,7,3,0,3,1,4,5,2,1,3,3,11,-2,1,-3,2,-1,0,0,1,1,-1,1,2,-1
KR_6758080383,420,-4,-78,-32,-5,3,0,3,0,5,5,-2,4,2,-4,8,4,-2,2,0,0,-1,12,-2,-1,3,0,0,0,-1,1,0,-1,3,-1
KR_6759208410,440,-4,-24,6,-3,-1,2,1,-1,3,2,0,1,1,-1,1,0,0,1,1,1,-4,2,-2,-4,6,1,0,0,-1,1,-1,1,6,-1
KR_6735504966,440,2,69,7,5,0,3,3,2,1,3,1,3,4,4,0,4,-2,2,0,0,5,6,-3,-3,6,6,0,1,0,0,1,1,0,-1
KR_6649741906,420,-2,-79,16,-7,-3,3,0,-3,5,2,-1,1,0,0,2,2,0,0,0,0,-4,-16,-1,0,1,-1,0,0,-1,-1,0,-1,2,-1
KR_6760309859,420,-2,-17,-33,6,2,2,4,-5,6,1,2,3,5,4,0,4,3,0,3,3,10,4,5,-6,1,4,0,-1,1,-1,-1,1,6,-1
KR_6687875025,440,1,-13,-17,2,0,1,1,2,1,3,2,3,5,-1,1,0,-1,1,0,0,-6,-31,4,-4,0,1,0,1,-1,1,1,1,4,-1
KR_6762784254,420,2,70,-28,10,1,0,1,0,1,1,3,0,3,4,7,11,2,0,2,1,16,-6,-3,-1,4,4,0,0,-1,0,1,1,1,-1
KR_6676242599,420,1,0,-4,-1,-2,2,0,0,2,2,2,2,4,-1,4,3,0,1,1,0,-1,49,3,-4,1,-17,0,1,-1,-1,1,-1,5,-1
KR_6753582567,420,-3,-106,-19,-5,0,0,0,1,2,3,-3,5,2,-3,4,1,0,0,0,0,-4,1,0,-3,3,-2,0,0,1,0,0,-1,1,-1
KR_6743389046,420,-1,-66,16,-10,2,2,4,-4,5,1,1,1,2,-7,7,0,-2,3,1,-1,-3,18,1,-6,5,-11,0,-1,-1,-1,-1,-1,2,-1
KR_6738949625,420,-1,16,-24,-9,4,0,4,-7,8,1,2,4,6,-4,5,1,-4,5,1,2,-6,7,-1,-1,2,0,0,2,-1,1,1,1,2,-1
KR_6747159881,420,-4,-24,-21,-12,-1,3,2,-6,7,1,-5,7,2,-3,3,0,3,0,3,-1,-4,16,0,-3,3,-3,0,-1,1,-1,-1,-1,5,-1
KR_6751183075,420,-5,-98,-14,-9,3,0,3,-4,5,1,-4,5,1,-3,5,2,-1,1,0,0,-13,-25,-7,-1,8,-1,0,-1,0,0,-1,1,0,-1
KR_6643970785,420,-3,-25,-44,-8,-9,10,1,-5,6,1,0,4,4,6,1,7,0,0,0,-3,-6,1,-1,0,1,2,0,-1,-1,-1,-1,-1,4,-1
KR_6763337609,440,0,57,-2,1,-4,6,2,1,2,3,-2,3,1,4,1,5,2,1,3,-1,-2,405,-1,-2,3,0,0,0,-1,-1,1,-1,5,-1
KR_6697462127,420,-1,-54,6,-5,-1,3,2,2,6,8,-4,5,1,-1,2,1,-1,1,0,-2,2,-2,0,-1,1,2,0,-3,-1,1,-1,-1,5,-1
KR_6444974995,420,-4,27,-20,-6,-1,1,0,0,1,1,-5,6,1,2,1,3,-2,3,1,0,-3,4,5,-7,2,-1,0,0,0,-1,-1,-1,0,-1
KR_6493355933,420,3,55,-1,3,0,1,1,3,1,4,-3,4,1,3,1,4,0,0,0,0,1,-9,-1,-4,5,4,0,0,0,-1,0,-1,0,-1
KR_6707277767,420,0,-29,56,0,5,0,5,2,0,2,-3,4,1,-2,2,0,-2,2,0,0,0,17,1,-2,1,-1,0,-1,-1,0,-1,1,6,-1
KR_6719003941,420,-3,31,-12,-7,-7,7,0,0,3,3,-2,2,0,2,3,5,0,4,4,0,1,-1,-4,0,4,0,0,1,-1,1,1,1,6,-1
KR_6475473702,420,-4,-9,13,-10,1,0,1,-8,9,1,0,2,2,-3,3,0,0,0,0,0,-8,11,-2,-3,5,-4,0,0,-1,-1,0,1,2,-1
KR_5762015173,420,-3,-51,0,-5,-2,3,1,8,1,9,-7,8,1,-4,4,0,0,2,2,0,-1,9,-2,-3,5,-2,0,-1,1,0,-1,1,1,-1
KR_6606816085,420,-5,-71,-20,-12,1,2,3,-2,2,0,-8,8,0,-3,3,0,0,1,1,0,-8,-5,1,-3,2,-2,0,-1,-1,-1,-1,-1,2,-1
KR_6759665141,440,-2,-57,6,-4,-1,2,1,0,4,4,-2,4,2,0,1,1,-1,1,0,0,-9,-1,-1,-3,4,3,0,-3,0,-1,-1,1,0,-1
KR_6745800623,420,0,5,28,2,2,0,2,4,1,5,-3,4,1,-4,6,2,3,4,7,0,0,1,-2,-1,3,-3,0,-2,0,0,-1,-1,0,-1
KR_6624513291,420,-5,-54,-19,-9,-3,5,2,-6,6,0,-3,3,0,2,1,3,1,0,1,0,-2,1,-1,-2,3,-1,0,-2,-1,0,-1,-1,3,-1
KR_6749562003,420,-3,25,12,-9,-1,2,1,-7,7,0,1,4,5,-1,1,0,-1,1,0,0,-18,24,-2,-2,4,-20,0,1,-1,1,1,1,3,-1
KR_6722010589,420,-5,-57,-24,-9,-1,2,1,-1,2,1,0,1,1,-1,2,1,-6,6,0,-1,-5,-2,-4,-3,7,-2,0,0,-1,-1,-1,-1,3,-1
KR_6759834650,420,-3,-88,20,-3,2,0,2,-7,7,0,-7,7,0,5,0,5,4,0,4,0,1,13,-1,0,1,-4,0,-2,1,-1,-1,1,1,-1
KR_6706720688,420,-4,-45,-29,6,6,0,6,1,1,2,-3,3,0,0,2,2,2,2,4,0,4,-5,0,-2,2,-2,0,-2,-1,1,-1,-1,3,-1
KR_6737623640,420,-2,7,-4,-5,-2,3,1,-6,7,1,1,4,5,2,3,5,0,2,2,0,0,-5,-1,-10,11,-1,0,-1,0,0,-1,-1,0,-1
KR_6688836645,420,-2,-7,-8,-7,1,2,3,-2,4,2,-3,3,0,-1,5,4,-2,3,1,-1,-6,3,3,-7,4,-3,0,0,-1,1,0,-1,4,-1
KR_6662080994,420,-3,-64,0,-1,0,1,1,-2,3,1,0,0,0,0,0,0,1,0,1,0,0,7,0,-4,4,-2,0,0,-1,-1,0,1,5,-1
KR_6714035161,420,-7,-95,-56,-5,-1,2,1,-1,1,0,-3,3,0,1,1,2,-1,2,1,0,-4,287,2,-5,3,0,0,0,0,-1,-1,-1,0,-1
KR_6727101159,420,1,-34,28,-2,5,0,5,2,0,2,-3,5,2,-4,6,2,-2,2,0,0,-7,-25,5,-8,3,8,0,1,1,1,1,1,5,-1
KR_6598540084,420,-4,-121,-27,-9,-4,4,0,-1,3,2,-2,2,0,-1,1,0,-1,2,1,0,-6,-18,-2,-2,4,4,0,-2,-1,1,-1,-1,4,-1
KR_6638414880,420,3,3,4,4,1,1,2,-1,4,3,3,0,3,4,2,6,-3,3,0,1,4,-273,-2,-1,3,-1,0,0,-1,1,0,1,5,-1
KR_6746882077,420,-3,26,-12,-5,5,1,6,-1,3,2,-1,1,0,-7,7,0,-1,1,0,0,-9,-4,0,-1,1,1,0,1,1,1,1,1,5,-1
KR_6702561016,420,-6,-126,-15,-22,-8,8,0,2,3,5,-6,6,0,-8,8,0,-2,3,1,-3,-30,-6,-3,-1,4,2,-1,-7,-1,-1,-1,-1,3,-1
KR_6582465160,420,-3,-74,-4,-9,-4,5,1,-4,6,2,0,3,3,-2,6,4,1,0,1,1,6,7,1,-4,3,-1,0,-1,-1,-1,-1,1,3,-1
KR_6736904889,420,-4,-59,-16,-10,-1,2,1,0,2,2,-7,8,1,-3,4,1,1,0,1,0,-5,-41,3,-4,1,22,0,-1,-1,-1,-1,-1,1,-1
KR_6726948778,420,0,-25,-3,1,3,0,3,-1,6,5,3,2,5,-5,7,2,1,1,2,0,2,323,2,-2,0,5,0,-1,1,1,-1,1,5,-1
KR_6513385371,420,-1,8,-24,-4,4,1,5,-5,8,3,-1,3,2,-2,3,1,0,1,1,0,-9,14,1,-3,2,-2,0,0,1,-1,0,-1,5,-1
KR_6753244009,420,-4,-56,-12,-1,4,1,5,0,6,6,0,4,4,-3,4,1,-2,2,0,0,1,271,1,-2,1,-4,0,0,1,-1,-1,-1,3,-1
KR_6696650460,420,-2,59,3,4,4,0,4,-6,7,1,-2,2,0,7,1,8,1,0,1,1,3,24,-2,-2,4,0,0,1,1,1,1,1,4,-1
KR_6592541680,420,-2,-31,-20,0,0,1,1,1,2,3,-1,3,2,0,5,5,0,2,2,0,0,1,-1,-3,4,-2,0,0,1,-1,1,-1,3,-1
KR_6742473881,440,1,86,-12,5,3,1,4,3,0,3,5,3,8,-5,6,1,-1,1,0,0,-1,-10,4,-7,3,2,0,1,0,0,1,1,0,-1
KR_6533908896,420,-1,-46,4,0,-2,4,2,0,1,1,0,1,1,-1,3,2,3,0,3,0,0,-124,-2,-7,9,1,0,-2,-1,-1,-1,-1,2,-1
KR_6725905274,420,1,-22,-30,1,0,1,1,1,1,2,2,0,2,1,2,3,-3,3,0,0,2,-192,-3,-2,5,0,0,0,-1,1,0,1,6,-1
KR_6656651208,420,0,-5,-8,-4,-2,2,0,-1,3,2,-3,5,2,1,4,5,1,1,2,-2,2,-106,2,-5,3,-2,0,0,-1,-1,0,-1,4,-1
KR_6708831711,420,-7,-82,-39,-13,-3,3,0,-5,9,4,-1,1,0,-3,3,0,-1,1,0,-3,-11,-21,-1,-1,2,0,0,-3,-1,1,-1,-1,4,-1
KR_6751637621,420,-2,-87,-17,-12,-3,5,2,0,2,2,-1,6,5,-8,8,0,0,2,2,-1,-10,-1,1,-5,4,2,0,-1,0,0,-1,-1,0,-1
KR_6676449971,420,-1,32,-28,-7,-1,3,2,-1,2,1,2,1,3,-7,8,1,0,1,1,0,-4,-5,1,-8,7,7,0,0,-1,-1,0,1,2,-1
KR_6606532207,420,0,13,16,-3,-4,5,1,2,2,4,3,0,3,-1,2,1,-3,4,1,0,-6,-5,-1,-1,2,-1,0,-2,-1,-1,-1,-1,1,-1
KR_6732117962,440,-2,3,-4,1,1,5,6,1,2,3,1,3,4,4,1,5,-6,8,2,2,9,5,-4,-1,5,3,0,1,1,0,1,1,1,-1
KR_6530313116,420,-7,-126,-18,-19,-2,3,1,-7,10,3,0,1,1,-8,10,2,-2,2,0,0,-16,12,-6,-1,7,-3,0,-3,-1,-1,-1,-1,2,-1
KR_6695905484,440,5,47,20,7,0,4,4,2,2,4,7,0,7,0,2,2,-2,2,0,0,4,0,0,-4,4,3,0,2,1,1,1,-1,5,-1
KR_6659045365,420,-1,10,4,-2,0,1,1,0,1,1,0,5,5,-1,2,1,-1,1,0,1,-4,-38,3,-4,1,-2,0,0,-1,-1,0,1,1,-1
KR_6743907935,440,0,29,-8,-3,-1,1,0,-6,10,4,-1,1,0,6,2,8,-1,2,1,-2,-3,-11,-1,-2,3,-2,0,1,-1,-1,-1,-1,6,-1
KR_6740073501,420,0,23,12,-6,-3,4,1,-3,5,2,0,2,2,-1,3,2,1,1,2,0,-7,490,-6,-2,8,-10,0,0,-1,-1,0,1,5,-1
KR_6626294259,420,0,61,-3,-4,7,2,9,-2,3,1,-1,4,3,-6,9,3,-2,2,0,-2,-10,-11,-3,-1,4,-1,0,1,1,-1,1,-1,3,-1
KR_5896870667,440,-2,-42,7,3,5,0,5,0,1,1,1,1,2,-1,1,0,-2,2,0,0,1,-15,-1,-1,2,-3,0,1,1,1,1,1,4,-1
KR_6760000588,420,2,-28,32,2,2,2,4,2,5,7,1,1,2,-2,3,1,-1,2,1,0,2,-1,-2,0,2,-1,0,1,1,1,-1,-1,6,-1
KR_6729813051,440,-3,-128,27,-10,0,1,1,2,2,4,-4,5,1,-7,7,0,-1,1,0,-2,-2,-10,0,-5,5,3,0,-1,1,1,-1,-1,3,-1
KR_6113946901,420,1,38,24,0,1,2,3,-1,2,1,1,0,1,-2,2,0,1,1,2,0,0,1,4,-5,1,4,0,0,-1,1,0,-1,1,-1
KR_6759364058,420,-2,-49,0,-5,-1,2,1,0,3,3,0,5,5,-3,4,1,-1,2,1,0,-10,45,-3,0,3,-26,0,0,0,0,0,-1,0,-1
KR_6642983550,420,1,73,-12,11,4,0,4,6,1,7,2,0,2,0,4,4,-1,2,1,2,6,5,0,-2,2,0,0,0,0,0,0,1,0,-1
KR_6750619101,420,-1,-27,-12,-2,-4,4,0,-4,5,1,3,3,6,1,4,5,2,1,3,-1,0,41,-1,-1,2,-28,0,0,0,-1,0,-1,0,-1
KR_6689601560,420,1,-74,4,2,2,2,4,1,0,1,-3,3,0,3,0,3,-1,2,1,1,7,0,1,-1,0,0,0,0,-1,0,0,1,3,-1
KR_6705470859,420,0,6,6,-1,1,2,3,1,1,2,-2,5,3,-1,1,0,0,0,0,1,-1,-8,1,-1,0,1,0,1,1,1,1,1,2,-1
KR_6760357752,420,-3,-39,4,-11,1,0,1,-3,5,2,1,1,2,-10,10,0,0,1,1,0,-8,344,-1,-3,4,1,0,0,1,-1,0,-1,3,-1
KR_6675552168,420,-2,41,-3,-3,-1,1,0,-4,4,0,4,1,5,-1,1,0,-1,3,2,0,-9,0,6,-7,1,0,0,-1,1,-1,-1,1,3,-1
KR_6753595760,420,-2,2,-8,1,0,4,4,1,1,2,-1,3,2,-5,6,1,6,0,6,0,-1,-7,-2,-4,6,-2,0,1,-1,-1,1,1,5,-1
KR_6097466386,420,0,-5,0,-3,-2,3,1,-2,3,1,-3,4,1,-1,2,1,5,0,5,0,-4,3,-1,-4,5,5,0,-1,1,1,-1,1,5,-1
KR_6503666703,420,-3,-66,-2,-3,-2,3,1,-3,5,2,4,0,4,-3,5,2,1,0,1,-2,0,-48,-7,0,7,16,0,-2,-1,-1,-1,-1,2,-1
KR_6744825836,440,-1,-42,-2,8,3,3,6,-1,3,2,5,1,6,0,3,3,1,1,2,0,7,23,0,-3,3,4,0,0,-1,1,-1,1,1,-1
KR_6662192760,420,-1,12,13,0,-2,2,0,2,1,3,1,4,5,2,3,5,-3,6,3,0,4,2,0,-4,4,2,0,0,0,-1,-1,1,0,-1
KR_6641783935,420,1,-51,0,3,3,0,3,0,5,5,3,3,6,-3,5,2,0,0,0,0,3,7,1,-2,1,-1,0,-1,-1,-1,-1,-1,5,-1
KR_6762272274,440,-1,27,-20,2,5,0,5,1,0,1,-5,8,3,1,1,2,0,1,1,0,-2,2,1,-6,5,-4,0,-1,-1,-1,-1,1,2,-1
KR_6738015248,420,-2,39,-37,-6,-1,1,0,-5,6,1,1,1,2,-1,3,2,0,1,1,0,-3,-5,2,-3,1,3,0,0,0,-1,0,-1,0,-1
KR_6658319693,440,-5,-64,-28,-8,-1,1,0,-3,3,0,-4,6,2,-2,3,1,2,2,4,0,-4,1,1,-4,3,-2,0,-1,-1,-1,-1,-1,4,-1
KR_6668824158,420,0,-8,0,0,-2,2,0,2,3,5,-2,3,1,0,2,2,2,1,3,0,3,-5,-1,-2,3,2,0,1,0,0,1,-1,0,-1
KR_6752004435,420,-1,2,0,-5,-1,3,2,0,2,2,-1,3,2,-2,6,4,-1,2,1,1,-3,27,3,-5,2,-2,0,0,-1,-1,0,1,3,-1
KR_6763836562,420,1,-28,-15,-4,4,0,4,-6,6,0,-3,4,1,0,0,0,1,0,1,0,-6,488,0,-1,1,2,0,0,-1,0,1,-1,1,-1
KR_6731851187,420,-1,9,0,-7,-1,2,1,-3,6,3,-1,2,1,0,2,2,-2,2,0,0,-5,-9,-3,-1,4,1,0,0,-1,-1,-1,-1,4,-1
KR_6711148391,420,-1,-42,21,-1,-5,5,0,3,1,4,0,1,1,0,4,4,1,0,1,-1,-1,34,5,-5,0,-24,0,0,-1,1,1,-1,1,-1
KR_6678216250,420,0,-5,-28,-9,3,1,4,0,2,2,1,2,3,-11,12,1,-2,2,0,-1,-13,2,1,-2,1,-1,0,-1,-1,1,-1,1,3,-1
KR_6592217930,420,-5,-29,-32,-6,-1,2,1,-1,2,1,-3,5,2,-2,4,2,1,2,3,0,-2,-14,0,-1,1,0,0,-2,1,0,-1,1,4,-1
KR_6605327772,420,-2,-11,-26,-7,3,0,3,-4,6,2,-2,4,2,-1,1,0,-3,4,1,3,-5,9,6,-7,1,-3,0,0,-1,1,-1,1,1,-1
KR_6659122190,420,1,-21,-16,9,6,0,6,-1,3,2,1,1,2,3,0,3,0,1,1,0,10,-2,-1,-5,6,-1,0,0,-1,1,0,1,3,-1
KR_6758051024,440,2,85,8,-3,-4,4,0,2,0,2,-3,7,4,5,6,11,-3,4,1,-1,-12,310,3,-5,2,2,0,1,0,0,1,-1,0,-1
KR_6741158688,440,-5,-105,-4,-10,-6,6,0,-4,5,1,-4,6,2,1,0,1,3,1,4,0,-4,-276,-5,-1,6,-15,0,0,-1,-1,-1,-1,6,-1
KR_6723559241,420,-3,-56,-32,-9,-5,7,2,-5,5,0,0,2,2,1,0,1,0,0,0,1,-2,10,-1,0,1,-2,0,0,-1,0,0,1,4,-1
KR_6610418998,420,1,-54,20,-3,0,1,1,-1,3,2,1,1,2,-3,4,1,0,0,0,0,-2,-39,-3,0,3,27,0,-1,-1,0,-1,-1,4,-1
KR_6607148273,420,1,10,20,4,-4,4,0,-3,6,3,4,0,4,6,0,6,1,2,3,0,2,-25,-2,0,2,24,0,1,0,0,1,1,0,-1
KR_6750724598,420,-1,54,28,-1,0,3,3,-5,5,0,0,2,2,6,1,7,-2,3,1,0,-5,356,4,-6,2,-1,0,1,1,0,1,1,4,-1
KR_6604293270,420,-1,31,46,1,1,2,3,1,3,4,-1,3,2,0,0,0,0,0,0,0,5,-9,-4,-1,5,-1,0,0,1,-1,0,1,6,-1
KR_6522759061,420,0,-13,24,4,-4,5,1,-1,2,1,-8,10,2,13,1,14,4,1,5,0,5,25,-3,-1,4,-9,0,1,-1,-1,1,-1,1,-1
KR_6610644076,420,1,-14,40,-1,2,0,2,-2,5,3,0,4,4,0,2,2,-1,1,0,1,-5,-4,-5,-3,8,4,0,1,1,1,1,1,3,-1
KR_6581661852,440,-4,2,-43,-16,-9,10,1,-2,4,2,-1,2,1,-2,2,0,-2,4,2,-1,-14,-148,-4,-4,8,2,0,-2,-1,-1,-1,-1,1,-1
KR_6443739798,420,-1,-30,-49,2,4,0,4,-3,5,2,-3,6,3,2,3,5,2,1,3,0,6,-3,-6,-2,8,3,0,1,-1,1,1,-1,6,-1
KR_6764012335,420,0,-69,0,-3,5,0,5,1,0,1,0,3,3,-8,10,2,-1,1,0,0,-4,-2,-1,0,1,-1,0,-1,1,-1,-1,-1,2,-1
KR_6671237597,420,0,-18,40,-5,-4,4,0,0,0,0,1,0,1,-1,1,0,-1,1,0,0,-4,-4,0,-3,3,3,0,-1,1,-1,-1,-1,3,-1
KR_6758028231,420,-7,-101,-28,-17,-2,2,0,-6,6,0,-3,3,0,-5,6,1,-1,1,0,-1,-9,10,1,-3,2,-5,0,-2,-1,1,-1,-1,5,-1
KR_6676564370,420,-3,-55,4,-14,-5,5,0,-2,3,1,-3,3,0,-4,4,0,0,2,2,-1,-20,-40,0,-4,4,1,0,-3,1,-1,-1,-1,1,-1
KR_6722281510,420,1,14,8,3,-1,2,1,3,3,6,2,2,4,0,2,2,-1,1,0,0,1,8,5,-8,3,-1,0,0,1,-1,1,1,1,-1
KR_6688820061,420,-1,-108,-27,1,-3,3,0,4,0,4,-3,4,1,-1,4,3,4,1,5,0,8,-5,-2,-3,5,-1,0,-1,1,-1,-1,1,1,-1
KR_6759890493,420,-2,-24,-32,-1,-2,3,1,-4,5,1,1,3,4,3,0,3,1,0,1,0,1,47,0,-3,3,-24,0,-1,0,-1,-1,1,0,-1
KR_6730109829,420,-4,-43,-16,2,3,0,3,-1,4,3,1,2,3,-1,4,3,0,1,1,2,7,-11,-5,-1,6,1,0,0,-1,-1,0,1,5,-1
KR_6658887031,420,-2,10,-31,-4,7,0,7,-2,4,2,0,5,5,-10,10,0,1,0,1,0,-1,-140,0,-3,3,-1,0,1,-1,-1,1,-1,5,-1
KR_6761353838,420,-3,-65,-17,-5,1,0,1,-1,5,4,-2,2,0,-3,5,2,0,1,1,0,0,7,5,-8,3,1,0,0,1,1,0,-1,6,-1
KR_6611890314,440,-4,-37,-8,-11,-3,5,2,1,3,4,-9,10,1,0,2,2,0,2,2,0,-2,4,-2,-4,6,-2,0,-2,-1,1,-1,-1,2,-1
KR_6548122170,420,-1,20,-32,3,-1,2,1,2,6,8,1,0,1,3,2,5,-2,2,0,0,12,-6,-1,-3,4,2,0,0,0,0,0,1,0,-1
KR_6759668548,440,-3,-116,0,-8,-3,3,0,-5,5,0,-1,3,2,-1,4,3,2,0,2,0,-10,12,-5,-2,7,-1,0,-1,-1,-1,-1,-1,5,-1
KR_6644922603,420,-6,-124,-47,-12,-8,8,0,-1,6,5,-1,3,2,1,2,3,-3,3,0,-1,-9,-8,-1,0,1,1,0,-3,-1,1,-1,-1,2,-1
KR_6729852758,440,-2,-75,-16,-6,-1,1,0,1,1,2,3,2,5,-8,9,1,-1,2,1,0,-5,-9,3,-4,1,-3,0,-1,-1,-1,-1,1,6,-1
KR_6737279394,420,-2,-36,-44,7,-3,4,1,2,1,3,5,1,6,2,1,3,1,0,1,0,5,2,-2,-2,4,-1,0,-2,-1,-1,-1,-1,2,-1
KR_6739176754,420,-5,-116,-24,-9,2,0,2,-1,4,3,-5,6,1,-4,6,2,-1,1,0,0,-6,10,1,-3,2,2,0,-1,1,-1,-1,-1,1,-1
KR_6725905450,420,-2,26,-24,-8,1,0,1,-2,3,1,-1,3,2,-5,7,2,-1,1,0,0,-8,0,1,-1,0,-5,0,-1,-1,1,-1,1,5,-1
KR_6695578517,420,1,39,-19,2,1,2,3,1,1,2,2,1,3,-4,4,0,2,0,2,0,1,-114,2,-4,2,3,0,-1,-1,-1,-1,-1,6,-1
KR_6639000646,420,-1,-163,-1,-2,0,0,0,2,4,6,-1,3,2,-5,7,2,2,1,3,0,7,31,0,-2,2,-18,0,-2,-1,-1,-1,1,6,-1
KR_6662710510,420,2,-6,32,0,1,0,1,0,4,4,2,1,3,-4,4,0,1,0,1,-2,-8,-56,-4,-2,6,1,0,0,-1,1,-1,-1,2,-1
KR_6762727417,420,-2,-81,-17,-5,-2,5,3,1,1,2,-2,2,0,-3,11,8,1,1,2,-1,1,7,-2,0,2,-1,0,-1,-1,1,-1,-1,5,-1
KR_6740308145,420,-1,-11,-12,-8,-2,2,0,-1,3,2,0,2,2,0,3,3,-5,6,1,-1,-3,1,4,-7,3,2,0,-1,-1,-1,-1,-1,5,-1
KR_6723804060,420,0,-17,-8,1,0,2,2,3,1,4,-3,3,0,2,1,3,-1,2,1,0,0,0,7,-9,2,-3,0,-1,1,0,-1,1,5,-1
KR_6724613495,420,-1,0,24,-3,-1,3,2,0,4,4,0,1,1,-3,5,2,1,0,1,0,-3,-4,-1,-3,4,3,0,0,0,0,0,-1,0,-1
KR_6629952507,420,3,28,25,12,-2,3,1,2,3,5,2,1,3,5,2,7,5,0,5,-1,10,-10,2,-4,2,2,0,1,1,0,1,-1,4,-1
KR_6741954469,420,-4,0,-28,-12,2,3,5,-9,10,1,-1,2,1,-3,3,0,-1,1,0,0,-15,-83,-4,-1,5,-3,0,-1,-1,-1,-1,-1,4,-1
KR_6652078733,420,3,29,27,1,-1,1,0,1,1,2,2,1,3,0,0,0,-1,1,0,0,-2,6,2,-4,2,2,0,0,1,0,0,-1,2,-1
KR_6740942446,420,-4,-77,22,-10,0,0,0,-3,5,2,-4,4,0,-2,3,1,-1,1,0,0,-9,-19,-5,0,5,2,0,0,-1,1,0,1,2,-1
KR_6755431069,420,-4,-98,-8,-8,-4,4,0,2,6,8,-2,3,1,-1,3,2,-3,4,1,0,-7,-9,4,-4,0,-6,0,-1,-1,-1,-1,-1,2,-1
KR_6452009887,420,0,-5,4,4,-1,2,1,2,0,2,1,3,4,1,3,4,1,2,3,0,6,-3,-2,-2,4,4,0,0,-1,1,-1,1,1,-1
KR_6749597872,420,-1,-31,-27,0,3,1,4,-1,3,2,-3,4,1,1,2,3,0,1,1,0,-1,-23,1,-4,3,20,0,1,1,1,1,-1,1,-1
KR_6760322890,420,-2,-67,4,-6,-2,6,4,-4,4,0,-1,2,1,1,1,2,0,0,0,0,-3,-6,-5,-1,6,1,0,-2,1,-1,-1,-1,3,-1
KR_6574776335,420,-1,7,-8,-4,6,1,7,-3,3,0,-4,6,2,-3,3,0,0,2,2,-1,-9,-258,-5,-2,7,-2,0,2,-1,1,1,-1,3,-1
KR_6761735428,420,0,16,-23,-2,-3,6,3,0,0,0,-3,5,2,3,1,4,1,1,2,0,2,-4,-2,-4,6,-1,0,0,-1,0,1,1,4,-1
KR_6750550563,420,-7,-89,-8,-5,0,1,1,3,1,4,-8,8,0,-3,3,0,3,0,3,0,3,2,3,-4,1,-2,0,0,1,1,1,-1,3,-1
KR_6696623756,420,-2,-6,-32,-8,-5,5,0,-3,4,1,2,3,5,-2,3,1,0,4,4,0,-4,-424,-1,-3,4,0,0,-1,-1,-1,-1,1,3,-1
KR_6706138837,420,0,-13,-20,4,3,0,3,1,3,4,0,1,1,0,1,1,0,1,1,0,0,8,-2,-1,3,-2,0,1,-1,1,1,1,2,-1
KR_6761832107,420,-4,-42,-40,-10,0,2,2,-4,4,0,-3,5,2,-1,4,3,-2,2,0,0,-9,-210,-3,0,3,0,0,0,-1,-1,-1,-1,2,-1
KR_6592455598,420,-1,-65,-28,-1,1,5,6,0,1,1,-4,4,0,4,0,4,-2,2,0,0,3,-2,-1,-4,5,5,0,-1,-1,-1,-1,1,5,-1
KR_6612688289,420,0,-86,0,1,2,0,2,0,2,2,0,1,1,1,2,3,-2,2,0,0,-1,116,0,-2,2,1,0,0,-1,1,0,-1,3,-1
KR_6704632993,420,-4,-57,-11,-2,0,1,1,0,1,1,1,1,2,-5,7,2,2,0,2,0,-4,-41,1,-5,4,20,0,-1,0,-1,-1,-1,0,-1
KR_6727365594,420,-7,-126,-36,-7,-1,2,1,0,1,1,-2,2,0,-4,5,1,0,0,0,1,-3,-8,-1,-4,5,-1,0,-1,-1,1,-1,1,2,-1
KR_6626621904,420,-2,-55,8,-6,-1,2,1,-3,4,1,-3,4,1,1,1,2,0,2,2,0,-5,-1,0,-2,2,-1,0,0,1,-1,1,1,6,-1
KR_6656936872,420,0,18,-8,1,2,1,3,-3,3,0,2,0,2,-1,2,1,1,0,1,0,2,2,-1,-3,4,-1,0,0,-1,-1,-1,-1,4,-1
KR_6712559657,420,-6,-112,24,-7,1,2,3,-4,5,1,-1,3,2,-4,5,1,1,0,1,0,-9,-7,0,-5,5,2,0,-1,1,-1,-1,-1,4,-1
KR_6628928352,420,-1,52,-16,2,2,1,3,-3,5,2,-1,3,2,1,0,1,3,1,4,0,2,-7,0,-3,3,1,0,0,1,-1,-1,1,1,-1
KR_6729344855,420,0,21,-12,-3,2,0,2,1,3,4,-7,7,0,3,1,4,-2,2,0,0,-8,0,1,-5,4,-5,0,0,-1,1,0,1,3,-1
KR_6752197657,440,-3,-5,-20,-8,-1,3,2,0,2,2,-1,2,1,-5,7,2,-1,2,1,0,-13,-5,-7,-3,10,2,0,0,1,-1,0,-1,4,-1
KR_6717479579,440,-4,26,0,-13,-1,6,5,-5,7,2,-1,3,2,-6,7,1,0,0,0,0,-21,-12,-3,-1,4,-4,0,-1,-1,1,-1,-1,5,-1
KR_6706102833,420,9,76,64,11,1,0,1,6,0,6,-1,3,2,6,3,9,-1,1,0,0,3,-4,-4,0,4,0,0,1,0,0,1,1,0,-1
KR_6363065206,420,-7,-76,8,-11,-2,3,1,-3,5,2,-4,4,0,-3,5,2,1,0,1,0,-8,0,0,0,0,-3,0,-1,-1,-1,-1,-1,2,-1
KR_6629985665,420,-2,-61,-4,-1,0,3,3,-4,5,1,0,3,3,3,2,5,0,1,1,0,2,-27,-1,-6,7,-2,0,-1,-1,0,-1,-1,1,-1
KR_6504409479,440,-5,-116,12,4,-3,3,0,4,1,5,0,1,1,4,3,7,-1,4,3,0,-1,-76,-2,-2,4,1,0,0,-1,-1,-1,-1,3,-1
KR_6437403690,420,-5,-65,5,-6,-1,3,2,-3,6,3,-1,4,3,-1,1,0,0,1,1,0,-2,-11,-2,-2,4,5,0,-1,1,-1,-1,1,6,-1
KR_6573483080,420,-4,-22,-30,-16,0,2,2,-8,10,2,0,2,2,-5,5,0,-3,4,1,0,-14,5,1,-7,6,-7,0,-1,-1,-1,-1,-1,2,-1
KR_6702349257,420,0,-35,12,1,-3,3,0,5,1,6,-1,6,5,0,1,1,0,0,0,0,3,5,0,-1,1,1,0,0,-1,-1,1,1,5,-1
KR_6754908568,420,4,6,-16,6,-1,1,0,1,1,2,2,4,6,3,2,5,1,0,1,0,9,-385,-7,-4,11,-1,0,-2,-1,-1,-1,1,3,-1
KR_6637236710,440,-1,19,-16,-3,1,2,3,-4,4,0,2,1,3,-2,6,4,0,2,2,2,-1,6,1,-2,1,-2,0,-2,1,-1,-1,1,2,-1
KR_6662889328,440,-3,-97,-15,-15,-3,4,1,-5,7,2,-3,4,1,-1,4,3,-3,3,0,0,-9,-3,2,-4,2,-2,0,-1,1,0,-1,-1,3,-1
KR_6739199965,420,-6,-70,-6,-13,0,0,0,-2,3,1,1,1,2,-11,11,0,-1,1,0,1,-12,-2,-2,-2,4,-3,0,-1,-1,-1,-1,1,3,-1
KR_6597195857,420,-1,5,-24,-6,2,0,2,-5,6,1,-1,3,2,-1,2,1,-1,2,1,1,-7,0,0,-5,5,-1,0,-1,-1,1,-1,1,2,-1
KR_6634668852,420,1,-6,24,-1,3,0,3,-2,4,2,-1,3,2,-1,4,3,0,2,2,0,1,-7,1,-2,1,2,0,0,-1,0,0,-1,4,-1
KR_6658491965,420,-9,-52,-118,-14,-2,3,1,-4,5,1,-7,7,0,-5,7,2,4,0,4,-1,-18,-19,-3,0,3,-1,0,-3,-1,-1,-1,-1,5,-1
KR_6759696099,420,2,58,-4,3,2,0,2,-1,2,1,1,0,1,0,3,3,1,0,1,0,2,-9,-5,0,5,2,0,0,-1,1,1,1,2,-1
KR_6688263850,420,0,-102,-36,-2,0,1,1,0,1,1,-2,3,1,0,2,2,0,0,0,0,0,-2,7,-7,0,-1,0,0,-1,-1,-1,-1,5,-1
KR_6761996973,420,1,31,16,-4,3,2,5,3,3,6,-8,9,1,-2,5,3,0,0,0,-4,-13,220,1,-2,1,1,0,1,-1,1,1,-1,2,-1
KR_6648936775,440,-1,78,-16,-3,-2,3,1,1,0,1,1,0,1,-1,3,2,-2,2,0,0,-5,-66,1,-5,4,-2,0,0,-1,1,0,1,2,-1
KR_6633981980,420,0,-76,22,-4,-4,4,0,-2,4,2,-3,4,1,6,0,6,-1,2,1,-1,2,-2,-2,-1,3,-1,0,-1,0,-1,-1,-1,0,-1
KR_6745036676,420,-3,-85,-8,-5,-2,3,1,0,3,3,-2,5,3,0,3,3,-1,1,0,1,-1,-44,-2,-2,4,23,0,0,1,-1,0,1,1,-1
KR_6711326421,420,-2,-71,50,-7,1,2,3,-2,3,1,-9,12,3,2,2,4,1,1,2,1,-3,-16,3,-5,2,-4,0,0,1,1,-1,1,3,-1
KR_6683118766,420,1,-23,-2,-1,-3,6,3,2,3,5,-2,2,0,-1,4,3,3,0,3,0,-5,-6,-3,-3,6,4,0,0,0,1,-1,-1,0,-1
KR_6422747256,420,2,14,4,4,4,0,4,2,1,3,0,3,3,0,2,2,-2,2,0,0,7,-171,-1,-2,3,0,0,0,1,-1,1,-1,6,-1
KR_6740275111,420,-2,-116,4,-5,1,1,2,1,0,1,-4,6,2,1,2,3,-4,4,0,0,-3,22,-3,-2,5,5,0,-1,1,-1,-1,-1,6,-1
KR_6722474354,420,-1,4,-11,-2,1,1,2,-3,4,1,-1,2,1,0,4,4,1,1,2,0,-6,-7,-2,-2,4,3,0,1,-1,-1,1,-1,6,-1
KR_6762671384,420,-6,-72,-14,-3,1,1,2,-1,1,0,-1,3,2,-2,3,1,0,2,2,0,1,13,2,-5,3,-9,0,-1,0,-1,-1,1,0,-1
KR_6725396277,420,-1,-77,9,-1,-3,3,0,-1,5,4,1,4,5,2,1,3,0,1,1,0,-2,320,0,-1,1,-1,0,-1,1,-1,-1,-1,2,-1
KR_6708951486,420,0,-40,0,-3,2,1,3,-2,3,1,1,2,3,-4,6,2,0,1,1,0,-9,-259,-2,-1,3,-1,0,0,-1,1,0,-1,2,-1
KR_6666746997,420,1,-24,-39,3,1,1,2,-2,3,1,0,2,2,2,1,3,2,2,4,0,1,1,-3,-3,6,3,0,-1,-1,-1,-1,1,5,-1
KR_6637249191,420,2,-36,-21,1,0,1,1,0,2,2,-1,3,2,0,4,4,2,3,5,0,2,-8,0,-5,5,-1,0,0,-1,1,0,-1,1,-1
KR_6731790264,420,0,-54,16,1,-2,3,1,2,0,2,0,2,2,0,1,1,1,2,3,0,4,-42,2,-3,1,24,0,0,1,0,-1,-1,5,-1
KR_6676557233,420,2,15,8,1,-1,2,1,-1,4,3,1,0,1,2,0,2,0,1,1,0,1,7,3,-5,2,3,0,0,-1,1,-1,1,4,-1
KR_6589475284,420,0,3,13,-1,-6,7,1,3,4,7,-1,3,2,3,1,4,0,2,2,0,15,32,-2,-4,6,-4,0,0,0,0,-1,-1,0,-1
KR_6728390242,420,-3,-31,-7,-5,-2,4,2,-2,4,2,-1,2,1,0,3,3,0,0,0,0,2,-16,1,-2,1,5,0,-1,1,0,-1,-1,5,-1
KR_6495347318,420,0,13,4,-2,-3,4,1,3,2,5,-3,3,0,0,3,3,1,0,1,0,2,13,4,-6,2,2,0,0,1,0,0,1,1,-1
KR_6418231539,420,-3,-96,11,-9,-8,8,0,3,2,5,-1,2,1,-3,4,1,0,0,0,-1,-4,-151,-2,-3,5,-6,0,-1,-1,-1,-1,-1,1,-1
KR_6601443867,420,-4,35,-44,-6,2,1,3,-3,6,3,-2,2,0,1,1,2,-4,4,0,0,0,-6,-2,-6,8,3,0,0,-1,-1,-1,-1,1,-1
KR_6652746689,420,-3,-10,46,-7,-2,2,0,-1,1,0,4,1,5,-4,4,0,-4,4,0,0,-11,-7,-4,0,4,1,0,-2,0,1,1,1,0,-1
KR_6626038118,420,1,1,15,2,3,1,4,-1,5,4,1,3,4,-1,2,1,0,3,3,0,2,-12,-2,-2,4,-3,0,0,-1,0,0,1,1,-1
KR_6649211767,420,-7,-100,-47,-14,-2,5,3,-1,5,4,-9,9,0,0,1,1,-2,5,3,0,-4,13,-5,-2,7,2,0,-3,1,-1,-1,1,6,-1
KR_6759013729,420,-4,38,-44,-14,2,1,3,-4,5,1,-14,14,0,3,1,4,-1,2,1,0,-3,39,-1,-1,2,-19,0,-1,-1,-1,-1,1,2,-1
KR_6680181880,420,-5,-70,56,-18,-7,10,3,-5,7,2,-5,6,1,0,0,0,-1,1,0,0,-15,-3,0,-2,2,-4,0,0,1,-1,-1,-1,6,-1
KR_6660305228,420,-1,-17,7,-2,-1,4,3,-1,1,0,-1,4,3,1,3,4,0,0,0,-1,2,-8,-1,0,1,-4,0,-1,-1,1,-1,-1,3,-1
KR_6666849993,420,2,31,-4,5,6,0,6,1,3,4,-5,7,2,2,1,3,1,1,2,0,7,-16,-3,-4,7,2,0,0,-1,1,1,-1,5,-1
KR_6732673479,420,-5,-20,-10,-5,-2,3,1,1,1,2,0,2,2,-1,3,2,-3,3,0,0,-4,17,1,-2,1,0,0,-1,-1,0,-1,-1,4,-1
KR_6617573273,420,-3,-57,8,-8,1,0,1,-1,2,1,1,4,5,-3,4,1,-6,7,1,0,-2,-1,1,-1,0,-1,0,-1,-1,0,-1,-1,3,-1
KR_6663173672,420,-1,-41,-20,-10,2,2,4,-4,8,4,-7,8,1,0,1,1,-1,2,1,-3,-21,109,-7,-3,10,12,0,-1,-1,-1,-1,-1,1,-1
KR_6642816369,420,-7,-124,-2,-18,-2,3,1,-2,4,2,-7,9,2,-7,8,1,0,0,0,-1,-14,-4,-1,-1,2,-2,0,-3,-1,-1,-1,-1,3,-1
KR_6737880402,420,-6,-94,23,-14,-3,3,0,-1,5,4,-7,8,1,1,3,4,-4,5,1,0,-6,29,1,-2,1,0,0,-2,-1,0,-1,1,5,-1
KR_6763954668,420,3,10,56,0,3,2,5,-3,3,0,-1,1,0,0,3,3,1,0,1,0,-2,4,4,-7,3,-2,0,-1,-1,0,-1,1,6,-1
KR_6695079954,420,-2,-4,-24,-3,1,1,2,-2,2,0,5,1,6,-6,8,2,-1,5,4,0,-12,-6,-2,0,2,0,0,0,-1,1,-1,1,5,-1
KR_6652984313,420,-1,-36,-15,-3,2,0,2,1,2,3,-4,5,1,-3,3,0,1,1,2,0,4,18,0,-1,1,-2,0,-1,-1,0,-1,-1,1,-1
KR_6748903186,420,1,-94,11,1,4,2,6,-1,4,3,-4,5,1,3,1,4,-1,3,2,0,-5,10,3,-3,0,-1,0,0,0,0,0,1,0,-1
KR_6650797857,420,-2,3,13,-6,-4,5,1,-1,1,0,-1,2,1,0,2,2,0,0,0,0,-6,4,-3,-1,4,-1,0,0,-1,0,-1,-1,2,-1
KR_6642534402,420,-2,-15,-8,2,-2,2,0,-2,5,3,1,4,5,2,1,3,3,0,3,1,7,-16,-4,-3,7,-1,0,-1,1,1,-1,1,4,-1
KR_6733754311,420,-5,42,-23,-8,0,2,2,-2,7,5,2,3,5,-3,9,6,-5,5,0,4,6,-9,-2,-2,4,0,0,-1,-1,-1,-1,1,6,-1
KR_6409941183,440,-4,41,-34,-5,-3,4,1,-3,4,1,-4,5,1,5,0,5,0,3,3,0,-4,-13,2,-6,4,-3,0,-1,-1,0,-1,-1,3,-1
KR_6731295160,420,-1,50,-20,-6,4,0,4,-5,6,1,-1,4,3,-2,3,1,-2,2,0,0,-9,-30,-1,-2,3,17,0,0,-1,-1,-1,1,1,-1
KR_6724017309,420,-4,-93,-11,-7,1,2,3,-3,4,1,-3,4,1,-1,3,2,-1,2,1,0,-6,-1,-2,-2,4,-2,0,0,-1,0,0,-1,1,-1
KR_6750689781,420,-3,-61,-17,-7,-1,2,1,3,2,5,-10,11,1,0,2,2,1,0,1,1,3,-6,-2,-1,3,1,0,-1,-1,-1,-1,1,2,-1
KR_6764148092,420,1,0,23,2,-5,5,0,3,0,3,-2,4,2,5,2,7,1,0,1,0,1,9,0,-3,3,2,0,-2,1,-1,-1,-1,3,-1
KR_6630637730,420,-1,-67,4,2,6,0,6,-4,5,1,1,1,2,1,1,2,-2,2,0,0,-1,-247,0,-2,2,-3,0,0,1,1,0,1,1,-1
KR_6502944279,420,-3,2,-8,-9,-2,2,0,-2,3,1,-1,3,2,-1,4,3,-3,3,0,0,-11,-4,0,-1,1,-1,0,-2,-1,1,-1,1,3,-1
KR_6630375280,420,-5,-77,-8,-18,-5,5,0,-2,3,1,-2,2,0,-8,8,0,-1,1,0,0,-14,-9,-4,-4,8,-2,0,0,-1,-1,-1,-1,2,-1
KR_6760729182,440,-4,19,-5,-3,1,0,1,-9,9,0,-2,4,2,3,2,5,4,1,5,0,3,-426,0,0,0,-1,0,-1,-1,0,-1,-1,3,-1
KR_6386414959,420,-1,-60,0,1,0,3,3,0,2,2,-5,5,0,5,1,6,1,2,3,0,6,7,4,-5,1,-1,0,-1,1,-1,-1,-1,2,-1
KR_6418839608,420,-1,-36,-7,-6,0,2,2,-1,3,2,2,1,3,-5,7,2,-2,2,0,0,-10,-5,0,-4,4,2,0,1,1,-1,1,1,2,-1
KR_6461662389,420,-5,-57,9,-4,-2,3,1,3,3,6,-1,3,2,-5,5,0,1,0,1,0,-4,195,-3,0,3,0,0,-2,0,0,-1,-1,0,-1
KR_6732248892,420,-6,-46,-4,-9,-5,7,2,-2,2,0,0,1,1,-3,6,3,1,1,2,1,-7,-122,-1,-4,5,1,0,-1,0,0,-1,1,0,-1
KR_6539632598,420,-1,-45,-17,-4,-2,4,2,-3,6,3,2,1,3,-2,4,2,1,2,3,-1,-4,2,0,-5,5,0,0,-2,-1,-1,-1,-1,6,-1
KR_6643017668,420,1,35,4,0,-1,1,0,1,1,2,3,1,4,-3,6,3,0,1,1,-1,-1,-22,-1,0,1,-1,0,0,0,-1,-1,-1,0,-1
KR_6701897274,440,1,-20,-4,1,-1,3,2,4,1,5,3,0,3,-2,2,0,-3,4,1,0,1,6,2,-3,1,-1,0,1,1,-1,1,1,1,-1
KR_6734009247,420,0,-9,35,-7,0,0,0,3,0,3,-5,6,1,-6,6,0,1,0,1,0,-10,2,0,-3,3,-4,0,0,1,-1,0,1,3,-1
KR_6761356408,440,2,-53,33,7,0,1,1,6,1,7,2,4,6,-3,4,1,2,0,2,0,10,-9,-1,-3,4,-4,0,0,0,1,-1,1,0,-1
KR_6745918647,420,-4,-105,0,-6,-3,6,3,5,0,5,-4,6,2,-2,3,1,-2,2,0,0,-6,1,3,-6,3,-7,0,0,-1,-1,-1,-1,3,-1
KR_6654373871,420,-7,-84,-42,-8,-2,2,0,-2,2,0,-2,4,2,-1,2,1,-1,1,0,0,-7,-8,-1,-2,3,-2,0,-2,-1,0,-1,-1,1,-1
KR_6763983706,420,-2,-69,12,-9,-1,3,2,0,2,2,0,3,3,-8,10,2,0,0,0,0,-7,17,1,-5,4,-4,0,0,1,1,-1,-1,4,-1
KR_6741477524,420,-9,-158,-56,-18,-16,16,0,-2,3,1,0,1,1,-3,4,1,3,1,4,-1,-2,-8,-2,-1,3,-1,-1,-4,-1,-1,-1,-1,2,-1
KR_6678603705,420,-4,-25,8,-10,-1,1,0,0,1,1,-4,5,1,-3,5,2,-2,2,0,0,-18,-14,0,-1,1,-1,0,-2,-1,0,-1,1,2,-1
KR_6728677952,420,5,26,6,3,3,2,5,5,0,5,1,1,2,-2,7,5,-4,4,0,1,4,250,-5,0,5,0,0,0,0,-1,0,1,0,-1
KR_6756082479,420,-7,-92,-32,-17,-5,6,1,-4,6,2,-1,2,1,-6,6,0,-1,1,0,0,-10,4,0,-4,4,-1,0,-1,-1,0,-1,-1,3,-1
KR_6386377898,420,-1,-22,12,-5,0,1,1,-5,5,0,-1,5,4,1,1,2,0,0,0,0,-7,12,-3,-4,7,-2,0,1,-1,1,1,-1,5,-1
KR_6726404168,420,-3,-47,0,-3,0,1,1,1,1,2,-2,3,1,-2,2,0,0,2,2,-1,-7,3,1,-3,2,-1,0,0,-1,1,0,-1,5,-1
KR_6623936031,420,-2,-25,-12,-3,-2,4,2,0,1,1,-2,3,1,0,2,2,1,1,2,0,-4,-31,-1,-5,6,8,0,-1,-1,-1,-1,1,1,-1
KR_6386470758,420,-5,-57,20,-7,-4,4,0,-1,2,1,-2,3,1,0,4,4,0,1,1,0,0,4,-3,-2,5,6,0,-2,-1,1,-1,1,6,-1
KR_6759847292,420,1,-47,12,5,-2,4,2,1,1,2,4,3,7,0,0,0,2,0,2,0,-2,147,-1,-1,2,0,0,1,0,1,1,1,0,-1
KR_6722231104,420,-4,-116,-21,-11,-6,6,0,-3,3,0,2,0,2,-5,7,2,1,0,1,0,-10,138,-3,-2,5,-11,0,0,-1,0,0,-1,4,-1
KR_6478194489,420,0,-88,-13,0,4,1,5,-2,2,0,-3,6,3,2,3,5,-1,3,2,0,-6,0,-1,-4,5,5,0,-1,0,0,-1,1,0,-1
KR_6739684968,420,0,-23,-16,-2,-2,3,1,-1,4,3,1,2,3,1,3,4,-1,2,1,0,5,382,-1,-3,4,-22,0,-2,-1,-1,-1,-1,5,-1
KR_6567987208,420,2,72,14,9,2,1,3,-5,5,0,1,2,3,6,0,6,5,1,6,0,7,7,1,-5,4,1,0,0,1,-1,-1,1,5,-1
KR_6643323702,420,0,33,10,7,5,0,5,-5,8,3,-1,2,1,7,0,7,1,0,1,0,2,-7,-1,-2,3,0,0,2,0,0,1,1,0,-1
KR_6629899750,420,0,37,-32,-5,0,2,2,-2,3,1,-3,6,3,-2,3,1,2,1,3,-1,-7,82,-2,-4,6,-1,0,0,1,-1,-1,-1,1,-1
KR_6741434765,420,1,-25,8,4,2,2,4,-1,4,3,0,2,2,3,0,3,0,1,1,0,2,5,0,-1,1,0,0,0,-1,1,1,1,6,-1
KR_6494855478,420,2,56,-4,-1,2,0,2,-1,4,3,-2,4,2,2,0,2,-2,2,0,0,-5,-3,-3,0,3,0,0,0,-1,1,0,1,2,-1
KR_6707781521,420,1,73,-36,8,2,1,3,-1,2,1,5,0,5,2,0,2,0,0,0,0,7,18,2,-2,0,0,0,0,1,0,1,1,6,-1
KR_6727613126,420,-2,-31,-19,-1,-1,2,1,-6,7,1,2,2,4,2,0,2,2,0,2,0,-6,-9,1,-1,0,2,0,1,1,1,1,1,3,-1
KR_6721331259,420,-4,-20,-5,-4,-1,1,0,3,0,3,0,6,6,-5,5,0,-1,1,0,0,1,-2,1,-6,5,0,0,-1,1,1,-1,-1,2,-1
KR_6763728430,440,-3,-1,8,-4,1,1,2,-1,4,3,-3,3,0,1,3,4,-2,4,2,-1,-1,-112,-4,-1,5,-2,0,-1,-1,-1,-1,-1,6,-1
KR_5653326716,420,-6,-76,6,-11,-3,4,1,-1,1,0,-2,5,3,-6,6,0,1,0,1,0,-13,22,-1,-1,2,1,0,-1,-1,1,-1,1,6,-1
KR_6532301295,420,-5,-73,-68,-6,-1,2,1,-2,5,3,-6,6,0,3,0,3,0,1,1,0,1,-1,-1,-6,7,-1,0,0,-1,-1,1,1,4,-1
KR_6663345093,420,-4,-76,-12,2,-2,4,2,0,0,0,6,1,7,0,3,3,-2,3,1,1,8,-2,-3,0,3,2,0,-2,1,-1,-1,1,4,-1
KR_6729559960,420,0,18,-10,-1,0,0,0,1,2,3,-5,8,3,2,0,2,1,0,1,0,-4,3,-12,-2,14,9,0,2,-1,1,1,1,6,-1
KR_6758316489,420,-2,-96,16,-7,-8,8,0,-4,5,1,-2,3,1,4,1,5,3,1,4,0,7,-8,2,-6,4,0,0,0,1,-1,-1,-1,1,-1
KR_6610947884,420,-2,-15,4,-10,0,2,2,-4,4,0,-4,5,1,-2,4,2,0,2,2,-1,-4,-179,0,-2,2,-1,0,-1,-1,1,-1,-1,5,-1
KR_6702377913,420,0,-5,-27,2,3,2,5,2,1,3,-1,6,5,0,2,2,-2,3,1,-1,-4,167,5,-6,1,1,0,0,1,-1,0,-1,5,-1
KR_6361596234,420,-2,-1,-2,-9,-3,3,0,-1,3,2,-2,4,2,-4,6,2,1,0,1,1,-7,0,0,0,0,1,0,-1,-1,0,-1,1,3,-1
KR_6737835494,420,-6,-106,-4,-14,-5,5,0,-1,1,0,0,4,4,-9,11,2,1,2,3,-1,-13,-6,-2,-1,3,-5,0,-1,-1,1,-1,-1,6,-1
KR_6437363223,420,2,-29,3,-1,2,0,2,1,0,1,-1,2,1,-4,4,0,1,2,3,0,1,10,4,-6,2,-2,0,0,0,0,0,-1,0,-1
KR_6746254830,420,-2,-72,0,-4,-1,1,0,-1,1,0,-5,5,0,2,2,4,1,1,2,0,4,7,0,-2,2,-3,0,-1,0,1,-1,-1,0,-1
KR_6692564547,420,-2,-20,16,-4,-1,3,2,1,3,4,3,2,5,-6,6,0,-1,2,1,-1,0,-4,-2,-3,5,-1,0,0,0,1,0,-1,0,-1
KR_6640999188,420,0,5,-4,0,-2,2,0,-1,3,2,5,2,7,0,3,3,-2,2,0,0,-10,6,3,-7,4,-1,0,1,-1,1,1,1,6,-1
KR_6761331544,420,-1,-45,-15,2,4,1,5,0,1,1,-1,1,0,1,1,2,-2,2,0,0,-2,23,-1,-4,5,0,0,-1,1,-1,-1,1,3,-1
KR_6724147252,420,0,27,-11,5,0,2,2,0,1,1,6,2,8,-4,4,0,3,0,3,1,-3,-8,0,-3,3,4,0,1,-1,-1,1,1,3,-1
KR_6633671980,420,1,3,-24,4,-1,3,2,-1,2,1,0,2,2,3,0,3,3,0,3,0,3,-5,-2,0,2,-3,0,-1,-1,-1,-1,1,3,-1
KR_6761339203,420,-1,42,28,-1,-5,7,2,2,3,5,3,1,4,-1,6,5,0,1,1,0,-2,1,1,-5,4,1,0,-1,-1,1,-1,1,4,-1
KR_6742332186,420,-3,-132,-44,-1,0,2,2,-3,6,3,0,4,4,1,1,2,1,0,1,0,-2,-32,3,-4,1,23,0,-1,1,-1,-1,1,4,-1
KR_6305060567,420,0,-6,24,-5,2,1,3,2,2,4,-7,8,1,-2,4,2,0,0,0,0,-8,-13,1,-4,3,-2,0,-1,-1,-1,-1,1,2,-1
KR_6617112890,420,-1,25,0,-2,2,1,3,-3,3,0,-3,8,5,0,2,2,2,2,4,0,-7,-3,-5,-2,7,-2,0,0,1,-1,0,1,3,-1
KR_6756043323,420,-1,39,-16,-2,-1,2,1,0,2,2,10,0,10,-8,9,1,-3,4,1,0,-4,-126,-5,-1,6,2,0,0,-1,0,1,-1,5,-1
KR_6703581307,440,-8,-177,-6,-26,-11,11,0,-2,2,0,-10,10,0,-4,7,3,1,1,2,-1,-24,11,-2,-1,3,-2,0,-4,-1,-1,-1,-1,4,-1
KR_6749916146,420,-2,-54,12,-6,1,0,1,-1,3,2,-6,8,2,-2,3,1,2,1,3,0,-3,-3,0,-1,1,-2,0,0,-1,1,0,-1,1,-1
KR_6742592916,420,-7,-132,-8,-21,-3,3,0,-4,6,2,-7,7,0,-6,7,1,-1,3,2,-1,-18,15,-6,0,6,-17,0,-3,0,-1,-1,-1,0,-1
KR_6741231295,440,-3,-91,-4,-3,-5,5,0,3,2,5,1,1,2,1,2,3,-3,5,2,0,1,-34,3,-4,1,8,0,-1,0,-1,-1,-1,0,-1
KR_6702248947,420,-4,-107,2,-8,0,0,0,-2,4,2,2,4,6,-8,8,0,0,0,0,0,-7,-61,1,-6,5,-2,0,-1,1,1,-1,-1,1,-1
KR_6741412838,420,0,-11,12,3,-4,4,0,5,0,5,4,0,4,-3,4,1,1,0,1,0,5,-15,6,-8,2,4,0,0,0,-1,0,-1,0,-1
KR_6746505807,420,-1,-7,16,-6,-3,3,0,2,0,2,-4,6,2,-2,4,2,1,1,2,0,-1,-11,4,-5,1,-1,0,0,-1,1,1,-1,2,-1
KR_6719100148,440,-2,-44,-15,-2,-3,4,1,1,4,5,2,1,3,-2,3,1,0,0,0,-1,3,0,-1,-3,4,0,0,0,0,-1,0,-1,0,-1
KR_6483979937,420,-2,-19,-22,2,0,1,1,-1,4,3,0,4,4,3,3,6,0,2,2,0,5,-262,1,-4,3,0,0,-1,-1,0,-1,1,1,-1
KR_6655481423,420,-2,5,0,-5,-4,4,0,1,1,2,-1,5,4,-1,3,2,0,1,1,0,-2,25,3,-4,1,-2,0,0,-1,1,-1,1,5,-1
KR_6673202579,420,5,70,48,7,-1,1,0,2,1,3,0,2,2,5,0,5,1,1,2,2,5,-1,0,-1,1,2,0,-1,1,-1,1,1,2,-1
KR_6707081179,440,3,35,0,7,5,0,5,0,1,1,-2,5,3,3,0,3,1,1,2,0,5,38,1,-4,3,-26,0,1,1,-1,1,1,6,-1
KR_6559416766,420,-2,3,-3,-7,2,1,3,-3,5,2,-2,2,0,-7,7,0,3,0,3,0,-1,-9,-4,0,4,2,0,0,1,0,-1,-1,2,-1
KR_6758087322,440,-1,40,4,2,1,1,2,0,2,2,0,3,3,1,2,3,0,1,1,0,3,16,3,-6,3,0,0,0,0,-1,0,1,0,-1
KR_6690594249,420,-5,-12,16,-3,1,1,2,-3,4,1,2,5,7,-3,6,3,0,1,1,0,-8,8,-3,-3,6,1,0,1,1,-1,1,-1,4,-1
KR_6456261654,440,2,72,20,-4,2,0,2,5,0,5,-4,5,1,-3,7,4,-4,4,0,0,2,37,1,-3,2,-19,0,-1,-1,1,-1,-1,5,-1
KR_6697221820,420,0,-32,-4,-1,-2,3,1,-2,4,2,-2,2,0,3,1,4,2,1,3,0,0,4,-2,-3,5,0,0,-1,0,-1,-1,-1,0,-1
KR_6747126264,420,0,-35,1,0,-2,3,1,1,1,2,1,1,2,-1,1,0,1,0,1,-1,1,-5,1,-2,1,1,0,0,1,-1,0,-1,1,-1
KR_6125133234,420,-6,-51,-112,-15,-5,9,4,-5,6,1,-3,4,1,-1,3,2,-1,1,0,1,-12,-3,-2,-2,4,-1,0,-3,-1,-1,-1,1,3,-1
KR_6525783045,420,-3,-75,16,-5,-2,6,4,1,2,3,-2,6,4,1,1,2,-3,5,2,0,1,7,2,-3,1,1,0,-2,-1,0,-1,1,4,-1
KR_6655491553,420,2,9,9,7,4,0,4,-1,5,4,2,1,3,4,1,5,-2,2,0,0,4,-4,-1,-2,3,-1,0,1,-1,1,1,-1,2,-1
KR_6723382693,420,-2,-5,-4,3,0,0,0,1,2,3,5,0,5,-1,5,4,-2,2,0,0,-6,12,1,-4,3,-2,0,0,-1,1,0,1,6,-1
KR_6745683194,440,-3,-30,13,-7,2,4,6,2,0,2,-6,7,1,-3,5,2,-2,3,1,0,0,-9,1,-4,3,-3,0,-2,1,-1,-1,1,3,-1
KR_6717562167,420,2,-19,-5,1,-2,6,4,0,5,5,0,2,2,3,2,5,0,0,0,0,11,-268,-3,-4,7,5,0,0,0,0,0,-1,0,-1
KR_6713337991,420,-1,-23,-18,-3,0,2,2,-3,4,1,4,0,4,-2,3,1,-2,3,1,1,-1,2,1,-6,5,-2,0,0,-1,0,0,1,5,-1
KR_6699924113,420,0,-57,-8,1,-2,4,2,2,2,4,-4,5,1,3,1,4,2,0,2,1,15,-4,-4,-3,7,2,0,-1,-1,-1,-1,1,3,-1
KR_6743392737,420,-1,-42,13,0,1,1,2,-2,3,1,3,0,3,0,3,3,-2,4,2,0,-4,-1,0,-2,2,-3,0,0,0,1,0,1,0,-1
KR_6720230272,420,0,-8,-14,-2,-1,4,3,-6,6,0,3,1,4,3,1,4,-1,3,2,0,4,-23,-3,-3,6,-2,0,0,1,-1,-1,-1,3,-1
KR_6607348470,420,3,26,30,8,3,1,4,4,0,4,-1,2,1,3,1,4,-1,5,4,0,4,33,0,-6,6,-26,0,1,1,1,1,1,6,-1
KR_6533339769,440,0,16,4,-9,4,1,5,2,0,2,0,2,2,-11,12,1,-4,5,1,-1,-30,-3,-2,-2,4,4,0,-2,1,-1,-1,-1,1,-1
KR_6732949443,420,-1,28,-35,-8,0,3,3,-1,4,3,-4,5,1,-1,2,1,-2,2,0,0,-5,0,1,-3,2,-2,0,-1,-1,-1,-1,-1,4,-1
KR_6600984544,440,1,16,28,-6,2,0,2,-3,5,2,1,1,2,-5,5,0,-1,2,1,0,-10,1,-4,-3,7,-2,0,0,-1,1,0,-1,3,-1
KR_6418680680,420,2,-60,80,-3,1,0,1,-3,7,4,-2,2,0,-3,4,1,4,0,4,0,2,57,-2,-2,4,13,0,0,0,1,-1,1,0,-1
KR_6733651865,420,-1,6,-35,-3,0,2,2,1,3,4,3,1,4,-7,8,1,0,3,3,1,-6,20,3,-5,2,-2,0,0,-1,-1,1,1,6,-1
KR_6731296769,420,2,26,-13,4,6,1,7,1,1,2,-4,6,2,-3,3,0,4,0,4,0,5,-3,1,-5,4,4,0,0,1,1,-1,-1,2,-1
KR_6654306380,420,-5,-30,0,-7,0,1,1,-1,1,0,-4,4,0,-1,4,3,-1,1,0,1,-7,3,1,-4,3,-6,0,-1,-1,-1,-1,1,1,-1
KR_6654306225,420,-2,-25,8,-10,-4,4,0,-7,8,1,0,2,2,2,3,5,-1,1,0,0,-6,-9,-1,-2,3,-1,0,-1,-1,-1,-1,-1,3,-1
KR_6645599641,420,1,-36,28,0,2,1,3,0,2,2,-1,4,3,0,1,1,-1,3,2,0,-1,-16,0,-1,1,6,0,0,-1,1,-1,-1,3,-1
KR_6607242126,420,-1,49,-20,-2,-2,2,0,-3,8,5,1,2,3,3,3,6,-1,1,0,-2,-3,-7,-2,-2,4,-1,0,0,-1,-1,-1,-1,6,-1
KR_6757848385,420,1,0,-32,2,4,1,5,-2,2,0,4,1,5,-4,8,4,0,1,1,0,-6,12,-6,-3,9,-1,0,0,-1,0,1,1,5,-1
KR_6513723587,420,-7,-56,-20,-13,0,2,2,-4,5,1,-8,14,6,0,6,6,-1,2,1,0,6,-19,-5,0,5,0,0,-2,-1,-1,-1,-1,2,-1
KR_6737447598,420,-5,-27,-47,-4,-4,4,0,1,2,3,-1,2,1,0,2,2,0,1,1,0,-1,104,1,-3,2,3,0,0,0,-1,-1,-1,0,-1
KR_6443544140,420,-1,79,-20,-2,-1,3,2,2,0,2,-3,4,1,1,0,1,-1,1,0,-1,-3,331,1,-5,4,-24,0,1,1,1,1,-1,4,-1
KR_6675819168,420,0,27,-20,-12,5,0,5,-5,5,0,-7,7,0,0,4,4,-5,6,1,-1,-18,-10,0,-2,2,-2,0,-1,-1,-1,-1,-1,1,-1
KR_6761620392,440,-2,22,-12,-7,-2,3,1,1,3,4,-5,6,1,0,2,2,-1,2,1,1,3,-5,1,-2,1,0,0,-2,0,-1,-1,1,0,-1
KR_6732383119,420,-5,-32,-16,-9,-6,7,1,3,0,3,1,3,4,-6,8,2,-1,2,1,0,-8,-2,-1,-2,3,1,0,-2,1,0,-1,-1,2,-1
KR_6733247913,420,-4,-120,20,-4,-4,5,1,-2,2,0,4,0,4,0,1,1,-2,8,6,0,-5,106,2,-2,0,18,0,-3,-1,0,-1,-1,1,-1
KR_6618729972,420,1,-6,16,-4,-1,1,0,3,2,5,-2,4,2,-4,4,0,0,1,1,0,0,7,-2,-2,4,2,0,0,-1,0,-1,-1,2,-1
KR_6742729865,440,-1,-65,7,-7,-1,1,0,-2,3,1,2,0,2,-6,9,3,0,0,0,-2,-4,3,-4,-1,5,-2,0,0,0,0,0,-1,0,-1
KR_6702879585,420,2,17,24,-3,0,0,0,0,4,4,2,1,3,-5,5,0,0,1,1,-1,-6,-32,-6,-3,9,0,0,0,1,-1,0,-1,5,-1
KR_6750401775,420,-2,16,-32,-7,0,1,1,2,2,4,-6,9,3,-2,2,0,-1,1,0,0,-5,-4,1,-2,1,0,0,-1,-1,-1,-1,-1,4,-1
KR_6762826291,420,0,-8,-18,3,3,0,3,0,2,2,-2,3,1,-2,3,1,4,0,4,0,2,-5,0,-3,3,0,0,0,1,-1,-1,-1,6,-1
KR_6761599037,420,1,10,16,-2,0,0,0,-1,3,2,-1,1,0,-1,3,2,1,0,1,-1,-4,180,-1,-7,8,-6,0,0,1,-1,0,-1,5,-1
KR_6629939885,440,-2,-66,-26,-3,0,1,1,1,1,2,2,1,3,-4,4,0,-2,2,0,0,-5,-3,-5,-3,8,-20,0,0,-1,1,0,1,5,-1
KR_6715721839,440,-1,10,-8,-12,-1,3,2,-4,4,0,3,2,5,-3,4,1,-7,8,1,0,-14,85,-1,0,1,0,0,1,-1,0,1,-1,4,-1
KR_6641780338,420,-3,3,-16,-9,-2,3,1,-6,9,3,-1,4,3,1,3,4,-1,1,0,0,-7,-56,2,-4,2,1,0,1,1,1,1,-1,4,-1
KR_6608041655,420,3,67,19,-4,-2,2,0,-4,5,1,1,0,1,1,2,3,0,1,1,0,-8,-225,-1,-2,3,1,0,1,-1,-1,1,-1,1,-1
KR_6727163533,420,-6,-59,-15,-8,-1,3,2,-1,4,3,-2,5,3,-3,3,0,-1,1,0,0,-2,-10,-4,-3,7,1,0,-1,-1,1,-1,1,2,-1
KR_6632859710,420,-3,-36,8,0,-2,2,0,0,4,4,3,2,5,1,3,4,-2,2,0,0,1,0,2,-4,2,1,0,0,1,-1,-1,-1,6,-1
KR_6569506930,420,1,-37,47,4,0,1,1,2,2,4,-3,3,0,-2,3,1,7,1,8,0,2,-7,0,-1,1,4,0,2,1,1,1,-1,2,-1
KR_6720650176,440,6,76,20,9,5,0,5,1,4,5,3,1,4,-2,4,2,2,0,2,0,1,7,2,-4,2,-4,0,2,-1,1,1,-1,6,-1
KR_6608185204,420,-2,42,-24,1,0,1,1,-4,4,0,0,3,3,7,0,7,-2,4,2,0,1,-17,-3,-1,4,2,0,-1,1,-1,-1,-1,4,-1
KR_6737563770,420,-1,-12,8,-10,0,4,4,-2,2,0,3,1,4,-4,4,0,-7,7,0,0,-8,37,-2,-1,3,-12,0,-2,-1,1,-1,-1,3,-1
KR_6750511071,440,-4,-10,-12,-4,-5,8,3,-2,4,2,3,5,8,2,0,2,-2,2,0,0,4,-7,2,-3,1,2,0,-1,0,-1,1,1,0,-1
KR_6711421633,420,-2,27,4,-1,-2,3,1,1,1,2,-1,2,1,1,5,6,0,2,2,0,8,112,5,-6,1,-4,0,0,0,1,0,1,0,-1
KR_6604418291,420,-2,-35,4,-2,0,1,1,4,2,6,-1,3,2,-5,7,2,0,1,1,0,-3,173,0,-2,2,1,0,0,-1,1,-1,1,6,-1
KR_6735164650,420,-3,-42,8,-3,-3,5,2,0,1,1,0,2,2,1,0,1,-1,1,0,0,0,25,3,-5,2,-3,0,0,-1,-1,-1,1,6,-1
KR_6760724119,440,0,-54,-33,-1,4,3,7,-1,2,1,-4,4,0,4,4,8,-4,6,2,0,11,-4,2,-2,0,0,0,-1,-1,-1,-1,1,1,-1
KR_6738168241,420,1,23,-28,-4,4,0,4,0,2,2,-2,2,0,-6,6,0,0,0,0,0,-7,1,2,-9,7,1,0,1,-1,1,1,1,6,-1
KR_6648627376,420,0,-35,-19,0,0,3,3,-1,2,1,1,0,1,1,3,4,-1,1,0,0,0,25,3,-4,1,-7,0,-1,-1,-1,-1,1,1,-1
KR_6714807928,420,-1,30,12,-3,0,3,3,-1,1,0,6,0,6,-4,6,2,-4,4,0,0,-10,22,0,-5,5,4,0,0,1,1,0,1,1,-1
KR_6652054610,420,-1,-18,8,-4,1,0,1,0,5,5,-2,3,1,-2,6,4,-1,1,0,0,-3,-40,-8,-1,9,38,0,0,-1,-1,0,-1,1,-1
KR_6732978268,420,-1,5,-20,-3,0,2,2,3,1,4,-1,1,0,-5,7,2,0,0,0,0,-2,132,3,-9,6,-24,0,0,1,-1,0,1,1,-1
KR_6749207201,420,-5,-83,-5,-9,-2,7,5,-2,2,0,-1,2,1,0,2,2,-4,5,1,-2,-5,1,-1,-2,3,2,0,-1,-1,1,-1,-1,1,-1
KR_6750624099,420,-3,-99,-48,-6,-8,8,0,1,1,2,0,0,0,1,0,1,0,0,0,0,-3,-9,-2,-1,3,-1,0,-1,-1,0,-1,-1,1,-1
KR_6692768827,420,-6,-65,-11,-7,-5,7,2,-4,5,1,0,3,3,0,4,4,2,0,2,2,-7,-12,-1,-2,3,3,0,-3,1,-1,-1,1,1,-1
KR_6731300780,420,1,7,24,2,3,0,3,-1,4,3,2,2,4,-3,4,1,1,0,1,0,-9,3,1,-3,2,3,0,0,-1,1,1,1,4,-1
KR_6679609606,420,5,6,8,6,3,1,4,-1,3,2,5,0,5,-1,3,2,0,0,0,1,-5,218,2,-4,2,3,0,1,1,1,1,-1,4,-1
KR_6743699694,420,-1,-68,8,0,-2,4,2,-2,3,1,2,0,2,2,1,3,0,0,0,0,4,3,2,-3,1,-3,0,0,1,0,0,-1,4,-1
KR_6762060195,420,2,-13,-16,1,-1,4,3,0,3,3,3,0,3,1,5,6,-2,4,2,0,5,66,1,-7,6,-2,0,1,1,-1,1,1,1,-1
KR_6639831764,420,2,93,-16,-2,5,1,6,-4,6,2,-4,5,1,0,1,1,1,2,3,0,-6,-30,0,-3,3,6,0,1,1,-1,1,1,4,-1
KR_6747165066,420,-1,10,16,4,-3,3,0,2,0,2,5,0,5,1,2,3,-1,2,1,1,5,-12,-3,-3,6,7,0,-1,-1,1,-1,1,3,-1
KR_6758741355,440,-3,0,12,1,7,0,7,-1,2,1,-3,5,2,-2,2,0,0,4,4,1,-5,5,0,-2,2,0,0,0,1,-1,-1,1,6,-1
KR_6751953129,420,-3,-42,-49,-6,0,2,2,-7,8,1,1,1,2,2,5,7,-2,2,0,0,-7,-6,0,-1,1,0,0,-1,-1,1,-1,-1,1,-1
KR_6744994241,420,-3,-75,-32,-13,-6,6,0,-3,3,0,-1,5,4,-3,5,2,0,0,0,-1,-13,-2,1,-3,2,0,0,-3,-1,-1,-1,-1,5,-1
KR_6597012119,420,1,60,22,-8,4,0,4,-5,6,1,-1,2,1,0,2,2,-6,8,2,0,-14,-16,-6,-3,9,0,0,1,-1,0,-1,-1,1,-1
KR_6624973663,420,-2,-80,20,-4,0,3,3,-2,6,4,-2,4,2,-3,4,1,3,1,4,0,0,-365,8,-8,0,-4,0,-2,-1,-1,-1,-1,6,-1
KR_6302346306,420,1,46,18,-2,-4,5,1,1,4,5,1,1,2,0,1,1,0,0,0,0,-2,0,4,-6,2,-2,0,0,-1,1,-1,-1,6,-1
KR_6762351793,440,2,-10,40,6,1,0,1,1,2,3,1,1,2,2,1,3,1,0,1,0,4,42,0,-3,3,-5,0,0,1,0,0,1,6,-1
KR_6730525111,440,-7,-100,-16,-14,-2,5,3,-2,2,0,0,3,3,-10,11,1,0,2,2,0,-14,26,2,-3,1,-1,0,-3,-1,0,-1,-1,2,-1
KR_6724140962,440,-7,-99,-28,-10,-7,7,0,-6,7,1,3,1,4,1,2,3,-1,2,1,-1,-8,3,0,-5,5,4,0,0,-1,1,-1,-1,3,-1
KR_6763178514,420,0,-61,-16,2,1,0,1,1,0,1,0,1,1,0,5,5,0,0,0,0,-4,-17,-2,-1,3,1,0,0,1,-1,0,1,5,-1
KR_6712316260,440,-3,-28,-8,-6,-5,5,0,5,1,6,2,0,2,-7,9,2,-1,2,1,-2,-8,-8,-3,-2,5,0,0,-1,-1,1,-1,1,4,-1
KR_6622170670,420,3,-7,32,2,0,2,2,2,0,2,-4,4,0,1,2,3,3,0,3,0,6,7,2,-3,1,0,0,0,-1,0,0,-1,2,-1
KR_6752089860,420,-4,-79,11,-9,-3,3,0,-7,8,1,-2,2,0,1,0,1,2,1,3,0,-5,107,0,-4,4,-2,0,-1,-1,-1,-1,-1,4,-1
KR_6730668821,420,-6,-48,-42,-13,-2,2,0,-6,6,0,-5,6,1,1,3,4,-1,2,1,-1,-18,-1,-5,0,5,0,0,0,-1,-1,-1,-1,5,-1
KR_6748821030,440,1,39,-16,3,0,3,3,0,8,8,5,0,5,-3,6,3,1,3,4,1,-4,-9,-1,-4,5,4,0,0,-1,-1,0,1,6,-1
KR_6635821466,420,-6,-100,11,-9,-2,3,1,-5,9,4,1,1,2,-3,3,0,0,1,1,0,-7,11,4,-6,2,-9,0,-1,0,1,-1,1,0,-1
KR_6473256917,420,2,45,8,-4,-2,4,2,1,2,3,1,5,6,-4,6,2,0,1,1,-1,-14,-13,-6,-3,9,3,0,-2,-1,1,-1,-1,6,-1
KR_6595214984,420,4,76,11,-3,1,0,1,0,2,2,-3,5,2,-2,2,0,1,0,1,0,-7,221,-2,-3,5,-1,0,0,1,-1,1,1,6,-1
KR_6710563239,420,0,10,-13,0,3,0,3,-1,4,3,5,0,5,-4,6,2,-3,4,1,0,-9,-3,4,-5,1,-4,0,0,0,0,0,-1,0,-1
KR_6712995527,420,0,0,-21,1,1,0,1,2,2,4,-1,4,3,-1,1,0,0,0,0,0,0,-82,-3,-2,5,17,0,-1,-1,1,-1,1,1,-1
KR_6748081237,420,0,-19,-1,-3,1,1,2,-2,2,0,-3,5,2,2,0,2,-1,2,1,1,-3,-3,-3,0,3,2,0,-1,-1,-1,-1,1,4,-1
KR_6759084412,420,1,-2,-12,-1,3,0,3,-2,6,4,1,3,4,-3,4,1,0,1,1,0,1,-22,-2,-4,6,3,0,0,-1,1,0,-1,4,-1
KR_6743075241,420,0,-16,-20,2,2,0,2,1,2,3,-2,2,0,2,2,4,-1,1,0,0,9,31,-1,0,1,0,0,-2,1,-1,-1,-1,5,-1
KR_6630373395,420,-3,-3,-15,-8,3,1,4,-7,7,0,-6,7,1,0,1,1,2,1,3,-1,-5,-41,-3,-2,5,17,0,-1,-1,-1,-1,-1,3,-1
KR_6668789585,420,2,32,18,0,-4,5,1,2,3,5,2,3,5,0,1,1,0,1,1,0,-4,1,0,-3,3,0,0,0,-1,1,-1,1,1,-1
KR_6704017700,420,2,53,16,1,6,0,6,-2,3,1,-3,3,0,4,3,7,-4,4,0,1,3,6,3,-3,0,1,0,0,0,1,0,1,0,-1
KR_6695916529,420,2,57,4,0,-4,5,1,-3,3,0,2,2,4,4,1,5,1,2,3,0,3,1,1,-5,4,-3,0,-1,-1,0,-1,1,2,-1
KR_6687883448,420,-2,-76,24,-3,-5,6,1,0,1,1,3,1,4,2,2,4,-3,3,0,0,-2,33,1,-5,4,-9,0,-3,1,1,-1,-1,3,-1
KR_6647751859,420,-2,20,-28,-1,-1,1,0,2,2,4,-3,4,1,4,2,6,-3,3,0,1,9,2,-3,-2,5,0,0,0,-1,0,0,1,3,-1
KR_6138111098,420,-3,7,-34,-7,0,2,2,-2,4,2,-7,8,1,2,2,4,0,0,0,0,-1,-5,-1,-6,7,-2,0,1,-1,-1,-1,1,2,-1
KR_6608500526,440,0,6,16,3,1,4,5,-7,9,2,4,2,6,4,0,4,1,1,2,0,3,-9,3,-6,3,-1,0,1,1,-1,1,-1,4,-1
KR_6754289806,420,-2,17,-8,-6,-2,5,3,5,1,6,-6,7,1,-2,2,0,-1,1,0,0,0,302,0,-2,2,-2,0,-2,1,-1,-1,1,6,-1
KR_6642134926,420,1,33,1,1,-6,7,1,1,1,2,1,1,2,3,0,3,2,0,2,0,6,-12,1,-5,4,-2,0,1,1,-1,-1,-1,5,-1
KR_6748637419,440,-3,-35,21,-1,0,1,1,-9,9,0,1,0,1,3,1,4,4,0,4,-1,-5,-98,-5,-1,6,0,0,-1,1,-1,-1,-1,2,-1
KR_6311968074,420,0,13,-6,1,1,2,3,2,0,2,-3,3,0,0,2,2,1,0,1,0,4,117,-5,0,5,4,0,1,1,0,1,1,6,-1
KR_6737927818,420,-6,-82,6,-14,-1,1,0,-7,9,2,-4,4,0,-2,3,1,0,0,0,0,-12,-8,-3,-2,5,2,0,-1,1,0,-1,-1,1,-1
KR_6729601268,420,-1,-29,1,2,-1,2,1,0,7,7,-3,3,0,4,1,5,2,1,3,0,1,319,1,-2,1,-2,0,0,1,-1,-1,-1,3,-1
KR_6761035766,420,0,-65,22,-1,-2,5,3,-2,3,1,3,2,5,2,1,3,-2,2,0,0,-5,102,0,-3,3,-1,0,0,1,0,0,1,4,-1
KR_5608953921,420,0,-139,-31,-4,1,0,1,2,2,4,-3,4,1,-7,11,4,3,4,7,0,-10,22,4,-6,2,0,0,-3,-1,-1,-1,-1,2,-1
KR_6737491644,440,-2,-45,32,-7,3,1,4,1,1,2,-9,9,0,-2,5,3,0,1,1,1,-12,-1,-2,-3,5,-2,0,-2,1,-1,-1,1,3,-1
KR_6754883902,440,0,-14,4,2,-2,2,0,5,2,7,2,1,3,-3,3,0,0,1,1,0,-1,-1,1,-3,2,-1,0,1,0,1,-1,1,0,-1
KR_6749555550,420,-7,-153,-46,-17,1,1,2,-7,9,2,3,0,3,-8,9,1,-6,6,0,0,-15,13,1,-4,3,-6,0,-3,0,-1,-1,-1,0,-1
KR_6718313838,440,3,78,-4,7,2,2,4,1,2,3,5,1,6,0,3,3,-1,1,0,0,1,2,0,-3,3,-2,0,0,0,1,1,1,0,-1
KR_6651202324,420,-3,-74,-16,-1,-2,3,1,2,0,2,-4,5,1,1,0,1,2,0,2,0,2,-3,1,-2,1,0,0,-1,-1,0,-1,-1,4,-1
KR_6652119883,420,-8,-57,-35,-13,-6,6,0,-7,8,1,-2,5,3,3,0,3,-1,2,1,-2,-13,-1,-3,0,3,-2,0,0,-1,-1,1,-1,5,-1
KR_6606928159,440,-3,-113,-17,-2,-7,7,0,0,0,0,-1,1,0,6,1,7,0,0,0,0,4,2,1,-3,2,1,0,-1,-1,0,-1,-1,5,-1
KR_6481760508,420,-1,35,-4,0,-2,2,0,1,0,1,1,1,2,0,1,1,0,1,1,0,3,129,3,-7,4,6,0,0,1,-1,-1,1,4,-1
KR_6628827235,420,0,19,-3,-4,2,0,2,3,1,4,3,1,4,-5,5,0,-7,9,2,0,-10,0,5,-5,0,4,0,0,1,0,0,-1,2,-1
KR_6486581950,440,-4,-44,-12,1,0,2,2,6,4,10,2,2,4,-9,10,1,2,0,2,2,-1,1,2,-4,2,-3,0,-2,-1,0,-1,1,6,-1
KR_6661257261,420,-2,-21,13,-4,-1,1,0,-2,4,2,0,3,3,-3,5,2,2,1,3,0,-4,0,-3,-4,7,1,0,-1,-1,-1,-1,-1,2,-1
KR_6675264260,420,3,45,4,9,2,0,2,1,2,3,3,1,4,1,2,3,2,0,2,0,9,11,0,-6,6,2,0,1,1,1,1,1,3,-1
KR_6602278548,420,0,-96,-14,-8,-4,4,0,-1,4,3,-2,5,3,-1,1,0,0,1,1,-1,-7,-270,1,-3,2,0,0,-1,-1,-1,-1,-1,5,-1
KR_6759794180,440,-5,-100,-56,-12,-8,9,1,7,0,7,-5,7,2,-4,5,1,-2,4,2,1,-2,1,-3,-2,5,0,0,-2,-1,-1,-1,1,2,-1
KR_6747472930,420,1,9,-47,4,-2,3,1,1,2,3,1,3,4,-3,4,1,7,1,8,0,8,-6,1,-4,3,4,0,0,-1,0,0,-1,3,-1
KR_6704885180,440,0,-3,8,-3,-1,2,1,6,2,8,1,1,2,-6,6,0,-3,4,1,1,-13,18,3,-5,2,-5,0,-1,-1,-1,-1,1,6,-1
KR_6758851423,440,-4,-107,-48,-15,3,2,5,-8,8,0,-3,4,1,0,2,2,-7,8,1,-3,-5,-4,1,-1,0,0,0,-3,1,-1,-1,-1,6,-1
KR_6687873150,420,-5,29,11,-9,-1,2,1,-2,2,0,-4,4,0,-2,4,2,0,0,0,1,-7,14,3,-6,3,0,0,-1,1,-1,-1,1,4,-1
KR_6726136585,420,0,11,-48,-7,1,2,3,2,2,4,-1,4,3,-9,9,0,0,1,1,0,-1,12,-1,-2,3,-2,0,0,-1,0,1,1,4,-1
KR_6638004278,420,-1,-6,-12,-2,0,2,2,2,1,3,-2,4,2,-4,5,1,2,1,3,0,-4,2,-5,0,5,2,0,0,-1,1,0,1,4,-1
KR_6676706206,420,-6,-23,-36,-12,-6,8,2,0,1,1,0,2,2,-4,6,2,-2,2,0,0,-5,-18,-5,-2,7,2,0,-1,-1,1,-1,-1,4,-1
KR_6715393817,440,-1,25,-12,-1,1,2,3,2,4,6,2,0,2,-3,4,1,-3,4,1,0,-8,-11,-1,-2,3,2,0,3,-1,0,1,1,4,-1
KR_6621033199,440,3,90,12,-2,0,1,1,3,4,7,-2,4,2,-2,3,1,-1,1,0,-1,-3,2,-2,0,2,2,0,1,-1,1,1,-1,2,-1
KR_6763162214,420,-3,-62,3,-9,-1,1,0,3,3,6,-3,5,2,-1,3,2,-7,7,0,0,-11,-8,2,-3,1,-2,0,-1,-1,-1,-1,1,3,-1
KR_6684689304,420,-1,-12,-1,0,2,1,3,-1,3,2,-5,6,1,5,0,5,-1,1,0,0,-4,-9,0,-2,2,-1,0,0,0,-1,-1,-1,0,-1
KR_6717781441,440,-1,-17,-5,1,-2,3,1,-3,5,2,3,1,4,2,1,3,1,0,1,0,5,-3,1,-4,3,-1,0,-1,-1,1,-1,-1,4,-1
KR_6760690833,420,-1,-50,-12,-8,-1,4,3,0,1,1,-4,5,1,-1,1,0,-2,3,1,0,-7,-4,-2,-2,4,3,0,0,-1,-1,-1,-1,1,-1
KR_6692018436,440,-2,-65,-6,0,1,0,1,3,1,4,-3,4,1,-1,1,0,0,0,0,0,-1,-12,0,-2,2,-1,0,0,-1,0,0,1,2,-1
KR_6761716075,420,1,21,8,-3,-2,5,3,-3,6,3,1,6,7,2,1,3,-1,1,0,0,-12,2,0,-2,2,-2,0,-2,-1,-1,-1,1,5,-1
KR_6693535362,420,-2,-28,-12,1,-2,3,1,3,1,4,-3,5,2,3,2,5,0,1,1,1,11,-474,-1,-5,6,5,0,-1,1,-1,-1,1,2,-1
KR_6696367392,420,-2,16,11,-6,1,0,1,-1,5,4,-1,2,1,-2,2,0,-3,4,1,0,-7,-6,2,-4,2,-2,0,-2,-1,-1,-1,-1,4,-1
KR_6705300944,420,-2,-11,-12,0,-1,3,2,-3,5,2,2,1,3,0,2,2,2,0,2,1,-1,-7,0,-2,2,-3,0,0,-1,1,0,1,5,-1
KR_6514814486,440,0,-48,3,5,-2,2,0,1,1,2,4,1,5,2,4,6,0,3,3,0,8,14,-4,-5,9,9,0,0,1,1,-1,-1,1,-1
KR_6693746119,420,-3,-62,4,-5,-4,4,0,0,2,2,-1,3,2,0,0,0,0,0,0,0,-8,-4,-2,-2,4,1,0,-1,1,0,-1,1,6,-1
KR_6623166353,420,1,-10,36,4,-2,3,1,-1,3,2,1,2,3,4,0,4,2,0,2,0,4,2,2,-2,0,1,0,0,1,-1,0,-1,5,-1
KR_6743880373,420,0,-28,9,-6,0,0,0,-4,5,1,-3,3,0,0,1,1,1,1,2,0,-3,32,-5,-2,7,-20,0,0,-1,1,1,-1,4,-1
KR_6607134308,420,0,-3,-16,-3,2,1,3,0,4,4,-1,1,0,-2,3,1,-2,3,1,0,-4,2,-3,-2,5,-3,0,0,-1,1,-1,-1,4,-1
KR_6617119995,420,-1,-69,11,-8,0,1,1,-5,5,0,-5,6,1,-1,1,0,3,0,3,0,-8,-57,-5,-2,7,22,0,0,1,-1,-1,-1,2,-1
KR_6660381457,420,1,-32,3,5,0,2,2,1,4,5,3,0,3,1,1,2,0,1,1,0,2,12,0,-2,2,-3,0,0,1,0,0,-1,3,-1
KR_6742906723,420,-2,-12,-68,5,6,2,8,-2,2,0,1,2,3,2,0,2,-2,2,0,0,-4,5,0,-2,2,-1,0,2,0,0,1,-1,0,-1
KR_6647301728,420,-5,48,-49,-13,-3,5,2,0,2,2,-6,6,0,-6,6,0,2,0,2,-1,-4,0,-5,0,5,-3,0,-1,-1,-1,-1,-1,3,-1
KR_6762241249,440,1,-1,33,1,0,2,2,-1,2,1,1,1,2,1,1,2,0,0,0,0,-2,-7,2,-7,5,0,0,0,0,0,0,-1,0,-1
KR_6746061269,420,-1,19,-12,-2,5,1,6,-1,2,1,2,1,3,-3,6,3,-5,7,2,0,-10,3,0,-3,3,1,0,-1,1,-1,-1,1,5,-1
KR_6619265504,440,-4,-65,-43,-8,-7,8,1,1,1,2,-9,10,1,8,2,10,-1,2,1,0,3,-11,-1,-1,2,1,0,-1,-1,-1,1,-1,4,-1
KR_6760830120,420,-3,-61,-42,-6,-1,5,4,0,5,5,-1,3,2,-2,2,0,-2,2,0,0,0,5,1,-6,5,-1,0,0,-1,-1,-1,1,5,-1
KR_6746005490,420,1,-7,-9,1,-1,1,0,0,2,2,2,1,3,1,1,2,-1,2,1,0,1,2,2,-3,1,-2,0,0,1,1,1,1,2,-1
KR_6747651629,420,-1,-30,-12,1,-5,6,1,3,0,3,0,1,1,0,2,2,3,0,3,0,6,-1,-2,0,2,-2,0,-1,-1,-1,-1,-1,2,-1
KR_6701303399,420,-5,-45,-15,-8,-4,4,0,0,0,0,-3,4,1,-1,2,1,0,0,0,0,-8,-4,-4,-1,5,-2,0,-1,1,-1,-1,-1,1,-1
KR_6603315344,440,-2,-79,12,-3,-3,5,2,0,1,1,-3,5,2,3,1,4,0,0,0,0,0,-1,-4,-3,7,-5,0,0,-1,1,0,-1,2,-1
KR_6730971107,420,-6,-80,4,-14,0,1,1,-4,4,0,-4,4,0,-6,6,0,0,2,2,0,-10,45,0,-3,3,-21,0,0,-1,1,0,-1,4,-1
KR_6721735335,420,-3,-1,11,-9,1,1,2,-4,6,2,-3,4,1,-2,6,4,-1,1,0,-2,-9,-11,-2,0,2,0,0,1,0,0,1,-1,0,-1
KR_6727034183,420,-3,-11,1,-8,-3,3,0,0,0,0,1,1,2,-3,3,0,-3,3,0,0,-4,7,-1,-1,2,-3,0,-1,-1,-1,-1,1,3,-1
KR_6724777810,420,-4,-16,16,-14,-1,2,1,-5,5,0,-2,4,2,-2,2,0,-4,4,0,-1,-16,-164,-2,-1,3,-3,0,0,0,-1,-1,-1,0,-1
KR_6596183399,420,-5,-11,-5,-7,-4,5,1,-3,4,1,-3,3,0,5,0,5,-2,3,1,0,-4,-189,4,-4,0,-2,0,-1,-1,1,-1,-1,3,-1
KR_6752446917,440,4,97,0,6,3,4,7,2,1,3,0,3,3,1,5,6,0,1,1,0,2,3,3,-4,1,0,0,1,1,0,1,1,2,-1
KR_6716968353,420,-3,-60,9,-7,-1,2,1,-3,6,3,2,0,2,-6,8,2,1,3,4,0,-9,-44,0,-1,1,19,0,0,1,1,0,1,5,-1
KR_6596174944,420,-7,-100,-12,-7,-2,7,5,-3,3,0,3,4,7,-6,7,1,1,0,1,-1,-6,-3,-4,-1,5,-4,0,-3,1,-1,-1,-1,4,-1
KR_6617390809,420,-2,-23,-32,-4,-2,5,3,-3,4,1,1,1,2,-3,5,2,3,0,3,0,-2,5,1,-1,0,-1,0,-1,-1,-1,-1,1,3,-1
KR_6683837709,420,-7,-124,-36,-10,-6,6,0,-1,3,2,-1,5,4,0,2,2,-2,2,0,0,-8,-18,-4,-1,5,-1,0,-4,-1,-1,-1,1,5,-1
KR_6747439599,420,-4,-24,-17,-8,0,2,2,-3,3,0,-2,4,2,-2,3,1,-1,1,0,0,-8,2,-4,-3,7,5,0,-3,0,-1,-1,1,0,-1
KR_6713516252,440,3,124,11,4,2,2,4,2,0,2,0,2,2,-1,2,1,1,4,5,2,3,5,3,-5,2,0,0,3,-1,1,1,1,1,-1
KR_5896930163,440,-3,9,-12,-9,-1,2,1,-3,4,1,-4,4,0,-1,2,1,0,1,1,0,-7,-14,-7,-2,9,-1,0,-1,-1,-1,-1,-1,4,-1
KR_6738748783,420,2,-30,16,0,5,1,6,2,2,4,-4,4,0,-3,3,0,0,1,1,0,-3,-10,-3,-2,5,0,0,2,-1,1,1,-1,5,-1
KR_6600495879,420,-3,-86,12,-4,-2,3,1,0,2,2,-2,5,3,0,9,9,0,0,0,0,0,-9,1,-3,2,2,0,0,1,1,-1,1,6,-1
KR_6757654438,420,-2,-40,8,-5,1,2,3,2,1,3,1,1,2,-5,5,0,-4,4,0,0,-6,-1,-4,0,4,1,0,-2,-1,-1,-1,-1,5,-1
KR_6742967882,420,-6,-137,15,-12,-2,2,0,0,3,3,-8,8,0,-3,6,3,1,0,1,1,-7,-10,-4,-2,6,-2,0,-1,-1,0,-1,1,1,-1
KR_6739710712,420,-1,-26,-4,4,4,0,4,4,3,7,-3,4,1,-2,3,1,1,1,2,-1,5,0,-1,0,1,0,0,-1,1,1,-1,-1,5,-1
KR_6748843399,420,-3,-52,-12,-14,-6,6,0,0,2,2,0,2,2,-5,10,5,-3,4,1,0,-14,0,-3,0,3,4,0,0,-1,1,0,-1,3,-1
KR_6725889092,420,0,-127,23,-13,-5,7,2,0,0,0,1,2,3,-7,9,2,-2,2,0,0,-11,3,-3,-2,5,3,0,-1,-1,1,-1,-1,2,-1
KR_6744291959,420,-1,-9,9,-10,0,0,0,-8,8,0,-6,9,3,4,1,5,0,1,1,-1,-9,16,-1,-3,4,3,0,-1,-1,-1,-1,-1,3,-1
KR_6649672457,420,0,-44,-5,-2,-4,5,1,0,3,3,5,0,5,-3,3,0,0,0,0,0,-6,3,-3,-2,5,-2,0,0,-1,-1,-1,-1,1,-1
KR_6726332306,420,0,40,12,-6,1,0,1,0,2,2,0,3,3,-7,8,1,0,0,0,0,-12,-10,-5,0,5,5,0,0,1,-1,0,-1,5,-1
KR_6715793856,420,-4,-18,-41,-9,2,3,5,-1,1,0,-10,12,2,0,2,2,0,1,1,-1,-11,-205,-1,-1,2,0,0,-1,-1,-1,-1,-1,6,-1
KR_6763031844,440,0,29,16,0,-1,3,2,2,3,5,3,1,4,2,3,5,-6,7,1,0,-2,-31,0,-1,1,0,0,1,0,1,1,-1,0,-1
KR_6711055390,420,-2,-27,16,-6,-3,4,1,-5,6,1,1,1,2,2,3,5,-1,1,0,0,0,-299,1,-1,0,12,0,-2,1,-1,-1,-1,4,-1
KR_6721385316,420,0,-46,30,9,2,1,3,0,0,0,-1,2,1,6,0,6,2,0,2,0,8,0,-1,-4,5,0,0,0,-1,-1,0,1,4,-1
KR_6647365231,440,-3,-34,-4,-5,-3,3,0,0,1,1,-2,3,1,-1,3,2,1,0,1,0,-3,-3,-1,-2,3,0,0,0,1,-1,0,-1,2,-1
KR_6741342893,420,2,44,17,3,1,1,2,4,2,6,-3,3,0,1,1,2,0,2,2,0,0,-23,2,-3,1,1,0,1,1,-1,1,1,2,-1
KR_6729002157,420,1,35,-30,4,-4,4,0,-1,2,1,2,1,3,4,1,5,3,0,3,0,4,2,-1,-4,5,1,0,0,-1,-1,0,-1,6,-1
KR_6743009480,420,-4,-41,-34,-4,-3,3,0,-1,3,2,-1,2,1,2,2,4,-1,2,1,0,-2,67,0,-3,3,-22,0,-1,-1,1,-1,-1,3,-1
KR_6751640002,420,-2,20,7,1,-2,2,0,-1,1,0,3,1,4,2,0,2,-1,1,0,0,0,24,0,-2,2,-2,0,0,1,0,0,1,3,-1
KR_6676177686,420,-2,-28,-12,-8,-5,6,1,1,3,4,-1,3,2,-4,5,1,1,1,2,0,-6,19,0,-2,2,0,0,0,-1,1,-1,-1,2,-1
KR_6631885731,440,-4,-106,-20,-10,-3,4,1,-3,4,1,0,3,3,-3,3,0,-1,1,0,0,-6,19,-1,-4,5,-1,0,0,-1,-1,0,-1,4,-1
KR_6613720264,440,-5,14,8,-15,-4,5,1,-2,3,1,0,2,2,-9,9,0,0,0,0,0,-15,-60,-1,-1,2,2,0,-2,0,-1,-1,-1,0,-1
KR_6745570164,420,-1,-1,-20,-4,1,1,2,0,2,2,-4,4,0,-4,5,1,3,4,7,-1,1,-7,0,-1,1,-2,0,0,-1,-1,0,-1,3,-1
KR_6607657796,420,4,6,14,3,2,0,2,5,1,6,0,2,2,-6,9,3,2,0,2,2,3,-9,-6,-3,9,3,0,-1,-1,-1,1,1,1,-1
KR_6717198345,440,-5,-29,-5,-9,0,3,3,-2,4,2,-9,9,0,2,1,3,0,1,1,0,-9,-17,0,-3,3,2,0,-1,-1,-1,-1,-1,1,-1
KR_6752602920,420,-3,-42,0,-17,-2,3,1,2,2,4,-4,6,2,-10,10,0,-3,4,1,0,-13,41,1,-3,2,-26,0,0,-1,1,0,-1,1,-1
KR_6713792782,420,-1,59,-11,0,1,0,1,-9,9,0,5,0,5,1,1,2,2,3,5,0,-2,32,-7,-1,8,-15,0,2,1,-1,-1,1,6,-1
KR_6612976716,420,0,-56,4,-3,0,1,1,0,2,2,-2,4,2,-1,1,0,0,1,1,0,3,-7,2,-2,0,0,0,0,1,1,-1,-1,3,-1
KR_6673992158,440,-3,-94,-16,-4,-1,3,2,-2,3,1,0,1,1,0,5,5,-1,3,2,2,2,0,2,-4,2,-4,0,-1,-1,1,-1,-1,4,-1
KR_6612228778,420,1,-6,6,0,-1,1,0,2,3,5,0,3,3,0,2,2,-1,1,0,0,-7,323,1,-3,2,1,0,2,1,1,1,-1,5,-1
KR_6653786222,440,-1,18,-5,1,-2,2,0,1,2,3,5,1,6,-2,3,1,-1,1,0,0,-4,33,1,-6,5,-2,0,2,-1,1,1,-1,5,-1
KR_6698730533,420,-3,-79,-6,-4,-1,3,2,-1,3,2,-1,3,2,-3,3,0,2,0,2,0,1,2,0,-3,3,0,0,-1,-1,-1,-1,-1,6,-1
KR_6753062642,420,-2,-73,6,-7,-4,4,0,-1,1,0,-2,2,0,-2,4,2,2,1,3,0,-4,-1,1,-3,2,0,0,-1,-1,1,-1,-1,1,-1
KR_6632283668,420,-2,23,-25,-8,-1,3,2,-1,2,1,0,2,2,-2,2,0,-4,4,0,0,-14,35,-3,-3,6,-14,0,-1,-1,-1,-1,-1,4,-1
KR_6653441827,420,0,-73,21,4,1,0,1,2,2,4,5,0,5,-5,5,0,1,0,1,-1,-1,-6,2,-6,4,1,0,0,0,0,0,-1,0,-1
KR_6764505745,440,-2,19,-12,-6,-4,4,0,2,1,3,-3,4,1,1,2,3,-2,2,0,0,-4,225,-1,-2,3,-1,0,-2,0,0,-1,-1,0,-1
KR_6688751020,420,0,17,16,10,4,0,4,2,1,3,5,0,5,0,3,3,-1,2,1,0,5,-14,-3,-2,5,1,0,-1,1,-1,-1,1,4,-1
KR_6699794511,420,-6,-94,-4,-22,-3,4,1,-5,6,1,-5,5,0,-5,7,2,-4,4,0,0,-16,-238,-3,-1,4,0,0,-3,-1,-1,-1,-1,6,-1
KR_6721207205,420,-6,-100,18,-9,-2,4,2,7,0,7,-2,3,1,-11,12,1,-1,1,0,0,-17,-2,2,-4,2,-5,0,0,0,-1,-1,-1,0,-1
KR_6656598337,420,2,3,8,-3,-5,5,0,-3,6,3,3,2,5,2,1,3,0,1,1,0,-6,53,2,-3,1,-19,0,-1,1,-1,-1,-1,6,-1
KR_6762795383,420,4,73,3,5,3,0,3,0,2,2,2,3,5,0,0,0,0,0,0,0,4,12,0,-4,4,1,0,0,-1,-1,-1,1,5,-1
KR_6711718045,420,-1,-51,44,-8,-2,5,3,1,1,2,-3,5,2,-3,4,1,-1,1,0,-1,-13,27,4,-8,4,-9,0,-1,-1,-1,-1,-1,6,-1
KR_6733383438,420,-5,-40,-32,-13,-1,2,1,-3,6,3,-2,2,0,-3,4,1,-4,5,1,0,-17,-9,-6,-2,8,4,0,-2,-1,-1,-1,-1,1,-1
KR_6729266233,420,-6,-94,-68,-7,1,1,2,0,1,1,-4,4,0,-2,3,1,-2,2,0,0,1,115,-1,0,1,2,0,-3,-1,-1,-1,-1,5,-1
KR_6745497485,440,-4,-69,4,-9,-2,2,0,-1,1,0,-1,2,1,-3,3,0,-2,2,0,0,-5,-133,2,-5,3,0,0,-1,1,-1,-1,-1,2,-1
KR_6616811485,420,3,41,4,6,1,2,3,1,1,2,2,6,8,0,4,4,2,1,3,2,16,2,2,-5,3,0,0,2,-1,1,1,1,5,-1
KR_6711330659,420,-3,0,28,-7,-7,8,1,0,2,2,-4,4,0,3,0,3,1,0,1,0,-2,307,0,-2,2,1,0,0,1,1,1,-1,5,-1
KR_6642915884,420,-2,-74,20,-3,-2,3,1,0,6,6,1,2,3,-2,4,2,0,0,0,0,-7,5,-3,0,3,2,0,0,-1,-1,0,-1,2,-1
KR_6530367879,420,-5,-56,-8,-8,-1,2,1,-5,5,0,-3,4,1,1,0,1,0,0,0,0,-6,-13,0,-3,3,-5,0,-1,0,-1,-1,-1,0,-1
KR_6601783690,420,-2,-24,-16,-14,-4,5,1,-6,6,0,1,2,3,-3,3,0,-2,2,0,-1,-18,3,2,-5,3,0,0,0,-1,-1,-1,-1,5,-1
KR_6527678595,420,-3,-38,15,-6,-7,8,1,-2,3,1,7,1,8,-4,4,0,0,2,2,0,0,-2,-3,-2,5,-2,0,-1,-1,1,-1,1,6,-1
KR_6761042062,420,-1,-92,-3,-6,-1,2,1,-3,7,4,5,1,6,1,2,3,-8,8,0,1,-6,-44,-3,-2,5,-4,0,-1,1,1,-1,-1,5,-1
KR_6755481705,440,-1,-12,20,4,-2,2,0,4,0,4,5,1,6,0,2,2,-3,5,2,0,2,23,0,-1,1,0,0,0,1,1,1,-1,6,-1
KR_6361660922,420,-2,-14,-24,-7,3,0,3,-4,4,0,-3,7,4,-1,4,3,-2,3,1,-1,-8,0,0,0,0,-1,0,-2,-1,-1,-1,-1,4,-1
KR_6727100161,420,-1,8,-2,-11,-5,5,0,-5,5,0,1,1,2,0,1,1,-2,2,0,-1,-7,28,0,-4,4,-3,0,-1,-1,-1,-1,-1,2,-1
KR_6751641222,420,0,12,-58,4,1,0,1,0,0,0,2,0,2,0,5,5,1,0,1,0,1,-36,1,-6,5,-3,0,0,-1,0,0,1,2,-1
KR_6668821536,420,-6,-98,19,-12,-4,4,0,-1,2,1,0,3,3,-7,7,0,0,1,1,1,-15,-14,-2,0,2,1,0,-1,-1,1,-1,1,6,-1
KR_6741019074,440,-2,-79,-18,-3,0,1,1,0,3,3,0,0,0,-3,4,1,0,1,1,0,1,200,-4,-2,6,-6,0,-1,-1,-1,-1,-1,2,-1
KR_6637137532,420,-1,-9,-20,0,-2,2,0,-5,7,2,4,0,4,-1,1,0,4,1,5,-2,-5,2,0,-6,6,-4,0,0,-1,0,0,-1,6,-1
KR_6740391636,420,0,8,-26,2,-3,3,0,1,1,2,0,0,0,5,3,8,-1,1,0,0,4,4,3,-7,4,2,0,0,-1,-1,-1,-1,1,-1
KR_6709081092,420,-2,-24,-12,-10,-4,4,0,-2,4,2,-1,6,5,0,2,2,-3,3,0,0,-2,-4,-1,-2,3,1,0,0,-1,0,-1,1,1,-1
KR_6559464889,420,-5,-13,-8,-13,-1,3,2,0,2,2,-5,5,0,-6,6,0,-1,2,1,0,-7,19,0,-2,2,-3,0,-1,-1,-1,-1,-1,2,-1
KR_6617192139,420,-5,-63,-16,-2,-2,2,0,1,2,3,4,1,5,-2,2,0,-3,3,0,0,-7,-15,-1,-1,2,2,0,-3,0,-1,-1,-1,0,-1
KR_6698703266,420,-2,-68,-14,5,-3,3,0,0,1,1,5,2,7,1,9,10,2,3,5,2,8,8,10,-10,0,-4,0,-1,1,1,-1,1,5,-1
KR_6672271001,420,-4,-1,-53,-12,-2,2,0,-1,3,2,0,2,2,-8,9,1,-1,1,0,0,-7,121,-2,-1,3,-3,0,0,0,-1,1,-1,0,-1
KR_6653036735,420,-1,2,1,-4,1,4,5,1,0,1,-1,2,1,-5,5,0,0,0,0,0,-11,3,-2,-1,3,1,0,1,-1,1,1,-1,5,-1
KR_6658793282,420,-1,-42,22,5,0,3,3,2,3,5,3,1,4,-3,4,1,3,0,3,0,-1,-24,-2,-2,4,-1,0,-3,1,-1,-1,-1,6,-1
KR_6525703284,420,-2,-76,-16,-4,-3,4,1,-3,7,4,3,1,4,-2,7,5,1,2,3,0,2,3,-1,-2,3,0,0,-2,-1,-1,-1,-1,5,-1
KR_6752285301,420,1,-42,20,0,-2,4,2,-4,4,0,0,2,2,3,1,4,3,1,4,0,-3,-5,-1,-4,5,1,0,0,0,0,0,1,0,-1
KR_6724475874,420,0,-55,0,0,-1,6,5,-3,4,1,1,3,4,4,3,7,-1,2,1,1,0,18,2,-4,2,-2,0,-1,-1,1,-1,-1,6,-1
KR_6737443125,420,-2,27,-28,1,0,1,1,1,1,2,-4,6,2,4,0,4,0,1,1,0,1,4,-2,-4,6,-3,0,0,-1,1,0,1,6,-1
KR_6686688004,420,-1,-98,-7,3,-4,5,1,-1,2,1,5,1,6,4,1,5,-1,2,1,0,6,-9,-1,-1,2,2,0,-1,1,0,-1,-1,5,-1
KR_6730076535,420,0,16,-20,0,-2,3,1,4,1,5,0,2,2,-1,3,2,-1,2,1,0,6,-2,5,-7,2,-4,0,0,-1,-1,0,-1,3,-1
KR_6684673686,420,-7,-124,-47,-13,-4,5,1,-4,6,2,-1,2,1,-1,3,2,-3,4,1,0,-16,-10,-1,-3,4,1,0,-4,-1,-1,-1,-1,4,-1
KR_6659999950,420,-5,-43,12,-10,-2,2,0,-7,7,0,1,1,2,-2,2,0,0,2,2,0,-9,9,-2,-2,4,-3,0,0,1,-1,0,-1,6,-1
KR_6721048191,420,-3,-85,0,-7,-5,5,0,-3,4,1,2,1,3,-1,1,0,0,1,1,0,0,2,1,-6,5,-5,0,-1,1,-1,-1,-1,3,-1
KR_6759225923,420,-3,-41,-9,0,5,0,5,1,3,4,-1,4,3,-3,9,6,-2,4,2,2,-4,1,0,-5,5,1,0,-1,-1,0,-1,-1,3,-1
KR_6731468759,420,-1,-3,-36,4,-3,4,1,1,3,4,-2,3,1,5,1,6,3,0,3,0,14,1,1,-4,3,3,0,0,-1,0,0,1,5,-1
KR_6640063827,420,-6,-16,-29,-13,2,0,2,-6,6,0,-6,6,0,-4,6,2,1,1,2,1,-12,1,1,-3,2,-2,0,0,1,-1,-1,1,5,-1
KR_6010020505,420,-2,-4,-8,0,1,1,2,-3,3,0,1,0,1,-1,2,1,2,0,2,0,-7,1,2,-4,2,-1,0,0,1,1,0,1,1,-1
KR_6758130329,440,2,41,16,2,1,1,2,-3,3,0,-3,5,2,4,2,6,3,5,8,1,5,2,1,-7,6,2,0,-1,-1,-1,-1,-1,6,-1
KR_6729238492,420,-9,-78,-39,-21,-4,5,1,-4,6,2,-6,6,0,-5,5,0,-2,2,0,-3,-13,-7,-3,-1,4,-3,0,0,-1,-1,-1,-1,3,-1
KR_6756495145,420,-1,-64,-7,-8,-3,3,0,-2,2,0,4,2,6,-4,4,0,-3,3,0,0,-9,-11,-4,-1,5,3,0,-1,-1,-1,-1,-1,5,-1
KR_6639183421,420,-1,-74,-12,-1,1,0,1,1,1,2,3,0,3,-4,4,0,-2,3,1,0,-1,-34,2,-7,5,30,0,-1,-1,-1,-1,1,1,-1
KR_6581371419,440,0,-85,10,-2,2,0,2,1,1,2,-2,2,0,-1,1,0,-2,2,0,0,-3,-7,-1,0,1,3,0,-1,-1,0,-1,-1,5,-1
KR_6618763700,420,0,-16,-8,-4,-6,6,0,-1,3,2,6,0,6,-4,5,1,1,1,2,0,-2,309,-1,-1,2,0,0,-1,-1,0,-1,-1,6,-1
KR_6713636247,420,2,10,33,2,2,0,2,1,2,3,-1,3,2,1,2,3,-1,2,1,0,-1,-2,3,-4,1,0,0,0,0,-1,-1,1,0,-1
KR_6741614285,420,-1,-30,19,-7,1,0,1,1,4,5,-2,5,3,-4,4,0,-3,3,0,0,-15,109,1,-3,2,-7,0,-1,-1,-1,1,-1,5,-1
KR_6713754332,420,0,-32,9,0,-1,3,2,-10,11,1,7,0,7,-2,4,2,6,0,6,0,-4,-108,1,-2,1,-1,0,-1,1,0,-1,1,6,-1
KR_6693329187,440,-4,28,-24,-3,-1,3,2,3,2,5,-2,3,1,-1,3,2,-2,3,1,-1,-1,8,0,-1,1,1,0,-1,-1,-1,1,-1,1,-1
KR_6547924102,420,0,-5,40,4,-1,2,1,5,0,5,-1,1,0,2,0,2,-1,1,0,-1,3,7,0,-4,4,3,0,0,1,1,-1,-1,1,-1
KR_6640663911,420,-1,4,20,-1,0,0,0,3,1,4,3,0,3,-4,4,0,-3,3,0,0,1,5,1,-6,5,1,0,0,1,1,0,1,2,-1
KR_6636266759,420,3,-18,-8,-2,2,1,3,3,2,5,-1,1,0,-6,6,0,0,4,4,-1,-8,-1,1,-7,6,4,0,0,-1,-1,0,-1,6,-1
KR_6764233854,420,0,-8,16,-7,3,0,3,-1,2,1,-1,1,0,-7,9,2,-1,1,0,0,-10,-12,-6,0,6,-1,0,0,-1,0,-1,1,1,-1
KR_6727945027,420,-1,40,-5,-7,1,1,2,0,4,4,-2,4,2,-3,6,3,-3,3,0,0,-1,-1,1,-4,3,3,0,0,-1,-1,-1,1,1,-1
KR_6725335085,420,-7,-35,-44,-12,-6,6,0,-1,2,1,1,0,1,-2,2,0,-4,4,0,1,-3,-10,-4,-3,7,1,0,-1,-1,-1,-1,1,1,-1
KR_6759964656,420,-2,69,-4,2,-1,3,2,-2,4,2,-1,1,0,3,2,5,3,0,3,0,-1,-53,-2,-2,4,11,0,0,1,-1,0,-1,4,-1
KR_6761200433,420,1,24,8,1,0,1,1,1,0,1,-4,4,0,2,0,2,2,2,4,0,-4,-1,1,-3,2,2,0,0,0,0,0,1,0,-1
KR_6673338119,420,1,-75,-20,1,1,2,3,1,1,2,-6,7,1,1,3,4,4,1,5,-1,4,-20,0,0,0,4,0,-2,-1,1,-1,-1,4,-1
KR_6621236505,420,0,46,-56,2,3,0,3,4,3,7,-3,4,1,-2,3,1,0,1,1,0,2,7,2,-4,2,0,0,1,0,1,1,-1,0,-1
KR_6731398955,420,-8,-92,-20,-10,-5,6,1,-5,5,0,-3,3,0,2,0,2,1,0,1,0,-2,6,-4,-4,8,-4,0,-1,1,-1,-1,-1,2,-1
KR_6763112742,420,-1,29,-20,-5,-5,7,2,0,1,1,-5,7,2,4,0,4,1,0,1,1,5,4,1,-1,0,1,0,0,0,-1,1,1,0,-1
KR_6753460849,420,1,41,3,-4,-2,3,1,0,1,1,0,0,0,-2,4,2,0,0,0,0,-5,-21,2,-4,2,0,0,-1,-1,1,-1,-1,1,-1
KR_6618682309,420,-2,8,-8,-3,-1,3,2,-2,4,2,1,1,2,0,3,3,-1,1,0,1,1,-286,0,-3,3,2,0,0,-1,1,0,1,6,-1
KR_6044997012,420,0,37,-18,-1,2,1,3,-2,6,4,-1,1,0,0,5,5,0,1,1,1,0,-7,-3,-3,6,3,0,1,1,0,1,1,3,-1
KR_6708503529,420,-9,-120,12,-10,-3,4,1,-4,5,1,-1,1,0,-1,3,2,-1,1,0,-2,-10,-23,0,-3,3,-2,0,-3,-1,-1,-1,-1,3,-1
KR_6722439130,420,4,-30,4,1,0,2,2,2,0,2,-1,4,3,1,4,5,-1,3,2,0,7,-43,-2,0,2,6,0,0,1,0,0,-1,5,-1
KR_6728525102,440,4,-24,24,7,-1,1,0,-1,2,1,8,1,9,0,2,2,1,1,2,0,7,-5,-2,-1,3,-2,0,0,1,0,0,1,6,-1
KR_6756239202,420,3,26,12,5,5,2,7,4,0,4,3,3,6,-6,6,0,-1,1,0,0,-5,33,-5,-2,7,-24,0,0,-1,0,1,-1,2,-1
KR_6638350958,420,-4,-102,-15,-8,-3,6,3,0,3,3,-2,4,2,-1,3,2,-2,3,1,-1,-2,-4,0,-3,3,-3,0,-2,-1,-1,-1,-1,4,-1
KR_6686556131,440,-3,19,-20,-9,-3,4,1,-7,8,1,2,1,3,-1,6,5,0,1,1,-1,-4,-16,5,-7,2,1,0,-1,-1,0,-1,-1,6,-1
KR_6722289367,440,-2,6,23,-11,-1,5,4,-3,4,1,0,4,4,-3,5,2,-4,6,2,0,-16,-15,4,-6,2,3,0,0,1,0,0,-1,1,-1
KR_5581771916,420,-4,-34,-24,-15,0,3,3,-7,9,2,-3,5,2,-4,4,0,-1,3,2,1,-11,-12,-2,-4,6,-1,0,-2,-1,-1,-1,1,1,-1
KR_6683673388,420,-2,-39,0,-8,-1,2,1,-4,5,1,2,0,2,-2,3,1,-3,3,0,0,-4,-361,-3,-2,5,-4,0,0,-1,1,0,-1,2,-1
KR_6723333035,420,-2,-62,-12,-2,3,0,3,-1,1,0,-1,4,3,0,3,3,-3,3,0,0,-2,10,0,-1,1,0,0,-1,-1,1,-1,-1,2,-1
KR_6654923823,420,-1,7,8,6,-3,4,1,1,0,1,2,1,3,6,1,7,0,0,0,0,6,-7,0,-2,2,2,0,-1,-1,1,-1,1,1,-1
KR_6742383180,440,-4,-94,20,-11,-8,8,0,0,3,3,-1,3,2,-1,4,3,-1,1,0,0,-3,3,7,-10,3,-4,0,-2,-1,-1,-1,-1,2,-1
KR_6647883661,420,-3,15,-24,1,-2,3,1,2,0,2,2,0,2,-1,2,1,0,0,0,0,0,7,7,-10,3,-1,0,0,-1,1,-1,1,6,-1
KR_6649746230,420,-3,-15,-16,-6,-2,2,0,0,3,3,-3,4,1,-2,5,3,1,2,3,0,-8,-21,-5,-2,7,17,0,0,-1,0,0,-1,5,-1
KR_6616790154,420,0,24,-12,-5,0,1,1,-3,3,0,-2,4,2,1,2,3,-1,3,2,0,-4,-36,-4,-4,8,31,0,-1,1,-1,-1,-1,1,-1
KR_6705726631,420,1,-79,8,-1,-2,3,1,5,3,8,2,3,5,-8,8,0,2,0,2,0,-7,-5,3,-3,0,1,0,-2,-1,-1,-1,1,2,-1
KR_6374337763,420,-6,-66,-64,-11,-1,4,3,-2,4,2,-3,3,0,-5,7,2,0,5,5,-1,-5,0,0,0,0,-9,0,1,0,1,-1,-1,0,-1
KR_6693620744,420,-2,-2,-24,-3,1,1,2,2,3,5,1,3,4,0,5,5,-7,7,0,0,-10,-4,-1,-4,5,-6,0,0,-1,1,1,1,1,-1
KR_6600921507,420,-1,-46,29,-4,-2,3,1,-2,3,1,-3,6,3,0,2,2,3,2,5,-1,0,-5,1,-2,1,-2,0,-1,-1,0,-1,-1,5,-1
KR_6764284960,420,-2,-17,-40,0,1,2,3,-2,5,3,-6,8,2,5,1,6,2,0,2,0,5,-14,1,-3,2,-2,0,0,-1,1,1,-1,1,-1
KR_6727354884,420,-3,-83,4,-10,1,0,1,-1,1,0,-3,5,2,-3,3,0,-4,5,1,0,-8,-136,0,-2,2,-1,0,-1,-1,0,-1,1,1,-1
KR_6688079763,420,-2,-69,0,-6,-3,3,0,0,2,2,0,4,4,0,2,2,-3,4,1,1,-7,0,-3,-1,4,3,0,-2,-1,-1,-1,1,4,-1
KR_6716745582,420,0,36,-15,-3,0,2,2,2,4,6,-1,1,0,-2,5,3,-2,5,3,1,-4,-8,3,-3,0,-1,0,0,-1,-1,0,1,3,-1
KR_6755238939,440,1,-41,0,-1,1,2,3,-2,3,1,0,3,3,0,4,4,0,1,1,0,0,5,5,-7,2,-4,0,0,1,-1,-1,-1,2,-1
KR_6752274189,440,0,-30,5,0,1,0,1,1,1,2,-1,2,1,0,6,6,-1,1,0,0,-5,-10,-2,-1,3,1,0,0,-1,1,-1,-1,2,-1
KR_6727138235,420,-2,-25,20,-8,-2,2,0,0,4,4,2,0,2,-6,7,1,-2,2,0,0,-11,3,1,-6,5,-3,0,0,0,1,0,-1,0,-1
KR_5581615684,420,-5,-36,-12,-12,-10,10,0,-7,9,2,6,1,7,-3,4,1,2,0,2,1,-8,-146,1,-6,5,-4,0,-2,-1,-1,-1,1,3,-1
KR_6651663099,420,2,12,8,3,2,1,3,2,2,4,3,1,4,-2,4,2,-2,3,1,0,10,-2,0,-2,2,-4,0,-1,1,0,-1,1,3,-1
KR_6714513399,420,-1,59,-20,-2,-2,2,0,0,3,3,-2,3,1,4,1,5,-2,3,1,0,6,-43,-2,-2,4,33,0,0,0,0,0,-1,0,-1
KR_6730816700,420,-1,34,-24,2,0,2,2,-4,5,1,6,0,6,6,1,7,-6,6,0,1,-2,0,4,-5,1,1,0,-1,-1,0,-1,1,2,-1
KR_6698343314,420,-4,-42,-45,-4,3,1,4,-3,3,0,-5,5,0,3,2,5,-2,4,2,1,-1,-9,3,-5,2,-2,0,-1,-1,-1,-1,-1,2,-1
KR_6735447515,440,-4,-85,-8,-13,1,2,3,-5,5,0,-2,4,2,-3,3,0,-4,4,0,0,-9,7,1,-3,2,4,0,-1,0,0,-1,-1,0,-1
KR_6762383061,420,4,23,48,-4,-2,5,3,-3,3,0,2,0,2,-1,1,0,0,3,3,-1,-10,2,-3,-1,4,5,0,0,0,1,0,-1,0,-1
KR_6602427536,420,-5,-115,7,-11,-3,3,0,1,1,2,-4,6,2,-2,2,0,-3,4,1,0,-12,5,-2,-1,3,0,0,-2,-1,-1,-1,-1,1,-1
KR_5761356875,420,0,19,4,5,3,1,4,-1,3,2,0,0,0,2,0,2,1,0,1,0,1,1,2,-3,1,0,0,0,0,0,0,1,0,-1
KR_6362831128,440,-5,-46,-4,-9,-3,5,2,-1,4,3,-2,2,0,0,3,3,-3,4,1,0,-6,0,0,0,0,-2,0,-1,1,1,-1,1,6,-1
KR_6751175131,440,-3,-26,15,-14,-4,4,0,1,2,3,-7,7,0,-5,6,1,1,0,1,-3,-27,159,-1,-3,4,1,0,-1,-1,-1,-1,-1,3,-1
KR_6649603999,420,-3,-71,8,-11,-1,1,0,-8,8,0,-2,2,0,2,0,2,-2,3,1,0,-16,-286,-1,-1,2,0,0,-2,-1,-1,-1,-1,2,-1
KR_6704225068,420,-2,-25,-15,-3,0,0,0,1,0,1,0,4,4,-2,5,3,-2,4,2,-2,-1,0,2,-2,0,2,0,-1,-1,-1,-1,1,3,-1
KR_5653389640,420,-3,-23,-33,0,-3,6,3,-2,6,4,3,0,3,0,5,5,2,1,3,0,0,30,-1,-7,8,1,0,0,1,0,0,-1,6,-1
KR_6697458918,420,-2,-51,1,-4,-1,1,0,-1,2,1,0,0,0,-2,2,0,0,1,1,0,-6,-37,-2,-5,7,0,0,0,1,-1,-1,-1,2,-1
KR_6739490150,420,-8,-140,-48,-16,-5,5,0,-1,3,2,-2,4,2,-7,7,0,-1,3,2,-1,-16,-6,-3,-1,4,1,0,-1,-1,0,-1,-1,3,-1
KR_6731484038,420,1,-22,31,-4,-3,5,2,3,3,6,-3,6,3,-1,3,2,0,1,1,-1,-4,-3,-2,-3,5,4,0,-2,1,-1,-1,-1,6,-1
KR_6732001536,420,-2,-59,8,-9,-2,3,1,-2,2,0,-5,6,1,-4,4,0,4,0,4,0,-8,-345,-2,-2,4,1,0,0,-1,1,0,-1,6,-1
KR_6730619902,420,-3,-57,24,-5,2,1,3,-1,2,1,-3,5,2,-4,4,0,1,2,3,0,-1,-158,-1,-2,3,-2,0,0,-1,0,0,-1,3,-1
KR_6709596084,440,-3,-51,-28,-7,0,3,3,-3,3,0,-1,3,2,-2,4,2,-1,1,0,0,-3,1,-1,-1,2,-1,0,0,-1,-1,0,-1,2,-1
KR_6761485840,420,-1,-47,-5,-4,1,0,1,6,0,6,-7,7,0,-1,2,1,-3,3,0,0,-2,-376,-1,-2,3,-1,0,-2,-1,-1,-1,-1,4,-1
KR_6753728088,420,-1,-39,8,-1,-4,5,1,4,0,4,-2,3,1,3,3,6,-2,3,1,0,-2,38,-1,-2,3,-13,0,0,-1,1,0,1,4,-1
KR_6757951787,420,3,-10,0,8,-5,5,0,4,1,5,0,3,3,6,0,6,3,1,4,0,13,14,1,-3,2,1,0,0,1,-1,-1,-1,2,-1
KR_6097346254,420,-6,-69,-21,-5,0,2,2,3,2,5,-5,5,0,-3,3,0,0,1,1,1,3,11,-1,-1,2,-3,0,-1,1,-1,-1,1,2,-1
KR_6616656852,420,0,13,2,-3,-1,2,1,3,2,5,0,1,1,-7,7,0,2,0,2,0,-9,46,-1,-3,4,-2,0,-1,0,0,-1,-1,0,-1
KR_6750427006,420,-1,-2,-52,5,-3,4,1,-5,7,2,1,0,1,12,0,12,0,1,1,0,10,3,1,-4,3,1,0,1,-1,-1,1,-1,3,-1
KR_6655961639,420,-3,-77,4,-6,-4,5,1,2,1,3,-3,7,4,0,4,4,-1,2,1,0,-1,9,-2,-4,6,0,0,0,1,-1,0,1,6,-1
KR_6564303959,420,-3,-61,4,-8,3,0,3,-1,1,0,1,1,2,-10,10,0,-1,2,1,-1,-11,5,1,-3,2,3,0,-1,1,1,-1,-1,3,-1
KR_6643547076,420,0,-18,-8,1,-1,2,1,-7,7,0,2,2,4,7,1,8,0,0,0,0,1,-3,-1,-4,5,-6,0,0,1,1,-1,-1,5,-1
KR_6647706530,440,-2,-87,-28,-7,0,2,2,-1,4,3,-1,1,0,-2,6,4,-3,4,1,-2,-19,-7,-5,0,5,4,0,-2,-1,-1,-1,-1,6,-1
KR_6628196139,420,1,33,5,3,1,2,3,1,1,2,2,1,3,0,2,2,-1,2,1,0,3,3,0,-3,3,0,0,1,1,0,1,1,3,-1
KR_6630846155,420,-7,-86,-12,-15,-5,5,0,1,2,3,-4,4,0,-4,7,3,-3,4,1,0,-11,1,-1,-2,3,-1,0,-1,0,-1,-1,-1,0,-1
KR_6603449472,420,-3,-125,-20,-6,-4,4,0,-1,3,2,0,3,3,-2,6,4,1,0,1,-1,-9,-2,-2,-2,4,0,0,-2,1,-1,-1,-1,3,-1
KR_6642663598,420,-2,1,-4,-5,1,0,1,1,0,1,-5,6,1,-2,2,0,0,0,0,0,0,-3,1,-3,2,-1,0,0,-1,-1,0,-1,3,-1
KR_6375997635,420,-2,50,-8,0,3,1,4,3,1,4,-8,8,0,2,3,5,0,1,1,0,-3,0,0,0,0,-4,0,0,-1,1,0,1,1,-1
KR_6637825236,420,-4,-18,-24,-9,-5,7,2,-2,2,0,1,0,1,-2,2,0,-1,2,1,0,-8,-5,-1,-1,2,1,0,-1,-1,0,-1,-1,3,-1
KR_6760138229,420,-1,19,0,-6,-2,2,0,0,1,1,-2,4,2,-2,3,1,0,2,2,0,-6,-5,0,-3,3,-1,0,0,-1,1,0,1,3,-1
KR_6737111910,420,-4,-17,-8,-5,2,2,4,-5,6,1,-1,5,4,-3,4,1,2,0,2,0,-8,-2,4,-5,1,2,0,-1,-1,-1,-1,-1,1,-1
KR_6607489022,420,-2,-58,-4,-6,-5,5,0,0,1,1,2,0,2,-4,5,1,1,0,1,0,-8,-6,1,-3,2,3,0,-1,-1,-1,-1,-1,6,-1
KR_6739363482,440,-1,23,4,-6,-4,6,2,-6,7,1,2,2,4,0,1,1,2,0,2,0,-9,4,-3,-5,8,1,0,1,0,0,1,-1,0,-1
KR_6628434084,420,-2,-45,16,-6,-5,5,0,0,1,1,-3,4,1,5,0,5,-3,4,1,0,-2,4,-1,-2,3,0,0,-1,1,1,1,-1,3,-1
KR_6719889052,420,6,65,-2,7,1,1,2,-4,6,2,0,3,3,7,2,9,3,1,4,0,10,-215,2,-3,1,-34,0,1,0,0,1,1,0,-1
KR_6715633384,420,-6,4,-20,-12,0,1,1,-11,12,1,-1,4,3,0,3,3,0,1,1,0,-15,-102,-2,-1,3,12,0,0,-1,1,1,1,5,-1
KR_6700980893,420,-3,4,-48,-9,-5,6,1,-4,6,2,-1,4,3,1,4,5,0,0,0,0,-1,-2,0,-3,3,1,0,-1,-1,-1,-1,-1,3,-1
KR_6649850579,420,-6,-57,5,-18,-3,3,0,-4,5,1,-7,7,0,-5,7,2,1,0,1,-1,-15,-1,-1,0,1,-3,0,-2,-1,-1,-1,-1,5,-1
KR_6758213223,420,-5,-52,-12,-8,-4,6,2,-1,2,1,2,0,2,-6,11,5,1,1,2,2,-7,1,1,-1,0,-1,0,-2,-1,-1,-1,1,5,-1
KR_6728762256,420,-5,-88,-8,-11,0,3,3,-4,5,1,-8,9,1,-1,2,1,2,3,5,-1,-15,-42,5,-5,0,17,0,-4,1,-1,-1,-1,3,-1
KR_6757572029,420,-7,-116,-40,-16,0,3,3,0,0,0,-3,6,3,-8,9,1,-5,7,2,-1,-10,22,0,-3,3,-25,0,-1,0,0,-1,-1,0,-1
KR_6717439721,420,-1,-26,-15,-4,-2,3,1,-2,5,3,3,2,5,-4,6,2,1,1,2,-1,-4,-13,-5,-1,6,1,0,0,1,-1,-1,-1,6,-1
KR_6384290020,420,-3,-10,-17,-6,1,0,1,-2,2,0,-5,5,0,0,1,1,0,0,0,0,-3,-5,2,-5,3,-2,0,-1,-1,0,-1,-1,3,-1
KR_6642801770,420,-3,-80,40,-12,-4,5,1,-3,3,0,4,0,4,-8,8,0,-1,1,0,0,-11,36,4,-6,2,-35,0,-1,-1,1,1,-1,3,-1
KR_6711352697,420,-2,-8,8,4,-5,5,0,0,4,4,2,0,2,2,3,5,5,0,5,0,8,-46,0,-3,3,9,0,-1,-1,1,-1,1,1,-1
KR_6577292902,420,0,64,-31,0,8,0,8,-1,2,1,-1,2,1,-3,3,0,-3,3,0,0,-7,-10,-1,-3,4,0,0,0,-1,0,1,-1,6,-1
KR_6729159592,420,-1,-77,-10,-4,-2,3,1,-2,3,1,2,1,3,-1,2,1,-1,4,3,-1,-8,-2,-4,-1,5,1,0,0,1,-1,-1,-1,5,-1
KR_6696854515,420,-3,-20,20,-9,0,1,1,0,0,0,-5,5,0,-2,3,1,-2,2,0,0,-10,213,1,-2,1,-1,0,0,1,1,0,-1,2,-1
KR_6638186148,440,-6,-101,-43,-17,-1,1,0,-4,5,1,2,0,2,-4,8,4,-10,10,0,0,-8,-12,-3,-3,6,-2,0,-1,-1,0,-1,-1,6,-1
KR_6375948950,420,-2,-55,-1,-7,-4,5,1,3,1,4,-2,7,5,-3,8,5,-1,3,2,0,0,0,0,0,0,-2,0,-1,-1,0,-1,1,5,-1
KR_6658934247,420,0,32,12,-1,-3,3,0,-1,3,2,0,2,2,1,0,1,2,0,2,0,3,6,0,-1,1,-1,0,0,-1,0,0,1,5,-1
KR_6309967040,420,3,-90,-22,7,-3,4,1,-4,5,1,7,0,7,6,2,8,1,0,1,-1,15,-25,1,-5,4,4,0,0,1,0,-1,-1,1,-1
KR_6715700428,420,-2,-28,-4,-3,-8,8,0,1,0,1,2,2,4,4,0,4,-2,3,1,0,-1,1,-1,-3,4,3,0,0,1,1,0,-1,2,-1
KR_6758467683,420,-4,-13,-12,-8,2,1,3,1,0,1,-6,7,1,-2,5,3,-3,3,0,0,0,-7,-2,-3,5,1,0,-3,1,-1,-1,-1,6,-1
KR_6712463266,420,-5,-47,-9,-8,-5,5,0,2,1,3,4,0,4,-3,4,1,-6,8,2,0,-1,10,1,-5,4,-3,0,-2,-1,0,-1,-1,3,-1
KR_6647346247,440,-5,-86,-8,-12,-6,7,1,-2,5,3,-3,4,1,-2,4,2,1,2,3,0,-11,-1,1,-3,2,3,0,-2,0,0,-1,-1,0,-1
KR_6724595010,420,-2,-47,-24,-6,3,0,3,-4,5,1,-1,2,1,-4,4,0,0,1,1,-1,-5,-4,-3,-1,4,-5,0,0,0,0,0,-1,0,-1
KR_6688732587,420,-11,-177,-57,-23,-7,7,0,-5,6,1,-10,10,0,-1,2,1,0,1,1,-1,-16,-16,-4,-2,6,-1,0,-2,-1,-1,-1,-1,6,-1
KR_6493479605,420,-5,-64,-52,-1,2,1,3,1,1,2,-1,3,2,0,5,5,-3,5,2,3,1,1,-1,-4,5,1,0,-2,-1,-1,-1,1,4,-1
KR_6609862326,420,2,58,23,-9,0,1,1,-2,4,2,1,5,6,-4,5,1,-4,6,2,-2,-7,18,3,-4,1,-1,0,0,0,-1,1,-1,0,-1
KR_6642620807,420,-1,46,24,-8,0,2,2,1,0,1,1,0,1,-9,9,0,-1,2,1,0,-12,5,1,-4,3,3,0,-1,1,1,-1,1,5,-1
KR_6731792343,420,-5,-26,-28,-9,-2,2,0,-2,3,1,-1,1,0,-2,2,0,-2,2,0,0,-8,-10,0,-2,2,0,0,0,-1,-1,0,-1,3,-1
KR_6623522877,420,-2,-92,2,-6,-4,5,1,1,3,4,0,2,2,-3,3,0,0,0,0,0,-3,1,-3,-1,4,-3,0,-2,-1,-1,-1,1,3,-1
KR_6643488329,420,-2,17,-19,-11,2,0,2,-6,6,0,-1,2,1,-4,5,1,-2,2,0,-1,-17,2,-2,-1,3,1,0,0,-1,0,-1,-1,1,-1
KR_6653165453,420,-1,-39,3,-2,-3,5,2,2,1,3,-1,3,2,0,0,0,0,3,3,1,1,17,2,-6,4,-2,0,0,-1,-1,-1,1,3,-1
KR_6603608808,420,-1,-51,15,-4,0,2,2,-3,6,3,0,5,5,-1,1,0,0,0,0,0,0,-6,-2,-6,8,0,0,1,0,0,-1,-1,0,-1
KR_6627098225,420,-1,-25,40,-4,-1,3,2,-3,5,2,-1,4,3,1,1,2,0,1,1,0,-3,6,2,-4,2,0,0,0,1,1,0,1,4,-1
KR_6728820335,420,2,-60,16,3,0,0,0,-2,4,2,2,1,3,0,1,1,3,0,3,0,0,3,-4,-2,6,3,0,0,-1,-1,1,-1,6,-1
KR_6667359536,420,-1,-1,8,-3,0,0,0,-3,5,2,1,3,4,1,4,5,-2,2,0,1,-6,17,3,-6,3,-30,0,0,1,1,0,1,2,-1
KR_6594094970,440,-3,1,-29,-4,0,2,2,-5,5,0,-1,2,1,-3,7,4,5,0,5,0,-7,-62,-2,-2,4,-2,0,-1,-1,-1,-1,1,1,-1
KR_6742440745,420,-3,-45,-17,-10,-4,5,1,-2,3,1,1,1,2,-4,6,2,-1,1,0,0,-5,-1,-1,-3,4,-1,0,0,1,1,-1,-1,5,-1
KR_6733378644,420,0,77,0,-4,1,1,2,-1,1,0,0,1,1,-3,3,0,-1,2,1,0,-3,-94,0,-1,1,-24,0,0,0,-1,0,1,0,-1
KR_6709277357,420,2,-57,-35,4,-3,4,1,3,1,4,1,0,1,2,2,4,1,0,1,-2,11,0,2,-5,3,-1,0,-1,0,-1,-1,-1,0,-1
KR_6716309119,420,-1,-59,-16,-2,2,1,3,1,2,3,-3,5,2,1,1,2,-3,5,2,2,-3,-9,-2,0,2,1,0,-1,-1,-1,-1,1,3,-1
KR_6618534716,420,-3,-115,-47,-1,-3,3,0,0,1,1,4,1,5,-2,3,1,0,2,2,-1,-3,3,0,-2,2,-1,0,0,0,1,0,-1,0,-1
KR_6693492295,420,3,17,-32,5,-4,5,1,-1,4,3,4,0,4,4,2,6,2,1,3,0,7,1,0,-3,3,3,0,0,0,0,0,-1,0,-1
KR_6740543406,420,-7,-80,-72,-14,-3,4,1,3,1,4,-11,11,0,-2,3,1,-1,1,0,0,-4,338,-1,0,1,-6,0,-3,1,0,-1,-1,6,-1
KR_6642342153,420,-6,-56,-7,-9,-3,3,0,-4,4,0,-4,4,0,0,0,0,2,0,2,0,-6,271,-1,-3,4,-5,0,-1,1,-1,-1,-1,1,-1
KR_6715200697,420,-1,-85,28,-7,-4,5,1,3,2,5,-1,3,2,-7,7,0,2,0,2,-2,-11,-6,-5,0,5,0,0,0,-1,0,0,-1,3,-1
KR_6745756352,420,-3,-33,-13,-3,0,1,1,1,2,3,1,3,4,-1,4,3,-4,4,0,0,-9,2,2,-3,1,0,0,0,-1,1,1,-1,2,-1
KR_6655163346,420,-7,-56,-56,-15,-6,7,1,-1,2,1,-3,4,1,-7,8,1,2,0,2,0,-10,-3,-2,-2,4,0,0,-2,-1,-1,-1,-1,2,-1
KR_6649685789,420,-5,-34,-40,-9,-3,3,0,-4,4,0,1,0,1,-3,9,6,0,1,1,0,-6,-8,-1,-1,2,1,0,-2,1,1,-1,1,5,-1
KR_6637147470,440,-4,-59,-4,0,1,0,1,-5,7,2,0,2,2,4,3,7,0,2,2,0,-1,-26,1,-4,3,15,0,-1,1,0,-1,-1,5,-1
KR_6719472727,420,0,-69,-4,4,1,0,1,2,2,4,1,2,3,0,0,0,0,1,1,0,3,2,-1,-5,6,0,0,-1,1,-1,-1,-1,3,-1
KR_6732003817,440,-3,-51,3,-2,-5,7,2,3,0,3,-4,5,1,3,3,6,1,1,2,0,0,-4,-1,-3,4,1,0,-2,-1,-1,-1,-1,6,-1
KR_6761390012,420,0,2,12,6,2,1,3,2,0,2,2,5,7,-4,7,3,4,0,4,0,8,15,4,-7,3,0,0,-1,1,-1,-1,1,6,-1
KR_6754046894,440,1,112,-8,-1,2,0,2,-2,6,4,2,1,3,-3,4,1,0,1,1,0,-5,42,1,-3,2,-33,0,2,1,0,1,-1,2,-1
KR_6605622547,420,0,-12,20,-1,0,2,2,0,1,1,-1,4,3,-1,3,2,1,0,1,0,0,1,2,-5,3,-1,0,-1,-1,-1,-1,1,6,-1
KR_6669116431,420,-7,-169,-37,-3,1,3,4,0,0,0,-3,3,0,-1,2,1,0,0,0,0,2,-8,-3,0,3,-5,0,-3,1,-1,-1,-1,4,-1
KR_6745424490,440,2,7,4,6,0,1,1,1,1,2,3,0,3,3,3,6,-1,3,2,-1,0,21,3,-6,3,-6,0,0,1,-1,1,-1,2,-1
KR_6709927064,420,0,15,-33,-5,-1,2,1,-3,5,2,-4,6,2,4,1,5,-1,2,1,1,-3,-308,2,-4,2,-1,0,0,-1,-1,1,1,3,-1
KR_6623490642,440,2,14,16,5,-1,1,0,2,2,4,1,0,1,2,1,3,1,0,1,0,6,18,-4,-4,8,-2,0,0,-1,0,0,1,1,-1
KR_6633217534,420,0,-10,-29,-4,-2,2,0,-7,7,0,-3,3,0,6,0,6,2,2,4,0,-8,-26,2,-4,2,4,0,-1,1,-1,-1,1,1,-1
KR_6713132084,420,2,42,-59,6,2,0,2,0,3,3,1,2,3,2,3,5,1,2,3,1,4,222,0,-2,2,1,0,1,1,1,1,1,1,-1
KR_6678791523,420,-5,-127,-10,-9,-5,6,1,0,2,2,1,0,1,-4,5,1,-1,1,0,-1,-13,-5,1,-1,0,-4,0,-3,-1,0,-1,-1,5,-1
KR_6635737866,420,4,-1,12,4,-4,4,0,1,1,2,4,0,4,1,0,1,2,0,2,0,2,-4,-1,-1,2,1,0,-1,1,1,-1,1,3,-1
KR_6744275880,420,-2,-15,8,-5,2,3,5,-4,5,1,-2,5,3,-2,4,2,1,1,2,0,-12,-4,-3,-1,4,-1,0,1,-1,0,1,-1,2,-1
KR_6753904123,420,-7,-64,-8,-10,-3,3,0,-1,2,1,-2,3,1,-1,4,3,-3,4,1,0,-3,-40,-2,0,2,20,0,-1,-1,1,-1,-1,6,-1
KR_6618425412,420,-11,-150,-48,-32,-15,15,0,-7,7,0,-7,7,0,0,2,2,-3,3,0,-2,-23,1,-3,-2,5,-6,0,-5,-1,1,-1,-1,2,-1
KR_6666794492,420,1,-31,-20,-1,-1,2,1,1,4,5,-3,5,2,3,3,6,-1,1,0,0,9,6,5,-9,4,-3,0,0,-1,-1,0,-1,5,-1
KR_6707318772,420,-5,12,-24,-8,-2,2,0,-6,6,0,2,1,3,0,0,0,-2,2,0,0,-7,3,1,-3,2,-1,0,-1,-1,-1,-1,-1,1,-1
KR_6761118151,420,0,10,8,-5,-2,4,2,0,5,5,2,2,4,-5,11,6,0,2,2,0,-8,-3,2,-4,2,-2,0,0,-1,1,1,1,6,-1
KR_6633933549,420,-5,-56,-36,-4,-3,6,3,-1,6,5,-1,3,2,-2,6,4,3,1,4,-3,-2,27,0,-5,5,-6,0,-1,-1,-1,-1,-1,6,-1
KR_6505144046,420,-2,17,0,-4,-4,4,0,-3,4,1,2,3,5,0,1,1,1,1,2,0,0,1,-1,-1,2,-4,0,-1,-1,-1,-1,-1,5,-1
KR_6640002729,420,-2,-49,-5,-4,2,2,4,-2,2,0,1,0,1,0,4,4,-5,5,0,-2,-16,-2,-2,-4,6,1,0,1,-1,1,1,-1,2,-1
KR_6658460864,420,-2,-44,-4,-11,-5,5,0,-1,3,2,-1,2,1,-4,6,2,0,0,0,0,-10,608,1,-5,4,2,0,0,-1,0,0,-1,2,-1
KR_6760603262,420,1,-19,12,1,-4,4,0,-1,5,4,1,2,3,7,2,9,-2,2,0,0,6,1,0,-3,3,-2,0,0,1,-1,0,1,5,-1
KR_6616657682,420,-1,-70,-28,-4,-1,2,1,-5,5,0,-2,4,2,2,1,3,2,0,2,0,-2,-33,-2,-1,3,38,0,1,-1,0,-1,-1,3,-1
KR_6748098810,420,0,-50,9,2,1,1,2,1,1,2,8,1,9,-8,8,0,0,1,1,0,-8,-16,-1,-4,5,2,0,0,-1,1,1,-1,6,-1
KR_6715694197,420,-3,-8,-10,-5,-4,4,0,1,2,3,-2,2,0,0,2,2,0,1,1,0,-1,-13,-5,-5,10,-1,0,0,-1,0,0,-1,3,-1
KR_6653474052,420,-6,-94,-40,-11,-1,1,0,-3,3,0,-8,9,1,1,2,3,0,1,1,0,-4,119,-2,-4,6,0,0,-1,-1,1,-1,-1,5,-1
KR_6683096983,420,-3,-22,16,-7,-2,5,3,-2,4,2,-5,5,0,0,3,3,2,2,4,0,-6,30,1,-2,1,2,0,0,1,1,0,-1,5,-1
KR_6752073591,420,0,-31,-2,2,4,0,4,-7,8,1,3,2,5,0,3,3,2,0,2,0,0,26,0,-2,2,0,0,0,1,-1,-1,-1,4,-1
KR_6729951179,420,5,107,-8,4,2,1,3,1,2,3,-2,4,2,2,0,2,1,0,1,0,8,2,6,-6,0,0,0,1,0,1,1,-1,0,-1
KR_6695309312,420,-3,-30,-28,-4,-2,2,0,1,4,5,-2,3,1,-2,3,1,1,3,4,3,6,2,5,-5,0,-2,0,0,1,1,-1,1,5,-1
KR_6673870775,420,3,115,10,-2,2,0,2,-2,3,1,-3,4,1,0,1,1,1,0,1,0,-5,3,2,-3,1,-1,0,0,1,1,0,1,6,-1
KR_6716934969,420,1,30,4,-3,-1,3,2,1,1,2,-3,4,1,2,2,4,-2,3,1,0,0,13,4,-6,2,5,0,1,-1,0,1,1,2,-1
KR_6715779468,440,-2,30,-37,-8,-2,4,2,-1,5,4,-1,5,4,-2,4,2,-2,4,2,-1,-5,3,0,-5,5,-7,0,-1,-1,0,-1,-1,6,-1
KR_6754866155,440,-3,-57,-30,-6,-4,4,0,-2,6,4,4,0,4,-4,6,2,0,1,1,0,-7,-1,7,-12,5,1,0,0,-1,1,-1,-1,4,-1
KR_6625581476,420,0,22,27,3,0,2,2,0,2,2,4,2,6,-1,2,1,0,0,0,0,-4,0,-3,-1,4,-1,0,1,-1,1,1,1,6,-1
KR_6696915284,420,-4,-82,44,-1,-3,3,0,3,1,4,2,0,2,-3,6,3,0,2,2,-1,3,-1,-1,-5,6,0,0,-3,-1,0,-1,1,5,-1
KR_6742597043,420,-7,-65,-16,-15,-3,4,1,-2,2,0,-7,9,2,1,2,3,-4,4,0,0,-13,-7,-2,0,2,2,0,-1,-1,-1,-1,1,2,-1
KR_6750979915,420,-2,33,-25,1,4,0,4,1,2,3,-3,4,1,-2,3,1,1,0,1,0,1,-44,1,-3,2,4,0,0,1,1,0,1,5,-1
KR_6762761728,420,2,-10,-4,2,0,0,0,2,1,3,3,2,5,-2,5,3,-1,1,0,0,6,6,5,-5,0,-2,0,0,0,1,1,-1,0,-1
KR_6757496623,420,-2,-91,-16,-1,-5,6,1,1,2,3,3,1,4,-2,3,1,2,1,3,0,12,10,1,-3,2,-1,0,-1,0,-1,-1,-1,0,-1
KR_6642850835,420,-3,-39,3,-8,0,2,2,0,2,2,-2,2,0,-4,5,1,-2,5,3,0,-6,-10,-4,0,4,1,0,-1,-1,-1,-1,-1,3,-1
KR_6698803319,420,3,-4,2,6,2,1,3,2,4,6,2,2,4,0,0,0,0,1,1,0,7,-10,-1,-5,6,8,0,0,0,-1,0,1,0,-1
KR_6536672509,420,0,-38,8,2,-1,3,2,0,2,2,7,1,8,-4,5,1,0,0,0,-1,-4,20,2,-3,1,-4,0,1,1,1,1,-1,4,-1
KR_6745830873,420,-4,-79,-3,-10,-1,2,1,-2,2,0,-3,4,1,-8,8,0,4,0,4,0,-9,-8,-4,-1,5,-2,0,-1,-1,1,-1,-1,1,-1
KR_6626191413,420,1,3,-20,-3,2,1,3,-1,3,2,-6,7,1,1,1,2,1,0,1,0,3,-174,1,-2,1,-2,0,0,-1,0,0,-1,4,-1
KR_6762280954,440,3,69,24,0,3,1,4,1,1,2,-2,6,4,-1,1,0,-1,1,0,0,1,1,0,-6,6,-2,0,1,-1,1,1,-1,4,-1
KR_6578661364,420,0,37,5,2,-2,4,2,4,0,4,3,1,4,-3,3,0,0,0,0,-1,1,201,1,-2,1,0,0,0,1,-1,0,-1,1,-1
KR_6752613766,420,1,53,5,-2,2,1,3,-1,5,4,1,0,1,-4,4,0,0,2,2,0,-7,-17,-1,-4,5,0,0,0,-1,1,-1,-1,1,-1
KR_6643012594,420,-7,-90,-35,-15,-1,2,1,-6,6,0,-2,3,1,-3,3,0,-3,3,0,0,-13,11,-2,-1,3,-1,0,-1,-1,-1,-1,-1,6,-1
KR_6758864776,420,-5,-65,-20,-11,-4,4,0,-1,1,0,-5,6,1,-1,6,5,0,1,1,-1,-13,-7,-1,-2,3,1,0,-1,0,0,-1,-1,0,-1
KR_6745233195,420,4,18,30,4,-1,3,2,-2,3,1,1,3,4,3,1,4,3,1,4,-1,7,-115,-1,0,1,1,0,2,1,-1,1,-1,2,-1
KR_6733689568,420,-3,-86,-24,1,1,1,2,2,2,4,3,1,4,-5,6,1,0,0,0,0,4,-2,3,-9,6,3,0,-1,-1,-1,-1,1,1,-1
KR_6739999996,440,1,10,19,1,-1,1,0,1,7,8,1,3,4,0,1,1,0,0,0,0,-2,33,-2,-2,4,-32,0,0,0,-1,0,1,0,-1
KR_6729398546,440,1,36,-4,-4,-8,9,1,4,1,5,1,2,3,-3,4,1,2,0,2,-1,0,255,-1,-3,4,-2,0,-1,0,-1,-1,-1,0,-1
KR_6713620577,420,1,-57,-11,4,0,0,0,3,0,3,-3,4,1,0,2,2,4,1,5,-1,4,-2,-1,-1,2,3,0,0,-1,-1,-1,-1,6,-1
KR_6660792921,440,-2,-39,20,2,-3,5,2,-1,3,2,3,0,3,2,3,5,1,1,2,0,5,-7,-4,-1,5,1,0,-1,1,0,-1,1,1,-1
KR_6630004053,420,-1,-19,-43,-7,-2,3,1,4,1,5,-1,3,2,-8,9,1,0,4,4,0,0,-30,-2,-1,3,1,0,-1,0,-1,-1,-1,0,-1
KR_6640804633,420,-3,-88,-9,-12,0,1,1,-3,4,1,-4,4,0,-5,5,0,0,0,0,0,-10,0,-1,-3,4,1,0,-1,-1,0,-1,-1,6,-1
KR_6712468853,420,0,-11,-14,-1,0,3,3,-3,3,0,2,0,2,-6,6,0,6,0,6,1,-1,0,-2,-1,3,-1,0,-1,1,1,-1,1,1,-1
KR_6661703519,420,-1,-53,11,-6,3,0,3,0,1,1,-6,7,1,-2,3,1,-1,1,0,0,-8,-5,0,-5,5,2,0,-1,1,0,-1,-1,3,-1
KR_6732382054,420,-3,-64,-18,-6,1,4,5,-1,3,2,-8,9,1,2,0,2,0,5,5,0,2,-14,2,-3,1,4,0,-1,-1,-1,-1,1,5,-1
KR_6712423462,420,0,42,8,5,1,2,3,-6,6,0,2,1,3,4,0,4,4,0,4,0,6,-2,-3,-2,5,-1,0,0,-1,-1,-1,1,1,-1
KR_6618176719,420,0,67,-11,-2,2,3,5,-1,3,2,0,2,2,-2,3,1,-1,1,0,0,-12,-14,1,-2,1,0,0,1,1,-1,1,1,6,-1
KR_6747362959,420,-2,-100,0,1,-2,3,1,-2,6,4,3,1,4,1,1,2,1,0,1,1,5,-5,5,-6,1,-2,0,0,-1,-1,-1,1,3,-1
KR_6689474347,420,-4,0,4,-3,4,1,5,-1,4,3,-6,7,1,-1,1,0,1,0,1,1,1,45,3,-7,4,-22,0,0,1,-1,1,1,5,-1
KR_6690547661,420,-5,-71,2,-5,3,3,6,-2,3,1,-2,2,0,-4,5,1,0,0,0,0,-10,6,4,-4,0,-4,0,-1,0,1,-1,1,0,-1
KR_6696687327,420,-6,-105,-53,-15,-4,4,0,1,2,3,-4,4,0,-10,10,0,2,0,2,0,-11,-19,2,-5,3,-2,0,-2,-1,-1,-1,1,1,-1
KR_6716201993,420,-3,-27,-40,-5,2,1,3,-5,5,0,-3,4,1,0,1,1,1,1,2,0,-9,-41,-5,-3,8,21,0,0,-1,1,-1,1,3,-1
KR_6592122621,420,0,-4,0,4,5,2,7,0,3,3,-3,3,0,1,3,4,1,1,2,0,-3,-4,-5,0,5,0,0,1,-1,1,1,1,5,-1
KR_6759593490,440,3,30,20,0,1,0,1,2,4,6,-1,3,2,0,0,0,-2,3,1,0,2,15,1,-3,2,3,0,0,0,1,0,-1,0,-1
KR_6722087380,420,-5,-71,-29,-4,-3,4,1,-1,5,4,-1,2,1,1,3,4,0,1,1,0,1,-9,2,-4,2,-1,0,-1,1,-1,-1,-1,4,-1
KR_6660293163,420,1,-27,-12,1,3,1,4,2,2,4,-4,5,1,-2,4,2,2,0,2,0,10,-3,0,-4,4,1,0,0,1,-1,0,-1,1,-1
KR_6723831810,420,0,-23,8,-2,2,1,3,2,0,2,1,1,2,-9,9,0,2,0,2,0,-7,1,0,-3,3,0,0,1,-1,1,1,-1,3,-1
KR_6742532683,420,-3,-24,-12,-1,2,1,3,-1,1,0,0,1,1,-1,3,2,-1,2,1,-1,-1,-15,-2,-4,6,-1,0,-1,0,0,-1,-1,0,-1
KR_6675820675,420,-1,71,24,-2,-2,6,4,0,1,1,0,1,1,-1,3,2,1,2,3,-1,-12,-8,-5,0,5,-1,0,1,0,0,1,-1,0,-1
KR_6730345273,420,-3,-20,-28,-2,0,2,2,0,1,1,-1,4,3,1,1,2,-2,2,0,0,3,4,0,-4,4,5,0,0,1,-1,-1,-1,5,-1
KR_6653796331,420,-6,-64,-30,-20,-1,1,0,-2,2,0,-4,5,1,-11,11,0,-2,2,0,0,-18,-4,-3,-2,5,-2,0,-2,1,1,-1,-1,3,-1
KR_6616861489,420,0,34,1,-9,1,0,1,-4,4,0,-3,3,0,-1,3,2,-2,3,1,0,-8,33,2,-6,4,0,0,0,-1,-1,0,-1,1,-1
KR_6633299248,420,-5,-66,-16,-7,-5,6,1,0,4,4,7,0,7,-4,4,0,-5,6,1,0,-7,-205,1,-2,1,-3,0,-1,-1,-1,-1,-1,3,-1
KR_6692696533,420,0,31,-4,8,0,3,3,4,2,6,3,1,4,0,1,1,1,0,1,0,11,8,2,-4,2,-3,0,0,1,1,0,1,5,-1
KR_6724303101,420,-7,-97,-20,-2,2,1,3,-2,4,2,-2,3,1,0,1,1,0,1,1,0,-5,-279,1,-3,2,0,0,-4,-1,-1,-1,-1,6,-1
KR_6608358119,420,0,46,0,-2,0,1,1,-4,4,0,1,1,2,-1,4,3,2,0,2,0,1,39,2,-6,4,-19,0,0,1,-1,0,-1,1,-1
KR_6762336785,420,0,-21,-26,5,5,1,6,4,0,4,-2,3,1,-2,3,1,0,2,2,0,11,1,4,-6,2,-3,0,0,1,-1,1,1,2,-1
KR_6608058836,440,-7,52,-5,-18,-2,2,0,-8,8,0,-7,8,1,0,0,0,-1,1,0,0,-22,-6,-2,-2,4,-6,0,-2,-1,-1,-1,-1,4,-1
KR_6755477684,420,-2,-8,-20,-1,2,0,2,-1,2,1,0,3,3,-4,6,2,2,0,2,0,-5,336,0,-3,3,2,0,-1,0,-1,-1,1,0,-1
KR_6533955544,420,-4,28,7,-13,-5,5,0,1,4,5,-3,5,2,-7,8,1,1,1,2,0,-11,-6,-4,-3,7,4,0,-2,-1,-1,-1,-1,4,-1
KR_6761157016,420,-3,-55,-18,-11,-3,3,0,-8,9,1,4,1,5,-2,3,1,-2,2,0,-1,-13,-4,-4,-2,6,4,0,-3,1,-1,-1,-1,1,-1
KR_6764544593,420,0,-38,8,3,-2,2,0,-2,3,1,2,3,5,5,0,5,0,0,0,0,9,-1,1,-4,3,7,0,0,0,0,0,1,0,-1
KR_6760249129,440,0,47,-12,3,0,1,1,1,2,3,0,5,5,0,2,2,2,0,2,0,12,56,2,-2,0,-2,0,0,0,-1,0,-1,0,-1
KR_6640805925,420,0,-85,-2,-1,-3,3,0,1,3,4,0,4,4,0,0,0,1,0,1,0,1,-11,-2,-2,4,3,0,0,0,0,0,-1,0,-1
KR_6625048200,420,-1,33,-28,-4,3,0,3,-2,3,1,0,3,3,-4,5,1,-1,2,1,1,1,-6,-1,-3,4,3,0,0,-1,-1,1,1,6,-1
KR_6493578702,420,3,65,-13,8,2,1,3,-3,3,0,5,0,5,4,2,6,0,0,0,0,7,-5,4,-5,1,-4,0,0,-1,-1,1,1,1,-1
KR_6706970204,420,-2,-63,3,-12,0,2,2,-2,3,1,-2,5,3,-8,11,3,0,0,0,-1,-10,5,0,-2,2,-1,0,1,-1,1,-1,-1,5,-1
KR_6750947296,440,-1,-40,-20,-3,0,2,2,-3,4,1,-1,2,1,1,0,1,0,1,1,0,-6,-2,2,-4,2,-1,0,-1,0,-1,-1,1,0,-1
KR_6418795515,420,-2,-130,44,-2,-2,2,0,3,1,4,0,1,1,-3,4,1,0,1,1,0,-1,6,-4,-2,6,0,0,-2,-1,-1,-1,-1,1,-1
KR_6757349015,420,2,37,20,5,-1,3,2,0,3,3,4,0,4,3,1,4,-1,2,1,0,6,8,0,-3,3,3,0,1,-1,1,1,1,3,-1
KR_6724009268,420,-1,-37,16,-6,0,2,2,4,0,4,-4,4,0,-6,8,2,0,2,2,0,-5,-3,0,-4,4,0,0,1,1,1,1,1,2,-1
KR_6762432533,440,-1,-60,12,-4,-2,3,1,-1,2,1,0,0,0,2,3,5,-3,5,2,0,0,-134,2,-3,1,1,0,0,0,-1,-1,-1,0,-1
KR_6741545463,420,4,31,9,10,2,1,3,-4,4,0,3,3,6,9,0,9,0,1,1,0,1,6,-1,-1,2,2,0,1,-1,1,1,1,5,-1
KR_6725927434,420,-3,-76,-22,-3,-3,3,0,3,2,5,1,3,4,-3,3,0,-1,2,1,0,-6,36,-1,-5,6,-31,0,0,0,-1,0,1,0,-1
KR_6637497965,420,-2,-50,12,-4,2,1,3,-2,3,1,1,7,8,-3,3,0,-2,2,0,0,-8,-16,-1,-1,2,0,0,-1,0,-1,-1,-1,0,-1
KR_6585776255,420,-5,20,-8,-15,-4,5,1,0,1,1,2,2,4,-13,14,1,0,0,0,0,-14,323,-3,0,3,0,0,0,1,1,-1,-1,2,-1
KR_6684831726,420,5,72,8,12,6,0,6,0,1,1,3,3,6,3,0,3,0,0,0,0,3,-41,1,-3,2,-1,0,2,-1,1,1,1,6,-1
KR_6747361528,420,-1,-37,9,-8,0,1,1,-6,7,1,0,2,2,-2,2,0,0,1,1,0,-6,-48,1,-5,4,14,0,-1,0,-1,-1,-1,0,-1
KR_6743834434,420,0,62,-16,-6,-2,3,1,0,3,3,-2,3,1,-1,2,1,-1,1,0,-1,-7,-199,-7,-1,8,-1,0,0,-1,-1,0,-1,2,-1
KR_6684337807,420,-1,-35,4,-7,-3,3,0,-2,2,0,2,1,3,-1,1,0,-3,3,0,0,-4,3,0,-3,3,-2,0,0,1,-1,-1,-1,4,-1
KR_6723776535,420,-2,-45,-22,-6,-1,3,2,-4,5,1,-3,4,1,0,1,1,2,1,3,0,-6,12,0,-3,3,-1,0,-1,-1,-1,-1,1,6,-1
KR_6725243495,420,-3,-13,-32,-1,-3,3,0,-1,1,0,-1,1,0,3,1,4,1,1,2,0,4,-21,2,-5,3,2,0,0,1,-1,0,-1,2,-1
KR_6757155650,420,-2,36,-31,-2,0,0,0,-1,3,2,0,2,2,0,8,8,-1,1,0,0,-4,6,-1,-3,4,2,0,-1,0,-1,-1,-1,0,-1
KR_6622780544,420,-2,-45,-51,-13,-3,5,2,-8,9,1,-2,5,3,-2,6,4,2,0,2,0,-6,-242,-2,-2,4,-3,0,-2,-1,-1,-1,-1,1,-1
KR_6601793797,420,1,-35,-14,2,2,0,2,2,1,3,-3,3,0,2,0,2,-1,1,0,0,8,-135,0,-4,4,1,0,0,1,1,0,1,2,-1
KR_6611215602,420,0,-9,16,-2,1,1,2,-1,2,1,-1,3,2,0,5,5,-1,2,1,0,-3,-46,-1,-3,4,19,0,0,-1,0,0,1,2,-1
KR_6754195759,420,1,-48,-8,-2,-2,3,1,-1,3,2,1,2,3,1,3,4,-1,3,2,-1,4,-6,-1,-3,4,1,0,-1,1,0,-1,-1,4,-1
KR_6752227979,420,2,49,30,-3,0,2,2,-3,6,3,0,3,3,2,5,7,-2,2,0,0,1,10,-5,-2,7,-5,0,0,1,-1,-1,-1,3,-1
KR_6641827204,420,1,23,8,0,7,1,8,-4,5,1,-2,3,1,0,1,1,-1,1,0,0,-4,-2,-1,-3,4,0,0,1,1,-1,1,1,6,-1
KR_6729248486,420,1,-30,4,5,-2,4,2,-4,4,0,4,0,4,4,1,5,3,3,6,0,-2,-45,1,-6,5,19,0,-1,-1,0,-1,1,6,-1
KR_6733743482,420,-4,-37,-12,-9,2,1,3,-1,1,0,-4,4,0,-4,5,1,-2,2,0,0,-9,5,-1,-3,4,0,0,-3,-1,-1,-1,1,5,-1
KR_6729281711,420,-4,58,-8,-12,1,2,3,-5,5,0,1,1,2,-5,8,3,-4,4,0,-1,-13,-16,-2,-3,5,-4,0,-1,-1,-1,-1,-1,1,-1
KR_6752311826,420,-3,-10,8,-8,-1,4,3,-5,7,2,-2,4,2,1,3,4,-1,1,0,0,-7,-5,0,-3,3,2,0,0,1,0,1,-1,1,-1
KR_6615905005,420,0,-36,-3,-4,0,0,0,0,1,1,-1,5,4,-5,6,1,2,0,2,0,2,-3,2,-2,0,-1,0,-1,1,1,-1,-1,6,-1
KR_6729187897,420,-3,-140,-22,-6,0,4,4,-5,6,1,-4,6,2,3,2,5,0,1,1,-3,-4,-9,-2,-3,5,0,0,-4,-1,-1,-1,-1,6,-1
KR_6757763123,420,-2,-44,-9,-1,-2,2,0,3,0,3,2,1,3,0,2,2,-4,5,1,0,0,2,-1,-2,3,-6,0,1,-1,1,1,-1,5,-1
KR_6596237653,420,-3,-9,5,-11,-9,9,0,-2,2,0,5,1,6,-3,3,0,-2,2,0,0,-11,227,-4,0,4,1,0,-2,-1,-1,-1,-1,5,-1
KR_6635662490,420,-3,-47,12,-6,1,0,1,2,0,2,-3,4,1,-5,5,0,-1,2,1,0,-6,-11,2,-5,3,-1,0,-1,-1,1,-1,1,1,-1
KR_6655258961,420,-2,-9,-4,-6,-1,3,2,2,1,3,-9,9,0,2,0,2,0,0,0,0,-2,-7,-6,0,6,0,0,-1,1,-1,-1,-1,6,-1
KR_6485830749,420,2,-44,32,1,0,0,0,2,0,2,3,3,6,-3,6,3,-1,2,1,1,6,-2,1,-4,3,-5,0,0,-1,-1,0,-1,3,-1
KR_6744866096,420,-3,-7,-28,-5,-2,2,0,-1,1,0,-1,1,0,-2,4,2,1,0,1,0,-3,-13,-5,-2,7,15,0,0,1,-1,-1,-1,1,-1
KR_6746206068,420,3,15,24,4,3,2,5,3,1,4,-1,2,1,0,1,1,-1,2,1,0,-4,9,1,-4,3,1,0,0,1,1,0,1,3,-1
KR_6391487921,420,0,-6,12,-6,-3,3,0,-1,2,1,3,1,4,-2,4,2,-3,4,1,0,-1,-445,1,-7,6,-1,0,-2,-1,1,-1,-1,6,-1
KR_6626651600,420,-5,3,-1,-11,-8,8,0,-4,5,1,1,3,4,1,3,4,-1,1,0,0,-6,-19,-3,-1,4,1,0,-2,1,-1,-1,-1,3,-1
KR_6759910667,420,-2,-72,-20,6,8,0,8,-9,9,0,1,2,3,5,2,7,1,1,2,1,5,1,-1,-6,7,5,0,-1,-1,-1,-1,1,3,-1
KR_6764160628,440,-2,37,21,-7,-2,2,0,-5,8,3,0,2,2,-2,5,3,2,0,2,0,-4,107,-2,-4,6,0,0,0,1,0,0,-1,5,-1
KR_6522500279,420,0,-10,-20,-6,-5,5,0,-2,2,0,-3,4,1,0,1,1,4,0,4,-3,-5,3,-2,-4,6,0,0,0,0,-1,0,-1,0,-1
KR_6721430755,420,-3,-5,4,-5,1,3,4,-3,4,1,1,1,2,-1,2,1,-3,3,0,0,-7,32,3,-6,3,-17,0,0,0,-1,-1,-1,0,-1
KR_6761750376,420,-3,44,8,-7,0,3,3,-3,4,1,-1,4,3,-1,3,2,-2,2,0,1,-14,-4,-6,0,6,3,0,0,-1,1,0,1,5,-1
KR_6742537950,440,-2,-97,5,-3,9,1,10,-5,6,1,-7,8,1,-1,3,2,1,1,2,0,7,3,4,-6,2,-2,0,-1,-1,0,-1,-1,4,-1
KR_6761549443,420,-1,-42,-2,4,4,1,5,1,1,2,-3,3,0,1,3,4,1,1,2,0,3,39,-4,-2,6,-28,0,0,-1,0,0,-1,4,-1
KR_6364470282,420,4,50,4,5,2,0,2,-1,1,0,4,1,5,-1,1,0,1,0,1,0,2,0,0,0,0,0,0,-1,-1,-1,-1,1,4,-1
KR_6729311561,420,1,29,12,-2,2,0,2,-4,4,0,0,5,5,-2,4,2,2,1,3,1,-4,-1,0,-4,4,-2,0,1,1,-1,1,1,5,-1
KR_6759613626,420,-3,-77,-16,-2,-2,4,2,-1,1,0,0,5,5,1,4,5,0,0,0,0,-2,279,3,-4,1,-2,0,-1,-1,-1,-1,-1,1,-1
KR_6626412312,420,0,-55,36,-2,-2,4,2,-3,4,1,-1,3,2,1,2,3,3,0,3,0,3,-3,-2,-3,5,-2,0,0,0,0,0,1,0,-1
KR_6761676507,420,-5,-96,-17,-9,-4,5,1,-2,5,3,-1,1,0,-3,4,1,1,1,2,0,-8,0,-5,-3,8,2,0,-1,-1,-1,-1,-1,2,-1
KR_6642104787,420,-3,-83,0,-5,-2,3,1,-1,6,5,2,0,2,-2,4,2,-2,2,0,-1,-2,-505,1,-1,0,2,0,0,1,1,0,-1,1,-1
KR_6699823743,420,4,38,20,1,5,1,6,-1,3,2,-2,2,0,-2,4,2,1,2,3,-1,-3,-314,-5,-2,7,1,0,2,1,1,1,-1,3,-1
KR_6721944539,420,1,-2,-12,-4,-3,4,1,-4,6,2,0,1,1,4,1,5,-1,1,0,0,0,253,-6,-1,7,1,0,0,-1,1,0,1,5,-1
KR_6757271150,420,-2,-22,4,-3,1,0,1,-3,5,2,-1,3,2,0,3,3,0,2,2,0,-2,-19,2,-4,2,-1,0,-1,0,-1,-1,1,0,-1
KR_6745961341,440,-2,-75,2,-3,-3,4,1,0,2,2,-3,4,1,4,2,6,-1,2,1,0,0,-15,-3,-1,4,3,0,-1,-1,-1,-1,-1,6,-1
KR_6672085669,420,-4,12,0,-5,-2,3,1,-1,3,2,-4,4,0,0,2,2,2,1,3,0,-7,6,3,-6,3,-4,0,-1,1,-1,-1,-1,1,-1
KR_6740307427,420,-1,-2,-8,-1,-4,5,1,0,3,3,5,0,5,-2,5,3,0,0,0,0,0,1,0,-7,7,-7,0,0,1,1,0,-1,5,-1
KR_6661217263,420,-6,-144,-16,-5,-2,3,1,-1,2,1,-2,4,2,1,1,2,-1,1,0,0,7,-19,-3,-1,4,-4,-1,-5,1,-1,-1,-1,5,-1
KR_6577214969,420,-4,32,-43,-13,-5,5,0,-10,17,7,0,4,4,1,1,2,1,1,2,-2,-18,1,-2,-2,4,4,0,-1,1,-1,-1,1,4,-1
KR_6720198774,440,-2,-63,-7,-6,-1,6,5,-5,6,1,4,3,7,-2,3,1,-2,3,1,0,-11,-4,0,-4,4,4,0,0,1,1,-1,-1,5,-1
KR_6702590334,420,-2,9,16,-10,-8,8,0,-5,5,0,3,4,7,-2,5,3,2,0,2,-1,-14,25,-5,0,5,-10,0,-2,-1,0,-1,-1,2,-1
KR_6651453647,420,0,-37,-19,2,2,2,4,2,1,3,-2,3,1,-1,5,4,1,1,2,0,1,-13,-7,0,7,-1,0,-1,1,-1,-1,-1,6,-1
KR_6653719085,420,-4,-57,-36,-1,-2,3,1,0,4,4,1,1,2,-1,3,2,1,1,2,0,0,244,-2,-4,6,-4,0,1,1,-1,-1,-1,3,-1
KR_6630683031,420,-5,-46,11,-20,-4,6,2,0,2,2,-11,12,1,-3,3,0,-2,2,0,0,-14,-190,-3,-3,6,0,0,-1,-1,-1,-1,1,1,-1
KR_6650731880,420,-2,-128,-2,-5,-1,1,0,1,2,3,0,1,1,-1,1,0,-4,4,0,0,-5,-146,-3,0,3,-3,0,-4,1,-1,-1,-1,3,-1
KR_6686548141,420,1,-8,15,-4,-3,3,0,4,0,4,-3,3,0,1,0,1,-3,5,2,0,-4,1,0,-1,1,0,0,0,1,1,0,-1,1,-1
KR_6754259653,420,-8,-111,-52,-13,-9,10,1,-3,5,2,-1,3,2,2,1,3,-2,3,1,-2,-3,-4,-1,-2,3,-1,0,-2,-1,-1,-1,-1,2,-1
KR_6702021268,420,0,64,-1,2,1,3,4,-1,4,3,-1,2,1,0,4,4,3,2,5,1,-2,-9,-1,-5,6,-2,0,0,-1,0,0,1,5,-1
KR_6693510458,420,0,11,20,2,2,3,5,-4,4,0,3,1,4,-2,3,1,3,1,4,0,6,4,1,-2,1,-1,0,0,-1,1,0,1,1,-1
KR_6045072255,420,-4,-2,7,-8,-1,3,2,-2,4,2,-1,2,1,-4,7,3,0,2,2,0,-7,-14,3,-7,4,0,0,-1,-1,1,-1,-1,3,-1
KR_6764267700,440,2,32,10,0,0,2,2,2,2,4,0,3,3,-1,2,1,-1,2,1,-1,-5,-8,0,-7,7,3,0,0,-1,-1,0,-1,5,-1
KR_6742524186,440,1,16,-14,2,-1,3,2,0,2,2,0,3,3,1,2,3,2,0,2,-1,-4,38,3,-4,1,-5,0,1,-1,0,1,-1,2,-1
KR_6636054334,420,-5,-88,-32,-12,-3,4,1,3,3,6,-9,9,0,-2,2,0,-1,1,0,0,-7,5,4,-6,2,-2,0,-1,0,0,-1,-1,0,-1
KR_6758148051,420,1,-24,44,0,-6,6,0,1,1,2,2,2,4,3,3,6,0,2,2,0,1,13,1,-4,3,-2,0,0,1,-1,1,1,6,-1
KR_6762171674,420,-2,-77,0,-3,-7,7,0,1,1,2,3,2,5,-1,1,0,1,1,2,0,-4,3,0,-3,3,0,0,1,1,-1,-1,-1,4,-1
KR_6623748471,420,-8,-84,-3,-13,-2,2,0,-2,2,0,-4,6,2,-2,2,0,-3,3,0,0,-7,-28,-2,-3,5,-1,0,-1,-1,0,-1,-1,3,-1
KR_6638319727,420,1,16,-12,9,1,4,5,1,0,1,0,2,2,7,1,8,0,1,1,2,11,-8,-2,-3,5,1,0,-1,1,-1,-1,1,3,-1
KR_6762978175,420,0,2,17,4,-5,8,3,0,1,1,3,0,3,3,2,5,3,2,5,0,9,-3,1,-3,2,3,0,1,1,-1,1,-1,6,-1
KR_6733666468,420,0,-15,-16,1,-5,5,0,1,1,2,4,2,6,1,0,1,0,0,0,0,10,-135,-1,-5,6,3,0,-1,1,0,-1,-1,5,-1
KR_6731662945,420,-4,-60,0,-8,3,1,4,-1,3,2,-10,12,2,1,1,2,-1,2,1,0,-4,-110,-4,-1,5,1,0,0,-1,0,-1,-1,2,-1
KR_6751924355,440,-6,-93,-42,-8,-3,4,1,0,3,3,-1,2,1,-4,6,2,0,1,1,0,-6,-223,-3,-2,5,-1,0,-4,-1,-1,-1,-1,5,-1
KR_6663380172,420,-4,-38,-47,-5,-2,2,0,2,1,3,-4,5,1,1,1,2,-2,3,1,0,0,0,2,-3,1,3,0,-1,-1,-1,-1,1,4,-1
KR_6709100364,420,-1,21,8,1,0,4,4,2,2,4,-2,2,0,1,0,1,0,0,0,-1,-2,12,1,-3,2,1,0,1,0,1,1,-1,0,-1
KR_6754684181,440,0,-4,-52,-2,-1,3,2,-1,5,4,2,0,2,-1,1,0,-1,1,0,0,-3,-58,0,-5,5,-1,0,-1,0,-1,-1,-1,0,-1
KR_6641538482,420,-3,-80,-6,-9,-5,6,1,-4,7,3,0,4,4,0,2,2,0,0,0,-3,-6,-235,2,-5,3,-6,0,-1,-1,-1,-1,-1,1,-1
KR_6758027900,420,0,-57,-16,6,1,2,3,-1,4,3,2,3,5,5,2,7,-1,2,1,0,-1,-26,4,-4,0,-5,0,-1,-1,0,-1,1,5,-1
KR_6755294269,420,-3,-119,0,-3,2,0,2,-5,6,1,-4,4,0,2,1,3,2,1,3,0,-6,-241,0,-2,2,0,0,0,-1,1,-1,-1,4,-1
KR_6545544151,420,-1,24,-37,-3,0,2,2,-3,6,3,-3,7,4,5,1,6,-2,2,0,0,5,-65,2,-6,4,-1,0,-1,-1,-1,1,-1,3,-1
KR_6758449638,420,-2,9,-12,-2,-2,3,1,-3,3,0,-1,5,4,5,1,6,-1,1,0,0,-5,8,-1,-1,2,0,0,1,-1,0,1,1,2,-1
KR_6639166581,420,-1,-27,20,-3,-6,6,0,-2,3,1,1,3,4,1,0,1,3,1,4,0,1,-45,-6,-1,7,17,0,-1,1,-1,-1,1,4,-1
KR_6647380389,420,3,67,24,9,1,0,1,0,3,3,0,2,2,3,5,8,5,0,5,0,6,2,-3,-1,4,1,0,1,1,1,1,1,4,-1
KR_6742322777,420,-4,-65,24,-7,2,2,4,2,2,4,-1,1,0,-9,9,0,-1,1,0,0,-7,-12,-1,-1,2,4,0,0,0,0,-1,1,0,-1
KR_6764237714,420,0,-86,4,-8,-3,5,2,0,2,2,-2,3,1,-2,2,0,-1,1,0,0,-1,-89,5,-6,1,-1,0,-1,-1,1,-1,-1,6,-1
KR_6753324289,440,-9,-95,-28,-12,-5,6,1,0,1,1,-2,4,2,-5,5,0,0,2,2,0,-3,-7,2,-3,1,-1,0,-2,-1,-1,-1,1,1,-1
KR_6699382961,420,-3,-85,-16,-8,2,0,2,2,1,3,-7,7,0,-4,6,2,-1,3,2,0,-7,-309,-1,-2,3,-3,0,-1,1,1,-1,-1,2,-1
KR_6581742871,420,-4,-60,4,-12,-3,3,0,1,2,3,-4,6,2,-3,5,2,-3,4,1,0,-17,6,0,-2,2,-3,0,-2,-1,0,-1,-1,3,-1
KR_6725635005,420,-4,-20,-29,-9,1,2,3,0,2,2,-5,7,2,-3,4,1,-2,2,0,0,-12,-1,-1,-5,6,1,0,-1,-1,1,-1,-1,2,-1
KR_6625046970,420,-2,-20,-11,-11,0,2,2,-3,5,2,-9,9,0,1,2,3,0,0,0,0,-6,5,4,-4,0,-2,0,0,-1,0,0,-1,3,-1
KR_6749583628,420,3,47,33,2,-1,2,1,2,0,2,3,2,5,-2,2,0,0,1,1,0,3,2,2,-5,3,0,0,0,0,1,1,1,0,-1
KR_6596822066,420,0,-1,5,1,-6,7,1,0,1,1,3,1,4,-1,4,3,5,0,5,0,-2,2,1,-4,3,2,0,1,-1,1,1,1,1,-1
KR_6729266326,420,0,11,-13,5,1,2,3,0,4,4,4,0,4,2,4,6,-2,2,0,-2,-6,-10,-1,-5,6,-2,0,1,1,1,1,1,3,-1
KR_6750771696,420,-5,-64,7,-9,-3,3,0,-6,7,1,-1,2,1,0,2,2,1,2,3,0,-8,-4,0,-3,3,0,0,-1,1,1,-1,-1,1,-1
KR_6741151726,420,2,51,-24,-5,3,0,3,-3,4,1,3,2,5,-6,6,0,-2,2,0,0,-11,-2,-2,-2,4,2,0,1,0,1,1,1,0,-1
KR_6539576272,420,-1,-32,6,1,5,1,6,-1,4,3,-1,3,2,-2,4,2,0,0,0,1,-1,1,2,-6,4,-5,0,0,-1,1,0,1,3,-1
KR_6662756551,420,-1,37,0,-1,2,0,2,0,3,3,-1,2,1,-2,2,0,0,0,0,0,0,-7,-5,-1,6,3,0,0,1,0,0,1,6,-1
KR_6741805257,420,-9,-152,-55,-15,-3,4,1,-2,2,0,-6,12,6,-1,5,4,-3,3,0,0,-2,-9,1,-4,3,-9,0,-4,-1,-1,-1,-1,3,-1
KR_6725242650,420,-3,-54,-3,-2,-4,4,0,0,4,4,1,1,2,0,3,3,1,2,3,0,-2,-7,-3,-1,4,1,0,0,-1,0,-1,1,1,-1
KR_6397058118,420,-1,3,-24,1,0,2,2,5,2,7,0,2,2,-1,4,3,-3,3,0,-1,-6,-9,1,-2,1,3,0,0,0,0,0,-1,0,-1
KR_6753447852,440,-2,-15,0,-2,1,2,3,-5,7,2,-1,2,1,4,3,7,-1,2,1,0,-4,-8,1,-3,2,3,0,-1,-1,-1,1,1,6,-1
KR_6733419857,440,-3,-26,-1,-3,-4,5,1,-1,4,3,-4,6,2,1,0,1,5,0,5,0,3,7,0,-1,1,1,0,0,-1,-1,-1,-1,3,-1
KR_6730481696,420,-2,-14,-49,-2,-2,2,0,3,1,4,-7,7,0,3,1,4,1,0,1,0,6,12,0,-2,2,0,0,0,1,-1,-1,-1,5,-1
KR_6699161115,420,-5,-109,-8,-13,1,0,1,-7,8,1,-6,8,2,-1,4,3,0,1,1,1,-19,161,0,-4,4,-1,0,-2,-1,0,-1,1,2,-1
KR_6621066812,440,2,61,12,-7,0,1,1,2,3,5,0,1,1,-3,4,1,-6,7,1,0,-9,8,-5,-2,7,-4,0,0,-1,0,-1,1,2,-1
KR_6611992310,420,-3,-32,12,-5,-3,4,1,-3,5,2,-4,4,0,4,3,7,1,0,1,2,-6,-15,-1,-3,4,3,0,-1,1,-1,-1,1,1,-1
KR_6568143004,420,-3,13,10,-5,0,2,2,-2,6,4,1,2,3,-3,6,3,-1,3,2,1,-7,2,2,-6,4,-3,0,-2,1,0,-1,1,4,-1
KR_6751412809,420,-2,-81,-1,-5,-3,5,2,-1,3,2,-1,1,0,1,1,2,-1,5,4,0,0,7,-2,-2,4,-3,0,-1,1,-1,-1,-1,4,-1
KR_6759007653,420,-2,37,16,1,-4,7,3,3,2,5,3,1,4,-2,5,3,1,1,2,4,10,-8,0,-2,2,1,0,-1,-1,1,-1,1,4,-1
KR_6653036157,420,2,8,-14,6,3,1,4,3,0,3,1,1,2,-1,1,0,0,0,0,0,9,-1,-1,-2,3,-2,0,3,-1,1,1,1,1,-1
KR_6763215085,420,2,-44,20,-2,0,1,1,2,1,3,-6,6,0,2,0,2,0,0,0,0,7,4,2,-5,3,-2,0,-1,-1,1,-1,-1,3,-1
KR_6750539146,420,-4,-45,16,-8,-4,4,0,2,2,4,0,0,0,-5,5,0,-1,1,0,0,-3,-3,-1,-4,5,1,0,0,0,1,0,-1,0,-1
KR_6634011068,420,-1,8,16,2,-1,1,0,0,0,0,0,2,2,-1,1,0,4,1,5,0,1,-112,0,0,0,1,0,0,-1,-1,1,1,6,-1
KR_6650364452,420,-3,-5,-5,-12,3,1,4,2,1,3,-1,3,2,-12,12,0,-4,4,0,0,-18,19,1,-5,4,-2,0,-1,-1,1,-1,-1,1,-1
KR_6758200346,420,-3,-55,-4,-1,-6,6,0,6,1,7,2,2,4,-7,9,2,4,1,5,1,7,-31,-6,0,6,19,0,-1,1,1,-1,1,2,-1
KR_6642890035,420,-2,-86,28,2,-1,4,3,-1,2,1,-1,1,0,3,3,6,2,1,3,0,3,-42,-1,0,1,21,0,-2,1,-1,-1,1,6,-1
KR_6682534294,420,1,46,-8,4,8,3,11,-8,12,4,3,1,4,-4,9,5,5,0,5,1,1,1,-2,-6,8,1,0,0,-1,-1,1,1,5,-1
KR_6606885692,420,2,50,12,2,4,1,5,6,0,6,-6,6,0,-3,6,3,1,0,1,0,2,89,3,-5,2,-1,0,-1,1,-1,-1,-1,6,-1
KR_6658536883,420,-4,6,-23,-6,-2,2,0,-1,3,2,2,0,2,-5,5,0,0,3,3,0,-7,5,-2,-2,4,-1,0,0,0,0,1,1,0,-1
KR_6729531382,420,-2,-60,-20,-4,-3,4,1,1,1,2,-5,7,2,-1,3,2,4,2,6,-1,1,21,0,-1,1,-2,0,-2,1,0,1,-1,5,-1
KR_6739523895,420,-6,-30,-44,-9,-3,3,0,-4,4,0,-2,3,1,2,1,3,-2,3,1,0,-5,-1,-1,-3,4,-1,0,0,-1,1,-1,-1,6,-1
KR_6732439763,420,3,40,-65,9,-1,1,0,-1,2,1,6,1,7,4,5,9,1,1,2,0,9,0,2,-6,4,-2,0,0,0,-1,1,-1,0,-1
KR_6648103929,420,1,-10,8,-8,-2,3,1,-4,6,2,-1,2,1,0,0,0,-1,1,0,0,-4,-189,2,-3,1,2,0,1,-1,-1,1,-1,3,-1
KR_5719824990,420,-6,-127,-56,-27,-16,17,1,-2,5,3,-5,8,3,-5,5,0,1,1,2,-2,-15,-7,-3,0,3,1,0,-4,-1,-1,-1,-1,5,-1
KR_6622922503,420,-5,-74,-26,-13,-1,4,3,-2,4,2,-5,6,1,-2,3,1,-3,3,0,0,-20,3,1,-4,3,-1,0,-1,1,-1,-1,1,3,-1
KR_6738610013,420,1,83,-16,1,-1,1,0,0,4,4,3,0,3,0,2,2,-1,1,0,0,1,118,4,-7,3,0,0,0,0,-1,0,1,0,-1
KR_6672325994,420,-3,54,-28,-12,-1,1,0,-6,6,0,-4,4,0,1,1,2,-2,2,0,0,-5,67,0,-1,1,9,0,-1,0,-1,-1,-1,0,-1
KR_6203672016,420,-2,-56,0,0,1,1,2,-3,5,2,4,0,4,-1,5,4,-1,1,0,0,-4,-14,-6,-3,9,-3,0,-1,-1,0,-1,-1,2,-1
KR_6689336566,420,2,9,-5,7,7,2,9,1,0,1,0,4,4,0,0,0,-1,1,0,0,2,5,8,-8,0,-3,0,2,-1,0,1,1,3,-1
KR_6701189682,420,-5,-96,-39,-6,1,1,2,-4,6,2,-3,5,2,0,1,1,0,1,1,0,-2,148,-3,-1,4,2,0,-1,0,-1,-1,1,0,-1
KR_6603042608,440,-2,-47,16,-7,2,0,2,0,4,4,-5,5,0,-5,7,2,1,0,1,0,1,-21,-2,-3,5,-2,0,-1,0,-1,-1,-1,0,-1
KR_6739540833,420,-1,-41,-9,-6,-4,4,0,1,1,2,-3,6,3,2,1,3,-2,2,0,0,-1,55,4,-8,4,-25,0,1,-1,-1,-1,-1,3,-1
KR_6735044864,420,-1,-39,-29,0,-2,3,1,2,2,4,3,0,3,-2,4,2,-1,1,0,0,5,0,5,-7,2,1,0,0,-1,0,-1,-1,2,-1
KR_6740951022,440,-2,-12,-4,-1,0,1,1,3,2,5,-1,2,1,-2,2,0,-1,1,0,0,-8,-2,2,-3,1,-1,0,0,-1,1,0,1,5,-1
KR_6673260442,420,-2,-52,-10,6,2,2,4,0,1,1,7,1,8,-1,2,1,-2,3,1,1,6,28,0,-3,3,0,0,-1,0,1,-1,1,0,-1
KR_6610306514,440,-1,-49,16,2,-1,1,0,-1,4,3,1,3,4,4,0,4,-1,1,0,0,3,-12,2,-5,3,-1,0,0,1,-1,0,-1,5,-1
KR_6730070336,420,0,38,8,0,4,0,4,-4,8,4,-3,3,0,1,4,5,2,0,2,0,-5,0,1,-3,2,1,0,1,1,-1,1,1,1,-1
KR_6740650589,420,0,20,-11,0,-3,4,1,2,2,4,2,1,3,-1,6,5,0,2,2,1,4,349,-4,-1,5,1,0,0,1,0,-1,1,2,-1
KR_6645543552,440,-3,-19,-30,-3,-3,4,1,4,1,5,3,1,4,-5,7,2,-2,3,1,0,0,19,1,-3,2,1,0,0,1,-1,-1,-1,1,-1
KR_6636966117,420,-2,-84,-15,-3,-1,3,2,-4,6,2,2,0,2,-1,2,1,1,0,1,-1,1,1,5,-6,1,1,0,0,-1,1,0,-1,1,-1
KR_6762286536,420,-7,-151,-12,-3,-3,3,0,2,0,2,2,4,6,-4,6,2,0,0,0,0,-7,-4,-4,-1,5,0,0,-2,-1,0,-1,-1,2,-1
KR_6722585034,420,-3,-65,-6,-2,2,2,4,2,4,6,-2,2,0,-3,4,1,-1,1,0,0,-1,-274,7,-11,4,-3,0,0,-1,-1,0,-1,5,-1
KR_6739540041,420,-5,-52,-13,-9,-3,5,2,-1,2,1,2,3,5,-6,7,1,-1,2,1,1,4,-14,-1,-2,3,-2,0,-1,-1,1,-1,1,5,-1
KR_6750458487,420,-5,-135,-16,-9,-5,5,0,-4,4,0,-2,3,1,2,0,2,0,0,0,0,-6,-2,0,-4,4,0,0,-2,-1,-1,-1,-1,5,-1
KR_6762975216,420,-1,3,-27,-4,-3,4,1,0,1,1,-1,2,1,0,0,0,0,0,0,0,-3,4,2,-3,1,0,0,-1,0,0,-1,-1,0,-1
KR_6648000201,420,1,-5,52,4,0,1,1,3,3,6,3,0,3,-4,5,1,2,0,2,0,-3,-29,0,-3,3,1,0,-1,0,-1,-1,-1,0,-1
KR_6097452329,420,-4,-4,0,-6,-2,4,2,10,0,10,-9,9,0,-3,4,1,-2,2,0,0,-7,-16,1,-2,1,1,0,-2,-1,1,-1,-1,5,-1
KR_6738224997,420,-3,-30,3,-10,-4,5,1,-6,9,3,0,0,0,-2,3,1,2,0,2,0,-14,-8,-2,-3,5,-1,0,0,-1,-1,0,-1,5,-1
KR_6638258431,420,-3,-10,9,-7,-1,2,1,-2,3,1,-1,2,1,-1,4,3,-2,2,0,0,-8,10,0,-7,7,-8,0,-1,-1,-1,-1,1,1,-1
KR_6764556151,420,-1,-26,-7,-4,-1,2,1,-3,3,0,-1,1,0,0,1,1,1,1,2,0,-3,-9,0,-3,3,3,0,-1,-1,-1,-1,1,3,-1
KR_6735093248,420,-5,-113,-16,-14,-2,5,3,-2,4,2,-9,13,4,-1,2,1,0,0,0,0,-7,-6,-3,-5,8,-3,0,-2,-1,-1,-1,-1,6,-1
KR_6086299194,420,-4,-30,14,-7,-6,6,0,5,2,7,-1,4,3,-5,7,2,0,1,1,-1,-5,5,-2,-5,7,-3,0,-1,0,-1,-1,-1,0,-1
KR_6754210595,420,-1,6,20,-6,-1,1,0,-2,7,5,-1,3,2,-4,8,4,2,1,3,0,-12,-9,-1,-3,4,-2,0,-1,-1,1,-1,-1,5,-1
KR_6503798197,420,0,-48,0,-12,1,0,1,-9,9,0,-4,5,1,0,5,5,0,1,1,-1,-12,42,-7,-2,9,-26,0,-3,1,-1,-1,-1,2,-1
KR_6666106646,420,2,26,18,4,4,2,6,-3,6,3,-2,4,2,3,0,3,2,0,2,0,4,18,1,-3,2,1,0,1,1,-1,1,-1,4,-1
KR_6715711774,440,2,-1,17,-3,1,1,2,-2,3,1,-4,7,3,-2,5,3,4,1,5,0,0,0,-2,-2,4,2,0,1,1,-1,1,-1,6,-1
KR_6744120189,440,-4,-31,10,-11,0,0,0,-5,5,0,-2,2,0,-4,6,2,0,2,2,0,-13,-128,0,-4,4,0,0,-1,1,1,-1,-1,5,-1
KR_6693259031,420,-5,-58,-12,-13,-5,5,0,2,0,2,-3,3,0,-3,3,0,-4,4,0,0,-10,-16,-7,0,7,4,0,-1,0,-1,-1,-1,0,-1
KR_6745636160,420,1,52,-34,-3,-5,5,0,-3,3,0,1,2,3,1,3,4,3,0,3,0,-3,-132,2,-3,1,1,0,1,1,-1,1,-1,6,-1
KR_6753067741,420,-5,-34,-52,-3,-1,3,2,-5,5,0,5,2,7,-2,3,1,0,1,1,0,-11,-15,5,-5,0,-1,0,0,1,1,0,-1,2,-1
KR_6760592819,420,-1,-37,23,-7,-1,5,4,1,2,3,-6,6,0,-1,2,1,0,0,0,0,-4,1,0,-2,2,2,0,-1,0,-1,-1,-1,0,-1
KR_6738663710,420,0,-25,-25,-2,-3,3,0,2,1,3,4,1,5,-6,7,1,1,0,1,0,0,-1,0,-4,4,0,0,-1,-1,-1,-1,-1,2,-1
KR_6739495552,440,-3,-93,-28,-9,0,0,0,-3,4,1,-2,3,1,-3,3,0,-1,1,0,0,-7,-13,-2,-3,5,0,0,-2,0,-1,-1,-1,0,-1
KR_6719658182,420,-7,-68,-20,-13,-4,5,1,1,2,3,-5,7,2,-4,6,2,-1,2,1,-2,-9,-12,-1,-1,2,2,0,-3,-1,-1,-1,-1,5,-1
KR_6758395627,420,-1,-35,-22,7,-4,4,0,-1,2,1,0,4,4,9,2,11,3,0,3,1,19,-93,4,-6,2,3,0,-2,-1,0,-1,1,1,-1
KR_6638385090,420,-4,-103,-14,-14,-6,9,3,0,1,1,0,2,2,-6,6,0,-2,2,0,-1,-16,-3,-4,-1,5,2,0,-3,-1,-1,-1,-1,4,-1
KR_6656786054,420,-2,-17,9,-11,-2,2,0,-2,7,5,-8,10,2,2,1,3,-1,3,2,-3,-5,-16,0,-1,1,1,0,-2,-1,-1,-1,-1,6,-1
KR_6762311517,420,-1,88,-36,1,1,2,3,6,2,8,-4,5,1,0,1,1,-2,2,0,1,6,-238,3,-3,0,-5,0,0,0,-1,1,1,0,-1
KR_6671124346,420,-4,-30,12,-2,-2,3,1,2,1,3,1,1,2,-2,6,4,-1,2,1,2,2,9,2,-6,4,-2,0,-1,1,-1,-1,1,6,-1
KR_6756291282,420,0,65,6,3,5,1,6,-4,4,0,4,1,5,-1,3,2,-1,1,0,0,-11,-15,1,-3,2,5,0,-1,-1,1,-1,1,6,-1
KR_6648376604,420,-3,-69,16,-8,-1,1,0,-2,3,1,-5,6,1,0,3,3,0,0,0,0,1,-2,-1,-3,4,-2,0,0,0,-1,0,-1,0,-1
KR_6565872212,420,2,51,20,-1,2,0,2,5,2,7,-3,3,0,-3,5,2,-2,2,0,0,-4,-14,-1,-2,3,4,0,0,-1,-1,-1,1,1,-1
KR_6632217819,420,-1,37,-4,0,3,1,4,0,2,2,-2,4,2,-1,2,1,0,1,1,0,-3,-10,-3,0,3,1,0,1,-1,0,1,1,5,-1
KR_6537660664,420,-3,-26,-6,-6,1,2,3,-3,4,1,-10,12,2,5,1,6,1,1,2,0,-4,348,2,-3,1,2,0,0,1,-1,1,1,6,-1
KR_6762930045,420,-7,-44,15,-18,-1,4,3,-2,3,1,-3,6,3,-10,10,0,-2,2,0,-2,-19,1,3,-5,2,-4,0,-1,-1,-1,-1,-1,3,-1
KR_6629973083,420,0,-100,37,-2,-7,7,0,-10,11,1,5,2,7,4,5,9,6,1,7,0,-6,-39,-2,-1,3,18,0,-1,1,-1,-1,-1,5,-1
KR_6729818789,420,-1,-47,-36,-3,-3,5,2,0,2,2,0,2,2,1,0,1,-1,1,0,0,-5,-68,-1,-3,4,-16,0,-2,-1,-1,-1,-1,1,-1
KR_6609194906,420,-7,-16,-14,-17,-2,2,0,-5,5,0,-1,2,1,-6,6,0,-3,3,0,0,-21,9,-2,-2,4,-4,0,-3,-1,-1,-1,-1,3,-1
KR_6689238426,420,3,114,34,9,2,1,3,4,1,5,9,2,11,-4,4,0,-2,2,0,0,-5,12,-1,-2,3,3,0,3,1,1,1,1,3,-1
KR_6653591275,420,-1,-20,-4,-7,-3,3,0,-1,4,3,-4,5,1,0,1,1,1,2,3,-1,-3,9,-4,-1,5,-3,0,0,-1,-1,0,-1,6,-1
KR_6764592418,440,1,24,4,-3,-1,1,0,-2,4,2,2,1,3,-1,2,1,-1,1,0,0,-7,5,2,-4,2,-3,0,1,-1,1,1,-1,1,-1
KR_6636012254,440,-5,-130,-7,-18,-4,4,0,-3,5,2,-2,5,3,-9,10,1,0,2,2,-1,-24,5,-1,0,1,0,0,-1,-1,0,-1,-1,3,-1
KR_6759000297,420,-2,-28,-12,-9,-1,2,1,-7,7,0,-2,2,0,2,3,5,-1,1,0,0,-12,9,4,-7,3,-5,0,0,-1,1,1,-1,5,-1
KR_6724417162,440,-4,-56,-26,-11,-1,5,4,-5,6,1,2,1,3,-6,7,1,-1,2,1,0,-6,182,-1,-2,3,1,0,-2,-1,1,-1,1,5,-1
KR_6717118752,420,2,79,-8,6,-3,5,2,5,0,5,-1,3,2,5,2,7,0,3,3,-1,7,-11,-2,-1,3,2,0,0,1,-1,0,-1,5,-1
KR_6725482258,440,-3,-40,16,-11,-2,3,1,3,1,4,-2,3,1,-7,8,1,-3,3,0,-1,-17,-60,0,-6,6,27,0,-2,-1,-1,-1,-1,1,-1
KR_6757905586,420,1,7,20,-4,-3,3,0,-1,2,1,0,3,3,-1,2,1,1,1,2,0,-6,6,1,-3,2,4,0,-1,1,-1,1,1,1,-1
KR_6651599675,420,-3,-16,14,-3,0,2,2,0,4,4,-5,5,0,3,3,6,-1,2,1,0,-3,-31,-1,-5,6,4,0,0,1,-1,0,-1,5,-1
KR_6731955638,420,-5,-93,-8,-11,-7,7,0,-2,4,2,2,1,3,-4,5,1,0,2,2,0,-8,9,1,-3,2,-2,0,-2,-1,-1,-1,-1,4,-1
KR_6737524331,440,2,55,7,3,-4,4,0,-1,1,0,4,4,8,5,0,5,-1,3,2,-1,-8,-3,-2,-2,4,2,0,1,0,-1,1,-1,0,-1
KR_6731758354,420,2,58,-12,-4,-1,2,1,-3,5,2,1,1,2,0,1,1,-1,2,1,0,-1,5,2,-2,0,1,0,1,1,-1,1,-1,3,-1
KR_6576694705,420,0,35,-11,-2,-1,2,1,-2,5,3,-2,4,2,3,0,3,0,1,1,0,3,1,2,-3,1,1,0,0,1,1,-1,1,6,-1
KR_6630310913,420,0,-24,16,-3,-3,4,1,2,3,5,0,2,2,-1,4,3,-1,1,0,-1,-5,1,4,-5,1,0,0,0,-1,1,1,-1,4,-1
KR_6640944636,420,1,25,-48,1,3,0,3,-1,5,4,2,5,7,-2,3,1,-1,2,1,0,2,2,2,-3,1,-1,0,1,-1,-1,1,-1,3,-1
KR_6732243489,420,-1,-34,0,-2,-4,4,0,-2,2,0,4,0,4,-1,2,1,1,1,2,0,5,-2,-4,-3,7,-3,0,-1,1,-1,-1,1,3,-1
KR_6646338718,420,-1,-3,-2,-2,1,2,3,3,2,5,1,3,4,-8,9,1,1,0,1,0,-1,-1,1,-4,3,-3,0,-1,-1,-1,1,1,6,-1
KR_6594390455,420,-4,-50,-21,-19,-2,3,1,-5,9,4,-6,13,7,-7,8,1,1,0,1,-1,-6,34,-1,-2,3,-7,0,0,0,-1,-1,-1,0,-1
KR_6760643501,420,-1,-39,-16,-2,1,3,4,2,3,5,-2,3,1,-3,6,3,0,0,0,-2,-7,1,5,-7,2,0,0,-1,1,1,-1,-1,2,-1
KR_6635991565,420,-1,-20,-19,-10,-2,3,1,-1,3,2,-9,10,1,1,2,3,1,0,1,0,1,-26,-1,-1,2,-1,0,-1,-1,-1,-1,-1,6,-1
KR_6724009321,440,-2,-77,-21,2,-3,3,0,5,0,5,-2,6,4,1,1,2,1,1,2,0,7,-14,0,-3,3,1,0,0,0,1,0,1,0,-1
KR_6727053971,420,0,-20,-12,-4,-2,2,0,-1,2,1,-4,4,0,1,1,2,2,0,2,0,1,40,-4,0,4,-18,0,-1,-1,-1,-1,1,5,-1
KR_6626604495,420,-3,-35,3,-7,-5,5,0,4,1,5,-2,5,3,-3,4,1,-1,1,0,0,-7,10,2,-2,0,0,0,-1,-1,0,1,1,4,-1
KR_6614978668,420,3,77,-1,5,5,3,8,1,1,2,-3,6,3,1,1,2,1,0,1,-1,5,12,-1,-2,3,4,0,0,1,-1,0,-1,3,-1
KR_6703491766,440,0,-43,-6,-4,2,2,4,-4,4,0,0,2,2,0,2,2,-2,2,0,0,0,24,-3,-2,5,-2,0,0,-1,-1,0,1,1,-1
KR_6742599688,420,-3,-30,3,-9,-1,2,1,-12,13,1,3,1,4,0,1,1,1,0,1,-1,-17,84,-2,-3,5,2,0,-3,-1,-1,-1,-1,2,-1
KR_6596825472,420,2,33,-16,5,0,1,1,2,0,2,2,0,2,-1,2,1,2,1,3,0,7,8,-1,-3,4,-1,0,0,-1,-1,0,-1,5,-1
KR_6764435083,440,1,-10,15,-3,2,1,3,0,0,0,-7,7,0,2,1,3,0,0,0,1,-4,14,0,-3,3,-4,0,-1,-1,1,-1,1,1,-1
KR_6645635397,420,-2,-28,5,-4,0,0,0,1,3,4,0,1,1,-5,5,0,0,2,2,0,-3,-169,-1,-5,6,30,0,-1,-1,0,-1,1,1,-1
KR_6759175161,420,1,15,9,-4,-2,3,1,0,1,1,-2,3,1,-1,3,2,1,0,1,0,-8,4,2,-3,1,0,0,0,0,1,0,-1,0,-1
KR_6589161342,420,-1,-21,-28,2,5,0,5,0,2,2,-1,2,1,-2,2,0,0,0,0,0,0,28,-3,-2,5,-14,0,0,1,-1,0,-1,5,-1
KR_6750799083,420,-2,-7,-4,-5,1,1,2,-7,7,0,0,2,2,0,0,0,1,0,1,0,-7,-112,3,-4,1,-6,0,0,-1,1,0,1,2,-1
KR_6659574285,420,-3,-2,-28,-1,-2,2,0,7,2,9,-3,4,1,-2,5,3,-1,1,0,0,3,12,1,-2,1,-2,0,-1,-1,-1,-1,-1,1,-1
KR_6757614149,420,-2,-35,-13,3,-3,4,1,1,2,3,5,2,7,-3,7,4,3,1,4,0,0,312,-2,-3,5,-2,0,-2,-1,-1,-1,1,1,-1
KR_6720438354,420,-3,-34,-24,0,4,0,4,-3,3,0,2,1,3,-3,4,1,0,1,1,0,-6,-55,-6,-1,7,28,0,-1,-1,-1,-1,-1,5,-1
KR_6646168554,420,-4,-74,-16,-4,-4,5,1,2,4,6,-3,3,0,2,2,4,-1,5,4,0,0,202,2,-3,1,-1,0,-2,-1,-1,-1,-1,5,-1
KR_6709224599,420,3,33,-8,4,2,0,2,6,2,8,-2,3,1,-1,5,4,-1,1,0,2,3,8,-2,-2,4,-5,0,1,-1,1,1,1,6,-1
KR_6739581619,420,-1,24,11,-1,-2,3,1,1,1,2,2,3,5,-2,2,0,0,0,0,0,-4,-42,2,-5,3,27,0,0,-1,1,0,-1,2,-1
KR_6639297033,420,1,52,16,2,-4,4,0,0,4,4,2,3,5,1,1,2,3,1,4,-1,-3,9,-1,-3,4,-5,0,0,-1,-1,-1,-1,6,-1
KR_6361565833,420,1,-13,48,-1,-4,5,1,1,1,2,0,1,1,1,0,1,1,0,1,0,4,0,0,0,0,-5,0,0,1,-1,-1,-1,3,-1
KR_6384224221,420,-1,4,-11,0,-1,2,1,2,3,5,1,2,3,-1,1,0,-1,1,0,0,-1,-13,2,-4,2,-1,0,-1,-1,0,-1,1,5,-1
KR_6625449189,420,-1,-24,7,-5,-3,3,0,1,2,3,-2,4,2,1,2,3,-2,2,0,0,-1,-10,-5,-1,6,3,0,-1,-1,1,-1,1,4,-1
KR_6650279024,420,-3,-124,51,-2,-5,5,0,4,2,6,1,3,4,-1,3,2,-1,1,0,0,3,-474,-1,-1,2,-1,0,-2,-1,-1,-1,1,6,-1
KR_6761217827,420,0,-71,1,9,0,1,1,1,1,2,0,0,0,7,0,7,1,1,2,0,10,-6,-1,-1,2,2,0,0,1,-1,0,1,1,-1
KR_6737980763,420,-2,-17,-24,4,-2,2,0,0,2,2,2,0,2,1,6,7,3,2,5,2,9,-3,0,-4,4,2,0,-1,1,-1,-1,-1,6,-1
KR_6739236690,420,0,-58,48,-4,-1,2,1,1,1,2,-3,8,5,-4,5,1,3,0,3,-1,2,-199,0,0,0,1,0,0,-1,1,0,-1,4,-1
KR_6608975362,420,-3,-48,-4,-10,-5,5,0,-5,6,1,-2,4,2,1,2,3,1,0,1,0,-5,-21,-3,-3,6,0,0,-3,-1,-1,-1,-1,6,-1
KR_6613441091,420,2,25,4,8,3,1,4,3,1,4,1,1,2,0,3,3,1,1,2,0,9,4,1,-5,4,0,0,0,0,1,1,1,0,-1
KR_6448899621,420,-1,-49,-7,-4,-1,2,1,-2,4,2,0,2,2,-1,4,3,0,1,1,0,0,-13,-3,-4,7,-1,0,-1,-1,-1,-1,1,2,-1
KR_6717098967,420,-2,-41,-21,3,-1,2,1,-4,8,4,2,1,3,4,1,5,2,1,3,0,10,11,-3,-3,6,-1,0,0,-1,-1,0,1,3,-1
KR_6140664648,420,-1,-79,11,-9,1,2,3,-3,4,1,1,3,4,-7,7,0,-1,1,0,0,-19,2,1,-6,5,-2,0,-2,-1,-1,-1,1,4,-1
KR_6722861838,420,0,-68,8,-6,2,1,3,0,2,2,-1,4,3,-6,8,2,-1,1,0,-1,-9,-4,2,-2,0,-1,0,-3,0,-1,-1,-1,0,-1
KR_6735948407,440,-5,-59,-15,-9,-2,2,0,1,1,2,-2,2,0,-9,9,0,3,1,4,0,-4,-8,-2,-3,5,2,0,-1,-1,1,-1,1,1,-1
KR_6649338255,420,1,33,31,-3,-2,2,0,1,1,2,1,1,2,-3,3,0,0,1,1,0,-2,3,-5,-1,6,-2,0,0,0,1,0,1,0,-1
KR_6640312484,420,-10,-29,-76,-9,3,0,3,-3,3,0,-9,9,0,0,2,2,0,2,2,0,-9,-10,-5,0,5,-1,0,-2,-1,-1,-1,-1,3,-1
KR_6650342211,420,-3,-13,-11,-9,-2,2,0,-2,4,2,-5,6,1,0,1,1,0,0,0,0,-7,-127,-2,-1,3,-1,0,-1,-1,-1,-1,-1,2,-1
KR_6473455998,420,4,8,29,6,12,1,13,-5,6,1,2,1,3,-1,7,6,-2,2,0,-1,-4,0,-4,-2,6,0,0,1,1,1,1,-1,3,-1
KR_6632234256,420,2,12,61,-4,1,0,1,2,0,2,1,1,2,-6,7,1,-2,4,2,1,-6,5,0,-2,2,-1,0,-1,1,1,-1,1,6,-1
KR_6757441533,420,-3,29,24,-10,-3,3,0,-3,6,3,-6,6,0,4,1,5,-2,2,0,-2,-11,-6,-1,-2,3,4,0,1,-1,1,1,-1,6,-1
KR_6756056343,420,-5,-37,-20,-5,-5,5,0,3,0,3,-4,5,1,0,7,7,1,0,1,1,0,-1,-1,-3,4,0,0,-1,1,0,-1,1,3,-1
KR_6667215666,440,-5,-40,-40,-11,0,4,4,-4,5,1,-6,7,1,-4,5,1,3,1,4,0,-12,14,2,-2,0,-1,0,-3,-1,-1,-1,-1,4,-1
KR_6649926185,420,-5,-54,-17,-12,-2,3,1,-1,2,1,-7,7,0,-3,5,2,1,0,1,0,-19,-1,1,-6,5,0,0,0,-1,-1,0,-1,5,-1
KR_6638614350,420,-3,-68,-15,0,2,1,3,-4,5,1,0,1,1,1,1,2,1,0,1,0,2,-1,-1,-1,2,0,0,-1,-1,0,-1,1,5,-1
KR_6762236153,420,-3,-28,-5,0,2,3,5,1,0,1,-3,4,1,1,1,2,-1,1,0,2,-4,4,-1,-1,2,-4,0,0,-1,-1,-1,1,2,-1
KR_6741068610,420,-3,-102,-7,-4,-2,4,2,1,2,3,-2,3,1,-3,4,1,2,3,5,0,0,-9,4,-5,1,-5,0,-3,0,-1,-1,1,0,-1
KR_6764398186,440,2,56,-4,1,1,3,4,-4,4,0,3,0,3,1,1,2,0,0,0,1,-4,-4,0,-3,3,1,0,0,1,0,1,1,4,-1
KR_6618269538,440,-4,32,-24,-10,0,2,2,-5,6,1,-4,5,1,-5,6,1,4,0,4,0,-15,-53,2,-4,2,-1,0,0,-1,-1,-1,-1,4,-1
KR_6617242645,420,-1,4,-14,-7,-2,2,0,-4,5,1,2,0,2,-2,3,1,-1,1,0,0,-4,-96,-3,-1,4,0,0,0,-1,-1,-1,-1,1,-1
KR_6716766619,420,3,26,8,7,2,0,2,2,0,2,-2,3,1,3,2,5,2,3,5,1,11,-3,1,-2,1,1,0,-1,1,-1,-1,1,4,-1
KR_6618648114,420,0,-64,-4,0,0,1,1,2,0,2,-4,5,1,2,2,4,0,1,1,0,4,-8,-3,-2,5,-3,0,0,-1,1,0,-1,4,-1
KR_6762983580,420,1,-3,18,-1,4,0,4,-2,3,1,-2,2,0,-1,5,4,0,1,1,0,-3,273,-3,-4,7,-2,0,0,1,1,0,-1,2,-1
KR_6673774892,420,-1,-41,-44,-4,3,0,3,-5,6,1,-1,3,2,0,2,2,-1,1,0,0,-10,-240,3,-4,1,-1,0,-1,-1,-1,-1,-1,4,-1
KR_6689172989,420,-3,-48,-18,-10,1,2,3,-4,5,1,0,2,2,-2,4,2,-5,6,1,0,-9,-52,0,-4,4,22,0,0,1,1,1,1,4,-1
KR_6581500118,420,3,38,-53,5,1,2,3,-5,8,3,-1,2,1,7,1,8,3,0,3,0,7,-10,0,-4,4,1,0,0,-1,-1,1,1,2,-1
KR_6662642547,420,-3,16,-17,-9,3,1,4,-2,3,1,-2,4,2,-4,5,1,-4,5,1,-1,-12,-18,5,-8,3,31,0,0,-1,-1,0,-1,3,-1
KR_6735353222,420,-5,-12,-28,-8,-4,5,1,2,2,4,3,2,5,-6,6,0,-3,3,0,2,-5,-5,-2,-1,3,0,0,0,-1,1,0,1,2,-1
KR_6701730860,420,-3,-40,-10,-4,0,2,2,-3,5,2,-1,5,4,-2,3,1,2,0,2,0,-2,-12,-5,0,5,2,0,-1,-1,1,-1,1,6,-1
KR_6654980690,420,-6,-37,-60,-13,-1,1,0,-6,6,0,-4,4,0,-3,7,4,1,0,1,0,-14,-5,-3,-4,7,2,0,-1,-1,-1,-1,1,5,-1
KR_6762311637,440,3,8,20,4,-5,6,1,2,2,4,5,3,8,0,4,4,2,0,2,0,1,3,4,-5,1,2,0,0,1,1,-1,-1,5,-1
KR_6727163303,440,-2,-118,16,-7,-3,3,0,0,1,1,2,2,4,-4,5,1,-2,2,0,-1,-8,-4,2,-2,0,-3,0,-1,1,0,-1,-1,4,-1
KR_6758618984,420,-1,-70,13,2,0,2,2,0,2,2,1,2,3,2,2,4,-1,1,0,0,6,-15,3,-4,1,0,0,0,-1,1,0,-1,2,-1
KR_6760511822,420,-5,-36,-23,-11,-6,8,2,-2,2,0,-4,5,1,3,3,6,-2,2,0,0,-4,190,0,-2,2,0,0,-2,-1,0,-1,-1,6,-1
KR_6757849243,420,-1,-4,-3,-6,-1,2,1,-5,5,0,-3,6,3,1,2,3,2,0,2,0,-6,-2,-3,-3,6,3,0,-1,-1,-1,-1,-1,4,-1
KR_6537790940,420,-2,-60,-8,-4,5,1,6,0,4,4,-2,2,0,-5,7,2,-2,2,0,0,-4,-263,0,-2,2,-2,0,0,1,1,-1,-1,5,-1
KR_6693041956,420,0,5,0,-6,5,1,6,-2,4,2,2,1,3,-5,6,1,-6,8,2,-2,-14,-20,4,-5,1,-1,0,-1,-1,1,1,-1,2,-1
KR_6627786937,420,-10,-121,-12,-15,-7,8,1,-3,4,1,-2,3,1,-3,3,0,0,1,1,-1,-13,-190,-4,-1,5,-2,0,-3,1,-1,-1,-1,5,-1
KR_6651948335,420,-1,-49,-15,0,-6,6,0,2,3,5,-1,4,3,5,1,6,0,1,1,0,-3,-6,0,-3,3,4,0,-1,-1,-1,-1,-1,1,-1
KR_6753390558,420,-6,-108,-40,-12,-1,1,0,0,0,0,-7,8,1,-3,3,0,-1,1,0,0,-10,14,-2,0,2,-3,0,0,-1,0,0,-1,5,-1
KR_6693488290,420,-2,-117,-44,1,1,3,4,0,2,2,-2,3,1,3,0,3,-1,2,1,-1,9,-8,1,-4,3,-1,0,0,-1,-1,-1,-1,6,-1
KR_6749207882,440,-1,-100,-1,0,0,0,0,0,2,2,0,3,3,0,2,2,0,0,0,1,1,-49,-2,-2,4,43,0,0,-1,1,-1,1,4,-1
KR_6596402305,420,-2,-108,-27,-4,2,3,5,1,3,4,-2,2,0,-3,4,1,-2,3,1,0,0,-510,-3,-2,5,-3,0,1,-1,-1,-1,1,4,-1
KR_6764002658,420,0,0,24,1,5,0,5,-1,3,2,1,1,2,-4,5,1,0,0,0,0,-5,-114,-5,-1,6,-1,0,-1,-1,0,-1,1,2,-1
KR_6695065995,420,-4,-79,4,-13,-6,8,2,-4,5,1,-5,5,0,-4,5,1,6,1,7,-1,-7,9,0,-2,2,-1,0,-2,-1,-1,-1,-1,6,-1
KR_6615331237,420,-3,-22,-24,-16,-1,1,0,-5,9,4,-3,3,0,-6,6,0,-1,1,0,0,-19,-11,1,-4,3,-2,0,-1,-1,-1,-1,-1,4,-1
KR_6238317912,420,-2,-14,20,-5,0,0,0,-3,5,2,-2,3,1,-3,4,1,3,0,3,0,-4,-1,-1,-3,4,1,0,0,1,0,0,-1,5,-1
KR_6743941976,420,1,26,2,-1,1,1,2,2,2,4,-2,6,4,-1,2,1,-1,1,0,0,-6,-4,-4,-2,6,1,0,-1,-1,-1,-1,1,4,-1
KR_6647802873,420,-5,-65,-20,-13,-6,6,0,-1,2,1,-3,4,1,-1,2,1,-2,3,1,0,-11,-251,-1,-2,3,-3,0,-1,-1,-1,-1,1,1,-1
KR_6749119359,420,-1,-18,4,-8,0,2,2,2,0,2,-2,3,1,-5,5,0,-3,3,0,0,-7,-4,3,-3,0,1,0,0,1,0,-1,1,3,-1
KR_6084800783,420,-1,-38,-12,-3,-2,3,1,-1,1,0,-3,6,3,1,1,2,2,0,2,0,6,-176,-1,-1,2,-1,0,0,0,-1,-1,-1,0,-1
KR_6724222148,420,-1,-36,-4,-5,0,3,3,1,1,2,-5,6,1,-1,3,2,0,0,0,0,-2,324,-3,-1,4,-1,0,0,-1,-1,0,-1,4,-1
KR_6755247427,420,-3,-59,-12,-4,-3,3,0,-8,9,1,2,3,5,3,2,5,2,0,2,0,-6,249,0,-1,1,-1,0,-1,1,-1,-1,-1,6,-1
KR_6715468435,440,-7,-92,-8,-18,0,3,3,-8,10,2,0,6,6,-4,4,0,-6,7,1,-2,-4,8,-3,-1,4,-3,0,-3,-1,0,-1,-1,6,-1
KR_6491763053,420,-2,-51,-16,-5,-4,4,0,-3,6,3,4,2,6,0,5,5,-2,2,0,0,-5,1,-5,-3,8,0,0,-1,-1,-1,-1,1,5,-1
KR_6653022264,420,-1,-22,14,-5,-2,3,1,1,0,1,-1,2,1,0,0,0,-3,4,1,0,-3,-2,0,0,0,1,0,-1,-1,-1,-1,1,2,-1
KR_6743680552,420,-3,-51,-26,4,1,0,1,0,1,1,5,0,5,-1,2,1,-1,4,3,0,3,35,4,-4,0,0,0,-2,1,-1,-1,1,6,-1
KR_6707558260,420,-6,-124,-3,-16,-6,6,0,-2,2,0,-4,4,0,-5,6,1,1,0,1,0,-13,3,-4,-2,6,2,0,-2,-1,-1,-1,-1,1,-1
KR_6636102790,440,-1,4,-8,-6,-1,3,2,0,7,7,0,1,1,0,0,0,-5,5,0,0,-6,-3,-1,-1,2,-1,0,0,1,0,0,1,4,-1
KR_6726912981,420,-2,-58,-28,-1,-2,2,0,5,1,6,-3,3,0,1,0,1,-2,2,0,0,1,2,-2,-1,3,3,0,0,0,1,0,-1,0,-1
KR_6615847622,420,0,51,8,-4,-2,3,1,-3,5,2,-1,5,4,1,1,2,1,0,1,0,-7,-13,2,-7,5,2,0,0,-1,0,0,-1,3,-1
KR_6616835074,420,1,75,4,6,2,1,3,1,0,1,-1,1,0,4,0,4,0,0,0,0,5,3,0,-4,4,0,0,1,1,-1,1,1,2,-1
KR_6759275340,420,-1,-94,8,0,-3,3,0,0,3,3,2,3,5,1,4,5,0,0,0,0,5,29,1,-5,4,-1,0,0,1,1,-1,1,5,-1
KR_6730687665,420,3,41,3,10,-1,2,1,1,1,2,4,1,5,3,2,5,3,0,3,0,10,-18,3,-5,2,3,0,0,-1,-1,-1,1,1,-1
KR_6607435725,420,-2,-122,-9,-8,-9,9,0,-5,8,3,1,0,1,0,5,5,5,0,5,0,-4,379,-2,-2,4,-2,0,-1,-1,1,-1,1,1,-1
KR_6731804559,420,1,79,0,1,1,0,1,-1,3,2,5,0,5,-3,5,2,-1,2,1,0,0,-5,-2,-2,4,2,0,0,-1,-1,-1,1,1,-1
KR_6624542773,420,-6,-71,-9,-10,-6,7,1,-3,3,0,-2,2,0,0,1,1,1,0,1,0,-7,-8,-5,-1,6,0,0,-3,-1,-1,-1,-1,1,-1
KR_6712703743,440,2,-42,13,2,-2,3,1,-1,4,3,1,1,2,2,0,2,2,1,3,0,6,-1,1,-3,2,1,0,-1,1,-1,-1,-1,4,-1
KR_6738294854,440,0,-7,4,-5,1,0,1,-1,3,2,2,0,2,-8,9,1,1,0,1,0,-3,-9,-3,-4,7,3,0,-1,-1,1,-1,-1,3,-1
KR_6690329452,420,-2,11,-36,-3,-1,3,2,5,0,5,-4,6,2,-4,6,2,1,2,3,0,-1,-6,-2,-2,4,0,0,-1,-1,-1,-1,-1,2,-1
KR_6732865599,420,-9,-131,-3,-20,-2,3,1,-3,5,2,4,0,4,-13,14,1,-6,6,0,0,-15,-7,-1,-4,5,0,0,-5,-1,-1,-1,-1,3,-1
KR_6722060305,420,-6,-79,-36,-16,0,1,1,-8,11,3,-4,5,1,-3,3,0,-1,2,1,0,-17,-5,0,-3,3,0,0,-1,-1,1,-1,-1,4,-1
KR_6731398062,420,-4,-23,-9,-3,-3,3,0,-4,4,0,1,2,3,4,1,5,-1,3,2,0,-2,-52,-2,-3,5,-4,0,-2,0,-1,-1,1,0,-1
KR_6751311105,440,-4,-125,-23,-4,1,2,3,5,2,7,-5,5,0,-5,5,0,0,1,1,-2,-10,-7,-3,-2,5,1,0,-1,-1,-1,-1,-1,1,-1
KR_6726730140,420,-3,-131,-36,-9,-7,7,0,0,4,4,1,2,3,-2,5,3,-1,1,0,-1,-4,-3,0,-4,4,-1,0,-1,-1,-1,-1,-1,3,-1
KR_6750065100,420,2,61,16,6,1,2,3,3,1,4,1,1,2,-2,6,4,3,3,6,1,1,174,-1,0,1,-2,0,0,1,1,1,1,6,-1
KR_6714848105,440,1,-22,20,2,2,2,4,-1,2,1,1,1,2,0,1,1,0,0,0,0,3,12,1,-5,4,-2,0,0,-1,1,-1,-1,5,-1
KR_6589386315,420,-5,-40,-28,-13,-1,4,3,-5,6,1,-8,9,1,2,2,4,-1,1,0,2,-9,-153,-2,-3,5,2,0,-4,-1,-1,-1,1,2,-1
KR_6609240912,420,-5,-80,-16,-10,-5,5,0,0,2,2,-3,5,2,0,1,1,-2,2,0,0,-6,2,1,-4,3,-1,0,0,-1,1,-1,-1,2,-1
KR_6640283352,440,0,-26,-12,0,3,4,7,0,2,2,-1,1,0,-3,5,2,1,0,1,0,-2,-4,-3,-1,4,0,0,0,-1,1,1,1,6,-1
KR_6725409234,420,-2,88,-32,-3,1,1,2,-2,5,3,-1,1,0,-2,6,4,1,1,2,0,-6,7,6,-7,1,-1,0,0,-1,1,1,1,6,-1
KR_6725659033,420,0,18,18,-4,0,1,1,-6,7,1,3,2,5,-3,4,1,2,1,3,1,-4,2,-4,-1,5,-1,0,0,0,0,0,1,0,-1
KR_6738692019,420,-4,19,-12,-13,-2,2,0,-2,3,1,-5,7,2,0,4,4,-4,4,0,0,-5,1,0,-3,3,1,0,-1,1,-1,-1,-1,6,-1
KR_6665140834,420,0,-25,52,-5,-4,4,0,-1,2,1,-2,4,2,2,1,3,0,0,0,-1,-5,37,-1,-1,2,-19,0,-1,1,0,-1,-1,6,-1
KR_6731790311,420,-3,4,-8,-10,-2,2,0,-5,6,1,-4,4,0,3,2,5,-2,2,0,0,-8,2,-4,-5,9,3,0,0,1,-1,0,-1,5,-1
KR_6620975465,440,-4,-53,-8,-10,-4,4,0,-2,3,1,1,1,2,-2,5,3,-3,3,0,0,-11,2,-3,-5,8,2,0,-1,-1,-1,-1,-1,1,-1
KR_6616843139,420,-1,-48,-40,-9,0,2,2,-8,9,1,-2,2,0,0,3,3,1,2,3,0,-8,21,-1,-1,2,0,0,-1,0,0,-1,1,0,-1
KR_6757880406,420,-2,-19,-8,-2,-3,3,0,-3,5,2,6,1,7,-1,1,0,-1,2,1,0,-2,2,0,-2,2,-2,0,0,0,0,-1,1,0,-1
KR_6760545570,420,0,-14,16,5,-1,2,1,4,1,5,1,1,2,1,0,1,0,1,1,1,6,223,3,-4,1,1,0,0,-1,1,0,1,1,-1
KR_6764354945,420,-5,-12,-8,-15,0,1,1,-2,2,0,-1,6,5,-12,14,2,0,1,1,0,-15,-46,-6,-1,7,25,0,-1,-1,0,-1,1,3,-1
KR_6759576677,420,-1,-31,4,-10,-3,3,0,0,2,2,-6,6,0,1,4,5,-2,3,1,0,3,-250,1,-1,0,-2,0,-1,-1,1,-1,-1,1,-1
KR_6602763431,420,-1,-94,-4,3,4,0,4,4,2,6,-4,7,3,-2,4,2,1,0,1,0,2,5,4,-6,2,6,0,0,0,1,-1,1,0,-1
KR_6755024990,420,0,-16,4,-1,0,1,1,0,0,0,2,1,3,-1,2,1,-2,3,1,0,-2,28,0,-4,4,-1,0,0,0,-1,0,-1,0,-1
KR_6752966816,420,-1,31,1,-6,-1,3,2,-1,1,0,0,5,5,0,1,1,-4,4,0,0,-3,-1,-4,0,4,3,0,-1,1,-1,-1,1,2,-1
KR_6047715943,440,-1,-28,-8,4,-2,3,1,3,1,4,0,1,1,2,1,3,1,2,3,0,10,-7,1,-4,3,0,0,0,-1,-1,0,1,2,-1
KR_6662241962,440,0,-43,4,1,-1,1,0,-3,6,3,0,0,0,-2,4,2,7,0,7,0,-1,2,1,-4,3,-2,0,0,1,-1,0,-1,4,-1
KR_6607767672,420,-2,-55,-3,-2,1,0,1,-3,4,1,0,2,2,5,1,6,-5,5,0,0,3,-12,2,-5,3,-3,0,-2,1,-1,-1,-1,5,-1
KR_6008469475,440,-2,-46,16,-8,-5,5,0,-1,1,0,0,1,1,-2,2,0,0,0,0,0,-12,-2,2,-5,3,-1,0,-1,1,-1,-1,-1,4,-1
KR_6723887069,420,1,4,-20,-1,2,0,2,-2,5,3,0,0,0,0,1,1,-1,1,0,0,3,-22,-3,0,3,1,0,0,-1,-1,0,-1,1,-1
KR_6730177098,420,-3,-69,4,-11,-3,5,2,0,3,3,-5,5,0,-3,5,2,0,1,1,0,-4,-1,-1,-3,4,1,0,0,1,1,-1,1,3,-1
KR_6733375409,420,-3,-48,-41,-10,0,4,4,-4,7,3,0,1,1,-5,6,1,-1,1,0,-3,-9,-3,0,-3,3,3,0,-1,0,0,-1,-1,0,-1
KR_6684021337,420,0,-28,2,-10,1,2,3,-3,4,1,-3,6,3,-3,5,2,-2,2,0,-1,-6,5,1,-4,3,-1,0,0,-1,1,1,-1,6,-1
KR_6713937362,440,-1,29,9,-6,-6,7,1,0,4,4,5,0,5,-5,5,0,0,0,0,-1,-6,32,4,-5,1,-16,0,-1,1,-1,-1,-1,6,-1
KR_6694398082,440,1,-12,8,10,-2,3,1,-2,7,5,0,1,1,1,3,4,13,0,13,0,4,-15,-2,-2,4,7,0,1,1,1,1,1,6,-1
KR_6743083085,420,-2,-17,13,-2,0,1,1,2,2,4,-1,3,2,1,2,3,-4,4,0,0,-2,-2,-2,-4,6,2,0,-2,-1,1,-1,-1,6,-1
KR_6098642429,420,2,84,12,1,2,0,2,-6,6,0,2,1,3,3,2,5,0,2,2,0,-1,-1,1,-4,3,-1,0,0,-1,-1,-1,1,4,-1
KR_6693393835,420,0,-22,4,-5,2,2,4,0,3,3,-2,2,0,-4,6,2,-1,1,0,-2,-7,92,-4,-1,5,0,0,0,-1,-1,1,-1,4,-1
KR_6744293122,420,-4,-24,-32,-7,3,1,4,-3,5,2,-6,6,0,-1,2,1,0,1,1,0,-1,-157,2,-3,1,0,0,-2,-1,-1,-1,1,3,-1
KR_6602119678,420,-6,-53,-22,-10,-1,2,1,-2,6,4,-3,4,1,-2,5,3,-2,2,0,0,-4,-1,1,-3,2,-1,0,-1,-1,1,-1,1,4,-1
KR_6713083538,420,2,-2,13,-2,4,1,5,-4,4,0,-2,6,4,0,0,0,0,0,0,0,-5,53,-1,-5,6,-13,0,-1,-1,-1,-1,-1,2,-1
KR_6596054364,420,-1,-36,-11,5,-4,4,0,0,1,1,3,1,4,5,2,7,1,0,1,0,14,-31,-1,0,1,2,0,0,-1,1,-1,1,6,-1
KR_6747409786,440,-3,70,16,-7,5,1,6,-3,4,1,-1,1,0,-7,9,2,-1,3,2,0,-12,-2,-2,-3,5,1,0,0,-1,1,1,1,2,-1
KR_6514588532,420,-2,-68,21,-14,0,1,1,-6,7,1,-2,4,2,-6,7,1,0,2,2,0,-16,-241,-2,-4,6,-2,0,0,-1,-1,-1,-1,2,-1
KR_6499552622,420,1,39,9,7,5,0,5,0,2,2,4,0,4,-4,6,2,2,1,3,2,7,24,0,-4,4,5,0,0,-1,1,0,1,4,-1
KR_6728793779,420,3,78,0,4,-1,2,1,-1,2,1,4,0,4,-3,3,0,5,0,5,0,0,3,2,-3,1,-1,0,2,-1,1,1,1,4,-1
KR_6084940252,420,-2,-30,1,-7,0,3,3,-1,2,1,-4,4,0,-1,5,4,-1,2,1,-1,-10,14,-5,0,5,0,0,0,-1,1,1,-1,4,-1
KR_6622864124,420,-4,-22,-24,-4,1,0,1,-2,3,1,0,3,3,-1,2,1,-2,3,1,0,-4,5,-1,-2,3,1,0,0,-1,-1,0,-1,5,-1
KR_6717296981,420,-4,20,-12,-9,1,4,5,-3,6,3,1,1,2,-7,8,1,-1,2,1,-2,-12,-1,0,-2,2,2,0,0,-1,1,-1,-1,3,-1
KR_6725839926,420,-7,-26,-8,-15,-5,7,2,-9,9,0,0,2,2,-1,2,1,0,0,0,0,-9,-160,1,-2,1,-2,-1,-5,-1,-1,-1,-1,5,-1
KR_6703592703,420,3,60,-1,5,1,2,3,2,2,4,1,1,2,1,3,4,0,0,0,0,-5,-8,4,-5,1,0,0,1,1,-1,1,-1,6,-1
KR_6649515769,420,1,34,-16,9,-2,2,0,4,0,4,2,1,3,6,0,6,-1,2,1,0,9,-8,2,-3,1,-2,0,0,-1,-1,0,-1,3,-1
KR_6724940555,440,-4,-23,-16,-7,2,1,3,-1,1,0,-8,10,2,-1,1,0,1,1,2,0,-3,-477,0,-3,3,-2,0,-1,-1,-1,-1,1,5,-1
KR_6744567899,420,0,23,0,-1,3,1,4,2,4,6,-2,4,2,-6,7,1,2,0,2,0,3,-1,3,-5,2,-1,0,-1,-1,-1,-1,1,4,-1
KR_6631257048,420,-3,46,8,-10,1,1,2,-8,9,1,-4,4,0,1,3,4,0,2,2,0,-14,9,4,-4,0,-1,0,0,-1,0,0,1,6,-1
KR_6714276582,420,-3,-95,-11,-14,-4,4,0,-5,6,1,-3,3,0,1,2,3,-3,3,0,0,-16,-67,-2,0,2,26,0,-2,-1,-1,-1,-1,3,-1
KR_6759427103,420,-3,-39,-12,-3,-2,5,3,-1,1,0,1,5,6,-2,6,4,1,0,1,-1,0,-25,-2,-3,5,2,0,0,-1,-1,-1,-1,2,-1
KR_6685890381,420,-2,3,-58,-2,-3,3,0,-1,1,0,4,0,4,-2,2,0,0,0,0,0,-5,-2,0,-1,1,1,0,0,-1,1,1,1,6,-1
KR_6728677821,440,-5,-93,-32,-7,-4,5,1,1,0,1,0,3,3,-5,6,1,1,1,2,-1,-7,-8,3,-6,3,-3,0,0,-1,0,0,-1,3,-1
KR_6745402529,440,-5,0,14,-7,0,0,0,-7,10,3,1,3,4,0,0,0,-1,4,3,0,-10,11,-3,-5,8,1,0,-2,-1,-1,-1,1,1,-1
KR_6717550237,420,1,-15,-12,8,-2,2,0,5,0,5,1,0,1,2,2,4,2,1,3,0,10,7,-2,-1,3,-1,0,0,0,-1,0,1,0,-1
KR_6645702870,420,-3,-44,-13,-6,6,0,6,-11,13,2,-2,2,0,0,1,1,1,1,2,0,-4,-332,1,-2,1,1,0,-1,-1,-1,-1,1,5,-1
KR_6754758221,420,-5,43,-16,-9,-1,2,1,3,2,5,-6,8,2,-4,5,1,-1,1,0,-1,-9,3,-1,-1,2,-2,0,0,-1,-1,-1,-1,3,-1
KR_6700056093,420,-3,-70,-40,-8,5,1,6,-4,5,1,-2,4,2,-5,9,4,-2,3,1,0,-7,2,1,-5,4,0,0,-2,-1,0,-1,-1,1,-1
KR_6676280251,420,1,-72,0,7,4,0,4,-1,4,3,1,1,2,3,0,3,0,1,1,0,10,4,3,-3,0,1,0,-1,-1,-1,-1,-1,2,-1
KR_6754085582,420,0,48,12,-2,-1,2,1,0,3,3,-3,4,1,3,0,3,-1,1,0,0,-1,-8,-3,-3,6,0,0,-1,1,-1,-1,-1,6,-1
KR_6706638563,420,-2,-87,12,-1,1,2,3,-1,3,2,-3,4,1,1,2,3,1,1,2,0,-2,-17,0,-3,3,1,0,-1,-1,0,-1,-1,2,-1
KR_6751393257,420,0,2,8,-3,1,0,1,0,1,1,-5,6,1,0,1,1,1,0,1,0,-3,-257,1,-3,2,0,0,0,-1,-1,0,-1,4,-1
KR_6718993627,440,-5,4,21,-14,2,0,2,2,6,8,-4,4,0,-8,10,2,-6,6,0,0,-15,-23,-3,-1,4,-1,0,-1,-1,-1,-1,-1,1,-1
KR_6062640480,440,-8,-15,-37,-10,-4,7,3,-3,6,3,1,1,2,-4,4,0,0,0,0,0,-5,-165,-2,0,2,0,0,-1,-1,0,-1,1,1,-1
KR_6740627040,420,-7,-133,-40,-1,-5,6,1,-1,1,0,-1,3,2,7,0,7,-1,2,1,0,2,-5,-1,-3,4,1,0,-2,0,-1,-1,-1,0,-1
KR_6709500689,440,-4,-67,-1,-5,-2,2,0,-1,2,1,-1,2,1,-2,2,0,1,2,3,0,-2,49,-1,-3,4,-24,0,0,-1,0,0,1,2,-1
KR_6716081304,420,1,48,-33,2,0,1,1,-2,6,4,2,2,4,0,1,1,2,0,2,1,10,12,-3,-1,4,0,0,2,0,-1,1,1,0,-1
KR_6740100593,420,-1,-67,8,-6,0,2,2,-3,3,0,-2,2,0,0,2,2,-1,1,0,0,-3,-9,0,-4,4,0,0,-2,1,-1,-1,1,2,-1
KR_6702719294,420,-2,-10,-12,-10,0,3,3,1,3,4,-4,4,0,-4,5,1,-3,3,0,0,-8,6,1,-2,1,-2,0,0,-1,-1,0,-1,4,-1
KR_6708864289,420,-3,8,16,-9,-1,2,1,-9,10,1,0,2,2,1,0,1,0,0,0,0,1,-26,2,-4,2,0,0,0,-1,-1,0,-1,5,-1
KR_6608308005,420,0,-10,18,-3,-2,5,3,1,1,2,0,1,1,-2,4,2,0,0,0,0,-8,-11,-8,-2,10,1,0,-1,-1,-1,-1,1,2,-1
KR_6529251869,420,-3,-88,-16,-2,-4,4,0,5,2,7,3,1,4,-6,6,0,0,1,1,0,4,-4,-1,-2,3,2,0,-1,-1,0,-1,-1,4,-1
KR_6640099595,420,-6,32,-48,-10,2,1,3,-9,9,0,-2,2,0,0,1,1,-1,1,0,0,-6,41,4,-9,5,-24,0,0,-1,-1,1,-1,4,-1
KR_6621148339,420,-7,-139,-24,-17,-1,2,1,-2,5,3,-4,5,1,-5,6,1,-5,5,0,-2,-24,1,-1,0,1,-2,-1,-6,-1,-1,-1,-1,4,-1
KR_6653592606,420,-5,-36,0,-12,3,0,3,-11,11,0,-1,4,3,-3,3,0,0,2,2,0,-9,-103,0,-3,3,-1,0,-1,1,-1,-1,-1,5,-1
KR_6658814236,440,-1,-21,16,-10,-4,4,0,1,3,4,3,0,3,-6,6,0,-4,4,0,0,-13,3,-9,-1,10,1,0,-2,-1,0,-1,1,1,-1
KR_6744804760,440,-1,-24,3,-7,-4,5,1,2,1,3,-1,3,2,-2,2,0,-2,2,0,-1,-5,-1,2,-3,1,-1,0,0,-1,1,0,-1,3,-1
KR_6617567515,420,-5,-48,7,-5,-2,5,3,-2,7,5,-1,4,3,1,2,3,-1,2,1,1,-5,-4,0,-2,2,-1,0,-2,1,-1,-1,1,6,-1
KR_6742749768,420,0,16,2,-1,2,0,2,1,1,2,0,2,2,-2,2,0,-2,3,1,0,-5,0,0,-3,3,0,0,0,-1,1,-1,1,1,-1
KR_6600556348,420,-3,-69,-16,-8,-5,7,2,2,0,2,-2,4,2,-3,3,0,0,0,0,0,-7,-196,1,-2,1,2,0,-1,-1,-1,-1,1,2,-1
KR_6694297249,420,0,-6,-24,-6,1,1,2,1,2,3,-6,7,1,-3,3,0,1,0,1,0,-2,-4,0,-6,6,3,0,0,1,-1,0,-1,2,-1
KR_6701284174,420,-4,-83,-19,-8,-7,7,0,-1,1,0,1,3,4,-1,1,0,0,0,0,-1,-3,-1,-1,-2,3,-3,0,-1,0,0,-1,-1,0,-1
KR_6537611758,420,-2,-49,-16,-6,-1,2,1,0,3,3,-2,3,1,-5,8,3,2,0,2,0,-3,-42,1,-3,2,14,0,0,-1,-1,-1,-1,4,-1
KR_6737607962,420,2,-2,28,1,-1,1,0,0,4,4,5,1,6,-1,1,0,-2,2,0,0,2,308,2,-2,0,4,0,1,1,1,1,1,5,-1
KR_6762265216,420,1,39,-9,0,-2,3,1,-3,3,0,-1,1,0,5,1,6,1,0,1,0,2,-510,-3,0,3,3,0,-1,1,-1,-1,-1,5,-1
KR_6738204284,420,0,-76,-24,-3,-1,2,1,-1,2,1,-1,2,1,0,3,3,0,0,0,0,-3,17,0,-3,3,-2,0,0,-1,-1,0,1,6,-1
KR_6734048533,420,0,-44,-14,3,0,3,3,-1,3,2,3,1,4,0,2,2,1,2,3,0,2,8,0,-3,3,-2,0,1,-1,0,1,1,2,-1
KR_6743294905,420,-4,2,-22,-10,4,0,4,1,0,1,-4,6,2,-9,9,0,-2,3,1,0,-9,10,6,-7,1,-3,0,-1,0,-1,-1,-1,0,-1
KR_6638408938,420,-4,-61,-16,-9,-1,4,3,-6,7,1,-1,4,3,-1,2,1,0,1,1,0,0,12,2,-5,3,2,0,-2,0,-1,-1,-1,0,-1
KR_6625276572,420,-4,37,7,-10,-1,1,0,-7,8,1,1,3,4,-3,6,3,0,4,4,0,-3,13,0,-5,5,-3,0,-1,1,0,-1,1,2,-1
KR_6647742490,420,-1,-23,-16,0,0,1,1,2,1,3,2,1,3,-1,3,2,-3,3,0,0,4,10,2,-3,1,-2,0,0,-1,1,0,-1,3,-1
KR_6764260319,420,-1,12,-16,-4,2,1,3,-1,3,2,-1,1,0,-2,4,2,-2,2,0,0,-4,363,-2,-1,3,0,0,-1,-1,0,1,-1,6,-1
KR_6761508172,420,-4,-8,-36,-3,1,3,4,-3,4,1,-1,1,0,3,1,4,-3,3,0,0,0,439,4,-7,3,-3,0,0,-1,1,1,1,5,-1
KR_6581405724,420,-3,-34,-28,-5,-1,1,0,3,0,3,2,2,4,-11,11,0,2,1,3,0,-6,-4,0,-2,2,-1,0,-1,-1,1,-1,-1,5,-1
KR_6748461091,440,-3,-28,-16,-12,0,4,4,-2,4,2,-1,2,1,0,1,1,-9,11,2,0,-12,46,-3,-2,5,-15,0,0,0,-1,-1,-1,0,-1
KR_6737580622,420,-1,-52,12,-8,0,1,1,0,1,1,-2,3,1,-6,7,1,0,0,0,0,-9,-9,1,-3,2,2,0,0,0,-1,-1,1,0,-1
KR_6601165226,420,-2,29,-29,-6,2,1,3,-3,4,1,-2,5,3,0,1,1,-3,3,0,0,-4,-1,-1,-1,2,2,0,1,-1,1,1,-1,2,-1
KR_6660290567,420,-2,-29,8,-7,3,2,5,-5,7,2,-2,2,0,-3,3,0,0,0,0,0,-4,-1,2,-4,2,-2,0,-2,1,-1,-1,1,5,-1
KR_6743968531,420,2,-1,4,7,2,0,2,2,1,3,3,1,4,0,3,3,0,2,2,0,4,-99,3,-6,3,-4,0,0,0,1,0,1,0,-1
KR_6613771112,420,-5,-78,-44,-6,-6,7,1,-4,4,0,3,1,4,0,4,4,1,1,2,-1,2,44,-2,-2,4,-24,0,-2,-1,-1,-1,-1,2,-1
KR_6759181597,420,-2,-53,8,-5,-5,5,0,-5,6,1,6,2,8,-1,4,3,0,0,0,-1,-2,1,-2,-4,6,-6,0,0,-1,1,0,-1,4,-1
KR_6607547123,420,2,-41,6,8,0,3,3,6,0,6,4,1,5,-2,5,3,0,2,2,0,10,4,1,-4,3,-2,0,0,1,-1,-1,1,1,-1
KR_6709064591,420,0,-77,8,4,0,4,4,3,1,4,-1,1,0,0,1,1,2,0,2,0,7,-185,-1,-2,3,1,0,0,-1,1,-1,-1,6,-1
KR_6642762773,420,-4,-82,-24,-4,-3,4,1,1,3,4,-2,3,1,0,3,3,0,2,2,0,4,18,2,-7,5,-4,0,-1,-1,1,-1,1,6,-1
KR_6764474740,440,-6,-103,-21,-8,1,0,1,-1,1,0,-1,2,1,-8,8,0,1,1,2,-1,-15,-5,-5,0,5,2,0,-2,-1,-1,-1,-1,1,-1
KR_6499411689,420,1,17,-16,-3,-1,5,4,-2,2,0,-4,5,1,3,1,4,1,0,1,0,-7,8,-3,-3,6,-2,0,0,1,-1,-1,-1,6,-1
KR_6746055281,440,2,58,8,10,2,3,5,1,0,1,4,1,5,0,2,2,3,1,4,0,10,6,0,-1,1,1,0,0,0,0,0,1,0,-1
KR_6731374745,420,1,5,-12,6,0,0,0,3,0,3,-2,2,0,3,1,4,2,2,4,0,12,2,0,-1,1,0,0,0,1,1,0,-1,1,-1
KR_6708225419,440,-2,36,-29,-2,-4,5,1,0,3,3,-1,4,3,4,2,6,-1,1,0,0,5,-3,-4,-4,8,-1,0,-1,1,-1,-1,1,4,-1
KR_6721888038,420,1,11,17,5,2,0,2,-1,2,1,4,0,4,4,3,7,-4,4,0,0,4,-5,0,0,0,-3,0,-1,1,-1,-1,1,4,-1
KR_6638902510,420,0,77,-15,2,1,0,1,2,2,4,-1,2,1,-2,5,3,2,0,2,0,5,-16,4,-6,2,0,0,1,-1,1,1,-1,2,-1
KR_6735481214,420,3,16,24,2,0,2,2,2,2,4,-2,3,1,-1,1,0,3,2,5,-1,-2,2,0,-6,6,-2,0,2,1,-1,1,-1,3,-1
KR_6760173661,420,1,7,17,2,-3,4,1,1,0,1,2,0,2,0,3,3,2,0,2,0,3,0,4,-8,4,2,0,-1,1,-1,-1,1,5,-1
KR_6731902375,420,-3,-93,-20,-4,-2,3,1,6,2,8,-3,3,0,-1,2,1,-4,4,0,0,0,-1,-2,-1,3,0,0,0,1,-1,-1,-1,1,-1
KR_6713515460,420,-7,-100,-44,-27,-6,7,1,-2,2,0,-3,7,4,-14,15,1,-2,2,0,1,-18,0,0,-3,3,-1,0,-4,-1,-1,-1,1,1,-1
KR_6602834454,420,1,40,-10,-4,4,0,4,-1,1,0,1,3,4,-5,6,1,-3,4,1,0,-6,3,-3,-1,4,-1,0,-2,-1,-1,-1,-1,4,-1
KR_6758919262,420,0,27,2,-4,1,0,1,-5,5,0,3,2,5,-2,4,2,-1,1,0,0,-6,-15,2,-3,1,0,0,-1,-1,-1,-1,-1,6,-1
KR_6726869290,420,-2,-21,-4,-4,-10,10,0,-2,5,3,0,4,4,4,2,6,4,1,5,1,2,0,-1,0,1,-2,0,1,1,1,-1,1,6,-1
KR_6715653703,440,-4,-41,-58,-5,-6,6,0,-2,3,1,0,1,1,4,0,4,-1,2,1,0,-9,11,0,-2,2,2,0,0,-1,-1,-1,1,3,-1
KR_6060421410,440,3,34,8,10,7,0,7,-1,2,1,3,0,3,1,1,2,0,2,2,0,12,200,-4,0,4,0,0,0,0,1,0,1,0,-1
KR_6648618732,420,-8,-117,-30,-20,-4,4,0,-5,5,0,-4,5,1,-5,5,0,-2,2,0,-1,-20,162,2,-4,2,-8,0,-4,1,-1,-1,-1,6,-1
KR_6726617421,420,-1,-7,-32,4,4,0,4,-4,5,1,1,1,2,3,2,5,0,0,0,0,-2,6,4,-5,1,-2,0,1,-1,1,1,1,4,-1
KR_6754034695,440,-2,-61,-32,-4,0,5,5,-3,5,2,1,2,3,-2,5,3,0,1,1,-1,-11,194,0,0,0,0,0,1,1,1,1,-1,1,-1
KR_6617356524,420,0,20,5,-1,-1,1,0,0,2,2,-1,1,0,0,1,1,1,0,1,0,-1,8,-3,-1,4,0,0,0,-1,-1,0,-1,4,-1
KR_6693205675,440,-3,-3,0,-12,-1,2,1,-2,2,0,-3,4,1,-6,9,3,0,0,0,0,-14,2,0,-4,4,-2,0,-2,1,-1,-1,-1,4,-1
KR_6760927762,420,-1,-44,0,-7,0,1,1,-6,9,3,-1,4,3,-1,2,1,1,1,2,-4,-7,-7,-1,-2,3,0,0,-1,-1,0,-1,-1,6,-1
KR_6759446444,420,-1,-10,-16,-6,-1,4,3,-1,5,4,-3,3,0,-2,5,3,1,1,2,0,3,248,-3,-1,4,-1,0,-1,-1,-1,-1,-1,4,-1
KR_6759673053,440,-7,-107,-137,-10,-3,5,2,-2,2,0,-4,7,3,-4,4,0,3,0,3,1,-4,-7,0,0,0,0,0,-1,-1,-1,-1,1,2,-1
KR_6642029612,420,1,22,0,-2,0,0,0,-3,6,3,-2,4,2,-2,4,2,5,1,6,0,-5,-179,-4,0,4,1,0,1,1,1,1,-1,6,-1
KR_6615647495,420,0,37,32,3,5,0,5,-1,5,4,2,1,3,-3,4,1,0,2,2,0,-1,0,-1,-2,3,0,0,1,1,1,1,1,5,-1
KR_6729996713,420,-5,-47,-3,-10,-1,2,1,-2,4,2,0,2,2,-6,6,0,-1,1,0,0,-9,1,1,-6,5,0,0,-1,-1,1,-1,1,5,-1
KR_6636126993,420,0,-29,8,0,2,1,3,0,2,2,-1,2,1,-1,3,2,0,0,0,0,2,-224,3,-5,2,-22,0,0,-1,0,-1,1,4,-1
KR_6712983919,420,-2,-125,12,-4,-3,4,1,0,3,3,-2,4,2,0,1,1,1,1,2,0,2,-20,1,-3,2,-4,0,-2,1,-1,-1,1,6,-1
KR_6744620880,420,1,32,8,0,3,4,7,-3,4,1,1,0,1,-1,4,3,0,2,2,1,-7,5,-3,0,3,-3,0,0,-1,0,1,1,5,-1
KR_6639372361,420,0,-34,-25,-8,-1,2,1,1,1,2,1,4,5,-9,11,2,0,4,4,-2,-12,34,3,-6,3,-4,0,-1,-1,1,-1,-1,6,-1
KR_6643726869,440,0,13,-4,-1,1,4,5,1,0,1,-2,5,3,-1,3,2,0,1,1,2,-1,-11,-1,-2,3,3,0,1,1,-1,1,1,6,-1
KR_6654093401,440,-1,-58,7,-2,-2,3,1,3,0,3,2,4,6,-2,5,3,-3,4,1,0,7,-2,2,-5,3,1,0,-1,1,-1,-1,-1,3,-1
KR_6719720509,420,2,14,-36,6,1,3,4,-1,1,0,2,3,5,4,2,6,0,1,1,1,7,7,3,-4,1,-1,0,0,1,-1,-1,1,2,-1
KR_6505079842,420,-2,-63,-5,-7,-1,3,2,1,3,4,-1,2,1,-7,7,0,1,1,2,0,-14,-4,0,-4,4,1,0,1,-1,1,-1,1,6,-1
KR_6728871721,420,-4,-64,-43,-4,-2,3,1,-5,6,1,-3,4,1,7,0,7,-1,3,2,0,6,38,3,-4,1,-1,0,-2,1,-1,-1,-1,3,-1
KR_6663390055,420,-2,-33,-16,-1,2,0,2,-1,1,0,-5,5,0,2,2,4,1,1,2,0,-5,-6,0,-3,3,0,0,0,-1,1,0,1,1,-1
KR_6687814297,420,-5,-128,4,-14,-3,4,1,-1,2,1,-5,6,1,-6,6,0,1,2,3,0,-20,5,5,-5,0,0,0,-3,1,-1,-1,-1,2,-1
KR_6623599387,420,-2,17,26,-9,-5,5,0,-1,1,0,1,2,3,-3,4,1,-1,2,1,0,-10,38,-1,-4,5,1,0,-1,1,1,1,1,1,-1
KR_6668818196,420,-1,-21,24,1,2,0,2,-3,4,1,-1,3,2,3,2,5,0,0,0,1,0,0,-2,-4,6,1,0,0,0,-1,0,1,0,-1
KR_6740355634,420,2,43,22,10,3,1,4,1,1,2,4,1,5,2,2,4,0,1,1,0,5,9,3,-3,0,1,0,1,0,0,1,1,0,-1
KR_6725560431,420,3,60,16,3,-1,1,0,3,2,5,2,1,3,-2,2,0,1,3,4,0,5,10,-5,-3,8,3,0,1,1,-1,1,1,4,-1
KR_6748614488,440,4,104,3,5,0,1,1,1,0,1,5,0,5,-1,2,1,0,2,2,0,6,-10,-3,-2,5,-1,0,0,-1,1,0,-1,6,-1
KR_6757740903,420,2,14,27,-2,1,0,1,-1,4,3,1,2,3,-1,4,3,-2,3,1,0,-3,-13,-3,-1,4,3,0,0,0,0,0,-1,0,-1
KR_6759581395,440,-3,-100,6,-6,-2,3,1,-3,4,1,-4,4,0,1,4,5,2,0,2,0,-3,-29,2,-3,1,10,0,0,-1,0,-1,1,1,-1
KR_6756846476,420,-1,-4,0,-3,5,0,5,-5,6,1,2,4,6,2,4,6,-7,8,1,0,-8,-14,-2,-3,5,3,0,-1,1,0,1,1,1,-1
KR_5608862686,420,-5,-112,27,-6,3,0,3,-5,5,0,-2,3,1,-1,1,0,-1,1,0,0,-14,-10,-5,-5,10,0,0,0,1,1,0,1,6,-1
KR_6635352504,420,1,26,-5,3,0,2,2,2,3,5,4,1,5,-1,1,0,-2,4,2,0,5,-195,2,-4,2,0,0,0,1,1,0,-1,1,-1
KR_6694073948,420,-4,-24,-29,-10,8,0,8,-6,7,1,-2,4,2,-6,8,2,-4,6,2,0,-13,2,4,-7,3,-1,0,-5,-1,-1,-1,1,5,-1
KR_6742482825,420,-1,0,-8,-2,-2,3,1,0,3,3,2,2,4,-1,1,0,-1,2,1,0,-1,0,-1,-1,2,1,0,-1,-1,1,-1,1,3,-1
KR_6697416790,420,-2,-86,7,-6,-2,3,1,2,2,4,-3,4,1,-1,2,1,-2,2,0,0,-1,-1,-4,0,4,0,0,-1,-1,0,-1,1,5,-1
KR_6324713295,420,-1,-12,-34,-1,0,0,0,1,0,1,1,4,5,-2,3,1,-1,1,0,0,0,4,1,-3,2,0,0,0,-1,-1,0,1,1,-1
KR_6728820740,440,-1,-18,-16,-9,-3,3,0,-5,6,1,2,1,3,0,1,1,-3,3,0,0,-7,-140,-1,-3,4,1,0,0,-1,0,0,-1,3,-1
KR_6643234620,420,-7,-119,-9,-14,-2,4,2,-2,2,0,-3,3,0,-5,9,4,-2,2,0,0,-12,-6,-7,-1,8,0,0,-2,-1,0,-1,1,4,-1
KR_6723817136,420,-6,-120,-24,-11,-4,5,1,2,0,2,-7,7,0,0,4,4,-2,2,0,0,-9,2,-1,-4,5,0,0,-2,-1,-1,-1,1,3,-1
KR_6753694692,420,-1,-33,-12,0,-2,2,0,1,4,5,2,1,3,1,2,3,-2,2,0,0,7,-10,-4,-3,7,4,0,0,-1,-1,0,1,2,-1
KR_6734309963,420,-1,-7,-12,-4,-4,4,0,-1,2,1,3,1,4,-4,4,0,2,0,2,0,-3,-8,0,-5,5,-3,0,0,1,1,1,-1,2,-1
KR_6600995497,420,-2,14,-6,-2,-2,3,1,-2,2,0,2,1,3,-2,3,1,2,0,2,0,-4,15,2,-3,1,-4,0,0,0,-1,0,1,0,-1
KR_6595977638,420,-2,-47,-16,3,2,1,3,-1,5,4,-1,3,2,3,4,7,0,1,1,0,7,60,4,-5,1,-1,0,0,-1,1,0,1,4,-1
KR_6705779632,420,2,-29,36,-3,1,3,4,-1,5,4,0,1,1,-1,4,3,-2,2,0,0,-7,82,-2,-2,4,0,0,0,1,-1,1,-1,5,-1
KR_6655575094,420,-5,-49,-19,-12,0,2,2,-1,2,1,-9,9,0,0,0,0,-2,2,0,0,-8,-11,-2,-2,4,1,0,-2,-1,1,-1,-1,4,-1
KR_6762300945,420,-1,-17,0,-8,-3,4,1,-2,3,1,-1,3,2,0,2,2,-2,2,0,-1,-7,4,1,-4,3,0,0,0,-1,-1,0,-1,4,-1
KR_6601498719,420,-6,-34,-44,-12,-3,5,2,-3,4,1,-4,4,0,-1,3,2,-1,2,1,0,-15,-302,1,-2,1,-1,0,-1,1,-1,-1,1,6,-1
KR_6323698319,420,-4,-87,-9,-6,1,0,1,-4,5,1,0,1,1,-3,6,3,0,1,1,0,-4,-131,2,-5,3,-1,0,-1,-1,0,-1,1,4,-1
KR_6624569883,420,-6,-91,-6,-7,0,1,1,-2,2,0,-10,10,0,3,1,4,2,0,2,0,0,-1,3,-5,2,-4,0,-3,1,-1,-1,-1,4,-1
KR_6422519484,420,4,30,40,9,0,1,1,6,1,7,2,5,7,0,3,3,1,1,2,1,8,-31,-3,-3,6,3,0,0,0,0,0,1,0,-1
KR_6646055210,420,0,-1,-28,1,-3,4,1,1,0,1,5,2,7,2,2,4,-4,5,1,0,2,421,3,-3,0,-1,0,0,-1,1,1,-1,5,-1
KR_6656844239,440,-1,-56,24,-6,1,1,2,0,2,2,-2,3,1,-5,6,1,0,1,1,0,-7,-1,4,-6,2,-2,0,-1,1,1,1,-1,3,-1
KR_6728268303,420,0,31,-26,-4,2,1,3,-6,6,0,-1,1,0,0,2,2,1,0,1,-2,-9,-4,-1,-3,4,-1,0,1,0,-1,1,-1,0,-1
KR_6612016250,420,-2,-57,12,-14,-1,2,1,1,1,2,1,0,1,-13,13,0,-2,2,0,-1,-14,9,-3,0,3,0,0,0,-1,0,-1,-1,5,-1
KR_6650418970,440,2,-32,8,3,1,1,2,2,2,4,3,1,4,-2,3,1,-1,1,0,0,7,32,-1,-3,4,3,0,0,-1,1,0,1,2,-1
KR_6750902304,420,-4,-111,-8,-4,3,0,3,1,1,2,-3,4,1,-2,3,1,-3,3,0,0,-1,1,3,-3,0,-8,0,-2,0,-1,-1,-1,0,-1
KR_6736504576,420,0,-11,11,-5,-3,3,0,1,5,6,0,2,2,-3,5,2,0,0,0,1,5,-1,-4,-2,6,-1,0,-1,0,-1,-1,1,0,-1
KR_6741363018,420,3,11,16,7,3,0,3,0,4,4,2,2,4,-3,5,2,5,0,5,-1,2,-4,-3,-3,6,2,0,0,1,-1,0,-1,6,-1
KR_6755948667,420,-3,-50,-8,-5,1,1,2,-1,3,2,2,2,4,-5,6,1,-2,2,0,0,1,1,2,-4,2,-2,0,1,-1,1,1,-1,2,-1
KR_6733377652,420,-7,-138,-88,-11,-2,3,1,-5,5,0,3,1,4,-7,8,1,0,0,0,0,-3,-5,-2,0,2,1,0,0,0,0,-1,1,0,-1
KR_6662628117,420,-2,-13,1,-10,-4,5,1,-1,3,2,-3,5,2,-1,2,1,-1,2,1,0,-7,-45,2,-5,3,1,0,0,-1,-1,-1,-1,1,-1
KR_6728766079,440,-3,-34,-8,-6,-6,6,0,1,0,1,0,1,1,-1,2,1,0,2,2,0,-3,2,-3,-3,6,2,0,-1,1,-1,-1,-1,4,-1
KR_6686917519,440,-3,-21,5,-6,-3,4,1,-5,8,3,3,4,7,-1,3,2,0,3,3,2,-6,20,-6,-1,7,-1,0,0,1,1,0,1,4,-1
KR_6754762443,420,-3,16,-35,-8,-3,3,0,-4,6,2,1,0,1,-1,1,0,-1,2,1,0,-5,1,-5,0,5,0,0,-1,-1,-1,-1,-1,6,-1
KR_6755664504,440,-5,-31,-24,-11,1,0,1,-3,6,3,-2,3,1,-7,7,0,0,0,0,0,-6,2,4,-9,5,-6,0,-2,-1,-1,-1,1,6,-1
KR_6540333149,420,1,4,-12,-3,1,3,4,-3,5,2,1,3,4,-2,2,0,0,1,1,0,-4,16,-5,-1,6,1,0,0,-1,-1,-1,1,5,-1
KR_6650988931,420,-3,-65,-1,-6,-1,1,0,-2,5,3,3,2,5,-2,4,2,-4,4,0,0,-4,-62,2,-4,2,21,0,-1,-1,-1,-1,1,2,-1
KR_6760707185,440,-3,-118,-32,-8,-4,5,1,-1,3,2,-6,8,2,2,0,2,1,0,1,0,4,-1,0,-2,2,2,0,-2,-1,-1,-1,-1,4,-1
KR_6604614373,420,0,-43,25,-2,3,0,3,4,0,4,-2,6,4,-4,4,0,-3,3,0,0,-5,-10,-2,-2,4,1,0,1,-1,-1,1,-1,5,-1
KR_6758000773,420,1,43,-24,1,-2,5,3,1,2,3,5,2,7,0,4,4,-3,4,1,1,1,9,0,-1,1,2,0,0,-1,1,0,1,2,-1
KR_6695680366,420,0,57,-24,4,0,2,2,2,4,6,3,1,4,-2,3,1,1,1,2,0,3,143,0,-4,4,-3,0,0,-1,0,1,-1,6,-1
KR_6761429661,420,-1,-3,10,-2,6,2,8,3,1,4,-4,5,1,-5,5,0,-2,2,0,0,-4,-7,0,-3,3,0,0,-1,1,1,-1,-1,3,-1
KR_6747102522,440,-5,-82,0,-8,-1,2,1,1,1,2,0,2,2,-8,10,2,0,1,1,0,-5,-12,-3,0,3,1,0,-1,1,1,-1,1,6,-1
KR_6748507100,420,-4,-61,-4,-5,0,3,3,2,0,2,-1,5,4,-6,7,1,0,1,1,0,-4,-9,-1,-3,4,-3,0,-2,-1,0,-1,-1,2,-1
KR_6602411627,420,0,28,4,2,1,2,3,0,1,1,2,3,5,3,3,6,-4,5,1,0,5,-2,1,-3,2,1,0,0,1,1,1,-1,1,-1
KR_6684029816,420,0,-30,0,-1,2,1,3,-1,4,3,3,1,4,-4,5,1,-1,1,0,1,-1,-3,-2,-3,5,-2,0,1,0,0,1,1,0,-1
KR_6618472136,420,-5,-23,32,-9,0,0,0,-4,4,0,1,1,2,-6,6,0,0,0,0,0,-2,49,0,-1,1,-34,0,0,1,-1,0,-1,3,-1
KR_6529498724,420,-1,-11,21,-1,1,1,2,1,1,2,2,3,5,-4,5,1,-1,3,2,0,-3,26,1,-2,1,2,0,0,-1,1,1,1,4,-1
KR_6744946248,420,1,11,0,2,-2,3,1,-1,2,1,1,1,2,2,2,4,2,1,3,0,6,3,1,-6,5,1,0,1,0,0,1,1,0,-1
KR_6749282545,420,-1,-14,-42,2,-1,2,1,3,2,5,0,3,3,0,5,5,0,2,2,1,2,1,4,-6,2,-1,0,0,0,1,0,1,0,-1
KR_6730870049,420,-1,-12,4,0,1,0,1,0,5,5,-3,7,4,3,1,4,-1,2,1,0,-11,352,1,-3,2,-3,0,1,-1,1,1,1,5,-1
KR_6727124936,420,-4,-51,-8,-10,-8,8,0,1,2,3,-4,6,2,3,2,5,-2,4,2,0,-6,0,-5,-3,8,0,0,-2,-1,-1,-1,-1,1,-1
KR_6745680223,440,2,51,4,2,0,3,3,3,3,6,2,0,2,0,0,0,-3,5,2,0,-9,234,-1,0,1,-13,0,1,1,1,1,1,2,-1
KR_6630316025,420,-5,-88,-24,-11,-1,2,1,-4,4,0,-3,3,0,-1,1,0,-2,2,0,0,-9,-72,-5,0,5,1,0,-1,-1,-1,-1,-1,5,-1
KR_6681733220,420,-2,-37,-12,0,-6,6,0,2,2,4,-2,5,3,2,0,2,4,0,4,0,11,8,2,-3,1,-1,0,0,1,-1,-1,-1,2,-1
KR_6678131930,420,1,99,40,3,4,1,5,-3,3,0,-1,3,2,2,2,4,1,1,2,1,-5,-3,0,-6,6,3,0,0,0,0,0,1,0,-1
KR_6589090696,420,-2,-56,0,-6,-6,7,1,-4,4,0,3,1,4,1,3,4,0,0,0,0,-2,-265,5,-5,0,-1,0,-1,-1,-1,-1,-1,6,-1
KR_6646275212,420,1,21,-4,-1,1,0,1,3,0,3,-4,7,3,-2,6,4,1,2,3,0,0,426,-3,-3,6,1,0,1,0,0,1,-1,0,-1
KR_6731733215,420,-3,-100,11,-7,-2,2,0,1,2,3,-3,6,3,1,1,2,-4,5,1,0,-3,-10,1,-2,1,-3,0,-1,1,-1,-1,-1,6,-1
KR_6711247945,420,-3,0,-16,-6,-1,4,3,-4,5,1,-2,3,1,-1,7,6,2,1,3,0,-9,-4,0,-2,2,1,0,-1,-1,-1,-1,1,4,-1
KR_6750030331,440,-2,-17,24,-11,1,5,6,-1,4,3,-3,3,0,-5,6,1,-3,3,0,-1,-14,104,-3,-1,4,-4,0,1,-1,0,1,-1,2,-1
KR_6736117585,420,-9,-90,-32,-17,-6,7,1,-6,6,0,1,2,3,-6,6,0,0,1,1,0,-11,7,0,-1,1,-1,0,-4,-1,-1,-1,-1,4,-1
KR_6731318917,420,1,-42,12,2,1,2,3,2,0,2,1,1,2,-3,3,0,1,0,1,-1,1,3,-1,-2,3,0,0,0,-1,0,0,-1,6,-1
KR_6729507278,420,-1,-61,4,4,0,0,0,1,1,2,-4,6,2,4,2,6,3,1,4,0,5,6,-2,-1,3,0,0,0,1,0,1,-1,6,-1
KR_6693193915,420,-3,-28,-16,0,4,0,4,0,1,1,1,1,2,-2,5,3,-3,4,1,1,-3,2,0,-6,6,-3,0,0,1,-1,-1,1,2,-1
KR_6681175786,420,-3,-68,-23,-10,-2,2,0,-5,7,2,1,3,4,-3,4,1,-1,2,1,-1,-10,127,2,-2,0,-5,0,0,-1,0,0,-1,5,-1
KR_6729625093,420,-5,-63,17,-9,-1,1,0,1,0,1,-1,3,2,-7,8,1,-1,1,0,0,-6,13,-3,-1,4,-1,0,-2,-1,1,-1,-1,6,-1
KR_6660040150,420,1,-29,-8,5,3,0,3,11,0,11,-4,9,5,-4,5,1,-1,2,1,0,2,-7,-2,0,2,1,0,-1,0,0,-1,1,0,-1
KR_6724101654,440,-5,-102,-9,-6,-2,3,1,1,1,2,-3,4,1,-1,2,1,-1,1,0,0,-4,-8,0,-4,4,-2,0,-1,-1,-1,-1,1,1,-1
KR_6764615012,440,-4,-35,-16,-8,-4,4,0,-1,1,0,-1,2,1,1,2,3,-3,3,0,0,-4,5,4,-5,1,3,0,-1,-1,1,-1,1,4,-1
KR_6741854914,440,2,71,24,5,-2,7,5,-1,1,0,0,2,2,6,0,6,2,1,3,0,0,-2,0,-3,3,0,0,2,0,1,1,1,0,-1
KR_6761486952,420,0,-11,-4,5,1,3,4,3,4,7,-1,3,2,2,3,5,0,1,1,1,1,-6,0,-4,4,3,0,1,1,1,1,-1,2,-1
KR_6637867071,420,1,-11,-8,3,2,1,3,0,1,1,-2,2,0,3,2,5,0,0,0,0,4,12,6,-9,3,-1,0,1,1,1,1,1,6,-1
KR_6744680786,420,0,6,4,-6,1,3,4,-1,3,2,-3,4,1,-4,5,1,1,2,3,-2,-9,374,2,-5,3,-1,0,1,1,-1,1,-1,6,-1
KR_6762435702,440,-3,-50,-15,-15,2,0,2,0,1,1,-18,20,2,2,2,4,-1,2,1,0,-17,-13,0,-3,3,6,0,0,-1,1,-1,-1,6,-1
KR_6739612702,440,0,-55,8,0,-2,2,0,-1,1,0,-1,3,2,3,0,3,1,0,1,0,0,-36,-6,-4,10,-1,0,-1,1,-1,-1,1,1,-1
KR_6701382708,420,0,-59,-4,3,-1,3,2,0,1,1,3,0,3,0,0,0,1,0,1,0,0,1,4,-6,2,-4,0,0,1,0,0,-1,2,-1
KR_6625213326,420,-2,-31,-27,-9,1,2,3,-1,4,3,-2,3,1,-5,6,1,-2,2,0,-2,-12,-13,-2,0,2,1,0,0,-1,-1,0,-1,2,-1
KR_6761211541,440,0,3,32,3,0,2,2,0,0,0,-6,6,0,5,0,5,4,0,4,0,6,-6,-3,-2,5,6,0,1,1,-1,1,1,1,-1
KR_6751429222,420,-3,0,-36,-8,0,2,2,-5,5,0,1,1,2,-4,5,1,0,0,0,0,-6,-1,-1,-2,3,-3,0,-1,-1,1,-1,-1,1,-1
KR_6531660231,420,0,9,-16,-3,-8,8,0,3,1,4,0,0,0,1,1,2,1,1,2,0,-5,3,0,-5,5,-2,0,0,-1,-1,-1,1,4,-1
KR_6739634942,420,-1,-46,-4,-9,2,2,4,-4,7,3,-2,4,2,-6,9,3,1,1,2,0,-4,-40,-2,0,2,16,0,0,-1,-1,1,1,6,-1
KR_6723926137,420,-1,-46,-28,2,-2,2,0,0,8,8,2,1,3,1,2,3,1,1,2,0,-1,12,2,-3,1,-2,0,0,-1,-1,0,-1,4,-1
KR_6761719612,420,0,-67,-4,-3,0,1,1,-1,2,1,-3,3,0,-1,6,5,2,2,4,0,0,265,-1,-1,2,1,0,0,1,-1,-1,1,2,-1
KR_6712199877,420,-7,-47,-51,-9,0,4,4,-5,5,0,-6,6,0,2,1,3,0,1,1,0,-11,17,1,-3,2,0,0,1,-1,1,1,1,3,-1
KR_6638795588,420,-2,-68,1,-5,1,2,3,-6,7,1,-1,3,2,-1,3,2,2,0,2,0,-8,-19,5,-7,2,-1,0,-3,1,-1,-1,1,5,-1
KR_6728669966,440,2,11,-2,3,4,0,4,0,0,0,-5,6,1,1,3,4,3,3,6,0,5,277,0,-5,5,3,0,0,0,0,0,-1,0,-1
KR_6639091053,440,1,-150,20,4,1,0,1,3,0,3,1,2,3,-2,6,4,1,0,1,1,6,-7,0,-4,4,1,0,-1,1,1,-1,1,4,-1
KR_6661537806,420,-4,-76,-4,1,-2,2,0,2,2,4,-4,6,2,5,0,5,0,2,2,0,9,0,1,-2,1,-4,0,0,-1,1,0,1,2,-1
KR_6692595746,420,-1,-24,-8,-3,-2,4,2,1,2,3,4,0,4,-1,5,4,-5,5,0,0,-3,-3,-1,-3,4,-1,0,-1,-1,0,-1,-1,2,-1
KR_6645507870,420,-4,-73,13,-12,0,1,1,-4,4,0,-1,2,1,-6,6,0,-1,1,0,0,-15,-20,-2,-3,5,2,0,-1,-1,1,-1,-1,5,-1
KR_6530301326,420,-2,-45,-17,-4,-1,1,0,1,1,2,0,1,1,1,0,1,-5,5,0,0,-4,11,1,-5,4,-3,0,-1,1,1,-1,-1,1,-1
KR_6666173567,420,-2,-11,10,-4,1,0,1,-6,6,0,1,0,1,1,1,2,-1,1,0,0,-12,45,2,-6,4,-6,0,0,1,-1,0,-1,6,-1
KR_6604282069,420,0,45,-4,-2,1,2,3,2,0,2,-6,7,1,1,3,4,0,1,1,0,3,-3,-1,-2,3,-2,0,0,1,0,0,-1,2,-1
KR_6538007019,420,-6,-75,-16,-10,0,1,1,-2,2,0,-1,2,1,-7,8,1,0,1,1,-2,-9,-29,4,-6,2,13,0,-1,-1,-1,-1,-1,3,-1
KR_6709801405,420,-9,-109,-24,-9,-1,4,3,5,1,6,-2,2,0,-7,7,0,-4,4,0,0,-3,-45,-2,0,2,6,0,-2,1,-1,-1,-1,2,-1
KR_5999721944,420,-5,-46,-12,-6,-6,7,1,1,4,5,0,3,3,-1,2,1,0,0,0,0,2,-15,0,-2,2,2,0,-3,-1,-1,-1,1,1,-1
KR_6755565022,420,1,-51,-22,5,-3,4,1,5,2,7,-1,7,6,3,1,4,1,0,1,1,9,-12,3,-5,2,2,0,0,-1,1,0,1,3,-1
KR_6729531210,420,-2,1,-26,-7,-3,4,1,-3,3,0,-2,5,3,2,1,3,-1,1,0,0,-2,-5,2,-4,2,0,0,-1,-1,1,-1,1,2,-1
KR_6599266367,420,-8,-138,-20,-21,-6,8,2,-6,7,1,-2,4,2,-4,4,0,-3,3,0,-1,-14,14,-3,-2,5,-2,0,-3,-1,-1,-1,-1,1,-1
KR_6653312216,440,-8,-83,-25,-15,-1,3,2,1,4,5,-8,9,1,-6,10,4,-1,1,0,-1,-6,-33,-3,-2,5,1,0,-3,-1,1,-1,-1,5,-1
KR_6757975623,440,-1,40,-4,1,-6,7,1,0,5,5,3,0,3,-1,3,2,5,1,6,0,5,2,2,-7,5,-1,0,0,1,-1,-1,-1,6,-1
KR_6730766061,420,-1,-37,28,-3,-1,1,0,0,3,3,4,2,6,-7,9,2,1,1,2,0,-1,23,0,-3,3,-1,0,-1,1,0,-1,-1,6,-1
KR_6751515641,420,-3,-24,4,-5,1,3,4,-3,4,1,-5,5,0,2,3,5,0,1,1,1,-7,-6,-4,-1,5,2,0,-1,-1,1,-1,1,4,-1
KR_6643208054,420,-1,-25,1,-4,-4,5,1,-2,3,1,-2,2,0,3,0,3,1,1,2,0,-2,4,-2,0,2,-1,0,-1,1,-1,-1,1,3,-1
KR_6618192338,420,-4,-38,-32,-6,-1,2,1,0,3,3,-7,8,1,2,4,6,0,3,3,1,3,-3,-2,-1,3,1,0,-2,-1,0,-1,1,1,-1
KR_6667520194,440,3,82,6,8,1,2,3,6,1,7,3,1,4,-2,2,0,0,4,4,2,9,0,1,-7,6,-1,0,1,1,0,1,1,1,-1
KR_6730130669,420,-3,-60,16,-5,-1,2,1,-1,2,1,0,3,3,-1,1,0,-2,2,0,0,-5,0,-1,0,1,0,0,0,-1,-1,-1,-1,3,-1
KR_6681186929,420,-6,-129,-44,-19,-1,3,2,-7,8,1,0,1,1,-7,11,4,-4,4,0,-2,-26,-80,1,-3,2,5,0,-3,0,0,-1,-1,0,-1
KR_6740455962,420,-2,42,-15,2,1,0,1,1,2,3,0,1,1,1,5,6,-1,3,2,0,4,0,2,-3,1,0,0,1,1,-1,1,1,2,-1
KR_6719132388,440,-1,-52,4,-3,1,1,2,3,3,6,-4,5,1,-2,4,2,-1,1,0,0,-5,-1,-1,-3,4,0,0,-1,1,1,-1,-1,4,-1
KR_6211807139,420,-3,-62,-33,-2,5,0,5,-9,9,0,-3,3,0,0,1,1,5,2,7,0,-7,-13,-3,-1,4,-1,0,-1,-1,0,-1,-1,2,-1
KR_6697026307,420,-6,-69,-33,-13,-4,5,1,0,1,1,-2,4,2,-7,15,8,0,1,1,0,-4,-11,-7,0,7,2,0,-1,-1,0,-1,-1,2,-1
KR_6712482910,420,-3,-49,-10,0,4,0,4,-1,3,2,-1,3,2,-2,2,0,0,3,3,0,1,256,2,-7,5,-4,0,-1,-1,1,-1,-1,6,-1
KR_6743610432,420,-1,-64,25,-6,-6,6,0,3,1,4,-5,5,0,0,5,5,2,2,4,0,1,-27,2,-4,2,-4,0,-1,1,1,-1,-1,6,-1
KR_6098609528,420,-5,-55,-30,-5,-4,4,0,0,1,1,-2,5,3,2,1,3,-1,1,0,-1,-1,-1,-2,-3,5,5,0,-1,1,0,-1,-1,4,-1
KR_6645299356,420,-3,-36,0,-12,-4,4,0,1,1,2,-3,4,1,-5,5,0,-1,3,2,0,-12,1,-2,-2,4,-5,0,-2,-1,0,-1,-1,2,-1
KR_6636520804,440,4,53,-12,7,-2,3,1,6,2,8,-1,1,0,4,0,4,0,0,0,0,10,-20,-2,-3,5,0,0,0,-1,-1,0,-1,4,-1
KR_6501225593,420,-2,26,-3,-2,1,0,1,-1,3,2,-2,6,4,1,0,1,-1,2,1,1,0,-7,-8,-4,12,3,0,-1,1,0,-1,1,4,-1
KR_6324175822,420,-3,-87,0,-7,1,1,2,-2,3,1,-5,10,5,-4,5,1,3,2,5,0,2,-11,-1,-5,6,3,0,-1,-1,0,-1,-1,1,-1
KR_6726591892,420,-1,-90,-36,5,4,2,6,-4,4,0,-3,3,0,5,2,7,3,0,3,1,9,7,2,-7,5,-1,0,0,1,-1,-1,1,2,-1
KR_6753881684,420,1,-57,-24,7,3,1,4,3,1,4,0,1,1,1,3,4,0,4,4,0,10,39,0,-1,1,-1,0,0,0,-1,0,-1,0,-1
KR_6742054463,420,1,-3,8,2,5,0,5,0,3,3,5,1,6,-3,5,2,-5,6,1,1,-2,-3,1,-2,1,-2,0,1,1,1,1,1,4,-1
KR_6732332841,420,-2,-24,-17,-8,-3,4,1,-3,4,1,-4,4,0,2,2,4,0,0,0,0,-6,3,-2,-2,4,1,0,-2,-1,-1,-1,1,3,-1
KR_6743206414,440,-1,-18,4,-4,1,1,2,-5,6,1,0,3,3,0,2,2,0,0,0,0,0,-1,1,-1,0,0,0,0,-1,0,0,-1,3,-1
KR_6628076324,420,-1,24,-8,-4,-1,1,0,-6,7,1,-3,5,2,3,1,4,3,1,4,0,-1,145,1,-2,1,-3,0,-1,-1,0,-1,1,5,-1
KR_6756785133,420,2,-23,0,9,3,1,4,2,0,2,4,1,5,-1,5,4,1,0,1,0,3,275,3,-5,2,4,0,-1,0,-1,1,-1,0,-1
KR_6695165574,420,0,52,-15,2,2,2,4,4,1,5,-2,2,0,-2,2,0,0,1,1,0,5,-175,2,-5,3,2,0,2,1,1,1,-1,3,-1
KR_6607308709,420,-1,35,0,-7,-5,5,0,-2,4,2,0,4,4,1,1,2,-1,5,4,0,-12,145,-7,-1,8,-24,0,1,-1,0,1,1,2,-1
KR_6759937716,420,-3,-71,-12,-2,-2,3,1,2,2,4,-1,3,2,0,0,0,-1,1,0,0,-3,208,-2,0,2,-1,0,-2,-1,-1,-1,1,2,-1
KR_6626623638,420,-10,-139,-24,-20,0,2,2,-5,5,0,-6,7,1,-8,8,0,-1,1,0,0,-29,-7,-3,-1,4,0,0,-3,-1,-1,-1,-1,4,-1
KR_6648080615,420,0,-1,-16,-1,-1,1,0,5,0,5,-1,3,2,-4,8,4,0,1,1,0,1,10,2,-7,5,-7,0,0,-1,1,0,1,5,-1
KR_6683711658,420,1,39,0,2,4,1,5,-3,6,3,-1,3,2,2,0,2,0,0,0,0,2,24,-3,-4,7,-5,0,1,-1,1,1,-1,2,-1
KR_6646354494,420,2,-20,0,1,-3,4,1,2,2,4,4,3,7,3,0,3,-5,5,0,0,5,5,0,-1,1,1,0,0,1,-1,0,1,1,-1
KR_6764503418,440,2,29,26,1,1,4,5,2,3,5,-1,2,1,-1,3,2,0,0,0,0,-4,-14,1,-3,2,2,0,1,-1,1,1,1,2,-1
KR_6722543904,440,-2,-70,8,-3,0,1,1,0,1,1,-1,3,2,-3,6,3,1,0,1,-2,-3,-32,-3,0,3,13,0,0,0,1,0,-1,0,-1
KR_6757930785,420,-3,2,-17,-2,0,0,0,0,3,3,-3,4,1,2,0,2,-1,5,4,0,-2,5,-5,0,5,0,0,-1,-1,-1,-1,1,3,-1
KR_6635920169,440,1,18,0,3,4,1,5,0,5,5,2,2,4,-3,6,3,0,0,0,2,1,20,-1,-2,3,-1,0,1,-1,-1,1,1,4,-1
KR_6678592313,420,-7,-100,-4,-23,-6,6,0,-4,4,0,-5,5,0,-6,6,0,-2,2,0,0,-19,-2,-3,-2,5,0,0,-3,-1,-1,-1,-1,4,-1
KR_6709129020,420,-6,-58,-47,-5,3,0,3,2,1,3,-1,3,2,-7,7,0,-2,2,0,0,2,2,-6,0,6,0,0,-1,-1,-1,-1,-1,5,-1
KR_6626457176,420,-3,2,-37,-11,-1,1,0,-5,6,1,1,1,2,-7,12,5,1,0,1,0,-8,200,0,-2,2,-5,0,-1,-1,-1,-1,-1,6,-1
KR_6694370813,420,-2,-68,-12,3,1,3,4,0,2,2,3,2,5,0,6,6,-1,1,0,0,4,1,0,-4,4,-1,0,-1,-1,1,-1,1,4,-1
KR_6760634975,420,-5,-8,-9,-19,2,0,2,1,0,1,-12,13,1,-8,9,1,-2,3,1,-1,-13,6,-2,-3,5,0,0,-1,-1,-1,-1,-1,2,-1
KR_6669593822,420,-1,11,-20,-9,-1,1,0,-2,3,1,-1,3,2,-5,5,0,0,1,1,0,-11,-8,-1,-2,3,1,0,0,1,-1,0,-1,3,-1
KR_6418646194,420,3,10,9,2,1,3,4,0,1,1,-7,7,0,7,0,7,1,0,1,-1,-6,6,1,-1,0,0,0,1,1,1,-1,-1,5,-1
KR_6727021500,420,-2,28,26,-2,-1,3,2,0,3,3,-1,4,3,2,1,3,-2,2,0,0,-6,-8,-1,-2,3,1,0,0,1,-1,-1,-1,3,-1
KR_6757136758,420,-1,-16,-16,-3,0,1,1,-2,4,2,-1,4,3,1,3,4,-1,2,1,-2,-10,19,-2,-2,4,-3,0,1,-1,1,1,-1,3,-1
KR_6638535690,440,-2,-71,17,-4,1,1,2,1,1,2,-2,4,2,-1,2,1,-3,4,1,0,-6,-307,-2,-2,4,-1,0,-1,-1,0,-1,1,5,-1
KR_6729217963,420,1,56,-12,-9,1,2,3,-1,2,1,-4,4,0,0,2,2,-5,6,1,0,-14,10,-5,-1,6,-1,0,1,0,1,1,1,0,-1
KR_6668867239,440,1,-15,8,3,-1,2,1,6,0,6,4,2,6,-6,6,0,0,1,1,0,1,10,0,-3,3,1,0,0,1,-1,0,1,2,-1
KR_6702646504,420,-3,15,-17,-7,-2,2,0,-1,5,4,-1,2,1,-2,4,2,-1,2,1,0,-8,345,-2,-4,6,4,0,-2,-1,-1,-1,1,3,-1
KR_6743673602,420,1,-23,18,1,0,1,1,2,1,3,-1,1,0,2,1,3,-2,3,1,0,1,-10,-3,-6,9,3,0,0,-1,1,0,-1,2,-1
KR_6748062517,420,-6,-55,-28,-3,0,1,1,0,0,0,0,4,4,-1,1,0,-2,3,1,0,-10,187,5,-8,3,-8,0,-1,-1,-1,-1,1,6,-1
KR_6745840732,420,-1,-103,-5,-8,-6,6,0,9,1,10,-2,5,3,-7,8,1,-2,6,4,0,5,2,1,-4,3,-1,0,-4,-1,-1,-1,1,4,-1
KR_6728637024,440,-2,-94,56,-7,-1,1,0,-2,2,0,-5,5,0,1,0,1,0,2,2,1,-6,3,-4,0,4,-2,0,0,-1,1,0,1,4,-1
KR_6733328021,420,-5,-6,-72,-4,3,1,4,-1,1,0,-3,5,2,-5,6,1,2,2,4,0,-4,-4,2,-2,0,-2,0,0,-1,0,0,1,6,-1
KR_6047568468,440,-5,-37,-28,-7,3,0,3,-6,7,1,-1,4,3,-2,3,1,-1,1,0,0,-5,7,3,-8,5,-2,0,0,0,0,0,-1,0,-1
KR_6648547665,420,-3,-44,-10,-4,-3,4,1,1,1,2,0,2,2,-2,2,0,0,3,3,0,-4,-2,-1,0,1,0,0,-1,-1,0,-1,1,1,-1
KR_6648682816,420,2,-26,0,3,-3,3,0,1,4,5,-2,4,2,7,1,8,0,2,2,0,8,-32,3,-4,1,8,0,0,1,-1,0,1,1,-1
KR_6753339759,440,-2,-56,0,1,-4,4,0,1,1,2,10,0,10,-4,6,2,-2,2,0,0,-3,2,-1,-3,4,-3,0,0,1,0,0,1,2,-1
KR_6739065853,420,4,72,-3,6,1,1,2,1,2,3,-2,2,0,4,2,6,2,1,3,0,3,-1,0,-4,4,8,0,1,0,0,1,1,0,-1
KR_6652838177,420,-1,-9,7,-3,-5,7,2,1,1,2,-2,2,0,3,4,7,0,1,1,0,6,-7,2,-3,1,2,0,-1,1,-1,-1,1,4,-1
KR_6726144570,420,-2,-35,8,-5,-1,3,2,4,1,5,-4,4,0,-4,5,1,0,1,1,-1,-3,-179,0,-3,3,0,0,-2,-1,-1,-1,-1,1,-1
KR_6724391091,420,-2,-84,-9,-11,-1,1,0,-3,6,3,-1,2,1,2,0,2,-8,9,1,0,-13,-3,-1,-2,3,0,0,-1,-1,-1,-1,-1,3,-1
KR_5597575674,420,-1,-4,-11,-5,-1,1,0,-4,5,1,-1,3,2,1,1,2,0,0,0,0,-2,-5,-4,0,4,1,0,0,0,-1,0,-1,0,-1
KR_6717413641,420,-3,-60,-24,-7,6,0,6,-7,7,0,-1,2,1,-2,3,1,-3,3,0,-1,-9,2,0,-5,5,4,0,1,-1,-1,1,-1,1,-1
KR_6609985371,420,-2,-22,-19,-8,1,2,3,-1,4,3,-5,6,1,-2,4,2,-1,6,5,0,-5,-2,-4,-2,6,3,0,0,0,-1,0,1,0,-1
KR_6749680393,420,-3,-93,-36,-8,-4,5,1,-3,3,0,-1,1,0,-2,3,1,2,1,3,0,-4,-27,-2,-3,5,3,0,-1,-1,-1,-1,-1,3,-1
KR_6757152064,420,-6,-112,-24,-8,-1,2,1,-2,2,0,-4,4,0,-1,1,0,0,0,0,0,-10,-24,-1,-1,2,1,0,-2,-1,-1,-1,-1,2,-1
KR_6086263542,420,-4,-69,-14,-9,1,4,5,-3,4,1,-5,6,1,-4,5,1,2,1,3,0,-6,-21,0,-6,6,-5,0,-2,-1,-1,-1,-1,5,-1
KR_6292018001,420,-3,29,-8,-6,0,0,0,-9,12,3,1,1,2,2,1,3,0,1,1,0,-15,25,4,-6,2,-27,0,0,-1,1,0,1,5,-1
KR_6641278904,420,-2,-3,-36,-4,2,0,2,0,1,1,-4,4,0,-2,3,1,0,0,0,0,-8,-11,0,-2,2,0,0,-1,-1,-1,-1,1,4,-1
KR_6727682411,420,1,-6,12,-5,-4,4,0,0,4,4,2,0,2,-2,5,3,-1,1,0,-1,-6,-50,-4,0,4,15,0,-2,1,-1,-1,-1,3,-1
KR_6624506213,420,-3,-12,-24,-14,-6,7,1,-1,4,3,0,2,2,-3,5,2,-4,6,2,0,-3,-6,-1,-1,2,1,0,-2,1,1,-1,1,6,-1
KR_6676636080,420,1,51,0,-4,1,1,2,-1,3,2,-4,6,2,1,1,2,-1,1,0,0,-4,2,-3,-3,6,1,0,0,1,-1,0,-1,5,-1
KR_6755085997,440,-2,-33,-16,-6,-1,5,4,-2,2,0,1,0,1,-2,4,2,-2,3,1,0,-7,-9,3,-5,2,-4,0,-1,-1,0,-1,-1,5,-1
KR_6734595229,420,-2,-8,-4,-9,-4,4,0,-2,4,2,-5,6,1,1,2,3,1,0,1,0,-9,-2,0,-5,5,0,0,0,-1,-1,0,-1,1,-1
KR_6635975897,440,-3,-38,-15,-6,-7,9,2,2,4,6,-5,5,0,4,5,9,0,3,3,0,-6,-1,0,-4,4,2,0,0,1,-1,-1,1,1,-1
KR_6729140494,420,-4,-34,3,5,0,2,2,2,3,5,-2,2,0,3,0,3,2,1,3,0,9,-7,0,-3,3,2,0,0,-1,-1,0,1,3,-1
KR_6630353972,420,0,24,-19,1,-5,5,0,0,2,2,6,1,7,-1,5,4,1,0,1,1,9,9,-2,-4,6,1,0,-2,1,-1,-1,1,2,-1
KR_6366999922,440,-2,-32,-13,-6,-6,6,0,2,1,3,1,5,6,-2,9,7,-1,3,2,-2,-3,0,0,0,0,3,0,-2,-1,-1,-1,-1,5,-1
KR_6719289094,420,0,2,24,1,1,0,1,-1,1,0,1,5,6,-1,4,3,1,1,2,-1,-3,-3,-3,-2,5,0,0,0,-1,0,0,-1,5,-1
KR_6662170735,420,1,5,5,0,2,0,2,5,2,7,-2,3,1,-5,6,1,0,1,1,1,-4,-19,-2,-5,7,21,0,0,1,-1,-1,1,3,-1
KR_6707624642,420,0,-29,2,1,0,1,1,3,2,5,-2,4,2,-4,4,0,4,0,4,0,4,8,-1,-1,2,2,0,0,1,-1,0,-1,2,-1
KR_6673972975,420,-5,-86,-38,-14,-4,5,1,0,1,1,-3,6,3,-2,6,4,-5,6,1,0,-8,-3,-1,0,1,0,0,-3,-1,-1,-1,-1,1,-1
KR_6759928267,440,-9,-97,-36,-13,0,2,2,-9,12,3,3,0,3,-1,4,3,-6,8,2,-2,-10,-11,-1,-1,2,-1,0,-2,1,0,-1,-1,1,-1
KR_6689262964,440,1,-41,-8,-1,1,0,1,2,3,5,1,2,3,-4,8,4,-1,1,0,4,7,-5,-3,-1,4,0,0,-1,-1,-1,-1,1,5,-1
KR_6751226990,440,1,-42,-1,1,-5,5,0,2,1,3,4,0,4,1,1,2,-1,2,1,0,2,1,0,-7,7,-1,0,-1,1,-1,-1,-1,1,-1
KR_6661652249,420,-2,9,4,0,-2,2,0,2,1,3,0,5,5,1,2,3,-1,2,1,0,8,-1,0,-1,1,3,0,-1,1,-1,-1,1,6,-1
KR_6693130469,420,-6,-117,-16,-9,-2,4,2,0,3,3,-3,5,2,-3,4,1,-1,1,0,0,-3,255,-3,-1,4,1,0,0,1,-1,-1,1,1,-1
KR_6734404787,420,0,46,-4,-1,3,0,3,2,0,2,-2,2,0,-3,5,2,-1,3,2,1,-2,-11,-2,-4,6,4,0,-1,1,-1,-1,1,3,-1
KR_6633986673,420,-1,-41,-16,-5,0,2,2,-1,3,2,-1,1,0,-4,6,2,1,1,2,0,-1,99,2,-3,1,-2,0,0,1,-1,-1,-1,4,-1
KR_6759618101,420,-1,-12,-39,0,-6,6,0,-3,6,3,5,0,5,3,3,6,1,0,1,0,-1,6,1,-4,3,-2,0,1,-1,0,1,-1,4,-1
KR_6472986218,420,5,89,8,4,3,0,3,2,2,4,-1,3,2,1,1,2,-1,2,1,0,3,1,-2,-4,6,-1,0,0,0,0,0,1,0,-1
KR_6648548716,420,5,29,16,4,1,0,1,7,0,7,-1,1,0,-1,2,1,-2,3,1,0,10,-360,2,-4,2,-1,0,0,-1,-1,0,-1,3,-1
KR_6528273366,420,2,-75,1,5,1,1,2,1,2,3,0,1,1,1,0,1,2,0,2,0,5,0,-1,-5,6,-1,0,-1,-1,-1,-1,-1,5,-1
KR_6642145546,420,-4,-21,25,-10,0,1,1,-4,7,3,-3,4,1,-2,3,1,-1,1,0,0,-12,4,-3,-2,5,-2,0,-2,0,-1,-1,-1,0,-1
KR_6717717833,440,-2,-19,32,-9,-2,6,4,0,2,2,-3,3,0,-6,9,3,2,0,2,1,-16,-16,-2,-1,3,1,0,-2,-1,-1,-1,1,2,-1
KR_6737461092,440,-2,48,17,-2,4,1,5,-2,2,0,-1,4,3,1,4,5,-4,5,1,0,-4,4,5,-9,4,0,0,0,1,1,-1,1,5,-1
KR_6743465293,420,-1,-19,11,1,5,0,5,-2,5,3,-1,2,1,0,3,3,-1,1,0,0,-9,-1,1,-3,2,-1,0,1,-1,1,1,-1,6,-1
KR_6746155180,420,0,-60,-4,0,-1,2,1,-2,3,1,10,3,13,-6,6,0,-1,1,0,0,2,20,1,-5,4,-3,0,-2,1,-1,-1,1,6,-1
KR_6637157220,420,0,54,-12,1,0,0,0,-7,7,0,2,1,3,5,1,6,1,0,1,0,-2,10,5,-6,1,-2,0,-1,-1,-1,-1,-1,3,-1
KR_6722717631,440,1,-10,-4,2,5,0,5,-2,4,2,1,3,4,2,1,3,-4,5,1,-2,-4,7,-2,-2,4,3,0,0,1,-1,0,-1,2,-1
KR_6756948016,420,3,-62,24,-5,3,1,4,3,4,7,-5,6,1,-6,8,2,0,0,0,-3,-6,-1,-5,0,5,1,0,0,-1,-1,-1,-1,1,-1
KR_6764390425,420,-1,-10,16,-1,1,2,3,0,4,4,-1,2,1,-1,4,3,0,0,0,0,0,-7,2,-5,3,7,0,-1,1,-1,-1,-1,6,-1
KR_6759274653,420,-4,-94,-8,2,-1,4,3,0,4,4,0,1,1,2,1,3,1,2,3,0,5,-9,0,-1,1,1,0,-2,1,-1,-1,-1,5,-1
KR_6652177137,420,-9,-150,-68,-17,1,0,1,1,0,1,-9,9,0,-4,4,0,-6,7,1,-1,-9,-39,-1,-3,4,26,0,-1,-1,-1,-1,-1,5,-1
KR_6760303129,440,0,-25,-1,-2,0,1,1,-3,3,0,1,2,3,0,1,1,0,0,0,0,-6,-4,1,-4,3,1,0,0,-1,0,0,1,5,-1
KR_6483803502,420,-1,-89,20,4,-2,2,0,6,3,9,4,1,5,-4,6,2,0,0,0,0,0,2,3,-4,1,-3,0,-3,-1,1,-1,1,4,-1
KR_6759280864,420,-6,-106,-33,-16,-2,5,3,0,0,0,-5,5,0,-4,5,1,-5,5,0,0,-11,-6,2,-6,4,-4,0,-3,-1,0,-1,-1,6,-1
KR_6751654759,420,-2,-86,16,-12,-5,6,1,0,2,2,-5,6,1,-2,3,1,0,1,1,0,-5,-3,-4,0,4,-2,0,-2,-1,0,-1,1,3,-1
KR_6642731525,420,-1,-65,20,2,1,0,1,0,2,2,1,1,2,1,1,2,-1,2,1,1,5,-5,-1,-4,5,-2,0,-1,-1,-1,-1,1,4,-1
KR_6723414493,420,1,-51,-18,3,3,0,3,2,1,3,-1,10,9,-1,2,1,0,0,0,0,5,4,1,-3,2,-2,0,0,0,-1,-1,-1,0,-1
KR_6758600710,420,-1,65,-7,-7,0,1,1,-4,4,0,-2,2,0,-1,4,3,0,3,3,0,-5,52,1,-5,4,-1,0,1,1,1,1,-1,1,-1
KR_6592083034,420,0,-31,16,-3,3,1,4,4,2,6,-3,4,1,-4,5,1,-3,3,0,0,-3,15,5,-7,2,-7,0,1,-1,0,-1,1,4,-1
KR_6514297845,440,-4,-76,-4,-6,0,4,4,0,2,2,-3,3,0,-3,5,2,0,2,2,0,-8,260,6,-8,2,-1,0,0,1,0,0,1,2,-1
KR_6756199459,420,2,-50,6,5,-1,2,1,5,2,7,-1,4,3,0,6,6,2,0,2,0,11,-12,-5,-2,7,3,0,-1,1,-1,-1,-1,5,-1
KR_6631496805,420,-3,-13,-22,-4,-2,5,3,1,0,1,3,2,5,-4,6,2,-2,3,1,-1,-3,-1,0,-6,6,-3,0,-2,-1,1,-1,-1,4,-1
KR_6715830537,440,-2,8,-21,-11,1,0,1,-7,11,4,-4,5,1,-1,2,1,0,3,3,0,-2,-101,-1,-1,2,1,0,-1,1,-1,-1,-1,1,-1
KR_6632267464,420,-1,0,-24,-3,-1,1,0,1,3,4,1,0,1,-1,3,2,-3,4,1,0,-3,-10,-2,-4,6,-3,0,-1,-1,0,-1,-1,5,-1
KR_6670600297,420,2,54,36,2,1,4,5,3,2,5,-5,6,1,2,2,4,1,0,1,0,-2,-3,3,-5,2,2,0,2,0,0,1,-1,0,-1
KR_6722512020,440,4,15,-15,2,2,0,2,-10,12,2,1,0,1,5,0,5,4,0,4,0,3,30,-2,-3,5,1,0,1,1,-1,-1,-1,3,-1
KR_6662731586,420,-3,28,-20,-5,7,0,7,0,1,1,0,3,3,-6,8,2,-6,7,1,2,-9,-10,-2,-5,7,4,0,0,-1,-1,0,1,6,-1
KR_6737400148,420,-1,-58,-5,-11,-1,3,2,-2,3,1,-4,5,1,-3,5,2,-1,3,2,-1,-9,6,-3,-2,5,0,0,0,0,0,1,-1,0,-1
KR_6639311573,420,-3,-66,-32,-2,-1,2,1,-1,3,2,-7,8,1,6,0,6,1,1,2,0,10,-20,1,-6,5,1,0,0,1,0,0,1,3,-1
KR_6756009552,420,-5,-30,-7,-7,1,2,3,1,2,3,-5,8,3,-5,5,0,1,1,2,-1,-7,-6,-4,0,4,1,0,-1,-1,-1,-1,-1,6,-1
KR_6615768450,420,0,95,16,1,-3,3,0,2,1,3,1,2,3,1,2,3,0,0,0,0,8,-271,3,-4,1,-1,0,-1,0,0,-1,1,0,-1
KR_6745580569,420,-3,-57,-16,-4,-2,3,1,-3,3,0,-1,3,2,-3,5,2,5,3,8,0,1,-4,-3,0,3,0,0,-2,-1,0,-1,1,6,-1
KR_6726798529,420,-1,-32,-16,-1,3,1,4,0,0,0,0,2,2,-5,5,0,1,0,1,0,-3,-7,-2,-4,6,-1,0,1,0,-1,1,-1,0,-1
KR_6761414813,420,0,-19,24,4,3,1,4,0,1,1,-1,3,2,2,2,4,0,0,0,0,3,-3,-1,-3,4,-2,0,1,1,1,1,-1,5,-1
KR_6760399135,420,-4,-33,-16,-12,0,2,2,1,3,4,-9,11,2,1,1,2,-5,5,0,-2,-10,-1,-2,0,2,-1,0,-1,0,-1,-1,-1,0,-1
KR_6621275417,440,-5,-40,11,-14,0,2,2,3,0,3,-9,9,0,-6,7,1,-2,3,1,0,-5,-119,-7,-2,9,2,0,-1,1,-1,-1,1,6,-1
KR_6753862200,440,0,-46,-9,0,-1,2,1,3,2,5,-1,4,3,1,1,2,-2,4,2,0,-2,-320,1,-2,1,2,0,-1,-1,-1,-1,1,2,-1
KR_6683040823,440,-1,32,-13,-6,1,1,2,-3,3,0,-1,4,3,-6,8,2,3,0,3,0,-8,0,-2,0,2,-1,0,-1,-1,0,-1,-1,1,-1
KR_6760991958,440,0,-22,16,3,-2,2,0,-1,1,0,-2,4,2,3,2,5,5,0,5,0,2,-3,0,-3,3,-2,0,0,0,0,0,1,0,-1
KR_6642832397,420,0,10,17,1,1,6,7,-2,3,1,-1,2,1,1,1,2,2,0,2,1,0,-32,-4,-1,5,-1,0,0,-1,0,1,1,3,-1
KR_6753396131,420,0,-41,8,-2,0,2,2,0,4,4,2,0,2,-4,6,2,0,0,0,1,2,-2,-2,-4,6,2,0,1,-1,0,1,1,3,-1
KR_6711170338,420,-2,-3,-23,-10,-8,9,1,-2,5,3,2,2,4,2,6,8,-4,4,0,2,-6,10,3,-3,0,2,0,-1,-1,1,-1,1,5,-1
KR_6758817556,420,0,-48,0,3,-1,2,1,-1,3,2,1,6,7,4,1,5,0,1,1,1,11,20,2,-4,2,-3,0,-1,1,-1,-1,1,3,-1
KR_6630615493,420,3,51,16,6,-1,2,1,-1,2,1,2,3,5,6,1,7,0,0,0,0,7,-1,2,-4,2,2,0,0,1,-1,0,1,2,-1
KR_6411307540,420,0,56,35,0,-2,4,2,-5,7,2,2,2,4,4,1,5,1,2,3,0,3,-16,-3,-3,6,0,0,-1,-1,1,-1,-1,1,-1
KR_6692415569,420,-2,-39,-12,-7,-4,4,0,-1,3,2,2,1,3,-1,2,1,-3,3,0,0,-4,-332,3,-6,3,-2,0,0,-1,-1,0,-1,5,-1
KR_6704037586,420,0,-12,21,-8,-1,3,2,-2,5,3,-1,2,1,-3,3,0,-1,5,4,-2,-8,-11,-4,0,4,1,0,2,-1,0,1,-1,2,-1
KR_6762284120,420,-5,21,-76,6,5,3,8,-1,1,0,-1,2,1,5,0,5,-2,2,0,0,4,2,-2,-1,3,1,0,1,0,-1,1,-1,0,-1
KR_6736976209,420,-4,-69,-47,-5,0,4,4,-1,2,1,-5,7,2,0,2,2,1,0,1,0,3,-3,1,-4,3,-1,0,-1,0,1,-1,1,0,-1
KR_6689388580,440,-2,-4,-8,0,-3,4,1,1,2,3,-2,4,2,7,0,7,-3,6,3,0,9,190,-5,-1,6,2,0,0,1,0,0,1,2,-1
KR_6684344537,420,-3,-29,-20,-4,3,0,3,-6,6,0,0,1,1,0,3,3,-1,1,0,0,-1,-394,0,-3,3,0,0,1,-1,-1,-1,-1,2,-1
KR_6749594220,420,0,-34,14,-4,2,2,4,-1,3,2,-3,5,2,-3,4,1,1,1,2,-1,-5,336,-4,0,4,-1,0,0,1,-1,0,-1,1,-1
KR_6630122077,420,2,37,-9,3,1,1,2,2,3,5,6,0,6,-5,7,2,-1,2,1,0,1,197,6,-6,0,-2,0,0,0,1,-1,-1,0,-1
KR_6752207591,440,-1,-56,16,2,0,1,1,-2,3,1,0,3,3,5,4,9,-1,2,1,0,-1,-303,1,-3,2,-1,0,0,0,1,0,-1,0,-1
KR_6503746066,420,-5,-119,-24,-16,-2,4,2,-5,5,0,-2,3,1,-6,7,1,-1,1,0,-1,-18,-30,1,-3,2,7,0,-2,0,-1,-1,-1,0,-1
KR_6723058592,420,0,5,20,2,-4,4,0,3,2,5,1,2,3,-1,2,1,3,2,5,0,0,-7,-6,0,6,0,0,0,1,-1,-1,1,6,-1
KR_6708723344,420,-5,24,-96,-1,-1,1,0,-2,2,0,0,1,1,2,3,5,0,2,2,-1,-2,-2,-4,-1,5,-1,0,0,-1,-1,0,-1,3,-1
KR_6763035020,420,-2,0,-11,3,1,0,1,-1,4,3,2,0,2,1,1,2,0,1,1,0,5,-9,-2,-2,4,-4,0,1,1,1,1,1,1,-1
KR_6759667528,440,3,81,0,5,1,2,3,5,2,7,3,1,4,-1,6,5,-3,3,0,1,-1,-58,-4,-1,5,3,0,1,1,-1,1,1,1,-1
KR_6671366829,420,0,-17,8,-3,-3,3,0,-1,4,3,-1,2,1,1,0,1,1,0,1,0,-2,8,-4,-3,7,-2,0,1,-1,1,1,-1,6,-1
KR_6752312882,420,-1,-40,-2,-7,-10,10,0,-1,3,2,3,0,3,3,0,3,-2,3,1,1,-5,-2,3,-5,2,-2,0,-1,1,-1,1,1,3,-1
KR_6693472258,420,0,-41,-6,-5,0,4,4,4,1,5,-1,1,0,-10,12,2,2,2,4,0,-3,43,-2,-4,6,-14,0,-2,-1,0,-1,-1,1,-1
KR_6717974576,440,-4,-58,0,-7,-4,5,1,3,1,4,-1,2,1,-6,7,1,1,0,1,0,-2,2,-1,-2,3,-3,0,-3,-1,-1,-1,-1,6,-1
KR_6702623638,420,6,38,8,5,6,2,8,-4,4,0,4,1,5,-1,5,4,0,1,1,1,-7,-9,-3,0,3,0,0,2,1,1,1,1,6,-1
KR_6660898863,420,-3,-29,-7,-9,0,1,1,-2,2,0,-1,4,3,-4,4,0,-2,3,1,0,-19,0,-1,-2,3,-2,0,-1,-1,-1,-1,-1,4,-1
KR_6761122102,420,-3,-15,0,-8,-5,5,0,0,5,5,-10,10,0,7,2,9,0,2,2,-1,2,8,4,-5,1,-2,0,-2,1,-1,-1,-1,5,-1
KR_6762518294,440,-1,24,-8,0,1,1,2,5,0,5,2,2,4,-6,7,1,-2,3,1,0,-4,0,2,-4,2,4,0,0,0,-1,-1,1,0,-1
KR_6714121894,420,-2,-67,-7,-5,-1,4,3,2,2,4,1,1,2,-6,6,0,-1,2,1,0,-5,-2,-3,0,3,1,0,0,-1,0,-1,-1,4,-1
KR_6758053722,420,-2,50,-5,-6,-4,6,2,-3,3,0,4,0,4,-3,5,2,0,0,0,0,-4,-2,3,-4,1,-2,0,0,-1,0,0,-1,4,-1
KR_6611521700,420,4,2,36,3,0,1,1,-2,5,3,5,1,6,1,0,1,-1,1,0,0,1,-366,0,-2,2,3,0,2,1,1,1,1,3,-1
KR_6725907318,420,-5,-71,12,-16,-4,6,2,-10,10,0,-6,7,1,2,1,3,2,0,2,0,-14,-1,0,-3,3,-3,0,-1,-1,1,-1,-1,6,-1
KR_6720372604,420,-2,-38,32,-4,-4,4,0,1,0,1,4,1,5,-4,5,1,-1,1,0,0,-4,-319,3,-3,0,0,0,-1,1,1,-1,-1,5,-1
KR_6739756790,420,-1,-63,-20,3,3,1,4,-1,1,0,1,0,1,3,3,6,-3,3,0,0,1,-38,2,-4,2,-2,0,0,1,-1,-1,1,1,-1
KR_6683736379,440,0,-42,-2,1,2,0,2,-1,1,0,0,0,0,0,1,1,0,1,1,-1,-3,-59,0,-4,4,-1,0,-1,1,-1,-1,-1,4,-1
KR_6666279918,420,-1,-52,-16,-4,-3,3,0,-1,3,2,-1,1,0,3,2,5,-2,3,1,0,-6,-27,-1,-3,4,4,0,0,-1,-1,1,1,3,-1
KR_6726621122,420,0,-8,-17,0,2,0,2,1,2,3,-4,4,0,2,3,5,-1,2,1,-1,-4,-1,0,-2,2,0,0,1,-1,1,1,-1,1,-1
KR_6728599097,420,-3,-11,16,-4,1,3,4,1,1,2,3,3,6,-6,7,1,-3,3,0,0,-6,-174,1,-1,0,-4,0,0,1,-1,-1,1,5,-1
KR_6649532922,440,-1,-29,-18,-14,-1,1,0,-1,1,0,-7,7,0,-5,6,1,0,1,1,-1,-17,-50,-4,-2,6,-1,0,-1,1,-1,-1,-1,5,-1
KR_6545456828,420,2,22,-12,0,1,0,1,-2,6,4,-1,4,3,-4,8,4,6,0,6,0,2,-9,-6,-1,7,4,0,0,-1,-1,1,-1,3,-1
KR_6759890477,420,-3,-50,8,-11,-1,4,3,0,1,1,-6,6,0,-3,4,1,-1,2,1,0,-6,-13,-2,-1,3,0,0,-2,-1,-1,-1,-1,4,-1
KR_6653414315,420,-2,-46,0,-3,2,2,4,-2,3,1,0,1,1,-4,5,1,1,1,2,0,-2,-48,-1,-1,2,10,0,-1,1,0,-1,1,2,-1
KR_6609119674,440,-2,-32,9,-8,0,0,0,-5,7,2,-2,4,2,-1,4,3,0,3,3,0,-9,7,-5,-1,6,2,0,0,-1,0,-1,-1,6,-1
KR_6637881095,420,-4,-158,-32,-7,-2,2,0,0,1,1,-2,3,1,0,2,2,-3,5,2,-1,-5,-259,0,-1,1,-1,0,0,-1,-1,-1,-1,1,-1
KR_6083956895,440,1,0,22,2,3,0,3,4,0,4,1,0,1,-4,4,0,-2,2,0,0,-5,-12,-1,-3,4,5,0,0,-1,1,1,1,4,-1
KR_6624576969,420,-4,-46,-7,-2,3,2,5,-1,5,4,-2,3,1,-1,4,3,-1,3,2,0,-5,-96,-4,-2,6,-3,0,-2,-1,1,-1,1,4,-1
KR_6724044134,420,2,11,27,9,4,0,4,0,1,1,1,3,4,2,2,4,2,2,4,1,4,163,-1,-2,3,-1,0,0,1,1,0,1,1,-1
KR_6627140841,420,-2,-141,-8,-6,0,2,2,-2,2,0,1,1,2,-2,3,1,-3,3,0,-1,-6,-39,-2,-2,4,36,0,-3,-1,-1,-1,-1,2,-1
KR_6642693023,420,-2,14,8,0,-3,3,0,0,4,4,-1,1,0,1,0,1,3,0,3,0,4,5,1,-2,1,0,0,0,1,-1,0,-1,3,-1
KR_6671276533,420,-5,-45,7,-6,-2,2,0,-2,4,2,0,3,3,0,1,1,-2,3,1,0,-8,-2,-3,-3,6,0,0,-1,-1,1,-1,-1,3,-1
KR_6733285809,420,-3,9,-32,-4,-5,6,1,-1,1,0,-2,5,3,3,0,3,1,0,1,0,2,12,-1,-2,3,1,0,-1,-1,0,-1,-1,2,-1
KR_6644134943,420,-5,-139,23,-8,0,1,1,-4,4,0,0,0,0,-2,4,2,-2,2,0,0,-11,-3,0,-5,5,-2,0,0,1,1,0,-1,3,-1
KR_6756725914,440,-2,18,-35,-8,0,3,3,-7,7,0,-2,2,0,-6,7,1,7,1,8,0,-9,120,0,-1,1,-1,0,-1,-1,-1,-1,-1,6,-1
KR_6616889745,420,1,-2,-8,2,1,3,4,1,1,2,-1,2,1,1,5,6,0,2,2,0,4,-2,-1,-3,4,-1,0,-1,-1,-1,-1,1,1,-1
KR_6691071564,440,-5,-53,-30,-8,-2,3,1,3,0,3,-2,3,1,-8,8,0,1,0,1,0,-3,-4,-2,-4,6,0,0,-1,-1,-1,-1,1,4,-1
KR_6724724253,420,0,-12,12,-3,-1,2,1,-4,4,0,1,1,2,-1,3,2,2,0,2,0,-1,0,2,-4,2,-1,0,0,-1,1,0,1,4,-1
KR_6596210279,420,-1,-48,-20,-2,1,1,2,2,0,2,0,0,0,-4,8,4,-1,1,0,0,-2,-3,3,-4,1,-1,0,-2,-1,-1,-1,-1,5,-1
KR_6753350394,440,0,64,26,-11,-1,1,0,-7,8,1,-3,4,1,0,3,3,0,0,0,0,-6,-6,1,-5,4,0,0,1,-1,1,1,-1,4,-1
KR_6715612921,440,1,1,12,-13,-7,7,0,0,3,3,-2,4,2,-5,5,0,1,2,3,-3,-5,-6,0,-9,9,1,0,0,0,-1,0,-1,0,-1
KR_6739602086,440,0,42,-12,-6,-2,3,1,-1,2,1,2,0,2,-4,7,3,-1,2,1,0,-9,92,1,-1,0,1,0,0,-1,-1,0,-1,5,-1
KR_6709294496,420,-5,3,-36,-9,1,2,3,-3,3,0,-6,6,0,0,1,1,-1,1,0,0,-11,-7,0,-3,3,-1,0,0,-1,-1,-1,1,3,-1
KR_6422157540,420,1,-17,-3,-2,-1,2,1,-2,3,1,-1,4,3,0,1,1,2,0,2,0,0,0,-1,-4,5,3,0,0,1,-1,0,-1,2,-1
KR_6702596445,420,-6,-12,-34,-6,-4,5,1,-2,4,2,3,3,6,-2,3,1,-1,2,1,0,-3,-38,1,-5,4,-2,0,0,0,-1,-1,-1,0,-1
KR_6713285316,440,0,-26,-2,-2,-4,4,0,-1,5,4,3,0,3,1,0,1,-1,1,0,0,5,0,6,-7,1,-1,0,-2,1,-1,-1,1,2,-1
KR_6640233587,420,-1,-79,-9,1,-2,2,0,1,0,1,0,3,3,2,0,2,0,0,0,0,4,-3,1,-3,2,-4,0,-1,-1,-1,-1,1,1,-1
KR_6662246268,420,0,-58,-5,0,-3,5,2,2,2,4,0,3,3,2,6,8,-1,1,0,0,0,-9,2,-4,2,3,0,1,0,1,1,-1,0,-1
KR_6461708502,420,-1,-18,-12,3,-3,3,0,2,1,3,3,0,3,1,2,3,0,1,1,-1,4,-4,-2,-2,4,-2,0,0,1,0,0,-1,1,-1
KR_6608391414,420,-3,28,31,-6,1,1,2,1,4,5,-8,9,1,0,3,3,0,0,0,1,-8,5,2,-6,4,-2,0,-1,0,-1,-1,1,0,-1
KR_6760643904,420,-1,-71,20,-8,-5,5,0,1,2,3,-3,4,1,-5,6,1,4,0,4,0,-9,11,-3,-3,6,-1,0,-3,-1,0,-1,-1,4,-1
KR_6204602356,420,-4,8,28,-15,-4,4,0,-2,2,0,-7,7,0,-2,6,4,0,2,2,-2,-28,-3,-6,-1,7,0,0,-1,-1,-1,-1,-1,4,-1
KR_6695770675,420,-3,-36,-4,-1,1,3,4,-5,7,2,-2,2,0,2,2,4,3,2,5,0,-4,5,0,-3,3,-1,0,1,1,1,1,1,4,-1
KR_6601563233,420,1,-35,-4,-5,0,1,1,0,3,3,-1,1,0,-4,4,0,0,0,0,0,-9,1,-2,-1,3,0,0,0,-1,0,0,-1,3,-1
KR_6730742079,420,-2,11,-20,-4,-1,2,1,-2,3,1,-4,5,1,1,1,2,2,0,2,0,-1,-6,-4,-2,6,0,0,1,1,1,1,-1,1,-1
KR_6744266600,420,-2,-20,-60,-1,0,1,1,0,3,3,0,2,2,0,2,2,-1,1,0,-1,-4,-44,0,-3,3,27,0,-1,-1,1,-1,-1,1,-1
KR_6725734008,420,-2,26,-28,-10,-1,3,2,-3,4,1,-3,3,0,-5,10,5,2,1,3,0,-6,-6,-7,-2,9,1,0,-1,-1,0,-1,1,6,-1
KR_6604491779,420,3,49,-20,-4,-2,5,3,-3,3,0,2,0,2,1,1,2,-2,2,0,0,1,-9,-1,-3,4,-2,0,-1,0,0,-1,-1,0,-1
KR_6725811505,420,1,-12,41,-3,-3,3,0,0,2,2,2,0,2,-1,3,2,-1,1,0,1,0,-12,1,-6,5,0,0,0,1,-1,0,1,4,-1
KR_6758354672,420,-1,14,-3,-6,-1,3,2,-2,2,0,-3,5,2,0,1,1,0,1,1,0,-5,104,1,-2,1,-1,0,-1,1,0,-1,-1,6,-1
KR_6685502799,440,-2,-44,8,-4,-1,1,0,3,0,3,1,1,2,-5,5,0,-2,2,0,0,-4,26,-3,-2,5,-33,0,1,-1,1,-1,-1,3,-1
KR_6729343686,420,-2,-30,44,-1,1,3,4,1,2,3,-3,4,1,0,2,2,0,2,2,0,0,3,-1,-4,5,1,0,0,0,0,-1,1,0,-1
KR_6723714459,420,-3,-54,-9,-7,-1,1,0,-3,5,2,-2,4,2,1,1,2,-2,2,0,0,-2,-252,0,-2,2,-3,0,-2,-1,-1,-1,-1,6,-1
KR_6738182916,420,-1,-77,-15,-3,-2,3,1,1,3,4,1,1,2,-3,3,0,0,0,0,0,1,-5,-8,-1,9,1,0,-1,-1,-1,-1,-1,1,-1
KR_6743974802,420,1,43,-36,-1,-4,4,0,1,2,3,-1,2,1,4,0,4,-1,1,0,0,-1,-237,4,-6,2,1,0,0,0,-1,0,-1,0,-1
KR_6660556801,420,-3,18,-40,-7,0,2,2,2,1,3,-3,6,3,-2,3,1,-4,4,0,0,-10,281,-7,-2,9,-2,0,-1,-1,-1,-1,-1,4,-1
KR_6745760410,420,1,35,16,-5,-4,4,0,0,3,3,-3,5,2,0,4,4,2,0,2,-4,-21,-4,-12,-2,14,6,0,-2,1,-1,-1,-1,2,-1
KR_6616846696,420,-4,-31,-9,-12,0,0,0,-2,4,2,-2,2,0,-6,6,0,-2,4,2,0,-10,181,-3,-1,4,-5,0,-1,-1,-1,-1,-1,4,-1
KR_6739169979,420,1,-28,4,5,0,1,1,7,4,11,-3,4,1,1,3,4,0,1,1,0,11,1,-3,-1,4,2,0,0,1,-1,1,-1,6,-1
KR_6638254799,420,-2,20,-8,-4,-1,2,1,-2,3,1,-5,6,1,3,2,5,1,0,1,0,1,-3,0,-5,5,7,0,-1,1,-1,-1,-1,6,-1
KR_6611481092,420,1,23,0,0,-2,2,0,-2,4,2,4,4,8,2,0,2,-2,2,0,0,-3,-129,-3,-1,4,0,0,0,-1,0,0,1,6,-1
KR_6747462451,420,2,18,-16,5,2,0,2,-2,5,3,1,1,2,4,2,6,0,1,1,0,6,-149,2,-5,3,2,0,-2,1,-1,-1,1,4,-1
KR_6658967340,420,-1,-22,4,-5,7,1,8,-4,6,2,-5,6,1,-4,4,0,1,0,1,0,-9,-31,-2,-1,3,0,0,0,1,-1,-1,-1,4,-1
KR_6631589973,420,-1,-6,-22,-10,1,1,2,2,0,2,-7,7,0,-4,5,1,-2,2,0,0,-10,17,-2,-3,5,-14,0,0,-1,-1,0,-1,4,-1
KR_6655546468,420,-1,-43,18,-2,-2,5,3,4,1,5,-2,4,2,-1,3,2,-1,1,0,0,0,33,-1,-4,5,-9,0,0,1,-1,1,-1,6,-1
KR_6671988584,420,0,9,22,-7,0,3,3,-2,2,0,2,1,3,-6,6,0,-1,1,0,-1,-11,13,1,-3,2,0,0,0,0,-1,1,-1,0,-1
KR_6637954775,420,-4,-49,-12,-2,1,1,2,0,2,2,-1,3,2,0,4,4,-2,2,0,0,4,-2,-2,-2,4,-1,0,-1,1,-1,-1,-1,2,-1
KR_6585705518,420,6,21,25,9,-1,1,0,7,1,8,-2,4,2,-1,4,3,6,1,7,0,6,15,-1,0,1,2,0,1,1,0,-1,-1,3,-1
KR_6662526148,420,-3,31,-32,-1,1,1,2,1,2,3,-1,3,2,-3,3,0,1,1,2,0,2,180,-6,-1,7,-2,0,-2,-1,-1,-1,1,4,-1
KR_6729655524,420,2,26,-1,2,1,0,1,-1,2,1,1,3,4,3,1,4,-2,2,0,0,3,4,-2,-3,5,2,0,0,-1,0,0,-1,3,-1
KR_5754755184,420,-6,-68,-20,-14,-3,3,0,-4,6,2,-3,3,0,-2,2,0,-2,4,2,-1,-14,8,-2,-3,5,-3,0,-1,-1,-1,-1,-1,4,-1
KR_6758349884,420,-5,-39,-18,-9,2,1,3,-3,5,2,-1,1,0,-5,5,0,-2,5,3,0,-9,-10,1,-3,2,-4,0,0,1,-1,0,-1,1,-1
KR_6708906887,440,-1,-3,-32,-10,-4,4,0,0,1,1,4,2,6,-5,5,0,-5,6,1,-1,-9,2,-1,-2,3,-5,0,0,0,-1,-1,-1,0,-1
KR_6684239011,420,-5,-157,-8,-14,-5,5,0,1,3,4,-1,2,1,-4,5,1,-5,5,0,-2,-7,38,2,-4,2,-13,0,-1,-1,-1,-1,-1,2,-1
KR_6741283437,440,-3,-130,-20,-8,3,3,6,-7,8,1,-1,1,0,3,2,5,-6,6,0,0,-4,-2,-1,-1,2,2,0,-2,-1,-1,-1,-1,5,-1
KR_6623803398,420,-5,-70,-8,-9,-7,7,0,2,4,6,-4,4,0,-1,6,5,1,2,3,3,6,-10,1,-4,3,0,0,-4,-1,-1,-1,1,2,-1
KR_6732881668,440,-4,-21,-8,-15,1,0,1,-3,4,1,-4,4,0,-8,8,0,-1,1,0,0,-14,-12,-1,-2,3,1,0,-1,-1,-1,-1,-1,3,-1
KR_6737828415,420,-3,73,-12,-7,1,1,2,0,4,4,0,1,1,-6,6,0,-2,2,0,0,-9,20,-1,-3,4,-4,0,0,-1,-1,0,1,1,-1
KR_6731330053,420,-1,-77,-12,-6,-1,2,1,-1,4,3,-3,4,1,0,3,3,-1,1,0,0,-5,197,-4,-1,5,0,0,-2,-1,-1,-1,-1,3,-1
KR_6750806984,440,3,22,36,8,-6,7,1,2,1,3,-3,3,0,13,0,13,2,0,2,0,12,5,2,-6,4,-1,0,-1,1,0,1,-1,4,-1
KR_6624656936,420,-3,-42,-12,-12,-1,4,3,0,0,0,-6,8,2,-4,5,1,-1,1,0,0,-3,-24,0,-3,3,-1,0,-1,-1,-1,-1,-1,1,-1
KR_6677393078,420,-1,2,-4,-12,1,0,1,-1,1,0,-9,9,0,-3,5,2,0,0,0,0,-5,11,-3,0,3,1,0,0,-1,1,0,-1,3,-1
KR_6751648754,420,0,18,12,-2,-5,5,0,2,1,3,4,1,5,-1,2,1,-2,2,0,0,-2,-22,-4,0,4,2,0,0,-1,0,0,1,6,-1
KR_6720288907,420,-3,-54,-51,-5,-5,5,0,-2,4,2,-2,4,2,3,2,5,1,2,3,0,2,-4,0,-2,2,0,0,-2,1,-1,-1,-1,5,-1
KR_6562031173,420,-5,-18,-12,-18,-1,2,1,-3,3,0,-7,8,1,-6,6,0,-1,2,1,-1,-22,5,0,-3,3,-3,0,-1,1,1,-1,-1,2,-1
KR_6607013099,440,-4,-1,-4,-6,5,0,5,-3,3,0,-5,5,0,-2,8,6,-1,1,0,0,-12,-6,-1,0,1,-1,0,1,-1,-1,-1,-1,6,-1
KR_6636048412,440,-3,-12,20,-2,2,4,6,-1,2,1,-1,2,1,-1,3,2,-1,3,2,0,-2,217,0,-4,4,-3,0,0,0,0,0,-1,0,-1
KR_6683742455,420,-7,-67,-58,-10,-4,5,1,-4,7,3,0,3,3,-1,2,1,-1,2,1,0,-5,-26,4,-4,0,-5,0,-1,-1,-1,-1,-1,2,-1
KR_6633814479,420,3,-34,-8,7,0,2,2,1,1,2,1,1,2,-1,5,4,6,0,6,0,0,214,-1,-1,2,0,0,-1,0,-1,-1,1,0,-1
KR_6745532980,420,-3,51,15,-10,-9,10,1,1,3,4,-3,4,1,1,1,2,0,0,0,0,-12,-7,-1,-2,3,-2,0,-1,-1,-1,-1,1,4,-1
KR_6741089427,420,2,26,5,-4,-1,4,3,-9,12,3,2,1,3,2,1,3,2,0,2,-1,-6,10,1,-4,3,-5,0,-1,-1,-1,1,-1,1,-1
KR_6750784948,440,-5,-34,-8,-12,-4,5,1,0,2,2,-1,2,1,-8,9,1,1,1,2,1,-5,-9,-4,-1,5,1,0,1,1,1,1,1,5,-1
KR_6669594693,420,0,38,-28,-4,-1,2,1,-2,5,3,-4,4,0,4,2,6,-1,1,0,0,-1,-6,-4,-4,8,2,0,1,1,-1,1,-1,1,-1
KR_6241831871,420,-5,-97,-20,-14,-2,5,3,2,0,2,-10,11,1,-1,2,1,-3,5,2,-3,-10,-4,-4,-1,5,0,0,-3,0,-1,-1,-1,0,-1
KR_6746691656,420,-3,-30,-10,2,2,1,3,8,0,8,4,2,6,-11,13,2,-1,1,0,0,3,376,6,-6,0,-3,0,-1,1,-1,-1,1,1,-1
KR_6690777789,420,-4,-28,-32,-6,-2,2,0,-3,3,0,3,0,3,-1,3,2,-3,3,0,0,-6,-10,1,-3,2,2,0,-1,-1,1,-1,-1,4,-1
KR_6523881113,420,-4,-128,-7,-4,2,1,3,-1,4,3,-1,3,2,0,1,1,-4,5,1,0,-8,-3,-4,0,4,-3,0,-1,-1,1,-1,1,1,-1
KR_6737626937,420,-4,15,-4,-4,0,1,1,0,2,2,1,3,4,-1,1,0,-4,4,0,2,-10,-2,3,-5,2,-5,0,0,-1,0,1,1,3,-1
KR_6683793267,420,-5,-43,-24,-6,-3,3,0,2,2,4,-8,8,0,4,6,10,-1,2,1,0,4,417,-2,0,2,0,0,1,1,-1,-1,1,5,-1
KR_6725517646,420,-1,-20,-8,-11,-4,5,1,2,0,2,-9,10,1,-1,2,1,1,0,1,-1,-14,6,6,-9,3,-1,0,-1,1,-1,-1,-1,2,-1
KR_6642704661,420,-2,-61,0,-4,-2,4,2,-4,5,1,1,1,2,-3,3,0,4,1,5,0,-1,-3,-3,-2,5,0,0,1,1,-1,1,1,3,-1
KR_6635311756,420,0,67,-32,0,3,2,5,-1,2,1,0,4,4,-2,3,1,0,0,0,0,-4,-1,-2,-1,3,2,0,1,-1,0,1,1,3,-1
KR_6735706626,420,-3,-66,-12,-3,-2,2,0,-2,4,2,1,6,7,0,3,3,0,4,4,1,-11,19,-3,0,3,-4,0,-2,-1,-1,-1,1,1,-1
KR_6725970771,420,2,69,0,5,-1,1,0,3,0,3,-1,4,3,5,0,5,-1,2,1,0,8,5,3,-3,0,-2,0,1,-1,-1,1,-1,3,-1
KR_6763465044,420,-4,-44,-40,-12,-6,8,2,2,1,3,-3,3,0,-2,5,3,-3,3,0,1,-1,13,1,-1,0,-2,0,-3,1,-1,-1,1,2,-1
KR_6760913552,420,-4,-14,-32,-6,-1,2,1,2,0,2,-1,1,0,-3,4,1,-3,4,1,0,-4,-1,-1,-1,2,1,0,0,-1,0,0,-1,6,-1
KR_6621122313,440,-4,-25,-9,-3,-2,2,0,-1,4,3,1,2,3,3,2,5,-4,4,0,0,-6,-6,0,-3,3,-4,0,0,-1,0,0,-1,3,-1
KR_6761152219,420,-2,-45,4,-4,0,1,1,2,1,3,1,1,2,-6,8,2,-1,1,0,0,-1,4,6,-8,2,-1,0,0,-1,-1,0,-1,3,-1
KR_6629221319,420,-1,35,7,-6,-4,5,1,0,1,1,-2,4,2,1,4,5,-1,2,1,1,2,9,1,-2,1,-2,0,0,0,0,0,1,0,-1
KR_6748520990,440,-4,-41,-28,-8,-2,4,2,1,1,2,-4,5,1,-2,3,1,-1,1,0,1,0,-56,-1,-5,6,-3,0,-1,0,1,-1,1,0,-1
KR_6642894663,420,-6,18,-12,-11,-1,2,1,-3,4,1,0,1,1,-4,6,2,-3,3,0,-1,-11,10,1,-1,0,0,0,-1,-1,-1,-1,-1,4,-1
KR_6751165801,420,-2,-70,-25,-2,3,0,3,0,2,2,-5,8,3,-1,1,0,1,0,1,0,3,-6,-3,0,3,2,0,-1,1,0,-1,-1,6,-1
KR_6630651197,420,-3,-51,23,-16,-3,5,2,-6,6,0,-2,3,1,-2,4,2,-3,3,0,0,-10,-284,0,-3,3,-3,0,-2,-1,1,-1,-1,5,-1
KR_6078522333,420,0,-13,-16,-1,-1,2,1,1,0,1,-1,2,1,-1,4,3,1,1,2,0,-2,-7,0,-3,3,0,0,0,0,0,0,-1,0,-1
KR_6701618058,420,-1,8,-25,3,-2,2,0,3,2,5,2,1,3,0,2,2,0,0,0,0,12,25,1,-7,6,-1,0,-1,1,-1,-1,1,6,-1
KR_6743388870,420,-6,-100,-36,-4,-3,4,1,-3,4,1,3,0,3,-3,6,3,2,1,3,0,0,-206,3,-5,2,-5,0,1,1,1,-1,-1,2,-1
KR_6750660899,440,-3,-19,4,-10,-3,4,1,-3,3,0,-2,4,2,-1,1,0,-1,1,0,0,-7,-9,2,-4,2,-3,0,0,1,-1,0,-1,6,-1
KR_6650442304,440,-1,-21,-36,1,-2,2,0,1,1,2,1,2,3,1,1,2,0,1,1,0,2,-24,2,-4,2,1,0,0,-1,-1,-1,-1,1,-1
KR_6724410851,420,-8,-80,-26,-16,-6,6,0,0,1,1,-4,4,0,-5,5,0,-1,6,5,-1,-14,6,5,-6,1,-2,0,-2,-1,1,-1,-1,5,-1
KR_6608114525,420,-5,-58,-16,-7,4,0,4,0,4,4,-1,2,1,-10,12,2,0,0,0,0,-8,-2,-1,-3,4,-5,0,-1,-1,-1,-1,1,1,-1
KR_6763422162,420,3,-10,10,12,-1,1,0,2,1,3,2,1,3,7,1,8,2,1,3,0,16,10,-1,-3,4,1,0,1,1,1,1,1,2,-1
KR_6758482936,420,-4,-49,31,-18,-1,1,0,2,0,2,-8,8,0,-9,9,0,-2,2,0,0,-9,-26,-2,-1,3,1,0,-1,0,1,-1,-1,0,-1
KR_6749894842,440,1,41,36,3,1,2,3,1,2,3,1,2,3,-3,5,2,3,1,4,1,-2,-3,1,-1,0,1,0,0,1,1,0,1,6,-1
KR_6718938977,440,1,26,-4,8,5,2,7,4,1,5,3,2,5,-3,3,0,-1,2,1,0,11,4,0,-2,2,0,0,-1,1,0,-1,1,3,-1
KR_6731543624,420,-2,-29,-16,-5,3,0,3,0,2,2,-5,7,2,-2,2,0,-1,1,0,0,-5,31,0,-3,3,-24,0,-1,-1,-1,-1,1,2,-1
KR_6764356491,420,-4,-28,-40,-8,1,0,1,-3,4,1,-3,4,1,2,4,6,-5,5,0,0,-1,136,4,-5,1,-7,0,-1,0,0,-1,-1,0,-1
KR_6695976122,440,3,69,-36,7,1,2,3,0,1,1,2,1,3,3,1,4,1,0,1,0,6,22,2,-2,0,-1,0,0,1,1,1,-1,5,-1
KR_6749460815,420,1,20,8,4,1,1,2,1,2,3,-1,5,4,1,2,3,2,0,2,0,3,5,0,-3,3,2,0,0,-1,0,0,1,4,-1
KR_6760664134,420,-1,17,-7,0,0,3,3,-1,6,5,0,2,2,-2,2,0,3,0,3,0,-2,4,-3,-1,4,-3,0,0,-1,0,0,-1,4,-1
KR_6674038184,420,-4,-28,-36,-5,2,0,2,-2,3,1,-6,7,1,1,1,2,0,2,2,0,-3,1,-1,-1,2,1,0,-1,-1,-1,-1,1,3,-1
KR_6706303467,420,-3,-34,-16,-1,-8,9,1,2,1,3,0,1,1,5,0,5,0,0,0,0,7,21,3,-4,1,-1,0,-2,-1,1,-1,-1,5,-1
KR_6375858571,420,-2,9,-16,-4,-4,5,1,0,2,2,3,2,5,-2,2,0,-1,1,0,1,-5,0,0,0,0,1,0,0,-1,0,-1,1,1,-1
KR_6606843087,420,-4,-26,-36,-11,-7,7,0,-4,4,0,1,5,6,1,2,3,-2,4,2,0,-12,-5,3,-5,2,0,0,1,1,-1,-1,1,3,-1
KR_6628922188,420,0,25,8,-8,1,2,3,-3,4,1,-1,2,1,-3,3,0,-2,2,0,0,-10,25,3,-4,1,-2,0,0,-1,-1,-1,-1,1,-1
KR_6729992484,420,2,43,20,-3,2,1,3,-1,2,1,-2,2,0,1,4,5,-3,3,0,0,-7,464,1,-3,2,-1,0,2,0,0,1,1,0,-1
KR_6545655957,420,0,-28,15,-8,0,1,1,-6,8,2,-3,6,3,-2,2,0,3,0,3,0,-7,12,1,-1,0,-1,0,-2,1,-1,-1,-1,6,-1
KR_6738697586,420,-2,49,8,0,6,0,6,-5,5,0,1,2,3,-4,4,0,2,0,2,0,-3,37,1,-5,4,-29,0,1,-1,-1,1,1,3,-1
KR_6712258959,420,-1,-53,-13,-2,-1,1,0,0,4,4,-6,8,2,3,3,6,2,0,2,0,4,11,4,-6,2,-7,0,-1,0,1,-1,1,0,-1
KR_6697242330,420,-3,-23,-12,-9,-6,9,3,-5,5,0,-2,4,2,5,2,7,-1,2,1,0,-6,1,-2,-1,3,2,0,1,1,1,1,1,1,-1
KR_6754398609,420,-4,-37,-8,-9,-1,1,0,-4,4,0,-3,5,2,-1,2,1,0,1,1,0,-7,3,-1,-5,6,-1,0,-1,-1,1,-1,-1,5,-1
KR_6643792606,440,2,53,20,0,0,2,2,2,1,3,1,4,5,-2,3,1,-1,2,1,0,-4,-4,-1,-1,2,0,0,2,-1,1,1,-1,2,-1
KR_6684685252,420,1,10,9,-4,-3,4,1,-2,4,2,0,2,2,1,2,3,0,2,2,0,-2,37,2,-5,3,-25,0,1,1,0,1,1,2,-1
KR_6745877494,440,-3,-73,-8,-6,-1,2,1,-4,4,0,-1,3,2,-1,1,0,1,0,1,0,-5,-222,-3,-3,6,0,0,-2,1,-1,-1,-1,1,-1
KR_6332224855,420,-4,-87,-18,-7,-1,1,0,0,1,1,-1,2,1,-5,5,0,0,1,1,0,-6,-12,-1,-4,5,-7,0,-2,-1,-1,-1,-1,3,-1
KR_6674178238,420,-3,-38,4,-9,2,1,3,-5,6,1,-3,4,1,-6,8,2,3,0,3,0,-9,1,-2,-3,5,-2,0,-2,1,-1,-1,-1,3,-1
KR_6606859047,420,-8,-80,-33,-13,-4,5,1,0,3,3,-1,6,5,-7,8,1,-1,2,1,1,-4,-51,-1,-1,2,29,0,-1,-1,0,-1,1,5,-1
KR_6757929391,420,0,-8,-8,-1,2,0,2,-1,3,2,0,2,2,-2,2,0,0,2,2,0,-4,4,0,-4,4,0,0,0,-1,-1,1,-1,5,-1
KR_6634964535,420,1,99,-27,0,0,0,0,2,0,2,-2,3,1,0,1,1,0,1,1,0,1,-218,-4,-1,5,4,0,0,-1,-1,0,1,6,-1
KR_6686769788,420,-6,-50,0,-10,-1,1,0,-1,5,4,-4,5,1,-5,5,0,1,0,1,0,-8,9,-1,-1,2,-2,0,-1,1,1,-1,-1,5,-1
KR_6755457732,420,1,-22,-2,0,1,1,2,-3,4,1,1,5,6,-2,2,0,3,2,5,1,-5,9,-1,-5,6,-4,0,1,-1,1,1,1,1,-1
KR_6605361607,420,-3,54,-4,-5,2,1,3,2,2,4,-4,5,1,-3,8,5,-2,2,0,1,-5,6,2,-7,5,-2,0,-1,1,-1,-1,1,1,-1
KR_6391943740,440,-5,-127,-36,-10,-1,3,2,7,3,10,-4,6,2,-8,8,0,-4,4,0,0,-7,5,-2,0,2,-4,0,-1,-1,0,-1,1,3,-1
KR_6622822084,420,1,-2,9,-3,0,2,2,2,2,4,5,0,5,-2,2,0,-8,8,0,-1,1,-46,-2,-2,4,26,0,-1,0,1,-1,-1,0,-1
KR_6676027292,420,-1,-2,-15,0,0,1,1,-3,4,1,1,0,1,2,2,4,0,1,1,1,3,-48,-5,-1,6,21,0,0,-1,1,0,1,4,-1
KR_6733783606,420,-5,-12,-40,-10,1,0,1,-2,4,2,-4,4,0,-3,4,1,-2,5,3,0,-7,18,4,-6,2,1,0,-2,-1,1,-1,-1,1,-1
KR_6697179865,420,0,28,8,-6,-3,3,0,1,3,4,-1,3,2,-4,4,0,1,1,2,0,-3,443,1,-4,3,3,0,-2,-1,-1,-1,1,3,-1
KR_6743600809,420,-4,-87,12,-11,-1,1,0,-4,7,3,3,1,4,-9,9,0,0,1,1,0,-9,7,0,-2,2,-2,0,-1,-1,-1,-1,1,2,-1
KR_6663403388,420,-2,-16,-6,-10,-4,5,1,-4,4,0,-3,3,0,2,4,6,-1,2,1,0,-2,-10,-4,0,4,0,1,3,-1,1,1,-1,1,-1
KR_6727661454,420,-2,-33,-12,-6,-5,6,1,-2,3,1,2,3,5,0,3,3,-1,1,0,-1,-12,2,-2,-4,6,2,0,0,-1,1,0,-1,3,-1
KR_6123824719,420,1,-5,20,0,-2,2,0,-1,3,2,2,0,2,0,1,1,1,0,1,0,0,15,-1,-1,2,0,0,0,-1,-1,-1,1,4,-1
KR_6709552815,440,0,32,-12,4,7,2,9,1,0,1,-6,6,0,2,4,6,0,0,0,0,-7,-2,3,-7,4,0,0,1,-1,1,1,1,4,-1
KR_6654784817,420,-2,-74,-12,-1,-1,2,1,-2,5,3,0,1,1,3,2,5,-1,1,0,0,0,-3,-2,-1,3,2,0,0,-1,-1,0,1,3,-1
KR_6747188718,420,-1,-50,-12,0,1,2,3,-3,4,1,0,2,2,0,5,5,2,0,2,1,1,-3,-1,-4,5,-5,0,1,0,1,1,1,0,-1
KR_6725618514,420,-3,-88,-16,-3,4,1,5,-2,4,2,-4,4,0,-1,4,3,0,1,1,0,-7,-46,0,-3,3,24,0,0,-1,1,0,-1,1,-1
KR_6731716191,440,-1,60,-20,-5,-3,3,0,0,1,1,-2,2,0,3,1,4,-3,5,2,1,-8,7,3,-4,1,1,0,0,-1,1,0,1,4,-1
KR_6720756149,440,-7,-93,-36,-15,-5,5,0,-4,7,3,-2,2,0,-5,5,0,1,2,3,0,-12,296,-4,0,4,1,0,0,-1,-1,-1,1,5,-1
KR_6674828382,420,-3,37,-4,-8,1,1,2,-4,5,1,3,1,4,-10,11,1,2,0,2,0,-8,116,-2,-2,4,1,0,0,0,1,0,-1,0,-1
KR_6654259339,420,-5,-29,-13,-6,-1,3,2,0,1,1,-1,3,2,-3,4,1,-1,2,1,-1,-6,-1,0,-6,6,-1,0,-1,-1,1,-1,-1,6,-1
KR_6601554651,440,-5,5,-16,-6,-1,1,0,-3,6,3,2,1,3,-5,8,3,1,0,1,0,-7,-7,0,-5,5,3,0,0,-1,1,1,1,6,-1
KR_6648647720,420,-2,-53,4,-3,1,1,2,-1,5,4,0,2,2,-2,4,2,-1,2,1,0,-4,2,1,-4,3,0,0,-1,-1,0,-1,1,2,-1
KR_6759465267,440,-4,-11,-24,-10,-4,5,1,-4,6,2,1,1,2,0,3,3,-3,4,1,-2,-5,13,-1,-5,6,-1,0,-2,-1,-1,-1,-1,6,-1
KR_6632222500,420,0,69,12,0,-1,3,2,1,2,3,-1,2,1,0,1,1,1,1,2,0,3,-397,-1,-1,2,5,0,0,0,0,0,1,0,-1
KR_6648069071,420,-4,-41,23,-5,-1,1,0,2,2,4,-3,5,2,-1,1,0,-2,2,0,0,-7,52,-3,-2,5,0,0,0,-1,1,-1,1,2,-1
KR_6761781891,420,1,-139,15,-4,0,0,0,-1,2,1,-3,6,3,0,2,2,0,1,1,0,-4,-4,-5,-1,6,-2,0,-1,0,0,-1,1,0,-1
KR_6759107386,420,-1,7,-4,-6,0,3,3,-4,6,2,1,4,5,-5,5,0,2,0,2,0,-5,10,1,-2,1,0,0,0,0,-1,-1,-1,0,-1
KR_6687406500,420,1,3,12,6,1,0,1,0,5,5,2,1,3,3,0,3,0,1,1,0,5,-18,-1,-4,5,2,0,1,-1,1,1,1,4,-1
KR_6047165641,420,-6,-52,-32,-12,-3,4,1,-3,3,0,-3,4,1,-4,5,1,1,3,4,0,-10,-35,0,-6,6,15,0,-3,-1,1,-1,1,2,-1
KR_6722008372,420,0,-9,21,1,-7,8,1,0,3,3,2,0,2,6,0,6,0,1,1,0,1,9,4,-5,1,-4,0,0,0,-1,-1,1,0,-1
KR_6750475226,440,-1,5,4,-7,-5,7,2,3,1,4,-3,4,1,-4,10,6,2,0,2,-1,-3,34,2,-4,2,-4,0,0,0,-1,1,-1,0,-1
KR_6635677053,420,-1,-22,-18,-9,-6,6,0,-4,5,1,8,0,8,-8,11,3,1,0,1,0,-16,279,0,0,0,0,0,-3,-1,-1,-1,-1,2,-1
KR_6609784676,440,-7,-38,-32,-12,-4,4,0,-2,2,0,-2,2,0,-4,4,0,0,1,1,0,-11,-15,-4,-1,5,-2,0,-1,-1,-1,-1,-1,6,-1
KR_6655524167,420,0,-56,4,1,3,1,4,-3,4,1,4,2,6,-2,4,2,-1,1,0,0,-3,-20,1,-4,3,2,0,1,1,-1,1,1,2,-1
KR_6725126656,440,-3,-97,7,-7,-9,11,2,-1,2,1,5,2,7,0,2,2,-2,4,2,0,-4,-2,-2,0,2,-1,0,0,1,1,-1,1,3,-1
KR_6763087551,420,2,29,31,-13,2,0,2,-1,2,1,-5,6,1,-6,7,1,-3,3,0,-1,-14,-12,-5,-1,6,2,0,-1,-1,-1,1,-1,6,-1
KR_6684323013,420,-5,-98,-4,-12,-1,2,1,-1,2,1,-2,4,2,-3,6,3,-5,5,0,0,-8,11,7,-8,1,-6,0,-2,-1,-1,-1,-1,5,-1
KR_6762216568,440,0,29,4,1,4,0,4,2,1,3,-3,5,2,-3,5,2,1,0,1,0,-2,2,4,-4,0,-1,0,0,1,0,1,1,3,-1
KR_6527079535,420,-3,-61,-10,-1,-2,2,0,-5,5,0,1,2,3,2,4,6,3,0,3,0,-2,0,2,-5,3,-6,0,-2,-1,-1,-1,1,6,-1
KR_6113969105,420,-1,-17,-21,-2,2,2,4,-2,6,4,-2,2,0,-1,3,2,1,0,1,0,-5,-5,-2,-3,5,-2,0,-1,-1,1,-1,-1,4,-1
KR_6664438617,420,-3,-6,4,-5,2,0,2,1,2,3,-1,1,0,-3,5,2,-4,4,0,0,-9,-10,-1,-3,4,1,0,0,-1,1,1,-1,1,-1
KR_6763479816,440,2,56,-20,1,4,0,4,-1,3,2,-1,3,2,3,4,7,-4,5,1,0,0,2,-3,-3,6,-5,0,1,-1,-1,1,1,4,-1
KR_6704148057,420,-1,-1,-17,-1,0,0,0,-4,4,0,0,5,5,5,1,6,-2,2,0,-1,-7,90,-2,-3,5,2,0,0,-1,1,0,-1,6,-1
KR_6725662222,420,-7,-81,-9,-17,-4,4,0,0,1,1,-5,6,1,-7,7,0,-1,1,0,0,-10,6,3,-6,3,-2,0,-3,0,-1,-1,-1,0,-1
KR_6702637005,420,-1,-25,4,-13,3,0,3,1,1,2,-4,5,1,-5,5,0,-8,8,0,0,-17,-6,3,-4,1,-3,0,-1,1,-1,-1,1,2,-1
KR_6762052436,420,3,71,18,4,-2,3,1,4,0,4,2,1,3,-4,4,0,4,0,4,0,1,-54,0,-4,4,22,0,0,1,-1,0,-1,1,-1
KR_6706579276,440,0,26,-15,-2,-4,4,0,2,2,4,0,0,0,1,1,2,-1,1,0,0,2,-4,1,-2,1,2,0,0,0,1,0,-1,0,-1
KR_6684704540,420,-4,-71,4,-10,-1,2,1,0,2,2,-3,4,1,-6,8,2,0,1,1,0,-10,4,0,-1,1,-1,0,-2,-1,0,-1,-1,2,-1
KR_6422412188,420,1,-50,3,-3,-1,3,2,-1,3,2,0,2,2,-3,5,2,2,1,3,0,3,6,2,-5,3,-5,0,0,-1,-1,0,-1,2,-1
KR_6723747404,420,-2,-106,28,-14,0,2,2,0,2,2,-7,11,4,-3,7,4,-4,4,0,-1,-6,-38,0,-1,1,25,0,-2,1,0,-1,-1,5,-1
KR_6618566557,420,-3,-75,-19,-6,-6,6,0,1,4,5,-6,8,2,4,2,6,1,0,1,0,6,28,6,-9,3,-1,0,-2,-1,-1,-1,-1,1,-1
KR_6752732403,420,-2,-54,3,-3,1,0,1,2,1,3,1,3,4,-6,8,2,-1,2,1,0,-4,-4,-2,-2,4,0,0,0,1,-1,0,-1,6,-1
KR_6754991909,420,-1,-75,-2,-1,-3,3,0,-5,5,0,5,0,5,1,3,4,1,0,1,-1,-3,-195,5,-6,1,-4,0,0,-1,-1,0,-1,3,-1
KR_6621190347,440,-3,-102,12,-7,-7,7,0,2,0,2,-3,4,1,0,2,2,1,5,6,0,-2,-3,1,-4,3,-3,0,-2,-1,-1,-1,-1,6,-1
KR_6601925967,420,-1,16,-32,-3,1,1,2,-4,5,1,1,3,4,0,4,4,-1,1,0,0,-4,-8,-1,-2,3,-1,0,2,1,1,1,1,6,-1
KR_6616787497,420,-4,-88,-1,-11,-5,7,2,0,0,0,-4,5,1,1,1,2,-3,3,0,0,-8,-1,-4,-1,5,-1,0,-1,-1,-1,-1,-1,3,-1
KR_6762569772,440,-4,-12,-42,-5,0,2,2,-1,3,2,1,4,5,-5,7,2,0,3,3,-1,-7,-7,2,-4,2,1,0,-1,-1,0,-1,-1,2,-1
KR_6760784440,420,3,34,11,1,0,3,3,1,0,1,0,1,1,0,1,1,0,2,2,0,1,-3,-4,-2,6,4,0,1,-1,1,1,1,4,-1
KR_6633919187,420,-3,6,-4,-10,1,0,1,-3,7,4,-5,5,0,-3,6,3,0,2,2,-4,-11,24,0,-1,1,-20,0,-1,0,0,-1,-1,0,-1
KR_6726223291,420,1,45,16,-1,3,1,4,-1,3,2,1,1,2,-4,7,3,0,1,1,0,1,-1,0,-5,5,1,0,-1,1,1,-1,1,1,-1
KR_6530732807,420,-1,-41,-42,-3,1,0,1,1,2,3,-2,6,4,2,5,7,-5,5,0,0,1,-23,-1,-1,2,1,0,0,-1,1,0,-1,3,-1
KR_6483361492,420,-5,-137,12,-15,1,1,2,-4,4,0,-7,8,1,-5,5,0,0,0,0,0,-10,25,-2,-2,4,-7,0,-2,1,-1,-1,-1,2,-1
KR_6752394220,420,0,-54,-11,-11,0,2,2,2,1,3,-10,11,1,1,3,4,-4,6,2,0,-6,288,-4,-1,5,-2,0,0,-1,-1,-1,1,6,-1
KR_6632645109,420,4,36,8,6,-1,3,2,1,2,3,5,0,5,-1,4,3,2,1,3,-1,2,-3,0,-1,1,-2,0,2,1,1,1,-1,6,-1
KR_6622615608,420,-4,-28,-1,-7,-6,6,0,0,2,2,-4,4,0,2,1,3,1,2,3,0,-9,4,-3,-3,6,-1,0,0,-1,-1,-1,1,5,-1
KR_6648654355,420,-7,-44,-48,-11,-3,4,1,-3,4,1,-4,4,0,-2,5,3,1,1,2,0,-7,-4,-4,-1,5,2,0,-1,-1,-1,-1,1,5,-1
KR_6676739314,420,-2,-48,12,-3,-1,2,1,2,1,3,-3,4,1,-1,2,1,0,0,0,0,0,-6,-3,-3,6,-2,0,0,-1,1,0,-1,6,-1
KR_6725828681,420,-1,5,-12,-3,1,2,3,-2,3,1,-1,5,4,-3,6,3,2,1,3,0,5,-1,-3,-2,5,5,0,0,0,1,-1,-1,0,-1
KR_6609101683,420,-1,23,40,-2,1,1,2,-3,5,2,6,4,10,-3,5,2,-3,5,2,0,-15,-377,4,-5,1,13,0,-1,-1,0,-1,-1,5,-1
KR_6745450584,440,-3,-12,22,-14,-2,4,2,-6,8,2,-3,4,1,0,2,2,-3,3,0,0,-11,38,-4,-5,9,-18,0,0,1,-1,0,-1,1,-1
KR_6658614947,420,0,21,20,0,5,4,9,-3,3,0,2,0,2,-3,4,1,-1,1,0,0,-11,92,-1,-2,3,-1,0,1,-1,-1,1,1,2,-1
KR_6530675257,420,-2,-58,0,-8,1,0,1,-1,3,2,-6,9,3,-3,5,2,1,0,1,-1,-3,12,4,-7,3,-1,0,-1,1,-1,-1,-1,6,-1
KR_6650090664,420,-5,-99,-32,-2,1,2,3,4,0,4,-5,6,1,-3,3,0,1,0,1,0,2,-1,0,-3,3,-2,0,0,1,-1,0,-1,5,-1
KR_6584085829,420,-2,27,-77,-7,2,1,3,-1,4,3,-2,5,3,-7,8,1,1,0,1,0,-3,-191,0,-1,1,-32,0,0,-1,-1,1,1,4,-1
KR_6643726272,440,-3,-21,-24,-4,-1,2,1,-1,1,0,-3,4,1,-1,1,0,2,0,2,0,-3,-117,0,-4,4,-1,0,0,0,0,0,-1,0,-1
KR_6742151430,420,0,38,-18,8,1,2,3,3,2,5,0,2,2,2,3,5,2,1,3,0,5,300,1,-6,5,30,0,1,-1,1,1,1,3,-1
KR_6646019960,420,-1,-8,-4,-2,1,2,3,1,1,2,-2,4,2,-2,2,0,0,3,3,0,-7,-230,-2,-3,5,1,0,0,-1,1,0,1,2,-1
KR_6047036860,420,-6,-74,-13,-15,-3,4,1,-6,7,1,0,2,2,-6,8,2,0,0,0,0,-10,8,2,-4,2,0,0,-2,0,-1,-1,-1,0,-1
KR_6677356362,440,-1,-14,-28,-2,2,2,4,-2,3,1,-2,2,0,-1,1,0,1,0,1,1,-1,5,5,-6,1,-4,0,1,-1,1,1,1,6,-1
KR_6493955548,420,1,-103,29,2,1,0,1,3,3,6,1,1,2,-3,3,0,0,1,1,0,-4,34,-3,-1,4,2,0,-1,0,1,-1,-1,0,-1
KR_6715162763,420,-1,21,19,-8,1,3,4,-4,6,2,-7,9,2,1,0,1,1,0,1,-1,-6,14,-1,-3,4,-2,0,0,-1,-1,-1,-1,6,-1
KR_6639002289,420,-1,23,-27,-1,-1,1,0,1,1,2,1,2,3,-2,2,0,0,0,0,0,0,155,-4,-2,6,1,0,1,-1,1,1,-1,1,-1
KR_6338841551,420,-4,-107,4,-5,-3,3,0,3,4,7,-1,1,0,-1,2,1,-3,3,0,0,-6,-6,-5,0,5,0,0,-1,-1,-1,-1,-1,6,-1
KR_6756060009,420,-1,1,8,-2,3,1,4,-5,7,2,-5,6,1,6,1,7,-1,2,1,0,2,-19,-2,-4,6,-1,0,0,0,0,0,1,0,-1
KR_6657186758,420,3,5,11,7,2,1,3,7,1,8,-4,4,0,-1,1,0,3,0,3,0,7,6,1,-2,1,0,0,0,1,-1,0,-1,2,-1
KR_6652222802,420,-2,-123,12,-6,-1,2,1,-1,2,1,-5,6,1,0,1,1,1,0,1,1,2,-136,2,-7,5,-3,0,-1,-1,-1,-1,1,1,-1
KR_6717590465,420,-1,9,-16,0,-2,2,0,1,4,5,-1,4,3,-1,3,2,3,2,5,0,-1,1,-1,0,1,1,0,0,1,-1,0,1,1,-1
KR_6712288614,440,0,53,-8,-4,1,0,1,-5,6,1,1,4,5,-2,4,2,1,4,5,-1,-6,-4,0,-2,2,-1,0,0,-1,0,0,-1,6,-1
KR_6724086551,420,-8,-95,-23,-21,-5,5,0,-6,8,2,-4,4,0,-2,4,2,-4,4,0,-1,-22,-11,-6,-2,8,6,0,-2,-1,-1,-1,-1,2,-1
KR_6729375230,420,-2,-91,0,-9,3,2,5,-3,4,1,-2,4,2,-8,9,1,1,1,2,0,-12,0,5,-8,3,-6,0,-1,1,-1,-1,-1,6,-1
KR_6667302789,440,2,-48,8,2,1,0,1,1,0,1,4,0,4,-3,4,1,-1,3,2,-1,3,243,-2,-1,3,0,0,0,-1,0,0,-1,1,-1
KR_6615775621,420,-1,-33,8,-6,-5,7,2,-2,3,1,4,1,5,-3,3,0,0,1,1,0,1,2,2,-3,1,-4,0,-1,1,-1,-1,-1,5,-1
KR_6759173448,420,3,36,27,5,0,3,3,6,1,7,4,2,6,-3,4,1,-2,2,0,0,-1,-6,4,-6,2,-2,0,0,1,1,0,-1,2,-1
KR_6093403144,420,3,28,-16,4,0,3,3,4,1,5,3,0,3,-3,4,1,0,2,2,-1,6,1,-1,-1,2,0,0,0,-1,-1,0,-1,4,-1
KR_6746103950,420,-5,-95,-24,-7,-3,3,0,0,4,4,4,0,4,-1,2,1,-7,7,0,0,0,-4,-3,0,3,0,0,-3,-1,-1,-1,1,3,-1
KR_6671897178,420,-3,-49,4,-6,0,1,1,1,4,5,-3,7,4,-5,6,1,1,0,1,0,-1,5,1,-4,3,-4,0,0,0,1,-1,1,0,-1
KR_6494233772,420,-4,-61,-18,-7,-2,3,1,-7,8,1,3,2,5,0,4,4,-1,2,1,1,-2,2,2,-8,6,-4,0,-2,1,-1,-1,1,2,-1
KR_6529960527,420,-3,-132,47,-8,0,0,0,-2,2,0,-4,5,1,-4,6,2,2,0,2,-1,-9,-12,-3,-2,5,0,0,-1,-1,1,-1,-1,5,-1
KR_6675417217,420,1,32,-9,-1,0,2,2,0,0,0,3,1,4,-4,4,0,0,1,1,0,-4,-6,-4,-2,6,2,0,0,-1,0,0,-1,4,-1
KR_6361640805,420,-4,-20,-37,5,3,0,3,0,2,2,2,3,5,0,0,0,0,2,2,-1,0,0,0,0,0,-13,0,-1,-1,0,1,-1,4,-1
KR_6621309791,420,0,51,-24,-5,-2,2,0,-7,9,2,2,2,4,1,2,3,1,0,1,0,-9,23,-1,-2,3,-3,0,2,1,0,1,-1,4,-1
KR_6764456637,420,-3,-74,-9,-11,-4,4,0,2,3,5,-5,6,1,-6,9,3,2,2,4,-1,-4,-2,-1,0,1,-2,0,-1,-1,-1,-1,-1,5,-1
KR_6724218980,420,-1,-27,0,6,-3,4,1,5,5,10,6,3,9,-2,3,1,0,0,0,0,5,-19,0,-3,3,0,0,-1,-1,0,1,1,1,-1
KR_6655439524,420,-1,-80,0,-1,-1,2,1,0,4,4,-2,5,3,2,0,2,0,1,1,-1,2,-8,-5,-2,7,2,0,-1,-1,1,-1,-1,2,-1
KR_6732766017,420,-2,-63,12,-8,-1,3,2,1,2,3,-4,4,0,-4,4,0,0,0,0,0,-3,-6,2,-4,2,-1,0,0,-1,1,-1,1,4,-1
KR_6752653593,420,0,-5,0,1,0,0,0,-1,3,2,2,3,5,-1,3,2,1,1,2,0,-3,-1,-3,-1,4,3,0,0,-1,-1,0,-1,2,-1
KR_6654857899,420,0,-38,-41,2,1,0,1,-2,4,2,-3,3,0,5,1,6,1,0,1,0,1,-1,-1,-4,5,-3,0,-1,-1,1,-1,1,5,-1
KR_6576585412,420,-4,-128,0,2,-3,3,0,-1,3,2,0,2,2,5,2,7,1,2,3,0,3,-7,2,-3,1,-1,0,-1,-1,1,-1,-1,2,-1
KR_6761293784,420,0,-65,0,-8,0,1,1,-2,3,1,-4,6,2,-2,5,3,0,1,1,0,-1,-13,1,-4,3,0,0,-1,1,-1,-1,-1,1,-1
KR_6753311756,420,-9,-13,-8,-2,0,1,1,-1,2,1,0,4,4,0,0,0,-1,1,0,0,-7,-2,-1,-2,3,1,0,-1,0,0,-1,-1,0,-1
KR_6596043935,420,-3,29,-20,-4,1,0,1,-1,2,1,-5,5,0,3,2,5,-2,2,0,0,-4,-2,-1,-1,2,1,0,-1,1,0,-1,1,1,-1
KR_6663352878,420,0,57,-78,-4,3,2,5,-3,3,0,-4,4,0,-1,7,6,1,0,1,0,-9,-221,-2,-2,4,0,0,1,-1,-1,-1,1,4,-1
KR_6755239024,420,0,-46,0,2,-5,5,0,1,2,3,4,2,6,0,2,2,2,0,2,0,9,140,0,0,0,2,0,-1,1,-1,-1,-1,1,-1
KR_6749690453,420,-4,-44,8,-2,2,1,3,0,1,1,-1,3,2,-4,4,0,1,2,3,0,-3,36,-2,-1,3,-14,0,-1,1,0,-1,-1,6,-1
KR_6566956330,420,-4,-71,-35,-12,0,1,1,-5,5,0,-1,3,2,-5,7,2,-1,1,0,0,-6,-5,1,-5,4,-4,0,-4,-1,-1,-1,-1,2,-1
KR_6723369313,420,-5,-45,-8,-10,1,0,1,-3,4,1,-5,5,0,-1,5,4,-2,2,0,0,-9,-76,1,-3,2,27,0,-1,0,-1,-1,1,0,-1
KR_6285285543,420,-6,-33,2,-11,-3,3,0,0,5,5,-4,4,0,-3,4,1,-1,1,0,0,-12,14,-1,0,1,-1,0,-1,-1,-1,-1,-1,6,-1
KR_6602302764,420,-2,-54,-24,-4,-2,3,1,-3,5,2,-2,4,2,0,1,1,3,1,4,0,2,-4,6,-6,0,-2,0,-2,-1,-1,-1,-1,1,-1
KR_6763342154,420,0,-12,-7,2,-1,1,0,-1,4,3,6,3,9,0,2,2,-2,2,0,0,4,14,0,-4,4,0,0,1,-1,1,1,1,5,-1
KR_6437320315,420,-4,-52,7,-11,-2,2,0,-1,4,3,-3,3,0,-3,3,0,-2,4,2,0,-13,1,-4,-6,10,2,0,0,-1,-1,0,-1,4,-1
KR_6673981635,420,-3,23,-12,-12,-4,4,0,-1,1,0,2,0,2,-6,7,1,-3,3,0,0,-13,-19,1,-2,1,1,0,0,0,1,1,-1,0,-1
KR_6635648299,420,-2,29,-32,0,3,0,3,0,0,0,4,2,6,-7,7,0,0,1,1,0,-8,2,-1,-2,3,-2,0,0,-1,1,-1,1,6,-1
KR_6644942489,420,0,2,-5,-6,-2,3,1,2,3,5,-3,3,0,-4,4,0,1,1,2,0,-7,-5,3,-3,0,1,0,0,0,0,0,-1,0,-1
KR_6592373853,420,-1,-84,-4,-2,-1,1,0,1,1,2,-2,4,2,-1,3,2,1,0,1,0,-4,14,-4,0,4,4,0,-2,-1,-1,-1,-1,6,-1
KR_6702597901,440,-3,-97,15,-7,-2,3,1,-1,4,3,-1,4,3,-2,7,5,-1,1,0,0,0,8,4,-7,3,-6,0,0,-1,1,-1,1,1,-1
KR_6675806917,420,1,7,16,5,2,0,2,3,3,6,-1,3,2,3,2,5,-2,4,2,1,-1,-5,1,-3,2,1,0,0,1,1,0,1,4,-1
KR_6642537741,420,-5,-42,-11,-6,-2,2,0,3,1,4,1,2,3,-5,9,4,-3,4,1,0,2,-22,4,-6,2,-2,0,0,-1,0,-1,-1,5,-1
KR_6630665024,440,-3,-46,8,-11,-2,2,0,0,3,3,-1,4,3,-9,9,0,1,1,2,-2,-13,330,0,-3,3,0,0,-1,-1,1,-1,-1,5,-1
KR_6728496754,420,2,37,16,-1,0,0,0,-1,5,4,4,3,7,-4,4,0,0,1,1,0,-14,254,3,-5,2,-4,0,0,-1,0,0,1,4,-1
KR_6710128448,420,2,26,-4,11,0,0,0,1,1,2,3,1,4,4,1,5,3,0,3,0,12,-54,-3,-1,4,34,0,-1,-1,1,-1,1,6,-1
KR_6763931512,420,-2,-19,-48,-4,-5,5,0,-2,4,2,-5,6,1,6,0,6,2,0,2,0,3,1,3,-5,2,2,0,0,-1,-1,-1,-1,1,-1
KR_6475565672,420,2,0,-13,1,1,0,1,-2,4,2,0,1,1,4,2,6,-2,4,2,0,2,151,4,-6,2,-3,0,-1,-1,-1,-1,-1,3,-1
KR_6760110555,420,0,27,4,-2,2,0,2,-4,5,1,1,3,4,2,2,4,-3,4,1,-1,1,-3,-2,-2,4,-1,0,-1,-1,-1,-1,-1,2,-1
KR_6732837426,440,2,90,-4,6,4,0,4,-2,4,2,1,3,4,4,0,4,-1,2,1,-1,2,2,1,-3,2,-2,0,0,0,-1,1,-1,0,-1
KR_6729340006,420,3,28,2,-2,0,2,2,-1,2,1,0,4,4,-3,7,4,2,1,3,4,3,-14,-3,-1,4,-1,0,0,-1,-1,0,-1,6,-1
KR_6760917312,420,-3,-81,-12,-3,-1,2,1,0,1,1,1,1,2,-1,1,0,-2,2,0,0,0,-34,6,-6,0,28,0,-1,-1,0,-1,-1,4,-1
KR_6728087073,440,-5,-104,-11,-10,1,2,3,-2,2,0,-4,5,1,-2,3,1,-3,4,1,-2,-17,-44,-1,-2,3,35,0,-3,-1,-1,-1,-1,4,-1
KR_6641840821,420,-3,31,0,-10,-1,2,1,-6,6,0,4,4,8,-4,4,0,-3,4,1,0,-6,7,5,-7,2,-3,0,-1,1,0,-1,-1,3,-1
KR_6616617817,420,-1,-64,6,0,2,2,4,4,0,4,-2,6,4,-2,4,2,-2,2,0,0,3,-234,1,-4,3,-1,0,-1,1,-1,-1,-1,1,-1
KR_6738681634,420,4,17,-11,6,3,0,3,3,1,4,1,1,2,0,3,3,-1,1,0,-1,1,-15,1,-5,4,3,0,0,0,0,0,-1,0,-1
KR_6704300711,420,1,-13,4,5,-1,3,2,2,2,4,4,0,4,-1,5,4,1,0,1,0,5,-15,-6,-1,7,1,0,-1,1,-1,-1,1,3,-1
KR_6638369810,420,-3,-101,-8,-6,-1,2,1,-1,2,1,-3,3,0,-4,4,0,3,0,3,0,-10,1,2,-4,2,2,0,0,-1,1,0,-1,1,-1
KR_6565280449,420,-3,-117,20,-6,0,1,1,-5,5,0,1,1,2,-2,2,0,0,0,0,-1,-10,2,-2,-1,3,0,0,-2,1,-1,-1,-1,5,-1
KR_6732810689,420,-2,30,-8,-10,0,2,2,-6,6,0,-2,3,1,1,0,1,-3,4,1,0,-16,-8,0,-3,3,-2,0,0,1,-1,-1,-1,1,-1
KR_6756551417,440,-3,-35,-4,-8,-1,4,3,-2,2,0,2,1,3,-1,3,2,-6,6,0,1,-9,-6,-2,-2,4,0,0,0,1,-1,0,1,3,-1
KR_6763279931,420,1,-52,-8,1,-2,3,1,0,3,3,4,2,6,1,3,4,-2,2,0,0,0,-109,2,-6,4,2,0,-1,0,0,-1,1,0,-1
KR_6713258989,440,-3,-46,-6,-10,-5,7,2,-7,12,5,2,2,4,-1,2,1,1,2,3,2,10,-6,1,-3,2,-3,0,-3,0,1,-1,1,0,-1
KR_6686017162,420,-1,-6,-1,-4,-1,3,2,1,2,3,1,2,3,-6,7,1,1,0,1,-1,0,-8,-1,-2,3,0,0,1,1,1,1,-1,6,-1
KR_6734293633,420,0,11,-17,1,-1,1,0,1,1,2,-1,3,2,1,2,3,1,1,2,0,4,97,1,-5,4,1,0,0,-1,-1,0,1,2,-1
KR_6618527480,420,-5,-51,-20,-13,-2,4,2,-5,6,1,-2,3,1,-3,5,2,-1,1,0,-1,-12,-2,-3,-2,5,0,0,-1,-1,-1,-1,-1,1,-1
KR_6630766730,420,0,60,20,-2,3,0,3,-1,2,1,-1,2,1,-3,6,3,0,3,3,0,-4,-6,3,-4,1,2,0,0,1,1,1,1,5,-1
KR_6709679202,420,6,77,12,6,3,0,3,-1,2,1,1,1,2,2,1,3,1,2,3,2,8,-250,-5,0,5,6,0,2,1,-1,1,1,3,-1
KR_6706138091,420,-3,7,-32,2,2,0,2,-1,2,1,3,1,4,1,0,1,-3,3,0,-1,5,-41,3,-3,0,2,0,0,-1,1,0,-1,3,-1
KR_6644511241,420,-5,-92,-39,-8,-2,3,1,-4,5,1,-2,3,1,-1,2,1,1,2,3,0,2,-7,-2,-4,6,3,0,-1,-1,1,-1,-1,1,-1
KR_6632894657,420,0,36,-21,3,3,0,3,-7,7,0,3,1,4,2,1,3,2,0,2,0,-3,11,-2,0,2,0,0,0,-1,1,0,1,5,-1
KR_6756308029,440,-1,90,11,-6,-10,10,0,-3,4,1,-3,7,4,5,5,10,5,2,7,-2,-6,3,-1,0,1,-1,0,1,-1,0,1,-1,2,-1
KR_6748992071,420,-5,-30,-40,-13,-3,3,0,2,4,6,-6,6,0,-2,4,2,-4,6,2,2,1,0,0,-4,4,-3,0,-1,1,1,-1,1,6,-1
KR_6736839822,440,-3,-83,8,-6,2,0,2,-5,6,1,1,0,1,1,4,5,-5,5,0,-1,-1,10,3,-8,5,1,0,0,1,0,1,-1,6,-1
KR_6725089208,440,-1,5,-11,-6,1,4,5,-4,6,2,-5,6,1,2,1,3,0,1,1,2,-6,-7,-4,-1,5,0,0,0,-1,-1,-1,1,1,-1
KR_6642909428,420,-2,-70,8,-6,1,1,2,-2,2,0,-4,4,0,-1,1,0,0,0,0,0,-3,-29,0,-1,1,-4,0,-1,-1,1,-1,-1,2,-1
KR_6643144858,420,0,-33,40,3,3,2,5,-2,2,0,0,1,1,1,1,2,1,0,1,0,2,3,2,-3,1,1,0,0,-1,1,-1,-1,4,-1
KR_6744782219,440,-4,-64,-9,-11,-6,7,1,2,0,2,0,0,0,-4,8,4,-3,4,1,0,-8,3,1,-3,2,-5,0,-1,0,0,-1,-1,0,-1
KR_6647906422,420,0,28,28,-7,1,2,3,-2,2,0,-7,8,1,-2,2,0,3,0,3,0,-5,44,-6,-2,8,-20,0,1,-1,-1,1,-1,5,-1
KR_6725683483,440,-2,-59,12,-7,-2,5,3,2,2,4,-3,5,2,-3,5,2,-1,1,0,0,-3,-10,2,-5,3,-3,0,-1,-1,1,-1,-1,2,-1
KR_6615382290,420,-4,29,-15,-6,-1,3,2,-1,2,1,0,2,2,-4,6,2,0,0,0,-1,-5,1,0,-2,2,0,0,-2,-1,-1,-1,-1,6,-1
KR_6752684163,440,-1,-53,-11,-2,2,4,6,1,1,2,3,0,3,-2,5,3,-6,6,0,0,-6,-8,1,-2,1,0,0,0,0,0,1,1,0,-1
KR_6723936187,420,-1,-29,21,-7,2,1,3,1,1,2,-3,5,2,-1,1,0,-6,10,4,-1,-7,-16,-2,-3,5,4,0,-2,-1,-1,-1,-1,5,-1
KR_6726570513,420,-1,-31,9,-7,1,0,1,-1,2,1,-3,3,0,-6,6,0,2,2,4,0,-6,159,0,-4,4,-2,0,0,0,0,-1,-1,0,-1
KR_6748548505,420,-4,-27,-67,-8,1,0,1,-2,2,0,-4,4,0,-2,2,0,-1,5,4,0,-1,-37,2,-2,0,32,0,-1,-1,-1,-1,-1,4,-1
KR_6742500775,420,-2,-71,-34,-2,-2,4,2,1,1,2,-1,4,3,-1,3,2,1,0,1,0,4,-18,0,-2,2,-6,0,-1,-1,-1,-1,-1,6,-1
KR_6757386757,420,-4,-56,-8,-11,-2,2,0,-4,4,0,-7,8,1,0,1,1,2,0,2,0,-8,1,-2,0,2,1,0,0,-1,1,0,-1,3,-1
KR_6630681896,420,-5,-82,-36,-13,2,1,3,3,1,4,-10,10,0,-4,4,0,-4,4,0,0,-8,-2,-3,-1,4,-1,0,-2,-1,-1,-1,-1,5,-1
KR_6730085104,420,-1,-33,23,-4,3,0,3,-1,3,2,-1,1,0,-5,5,0,0,1,1,0,-10,-9,-5,0,5,20,0,-1,-1,1,-1,-1,5,-1
KR_6744062139,440,-4,64,-17,-7,1,1,2,4,1,5,-1,1,0,-4,4,0,-7,9,2,0,-7,108,0,-4,4,0,0,2,-1,1,1,-1,4,-1
KR_6659465453,420,-2,5,-20,-13,0,2,2,1,2,3,-6,8,2,-6,6,0,-2,2,0,-2,-26,-5,-3,0,3,2,0,-3,0,-1,-1,-1,0,-1
KR_6761144869,420,-2,-14,-8,-3,-3,3,0,1,3,4,3,1,4,-3,4,1,-1,1,0,0,-1,3,0,-3,3,2,0,0,1,-1,0,-1,1,-1
KR_6653887409,420,0,-46,17,-4,2,0,2,-1,4,3,-5,5,0,-2,3,1,2,0,2,0,0,-266,-6,0,6,1,0,0,1,-1,-1,-1,5,-1
KR_6681077144,420,-5,-104,-38,-7,-1,2,1,-8,8,0,1,2,3,0,1,1,1,0,1,0,-13,-1,-1,-4,5,-1,0,-1,-1,-1,-1,-1,1,-1
KR_6697998814,420,-2,-37,11,-5,-3,3,0,1,1,2,3,0,3,-4,4,0,-2,3,1,0,-4,3,3,-6,3,-1,0,-1,-1,-1,-1,-1,2,-1
KR_6688711397,420,5,43,18,9,2,1,3,7,0,7,1,3,4,-1,3,2,0,1,1,0,7,-5,1,-5,4,0,0,3,-1,1,1,-1,2,-1
KR_6696790692,420,2,38,8,1,1,2,3,2,1,3,-1,3,2,-2,4,2,1,0,1,0,0,10,-3,-5,8,0,0,0,-1,-1,0,-1,4,-1
KR_6640907015,420,-2,-6,-4,-3,0,1,1,1,4,5,-8,8,0,4,0,4,0,1,1,0,0,-7,0,-3,3,4,0,0,-1,1,0,1,3,-1
KR_6664154551,420,-1,-30,-22,-2,-4,6,2,-3,4,1,2,1,3,0,3,3,3,0,3,0,4,-4,-3,-2,5,-1,0,-1,-1,0,-1,-1,2,-1
KR_6732487479,420,3,-27,-12,7,-3,3,0,1,3,4,8,0,8,-2,3,1,3,2,5,0,7,-1,-4,-3,7,-3,0,-1,1,-1,-1,1,5,-1
KR_6685978441,420,-2,-14,20,-6,-3,3,0,2,1,3,-1,2,1,-3,4,1,-1,2,1,0,-4,42,-2,-1,3,-23,0,-3,1,0,-1,-1,6,-1
KR_6739781224,420,-1,-13,-9,-5,-2,2,0,0,1,1,-2,7,5,-1,1,0,0,1,1,0,4,-9,0,-6,6,-2,0,-1,1,-1,-1,-1,1,-1
KR_6760487489,420,-7,-107,-29,-12,-2,5,3,-10,10,0,-2,2,0,2,3,5,0,1,1,0,1,-1,1,-2,1,2,0,-3,-1,-1,-1,-1,4,-1
KR_6730561504,420,-4,-9,-10,-13,-6,6,0,-2,5,3,2,1,3,-2,4,2,-5,5,0,-1,-6,1,0,-2,2,-2,0,0,-1,-1,-1,-1,1,-1
KR_6724280041,440,-3,-57,-44,-7,-3,3,0,-4,5,1,-4,5,1,2,1,3,2,1,3,0,-4,2,1,-4,3,0,0,0,-1,0,-1,-1,1,-1
KR_6729909855,420,0,-20,4,4,-2,4,2,5,2,7,0,1,1,0,2,2,1,0,1,0,4,39,0,-1,1,-12,0,0,0,0,0,1,0,-1
KR_6125005659,420,1,61,16,-2,3,2,5,-2,5,3,-1,2,1,-2,5,3,0,1,1,-1,-7,97,2,-4,2,0,0,0,0,1,0,-1,0,-1
KR_6721415615,420,-1,-15,27,2,-1,1,0,4,1,5,1,2,3,-1,1,0,-1,1,0,-1,1,59,2,-2,0,0,0,0,-1,-1,0,-1,1,-1
KR_6687378166,420,1,6,32,-7,1,2,3,1,1,2,0,1,1,-4,5,1,-5,5,0,0,-14,262,3,-3,0,-2,0,0,-1,-1,-1,-1,3,-1
KR_6621184916,420,-1,-46,-16,-7,0,3,3,-6,10,4,0,1,1,-1,4,3,0,1,1,1,-2,24,1,-4,3,-2,0,-1,-1,1,-1,1,2,-1
KR_6735238161,440,2,10,10,9,5,0,5,-1,2,1,8,1,9,-1,4,3,-2,2,0,0,2,-1,1,-3,2,3,0,2,-1,1,1,-1,2,-1
KR_6724496418,420,-4,39,-18,-4,1,1,2,-4,5,1,-2,3,1,1,2,3,0,1,1,0,-3,19,1,-6,5,2,0,-1,1,-1,-1,-1,6,-1
KR_6639226936,420,-1,-84,11,-1,-6,7,1,-1,3,2,0,0,0,6,1,7,0,1,1,0,4,252,2,-2,0,-3,0,-2,-1,-1,-1,-1,5,-1
KR_6662828578,440,-9,-154,8,-12,1,3,4,0,2,2,-6,6,0,-3,4,1,-4,4,0,0,-9,-9,-1,-1,2,0,0,-2,0,0,-1,-1,0,-1
KR_6609910104,440,0,-1,29,-4,-1,1,0,-4,8,4,3,0,3,4,1,5,-6,6,0,0,-8,-4,-3,-3,6,4,0,0,-1,1,0,1,1,-1
KR_6746232228,420,3,-11,-16,12,2,2,4,-4,4,0,9,0,9,0,1,1,5,0,5,0,9,14,0,-1,1,1,0,1,0,1,1,1,0,-1
KR_6650707392,420,-3,-26,-3,-8,1,1,2,5,3,8,-7,7,0,-3,3,0,-4,4,0,0,-6,-30,-1,-4,5,-1,0,-1,-1,-1,-1,-1,1,-1
KR_6661020391,420,3,21,12,5,1,1,2,4,0,4,-2,3,1,2,1,3,0,1,1,0,10,137,-3,-3,6,28,0,0,-1,-1,0,1,4,-1
KR_6620621830,420,-2,-68,-19,-9,-2,3,1,-4,6,2,-3,5,2,-1,2,1,1,0,1,0,-12,-71,-2,-4,6,3,0,1,0,1,1,-1,0,-1
KR_6611259598,420,-4,-86,-28,-8,-1,2,1,1,1,2,-8,8,0,-1,2,1,1,2,3,-1,-3,-1,-2,-4,6,-1,0,-2,-1,-1,-1,-1,2,-1
KR_6745484081,440,2,-48,4,7,-2,2,0,6,3,9,1,2,3,4,6,10,-2,2,0,0,10,-7,-3,-3,6,2,0,0,0,-1,0,1,0,-1
KR_6738919636,420,1,-92,-4,0,1,2,3,6,2,8,-8,11,3,0,1,1,1,0,1,0,6,5,-3,0,3,0,0,0,1,1,-1,-1,3,-1
KR_6661959944,420,6,48,-17,8,3,1,4,1,2,3,3,0,3,-1,2,1,2,0,2,0,4,-2,0,-2,2,0,0,0,-1,1,1,1,6,-1
KR_6745873442,440,-1,-78,8,-8,-4,5,1,-4,4,0,1,1,2,-4,7,3,3,1,4,0,-7,14,3,-5,2,-4,0,-1,-1,0,-1,-1,3,-1
KR_6642110160,420,-4,-38,-55,-5,-1,2,1,-1,4,3,-2,2,0,0,3,3,-1,2,1,0,7,-169,-3,-2,5,-3,0,-2,-1,-1,-1,1,3,-1
KR_6757991666,420,-3,47,-29,-5,2,1,3,-4,4,0,-1,2,1,-3,3,0,1,1,2,0,-11,136,-4,-3,7,0,0,0,-1,-1,0,-1,4,-1
KR_6535165839,420,-4,23,-10,-17,-1,2,1,-1,5,4,-5,5,0,-8,10,2,-2,3,1,0,-14,230,-1,-1,2,-3,0,-1,1,1,-1,-1,3,-1
KR_6762540912,420,-2,-11,8,3,3,1,4,2,1,3,3,1,4,-4,4,0,-1,2,1,0,2,-5,1,-1,0,-4,0,0,1,0,0,-1,1,-1
KR_6763109184,440,-6,-68,-4,-15,-3,6,3,-8,9,1,3,0,3,-5,5,0,-2,3,1,0,-18,-302,-1,-1,2,0,0,0,-1,0,-1,1,1,-1
KR_6739169376,420,-3,-13,4,-4,2,0,2,3,1,4,-3,5,2,-2,2,0,-4,4,0,-1,-6,-24,-3,-1,4,0,0,0,-1,-1,-1,-1,6,-1
KR_6695121114,420,-5,-23,4,-10,0,2,2,-1,3,2,-4,5,1,-4,6,2,-1,2,1,-2,-16,212,-4,-2,6,1,0,-1,-1,-1,-1,-1,1,-1
KR_6758199359,420,-2,-62,-16,-7,-5,6,1,2,0,2,-6,8,2,3,0,3,-1,3,2,0,0,2,-2,-2,4,0,0,-2,1,-1,-1,-1,1,-1
KR_6728728211,420,-4,-21,-12,-11,-3,4,1,-3,3,0,-2,2,0,1,3,4,-4,4,0,0,-10,28,2,-3,1,-11,0,-2,-1,1,-1,-1,2,-1
KR_6725978570,420,-2,-100,-24,-3,-5,5,0,-1,2,1,1,3,4,1,6,7,1,1,2,0,8,8,-2,-1,3,-2,0,-1,1,1,1,1,1,-1
KR_6479197266,420,-3,-13,-12,-9,1,2,3,-7,7,0,2,3,5,-3,3,0,-2,2,0,0,-6,-45,2,-3,1,20,0,-3,-1,0,-1,-1,6,-1
KR_6672191203,420,0,-24,24,-10,0,0,0,0,4,4,-2,4,2,-7,8,1,-1,1,0,0,-8,7,3,-7,4,-4,0,-1,-1,-1,-1,-1,6,-1
KR_6642666950,420,3,39,0,6,0,2,2,7,0,7,0,2,2,-3,4,1,2,1,3,1,6,-1,-1,-1,2,-1,0,0,-1,1,1,1,2,-1
KR_6760939349,420,-2,-103,-4,2,1,1,2,3,2,5,-2,5,3,1,2,3,-1,2,1,0,4,15,3,-3,0,-1,0,0,1,-1,0,1,2,-1
KR_6742368509,420,0,19,-8,-7,2,1,3,0,3,3,2,0,2,-9,10,1,-2,2,0,0,-12,-8,-1,-3,4,0,0,-1,-1,-1,-1,-1,6,-1
KR_6692469689,420,-2,-9,0,-2,2,2,4,-6,6,0,1,4,5,2,0,2,-1,2,1,0,2,1,1,-2,1,1,0,0,1,1,0,-1,1,-1
KR_6697311437,440,1,-46,-1,-1,7,0,7,0,1,1,-1,3,2,-3,5,2,-4,4,0,0,-6,-3,6,-8,2,-1,0,-1,-1,1,1,1,3,-1
KR_6761044140,420,-4,-60,8,-16,-2,2,0,0,3,3,-7,7,0,-7,8,1,0,0,0,0,-13,-2,-5,0,5,0,0,-1,-1,-1,-1,-1,6,-1
KR_6204795253,420,-2,14,8,-3,2,0,2,-6,9,3,3,0,3,-3,4,1,1,2,3,0,-1,7,1,-6,5,-2,0,-1,1,-1,-1,-1,4,-1
KR_6633773093,420,1,-41,-4,0,-2,2,0,-3,5,2,-4,6,2,5,2,7,4,2,6,1,-2,56,-2,-2,4,-1,0,0,0,0,0,1,0,-1
KR_6749710290,420,1,2,-13,1,2,0,2,6,2,8,-1,3,2,-4,4,0,-2,3,1,0,-3,257,-1,0,1,2,0,0,-1,1,1,-1,6,-1
KR_6740198277,420,-4,-59,-28,-4,-1,3,2,0,2,2,0,1,1,-2,5,3,-1,1,0,0,-8,-284,-3,-2,5,-1,0,0,-1,1,0,1,1,-1
KR_6729688652,420,-1,-18,-21,-4,2,0,2,1,2,3,-5,5,0,-1,5,4,-1,1,0,0,-6,-5,-1,-5,6,3,0,1,-1,1,1,-1,5,-1
KR_6622715186,420,-2,8,4,-5,-2,3,1,-1,3,2,2,0,2,-1,2,1,-3,3,0,0,-5,1,0,-3,3,1,0,0,1,-1,-1,-1,4,-1
KR_6694432597,420,2,-4,-18,4,0,1,1,3,1,4,2,1,3,-2,3,1,1,0,1,0,5,5,4,-7,3,-1,0,0,-1,1,0,1,3,-1
KR_6090950350,440,-6,-12,-26,-17,-4,4,0,-2,5,3,0,1,1,0,0,0,-11,11,0,0,-14,16,3,-8,5,-5,0,-2,-1,0,-1,-1,5,-1
KR_6764552808,420,-1,-78,-28,1,-1,2,1,2,1,3,-4,4,0,4,1,5,0,0,0,0,7,0,0,-3,3,0,0,1,1,-1,1,1,3,-1
KR_6733224711,420,0,52,-4,-2,7,0,7,-1,1,0,2,1,3,-3,5,2,-7,8,1,0,-7,18,1,-6,5,1,0,3,-1,1,1,1,1,-1
KR_6647106504,420,-2,2,-20,-6,0,0,0,-1,4,3,-1,2,1,-4,4,0,0,1,1,0,-3,-120,-3,-1,4,0,0,-1,-1,1,1,1,6,-1
KR_6748483684,440,-2,29,-24,-2,-7,7,0,-1,2,1,0,2,2,6,4,10,0,0,0,0,9,-221,-1,-1,2,4,0,-3,1,-1,-1,-1,6,-1
KR_6621617457,420,-2,-47,-33,-9,8,1,9,-1,1,0,-8,9,1,-8,10,2,0,0,0,1,-8,3,-4,0,4,1,0,-1,-1,-1,1,1,5,-1
KR_6660334438,420,-5,-86,4,-8,-5,6,1,-2,2,0,-3,4,1,3,1,4,-1,2,1,0,-7,4,2,-5,3,-5,0,-2,1,-1,-1,-1,2,-1
KR_6737807355,420,-2,-56,-77,-14,0,1,1,-1,2,1,-4,6,2,-5,5,0,-4,4,0,-1,-11,-11,-3,-1,4,4,0,-2,-1,-1,-1,-1,2,-1
KR_6571711895,420,0,-19,-32,5,1,0,1,3,2,5,1,1,2,0,1,1,0,2,2,-1,2,7,-2,-2,4,-1,0,-1,-1,0,-1,-1,3,-1
KR_6729392995,420,-5,-68,-2,-4,1,1,2,-1,2,1,-5,6,1,-1,4,3,2,0,2,0,-2,3,-1,-2,3,8,0,0,-1,1,-1,1,3,-1
KR_6764396312,420,2,52,4,5,-1,3,2,0,3,3,4,1,5,1,2,3,1,2,3,0,4,3,0,-2,2,-1,0,-1,1,-1,-1,-1,3,-1
KR_6723918935,420,0,-14,-4,2,-1,2,1,-1,3,2,1,2,3,-2,5,3,5,0,5,1,4,5,-1,0,1,-1,0,1,1,-1,1,1,4,-1
KR_6763370262,440,4,37,32,6,5,0,5,2,1,3,0,0,0,-3,5,2,2,0,2,0,1,-11,-5,0,5,2,0,0,-1,0,1,1,5,-1
KR_6683201686,420,-2,-41,1,-5,-4,5,1,-1,4,3,-3,4,1,1,0,1,2,0,2,0,3,7,-5,-2,7,-5,0,0,-1,0,0,-1,4,-1
KR_6762433936,440,0,11,-4,1,-1,5,4,-6,7,1,9,0,9,-3,5,2,2,3,5,0,-7,-17,-1,0,1,2,0,1,1,1,1,1,5,-1
KR_6729203617,420,-2,-43,-11,-3,7,0,7,-8,9,1,1,4,5,-4,6,2,1,0,1,0,-6,3,5,-5,0,-5,0,1,-1,-1,-1,1,1,-1
KR_6632230532,420,-1,-31,-17,-7,-2,5,3,-11,11,0,6,0,6,0,1,1,0,0,0,0,-10,-11,-4,-1,5,0,0,-1,-1,1,-1,-1,3,-1
KR_6666150333,420,-6,-3,-8,-11,-1,5,4,-13,14,1,1,1,2,0,1,1,2,1,3,0,-6,109,3,-4,1,0,0,-1,-1,-1,-1,-1,1,-1
KR_6762373114,440,-4,-16,-28,-9,0,3,3,-9,11,2,-1,2,1,1,2,3,0,0,0,0,-10,-10,-1,-1,2,2,0,0,-1,1,0,1,6,-1
KR_6636081328,420,-5,-70,-12,-2,1,3,4,-3,4,1,-3,4,1,2,3,5,1,0,1,0,-2,-126,-4,-4,8,-3,0,1,-1,1,1,-1,4,-1
KR_6752506789,420,-2,-14,12,-5,-1,1,0,2,1,3,-2,3,1,1,3,4,-5,5,0,0,0,3,2,-5,3,-2,0,0,-1,1,1,-1,3,-1
KR_6692098597,420,-8,-92,-48,-20,-2,2,0,-8,9,1,-2,4,2,-6,6,0,-2,2,0,-2,-20,-5,-1,-2,3,-6,0,-3,-1,-1,-1,-1,3,-1
KR_6730738283,420,2,31,21,0,0,0,0,-4,5,1,3,0,3,0,2,2,1,1,2,0,0,-124,4,-4,0,0,0,-1,1,-1,-1,1,5,-1
KR_6763529541,420,-2,-71,8,-9,-2,3,1,-2,3,1,-1,4,3,-2,6,4,-2,3,1,0,-6,-1,-1,-1,2,-1,0,-3,-1,-1,-1,-1,4,-1
KR_6538446702,420,-4,-20,-51,-5,-2,3,1,3,1,4,-6,7,1,-1,6,5,1,1,2,1,2,8,0,-3,3,-2,0,-1,1,-1,-1,1,5,-1
KR_6761623097,420,2,-31,3,9,1,0,1,8,1,9,-3,5,2,2,1,3,1,0,1,0,8,17,4,-5,1,-1,0,0,1,1,0,1,1,-1
KR_6740333349,420,0,-17,4,-3,-2,2,0,1,2,3,0,2,2,-2,3,1,0,1,1,0,-1,6,0,-3,3,-2,0,0,-1,-1,0,-1,6,-1
KR_6682809028,440,0,-24,11,-2,6,0,6,3,0,3,-5,5,0,-6,8,2,0,0,0,0,-6,-9,-2,-1,3,1,0,0,0,-1,-1,-1,0,-1
KR_6762486869,420,0,-24,-14,2,-3,3,0,1,1,2,-1,3,2,5,1,6,0,3,3,0,9,-8,0,-4,4,4,0,0,1,0,0,-1,5,-1
KR_6640140381,420,-3,-22,-3,-6,2,0,2,-2,2,0,-1,3,2,-5,6,1,0,1,1,0,-10,-2,1,-4,3,-2,0,-2,1,-1,-1,-1,2,-1
KR_5761740326,420,-1,-30,15,-8,-3,3,0,-4,5,1,1,1,2,-1,2,1,-1,2,1,0,-2,11,2,-3,1,0,0,-1,-1,-1,-1,-1,2,-1
KR_6583547192,420,-5,-108,-12,-9,-2,2,0,-2,3,1,-3,5,2,-2,2,0,0,3,3,1,-8,-5,-3,-1,4,-1,0,-1,-1,1,-1,1,4,-1
KR_6621116751,440,2,3,-17,-5,-3,5,2,-1,3,2,0,0,0,-4,6,2,3,1,4,0,-2,0,1,-3,2,0,0,-2,-1,-1,1,-1,2,-1
KR_6698665354,420,2,-1,0,-1,1,4,5,4,0,4,2,1,3,-7,8,1,-1,3,2,-2,-7,2,4,-6,2,-2,0,1,-1,1,1,-1,2,-1
KR_6729501422,420,1,25,-4,-5,1,0,1,-1,4,3,-1,5,4,-5,6,1,1,0,1,0,-12,1,-1,-3,4,0,0,-1,-1,-1,-1,-1,6,-1
KR_6759971499,420,0,10,0,-3,1,2,3,-1,1,0,-1,1,0,-2,2,0,0,0,0,0,-4,15,0,-1,1,-1,0,0,-1,0,0,-1,6,-1
KR_6702551139,420,-5,-87,-37,-12,-5,5,0,-3,5,2,0,2,2,-3,6,3,-1,1,0,0,-15,23,2,-3,1,-12,0,-1,1,0,-1,-1,2,-1
KR_6690689757,420,-1,22,2,1,-1,3,2,-1,6,5,1,2,3,1,0,1,1,0,1,0,0,-52,-3,-1,4,-18,0,-1,-1,-1,-1,1,5,-1
KR_6695762663,440,-2,-51,31,7,-3,4,1,0,2,2,0,1,1,10,0,10,0,1,1,0,4,-197,2,-3,1,-3,0,0,1,1,-1,-1,2,-1
KR_6761246633,440,2,19,-20,5,1,2,3,0,1,1,1,0,1,0,3,3,3,0,3,0,-1,-20,-8,-1,9,0,0,1,-1,-1,1,1,3,-1
KR_6720365600,440,-5,-74,-30,-18,-4,4,0,-4,4,0,-2,5,3,-8,9,1,0,0,0,0,-18,-64,-3,-3,6,30,0,0,0,-1,-1,-1,0,-1
KR_6760369652,420,2,62,14,2,6,1,7,2,4,6,-9,12,3,1,3,4,2,0,2,-1,9,-344,-1,-1,2,0,0,1,1,1,1,-1,3,-1
KR_6600196409,420,-1,-46,-23,1,1,1,2,-3,3,0,1,0,1,3,1,4,-1,5,4,0,4,135,-3,-2,5,2,0,0,-1,1,-1,1,1,-1
KR_6763241882,420,1,-29,11,-1,-2,2,0,0,1,1,3,0,3,-2,3,1,0,0,0,0,-2,-8,-5,0,5,2,0,1,1,-1,1,1,4,-1
KR_6735118766,420,-4,-86,-20,-8,-2,3,1,-5,5,0,1,1,2,-1,1,0,-1,2,1,0,-5,-25,-2,-2,4,-2,0,0,0,-1,0,-1,0,-1
KR_6761311989,420,-1,-39,-30,2,4,1,5,4,1,5,-3,3,0,-1,1,0,-2,2,0,0,2,23,5,-8,3,0,0,0,0,0,0,1,0,-1
KR_6699941058,420,1,-2,0,-2,2,0,2,-3,3,0,0,0,0,-1,4,3,0,0,0,0,0,2,0,-3,3,-3,0,0,-1,-1,0,-1,3,-1
KR_6737331621,440,-6,-59,-33,-16,-10,12,2,-4,7,3,3,3,6,0,4,4,-5,6,1,0,-20,-7,-2,0,2,-1,0,-4,-1,-1,-1,-1,3,-1
KR_6725355089,420,0,-67,16,4,5,1,6,0,2,2,0,2,2,1,1,2,-2,2,0,0,0,24,1,-4,3,-2,0,-1,1,1,-1,1,1,-1
KR_6691553172,440,-2,-33,24,-7,1,0,1,-4,4,0,2,0,2,-7,8,1,1,3,4,0,1,113,4,-9,5,3,0,-1,1,1,-1,1,4,-1
KR_6762415163,420,-2,-98,-4,-5,-1,2,1,2,1,3,-5,8,3,-4,5,1,3,1,4,-1,2,0,2,-7,5,-3,0,-1,-1,-1,-1,-1,1,-1
KR_6728516028,420,-1,-25,44,-3,-3,4,1,1,1,2,-1,2,1,4,1,5,-4,4,0,1,1,-5,-2,-3,5,-2,0,-2,1,1,-1,1,5,-1
KR_6751628206,420,-3,-36,-28,-6,-4,4,0,1,4,5,-1,1,0,-1,2,1,-1,4,3,0,-2,163,0,-2,2,-1,0,-2,-1,-1,-1,-1,4,-1
KR_6748882658,420,2,-23,-4,7,3,0,3,-1,2,1,-6,6,0,8,1,9,3,0,3,0,7,-26,0,-2,2,19,0,1,0,0,1,1,0,-1
KR_6763813320,420,-7,-57,5,-12,-2,3,1,-4,4,0,-2,3,1,-2,3,1,-2,2,0,0,-16,4,0,-1,1,0,0,0,0,-1,-1,-1,0,-1
KR_6640680419,440,0,-69,-16,-4,-2,3,1,1,1,2,-2,2,0,-1,3,2,0,0,0,0,-1,-13,-3,-2,5,2,0,-2,-1,-1,-1,-1,2,-1
KR_6725515155,440,-3,-57,1,-13,2,3,5,1,2,3,1,3,4,-12,13,1,-5,5,0,-3,-15,-2,-5,-1,6,1,0,-1,0,1,-1,-1,0,-1
KR_6738658547,420,-5,-129,-48,-10,-6,7,1,-2,3,1,-1,2,1,0,0,0,-1,1,0,0,-8,8,-1,-3,4,2,0,-2,-1,-1,-1,-1,2,-1
KR_6718938602,420,-2,2,4,-1,-2,2,0,2,1,3,1,1,2,-3,3,0,1,2,3,0,-5,-109,-5,-2,7,3,0,0,0,-1,0,-1,0,-1
KR_6725508976,420,-1,-68,-12,-9,-4,4,0,1,2,3,-2,3,1,-2,3,1,-2,2,0,0,-5,-43,-1,-3,4,21,0,0,-1,0,0,-1,5,-1
KR_6742992835,440,-5,-111,-32,-7,2,2,4,-6,7,1,-3,6,3,-1,4,3,1,2,3,-1,-1,46,3,-7,4,-23,0,-2,-1,1,-1,-1,5,-1
KR_6743007533,420,-1,-131,-8,-6,1,4,5,1,3,4,-6,7,1,-2,6,4,0,2,2,0,0,-6,-1,-2,3,2,0,-3,-1,0,-1,1,2,-1
KR_6728408207,420,-6,-90,-9,-8,-2,2,0,0,1,1,-5,6,1,-2,2,0,1,0,1,0,0,6,-2,-2,4,-3,0,-3,-1,1,-1,-1,6,-1
KR_6719711069,420,-3,-28,-8,-1,0,0,0,1,2,3,-3,3,0,3,1,4,-2,2,0,0,2,-40,-3,-1,4,19,0,-1,0,-1,-1,-1,0,-1
KR_6759519155,420,1,-7,-8,0,-1,3,2,3,3,6,-1,1,0,-1,3,2,0,1,1,0,1,-39,0,-5,5,15,0,1,0,1,1,1,0,-1
KR_6703056822,420,-3,-1,-16,-14,-1,3,2,-5,6,1,-3,3,0,-3,8,5,-2,2,0,0,-11,183,-2,-2,4,2,0,-3,1,-1,-1,-1,1,-1
KR_6609704338,420,-3,-14,-31,-5,-6,6,0,3,2,5,4,1,5,-4,4,0,-2,4,2,0,-2,-5,-2,-2,4,0,0,-3,0,-1,-1,1,0,-1
KR_6691605227,420,-3,17,-8,-9,1,0,1,-6,6,0,-2,3,1,-2,3,1,0,0,0,0,-5,6,-2,-4,6,-2,0,0,1,-1,0,-1,2,-1
KR_6715676911,420,-1,6,4,-5,-1,2,1,-5,6,1,3,2,5,-4,5,1,2,0,2,0,-4,23,-3,-2,5,-24,0,-1,-1,-1,-1,-1,6,-1
KR_6395319225,420,-3,-32,-12,-3,-1,1,0,-1,3,2,0,2,2,0,3,3,-1,1,0,0,-1,-5,4,-7,3,5,0,0,-1,0,0,-1,5,-1
KR_6697692076,420,-1,-22,-2,0,-4,5,1,-2,2,0,3,4,7,4,0,4,-1,1,0,-1,2,-174,4,-5,1,16,0,-2,-1,-1,-1,-1,4,-1
KR_6735301517,420,-2,-55,-25,-5,-4,5,1,2,4,6,-4,5,1,0,4,4,1,1,2,1,-5,-20,6,-6,0,-2,0,-1,-1,-1,-1,1,2,-1
KR_6712784474,420,-2,-16,-40,-1,4,0,4,-2,3,1,-1,2,1,0,3,3,-2,3,1,0,-5,-82,3,-5,2,-22,0,-1,-1,-1,-1,1,2,-1
KR_6749972571,420,-3,-99,-28,-6,-4,5,1,-2,4,2,0,5,5,2,4,6,-2,3,1,0,-2,-37,-3,0,3,18,0,0,-1,1,-1,-1,3,-1
KR_6685223008,420,-6,-113,-17,-10,-9,10,1,-1,3,2,-4,6,2,1,2,3,3,2,5,0,8,0,-1,-1,2,2,0,-1,1,0,-1,1,6,-1
KR_6715539783,420,1,20,-20,-1,3,2,5,-5,8,3,-2,3,1,1,2,3,2,1,3,0,0,5,-1,-1,2,0,0,2,-1,1,1,-1,4,-1
KR_6760467264,420,-1,-2,-29,-2,4,0,4,1,1,2,-2,4,2,-5,6,1,0,2,2,0,-7,-5,-1,-2,3,1,0,-1,1,1,1,1,3,-1
KR_6737487436,420,-3,27,-24,-8,0,1,1,-1,4,3,-9,9,0,0,9,9,2,4,6,0,-5,0,-2,-1,3,-4,0,0,-1,-1,0,1,3,-1
KR_6752980918,420,-1,-58,4,1,1,1,2,4,0,4,2,3,5,-4,5,1,-2,3,1,0,-4,-11,-2,-3,5,-1,0,-1,1,1,-1,-1,2,-1
KR_6592175597,420,-3,-64,-8,-9,-1,3,2,-5,7,2,-2,3,1,1,0,1,-2,3,1,0,-2,10,1,-6,5,-4,0,0,1,-1,-1,1,1,-1
KR_6757418686,420,-2,-58,9,-6,1,1,2,-1,2,1,0,3,3,-6,9,3,0,2,2,0,-5,-2,0,-2,2,-1,0,-3,1,-1,-1,-1,2,-1
KR_6705993722,420,0,24,6,1,1,0,1,5,0,5,-5,6,1,-1,2,1,1,0,1,0,1,171,0,-3,3,0,0,0,-1,1,0,1,4,-1
KR_6759983787,420,-1,43,-8,-7,-6,7,1,-1,4,3,1,5,6,-1,5,4,0,0,0,1,-3,4,-1,-4,5,0,0,0,-1,0,0,1,1,-1
KR_6659848822,420,0,-7,8,2,-3,4,1,3,2,5,-1,4,3,1,1,2,2,1,3,-1,0,8,3,-6,3,2,0,0,1,0,0,-1,4,-1
KR_6661579092,420,-4,-48,-27,-13,1,0,1,-2,2,0,-10,10,0,-2,4,2,0,0,0,-2,-10,-10,-6,-1,7,0,0,-1,1,0,-1,-1,5,-1
KR_6750665491,440,1,7,12,-1,3,4,7,-3,5,2,2,2,4,-2,5,3,-1,5,4,0,2,-2,-3,-2,5,0,0,-1,1,-1,1,1,5,-1
KR_6750323978,420,0,-15,-5,4,2,1,3,-1,2,1,2,1,3,1,3,4,0,0,0,1,5,2,-2,-2,4,0,0,-2,-1,1,-1,1,3,-1
KR_6648744010,440,0,5,0,2,-4,5,1,-3,3,0,9,1,10,0,0,0,0,0,0,0,-6,-1,-3,-2,5,3,0,-1,-1,1,-1,1,3,-1
KR_6763694045,440,3,51,16,0,-1,2,1,3,1,4,4,1,5,-2,3,1,-4,4,0,0,-8,0,0,-3,3,1,0,0,-1,0,1,-1,3,-1
KR_6724140752,420,-2,-61,9,-10,0,2,2,1,3,4,-9,11,2,0,0,0,-2,4,2,0,-5,-8,-6,-1,7,-1,0,0,-1,-1,0,-1,4,-1
KR_6725563998,420,1,45,-37,2,0,2,2,0,3,3,4,1,5,0,2,2,-2,3,1,0,4,-45,1,-6,5,15,0,2,1,-1,-1,-1,5,-1
KR_6750572494,440,-5,2,-44,-15,-1,3,2,-1,6,5,-6,7,1,-5,6,1,-2,2,0,0,-12,-2,-3,0,3,2,0,0,1,-1,0,-1,6,-1
KR_6659634488,420,-3,-22,-8,-6,4,0,4,-3,3,0,0,1,1,-6,6,0,-1,3,2,0,-10,19,0,-3,3,-1,0,-1,0,1,-1,-1,0,-1
KR_6693326685,440,-1,-25,-24,-9,5,2,7,-7,8,1,-1,1,0,-6,8,2,0,1,1,0,-10,-9,1,-2,1,-2,0,3,-1,1,1,1,4,-1
KR_6745207433,420,-3,-61,-36,-9,-2,2,0,-6,6,0,2,0,2,-2,3,1,-1,1,0,-1,-11,-17,0,-3,3,-2,0,1,-1,-1,-1,-1,6,-1
KR_6583975386,420,0,55,25,2,4,2,6,0,2,2,-1,4,3,-3,5,2,2,1,3,-1,1,5,2,-4,2,2,0,0,1,0,0,-1,3,-1
KR_6622726425,420,-3,-50,16,-6,-1,2,1,-2,3,1,-1,1,0,-2,2,0,0,0,0,0,-6,-12,-1,-2,3,0,0,-1,-1,-1,-1,1,5,-1
KR_6614960581,420,-6,-113,-24,-6,-2,2,0,-3,6,3,-1,1,0,-1,2,1,1,1,2,0,-7,1,3,-5,2,-6,0,-2,-1,-1,-1,-1,1,-1
KR_6666491867,420,-1,-5,31,-7,0,0,0,-1,1,0,-2,4,2,-2,2,0,-2,3,1,0,-4,70,-2,-1,3,0,0,1,-1,1,1,1,5,-1
KR_6646310477,420,0,-40,-5,3,-1,2,1,1,2,3,4,1,5,-1,3,2,0,0,0,0,2,-14,0,-2,2,-2,0,0,0,0,0,1,0,-1
KR_6753385365,420,-5,-132,-14,-13,-2,3,1,-5,9,4,-9,9,0,4,1,5,-1,1,0,-1,-10,-322,-1,0,1,-2,0,-4,-1,-1,-1,-1,4,-1
KR_6758430711,420,-8,-10,-38,-20,-9,9,0,0,1,1,-8,8,0,-2,2,0,-1,1,0,0,-16,6,-2,-1,3,0,0,-1,-1,0,-1,-1,2,-1
KR_6758891341,440,1,-83,12,2,-1,1,0,1,1,2,-1,4,3,2,2,4,1,0,1,0,4,5,2,-6,4,0,0,0,1,-1,0,-1,3,-1
KR_6609673181,440,3,82,10,-5,2,2,4,2,0,2,0,1,1,-7,7,0,-2,2,0,1,-14,-9,-5,-2,7,1,0,2,-1,1,1,1,1,-1
KR_6725590061,420,1,126,11,1,2,0,2,-3,4,1,4,3,7,-2,2,0,0,0,0,0,-4,-43,3,-3,0,9,0,1,-1,1,1,1,6,-1
KR_6709054705,440,-6,-138,-29,-5,-5,5,0,-1,1,0,6,0,6,-3,4,1,-2,2,0,0,-7,10,3,-6,3,-4,0,0,0,-1,-1,1,0,-1
KR_6754304081,420,-1,-54,-24,1,-1,1,0,5,0,5,-1,4,3,-4,6,2,2,1,3,0,-1,-10,2,-3,1,2,0,1,0,1,1,1,0,-1
KR_6722115505,420,-7,-103,-4,-16,-6,8,2,0,1,1,-5,5,0,-5,5,0,0,0,0,0,-7,12,-3,-2,5,-6,0,-2,1,1,-1,-1,5,-1
KR_6760762827,440,-7,-17,-36,-12,-9,9,0,1,3,4,1,1,2,-1,1,0,-4,5,1,0,-17,3,-4,0,4,-1,0,1,-1,-1,1,1,2,-1
KR_6675491159,420,-2,-56,0,-7,0,2,2,-2,4,2,-2,3,1,-3,6,3,0,0,0,0,-1,361,1,-2,1,-1,0,-2,-1,1,-1,-1,1,-1
KR_6739157394,420,0,40,-4,-3,-3,3,0,-1,3,2,5,1,6,-3,4,1,-1,1,0,0,-11,284,-2,-1,3,1,0,0,-1,1,0,-1,4,-1
KR_6753302891,440,-1,3,8,-1,5,0,5,-2,5,3,1,0,1,-4,4,0,-1,1,0,0,-6,202,-5,0,5,2,0,0,0,-1,-1,-1,0,-1
KR_6725233956,420,-1,-74,-2,-8,-1,3,2,-1,1,0,-4,5,1,-1,1,0,-1,3,2,0,-10,0,1,-5,4,-5,0,0,0,0,0,-1,0,-1
KR_6596001182,420,-2,-37,4,-4,1,2,3,0,2,2,-3,3,0,-2,4,2,0,0,0,0,-1,-1,-2,0,2,2,0,0,1,-1,-1,-1,3,-1
KR_6751194511,420,3,85,-8,6,1,2,3,-4,7,3,3,0,3,4,2,6,2,0,2,0,3,14,-3,0,3,5,0,1,-1,-1,1,1,3,-1
KR_6722154547,440,-10,-115,-35,-23,-8,8,0,-2,4,2,-2,5,3,-9,9,0,-2,3,1,0,-18,-24,-1,0,1,0,0,-5,-1,-1,-1,-1,3,-1
KR_6637434055,420,-2,-14,-12,-2,0,0,0,-1,2,1,0,5,5,-1,1,0,0,0,0,0,1,3,-1,-2,3,-1,0,0,-1,-1,0,-1,2,-1
KR_6738649434,440,-1,-80,8,0,-3,4,1,2,4,6,0,3,3,1,2,3,0,1,1,-1,5,-372,-1,-2,3,-1,0,-1,-1,-1,-1,-1,3,-1
KR_6762379639,440,2,55,-8,6,1,0,1,0,2,2,3,3,6,2,4,6,0,2,2,0,6,-186,1,-1,0,1,0,1,-1,0,1,-1,4,-1
KR_6563373452,420,-10,-114,-67,-20,-3,3,0,-2,2,0,-2,4,2,-12,14,2,-1,2,1,-1,-12,-16,5,-7,2,-7,0,-3,-1,1,-1,-1,3,-1
KR_6319958715,420,-2,29,-40,0,1,2,3,-2,5,3,-2,3,1,3,4,7,0,2,2,-1,0,144,-4,-2,6,1,0,1,-1,-1,1,-1,3,-1
KR_6706117353,420,-4,-28,-34,-11,0,2,2,-2,2,0,-5,5,0,-3,4,1,-1,2,1,0,-15,-4,-2,0,2,0,0,-1,1,-1,-1,-1,4,-1
KR_6633904623,420,-2,-53,-1,-1,2,1,3,-3,4,1,0,1,1,0,1,1,0,0,0,0,4,-3,0,0,0,0,0,1,-1,1,1,-1,6,-1
KR_6721528399,440,-4,-61,-11,-13,1,1,2,-4,4,0,-3,4,1,-6,6,0,-1,2,1,0,-20,-1,-2,-3,5,-2,0,-1,1,-1,-1,-1,3,-1
KR_6707121500,420,0,48,7,-2,0,1,1,-2,5,3,-7,7,0,6,1,7,1,3,4,0,0,-6,-5,0,5,2,0,1,-1,1,1,1,4,-1
KR_6624672496,420,0,-9,-16,5,-3,3,0,1,1,2,2,2,4,5,0,5,0,0,0,0,8,45,6,-8,2,-12,0,-1,1,-1,-1,1,5,-1
KR_6751302428,420,1,-12,14,-2,0,2,2,-4,4,0,-2,2,0,3,3,6,1,1,2,0,1,110,-4,-3,7,1,0,-1,1,-1,-1,-1,5,-1
KR_6618509391,420,-7,-138,-45,-17,-4,5,1,-2,6,4,-2,2,0,-8,8,0,-1,1,0,-1,-7,12,-1,-2,3,-5,0,-1,-1,0,-1,-1,1,-1
KR_6760401382,420,-2,-67,-7,-3,-7,7,0,-1,2,1,2,1,3,4,1,5,-1,1,0,0,-2,23,3,-3,0,-9,0,0,-1,1,0,-1,3,-1
KR_6730904079,420,0,-2,-16,1,-1,4,3,3,2,5,0,3,3,-2,4,2,1,1,2,0,-2,272,1,-3,2,1,0,0,1,0,0,1,6,-1
KR_6756973747,420,0,-35,12,2,-2,2,0,-1,1,0,7,1,8,-3,3,0,1,1,2,0,-3,20,-1,-2,3,-1,0,-1,1,-1,-1,1,2,-1
KR_6696841088,420,-4,-44,-44,-3,1,0,1,-3,4,1,-1,3,2,0,3,3,0,0,0,0,-2,0,-1,-4,5,-3,0,0,0,0,0,1,0,-1
KR_6721795792,420,-3,-106,-20,-3,-1,3,2,3,2,5,1,1,2,-6,6,0,0,1,1,0,-4,-4,5,-7,2,-3,0,-1,1,1,-1,-1,2,-1
KR_6494171389,420,-3,-82,-10,-9,-5,6,1,-3,5,2,2,3,5,-1,3,2,-2,2,0,0,-5,3,1,-2,1,-2,0,-1,0,0,-1,-1,0,-1
KR_6753747698,420,-2,17,-3,-5,-1,6,5,-4,6,2,-2,3,1,0,2,2,2,0,2,0,-6,458,-2,0,2,1,0,0,-1,0,-1,-1,1,-1
KR_6685760653,440,-5,-61,11,-9,-3,3,0,0,2,2,-4,7,3,-2,3,1,0,6,6,0,-3,-14,2,-3,1,-2,0,-2,-1,1,-1,-1,3,-1
KR_6614708775,440,-1,0,-20,1,3,0,3,-1,2,1,0,0,0,1,1,2,-2,2,0,0,-2,5,-1,0,1,1,0,0,1,-1,0,1,2,-1
KR_6711297184,420,-7,-149,-23,-14,0,3,3,0,3,3,-8,8,0,-7,8,1,1,0,1,0,-14,-403,-1,-1,2,-1,0,-2,-1,0,-1,-1,4,-1
KR_6569698033,420,-1,-19,0,-2,2,1,3,-1,2,1,-4,5,1,3,0,3,-2,2,0,0,0,71,-2,-2,4,-13,0,0,-1,-1,-1,1,3,-1
KR_6628858997,420,3,9,-34,6,0,0,0,0,0,0,5,0,5,-2,3,1,3,0,3,-1,0,18,-1,-2,3,3,0,0,0,1,0,-1,0,-1
KR_6709147637,420,-5,-66,-13,-10,-4,5,1,-3,4,1,0,0,0,-1,1,0,-2,3,1,0,-8,2,0,-2,2,-1,0,-2,1,-1,-1,-1,3,-1
KR_6545699860,420,-3,-26,4,-2,-1,3,2,1,4,5,-2,2,0,2,2,4,-2,4,2,0,3,9,5,-7,2,-2,0,-1,-1,1,-1,1,6,-1
KR_6571655670,420,-1,6,-12,-4,1,3,4,2,0,2,2,1,3,-9,9,0,0,0,0,-1,-7,0,7,-10,3,-1,0,-1,1,-1,-1,-1,2,-1
KR_6742252463,420,5,-33,16,-1,-4,5,1,1,1,2,-1,1,0,3,0,3,0,1,1,-1,2,-7,-2,-4,6,-3,0,0,-1,-1,0,-1,2,-1
KR_6745702466,440,0,-17,21,5,2,1,3,7,4,11,2,4,6,-5,6,1,-1,2,1,1,-1,23,0,0,0,0,0,1,1,1,1,1,1,-1
KR_6705524606,440,-3,-45,8,1,-3,3,0,0,2,2,1,0,1,6,0,6,-3,6,3,-1,4,-33,1,-4,3,20,0,-1,-1,0,-1,-1,1,-1
KR_6302423754,420,-1,22,11,-2,2,2,4,-1,1,0,-2,4,2,3,1,4,-4,4,0,-1,-3,-5,-6,0,6,2,0,-1,-1,-1,-1,-1,3,-1
KR_6645415611,420,1,35,-3,-4,-4,5,1,4,0,4,-5,6,1,-2,5,3,3,1,4,0,0,-3,-5,0,5,1,0,-1,-1,-1,-1,-1,2,-1
KR_6647782336,440,-3,-34,-20,-4,4,1,5,-3,8,5,-2,5,3,0,3,3,-3,3,0,-1,-1,-14,2,-5,3,3,0,-1,-1,-1,-1,-1,1,-1
KR_6347254455,420,-1,35,4,-2,3,0,3,-1,1,0,-3,4,1,1,0,1,-2,2,0,0,-4,20,3,-4,1,-19,0,0,-1,0,0,1,3,-1
KR_6705422300,420,-1,-45,19,-4,-6,6,0,0,1,1,2,2,4,0,1,1,0,0,0,1,3,8,-1,0,1,-2,0,-2,1,-1,-1,1,5,-1
KR_6714716932,420,0,-26,-4,1,0,2,2,0,3,3,-1,3,2,5,1,6,-3,3,0,0,3,-29,8,-10,2,22,0,-1,-1,-1,-1,-1,6,-1
KR_6664105476,420,-4,-93,-1,-10,-5,5,0,1,2,3,-6,8,2,0,1,1,0,1,1,0,-3,33,5,-6,1,-19,0,-3,1,-1,-1,-1,6,-1
KR_6761063414,440,-1,-85,-20,-2,0,1,1,-2,3,1,-2,4,2,-2,3,1,4,1,5,0,2,-7,-2,-3,5,2,0,0,-1,1,0,-1,3,-1
KR_6483881389,420,-1,-84,4,-7,-2,5,3,0,1,1,-2,3,1,-2,2,0,-1,1,0,-2,-7,6,-2,-2,4,-4,0,-1,1,-1,-1,-1,3,-1
KR_6738525413,420,-4,-37,-24,-11,-2,3,1,0,1,1,-4,6,2,-6,6,0,1,0,1,0,-10,-90,-4,0,4,1,0,0,-1,1,1,-1,3,-1
KR_6607770990,420,-2,9,-16,-2,2,1,3,-1,2,1,-2,3,1,0,2,2,-1,2,1,1,1,-4,-2,0,2,0,0,0,-1,-1,0,1,5,-1
KR_6547937566,420,-2,-17,-29,-4,3,1,4,-1,3,2,-1,4,3,-3,4,1,-2,2,0,0,-8,2,-2,-1,3,2,0,-1,-1,-1,-1,-1,1,-1
KR_6731457570,420,3,-20,-11,10,0,1,1,0,2,2,6,0,6,0,0,0,4,0,4,1,6,-137,-4,-1,5,1,0,1,0,1,1,1,0,-1
KR_6609267587,440,0,42,-28,-1,2,1,3,-6,7,1,1,0,1,4,3,7,-2,2,0,0,-1,-31,-1,-1,2,-2,0,0,0,0,0,1,0,-1
KR_6760704418,420,2,54,40,2,-2,2,0,2,3,5,-1,3,2,2,4,6,1,0,1,0,-1,7,1,-3,2,0,0,0,1,0,0,1,6,-1
KR_6724835421,420,-1,-12,-24,2,-5,5,0,4,0,4,-2,5,3,5,0,5,0,1,1,0,6,186,-1,-3,4,1,0,0,-1,-1,0,1,3,-1
KR_6605435375,420,0,40,-4,-7,0,1,1,-3,4,1,-6,8,2,2,0,2,0,0,0,-1,-14,-245,-5,-2,7,0,0,-2,-1,-1,-1,-1,1,-1
KR_6724002490,440,-1,37,-3,-6,-2,2,0,-3,5,2,1,0,1,-3,3,0,1,0,1,0,-8,-12,-6,-1,7,3,0,-1,-1,-1,-1,-1,3,-1
KR_6732756788,420,-5,-74,-15,-12,-1,2,1,-4,6,2,-4,5,1,-6,8,2,3,1,4,1,-15,-1,2,-6,4,-4,0,-1,-1,-1,-1,1,6,-1
KR_6750847610,420,-2,-83,12,-13,-2,3,1,-3,5,2,0,4,4,-5,7,2,-3,4,1,-1,-14,68,-2,-2,4,2,0,0,-1,-1,1,-1,2,-1
KR_6756877822,420,-3,19,-20,-1,0,4,4,-4,4,0,-4,5,1,6,2,8,1,0,1,1,2,233,2,-5,3,-3,0,0,1,-1,0,-1,2,-1
KR_6723860906,420,-4,-2,-19,-1,-5,5,0,3,1,4,5,4,9,-5,5,0,1,5,6,0,8,4,2,-4,2,-2,0,0,1,-1,-1,1,5,-1
KR_6643267033,420,-1,-55,-2,0,0,0,0,1,1,2,3,1,4,-6,6,0,2,0,2,0,3,-4,-3,-2,5,1,0,0,-1,1,0,-1,1,-1
KR_6606643901,420,-2,27,-5,-6,-3,3,0,2,3,5,-3,3,0,-2,3,1,0,3,3,0,-2,-37,-3,0,3,11,0,0,0,1,0,1,0,-1
KR_6612641986,440,-5,-65,4,-4,-2,3,1,0,0,0,-3,4,1,-3,5,2,4,1,5,0,-4,33,-2,-2,4,-20,0,-1,1,-1,-1,-1,4,-1
KR_6731598369,420,-1,-59,12,-6,-1,1,0,3,3,6,-5,9,4,-2,3,1,-1,1,0,-1,-3,-22,0,-2,2,0,0,-2,-1,1,-1,-1,3,-1
KR_6617496212,420,-3,-84,-37,-11,-3,3,0,0,3,3,-3,4,1,-3,4,1,-2,3,1,0,-9,-2,-2,-3,5,-2,0,-2,-1,-1,-1,-1,1,-1
KR_6641581330,420,1,72,-31,1,-2,2,0,-2,4,2,3,3,6,3,1,4,-1,1,0,0,3,4,0,-2,2,-2,0,-1,-1,-1,-1,-1,1,-1
KR_6764431414,420,-1,-17,-7,-7,-3,3,0,3,2,5,0,1,1,-4,5,1,-3,4,1,0,-7,-153,4,-7,3,15,0,-2,1,-1,-1,1,5,-1
KR_6761557746,440,-1,-55,26,-7,-2,2,0,3,0,3,1,3,4,0,1,1,-9,13,4,0,-8,-12,-3,-1,4,3,0,-1,-1,1,-1,-1,6,-1
KR_6664527908,420,-2,-41,44,-11,1,3,4,1,3,4,-2,2,0,-7,7,0,-4,4,0,0,-13,60,-6,-4,10,17,0,1,0,1,1,-1,0,-1
KR_6665095954,420,-4,33,-41,-13,-2,4,2,-1,3,2,-1,2,1,-6,9,3,-3,4,1,0,-9,-2,-1,0,1,-1,0,0,-1,-1,-1,-1,6,-1
KR_6732675008,440,-2,-17,-7,-5,2,1,3,-3,6,3,-4,4,0,0,2,2,0,2,2,0,1,44,-2,-5,7,-12,0,1,-1,-1,1,-1,6,-1
KR_6697002206,420,0,-33,-10,-4,-1,2,1,1,0,1,-3,4,1,-1,4,3,0,0,0,0,0,225,-5,-4,9,4,0,-2,-1,-1,-1,-1,2,-1
KR_6762207813,420,-3,-25,20,-5,-3,3,0,1,2,3,0,3,3,-3,4,1,0,2,2,0,-2,-7,0,-1,1,0,0,-1,-1,-1,-1,-1,6,-1
KR_6726519765,420,0,33,-17,-6,1,2,3,0,4,4,0,6,6,-4,6,2,-3,3,0,1,0,64,1,-2,1,-26,0,1,-1,1,1,1,4,-1
KR_6699059299,440,0,-35,-12,4,-2,2,0,0,2,2,-2,2,0,8,0,8,0,2,2,0,4,-362,-5,-1,6,0,0,-1,0,-1,-1,1,0,-1
KR_5896775962,440,-8,-58,-27,-14,-3,4,1,2,3,5,-2,2,0,-9,10,1,-2,4,2,-2,-20,-8,-7,0,7,-1,0,-4,-1,-1,-1,-1,1,-1
KR_6745897876,440,-9,-190,-16,-18,-5,5,0,-1,4,3,-8,8,0,-4,8,4,0,1,1,-1,-14,-7,-4,-1,5,-2,0,-1,-1,-1,-1,-1,1,-1
KR_6724951348,420,3,-17,16,7,-5,5,0,0,2,2,2,3,5,8,0,8,2,2,4,0,10,-9,-1,-2,3,4,0,0,1,0,-1,-1,4,-1
KR_6485540877,420,2,18,4,6,2,0,2,-4,4,0,5,1,6,3,0,3,0,0,0,0,-1,140,2,-4,2,1,0,2,0,1,1,-1,0,-1
KR_6757697112,420,-3,-41,0,-13,-1,1,0,-4,5,1,-3,8,5,-4,6,2,-1,1,0,-1,-14,8,0,-3,3,-4,0,-1,-1,1,-1,-1,3,-1
KR_6527932464,420,-1,-66,25,-1,-3,3,0,-1,3,2,3,2,5,1,0,1,-1,2,1,0,-2,1,0,-4,4,0,0,-1,1,-1,-1,-1,2,-1
KR_6732879064,420,0,-5,11,-4,0,0,0,2,0,2,2,2,4,-9,10,1,1,0,1,0,-3,3,1,-7,6,2,0,-1,0,0,-1,-1,0,-1
KR_6629240638,420,-2,14,-26,-2,3,1,4,-3,5,2,-3,3,0,0,1,1,1,1,2,0,-1,-2,0,-3,3,1,0,-2,1,-1,-1,-1,6,-1
KR_6759842381,420,-1,-29,1,-5,2,1,3,-2,2,0,-2,2,0,-3,3,0,0,2,2,0,-9,-3,1,-3,2,2,0,-2,-1,1,-1,1,2,-1
KR_6710051625,420,-1,25,-12,-4,-4,4,0,-7,7,0,2,0,2,3,3,6,2,0,2,-2,-16,17,1,-3,2,2,0,0,-1,-1,-1,-1,3,-1
KR_6753989038,440,-4,-145,-32,-5,-3,4,1,-3,3,0,-2,4,2,4,0,4,-1,1,0,-1,4,-43,-2,-1,3,18,0,-4,-1,-1,-1,-1,1,-1
KR_6661491772,420,-2,9,-24,0,-1,4,3,2,3,5,-4,6,2,2,1,3,1,0,1,-1,3,-2,-2,-2,4,0,0,-1,1,-1,1,-1,1,-1
KR_6743138574,420,-2,19,17,0,2,1,3,2,1,3,-3,5,2,-1,2,1,0,0,0,0,-2,52,0,-1,1,-17,0,1,-1,1,1,1,1,-1
KR_6763308628,440,0,-110,4,3,-1,2,1,-1,1,0,-3,3,0,5,0,5,3,0,3,1,7,-154,-2,-2,4,1,0,0,-1,-1,-1,1,1,-1
KR_6633407189,420,-4,-85,-14,-13,-5,5,0,2,2,4,-2,4,2,-8,9,1,0,1,1,0,-11,149,-6,0,6,-1,0,0,0,1,0,-1,0,-1
KR_6757629558,420,-3,78,-18,-9,-1,1,0,-6,7,1,-2,2,0,-1,3,2,1,1,2,0,-2,47,2,-3,1,-22,0,1,0,-1,1,-1,0,-1
KR_6722837020,440,-3,-107,10,-7,-2,2,0,-4,6,2,1,0,1,-2,3,1,0,1,1,0,0,18,0,-4,4,2,0,-1,1,0,-1,-1,5,-1
KR_6602099064,420,-1,40,-8,-2,-5,6,1,-2,2,0,-1,2,1,6,1,7,0,1,1,0,-3,186,0,-3,3,-2,0,2,1,-1,1,-1,5,-1
KR_6738182692,440,0,28,20,-2,-1,1,0,-4,4,0,3,2,5,-3,4,1,3,0,3,0,-9,4,6,-8,2,-2,0,0,1,-1,0,1,3,-1
KR_6601877076,420,1,31,-4,-6,-1,2,1,-3,5,2,2,1,3,-4,6,2,0,1,1,0,-11,-114,-3,0,3,-1,0,2,-1,1,1,-1,6,-1
KR_5661212927,420,-1,29,-20,-9,1,0,1,-9,10,1,2,0,2,-2,4,2,-1,1,0,0,-7,-2,-1,-2,3,-1,0,0,-1,-1,0,-1,4,-1
KR_6754793545,420,0,7,0,-6,-3,3,0,-2,4,2,-2,2,0,1,2,3,0,0,0,0,-2,-5,-6,-1,7,-3,0,-1,-1,-1,-1,-1,3,-1
KR_6666144330,420,1,1,17,-7,2,0,2,-5,7,2,2,0,2,-6,7,1,0,1,1,0,-8,13,-2,-2,4,-2,0,0,1,-1,-1,-1,2,-1
KR_6487933312,420,-1,-20,16,-3,-4,4,0,4,2,6,-1,2,1,-3,5,2,1,0,1,0,2,-8,-4,-2,6,4,0,0,-1,-1,0,-1,2,-1
KR_6759352926,440,3,27,25,0,2,0,2,-1,2,1,-1,2,1,1,1,2,-1,1,0,0,0,9,1,-3,2,1,0,0,0,1,0,-1,0,-1
KR_6761006383,420,2,2,42,-1,-2,4,2,1,0,1,-2,2,0,0,1,1,2,3,5,0,-3,32,-8,-1,9,-14,0,0,0,1,0,1,0,-1
KR_6365283602,420,1,58,-35,4,-2,3,1,3,1,4,-1,2,1,-1,1,0,5,1,6,0,6,0,0,0,0,3,0,0,1,-1,0,-1,2,-1
KR_6743332927,420,-4,-50,-33,-9,-3,4,1,-3,3,0,-4,4,0,-2,8,6,3,1,4,1,0,-13,-8,-1,9,1,0,-1,-1,-1,-1,1,2,-1
KR_6606598596,420,-2,-20,17,-8,-4,4,0,1,0,1,-3,3,0,-3,5,2,1,1,2,0,-2,4,-1,-3,4,0,0,-2,1,-1,-1,-1,1,-1
KR_6760070275,420,-2,108,-4,-7,0,3,3,-4,6,2,-1,3,2,-3,6,3,1,2,3,0,-16,-44,-2,-1,3,0,0,1,-1,-1,1,-1,2,-1
KR_6687259717,420,-2,11,-15,-8,-3,3,0,0,2,2,-6,6,0,1,0,1,0,0,0,0,-7,-35,-2,0,2,21,0,0,1,-1,0,-1,4,-1
KR_6731727656,420,-6,-123,1,-14,0,0,0,-1,1,0,-5,7,2,-5,5,0,-3,5,2,0,-8,-2,1,-3,2,-1,0,-2,-1,-1,-1,-1,1,-1
KR_6763954911,420,-5,-107,-20,-9,-4,4,0,-1,1,0,0,0,0,-2,2,0,-2,2,0,0,-6,5,-2,-1,3,-2,0,-1,-1,-1,-1,-1,4,-1
KR_6634294960,420,1,62,7,4,2,1,3,-8,12,4,5,0,5,5,0,5,0,0,0,0,-3,-1,4,-4,0,-1,0,0,1,1,0,1,6,-1
KR_6762854453,420,0,-22,3,-6,-1,1,0,-3,4,1,3,0,3,-5,5,0,0,1,1,0,-14,7,7,-9,2,-4,0,0,-1,-1,-1,-1,5,-1
KR_6714772731,420,0,33,11,-3,0,2,2,-8,8,0,1,2,3,4,2,6,0,1,1,0,0,34,-2,-5,7,-21,0,0,0,1,0,1,0,-1
KR_6591016961,420,1,-44,-8,-2,-3,4,1,2,0,2,-4,4,0,0,2,2,3,0,3,0,4,15,-1,-4,5,-1,0,-2,1,-1,-1,1,5,-1
KR_6641219228,420,-2,9,-41,-4,-4,5,1,-4,5,1,2,2,4,2,2,4,0,0,0,0,1,8,3,-3,0,0,0,0,0,-1,1,-1,0,-1
KR_6616705782,420,-6,-40,1,-6,-4,6,2,1,4,5,-3,5,2,0,1,1,0,0,0,0,-1,-21,0,-3,3,-7,0,-1,1,0,-1,1,3,-1
KR_6669849912,420,-4,-20,-24,-4,-5,6,1,2,1,3,-1,2,1,0,3,3,0,1,1,0,2,-9,-1,-3,4,-2,0,-2,-1,-1,-1,-1,3,-1
KR_6591863641,420,1,19,-24,0,-4,5,1,3,1,4,0,2,2,0,1,1,1,0,1,1,6,8,-5,-2,7,2,0,-1,1,-1,-1,1,6,-1
KR_6742629357,420,-4,-63,-25,-8,-3,3,0,0,5,5,-1,1,0,-3,6,3,-1,1,0,0,-9,2,1,-6,5,-4,0,-1,0,1,-1,-1,0,-1
KR_6288228651,420,-5,42,-4,-11,-6,6,0,0,1,1,2,2,4,-5,7,2,-2,3,1,0,-5,27,6,-6,0,-1,0,0,-1,1,0,-1,2,-1
KR_6688095338,420,-2,15,-47,-5,-2,3,1,-5,6,1,1,0,1,-1,3,2,2,2,4,0,-5,2,0,0,0,1,0,0,-1,-1,0,-1,2,-1
KR_6241658447,420,0,7,-1,3,1,2,3,6,1,7,-2,4,2,-1,3,2,-1,2,1,0,2,180,-2,-2,4,2,0,0,1,1,0,1,5,-1
KR_6760730667,420,-3,-46,-24,-6,2,0,2,4,0,4,-6,7,1,-2,3,1,-4,5,1,0,-3,-5,-3,0,3,-1,0,-1,0,0,-1,1,0,-1
KR_6744550890,420,-3,-63,-31,-7,1,0,1,-3,4,1,-3,3,0,-1,5,4,-1,2,1,2,-4,-2,4,-6,2,-5,0,0,-1,-1,1,1,1,-1
KR_6731604566,420,-4,-39,-5,-4,-3,3,0,-3,6,3,-1,2,1,1,1,2,2,1,3,0,4,-4,1,-4,3,-3,0,-1,1,-1,-1,-1,5,-1
KR_6691130600,420,-8,-50,-15,-1,1,0,1,-4,5,1,3,0,3,0,1,1,-1,3,2,0,-2,1,-1,0,1,0,0,-2,1,-1,-1,-1,4,-1
KR_6712910985,420,-2,9,17,-6,-2,2,0,1,2,3,0,1,1,-3,6,3,-2,3,1,-1,-10,12,1,-4,3,-4,0,0,-1,1,1,-1,1,-1
KR_6761523068,420,-2,-88,-4,-7,1,1,2,-4,4,0,4,4,8,-7,7,0,-1,1,0,0,-13,3,-2,0,2,0,0,-2,1,-1,-1,-1,3,-1
KR_6640590190,420,-2,14,0,-8,-1,2,1,-7,7,0,1,2,3,-1,5,4,0,1,1,0,-9,13,1,-2,1,-1,0,-1,0,-1,-1,1,0,-1
KR_6759584671,420,-2,-112,-11,-5,-2,3,1,0,1,1,-1,5,4,-6,8,2,4,0,4,0,-3,-2,-1,-2,3,1,0,-2,0,1,-1,-1,0,-1
KR_6611183165,420,-1,26,-28,-6,-3,3,0,-3,4,1,2,1,3,-4,7,3,2,0,2,0,-9,4,0,-2,2,-1,0,1,-1,1,1,-1,6,-1
KR_6663396085,420,-1,-18,21,2,2,1,3,-5,6,1,2,3,5,3,0,3,0,1,1,1,1,-210,0,-2,2,-2,0,-1,1,-1,-1,1,4,-1
KR_6667199685,440,1,-103,-4,2,-6,7,1,3,2,5,1,0,1,5,2,7,-1,2,1,0,9,0,0,-3,3,1,0,-1,1,1,1,-1,2,-1
KR_6745808046,420,-1,5,-28,-6,-1,2,1,-5,6,1,-1,3,2,1,2,3,0,0,0,0,0,-11,1,-5,4,1,0,0,-1,1,0,1,6,-1
KR_6733362675,440,-1,21,10,0,-2,4,2,3,0,3,-3,4,1,3,1,4,-1,2,1,0,0,3,1,-3,2,-1,0,0,-1,-1,0,1,3,-1
KR_6736973895,440,-2,-63,15,-1,-2,5,3,3,0,3,0,1,1,-1,1,0,-1,2,1,0,1,2,-1,-3,4,2,0,-2,1,-1,-1,-1,6,-1
KR_6720739187,420,1,-3,-27,-2,-4,6,2,0,2,2,2,1,3,2,1,3,-2,3,1,0,4,-136,-1,-2,3,2,0,-1,-1,1,-1,-1,3,-1
KR_6676409404,420,-3,-35,-19,-8,-2,4,2,-1,3,2,-11,12,1,-2,5,3,8,1,9,-3,-3,-14,1,-5,4,1,0,-3,-1,-1,-1,-1,2,-1
KR_6666245339,420,5,54,55,12,2,0,2,3,1,4,5,0,5,2,1,3,0,0,0,0,11,-4,1,-6,5,3,0,0,1,0,1,1,1,-1
KR_6723666727,420,3,5,29,0,-2,3,1,-4,5,1,9,1,10,-4,8,4,1,1,2,0,1,11,0,-5,5,6,0,0,-1,0,-1,-1,6,-1
KR_6755239879,420,-1,-60,12,-1,-1,2,1,1,3,4,-4,6,2,2,2,4,1,1,2,0,7,-40,1,-4,3,23,0,0,1,-1,0,1,2,-1
KR_6140492623,420,-3,-73,4,-5,-5,6,1,-4,5,1,3,0,3,2,0,2,-1,3,2,0,-4,10,0,-7,7,1,0,-1,-1,1,-1,1,2,-1
KR_6730003517,420,-5,-66,-48,-6,0,2,2,-8,10,2,1,0,1,0,1,1,1,0,1,0,-4,15,-1,-2,3,-2,0,-1,-1,0,-1,-1,1,-1
KR_6761314026,420,-2,-91,-3,-9,-2,5,3,-3,3,0,-1,2,1,-1,3,2,-2,2,0,1,-5,-1,-1,-3,4,-3,0,0,-1,0,0,1,4,-1
KR_6761700685,440,1,8,24,1,0,6,6,0,1,1,-2,3,1,0,1,1,3,2,5,1,4,-247,0,-2,2,-1,0,0,-1,-1,1,1,3,-1
KR_6660822670,420,-5,-60,-35,-10,2,1,3,0,1,1,-2,4,2,-8,9,1,-2,4,2,-1,4,-15,-2,-1,3,-3,0,-1,-1,-1,-1,-1,4,-1
KR_6754383704,420,1,-89,4,4,-3,3,0,5,2,7,7,1,8,-6,7,1,1,1,2,0,2,17,-2,-5,7,5,0,-1,-1,1,1,1,2,-1
KR_6759855221,420,-2,-24,12,-4,-2,3,1,0,5,5,-4,6,2,1,2,3,1,0,1,1,-3,4,3,-8,5,-4,0,0,-1,-1,0,1,6,-1
KR_6763792890,420,-2,-42,-1,-7,1,1,2,-2,5,3,-5,5,0,0,3,3,-1,1,0,0,-10,5,-2,-2,4,-22,0,1,-1,1,1,-1,4,-1
KR_6758349536,420,-7,-128,12,-14,-4,4,0,-6,6,0,-1,2,1,-4,4,0,1,0,1,0,-11,-8,3,-6,3,-1,0,-3,-1,1,-1,-1,2,-1
KR_6740427032,420,-3,31,-35,1,3,1,4,-1,2,1,-3,3,0,-1,2,1,3,0,3,0,0,-12,-2,-3,5,-3,0,0,0,1,1,1,0,-1
KR_6715800335,420,-6,-93,-28,-3,-2,4,2,4,4,8,0,2,2,-4,4,0,-1,1,0,0,-2,-16,-3,-2,5,-2,0,0,1,-1,-1,-1,4,-1
KR_6757129505,420,1,-11,6,-1,3,1,4,-4,5,1,1,2,3,-2,6,4,1,0,1,0,-8,-4,-3,-1,4,0,0,-1,1,-1,-1,1,3,-1
KR_6761623943,420,-3,4,-8,-5,-9,9,0,2,2,4,1,2,3,-2,3,1,3,1,4,0,-4,14,-2,-2,4,1,0,-1,0,1,-1,1,0,-1
KR_6744713056,420,-6,-49,-36,-10,-7,7,0,-1,3,2,-3,5,2,3,2,5,-2,4,2,0,-4,-18,-1,-4,5,2,0,-4,-1,-1,-1,1,3,-1
KR_6726342262,420,-4,-37,28,-11,-4,4,0,-2,3,1,-1,3,2,-3,4,1,-1,4,3,0,-3,-6,2,-2,0,1,0,-1,-1,1,1,1,5,-1
KR_6713964626,440,-3,-86,-8,-11,1,1,2,-2,5,3,-3,4,1,-6,6,0,-1,4,3,-2,-10,4,-6,-1,7,-2,0,-2,-1,1,-1,-1,6,-1
KR_6626680119,420,-2,-21,-8,-4,0,1,1,-8,8,0,1,2,3,3,1,4,0,0,0,0,-12,205,-1,-1,2,-1,0,0,-1,0,-1,1,4,-1
KR_6748093708,420,-3,18,-32,1,5,1,6,-2,4,2,2,2,4,0,2,2,-4,4,0,0,-5,-347,-1,0,1,-3,0,-1,-1,-1,-1,1,5,-1
KR_6731471862,420,-3,-70,-19,-7,2,1,3,2,3,5,-2,4,2,-9,9,0,0,2,2,0,-5,-4,-1,-2,3,0,0,-1,-1,-1,-1,-1,2,-1
KR_6761657784,420,-3,-42,4,-8,-6,7,1,0,2,2,-2,2,0,-2,5,3,2,0,2,0,-2,5,1,-4,3,-2,0,-2,-1,0,-1,1,6,-1
KR_6452123028,420,1,39,10,1,2,3,5,-2,2,0,3,3,6,-3,5,2,1,2,3,0,0,4,-2,-2,4,1,0,0,-1,-1,1,1,4,-1
KR_6735411650,420,-4,-34,12,-12,0,0,0,3,0,3,-2,5,3,-5,5,0,-8,8,0,0,-18,1,-1,-1,2,0,0,-1,-1,-1,-1,-1,1,-1
KR_6585825918,420,-7,-104,-24,-18,-2,5,3,0,0,0,-8,9,1,-4,4,0,-4,4,0,0,-9,-14,0,0,0,-1,0,-3,-1,-1,-1,-1,1,-1
KR_6696064528,420,1,-98,10,1,-6,6,0,4,0,4,-4,6,2,5,2,7,2,0,2,2,13,36,-6,0,6,3,0,-1,-1,1,-1,1,4,-1
KR_6752548822,440,0,18,-3,1,3,1,4,-3,10,7,2,4,6,-1,4,3,0,3,3,-3,-10,11,-4,-3,7,-3,0,0,-1,-1,0,-1,3,-1
KR_6592367353,420,0,-14,3,2,5,0,5,2,1,3,-4,5,1,0,1,1,-1,3,2,0,0,-12,3,-4,1,0,0,0,1,-1,1,-1,3,-1
KR_6764420555,420,-4,-90,-7,-8,-4,4,0,-1,2,1,-6,7,1,2,1,3,1,0,1,0,-11,-1,-5,0,5,3,0,0,-1,-1,0,1,3,-1
KR_6607727247,420,2,42,-12,0,1,2,3,2,2,4,2,2,4,-1,2,1,-4,4,0,-1,-4,9,2,-4,2,-3,0,0,-1,-1,-1,-1,5,-1
KR_6730069921,420,-7,-44,-35,-13,-4,4,0,-1,1,0,-3,3,0,-1,2,1,-4,4,0,-1,-14,24,-3,-2,5,-7,0,-1,-1,-1,-1,-1,3,-1
KR_6703620101,440,-3,-142,8,-10,-4,5,1,-1,3,2,-2,5,3,-1,3,2,-2,5,3,-1,-10,-19,-2,0,2,18,0,-1,-1,0,-1,-1,2,-1
KR_6710966702,420,-5,-116,-17,-3,-3,3,0,-1,5,4,-5,5,0,3,0,3,3,0,3,0,6,-7,-3,0,3,-2,0,-2,1,-1,-1,1,3,-1
KR_6653640904,420,-2,-14,16,-7,-4,6,2,-5,5,0,-1,2,1,3,0,3,0,2,2,0,-4,-4,-3,-2,5,1,0,0,1,-1,-1,1,3,-1
KR_6742703643,420,2,31,-16,-3,-9,9,0,1,0,1,-1,2,1,5,5,10,1,0,1,0,6,5,0,-2,2,-1,0,-2,-1,-1,-1,-1,1,-1
KR_6722614570,420,2,-18,15,3,-5,5,0,4,0,4,0,3,3,1,1,2,3,1,4,0,1,5,-2,-2,4,0,0,-1,1,-1,-1,1,1,-1
KR_5609003628,420,-8,-75,-106,-15,0,0,0,-4,4,0,-8,8,0,-5,6,1,2,0,2,0,-9,-79,-1,-3,4,3,0,-5,-1,-1,-1,-1,3,-1
KR_6762561179,440,2,50,22,2,0,2,2,0,3,3,3,1,4,-5,6,1,4,0,4,0,-4,-216,2,-4,2,4,0,0,1,1,1,-1,3,-1
KR_6726184784,420,-1,-83,4,-1,1,1,2,-2,3,1,-2,5,3,2,1,3,0,1,1,0,-1,2,0,-5,5,-3,0,-1,-1,-1,-1,-1,3,-1
KR_6720196959,440,-6,-121,-12,-11,1,1,2,-4,7,3,-8,9,1,0,2,2,0,2,2,-1,-5,-11,-2,-3,5,0,0,-2,0,-1,-1,-1,0,-1
KR_6757396613,420,-8,-76,-12,-21,1,1,2,0,0,0,-6,8,2,-14,14,0,-2,3,1,0,-18,-11,-3,-1,4,0,0,-2,-1,-1,-1,-1,5,-1
KR_6602405333,420,-2,-55,-9,-4,1,1,2,3,1,4,-5,6,1,-2,5,3,-1,2,1,0,-5,-3,-1,-3,4,-3,0,-1,-1,1,-1,-1,3,-1
KR_6244021175,420,-3,-75,3,-8,-3,3,0,0,3,3,-8,8,0,2,0,2,1,0,1,0,-6,-9,-7,-1,8,4,0,-2,1,-1,-1,-1,6,-1
KR_6692225264,420,0,-25,15,-2,0,2,2,1,1,2,2,5,7,-4,5,1,-1,2,1,0,0,-289,1,-4,3,0,0,0,-1,1,0,-1,3,-1
KR_6696234537,420,3,51,24,-10,0,3,3,0,4,4,0,3,3,-8,8,0,-2,2,0,0,-14,-243,1,-4,3,-2,0,0,0,0,-1,1,0,-1
KR_6238581644,420,-1,-44,9,-6,-4,5,1,2,0,2,2,0,2,-4,5,1,-2,2,0,0,-7,42,-2,-1,3,0,0,1,1,1,1,-1,3,-1
KR_6724070089,420,-3,-67,-24,-4,-1,4,3,-4,4,0,-1,3,2,2,2,4,0,0,0,0,-1,6,1,-5,4,-1,0,-2,-1,-1,-1,-1,5,-1
KR_6748849046,420,-5,-85,-13,-7,3,0,3,-3,4,1,-3,4,1,-5,9,4,1,2,3,0,-4,107,-2,-2,4,2,0,-1,-1,1,-1,-1,5,-1
KR_5608921881,420,-4,-81,-12,-2,0,3,3,0,2,2,-2,5,3,2,1,3,-2,3,1,0,4,20,0,-8,8,0,0,1,1,1,-1,-1,4,-1
KR_6632222972,420,-3,-72,4,-13,-3,4,1,-3,5,2,-3,4,1,-2,3,1,-2,2,0,1,-11,101,3,-3,0,1,0,-1,-1,0,-1,1,5,-1
KR_6669160443,420,2,-6,16,1,-2,4,2,0,4,4,4,0,4,0,2,2,-1,3,2,0,8,-19,-3,-2,5,6,0,1,-1,1,1,1,2,-1
KR_6660727358,420,-1,-105,-7,0,0,2,2,3,0,3,-2,6,4,-3,3,0,2,0,2,0,-1,-34,-3,-3,6,1,0,0,-1,-1,-1,1,1,-1
KR_6739828865,420,2,-65,-16,6,-4,4,0,9,1,10,1,0,1,-1,3,2,1,1,2,0,7,3,1,-5,4,-3,0,0,1,0,0,-1,4,-1
KR_6683015031,420,0,-20,-5,-2,0,1,1,1,2,3,-3,6,3,-1,5,4,1,2,3,-1,-3,7,3,-5,2,-5,0,-1,-1,0,-1,-1,1,-1
KR_6633058619,420,0,5,8,-5,1,1,2,2,1,3,-4,4,0,-2,5,3,-2,2,0,0,-18,-22,-1,-2,3,3,0,0,-1,1,0,1,5,-1
KR_6684625805,420,-3,-61,0,-4,2,1,3,0,1,1,-4,6,2,-3,4,1,1,0,1,1,0,-3,-1,0,1,1,0,-1,-1,1,1,1,2,-1
KR_6654244922,420,-1,-103,23,-4,-1,2,1,0,1,1,-1,2,1,-1,1,0,-1,2,1,0,-6,4,1,-6,5,1,0,0,-1,1,0,-1,3,-1
KR_6712324983,440,5,41,40,7,0,2,2,-1,2,1,1,1,2,4,0,4,3,1,4,0,10,-27,-2,-3,5,0,0,0,-1,0,0,-1,5,-1
KR_6332758190,420,-5,-52,-25,-14,-5,6,1,-4,7,3,-3,5,2,-5,8,3,3,0,3,-2,-11,183,1,-3,2,1,0,-1,-1,-1,-1,-1,1,-1
KR_6696942171,420,-3,-1,8,-8,-1,2,1,-1,3,2,-4,4,0,-5,5,0,3,0,3,-1,-5,-279,0,-3,3,-2,0,0,1,-1,-1,-1,4,-1
KR_6706711606,420,2,34,7,-1,1,0,1,-1,4,3,0,0,0,-1,1,0,0,0,0,2,1,-3,2,-6,4,-2,0,0,1,-1,0,1,2,-1
KR_6696548294,420,0,-12,28,6,3,1,4,5,3,8,-3,3,0,3,2,5,-2,4,2,0,5,-2,1,-4,3,2,0,-1,-1,1,-1,1,6,-1
KR_6632783217,420,-1,28,-12,-13,-2,2,0,-2,3,1,-1,2,1,-5,7,2,-3,3,0,0,-15,109,-8,-3,11,1,0,-2,-1,-1,-1,-1,2,-1
KR_6637231508,420,0,-44,-4,0,-2,3,1,-2,3,1,0,3,3,2,3,5,2,0,2,0,2,5,-3,-2,5,-1,0,0,-1,-1,0,1,4,-1
KR_6721272856,420,-3,-34,-28,-4,1,0,1,-2,2,0,-1,2,1,-3,3,0,1,0,1,0,-10,1,0,-3,3,-3,0,-1,-1,1,-1,-1,4,-1
KR_6606963635,420,-2,-49,-4,-8,-4,4,0,-2,4,2,-4,9,5,2,0,2,0,0,0,-1,-2,-121,0,-2,2,-1,0,-1,0,-1,-1,-1,0,-1
KR_6724000704,420,1,135,13,-3,2,3,5,-1,2,1,-4,5,1,1,3,4,-1,3,2,0,-11,-4,-5,-1,6,4,0,1,-1,-1,1,1,6,-1
KR_6714060205,420,-3,-15,-44,-8,0,3,3,-6,6,0,-2,2,0,1,1,2,-1,2,1,0,-9,-5,-5,-2,7,2,0,0,-1,-1,0,1,5,-1
KR_6695714214,420,-1,-2,18,0,1,1,2,2,1,3,5,2,7,-6,6,0,-2,2,0,0,0,45,-2,-1,3,-3,0,1,-1,1,1,-1,1,-1
KR_6589219636,440,-3,-53,-16,-3,-5,5,0,3,2,5,0,1,1,0,3,3,-1,2,1,0,-3,-2,0,-2,2,1,0,-2,1,0,-1,-1,4,-1
KR_6642082553,420,-2,-80,4,-11,-3,3,0,-3,3,0,-1,3,2,-3,4,1,-1,2,1,0,-4,25,-1,-4,5,-7,0,0,-1,-1,-1,-1,1,-1
KR_6759713714,440,-4,-115,2,-3,1,1,2,2,0,2,-6,6,0,0,3,3,0,1,1,0,3,-1,-3,0,3,1,0,-1,0,-1,-1,-1,0,-1
KR_6537717309,420,-4,-74,-44,-7,-5,6,1,-2,2,0,1,3,4,0,5,5,-1,2,1,0,-4,-395,-4,-1,5,1,0,0,0,-1,0,-1,0,-1
KR_6453041550,420,-4,-49,14,-4,-1,1,0,-1,4,3,4,1,5,-4,5,1,-2,3,1,0,-7,-6,-5,-2,7,3,0,0,-1,1,0,1,5,-1
KR_6710232118,420,-3,-42,0,-5,-5,6,1,3,1,4,8,1,9,-9,11,2,-2,3,1,0,2,-247,2,-4,2,0,0,0,-1,-1,-1,1,2,-1
KR_6648578056,420,3,34,35,7,1,1,2,0,2,2,-2,4,2,8,1,9,0,2,2,0,8,-179,-1,0,1,1,0,1,1,0,1,1,6,-1
KR_6637067143,420,3,64,36,-4,-2,3,1,1,5,6,1,3,4,-2,5,3,-2,2,0,0,-6,-291,1,-3,2,1,0,1,0,-1,1,-1,0,-1
KR_6607027220,420,-2,-78,16,-9,-3,4,1,2,3,5,1,2,3,-5,6,1,-4,4,0,0,-5,-7,-2,-1,3,0,0,-1,-1,0,-1,1,6,-1
KR_6681125783,420,-4,-63,19,-2,-5,5,0,2,3,5,-3,5,2,1,3,4,3,2,5,0,6,-118,-5,0,5,-1,0,-2,1,-1,-1,-1,2,-1
KR_6657030072,420,-5,-27,-20,-6,-3,6,3,-1,2,1,2,0,2,-1,4,3,-3,3,0,2,-4,-3,4,-6,2,0,0,-1,1,1,-1,-1,2,-1
KR_6732815546,420,-1,26,-7,1,-1,1,0,0,2,2,4,0,4,1,3,4,-3,3,0,0,-1,-4,-3,-1,4,6,0,0,1,1,-1,-1,2,-1
KR_6708776062,420,-4,-94,-18,-10,0,1,1,-3,4,1,1,2,3,-3,3,0,-5,5,0,0,-9,9,4,-5,1,-2,0,-1,0,0,-1,1,0,-1
KR_6683282892,440,-1,43,3,4,1,0,1,1,4,5,-2,3,1,4,2,6,0,1,1,0,2,-9,-3,-4,7,-1,0,0,1,1,0,1,6,-1
KR_6581658566,420,-3,-25,-40,-5,-3,4,1,-2,3,1,-2,2,0,1,1,2,1,1,2,0,-5,-8,-3,-2,5,-2,0,-2,-1,-1,-1,1,2,-1
KR_6689752516,420,-2,-38,9,-4,1,2,3,3,0,3,-2,6,4,-2,5,3,-4,8,4,-1,-9,-11,2,-5,3,-3,0,-2,-1,0,-1,1,1,-1
KR_6761138241,440,1,-16,12,-3,2,3,5,-6,7,1,1,0,1,0,1,1,0,1,1,1,-3,0,-1,-2,3,1,0,0,0,0,0,1,0,-1
KR_6752265960,420,-2,-12,-15,1,1,4,5,1,0,1,0,5,5,0,3,3,-1,2,1,0,7,-60,1,-5,4,1,0,-1,-1,1,-1,-1,1,-1
KR_6603770298,420,2,-71,-20,-10,-7,8,1,2,1,3,0,3,3,-6,6,0,1,0,1,-1,-6,3,-1,-2,3,-1,0,0,1,1,1,-1,4,-1
KR_6640187909,420,0,-43,20,-5,-1,3,2,0,0,0,2,2,4,-6,6,0,0,2,2,0,-6,-8,-5,-1,6,2,0,0,-1,1,0,-1,6,-1
KR_6731280623,420,-5,-22,16,-11,3,0,3,-8,11,3,-3,6,3,-2,2,0,-1,1,0,0,-14,-221,0,-2,2,-3,0,1,-1,1,1,1,3,-1
KR_6723254156,420,0,-16,-12,-2,5,0,5,3,1,4,-8,9,1,2,3,5,-4,6,2,0,-5,2,-2,-1,3,1,0,-2,1,-1,-1,1,1,-1
KR_6703642748,420,-5,-63,-27,-9,-6,6,0,2,1,3,0,3,3,-4,5,1,-1,2,1,0,-4,-15,-3,0,3,3,0,-1,-1,0,-1,-1,6,-1
KR_6661605194,420,-3,-86,-12,-5,-2,4,2,-6,6,0,4,0,4,0,0,0,-1,1,0,0,-6,12,4,-5,1,-1,0,-1,1,1,-1,1,4,-1
KR_6713698510,420,1,41,16,-2,0,2,2,0,3,3,-1,2,1,-2,3,1,1,0,1,0,-6,-21,-1,-2,3,6,0,0,1,1,0,1,2,-1
KR_6565904148,420,-1,-62,16,0,-3,3,0,7,4,11,-4,6,2,0,1,1,0,2,2,0,-1,216,2,-5,3,-1,0,0,-1,1,0,-1,5,-1
KR_6630365019,420,2,-13,-16,10,2,1,3,5,0,5,1,0,1,-3,7,4,5,1,6,1,16,-30,0,-2,2,20,0,0,1,1,0,1,6,-1
KR_6698197030,420,-1,13,-8,-3,0,0,0,0,3,3,-10,10,0,8,0,8,-1,2,1,0,6,7,-4,-2,6,-1,0,-2,1,-1,-1,-1,6,-1
KR_6713971810,420,-3,-77,-24,2,4,2,6,4,1,5,0,6,6,-8,8,0,2,1,3,1,-2,149,2,-6,4,0,0,-1,-1,1,-1,1,4,-1
KR_6751896211,420,0,-18,19,-12,-3,3,0,-8,9,1,-1,1,0,1,3,4,-1,2,1,0,-14,-25,1,-5,4,3,0,-1,-1,0,-1,-1,4,-1
KR_6762116131,420,0,-24,12,0,-3,4,1,0,3,3,-1,2,1,4,0,4,0,0,0,0,10,5,2,-4,2,0,0,0,-1,-1,-1,-1,2,-1
KR_6748904493,440,1,29,3,5,0,1,1,-1,1,0,5,3,8,-4,6,2,5,1,6,0,2,5,1,-6,5,3,0,0,1,0,0,1,5,-1
KR_6621187236,420,-4,-84,-3,-5,-3,4,1,5,0,5,-4,5,1,-3,3,0,0,0,0,0,-3,-8,-1,0,1,0,0,-2,-1,1,-1,1,3,-1
KR_6740385187,420,-3,-20,38,-10,-1,2,1,-2,2,0,-1,2,1,0,3,3,-6,6,0,0,-9,-7,0,0,0,1,0,-1,1,1,-1,-1,4,-1
KR_6493859583,420,0,98,-16,1,-4,5,1,1,1,2,0,3,3,3,1,4,1,0,1,0,16,0,-1,-3,4,3,0,0,0,-1,-1,-1,0,-1
KR_6752360338,420,-1,-10,-8,-6,-10,10,0,0,1,1,2,2,4,2,1,3,0,1,1,0,-1,7,1,-3,2,0,0,0,-1,-1,-1,-1,3,-1
KR_6724756992,420,-3,-8,-11,-9,-2,2,0,-3,6,3,-5,5,0,1,9,10,0,0,0,0,-11,168,-2,-4,6,-1,0,-2,0,0,-1,1,0,-1
KR_6733596234,420,-4,-64,-8,-8,0,2,2,-1,3,2,-6,8,2,0,1,1,-1,1,0,0,-10,-12,-1,-1,2,0,0,-1,1,1,-1,-1,3,-1
KR_6675451831,420,-5,-3,-16,-11,-4,4,0,-2,5,3,-4,5,1,-1,2,1,0,0,0,0,-14,18,-2,-2,4,-3,0,-1,-1,0,-1,-1,6,-1
KR_6692058209,420,-2,36,-12,-5,1,0,1,-2,2,0,0,3,3,-1,3,2,-3,3,0,0,-17,3,-5,-3,8,1,0,0,1,0,0,1,2,-1
KR_6652888185,420,0,27,-22,-2,0,3,3,-2,4,2,2,2,4,-4,4,0,2,1,3,0,-1,-123,4,-6,2,-3,0,0,-1,1,0,-1,4,-1
KR_6758697384,420,-4,-74,-4,-6,-1,2,1,-6,6,0,-3,4,1,1,1,2,3,0,3,-1,-3,-15,1,-3,2,1,0,-1,-1,-1,-1,-1,4,-1
KR_6643656925,440,-3,-21,4,-9,5,0,5,-3,4,1,-6,7,1,-6,7,1,1,1,2,-1,-13,-6,-2,0,2,0,0,0,-1,-1,1,-1,1,-1
KR_6731816316,420,6,13,40,10,-3,4,1,7,1,8,0,5,5,5,0,5,1,1,2,1,16,8,2,-3,1,0,0,2,1,1,1,1,3,-1
KR_6610445778,440,4,6,-3,8,1,3,4,2,2,4,4,1,5,0,3,3,1,0,1,0,3,-256,0,-2,2,-4,0,0,1,1,1,1,5,-1
KR_6691570420,420,-2,-3,-8,-5,-2,3,1,1,1,2,-7,8,1,1,1,2,2,1,3,0,-3,-23,3,-5,2,4,0,0,1,-1,0,-1,5,-1
KR_6655943505,420,-5,-1,-39,-4,1,1,2,-5,7,2,-1,2,1,3,1,4,-2,2,0,0,-5,23,1,-5,4,-26,0,-1,0,1,-1,-1,0,-1
KR_6755364999,420,1,-3,-24,-7,-2,2,0,-4,4,0,2,0,2,-2,3,1,-1,1,0,0,-7,7,5,-8,3,-2,0,0,-1,-1,0,-1,3,-1
KR_6713057934,420,-2,-31,18,-4,3,0,3,-1,1,0,-5,8,3,-1,1,0,0,2,2,0,-6,-9,-4,0,4,-2,0,-2,-1,1,-1,1,4,-1
KR_6409291318,420,-1,-19,-43,-10,2,2,4,-4,5,1,-9,9,0,0,1,1,1,0,1,0,-10,5,-1,-2,3,0,0,-1,0,-1,-1,-1,0,-1
KR_6654954142,440,1,-122,32,-1,0,1,1,5,0,5,-4,5,1,0,2,2,-2,2,0,0,2,-1,-1,-1,2,1,0,-1,1,1,-1,-1,2,-1
KR_6760757297,420,2,81,4,3,3,0,3,-3,3,0,3,1,4,1,1,2,-1,2,1,0,-5,-2,0,-4,4,8,0,1,-1,1,1,1,5,-1
KR_6752461112,420,-7,-96,-28,-9,-4,6,2,0,1,1,1,5,6,-11,12,1,5,1,6,0,-1,12,-1,-1,2,2,0,-2,1,-1,-1,-1,4,-1
KR_6752401237,420,-7,-218,-28,-15,1,5,6,4,1,5,-15,15,0,-4,6,2,-1,2,1,-1,1,213,0,0,0,-1,-2,-8,-1,-1,-1,-1,6,-1
KR_6754328273,420,-1,66,-28,0,6,0,6,-2,3,1,4,1,5,-4,5,1,-4,4,0,0,-8,39,2,-6,4,-1,0,0,1,1,-1,1,4,-1
KR_6762906437,420,-2,-22,-8,-5,1,0,1,-1,2,1,1,2,3,-5,6,1,-1,2,1,-2,-10,-13,0,-2,2,-1,0,-1,0,-1,-1,-1,0,-1
KR_6668536872,420,1,51,-40,3,-2,2,0,1,2,3,-1,4,3,4,2,6,1,2,3,0,3,113,-3,-2,5,5,0,-2,-1,-1,-1,-1,5,-1
KR_6753576112,440,-2,-29,-27,-9,-1,3,2,0,0,0,0,0,0,-10,12,2,2,0,2,0,-11,-1,-3,-1,4,3,0,-1,-1,-1,-1,-1,1,-1
KR_6655433504,420,-5,-103,-23,-18,-8,9,1,-4,6,2,2,1,3,-10,11,1,2,0,2,0,-11,-233,2,-4,2,-7,0,-2,-1,-1,-1,-1,5,-1
KR_6623219256,440,-7,-88,-32,-20,-9,9,0,-3,3,0,-2,5,3,-5,5,0,-1,1,0,0,-16,-8,2,-4,2,-1,-1,-6,-1,-1,-1,-1,4,-1
KR_6694811435,420,-3,-8,-12,-7,0,2,2,-5,7,2,2,4,6,-3,3,0,-1,2,1,0,-13,35,0,-5,5,-27,0,0,-1,-1,-1,1,5,-1
KR_6760466108,420,0,0,36,4,-1,3,2,-2,3,1,1,1,2,5,3,8,1,2,3,1,8,5,1,-3,2,0,0,-1,1,-1,-1,1,5,-1
KR_6715783511,420,4,38,5,5,-3,3,0,3,2,5,4,1,5,0,4,4,1,0,1,0,8,13,1,-5,4,1,0,0,-1,-1,0,1,5,-1
KR_6704850769,420,-4,-101,-44,-7,0,1,1,4,1,5,-6,7,1,-1,4,3,-4,4,0,0,-2,-32,-3,-2,5,3,0,0,-1,1,0,-1,6,-1
KR_6641465604,420,3,56,29,3,-1,3,2,-3,4,1,-1,3,2,5,0,5,3,0,3,0,3,-324,2,-2,0,0,0,0,1,0,-1,1,2,-1
KR_6735501352,420,-2,51,29,-1,0,0,0,1,0,1,2,2,4,-8,8,0,4,1,5,1,-8,117,1,-3,2,0,0,2,1,1,-1,1,6,-1
KR_6705834823,420,-1,65,-5,0,2,0,2,-1,1,0,-2,4,2,2,1,3,-1,2,1,0,-4,-154,2,-3,1,2,0,0,1,-1,1,-1,4,-1
KR_6665626836,440,-3,-43,-22,-2,3,1,4,-2,4,2,2,1,3,-5,5,0,0,0,0,0,-9,145,1,-2,1,-1,0,0,-1,1,0,1,6,-1
KR_6516790036,420,5,22,-13,13,2,0,2,1,2,3,2,3,5,6,1,7,2,1,3,0,10,39,6,-6,0,-13,0,0,-1,-1,0,1,1,-1
KR_6097330557,420,-3,-103,-16,-8,1,0,1,-2,3,1,1,6,7,-4,5,1,-4,6,2,-1,2,-110,2,-5,3,0,0,-3,0,-1,-1,-1,0,-1
KR_6742646410,420,-7,-147,-36,-17,-6,7,1,-2,3,1,-3,4,1,-6,7,1,0,1,1,-1,-6,-6,-1,-2,3,-2,0,-3,-1,-1,-1,-1,1,-1
KR_6713548041,420,-4,-60,-20,-9,-1,3,2,0,1,1,-2,2,0,-5,6,1,-1,1,0,0,-8,-4,3,-5,2,3,0,-2,1,1,-1,-1,6,-1
KR_6754094838,420,-2,-48,7,-4,0,0,0,1,1,2,-1,3,2,-2,4,2,-2,3,1,-1,-4,-22,0,-2,2,3,0,0,1,-1,0,-1,6,-1
KR_6659489908,420,0,-109,13,-8,1,1,2,-3,3,0,0,3,3,-3,6,3,-3,3,0,0,-5,22,-4,-2,6,-4,0,0,1,1,0,-1,6,-1
KR_6726122001,420,0,-62,-19,-6,-1,2,1,0,3,3,-8,9,1,2,3,5,1,0,1,-2,1,-7,-2,-1,3,0,0,-1,-1,-1,-1,-1,4,-1
KR_6658743644,420,-3,-83,-16,-5,4,0,4,1,2,3,-2,4,2,-5,9,4,-3,6,3,0,-3,-8,0,-2,2,-2,0,-1,1,-1,-1,-1,5,-1
KR_6505135349,420,2,30,-12,1,2,1,3,-8,9,1,2,0,2,4,0,4,1,0,1,0,5,229,-1,-2,3,-1,0,1,1,-1,1,-1,3,-1
KR_6744712262,440,-9,-89,-28,-18,1,1,2,-5,10,5,-2,3,1,-8,8,0,-4,4,0,0,-13,-6,2,-3,1,-3,0,-2,-1,-1,-1,-1,4,-1
KR_6759948038,420,-1,-30,-12,-8,-4,6,2,-6,7,1,7,2,9,-3,4,1,-2,2,0,0,-4,-1,2,-3,1,0,0,-1,1,1,-1,1,3,-1
KR_6738323881,420,-2,-13,0,-2,-4,4,0,-2,3,1,-1,5,4,1,1,2,4,1,5,0,2,4,-2,-1,3,2,0,0,1,1,1,1,1,-1
KR_6719446251,420,-2,27,-19,-2,-2,2,0,-3,3,0,1,2,3,1,1,2,1,0,1,1,-3,6,3,-7,4,-1,0,0,1,0,0,1,3,-1
KR_6728600550,440,1,6,2,3,-3,3,0,0,2,2,2,2,4,2,3,5,2,0,2,0,10,417,0,-4,4,1,0,0,1,-1,0,1,4,-1
KR_6759990516,420,-4,-65,-39,-1,-4,5,1,0,1,1,0,2,2,5,0,5,-2,3,1,0,5,-4,2,-4,2,0,0,-1,0,-1,-1,1,0,-1
KR_6748615835,440,-3,-62,-9,-8,3,0,3,-7,7,0,1,0,1,-5,7,2,0,1,1,1,-10,203,0,-2,2,-5,0,0,0,-1,0,1,0,-1
KR_6614621305,440,-3,-44,20,-7,-2,2,0,-5,6,1,-4,4,0,5,0,5,-1,1,0,0,1,3,0,-1,1,-2,0,-1,1,-1,-1,1,6,-1
KR_6634189176,420,-3,9,-16,-15,-3,4,1,1,1,2,-3,4,1,-6,8,2,-4,4,0,0,-16,18,2,-2,0,-3,0,-1,-1,-1,-1,-1,2,-1
KR_6759028482,420,-4,-26,0,-5,-1,1,0,-1,4,3,0,4,4,-3,3,0,0,0,0,0,-4,-2,0,-1,1,-4,0,0,-1,1,0,-1,6,-1
KR_6753255996,420,-4,-51,3,-7,2,2,4,-5,5,0,-3,6,3,-1,1,0,0,3,3,0,-11,244,-4,-1,5,1,0,0,1,1,0,1,2,-1
KR_6692676494,420,-4,-102,16,-12,0,1,1,1,3,4,-6,8,2,-6,6,0,-1,2,1,-1,-9,9,-2,-1,3,-2,0,-2,-1,-1,-1,-1,4,-1
KR_6740273888,420,-3,-30,-1,-5,0,1,1,-3,3,0,1,1,2,-3,5,2,0,1,1,0,-4,-2,-3,-3,6,-2,0,0,1,1,-1,1,6,-1
KR_6759744744,440,3,-15,8,1,-2,3,1,9,0,9,0,2,2,-4,8,4,-2,2,0,0,-3,-9,4,-6,2,1,0,-1,1,-1,-1,1,3,-1
KR_6635906333,420,-3,-106,-20,-2,0,1,1,1,1,2,0,3,3,-2,4,2,-1,2,1,0,1,10,-2,-1,3,0,0,-1,-1,-1,-1,-1,6,-1
KR_6097570609,420,2,-36,10,4,0,3,3,3,1,4,2,2,4,-1,1,0,0,0,0,-1,4,-8,1,-2,1,-1,0,0,0,0,0,-1,0,-1
KR_6731542590,420,-7,-52,-48,-14,1,4,5,-2,3,1,-5,5,0,-9,10,1,1,1,2,-1,-12,0,2,-2,0,-2,0,-1,-1,-1,-1,-1,6,-1
KR_6760925910,420,-1,-6,-7,-2,1,1,2,-3,4,1,-1,2,1,3,1,4,-2,3,1,0,-5,-3,2,-4,2,-1,0,0,-1,0,0,1,5,-1
KR_6716210814,420,-6,28,-82,-4,1,0,1,-3,5,2,-1,4,3,0,2,2,-1,2,1,-1,-4,42,-2,-1,3,-31,0,-1,-1,-1,-1,-1,5,-1
KR_6684978578,420,1,82,4,7,0,1,1,-5,6,1,6,1,7,6,1,7,0,1,1,0,7,-5,-3,-4,7,0,1,3,-1,1,1,1,6,-1
KR_6537640274,420,-1,-49,28,-12,1,1,2,-3,4,1,-3,5,2,-7,7,0,0,1,1,-2,-18,-14,-3,0,3,4,0,0,1,-1,-1,-1,5,-1
KR_6725524242,420,2,73,18,0,2,0,2,-2,4,2,1,0,1,1,1,2,-2,2,0,0,-6,4,2,-3,1,1,0,0,0,1,0,-1,0,-1
KR_6693509797,420,-4,-64,-40,-13,1,1,2,-3,6,3,-8,10,2,-3,4,1,0,2,2,0,-19,344,-1,-1,2,-1,0,-4,-1,-1,-1,-1,1,-1
KR_6434617589,420,-1,-57,-7,1,5,0,5,-6,7,1,1,3,4,2,4,6,-1,1,0,0,6,-7,3,-4,1,0,0,0,1,1,0,1,1,-1
KR_6605373513,420,-2,4,20,-7,0,1,1,-1,1,0,0,2,2,-5,7,2,-1,2,1,0,-9,12,5,-9,4,-5,0,0,-1,0,0,-1,6,-1
KR_6714663722,420,-1,-32,-8,-3,-3,4,1,-1,2,1,-1,1,0,2,3,5,0,0,0,0,-3,-118,-3,0,3,0,0,-1,-1,-1,-1,1,1,-1
KR_6741453207,420,-2,-12,32,-11,-3,4,1,-2,4,2,0,2,2,-1,1,0,-5,5,0,0,-8,13,4,-6,2,-5,0,0,0,1,0,-1,0,-1
KR_6649448451,420,-3,-27,-25,4,-5,5,0,-4,4,0,2,1,3,5,1,6,6,0,6,0,3,-320,0,-5,5,-2,0,-2,-1,0,-1,1,2,-1
KR_6628940428,420,-7,-80,-32,-15,1,1,2,-5,6,1,-3,4,1,3,2,5,-11,11,0,0,-12,2,2,-3,1,-3,0,-2,-1,-1,-1,-1,3,-1
KR_6760259504,420,-1,-27,-23,-3,-7,8,1,1,3,4,1,1,2,0,4,4,2,1,3,0,6,-2,-1,0,1,3,0,-1,-1,1,-1,1,4,-1
KR_6761901690,440,-2,43,-20,-3,1,2,3,-9,9,0,1,2,3,4,4,8,0,1,1,1,-3,-13,0,-4,4,0,0,0,0,-1,0,1,0,-1
KR_6628002141,420,-2,-42,-3,-13,-4,6,2,-2,3,1,-2,2,0,-5,5,0,0,0,0,0,-12,3,1,-8,7,4,0,0,-1,1,0,-1,4,-1
KR_6761880537,440,-4,-82,3,-10,-3,3,0,5,1,6,-6,7,1,-7,7,0,1,0,1,0,-4,-2,-1,-3,4,-3,0,-2,-1,0,-1,-1,2,-1
KR_6615956708,420,0,59,-14,-2,-2,2,0,-2,2,0,1,0,1,0,2,2,1,2,3,0,-4,10,3,-4,1,1,0,0,-1,1,0,1,4,-1
KR_6650331684,440,-4,-76,-18,-3,1,4,5,0,3,3,-1,3,2,-2,3,1,-1,1,0,0,-7,12,1,-6,5,-2,0,0,0,1,0,-1,0,-1
KR_6724016173,420,-7,-114,-24,-9,-2,2,0,-3,3,0,-7,8,1,3,2,5,0,1,1,0,1,7,1,-2,1,0,-1,-6,-1,-1,-1,-1,3,-1
KR_6761153301,440,-3,-43,21,-6,6,1,7,-8,10,2,-4,7,3,1,2,3,-1,6,5,0,-3,-157,2,-3,1,2,0,-1,-1,-1,-1,1,2,-1
KR_6656724455,420,2,-68,1,3,4,1,5,0,3,3,0,4,4,2,0,2,-3,3,0,-2,-2,1,0,-1,1,1,0,1,0,1,1,-1,0,-1
KR_6759093090,420,-1,20,4,0,-1,1,0,-1,3,2,3,0,3,2,3,5,-3,3,0,0,5,0,-1,-1,2,6,0,0,1,1,-1,1,4,-1
KR_6658881951,440,-1,-29,-12,-3,6,0,6,0,1,1,-5,6,1,-2,3,1,-2,3,1,0,-7,-15,-2,-4,6,-1,0,0,-1,0,-1,1,2,-1
KR_6692627404,420,-2,-33,-8,0,-4,5,1,2,1,3,3,2,5,1,1,2,-2,3,1,0,1,1,0,0,0,0,0,2,1,1,1,1,6,-1
KR_6762647194,420,-2,-33,-20,-2,4,0,4,1,0,1,-3,4,1,-3,3,0,-1,2,1,0,-3,-560,-3,-1,4,1,0,0,-1,0,0,1,4,-1
KR_6742018088,420,-2,-38,-9,-6,-1,2,1,-1,2,1,0,1,1,-2,4,2,-2,2,0,-1,-5,-316,0,-3,3,1,0,0,-1,-1,0,-1,6,-1
KR_6733193095,420,-4,-62,-13,-9,-2,3,1,3,2,5,-4,5,1,-4,4,0,-2,3,1,0,-5,-1,-1,-4,5,-4,0,-1,-1,-1,-1,1,2,-1
KR_6731587940,420,-8,-102,-16,-16,-4,4,0,-2,3,1,-3,5,2,-2,4,2,-5,6,1,0,-7,-15,-1,-3,4,-3,0,-2,-1,1,-1,-1,5,-1
KR_6723182445,420,0,13,21,8,2,0,2,-4,5,1,3,1,4,5,1,6,2,0,2,0,2,-9,0,-3,3,2,0,3,-1,1,1,1,4,-1
KR_6614762445,420,-2,18,20,-1,1,1,2,-2,6,4,2,1,3,-1,1,0,-1,1,0,1,-1,7,-2,-3,5,1,0,0,0,-1,0,1,0,-1
KR_6731197111,420,-3,-56,-20,-2,0,0,0,-1,1,0,-2,5,3,1,0,1,0,0,0,0,-1,-3,1,-3,2,-1,0,0,0,-1,-1,-1,0,-1
KR_6723942520,440,0,10,12,0,8,0,8,-4,5,1,-1,2,1,0,4,4,-3,5,2,-1,-11,-19,-7,-1,8,6,0,2,0,1,1,-1,0,-1
KR_6597123502,420,-2,-27,-20,-1,1,1,2,2,0,2,4,0,4,-5,8,3,-3,6,3,0,5,9,-4,-2,6,2,0,0,0,1,-1,-1,0,-1
KR_6706106647,440,-4,-30,16,-13,-7,7,0,2,2,4,-5,6,1,0,2,2,-3,3,0,0,-2,46,2,-4,2,-8,0,0,1,0,0,-1,4,-1
KR_6695980643,420,1,2,11,4,-1,2,1,3,0,3,3,3,6,0,0,0,-1,1,0,0,3,17,4,-4,0,-1,0,-1,0,0,-1,-1,0,-1
KR_6758089944,420,-1,-21,15,-6,-2,4,2,1,0,1,-1,2,1,-5,5,0,1,2,3,1,0,-4,-1,-6,7,5,0,0,0,-1,0,1,0,-1
KR_6726198841,440,-3,-17,-2,-12,-2,3,1,2,2,4,-1,1,0,-3,5,2,-8,9,1,0,-9,-8,-3,-3,6,3,0,-2,-1,1,-1,-1,4,-1
KR_6762671534,420,-1,-58,40,-3,-2,3,1,0,2,2,-2,3,1,2,2,4,-1,2,1,0,-3,7,3,-5,2,-3,0,0,1,1,0,-1,5,-1
KR_6712738533,420,-5,-50,-36,-11,-2,4,2,1,3,4,-1,3,2,-6,8,2,-3,4,1,0,-10,-10,-2,-1,3,1,0,-1,1,-1,-1,-1,5,-1
KR_6653408018,420,-4,-92,-20,-5,-5,5,0,-1,3,2,-2,2,0,4,2,6,-1,1,0,0,-2,-9,-1,-4,5,1,0,-1,0,0,-1,1,0,-1
KR_6612056305,420,4,19,27,3,-2,3,1,-4,5,1,7,0,7,2,0,2,0,2,2,0,8,1,0,-5,5,-2,0,1,0,0,1,-1,0,-1
KR_6677655844,420,-3,-80,-4,-4,3,1,4,-6,7,1,-5,5,0,2,1,3,2,0,2,1,-9,-22,-3,-1,4,2,0,-1,1,0,-1,1,6,-1
KR_6741889411,420,2,32,-28,2,3,1,4,1,4,5,-1,3,2,1,2,3,-2,2,0,0,0,3,3,-9,6,-2,0,0,-1,1,0,-1,6,-1
KR_6726060260,420,-9,-110,-12,-22,-6,7,1,-2,4,2,-6,7,1,-4,4,0,-4,5,1,0,-7,-5,-1,-2,3,-2,0,-4,-1,-1,-1,-1,1,-1
KR_6724508108,420,-4,-58,-8,-10,2,0,2,-4,4,0,-2,2,0,-5,6,1,-1,1,0,0,-11,-10,-7,-1,8,1,0,-1,-1,-1,-1,1,2,-1
KR_6748085598,420,-6,-72,-32,-9,-4,5,1,-3,3,0,-3,3,0,0,1,1,1,1,2,1,-6,5,1,-2,1,-3,0,-2,-1,1,-1,1,3,-1
KR_6656700755,420,2,2,17,1,5,1,6,-3,5,2,3,2,5,-4,4,0,0,0,0,0,0,-5,-1,-2,3,-1,0,0,1,-1,-1,-1,3,-1
KR_6672353178,420,-6,-5,-15,-12,-5,6,1,-1,4,3,0,0,0,-1,3,2,-5,6,1,0,-12,-2,-1,-4,5,-4,0,0,-1,0,0,1,6,-1
KR_6750993443,440,1,-44,-8,-3,5,0,5,-3,3,0,0,4,4,-5,5,0,0,0,0,0,-10,-21,-2,-3,5,2,0,0,-1,0,0,-1,1,-1
KR_6742257334,420,-5,-3,-22,-11,-7,8,1,2,0,2,-4,5,1,-2,4,2,0,0,0,0,-3,-100,-3,-1,4,-1,0,-1,1,-1,-1,1,6,-1
KR_6651739680,420,-3,-27,-8,2,2,3,5,3,1,4,0,2,2,-1,2,1,-2,2,0,1,3,5,-1,-4,5,-6,0,0,-1,0,0,1,6,-1
KR_6603409287,440,0,3,7,-6,1,1,2,-5,6,1,-4,4,0,0,1,1,2,1,3,0,-8,2,3,-4,1,-2,0,1,1,1,1,1,3,-1
KR_6707356961,440,2,57,-1,8,1,0,1,10,1,11,3,3,6,2,4,6,-8,10,2,2,3,9,0,-3,3,2,0,-1,0,-1,-1,1,0,-1
KR_6720530643,420,1,-2,2,4,4,1,5,0,1,1,-1,1,0,-3,4,1,4,0,4,1,-3,367,0,-1,1,-1,0,1,1,1,-1,1,4,-1
KR_6725648648,420,-4,-11,-38,2,-2,5,3,4,0,4,-2,4,2,2,1,3,0,2,2,0,3,0,0,-2,2,4,0,0,-1,-1,0,1,4,-1
KR_6612737141,420,-5,-15,-40,-2,0,1,1,1,1,2,0,3,3,0,0,0,-3,3,0,0,-5,-3,-2,0,2,-1,0,-2,-1,-1,-1,1,1,-1
KR_6675523643,420,1,-7,-3,-3,0,2,2,1,2,3,-2,3,1,-3,4,1,1,2,3,0,1,-1,-3,-1,4,-1,0,-3,1,-1,-1,-1,1,-1
KR_6751833939,420,1,1,-16,6,0,2,2,2,1,3,-4,5,1,5,2,7,3,0,3,0,8,-8,1,-1,0,-2,0,2,-1,-1,1,1,5,-1
KR_6653710112,440,-1,25,-12,-17,-8,9,1,0,3,3,-5,6,1,1,0,1,-5,5,0,-2,-21,-1,-1,-3,4,-3,0,0,-1,-1,0,-1,3,-1
KR_6763337884,420,-6,-23,-44,-8,2,1,3,-5,5,0,1,1,2,-6,6,0,0,0,0,0,-6,16,6,-7,1,-2,0,0,-1,1,0,-1,2,-1
KR_6750677931,440,-2,-85,-4,-4,-3,3,0,-1,4,3,-3,4,1,4,2,6,-1,1,0,0,-4,21,-2,-2,4,-2,0,0,0,-1,-1,-1,0,-1
KR_6609625801,420,-1,55,-11,-5,3,1,4,-4,4,0,-2,3,1,-3,3,0,1,1,2,0,-2,2,1,-3,2,-1,0,1,1,1,1,1,3,-1
KR_6698072228,420,-5,-20,-28,-21,-2,3,1,-4,4,0,-2,3,1,-7,8,1,-6,6,0,0,-22,21,-1,-4,5,-8,0,-1,-1,1,-1,-1,5,-1
KR_5610556289,420,-2,-32,2,-7,0,2,2,-3,3,0,2,2,4,-4,7,3,-2,3,1,1,-1,132,-1,-3,4,-7,0,-2,-1,-1,-1,1,5,-1
KR_6673665975,420,1,-6,-8,-6,0,1,1,-1,4,3,-7,9,2,2,2,4,0,1,1,0,4,-138,-1,-1,2,0,0,1,1,1,-1,1,5,-1
KR_6751046272,440,-6,-125,-39,-21,-9,9,0,-1,1,0,-4,4,0,-3,3,0,-4,9,5,-2,-19,287,-7,0,7,1,0,-2,-1,-1,-1,-1,3,-1
KR_6758494679,420,-1,-9,-16,-1,-2,4,2,0,1,1,2,1,3,1,0,1,-2,2,0,-1,6,18,-3,-2,5,-5,0,-1,0,-1,-1,-1,0,-1
KR_6603794247,440,-3,-37,-4,-6,-4,5,1,-2,4,2,1,3,4,-1,2,1,0,1,1,0,1,-12,0,-4,4,2,0,0,-1,-1,-1,-1,3,-1
KR_6743895930,420,0,43,-1,-3,2,1,3,-3,5,2,1,1,2,-2,3,1,-1,2,1,0,-1,-134,1,-6,5,2,0,0,0,1,0,-1,0,-1
KR_6737688038,420,0,-68,2,-1,-4,4,0,-2,3,1,0,3,3,5,0,5,0,0,0,1,6,12,0,-5,5,-3,0,-1,-1,-1,-1,1,3,-1
KR_6683960220,420,-4,-49,-11,-8,-5,7,2,-1,3,2,-4,7,3,1,3,4,1,1,2,-1,-8,5,2,-5,3,-7,0,-1,-1,1,-1,-1,2,-1
KR_6731924973,420,-1,-10,20,-3,-1,1,0,2,3,5,3,0,3,-3,4,1,-4,4,0,0,0,-9,1,-1,0,0,0,-1,1,-1,-1,-1,5,-1
KR_6580779884,420,-4,-23,12,-6,-3,3,0,4,2,6,-3,3,0,1,2,3,-5,5,0,1,-2,-505,-2,-3,5,-1,0,0,-1,-1,-1,1,4,-1
KR_6479914284,420,2,-77,2,-3,1,2,3,-3,4,1,-4,4,0,3,1,4,0,1,1,0,-1,-7,-3,0,3,-3,0,0,1,-1,-1,-1,2,-1
KR_6761613307,420,2,-46,0,7,2,2,4,3,1,4,1,1,2,1,2,3,0,1,1,0,8,-111,9,-12,3,-4,0,0,-1,1,0,1,4,-1
KR_6589459657,420,-2,-1,-8,-1,1,1,2,1,3,4,1,1,2,-1,1,0,-3,4,1,0,-8,307,-2,-2,4,3,0,-1,1,0,-1,1,2,-1
KR_6683631972,420,2,6,-1,3,1,1,2,0,0,0,2,1,3,3,1,4,-3,4,1,0,2,-254,0,-2,2,1,0,1,0,1,1,-1,0,-1
KR_6641953115,420,-8,-125,-28,-18,-3,4,1,-4,4,0,-7,7,0,-2,6,4,-2,2,0,0,-12,-2,2,-3,1,-1,0,-3,-1,-1,-1,-1,6,-1
KR_6654135018,420,2,75,22,3,2,0,2,-2,4,2,-2,4,2,1,0,1,4,0,4,0,7,1,-1,-3,4,2,0,0,0,-1,1,1,0,-1
KR_6674431850,420,0,-62,24,-1,0,3,3,-2,4,2,4,0,4,-2,6,4,-1,1,0,0,4,-225,1,-3,2,0,0,-2,1,-1,-1,-1,6,-1
KR_6719837960,420,0,-49,-18,-2,-2,2,0,1,5,6,0,2,2,-2,2,0,1,1,2,0,2,-20,1,-3,2,-2,0,-1,1,-1,-1,1,4,-1
KR_6737606654,420,0,-72,-11,-6,1,2,3,5,0,5,-3,5,2,-8,8,0,-1,1,0,0,-2,29,-7,-2,9,-12,0,-1,1,-1,-1,-1,1,-1
KR_6737343187,440,-3,-65,-43,-15,-3,4,1,-4,7,3,-5,10,5,-3,7,4,0,0,0,-2,-14,-6,-2,0,2,1,0,0,-1,1,1,-1,2,-1
KR_6646678737,420,0,-21,-15,3,-1,2,1,3,1,4,-3,4,1,2,1,3,2,0,2,0,7,-9,-2,-3,5,1,0,0,0,-1,0,1,0,-1
KR_6649425993,420,1,44,0,0,-1,1,0,0,0,0,2,0,2,1,0,1,-2,2,0,0,-3,3,3,-3,0,-3,0,0,1,1,0,1,1,-1
KR_6608545274,420,-1,-51,-15,-3,2,1,3,2,2,4,-3,4,1,-1,4,3,-3,3,0,0,-4,-55,2,-3,1,20,0,-1,1,0,-1,-1,4,-1
KR_6702604414,420,-1,-52,8,-4,2,3,5,0,5,5,1,3,4,-5,7,2,-2,2,0,1,-6,-4,1,-4,3,-4,0,-1,-1,1,-1,-1,1,-1
KR_6706185868,420,-4,-27,-32,-6,-9,9,0,-1,1,0,-3,3,0,5,0,5,2,0,2,0,1,2,2,-4,2,4,0,-1,-1,-1,-1,-1,5,-1
KR_6760654767,420,2,64,2,3,0,2,2,1,1,2,5,0,5,5,2,7,-8,8,0,1,-3,6,2,-6,4,2,0,0,1,-1,1,1,1,-1
KR_6688259932,420,-6,-14,-64,-11,5,0,5,-3,3,0,-7,9,2,-2,6,4,-4,5,1,0,-10,6,1,-3,2,-3,0,-2,-1,-1,-1,1,3,-1
KR_6615727014,420,-4,-106,-30,-8,-2,3,1,-1,3,2,-3,4,1,-1,3,2,-1,2,1,-1,-2,-3,-1,-2,3,0,0,-3,-1,-1,-1,-1,2,-1
KR_6387573577,420,-3,-1,-13,-5,-1,3,2,0,1,1,-3,6,3,1,1,2,-2,2,0,2,0,242,3,-4,1,0,0,-1,1,-1,-1,1,5,-1
KR_6635853362,420,-8,-60,-15,-16,-5,6,1,-1,4,3,-6,7,1,-6,6,0,2,1,3,0,-4,2,4,-6,2,-6,0,-2,-1,1,-1,-1,2,-1
KR_6738417561,420,1,-13,8,4,2,3,5,0,1,1,3,1,4,-1,3,2,0,0,0,0,-4,123,-1,-3,4,0,0,-1,-1,-1,-1,1,2,-1
KR_6587447651,420,-4,34,-35,-12,-1,2,1,-2,5,3,-3,4,1,-3,4,1,-3,4,1,-3,-17,4,1,-1,0,-5,0,1,0,1,1,-1,0,-1
KR_6392470962,420,-1,-59,-32,-4,1,0,1,-3,4,1,-4,5,1,0,1,1,2,0,2,0,-1,-1,-1,-1,2,1,0,0,-1,-1,0,1,2,-1
KR_6731784190,440,-2,-24,-20,2,6,1,7,0,2,2,3,1,4,-7,10,3,0,1,1,1,-9,5,0,-5,5,2,0,-1,1,1,-1,1,3,-1
KR_6758634887,420,2,13,24,0,0,2,2,1,1,2,-1,2,1,0,0,0,0,0,0,0,-1,20,-4,-1,5,-3,0,-1,-1,1,-1,1,4,-1
KR_6757115877,420,0,-1,-13,-3,-7,7,0,-3,3,0,1,1,2,3,1,4,3,1,4,0,-1,5,2,-3,1,-1,0,0,0,0,1,1,0,-1
KR_6743127823,420,1,-18,7,-10,1,1,2,-3,5,2,-5,7,2,-3,5,2,0,1,1,0,-7,-8,-3,-3,6,-3,0,-1,-1,-1,-1,-1,3,-1
KR_6652318664,420,2,43,12,3,5,0,5,0,3,3,-4,5,1,4,1,5,-2,3,1,0,1,1,-3,-5,8,2,0,0,1,-1,0,1,4,-1
KR_6702293326,420,0,-20,2,-2,-2,2,0,-1,1,0,0,3,3,1,3,4,0,1,1,0,-3,-3,-2,-3,5,0,0,-1,0,-1,-1,1,0,-1
KR_6725778222,420,-6,-78,-47,-17,-3,6,3,-4,5,1,-2,2,0,-6,6,0,-2,3,1,0,-17,168,-5,0,5,1,0,-2,1,1,-1,-1,1,-1
KR_6654447892,440,-2,-57,-47,-1,-3,3,0,1,0,1,1,1,2,-4,5,1,4,0,4,0,3,7,2,-5,3,4,0,1,1,0,1,1,6,-1
KR_6615341308,420,-6,-21,-12,-13,4,2,6,-9,10,1,0,0,0,-4,5,1,-4,5,1,-1,-10,364,-2,-1,3,2,0,0,-1,0,0,-1,2,-1
KR_6704264392,420,0,-59,15,-2,1,0,1,3,3,6,-1,6,5,-4,6,2,-1,2,1,-1,-7,6,1,-4,3,1,0,0,-1,1,-1,-1,5,-1
KR_6608999231,420,0,20,15,3,-2,3,1,2,0,2,-2,5,3,4,3,7,1,1,2,0,1,2,-3,-2,5,0,0,-1,0,-1,-1,-1,0,-1
KR_6715149078,420,2,98,-28,-2,5,1,6,1,4,5,1,2,3,-7,7,0,-2,2,0,0,-4,-17,-3,0,3,1,0,1,0,1,1,-1,0,-1
KR_6726527464,420,-5,-98,-25,-17,-1,2,1,0,2,2,-2,4,2,-14,15,1,0,0,0,0,-14,21,-2,0,2,-20,-1,-5,0,-1,-1,-1,0,-1
KR_6743039790,420,3,40,-44,0,-4,4,0,-3,5,2,3,1,4,3,1,4,1,2,3,0,3,-10,1,-2,1,0,0,1,-1,-1,-1,-1,2,-1
KR_6616854138,420,-2,-44,-4,-10,-3,3,0,-2,2,0,-1,1,0,-5,6,1,1,0,1,0,-9,-125,1,-4,3,-5,-1,-5,-1,-1,-1,-1,1,-1
KR_6755360748,420,-3,-7,0,-6,-5,6,1,1,1,2,-2,3,1,-1,1,0,1,3,4,0,-4,1,-2,-1,3,1,0,-1,1,0,-1,-1,1,-1
KR_6594320756,420,-3,-29,-20,-1,1,1,2,-2,2,0,-5,6,1,5,0,5,0,2,2,0,2,5,-3,-2,5,-4,0,-1,1,-1,-1,-1,6,-1
KR_6725967592,420,-2,-66,-15,-10,-2,4,2,-1,4,3,-3,4,1,-3,9,6,-1,1,0,0,-6,-21,1,-5,4,-2,0,-2,-1,-1,-1,1,3,-1
KR_6742787852,420,-3,-136,-3,-10,-1,1,0,-1,1,0,-3,4,1,-4,5,1,-1,1,0,0,-5,-7,-1,-4,5,-2,0,-2,-1,-1,-1,-1,6,-1
KR_6650000158,420,-1,-77,19,-2,-2,2,0,5,1,6,-1,3,2,-3,3,0,-1,2,1,0,-9,-2,-2,-1,3,-4,0,0,-1,0,0,1,2,-1
KR_6640319866,440,-1,-28,47,-3,2,3,5,0,3,3,-4,10,6,1,3,4,-2,2,0,-1,-6,-32,-3,-1,4,-1,0,-1,-1,0,-1,-1,6,-1
KR_6495030773,420,-5,-25,-4,-14,-2,5,3,-4,4,0,-3,4,1,-4,7,3,-1,2,1,-2,-13,2,2,-4,2,-4,0,-2,-1,0,-1,-1,2,-1
KR_6726765916,420,0,17,12,-7,-3,3,0,0,4,4,3,1,4,-6,8,2,-1,1,0,0,-11,8,5,-5,0,1,0,-1,1,-1,-1,1,6,-1
KR_6583970632,420,0,-69,20,3,1,1,2,3,2,5,-1,1,0,-1,2,1,1,2,3,0,0,-2,1,-3,2,-1,0,-2,-1,-1,-1,-1,5,-1
KR_5773485340,420,0,19,-24,-7,-6,8,2,-5,5,0,1,2,3,4,1,5,-1,2,1,-1,-6,-3,1,-5,4,0,-1,-3,-1,-1,-1,-1,5,-1
KR_6759550544,420,-4,-37,4,-19,1,0,1,-3,5,2,-2,3,1,-10,12,2,-5,5,0,0,-21,-1,-2,-2,4,-1,0,-1,-1,0,-1,-1,6,-1
KR_6619770245,420,0,6,14,1,2,0,2,0,0,0,4,2,6,-2,2,0,-3,3,0,0,-2,1,1,-5,4,-2,0,1,-1,-1,1,-1,6,-1
KR_6717936406,420,3,60,4,-1,3,2,5,-2,5,3,1,1,2,-2,6,4,-1,1,0,0,-6,-35,1,-4,3,1,0,1,1,1,1,1,2,-1
KR_6729893166,420,-2,-57,-95,0,-1,1,0,2,0,2,-5,6,1,2,3,5,2,0,2,0,7,153,-4,-1,5,-3,0,-2,1,-1,1,1,4,-1
KR_6323761148,420,-1,-32,48,-8,-4,5,1,-1,3,2,1,1,2,-3,4,1,-1,1,0,0,-9,-5,0,-5,5,-1,0,-1,-1,1,-1,-1,5,-1
KR_6760952682,420,-6,-117,-21,-7,0,3,3,0,2,2,-3,5,2,-1,2,1,-3,3,0,0,-3,-16,2,-3,1,-4,0,-1,-1,1,-1,1,4,-1
KR_6762516286,440,-11,-146,-36,-21,-4,4,0,-7,7,0,0,2,2,-6,6,0,-4,5,1,0,-16,-1,-3,-1,4,-3,0,-2,-1,-1,-1,-1,5,-1
KR_6652419329,420,-2,-64,-36,-5,0,2,2,-7,7,0,1,1,2,0,5,5,1,1,2,0,2,291,-4,0,4,1,0,0,1,-1,-1,-1,1,-1
KR_6749897749,420,4,123,-33,4,1,3,4,-5,6,1,4,0,4,2,3,5,2,2,4,-1,5,8,4,-7,3,1,0,1,-1,-1,1,-1,3,-1
KR_6547856196,420,-8,-6,4,-20,-4,4,0,1,3,4,-1,1,0,-11,13,2,-5,6,1,0,-20,-19,-2,0,2,2,0,-1,-1,-1,-1,-1,4,-1
KR_6722303975,440,4,84,46,14,2,4,6,0,2,2,5,1,6,5,1,6,2,2,4,1,-1,10,-3,-2,5,2,0,3,0,0,1,1,0,-1
KR_6711502416,420,-2,20,-26,-11,1,1,2,0,1,1,-1,3,2,0,2,2,-11,11,0,0,-10,-26,1,-4,3,6,0,0,-1,-1,0,-1,4,-1
KR_6695140547,420,3,-17,4,4,2,3,5,-1,5,4,0,2,2,3,0,3,0,1,1,0,5,-7,-3,0,3,0,0,0,-1,0,1,1,5,-1
KR_5896816428,440,-2,-3,4,-6,0,2,2,-4,4,0,1,4,5,-2,3,1,-1,1,0,0,-14,40,-3,-1,4,-21,0,0,-1,-1,0,1,4,-1
KR_6624451195,420,2,-35,0,2,-1,1,0,2,0,2,-4,5,1,2,1,3,3,1,4,1,6,-1,-4,-2,6,-3,0,0,-1,1,0,1,4,-1
KR_6764252985,420,-2,-72,-34,-3,-4,5,1,3,2,5,-3,4,1,0,3,3,1,0,1,0,7,30,7,-10,3,-1,0,1,-1,1,-1,-1,4,-1
KR_6609775983,420,-3,-38,-1,-8,0,3,3,1,1,2,-4,5,1,-2,5,3,-3,3,0,0,-7,-112,0,-3,3,2,0,-1,1,1,-1,-1,2,-1
KR_6673695137,420,3,-15,-48,-3,-7,9,2,0,2,2,7,0,7,-1,1,0,-2,3,1,-1,0,229,-4,-1,5,1,0,-3,-1,-1,-1,-1,4,-1
KR_6623298417,420,-2,8,-36,-12,0,1,1,-4,6,2,-4,5,1,-1,5,4,-3,4,1,1,0,-10,-2,-3,5,-3,0,-1,-1,-1,-1,1,3,-1
KR_6699282467,420,0,-56,13,6,1,2,3,7,1,8,-3,4,1,-2,2,0,3,0,3,0,6,-4,-1,-3,4,1,0,-2,1,-1,-1,-1,1,-1
KR_6750331634,420,-1,-77,-18,-1,0,3,3,0,4,4,0,2,2,0,0,0,-1,1,0,0,5,-21,3,-4,1,2,0,-1,1,-1,-1,-1,1,-1
KR_6395296072,420,-6,-16,-32,-3,0,1,1,0,1,1,0,1,1,-2,3,1,-1,1,0,0,-7,-11,-2,-4,6,-2,0,-2,1,-1,-1,1,3,-1
KR_6611029113,420,0,44,-30,-5,0,2,2,-1,5,4,-6,6,0,-1,3,2,3,0,3,0,-5,38,-6,-2,8,-10,0,1,-1,0,1,1,1,-1
KR_6082314260,420,-6,-111,-19,-3,-5,7,2,1,3,4,1,0,1,0,3,3,0,0,0,0,4,0,-1,-2,3,0,0,-1,1,-1,-1,-1,2,-1
KR_6760839644,420,-1,-59,4,4,6,0,6,-1,2,1,1,1,2,-2,6,4,0,1,1,0,-5,0,-1,-1,2,-1,0,1,1,1,-1,-1,4,-1
KR_6756012173,420,-4,-16,7,-13,1,4,5,-3,5,2,-4,5,1,0,1,1,-7,7,0,0,-17,-4,-1,-1,2,2,0,-2,-1,-1,-1,-1,3,-1
KR_6533537070,420,-3,-128,-54,-6,-2,3,1,0,1,1,-6,6,0,1,2,3,1,4,5,2,-2,-56,5,-7,2,19,0,-3,-1,0,-1,-1,6,-1
KR_6244078130,420,1,-49,9,5,3,0,3,0,2,2,-1,3,2,3,0,3,0,0,0,0,4,2,3,-6,3,-5,0,0,1,-1,0,1,1,-1
KR_6758623792,440,-3,-51,0,-5,-5,5,0,2,0,2,1,2,3,-4,4,0,1,0,1,0,-1,-1,3,-4,1,-1,0,-2,-1,0,-1,1,6,-1
KR_6618511442,420,-2,-52,24,-4,0,2,2,-2,3,1,0,5,5,0,2,2,-2,3,1,0,-6,15,1,-3,2,0,0,0,-1,1,0,-1,1,-1
KR_6739429623,440,0,-25,-4,0,-2,2,0,1,0,1,-1,3,2,0,3,3,2,0,2,0,2,-1,-2,-1,3,1,0,0,0,1,1,1,0,-1
KR_6730078128,420,-6,-24,3,-13,0,1,1,-5,7,2,-3,3,0,-6,6,0,1,0,1,-1,-10,-11,-5,-1,6,3,0,-1,-1,1,-1,-1,6,-1
KR_6699853364,420,0,-5,8,2,5,4,9,-5,6,1,4,0,4,1,7,8,-3,4,1,-1,-9,-9,4,-4,0,-1,0,0,-1,1,-1,-1,6,-1
KR_6395385378,420,1,-16,32,3,1,1,2,3,3,6,2,1,3,-3,4,1,0,1,1,0,10,-8,2,-3,1,-3,0,0,0,1,0,-1,0,-1
KR_6634733347,440,-3,-71,-12,-2,-2,3,1,0,3,3,0,3,3,0,2,2,0,3,3,1,3,-7,0,-2,2,-2,0,-3,-1,-1,-1,1,6,-1
KR_6723438055,420,-4,-52,-9,-13,1,2,3,-6,7,1,-7,7,0,-2,3,1,1,0,1,0,-11,1,-2,-2,4,2,0,0,1,-1,-1,1,1,-1
KR_6653882300,420,-5,-3,-24,-9,0,1,1,-9,9,0,-6,8,2,6,1,7,0,2,2,-2,-8,-2,-2,0,2,1,0,0,-1,0,1,-1,6,-1
KR_6486669157,420,3,115,-19,14,-1,2,1,-1,3,2,4,1,5,7,1,8,5,3,8,0,9,6,2,-5,3,0,0,0,0,-1,1,1,0,-1
KR_6399515589,440,-3,18,-4,-3,1,4,5,-2,5,3,6,1,7,-5,6,1,-3,4,1,0,-13,-11,-2,-4,6,2,0,1,1,1,1,1,6,-1
KR_6718613330,420,0,-19,24,-7,1,1,2,0,1,1,0,2,2,-4,5,1,-4,4,0,0,-5,-6,1,-2,1,2,0,-1,-1,-1,-1,-1,1,-1
KR_6744525406,420,0,56,12,7,-1,1,0,-2,3,1,4,0,4,4,2,6,2,0,2,0,6,0,-1,-3,4,-4,0,0,0,1,0,1,0,-1
KR_6641589901,420,-4,-63,1,-9,2,1,3,1,1,2,-4,4,0,-6,7,1,-2,2,0,0,-5,-6,-4,-1,5,0,0,-1,-1,1,-1,-1,4,-1
KR_6683817875,440,4,122,8,3,2,0,2,-1,4,3,3,0,3,1,0,1,-2,2,0,0,-1,8,-3,-2,5,3,0,1,1,1,1,1,3,-1
KR_6728431567,420,2,9,12,6,-4,4,0,7,0,7,-2,4,2,0,4,4,5,1,6,-1,5,-9,3,-6,3,-2,0,0,1,-1,0,1,3,-1
KR_6668609545,420,-3,-35,-36,-3,-5,6,1,-2,4,2,2,0,2,2,0,2,0,2,2,0,2,-6,3,-8,5,1,0,-1,-1,1,-1,1,4,-1
KR_6745863815,420,-3,16,-64,-5,0,7,7,3,0,3,-3,3,0,-4,4,0,-1,1,0,-1,-1,10,-3,-1,4,-6,0,-1,-1,-1,-1,-1,6,-1
KR_6635652485,420,1,-32,24,1,-2,3,1,2,2,4,-1,6,5,3,4,7,-1,2,1,0,4,48,4,-5,1,-18,0,0,-1,1,0,1,5,-1
KR_6733291749,420,-1,60,-76,-7,-1,2,1,-2,2,0,0,6,6,-5,8,3,1,1,2,-3,-10,3,3,-5,2,0,0,-1,-1,-1,-1,-1,1,-1
KR_6494945139,420,-4,7,-51,2,-1,2,1,1,1,2,3,0,3,8,1,9,-9,9,0,-1,9,9,3,-5,2,1,0,-1,-1,-1,-1,-1,3,-1
KR_6742717103,420,-3,-76,-26,-8,-5,5,0,-4,5,1,0,4,4,-2,5,3,3,0,3,0,-6,7,3,-3,0,-2,0,-1,-1,0,-1,-1,5,-1
KR_6676724124,420,-1,56,-20,-7,2,1,3,-1,4,3,-3,6,3,-4,7,3,-1,3,2,1,-4,36,5,-7,2,-2,0,0,-1,-1,-1,1,1,-1
KR_6759269166,420,-2,-39,-24,-4,0,2,2,2,1,3,0,3,3,-1,2,1,-5,5,0,0,4,-4,2,-2,0,-2,0,-1,-1,0,-1,-1,2,-1
KR_6720291507,440,1,36,12,0,0,3,3,2,2,4,-4,4,0,2,1,3,0,1,1,0,-2,-7,-1,0,1,1,0,-3,-1,-1,-1,1,4,-1
KR_6757083197,420,-2,-43,4,-5,1,0,1,-3,5,2,-2,2,0,0,0,0,-1,2,1,0,-4,-122,-1,-6,7,-7,0,-1,-1,-1,-1,-1,3,-1
KR_6626720041,420,-3,11,-36,-3,2,1,3,-3,4,1,0,2,2,-2,2,0,0,1,1,0,-2,1,1,-2,1,-1,0,0,-1,-1,-1,-1,5,-1
KR_6626897282,420,0,13,-4,2,-1,2,1,0,1,1,1,3,4,2,2,4,0,4,4,0,1,-2,-1,-1,2,1,0,-1,-1,-1,-1,-1,3,-1
KR_6618846565,420,-2,-42,11,-3,-2,2,0,0,1,1,-2,5,3,-1,3,2,2,0,2,2,5,1,0,-3,3,1,0,-1,1,1,-1,1,3,-1
KR_6656754936,420,-3,-44,-4,-2,-3,4,1,-1,3,2,3,3,6,-1,1,0,0,2,2,0,-6,2,3,-6,3,-3,0,0,-1,1,1,1,6,-1
KR_6675546003,420,-2,11,-24,-5,-2,3,1,-3,6,3,-3,3,0,-5,5,0,8,0,8,-1,4,0,0,-1,1,0,0,-1,0,0,-1,-1,0,-1
KR_6361614571,420,-4,-36,16,-11,-6,6,0,-2,4,2,2,1,3,-2,3,1,-3,4,1,0,-13,0,0,0,0,-16,0,-1,0,-1,-1,-1,0,-1
KR_6633300187,420,2,37,0,5,0,2,2,3,1,4,0,3,3,2,2,4,0,2,2,0,-2,278,1,-5,4,4,0,0,0,-1,0,-1,0,-1
KR_6693649665,420,0,-2,-35,2,4,1,5,-8,8,0,4,1,5,-1,4,3,3,1,4,0,-4,-21,-4,-1,5,2,0,-1,-1,1,-1,-1,5,-1
KR_6631316535,420,-6,-140,0,-10,-4,6,2,-3,4,1,0,4,4,-1,4,3,-2,2,0,-1,-5,3,1,-1,0,1,0,-3,-1,0,-1,-1,1,-1
KR_6595610075,420,0,44,-10,3,0,1,1,-2,3,1,4,3,7,-1,1,0,2,1,3,0,0,43,5,-5,0,0,0,2,1,0,1,1,5,-1
KR_6764171067,420,0,17,-16,0,-2,2,0,-5,6,1,2,0,2,0,0,0,5,0,5,0,0,-23,-2,0,2,3,0,2,-1,1,1,1,6,-1
KR_6660453880,420,-2,-8,4,-6,3,1,4,-3,3,0,-3,5,2,-2,3,1,-1,4,3,0,-9,-7,-3,-4,7,1,0,0,1,-1,-1,-1,2,-1
KR_6749784235,420,-3,-83,-9,-7,-1,3,2,3,1,4,2,3,5,-9,10,1,-2,3,1,0,0,-3,-3,-3,6,2,0,-1,-1,1,-1,-1,2,-1
KR_6728723144,420,-1,-45,-16,-2,-2,7,5,0,0,0,2,2,4,-1,2,1,-1,1,0,0,-2,-2,-3,-1,4,3,0,-1,-1,0,-1,-1,6,-1
KR_6755445113,420,-4,20,-16,-9,4,2,6,1,3,4,-7,8,1,-7,9,2,0,0,0,0,-3,-4,2,-2,0,0,0,0,-1,0,-1,1,2,-1
KR_6757589508,420,-2,-29,-48,-13,-7,7,0,-1,1,0,-6,6,0,0,5,5,1,0,1,0,-3,-22,-5,0,5,0,0,0,-1,-1,0,-1,1,-1
KR_6395426590,420,-3,-61,4,-9,-1,1,0,-6,8,2,1,0,1,-4,7,3,1,1,2,0,-14,2,-3,-2,5,-4,0,-1,-1,1,-1,-1,5,-1
KR_6602719700,420,0,-21,-8,-8,5,0,5,-5,11,6,-4,4,0,-3,6,3,-1,2,1,0,-10,10,-1,-2,3,-3,0,1,1,-1,-1,-1,3,-1
KR_6748258214,440,-4,-28,-39,-8,-4,4,0,1,0,1,-2,3,1,-3,8,5,0,1,1,0,-8,-9,5,-6,1,-5,0,0,-1,-1,-1,-1,5,-1
KR_6738362749,420,0,-48,24,-6,-3,3,0,0,2,2,0,2,2,-1,1,0,-2,2,0,0,-5,-169,0,-4,4,-4,0,0,-1,1,0,-1,3,-1
KR_6737337545,420,-2,70,11,-6,0,2,2,-2,4,2,-2,3,1,-1,2,1,-1,1,0,0,-9,27,0,-4,4,-27,0,0,-1,0,0,1,6,-1
KR_6475740629,420,-2,20,8,-7,-2,3,1,0,4,4,1,3,4,-3,4,1,-3,3,0,0,-8,-119,3,-10,7,1,0,0,-1,-1,-1,-1,5,-1
KR_6641888358,420,-4,-1,-24,-5,-1,3,2,-5,5,0,-2,4,2,3,2,5,0,3,3,0,-2,-9,1,-5,4,2,0,1,1,1,1,-1,3,-1
KR_6730050645,420,-6,-25,-25,-14,-5,5,0,-6,6,0,-5,5,0,1,2,3,1,0,1,-1,-10,0,-1,-3,4,-2,0,-4,-1,0,-1,-1,6,-1
KR_6763982439,420,-2,-40,-10,-4,1,0,1,3,0,3,-2,3,1,-3,4,1,-3,3,0,0,1,152,2,-5,3,-1,0,0,0,1,1,1,0,-1
KR_6726603065,420,-4,-114,-10,-3,-1,4,3,0,3,3,0,1,1,0,3,3,-2,2,0,0,0,-8,-2,-3,5,3,0,-3,1,-1,-1,-1,3,-1
KR_6675743015,420,-2,-2,-40,-5,-2,3,1,1,2,3,-6,7,1,1,1,2,1,0,1,0,3,8,0,-2,2,0,0,0,-1,-1,0,-1,6,-1
KR_6745930420,440,-5,-57,-29,-5,-1,1,0,0,3,3,-3,4,1,-1,1,0,0,0,0,0,-6,190,-5,-3,8,4,0,-1,1,1,-1,1,4,-1
KR_6673673679,440,-2,-101,4,-1,-8,8,0,0,3,3,3,0,3,5,2,7,-1,2,1,0,0,-33,0,0,0,19,0,-1,0,0,-1,1,0,-1
KR_6610022532,420,0,22,44,2,0,3,3,-3,4,1,3,0,3,2,5,7,0,0,0,0,-7,8,0,-1,1,0,0,0,0,1,1,-1,0,-1
KR_6654793619,420,-4,-28,-48,-7,-4,5,1,-1,4,3,-1,1,0,0,2,2,-1,1,0,1,-3,-3,0,-3,3,0,0,0,0,0,0,1,0,-1
KR_6669075184,420,-10,-42,-108,-20,-8,8,0,-1,1,0,-5,6,1,-4,4,0,-2,3,1,0,-21,-9,-1,-1,2,5,0,-1,-1,-1,-1,-1,1,-1
KR_6668288307,420,1,47,8,17,-2,4,2,0,2,2,6,2,8,9,0,9,4,0,4,-1,14,0,1,-3,2,-6,0,-1,0,-1,1,-1,0,-1
KR_6762914778,420,-2,93,-92,-3,-1,2,1,-4,5,1,-1,2,1,3,1,4,0,0,0,0,-2,-3,-2,-1,3,0,0,0,1,-1,0,-1,4,-1
KR_6741507421,420,-2,-41,-16,-7,-3,3,0,-1,4,3,-5,7,2,2,0,2,0,0,0,0,1,2,-2,-1,3,-1,0,0,-1,-1,-1,-1,4,-1
KR_6631915576,420,-1,-26,12,-9,3,0,3,-7,9,2,-3,4,1,-1,1,0,-1,2,1,0,-8,56,0,-1,1,-14,0,0,0,-1,0,-1,0,-1
KR_6737330165,440,-4,-80,4,-4,1,2,3,-1,1,0,-4,8,4,2,0,2,-2,2,0,0,-8,10,0,-3,3,-22,0,0,-1,1,1,-1,2,-1
KR_6550387103,420,-1,-24,12,-3,-2,3,1,-1,2,1,5,0,5,-4,6,2,-1,1,0,-1,-3,42,0,-2,2,-25,0,0,-1,-1,-1,-1,3,-1
KR_6605271140,420,-4,-147,1,-6,-2,2,0,1,4,5,-5,7,2,0,5,5,0,0,0,0,3,3,2,-4,2,-1,0,-2,-1,0,-1,-1,3,-1
KR_6701252336,420,-2,-93,24,-9,-3,5,2,1,1,2,-3,3,0,-4,4,0,0,0,0,0,-5,-5,2,-3,1,-4,0,-2,-1,0,-1,-1,6,-1
KR_6753384556,420,-6,-124,-36,-13,-6,6,0,3,0,3,-5,5,0,-4,7,3,-1,1,0,-1,-1,4,4,-4,0,-1,0,-1,-1,1,-1,-1,1,-1
KR_6649259333,420,0,22,-8,-1,2,0,2,5,0,5,0,2,2,-4,4,0,-4,6,2,0,-6,-1,0,-4,4,-7,0,-1,-1,-1,-1,-1,6,-1
KR_6595975614,420,-3,-64,4,-6,-2,2,0,0,0,0,-6,7,1,2,3,5,0,1,1,0,-4,1,2,-6,4,-3,0,-2,1,1,-1,-1,6,-1
KR_6756617995,440,0,31,-14,-4,-1,1,0,1,0,1,-3,6,3,-1,3,2,0,1,1,0,-1,-187,-5,-1,6,0,0,-1,-1,-1,-1,-1,6,-1
KR_6754741972,440,1,84,-8,7,-1,2,1,-3,3,0,-1,3,2,11,3,14,1,0,1,0,11,5,0,-2,2,4,0,0,1,-1,1,1,5,-1
KR_6654808374,420,-2,-27,2,-4,-6,7,1,1,1,2,-2,2,0,2,2,4,1,2,3,0,2,1,2,-3,1,1,0,-1,0,-1,-1,-1,0,-1
KR_6530330857,420,-1,-23,-24,-8,1,1,2,-7,9,2,0,2,2,-3,5,2,1,2,3,0,-7,0,1,-4,3,4,0,1,-1,-1,1,1,5,-1
KR_6636471194,420,-2,-8,-4,-1,2,1,3,4,1,5,0,3,3,-5,6,1,-2,2,0,0,-7,-198,-1,-2,3,-1,0,1,-1,1,-1,-1,4,-1
KR_5762484203,420,0,-64,-1,-1,1,0,1,0,2,2,-1,1,0,1,0,1,-2,3,1,0,-1,-20,1,-7,6,-3,0,0,1,-1,-1,1,5,-1
KR_6474981896,420,-1,-16,-28,-3,0,0,0,-3,5,2,2,3,5,-1,3,2,-1,1,0,-1,-7,2,-6,-1,7,3,0,-1,-1,1,-1,-1,6,-1
KR_6764645820,420,-5,-71,13,-15,-1,1,0,-2,3,1,-3,5,2,-7,8,1,-2,2,0,-2,-17,-4,0,-3,3,-2,0,-1,-1,1,-1,-1,5,-1
KR_6762774056,420,1,46,3,-5,0,1,1,2,0,2,3,6,9,-7,8,1,-3,4,1,2,-6,-6,0,-2,2,-1,0,1,1,1,1,1,3,-1
KR_6725642243,420,-3,3,-20,-8,-1,1,0,1,2,3,0,5,5,-5,6,1,-3,5,2,0,-12,35,0,-1,1,-22,0,-1,0,-1,-1,1,0,-1
KR_6756913811,420,2,23,12,0,5,0,5,-1,2,1,-3,3,0,-1,2,1,0,0,0,1,-5,-7,-5,0,5,-3,0,1,-1,1,1,1,1,-1
KR_6757114061,420,1,24,19,0,-1,2,1,-1,2,1,1,1,2,-1,1,0,2,0,2,0,0,5,-1,-4,5,2,0,-1,-1,0,-1,1,5,-1
KR_6724935692,420,-4,-52,-24,-15,-3,3,0,-7,7,0,-1,2,1,-4,5,1,0,0,0,0,-11,3,-1,-2,3,-2,0,0,-1,-1,0,-1,2,-1
KR_6733559639,420,-1,-41,8,1,-6,7,1,3,2,5,-3,4,1,4,0,4,3,0,3,0,3,13,2,-7,5,3,0,1,1,1,1,1,3,-1
KR_6647518775,440,0,-51,-8,0,-2,2,0,4,1,5,0,0,0,-2,4,2,0,0,0,-1,3,13,-1,-2,3,-6,0,-1,-1,0,-1,-1,5,-1
KR_6741075186,440,-2,-95,-44,-1,1,3,4,-5,6,1,5,1,6,-1,4,3,-1,1,0,-1,-13,-13,-3,0,3,0,0,-1,0,0,-1,-1,0,-1
KR_6603720959,420,-3,-45,-12,-10,1,1,2,-5,6,1,-2,4,2,0,2,2,-4,5,1,-1,-20,-8,-6,-3,9,3,0,-2,-1,-1,-1,-1,3,-1
KR_6361636121,420,-10,-61,-35,-24,-7,9,2,-3,4,1,-7,7,0,-6,6,0,-1,1,0,-1,-30,0,0,0,0,-1,0,-2,-1,0,-1,-1,1,-1
KR_6680376759,420,-3,-112,-2,-4,-1,1,0,-4,4,0,-1,1,0,1,0,1,1,0,1,0,0,-2,-4,-2,6,0,0,0,0,1,-1,-1,0,-1
KR_6716275527,420,-4,-10,0,-9,1,1,2,-9,12,3,6,2,8,-6,6,0,-1,3,2,0,-7,23,2,-4,2,-25,0,-1,0,0,-1,-1,0,-1
KR_6746279285,420,-1,-4,-16,-1,2,0,2,1,0,1,-3,3,0,0,1,1,-1,3,2,0,-3,97,-3,-3,6,4,0,1,1,1,1,-1,2,-1
KR_6624142107,420,-6,-123,-16,-11,-3,3,0,-4,5,1,-4,4,0,1,2,3,-1,2,1,0,-13,-3,-3,-1,4,1,0,-3,-1,-1,-1,-1,6,-1
KR_6663090002,420,-2,-42,-18,3,1,0,1,0,1,1,1,1,2,1,1,2,0,1,1,0,4,4,1,-4,3,-1,0,-1,1,-1,-1,1,3,-1
KR_6597031727,420,-1,4,25,-2,2,2,4,-7,9,2,1,1,2,-2,3,1,4,0,4,0,-3,12,0,-5,5,0,0,0,1,1,1,1,6,-1
KR_6721315503,420,0,22,-7,4,-1,3,2,1,2,3,6,0,6,-1,3,2,-1,1,0,0,-3,4,3,-5,2,1,0,0,0,0,0,-1,0,-1
KR_6637572548,420,1,-19,4,0,2,1,3,-1,2,1,0,3,3,1,2,3,-2,5,3,1,-5,15,-3,-4,7,0,0,0,0,0,0,1,0,-1
KR_6672252886,420,-1,18,8,-7,2,0,2,-5,6,1,-6,7,1,3,1,4,-1,1,0,0,-9,20,0,-6,6,1,0,0,-1,-1,0,1,3,-1
KR_6689634202,440,-2,-86,4,1,-5,5,0,3,1,4,4,1,5,-1,2,1,0,1,1,0,1,-5,2,-4,2,-2,0,-1,-1,1,-1,-1,3,-1
KR_6744978546,420,-1,35,-13,1,1,2,3,-2,4,2,3,1,4,0,0,0,-1,5,4,0,-2,297,0,-2,2,-2,0,1,1,-1,1,1,6,-1
KR_6651586015,420,-3,-138,-24,-4,-6,6,0,-2,3,1,-2,2,0,4,0,4,2,0,2,-1,10,-6,-2,-4,6,-2,0,-2,1,-1,-1,-1,2,-1
KR_6625321973,420,0,-8,-18,5,0,2,2,-1,3,2,2,0,2,4,1,5,0,2,2,0,3,-2,3,-4,1,1,0,1,-1,-1,-1,1,3,-1
KR_6587386019,420,2,-47,24,2,-3,5,2,10,1,11,1,4,5,-5,5,0,-1,1,0,-1,6,-3,1,-3,2,1,0,-1,1,0,-1,-1,1,-1
KR_6714883149,440,-2,-28,4,-3,-1,3,2,0,3,3,1,2,3,0,4,4,-3,4,1,0,-2,13,-4,-2,6,-6,0,0,0,1,0,1,0,-1
KR_6726667618,420,-5,-94,-4,-8,-1,2,1,-2,5,3,1,3,4,-5,5,0,-1,3,2,0,-14,226,4,-7,3,0,0,-1,-1,-1,-1,-1,3,-1
KR_6758141811,420,-1,-46,-16,-8,-8,8,0,4,4,8,0,0,0,-3,5,2,-1,1,0,-2,1,-140,1,-5,4,3,0,-2,-1,-1,-1,-1,2,-1
KR_6763540857,440,0,-28,-18,0,0,3,3,-1,3,2,3,2,5,0,3,3,-2,3,1,1,0,190,1,-4,3,0,0,-3,1,-1,-1,1,6,-1
KR_6647410001,420,-4,-72,-2,-3,-1,2,1,3,0,3,-1,5,4,-3,3,0,-1,2,1,0,-5,0,3,-4,1,-4,0,0,-1,1,0,-1,6,-1
KR_6695693130,420,-3,-55,-17,-2,-3,3,0,-4,5,1,0,2,2,5,0,5,0,2,2,0,0,14,3,-4,1,-2,0,0,-1,0,0,1,4,-1
KR_6762744180,420,-2,6,-4,-6,1,1,2,-1,4,3,2,0,2,-7,8,1,-1,3,2,0,-8,-5,-1,0,1,-1,0,-1,1,-1,-1,-1,3,-1
KR_6764518050,440,-5,-32,-28,-18,-2,3,1,-7,9,2,-1,4,3,-7,8,1,-1,1,0,0,-14,-7,-3,-1,4,0,0,-1,-1,0,-1,-1,2,-1
KR_6751619066,420,-2,5,-11,-7,-4,5,1,-1,2,1,2,2,4,-3,4,1,-1,1,0,1,-2,-3,1,-3,2,-1,0,-1,-1,-1,-1,1,5,-1
KR_6737008750,420,1,72,-15,0,4,0,4,-1,1,0,-1,3,2,-2,2,0,0,1,1,-2,-7,5,1,-5,4,0,0,0,1,-1,0,-1,2,-1
KR_6761272716,420,-3,27,-13,-14,-3,3,0,-3,4,1,-6,10,4,-5,7,2,3,2,5,0,-6,28,-3,0,3,-23,0,0,-1,0,-1,-1,5,-1
KR_6759133162,420,-2,-6,-38,-6,0,4,4,-7,7,0,0,1,1,1,2,3,0,0,0,-1,-6,2,-2,-1,3,0,0,1,1,1,1,-1,4,-1
KR_6761397694,440,-2,5,-24,-1,3,0,3,1,4,5,-4,6,2,0,4,4,-1,2,1,0,-1,-14,2,-2,0,0,0,-1,1,-1,-1,-1,6,-1
KR_6713132989,420,1,-40,1,-2,4,0,4,-1,2,1,-4,4,0,1,2,3,-2,2,0,-1,-8,-203,4,-5,1,-2,0,0,0,1,0,-1,0,-1
KR_6361601651,420,-1,-66,36,-5,-1,3,2,-1,2,1,-1,1,0,-2,4,2,0,2,2,0,-1,0,0,0,0,-5,0,0,-1,-1,-1,-1,4,-1
KR_6745988863,420,-2,-73,12,-4,0,0,0,1,3,4,-5,5,0,0,1,1,0,0,0,0,5,335,-3,-3,6,-4,0,0,-1,-1,0,-1,4,-1
KR_6751527226,420,-7,-72,-16,-23,-5,6,1,-3,3,0,0,1,1,-12,14,2,-3,3,0,-1,-26,-1,-1,-2,3,-1,0,-2,0,-1,-1,-1,0,-1
KR_6694169397,420,-6,-60,-12,-16,-1,1,0,-4,4,0,-4,4,0,-7,7,0,0,0,0,-1,-12,18,3,-5,2,-6,0,-2,-1,-1,-1,-1,3,-1
KR_6677437562,440,-2,-101,-16,-3,2,2,4,-5,7,2,0,1,1,-1,4,3,1,1,2,0,-3,-6,-2,-2,4,1,0,-4,1,-1,-1,1,2,-1
KR_6759949637,440,-4,0,-40,-7,0,3,3,-2,6,4,-1,3,2,1,0,1,-5,6,1,-3,-16,-468,1,-3,2,-2,0,-1,-1,0,-1,-1,3,-1
KR_6605412388,420,-5,-73,-28,-5,-1,1,0,-1,2,1,-3,4,1,0,0,0,0,0,0,0,-3,-253,0,0,0,20,0,0,-1,1,-1,1,2,-1
KR_6763460557,420,-1,37,24,3,4,2,6,6,0,6,-7,7,0,0,1,1,0,1,1,0,5,-5,2,-4,2,0,0,1,-1,-1,1,1,1,-1
KR_6754730787,420,-3,-129,4,-13,-2,2,0,0,3,3,-10,10,0,-5,7,2,4,0,4,-1,-8,-3,-3,-2,5,-3,0,-2,-1,0,-1,-1,5,-1
KR_6695621446,420,-2,60,-11,-2,-5,8,3,-2,4,2,-1,1,0,3,4,7,3,2,5,0,-2,-14,0,-2,2,-3,0,0,-1,-1,-1,-1,3,-1
KR_6722422875,440,3,66,13,9,6,1,7,3,0,3,4,1,5,-2,5,3,-2,2,0,0,2,13,1,-2,1,0,0,1,1,1,1,-1,5,-1
KR_6736771495,440,-2,1,-16,2,3,1,4,2,2,4,1,2,3,-4,7,3,0,4,4,-3,-8,-17,-7,-2,9,0,0,0,1,-1,-1,-1,1,-1
KR_6644657559,420,3,33,35,3,1,0,1,-2,3,1,3,0,3,2,0,2,-1,1,0,0,-1,-8,0,-4,4,2,0,0,1,-1,0,-1,5,-1
KR_6732268984,440,-4,-85,-16,-5,-1,3,2,0,3,3,3,0,3,-5,7,2,-2,2,0,0,-1,3,-2,-2,4,-6,0,-1,0,-1,-1,1,0,-1
KR_6747381858,420,-7,-47,-32,-23,-1,1,0,-6,6,0,-1,3,2,-7,7,0,-8,8,0,0,-26,-1,1,-2,1,-1,0,-1,-1,1,-1,-1,2,-1
KR_6656231702,420,-4,-8,-12,-4,-4,4,0,3,0,3,-4,4,0,2,4,6,-1,1,0,-1,0,6,-1,-1,2,1,0,-1,-1,-1,-1,-1,4,-1
KR_6620660403,420,1,-77,4,6,-2,2,0,2,0,2,4,1,5,0,3,3,2,1,3,0,5,0,1,-2,1,-1,0,0,0,0,0,-1,0,-1
KR_6722114939,440,-1,-65,-16,-5,0,4,4,1,1,2,-2,4,2,-3,4,1,-1,2,1,0,-4,359,-1,-2,3,11,0,0,-1,1,-1,-1,2,-1
KR_6763156516,440,-3,-63,-32,2,-6,7,1,1,4,5,2,0,2,3,1,4,2,0,2,0,15,2,3,-4,1,-1,0,-1,-1,-1,-1,-1,5,-1
KR_6600583446,420,0,-68,-16,4,2,0,2,0,6,6,-1,3,2,3,0,3,0,0,0,0,9,2,-2,-3,5,2,0,-1,0,0,-1,1,0,-1
KR_6751082049,440,-1,-34,-24,-8,-4,4,0,-6,7,1,0,3,3,-1,3,2,3,1,4,-1,-4,1,-2,-5,7,1,0,-1,-1,-1,-1,-1,2,-1
KR_6730575153,420,-1,8,-4,-3,-2,3,1,-1,3,2,1,2,3,-2,4,2,1,0,1,-1,-1,4,4,-5,1,-4,0,0,-1,-1,0,-1,4,-1
KR_6474956226,420,-6,-64,-31,-12,-2,3,1,0,2,2,-1,5,4,-5,5,0,-4,5,1,0,-8,-4,0,-3,3,1,0,-1,-1,-1,-1,-1,3,-1
KR_6633226001,420,-2,-22,8,-5,-3,5,2,0,3,3,-2,2,0,-5,6,1,5,0,5,0,-4,-11,-2,-5,7,-1,0,-1,-1,0,-1,-1,6,-1
KR_6745938332,420,2,127,-24,5,4,0,4,0,2,2,-3,4,1,2,0,2,2,0,2,0,1,-2,1,-3,2,-1,0,0,0,1,0,1,0,-1
KR_6561611338,420,3,125,-46,6,3,2,5,-1,4,3,4,1,5,-1,2,1,1,0,1,1,15,-8,-1,0,1,1,0,4,0,1,1,1,0,-1
KR_6630490819,420,-1,-19,13,2,-2,3,1,1,2,3,1,3,4,3,1,4,-1,2,1,0,3,1,1,-4,3,-1,0,0,1,1,0,-1,1,-1
KR_6696809024,420,2,-2,16,9,-1,2,1,-4,4,0,5,0,5,9,1,10,0,1,1,0,7,11,1,-2,1,0,0,1,1,-1,1,1,4,-1
KR_6638607765,440,-1,-63,-24,6,-4,5,1,2,1,3,1,1,2,6,0,6,1,0,1,0,9,-1,-1,-1,2,2,0,-2,-1,0,-1,1,1,-1
KR_6634902889,440,-3,-34,12,-6,0,2,2,1,3,4,-2,2,0,-5,5,0,0,1,1,0,-9,-11,-5,-1,6,-2,0,-1,-1,-1,-1,-1,2,-1
KR_6728145405,440,-2,-66,-12,-5,-4,5,1,1,2,3,-1,2,1,-5,6,1,4,1,5,1,-11,-20,2,-2,0,-2,0,-1,-1,1,-1,1,5,-1
KR_6675372922,420,5,-20,31,6,3,1,4,5,1,6,-2,3,1,-2,4,2,2,0,2,0,6,-6,-3,-3,6,0,0,0,1,1,0,1,6,-1
KR_6751671263,420,0,29,1,4,3,1,4,2,0,2,0,5,5,2,1,3,-3,3,0,0,10,-14,-1,0,1,-1,0,1,0,1,1,1,0,-1
KR_6727138041,420,0,-55,18,-4,2,0,2,0,2,2,-1,4,3,-6,10,4,1,0,1,-1,-8,-2,-1,-3,4,-1,0,-1,0,0,-1,-1,0,-1
KR_6632333478,420,-1,-15,-20,1,-2,3,1,4,3,7,-3,4,1,3,3,6,-1,2,1,1,6,-16,4,-6,2,0,0,0,-1,1,0,1,6,-1
KR_6662542652,420,-3,-7,-15,-4,0,2,2,-3,4,1,3,3,6,-5,8,3,1,1,2,0,-8,-21,-9,-4,13,-4,0,-1,-1,1,-1,1,4,-1
KR_6601745710,420,-2,-36,20,8,4,2,6,9,0,9,0,1,1,-5,5,0,0,0,0,1,-1,-11,-3,-2,5,3,0,0,1,1,-1,1,2,-1
KR_6762619953,420,-1,-19,-20,3,0,1,1,1,4,5,-2,2,0,3,1,4,1,1,2,0,4,-3,4,-7,3,7,0,0,1,0,0,1,4,-1
KR_6505405881,420,-1,-46,-27,-8,-1,1,0,-1,4,3,2,2,4,-11,11,0,3,0,3,0,-16,-31,-3,-1,4,25,0,-3,-1,-1,-1,-1,5,-1
KR_6759240635,420,-4,-41,-32,-13,-4,4,0,-3,3,0,-2,6,4,2,1,3,-6,6,0,0,-12,-24,-2,-3,5,-4,0,1,-1,1,-1,-1,6,-1
KR_6737819561,420,-3,-133,28,-11,-3,4,1,0,4,4,-3,4,1,-1,2,1,-4,4,0,-1,-12,-2,0,-1,1,-1,0,-1,0,1,-1,-1,0,-1
KR_6763087937,420,-3,-9,-4,-9,-1,2,1,0,2,2,-7,8,1,0,3,3,-1,2,1,0,-11,-3,-2,-1,3,0,0,0,-1,1,0,1,5,-1
KR_6724512707,420,0,22,-3,2,0,1,1,3,1,4,-3,4,1,0,4,4,2,0,2,0,5,2,1,-1,0,1,0,1,1,0,1,-1,2,-1
KR_6592338088,420,4,22,12,-1,2,2,4,-1,3,2,-3,4,1,3,1,4,-2,3,1,-1,2,55,3,-6,3,-2,0,2,1,1,1,-1,4,-1
KR_6726247332,420,0,45,-8,-3,1,1,2,-7,7,0,1,2,3,1,0,1,1,0,1,0,-1,-10,-3,-1,4,0,0,1,-1,0,1,-1,3,-1
KR_6726885068,420,-3,-73,-34,-3,1,0,1,2,1,3,-2,4,2,-2,3,1,-2,3,1,0,-4,4,-1,-2,3,0,0,-2,1,1,-1,-1,2,-1
KR_6764444845,440,1,-34,16,-2,-2,2,0,-4,4,0,1,1,2,2,0,2,1,1,2,1,-1,-36,0,-6,6,13,0,0,1,-1,0,1,3,-1
KR_6515053861,420,-2,48,7,-3,4,0,4,-4,4,0,-3,4,1,-1,2,1,1,0,1,0,-8,0,0,-2,2,-1,0,-1,0,-1,-1,-1,0,-1
KR_6708662324,420,-3,-66,-9,-8,-2,2,0,-2,4,2,0,2,2,-2,3,1,-2,2,0,-1,-8,0,2,-3,1,2,0,-1,-1,1,-1,-1,4,-1
KR_6695455815,420,1,9,-18,7,5,1,6,2,3,5,1,0,1,-1,2,1,0,0,0,0,12,375,-2,-2,4,0,0,1,1,-1,1,1,1,-1
KR_6763159961,420,-2,-1,-32,-12,-7,9,2,-3,4,1,3,0,3,-5,8,3,0,1,1,-2,-16,53,0,-2,2,-4,0,-2,0,0,-1,-1,0,-1
KR_6077195320,420,0,38,12,1,3,3,6,-3,3,0,1,1,2,0,2,2,0,2,2,0,7,-165,-3,-3,6,-1,0,0,0,1,-1,-1,0,-1
KR_6615412139,420,1,-68,25,5,-3,3,0,4,2,6,-2,5,3,3,1,4,3,0,3,1,11,-4,-3,-1,4,6,0,0,1,1,0,1,3,-1
KR_6692892443,440,-7,-94,-17,-14,-4,4,0,-2,3,1,-8,9,1,0,2,2,0,1,1,0,-4,-4,-1,0,1,0,0,-1,0,-1,-1,-1,0,-1
KR_6761727099,420,3,-18,-12,9,1,0,1,3,1,4,3,0,3,4,5,9,-2,3,1,0,15,2,1,-3,2,3,0,0,1,0,-1,-1,1,-1
KR_6047090124,420,-3,8,12,-4,0,2,2,-7,11,4,0,1,1,1,0,1,2,1,3,0,-8,-7,-4,-2,6,3,0,0,1,-1,0,-1,4,-1
KR_6645570378,420,2,-20,14,1,-2,4,2,1,2,3,-2,2,0,3,1,4,1,0,1,0,5,15,-2,-2,4,3,0,1,-1,-1,1,-1,4,-1
KR_6721737656,420,1,36,-36,1,-5,5,0,-5,5,0,3,0,3,9,0,9,-1,1,0,1,4,-2,-3,-2,5,-1,0,0,1,-1,-1,1,2,-1
KR_6715323944,420,-3,-25,-28,-2,-2,2,0,0,3,3,0,2,2,1,2,3,-1,3,2,0,1,-4,3,-3,0,1,0,-3,-1,-1,-1,1,5,-1
KR_6601975294,420,-2,-30,5,-1,-2,2,0,1,1,2,3,3,6,-1,2,1,-2,2,0,0,3,2,0,-3,3,-2,0,-1,-1,-1,-1,-1,2,-1
KR_6720638007,420,-9,-105,-52,-17,0,1,1,1,3,4,-6,7,1,-10,10,0,-2,2,0,0,-11,-2,-2,-1,3,-1,0,-1,-1,0,-1,-1,6,-1
KR_6665903701,420,2,-45,9,2,-1,1,0,1,1,2,-3,5,2,1,2,3,4,2,6,0,3,12,-2,-2,4,0,0,0,1,1,0,-1,4,-1
KR_6078968416,420,-2,-46,-4,-7,3,2,5,-4,5,1,-1,2,1,-4,7,3,-1,1,0,0,-9,-21,-2,-4,6,2,0,-1,-1,-1,-1,-1,3,-1
KR_6760198670,420,-2,-20,-23,-6,-2,2,0,-7,7,0,0,4,4,2,1,3,1,1,2,0,-3,-210,5,-5,0,-2,0,-1,1,1,-1,1,6,-1
KR_6760978403,420,-3,7,-5,-3,1,0,1,0,4,4,1,2,3,-2,2,0,-3,4,1,1,-6,194,5,-7,2,30,0,0,0,0,0,1,0,-1
KR_6715030496,420,-2,-55,0,-6,1,1,2,0,4,4,-1,2,1,-4,5,1,-2,2,0,0,-7,5,-3,-2,5,-4,0,0,0,-1,-1,1,0,-1
KR_6751362231,420,-3,-52,-25,-8,-1,4,3,-7,9,2,3,2,5,0,2,2,-3,3,0,0,-6,-15,-3,0,3,2,0,-1,-1,1,-1,1,4,-1
KR_6623990579,420,-1,-3,-44,3,-6,7,1,3,0,3,4,2,6,0,0,0,2,0,2,0,4,1,1,-4,3,-1,0,0,-1,1,0,-1,4,-1
KR_6724563013,420,-2,24,-8,-2,-4,4,0,-3,5,2,2,3,5,3,3,6,0,3,3,0,-2,4,0,-2,2,2,0,0,-1,0,1,-1,5,-1
KR_6659965721,440,4,33,17,8,1,1,2,4,5,9,1,1,2,0,2,2,2,0,2,0,9,-1,5,-5,0,-3,0,2,-1,1,1,-1,6,-1
KR_6648530940,420,-1,-12,8,-4,2,0,2,-1,2,1,-3,4,1,0,0,0,-2,2,0,0,-7,7,1,-5,4,3,0,-1,-1,-1,-1,1,2,-1
KR_6717506913,420,-4,-61,-32,0,1,0,1,-3,5,2,-1,3,2,6,1,7,-3,3,0,0,-1,-5,2,-3,1,-1,0,0,-1,0,0,-1,6,-1
KR_6738047767,440,-5,-123,-16,-8,-2,2,0,0,3,3,-8,8,0,3,1,4,-1,1,0,0,-9,-9,-3,-1,4,2,0,-1,0,-1,-1,-1,0,-1
KR_6696593960,420,-5,-3,-44,-4,2,1,3,-1,1,0,-2,3,1,-4,4,0,1,1,2,0,-9,1,-6,0,6,1,0,-1,-1,-1,-1,-1,1,-1
KR_6532212174,420,-1,-20,8,-3,-2,3,1,-2,4,2,-6,6,0,5,1,6,2,1,3,0,2,8,1,-4,3,2,0,-1,1,-1,-1,-1,2,-1
KR_6721046421,420,-2,-30,8,-1,3,1,4,-1,4,3,-2,2,0,0,0,0,-1,1,0,-1,-6,1,0,-2,2,-1,0,0,1,1,1,-1,3,-1
KR_6734832296,420,0,-54,-16,-2,-1,2,1,-1,3,2,1,2,3,-1,2,1,0,1,1,-1,5,103,2,-4,2,1,0,0,-1,1,-1,-1,2,-1
KR_6736481629,420,1,46,8,-1,-7,8,1,5,1,6,6,0,6,-2,3,1,-3,3,0,-1,-1,-13,2,-4,2,-3,0,-1,1,-1,-1,-1,1,-1
KR_6646145587,420,-3,36,-32,-1,-1,3,2,-3,4,1,4,0,4,-2,6,4,1,2,3,0,-1,5,-1,0,1,0,0,0,1,-1,-1,1,5,-1
KR_6743008237,440,2,54,-4,-6,0,1,1,-1,1,0,-3,6,3,-2,2,0,0,0,0,0,-6,272,-2,-2,4,0,0,1,-1,-1,1,-1,1,-1
KR_6743503129,420,-3,-63,-33,-10,2,0,2,-4,6,2,-5,7,2,-3,5,2,0,1,1,0,-3,18,-3,-1,4,0,0,0,-1,0,0,-1,1,-1
KR_6756749486,420,-4,-20,0,-9,-2,2,0,-6,6,0,1,3,4,-3,7,4,1,1,2,0,-12,1,-2,-2,4,0,0,0,-1,0,0,-1,6,-1
KR_6618551534,420,-2,-36,18,-4,-3,4,1,-1,1,0,0,3,3,1,2,3,-1,1,0,0,2,-1,1,-3,2,4,0,-1,-1,0,-1,-1,3,-1
KR_6755177910,420,-2,-30,0,-5,-3,4,1,1,2,3,0,3,3,-2,5,3,-1,1,0,0,-1,-21,3,-5,2,0,0,-1,1,1,-1,1,3,-1
KR_6733310685,420,5,9,-8,6,1,4,5,1,4,5,2,3,5,-2,5,3,4,0,4,0,11,-1,0,-1,1,1,0,1,-1,0,1,1,1,-1
KR_6721420522,420,-4,-4,-27,-8,-3,5,2,-4,7,3,-2,2,0,0,1,1,1,0,1,0,-6,-2,0,-5,5,-2,0,-2,0,1,-1,-1,0,-1
KR_6760101345,420,-6,-9,-32,-7,-2,3,1,0,3,3,-1,3,2,-2,3,1,-2,4,2,0,-2,-3,-4,-2,6,-1,0,0,-1,-1,0,1,4,-1
KR_6757052486,420,-6,-146,-43,-18,-1,3,2,-7,7,0,-10,10,0,0,2,2,0,1,1,0,-14,-28,-4,-1,5,2,0,-3,-1,1,-1,-1,5,-1
KR_6758968093,420,-2,-70,-11,-5,-1,4,3,1,3,4,-3,4,1,-4,6,2,2,1,3,-1,-2,-13,-1,-2,3,-3,0,0,-1,1,-1,-1,2,-1
KR_6715520013,440,2,24,-4,5,3,1,4,-5,10,5,5,0,5,0,5,5,2,0,2,0,0,8,-5,-1,6,3,0,0,-1,-1,-1,1,3,-1
KR_6651451724,420,-1,-37,-35,2,-3,4,1,-1,3,2,3,1,4,4,1,5,-1,1,0,0,7,1,2,-4,2,-1,0,0,0,-1,0,-1,0,-1
KR_6722363480,420,1,-10,-8,7,3,1,4,0,4,4,2,2,4,2,2,4,0,0,0,0,5,-3,1,-6,5,-2,0,1,1,1,1,-1,6,-1
KR_6672871283,420,-1,-45,25,-3,0,4,4,-2,2,0,3,1,4,-1,1,0,-3,3,0,-2,-5,-1,0,-4,4,-1,0,-1,1,0,-1,-1,2,-1
KR_6638555099,420,1,-47,-6,4,8,1,9,-1,2,1,-4,4,0,0,4,4,1,0,1,0,-2,11,1,-5,4,1,0,1,1,-1,1,-1,1,-1
KR_6622748755,420,0,55,-20,-3,-1,2,1,-2,3,1,-2,3,1,2,0,2,0,2,2,0,-9,-11,-1,-2,3,-5,0,-1,-1,-1,-1,1,3,-1
KR_6566277281,420,-3,-17,1,-4,-2,2,0,0,2,2,-3,3,0,1,2,3,0,1,1,0,-5,-11,3,-6,3,-1,0,-1,-1,-1,-1,-1,3,-1
KR_6742831021,420,-4,0,-29,-4,1,2,3,-3,5,2,-1,3,2,0,3,3,-1,1,0,0,2,3,0,-1,1,0,0,1,-1,-1,1,1,1,-1
KR_6601904566,420,0,21,12,-4,0,1,1,0,2,2,0,1,1,-4,4,0,0,1,1,0,-8,-238,-1,-2,3,2,0,1,-1,1,1,-1,4,-1
KR_6734328400,420,4,-10,2,10,3,1,4,-2,2,0,0,2,2,9,0,9,0,0,0,0,9,28,0,-6,6,-4,0,1,-1,-1,1,1,3,-1
KR_6676225406,420,-5,-94,-17,-8,0,1,1,-3,5,2,-2,4,2,-2,5,3,-1,2,1,0,1,-4,-3,-4,7,-1,0,0,-1,0,-1,-1,5,-1
KR_6581718109,440,-1,11,-30,-10,-3,5,2,-7,9,2,-2,5,3,-1,4,3,3,3,6,-2,-9,-143,-11,-1,12,3,0,-2,-1,-1,-1,-1,4,-1
KR_6670773222,420,-1,71,-29,-4,0,1,1,2,0,2,1,3,4,-8,9,1,1,2,3,-1,-9,-144,-1,-3,4,1,0,-1,-1,-1,-1,-1,6,-1
KR_6758091164,440,-2,45,-15,-9,5,1,6,-8,8,0,2,2,4,-9,11,2,1,0,1,1,-17,9,2,-6,4,1,0,1,1,0,1,-1,4,-1
KR_6759337643,420,2,-10,4,-1,-2,4,2,-1,2,1,4,2,6,-3,5,2,1,1,2,1,-1,0,-3,-1,4,2,0,2,0,-1,1,1,0,-1
KR_6640302948,420,3,21,-26,3,1,2,3,1,1,2,1,1,2,1,1,2,-1,3,2,-1,0,441,1,-2,1,1,0,1,-1,1,1,-1,2,-1
KR_6686046517,420,0,4,-11,6,4,1,5,0,3,3,0,2,2,0,0,0,2,2,4,-1,10,0,5,-6,1,1,0,0,0,-1,0,-1,0,-1
KR_6633158841,420,-2,7,36,-3,-1,3,2,1,1,2,-3,4,1,1,1,2,-1,1,0,0,-5,-3,-1,-1,2,1,0,0,-1,-1,-1,-1,3,-1
KR_6383365713,440,-1,8,-11,-8,-2,3,1,-3,4,1,-4,5,1,0,2,2,1,0,1,0,-11,0,-1,-1,2,-2,0,0,0,-1,0,-1,0,-1
KR_6744542397,420,-4,-15,-44,-14,2,1,3,-6,7,1,-5,7,2,-5,5,0,0,1,1,0,-14,-7,-4,0,4,0,0,-1,-1,-1,-1,-1,3,-1
KR_6748817709,440,1,-15,-4,2,2,1,3,-2,2,0,-3,3,0,2,4,6,3,2,5,0,-3,27,3,-5,2,-5,0,0,0,-1,0,-1,0,-1
KR_6325500093,420,-2,-75,-16,-4,-2,3,1,1,1,2,-1,4,3,0,4,4,-2,2,0,0,-4,2,4,-8,4,0,0,-1,-1,-1,-1,1,4,-1
KR_6725116769,440,-6,-133,-13,-20,-1,1,0,-4,5,1,-6,7,1,-6,6,0,-3,3,0,0,-9,-4,-3,0,3,0,0,-1,0,0,-1,-1,0,-1
KR_6761403999,420,-1,58,-15,1,-4,5,1,-1,1,0,0,1,1,6,1,7,0,1,1,0,2,0,-3,0,3,1,0,0,-1,0,0,1,6,-1
KR_6678234519,420,0,-59,34,-4,8,0,8,-2,2,0,-1,1,0,-6,11,5,-3,3,0,0,0,23,-3,-1,4,1,0,-2,-1,1,-1,-1,5,-1
KR_6748822378,440,1,8,9,-5,2,1,3,0,2,2,-4,4,0,-1,5,4,-2,3,1,0,-2,274,-1,-4,5,0,0,-1,-1,1,1,1,3,-1
KR_6636178380,420,-1,-34,-12,-1,1,0,1,-2,2,0,-3,4,1,1,1,2,2,0,2,1,3,23,2,-4,2,-1,0,0,-1,1,0,1,6,-1
KR_6752136301,440,-1,-82,-4,1,5,0,5,-1,1,0,4,0,4,-4,4,0,-3,5,2,-1,-3,-2,2,-7,5,1,0,-1,-1,-1,-1,-1,3,-1
KR_6741298464,420,-3,-95,1,-8,-1,2,1,-3,3,0,4,2,6,-3,6,3,-5,6,1,0,-11,-1,1,-1,0,-1,0,-1,-1,1,-1,-1,5,-1
KR_6359738710,420,-4,-23,-12,-6,-4,8,4,-6,6,0,2,1,3,2,3,5,0,0,0,0,-8,0,0,0,0,4,0,-1,-1,-1,-1,1,4,-1
KR_6752160779,420,-2,-54,8,-7,-2,4,2,0,1,1,0,1,1,-3,4,1,-2,2,0,0,-6,-21,3,-5,2,9,0,-1,-1,0,-1,-1,2,-1
KR_6749690360,420,0,18,12,2,-2,2,0,2,2,4,3,1,4,-4,6,2,3,0,3,0,0,5,2,-4,2,-5,0,1,1,1,1,1,6,-1
KR_6678091130,420,2,78,44,2,4,0,4,1,1,2,-1,5,4,-1,2,1,-1,1,0,0,-7,-102,0,-3,3,2,0,1,-1,1,1,1,1,-1
KR_6687340921,420,-4,-10,-3,-14,4,0,4,-2,2,0,-3,4,1,-7,7,0,-6,6,0,-3,-22,41,-1,-2,3,-8,0,1,-1,1,1,-1,4,-1
KR_6596321652,420,1,-10,15,4,-1,5,4,0,1,1,0,2,2,5,0,5,0,0,0,0,4,-107,3,-6,3,-13,0,-2,1,1,-1,-1,5,-1
KR_6451965068,420,0,-64,8,-5,1,0,1,1,0,1,-4,6,2,-4,5,1,1,0,1,0,-3,22,0,-4,4,-3,0,0,1,-1,0,-1,4,-1
KR_6663424659,420,-3,-55,36,-5,-8,9,1,-2,3,1,1,1,2,6,2,8,-2,3,1,-1,6,-181,-3,0,3,1,0,-1,-1,-1,1,-1,2,-1
KR_6653576104,420,-1,14,-3,-1,3,0,3,-1,3,2,0,3,3,-3,5,2,0,2,2,0,-4,-3,1,-4,3,2,0,1,-1,1,1,-1,4,-1
KR_6657302377,420,2,46,12,7,3,0,3,0,2,2,3,1,4,1,0,1,0,0,0,0,12,-15,-1,-2,3,0,0,1,-1,1,1,1,1,-1
KR_6636436939,440,2,41,57,2,-1,2,1,1,0,1,-2,3,1,3,3,6,1,0,1,0,0,8,-2,-3,5,3,0,-2,0,-1,1,1,0,-1
KR_6742392648,420,0,18,-12,-2,-4,4,0,2,1,3,2,1,3,1,3,4,-3,4,1,0,-2,-4,-1,-4,5,-1,0,-1,1,-1,-1,-1,6,-1
KR_6753815502,440,-3,-102,-20,-10,-1,1,0,0,3,3,-5,5,0,-6,7,1,2,0,2,0,-11,-9,-3,-2,5,1,0,-2,-1,-1,-1,-1,5,-1
KR_6656801648,420,-2,8,-14,-9,0,2,2,-3,6,3,0,3,3,-6,7,1,0,1,1,0,-9,1,-1,-5,6,0,0,0,-1,1,1,-1,1,-1
KR_6659927411,440,-2,59,-5,-7,-1,2,1,-1,4,3,0,2,2,-4,5,1,-1,1,0,0,-2,7,-4,-1,5,1,0,0,1,-1,0,-1,3,-1
KR_6740698001,440,-5,-61,-28,-16,-5,5,0,0,3,3,-7,8,1,-4,7,3,0,1,1,0,-18,0,-5,0,5,1,0,-2,-1,-1,-1,-1,1,-1
KR_6743361151,420,-7,-58,-16,-15,-9,9,0,1,2,3,-2,6,4,-5,5,0,0,0,0,-1,-6,-16,1,-2,1,1,0,0,-1,-1,-1,-1,4,-1
KR_6586212786,420,-5,-14,-36,-14,0,2,2,-7,11,4,-4,6,2,1,1,2,-4,4,0,0,-7,6,-1,-3,4,-6,0,-3,-1,-1,-1,-1,3,-1
KR_6483285850,420,2,5,12,-4,-2,2,0,0,3,3,3,0,3,-5,6,1,0,1,1,0,-6,10,0,-1,1,-1,0,1,-1,1,1,-1,5,-1
KR_6651479363,420,-4,-99,-11,-14,1,2,3,3,1,4,-5,5,0,-11,11,0,-2,3,1,0,-16,1,0,-4,4,-3,0,0,-1,1,1,-1,1,-1
KR_6660364081,420,3,18,-8,12,-2,4,2,3,4,7,2,2,4,7,0,7,2,0,2,2,21,5,-7,-3,10,-1,0,2,1,1,1,1,2,-1
KR_6706075942,440,1,43,17,-2,6,1,7,-9,10,1,-1,6,5,2,1,3,0,1,1,0,-12,27,-2,-7,9,-1,0,3,-1,1,1,1,3,-1
KR_6723993715,420,-4,-50,24,-4,0,1,1,-4,6,2,-4,7,3,4,1,5,0,1,1,1,0,15,2,-3,1,0,0,-1,-1,-1,-1,1,6,-1
KR_6658119661,420,-1,-55,4,-5,-4,4,0,0,2,2,-1,1,0,0,1,1,0,1,1,-1,-6,-6,0,-2,2,0,0,-1,-1,-1,-1,-1,2,-1
KR_6743065271,420,3,51,-8,3,0,3,3,1,2,3,1,1,2,1,2,3,0,1,1,0,5,-26,4,-5,1,4,0,0,0,-1,0,1,0,-1
KR_6762586585,420,-3,-30,-28,-8,-2,2,0,0,3,3,1,0,1,-7,7,0,0,4,4,0,-7,515,2,-5,3,-5,0,-1,1,-1,-1,-1,5,-1
KR_6620154920,420,-4,-40,4,-13,1,1,2,-2,3,1,-3,4,1,-7,7,0,-2,4,2,-1,-17,-3,-5,-3,8,6,0,-2,-1,-1,-1,-1,6,-1
KR_6668217831,420,-4,-35,28,-10,-3,3,0,-2,3,1,1,1,2,-7,9,2,1,1,2,-1,-11,1,-3,0,3,2,0,-1,-1,0,-1,-1,1,-1
KR_6723154098,420,-1,-2,7,-3,-5,5,0,3,2,5,0,3,3,1,1,2,-2,2,0,0,7,-3,-1,-2,3,-1,0,0,1,-1,-1,1,5,-1
KR_6600322258,420,3,14,52,0,0,1,1,1,1,2,-11,12,1,8,2,10,2,1,3,0,3,5,1,-4,3,-1,0,1,-1,1,1,1,5,-1
KR_6629850927,420,-4,-14,-35,-6,2,0,2,-3,5,2,-7,7,0,2,0,2,0,0,0,0,-7,2,-2,-1,3,-1,0,1,-1,-1,-1,1,5,-1
KR_6721095466,420,-1,63,-64,-7,-3,3,0,-2,2,0,-1,5,4,-1,5,4,0,3,3,0,-6,-1,0,0,0,-2,0,1,-1,0,1,1,5,-1
KR_6648719303,420,0,40,20,-4,2,0,2,1,0,1,-3,7,4,-4,4,0,0,0,0,0,-4,13,-1,0,1,1,0,0,1,0,0,-1,3,-1
KR_6654045331,420,-2,-44,-3,-12,1,0,1,-1,2,1,-6,7,1,-7,8,1,1,0,1,0,-11,-30,-2,-3,5,3,0,-2,0,-1,-1,-1,0,-1
KR_6579106722,420,-1,6,12,1,-4,5,1,3,0,3,-1,2,1,4,2,6,-1,1,0,0,7,215,2,-4,2,-1,0,1,1,-1,-1,1,1,-1
KR_6683050555,420,0,-80,11,-6,-4,4,0,4,1,5,-6,6,0,-2,4,2,2,0,2,0,-3,8,0,-4,4,-4,0,-1,1,-1,-1,-1,5,-1
KR_6576492396,420,-1,-25,-16,-5,0,1,1,0,1,1,1,2,3,-7,8,1,1,0,1,0,-9,3,-2,-1,3,-1,0,-1,-1,-1,-1,-1,4,-1
KR_6764343703,420,-2,-26,-21,-2,-2,2,0,1,0,1,1,2,3,1,4,5,-3,4,1,0,-1,-9,-3,-1,4,1,0,-1,-1,1,-1,1,5,-1
KR_6625721309,420,-3,-65,1,0,7,0,7,-1,1,0,-1,3,2,-2,2,0,-3,3,0,0,-4,-275,-1,-1,2,-2,0,-2,-1,1,-1,-1,1,-1
KR_6740280449,420,-8,-64,-84,-14,1,0,1,-6,7,1,-5,6,1,-2,4,2,-2,2,0,0,-2,-14,-1,-1,2,-1,0,-1,-1,-1,-1,-1,6,-1
KR_6749109454,420,-4,-59,1,-8,-2,2,0,-1,4,3,-5,5,0,4,1,5,-4,4,0,1,-2,9,-1,-4,5,-2,0,0,-1,1,-1,1,5,-1
KR_6609187093,440,-3,-19,-5,-9,-9,12,3,2,2,4,0,1,1,0,0,0,-2,4,2,0,-2,6,-7,-2,9,-1,0,-2,-1,0,-1,1,3,-1
KR_6745105322,420,-1,-70,-8,-7,-1,1,0,-3,5,2,1,2,3,-4,4,0,0,0,0,-1,-7,-3,-1,-3,4,1,0,-2,1,-1,-1,-1,2,-1
KR_6713700010,440,-2,73,8,-3,5,0,5,-5,8,3,-3,6,3,0,3,3,0,1,1,0,-4,-23,5,-5,0,-2,0,0,-1,0,1,1,5,-1
KR_6743001641,420,0,-77,3,-3,-3,3,0,-4,4,0,1,3,4,1,1,2,2,1,3,1,0,-3,2,-3,1,-2,0,-2,-1,-1,-1,1,4,-1
KR_6756377217,440,-2,24,3,-5,-5,6,1,4,2,6,0,1,1,-4,8,4,0,0,0,0,-5,-16,3,-5,2,2,0,-1,0,0,-1,-1,0,-1
KR_6732454739,420,4,-54,12,8,0,2,2,3,3,6,3,0,3,0,0,0,2,0,2,2,8,-13,-2,-2,4,3,0,-1,-1,0,-1,1,6,-1
KR_6667946360,440,-3,-70,-16,-7,2,1,3,-3,4,1,4,2,6,-8,8,0,-2,2,0,1,-5,-7,0,-4,4,-2,0,-3,-1,-1,-1,1,5,-1
KR_6727510235,420,-4,-54,-16,-4,-1,1,0,2,0,2,-6,8,2,1,0,1,0,2,2,0,-3,-7,-6,-2,8,-3,0,-1,1,-1,-1,-1,6,-1
KR_6620908185,420,2,23,8,4,6,1,7,0,1,1,-3,6,3,0,6,6,1,0,1,2,6,3,2,-2,0,0,0,2,-1,1,1,1,5,-1
KR_6617607515,420,7,26,-7,1,2,1,3,1,3,4,-5,5,0,2,3,5,1,0,1,-1,3,272,-7,-1,8,6,0,2,0,1,1,-1,0,-1
KR_6722328009,420,0,-35,6,-4,3,1,4,0,2,2,-2,4,2,-4,4,0,-1,1,0,0,-8,-16,-1,-4,5,-11,0,-1,0,-1,-1,-1,0,-1
KR_6589159572,420,-3,-110,-43,-2,-2,2,0,3,1,4,1,3,4,-4,5,1,0,1,1,0,-4,-315,-2,-1,3,-5,0,-2,-1,-1,-1,-1,2,-1
KR_6195030157,440,-4,-45,-13,-10,-7,9,2,-3,5,2,1,0,1,-1,1,0,0,0,0,0,-10,-4,-5,-3,8,1,0,-1,-1,-1,-1,-1,2,-1
KR_6625101744,420,-2,-14,-13,-3,-1,1,0,5,2,7,-5,6,1,-1,3,2,-1,1,0,0,-4,7,3,-6,3,1,0,0,1,1,0,1,5,-1
KR_6648435628,420,-4,-71,10,-3,-6,7,1,5,0,5,0,2,2,-3,3,0,1,2,3,0,1,20,2,-5,3,0,0,1,-1,1,1,-1,4,-1
KR_6601434944,420,0,-104,-4,-2,-2,2,0,2,1,3,-1,2,1,-3,5,2,2,1,3,0,0,-4,2,-2,0,-2,0,1,0,1,-1,-1,0,-1
KR_6737050596,420,-1,-8,4,0,-1,1,0,3,1,4,1,2,3,-3,3,0,0,0,0,0,-4,12,2,-6,4,2,0,0,1,1,0,1,5,-1
KR_6383995840,440,-1,79,-6,-1,-3,5,2,0,1,1,1,1,2,1,1,2,0,3,3,1,-5,259,0,-3,3,-5,0,-1,-1,-1,-1,1,2,-1
KR_6742832081,420,2,51,10,4,6,1,7,3,2,5,-2,4,2,1,2,3,-4,11,7,0,-1,-39,0,-1,1,4,0,0,0,0,1,-1,0,-1
KR_6634222982,420,2,25,-24,-1,-3,3,0,-1,5,4,-3,4,1,4,2,6,2,1,3,-1,2,10,3,-6,3,-6,0,-1,-1,-1,-1,-1,4,-1
KR_6695019231,420,-10,-138,-20,-19,-5,5,0,-1,1,0,-5,6,1,-7,11,4,-1,2,1,1,-7,3,3,-7,4,0,0,-2,1,0,-1,-1,4,-1
KR_6724362028,420,-3,-47,6,-3,-6,7,1,0,0,0,-5,5,0,1,2,3,7,1,8,0,7,-399,0,-1,1,-3,-1,-4,1,-1,-1,-1,2,-1
KR_6761358253,420,3,57,10,2,-3,4,1,2,1,3,-1,1,0,1,1,2,3,1,4,1,8,5,2,-4,2,0,0,1,-1,-1,1,1,5,-1
KR_6736934140,440,-5,-67,0,-15,1,1,2,-4,6,2,-7,8,1,-7,9,2,2,1,3,0,-18,-7,-1,-3,4,-1,0,-4,-1,-1,-1,-1,5,-1
KR_6738676493,420,-3,-16,-20,-3,-2,2,0,1,2,3,0,1,1,-2,3,1,0,0,0,0,1,-287,1,-2,1,0,0,0,0,1,0,-1,0,-1
KR_6732476427,420,-5,-28,-26,-12,0,3,3,-3,3,0,-3,3,0,-6,7,1,0,0,0,0,-9,12,1,-3,2,-3,0,-2,-1,-1,-1,1,5,-1
KR_6608946574,420,-3,-73,-8,-2,-3,3,0,1,1,2,-1,3,2,2,3,5,-1,4,3,0,-1,-9,-2,-1,3,0,0,-1,-1,-1,-1,-1,6,-1
KR_6728398633,420,-4,-49,-4,-9,-6,6,0,1,2,3,-1,1,0,-2,5,3,-1,1,0,-1,-6,-7,1,-3,2,4,0,-2,-1,-1,-1,-1,5,-1
KR_6684186141,420,-3,-148,12,-5,-4,9,5,-1,4,3,2,1,3,-5,6,1,3,1,4,0,1,-22,-1,-1,2,0,0,-2,1,1,-1,-1,1,-1
KR_6733542914,420,-1,9,-25,12,7,1,8,8,1,9,-4,4,0,1,1,2,0,1,1,0,17,-2,6,-6,0,-1,0,2,-1,1,1,1,2,-1
KR_6637038016,420,0,15,1,6,1,0,1,5,0,5,2,0,2,-2,3,1,0,0,0,0,2,0,2,-5,3,-3,0,0,-1,1,1,1,3,-1
KR_6727189755,420,2,20,12,1,1,1,2,1,2,3,-2,3,1,1,2,3,0,0,0,0,-8,5,-3,-4,7,0,0,2,1,1,1,1,3,-1
KR_6763631170,440,-1,-80,14,3,-2,3,1,1,1,2,2,0,2,1,5,6,1,1,2,0,7,5,4,-6,2,0,0,-3,-1,-1,-1,1,3,-1
KR_6626286345,420,-5,-18,3,-11,0,0,0,-2,3,1,0,3,3,-2,3,1,-7,8,1,0,-10,2,-1,-2,3,-1,0,-1,0,-1,-1,-1,0,-1
KR_6751340505,420,2,2,-2,5,-2,3,1,1,0,1,-2,3,1,4,2,6,4,0,4,1,8,5,0,-8,8,2,0,-1,1,-1,-1,1,4,-1
KR_6726133370,440,-4,-4,1,2,1,0,1,3,0,3,-5,5,0,2,1,3,1,1,2,2,4,-12,-3,-2,5,2,0,0,0,0,0,1,0,-1
KR_6721137565,420,0,-44,-12,2,-2,6,4,-4,4,0,1,1,2,4,1,5,3,2,5,0,8,-17,-3,0,3,1,0,0,0,-1,-1,-1,0,-1
KR_6714649192,420,-2,16,24,-9,-1,2,1,-4,7,3,-2,4,2,-1,2,1,-1,1,0,0,-7,-124,-2,-2,4,-3,0,-1,-1,0,-1,-1,3,-1
KR_6725533836,420,2,-52,3,3,-2,4,2,2,1,3,3,2,5,-2,5,3,2,1,3,0,7,0,-3,-3,6,-1,0,-2,-1,-1,-1,1,1,-1
KR_6667642484,420,-4,-82,-28,-11,-1,4,3,-1,4,3,-8,11,3,-1,1,0,0,0,0,0,-2,7,2,-4,2,-1,0,-3,-1,-1,-1,-1,4,-1
KR_6562074665,420,-2,-74,-20,2,-2,5,3,1,2,3,-1,4,3,5,2,7,-1,2,1,0,9,-5,3,-5,2,0,0,-3,1,-1,-1,-1,1,-1
KR_6592215478,420,-2,-21,-17,-7,0,1,1,1,4,5,0,4,4,-9,11,2,1,0,1,-1,-3,6,1,-4,3,-1,0,-1,-1,-1,-1,-1,2,-1
KR_6693675124,420,-1,-48,-4,1,-2,2,0,1,0,1,-2,3,1,4,6,10,0,0,0,0,1,-137,1,-4,3,-7,0,-1,-1,1,-1,1,3,-1
KR_6698757779,420,0,-10,16,4,2,0,2,0,1,1,2,0,2,0,0,0,0,0,0,1,4,18,-3,-1,4,0,0,1,-1,-1,1,1,2,-1
KR_6751405635,420,-2,-74,-26,-1,-4,5,1,0,1,1,2,2,4,0,0,0,1,0,1,0,-1,162,1,-1,0,0,0,0,-1,-1,0,-1,6,-1
KR_6636042601,420,-6,-55,-16,-11,0,0,0,-3,5,2,-8,9,1,4,1,5,-4,4,0,0,-8,12,1,-2,1,0,0,-1,-1,-1,-1,-1,1,-1
KR_6006080485,420,-2,-12,2,8,2,2,4,0,4,4,3,1,4,2,0,2,1,0,1,0,4,-277,-3,-1,4,-1,0,1,-1,1,1,1,5,-1
KR_6729613632,420,0,-12,0,-2,-3,4,1,1,1,2,-2,4,2,2,2,4,0,2,2,0,6,7,4,-5,1,-3,0,-1,-1,-1,-1,-1,5,-1
KR_6617456684,420,-6,-35,5,-17,0,1,1,-7,9,2,-5,5,0,1,2,3,-6,7,1,0,-18,-51,1,-4,3,0,0,-2,-1,1,-1,1,2,-1
KR_6763074878,420,1,-3,-30,1,-2,3,1,3,1,4,1,0,1,-4,4,0,3,0,3,0,5,9,3,-5,2,1,0,-1,-1,-1,-1,1,5,-1
KR_6751517133,420,-2,-99,20,-4,1,3,4,1,1,2,2,1,3,-7,8,1,-1,1,0,0,-6,-5,3,-4,1,-1,0,0,1,1,0,1,5,-1
KR_6739580419,420,2,-24,16,2,-1,1,0,0,5,5,1,2,3,1,3,4,1,0,1,1,2,3,-2,-5,7,3,0,1,0,-1,1,-1,0,-1
KR_6759562342,420,-4,-164,-36,-7,-2,2,0,-4,5,1,-1,2,1,1,0,1,-1,1,0,-1,-4,-296,-2,-2,4,-2,0,-2,-1,-1,-1,-1,1,-1
KR_6750573526,440,1,17,-33,1,1,0,1,4,1,5,-1,5,4,-1,3,2,-2,2,0,0,-5,8,-3,-3,6,2,0,0,1,-1,1,-1,3,-1
KR_6746395390,420,-1,9,20,2,2,0,2,0,2,2,0,0,0,1,2,3,-1,1,0,-1,-2,-6,1,-3,2,2,0,0,1,-1,-1,-1,4,-1
KR_6660323492,440,3,3,24,8,0,3,3,-1,4,3,3,0,3,5,0,5,1,1,2,2,9,-1,-1,-2,3,1,0,1,0,-1,1,1,0,-1
KR_6717316165,420,-6,-79,4,-10,-2,3,1,-4,5,1,2,0,2,-6,6,0,0,0,0,0,-11,-5,1,-3,2,2,0,0,0,-1,-1,-1,0,-1
KR_6762228131,420,-4,-21,-52,-11,-2,4,2,-3,3,0,-4,4,0,0,2,2,-2,2,0,0,-7,28,0,-3,3,-6,0,1,-1,-1,1,-1,2,-1
KR_6751871258,420,4,-28,29,6,-3,3,0,3,3,6,3,2,5,3,0,3,0,0,0,0,5,-17,3,-7,4,-2,0,0,-1,1,1,1,5,-1
KR_6763960247,420,0,-104,-29,2,-3,3,0,-1,2,1,2,1,3,4,2,6,0,0,0,0,4,22,-1,-1,2,-6,0,0,-1,1,-1,1,4,-1
KR_6756445831,420,-5,-35,8,-10,6,1,7,0,2,2,-6,6,0,-10,11,1,0,0,0,0,-7,-9,-2,-5,7,3,0,0,-1,1,1,-1,2,-1
KR_6682694759,420,1,-22,-12,2,3,1,4,0,1,1,-1,2,1,0,1,1,0,0,0,0,4,3,4,-5,1,-2,0,0,0,-1,-1,1,0,-1
KR_6752891555,420,0,35,-25,1,1,1,2,-3,4,1,2,1,3,2,0,2,-1,1,0,0,2,10,8,-10,2,0,0,-1,1,0,-1,-1,3,-1
KR_6679393895,420,-3,26,-30,-6,-2,5,3,-7,8,1,-3,5,2,1,2,3,5,0,5,0,-3,13,-2,-1,3,-2,0,0,-1,-1,1,-1,5,-1
KR_6725843103,440,-5,-136,-31,1,0,1,1,1,0,1,-4,4,0,1,2,3,3,1,4,0,1,-4,2,-4,2,-1,0,-1,-1,-1,-1,1,1,-1
KR_6702656309,440,3,-14,24,7,1,2,3,2,1,3,-3,3,0,7,1,8,0,3,3,0,-2,13,3,-4,1,1,0,0,1,0,0,1,3,-1
KR_5608947348,420,-3,-99,-24,-3,-5,6,1,1,2,3,0,1,1,2,1,3,-1,2,1,0,5,-3,-1,-3,4,-1,0,-1,1,1,-1,-1,3,-1
KR_6760753841,440,-5,3,-12,-10,-3,3,0,-5,5,0,-2,5,3,0,2,2,0,3,3,0,-12,12,-1,-2,3,-5,0,0,-1,0,0,-1,1,-1
KR_6764476780,420,-3,-11,-28,5,-6,6,0,0,2,2,0,1,1,5,2,7,6,0,6,0,2,7,-3,-3,6,7,0,0,0,-1,1,1,0,-1
KR_6716304603,440,-5,-100,-28,-9,0,2,2,-1,2,1,2,2,4,-7,7,0,-3,3,0,0,-3,-37,0,-1,1,26,0,-3,-1,1,-1,-1,4,-1
KR_6733600519,420,-3,-78,0,-4,-1,4,3,-1,5,4,-3,3,0,1,2,3,0,2,2,1,-3,-24,1,-4,3,-4,0,0,1,1,-1,-1,6,-1
KR_6607464297,420,-3,-14,24,-10,0,0,0,0,0,0,-4,4,0,-6,7,1,0,0,0,0,-5,0,-3,-1,4,-2,0,-1,-1,-1,-1,-1,1,-1
KR_6692095166,420,-10,-86,-14,-19,-3,3,0,-3,3,0,-3,4,1,-5,6,1,-5,5,0,-1,-15,73,-2,-2,4,26,0,-2,-1,-1,-1,-1,1,-1
KR_6546069490,420,-3,-9,16,-8,-3,3,0,-3,5,2,1,3,4,-2,6,4,-1,2,1,0,-6,-14,3,-4,1,0,0,0,-1,-1,-1,-1,3,-1
KR_5581513919,420,-6,-27,-53,-17,5,1,6,-9,10,1,-11,11,0,-3,5,2,1,0,1,1,-22,-189,0,-2,2,-2,0,-3,-1,-1,-1,1,2,-1
KR_6731839103,420,-1,-37,20,0,-6,7,1,-2,5,3,4,2,6,4,1,5,0,3,3,1,1,-1,-1,-1,2,-1,0,-1,-1,-1,-1,1,5,-1
KR_6749924273,420,-6,-32,-1,-10,-2,5,3,2,1,3,-7,8,1,-2,3,1,-1,2,1,2,-5,3,1,-5,4,1,0,0,0,0,0,1,0,-1
KR_6738745820,420,1,31,4,-3,0,2,2,4,1,5,-8,9,1,1,3,4,0,0,0,-1,6,212,-2,0,2,2,0,-1,-1,-1,-1,-1,5,-1
KR_6732501049,420,-4,-144,9,-19,-9,9,0,1,2,3,-1,4,3,-4,5,1,-6,8,2,0,-10,26,0,-2,2,-11,0,-3,-1,1,-1,-1,6,-1
KR_6629401855,420,-1,-42,8,-8,-2,6,4,2,0,2,-1,4,3,-3,4,1,-4,4,0,-1,-2,-17,-3,-1,4,2,0,-1,-1,-1,-1,-1,6,-1
KR_6696095412,420,2,-90,37,2,0,1,1,0,3,3,0,4,4,0,4,4,2,0,2,0,5,0,-4,-2,6,3,0,1,1,1,1,1,5,-1
KR_6696676321,420,-3,-63,32,-5,-1,1,0,-3,3,0,-4,4,0,1,1,2,2,0,2,0,-2,105,-1,-2,3,0,0,-1,-1,0,-1,-1,6,-1
KR_6328275415,420,-4,-64,18,-8,-3,3,0,0,3,3,-2,2,0,1,2,3,-4,4,0,0,-9,-7,-6,-1,7,1,0,-1,-1,-1,-1,-1,2,-1
KR_6701511427,420,-3,17,20,-5,0,1,1,0,1,1,-1,3,2,-6,9,3,2,1,3,2,-1,-3,0,-1,1,1,0,-1,-1,-1,-1,1,5,-1
KR_6694218893,420,0,-33,-4,-4,1,0,1,0,1,1,-5,5,0,0,1,1,0,0,0,0,-10,-108,-5,-4,9,5,0,-1,0,1,1,1,0,-1
KR_6631537927,420,3,35,20,4,4,1,5,-1,2,1,3,0,3,-3,6,3,1,0,1,0,-7,-7,0,-1,1,0,0,1,1,1,1,1,6,-1
KR_6726716502,420,-6,-108,-12,-12,-1,2,1,-7,8,1,-1,1,0,-2,2,0,-1,2,1,0,-12,-7,-4,-3,7,-2,0,-1,-1,-1,-1,-1,5,-1
KR_6646986332,420,-1,4,-4,4,0,2,2,4,0,4,-2,3,1,1,0,1,1,1,2,0,6,-6,2,-4,2,-2,0,0,0,-1,1,1,0,-1
KR_6738947738,420,-3,48,20,-4,-2,2,0,1,2,3,-2,5,3,0,1,1,-1,1,0,-1,0,34,0,-5,5,0,0,0,1,-1,1,-1,2,-1
KR_6656809323,440,-7,-23,-46,-11,-1,1,0,-2,3,1,-1,4,3,-2,2,0,-5,6,1,0,-11,401,-1,-3,4,2,0,-1,-1,-1,-1,1,1,-1
KR_6760943906,420,0,75,7,-5,1,1,2,1,1,2,-2,4,2,-2,4,2,-3,3,0,0,-4,0,-3,0,3,0,0,1,0,0,1,1,0,-1
KR_6750486558,440,-6,-113,-4,-13,-5,5,0,-5,7,2,-2,3,1,-4,7,3,3,2,5,0,-17,27,-2,-1,3,-19,0,-1,1,1,-1,-1,6,-1
KR_6638465676,420,0,20,-4,1,0,1,1,-1,2,1,-5,7,2,3,1,4,4,3,7,0,3,2,-5,-3,8,0,0,1,-1,-1,1,1,5,-1
KR_6712916855,420,-2,-42,28,-9,-2,2,0,-2,5,3,1,2,3,-1,2,1,-5,5,0,0,-10,38,2,-5,3,-30,0,-2,0,-1,-1,-1,0,-1
KR_6586283966,420,2,-8,-34,0,7,0,7,-2,3,1,-1,3,2,-1,3,2,-3,4,1,-2,-5,-4,3,-5,2,2,0,1,-1,1,1,-1,1,-1
KR_6752578697,420,0,19,-31,-2,-1,1,0,-3,4,1,-6,6,0,8,0,8,0,1,1,-1,1,-8,0,-1,1,-1,0,0,1,1,-1,-1,6,-1
KR_6675650145,420,1,46,-9,1,-4,7,3,-6,7,1,4,0,4,4,1,5,3,0,3,-1,8,-6,-2,-3,5,0,0,-1,0,-1,1,-1,0,-1
KR_6762501228,420,-3,-74,-21,-8,-3,3,0,5,2,7,1,3,4,-11,11,0,0,1,1,0,-2,-4,-2,-3,5,-5,0,-1,-1,1,-1,-1,5,-1
KR_6742648434,420,2,102,-12,2,-2,2,0,1,1,2,3,4,7,-2,4,2,2,0,2,0,-1,26,-2,-2,4,-19,0,1,1,0,1,-1,6,-1
KR_6762688223,440,-6,-84,-48,-13,-6,6,0,1,1,2,-4,4,0,-4,6,2,0,3,3,0,-9,37,0,-2,2,-23,0,-2,1,-1,-1,-1,2,-1
KR_6723648077,420,2,10,-8,4,-4,4,0,4,0,4,4,0,4,1,2,3,-1,4,3,0,10,11,3,-5,2,1,0,1,-1,1,1,-1,1,-1
KR_6726810979,420,-4,-38,-17,-8,0,2,2,-2,4,2,-3,6,3,-2,5,3,-1,2,1,0,-1,-7,-4,-2,6,1,0,-1,1,-1,-1,1,3,-1
KR_6667048686,420,-5,-76,4,-8,2,0,2,0,2,2,-3,3,0,-2,5,3,-5,6,1,0,-4,7,-3,-1,4,-3,0,-1,-1,1,-1,-1,2,-1
KR_6625055957,420,-7,-39,-45,-7,5,0,5,-5,5,0,-3,3,0,-3,3,0,-1,2,1,0,-9,0,3,-6,3,1,0,-1,-1,-1,-1,-1,1,-1
KR_6709821313,420,1,9,20,-4,0,1,1,1,3,4,1,1,2,0,1,1,-6,6,0,0,-4,3,0,-3,3,-4,0,0,1,0,0,-1,5,-1
KR_6722909299,440,-2,-50,-3,-4,0,0,0,1,0,1,0,0,0,-4,5,1,-1,1,0,0,0,-3,1,-5,4,-2,0,-1,-1,1,-1,1,3,-1
KR_6649407874,420,0,58,2,0,3,0,3,-3,4,1,1,0,1,-1,3,2,0,0,0,0,-1,216,-2,-3,5,1,0,1,1,-1,1,1,5,-1
KR_6611101795,420,-4,-25,-32,-3,-2,3,1,-2,2,0,1,2,3,0,0,0,0,1,1,0,-8,-14,1,-6,5,-4,0,-2,-1,-1,-1,-1,6,-1
KR_6689119075,420,-1,-50,12,-3,-4,5,1,1,2,3,2,0,2,-2,3,1,0,0,0,0,-1,45,0,-2,2,-26,0,-2,1,-1,-1,1,6,-1
KR_6717377547,420,-5,-39,-16,-10,-2,3,1,-1,4,3,-3,7,4,-3,5,2,-1,1,0,0,-7,-12,1,-4,3,-3,0,0,1,-1,0,-1,5,-1
KR_6689764285,440,3,3,21,9,2,2,4,0,2,2,1,1,2,3,1,4,3,1,4,0,15,-36,4,-5,1,24,0,0,1,1,0,1,6,-1
KR_6623836717,440,-3,-82,-14,-3,-4,6,2,1,1,2,0,2,2,0,2,2,0,2,2,0,4,-75,2,-3,1,19,0,-1,-1,-1,-1,-1,2,-1
KR_6724662170,420,1,17,0,-2,-1,3,2,-2,2,0,2,2,4,0,0,0,-1,1,0,0,-7,-14,-1,-3,4,1,0,0,-1,1,0,-1,2,-1
KR_6714009374,420,-4,-45,-31,-7,-2,2,0,-3,7,4,-5,5,0,0,1,1,3,1,4,0,-6,556,0,-4,4,1,0,0,-1,0,1,-1,2,-1
KR_6651505540,420,-7,-103,-27,-17,-1,3,2,-6,8,2,-8,8,0,-1,4,3,-1,3,2,-1,-17,0,-1,-1,2,-1,0,-1,0,1,-1,-1,0,-1
KR_6740422411,420,0,60,11,-3,1,1,2,-7,7,0,1,2,3,1,1,2,1,0,1,0,-9,-12,-4,-2,6,-1,0,0,1,1,0,1,5,-1
KR_6736469125,420,-4,-43,-22,-5,0,1,1,0,3,3,-1,4,3,-5,8,3,1,1,2,0,-3,16,-2,-5,7,-3,0,-1,-1,-1,-1,-1,4,-1
KR_6742136060,420,-3,53,8,-3,1,0,1,1,2,3,-4,5,1,1,1,2,-2,2,0,0,-1,-19,0,-5,5,4,0,0,1,-1,0,-1,5,-1
KR_6743324934,420,0,-9,-4,-2,0,2,2,1,1,2,-3,4,1,1,0,1,-1,1,0,0,1,29,3,-6,3,-22,0,0,-1,-1,0,-1,2,-1
KR_6763923742,420,0,-13,20,-3,-2,4,2,2,1,3,-5,6,1,2,2,4,0,1,1,0,-4,-2,1,-3,2,0,0,-1,1,1,-1,1,2,-1
KR_6757844386,420,0,-20,0,-3,-1,2,1,-1,2,1,-2,9,7,-3,4,1,4,1,5,0,-5,41,2,-3,1,-38,0,0,1,1,0,-1,2,-1
KR_6495518277,420,0,39,0,-3,2,0,2,-4,6,2,0,3,3,-2,4,2,1,0,1,0,2,-300,0,-4,4,-2,0,0,1,-1,0,1,3,-1
KR_6739385011,420,-2,-39,-23,4,-1,3,2,-3,3,0,4,3,7,3,1,4,1,2,3,1,-5,6,0,-5,5,-2,0,-1,-1,1,-1,1,6,-1
KR_6607035171,420,-4,20,-67,-9,-6,7,1,-5,5,0,0,2,2,4,2,6,-2,2,0,0,-6,3,-1,-3,4,1,0,-1,-1,-1,-1,1,6,-1
KR_6743652291,420,1,-20,0,2,5,1,6,1,6,7,-4,5,1,-2,3,1,2,0,2,0,-2,9,3,-4,1,2,0,0,-1,1,1,1,1,-1
KR_6756839317,420,-2,-60,-24,-3,0,3,3,0,0,0,1,1,2,-3,4,1,-1,1,0,0,-10,-17,-4,-1,5,4,0,-3,1,0,-1,1,2,-1
KR_6634079419,420,1,-44,4,1,-1,1,0,-1,2,1,0,2,2,4,0,4,-1,1,0,0,4,-124,-1,0,1,-1,0,1,1,1,1,1,6,-1
KR_6703985884,420,1,-34,-12,2,0,3,3,2,3,5,3,2,5,0,1,1,-3,6,3,0,7,-40,6,-6,0,15,0,0,1,1,1,1,1,-1
KR_6693698461,420,4,66,-24,4,2,2,4,-2,6,4,0,1,1,-2,2,0,6,1,7,-1,-1,10,1,-5,4,-1,0,2,1,0,1,1,6,-1
KR_6746801012,420,0,-7,2,-1,0,1,1,-1,2,1,0,6,6,0,1,1,0,1,1,0,1,-15,-2,-1,3,1,0,0,1,-1,0,-1,4,-1
KR_6728790357,420,-3,-52,-26,-9,2,0,2,-8,8,0,0,2,2,-1,2,1,-2,5,3,0,-9,-31,-1,-2,3,20,0,-1,-1,-1,-1,-1,5,-1
KR_6730002077,420,-4,-13,-16,-13,-2,3,1,-1,5,4,-7,8,1,-3,4,1,0,2,2,-2,-18,5,-2,-1,3,-1,0,-2,-1,-1,-1,-1,4,-1
KR_6726869943,420,2,-28,1,0,2,0,2,6,1,7,-6,6,0,0,1,1,-2,2,0,0,5,-13,0,0,0,3,0,0,-1,1,-1,1,5,-1
KR_6630151707,420,-2,13,8,0,-3,3,0,3,0,3,0,4,4,-1,2,1,1,0,1,0,-11,198,1,-2,1,-1,0,1,-1,1,1,-1,3,-1
KR_6731430727,420,3,12,-1,3,2,1,3,-1,1,0,-1,3,2,2,0,2,1,0,1,0,4,-11,-1,-2,3,-2,0,0,0,-1,0,1,0,-1
KR_6726385321,420,4,60,13,0,-1,3,2,0,2,2,0,2,2,2,5,7,-1,6,5,-2,-3,14,1,-5,4,8,0,2,0,1,1,1,0,-1
KR_6062656281,440,-5,-66,-16,-14,-8,8,0,-2,2,0,1,0,1,-5,6,1,0,0,0,0,-9,-27,1,-5,4,2,0,-2,-1,0,-1,-1,3,-1
KR_6636611283,440,2,-5,20,-1,5,0,5,-2,3,1,-1,1,0,-3,4,1,0,0,0,0,-1,-3,2,-7,5,-5,0,1,-1,1,1,1,5,-1
KR_6605172819,420,-3,-23,-19,-7,-4,5,1,-1,6,5,2,1,3,-4,8,4,0,0,0,1,-7,-41,-2,-1,3,17,0,-1,1,-1,-1,1,5,-1
KR_6632346582,420,-2,-5,-4,-9,1,1,2,-7,9,2,0,2,2,-2,2,0,-1,2,1,0,-10,304,-5,-3,8,4,0,0,-1,-1,0,1,6,-1
KR_6762718294,420,0,-5,10,-7,2,0,2,-2,3,1,-4,5,1,-1,3,2,-2,2,0,0,-11,-12,-3,-3,6,1,0,0,1,-1,-1,-1,5,-1
KR_6749063823,420,0,-72,-29,1,0,1,1,2,2,4,5,2,7,-6,6,0,0,0,0,2,7,-15,1,-5,4,2,0,-1,1,-1,-1,1,1,-1
KR_6338914408,420,-7,-76,-40,-12,-10,11,1,-2,3,1,-1,4,3,-3,3,0,4,0,4,-1,-5,-8,0,-1,1,1,0,-2,-1,1,-1,-1,3,-1
KR_6691942591,420,0,-38,-21,-1,-3,5,2,7,0,7,1,1,2,-6,7,1,0,3,3,0,-3,-3,1,-5,4,0,0,0,1,0,0,-1,1,-1
KR_6753198716,420,-4,-104,-16,-10,-1,2,1,-1,2,1,-4,5,1,-5,5,0,1,2,3,-1,-10,26,-2,0,2,-3,0,-1,-1,1,-1,-1,4,-1
KR_6409448015,420,1,-12,5,-7,1,3,4,0,2,2,-3,7,4,-5,5,0,0,2,2,0,-4,5,2,-6,4,1,0,1,-1,1,1,1,2,-1
KR_6596717106,420,1,6,20,1,-2,3,1,-3,5,2,2,0,2,2,1,3,2,0,2,0,3,10,0,-4,4,1,0,0,1,0,0,-1,6,-1
KR_6733918713,420,2,-2,2,-2,5,0,5,1,0,1,-2,2,0,-1,3,2,-5,5,0,0,-8,28,0,-1,1,2,0,0,0,1,0,1,0,-1
KR_6648834366,420,-1,32,28,3,1,0,1,2,2,4,3,1,4,-3,3,0,0,2,2,0,-3,-34,4,-5,1,30,0,0,1,1,1,1,3,-1
KR_6585586338,420,2,69,16,4,4,0,4,-1,5,4,0,2,2,-1,2,1,2,0,2,-1,-3,10,3,-4,1,-3,0,2,1,1,1,-1,5,-1
KR_6741229164,420,-1,-57,-4,-4,-6,6,0,0,5,5,2,1,3,-1,4,3,1,1,2,0,-6,-2,2,-4,2,0,0,-1,1,-1,-1,-1,4,-1
KR_6623287675,420,0,34,-8,0,5,0,5,3,2,5,-8,8,0,0,1,1,0,2,2,1,-3,-6,-3,-1,4,0,0,-1,-1,1,-1,1,1,-1
KR_6613755302,440,1,13,21,-1,4,3,7,2,2,4,-5,5,0,-2,4,2,0,0,0,0,-8,0,-2,-3,5,5,0,-2,1,-1,-1,1,4,-1
KR_6654756626,420,-2,-3,8,-5,0,0,0,-1,4,3,-2,2,0,0,1,1,-2,3,1,0,-3,1,-2,-1,3,0,0,0,-1,-1,0,-1,1,-1
KR_6737815955,420,-2,73,-39,-11,-2,2,0,-9,9,0,-8,8,0,8,0,8,0,2,2,0,-10,38,-3,-4,7,-18,0,-1,-1,-1,-1,-1,1,-1
KR_6722557949,440,-1,-68,-8,-2,-1,2,1,-1,3,2,1,1,2,0,1,1,-1,2,1,0,4,-17,2,-5,3,3,0,0,1,0,0,-1,6,-1
KR_6660561675,420,-2,-72,7,-3,-4,5,1,2,0,2,1,1,2,-2,2,0,0,1,1,0,2,-13,-7,-1,8,2,0,-1,1,1,-1,-1,6,-1
KR_6760750852,420,-1,18,32,-2,0,1,1,0,1,1,1,5,6,-4,4,0,1,2,3,0,-6,-5,-2,-1,3,1,0,0,1,0,-1,-1,1,-1
KR_6738777449,420,1,30,0,-4,2,0,2,-2,3,1,-1,1,0,-3,3,0,0,1,1,0,-4,-47,-2,-1,3,24,0,0,1,1,0,-1,3,-1
KR_6763656480,440,2,1,12,10,3,0,3,3,2,5,1,2,3,5,2,7,-2,2,0,0,4,-98,-3,-2,5,5,0,0,1,1,0,-1,2,-1
KR_6714551488,420,-2,-86,-31,-9,-2,2,0,0,5,5,-4,4,0,-1,2,1,-2,3,1,0,-4,303,1,-5,4,1,0,0,1,1,1,1,6,-1
KR_6735443671,420,-4,-17,-16,-13,1,1,2,-1,2,1,-12,12,0,-1,2,1,0,0,0,0,-14,41,0,-3,3,3,0,0,-1,-1,0,1,1,-1
KR_6646030166,440,-4,-95,-4,-16,-3,5,2,2,0,2,-4,4,0,-5,6,1,-6,6,0,0,-17,-12,-4,-1,5,0,0,-1,0,1,-1,-1,0,-1
KR_6708908194,420,-1,-42,20,-6,-2,4,2,0,4,4,-1,1,0,-1,1,0,-2,3,1,0,-3,-7,-1,-5,6,1,0,0,0,0,0,-1,0,-1
KR_6703493282,440,-2,-48,-16,-1,0,5,5,-5,8,3,1,7,8,3,1,4,0,1,1,0,1,-1,-1,-3,4,-2,0,-1,1,-1,-1,1,2,-1
KR_6562086306,420,0,22,-7,-1,-2,2,0,-4,5,1,-1,1,0,3,0,3,3,1,4,0,4,-68,1,-2,1,-19,0,0,1,-1,1,1,4,-1
KR_6760916035,420,-3,34,-4,-12,-1,4,3,-5,7,2,0,5,5,-7,8,1,1,2,3,0,-13,3,1,-1,0,0,0,0,-1,0,1,1,1,-1
KR_6679582929,420,-2,-82,-28,-5,-4,6,2,1,2,3,-3,3,0,0,0,0,1,0,1,0,3,-44,4,-7,3,13,0,0,-1,-1,-1,-1,2,-1
KR_6738542333,420,-1,-6,-18,-1,2,1,3,1,3,4,-3,4,1,-3,4,1,2,0,2,0,-8,-5,0,-3,3,0,0,-1,-1,-1,-1,1,1,-1
KR_6575614545,420,-1,-111,-16,-6,-3,4,1,1,0,1,-2,4,2,-2,2,0,0,1,1,-1,-4,-11,-2,0,2,-1,0,-1,-1,1,-1,-1,2,-1
KR_6736755549,420,1,-19,7,1,0,1,1,0,2,2,3,0,3,-1,1,0,-1,2,1,1,3,7,1,-2,1,2,0,0,-1,-1,0,1,3,-1
KR_6648715574,440,-4,-27,-5,-9,-5,7,2,-1,2,1,1,2,3,0,4,4,-4,4,0,-1,-13,-3,-3,-2,5,-1,0,-2,-1,-1,-1,-1,4,-1
KR_6682468746,420,-3,-57,-20,-12,1,1,2,3,5,8,-13,16,3,-1,4,3,-2,2,0,0,0,-27,0,-2,2,27,0,-2,0,-1,-1,-1,0,-1
KR_6725212731,420,-7,-153,-15,-16,-6,7,1,-1,2,1,-5,6,1,-2,2,0,-2,3,1,-3,-10,-4,1,-2,1,-2,0,-1,-1,-1,-1,-1,4,-1
KR_6694687439,440,-2,-15,0,-3,-2,2,0,-2,3,1,6,0,6,-6,7,1,1,1,2,2,-9,3,0,-3,3,-4,0,0,1,-1,0,1,4,-1
KR_6391559107,420,-2,-34,-7,-9,-1,1,0,2,0,2,-4,5,1,-4,6,2,-2,3,1,0,-14,196,-4,-1,5,0,0,-1,-1,-1,-1,-1,5,-1
KR_6710840604,420,-3,-39,-7,-9,1,1,2,-1,3,2,-6,6,0,-1,3,2,-2,2,0,0,-7,47,3,-8,5,-22,0,-1,-1,1,-1,-1,5,-1
KR_6375809168,420,-5,-71,-8,-11,0,3,3,-7,9,2,1,1,2,-1,2,1,-4,4,0,0,-8,0,0,0,0,-6,0,0,-1,0,0,1,3,-1
KR_6650028099,420,-5,-66,-22,-9,-2,2,0,-5,6,1,-1,2,1,0,3,3,-1,2,1,0,-6,-19,3,-3,0,2,0,-1,-1,0,-1,-1,1,-1
KR_6728010401,440,-6,-48,4,-11,-4,4,0,-2,2,0,-3,4,1,-2,3,1,0,2,2,0,-3,-3,1,-3,2,0,0,-1,0,0,-1,-1,0,-1
KR_6759192895,420,-2,4,2,-7,-6,7,1,-2,2,0,-2,3,1,2,2,4,1,1,2,-1,1,-4,-7,0,7,4,0,-1,1,-1,-1,-1,1,-1
KR_6638960175,420,5,56,-20,4,-3,4,1,4,5,9,5,1,6,0,1,1,-2,3,1,0,0,-5,1,-3,2,2,0,0,1,1,1,1,1,-1
KR_6744518862,420,-5,-56,-39,-15,-5,5,0,-2,6,4,-4,6,2,-4,6,2,0,3,3,-3,-14,-15,-3,-1,4,-3,0,-2,1,-1,-1,-1,3,-1
KR_6759824401,420,-5,-56,-8,-13,-1,1,0,-4,6,2,-3,4,1,-2,3,1,-3,3,0,0,-9,-381,1,-3,2,-2,0,0,-1,0,-1,-1,5,-1
KR_5581547937,420,-5,-29,10,-12,-5,5,0,2,1,3,2,0,2,-7,8,1,-4,6,2,-1,-11,-10,2,-7,5,-1,0,-2,-1,-1,-1,-1,4,-1
KR_6630738155,420,-1,-94,-8,-5,1,1,2,4,0,4,-6,8,2,-2,3,1,-2,3,1,0,2,2,2,-3,1,4,0,-1,-1,0,-1,1,6,-1
KR_6662454151,420,-6,-68,-2,-10,2,0,2,-4,5,1,1,2,3,-2,5,3,-7,7,0,0,-10,-3,-1,-5,6,1,0,-1,1,1,-1,-1,6,-1
KR_6756323724,440,0,9,-17,4,0,8,8,4,0,4,-3,3,0,5,0,5,-2,5,3,1,-10,-35,1,-1,0,-3,0,2,1,0,1,1,1,-1
KR_6301557080,420,0,-83,-8,-5,0,1,1,-3,3,0,-1,1,0,-1,4,3,0,2,2,0,-4,176,1,-3,2,0,0,0,1,1,1,1,6,-1
KR_6628982514,420,-3,-69,0,-5,-1,2,1,2,3,5,-2,2,0,0,1,1,-4,4,0,0,-5,-7,2,-6,4,-4,0,-1,-1,1,-1,-1,1,-1
KR_6760218592,420,0,21,-54,2,6,1,7,-3,3,0,-1,3,2,0,1,1,0,1,1,0,-8,283,-5,-1,6,3,0,1,-1,0,1,1,1,-1
KR_6667001675,420,-1,-60,-28,-5,-3,3,0,-1,3,2,0,4,4,-1,2,1,0,0,0,0,-6,6,-4,-2,6,0,0,0,-1,-1,1,-1,5,-1
KR_6045984098,420,-3,-37,-28,-2,-4,4,0,2,1,3,0,2,2,0,0,0,0,0,0,0,3,-7,-3,-2,5,1,0,0,-1,1,0,1,3,-1
KR_6696594500,420,0,-21,12,-3,0,2,2,-4,5,1,2,2,4,1,1,2,-2,3,1,-1,-1,7,-2,-4,6,0,0,-1,0,-1,-1,-1,0,-1
KR_6689112204,420,-3,-39,-19,-14,1,0,1,-4,4,0,-9,11,2,-3,5,2,1,0,1,0,-7,3,0,-5,5,0,0,-2,1,-1,-1,-1,6,-1
KR_6728420656,420,1,25,31,2,-1,4,3,2,1,3,1,1,2,0,2,2,0,0,0,0,0,-2,2,-2,0,1,0,0,1,-1,0,1,5,-1
KR_6683919083,420,-5,-89,-49,-16,-10,10,0,0,1,1,0,2,2,-3,3,0,-3,4,1,0,-3,-11,-4,-2,6,-3,0,0,-1,0,-1,-1,6,-1
KR_6729667574,420,-1,12,16,-5,-3,4,1,-1,3,2,-2,2,0,0,4,4,1,0,1,0,-4,-1,-2,-1,3,0,0,-1,1,-1,-1,-1,5,-1
KR_6626466992,420,-1,-46,-16,-3,1,2,3,-3,3,0,-2,2,0,0,1,1,1,0,1,0,-1,-1,-1,-3,4,-1,0,0,-1,-1,0,-1,4,-1
KR_6653097898,420,-5,-38,-10,-12,-3,3,0,-1,2,1,0,1,1,-1,1,0,-7,7,0,0,-11,-4,0,-6,6,-6,0,-2,-1,-1,-1,-1,1,-1
KR_6711233434,420,0,-4,-39,0,1,0,1,1,2,3,1,2,3,-3,5,2,0,0,0,0,-1,-25,-1,-4,5,-2,0,-1,1,-1,-1,1,2,-1
KR_6746663507,420,-1,54,16,-4,2,0,2,-4,6,2,-2,4,2,3,1,4,-3,4,1,0,-9,-10,-1,-4,5,-2,0,1,1,1,1,-1,6,-1
KR_6634709539,420,-4,-70,-40,-8,-4,5,1,-2,3,1,-1,1,0,-1,2,1,0,0,0,0,-1,-8,-5,-2,7,5,0,-1,1,-1,-1,-1,1,-1
KR_6714619475,420,0,-71,-8,-1,0,1,1,-3,5,2,0,2,2,1,2,3,1,0,1,0,1,-94,-3,-1,4,-1,0,-1,-1,1,-1,-1,1,-1
KR_6658774172,420,2,47,20,2,1,1,2,0,3,3,3,0,3,0,1,1,-2,2,0,1,2,-2,-3,-2,5,3,0,1,-1,1,1,1,1,-1
KR_6755948497,420,-3,-84,-4,-7,-1,2,1,-1,3,2,-5,6,1,0,0,0,0,1,1,0,-1,-7,1,-4,3,1,0,0,0,0,-1,-1,0,-1
KR_6755316079,420,2,-26,20,1,0,3,3,2,1,3,0,2,2,-2,4,2,1,1,2,0,0,-283,5,-8,3,-2,0,-1,1,0,1,1,4,-1
KR_6723540526,420,-1,29,29,-7,0,2,2,-2,4,2,2,2,4,-6,7,1,-1,1,0,0,-13,327,-2,-2,4,1,0,-1,1,-1,-1,1,6,-1
KR_6575406956,420,-1,-11,-15,-3,1,1,2,-1,3,2,-1,1,0,-1,2,1,-1,2,1,0,-5,25,-2,-2,4,-2,0,-1,1,-1,-1,-1,2,-1
KR_6244135115,420,-2,7,16,3,-2,2,0,5,1,6,2,3,5,-2,4,2,0,0,0,0,8,-10,4,-6,2,-4,0,0,1,-1,0,-1,2,-1
KR_6758400400,420,0,30,0,1,2,1,3,-3,3,0,1,4,5,4,0,4,-3,4,1,0,-6,-1,0,-4,4,-1,0,2,-1,1,1,1,4,-1
KR_6626232192,420,0,-46,-4,-1,-3,5,2,1,1,2,2,1,3,0,2,2,-1,1,0,0,-2,-6,-2,-2,4,0,0,1,-1,-1,1,1,1,-1
KR_6584179532,420,1,43,-32,4,-2,4,2,-3,3,0,2,2,4,5,1,6,2,0,2,0,11,5,-3,-2,5,-2,0,-1,0,0,-1,-1,0,-1
KR_6662154747,420,-4,-128,-12,-9,-3,3,0,0,3,3,-4,4,0,-3,5,2,1,0,1,0,-10,53,0,-3,3,-19,0,-1,1,-1,-1,-1,6,-1
KR_6762773165,420,-1,24,-12,1,0,0,0,-1,4,3,-1,4,3,4,2,6,-1,2,1,0,-2,7,1,-2,1,0,0,1,1,1,1,1,2,-1
KR_6735494471,420,-2,-35,-20,-7,0,0,0,-4,5,1,1,1,2,-3,4,1,-1,1,0,0,-10,0,1,-3,2,1,0,0,-1,1,0,-1,6,-1
KR_6632318970,420,-4,-49,-31,-7,-3,3,0,-1,4,3,-5,6,1,1,2,3,1,0,1,0,-1,-12,-3,0,3,2,0,0,-1,1,0,1,6,-1
KR_6753699692,440,4,29,3,1,3,2,5,-1,2,1,0,2,2,0,3,3,-1,2,1,0,-1,-5,-1,-1,2,4,0,1,1,-1,-1,1,1,-1
KR_6721222406,420,0,35,24,-7,-2,3,1,-6,8,2,-3,3,0,3,2,5,1,0,1,-1,-13,-7,-1,-4,5,-1,0,0,-1,1,0,-1,6,-1
KR_6730273732,420,0,79,11,-1,-2,2,0,1,3,4,-5,8,3,3,0,3,2,0,2,0,5,7,3,-5,2,3,0,0,1,-1,-1,1,2,-1
KR_6695132088,420,-2,-29,26,-6,0,2,2,-1,3,2,0,4,4,-3,4,1,-2,2,0,0,-8,-11,0,-2,2,0,0,-2,-1,-1,-1,-1,4,-1
KR_6759475403,420,0,-20,-12,3,3,1,4,1,1,2,4,0,4,-5,6,1,0,0,0,0,-1,-2,-5,0,5,1,0,2,1,1,1,1,6,-1
KR_6708748155,420,2,1,40,-2,-2,6,4,0,1,1,0,1,1,0,3,3,0,1,1,0,-1,-4,-3,0,3,2,0,0,-1,1,0,-1,5,-1
KR_6749984190,420,1,65,-2,4,6,1,7,-1,2,1,-1,3,2,0,1,1,0,3,3,0,-1,8,-1,-2,3,3,0,0,-1,1,1,1,3,-1
KR_6677248382,440,-1,-4,-24,-1,3,0,3,1,2,3,-2,5,3,-3,5,2,0,0,0,0,-6,-7,-3,-1,4,0,0,0,-1,1,0,1,2,-1
KR_6724822081,420,1,7,0,5,0,5,5,0,2,2,1,3,4,2,1,3,2,2,4,1,16,-1,0,-2,2,2,0,1,-1,1,1,1,1,-1
KR_6714706238,420,-1,-21,26,-6,-3,4,1,-3,4,1,2,1,3,-1,3,2,-1,1,0,-1,-14,181,5,-5,0,-1,0,-1,-1,1,-1,-1,1,-1
KR_6663444505,420,-1,-44,-1,0,-3,3,0,3,1,4,-2,4,2,2,0,2,0,1,1,0,3,128,-1,-1,2,1,0,0,-1,-1,0,-1,2,-1
KR_6678786120,420,0,18,2,2,4,1,5,-1,4,3,-2,5,3,-2,4,2,3,0,3,0,-5,-4,-2,-3,5,7,0,0,1,0,0,1,2,-1
KR_6596118238,420,2,17,-5,4,-2,2,0,3,0,3,2,0,2,3,3,6,-2,3,1,0,-1,-3,-2,-4,6,2,0,1,-1,1,1,-1,4,-1
KR_6720671016,420,0,-24,-16,0,-5,5,0,0,5,5,1,0,1,2,0,2,2,1,3,0,4,6,3,-5,2,2,0,1,-1,-1,1,-1,5,-1
KR_6754330340,420,0,-29,9,-3,-1,5,4,0,3,3,-2,9,7,-3,7,4,3,0,3,-2,-5,10,-1,-1,2,0,0,-1,-1,-1,-1,-1,2,-1
KR_6602372749,420,-4,-85,8,-4,-3,3,0,-3,3,0,4,1,5,-2,4,2,0,2,2,-1,-3,-276,-1,-2,3,-1,0,0,-1,-1,-1,-1,4,-1
KR_6673857814,440,-2,-60,1,-7,3,0,3,0,5,5,-5,6,1,-4,4,0,-1,2,1,0,-9,6,-6,0,6,-3,0,0,-1,-1,-1,-1,6,-1
KR_6731108445,420,-6,-72,-34,-10,-4,8,4,-2,3,1,-2,2,0,-6,6,0,4,0,4,2,-1,7,-4,-5,9,-1,0,-2,-1,-1,-1,1,6,-1
KR_6750129416,420,0,-19,16,5,-3,3,0,1,1,2,3,2,5,2,2,4,2,2,4,0,-2,235,-1,-1,2,1,0,-1,1,-1,-1,-1,1,-1
KR_6655330766,420,-2,-45,-24,-2,0,3,3,1,1,2,1,2,3,-4,4,0,0,2,2,0,-8,-28,4,-5,1,-3,0,0,-1,-1,0,-1,1,-1
KR_6746900598,420,-2,-20,-32,-14,-8,9,1,2,0,2,-2,5,3,-3,3,0,-3,3,0,0,-7,16,-2,-2,4,-14,0,-1,1,-1,-1,1,1,-1
KR_6756047336,420,0,53,-5,-3,-1,1,0,-3,4,1,0,2,2,0,2,2,1,0,1,0,-4,2,0,-1,1,0,0,2,-1,1,1,-1,2,-1
KR_6605500044,420,-1,40,-8,1,4,2,6,-4,5,1,-2,3,1,3,2,5,0,2,2,0,-1,-311,-2,-2,4,-3,0,1,-1,-1,1,1,6,-1
KR_6717378317,420,-2,-51,-32,-3,0,4,4,0,4,4,-9,10,1,4,1,5,2,0,2,1,3,4,0,-1,1,2,0,-2,-1,-1,-1,1,6,-1
KR_6445135091,420,1,-22,16,4,2,2,4,1,2,3,-4,6,2,4,2,6,1,0,1,0,8,4,-2,-3,5,-1,0,0,-1,-1,1,-1,3,-1
KR_6663291253,420,-3,-138,12,-1,0,2,2,2,2,4,-2,3,1,0,2,2,-1,1,0,0,3,2,1,-3,2,-4,0,-1,-1,1,-1,1,4,-1
KR_6676654710,420,-1,-65,-16,-6,2,1,3,-1,4,3,-3,3,0,-4,6,2,0,0,0,0,-5,-45,-2,-2,4,15,0,-1,-1,-1,-1,-1,2,-1
KR_6562208202,420,-4,18,-24,-11,0,1,1,-2,5,3,-3,4,1,-5,5,0,-1,2,1,0,-11,-338,-4,-2,6,3,0,-1,-1,0,-1,-1,6,-1
KR_6717339939,420,-2,-23,0,-9,-1,2,1,-1,1,0,-1,2,1,-5,7,2,-1,1,0,0,-10,-5,0,-3,3,-2,0,-1,-1,-1,-1,-1,3,-1
KR_6668395365,420,-4,-49,-9,-4,-1,2,1,-2,4,2,-2,4,2,2,0,2,-1,1,0,0,-3,194,0,-2,2,1,0,-1,-1,1,-1,-1,4,-1
KR_6731948371,440,-2,27,-12,-4,-1,2,1,-5,7,2,0,1,1,-3,5,2,5,0,5,1,-11,-7,-7,-4,11,-1,0,0,-1,-1,0,1,1,-1
KR_6742677969,420,-2,-51,0,-5,-4,4,0,3,1,4,0,2,2,-3,4,1,-1,2,1,0,-2,4,0,-3,3,-1,0,-1,1,-1,-1,1,6,-1
KR_6758356218,420,-1,45,36,-2,-1,1,0,2,2,4,0,4,4,-3,4,1,0,1,1,0,-9,0,0,-3,3,-2,0,1,1,1,1,-1,4,-1
KR_6716485991,420,-6,-75,-31,-11,0,1,1,-1,3,2,-5,6,1,-7,7,0,2,1,3,0,-5,4,2,-2,0,-1,0,-1,1,-1,-1,-1,3,-1
KR_6559390935,420,-8,-62,-52,-16,-2,3,1,-5,6,1,-8,8,0,-1,4,3,0,0,0,0,-10,-470,-1,-1,2,-3,0,-2,-1,-1,-1,-1,1,-1
KR_6608581704,420,-3,-23,-8,-5,-5,7,2,2,0,2,0,3,3,-2,4,2,0,1,1,0,-2,1,0,-2,2,5,0,-1,-1,1,-1,-1,5,-1
KR_6632754816,440,-3,-101,-20,-5,-5,6,1,2,2,4,-3,3,0,-1,3,2,2,1,3,0,-2,245,5,-5,0,-2,0,-3,-1,1,-1,1,5,-1
KR_6046365762,420,0,-10,-10,-1,2,1,3,3,0,3,-1,3,2,-2,2,0,-3,4,1,0,3,-1,-5,0,5,2,0,-1,0,0,-1,-1,0,-1
KR_6670444190,420,-3,-51,15,-8,-3,5,2,1,0,1,-3,4,1,-2,3,1,-1,1,0,0,-1,-10,-2,-1,3,0,0,-2,-1,-1,-1,-1,3,-1
KR_6637247868,420,-1,-19,-11,4,2,2,4,-1,2,1,1,3,4,-2,6,4,4,2,6,-1,-3,7,1,-2,1,-2,0,0,1,-1,1,-1,6,-1
KR_6727596700,420,-4,-132,-15,-5,-4,4,0,1,1,2,2,0,2,-5,6,1,1,6,7,0,0,-14,-4,-2,6,-1,0,0,-1,1,-1,-1,6,-1
KR_6762485742,440,-1,-67,-8,-4,-3,3,0,-2,2,0,4,5,9,-4,4,0,1,1,2,0,-9,-4,-2,-5,7,1,0,-1,0,0,-1,-1,0,-1
KR_6581466120,420,-2,-89,-36,-5,-5,6,1,0,4,4,5,1,6,-6,7,1,1,1,2,0,-1,-3,0,-2,2,0,0,-1,-1,0,-1,-1,1,-1
KR_6629432215,420,1,0,23,1,-3,5,2,6,0,6,-2,2,0,0,0,0,0,1,1,1,-3,0,0,-4,4,1,0,0,1,1,-1,1,4,-1
KR_6575094284,420,-4,-19,-11,-9,-2,2,0,0,2,2,-1,3,2,-3,3,0,-3,3,0,0,-8,-220,2,-4,2,-1,0,0,-1,0,0,-1,4,-1
KR_6762739675,420,-2,16,-24,4,-1,1,0,3,0,3,4,3,7,2,0,2,-4,5,1,1,8,5,6,-6,0,-1,0,2,1,1,1,1,4,-1
KR_6729617842,420,0,12,-25,0,-1,1,0,-1,4,3,1,0,1,1,1,2,0,0,0,-1,2,-14,1,-2,1,0,0,-1,-1,-1,-1,-1,3,-1
KR_6667109013,420,3,79,15,6,1,0,1,2,3,5,1,1,2,1,2,3,1,0,1,1,6,-14,2,-2,0,0,0,2,1,1,1,1,6,-1
KR_6587435736,420,-5,-112,4,-10,0,2,2,-3,5,2,-9,10,1,1,4,5,1,2,3,-1,1,6,-1,-2,3,0,0,-3,1,-1,-1,-1,6,-1
KR_6748978069,420,-2,-38,-17,-7,2,1,3,2,2,4,-4,8,4,-2,6,4,-5,5,0,0,-7,102,1,-4,3,2,0,-1,-1,1,-1,-1,6,-1
KR_6630504135,420,2,79,16,5,4,0,4,4,1,5,0,3,3,-3,3,0,0,0,0,0,-2,12,2,-4,2,-1,0,0,1,0,1,1,4,-1
KR_6760785241,420,-4,-82,-9,-14,-2,4,2,-1,3,2,-1,3,2,-10,10,0,0,1,1,1,-8,0,1,-7,6,2,0,0,-1,1,0,-1,2,-1
KR_6624978693,420,-3,-63,37,-5,-5,5,0,-2,5,3,5,1,6,-3,5,2,0,1,1,-1,-5,-3,-2,-1,3,-1,0,0,0,0,0,-1,0,-1
KR_6695801082,420,3,59,-16,5,1,2,3,3,0,3,2,2,4,0,5,5,-1,1,0,0,2,2,1,-5,4,-1,0,1,-1,-1,1,1,3,-1
KR_6750603505,440,-2,-34,-16,-7,2,1,3,-3,4,1,0,0,0,-9,11,2,3,0,3,0,-9,8,-1,-3,4,2,0,-1,-1,0,-1,1,3,-1
KR_6723508915,420,-4,-20,0,-6,-1,3,2,-2,2,0,-4,5,1,2,0,2,-1,1,0,-1,-3,2,1,-1,0,0,0,-1,0,1,-1,-1,0,-1
KR_6741320365,420,3,5,-27,5,-2,2,0,5,0,5,1,3,4,-1,3,2,2,1,3,0,9,-5,1,-5,4,4,0,0,-1,-1,0,-1,6,-1
KR_6677080132,440,-3,-53,-24,-9,0,1,1,-2,3,1,0,3,3,-5,5,0,-2,3,1,-2,-14,3,-5,-1,6,-3,0,0,-1,1,0,-1,1,-1
KR_6625115105,420,-5,-123,-3,-11,-3,4,1,0,3,3,-5,7,2,-3,4,1,0,1,1,0,-9,134,5,-8,3,-4,0,-2,-1,1,-1,-1,5,-1
KR_6528090370,420,-3,-77,2,2,0,1,1,3,2,5,-1,5,4,0,1,1,0,0,0,0,3,-1,0,-2,2,-2,0,0,0,1,0,-1,0,-1
KR_6660901329,440,0,-42,44,-5,-1,3,2,1,2,3,-5,5,0,1,4,5,-1,5,4,0,5,-417,-2,0,2,-1,0,0,-1,0,0,1,2,-1
KR_6463250656,420,-1,-88,42,-7,-2,2,0,-2,3,1,-2,4,2,-1,2,1,0,0,0,0,-2,0,-1,-4,5,0,0,-1,0,-1,-1,1,0,-1
KR_6654185841,420,-3,-11,12,-5,-2,3,1,1,2,3,-1,3,2,-2,2,0,-1,1,0,0,-4,-125,-3,0,3,-1,0,-1,-1,0,-1,1,6,-1
KR_6689698709,440,-3,-87,-16,-2,-1,1,0,-3,3,0,-1,2,1,-1,2,1,4,0,4,0,2,11,4,-6,2,1,0,0,-1,0,-1,-1,1,-1
KR_6726732916,420,0,-20,-20,3,2,1,3,2,2,4,1,2,3,-2,2,0,0,1,1,1,0,-124,3,-4,1,0,0,0,1,1,-1,1,4,-1
KR_6627531800,420,-3,-67,-28,-1,-3,3,0,0,5,5,5,2,7,-3,5,2,0,3,3,0,0,14,0,-1,1,-1,0,-2,1,0,-1,1,5,-1
KR_6764555634,420,2,-7,-7,9,0,0,0,0,1,1,0,2,2,4,4,8,5,1,6,0,8,24,0,-3,3,-24,0,0,0,0,1,1,0,-1
KR_6648271373,420,-3,-16,4,-8,-1,3,2,0,2,2,-3,5,2,-4,6,2,0,1,1,0,-6,-10,1,-2,1,-3,0,-2,0,0,-1,-1,0,-1
KR_6644075846,420,-1,-11,-9,-10,-3,4,1,3,2,5,0,2,2,-6,6,0,-4,5,1,0,-13,-14,-4,0,4,0,0,-1,-1,1,-1,-1,2,-1
KR_6693822005,420,-3,-67,4,-6,-2,2,0,2,3,5,-4,5,1,0,4,4,-2,2,0,3,-2,-291,2,-4,2,2,0,-2,1,-1,-1,1,4,-1
KR_6735393014,420,4,39,16,3,2,1,3,2,2,4,0,1,1,-2,4,2,1,0,1,0,-2,0,0,-4,4,-1,0,0,1,-1,0,1,6,-1
KR_6565921392,440,-2,11,-12,-4,3,1,4,2,2,4,-3,3,0,-1,4,3,-5,5,0,0,-9,-1,1,-2,1,1,0,0,-1,1,-1,1,2,-1
KR_6653700052,420,-2,10,-14,-6,-1,2,1,-6,6,0,-1,2,1,1,3,4,1,1,2,1,0,-6,4,-5,1,-3,0,0,-1,1,0,-1,4,-1
KR_6648602765,420,-3,-112,-18,-7,-3,3,0,0,2,2,-1,1,0,-3,3,0,0,0,0,0,-3,-2,-3,-1,4,-2,0,0,-1,-1,-1,-1,1,-1
KR_6741076050,420,-3,-63,34,-8,1,1,2,1,4,5,-8,8,0,-2,3,1,0,1,1,0,-12,-301,1,-2,1,35,0,-1,-1,-1,-1,-1,4,-1
KR_6751097303,440,-3,-99,-16,-7,-1,1,0,2,1,3,-1,2,1,-6,8,2,-1,1,0,0,-3,-9,-3,-2,5,2,0,-2,-1,-1,-1,-1,2,-1
KR_6642814513,420,2,61,0,-2,1,2,3,-5,5,0,-1,1,0,2,2,4,1,1,2,0,-10,-2,-1,-4,5,-4,0,0,0,1,0,1,0,-1
KR_6711630668,420,0,70,33,0,1,1,2,-3,4,1,2,0,2,1,2,3,-1,1,0,1,0,3,-1,-1,2,2,0,-2,1,-1,-1,1,5,-1
KR_6661564122,420,1,-47,15,6,1,2,3,0,3,3,0,3,3,0,0,0,5,3,8,0,4,3,-4,-3,7,-3,0,0,0,1,0,-1,0,-1
KR_6733436488,420,0,-27,8,3,-5,5,0,2,0,2,0,3,3,5,1,6,1,0,1,0,3,1,-1,-2,3,2,0,-1,1,-1,-1,-1,6,-1
KR_6380750318,420,-4,-40,12,-4,3,0,3,-3,6,3,-4,5,1,-1,1,0,1,0,1,0,-6,-3,-5,-2,7,3,0,-1,0,-1,-1,-1,0,-1
KR_6674245151,420,-4,-83,12,-6,-7,7,0,0,2,2,0,1,1,-1,2,1,2,0,2,0,2,26,-2,-1,3,2,0,-1,0,0,-1,-1,0,-1
KR_6757566455,420,0,13,-28,-2,-11,11,0,8,2,10,-2,5,3,2,2,4,1,0,1,-1,6,3,-3,-3,6,1,-1,-5,1,-1,-1,-1,3,-1
KR_6736071160,420,-1,-4,-73,-2,-2,4,2,0,2,2,-1,5,4,-1,2,1,2,0,2,0,-3,6,2,-6,4,-1,0,0,-1,-1,-1,1,3,-1
KR_6763743042,440,-1,44,-12,-6,1,1,2,2,0,2,-4,4,0,-3,4,1,-2,3,1,0,-5,-7,2,-6,4,-1,0,0,0,1,0,-1,0,-1
KR_6757609078,420,3,-1,16,4,-2,2,0,6,0,6,5,0,5,-4,6,2,-1,2,1,-1,2,140,3,-6,3,-1,0,-1,0,1,-1,-1,0,-1
KR_6748733996,420,-1,-37,20,-4,-5,7,2,-4,5,1,4,0,4,1,0,1,0,0,0,0,-4,-5,0,-2,2,2,0,0,1,-1,-1,-1,5,-1
KR_6712366118,420,-4,-14,-39,-6,-4,4,0,0,3,3,1,4,5,-2,5,3,-1,1,0,0,-6,6,3,-5,2,-1,0,0,-1,1,0,-1,2,-1
KR_6754478488,420,1,50,-8,-1,3,0,3,-3,7,4,0,2,2,-2,2,0,1,1,2,1,-4,7,-1,-2,3,-2,0,2,1,-1,1,1,3,-1
KR_6727694125,420,-2,-42,-11,-5,-4,4,0,1,2,3,0,3,3,0,6,6,-2,2,0,-2,-8,31,1,-4,3,-2,0,-1,0,-1,-1,-1,0,-1
KR_6621547409,420,-2,-75,4,-6,-1,3,2,-3,4,1,-1,6,5,-1,6,5,0,1,1,-1,-6,8,-3,-1,4,-1,0,0,-1,0,0,-1,2,-1
KR_6717150639,420,-3,-53,-17,6,-5,5,0,0,2,2,4,3,7,7,2,9,0,0,0,0,8,-5,3,-6,3,-1,0,-1,1,1,-1,-1,5,-1
KR_6647569799,440,4,16,12,6,3,1,4,0,1,1,2,1,3,-1,2,1,2,0,2,0,6,3,-1,-3,4,-1,0,0,1,-1,1,1,2,-1
KR_5847221730,420,-4,-31,4,-4,-1,2,1,2,2,4,-6,8,2,1,1,2,0,0,0,1,2,1,3,-4,1,0,0,0,-1,-1,0,1,4,-1
KR_6740260793,420,-7,-83,-20,-9,-2,2,0,-1,2,1,2,1,3,-6,7,1,-2,3,1,1,-7,-75,-2,-4,6,1,0,-2,-1,-1,-1,1,1,-1
KR_6592280212,420,-2,15,-16,-6,0,0,0,1,2,3,-5,8,3,-1,4,3,-1,2,1,1,-1,-44,-1,-3,4,-1,0,-1,-1,-1,-1,1,1,-1
KR_6753121534,420,-3,-22,-12,-8,1,1,2,-1,3,2,0,1,1,-7,8,1,-1,3,2,0,-10,-3,0,-5,5,-1,0,0,-1,1,0,-1,6,-1
KR_6673456411,420,-3,-54,-19,1,0,2,2,-5,8,3,4,3,7,0,2,2,2,0,2,1,2,-16,-1,-2,3,-5,0,-1,1,0,-1,1,4,-1
KR_6724606186,420,-8,-50,-36,-16,-1,2,1,-4,4,0,-3,5,2,-6,6,0,-2,2,0,0,-25,-413,-3,0,3,-24,0,-2,-1,-1,-1,1,6,-1
KR_6632290944,420,-2,-18,15,-8,-2,2,0,0,1,1,1,2,3,-6,6,0,-1,1,0,0,-18,6,0,-1,1,1,0,0,1,0,0,-1,6,-1
KR_6632663775,440,-2,2,17,-2,-2,3,1,2,2,4,1,0,1,-2,2,0,-1,2,1,0,-6,-7,-2,-1,3,-1,0,0,1,1,0,1,1,-1
KR_6607342570,420,-2,-114,-34,-3,1,0,1,-3,4,1,-2,3,1,0,1,1,1,0,1,-1,-5,2,4,-5,1,-1,0,0,0,1,0,-1,0,-1
KR_6733773044,420,-3,18,-23,-7,-4,4,0,1,1,2,-2,4,2,-4,4,0,2,0,2,0,-8,-20,0,-1,1,0,0,0,-1,-1,0,-1,5,-1
KR_6703871964,420,-5,-72,-17,-12,-6,6,0,1,2,3,2,2,4,-2,4,2,-7,8,1,0,-5,424,1,-3,2,-3,0,-2,1,0,-1,-1,1,-1
KR_6751302146,420,-1,-20,-36,-7,2,0,2,-7,10,3,-2,3,1,-1,3,2,1,0,1,0,5,4,1,-4,3,1,0,0,0,-1,0,-1,0,-1
KR_6649580950,440,-3,-79,-4,-8,-3,3,0,-1,2,1,-1,2,1,-4,5,1,1,0,1,-1,-4,6,-1,-4,5,-9,0,-2,0,-1,-1,-1,0,-1
KR_6653236879,440,3,-51,23,-1,1,0,1,-2,5,3,0,3,3,0,3,3,0,0,0,-2,4,-71,4,-5,1,-3,0,0,0,1,0,-1,0,-1
KR_6609663461,420,-3,-131,-16,-8,-6,6,0,-1,2,1,-5,6,1,1,2,3,3,2,5,0,-1,-302,-2,-3,5,3,0,-1,1,-1,-1,-1,5,-1
KR_6692002741,440,-2,-72,28,-7,-5,5,0,1,0,1,-5,6,1,2,1,3,0,0,0,0,-1,3,-2,-2,4,0,0,0,0,1,0,1,0,-1
KR_6602001207,420,-1,-9,-8,-1,0,2,2,-4,4,0,-2,3,1,6,0,6,-1,2,1,0,2,1,-1,-1,2,2,0,1,-1,-1,1,-1,6,-1
KR_6683965118,420,-2,-9,-28,-4,-1,2,1,-4,7,3,-3,3,0,3,1,4,1,0,1,0,3,-1,1,-2,1,0,0,0,0,0,0,1,0,-1
KR_6758458949,420,-2,-76,25,-2,-2,3,1,1,2,3,0,0,0,0,0,0,-1,1,0,0,-6,-76,-1,-2,3,-2,0,-2,-1,1,-1,1,5,-1
KR_6757376434,420,-2,18,16,-5,-3,4,1,-1,3,2,2,3,5,-3,4,1,0,1,1,0,-2,8,1,-3,2,-3,0,-1,0,0,-1,-1,0,-1
KR_6661731314,420,-1,-10,12,-4,0,3,3,2,1,3,1,2,3,-6,6,0,-1,2,1,0,-7,7,-1,-2,3,-3,0,0,-1,-1,-1,1,5,-1
KR_6750421036,440,-2,9,-8,4,1,3,4,2,2,4,0,0,0,2,2,4,-1,1,0,0,6,-4,1,-5,4,0,0,1,0,-1,1,1,0,-1
KR_6716424823,440,3,52,-16,12,0,2,2,0,4,4,4,3,7,5,0,5,3,1,4,0,7,10,3,-5,2,4,0,0,0,-1,0,1,0,-1
KR_6473094711,420,-8,-24,-20,-16,-5,8,3,-2,3,1,-3,4,1,1,4,5,-7,8,1,0,-11,6,2,-3,1,-7,0,-1,-1,-1,-1,1,4,-1
KR_6727207730,420,-2,-87,1,-16,-1,3,2,-4,5,1,-2,3,1,-8,9,1,-1,1,0,-1,-19,-5,-3,-2,5,-3,0,1,-1,1,-1,-1,6,-1
KR_6725783355,420,-2,-42,-24,-5,1,1,2,-3,5,2,-3,4,1,-1,2,1,1,3,4,1,-1,-9,2,-5,3,3,0,0,0,0,0,1,0,-1
KR_6733181808,420,-2,-18,-31,-1,1,2,3,-3,4,1,-1,4,3,3,0,3,-1,2,1,0,-7,11,0,-2,2,-1,0,0,0,-1,0,1,0,-1
KR_6650012664,420,-7,-66,0,-11,-5,6,1,0,1,1,2,2,4,-2,3,1,-6,6,0,0,-6,-4,-3,0,3,0,0,-3,1,-1,-1,-1,1,-1
KR_6603465461,420,-4,-107,-51,-10,-4,5,1,-4,5,1,-1,1,0,-2,2,0,1,0,1,-1,-9,-5,-1,-2,3,-1,0,-2,-1,-1,-1,-1,6,-1
KR_6650413999,420,-5,26,-88,-12,-1,2,1,-3,5,2,-2,5,3,-3,4,1,-3,3,0,0,-10,-7,-5,-1,6,-3,0,-2,0,-1,-1,-1,0,-1
KR_6596220522,420,0,12,-31,-1,0,1,1,-6,8,2,1,0,1,2,3,5,2,0,2,0,4,11,5,-7,2,1,0,-1,-1,-1,-1,1,4,-1
KR_6621270753,420,-3,-5,-44,-10,1,2,3,-3,5,2,-1,2,1,-2,4,2,-5,5,0,0,-10,6,-3,-2,5,-1,0,-1,-1,1,-1,-1,5,-1
KR_6749103726,420,1,-5,-3,3,3,0,3,-1,2,1,3,0,3,-2,2,0,0,2,2,0,2,-9,-1,-4,5,2,0,2,-1,1,-1,-1,2,-1
KR_6691769611,420,-2,-36,-20,-10,-4,4,0,0,3,3,-7,7,0,1,1,2,0,0,0,0,-5,3,3,-3,0,2,0,0,1,1,-1,-1,2,-1
KR_6756136423,420,-1,-1,-24,-3,-3,4,1,-3,3,0,1,0,1,2,2,4,0,1,1,0,-6,-48,0,-5,5,-7,0,1,1,1,1,1,3,-1
KR_6760094540,420,2,46,4,10,-3,4,1,4,3,7,4,1,5,6,1,7,-1,3,2,2,13,9,6,-7,1,-3,0,1,0,0,1,1,0,-1
KR_6732007913,420,-2,21,-24,-1,1,0,1,-5,7,2,0,0,0,0,2,2,3,1,4,0,-2,-3,-4,-1,5,5,0,1,1,1,1,1,3,-1
KR_6748276785,440,-1,19,-20,-7,0,1,1,-3,4,1,0,1,1,0,5,5,-4,4,0,0,-12,-1,0,-2,2,-3,0,-2,0,-1,-1,1,0,-1
KR_6649627248,420,-3,-120,24,-4,-6,6,0,4,1,5,-1,1,0,1,0,1,-2,3,1,0,-4,-1,2,-4,2,-2,0,-1,0,-1,-1,-1,0,-1
KR_6361641258,420,-3,-47,-34,-10,-1,2,1,-3,3,0,-2,4,2,-3,4,1,-1,1,0,-1,-13,0,0,0,0,3,0,-2,0,-1,-1,-1,0,-1
KR_6744918623,420,-3,-8,-36,-8,-4,5,1,0,2,2,-1,1,0,-3,8,5,0,0,0,0,-4,0,-3,-1,4,1,0,-3,-1,-1,-1,-1,6,-1
KR_6755249375,440,-2,-32,-3,5,1,0,1,-2,2,0,1,0,1,5,2,7,0,0,0,-1,2,-1,-3,-2,5,-1,0,0,1,-1,0,-1,3,-1
KR_6761695670,420,-2,-78,-20,-7,3,1,4,-3,7,4,-1,4,3,-7,8,1,1,0,1,0,-7,2,-2,-3,5,0,0,-1,-1,0,-1,-1,4,-1
KR_6702291158,420,3,34,-18,13,5,0,5,3,0,3,1,2,3,2,0,2,2,2,4,0,15,13,-3,-2,5,0,0,1,-1,-1,1,1,1,-1
KR_6762115062,420,-1,-34,-11,-1,-4,4,0,3,1,4,1,3,4,-2,11,9,1,0,1,1,4,11,0,-1,1,0,0,1,0,0,1,1,0,-1
KR_6740179990,420,-4,-43,1,-9,0,2,2,-2,4,2,-4,6,2,-5,6,1,2,1,3,0,-9,-2,2,-3,1,-4,0,0,-1,1,0,1,6,-1
KR_6625185986,420,-5,-82,-16,-8,2,0,2,-6,7,1,-6,7,1,1,0,1,1,0,1,0,-7,-7,1,-4,3,1,-1,-4,-1,-1,-1,-1,4,-1
KR_6601514054,420,-4,-27,-24,-8,-3,3,0,-1,1,0,2,0,2,-7,8,1,1,1,2,0,-7,-8,2,-4,2,0,0,0,-1,-1,-1,-1,6,-1
KR_6637075302,420,-4,-85,-4,-10,1,1,2,-7,8,1,2,3,5,-4,5,1,-2,2,0,-1,-9,-22,3,-3,0,-1,0,-2,-1,1,-1,-1,1,-1
KR_6740569199,420,1,23,-10,2,2,0,2,3,3,6,-9,9,0,4,0,4,2,1,3,0,7,246,1,-3,2,3,0,1,0,-1,1,1,0,-1
KR_6673531160,420,0,-13,8,0,1,0,1,-2,6,4,0,3,3,1,2,3,0,1,1,-1,-9,-2,2,-5,3,-4,0,0,1,-1,0,-1,5,-1
KR_6761439470,420,-4,-51,3,-12,3,2,5,-2,2,0,-2,7,5,-8,8,0,-3,3,0,0,-15,0,1,-4,3,-1,0,-1,-1,0,-1,-1,6,-1
KR_6693262263,420,1,-23,16,2,5,0,5,-5,6,1,1,0,1,-1,1,0,2,0,2,0,-1,22,1,-3,2,0,0,1,0,1,1,1,0,-1
KR_6661809647,420,-5,-80,-24,-2,0,0,0,0,1,1,0,3,3,-2,2,0,0,1,1,0,-5,-124,0,-2,2,-2,0,0,-1,1,0,-1,4,-1
KR_6742608822,420,4,24,3,4,0,1,1,0,2,2,-2,5,3,0,3,3,6,0,6,0,8,-42,0,-3,3,17,0,0,-1,-1,0,-1,3,-1
KR_6494974210,420,1,0,32,2,-1,4,3,0,1,1,0,3,3,2,0,2,1,3,4,0,-3,12,-1,-5,6,1,0,0,1,0,-1,1,5,-1
KR_6730207186,420,-2,-53,35,-5,-2,4,2,-1,4,3,0,2,2,-2,2,0,0,1,1,0,-10,-126,3,-5,2,-4,0,-2,-1,-1,-1,-1,5,-1
KR_6620244406,420,2,9,24,2,-1,3,2,4,1,5,-1,4,3,1,1,2,-1,1,0,0,3,26,-1,-3,4,-1,0,0,-1,1,1,1,2,-1
KR_6634394743,420,0,-1,9,-5,-4,4,0,2,1,3,-1,3,2,-2,2,0,0,0,0,0,-2,29,4,-5,1,3,0,0,-1,1,0,-1,2,-1
KR_6618933632,420,-5,-37,-15,-10,-3,3,0,-1,2,1,2,0,2,-2,2,0,-6,10,4,0,-9,3,-3,-1,4,-1,0,-1,-1,1,-1,1,1,-1
KR_6753630077,440,0,-11,-21,1,2,0,2,-3,4,1,-3,5,2,7,1,8,-2,3,1,0,2,19,-4,-1,5,-24,0,0,1,0,1,-1,4,-1
KR_6757295193,420,0,28,-4,-1,3,1,4,6,1,7,-4,6,2,-6,6,0,0,1,1,0,3,6,6,-7,1,-3,0,0,-1,0,-1,-1,5,-1
KR_6709764920,420,-1,-4,-15,-4,0,1,1,-3,6,3,0,1,1,-1,2,1,0,0,0,0,-5,7,2,-3,1,-4,0,0,1,0,0,-1,6,-1
KR_6623129714,440,1,30,-7,-2,1,3,4,-3,4,1,2,0,2,-3,5,2,1,0,1,0,2,8,-1,-3,4,4,0,0,-1,-1,0,-1,1,-1
KR_6762493834,440,-2,0,-51,0,3,1,4,-6,9,3,3,1,4,-2,2,0,2,0,2,0,-5,-37,2,-5,3,3,0,0,-1,-1,0,1,2,-1
KR_6642771718,420,-1,-8,-21,3,-2,3,1,-1,1,0,7,0,7,-3,5,2,2,1,3,-1,6,-11,2,-5,3,1,0,-1,-1,0,-1,-1,6,-1
KR_6683130978,420,-1,47,4,-2,1,2,3,0,2,2,2,3,5,1,2,3,-6,7,1,0,-3,0,1,-3,2,1,0,1,1,-1,1,1,3,-1
KR_6720324978,440,-6,-40,-50,-6,1,2,3,-5,5,0,1,3,4,-1,2,1,-2,3,1,0,2,197,4,-5,1,3,0,-1,0,-1,-1,1,0,-1
KR_6760526430,420,0,-59,8,-3,4,0,4,1,3,4,-2,4,2,-6,7,1,0,0,0,0,-5,5,-1,-4,5,-6,0,-1,1,1,-1,1,1,-1
KR_6749091669,420,-4,-17,0,-2,5,0,5,-1,4,3,-7,8,1,1,2,3,0,2,2,0,4,-49,3,-5,2,18,0,0,-1,1,0,1,6,-1
KR_6538058220,420,1,-25,0,0,-2,3,1,-1,2,1,2,1,3,1,1,2,0,0,0,0,2,-85,-6,0,6,-1,0,-1,-1,0,-1,1,1,-1
KR_6605347419,420,-2,-63,44,-7,-3,3,0,2,2,4,4,0,4,-10,11,1,0,3,3,-2,-9,-3,-1,-1,2,-1,0,-2,0,1,-1,-1,0,-1
KR_6748960596,420,-1,-24,19,1,-2,2,0,-3,6,3,4,2,6,2,0,2,0,0,0,0,2,4,-1,-2,3,-1,0,0,1,0,0,-1,2,-1
KR_6737537218,420,-3,-67,-28,-2,-2,3,1,5,0,5,-1,4,3,-1,2,1,-3,3,0,0,7,3,1,-4,3,-4,0,0,-1,1,0,1,5,-1
KR_6760785889,420,-9,-75,-124,-24,-1,1,0,1,2,3,-13,13,0,-10,12,2,-1,2,1,0,-21,-1,-2,-1,3,1,0,-1,0,-1,1,-1,0,-1
KR_6733293087,420,4,50,8,15,3,1,4,-1,2,1,8,0,8,2,8,10,3,0,3,4,1,-6,8,-8,0,-4,0,3,1,1,1,1,1,-1
KR_6669592860,420,1,-69,4,1,1,0,1,3,3,6,0,1,1,-3,4,1,0,1,1,0,-2,0,3,-4,1,-2,0,0,-1,1,0,-1,2,-1
KR_6518411247,420,-2,-60,-9,-7,-4,5,1,1,2,3,-6,9,3,3,4,7,-1,1,0,0,-4,-19,-4,0,4,1,0,0,1,-1,-1,1,6,-1
KR_6734514855,420,0,-58,13,1,1,3,4,3,1,4,-3,6,3,1,2,3,-1,1,0,0,7,-9,-2,-4,6,-2,0,2,-1,1,1,-1,4,-1
KR_6676601748,420,0,-14,9,-6,-2,2,0,0,1,1,2,1,3,-3,6,3,-3,4,1,0,-8,36,-4,-3,7,-19,0,-2,-1,-1,-1,-1,1,-1
KR_6755188978,420,-3,-1,-52,0,1,1,2,-7,7,0,6,1,7,-1,2,1,1,0,1,0,-4,6,5,-7,2,-5,0,0,-1,1,-1,1,4,-1
KR_6717772714,440,-5,-49,1,-6,-3,7,4,-4,9,5,0,2,2,-1,1,0,2,0,2,4,0,3,-1,0,1,0,0,-2,0,-1,-1,1,0,-1
KR_6727200040,440,-2,76,-32,-6,0,3,3,-2,2,0,-6,8,2,2,1,3,0,2,2,-1,-7,45,0,-1,1,-4,0,-1,-1,-1,-1,-1,5,-1
KR_6325441830,420,2,-26,-5,-1,-1,1,0,3,2,5,-2,6,4,0,2,2,-1,2,1,0,-3,-6,0,-2,2,1,0,-1,0,0,-1,-1,0,-1
KR_6762695978,420,-4,-64,-4,-10,0,2,2,-8,8,0,-3,3,0,1,2,3,0,2,2,-1,-12,-11,-2,-2,4,0,0,-1,1,0,-1,-1,2,-1
KR_6724675199,440,-6,-54,-31,-11,-5,9,4,3,0,3,-10,10,0,1,1,2,0,0,0,-1,-4,-13,-1,-3,4,0,0,-1,0,0,-1,-1,0,-1
KR_6529790740,420,1,12,-8,-6,1,2,3,-5,6,1,0,2,2,-3,5,2,1,1,2,0,-9,13,-2,-3,5,-3,0,0,-1,-1,1,-1,3,-1
KR_6655661058,440,-1,18,4,-5,-1,1,0,2,0,2,-4,4,0,-1,2,1,-1,2,1,0,-3,-10,-4,-6,10,-3,0,1,-1,1,1,-1,3,-1
KR_6737486634,420,-2,-33,8,-5,-2,2,0,-1,2,1,1,4,5,-3,3,0,0,0,0,1,4,205,0,-3,3,2,0,0,1,-1,0,1,5,-1
KR_6712028459,420,-5,-66,4,-8,-7,7,0,-2,4,2,0,1,1,1,6,7,0,1,1,0,-2,8,5,-6,1,3,0,0,1,-1,-1,-1,1,-1
KR_6601854148,420,-5,-132,-36,-7,-8,9,1,3,0,3,-1,2,1,-1,2,1,0,0,0,0,-1,-192,-2,-1,3,2,0,-1,-1,-1,-1,-1,1,-1
KR_5608817885,420,-3,-34,-4,-11,-2,4,2,-1,3,2,-5,6,1,-2,2,0,-1,1,0,0,-10,-163,-4,-5,9,5,0,0,-1,0,-1,-1,1,-1
KR_6619814780,420,-2,-10,-16,-10,1,1,2,0,1,1,3,0,3,-8,10,2,-6,6,0,-1,-12,-8,-2,-3,5,-1,0,-1,-1,1,-1,-1,3,-1
KR_6717482335,420,1,-57,13,3,-2,3,1,-2,4,2,3,0,3,4,1,5,0,0,0,0,3,-6,-5,0,5,1,0,0,-1,1,0,1,3,-1
KR_6707875020,420,-6,-40,-25,-16,3,0,3,-1,3,2,-5,5,0,-12,12,0,-1,3,2,0,-17,1,3,-6,3,-2,0,-1,-1,-1,-1,-1,2,-1
KR_6619919260,420,1,38,-8,4,1,2,3,2,0,2,-3,3,0,4,0,4,0,3,3,0,1,-5,0,-2,2,-3,0,1,1,0,1,1,4,-1
KR_6683057942,420,-5,-40,-28,-12,-2,4,2,-3,5,2,-4,8,4,-1,2,1,-2,3,1,0,-11,8,-5,-1,6,0,0,0,-1,1,-1,-1,4,-1
KR_6756376141,420,-5,-67,5,-1,1,0,1,-1,3,2,-1,2,1,-1,1,0,1,2,3,-2,-4,16,2,-2,0,-25,0,-2,-1,1,-1,-1,6,-1
KR_6761509720,420,-6,-108,-29,-22,-5,6,1,-3,5,2,-5,6,1,-4,6,2,-5,5,0,0,-12,-7,-1,-1,2,-1,0,-1,-1,0,-1,-1,3,-1
KR_6710510859,420,-4,-86,15,-10,0,2,2,-3,5,2,2,1,3,-11,12,1,2,0,2,-2,-8,-9,-2,-3,5,3,0,-1,-1,1,-1,-1,1,-1
KR_6756060741,420,-2,-62,-95,-2,4,1,5,-1,1,0,1,2,3,-5,6,1,-1,2,1,0,-6,-6,-3,-2,5,0,0,-1,-1,0,-1,-1,1,-1
KR_6740173849,420,-5,-68,-25,-12,-3,3,0,-5,5,0,-3,7,4,-1,2,1,0,1,1,-1,-13,-33,-3,-1,4,1,0,-1,-1,-1,-1,-1,5,-1
KR_6739463226,420,-2,16,0,-8,-2,3,1,-1,1,0,2,1,3,-6,6,0,-1,1,0,0,-10,-10,-3,-1,4,4,0,-2,-1,1,-1,-1,2,-1
KR_6628307426,420,3,31,36,2,2,0,2,-3,4,1,-2,3,1,5,1,6,0,0,0,0,-3,-35,3,-4,1,18,0,0,1,-1,0,1,1,-1
KR_6761084573,420,-2,-14,5,3,-1,3,2,-2,3,1,1,1,2,1,3,4,4,1,5,0,4,5,4,-6,2,-7,0,0,0,1,0,1,0,-1
KR_6750382110,420,-5,-40,18,-9,-2,2,0,-1,2,1,-4,4,0,-2,3,1,0,0,0,0,-5,7,0,-2,2,0,0,-1,-1,-1,-1,-1,2,-1
KR_6731177894,420,-2,-54,-19,-1,-4,5,1,1,4,5,-4,6,2,3,0,3,3,0,3,0,4,-8,-1,-2,3,-2,0,0,0,1,-1,1,0,-1
KR_6731626856,420,0,-35,-26,-6,1,1,2,-5,6,1,1,2,3,-3,4,1,0,0,0,0,-8,-15,-3,0,3,1,0,-1,-1,0,-1,-1,1,-1
KR_6721270462,420,-1,-55,-8,-7,5,0,5,-4,5,1,-3,5,2,-4,5,1,-1,2,1,-1,-9,1,-1,-1,2,-2,0,-2,-1,0,-1,-1,3,-1
KR_6747478990,420,-1,-19,4,-1,-2,2,0,4,0,4,2,3,5,-5,7,2,0,1,1,0,-7,-11,2,-5,3,6,0,-1,1,-1,-1,1,5,-1
KR_6494021393,420,2,-42,8,1,0,1,1,5,0,5,-1,2,1,-4,5,1,1,0,1,1,3,-20,-1,-2,3,1,0,0,-1,1,0,1,2,-1
KR_6757438991,420,-6,-126,-27,-13,0,0,0,-3,3,0,-8,8,0,-2,3,1,0,0,0,0,-3,-27,-2,-1,3,-1,0,-2,0,-1,-1,-1,0,-1
KR_6683158775,440,-4,-16,-16,-11,-4,5,1,-3,3,0,-5,5,0,2,2,4,-1,1,0,0,-8,-8,1,-2,1,-1,0,-1,-1,-1,-1,1,2,-1
KR_6761994402,420,-4,-96,-64,-8,-6,7,1,-2,4,2,-1,3,2,-1,1,0,2,1,3,-1,-9,-5,1,-3,2,-1,0,-2,-1,-1,-1,-1,5,-1
KR_6721931559,420,-2,-53,-9,-7,-2,2,0,0,2,2,-3,4,1,-3,5,2,1,0,1,0,-8,-18,-8,-4,12,-4,0,1,-1,1,1,-1,1,-1
KR_6483669743,420,-1,-49,-8,-10,-8,8,0,-2,4,2,-3,4,1,2,1,3,1,1,2,-1,-6,-6,-3,0,3,0,0,-1,-1,-1,-1,-1,2,-1
KR_6660676606,420,2,-18,4,9,2,1,3,-1,2,1,2,0,2,4,2,6,2,0,2,1,19,0,7,-9,2,-3,0,0,1,1,0,1,3,-1
KR_6581426837,420,1,18,0,-5,0,1,1,-3,4,1,2,2,4,-6,6,0,2,0,2,-1,-6,-1,1,-2,1,0,0,1,-1,0,1,-1,3,-1
KR_6729289682,420,-2,13,-23,-7,1,0,1,-2,4,2,0,2,2,-3,6,3,-3,3,0,0,-8,9,1,-2,1,-1,0,0,1,-1,0,1,6,-1
KR_6639393237,420,2,40,-4,1,0,2,2,-2,5,3,1,2,3,2,0,2,0,1,1,0,1,5,5,-5,0,0,0,1,0,1,1,1,0,-1
KR_6706123613,420,0,31,14,-8,-2,3,1,-2,2,0,-3,6,3,1,3,4,-2,3,1,0,-6,2,-1,-2,3,5,0,0,-1,1,0,-1,1,-1
KR_6725780262,440,-1,24,-12,2,8,1,9,-2,3,1,-3,3,0,0,0,0,-1,1,0,0,-8,-9,-1,-1,2,-2,0,0,-1,-1,0,-1,4,-1
KR_6697191866,420,-3,-64,12,-5,-5,5,0,-1,1,0,2,3,5,-1,1,0,0,0,0,0,0,39,2,-2,0,-23,0,-3,1,1,-1,1,5,-1
KR_6439798381,420,1,-33,-14,4,0,2,2,0,4,4,3,1,4,1,3,4,0,0,0,0,4,2,3,-6,3,-2,0,1,0,-1,1,1,0,-1
KR_6738346108,420,-1,13,24,1,5,0,5,-3,5,2,-2,2,0,1,2,3,0,0,0,0,0,10,3,-7,4,0,0,-1,1,-1,-1,-1,6,-1
KR_6752147880,420,-2,36,-27,-3,-3,4,1,-1,1,0,1,0,1,1,1,2,-1,1,0,0,0,-1,-2,-1,3,-2,0,0,-1,-1,1,-1,3,-1
KR_6618520749,420,-1,-46,4,-2,1,0,1,2,2,4,-2,3,1,-2,5,3,-1,1,0,0,0,8,3,-6,3,-3,0,-1,-1,1,1,-1,4,-1
KR_6752651189,440,-2,42,-12,-3,1,0,1,-1,2,1,1,7,8,-3,3,0,-1,2,1,0,-1,102,6,-7,1,-6,0,2,-1,1,1,-1,1,-1
KR_6757156365,420,-3,-46,4,-5,0,2,2,0,3,3,2,1,3,-5,7,2,-2,3,1,0,-10,-19,-4,-1,5,2,0,-1,0,-1,-1,1,0,-1
KR_6760900562,440,-3,-58,-28,0,1,1,2,0,2,2,0,1,1,0,1,1,-1,2,1,0,1,262,-5,-2,7,-37,0,0,-1,0,0,1,6,-1
KR_6749038905,420,1,2,9,6,0,0,0,3,0,3,4,3,7,1,2,3,-2,7,5,0,1,-15,1,-2,1,5,0,0,0,1,0,-1,0,-1
KR_6760870656,420,-2,-55,24,-3,-1,3,2,-1,5,4,0,2,2,-2,5,3,1,1,2,0,2,-8,2,-4,2,0,0,-1,-1,-1,-1,1,2,-1
KR_6632266445,420,1,18,-32,4,2,2,4,-1,3,2,-1,5,4,4,6,10,0,1,1,0,9,-2,0,-2,2,2,0,0,-1,-1,1,1,5,-1
KR_6759159802,420,-3,-61,19,-1,-2,4,2,1,1,2,1,2,3,0,1,1,-1,1,0,1,-4,-20,0,0,0,0,0,0,1,-1,-1,1,6,-1
KR_6723700228,420,-3,-6,0,-2,4,0,4,1,4,5,-8,8,0,1,1,2,0,2,2,0,-7,-5,-8,-2,10,1,0,-1,-1,1,1,1,5,-1
KR_6493094399,420,-4,-35,-27,-8,-2,4,2,0,2,2,-2,3,1,-3,3,0,-1,1,0,-1,-8,197,-1,-3,4,-1,0,0,-1,1,0,1,6,-1
KR_6668638245,440,-2,-11,20,-11,-2,2,0,-2,5,3,-3,3,0,-3,4,1,-1,2,1,0,-17,14,2,-6,4,-4,0,0,-1,-1,0,-1,6,-1
KR_6746864531,420,0,-33,44,-5,3,0,3,1,1,2,-10,11,1,2,0,2,-1,3,2,0,-3,-114,-1,-3,4,2,0,1,1,1,-1,-1,3,-1
KR_6656073027,420,1,32,-28,-2,0,0,0,-2,3,1,-2,2,0,0,2,2,2,1,3,-1,-5,3,0,-2,2,1,0,-1,-1,-1,-1,-1,4,-1
KR_6672781464,420,-4,-29,4,-7,-3,3,0,1,3,4,1,4,5,-6,6,0,0,5,5,0,-8,-14,0,-4,4,3,0,-2,-1,-1,-1,1,1,-1
KR_6733477538,420,1,6,32,-2,3,2,5,-4,6,2,-5,5,0,0,4,4,4,0,4,1,-4,6,1,-4,3,-2,0,0,1,-1,-1,1,4,-1
KR_6561576441,420,-2,-30,-12,-9,-3,5,2,0,4,4,1,2,3,-9,9,0,2,0,2,-2,-11,-8,-1,-2,3,-2,0,-2,-1,-1,-1,-1,5,-1
KR_6759351705,420,-4,-87,52,-15,-2,3,1,0,1,1,-7,7,0,-5,5,0,-1,1,0,-1,-8,-2,1,-2,1,-2,0,-2,-1,-1,-1,-1,5,-1
KR_6531019873,420,-4,-29,16,-6,-4,5,1,-3,5,2,7,1,8,-4,5,1,-2,3,1,0,-11,1,-1,-3,4,-1,0,-1,-1,1,-1,1,2,-1
KR_6483593568,420,-2,-74,28,-2,0,0,0,1,3,4,1,2,3,-4,4,0,0,0,0,0,-5,99,0,0,0,0,0,-2,-1,1,-1,1,4,-1
KR_6729869912,420,1,-49,-31,5,2,1,3,2,1,3,1,4,5,-1,2,1,1,2,3,0,14,-1,1,-5,4,1,0,-1,1,1,-1,1,5,-1
KR_6669814602,420,1,44,7,-5,2,3,5,-3,5,2,1,2,3,-4,5,1,-1,2,1,0,-10,12,-3,-1,4,-4,0,1,-1,1,1,1,6,-1
KR_6668621909,420,-1,-16,-11,6,4,0,4,6,1,7,1,2,3,-4,5,1,-1,1,0,0,8,23,1,-4,3,-11,0,0,1,-1,-1,-1,6,-1
KR_6739281097,420,-2,87,-28,1,4,0,4,-5,7,2,-2,5,3,3,2,5,1,0,1,0,3,3,3,-4,1,0,0,1,-1,1,1,-1,1,-1
KR_6688115198,420,3,76,14,3,3,0,3,4,0,4,-3,5,2,3,3,6,-4,4,0,0,3,11,8,-8,0,-1,0,-1,-1,-1,-1,1,4,-1
KR_6084904076,420,-12,-52,-99,-11,1,1,2,-10,10,0,-2,2,0,-1,3,2,1,1,2,0,-7,5,-3,-2,5,0,0,-1,-1,-1,-1,-1,1,-1
KR_6753005219,420,-1,19,4,-3,2,1,3,-1,4,3,2,1,3,-7,7,0,1,0,1,0,-4,-12,-5,0,5,2,0,1,-1,-1,1,-1,1,-1
KR_6760908972,420,2,72,-4,2,3,1,4,0,1,1,3,0,3,-5,8,3,1,0,1,0,-5,-3,-1,0,1,2,0,0,1,-1,-1,-1,1,-1
KR_6691736547,420,-6,-121,-32,-13,-3,3,0,-4,5,1,-3,4,1,0,4,4,-3,6,3,-1,-9,9,2,-2,0,-2,0,-1,1,0,-1,-1,3,-1
KR_6705990884,420,-6,-105,-20,-14,-4,5,1,-1,2,1,-4,5,1,-3,4,1,-2,4,2,0,-10,1,-2,0,2,-2,0,-1,1,1,-1,1,5,-1
KR_6757555111,420,-8,-64,-28,-20,-2,3,1,-4,6,2,-5,6,1,-6,8,2,-3,3,0,0,-23,313,2,-3,1,0,0,-2,-1,-1,-1,-1,5,-1
KR_6638238245,420,-2,-4,8,-8,-7,7,0,-2,4,2,0,2,2,1,1,2,0,0,0,0,-10,5,-2,-2,4,-1,0,1,-1,0,1,-1,5,-1
KR_6702468781,420,3,55,6,7,1,0,1,3,1,4,2,6,8,1,0,1,0,0,0,0,3,55,2,-4,2,-16,0,0,1,1,-1,1,3,-1
KR_6733361337,420,0,-21,8,1,-1,3,2,2,2,4,0,2,2,1,1,2,-1,1,0,0,1,7,1,-2,1,-3,0,-1,-1,0,-1,-1,3,-1
KR_6764529863,420,-2,8,4,-5,-1,2,1,1,3,4,-5,6,1,3,2,5,-3,4,1,-1,-7,24,4,-7,3,-6,0,0,-1,1,0,-1,2,-1
KR_6685670721,440,-1,-33,9,-3,-3,3,0,-1,1,0,0,1,1,3,1,4,-2,3,1,0,0,3,-2,-4,6,1,0,-1,1,0,-1,-1,2,-1
KR_6749265123,420,-2,-39,11,2,2,1,3,2,3,5,0,1,1,-1,4,3,-1,1,0,0,-2,-19,-2,-1,3,-1,0,1,-1,0,1,-1,2,-1
KR_6384613959,440,-3,-110,-32,-2,-2,2,0,0,1,1,3,1,4,-3,4,1,0,1,1,0,-3,-6,-2,-1,3,-4,0,-1,1,-1,-1,1,3,-1
KR_6604454727,420,-2,-67,1,-7,-4,4,0,-2,2,0,0,2,2,1,1,2,-2,4,2,0,-6,-114,-4,-1,5,-4,0,-2,-1,-1,-1,1,1,-1
KR_6661151221,420,-1,33,-41,-6,1,0,1,-2,2,0,-1,1,0,-4,4,0,0,0,0,0,-7,-120,-1,0,1,-2,0,0,-1,-1,-1,-1,1,-1
KR_6646882621,420,-4,36,-12,-15,0,3,3,-9,9,0,-4,5,1,0,4,4,-2,2,0,0,-6,-135,1,-3,2,-1,0,-1,0,1,-1,1,0,-1
KR_6645684165,420,-2,15,16,-11,0,1,1,-5,5,0,-4,5,1,-1,5,4,-1,1,0,0,-9,-10,-2,0,2,2,0,-1,1,-1,-1,1,3,-1
KR_6641403121,420,0,63,-16,4,2,1,3,1,2,3,-4,6,2,3,0,3,2,1,3,0,8,3,1,-3,2,-2,0,1,0,0,1,1,0,-1
KR_6653453101,420,-2,-56,12,-14,-2,3,1,-4,4,0,-6,7,1,0,2,2,-2,2,0,0,-10,-1,-4,0,4,0,0,-2,-1,1,-1,-1,3,-1
KR_6762648728,420,1,-2,20,0,5,2,7,-1,2,1,0,1,1,-5,6,1,1,0,1,0,-5,2,1,-4,3,-1,0,-2,0,1,-1,1,0,-1
KR_6753302193,420,-7,-22,-40,-15,-1,2,1,-9,9,0,-8,9,1,3,1,4,0,0,0,0,-13,-61,-8,0,8,2,0,-1,0,1,-1,-1,0,-1
KR_6615029881,420,-7,-40,-19,-10,-4,5,1,-1,2,1,0,3,3,-4,7,3,-1,1,0,0,-6,-3,-6,-1,7,1,0,-1,-1,-1,-1,-1,3,-1
KR_6755317520,420,-6,-53,-33,-10,-4,4,0,-4,4,0,-6,6,0,4,2,6,0,1,1,0,-4,-9,-4,-1,5,0,0,-1,-1,-1,-1,-1,3,-1
KR_6714846839,420,-3,-113,-37,-10,-6,6,0,-5,7,2,2,0,2,-1,1,0,0,0,0,0,-2,-5,0,-4,4,-2,0,-1,-1,1,-1,-1,6,-1
KR_6651569089,420,-2,-29,4,-3,-2,4,2,0,5,5,-1,5,4,1,1,2,-1,1,0,0,-4,-38,-2,-4,6,7,0,-1,1,-1,-1,1,1,-1
KR_6742037609,420,-4,-24,-40,-7,-5,5,0,-6,7,1,-3,4,1,5,0,5,2,0,2,1,3,-3,0,-3,3,1,0,-1,-1,-1,-1,1,4,-1
KR_6609456898,420,1,28,-13,5,1,2,3,0,3,3,6,1,7,-2,3,1,0,0,0,0,5,0,-3,-1,4,-1,0,0,0,0,0,1,0,-1
KR_6606914726,420,2,21,3,2,-3,3,0,4,2,6,-1,2,1,0,0,0,2,1,3,0,4,289,-2,-1,3,-38,0,1,1,1,-1,1,5,-1
KR_6761557964,420,-2,-83,4,-2,-1,2,1,-2,3,1,2,2,4,-3,4,1,2,0,2,0,-3,6,1,-2,1,3,0,-2,1,-1,-1,-1,4,-1
KR_6619705922,420,-3,-51,-18,-4,-3,5,2,1,0,1,1,3,4,-2,2,0,-1,1,0,0,-9,4,-2,-2,4,-1,0,0,-1,1,0,-1,4,-1
KR_6626144277,420,4,2,-8,8,6,1,7,4,1,5,0,0,0,-3,3,0,1,2,3,0,2,-2,0,-2,2,2,0,0,-1,1,0,1,5,-1
KR_6715517423,420,-2,-8,-24,-3,-2,2,0,1,2,3,-7,8,1,1,1,2,4,2,6,0,1,17,0,-2,2,2,0,0,-1,1,0,1,6,-1
KR_6729957730,420,3,82,60,6,7,0,7,-2,3,1,0,3,3,1,1,2,0,0,0,0,-1,-3,-1,-2,3,1,0,2,-1,-1,1,1,3,-1
KR_6739537543,440,-1,13,3,5,-2,3,1,1,2,3,-3,4,1,2,2,4,7,1,8,2,8,6,4,-9,5,-1,0,0,-1,1,0,1,3,-1
KR_6720599890,420,3,9,8,7,3,0,3,2,0,2,2,0,2,0,1,1,0,0,0,0,4,0,-1,-3,4,0,0,0,1,1,1,1,5,-1
KR_6621590043,420,0,24,-13,-3,0,2,2,1,1,2,-2,4,2,-2,5,3,0,0,0,0,5,1,-1,-4,5,-2,0,-1,-1,-1,-1,-1,3,-1
KR_6731234602,420,4,109,-12,4,5,0,5,0,1,1,-2,3,1,1,1,2,0,0,0,0,-3,41,-2,-2,4,-12,0,3,-1,-1,1,1,5,-1
KR_6742270394,420,0,41,2,1,7,0,7,0,0,0,-2,6,4,-5,6,1,1,0,1,1,-8,2,-2,-2,4,0,0,-1,-1,1,-1,1,3,-1
KR_6591810859,420,2,-44,27,-1,1,2,3,2,1,3,-2,4,2,-1,2,1,-1,1,0,0,-3,-150,1,-4,3,-13,0,0,-1,1,0,-1,2,-1
KR_6759321390,420,-2,-7,-12,3,5,1,6,3,5,8,3,1,4,-7,7,0,-1,1,0,0,-2,162,3,-3,0,-2,0,-1,1,-1,1,1,3,-1
KR_6677174526,440,-1,-45,-4,-2,-2,5,3,-1,3,2,1,2,3,-5,5,0,5,3,8,-1,0,-1,-3,-2,5,0,0,-1,-1,-1,-1,-1,2,-1
KR_6726586660,420,-7,-112,-16,-11,-7,7,0,2,2,4,0,0,0,-3,5,2,-3,3,0,-1,-8,-292,7,-8,1,-7,0,-2,-1,-1,-1,-1,2,-1
KR_6720795034,440,-1,-6,12,-2,-1,2,1,0,1,1,0,4,4,5,0,5,-6,6,0,0,0,-7,-1,-2,3,-2,0,0,0,1,1,1,0,-1
KR_6639100033,420,-1,-7,24,-2,-1,1,0,-4,7,3,0,2,2,2,1,3,1,0,1,0,-2,124,-1,-4,5,0,0,-1,-1,1,-1,-1,4,-1
KR_6675580536,420,2,35,16,2,5,0,5,2,2,4,-3,3,0,0,5,5,-2,2,0,1,1,-10,3,-6,3,-1,0,-1,1,-1,-1,1,6,-1
KR_6761616520,420,1,8,16,-4,0,0,0,1,3,4,1,1,2,-2,2,0,-4,4,0,0,-14,31,0,-2,2,-36,0,0,0,-1,0,-1,0,-1
KR_6688717799,420,-2,-46,-8,0,2,0,2,4,1,5,1,1,2,-7,8,1,0,1,1,0,-1,10,3,-6,3,-2,0,1,1,1,1,1,1,-1
KR_6738740971,420,-3,-53,-11,-5,0,1,1,1,4,5,-2,3,1,-4,7,3,0,2,2,-1,-3,-202,2,-5,3,4,0,-2,-1,-1,-1,-1,5,-1
KR_6757526120,420,0,-19,-8,0,2,2,4,0,3,3,2,0,2,-1,5,4,-3,3,0,0,-6,-1,1,-3,2,0,0,-1,1,1,-1,-1,2,-1
KR_6729879857,440,-4,-90,-14,-4,-2,3,1,1,3,4,1,2,3,-4,5,1,0,1,1,-1,-6,15,2,-5,3,-5,0,0,-1,1,-1,-1,3,-1
KR_6712671655,420,-3,-71,11,-9,-2,4,2,1,0,1,-3,4,1,-2,2,0,-3,3,0,0,-2,-163,-5,-1,6,-1,0,-3,-1,-1,-1,-1,5,-1
KR_6724539707,420,-1,-6,-12,3,0,0,0,-2,5,3,1,1,2,4,1,5,0,0,0,1,8,-6,-1,-1,2,2,0,-1,1,-1,-1,1,5,-1
KR_6659985846,440,3,-35,16,8,0,3,3,3,4,7,3,0,3,1,4,5,1,1,2,0,6,5,-2,-4,6,0,0,0,-1,1,-1,-1,5,-1
KR_6722198412,420,-2,-5,21,-3,-1,2,1,-9,9,0,2,1,3,6,1,7,-1,2,1,0,-2,5,-2,0,2,-1,0,0,1,-1,-1,1,3,-1
KR_6763036959,420,2,-15,-8,5,1,1,2,2,1,3,2,3,5,2,3,5,-2,3,1,0,2,-5,-1,-5,6,-1,0,0,0,1,0,1,0,-1
KR_6620342068,420,-3,-48,-12,-12,1,2,3,-6,6,0,-3,3,0,-4,6,2,0,0,0,0,-12,6,-3,-1,4,1,0,0,-1,1,-1,-1,1,-1
KR_6750940574,420,-3,-28,-31,-3,0,1,1,-3,3,0,1,2,3,1,3,4,-2,2,0,0,-4,-303,0,-3,3,1,0,0,1,0,0,-1,2,-1
KR_6668640909,420,2,36,-24,0,0,2,2,-8,8,0,0,2,2,1,4,5,7,1,8,0,-5,-232,1,-2,1,0,0,-1,-1,-1,-1,-1,5,-1
KR_6688144004,420,-7,-97,-28,-17,-2,2,0,-5,6,1,1,1,2,-8,8,0,-3,3,0,-2,-18,-7,-3,-1,4,-2,0,0,-1,0,-1,-1,3,-1
KR_6688773176,420,-3,-46,-8,1,-2,4,2,1,3,4,2,2,4,2,3,5,-2,2,0,0,10,-3,5,-7,2,-5,0,0,-1,1,0,1,4,-1
KR_6733466919,420,-3,-78,0,-7,0,3,3,-5,6,1,-5,6,1,1,1,2,2,2,4,-1,-2,-48,0,-2,2,16,0,0,-1,0,1,-1,5,-1
KR_6744253117,420,1,13,11,-1,1,2,3,0,4,4,-4,4,0,0,1,1,2,0,2,0,6,17,0,-4,4,1,0,0,1,-1,0,-1,3,-1
KR_6726701390,420,-6,-8,-48,-14,1,1,2,-4,4,0,-4,4,0,-7,8,1,0,0,0,0,-16,155,-1,-1,2,-4,0,-1,-1,-1,1,-1,3,-1
KR_6763432094,420,-2,-40,-9,-8,0,0,0,-3,3,0,1,1,2,-5,6,1,-1,1,0,0,-6,-36,1,-3,2,2,0,0,0,-1,0,-1,0,-1
KR_6709880967,420,-3,-24,-4,-5,-4,4,0,-3,4,1,0,1,1,1,1,2,1,2,3,-1,-2,32,-6,-4,10,-20,0,-1,-1,1,-1,-1,5,-1
KR_6755440655,420,-1,7,-8,0,-1,4,3,-1,3,2,4,0,4,-1,1,0,-1,1,0,0,-2,151,1,-6,5,2,0,1,1,1,1,-1,5,-1
KR_6745027717,420,-3,17,-32,-6,-1,1,0,-1,4,3,-3,4,1,0,2,2,-1,3,2,0,-4,-40,5,-6,1,2,0,0,-1,0,0,1,3,-1
KR_5653312031,420,-7,-105,12,-16,-3,4,1,-2,3,1,-3,6,3,-8,10,2,0,0,0,0,-18,27,-5,-2,7,-5,0,-2,-1,-1,-1,1,6,-1
KR_6688760711,420,-8,-108,-64,-12,0,3,3,-1,1,0,-5,6,1,-4,6,2,-2,3,1,-1,-9,-12,-5,0,5,-1,0,-3,-1,-1,-1,-1,4,-1
KR_6731301332,420,6,25,24,9,-1,1,0,-1,6,5,3,0,3,6,1,7,2,0,2,0,7,-211,0,-1,1,0,0,1,1,-1,-1,-1,2,-1
KR_6654766006,420,1,82,-32,-4,-1,1,0,6,0,6,-1,4,3,-5,6,1,-3,3,0,0,-2,7,2,-4,2,-4,0,0,-1,0,0,-1,4,-1
KR_6636388813,420,-7,-57,-28,-9,-3,3,0,-2,4,2,-1,3,2,-2,4,2,-1,1,0,0,-4,-31,-2,-1,3,0,0,-1,0,1,-1,1,0,-1
KR_6753179925,440,0,38,-28,3,0,3,3,-1,3,2,5,0,5,-1,3,2,0,0,0,0,0,-4,2,-5,3,8,0,1,-1,0,1,-1,4,-1
KR_6762635827,440,-3,7,-24,-16,1,2,3,-4,4,0,-7,8,1,-4,5,1,-2,2,0,-1,-18,31,0,-4,4,-19,0,-1,-1,-1,-1,-1,2,-1
KR_6701469385,420,1,40,-15,-9,-3,3,0,0,4,4,-3,6,3,1,1,2,-4,4,0,0,-5,-1,1,-3,2,0,0,-1,-1,-1,-1,-1,4,-1
KR_6660113231,440,1,-35,0,-3,4,0,4,4,4,8,-4,4,0,-8,9,1,1,0,1,-1,-3,-11,0,-2,2,0,0,0,-1,-1,-1,-1,4,-1
KR_6587323145,420,1,1,9,2,1,2,3,4,0,4,-1,5,4,-2,3,1,0,0,0,0,7,-42,-1,-1,2,17,0,0,-1,-1,-1,-1,3,-1
KR_6668716742,420,-2,1,-12,-4,0,0,0,-2,5,3,2,1,3,-4,5,1,0,1,1,0,-10,-2,-1,-4,5,2,0,0,0,1,0,1,0,-1
KR_6638535040,420,2,-35,-12,4,1,2,3,-2,4,2,2,2,4,2,1,3,1,0,1,-1,0,2,1,-4,3,2,0,1,1,1,1,-1,6,-1
KR_6750198943,420,1,-50,-8,1,-2,4,2,0,2,2,-1,1,0,5,1,6,-1,2,1,0,5,-3,0,-1,1,-1,0,-1,0,-1,-1,-1,0,-1
KR_6204705595,420,0,-70,16,-1,-5,6,1,3,0,3,0,1,1,2,1,3,-1,1,0,0,5,-6,-2,-7,9,4,0,-1,0,1,-1,-1,0,-1
KR_6738088980,440,3,67,16,-2,3,0,3,1,1,2,-9,12,3,-1,6,5,4,2,6,-4,-12,17,1,-3,2,-1,0,0,-1,-1,1,-1,6,-1
KR_6712033574,420,-2,-57,3,-4,-3,3,0,3,1,4,0,2,2,-5,6,1,1,0,1,0,-4,273,-1,-3,4,1,0,-1,1,-1,-1,1,1,-1
KR_6606993976,420,-1,28,-36,2,5,1,6,-2,5,3,-5,5,0,5,1,6,-1,4,3,0,0,11,3,-4,1,0,0,3,-1,1,1,1,5,-1
KR_6651674875,420,1,-43,0,6,1,1,2,1,1,2,2,1,3,2,2,4,0,0,0,-1,3,-3,-1,-2,3,-1,0,0,-1,1,0,-1,1,-1
KR_6723853770,420,-4,-121,0,-10,-4,4,0,2,2,4,-8,8,0,-2,5,3,2,4,6,-1,1,-7,-3,0,3,2,0,-3,-1,-1,-1,-1,5,-1
KR_6711188469,420,-6,-120,-42,-7,-5,5,0,2,1,3,-4,4,0,0,0,0,0,0,0,0,-6,131,-4,-1,5,-4,0,-2,1,-1,-1,1,1,-1
KR_6689485402,420,-2,-101,16,-8,-1,4,3,1,3,4,-3,5,2,-1,2,1,-4,4,0,0,-10,-1,0,-4,4,-4,0,-1,1,1,-1,-1,1,-1
KR_6744774342,440,-4,-103,-24,-16,2,2,4,1,1,2,-9,10,1,-9,9,0,-1,4,3,1,-2,-4,-1,-2,3,-1,0,-1,-1,-1,-1,1,3,-1
KR_6763855569,420,-5,-21,-20,-13,0,0,0,-4,7,3,-2,5,3,-3,4,1,-4,4,0,0,-13,4,2,-2,0,0,0,-1,1,-1,-1,-1,4,-1
KR_6760802823,420,-5,-53,30,-17,-9,10,1,-2,2,0,-7,7,0,0,3,3,1,1,2,0,-2,-10,-2,0,2,-1,0,-2,1,-1,-1,1,5,-1
KR_6661687995,420,-11,-117,-30,-5,-5,5,0,3,2,5,-7,7,0,5,0,5,-1,1,0,-1,4,6,-1,0,1,0,-1,-3,-1,-1,-1,-1,2,-1
KR_6561914530,420,-1,22,15,-7,-1,3,2,-3,4,1,-3,5,2,1,1,2,-1,2,1,0,-6,-7,3,-7,4,4,0,0,-1,-1,0,1,2,-1
KR_6758978233,420,-1,-50,-8,-5,0,0,0,2,1,3,-5,5,0,-1,3,2,-1,1,0,0,-5,10,4,-9,5,-5,0,0,1,-1,0,1,1,-1
KR_6607075658,420,-7,-91,0,-16,-2,3,1,-2,3,1,-7,9,2,-3,4,1,-2,3,1,0,-8,4,1,-3,2,4,0,-3,0,-1,-1,1,0,-1
KR_6602184741,420,-1,-65,8,-5,-3,5,2,2,1,3,3,2,5,-6,8,2,-1,2,1,-1,-5,5,-1,-1,2,-3,0,-2,-1,0,-1,-1,2,-1
KR_6740459637,420,-4,-84,-12,-8,-4,4,0,-1,5,4,-1,1,0,-2,2,0,0,0,0,0,-6,-57,-1,-3,4,12,0,0,-1,-1,-1,1,5,-1
KR_6711565700,420,-4,-14,-3,-17,-1,2,1,-1,2,1,1,2,3,-13,15,2,-3,4,1,0,-15,133,-2,-1,3,0,0,-1,-1,-1,-1,-1,4,-1
KR_6747399920,420,2,-30,8,6,-1,3,2,-2,3,1,5,2,7,1,3,4,3,1,4,0,10,5,1,-6,5,-1,0,1,1,1,1,-1,3,-1
KR_6623154791,420,-2,-62,17,-12,0,1,1,-9,13,4,1,0,1,-1,2,1,-3,3,0,0,-11,-226,-1,-5,6,-1,0,0,-1,-1,-1,1,6,-1
KR_6677381613,420,2,7,-35,5,0,0,0,0,3,3,2,2,4,0,0,0,3,0,3,0,4,-47,2,-3,1,23,0,0,-1,0,0,1,3,-1
KR_6708706872,420,0,8,-22,-2,3,2,5,-1,6,5,-6,7,1,5,1,6,-3,3,0,1,-7,-3,-4,0,4,-2,0,0,-1,0,1,1,4,-1
KR_6763904217,420,-2,-40,16,-9,-2,2,0,-2,6,4,0,3,3,-7,7,0,2,0,2,0,-2,0,5,-5,0,-3,0,0,1,-1,0,-1,2,-1
KR_6499333367,420,2,-44,-4,-2,-3,3,0,-1,1,0,0,3,3,-2,3,1,4,0,4,-2,-7,-4,-2,-5,7,1,0,-2,-1,1,-1,-1,4,-1
KR_6576232176,420,1,-46,-25,2,0,1,1,0,1,1,-2,7,5,5,0,5,-1,1,0,0,7,-32,1,-3,2,5,0,-1,0,-1,-1,-1,0,-1
KR_6724675233,420,-1,-12,8,-8,-2,3,1,0,1,1,-2,3,1,-4,4,0,0,0,0,0,-8,16,0,-3,3,-1,0,1,-1,1,1,-1,4,-1
KR_6629860521,420,-2,-41,-14,-5,2,0,2,-5,5,0,-1,4,3,-1,2,1,0,0,0,0,-10,5,-2,-2,4,-1,0,0,-1,-1,0,1,2,-1
KR_6756250189,420,-3,-95,0,-5,-4,4,0,1,0,1,2,1,3,-3,3,0,-1,2,1,0,-2,-6,1,-2,1,0,0,-1,-1,-1,-1,1,1,-1
KR_6631457482,420,-5,-52,-35,-14,-4,4,0,-6,6,0,0,4,4,-4,5,1,0,1,1,0,-8,-6,-6,0,6,-2,0,-2,-1,-1,-1,1,1,-1
KR_6758939628,420,-1,-70,16,-4,-7,8,1,4,1,5,2,3,5,-3,3,0,0,0,0,0,8,-1,2,-5,3,-1,0,-2,0,1,-1,-1,0,-1
KR_6605200800,420,1,-2,-1,2,1,0,1,0,3,3,3,0,3,-2,3,1,0,0,0,0,-3,-2,-6,0,6,3,0,0,1,0,0,-1,3,-1
KR_6755962788,420,-7,-45,4,-1,3,1,4,-1,3,2,0,1,1,0,3,3,-3,3,0,0,-10,20,0,-3,3,-20,0,-2,-1,-1,-1,-1,2,-1
KR_6632318028,420,0,52,13,2,1,1,2,3,1,4,2,3,5,-1,1,0,-3,5,2,0,2,-8,1,-3,2,0,0,0,1,0,0,1,1,-1
KR_6525710488,420,4,-34,44,-1,4,1,5,0,0,0,-2,3,1,-3,3,0,0,0,0,0,-6,12,-1,-2,3,0,0,-1,0,1,-1,1,0,-1
KR_6746956348,420,-1,2,15,3,-2,4,2,-1,1,0,2,2,4,5,2,7,-1,1,0,0,5,-8,-3,0,3,-1,0,-1,1,-1,1,1,6,-1
KR_6756174844,420,-1,14,-9,0,3,1,4,0,3,3,0,1,1,-3,5,2,0,2,2,0,-6,0,-1,-3,4,2,0,0,1,0,0,1,1,-1
KR_6619468888,420,2,110,-12,10,1,1,2,5,1,6,5,0,5,0,3,3,-1,5,4,1,15,142,1,-2,1,3,0,0,1,-1,0,1,4,-1
KR_6693916135,420,2,21,8,3,2,0,2,-1,1,0,-3,3,0,3,1,4,2,1,3,0,2,2,1,-3,2,-2,0,0,0,0,0,1,0,-1
KR_6712020277,420,-3,-28,-15,-6,-3,4,1,-1,3,2,-3,4,1,0,1,1,1,2,3,0,3,-55,2,-5,3,25,0,-1,-1,-1,-1,1,2,-1
KR_6749211403,420,-6,-91,-4,-8,-3,4,1,-1,1,0,-1,1,0,2,2,4,-5,5,0,0,-1,-1,-3,-1,4,-1,0,-1,-1,-1,-1,-1,4,-1
KR_6076650039,440,-2,-72,10,-2,2,3,5,1,0,1,4,0,4,-8,9,1,-1,1,0,0,0,-8,3,-7,4,-5,0,0,-1,1,1,1,3,-1
KR_6546797534,420,-2,4,-36,-1,-4,4,0,4,0,4,2,1,3,-3,3,0,0,2,2,0,-1,-4,-1,-2,3,0,0,0,1,0,-1,-1,3,-1
KR_6693986369,420,-5,-10,-62,-10,-2,3,1,-8,8,0,2,0,2,-1,2,1,-1,5,4,0,-6,0,1,-7,6,0,0,0,0,0,0,-1,0,-1
KR_6732606499,440,-4,44,-4,-9,-6,6,0,-1,4,3,-1,4,3,2,0,2,-3,3,0,0,-9,-2,-3,-3,6,2,0,-1,-1,-1,-1,-1,5,-1
KR_6617033537,420,-3,-58,-8,-6,1,3,4,-1,3,2,-1,3,2,-2,2,0,-3,3,0,0,-7,3,3,-5,2,1,0,0,-1,1,0,-1,2,-1
KR_6737466921,420,-1,-7,-8,-1,0,1,1,0,2,2,-2,3,1,2,0,2,-1,1,0,1,4,24,0,-5,5,-3,0,-1,-1,0,-1,1,5,-1
KR_6644083244,440,-4,-61,-7,-7,-8,9,1,0,4,4,3,1,4,-1,3,2,-1,1,0,0,-3,-5,-1,-2,3,-1,0,-1,0,-1,-1,-1,0,-1
KR_6762862133,420,-1,-6,-19,-2,2,0,2,1,1,2,-1,1,0,-5,7,2,1,0,1,0,-4,11,0,-3,3,-4,0,0,-1,0,-1,-1,6,-1
KR_6731250466,420,-1,-18,-12,-1,0,2,2,0,1,1,2,0,2,-5,6,1,2,1,3,0,-4,42,-1,-1,2,-14,0,0,1,1,-1,-1,4,-1
KR_6561989856,420,-1,-8,-12,-6,-1,2,1,1,1,2,-2,3,1,-2,2,0,-2,2,0,0,-2,2,0,-6,6,-10,0,-1,-1,-1,-1,-1,1,-1
KR_6757627420,420,-7,-86,-24,-23,-4,4,0,-2,2,0,-6,6,0,-9,10,1,-2,3,1,-1,-13,-8,3,-4,1,-3,0,-2,-1,-1,-1,-1,2,-1
KR_5760480636,420,3,-66,44,6,1,0,1,7,1,8,-1,3,2,-2,3,1,1,0,1,0,3,9,0,-3,3,-4,0,0,1,-1,1,1,5,-1
KR_6668360158,420,-5,-99,-40,-8,-4,5,1,-5,8,3,1,2,3,-3,4,1,3,0,3,1,-1,7,4,-5,1,-2,0,-1,0,-1,-1,1,0,-1
KR_6678235688,420,-2,-38,-40,-5,0,2,2,0,4,4,-8,8,0,2,2,4,1,0,1,-2,0,17,1,-3,2,2,0,0,-1,0,0,-1,4,-1
KR_6422476594,420,-6,-82,-15,-11,-4,4,0,-2,9,7,-6,8,2,2,1,3,-1,1,0,-1,2,-9,-3,-2,5,0,0,-1,-1,0,-1,-1,2,-1
KR_6749393106,420,-5,-59,-24,-10,-2,3,1,1,1,2,0,0,0,-1,1,0,-8,9,1,0,-9,-14,-4,-2,6,3,0,-1,-1,0,-1,-1,1,-1
KR_6733309960,420,4,-46,-2,6,1,1,2,0,2,2,4,2,6,-1,1,0,2,0,2,0,3,64,-4,-1,5,-4,0,0,1,-1,-1,1,6,-1
KR_6648274873,420,-4,-28,-28,-4,-1,1,0,0,1,1,-1,4,3,-1,3,2,-1,1,0,0,-7,3,-1,-2,3,0,0,0,1,1,0,1,2,-1
KR_6738316196,420,2,-11,8,-4,1,3,4,-3,4,1,-7,7,0,2,1,3,3,1,4,0,-6,-20,1,-1,0,-1,0,0,1,-1,0,1,2,-1
KR_6682496852,420,-4,-80,-8,-4,-2,2,0,0,1,1,-1,2,1,-3,4,1,2,0,2,0,-4,-2,0,-2,2,0,0,-1,-1,-1,-1,-1,1,-1
KR_6637154554,420,-1,9,-20,-2,4,0,4,0,2,2,-10,10,0,2,1,3,2,0,2,0,-2,302,2,-3,1,-1,0,0,-1,0,0,-1,6,-1
KR_6651612983,420,-3,26,-24,-5,1,1,2,1,2,3,-1,4,3,-5,7,2,-1,1,0,0,-5,5,0,-1,1,0,0,0,-1,1,1,1,6,-1
KR_6754707464,420,-4,-52,0,-8,2,0,2,-6,7,1,-3,4,1,0,1,1,-1,3,2,0,-5,-7,-3,-3,6,-2,0,-1,-1,-1,-1,1,5,-1
KR_6737734495,440,0,35,-8,-5,2,1,3,0,3,3,2,3,5,-9,11,2,0,1,1,1,-15,8,-2,-3,5,-2,0,0,0,0,0,1,0,-1
KR_6632764384,420,0,56,3,-1,-4,4,0,-2,3,1,3,1,4,-1,4,3,3,0,3,0,-2,-3,-2,-2,4,-1,0,-1,-1,-1,-1,-1,4,-1
KR_6700525121,420,-2,-26,-30,-2,1,0,1,-1,4,3,-2,6,4,-1,3,2,1,0,1,0,-3,-12,2,-7,5,-4,0,0,-1,-1,0,1,4,-1
KR_6715849556,420,-3,23,12,-6,1,3,4,-2,3,1,-5,7,2,0,6,6,0,1,1,0,-2,4,0,-3,3,-5,0,0,-1,1,1,1,3,-1
KR_6636635862,420,1,-41,8,-4,-1,2,1,-7,7,0,3,0,3,-1,4,3,2,1,3,0,-6,-12,1,-3,2,5,0,0,-1,-1,-1,-1,6,-1
KR_6649514693,420,-2,6,-43,-14,-1,5,4,-3,3,0,-6,7,1,-5,7,2,1,0,1,-1,-19,6,-1,-3,4,0,0,-2,1,1,-1,-1,5,-1
KR_6752166562,420,3,20,12,7,1,1,2,-4,6,2,2,0,2,6,1,7,2,3,5,1,4,114,0,-3,3,-2,0,1,1,-1,1,1,5,-1
KR_6490508019,440,2,-51,-8,5,-8,8,0,-4,4,0,4,1,5,0,2,2,13,0,13,0,11,2,-1,-3,4,-1,0,-1,1,-1,-1,-1,5,-1
KR_6660676037,420,-6,-9,-32,-10,1,0,1,-3,6,3,-3,4,1,-4,6,2,-1,1,0,1,-5,2,-5,-3,8,2,0,-3,-1,-1,-1,1,4,-1
KR_6660180691,420,-2,6,-14,-9,-3,3,0,-3,7,4,-3,4,1,-2,4,2,2,0,2,0,-10,-6,1,-2,1,1,0,0,-1,-1,0,-1,3,-1
KR_6762701741,420,0,11,1,5,2,2,4,2,1,3,3,1,4,-3,5,2,1,2,3,0,-2,8,6,-11,5,-2,0,1,-1,1,-1,1,2,-1
KR_6627900288,420,2,-26,34,2,2,2,4,3,2,5,-3,5,2,3,1,4,-3,3,0,0,10,363,5,-5,0,-3,0,0,1,-1,0,1,5,-1
KR_6729891480,420,-2,-29,-20,-4,-2,2,0,1,1,2,1,1,2,-3,6,3,-1,2,1,-1,-2,-10,-4,-2,6,-2,0,-2,-1,-1,-1,-1,3,-1
KR_6761833885,420,-2,19,0,-3,-2,3,1,-5,7,2,1,2,3,2,1,3,1,1,2,0,-4,8,2,-3,1,-4,0,0,0,-1,0,-1,0,-1
KR_6671288031,420,-2,-49,-21,-12,-1,2,1,-5,5,0,0,1,1,-5,5,0,-1,1,0,0,-10,4,0,-5,5,-5,0,0,-1,-1,0,-1,5,-1
KR_6697730604,420,0,-8,0,-2,2,0,2,0,1,1,-8,8,0,4,2,6,0,1,1,1,-2,-32,1,-3,2,10,0,-1,1,-1,-1,1,3,-1
KR_6596271675,420,0,-59,-12,2,-1,4,3,0,2,2,2,1,3,2,1,3,-1,2,1,0,2,1,1,-2,1,-2,0,0,1,-1,0,-1,4,-1
KR_6725362117,420,-6,-100,-42,-6,6,1,7,-7,7,0,-1,2,1,-3,3,0,-1,1,0,0,-8,7,-3,0,3,4,0,-1,-1,-1,-1,-1,5,-1
KR_6748993448,420,0,32,15,-3,-4,4,0,-2,5,3,5,2,7,-1,3,2,-1,1,0,1,-6,0,8,-10,2,1,0,0,-1,-1,-1,1,3,-1
KR_6753675869,420,-1,-89,-8,0,0,2,2,2,2,4,2,0,2,-4,5,1,0,1,1,0,1,-8,2,-4,2,-1,0,0,1,-1,0,1,1,-1
KR_6699492944,420,-4,-66,-37,-7,-4,4,0,1,2,3,0,1,1,-4,5,1,0,1,1,0,-6,-260,-1,-2,3,-2,0,-2,-1,-1,-1,1,4,-1
KR_6756399747,420,0,19,-14,3,3,0,3,-2,2,0,0,5,5,1,2,3,1,0,1,0,4,0,2,-4,2,4,0,-1,1,0,-1,1,4,-1
KR_6709199780,420,-3,-17,14,-3,-2,2,0,-3,5,2,1,1,2,-1,4,3,2,0,2,0,-6,2,2,-4,2,0,0,0,1,-1,0,-1,1,-1
KR_6582103061,420,-3,-33,8,-6,0,2,2,2,1,3,1,1,2,-8,8,0,-1,1,0,0,-6,6,1,-6,5,1,0,0,-1,-1,0,-1,6,-1
KR_6763869434,420,0,-18,32,-7,-3,3,0,-1,2,1,2,1,3,-4,6,2,-1,1,0,0,-11,13,-3,-2,5,-2,0,0,1,0,0,-1,3,-1
KR_6601840207,420,-2,-72,-8,-3,2,1,3,0,0,0,-4,4,0,-4,8,4,3,0,3,1,-4,-35,2,-4,2,1,0,0,1,-1,0,1,5,-1
KR_6637298506,420,0,-22,4,1,-1,2,1,3,2,5,2,0,2,-3,4,1,0,1,1,0,2,230,-8,-2,10,-1,0,1,0,-1,1,1,0,-1
KR_6697339257,420,0,-44,21,3,-2,3,1,1,0,1,2,0,2,1,0,1,1,1,2,-1,1,-2,-2,-2,4,-3,0,-2,1,-1,-1,-1,2,-1
KR_6721370127,420,-5,-84,-16,-9,-2,2,0,7,1,8,1,3,4,-10,10,0,-5,8,3,-1,-7,1,3,-5,2,-2,0,-2,-1,1,-1,-1,6,-1
KR_6763231182,420,4,47,-20,8,2,0,2,3,1,4,-1,3,2,2,0,2,2,1,3,0,3,10,1,-2,1,1,0,1,-1,1,1,-1,1,-1
KR_6760861537,420,2,11,32,-4,2,1,3,2,1,3,-2,4,2,-6,6,0,0,0,0,0,-6,-2,-2,-1,3,3,0,0,-1,1,0,1,1,-1
KR_6762567236,440,-7,-26,-38,-16,-3,4,1,-3,3,0,-2,2,0,-4,4,0,-4,5,1,0,-15,235,-3,-1,4,4,0,0,-1,-1,-1,-1,5,-1
KR_6759910987,420,-3,-83,-8,2,-4,4,0,4,0,4,-2,5,3,3,2,5,1,0,1,2,7,0,1,-6,5,-1,0,-1,1,-1,-1,1,4,-1
KR_5675771957,420,-4,-22,-40,-12,-2,3,1,-4,6,2,-1,3,2,-5,6,1,0,0,0,0,-12,8,2,-5,3,-2,0,-2,-1,-1,-1,-1,3,-1
KR_6738966319,420,-2,-9,12,-1,-4,4,0,-1,3,2,1,5,6,2,0,2,1,0,1,0,2,-1,0,-6,6,-1,0,0,1,0,-1,-1,3,-1
KR_6715755725,420,-2,-38,19,0,0,1,1,3,1,4,-3,7,4,0,5,5,0,1,1,0,-1,242,3,-4,1,-1,0,0,1,1,1,-1,1,-1
KR_6604559245,420,-2,-29,-19,-4,-2,3,1,0,1,1,-2,3,1,-1,4,3,1,0,1,0,-2,4,3,-5,2,-2,0,0,-1,0,0,-1,3,-1
KR_6316111928,420,-2,-33,16,-6,1,2,3,-5,5,0,-1,1,0,-2,3,1,1,0,1,0,-8,18,-1,-3,4,-1,0,-1,0,-1,-1,1,0,-1
KR_6734385100,440,-6,13,0,-16,-3,7,4,-3,3,0,-3,4,1,-5,5,0,-2,2,0,-1,-23,-9,-3,-1,4,-1,0,0,-1,1,-1,-1,2,-1
KR_6647987758,420,-1,5,-24,-4,-9,11,2,-6,6,0,2,2,4,9,0,9,0,3,3,1,-1,5,2,-2,0,1,0,-2,-1,-1,-1,1,6,-1
KR_6746236363,420,-3,-70,5,-12,-5,6,1,-2,3,1,-2,2,0,0,4,4,-3,4,1,0,-1,-5,0,-2,2,-3,0,-3,-1,1,-1,-1,1,-1
KR_6726194761,440,-1,-92,-4,-1,1,0,1,0,3,3,-1,3,2,0,2,2,-1,1,0,0,-4,27,4,-5,1,-34,0,0,-1,1,0,1,1,-1
KR_6760344940,420,-6,-89,8,-12,1,1,2,-4,4,0,-4,5,1,-3,5,2,-2,2,0,0,-3,10,-4,-3,7,-6,0,-1,0,0,-1,-1,0,-1
KR_6701922758,440,0,-40,12,0,2,0,2,-3,3,0,0,0,0,0,2,2,1,1,2,0,-2,7,1,-5,4,-2,0,-1,-1,1,-1,-1,5,-1
KR_6707477626,440,1,15,-4,3,-3,3,0,-2,2,0,-1,2,1,9,0,9,0,1,1,0,2,9,1,-3,2,-2,0,0,-1,-1,0,1,2,-1
KR_6615850108,420,-2,-56,-18,-13,-4,4,0,0,2,2,5,1,6,-12,13,1,-2,3,1,0,-7,-4,0,-2,2,3,0,-3,-1,-1,-1,-1,2,-1
KR_6759350639,440,-1,-79,-8,6,2,1,3,-1,1,0,4,0,4,1,2,3,0,3,3,0,3,1,0,-4,4,-4,0,0,0,1,0,1,0,-1
KR_6725518489,420,-2,3,4,-7,-1,2,1,-2,3,1,-2,3,1,-3,5,2,1,1,2,-1,-6,4,1,-3,2,-1,0,0,-1,1,0,-1,4,-1
KR_6764136697,420,2,31,-44,8,-4,4,0,-1,1,0,3,3,6,8,1,9,2,0,2,1,12,156,0,-4,4,4,0,-1,-1,-1,-1,1,2,-1
KR_6746812136,420,-3,-72,0,-8,-5,5,0,1,4,5,5,2,7,-7,10,3,-2,3,1,-1,-15,-95,-1,-1,2,-1,0,-3,1,-1,-1,-1,4,-1
KR_6762263954,440,-1,1,8,-6,-2,3,1,1,0,1,-3,5,2,-2,3,1,0,1,1,0,-10,6,0,-3,3,-3,0,0,-1,-1,0,-1,4,-1
KR_6660164865,440,-1,-99,28,-4,-6,7,1,1,1,2,2,1,3,-2,4,2,1,0,1,-2,1,4,1,-4,3,-2,0,0,-1,-1,-1,-1,6,-1
KR_6731647048,420,-2,-28,-8,-1,5,0,5,2,4,6,0,4,4,-2,2,0,-6,7,1,0,-8,-7,-1,-2,3,-4,0,0,-1,-1,-1,1,6,-1
KR_6748161842,420,-4,-106,-8,-7,0,0,0,-1,3,2,3,2,5,-6,7,1,-3,3,0,0,-10,-133,0,-3,3,1,0,-2,-1,1,-1,1,5,-1
KR_6729537465,440,0,-65,13,0,1,3,4,-1,3,2,-4,4,0,4,0,4,0,1,1,0,-1,-5,-2,-1,3,-2,0,-1,-1,0,-1,-1,4,-1
KR_6654827965,420,-4,-8,-4,-11,2,1,3,-8,10,2,1,1,2,-1,3,2,-5,6,1,0,-6,-188,1,-4,3,7,0,-1,1,-1,-1,-1,1,-1
KR_6709982255,420,2,-11,24,5,1,1,2,0,1,1,-4,5,1,10,0,10,-2,2,0,0,13,2,-1,-4,5,0,0,0,-1,1,0,-1,2,-1
KR_6655188590,420,0,-11,-21,-3,-1,1,0,2,1,3,1,4,5,-5,6,1,0,1,1,0,-5,10,-1,-3,4,-1,0,-1,-1,1,1,-1,6,-1
KR_6583843538,420,1,-30,-15,2,3,0,3,3,2,5,-3,4,1,-2,6,4,1,1,2,0,4,3,-1,-1,2,1,0,0,0,1,-1,1,0,-1
KR_6753125238,420,-3,-18,0,-1,-8,9,1,1,2,3,8,0,8,-1,1,0,-1,1,0,0,4,-7,-5,-2,7,-2,0,-1,-1,-1,-1,-1,2,-1
KR_6708191424,440,-5,-30,-2,-8,1,0,1,-5,6,1,0,2,2,-3,6,3,-1,1,0,0,-10,4,0,-3,3,3,0,-1,1,0,-1,-1,5,-1
KR_6399366679,420,3,44,-34,6,4,0,4,1,3,4,-1,3,2,3,2,5,-1,2,1,0,8,-3,-1,-2,3,-1,0,2,-1,1,1,-1,2,-1
KR_6710824035,420,-6,-5,-47,-11,0,3,3,-3,3,0,-6,6,0,-2,3,1,0,1,1,0,-7,-8,0,-6,6,0,0,0,-1,-1,1,1,4,-1
KR_6760429994,420,-2,-54,1,-10,-2,3,1,0,2,2,-2,4,2,-4,4,0,-2,2,0,0,-9,-5,-5,-1,6,-1,0,-1,-1,-1,-1,1,5,-1
KR_6084046052,440,0,-18,24,0,-1,3,2,-2,2,0,1,1,2,-1,1,0,3,4,7,0,-4,1,3,-6,3,0,0,1,0,1,1,1,0,-1
KR_6689334836,440,-2,-53,-29,-5,1,0,1,4,2,6,1,2,3,-9,10,1,-2,2,0,1,-8,-3,4,-6,2,-2,0,-1,-1,0,-1,1,4,-1
KR_6692820877,440,-3,17,4,-13,1,1,2,-4,4,0,-5,6,1,-2,5,3,-3,3,0,0,-15,-8,-8,-1,9,0,0,0,-1,-1,1,-1,5,-1
KR_6723701941,420,1,-16,8,6,-2,4,2,4,2,6,1,0,1,3,1,4,0,2,2,1,10,242,-1,-2,3,3,0,0,1,1,1,1,2,-1
KR_6752906716,420,1,32,-12,7,3,0,3,-3,3,0,7,0,7,1,2,3,-1,2,1,0,0,-147,1,-2,1,0,0,1,-1,1,1,-1,5,-1
KR_6639658747,420,-2,-54,7,-10,0,4,4,1,1,2,-3,5,2,-6,6,0,-2,3,1,0,-12,-5,-1,0,1,-1,0,-3,1,1,-1,1,3,-1
KR_6724033965,440,0,-24,0,-3,-1,1,0,-3,4,1,0,1,1,-2,4,2,3,0,3,0,-4,5,1,-7,6,-4,0,0,-1,-1,0,1,1,-1
KR_6730455177,420,-1,-40,97,-2,-2,3,1,-1,2,1,0,2,2,-1,1,0,2,2,4,0,-9,-52,4,-5,1,14,0,-2,-1,1,-1,1,6,-1
KR_6762767366,420,-3,-80,-8,-9,-6,10,4,1,1,2,0,3,3,-3,3,0,-1,1,0,-1,-6,-2,0,-3,3,-2,0,-2,1,-1,-1,-1,3,-1
KR_6725561735,420,-4,-121,-4,-4,-7,7,0,2,1,3,1,2,3,-4,7,3,4,0,4,0,9,8,-1,-4,5,-2,0,0,-1,1,-1,-1,4,-1
KR_6746292728,420,-4,-26,0,-9,0,1,1,-5,7,2,-1,4,3,0,2,2,-3,3,0,1,-14,1,1,-4,3,-3,0,-2,0,1,-1,1,0,-1
KR_6725275509,420,-2,9,-4,-3,0,1,1,-2,2,0,1,0,1,0,0,0,-2,4,2,-1,-6,-23,-3,-1,4,8,0,0,0,-1,-1,-1,0,-1
KR_6518465494,420,-4,3,16,-17,-7,7,0,-3,3,0,-2,2,0,-5,6,1,0,2,2,0,-14,-175,1,-3,2,-2,0,-1,-1,1,-1,-1,5,-1
KR_6749905585,420,2,-57,26,-3,-2,4,2,3,2,5,-3,5,2,3,2,5,-4,4,0,0,0,0,-3,-2,5,-2,0,1,-1,1,-1,-1,4,-1
KR_6700818005,420,-1,-59,-25,9,-1,2,1,4,0,4,4,2,6,1,2,3,1,1,2,0,9,-6,-3,-4,7,7,0,0,-1,1,1,1,5,-1
KR_6711103894,420,0,-59,5,5,1,0,1,1,1,2,-2,2,0,3,0,3,2,0,2,-1,0,-17,0,-4,4,-3,0,0,-1,0,0,-1,2,-1
KR_6692852840,440,-4,-95,-17,-12,-3,3,0,-1,2,1,-6,7,1,1,0,1,-3,3,0,0,-11,-1,0,-4,4,-3,0,1,-1,-1,1,1,5,-1
KR_6618562026,420,-3,-114,23,-3,6,1,7,0,2,2,1,1,2,-9,10,1,-1,2,1,1,-5,261,2,-4,2,-1,0,-2,1,-1,-1,1,4,-1
KR_6725881459,440,1,-63,-17,4,-2,3,1,2,2,4,0,3,3,2,2,4,2,3,5,0,14,-386,-3,0,3,1,0,1,-1,1,1,1,4,-1
KR_6760332083,420,-2,-11,24,-8,4,0,4,-11,11,0,-3,6,3,2,1,3,0,4,4,0,-10,4,1,-3,2,1,0,0,1,1,0,1,2,-1
KR_6757418120,420,-6,-130,1,-23,-3,4,1,-3,3,0,-9,9,0,-9,11,2,1,0,1,0,-16,-10,-1,-4,5,0,0,-2,-1,-1,-1,-1,4,-1
KR_6530807267,420,-1,-51,36,-4,-4,5,1,2,1,3,0,4,4,-3,3,0,1,0,1,0,-4,11,1,-3,2,-1,0,-1,-1,-1,-1,-1,1,-1
KR_6763395870,440,-1,-81,-24,2,1,0,1,-1,2,1,2,0,2,-1,2,1,1,2,3,0,9,1,-2,-3,5,-2,0,0,1,-1,0,1,6,-1
KR_6709032006,420,-3,-45,-11,-5,-5,7,2,2,1,3,0,1,1,-2,6,4,0,1,1,0,0,42,-2,0,2,-15,0,-3,-1,-1,-1,-1,6,-1
KR_6730629053,420,-5,-45,-31,-16,-2,3,1,-12,15,3,3,1,4,-3,5,2,-2,2,0,0,-16,2,-1,-3,4,-2,0,-2,0,0,-1,1,0,-1
KR_6705411816,420,-4,20,0,-4,0,1,1,3,0,3,0,2,2,-6,7,1,-1,3,2,0,-9,9,4,-4,0,-1,0,0,1,1,1,1,1,-1
KR_6764250682,420,0,-21,0,-6,3,1,4,2,1,3,-1,7,6,-9,9,0,-1,1,0,-1,-11,-3,2,-4,2,-6,0,-1,-1,0,-1,-1,2,-1
KR_6698859479,420,-3,-17,-28,-8,0,1,1,-7,7,0,0,1,1,-1,3,2,0,1,1,0,-2,-5,-4,0,4,4,0,-1,-1,-1,-1,-1,6,-1
KR_6762845639,420,-2,-53,-8,-1,-1,2,1,0,3,3,-2,3,1,1,3,4,1,2,3,1,-4,-4,-7,-2,9,-1,0,-1,-1,-1,-1,1,4,-1
KR_6698729192,420,-1,-22,-20,-2,-2,3,1,-3,3,0,2,1,3,-1,4,3,2,0,2,-2,-2,-19,0,-3,3,2,0,0,1,-1,-1,-1,1,-1
KR_6691179350,440,-4,-7,-9,2,1,1,2,4,1,5,-2,4,2,-4,4,0,3,1,4,0,0,-121,-1,-4,5,1,0,-4,-1,-1,-1,-1,3,-1
KR_6669988580,440,1,-19,-16,-1,1,1,2,0,3,3,-2,4,2,2,5,7,-2,3,1,2,-4,-12,-5,-2,7,0,0,0,0,-1,0,-1,0,-1
KR_6513869811,420,3,-11,4,12,-1,2,1,-1,1,0,6,1,7,7,0,7,1,1,2,0,16,-3,-2,0,2,3,0,1,1,-1,-1,1,5,-1
KR_6663219407,420,1,3,23,-3,-3,5,2,-2,3,1,-1,3,2,2,2,4,1,0,1,0,0,-6,-3,0,3,0,0,0,0,0,1,-1,0,-1
KR_6676013461,420,-8,-116,-16,-21,0,2,2,-3,3,0,-10,10,0,-10,11,1,2,1,3,0,-16,4,2,-6,4,0,0,-3,1,-1,-1,-1,5,-1
KR_6506034525,440,2,-36,-16,-1,-1,2,1,-2,5,3,0,0,0,1,1,2,1,1,2,0,4,4,0,-2,2,-1,0,0,-1,0,0,1,3,-1
KR_6749592792,420,-5,30,-13,-9,-2,3,1,-5,5,0,2,0,2,-1,1,0,-3,5,2,0,-9,14,1,-3,2,-4,0,0,-1,1,-1,-1,5,-1
KR_6533376140,440,-4,-63,-28,-5,1,0,1,-4,7,3,-1,2,1,-2,3,1,1,0,1,0,0,-4,0,-7,7,-1,0,-1,-1,0,-1,-1,1,-1
KR_6648521044,420,-3,-64,-33,-12,1,0,1,2,2,4,-9,9,0,-3,3,0,-3,3,0,-2,-10,-8,0,-3,3,2,0,-2,1,-1,-1,-1,3,-1
KR_6666980870,420,-4,-76,-12,-10,-4,5,1,-6,6,0,-2,3,1,3,1,4,-1,2,1,0,-7,-2,-5,-3,8,0,0,-1,-1,-1,-1,-1,5,-1
KR_6641737479,420,-7,-106,-44,-10,2,2,4,-1,4,3,-1,4,3,-1,2,1,-9,11,2,0,-9,-10,3,-5,2,0,0,-2,-1,0,-1,1,5,-1
KR_6648453177,420,-4,-69,-20,-6,0,0,0,-5,6,1,-1,4,3,0,3,3,0,0,0,0,-2,2,2,-6,4,2,0,0,-1,-1,0,-1,5,-1
KR_6750370086,440,0,-39,-8,-8,-6,6,0,0,2,2,-1,3,2,-1,6,5,0,0,0,-2,-12,9,-2,-1,3,-3,0,1,0,-1,-1,-1,0,-1
KR_6722265815,440,0,14,0,-7,-3,4,1,-9,10,1,-2,3,1,5,1,6,2,0,2,0,-10,-5,-7,-2,9,4,0,-2,-1,-1,-1,-1,5,-1
KR_6695285705,420,-3,7,-25,-11,2,3,5,-11,11,0,-3,3,0,-1,6,5,2,1,3,-1,-23,-3,-2,-1,3,1,0,0,1,-1,1,-1,3,-1
KR_6607885830,420,-3,-7,-3,-6,-1,2,1,0,0,0,-6,6,0,3,2,5,-2,3,1,0,-5,-60,0,-1,1,-25,0,-1,1,-1,-1,-1,1,-1
KR_6760392652,420,-2,14,-22,-1,-4,7,3,1,2,3,1,1,2,-1,4,3,2,0,2,0,1,239,1,-2,1,0,0,-1,-1,-1,-1,1,6,-1
KR_6484108655,420,-4,-99,-1,-4,-2,3,1,-1,4,3,1,1,2,-2,2,0,0,1,1,1,2,5,0,-3,3,0,0,-1,-1,-1,-1,1,3,-1
KR_6684654000,420,-5,-125,-11,-8,2,1,3,0,1,1,-6,7,1,-4,5,1,0,1,1,0,-1,6,0,-2,2,-2,0,-1,-1,1,-1,-1,6,-1
KR_6749583482,420,-4,-59,-12,-10,-1,3,2,0,3,3,0,4,4,-8,9,1,-1,3,2,-3,-11,-5,-1,-2,3,0,0,-2,0,0,-1,-1,0,-1
KR_6638955313,420,-3,-62,24,-8,-1,1,0,-2,5,3,-4,4,0,-1,2,1,0,1,1,0,-7,-26,-1,-3,4,0,0,-1,-1,-1,-1,-1,4,-1
KR_6749614147,420,-4,-61,-45,-9,-4,6,2,1,0,1,-1,2,1,-5,8,3,0,2,2,0,-1,-16,-1,-4,5,-4,0,-1,0,-1,-1,-1,0,-1
KR_6760729680,420,-4,-39,-4,-6,-1,2,1,1,3,4,-6,8,2,-2,3,1,2,0,2,0,-6,1,-1,-3,4,2,0,0,0,-1,-1,-1,0,-1
KR_6642957974,420,-13,-126,-32,-16,-5,5,0,-2,3,1,-6,6,0,0,3,3,-3,4,1,0,-7,4,-3,0,3,1,0,-4,0,0,-1,1,0,-1
KR_6608858965,420,-2,3,10,-7,1,2,3,0,6,6,0,3,3,-9,11,2,1,0,1,1,-5,-4,-2,-2,4,0,0,-1,-1,-1,-1,1,6,-1
KR_6658053551,420,2,-5,8,8,1,0,1,5,1,6,5,1,6,-1,1,0,-2,2,0,1,-1,52,5,-7,2,-28,0,0,0,0,0,1,0,-1
KR_6525354318,420,0,21,-10,0,0,4,4,-2,3,1,-3,3,0,7,0,7,-2,3,1,0,4,-41,1,-2,1,14,0,-1,1,0,-1,-1,3,-1
KR_6636606957,420,-2,4,11,-4,-5,5,0,-1,2,1,0,3,3,4,1,5,-2,2,0,0,-4,-3,-5,-2,7,4,0,0,1,1,0,1,3,-1
KR_6625022897,420,-3,-19,-16,-13,-1,2,1,-1,4,3,-4,5,1,-6,6,0,-1,4,3,-2,-20,4,5,-6,1,-5,0,-1,-1,-1,-1,-1,5,-1
KR_6695149152,440,1,81,-15,3,4,1,5,-3,4,1,3,2,5,1,2,3,-2,2,0,-1,-4,-6,-1,0,1,-1,0,0,0,0,-1,-1,0,-1
KR_6623267144,440,4,-44,24,8,-4,6,2,5,0,5,2,0,2,3,0,3,2,1,3,-1,8,-6,-3,-1,4,1,0,0,1,0,0,-1,3,-1
KR_6756171999,420,-1,-27,-16,-2,0,4,4,-4,5,1,3,0,3,-1,3,2,0,2,2,-1,2,-4,2,-6,4,2,0,-1,1,1,-1,-1,3,-1
KR_6563420186,420,-3,-83,16,-8,1,1,2,-3,4,1,-1,6,5,-3,5,2,-2,3,1,-1,-12,-1,2,-3,1,-1,0,-2,1,1,-1,-1,4,-1
KR_6743982263,420,-6,-86,4,-9,-1,2,1,-4,5,1,-2,4,2,-5,6,1,3,0,3,1,-4,-14,-4,-1,5,4,0,0,-1,0,-1,1,2,-1
KR_6671426953,420,-1,-36,-24,-1,2,2,4,-1,3,2,1,6,7,-3,5,2,0,0,0,-1,-4,11,-3,0,3,1,0,0,1,-1,0,-1,3,-1
KR_6751075671,420,-3,-24,-4,-11,-4,5,1,-2,2,0,1,1,2,-5,6,1,-1,1,0,0,-10,7,-1,-3,4,-1,0,-1,-1,-1,-1,-1,1,-1
KR_6529043700,420,-4,-24,4,-9,-1,3,2,-2,4,2,-5,6,1,1,3,4,-2,3,1,0,-2,-71,-1,-1,2,-17,0,-1,-1,1,-1,-1,3,-1
KR_6660699833,420,-6,-56,-9,-9,1,0,1,1,2,3,-5,10,5,-5,5,0,-1,2,1,-1,-6,-31,3,-3,0,0,0,-2,-1,-1,-1,-1,1,-1
KR_6650228666,420,-4,-50,11,-14,-1,2,1,1,1,2,-4,4,0,-8,9,1,-2,2,0,0,-13,0,-3,-5,8,2,0,-2,-1,1,-1,1,3,-1
KR_6758036648,420,-2,-63,-20,-1,-2,4,2,3,1,4,1,1,2,-2,4,2,-1,2,1,-1,5,-19,6,-7,1,-2,0,-1,-1,-1,-1,-1,1,-1
KR_6569628017,420,-3,-36,-3,-5,0,2,2,1,1,2,1,6,7,-5,6,1,-2,3,1,1,-5,0,-2,-2,4,-1,0,-1,-1,0,-1,1,5,-1
KR_6749171751,420,-1,-13,-18,-2,-3,3,0,1,1,2,-1,2,1,-2,6,4,3,0,3,0,3,5,-2,-2,4,-2,0,-1,1,0,-1,1,1,-1
KR_6750265970,420,-1,-54,-13,-3,-1,2,1,5,0,5,2,2,4,-8,8,0,-1,3,2,-1,-10,-24,-3,0,3,3,0,-1,-1,1,-1,-1,5,-1
KR_6706851899,440,-2,36,-41,1,2,0,2,-1,3,2,3,0,3,-5,5,0,2,0,2,0,3,22,2,-6,4,-18,0,-1,-1,0,-1,1,5,-1
KR_6726250626,420,-3,-48,12,-10,0,0,0,-4,7,3,-2,3,1,-3,5,2,-1,1,0,0,-18,-36,4,-5,1,15,0,0,-1,-1,-1,-1,5,-1
KR_6712858730,420,-1,102,11,-1,3,1,4,-6,7,1,-2,4,2,3,1,4,1,1,2,0,-1,-7,-2,-1,3,3,0,2,0,-1,1,1,0,-1
KR_6637161342,420,-4,-1,6,-5,-3,3,0,2,0,2,-4,6,2,1,1,2,-1,2,1,0,-3,103,0,-4,4,-3,0,0,0,0,0,-1,0,-1
KR_6746316590,420,-4,-48,-8,-12,-3,4,1,-1,1,0,0,1,1,-7,8,1,-1,2,1,0,-12,-10,1,-3,2,1,0,-2,1,-1,-1,-1,6,-1
KR_6750807172,420,-1,-21,17,-1,-1,2,1,-1,3,2,2,0,2,-2,4,2,1,1,2,0,-1,-110,3,-6,3,-3,0,0,1,-1,0,1,1,-1
KR_6612578640,420,-1,-16,0,-7,-2,2,0,2,4,6,-3,3,0,-2,3,1,-2,3,1,0,-8,-127,-1,-2,3,1,0,0,1,-1,-1,1,6,-1
KR_6583862153,420,-1,-28,0,-5,1,3,4,2,3,5,-5,7,2,-4,4,0,1,1,2,1,-5,3,-1,-2,3,1,0,-1,-1,-1,-1,1,6,-1
KR_6531566092,420,0,56,12,4,-1,5,4,1,5,6,6,5,11,0,1,1,-2,3,1,2,5,7,2,-4,2,0,0,2,0,1,1,1,0,-1
KR_6640999138,420,-6,-29,-22,-2,1,0,1,2,1,3,-3,3,0,-4,5,1,2,0,2,1,-3,231,5,-5,0,0,0,-1,-1,-1,-1,1,1,-1
KR_6739471730,420,-1,-6,0,0,1,0,1,5,1,6,-3,5,2,0,1,1,-3,3,0,0,1,-1,0,0,0,3,0,0,1,1,1,1,5,-1
KR_6750579585,420,0,-91,-16,2,3,0,3,5,4,9,-1,4,3,-2,3,1,-3,3,0,0,3,-2,2,-3,1,1,0,0,1,0,0,-1,2,-1
KR_6751798643,420,0,87,-19,-1,4,0,4,-3,3,0,0,1,1,-4,6,2,2,1,3,0,-4,231,-4,-1,5,0,0,0,0,0,0,-1,0,-1
KR_6702889830,420,5,70,51,14,5,0,5,6,1,7,3,1,4,0,3,3,0,2,2,0,1,16,4,-5,1,-1,0,1,1,1,1,1,4,-1
KR_6671368703,420,-4,-94,-20,-17,-1,2,1,-14,14,0,-1,2,1,1,0,1,-2,4,2,0,-16,-16,4,-5,1,-1,0,0,-1,-1,-1,-1,1,-1
KR_6764519736,420,-3,-71,-16,-7,-4,4,0,-4,4,0,3,0,3,-3,3,0,1,0,1,0,-3,-7,-2,-3,5,-2,0,0,-1,-1,-1,-1,3,-1
KR_6636518575,420,1,1,49,3,-7,7,0,7,1,8,2,0,2,2,2,4,-1,2,1,1,9,-1,1,-5,4,3,0,1,1,1,1,1,4,-1
KR_6683055161,420,-3,-28,2,-3,-1,3,2,1,0,1,-3,4,1,1,1,2,-1,1,0,0,2,-4,-5,-1,6,5,0,-2,1,-1,-1,-1,1,-1
KR_6688015330,420,3,36,43,4,4,2,6,2,2,4,-1,2,1,0,1,1,-1,1,0,0,0,5,-2,0,2,2,0,1,1,-1,1,1,3,-1
KR_6644681009,420,-4,-88,-36,-7,-2,2,0,-6,7,1,-1,1,0,-2,5,3,4,0,4,-1,-6,4,-7,-2,9,-4,0,-1,-1,1,-1,-1,3,-1
KR_6757838241,420,-3,-97,-12,-14,-11,11,0,-4,5,1,0,2,2,0,2,2,1,0,1,-2,-2,-151,0,-1,1,-3,0,-5,-1,-1,-1,-1,2,-1
KR_6757625744,420,2,40,16,4,-2,2,0,4,1,5,-1,3,2,0,3,3,3,1,4,0,3,9,3,-5,2,1,0,0,1,1,0,-1,6,-1
KR_6686367011,420,0,-45,8,-2,4,0,4,-2,5,3,2,0,2,-7,8,1,1,0,1,0,-2,7,2,-5,3,-3,0,0,0,0,0,-1,0,-1
KR_6663032098,420,-3,-78,-8,-9,-3,4,1,-1,4,3,0,0,0,-4,5,1,-1,1,0,0,-10,6,0,-2,2,-1,0,-1,-1,0,-1,-1,2,-1
KR_6713646874,440,-4,-21,-20,2,-4,4,0,3,2,5,6,1,7,-1,4,3,-2,2,0,0,2,1,1,-3,2,0,0,-1,-1,0,-1,1,3,-1
KR_6694940022,420,-4,-31,-12,-9,-1,2,1,-1,3,2,-5,5,0,-1,2,1,-1,1,0,0,-6,2,-1,-1,2,0,0,-1,1,0,-1,-1,4,-1
KR_6762826359,420,-5,-32,-40,-14,-1,3,2,-2,4,2,-1,1,0,-11,12,1,1,0,1,1,-5,-13,-3,-1,4,2,0,-1,1,-1,-1,1,5,-1
KR_6750842668,440,1,46,4,2,0,2,2,-2,4,2,0,0,0,5,3,8,-1,1,0,0,-3,15,-3,-2,5,-1,0,1,0,0,1,-1,0,-1
KR_6587375337,420,0,-39,-8,-4,-4,6,2,-1,5,4,-1,1,0,2,2,4,0,1,1,0,-6,3,-2,-2,4,-1,0,-1,-1,-1,-1,-1,1,-1
KR_6478733248,420,-1,-49,6,0,2,1,3,-1,3,2,1,1,2,-3,4,1,1,1,2,0,0,-7,0,-3,3,4,0,-1,1,-1,-1,-1,1,-1
KR_6659520869,420,-1,-3,5,-7,-2,3,1,2,2,4,0,1,1,-5,6,1,-2,4,2,-1,-9,0,-3,-4,7,-1,0,0,0,0,0,-1,0,-1
KR_6754759185,420,-5,-42,0,-14,-4,6,2,-3,4,1,0,2,2,-1,3,2,-6,7,1,-2,-10,0,-2,0,2,-2,0,-3,-1,0,-1,-1,1,-1
KR_6760462036,420,2,-45,10,-3,-1,2,1,3,0,3,1,2,3,-7,7,0,1,0,1,0,-4,-41,-3,0,3,21,0,-1,1,-1,-1,-1,1,-1
KR_6409385474,420,-4,-95,4,-13,-4,4,0,-1,2,1,-4,9,5,-6,7,1,2,0,2,0,-10,-11,0,-4,4,-6,0,-4,-1,0,-1,-1,3,-1
KR_6658539821,420,-4,-22,-18,-2,-3,5,2,3,0,3,-3,4,1,3,2,5,-2,3,1,0,2,-2,-1,-3,4,-1,0,-1,-1,-1,-1,-1,4,-1
KR_6684351874,420,3,107,0,2,-1,5,4,1,1,2,0,1,1,-2,3,1,4,2,6,0,-2,-5,2,-4,2,0,0,1,1,0,1,1,4,-1
KR_6618253499,420,1,-72,12,-2,-1,2,1,3,3,6,5,3,8,-3,5,2,-6,6,0,-1,-7,18,-3,0,3,2,0,-1,-1,-1,-1,-1,1,-1
KR_6611957398,420,-4,5,-44,-7,-2,3,1,-3,9,6,-1,1,0,2,1,3,-3,4,1,0,-9,39,1,-3,2,-28,0,-2,-1,1,-1,-1,1,-1
KR_6671213396,420,-1,-7,-24,3,-3,6,3,0,2,2,-1,4,3,6,0,6,1,0,1,0,4,1,-1,-4,5,2,0,-1,-1,1,-1,-1,4,-1
KR_6722268534,440,-3,-37,12,-7,-4,4,0,-2,5,3,0,2,2,-3,5,2,2,1,3,-2,-15,-46,-2,-3,5,17,0,-2,1,-1,-1,-1,5,-1
KR_6625103770,420,2,-12,-24,3,1,2,3,-4,6,2,1,3,4,6,1,7,-1,3,2,1,3,-4,-1,-1,2,0,0,0,1,1,1,1,3,-1
KR_6762744749,420,-4,-83,4,-4,-2,2,0,-2,2,0,1,0,1,0,2,2,-1,2,1,-1,-3,-7,2,-4,2,-3,0,-1,0,0,-1,-1,0,-1
KR_6601649642,420,-1,-11,-7,-7,-1,1,0,0,0,0,-2,2,0,-3,5,2,-1,1,0,0,-2,9,-2,-3,5,1,0,0,-1,0,0,-1,5,-1
KR_6762983540,420,1,52,8,4,4,0,4,4,3,7,4,1,5,-2,3,1,-6,7,1,-1,-4,-4,-2,0,2,1,0,2,-1,1,1,-1,1,-1
KR_6757799401,440,-1,-21,-3,-1,0,2,2,-1,3,2,-1,4,3,1,3,4,0,1,1,0,-3,51,5,-8,3,-2,0,-1,1,-1,-1,-1,1,-1
KR_6695180577,420,0,15,-1,1,2,4,6,4,1,5,-3,6,3,-1,2,1,-1,2,1,0,-4,-2,-1,0,1,2,0,0,1,1,-1,-1,1,-1
KR_6725192841,420,1,17,-22,3,5,1,6,0,1,1,0,2,2,-1,2,1,-1,2,1,0,2,-81,-1,-2,3,1,0,1,-1,1,1,-1,4,-1
KR_6697257965,420,-5,-53,-59,-2,-1,2,1,0,1,1,2,2,4,1,1,2,-4,7,3,0,-3,0,-3,-1,4,-4,0,-1,-1,-1,-1,1,4,-1
KR_6661542212,420,1,-52,-12,7,2,0,2,0,0,0,5,0,5,-1,2,1,1,0,1,0,6,4,3,-3,0,-5,0,-1,-1,1,-1,1,4,-1
KR_6626691513,420,-4,-73,-12,-5,-1,1,0,-2,5,3,-1,4,3,-4,7,3,3,0,3,0,-6,-4,-4,-3,7,2,0,-1,1,1,-1,1,1,-1
KR_6662989222,420,0,13,-4,4,1,3,4,-1,5,4,0,3,3,3,1,4,1,3,4,0,0,-139,-1,-1,2,1,0,1,-1,-1,1,-1,6,-1
KR_6721964356,420,-2,-4,-15,-4,1,0,1,1,2,3,-3,4,1,-4,6,2,1,0,1,0,-5,-5,0,-1,1,-3,0,-1,-1,1,-1,1,5,-1
KR_6662876576,440,-1,12,-1,-10,0,2,2,-3,5,2,3,0,3,-7,7,0,-3,4,1,-1,-15,5,-1,-3,4,1,0,0,-1,1,-1,-1,1,-1
KR_6746569413,420,0,-4,16,9,4,2,6,4,3,7,2,1,3,0,3,3,-1,1,0,0,15,-38,2,-5,3,21,0,1,-1,-1,-1,1,3,-1
KR_6669564745,420,0,50,-22,-3,5,0,5,3,2,5,-6,7,1,-4,5,1,-1,1,0,2,-3,2,1,-7,6,-2,0,0,-1,-1,-1,1,4,-1
KR_6746364442,420,-1,-63,-24,-2,-2,3,1,0,4,4,1,1,2,-3,4,1,2,1,3,-1,2,239,-5,-1,6,27,0,-1,-1,1,-1,-1,6,-1
KR_6727171015,420,2,29,12,2,2,0,2,-3,5,2,2,2,4,1,0,1,0,0,0,0,-1,-224,1,-6,5,0,0,0,1,-1,0,1,2,-1
KR_6746706440,420,1,-25,13,6,0,3,3,2,2,4,2,2,4,3,2,5,-1,1,0,0,2,179,0,-4,4,2,0,1,1,1,1,1,5,-1
KR_6661648222,420,-1,50,-16,2,-1,2,1,-2,6,4,3,3,6,0,0,0,2,1,3,0,1,28,-2,-1,3,-11,0,0,-1,0,1,1,1,-1
KR_6559357520,420,-2,-84,-33,2,1,0,1,2,2,4,2,0,2,-1,3,2,-2,3,1,1,10,16,-1,-2,3,2,0,0,1,-1,0,1,1,-1
KR_6755014204,440,0,12,24,0,0,1,1,-3,4,1,2,2,4,1,2,3,0,1,1,0,-3,-484,-4,0,4,-3,0,-1,-1,-1,-1,-1,5,-1
KR_6740641332,420,-1,-10,-12,-1,5,0,5,0,2,2,2,2,4,-7,8,1,-1,1,0,-1,-4,-21,-4,-2,6,2,0,-1,-1,0,-1,-1,2,-1
KR_6628941693,420,-5,-65,-48,-16,-6,7,1,0,1,1,-7,7,0,3,1,4,-6,8,2,0,-14,-10,-2,0,2,1,0,-1,-1,-1,-1,-1,5,-1
KR_6638332079,420,-1,-44,-24,-5,0,1,1,-9,10,1,1,3,4,-4,4,0,7,1,8,-1,-10,2,1,-7,6,-3,0,0,-1,-1,0,-1,2,-1
KR_6737869467,420,-3,-60,16,-11,-5,6,1,-1,2,1,-2,3,1,-3,4,1,0,1,1,0,-3,-14,0,-4,4,3,-1,-4,-1,-1,-1,-1,2,-1
KR_6728556715,440,2,0,4,2,-2,2,0,-2,6,4,3,1,4,1,2,3,2,0,2,0,4,20,5,-7,2,-2,0,-1,0,1,-1,-1,0,-1
KR_6745535035,420,-2,-45,-10,-12,-4,5,1,-1,3,2,1,0,1,-6,6,0,-2,5,3,0,-10,11,0,-1,1,3,0,-1,1,0,-1,-1,3,-1
KR_6717857453,440,1,30,6,2,2,0,2,-1,6,5,-1,2,1,3,1,4,-1,2,1,0,-1,-3,0,-7,7,0,0,0,-1,1,0,1,1,-1
KR_6762258003,420,3,121,9,4,4,1,5,2,2,4,-1,3,2,-2,4,2,1,1,2,0,-3,7,-3,-2,5,-4,0,2,0,-1,1,1,0,-1
KR_6654920919,420,-4,-47,-12,-5,-5,7,2,-3,4,1,1,1,2,1,1,2,1,0,1,0,-2,3,2,-5,3,-4,0,0,-1,0,-1,1,6,-1
KR_6751471402,420,4,41,36,7,0,0,0,4,0,4,1,2,3,-3,4,1,5,0,5,0,8,1,5,-5,0,-3,0,2,-1,1,1,1,1,-1
KR_6742589424,440,-3,-14,3,-6,-3,4,1,1,3,4,-3,5,2,-1,2,1,0,0,0,0,-7,-18,0,-4,4,6,0,0,-1,1,0,-1,3,-1
KR_6751973636,420,1,-18,8,4,1,1,2,0,3,3,5,1,6,0,2,2,-2,3,1,0,1,23,2,-2,0,-1,0,0,1,0,0,1,6,-1
KR_6653097208,420,0,7,7,6,-2,3,1,-1,3,2,6,0,6,2,0,2,1,0,1,0,1,4,0,-3,3,-1,-1,0,1,-1,-1,-1,2,-1
KR_6725287338,420,-6,-65,-39,-9,-1,2,1,-1,3,2,2,2,4,-8,9,1,-1,1,0,0,-6,-6,2,-4,2,1,0,-2,-1,-1,-1,-1,3,-1
KR_6731674565,420,-2,-72,-20,0,-1,4,3,-2,3,1,-2,4,2,2,1,3,3,0,3,0,5,285,-1,-2,3,1,0,1,1,-1,-1,1,5,-1
KR_6654836384,420,-2,0,-24,-4,2,0,2,-4,6,2,1,3,4,0,1,1,-3,4,1,0,-12,6,-3,-2,5,0,0,0,-1,-1,0,1,4,-1
KR_6731552983,420,-2,-54,6,-11,-5,5,0,-4,5,1,-1,5,4,0,3,3,-1,1,0,0,-15,-41,4,-7,3,24,0,-1,-1,1,-1,1,4,-1
KR_6745891075,420,-6,24,-12,-14,-5,5,0,0,1,1,-7,8,1,-3,3,0,1,1,2,0,-5,7,0,-5,5,2,0,-1,1,0,-1,-1,2,-1
KR_6682988049,420,-5,-12,-24,-9,-6,6,0,-5,6,1,-3,4,1,7,0,7,-2,2,0,0,0,7,0,-4,4,-3,0,-2,1,-1,-1,1,5,-1
KR_6752658930,440,-2,4,4,-3,-4,4,0,2,2,4,0,2,2,-2,3,1,1,1,2,0,4,-8,0,-1,1,2,0,0,0,0,0,-1,0,-1
KR_6650323335,420,-6,-113,40,-5,1,2,3,1,3,4,-4,6,2,0,3,3,-3,3,0,1,0,-1,-3,-4,7,-4,0,-4,1,-1,-1,1,2,-1
KR_6637102340,440,-4,-17,4,-3,0,3,3,1,0,1,-1,3,2,-2,5,3,-1,3,2,0,-15,228,-2,-2,4,1,0,-1,-1,1,-1,1,1,-1
KR_6616742897,420,5,-14,32,12,2,0,2,0,2,2,5,1,6,3,0,3,2,0,2,0,11,-226,-1,-3,4,2,0,0,0,1,1,-1,0,-1
KR_6698020298,420,2,71,-1,-2,-1,2,1,-1,3,2,0,3,3,0,1,1,0,0,0,0,-4,-7,3,-4,1,0,0,0,1,1,1,1,6,-1
KR_6638290767,420,-5,-96,-2,-13,-2,2,0,-3,3,0,-5,5,0,-3,5,2,0,1,1,0,-9,115,-2,-3,5,-4,0,-2,-1,-1,-1,-1,3,-1
KR_6691118392,440,-1,-18,-32,-2,1,0,1,0,2,2,-4,5,1,2,0,2,-1,1,0,0,2,1,1,-6,5,1,0,-1,-1,1,-1,1,2,-1
KR_6673919037,420,-3,-75,4,-9,0,1,1,1,0,1,-2,2,0,-9,11,2,1,0,1,0,-7,1,-1,-2,3,-1,0,0,-1,-1,0,-1,6,-1
KR_6759901348,440,-1,-58,21,-6,3,2,5,-1,2,1,-5,6,1,-2,4,2,-1,1,0,0,-12,-8,-1,-3,4,3,0,0,-1,1,1,-1,6,-1
KR_6745364967,420,-2,-123,-8,-4,-1,1,0,-2,2,0,1,0,1,-2,2,0,0,0,0,0,-6,-3,-4,-2,6,0,0,0,-1,1,0,-1,5,-1
KR_6737521347,420,-1,-12,0,-3,2,0,2,0,2,2,-2,5,3,-3,4,1,0,1,1,0,-3,-9,2,-4,2,0,0,0,-1,1,0,-1,3,-1
KR_6757968917,420,-4,-27,-31,-3,-3,3,0,-4,7,3,4,2,6,1,2,3,-1,3,2,0,0,-27,-3,-1,4,1,0,1,-1,1,-1,1,3,-1
KR_6624540647,420,-3,-36,0,-7,1,0,1,0,1,1,-1,1,0,-5,8,3,-2,2,0,0,-14,-7,-1,-2,3,-3,0,0,1,1,0,-1,1,-1
KR_6668573813,420,-4,-26,-1,-3,-2,2,0,0,1,1,5,0,5,-3,5,2,-3,4,1,0,1,-28,5,-6,1,0,0,0,1,-1,0,-1,5,-1
KR_6707856206,420,-1,22,0,-11,-3,5,2,-3,6,3,-1,2,1,-4,8,4,0,3,3,-2,-11,-8,-3,-1,4,1,0,0,0,-1,1,-1,0,-1
KR_6741874375,420,-1,-11,-32,-1,2,2,4,1,2,3,-3,3,0,0,1,1,-1,1,0,0,-4,151,-2,-3,5,2,0,0,1,-1,0,-1,1,-1
KR_6762619197,440,-1,54,-16,1,-1,2,1,0,3,3,1,3,4,2,1,3,-1,3,2,0,-2,6,-1,-1,2,0,0,-1,-1,-1,1,-1,6,-1
KR_6715415762,420,-2,-7,-1,-2,-6,8,2,2,0,2,-3,5,2,5,3,8,0,0,0,1,4,1,0,-3,3,1,0,-1,-1,-1,-1,1,4,-1
KR_6746729236,420,1,12,32,2,-5,6,1,1,1,2,7,1,8,-2,2,0,1,3,4,1,-4,-13,-1,-2,3,3,0,0,1,1,1,1,1,-1
KR_6745120053,420,-2,-53,-8,2,6,0,6,-1,3,2,1,3,4,-3,3,0,-1,1,0,-1,-2,8,2,-3,1,-24,0,1,1,-1,1,-1,2,-1
KR_6618503406,420,2,8,-8,0,2,0,2,-1,3,2,-1,3,2,0,1,1,0,0,0,0,-5,16,0,-2,2,4,0,0,-1,1,0,-1,1,-1
KR_6627216568,420,-4,12,-24,-7,-2,2,0,-4,4,0,-8,8,0,7,1,8,0,0,0,0,2,-132,0,-2,2,0,0,-1,1,1,-1,-1,2,-1
KR_6649315357,420,-4,1,-25,-8,-3,4,1,-1,2,1,-2,6,4,-3,5,2,1,1,2,0,-6,-20,0,-2,2,-2,0,-1,-1,-1,-1,-1,4,-1
KR_6742725591,420,-6,-74,-40,-9,-3,4,1,-4,4,0,-1,2,1,-1,2,1,0,1,1,0,-11,2,-3,-1,4,1,0,0,-1,-1,-1,-1,5,-1
KR_6734420613,420,-5,-118,-44,-13,-2,2,0,-4,4,0,-2,2,0,0,2,2,-5,5,0,0,-15,-21,-6,-2,8,-1,0,-1,0,-1,-1,-1,0,-1
KR_6699260739,420,-1,-55,76,-6,-2,2,0,-1,2,1,-1,2,1,-2,2,0,0,0,0,-1,-4,8,-5,-1,6,-2,0,0,0,0,0,-1,0,-1
KR_6653491129,420,-6,-46,-4,-16,-3,3,0,-2,4,2,-5,8,3,-3,3,0,-3,4,1,0,-9,1,-4,0,4,-2,0,-1,-1,-1,-1,-1,2,-1
KR_6724730785,420,-5,-36,0,-9,-1,1,0,0,0,0,4,0,4,-14,16,2,2,1,3,0,-5,34,1,-2,1,-28,0,-1,-1,-1,-1,-1,3,-1
KR_6699420704,420,5,-3,32,2,0,1,1,2,1,3,-1,2,1,-1,6,5,2,0,2,-1,-6,-2,2,-3,1,1,0,1,1,1,1,-1,5,-1
KR_6758260502,420,0,-88,0,-3,1,0,1,6,2,8,-4,6,2,-4,7,3,-2,2,0,-1,-1,16,-2,-5,7,-8,0,0,0,0,0,-1,0,-1
KR_6621815709,420,2,37,4,0,-1,2,1,-4,6,2,-2,3,1,6,0,6,1,0,1,0,-1,17,3,-4,1,0,0,0,1,-1,1,-1,5,-1
KR_6456417563,420,-3,-15,-4,-14,-2,2,0,1,0,1,-6,7,1,-6,7,1,-1,1,0,0,-9,6,-1,-3,4,-4,0,0,-1,1,0,-1,2,-1
KR_6739464294,420,0,-28,-20,8,1,3,4,-3,6,3,0,4,4,6,1,7,4,0,4,0,11,-6,0,-1,1,1,0,0,-1,0,0,-1,3,-1
KR_6685594710,420,-8,-81,-37,-14,-2,5,3,-6,6,0,-1,2,1,-5,5,0,0,1,1,1,-9,-33,-3,-2,5,-2,0,-3,0,0,-1,1,0,-1
KR_6762951639,440,-2,-58,8,-1,4,0,4,2,1,3,1,1,2,-2,2,0,-6,7,1,0,0,5,1,-2,1,0,0,-1,-1,1,1,-1,3,-1
KR_6621841602,420,-1,16,40,-5,3,1,4,-1,3,2,-2,3,1,-4,7,3,-1,1,0,-1,-13,7,1,-5,4,-2,0,2,-1,1,1,-1,2,-1
KR_6760176610,420,-1,-69,0,-8,-2,3,1,-1,5,4,-1,5,4,-6,7,1,2,0,2,0,-7,24,1,-1,0,-1,0,0,0,0,0,1,0,-1
KR_6722940981,440,-2,-58,-16,0,0,2,2,0,4,4,1,4,5,-1,3,2,0,1,1,0,0,3,-1,-3,4,2,0,0,-1,1,-1,1,6,-1
KR_6605175781,420,1,-29,-8,2,2,2,4,0,0,0,5,2,7,-5,6,1,0,1,1,1,5,-21,-2,-4,6,12,0,-2,1,-1,-1,1,2,-1
KR_6525105094,420,1,20,4,-6,1,1,2,-1,1,0,0,2,2,-7,7,0,1,4,5,0,-9,10,1,-1,0,-1,0,0,1,1,-1,-1,6,-1
KR_6726681110,420,2,63,-12,3,3,1,4,1,4,5,-6,7,1,2,1,3,3,0,3,0,9,46,-2,-1,3,-22,0,-1,1,-1,1,1,2,-1
KR_6535726587,420,-1,-35,-52,2,3,0,3,2,2,4,-3,4,1,2,2,4,-2,2,0,0,6,-5,0,-4,4,1,0,1,0,-1,-1,1,0,-1
KR_6715593454,420,-4,-55,-8,-2,-3,5,2,4,1,5,-2,3,1,2,1,3,-3,4,1,0,2,-383,-1,-1,2,-3,0,-1,-1,-1,-1,1,6,-1
KR_6763311114,440,-1,-25,-40,2,1,2,3,-2,4,2,2,1,3,2,3,5,-1,2,1,0,3,6,2,-6,4,-1,0,0,-1,-1,0,1,3,-1
KR_6618747007,420,-4,-76,-23,0,-3,3,0,-2,3,1,0,4,4,1,3,4,4,0,4,0,1,-12,-3,0,3,0,0,0,-1,-1,-1,-1,5,-1
KR_6756384150,420,-4,-40,12,-11,-5,5,0,-2,2,0,-2,3,1,1,4,5,-3,3,0,0,-4,3,-1,-2,3,1,0,-1,-1,-1,-1,-1,1,-1
KR_6302694080,420,1,-10,-23,-4,-3,3,0,0,1,1,0,2,2,0,2,2,-1,2,1,0,1,1,2,-4,2,-3,0,-1,1,-1,-1,-1,5,-1
KR_6726656303,420,-1,8,0,-7,3,0,3,3,1,4,-7,7,0,-8,9,1,2,1,3,-1,-7,-174,-2,-4,6,-1,0,0,-1,-1,0,-1,2,-1
KR_6632396589,440,-5,44,-20,-9,1,2,3,-4,6,2,-1,2,1,-3,4,1,-2,4,2,0,-5,-2,2,-5,3,-3,0,0,-1,1,0,-1,4,-1
KR_6722261556,420,-2,-74,11,2,-4,5,1,4,1,5,-1,3,2,1,1,2,2,0,2,0,3,-16,-1,-1,2,2,0,0,0,1,0,-1,0,-1
KR_6622637161,420,-2,-59,-8,-5,-3,6,3,3,1,4,0,3,3,-3,3,0,-2,6,4,0,-5,23,1,-5,4,-3,0,-2,0,0,-1,-1,0,-1
KR_6728670329,440,4,48,6,7,0,1,1,0,2,2,2,1,3,4,0,4,1,1,2,0,0,-3,0,-2,2,-2,0,1,-1,1,1,1,2,-1
KR_6744668695,420,-4,-5,-35,-5,2,1,3,2,2,4,-7,8,1,-1,3,2,-1,2,1,1,-13,233,-2,-1,3,-1,0,-1,-1,-1,-1,1,3,-1
KR_6710859675,420,-2,-8,-23,-7,-2,2,0,2,1,3,-4,4,0,-3,3,0,0,2,2,0,-3,-8,3,-5,2,-2,0,-1,0,-1,-1,-1,0,-1
KR_6717231579,440,-7,-96,-29,-16,-5,6,1,-2,3,1,-6,7,1,-2,5,3,-1,3,2,-1,-7,1,-8,-1,9,5,0,0,-1,-1,-1,-1,2,-1
KR_6633861571,420,-3,-50,-16,-8,4,0,4,-4,8,4,-4,5,1,-2,2,0,-2,2,0,0,-7,3,0,-3,3,1,0,0,1,0,0,1,5,-1
KR_6736440361,420,-3,-42,-39,2,1,4,5,0,2,2,4,1,5,-3,4,1,0,0,0,0,-5,0,-1,-2,3,0,0,1,-1,1,1,1,3,-1
KR_6738049422,420,2,-1,13,6,-3,4,1,-1,1,0,3,0,3,7,0,7,0,1,1,0,5,-49,2,-6,4,30,0,0,-1,-1,-1,1,4,-1
KR_6719019512,440,-5,-119,-28,-20,-7,8,1,-3,5,2,-3,3,0,-4,6,2,-3,4,1,0,-8,4,-3,0,3,0,0,-3,-1,-1,-1,-1,2,-1
KR_6737506304,420,-3,-44,4,-6,-2,2,0,-1,6,5,3,3,6,-2,3,1,-4,4,0,0,-11,2,1,-2,1,-1,0,-3,-1,-1,-1,-1,1,-1
KR_6628682290,420,1,-59,-8,9,-1,3,2,7,0,7,1,1,2,-1,5,4,3,1,4,0,14,34,6,-6,0,0,0,0,-1,-1,-1,-1,6,-1
KR_6749191238,420,-1,32,-20,4,-1,2,1,1,1,2,4,1,5,2,2,4,-2,2,0,1,5,-126,3,-4,1,2,0,0,1,1,0,1,3,-1
KR_6422191296,420,-3,-88,0,-8,-7,8,1,1,2,3,0,2,2,-3,5,2,1,0,1,-1,-5,-226,-1,0,1,2,0,-2,-1,-1,-1,-1,4,-1
KR_6756450282,420,-4,0,-20,-9,0,0,0,-1,2,1,-3,4,1,-5,5,0,0,1,1,0,-8,10,-3,0,3,0,0,-1,-1,-1,-1,1,1,-1
KR_6362888730,440,-8,-125,-19,-18,-3,3,0,-2,5,3,-4,4,0,-7,9,2,-2,3,1,-1,-10,0,0,0,0,1,0,-2,-1,0,-1,-1,3,-1
KR_6569822170,420,-5,-60,-1,-11,-6,7,1,-3,5,2,-1,5,4,-3,3,0,2,0,2,0,1,-9,-1,-3,4,4,0,-3,-1,-1,-1,-1,3,-1
KR_6719769901,420,-4,-52,-24,-1,2,1,3,-6,7,1,0,2,2,2,2,4,1,0,1,0,-3,-99,2,-4,2,-4,0,-2,-1,-1,-1,1,4,-1
KR_6683596885,420,-1,-40,-29,0,-2,4,2,0,2,2,1,2,3,0,1,1,1,2,3,-1,-4,-15,-1,-2,3,2,0,-1,1,-1,-1,-1,1,-1
KR_6692428764,420,-1,-16,-15,-1,-2,3,1,2,1,3,0,2,2,-1,3,2,0,0,0,0,-1,-5,1,-6,5,-4,0,0,-1,1,0,-1,3,-1
KR_6641022730,420,-3,-50,-8,-11,-3,3,0,2,1,3,-3,4,1,-1,1,0,-6,6,0,0,-3,-12,-1,-3,4,-2,0,-1,-1,-1,-1,-1,6,-1
KR_6747715721,420,3,38,-23,6,4,0,4,6,2,8,-1,2,1,-3,6,3,0,0,0,0,5,3,0,-2,2,0,0,0,0,0,0,1,0,-1
KR_6720177443,440,1,-6,22,3,-3,3,0,4,0,4,-3,4,1,2,1,3,3,1,4,0,0,-5,-2,-2,4,1,0,0,0,-1,1,-1,0,-1
KR_6687330010,420,-2,-28,-37,-4,0,4,4,-15,15,0,0,2,2,5,0,5,6,0,6,0,2,10,-1,-2,3,-2,0,0,0,0,1,1,0,-1
KR_6673115266,420,-3,-90,-23,-5,-1,3,2,-5,7,2,1,0,1,0,3,3,0,0,0,0,-5,-1,3,-4,1,-3,0,-2,-1,1,-1,1,2,-1
KR_6726315575,420,-5,17,8,-15,0,0,0,-13,13,0,-3,3,0,0,2,2,1,1,2,0,-17,-164,-4,-3,7,-36,0,0,1,-1,-1,1,6,-1
KR_6623573064,440,-1,34,-18,2,1,0,1,1,2,3,-3,5,2,0,1,1,3,0,3,0,3,5,-4,-2,6,1,0,0,1,1,0,1,5,-1
KR_6078554926,420,-1,-38,15,0,-1,1,0,3,1,4,-6,7,1,1,1,2,3,0,3,0,3,2,0,-5,5,-2,0,0,1,1,-1,-1,4,-1
KR_6637212970,420,-7,-76,-20,-14,-2,2,0,-6,7,1,-1,3,2,-2,3,1,-3,3,0,0,-13,-24,-2,-2,4,0,0,-2,-1,1,-1,-1,4,-1
KR_6530819965,420,0,-40,-28,-2,2,0,2,-2,7,5,2,2,4,-2,2,0,-2,2,0,0,-3,-12,-2,-3,5,-1,0,0,-1,-1,-1,-1,4,-1
KR_6604177089,420,-2,25,-18,-9,1,1,2,-3,4,1,0,1,1,-6,7,1,-1,2,1,0,-11,-46,-2,-1,3,6,0,0,1,1,-1,-1,2,-1
KR_6753048485,420,1,23,-20,1,5,0,5,-2,4,2,-7,8,1,3,2,5,2,0,2,0,4,24,1,-2,1,2,0,-1,1,-1,-1,-1,4,-1
KR_6618848070,420,-1,-35,-32,1,-6,6,0,-2,3,1,6,0,6,0,1,1,3,1,4,-1,1,13,0,-1,1,1,0,-1,1,1,-1,-1,4,-1
KR_6704000424,420,0,6,12,-2,4,3,7,1,2,3,-1,3,2,-1,7,6,-5,7,2,-1,-10,356,-3,-1,4,-1,0,0,1,1,-1,-1,2,-1
KR_6764654280,420,-1,-51,17,-3,-6,6,0,-1,2,1,4,1,5,-1,1,0,1,2,3,-1,2,2,-4,-1,5,0,0,0,0,1,0,-1,0,-1
KR_6676098886,420,-5,-83,-15,-8,-4,5,1,-1,3,2,-3,3,0,-3,4,1,3,1,4,0,-2,-7,-2,0,2,-4,0,-2,1,-1,-1,-1,2,-1
KR_6602367107,420,2,3,0,-2,-1,2,1,1,2,3,-4,5,1,3,2,5,-1,1,0,0,0,0,3,-4,1,0,0,-1,-1,-1,-1,1,2,-1
KR_6725762495,420,-1,-63,-29,-3,-2,3,1,-1,2,1,0,0,0,-2,2,0,2,0,2,1,-2,6,-1,-2,3,-3,0,-2,-1,-1,-1,1,6,-1
KR_6736539793,420,1,84,8,-1,1,1,2,-5,7,2,-2,5,3,2,1,3,3,0,3,0,-2,-3,-1,-2,3,-2,0,0,0,-1,0,-1,0,-1
KR_6635116511,420,-1,31,-13,3,5,1,6,-1,3,2,-4,6,2,0,2,2,3,0,3,0,-6,-141,-4,-1,5,0,0,0,-1,0,1,1,5,-1
KR_6748425359,440,-8,-43,-4,-24,-7,7,0,0,1,1,-3,4,1,-11,11,0,-3,3,0,0,-19,-198,-4,0,4,1,0,-2,1,-1,-1,-1,3,-1
KR_6701768421,420,-2,1,12,-6,-2,2,0,-3,3,0,1,1,2,1,2,3,-3,3,0,0,-6,-5,-1,-2,3,-5,0,-1,-1,-1,-1,-1,1,-1
KR_6599831685,420,-2,-57,-8,-3,-3,3,0,-2,2,0,1,4,5,0,3,3,1,0,1,1,-5,1,0,-3,3,3,0,-1,-1,0,-1,-1,4,-1
KR_6729945921,440,6,129,20,12,-2,3,1,1,0,1,0,4,4,0,1,1,13,2,15,1,4,-4,-1,-1,2,2,0,0,0,0,1,1,0,-1
KR_6693392314,440,1,-11,-1,-7,13,0,13,-5,5,0,-8,9,1,-3,5,2,-4,4,0,1,-13,1,-1,-1,2,1,0,1,-1,0,1,1,6,-1
KR_6743462076,420,2,-6,-13,9,3,1,4,-1,2,1,3,1,4,2,3,5,2,0,2,0,5,104,2,-3,1,0,0,1,1,-1,1,1,2,-1
KR_6672946834,440,-6,-78,-44,-14,-4,6,2,-3,4,1,-1,2,1,-5,5,0,-1,1,0,-1,-20,-3,-4,-3,7,-3,0,-2,0,0,-1,-1,0,-1
KR_6742332904,440,-5,-59,0,-2,1,4,5,-1,4,3,1,6,7,-1,3,2,-2,3,1,0,-3,19,8,-10,2,-3,0,-1,1,0,-1,1,4,-1
KR_6708979802,440,-2,-74,-25,-4,1,1,2,0,2,2,-6,7,1,2,1,3,-1,4,3,0,3,2,2,-4,2,-2,0,-2,-1,-1,-1,1,2,-1
KR_6606950618,420,1,-19,16,-1,2,1,3,-4,4,0,-2,3,1,2,1,3,1,1,2,0,-4,-8,-7,-2,9,2,0,0,-1,-1,1,-1,2,-1
KR_6238274001,420,-5,-13,-20,-3,-3,3,0,-3,5,2,0,3,3,3,0,3,0,0,0,1,5,2,0,-2,2,1,0,0,-1,1,0,1,4,-1
KR_6609462097,440,-3,-63,5,-9,-2,2,0,1,0,1,-2,2,0,-4,5,1,-2,2,0,0,-7,-40,-3,0,3,27,0,-1,1,-1,-1,-1,5,-1
KR_6732054353,440,1,0,-12,2,4,0,4,1,1,2,-9,10,1,3,0,3,3,1,4,1,7,-28,0,-3,3,-1,0,0,-1,1,-1,1,2,-1
KR_6750146390,440,-2,1,11,-4,4,0,4,-5,5,0,0,1,1,-5,5,0,2,1,3,0,-8,-236,0,-2,2,-30,0,0,-1,1,0,1,4,-1
KR_6733479716,420,1,-3,4,9,3,0,3,3,0,3,3,0,3,0,2,2,0,1,1,0,7,-19,0,-3,3,1,0,0,-1,1,1,1,5,-1
KR_6757566562,420,-3,-91,3,-2,-5,7,2,-1,2,1,-1,3,2,6,0,6,-1,3,2,0,5,-2,-1,-3,4,0,0,-4,1,-1,-1,-1,2,-1
KR_6723686258,420,2,39,-4,12,0,3,3,-1,1,0,5,1,6,7,1,8,1,2,3,0,10,3,1,-3,2,-2,0,0,-1,1,0,1,6,-1
KR_6727591114,420,-2,-75,28,0,1,2,3,-3,7,4,-2,3,1,2,1,3,2,0,2,1,0,3,2,-7,5,-1,0,0,0,-1,0,-1,0,-1
KR_6743398439,420,5,-39,24,15,-4,4,0,5,1,6,3,0,3,9,0,9,2,1,3,0,18,-4,0,-4,4,1,0,1,1,-1,1,1,5,-1
KR_6682936811,420,-4,-15,16,-12,0,1,1,-4,9,5,-6,7,1,0,1,1,-2,3,1,-1,-12,-364,2,-2,0,-3,0,-2,-1,-1,-1,-1,6,-1
KR_6749183688,440,2,-3,21,6,1,3,4,5,1,6,-1,2,1,1,0,1,0,0,0,0,11,-341,0,0,0,0,0,1,1,1,1,-1,4,-1
KR_6728769611,440,-4,2,-16,-5,4,0,4,-1,6,5,-4,7,3,-5,8,3,1,0,1,0,-9,3,0,-4,4,-3,0,0,-1,0,-1,-1,6,-1
KR_6759467880,440,1,-5,-3,1,-5,5,0,5,1,6,3,0,3,-1,3,2,-1,2,1,0,10,-7,-3,-2,5,4,0,-1,1,-1,-1,-1,4,-1
KR_6635188492,440,-1,-46,-4,2,0,2,2,3,2,5,-1,1,0,1,1,2,-1,2,1,0,3,182,-1,-5,6,1,0,0,0,1,0,-1,0,-1
KR_6676533105,420,3,140,-4,3,-1,4,3,0,2,2,1,1,2,2,2,4,1,0,1,0,5,14,0,-3,3,-3,0,0,-1,1,1,-1,1,-1
KR_6753026511,440,0,12,-8,-5,2,1,3,-3,4,1,-2,2,0,-3,5,2,1,7,8,0,-10,-64,0,-1,1,17,0,-1,-1,1,-1,1,4,-1
KR_6756731819,420,0,-15,-22,0,0,4,4,1,3,4,1,1,2,-2,2,0,0,1,1,0,-4,1,-4,0,4,1,0,1,-1,-1,1,1,1,-1
KR_6611892002,420,-5,-79,-20,-9,0,3,3,0,1,1,-5,5,0,-3,5,2,-1,3,2,0,-2,-281,-4,-1,5,4,0,0,0,1,0,-1,0,-1
KR_6744567589,420,-4,-77,8,-9,-6,6,0,1,1,2,-5,6,1,2,0,2,-1,2,1,0,1,-2,0,-2,2,-1,0,-1,-1,0,-1,-1,5,-1
KR_6670039052,440,-3,14,-2,-9,0,4,4,-2,2,0,1,1,2,-1,2,1,-7,9,2,-2,-11,146,-2,-2,4,0,0,-1,-1,0,-1,-1,5,-1
KR_6750553338,420,-2,52,-16,-6,2,1,3,2,0,2,-5,5,0,-3,3,0,-2,2,0,0,-7,-16,0,-3,3,-1,0,0,-1,0,0,-1,4,-1
KR_6669564813,420,2,52,-29,2,3,0,3,-3,3,0,-2,5,3,4,0,4,0,1,1,0,-1,-9,1,-5,4,4,0,0,-1,1,1,-1,6,-1
KR_6563322248,420,-3,-27,-10,-13,-2,2,0,-8,9,1,1,1,2,-4,4,0,0,0,0,0,-21,-42,-3,-1,4,-1,0,-1,-1,-1,-1,1,6,-1
KR_6597737168,420,-3,-74,-31,-4,1,1,2,-5,6,1,0,1,1,1,1,2,-1,2,1,0,-2,-14,2,-2,0,-1,0,0,1,1,-1,1,1,-1
KR_6545632712,420,2,19,12,-6,-6,6,0,-1,5,4,1,0,1,-2,2,0,2,0,2,0,-1,0,0,-2,2,1,0,0,1,1,-1,-1,1,-1
KR_6662856701,420,0,-39,4,0,3,0,3,-2,3,1,-1,5,4,-2,5,3,2,1,3,0,2,104,-1,-2,3,4,0,0,1,0,0,1,3,-1
KR_6760712949,420,1,46,16,2,-4,5,1,0,2,2,1,2,3,2,2,4,3,0,3,2,5,-9,-1,-3,4,-3,0,1,1,-1,1,1,5,-1
KR_6525315533,420,-6,-34,-12,-14,-2,2,0,-3,3,0,-2,2,0,-6,6,0,-1,1,0,0,-16,-4,-2,0,2,0,0,-1,-1,-1,-1,-1,2,-1
KR_6606659371,420,1,21,28,-3,2,2,4,-5,5,0,6,2,8,-5,5,0,-1,2,1,1,-12,22,4,-5,1,-1,0,0,-1,-1,-1,1,6,-1
KR_6735221939,420,1,-27,-12,5,1,1,2,8,0,8,1,1,2,0,1,1,-5,6,1,0,6,-44,-1,0,1,0,0,-1,-1,0,-1,1,4,-1
KR_6709017161,420,4,29,8,8,2,2,4,-1,1,0,7,0,7,3,2,5,-3,3,0,0,4,-37,1,-4,3,16,0,-2,1,1,-1,1,1,-1
KR_6711027176,420,-3,-4,-4,-7,-1,1,0,0,2,2,-3,4,1,-3,4,1,0,1,1,0,-6,-21,0,-1,1,-2,0,0,-1,1,-1,1,2,-1
KR_6635025517,420,-5,-46,-39,-7,-1,1,0,-4,4,0,3,3,6,-2,4,2,-3,3,0,0,-2,1,-4,-1,5,-4,0,-2,1,-1,-1,-1,5,-1
KR_6694187940,440,-1,-28,0,-2,-2,3,1,0,2,2,-1,3,2,1,5,6,0,2,2,1,-8,-31,1,-6,5,4,0,0,0,1,1,1,0,-1
KR_6695351842,420,-6,-94,-16,-21,-5,5,0,-6,7,1,-5,5,0,-4,4,0,-1,1,0,0,-12,-27,-4,-1,5,2,0,-3,-1,-1,-1,-1,1,-1
KR_6642936651,420,-3,-27,-4,1,-1,2,1,1,2,3,5,0,5,-5,6,1,1,1,2,0,-1,12,-2,-2,4,0,0,1,-1,1,1,-1,6,-1
KR_6727042399,420,2,21,8,3,1,3,4,-1,2,1,1,6,7,-4,7,3,6,0,6,2,0,-13,-4,-3,7,3,0,-2,-1,-1,-1,1,1,-1
KR_6529628083,420,3,72,19,5,4,0,4,3,0,3,-1,4,3,-1,6,5,0,0,0,0,6,-12,6,-6,0,-2,0,0,0,-1,0,1,0,-1
KR_6738116488,420,0,-37,6,-1,0,1,1,2,2,4,-2,4,2,0,2,2,-1,3,2,-1,-2,3,-3,-1,4,2,0,0,-1,-1,0,-1,5,-1
KR_6672514159,420,-4,-7,-13,-6,2,1,3,1,1,2,-5,5,0,-4,5,1,0,1,1,0,-7,-5,0,-2,2,3,0,0,-1,-1,0,1,2,-1
KR_6708407839,440,3,74,40,9,3,1,4,4,2,6,4,1,5,-2,5,3,0,0,0,0,9,-7,-1,-2,3,0,0,1,0,1,1,1,0,-1
KR_6712234390,420,1,-14,5,1,1,1,2,3,0,3,-3,3,0,-1,4,3,1,0,1,0,2,131,0,-2,2,1,0,-1,-1,1,1,-1,3,-1
KR_6759685949,420,-6,-81,-18,-7,1,3,4,-1,3,2,-7,9,2,1,2,3,-1,2,1,-1,-9,189,-4,-2,6,-3,0,-1,1,-1,-1,-1,4,-1
KR_6744470383,420,1,36,23,-2,2,4,6,-2,2,0,0,1,1,-4,4,0,2,2,4,0,-2,36,-4,-2,6,-5,0,0,-1,-1,1,1,2,-1
KR_6626655988,420,1,-57,-20,3,1,4,5,0,2,2,0,3,3,-1,2,1,3,0,3,-1,4,6,-3,-2,5,1,0,0,1,-1,0,-1,2,-1
KR_6638698417,420,-2,-39,8,-1,0,1,1,-2,6,4,1,2,3,0,0,0,0,0,0,0,-6,-3,-2,-3,5,0,0,-1,1,1,-1,-1,4,-1
KR_6596199887,420,2,11,-5,1,-1,2,1,3,1,4,-3,3,0,4,2,6,-2,3,1,1,11,-24,-1,-3,4,-2,0,2,-1,1,1,1,4,-1
KR_6760408342,420,0,35,-7,-2,2,0,2,-4,7,3,6,1,7,-6,7,1,0,0,0,0,-11,11,0,0,0,-1,0,-1,-1,-1,-1,-1,2,-1
KR_6761168378,420,2,5,8,5,-2,3,1,2,3,5,4,2,6,2,2,4,-1,2,1,0,-3,-19,-2,0,2,2,0,0,1,1,0,1,5,-1
KR_6488264786,420,-9,9,-24,-3,-2,2,0,-3,5,2,1,1,2,2,0,2,-1,3,2,0,-1,297,0,-1,1,1,0,0,-1,0,-1,1,6,-1
KR_6661117351,420,1,-7,20,-1,-3,6,3,4,0,4,-3,5,2,0,2,2,1,0,1,0,2,5,-6,-1,7,-5,0,-2,1,-1,-1,1,6,-1
KR_6757914722,440,-2,1,-8,-4,-4,5,1,3,1,4,-1,2,1,-1,4,3,-1,2,1,2,-6,4,-2,-5,7,-2,0,1,1,-1,1,-1,1,-1
KR_6530972922,420,-2,-45,-8,-13,-4,4,0,-3,7,4,-4,8,4,-2,7,5,0,0,0,-3,-22,-3,-3,-3,6,-2,0,-1,-1,1,-1,-1,2,-1
KR_6759112322,420,3,73,46,-3,0,2,2,-2,4,2,0,3,3,-2,4,2,1,0,1,-1,-9,-2,2,-6,4,2,0,-1,0,-1,-1,-1,0,-1
KR_6734579678,420,-3,-50,-12,-6,1,1,2,-4,4,0,-1,1,0,-1,2,1,-1,1,0,0,0,-362,-2,-2,4,0,0,-1,-1,-1,-1,-1,4,-1
KR_6696927476,420,-2,-23,-12,-11,1,3,4,-2,3,1,0,5,5,-11,14,3,1,0,1,-1,-6,-49,-5,0,5,8,0,0,-1,1,-1,-1,4,-1
KR_6759133756,420,0,-29,-28,1,-3,5,2,1,1,2,4,1,5,-1,3,2,0,0,0,0,0,-6,-4,0,4,3,0,-1,0,0,-1,-1,0,-1
KR_6757532185,420,-5,-50,-12,-5,-6,7,1,-1,2,1,2,5,7,-1,3,2,1,1,2,0,-3,0,-2,-1,3,-1,0,-2,0,1,-1,1,0,-1
KR_6742681592,420,-1,9,-28,-4,1,2,3,1,2,3,-2,2,0,-3,5,2,-1,2,1,-1,-6,-4,-5,0,5,-1,0,0,-1,-1,1,1,1,-1
KR_6687870474,420,-3,-57,6,4,-2,2,0,2,3,5,4,2,6,2,0,2,-2,4,2,0,1,-220,-1,-4,5,-5,0,1,-1,0,-1,1,4,-1
KR_6716389179,420,-4,12,16,-8,-1,2,1,-7,8,1,-3,3,0,3,2,5,0,0,0,-1,-3,-270,4,-5,1,0,0,0,-1,-1,0,-1,3,-1
KR_6752188552,440,-1,30,-37,-9,-9,9,0,-6,6,0,0,4,4,4,1,5,2,0,2,0,0,1,-2,-1,3,2,0,0,0,0,-1,-1,0,-1
KR_6654778627,420,-6,-44,-24,-14,-2,3,1,-1,2,1,-7,8,1,-4,4,0,0,1,1,0,-9,-51,1,-5,4,17,0,-2,-1,0,-1,-1,1,-1
KR_6483691652,420,1,49,21,-3,0,0,0,-7,7,0,5,1,6,0,1,1,-1,2,1,0,-9,-11,1,-3,2,3,0,0,1,1,1,-1,5,-1
KR_6763068737,420,-1,-52,-31,-3,2,0,2,-4,6,2,1,1,2,-2,2,0,0,1,1,0,-1,-121,-2,-1,3,-2,0,0,-1,1,0,-1,1,-1
KR_6763596140,420,1,10,5,6,1,0,1,-1,4,3,-1,3,2,3,0,3,4,1,5,0,8,-346,4,-5,1,2,0,0,-1,-1,0,1,5,-1
KR_6647777642,420,-4,-25,-8,-6,-4,4,0,-5,5,0,0,2,2,3,1,4,0,1,1,0,-9,-8,-2,-3,5,-5,0,0,-1,-1,0,1,4,-1
KR_6535231640,420,0,3,-24,-1,2,2,4,0,1,1,0,2,2,-4,5,1,1,3,4,0,-5,-11,-2,-2,4,6,0,-1,-1,1,-1,-1,3,-1
KR_6742426908,440,-3,-77,-8,-4,0,0,0,0,2,2,-2,2,0,-1,2,1,-1,2,1,0,-2,-16,-4,-3,7,0,0,0,-1,1,0,-1,4,-1
KR_6645598206,420,-2,21,-56,-4,2,2,4,-2,2,0,0,3,3,-4,4,0,0,0,0,-2,-12,9,6,-8,2,-4,0,0,-1,-1,0,-1,2,-1
KR_6706009883,420,-2,4,-40,-8,1,2,3,-3,5,2,0,2,2,-3,3,0,-3,3,0,0,-7,-8,0,-2,2,0,0,-1,-1,-1,-1,1,6,-1
KR_6763124339,420,-4,-96,-21,-7,0,1,1,-1,3,2,-3,4,1,-1,1,0,-2,2,0,0,-4,-36,2,-3,1,-1,0,-1,-1,1,-1,-1,4,-1
KR_6619102906,420,-1,-10,4,-2,1,0,1,3,1,4,-5,6,1,1,0,1,-2,2,0,-1,-3,81,-3,-2,5,-3,0,0,-1,1,0,-1,4,-1
KR_6761715537,420,1,10,27,0,0,1,1,2,2,4,0,3,3,0,3,3,-2,7,5,-1,-4,-4,-4,-1,5,0,0,-1,-1,1,-1,-1,5,-1
KR_6655413176,420,3,31,9,6,1,1,2,-1,2,1,7,1,8,-1,4,3,0,2,2,-1,10,-9,2,-3,1,-2,0,1,1,1,-1,-1,3,-1
KR_6580897963,420,0,28,0,2,2,3,5,-2,5,3,1,1,2,2,1,3,-1,1,0,2,2,19,-2,-3,5,-6,0,0,1,-1,0,1,3,-1
KR_6642011226,420,-5,-98,-20,-14,-7,7,0,-1,2,1,-3,3,0,-3,5,2,0,1,1,0,-14,-14,-7,-1,8,0,0,-2,-1,-1,-1,-1,1,-1
KR_6623657440,440,-2,-37,-6,-1,3,0,3,-1,1,0,3,3,6,-7,8,1,1,0,1,0,-2,13,-6,-1,7,0,0,0,-1,0,-1,-1,2,-1
KR_6743568283,420,3,22,12,2,1,0,1,3,0,3,-4,9,5,0,2,2,2,0,2,0,-4,-19,2,-4,2,-1,0,0,1,-1,-1,1,1,-1
KR_6743795369,420,-1,-72,19,-3,2,1,3,-1,2,1,0,0,0,-4,5,1,0,0,0,0,-6,-3,-1,-1,2,0,0,-2,1,-1,-1,-1,1,-1
KR_6698354089,420,-2,-70,3,-4,-3,3,0,0,2,2,-3,3,0,-1,3,2,3,0,3,0,1,2,2,-3,1,1,0,-2,1,-1,-1,-1,3,-1
KR_6481911487,420,1,-19,-5,0,-1,2,1,0,2,2,-2,5,3,5,3,8,-2,3,1,0,2,-7,1,-3,2,-1,0,-1,-1,0,-1,-1,5,-1
KR_6638853541,420,-2,-57,-14,-10,-6,6,0,-8,10,2,1,3,4,3,2,5,0,2,2,0,0,-3,0,-4,4,-1,0,-1,-1,1,-1,-1,3,-1
KR_6618895390,420,-2,-63,-40,-1,-2,6,4,0,3,3,1,3,4,-1,1,0,1,6,7,0,0,-4,0,-1,1,3,0,-1,-1,1,-1,1,6,-1
KR_6764611077,440,2,-39,52,-3,-2,2,0,1,2,3,0,4,4,-3,5,2,1,0,1,-1,-7,85,0,-2,2,-1,0,0,1,1,1,-1,6,-1
KR_6757702025,420,3,-58,8,2,4,2,6,1,2,3,-3,3,0,-1,2,1,1,1,2,0,3,12,0,-1,1,-3,0,1,1,0,1,-1,4,-1
KR_6663260224,420,0,-22,6,-1,0,2,2,0,1,1,5,2,7,-6,6,0,0,1,1,-1,-6,-9,-4,-3,7,9,0,0,-1,-1,-1,-1,1,-1
KR_6473129977,420,-4,-24,-13,-10,-2,2,0,-2,3,1,-2,2,0,-6,8,2,2,0,2,0,-9,-2,2,-6,4,3,0,0,-1,1,0,-1,1,-1
KR_6384299800,420,-6,-55,-20,-12,-2,2,0,-7,7,0,-2,4,2,-4,4,0,3,0,3,0,-6,4,-1,-2,3,2,0,-1,1,-1,-1,-1,6,-1
KR_6713582521,440,-3,-33,-12,-6,-5,6,1,2,2,4,-1,2,1,0,1,1,-2,4,2,0,-1,42,-1,-1,2,0,0,0,-1,0,-1,1,1,-1
KR_6707379707,420,1,-12,13,2,-1,2,1,1,2,3,-1,3,2,3,0,3,0,0,0,0,2,-32,-5,-2,7,1,0,0,1,-1,0,1,1,-1
KR_6671903014,420,-7,-124,-47,-14,-2,2,0,0,0,0,0,0,0,-10,10,0,-2,3,1,-1,-18,1,0,-2,2,-2,0,-4,-1,-1,-1,-1,5,-1
KR_6753566295,420,0,36,11,-7,-1,2,1,-4,5,1,5,2,7,-6,7,1,-1,2,1,-1,-12,-37,0,-5,5,-1,0,0,1,-1,1,-1,3,-1
KR_6610545617,420,0,-23,-24,-2,-4,4,0,4,1,5,0,5,5,-1,3,2,-1,1,0,0,0,41,0,-4,4,-7,0,0,0,-1,0,-1,0,-1
KR_6618412747,420,1,-43,-14,-1,4,0,4,1,0,1,1,0,1,-5,5,0,-2,3,1,0,-2,36,2,-3,1,-30,0,-1,-1,-1,-1,-1,4,-1
KR_6694148800,420,4,86,36,2,4,0,4,-2,3,1,3,2,5,-3,4,1,0,1,1,0,-2,-377,4,-6,2,-1,0,1,1,1,1,1,5,-1
KR_6748859801,440,-2,-96,-40,-1,3,0,3,0,5,5,-3,7,4,-3,7,4,2,1,3,0,10,-44,-3,-3,6,25,0,-2,-1,-1,-1,1,1,-1
KR_6749005102,420,-5,-105,9,-11,-6,6,0,-4,4,0,-4,5,1,4,0,4,-1,1,0,0,-2,12,1,-4,3,0,0,-2,0,-1,-1,1,0,-1
KR_6611706045,420,-6,-118,-20,-12,5,1,6,-5,6,1,-7,7,0,0,0,0,-5,5,0,1,-9,-19,0,-2,2,-1,0,-1,-1,1,-1,1,4,-1
KR_6583986457,420,-1,13,-12,-4,-3,5,2,-1,5,4,-1,2,1,2,2,4,-1,3,2,0,1,257,0,-2,2,-1,0,0,-1,1,0,-1,1,-1
KR_6749520428,420,-3,-59,-16,-6,1,1,2,-1,2,1,-5,6,1,-1,4,3,0,1,1,0,-8,-8,-3,-3,6,-1,0,1,-1,1,1,1,1,-1
KR_6719162976,420,3,-22,42,8,7,2,9,1,2,3,4,1,5,-4,8,4,0,0,0,0,8,115,3,-4,1,-3,0,0,0,0,0,1,0,-1
KR_6361650941,420,3,-19,0,-4,-2,4,2,0,2,2,1,2,3,-4,4,0,1,0,1,0,-8,0,0,0,0,2,0,0,0,0,0,-1,0,-1
KR_6725807714,420,-6,-68,-32,-9,0,0,0,-5,6,1,-2,3,1,-2,5,3,0,0,0,0,-7,6,-5,-3,8,-3,0,0,1,-1,-1,1,5,-1
KR_6737760222,420,0,-15,-4,0,3,2,5,-2,4,2,-2,4,2,1,1,2,0,0,0,1,0,7,2,-8,6,3,0,-1,-1,-1,-1,1,2,-1
KR_6634344756,420,-3,-33,4,-4,-1,4,3,-1,3,2,-3,6,3,1,2,3,0,0,0,0,-4,-98,-2,-4,6,-5,0,-1,-1,1,-1,1,3,-1
KR_6363566302,420,-2,-42,-46,2,-2,4,2,4,1,5,-4,4,0,4,0,4,0,1,1,0,7,0,0,0,0,4,0,0,-1,-1,-1,-1,2,-1
KR_6746589687,420,-2,-62,-30,-11,0,0,0,-2,3,1,0,3,3,-6,7,1,-3,3,0,0,-12,-15,-6,-2,8,2,0,-1,0,-1,-1,-1,0,-1
KR_6638469878,440,2,63,16,-5,-3,4,1,-6,8,2,2,0,2,0,1,1,2,0,2,0,-3,6,0,-3,3,-4,0,1,-1,1,1,-1,5,-1
KR_6737868989,420,-3,14,4,2,-1,1,0,4,1,5,-1,2,1,-1,1,0,1,1,2,0,3,-3,0,-2,2,0,0,1,0,-1,1,1,0,-1
KR_6621935106,420,-6,-41,-60,-4,0,2,2,-3,3,0,-2,5,3,-1,3,2,2,1,3,0,-4,-418,-2,0,2,0,0,-3,-1,-1,-1,1,2,-1
KR_6730805315,420,4,-44,12,3,-3,3,0,1,2,3,3,1,4,1,1,2,1,1,2,0,7,1,-3,-6,9,2,0,1,0,0,1,-1,0,-1
KR_6743987870,440,-2,-1,-14,1,3,0,3,-2,4,2,1,1,2,2,2,4,-3,5,2,0,-2,0,-4,-2,6,-3,0,0,-1,-1,1,-1,1,-1
KR_6690869629,420,3,30,12,5,-2,3,1,0,3,3,-2,3,1,7,1,8,2,0,2,0,4,-27,-4,0,4,4,0,3,1,1,1,1,5,-1
KR_6616961906,420,-3,-80,12,-6,-6,6,0,3,0,3,-4,4,0,-1,1,0,2,0,2,0,1,8,0,-3,3,-4,0,0,0,-1,-1,1,0,-1
KR_6695607247,420,0,54,-20,-3,1,3,4,-1,2,1,0,1,1,-5,7,2,2,0,2,0,-6,-36,2,-3,1,0,0,0,1,-1,-1,1,6,-1
KR_6742982317,420,-3,15,-68,-2,5,0,5,0,0,0,1,1,2,-5,5,0,-3,5,2,0,-2,7,2,-3,1,-4,0,-1,-1,-1,-1,1,3,-1
KR_6674930347,420,1,-79,-9,3,1,3,4,2,0,2,1,1,2,-1,2,1,0,0,0,0,0,-10,1,-3,2,-4,0,-1,-1,1,-1,-1,2,-1
KR_6623747564,440,0,11,8,4,2,3,5,1,1,2,-1,2,1,-2,4,2,4,0,4,0,3,4,0,-1,1,1,0,1,0,1,1,1,0,-1
KR_6714348462,440,2,37,-12,6,5,2,7,0,1,1,2,1,3,-3,4,1,2,2,4,0,8,4,5,-6,1,0,0,2,-1,0,1,-1,4,-1
KR_6729463374,420,-6,-58,23,-14,-4,5,1,-4,6,2,-3,4,1,-2,2,0,-1,1,0,1,-9,18,0,-1,1,-1,0,-1,-1,1,1,1,2,-1
KR_6630210731,420,-1,-23,-56,0,-3,5,2,3,0,3,2,3,5,-3,5,2,1,0,1,1,5,-7,0,-1,1,0,0,1,-1,1,1,1,2,-1
KR_6746920903,440,-1,29,52,-10,-5,9,4,0,1,1,2,0,2,-6,6,0,-1,3,2,0,-15,6,-1,-3,4,2,0,1,-1,0,1,1,1,-1
KR_6724893977,420,-1,-12,4,-6,1,1,2,-1,5,4,-3,4,1,-3,5,2,0,1,1,0,-2,0,-6,-2,8,2,0,0,-1,-1,-1,-1,4,-1
KR_6603562407,420,-5,8,-26,-10,-2,2,0,-4,6,2,-3,5,2,-1,4,3,0,2,2,-1,-9,-46,0,-3,3,8,0,-2,-1,-1,-1,1,2,-1
KR_6723480430,420,-1,-19,-28,-3,1,0,1,2,2,4,-3,5,2,-3,3,0,0,1,1,0,4,12,-6,-1,7,0,0,0,-1,1,1,1,3,-1
KR_6615006974,420,1,33,-20,-3,-3,4,1,3,2,5,1,0,1,-2,4,2,-2,4,2,0,-4,-41,-3,0,3,1,0,1,-1,-1,-1,1,6,-1
KR_6756094466,420,-4,-26,-36,-7,-4,4,0,-2,2,0,1,0,1,1,2,3,-3,3,0,0,-4,9,-1,-3,4,-3,0,-2,-1,-1,-1,-1,3,-1
KR_6726920739,420,0,5,-16,1,-2,2,0,2,1,3,-2,3,1,3,0,3,0,0,0,0,3,-21,-1,-3,4,2,0,0,1,1,0,1,1,-1
KR_6642589103,420,-1,-11,-8,-2,-3,5,2,0,7,7,2,0,2,-1,2,1,0,0,0,0,0,0,0,-4,4,-3,0,0,0,0,0,-1,0,-1
KR_6685535292,420,0,-34,-4,0,0,1,1,2,3,5,0,4,4,-1,4,3,-1,3,2,0,4,-12,1,-3,2,1,0,0,-1,-1,0,1,5,-1
KR_6758449178,420,-4,-7,-68,-4,-2,4,2,0,0,0,-1,3,2,-2,3,1,1,1,2,0,2,-1,-1,-3,4,-2,0,-1,-1,-1,-1,-1,1,-1
KR_6744935105,420,0,-32,-3,1,3,2,5,-7,8,1,3,1,4,4,1,5,-2,2,0,0,0,-6,-2,-3,5,1,0,0,-1,-1,0,-1,1,-1
KR_6474918582,420,-2,-80,-39,-5,-2,4,2,-2,3,1,-4,6,2,0,4,4,3,2,5,0,0,-38,-1,-3,4,1,0,-2,-1,-1,-1,-1,6,-1
KR_6600759268,420,0,-28,10,-5,0,0,0,2,1,3,-3,4,1,-3,4,1,-1,2,1,2,-3,22,1,-5,4,0,0,0,1,-1,-1,1,2,-1
KR_6729997902,420,1,44,3,-3,-3,3,0,1,3,4,-4,4,0,4,0,4,-1,1,0,1,6,0,-1,-3,4,3,0,-1,1,-1,-1,1,6,-1
KR_6670218612,420,-2,-34,-13,-4,0,1,1,-5,6,1,0,4,4,0,3,3,1,0,1,0,-1,136,0,-3,3,-4,0,0,1,1,0,-1,5,-1
KR_6746944798,440,2,55,0,-2,-2,2,0,3,0,3,6,0,6,-7,9,2,-2,2,0,0,-2,7,2,-3,1,1,0,1,1,1,1,1,1,-1
KR_6764208466,420,2,25,32,6,-2,2,0,5,0,5,1,3,4,1,7,8,1,2,3,0,5,3,-2,-2,4,3,0,1,1,-1,1,1,4,-1
KR_6740635157,420,5,74,-5,9,4,1,5,3,0,3,1,1,2,0,2,2,1,1,2,-1,2,0,0,-2,2,2,0,0,0,0,1,-1,0,-1
KR_6753381265,420,2,52,-28,7,-1,1,0,3,2,5,1,1,2,4,1,5,0,3,3,0,12,8,-1,-2,3,2,0,2,1,0,1,1,5,-1
KR_6626665215,420,-3,-15,4,-9,-1,1,0,-4,4,0,-3,3,0,-1,2,1,0,1,1,0,-3,-2,-4,-1,5,2,0,-1,-1,-1,-1,-1,5,-1
KR_6649075112,420,-2,-18,-11,-5,-2,4,2,-6,8,2,3,2,5,4,1,5,-4,5,1,0,-7,5,3,-5,2,-1,0,-1,0,-1,-1,-1,0,-1
KR_6731273790,420,-3,75,-91,-8,1,1,2,-5,5,0,-1,2,1,-2,5,3,-1,1,0,-2,-12,22,-2,-4,6,-1,0,0,0,-1,0,-1,0,-1
KR_6761233301,440,1,6,8,5,1,1,2,0,3,3,0,1,1,4,1,5,0,1,1,0,11,-1,0,-5,5,-1,0,0,-1,0,0,1,4,-1
KR_6757172261,420,-4,9,-48,-7,5,0,5,0,3,3,-8,8,0,-3,3,0,-1,1,0,0,-11,-140,0,-6,6,-6,0,0,-1,1,0,1,5,-1
KR_6738146749,420,0,41,-20,0,1,2,3,-2,2,0,0,3,3,1,1,2,0,0,0,0,0,-8,0,-3,3,1,0,2,-1,1,1,1,2,-1
KR_6608653781,420,-2,-7,8,-6,-2,2,0,4,3,7,0,2,2,-8,9,1,0,0,0,0,-4,366,2,-5,3,-2,0,0,-1,0,-1,-1,1,-1
KR_6763526386,440,1,-105,79,-7,-5,7,2,-1,2,1,4,1,5,-4,5,1,-1,1,0,0,-2,-7,-3,-1,4,1,0,-1,1,1,-1,1,5,-1
KR_6618655938,420,-2,-23,-7,-3,3,1,4,1,1,2,-6,6,0,0,2,2,-1,2,1,0,2,-9,0,-3,3,4,0,-2,1,-1,-1,-1,6,-1
KR_6543495721,420,1,15,8,-5,2,0,2,-1,7,6,-1,6,5,-3,6,3,-2,3,1,-2,-8,9,-4,-1,5,1,0,0,-1,1,1,1,1,-1
KR_6672974681,440,-3,-15,12,-3,-5,8,3,-1,1,0,-1,5,4,5,0,5,-1,3,2,0,4,18,0,-1,1,0,0,-1,-1,-1,-1,-1,6,-1
KR_6538527717,420,-1,-72,-31,-1,0,1,1,-1,2,1,-1,3,2,1,1,2,0,0,0,1,5,-3,-2,-1,3,-1,0,0,1,-1,0,1,4,-1
KR_6656858890,420,4,-8,12,8,0,0,0,1,3,4,-3,3,0,10,0,10,0,0,0,0,11,9,-1,-4,5,1,0,0,1,0,1,-1,6,-1
KR_6715448666,420,-3,28,-12,-9,-1,1,0,-2,6,4,-6,7,1,0,2,2,0,1,1,1,2,-49,2,-3,1,25,0,0,-1,1,0,1,6,-1
KR_6609941720,420,-5,-70,-17,-11,-7,8,1,-5,7,2,4,0,4,-2,4,2,-1,2,1,0,-10,77,-5,-2,7,-1,0,-1,-1,-1,-1,-1,2,-1
KR_6684753906,420,-8,-93,-12,-18,-2,4,2,-6,7,1,-2,5,3,-5,7,2,-3,4,1,0,-13,-223,0,-1,1,-1,0,-2,-1,-1,-1,1,3,-1
KR_6737417107,420,0,47,28,-2,-2,3,1,-1,5,4,5,2,7,-3,3,0,-1,1,0,0,-5,4,1,-3,2,-4,0,0,1,-1,0,1,1,-1
KR_6738979890,420,-1,3,-12,3,5,1,6,1,4,5,4,2,6,-3,3,0,-4,4,0,-1,-9,-106,1,-4,3,0,0,0,-1,1,0,-1,3,-1
KR_6764262948,420,-2,10,-40,-5,-6,7,1,7,1,8,-8,12,4,-1,2,1,3,0,3,1,-5,1,-3,0,3,3,0,2,-1,0,1,1,3,-1
KR_6361650439,420,-7,-104,-21,-16,-5,5,0,-2,4,2,-5,6,1,-5,5,0,1,0,1,0,-21,0,0,0,0,-5,0,-2,1,-1,-1,-1,6,-1
KR_6760566884,420,-3,-100,-6,-5,-9,9,0,2,1,3,1,1,2,0,3,3,1,0,1,0,-2,6,0,-1,1,1,0,-2,-1,-1,-1,1,1,-1
KR_6592214157,420,-2,-51,-17,5,2,1,3,-2,4,2,1,2,3,2,2,4,2,0,2,0,8,4,5,-7,2,-2,0,-2,-1,-1,-1,1,4,-1
KR_6384261060,420,1,-7,8,-3,-1,3,2,0,3,3,-2,2,0,0,4,4,0,1,1,-1,-6,1,1,-3,2,1,0,1,-1,0,1,-1,3,-1
KR_6725327013,420,-2,-37,0,-8,2,3,5,-1,2,1,0,1,1,-5,6,1,-4,5,1,-2,-12,-20,4,-5,1,-1,0,0,-1,-1,0,-1,1,-1
KR_6760567007,420,-4,-45,-24,-3,-2,4,2,-3,4,1,-1,3,2,5,6,11,-2,5,3,2,2,-11,-2,-1,3,-2,0,-1,1,0,-1,1,4,-1
KR_6724188595,420,-2,-63,1,1,2,2,4,-1,3,2,3,0,3,-2,2,0,-1,1,0,0,9,4,6,-9,3,-4,0,-1,-1,1,-1,1,5,-1
KR_6745794312,420,0,1,-8,-3,-2,3,1,-5,5,0,3,0,3,0,3,3,1,2,3,0,-5,-24,-1,-2,3,30,0,-1,1,-1,-1,1,4,-1
KR_6738283389,420,0,-14,-32,-2,0,0,0,0,5,5,-2,3,1,0,3,3,0,0,0,0,2,-2,-3,-3,6,3,0,-1,-1,-1,-1,-1,5,-1
KR_6592425107,420,0,64,-16,-6,-2,2,0,3,1,4,-4,6,2,-2,3,1,-1,1,0,0,-7,3,1,-5,4,1,0,0,-1,1,1,-1,5,-1
KR_6687398001,420,-3,-48,-6,-10,-1,1,0,-2,3,1,-6,6,0,-2,2,0,1,0,1,0,-10,-5,-1,-2,3,-6,0,-1,-1,-1,-1,-1,1,-1
KR_6647842027,440,-4,-26,9,-7,-7,7,0,2,3,5,0,1,1,-1,6,5,-1,1,0,-1,-2,-2,1,-5,4,3,0,0,-1,1,0,-1,1,-1
KR_6734236377,420,-1,12,24,-3,1,3,4,2,3,5,3,1,4,-7,9,2,-2,4,2,0,-5,-10,-1,0,1,0,0,-1,1,1,-1,-1,3,-1
KR_6760828592,420,-3,-45,15,-2,-2,4,2,-1,3,2,0,2,2,2,2,4,-1,1,0,0,5,-54,0,-2,2,25,0,-3,1,-1,-1,-1,4,-1
KR_6758980163,440,0,-36,-3,-4,-3,5,2,4,0,4,-6,7,1,-2,7,5,3,0,3,2,-5,-12,-2,-6,8,-2,0,0,-1,1,1,1,5,-1
KR_6599552329,440,-5,-90,2,-18,-10,12,2,-5,7,2,-2,3,1,-2,4,2,1,0,1,0,-10,-4,0,0,0,1,0,-6,-1,-1,-1,-1,4,-1
KR_6742211969,420,-5,-46,-32,-10,-4,5,1,-7,8,1,-3,5,2,2,0,2,2,0,2,0,-4,3,-3,-1,4,1,0,-2,1,-1,-1,-1,6,-1
KR_6729896630,420,0,-47,-20,1,2,4,6,-4,5,1,-2,4,2,0,4,4,5,2,7,0,4,-5,-3,-1,4,-1,0,1,-1,1,1,1,3,-1
KR_6761639803,440,-5,-42,0,-4,-7,8,1,3,2,5,-7,7,0,6,0,6,1,0,1,0,9,5,-1,-3,4,0,0,-2,1,-1,-1,-1,4,-1
KR_6493831619,420,3,35,-12,4,2,1,3,2,2,4,0,1,1,-1,2,1,1,1,2,1,6,3,2,-4,2,0,0,1,1,1,1,1,4,-1
KR_6733307519,420,-1,-40,-7,-4,0,3,3,-2,3,1,0,2,2,-1,2,1,-1,1,0,0,-2,1,0,-1,1,2,0,-1,1,-1,-1,-1,5,-1
KR_6747496480,420,2,-39,2,0,-4,5,1,2,1,3,4,2,6,-1,3,2,-1,3,2,0,7,66,-5,-3,8,6,0,-2,1,-1,-1,-1,5,-1
KR_6604145526,420,1,-57,12,9,-2,3,1,2,3,5,6,1,7,2,3,5,1,2,3,0,11,1,-2,-1,3,1,0,-1,1,-1,-1,1,5,-1
KR_6311395182,420,-8,-114,-25,-21,0,2,2,-2,6,4,-5,5,0,-13,14,1,-1,1,0,0,-12,15,-1,0,1,-1,0,-1,-1,0,-1,-1,3,-1
KR_6731657764,420,-1,-12,20,-12,-2,2,0,-3,5,2,-2,2,0,-1,3,2,-4,5,1,0,-5,272,-5,-4,9,6,0,0,1,-1,0,-1,3,-1
KR_6677313067,420,-2,-61,28,-7,1,2,3,-6,6,0,-1,4,3,0,0,0,-1,1,0,0,-5,7,-6,0,6,-3,0,0,0,0,0,-1,0,-1
KR_6575044556,420,-2,-45,28,-2,2,0,2,2,0,2,2,2,4,-6,8,2,-2,3,1,0,-1,6,-1,-5,6,-1,0,0,-1,1,-1,1,2,-1
KR_6762227987,420,-1,-26,-8,-11,-3,4,1,0,1,1,-2,2,0,-2,3,1,-4,4,0,0,-10,15,4,-6,2,-5,0,-1,-1,1,-1,-1,3,-1
KR_6756795733,420,0,54,-39,0,0,2,2,-1,7,6,-1,7,6,4,0,4,-2,3,1,0,-12,7,-1,-1,2,3,0,2,-1,1,1,1,2,-1
KR_6638765911,420,-2,19,4,-7,2,0,2,0,3,3,-6,6,0,-5,5,0,2,1,3,0,-8,40,-1,0,1,-21,0,-1,1,-1,-1,1,5,-1
KR_6704019000,420,0,3,-12,1,3,0,3,-1,1,0,0,3,3,-1,3,2,0,0,0,0,-2,-40,-3,-2,5,12,0,0,1,1,1,1,2,-1
KR_6758021985,420,-3,15,-20,-1,-3,4,1,-4,6,2,-2,4,2,6,2,8,2,0,2,0,4,34,-5,-2,7,-19,0,0,-1,-1,0,1,1,-1
KR_6646261772,420,-2,31,-4,-2,2,2,4,3,1,4,-4,5,1,-1,2,1,-2,2,0,0,-3,2,2,-3,1,0,0,1,-1,-1,1,-1,2,-1
KR_6728981880,420,-5,-69,4,-5,-2,2,0,-2,4,2,-1,1,0,-1,4,3,1,2,3,0,-2,-54,-3,-2,5,8,0,0,-1,-1,-1,1,6,-1
KR_6764167470,420,1,78,24,1,-3,3,0,-1,3,2,1,3,4,3,4,7,1,0,1,-1,4,12,6,-6,0,0,0,1,1,1,1,1,6,-1
KR_6762112053,420,3,38,-28,3,1,4,5,0,3,3,-1,2,1,0,1,1,3,2,5,0,9,51,-1,-1,2,-17,0,0,-1,0,1,-1,2,-1
KR_6667672751,420,0,-6,6,1,5,0,5,1,2,3,1,2,3,-6,6,0,0,2,2,-1,-6,0,-3,-2,5,2,0,4,-1,1,1,-1,2,-1
KR_6710073304,420,-1,-6,-17,-2,-2,3,1,-1,3,2,4,0,4,0,1,1,-3,6,3,-1,-2,-19,-3,0,3,-3,0,0,-1,-1,0,-1,6,-1
KR_6519705291,440,-3,55,4,-4,-1,2,1,-5,5,0,0,6,6,1,4,5,1,0,1,-1,-5,-25,-7,-1,8,2,0,0,-1,0,-1,-1,1,-1
KR_6663717440,420,-4,-74,-4,-7,-1,3,2,3,1,4,-1,2,1,-5,6,1,-3,3,0,1,-4,95,0,-3,3,-2,0,0,-1,1,0,1,1,-1
KR_6584279643,420,1,14,0,-3,1,0,1,-7,8,1,-1,2,1,3,1,4,1,0,1,0,-1,-118,-4,-2,6,-3,0,1,1,-1,1,1,4,-1
KR_6612787887,420,-5,-108,-35,-6,0,1,1,-2,4,2,-5,6,1,0,3,3,1,1,2,-1,0,-1,-2,-2,4,-1,0,-1,-1,-1,-1,-1,3,-1
KR_6232218873,420,2,4,4,1,5,1,6,0,2,2,-5,7,2,1,4,5,0,1,1,0,4,223,-6,-1,7,4,0,0,-1,-1,0,-1,2,-1
KR_6604339608,420,0,30,-6,-2,4,0,4,-6,7,1,-1,5,4,2,0,2,-1,1,0,0,-10,7,2,-3,1,1,0,1,1,1,1,1,5,-1
KR_6626365913,420,-3,-97,-27,-6,0,2,2,1,2,3,-1,2,1,-8,9,1,2,1,3,0,-2,-29,-2,-2,4,1,0,-2,0,-1,-1,-1,0,-1
KR_6744853821,420,-4,-66,-12,-8,0,2,2,0,4,4,2,0,2,-10,11,1,0,1,1,0,-13,-6,-1,-2,3,3,0,-2,-1,-1,-1,1,4,-1
KR_6591917582,420,-1,-36,-16,-2,-1,1,0,0,2,2,-1,3,2,0,0,0,0,0,0,0,-3,18,0,-4,4,-4,0,0,-1,-1,0,1,4,-1
KR_6761575246,440,2,-32,0,4,-3,3,0,1,1,2,-2,3,1,8,3,11,0,1,1,0,11,44,4,-7,3,-30,0,1,-1,1,1,1,5,-1
KR_6757373552,420,-5,-105,-20,-9,-3,4,1,-5,7,2,0,1,1,-1,3,2,0,0,0,0,-2,-50,-3,0,3,27,0,-2,-1,-1,-1,-1,6,-1
KR_6710301168,420,-3,-32,0,-11,1,2,3,-2,5,3,-2,3,1,-3,3,0,-5,7,2,0,-14,41,2,-4,2,-1,0,-1,-1,-1,-1,-1,4,-1
KR_6641828916,420,-3,-39,-9,-8,-4,4,0,-1,3,2,-4,5,1,0,2,2,1,1,2,-1,1,355,0,-2,2,-1,0,-1,-1,-1,-1,-1,1,-1
KR_6695606732,420,-3,35,-4,-10,-2,3,1,-6,7,1,1,4,5,0,5,5,-3,3,0,-1,-3,5,-3,0,3,-4,0,-2,-1,-1,-1,-1,4,-1
KR_6735346840,420,0,31,29,1,4,0,4,5,0,5,-2,5,3,1,1,2,-7,7,0,1,0,-27,-2,-3,5,30,0,0,-1,1,-1,1,5,-1
KR_6662975931,420,-2,-45,-28,-6,-3,4,1,0,7,7,-2,4,2,0,1,1,-1,3,2,0,-2,-14,1,-4,3,-2,0,0,1,-1,-1,1,6,-1
KR_6723996600,440,-2,15,-41,1,-2,2,0,1,0,1,1,0,1,-1,3,2,2,1,3,0,0,-5,2,-4,2,0,0,0,1,-1,0,1,1,-1
KR_6698796639,420,-5,-24,-30,-8,1,1,2,-2,3,1,-6,7,1,-1,3,2,0,1,1,0,-9,-3,0,-3,3,-3,0,0,-1,-1,0,-1,2,-1
KR_6728520540,420,-5,-53,-48,-12,-2,2,0,-2,5,3,-5,7,2,-6,6,0,3,1,4,-2,-11,-25,-1,0,1,17,0,-2,-1,-1,-1,-1,5,-1
KR_6683069353,420,1,-35,16,6,0,2,2,4,0,4,0,1,1,0,2,2,2,0,2,0,9,3,-2,-6,8,-2,0,0,1,0,0,1,3,-1
KR_6605738285,420,-6,-60,-7,-5,0,1,1,1,1,2,-5,5,0,-1,1,0,0,1,1,0,-4,2,1,-2,1,-2,0,0,-1,1,0,-1,1,-1
KR_6751814373,440,-2,-10,8,-5,-4,5,1,3,2,5,0,0,0,-4,6,2,0,0,0,0,-5,-408,-2,-1,3,-1,0,-1,0,0,-1,1,0,-1
KR_6730924923,420,-2,61,-36,-5,1,2,3,1,3,4,0,1,1,-4,5,1,-3,3,0,0,-2,-104,0,-2,2,-3,0,1,1,-1,1,-1,3,-1
KR_6762430894,420,-5,-75,-27,-11,1,1,2,0,2,2,-7,7,0,-3,4,1,-2,2,0,0,-8,1,-2,-4,6,-4,0,-2,0,-1,-1,1,0,-1
KR_6634580564,420,-4,-31,-17,0,-3,6,3,0,5,5,6,1,7,-3,5,2,0,0,0,1,0,-1,-2,-2,4,2,0,-1,-1,1,-1,1,4,-1
KR_6751407392,420,-8,-136,-16,-23,-7,7,0,0,3,3,-9,9,0,-7,8,1,0,0,0,0,-11,1,-2,-1,3,0,0,-2,1,-1,-1,-1,2,-1
KR_6702547226,440,2,26,4,5,2,2,4,3,0,3,2,1,3,1,0,1,-3,5,2,-1,-2,12,-4,-1,5,1,0,-2,1,-1,-1,-1,6,-1
KR_6706569907,420,-6,-65,4,-11,-8,9,1,1,0,1,-3,5,2,-2,4,2,1,0,1,-1,-1,7,-2,-1,3,2,0,-1,1,1,-1,-1,2,-1
KR_6646652972,420,-1,40,0,-1,-7,7,0,0,1,1,3,2,5,1,4,5,2,0,2,1,4,2,2,-4,2,-2,0,0,1,-1,0,1,4,-1
KR_6757159746,420,-3,8,-13,-8,0,2,2,2,0,2,-5,5,0,-3,3,0,-2,4,2,-1,-9,27,2,-5,3,0,0,1,-1,-1,1,-1,2,-1
KR_6754228218,420,-5,3,-4,-12,-1,2,1,2,1,3,-3,4,1,-6,9,3,-4,5,1,-1,-11,-20,-3,0,3,0,0,-1,1,-1,-1,-1,1,-1
KR_6631120084,420,0,-24,-11,2,0,2,2,-1,3,2,-1,4,3,5,0,5,-1,1,0,0,1,10,7,-10,3,-4,0,0,1,1,0,1,5,-1
KR_6608459926,420,-2,-24,-12,-3,0,1,1,0,0,0,1,1,2,-4,4,0,0,0,0,0,-5,5,3,-5,2,-1,0,0,1,0,0,-1,5,-1
KR_6660233625,420,-3,-21,-9,-5,1,1,2,-9,10,1,2,1,3,1,3,4,0,3,3,0,-5,1,-3,-3,6,-1,0,0,-1,1,-1,-1,5,-1
KR_6726109197,420,-6,-71,-40,-14,-5,6,1,-4,7,3,-1,3,2,-5,5,0,1,0,1,0,-8,-5,-4,-1,5,-2,0,-2,-1,0,-1,-1,3,-1
KR_6625027167,420,-1,-37,1,-3,3,1,4,3,0,3,-5,7,2,-4,4,0,0,0,0,0,-4,-10,-4,-1,5,0,0,0,-1,1,-1,-1,1,-1
KR_6761656673,440,0,4,12,-4,-3,4,1,-4,5,1,-5,6,1,3,1,4,5,1,6,0,-3,1,0,-1,1,0,0,3,-1,1,1,-1,3,-1
KR_6628809437,420,-1,-35,-40,-5,1,0,1,0,4,4,-4,9,5,0,2,2,-2,2,0,0,-11,324,-1,-1,2,-4,0,-2,-1,-1,-1,-1,6,-1
KR_6698105040,440,-4,-45,-37,-6,-5,5,0,1,3,4,4,0,4,-5,8,3,-1,2,1,0,-4,-7,4,-7,3,1,0,-3,-1,-1,-1,-1,3,-1
KR_6569720573,420,1,-105,-19,6,0,2,2,0,4,4,-1,2,1,5,0,5,2,1,3,0,10,-53,1,-3,2,27,0,0,1,-1,-1,1,2,-1
KR_6741336473,440,-1,63,-2,-4,-1,2,1,0,3,3,5,0,5,-4,5,1,-4,4,0,0,-8,-1,2,-2,0,1,0,0,1,-1,1,-1,6,-1
KR_6650103439,420,-1,5,-18,1,-5,6,1,0,0,0,-1,3,2,6,1,7,1,1,2,0,4,0,-1,-3,4,3,0,-1,-1,-1,1,1,5,-1
KR_6756250319,420,-4,-121,-39,-3,-2,3,1,0,1,1,6,1,7,-3,3,0,-4,4,0,0,-5,-24,2,-5,3,-2,0,0,-1,1,-1,1,4,-1
KR_6583542113,420,1,56,22,2,4,0,4,2,0,2,-4,4,0,-2,5,3,2,0,2,1,6,18,0,-1,1,-1,0,0,1,1,0,1,5,-1
KR_6608105969,420,-5,-94,-52,-4,-1,3,2,1,0,1,-2,3,1,-1,2,1,-1,1,0,0,1,-3,-1,-1,2,0,0,-3,-1,0,-1,-1,6,-1
KR_6084412222,420,-1,65,-12,1,3,2,5,0,1,1,0,3,3,-2,3,1,0,1,1,0,-8,-1,-2,-3,5,-1,0,1,-1,1,-1,1,4,-1
KR_6761505113,440,-2,-24,-12,4,1,1,2,0,3,3,1,1,2,4,1,5,-2,2,0,1,6,-1,1,-5,4,-1,0,-1,1,-1,-1,1,4,-1
KR_6762587104,420,2,86,12,-2,1,3,4,-3,3,0,1,1,2,-2,2,0,1,0,1,0,-7,4,3,-5,2,3,0,1,0,1,1,-1,0,-1
KR_6722267813,420,0,-3,-20,-5,5,0,5,-9,10,1,-1,1,0,-2,3,1,2,1,3,0,-13,9,-3,-1,4,2,0,0,-1,1,1,1,3,-1
KR_6718976076,420,2,19,4,5,0,3,3,2,3,5,2,2,4,-1,2,1,2,1,3,-2,2,-6,-6,-1,7,1,0,-1,-1,1,-1,-1,1,-1
KR_6763933179,420,1,3,-20,6,-3,4,1,2,0,2,3,1,4,0,1,1,4,0,4,0,13,71,2,-3,1,1,0,0,-1,-1,-1,1,3,-1
KR_6760832694,420,-3,29,-56,-5,0,1,1,0,3,3,-2,4,2,0,2,2,-3,4,1,0,-5,-1,4,-5,1,1,0,0,-1,-1,1,1,5,-1
KR_6729469334,420,0,-26,28,-3,-2,3,1,1,3,4,-5,8,3,1,4,5,2,0,2,0,-3,-9,1,-5,4,1,0,0,-1,1,0,1,1,-1
KR_6764288833,440,-3,11,-14,-8,-2,3,1,-4,6,2,-3,3,0,-2,4,2,3,0,3,0,-3,5,-2,-3,5,1,0,0,1,-1,-1,-1,4,-1
KR_6439845135,420,0,-20,11,0,-2,3,1,-1,2,1,2,3,5,1,3,4,0,1,1,0,2,66,-4,-2,6,-3,0,-1,1,-1,-1,1,5,-1
KR_6734642049,420,0,-96,43,0,-4,4,0,4,1,5,0,2,2,1,0,1,-1,2,1,0,-2,38,0,-2,2,-2,0,-1,0,1,-1,1,0,-1
KR_6666991241,420,-2,-36,-28,-13,3,1,4,-3,3,0,-5,6,1,-3,5,2,-5,6,1,-2,-19,-58,-1,-2,3,17,0,2,-1,1,1,-1,3,-1
KR_6670508659,420,-8,-90,-40,-14,-5,6,1,-6,10,4,1,2,3,-3,3,0,-1,2,1,0,-9,-18,0,-1,1,0,0,0,-1,-1,-1,-1,6,-1
KR_6728611371,420,-3,-66,-11,-7,-3,3,0,3,4,7,-2,3,1,-4,4,0,-1,1,0,-1,1,9,6,-7,1,-5,0,0,1,1,-1,1,6,-1
KR_6758695334,420,0,-13,-16,4,0,2,2,2,3,5,3,0,3,0,1,1,-1,1,0,0,2,8,1,-4,3,0,0,2,1,-1,1,1,2,-1
KR_6749146902,420,2,28,7,4,6,0,6,1,3,4,5,3,8,-5,6,1,-3,3,0,-1,-1,317,1,-3,2,-1,0,0,1,-1,1,-1,2,-1
KR_6754839531,420,1,-80,-3,2,1,0,1,-1,2,1,4,0,4,-1,4,3,-1,1,0,0,0,10,-3,-1,4,0,0,-2,1,-1,1,-1,5,-1
KR_6732724810,420,-2,-30,-48,-2,0,2,2,-5,5,0,2,0,2,1,1,2,0,0,0,0,3,237,1,-4,3,-1,0,0,-1,-1,0,1,5,-1
KR_6744830683,440,-2,-66,-5,-1,1,1,2,-1,3,2,5,0,5,-2,2,0,-4,4,0,0,-7,30,0,-3,3,-2,0,-1,-1,0,-1,1,2,-1
KR_6705422866,420,-9,-114,-20,-22,-3,5,2,-4,4,0,-12,12,0,-1,2,1,-2,3,1,0,-11,-60,-5,0,5,16,0,-2,-1,-1,-1,1,3,-1
KR_6666079426,420,-3,18,0,-6,-2,6,4,-2,3,1,-1,3,2,0,2,2,-1,1,0,0,-5,106,0,-3,3,1,0,-2,1,-1,-1,-1,6,-1
KR_6648993322,440,1,5,-8,-3,-1,2,1,-1,1,0,-1,6,5,1,2,3,-1,1,0,0,-4,2,0,-4,4,-4,0,0,0,1,0,-1,0,-1
KR_6694476755,420,-4,-73,-8,1,-1,1,0,2,1,3,-1,2,1,1,3,4,0,0,0,1,2,-8,-1,-2,3,4,0,-1,-1,0,-1,1,4,-1
KR_6596262209,420,0,62,6,1,2,0,2,1,1,2,-3,3,0,1,2,3,0,1,1,0,-1,12,-3,-1,4,3,0,1,1,-1,1,-1,5,-1
KR_6712643058,440,-5,-100,-11,-17,-7,7,0,-2,5,3,-6,8,2,-1,4,3,-1,1,0,0,-6,8,9,-10,1,-4,0,-4,1,-1,-1,-1,3,-1
KR_6761505424,440,-2,-56,-4,-6,-3,4,1,3,1,4,0,2,2,-4,4,0,-2,2,0,0,-1,3,3,-5,2,-3,0,0,0,0,0,-1,0,-1
KR_6757656527,420,-1,25,20,-4,1,1,2,-3,3,0,-1,4,3,-1,2,1,0,0,0,0,-5,-267,4,-4,0,-1,0,-2,1,-1,-1,1,4,-1
KR_6656638672,420,1,-22,-2,1,2,2,4,1,2,3,2,1,3,-3,5,2,-1,2,1,0,0,93,7,-8,1,5,0,0,0,1,0,-1,0,-1
KR_6731365837,420,-2,-48,-40,-6,1,1,2,-3,4,1,-5,6,1,-1,1,0,2,0,2,-1,-2,-32,-2,-1,3,1,0,-1,-1,-1,-1,-1,5,-1
KR_6725835546,440,-3,-90,-26,-8,-5,5,0,-1,3,2,-2,3,1,-1,4,3,1,1,2,0,-3,-31,3,-3,0,19,0,-1,1,0,-1,1,2,-1
KR_6762703327,440,-1,1,-1,1,2,4,6,4,0,4,0,5,5,-5,5,0,0,1,1,1,-2,-4,-1,0,1,1,0,0,0,0,-1,1,0,-1
KR_6751818523,420,-3,-53,-8,-7,-2,3,1,0,2,2,-3,4,1,-1,1,0,-1,1,0,-1,-8,-12,-3,-4,7,-3,0,-2,0,0,-1,-1,0,-1
KR_6545381569,420,-3,19,-12,-8,-3,5,2,-1,4,3,0,2,2,-6,6,0,2,1,3,0,-9,7,2,-2,0,0,0,-1,-1,-1,-1,-1,4,-1
KR_6764518640,440,-5,-53,-12,-14,-2,2,0,-4,5,1,-5,9,4,-2,9,7,-1,2,1,-4,-36,-10,-2,-5,7,-2,0,0,-1,1,-1,-1,2,-1
KR_6645513579,420,-4,-48,-19,-10,0,1,1,-8,9,1,-2,5,3,-1,4,3,1,0,1,-1,-7,23,-2,-1,3,-10,0,-1,-1,-1,-1,-1,2,-1
KR_6738578490,420,1,-6,15,0,0,4,4,1,1,2,0,2,2,0,1,1,-1,1,0,0,2,1,2,-5,3,0,0,1,1,1,1,-1,6,-1
KR_6760148034,420,-3,-45,4,-1,7,2,9,3,1,4,-3,4,1,-7,7,0,-1,2,1,0,-9,-10,-2,0,2,0,0,1,-1,1,1,-1,6,-1
KR_6697321135,420,-4,-38,-19,-10,-3,4,1,-1,2,1,-2,6,4,-3,3,0,-1,2,1,-1,-8,3,0,-1,1,1,0,0,-1,-1,0,-1,5,-1
KR_6759023444,440,2,20,3,4,3,0,3,0,2,2,0,1,1,2,0,2,-1,2,1,0,2,-4,0,-3,3,-1,0,-1,1,-1,-1,-1,2,-1
KR_6631547001,420,1,19,-13,0,1,0,1,3,4,7,-4,5,1,-1,2,1,1,0,1,0,4,39,0,-3,3,-27,0,1,-1,-1,1,-1,4,-1
KR_6725109293,440,-1,-3,-24,0,-1,1,0,-1,2,1,1,7,8,0,0,0,1,1,2,-1,-6,0,-2,-1,3,-2,0,0,-1,0,1,-1,5,-1
KR_6693254971,440,2,7,-7,5,-2,3,1,5,3,8,0,5,5,2,2,4,0,0,0,0,5,7,0,0,0,0,0,0,1,0,0,1,2,-1
KR_6097186357,420,-5,-115,-8,-6,-4,7,3,0,4,4,-3,3,0,3,2,5,-2,2,0,0,-2,-37,0,-2,2,2,0,-2,1,-1,-1,1,4,-1
KR_6696884304,420,-2,7,-22,-2,-3,3,0,0,1,1,-3,6,3,2,1,3,2,0,2,0,8,6,0,-3,3,1,0,1,-1,1,1,1,1,-1
KR_6759607719,420,-2,-50,7,0,1,3,4,2,4,6,1,1,2,-3,4,1,-1,2,1,0,-2,10,-1,-3,4,0,0,-1,1,1,-1,-1,2,-1
KR_6657090857,420,-6,-65,-48,-14,-7,8,1,1,0,1,-5,6,1,0,2,2,-3,3,0,-1,-4,-12,1,-2,1,-1,0,-3,-1,-1,-1,-1,1,-1
KR_6738282995,420,-4,-1,-16,-4,-2,4,2,2,0,2,0,0,0,-1,1,0,-3,3,0,0,-4,-17,-3,-2,5,-3,0,0,1,-1,0,-1,5,-1
KR_6583737921,420,-2,-56,20,-3,0,3,3,0,3,3,-1,2,1,-3,4,1,1,0,1,0,-4,-21,1,-2,1,-5,0,-1,1,-1,-1,-1,3,-1
KR_6709300538,420,0,46,-21,4,-2,3,1,3,0,3,2,1,3,0,0,0,1,1,2,0,5,33,-2,-2,4,5,0,1,0,1,1,1,0,-1
KR_6761245723,420,-5,-44,-64,-4,-2,3,1,-3,3,0,-2,3,1,3,2,5,0,1,1,0,-1,-2,-1,-3,4,-3,0,-1,-1,-1,-1,1,2,-1
KR_6684578820,420,4,26,33,-1,0,1,1,1,3,4,-2,4,2,1,0,1,-1,3,2,0,-1,12,-1,0,1,1,0,-1,0,-1,-1,-1,0,-1
KR_6448958636,420,0,-57,-8,-2,0,2,2,2,0,2,1,3,4,-5,7,2,0,0,0,0,1,29,2,-7,5,0,0,-1,0,1,-1,-1,0,-1
KR_6732387618,420,0,-41,-12,-8,1,0,1,-2,5,3,-5,5,0,0,0,0,-2,3,1,0,-2,-15,0,-4,4,-3,0,1,-1,1,1,-1,4,-1
KR_6045916152,420,-1,-47,10,-1,-3,3,0,1,1,2,0,1,1,0,0,0,1,0,1,0,3,-7,-3,-1,4,2,0,-1,-1,-1,-1,-1,5,-1
KR_6731998179,440,-5,-74,-28,-13,-1,1,0,-2,2,0,-1,2,1,-5,6,1,-4,4,0,0,-8,348,-2,-3,5,0,0,-2,-1,0,-1,-1,4,-1
KR_6738233966,420,1,43,-16,4,1,0,1,-3,4,1,7,0,7,-1,2,1,0,0,0,0,1,-69,-1,-2,3,-20,0,-2,-1,-1,-1,1,5,-1
KR_6702334098,420,5,56,34,6,0,1,1,9,2,11,-1,2,1,-2,3,1,0,2,2,1,4,-7,-2,-2,4,0,0,0,-1,1,1,1,6,-1
KR_6722888304,420,-5,-82,-28,-4,0,0,0,0,6,6,-3,3,0,-3,4,1,2,1,3,0,5,-14,-2,-2,4,-1,0,-1,-1,1,-1,-1,5,-1
KR_6637047874,420,-3,-72,-22,-10,-4,5,1,-1,1,0,-1,3,2,-5,7,2,1,0,1,0,-3,11,-1,-1,2,0,0,0,0,1,0,-1,0,-1
KR_6745913631,420,-3,-60,-19,-5,0,1,1,-3,6,3,-2,3,1,0,5,5,0,3,3,0,-4,-5,-1,0,1,1,0,0,-1,0,-1,-1,5,-1
KR_6721857024,420,-1,2,-64,6,0,4,4,2,4,6,-4,5,1,7,0,7,1,1,2,0,5,-5,-4,-4,8,-1,0,-2,0,-1,-1,1,0,-1
KR_6654508289,440,-3,-39,-40,-10,0,1,1,-6,6,0,0,3,3,-4,5,1,0,0,0,0,-7,56,0,-4,4,-22,0,-1,-1,0,-1,-1,2,-1
KR_6273350599,420,0,11,-9,-3,2,1,3,0,4,4,-4,7,3,2,2,4,-3,4,1,1,-5,-3,-1,-2,3,1,0,1,1,1,1,1,2,-1
KR_6646357938,420,0,20,-8,-7,2,1,3,1,0,1,-5,5,0,-4,5,1,-1,2,1,0,-8,-9,-2,0,2,-1,0,0,0,1,-1,-1,0,-1
KR_6755537997,420,-1,2,11,-3,-3,3,0,0,2,2,-1,3,2,1,1,2,0,2,2,0,0,-14,2,-3,1,0,0,-1,1,1,1,-1,6,-1
KR_6709647277,420,-3,-34,4,-6,4,0,4,3,0,3,-9,9,0,-2,2,0,-2,4,2,-1,-6,3,0,-3,3,-3,0,0,1,-1,0,-1,3,-1
KR_6646248734,420,-4,-90,20,-3,-1,1,0,5,0,5,-4,4,0,-3,4,1,0,1,1,0,0,-11,6,-8,2,2,0,0,1,1,1,-1,5,-1
KR_6673331598,420,-1,30,-35,-7,0,0,0,-3,4,1,-4,4,0,5,4,9,-5,5,0,0,-4,-9,0,-4,4,-2,0,-1,-1,1,-1,-1,3,-1
KR_6731833749,420,-4,-47,-8,-11,0,2,2,0,2,2,-4,4,0,-3,4,1,-4,4,0,0,-11,-9,0,-2,2,2,0,0,1,-1,0,-1,6,-1
KR_6762677311,420,0,-28,-16,-2,-2,2,0,0,2,2,1,2,3,-2,3,1,1,0,1,0,-7,9,-1,-2,3,-5,0,0,1,-1,0,-1,6,-1
KR_6606493405,420,-4,20,-8,-7,-2,2,0,-1,6,5,1,1,2,-4,4,0,-1,1,0,0,-8,-168,1,-3,2,0,0,0,1,0,1,-1,1,-1
KR_6632313711,420,1,22,0,-2,-2,2,0,1,2,3,2,1,3,-3,5,2,0,0,0,0,-7,4,1,-7,6,-3,0,0,-1,1,0,-1,3,-1
KR_6721356802,420,-1,-99,-15,3,-2,2,0,2,1,3,5,1,6,-1,1,0,-1,1,0,-1,2,-5,-1,-1,2,-5,0,0,-1,0,0,-1,3,-1
KR_6673603064,440,-3,-5,4,-4,-2,2,0,1,1,2,0,2,2,-2,2,0,-1,2,1,0,0,18,0,-2,2,0,0,1,0,1,1,-1,0,-1
KR_6717378425,420,-2,37,-12,-3,-1,3,2,-2,6,4,-1,4,3,2,0,2,-1,1,0,0,0,3,-2,-2,4,0,0,0,1,-1,0,1,5,-1
KR_6727166787,420,0,-6,-40,0,-1,3,2,2,4,6,-3,5,2,3,0,3,-1,1,0,-2,8,6,5,-6,1,2,0,0,-1,1,0,-1,1,-1
KR_6637043465,440,-3,-22,-46,-7,2,2,4,-1,2,1,-4,5,1,-1,1,0,-3,3,0,-2,-6,-2,-1,-2,3,2,0,-1,1,-1,-1,-1,5,-1
KR_6618712504,420,-1,-32,4,-12,0,3,3,0,1,1,-2,2,0,-8,10,2,-2,2,0,0,-4,1,-8,0,8,0,0,-1,0,-1,-1,-1,0,-1
KR_6551546609,420,1,-8,-32,3,-3,4,1,-2,5,3,1,3,4,7,3,10,0,0,0,0,10,4,5,-7,2,0,0,-1,-1,1,-1,1,5,-1
KR_6763360759,420,4,-28,21,12,6,3,9,1,1,2,4,0,4,1,2,3,0,2,2,1,10,-3,2,-2,0,3,0,1,1,1,1,1,2,-1
KR_6763153358,440,3,6,-8,5,-1,1,0,-1,1,0,5,4,9,3,1,4,-1,6,5,0,2,6,-1,-5,6,1,0,0,0,-1,-1,1,0,-1
KR_6762101749,420,-5,-75,20,-10,-3,4,1,-2,2,0,-6,6,0,0,3,3,1,1,2,0,-9,-12,1,-2,1,-3,0,0,-1,-1,-1,1,1,-1
KR_6707823798,420,0,13,-58,6,1,2,3,0,8,8,2,2,4,3,1,4,0,2,2,0,3,3,0,-6,6,2,0,0,-1,-1,-1,-1,6,-1
KR_6728023641,420,1,-30,-6,3,0,2,2,-3,8,5,4,1,5,1,1,2,1,1,2,0,6,297,-5,-1,6,1,0,0,-1,1,0,1,4,-1
KR_6764216808,440,-2,23,-36,2,5,1,6,0,4,4,-1,3,2,-4,5,1,2,0,2,0,-4,5,0,-1,1,0,0,1,-1,1,1,1,4,-1
KR_6760674885,420,0,24,16,3,4,0,4,1,3,4,-1,1,0,-2,6,4,1,1,2,0,-3,3,5,-5,0,3,0,0,1,1,0,1,2,-1
KR_6673401032,420,2,3,20,2,7,0,7,2,2,4,-2,2,0,-4,5,1,-1,1,0,-1,2,11,2,-3,1,-1,0,0,-1,1,0,-1,2,-1
KR_6740053337,420,2,41,4,9,-1,3,2,5,1,6,0,2,2,2,1,3,3,2,5,0,13,6,4,-7,3,2,0,0,0,1,1,1,0,-1
KR_6693510036,420,-3,-27,-24,-9,2,2,4,-4,5,1,-2,2,0,1,4,5,-6,9,3,-1,-13,221,3,-4,1,1,0,0,-1,0,0,1,4,-1
KR_6749472101,420,2,-5,-8,2,3,1,4,0,0,0,-1,4,3,1,0,1,-1,1,0,0,1,10,1,-2,1,-5,0,0,1,1,0,-1,5,-1
KR_6732357101,420,-1,-73,29,0,-1,1,0,5,1,6,0,1,1,-3,4,1,-1,2,1,0,0,-10,-6,-1,7,1,0,-1,1,1,-1,1,5,-1
KR_6653326968,420,-4,-70,-24,-13,1,2,3,1,0,1,-5,5,0,-6,7,1,-4,4,0,0,-8,-4,-2,-2,4,-1,0,-1,-1,1,-1,-1,3,-1
KR_6597115249,420,-5,-18,-21,-6,-7,7,0,4,1,5,0,2,2,-3,8,5,0,0,0,0,1,-11,-3,-2,5,1,0,-1,-1,-1,-1,-1,5,-1
KR_6751550022,420,6,71,20,-3,0,1,1,-7,7,0,4,0,4,-3,5,2,3,0,3,0,-5,203,-5,-1,6,0,0,2,-1,1,1,-1,2,-1
KR_6617378778,420,-3,-38,-28,-2,-2,4,2,0,1,1,-1,4,3,3,3,6,-2,3,1,0,1,12,2,-5,3,2,0,-1,-1,1,-1,1,6,-1
KR_6758121528,420,-5,16,8,-2,-4,4,0,-2,3,1,-2,3,1,5,1,6,1,3,4,0,0,14,2,-3,1,1,0,-1,1,-1,-1,1,1,-1
KR_6721340956,420,-2,-9,-20,1,-2,3,1,1,1,2,0,0,0,2,0,2,0,0,0,0,1,-9,-3,-2,5,7,0,-1,1,-1,-1,1,2,-1
KR_6661169950,420,-3,-8,-16,-11,-3,5,2,-1,3,2,-1,3,2,-4,5,1,-2,2,0,0,-9,-4,1,-2,1,0,0,-1,-1,-1,-1,1,6,-1
KR_6756799458,420,3,-47,0,11,0,1,1,1,1,2,3,3,6,5,2,7,2,1,3,3,7,8,-1,0,1,0,0,1,1,1,1,1,5,-1
KR_6651285541,420,-3,-41,16,-5,0,1,1,-1,4,3,-2,5,3,-3,5,2,1,2,3,0,-11,-7,-2,-1,3,0,0,0,-1,1,0,-1,3,-1
KR_6651931870,420,-5,-108,12,-11,-5,5,0,2,2,4,-9,9,0,-1,1,0,2,0,2,0,6,-19,0,-4,4,-2,0,-2,-1,1,-1,-1,5,-1
KR_6735660287,420,-6,-145,13,-11,-4,6,2,0,1,1,-1,2,1,-4,4,0,-2,2,0,0,-7,-30,3,-6,3,4,0,-2,-1,1,-1,-1,4,-1
KR_6718523128,420,-2,-18,-29,-6,-1,2,1,-2,4,2,0,4,4,-4,6,2,1,0,1,0,-14,300,-4,-1,5,3,0,-1,-1,-1,-1,1,2,-1
KR_6720232514,440,1,-67,20,-3,3,1,4,-1,2,1,0,1,1,-2,3,1,-3,3,0,-1,-8,-1,1,-1,0,-2,0,0,0,0,0,-1,0,-1
KR_6721141867,420,-4,-73,-44,-10,-1,2,1,-2,2,0,-3,4,1,-1,2,1,-3,4,1,-1,-9,0,-4,-3,7,-1,0,-2,-1,-1,-1,-1,3,-1
KR_6703061214,420,2,-24,30,-1,0,3,3,3,0,3,-2,2,0,-4,7,3,2,0,2,0,0,1,-1,-2,3,-1,0,0,-1,-1,0,-1,5,-1
KR_6649589080,420,-3,-63,-8,-2,-2,2,0,0,2,2,2,1,3,0,1,1,-2,2,0,-1,1,-5,-2,-2,4,1,0,-1,1,-1,-1,-1,6,-1
KR_6708999777,420,-4,-45,-4,-8,1,1,2,-2,4,2,1,1,2,-6,6,0,-2,3,1,0,-11,108,-3,-1,4,0,0,0,-1,0,0,-1,1,-1
KR_6731936728,420,1,35,31,9,1,0,1,2,0,2,1,3,4,3,2,5,2,0,2,0,7,2,0,-2,2,0,0,0,-1,1,1,1,3,-1
KR_6594000576,440,-8,-124,-12,-18,-9,9,0,-3,3,0,-3,5,2,-1,4,3,-2,2,0,0,-16,5,-1,-4,5,-2,0,-2,-1,-1,-1,-1,5,-1
KR_6674064127,420,-3,-41,-8,4,-4,4,0,5,3,8,2,2,4,1,1,2,0,1,1,1,9,3,-1,-1,2,-1,0,0,-1,-1,0,1,6,-1
KR_6762782737,420,-4,-63,-16,-13,-1,1,0,-2,2,0,-11,15,4,1,3,4,0,3,3,0,-4,1,2,-3,1,0,0,-1,1,0,-1,-1,2,-1
KR_6485671562,420,0,-87,8,4,-3,3,0,-5,6,1,4,0,4,2,0,2,6,0,6,0,5,6,1,-2,1,0,0,-1,-1,1,-1,1,2,-1
KR_6668160036,420,-1,22,-28,-3,1,2,3,-1,3,2,-1,3,2,1,1,2,-3,4,1,0,-5,-40,-6,-1,7,12,0,0,-1,-1,1,1,3,-1
KR_6583936016,420,3,34,20,6,4,1,5,-1,7,6,4,1,5,-1,2,1,0,1,1,0,-3,-25,1,-4,3,-1,0,1,-1,-1,1,1,3,-1
KR_6725713718,440,-2,31,-19,-1,3,0,3,3,0,3,-3,5,2,-3,3,0,-1,1,0,0,-6,0,4,-8,4,-3,0,0,-1,-1,-1,-1,3,-1
KR_6077297462,420,-2,-30,0,-4,-1,1,0,-2,5,3,-2,3,1,1,1,2,0,0,0,0,-2,-116,0,-4,4,0,0,-1,-1,-1,-1,-1,1,-1
KR_6582564464,420,2,72,-29,-1,-2,3,1,1,1,2,3,0,3,-1,2,1,-2,6,4,0,4,-7,0,-5,5,-1,0,-1,-1,1,1,1,1,-1
KR_6745182929,420,-3,-94,-9,-8,0,1,1,1,1,2,-5,7,2,0,3,3,-4,4,0,0,-10,-18,2,-7,5,-1,0,-3,-1,-1,-1,-1,6,-1
KR_6491719036,420,-4,8,-14,-15,2,1,3,-3,5,2,-4,5,1,-9,10,1,-1,1,0,-2,-20,-1,-1,-3,4,2,0,-2,-1,0,-1,-1,1,-1
KR_6725909412,420,-1,-72,4,-10,-4,4,0,-2,4,2,-1,2,1,-6,8,2,3,2,5,0,-8,-1,0,-3,3,-2,0,-2,-1,0,-1,-1,3,-1
KR_6586918759,420,-4,-119,-44,-14,0,1,1,2,1,3,-8,8,0,-5,7,2,-3,5,2,0,-6,0,-1,0,1,-3,0,-1,-1,-1,-1,1,2,-1
KR_6758063024,440,0,-3,-1,-2,-1,1,0,-1,3,2,0,5,5,0,5,5,0,4,4,0,-10,0,3,-6,3,1,0,0,1,-1,1,1,6,-1
KR_6635023367,420,0,-10,12,-4,-7,9,2,2,1,3,1,3,4,0,0,0,0,1,1,0,0,-11,-3,0,3,5,0,-2,-1,-1,-1,-1,3,-1
KR_6744734912,440,-2,-37,-17,-5,0,0,0,-2,6,4,0,4,4,1,1,2,-4,4,0,0,-5,-16,2,-3,1,0,0,-1,0,0,-1,-1,0,-1
KR_6662614101,420,-2,-22,-21,-1,-2,3,1,0,4,4,-1,3,2,2,0,2,0,2,2,0,1,-8,-2,-2,4,1,0,-1,1,0,-1,1,6,-1
KR_6753713099,420,-2,-22,-32,-6,4,1,5,-3,5,2,-6,7,1,-1,4,3,0,1,1,0,-4,-3,-2,-2,4,2,0,-1,-1,1,-1,1,2,-1
KR_6729462570,420,3,61,16,9,3,1,4,5,2,7,0,6,6,0,1,1,1,0,1,0,9,-11,-3,-1,4,1,0,2,-1,0,1,-1,6,-1
KR_6752800275,420,0,26,-5,1,0,1,1,1,1,2,-3,4,1,1,3,4,2,1,3,1,-1,8,1,-5,4,-5,0,0,-1,-1,0,1,5,-1
KR_6369900612,420,-5,-106,20,-7,-1,2,1,5,1,6,-1,1,0,-7,7,0,-3,4,1,0,-8,0,0,0,0,-3,0,-2,-1,-1,-1,-1,3,-1
KR_6333460808,420,3,0,-8,2,-1,2,1,-7,7,0,8,1,9,0,2,2,2,1,3,0,-1,2,0,-3,3,4,0,1,1,-1,1,-1,4,-1
KR_6745492472,420,-1,-5,-12,-6,4,0,4,-4,9,5,1,2,3,-6,6,0,-1,4,3,0,-13,0,-1,-2,3,0,0,1,-1,1,1,1,1,-1
KR_6763401520,420,-1,-46,12,2,1,2,3,-1,2,1,2,6,8,0,3,3,0,1,1,0,-1,4,0,-2,2,-2,0,0,-1,1,0,1,6,-1
KR_6090934798,440,2,78,2,1,-3,3,0,1,4,5,2,1,3,0,4,4,1,0,1,1,9,3,-1,-3,4,-1,0,-1,1,1,-1,1,2,-1
KR_6755616072,420,1,-59,-12,7,2,2,4,4,1,5,3,2,5,-3,3,0,1,2,3,0,8,33,3,-6,3,0,0,-1,-1,1,-1,-1,4,-1
KR_6582525233,420,0,-44,20,2,2,1,3,3,3,6,0,2,2,-4,4,0,1,1,2,1,3,-8,3,-7,4,-1,0,1,-1,1,1,1,2,-1
KR_6623441791,440,-1,-33,8,-2,-1,1,0,1,2,3,-3,4,1,2,3,5,-1,2,1,0,-1,-236,-1,-4,5,-1,0,0,-1,-1,-1,1,6,-1
KR_6731377442,420,2,9,-20,9,5,0,5,5,0,5,0,2,2,-1,1,0,0,0,0,0,7,175,-2,-4,6,4,0,2,1,0,1,-1,4,-1
KR_6418723972,420,1,60,25,-2,-1,3,2,0,1,1,-3,4,1,5,2,7,-3,3,0,0,2,7,-2,-4,6,4,0,1,1,-1,1,1,6,-1
KR_6743394826,420,-2,18,-36,-5,2,1,3,-5,5,0,-1,4,3,0,1,1,-1,1,0,0,-13,3,-2,0,2,-1,0,0,1,1,0,-1,5,-1
KR_6741717860,420,-3,-48,4,-2,-4,4,0,1,2,3,-1,3,2,2,1,3,0,0,0,0,5,4,-1,-5,6,-2,0,0,-1,1,-1,-1,2,-1
KR_6738478106,420,-6,-72,-32,-8,-4,4,0,-1,2,1,-1,3,2,-3,6,3,1,2,3,0,0,-7,-3,-1,4,2,0,0,0,-1,-1,1,0,-1
KR_6762268620,420,-7,-129,-24,-16,-8,8,0,-2,4,2,-3,4,1,-2,6,4,-1,2,1,0,-5,1,-1,-2,3,-4,0,-1,-1,-1,-1,-1,4,-1
KR_6730147843,420,-2,-77,-20,-2,-3,5,2,2,1,3,3,0,3,0,5,5,-4,4,0,-1,-1,-5,-2,-2,4,0,0,-1,1,1,-1,-1,4,-1
KR_6750144199,420,-2,-73,0,8,3,1,4,0,3,3,-1,3,2,3,0,3,3,2,5,0,7,6,1,-3,2,-1,0,-2,1,-1,-1,1,4,-1
KR_6695997132,440,-2,1,7,-8,-1,1,0,-5,6,1,4,5,9,-5,6,1,-1,4,3,-2,-10,16,6,-10,4,-1,0,2,-1,-1,1,-1,3,-1
KR_6646618950,420,1,22,6,2,-1,4,3,5,0,5,-1,3,2,3,5,8,-4,5,1,0,-1,-15,-2,0,2,3,0,0,1,1,-1,-1,5,-1
KR_6733720311,420,1,4,24,9,2,1,3,3,4,7,2,2,4,1,2,3,1,1,2,0,4,8,1,-5,4,0,0,1,1,-1,1,1,2,-1
KR_6618804790,420,-7,-70,-34,-14,-3,3,0,-5,5,0,0,2,2,-7,8,1,1,1,2,0,-19,-8,-1,-4,5,-3,0,-1,-1,-1,-1,1,1,-1
KR_6607218005,420,-2,-73,-28,0,6,0,6,-2,3,1,-4,4,0,-1,2,1,1,0,1,0,-2,4,4,-4,0,0,0,0,-1,0,0,1,5,-1
KR_6618460274,420,-4,-57,-11,-6,-3,4,1,-5,6,1,3,2,5,0,3,3,-1,1,0,-1,-3,-15,-1,-2,3,1,0,1,1,1,1,-1,5,-1
KR_6761574987,420,-6,-87,-12,-8,1,2,3,-3,5,2,0,1,1,-2,2,0,-4,4,0,0,-8,-1,0,-4,4,1,0,-3,-1,-1,-1,-1,6,-1
KR_6689430090,420,9,75,97,17,6,1,7,-2,2,0,3,1,4,6,2,8,4,1,5,0,3,-2,1,-4,3,2,0,2,0,1,-1,-1,0,-1
KR_6597212257,420,-2,-20,-7,-7,0,0,0,-4,5,1,0,2,2,1,2,3,-4,4,0,1,-4,4,1,-4,3,-1,0,-1,0,-1,-1,1,0,-1
KR_6710927125,420,-6,-27,13,-11,-5,6,1,-1,2,1,-5,6,1,-2,2,0,2,0,2,1,-6,-2,4,-4,0,-3,0,-2,-1,-1,-1,1,3,-1
KR_6680336069,420,-7,-77,-64,-16,-5,7,2,-3,3,0,-2,4,2,-4,4,0,-2,2,0,-2,-16,2,-5,0,5,-1,0,-3,-1,-1,-1,-1,6,-1
KR_6636969435,420,-6,-19,4,-19,-3,4,1,-1,3,2,-10,11,1,-5,6,1,0,2,2,0,-10,14,-2,0,2,-4,0,-1,-1,-1,1,-1,3,-1
KR_6517761949,420,1,-5,-2,-1,0,1,1,0,1,1,1,2,3,-2,3,1,0,0,0,0,-4,-5,-4,0,4,0,0,0,0,-1,-1,-1,0,-1
KR_6763964810,420,0,-27,-14,2,0,2,2,0,1,1,2,1,3,1,0,1,-1,1,0,0,6,-15,1,-1,0,3,0,0,-1,1,0,1,6,-1
KR_6746094954,420,0,-33,-4,4,5,1,6,2,2,4,-2,3,1,-4,6,2,3,1,4,0,6,2,1,-3,2,-1,0,0,-1,-1,0,1,3,-1
KR_6758284919,440,2,88,0,9,0,1,1,1,2,3,2,5,7,6,0,6,0,1,1,0,8,-4,-3,-1,4,1,0,1,0,1,1,1,0,-1
KR_6727552322,420,3,71,8,6,2,1,3,3,1,4,-1,3,2,2,4,6,0,1,1,0,2,5,1,-4,3,4,0,0,1,1,0,1,5,-1
KR_6732202581,440,-4,-32,8,-8,-2,4,2,-1,2,1,-3,3,0,1,3,4,-3,3,0,-1,-11,-10,-3,-3,6,-5,0,0,-1,1,0,1,4,-1
KR_6628618435,420,-1,-53,24,1,1,0,1,-1,2,1,-2,2,0,0,2,2,3,0,3,0,1,-128,-3,-3,6,-2,0,-1,0,1,-1,1,0,-1
KR_6723925820,440,-1,44,-21,-2,1,4,5,1,1,2,-1,2,1,-1,2,1,-2,3,1,0,-10,7,3,-4,1,-5,0,-1,-1,1,-1,-1,6,-1
KR_6742309010,420,-2,-91,-8,-6,0,0,0,0,2,2,0,1,1,-3,3,0,-3,3,0,0,-6,-51,-1,-2,3,25,0,0,-1,-1,0,-1,2,-1
KR_6648406564,420,4,53,0,-1,3,0,3,-1,4,3,1,2,3,-4,4,0,0,1,1,0,-8,-5,0,-3,3,0,0,1,0,0,1,-1,0,-1
KR_6751462439,420,-1,28,9,-14,-1,3,2,-5,5,0,-6,7,1,-1,4,3,-1,1,0,0,-19,47,-1,-1,2,-18,0,0,-1,1,-1,-1,2,-1
KR_6653117763,420,-4,-88,-28,-1,4,0,4,1,0,1,-1,1,0,-2,2,0,-3,3,0,0,-4,-2,6,-7,1,-6,0,1,-1,1,1,-1,1,-1
KR_6661052745,420,-2,0,5,-5,2,1,3,-9,10,1,0,3,3,1,3,4,1,1,2,0,-13,5,2,-6,4,1,0,-1,1,-1,-1,1,6,-1
KR_6707701801,420,0,-21,8,3,-2,2,0,-1,4,3,6,1,7,0,0,0,0,0,0,0,0,-5,3,-5,2,-8,0,0,1,1,0,1,5,-1
KR_6628067802,420,1,-3,12,4,-1,3,2,1,0,1,-2,2,0,3,1,4,3,1,4,0,3,6,-2,-1,3,-2,0,0,1,-1,0,1,5,-1
KR_6133543731,420,-3,-21,-13,-5,4,1,5,1,2,3,-8,8,0,-3,6,3,1,0,1,0,-1,-1,-5,0,5,-4,0,-2,-1,-1,-1,1,5,-1
KR_6623224835,420,-5,-35,-26,-5,-2,2,0,0,3,3,1,1,2,-4,6,2,0,1,1,0,-4,23,2,-3,1,-24,0,0,-1,0,0,-1,3,-1
KR_6409066887,440,-4,-107,-20,-5,-1,1,0,-5,6,1,0,2,2,1,0,1,0,2,2,0,2,-251,1,-7,6,-5,0,-1,-1,-1,-1,-1,3,-1
KR_6683665965,440,-3,-97,32,-6,-2,4,2,-4,6,2,2,0,2,1,2,3,-3,6,3,0,-4,3,-4,-1,5,-3,0,-2,0,-1,-1,-1,0,-1
KR_6644566475,420,-3,-77,14,-9,0,2,2,-1,3,2,-1,2,1,-4,6,2,-3,3,0,0,-9,-10,-2,0,2,-2,0,0,-1,-1,0,-1,2,-1
KR_6597070616,420,0,-81,20,-2,0,1,1,-3,4,1,5,2,7,-5,5,0,1,0,1,0,-6,-211,0,-3,3,-5,0,-1,0,1,-1,1,0,-1
KR_6573909054,420,-6,-87,-39,-6,3,0,3,0,2,2,-4,4,0,-2,3,1,-3,3,0,0,-7,5,-2,-2,4,-23,0,0,-1,-1,-1,-1,6,-1
KR_6750598600,440,-2,-19,-24,-3,-7,8,1,-3,4,1,4,2,6,4,4,8,-1,3,2,-2,-8,2,-1,-1,2,3,0,0,1,-1,-1,-1,3,-1
KR_6763235960,440,-2,3,-2,-5,-1,1,0,-2,3,1,1,0,1,-3,5,2,0,0,0,0,-8,-3,-3,-2,5,2,0,0,-1,0,0,1,1,-1
KR_6726821568,420,-2,-91,36,-4,2,0,2,0,2,2,-2,5,3,-1,2,1,-3,4,1,0,-11,-3,0,-4,4,-5,0,-1,-1,1,1,1,4,-1
KR_6656708276,420,-3,23,11,-5,-4,5,1,-3,3,0,1,0,1,-1,2,1,2,3,5,-1,-5,-3,-2,-2,4,2,0,-3,0,-1,-1,-1,0,-1
KR_6661676878,420,-6,7,-28,-9,0,3,3,-3,4,1,1,1,2,-5,5,0,-2,2,0,0,-13,24,-2,-2,4,-1,0,-1,-1,1,-1,-1,2,-1
KR_6714265479,440,-2,-18,-16,-2,-5,5,0,2,0,2,1,2,3,0,2,2,0,0,0,0,-3,2,3,-5,2,-2,0,0,1,-1,-1,-1,1,-1
KR_6742663281,420,-6,-132,-80,-15,-8,10,2,-5,7,2,3,2,5,-5,5,0,0,1,1,-2,-13,-13,-1,-3,4,-1,0,-4,-1,1,-1,-1,2,-1
KR_6641477040,420,4,47,-28,9,0,2,2,6,1,7,-2,3,1,5,0,5,0,1,1,0,5,-5,-2,-1,3,3,0,1,-1,-1,1,1,5,-1
KR_6740347279,420,-4,-6,-5,-1,0,4,4,-4,6,2,-1,1,0,3,2,5,1,1,2,0,3,0,1,-5,4,-2,0,-2,-1,-1,-1,-1,5,-1
KR_6602227647,420,-4,-51,-49,-8,-2,2,0,0,3,3,0,1,1,-6,6,0,0,0,0,-1,-10,-3,-5,-3,8,-1,0,0,-1,-1,0,-1,5,-1
KR_6702584923,420,1,26,12,2,-1,4,3,2,1,3,1,1,2,-1,2,1,1,0,1,0,-3,6,2,-4,2,1,0,0,1,0,0,-1,6,-1
KR_6678257084,420,-4,-37,18,-6,5,1,6,-4,5,1,-1,1,0,-7,7,0,1,1,2,0,-11,-210,-2,-2,4,-25,0,-1,1,-1,-1,-1,4,-1
KR_6660623453,420,-7,-65,28,-11,-4,4,0,4,0,4,-1,4,3,-8,8,0,-2,2,0,0,-13,0,-2,-1,3,2,0,0,1,1,-1,-1,3,-1
KR_6606318291,420,0,31,-60,5,5,0,5,-3,4,1,4,0,4,0,2,2,-1,1,0,0,3,-8,1,-3,2,1,0,0,-1,-1,0,1,4,-1
KR_6731786533,440,-2,-53,-6,-5,-4,5,1,-3,3,0,1,3,4,0,3,3,1,0,1,-1,-11,-56,1,-1,0,21,0,0,1,1,-1,-1,6,-1
KR_6707268117,440,-2,-53,24,-10,-4,5,1,3,1,4,-2,7,5,-5,5,0,-2,2,0,-1,-11,27,-4,-5,9,-2,0,-2,-1,-1,-1,-1,4,-1
KR_6762933354,420,2,-32,12,-1,-4,6,2,6,0,6,0,5,5,-2,3,1,-1,2,1,0,-3,-56,-5,-2,7,16,0,0,-1,0,0,-1,3,-1
KR_6642878052,420,-5,-55,0,-7,-1,4,3,1,0,1,-7,7,0,0,2,2,0,0,0,0,-3,17,-7,-1,8,-2,0,-1,-1,1,-1,1,6,-1
KR_6660787485,420,-2,28,-40,-2,1,2,3,2,2,4,1,3,4,-5,6,1,-1,2,1,0,-2,419,-3,0,3,0,0,1,1,0,1,1,6,-1
KR_6760742269,420,-3,-62,16,-9,-2,2,0,-1,4,3,-5,6,1,-1,3,2,0,2,2,-1,-2,-5,-3,-1,4,1,0,0,-1,1,0,-1,3,-1
KR_6685451256,420,-4,-116,-28,-13,-4,4,0,1,3,4,-6,8,2,-2,3,1,-2,2,0,0,-7,16,2,-4,2,0,0,-2,-1,-1,-1,-1,6,-1
KR_6720138986,440,2,-62,4,8,1,2,3,1,1,2,-3,4,1,2,0,2,7,0,7,0,7,3,0,-5,5,4,0,0,0,0,-1,-1,0,-1
KR_6732546922,420,4,13,36,8,-4,5,1,2,1,3,2,2,4,5,1,6,3,0,3,0,15,7,4,-6,2,-1,0,0,1,-1,1,1,4,-1
KR_6313718910,420,-7,-162,3,-12,1,0,1,-2,3,1,-2,3,1,-3,3,0,-6,6,0,0,-13,-54,2,-3,1,-3,0,-3,-1,-1,-1,-1,4,-1
KR_6705588746,440,-6,-96,-49,-7,-2,5,3,0,0,0,-1,3,2,2,3,5,-6,7,1,-1,-4,-4,-2,-1,3,0,0,-1,-1,1,-1,-1,5,-1
KR_6760216866,440,-2,10,39,-17,-1,2,1,0,3,3,-7,7,0,-8,9,1,-1,1,0,0,-19,0,-1,-1,2,-4,0,0,0,0,0,-1,0,-1
KR_6751606887,420,1,-39,27,-2,-4,6,2,6,2,8,-1,6,5,-5,9,4,2,2,4,0,5,-11,-1,-1,2,0,0,-2,0,0,-1,1,0,-1
KR_6731596996,420,-3,17,-12,-5,0,1,1,-4,4,0,-1,3,2,3,1,4,-3,3,0,0,-10,-1,1,-3,2,-4,0,0,-1,-1,0,-1,5,-1
KR_6654147183,420,-3,0,-16,-6,-2,3,1,0,5,5,-6,7,1,2,1,3,0,1,1,-1,-3,-3,2,-3,1,0,0,-1,1,1,-1,-1,4,-1
KR_6755084248,420,-1,13,-8,-3,2,1,3,2,2,4,0,0,0,-6,7,1,-1,1,0,0,-3,15,5,-5,0,-4,0,0,1,-1,0,1,6,-1
KR_6623396264,440,-3,5,-39,-2,-3,5,2,-2,4,2,-1,2,1,3,0,3,1,0,1,0,6,-2,1,-4,3,2,0,-2,-1,-1,-1,1,1,-1
KR_6723875883,440,-2,-55,-44,-6,-2,5,3,-2,2,0,2,1,3,-2,2,0,-2,2,0,0,-8,-3,-4,-2,6,0,0,0,-1,0,0,1,3,-1
KR_6580511489,420,-1,-73,18,-4,-2,3,1,1,3,4,-2,5,3,-2,3,1,1,0,1,-1,-4,-261,-1,-3,4,0,0,-1,-1,1,-1,-1,6,-1
KR_6748354020,420,2,-48,0,11,-1,2,1,3,2,5,-3,4,1,6,0,6,6,0,6,0,15,20,2,-3,1,-1,0,0,-1,-1,-1,1,6,-1
KR_6755379892,420,-2,-61,-16,-6,-5,6,1,-1,2,1,-3,4,1,3,0,3,0,1,1,-2,-8,322,-3,0,3,4,0,0,1,-1,-1,-1,3,-1
KR_6721401199,420,-4,-64,12,-7,-1,1,0,-2,5,3,4,1,5,-7,8,1,-1,2,1,0,-10,-1,-7,-5,12,-1,0,0,0,0,-1,-1,0,-1
KR_6084823048,420,0,10,21,0,4,0,4,-4,8,4,-2,2,0,1,3,4,1,0,1,0,-2,3,2,-3,1,-1,0,0,-1,1,0,-1,3,-1
KR_6689014064,420,2,-25,17,2,2,1,3,0,0,0,3,1,4,-3,3,0,0,0,0,0,1,-219,2,-3,1,-17,0,0,-1,1,-1,1,6,-1
KR_6725470338,420,2,-40,-30,0,-2,3,1,1,1,2,-1,4,3,1,2,3,1,2,3,-2,-2,22,0,-1,1,-2,0,-1,-1,-1,-1,-1,3,-1
KR_6576625925,420,2,-43,-4,3,6,2,8,1,2,3,0,2,2,-2,6,4,-2,2,0,0,-1,12,0,0,0,-1,0,1,1,1,-1,-1,1,-1
KR_6608399062,420,1,50,8,5,2,1,3,1,2,3,-2,3,1,1,1,2,3,0,3,0,9,-4,2,-5,3,3,0,1,0,0,1,1,0,-1
KR_6661301630,420,3,8,16,6,2,0,2,8,0,8,1,3,4,-3,3,0,-2,4,2,0,2,-2,0,0,0,2,0,1,1,1,1,-1,1,-1
KR_6760279082,420,3,-7,4,12,3,1,4,1,0,1,0,1,1,8,2,10,0,0,0,0,11,-137,0,-2,2,3,0,0,1,-1,1,-1,3,-1
KR_6726758748,420,-3,11,-16,-8,2,1,3,-1,2,1,-2,5,3,-7,8,1,0,2,2,0,-11,-17,0,-3,3,-5,0,1,0,1,1,-1,0,-1
KR_6637457676,420,-4,-22,-8,-5,4,1,5,-3,8,5,-4,5,1,-2,3,1,0,0,0,0,-3,-17,-1,-1,2,0,0,-1,-1,-1,-1,-1,2,-1
KR_6695026925,420,-4,-23,20,-2,-2,2,0,-1,2,1,2,1,3,-2,3,1,1,3,4,1,1,-1,0,-1,1,0,0,-1,1,-1,-1,1,6,-1
KR_6762617139,440,0,-38,20,-5,-2,3,1,0,1,1,-3,4,1,-1,2,1,1,0,1,0,-2,0,1,-4,3,0,0,-1,1,1,-1,-1,4,-1
KR_6727489367,420,-3,-79,0,-5,1,3,4,-2,4,2,-1,1,0,-4,5,1,1,1,2,0,-10,-9,-2,-2,4,0,0,-1,1,0,-1,-1,6,-1
KR_6724314275,420,-6,-127,-43,-5,-4,4,0,-2,2,0,1,2,3,-3,9,6,3,1,4,2,-5,-4,3,-4,1,-1,0,0,-1,-1,0,1,1,-1
KR_6762235993,420,-3,-80,-32,-6,2,0,2,1,1,2,-5,5,0,-4,4,0,0,1,1,0,-2,61,2,-3,1,0,0,0,1,1,0,-1,1,-1
KR_6660501681,420,-5,-64,8,-10,0,1,1,2,2,4,-8,8,0,0,1,1,-4,6,2,0,-1,322,-2,-1,3,1,0,-1,-1,-1,-1,-1,4,-1
KR_6635631815,420,-2,-68,27,-8,0,4,4,-2,5,3,0,2,2,-3,4,1,-3,4,1,-1,-11,-7,4,-4,0,-3,0,-2,1,1,-1,-1,6,-1
KR_6744473552,420,-1,-91,1,-2,0,1,1,2,1,3,-3,5,2,-3,4,1,2,0,2,1,-2,16,-3,0,3,1,0,-2,0,0,-1,1,0,-1
KR_6671572985,420,-4,-34,-8,-13,-1,3,2,-8,8,0,0,1,1,-1,3,2,-3,3,0,-1,-17,-1,-4,-2,6,-4,0,-1,1,-1,-1,-1,5,-1
KR_6760301878,420,0,54,25,1,-2,3,1,0,3,3,1,1,2,-1,5,4,3,1,4,1,-2,319,2,-7,5,-1,0,1,1,1,1,1,4,-1
KR_6567056090,420,-1,-49,20,2,-2,5,3,1,3,4,3,1,4,1,0,1,-1,2,1,0,4,4,1,-4,3,-1,0,-1,1,-1,-1,-1,2,-1
KR_6738726821,420,-2,-100,-29,-7,0,2,2,-1,4,3,-2,2,0,-3,3,0,-1,1,0,0,-4,0,0,-2,2,-1,0,-3,-1,-1,-1,-1,2,-1
KR_6690644378,420,6,37,20,8,5,3,8,2,1,3,0,2,2,-1,1,0,2,0,2,0,2,3,-3,-2,5,2,0,1,1,-1,1,1,3,-1
KR_6738498075,420,-5,-60,12,-9,-3,4,1,-4,4,0,1,1,2,-3,6,3,0,3,3,1,-7,0,0,-2,2,-1,0,-1,-1,1,-1,1,4,-1
KR_6739252326,420,-3,-20,6,0,-2,3,1,1,0,1,-1,3,2,0,2,2,2,0,2,0,2,4,1,-3,2,-1,0,0,1,-1,-1,-1,3,-1
KR_6642051017,420,-5,2,-25,-7,2,2,4,-3,6,3,-5,5,0,0,3,3,-1,1,0,0,-3,-2,-4,-2,6,-2,0,-2,-1,1,-1,1,4,-1
KR_6733436032,420,1,-5,12,-8,-5,6,1,-5,5,0,2,3,5,0,3,3,0,0,0,0,-6,1,-2,-1,3,0,0,1,0,0,1,-1,0,-1
KR_6630897436,420,-5,-84,-7,-13,-8,9,1,-4,5,1,0,3,3,1,3,4,-2,2,0,0,-10,25,3,-4,1,-3,0,-2,0,0,-1,-1,0,-1
KR_6700166647,420,-5,-81,-48,-13,-2,3,1,-2,3,1,-7,8,1,-2,2,0,0,0,0,0,-8,-2,1,-5,4,-2,0,-1,-1,-1,-1,-1,3,-1
KR_6653336111,420,-5,-31,-50,-4,-1,2,1,-3,6,3,0,2,2,1,0,1,-1,3,2,0,0,-15,-3,-2,5,2,0,0,0,-1,0,-1,0,-1
KR_6684660575,420,-2,106,-8,-2,4,2,6,1,2,3,-1,1,0,-4,4,0,-2,2,0,0,-8,13,2,-3,1,-2,0,1,-1,1,1,-1,3,-1
KR_6659044161,420,-2,-43,0,-9,-3,3,0,-1,2,1,-1,3,2,1,2,3,-5,5,0,0,-4,-6,1,-3,2,2,0,-2,0,-1,-1,-1,0,-1
KR_6687846326,440,-2,-44,0,-8,-6,6,0,-2,2,0,-5,5,0,5,3,8,0,0,0,0,-3,-39,1,-3,2,13,0,-2,-1,-1,-1,-1,5,-1
KR_6759220546,420,-2,-54,-10,-10,0,1,1,-2,2,0,-1,4,3,-6,10,4,-1,2,1,0,-13,0,-5,-3,8,-4,0,0,-1,0,0,-1,4,-1
KR_6575392359,420,0,-20,15,3,1,1,2,3,0,3,4,0,4,-6,6,0,1,1,2,0,3,44,-4,-3,7,4,0,0,1,1,0,-1,3,-1
KR_6395347452,420,-6,-59,8,-14,-3,4,1,-5,5,0,1,3,4,-4,7,3,-3,3,0,-3,-19,5,0,-4,4,-5,0,-1,1,1,-1,-1,1,-1
KR_6530933536,420,-3,-41,-12,-5,0,3,3,3,0,3,-2,2,0,-6,6,0,0,0,0,0,-6,5,-5,0,5,4,0,0,0,0,0,-1,0,-1
KR_6672409591,420,-4,-72,8,-2,1,0,1,1,1,2,0,2,2,-2,2,0,-2,2,0,0,-2,-7,-1,-1,2,2,0,-1,1,-1,-1,-1,6,-1
KR_6762680783,440,0,-33,12,-2,1,0,1,-1,6,5,-2,2,0,1,3,4,-1,2,1,0,-5,25,0,-2,2,-4,0,1,-1,-1,1,1,1,-1
KR_6660922722,420,-4,-34,-17,-13,-3,3,0,-3,3,0,0,0,0,-2,6,4,-5,6,1,0,-15,-6,0,-2,2,-5,0,-1,-1,-1,-1,-1,5,-1
KR_6545681875,420,-2,-128,-12,-5,2,1,3,1,2,3,-4,6,2,-4,8,4,0,0,0,0,4,-33,-5,-2,7,3,0,-1,1,1,1,-1,1,-1
KR_6636496382,420,0,65,-28,0,1,0,1,-5,5,0,5,0,5,-2,2,0,1,0,1,0,-4,-5,-2,-4,6,-3,0,1,1,1,1,1,4,-1
KR_6615691876,420,1,-34,25,-1,2,3,5,1,2,3,2,3,5,-5,6,1,-1,1,0,1,4,6,0,-2,2,5,0,0,1,1,-1,1,5,-1
KR_6650041379,420,-1,-25,-28,-5,2,0,2,-1,2,1,-6,8,2,-1,3,2,1,0,1,-1,-1,-8,-2,-3,5,-2,0,-1,-1,-1,-1,-1,6,-1
KR_6661625936,420,-1,-83,1,-6,1,0,1,1,3,4,-1,2,1,-8,8,0,1,2,3,-1,-6,-5,-5,-1,6,4,0,-1,-1,1,-1,-1,6,-1
KR_6703241826,420,-1,50,0,-4,-1,2,1,-5,5,0,1,5,6,1,2,3,0,2,2,0,1,22,2,-5,3,3,0,0,1,-1,0,1,2,-1
KR_6750533705,440,-1,7,8,-10,-4,4,0,-2,6,4,-8,9,1,1,2,3,3,0,3,1,-11,2,-4,-3,7,-5,0,1,-1,1,1,1,2,-1
KR_6714600709,420,-6,-62,-28,-14,-5,9,4,-3,5,2,-2,3,1,-2,2,0,-2,3,1,0,-5,-1,0,-2,2,0,0,-3,-1,0,-1,-1,2,-1
KR_6604866562,420,1,-12,-16,12,-3,5,2,3,0,3,11,0,11,4,0,4,-3,4,1,0,10,-21,0,-6,6,-2,0,1,1,-1,1,1,3,-1
KR_6760806541,420,-3,-41,-8,-11,-10,12,2,0,2,2,0,0,0,0,1,1,-1,2,1,1,-6,20,2,-4,2,-5,0,0,-1,-1,0,1,4,-1
KR_6748411893,440,0,0,19,3,1,2,3,3,0,3,0,1,1,0,4,4,-1,2,1,0,1,0,1,-1,0,-1,0,-2,0,1,-1,1,0,-1
KR_6505190014,420,0,11,-16,-2,0,1,1,0,1,1,-3,3,0,1,2,3,0,2,2,-1,-3,71,3,-6,3,-24,0,0,-1,1,0,-1,3,-1
KR_6726958384,420,0,-39,23,3,-1,2,1,5,4,9,-4,6,2,2,1,3,1,0,1,0,4,-4,2,-2,0,-1,0,0,-1,0,0,-1,2,-1
KR_6079921970,420,1,-4,0,5,-1,1,0,4,2,6,-4,4,0,1,0,1,5,0,5,0,4,4,2,-6,4,-2,0,1,-1,-1,1,-1,3,-1
KR_6625824644,440,-2,-61,16,6,0,2,2,3,0,3,-2,4,2,4,2,6,1,0,1,-1,9,4,2,-6,4,4,0,0,0,-1,-1,-1,0,-1
KR_6647286833,440,-7,-94,-30,-8,-1,2,1,-1,3,2,6,2,8,-10,15,5,-2,2,0,1,-4,-1,-2,-5,7,-1,0,-3,1,-1,-1,-1,3,-1
KR_6733253651,420,-1,-9,4,-4,-1,2,1,2,0,2,-1,3,2,-3,5,2,-1,1,0,0,-5,12,-3,0,3,1,0,0,0,0,0,-1,0,-1
KR_6743874553,420,2,29,8,4,3,2,5,0,3,3,2,1,3,0,0,0,-1,2,1,0,-1,-5,1,-2,1,0,0,0,1,1,0,1,6,-1
KR_6731310648,420,-2,-9,0,-6,-2,2,0,4,0,4,-4,5,1,2,1,3,-6,8,2,0,-9,88,3,-5,2,3,0,0,-1,-1,-1,-1,4,-1
KR_6603043116,440,-2,-15,4,-7,-2,3,1,-4,7,3,0,1,1,-1,1,0,0,0,0,0,-4,6,0,-4,4,0,0,-1,1,1,-1,1,2,-1
KR_6738201470,420,2,3,12,4,-4,5,1,3,0,3,-2,4,2,6,0,6,1,0,1,0,5,2,4,-5,1,-1,0,0,1,-1,1,-1,1,-1
KR_6629310770,420,-1,4,-11,-7,2,1,3,0,3,3,-3,4,1,-5,5,0,-1,2,1,0,-5,6,-1,-2,3,2,0,-1,-1,1,-1,-1,2,-1
KR_6751358560,420,-1,19,24,0,-2,2,0,1,1,2,5,4,9,-2,2,0,-2,2,0,0,-4,5,-2,-3,5,2,0,-1,1,-1,-1,-1,5,-1
KR_6448870134,420,-6,-60,-40,-13,-1,3,2,-1,2,1,-7,8,1,-1,4,3,-3,6,3,0,-13,-40,-3,-2,5,15,0,-3,-1,-1,-1,1,6,-1
KR_6633990477,420,-7,-127,-4,-16,-3,5,2,-4,7,3,0,4,4,-8,11,3,-1,3,2,-1,-9,27,-4,-1,5,-1,0,-5,-1,-1,-1,-1,1,-1
KR_6625622240,420,2,-26,-27,4,5,1,6,-2,5,3,3,0,3,-4,7,3,2,0,2,-1,1,-4,-4,-1,5,0,0,0,-1,1,0,-1,3,-1
KR_6651647761,420,-3,-34,-1,-4,1,2,3,0,1,1,2,1,3,-2,3,1,-5,7,2,0,6,4,1,-2,1,0,0,0,-1,-1,0,1,3,-1
KR_6643339388,420,-5,-88,-5,-15,-5,5,0,1,0,1,-9,9,0,-2,2,0,0,1,1,0,-5,-1,0,-2,2,-2,0,0,-1,0,-1,-1,1,-1
KR_6762298968,420,-3,-66,17,-10,0,0,0,-1,3,2,2,0,2,-10,10,0,-1,2,1,0,-18,14,-2,-1,3,-3,0,-1,-1,1,-1,-1,4,-1
KR_6723828525,440,-9,-96,-6,-15,-2,4,2,-1,3,2,-2,2,0,-3,3,0,-7,8,1,0,-7,-10,0,-3,3,0,0,-1,-1,-1,-1,-1,4,-1
KR_6738100131,420,-4,-7,-3,-11,-2,3,1,0,1,1,-2,2,0,-3,3,0,-4,5,1,0,-7,1,2,-5,3,-2,0,-2,-1,-1,-1,1,2,-1
KR_6757867091,420,1,-25,28,1,1,1,2,2,2,4,-4,6,2,3,1,4,-1,1,0,0,2,5,1,-4,3,2,0,0,1,0,0,1,1,-1
KR_6662738520,440,-6,10,-34,-7,-1,2,1,-6,7,1,3,1,4,-2,7,5,-1,1,0,0,-1,-9,2,-2,0,-1,0,-1,1,-1,-1,1,2,-1
KR_6646704075,420,3,27,8,5,3,0,3,0,1,1,0,3,3,2,0,2,0,0,0,0,-1,-1,1,-4,3,4,0,-1,-1,-1,-1,1,6,-1
KR_6622604327,420,-4,-58,-4,-10,-1,1,0,-6,7,1,0,1,1,-3,6,3,0,2,2,0,-11,-1,-3,-1,4,1,0,-1,-1,-1,-1,1,5,-1
KR_6682983958,420,0,-10,19,-6,-5,5,0,1,1,2,-1,5,4,0,2,2,-1,2,1,0,-2,-5,0,-3,3,-1,0,0,-1,1,-1,-1,3,-1
KR_6761699799,420,-1,-21,23,-4,-2,2,0,-4,6,2,2,2,4,1,1,2,-1,3,2,0,-10,5,-2,0,2,3,0,1,-1,1,1,-1,2,-1
KR_6640848079,420,-3,-118,12,-9,-6,6,0,-3,3,0,-2,4,2,3,1,4,-1,1,0,0,2,223,-2,-1,3,5,0,-2,1,-1,-1,-1,5,-1
KR_6762290688,420,-4,37,-41,-12,1,0,1,-1,2,1,-3,5,2,-9,9,0,0,1,1,0,-6,-13,-5,0,5,-1,0,-2,-1,0,-1,-1,2,-1
KR_6668680743,420,-3,28,-3,3,3,0,3,4,2,6,-1,2,1,-1,4,3,-2,2,0,0,1,-4,1,-3,2,-2,0,1,-1,1,1,1,1,-1
KR_6654735981,420,-6,-81,3,-9,1,1,2,-1,2,1,-3,3,0,-5,5,0,-1,1,0,0,-12,-5,-1,-1,2,0,0,-1,-1,-1,-1,-1,5,-1
KR_6604506049,420,0,-39,13,2,4,0,4,0,0,0,-1,5,4,-1,1,0,0,0,0,0,-2,5,-1,-3,4,1,0,-1,-1,-1,-1,1,4,-1
KR_6745953610,420,-2,-23,-12,-19,-8,9,1,-1,2,1,-7,9,2,-4,7,3,1,1,2,-2,-19,-185,-1,-4,5,0,0,-1,1,0,-1,-1,4,-1
KR_6495407309,420,-3,-18,8,-6,0,0,0,2,4,6,0,2,2,-6,8,2,-2,4,2,0,1,11,2,-6,4,-3,0,0,-1,0,1,-1,3,-1
KR_6747374152,420,1,-19,16,0,-1,1,0,1,3,4,-3,4,1,2,1,3,1,2,3,0,-3,-32,-1,-1,2,21,0,0,-1,-1,0,1,5,-1
KR_6760994110,420,-2,-98,32,-4,-2,3,1,6,0,6,1,1,2,-7,9,2,-2,2,0,-1,-8,4,3,-5,2,-3,0,-1,0,-1,-1,-1,0,-1
KR_6759489557,440,1,-30,-24,1,0,2,2,0,1,1,3,2,5,-1,4,3,-1,2,1,0,-4,6,-2,-3,5,-1,0,-1,1,1,-1,1,4,-1
KR_6695906144,440,5,124,-9,6,0,3,3,0,0,0,1,1,2,4,2,6,1,1,2,0,1,25,2,-5,3,1,0,1,1,-1,1,-1,4,-1
KR_6753472512,440,-1,-30,-28,-4,1,0,1,-7,7,0,2,1,3,-1,2,1,1,4,5,0,0,13,-4,0,4,0,0,0,1,1,-1,1,3,-1
KR_6649573148,420,-5,-43,0,-15,-5,5,0,0,0,0,1,2,3,-11,12,1,0,0,0,0,-11,18,-2,-2,4,-6,0,-1,1,0,-1,-1,6,-1
KR_6731853130,420,-2,-65,8,-2,-5,5,0,0,6,6,-1,4,3,2,1,3,2,3,5,0,-5,-349,-2,-1,3,22,0,-4,1,-1,-1,-1,2,-1
KR_6666220243,420,-6,-93,-16,-12,-2,2,0,-1,2,1,0,2,2,-7,7,0,-2,3,1,0,-15,-9,-4,-3,7,2,0,0,1,0,0,1,2,-1
KR_6750180495,420,0,37,1,1,1,0,1,1,3,4,5,3,8,-1,4,3,-5,6,1,0,-11,3,4,-4,0,3,0,1,-1,1,1,-1,3,-1
KR_6665824642,440,3,24,16,2,1,2,3,3,3,6,-3,3,0,0,2,2,1,0,1,0,3,-12,6,-6,0,3,0,0,-1,1,0,-1,4,-1
KR_6763034976,420,-2,-29,20,-8,-5,6,1,-2,3,1,-2,3,1,1,1,2,0,0,0,0,2,-60,5,-5,0,15,0,-1,1,-1,-1,-1,1,-1
KR_6095329125,420,0,42,-34,3,6,3,9,1,2,3,-3,4,1,-2,4,2,1,1,2,0,1,7,-2,-3,5,4,0,1,-1,1,1,1,1,-1
KR_6724769178,420,4,23,19,10,1,2,3,2,2,4,0,3,3,4,1,5,3,0,3,-1,9,-29,2,-7,5,1,0,0,0,-1,1,-1,0,-1
KR_6757417113,420,-4,-42,16,2,-1,2,1,-1,3,2,1,3,4,3,0,3,0,0,0,0,0,9,-2,-3,5,-4,0,-1,-1,-1,-1,1,2,-1
KR_6754775491,440,-5,-65,-8,-1,2,1,3,0,2,2,-2,3,1,-2,4,2,1,0,1,0,0,-7,2,-6,4,3,0,-1,1,-1,-1,1,2,-1
KR_6727861610,420,-2,21,-33,-2,-3,4,1,-1,1,0,1,1,2,0,2,2,1,2,3,0,-8,-19,-3,-1,4,1,0,-1,-1,-1,-1,-1,1,-1
KR_6537741902,420,1,9,36,1,-4,6,2,-1,2,1,1,2,3,4,2,6,1,0,1,0,6,-27,-1,-2,3,0,0,0,-1,0,0,1,2,-1
KR_6722491918,440,1,-78,-20,0,1,0,1,2,0,2,0,2,2,-3,4,1,0,0,0,0,3,11,4,-8,4,-3,0,-2,-1,-1,-1,-1,4,-1
KR_6653275424,420,3,25,16,5,1,1,2,1,2,3,2,1,3,1,3,4,0,0,0,0,6,-3,-3,0,3,-3,0,0,-1,0,0,-1,5,-1
KR_6737911659,420,3,13,48,1,-1,2,1,0,4,4,-3,4,1,2,3,5,3,1,4,0,-5,-18,-1,-2,3,2,0,0,1,-1,-1,-1,1,-1
KR_6670507749,420,-4,26,-16,-4,-1,2,1,0,1,1,-7,7,0,2,1,3,2,0,2,0,8,-1,-2,-3,5,1,0,0,1,-1,-1,-1,4,-1
KR_6666591345,420,1,0,15,-1,-8,8,0,1,1,2,-1,3,2,7,0,7,0,0,0,0,7,-2,1,-2,1,1,0,-2,-1,-1,-1,-1,6,-1
KR_6712530030,420,-3,-54,2,-8,-3,3,0,-2,4,2,2,4,6,1,0,1,-6,8,2,0,-8,-2,4,-6,2,-1,0,-4,-1,0,-1,-1,1,-1
KR_6338964881,420,2,30,6,0,-1,3,2,0,1,1,0,0,0,4,1,5,-3,3,0,0,1,-6,-4,-4,8,1,0,1,-1,-1,1,-1,5,-1
KR_6692155912,420,-1,51,12,4,-1,1,0,-1,2,1,5,0,5,0,3,3,1,2,3,1,8,-6,1,-7,6,7,0,0,1,0,0,1,1,-1
KR_6705308912,420,-3,-51,-28,-9,-6,7,1,-4,4,0,3,1,4,-2,2,0,0,0,0,0,-9,-99,0,-2,2,-4,0,0,0,-1,-1,-1,0,-1
KR_6740206522,420,-2,-34,20,-8,1,0,1,-4,6,2,-1,2,1,-1,1,0,-3,3,0,0,-6,-42,6,-7,1,13,0,0,0,-1,0,-1,0,-1
KR_6632617445,420,1,4,-23,-5,5,0,5,-2,3,1,-6,7,1,-3,3,0,1,0,1,0,-1,143,0,-2,2,0,0,0,1,1,0,-1,2,-1
KR_6762070968,420,1,-11,40,0,-2,2,0,3,0,3,-1,2,1,-1,2,1,1,0,1,0,1,5,0,-2,2,-3,0,0,1,1,0,1,2,-1
KR_6757938226,420,1,-22,19,3,-2,5,3,4,0,4,-3,3,0,3,0,3,1,1,2,0,-3,29,5,-5,0,0,0,0,1,0,0,-1,4,-1
KR_6759128979,420,-5,-101,10,-5,1,2,3,3,0,3,-5,7,2,-2,3,1,-2,2,0,0,-6,6,0,-4,4,-1,0,0,-1,1,0,-1,5,-1
KR_6724636874,420,0,-126,28,-8,-3,4,1,1,3,4,-3,3,0,-3,4,1,0,0,0,0,-6,-21,-2,0,2,-1,0,0,-1,0,0,-1,4,-1
KR_6756582258,420,-1,-23,0,-2,-4,4,0,2,2,4,2,2,4,-1,7,6,-1,1,0,0,1,31,-3,-1,4,-17,0,-1,1,-1,-1,-1,6,-1
KR_6696066521,420,1,2,-11,2,2,0,2,-3,5,2,-1,2,1,4,2,6,0,0,0,0,1,-46,0,-2,2,17,0,-1,-1,-1,-1,-1,4,-1
KR_5761948822,420,-1,-54,-24,1,-2,2,0,-3,4,1,0,3,3,5,0,5,1,0,1,0,-2,5,0,-3,3,-1,0,-1,-1,-1,-1,-1,3,-1
KR_6529336953,420,0,-44,13,2,1,1,2,-1,3,2,-2,3,1,0,6,6,4,0,4,-1,3,22,1,-6,5,-6,0,-1,1,-1,-1,-1,5,-1
KR_6731532755,420,-1,-22,0,-2,0,0,0,2,2,4,-6,6,0,1,2,3,1,0,1,0,2,10,3,-4,1,-1,0,0,-1,-1,0,-1,5,-1
KR_6737638786,420,-4,34,-56,-4,-4,4,0,2,3,5,1,2,3,-3,5,2,0,1,1,0,2,41,0,-5,5,-25,0,-2,-1,1,-1,1,6,-1
KR_6540316181,420,-3,-25,9,-11,5,1,6,-2,3,1,-11,12,1,-3,5,2,0,1,1,1,-7,-47,-2,-5,7,7,0,-1,-1,1,-1,1,3,-1
KR_6734406990,420,-1,-46,-4,-7,-3,4,1,2,1,3,-7,8,1,-1,1,0,2,2,4,-2,-10,-20,1,-3,2,4,0,0,-1,-1,0,-1,1,-1
KR_6762905398,440,-1,51,-4,-11,-1,3,2,-6,7,1,1,3,4,-2,6,4,-3,5,2,0,-14,-13,-3,-1,4,-1,0,1,-1,-1,-1,-1,3,-1
KR_6654193527,440,-2,-14,-37,-3,2,0,2,-3,6,3,-1,1,0,-2,3,1,1,0,1,0,-3,3,2,-4,2,-4,0,0,-1,-1,0,-1,5,-1
KR_6745751323,420,0,-38,3,0,-2,3,1,-1,1,0,2,2,4,1,3,4,0,2,2,0,-6,-7,-5,-1,6,-3,0,-1,1,-1,-1,-1,2,-1
KR_6596915168,420,-5,-24,-40,-12,-2,3,1,-5,9,4,-3,4,1,-2,2,0,0,1,1,0,-2,110,-2,-3,5,-3,0,-2,-1,0,-1,-1,1,-1
KR_6583438749,420,2,4,20,7,-1,1,0,6,0,6,0,2,2,-3,7,4,5,1,6,1,11,3,-1,-7,8,2,0,-1,-1,-1,-1,1,6,-1
KR_6738596098,420,-1,-24,8,-6,-1,2,1,-2,2,0,-1,4,3,-1,2,1,-1,1,0,0,-7,-6,-3,0,3,2,0,0,1,-1,0,-1,5,-1
KR_6599572776,440,-4,-162,19,-16,-4,5,1,-7,9,2,-1,6,5,-4,5,1,0,2,2,-1,-11,-10,-6,-1,7,-2,0,-1,0,0,-1,-1,0,-1
KR_6642842664,420,-5,-94,-54,-9,1,1,2,-6,6,0,-4,7,3,-1,1,0,1,0,1,0,-9,-3,-4,-4,8,0,0,-1,-1,-1,-1,-1,5,-1
KR_6633332200,420,0,-5,-44,-4,-5,7,2,-7,7,0,6,0,6,1,1,2,1,0,1,-1,0,0,-2,-1,3,3,0,-1,0,-1,-1,-1,0,-1
KR_6443135500,420,2,73,-16,1,2,6,8,-2,2,0,-1,6,5,2,1,3,0,1,1,0,1,2,0,-2,2,-1,0,1,-1,1,1,-1,5,-1
KR_6133418719,420,-1,-116,40,-9,-3,4,1,-1,5,4,0,0,0,-4,8,4,-1,2,1,-1,-8,-15,-2,-1,3,0,0,-2,0,-1,-1,-1,0,-1
KR_6463947730,420,-3,-71,-21,-10,-3,4,1,0,2,2,-3,5,2,-4,6,2,0,2,2,-2,-13,-6,-5,-1,6,1,0,-1,-1,1,-1,-1,6,-1
KR_6707172430,440,-2,39,-1,-6,-2,3,1,0,3,3,-1,4,3,-2,3,1,-1,1,0,0,-3,13,-2,-1,3,0,0,0,-1,-1,0,-1,6,-1
KR_6498333625,420,0,11,26,1,-3,3,0,0,2,2,4,2,6,0,0,0,0,0,0,0,3,-24,-3,-2,5,29,0,1,1,1,1,1,6,-1
KR_6761662494,420,-2,-10,-43,3,0,1,1,3,4,7,-1,3,2,-1,5,4,2,0,2,0,-2,-32,-3,-5,8,-1,0,0,0,-1,-1,-1,0,-1
KR_6762141523,420,-2,9,12,2,-3,4,1,3,0,3,5,2,7,-4,6,2,1,2,3,-1,5,-8,0,-3,3,-2,0,0,1,0,0,-1,3,-1
KR_6625779230,420,-2,-30,-28,-10,-4,5,1,-1,2,1,2,1,3,-3,4,1,-4,4,0,0,-9,-4,1,-4,3,1,0,-2,-1,1,-1,-1,2,-1
KR_6660969666,420,-5,-11,-36,-9,1,0,1,-4,4,0,-3,3,0,-2,3,1,-1,1,0,0,-12,-3,1,-4,3,0,0,1,-1,1,1,-1,2,-1
KR_6503400641,420,-8,5,-27,-10,1,1,2,-3,4,1,-1,3,2,-7,8,1,0,1,1,0,-13,-7,-3,-4,7,0,0,-2,0,-1,-1,1,0,-1
KR_6725108793,420,4,18,-5,11,2,1,3,1,1,2,-2,4,2,9,1,10,1,0,1,-1,12,-21,0,-3,3,5,0,2,1,1,1,-1,2,-1
KR_6726460790,420,-7,-93,-47,-8,0,4,4,-1,2,1,0,2,2,-7,8,1,0,0,0,0,-4,-2,-1,-4,5,-5,0,-2,-1,-1,-1,-1,4,-1
KR_6649601855,440,-5,16,-31,-10,-5,6,1,-4,6,2,-2,3,1,-3,4,1,4,0,4,0,-4,-230,0,-3,3,0,0,-1,-1,0,-1,-1,1,-1
KR_6693837663,420,-11,-175,-51,-24,-4,4,0,-3,3,0,-7,9,2,-10,13,3,0,0,0,0,-17,-6,0,-4,4,-1,0,-3,-1,-1,-1,1,3,-1
KR_6724344356,440,-3,-21,-27,-2,0,2,2,-4,4,0,0,0,0,0,1,1,2,0,2,0,-4,23,0,-4,4,4,0,1,1,-1,1,-1,3,-1
KR_6618709589,420,-2,7,-1,-2,4,1,5,1,1,2,-2,3,1,-4,7,3,-1,2,1,1,-8,-118,0,-3,3,-1,0,-1,1,1,-1,1,3,-1
KR_6545602170,420,-6,-106,-8,-13,-3,3,0,-3,4,1,0,2,2,-8,8,0,1,0,1,0,-16,-3,-6,0,6,0,0,-1,-1,-1,-1,-1,1,-1
KR_6622135833,420,-2,-23,-4,-4,-1,2,1,1,1,2,2,0,2,-3,5,2,-3,3,0,0,-2,-112,0,-4,4,-15,0,-1,0,1,-1,-1,0,-1
KR_6714719433,420,-2,-2,-32,-1,-1,2,1,-2,3,1,3,2,5,-4,9,5,3,3,6,0,4,52,3,-3,0,-34,0,0,-1,0,1,1,5,-1
KR_6626309031,420,0,0,0,2,-3,3,0,-1,2,1,1,3,4,3,0,3,2,2,4,0,1,-5,-2,-3,5,-3,0,0,0,-1,0,1,0,-1
KR_6731268342,420,-1,-15,8,-7,1,0,1,0,2,2,-6,8,2,-3,4,1,1,1,2,0,-4,-6,-5,0,5,6,0,-1,1,-1,-1,-1,6,-1
KR_6695830951,440,-1,2,-29,4,0,1,1,2,2,4,3,3,6,0,2,2,-1,2,1,0,9,1,-3,-3,6,2,0,0,-1,0,0,-1,3,-1
KR_6673137305,420,-1,-67,-28,-3,-3,5,2,-2,4,2,-2,3,1,4,3,7,0,1,1,0,6,-3,-2,-2,4,-2,0,-2,-1,-1,-1,-1,1,-1
KR_6695247066,420,-3,-67,1,-1,-1,3,2,-2,5,3,2,0,2,2,2,4,-2,3,1,0,3,-4,2,-4,2,2,0,1,0,0,-1,1,0,-1
KR_6701271049,420,-1,20,6,-2,-1,1,0,1,4,5,2,0,2,-2,3,1,-2,2,0,0,0,-2,1,-6,5,-3,0,0,1,-1,0,-1,5,-1
KR_6752578412,440,-2,-42,8,-7,-4,4,0,0,1,1,-2,3,1,-1,2,1,0,0,0,0,-8,50,-1,0,1,0,0,1,1,0,1,-1,5,-1
KR_6623644572,420,0,17,-33,5,-5,7,2,2,0,2,0,1,1,8,0,8,0,2,2,0,10,5,2,-4,2,0,0,0,1,-1,1,1,6,-1
KR_6739404980,420,-5,-81,-8,-12,0,2,2,-2,3,1,-4,5,1,-5,5,0,-1,1,0,0,-11,-4,0,-1,1,-1,0,-1,-1,-1,-1,1,1,-1
KR_6762761941,420,1,-81,12,-1,0,1,1,4,1,5,-3,5,2,-1,2,1,-1,1,0,0,2,29,0,-3,3,-13,0,0,-1,0,-1,1,5,-1
KR_6753589513,440,4,-32,8,8,6,0,6,0,0,0,1,1,2,-1,2,1,2,1,3,0,14,-7,2,-4,2,0,0,0,0,0,0,1,0,-1
KR_6729617109,440,0,22,-5,-3,3,2,5,-3,6,3,0,1,1,-2,3,1,-1,2,1,0,-6,323,1,-4,3,2,0,2,-1,1,1,-1,3,-1
KR_6363089571,420,-3,-22,12,-9,-9,9,0,-1,7,6,1,2,3,-1,4,3,1,1,2,1,-2,0,0,0,0,-1,0,2,1,1,1,1,6,-1
KR_6596138637,420,2,9,32,3,-3,3,0,0,2,2,1,2,3,2,1,3,3,0,3,1,2,22,0,-1,1,-3,0,1,-1,-1,1,1,1,-1
