matchId,queueId,Diff_LV,Diff_CS,Diff_jglCS,Diff-K,Diff-K-top,K-WIN-top,K-LOSE-top,Diff-K-jug,K-WIN-jug,K-LOSE-jug,Diff-K-mid,K-WIN-mid,K-LOSE-mid,Diff-K-ad,K-WIN-ad,K-LOSE-ad,Diff-K-sup,K-WIN-sup,K-LOSE-sup,invadeKill,Diff-A,Diff_WARDplaced,Diff-ControlWARDplaced,LOSE_controlWARDPlaced,WIN_controlWARDPlaced,Diff_WARDkill,Diff_Inhibitor,Diff_TOWERkill,Diff_FirstDRAGON,Diff_FirstHERALD,Diff_Firsttower,Diff_FirstBLOOD,dragonType,result
KR_6764348017,420,0,-22,1,-2,-3,5,2,1,2,3,-1,2,1,1,1,2,0,1,1,0,0,-4,1,-3,2,2,0,-1,1,1,-1,-1,5,-1
KR_6717534637,420,-3,-19,-20,-15,-2,3,1,1,0,1,-10,12,2,-5,5,0,1,0,1,0,-16,2,2,-6,4,-8,0,-1,-1,-1,-1,-1,1,-1
KR_6144706447,420,-1,14,5,-1,-3,4,1,3,1,4,4,0,4,-4,6,2,-1,1,0,0,-2,3,0,-4,4,0,0,-1,-1,1,-1,1,4,-1
KR_6659596541,440,0,35,-15,-1,2,1,3,-2,3,1,-5,5,0,3,3,6,1,0,1,0,5,4,-2,-1,3,-1,0,0,-1,0,0,1,3,-1
KR_6674320621,420,0,-28,1,-2,-2,2,0,-4,7,3,-1,4,3,4,3,7,1,1,2,0,-1,-5,-3,-4,7,0,0,-1,1,-1,-1,-1,1,-1
KR_6741991317,440,0,-49,4,-4,-4,5,1,0,3,3,-2,2,0,2,1,3,0,0,0,0,0,3,-1,-4,5,1,0,0,-1,1,0,-1,6,-1
KR_5996612206,440,2,49,-28,0,1,3,4,-4,8,4,3,1,4,3,0,3,-3,4,1,0,-2,-2,-3,-1,4,1,0,0,-1,0,0,1,2,-1
KR_6762145719,420,1,7,-4,6,1,1,2,0,1,1,4,1,5,2,4,6,-1,3,2,0,2,-26,0,-2,2,0,0,0,0,0,0,1,0,-1
KR_6763278005,420,2,17,20,8,0,3,3,0,2,2,-6,8,2,14,1,15,0,0,0,1,16,6,2,-6,4,-3,0,0,-1,-1,-1,1,3,-1
KR_6752158501,420,4,86,-24,9,-1,1,0,1,0,1,4,1,5,4,0,4,1,0,1,1,9,-15,2,-3,1,8,0,2,1,1,1,1,5,-1
KR_6552176943,420,-1,-20,4,-5,-2,4,2,0,4,4,1,2,3,-5,7,2,1,0,1,0,-6,5,1,-4,3,-2,0,-1,-1,0,-1,-1,5,-1
KR_6757604378,440,-4,-59,15,-10,-6,7,1,-2,2,0,-1,2,1,3,3,6,-4,4,0,-1,-10,0,-3,-3,6,-3,0,-1,1,-1,-1,-1,3,-1
KR_6759824934,420,1,9,0,-1,0,1,1,5,0,5,-2,4,2,-5,6,1,1,0,1,0,6,2,1,-3,2,-1,0,0,-1,-1,0,-1,1,-1
KR_6684712070,420,-1,-45,-48,4,-4,7,3,3,1,4,7,1,8,-2,4,2,0,0,0,0,6,-1,1,-2,1,1,0,0,-1,-1,1,-1,6,-1
KR_6745895282,420,-6,-35,-4,-21,-8,8,0,-6,7,1,-3,3,0,-4,7,3,0,0,0,-1,-20,15,-1,-1,2,-2,0,-2,-1,-1,-1,-1,4,-1
KR_6579421689,420,-2,-13,-31,-1,0,0,0,0,4,4,-7,9,2,4,2,6,2,0,2,0,10,10,5,-7,2,0,0,-1,1,0,-1,1,6,-1
KR_6727792005,420,3,47,20,6,-4,4,0,-1,3,2,-1,3,2,10,1,11,2,0,2,0,8,4,2,-5,3,-2,0,1,1,-1,1,1,6,-1
KR_6622768071,440,-1,-51,4,-1,-1,2,1,1,3,4,2,0,2,-2,4,2,-1,1,0,0,-6,5,1,-3,2,-2,0,-1,0,1,-1,-1,0,-1
KR_6634187975,420,-1,-53,24,-4,1,0,1,-1,2,1,0,1,1,-3,3,0,-1,1,0,1,-4,-19,-3,0,3,1,0,0,-1,1,0,1,4,-1
KR_6421075865,420,-3,-75,-1,-5,-6,7,1,-4,6,2,2,3,5,3,2,5,0,1,1,-1,4,-7,-1,-5,6,-2,0,0,1,1,1,-1,6,-1
KR_6348391634,420,0,-35,-28,0,3,2,5,1,1,2,6,0,6,-11,11,0,1,1,2,2,1,26,2,-4,2,1,0,-1,-1,-1,-1,1,5,-1
KR_6605030253,420,0,-43,-16,-7,0,2,2,0,1,1,-7,10,3,-1,2,1,1,0,1,0,-5,-1,-2,-3,5,-3,0,0,1,0,1,-1,3,-1
KR_6759089769,420,4,-1,16,2,3,1,4,-1,2,1,-2,3,1,1,0,1,1,3,4,0,4,403,-4,-1,5,1,0,1,0,0,1,1,0,-1
KR_6732868593,440,0,-12,8,0,2,0,2,-1,5,4,-3,5,2,3,2,5,-1,1,0,-1,5,7,3,-5,2,-2,0,0,-1,-1,-1,1,2,-1
KR_6680460835,420,-2,23,-8,-9,-1,2,1,-2,3,1,-7,7,0,0,4,4,1,1,2,-1,-6,-10,-6,-2,8,0,0,1,-1,-1,1,-1,6,-1
KR_6708352437,440,-5,8,-44,-19,-4,5,1,-8,9,1,0,1,1,1,2,3,-8,8,0,1,-17,0,-1,-2,3,-4,0,-2,-1,-1,-1,1,5,-1
KR_6756465405,420,-4,-12,-20,-10,2,2,4,-5,7,2,-7,8,1,-4,5,1,4,1,5,0,-2,-45,-4,0,4,8,0,0,-1,-1,-1,1,6,-1
KR_6734045373,440,0,-6,14,-2,0,1,1,-1,2,1,-1,2,1,0,6,6,0,1,1,0,4,29,-1,-6,7,-13,0,-1,1,-1,-1,-1,6,-1
KR_6584728476,420,-1,-41,0,-6,3,1,4,-4,4,0,3,2,5,-8,9,1,0,1,1,0,-11,-2,-4,0,4,0,0,-1,-1,-1,-1,1,2,-1
KR_6576908399,420,-3,-58,-45,-4,0,2,2,-3,7,4,2,3,5,-2,3,1,-1,2,1,0,-10,11,-4,-3,7,-2,0,0,-1,-1,-1,1,2,-1
KR_6638838500,420,-6,-80,12,-17,-5,5,0,-1,4,3,2,1,3,-12,12,0,-1,1,0,0,-20,-17,0,-3,3,-4,0,-1,-1,-1,-1,-1,2,-1
KR_6720353278,420,0,-13,-7,-8,-1,2,1,-7,8,1,3,0,3,-5,6,1,2,1,3,-3,-12,1,-3,-2,5,1,0,0,-1,-1,0,-1,4,-1
KR_6642398320,420,-2,-42,0,-13,0,2,2,-7,7,0,0,0,0,-4,5,1,-2,2,0,0,-11,-4,-1,-4,5,0,0,0,-1,1,0,-1,1,-1
KR_6647503087,420,0,-94,12,-5,-2,4,2,0,1,1,2,2,4,-5,5,0,0,0,0,0,-4,2,-1,-3,4,0,0,0,-1,1,-1,-1,2,-1
KR_6723996212,420,-3,15,-4,-4,-6,6,0,1,1,2,0,1,1,-1,4,3,2,1,3,0,-1,-14,-3,0,3,5,0,0,-1,0,-1,-1,4,-1
KR_6566349065,420,-2,15,-16,-7,2,0,2,-6,10,4,-2,2,0,1,0,1,-2,2,0,0,-11,200,-1,-3,4,-1,0,0,-1,-1,0,-1,3,-1
KR_6719425100,420,1,0,12,1,2,0,2,-1,3,2,0,0,0,0,0,0,0,2,2,0,3,8,2,-6,4,-1,0,-1,-1,1,-1,-1,6,-1
KR_6723694293,420,-2,10,26,-7,-3,3,0,-1,5,4,-4,4,0,0,3,3,1,0,1,-1,-7,6,2,-2,0,1,0,0,-1,-1,1,-1,5,-1
KR_6605360426,420,1,-27,24,0,1,0,1,1,2,3,5,1,6,-6,8,2,-1,2,1,0,-6,170,-1,-5,6,6,0,1,-1,1,1,-1,1,-1
KR_6743023669,440,-2,-79,1,-11,3,5,8,-2,3,1,-3,4,1,-5,6,1,-4,4,0,0,-8,3,0,-1,1,-2,0,-1,-1,1,-1,1,4,-1
KR_6690032799,420,-3,-73,-29,-7,-2,2,0,-3,3,0,-2,2,0,0,1,1,0,5,5,1,-1,6,0,-2,2,-3,0,-1,-1,-1,-1,1,2,-1
KR_6756225564,420,1,-7,32,6,1,0,1,4,0,4,2,1,3,-3,7,4,2,0,2,1,3,-410,2,-4,2,0,0,-1,1,1,-1,1,5,-1
KR_6677405881,440,-5,-102,4,-15,-3,3,0,-2,5,3,-5,5,0,-4,7,3,-1,2,1,-4,-19,-3,-1,-5,6,-4,0,-1,-1,-1,-1,-1,4,-1
KR_6764676932,420,3,29,19,2,2,3,5,-1,2,1,0,3,3,-4,7,3,5,0,5,1,-5,-25,-1,-2,3,-2,0,2,-1,0,-1,1,5,-1
KR_6750253568,420,-4,-75,0,-6,2,1,3,-4,6,2,-3,3,0,1,2,3,-2,2,0,0,-3,-4,2,-5,3,6,0,-1,-1,-1,-1,-1,3,-1
KR_6747748687,440,1,-13,13,0,1,1,2,1,0,1,-5,6,1,3,3,6,0,0,0,0,-1,8,-2,-5,7,3,0,0,1,1,0,1,5,-1
KR_6191370793,440,1,57,1,1,4,1,5,-5,6,1,-4,4,0,3,3,6,3,0,3,1,2,-2,0,-2,2,-2,0,1,-1,1,1,1,3,-1
KR_6724709136,420,-2,-87,-4,-8,-3,4,1,3,2,5,-1,3,2,-7,8,1,0,4,4,0,-4,3,1,-3,2,-1,0,-2,1,-1,-1,-1,3,-1
KR_6760446107,420,-2,-11,-28,-7,-3,3,0,1,2,3,1,0,1,-3,7,4,-3,3,0,0,-6,-18,-3,0,3,0,0,0,0,1,0,-1,0,-1
KR_6764216568,420,-4,-28,-4,-4,-3,4,1,-1,2,1,0,3,3,0,3,3,0,0,0,0,1,-1,8,-10,2,-6,0,0,0,0,0,-1,0,-1
KR_6603047648,420,-2,-14,-31,-4,0,1,1,-1,3,2,6,1,7,-8,8,0,-1,1,0,0,-10,-1,1,-1,0,-1,0,0,-1,0,0,-1,3,-1
KR_6731921856,420,1,70,-8,-1,0,0,0,-1,6,5,-2,5,3,3,2,5,-1,3,2,0,-2,-1,-1,-2,3,0,0,0,-1,-1,0,1,6,-1
KR_6709760185,440,-3,19,-12,-9,3,0,3,-6,7,1,0,1,1,-5,7,2,-1,3,2,0,-5,409,-2,-2,4,-2,0,0,0,1,1,-1,0,-1
KR_6660197556,420,-4,-82,-4,-2,-3,4,1,-4,4,0,2,0,2,4,2,6,-1,2,1,0,-1,-13,1,-2,1,0,0,-1,-1,1,-1,-1,5,-1
KR_6723728170,440,-6,-72,-29,-11,1,1,2,-11,11,0,1,2,3,-2,4,2,0,0,0,-3,-12,6,5,-7,2,-3,0,-1,1,0,-1,-1,3,-1
KR_6672267098,420,0,-7,0,-10,1,3,4,0,1,1,-5,6,1,0,2,2,-6,6,0,0,-9,5,1,-2,1,0,0,-1,-1,-1,-1,-1,2,-1
KR_6762945111,420,4,-3,96,2,1,1,2,-1,3,2,1,0,1,1,1,2,0,1,1,0,-4,-8,-4,0,4,1,0,-1,0,1,-1,1,0,-1
KR_6736307903,440,-2,-90,16,-5,0,2,2,-3,3,0,-1,1,0,1,2,3,-2,2,0,0,-5,-6,3,-5,2,0,0,-1,0,-1,-1,-1,0,-1
KR_6723762617,440,-2,44,8,-3,1,0,1,-7,8,1,1,2,3,2,0,2,0,3,3,-1,-5,-30,-2,-3,5,0,0,1,-1,1,1,-1,6,-1
KR_6751899461,440,-2,-2,0,-7,0,2,2,-7,7,0,-1,3,2,1,1,2,0,1,1,0,-5,-7,0,-4,4,4,0,0,-1,0,0,-1,6,-1
KR_6620963514,440,-1,-37,-10,4,1,1,2,-2,3,1,1,4,5,3,1,4,1,0,1,0,-4,4,4,-6,2,-2,0,-1,1,1,-1,1,3,-1
KR_6748826184,440,0,-17,9,8,3,3,6,2,0,2,0,2,2,2,2,4,1,0,1,0,9,26,2,-4,2,-4,0,0,-1,-1,1,1,4,-1
KR_6761802271,420,1,47,-7,1,0,3,3,-9,9,0,8,1,9,2,2,4,0,1,1,-1,-5,7,4,-8,4,-4,0,0,-1,0,0,-1,5,-1
KR_6620545213,420,-3,-78,-52,-4,-5,7,2,-5,6,1,2,3,5,4,2,6,0,2,2,1,8,6,1,-6,5,-4,0,-1,-1,1,-1,1,5,-1
KR_6758610093,420,-1,-23,8,2,0,2,2,0,0,0,-1,3,2,2,5,7,1,0,1,0,10,12,1,-4,3,1,0,0,1,-1,0,-1,4,-1
KR_6749820034,420,3,63,4,3,0,4,4,-3,5,2,3,2,5,1,5,6,2,0,2,0,-1,20,1,-3,2,-2,0,1,-1,0,1,1,4,-1
KR_6739443745,420,4,74,43,1,-2,4,2,5,1,6,-3,3,0,0,1,1,1,0,1,0,2,-3,-4,-1,5,6,0,0,1,-1,0,-1,6,-1
KR_6691793024,440,-1,-31,-4,-1,-1,3,2,-3,3,0,3,3,6,6,0,6,-6,7,1,0,11,-237,1,-8,7,-4,0,0,1,1,0,-1,6,-1
KR_6636488424,420,-2,-22,-28,5,-2,2,0,-1,3,2,0,1,1,8,0,8,0,2,2,0,6,-153,1,-4,3,23,0,0,-1,-1,-1,-1,2,-1
KR_6760497413,420,-3,-12,-23,0,0,1,1,3,0,3,-4,5,1,-2,5,3,3,0,3,0,4,-45,-5,-4,9,28,0,0,1,-1,-1,1,5,-1
KR_6668411490,420,-8,-73,7,-18,2,3,5,-4,5,1,-7,7,0,-4,5,1,-5,5,0,0,-23,-5,-3,-4,7,-2,0,-2,1,-1,-1,-1,2,-1
KR_6567380657,420,0,12,-31,-6,-1,2,1,0,2,2,1,0,1,-3,4,1,-3,4,1,-1,-7,8,1,-4,3,-6,0,0,-1,1,1,-1,6,-1
KR_6374274826,420,-7,-76,-12,-11,-4,4,0,-7,9,2,-1,3,2,3,0,3,-2,3,1,0,-13,0,0,0,0,-2,0,-1,1,0,-1,1,5,-1
KR_6670583427,420,-1,45,-25,-5,-2,3,1,4,1,5,-6,7,1,-1,1,0,0,0,0,0,3,11,6,-7,1,-3,0,-2,0,1,-1,1,0,-1
KR_6505104602,420,-4,-28,-8,-2,-1,3,2,3,1,4,1,3,4,-2,4,2,-3,4,1,0,1,-385,2,-5,3,-1,0,-2,-1,-1,-1,1,5,-1
KR_6722925909,420,-5,-40,-26,-8,-2,2,0,-6,9,3,1,0,1,-1,1,0,0,0,0,-2,-7,-348,5,-6,1,-1,0,0,-1,1,-1,-1,2,-1
KR_6709396028,420,-3,-6,1,-1,0,0,0,-4,5,1,6,0,6,-5,7,2,2,1,3,1,-10,-1,-2,-2,4,-2,0,0,-1,1,0,1,4,-1
KR_6746293627,420,-4,-98,-16,-5,-7,8,1,0,1,1,-1,4,3,4,0,4,-1,3,2,-1,3,-315,1,-4,3,-2,0,0,-1,-1,-1,-1,3,-1
KR_6624411982,420,3,7,47,8,3,0,3,1,0,1,10,1,11,-5,5,0,-1,2,1,0,-3,-4,0,-1,1,-3,0,0,-1,0,1,1,6,-1
KR_6560785173,420,-6,-61,-52,-15,2,0,2,-7,7,0,-1,2,1,-6,6,0,-3,4,1,0,-22,-7,-3,-3,6,1,0,-1,-1,1,-1,-1,3,-1
KR_6676376767,420,-3,-118,92,-13,-2,3,1,1,0,1,-10,11,1,-1,1,0,-1,2,1,0,-12,-154,0,-1,1,1,0,-3,1,1,-1,-1,2,-1
KR_5535226422,420,2,10,-4,7,6,0,6,2,1,3,1,1,2,-4,4,0,2,0,2,0,6,17,3,-3,0,-1,0,2,-1,1,1,1,3,-1
KR_6652187849,420,-3,-2,-16,0,-3,4,1,0,1,1,5,0,5,-3,3,0,1,0,1,0,1,1,-1,-2,3,-1,0,-1,0,0,-1,-1,0,-1
KR_6734760409,440,-1,-45,-8,0,-2,3,1,1,4,5,-1,1,0,0,2,2,2,0,2,0,-1,3,0,-7,7,0,0,1,1,1,1,-1,5,-1
KR_6640178322,420,-6,-74,-8,-6,-3,3,0,-4,5,1,-4,7,3,4,0,4,1,1,2,0,-5,-7,0,-5,5,-2,0,-1,-1,-1,-1,-1,1,-1
KR_6741152656,420,-6,-43,20,-15,-1,4,3,-14,15,1,-2,4,2,1,0,1,1,1,2,0,-5,3,0,-1,1,-3,0,-1,-1,1,-1,1,4,-1
KR_6722701517,420,-5,-32,-40,-4,2,1,3,0,3,3,2,1,3,-5,5,0,-3,3,0,0,-11,-8,-3,-2,5,2,0,-1,-1,1,-1,-1,3,-1
KR_6722679168,420,-1,-23,12,-11,0,2,2,2,1,3,-7,8,1,-4,5,1,-2,3,1,-1,-10,-118,-2,-1,3,-1,0,0,-1,1,0,-1,3,-1
KR_6762374730,420,3,24,-3,12,-1,4,3,9,0,9,0,2,2,3,0,3,1,0,1,0,13,4,1,-2,1,-1,0,1,-1,0,-1,-1,4,-1
KR_6736106564,420,-2,-87,4,-7,2,1,3,-3,5,2,-5,5,0,0,2,2,-1,2,1,0,-13,7,0,-5,5,0,0,1,-1,-1,1,-1,3,-1
KR_6762288385,420,-9,-74,-27,-26,-5,5,0,-1,1,0,-6,7,1,-10,11,1,-4,7,3,0,-19,-16,-3,-1,4,2,0,-7,-1,-1,-1,-1,5,-1
KR_6650369592,420,1,41,-27,-3,0,3,3,-4,4,0,-2,2,0,3,4,7,0,1,1,0,-7,22,-4,-2,6,-1,0,0,-1,-1,-1,-1,4,-1
KR_6734869990,420,-4,-36,8,-7,-3,3,0,-1,2,1,0,2,2,3,2,5,-6,7,1,1,-1,-11,-2,-1,3,6,0,-1,-1,1,-1,1,2,-1
KR_6746398030,420,-2,0,-3,-2,2,1,3,-1,1,0,1,1,2,0,4,4,-4,4,0,0,-7,4,1,-2,1,2,0,1,-1,1,1,1,1,-1
KR_6673355620,420,-3,-14,-16,-8,3,2,5,-3,5,2,-4,7,3,-3,6,3,-1,3,2,-1,-11,5,-1,-1,2,-3,0,-2,-1,-1,-1,-1,1,-1
KR_6742475292,420,-3,-10,-16,-9,-8,9,1,-2,5,3,-1,5,4,2,1,3,0,2,2,0,-7,6,-1,-1,2,-1,0,-4,-1,-1,-1,-1,6,-1
KR_6750093061,440,-2,-57,16,-1,-2,2,0,-4,5,1,2,4,6,1,0,1,2,0,2,0,2,8,0,-4,4,1,0,0,-1,1,0,-1,3,-1
KR_6718731028,420,-5,-19,-7,-7,3,3,6,-2,2,0,-1,4,3,-7,7,0,0,0,0,0,-6,-35,-4,0,4,3,0,-1,-1,1,-1,1,1,-1
KR_6751598244,420,-1,30,4,-3,0,1,1,-2,3,1,-1,3,2,0,4,4,0,3,3,-1,-5,-49,-2,-2,4,11,0,2,1,-1,1,-1,6,-1
KR_6759360510,420,-5,-12,-16,-9,-5,5,0,-3,5,2,-5,5,0,4,2,6,0,2,2,1,-9,1,3,-7,4,4,0,0,-1,-1,0,1,2,-1
KR_6678714298,440,-1,43,-13,-5,-3,4,1,1,1,2,2,1,3,-3,4,1,-2,3,1,-1,-2,-191,1,-5,4,11,0,-2,-1,0,-1,-1,2,-1
KR_6760403021,420,-8,-75,-11,-11,-3,3,0,-5,5,0,-1,2,1,-1,2,1,-1,2,1,0,-6,-7,0,-3,3,-6,0,-1,-1,0,-1,-1,5,-1
KR_6726354960,420,4,120,19,5,3,1,4,0,3,3,3,1,4,-2,5,3,1,1,2,0,-1,0,0,-4,4,-3,0,1,-1,0,1,1,5,-1
KR_6508151367,420,1,60,4,4,2,1,3,9,1,10,-4,5,1,-2,3,1,-1,2,1,0,-8,179,3,-6,3,3,0,1,-1,1,1,-1,1,-1
KR_5797444704,420,2,13,-8,6,-2,3,1,-1,4,3,2,0,2,5,0,5,2,1,3,0,10,2,2,-6,4,3,0,-1,-1,-1,-1,1,4,-1
KR_6668991480,420,0,3,8,1,0,1,1,-2,3,1,-1,4,3,3,0,3,1,0,1,-2,-3,7,7,-8,1,-1,0,1,1,1,1,-1,5,-1
KR_6612585861,420,-3,-84,4,-6,0,5,5,-1,6,5,-1,2,1,0,1,1,-4,7,3,-1,-3,-393,5,-6,1,-7,0,-1,-1,0,1,-1,2,-1
KR_6534532464,420,-1,-28,12,-6,0,1,1,1,3,4,-4,6,2,-2,4,2,-1,3,2,0,-3,-13,-1,-3,4,-2,0,-1,-1,1,-1,-1,6,-1
KR_6700016032,440,-1,-17,20,1,-2,3,1,-1,1,0,3,3,6,0,2,2,1,1,2,0,3,-2,-2,-1,3,0,0,1,0,1,1,-1,0,-1
KR_6758888679,420,-7,-110,-37,-3,-5,5,0,-1,1,0,-2,2,0,6,2,8,-1,2,1,0,-6,17,0,-4,4,0,0,-1,1,-1,-1,-1,3,-1
KR_6063955320,420,4,12,16,6,-2,2,0,2,1,3,7,1,8,-2,3,1,1,0,1,0,9,-9,-1,-1,2,4,0,1,0,0,1,-1,0,-1
KR_6595954962,420,-3,-27,-11,-3,0,1,1,-2,4,2,3,1,4,-4,5,1,0,1,1,0,-8,-1,0,-4,4,-4,0,0,-1,1,-1,-1,6,-1
KR_6330761622,420,-4,-5,10,-10,-2,3,1,1,2,3,-3,7,4,-6,6,0,0,0,0,0,-9,-4,1,-4,3,2,0,-1,1,-1,-1,-1,2,-1
KR_6660837065,420,-1,8,-7,-9,0,0,0,-8,8,0,-1,3,2,-1,3,2,1,1,2,0,-10,-219,-2,-2,4,-3,0,1,1,0,1,-1,1,-1
KR_6683182393,440,-5,-72,-11,-11,-1,1,0,-1,3,2,-1,2,1,-8,8,0,0,1,1,0,-1,-9,0,-2,2,1,0,-3,-1,-1,-1,-1,1,-1
KR_6257096722,440,-3,10,-24,-2,-3,4,1,3,1,4,-5,5,0,1,3,4,2,2,4,0,2,-6,-2,-4,6,1,0,2,-1,-1,1,1,5,-1
KR_6601907444,420,-3,9,-20,-7,0,1,1,-3,3,0,0,3,3,-4,4,0,0,1,1,0,-9,-32,-1,-1,2,-2,0,1,-1,1,1,-1,5,-1
KR_6567922561,420,-5,-55,-14,-16,-3,3,0,-5,7,2,-1,3,2,-5,6,1,-2,3,1,-2,-17,-428,3,-4,1,10,0,-2,-1,-1,-1,-1,3,-1
KR_6758241050,440,-3,-71,-21,-8,2,2,4,-5,5,0,-2,2,0,-1,4,3,-2,2,0,0,-7,2,1,-7,6,-3,0,0,-1,-1,-1,-1,6,-1
KR_6727668838,420,-3,47,4,-1,5,1,6,-1,3,2,3,3,6,-6,6,0,-2,3,1,0,-17,-3,0,-3,3,-3,0,-1,1,1,-1,-1,1,-1
KR_6473348141,420,-1,-2,-24,1,-2,5,3,1,2,3,-2,3,1,3,2,5,1,1,2,2,10,-2,-1,-3,4,0,0,0,1,-1,0,1,1,-1
KR_6761574099,420,-4,28,-24,-11,-1,1,0,-4,4,0,-4,5,1,-1,1,0,-1,1,0,0,-12,-1,-5,-2,7,5,0,-1,-1,-1,-1,-1,4,-1
KR_6737799647,420,-2,-58,-5,-12,0,2,2,-6,7,1,-2,2,0,-2,3,1,-2,2,0,-3,-7,-3,2,-3,1,-6,0,0,0,1,0,-1,0,-1
KR_6723268421,420,0,18,14,-4,-4,4,0,1,1,2,-1,1,0,0,4,4,0,1,1,0,4,9,-2,-5,7,1,0,-1,1,-1,-1,-1,1,-1
KR_6608457303,420,-2,-44,-12,-1,-2,3,1,0,2,2,-1,4,3,2,2,4,0,1,1,2,9,-4,-1,-2,3,-4,0,0,0,0,-1,1,0,-1
KR_6752194843,420,-2,9,-4,-4,-2,2,0,-2,3,1,2,1,3,2,1,3,-4,5,1,0,-10,-15,1,-7,6,-5,0,0,0,-1,0,1,0,-1
KR_6724627012,420,-4,-39,-16,-6,-2,3,1,-6,8,2,0,3,3,1,2,3,1,1,2,0,-3,3,-1,-2,3,1,0,0,-1,1,0,1,5,-1
KR_6679105931,420,2,23,26,7,7,0,7,-1,3,2,4,0,4,-5,5,0,2,1,3,0,1,3,0,-4,4,1,0,1,1,1,1,1,6,-1
KR_6756291100,420,3,-60,20,5,-5,5,0,7,1,8,5,3,8,-1,3,2,-1,1,0,-3,1,16,0,-2,2,-1,0,-1,-1,1,-1,-1,4,-1
KR_6660609877,420,3,50,-16,4,-4,5,1,2,0,2,2,3,5,0,1,1,4,2,6,1,2,13,-2,0,2,1,0,0,-1,1,-1,1,4,-1
KR_6745753550,420,-1,-27,-8,-2,1,0,1,0,7,7,-1,1,0,-4,4,0,2,1,3,-1,-2,-9,0,-4,4,-1,0,0,-1,1,0,-1,2,-1
KR_6622877309,440,-4,-91,-16,-14,-1,2,1,-5,5,0,-4,6,2,-6,6,0,2,1,3,-1,-13,4,1,-3,2,1,0,-1,1,0,-1,-1,4,-1
KR_6696873058,420,1,2,19,1,4,3,7,1,1,2,-1,2,1,-2,3,1,-1,1,0,0,-6,6,-2,-2,4,2,0,1,1,1,1,1,2,-1
KR_6762670718,420,2,62,10,5,1,0,1,1,6,7,3,1,4,-2,2,0,2,3,5,0,1,-9,-1,-1,2,-2,0,1,-1,1,1,-1,2,-1
KR_6759185229,420,-3,-21,-40,0,2,0,2,-5,5,0,5,1,6,-2,4,2,0,1,1,0,0,16,2,-4,2,-3,0,1,-1,1,1,1,4,-1
KR_6582212940,420,-1,-148,43,-11,-3,4,1,0,1,1,0,5,5,0,3,3,-8,9,1,-1,-10,2,1,-3,2,-1,0,0,-1,-1,-1,-1,3,-1
KR_6743358798,420,1,33,-8,-5,0,3,3,0,1,1,-4,5,1,-1,4,3,0,1,1,0,-6,4,5,-5,0,-2,0,0,1,-1,1,-1,3,-1
KR_6762896340,420,-3,17,-40,-3,-2,2,0,-3,4,1,2,3,5,-1,4,3,1,0,1,0,-7,-4,-2,0,2,4,0,-1,-1,-1,1,1,2,-1
KR_6583652618,420,-5,-32,-45,-2,-1,2,1,3,2,5,-4,4,0,-1,3,2,1,1,2,0,-5,-8,1,-1,0,-1,0,2,-1,1,1,-1,6,-1
KR_6759515402,420,0,-33,0,-7,1,0,1,-1,2,1,-2,8,6,-3,4,1,-2,3,1,0,-8,-94,-1,-3,4,-6,0,-1,0,0,-1,-1,0,-1
KR_6646354512,420,-1,-129,3,1,-3,4,1,-1,3,2,8,1,9,-3,3,0,0,0,0,0,-1,10,5,-5,0,-1,0,0,-1,1,0,-1,2,-1
KR_6665813173,420,2,38,-2,2,2,1,3,-1,3,2,0,0,0,0,3,3,1,0,1,0,5,9,4,-5,1,-4,0,0,0,0,-1,1,0,-1
KR_6647562354,440,1,-45,-11,-4,1,0,1,1,2,3,3,3,6,-6,6,0,-3,3,0,0,-11,-14,-5,0,5,2,0,1,-1,1,1,-1,1,-1
KR_6586110484,420,-1,43,-4,-11,0,2,2,-5,5,0,-3,6,3,-4,5,1,1,1,2,0,-18,5,-1,-1,2,3,0,-1,-1,-1,-1,-1,6,-1
KR_6759727870,440,2,-31,7,2,4,1,5,1,0,1,-2,4,2,-2,3,1,1,1,2,1,3,-167,3,-4,1,5,0,0,-1,0,1,1,5,-1
KR_6581399277,420,-3,-23,-62,-4,2,0,2,-1,2,1,-5,8,3,-1,1,0,1,0,1,0,2,-33,0,-3,3,-2,0,-1,-1,-1,-1,1,5,-1
KR_6529239802,420,-1,-42,-17,-3,2,1,3,-1,1,0,-6,6,0,0,2,2,2,1,3,1,0,-30,-1,-2,3,-5,0,-1,0,0,-1,1,0,-1
KR_6736454221,440,-5,-52,-24,-9,-1,4,3,2,0,2,-4,5,1,-4,4,0,-2,2,0,0,-7,1,2,-2,0,1,0,-1,-1,-1,-1,-1,5,-1
KR_6703442026,420,-5,-50,-8,-6,-6,8,2,-2,2,0,-2,2,0,5,3,8,-1,2,1,0,-6,5,0,0,0,0,0,-4,-1,0,-1,-1,6,-1
KR_6647269865,440,1,59,-6,1,3,1,4,-5,5,0,-1,2,1,4,1,5,0,0,0,0,-3,2,-1,-6,7,2,0,1,1,1,1,1,6,-1
KR_6763771529,420,2,84,4,0,0,3,3,2,1,3,-1,3,2,-2,7,5,1,0,1,0,-4,3,4,-8,4,-1,0,-1,-1,1,-1,-1,4,-1
KR_6508554390,420,-1,-81,-30,-3,2,1,3,-5,7,2,1,3,4,1,2,3,-2,5,3,-1,0,169,1,-4,3,-4,0,-1,-1,-1,-1,-1,5,-1
KR_6678788304,440,-3,-37,-11,-12,0,2,2,-2,4,2,-2,3,1,-2,3,1,-6,7,1,-2,-16,-5,-2,-3,5,-2,0,-1,-1,1,-1,-1,1,-1
KR_6728289813,420,-6,-109,-33,-24,-3,4,1,-2,2,0,-5,5,0,-13,15,2,-1,2,1,-1,-20,161,3,-6,3,1,0,-1,-1,-1,-1,-1,4,-1
KR_6738120689,420,-1,-4,7,6,5,1,6,3,1,4,0,2,2,-1,5,4,-1,1,0,0,1,1,0,-2,2,-2,0,1,-1,-1,-1,1,1,-1
KR_6715337712,440,-4,-6,-16,-6,-1,3,2,1,2,3,-2,4,2,-4,4,0,0,0,0,0,-5,21,2,-4,2,-7,0,1,-1,1,1,1,1,-1
KR_6762581122,420,4,21,13,6,2,1,3,-5,5,0,2,1,3,5,2,7,2,0,2,0,7,0,1,-3,2,0,0,0,-1,1,-1,-1,6,-1
KR_6740942855,420,-5,-74,-8,-4,0,3,3,5,5,10,-4,7,3,-2,3,1,-3,5,2,0,-12,-368,-2,-1,3,10,0,-2,0,1,-1,-1,0,-1
KR_6759462022,420,-3,-28,6,-10,-4,4,0,-2,5,3,0,2,2,-4,5,1,0,2,2,0,-2,2,3,-5,2,-3,0,0,-1,0,0,-1,2,-1
KR_6679052503,420,2,3,24,-2,4,0,4,-1,2,1,-5,5,0,2,0,2,-2,2,0,0,-3,0,-2,-5,7,-1,0,0,1,0,0,1,2,-1
KR_6627686387,420,-1,-14,-9,-2,-1,1,0,3,1,4,3,0,3,-4,4,0,-3,3,0,0,-7,-22,1,-2,1,3,0,0,-1,0,0,-1,2,-1
KR_6421130766,420,-2,5,11,-13,2,1,3,1,1,2,-4,4,0,-9,10,1,-3,3,0,0,-18,-32,0,-5,5,8,0,-1,-1,1,-1,-1,4,-1
KR_6747299566,420,-2,5,24,-9,-3,5,2,-1,1,0,-7,8,1,2,0,2,0,0,0,0,1,6,0,-1,1,1,0,2,-1,0,1,-1,4,-1
KR_6747826274,420,-5,-124,12,-10,-3,4,1,-4,4,0,0,2,2,-1,2,1,-2,2,0,0,-7,4,-2,-1,3,-5,0,-1,-1,-1,-1,-1,4,-1
KR_6348137673,440,-3,-25,12,-7,-1,3,2,-5,6,1,0,1,1,-3,4,1,2,1,3,0,-12,-13,0,-4,4,-1,0,0,1,-1,0,-1,2,-1
KR_6718039043,420,1,-29,-8,-3,-5,5,0,2,1,3,-2,3,1,1,4,5,1,2,3,0,0,-8,4,-6,2,1,0,0,0,-1,0,1,0,-1
KR_6751465018,420,-5,-26,-20,-9,-1,3,2,-5,5,0,-4,4,0,1,0,1,0,1,1,0,-5,137,-4,-2,6,0,0,-4,-1,-1,-1,-1,2,-1
KR_6718318703,440,-2,22,-32,-5,2,0,2,-3,5,2,-2,6,4,-1,4,3,-1,2,1,-3,-13,297,1,-4,3,-1,0,0,0,0,1,-1,0,-1
KR_6743587500,420,0,49,24,0,1,2,3,0,2,2,-2,2,0,0,0,0,1,0,1,0,0,-3,-6,0,6,2,0,0,-1,0,0,-1,3,-1
KR_6611517191,420,2,30,16,-4,1,1,2,-1,2,1,-1,4,3,-3,5,2,0,2,2,-2,-11,-9,-2,0,2,1,0,0,-1,0,-1,-1,6,-1
KR_6504376376,420,-2,-26,-4,-12,-5,5,0,-3,4,1,3,1,4,-8,8,0,1,2,3,0,-8,-144,-4,-2,6,3,0,-2,-1,-1,-1,-1,5,-1
KR_6705861844,420,-2,-45,16,-9,-3,3,0,-5,8,3,0,4,4,-3,5,2,2,2,4,0,-5,-43,0,-4,4,23,0,-1,0,0,-1,-1,0,-1
KR_6508125591,420,3,55,20,1,2,3,5,0,3,3,-2,3,1,0,1,1,1,0,1,0,-5,-20,2,-4,2,1,0,1,1,1,1,-1,2,-1
KR_6694709500,420,-2,-57,-8,-1,1,1,2,4,2,6,2,5,7,-4,4,0,-4,5,1,0,-5,-5,3,-5,2,0,0,-1,1,0,-1,1,2,-1
KR_6741237059,440,-5,-20,-3,-12,-7,8,1,-1,2,1,4,0,4,-7,7,0,-1,1,0,0,-15,-53,2,-3,1,6,0,-2,-1,-1,-1,-1,6,-1
KR_6584126978,420,0,83,-5,0,0,2,2,-1,3,2,-1,3,2,2,1,3,0,1,1,0,-5,40,-4,-1,5,-28,0,0,0,0,0,1,0,-1
KR_6105853598,420,3,49,13,-1,2,0,2,-3,7,4,2,0,2,-2,3,1,0,0,0,0,-3,7,5,-8,3,0,0,0,1,-1,0,-1,4,-1
KR_6432959589,420,-6,-43,-9,-11,2,2,4,3,1,4,-10,10,0,-7,8,1,1,1,2,0,-8,-11,-3,-2,5,0,0,-2,-1,-1,-1,-1,6,-1
KR_6763772651,420,-1,2,-16,2,-4,4,0,-1,2,1,0,1,1,1,1,2,6,0,6,0,0,-1,-1,-1,2,2,0,1,1,-1,-1,-1,4,-1
KR_6701896318,420,1,22,12,5,2,0,2,7,0,7,3,1,4,-9,9,0,2,1,3,0,3,285,-2,0,2,-1,0,0,0,-1,1,-1,0,-1
KR_6646123919,420,-4,-41,4,-13,-3,3,0,0,2,2,-5,5,0,-2,4,2,-3,3,0,0,-12,98,0,-1,1,2,0,-2,1,1,-1,-1,4,-1
KR_6526310002,420,-3,-32,-14,-3,-5,5,0,-4,4,0,4,0,4,1,6,7,1,2,3,0,-6,41,-1,-3,4,-20,0,-2,-1,-1,-1,-1,5,-1
KR_6664480582,420,-2,-22,-6,-13,-8,8,0,-2,2,0,-1,4,3,-3,3,0,1,1,2,0,-9,-16,-4,-2,6,1,0,0,-1,-1,-1,-1,1,-1
KR_6720060987,420,-3,-95,-10,-4,0,1,1,0,4,4,1,5,6,-5,5,0,0,0,0,0,-3,-5,-1,-1,2,1,0,-4,-1,-1,-1,-1,5,-1
KR_6754386867,420,-5,52,-5,-8,1,1,2,-3,5,2,-3,4,1,-2,2,0,-1,3,2,0,-8,425,-3,-1,4,-25,0,0,1,1,-1,1,6,-1
KR_6751796521,420,2,67,20,1,0,1,1,0,2,2,2,3,5,-4,5,1,3,1,4,0,3,417,4,-4,0,0,0,1,1,-1,1,1,2,-1
KR_6724933732,420,-2,-5,23,-10,-2,3,1,-3,4,1,-3,6,3,0,3,3,-2,3,1,0,-7,-8,-2,-1,3,-3,0,-2,0,0,-1,-1,0,-1
KR_6720099499,420,3,44,36,4,-1,1,0,-1,2,1,1,1,2,3,1,4,2,1,3,0,4,22,2,-4,2,-4,0,2,0,-1,1,1,0,-1
KR_6749046802,420,-4,-39,9,-8,1,0,1,0,0,0,2,3,5,-8,8,0,-3,3,0,0,-4,3,-3,-2,5,0,0,-2,1,-1,-1,-1,3,-1
KR_6734609342,420,1,-44,2,4,-1,4,3,1,3,4,5,4,9,1,1,2,-2,3,1,-1,-3,-2,3,-6,3,-1,0,1,0,1,1,-1,0,-1
KR_6621386243,420,-2,-44,1,-14,-4,6,2,-1,2,1,-2,4,2,-7,7,0,0,1,1,-2,-13,83,1,-4,3,-3,0,-1,-1,-1,-1,-1,3,-1
KR_6709987250,420,-4,-18,2,-9,2,0,2,1,3,4,-10,10,0,-4,5,1,2,0,2,0,0,5,-1,-3,4,-2,0,-1,0,-1,-1,1,0,-1
KR_6694776666,420,-5,-52,-4,-12,-2,3,1,-7,9,2,-4,6,2,0,2,2,1,1,2,1,-6,-7,-5,0,5,2,0,-1,0,-1,-1,1,0,-1
KR_6722838773,420,-1,-41,-8,-6,1,2,3,2,2,4,-3,5,2,-5,6,1,-1,1,0,0,-5,4,1,-4,3,-5,0,1,-1,1,1,-1,1,-1
KR_5968002782,420,-1,3,-8,-4,3,0,3,-2,6,4,1,2,3,-4,4,0,-2,2,0,0,-9,-11,0,-2,2,-1,0,1,0,1,-1,1,0,-1
KR_6461700907,420,2,56,-17,7,2,5,7,5,2,7,-4,4,0,5,0,5,-1,2,1,0,0,-20,-2,-4,6,9,0,0,-1,-1,0,1,1,-1
KR_6692843600,420,0,25,-21,-10,3,1,4,-1,3,2,-8,9,1,-4,4,0,0,1,1,0,-16,-147,2,-5,3,-4,0,-2,-1,-1,-1,-1,4,-1
KR_6704877396,420,-2,-56,34,-11,-1,2,1,1,1,2,-6,7,1,-3,7,4,-2,2,0,0,-7,-17,-3,-1,4,4,0,-3,0,1,-1,-1,0,-1
KR_6667897218,420,1,31,32,-1,1,0,1,-2,3,1,0,4,4,-2,3,1,2,0,2,0,-8,-5,-2,-2,4,0,0,1,1,-1,1,1,2,-1
KR_6595277018,420,-1,18,-28,-4,0,2,2,-1,1,0,0,0,0,-2,2,0,-1,2,1,0,-6,206,-2,-1,3,-2,0,0,-1,-1,0,-1,6,-1
KR_6763297301,420,0,75,-8,0,-4,6,2,3,0,3,0,2,2,3,1,4,-2,2,0,0,3,-434,1,-2,1,-15,0,0,1,-1,1,-1,2,-1
KR_6097363988,420,-6,-32,-17,-12,1,3,4,-6,6,0,-2,4,2,-1,2,1,-4,4,0,0,-20,-3,-3,-2,5,-2,0,-2,-1,0,-1,-1,5,-1
KR_6763199523,420,1,-80,-28,4,0,3,3,1,4,5,4,2,6,-2,4,2,1,2,3,1,-1,-38,0,-2,2,24,0,0,1,1,-1,1,5,-1
KR_6762877157,440,0,13,20,-5,4,1,5,-1,2,1,0,4,4,-6,6,0,-2,2,0,0,-12,-13,-11,0,11,5,0,0,0,1,0,-1,0,-1
KR_6724841286,440,2,29,4,1,-2,2,0,1,2,3,-2,2,0,2,0,2,2,0,2,0,0,-22,-4,-3,7,-2,0,1,-1,0,-1,-1,2,-1
KR_6760100590,420,0,-25,-8,2,2,2,4,-1,1,0,2,2,4,0,1,1,-1,3,2,0,-1,188,2,-4,2,0,0,-1,1,-1,-1,1,4,-1
KR_6744825070,440,-2,-39,6,0,-1,3,2,0,2,2,2,1,3,1,1,2,-2,2,0,0,-3,58,2,-3,1,-16,0,0,0,1,1,1,0,-1
KR_6742793012,440,-1,-64,-16,5,-5,5,0,-1,3,2,0,1,1,9,1,10,2,0,2,0,11,-39,-2,-2,4,36,0,0,-1,0,0,1,3,-1
KR_6620446966,420,-1,19,2,-8,1,1,2,-1,3,2,-5,6,1,-3,7,4,0,1,1,0,-3,-2,-5,-1,6,-4,0,-1,-1,-1,-1,1,3,-1
KR_6548349046,420,-1,2,2,-5,1,1,2,-2,3,1,4,1,5,-3,4,1,-5,5,0,0,-7,-14,-3,-2,5,-2,0,-1,-1,1,-1,1,1,-1
KR_6733617473,420,-5,-52,4,-5,1,2,3,1,3,4,-2,4,2,-5,5,0,0,1,1,-1,-11,-9,-4,-1,5,0,0,-1,0,1,-1,-1,0,-1
KR_6658603226,420,6,23,60,15,8,0,8,4,1,5,-2,5,3,3,1,4,2,0,2,0,8,-3,-2,-3,5,1,0,2,1,1,1,-1,4,-1
KR_6444984951,420,1,-34,0,6,1,1,2,1,1,2,2,4,6,1,1,2,1,1,2,0,9,8,4,-8,4,-1,0,0,1,0,0,1,2,-1
KR_6684067126,420,-2,2,-16,-7,0,1,1,-2,5,3,-2,3,1,-3,5,2,0,2,2,-1,-1,-10,-1,-2,3,5,0,-1,-1,-1,-1,-1,1,-1
KR_6759277052,420,0,-79,12,-11,0,2,2,-3,4,1,-1,3,2,-6,6,0,-1,3,2,-1,-13,-7,-3,-2,5,-5,0,0,-1,-1,-1,-1,5,-1
KR_6320797892,420,0,2,-18,-1,-5,5,0,-2,6,4,1,0,1,4,0,4,1,0,1,0,4,8,4,-6,2,0,0,-1,1,-1,-1,1,5,-1
KR_6709251365,420,0,32,24,-4,-6,6,0,0,2,2,-1,3,2,0,2,2,3,0,3,0,-2,-2,-1,-3,4,1,0,-1,1,-1,-1,1,3,-1
KR_6673690056,420,0,-111,-8,2,-2,2,0,2,0,2,1,1,2,1,0,1,0,0,0,0,4,-38,1,-5,4,20,0,-1,1,-1,-1,1,6,-1
KR_6729223007,440,-1,35,8,-2,0,0,0,-1,4,3,1,1,2,2,1,3,-4,6,2,0,0,3,-2,-6,8,-1,0,0,-1,-1,0,1,4,-1
KR_6655331325,420,-3,-76,4,2,1,1,2,0,1,1,4,0,4,-3,6,3,0,0,0,3,7,-1,2,-6,4,3,0,-2,-1,1,-1,1,3,-1
KR_6759354931,420,0,-37,-5,8,4,0,4,1,5,6,3,2,5,0,2,2,0,0,0,0,8,-9,-6,0,6,2,0,0,1,0,0,-1,3,-1
KR_6130510565,420,-2,34,-16,-6,0,2,2,-6,7,1,2,3,5,-1,1,0,-1,1,0,0,-6,172,3,-5,2,3,0,-1,1,-1,-1,-1,5,-1
KR_6649109394,420,-1,-1,0,-3,-2,4,2,3,1,4,0,1,1,-2,2,0,-2,2,0,0,-7,2,1,-3,2,-2,0,0,-1,1,-1,-1,5,-1
KR_6740052901,420,-3,-35,-30,-10,-6,7,1,-2,5,3,-2,4,2,-1,4,3,1,2,3,0,1,137,-4,-1,5,0,0,-4,-1,-1,-1,-1,1,-1
KR_6707115660,420,-1,-73,15,-3,-6,7,1,-2,3,1,2,1,3,2,0,2,1,1,2,0,-1,7,-1,-3,4,-4,0,0,-1,0,-1,-1,5,-1
KR_6731863088,420,0,18,18,2,-1,2,1,0,0,0,0,1,1,0,2,2,3,2,5,1,3,3,0,-3,3,4,0,0,1,-1,0,1,2,-1
KR_6654239891,420,2,-17,24,-5,0,3,3,1,0,1,1,2,3,-5,5,0,-2,3,1,0,-4,-11,-2,-1,3,1,0,0,-1,-1,0,-1,6,-1
KR_6732772305,440,-4,-26,0,-11,0,1,1,-5,7,2,-3,4,1,-3,3,0,0,1,1,0,-14,-32,-5,-3,8,-1,0,0,-1,-1,0,-1,2,-1
KR_6760696898,440,1,60,0,4,2,1,3,4,0,4,2,2,4,1,2,3,-5,6,1,0,1,0,1,-4,3,-1,0,0,0,0,0,1,0,-1
KR_6738588035,420,-2,-55,3,-3,-2,3,1,0,4,4,-1,4,3,-2,3,1,2,0,2,0,8,-47,-1,0,1,18,0,-2,-1,0,-1,-1,5,-1
KR_6760335757,420,-3,-60,1,-16,-6,6,0,3,2,5,-1,2,1,-8,8,0,-4,4,0,-1,-14,31,1,-2,1,-12,0,-2,-1,-1,-1,-1,5,-1
KR_6757367292,440,-4,-59,-12,-13,-3,4,1,-5,7,2,1,1,2,-5,6,1,-1,3,2,0,-16,14,0,-4,4,-2,0,0,-1,1,0,1,4,-1
KR_6672177681,420,-2,-51,-4,-7,-4,5,1,-3,6,3,-1,1,0,3,0,3,-2,2,0,0,-11,38,1,-4,3,-30,0,-2,-1,1,-1,1,6,-1
KR_6604385543,420,-3,-68,-8,-4,-2,2,0,2,0,2,0,0,0,-2,3,1,-2,4,2,0,-2,-2,-3,-5,8,-3,0,0,-1,-1,0,1,5,-1
KR_6710771704,420,-2,-103,7,-5,-1,1,0,-2,3,1,3,1,4,-4,5,1,-1,2,1,0,-3,-323,0,-2,2,-1,0,-1,-1,-1,-1,1,4,-1
KR_6749427299,420,-1,-24,3,-8,-3,6,3,1,1,2,-2,2,0,3,2,5,-7,7,0,0,2,-38,-1,0,1,12,0,-2,-1,-1,-1,1,5,-1
KR_6629127263,440,1,-28,-4,5,-2,2,0,1,2,3,2,0,2,0,1,1,4,2,6,2,0,0,0,-4,4,-1,0,0,1,0,0,1,1,-1
KR_6680749323,420,2,2,0,6,2,2,4,-5,7,2,7,2,9,1,0,1,1,0,1,2,5,-1,-2,-4,6,-1,0,3,-1,1,1,1,4,-1
KR_6696142448,420,-4,-68,8,-8,-1,2,1,-3,5,2,-3,4,1,-2,2,0,1,0,1,-1,-5,-6,1,-5,4,-1,0,0,-1,0,0,-1,3,-1
KR_6733758960,420,2,-11,39,0,2,0,2,3,1,4,0,0,0,-5,5,0,0,1,1,0,-3,8,1,-7,6,-5,0,0,-1,1,0,-1,3,-1
KR_6596092277,420,0,31,-7,0,1,0,1,-2,7,5,-2,5,3,3,1,4,0,1,1,0,7,0,0,-3,3,1,0,-1,1,-1,-1,1,5,-1
KR_6650180283,420,-3,-68,-16,-7,0,1,1,0,2,2,-3,3,0,0,3,3,-4,4,0,0,-9,-44,-1,-5,6,9,0,-1,-1,0,-1,-1,6,-1
KR_6713755820,440,1,50,16,-1,0,5,5,-3,3,0,3,0,3,2,4,6,-3,4,1,0,-6,-3,0,-5,5,-2,0,0,1,-1,1,-1,3,-1
KR_6731965638,420,-5,-95,0,-16,2,2,4,-1,3,2,-9,11,2,-6,6,0,-2,2,0,0,-11,4,4,-4,0,-5,0,-4,-1,-1,-1,-1,6,-1
KR_6695182415,420,-1,-73,-1,-1,-1,3,2,-3,3,0,5,2,7,0,0,0,-2,2,0,0,2,-4,-2,-5,7,-1,0,-1,-1,-1,-1,1,2,-1
KR_6500006732,420,-4,-53,1,-4,0,1,1,3,1,4,-5,5,0,-4,4,0,2,0,2,0,0,-35,-5,-1,6,24,0,0,-1,1,0,-1,5,-1
KR_6711979476,420,1,2,-7,6,0,2,2,3,0,3,-5,7,2,1,0,1,7,1,8,1,3,-476,-1,-1,2,1,0,-1,-1,-1,-1,1,3,-1
KR_6588512093,420,1,-3,-17,4,0,2,2,1,1,2,1,1,2,2,0,2,0,0,0,0,10,16,1,-4,3,-2,0,-1,-1,1,-1,-1,5,-1
KR_6596347402,440,0,39,-8,-2,0,1,1,1,2,3,2,1,3,-4,5,1,-1,2,1,0,2,-3,-1,-5,6,-5,0,0,-1,-1,0,-1,4,-1
KR_6682439150,420,-5,-64,-42,-8,-3,4,1,-2,4,2,-3,4,1,1,2,3,-1,2,1,0,-3,-6,0,-2,2,-1,0,-1,-1,1,-1,1,6,-1
KR_6650690870,420,-1,-24,-22,-6,1,1,2,-3,4,1,-1,3,2,-3,5,2,0,1,1,0,3,-19,-8,-1,9,27,0,0,-1,-1,-1,-1,5,-1
KR_6695499703,420,2,-5,29,1,-2,3,1,0,4,4,-2,5,3,1,0,1,4,0,4,1,3,7,2,-4,2,-5,0,1,-1,1,1,1,4,-1
KR_6613560656,440,2,-10,8,4,-3,4,1,3,1,4,0,1,1,0,4,4,4,0,4,0,8,-97,3,-6,3,-1,0,-1,1,-1,-1,1,4,-1
KR_6653285548,420,3,28,36,2,-2,3,1,0,3,3,3,0,3,-4,4,0,5,0,5,0,1,67,-1,-4,5,-31,0,-1,1,1,-1,1,6,-1
KR_6720446357,420,0,-25,28,-2,-10,11,1,0,0,0,7,0,7,1,3,4,0,1,1,0,3,-1,0,-2,2,-4,0,-1,-1,1,-1,-1,3,-1
KR_6679201984,440,0,-58,-4,-10,-5,6,1,0,2,2,-5,5,0,0,8,8,0,2,2,-1,-7,-4,-4,-1,5,2,0,-2,1,-1,-1,-1,6,-1
KR_6552812376,420,-7,-106,-23,-13,-2,4,2,-4,4,0,-3,4,1,-2,2,0,-2,2,0,0,-9,-9,2,-4,2,-3,0,-1,-1,-1,-1,-1,6,-1
KR_6105814144,420,0,-15,16,-4,-1,3,2,-3,5,2,3,1,4,-2,3,1,-1,2,1,0,-3,-7,3,-5,2,2,0,-1,1,-1,-1,-1,2,-1
KR_6647697772,420,-1,-26,-6,4,0,0,0,4,2,6,-2,2,0,2,2,4,0,1,1,0,8,-172,1,-4,3,-4,0,-1,-1,1,-1,-1,2,-1
KR_6252279616,420,1,-40,0,-1,2,0,2,-4,6,2,2,1,3,2,0,2,-3,3,0,0,-3,-21,-2,-1,3,-1,0,0,-1,0,0,-1,3,-1
KR_6654392511,420,-2,3,16,-5,1,3,4,0,2,2,-2,2,0,-3,6,3,-1,1,0,0,-7,-6,-5,-4,9,0,0,1,-1,-1,1,-1,3,-1
KR_6738451201,420,0,-28,-7,13,3,0,3,1,3,4,1,1,2,7,2,9,1,1,2,1,22,-15,2,-2,0,-2,0,-1,0,0,-1,1,0,-1
KR_6733646560,420,3,2,18,2,-4,5,1,0,4,4,4,0,4,0,1,1,2,0,2,0,0,-7,-4,-1,5,-2,0,1,-1,-1,1,-1,6,-1
KR_6754314951,420,-6,-112,-32,-17,-3,5,2,1,0,1,-1,3,2,-12,12,0,-2,2,0,0,-13,-13,1,-3,2,1,0,-3,-1,-1,-1,-1,3,-1
KR_6760328218,440,3,87,32,-4,-4,5,1,-2,6,4,2,4,6,0,3,3,0,0,0,-1,-10,-13,0,-4,4,0,0,-1,0,0,-1,-1,0,-1
KR_6761637745,420,2,-34,0,4,2,3,5,0,1,1,-4,6,2,4,3,7,2,3,5,0,4,-35,4,-6,2,19,0,1,1,-1,1,1,4,-1
KR_6756161817,420,2,12,-7,6,3,2,5,-1,4,3,1,0,1,-3,4,1,6,2,8,3,5,46,-3,-2,5,-13,0,1,-1,0,1,1,4,-1
KR_6756510191,440,0,-62,4,-2,-1,1,0,7,1,8,-2,4,2,-3,5,2,-3,3,0,0,-6,-6,-2,-3,5,0,0,-3,1,-1,-1,-1,5,-1
KR_6681684572,440,-4,-37,-20,-9,-4,5,1,-4,6,2,-2,2,0,1,0,1,0,0,0,0,-2,22,0,-4,4,4,0,-1,-1,-1,-1,-1,5,-1
KR_6195404840,420,-4,-24,-12,-14,0,2,2,0,1,1,-4,5,1,-5,5,0,-5,6,1,0,-15,-7,-4,-3,7,4,0,-3,-1,-1,-1,-1,1,-1
KR_6655377405,420,-6,-80,-4,-9,-2,4,2,-5,5,0,-2,2,0,0,2,2,0,1,1,0,-2,-46,-5,-1,6,7,0,-2,-1,-1,-1,1,2,-1
KR_6670011693,420,-1,5,12,-2,3,1,4,2,1,3,-3,7,4,-3,6,3,-1,2,1,0,-1,18,0,-2,2,-6,0,1,-1,-1,1,-1,4,-1
KR_6195109400,420,0,-16,1,-8,-2,3,1,-2,3,1,-3,5,2,-1,2,1,0,2,2,0,-11,-2,-1,-6,7,0,0,-2,-1,-1,-1,-1,2,-1
KR_6347834444,420,-4,-108,-48,-9,-4,4,0,-4,5,1,1,1,2,0,2,2,-2,2,0,0,-8,7,0,-6,6,1,0,-1,1,-1,-1,-1,6,-1
KR_6687950781,420,-5,-60,-20,-8,2,1,3,1,1,2,-3,7,4,-4,6,2,-4,5,1,-1,-6,-5,9,-9,0,-4,0,0,-1,-1,-1,-1,3,-1
KR_6760645529,440,-1,19,-28,-1,6,0,6,4,0,4,-1,8,7,-7,8,1,-3,3,0,0,-8,4,3,-4,1,-4,0,0,-1,0,1,-1,6,-1
KR_6621932285,440,0,-22,-36,2,2,1,3,-2,2,0,3,0,3,-1,2,1,0,0,0,0,-4,-45,-1,-3,4,20,0,-2,-1,-1,-1,1,3,-1
KR_6709213726,420,1,-39,5,-2,0,3,3,-2,2,0,-1,3,2,2,1,3,-1,2,1,0,-5,132,5,-5,0,-1,0,1,-1,1,1,1,5,-1
KR_6709364473,420,1,-40,0,3,2,1,3,0,3,3,5,0,5,-2,4,2,-2,2,0,-1,-2,-1,-1,-5,6,-5,0,1,-1,1,1,-1,3,-1
KR_6668033289,420,-2,-21,-56,-1,1,4,5,-1,2,1,0,4,4,0,4,4,-1,1,0,0,6,10,0,-5,5,-2,0,0,-1,-1,-1,1,6,-1
KR_6700108200,420,0,-46,-4,0,-3,3,0,0,1,1,1,2,3,1,1,2,1,0,1,0,3,-2,2,-4,2,2,0,0,1,-1,-1,1,2,-1
KR_6751418364,420,-4,-73,-9,-9,-3,4,1,4,1,5,-3,3,0,-9,9,0,2,0,2,0,-10,359,1,-6,5,4,0,-1,1,0,-1,1,2,-1
KR_6689332175,420,1,-2,-11,-6,4,1,5,-8,9,1,-4,5,1,1,0,1,1,1,2,-2,-4,-5,1,-2,1,0,0,-1,-1,1,-1,-1,1,-1
KR_6701080418,420,-2,-29,-30,-4,-1,2,1,-1,2,1,-4,5,1,1,1,2,1,0,1,0,-3,4,-3,-2,5,3,0,-1,-1,-1,-1,-1,3,-1
KR_6746663313,420,1,-1,-4,10,2,1,3,3,2,5,7,1,8,-3,3,0,1,0,1,0,5,-262,1,-3,2,3,0,1,-1,-1,1,1,4,-1
KR_6681505782,440,0,-4,-36,-7,1,1,2,-3,4,1,1,0,1,-5,6,1,-1,1,0,-1,-12,-2,1,-5,4,0,0,-2,1,1,-1,-1,1,-1
KR_6097319988,440,0,-1,0,-2,-1,1,0,-1,4,3,2,2,4,1,5,6,-3,4,1,0,-1,-21,-2,-1,3,2,0,1,0,0,1,-1,0,-1
KR_6730289875,420,-7,-91,-50,-6,-1,2,1,0,5,5,-4,5,1,-1,2,1,0,0,0,-1,-4,-3,-1,-2,3,-5,0,-3,-1,-1,-1,-1,1,-1
KR_6580695987,420,1,-26,-1,-6,0,2,2,-4,5,1,2,0,2,-3,5,2,-1,1,0,0,-9,5,4,-6,2,0,0,0,-1,1,0,-1,5,-1
KR_6684893946,420,-6,-101,-9,-8,-1,5,4,-4,5,1,-4,4,0,0,2,2,1,1,2,0,4,-113,3,-4,1,-1,0,-1,-1,1,-1,-1,4,-1
KR_6496619759,420,2,97,0,5,4,1,5,1,1,2,-1,3,2,1,1,2,0,2,2,0,0,8,1,-2,1,-3,0,1,-1,1,1,1,5,-1
KR_6757876517,420,-5,-43,-17,-5,-5,5,0,-5,7,2,2,1,3,1,8,9,2,0,2,1,0,-1,0,-1,1,0,0,0,0,-1,-1,1,0,-1
KR_6730675611,420,3,7,4,5,-1,3,2,0,3,3,4,2,6,3,1,4,-1,1,0,0,-3,13,4,-8,4,-6,0,1,-1,-1,1,1,1,-1
KR_6624362119,420,-4,-29,-22,-7,2,0,2,1,3,4,-9,10,1,0,1,1,-1,1,0,0,-1,-67,-5,0,5,30,0,-1,-1,-1,-1,-1,2,-1
KR_6707320606,420,-1,-60,8,-1,-1,2,1,1,5,6,3,1,4,1,1,2,-5,6,1,0,-4,5,-1,-3,4,-3,0,-1,1,1,-1,1,6,-1
KR_6504028670,420,-1,-35,-28,-19,0,3,3,-7,10,3,-10,14,4,1,0,1,-3,4,1,-2,-14,-8,-5,0,5,-2,0,-2,1,-1,-1,-1,1,-1
KR_6751121175,420,-2,-99,20,-2,5,0,5,0,4,4,0,0,0,-6,7,1,-1,2,1,-1,-8,-6,-1,-5,6,-4,0,0,1,-1,1,-1,5,-1
KR_6608512180,420,-3,-13,-19,-8,4,0,4,-1,3,2,-11,11,0,0,1,1,0,0,0,0,-4,-44,-2,-2,4,16,0,-2,-1,1,-1,-1,3,-1
KR_6620554232,420,-9,-158,-33,-14,1,1,2,-3,4,1,-8,8,0,-3,4,1,-1,2,1,0,-8,2,1,-5,4,-2,0,-1,0,-1,-1,-1,0,-1
KR_6631110039,420,0,17,0,-2,-1,3,2,-1,3,2,-1,2,1,-2,3,1,3,1,4,0,-2,7,0,-2,2,-1,0,0,0,0,0,1,0,-1
KR_6755959952,420,-1,3,19,-8,-4,7,3,-2,7,5,-6,6,0,1,2,3,3,0,3,0,-7,-8,-3,-2,5,2,0,0,-1,0,0,-1,5,-1
KR_6756125014,420,1,-67,36,3,1,1,2,3,1,4,-1,5,4,-2,2,0,2,1,3,0,-4,-53,1,-3,2,19,0,0,0,1,-1,1,0,-1
KR_6755340827,440,1,-3,16,-1,2,2,4,-2,6,4,-1,2,1,1,3,4,-1,2,1,0,3,-2,2,-3,1,1,0,0,1,1,0,-1,5,-1
KR_6663762666,420,-2,21,-34,-4,0,1,1,1,1,2,-5,6,1,-1,3,2,1,0,1,0,-1,-3,0,-3,3,0,0,0,1,0,0,-1,5,-1
KR_6707587654,420,2,46,-11,5,0,3,3,2,2,4,3,1,4,0,0,0,0,0,0,0,6,-12,6,-6,0,-2,0,1,-1,1,1,-1,4,-1
KR_6001965531,420,-4,-50,0,-9,-2,3,1,0,2,2,-2,5,3,0,2,2,-5,6,1,0,-14,-6,-3,-4,7,-1,0,-2,1,-1,-1,-1,4,-1
KR_6627763940,420,-5,-23,-25,-4,-3,4,1,4,2,6,-1,3,2,-4,4,0,0,2,2,0,1,33,1,-3,2,0,0,-2,-1,-1,-1,-1,1,-1
KR_6693855515,420,-3,3,-36,-6,1,0,1,1,4,5,-6,6,0,-2,4,2,0,1,1,-1,-9,9,4,-5,1,-3,0,1,-1,-1,1,-1,5,-1
KR_6761755550,440,1,49,24,-7,-3,4,1,1,0,1,-3,4,1,-2,3,1,0,0,0,0,-2,268,0,-4,4,2,0,-1,1,1,-1,-1,1,-1
KR_6759467834,420,-3,-79,32,-17,-4,5,1,-9,9,0,-1,3,2,-2,5,3,-1,2,1,0,-14,-5,1,-1,0,0,0,-3,1,-1,-1,-1,2,-1
KR_6721089058,420,-8,-122,-19,-14,-4,7,3,-2,3,1,-5,8,3,-1,3,2,-2,2,0,0,-8,-361,0,-3,3,-3,0,-2,-1,-1,-1,1,3,-1
KR_6731842896,420,-4,32,-15,-6,-2,2,0,-3,3,0,1,0,1,-2,3,1,0,0,0,0,-2,-192,1,-3,2,0,0,-1,1,-1,-1,1,6,-1
KR_6630251103,420,-3,-36,5,-3,-1,2,1,1,2,3,1,3,4,-4,4,0,0,1,1,0,-8,0,-2,-2,4,-3,0,1,1,1,1,1,3,-1
KR_6675696639,440,-7,12,-31,-8,-1,4,3,1,4,5,-9,12,3,0,1,1,1,3,4,1,-4,-55,-1,-2,3,15,0,-3,-1,-1,-1,1,5,-1
KR_6227647980,420,-2,-12,11,-4,-2,2,0,-2,3,1,0,0,0,1,1,2,-1,1,0,0,-2,10,-2,-3,5,-4,0,0,-1,1,0,-1,1,-1
KR_6501383154,420,-1,-34,12,-11,1,1,2,-1,2,1,-2,3,1,-8,8,0,-1,1,0,0,-14,57,2,-2,0,17,0,-1,1,0,-1,-1,1,-1
KR_6725116502,420,-1,-27,-20,4,1,3,4,-1,5,4,1,2,3,3,0,3,0,1,1,0,0,-1,0,-4,4,-1,0,0,0,-1,0,1,0,-1
KR_6619955025,420,-3,31,-21,3,-3,3,0,0,4,4,1,2,3,5,2,7,0,2,2,0,14,-9,-4,0,4,0,0,0,-1,1,0,1,3,-1
KR_6709996847,440,0,-97,-21,1,-1,3,2,3,2,5,-4,6,2,3,2,5,0,0,0,0,3,-6,-6,0,6,4,0,-1,-1,1,-1,1,2,-1
KR_6754988347,420,-3,-71,-28,-8,0,3,3,-3,4,1,-5,5,0,3,2,5,-3,3,0,0,-10,4,-3,-1,4,2,0,-1,-1,-1,-1,-1,3,-1
KR_6756727072,420,-1,9,-7,-4,-1,3,2,-3,3,0,-1,1,0,2,2,4,-1,1,0,0,-4,7,-1,-4,5,-6,0,-1,-1,-1,-1,1,4,-1
KR_6763768431,420,-1,17,23,-10,0,1,1,-4,4,0,0,2,2,0,1,1,-6,7,1,-1,-11,12,0,-3,3,-2,0,1,1,0,-1,-1,1,-1
KR_6761499990,440,-5,-18,-20,-6,-1,2,1,1,3,4,-6,6,0,-1,3,2,1,0,1,-1,-4,0,0,-2,2,1,0,-1,0,1,-1,-1,0,-1
KR_6755135014,420,0,-38,-19,-2,0,2,2,0,3,3,-1,2,1,-1,2,1,0,1,1,0,0,44,0,-3,3,-22,0,0,0,-1,0,1,0,-1
KR_6693746518,420,-2,-13,8,-10,0,0,0,0,3,3,-3,5,2,-3,3,0,-4,4,0,0,-4,-143,2,-5,3,-4,0,1,-1,0,1,1,2,-1
KR_6606094984,420,-4,3,-5,-6,-2,3,1,0,4,4,-2,2,0,-1,3,2,-1,1,0,0,-6,-223,0,-1,1,-3,0,1,1,1,1,-1,3,-1
KR_6749735199,420,1,5,8,6,-2,2,0,-1,3,2,7,0,7,0,0,0,2,0,2,0,6,18,1,-4,3,-2,0,0,1,-1,0,-1,4,-1
KR_6756881978,420,-1,82,-40,-8,2,1,3,-4,9,5,-3,4,1,0,3,3,-3,3,0,0,-12,-232,2,-6,4,1,0,0,-1,-1,1,1,1,-1
KR_6754762626,420,-6,-25,-39,-13,-1,3,2,-2,3,1,-7,7,0,-1,4,3,-2,3,1,0,-12,2,0,-3,3,-1,0,0,-1,-1,-1,-1,4,-1
KR_6413788675,420,4,75,20,-4,-2,4,2,-4,5,1,0,0,0,2,0,2,0,0,0,0,-2,-145,3,-5,2,-12,0,2,1,-1,1,1,1,-1
KR_6700283284,420,-3,7,-8,-9,7,1,8,-4,9,5,-3,5,2,-6,6,0,-3,5,2,0,-13,11,-1,-1,2,1,0,0,-1,1,1,1,1,-1
KR_6673396391,420,-6,-68,-8,-9,-4,4,0,-4,4,0,-3,4,1,2,5,7,0,0,0,0,-9,17,-1,-3,4,-5,0,-1,-1,-1,-1,1,6,-1
KR_6735980734,420,-2,-49,9,-3,-6,7,1,-4,4,0,2,1,3,4,2,6,1,4,5,0,2,-322,-2,-1,3,13,0,0,1,0,0,1,2,-1
KR_6578650001,420,1,-37,28,-4,-3,5,2,4,0,4,0,2,2,0,3,3,-5,5,0,0,-2,-13,-5,-3,8,7,0,1,1,-1,1,-1,4,-1
KR_6651035856,420,0,58,0,1,-4,4,0,-3,4,1,0,2,2,5,2,7,3,0,3,0,9,44,3,-6,3,-34,0,1,-1,1,1,1,2,-1
KR_6759989860,420,-3,27,-2,-1,3,1,4,-4,4,0,-1,3,2,0,4,4,1,0,1,0,-1,11,5,-8,3,-4,0,0,1,0,0,1,3,-1
KR_6755059776,440,-6,-40,-4,-11,-2,3,1,1,1,2,0,1,1,-9,10,1,-1,1,0,0,-10,2,3,-5,2,-5,0,-3,-1,1,-1,-1,2,-1
KR_6718436851,420,-7,-57,-38,-1,-4,4,0,-4,4,0,6,1,7,0,4,4,1,2,3,0,-1,-323,-3,-3,6,-3,0,-1,-1,-1,-1,-1,3,-1
KR_6616436569,420,-5,-77,-25,-16,-7,8,1,-2,2,0,3,0,3,-6,7,1,-4,4,0,-1,-13,-3,-2,-4,6,0,0,-2,-1,-1,-1,-1,1,-1
KR_6560647825,420,-1,19,-8,3,-3,4,1,2,1,3,1,0,1,2,0,2,1,0,1,0,12,-1,1,-2,1,0,0,1,1,-1,1,-1,6,-1
KR_6752491539,420,-1,5,0,5,2,0,2,-2,7,5,1,2,3,2,1,3,2,0,2,2,12,2,-2,-5,7,-4,0,0,1,-1,0,1,3,-1
KR_6751106058,420,1,-28,35,6,3,1,4,-1,3,2,0,5,5,1,2,3,3,1,4,0,5,4,4,-5,1,-1,0,0,1,0,-1,1,4,-1
KR_6624667279,420,-5,-66,-15,-21,-1,3,2,-8,8,0,-10,12,2,-2,4,2,0,1,1,0,-18,2,-2,-3,5,-4,0,-2,-1,0,-1,-1,2,-1
KR_6716435190,420,-2,-51,-12,-5,-3,5,2,2,2,4,-2,2,0,-3,4,1,1,1,2,0,-5,-248,1,-2,1,1,0,0,-1,-1,-1,-1,3,-1
KR_6761917148,420,-3,-37,-11,-12,0,0,0,-4,4,0,-3,3,0,1,0,1,-6,7,1,0,-16,2,-2,-2,4,-1,0,0,-1,-1,-1,-1,2,-1
KR_6690554868,420,2,-99,8,4,0,2,2,2,0,2,6,1,7,-5,5,0,1,0,1,1,0,-2,0,-3,3,2,0,0,1,1,-1,1,4,-1
KR_6758795858,420,-1,-33,-24,1,2,1,3,0,1,1,-2,5,3,0,1,1,1,0,1,0,3,31,0,-3,3,-18,0,0,-1,-1,0,1,4,-1
KR_6705901146,420,-5,-71,-17,-11,-1,5,4,-2,2,0,-8,8,0,-4,5,1,4,1,5,0,-10,-2,0,-6,6,0,0,-2,-1,-1,-1,-1,5,-1
KR_6567445394,420,1,3,-3,4,2,0,2,1,2,3,5,1,6,2,2,4,-6,6,0,0,5,1,2,-3,1,-1,0,-1,-1,1,1,-1,1,-1
KR_6717943257,420,-1,23,-8,0,0,3,3,0,1,1,1,0,1,0,2,2,-1,1,0,0,-6,-6,0,-1,1,-1,0,0,-1,1,-1,-1,6,-1
KR_6416013896,420,-4,-84,-16,-10,-1,2,1,-2,3,1,-1,3,2,-3,4,1,-3,5,2,-2,-8,-3,-3,-1,4,-1,0,-1,-1,-1,-1,-1,1,-1
KR_6648174257,420,-2,2,-9,-5,-3,3,0,-3,7,4,2,2,4,-1,1,0,0,0,0,0,-10,1,-2,-3,5,-3,0,1,-1,1,1,-1,1,-1
KR_6613242067,420,-3,-74,-32,-5,0,0,0,1,3,4,-8,10,2,2,2,4,0,1,1,0,5,194,-1,-1,2,-5,0,-1,-1,0,-1,-1,3,-1
KR_6738662428,420,-4,-20,-12,-14,2,0,2,0,2,2,1,2,3,-4,6,2,-13,16,3,0,-20,-7,-3,0,3,1,0,0,-1,0,-1,-1,6,-1
KR_6652106851,420,-5,9,-24,-18,-1,3,2,-2,4,2,0,3,3,-8,10,2,-7,7,0,0,-24,42,5,-8,3,-8,0,0,-1,1,-1,-1,2,-1
KR_6724884543,440,2,-19,-3,4,0,1,1,5,0,5,-4,6,2,1,1,2,2,0,2,0,6,259,2,-6,4,-2,0,0,-1,-1,1,-1,3,-1
KR_6304370691,440,-5,-64,-11,-7,-3,3,0,-1,2,1,-4,4,0,1,1,2,0,1,1,0,-6,29,0,-1,1,-2,0,-1,1,-1,-1,1,1,-1
KR_6729641821,420,-1,34,-16,-1,2,0,2,-1,5,4,-6,6,0,2,1,3,2,0,2,0,1,17,-3,-2,5,1,0,1,1,-1,1,-1,2,-1
KR_6663820039,420,-1,40,-48,-3,1,1,2,2,1,3,3,3,6,-9,11,2,0,0,0,0,-4,5,-3,-3,6,2,0,0,-1,-1,-1,1,4,-1
KR_6757885401,420,-1,18,-13,-1,0,2,2,0,3,3,-2,2,0,0,2,2,1,1,2,0,-2,3,5,-9,4,2,0,0,-1,-1,0,1,5,-1
KR_6695181154,420,-2,-39,-3,-10,-1,3,2,-3,4,1,-5,5,0,-1,3,2,0,0,0,0,-9,-12,-4,-3,7,3,0,0,1,-1,-1,-1,4,-1
KR_6723880545,420,-1,-15,-10,-4,-2,4,2,-1,2,1,1,2,3,-2,3,1,0,0,0,0,-5,3,1,-6,5,-2,0,-2,-1,1,-1,1,1,-1
KR_6760658936,420,0,-70,-6,-1,0,2,2,2,1,3,-1,1,0,-2,5,3,0,2,2,0,4,-5,3,-4,1,-1,0,1,1,1,1,-1,1,-1
KR_6589344551,420,-4,-66,-12,-6,-3,3,0,-4,5,1,-3,4,1,4,2,6,0,0,0,1,1,2,4,-6,2,-2,0,0,-1,-1,-1,1,4,-1
KR_6761339329,440,-4,-68,-28,-6,0,1,1,0,3,3,-2,3,1,-3,5,2,-1,2,1,1,4,-4,-3,-1,4,1,0,0,-1,-1,0,1,5,-1
KR_6612916502,420,-3,-54,-6,-9,2,0,2,3,1,4,0,0,0,-10,12,2,-4,4,0,0,-5,-482,-3,0,3,-2,0,-2,1,-1,-1,-1,4,-1
KR_6754209384,420,-2,-20,8,1,-1,2,1,0,1,1,1,1,2,2,2,4,-1,2,1,0,1,9,4,-5,1,0,0,-1,1,-1,1,1,3,-1
KR_6471434870,420,-3,-88,-12,0,-2,3,1,-3,3,0,0,2,2,4,1,5,1,0,1,0,1,1,1,-4,3,-2,0,1,1,1,1,1,5,-1
KR_6650200319,420,-2,-43,-1,-5,-5,5,0,3,2,5,-3,5,2,-1,2,1,1,1,2,0,2,4,0,-2,2,3,0,-1,1,-1,-1,-1,6,-1
KR_6609816206,420,2,62,-32,11,6,0,6,3,1,4,0,1,1,-1,2,1,3,0,3,0,1,-2,-1,-4,5,1,0,2,-1,1,1,-1,6,-1
KR_6688091301,420,-4,-74,-24,-9,-6,7,1,-2,4,2,-3,4,1,3,3,6,-1,2,1,0,-2,-118,3,-6,3,-4,0,-1,1,-1,-1,-1,2,-1
KR_6724918492,420,-1,-78,10,4,0,2,2,0,0,0,5,1,6,-2,2,0,1,4,5,0,-1,-329,-2,-1,3,1,0,0,1,1,0,1,5,-1
KR_6636858312,420,-1,-8,-8,-2,1,1,2,-9,9,0,0,1,1,4,1,5,2,1,3,0,0,-1,2,-3,1,-2,0,0,-1,-1,-1,-1,1,-1
KR_6683076950,420,-7,-107,-33,-20,-8,10,2,1,2,3,-5,8,3,-4,6,2,-4,6,2,0,-10,-11,-2,0,2,0,0,-1,-1,-1,-1,1,2,-1
KR_6764199258,420,-4,-48,-36,-11,-3,3,0,-1,6,5,0,2,2,-7,8,1,0,0,0,0,-10,15,1,-4,3,0,0,-1,-1,1,-1,-1,6,-1
KR_6761567431,420,-2,-44,-12,-6,-2,4,2,0,1,1,1,3,4,-4,5,1,-1,2,1,0,-9,5,-2,-2,4,-4,0,0,-1,1,-1,-1,6,-1
KR_6672380964,420,-2,53,-19,2,1,0,1,0,4,4,2,1,3,-2,5,3,1,0,1,0,1,-9,-1,-5,6,-2,0,0,-1,0,0,-1,1,-1
KR_6761249910,440,-8,-76,-56,-11,-4,4,0,-2,2,0,0,1,1,-5,7,2,0,1,1,0,-8,28,-1,-1,2,-4,0,-1,-1,1,-1,-1,2,-1
KR_6752824619,420,-4,-99,31,-19,-3,4,1,-8,8,0,-2,2,0,-4,7,3,-2,3,1,-2,-26,-6,-2,-2,4,0,0,-1,-1,0,-1,-1,6,-1
KR_6586458277,440,-3,-53,-12,1,-2,3,1,3,1,4,1,4,5,-2,5,3,1,2,3,1,4,23,4,-9,5,-5,0,-2,-1,-1,-1,1,5,-1
KR_6708486641,420,-2,-15,-41,-4,0,1,1,0,5,5,2,1,3,-6,8,2,0,2,2,0,4,-341,-1,-3,4,0,0,-1,-1,-1,-1,-1,6,-1
KR_6609296977,420,-2,-72,-12,-10,1,1,2,-3,3,0,-2,3,1,-6,6,0,0,0,0,0,-18,-4,-5,-1,6,0,0,-1,1,-1,-1,-1,5,-1
KR_6756789126,440,-8,-109,-36,-30,-3,4,1,-13,13,0,-5,5,0,-5,8,3,-4,5,1,0,-30,-16,3,-8,5,-6,-2,-7,-1,-1,-1,-1,5,-1
KR_6764255695,420,1,58,-17,-6,0,2,2,-1,2,1,0,2,2,-5,5,0,0,1,1,1,-12,519,0,-3,3,-4,0,0,1,-1,1,1,1,-1
KR_6741928080,420,-1,-10,6,5,-2,2,0,5,2,7,-2,3,1,2,2,4,2,0,2,0,12,205,5,-6,1,-1,0,0,1,-1,0,1,2,-1
KR_6422914040,420,5,87,-8,4,2,1,3,0,2,2,0,3,3,-1,2,1,3,0,3,-2,-1,44,3,-6,3,-17,0,1,-1,1,1,1,3,-1
KR_6718466499,420,-6,-51,-40,-5,2,1,3,-1,2,1,-6,7,1,0,1,1,0,0,0,0,-1,-94,0,-1,1,3,0,-3,-1,-1,-1,1,4,-1
KR_6065337133,420,-2,-60,96,-5,-2,4,2,-3,3,0,4,3,7,-1,3,2,-3,4,1,0,-5,-3,2,-2,0,-3,0,-2,0,0,-1,-1,0,-1
KR_6253356853,420,-5,-15,-16,-7,-3,3,0,-2,4,2,2,0,2,-5,7,2,1,0,1,0,-16,-85,-2,-3,5,-21,0,0,-1,0,-1,1,2,-1
KR_6375631692,420,2,-52,4,2,-1,1,0,3,1,4,1,0,1,-2,3,1,1,0,1,0,6,0,0,0,0,-1,0,0,-1,0,0,1,6,-1
KR_6675065036,440,-7,-72,0,-17,-2,4,2,-5,5,0,-2,4,2,-5,7,2,-3,5,2,0,-18,-7,2,-5,3,-4,0,-4,-1,-1,-1,-1,5,-1
KR_6385353484,420,0,36,-4,0,3,2,5,-2,3,1,2,1,3,-3,4,1,0,1,1,0,-2,-40,1,-3,2,21,0,0,0,1,1,1,0,-1
KR_6617564526,420,-1,-37,16,-1,4,1,5,-3,4,1,-2,4,2,0,0,0,0,1,1,-1,-3,3,2,-2,0,0,0,0,-1,0,0,-1,1,-1
KR_6729259044,420,-3,-34,-19,-1,1,3,4,1,0,1,-1,3,2,-2,2,0,0,0,0,0,-4,-114,3,-3,0,-2,0,0,1,-1,-1,1,1,-1
KR_6746437749,420,-3,-16,-24,-13,-1,1,0,-2,5,3,2,1,3,-11,12,1,-1,3,2,-2,-18,13,0,0,0,1,0,-1,-1,-1,-1,-1,3,-1
KR_6723489458,420,0,15,-6,-4,-1,5,4,0,2,2,-1,5,4,-3,8,5,1,4,5,0,0,-9,-3,-3,6,0,0,-1,-1,-1,-1,1,3,-1
KR_6737096966,420,-1,-15,-12,-5,1,1,2,1,2,3,-7,8,1,-1,2,1,1,0,1,0,2,5,2,-3,1,-2,0,-2,0,-1,-1,-1,0,-1
KR_6728134221,440,-5,-14,-35,-6,1,2,3,2,2,4,-3,6,3,-5,5,0,-1,1,0,0,-10,3,6,-6,0,-2,0,-1,-1,-1,-1,1,2,-1
KR_6746514432,440,-8,-9,-53,-3,2,1,3,-6,6,0,4,1,5,-2,2,0,-1,1,0,0,-11,-15,-5,-2,7,0,0,0,0,-1,-1,1,0,-1
KR_6077808724,420,-1,-58,-13,2,-2,3,1,-4,4,0,1,3,4,2,1,3,5,0,5,0,7,-9,-5,-2,7,2,0,-2,1,-1,-1,1,1,-1
KR_6391972618,420,-1,15,-20,2,-1,1,0,1,2,3,2,0,2,0,1,1,0,0,0,0,0,3,2,-4,2,4,0,0,1,-1,0,1,2,-1
KR_6758042301,420,-2,-11,16,1,-2,2,0,1,1,2,-1,2,1,0,1,1,3,1,4,0,0,-23,-9,-1,10,4,0,1,-1,1,1,-1,2,-1
KR_6181977796,420,-8,-135,-8,-18,0,0,0,-4,6,2,-4,5,1,-8,8,0,-2,2,0,0,-16,-200,-4,-4,8,-6,0,-1,-1,0,-1,-1,5,-1
KR_6323471256,420,4,19,23,11,2,1,3,1,2,3,-2,7,5,8,1,9,2,3,5,0,8,8,0,-2,2,0,0,1,-1,-1,1,-1,1,-1
KR_6761119189,420,-1,17,-10,-6,-1,2,1,-2,3,1,-6,9,3,1,1,2,2,0,2,0,-5,-246,-1,-3,4,-5,0,-1,1,-1,-1,-1,6,-1
KR_6741114452,420,-2,-112,-24,-11,-3,3,0,-2,3,1,2,1,3,-6,7,1,-2,3,1,0,-10,-1,-2,-1,3,-2,0,-2,-1,0,-1,1,2,-1
KR_6733537374,420,1,-26,9,4,3,3,6,2,3,5,0,1,1,-1,3,2,0,0,0,1,-2,-5,-4,-2,6,-3,0,0,-1,1,0,1,5,-1
KR_6726514328,420,-3,-75,4,-11,-6,6,0,-1,3,2,-3,5,2,-1,2,1,0,0,0,0,-8,-1,-2,-3,5,-3,0,-1,1,-1,-1,1,6,-1
KR_6739553590,420,0,-8,22,1,6,0,6,4,5,9,-9,9,0,-1,4,3,1,0,1,0,0,-13,-7,-1,8,0,0,0,1,-1,-1,1,3,-1
KR_6761021032,420,0,-7,12,-5,-7,7,0,0,1,1,0,4,4,2,0,2,0,0,0,0,-2,2,1,-4,3,1,0,1,-1,1,-1,1,3,-1
KR_6752429028,420,-3,-63,-25,-10,-5,5,0,-6,6,0,5,1,6,-5,5,0,1,2,3,-1,-14,-9,-2,-2,4,-1,0,-1,-1,0,-1,-1,6,-1
KR_5921253128,440,-2,-83,23,-4,0,0,0,-2,3,1,-2,2,0,0,1,1,0,0,0,-1,-1,-3,0,-4,4,-3,0,-1,1,1,-1,-1,4,-1
KR_6668828588,440,0,68,-4,-6,1,1,2,-5,8,3,1,2,3,-3,4,1,0,1,1,0,-5,5,-1,-3,4,2,0,0,0,-1,0,-1,0,-1
KR_6712578261,420,1,-34,36,-1,-4,4,0,-8,8,0,11,0,11,-1,1,0,1,1,2,0,-2,8,-1,0,1,1,0,0,-1,-1,0,1,4,-1
KR_6484121685,420,3,35,-23,4,1,2,3,-2,5,3,0,3,3,5,4,9,0,0,0,0,4,-4,-2,-1,3,4,0,0,-1,-1,-1,1,5,-1
KR_6593031728,420,-3,44,8,-8,-4,4,0,-2,3,1,-1,1,0,1,3,4,-2,4,2,0,-10,-55,2,-4,2,-4,0,0,-1,1,0,-1,4,-1
KR_6727429184,440,-1,-17,-24,0,-3,4,1,4,1,5,1,1,2,-2,2,0,0,1,1,1,2,230,0,-2,2,2,0,0,1,1,0,1,4,-1
KR_6753719404,420,0,0,0,5,-4,4,0,6,2,8,4,1,5,-2,6,4,1,1,2,3,8,6,7,-7,0,-3,0,-1,1,0,-1,1,1,-1
KR_6594596527,420,-1,16,18,-9,-5,5,0,-3,3,0,-2,2,0,0,1,1,1,0,1,0,-4,3,-1,-3,4,-2,0,-1,0,-1,-1,-1,0,-1
KR_6752734641,420,-1,-4,13,4,-2,5,3,0,1,1,3,1,4,1,2,3,2,0,2,0,6,4,-1,-3,4,0,0,-1,1,0,-1,-1,2,-1
KR_6710122325,420,-5,-50,-3,0,3,1,4,2,0,2,-3,5,2,-5,6,1,3,0,3,-1,-10,-12,-1,-5,6,3,0,-3,-1,-1,-1,-1,5,-1
KR_6748202664,420,-4,-68,17,0,-3,4,1,0,3,3,4,0,4,-1,1,0,0,0,0,0,-4,-17,-3,-3,6,0,0,0,-1,-1,-1,-1,4,-1
KR_6673021527,420,0,39,4,-8,5,0,5,1,1,2,-15,16,1,4,0,4,-3,3,0,-1,-4,3,4,-4,0,0,0,-1,-1,1,-1,-1,3,-1
KR_6724619634,420,-1,-4,-4,-4,-1,2,1,2,4,6,-4,5,1,-1,5,4,0,1,1,0,1,0,1,-4,3,-1,0,0,-1,-1,-1,1,1,-1
KR_6670286452,420,-5,-67,-22,-11,-1,1,0,-7,7,0,0,1,1,-2,3,1,-1,1,0,0,-7,-37,-2,-2,4,3,0,-1,-1,-1,-1,1,1,-1
KR_6764548344,420,-5,-84,20,-9,-5,5,0,0,1,1,0,2,2,-1,1,0,-3,3,0,0,-13,-3,0,-1,1,-2,0,-1,-1,1,-1,-1,1,-1
KR_6720633792,420,-4,-29,-19,-8,2,1,3,-2,2,0,-3,5,2,-2,2,0,-3,3,0,0,-10,-7,-2,0,2,-1,0,-2,-1,1,-1,-1,1,-1
KR_6719205851,420,-3,-84,24,-5,-7,7,0,2,1,3,-2,3,1,1,2,3,1,1,2,1,5,-7,0,-3,3,1,0,-1,1,1,-1,1,6,-1
KR_6531420778,420,-1,18,-21,-6,-1,2,1,-1,2,1,-3,3,0,-1,1,0,0,0,0,0,-4,6,0,-2,2,-4,0,0,-1,0,0,-1,3,-1
KR_6737591208,420,-2,0,-16,2,4,2,6,-1,2,1,-1,1,0,-3,4,1,3,0,3,0,2,2,-3,-3,6,3,0,0,1,-1,1,-1,6,-1
KR_6613385755,420,-5,-59,-13,-10,-5,5,0,-2,2,0,-2,5,3,2,2,4,-3,3,0,0,-5,-112,3,-6,3,-4,0,-1,0,-1,-1,-1,0,-1
KR_6641418577,420,-4,-17,11,-11,-3,4,1,1,3,4,-3,5,2,-3,3,0,-3,5,2,0,-4,-4,-2,-4,6,-1,0,-1,-1,-1,-1,-1,3,-1
KR_6096583069,420,-3,-32,6,-2,-1,3,2,-7,7,0,7,0,7,0,2,2,-1,1,0,-1,-10,-3,-6,-1,7,-4,0,0,0,1,0,1,0,-1
KR_6706217597,440,-4,-34,4,-4,-4,4,0,-2,5,3,2,4,6,0,4,4,0,2,2,0,-8,-10,1,-2,1,-1,0,-1,-1,0,-1,1,5,-1
KR_6746604653,420,-3,-50,14,-6,0,1,1,-7,9,2,0,1,1,0,2,2,1,0,1,1,-4,4,-3,-2,5,-2,0,-1,0,0,-1,1,0,-1
KR_6730803817,420,-9,-89,-66,-21,-9,11,2,1,2,3,0,1,1,-12,14,2,-1,3,2,0,-8,1,2,-4,2,1,0,-3,-1,-1,-1,-1,2,-1
KR_6327771119,420,-4,-99,-32,-8,-4,4,0,1,1,2,-4,5,1,2,1,3,-3,5,2,-1,0,-4,2,-2,0,0,0,-2,-1,-1,-1,-1,6,-1
KR_6508594603,420,-1,1,0,0,1,0,1,1,3,4,0,3,3,-5,5,0,3,0,3,0,0,-4,-3,-1,4,0,0,0,1,1,0,1,6,-1
KR_6733825407,440,-2,-11,-11,0,-4,4,0,-2,3,1,2,3,5,2,1,3,2,0,2,0,-1,-22,-8,-1,9,3,0,1,1,0,1,1,2,-1
KR_6755923374,420,-6,-4,-63,-16,-3,4,1,-6,6,0,-3,3,0,-7,9,2,3,1,4,0,-12,6,-1,-2,3,-2,0,-1,-1,-1,-1,1,4,-1
KR_6685326213,420,3,26,44,4,0,0,0,0,1,1,-2,4,2,7,0,7,-1,2,1,0,2,-144,-3,-1,4,0,0,1,0,-1,1,-1,0,-1
KR_6729005421,420,0,-49,-19,-8,1,4,5,-1,3,2,-6,8,2,0,3,3,-2,3,1,-3,-5,3,-2,0,2,1,0,-2,-1,0,-1,-1,2,-1
KR_6672289177,420,-2,-2,-20,-4,-5,5,0,-1,2,1,2,0,2,1,1,2,-1,3,2,0,-2,33,-3,-2,5,-8,0,0,-1,-1,0,-1,5,-1
KR_6647020512,420,-1,1,-21,-1,-1,1,0,-1,1,0,-1,2,1,2,0,2,0,0,0,0,1,6,0,-2,2,-2,0,-1,-1,-1,-1,-1,2,-1
KR_5799681970,420,-4,24,-19,-9,-1,1,0,1,3,4,-5,5,0,-3,5,2,-1,1,0,0,-8,-58,-1,-6,7,-2,0,0,-1,-1,-1,-1,3,-1
KR_6526241911,420,-4,-74,-9,-10,3,3,6,-2,2,0,-4,5,1,-4,4,0,-3,3,0,0,-6,24,-2,-1,3,-3,0,1,-1,0,1,-1,6,-1
KR_6733313199,420,1,-41,-3,-4,-1,4,3,1,1,2,-3,4,1,-1,1,0,0,1,1,0,-6,3,-3,-2,5,2,0,0,1,-1,0,-1,6,-1
KR_6720534765,420,-1,-26,-39,-2,1,1,2,-2,4,2,-4,4,0,3,0,3,0,0,0,0,3,72,1,-1,0,1,0,-1,-1,-1,-1,-1,3,-1
KR_6580565704,440,0,22,9,-6,0,0,0,-8,10,2,4,1,5,0,2,2,-2,2,0,0,-13,-26,3,-7,4,4,0,0,-1,0,0,-1,4,-1
KR_6760982344,420,3,44,16,3,-4,4,0,1,0,1,3,4,7,2,3,5,1,2,3,0,3,19,-5,-1,6,3,0,0,0,1,0,1,0,-1
KR_6758706015,420,-3,4,10,-6,0,3,3,1,1,2,-2,3,1,-5,6,1,0,0,0,0,-7,6,0,-3,3,-3,0,0,-1,-1,0,-1,2,-1
KR_6650834688,420,-6,-73,-36,-14,1,0,1,-11,11,0,-2,3,1,-1,2,1,-1,3,2,-1,-10,-12,-7,0,7,1,0,-2,-1,-1,-1,-1,6,-1
KR_6710219244,420,2,-33,36,4,1,1,2,1,6,7,1,2,3,-1,4,3,2,1,3,-2,-1,47,2,-3,1,-16,0,0,-1,-1,-1,-1,5,-1
KR_6746485935,420,-3,-25,-61,-5,-4,5,1,-1,4,3,3,2,5,-3,5,2,0,1,1,0,-4,-10,-1,-2,3,-2,0,-2,-1,1,-1,1,6,-1
KR_6755709338,420,-2,-27,-2,-11,-1,1,0,-7,7,0,-6,6,0,2,2,4,1,0,1,0,-3,3,-1,-4,5,1,0,0,-1,-1,-1,-1,1,-1
KR_6758178454,420,1,-26,2,5,-2,3,1,-2,2,0,-1,1,0,7,2,9,3,0,3,0,8,7,0,-1,1,1,0,0,1,1,1,-1,5,-1
KR_6724897417,420,-5,-90,34,-9,-1,2,1,0,1,1,-7,9,2,0,2,2,-1,1,0,-1,-6,32,-1,-1,2,1,0,-1,-1,-1,-1,-1,4,-1
KR_6729886755,420,-2,-50,-36,-5,0,3,3,7,1,8,-10,11,1,-4,7,3,2,1,3,0,4,-7,-2,-2,4,-2,0,-1,1,1,-1,-1,5,-1
KR_6733032478,420,-4,-6,-4,-7,-3,3,0,0,4,4,-1,2,1,-1,5,4,-2,2,0,0,-7,-6,-1,-4,5,7,0,-1,1,-1,-1,1,2,-1
KR_6354819881,440,1,-42,-10,-5,1,1,2,-2,3,1,-4,5,1,0,3,3,0,1,1,0,1,0,0,0,0,-2,0,0,0,0,0,1,0,-1
KR_6749176403,440,-6,-39,12,-16,-1,2,1,-2,2,0,-6,6,0,-5,5,0,-2,2,0,0,-16,-18,-1,0,1,-1,0,-1,0,-1,-1,1,0,-1
KR_6705675759,420,-4,-32,9,-8,1,0,1,-2,3,1,0,3,3,-5,5,0,-2,2,0,0,-11,-5,-1,0,1,1,0,-1,-1,-1,-1,-1,4,-1
KR_6741660261,420,0,-1,-12,-4,0,2,2,-4,5,1,0,1,1,0,2,2,0,1,1,0,-3,-6,-1,-3,4,1,0,0,-1,1,0,1,2,-1
KR_6603068281,420,-3,-32,3,-6,0,1,1,-4,5,1,-2,4,2,0,3,3,0,3,3,0,-9,10,-1,-3,4,-4,0,-1,1,-1,-1,1,5,-1
KR_6595005849,420,0,-24,4,-5,0,1,1,0,3,3,0,3,3,-4,5,1,-1,2,1,0,-10,6,0,-6,6,1,0,1,-1,1,1,1,2,-1
KR_6689937800,420,3,44,-8,3,5,0,5,-1,4,3,4,2,6,-5,5,0,0,1,1,0,-4,-4,2,-4,2,1,0,-1,-1,-1,-1,1,2,-1
KR_6673012570,420,-2,-21,0,-5,-1,1,0,2,1,3,-2,5,3,-3,5,2,-1,1,0,0,1,1,0,-6,6,-5,0,-2,-1,-1,-1,1,6,-1
KR_6605862030,420,-4,-10,-12,-4,-4,4,0,-1,4,3,2,0,2,-2,3,1,1,1,2,0,-5,-3,3,-7,4,-3,0,0,-1,1,1,-1,4,-1
KR_6750223997,420,0,10,6,4,-1,1,0,1,0,1,1,2,3,1,0,1,2,6,8,0,2,-87,1,-5,4,0,0,0,1,1,0,1,4,-1
KR_6711453533,420,-4,-43,-39,-6,5,0,5,-9,9,0,1,1,2,-1,1,0,-2,3,1,-2,-15,26,-1,-2,3,-1,0,-3,1,-1,-1,-1,6,-1
KR_6693341610,420,0,-27,5,-3,1,1,2,-2,4,2,-3,4,1,1,1,2,0,0,0,0,1,-4,-3,-5,8,0,0,-1,-1,-1,-1,-1,4,-1
KR_6762218819,420,-7,-65,-56,-13,0,0,0,-5,5,0,-2,3,1,-7,8,1,1,0,1,0,-13,3,2,-5,3,-4,0,-1,0,1,-1,1,0,-1
KR_6377648177,420,-1,-54,-24,2,-1,2,1,0,1,1,0,1,1,3,0,3,0,1,1,0,4,15,-1,-3,4,-4,0,-1,0,-1,-1,1,0,-1
KR_6734580244,420,-1,17,-33,-2,4,1,5,0,1,1,-2,2,0,-2,2,0,-2,2,0,0,-8,-1,1,-4,3,-3,0,0,0,0,0,1,0,-1
KR_6653178026,420,2,-41,16,6,1,1,2,3,1,4,3,0,3,-1,1,0,0,1,1,0,6,-4,0,-3,3,0,0,0,-1,1,0,-1,5,-1
KR_6751306517,420,-1,-45,-4,-13,1,2,3,-2,4,2,-8,8,0,-1,2,1,-3,3,0,0,-11,19,-2,-4,6,-3,0,-2,-1,-1,-1,-1,2,-1
KR_6562296727,420,1,8,-1,-3,2,0,2,-2,5,3,-4,5,1,-1,4,3,2,0,2,0,-10,-5,-1,-3,4,0,0,1,-1,0,1,1,4,-1
KR_6375165963,420,-4,-35,-8,0,-2,3,1,3,1,4,2,2,4,-3,4,1,0,1,1,0,4,0,0,0,0,-7,0,1,-1,-1,1,1,3,-1
KR_6621020144,440,-8,-192,16,-20,-6,6,0,-5,8,3,-3,4,1,-5,6,1,-1,2,1,0,-19,-4,1,-5,4,-1,0,-2,0,-1,-1,-1,0,-1
KR_6762998092,420,2,30,22,-1,1,1,2,0,4,4,3,1,4,-2,5,3,-3,3,0,0,-5,-10,3,-5,2,0,0,0,0,0,0,-1,0,-1
KR_6745597527,420,-3,-42,-19,-3,-1,2,1,0,2,2,-3,4,1,2,0,2,-1,2,1,0,-7,41,-3,0,3,-28,0,0,-1,1,0,1,1,-1
KR_6755687764,420,0,-8,-20,-3,-3,4,1,2,0,2,-5,5,0,3,3,6,0,1,1,0,1,113,-2,-2,4,0,0,0,1,0,0,-1,5,-1
KR_6752294443,440,-4,54,-42,-16,-2,3,1,-3,3,0,2,3,5,-4,6,2,-9,10,1,0,-21,-24,-1,-3,4,0,0,0,-1,-1,0,-1,2,-1
KR_6716376929,420,-4,-107,-17,-6,0,3,3,0,1,1,4,1,5,-1,2,1,-9,10,1,0,-2,-44,-1,-2,3,29,0,-4,0,0,-1,1,0,-1
KR_6681072983,420,-2,-43,44,-3,0,1,1,-1,2,1,1,3,4,-2,3,1,-1,3,2,0,-2,-6,-2,-4,6,1,0,-1,0,0,-1,1,0,-1
KR_6601107632,420,0,-28,0,-4,0,2,2,-3,4,1,0,2,2,-1,3,2,0,0,0,0,-10,6,0,-3,3,0,0,0,-1,1,0,-1,5,-1
KR_6709865077,420,-2,-88,28,2,2,1,3,5,1,6,-4,7,3,-2,3,1,1,0,1,0,4,3,2,-4,2,-1,0,1,1,1,1,1,6,-1
KR_6763417439,420,-1,31,-8,6,1,0,1,5,3,8,-2,3,1,-1,1,0,3,0,3,0,7,35,7,-8,1,-26,0,0,-1,-1,0,1,4,-1
KR_6702124460,420,-1,16,-25,0,1,1,2,-1,5,4,5,2,7,-4,5,1,-1,2,1,0,1,-194,-2,0,2,1,0,1,-1,1,1,1,3,-1
KR_6758502969,420,-1,-36,8,-4,3,3,6,1,2,3,-1,4,3,-3,3,0,-4,4,0,1,-6,4,0,-3,3,-4,0,0,1,1,0,1,3,-1
KR_6433407459,420,-4,-110,-23,-13,2,2,4,-4,4,0,-5,6,1,-5,6,1,-1,1,0,0,-4,-22,-4,-1,5,-2,0,-1,-1,-1,-1,1,3,-1
KR_6762328330,420,-3,-14,-32,-6,1,2,3,-2,2,0,4,0,4,-9,10,1,0,0,0,0,-13,-16,-1,-3,4,-1,0,1,-1,1,1,-1,6,-1
KR_6758630614,420,0,19,-28,-1,-4,4,0,-3,5,2,2,1,3,2,1,3,2,1,3,-2,1,39,0,0,0,-30,0,0,-1,0,0,-1,6,-1
KR_6624558761,420,-2,8,-17,-8,-3,5,2,2,1,3,-3,5,2,-1,1,0,-3,3,0,-1,-11,47,-1,0,1,-30,0,0,0,0,0,-1,0,-1
KR_6741016248,420,-2,-44,-20,-2,0,0,0,0,3,3,-1,4,3,-1,4,3,0,1,1,0,-3,-446,3,-5,2,1,0,-1,-1,-1,-1,1,4,-1
KR_6696297604,420,-3,9,10,-2,-3,3,0,0,1,1,-3,5,2,3,2,5,1,0,1,0,-1,-8,0,-6,6,-2,0,0,1,-1,-1,1,4,-1
KR_6681940672,440,0,44,0,-2,-1,4,3,1,2,3,-1,3,2,-3,4,1,2,0,2,0,-2,-1,-1,-4,5,-1,0,1,-1,1,1,1,3,-1
KR_6659938621,420,-6,-92,-25,-12,-2,3,1,-2,3,1,-5,5,0,-1,2,1,-2,2,0,0,-9,-1,0,-2,2,-5,0,-2,-1,-1,-1,-1,6,-1
KR_6717557151,420,-1,15,-12,-4,0,2,2,-4,5,1,4,3,7,-1,1,0,-3,3,0,0,-10,-6,3,-5,2,2,0,1,-1,1,-1,-1,2,-1
KR_6764497323,420,-8,-72,-4,-19,-5,7,2,0,2,2,-2,3,1,-11,12,1,-1,1,0,0,-14,-11,-2,-3,5,-5,0,-2,0,-1,-1,1,0,-1
KR_6670612328,420,-4,1,0,-5,2,2,4,-5,7,2,-2,2,0,2,1,3,-2,2,0,2,-5,3,-3,-4,7,0,0,-1,1,-1,-1,1,6,-1
KR_6754664878,420,-6,-71,5,-12,-3,4,1,-4,4,0,0,2,2,-4,4,0,-1,1,0,0,-14,29,-4,0,4,-18,0,-2,-1,1,-1,1,6,-1
KR_6659090733,440,-6,-52,-41,-10,4,0,4,-10,11,1,-4,4,0,0,1,1,0,0,0,0,-10,-36,-8,-2,10,-2,0,-1,-1,-1,-1,-1,4,-1
KR_6681224482,420,-5,-85,4,-7,0,1,1,-3,5,2,-3,4,1,-1,3,2,0,0,0,0,-9,-3,2,-5,3,2,0,-1,-1,1,-1,-1,1,-1
KR_6709559234,420,0,14,-8,1,3,2,5,0,4,4,-4,5,1,6,2,8,-4,4,0,-1,-2,10,4,-5,1,-2,0,1,-1,1,1,-1,6,-1
KR_6733769531,420,-3,8,-52,-5,-1,3,2,-1,2,1,-2,4,2,-3,3,0,2,1,3,0,-4,-213,0,-5,5,0,0,0,-1,1,0,1,6,-1
KR_6733915157,420,1,-19,12,3,0,1,1,4,0,4,5,2,7,-3,4,1,-3,3,0,0,-11,13,1,-3,2,4,0,1,1,0,1,1,3,-1
KR_6763881897,420,-5,-80,-4,-11,-6,7,1,-4,8,4,0,1,1,1,0,1,-2,3,1,0,-10,0,-4,-1,5,4,0,-1,-1,-1,-1,-1,4,-1
KR_6697213208,420,2,53,-14,-1,0,2,2,-2,3,1,-7,7,0,7,2,9,1,1,2,-2,-9,-21,-2,-3,5,2,0,0,1,-1,-1,-1,3,-1
KR_6728732863,420,0,49,16,-4,-4,5,1,2,2,4,0,2,2,-4,5,1,2,2,4,0,-3,1,0,-3,3,1,0,0,1,1,-1,-1,4,-1
KR_6669632576,420,0,-3,4,5,-1,3,2,0,2,2,-3,3,0,11,0,11,-2,2,0,0,6,-5,0,-4,4,5,0,0,-1,-1,1,1,5,-1
KR_6711095297,420,-7,-73,-46,-14,-5,8,3,-1,3,2,-5,7,2,-2,3,1,-1,1,0,0,-2,-437,1,-2,1,-1,0,-2,-1,-1,-1,-1,4,-1
KR_6533775856,440,-2,-55,-14,-7,-4,4,0,3,1,4,0,1,1,-5,6,1,-1,1,0,0,-3,11,-3,-4,7,-4,0,1,-1,1,1,-1,2,-1
KR_6571264445,420,-5,-37,-17,-10,-3,5,2,0,3,3,1,1,2,-3,7,4,-5,5,0,0,-8,17,0,-1,1,0,0,-3,-1,1,-1,-1,6,-1
KR_6592242684,440,-5,-38,-40,-16,-10,11,1,-4,7,3,2,2,4,-4,4,0,0,3,3,0,-8,-4,1,-4,3,-1,0,0,-1,0,-1,1,2,-1
KR_6584552795,420,-2,15,-28,-12,-2,3,1,-1,4,3,0,2,2,-6,6,0,-3,3,0,-1,-20,-119,-5,0,5,3,0,-2,-1,-1,-1,-1,5,-1
KR_6386292777,420,-3,29,-16,-12,3,4,7,-5,5,0,-3,7,4,-5,7,2,-2,2,0,-3,-15,-21,-2,-2,4,-7,0,0,-1,-1,-1,1,5,-1
KR_6562229695,420,-6,-52,11,-5,-3,4,1,1,2,3,-2,2,0,0,1,1,-1,1,0,0,-5,-1,3,-5,2,-1,0,-1,1,-1,-1,1,2,-1
KR_6668449814,420,0,27,-24,2,-1,3,2,-8,12,4,-1,4,3,5,1,6,7,1,8,0,6,1,-4,-1,5,3,0,0,-1,-1,1,1,2,-1
KR_6688111745,420,-4,-116,-35,-6,-3,6,3,-1,5,4,-5,5,0,3,0,3,0,0,0,1,0,2,-2,-2,4,0,0,-1,-1,-1,-1,1,3,-1
KR_6003422837,420,-11,-161,-34,-11,-6,6,0,-3,4,1,-2,2,0,1,2,3,-1,1,0,1,-7,87,-5,0,5,1,-1,-5,-1,-1,-1,1,2,-1
KR_6653361951,420,-1,-21,11,6,3,3,6,-1,1,0,2,2,4,-1,2,1,3,2,5,1,5,-6,-3,-2,5,4,0,0,-1,0,-1,-1,1,-1
KR_6758769425,420,0,-84,24,0,-3,5,2,1,3,4,0,1,1,1,1,2,1,0,1,0,4,5,-1,-3,4,2,0,-1,1,1,-1,-1,2,-1
KR_6746165630,420,1,-36,30,2,2,0,2,0,0,0,2,2,4,-1,4,3,-1,1,0,1,-5,16,2,-4,2,-3,0,0,1,1,-1,1,3,-1
KR_6763160324,420,2,27,12,4,-2,2,0,1,1,2,6,1,7,0,0,0,-1,2,1,0,5,8,3,-3,0,-1,0,0,1,1,1,-1,4,-1
KR_6327421549,420,-3,-94,-4,5,2,1,3,7,0,7,0,3,3,-4,5,1,0,0,0,0,8,41,4,-6,2,0,0,-2,0,1,-1,1,0,-1
KR_6716296311,440,5,21,20,14,-2,2,0,0,3,3,9,0,9,5,1,6,2,0,2,0,16,-12,-4,-3,7,5,0,1,1,-1,1,1,1,-1
KR_6729521495,420,-1,-29,-8,-6,1,1,2,-5,7,2,0,1,1,-2,2,0,0,2,2,0,-5,-6,-4,-2,6,1,0,-1,-1,-1,-1,-1,4,-1
KR_6468268248,420,-1,47,-25,5,-1,3,2,-4,6,2,9,0,9,3,4,7,-2,4,2,1,2,121,-5,-3,8,-1,0,4,-1,1,1,1,1,-1
KR_6644701806,440,-2,-119,17,-4,-3,3,0,4,4,8,0,3,3,-1,2,1,-4,4,0,-1,1,-10,-3,0,3,-2,0,-2,1,-1,-1,-1,2,-1
KR_6606077722,420,0,73,4,0,3,1,4,-4,4,0,0,1,1,2,1,3,-1,2,1,0,-8,6,4,-4,0,-2,0,-1,1,1,-1,-1,6,-1
KR_6762573865,420,-1,23,-16,-3,-2,2,0,-3,4,1,-1,4,3,4,2,6,-1,1,0,0,-9,7,0,-2,2,-1,0,2,-1,-1,1,1,4,-1
KR_6422768188,420,0,1,21,-8,0,1,1,0,3,3,-2,6,4,4,1,5,-10,10,0,-1,-14,2,1,-4,3,4,0,1,-1,1,1,-1,3,-1
KR_6762412512,420,-2,-63,8,-2,-1,4,3,6,1,7,-5,5,0,-3,5,2,1,0,1,0,1,4,0,-2,2,1,0,-1,-1,-1,-1,1,1,-1
KR_6669012524,440,-5,-54,-32,-18,2,1,3,-9,10,1,2,0,2,-6,7,1,-7,8,1,1,-21,5,4,-6,2,-1,0,0,-1,1,1,1,2,-1
KR_6763871682,420,1,-60,-23,0,-2,4,2,0,3,3,3,4,7,0,2,2,-1,1,0,-1,0,-15,1,-3,2,0,0,-1,0,1,-1,-1,0,-1
KR_6622352306,420,2,5,16,3,3,0,3,-1,2,1,3,2,5,-1,2,1,-1,2,1,0,8,2,2,-3,1,0,0,1,-1,1,1,-1,4,-1
KR_6761318320,440,-3,-32,32,-10,0,2,2,2,0,2,-6,6,0,-5,6,1,-1,1,0,0,-10,3,-1,-2,3,0,0,0,1,-1,-1,-1,1,-1
KR_6738201470,420,2,3,12,4,-4,5,1,3,0,3,-2,4,2,6,0,6,1,0,1,0,5,2,4,-5,1,-1,0,0,1,-1,1,-1,1,-1
KR_6744699703,420,-4,-42,-8,-12,-2,4,2,-3,4,1,-5,7,2,1,1,2,-3,3,0,-1,-11,11,0,-5,5,-5,0,-1,-1,-1,-1,-1,5,-1
KR_6716599871,420,-3,-10,28,-9,-1,3,2,-3,4,1,-1,7,6,-3,6,3,-1,3,2,0,-14,0,-1,-4,5,3,0,0,-1,-1,0,-1,3,-1
KR_6682331009,420,-1,-87,-18,-2,-1,3,2,-3,4,1,1,6,7,0,3,3,1,0,1,0,5,23,-2,-4,6,2,0,-1,-1,-1,-1,1,6,-1
KR_6746639861,440,-2,-83,4,-2,-2,5,3,2,0,2,3,1,4,-4,5,1,-1,3,2,1,-1,-254,1,-3,2,-4,0,-1,-1,1,-1,1,1,-1
KR_6749174708,420,2,38,-24,4,-3,3,0,6,1,7,6,0,6,-4,5,1,-1,2,1,2,1,12,-4,0,4,3,0,0,1,-1,1,1,3,-1
KR_6643137080,420,-3,-121,4,-9,-2,2,0,-3,5,2,-1,1,0,0,2,2,-3,4,1,0,-5,155,-2,-4,6,-1,0,-2,1,-1,-1,-1,1,-1
KR_6729460606,420,-2,27,37,-6,1,1,2,-4,4,0,-1,3,2,0,3,3,-2,2,0,0,-6,35,-2,-2,4,-35,0,0,1,-1,-1,1,3,-1
KR_6679287344,440,-3,-66,13,-4,-5,6,1,-5,5,0,-3,4,1,8,0,8,1,0,1,0,2,5,3,-8,5,-4,0,-2,1,-1,-1,1,1,-1
KR_6404034581,420,-4,-85,2,-9,-3,4,1,-2,3,1,-3,4,1,0,2,2,-1,2,1,0,-2,5,3,-7,4,-4,0,-1,1,1,-1,-1,4,-1
KR_6373669066,420,-2,-55,17,-5,-3,3,0,1,1,2,-1,1,0,-2,3,1,0,1,1,0,-7,0,0,0,0,3,0,0,1,-1,-1,1,2,-1
KR_6762502731,420,-5,-100,-18,-13,-10,11,1,1,2,3,-6,7,1,0,1,1,2,1,3,0,-1,8,1,-3,2,-1,0,-1,-1,-1,-1,-1,1,-1
KR_6731144602,420,-2,-46,-27,-5,-3,3,0,0,2,2,0,2,2,-1,2,1,-1,1,0,0,-1,1,1,-5,4,4,0,-1,1,-1,-1,1,1,-1
KR_6727707795,420,1,18,-3,-2,-3,4,1,0,3,3,-1,3,2,2,1,3,0,2,2,0,-1,1,-3,-1,4,-1,0,0,-1,-1,1,-1,2,-1
KR_6711575951,420,-2,60,-12,-3,-4,4,0,-2,4,2,2,1,3,2,1,3,-1,1,0,0,1,-4,2,-4,2,1,0,0,-1,-1,-1,-1,1,-1
KR_6740813447,420,-1,-11,-3,2,-1,1,0,-1,2,1,-2,2,0,6,0,6,0,0,0,0,8,6,4,-5,1,-3,0,-1,1,0,-1,1,4,-1
KR_6700074672,440,-3,-103,12,-4,-2,3,1,-3,3,0,-1,5,4,3,0,3,-1,1,0,-1,0,-9,-3,-4,7,-4,0,-2,-1,-1,-1,-1,5,-1
KR_6761418521,420,-3,-114,-9,-8,-2,3,1,2,0,2,0,1,1,-8,9,1,0,0,0,-1,-9,-1,-1,-3,4,-3,0,-3,-1,-1,-1,-1,2,-1
KR_6580505239,440,1,-17,22,-7,0,2,2,-1,3,2,0,2,2,-6,8,2,0,0,0,0,-16,14,-1,-2,3,0,0,1,-1,1,1,-1,3,-1
KR_6730161883,420,2,45,-4,5,2,1,3,2,1,3,3,2,5,0,1,1,-2,3,1,0,2,-15,-2,-3,5,1,0,-2,1,1,-1,1,6,-1
KR_6696592435,420,-3,-81,-19,-14,-8,8,0,-3,3,0,0,2,2,0,1,1,-3,3,0,-1,-6,-4,-1,-6,7,1,0,-2,-1,-1,-1,-1,3,-1
KR_6617239400,420,-4,-84,36,-8,-1,1,0,-4,4,0,-4,4,0,1,0,1,0,0,0,0,-9,-263,-4,-1,5,-3,0,-1,-1,-1,-1,-1,2,-1
KR_6690941278,440,-1,-14,-20,-5,-1,2,1,0,2,2,-5,5,0,-1,4,3,2,0,2,0,2,-3,-9,-3,12,-5,0,-1,-1,-1,-1,-1,4,-1
KR_6744670046,420,-2,-39,8,-6,-4,9,5,-2,4,2,3,3,6,0,2,2,-3,3,0,0,-14,-240,-2,-2,4,0,0,0,1,-1,0,1,3,-1
KR_6317938955,420,0,38,-8,0,2,1,3,-1,1,0,5,2,7,-4,4,0,-2,2,0,0,-3,0,4,-5,1,3,0,0,-1,-1,0,-1,6,-1
KR_6663291487,420,-3,-88,-28,-5,-3,3,0,-1,2,1,-1,2,1,3,4,7,-3,4,1,0,-2,13,2,-4,2,-3,0,-2,-1,-1,-1,1,4,-1
KR_6747180131,420,2,13,9,-2,-2,2,0,0,2,2,0,3,3,0,4,4,0,0,0,0,0,-1,-1,-1,2,-2,0,0,0,0,0,1,0,-1
KR_6380828042,420,-1,-28,17,-8,-1,1,0,2,2,4,-2,3,1,-3,5,2,-4,4,0,-1,-10,4,1,-5,4,-4,0,0,-1,-1,-1,-1,1,-1
KR_6722646779,420,3,-18,20,7,3,0,3,0,2,2,6,1,7,-1,5,4,-1,2,1,2,10,24,1,-5,4,0,0,0,1,1,0,1,2,-1
KR_6597314178,420,-3,-42,0,-10,3,3,6,-6,9,3,-1,3,2,-1,2,1,-5,5,0,0,-15,3,1,-3,2,-3,0,0,-1,0,-1,1,1,-1
KR_6743928264,420,-3,-45,8,-5,-2,5,3,1,4,5,-3,5,2,-1,2,1,0,1,1,0,1,15,-4,-1,5,2,0,0,0,-1,-1,-1,0,-1
KR_6762690417,420,-3,-90,-28,-8,-1,1,0,-1,4,3,-3,3,0,-1,2,1,-2,4,2,0,-9,4,1,-4,3,-4,0,-3,-1,-1,-1,-1,5,-1
KR_6602294866,420,-4,-92,-6,-15,-8,9,1,-2,3,1,-1,4,3,-4,5,1,0,1,1,0,-9,-1,-1,-5,6,-4,0,-3,-1,1,-1,-1,6,-1
KR_6674358038,420,0,-39,5,0,3,2,5,-1,2,1,-3,4,1,0,2,2,1,1,2,0,-1,14,0,-2,2,-6,0,-1,-1,0,-1,-1,1,-1
KR_6659595025,420,0,-16,-5,-3,-2,2,0,-3,4,1,2,1,3,2,3,5,-2,3,1,0,-6,163,-1,-1,2,-2,0,-1,1,-1,-1,-1,3,-1
KR_6609173652,420,0,-3,-4,0,1,0,1,-2,6,4,-4,5,1,2,0,2,3,0,3,0,0,45,2,-5,3,-6,0,-1,-1,-1,-1,1,5,-1
KR_6719397514,420,-6,-104,-38,-3,-3,4,1,-1,2,1,0,2,2,1,2,3,0,0,0,1,1,67,-3,0,3,-1,-1,-5,-1,-1,-1,1,6,-1
KR_6760539519,420,-2,-20,28,0,-2,2,0,-2,5,3,3,1,4,1,0,1,0,1,1,0,-2,-3,1,-5,4,0,0,-1,1,0,-1,-1,2,-1
KR_6537603452,420,-6,-16,-32,-9,-5,5,0,-3,3,0,-1,5,4,0,0,0,0,0,0,0,-8,-10,-5,-2,7,6,0,0,1,0,0,-1,5,-1
KR_6756042784,420,-1,-9,16,-7,-2,2,0,0,2,2,-6,8,2,-1,3,2,2,0,2,0,-1,-1,-1,-1,2,2,0,0,1,-1,1,-1,6,-1
KR_6678861212,440,1,18,4,-3,-4,6,2,0,3,3,6,3,9,-3,3,0,-2,2,0,1,4,-2,-2,-3,5,-4,0,-1,1,-1,-1,1,1,-1
KR_6760933710,420,-3,-48,-4,-7,-2,2,0,0,1,1,-3,6,3,-4,7,3,2,1,3,0,-4,8,-6,-2,8,-4,0,-1,-1,-1,-1,-1,6,-1
KR_6480433429,420,-2,-41,16,-5,-5,5,0,-1,3,2,7,2,9,-3,6,3,-3,4,1,-1,5,-4,-4,-3,7,-1,0,0,1,-1,-1,1,2,-1
KR_6738365963,420,-4,-18,-12,-15,1,1,2,-6,6,0,-4,4,0,-5,6,1,-1,1,0,0,-18,-4,2,-6,4,-5,0,0,1,1,0,-1,4,-1
KR_6677523070,440,-2,-39,16,-11,0,0,0,-4,5,1,-5,8,3,0,2,2,-2,2,0,-1,-23,34,1,-4,3,-17,0,-1,0,1,-1,-1,0,-1
KR_6627588896,420,-2,58,-16,-3,5,0,5,2,1,3,-2,4,2,-6,6,0,-2,2,0,0,-8,-15,3,-6,3,-2,0,2,-1,1,1,1,4,-1
KR_6724631676,420,0,-37,-4,-3,2,1,3,-3,3,0,-6,7,1,4,1,5,0,0,0,0,-1,34,-1,-1,2,-2,0,0,0,-1,-1,-1,0,-1
KR_6695102505,420,-5,-67,-28,-9,-1,3,2,-2,2,0,-6,6,0,3,0,3,-3,3,0,0,-2,33,-2,-2,4,-3,0,-2,-1,-1,-1,1,6,-1
KR_6566394566,420,-1,68,-4,-2,-4,6,2,-4,5,1,0,0,0,4,3,7,2,1,3,1,-2,3,2,-3,1,1,0,1,1,-1,1,1,5,-1
KR_6715284399,420,-1,13,-16,0,0,2,2,-1,2,1,6,0,6,-3,3,0,-2,3,1,0,-5,2,-1,-3,4,-3,0,1,1,1,1,-1,4,-1
KR_6747406667,440,-5,-52,-68,-10,4,0,4,-6,7,1,-5,5,0,-2,5,3,-1,1,0,-1,-12,-2,1,-4,3,1,0,0,-1,-1,0,-1,1,-1
KR_6730490681,420,-1,-25,24,-3,0,1,1,1,3,4,2,1,3,-1,4,3,-5,5,0,0,-3,16,0,-1,1,0,0,-1,-1,1,-1,-1,2,-1
KR_6663336473,420,2,55,32,3,-1,2,1,4,0,4,1,1,2,-1,2,1,0,1,1,0,-5,-6,3,-5,2,-6,0,1,1,0,1,-1,5,-1
KR_6702279591,420,-3,-39,-12,-1,1,2,3,3,0,3,-1,3,2,-3,4,1,-1,2,1,3,-3,-4,3,-5,2,-1,0,-1,-1,1,-1,-1,4,-1
KR_6595641099,420,-4,-44,-12,-12,-3,3,0,-1,1,0,-5,5,0,-4,4,0,1,0,1,0,-9,8,-3,-1,4,-2,0,-1,-1,-1,-1,-1,3,-1
KR_6692774500,420,-1,9,-32,-4,0,2,2,-1,3,2,-1,4,3,-1,4,3,-1,1,0,-1,-1,136,-1,-5,6,3,0,-1,-1,1,-1,-1,5,-1
KR_6710690970,420,-1,-16,31,1,-3,4,1,0,1,1,-1,3,2,5,0,5,0,1,1,1,3,-22,0,-2,2,1,0,0,-1,1,0,1,4,-1
KR_6660916138,420,-4,-55,-4,-8,-9,9,0,0,1,1,3,1,4,0,2,2,-2,2,0,0,-3,9,0,-4,4,-4,0,-2,-1,-1,-1,-1,1,-1
KR_6652939324,440,1,-3,-16,-7,-5,6,1,6,0,6,-2,2,0,-4,6,2,-2,3,1,0,-4,323,1,-2,1,-4,0,-1,-1,-1,-1,-1,5,-1
KR_6501537360,420,-4,-86,-15,-11,-4,5,1,-2,3,1,3,4,7,-6,7,1,-2,3,1,1,-12,24,-1,-1,2,-5,0,-2,1,-1,-1,1,4,-1
KR_6718845597,420,-7,-110,-71,-10,-2,3,1,1,0,1,-10,13,3,4,1,5,-3,5,2,-1,0,-42,-4,0,4,17,0,0,-1,-1,-1,-1,1,-1
KR_6688935209,420,0,6,-24,7,0,2,2,4,0,4,1,1,2,2,3,5,0,1,1,-1,14,-4,3,-8,5,2,0,0,-1,1,0,-1,6,-1
KR_6140330218,420,-7,-44,-16,-18,-4,5,1,-9,10,1,-6,9,3,-1,1,0,2,1,3,0,-15,2,1,-5,4,2,0,-2,-1,0,-1,-1,2,-1
KR_6762475888,420,-3,-80,-5,-6,-2,2,0,-6,9,3,-1,4,3,5,1,6,-2,2,0,0,9,4,0,-1,1,-2,0,0,0,0,-1,1,0,-1
KR_6664427140,420,0,-34,22,-4,2,1,3,-3,4,1,-2,2,0,0,4,4,-1,1,0,-1,-9,1,0,-2,2,-1,0,0,-1,-1,0,-1,4,-1
KR_6568956775,420,-1,-44,-21,0,-2,2,0,1,2,3,-1,4,3,3,2,5,-1,1,0,-1,11,295,2,-2,0,4,0,-2,1,-1,-1,-1,6,-1
KR_6714438169,420,-4,-13,-16,-10,-2,5,3,-5,6,1,-3,5,2,-2,3,1,2,0,2,-2,-12,-24,2,-4,2,2,0,0,-1,-1,0,1,4,-1
KR_6748425567,440,-4,-51,30,-13,0,3,3,3,3,6,-10,10,0,-3,5,2,-3,3,0,0,-14,-11,3,-5,2,-1,0,-1,1,0,-1,-1,4,-1
KR_6725566545,420,-3,-15,15,-9,-1,1,0,-3,3,0,-2,3,1,2,3,5,-5,6,1,-1,-10,-10,-1,-3,4,-2,0,0,-1,0,0,-1,6,-1
KR_6755769573,420,-2,-59,-19,-4,-3,4,1,0,0,0,-1,2,1,-1,3,2,1,0,1,0,-4,-1,-1,-2,3,-2,0,0,1,0,0,-1,4,-1
KR_6653491026,420,-5,8,-14,-14,-6,7,1,-3,6,3,1,1,2,-3,5,2,-3,4,1,0,-14,-277,1,-4,3,4,0,-1,0,-1,-1,-1,0,-1
KR_6718476418,420,3,116,8,6,3,0,3,1,1,2,-2,2,0,5,0,5,-1,2,1,0,3,-513,2,-5,3,3,0,1,-1,0,1,1,3,-1
KR_6690905483,440,-2,-61,-14,3,-2,3,1,3,1,4,1,0,1,-3,4,1,4,0,4,0,4,-147,-2,-2,4,4,0,-1,0,-1,-1,-1,0,-1
KR_6747597371,420,-4,-79,0,-11,-6,6,0,-2,3,1,4,1,5,-7,8,1,0,0,0,0,-4,-6,-1,-3,4,-2,0,-2,-1,0,-1,-1,1,-1
KR_6711036814,420,-3,-13,-22,-10,0,0,0,-6,6,0,-5,5,0,0,4,4,1,2,3,0,-9,-3,-2,-3,5,-1,0,0,-1,-1,-1,1,1,-1
KR_6742876110,420,-8,-84,-48,-15,-3,3,0,-2,3,1,-2,2,0,-6,8,2,-2,3,1,0,-10,-173,1,-2,1,-1,0,-4,-1,-1,-1,-1,2,-1
KR_6585095135,420,0,-72,20,-2,-1,1,0,2,1,3,1,3,4,-3,4,1,-1,1,0,0,0,-1,-1,-5,6,-6,0,-1,1,-1,-1,-1,2,-1
KR_6753552040,440,1,61,-8,6,0,2,2,-2,5,3,-1,2,1,9,1,10,0,1,1,-1,3,1,1,-4,3,0,0,1,1,0,1,-1,3,-1
KR_6470671290,420,-5,-53,-1,-8,-1,3,2,2,0,2,-2,2,0,-3,4,1,-4,5,1,0,-5,-132,1,-4,3,-1,0,-2,-1,1,-1,-1,3,-1
KR_6712784480,420,-5,-54,-28,-2,-5,6,1,4,0,4,0,1,1,-1,3,2,0,1,1,0,5,-10,-1,-1,2,1,0,0,-1,0,-1,-1,1,-1
KR_6742879981,440,-7,-116,-20,1,-1,2,1,-3,4,1,1,2,3,2,3,5,2,1,3,0,-3,-20,-7,-1,8,1,0,-4,-1,-1,-1,1,5,-1
KR_6643550699,420,-5,-68,-15,-5,-2,3,1,-1,2,1,0,1,1,-2,6,4,0,1,1,0,-6,-6,2,-4,2,0,0,0,1,1,0,-1,6,-1
KR_6763694692,420,0,-75,-7,-4,0,0,0,-5,6,1,2,0,2,1,3,4,-2,2,0,0,-7,-17,-3,0,3,0,0,-1,-1,1,-1,-1,2,-1
KR_6742024568,440,-6,-43,-15,-17,-1,2,1,-9,10,1,0,5,5,-2,3,1,-5,7,2,-1,-14,1,-2,-2,4,4,0,-2,1,1,-1,-1,4,-1
KR_6512128282,420,-2,-38,28,3,6,1,7,0,3,3,-6,8,2,3,0,3,0,0,0,1,-7,-2,3,-5,2,2,0,0,1,1,1,-1,1,-1
KR_6257691723,420,0,3,-28,2,-1,2,1,3,0,3,1,1,2,-1,2,1,0,0,0,0,1,17,-1,-1,2,1,0,2,-1,-1,1,-1,5,-1
KR_6716939890,420,-2,-81,20,-3,1,0,1,0,2,2,1,3,4,-4,6,2,-1,2,1,0,-4,1,2,-4,2,-2,0,-2,0,-1,-1,1,0,-1
KR_6755389146,420,1,10,-12,-4,-3,3,0,-1,3,2,4,0,4,-2,2,0,-2,2,0,0,-6,109,-2,-2,4,2,0,0,-1,-1,0,-1,2,-1
KR_6679707734,420,-1,16,25,-10,-2,2,0,-1,9,8,-6,10,4,-4,7,3,3,0,3,1,-16,5,1,-3,2,-2,0,1,-1,1,1,-1,4,-1
KR_6755055673,420,-2,-26,5,-2,0,1,1,-3,4,1,5,0,5,-6,9,3,2,2,4,2,5,-4,-2,-1,3,2,0,0,-1,1,0,1,4,-1
KR_6681541129,420,-4,-79,1,-3,-6,9,3,-1,3,2,-1,3,2,2,4,6,3,1,4,0,7,23,2,-4,2,0,0,-1,-1,-1,-1,1,5,-1
KR_5913489583,420,-8,-142,-44,-12,-3,4,1,0,1,1,-1,2,1,-5,7,2,-3,3,0,-1,-5,1,3,-4,1,-7,0,-2,-1,0,-1,-1,3,-1
KR_6633898490,420,-4,-16,-4,-9,-3,3,0,-4,4,0,-5,6,1,0,3,3,3,1,4,0,-10,-2,-1,-3,4,1,0,1,-1,1,1,-1,1,-1
KR_6636087142,420,-5,-5,-14,-9,-2,2,0,-2,2,0,7,3,10,-11,13,2,-1,2,1,0,-10,-33,3,-4,1,13,0,0,-1,-1,0,1,6,-1
KR_6500027259,420,-1,-46,-17,3,1,3,4,3,0,3,0,2,2,-1,2,1,0,1,1,1,2,57,4,-5,1,2,0,0,1,-1,0,1,4,-1
KR_6717720367,420,-1,-49,16,-4,-4,5,1,0,2,2,0,2,2,0,2,2,0,0,0,0,-6,0,0,-2,2,-5,0,-1,1,1,-1,-1,3,-1
KR_6567803644,420,0,48,8,5,0,0,0,2,2,4,1,2,3,0,2,2,2,0,2,0,6,0,1,-3,2,1,0,0,-1,0,0,1,3,-1
KR_6720395153,420,-3,-24,-12,-6,-1,2,1,-3,6,3,5,0,5,-4,6,2,-3,3,0,0,-9,-2,1,-4,3,0,0,2,-1,1,1,1,2,-1
KR_6734576635,420,-6,-102,8,-11,-4,4,0,-5,7,2,-2,2,0,0,2,2,0,1,1,0,-8,-26,-2,-3,5,-3,0,-2,-1,-1,-1,-1,1,-1
KR_6607339769,440,-3,-64,-40,2,-1,3,2,3,0,3,-5,5,0,3,0,3,2,1,3,0,3,-105,1,-6,5,-1,0,1,-1,1,1,-1,1,-1
KR_6733855411,440,-3,9,-16,-7,-4,4,0,0,4,4,-1,3,2,-2,5,3,0,0,0,0,-7,284,0,-2,2,2,0,-1,1,-1,-1,-1,5,-1
KR_6693508848,420,-4,-50,-5,-9,-5,5,0,-3,4,1,1,0,1,-3,3,0,1,1,2,0,-2,14,-4,0,4,-3,0,-1,-1,0,-1,-1,3,-1
KR_6761921532,420,-3,-13,-16,-8,1,0,1,-5,6,1,1,4,5,-2,3,1,-3,4,1,1,-11,-2,1,-1,0,-1,0,-1,1,0,-1,1,3,-1
KR_6720426526,420,-3,18,-23,-6,0,1,1,-1,1,0,-5,5,0,0,1,1,0,1,1,0,-5,8,0,-2,2,-2,0,0,-1,-1,0,-1,2,-1
KR_6746138019,440,5,76,22,4,3,2,5,-2,3,1,4,1,5,-1,2,1,0,0,0,0,-3,115,-2,-5,7,-1,0,4,1,1,1,-1,1,-1
KR_6650307342,420,-2,-7,-8,-12,0,2,2,-1,1,0,0,3,3,-8,8,0,-3,3,0,0,-15,-12,3,-8,5,-2,0,-1,-1,1,-1,-1,3,-1
KR_6567970391,420,0,-24,-6,2,0,2,2,1,2,3,0,2,2,0,0,0,1,0,1,0,8,-49,-1,-2,3,27,0,-1,-1,0,-1,1,4,-1
KR_6634576548,420,2,-48,-20,0,0,0,0,5,0,5,0,0,0,-3,4,1,-2,2,0,0,0,-6,-3,-2,5,2,0,-2,0,1,-1,1,0,-1
KR_6742147686,440,-3,-42,-8,6,-2,4,2,0,1,1,3,0,3,6,6,12,-1,1,0,5,14,-16,-4,-2,6,3,0,-1,-1,-1,-1,1,1,-1
KR_6712443007,420,-4,-20,-25,-2,2,1,3,7,1,8,-1,2,1,-7,8,1,-3,3,0,0,-2,221,0,-2,2,-1,0,0,1,-1,-1,-1,5,-1
KR_6760946931,440,0,3,-22,2,5,1,6,-8,8,0,-1,1,0,4,1,5,2,2,4,0,-3,-12,-4,-1,5,2,0,-2,-1,1,-1,1,2,-1
KR_6760847431,420,0,62,0,3,1,1,2,1,1,2,-2,4,2,2,0,2,1,1,2,0,2,0,1,-4,3,-2,0,1,0,1,1,-1,0,-1
KR_6677191777,420,0,-43,-23,-4,1,1,2,-2,2,0,-3,4,1,0,1,1,0,1,1,0,3,-5,1,-4,3,0,0,-1,1,-1,-1,1,6,-1
KR_6667882441,420,-2,-4,-8,3,-3,3,0,3,0,3,1,4,5,1,0,1,1,1,2,-2,1,-2,5,-5,0,0,0,-1,1,-1,-1,-1,3,-1
KR_6726020604,420,-1,-36,0,1,-4,5,1,-3,4,1,5,1,6,4,0,4,-1,1,0,0,0,1,2,-4,2,0,0,0,1,0,0,-1,5,-1
KR_6654306475,420,-2,-55,8,-5,-1,2,1,3,0,3,-4,4,0,-2,3,1,-1,1,0,0,-2,-1,0,-3,3,-5,0,0,-1,-1,-1,-1,1,-1
KR_6716536373,440,1,144,32,-4,-1,3,2,3,1,4,3,2,5,-8,8,0,-1,5,4,0,-12,0,-2,-4,6,2,0,1,1,1,1,-1,4,-1
KR_6750661809,420,-5,-82,-11,-6,1,1,2,-2,2,0,-1,4,3,-2,3,1,-2,3,1,0,-4,97,-2,-1,3,2,0,-2,-1,-1,-1,1,6,-1
KR_6749973446,420,-1,-16,41,-9,-4,4,0,-3,4,1,2,5,7,-4,4,0,0,0,0,0,-9,-336,1,-3,2,3,0,-1,-1,-1,-1,-1,5,-1
KR_6496403488,420,-9,-41,-65,-25,0,2,2,-17,17,0,-2,5,3,-4,4,0,-2,3,1,0,-14,-48,-4,-3,7,0,0,-3,0,-1,-1,1,0,-1
KR_6718712551,420,-8,-109,-39,-24,-12,12,0,-2,3,1,-7,8,1,-3,4,1,0,0,0,0,-7,47,4,-4,0,-11,0,-4,0,-1,-1,-1,0,-1
KR_6505078150,420,-1,-43,13,-7,-2,4,2,-1,4,3,1,0,1,-5,7,2,0,0,0,0,-12,-51,-2,-7,9,28,0,-1,1,1,-1,1,4,-1
KR_6723738422,420,-9,-121,8,-15,-3,3,0,-1,2,1,-5,6,1,-3,3,0,-3,3,0,0,-10,5,-4,-2,6,1,0,-3,-1,-1,-1,-1,1,-1
KR_6704459343,420,-1,38,6,-5,-7,7,0,1,2,3,-3,4,1,2,4,6,2,1,3,0,0,290,2,-5,3,0,0,-1,1,-1,-1,-1,6,-1
KR_6729169773,420,-5,-77,-11,-6,-2,6,4,3,3,6,-2,2,0,-3,5,2,-2,4,2,-1,-1,-6,3,-5,2,2,0,-2,-1,0,-1,-1,5,-1
KR_6697852848,420,-3,-50,1,-6,-6,8,2,2,0,2,3,1,4,-5,6,1,0,1,1,1,-8,-28,2,-3,1,1,0,-1,-1,1,-1,1,3,-1
KR_6320981926,420,-2,-9,4,-2,3,1,4,-4,5,1,0,3,3,-1,2,1,0,0,0,0,-5,-17,2,-6,4,4,0,0,-1,1,1,1,4,-1
KR_6672586824,420,1,-37,12,-4,0,2,2,-5,6,1,4,0,4,-4,4,0,1,0,1,0,0,-340,-2,-3,5,-4,0,0,-1,1,1,1,6,-1
KR_6749393243,440,0,11,1,4,0,1,1,4,1,5,-7,9,2,3,0,3,4,1,5,0,12,-232,-3,-2,5,5,0,-1,0,0,-1,-1,0,-1
KR_6693866615,420,2,11,-28,3,-1,2,1,-1,2,1,5,0,5,0,0,0,0,2,2,0,8,-5,-2,0,2,3,0,1,-1,-1,1,1,2,-1
KR_6746443603,420,4,64,33,15,0,2,2,5,3,8,7,0,7,1,0,1,2,2,4,0,6,-4,-4,-1,5,2,0,1,-1,1,1,1,1,-1
KR_6735544026,440,-4,-146,-20,-8,1,1,2,1,2,3,-3,6,3,-5,8,3,-2,2,0,-1,-11,-62,-6,-2,8,35,0,-1,0,-1,-1,-1,0,-1
KR_6723843674,420,1,-9,0,1,5,0,5,-4,5,1,1,3,4,-3,3,0,2,0,2,-1,-10,-18,0,-3,3,-2,0,1,0,0,1,-1,0,-1
KR_6731311752,420,-8,-67,-24,-15,-2,5,3,-5,5,0,0,2,2,-7,8,1,-1,1,0,-1,-18,96,3,-8,5,-2,0,-2,-1,-1,-1,-1,4,-1
KR_6617773079,420,-1,-4,0,1,0,3,3,-2,6,4,1,2,3,6,3,9,-4,5,1,2,5,-9,1,-5,4,0,0,1,1,-1,1,1,3,-1
KR_6571131358,420,-6,-36,13,-15,-2,3,1,-5,7,2,-2,5,3,-6,8,2,0,0,0,0,-15,-1,1,-4,3,-6,0,0,-1,0,-1,1,5,-1
KR_6689728179,440,-2,36,-20,3,-5,6,1,-1,4,3,0,1,1,4,0,4,5,0,5,0,10,-3,0,-6,6,5,0,0,1,-1,1,-1,6,-1
KR_6747817681,440,-2,2,-1,-6,-4,5,1,0,1,1,1,4,5,-1,2,1,-2,2,0,0,-4,-42,1,-3,2,21,0,0,-1,0,-1,-1,2,-1
KR_6327953625,420,-4,-72,-40,-10,1,1,2,1,4,5,-2,2,0,-7,7,0,-3,3,0,0,-16,-25,-2,-3,5,1,0,-1,-1,-1,-1,-1,6,-1
KR_6613847526,440,-3,-10,-19,-12,2,1,3,-5,5,0,1,2,3,-7,9,2,-3,3,0,0,-19,-27,-3,0,3,1,0,-2,-1,-1,-1,-1,1,-1
KR_6754559631,420,-2,2,16,-9,-3,5,2,-1,1,0,-8,13,5,3,0,3,0,1,1,-2,-4,4,0,-3,3,-1,0,-2,-1,-1,-1,-1,5,-1
KR_6763354919,440,2,54,4,-5,0,3,3,-1,4,3,5,1,6,-9,9,0,0,2,2,1,-12,-102,-1,-4,5,4,0,2,-1,1,1,1,4,-1
KR_6589421862,420,-6,-79,-9,-4,-1,4,3,2,2,4,0,3,3,-4,5,1,-1,3,2,-1,-3,-10,-2,-3,5,3,0,0,1,-1,1,-1,4,-1
KR_6617680186,420,-3,-86,-28,-5,-3,7,4,0,4,4,0,2,2,1,3,4,-3,4,1,0,-1,-12,1,-3,2,-2,0,-1,-1,1,-1,1,1,-1
KR_6724935816,420,-1,-65,-6,-5,2,1,3,1,5,6,-1,4,3,-6,11,5,-1,1,0,-2,-12,8,2,-8,6,-4,0,-1,-1,1,1,-1,3,-1
KR_6764691287,420,-6,-101,-36,-17,-1,3,2,1,1,2,-4,4,0,-5,5,0,-8,8,0,0,-15,0,-1,-3,4,2,0,-2,-1,1,-1,-1,5,-1
KR_6630635068,420,-4,-59,-32,-6,-2,3,1,-7,8,1,1,2,3,1,2,3,1,0,1,0,-5,-283,2,-4,2,-1,0,-2,-1,-1,-1,-1,4,-1
KR_6624626150,420,1,-129,-4,-1,-2,3,1,0,2,2,1,0,1,-1,4,3,1,1,2,0,-4,-21,-1,-2,3,-1,0,0,1,-1,0,-1,1,-1
KR_6715784764,420,2,13,20,6,-1,1,0,-6,6,0,4,0,4,8,0,8,1,2,3,1,9,10,-2,-3,5,-1,0,0,1,1,0,1,1,-1
KR_6560594176,420,-4,-35,-5,-10,-4,6,2,-3,5,2,-2,3,1,-3,6,3,2,2,4,-1,-12,0,2,-5,3,-1,0,1,-1,-1,1,1,3,-1
KR_6682981271,420,-2,-47,-24,-14,-7,7,0,1,3,4,-3,4,1,-5,7,2,0,2,2,0,-16,-1,3,-4,1,-1,0,0,-1,0,0,-1,2,-1
KR_6761521208,420,-3,10,-4,-10,-2,2,0,-1,1,0,0,5,5,-3,3,0,-4,4,0,0,-8,3,0,-4,4,2,0,1,-1,0,1,1,2,-1
KR_6622841694,420,-1,-98,-78,-4,0,1,1,-3,4,1,2,0,2,-3,3,0,0,1,1,0,-1,-9,-1,-5,6,1,0,-1,-1,-1,-1,-1,1,-1
KR_6593109093,420,-3,-58,-28,-7,-5,6,1,0,5,5,-3,4,1,-2,6,4,3,2,5,-1,4,-2,2,-4,2,-4,0,-1,-1,-1,-1,1,2,-1
KR_6582295534,420,-1,-28,-45,4,5,0,5,1,4,5,-3,3,0,1,2,3,0,1,1,0,6,0,1,-7,6,-5,0,0,-1,-1,0,1,3,-1
KR_6516013973,420,-1,57,12,-4,3,2,5,-3,4,1,-7,8,1,4,2,6,-1,1,0,0,-3,-3,-2,-2,4,1,0,0,1,1,1,-1,1,-1
KR_6105823274,420,-2,-93,4,-6,2,0,2,-4,5,1,-6,8,2,0,3,3,2,0,2,0,-1,35,0,-2,2,-23,0,0,1,-1,-1,-1,4,-1
KR_6763926820,420,-1,-51,-27,-6,-1,4,3,1,0,1,3,0,3,-1,3,2,-8,10,2,-1,-6,-30,-1,-1,2,22,0,0,-1,0,1,-1,1,-1
KR_6740092132,420,-3,-43,23,-7,-2,2,0,0,3,3,0,0,0,-5,6,1,0,0,0,0,-9,-16,3,-6,3,-3,0,-1,1,1,-1,1,6,-1
KR_6615917908,420,-2,-26,-12,-8,-1,1,0,-4,6,2,0,1,1,-1,4,3,-2,4,2,0,-10,-3,0,-1,1,-1,0,0,-1,0,-1,1,1,-1
KR_6638077000,420,1,30,21,5,0,1,1,0,3,3,-5,7,2,7,0,7,3,0,3,0,0,10,-2,-1,3,-1,0,1,1,0,1,1,4,-1
KR_6761525965,440,-1,24,-27,-10,5,0,5,-6,8,2,-1,1,0,-4,5,1,-4,4,0,0,-15,-28,-3,0,3,0,0,1,0,0,1,-1,0,-1
KR_6727144415,420,0,22,-25,0,2,0,2,-2,4,2,0,1,1,0,6,6,0,2,2,1,-4,0,4,-5,1,-1,0,0,-1,-1,1,1,2,-1
KR_6693391611,440,-3,-56,-8,-4,1,3,4,-1,4,3,1,2,3,-4,8,4,-1,2,1,0,-10,-7,-5,-1,6,2,0,0,0,0,0,-1,0,-1
KR_6761963028,420,0,-18,20,2,0,0,0,-5,9,4,5,0,5,2,1,3,0,1,1,0,1,-100,-1,-5,6,-7,0,0,1,0,0,1,6,-1
KR_6751900596,440,-6,-68,-40,-7,-1,3,2,-6,7,1,-2,4,2,0,3,3,2,2,4,0,-6,-3,0,-1,1,-1,0,-2,-1,-1,-1,-1,6,-1
KR_6645722468,420,3,-13,4,5,-1,2,1,-2,6,4,-3,3,0,6,0,6,5,1,6,0,9,11,2,-4,2,-1,0,0,0,0,1,-1,0,-1
KR_6571093137,420,-3,22,-12,-3,-2,2,0,-2,2,0,-1,2,1,0,4,4,2,1,3,0,2,-126,0,-5,5,1,0,-1,-1,-1,-1,-1,6,-1
KR_6762144393,420,1,47,7,3,2,1,3,1,3,4,3,0,3,-2,3,1,-1,3,2,0,-7,40,4,-7,3,-6,0,0,-1,1,1,-1,5,-1
KR_6710020602,420,-1,-89,-12,1,3,0,3,-7,8,1,7,3,10,-1,3,2,-1,3,2,1,6,-2,4,-7,3,-5,0,-2,-1,1,-1,1,2,-1
KR_6726349579,420,-3,-33,-16,-3,0,2,2,-1,2,1,-1,1,0,-1,2,1,0,1,1,0,-4,-8,-4,-2,6,-2,0,0,-1,-1,0,1,4,-1
KR_6744068956,420,0,-15,0,0,2,0,2,4,1,5,-3,4,1,-2,5,3,-1,1,0,0,1,5,-3,-5,8,-2,0,1,-1,-1,1,-1,4,-1
KR_6727437371,420,2,-60,32,5,-1,1,0,2,3,5,1,1,2,3,3,6,0,1,1,0,6,5,3,-4,1,0,0,-1,-1,-1,-1,1,6,-1
KR_6760069044,420,0,-30,24,-1,0,2,2,1,1,2,-4,4,0,2,3,5,0,1,1,0,-1,-3,-4,-1,5,-5,0,0,1,1,0,1,6,-1
KR_6763223369,420,1,4,3,-1,-2,2,0,1,1,2,1,4,5,-1,1,0,0,0,0,0,-1,0,0,-1,1,-2,0,0,-1,0,0,1,6,-1
KR_6609329484,420,-1,-30,-15,-2,0,2,2,-6,6,0,-2,4,2,6,1,7,0,0,0,0,0,8,-1,-4,5,5,0,-1,-1,-1,-1,1,4,-1
KR_6742267798,420,-1,-11,-20,-2,5,0,5,-4,7,3,-1,4,3,-1,1,0,-1,1,0,0,-10,0,2,-4,2,2,0,1,-1,0,1,1,4,-1
KR_6471608434,420,-2,-12,-42,-1,-1,2,1,2,4,6,-1,3,2,-2,3,1,1,2,3,0,2,-9,4,-5,1,-1,0,-1,-1,1,-1,1,5,-1
KR_6757392551,440,-4,-66,4,-10,-2,3,1,-5,5,0,-1,1,0,-3,4,1,1,1,2,-1,-9,-2,3,-5,2,0,0,-1,0,1,-1,-1,0,-1
KR_6622792913,440,0,10,5,1,1,0,1,4,1,5,-2,2,0,-2,2,0,0,0,0,-1,-4,-6,-1,-2,3,1,0,0,-1,1,1,-1,2,-1
KR_6747714414,420,-5,-7,-27,-13,-5,5,0,-6,6,0,-1,3,2,-1,3,2,0,0,0,0,-8,32,0,-3,3,-16,0,0,-1,0,0,-1,6,-1
KR_6759318233,420,-3,-62,-20,-3,1,0,1,-2,2,0,0,5,5,-1,3,2,-1,1,0,0,-3,17,-4,-4,8,3,0,0,0,0,0,1,0,-1
KR_6733552142,420,-7,-65,-39,-20,-7,9,2,-5,5,0,-5,7,2,0,6,6,-3,4,1,0,-18,-2,2,-6,4,-3,0,-2,-1,-1,-1,1,2,-1
KR_6722339583,420,-6,-203,16,-16,-3,3,0,1,0,1,-10,10,0,-4,5,1,0,1,1,0,-13,-14,-3,0,3,0,0,-3,-1,-1,-1,-1,6,-1
KR_6752806893,420,-4,-21,-44,-7,-3,4,1,-4,4,0,0,2,2,-1,4,3,1,4,5,0,-2,5,1,-2,1,1,0,0,-1,-1,0,-1,2,-1
KR_6648806412,420,-1,-1,4,-5,-1,3,2,-4,7,3,-2,3,1,1,1,2,1,1,2,-1,-3,-5,-4,-2,6,1,0,0,-1,1,0,-1,2,-1
KR_6583604368,420,0,-62,-4,-4,3,1,4,-6,6,0,2,0,2,-2,5,3,-1,1,0,0,-7,-6,-1,-2,3,0,0,-1,0,1,-1,-1,0,-1
KR_6587601511,420,-4,-20,-102,-4,-1,3,2,1,2,3,0,0,0,-1,3,2,-3,3,0,0,-3,-30,3,-4,1,12,0,1,-1,-1,-1,-1,3,-1
KR_6474964560,420,-8,-114,3,-26,-7,7,0,-10,11,1,-5,5,0,-3,5,2,-1,1,0,0,-21,-3,-4,0,4,1,0,-3,1,-1,-1,-1,5,-1
KR_5999750828,420,-8,-15,-11,-15,0,1,1,-2,3,1,-5,6,1,-6,8,2,-2,2,0,0,-22,-58,0,-5,5,-3,0,-2,-1,0,-1,-1,1,-1
KR_6625238444,420,0,-16,-19,-3,-7,9,2,0,1,1,4,1,5,-5,7,2,5,0,5,0,0,5,6,-7,1,-3,0,0,-1,-1,0,-1,5,-1
KR_6428300675,440,1,20,18,6,0,1,1,-3,5,2,-1,1,0,7,0,7,3,0,3,0,10,-7,-2,-3,5,-1,0,0,0,1,0,-1,0,-1
KR_6746815936,420,-5,-63,-24,-7,-2,3,1,-4,4,0,-4,4,0,3,0,3,0,0,0,0,0,9,-2,-1,3,0,0,-1,-1,-1,-1,1,4,-1
KR_6658649099,420,-3,-44,-15,-12,-5,6,1,-2,7,5,-2,2,0,0,1,1,-3,3,0,0,-12,2,0,-4,4,0,0,-1,-1,1,-1,1,5,-1
KR_6529662173,420,2,-20,28,7,3,0,3,2,2,4,0,1,1,0,3,3,2,0,2,0,8,-3,0,-4,4,-2,0,0,1,0,0,1,6,-1
KR_6550668269,440,-4,-10,-44,-7,2,1,3,-4,5,1,-1,1,0,-1,3,2,-3,4,1,0,-1,32,-4,-1,5,1,0,-1,-1,-1,-1,-1,4,-1
KR_6759712818,420,2,-7,-16,7,-3,3,0,0,2,2,0,5,5,6,0,6,4,0,4,0,14,18,-1,-2,3,3,0,0,1,-1,0,-1,6,-1
KR_6678153782,420,2,41,5,-3,2,0,2,-2,3,1,-2,5,3,-3,4,1,2,0,2,1,-4,-4,4,-8,4,4,0,0,0,1,0,1,0,-1
KR_6711912668,420,-2,-26,-5,-9,1,2,3,0,3,3,0,1,1,-2,3,1,-8,8,0,0,-10,-144,2,-4,2,-2,0,-1,-1,1,-1,-1,6,-1
KR_6752852103,420,-4,-29,-11,-11,-2,3,1,-5,5,0,-4,5,1,-3,3,0,3,1,4,0,-5,1,-1,-1,2,1,0,-3,-1,-1,-1,-1,3,-1
KR_6720459441,420,1,-28,-4,3,5,0,5,1,2,3,-3,4,1,0,1,1,0,2,2,0,5,-13,3,-4,1,-2,0,-1,0,-1,-1,-1,0,-1
KR_6760929777,420,-2,-14,-12,1,-5,6,1,-1,2,1,1,3,4,1,1,2,5,0,5,0,4,3,0,0,0,-1,0,1,-1,-1,1,1,4,-1
KR_6695227549,420,0,9,-1,-6,-2,2,0,3,4,7,0,4,4,-2,5,3,-5,5,0,-2,-8,3,-3,-5,8,-1,0,0,1,-1,-1,-1,1,-1
KR_6761356448,420,-6,-137,-32,-17,-5,6,1,-1,1,0,-3,6,3,-1,1,0,-7,9,2,-1,-7,128,-2,0,2,1,0,-3,-1,0,-1,-1,1,-1
KR_6548565501,420,2,33,0,-1,2,1,3,-3,6,3,4,0,4,-1,4,3,-3,3,0,0,-6,18,-1,-6,7,6,0,0,-1,1,0,-1,1,-1
KR_6758619559,420,-3,35,1,-11,2,2,4,-5,5,0,-1,1,0,-4,4,0,-3,4,1,0,-19,1,1,-4,3,-6,0,0,-1,0,0,-1,5,-1
KR_6108597283,440,-4,-40,7,-11,-2,2,0,-1,1,0,-6,6,0,-4,5,1,2,0,2,0,0,110,-3,-3,6,-3,0,0,-1,0,0,-1,2,-1
KR_6608558678,420,2,79,-2,6,1,2,3,0,4,4,-5,6,1,5,1,6,5,0,5,0,5,48,-2,-3,5,-20,0,2,1,1,1,1,4,-1
KR_6519625596,420,1,13,27,2,3,1,4,-2,3,1,1,0,1,1,1,2,-1,1,0,0,-1,1,1,-2,1,0,0,-1,-1,-1,-1,1,1,-1
KR_6575437598,420,0,23,11,5,5,0,5,-1,2,1,-1,3,2,-1,1,0,3,0,3,0,2,-45,0,-2,2,23,0,1,-1,1,1,1,4,-1
KR_6720081347,420,-1,-24,-20,1,2,0,2,2,1,3,-1,2,1,-3,5,2,1,0,1,0,-3,-30,4,-5,1,-3,0,0,-1,1,1,1,5,-1
KR_6609772662,420,-1,-3,-4,-4,-3,4,1,4,0,4,2,1,3,-4,10,6,-3,3,0,0,0,17,3,-6,3,-4,0,-2,-1,-1,-1,-1,4,-1
KR_6590447691,420,3,15,8,2,2,0,2,1,3,4,-3,5,2,2,1,3,0,1,1,0,6,39,-2,-2,4,-20,0,0,-1,1,0,-1,3,-1
KR_6759040503,420,3,3,-6,1,4,2,6,1,4,5,-3,4,1,-2,3,1,1,1,2,0,-5,2,-2,-1,3,2,0,0,-1,1,1,-1,5,-1
KR_6622576650,420,-5,-39,-16,-9,-1,3,2,-2,3,1,0,1,1,-3,3,0,-3,3,0,1,-10,-4,0,-3,3,-6,0,0,-1,1,-1,1,4,-1
KR_6757656653,440,-3,3,0,-4,-3,3,0,3,7,10,-2,4,2,-2,3,1,0,0,0,0,-4,14,-1,-6,7,-2,0,1,-1,1,1,1,6,-1
KR_6712420288,420,-1,0,-31,-5,-3,3,0,-3,4,1,1,0,1,0,4,4,0,4,4,0,-4,207,1,-4,3,6,0,0,-1,1,0,1,1,-1
KR_6665395209,420,-3,-130,20,-7,-5,5,0,-10,11,1,-2,3,1,7,1,8,3,3,6,0,-1,1,0,-2,2,0,0,0,-1,0,-1,-1,4,-1
KR_6628072367,420,-5,-98,16,-9,-3,5,2,1,2,3,-6,6,0,-1,3,2,0,1,1,0,-2,50,-1,-2,3,-4,0,-2,0,-1,-1,-1,0,-1
KR_6764158310,420,2,31,1,5,-1,2,1,1,1,2,-2,2,0,5,0,5,2,0,2,0,7,217,1,-7,6,4,0,1,1,-1,1,1,4,-1
KR_6733463062,440,3,53,24,2,2,2,4,-3,6,3,1,1,2,6,2,8,-4,4,0,1,0,-2,0,-4,4,1,0,2,-1,1,1,1,2,-1
KR_6754916084,420,-1,37,16,-3,-1,2,1,1,0,1,-2,4,2,0,2,2,-1,5,4,0,6,36,3,-5,2,1,0,-1,1,1,1,1,4,-1
KR_6698322599,420,-3,-90,-31,-6,-8,8,0,-3,4,1,0,1,1,5,2,7,0,0,0,0,5,2,2,-5,3,0,0,0,0,-1,-1,-1,0,-1
KR_6754133118,420,1,-53,-13,-1,0,0,0,0,4,4,-1,4,3,0,0,0,0,0,0,0,5,-2,-3,-4,7,2,0,0,0,-1,-1,-1,0,-1
KR_6669122340,420,-4,-34,0,-6,-3,3,0,2,2,4,-4,6,2,-1,3,2,0,1,1,0,3,-1,1,-5,4,-3,0,-1,-1,0,-1,-1,3,-1
KR_6677077969,420,0,-28,36,6,0,0,0,-1,3,2,-1,1,0,6,2,8,2,0,2,1,11,-2,1,-4,3,-1,0,0,-1,1,1,1,3,-1
KR_6739798284,420,1,-42,16,2,-1,1,0,3,1,4,-3,4,1,3,0,3,0,1,1,0,3,3,-3,-2,5,2,0,0,-1,0,0,-1,2,-1
KR_6620154658,420,-2,-27,-20,2,-4,4,0,7,1,8,1,2,3,-2,4,2,0,1,1,0,2,-1,3,-4,1,1,0,-1,0,-1,-1,1,0,-1
KR_6739240266,420,0,-20,-5,10,-1,5,4,6,2,8,-1,2,1,7,2,9,-1,2,1,-1,22,4,0,-6,6,0,0,1,1,-1,1,-1,6,-1
KR_6618047261,420,-1,-39,5,0,2,3,5,3,1,4,-2,2,0,0,0,0,-3,3,0,0,1,-49,2,-5,3,22,0,-1,0,-1,-1,-1,0,-1
KR_6603222036,420,0,-17,1,-5,2,1,3,-3,4,1,2,1,3,-5,5,0,-1,1,0,0,-10,-3,-1,-4,5,1,0,-1,0,-1,-1,1,0,-1
KR_6754786357,420,-3,-31,6,-12,-3,5,2,-5,5,0,-1,3,2,-2,2,0,-1,1,0,-1,-8,-92,-1,-3,4,0,0,-3,0,-1,-1,-1,0,-1
KR_6762305628,420,-6,-8,-20,-19,-3,3,0,-3,5,2,-4,4,0,-6,6,0,-3,3,0,0,-21,-20,-3,-2,5,1,0,-2,-1,0,-1,-1,5,-1
KR_6355711847,440,-2,-25,14,-4,0,2,2,0,1,1,-1,5,4,-2,4,2,-1,1,0,0,1,0,0,0,0,-2,0,1,1,1,1,-1,2,-1
KR_6748191893,420,3,35,49,10,7,0,7,2,3,5,3,0,3,-2,3,1,0,1,1,0,-3,121,3,-4,1,2,0,3,1,0,1,1,6,-1
KR_6739148209,420,-9,-118,-73,-18,-2,2,0,-6,7,1,-8,9,1,-1,3,2,-1,3,2,0,-15,96,-4,-4,8,2,0,-2,-1,-1,-1,-1,6,-1
KR_6689599001,420,-3,-50,-3,-7,0,1,1,-3,5,2,1,0,1,-1,3,2,-4,4,0,0,-9,3,2,-5,3,-3,0,-1,-1,0,-1,-1,5,-1
KR_6695615192,440,0,-79,18,2,-3,4,1,-3,5,2,-3,3,0,2,4,6,9,3,12,-1,5,1,-5,-1,6,0,0,-1,-1,1,-1,-1,5,-1
KR_6423089611,420,-1,8,36,2,0,1,1,2,4,6,-3,4,1,0,4,4,3,0,3,2,5,1,2,-6,4,-3,0,0,1,1,0,1,6,-1
KR_6764203708,420,-2,46,-40,-6,2,0,2,-4,4,0,1,2,3,-8,9,1,3,1,4,0,-5,22,1,-1,0,1,0,0,-1,-1,-1,-1,4,-1
KR_6688958065,420,-2,-52,0,-6,-2,2,0,2,2,4,-1,2,1,-4,4,0,-1,1,0,-2,-1,-15,-4,-3,7,5,0,-1,-1,0,-1,-1,5,-1
KR_6591077377,420,-9,-129,-43,-23,-8,8,0,-2,3,1,-2,2,0,-12,13,1,1,1,2,0,-13,-3,0,-5,5,-4,0,-2,-1,1,-1,-1,1,-1
KR_6422686887,420,-4,-61,6,-4,-4,4,0,1,3,4,-5,5,0,3,1,4,1,0,1,0,0,-6,-2,-4,6,-2,0,-1,-1,1,-1,-1,1,-1
KR_6735267676,420,-1,-12,10,-4,-1,3,2,-3,5,2,1,2,3,-2,6,4,1,0,1,0,-6,-6,4,-8,4,-7,0,-1,-1,1,-1,-1,6,-1
KR_6753496367,440,-6,-72,12,-13,0,3,3,-6,7,1,-2,4,2,-2,2,0,-3,3,0,1,-17,1,-1,-1,2,1,0,-1,-1,1,1,1,1,-1
KR_6764204809,420,-1,22,0,-9,0,0,0,-6,9,3,-2,4,2,-2,2,0,1,0,1,0,-17,-3,0,-3,3,1,0,0,-1,-1,0,-1,6,-1
KR_6589551749,420,-6,-39,-20,-7,-5,5,0,2,5,7,-3,5,2,-1,5,4,0,2,2,0,-6,4,6,-8,2,0,0,-1,1,-1,-1,-1,6,-1
KR_6754156244,420,2,39,16,5,1,1,2,-1,2,1,1,3,4,2,1,3,2,0,2,-1,0,5,-1,-1,2,-1,0,0,1,1,0,-1,4,-1
KR_6646042204,420,-1,-9,0,-5,-1,2,1,0,3,3,-3,3,0,-1,3,2,0,1,1,0,-4,1,-2,-2,4,-3,0,-1,-1,1,1,1,3,-1
KR_6743437938,420,-4,-16,-17,-9,-4,4,0,0,2,2,-7,7,0,-2,5,3,4,0,4,-1,-1,-3,-2,-2,4,5,0,-2,0,-1,-1,-1,0,-1
KR_6689450934,420,-6,-91,-40,-20,-3,5,2,-10,13,3,-2,4,2,-4,5,1,-1,1,0,0,-29,-13,-5,-1,6,-1,0,-2,0,0,-1,-1,0,-1
KR_6729515421,440,-4,-61,-4,-13,-6,7,1,1,2,3,-6,7,1,2,3,5,-4,4,0,-1,-9,9,-1,-6,7,-7,0,-3,1,-1,-1,-1,5,-1
KR_6762124690,420,0,-4,-28,2,4,0,4,2,0,2,0,1,1,-3,3,0,-1,1,0,0,0,-13,-1,-3,4,1,0,0,-1,1,1,-1,3,-1
KR_6618865167,420,2,68,-12,4,1,2,3,2,2,4,-3,5,2,2,5,7,2,0,2,-2,8,6,1,-3,2,0,0,1,1,0,1,-1,1,-1
KR_6759398577,420,-1,26,4,-5,-1,5,4,2,0,2,1,1,2,-4,5,1,-3,3,0,-1,-6,-3,0,-1,1,-5,0,-1,-1,-1,-1,-1,3,-1
KR_6727725618,440,-3,-44,20,-2,-1,1,0,0,1,1,-2,3,1,-2,3,1,3,1,4,0,-1,-7,-4,-1,5,0,0,0,1,-1,0,1,2,-1
KR_6764088357,420,-5,-61,20,-13,-2,5,3,1,0,1,-10,10,0,-1,4,3,-1,3,2,0,-3,16,2,-5,3,-3,0,-1,-1,-1,-1,-1,3,-1
KR_6602465505,420,-1,-100,23,-4,2,1,3,-6,9,3,3,3,6,-2,2,0,-1,2,1,-1,-12,29,-4,-1,5,-1,0,-1,1,1,-1,-1,2,-1
KR_6746512386,440,1,29,-28,2,3,0,3,-2,4,2,2,1,3,-1,4,3,0,1,1,0,3,-45,2,-3,1,32,0,1,-1,-1,1,1,6,-1
KR_6666673536,420,0,39,-4,1,3,1,4,-1,1,0,0,1,1,0,1,1,-1,1,0,0,4,355,1,-2,1,1,0,0,-1,1,1,1,4,-1
KR_6711774915,420,-2,-32,-26,1,-3,6,3,2,2,4,0,3,3,3,1,4,-1,2,1,0,5,0,4,-5,1,-1,0,-2,-1,-1,-1,-1,2,-1
KR_6706041868,420,-2,-7,-20,-8,-2,2,0,-1,1,0,-3,5,2,-2,3,1,0,1,1,0,-5,-11,2,-5,3,5,0,1,0,1,1,-1,0,-1
KR_6728461669,420,-2,-22,-13,4,-3,3,0,5,0,5,2,1,3,2,0,2,-2,2,0,0,7,-111,5,-7,2,3,0,1,1,1,1,1,2,-1
KR_6757950258,420,-1,19,44,1,0,1,1,2,1,3,2,2,4,-3,5,2,0,1,1,2,-10,-266,1,-1,0,-3,0,0,-1,-1,1,1,6,-1
KR_6732464212,440,-3,-55,0,0,1,1,2,-3,3,0,3,0,3,-2,2,0,1,0,1,0,2,-12,-4,-1,5,-2,0,-1,-1,-1,-1,1,4,-1
KR_6258927298,440,-4,-116,-18,-4,1,2,3,1,4,5,-1,4,3,-4,5,1,-1,1,0,0,6,-1,-4,-4,8,-3,0,0,0,0,-1,-1,0,-1
KR_6552916286,420,-1,58,-9,-5,-2,5,3,0,1,1,2,2,4,-5,5,0,0,2,2,0,-9,20,3,-5,2,1,0,1,-1,1,1,-1,1,-1
KR_6594772335,440,-6,-74,-12,-15,-1,2,1,-3,6,3,-4,6,2,-4,5,1,-3,3,0,0,-14,-11,-1,-2,3,-3,0,-1,-1,-1,-1,-1,4,-1
KR_6700275142,440,-8,-49,-4,-21,-3,4,1,-6,10,4,2,1,3,-11,11,0,-3,4,1,0,-15,1,5,-8,3,-3,0,-4,-1,-1,-1,-1,6,-1
KR_6727443116,420,-6,-92,-28,-9,-1,2,1,-3,3,0,-1,4,3,-5,5,0,1,0,1,0,-6,-334,-1,0,1,-1,0,-1,-1,-1,-1,-1,3,-1
KR_6758001177,420,-2,-47,-3,-1,-2,4,2,-1,4,3,1,1,2,-1,3,2,2,0,2,1,-2,1,0,-5,5,0,0,1,-1,-1,-1,1,1,-1
KR_6640906783,420,-2,-55,-46,-6,-1,1,0,-3,4,1,-3,5,2,2,1,3,-1,2,1,0,-4,-10,0,-4,4,1,0,-1,-1,-1,-1,1,6,-1
KR_6745248561,420,-1,37,-4,3,1,4,5,1,1,2,3,1,4,-1,1,0,-1,1,0,0,-3,-24,0,-2,2,1,0,0,1,-1,0,1,6,-1
KR_6726088200,420,-2,-47,-8,-3,0,1,1,-3,3,0,-1,3,2,1,0,1,0,1,1,0,4,6,1,-6,5,0,0,0,-1,1,0,-1,1,-1
KR_6758577726,420,2,24,0,8,4,0,4,0,3,3,4,1,5,-1,4,3,1,4,5,0,-8,-3,1,-4,3,-4,0,-1,1,1,1,1,1,-1
KR_6745205640,420,-3,-80,16,-12,-7,7,0,6,0,6,-7,8,1,-2,2,0,-2,3,1,0,-3,-1,2,-3,1,-1,0,-1,1,1,-1,-1,1,-1
KR_6723072427,420,-2,-80,-2,-2,-5,5,0,5,3,8,-3,4,1,2,2,4,-1,2,1,0,0,114,-4,-3,7,3,0,-1,-1,-1,-1,-1,5,-1
KR_6754527883,420,0,14,7,2,0,2,2,2,2,4,-1,5,4,2,1,3,-1,1,0,0,-3,21,0,-3,3,-25,0,1,0,1,1,1,0,-1
KR_6760852816,420,-1,-73,5,-4,-2,2,0,-5,6,1,1,1,2,0,1,1,2,0,2,0,-15,-2,-3,-1,4,1,0,1,-1,-1,-1,1,3,-1
KR_6763547122,440,2,-1,-1,6,2,0,2,0,0,0,3,1,4,0,1,1,1,0,1,0,5,42,0,-4,4,-28,0,2,-1,1,1,-1,2,-1
KR_6316070636,420,-7,-85,-29,-12,1,0,1,-11,11,0,1,1,2,-4,4,0,1,1,2,1,-10,-7,-4,-1,5,-2,0,-2,-1,-1,-1,1,1,-1
KR_6755323543,440,-2,-21,-27,-3,0,3,3,2,1,3,-1,3,2,-4,10,6,0,0,0,2,4,-9,-1,-1,2,1,0,0,-1,1,0,1,2,-1
KR_6118916248,420,-2,-30,-16,-1,2,0,2,-3,5,2,1,0,1,2,0,2,-3,3,0,0,-1,-34,4,-4,0,17,0,-1,0,1,-1,-1,0,-1
KR_6679732048,420,2,-26,-8,8,-3,5,2,4,0,4,2,2,4,0,1,1,5,0,5,0,10,-8,5,-7,2,0,0,1,-1,1,1,-1,2,-1
KR_6742944864,420,-4,-58,-36,-7,-3,4,1,-3,5,2,-1,2,1,0,2,2,0,0,0,0,-2,22,6,-6,0,-28,0,-1,-1,-1,-1,-1,2,-1
KR_6664937945,420,-5,-120,-15,-4,2,1,3,0,2,2,-5,6,1,1,1,2,-2,2,0,0,4,-1,-1,-2,3,2,0,-2,-1,-1,-1,-1,1,-1
KR_6514211078,420,0,21,30,-6,-2,2,0,0,3,3,-1,1,0,-2,3,1,-1,2,1,0,-9,-12,2,-2,0,-1,0,0,-1,1,0,-1,5,-1
KR_6733028377,420,-8,-57,-12,-9,-2,4,2,0,0,0,-3,3,0,-3,4,1,-1,2,1,0,-7,0,-1,-5,6,0,0,-1,-1,0,-1,-1,4,-1
KR_6755181873,420,-6,-75,-24,-12,-4,5,1,-5,7,2,-6,9,3,1,1,2,2,1,3,-1,-12,125,-3,0,3,-1,0,-1,-1,-1,-1,-1,3,-1
KR_6746371814,420,-1,-39,12,-4,-2,4,2,1,2,3,-3,4,1,0,0,0,0,0,0,0,-1,-54,-3,-1,4,1,0,0,1,1,0,-1,2,-1
KR_6581463305,420,3,-2,-31,19,2,0,2,5,0,5,2,2,4,5,3,8,5,1,6,0,23,-3,-2,-3,5,1,0,2,1,1,1,-1,6,-1
KR_6754863248,440,-3,-36,18,-9,-1,3,2,-1,2,1,-3,6,3,-4,5,1,0,0,0,-1,-8,-1,-5,-2,7,3,0,-1,1,1,-1,-1,6,-1
KR_6682849530,440,5,60,15,9,3,0,3,0,5,5,8,0,8,-2,3,1,0,0,0,0,6,-9,2,-5,3,4,0,1,1,1,1,1,1,-1
KR_6639490421,420,0,20,-32,0,-4,5,1,2,2,4,2,2,4,1,3,4,-1,1,0,0,7,-12,2,-5,3,6,0,1,0,0,1,-1,0,-1
KR_6537447625,420,1,35,0,5,-1,3,2,-1,4,3,3,0,3,5,0,5,-1,1,0,0,3,-3,1,-5,4,-2,0,0,1,1,1,1,6,-1
KR_6762886904,420,-3,-50,6,-2,-3,5,2,5,1,6,-4,7,3,1,2,3,-1,1,0,0,13,-3,2,-4,2,-3,0,-2,-1,1,-1,1,5,-1
KR_6567359657,420,-1,-69,20,0,-1,1,0,3,0,3,2,0,2,-2,3,1,-2,3,1,0,3,-43,0,-3,3,-3,0,0,1,-1,0,1,3,-1
KR_6653966917,440,-4,-105,-5,-9,-2,3,1,-1,4,3,-5,8,3,-1,1,0,0,0,0,-1,-11,-21,-2,-1,3,0,0,0,0,0,-1,-1,0,-1
KR_6669830154,420,2,61,4,7,0,1,1,4,0,4,0,2,2,2,1,3,1,0,1,0,11,6,-1,-2,3,-2,0,0,-1,-1,0,-1,5,-1
KR_6757849435,420,-3,1,-11,-5,-4,4,0,-6,6,0,-1,4,3,0,3,3,6,0,6,1,-1,-18,-1,-2,3,0,0,0,-1,1,0,1,5,-1
KR_6738428901,420,0,-52,-20,1,7,0,7,1,0,1,-3,8,5,-6,8,2,2,1,3,1,3,-3,1,-3,2,1,0,1,-1,1,1,1,4,-1
KR_6730359139,420,-3,-115,20,-1,1,1,2,-1,4,3,1,0,1,-4,4,0,2,1,3,0,-10,-11,1,-2,1,-3,0,-1,0,-1,-1,-1,0,-1
KR_6722618960,420,-4,-46,28,-15,-3,5,2,-1,3,2,-8,11,3,0,0,0,-3,4,1,-1,-15,-111,-3,-1,4,-1,0,-3,-1,-1,-1,-1,4,-1
KR_6737162247,420,1,80,20,-1,4,2,6,-1,4,3,0,2,2,-2,3,1,-2,2,0,-1,-8,-2,1,-3,2,-3,0,1,-1,1,1,-1,4,-1
KR_6601170796,420,-4,-46,-8,-4,2,2,4,0,2,2,-3,6,3,-4,5,1,1,1,2,-1,0,-1,-2,0,2,0,0,-1,-1,-1,-1,-1,5,-1
KR_6611677966,420,2,8,0,9,5,1,6,1,2,3,-3,6,3,-1,2,1,7,1,8,-1,6,-5,0,-1,1,0,0,2,1,1,-1,-1,3,-1
KR_6355819094,420,1,4,8,0,1,3,4,0,3,3,2,1,3,-1,2,1,-2,2,0,0,-6,0,0,0,0,1,0,-1,1,-1,-1,-1,5,-1
KR_6717690489,420,1,35,-28,4,3,0,3,5,2,7,-4,5,1,0,0,0,0,0,0,0,4,3,0,-6,6,2,0,1,0,0,1,1,0,-1
KR_6503687148,420,0,-34,0,0,-2,3,1,-3,4,1,1,0,1,5,0,5,-1,2,1,0,2,184,3,-3,0,0,0,1,1,-1,1,1,2,-1
KR_6733928237,440,-4,-64,3,-6,-7,7,0,-2,2,0,-1,3,2,3,3,6,1,0,1,0,9,-4,-2,-1,3,3,0,-1,-1,-1,-1,-1,5,-1
KR_6749728405,420,-2,53,-8,-8,-1,1,0,2,1,3,-3,4,1,-6,8,2,0,0,0,0,-6,-9,-1,-3,4,4,0,-1,0,-1,-1,1,0,-1
KR_6095295173,420,-8,-148,-30,-20,-7,7,0,-7,8,1,-9,9,0,3,1,4,0,1,1,-1,-4,-150,-5,0,5,1,0,-3,-1,-1,-1,-1,4,-1
KR_6758847001,420,3,83,19,14,13,0,13,-2,5,3,2,4,6,2,0,2,-1,1,0,1,3,-6,2,-3,1,1,0,2,1,1,1,1,3,-1
KR_6733704954,420,-3,-23,-11,-3,-1,3,2,1,1,2,-3,3,0,-1,1,0,1,1,2,0,-1,-27,7,-7,0,-3,0,0,1,1,0,1,6,-1
KR_6764201747,420,0,-38,31,6,-3,4,1,2,2,4,5,2,7,3,0,3,-1,3,2,1,4,-6,1,-3,2,0,0,-1,1,0,-1,1,4,-1
KR_6667885744,420,-1,-5,24,-4,-2,2,0,-1,1,0,-1,3,2,1,2,3,-1,2,1,0,-3,-22,0,-2,2,1,0,0,1,0,-1,-1,3,-1
KR_6689330570,420,0,-17,4,-3,2,3,5,-1,3,2,-7,9,2,1,2,3,2,0,2,0,4,21,-1,-1,2,0,0,0,1,1,1,-1,5,-1
KR_6738643480,420,-3,-35,-28,-5,-1,2,1,-4,5,1,1,1,2,0,0,0,-1,1,0,0,-5,-166,6,-7,1,-1,0,0,-1,1,0,-1,4,-1
KR_6759653766,440,3,-11,-13,7,2,1,3,1,2,3,3,1,4,-2,5,3,3,2,5,0,-1,7,-5,-1,6,4,0,1,0,0,1,-1,0,-1
KR_6608052241,440,-6,-77,-40,-13,-1,1,0,2,5,7,-7,8,1,-7,8,1,0,0,0,0,-5,-3,-1,-4,5,-3,0,0,1,-1,-1,-1,4,-1
KR_6747193068,440,3,55,-12,2,4,1,5,-4,4,0,2,1,3,1,4,5,-1,2,1,0,4,309,-2,-3,5,0,0,2,-1,1,1,-1,4,-1
KR_6733062488,420,-2,-108,16,-14,-11,11,0,-4,8,4,-2,4,2,0,1,1,3,1,4,-1,-6,10,-1,-1,2,1,0,-1,-1,-1,-1,-1,4,-1
KR_6711432418,420,2,73,20,0,3,0,3,-11,12,1,3,2,5,5,1,6,0,3,3,0,0,24,5,-8,3,0,0,2,1,1,1,1,5,-1
KR_6745998269,440,3,20,0,2,1,0,1,-2,3,1,4,0,4,-1,3,2,0,2,2,0,-1,-28,-4,0,4,1,0,0,-1,1,0,-1,1,-1
KR_6618105739,420,-6,-31,-44,-8,-6,6,0,-3,4,1,4,0,4,0,4,4,-3,3,0,1,-3,-4,-3,-4,7,-3,0,0,-1,1,-1,1,5,-1
KR_6687210829,420,-1,22,-20,-5,-3,4,1,2,1,3,-4,4,0,0,1,1,0,1,1,0,-3,-4,-1,-3,4,3,0,-1,-1,-1,-1,-1,1,-1
KR_6380918217,420,-3,-109,4,-10,-2,2,0,3,3,6,-8,10,2,-3,4,1,0,2,2,0,-4,6,-2,-3,5,-1,0,-1,-1,1,-1,-1,3,-1
KR_6759445929,420,3,42,0,7,0,1,1,2,0,2,2,0,2,4,0,4,-1,2,1,0,8,20,5,-10,5,-1,0,0,1,-1,0,1,4,-1
KR_6751196549,420,0,-12,-4,-6,-4,4,0,1,3,4,3,0,3,-3,6,3,-3,4,1,0,-3,-1,1,-1,0,4,0,0,1,0,0,-1,1,-1
KR_6684163795,420,3,12,4,4,1,1,2,0,2,2,2,0,2,0,2,2,1,0,1,0,5,2,0,-4,4,-2,0,0,1,-1,1,-1,1,-1
KR_6764337586,420,-2,-16,-16,-4,-3,4,1,-6,8,2,0,0,0,4,1,5,1,1,2,0,2,13,-1,-3,4,-3,0,0,-1,-1,0,-1,3,-1
KR_6761274987,420,1,103,-16,3,1,0,1,6,1,7,1,0,1,-4,6,2,-1,1,0,1,7,-10,-4,-1,5,-1,0,0,-1,1,0,1,1,-1
KR_6748973137,440,-4,2,-36,-9,-5,5,0,0,2,2,1,3,4,-5,9,4,0,2,2,0,-6,0,4,-6,2,-1,0,0,-1,0,-1,-1,5,-1
KR_6658066731,420,-3,21,3,-5,-1,3,2,0,2,2,-1,3,2,-1,1,0,-2,2,0,0,-7,-3,-1,-4,5,-3,0,-2,-1,-1,-1,-1,5,-1
KR_6746993577,420,-5,-44,-14,-13,-3,4,1,-3,3,0,-5,5,0,0,1,1,-2,3,1,0,-9,39,-5,-2,7,-28,0,0,-1,0,0,-1,2,-1
KR_6670512155,420,2,20,38,5,-5,5,0,1,4,5,8,0,8,1,3,4,0,0,0,0,-1,14,3,-5,2,3,0,2,1,1,1,1,5,-1
KR_6601294829,420,-4,-103,12,-6,0,0,0,-2,3,1,1,4,5,-6,6,0,1,0,1,0,-7,-4,2,-3,1,-1,0,0,1,0,-1,-1,6,-1
KR_6729399491,420,-8,-28,-38,-12,-2,4,2,0,2,2,-5,6,1,-4,4,0,-1,1,0,0,-5,23,3,-4,1,-2,0,0,0,1,0,1,0,-1
KR_6646882949,420,0,48,-4,-6,6,0,6,1,0,1,-1,3,2,0,5,5,-12,13,1,-1,-10,8,2,-3,1,-4,0,0,-1,0,-1,-1,4,-1
KR_6433470839,440,-1,-37,20,-8,0,1,1,-2,6,4,-4,4,0,1,1,2,-3,3,0,0,-8,-38,-1,-1,2,25,0,-1,-1,-1,-1,-1,6,-1
KR_6719633713,420,-5,-9,-44,-7,0,1,1,-2,4,2,-1,4,3,-2,4,2,-2,2,0,0,-5,-3,1,-2,1,3,0,0,-1,1,0,1,3,-1
KR_6641549173,420,-2,-58,8,-4,2,0,2,-1,2,1,-2,3,1,-3,3,0,0,0,0,0,-5,-10,1,-3,2,-2,0,0,-1,1,0,1,3,-1
KR_6631569847,420,-2,109,-104,3,2,0,2,-3,7,4,-1,3,2,2,2,4,3,0,3,0,2,21,2,-3,1,-2,0,2,-1,0,1,1,4,-1
KR_6732125459,420,-2,-15,-16,-2,-1,2,1,-2,2,0,-2,3,1,5,1,6,-2,5,3,2,-1,-2,5,-10,5,-2,0,0,-1,1,0,1,2,-1
KR_6668532153,420,-1,-1,-36,3,-3,6,3,0,3,3,-4,5,1,5,2,7,5,0,5,0,12,13,5,-5,0,-2,0,1,-1,1,1,1,4,-1
KR_6754504079,420,-1,-16,-8,-4,-1,4,3,0,0,0,1,1,2,-3,3,0,-1,2,1,0,-10,-5,-2,-3,5,3,0,0,1,-1,0,-1,1,-1
KR_6695035165,440,-5,-90,-6,-11,3,2,5,0,1,1,-7,7,0,-1,1,0,-6,6,0,0,-5,221,1,-3,2,-1,0,-1,0,-1,-1,1,0,-1
KR_6737095305,440,-8,-84,-28,-7,3,3,6,3,1,4,-6,8,2,0,4,4,-7,9,2,2,-2,-3,-3,0,3,-1,0,-1,-1,-1,-1,1,6,-1
KR_6657768794,420,-1,-13,15,-1,3,0,3,-8,11,3,-4,5,1,5,1,6,3,0,3,0,0,-11,-1,-2,3,-1,0,0,-1,0,0,1,4,-1
KR_6578327646,420,1,-78,5,-5,-6,8,2,1,2,3,4,2,6,-1,3,2,-3,3,0,0,-1,-14,-6,-2,8,2,0,-2,-1,-1,-1,1,6,-1
KR_6754606961,420,-2,-40,31,-7,-1,3,2,-1,4,3,-1,4,3,-4,5,1,0,0,0,0,-11,3,0,-3,3,-4,0,-1,-1,-1,-1,1,5,-1
KR_6495387178,420,4,55,13,3,0,1,1,0,5,5,1,1,2,3,1,4,-1,1,0,0,3,18,1,-7,6,-3,0,0,1,-1,0,1,4,-1
KR_5957003755,420,3,6,-20,2,0,3,3,0,1,1,-3,6,3,1,2,3,4,0,4,0,7,0,-3,-2,5,1,0,1,-1,-1,1,-1,2,-1
KR_6680776340,420,-3,-96,-9,-10,0,2,2,0,0,0,-7,7,0,1,0,1,-4,4,0,0,-4,-5,-1,-5,6,-4,0,-1,-1,-1,-1,1,3,-1
KR_6595156573,420,1,5,12,7,3,0,3,2,0,2,-4,5,1,5,2,7,1,1,2,0,3,274,1,-6,5,-3,0,1,1,1,1,-1,5,-1
KR_6756591518,420,-3,8,-12,-3,1,1,2,-3,5,2,3,0,3,-3,4,1,-1,1,0,0,-12,-24,1,-5,4,-2,0,0,1,1,0,1,1,-1
KR_6420069597,420,-3,22,8,-12,-5,5,0,-6,6,0,5,1,6,-4,4,0,-2,2,0,0,-16,-41,3,-4,1,2,0,0,0,-1,0,-1,0,-1
KR_6742828363,420,-3,-19,-12,-14,-1,2,1,-1,2,1,-2,2,0,-3,4,1,-7,7,0,0,-9,28,5,-6,1,-4,0,-1,-1,-1,-1,-1,6,-1
KR_6704559190,420,-1,-49,-22,-2,2,1,3,2,6,8,1,1,2,-4,6,2,-3,4,1,0,2,21,0,-4,4,0,0,-1,1,1,-1,1,6,-1
KR_6574700455,420,1,-1,0,0,3,0,3,-3,5,2,2,2,4,1,4,5,-3,5,2,0,3,3,3,-4,1,0,0,0,-1,-1,0,1,1,-1
KR_6320879817,420,2,30,47,4,3,0,3,-1,3,2,0,3,3,2,1,3,0,1,1,0,5,-2,1,-3,2,1,0,1,-1,1,1,-1,6,-1
KR_6704443280,420,-4,-52,0,-16,-3,7,4,-1,3,2,-6,8,2,-4,4,0,-2,3,1,0,-17,10,0,-2,2,-2,0,0,-1,0,0,1,5,-1
KR_6724809118,420,-4,-30,-4,-10,1,1,2,-3,3,0,-1,2,1,-7,7,0,0,1,1,0,-14,22,0,-5,5,-2,0,-2,-1,-1,-1,-1,2,-1
KR_6670818006,420,-4,-65,-4,-10,-2,3,1,2,1,3,2,0,2,-12,13,1,0,0,0,0,-5,2,-1,-3,4,2,0,-1,-1,-1,-1,1,5,-1
KR_6729520957,420,1,-10,26,3,0,0,0,1,0,1,-7,7,0,7,0,7,2,0,2,0,9,-5,1,-2,1,-2,0,0,1,1,0,-1,5,-1
KR_6754331237,420,1,34,12,9,-2,3,1,-1,2,1,0,2,2,9,1,10,3,2,5,0,2,-4,-1,-2,3,-1,0,-1,1,0,-1,1,2,-1
KR_6717158598,420,-2,-42,-16,-10,3,0,3,1,1,2,-5,8,3,-4,4,0,-5,10,5,0,-1,-45,-2,0,2,22,0,0,1,1,-1,-1,6,-1
KR_6763233399,440,0,45,0,1,4,0,4,-4,5,1,1,2,3,-2,7,5,2,2,4,0,-7,-84,2,-3,1,-20,0,0,0,1,1,1,0,-1
KR_6484071483,420,0,-21,-20,-2,-2,5,3,0,2,2,-2,3,1,1,1,2,1,1,2,0,2,-2,-2,-2,4,0,0,1,1,1,1,-1,6,-1
KR_6730081344,420,-4,-27,-20,-12,-2,3,1,-9,10,1,-2,5,3,-2,4,2,3,1,4,0,-4,-101,-1,-3,4,-6,0,-2,0,0,-1,-1,0,-1
KR_6332419920,420,-6,-95,4,-12,-3,3,0,-3,4,1,-6,6,0,-1,3,2,1,1,2,0,-7,0,1,-3,2,1,0,0,1,-1,-1,-1,3,-1
KR_6742689016,440,0,1,12,-1,1,0,1,3,0,3,3,1,4,-8,10,2,0,0,0,0,-5,3,-1,-2,3,3,0,-1,-1,1,-1,1,3,-1
KR_6578436965,420,2,53,-11,5,0,1,1,2,2,4,-1,6,5,1,0,1,3,0,3,0,9,-23,0,-1,1,3,0,0,-1,1,-1,1,1,-1
KR_6505170985,420,-1,-21,-57,2,1,2,3,0,3,3,2,6,8,0,2,2,-1,1,0,-1,9,11,2,-5,3,-4,0,0,-1,-1,0,-1,5,-1
KR_6743900355,420,0,-49,-20,2,-7,8,1,-3,3,0,5,0,5,7,1,8,0,1,1,2,4,-4,-3,-1,4,4,0,0,1,-1,-1,1,6,-1
KR_6602078804,420,1,-43,-18,0,-2,2,0,2,2,4,1,1,2,-5,6,1,4,0,4,0,1,274,2,-2,0,-4,0,0,-1,1,0,-1,3,-1
KR_6759066399,420,0,-64,36,-11,1,0,1,1,2,3,0,1,1,-10,11,1,-3,6,3,0,-15,-56,1,-3,2,4,0,-1,1,-1,-1,-1,6,-1
KR_6753145078,420,-1,-60,-28,-1,-2,2,0,-5,7,2,1,2,3,3,2,5,2,0,2,0,6,-5,-1,-2,3,1,0,0,-1,1,0,-1,5,-1
KR_6740644799,420,-8,-41,-49,-10,-5,5,0,-2,2,0,0,1,1,-1,6,5,-2,2,0,0,-8,-1,1,-1,0,-1,0,-3,-1,0,-1,-1,4,-1
KR_6552837404,420,-2,-73,-36,-3,3,1,4,-3,3,0,-4,6,2,1,4,5,0,1,1,0,-2,-8,-6,0,6,3,0,0,-1,1,1,1,1,-1
KR_6088226832,420,2,29,-9,1,2,0,2,-1,5,4,2,0,2,-2,2,0,0,1,1,0,-3,69,1,-4,3,3,0,0,-1,-1,0,-1,2,-1
KR_5540437459,440,-2,29,-56,-4,1,1,2,-5,5,0,2,2,4,-1,2,1,-1,1,0,-2,-11,6,-1,-6,7,-12,0,-1,-1,-1,-1,-1,3,-1
KR_6755567686,420,-5,-38,-4,-13,0,0,0,-4,8,4,-4,5,1,-3,4,1,-2,4,2,0,-13,-8,0,-4,4,2,0,0,1,-1,-1,-1,6,-1
KR_6450108989,440,1,1,-6,1,4,1,5,-2,2,0,4,2,6,0,3,3,-5,6,1,0,-1,15,2,-5,3,1,0,0,-1,1,-1,-1,5,-1
KR_6740997588,420,-2,-59,-36,-3,7,0,7,-1,1,0,0,4,4,-8,9,1,-1,2,1,0,-6,-13,-1,-1,2,0,0,0,0,0,-1,1,0,-1
KR_6719573315,420,-1,-15,12,-6,-5,5,0,1,1,2,1,3,4,-2,4,2,-1,1,0,1,-1,356,-3,-2,5,1,0,-1,1,-1,-1,1,3,-1
KR_6710137466,420,-4,-48,-8,-11,-1,2,1,-6,6,0,1,1,2,-4,4,0,-1,1,0,0,-9,11,1,-6,5,0,0,-1,1,1,-1,-1,1,-1
KR_6668780429,420,0,0,-24,0,1,1,2,-3,5,2,-3,5,2,5,0,5,0,2,2,0,0,-42,3,-4,1,21,0,1,1,-1,1,1,3,-1
KR_6373590675,420,-9,-123,-56,-23,-2,4,2,-14,15,1,-3,3,0,-2,3,1,-2,3,1,0,-19,0,0,0,0,0,0,-2,-1,-1,-1,-1,3,-1
KR_6729247539,440,-6,-16,16,-10,0,1,1,-8,10,2,-2,2,0,3,0,3,-3,4,1,0,-12,11,2,-3,1,-2,0,-1,0,0,-1,-1,0,-1
KR_6590562879,420,0,-2,-20,-1,1,0,1,1,5,6,-6,8,2,1,0,1,2,0,2,1,4,6,1,-2,1,-1,0,0,-1,1,1,1,1,-1
KR_6719156851,420,-2,-66,-20,-3,1,0,1,0,2,2,-4,7,3,-2,2,0,2,0,2,0,-2,-6,-5,0,5,1,0,-1,-1,-1,-1,1,3,-1
KR_6743616169,420,-5,-51,-8,-10,-3,3,0,0,1,1,-1,4,3,-9,9,0,3,1,4,-1,-8,-4,1,-1,0,-1,0,-3,-1,-1,-1,-1,4,-1
KR_6720639177,420,-4,5,-40,-9,-7,9,2,-6,8,2,3,3,6,1,1,2,0,2,2,0,-1,0,1,-2,1,1,0,-2,1,-1,-1,-1,6,-1
KR_6730393589,420,-4,1,1,-7,0,2,2,3,2,5,-7,7,0,-2,4,2,-1,3,2,-1,-4,-11,-2,-1,3,1,0,-1,-1,-1,-1,-1,3,-1
KR_6758698294,420,-3,-103,-16,-9,-2,3,1,1,1,2,-7,7,0,-2,3,1,1,0,1,0,-5,-116,1,-4,3,0,0,-2,-1,-1,-1,1,6,-1
KR_6668854127,440,-1,-2,-4,-6,-3,4,1,-1,2,1,-3,7,4,0,1,1,1,0,1,0,1,2,-2,-1,3,-2,0,-1,-1,-1,-1,-1,5,-1
KR_6721704440,420,-3,-66,0,-6,-1,2,1,0,2,2,2,1,3,-6,7,1,-1,3,2,0,-6,-5,-5,0,5,0,0,0,1,1,0,1,5,-1
KR_6722181470,420,0,-47,26,-5,-3,5,2,-3,5,2,-4,4,0,3,3,6,2,2,4,-1,-8,1,-6,-3,9,-7,0,0,-1,-1,-1,-1,4,-1
KR_6185569488,420,-9,-49,-64,-23,-1,1,0,-5,5,0,-3,3,0,-13,14,1,-1,1,0,-2,-21,287,-2,0,2,-1,0,-2,-1,-1,-1,-1,5,-1
KR_6663251943,420,-1,-21,16,-3,0,1,1,-4,4,0,2,1,3,1,1,2,-2,2,0,0,-5,-9,2,-4,2,1,0,-1,-1,-1,-1,-1,2,-1
KR_6567392485,420,1,-8,12,2,-1,1,0,-1,2,1,-1,3,2,5,7,12,0,0,0,0,-6,53,6,-10,4,-26,0,1,-1,1,1,-1,1,-1
KR_6750468638,440,-1,86,-12,-1,10,0,10,-1,1,0,-1,2,1,-6,8,2,-3,4,1,0,1,2,-2,-1,3,0,0,0,-1,1,1,1,5,-1
KR_6729247180,420,-1,-48,9,-7,-1,4,3,-5,5,0,3,3,6,1,0,1,-5,5,0,1,-3,-9,0,-3,3,6,0,0,0,1,0,1,0,-1
KR_6705211843,420,-4,-100,-8,-9,-3,4,1,0,4,4,-5,5,0,-1,4,3,0,1,1,-1,-4,-1,0,-7,7,-3,0,-1,-1,1,-1,-1,3,-1
KR_6508700512,420,-2,-58,-8,-4,1,0,1,3,1,4,-1,2,1,-6,8,2,-1,2,1,0,-1,-15,3,-5,2,-3,0,-1,-1,1,-1,-1,4,-1
KR_6601839656,420,-7,-69,-24,-14,0,1,1,-1,1,0,-3,4,1,-6,7,1,-4,4,0,-1,-12,0,0,-3,3,0,0,-2,-1,-1,-1,-1,3,-1
KR_6645535678,420,0,13,-24,-3,6,1,7,1,1,2,-1,5,4,-8,8,0,-1,1,0,1,-14,-1,1,-5,4,-2,0,1,1,1,1,1,3,-1
KR_6715299702,440,-6,-59,-36,-14,-5,5,0,-6,6,0,-4,6,2,0,0,0,1,1,2,-1,-16,-5,-6,0,6,0,0,-2,0,1,-1,-1,0,-1
KR_6753592470,440,-4,-41,-23,-5,-1,3,2,4,2,6,2,2,4,-4,7,3,-6,6,0,-1,3,-251,1,-4,3,2,0,-2,-1,-1,-1,1,4,-1
KR_6727955828,420,0,26,-16,-4,-4,4,0,-2,4,2,0,2,2,4,1,5,-2,3,1,1,0,-5,5,-8,3,1,0,-1,-1,0,-1,1,6,-1
KR_6753510247,440,-2,-82,32,3,-5,5,0,0,3,3,3,0,3,6,0,6,-1,1,0,0,8,35,6,-6,0,-1,0,2,1,1,1,1,3,-1
KR_6756339765,420,-4,-46,8,-4,-5,5,0,-1,4,3,-6,7,1,7,0,7,1,0,1,0,8,-182,-1,-5,6,7,0,-2,1,-1,-1,1,5,-1
KR_6756858084,420,3,-11,8,5,3,1,4,0,2,2,-1,3,2,0,1,1,3,4,7,0,14,-13,3,-5,2,2,0,-2,0,-1,-1,1,0,-1
KR_6732349521,440,-6,-82,-31,-13,0,3,3,-10,12,2,-1,1,0,1,1,2,-3,6,3,0,-10,-2,1,-4,3,-2,0,-1,1,-1,-1,1,5,-1
KR_6381170173,420,3,12,17,-1,1,0,1,1,2,3,1,2,3,-2,3,1,-2,2,0,0,-7,3,-1,-3,4,1,0,-2,1,-1,-1,1,2,-1
KR_6431555903,420,0,-9,-20,-2,1,2,3,0,2,2,-6,7,1,1,1,2,2,1,3,0,-1,6,-1,-2,3,0,0,-1,-1,-1,-1,-1,1,-1
KR_6566283502,420,-7,-61,-69,-9,0,1,1,-6,8,2,-1,2,1,2,2,4,-4,4,0,0,2,3,4,-6,2,-2,0,-2,0,-1,-1,1,0,-1
KR_6680672814,440,0,45,-37,0,-1,4,3,-1,1,0,2,0,2,2,2,4,-2,3,1,0,0,11,3,-5,2,-1,0,1,-1,-1,1,-1,2,-1
KR_6681980354,440,-2,-49,0,-3,0,5,5,-3,4,1,-1,4,3,1,2,3,0,2,2,-1,-2,4,-1,-2,3,-3,0,0,-1,0,0,-1,4,-1
KR_6495311793,420,-2,16,12,-6,-1,2,1,-2,4,2,-2,3,1,-1,4,3,0,1,1,0,-6,-4,-2,-2,4,0,0,0,1,-1,0,1,1,-1
KR_6703506483,420,0,20,-24,-4,-2,2,0,-2,3,1,1,1,2,-2,4,2,1,0,1,0,-10,1,0,-3,3,-2,0,0,1,1,0,1,1,-1
KR_6588612320,420,-1,-40,12,-3,-2,4,2,0,1,1,1,1,2,-3,7,4,1,0,1,0,3,2,-3,0,3,-1,0,-1,1,-1,-1,-1,1,-1
KR_6728253608,420,0,-20,22,-3,-1,2,1,2,1,3,-6,7,1,2,0,2,0,2,2,0,-4,-2,-7,-1,8,0,0,0,1,0,0,-1,4,-1
KR_6757343191,420,-5,-62,2,-11,-2,3,1,-1,1,0,-3,4,1,-5,7,2,0,1,1,-1,-7,5,-2,-3,5,-4,0,-1,-1,-1,-1,-1,4,-1
KR_6668591950,420,-3,-110,-2,-4,-3,3,0,-1,1,0,1,1,2,-1,4,3,0,0,0,0,-2,112,1,-7,6,-4,0,0,1,1,0,-1,1,-1
KR_6459211144,420,-3,-22,-31,-8,-4,4,0,-3,4,1,-1,4,3,-1,5,4,1,0,1,0,-7,-10,-4,-1,5,-2,0,-1,-1,-1,-1,-1,2,-1
KR_6659166255,420,-5,-54,-14,-17,-3,4,1,-5,6,1,-3,8,5,-4,4,0,-2,5,3,-1,-6,-3,-2,0,2,1,0,-2,1,-1,-1,-1,6,-1
KR_6524015422,420,-2,-33,-13,-7,-4,5,1,-1,1,0,-1,3,2,0,0,0,-1,1,0,0,-4,-7,1,-5,4,-5,0,-2,1,-1,-1,1,6,-1
KR_6571314596,420,-3,23,-34,-9,1,0,1,-10,10,0,3,1,4,-3,3,0,0,4,4,0,-13,39,-1,-3,4,-32,0,0,-1,0,1,1,4,-1
KR_6675094902,440,-1,-72,20,-3,-4,5,1,10,1,11,0,2,2,-10,12,2,1,0,1,-1,-5,243,-3,-3,6,-2,0,-1,1,-1,-1,-1,1,-1
KR_6744704310,440,0,60,4,-6,-5,5,0,1,3,4,2,1,3,-2,6,4,-2,2,0,0,0,-5,-2,-2,4,4,0,0,1,-1,-1,1,6,-1
KR_6707895364,440,0,-72,-8,5,2,0,2,0,1,1,-1,1,0,7,3,10,-3,3,0,0,4,-2,0,-2,2,-7,0,-2,1,-1,-1,-1,5,-1
KR_6749803941,420,0,48,-24,-2,2,0,2,-4,5,1,1,0,1,-1,2,1,0,0,0,1,0,6,-2,-4,6,3,0,0,-1,-1,0,1,6,-1
KR_6730880076,420,-2,-43,-12,-2,2,1,3,-3,4,1,-1,5,4,0,2,2,0,1,1,0,-1,-14,3,-6,3,-5,0,0,0,0,-1,1,0,-1
KR_6763315463,440,-2,9,-24,-13,4,0,4,0,3,3,1,0,1,-17,18,1,-1,1,0,0,-11,15,-3,0,3,2,0,1,-1,1,-1,-1,2,-1
KR_6761874799,420,-1,76,-16,-2,-5,6,1,-1,1,0,2,4,6,0,0,0,2,0,2,0,2,-4,-2,-1,3,0,0,-1,-1,-1,-1,1,2,-1
KR_6749782291,420,-2,-24,33,-7,-3,4,1,2,0,2,-1,3,2,-5,9,4,0,0,0,0,-3,13,3,-6,3,3,0,0,1,-1,-1,-1,3,-1
KR_6646938638,420,-2,21,-32,5,3,1,4,2,0,2,0,1,1,2,1,3,-2,4,2,0,6,-3,3,-5,2,0,0,-1,1,-1,-1,1,6,-1
KR_6729309764,420,3,92,55,9,4,1,5,0,2,2,10,3,13,-6,7,1,1,0,1,0,-1,-3,-1,-3,4,3,0,3,1,1,1,1,5,-1
KR_6701847977,420,2,-26,8,8,1,0,1,1,2,3,7,1,8,-3,4,1,2,0,2,0,4,2,3,-5,2,-1,0,-1,0,-1,-1,1,0,-1
KR_6669383461,420,-3,-60,3,-10,-3,3,0,-2,3,1,0,1,1,-4,4,0,-1,2,1,0,-4,-1,-2,-4,6,0,0,-3,-1,-1,-1,-1,4,-1
KR_6735969511,420,-2,-11,-4,4,5,1,6,-1,1,0,3,1,4,-1,3,2,-2,3,1,1,3,-1,2,-3,1,-1,0,1,-1,0,1,1,5,-1
KR_6744051878,420,-2,-37,-56,-2,3,1,4,0,0,0,-1,2,1,-1,1,0,-3,3,0,0,0,1,0,-2,2,-1,0,0,-1,1,-1,-1,3,-1
KR_6621058220,440,-4,39,-23,-8,0,2,2,1,1,2,-1,2,1,-8,9,1,0,0,0,0,-1,-12,-4,-1,5,1,0,0,1,-1,0,1,3,-1
KR_6584058231,420,0,-51,3,3,0,1,1,-4,7,3,2,0,2,3,3,6,2,2,4,0,13,-221,-1,-1,2,1,0,-2,1,-1,-1,1,5,-1
KR_6576268806,440,-5,-113,-16,-9,2,1,3,-1,5,4,-7,8,1,-3,3,0,0,0,0,0,-15,-37,-1,-2,3,2,0,-2,-1,1,-1,-1,3,-1
KR_6731996570,420,0,1,-9,2,4,1,5,-6,7,1,0,2,2,4,3,7,0,1,1,0,-4,-110,-2,-2,4,0,0,-1,-1,-1,-1,-1,1,-1
KR_6453040692,420,-1,-60,-27,-4,-2,2,0,-3,6,3,5,0,5,-3,3,0,-1,3,2,0,-9,16,5,-10,5,0,0,0,-1,-1,0,-1,6,-1
KR_6685755566,420,-3,1,-20,-6,-4,4,0,-2,3,1,2,0,2,-2,4,2,0,2,2,0,-2,-20,1,-6,5,-4,0,-1,-1,-1,-1,-1,1,-1
KR_6674687523,420,-2,35,-28,-5,-1,2,1,-4,4,0,0,0,0,0,2,2,0,1,1,0,-3,13,2,-8,6,2,0,0,-1,-1,0,-1,1,-1
KR_6565984868,420,-3,-82,-4,-3,-2,4,2,3,1,4,2,2,4,-6,7,1,0,0,0,-1,-4,-17,-3,-1,4,4,0,-1,1,1,-1,-1,6,-1
KR_6306015864,440,0,19,20,1,0,4,4,0,3,3,0,1,1,1,1,2,0,0,0,0,3,-40,-1,0,1,-2,0,0,1,1,0,-1,3,-1
KR_6690451221,420,2,43,-13,1,1,1,2,1,2,3,1,2,3,1,0,1,-3,4,1,0,1,4,-1,-6,7,2,0,-1,-1,-1,-1,-1,4,-1
KR_6747914446,420,1,84,-4,0,3,0,3,0,1,1,-2,2,0,-1,2,1,0,1,1,0,-6,36,-1,-2,3,-27,0,1,-1,0,1,-1,2,-1
KR_6711674491,420,2,-2,22,-4,-2,2,0,-5,5,0,4,4,8,-1,1,0,0,3,3,0,-11,-53,-9,-2,11,-9,0,2,0,1,1,-1,0,-1
KR_6725676803,420,-1,0,8,4,-5,5,0,2,2,4,4,1,5,1,1,2,2,1,3,1,10,19,0,-4,4,4,0,1,0,0,1,1,0,-1
KR_6745838512,420,1,54,-36,4,4,2,6,-1,4,3,2,2,4,-2,4,2,1,3,4,0,3,-7,1,-8,7,0,0,1,-1,0,1,-1,2,-1
KR_6756146966,420,-1,-11,-4,-2,-1,4,3,0,1,1,-3,4,1,1,2,3,1,0,1,0,2,-344,0,-1,1,-1,0,0,1,0,0,-1,1,-1
KR_6425477910,420,-4,-51,-45,-13,0,1,1,1,0,1,-11,15,4,-2,5,3,-1,1,0,0,-10,-7,-3,-2,5,0,0,-1,1,-1,-1,-1,4,-1
KR_6723563929,420,-2,-53,1,-13,-4,4,0,-2,3,1,1,1,2,-7,7,0,-1,2,1,0,-17,-134,-6,0,6,2,0,-2,-1,-1,-1,-1,2,-1
KR_6731452456,420,-3,-26,12,-6,-5,7,2,0,3,3,1,0,1,-1,2,1,-1,1,0,0,-3,-6,-1,-3,4,-1,0,-1,1,-1,-1,1,2,-1
KR_6695056628,420,5,66,13,11,4,0,4,0,2,2,-2,5,3,4,2,6,5,2,7,0,3,-43,1,-3,2,10,0,4,1,1,1,1,5,-1
KR_6725690450,440,1,29,-8,1,-1,2,1,1,2,3,1,3,4,1,3,4,-1,2,1,0,-5,-2,-1,-2,3,0,0,0,-1,1,0,1,1,-1
KR_6582170589,420,-4,-46,2,-5,-2,5,3,-2,6,4,-4,9,5,3,2,5,0,0,0,3,0,-29,0,-2,2,11,0,-2,-1,-1,-1,1,3,-1
KR_5528969774,420,-4,19,-12,-2,-2,2,0,9,0,9,-14,14,0,5,0,5,0,1,1,2,7,-7,-4,-1,5,2,0,-1,-1,-1,-1,1,4,-1
KR_6728106124,440,0,-11,-21,-2,-2,5,3,-6,6,0,0,4,4,1,2,3,5,0,5,0,-3,0,-1,-2,3,4,0,-1,-1,-1,-1,-1,5,-1
KR_6760536651,420,-1,-9,1,1,4,1,5,1,2,3,4,0,4,-3,3,0,-5,6,1,1,0,23,0,0,0,1,0,-1,0,1,-1,1,0,-1
KR_6755765026,420,3,-20,56,3,2,0,2,-2,2,0,1,2,3,1,0,1,1,0,1,0,4,111,-2,-2,4,5,0,0,1,1,1,-1,6,-1
KR_6664971938,420,-1,-51,-4,-1,-2,2,0,0,2,2,2,2,4,-3,4,1,2,1,3,0,0,6,-2,-3,5,1,0,0,-1,1,0,1,3,-1
KR_6582105299,420,-3,-32,-20,-4,-2,3,1,-3,4,1,0,2,2,1,1,2,0,0,0,0,0,-21,-2,-2,4,4,0,-1,-1,-1,-1,1,6,-1
KR_6671562630,420,-4,-22,-5,-6,0,1,1,-3,3,0,-4,6,2,2,0,2,-1,2,1,0,-6,6,-2,0,2,-5,0,-1,-1,-1,-1,-1,4,-1
KR_6624972772,420,4,35,22,5,1,0,1,-2,2,0,2,0,2,2,1,3,2,0,2,0,3,1,5,-6,1,0,0,1,1,-1,1,-1,3,-1
KR_6061959580,440,1,-69,21,7,1,1,2,2,2,4,2,0,2,1,1,2,1,2,3,0,8,129,4,-4,0,1,0,0,0,1,0,1,0,-1
KR_6711849179,420,-4,-32,-32,-14,-1,3,2,-2,4,2,-3,4,1,-9,11,2,1,0,1,0,-10,89,1,-4,3,0,0,-2,-1,-1,-1,-1,3,-1
KR_6673130689,420,-2,-56,0,-7,0,2,2,0,1,1,-8,8,0,0,2,2,1,2,3,0,1,-7,-4,-1,5,-1,0,0,-1,0,0,-1,3,-1
KR_6592304586,420,-3,-52,-7,-7,-2,3,1,0,1,1,-3,3,0,1,2,3,-3,3,0,0,-2,-307,-4,0,4,-1,0,-1,-1,1,-1,1,6,-1
KR_6759230470,440,-1,-76,-4,-4,0,1,1,-2,2,0,3,1,4,1,0,1,-6,7,1,0,-9,-5,-5,-2,7,2,0,0,-1,1,1,1,6,-1
KR_6761231198,440,0,-2,0,-6,3,1,4,-3,3,0,-3,4,1,-2,4,2,-1,3,2,0,-5,-41,-5,0,5,-5,0,0,-1,0,0,-1,2,-1
KR_6717375919,420,-2,42,24,-6,0,1,1,2,1,3,-7,9,2,-2,4,2,1,0,1,0,-6,-5,3,-5,2,-1,0,0,0,-1,0,-1,0,-1
KR_6737252787,420,-1,-71,-8,0,-4,5,1,2,2,4,3,0,3,0,1,1,-1,4,3,0,-4,218,2,-4,2,-15,0,0,1,-1,-1,-1,3,-1
KR_6736483294,420,1,51,-4,-3,0,3,3,-3,5,2,-1,3,2,0,0,0,1,1,2,0,-5,-15,2,-5,3,-1,0,0,-1,-1,1,-1,3,-1
KR_6757810940,420,-2,-23,-27,0,2,0,2,-1,2,1,0,3,3,-2,5,3,1,0,1,0,2,0,1,-5,4,5,0,0,-1,-1,0,-1,4,-1
KR_6742540434,420,-2,-36,14,-7,1,0,1,2,2,4,-3,5,2,-1,3,2,-6,6,0,0,-4,-12,-4,0,4,-1,0,0,1,-1,-1,-1,1,-1
KR_6684381433,420,-2,-76,-12,-6,-4,4,0,0,1,1,-7,8,1,5,1,6,0,0,0,0,3,-35,2,-5,3,17,0,-1,-1,-1,-1,-1,3,-1
KR_6656439761,420,-1,-75,36,-10,3,0,3,2,2,4,-6,6,0,-6,7,1,-3,3,0,0,-10,-44,-1,-2,3,12,0,-1,1,1,-1,-1,2,-1
KR_6702790626,420,-6,-90,-40,-10,-5,6,1,1,2,3,-5,6,1,0,2,2,-1,1,0,0,-3,-42,-2,-2,4,19,0,-1,-1,0,-1,-1,4,-1
KR_6733650174,420,-4,-60,0,-7,-4,5,1,-1,2,1,0,3,3,0,2,2,-2,2,0,0,-4,-19,-4,-2,6,9,0,-2,-1,1,-1,-1,1,-1
KR_6724547638,420,-3,-16,-4,-13,2,1,3,-3,5,2,-5,5,0,-6,6,0,-1,2,1,0,-13,4,4,-8,4,-2,0,0,-1,-1,0,-1,3,-1
KR_6718987272,420,-11,-109,-72,-25,-3,6,3,-2,2,0,-9,9,0,-13,13,0,2,1,3,-1,-9,-4,-2,0,2,0,0,-3,-1,-1,-1,-1,6,-1
KR_6729263731,420,-4,-36,-16,-6,-1,2,1,1,2,3,-8,8,0,1,3,4,1,1,2,0,-4,-9,-1,-2,3,-1,0,0,-1,1,0,-1,5,-1
KR_6752428161,440,-2,-14,-19,-4,1,1,2,0,1,1,-1,1,0,-1,1,0,-3,3,0,0,-4,2,0,-4,4,-5,0,0,-1,-1,0,1,3,-1
KR_6435271990,420,-2,-82,-15,-4,-1,1,0,-1,3,2,-6,6,0,1,1,2,3,0,3,0,-3,181,-2,0,2,2,0,0,-1,-1,-1,-1,3,-1
KR_6537883708,420,-4,5,-20,-10,-2,3,1,-1,4,3,-3,5,2,-4,5,1,0,0,0,0,-5,-4,-1,-3,4,3,0,0,-1,-1,0,1,3,-1
KR_6694776729,420,0,-51,17,-3,5,1,6,0,2,2,1,1,2,-7,7,0,-2,2,0,0,-7,-35,0,-2,2,17,0,0,1,1,-1,-1,6,-1
KR_6741208103,420,-3,-87,-32,-3,0,1,1,-5,6,1,1,2,3,1,2,3,0,0,0,1,-3,-352,1,-4,3,0,0,0,-1,-1,0,1,2,-1
KR_6419643824,420,0,-10,-43,-1,-2,3,1,-1,3,2,-1,6,5,1,1,2,2,0,2,0,5,151,-1,-1,2,-1,0,-2,-1,-1,-1,1,5,-1
KR_6702041123,420,-3,-42,4,-10,-1,2,1,-4,6,2,1,3,4,-5,6,1,-1,2,1,0,-4,-5,-2,-2,4,2,0,0,0,1,-1,-1,0,-1
KR_6735234391,440,-6,-12,-20,-14,-6,6,0,-4,4,0,-5,5,0,0,2,2,1,2,3,0,-16,3,0,-1,1,-1,0,-1,-1,0,-1,-1,5,-1
KR_6751940598,420,-1,-58,-12,-7,1,1,2,-1,3,2,-1,2,1,-1,8,7,-5,6,1,1,-5,-6,-2,-2,4,-2,0,-1,1,-1,-1,1,5,-1
KR_6760962420,420,3,-67,-22,5,2,2,4,1,2,3,2,2,4,0,0,0,0,0,0,0,7,-92,-4,-3,7,1,0,0,0,-1,-1,-1,0,-1
KR_6480735278,420,-2,-63,-16,-8,-4,4,0,-3,3,0,0,4,4,-2,3,1,1,2,3,0,-2,44,-2,-1,3,-24,0,-1,1,-1,-1,-1,4,-1
KR_6647103612,440,-2,4,-3,-4,2,0,2,-2,4,2,-2,2,0,-2,3,1,0,0,0,0,-9,-1,-2,-6,8,1,0,1,-1,1,1,1,5,-1
KR_6760570687,440,-3,-47,-4,-4,-2,3,1,0,2,2,-1,1,0,-2,2,0,1,0,1,-1,0,-24,2,-4,2,0,0,0,-1,1,1,-1,2,-1
KR_6631234664,420,-3,-29,-20,-5,-5,6,1,0,2,2,-1,3,2,4,1,5,-3,4,1,0,5,-10,-2,-3,5,2,0,-2,-1,-1,-1,-1,4,-1
KR_6600993419,440,-6,-65,-32,-10,-3,4,1,-1,1,0,-4,5,1,-1,3,2,-1,1,0,0,-1,-8,0,-3,3,4,0,-2,-1,1,-1,-1,6,-1
KR_6002161427,420,-5,-82,-19,-7,-6,6,0,1,2,3,1,2,3,-2,4,2,-1,1,0,0,-6,-31,-3,-2,5,0,0,-3,-1,-1,-1,-1,2,-1
KR_6759149387,420,0,-30,-4,3,2,1,3,0,1,1,-1,3,2,3,0,3,-1,1,0,0,0,-98,3,-8,5,-2,0,0,-1,1,0,-1,1,-1
KR_6659005740,440,-1,-22,16,8,-2,2,0,3,2,5,-3,3,0,4,2,6,6,1,7,0,22,-2,-3,-2,5,0,0,1,-1,-1,1,1,2,-1
KR_6677234319,420,-5,-92,-4,-5,-1,2,1,-3,3,0,-1,2,1,-1,4,3,1,0,1,0,-6,19,0,-7,7,1,0,-1,-1,-1,-1,-1,1,-1
KR_6733044636,420,-3,-156,-19,-5,-6,7,1,2,0,2,-4,4,0,0,3,3,3,0,3,0,3,-16,-2,-2,4,0,0,-3,-1,-1,-1,-1,3,-1
KR_6612425007,440,-6,-28,-31,-15,-9,13,4,-3,5,2,-2,2,0,1,1,2,-2,3,1,-1,-10,-1,1,-2,1,-4,0,-2,-1,-1,-1,-1,5,-1
KR_6721185419,420,-4,-104,7,-14,-2,4,2,2,1,3,-7,7,0,-5,8,3,-2,2,0,0,-7,-12,1,-1,0,0,0,-1,-1,-1,-1,1,1,-1
KR_6619554871,440,-5,-81,-20,-6,-9,9,0,-2,2,0,5,0,5,0,3,3,0,0,0,0,-5,0,-1,-1,2,2,0,-2,-1,0,-1,-1,1,-1
KR_6724336870,420,-5,-18,0,-17,-7,8,1,1,2,3,-6,8,2,-5,7,2,0,0,0,0,-19,-17,-6,0,6,-1,0,1,-1,-1,1,-1,2,-1
KR_6757344457,420,-5,-73,4,-10,0,1,1,1,1,2,-4,5,1,-6,7,1,-1,1,0,0,-3,357,-1,-3,4,-4,0,-3,-1,-1,-1,-1,3,-1
KR_6762964491,420,0,-27,-9,-8,-2,4,2,0,1,1,-5,6,1,-2,3,1,1,1,2,-1,-10,11,-2,-2,4,4,0,0,-1,-1,-1,-1,6,-1
KR_6751071754,440,0,-26,0,0,2,1,3,-3,3,0,5,0,5,1,0,1,-5,6,1,-1,9,-7,-3,-3,6,5,0,-1,1,1,-1,-1,3,-1
KR_6743198203,420,-4,-46,-40,-11,-2,2,0,-6,7,1,2,1,3,-5,5,0,0,1,1,0,-14,4,0,-1,1,-1,0,0,-1,-1,0,-1,6,-1
KR_6749686103,420,-1,-35,0,-5,-8,8,0,2,0,2,-1,1,0,-2,5,3,4,0,4,-1,1,0,0,-1,1,2,0,-2,1,-1,-1,-1,1,-1
KR_6618818228,420,-3,-35,-24,-10,-3,4,1,-4,4,0,3,0,3,-7,7,0,1,0,1,0,-7,9,1,-3,2,2,0,-1,-1,1,-1,-1,5,-1
KR_6755778822,420,0,42,-28,-5,2,0,2,-1,2,1,-2,5,3,-2,2,0,-2,2,0,-2,-9,-4,-4,-1,5,-1,0,0,-1,-1,0,-1,2,-1
KR_5542078129,420,3,7,-14,2,0,2,2,3,0,3,3,2,5,-7,7,0,3,1,4,0,1,0,1,-4,3,2,0,-1,1,-1,-1,-1,3,-1
KR_6683010660,420,3,57,30,-4,0,3,3,2,2,4,-5,7,2,-1,5,4,0,2,2,0,1,5,2,-3,1,-2,0,-2,1,1,-1,-1,1,-1
KR_6728556179,420,1,-14,-17,0,2,1,3,-4,6,2,0,1,1,0,1,1,2,0,2,0,2,-7,0,-4,4,6,0,1,-1,0,1,1,5,-1
KR_6729242652,440,-2,20,-48,-6,3,2,5,-3,6,3,0,1,1,-2,2,0,-4,4,0,1,-5,-15,-1,-1,2,-1,0,1,1,1,1,1,3,-1
KR_6721980152,420,1,32,51,0,2,0,2,3,1,4,-8,8,0,0,2,2,3,3,6,-2,-7,-3,-1,-1,2,1,0,0,0,-1,-1,-1,0,-1
KR_6764276536,420,0,-12,8,-1,1,1,2,-1,3,2,3,2,5,-1,2,1,-3,3,0,0,-3,-2,-2,-1,3,-2,0,0,-1,0,0,-1,2,-1
KR_6595703443,420,-4,-75,-38,-8,-2,2,0,-3,4,1,2,0,2,-1,2,1,-4,4,0,0,-5,-20,-1,-1,2,3,0,-2,-1,-1,-1,-1,6,-1
KR_5538601914,420,-1,-68,4,-3,-7,9,2,1,1,2,1,1,2,2,0,2,0,0,0,0,6,5,2,-4,2,-3,0,-1,-1,-1,-1,-1,2,-1
KR_6755307155,440,-6,-117,-42,-17,-1,2,1,-6,7,1,4,1,5,-11,11,0,-3,5,2,0,-13,28,-3,0,3,3,0,-1,-1,0,-1,1,3,-1
KR_6636576915,420,2,2,8,-7,0,1,1,-3,4,1,1,2,3,-3,5,2,-2,2,0,0,-10,3,-2,-3,5,1,0,0,-1,-1,0,1,3,-1
KR_6693439427,420,-7,-116,-19,-17,-4,4,0,-2,4,2,-3,5,2,-7,8,1,-1,1,0,0,-13,-23,-1,-2,3,-1,0,-3,-1,-1,-1,-1,1,-1
KR_6732501754,440,-2,-77,0,-3,-3,5,2,1,0,1,-4,5,1,1,0,1,2,0,2,0,-3,-58,-7,0,7,30,0,0,0,-1,-1,1,0,-1
KR_6764023738,420,-2,-54,5,-12,-1,4,3,-3,4,1,-3,3,0,-7,8,1,2,0,2,-1,-9,-3,-4,-1,5,0,0,-1,-1,-1,-1,-1,2,-1
KR_6691331269,440,-1,-27,-28,1,-8,8,0,0,2,2,-3,4,1,8,2,10,4,0,4,0,15,2,5,-7,2,0,0,0,1,-1,-1,1,1,-1
KR_6744411049,420,2,49,-13,0,2,0,2,-1,2,1,-2,3,1,3,3,6,-2,2,0,0,-3,-1,-4,-1,5,0,0,2,0,1,1,1,0,-1
KR_6651200283,420,2,-8,13,6,0,1,1,6,0,6,0,0,0,1,1,2,-1,2,1,2,10,309,-1,-4,5,-2,0,0,1,1,0,1,4,-1
KR_6647083909,420,0,-17,20,-5,-1,1,0,-1,2,1,-8,9,1,4,0,4,1,0,1,0,-5,-5,-2,-2,4,-3,0,-1,-1,0,-1,-1,3,-1
KR_6693119223,420,-2,-48,20,-2,-6,6,0,3,0,3,-5,6,1,3,3,6,3,0,3,-1,0,20,4,-4,0,-1,0,0,-1,1,-1,-1,1,-1
KR_6575724956,420,1,45,-10,-2,1,0,1,3,2,5,1,1,2,-4,5,1,-3,4,1,0,-8,40,-2,-6,8,-33,0,1,-1,0,1,-1,6,-1
KR_6160196289,420,2,11,17,3,2,1,3,1,3,4,2,0,2,-1,4,3,-1,2,1,0,-7,-2,-2,-3,5,0,0,0,1,1,1,-1,5,-1
KR_6713104799,440,-7,-147,-12,-15,-1,1,0,0,1,1,-5,6,1,-7,8,1,-2,2,0,-1,-17,11,-6,-1,7,1,0,-2,-1,-1,-1,-1,1,-1
KR_6750239248,420,2,-6,33,-1,1,1,2,-8,9,1,4,0,4,2,0,2,0,2,2,0,-12,-1,0,-1,1,2,0,1,1,1,1,-1,5,-1
KR_6621599021,420,-4,-59,24,-13,-3,3,0,4,2,6,-2,2,0,-10,12,2,-2,3,1,0,-5,-16,-6,0,6,4,0,0,-1,1,-1,-1,2,-1
KR_6733771414,420,0,10,20,3,2,0,2,2,1,3,-3,5,2,0,2,2,2,1,3,1,1,-129,5,-7,2,-4,0,0,-1,1,0,1,2,-1
KR_6589644550,440,-6,-79,-20,-7,-1,2,1,-7,7,0,2,0,2,-3,3,0,2,2,4,0,-6,-1,4,-8,4,4,0,0,1,-1,0,1,2,-1
KR_6729306952,420,-8,-18,-79,-13,-3,3,0,-10,10,0,0,1,1,1,2,3,-1,1,0,-1,-14,-2,-1,-1,2,3,0,-4,-1,-1,-1,-1,5,-1
KR_6719118392,440,-2,-67,-36,-5,0,1,1,-2,3,1,-1,2,1,0,1,1,-2,2,0,0,-3,-4,-2,-2,4,-2,0,-1,0,1,-1,-1,0,-1
KR_6644367742,420,-4,-47,-9,-7,-2,3,1,-2,2,0,-4,5,1,1,1,2,0,0,0,0,-12,-4,0,-3,3,-1,0,0,-1,1,0,1,5,-1
KR_6689976497,440,0,-28,-2,3,0,3,3,3,1,4,1,2,3,0,2,2,-1,2,1,0,3,-7,1,-2,1,2,0,-1,1,1,-1,-1,6,-1
KR_6374307338,420,-2,-94,15,-4,0,1,1,-1,4,3,1,1,2,-3,3,0,-1,1,0,0,-2,0,0,0,0,0,0,-3,-1,-1,-1,-1,3,-1
KR_6742103518,420,0,-14,12,2,-5,5,0,2,2,4,2,1,3,1,3,4,2,2,4,0,9,-23,2,-6,4,6,0,0,-1,-1,-1,1,1,-1
KR_6632191520,420,3,40,11,4,4,1,5,1,2,3,2,1,3,0,2,2,-3,3,0,0,-2,0,-2,-2,4,-2,0,1,1,1,1,1,4,-1
KR_6653317992,420,2,60,-24,3,6,1,7,-1,3,2,-3,5,2,-1,1,0,2,0,2,0,1,5,-1,-3,4,1,0,0,-1,1,0,1,2,-1
KR_6647095153,420,0,11,-36,10,1,1,2,4,0,4,4,0,4,2,0,2,-1,2,1,0,10,9,1,-2,1,0,0,-1,1,-1,-1,1,4,-1
KR_6637992997,420,-4,-68,-3,-14,0,3,3,-1,4,3,-5,7,2,-5,6,1,-3,4,1,0,-10,-1,0,-4,4,-2,0,-2,0,-1,-1,1,0,-1
KR_5998258528,440,-6,-91,-24,-12,0,3,3,-7,8,1,1,2,3,-3,3,0,-3,3,0,-1,-23,-175,-4,-1,5,9,0,-1,-1,-1,-1,-1,4,-1
KR_6649227342,420,2,-37,-24,6,2,1,3,-1,2,1,-3,4,1,4,5,9,4,0,4,1,5,-3,1,-2,1,0,0,-1,-1,1,-1,1,1,-1
KR_6756270795,420,-3,11,-71,-2,3,2,5,-2,2,0,-1,6,5,1,2,3,-3,4,1,0,-1,85,0,-3,3,1,0,0,0,0,0,-1,0,-1
KR_6729207873,420,-2,-65,-24,1,0,1,1,1,2,3,-1,1,0,-2,4,2,3,1,4,0,5,310,1,-4,3,0,0,0,-1,1,0,-1,6,-1
KR_6680563557,420,-1,-4,24,3,-2,3,1,6,1,7,2,0,2,0,2,2,-3,3,0,0,3,121,0,-1,1,-2,0,-1,1,-1,-1,1,2,-1
KR_6647457675,420,-6,-69,8,-14,-1,4,3,-10,10,0,-1,4,3,-2,4,2,0,0,0,1,-12,2,2,-4,2,-3,0,-1,-1,-1,-1,1,2,-1
KR_6730832796,420,-5,-78,-12,-11,-2,4,2,0,3,3,-1,4,3,-5,8,3,-3,3,0,0,-14,2,-2,-2,4,-8,0,-1,-1,0,-1,-1,1,-1
KR_6695673188,420,-1,-27,-13,5,-1,2,1,-3,3,0,0,3,3,7,0,7,2,1,3,0,6,-9,1,-4,3,0,0,1,-1,-1,1,1,4,-1
KR_6751980769,440,0,2,12,-3,2,3,5,1,1,2,1,1,2,-3,3,0,-4,6,2,0,-7,-5,-1,-1,2,-2,0,1,0,1,1,-1,0,-1
KR_6738672397,440,-4,-62,-32,-11,-1,1,0,-8,8,0,0,2,2,3,1,4,-5,6,1,0,-3,-1,1,-6,5,2,0,-1,0,1,-1,-1,0,-1
KR_6741131668,440,-2,-68,-40,2,2,1,3,-6,6,0,1,1,2,6,2,8,-1,1,0,-1,-2,4,1,-2,1,-5,0,-1,-1,1,-1,-1,3,-1
KR_6702024743,420,0,-7,12,0,-2,5,3,-1,2,1,3,2,5,1,3,4,-1,1,0,0,-8,-11,-2,-3,5,5,0,-3,-1,1,-1,-1,1,-1
KR_6727793327,420,1,17,-8,-7,0,1,1,-1,2,1,-2,2,0,-1,2,1,-3,4,1,0,-8,-11,3,-4,1,1,0,0,-1,-1,0,-1,1,-1
KR_6728036197,440,-2,-121,8,2,2,3,5,1,0,1,2,0,2,-6,7,1,3,2,5,2,8,-1,1,-2,1,-1,0,-1,1,0,-1,1,4,-1
KR_6685202943,420,-4,-12,28,-2,-1,2,1,1,1,2,5,2,7,-6,6,0,-1,1,0,0,-11,6,4,-6,2,-1,0,0,-1,1,1,-1,3,-1
KR_6724042018,440,-9,-109,-20,-14,-1,2,1,-4,5,1,-2,4,2,-1,3,2,-6,6,0,0,-7,-20,-5,0,5,1,0,-2,-1,-1,-1,-1,4,-1
KR_6694308471,440,-1,-56,-23,-3,4,0,4,1,2,3,-4,4,0,-4,6,2,0,0,0,0,-1,20,-2,-4,6,0,0,0,-1,0,0,-1,2,-1
KR_6760261314,440,-3,3,-12,-13,-3,5,2,-2,2,0,-1,3,2,-4,4,0,-3,3,0,0,-10,-6,1,-1,0,2,0,-1,-1,-1,-1,-1,3,-1
KR_6740959118,440,2,70,-22,5,3,2,5,-2,3,1,1,0,1,1,1,2,2,2,4,0,1,12,0,-1,1,2,0,0,-1,-1,0,1,5,-1
KR_6707630422,420,-6,-12,-8,-16,-1,2,1,-4,4,0,-5,5,0,-4,4,0,-2,2,0,0,-18,-3,0,-1,1,-2,0,-3,-1,-1,-1,-1,5,-1
KR_6750690420,440,-4,-34,-24,-8,-3,5,2,-3,4,1,2,0,2,-4,6,2,0,0,0,-1,-7,-3,-2,-1,3,1,0,-2,-1,-1,-1,-1,4,-1
KR_6705555152,420,-5,-17,0,-12,-2,4,2,0,3,3,-3,4,1,-6,6,0,-1,1,0,0,-7,7,4,-7,3,-1,0,0,-1,-1,0,-1,6,-1
KR_6735011132,420,5,38,54,1,1,2,3,-7,8,1,3,2,5,3,0,3,1,0,1,0,0,-100,0,-2,2,1,0,0,0,-1,0,-1,0,-1
KR_6740808748,420,-4,-63,-13,-6,-2,3,1,2,3,5,-4,5,1,2,0,2,-4,5,1,0,-7,298,-3,0,3,1,0,-2,-1,-1,-1,1,4,-1
KR_6674428937,440,-3,-72,-40,-12,-4,4,0,0,2,2,-1,2,1,-6,7,1,-1,2,1,0,-8,3,1,-4,3,2,0,-3,-1,-1,-1,-1,3,-1
KR_6652382660,420,-1,7,0,-3,-1,3,2,2,0,2,4,0,4,-4,6,2,-4,6,2,-1,1,21,1,-4,3,-18,0,-1,0,1,-1,-1,0,-1
KR_6745805556,420,-2,30,19,-16,-7,8,1,-1,1,0,-2,5,3,-8,9,1,2,1,3,-3,-26,-4,-2,-1,3,1,0,-1,-1,-1,-1,-1,1,-1
KR_6513755292,420,-2,2,4,-11,0,1,1,-8,10,2,-1,4,3,-2,4,2,0,0,0,0,-11,-6,-6,0,6,5,0,0,-1,1,-1,-1,2,-1
KR_6742989621,440,-4,-18,-29,-3,1,4,5,0,2,2,4,0,4,-6,8,2,-2,3,1,0,-9,-21,-4,-1,5,-5,0,-1,-1,-1,-1,-1,5,-1
KR_6713234637,420,-2,-50,28,-9,-3,3,0,-1,3,2,-2,4,2,-2,2,0,-1,1,0,0,-10,-1,0,-6,6,2,0,0,-1,-1,0,-1,5,-1
KR_6397578525,420,-2,-40,-10,-4,-1,2,1,-2,6,4,-5,5,0,2,1,3,2,0,2,0,3,-2,-2,-3,5,-1,0,0,-1,0,0,-1,3,-1
KR_6763597014,420,1,28,16,0,2,1,3,-4,6,2,2,1,3,-1,4,3,1,1,2,0,-4,-13,-2,-2,4,1,0,-1,-1,-1,-1,1,3,-1
KR_6498961992,420,-2,-21,-4,-7,0,1,1,3,1,4,-4,4,0,-5,6,1,-1,1,0,0,-6,-24,-6,-2,8,30,0,0,-1,-1,0,1,4,-1
KR_6421217457,420,-3,-12,-23,-6,3,3,6,-1,4,3,-5,5,0,-2,2,0,-1,2,1,0,-8,-23,0,-5,5,0,0,0,-1,1,-1,1,6,-1
KR_6727506328,440,-3,-34,-3,-8,-1,2,1,-3,3,0,3,1,4,-6,8,2,-1,1,0,0,-13,0,5,-7,2,-3,0,-1,-1,-1,-1,1,3,-1
KR_6077587682,420,-2,8,-32,-5,-1,2,1,0,3,3,-1,2,1,-4,5,1,1,2,3,0,-1,-4,-1,-4,5,-1,0,-1,1,-1,-1,1,3,-1
KR_6728000844,420,-6,-85,4,-12,-8,8,0,1,3,4,-6,6,0,0,2,2,1,1,2,0,-1,-11,-6,0,6,-1,0,-2,0,1,-1,1,0,-1
KR_6760989909,420,-2,33,-2,-7,-1,1,0,-4,4,0,-5,5,0,3,0,3,0,0,0,0,-4,-2,-4,0,4,2,0,-1,1,-1,-1,1,1,-1
KR_6730740089,420,-3,-33,-8,-4,1,0,1,0,2,2,3,1,4,-8,8,0,0,1,1,0,-6,-123,-2,-2,4,4,0,0,-1,1,0,1,4,-1
KR_6738526338,420,-2,2,-4,-5,-1,2,1,0,3,3,1,2,3,-3,4,1,-2,2,0,0,-7,14,1,-2,1,-2,0,0,-1,-1,-1,-1,2,-1
KR_6763778499,420,0,-4,-16,-7,-4,5,1,-2,7,5,-1,1,0,1,1,2,-1,1,0,0,-6,2,2,-3,1,0,0,-3,1,-1,-1,1,4,-1
KR_6759171097,440,0,-42,20,-11,-5,5,0,-4,7,3,-1,3,2,-2,4,2,1,0,1,-1,-12,32,-3,-2,5,-11,0,0,1,0,0,-1,4,-1
KR_6677461231,420,0,-19,-30,-3,-1,3,2,1,2,3,-4,6,2,0,3,3,1,4,5,0,2,3,3,-5,2,-1,0,-1,1,-1,-1,-1,3,-1
KR_6630631024,420,-4,6,7,-5,-1,1,0,-8,8,0,-2,3,1,3,1,4,3,0,3,0,-2,-4,-1,-4,5,2,0,-1,1,-1,-1,-1,4,-1
KR_6655919195,420,-2,-81,36,-5,-9,10,1,4,0,4,2,3,5,-3,6,3,1,0,1,-1,2,-13,1,-2,1,-1,0,-1,-1,-1,-1,-1,4,-1
KR_6678821764,440,-1,16,-60,9,-6,7,1,1,1,2,2,1,3,11,1,12,1,0,1,1,17,7,-1,-1,2,-1,0,-1,0,-1,1,1,0,-1
KR_6717544589,420,-1,67,40,-1,-2,3,1,-3,6,3,0,2,2,2,1,3,2,0,2,0,-2,3,0,-2,2,-1,0,0,1,1,0,1,5,-1
KR_6562158077,420,-3,37,-25,-7,1,3,4,-6,6,0,1,0,1,-1,1,0,-2,2,0,0,-7,-395,-3,-1,4,0,0,0,-1,-1,-1,-1,3,-1
KR_6749168493,420,-8,-92,-85,-12,1,1,2,-7,8,1,1,1,2,-6,6,0,-1,1,0,0,-10,-11,-3,-1,4,0,0,-2,0,-1,-1,-1,0,-1
KR_6484252112,420,-2,41,4,-6,2,1,3,-7,7,0,0,2,2,-2,2,0,1,0,1,0,-16,-183,-3,-2,5,5,0,1,-1,-1,1,-1,2,-1
KR_6741087070,440,-3,-90,-8,-5,3,0,3,4,0,4,-6,6,0,-1,1,0,-5,5,0,-1,3,8,-3,-2,5,2,0,1,1,0,-1,-1,6,-1
KR_6757306596,420,3,24,18,0,-1,1,0,2,1,3,3,1,4,-1,3,2,-3,4,1,0,0,108,-2,-4,6,-1,0,1,-1,1,1,1,6,-1
KR_6716508646,420,-1,75,-16,4,-1,2,1,0,3,3,4,1,5,0,1,1,1,1,2,0,3,-25,1,-6,5,4,0,0,1,-1,0,1,2,-1
KR_6424377348,420,-2,6,0,-3,-1,2,1,-5,6,1,0,1,1,3,1,4,0,2,2,0,-1,-19,-4,-2,6,3,0,0,1,-1,0,1,5,-1
KR_6669960069,440,1,12,0,-11,-4,5,1,-5,7,2,-1,1,0,-3,4,1,2,0,2,0,-6,2,0,-3,3,0,0,0,-1,-1,0,-1,4,-1
KR_6706194469,420,-4,-65,-12,-8,-1,2,1,-4,4,0,-2,2,0,-1,5,4,0,1,1,0,-3,-1,-1,0,1,-2,0,-1,-1,1,-1,-1,3,-1
KR_6740166531,440,0,-2,24,0,0,0,0,1,2,3,-3,7,4,0,2,2,2,0,2,0,1,27,-1,-3,4,-1,0,0,1,-1,1,-1,4,-1
KR_6622838557,440,-6,-42,-27,5,7,0,7,-4,5,1,6,2,8,-4,4,0,0,0,0,1,-3,-2,-1,0,1,0,0,-1,-1,-1,-1,1,3,-1
KR_6530521153,420,-2,-18,-12,0,0,4,4,0,0,0,1,3,4,-1,2,1,0,1,1,0,2,-12,-4,0,4,1,0,-1,-1,-1,-1,-1,2,-1
KR_6727028364,420,-2,-4,-26,-1,-1,1,0,-3,3,0,2,3,5,2,2,4,-1,2,1,0,4,-4,-2,-7,9,-1,0,0,1,-1,-1,1,3,-1
KR_6690995341,440,-1,51,-20,8,-2,3,1,5,3,8,0,3,3,5,0,5,0,2,2,1,18,-1,0,-5,5,-5,0,0,1,1,0,1,4,-1
KR_5538489086,420,-2,-80,-18,-4,0,1,1,-1,1,0,-1,4,3,-2,3,1,0,1,1,0,-2,16,-2,-1,3,0,0,-1,-1,-1,-1,-1,4,-1
KR_6661081212,420,-2,-51,-41,-13,-2,2,0,-2,3,1,-5,5,0,0,1,1,-4,4,0,0,-7,-26,-2,-2,4,-4,0,0,0,-1,0,-1,0,-1
KR_6756220809,440,3,5,-20,2,0,1,1,0,0,0,1,5,6,5,0,5,-4,5,1,0,2,11,0,-1,1,0,0,1,-1,-1,1,1,2,-1
KR_6750079261,440,0,-17,-24,0,4,0,4,5,2,7,-5,5,0,-2,3,1,-2,3,1,-1,-6,0,-6,-1,7,3,0,-1,-1,-1,-1,-1,6,-1
KR_6724416572,420,5,92,36,3,2,1,3,0,2,2,1,1,2,-1,2,1,1,3,4,0,-7,-3,0,0,0,7,0,0,1,-1,0,1,2,-1
KR_6756846063,420,0,-28,-12,1,0,3,3,2,0,2,2,3,5,-2,2,0,-1,1,0,0,1,-126,-2,-3,5,3,0,0,1,-1,-1,-1,2,-1
KR_6606127029,420,0,-15,-16,4,2,1,3,0,2,2,0,3,3,1,3,4,1,0,1,0,6,-2,-5,0,5,3,0,-1,1,-1,1,1,2,-1
KR_6613761389,420,-1,-27,-23,-9,-5,6,1,-2,4,2,-5,5,0,1,2,3,2,1,3,0,-2,1,3,-7,4,0,0,-1,1,-1,-1,1,3,-1
KR_6756487672,420,-3,-36,16,-8,-1,5,4,2,0,2,-3,5,2,-5,6,1,-1,1,0,0,-8,8,2,-3,1,-5,0,-2,-1,-1,-1,1,4,-1
KR_6534557663,420,-4,-73,10,-7,3,1,4,0,2,2,1,4,5,-5,10,5,-6,6,0,0,-7,-5,2,-4,2,-1,0,0,1,1,-1,-1,1,-1
KR_6510749631,420,-7,-127,3,1,1,1,2,-3,9,6,4,0,4,0,0,0,-1,2,1,0,-1,2,1,-5,4,-1,0,-3,1,1,-1,-1,3,-1
KR_6729537140,440,1,-37,-44,-1,0,1,1,1,1,2,-3,4,1,-1,1,0,2,0,2,0,1,18,0,-3,3,0,0,0,-1,-1,-1,-1,3,-1
KR_6001515908,420,-5,-59,-19,-5,-4,5,1,5,0,5,-3,4,1,-3,4,1,0,1,1,1,-2,9,3,-5,2,0,0,0,1,-1,0,1,4,-1
KR_6731723706,440,1,-33,24,7,0,2,2,0,2,2,0,1,1,-1,2,1,8,0,8,0,6,-39,4,-5,1,21,0,0,-1,-1,0,1,1,-1
KR_6601278328,420,-3,-91,-41,1,2,0,2,0,1,1,4,0,4,-6,6,0,1,0,1,0,-2,-5,4,-6,2,-1,0,0,-1,0,0,-1,6,-1
KR_6605246537,420,-5,-10,-20,-1,-1,2,1,2,2,4,0,2,2,-2,2,0,0,1,1,0,5,-15,-3,-3,6,3,0,0,1,-1,0,1,5,-1
KR_6717852526,440,-1,-34,31,-5,2,1,3,-2,4,2,-5,5,0,0,0,0,0,0,0,0,-6,-48,-5,-1,6,-1,0,-1,-1,0,-1,-1,4,-1
KR_6752135141,420,-2,-80,-15,-3,3,0,3,-1,2,1,-4,5,1,-1,2,1,0,0,0,0,0,139,3,-5,2,-2,0,-1,-1,1,1,-1,3,-1
KR_6744834834,420,-4,-83,7,-8,-1,1,0,-1,2,1,-4,4,0,-2,2,0,0,0,0,0,-9,-105,-1,-2,3,-1,0,-1,-1,1,-1,-1,2,-1
KR_6732270922,440,0,38,-18,0,-1,1,0,5,1,6,-2,3,1,-1,1,0,-1,2,1,0,1,-6,-4,-3,7,3,0,0,0,-1,-1,-1,0,-1
KR_6710036156,420,-2,-6,30,0,0,0,0,1,2,3,-1,2,1,0,3,3,0,2,2,0,0,45,-3,-3,6,-30,0,1,-1,1,1,1,2,-1
KR_6577956369,420,1,-32,104,-3,-1,1,0,1,0,1,-9,11,2,5,0,5,1,0,1,0,3,23,0,-2,2,0,0,2,1,1,1,1,6,-1
KR_6374431021,420,-2,-65,-19,1,0,1,1,3,6,9,0,4,4,0,1,1,-2,2,0,0,0,0,0,0,0,-6,0,-1,1,-1,-1,-1,5,-1
KR_6674573488,420,-3,-5,7,-9,1,0,1,1,3,4,-3,3,0,-2,3,1,-6,7,1,0,-5,-3,-3,-2,5,-2,0,-1,1,-1,-1,-1,3,-1
KR_6753584492,440,-3,-43,-17,-7,-4,4,0,1,3,4,-1,4,3,-1,2,1,-2,3,1,0,-1,115,-5,-2,7,5,0,-1,0,1,-1,-1,0,-1
KR_6733337871,420,-1,8,8,-6,-5,6,1,-1,4,3,-1,1,0,1,0,1,0,1,1,0,-8,11,0,-3,3,-1,0,1,-1,1,1,-1,2,-1
KR_6716971091,420,-1,-7,4,3,1,1,2,1,2,3,-2,3,1,2,3,5,1,1,2,0,0,313,4,-6,2,-2,0,0,0,-1,-1,1,0,-1
KR_6276838835,420,-3,-64,-17,-17,-3,4,1,-2,3,1,-11,11,0,-2,2,0,1,0,1,0,2,11,-1,-1,2,4,0,-3,-1,-1,-1,-1,5,-1
KR_6739194077,420,-1,-52,27,-2,-2,2,0,-1,1,0,2,2,4,-1,1,0,0,0,0,0,-4,-37,3,-3,0,18,0,-2,1,-1,-1,1,4,-1
KR_6622465954,420,0,25,-8,2,-4,6,2,2,0,2,3,2,5,2,1,3,-1,1,0,0,4,15,6,-7,1,-3,0,-1,0,0,-1,-1,0,-1
KR_6551510647,420,-2,-5,-4,-4,0,0,0,-2,5,3,-1,3,2,0,0,0,-1,1,0,0,-9,-160,-3,-1,4,-1,0,0,-1,1,0,1,2,-1
KR_6749825780,440,1,22,20,1,-1,2,1,1,2,3,3,0,3,-3,5,2,1,1,2,0,-1,31,0,-4,4,-23,0,1,1,1,1,1,6,-1
KR_6740968828,420,0,-41,4,2,0,1,1,2,2,4,1,0,1,2,0,2,-3,4,1,0,3,-98,4,-6,2,-2,0,0,0,1,0,1,0,-1
KR_6679843186,420,0,33,17,4,0,2,2,7,1,8,-1,4,3,2,1,3,-4,4,0,0,3,3,0,-2,2,1,0,-1,1,-1,-1,1,1,-1
KR_5967905840,420,-1,-33,0,-1,-3,3,0,3,2,5,2,1,3,-3,4,1,0,1,1,0,2,15,1,-4,3,-4,0,0,-1,-1,0,-1,2,-1
KR_6621313382,420,-4,-6,-8,-9,-1,3,2,-6,6,0,2,4,6,-2,4,2,-2,2,0,0,-10,-110,2,-4,2,-1,0,0,-1,1,0,-1,5,-1
KR_6756126249,420,0,13,-12,-1,-3,3,0,2,1,3,-3,4,1,2,4,6,1,2,3,0,10,-5,4,-6,2,0,0,-1,1,1,-1,1,6,-1
KR_6636959355,420,0,76,0,-2,-3,6,3,1,0,1,1,0,1,-3,5,2,2,0,2,-1,-4,25,-1,0,1,3,0,1,0,-1,1,-1,0,-1
KR_6696220207,420,-3,-52,-4,-6,-2,5,3,-1,4,3,2,1,3,-3,4,1,-2,4,2,0,-7,-393,4,-7,3,1,0,0,-1,0,-1,-1,6,-1
KR_6754050243,420,1,53,-26,0,2,0,2,-4,5,1,3,2,5,0,3,3,-1,2,1,0,-7,-4,-3,-2,5,0,0,-1,1,-1,-1,-1,1,-1
KR_6761983507,420,-4,-79,-13,-10,-8,8,0,-4,5,1,0,4,4,-2,5,3,4,0,4,0,-4,-1,-4,-2,6,-2,0,1,-1,-1,1,-1,2,-1
KR_6595587956,420,-4,-55,-14,-11,-3,4,1,-6,7,1,-1,5,4,-1,1,0,0,1,1,2,-8,2,0,-2,2,0,0,-2,1,-1,-1,1,3,-1
KR_6595665062,420,-4,-56,-3,-8,0,4,4,-1,4,3,-2,5,3,-4,4,0,-1,2,1,-1,-9,175,-2,-3,5,-1,0,0,-1,-1,0,-1,2,-1
KR_6381282578,420,-1,30,-56,-1,-1,1,0,0,4,4,-2,3,1,1,0,1,1,0,1,0,1,5,0,-5,5,1,0,0,-1,1,-1,-1,5,-1
KR_6659297613,420,-5,-77,-24,-8,0,2,2,2,2,4,4,1,5,-14,14,0,0,1,1,-1,-11,-3,-3,-1,4,-2,0,-2,-1,-1,-1,-1,4,-1
KR_6658516517,420,-3,-93,-21,-7,0,1,1,-3,5,2,-1,2,1,-3,6,3,0,1,1,0,-3,-7,-4,-2,6,-4,0,-1,-1,-1,-1,-1,6,-1
KR_6700412728,420,0,-11,-7,-1,-2,3,1,-2,3,1,6,1,7,-1,2,1,-2,2,0,0,-2,-10,1,-5,4,-5,0,-1,-1,-1,-1,1,3,-1
KR_6508117920,420,0,18,0,1,3,0,3,-1,1,0,-3,4,1,1,2,3,1,0,1,0,0,-376,-2,-2,4,1,0,-1,-1,-1,-1,-1,1,-1
KR_6640621389,420,-1,3,-16,-5,-2,3,1,-1,1,0,-1,3,2,0,1,1,-1,1,0,0,-6,-3,1,-4,3,2,0,0,-1,-1,-1,-1,4,-1
KR_6667306284,420,-2,-52,0,-1,-1,1,0,2,0,2,-3,3,0,1,0,1,0,0,0,0,4,0,2,-5,3,-5,0,0,0,1,0,1,0,-1
KR_6485040536,420,0,-87,34,-2,-2,3,1,1,4,5,1,2,3,-2,2,0,0,1,1,0,2,21,-4,-1,5,1,0,-1,-1,-1,-1,-1,1,-1
KR_6593907707,420,-3,-46,0,-9,-3,5,2,-9,9,0,-2,3,1,1,0,1,4,0,4,0,-7,2,-2,-1,3,2,0,-1,-1,-1,-1,-1,3,-1
KR_6113309111,420,-5,14,-10,-11,1,0,1,-3,5,2,2,0,2,-9,9,0,-2,2,0,0,-9,20,-10,-3,13,1,0,-1,-1,-1,-1,-1,3,-1
KR_6759646627,440,-3,-52,-4,-13,-3,3,0,-4,5,1,1,0,1,-5,6,1,-2,2,0,0,-15,24,-2,-5,7,4,0,0,0,-1,0,1,0,-1
KR_6702301856,420,-3,-65,-12,0,-1,2,1,-2,4,2,0,1,1,2,1,3,1,1,2,0,4,15,3,-6,3,-2,0,0,-1,1,-1,1,6,-1
KR_6726319346,420,2,30,39,6,3,0,3,3,1,4,-2,5,3,3,0,3,-1,1,0,0,-3,17,4,-5,1,-3,0,1,1,0,1,-1,2,-1
KR_6736004367,420,-2,-70,4,1,-6,6,0,8,2,10,4,1,5,-4,5,1,-1,2,1,0,0,-2,-3,-1,4,1,0,-2,-1,-1,-1,-1,1,-1
KR_6701519713,420,1,12,24,-6,1,0,1,-1,2,1,1,1,2,-4,8,4,-3,4,1,0,-14,10,-5,-3,8,1,0,0,-1,1,0,-1,4,-1
KR_6705148271,440,3,55,0,4,7,0,7,4,0,4,-4,4,0,-2,2,0,-1,1,0,-1,-1,-56,-4,-1,5,11,0,1,-1,-1,1,-1,6,-1
KR_6732659483,440,-3,36,-13,-9,-4,5,1,-3,3,0,-4,5,1,0,2,2,2,0,2,0,-3,11,2,-3,1,0,0,0,1,-1,1,-1,5,-1
KR_6433228995,420,-1,-1,5,2,-9,10,1,-1,1,0,1,0,1,10,0,10,1,0,1,1,11,6,-5,-4,9,-1,0,0,0,0,1,1,0,-1
KR_6670166868,420,-8,-50,-8,-17,-2,3,1,-7,7,0,-3,4,1,-4,5,1,-1,3,2,0,-20,43,-2,-2,4,-24,0,-1,1,-1,-1,1,6,-1
KR_6497585409,420,0,47,12,-7,2,1,3,-9,10,1,-3,3,0,1,4,5,2,0,2,0,-6,40,-2,-3,5,-11,0,0,1,-1,-1,-1,1,-1
KR_6737524162,440,0,-5,2,-6,-1,3,2,0,3,3,0,4,4,-7,7,0,2,0,2,-1,-4,-10,-1,-2,3,3,0,-1,1,-1,-1,-1,6,-1
KR_6596855990,440,1,-23,-8,0,1,1,2,-1,4,3,3,2,5,-3,7,4,0,0,0,0,-1,-268,-2,-2,4,1,0,1,-1,-1,1,-1,2,-1
KR_6757684159,440,-3,-65,-16,-4,-3,4,1,-1,1,0,2,0,2,1,2,3,-3,4,1,0,-6,7,-2,-3,5,1,0,0,-1,0,-1,-1,1,-1
KR_6677569925,420,-2,-32,-16,0,0,1,1,1,1,2,-5,9,4,6,0,6,-2,3,1,1,6,-32,-3,-4,7,2,0,0,-1,-1,0,1,5,-1
KR_6684989125,420,0,64,-19,-1,1,3,4,0,2,2,1,4,5,-1,4,3,-2,2,0,0,-2,-5,2,-6,4,0,0,-1,-1,1,-1,1,6,-1
KR_6724818235,420,-1,-34,-33,0,-2,5,3,2,0,2,4,1,5,-4,5,1,0,0,0,0,3,-4,3,-7,4,-1,0,0,-1,1,1,-1,1,-1
KR_6213436561,420,1,-1,-24,4,-5,5,0,2,2,4,-1,2,1,8,2,10,0,1,1,0,6,2,6,-8,2,-4,0,1,-1,1,1,-1,5,-1
KR_6741871954,420,-2,-66,-18,-6,0,0,0,5,0,5,-8,9,1,-3,4,1,0,2,2,-1,-8,-6,7,-8,1,-4,0,-1,1,0,-1,-1,3,-1
KR_6113803285,420,-7,-32,-40,-15,-2,5,3,-3,3,0,-7,7,0,-1,1,0,-2,4,2,0,-9,6,0,-2,2,-2,0,-2,-1,-1,-1,1,1,-1
KR_6740171332,420,-2,24,-22,-2,0,1,1,-1,1,0,0,5,5,-3,5,2,2,0,2,0,-4,15,2,-5,3,0,0,0,1,-1,0,1,1,-1
KR_6735554443,420,-3,-66,12,-10,2,3,5,2,3,5,-4,5,1,-5,6,1,-5,5,0,0,-13,74,5,-9,4,-19,0,-1,1,1,-1,1,5,-1
KR_6757635476,440,0,-21,15,-3,1,3,4,4,1,5,-3,5,2,-3,3,0,-2,3,1,0,3,-6,-2,-2,4,0,0,-1,-1,-1,-1,-1,5,-1
KR_6605087205,420,2,108,-8,5,3,0,3,-1,6,5,1,0,1,1,1,2,1,0,1,0,6,1,-1,-3,4,0,0,0,-1,-1,0,1,3,-1
KR_6433072154,420,-4,-5,-1,-8,-3,5,2,-3,3,0,-3,5,2,4,2,6,-3,3,0,0,0,334,1,-3,2,1,0,-1,-1,1,1,-1,3,-1
KR_6755848545,440,-4,-26,-13,-9,0,1,1,-2,5,3,-9,11,2,3,1,4,-1,3,2,0,-3,-116,-2,0,2,2,0,0,-1,-1,0,-1,2,-1
KR_6723843345,420,-5,-94,-12,-16,-6,7,1,-2,2,0,-5,5,0,-1,8,7,-2,2,0,0,-12,-26,0,-5,5,0,0,-2,-1,-1,-1,-1,4,-1
KR_6754139409,420,-2,14,4,-8,-1,2,1,-3,4,1,-2,3,1,0,1,1,-2,2,0,0,-6,-14,-4,-2,6,-2,0,-1,-1,1,-1,-1,3,-1
KR_6384292462,420,-2,-44,-1,-10,0,2,2,-1,2,1,-3,4,1,-5,6,1,-1,1,0,0,-13,-7,1,-5,4,0,0,-1,-1,-1,-1,-1,2,-1
KR_6750687102,420,0,5,4,-2,-2,3,1,1,3,4,-2,4,2,1,2,3,0,0,0,0,-1,-6,-3,-6,9,-1,0,0,-1,1,0,-1,4,-1
KR_5857629476,420,-4,-91,-48,-6,-4,4,0,0,3,3,0,2,2,-1,3,2,-1,2,1,0,0,-3,1,-3,2,-1,0,-1,-1,0,-1,-1,5,-1
KR_6267032995,420,-2,15,4,-5,-3,3,0,-3,6,3,2,0,2,0,4,4,-1,1,0,0,-6,2,4,-6,2,3,0,-1,0,-1,-1,-1,0,-1
KR_6740778624,420,-2,-51,-11,-8,0,2,2,-3,4,1,-1,2,1,-4,6,2,0,1,1,1,-11,1,-1,-2,3,3,0,-1,0,-1,-1,1,0,-1
KR_6609723608,420,-3,45,-24,-5,1,0,1,-2,4,2,2,1,3,-4,4,0,-2,2,0,0,-9,20,0,-4,4,-5,0,0,-1,-1,-1,-1,3,-1
KR_6739593655,420,3,-24,-16,12,3,2,5,1,4,5,4,1,5,4,0,4,0,1,1,0,8,-40,0,-2,2,13,0,-1,0,0,-1,1,0,-1
KR_6740409048,420,-1,43,-23,-6,-5,5,0,2,1,3,-1,3,2,-1,3,2,-1,1,0,0,-3,1,3,-6,3,-7,0,-1,-1,0,-1,-1,6,-1
KR_6347773129,420,-1,-25,24,0,0,3,3,-1,1,0,0,4,4,0,2,2,1,1,2,0,0,-6,1,-5,4,-2,0,-1,1,-1,-1,1,3,-1
KR_6754143029,420,-1,-29,-36,-5,-3,5,2,3,3,6,-5,10,5,4,1,5,-4,4,0,2,1,-1,-1,0,1,1,0,-1,1,-1,-1,1,6,-1
KR_6705833588,420,-2,-49,16,-11,-1,2,1,-1,3,2,-3,4,1,-4,6,2,-2,2,0,-1,-4,-7,2,-3,1,-1,0,0,-1,-1,0,-1,3,-1
KR_6715243200,440,2,18,12,4,3,3,6,2,0,2,0,6,6,-3,5,2,2,1,3,0,9,-2,-2,-2,4,2,0,2,1,1,1,1,5,-1
KR_6742513720,420,-3,-152,-30,3,3,1,4,-1,2,1,1,2,3,2,2,4,-2,3,1,-1,0,4,1,-3,2,-3,0,-1,0,0,-1,-1,0,-1
KR_6742779443,420,-6,-45,-19,-3,2,1,3,5,2,7,0,4,4,-10,10,0,0,1,1,-1,-5,7,2,-4,2,0,0,-1,1,1,1,-1,3,-1
KR_6327803414,420,3,49,2,0,2,2,4,-3,3,0,0,2,2,-3,7,4,4,1,5,0,3,3,-4,-1,5,2,0,1,-1,0,1,-1,1,-1
KR_6755813547,420,-8,-134,12,-5,-6,6,0,-1,5,4,-2,2,0,2,2,4,2,0,2,0,-3,-4,2,-6,4,2,0,-5,-1,-1,-1,1,4,-1
KR_6722975109,420,2,38,32,0,0,0,0,4,0,4,3,2,5,-6,6,0,-1,1,0,1,-5,-231,-2,-4,6,0,0,1,1,-1,1,1,1,-1
KR_6756146525,420,-5,-27,-69,-5,4,1,5,-6,6,0,0,0,0,-2,5,3,-1,2,1,1,-1,-1,3,-4,1,-5,0,-1,-1,-1,-1,1,1,-1
KR_6742723106,420,-3,-24,-15,1,3,0,3,0,4,4,3,0,3,-4,5,1,-1,3,2,-1,0,12,1,-2,1,-1,0,1,0,0,1,-1,0,-1
KR_6613354581,420,-2,0,-23,-5,0,1,1,-3,6,3,-1,4,3,-1,3,2,0,0,0,0,-2,-23,0,-1,1,3,0,-1,1,-1,-1,-1,4,-1
KR_6609428872,420,0,-21,-20,5,0,2,2,1,5,6,3,2,5,3,2,5,-2,2,0,-1,3,-9,-4,-1,5,1,0,-1,1,0,-1,-1,5,-1
KR_6719447225,420,-1,-70,5,3,-1,2,1,2,1,3,4,0,4,0,3,3,-2,2,0,0,-5,-4,2,-4,2,-1,0,-1,1,-1,-1,-1,4,-1
KR_6435085607,420,1,-48,-4,1,0,1,1,0,0,0,1,1,2,3,3,6,-3,4,1,0,0,31,-1,-2,3,-25,0,0,-1,0,0,-1,2,-1
KR_6751154117,440,-1,30,0,9,2,2,4,-5,6,1,0,3,3,1,1,2,11,0,11,2,8,-1,-4,-2,6,-3,0,-1,1,1,-1,1,3,-1
KR_6758089575,440,1,10,8,3,-1,1,0,2,0,2,-1,2,1,0,1,1,3,2,5,0,1,-148,-2,-4,6,3,0,-1,0,-1,-1,1,0,-1
KR_6751211663,420,2,122,4,0,-2,3,1,-4,4,0,2,0,2,5,1,6,-1,2,1,0,-1,9,-2,-3,5,0,0,0,1,-1,-1,1,1,-1
KR_6680617363,420,-3,7,-20,-6,-1,1,0,1,1,2,-4,4,0,-2,6,4,0,0,0,0,-7,-3,2,-5,3,-3,0,0,-1,1,0,-1,5,-1
KR_6746446259,420,1,12,4,-2,0,2,2,1,2,3,2,1,3,-4,6,2,-1,2,1,0,-4,22,7,-10,3,-3,0,1,-1,1,1,1,3,-1
KR_6759732282,420,1,-11,16,-6,4,1,5,1,0,1,3,1,4,-4,7,3,-10,10,0,0,-12,1,4,-6,2,-4,0,-1,-1,1,-1,-1,1,-1
KR_6732567759,440,1,24,-3,5,-3,4,1,7,2,9,-1,3,2,5,2,7,-3,3,0,1,5,-47,1,-6,5,6,0,0,1,-1,-1,1,4,-1
KR_6576871218,440,-3,18,-4,-8,-1,1,0,-3,3,0,-2,3,1,-1,3,2,-1,2,1,0,-8,0,0,-2,2,-4,0,0,-1,1,0,-1,5,-1
KR_6622062007,420,-6,-125,-33,-18,-4,5,1,-5,6,1,-2,2,0,-5,7,2,-2,3,1,-1,-13,-315,-1,-1,2,-2,0,-4,-1,-1,-1,-1,2,-1
KR_6753210454,420,-1,36,-24,-3,1,3,4,-1,2,1,-3,5,2,-3,3,0,3,1,4,0,-2,-4,2,-4,2,1,0,0,-1,1,-1,-1,6,-1
KR_6667214151,420,-4,-5,-56,-7,-2,3,1,-2,5,3,-1,2,1,-2,3,1,0,0,0,0,-3,-6,1,-1,0,0,0,0,-1,-1,0,-1,6,-1
KR_6648726419,440,-2,10,-134,-1,0,4,4,-2,2,0,5,1,6,-3,4,1,-1,2,1,0,1,10,5,-6,1,0,0,1,-1,-1,-1,-1,4,-1
KR_6633778200,420,-3,-48,4,-8,1,1,2,-4,8,4,-2,5,3,0,3,3,-3,3,0,0,-5,18,-4,-3,7,1,0,0,-1,-1,0,-1,2,-1
KR_6646001038,420,-2,-45,-6,-4,-3,3,0,0,0,0,1,6,7,-3,4,1,1,0,1,0,0,15,0,-5,5,7,0,0,1,0,0,-1,4,-1
KR_6695237317,420,-4,-44,-20,2,-2,3,1,4,1,5,-3,4,1,3,1,4,0,0,0,0,9,-22,-2,-2,4,1,0,-1,1,1,-1,1,5,-1
KR_6762505119,420,0,65,4,-2,1,0,1,7,1,8,-5,5,0,-2,4,2,-3,4,1,0,-7,307,-1,-1,2,-2,0,0,1,0,0,-1,5,-1
KR_6763331172,420,1,18,8,-3,1,1,2,-1,3,2,-4,6,2,1,1,2,0,2,2,0,2,6,3,-9,6,-3,0,-1,1,-1,-1,1,3,-1
KR_6526388337,420,-1,3,-29,0,1,3,4,-5,7,2,-1,5,4,3,3,6,2,0,2,-1,-2,40,0,-4,4,-11,0,-1,1,-1,-1,1,6,-1
KR_6686639249,420,-3,-13,-42,-3,-2,2,0,-4,6,2,3,0,3,0,1,1,0,0,0,0,-4,3,0,-2,2,3,0,-1,-1,-1,-1,1,3,-1
KR_6737672149,420,-3,-39,-17,-11,-4,4,0,1,0,1,0,5,5,-9,10,1,1,0,1,0,-8,24,-4,-2,6,1,0,-2,-1,1,-1,1,1,-1
KR_6713141739,440,-1,-19,-9,-10,3,0,3,-1,1,0,-5,7,2,-6,7,1,-1,1,0,0,-13,42,1,-2,1,-3,0,-1,-1,-1,-1,-1,6,-1
KR_6763453060,440,2,-39,22,2,10,0,10,2,1,3,-2,4,2,-3,5,2,-5,5,0,0,3,-10,-5,-1,6,0,0,1,1,-1,1,1,6,-1
KR_6689367096,420,-1,21,-2,-4,1,1,2,-3,4,1,2,0,2,-3,4,1,-1,2,1,0,-5,5,-2,-5,7,-3,0,0,-1,0,0,-1,6,-1
KR_6742023841,440,-5,-104,-4,-12,-3,3,0,0,0,0,-4,8,4,-3,3,0,-2,2,0,0,-8,0,0,-2,2,-3,0,-3,-1,-1,-1,-1,2,-1
KR_6755688339,420,0,68,-5,-4,3,2,5,-3,5,2,-1,2,1,-1,3,2,-2,2,0,0,-5,18,-2,0,2,-1,0,0,-1,1,0,-1,4,-1
KR_6567462080,440,2,44,8,5,-4,4,0,1,3,4,4,1,5,0,4,4,4,0,4,1,7,9,1,-5,4,-5,0,1,1,-1,1,1,2,-1
KR_6456245312,420,3,30,-16,8,1,1,2,3,1,4,1,0,1,1,3,4,2,0,2,0,5,-18,-3,-1,4,-2,0,1,-1,-1,-1,1,3,-1
KR_6749104788,420,-1,-27,-4,-5,-2,2,0,-3,5,2,0,1,1,0,3,3,0,1,1,0,-9,275,2,-4,2,-1,0,0,1,-1,0,1,4,-1
KR_6759565054,420,-6,-71,-20,-7,-2,4,2,-4,6,2,2,2,4,-2,2,0,-1,2,1,1,-9,2,-2,-2,4,0,0,0,-1,1,-1,1,4,-1
KR_6713654052,420,2,-29,19,4,1,1,2,5,0,5,-6,6,0,1,1,2,3,1,4,0,4,48,-1,-1,2,-14,0,1,1,1,1,-1,4,-1
KR_6692488232,420,-3,-15,-16,-14,0,2,2,-2,2,0,-4,4,0,-3,4,1,-5,6,1,-1,-10,-6,1,-3,2,1,0,0,-1,-1,0,-1,6,-1
KR_6658780495,420,0,12,-11,-1,-1,1,0,1,0,1,-1,1,0,0,1,1,0,1,1,0,2,2,1,-2,1,-4,0,0,1,-1,0,-1,1,-1
KR_6599372452,420,3,12,12,2,1,2,3,1,0,1,-1,5,4,2,1,3,-1,2,1,0,3,9,-1,-1,2,0,0,1,0,0,1,1,0,-1
KR_6713328665,420,-2,-58,-16,-10,-3,3,0,-3,4,1,2,3,5,-2,3,1,-4,5,1,0,-3,44,0,-1,1,-16,0,0,-1,-1,1,-1,2,-1
KR_6759127289,420,-1,-83,42,-3,-3,3,0,1,0,1,-6,6,0,2,0,2,3,0,3,0,1,-9,0,-3,3,0,0,-2,1,1,-1,-1,4,-1
KR_6371230226,420,-2,78,-32,3,3,1,4,-1,2,1,-1,2,1,2,2,4,0,2,2,0,4,0,0,0,0,0,0,1,-1,-1,1,1,5,-1
KR_6493519343,440,1,-1,23,2,0,4,4,7,1,8,-4,8,4,1,2,3,-2,3,1,0,7,-3,0,-3,3,0,0,2,-1,1,1,-1,5,-1
KR_6752738635,420,1,-8,16,0,1,3,4,1,2,3,2,4,6,-4,4,0,0,1,1,-1,4,-113,1,-4,3,2,0,-1,1,1,1,-1,4,-1
KR_6620049309,420,-1,36,12,-1,-1,2,1,1,1,2,-4,4,0,3,0,3,0,0,0,0,0,7,0,-3,3,0,0,1,-1,-1,1,-1,3,-1
KR_6681112742,420,-7,-136,-22,-16,-4,4,0,-8,9,1,-4,6,2,-1,7,6,1,1,2,0,-4,-9,1,-4,3,0,0,-3,0,-1,-1,1,0,-1
KR_6123345473,440,3,-26,16,10,1,2,3,-1,2,1,3,2,5,4,2,6,3,0,3,0,16,4,-1,-1,2,-2,0,0,-1,1,0,1,4,-1
KR_6740266000,420,3,43,-8,1,1,1,2,1,2,3,-1,3,2,1,2,3,-1,3,2,0,0,4,4,-6,2,-1,0,2,1,1,1,-1,4,-1
KR_6728700025,420,-3,-7,-37,-4,-4,5,1,2,1,3,-2,6,4,2,1,3,-2,4,2,1,7,-9,3,-5,2,0,0,0,-1,-1,-1,1,1,-1
KR_6712866719,420,-5,-40,-16,-16,-1,2,1,-1,3,2,-6,6,0,-9,9,0,1,0,1,0,-14,-10,1,-2,1,-2,0,-1,-1,1,-1,-1,5,-1
KR_6708443787,420,0,-54,7,-8,-3,5,2,0,4,4,-4,8,4,-3,4,1,2,2,4,1,-1,6,-4,-5,9,-3,0,-1,1,-1,-1,1,5,-1
KR_6746671066,440,-4,-27,-20,-12,0,2,2,-4,6,2,-2,6,4,-2,5,3,-4,5,1,0,-14,3,-3,-5,8,2,0,-1,1,-1,-1,-1,3,-1
KR_6679426951,420,1,78,-12,2,-1,1,0,-3,3,0,3,1,4,3,1,4,0,0,0,1,0,21,-1,-3,4,1,0,0,-1,0,0,1,3,-1
KR_6745841125,420,0,46,-21,2,-1,3,2,0,2,2,7,0,7,-4,7,3,0,2,2,0,-1,-5,4,-5,1,2,0,0,-1,0,0,1,4,-1
KR_6695560265,440,-3,-19,-24,-5,-8,8,0,2,3,5,-3,5,2,2,2,4,2,0,2,1,0,461,0,0,0,1,0,-3,1,1,-1,1,2,-1
KR_6731646241,420,1,-3,-32,5,-4,4,0,2,2,4,4,1,5,3,0,3,0,0,0,0,14,-217,-5,-1,6,7,0,-1,1,-1,-1,1,6,-1
KR_6567414063,420,-2,-4,-4,-8,-3,3,0,2,2,4,-4,5,1,-3,4,1,0,0,0,-2,-12,-36,4,-5,1,4,0,0,0,0,0,-1,0,-1
KR_6732558957,420,-3,-128,-27,-1,-1,4,3,0,3,3,4,2,6,-2,3,1,-2,3,1,1,9,-42,4,-8,4,5,0,-3,-1,-1,-1,1,6,-1
KR_6001680402,420,1,-5,26,-5,1,2,3,0,2,2,-1,1,0,-3,4,1,-2,4,2,0,-1,1,6,-7,1,-2,0,0,-1,1,0,-1,4,-1
KR_6695483190,420,0,-32,-20,-1,0,4,4,-5,5,0,2,2,4,2,2,4,0,1,1,0,-1,6,-1,-2,3,1,0,1,1,1,1,1,4,-1
KR_6621041645,440,-1,5,15,-8,-4,4,0,5,3,8,-1,3,2,-7,9,2,-1,1,0,-1,-14,-49,-4,-1,5,18,0,-1,-1,1,-1,-1,6,-1
KR_6160221844,420,-5,-59,24,-9,-1,4,3,-1,4,3,-9,9,0,0,3,3,2,0,2,0,-11,9,0,-5,5,-4,0,-2,-1,-1,-1,-1,1,-1
KR_6759108621,420,-4,-33,-52,-3,0,2,2,-2,2,0,0,3,3,0,1,1,-1,1,0,0,-3,-20,-3,-1,4,1,0,0,-1,0,0,-1,4,-1
KR_6730567650,420,-2,-43,12,-4,-1,1,0,0,3,3,0,3,3,-1,4,3,-2,7,5,0,-7,1,3,-7,4,-4,0,-1,1,1,-1,-1,5,-1
KR_6607160346,420,-8,-166,-35,-18,-6,8,2,-1,3,2,-8,9,1,-1,2,1,-2,3,1,0,-7,-15,-1,0,1,0,0,-5,-1,-1,-1,-1,3,-1
KR_6755968642,420,-3,4,20,-11,-1,3,2,2,1,3,-5,6,1,-6,8,2,-1,1,0,0,-10,-4,-1,0,1,0,0,-1,-1,1,-1,-1,3,-1
KR_6758122311,420,-1,-49,20,-10,-1,2,1,1,2,3,-3,4,1,-6,7,1,-1,1,0,0,-10,0,-2,-2,4,1,0,0,1,-1,-1,-1,1,-1
KR_6714164705,420,-3,-44,-13,-6,2,0,2,3,1,4,-2,3,1,-4,4,0,-5,6,1,0,-7,-37,1,-2,1,1,0,-2,-1,1,-1,-1,3,-1
KR_6703802506,420,-3,-2,4,-15,0,2,2,-2,4,2,-10,12,2,-2,2,0,-1,1,0,-3,-13,-13,-2,-3,5,6,0,-1,-1,1,-1,-1,2,-1
KR_6687792745,420,-2,38,-15,-7,0,2,2,2,2,4,-11,13,2,0,4,4,2,1,3,2,-1,3,5,-6,1,0,0,-1,1,-1,-1,1,5,-1
KR_6725528544,420,-2,-118,2,-1,-3,5,2,1,2,3,4,0,4,-1,2,1,-2,3,1,0,7,0,-1,-3,4,6,0,0,1,-1,-1,-1,3,-1
KR_6715580992,420,-5,-106,-24,-6,7,0,7,-4,4,0,-4,5,1,-1,1,0,-4,4,0,0,-7,134,-6,-1,7,9,0,0,-1,1,0,1,1,-1
KR_6630555858,420,2,-14,-18,3,0,4,4,-1,2,1,5,0,5,-1,2,1,0,0,0,0,-1,16,4,-6,2,1,0,0,-1,1,1,-1,4,-1
KR_6754072874,420,2,30,-15,1,2,0,2,4,1,5,-6,8,2,0,1,1,1,0,1,-1,5,2,0,0,0,1,0,0,-1,0,0,-1,5,-1
KR_6667307509,420,0,-53,-17,-1,1,0,1,-2,5,3,-1,1,0,0,0,0,1,0,1,0,-3,41,-2,-5,7,-1,0,-1,0,1,-1,1,0,-1
KR_6740340153,420,0,-45,-5,-3,5,0,5,-2,4,2,-5,5,0,-1,5,4,0,1,1,0,-4,0,1,-7,6,-5,0,0,1,1,-1,-1,1,-1
KR_6728736552,420,0,22,-44,0,3,3,6,1,2,3,-2,2,0,2,3,5,-4,5,1,-1,6,-9,-3,-1,4,-1,0,1,1,1,1,-1,1,-1
KR_6659725893,420,4,35,11,6,-4,7,3,3,2,5,3,0,3,4,0,4,0,1,1,0,12,-2,2,-8,6,0,0,0,-1,1,-1,1,4,-1
KR_6726582031,420,2,87,9,4,2,2,4,-3,5,2,0,1,1,3,0,3,2,1,3,0,-2,-33,1,-4,3,31,0,1,-1,-1,1,1,2,-1
KR_6721934094,420,-1,15,-41,-2,6,0,6,-3,5,2,0,4,4,1,3,4,-6,6,0,0,2,-7,-3,-3,6,1,0,-1,-1,1,1,-1,6,-1
KR_6599231632,420,-1,29,-4,-3,4,0,4,-1,2,1,-2,4,2,1,1,2,-5,6,1,0,-8,10,-4,-2,6,-2,0,0,-1,-1,0,1,2,-1
KR_6695681911,420,-1,-52,-16,-1,-3,4,1,0,1,1,1,2,3,0,2,2,1,1,2,0,2,10,-4,-1,5,-1,0,-1,-1,-1,-1,-1,3,-1
KR_6668069145,420,0,7,16,-3,-2,5,3,-4,5,1,1,0,1,1,1,2,1,0,1,0,-4,-13,-5,-1,6,5,0,0,-1,0,1,1,6,-1
KR_6624975623,420,-5,-106,-10,-7,-1,2,1,2,0,2,-6,9,3,-1,4,3,-1,1,0,-1,3,-34,1,-4,3,-1,0,-1,1,0,-1,-1,5,-1
KR_6362484830,420,-6,-51,-12,-12,1,1,2,-2,7,5,-7,8,1,-4,6,2,0,1,1,0,-17,0,0,0,0,0,0,-1,0,1,-1,-1,0,-1
KR_6650538505,420,-8,-116,-12,-11,-5,6,1,1,2,3,-4,6,2,0,3,3,-3,3,0,-1,-7,-18,-2,-1,3,-1,0,-3,0,1,-1,-1,0,-1
KR_6738182923,440,-2,-54,-16,-8,-6,6,0,-1,6,5,0,1,1,0,4,4,-1,2,1,0,-7,5,-1,-4,5,-2,0,-1,-1,-1,-1,1,1,-1
KR_6745907726,420,-1,14,12,2,0,2,2,1,0,1,1,0,1,3,3,6,-3,4,1,0,4,5,3,-7,4,-4,0,0,0,0,0,1,0,-1
KR_6601332548,420,1,5,-19,3,1,0,1,-2,3,1,1,4,5,3,1,4,0,1,1,0,4,3,1,-6,5,-1,0,-1,1,-1,-1,-1,2,-1
KR_6744937119,420,-6,-62,-28,-9,-1,2,1,-2,3,1,-6,6,0,-1,2,1,1,0,1,0,-9,1,6,-9,3,-4,0,-1,-1,-1,-1,-1,1,-1
KR_6690467879,420,-3,-70,-8,-5,0,4,4,0,2,2,3,1,4,-5,5,0,-3,3,0,0,-9,-12,-5,0,5,3,0,-1,1,-1,-1,1,5,-1
KR_6762503740,420,-3,-42,21,-7,0,6,6,-4,5,1,-2,4,2,0,1,1,-1,2,1,0,-12,-7,0,-6,6,-1,0,0,1,-1,-1,1,5,-1
KR_6751709241,420,-1,-43,39,3,-1,5,4,-1,2,1,0,3,3,5,1,6,0,0,0,1,0,-2,-1,-4,5,1,0,-2,-1,-1,-1,-1,4,-1
KR_6726438670,420,-5,-76,-23,-4,-2,2,0,-3,4,1,-4,5,1,1,3,4,4,3,7,-1,-2,-139,-2,-2,4,-3,0,-2,-1,-1,-1,-1,6,-1
KR_6604949927,420,-4,-74,14,-3,-6,7,1,0,1,1,3,1,4,3,0,3,-3,3,0,0,1,7,3,-4,1,-4,0,-1,-1,-1,-1,-1,3,-1
KR_6707905577,420,-1,-60,-20,-1,-1,1,0,1,1,2,0,3,3,1,2,3,-2,3,1,0,-4,153,3,-7,4,-2,0,0,-1,-1,1,1,6,-1
KR_6714205865,420,-3,-142,-31,-16,-1,1,0,-1,3,2,-9,10,1,0,0,0,-5,6,1,-1,-5,18,-4,0,4,2,0,-3,-1,-1,-1,-1,6,-1
KR_6712574357,420,-3,-93,-8,4,1,2,3,-1,2,1,2,2,4,2,1,3,0,2,2,1,0,-1,2,-5,3,-5,0,-1,1,-1,-1,1,3,-1
KR_6678368914,420,1,40,-48,3,5,1,6,1,1,2,2,3,5,-2,4,2,-3,4,1,0,6,2,5,-6,1,-3,0,-1,-1,-1,-1,-1,6,-1
KR_6680646064,420,1,40,40,4,4,0,4,2,3,5,2,3,5,-3,4,1,-1,1,0,0,-1,-256,2,-4,2,-1,0,0,-1,-1,1,-1,2,-1
KR_6571057336,420,1,-36,-13,2,1,2,3,1,0,1,-3,6,3,3,6,9,0,1,1,-1,-4,-9,2,-3,1,1,0,-2,1,-1,-1,-1,4,-1
KR_6552739176,420,0,3,28,6,0,2,2,5,1,6,1,0,1,-1,4,3,1,2,3,0,3,37,-1,-3,4,-1,0,0,-1,0,0,-1,1,-1
KR_6699488780,420,-1,-71,-44,2,-5,7,2,3,1,4,4,0,4,2,0,2,-2,2,0,-1,4,-5,1,-5,4,0,0,-1,-1,1,-1,-1,5,-1
KR_6669281543,420,0,-53,-20,2,-5,7,2,2,2,4,3,2,5,2,1,3,0,1,1,1,10,192,4,-6,2,-3,0,-2,1,-1,-1,1,5,-1
KR_6727520995,420,-2,23,-17,-12,2,1,3,-3,4,1,0,1,1,-3,3,0,-8,8,0,0,-17,26,-1,-4,5,-15,0,-1,1,1,-1,-1,5,-1
KR_6748507144,420,-4,-75,16,-15,-1,2,1,-3,7,4,0,3,3,-2,3,1,-9,9,0,0,-6,-55,-2,-2,4,19,0,-1,1,1,-1,-1,6,-1
KR_6760536518,420,-2,-81,-24,-5,3,1,4,1,2,3,-3,5,2,-5,5,0,-1,2,1,1,-5,336,-2,-2,4,0,0,0,-1,1,1,1,2,-1
KR_6720487532,420,-6,-24,-45,-13,2,1,3,-3,3,0,-3,6,3,-9,13,4,0,3,3,0,-7,2,-4,-4,8,1,0,0,-1,1,-1,1,6,-1
KR_6607786728,420,1,27,-5,-5,0,0,0,-1,2,1,-1,4,3,0,3,3,-3,4,1,0,-1,-3,-2,-3,5,0,0,0,0,-1,1,-1,0,-1
KR_6735055752,420,1,9,4,1,2,0,2,1,3,4,-3,4,1,2,0,2,-1,3,2,0,-1,-19,-4,-1,5,1,0,0,-1,1,0,1,6,-1
KR_6682479892,420,-1,-89,20,-10,-2,4,2,-1,1,0,-1,2,1,-6,8,2,0,2,2,-1,-13,6,-1,-5,6,1,0,-2,-1,-1,-1,-1,4,-1
KR_6665754133,440,-1,24,12,-1,0,0,0,3,3,6,0,2,2,3,0,3,-7,9,2,0,-4,3,3,-5,2,-1,0,1,1,1,1,1,4,-1
KR_6735064866,420,-7,-159,15,-15,-1,4,3,-1,1,0,-7,7,0,-5,6,1,-1,2,1,1,-8,-18,-4,0,4,-2,0,-2,1,0,-1,1,2,-1
KR_6749369026,420,-8,-89,-42,-17,-4,4,0,-1,3,2,-9,9,0,-2,4,2,-1,1,0,0,-9,6,3,-7,4,-7,0,-1,-1,0,-1,-1,5,-1
KR_6629885222,420,0,-12,27,-3,0,3,3,1,2,3,-2,4,2,1,5,6,-3,4,1,0,-1,26,3,-4,1,-1,0,0,1,1,1,1,5,-1
KR_6750745080,420,0,-64,12,0,-3,5,2,-2,3,1,6,0,6,0,2,2,-1,1,0,0,-1,-15,-4,-3,7,-4,0,-1,1,0,-1,-1,6,-1
KR_6731722933,420,-2,-38,16,-7,-4,4,0,-3,3,0,3,1,4,-2,2,0,-1,1,0,0,-2,-9,-3,-3,6,-3,0,0,-1,0,0,-1,3,-1
KR_6550631158,440,3,-8,0,12,3,0,3,2,0,2,7,1,8,0,1,1,0,0,0,0,10,4,7,-11,4,1,0,1,0,1,1,1,0,-1
KR_6751185653,420,-1,8,32,-9,2,2,4,-4,6,2,1,1,2,-7,7,0,-1,1,0,-3,-19,-26,-4,-2,6,33,0,-1,-1,-1,-1,-1,6,-1
KR_6331189782,420,0,40,-25,-2,0,2,2,-2,5,3,1,0,1,1,0,1,-2,2,0,0,3,-24,1,-5,4,-2,0,0,-1,-1,0,-1,3,-1
KR_6761363555,420,2,-54,43,0,0,0,0,1,2,3,0,0,0,-2,2,0,1,1,2,0,-4,-2,-1,-4,5,-2,0,0,1,-1,0,-1,6,-1
KR_6566227016,420,-3,-54,-88,-4,-2,2,0,-1,2,1,-4,6,2,2,2,4,1,4,5,-1,1,0,3,-6,3,-2,0,0,-1,0,-1,-1,6,-1
KR_6758908625,420,-7,-140,-8,-17,1,1,2,0,1,1,-5,7,2,-13,14,1,0,2,2,1,-15,-3,-1,-1,2,3,0,-1,-1,0,-1,1,4,-1
KR_6613868333,440,-1,-61,8,-3,-3,3,0,2,0,2,5,1,6,-4,4,0,-3,3,0,0,-8,99,-2,-5,7,-4,0,-1,-1,1,-1,1,6,-1
KR_6751813564,420,-1,29,4,0,2,0,2,0,3,3,2,0,2,-2,2,0,-2,2,0,0,-8,-3,2,-8,6,-2,0,0,-1,1,1,1,5,-1
KR_6754265491,420,-7,-109,-13,-11,-3,4,1,-2,2,0,-3,4,1,-2,2,0,-1,1,0,0,-9,-19,3,-5,2,-3,0,-3,1,0,-1,-1,4,-1
KR_6714868601,420,-2,-1,-28,-8,1,1,2,-3,5,2,-1,5,4,-2,4,2,-3,3,0,0,-6,4,3,-5,2,-2,0,-1,-1,1,-1,1,3,-1
KR_6736652733,420,-4,-60,-36,-13,-2,4,2,-4,7,3,-2,3,1,-5,7,2,0,1,1,-1,-5,26,-1,-5,6,-4,0,0,-1,-1,0,-1,1,-1
KR_6606213027,420,-5,-50,-30,-8,0,2,2,-5,5,0,0,0,0,-3,3,0,0,0,0,-1,-4,7,1,-3,2,2,0,-3,-1,-1,-1,-1,6,-1
KR_6748903761,420,1,51,-8,8,-1,2,1,-5,6,1,5,1,6,6,1,7,3,3,6,-1,4,-5,-1,0,1,0,0,2,0,0,1,-1,0,-1
KR_6720105291,420,-2,15,8,-4,3,4,7,1,3,4,2,2,4,-7,8,1,-3,4,1,1,2,-7,-4,-1,5,3,0,-1,1,1,-1,1,5,-1
KR_6704774981,420,-4,-60,4,-8,1,0,1,1,3,4,-3,3,0,-7,9,2,0,0,0,-1,-13,-39,2,-6,4,26,0,-1,-1,1,-1,-1,1,-1
KR_6693677869,440,-2,4,-44,1,-2,3,1,-4,6,2,1,2,3,4,0,4,2,0,2,1,10,21,2,-3,1,-4,0,-1,-1,-1,1,1,4,-1
KR_6618563476,420,-4,-67,2,-10,2,1,3,-10,10,0,-1,3,2,-1,1,0,0,0,0,0,-7,22,-3,-1,4,-1,0,-3,1,-1,-1,-1,2,-1
KR_6543787177,420,-1,70,-11,-6,1,0,1,-1,2,1,-2,4,2,-6,6,0,2,0,2,0,-11,-248,2,-4,2,-2,0,0,-1,-1,1,-1,3,-1
KR_6693745396,420,1,12,28,-6,-2,4,2,2,0,2,-2,3,1,-1,1,0,-3,3,0,-1,-5,-11,-4,-1,5,5,0,1,1,1,1,-1,2,-1
KR_6652853183,420,-5,-89,-32,-13,1,1,2,1,0,1,-2,4,2,-7,8,1,-6,6,0,0,-11,7,-1,-2,3,-3,0,-1,-1,1,-1,-1,4,-1
KR_6628573557,420,-4,7,-4,-10,-1,2,1,1,1,2,1,3,4,-10,11,1,-1,1,0,0,-12,-7,-2,-3,5,0,0,0,-1,1,-1,1,4,-1
KR_6672650090,420,-2,-37,-13,-9,-3,3,0,-4,4,0,2,2,4,-1,4,3,-3,3,0,-2,-17,65,-7,-2,9,3,0,-1,1,1,1,-1,5,-1
KR_6693788934,420,-1,23,-4,-6,-2,6,4,-1,3,2,-3,4,1,1,1,2,-1,2,1,0,-1,-8,-3,-2,5,0,0,-1,-1,-1,-1,-1,4,-1
KR_6755071833,420,-2,5,-20,-8,1,4,5,-1,3,2,-2,3,1,-3,6,3,-3,4,1,-1,-9,-1,1,-1,0,-2,0,0,1,1,-1,-1,5,-1
KR_6757528879,420,1,-21,19,-4,2,0,2,-4,5,1,-2,3,1,0,2,2,0,1,1,-1,-13,-51,-4,-3,7,21,0,0,-1,1,0,-1,6,-1
KR_6332718651,440,-3,11,-36,-7,-1,1,0,-1,2,1,-1,2,1,0,2,2,-4,4,0,0,-11,-44,0,-4,4,-5,0,0,-1,0,0,-1,3,-1
KR_6752396397,420,-1,-27,5,-5,2,1,3,-5,5,0,-3,5,2,0,0,0,1,0,1,0,-6,13,6,-8,2,-5,0,-1,-1,-1,-1,1,1,-1
KR_6706175010,440,-4,-30,-23,-5,-2,3,1,1,2,3,-1,2,1,-3,3,0,0,0,0,0,0,2,2,-2,0,1,0,0,0,-1,-1,-1,0,-1
KR_6689653362,420,0,-56,-17,-2,-5,6,1,7,0,7,-3,4,1,-1,2,1,0,0,0,1,8,5,0,0,0,-2,0,0,1,0,0,1,6,-1
KR_6681090432,420,4,45,9,10,2,3,5,3,0,3,6,1,7,-1,2,1,0,0,0,0,13,-3,0,-4,4,2,0,0,0,1,1,-1,0,-1
KR_5797494022,420,2,14,-1,2,0,1,1,-4,5,1,0,4,4,2,2,4,4,2,6,-1,-3,-1,0,-4,4,-4,0,2,-1,0,1,-1,3,-1
KR_6715970780,420,1,-9,-15,3,-2,3,1,3,1,4,1,1,2,-1,1,0,2,3,5,-1,3,12,1,-5,4,-27,0,-1,1,-1,-1,-1,3,-1
KR_6610328028,420,-5,-12,-24,-7,-2,4,2,3,2,5,-3,6,3,-6,7,1,1,2,3,0,-10,8,0,-1,1,-1,0,-1,-1,-1,-1,1,1,-1
KR_6633529741,420,-4,60,-8,-7,-2,2,0,-3,4,1,-2,4,2,0,4,4,0,1,1,0,-3,8,-3,-4,7,-1,0,0,-1,-1,0,-1,5,-1
KR_6660802591,420,2,60,8,2,3,0,3,0,2,2,-3,3,0,1,1,2,1,0,1,1,1,7,-4,0,4,-3,0,0,0,0,0,1,0,-1
KR_6375133297,420,-3,-9,16,-11,1,2,3,-7,9,2,0,1,1,-4,4,0,-1,3,2,-1,-10,0,0,0,0,0,0,0,-1,1,1,-1,4,-1
KR_6613827018,420,3,32,20,6,-1,1,0,-1,3,2,0,2,2,3,3,6,5,0,5,0,6,-11,3,-6,3,1,0,0,0,0,0,1,0,-1
KR_6720605132,420,-6,-80,-23,-11,-6,9,3,-1,1,0,-6,8,2,3,2,5,-1,2,1,-1,-3,1,-1,-1,2,-1,0,-4,-1,-1,-1,-1,2,-1
KR_6750106649,420,2,3,7,2,2,1,3,1,2,3,3,1,4,-2,4,2,-2,3,1,0,2,-27,4,-6,2,1,0,-1,-1,-1,-1,1,1,-1
KR_6737674785,420,-3,-7,-29,-6,0,1,1,-4,7,3,-5,5,0,1,0,1,2,0,2,0,-1,-339,1,-3,2,3,0,-1,-1,-1,-1,-1,4,-1
KR_6690809803,420,1,39,4,0,-5,5,0,1,2,3,2,1,3,1,2,3,1,0,1,0,-2,0,3,-3,0,-1,0,0,-1,1,-1,1,6,-1
KR_6763633938,420,1,58,19,-2,-1,2,1,-3,3,0,3,1,4,0,2,2,-1,1,0,0,-4,51,-1,-2,3,-6,0,0,0,0,1,-1,0,-1
KR_6611532129,420,-1,-76,11,-4,-1,4,3,-1,4,3,-2,3,1,1,1,2,-1,1,0,0,-3,-1,3,-7,4,-5,0,0,1,1,0,-1,3,-1
KR_6535833868,420,-1,-32,-12,-2,1,1,2,-3,4,1,0,3,3,0,1,1,0,1,1,0,-6,29,2,-7,5,1,0,0,-1,-1,-1,1,4,-1
KR_6679037900,420,0,26,12,1,-1,4,3,-1,4,3,0,1,1,2,1,3,1,0,1,-1,3,1,0,-2,2,2,0,-1,1,0,-1,-1,5,-1
KR_6730951142,420,0,-29,-8,2,-6,9,3,1,3,4,4,1,5,2,1,3,1,0,1,0,4,3,-3,-1,4,1,0,-1,-1,-1,-1,-1,5,-1
KR_6749956702,440,0,-7,-12,-1,4,0,4,-2,3,1,-3,3,0,-1,3,2,1,2,3,1,-7,-2,0,-6,6,2,0,0,-1,-1,-1,1,5,-1
KR_6649898612,420,-4,-67,-5,-5,2,1,3,-1,1,0,-2,4,2,-3,6,3,-1,3,2,0,-4,0,-2,-3,5,2,0,0,0,-1,0,-1,0,-1
KR_6740803021,420,-1,-14,-4,-4,2,1,3,-4,6,2,3,1,4,-3,3,0,-2,4,2,1,-7,-169,-1,-1,2,-1,0,0,-1,1,1,1,3,-1
KR_6687926750,420,-5,-93,-8,-8,0,1,1,-1,1,0,0,2,2,-7,7,0,0,2,2,0,-7,-40,0,-1,1,1,0,-2,-1,1,-1,-1,5,-1
KR_6716459975,420,1,55,18,-10,-1,2,1,-1,3,2,-4,5,1,-2,2,0,-2,2,0,0,-19,6,-4,-3,7,-1,0,0,-1,-1,-1,1,5,-1
KR_6752294365,420,-6,-37,-44,-16,-4,4,0,-3,4,1,-6,10,4,-3,5,2,0,1,1,0,-4,-4,-3,-1,4,0,0,0,-1,-1,0,-1,5,-1
KR_6754257659,440,3,-28,2,7,6,0,6,3,1,4,-2,2,0,1,2,3,-1,2,1,-1,4,10,-1,-1,2,0,0,1,0,0,-1,-1,0,-1
KR_6615866964,420,1,46,10,5,-1,3,2,3,4,7,-2,2,0,3,0,3,2,0,2,0,9,-2,2,-7,5,-1,0,1,-1,-1,1,1,2,-1
KR_6759566176,440,0,54,1,-2,3,1,4,-2,3,1,3,1,4,-4,6,2,-2,3,1,0,-7,4,-4,-3,7,-3,0,1,-1,1,1,-1,1,-1
KR_6710574286,420,1,-1,-4,0,1,2,3,3,0,3,-1,1,0,-3,3,0,0,0,0,0,-2,-2,-2,-3,5,-1,0,1,-1,-1,1,1,5,-1
KR_6754350775,440,-2,-50,8,-3,-3,3,0,1,0,1,1,2,3,-2,2,0,0,2,2,0,-1,6,-4,-6,10,-2,0,-1,-1,-1,-1,1,6,-1
KR_6628328436,420,-1,16,-7,4,0,1,1,-1,2,1,0,4,4,5,0,5,0,0,0,0,4,-143,0,-4,4,1,0,-1,1,1,-1,-1,4,-1
KR_6755210775,420,2,87,-8,-1,1,1,2,3,1,4,-3,5,2,0,2,2,-2,2,0,0,5,1,0,-4,4,5,0,0,-1,-1,0,-1,3,-1
KR_6652961189,420,-3,-30,0,-15,-3,5,2,-3,4,1,-7,8,1,-1,1,0,-1,1,0,0,-7,-7,2,-3,1,-3,0,0,-1,-1,-1,-1,3,-1
KR_6754876060,420,-7,-94,-41,-12,-4,4,0,1,1,2,-5,7,2,-4,4,0,0,2,2,-2,-8,-55,-4,-3,7,20,0,0,-1,-1,-1,-1,3,-1
KR_6723286689,420,-3,-50,-12,-8,-5,6,1,0,2,2,-3,4,1,0,0,0,0,0,0,0,-3,10,-1,-2,3,0,0,-1,-1,-1,-1,-1,5,-1
KR_6652306389,420,0,-9,3,-1,-1,1,0,2,0,2,0,1,1,-2,3,1,0,1,1,0,-3,-47,-2,-3,5,22,0,0,-1,0,0,1,6,-1
KR_6574879822,420,-5,-61,-48,-14,-4,4,0,-4,4,0,1,0,1,-6,6,0,-1,1,0,0,-13,99,-2,-3,5,-3,0,-2,-1,-1,-1,-1,3,-1
KR_6650383666,420,0,-44,-11,5,-4,4,0,5,2,7,0,2,2,5,0,5,-1,1,0,1,9,147,5,-9,4,1,0,0,-1,1,1,1,4,-1
KR_6636179812,420,-1,-27,12,-5,0,1,1,-1,3,2,0,3,3,-4,5,1,0,2,2,0,-6,0,-1,-3,4,1,0,-1,-1,1,-1,1,3,-1
KR_6678782069,440,-3,-58,7,-9,3,1,4,-3,3,0,2,2,4,-10,10,0,-1,3,2,-1,-16,5,-1,-2,3,0,0,0,-1,1,1,-1,4,-1
KR_6761686587,420,2,-39,12,8,5,0,5,1,1,2,0,1,1,3,3,6,-1,1,0,0,2,6,1,-5,4,0,0,-1,-1,-1,-1,-1,4,-1
KR_6732124355,420,-6,-121,-19,-13,-2,4,2,-2,3,1,-5,5,0,-4,5,1,0,0,0,0,-15,-1,-1,-1,2,-6,0,-2,-1,-1,-1,1,3,-1
KR_6704894743,420,-3,-83,-24,1,2,1,3,1,4,5,0,1,1,-4,4,0,2,0,2,0,3,6,-3,0,3,2,0,-1,1,-1,-1,1,5,-1
KR_6505515499,420,-5,-34,-3,-12,0,2,2,-3,4,1,-3,5,2,0,1,1,-6,6,0,0,-6,-20,0,-2,2,0,0,-1,-1,-1,-1,-1,6,-1
KR_6675558132,420,-3,-11,-20,-14,-4,4,0,-8,10,2,4,1,5,-4,6,2,-2,2,0,-1,-11,2,-1,-1,2,-1,0,0,-1,1,0,-1,5,-1
KR_6700946926,440,-5,-114,-13,-13,-4,5,1,2,1,3,-3,4,1,-7,7,0,-1,1,0,0,-7,-1,2,-5,3,2,0,-1,-1,1,-1,1,1,-1
KR_6741079945,440,3,102,-6,-2,6,0,6,-7,7,0,-5,9,4,3,1,4,1,0,1,0,-12,1,-4,0,4,1,0,2,-1,1,1,1,1,-1
KR_6510918511,420,6,-2,96,-7,6,0,6,4,0,4,-2,4,2,-7,7,0,-8,9,1,1,-11,225,0,-1,1,1,0,-1,0,1,-1,1,0,-1
KR_6645813366,420,1,23,34,5,0,1,1,-1,3,2,-4,5,1,10,0,10,0,0,0,1,7,3,2,-5,3,-1,0,1,-1,0,1,1,3,-1
KR_6745829228,420,-1,-42,-16,-2,3,0,3,0,2,2,-4,7,3,0,1,1,-1,1,0,0,0,0,3,-3,0,-1,0,0,1,-1,-1,1,4,-1
KR_6750600894,440,-3,-99,-24,-9,-3,4,1,-1,3,2,-7,7,0,2,1,3,0,1,1,0,-11,-1,1,-3,2,-1,0,-1,0,0,-1,-1,0,-1
KR_6711597397,440,-1,24,-8,-6,-1,2,1,-3,9,6,1,1,2,0,2,2,-3,5,2,-1,-4,4,7,-10,3,-1,0,0,-1,0,1,-1,5,-1
KR_6705317555,420,1,47,-12,12,3,2,5,2,1,3,5,0,5,4,0,4,-2,2,0,0,10,-6,-2,-2,4,3,0,0,1,-1,0,1,4,-1
KR_6718056337,420,-3,2,-29,-15,-6,7,1,1,0,1,-2,6,4,-7,8,1,-1,1,0,-1,-9,-18,-2,-1,3,-2,0,-3,-1,-1,-1,-1,4,-1
KR_6757719457,440,5,76,8,5,-1,3,2,4,0,4,0,5,5,3,5,8,-1,2,1,0,6,-4,-1,-4,5,2,0,1,1,1,1,-1,5,-1
KR_6733829090,420,-4,-48,-24,-14,-3,3,0,-1,1,0,1,1,2,1,2,3,-12,15,3,0,-12,2,3,-3,0,-2,0,-1,-1,-1,-1,1,5,-1
KR_6673090530,420,-8,-78,-52,-9,-2,2,0,-5,7,2,-2,4,2,3,2,5,-3,3,0,-1,-8,-10,-2,-4,6,-2,0,-1,1,1,-1,-1,1,-1
KR_6763229334,440,-1,-29,-16,-1,-4,5,1,0,1,1,5,1,6,-2,7,5,0,0,0,1,0,-6,-2,-1,3,2,0,0,-1,1,1,1,6,-1
KR_6752652871,420,-1,-44,-16,2,-2,2,0,1,4,5,1,6,7,-1,4,3,3,0,3,1,5,7,0,-3,3,-1,0,0,-1,1,0,1,1,-1
KR_6750483209,440,-1,5,-9,2,0,0,0,0,3,3,5,0,5,1,1,2,-4,5,1,0,5,0,-5,0,5,0,0,0,0,1,0,1,0,-1
KR_6681048243,420,-5,-56,0,-8,6,2,8,0,0,0,-5,6,1,-5,5,0,-4,4,0,-1,-14,-8,-1,-3,4,0,0,0,-1,1,-1,-1,4,-1
KR_6754510459,440,7,58,16,11,6,0,6,1,3,4,3,1,4,1,2,3,0,0,0,0,3,23,1,-6,5,-2,0,0,1,1,0,1,6,-1
KR_6537350512,420,-2,-6,-36,-1,0,2,2,4,0,4,-4,4,0,0,0,0,-1,2,1,0,3,-2,0,-6,6,-4,0,-1,1,-1,-1,1,6,-1
KR_6542137045,420,-8,-59,-28,-15,-3,3,0,-1,3,2,-4,5,1,-2,3,1,-5,5,0,0,-11,-2,-1,-3,4,-2,0,-3,0,-1,-1,-1,0,-1
KR_6754002344,420,-2,-17,-8,-4,-3,3,0,-3,5,2,3,1,4,-1,1,0,0,0,0,0,1,10,4,-6,2,1,0,0,-1,1,0,-1,5,-1
KR_5648437475,420,-2,13,-4,-4,-3,4,1,-1,4,3,-3,3,0,3,2,5,0,2,2,0,-8,12,0,-4,4,0,0,0,-1,0,1,-1,6,-1
KR_6663074973,420,-2,-89,-8,-6,3,0,3,-2,2,0,-1,1,0,-4,4,0,-2,2,0,0,-8,-2,-1,-1,2,-2,0,-1,1,-1,-1,1,6,-1
KR_6695358334,420,-5,-69,-8,-12,0,4,4,0,1,1,-3,5,2,-9,9,0,0,1,1,0,-17,3,-1,-3,4,-4,0,-1,-1,0,-1,-1,1,-1
KR_6753532346,440,-7,-123,-16,-10,0,1,1,2,2,4,-4,4,0,-6,7,1,-2,2,0,1,-8,-8,-1,-3,4,3,0,-2,-1,-1,-1,1,3,-1
KR_6619565311,420,-3,-36,3,-8,-3,5,2,-2,4,2,-2,5,3,0,1,1,-1,2,1,0,-5,-49,-3,-2,5,15,0,-2,-1,0,-1,1,4,-1
KR_6749500064,440,-4,-62,3,-7,-2,3,1,-1,6,5,0,3,3,-4,5,1,0,0,0,0,-8,265,-3,-2,5,1,0,-1,-1,0,-1,1,2,-1
KR_6730155039,420,3,90,0,9,1,2,3,2,3,5,3,3,6,3,1,4,0,2,2,0,10,-49,-2,-3,5,7,0,0,1,0,1,1,5,-1
KR_6764386283,440,-1,-37,12,-5,0,0,0,0,2,2,0,2,2,-5,5,0,0,0,0,0,-3,8,2,-7,5,-1,0,0,-1,1,0,-1,4,-1
KR_6735678674,440,0,-11,16,2,0,1,1,0,2,2,0,0,0,2,1,3,0,0,0,0,2,-2,1,-3,2,0,0,1,-1,1,1,1,1,-1
KR_6724539737,420,-2,-66,-4,-4,0,3,3,-1,4,3,-1,2,1,-2,3,1,0,1,1,0,-4,12,-6,0,6,5,0,0,-1,-1,-1,-1,2,-1
KR_6763627113,420,1,-25,14,4,0,4,4,2,4,6,-2,3,1,5,1,6,-1,1,0,0,1,-9,-7,-1,8,1,0,0,1,-1,0,1,1,-1
KR_6724972488,440,-2,-53,-32,-4,-3,5,2,1,8,9,-5,5,0,3,2,5,0,1,1,-2,-3,-5,0,-3,3,-4,0,-3,-1,-1,-1,-1,4,-1
KR_6695710576,420,-1,-79,12,-3,1,0,1,4,0,4,-3,5,2,-1,1,0,-4,4,0,0,-4,-6,4,-6,2,-1,0,-1,-1,1,-1,1,5,-1
KR_6315362875,440,-2,-54,-25,2,0,3,3,0,1,1,0,3,3,4,1,5,-2,2,0,0,0,8,3,-4,1,-3,0,0,-1,1,1,-1,5,-1
KR_6760415241,420,2,-34,44,1,-5,5,0,1,1,2,0,3,3,2,3,5,3,1,4,0,3,2,-4,-2,6,-5,0,0,1,-1,0,1,3,-1
KR_6751627220,420,-4,-98,12,-13,-3,3,0,-2,3,1,-2,4,2,-3,5,2,-3,4,1,0,-6,-7,-8,-1,9,0,0,-2,-1,-1,-1,1,4,-1
KR_6763812000,420,-1,0,2,-2,-2,2,0,-2,3,1,0,2,2,2,0,2,0,0,0,0,-4,-22,-5,-2,7,3,0,0,0,-1,-1,1,0,-1
KR_6716936149,420,-5,-115,-8,-8,-3,3,0,-2,3,1,-1,2,1,-3,5,2,1,0,1,0,0,-81,-5,0,5,-1,0,-2,-1,-1,-1,-1,2,-1
KR_6675707046,420,-2,-35,-4,0,-1,1,0,0,2,2,-2,4,2,0,1,1,3,0,3,0,3,178,-1,-4,5,-2,0,-2,-1,-1,-1,1,5,-1
KR_6749176388,420,-1,-96,-2,0,5,0,5,4,2,6,1,2,3,-10,10,0,0,1,1,0,2,-2,3,-4,1,2,0,-2,1,-1,-1,-1,1,-1
KR_6762544039,420,-4,-72,-31,-14,3,0,3,-2,5,3,-7,9,2,-6,6,0,-2,3,1,-1,-8,9,2,-2,0,0,0,-1,-1,-1,-1,1,5,-1
KR_6660115672,420,-1,-16,-4,-2,2,2,4,-2,3,1,-1,5,4,1,0,1,-2,2,0,0,2,-15,1,-2,1,0,0,-1,-1,1,-1,-1,3,-1
KR_6695773556,420,2,-60,32,0,-1,2,1,0,1,1,-4,8,4,3,2,5,2,1,3,0,0,-8,-1,-2,3,3,0,1,0,1,1,-1,0,-1
KR_6576733930,440,-1,-44,16,-12,-1,5,4,-2,2,0,2,0,2,-8,9,1,-3,3,0,0,-10,-21,0,-3,3,0,0,-1,1,-1,-1,-1,2,-1
KR_6757007594,420,0,-9,-8,-7,1,1,2,-2,3,1,-3,4,1,-2,2,0,-1,1,0,0,-11,-7,0,-2,2,-2,0,1,-1,0,1,1,4,-1
KR_6391795351,420,1,-35,20,1,-2,3,1,1,1,2,0,1,1,3,1,4,-1,2,1,0,6,-3,1,-5,4,-1,0,1,-1,1,1,-1,1,-1
KR_6759502886,440,1,87,25,-3,2,2,4,-1,5,4,0,4,4,-5,7,2,1,0,1,0,-6,4,-2,-3,5,2,0,1,1,1,1,1,4,-1
KR_6685250822,420,-3,-15,17,-1,1,2,3,3,2,5,-1,3,2,-3,6,3,-1,2,1,1,-3,-32,-1,-3,4,-1,0,0,0,-1,1,1,0,-1
KR_5535983336,420,-2,9,-13,-2,2,2,4,4,3,7,0,2,2,-3,5,2,-5,6,1,0,-10,-5,0,-4,4,0,0,0,-1,0,-1,1,4,-1
KR_6533166838,420,-2,-16,-29,-14,-3,4,1,-3,4,1,-8,8,0,-1,1,0,1,2,3,-1,-14,-2,-3,0,3,-1,0,-2,-1,-1,-1,-1,6,-1
KR_6761024981,420,-2,-15,0,-6,1,1,2,-5,6,1,-2,5,3,0,1,1,0,2,2,0,-14,3,-3,-4,7,-1,0,-1,-1,0,-1,-1,2,-1
KR_6760642562,420,-5,-98,0,-3,-5,5,0,2,2,4,-2,4,2,2,0,2,0,0,0,0,0,-7,2,-4,2,-1,-1,-2,1,-1,-1,-1,5,-1
KR_6758183032,440,0,41,-24,-8,2,0,2,-8,8,0,2,1,3,-3,3,0,-1,1,0,0,-12,-35,4,-6,2,4,0,0,-1,-1,-1,1,4,-1
KR_6754659627,420,-2,13,-63,-3,2,2,4,-5,7,2,0,1,1,0,3,3,0,1,1,0,-10,-1,-3,-3,6,-3,0,0,-1,1,1,1,6,-1
KR_6726011143,420,1,44,-15,-1,0,0,0,-3,3,0,-4,7,3,4,1,5,2,1,3,0,-1,0,0,-2,2,1,0,0,-1,1,0,-1,5,-1
KR_6674063060,420,1,-23,62,2,-2,3,1,-2,2,0,2,2,4,5,1,6,-1,1,0,0,5,6,-3,-3,6,-2,0,-1,1,-1,-1,1,2,-1
KR_6686940900,420,-5,-100,0,-10,-9,9,0,1,2,3,-3,3,0,-1,1,0,2,1,3,0,-8,1,-3,-4,7,0,0,0,1,1,1,-1,6,-1
KR_6594836343,440,-3,-37,-12,-9,-1,2,1,-2,5,3,-2,3,1,-1,1,0,-3,3,0,0,-10,1,1,-4,3,-1,0,0,-1,0,0,1,4,-1
KR_6728668327,420,0,8,-12,0,4,0,4,2,0,2,2,2,4,-1,2,1,-7,8,1,0,-1,17,0,-4,4,-5,0,1,-1,-1,1,-1,5,-1
KR_6585871010,420,-2,26,-4,2,-4,4,0,3,1,4,-2,3,1,2,0,2,3,0,3,0,9,-4,-1,-2,3,-2,0,-1,1,-1,-1,1,2,-1
KR_6760595759,440,1,-15,-16,3,-1,4,3,3,0,3,0,5,5,-2,2,0,3,3,6,0,-2,330,1,-4,3,-2,0,-1,1,-1,-1,1,3,-1
KR_6754092424,420,-3,-84,-7,-7,0,1,1,1,0,1,-3,3,0,-4,4,0,-1,4,3,0,-5,-10,0,-3,3,0,0,-1,-1,1,-1,-1,2,-1
KR_6754955981,420,2,3,15,7,7,1,8,-1,1,0,-2,4,2,2,1,3,1,0,1,0,5,8,-3,-2,5,3,0,2,0,1,1,1,0,-1
KR_6643339956,420,-2,-10,-33,-3,0,0,0,-2,2,0,2,0,2,3,5,8,-6,6,0,0,0,2,-1,-1,2,1,0,-1,-1,-1,-1,-1,5,-1
KR_6667382936,420,-4,-65,-24,-9,-4,5,1,-3,3,0,3,0,3,-1,5,4,-4,5,1,0,3,-5,1,-4,3,-2,0,0,1,0,0,1,4,-1
KR_6718744626,420,0,-71,27,3,4,1,5,-4,5,1,0,3,3,2,1,3,1,0,1,0,-1,-12,-2,-1,3,10,0,0,0,1,0,1,0,-1
KR_6760213057,440,0,-11,13,-1,-1,2,1,3,5,8,-4,4,0,1,1,2,0,1,1,0,3,19,1,-3,2,-1,0,0,0,1,0,1,0,-1
KR_6732108140,420,0,9,-4,0,4,0,4,-2,3,1,0,1,1,-1,2,1,-1,1,0,0,-2,-3,0,-2,2,-2,0,0,1,-1,0,-1,6,-1
KR_6662998378,420,-2,-35,-34,-2,-3,3,0,0,3,3,0,3,3,2,1,3,-1,2,1,0,-3,-1,4,-7,3,-2,0,-2,1,-1,-1,1,6,-1
KR_5967999301,420,-3,-69,28,-5,0,1,1,-5,7,2,1,1,2,-4,7,3,3,0,3,0,-9,-7,0,-8,8,-2,0,-1,-1,1,-1,-1,5,-1
KR_6760609165,420,-2,-29,24,-1,3,3,6,-1,2,1,-5,6,1,2,1,3,0,1,1,0,5,-41,-1,-5,6,14,0,-1,1,-1,1,1,3,-1
KR_6675002462,420,-4,-23,-29,-6,2,3,5,-6,7,1,-2,3,1,0,2,2,0,1,1,0,-11,-6,3,-4,1,0,0,-1,-1,-1,-1,1,6,-1
KR_6735495291,420,-5,-67,-10,-18,-1,2,1,-2,3,1,-10,11,1,-3,6,3,-2,2,0,0,-15,-1,-5,-1,6,2,0,-3,-1,1,-1,-1,2,-1
KR_6531334872,420,-1,-19,-31,-1,-5,5,0,1,0,1,0,4,4,3,3,6,0,0,0,0,5,19,2,-4,2,0,0,0,1,-1,0,-1,6,-1
KR_6738389722,420,1,10,16,-1,2,0,2,2,3,5,-1,1,0,-2,6,4,-2,3,1,0,-5,-52,-2,-3,5,20,0,0,-1,1,0,1,2,-1
KR_6757496191,420,0,-44,11,3,-2,4,2,0,4,4,-1,2,1,4,1,5,2,0,2,0,7,-4,-7,-4,11,-5,0,0,-1,1,0,-1,6,-1
KR_6747397058,420,2,67,4,5,1,0,1,2,2,4,-4,5,1,7,0,7,-1,2,1,0,8,2,4,-6,2,3,0,0,0,1,0,1,0,-1
KR_6741495525,420,-3,-34,-8,-5,1,2,3,-1,1,0,-4,4,0,0,2,2,-1,1,0,0,-3,2,4,-5,1,-1,0,0,0,-1,0,1,0,-1
KR_6757375036,420,3,46,59,2,0,1,1,3,0,3,2,1,3,-4,4,0,1,0,1,0,0,-123,3,-3,0,-1,0,-1,-1,-1,-1,-1,3,-1
KR_6742170449,420,-4,-124,-4,-9,-2,2,0,-3,4,1,-1,6,5,-3,3,0,0,0,0,0,-12,-11,0,-4,4,1,0,-3,-1,0,-1,-1,1,-1
KR_6532721304,420,0,-88,8,3,-1,3,2,1,5,6,-1,2,1,1,2,3,3,0,3,0,1,-6,2,-6,4,2,0,-2,1,-1,-1,-1,5,-1
KR_6622624157,440,0,-29,-6,-3,-4,4,0,-1,5,4,1,1,2,0,2,2,1,1,2,0,2,12,1,-2,1,0,0,-2,1,1,-1,-1,4,-1
KR_6659997062,420,0,-45,7,-1,-3,4,1,0,2,2,1,1,2,-3,4,1,4,1,5,0,2,-299,1,-4,3,2,0,0,-1,1,1,-1,5,-1
KR_6702620570,420,-1,-44,-10,-9,-2,3,1,-5,6,1,-1,3,2,1,3,4,-2,2,0,0,-11,-1,-4,-1,5,-1,0,0,1,0,0,-1,3,-1
KR_6756489003,420,-4,-7,-32,-12,-3,4,1,1,4,5,1,2,3,-9,11,2,-2,6,4,0,-3,-3,-2,-4,6,2,0,0,-1,0,0,-1,3,-1
KR_6647484643,420,-1,15,16,-7,3,2,5,-3,4,1,-6,7,1,-1,1,0,0,5,5,0,-2,-239,5,-6,1,-4,0,0,-1,1,-1,1,4,-1
KR_6404294299,420,-2,-50,8,-1,-2,3,1,-2,2,0,-5,6,1,7,0,7,1,1,2,1,9,9,4,-4,0,0,0,-2,1,0,-1,1,1,-1
KR_6082510159,440,0,8,54,-1,3,0,3,3,3,6,-1,2,1,-5,6,1,-1,2,1,0,-9,10,-1,-5,6,-5,0,2,1,0,-1,-1,3,-1
KR_6712161306,420,-6,-14,-4,-6,-4,5,1,-3,5,2,0,2,2,4,0,4,-3,4,1,1,-10,-5,-1,-3,4,0,0,-2,0,-1,-1,1,0,-1
KR_6762384464,420,-5,-53,-18,-15,-3,5,2,-3,3,0,-3,3,0,-2,7,5,-4,4,0,-2,-8,-4,5,-6,1,0,0,-2,-1,-1,-1,-1,5,-1
KR_6730931063,420,0,36,-24,1,-4,6,2,1,3,4,4,1,5,0,0,0,0,0,0,0,-2,-94,3,-4,1,-3,0,1,-1,1,1,-1,1,-1
KR_6589482384,420,-2,21,7,-2,-2,3,1,-3,5,2,4,0,4,-2,6,4,1,0,1,0,-1,212,1,-3,2,-4,0,0,-1,0,0,1,2,-1
KR_6592192679,420,-2,-52,-10,-7,-1,5,4,-6,7,1,-2,4,2,7,0,7,-5,6,1,-1,-5,15,0,-5,5,-3,0,-3,-1,-1,-1,-1,2,-1
KR_6756855660,420,0,-36,20,-3,-3,5,2,-1,1,0,-1,1,0,1,4,5,1,0,1,-1,3,-32,-4,-2,6,7,0,0,1,0,0,-1,1,-1
KR_6739138379,420,-8,-24,-28,-17,-6,6,0,-4,6,2,-9,11,2,1,0,1,1,1,2,0,-11,279,-3,0,3,-1,0,-2,-1,-1,-1,-1,4,-1
KR_6667854696,420,-4,-81,-10,-16,-1,3,2,-6,7,1,-3,4,1,-5,7,2,-1,1,0,0,-9,37,-5,0,5,-18,0,-3,1,-1,-1,1,2,-1
KR_6689861726,420,-8,-88,-29,-14,2,1,3,0,1,1,-11,12,1,-2,2,0,-3,3,0,0,-16,-9,-4,-2,6,-3,0,-2,-1,-1,-1,1,6,-1
KR_6715996816,420,-4,-80,10,-10,-2,4,2,-4,5,1,-2,3,1,-2,3,1,0,0,0,0,-8,7,1,-2,1,0,0,0,1,-1,0,-1,3,-1
KR_6397613538,420,-2,-47,-13,-4,-4,4,0,2,3,5,1,1,2,0,2,2,-3,3,0,0,-2,-23,0,-3,3,1,0,-3,0,-1,-1,-1,0,-1
KR_6714494486,420,0,-11,-25,1,-1,2,1,0,1,1,3,2,5,0,3,3,-1,1,0,0,-5,-8,-2,-2,4,-1,0,0,0,1,0,1,0,-1
KR_6626312934,420,-3,-95,-22,-7,0,1,1,-3,4,1,-2,2,0,-5,7,2,3,0,3,0,-4,-3,-2,-2,4,2,0,0,0,1,-1,-1,0,-1
KR_6741210448,440,-1,-15,-23,2,-4,5,1,3,3,6,2,1,3,1,2,3,0,1,1,-1,-4,51,2,-4,2,-29,0,1,0,0,1,-1,0,-1
KR_6762432720,420,1,-18,4,-7,-1,6,5,-2,2,0,-2,2,0,-2,2,0,0,0,0,-1,-6,4,-3,-4,7,-7,0,-1,0,-1,-1,-1,0,-1
KR_6759468883,420,-5,-83,-8,-7,-4,5,1,0,4,4,-1,2,1,-1,4,3,-1,1,0,0,1,239,-6,-2,8,-4,0,0,1,-1,0,1,3,-1
KR_6678611238,420,-1,59,-8,-9,0,4,4,1,1,2,0,3,3,-8,11,3,-2,2,0,-1,-5,-7,0,-3,3,0,0,0,1,1,1,-1,1,-1
KR_6656255461,420,0,-30,4,-6,1,1,2,-5,7,2,2,1,3,-2,5,3,-2,2,0,-1,-14,-3,-3,-2,5,-2,0,1,-1,1,1,-1,2,-1
KR_6638363889,420,1,45,-52,2,0,0,0,-1,3,2,0,4,4,3,3,6,0,4,4,0,3,1,5,-6,1,2,0,1,-1,-1,1,1,6,-1
KR_6603106254,420,-3,-55,19,-6,-2,4,2,-1,3,2,-2,5,3,1,2,3,-2,3,1,0,-5,-49,1,-3,2,16,0,-1,-1,1,-1,-1,1,-1
KR_6755107365,440,-1,18,-20,4,6,0,6,-4,7,3,-3,5,2,6,3,9,-1,1,0,0,-8,-5,0,-1,1,1,0,-1,-1,1,1,1,6,-1
KR_6720180434,420,-1,-28,-8,-5,-4,4,0,-6,6,0,2,1,3,0,0,0,3,1,4,0,0,-8,-3,0,3,0,0,-1,-1,-1,-1,-1,1,-1
KR_6568081350,440,-1,66,-23,-4,-4,5,1,-3,4,1,1,1,2,4,4,8,-2,2,0,1,2,10,0,-5,5,2,0,-1,-1,-1,-1,1,2,-1
KR_6647783181,420,2,-8,1,0,1,0,1,2,1,3,1,1,2,-3,5,2,-1,3,2,-1,-2,0,1,-1,0,0,0,1,1,-1,1,-1,1,-1
KR_6647197188,440,0,-4,32,-1,-3,3,0,1,1,2,0,3,3,1,0,1,0,0,0,0,-3,-57,3,-3,0,-2,0,0,-1,0,0,1,5,-1
KR_6715749127,420,-4,-75,-1,-12,-4,5,1,-1,3,2,-7,9,2,-2,2,0,2,2,4,1,-3,-15,-6,0,6,1,0,-2,1,1,-1,1,5,-1
KR_6604669887,420,-1,-28,4,-1,-1,1,0,-2,4,2,2,1,3,-1,2,1,1,2,3,0,-1,-19,-6,-3,9,1,0,-1,0,-1,-1,-1,0,-1
KR_6653324979,420,-2,-28,-24,-1,1,2,3,3,2,5,-4,5,1,0,5,5,-1,5,4,0,5,193,-3,-3,6,-1,0,0,-1,1,-1,1,4,-1
KR_6621130294,440,-2,-38,-16,2,-1,2,1,-1,4,3,2,0,2,-2,3,1,4,0,4,0,7,1,-1,-1,2,4,0,0,1,1,-1,1,5,-1
KR_6742912612,420,-2,-4,-12,-2,-2,2,0,2,3,5,-1,2,1,-3,8,5,2,0,2,-1,3,-4,-3,-1,4,3,0,-2,1,-1,-1,-1,1,-1
KR_6763710631,420,-5,-58,0,-11,1,1,2,0,2,2,0,2,2,-7,7,0,-5,5,0,0,-11,11,-3,0,3,1,0,-1,-1,1,-1,1,3,-1
KR_6759539589,420,5,76,-24,6,4,1,5,1,2,3,-3,3,0,6,2,8,-2,2,0,0,3,-3,2,-4,2,-3,0,2,1,-1,1,-1,2,-1
KR_6747323909,420,-8,-49,-56,-13,-7,7,0,2,2,4,-1,6,5,-4,7,3,-3,3,0,0,-11,-5,-3,0,3,-2,0,-3,-1,-1,-1,-1,5,-1
KR_6727813157,420,-1,-1,11,0,3,1,4,-1,3,2,-2,4,2,0,4,4,0,0,0,0,-4,1,-2,-4,6,-5,0,0,-1,1,1,1,3,-1
KR_6665148765,420,-2,14,-12,-3,-6,6,0,2,2,4,0,0,0,1,2,3,0,1,1,0,-5,4,4,-5,1,-1,0,1,-1,0,1,-1,6,-1
KR_6764178384,420,-6,-46,-28,-11,3,4,7,-6,7,1,0,1,1,-8,10,2,0,0,0,0,-8,-5,0,-2,2,-2,0,-2,-1,-1,-1,1,2,-1
KR_6715921464,420,-5,-102,-48,-8,-3,3,0,-1,2,1,-5,6,1,1,2,3,0,1,1,0,2,38,2,-4,2,-24,0,-1,1,-1,-1,-1,1,-1
KR_6760448894,420,-3,-43,3,-10,-1,6,5,-2,5,3,-7,10,3,0,4,4,0,0,0,0,-11,-28,-2,-2,4,3,0,-1,-1,-1,-1,1,5,-1
KR_6621540175,420,2,27,-4,1,5,1,6,2,0,2,-1,3,2,-5,8,3,0,1,1,-1,-5,1,1,-3,2,0,0,1,1,1,1,-1,5,-1
KR_6741015793,440,1,5,0,0,0,1,1,1,2,3,-2,3,1,-4,7,3,5,0,5,0,1,-8,-1,-2,3,0,0,1,-1,-1,1,1,2,-1
KR_6690031007,420,-3,3,-7,3,3,4,7,5,0,5,-7,7,0,5,1,6,-3,3,0,-1,8,-1,-2,-4,6,3,0,-1,0,1,-1,-1,0,-1
KR_6484218311,420,-13,-189,-58,-22,-5,5,0,-3,3,0,-7,7,0,-4,4,0,-3,3,0,-1,-15,-9,-1,-2,3,1,-1,-7,-1,-1,-1,-1,3,-1
KR_6736207387,420,4,2,-5,7,0,2,2,5,2,7,0,1,1,2,4,6,0,1,1,0,16,4,0,-2,2,2,0,0,1,-1,0,1,1,-1
KR_6643638245,440,-4,-4,-24,-7,-3,3,0,0,2,2,-1,5,4,-1,3,2,-2,4,2,0,0,-1,-2,0,2,1,0,-1,1,-1,-1,-1,2,-1
KR_6576856570,420,-4,-55,-40,-4,-4,4,0,-2,7,5,-1,3,2,5,1,6,-2,2,0,0,-3,-27,2,-5,3,10,0,-1,0,0,-1,-1,0,-1
KR_6741059635,420,-2,-105,-12,-7,-4,4,0,-3,3,0,0,2,2,1,0,1,-1,2,1,0,-5,-7,-2,-1,3,-3,0,-1,-1,-1,-1,-1,3,-1
KR_6613603503,420,-3,-84,-50,-10,-3,3,0,-1,2,1,1,3,4,-7,7,0,0,1,1,-1,-7,10,12,-13,1,-1,0,-2,-1,-1,-1,-1,5,-1
KR_6650233287,420,0,29,-9,-11,2,1,3,-10,12,2,0,4,4,-3,3,0,0,0,0,0,-22,4,-2,-1,3,-3,0,-1,-1,-1,-1,1,2,-1
KR_6105808911,420,-4,7,-24,-6,0,0,0,-5,9,4,0,1,1,0,4,4,-1,1,0,0,-15,0,5,-9,4,-9,0,-1,-1,-1,-1,1,5,-1
KR_6752619286,420,1,-20,-10,3,2,0,2,1,1,2,0,3,3,-1,3,2,1,2,3,0,5,-18,0,-2,2,1,0,0,-1,1,0,1,3,-1
KR_6746886951,420,2,-32,21,5,-1,3,2,2,3,5,4,3,7,-1,3,2,1,0,1,1,6,2,-2,-3,5,1,0,0,-1,-1,0,1,4,-1
KR_6689310069,420,1,-14,-13,-8,-4,4,0,0,6,6,-2,5,3,-3,3,0,1,1,2,0,-1,12,4,-8,4,-2,0,0,1,-1,0,-1,4,-1
KR_6763677459,420,-3,-63,0,-7,-1,3,2,-2,2,0,-5,6,1,3,0,3,-2,5,3,-1,-2,-9,1,-4,3,3,0,-1,1,-1,-1,-1,5,-1
KR_6756194029,440,-4,8,-9,-9,-4,4,0,-8,9,1,-2,4,2,6,4,10,-1,1,0,0,-4,133,-4,0,4,2,0,-1,-1,1,-1,1,5,-1
KR_6597232489,420,1,62,-3,0,-2,4,2,1,1,2,-2,5,3,1,0,1,2,0,2,1,0,1,0,-1,1,0,0,1,-1,1,1,1,2,-1
KR_6690584467,420,-5,-60,-21,-13,-5,7,2,-4,6,2,-4,5,1,0,2,2,0,0,0,0,-8,-35,-6,0,6,-4,0,-3,0,-1,-1,-1,0,-1
KR_6742721390,440,-8,-123,6,-19,-2,2,0,-5,5,0,-5,5,0,-2,3,1,-5,5,0,0,-9,137,0,-3,3,-1,0,-1,-1,1,-1,-1,5,-1
KR_6685083034,420,-1,24,-4,-7,-3,3,0,-1,1,0,-1,1,0,-2,3,1,0,0,0,0,-8,0,-1,-4,5,1,0,0,-1,0,0,-1,1,-1
KR_6686503976,440,-4,-56,7,-9,-3,4,1,-4,5,1,-4,5,1,0,3,3,2,4,6,0,-13,22,0,-2,2,-3,0,-1,1,0,-1,1,4,-1
KR_6701778083,420,-4,-50,10,-13,3,0,3,0,0,0,-7,9,2,-7,9,2,-2,2,0,-2,-3,1,-4,-1,5,1,0,-2,-1,-1,-1,-1,4,-1
KR_6762075785,420,-4,-84,-20,-9,-1,3,2,-4,4,0,-2,6,4,-1,1,0,-1,2,1,0,-6,-1,-2,-1,3,-2,0,-1,0,0,-1,-1,0,-1
KR_6760887948,420,-2,-41,-8,-1,5,0,5,-3,3,0,2,1,3,-5,5,0,0,2,2,1,-8,-9,5,-5,0,-2,0,-2,-1,1,-1,1,1,-1
KR_6088295137,420,-3,-7,-50,1,0,1,1,1,4,5,-1,2,1,1,1,2,0,0,0,0,3,-116,-2,-3,5,-3,0,0,1,-1,-1,1,5,-1
KR_6762132130,420,2,95,-28,11,2,1,3,1,1,2,7,0,7,0,1,1,1,0,1,0,8,-243,8,-8,0,5,0,0,-1,0,0,1,5,-1
KR_6739257920,420,-2,-57,-12,-3,-1,2,1,0,3,3,-1,2,1,-1,2,1,0,2,2,1,0,4,0,-2,2,-2,0,-1,1,1,-1,1,2,-1
KR_6749697213,420,-2,-34,7,-8,3,3,6,-1,1,0,-3,4,1,-6,8,2,-1,1,0,-1,-3,-20,1,-2,1,1,0,-1,1,1,-1,-1,2,-1
KR_6695876036,420,-4,-43,-28,-8,-1,1,0,2,2,4,-2,3,1,-7,7,0,0,4,4,1,-5,-17,-3,-2,5,-1,0,-2,-1,-1,-1,1,5,-1
KR_6751288676,420,-5,-78,24,-7,1,1,2,1,3,4,-1,3,2,-6,8,2,-2,3,1,0,-1,-11,-4,-1,5,-2,0,-2,-1,-1,-1,-1,4,-1
KR_6613363190,420,-5,4,-52,-5,-2,2,0,-2,4,2,0,2,2,-1,3,2,0,2,2,0,1,6,-4,-4,8,3,0,-1,1,-1,-1,1,6,-1
KR_6607429259,440,-6,-30,-20,-17,-2,5,3,-6,6,0,-2,6,4,-7,7,0,0,2,2,0,-8,-109,-1,-3,4,2,0,-2,-1,0,-1,-1,6,-1
KR_6756113565,420,2,57,11,6,-3,4,1,2,1,3,4,4,8,2,1,3,1,0,1,-1,0,10,5,-6,1,-1,0,2,-1,-1,1,-1,5,-1
KR_6668589106,420,0,-18,-22,-7,-1,2,1,-3,4,1,0,1,1,-3,3,0,0,0,0,0,-10,31,2,-4,2,0,0,0,-1,0,0,1,3,-1
KR_6650454530,420,-1,18,-9,0,-1,1,0,1,0,1,6,1,7,-3,3,0,-3,4,1,0,-2,2,2,-3,1,-3,0,-1,-1,-1,-1,1,2,-1
KR_6753889137,420,-2,24,-15,-6,-2,4,2,-1,1,0,0,4,4,-2,3,1,-1,3,2,0,-6,23,-5,0,5,2,0,0,0,1,0,-1,0,-1
KR_6702228678,420,4,45,20,1,1,1,2,2,1,3,3,0,3,-2,2,0,-3,4,1,0,-1,-8,-5,-2,7,4,0,0,1,-1,0,-1,4,-1
KR_6687993759,420,-1,25,-11,-5,-2,5,3,-2,4,2,-4,4,0,2,1,3,1,0,1,0,-1,-9,-2,-3,5,-2,0,-2,-1,-1,-1,-1,3,-1
KR_5872975365,420,-1,24,-13,-11,-4,7,3,-1,2,1,-4,6,2,-2,2,0,0,3,3,0,-6,-78,-3,-5,8,-3,0,-1,-1,-1,-1,-1,3,-1
KR_6691319661,440,2,49,12,-4,1,1,2,-1,2,1,-5,5,0,-1,3,2,2,0,2,-1,0,4,1,-5,4,2,0,0,-1,1,0,-1,2,-1
KR_6441006501,420,5,134,-8,4,2,1,3,-7,9,2,2,2,4,6,1,7,1,0,1,0,-5,-202,3,-5,2,-3,0,3,-1,1,1,-1,2,-1
KR_6763157708,420,-5,-66,-60,-5,-1,2,1,-1,4,3,-3,4,1,-1,4,3,1,1,2,1,-3,0,-1,-4,5,-3,0,-4,-1,-1,-1,1,1,-1
KR_6753619893,440,-1,-46,-3,-6,-2,2,0,0,4,4,0,2,2,-4,4,0,0,1,1,0,-1,7,1,-4,3,-5,0,0,-1,1,0,-1,6,-1
KR_6301129827,420,-3,-90,-17,-9,-12,12,0,0,4,4,-1,4,3,1,2,3,3,1,4,0,-3,-24,1,-9,8,1,0,-2,-1,-1,-1,-1,5,-1
KR_6751735684,420,-1,2,-12,-1,0,1,1,-2,4,2,3,3,6,1,4,5,-3,3,0,0,0,5,-1,-2,3,0,0,0,-1,1,-1,1,1,-1
KR_6741149150,420,0,-1,5,-6,0,0,0,0,2,2,-4,4,0,0,2,2,-2,2,0,0,0,28,-4,-2,6,-2,0,0,-1,1,0,-1,6,-1
KR_6648319627,420,2,55,7,4,3,0,3,0,1,1,2,1,3,-2,3,1,1,1,2,0,5,-176,-2,-4,6,0,0,1,1,1,1,-1,6,-1
KR_6375559460,420,-1,-28,4,-7,1,0,1,-6,8,2,0,1,1,-2,2,0,0,1,1,0,-8,0,0,0,0,-2,0,0,1,-1,-1,-1,3,-1
KR_6107104833,420,0,-13,-15,-4,-3,4,1,0,4,4,-4,6,2,2,1,3,1,1,2,0,1,-1,-4,-3,7,4,0,-1,0,-1,-1,1,0,-1
KR_6596339036,420,-2,-18,-4,-5,0,2,2,1,1,2,-1,2,1,-4,4,0,-1,1,0,0,-6,-5,3,-7,4,-2,0,-1,1,-1,-1,-1,5,-1
KR_6672968019,420,0,-44,-8,1,2,1,3,-2,6,4,1,2,3,0,0,0,0,0,0,0,3,5,3,-3,0,-1,0,-1,1,1,-1,-1,2,-1
KR_6724335402,420,-2,-5,-13,-5,-2,4,2,2,0,2,-6,7,1,1,1,2,0,1,1,0,-3,15,-3,-2,5,3,0,-1,0,1,-1,-1,0,-1
KR_6705902505,420,-1,-78,0,-2,-7,7,0,3,0,3,2,0,2,3,0,3,-3,4,1,0,-3,-219,1,-1,0,-3,0,-3,1,0,-1,-1,4,-1
KR_6661138802,440,0,-5,8,2,3,0,3,2,1,3,-5,9,4,0,2,2,2,0,2,0,9,180,-1,0,1,-4,0,-1,1,-1,-1,-1,6,-1
KR_6641452651,420,0,-17,-10,-4,-3,4,1,3,1,4,-1,3,2,-3,3,0,0,1,1,0,-8,157,-3,-1,4,-21,0,0,-1,0,0,1,6,-1
KR_6740178207,420,0,0,12,4,-2,2,0,1,2,3,2,3,5,2,3,5,1,1,2,0,1,-36,4,-7,3,1,0,0,1,1,1,1,1,-1
KR_6757244015,420,-1,-43,-10,-6,-2,2,0,-2,5,3,-4,4,0,3,2,5,-1,4,3,0,0,-10,2,-4,2,1,0,0,-1,1,1,-1,2,-1
KR_6410315605,420,-3,2,-30,-2,7,0,7,-1,4,3,-3,3,0,-3,4,1,-2,2,0,0,-1,36,0,-5,5,-12,0,0,-1,-1,-1,1,3,-1
KR_6749892565,420,-1,-23,-4,-4,-6,7,1,-1,3,2,3,0,3,-1,4,3,1,0,1,0,-5,-8,-5,0,5,1,0,-1,-1,-1,-1,-1,4,-1
KR_6419995525,420,-5,47,-5,-16,1,3,4,-5,8,3,0,7,7,-8,8,0,-4,6,2,-2,-21,-8,-3,-1,4,2,0,1,-1,1,1,-1,4,-1
KR_6618160469,420,-1,24,-16,6,-4,4,0,0,4,4,1,2,3,7,1,8,2,0,2,0,12,-4,0,-5,5,1,0,0,-1,-1,-1,1,3,-1
KR_6764109174,420,-1,-3,-12,-7,-7,7,0,3,1,4,2,1,3,-5,7,2,0,1,1,0,-7,235,6,-6,0,-2,0,-2,-1,1,-1,-1,3,-1
KR_6764257089,420,-1,-27,-16,-11,2,1,3,2,1,3,-4,6,2,-11,11,0,0,2,2,0,-22,-9,0,-2,2,-1,0,-3,1,-1,-1,-1,5,-1
KR_6470293703,420,-2,-45,-8,-13,-2,3,1,-2,8,6,-11,11,0,1,4,5,1,2,3,-1,-13,-9,0,-4,4,0,0,-2,-1,1,-1,-1,5,-1
KR_6746572839,420,-2,-4,-28,-7,0,4,4,1,3,4,-3,4,1,-3,3,0,-2,2,0,-3,-2,-2,3,-4,1,0,0,-1,0,0,-1,-1,0,-1
KR_6732218989,440,0,-59,34,-4,-1,3,2,-3,6,3,2,0,2,-2,7,5,0,2,2,0,6,-291,1,-4,3,1,0,-2,-1,-1,-1,-1,4,-1
KR_6689274927,420,-7,-53,-24,-10,-2,2,0,-2,3,1,-6,9,3,-1,1,0,1,0,1,-1,-11,5,0,-2,2,-2,0,-2,1,1,-1,-1,5,-1
KR_6737480878,420,-5,-50,-4,2,1,2,3,-1,3,2,0,3,3,1,2,3,1,0,1,0,3,-276,1,-3,2,1,0,-1,-1,-1,-1,1,6,-1
KR_6747281008,440,0,0,7,0,-1,1,0,1,3,4,1,1,2,0,2,2,-1,1,0,0,1,1,0,-3,3,2,0,0,1,-1,0,-1,2,-1
KR_6624320463,420,0,16,-36,4,4,1,5,4,5,9,-5,7,2,1,2,3,0,0,0,-1,-1,10,8,-11,3,-5,0,0,-1,-1,0,1,5,-1
KR_6748888891,440,-2,-14,-36,-4,3,0,3,-7,7,0,-3,4,1,-1,4,3,4,0,4,0,-6,-60,-2,-1,3,-3,0,1,-1,1,1,-1,1,-1
KR_6634115320,420,-2,-23,-8,-6,0,1,1,0,2,2,-3,3,0,-4,4,0,1,0,1,0,-3,4,0,-2,2,-1,0,-1,-1,0,-1,1,6,-1
KR_6471517906,420,-4,-79,0,-9,-1,3,2,-2,3,1,-2,3,1,-4,4,0,0,0,0,0,-8,9,-1,-1,2,-2,0,0,-1,1,0,-1,3,-1
KR_6682844838,420,1,2,13,3,7,0,7,1,2,3,-2,4,2,-5,8,3,2,1,3,2,5,4,-4,-1,5,3,0,2,1,-1,1,1,5,-1
KR_6678984461,420,-2,0,12,-4,-2,4,2,1,3,4,-1,3,2,0,0,0,-2,2,0,0,0,-18,3,-7,4,-4,0,0,1,1,0,1,4,-1
KR_6736012955,420,-3,-84,3,-10,1,2,3,0,1,1,-3,3,0,-6,6,0,-2,2,0,0,-12,5,0,-1,1,-1,0,0,-1,-1,-1,-1,1,-1
KR_6764591799,420,-1,-60,6,-1,-5,6,1,0,2,2,-3,4,1,2,0,2,5,0,5,0,6,2,-1,-2,3,4,0,1,1,-1,1,-1,3,-1
KR_6762438023,420,0,-77,0,2,-1,2,1,-1,2,1,0,4,4,0,1,1,4,0,4,-1,-4,29,1,-3,2,-4,0,1,-1,-1,1,-1,5,-1
KR_6764145864,420,1,38,-23,5,-1,2,1,2,2,4,1,0,1,3,1,4,0,1,1,1,8,15,2,-4,2,-2,0,0,1,-1,0,1,2,-1
KR_6682019877,420,-2,-25,-4,-2,0,2,2,-3,5,2,-4,7,3,8,0,8,-3,4,1,-1,-6,-23,-4,-3,7,3,0,0,0,-1,-1,-1,0,-1
KR_6758756823,420,-3,-34,-12,-9,2,2,4,-3,5,2,-3,7,4,-5,7,2,0,1,1,1,-10,-1,-4,0,4,0,0,0,-1,-1,-1,1,1,-1
KR_6725591133,420,-2,-3,-23,1,0,0,0,-4,6,2,2,1,3,3,2,5,0,1,1,0,-3,-5,-1,-2,3,2,0,0,-1,1,0,1,6,-1
KR_6727733402,420,-1,7,-26,-12,1,1,2,-3,4,1,-5,6,1,-2,3,1,-3,3,0,0,-13,28,-4,0,4,-15,0,1,0,-1,1,1,0,-1
KR_6132273984,440,-2,-21,17,-7,-1,3,2,2,3,5,-2,3,1,-9,10,1,3,0,3,1,-16,-9,-4,-3,7,4,0,-2,-1,1,-1,1,5,-1
KR_6476459248,420,-1,17,-15,-4,1,3,4,0,3,3,-1,4,3,-4,5,1,0,0,0,0,-6,-30,1,-5,4,20,0,-1,-1,-1,-1,1,2,-1
KR_6649327615,420,0,-73,-16,-1,-3,3,0,-2,3,1,-1,2,1,4,4,8,1,1,2,0,2,4,-2,-3,5,1,0,0,-1,1,1,1,2,-1
KR_6635910025,420,-2,-53,21,-3,2,0,2,-4,5,1,-2,4,2,0,2,2,1,1,2,0,-5,-6,2,-4,2,0,0,-1,-1,-1,-1,1,2,-1
KR_6735292143,420,-5,-82,4,-5,-3,3,0,-1,1,0,-7,7,0,6,0,6,0,1,1,0,4,-212,0,-3,3,2,0,-1,-1,1,-1,-1,3,-1
KR_6704744023,440,-4,-2,-8,-10,-1,4,3,-5,6,1,0,2,2,-5,7,2,1,3,4,-2,-8,4,6,-6,0,-6,0,-2,0,-1,-1,-1,0,-1
KR_6750422664,420,-2,-52,17,-4,-1,2,1,1,2,3,0,3,3,-5,7,2,1,1,2,0,0,105,-3,-1,4,-3,0,-1,1,-1,-1,-1,3,-1
KR_6743080562,440,0,-12,-55,7,-2,2,0,0,2,2,1,0,1,9,1,10,-1,3,2,2,11,-10,2,-3,1,3,0,0,-1,0,-1,1,4,-1
KR_6652254635,420,-5,-50,-9,-12,-6,6,0,-3,5,2,-4,5,1,-2,2,0,3,0,3,-1,-3,-1,1,-5,4,-4,0,-3,1,-1,-1,-1,4,-1
KR_6677058008,420,-5,-85,-18,-9,-1,3,2,2,2,4,-2,3,1,-6,7,1,-2,3,1,-3,-8,-5,-2,0,2,0,0,-5,1,-1,-1,-1,3,-1
KR_6696981997,420,-2,-53,17,-5,-1,1,0,4,2,6,4,0,4,-4,5,1,-8,9,1,0,-11,-1,-2,-2,4,1,0,-1,-1,-1,-1,1,1,-1
KR_6756454347,420,1,63,-10,-3,2,1,3,3,0,3,-4,7,3,-1,5,4,-3,3,0,-1,4,-7,-2,-2,4,-2,0,-1,0,-1,-1,-1,0,-1
KR_6647759116,440,-2,-4,16,-2,-1,3,2,3,1,4,-1,2,1,-4,4,0,1,0,1,0,-5,-9,-5,-1,6,-1,0,-1,-1,1,1,1,6,-1
KR_6763060774,420,-2,-44,0,-5,-3,4,1,-1,2,1,-5,6,1,2,5,7,2,2,4,-3,-4,6,5,-6,1,2,0,0,1,-1,0,-1,5,-1
KR_6629574427,420,2,0,-12,1,-1,1,0,-3,5,2,5,4,9,1,4,5,-1,1,0,0,2,4,4,-7,3,1,0,0,1,-1,0,-1,3,-1
KR_6712655222,420,-4,-67,-20,-15,-3,4,1,-13,15,2,2,0,2,0,5,5,-1,2,1,0,-13,0,0,-5,5,-5,0,-2,-1,1,-1,-1,3,-1
KR_6751859253,420,-1,-10,12,-4,2,1,3,-3,4,1,-4,5,1,3,1,4,-2,3,1,0,-5,-35,-3,0,3,1,0,0,-1,-1,0,-1,1,-1
KR_6722875436,420,3,46,4,6,-2,4,2,6,0,6,-3,3,0,5,2,7,0,1,1,0,10,-24,-1,-3,4,-1,0,0,1,-1,-1,-1,6,-1
KR_6688896723,420,-3,-13,-57,-2,-1,2,1,0,0,0,1,3,4,-3,3,0,1,0,1,0,-2,-7,4,-5,1,-3,0,-2,-1,1,-1,-1,6,-1
KR_6617352887,420,-10,-147,-8,-22,-5,6,1,0,3,3,0,4,4,-14,14,0,-3,3,0,1,-10,-2,1,-4,3,3,0,-5,-1,1,-1,1,3,-1
KR_6636345965,420,-5,-50,-30,-4,0,1,1,1,1,2,-2,4,2,2,3,5,-5,6,1,1,-4,-295,-2,-2,4,0,0,-1,-1,-1,-1,1,5,-1
KR_5999732948,420,-7,-120,-62,-11,-9,10,1,-1,3,2,-2,2,0,1,0,1,0,0,0,0,2,-18,0,-3,3,1,0,-1,-1,-1,-1,-1,1,-1
KR_6576240316,440,-1,17,-9,4,3,0,3,5,1,6,-7,9,2,4,4,8,-1,1,0,1,2,-271,3,-4,1,-30,0,0,1,1,1,1,6,-1
KR_6733680828,420,-2,-52,-16,-9,-2,3,1,1,2,3,-2,3,1,-6,6,0,0,3,3,0,-6,1,-4,-1,5,1,0,0,0,-1,0,-1,0,-1
KR_6650984486,420,-2,-86,0,-10,0,1,1,-1,1,0,-4,5,1,-5,10,5,0,1,1,0,-7,-245,2,-4,2,-1,0,-3,-1,-1,-1,1,6,-1
KR_6147489050,420,-3,-29,-27,-5,0,2,2,-1,2,1,0,2,2,-6,9,3,2,0,2,-1,-6,-1,-1,-7,8,-4,0,0,0,-1,-1,-1,0,-1
KR_6319493097,420,-3,6,-32,-6,-1,1,0,-1,1,0,-4,7,3,1,2,3,-1,2,1,0,-4,-21,-3,0,3,1,0,0,-1,-1,-1,-1,6,-1
KR_6719420997,440,0,-26,0,-2,-3,4,1,-1,2,1,4,0,4,-1,3,2,-1,1,0,0,-5,0,1,-5,4,-1,0,-1,-1,1,-1,-1,4,-1
KR_6700363976,420,-2,-65,34,-4,-1,7,6,-5,5,0,0,2,2,2,2,4,0,0,0,1,5,-4,0,-2,2,-2,0,0,-1,1,0,1,2,-1
KR_6533838702,420,-2,-78,20,-2,0,2,2,0,2,2,0,1,1,-6,7,1,4,0,4,0,-8,-2,-4,-2,6,-2,0,-1,-1,-1,-1,-1,2,-1
KR_6570091827,420,-2,38,0,-6,1,0,1,-2,2,0,-3,4,1,-1,4,3,-1,2,1,-1,-10,-34,2,-3,1,-4,0,1,-1,-1,1,-1,1,-1
KR_6740355924,440,0,-47,12,-3,-3,4,1,2,0,2,0,1,1,-2,4,2,0,1,1,-1,2,28,-1,-2,3,-3,0,-1,0,1,-1,-1,0,-1
KR_6428366220,440,-4,-64,-12,-3,-2,3,1,-4,7,3,3,1,4,0,2,2,0,0,0,1,5,-5,0,-4,4,-4,0,-1,1,-1,-1,1,6,-1
KR_6705184837,420,-3,35,15,-1,4,1,5,-6,6,0,-1,3,2,1,3,4,1,1,2,1,2,170,-2,-1,3,3,0,0,1,1,1,1,1,-1
KR_6701008554,440,5,93,24,12,3,1,4,1,3,4,6,0,6,-2,5,3,4,1,5,0,2,-286,2,-3,1,1,0,2,0,0,1,1,0,-1
KR_6759372070,440,-3,-13,5,-8,2,0,2,-3,5,2,-3,3,0,-3,5,2,-1,2,1,0,-13,-14,-5,0,5,2,0,0,-1,1,0,-1,2,-1
KR_6711145564,420,1,-28,4,-9,-1,4,3,0,2,2,-6,8,2,-2,2,0,0,0,0,0,-10,30,2,-4,2,-6,0,0,0,0,1,-1,0,-1
KR_6694736382,420,1,20,-8,1,0,2,2,4,0,4,-1,2,1,-1,6,5,-1,2,1,0,2,0,1,-4,3,0,0,0,1,-1,1,-1,5,-1
KR_6593576503,420,-3,-65,-84,-4,-1,3,2,0,1,1,-3,4,1,-3,5,2,3,0,3,0,-3,2,1,-4,3,-2,0,-2,-1,-1,-1,1,2,-1
KR_6676127439,420,-3,-55,-48,-5,-3,4,1,2,3,5,-7,7,0,3,1,4,0,0,0,0,3,-87,2,-8,6,-6,0,0,1,1,0,-1,6,-1
KR_6663471769,420,-5,-54,28,-2,0,0,0,-4,4,0,-2,5,3,4,2,6,0,3,3,2,3,23,2,-5,3,1,0,0,-1,1,-1,1,1,-1
KR_6740233293,420,1,10,-50,-4,0,0,0,-1,4,3,-3,3,0,-2,2,0,2,1,3,0,-2,-1,-2,-1,3,0,0,0,-1,-1,-1,-1,2,-1
KR_6709021586,420,1,-32,11,1,0,1,1,2,4,6,3,1,4,-6,7,1,2,1,3,0,-11,107,2,-6,4,-4,0,-1,-1,1,-1,1,6,-1
KR_6659202420,420,-4,-89,-9,-3,0,1,1,0,1,1,0,6,6,-4,5,1,1,0,1,0,-4,11,7,-7,0,-1,0,0,-1,1,-1,-1,3,-1
KR_6722249388,420,-1,-19,-16,-2,-1,2,1,1,2,3,-2,3,1,1,1,2,-1,2,1,1,-4,54,0,-3,3,1,0,0,-1,1,0,1,6,-1
KR_6693668441,420,-4,-8,-15,-7,-2,5,3,-2,4,2,-1,2,1,-2,2,0,0,0,0,0,-9,-1,5,-5,0,-3,0,0,1,0,-1,-1,5,-1
KR_6338821721,420,2,-31,39,-5,-3,3,0,1,4,5,-4,7,3,-1,2,1,2,0,2,0,1,8,-4,-2,6,3,0,0,-1,-1,0,-1,1,-1
KR_6509820517,420,2,79,36,6,1,1,2,-1,1,0,6,0,6,1,1,2,-1,1,0,0,-1,-1,0,-4,4,-1,0,1,1,1,1,-1,6,-1
KR_6651249210,420,-12,-129,-24,-11,-7,10,3,2,0,2,1,2,3,-9,9,0,2,0,2,0,-10,-9,-3,-1,4,0,0,-2,1,-1,-1,-1,5,-1
KR_6732370733,440,4,51,0,5,2,0,2,-2,3,1,5,0,5,1,0,1,-1,2,1,0,3,17,2,-5,3,0,0,0,-1,-1,-1,1,2,-1
KR_6744943302,420,-6,-32,-33,-6,-2,3,1,-2,3,1,-1,2,1,-1,1,0,0,0,0,0,-2,-12,-4,0,4,21,0,0,-1,-1,0,-1,2,-1
KR_6077795402,420,-5,-25,-1,-13,1,0,1,-5,6,1,-5,5,0,-3,3,0,-1,1,0,0,-18,-229,-3,-2,5,-2,0,-1,1,1,-1,-1,5,-1
KR_6647140137,440,3,16,38,4,0,1,1,0,1,1,-3,3,0,7,0,7,0,0,0,0,7,36,5,-5,0,-3,0,1,-1,1,1,-1,4,-1
KR_6761271509,420,2,-22,12,-2,1,0,1,-3,4,1,0,1,1,2,3,5,-2,3,1,0,-1,-3,4,-6,2,2,0,0,1,-1,-1,1,2,-1
KR_6689143150,420,-1,12,-12,-3,3,1,4,-2,4,2,1,0,1,-2,4,2,-3,3,0,0,-6,-41,-3,-4,7,17,0,0,-1,-1,0,1,1,-1
KR_6602419153,420,-1,10,28,-6,1,1,2,-3,4,1,-4,8,4,1,1,2,-1,2,1,-1,-2,16,-3,0,3,-4,0,0,0,-1,1,-1,0,-1
KR_6673486003,420,-3,-35,12,-9,2,1,3,-1,5,4,-2,4,2,-9,11,2,1,0,1,0,-12,-181,-4,0,4,0,-1,-2,1,-1,-1,1,6,-1
KR_6652185505,420,-2,-15,-4,-8,-1,2,1,-1,1,0,0,4,4,-6,6,0,0,1,1,0,-13,1,-5,0,5,-1,0,0,-1,-1,0,-1,3,-1
KR_6647163397,440,-6,-32,-24,-15,-5,5,0,-4,5,1,-1,4,3,-3,6,3,-2,5,3,0,-16,24,-1,-2,3,-1,0,-4,1,-1,-1,-1,6,-1
KR_6756416506,420,0,-22,12,-8,1,2,3,0,4,4,-1,1,0,-6,6,0,-2,2,0,0,-10,0,0,0,0,-3,0,0,-1,1,1,-1,3,-1
KR_6752898801,420,-1,17,20,-8,-4,4,0,-6,6,0,1,4,5,0,1,1,1,1,2,0,-9,-29,1,-3,2,23,0,-1,1,-1,-1,1,3,-1
KR_6335871810,420,-4,88,-32,-14,-3,5,2,-3,3,0,-2,4,2,-1,5,4,-5,6,1,0,-9,-22,-6,0,6,1,0,1,-1,-1,-1,-1,6,-1
KR_6696964674,420,-1,1,-12,0,-3,5,2,-1,6,5,3,0,3,2,2,4,-1,2,1,0,-2,9,1,-4,3,-4,0,-1,1,1,-1,1,6,-1
KR_6729209172,420,-3,42,20,-8,-1,3,2,-4,6,2,4,1,5,-6,6,0,-1,1,0,0,-19,1,0,-1,1,-2,0,1,1,1,1,-1,6,-1
KR_6740295748,420,-2,-66,-8,-5,-1,2,1,-2,4,2,-1,5,4,2,4,6,-3,3,0,0,2,0,1,-7,6,1,0,0,0,0,0,-1,0,-1
KR_6754884372,420,-1,-24,-1,3,-2,4,2,3,1,4,2,3,5,-1,6,5,1,1,2,1,5,-2,-4,-3,7,3,0,-1,-1,1,1,-1,6,-1
KR_6686083536,420,2,12,0,2,-1,4,3,1,3,4,0,1,1,1,2,3,1,0,1,1,10,-4,-3,-2,5,1,0,-1,-1,-1,-1,1,3,-1
KR_6651472284,420,1,-27,-24,3,1,1,2,0,2,2,1,3,4,-1,3,2,2,1,3,0,2,-230,0,-5,5,-1,0,0,0,1,-1,-1,0,-1
KR_6590522858,420,-2,-53,-1,-5,0,1,1,-1,3,2,-2,4,2,-2,7,5,0,1,1,0,-5,1,1,-3,2,2,0,0,1,1,-1,-1,6,-1
KR_6673040228,420,4,27,20,2,5,1,6,-4,9,5,2,0,2,-1,3,2,0,2,2,0,-6,3,-3,-3,6,0,0,1,-1,0,1,1,5,-1
KR_6425511114,420,-7,-90,-45,-15,-3,4,1,2,3,5,-5,6,1,-7,7,0,-2,4,2,0,-11,3,8,-10,2,-4,0,-4,1,-1,-1,-1,5,-1
KR_6596162618,420,1,-22,19,4,-1,4,3,5,0,5,3,3,6,-2,5,3,-1,1,0,-2,-5,302,1,-4,3,1,0,-1,0,0,-1,-1,0,-1
KR_6729732110,420,-3,-55,-20,-12,2,2,4,-4,4,0,-1,2,1,-7,8,1,-2,2,0,0,-11,-32,-5,0,5,-1,0,-2,-1,-1,-1,-1,4,-1
KR_5968260967,420,0,-15,17,6,-1,3,2,3,2,5,0,2,2,4,1,5,0,0,0,2,9,-187,4,-5,1,-1,0,1,1,1,1,1,1,-1
KR_6648134388,440,-4,-34,-8,-9,-2,3,1,-6,6,0,1,0,1,-1,1,0,-1,4,3,0,-11,-36,0,-5,5,-4,0,0,0,0,-1,1,0,-1
KR_6646102482,420,0,24,7,-1,-1,1,0,0,5,5,-2,3,1,-1,2,1,3,0,3,0,-2,10,1,-3,2,0,0,0,-1,1,-1,1,1,-1
KR_6552688560,420,-2,-57,13,-7,-2,2,0,-3,5,2,-1,3,2,2,2,4,-3,3,0,0,-4,-255,-5,0,5,2,0,-1,1,1,-1,1,1,-1
KR_6692737771,440,0,-25,-37,1,3,0,3,-2,3,1,0,1,1,0,1,1,0,0,0,0,-1,-16,-7,-1,8,-3,0,0,-1,1,0,-1,1,-1
KR_6688875269,420,-5,-120,-6,-10,-3,3,0,-2,3,1,-4,4,0,-2,3,1,1,0,1,0,-8,-3,0,-2,2,0,0,-4,-1,-1,-1,-1,3,-1
KR_6753815656,420,-3,-12,1,-6,1,1,2,-7,10,3,-5,5,0,3,3,6,2,0,2,0,1,-99,3,-3,0,-1,0,-1,-1,-1,-1,-1,2,-1
KR_6759259372,420,-5,-62,-65,-4,0,0,0,-2,2,0,-2,4,2,0,0,0,0,0,0,0,-8,32,-1,-4,5,0,0,0,-1,1,0,1,4,-1
KR_6713351060,420,-3,-16,0,-5,3,1,4,1,1,2,1,3,4,-4,4,0,-6,6,0,-1,-10,1,-3,-4,7,-2,0,-1,-1,1,1,-1,3,-1
KR_6715348642,440,0,-60,-28,-4,-2,3,1,-1,4,3,5,0,5,-3,4,1,-3,4,1,-1,0,-12,-1,-4,5,3,0,0,-1,0,-1,-1,5,-1
KR_6757918991,420,-3,-39,-8,-9,0,0,0,-2,3,1,-12,12,0,4,1,5,1,1,2,0,-7,-3,-6,-2,8,5,0,-2,-1,-1,-1,-1,5,-1
KR_6603842876,440,1,-118,16,6,1,3,4,5,0,5,1,0,1,-1,5,4,0,2,2,0,-1,15,3,-5,2,-4,0,1,0,1,1,-1,0,-1
KR_6679324829,420,0,32,5,4,1,1,2,-1,3,2,6,1,7,-2,2,0,0,1,1,0,0,-82,1,-3,2,-2,0,-1,-1,-1,-1,1,2,-1
KR_6566363573,420,-1,9,-8,-1,-2,3,1,2,2,4,3,3,6,-5,6,1,1,3,4,0,7,214,-3,-3,6,2,0,-1,-1,-1,-1,-1,4,-1
KR_6762533121,420,1,93,-32,2,-2,3,1,-1,1,0,-3,6,3,10,2,12,-2,2,0,0,8,-22,-3,-1,4,1,0,0,-1,-1,1,1,3,-1
KR_6701659547,420,-9,-116,-12,-19,-4,7,3,-4,5,1,-2,2,0,-9,10,1,0,1,1,0,-17,-12,-6,-4,10,-1,0,-2,-1,-1,-1,-1,5,-1
KR_6740344821,420,1,-43,12,2,0,3,3,2,2,4,2,0,2,0,1,1,-2,5,3,0,7,-6,0,-4,4,6,0,0,-1,1,-1,-1,2,-1
KR_6632153695,420,-6,-80,-12,-9,-2,4,2,0,2,2,3,0,3,-11,15,4,1,3,4,0,3,5,-1,-2,3,-1,0,-2,-1,-1,-1,-1,4,-1
KR_6764645356,440,-5,-110,-30,-7,-1,3,2,0,1,1,1,2,3,-6,7,1,-1,3,2,0,3,-26,-1,-3,4,5,0,-2,-1,1,-1,1,4,-1
KR_6743747508,420,1,14,32,0,-3,7,4,2,2,4,1,2,3,-2,3,1,2,0,2,1,-3,2,0,-5,5,-1,0,-1,-1,-1,-1,1,1,-1
KR_6635559104,420,-3,-1,-35,-7,-2,2,0,4,0,4,-4,7,3,-5,6,1,0,1,1,0,-9,-20,3,-7,4,-3,0,0,-1,-1,0,-1,5,-1
KR_6373622609,420,-1,3,-24,-6,1,0,1,-3,3,0,-2,4,2,-1,2,1,-1,3,2,0,-8,0,0,0,0,-2,0,0,-1,-1,-1,-1,6,-1
KR_6682600461,420,-1,78,-12,-2,-1,2,1,-2,3,1,1,4,5,1,2,3,-1,2,1,0,-2,7,1,-3,2,3,0,0,-1,-1,-1,1,4,-1
KR_6480817751,420,-5,-48,-47,-8,0,2,2,-3,3,0,-4,4,0,1,2,3,-2,3,1,0,-6,-1,-3,0,3,0,0,0,-1,1,0,1,4,-1
KR_6735750946,420,2,39,11,3,3,0,3,0,4,4,-1,2,1,-1,1,0,2,1,3,0,1,243,-1,-7,8,-1,0,2,0,1,1,1,0,-1
KR_6736953159,420,0,-39,0,5,0,3,3,2,1,3,2,0,2,-1,2,1,2,3,5,0,1,-1,0,-4,4,0,0,0,-1,1,0,1,2,-1
KR_6605564564,420,-2,-38,-50,8,0,1,1,0,3,3,1,2,3,7,0,7,0,2,2,0,20,8,-6,-3,9,41,0,-1,-1,-1,-1,-1,2,-1
KR_6752104018,420,-1,-25,15,-4,2,0,2,-2,2,0,0,3,3,-6,6,0,2,0,2,0,-8,5,-1,-4,5,-3,0,0,1,1,1,-1,2,-1
KR_6001669171,420,-2,-61,-2,1,0,2,2,2,1,3,-1,1,0,-2,3,1,2,0,2,0,6,69,2,-4,2,4,0,-1,1,-1,-1,1,5,-1
KR_6763372550,420,-2,-34,-22,-4,-1,2,1,1,1,2,1,1,2,-4,4,0,-1,1,0,0,-1,22,2,-4,2,1,0,1,-1,1,1,-1,4,-1
KR_6573629655,440,-5,-97,-6,-5,-3,3,0,4,3,7,-2,3,1,-4,7,3,0,2,2,0,-1,-3,-2,-2,4,1,0,-1,1,1,-1,1,1,-1
KR_6737204959,420,-1,-34,-16,-7,3,0,3,-6,9,3,1,0,1,-1,2,1,-4,5,1,1,-2,-6,7,-9,2,-6,0,0,1,0,0,1,6,-1
KR_6726157164,420,-6,-33,-88,-3,-3,5,2,-1,2,1,1,2,3,0,0,0,0,0,0,0,5,-44,0,-1,1,31,0,-2,0,-1,-1,-1,0,-1
KR_6747260255,420,-3,-50,-2,-3,1,1,2,-1,6,5,-2,3,1,-1,1,0,0,1,1,0,-6,4,0,-4,4,1,0,-1,-1,0,-1,-1,2,-1
KR_6637280356,420,-4,-47,-28,-7,0,1,1,-6,6,0,0,1,1,3,1,4,-4,5,1,0,-5,-225,0,-1,1,-2,0,0,-1,-1,0,-1,3,-1
KR_6729185656,440,-1,36,0,3,2,0,2,-2,2,0,1,1,2,2,1,3,0,1,1,0,2,-2,5,-7,2,0,0,-1,1,-1,-1,1,3,-1
KR_6745664314,420,-1,37,9,-14,-2,2,0,-6,7,1,2,2,4,-9,9,0,1,1,2,-1,-12,-22,2,-3,1,0,0,0,-1,-1,0,-1,5,-1
KR_6760549802,420,-5,-107,-44,-12,-3,5,2,3,3,6,-12,12,0,-1,2,1,1,1,2,0,-1,30,-2,-1,3,-1,0,-2,0,-1,-1,-1,0,-1
KR_6418828316,420,-5,-85,-16,-8,1,1,2,-3,4,1,-9,10,1,2,1,3,1,0,1,0,1,13,1,-6,5,1,0,0,-1,-1,-1,-1,2,-1
KR_6618083945,420,-1,-36,24,-6,-3,5,2,-1,3,2,-2,3,1,1,4,5,-1,1,0,0,-3,19,3,-5,2,-5,0,0,1,0,0,-1,4,-1
KR_6740749364,420,-6,-43,-52,-18,-3,3,0,-4,8,4,-2,3,1,-8,8,0,-1,1,0,0,-22,-10,0,-5,5,1,0,-2,-1,-1,-1,-1,2,-1
KR_6748912745,420,-2,-110,-9,0,0,2,2,0,1,1,0,3,3,0,0,0,0,0,0,0,4,8,3,-4,1,-1,0,0,-1,1,0,-1,4,-1
KR_6764370681,420,-2,-33,-1,-11,-6,7,1,-3,6,3,0,6,6,-1,2,1,-1,2,1,1,-8,5,1,-3,2,1,0,1,-1,1,1,1,5,-1
KR_6671392548,420,-1,-30,20,0,0,0,0,2,2,4,2,0,2,-4,5,1,0,0,0,0,0,16,-2,-3,5,-1,0,0,1,1,0,1,3,-1
KR_6493500831,420,-1,-41,4,0,-1,3,2,4,0,4,1,2,3,-5,9,4,1,1,2,0,0,-22,-4,0,4,4,0,0,-1,-1,-1,-1,6,-1
KR_6699549181,420,-6,-61,-16,-15,-8,8,0,-3,3,0,0,2,2,-1,2,1,-3,3,0,0,-14,-14,-1,-3,4,1,0,-1,-1,-1,-1,-1,1,-1
KR_6753425080,420,-1,22,3,-9,2,2,4,2,1,3,-5,8,3,-6,6,0,-2,2,0,0,-10,-117,0,-3,3,1,0,-1,-1,-1,-1,1,4,-1
KR_6762610927,420,1,-17,12,-9,2,1,3,-9,9,0,-1,2,1,-1,4,3,0,1,1,0,-13,5,-5,0,5,1,0,1,1,-1,1,-1,3,-1
KR_6755950771,420,-3,-27,-19,-5,-3,3,0,2,2,4,0,4,4,1,1,2,-5,5,0,0,-7,102,-2,-2,4,2,0,-1,-1,1,-1,1,6,-1
KR_6710178123,420,-4,3,-10,-12,-4,4,0,-2,2,0,-3,6,3,1,0,1,-4,4,0,0,-7,-4,0,-3,3,1,0,1,1,1,-1,-1,1,-1
KR_6730737019,420,-5,-148,24,-9,-3,5,2,-1,2,1,1,3,4,-2,3,1,-4,4,0,0,-5,3,1,-1,0,-3,0,-2,1,-1,-1,-1,6,-1
KR_6757717171,420,-1,-14,-18,-2,5,0,5,1,2,3,-3,4,1,-5,7,2,0,1,1,0,-1,9,3,-6,3,0,0,0,-1,1,0,1,5,-1
KR_6705261940,440,2,-31,40,4,2,2,4,2,3,5,1,2,3,1,5,6,-2,2,0,0,3,-10,-1,-3,4,0,0,1,1,1,1,-1,5,-1
KR_6736229155,420,-3,-21,4,-9,1,0,1,-3,5,2,-4,5,1,-2,3,1,-1,3,2,1,-12,-8,0,-2,2,3,0,0,0,1,0,1,0,-1
KR_6740986746,420,-4,-76,-18,-10,-2,3,1,-1,3,2,-5,6,1,-1,3,2,-1,1,0,0,-6,6,3,-6,3,-3,0,-3,-1,-1,-1,-1,6,-1
KR_6724730979,420,-4,-107,-21,-10,-3,3,0,-2,4,2,0,4,4,-4,6,2,-1,3,2,-2,-2,-5,-3,-2,5,0,0,-2,-1,1,-1,-1,2,-1
KR_6645172089,420,-1,3,-14,4,2,0,2,-2,6,4,0,3,3,4,1,5,0,1,1,0,-4,5,1,-4,3,2,0,0,-1,1,1,1,5,-1
KR_6717825467,420,0,67,8,0,5,0,5,-2,2,0,-1,3,2,-2,2,0,0,0,0,1,-6,-10,-1,-3,4,1,0,1,-1,1,1,1,5,-1
KR_6747719127,420,-3,-9,-47,0,-2,2,0,1,4,5,-1,2,1,0,2,2,2,0,2,0,9,3,0,-3,3,1,0,-1,1,-1,-1,-1,5,-1
KR_6599054158,440,1,-23,-24,-1,4,1,5,-1,6,5,-5,6,1,1,3,4,0,1,1,0,5,2,2,-3,1,-2,0,0,0,0,0,1,0,-1
KR_6622008543,440,-3,-22,16,-4,2,0,2,-4,7,3,2,2,4,-3,4,1,-1,1,0,0,-5,-38,0,-4,4,0,0,-1,-1,-1,-1,1,5,-1
KR_6743030035,420,-2,-93,-4,-4,0,0,0,-1,1,0,1,3,4,-2,4,2,-2,2,0,0,-6,-1,0,0,0,-4,0,0,-1,1,0,-1,5,-1
KR_6227726894,420,-5,-134,-30,-4,2,0,2,-1,4,3,-1,2,1,-2,4,2,-2,2,0,0,-6,19,-4,-6,10,-7,0,-1,1,-1,-1,-1,3,-1
KR_6674563869,420,-2,-63,-28,-12,-7,7,0,-6,6,0,5,1,6,-4,10,6,0,2,2,0,-7,-1,2,-3,1,-1,0,-1,-1,-1,-1,-1,6,-1
KR_6691309082,440,-3,-6,-6,-7,-2,5,3,-2,3,1,0,3,3,0,2,2,-3,3,0,0,0,-5,0,-6,6,-4,0,-1,-1,-1,-1,1,4,-1
KR_6749937262,420,1,-28,29,3,-6,6,0,0,1,1,3,2,5,2,1,3,4,0,4,2,5,5,0,-2,2,-4,0,2,0,1,1,1,0,-1
KR_6668915407,440,2,-15,21,5,1,0,1,5,0,5,7,0,7,-5,5,0,-3,4,1,0,9,212,4,-4,0,19,0,0,0,1,1,-1,0,-1
KR_6675781646,420,2,-20,43,3,0,1,1,0,3,3,-2,4,2,4,0,4,1,1,2,0,1,-2,-2,-7,9,-2,0,0,1,-1,1,-1,5,-1
KR_6749289457,440,-1,-50,-12,-4,1,1,2,1,2,3,0,3,3,0,2,2,-6,7,1,1,-4,-3,-2,0,2,0,0,-1,-1,0,-1,1,4,-1
KR_6667404826,420,1,62,-11,-1,6,0,6,4,1,5,-5,5,0,-5,6,1,-1,1,0,0,-5,0,5,-10,5,-5,0,1,1,1,1,-1,3,-1
KR_6450177109,440,2,14,28,9,1,1,2,6,1,7,-1,1,0,5,11,16,-2,2,0,-1,0,-268,-1,-5,6,5,0,1,1,-1,1,-1,4,-1
KR_6347916516,420,-7,-113,26,-24,-3,5,2,-1,4,3,-1,4,3,-16,17,1,-3,3,0,-2,-28,-7,-2,-3,5,-1,0,-3,-1,-1,-1,-1,1,-1
KR_6602781806,420,1,-39,24,2,0,3,3,0,2,2,2,1,3,-1,2,1,1,0,1,0,4,34,3,-5,2,1,0,0,1,1,0,-1,1,-1
KR_6755020974,420,1,-44,12,4,2,1,3,3,4,7,1,1,2,-3,5,2,1,0,1,0,2,59,-2,-3,5,1,0,0,1,1,1,-1,2,-1
KR_6612220813,420,-4,-124,-21,-10,-2,2,0,1,2,3,-2,3,1,-4,4,0,-3,5,2,0,-5,0,-2,-4,6,-1,0,-1,-1,0,-1,-1,6,-1
KR_6663840502,420,3,12,12,2,4,0,4,0,2,2,4,3,7,-6,9,3,0,0,0,0,2,-13,-2,-4,6,0,0,0,-1,1,1,-1,6,-1
KR_6638799004,420,-3,-38,-10,-2,-6,6,0,3,2,5,0,3,3,2,1,3,-1,3,2,0,0,175,-1,-5,6,1,0,-2,-1,-1,-1,-1,6,-1
KR_6754276828,420,1,-10,26,-5,-1,1,0,0,2,2,1,0,1,-2,4,2,-3,3,0,0,-10,1,-3,0,3,2,0,0,-1,1,-1,1,1,-1
KR_6749107067,420,1,50,-9,0,-3,4,1,1,1,2,0,1,1,3,1,4,-1,1,0,0,1,-7,2,-3,1,-4,0,0,1,1,-1,1,5,-1
KR_6595745872,420,2,-39,14,8,-1,1,0,4,1,5,4,2,6,-1,2,1,2,1,3,2,21,17,0,-2,2,0,0,1,-1,1,1,1,4,-1
KR_6421300999,420,-4,-65,4,-9,-6,8,2,1,1,2,-4,6,2,-1,1,0,1,0,1,0,-2,10,2,-7,5,1,0,1,1,1,1,-1,5,-1
KR_6258599073,420,-9,-36,-20,-21,-4,5,1,0,2,2,-3,3,0,-9,10,1,-5,5,0,-1,-16,17,-4,0,4,1,0,-4,0,-1,-1,-1,0,-1
KR_6689933819,440,-1,39,16,1,-2,2,0,2,0,2,-8,8,0,8,1,9,1,1,2,-1,-1,6,2,-3,1,1,0,1,-1,-1,1,-1,3,-1
KR_6739752329,440,-3,-42,-40,-6,3,2,5,-3,4,1,-5,5,0,-1,4,3,0,1,1,1,1,6,0,-2,2,-2,0,0,1,-1,-1,1,5,-1
KR_6077752255,420,3,4,43,-6,-1,3,2,0,1,1,0,0,0,-5,7,2,0,1,1,0,-9,13,0,-2,2,0,0,-1,-1,-1,-1,-1,4,-1
KR_6759843540,420,-2,-68,32,-9,1,0,1,-5,5,0,2,2,4,-5,5,0,-2,2,0,0,-12,-3,1,-2,1,-2,0,-1,-1,-1,-1,-1,5,-1
KR_6696537878,420,-2,-6,-42,-6,-3,4,1,-3,7,4,3,1,4,-4,4,0,1,0,1,0,-4,12,0,-5,5,-1,0,1,-1,1,1,-1,6,-1
KR_6724055312,420,1,-17,-9,3,-1,2,1,7,3,10,2,1,3,-7,7,0,2,0,2,0,4,1,-2,-6,8,-2,0,0,-1,-1,-1,1,3,-1
KR_6687262417,420,-1,-15,-7,0,0,1,1,-3,6,3,1,1,2,2,0,2,0,0,0,-1,1,-324,2,-6,4,2,0,0,-1,0,0,-1,4,-1
KR_6763333551,440,-2,-64,-15,3,-1,1,0,-1,4,3,5,1,6,0,2,2,0,2,2,0,9,470,-3,-2,5,0,0,-1,0,-1,-1,1,0,-1
KR_6746383010,420,-2,-20,-4,-8,-5,6,1,-2,4,2,1,3,4,-3,6,3,1,3,4,-1,-1,-232,1,-5,4,-1,0,-2,-1,-1,-1,-1,1,-1
KR_6762575445,420,-2,25,15,-1,5,0,5,2,0,2,-4,4,0,1,0,1,-5,5,0,0,-5,4,3,-5,2,-2,0,0,-1,0,0,-1,2,-1
KR_6535935395,420,0,47,2,-5,0,0,0,-3,6,3,0,1,1,-1,4,3,-1,2,1,0,-6,1,-1,-5,6,-2,0,0,-1,0,0,1,2,-1
KR_6753826856,420,3,29,21,2,0,4,4,-1,4,3,2,3,5,2,3,5,-1,3,2,0,-4,8,3,-3,0,-4,0,0,-1,1,-1,-1,5,-1
KR_6602314762,420,-2,-123,0,-3,-3,3,0,2,2,4,-2,2,0,0,1,1,0,1,1,0,1,-11,0,-2,2,4,0,0,0,1,0,-1,0,-1
KR_6707148866,420,-3,-6,0,-3,1,0,1,-2,5,3,1,0,1,-2,2,0,-1,1,0,0,-7,-9,-3,-5,8,0,0,-1,-1,1,-1,1,2,-1
KR_6697799760,420,0,-52,8,4,1,0,1,5,0,5,0,1,1,2,1,3,-4,4,0,0,3,-38,-5,-2,7,15,0,1,-1,1,1,1,2,-1
KR_6748211995,420,1,-41,-7,-5,4,1,5,-4,4,0,-5,6,1,1,5,6,-1,1,0,0,-2,-34,1,-2,1,15,0,-1,-1,-1,-1,1,5,-1
KR_6719866187,440,-4,12,-62,-8,-8,8,0,-3,5,2,0,1,1,3,3,6,0,1,1,0,-9,271,2,-6,4,1,0,-2,1,-1,-1,-1,1,-1
KR_6677544439,420,1,2,6,7,5,0,5,0,2,2,4,0,4,-1,1,0,-1,2,1,-1,6,11,2,-6,4,0,0,0,-1,0,1,-1,1,-1
KR_6710522468,420,-3,-27,1,-11,2,0,2,-5,5,0,-4,4,0,-3,5,2,-1,3,2,0,-4,46,-1,-3,4,-1,0,-1,-1,-1,-1,-1,6,-1
KR_6763538855,420,-6,-118,-40,0,1,1,2,-1,3,2,1,1,2,-1,3,2,0,0,0,0,-1,-1,1,-6,5,-6,0,-1,-1,-1,-1,-1,2,-1
KR_6759644387,420,3,-34,24,2,1,0,1,1,1,2,0,6,6,-2,2,0,2,0,2,0,5,10,7,-9,2,1,0,1,1,1,1,1,1,-1
KR_6724847822,420,1,3,-14,-1,-2,3,1,0,1,1,-1,4,3,3,3,6,-1,1,0,-2,-6,-13,0,-3,3,-1,0,-1,-1,-1,1,-1,6,-1
KR_6739377965,420,-4,-14,-6,-6,-5,5,0,2,2,4,-2,3,1,0,2,2,-1,3,2,0,-2,-168,0,-4,4,20,0,0,-1,1,0,1,3,-1
KR_6484082543,420,2,5,-9,1,-5,7,2,0,4,4,0,4,4,2,0,2,4,0,4,0,-1,-8,-4,-5,9,2,0,-1,-1,-1,-1,-1,6,-1
KR_6611296603,420,-1,-53,22,-5,2,0,2,3,1,4,-5,5,0,-5,8,3,0,3,3,0,-6,-128,-1,-1,2,0,0,-2,1,-1,-1,1,5,-1
KR_6710125738,420,1,-47,-12,-1,-4,5,1,2,1,3,0,2,2,0,3,3,1,1,2,0,-2,4,3,-4,1,-5,0,0,1,0,0,1,6,-1
KR_6580591621,420,2,-81,17,-1,0,1,1,-1,3,2,-1,3,2,0,3,3,1,0,1,0,-5,-10,0,-7,7,3,0,1,-1,-1,1,1,2,-1
KR_6722342919,420,-4,-72,20,-15,2,3,5,0,5,5,-5,8,3,-5,6,1,-7,7,0,1,-20,-4,-3,-1,4,1,0,-2,-1,1,-1,1,3,-1
KR_6613516514,420,-3,-68,-16,-12,-4,4,0,-4,5,1,1,4,5,-3,3,0,-2,2,0,0,-7,-127,-1,0,1,-1,0,0,1,-1,-1,-1,1,-1
KR_6500128379,420,2,-2,4,5,5,1,6,-1,2,1,0,1,1,3,2,5,-2,3,1,1,0,-4,3,-4,1,0,0,-1,-1,-1,-1,1,6,-1
KR_6456287315,420,-1,14,6,-11,1,2,3,1,3,4,-1,4,3,-9,11,2,-3,3,0,0,-15,10,-2,-2,4,3,0,0,1,1,-1,1,6,-1
KR_6739525639,440,-5,-43,-24,-10,-6,6,0,2,1,3,-4,5,1,-4,5,1,2,0,2,0,-4,1,-3,0,3,0,0,0,-1,1,-1,-1,5,-1
KR_6449790745,420,-5,-57,-28,-5,-1,2,1,2,1,3,1,0,1,-3,4,1,-4,4,0,0,-1,232,3,-4,1,-3,0,0,0,0,1,-1,0,-1
KR_6757774755,440,-1,-41,-8,1,0,3,3,-6,9,3,3,2,5,1,1,2,3,3,6,1,4,3,1,-3,2,-1,0,0,1,1,0,1,1,-1
KR_6763820029,420,-1,-21,4,0,-3,4,1,1,3,4,-2,2,0,3,2,5,1,1,2,0,0,-9,1,-3,2,1,0,0,1,1,0,-1,3,-1
KR_6384400420,420,-2,-1,8,0,2,0,2,0,1,1,-1,3,2,1,5,6,-2,3,1,0,5,26,1,-5,4,1,0,-1,1,-1,-1,1,5,-1
KR_6380954173,420,-3,-146,-12,-5,0,3,3,-2,6,4,6,2,8,-9,10,1,0,1,1,0,-2,-8,-1,0,1,-3,0,-3,-1,0,-1,1,4,-1
KR_6757813083,420,-2,-51,8,-3,-1,2,1,-4,5,1,0,3,3,2,2,4,0,2,2,0,-2,4,3,-4,1,0,0,0,1,-1,0,1,1,-1
KR_6737582600,420,2,53,-6,0,0,3,3,0,3,3,-1,4,3,2,3,5,-1,2,1,0,-5,-16,-5,-4,9,3,0,0,1,0,1,-1,2,-1
KR_6731341811,420,-2,-15,-14,-2,0,1,1,0,2,2,-5,8,3,3,0,3,0,2,2,0,3,2,5,-8,3,-4,0,-1,-1,-1,-1,-1,2,-1
KR_6703569962,420,1,-5,-40,6,-3,3,0,1,3,4,2,2,4,4,4,8,2,2,4,0,11,0,2,-5,3,0,0,-2,1,1,-1,1,4,-1
KR_6750200122,420,-4,-92,-7,-3,2,1,3,-1,2,1,-4,6,2,0,1,1,0,0,0,0,0,-2,2,-2,0,0,0,1,-1,1,1,1,5,-1
KR_6744154679,420,-5,-97,-58,-4,-3,5,2,-1,2,1,1,9,10,-2,5,3,1,1,2,0,-6,-2,-3,-2,5,1,0,-1,-1,0,-1,-1,1,-1
KR_6672600388,440,-3,-32,-28,-3,-6,6,0,0,4,4,2,0,2,-4,6,2,5,0,5,1,-1,104,-5,-1,6,4,0,1,-1,0,-1,1,4,-1
KR_6604581120,420,-2,-73,-1,-8,-5,5,0,-2,6,4,-2,4,2,1,2,3,0,0,0,0,2,14,4,-6,2,-1,0,-1,1,-1,-1,1,6,-1
KR_6648251099,420,-3,-37,0,-10,-4,5,1,-3,8,5,3,3,6,-5,5,0,-1,1,0,0,-19,-7,1,-4,3,-2,0,0,1,1,-1,-1,1,-1
KR_6740622361,420,-4,-96,-60,-8,0,0,0,1,0,1,-2,4,2,-6,6,0,-1,2,1,-1,-5,-11,-1,-5,6,-2,0,-1,1,0,-1,-1,2,-1
KR_6744894285,420,-2,-29,-28,-3,4,0,4,0,1,1,-6,6,0,-1,3,2,0,0,0,0,-1,0,0,-4,4,-4,0,-2,-1,-1,-1,1,2,-1
KR_6733361906,420,1,47,9,2,1,1,2,5,0,5,1,2,3,-4,6,2,-1,2,1,0,-2,47,1,-4,3,-33,0,0,1,1,0,1,5,-1
KR_6700296765,440,1,48,-38,4,3,0,3,-2,4,2,2,2,4,1,2,3,0,0,0,0,6,3,2,-7,5,1,0,1,1,1,1,1,3,-1
KR_6433014068,420,-1,-30,12,-5,4,0,4,-2,7,5,-1,2,1,-2,2,0,-4,4,0,0,-9,-143,-3,-1,4,3,0,-1,1,-1,-1,1,2,-1
KR_6730072840,420,-3,-58,-4,-14,5,0,5,-1,2,1,-10,10,0,-7,8,1,-1,2,1,0,-10,-11,-6,0,6,0,0,-2,1,-1,-1,-1,5,-1
KR_6704050430,440,-3,-108,-13,-5,-2,2,0,-2,6,4,-2,2,0,2,3,5,-1,2,1,0,-5,2,5,-5,0,1,0,-1,1,-1,-1,-1,3,-1
KR_6701314502,420,-3,-70,0,-8,-2,3,1,-2,2,0,0,1,1,-2,6,4,-2,2,0,-1,-3,4,-1,-4,5,-3,0,-1,1,-1,-1,-1,3,-1
KR_6680408165,440,-3,22,-28,-9,-3,4,1,-7,7,0,1,0,1,0,0,0,0,1,1,0,-7,25,2,-4,2,-4,0,0,-1,0,0,-1,2,-1
KR_6592119160,440,-3,-28,9,-6,3,1,4,-1,3,2,0,2,2,-5,5,0,-3,3,0,0,-11,-20,3,-7,4,2,0,0,-1,1,1,-1,5,-1
KR_6606201365,420,-4,-11,-42,-5,-1,2,1,1,1,2,-4,6,2,1,3,4,-2,3,1,0,-2,-2,0,-4,4,-2,0,0,1,-1,-1,-1,5,-1
KR_6676669677,420,0,5,0,-2,-4,4,0,0,2,2,2,5,7,0,2,2,0,0,0,0,-8,11,-2,-5,7,0,0,0,1,-1,-1,-1,3,-1
KR_6748374541,440,1,19,7,-4,-1,1,0,-8,8,0,2,1,3,2,2,4,1,0,1,1,-7,4,1,-4,3,-1,0,0,0,1,0,1,0,-1
KR_6617849664,420,-5,-44,-40,-7,-2,4,2,-3,4,1,-1,1,0,-2,3,1,1,0,1,1,-5,-11,1,-7,6,-1,0,-1,-1,-1,-1,1,3,-1
KR_6712685563,420,1,-36,19,1,-1,1,0,-4,8,4,4,0,4,2,0,2,0,5,5,0,-4,-92,2,-4,2,-1,0,-1,-1,0,-1,-1,3,-1
KR_6671813319,440,-2,25,16,4,1,1,2,-1,2,1,6,0,6,1,2,3,-3,5,2,0,-7,13,-1,-3,4,0,0,0,1,0,0,-1,6,-1
KR_6715549482,440,3,-40,24,2,-1,1,0,5,2,7,-2,2,0,3,1,4,-3,4,1,0,-7,1,2,-4,2,-1,0,0,1,1,1,1,5,-1
KR_6704367172,420,-2,-17,-8,-6,-6,6,0,-6,8,2,-2,3,1,8,1,9,0,1,1,0,-1,2,2,-6,4,0,0,0,0,0,-1,-1,0,-1
KR_6704975051,420,-4,-56,0,-8,1,1,2,1,2,3,-6,6,0,-3,4,1,-1,1,0,0,-7,-38,1,-5,4,15,0,-3,1,-1,-1,1,4,-1
KR_6748669324,420,-2,42,-16,-2,0,1,1,0,4,4,-5,5,0,2,1,3,1,1,2,0,2,1,-3,-1,4,0,0,0,-1,-1,0,1,2,-1
KR_6682342037,420,-1,-3,-4,-2,-3,4,1,0,3,3,2,3,5,-4,6,2,3,0,3,0,-3,-97,4,-7,3,-4,0,-1,-1,1,-1,1,4,-1
KR_6603767088,440,1,-9,16,-2,-6,7,1,-2,4,2,0,4,4,4,2,6,2,1,3,-1,-1,0,0,-5,5,-1,0,0,1,0,-1,-1,2,-1
KR_6739673460,440,-1,-63,12,-8,0,3,3,-1,3,2,0,4,4,-5,6,1,-2,2,0,-1,-9,4,0,-3,3,-1,0,-1,1,1,-1,-1,5,-1
KR_6195321669,420,-1,15,-20,-3,0,2,2,-1,2,1,-2,3,1,0,4,4,0,2,2,0,-6,-10,-3,-4,7,-3,0,0,-1,-1,0,1,5,-1
KR_6737458021,420,0,5,4,5,3,2,5,2,2,4,-4,5,1,2,3,5,2,0,2,0,6,-4,2,-4,2,0,0,0,-1,-1,1,1,5,-1
KR_6740859970,440,3,-24,-8,1,-1,2,1,-4,7,3,3,2,5,3,0,3,0,0,0,-1,3,7,0,-2,2,-1,0,-1,0,-1,-1,-1,0,-1
KR_6750953169,420,-5,-115,-44,-12,-3,4,1,-1,1,0,-8,8,0,-3,4,1,3,0,3,0,-5,-10,-3,-2,5,-3,0,-2,-1,-1,-1,-1,4,-1
KR_6617399340,420,2,-6,32,-1,3,0,3,-1,1,0,-1,1,0,-1,2,1,-1,2,1,0,-6,-9,0,-1,1,2,0,0,-1,1,1,1,4,-1
KR_6700521618,420,-2,-64,19,-7,-6,8,2,-1,1,0,3,2,5,-5,7,2,2,1,3,1,0,16,2,-4,2,-1,0,0,1,-1,-1,1,4,-1
KR_6716016966,420,-1,-34,-4,-5,1,3,4,-2,2,0,-2,3,1,1,3,4,-3,3,0,0,-8,-7,-5,-1,6,-2,0,-1,-1,-1,-1,1,4,-1
KR_6565977913,420,-1,-44,-19,-6,-3,4,1,-3,5,2,0,4,4,0,1,1,0,1,1,0,4,6,-1,-1,2,-1,0,0,0,-1,-1,-1,0,-1
KR_6699507434,440,-6,-45,-33,-8,-2,3,1,-6,6,0,0,4,4,-2,2,0,2,1,3,0,-6,-1,1,-3,2,-3,0,-2,0,-1,-1,-1,0,-1
KR_6713713644,420,-1,-26,-8,-1,2,2,4,3,1,4,-4,4,0,-1,3,2,-1,2,1,0,-3,24,3,-6,3,0,0,1,1,1,1,1,1,-1
KR_6643262972,420,1,0,9,0,1,1,2,-3,4,1,3,1,4,2,2,4,-3,3,0,0,-4,-2,4,-4,0,2,0,0,-1,1,0,1,2,-1
KR_6739319971,420,-1,-42,16,-5,-3,5,2,-7,8,1,3,1,4,3,4,7,-1,1,0,1,7,-323,-2,-1,3,2,0,-1,-1,-1,-1,1,5,-1
KR_6001518630,420,-3,-39,-31,-5,3,0,3,0,0,0,-2,2,0,-2,3,1,-4,4,0,0,-9,-19,-3,-3,6,-4,0,0,-1,0,0,-1,4,-1
KR_6720756026,420,-4,78,-35,-3,1,2,3,-5,7,2,-1,2,1,1,1,2,1,0,1,0,-3,3,1,-4,3,0,0,-1,-1,1,-1,1,4,-1
KR_6647504916,420,-1,-68,4,-1,4,1,5,-1,3,2,-3,3,0,-2,2,0,1,0,1,0,-6,2,3,-5,2,0,0,0,1,-1,0,-1,4,-1
KR_6602349776,420,-4,-153,17,-1,-1,2,1,-2,2,0,0,2,2,-2,5,3,4,1,5,0,-2,3,-1,-2,3,4,0,0,1,0,0,-1,5,-1
KR_6683934294,420,-1,20,-12,1,2,0,2,0,1,1,-2,3,1,1,1,2,0,2,2,0,3,-60,-4,0,4,17,0,0,-1,1,0,-1,5,-1
KR_6753880787,420,2,31,-1,1,-4,6,2,-3,3,0,1,3,4,3,0,3,4,0,4,0,3,2,2,-2,0,1,0,0,1,-1,-1,1,6,-1
KR_6751872833,440,0,-8,26,-6,-3,4,1,0,1,1,0,1,1,1,7,8,-4,5,1,-1,-13,-3,-1,-4,5,4,0,0,1,-1,1,1,6,-1
KR_6752078454,420,-6,-27,-52,-14,0,1,1,-3,3,0,-9,11,2,-4,5,1,2,0,2,0,-1,-29,-5,0,5,-6,0,-2,-1,-1,-1,-1,3,-1
KR_6748292873,440,-2,-36,-18,-3,2,3,5,-7,9,2,1,2,3,-3,5,2,4,0,4,-1,-2,-2,-3,-1,4,-1,0,-1,0,0,-1,-1,0,-1
KR_6214603210,420,-2,11,-26,4,-2,3,1,2,3,5,5,0,5,-4,7,3,3,2,5,0,4,-302,2,-3,1,-1,0,0,-1,-1,-1,-1,3,-1
KR_6693725199,420,-3,-23,-35,-8,-5,6,1,2,3,5,-8,8,0,3,4,7,0,4,4,0,-6,0,-2,0,2,0,0,0,-1,-1,1,1,3,-1
KR_6683658757,440,-1,-69,4,-1,0,1,1,-1,5,4,2,0,2,-1,1,0,-1,3,2,0,1,7,-1,-4,5,0,0,0,0,0,0,1,0,-1
KR_6681133311,440,-1,5,24,1,-7,7,0,1,0,1,3,0,3,5,1,6,-1,2,1,0,-1,8,-1,-4,5,0,0,-1,1,-1,-1,-1,3,-1
KR_6717941008,420,-1,1,-8,3,1,3,4,-3,4,1,2,3,5,1,3,4,2,0,2,0,4,4,3,-5,2,4,0,2,1,1,1,1,5,-1
KR_6708987754,420,1,15,8,-9,-4,4,0,-1,1,0,2,2,4,-6,6,0,0,1,1,-1,-14,12,-3,-4,7,-7,0,-2,1,-1,-1,-1,2,-1
KR_6758952154,420,-4,-79,-9,-13,0,2,2,-1,2,1,0,1,1,-8,10,2,-4,6,2,2,-8,1,-3,0,3,-2,0,-2,1,-1,-1,1,5,-1
KR_6577176302,420,-2,-5,7,0,0,0,0,2,1,3,-3,4,1,1,3,4,0,0,0,0,0,-1,1,-7,6,1,0,0,1,1,1,1,4,-1
KR_6652926746,420,-1,-67,8,-6,-6,6,0,-1,1,0,1,2,3,0,2,2,0,2,2,0,-4,10,3,-3,0,0,0,-1,-1,0,-1,-1,6,-1
KR_6646490954,420,-4,-60,-52,-1,-5,7,2,5,3,8,-4,4,0,5,0,5,-2,2,0,0,5,-38,1,-1,0,0,0,0,0,1,-1,1,0,-1
KR_6730001012,420,-1,2,3,1,2,1,3,-4,9,5,-2,3,1,1,3,4,4,1,5,1,2,-11,1,-3,2,2,0,2,1,1,1,1,6,-1
KR_6750354828,420,-1,-68,13,-6,-2,3,1,-1,5,4,-2,4,2,-3,3,0,2,0,2,0,4,0,-2,-4,6,2,0,0,-1,1,-1,-1,4,-1
KR_6614670206,420,-1,26,-7,-7,-1,3,2,1,3,4,-3,3,0,-3,3,0,-1,3,2,0,-1,-1,-1,-5,6,2,0,1,-1,1,1,1,1,-1
KR_6610503680,420,-1,-6,-9,-6,-2,5,3,0,1,1,3,1,4,-5,5,0,-2,3,1,0,-4,-7,2,-2,0,3,0,-2,1,-1,-1,-1,1,-1
KR_6653127505,420,-5,-74,-7,-14,-3,3,0,-4,4,0,-3,5,2,-7,10,3,3,0,3,0,-12,5,-2,0,2,-2,0,-1,-1,0,-1,-1,2,-1
KR_6570311469,420,-2,-16,4,-7,-3,4,1,-2,4,2,1,0,1,-2,2,0,-1,1,0,0,-6,-4,-6,0,6,3,0,-1,-1,0,-1,1,4,-1
KR_6732467579,420,-4,-4,-8,-8,-4,5,1,-1,3,2,1,2,3,-2,4,2,-2,2,0,0,-13,-8,-2,-3,5,-1,0,-1,-1,-1,-1,-1,1,-1
KR_6733449668,420,1,97,8,8,0,1,1,-4,4,0,8,2,10,7,1,8,-3,5,2,0,5,3,1,-4,3,-2,0,2,1,-1,1,-1,2,-1
KR_6729654674,440,-9,-67,-45,-21,-4,5,1,-3,5,2,-3,4,1,-2,2,0,-9,9,0,0,-23,-16,-2,-2,4,-2,0,-2,-1,-1,-1,-1,6,-1
KR_6612483788,440,-2,-30,-32,-6,0,1,1,2,1,3,-6,7,1,-2,4,2,0,0,0,0,-5,0,-1,-4,5,-3,0,0,-1,-1,0,-1,4,-1
KR_6589690734,420,-4,-95,0,-8,1,0,1,-4,6,2,-1,3,2,-3,3,0,-1,1,0,-2,-13,7,-2,-4,6,-4,0,0,-1,0,0,-1,3,-1
KR_6673456788,420,-3,22,12,-3,-4,4,0,4,3,7,2,2,4,-4,5,1,-1,1,0,0,0,259,3,-3,0,1,0,1,1,1,1,1,6,-1
KR_6756727486,420,-1,-32,7,6,1,1,2,2,1,3,-3,4,1,4,4,8,2,0,2,1,5,3,8,-8,0,0,0,-3,1,-1,1,1,6,-1
KR_6764674750,420,-2,-30,-20,-12,1,0,1,0,1,1,-13,13,0,0,0,0,0,0,0,0,-3,-8,0,-5,5,-1,0,-2,0,-1,-1,-1,0,-1
KR_6743771236,440,3,34,24,6,0,2,2,2,3,5,5,2,7,1,1,2,-2,3,1,0,0,-14,-5,0,5,2,0,0,1,-1,1,1,5,-1
KR_6653414670,420,-4,-7,-9,-5,4,1,5,0,4,4,-2,4,2,-7,7,0,0,2,2,0,-11,-1,7,-9,2,-1,0,0,-1,0,1,-1,4,-1
KR_6725984545,420,-2,-25,-45,-3,7,0,7,-6,6,0,1,0,1,-4,5,1,-1,1,0,-1,-9,-4,1,-4,3,-3,0,1,-1,1,1,-1,3,-1
KR_6487490441,420,-5,-59,-40,-6,-6,6,0,5,1,6,-1,4,3,-4,6,2,0,0,0,1,0,62,5,-6,1,-22,0,0,-1,-1,-1,1,4,-1
KR_6025780748,440,2,46,25,3,4,1,5,-4,5,1,-3,5,2,5,0,5,1,0,1,1,-4,134,2,-3,1,0,0,2,-1,0,1,1,4,-1
KR_6717232304,440,1,4,16,4,0,1,1,4,1,5,-2,2,0,2,4,6,0,1,1,0,12,6,-3,-5,8,2,0,1,1,1,1,1,1,-1
KR_6682876252,440,-3,-63,-16,2,3,2,5,-2,3,1,1,4,5,7,0,7,-7,7,0,0,6,0,2,-4,2,-3,0,0,-1,1,0,-1,5,-1
KR_6652362878,440,3,-17,32,8,-1,2,1,3,1,4,3,1,4,4,4,8,-1,2,1,0,0,-12,0,-4,4,2,0,0,0,1,-1,1,0,-1
KR_6763499976,420,1,-31,-20,-6,0,1,1,-3,4,1,-2,3,1,-2,3,1,1,1,2,0,-11,-16,-5,-3,8,8,0,0,1,-1,-1,1,3,-1
KR_6744040830,420,-1,63,8,-5,1,4,5,-3,5,2,-1,1,0,-4,5,1,2,0,2,1,-5,16,-1,-3,4,-2,0,0,-1,0,0,1,2,-1
KR_6362343733,440,-2,-58,-4,-8,-1,1,0,2,0,2,2,1,3,-2,2,0,-9,9,0,0,-7,0,0,0,0,0,0,0,-1,0,0,-1,3,-1
KR_6733403430,440,1,20,-8,3,-2,4,2,-4,6,2,0,1,1,7,0,7,2,0,2,0,9,-187,2,-5,3,3,0,-1,1,-1,-1,-1,4,-1
KR_6755744374,420,0,-53,25,-2,0,1,1,-2,4,2,0,1,1,-1,3,2,1,0,1,0,-3,2,4,-6,2,2,0,1,1,1,1,-1,3,-1
KR_6578399199,420,1,19,-16,2,2,0,2,-3,5,2,8,0,8,-5,6,1,0,4,4,0,1,-169,-2,-1,3,-1,0,-2,-1,0,-1,-1,1,-1
KR_6692696730,440,-3,-30,0,-9,-2,3,1,0,2,2,-2,2,0,-3,6,3,-2,3,1,0,-9,-22,-7,-3,10,3,0,-1,-1,-1,-1,-1,3,-1
KR_6703538815,420,0,-56,-17,-6,-6,6,0,-1,5,4,1,1,2,0,3,3,0,3,3,0,-1,4,-2,0,2,-2,0,-1,0,1,-1,-1,0,-1
KR_6680225717,420,0,-1,-3,-7,1,2,3,-1,3,2,-1,3,2,-2,6,4,-4,5,1,0,-11,-7,-1,-2,3,1,0,-1,0,-1,-1,-1,0,-1
KR_6580798295,420,0,3,4,-5,-1,1,0,0,2,2,-3,4,1,-2,3,1,1,1,2,0,-5,9,-3,-2,5,3,0,2,-1,1,1,-1,3,-1
KR_6672558819,420,-1,-65,16,0,2,1,3,0,2,2,-1,2,1,-1,2,1,0,1,1,0,-3,-10,-3,-1,4,1,0,-1,-1,-1,-1,1,5,-1
KR_6763095210,420,0,-53,24,-5,2,2,4,0,2,2,-7,8,1,0,1,1,0,1,1,0,-5,12,-1,-2,3,-3,0,-1,0,-1,-1,-1,0,-1
KR_6602426192,420,-1,-70,32,-5,0,1,1,-2,3,1,-2,3,1,-1,2,1,0,2,2,-1,-5,-1,-3,-1,4,-8,0,-1,-1,-1,-1,-1,1,-1
KR_6753254468,440,-5,-36,4,-10,-6,6,0,-6,6,0,5,0,5,-1,3,2,-2,2,0,0,-8,3,-3,-3,6,4,0,0,-1,0,0,1,2,-1
KR_6746412228,440,1,79,-48,-5,3,0,3,2,2,4,-11,12,1,0,2,2,1,0,1,0,-5,6,1,-2,1,-4,0,0,-1,-1,-1,1,5,-1
KR_6332469015,420,-4,-27,-40,-11,1,1,2,-3,4,1,-5,8,3,-3,4,1,-1,1,0,-3,-16,10,4,-7,3,-8,0,-1,1,0,-1,-1,2,-1
KR_6423003491,420,-1,11,3,3,1,1,2,2,2,4,3,2,5,-2,3,1,-1,1,0,0,0,-6,-2,-4,6,6,0,0,0,0,0,-1,0,-1
KR_6729612208,420,-4,-89,-11,-6,-4,6,2,2,0,2,2,2,4,-6,6,0,0,0,0,-1,-4,-14,-1,-4,5,-1,0,0,1,0,0,-1,1,-1
KR_6637371487,420,-7,-72,-42,-17,-6,7,1,-4,5,1,-3,3,0,-5,5,0,1,0,1,0,-11,0,3,-6,3,-3,0,-1,1,-1,-1,1,2,-1
KR_6424662227,420,6,88,32,2,0,0,0,-2,4,2,6,1,7,0,3,3,-2,2,0,1,-1,8,3,-3,0,-3,0,0,-1,0,1,1,5,-1
KR_6743500758,420,-4,-68,0,-3,-3,5,2,-1,1,0,6,1,7,-6,6,0,1,0,1,0,1,22,1,-5,4,4,0,-3,-1,-1,-1,-1,6,-1
KR_6756318153,420,-4,-60,-12,-10,-1,2,1,-2,3,1,-4,6,2,-2,2,0,-1,2,1,0,-6,-4,1,-2,1,3,0,-1,-1,-1,-1,-1,2,-1
KR_6647090538,440,-7,-55,-46,-6,1,0,1,0,7,7,-3,7,4,-4,6,2,0,1,1,4,11,-31,-4,-1,5,-1,0,-2,0,-1,-1,1,0,-1
KR_6693803225,420,-3,-40,6,-4,-6,7,1,1,5,6,2,0,2,-3,5,2,2,0,2,0,-6,0,1,-3,2,0,0,1,1,-1,-1,-1,4,-1
KR_6602396327,420,5,32,22,5,0,1,1,5,0,5,3,0,3,-5,5,0,2,0,2,-1,-1,27,3,-5,2,-7,0,1,-1,1,1,-1,1,-1
KR_6764663678,440,-3,-95,-28,-10,0,1,1,-2,4,2,-4,5,1,-5,6,1,1,0,1,0,-14,-6,-1,-2,3,-1,0,-2,0,-1,-1,-1,0,-1
KR_6606803696,420,-6,-61,-24,-11,-5,6,1,-1,5,4,-3,4,1,-2,4,2,0,1,1,-1,-9,35,2,-2,0,-1,0,-1,0,0,-1,-1,0,-1
KR_6760493690,420,-3,12,-20,-7,1,1,2,1,5,6,-3,4,1,-1,3,2,-5,5,0,0,-1,-4,1,-4,3,0,0,-2,-1,0,-1,-1,3,-1
KR_6648676240,440,1,-80,-15,3,-2,2,0,3,1,4,-1,4,3,2,1,3,1,0,1,0,2,4,-7,0,7,3,0,0,-1,-1,0,-1,2,-1
KR_6733908729,420,-5,-123,-16,-7,0,2,2,-1,1,0,-5,5,0,0,0,0,-1,1,0,0,-1,-3,0,-3,3,0,0,-1,-1,-1,-1,-1,1,-1
KR_6404199759,420,-4,-75,-27,-7,-3,4,1,-1,1,0,-1,3,2,-2,2,0,0,1,1,0,-1,25,2,-5,3,-3,0,0,0,0,0,1,0,-1
KR_6604333344,420,-2,-19,-10,1,3,1,4,-1,1,0,0,2,2,0,2,2,-1,1,0,0,2,6,2,-2,0,1,0,0,0,-1,1,1,0,-1
KR_6737935086,440,-2,-31,0,-3,-4,6,2,-2,2,0,-1,3,2,2,0,2,2,1,3,0,-3,6,1,-5,4,-1,0,1,1,1,1,-1,3,-1
KR_6686096865,420,0,-39,-4,-2,-4,4,0,1,0,1,-1,2,1,2,0,2,0,0,0,0,4,-2,0,-3,3,1,0,0,-1,-1,-1,-1,4,-1
KR_6761431451,440,-7,-100,-27,-18,1,0,1,-7,9,2,-4,4,0,-6,7,1,-2,3,1,-1,-7,-10,0,0,0,-1,0,-2,-1,0,-1,1,4,-1
KR_6607409273,420,-3,-37,-5,-6,-9,9,0,-1,2,1,-1,2,1,4,1,5,1,2,3,0,4,3,0,-3,3,4,0,0,0,1,1,-1,0,-1
KR_6733543374,420,1,17,-8,3,-1,1,0,-1,4,3,3,1,4,2,2,4,0,1,1,1,1,7,2,-6,4,-1,0,0,-1,1,1,1,5,-1
KR_5934002646,440,-7,-62,-40,-7,-3,4,1,1,2,3,4,1,5,-7,11,4,-2,2,0,0,-1,-11,6,-7,1,-3,0,-2,-1,0,-1,1,3,-1
KR_6668698829,420,-2,-50,-16,-2,-5,5,0,-1,2,1,0,1,1,3,2,5,1,1,2,0,1,4,5,-6,1,-3,0,0,-1,1,-1,-1,4,-1
KR_6708543779,420,-3,-27,-10,-1,-1,1,0,6,2,8,0,2,2,-4,4,0,-2,3,1,0,5,-2,-1,-3,4,-3,0,-1,-1,-1,-1,-1,3,-1
KR_6763710228,420,0,7,-22,1,-4,6,2,2,2,4,2,0,2,-1,3,2,2,0,2,0,4,2,-6,-2,8,3,0,0,0,1,0,-1,0,-1
KR_6653416206,420,-5,34,-16,-9,2,1,3,1,1,2,-6,6,0,-7,8,1,1,0,1,-1,-9,-17,1,-4,3,-1,0,0,-1,1,-1,-1,6,-1
KR_6685664210,420,1,28,-10,2,1,1,2,-2,2,0,2,0,2,3,2,5,-2,4,2,-1,7,-34,-2,-3,5,5,0,0,0,1,1,-1,0,-1
KR_6755294241,420,1,-21,-8,-1,0,1,1,-2,3,1,3,0,3,-2,2,0,0,0,0,0,-8,-4,0,-4,4,1,0,0,-1,1,0,1,2,-1
KR_6607916497,420,-1,-68,28,-7,1,2,3,-3,5,2,-1,1,0,-1,2,1,-3,3,0,0,-4,-2,2,-4,2,-1,0,-1,-1,-1,-1,-1,2,-1
KR_6617691298,420,3,-10,-8,4,2,1,3,-2,3,1,2,1,3,-1,3,2,3,0,3,0,4,-6,4,-6,2,1,0,1,0,0,1,-1,0,-1
KR_6613517653,420,2,57,37,5,1,2,3,-7,7,0,-3,3,0,12,1,13,2,1,3,0,5,-4,-1,0,1,2,0,1,1,-1,1,1,4,-1
KR_6763734292,420,0,40,-8,2,1,1,2,0,4,4,0,3,3,-1,6,5,2,0,2,-1,1,-7,0,-3,3,1,0,1,1,0,1,-1,1,-1
KR_6743547118,440,0,-10,-8,-2,3,0,3,0,3,3,-1,1,0,-3,6,3,-1,1,0,0,-4,-31,-3,-1,4,1,0,-1,-1,0,-1,-1,3,-1
KR_6723898043,420,0,-64,-23,3,0,1,1,1,2,3,-3,3,0,4,0,4,1,0,1,0,3,1,0,-3,3,1,0,0,1,1,-1,-1,1,-1
KR_6532680311,420,-6,-85,-12,-9,-2,2,0,2,1,3,-5,7,2,-1,2,1,-3,5,2,1,-6,-1,2,-4,2,-3,0,-2,-1,1,-1,1,5,-1
KR_6661666257,420,2,38,8,6,2,1,3,2,0,2,3,2,5,1,5,6,-2,2,0,0,7,-107,2,-4,2,0,0,0,-1,-1,-1,1,2,-1
KR_6631292272,420,1,54,-40,3,4,0,4,-2,2,0,-2,3,1,0,0,0,3,1,4,0,1,111,3,-6,3,-1,0,1,0,1,1,1,0,-1
KR_6657875293,420,0,-56,-24,5,-1,2,1,4,2,6,0,3,3,2,0,2,0,2,2,0,13,16,-1,-3,4,-6,0,-1,-1,-1,-1,-1,4,-1
KR_6602534968,420,-3,-61,-39,-12,-3,4,1,0,2,2,-4,6,2,-4,6,2,-1,1,0,-1,-12,-12,-4,0,4,0,0,-1,1,-1,-1,-1,3,-1
KR_6690994417,420,-1,-1,-5,8,3,1,4,0,2,2,5,2,7,-2,6,4,2,0,2,0,1,130,-2,-3,5,0,0,-1,-1,1,-1,1,5,-1
KR_6674226837,420,0,-18,-11,-2,-2,3,1,7,0,7,-2,3,1,-3,4,1,-2,2,0,0,-2,16,0,-4,4,5,0,0,-1,1,0,1,3,-1
KR_6754064211,420,5,13,17,8,3,1,4,-2,5,3,3,1,4,6,1,7,-2,5,3,1,12,-3,4,-5,1,-1,0,1,1,1,1,1,2,-1
KR_6760334435,420,-1,-13,8,-7,3,0,3,-3,4,1,0,2,2,-2,5,3,-5,5,0,0,-11,-2,-1,-4,5,-1,0,-1,-1,-1,-1,-1,3,-1
KR_6746514169,440,-2,-10,-8,-1,4,0,4,-2,3,1,4,1,5,-8,10,2,1,1,2,0,7,54,5,-5,0,-27,0,0,-1,1,0,1,1,-1
KR_6742859495,420,-4,32,0,-11,-2,3,1,-2,4,2,-1,2,1,-4,4,0,-2,2,0,0,-11,7,3,-4,1,-5,0,0,-1,0,0,-1,2,-1
KR_6747229922,420,-3,-38,8,-5,1,1,2,1,1,2,-7,9,2,-1,2,1,1,0,1,0,-3,371,-2,-3,5,1,0,0,-1,0,0,-1,1,-1
KR_6709836535,420,1,-25,20,2,-5,6,1,5,1,6,0,2,2,2,3,5,0,1,1,1,0,41,1,-5,4,-23,0,0,1,-1,1,1,3,-1
KR_6406543524,420,1,11,-20,-4,7,1,8,0,3,3,-2,2,0,-3,3,0,-6,6,0,0,-6,-11,2,-5,3,1,0,0,-1,1,-1,1,2,-1
KR_6710200362,420,2,-11,28,4,1,0,1,4,1,5,-1,2,1,2,3,5,-2,2,0,-1,3,161,3,-5,2,2,0,0,-1,-1,1,-1,3,-1
KR_6703745296,420,2,1,6,-3,2,0,2,3,1,4,-8,8,0,0,3,3,0,0,0,-1,-3,11,3,-4,1,-2,0,1,-1,0,-1,-1,2,-1
KR_6760679703,420,-3,-73,-4,-9,2,0,2,1,3,4,4,0,4,-14,15,1,-2,3,1,0,-10,-257,-4,-1,5,-3,0,0,0,1,-1,-1,0,-1
KR_6710073661,420,-1,-27,35,-3,-2,2,0,4,3,7,-1,3,2,-1,3,2,-3,3,0,0,-1,25,6,-7,1,-6,0,0,1,-1,-1,1,1,-1
KR_6760947244,420,-1,12,-24,-4,-1,4,3,-1,2,1,-1,3,2,-2,3,1,1,2,3,0,-10,-19,-2,-1,3,1,0,1,-1,-1,1,-1,4,-1
KR_6743018279,440,-1,63,5,2,2,1,3,2,1,3,-2,2,0,0,5,5,0,0,0,0,1,3,-3,0,3,-1,0,0,1,-1,0,1,4,-1
KR_6321397652,420,-3,-12,4,-16,-7,7,0,-3,3,0,-4,6,2,0,0,0,-2,2,0,-1,-6,-156,0,-2,2,-3,0,-2,1,-1,-1,-1,6,-1
KR_6572930286,420,0,5,12,-1,-3,5,2,0,0,0,0,3,3,1,2,3,1,1,2,0,3,-7,1,-4,3,0,0,0,-1,0,0,1,3,-1
KR_6763646873,420,1,-10,0,2,-8,8,0,4,0,4,6,1,7,-2,3,1,2,1,3,0,6,-347,1,-4,3,3,0,0,-1,-1,0,1,3,-1
KR_6721216081,420,1,-2,3,2,2,0,2,5,1,6,3,1,4,-3,5,2,-5,6,1,0,-2,-7,2,-6,4,-4,0,-2,-1,1,-1,1,3,-1
KR_6689796415,440,-2,-57,-12,-8,1,0,1,-4,6,2,3,0,3,-4,4,0,-4,4,0,0,-10,2,1,-5,4,0,0,-1,-1,1,-1,-1,2,-1
KR_6650279785,420,-2,-12,18,-5,1,0,1,-5,5,0,3,2,5,-1,3,2,-3,3,0,0,-6,-284,2,-4,2,0,0,-1,-1,-1,-1,-1,3,-1
KR_6690967845,440,-2,-43,2,-10,-2,2,0,-1,2,1,1,1,2,-7,8,1,-1,1,0,0,-13,8,-1,-4,5,0,0,-1,-1,1,-1,-1,4,-1
KR_6755463571,420,0,-20,1,-1,-4,6,2,-1,1,0,0,2,2,2,1,3,2,0,2,0,1,-4,-4,-3,7,1,0,-1,-1,-1,-1,-1,6,-1
KR_6681951076,420,1,33,-4,-2,3,1,4,-3,5,2,-4,4,0,3,0,3,-1,1,0,0,-8,11,3,-5,2,1,0,-1,0,0,-1,-1,0,-1
KR_6625014211,420,2,39,-4,1,3,1,4,0,1,1,1,3,4,-2,6,4,-1,2,1,0,-2,-2,0,-3,3,-2,0,1,1,-1,1,-1,1,-1
KR_6543077153,420,-2,-16,23,-7,-2,3,1,-2,6,4,-2,2,0,0,3,3,-1,2,1,0,-7,174,-5,0,5,-2,0,0,-1,0,-1,1,6,-1
KR_6740777383,420,2,42,-19,7,3,0,3,1,2,3,-1,2,1,-1,2,1,5,0,5,0,3,18,0,-1,1,2,0,1,1,1,1,1,4,-1
KR_6679155715,440,-1,-37,-4,-4,-2,4,2,4,0,4,4,1,5,-10,10,0,0,0,0,0,-9,4,-6,-2,8,-3,0,0,1,-1,-1,1,3,-1
KR_6631463401,420,-3,-48,8,-12,-4,4,0,-4,5,1,0,1,1,-4,5,1,0,2,2,0,-7,-185,-6,0,6,5,0,-1,-1,-1,-1,-1,5,-1
KR_6652900515,420,0,-11,-3,-1,0,1,1,-2,4,2,3,2,5,0,3,3,-2,4,2,1,1,5,1,-3,2,0,0,0,-1,1,0,1,3,-1
KR_6724529106,420,-3,-37,-12,-7,1,3,4,1,1,2,1,0,1,-6,6,0,-4,5,1,0,-5,0,-6,-2,8,-2,0,-1,1,1,-1,-1,6,-1
KR_6558957742,420,-6,-29,-48,-4,-2,4,2,-2,2,0,1,1,2,-1,1,0,0,0,0,-1,-1,-1,-6,-1,7,0,0,0,-1,0,-1,-1,4,-1
KR_6696088617,420,-4,-23,-11,-7,2,2,4,-2,5,3,-9,9,0,2,0,2,0,1,1,1,-12,202,0,-3,3,-7,0,-1,1,-1,-1,1,2,-1
KR_6678933968,440,-2,-54,8,2,-4,5,1,3,1,4,2,4,6,-1,4,3,2,0,2,0,-1,-381,1,-4,3,1,0,0,-1,1,-1,1,2,-1
KR_6672863594,420,-2,-48,6,-1,-4,6,2,3,1,4,-2,6,4,-3,5,2,5,2,7,2,6,17,-2,-3,5,-3,0,-1,1,-1,-1,-1,6,-1
KR_6707059028,420,-1,74,20,0,0,0,0,0,2,2,-5,5,0,1,1,2,4,1,5,0,6,-11,-1,-4,5,0,0,1,0,1,1,1,0,-1
KR_6761808110,440,-4,-43,20,-3,1,1,2,1,1,2,-2,4,2,0,3,3,-3,4,1,0,-3,17,-3,-1,4,-3,0,0,-1,-1,-1,-1,6,-1
KR_6724236682,420,0,-34,12,-3,-2,2,0,-4,4,0,-1,2,1,-1,1,0,5,0,5,0,-9,-19,1,-1,0,-3,0,0,0,-1,0,-1,0,-1
KR_6731246396,420,-1,-9,-30,-6,-2,2,0,-1,1,0,-3,5,2,0,2,2,0,1,1,-1,-1,-111,1,-3,2,4,0,0,-1,-1,-1,-1,1,-1
KR_6652991074,420,-2,-59,-1,-6,2,2,4,0,2,2,0,1,1,-6,7,1,-2,2,0,-1,-6,-1,-1,-1,2,0,0,-1,-1,-1,-1,-1,5,-1
KR_6628520526,420,-2,-50,-19,1,1,0,1,3,0,3,-4,6,2,0,2,2,1,0,1,-1,2,-50,-1,-5,6,20,0,0,1,1,0,-1,1,-1
KR_6565270878,420,5,4,0,2,4,0,4,3,0,3,-3,4,1,-3,4,1,1,1,2,0,3,2,-1,-1,2,2,0,1,-1,0,1,-1,2,-1
KR_6568038398,420,-3,-10,-16,-8,-1,3,2,-2,4,2,2,0,2,-6,8,2,-1,2,1,0,-3,1,0,-4,4,-1,0,-1,-1,-1,-1,-1,6,-1
KR_6741965245,420,-1,-17,14,-6,-2,2,0,-2,5,3,-4,4,0,4,1,5,-2,2,0,0,-7,-17,2,-3,1,1,0,0,-1,0,0,-1,1,-1
KR_6743575600,420,0,43,-8,0,-1,2,1,2,2,4,-3,3,0,0,3,3,2,2,4,0,4,-20,-5,-3,8,2,0,0,1,-1,-1,1,1,-1
KR_6743343007,420,-4,-77,-24,-9,-1,4,3,-3,4,1,-2,2,0,-2,3,1,-1,1,0,0,-11,-194,1,-2,1,-4,0,-1,-1,-1,-1,-1,3,-1
KR_6545895666,420,-2,20,4,-5,2,1,3,-7,7,0,1,1,2,0,3,3,-1,2,1,1,-9,-5,-1,-5,6,2,0,1,1,1,1,1,2,-1
KR_6638333075,420,-3,-53,-24,-10,-3,4,1,-3,4,1,-2,2,0,-3,4,1,1,1,2,0,-8,-24,-7,-1,8,4,0,-1,-1,-1,-1,1,3,-1
KR_6739248206,420,-6,-10,-8,-8,-4,4,0,-4,5,1,-5,6,1,1,1,2,4,1,5,0,-3,11,3,-6,3,-2,0,0,1,-1,1,-1,1,-1
KR_6539578632,420,-1,10,-40,0,-4,4,0,2,0,2,-1,4,3,4,1,5,-1,1,0,0,1,-3,1,-2,1,-1,0,0,-1,0,0,1,4,-1
KR_6757358582,420,-2,-29,-28,-2,1,0,1,-4,5,1,3,1,4,-2,4,2,0,1,1,-2,-14,13,-2,-1,3,-1,0,0,1,1,1,-1,3,-1
KR_6639634737,420,1,67,0,-3,1,2,3,-6,6,0,0,0,0,0,2,2,2,0,2,0,0,-5,1,-3,2,7,0,-1,-1,-1,1,1,5,-1
KR_6723203812,420,0,-65,13,0,3,0,3,1,2,3,-6,7,1,4,2,6,-2,3,1,0,5,-4,-2,-3,5,0,0,1,1,1,1,-1,1,-1
KR_6743987222,420,-6,-63,-16,-6,-6,7,1,-2,4,2,-1,1,0,3,2,5,0,1,1,0,5,-9,-1,-4,5,-1,0,-1,-1,1,-1,1,4,-1
KR_6588584312,420,3,-53,36,-2,0,1,1,2,3,5,-1,1,0,-4,5,1,1,2,3,0,-6,-27,4,-7,3,20,0,-1,1,-1,-1,-1,6,-1
KR_6716384897,440,-5,-29,-21,-5,1,1,2,-5,5,0,-2,2,0,5,1,6,-4,5,1,0,-13,-41,7,-10,3,1,0,1,-1,0,1,1,2,-1
KR_6746435943,420,-2,12,0,-9,-1,2,1,-5,7,2,1,3,4,-1,2,1,-3,5,2,1,-11,-20,1,-3,2,-2,0,-3,1,-1,-1,1,5,-1
KR_6722243628,420,-2,-25,16,-4,3,0,3,-3,4,1,0,0,0,-5,6,1,1,0,1,0,-3,-279,2,-5,3,-8,0,0,-1,1,0,1,4,-1
KR_6738269174,440,-6,-6,0,-12,-1,2,1,-2,3,1,2,4,6,-6,6,0,-5,6,1,-1,-12,259,2,-2,0,0,0,-1,-1,1,-1,-1,4,-1
KR_6683512660,440,-1,-49,7,-4,-4,6,2,1,0,1,1,2,3,-2,3,1,0,0,0,0,2,-19,-3,-1,4,0,0,0,1,1,0,-1,6,-1
KR_6606587496,420,2,35,16,7,1,1,2,4,0,4,-6,7,1,8,1,9,0,0,0,0,8,4,0,-2,2,2,0,2,0,0,1,1,0,-1
KR_6679884815,420,-6,-97,8,-16,-3,3,0,-1,3,2,-5,5,0,-7,8,1,0,1,1,0,-12,0,2,-6,4,1,0,-1,-1,-1,-1,-1,4,-1
KR_6609369541,420,-4,-179,-46,-8,-1,2,1,-4,5,1,-7,7,0,2,0,2,2,1,3,0,-8,-18,-1,-2,3,1,0,-3,-1,-1,-1,-1,4,-1
KR_6656395627,420,-8,-70,-76,-11,-1,1,0,-7,9,2,-4,4,0,2,0,2,-1,1,0,0,-7,2,-4,-3,7,-7,0,-2,-1,-1,-1,-1,1,-1
KR_6755251647,420,-4,-12,-32,-13,2,1,3,-6,6,0,-2,2,0,-6,6,0,-1,1,0,0,-13,-4,1,-3,2,0,0,-1,-1,-1,-1,-1,2,-1
KR_6435023623,420,-2,-64,-12,-9,2,3,5,-3,6,3,-4,5,1,-3,3,0,-1,1,0,0,-3,-3,-4,0,4,-1,0,-2,-1,-1,-1,-1,3,-1
KR_6684388447,420,-3,-73,-14,-11,-4,7,3,-5,5,0,-5,5,0,-2,3,1,5,0,5,-1,-9,-3,1,-4,3,1,0,0,1,-1,0,-1,6,-1
KR_6710023689,420,-4,-77,-36,-3,0,1,1,-1,2,1,2,1,3,-2,2,0,-2,4,2,0,-9,-8,-4,-2,6,4,0,-3,-1,-1,-1,-1,5,-1
KR_6646075462,440,-4,-44,-17,-4,-7,7,0,2,2,4,1,0,1,0,4,4,0,2,2,0,3,0,2,-3,1,-2,0,-1,1,-1,-1,-1,1,-1
KR_6646427644,420,-3,-28,4,-6,-1,2,1,3,1,4,-7,8,1,-4,5,1,3,0,3,0,-1,4,-2,-1,3,-2,0,0,0,-1,0,-1,0,-1
KR_6683558469,420,-1,-14,-23,1,-3,4,1,-3,5,2,-4,5,1,5,1,6,6,0,6,0,-1,-8,2,-5,3,3,0,-1,1,0,-1,1,6,-1
KR_6731743475,420,1,135,-12,4,6,0,6,0,2,2,4,0,4,-5,9,4,-1,1,0,-1,1,6,7,-10,3,-4,0,1,1,0,1,1,6,-1
KR_6742819607,420,-4,-24,-68,-6,1,1,2,-2,3,1,3,1,4,-5,6,1,-3,3,0,-2,-12,7,-1,-4,5,-1,0,1,0,0,-1,-1,0,-1
KR_6749234967,420,-1,12,-40,-3,2,0,2,2,2,4,1,0,1,-8,8,0,0,0,0,0,-6,-3,-2,-3,5,5,0,0,-1,1,0,1,6,-1
KR_6754925951,420,-2,-82,4,7,-1,1,0,1,0,1,6,1,7,-1,4,3,2,0,2,0,5,-9,-4,0,4,-1,0,-1,-1,0,-1,-1,2,-1
KR_6667863617,420,3,8,20,8,0,2,2,1,2,3,5,0,5,2,1,3,0,0,0,0,0,3,1,-4,3,2,0,-1,-1,1,-1,1,3,-1
KR_6462786194,420,1,-18,4,-1,1,1,2,-1,2,1,0,1,1,-1,1,0,0,0,0,0,-3,4,-1,-3,4,-1,0,0,1,-1,1,-1,1,-1
KR_6729435220,420,1,59,16,2,1,2,3,-3,3,0,0,4,4,4,2,6,0,2,2,-2,-7,5,3,-8,5,1,0,2,-1,1,1,1,2,-1
KR_6711215618,420,-4,-36,9,-10,-5,7,2,-1,1,0,0,1,1,-4,6,2,0,1,1,0,-5,-9,0,-5,5,5,0,-1,1,-1,-1,-1,1,-1
KR_6757419895,420,1,-137,-24,-4,-4,8,4,3,2,5,-2,4,2,-1,4,3,0,2,2,0,4,4,5,-7,2,-3,0,-2,-1,-1,-1,-1,2,-1
KR_6741813818,420,-3,-53,-20,-5,-5,5,0,3,4,7,-1,1,0,-2,3,1,0,2,2,0,-3,-3,-1,-6,7,0,0,0,1,-1,0,-1,6,-1
KR_6730971057,420,-3,-55,-18,-1,-1,3,2,3,1,4,1,3,4,3,2,5,-7,7,0,0,-2,9,5,-7,2,-3,0,0,-1,-1,-1,-1,2,-1
KR_6672449411,420,-5,-98,16,-18,-2,3,1,-5,6,1,-2,2,0,-9,10,1,0,0,0,-1,-20,-6,-4,-1,5,-2,0,-2,-1,1,-1,-1,6,-1
KR_6600882916,420,-8,-129,-45,-22,-4,5,1,-7,8,1,-7,8,1,-3,3,0,-1,1,0,-2,-13,5,0,-4,4,-6,0,-5,-1,-1,-1,-1,4,-1
KR_6759621191,440,-2,-38,23,-7,-1,2,1,-4,4,0,3,1,4,-5,6,1,0,0,0,0,-8,-45,-2,-2,4,32,0,-1,-1,1,-1,-1,6,-1
KR_6758968738,440,-2,5,10,-13,-4,5,1,-7,8,1,-1,2,1,-4,6,2,3,0,3,-1,-13,7,-2,-2,4,-6,0,0,-1,1,-1,-1,4,-1
KR_6671473079,420,-6,-69,-12,-17,-3,3,0,-2,2,0,-1,4,3,-10,11,1,-1,1,0,-1,-16,68,2,-6,4,-6,0,-1,-1,1,-1,-1,3,-1
KR_6686103913,420,-3,-54,-15,-1,3,3,6,-3,6,3,-1,2,1,1,3,4,-1,3,2,0,1,-5,-6,-1,7,-1,0,-2,1,-1,-1,1,1,-1
KR_6647196548,440,-1,-32,29,-2,-2,2,0,-1,2,1,-4,5,1,6,2,8,-1,2,1,0,-11,-7,-1,-4,5,-3,0,0,-1,0,0,-1,2,-1
KR_6637167477,420,-1,-52,28,-4,-3,3,0,2,2,4,-5,5,0,1,0,1,1,0,1,0,5,31,2,-6,4,-26,0,-1,1,1,-1,-1,6,-1
KR_6763782654,420,-1,-86,-28,2,5,4,9,0,1,1,-4,4,0,-1,2,1,2,0,2,0,1,-448,0,-2,2,0,0,0,-1,-1,1,-1,6,-1
KR_6756322224,440,-2,-119,-13,-12,0,3,3,2,3,5,-4,6,2,-10,11,1,0,0,0,0,-1,5,-2,0,2,0,0,-3,-1,-1,-1,1,1,-1
KR_6573265341,420,-1,-35,8,-5,0,3,3,0,5,5,-3,3,0,0,1,1,-2,2,0,0,-6,-3,-2,-3,5,0,0,0,1,0,0,-1,3,-1
KR_6620510085,420,-6,-142,-34,-8,0,0,0,-4,5,1,-1,4,3,-3,4,1,0,0,0,-1,-2,-5,4,-7,3,-2,0,-2,-1,-1,-1,-1,6,-1
KR_6732829778,440,-1,-55,-32,-5,-1,2,1,-5,5,0,-1,3,2,0,1,1,2,0,2,0,-4,-3,-6,-1,7,-1,0,-1,-1,-1,-1,1,4,-1
KR_6704870598,420,-3,-7,-35,-6,1,0,1,0,3,3,-5,6,1,-1,2,1,-1,2,1,0,-3,4,0,-3,3,-1,0,0,-1,0,0,1,4,-1
KR_6624385662,440,-1,-16,-23,0,2,2,4,0,4,4,-2,2,0,0,5,5,0,2,2,-1,-7,2,-4,-1,5,1,0,-1,-1,-1,-1,-1,5,-1
KR_6723241430,420,-3,3,4,-5,2,0,2,0,1,1,-2,4,2,-4,5,1,-1,1,0,0,-4,-57,1,-4,3,-4,0,-2,-1,-1,-1,-1,3,-1
KR_6579747238,420,0,36,7,2,-7,8,1,5,2,7,2,0,2,2,2,4,0,1,1,0,0,3,3,-4,1,-1,0,-1,1,-1,-1,-1,3,-1
KR_6709722424,440,-3,36,-52,-13,-6,8,2,-1,2,1,-4,4,0,-1,4,3,-1,4,3,-1,-24,-1,0,-3,3,0,0,-2,-1,0,-1,-1,2,-1
KR_6634410346,420,1,-32,0,4,-2,3,1,-2,4,2,-3,4,1,5,1,6,6,1,7,0,7,10,4,-5,1,-3,0,2,-1,1,1,-1,5,-1
KR_6760626718,420,-4,-31,-12,-13,0,4,4,-3,4,1,-3,4,1,-3,4,1,-4,4,0,-1,-23,108,-1,-5,6,-7,0,0,-1,-1,-1,-1,3,-1
KR_6648012938,440,-1,-50,28,0,-9,9,0,0,4,4,-2,3,1,10,1,11,1,2,3,0,1,13,1,-4,3,-13,0,-1,1,1,-1,-1,2,-1
KR_6729562678,420,-3,-86,-15,-14,-4,4,0,1,3,4,-2,3,1,-6,7,1,-3,3,0,0,-9,-176,3,-3,0,-2,0,-1,-1,-1,-1,-1,6,-1
KR_6758599763,420,0,-31,-10,-1,3,0,3,-3,3,0,1,1,2,0,2,2,-2,4,2,-1,-2,6,1,-2,1,-4,0,-1,-1,-1,1,-1,1,-1
KR_6752381263,440,-2,52,-20,-5,-1,2,1,-1,2,1,1,2,3,0,2,2,-4,4,0,0,-9,-4,2,-3,1,0,0,-1,-1,-1,-1,1,4,-1
KR_6662459119,420,-4,-44,-8,-8,-1,1,0,1,1,2,-6,7,1,-1,2,1,-1,3,2,0,-7,0,-4,-2,6,-4,0,-1,-1,-1,-1,-1,3,-1
KR_6668867960,420,1,-2,12,2,-2,3,1,7,3,10,-3,3,0,1,2,3,-1,1,0,0,8,-4,0,-2,2,3,0,1,1,0,1,1,2,-1
KR_6667096096,420,-2,-53,-12,2,1,1,2,-1,2,1,1,4,5,1,2,3,0,1,1,0,-5,11,-3,-1,4,-2,0,-1,-1,1,-1,1,2,-1
KR_6710084915,420,-5,-44,-36,-7,-1,2,1,-3,5,2,-3,5,2,-4,7,3,4,0,4,0,4,-22,-3,-1,4,19,0,-1,1,-1,-1,-1,2,-1
KR_6686569945,420,0,20,-38,-3,4,1,5,-1,3,2,3,0,3,-3,3,0,-6,6,0,0,-8,-2,1,-3,2,-3,0,-1,-1,-1,-1,1,5,-1
KR_6728972834,420,-7,-39,-36,-7,-5,6,1,-4,4,0,1,2,3,0,2,2,1,1,2,0,-1,31,0,-4,4,-5,0,-1,-1,-1,1,1,6,-1
KR_6760687449,420,0,-58,4,-1,-2,2,0,1,2,3,-3,4,1,2,1,3,1,0,1,0,6,6,4,-7,3,1,0,-1,1,-1,-1,1,4,-1
KR_6735108427,420,1,-107,5,-4,1,2,3,-1,3,2,3,1,4,-7,8,1,0,2,2,-2,-11,8,2,-7,5,-5,0,-3,1,-1,-1,-1,1,-1
KR_6652998622,420,0,-3,-11,1,-2,3,1,1,2,3,2,1,3,-2,5,3,2,2,4,0,0,3,2,-2,0,-2,0,0,0,-1,0,-1,0,-1
KR_6694817542,420,-2,31,4,-1,2,0,2,1,1,2,2,4,6,-4,5,1,-2,2,0,0,-7,7,-4,-4,8,0,0,-1,-1,1,-1,1,3,-1
KR_6698996022,420,0,10,-10,-2,-6,7,1,-3,3,0,2,2,4,2,1,3,3,1,4,1,3,-1,0,-1,1,4,0,2,1,1,1,1,1,-1
KR_6718463485,420,-4,4,-12,-10,0,3,3,-4,5,1,0,0,0,-1,4,3,-5,5,0,0,-8,-2,0,-3,3,-2,0,-1,-1,-1,-1,-1,6,-1
KR_6632549182,420,-5,26,-35,-13,0,1,1,-4,5,1,-5,6,1,-1,1,0,-3,5,2,0,-14,-2,2,-6,4,0,0,-2,-1,1,-1,-1,3,-1
KR_6679308428,420,-4,-30,26,-10,-4,5,1,-2,4,2,-1,2,1,-1,2,1,-2,2,0,0,-13,-22,0,-1,1,1,0,-3,-1,1,-1,-1,1,-1
KR_6644322560,420,-3,-38,-20,-5,0,4,4,1,2,3,-7,9,2,0,1,1,1,0,1,0,-1,-2,3,-5,2,1,0,-1,-1,1,-1,-1,3,-1
KR_6714267636,420,-2,-101,-11,-3,0,1,1,-4,4,0,4,3,7,-1,1,0,-2,3,1,-1,-5,6,4,-11,7,-6,0,-1,-1,1,-1,-1,6,-1
KR_6636272255,420,-1,73,4,-7,0,4,4,-4,4,0,1,4,5,-5,7,2,1,2,3,0,-10,-1,-1,-2,3,0,0,0,-1,1,1,-1,6,-1
KR_6720139982,420,-1,43,-6,-5,0,1,1,-2,4,2,-2,2,0,0,2,2,-1,1,0,0,-8,2,1,-2,1,-1,0,-1,-1,-1,-1,1,6,-1
KR_6692402113,420,-1,-65,-9,-6,-3,3,0,-3,6,3,-2,2,0,1,2,3,1,0,1,0,-5,-6,3,-7,4,-3,0,-2,-1,-1,-1,-1,3,-1
KR_6754405858,420,5,71,54,6,0,0,0,2,0,2,0,0,0,-1,4,3,5,1,6,0,5,-177,-3,-2,5,2,0,0,0,-1,0,1,0,-1
KR_6739870146,420,-1,-15,-8,-3,4,0,4,-9,11,2,0,0,0,4,1,5,-2,2,0,0,1,5,1,-2,1,0,0,-1,-1,-1,-1,-1,3,-1
KR_6655953211,420,2,13,8,-5,-3,3,0,2,0,2,-7,7,0,1,2,3,2,3,5,-1,-4,240,-1,-1,2,-2,0,1,-1,-1,1,-1,1,-1
KR_6707139242,420,-2,-41,-49,-2,2,0,2,0,1,1,2,3,5,-2,3,1,-4,6,2,-2,-7,-2,-3,-2,5,3,0,-1,0,1,1,-1,0,-1
KR_6726016356,420,-2,55,-16,-4,-3,4,1,-7,8,1,3,0,3,2,3,5,1,0,1,-1,-8,10,0,-1,1,1,0,0,1,0,0,-1,3,-1
KR_6257612891,420,-5,-77,-40,-8,-5,5,0,5,0,5,-4,7,3,-4,6,2,0,0,0,0,0,179,-1,-3,4,-2,0,0,0,0,0,1,0,-1
KR_6640643545,420,0,26,-15,0,0,2,2,1,0,1,1,1,2,-2,4,2,0,2,2,0,3,-3,0,-2,2,-3,0,-1,0,0,-1,-1,0,-1
KR_6748321929,440,-1,-42,7,-8,-4,4,0,5,3,8,-1,3,2,-7,7,0,-1,3,2,1,-5,10,-8,-2,10,-4,0,0,0,0,0,1,0,-1
KR_6625106473,420,0,-10,-16,-3,1,1,2,0,3,3,0,5,5,-1,3,2,-3,5,2,0,-3,-104,-6,0,6,1,0,0,0,-1,-1,-1,0,-1
KR_6759691983,420,1,14,-32,-2,-1,2,1,-5,5,0,2,1,3,2,1,3,0,1,1,0,-6,-8,-3,-2,5,-1,0,1,0,1,1,-1,0,-1
KR_6258749019,420,-1,0,-20,-2,-4,4,0,-2,5,3,5,2,7,-1,3,2,0,0,0,0,-2,7,6,-9,3,-1,0,-2,0,0,-1,-1,0,-1
KR_6710598333,420,-2,-50,4,-6,-7,8,1,-3,4,1,4,1,5,2,2,4,-2,2,0,0,-4,2,4,-6,2,-1,0,-1,-1,-1,-1,-1,3,-1
KR_6625308139,420,-4,-66,-14,-6,-1,2,1,-1,3,2,-2,4,2,0,5,5,-2,2,0,0,-6,-37,0,-4,4,0,0,-1,0,0,-1,-1,0,-1
KR_6617513998,420,0,-45,-9,0,1,3,4,-3,6,3,1,2,3,3,1,4,-2,2,0,0,1,215,-3,-3,6,-2,0,0,-1,-1,-1,-1,3,-1
KR_6762169011,420,-3,-31,-46,-2,-1,1,0,-1,3,2,1,2,3,-1,1,0,0,1,1,0,0,7,5,-6,1,0,0,-1,-1,-1,-1,-1,4,-1
KR_6692640110,440,1,-32,-21,0,-1,3,2,1,2,3,-1,3,2,2,1,3,-1,2,1,0,4,-22,1,-4,3,-3,0,0,-1,1,0,-1,4,-1
KR_6558891686,420,-5,-59,-1,-5,-1,1,0,-6,7,1,-3,4,1,1,1,2,4,0,4,0,-10,259,-4,-5,9,1,0,-1,1,-1,-1,1,2,-1
KR_6578419044,420,-3,56,-12,-14,2,3,5,-2,4,2,-2,2,0,-14,15,1,2,2,4,0,-27,39,-1,-2,3,-23,0,-1,-1,1,1,-1,1,-1
KR_6621190707,440,-3,-94,16,-8,0,0,0,0,0,0,-5,5,0,-3,3,0,0,0,0,0,-7,-33,-3,0,3,35,0,-1,1,0,-1,-1,3,-1
KR_6638691998,420,-1,3,-25,-11,-3,3,0,-5,6,1,0,1,1,-2,3,1,-1,2,1,0,-10,6,0,-2,2,1,0,1,-1,0,1,-1,3,-1
KR_6576823569,440,1,16,12,0,-2,6,4,-4,6,2,2,2,4,2,0,2,2,1,3,0,-2,-1,-1,-5,6,-5,0,-1,-1,-1,-1,1,3,-1
KR_6424418017,420,-2,-14,-2,-12,-1,1,0,-5,6,1,3,1,4,-9,9,0,0,1,1,0,-14,-4,-1,-2,3,-1,0,-2,-1,-1,-1,1,1,-1
KR_6740921604,420,-4,-146,-10,-9,-3,3,0,-1,2,1,-2,4,2,-2,2,0,-1,1,0,-3,-12,-5,-4,-2,6,-5,0,0,-1,-1,0,-1,1,-1
KR_6751907501,420,-1,-13,16,2,0,2,2,5,1,6,-4,5,1,1,1,2,0,0,0,0,4,330,3,-4,1,-2,0,0,1,-1,0,1,4,-1
KR_6611416167,420,-5,-80,-28,-9,0,0,0,-5,5,0,0,0,0,-4,5,1,0,1,1,0,-8,-181,-4,0,4,-18,0,-1,-1,-1,-1,-1,4,-1
KR_6603554341,420,0,14,0,-6,0,0,0,0,2,2,-2,4,2,-4,6,2,0,0,0,0,-9,-212,2,-4,2,-3,0,-2,-1,0,-1,-1,2,-1
KR_6745793480,420,0,-34,-3,0,3,1,4,4,2,6,-9,14,5,-1,1,0,3,0,3,0,8,1,2,-5,3,3,0,-1,1,-1,-1,-1,5,-1
KR_6711734975,440,-4,5,-26,-9,-4,5,1,-2,2,0,-2,4,2,-1,3,2,0,1,1,-2,-11,-11,-3,-3,6,3,0,0,-1,-1,-1,-1,1,-1
KR_6744301227,420,-5,-37,-16,-7,-3,3,0,2,1,3,-6,6,0,0,3,3,0,1,1,-1,-2,-6,2,-5,3,-4,0,-2,-1,-1,-1,-1,3,-1
KR_6711963448,420,-4,-84,-8,-16,-3,3,0,-4,4,0,-4,5,1,-4,5,1,-1,2,1,0,-16,303,-4,-1,5,-16,0,-2,-1,-1,-1,-1,2,-1
KR_6763260039,420,6,13,27,7,0,1,1,5,0,5,-2,5,3,2,1,3,2,0,2,1,6,-7,-1,-1,2,0,0,0,1,-1,0,1,1,-1
KR_6748189421,420,-4,-11,-4,-7,2,0,2,-5,5,0,0,1,1,-3,4,1,-1,1,0,0,-5,-51,3,-5,2,4,0,1,-1,1,1,1,1,-1
KR_6734106882,420,-3,-47,6,-3,3,0,3,0,0,0,1,0,1,-5,5,0,-2,3,1,1,-8,-13,-2,-2,4,1,0,-1,0,-1,-1,1,0,-1
KR_6756210478,420,-5,-39,-9,-10,-2,2,0,0,3,3,-5,7,2,-4,5,1,1,1,2,0,-8,-3,-2,-2,4,0,0,-2,-1,-1,-1,-1,5,-1
KR_6401364553,440,1,49,0,-1,2,0,2,-8,8,0,2,2,4,2,2,4,1,1,2,0,3,1,-2,0,2,1,0,0,0,-1,0,-1,0,-1
KR_6614094959,420,-1,-23,7,-2,4,1,5,-3,7,4,-3,4,1,0,3,3,0,1,1,1,-10,8,7,-8,1,0,0,0,1,1,-1,1,6,-1
KR_6760620477,420,-1,-6,-11,-1,-3,5,2,-2,2,0,1,2,3,5,4,9,-2,3,1,0,-2,-5,0,-2,2,-2,0,1,-1,1,1,-1,3,-1
KR_6696528276,420,-4,-34,-24,-7,-1,1,0,-3,5,2,-5,6,1,2,3,5,0,2,2,0,-10,146,-2,-1,3,1,0,0,-1,0,1,1,1,-1
KR_6741964377,440,-3,-8,-28,-11,2,3,5,-7,7,0,-5,6,1,1,3,4,-2,4,2,0,-8,3,-4,-3,7,0,0,0,-1,-1,0,-1,5,-1
KR_6713285308,420,-6,-31,8,-14,-3,3,0,-2,6,4,-5,5,0,-2,4,2,-2,2,0,-1,-18,-10,0,-4,4,-3,0,-3,1,-1,-1,-1,4,-1
KR_6632141563,420,-4,-10,-24,-4,-2,2,0,-6,8,2,-4,6,2,8,0,8,0,0,0,0,-4,-19,3,-5,2,-3,0,-1,1,-1,-1,-1,4,-1
KR_6673610590,420,1,-30,-9,-2,4,0,4,-2,5,3,-4,9,5,1,0,1,-1,2,1,0,-3,-128,-2,-3,5,-1,0,-2,-1,-1,-1,1,2,-1
KR_6252358129,420,-10,-91,-52,-24,-2,5,3,-3,6,3,-4,5,1,-14,14,0,-1,1,0,0,-21,-4,-5,-1,6,-1,0,-3,-1,-1,-1,-1,1,-1
KR_6711079693,420,-5,2,-21,-9,-6,6,0,1,2,3,-4,5,1,-1,5,4,1,0,1,0,-1,107,4,-6,2,-1,0,0,1,-1,-1,-1,3,-1
KR_6496846326,420,1,6,-3,7,3,0,3,0,6,6,4,0,4,0,2,2,0,1,1,1,15,19,0,-4,4,1,0,-1,1,1,-1,1,6,-1
KR_6725961091,420,0,1,-29,2,1,0,1,0,6,6,-1,5,4,1,0,1,1,0,1,1,10,-191,1,-5,4,-2,0,-1,-1,0,-1,1,5,-1
KR_6650957561,420,-4,-95,-12,-8,2,1,3,-6,6,0,0,1,1,-4,9,5,0,1,1,1,-10,-12,-2,-1,3,1,0,0,0,-1,-1,1,0,-1
KR_6715219196,420,-3,-31,-7,-3,-3,3,0,-1,2,1,-4,5,1,2,1,3,3,0,3,0,4,6,0,-1,1,-1,0,-2,0,-1,-1,-1,0,-1
KR_6567340057,420,-1,-63,4,-10,-6,8,2,1,2,3,-2,2,0,-2,3,1,-1,4,3,0,-4,8,1,-2,1,-3,0,-1,1,-1,-1,-1,4,-1
KR_6733833827,420,-3,37,-32,-6,2,1,3,-1,4,3,-4,5,1,-3,3,0,0,0,0,0,-4,-12,-4,-1,5,1,0,-1,-1,-1,-1,1,5,-1
KR_6726942509,420,-2,1,1,-4,-1,4,3,0,3,3,-3,4,1,0,2,2,0,1,1,0,-1,-243,0,-3,3,-2,0,0,0,-1,1,-1,0,-1
KR_6680986650,420,-4,-81,-20,-7,-2,3,1,-3,5,2,-1,2,1,1,1,2,-2,2,0,0,-5,-1,-3,-1,4,-6,0,-1,-1,-1,-1,1,4,-1
KR_6681176997,440,-4,-111,17,-13,-1,1,0,-5,5,0,-4,6,2,-1,2,1,-2,4,2,0,-12,11,-9,-1,10,-1,0,0,-1,1,0,-1,3,-1
KR_6757302641,440,-2,-21,8,-5,-1,1,0,0,2,2,-3,3,0,-2,2,0,1,0,1,0,-5,-7,-1,-3,4,0,0,-3,1,-1,-1,-1,4,-1
KR_6764546111,440,-3,50,-29,-7,1,2,3,-5,6,1,-2,3,1,-1,3,2,0,1,1,1,1,-70,5,-9,4,17,0,0,0,0,0,1,0,-1
KR_6729171187,420,4,38,-16,9,0,3,3,4,3,7,0,1,1,3,4,7,2,0,2,-1,7,12,-2,-2,4,-3,0,0,1,-1,1,-1,2,-1
KR_6322084241,420,-6,-108,8,-13,-4,5,1,3,1,4,-3,3,0,-7,8,1,-2,3,1,0,-9,12,0,-3,3,1,0,-2,-1,-1,-1,-1,1,-1
KR_6759169387,420,-4,-22,-32,-11,-5,6,1,-4,4,0,0,3,3,-1,3,2,-1,1,0,0,-7,-8,4,-6,2,-3,0,1,-1,-1,1,-1,1,-1
KR_6584462572,440,-10,-107,-50,-36,0,2,2,-5,6,1,-1,2,1,-26,28,2,-4,4,0,-2,-30,-9,-1,-1,2,-1,0,-5,-1,-1,-1,-1,4,-1
KR_6676758623,420,-6,-63,-36,-13,-3,4,1,-5,6,1,-4,5,1,-1,1,0,0,0,0,0,-3,4,-1,-2,3,1,0,0,-1,1,-1,-1,4,-1
KR_6665753117,420,2,22,6,0,1,0,1,0,2,2,-2,5,3,1,0,1,0,0,0,0,-4,317,8,-11,3,-2,0,1,1,0,1,-1,4,-1
KR_6715695083,420,-1,-97,-12,-9,-6,6,0,1,1,2,-1,3,2,-2,3,1,-1,1,0,-3,-10,-5,1,-4,3,-2,0,-1,-1,0,-1,-1,5,-1
KR_6508988806,420,-3,5,-41,-6,2,0,2,1,3,4,-6,6,0,-1,2,1,-2,2,0,0,-1,11,-1,-3,4,0,0,-1,-1,-1,-1,-1,4,-1
KR_6718399298,420,-1,-58,-3,2,-1,1,0,2,0,2,6,0,6,-5,6,1,0,2,2,0,0,-10,0,-3,3,0,0,-1,0,0,-1,1,0,-1
KR_6761192479,440,-1,-7,6,-5,-1,3,2,-2,3,1,-3,4,1,1,1,2,0,0,0,0,-2,5,8,-10,2,0,0,-1,1,-1,-1,1,2,-1
KR_6718355460,420,0,-33,13,-1,2,0,2,1,1,2,1,1,2,-5,7,2,0,0,0,-2,-4,-7,-4,-3,7,0,0,1,-1,1,-1,-1,1,-1
KR_6658794044,420,-3,22,10,-4,-3,3,0,-4,4,0,3,1,4,0,3,3,0,1,1,2,-7,109,4,-5,1,-3,0,-1,1,1,-1,1,4,-1
KR_6764569757,420,-3,-37,-36,-2,0,2,2,-4,5,1,2,0,2,2,2,4,-2,4,2,0,6,-4,2,-3,1,0,0,-1,1,-1,-1,-1,2,-1
KR_6618197701,420,0,-23,20,-2,2,1,3,-3,6,3,-2,2,0,-1,1,0,2,4,6,0,1,-12,-2,-2,4,-1,0,-2,-1,1,-1,1,3,-1
KR_6621093410,440,-2,25,36,-4,-4,4,0,0,2,2,1,1,2,0,4,4,-1,2,1,0,-4,-6,-1,-2,3,1,0,1,1,1,1,-1,6,-1
KR_6553014442,420,-4,-57,-27,-10,-2,3,1,-5,7,2,-1,6,5,2,3,5,-4,4,0,0,-7,-2,3,-4,1,-1,0,-2,-1,-1,-1,-1,3,-1
KR_6740250335,420,1,31,22,1,-2,2,0,3,0,3,-7,7,0,6,0,6,1,1,2,0,5,-7,-4,0,4,-2,0,1,-1,1,1,-1,3,-1
KR_6762286921,420,4,13,47,11,3,2,5,4,3,7,-1,5,4,4,1,5,1,0,1,3,9,-6,4,-7,3,-3,0,2,1,-1,1,1,4,-1
KR_6755163218,420,-3,-141,-16,-1,2,1,3,1,2,3,-1,4,3,-3,5,2,0,0,0,0,3,-41,1,-3,2,29,0,-3,1,0,-1,-1,4,-1
KR_6444311138,420,-1,-57,24,-3,-1,1,0,2,2,4,-4,5,1,-1,2,1,1,1,2,0,-1,-13,-1,-2,3,2,0,0,1,1,0,-1,4,-1
KR_6737124767,420,-5,-110,4,-14,-3,4,1,0,0,0,-7,8,1,-3,4,1,-1,2,1,0,-14,-236,-1,-4,5,-1,0,0,-1,0,-1,-1,3,-1
KR_6747327436,440,-3,-52,-15,-7,1,2,3,-2,3,1,-1,1,0,-5,8,3,0,0,0,0,-4,7,1,-1,0,0,0,0,0,0,-1,1,0,-1
KR_6752177169,420,-10,-124,-35,-10,-1,3,2,-3,4,1,-2,2,0,-1,1,0,-3,4,1,0,-6,-9,0,0,0,0,0,-2,0,0,-1,-1,0,-1
KR_6660832793,420,-1,-16,-28,-6,1,0,1,-2,3,1,-1,3,2,-3,5,2,-1,1,0,0,-9,15,2,-3,1,1,0,0,-1,1,1,1,1,-1
KR_6718736273,420,-7,-161,-65,-7,2,1,3,-7,7,0,-1,2,1,-2,2,0,1,0,1,0,-8,-12,-3,-4,7,-3,0,-4,0,-1,-1,-1,0,-1
KR_6096772055,420,-2,-17,-36,-1,-2,4,2,1,0,1,3,1,4,-2,5,3,-1,2,1,0,6,1,2,-4,2,-1,0,-1,-1,-1,-1,1,3,-1
KR_6749016312,440,1,6,-1,-3,1,0,1,1,0,1,-4,5,1,0,1,1,-1,1,0,0,-4,1,0,-3,3,2,0,0,0,0,0,-1,0,-1
KR_6586151383,420,-1,-82,5,-2,-2,3,1,8,1,9,-8,9,1,-1,2,1,1,1,2,0,5,-42,-6,0,6,25,0,-2,1,-1,-1,-1,1,-1
KR_6689849117,440,-3,-18,4,-9,0,2,2,-7,7,0,-2,3,1,2,4,6,-2,2,0,0,-2,2,2,-6,4,-3,0,0,-1,-1,0,1,2,-1
KR_5820379169,420,1,22,-4,-3,2,1,3,1,2,3,-5,6,1,-1,2,1,0,0,0,0,7,-4,1,-6,5,0,0,-1,-1,0,-1,-1,1,-1
KR_6752212102,420,-2,82,-8,2,-4,4,0,-1,4,3,8,3,11,2,2,4,-3,3,0,-1,0,-6,-1,-3,4,0,0,-2,1,-1,-1,-1,1,-1
KR_6762343459,420,-2,8,0,-5,-3,5,2,-2,3,1,-1,3,2,0,3,3,1,2,3,0,-7,-1,-2,-3,5,0,0,-1,1,-1,-1,1,3,-1
KR_6618932324,420,-1,92,-24,-2,4,1,5,-5,5,0,0,3,3,0,0,0,-1,1,0,0,-5,-3,-1,-1,2,0,0,-1,-1,-1,-1,-1,3,-1
KR_6683428899,440,-3,-71,-4,-8,0,2,2,0,1,1,-5,7,2,-3,3,0,0,0,0,0,-10,-3,1,-3,2,-2,0,-1,-1,1,-1,-1,5,-1
KR_6602393585,420,-4,-79,-13,-10,0,2,2,-2,4,2,-8,9,1,-1,4,3,1,3,4,0,-4,-105,0,-4,4,-4,0,-1,-1,1,-1,-1,6,-1
KR_6748766654,420,-1,-85,7,-2,-6,6,0,0,4,4,1,2,3,3,3,6,0,0,0,0,2,1,-1,0,1,0,0,0,1,1,-1,-1,5,-1
KR_6709233034,420,-3,58,30,-5,1,1,2,0,2,2,-2,2,0,-2,3,1,-2,2,0,0,-7,31,4,-6,2,-24,0,-1,-1,1,1,-1,4,-1
KR_6756693120,420,3,8,0,5,0,3,3,1,3,4,-1,4,3,2,3,5,3,1,4,-1,3,-134,0,-4,4,3,0,1,1,-1,1,-1,6,-1
KR_6729698759,440,-3,-69,-25,-7,-1,8,7,0,4,4,-3,6,3,4,0,4,-7,9,2,-1,0,-4,-7,0,7,3,0,-3,-1,-1,-1,1,3,-1
KR_6730936192,420,-4,-22,-40,-2,1,0,1,3,1,4,-2,4,2,-4,6,2,0,2,2,1,0,-17,1,-6,5,2,0,-1,1,-1,-1,1,3,-1
KR_6623824178,420,-3,-34,28,-12,-3,3,0,-1,3,2,-1,2,1,-7,10,3,0,1,1,-1,-9,-8,-1,-6,7,-1,0,-1,1,1,-1,-1,4,-1
KR_6741838254,420,-1,-5,14,-9,-2,3,1,-5,7,2,-3,4,1,1,2,3,0,1,1,0,-3,-17,-1,-6,7,2,0,0,-1,0,0,-1,3,-1
KR_6617673775,420,-3,-42,-8,-6,-1,3,2,2,1,3,-1,1,0,-5,6,1,-1,1,0,-1,-2,1,1,-4,3,-2,0,-1,1,0,-1,-1,3,-1
KR_6641372151,420,-2,-63,1,-9,-1,3,2,1,1,2,-5,5,0,-1,4,3,-3,4,1,0,-2,15,3,-6,3,-2,0,0,-1,0,0,-1,2,-1
KR_6712347981,420,1,13,4,0,1,3,4,-4,7,3,3,1,4,-2,2,0,2,0,2,0,-5,55,0,-3,3,-23,0,-1,1,1,-1,1,6,-1
KR_6740151294,420,-4,-5,-13,-9,-1,1,0,-3,5,2,3,0,3,-1,2,1,-7,8,1,0,-4,5,3,-4,1,-3,0,-3,1,-1,-1,-1,5,-1
KR_6757917466,420,0,44,-48,-6,0,2,2,-5,5,0,-2,3,1,1,1,2,0,0,0,0,-11,-1,-2,-3,5,1,0,0,-1,-1,0,-1,2,-1
KR_6512026913,420,-1,-15,28,-3,-5,8,3,-1,2,1,1,2,3,-3,3,0,5,0,5,0,-1,158,-4,-1,5,4,0,-2,1,-1,-1,-1,5,-1
KR_6617762384,420,-1,-55,-11,-7,-1,5,4,4,2,6,-6,6,0,-5,6,1,1,1,2,1,-4,-2,-1,-2,3,-4,0,-1,-1,-1,-1,1,2,-1
KR_6613657729,420,0,25,4,-5,0,1,1,-4,4,0,-1,2,1,0,2,2,0,1,1,-1,-7,-3,-1,-4,5,-2,0,0,-1,0,0,-1,5,-1
KR_6639659206,420,0,2,14,-1,-2,2,0,1,2,3,-3,4,1,3,1,4,0,0,0,0,-3,7,4,-5,1,3,0,-1,-1,1,-1,1,1,-1
KR_6762170547,420,1,-37,32,7,9,0,9,3,1,4,-2,4,2,-3,3,0,0,2,2,0,0,7,0,-2,2,1,0,1,-1,1,1,1,4,-1
KR_6668534425,420,-4,-121,-4,-6,-3,5,2,5,1,6,-3,5,2,-6,7,1,1,1,2,0,-1,97,0,-3,3,-2,0,-2,1,-1,-1,-1,1,-1
KR_6612158565,420,-2,5,-14,-10,0,1,1,1,3,4,-3,3,0,-6,7,1,-2,4,2,0,-13,-1,-3,0,3,2,0,0,-1,-1,0,-1,4,-1
KR_6756323221,420,1,56,0,1,-3,3,0,-3,4,1,3,0,3,3,3,6,1,1,2,-1,5,-5,-2,0,2,2,0,0,0,1,0,-1,0,-1
KR_6756946856,420,1,-92,11,7,0,3,3,4,0,4,2,2,4,0,5,5,1,1,2,1,9,-51,3,-5,2,22,0,-1,1,-1,-1,-1,1,-1
KR_6755861437,440,-4,-76,1,-12,-6,7,1,4,1,5,-6,6,0,-4,4,0,0,1,1,0,-4,1,-2,-2,4,0,0,-1,-1,-1,-1,-1,1,-1
KR_6160214078,420,-5,-114,-15,-12,-9,9,0,4,3,7,-3,3,0,-3,6,3,-1,1,0,-1,-10,2,3,-5,2,-4,0,-3,-1,-1,-1,-1,3,-1
KR_5938002643,420,-3,-30,-14,-7,2,0,2,0,4,4,-5,6,1,-2,2,0,-2,3,1,0,-15,-32,-3,-2,5,-2,0,-1,-1,1,-1,1,5,-1
KR_6720405866,420,-1,2,4,-2,0,2,2,-1,4,3,3,1,4,1,4,5,-5,5,0,-1,-6,50,0,-5,5,-14,0,0,-1,1,0,-1,5,-1
KR_6401275904,440,-8,-122,-6,-21,-3,5,2,-6,7,1,-6,7,1,-4,6,2,-2,2,0,0,-15,-222,-1,0,1,0,0,-2,-1,1,-1,1,1,-1
KR_6713600684,420,-1,9,-1,-5,-4,5,1,-1,2,1,-5,5,0,7,1,8,-2,2,0,0,-3,-17,-3,-2,5,0,0,-1,-1,-1,-1,1,5,-1
KR_6584536646,440,-7,-84,-44,-9,-4,6,2,-1,2,1,-3,4,1,-1,4,3,0,0,0,0,2,-39,-1,-3,4,3,0,-1,-1,-1,-1,-1,5,-1
KR_6677370619,420,1,-2,-3,-2,5,2,7,-5,10,5,-2,3,1,0,2,2,0,0,0,0,-4,-15,-2,-2,4,2,0,0,-1,-1,-1,-1,1,-1
KR_6764419630,420,-3,26,-40,-11,0,0,0,0,2,2,-1,3,2,-6,6,0,-4,5,1,-1,-16,-3,-1,0,1,-2,0,0,-1,-1,-1,-1,3,-1
KR_6670543374,420,-2,-70,-35,-6,-5,6,1,-1,2,1,0,2,2,2,2,4,-2,2,0,1,1,1,4,-8,4,-1,0,-1,-1,1,-1,1,4,-1
KR_6750918187,420,-3,-26,-5,-6,-4,5,1,-4,4,0,1,0,1,1,0,1,0,0,0,0,-4,-8,-5,0,5,3,0,-1,-1,1,-1,-1,2,-1
KR_6679856211,420,-4,6,8,-12,-3,3,0,-2,4,2,-5,5,0,0,2,2,-2,3,1,-1,-9,4,-2,-4,6,0,0,-2,-1,-1,-1,-1,4,-1
KR_6625380342,440,1,12,26,2,2,1,3,1,2,3,-5,6,1,5,1,6,-1,1,0,0,7,4,0,-3,3,-1,0,1,-1,1,1,-1,6,-1
KR_6386215035,420,-2,18,-3,-8,-2,4,2,-2,3,1,-5,6,1,3,2,5,-2,4,2,0,-3,48,-1,-4,5,-11,0,-1,1,-1,-1,-1,6,-1
KR_6415958707,420,-3,-33,-14,-9,0,2,2,-2,6,4,-2,7,5,-4,8,4,-1,2,1,-2,-6,-3,-2,-1,3,-3,0,-1,-1,-1,-1,-1,5,-1
KR_6729137822,440,-1,-68,0,-4,3,1,4,-4,4,0,0,3,3,-3,3,0,0,1,1,-2,-8,5,-2,-2,4,-2,0,0,-1,0,0,-1,3,-1
KR_6724593514,420,2,5,12,3,-2,5,3,0,2,2,3,2,5,-1,3,2,3,0,3,0,11,-7,0,-7,7,2,0,-2,1,-1,-1,-1,3,-1
KR_6726363440,420,1,30,-3,0,0,3,3,3,1,4,-8,8,0,3,2,5,2,2,4,1,0,-352,3,-4,1,-3,0,-1,-1,-1,-1,1,2,-1
KR_6672684695,440,-2,-39,9,-5,6,0,6,-3,4,1,-2,6,4,-5,5,0,-1,2,1,1,-4,-13,-5,-1,6,4,0,-1,-1,0,-1,1,3,-1
KR_6715302508,440,-1,1,-8,-13,-1,3,2,-9,12,3,-1,3,2,-3,4,1,1,1,2,1,-15,12,-5,-1,6,-2,0,-1,-1,0,1,1,1,-1
KR_5540542370,440,0,-19,-28,5,3,0,3,-2,4,2,4,1,5,0,3,3,0,1,1,-1,3,-1,3,-4,1,2,0,0,-1,1,1,-1,4,-1
KR_6664988842,420,-8,-104,-29,-20,-8,8,0,-5,7,2,-6,7,1,0,2,2,-1,1,0,-1,-11,-89,-3,-1,4,2,0,-3,-1,-1,-1,1,5,-1
KR_6701373893,420,-4,-77,3,-8,-1,5,4,-2,3,1,-3,3,0,-1,2,1,-1,1,0,0,-8,0,2,-8,6,-8,0,-1,0,0,-1,1,0,-1
KR_6703697227,420,-4,1,-16,-12,-1,2,1,-12,14,2,-3,3,0,2,2,4,2,1,3,0,-13,13,-4,-3,7,-17,0,0,-1,-1,1,-1,6,-1
KR_6764363193,420,1,34,-33,8,1,1,2,9,1,10,-2,4,2,0,2,2,0,1,1,1,4,12,2,-4,2,0,0,-1,0,-1,-1,1,0,-1
KR_6637375674,420,-1,34,19,-4,4,2,6,-4,4,0,1,2,3,-4,5,1,-1,2,1,0,-7,34,0,-3,3,-20,0,3,-1,1,1,1,3,-1
KR_6733875701,420,2,1,8,1,1,0,1,-3,3,0,3,3,6,1,1,2,-1,2,1,0,4,-184,3,-6,3,-1,0,1,1,0,1,1,6,-1
KR_6764124867,420,-1,47,-24,-6,3,0,3,-1,3,2,-3,4,1,-4,6,2,-1,3,2,0,-6,-20,-3,-1,4,0,0,1,1,1,1,-1,3,-1
KR_6591130036,420,-3,16,28,-7,1,2,3,-2,3,1,-2,2,0,-4,5,1,0,0,0,-1,-14,7,2,-4,2,-3,0,1,1,-1,1,-1,5,-1
KR_6595936225,420,-6,-150,-11,-9,-5,6,1,-2,3,1,4,2,6,-2,6,4,-4,5,1,-2,-6,-3,3,-10,7,-4,0,-1,0,-1,-1,-1,0,-1
KR_6734713026,420,-4,-66,-72,-14,2,1,3,-5,6,1,0,2,2,-9,10,1,-2,2,0,0,-11,-44,-4,-1,5,20,0,0,-1,-1,0,-1,1,-1
KR_6708253264,420,-3,-54,-28,-2,-1,1,0,0,2,2,-1,3,2,0,4,4,0,2,2,0,-6,-23,3,-4,1,4,0,1,1,1,1,1,6,-1
KR_6696933451,420,-1,-22,-12,-4,5,0,5,-3,4,1,-3,5,2,1,2,3,-4,7,3,-1,-6,28,5,-5,0,-2,0,-1,-1,-1,-1,-1,5,-1
KR_6636157518,420,-3,-70,-4,-6,-4,5,1,-2,2,0,0,1,1,0,0,0,0,0,0,0,-4,167,-1,-2,3,-1,0,0,1,-1,0,-1,6,-1
KR_6112271965,420,-2,-9,3,-5,1,2,3,-4,6,2,-2,3,1,1,3,4,-1,5,4,0,-2,4,1,-5,4,-6,0,0,1,0,1,1,4,-1
KR_6751214384,420,3,-6,-2,9,3,0,3,2,2,4,0,2,2,2,3,5,2,0,2,0,3,-275,-2,-2,4,4,0,-1,1,1,1,-1,6,-1
KR_6728458900,420,-6,-72,-8,-11,-9,10,1,3,1,4,-6,9,3,-1,5,4,2,0,2,4,8,-2,-3,-3,6,-2,0,-1,1,-1,-1,1,2,-1
KR_6639793796,420,-2,-49,2,1,-2,4,2,4,1,5,-3,3,0,2,3,5,0,2,2,1,7,-11,6,-8,2,-3,0,-1,1,-1,-1,1,3,-1
KR_6757885009,420,-4,45,16,-14,-5,5,0,0,4,4,-4,4,0,-3,4,1,-2,4,2,0,-13,13,6,-8,2,2,0,0,-1,-1,0,-1,5,-1
KR_6640000107,420,-3,-40,-12,-8,0,1,1,0,3,3,-1,3,2,-5,7,2,-2,2,0,-1,-5,1,0,-6,6,-3,0,0,-1,1,0,-1,4,-1
KR_6590452318,420,2,-26,40,7,-2,2,0,5,1,6,2,0,2,2,2,4,0,0,0,0,8,3,2,-4,2,-1,0,0,-1,1,0,1,4,-1
KR_6760992815,420,2,3,-27,7,4,1,5,2,1,3,0,0,0,0,2,2,1,0,1,0,6,-1,5,-5,0,6,0,1,1,0,1,1,5,-1
KR_6476480443,420,-1,-39,7,-3,-2,3,1,-4,4,0,1,2,3,-3,6,3,5,0,5,0,4,-2,-3,-3,6,-2,0,0,1,-1,0,-1,1,-1
KR_6687911979,420,-7,-105,-11,-19,-11,11,0,-3,4,1,-1,3,2,-5,6,1,1,1,2,-1,-10,-2,0,-3,3,-2,0,-4,1,-1,-1,-1,3,-1
KR_6617473490,420,-2,54,-28,-7,0,0,0,-1,1,0,-4,6,2,1,5,6,-3,4,1,1,-7,282,-1,-2,3,-30,0,-1,0,-1,-1,1,0,-1
KR_6748414082,420,1,39,29,-3,-5,5,0,3,0,3,1,2,3,0,6,6,-2,3,1,1,2,-5,0,-1,1,3,0,0,0,0,1,1,0,-1
KR_6757781082,420,-2,-45,-6,-5,2,0,2,-4,4,0,-3,5,2,1,1,2,-1,2,1,0,-4,2,1,-4,3,-4,0,-1,-1,-1,-1,-1,2,-1
KR_6746557833,440,-4,-101,-12,-4,-1,3,2,-1,5,4,2,3,5,-5,9,4,1,0,1,0,2,-3,-1,-2,3,-1,0,-1,-1,0,-1,-1,6,-1
KR_6616128053,420,-2,-34,7,-7,-1,1,0,-3,4,1,0,4,4,0,1,1,-3,3,0,0,-8,7,0,-2,2,-3,0,-1,-1,-1,-1,-1,3,-1
KR_6758222136,420,0,-119,4,-4,-2,3,1,2,0,2,2,4,6,-5,6,1,-1,1,0,0,5,-40,-4,0,4,1,0,-2,-1,-1,-1,-1,2,-1
KR_6754446965,420,-2,-55,-4,-2,-1,1,0,1,0,1,-1,1,0,-1,3,2,0,1,1,0,-4,6,0,-2,2,-4,0,0,-1,0,0,-1,6,-1
KR_6604447495,420,0,-45,0,-7,0,2,2,-4,4,0,0,2,2,-6,7,1,3,0,3,0,-9,19,4,-8,4,-4,0,0,0,-1,0,-1,0,-1
KR_6729316135,420,-1,-36,5,-4,1,0,1,-5,6,1,-3,4,1,4,1,5,-1,1,0,1,-1,-256,1,-3,2,1,0,0,0,-1,1,1,0,-1
KR_6690837785,440,1,32,16,-1,-3,3,0,0,2,2,-3,7,4,3,1,4,2,1,3,0,-8,3,-1,-2,3,3,0,1,1,1,1,1,2,-1
KR_6633495606,420,-3,-4,16,-11,-1,4,3,-1,3,2,1,4,5,0,2,2,-10,10,0,0,-8,-77,-2,-2,4,-2,0,-4,1,-1,-1,1,6,-1
KR_6742840772,420,-7,-119,-14,-12,-6,6,0,-1,2,1,-2,5,3,-4,4,0,1,1,2,0,-9,-2,-1,-2,3,-3,0,-3,0,1,-1,1,0,-1
KR_6659889045,420,-1,-52,24,-2,1,2,3,2,1,3,2,0,2,-4,5,1,-3,5,2,0,2,13,5,-8,3,-4,0,-1,1,-1,-1,-1,3,-1
KR_6735669385,420,-1,-47,-16,-5,-2,3,1,0,2,2,-5,7,2,0,3,3,2,2,4,0,1,-1,-1,-1,2,2,0,-1,0,-1,-1,-1,0,-1
KR_6615270538,420,-2,3,-28,-8,-1,1,0,-5,8,3,-4,6,2,-1,3,2,3,0,3,0,-1,-2,-1,-2,3,-1,0,0,0,0,-1,1,0,-1
KR_6643092117,420,1,-7,23,1,-2,2,0,1,4,5,-3,3,0,3,2,5,2,2,4,0,8,360,2,-3,1,4,0,1,1,0,1,1,1,-1
KR_6758276175,420,-1,-50,8,-3,-3,3,0,1,3,4,0,1,1,0,1,1,-1,2,1,0,-5,7,-2,0,2,2,0,-1,-1,-1,1,-1,3,-1
KR_6629506079,420,-3,-14,-12,-3,-1,3,2,0,3,3,-6,8,2,2,5,7,2,2,4,1,6,1,-3,-2,5,0,0,-1,-1,-1,-1,1,5,-1
KR_6694827482,440,-9,-152,-52,-24,-1,1,0,-9,9,0,-1,4,3,-6,10,4,-7,7,0,0,-26,-247,-3,0,3,1,0,-2,-1,-1,-1,-1,2,-1
KR_6764100930,420,-1,-62,44,8,-4,5,1,6,1,7,-2,2,0,1,1,2,7,1,8,0,9,-51,4,-6,2,11,0,0,1,-1,-1,1,1,-1
KR_6739111500,420,-1,-76,-15,-3,-1,4,3,-1,2,1,0,1,1,-1,3,2,0,0,0,-1,5,7,0,-4,4,-3,0,0,-1,1,0,-1,1,-1
KR_6609236724,420,-2,-10,8,1,0,1,1,0,3,3,-2,4,2,1,2,3,2,1,3,1,7,187,-2,-3,5,1,0,0,-1,1,0,1,2,-1
KR_6113295076,420,3,-3,58,13,3,1,4,2,4,6,1,2,3,1,4,5,6,0,6,0,10,-2,6,-8,2,-4,0,2,1,1,1,1,5,-1
KR_6741139971,420,-3,-42,0,-8,-4,4,0,-2,5,3,0,0,0,-2,4,2,0,0,0,-1,-5,-41,-4,-1,5,0,0,-1,1,-1,-1,-1,2,-1
KR_6629827691,420,-1,-68,-48,0,-3,3,0,2,1,3,-2,4,2,0,1,1,3,1,4,0,7,-2,-2,-2,4,-1,0,-1,-1,-1,-1,-1,3,-1
KR_6725905239,420,1,-32,5,2,-2,2,0,4,1,5,-1,4,3,0,4,4,1,2,3,1,2,-5,2,-3,1,-2,0,1,1,1,1,1,5,-1
KR_6747878655,440,-1,-6,-18,3,1,0,1,0,3,3,1,1,2,2,1,3,-1,4,3,0,3,0,1,-5,4,-1,0,0,1,-1,0,1,1,-1
KR_6738636008,420,-3,-100,29,-7,-12,14,2,2,4,6,2,1,3,0,3,3,1,1,2,-1,8,-3,-4,-2,6,-4,0,-3,-1,1,-1,-1,4,-1
KR_6762348865,420,1,-54,-28,1,6,0,6,2,0,2,-2,3,1,-3,3,0,-2,4,2,0,3,3,-4,0,4,0,0,-1,0,-1,-1,-1,0,-1
KR_6699462879,440,-2,27,-4,-7,-3,5,2,0,1,1,0,6,6,-3,3,0,-1,2,1,0,-3,-13,1,-3,2,-2,0,-1,0,-1,-1,1,0,-1
KR_6761638939,420,-1,-41,1,-9,3,1,4,0,2,2,-2,5,3,-8,9,1,-2,4,2,0,-18,-4,-3,-1,4,0,0,-1,1,-1,-1,-1,3,-1
KR_6612674215,420,0,9,12,2,2,2,4,-3,4,1,4,1,5,-1,1,0,0,0,0,0,0,-318,0,-2,2,0,0,-1,-1,-1,-1,1,5,-1
KR_6691057869,440,0,-77,9,3,-1,3,2,-1,5,4,1,0,1,3,1,4,1,0,1,0,5,10,6,-6,0,0,0,-1,-1,1,-1,-1,4,-1
KR_6757548183,420,-2,-36,4,-2,-1,1,0,1,2,3,1,6,7,0,6,6,-3,3,0,0,-3,-21,1,-7,6,5,0,-1,1,-1,-1,1,2,-1
KR_6620411758,420,-4,17,-36,-3,0,2,2,-2,4,2,4,1,5,-3,6,3,-2,3,1,0,4,-7,-5,-1,6,2,0,0,-1,-1,-1,-1,2,-1
KR_6704007998,440,-9,-66,-32,-11,-6,6,0,-4,7,3,0,2,2,-2,4,2,1,1,2,0,-4,-6,-2,0,2,1,0,-1,-1,-1,-1,1,4,-1
KR_6609628808,420,-3,-7,-11,-10,2,0,2,-5,7,2,0,2,2,-6,9,3,-1,1,0,0,-11,-10,-2,-3,5,0,0,-1,-1,1,-1,1,5,-1
KR_6760607561,420,-4,-49,-26,-18,-2,5,3,-9,9,0,-8,8,0,2,1,3,-1,1,0,0,-14,-269,0,-4,4,-3,0,-1,-1,-1,-1,1,1,-1
KR_6764112139,420,-4,-29,12,-14,0,2,2,-4,5,1,-1,3,2,-5,7,2,-4,4,0,0,-11,-12,-2,-1,3,-3,0,-1,-1,-1,-1,-1,3,-1
KR_6735717938,420,-3,-32,-21,-5,-2,2,0,1,0,1,0,1,1,0,4,4,-4,4,0,0,0,9,5,-6,1,-2,0,-1,-1,1,-1,-1,6,-1
KR_6761784455,420,0,0,7,-6,-2,3,1,-1,2,1,0,1,1,-3,6,3,0,1,1,0,-4,189,2,-5,3,-4,0,0,1,-1,-1,-1,5,-1
KR_6571297790,420,0,-21,16,-2,-1,1,0,0,1,1,-1,4,3,0,0,0,0,0,0,0,0,-11,-1,-5,6,2,0,1,1,0,1,-1,5,-1
KR_6744756177,440,1,63,3,1,2,1,3,0,2,2,0,2,2,-2,3,1,1,0,1,0,-2,-117,5,-5,0,1,0,1,-1,0,1,1,5,-1
KR_6729361898,420,-4,-127,34,-10,-1,3,2,-1,3,2,-4,7,3,-5,8,3,1,0,1,0,-8,-9,0,-4,4,-5,0,-1,-1,0,-1,-1,6,-1
KR_6739238378,420,-4,-97,-16,-9,-1,2,1,-1,3,2,-2,3,1,-1,4,3,-4,6,2,0,-7,11,1,-5,4,-1,0,-1,-1,0,-1,1,5,-1
KR_6547553917,440,-2,24,-12,-2,0,2,2,-2,4,2,0,0,0,-1,1,0,1,1,2,-1,-4,-21,-1,-7,8,3,0,0,-1,0,0,-1,5,-1
KR_6718674281,420,-3,-65,-32,-3,-3,3,0,1,0,1,8,0,8,-8,8,0,-1,1,0,1,-3,12,-6,-4,10,-1,0,0,-1,-1,-1,1,2,-1
KR_6764143836,420,-1,1,-40,-2,3,0,3,-1,2,1,-1,2,1,0,2,2,-3,3,0,-1,-5,-2,3,-4,1,-4,0,0,-1,0,0,-1,5,-1
KR_6723691496,420,1,-47,-11,0,4,1,5,-2,2,0,-1,4,3,-3,6,3,2,0,2,0,-4,131,3,-5,2,-4,0,-1,-1,-1,1,1,2,-1
KR_6758461972,420,-5,-38,-16,-6,0,1,1,1,1,2,0,4,4,-3,3,0,-4,4,0,0,-11,-3,-3,-1,4,0,0,-2,1,-1,-1,-1,5,-1
KR_6761109565,420,-2,-52,12,0,-4,4,0,0,1,1,5,0,5,0,1,1,-1,2,1,-1,3,6,-1,-1,2,-3,0,0,1,-1,1,-1,2,-1
KR_6750746801,440,-2,-39,-33,-10,1,1,2,-1,3,2,-3,3,0,-7,7,0,0,0,0,0,-10,-33,-6,-3,9,-1,0,-2,-1,-1,-1,-1,2,-1
KR_6732041302,420,-2,32,-12,-7,3,2,5,-1,6,5,-7,8,1,-1,4,3,-1,2,1,1,-8,-110,1,-6,5,-5,0,-1,-1,-1,-1,1,5,-1
KR_6757332946,420,-4,-52,2,-9,-4,4,0,-2,2,0,-1,2,1,-1,3,2,-1,1,0,0,-12,-21,-1,-3,4,2,0,-1,-1,-1,-1,-1,2,-1
KR_6756002682,420,0,-49,20,7,-2,2,0,1,1,2,1,3,4,1,2,3,6,5,11,2,8,-353,1,-1,0,7,0,-1,0,0,-1,1,0,-1
KR_6331481443,420,1,52,8,-2,-3,4,1,0,1,1,2,2,4,0,5,5,-1,1,0,0,5,49,0,-6,6,-29,0,1,-1,1,1,-1,4,-1
KR_6653260398,420,-3,-39,-33,-3,2,2,4,0,3,3,3,1,4,-1,1,0,-7,8,1,0,-5,-32,4,-6,2,28,0,-3,-1,1,-1,-1,1,-1
KR_6752758424,420,2,-68,0,-9,-6,7,1,-2,5,3,0,1,1,0,4,4,-1,3,2,-2,-1,1,3,-5,2,4,0,-2,-1,0,-1,-1,1,-1
KR_6097803316,420,0,-8,-4,-1,-2,3,1,3,2,5,-2,5,3,-1,1,0,1,0,1,0,1,-1,2,-3,1,-1,0,-1,1,-1,-1,-1,5,-1
KR_6726204938,420,1,49,12,-3,3,0,3,-1,2,1,-2,3,1,-3,7,4,0,1,1,0,-8,5,0,-2,2,0,0,0,-1,1,1,-1,4,-1
KR_6636671610,420,-5,-44,-9,-12,-5,6,1,-2,4,2,-1,2,1,-5,5,0,1,0,1,-1,-6,6,-2,-2,4,-3,0,0,-1,0,0,-1,2,-1
KR_6756232262,440,-4,-43,-9,-5,1,0,1,2,3,5,3,0,3,-6,7,1,-5,5,0,0,-6,5,5,-7,2,-8,0,0,0,-1,1,1,0,-1
KR_6749799055,440,-4,-124,-16,-9,-6,6,0,-2,3,1,3,1,4,-4,4,0,0,5,5,0,-6,-181,-3,0,3,-4,0,-2,-1,-1,-1,1,5,-1
KR_6740431334,440,-1,-21,-27,0,0,3,3,0,2,2,1,1,2,-2,2,0,1,0,1,0,0,3,3,-4,1,1,0,-1,1,-1,-1,-1,5,-1
KR_6622284394,420,-1,-35,-13,3,-2,3,1,0,2,2,2,0,2,1,2,3,2,2,4,-1,4,-8,-2,-1,3,-1,0,-1,0,1,-1,-1,0,-1
KR_6529332317,420,-8,-153,-16,-18,-7,7,0,-1,3,2,-2,3,1,-7,7,0,-1,1,0,0,-15,7,-1,-3,4,-2,0,-3,-1,0,-1,-1,4,-1
KR_6754850729,420,0,-16,-24,0,0,0,0,-1,2,1,-1,2,1,-1,1,0,3,0,3,-1,-3,2,-2,-3,5,1,0,-1,0,0,-1,-1,0,-1
KR_6621610364,420,-2,-43,2,-6,3,1,4,-2,4,2,-4,5,1,-3,6,3,0,1,1,1,4,0,2,-3,1,-5,0,1,1,-1,-1,1,2,-1
KR_6714210663,420,-3,-52,-44,-4,0,1,1,-1,2,1,-1,1,0,1,2,3,-3,3,0,1,-5,-295,0,-3,3,1,0,1,-1,-1,-1,1,4,-1
KR_6764107779,420,-4,-61,31,-12,-5,9,4,-3,3,0,-3,4,1,0,1,1,-1,1,0,0,-7,29,-1,-3,4,0,0,-1,-1,1,-1,1,2,-1
KR_6757782287,420,-3,-9,-57,-16,-1,3,2,-8,8,0,-5,5,0,-5,7,2,3,3,6,-1,-16,7,-1,-1,2,-2,0,-1,0,-1,-1,-1,0,-1
KR_6746990413,420,-7,26,-20,-5,1,0,1,-3,3,0,-1,1,0,1,3,4,-3,3,0,0,-15,-22,-5,0,5,2,0,-1,0,0,-1,1,0,-1
KR_6725514426,420,1,-13,4,-4,-1,5,4,3,0,3,-2,5,3,-1,1,0,-3,4,1,0,-1,-5,2,-3,1,0,0,0,-1,1,-1,-1,6,-1
KR_6693644036,440,-1,-62,-20,2,0,1,1,-3,7,4,-1,2,1,3,0,3,3,0,3,0,2,44,3,-5,2,-1,0,0,1,-1,-1,-1,6,-1
KR_6728082603,440,-5,-106,0,-2,-3,3,0,6,0,6,-2,4,2,-5,5,0,2,0,2,0,3,3,-3,0,3,0,0,-1,0,-1,-1,-1,0,-1
KR_6720345747,420,1,75,-19,5,2,0,2,-2,3,1,8,0,8,-4,5,1,1,0,1,0,0,131,-3,-1,4,4,0,1,-1,1,1,1,4,-1
KR_6709169842,420,-2,-33,-56,-1,-3,3,0,0,3,3,0,3,3,2,0,2,0,3,3,1,2,59,0,-4,4,-2,0,0,1,1,0,1,2,-1
KR_6753597928,440,2,-42,32,3,-2,2,0,-1,1,0,1,0,1,4,0,4,1,1,2,0,4,189,3,-6,3,-1,0,-1,1,1,-1,-1,3,-1
KR_6630362327,420,-1,-13,-4,-2,0,0,0,-2,6,4,0,3,3,2,2,4,-2,2,0,0,-11,-147,0,-3,3,0,0,0,-1,1,0,-1,2,-1
KR_6674732793,420,-3,-83,6,-4,0,0,0,-5,7,2,1,3,4,-1,3,2,1,0,1,0,-6,-11,0,-2,2,1,0,-2,0,0,-1,-1,0,-1
KR_6750185339,420,-4,-77,-20,-6,0,0,0,-2,6,4,2,1,3,-2,2,0,-4,4,0,0,-7,-18,-5,-2,7,0,0,-3,1,-1,-1,-1,5,-1
KR_6760499151,420,-2,-67,-48,-2,1,1,2,-1,2,1,0,1,1,-5,5,0,3,0,3,0,-5,315,1,-3,2,1,0,0,-1,1,-1,1,1,-1
KR_6655856302,420,-6,-55,-28,-11,-3,4,1,-3,3,0,-2,3,1,-2,3,1,-1,2,1,0,-7,-10,0,-4,4,0,0,-1,1,-1,-1,-1,6,-1
KR_6675311963,420,2,33,-45,6,1,0,1,-1,1,0,-2,3,1,5,0,5,3,0,3,0,7,34,-1,-1,2,-2,0,0,1,1,0,-1,5,-1
KR_6617931333,420,-2,-81,32,-10,1,1,2,-6,6,0,-6,6,0,1,1,2,0,1,1,0,-5,16,-2,-1,3,2,0,0,1,-1,-1,-1,1,-1
KR_6605998359,420,-2,-85,11,-7,0,2,2,-1,6,5,4,1,5,-7,7,0,-3,3,0,1,-4,-5,-2,-4,6,-7,0,-1,0,1,-1,1,0,-1
KR_6682227023,420,0,47,-11,-1,0,0,0,-2,3,1,-2,2,0,3,2,5,0,1,1,0,-2,2,-4,-1,5,1,0,0,1,0,0,-1,1,-1
KR_6749913326,420,-2,-27,-19,-1,-1,1,0,0,1,1,0,1,1,1,1,2,-1,1,0,0,1,-9,-2,-2,4,0,0,0,-1,0,0,-1,6,-1
KR_6621725295,420,0,-44,-4,0,1,1,2,-3,8,5,0,2,2,0,3,3,2,0,2,-1,0,-14,-1,-2,3,2,0,0,1,1,0,-1,5,-1
KR_6729304056,420,-5,-53,-30,-8,2,1,3,-1,3,2,-6,7,1,-2,2,0,-1,2,1,0,-4,-7,-3,-2,5,1,0,-2,-1,-1,-1,1,4,-1
KR_6700974650,420,-4,-96,-24,-9,0,0,0,-2,3,1,-4,4,0,-4,4,0,1,0,1,-1,-6,2,4,-5,1,-3,0,-2,-1,0,-1,-1,3,-1
KR_6545419540,440,-2,-15,8,-10,-6,7,1,-2,2,0,-7,7,0,5,1,6,0,1,1,-1,-5,-7,-4,-2,6,0,0,-4,1,1,-1,-1,1,-1
KR_6690013456,420,-5,-31,-52,-4,1,1,2,-4,4,0,1,4,5,-2,3,1,0,0,0,0,-3,-14,2,-6,4,-2,0,0,-1,-1,0,1,1,-1
KR_6726780127,420,2,26,-12,0,-1,2,1,2,3,5,-1,2,1,-5,5,0,5,1,6,0,-2,4,2,-4,2,-4,0,0,1,-1,0,1,4,-1
KR_6754269078,440,1,-1,-27,2,2,2,4,5,4,9,-1,6,5,-4,5,1,0,0,0,0,4,13,0,-5,5,1,0,0,1,-1,-1,-1,3,-1
KR_6613475471,420,-6,-77,-44,-13,-1,4,3,-3,5,2,-5,8,3,-1,4,3,-3,4,1,1,-1,-396,0,-1,1,2,0,-2,-1,-1,-1,-1,2,-1
KR_6648759553,420,-5,-77,-1,-3,-4,4,0,0,1,1,2,0,2,-1,2,1,0,0,0,0,-2,-12,-1,0,1,-1,0,-1,-1,0,-1,1,4,-1
KR_6760350458,440,-3,-42,-14,-6,-1,3,2,-4,4,0,-2,3,1,2,1,3,-1,3,2,-1,-9,-4,1,-1,0,1,0,0,1,0,0,-1,6,-1
KR_6757250327,420,-3,-21,20,-7,1,0,1,-4,7,3,-3,6,3,-2,5,3,1,2,3,1,-10,-4,-5,-2,7,1,0,-1,0,-1,-1,1,0,-1
KR_6658137503,420,-1,-11,12,-2,0,1,1,-1,1,0,-1,4,3,-1,2,1,1,0,1,0,-3,8,-3,-2,5,-1,0,0,-1,1,0,1,2,-1
KR_6690530886,420,-3,-23,15,-7,3,2,5,0,1,1,3,1,4,-8,8,0,-5,5,0,0,-13,-9,-1,-2,3,-2,0,-1,-1,0,-1,1,1,-1
KR_6752347166,440,-5,-29,-24,-6,-2,4,2,-2,2,0,-4,6,2,-2,4,2,4,1,5,0,3,-4,-5,0,5,-1,0,-1,0,-1,1,-1,0,-1
KR_6673659250,420,-7,-95,-32,-16,0,3,3,-8,8,0,-8,10,2,1,2,3,-1,2,1,-2,-13,-7,1,-2,1,-2,0,-2,-1,-1,-1,-1,2,-1
KR_6659676618,420,0,-65,-8,-7,3,3,6,2,2,4,-2,3,1,-6,6,0,-4,4,0,-1,-12,-2,0,-1,1,3,0,-1,0,0,-1,-1,0,-1
KR_6609395355,420,-5,-72,-4,-13,-1,2,1,-2,4,2,-4,6,2,-4,4,0,-2,2,0,0,-12,-3,0,-2,2,-1,0,0,-1,-1,0,1,2,-1
KR_6659541737,420,1,59,-44,-2,8,1,9,-2,3,1,-1,1,0,-8,8,0,1,0,1,1,-12,4,-3,-1,4,2,0,0,1,-1,1,1,2,-1
KR_6613113284,420,-3,-28,-33,-7,1,1,2,-2,4,2,0,1,1,-6,6,0,0,0,0,0,-8,1,-1,-2,3,-1,0,0,-1,0,-1,-1,1,-1
KR_6652873829,420,-2,31,-12,-5,-2,3,1,-2,4,2,-1,3,2,-1,3,2,1,0,1,0,-4,-34,-5,-1,6,20,0,0,-1,0,0,-1,1,-1
KR_6683646046,440,2,39,12,3,3,0,3,-3,3,0,0,3,3,1,3,4,2,0,2,0,-11,280,1,-2,1,-2,0,0,-1,0,0,1,4,-1
KR_6705819419,420,0,-29,12,2,1,1,2,1,0,1,-3,3,0,1,1,2,2,1,3,0,3,2,0,-4,4,6,0,0,1,1,0,-1,4,-1
KR_6655792374,420,-1,-12,-12,0,0,1,1,0,0,0,5,2,7,-3,5,2,-2,2,0,0,4,-24,-1,-2,3,-1,0,0,0,-1,0,-1,0,-1
KR_6679322795,420,-6,-17,-109,-6,1,0,1,-1,2,1,1,0,1,-7,7,0,0,1,1,2,-4,-26,0,-3,3,6,0,-5,-1,-1,-1,1,6,-1
KR_6687261651,420,-7,-120,-36,-10,-1,1,0,-4,5,1,-5,5,0,-1,1,0,1,1,2,0,-3,-8,-3,-3,6,-3,0,-1,-1,-1,-1,-1,3,-1
KR_6612250205,420,-5,-101,-20,-14,-7,10,3,-1,2,1,3,2,5,-7,8,1,-2,3,1,0,-5,-23,1,-3,2,0,0,-3,-1,0,-1,-1,2,-1
KR_6505936806,420,1,-10,-9,8,3,0,3,4,1,5,-1,3,2,2,2,4,0,0,0,1,13,-4,4,-6,2,0,0,0,1,1,0,1,2,-1
KR_6348777428,420,1,12,-2,0,-1,3,2,1,4,5,2,3,5,-6,7,1,4,1,5,0,-8,-1,-3,-3,6,0,0,1,-1,0,1,1,6,-1
KR_6757759020,420,1,86,11,-2,1,2,3,-1,6,5,1,1,2,-1,3,2,-2,2,0,0,1,-1,4,-5,1,0,0,-1,1,-1,-1,-1,3,-1
KR_6147622789,420,0,-35,-12,-7,-4,4,0,1,2,3,3,1,4,-6,6,0,-1,2,1,1,-9,-21,0,-5,5,-2,0,-2,-1,-1,-1,1,2,-1
KR_6763710184,420,-4,-70,-24,-10,-2,2,0,-4,4,0,-1,3,2,0,1,1,-3,3,0,1,-8,-1,3,-3,0,0,0,0,-1,0,0,-1,2,-1
KR_6687266337,420,-6,-64,-12,-5,-2,3,1,-2,2,0,2,1,3,-1,4,3,-2,2,0,0,-8,-10,-2,-2,4,-1,0,0,-1,-1,-1,1,6,-1
KR_6733790992,440,1,19,-15,-2,-2,3,1,-4,5,1,4,1,5,0,2,2,0,0,0,1,0,-343,-1,-3,4,-3,0,0,-1,1,0,1,4,-1
KR_6673705553,420,0,35,16,0,2,2,4,-1,3,2,1,1,2,1,1,2,-3,5,2,1,-3,-7,0,-3,3,1,0,-1,-1,1,-1,1,4,-1
KR_6530486042,420,-6,-71,-28,-15,-9,9,0,-2,3,1,-1,3,2,-2,2,0,-1,3,2,-1,-10,-182,1,-3,2,0,0,-2,-1,-1,-1,-1,1,-1
KR_6692549258,420,-2,18,15,-7,-3,4,1,-5,10,5,0,2,2,1,2,3,0,1,1,0,-3,2,-4,-3,7,-1,0,-1,1,0,-1,-1,1,-1
KR_6759216147,420,-1,-46,12,-4,0,1,1,-5,6,1,3,3,6,1,4,5,-3,3,0,0,-10,-1,1,-4,3,-2,0,-1,-1,1,-1,-1,4,-1
KR_6645488016,440,-8,-119,-36,-9,-5,8,3,1,0,1,-3,6,3,-1,4,3,-1,4,3,0,0,3,4,-5,1,-1,0,-1,0,1,-1,1,0,-1
KR_6641461790,420,1,-9,-16,3,0,3,3,0,2,2,0,2,2,5,0,5,-2,2,0,0,8,-5,-1,0,1,-1,0,0,1,1,0,-1,6,-1
KR_6747653653,420,-5,-74,-11,-13,-1,4,3,-4,5,1,-6,8,2,0,2,2,-2,3,1,2,-16,-3,-2,0,2,0,0,-3,-1,1,-1,1,3,-1
KR_6621484565,420,-5,-54,0,-15,0,0,0,-11,13,2,-4,7,3,-1,4,3,1,0,1,0,-15,244,-5,0,5,2,0,0,-1,0,0,-1,6,-1
KR_6735611241,440,0,-83,8,-4,-2,2,0,-6,8,2,0,2,2,3,2,5,1,2,3,0,-10,10,-1,-1,2,6,0,-1,-1,0,-1,1,3,-1
KR_6681042861,420,0,20,-16,-8,-1,1,0,1,1,2,1,2,3,-6,7,1,-3,3,0,0,-10,3,1,-2,1,-2,0,0,-1,1,-1,-1,2,-1
KR_5802234588,420,-3,-12,-28,-6,-2,3,1,-3,3,0,0,2,2,-1,1,0,0,1,1,0,-5,3,-1,-3,4,-5,0,-1,-1,-1,-1,-1,4,-1
KR_6760914207,420,-6,-20,-107,-5,0,2,2,-2,3,1,1,2,3,-2,4,2,-2,3,1,0,-5,12,3,-5,2,0,0,0,-1,-1,1,1,3,-1
KR_6072637944,420,-3,-16,-4,-8,-1,1,0,-4,5,1,-1,2,1,-1,4,3,-1,1,0,0,-7,129,1,-3,2,1,0,0,-1,-1,-1,1,3,-1
KR_6724998453,420,-2,2,-10,-7,-5,5,0,-1,2,1,0,3,3,-1,4,3,0,0,0,0,-11,40,3,-8,5,-20,0,-2,-1,-1,-1,-1,5,-1
KR_6643241669,420,4,-24,4,2,-4,4,0,5,1,6,3,0,3,-2,2,0,0,2,2,0,-2,-6,-5,-2,7,1,0,0,-1,-1,0,1,6,-1
KR_6723957362,420,0,29,-23,-7,0,2,2,0,2,2,2,1,3,-7,8,1,-2,2,0,0,-13,6,0,-6,6,-2,0,0,-1,-1,-1,1,3,-1
KR_6761453627,420,-4,-63,-48,-11,-4,4,0,-3,6,3,-4,5,1,0,4,4,0,1,1,-1,-12,33,-3,-1,4,-20,0,-3,-1,-1,-1,-1,2,-1
KR_6580478918,420,1,-67,-30,5,4,0,4,-2,5,3,2,3,5,-1,3,2,2,0,2,0,8,2,1,-6,5,2,0,0,1,1,1,-1,5,-1
KR_6757253302,420,2,39,20,1,1,3,4,-2,4,2,1,0,1,0,4,4,1,1,2,0,4,-1,2,-6,4,-4,0,0,1,1,0,-1,6,-1
KR_6647060641,440,-2,-37,-2,-6,-2,4,2,0,1,1,1,2,3,-7,8,1,2,4,6,0,3,3,-2,-2,4,-3,0,-2,-1,-1,-1,1,6,-1
KR_6596521054,440,-6,-50,-35,-14,1,3,4,-7,8,1,-4,5,1,-3,5,2,-1,1,0,0,-11,290,-3,-1,4,0,0,-1,-1,1,-1,-1,3,-1
KR_6693716675,420,-5,-64,-20,-9,0,1,1,-1,2,1,-1,2,1,-1,3,2,-6,8,2,0,-8,9,-1,-2,3,0,0,0,-1,1,0,-1,6,-1
KR_6620517722,420,-5,99,-20,-6,0,2,2,-1,2,1,-1,3,2,-3,5,2,-1,1,0,1,-6,-14,-4,-3,7,0,0,1,-1,-1,1,1,3,-1
KR_6756131052,420,-4,-105,-23,-8,0,1,1,-2,7,5,-4,6,2,0,1,1,-2,4,2,0,-14,-8,-4,-4,8,3,0,0,1,-1,0,-1,1,-1
KR_6762582893,420,-1,45,4,-7,-1,1,0,-4,4,0,-3,4,1,1,4,5,0,1,1,0,-10,-7,-3,-4,7,0,0,0,-1,1,0,1,6,-1
KR_6763721560,420,-1,-92,-25,3,0,3,3,0,3,3,-2,4,2,5,1,6,0,0,0,0,3,129,-1,-4,5,-1,0,-1,-1,1,-1,-1,5,-1
KR_6648838551,420,-4,-118,-57,-8,-2,4,2,0,3,3,-5,5,0,-4,5,1,3,0,3,0,-4,-9,-1,-3,4,3,0,-2,-1,1,-1,1,1,-1
KR_6727640528,440,-1,-2,12,-3,-2,2,0,1,1,2,3,1,4,-4,5,1,-1,2,1,0,-2,-5,-3,-6,9,-2,0,0,1,1,-1,-1,2,-1
KR_6711637219,420,1,-15,12,-3,1,1,2,-6,6,0,-2,2,0,0,2,2,4,1,5,0,-1,77,3,-8,5,-3,0,0,1,-1,1,-1,1,-1
KR_6759437778,440,-1,-28,23,-2,-3,5,2,6,1,7,-4,4,0,3,4,7,-4,4,0,-1,-7,17,2,-4,2,1,0,1,0,1,1,-1,0,-1
KR_6684821561,420,-2,1,-26,-2,-1,2,1,2,2,4,2,0,2,-3,3,0,-2,2,0,0,-1,-6,-2,-2,4,-2,0,1,0,1,1,-1,0,-1
KR_6760580597,420,-2,-62,-4,5,5,0,5,-2,4,2,2,2,4,2,0,2,-2,2,0,0,0,-10,-1,-5,6,3,0,0,-1,1,0,1,1,-1
KR_6744998259,420,-2,-60,7,-5,-1,1,0,0,3,3,-5,6,1,-2,3,1,3,0,3,0,-1,-262,-1,-1,2,3,0,-1,1,-1,-1,-1,3,-1
KR_6673480951,420,-5,-32,-9,-18,-7,8,1,-5,8,3,-2,2,0,3,4,7,-7,7,0,0,-17,-9,-5,0,5,4,0,-2,-1,-1,-1,-1,3,-1
KR_6717495134,440,0,17,-28,0,-5,6,1,0,2,2,-2,2,0,3,3,6,4,1,5,1,2,-4,2,-5,3,6,0,0,0,-1,0,1,0,-1
KR_6758697576,420,-2,25,-8,-10,0,3,3,-2,4,2,2,1,3,-2,2,0,-8,9,1,0,-14,-18,-2,-2,4,0,0,1,1,-1,1,1,5,-1
KR_6663144280,420,-5,-62,1,-9,-1,1,0,-3,5,2,-1,1,0,-3,3,0,-1,1,0,-1,-15,11,-1,-5,6,-1,0,0,-1,1,-1,-1,4,-1
KR_6743861929,420,-8,-127,-35,-10,0,0,0,-3,3,0,-4,6,2,0,3,3,-3,3,0,0,0,-22,-2,-3,5,4,0,-1,-1,1,-1,-1,5,-1
KR_6734734707,440,-4,-55,-15,-7,-2,4,2,-4,7,3,-1,1,0,0,3,3,0,2,2,0,-8,-10,-7,0,7,0,0,-1,-1,0,-1,-1,2,-1
KR_6750228726,420,-4,-79,-4,-17,-2,5,3,-7,8,1,-7,7,0,0,3,3,-1,5,4,0,-6,-324,2,-2,0,-1,0,0,-1,-1,-1,-1,4,-1
KR_6634526082,420,-1,-3,-16,-1,1,1,2,-2,2,0,1,0,1,1,1,2,-2,2,0,-1,-6,-4,-6,-3,9,2,0,0,1,1,1,-1,6,-1
KR_6741123485,440,-4,-35,-47,-11,1,0,1,-5,5,0,-3,6,3,-4,4,0,0,1,1,0,-2,-382,0,-2,2,1,0,-1,1,-1,-1,-1,5,-1
KR_6565847715,420,-2,34,0,-7,-3,4,1,-2,3,1,-2,7,5,-1,2,1,1,0,1,0,-4,12,0,-2,2,-6,0,-2,1,-1,-1,-1,3,-1
KR_6727018191,420,0,97,24,-3,-3,4,1,-3,4,1,-1,3,2,4,2,6,0,0,0,0,-10,4,0,-4,4,-2,0,0,-1,1,1,1,4,-1
KR_6725765005,440,1,-28,20,-2,0,2,2,2,1,3,1,0,1,-4,4,0,-1,3,2,-1,-2,-40,-2,-3,5,30,0,0,0,1,0,-1,0,-1
KR_6715892157,440,-1,40,-6,-6,3,0,3,-4,4,0,-1,1,0,-3,3,0,-1,1,0,0,-8,8,-2,-4,6,3,0,-1,1,1,-1,-1,5,-1
KR_6764178080,420,-2,-80,-32,4,2,0,2,2,1,3,3,4,7,1,2,3,-4,4,0,0,8,-7,-2,0,2,0,0,0,0,0,0,-1,0,-1
KR_6760980080,420,0,8,-20,1,1,0,1,1,2,3,4,0,4,-5,5,0,0,0,0,0,-1,-10,5,-6,1,-1,0,1,-1,1,1,1,5,-1
KR_6741028549,440,0,-52,-9,-1,-1,2,1,-1,3,2,3,3,6,-1,3,2,-1,1,0,0,1,-12,-4,-2,6,4,0,0,0,0,0,-1,0,-1
KR_6722527565,420,0,-2,4,1,2,0,2,3,1,4,-4,4,0,0,3,3,0,3,3,0,-4,274,0,-1,1,-1,0,1,-1,1,1,1,4,-1
KR_6646387544,420,-4,-55,-35,-2,-2,3,1,-4,4,0,-1,3,2,4,0,4,1,1,2,-1,3,31,-4,-2,6,7,0,-1,1,-1,1,-1,1,-1
KR_6726629607,420,0,-5,6,-4,0,0,0,-2,5,3,-2,4,2,1,1,2,-1,2,1,0,0,-26,-3,-3,6,-1,0,0,1,1,0,-1,6,-1
KR_6742382246,420,0,1,-24,2,2,0,2,-4,6,2,1,1,2,0,1,1,3,1,4,0,-5,-9,-3,-4,7,-2,0,1,-1,0,1,-1,1,-1
KR_6727802161,420,-1,-59,0,-2,0,2,2,0,0,0,-6,7,1,2,1,3,2,0,2,0,5,1,4,-7,3,-3,0,0,1,1,1,-1,5,-1
KR_6723157540,420,0,-10,41,1,-6,7,1,2,3,5,2,0,2,1,2,3,2,1,3,-1,5,19,0,-4,4,-1,0,-2,1,-1,-1,-1,3,-1
KR_6746616898,440,-1,8,16,1,0,2,2,-3,3,0,0,3,3,2,0,2,2,0,2,0,3,1,4,-9,5,1,0,-2,1,-1,-1,1,3,-1
KR_6700012718,420,-2,-40,-14,-7,-1,1,0,-3,5,2,4,1,5,-7,10,3,0,0,0,-1,-8,-4,-1,-3,4,0,0,0,-1,0,0,-1,1,-1
KR_6601242379,440,-5,-99,-28,-9,-4,6,2,-1,3,2,-1,2,1,-4,9,5,1,0,1,1,-2,3,5,-5,0,-1,0,-3,-1,-1,-1,1,6,-1
KR_6683695395,420,1,59,56,4,1,1,2,-1,1,0,-1,1,0,3,0,3,2,0,2,0,3,1,-1,-2,3,0,0,1,-1,-1,1,1,6,-1
KR_6571008750,420,-3,-113,6,-7,0,3,3,-2,4,2,-5,7,2,1,3,4,-1,2,1,0,2,-166,-3,-1,4,16,0,-1,-1,1,-1,-1,1,-1
KR_6758785771,420,-1,-90,6,-2,-2,2,0,3,2,5,3,2,5,-1,4,3,-5,6,1,-1,-2,-33,1,-7,6,5,0,-1,-1,1,-1,-1,3,-1
KR_6751021590,440,-1,-79,-13,-7,3,2,5,3,1,4,-6,7,1,-6,10,4,-1,3,2,-1,-3,-3,-2,-1,3,0,0,-2,-1,-1,-1,-1,1,-1
KR_6757275652,420,3,-23,4,8,7,1,8,1,2,3,0,2,2,0,5,5,0,2,2,0,5,3,-1,0,1,0,0,1,-1,0,1,-1,2,-1
KR_6683595776,420,-3,-97,-36,-1,7,1,8,-1,2,1,-5,5,0,-3,6,3,1,1,2,0,-10,-46,-3,-4,7,12,0,-2,-1,-1,-1,1,1,-1
KR_6644401285,420,-2,19,-31,-11,2,0,2,-9,10,1,1,2,3,2,3,5,-7,7,0,0,-4,0,-3,-4,7,-3,0,0,-1,0,-1,1,5,-1
KR_6724802257,420,-2,-22,-7,4,3,0,3,2,2,4,-1,2,1,-1,2,1,1,3,4,0,7,-1,0,-3,3,-2,0,1,0,-1,1,1,0,-1
KR_6722915672,420,-1,-11,-2,-1,-1,1,0,-3,5,2,2,0,2,0,2,2,1,0,1,0,0,12,4,-6,2,3,0,1,1,1,1,-1,5,-1
KR_6761967586,420,-1,37,-10,-6,-4,5,1,-2,5,3,-2,4,2,1,1,2,1,2,3,0,-4,1,-2,-3,5,3,0,1,1,-1,1,-1,6,-1
KR_6118555384,440,-1,57,2,-4,3,0,3,-8,8,0,-3,5,2,2,0,2,2,3,5,0,4,124,2,-2,0,-2,0,1,1,-1,-1,-1,2,-1
KR_6694205587,440,-6,-78,0,4,2,1,3,5,2,7,-2,2,0,-1,1,0,0,6,6,0,6,-6,-3,0,3,0,0,-1,-1,-1,-1,-1,4,-1
KR_6720706293,420,-4,-56,-18,-7,-3,5,2,-3,4,1,0,3,3,-1,3,2,0,1,1,0,0,2,2,-5,3,-4,0,-1,1,-1,-1,1,6,-1
KR_6715499530,440,-2,23,4,-5,0,0,0,-4,5,1,2,1,3,-3,4,1,0,2,2,0,-2,-7,-5,-3,8,5,0,-1,-1,-1,-1,1,4,-1
KR_6663916394,420,0,53,-14,4,0,1,1,1,1,2,2,2,4,1,2,3,0,2,2,0,2,-3,3,-4,1,-1,0,-1,1,-1,-1,-1,2,-1
KR_6377659957,420,-3,66,-16,-6,-1,1,0,-2,3,1,-5,6,1,1,1,2,1,1,2,0,-2,14,-8,0,8,-13,0,-1,-1,-1,-1,1,1,-1
KR_6213541201,420,-4,-65,8,-2,1,1,2,3,3,6,-3,3,0,-2,2,0,-1,3,2,0,-2,-171,1,-5,4,-2,0,-1,-1,1,-1,-1,5,-1
KR_6639524330,420,0,30,25,0,1,0,1,-3,5,2,-1,3,2,0,4,4,3,0,3,0,0,0,3,-3,0,1,0,-1,-1,1,-1,-1,5,-1
KR_6725994051,420,-5,-69,-16,-9,-2,5,3,-2,3,1,-3,3,0,-2,2,0,0,2,2,0,-6,1,-3,-1,4,1,0,-1,-1,0,-1,-1,1,-1
KR_6750667142,440,-1,4,-5,-6,-2,3,1,1,2,3,1,0,1,0,3,3,-6,6,0,-1,0,-7,-2,0,2,-2,0,0,0,0,0,-1,0,-1
KR_6754429699,440,-3,32,-7,-10,1,1,2,-3,4,1,-3,4,1,-4,9,5,-1,2,1,-1,-14,-4,-2,-3,5,1,0,-1,0,-1,-1,-1,0,-1
KR_6735605214,420,-1,-13,-19,-6,0,2,2,1,0,1,0,1,1,-4,5,1,-3,4,1,-1,-6,-1,0,-3,3,1,0,0,1,-1,-1,-1,6,-1
KR_6758583076,420,2,57,-10,11,2,1,3,-1,2,1,4,1,5,7,3,10,-1,4,3,2,3,-11,2,-3,1,2,0,0,1,-1,1,1,3,-1
KR_6746844519,420,-1,15,12,-5,-3,3,0,1,2,3,3,0,3,-4,5,1,-2,2,0,0,-5,4,0,-8,8,-2,0,-2,1,-1,-1,1,3,-1
KR_6754174391,420,-1,-10,12,-1,-4,5,1,1,1,2,1,3,4,0,6,6,1,2,3,0,7,3,-3,0,3,0,0,-3,1,-1,-1,-1,4,-1
KR_6761724572,420,-3,-101,-11,-7,-5,5,0,0,2,2,1,2,3,-2,2,0,-1,2,1,0,-3,15,-2,-3,5,-3,0,-1,1,-1,-1,-1,3,-1
KR_6630864783,420,-6,-75,-51,-11,-1,3,2,-6,6,0,-3,5,2,0,2,2,-1,1,0,0,-5,-7,-3,0,3,1,0,-4,-1,-1,-1,-1,5,-1
KR_6692771570,440,-2,-18,1,3,0,4,4,-1,1,0,-1,1,0,1,0,1,4,1,5,0,7,-4,-7,-2,9,2,0,-1,-1,-1,-1,-1,6,-1
KR_6648781128,420,-2,28,-18,-5,4,1,5,-2,3,1,0,0,0,0,4,4,-7,7,0,-2,-12,-1,0,-2,2,3,0,-1,-1,1,1,-1,1,-1
KR_6505065558,420,-2,1,-10,-6,1,2,3,-5,8,3,0,3,3,-7,7,0,5,2,7,0,-11,-27,-1,-3,4,1,0,-1,-1,1,-1,-1,1,-1
KR_6123339406,440,-2,16,-34,-7,3,1,4,-10,10,0,2,1,3,-1,3,2,-1,4,3,0,-9,4,6,-7,1,-5,0,0,-1,0,0,1,2,-1
KR_6665325919,420,1,26,12,3,-4,5,1,1,1,2,1,2,3,4,2,6,1,1,2,1,3,18,-1,-3,4,-2,0,0,1,1,1,1,1,-1
KR_6740403810,420,0,-13,8,0,2,0,2,2,0,2,-1,1,0,-2,2,0,-1,1,0,0,0,3,-1,-2,3,0,0,0,-1,1,0,1,1,-1
KR_6607551751,420,4,50,22,3,2,1,3,-3,7,4,1,2,3,2,2,4,1,0,1,0,3,38,2,-4,2,-23,0,1,-1,1,1,-1,3,-1
KR_6699544187,420,-2,-84,-8,-6,1,2,3,-1,1,0,1,5,6,-2,3,1,-5,5,0,0,0,0,-1,-2,3,-2,0,-1,-1,1,-1,-1,1,-1
KR_6684167951,420,0,-40,-39,1,0,1,1,1,3,4,-3,4,1,2,3,5,1,4,5,0,4,6,2,-3,1,1,0,-1,1,-1,-1,-1,4,-1
KR_6613415392,420,-3,-37,-16,-7,-7,7,0,1,0,1,1,3,4,0,5,5,-2,4,2,0,0,111,-3,-4,7,0,0,-1,1,-1,-1,1,5,-1
KR_6763571355,420,-3,-53,9,-2,0,1,1,-1,3,2,-1,1,0,0,0,0,0,0,0,0,2,110,2,-2,0,-2,0,-1,-1,-1,-1,1,2,-1
KR_6743932885,420,-3,-47,-12,-4,-6,6,0,1,1,2,4,3,7,-3,4,1,0,1,1,0,2,1,-1,-2,3,0,0,0,1,-1,0,1,2,-1
KR_6669069768,440,0,-21,3,-1,1,1,2,1,1,2,0,1,1,-1,5,4,-2,3,1,0,-7,15,5,-5,0,0,0,0,0,1,0,1,0,-1
KR_6763677900,420,-5,-16,-47,-9,-3,4,1,-2,3,1,-2,3,1,-3,5,2,1,0,1,0,-3,-9,0,-4,4,-15,0,0,-1,-1,-1,-1,2,-1
KR_6435168716,420,-2,-57,4,-2,0,2,2,0,8,8,1,1,2,-2,2,0,-1,1,0,0,-1,-4,-3,-3,6,0,0,0,-1,-1,1,-1,3,-1
KR_6717856064,420,2,55,28,8,0,2,2,2,0,2,5,1,6,0,1,1,1,0,1,0,2,-18,-1,-6,7,4,0,1,1,1,1,1,5,-1
KR_6682544735,420,2,9,0,-2,-1,2,1,2,1,3,-2,4,2,0,2,2,-1,2,1,0,5,-5,-2,-3,5,-2,0,0,-1,-1,0,-1,4,-1
KR_6571283762,420,1,-29,18,-2,-1,4,3,0,1,1,1,0,1,-1,3,2,-1,3,2,0,-2,-3,-6,0,6,4,0,-2,0,-1,-1,1,0,-1
KR_6758332554,420,-1,-32,8,1,1,1,2,3,0,3,-1,1,0,-2,3,1,0,0,0,0,2,28,3,-7,4,1,0,0,-1,-1,0,-1,6,-1
KR_6737992456,440,-4,-49,-12,-10,0,3,3,-4,5,1,-1,2,1,-6,7,1,1,2,3,0,-11,-8,1,-4,3,-1,0,0,-1,1,-1,-1,4,-1
KR_6340179140,440,-3,-46,-16,-5,-6,6,0,-1,3,2,3,0,3,-2,4,2,1,0,1,-1,-4,-50,-2,-3,5,7,0,-1,-1,-1,-1,-1,3,-1
KR_6746573557,420,-11,-155,-40,-14,3,0,3,-3,4,1,-8,8,0,-4,4,0,-2,3,1,-2,-12,-59,-3,0,3,21,0,-4,0,-1,-1,-1,0,-1
KR_6332782149,440,-4,-33,-1,-8,0,1,1,-3,4,1,-1,2,1,-4,4,0,0,2,2,0,-13,-25,0,-4,4,30,0,-2,-1,0,-1,-1,2,-1
KR_6082672546,440,-2,-3,1,0,-3,3,0,-2,2,0,0,0,0,4,0,4,1,0,1,0,2,-7,-3,-1,4,4,0,-1,-1,-1,-1,-1,2,-1
KR_6647901979,440,0,54,0,-1,4,1,5,-2,2,0,-4,5,1,1,1,2,0,3,3,2,-2,2,2,-2,0,1,0,0,0,0,0,1,0,-1
KR_6399686549,420,-3,-59,-36,-10,-3,6,3,-4,7,3,-7,9,2,5,0,5,-1,2,1,0,-4,1,4,-4,0,-1,0,-3,-1,-1,-1,1,4,-1
KR_6684156393,420,3,61,-15,6,3,0,3,-7,7,0,5,0,5,3,0,3,2,0,2,1,3,-6,-2,-3,5,-2,0,1,1,1,1,1,6,-1
KR_6759370111,420,-5,-47,-24,-2,-1,3,2,-2,4,2,-2,3,1,4,2,6,-1,1,0,0,-3,-11,-1,-1,2,-1,0,-1,-1,-1,-1,1,5,-1
KR_6754687319,420,-2,-31,29,-4,6,1,7,-3,3,0,-3,4,1,-3,3,0,-1,1,0,-2,-6,-16,-1,-1,2,3,0,0,-1,1,1,-1,2,-1
KR_6763789993,420,-3,-63,14,-10,-5,5,0,-4,5,1,2,0,2,-3,3,0,0,0,0,0,-10,0,0,-2,2,0,0,-1,-1,0,-1,-1,5,-1
KR_6724756909,420,-1,-9,-20,2,3,0,3,0,1,1,0,3,3,-1,1,0,0,0,0,0,0,1,2,-4,2,0,0,0,1,1,0,1,2,-1
KR_6704135189,420,-1,32,-84,2,3,1,4,2,2,4,0,2,2,-5,7,2,2,1,3,-1,0,-2,-3,-1,4,0,0,2,-1,-1,1,-1,1,-1
KR_6699165052,420,-2,25,-36,-2,0,2,2,0,6,6,2,0,2,-2,4,2,-2,3,1,0,-3,2,6,-7,1,1,0,-1,1,-1,-1,-1,6,-1
KR_6757312155,420,-1,57,-20,1,-1,1,0,0,2,2,-4,4,0,4,1,5,2,2,4,0,0,-7,-4,-1,5,6,0,0,-1,-1,-1,1,1,-1
KR_6761151488,440,-1,31,-17,-6,-3,4,1,-1,1,0,-5,6,1,1,0,1,2,0,2,0,0,-1,-1,0,1,1,0,-1,-1,0,-1,-1,4,-1
KR_6741041230,420,-2,-50,-12,-5,1,0,1,-2,6,4,0,4,4,0,0,0,-4,5,1,0,-7,-60,5,-8,3,-4,0,-1,-1,1,-1,-1,1,-1
KR_6659783177,420,-3,-54,-5,-10,-3,5,2,-6,7,1,-3,4,1,-1,5,4,3,2,5,0,-8,2,0,-4,4,-2,0,0,-1,1,0,-1,2,-1
KR_6758426019,440,-4,-51,-8,-12,-5,5,0,2,3,5,-4,7,3,-6,6,0,1,0,1,-1,-16,24,2,-4,2,0,0,0,-1,1,0,-1,1,-1
KR_6720400630,420,1,-49,-32,10,2,1,3,2,2,4,0,2,2,6,0,6,0,0,0,0,11,0,2,-6,4,-4,0,-1,-1,-1,-1,1,5,-1
KR_6610562579,420,2,36,-28,0,1,1,2,-1,5,4,4,2,6,-3,3,0,-1,2,1,0,-8,-42,0,-3,3,15,0,1,-1,1,1,1,6,-1
KR_6604439443,420,-5,22,-15,-19,1,2,3,-9,9,0,-7,7,0,-3,5,2,-1,1,0,0,-21,-28,-5,-1,6,1,0,0,1,1,0,-1,3,-1
KR_6413722365,420,1,37,-39,3,3,1,4,-2,2,0,0,1,1,2,1,3,0,1,1,0,1,126,2,-4,2,-3,0,1,1,-1,1,1,4,-1
KR_6696895466,420,2,70,-20,1,1,1,2,0,3,3,-1,5,4,-2,2,0,3,0,3,0,1,172,2,-4,2,1,0,-1,1,-1,-1,-1,1,-1
KR_6749868914,420,-2,17,-32,-2,-3,3,0,2,4,6,3,1,4,-5,6,1,1,0,1,1,1,8,0,-4,4,1,0,0,0,-1,-1,1,0,-1
KR_6736670731,420,-2,-35,-15,-2,3,0,3,2,3,5,-2,2,0,-3,3,0,-2,2,0,-1,-9,-5,0,-2,2,1,0,1,-1,1,1,-1,3,-1
KR_6746508864,420,-7,-112,20,-15,-1,3,2,-3,4,1,-1,2,1,-7,7,0,-3,4,1,1,-11,-133,3,-6,3,-2,0,-3,-1,-1,-1,1,5,-1
KR_6678707443,420,-1,-2,-8,-5,-2,4,2,6,1,7,-3,4,1,-7,7,0,1,0,1,0,-7,5,1,-4,3,-2,0,-1,1,1,-1,-1,2,-1
KR_6720394166,420,-8,-72,-91,-17,-8,8,0,-5,5,0,-1,2,1,-3,4,1,0,4,4,-2,-9,-13,0,-1,1,0,-1,-4,-1,-1,-1,-1,5,-1
KR_6756074927,420,2,-48,-16,0,-1,4,3,3,3,6,1,2,3,1,2,3,-4,4,0,1,-4,20,-1,-5,6,-1,0,-1,-1,0,-1,1,5,-1
KR_6763279080,420,-3,-52,-52,-5,-3,5,2,0,2,2,-1,2,1,0,4,4,-1,1,0,0,-6,2,2,-5,3,-2,0,0,-1,-1,0,-1,4,-1
KR_6693136224,420,4,38,49,7,3,0,3,5,3,8,2,2,4,-1,5,4,-2,3,1,0,1,403,1,-1,0,0,0,1,1,0,1,-1,3,-1
KR_6693330844,440,-6,-68,-15,-4,2,0,2,1,1,2,-3,4,1,-3,4,1,-1,1,0,0,-6,4,-1,-2,3,-1,0,-1,-1,0,-1,-1,4,-1
KR_6741973472,420,-4,-52,-41,0,3,1,4,1,5,6,1,2,3,-5,7,2,0,1,1,0,-6,2,-1,-2,3,-2,0,1,-1,0,1,-1,5,-1
KR_6751634740,420,4,84,-4,3,-1,2,1,2,0,2,4,4,8,-3,3,0,1,0,1,0,-1,-14,-1,-1,2,2,0,3,1,1,1,-1,6,-1
KR_5542133744,420,-2,-54,-11,-7,-4,4,0,1,1,2,-4,7,3,1,0,1,-1,3,2,-1,-9,-3,0,-3,3,1,0,-2,-1,-1,-1,-1,1,-1
KR_6645628839,420,1,-11,-16,3,2,1,3,5,2,7,-3,4,1,2,1,3,-3,3,0,0,-3,7,-2,-2,4,4,0,0,1,-1,0,1,2,-1
KR_6675499068,420,0,-31,19,5,0,3,3,4,0,4,-1,4,3,-1,3,2,3,0,3,0,6,40,0,-2,2,-3,0,-1,0,0,-1,1,0,-1
KR_6650280889,420,1,81,-10,1,-1,2,1,-3,5,2,3,0,3,3,0,3,-1,1,0,0,-2,-213,0,-1,1,2,0,0,0,-1,0,1,0,-1
KR_6548502145,420,-4,-111,20,-12,-1,2,1,-1,1,0,-4,6,2,-7,8,1,1,0,1,0,-16,230,1,-7,6,-3,0,-3,1,0,-1,-1,2,-1
KR_6347872751,420,-3,-56,24,-13,-1,1,0,0,1,1,-7,7,0,0,2,2,-5,5,0,0,-16,47,2,-4,2,-35,0,-1,-1,0,-1,-1,5,-1
KR_6650337733,420,3,40,7,-1,-1,2,1,0,1,1,2,3,5,-1,1,0,-1,1,0,0,-4,2,-1,-2,3,-1,0,1,-1,1,1,-1,3,-1
KR_6656939091,440,1,58,-1,2,-3,10,7,-1,2,1,2,1,3,4,2,6,0,0,0,0,-2,4,3,-3,0,-3,0,-1,-1,-1,-1,-1,1,-1
KR_6685152748,420,-5,-100,9,-13,-1,2,1,-8,10,2,-4,5,1,1,4,5,-1,2,1,0,-20,2,2,-5,3,-1,0,0,0,0,0,1,0,-1
KR_6508071847,420,0,-22,-4,1,3,0,3,1,3,4,2,0,2,-5,5,0,0,1,1,0,5,53,2,-2,0,-30,0,0,-1,-1,-1,1,3,-1
KR_6756283094,420,-2,-21,-6,8,0,3,3,1,0,1,4,1,5,2,3,5,1,1,2,1,8,10,-3,-2,5,0,0,0,1,1,-1,1,3,-1
KR_6602577722,420,-5,-22,16,-13,-4,7,3,-3,4,1,-1,4,3,-2,2,0,-3,3,0,0,-15,-1,-1,0,1,2,0,-1,1,-1,-1,-1,5,-1
KR_6738566796,420,-1,30,-16,7,-2,3,1,2,4,6,0,3,3,7,2,9,0,1,1,0,9,3,1,-2,1,0,0,-1,-1,-1,-1,1,1,-1
KR_6673539063,420,-2,-3,-32,0,-3,3,0,-6,6,0,4,0,4,2,2,4,3,0,3,1,5,18,4,-7,3,-5,0,-1,-1,1,-1,1,5,-1
KR_6580701197,420,-2,-50,12,-3,-1,2,1,3,2,5,-1,1,0,-2,5,3,-2,2,0,1,0,-3,-4,-4,8,1,0,0,1,0,0,1,6,-1
KR_6739191752,420,-4,-39,-32,-7,4,1,5,-1,4,3,-3,4,1,-6,8,2,-1,3,2,-1,-12,6,1,-3,2,-3,0,-1,0,1,-1,-1,0,-1
KR_6689907691,440,0,-30,-8,-1,-4,4,0,1,2,3,2,0,2,2,2,4,-2,6,4,1,6,-12,-3,-2,5,6,0,0,-1,1,0,1,1,-1
KR_6710464914,420,2,48,-4,4,3,0,3,2,5,7,0,1,1,0,4,4,-1,1,0,0,4,-3,1,-6,5,0,0,0,-1,1,0,-1,5,-1
KR_6689507212,420,-2,-13,6,-3,2,2,4,-1,4,3,-4,5,1,1,1,2,-1,2,1,0,-8,-17,1,-6,5,-5,0,-1,-1,0,-1,-1,1,-1
KR_6751175126,420,-5,-84,-15,-11,0,2,2,0,3,3,-3,6,3,-4,6,2,-4,4,0,0,-7,91,1,-4,3,-3,0,-2,-1,-1,-1,-1,6,-1
KR_6748957881,420,-5,-55,-36,-9,-2,4,2,-2,2,0,-6,6,0,1,2,3,0,0,0,0,-2,-12,-2,-1,3,1,0,-1,-1,0,-1,-1,3,-1
KR_6689917267,420,-6,-37,-16,-18,-1,3,2,-4,4,0,-12,13,1,-2,3,1,1,0,1,0,-11,-6,-2,-1,3,-2,0,-1,-1,-1,-1,-1,3,-1
KR_6704906909,440,-1,-62,6,-10,0,1,1,-1,4,3,-5,6,1,-1,3,2,-3,3,0,0,-7,-5,1,-2,1,-1,0,0,-1,1,0,1,5,-1
KR_6721247489,420,-1,-15,-20,-10,3,0,3,-5,6,1,-6,7,1,-1,2,1,-1,1,0,-3,-15,1,-4,-2,6,-1,0,1,-1,-1,1,-1,4,-1
KR_6725031036,440,-3,-46,-4,-7,-4,6,2,-4,4,0,-1,1,0,0,4,4,2,0,2,1,0,-2,2,-4,2,-5,0,-2,1,-1,-1,1,4,-1
KR_6606658928,420,-4,2,-12,-5,-2,2,0,-3,5,2,-4,6,2,1,2,3,3,1,4,0,-8,-23,-2,-6,8,0,0,0,0,1,0,1,0,-1
KR_6761658535,420,-3,-17,-32,-4,0,1,1,2,3,5,-4,5,1,0,2,2,-2,5,3,0,-4,259,1,-3,2,-3,0,0,-1,-1,0,1,5,-1
KR_6497564571,420,-5,-56,-13,-15,-2,3,1,-8,10,2,2,1,3,-2,3,1,-5,5,0,-2,-15,2,-2,-1,3,-1,0,-2,0,0,-1,-1,0,-1
KR_6756343314,420,-6,-66,7,-11,-6,7,1,4,0,4,-1,3,2,-7,10,3,-1,2,1,0,-4,-5,-1,-2,3,2,0,-1,0,0,-1,-1,0,-1
KR_6658751469,420,-2,-48,-12,-4,0,2,2,-2,5,3,-5,6,1,1,4,5,2,1,3,0,-6,152,2,-7,5,-1,0,0,1,-1,-1,-1,5,-1
KR_6689197619,420,-2,13,4,-3,2,1,3,-2,7,5,-1,1,0,0,2,2,-2,2,0,0,-1,10,5,-7,2,0,0,-1,1,1,-1,-1,1,-1
KR_6567996743,440,-4,28,-20,-13,-3,5,2,-2,3,1,-1,5,4,0,2,2,-7,7,0,1,-15,-5,3,-6,3,6,0,-3,1,-1,-1,1,2,-1
KR_6714052526,420,-5,-93,-16,-12,-1,1,0,-5,6,1,-2,2,0,-3,4,1,-1,1,0,0,-13,-83,-2,-3,5,1,0,-2,-1,-1,-1,-1,6,-1
KR_6685395055,420,-1,-10,-32,0,1,3,4,3,2,5,-3,5,2,-1,2,1,0,0,0,0,4,6,3,-3,0,-5,0,-1,1,1,-1,-1,4,-1
KR_6740809324,420,-4,-7,-26,-4,2,1,3,4,0,4,-2,4,2,-4,4,0,-4,4,0,0,-10,-122,0,-2,2,0,0,-2,-1,1,-1,1,4,-1
KR_6754256108,420,-2,-49,4,-1,-4,7,3,2,0,2,0,2,2,2,1,3,-1,1,0,0,8,22,3,-3,0,0,0,0,0,1,0,-1,0,-1
KR_6732760947,440,-3,-31,-12,-10,-4,5,1,-1,3,2,-1,4,3,-3,5,2,-1,1,0,0,-8,3,-2,-1,3,-1,0,-1,-1,-1,-1,-1,2,-1
KR_6707012618,420,1,79,-33,4,2,2,4,-1,3,2,-1,2,1,2,0,2,2,0,2,0,2,-36,-2,-1,3,13,0,1,-1,-1,1,1,3,-1
KR_6710094405,420,0,-41,8,-1,1,0,1,-4,4,0,-1,6,5,1,2,3,2,1,3,-1,0,-3,-3,-3,6,-1,0,-2,-1,-1,-1,-1,1,-1
KR_6704724415,420,-2,19,-9,-3,2,0,2,-2,4,2,-3,3,0,0,3,3,0,0,0,-1,-5,-8,0,-4,4,-1,0,0,1,-1,0,-1,3,-1
KR_6755831245,420,-6,-131,-55,-7,-1,2,1,-3,6,3,-3,7,4,-6,8,2,6,0,6,1,-2,-8,-2,-2,4,1,0,-3,-1,-1,-1,1,5,-1
KR_6671636205,420,-1,-40,-8,-9,-5,6,1,2,2,4,0,1,1,-5,5,0,-1,1,0,-1,-5,-3,5,-7,2,1,0,1,-1,0,-1,-1,3,-1
KR_6669054760,420,-2,-63,-10,-7,-1,3,2,-2,3,1,-4,8,4,0,3,3,0,0,0,-2,-12,-5,-3,-2,5,-1,0,-1,-1,1,-1,-1,6,-1
KR_6763321266,420,-9,-105,-41,-22,-7,7,0,-2,2,0,0,2,2,-8,9,1,-5,5,0,0,-17,-223,-3,-1,4,-1,0,-2,-1,0,-1,-1,4,-1
KR_6762532375,420,-2,-47,-12,0,1,0,1,3,0,3,-5,5,0,0,6,6,1,2,3,0,5,-23,3,-5,2,4,0,-1,1,-1,-1,1,3,-1
KR_6717470530,420,2,-9,-24,11,2,3,5,-3,5,2,7,2,9,2,3,5,3,0,3,1,8,-185,2,-6,4,1,0,-2,1,-1,-1,1,4,-1
KR_6716748365,440,-3,-106,7,-8,1,0,1,-3,6,3,-5,7,2,-1,2,1,0,1,1,0,-6,-472,2,-6,4,-2,0,-1,1,-1,-1,-1,3,-1
KR_6613490483,420,-4,-92,-20,-9,-5,5,0,-4,5,1,-6,6,0,6,1,7,0,0,0,0,-3,-54,3,-4,1,31,0,-1,-1,0,-1,-1,1,-1
KR_6612743969,420,-2,-6,4,1,-2,3,1,-7,8,1,5,2,7,0,3,3,5,2,7,-1,3,-13,0,-1,1,-2,0,-2,1,1,-1,-1,4,-1
KR_6746581525,440,0,-1,-9,0,1,0,1,5,0,5,-5,5,0,-1,2,1,0,0,0,0,3,22,2,-7,5,-1,0,0,-1,1,0,-1,2,-1
KR_6640096381,420,-3,-18,-5,-11,-7,8,1,-3,5,2,5,2,7,-4,4,0,-2,2,0,0,-6,4,-3,-1,4,-4,0,1,0,1,-1,-1,0,-1
KR_6567355065,420,-4,-36,-57,-10,-4,4,0,1,0,1,-11,11,0,2,2,4,2,0,2,0,-2,-3,1,-3,2,-2,0,-1,-1,-1,-1,-1,2,-1
KR_6763094155,420,-2,-19,-3,-1,0,3,3,-1,2,1,-1,5,4,1,1,2,0,2,2,0,1,1,4,-5,1,-2,0,1,-1,1,1,-1,5,-1
KR_6753571721,440,0,-35,15,3,-2,3,1,2,2,4,2,0,2,-1,2,1,2,2,4,0,-1,9,4,-4,0,-3,0,2,0,0,1,-1,0,-1
KR_6725937007,420,4,14,-1,5,3,3,6,2,1,3,-2,4,2,0,2,2,2,0,2,0,3,1,1,-2,1,2,0,0,-1,1,1,-1,2,-1
KR_6660702224,420,-1,-41,-4,-3,2,1,3,-1,2,1,-2,5,3,-2,3,1,0,1,1,-1,6,-5,-3,-2,5,0,0,0,-1,-1,-1,-1,2,-1
KR_6751022694,440,-1,-35,-7,-8,-1,1,0,2,2,4,1,1,2,-8,8,0,-2,2,0,0,-10,7,2,-5,3,-4,0,0,-1,-1,0,-1,4,-1
KR_6645722679,440,-4,9,-8,-6,0,0,0,-2,4,2,-3,3,0,-1,1,0,0,1,1,0,-1,12,5,-7,2,-6,0,-1,-1,-1,-1,-1,5,-1
KR_6631076165,420,0,-33,-23,4,0,0,0,2,1,3,2,0,2,2,2,4,-2,3,1,0,11,-20,-3,-2,5,2,0,-1,1,0,-1,1,6,-1
KR_6735324092,440,-7,-65,-23,-15,0,1,1,-9,11,2,3,1,4,-4,5,1,-5,7,2,0,-6,-4,-2,-4,6,0,0,0,1,0,-1,-1,6,-1
KR_6746399579,420,5,18,4,13,0,2,2,2,2,4,4,3,7,3,1,4,4,0,4,0,13,-3,-1,-3,4,4,0,0,1,1,-1,1,4,-1
KR_6640052577,420,-5,-48,-34,-17,-8,9,1,2,4,6,0,2,2,-2,2,0,-9,10,1,-1,-12,47,-3,-2,5,-10,0,-2,-1,1,-1,-1,2,-1
KR_6706844854,420,1,-76,-20,-2,1,2,3,1,2,3,-2,3,1,-1,3,2,-1,1,0,0,2,-5,-1,-2,3,0,0,0,0,-1,0,-1,0,-1
KR_6734651812,420,-5,-12,-40,-12,-3,4,1,-9,9,0,-3,5,2,2,3,5,1,0,1,1,-1,2,-2,-1,3,4,0,-1,-1,-1,-1,1,2,-1
KR_6570919585,420,2,51,-20,6,0,1,1,0,2,2,2,3,5,-1,3,2,5,0,5,0,3,4,-3,-4,7,2,0,0,-1,-1,0,1,6,-1
KR_6758369245,420,-3,-56,-20,-9,-2,2,0,-1,5,4,-5,5,0,-2,6,4,1,2,3,0,-9,-61,1,-5,4,0,0,0,-1,-1,-1,1,1,-1
KR_6726742393,420,-2,20,-12,-8,-2,2,0,1,2,3,-3,5,2,-4,5,1,0,1,1,2,-6,-9,3,-4,1,-3,0,0,1,-1,-1,1,5,-1
KR_6693670484,420,2,17,4,2,-1,2,1,-1,3,2,1,1,2,3,0,3,0,0,0,0,3,-1,0,-4,4,-2,0,1,1,0,1,-1,5,-1
KR_6668265008,420,-8,-36,-96,-17,-3,3,0,-4,4,0,-1,3,2,-1,4,3,-8,8,0,0,-26,-5,-4,0,4,-2,0,-3,-1,-1,-1,1,3,-1
KR_6661482700,420,1,20,-13,2,-2,2,0,3,1,4,1,1,2,-1,2,1,1,0,1,0,5,-18,-2,-2,4,4,0,-1,1,-1,-1,1,6,-1
KR_6569027493,420,1,-12,11,6,-1,2,1,5,0,5,2,0,2,1,0,1,-1,1,0,0,9,18,3,-8,5,-1,0,1,1,-1,1,1,1,-1
KR_6623003747,420,-2,-29,-8,-17,-1,1,0,-4,5,1,-3,3,0,-8,9,1,-1,1,0,0,-13,17,-1,-5,6,0,0,0,-1,-1,-1,-1,1,-1
KR_6709942852,420,1,-10,16,-1,0,2,2,-2,3,1,4,2,6,-2,3,1,-1,1,0,0,-2,-21,-1,-2,3,-2,0,0,0,-1,0,-1,0,-1
KR_6760604977,420,-3,37,-9,-8,-2,3,1,-1,4,3,-6,7,1,1,5,6,0,2,2,0,-2,1,0,-4,4,-3,0,0,0,-1,-1,1,0,-1
KR_6674814572,420,2,33,8,-4,0,1,1,-1,3,2,-1,4,3,-1,2,1,-1,4,3,0,4,6,4,-5,1,-2,0,-1,-1,-1,-1,-1,1,-1
KR_6717632655,420,3,39,12,0,2,0,2,-5,6,1,2,5,7,-1,5,4,2,0,2,0,5,-262,-2,-1,3,-1,0,0,-1,-1,-1,1,4,-1
KR_6638280361,420,-1,-19,-15,-2,2,0,2,-5,8,3,3,3,6,-2,5,3,0,2,2,1,3,-42,1,-5,4,11,0,-1,1,-1,-1,1,2,-1
KR_6636181063,420,-1,-27,28,-5,3,0,3,-1,1,0,-2,3,1,0,1,1,-5,5,0,0,-1,16,1,-2,1,2,0,0,1,0,0,-1,5,-1
KR_6625055449,420,-1,16,-8,-8,0,2,2,-2,4,2,-3,3,0,-2,6,4,-1,3,2,-1,-10,32,-3,-1,4,-19,0,-2,-1,-1,-1,-1,5,-1
KR_6509076554,420,-4,-19,-52,-6,2,0,2,-1,2,1,-4,4,0,-2,3,1,-1,1,0,0,-7,-8,2,-4,2,-4,0,-1,-1,-1,-1,-1,2,-1
KR_5953259693,420,-5,-25,-20,-8,-4,4,0,-2,3,1,2,1,3,-3,3,0,-1,2,1,0,-11,-9,-4,-2,6,1,0,-1,-1,0,-1,-1,5,-1
KR_6679100387,420,1,64,-12,-2,-1,2,1,2,3,5,0,1,1,-3,5,2,0,0,0,0,8,-7,-3,-1,4,2,0,0,-1,0,0,1,4,-1
KR_6711708247,420,1,13,17,0,6,1,7,0,3,3,1,0,1,-7,7,0,0,0,0,1,-8,267,-1,-2,3,3,0,2,-1,1,1,1,6,-1
KR_6728852254,420,-1,-48,-12,-7,-1,2,1,5,3,8,0,2,2,-2,3,1,-9,9,0,0,-4,-21,1,-2,1,1,0,0,-1,-1,-1,1,5,-1
KR_6755928456,420,0,-1,-40,-5,-3,3,0,-1,4,3,-1,1,0,0,3,3,0,2,2,-1,-1,-4,-3,-3,6,3,0,0,-1,-1,1,-1,2,-1
KR_6754829185,420,1,-22,1,3,2,0,2,-1,4,3,4,1,5,-2,6,4,0,2,2,0,1,-3,1,-6,5,5,0,-1,-1,1,-1,1,6,-1
KR_6664843024,420,-4,-58,20,-10,-2,2,0,0,2,2,-2,3,1,-4,7,3,-2,2,0,0,-9,230,-3,-1,4,-2,0,0,-1,0,0,-1,1,-1
KR_6756230741,420,-1,-13,-2,-4,-1,3,2,-3,4,1,2,1,3,-2,4,2,0,0,0,0,-7,-37,1,-5,4,1,0,-1,-1,0,-1,1,2,-1
KR_6719644867,420,-3,-24,-17,-6,-4,4,0,0,3,3,-3,3,0,0,1,1,1,0,1,0,-5,-100,-2,-3,5,2,0,-1,-1,-1,-1,-1,5,-1
KR_6729631405,420,-5,-97,-24,-11,-3,4,1,3,2,5,0,0,0,-7,7,0,-4,4,0,0,-8,-10,-7,0,7,2,0,-3,-1,-1,-1,-1,1,-1
KR_6763010446,420,0,24,-28,-2,3,2,5,0,1,1,-1,2,1,-3,5,2,-1,1,0,0,0,-4,1,-1,0,-1,0,0,-1,-1,0,1,6,-1
KR_6711554791,420,-4,3,-16,-6,-2,2,0,-1,1,0,-2,2,0,0,3,3,-1,1,0,0,-4,8,-8,0,8,1,0,0,-1,-1,-1,-1,3,-1
KR_6613648031,420,-3,-17,-26,-4,0,1,1,-4,5,1,0,1,1,0,0,0,0,0,0,0,-7,-7,-1,-3,4,5,0,0,0,-1,0,-1,0,-1
KR_6496542765,420,-2,-5,-19,1,-2,2,0,1,1,2,-4,4,0,4,1,5,2,0,2,1,6,1,-1,-3,4,1,0,0,-1,-1,-1,1,6,-1
KR_6743026747,420,-4,-78,12,-5,-6,7,1,2,4,6,-1,5,4,0,4,4,0,0,0,-2,-2,287,-1,-4,5,1,0,-2,0,-1,-1,-1,0,-1
KR_6749291550,420,1,17,8,5,-1,2,1,3,2,5,2,0,2,1,1,2,0,0,0,1,8,26,2,-4,2,-3,0,1,1,0,1,1,6,-1
KR_6754022323,420,-1,43,24,2,4,0,4,-3,5,2,0,2,2,1,2,3,0,2,2,1,-3,1,-4,-2,6,-1,0,0,1,-1,0,1,5,-1
KR_6724693144,440,0,23,-12,-5,1,1,2,1,1,2,3,0,3,-3,3,0,-7,7,0,0,-2,0,2,-3,1,-1,0,-1,0,0,-1,-1,0,-1
KR_6709197987,440,2,-44,8,7,-2,2,0,-1,3,2,1,1,2,5,0,5,4,0,4,0,7,16,3,-6,3,2,0,1,1,-1,1,-1,1,-1
KR_6722664431,420,-4,-3,-19,-12,0,1,1,-5,5,0,-7,7,0,2,0,2,-2,2,0,0,-8,4,3,-4,1,1,0,-1,-1,-1,-1,-1,5,-1
KR_6612677347,420,4,131,-36,0,5,0,5,-1,3,2,-1,2,1,-2,4,2,-1,1,0,0,-5,-28,-4,0,4,3,0,1,-1,-1,1,-1,6,-1
KR_6758428659,420,1,-12,23,1,1,1,2,-3,4,1,-2,4,2,2,2,4,3,1,4,0,1,9,-1,-1,2,-2,0,2,1,1,1,-1,3,-1
KR_6097205876,420,-4,-5,-16,-3,-2,4,2,-1,6,5,-5,8,3,6,1,7,-1,1,0,0,0,19,-4,-4,8,-2,0,-1,-1,1,-1,1,4,-1
KR_6607463982,420,0,71,17,-8,1,3,4,-3,8,5,0,0,0,-6,6,0,0,1,1,0,-14,-2,1,-6,5,3,0,0,-1,-1,0,-1,2,-1
KR_6752330531,440,-2,-53,0,0,3,1,4,-7,7,0,-2,2,0,2,1,3,4,1,5,0,-3,-1,0,-5,5,1,0,0,-1,1,0,1,4,-1
KR_6757907904,420,1,-16,4,-2,1,1,2,-1,6,5,4,1,5,-3,3,0,-3,3,0,0,-4,-22,-4,0,4,4,0,0,1,-1,0,-1,5,-1
KR_6755024296,420,-2,-15,-24,-6,-2,3,1,1,5,6,-4,4,0,1,0,1,-2,2,0,0,-1,-6,-3,-1,4,-2,0,0,-1,0,0,-1,6,-1
KR_6645962312,420,-1,-18,27,1,-3,3,0,2,1,3,-1,2,1,3,2,5,0,1,1,0,1,104,2,-6,4,5,0,-1,1,-1,-1,1,6,-1
KR_6592932301,420,0,18,-4,3,-1,3,2,-3,3,0,4,0,4,0,2,2,3,1,4,0,3,-2,-2,0,2,-2,0,1,-1,1,1,-1,6,-1
KR_6652273417,440,-2,-18,-4,-8,-4,4,0,0,0,0,0,1,1,-5,8,3,1,1,2,0,-5,7,-6,-2,8,-2,0,0,1,0,0,-1,4,-1
KR_6660927643,420,0,-3,35,-4,1,1,2,-1,3,2,0,3,3,-2,4,2,-2,2,0,0,-2,-9,-3,0,3,-1,0,-1,-1,1,-1,1,6,-1
KR_6746663895,420,-1,-104,98,-10,-3,3,0,-1,2,1,-2,3,1,-5,6,1,1,0,1,0,-13,18,-6,0,6,0,0,-2,1,-1,-1,1,2,-1
KR_6716360170,420,0,-13,-10,1,0,1,1,-4,5,1,3,0,3,2,0,2,0,0,0,0,4,19,-4,-2,6,3,0,0,-1,-1,0,1,4,-1
KR_6754376203,420,0,-23,-8,-6,0,3,3,0,2,2,-3,3,0,0,4,4,-3,4,1,-1,-8,9,0,-4,4,-6,0,-1,0,-1,-1,-1,0,-1
KR_6753321126,420,1,-8,18,-6,1,1,2,-3,6,3,-5,6,1,0,2,2,1,0,1,1,-3,279,-2,-5,7,27,0,1,-1,1,1,1,6,-1
KR_6661668771,440,-4,-12,-9,-17,-3,3,0,0,1,1,-8,8,0,-2,5,3,-4,5,1,-1,-7,9,0,-1,1,-3,0,-1,0,0,-1,-1,0,-1
KR_6727983139,420,-1,-85,-21,-1,1,0,1,-2,3,1,-4,4,0,2,1,3,2,1,3,0,3,0,-2,-2,4,1,0,0,-1,1,-1,-1,5,-1
KR_6714070522,420,-8,-99,-38,-14,-3,3,0,-1,3,2,-4,4,0,-3,7,4,-3,3,0,0,-7,-430,1,-2,1,0,0,0,-1,1,0,1,1,-1
KR_6568232930,420,1,-17,20,-2,6,0,6,2,1,3,-6,6,0,-5,7,2,1,1,2,1,-3,125,-2,0,2,-1,0,1,-1,1,1,1,6,-1
KR_6674061788,420,-3,-46,-8,1,-3,4,1,0,2,2,0,1,1,3,0,3,1,0,1,0,5,0,1,-3,2,-1,0,-1,1,-1,-1,1,5,-1
KR_6692716295,420,-2,-91,4,-2,-2,2,0,-2,3,1,-3,4,1,1,3,4,4,0,4,0,1,25,2,-7,5,2,0,0,0,-1,-1,-1,0,-1
KR_6740832069,420,1,-34,-20,2,0,1,1,0,3,3,1,3,4,-1,2,1,2,2,4,0,-1,-16,-1,-1,2,1,0,-1,-1,-1,-1,-1,4,-1
KR_6743479576,440,0,-56,-3,4,-3,3,0,3,2,5,1,0,1,1,2,3,2,0,2,1,10,-4,-1,-4,5,-2,0,-1,-1,-1,-1,1,4,-1
KR_6651875198,420,-3,65,-20,-6,8,1,9,-8,9,1,2,1,3,-9,9,0,1,1,2,0,-19,-6,-1,-1,2,-3,0,0,0,0,1,1,0,-1
KR_6625032255,420,0,8,24,-4,-1,4,3,-3,3,0,2,0,2,-1,2,1,-1,1,0,0,-8,1,-4,-2,6,2,0,-1,-1,-1,-1,-1,5,-1
KR_6349982442,420,-6,-43,-28,-5,0,2,2,1,4,5,1,2,3,-6,7,1,-1,1,0,1,-3,-1,0,-6,6,4,0,-2,-1,0,-1,1,4,-1
KR_6361617439,420,1,-35,59,-2,0,3,3,0,4,4,-4,5,1,2,0,2,0,2,2,0,-2,0,0,0,0,-4,0,-1,1,-1,-1,-1,1,-1
KR_6737939508,440,-1,-81,-2,-3,0,0,0,-6,6,0,2,1,3,2,0,2,-1,1,0,0,-2,8,5,-8,3,0,0,-1,-1,1,-1,-1,2,-1
KR_6756555696,420,-1,57,-13,2,-1,2,1,2,2,4,-1,1,0,3,1,4,-1,1,0,0,6,349,3,-6,3,5,0,0,1,-1,0,-1,2,-1
KR_6624443232,420,-4,-22,-16,-4,-1,1,0,-1,3,2,-1,3,2,-1,3,2,0,1,1,0,2,-6,1,-2,1,5,0,0,1,-1,0,1,2,-1
KR_6668835051,420,-4,-35,-8,-11,0,3,3,-7,7,0,-1,4,3,-3,3,0,0,0,0,0,-14,-3,-3,-2,5,1,0,0,1,-1,-1,-1,2,-1
KR_6578611502,420,-2,-136,25,-5,1,0,1,-4,7,3,-1,1,0,0,5,5,-1,2,1,0,-6,-19,-5,-2,7,0,0,-2,0,1,-1,-1,0,-1
KR_6617405224,420,-3,72,-10,-5,-2,3,1,2,0,2,-1,2,1,-4,5,1,0,2,2,0,0,-20,1,-7,6,4,0,-1,-1,-1,-1,-1,5,-1
KR_6644484324,420,0,-74,16,1,0,2,2,2,1,3,-1,3,2,-2,2,0,2,0,2,0,7,2,-5,0,5,-1,0,0,1,0,0,-1,4,-1
KR_6712616671,420,-2,-51,25,-4,2,0,2,0,4,4,-1,1,0,-3,3,0,-2,5,3,0,-12,110,3,-7,4,-5,0,0,1,-1,0,1,6,-1
KR_6651841483,440,-4,23,-20,-7,-2,2,0,-4,5,1,1,0,1,0,0,0,-2,2,0,-1,-12,-12,0,-2,2,-1,0,1,-1,-1,1,-1,4,-1
KR_6758351667,420,-1,-3,16,3,3,0,3,2,1,3,-2,4,2,-1,4,3,1,0,1,0,8,-238,-3,-4,7,6,0,0,0,1,0,-1,0,-1
KR_6756312745,420,-6,-83,-45,-14,-8,8,0,-2,3,1,-2,2,0,-1,1,0,-1,1,0,0,-9,5,0,-2,2,0,0,-2,1,0,-1,-1,5,-1
KR_6764519873,420,3,-25,-10,8,0,1,1,-2,3,1,6,4,10,3,1,4,1,0,1,0,9,40,1,-5,4,-23,0,0,-1,1,-1,1,5,-1
KR_6704116104,420,-1,-45,0,-6,0,0,0,-2,3,1,-3,5,2,-1,2,1,0,1,1,0,-6,0,-1,-1,2,1,0,-2,-1,-1,-1,-1,3,-1
KR_6704371399,420,0,100,-100,6,0,1,1,-3,4,1,8,2,10,0,4,4,1,0,1,-1,3,2,2,-5,3,0,0,1,0,0,1,-1,0,-1
KR_6660034111,420,2,34,-13,12,3,0,3,0,2,2,-1,1,0,9,2,11,1,0,1,0,13,36,6,-8,2,0,0,1,0,1,-1,1,0,-1
KR_6545374379,420,3,52,29,1,1,0,1,1,0,1,-1,4,3,0,1,1,0,0,0,0,1,14,4,-4,0,2,0,1,0,0,1,-1,0,-1
KR_6698383993,420,-2,18,-20,-3,-1,3,2,1,0,1,-3,5,2,4,1,5,-4,4,0,0,-5,-2,0,-2,2,2,0,-1,-1,-1,-1,1,3,-1
KR_6758207153,420,1,-71,24,6,1,2,3,3,2,5,0,2,2,-1,1,0,3,0,3,1,9,8,4,-5,1,-3,0,-1,1,1,-1,1,6,-1
KR_6756563016,420,-7,-153,2,-17,-8,8,0,-2,3,1,-2,3,1,-3,4,1,-2,2,0,0,-14,-23,-2,-3,5,1,0,-3,1,1,-1,-1,6,-1
KR_6729134190,420,-3,-111,20,-2,0,0,0,1,3,4,0,1,1,0,3,3,-3,3,0,0,-2,-6,-2,-1,3,-4,0,-1,0,-1,-1,-1,0,-1
KR_6759340834,420,-1,-55,28,-5,-7,7,0,2,1,3,1,2,3,-2,3,1,1,2,3,0,1,-8,-7,0,7,-3,0,-2,1,-1,-1,-1,3,-1
KR_6726006096,420,-4,-14,-17,-3,-2,4,2,-4,5,1,-1,1,0,3,2,5,1,1,2,0,-2,-38,-4,-1,5,4,0,-1,-1,-1,-1,-1,6,-1
KR_6542934634,420,-4,-70,-3,-5,-6,6,0,2,0,2,-3,3,0,0,0,0,2,0,2,-1,-3,0,3,-3,0,0,0,0,-1,1,1,-1,6,-1
KR_6719122385,440,-2,-92,-48,0,-1,3,2,0,0,0,8,1,9,-2,5,3,-5,5,0,0,7,11,-1,-1,2,-5,0,-2,-1,-1,-1,1,6,-1
KR_6599425396,420,0,-61,20,2,-1,2,1,-1,2,1,5,3,8,-1,2,1,0,0,0,0,5,11,0,-5,5,2,0,-1,1,1,-1,-1,1,-1
KR_6680306810,420,-3,-75,4,-10,-9,9,0,-2,3,1,-2,4,2,-1,2,1,4,0,4,0,0,48,-1,-1,2,-29,0,-1,-1,0,-1,-1,1,-1
KR_6749479351,420,-5,-119,-21,-14,-5,7,2,2,1,3,-2,3,1,-8,8,0,-1,3,2,0,-8,-1,0,-1,1,1,0,-1,1,-1,-1,-1,3,-1
KR_6577339465,440,-2,-28,-44,-2,0,3,3,-1,2,1,-4,5,1,3,0,3,0,0,0,0,-7,-28,2,-3,1,-2,0,0,-1,1,0,-1,2,-1
KR_6567751764,420,-1,2,-6,-2,0,0,0,1,4,5,3,1,4,-3,5,2,-3,3,0,0,-2,9,-1,-3,4,2,0,0,-1,-1,0,-1,4,-1
KR_6746879262,420,-4,-35,36,-11,-1,2,1,-3,3,0,-5,5,0,-3,9,6,1,0,1,0,-14,5,-4,-3,7,-2,0,0,1,0,-1,1,6,-1
KR_6644048422,440,-1,-62,0,-4,0,1,1,-2,7,5,4,0,4,-6,7,1,0,1,1,1,-7,-50,-7,-1,8,36,0,-2,1,-1,-1,1,2,-1
KR_6711695762,440,-4,-17,-3,-8,-2,2,0,-3,4,1,-1,2,1,1,1,2,-3,3,0,0,-6,-16,0,-3,3,9,0,0,-1,-1,0,-1,5,-1
KR_6622536957,420,-1,13,-22,-4,2,0,2,0,3,3,1,1,2,-3,3,0,-4,5,1,-1,-3,0,-3,0,3,1,0,1,-1,-1,1,-1,4,-1
KR_6518629864,420,-2,-68,20,-6,2,1,3,-3,3,0,-4,5,1,2,2,4,-3,3,0,-1,-6,1,0,-4,4,0,0,-2,1,1,-1,-1,5,-1
KR_6736528470,420,-1,25,23,-1,4,0,4,-1,4,3,0,1,1,-1,3,2,-3,4,1,0,-8,9,2,-4,2,3,0,-1,-1,1,-1,1,2,-1
KR_6605120867,420,-3,-58,36,-1,-1,3,2,-1,2,1,1,0,1,-2,3,1,2,0,2,0,0,19,4,-9,5,-21,0,0,0,0,0,-1,0,-1
KR_6760474035,420,-1,30,-44,9,-3,4,1,-5,5,0,2,1,3,9,0,9,6,0,6,0,14,114,-1,-3,4,-1,0,2,1,0,1,-1,4,-1
KR_6735245790,420,-1,-45,-12,1,1,2,3,-3,7,4,3,1,4,0,1,1,0,2,2,0,3,-5,1,-5,4,5,0,1,1,-1,1,1,3,-1
KR_6759301220,440,-1,-101,11,-1,-3,4,1,3,1,4,2,2,4,0,9,9,-3,3,0,0,2,-8,2,-5,3,-3,0,0,-1,0,-1,-1,6,-1
KR_6672182069,420,0,-39,12,-3,-2,3,1,-2,3,1,0,3,3,0,7,7,1,1,2,0,-6,-3,2,-6,4,2,0,1,0,-1,1,-1,0,-1
KR_6656652327,420,-8,-114,-39,-16,-6,8,2,3,4,7,-4,6,2,-5,5,0,-4,5,1,1,-11,301,-2,-2,4,0,0,-2,-1,-1,-1,1,1,-1
KR_6599248796,440,-3,-89,4,-4,3,0,3,1,2,3,-4,4,0,-1,3,2,-3,4,1,0,0,161,-1,0,1,0,0,-1,-1,1,-1,-1,6,-1
KR_6650438017,420,-2,-15,-5,-1,0,1,1,-1,2,1,-2,4,2,2,1,3,0,1,1,1,-1,-3,-2,-4,6,4,0,0,1,-1,0,1,6,-1
KR_6724443697,440,-2,0,-24,-8,-3,5,2,-3,4,1,-1,4,3,-1,4,3,0,0,0,-2,-19,-9,5,-7,2,-3,0,0,-1,-1,-1,-1,2,-1
KR_6672240593,420,0,22,-7,3,1,1,2,-1,3,2,3,0,3,0,3,3,0,2,2,0,10,25,-4,0,4,0,0,-1,-1,-1,-1,1,5,-1
KR_6739462657,420,-3,-62,-36,-8,-1,4,3,1,2,3,-4,6,2,-4,7,3,0,1,1,-1,-9,-4,-1,-4,5,2,0,-1,-1,-1,-1,-1,5,-1
KR_6570222899,420,-2,-94,14,-2,-1,4,3,-1,5,4,4,1,5,-2,3,1,-2,3,1,0,1,-1,1,-3,2,-1,0,0,-1,1,0,1,5,-1
KR_6730491447,420,-5,-53,-72,-6,-2,4,2,-5,5,0,4,1,5,-1,1,0,-2,2,0,0,-9,-2,-1,-2,3,0,0,-1,-1,1,-1,1,5,-1
KR_6639856123,420,-6,-102,8,-16,-5,5,0,4,2,6,-2,4,2,-6,6,0,-7,7,0,0,-13,-14,-4,-5,9,1,0,-3,-1,-1,-1,1,5,-1
KR_6763487658,440,-3,-42,1,-4,1,2,3,-1,1,0,-4,4,0,1,1,2,-1,1,0,0,-11,25,-4,-3,7,2,0,0,-1,0,0,1,1,-1
KR_6682169799,420,3,22,-9,0,4,1,5,-3,5,2,-4,5,1,1,4,5,2,0,2,0,-2,1,-1,-3,4,4,0,1,0,1,1,-1,0,-1
KR_6714819845,420,0,10,-5,-7,0,0,0,-3,5,2,1,1,2,0,4,4,-5,6,1,0,-13,2,3,-3,0,-1,0,0,1,1,-1,-1,1,-1
KR_6685114351,420,-2,-39,-4,-6,-2,2,0,-5,6,1,5,2,7,-3,3,0,-1,1,0,0,-8,3,-4,0,4,20,0,-1,-1,-1,-1,-1,3,-1
KR_6653859853,420,-2,-31,-28,-4,-4,6,2,-1,3,2,0,0,0,3,1,4,-2,3,1,0,-4,0,-1,-2,3,2,0,0,-1,-1,-1,-1,6,-1
KR_6757393898,420,-1,-57,4,-5,2,0,2,-1,2,1,1,1,2,2,3,5,-9,10,1,0,-9,-180,-2,0,2,1,0,-1,-1,0,-1,-1,4,-1
KR_6523697483,420,-1,13,-8,-1,-2,4,2,2,4,6,-1,2,1,1,3,4,-1,1,0,0,-6,-3,1,-7,6,2,0,0,-1,-1,-1,-1,3,-1
KR_6621828467,420,-2,-8,-4,-7,-3,3,0,1,1,2,3,3,6,-7,9,2,-1,1,0,-2,-5,5,2,-6,4,-2,0,1,-1,1,1,-1,6,-1
KR_6741432233,440,-3,-32,-8,-6,-2,2,0,2,1,3,-3,4,1,-3,4,1,0,1,1,0,3,1,0,-6,6,-2,0,-1,0,-1,-1,-1,0,-1
KR_6751046316,420,3,111,5,6,1,1,2,3,1,4,0,3,3,4,1,5,-2,2,0,1,3,1,0,-2,2,0,0,2,0,1,1,1,0,-1
KR_6674176099,420,-2,-52,-29,-5,0,3,3,0,3,3,2,3,5,-4,4,0,-3,3,0,0,-5,-418,-1,-4,5,2,0,1,1,-1,-1,-1,4,-1
KR_6616642398,420,2,48,-24,2,0,2,2,-2,3,1,7,0,7,1,2,3,-4,4,0,0,-8,-1,-2,-1,3,2,0,0,-1,1,1,1,4,-1
KR_6570509734,420,0,11,3,-3,0,1,1,-3,4,1,-2,6,4,1,1,2,1,0,1,0,-1,16,3,-6,3,-2,0,1,-1,1,1,1,4,-1
KR_6655449478,420,-2,-57,0,-3,-1,2,1,-6,6,0,-6,6,0,9,0,9,1,1,2,0,3,-10,-1,-4,5,-1,0,0,-1,-1,-1,-1,2,-1
KR_6657364739,420,-4,-42,-32,-6,4,0,4,-3,3,0,-5,6,1,0,2,2,-2,3,1,0,0,1,0,-4,4,1,0,0,1,-1,-1,-1,6,-1
KR_6724783059,420,-2,-40,4,-7,-3,4,1,-1,6,5,0,1,1,-1,3,2,-2,2,0,0,-5,2,0,-2,2,-1,0,-1,-1,-1,-1,-1,2,-1
KR_6748273463,440,-5,-74,0,-11,-1,4,3,-18,19,1,1,1,2,8,2,10,-1,1,0,0,-3,4,-4,-3,7,2,0,-1,0,0,-1,-1,0,-1
KR_6754255083,420,1,27,21,4,-5,5,0,-2,3,1,6,0,6,4,4,8,1,1,2,0,8,8,1,-5,4,1,0,2,1,1,1,1,4,-1
KR_6695924287,420,1,28,4,7,-2,3,1,1,3,4,3,2,5,1,0,1,4,0,4,0,4,5,1,-3,2,0,0,0,1,1,1,1,5,-1
KR_6709417072,420,1,41,-5,-5,4,1,5,-2,2,0,-2,3,1,-5,5,0,0,0,0,0,-6,10,7,-7,0,-1,0,1,1,1,1,-1,6,-1
KR_6741050297,420,0,-21,-11,-3,0,2,2,1,2,3,-1,5,4,-3,5,2,0,1,1,1,9,-6,-3,-1,4,5,0,-1,1,-1,-1,1,1,-1
KR_6274376813,420,-1,-32,-4,-2,-3,4,1,0,1,1,4,3,7,-3,5,2,0,2,2,0,-5,1,1,-3,2,-1,0,1,1,-1,-1,1,4,-1
KR_6761210522,420,-1,-4,40,-12,-6,9,3,5,0,5,-6,7,1,-5,6,1,0,1,1,1,-9,-5,-2,-3,5,-6,0,1,1,1,1,1,5,-1
KR_6348115101,440,-1,57,-16,4,1,2,3,2,3,5,-1,2,1,1,0,1,1,0,1,1,9,3,1,-4,3,0,0,0,1,-1,0,1,3,-1
KR_6761681509,420,-2,-42,-32,3,2,0,2,4,0,4,-1,1,0,-2,2,0,0,2,2,0,-1,-233,4,-5,1,-1,0,-1,1,-1,-1,1,2,-1
KR_6738105522,440,-1,17,1,-12,-4,4,0,-7,8,1,-1,4,3,0,3,3,0,0,0,-2,-9,7,-5,-3,8,-6,0,1,1,-1,-1,-1,1,-1
KR_6670862412,420,-3,10,-28,-1,2,1,3,-2,3,1,-1,1,0,1,0,1,-1,3,2,0,-3,7,3,-4,1,-3,0,0,1,-1,0,-1,4,-1
KR_6763220952,420,0,-56,16,-3,-1,4,3,6,2,8,0,0,0,-5,5,0,-3,4,1,-1,-3,-48,2,-3,1,1,0,-1,1,1,-1,-1,1,-1
KR_6750848397,440,-3,-43,8,-8,-5,5,0,8,2,10,-5,7,2,-5,5,0,-1,2,1,0,-3,-14,-6,0,6,3,0,-1,1,0,-1,1,5,-1
KR_6609304731,420,-8,-36,-27,-14,-1,2,1,-2,5,3,-8,9,1,-2,3,1,-1,1,0,0,-5,-3,0,-1,1,0,0,-3,-1,-1,-1,-1,3,-1
KR_6744281432,420,-1,-26,-20,1,-4,5,1,-3,3,0,0,1,1,1,3,4,7,1,8,0,7,55,-3,-2,5,-17,0,-1,-1,-1,1,-1,2,-1
KR_6672996097,420,-5,3,-47,-15,-3,5,2,-2,3,1,-9,10,1,0,1,1,-1,1,0,0,-9,5,1,-5,4,-4,0,-2,-1,-1,-1,-1,4,-1
KR_6671511395,420,-5,-69,-16,-6,3,0,3,-1,6,5,-1,2,1,-7,7,0,0,2,2,0,0,-16,-2,-3,5,-2,0,-1,1,1,-1,-1,4,-1
KR_6764217516,420,-1,-38,-8,4,1,3,4,0,4,4,5,2,7,-1,2,1,-1,3,2,0,1,1,1,-1,0,-1,0,0,-1,1,1,-1,5,-1
KR_6660813594,420,-4,-37,8,-8,1,1,2,-3,3,0,0,1,1,-7,10,3,1,0,1,0,-6,-29,-4,-1,5,24,0,0,-1,1,0,1,1,-1
KR_6750340929,420,1,47,5,-1,-2,3,1,4,1,5,3,1,4,-8,8,0,2,0,2,2,-2,5,2,-5,3,-1,0,0,-1,-1,-1,1,1,-1
KR_6618503436,420,1,31,1,1,4,0,4,-1,3,2,-1,3,2,0,2,2,-1,1,0,0,-2,2,-2,-5,7,0,0,0,-1,-1,0,-1,5,-1
KR_6544829113,440,-2,-15,-20,-10,0,3,3,1,3,4,-2,4,2,-6,6,0,-3,4,1,-1,-11,-12,-2,-2,4,1,0,-1,-1,-1,-1,-1,6,-1
KR_6764533669,420,-1,4,6,-4,-2,3,1,0,3,3,1,0,1,-2,2,0,-1,2,1,-1,-4,90,-5,0,5,-1,0,-1,1,-1,-1,-1,5,-1
KR_6721237023,420,-3,-168,-20,-2,-2,2,0,5,0,5,-4,4,0,-1,5,4,0,1,1,0,5,85,2,-3,1,-2,0,-2,0,-1,-1,-1,0,-1
KR_6667484316,440,-1,-21,-43,-5,-2,4,2,-1,2,1,-3,3,0,1,2,3,0,1,1,0,-1,7,6,-6,0,0,0,-1,0,-1,-1,-1,0,-1
KR_6725955475,420,-2,-25,8,-9,-1,4,3,-1,2,1,-7,7,0,3,3,6,-3,3,0,0,0,-5,4,-6,2,-1,0,0,0,-1,-1,-1,0,-1
KR_6761223600,420,-3,-21,24,-9,2,0,2,1,2,3,-7,7,0,-5,7,2,0,0,0,0,-6,0,-2,-1,3,1,0,0,-1,1,-1,-1,5,-1
KR_6508810470,420,1,17,20,-2,0,2,2,-2,2,0,-5,6,1,3,0,3,2,1,3,1,2,0,3,-3,0,0,0,-1,1,-1,-1,1,4,-1
KR_5751653804,440,-3,27,43,-1,-5,5,0,9,0,9,2,0,2,-5,5,0,-2,2,0,0,-5,1,0,-4,4,-3,0,0,1,1,0,-1,2,-1
KR_6606140511,420,-3,-75,-16,-8,-1,3,2,-3,5,2,-1,3,2,-3,3,0,0,3,3,0,-5,-296,3,-7,4,-2,0,-1,-1,-1,-1,-1,4,-1
KR_6612214277,420,-2,11,-25,-4,-2,2,0,-1,3,2,-1,1,0,1,1,2,-1,1,0,0,0,11,2,-6,4,-6,0,0,0,-1,0,-1,0,-1
KR_6704555130,420,0,-3,0,-2,0,3,3,2,1,3,0,2,2,-3,3,0,-1,2,1,0,-4,-4,0,-3,3,3,0,0,-1,1,0,-1,5,-1
KR_6761398757,420,0,-23,28,-1,-4,4,0,2,1,3,-1,4,3,3,1,4,-1,2,1,0,5,-4,3,-6,3,0,0,0,1,0,0,1,3,-1
KR_6746850637,420,-1,-49,-17,-3,-1,3,2,2,2,4,-5,6,1,0,2,2,1,1,2,0,-5,-5,1,-3,2,2,0,-1,0,-1,-1,-1,0,-1
KR_6606667228,420,5,36,12,6,-3,5,2,4,0,4,1,1,2,5,1,6,-1,1,0,0,11,3,-4,-1,5,0,0,1,1,1,-1,1,6,-1
KR_6664927500,420,0,-20,23,-3,3,2,5,2,4,6,-1,2,1,-7,8,1,0,3,3,0,-3,4,2,-8,6,-4,0,-1,-1,1,-1,-1,2,-1
KR_6697421646,440,0,-60,-9,-3,-4,4,0,-1,3,2,6,1,7,-5,8,3,1,2,3,-3,-20,-18,-2,-4,6,1,0,-1,0,-1,-1,-1,0,-1
KR_6746494721,420,-1,-2,-12,-2,1,1,2,-1,3,2,0,1,1,-1,2,1,-1,1,0,0,-1,-5,2,-2,0,-1,0,0,1,0,0,-1,3,-1
KR_6740154395,420,-1,33,-8,-11,-2,2,0,-5,8,3,-3,4,1,0,1,1,-1,1,0,-1,-11,29,-7,-2,9,-8,0,-1,1,-1,-1,-1,6,-1
KR_6763582358,420,-4,-31,8,-14,-16,16,0,-2,2,0,-1,3,2,2,0,2,3,0,3,-1,-5,2,-4,0,4,1,0,-3,1,0,-1,-1,4,-1
KR_6686871230,420,-1,-31,-1,-6,-2,5,3,1,0,1,-3,6,3,-2,3,1,0,0,0,0,-7,-2,1,-2,1,-4,0,0,-1,1,1,-1,3,-1
KR_6624876449,420,-5,-23,-23,-6,1,1,2,-3,8,5,2,3,5,-3,3,0,-3,3,0,1,-6,31,-1,-3,4,-9,0,-1,-1,-1,-1,1,1,-1
KR_6643126434,420,-4,14,-12,-1,-2,2,0,-3,8,5,4,1,5,-1,2,1,1,0,1,0,0,4,0,-4,4,5,0,0,1,-1,0,-1,5,-1
KR_6717675036,420,-3,-22,-32,-10,0,1,1,-4,7,3,-2,5,3,-2,4,2,-2,3,1,-1,-11,1,-1,0,1,0,0,0,0,-1,0,-1,0,-1
KR_6722721608,420,-4,-51,8,-4,3,4,7,-2,2,0,-3,3,0,-3,5,2,1,1,2,0,-7,-44,-1,-1,2,-2,0,-2,-1,1,-1,-1,2,-1
KR_6742028707,440,-1,-27,0,-6,1,2,3,0,2,2,4,0,4,-10,10,0,-1,1,0,-1,-3,0,5,-6,1,-3,0,-2,0,-1,-1,-1,0,-1
KR_6654170699,420,0,-39,19,-1,-1,1,0,-4,5,1,-2,2,0,4,2,6,2,0,2,2,4,-3,1,-5,4,-4,0,0,0,1,0,1,0,-1
KR_6746449403,420,-4,-67,-34,-7,-2,2,0,-7,7,0,4,1,5,-1,1,0,-1,1,0,0,-13,-9,-2,-1,3,0,0,-2,1,-1,-1,1,2,-1
KR_6612292903,420,1,0,5,2,1,1,2,-2,4,2,3,0,3,2,3,5,-2,2,0,0,-4,-37,3,-4,1,16,0,-1,-1,-1,-1,1,1,-1
KR_6611426139,420,-4,24,-4,-7,-2,2,0,-3,4,1,-3,5,2,2,0,2,-1,1,0,0,-8,-3,0,-4,4,1,0,-1,-1,-1,-1,-1,2,-1
KR_6667880536,420,1,42,27,-1,-8,9,1,0,0,0,3,1,4,4,1,5,0,0,0,1,3,-8,0,-1,1,0,0,0,-1,1,-1,1,2,-1
KR_6762663549,420,2,10,-4,3,2,2,4,-3,4,1,1,3,4,4,2,6,-1,2,1,1,1,9,-1,0,1,1,0,-1,1,-1,-1,-1,3,-1
KR_6764102647,420,-1,-29,2,-8,1,1,2,-3,6,3,-5,6,1,-3,5,2,2,0,2,1,-8,11,2,-5,3,-1,0,0,1,-1,1,1,5,-1
KR_6626377045,420,-1,-30,-1,-3,-1,3,2,-1,2,1,-3,4,1,-2,5,3,4,0,4,0,0,-2,2,-4,2,1,0,0,0,0,0,1,0,-1
KR_6734656484,420,1,72,12,0,2,1,3,-1,5,4,2,3,5,-2,4,2,-1,2,1,0,-10,3,-3,-1,4,-2,0,1,-1,1,1,1,1,-1
KR_6674655789,440,-3,-68,4,-1,-1,1,0,0,1,1,-2,2,0,1,0,1,1,1,2,0,0,-247,3,-5,2,2,0,0,-1,1,0,1,1,-1
KR_6741339252,420,1,-50,-12,-2,1,1,2,2,4,6,0,2,2,-5,5,0,0,1,1,0,-9,5,1,-5,4,1,0,-1,1,0,-1,1,1,-1
KR_6653327774,420,1,-38,8,6,-3,3,0,-1,2,1,6,0,6,1,1,2,3,0,3,0,4,-5,0,-4,4,-5,0,-1,1,1,1,1,1,-1
KR_6658020816,420,-3,-72,-44,-7,-1,2,1,-1,3,2,-4,5,1,-1,1,0,0,0,0,0,-8,1,-1,-4,5,-7,0,-1,-1,-1,-1,-1,6,-1
KR_6720679730,420,0,-17,8,3,4,2,6,-1,2,1,1,1,2,-1,4,3,0,2,2,0,0,6,5,-6,1,-2,0,1,-1,1,1,1,3,-1
KR_6674508564,440,-5,-69,-8,-10,-5,5,0,-3,7,4,0,1,1,-2,2,0,0,0,0,0,-13,-1,3,-6,3,-5,0,0,1,-1,0,-1,5,-1
KR_6726195428,420,-5,-72,4,-9,2,2,4,-5,7,2,-8,9,1,1,4,5,1,0,1,-1,-5,25,-2,-1,3,0,-1,-3,1,-1,-1,-1,6,-1
KR_6724843175,420,-2,-15,-16,-4,-3,4,1,3,3,6,-4,6,2,-1,3,2,1,1,2,0,2,-8,-5,0,5,7,0,0,-1,-1,0,1,3,-1
KR_6743493854,420,-1,-51,10,4,-3,3,0,2,2,4,-1,2,1,5,3,8,1,0,1,0,13,6,0,-2,2,-1,0,1,-1,1,1,-1,1,-1
KR_6683465703,440,-4,-68,-16,-11,-3,3,0,-5,9,4,3,3,6,-5,6,1,-1,2,1,-1,-19,-286,-1,-1,2,-4,0,-2,1,-1,-1,-1,4,-1
KR_6612840944,420,-1,-69,-16,0,2,0,2,-1,1,0,1,2,3,-1,4,3,-1,2,1,0,5,-21,0,-1,1,-1,0,1,-1,1,1,-1,5,-1
KR_6739632450,420,-2,19,5,-4,4,0,4,-4,9,5,-7,7,0,4,1,5,-1,2,1,1,-5,-19,0,-2,2,1,0,-1,-1,-1,-1,1,5,-1
KR_6757781025,420,-2,-87,0,-10,1,1,2,-1,3,2,-6,7,1,-3,4,1,-1,4,3,0,-10,-2,-1,-1,2,2,0,0,0,1,0,-1,0,-1
KR_6741759832,420,-2,-63,6,-7,-2,2,0,-2,3,1,1,3,4,-1,1,0,-3,3,0,0,-7,-3,-2,-2,4,0,0,-1,-1,0,-1,-1,5,-1
KR_6322124977,420,-8,-117,-5,-16,-3,3,0,-1,2,1,-7,7,0,-1,2,1,-4,4,0,0,-13,-11,-4,0,4,-2,-1,-7,-1,0,-1,-1,4,-1
KR_6649576686,440,-5,-17,-26,-8,-1,1,0,-3,4,1,-2,2,0,-2,2,0,0,0,0,0,-10,-1,3,-4,1,1,0,-2,-1,-1,-1,-1,1,-1
KR_6615230789,420,2,38,7,-1,0,1,1,-2,4,2,0,0,0,0,3,3,1,0,1,0,-3,3,-2,-3,5,-14,0,0,-1,-1,0,-1,2,-1
KR_6756181263,420,2,21,-11,-2,2,2,4,-6,6,0,4,1,5,-1,2,1,-1,2,1,0,-1,12,-2,-5,7,-2,0,-1,0,-1,-1,-1,0,-1
KR_6752223470,420,-5,-79,-12,-10,-2,2,0,-6,6,0,1,3,4,-2,4,2,-1,1,0,0,-9,-1,-1,-2,3,-7,0,0,0,1,0,-1,0,-1
KR_6710081593,420,-4,-54,-16,-6,-4,4,0,3,1,4,-4,10,6,-3,4,1,2,0,2,0,-1,-2,-1,-3,4,-3,0,0,1,0,0,-1,6,-1
KR_6743049694,420,2,-13,4,5,-1,2,1,4,0,4,4,0,4,-4,6,2,2,0,2,0,6,-2,-1,-1,2,0,0,-1,-1,-1,-1,1,2,-1
KR_6669020626,420,0,4,-8,2,-1,1,0,2,2,4,1,2,3,-1,3,2,1,0,1,0,5,-125,2,-7,5,-1,0,0,1,-1,0,1,2,-1
KR_6508089603,420,-2,87,-111,-7,1,1,2,-6,8,2,0,2,2,0,3,3,-2,2,0,1,-9,-13,-1,-1,2,-1,0,1,-1,0,1,1,3,-1
KR_6711493069,440,-3,-37,-4,-3,-6,8,2,-2,5,3,3,0,3,2,1,3,0,2,2,-1,-4,-5,-2,-2,4,-3,0,0,1,-1,-1,-1,5,-1
KR_6592378655,420,0,-19,0,2,2,0,2,-2,3,1,-1,3,2,0,2,2,3,0,3,0,0,-139,-3,-4,7,-2,0,0,1,-1,0,1,1,-1
KR_6512079472,420,2,1,2,2,4,1,5,-1,2,1,-3,3,0,0,2,2,2,1,3,0,-4,248,-3,-4,7,-7,0,1,-1,1,1,1,5,-1
KR_6741077377,420,-8,-71,-60,-7,1,1,2,-3,3,0,-1,3,2,-4,5,1,0,2,2,-1,-8,-285,1,-2,1,-1,0,0,0,0,0,-1,0,-1
KR_6758987179,420,-5,-10,-22,-15,-2,5,3,-2,3,1,0,4,4,-3,4,1,-8,8,0,0,-13,-1,-2,-3,5,0,0,0,-1,-1,-1,-1,6,-1
KR_6670599946,420,-4,-84,-14,-3,-3,3,0,2,4,6,-2,3,1,0,0,0,0,0,0,0,-2,-286,1,-4,3,-4,0,-2,-1,-1,-1,1,3,-1
KR_6648846767,440,-1,-18,-41,-4,0,2,2,-1,4,3,-5,8,3,1,1,2,1,1,2,0,0,-54,5,-6,1,0,0,0,-1,-1,-1,1,4,-1
KR_6662419778,420,-1,-28,-17,-5,-2,3,1,0,4,4,4,0,4,-3,8,5,-4,5,1,0,-3,-3,-1,-1,2,2,0,0,1,0,-1,1,2,-1
KR_6705064354,420,-1,-17,0,-8,-3,3,0,-3,5,2,-1,1,0,0,1,1,-1,2,1,0,-5,0,-7,-1,8,-2,0,0,1,-1,0,-1,5,-1
KR_6754797279,420,-1,-52,-8,0,1,1,2,2,0,2,3,0,3,-5,7,2,-1,3,2,0,3,103,4,-6,2,5,0,1,0,1,1,-1,0,-1
KR_6652412798,420,1,44,4,10,1,1,2,2,3,5,4,1,5,2,1,3,1,1,2,0,8,16,5,-5,0,-2,0,1,-1,1,1,1,3,-1
KR_6736589735,420,-8,-53,-72,-14,-4,4,0,-5,5,0,-3,4,1,-2,2,0,0,1,1,0,-7,111,-2,-1,3,-1,0,-2,-1,1,-1,-1,4,-1
KR_6618384969,420,2,31,-8,0,5,0,5,0,0,0,-4,4,0,0,3,3,-1,1,0,0,-5,-1,-5,0,5,1,0,0,1,0,1,-1,5,-1
KR_6760670073,440,2,-52,25,2,4,1,5,3,2,5,2,1,3,-8,10,2,1,0,1,0,5,-3,-1,-2,3,1,0,0,1,1,0,-1,2,-1
KR_6718712160,420,-2,-51,-4,-8,-1,2,1,-1,3,2,-3,3,0,-2,3,1,-1,1,0,0,-8,-14,-1,-2,3,-2,0,-1,-1,1,-1,1,2,-1
KR_6704502913,420,-7,-82,-34,-15,-4,4,0,-1,2,1,-4,4,0,-6,6,0,0,1,1,0,-7,-22,-2,-4,6,-1,0,0,-1,-1,-1,-1,3,-1
KR_6738701198,420,-3,-97,-2,-5,2,1,3,-2,3,1,-1,1,0,2,2,4,-6,6,0,0,-3,0,-3,0,3,1,0,-2,-1,-1,-1,1,3,-1
KR_6741286214,420,-2,-23,4,-8,-5,5,0,-8,9,1,1,1,2,1,2,3,3,1,4,0,0,-250,-2,-2,4,1,0,-1,-1,-1,-1,-1,4,-1
KR_6718929432,420,1,-10,-2,9,1,1,2,5,2,7,3,0,3,-1,2,1,1,0,1,1,10,109,-1,-6,7,-4,0,0,1,0,0,1,5,-1
KR_6616569832,420,-3,-68,4,-4,-4,4,0,1,0,1,4,1,5,-2,3,1,-3,3,0,0,-5,-12,-2,-3,5,-1,0,-1,0,0,-1,-1,0,-1
KR_6535799015,420,0,-10,34,4,3,0,3,0,4,4,1,2,3,0,1,1,0,1,1,0,1,-2,6,-9,3,2,0,0,-1,1,0,1,1,-1
KR_6742289979,420,-1,-41,12,-3,2,2,4,1,3,4,-2,2,0,0,1,1,-4,4,0,0,-6,55,1,-3,2,-14,0,1,0,1,1,-1,0,-1
KR_6733977898,440,-2,-49,3,-6,-4,4,0,-1,3,2,1,1,2,-2,4,2,0,1,1,0,-5,-26,-1,-5,6,4,0,0,1,-1,0,-1,1,-1
KR_6609525751,420,-7,-24,-4,-14,-10,10,0,-3,5,2,-7,9,2,4,0,4,2,1,3,0,-10,16,-1,-3,4,-9,0,0,-1,-1,-1,-1,3,-1
KR_6685142926,440,-1,64,-12,-5,0,2,2,-6,6,0,-4,4,0,4,6,10,1,0,1,-1,-4,-4,2,-4,2,-3,0,0,-1,0,0,-1,3,-1
KR_6576289037,440,-1,22,-9,2,2,3,5,-1,2,1,-6,6,0,5,1,6,2,0,2,0,6,4,3,-5,2,-2,0,0,-1,1,0,-1,6,-1
KR_6508020713,420,-2,52,-62,-11,5,0,5,-13,15,2,1,0,1,-4,5,1,0,2,2,-1,-14,-25,-4,0,4,-1,0,1,-1,1,1,-1,4,-1
KR_6715176554,440,-6,-65,-36,-15,2,1,3,-10,12,2,4,1,5,-2,5,3,-9,10,1,1,-18,-5,0,-3,3,-3,0,-1,0,0,-1,-1,0,-1
KR_6674632040,420,-1,74,4,-2,2,1,3,-2,7,5,2,2,4,-4,7,3,0,4,4,-1,-5,7,1,-2,1,1,0,0,1,1,1,-1,2,-1
KR_6653164639,420,0,-39,-13,-6,2,1,3,-8,8,0,0,1,1,-1,2,1,1,1,2,0,-10,4,2,-4,2,-3,0,0,0,0,0,-1,0,-1
KR_6703962761,420,-1,-32,8,2,4,1,5,-2,4,2,-6,7,1,4,0,4,2,0,2,0,3,-114,-3,-1,4,-1,0,0,-1,1,1,1,1,-1
KR_6754177867,420,-5,-38,-2,-11,0,1,1,-5,6,1,0,2,2,-4,6,2,-2,2,0,0,-13,3,4,-5,1,-4,0,-1,-1,1,-1,-1,2,-1
KR_6544788296,440,-4,-138,83,-11,2,3,5,-2,4,2,-10,10,0,-1,5,4,0,1,1,-1,-10,-9,-2,-2,4,-2,0,-3,1,1,-1,-1,4,-1
KR_6754241043,420,-8,-196,-32,-14,-2,2,0,1,1,2,-8,9,1,-3,3,0,-2,4,2,0,-5,-50,-2,-2,4,22,0,-3,1,-1,-1,-1,4,-1
KR_6756514669,420,1,-17,42,2,-2,5,3,0,1,1,1,1,2,5,0,5,-2,2,0,1,8,2,-1,-3,4,5,0,-2,1,-1,-1,1,1,-1
KR_6740133936,420,-2,-28,20,-7,-3,3,0,-1,1,0,-2,4,2,-1,2,1,0,1,1,0,-7,-7,1,-2,1,2,0,-1,-1,-1,-1,1,1,-1
KR_6729457307,440,0,-6,19,-4,-4,4,0,2,0,2,0,2,2,4,0,4,-6,8,2,0,-7,-10,-2,-3,5,0,0,-1,1,-1,-1,-1,2,-1
KR_6375730420,420,0,-14,-4,-8,-1,3,2,-1,4,3,-2,2,0,-3,5,2,-1,1,0,0,-12,0,0,0,0,-3,0,1,1,0,1,1,1,-1
KR_6118086119,420,0,-9,4,8,0,0,0,3,0,3,0,2,2,3,0,3,2,0,2,0,14,-5,-2,-1,3,0,0,0,1,0,0,1,5,-1
KR_6700717582,420,-2,-56,20,-2,-1,1,0,-1,3,2,-2,3,1,2,3,5,0,0,0,0,1,23,3,-4,1,-33,0,-2,-1,0,-1,-1,2,-1
KR_6705020357,440,0,-79,5,-5,-1,3,2,6,3,9,-5,6,1,-2,4,2,-3,4,1,0,6,-13,1,-5,4,-3,0,1,1,1,1,-1,2,-1
KR_6722318673,420,-5,-93,-16,-6,-2,2,0,0,1,1,-2,2,0,3,0,3,-5,5,0,0,-5,19,4,-5,1,-6,0,-2,-1,1,-1,-1,3,-1
KR_6755101758,420,0,-5,-8,0,-2,3,1,4,0,4,2,1,3,-4,4,0,0,1,1,0,-5,3,1,-3,2,-3,0,1,0,1,1,-1,0,-1
KR_6607639652,440,2,-4,3,6,6,0,6,-2,2,0,-5,6,1,5,0,5,2,0,2,0,6,-109,0,-4,4,-2,0,1,-1,1,1,1,1,-1
KR_6533832505,440,0,-53,-4,-9,-3,3,0,-2,3,1,-1,1,0,-2,3,1,-1,1,0,0,-13,18,2,-5,3,-4,0,-1,0,1,-1,-1,0,-1
KR_6567783584,420,-2,-29,-16,-1,-1,4,3,-1,3,2,1,2,3,-2,4,2,2,0,2,0,-4,4,-3,0,3,3,0,-1,0,0,1,1,0,-1
KR_6505026590,420,-3,-48,-4,-2,-3,4,1,1,4,5,1,6,7,1,2,3,-2,5,3,-1,-6,284,2,-4,2,-3,0,-1,1,-1,-1,-1,4,-1
KR_6680143943,420,-2,-83,-38,-1,-3,3,0,3,3,6,0,2,2,0,0,0,-1,1,0,0,4,-1,4,-4,0,-1,0,-1,-1,0,-1,-1,2,-1
KR_6730427619,420,-1,-49,-28,-12,-4,5,1,1,0,1,-3,4,1,0,3,3,-6,9,3,-1,-5,19,-3,0,3,1,0,-1,0,-1,-1,-1,0,-1
KR_6648623607,420,-1,-6,18,-1,1,1,2,0,1,1,-6,6,0,2,2,4,2,1,3,0,-3,-1,0,-3,3,2,0,0,-1,1,0,1,2,-1
KR_6747042420,420,1,30,15,6,5,0,5,3,1,4,-6,7,1,4,1,5,0,0,0,0,5,4,1,-2,1,0,0,-1,1,-1,1,1,2,-1
KR_6727910571,420,1,17,-1,-2,-1,2,1,-1,4,3,1,1,2,1,3,4,-2,2,0,0,-3,-35,-6,-1,7,24,0,0,-1,-1,0,-1,6,-1
KR_6683062949,440,-1,2,-28,-1,-1,1,0,0,5,5,-6,7,1,5,2,7,1,0,1,0,2,-11,-5,0,5,-2,0,-1,-1,-1,-1,-1,6,-1
KR_6735262703,440,6,98,8,3,-1,3,2,0,1,1,-2,3,1,1,1,2,5,1,6,1,3,10,2,-4,2,-3,0,1,1,0,1,1,3,-1
KR_6634484149,420,-9,-73,-72,-5,-1,2,1,0,0,0,-3,3,0,3,0,3,-4,4,0,0,-7,-6,-1,-2,3,0,0,-1,-1,-1,-1,1,2,-1
KR_6754368792,440,-3,-10,8,-13,-4,5,1,0,3,3,-2,3,1,-7,8,1,0,1,1,-1,-13,8,-2,-2,4,-1,0,0,-1,-1,0,-1,6,-1
KR_6751254085,420,-1,-68,3,-1,1,3,4,2,0,2,1,1,2,-5,5,0,0,0,0,0,-1,3,-1,-2,3,-1,0,0,-1,-1,-1,1,1,-1
KR_6661805980,420,-1,-25,-8,5,1,1,2,5,1,6,1,3,4,-2,4,2,0,0,0,0,4,40,-3,-2,5,-3,0,0,0,-1,0,1,0,-1
KR_6667288230,420,-1,-54,6,-3,3,1,4,-4,7,3,2,1,3,-3,6,3,-1,4,3,0,-3,-113,-2,-6,8,-3,0,0,-1,1,1,1,3,-1
KR_6720632526,420,-6,-115,-56,-11,0,3,3,-2,2,0,-4,4,0,-3,3,0,-2,2,0,0,-11,2,-1,-1,2,-1,0,-1,-1,-1,-1,-1,5,-1
KR_6764056317,420,2,-24,11,4,3,0,3,-3,5,2,1,0,1,5,3,8,-2,3,1,0,3,-373,-3,-3,6,6,0,0,-1,0,1,-1,5,-1
KR_6680599384,420,-8,-136,-20,-18,-1,2,1,-2,3,1,-7,8,1,-4,8,4,-4,4,0,0,-9,-7,0,-5,5,0,0,-3,-1,-1,-1,-1,2,-1
KR_6746565106,420,0,-59,5,-2,2,0,2,1,5,6,2,3,5,-7,8,1,0,2,2,-1,-5,-32,-1,-5,6,29,0,-1,-1,1,1,1,5,-1
KR_6756966263,420,-3,-43,10,-9,-3,3,0,-3,4,1,-3,3,0,-1,2,1,1,0,1,0,-7,14,2,-5,3,1,0,-3,-1,-1,-1,-1,5,-1
KR_6655981140,420,-3,-36,18,-7,-7,7,0,1,3,4,3,0,3,-6,7,1,2,0,2,1,-9,1,-1,-5,6,2,0,-1,1,-1,-1,1,3,-1
KR_6620136300,420,-3,-7,-28,-11,-3,4,1,-3,4,1,-3,4,1,-3,3,0,1,0,1,0,-8,12,-6,-2,8,-6,0,0,-1,0,-1,1,5,-1
KR_6740399973,420,-2,-17,-5,-8,-1,2,1,-3,3,0,-1,3,2,-3,3,0,0,1,1,0,-6,-10,1,-5,4,-1,0,0,0,0,0,-1,0,-1
KR_6754280491,420,1,-11,-16,-2,-1,3,2,0,3,3,0,1,1,-1,1,0,0,1,1,-1,-1,3,1,-7,6,1,0,0,0,1,0,-1,0,-1
KR_6707256945,420,-1,-72,11,-5,0,1,1,0,3,3,-2,3,1,-4,4,0,1,0,1,0,-4,1,2,-5,3,1,0,-1,-1,1,-1,-1,6,-1
KR_6693616477,420,-1,-42,24,-4,-2,3,1,-1,2,1,-3,3,0,0,1,1,2,1,3,0,-3,-4,-5,0,5,4,0,-1,1,-1,-1,-1,5,-1
KR_6677286827,420,0,8,-8,-5,-1,2,1,-2,4,2,0,1,1,-2,2,0,0,1,1,0,-8,-40,-4,-4,8,6,0,-1,-1,-1,-1,1,4,-1
KR_6723554701,420,1,-66,8,5,0,2,2,-1,6,5,1,1,2,5,0,5,0,1,1,0,5,31,2,-7,5,-8,0,-1,0,-1,-1,1,0,-1
KR_6584877049,420,-2,-33,-3,-8,1,1,2,-1,2,1,0,2,2,-2,2,0,-6,6,0,-2,-12,0,-3,-1,4,-5,0,0,-1,-1,0,-1,6,-1
KR_6758581919,420,-5,-48,-40,-15,-3,3,0,1,4,5,-1,2,1,-5,5,0,-7,7,0,0,-12,2,-2,-1,3,-2,0,-1,-1,1,-1,-1,6,-1
KR_6613340583,420,-6,-157,-48,-12,-2,2,0,1,2,3,-5,5,0,-6,8,2,0,1,1,0,-3,-18,-1,-3,4,-2,0,-3,-1,0,-1,-1,3,-1
KR_6568037310,440,2,-33,7,1,0,0,0,1,4,5,1,3,4,0,5,5,-1,1,0,0,-2,-27,0,-6,6,5,0,-2,1,-1,-1,-1,6,-1
KR_6709694462,420,-4,-60,-40,-3,0,2,2,2,4,6,-1,3,2,-3,5,2,-1,2,1,2,0,-10,4,-10,6,8,0,-1,-1,-1,-1,1,3,-1
KR_6740804766,440,-5,-88,-14,-16,0,1,1,-2,5,3,-4,5,1,-8,8,0,-2,2,0,-2,-18,-7,-3,-1,4,3,0,0,1,0,-1,-1,6,-1
KR_6509766547,420,-2,-67,1,0,-1,3,2,3,3,6,0,3,3,-2,7,5,0,1,1,0,6,-140,-2,-5,7,-1,0,-4,1,-1,-1,-1,2,-1
KR_5906402708,420,-4,37,-4,-11,1,0,1,-6,6,0,0,1,1,-7,7,0,1,0,1,0,-16,-257,2,-4,2,-1,0,-1,-1,-1,-1,-1,2,-1
KR_6627992940,420,0,16,0,1,1,0,1,1,0,1,-2,4,2,2,1,3,-1,1,0,0,0,9,4,-8,4,-5,0,2,-1,1,1,-1,5,-1
KR_6649517947,420,-4,-95,-5,-20,-1,3,2,-2,2,0,-10,10,0,-5,5,0,-2,3,1,-1,-21,-9,-3,0,3,0,0,-2,-1,-1,-1,-1,3,-1
KR_6566129810,420,-4,-123,-4,4,-3,3,0,7,1,8,-8,8,0,5,2,7,3,1,4,0,12,-12,-4,-3,7,3,0,-1,1,0,-1,1,2,-1
KR_6725977480,420,-5,-43,-33,-21,-8,8,0,-6,7,1,-3,3,0,-4,4,0,0,1,1,-1,-9,5,-2,-2,4,1,0,-2,-1,-1,-1,-1,3,-1
KR_6524858272,440,-3,27,-7,-8,-2,6,4,-1,4,3,3,0,3,-5,5,0,-3,3,0,0,-3,0,-2,-1,3,-2,0,0,1,-1,-1,-1,5,-1
KR_6682941358,420,-1,-6,-20,-11,1,1,2,-4,5,1,-7,7,0,-3,5,2,2,1,3,-1,-10,-9,-1,-3,4,2,0,-2,-1,0,-1,-1,4,-1
KR_6682262061,420,0,-20,-24,-10,5,0,5,-7,8,1,0,2,2,-6,7,1,-2,2,0,0,-13,337,0,-1,1,-1,0,-1,-1,-1,-1,-1,1,-1
KR_6611306795,420,0,-31,-11,3,3,1,4,-3,5,2,4,0,4,-1,3,2,0,1,1,0,2,139,8,-8,0,1,0,0,-1,1,-1,1,3,-1
KR_6420465589,420,-4,17,-19,-14,-2,3,1,-3,5,2,-2,4,2,-5,5,0,-2,4,2,0,-17,96,-6,0,6,3,0,-1,-1,-1,-1,-1,2,-1
KR_6630409067,420,-5,-73,-18,-7,-3,3,0,-4,5,1,3,0,3,-4,4,0,1,1,2,0,-4,3,1,-5,4,-1,0,0,-1,1,0,-1,5,-1
KR_6617707039,420,-2,-83,6,-8,-3,3,0,4,0,4,-5,9,4,-2,3,1,-2,2,0,-1,-1,-10,-5,0,5,1,0,-1,-1,1,1,-1,5,-1
KR_6740045807,420,2,18,-10,1,0,3,3,-1,2,1,2,2,4,-1,2,1,1,0,1,0,6,5,-1,0,1,2,0,-1,-1,1,-1,-1,3,-1
KR_6649022953,440,4,128,-4,1,1,1,2,-3,4,1,0,2,2,-1,2,1,4,0,4,1,0,-3,-8,-1,9,2,0,3,-1,1,1,1,4,-1
KR_6723010601,420,0,18,-16,2,2,1,3,-1,1,0,-3,4,1,3,0,3,1,1,2,0,3,-16,2,-3,1,2,0,0,1,1,0,1,1,-1
KR_6762562360,420,-1,-7,-5,0,3,2,5,0,1,1,-1,6,5,-1,4,3,-1,1,0,0,-2,-11,0,-3,3,3,0,-1,1,0,-1,-1,4,-1
KR_6752108722,420,-2,-20,-2,-8,-3,4,1,1,1,2,-4,5,1,-2,2,0,0,1,1,0,-2,52,7,-7,0,-11,0,-1,0,1,-1,-1,0,-1
KR_6753069291,420,0,-25,26,-7,-1,3,2,-2,2,0,-3,3,0,-1,2,1,0,1,1,0,-9,-52,-8,-1,9,14,0,-1,-1,-1,-1,-1,6,-1
KR_6757894134,420,2,48,-12,4,5,0,5,-2,3,1,5,2,7,-3,4,1,-1,2,1,0,2,4,-1,-6,7,0,0,1,0,1,1,1,0,-1
KR_6728646526,420,0,0,16,-7,-2,3,1,1,2,3,-1,1,0,-5,5,0,0,0,0,0,-9,26,-4,-2,6,-19,0,0,-1,-1,0,-1,1,-1
KR_6756061304,420,-1,-47,21,-5,-3,5,2,-6,6,0,3,4,7,-2,3,1,3,0,3,0,-7,-11,2,-3,1,1,0,-1,1,-1,-1,1,1,-1
KR_6749200611,420,2,-54,-12,0,0,1,1,2,1,3,-4,8,4,1,4,5,1,2,3,0,-3,0,-1,-2,3,-1,0,1,-1,1,-1,-1,3,-1
KR_6725028986,420,-2,14,-32,-3,0,2,2,-3,5,2,0,1,1,0,3,3,0,2,2,0,-4,46,1,-4,3,-14,0,1,1,-1,1,-1,6,-1
KR_6505833327,420,-5,-48,-24,-5,1,3,4,1,2,3,-4,4,0,-1,3,2,-2,4,2,0,2,9,0,-5,5,-5,0,0,-1,-1,-1,-1,3,-1
KR_6471344063,420,0,3,7,0,-1,1,0,2,2,4,0,2,2,-1,1,0,0,0,0,0,-1,-3,-4,-2,6,0,0,-1,0,1,-1,1,0,-1
KR_6749781341,420,-2,-95,-16,-3,-3,3,0,-3,4,1,0,0,0,4,2,6,-1,1,0,0,2,307,7,-8,1,0,0,-1,1,-1,-1,-1,1,-1
KR_6731360421,420,-3,56,-14,-8,-2,3,1,-3,3,0,-2,3,1,-2,2,0,1,0,1,0,-9,4,-3,-1,4,-1,0,0,0,-1,0,-1,0,-1
KR_6729705509,440,1,23,0,1,1,1,2,8,1,9,2,0,2,-10,10,0,0,1,1,0,-1,-1,1,-3,2,-4,0,0,1,-1,-1,1,4,-1
KR_6727706158,420,1,-9,-22,-3,0,0,0,3,0,3,-5,9,4,0,4,4,-1,2,1,0,5,1,-2,-5,7,-2,0,0,1,-1,1,1,5,-1
KR_6650825488,420,2,83,-25,3,2,3,5,3,2,5,2,0,2,-4,4,0,0,1,1,0,-2,7,2,-3,1,-3,0,2,0,1,1,1,0,-1
KR_6741818324,420,-4,-72,-22,-3,1,2,3,-2,7,5,-1,1,0,-4,6,2,3,0,3,0,-4,0,1,-2,1,-2,0,-2,-1,1,-1,1,5,-1
KR_6567367575,420,2,63,5,-3,-3,4,1,-2,2,0,3,0,3,-3,3,0,2,0,2,0,-1,-13,4,-8,4,1,0,-1,1,-1,-1,1,5,-1
KR_6764649848,420,-2,-47,4,-7,0,3,3,-6,7,1,0,3,3,-1,2,1,0,0,0,-1,-14,3,7,-8,1,-3,0,0,0,-1,-1,-1,0,-1
KR_6739360734,420,-7,-135,-4,-5,-3,3,0,0,3,3,-3,5,2,1,5,6,0,0,0,0,-4,25,-2,-2,4,0,0,-1,0,1,-1,1,0,-1
KR_6620259180,420,-2,-53,45,1,-4,4,0,4,0,4,-1,2,1,3,0,3,-1,1,0,0,5,7,7,-7,0,-2,0,-1,-1,-1,-1,-1,4,-1
KR_6376959266,420,1,41,34,-1,1,1,2,-5,5,0,2,1,3,0,2,2,1,0,1,0,-8,108,0,-6,6,-2,0,0,-1,0,0,-1,4,-1
KR_6651804561,420,-3,-21,-5,-9,-3,3,0,1,1,2,-2,3,1,-4,5,1,-1,1,0,0,-13,6,2,-4,2,1,0,0,-1,-1,-1,-1,3,-1
KR_6726701559,420,-1,12,-8,2,-1,4,3,4,1,5,4,0,4,-2,4,2,-3,3,0,0,-1,4,1,-7,6,5,0,0,-1,-1,-1,-1,2,-1
KR_6723258251,420,-2,-78,-16,-8,1,2,3,-2,2,0,-4,4,0,-3,3,0,0,0,0,-1,-14,4,0,-2,2,-2,0,0,0,-1,-1,-1,0,-1
KR_6552083180,420,-2,-40,7,-1,3,0,3,-3,7,4,-3,6,3,1,3,4,1,2,3,-1,-5,41,0,-3,3,-17,0,1,1,-1,1,-1,1,-1
KR_6676442731,420,-4,-60,4,-11,-2,4,2,-2,3,1,-7,7,0,0,0,0,0,0,0,0,-5,21,-2,-3,5,-14,0,0,-1,-1,0,-1,5,-1
KR_6581627830,420,3,28,4,3,4,1,5,-3,3,0,3,0,3,0,2,2,-1,1,0,0,-4,-8,0,-4,4,3,0,0,1,0,0,1,5,-1
KR_6640961427,420,4,-55,36,-1,2,0,2,-4,4,0,1,1,2,0,2,2,0,1,1,-1,-4,7,2,-5,3,-4,0,0,-1,1,-1,-1,5,-1
KR_6665247333,420,-2,-24,16,-13,-1,1,0,-1,3,2,-5,7,2,-5,6,1,-1,1,0,0,-4,7,-3,0,3,-2,0,-1,-1,-1,-1,-1,5,-1
KR_6751854234,440,-5,-143,-36,-4,0,3,3,-2,3,1,2,2,4,-6,7,1,2,1,3,0,-3,0,-5,0,5,-2,0,-1,0,0,-1,-1,0,-1
KR_6613442926,420,-1,-33,12,0,0,1,1,-1,1,0,2,3,5,-2,3,1,1,1,2,0,1,1,2,-6,4,2,0,0,1,1,0,-1,4,-1
KR_6537939010,420,-2,-113,9,-6,-1,1,0,-2,3,1,2,1,3,0,2,2,-5,7,2,0,-11,-17,3,-7,4,-3,0,-2,-1,0,-1,-1,6,-1
KR_6709592240,420,-4,-113,1,-10,-1,1,0,-1,3,2,-3,6,3,-3,3,0,-2,3,1,0,-6,152,0,-3,3,-3,0,0,1,-1,0,-1,5,-1
KR_6727852346,420,-5,-58,-4,-14,-3,4,1,-7,8,1,0,1,1,-5,7,2,1,3,4,0,-3,-4,4,-7,3,-4,0,-4,-1,-1,-1,-1,4,-1
KR_6733452765,420,-3,-9,-2,-7,-1,1,0,2,2,4,-7,8,1,1,3,4,-2,4,2,-2,-6,-6,0,-5,5,4,0,0,1,-1,0,-1,3,-1
KR_6715689461,420,-2,23,-12,-2,4,3,7,-4,5,1,2,3,5,-1,3,2,-3,3,0,0,-2,18,1,-6,5,3,0,0,-1,1,1,1,4,-1
KR_6751813704,440,-1,40,8,-6,0,2,2,-6,6,0,2,0,2,-4,5,1,2,1,3,0,-5,-5,0,0,0,0,0,0,0,0,0,1,0,-1
KR_6746591834,440,-4,-14,-18,-11,-2,4,2,-3,3,0,-10,10,0,3,3,6,1,0,1,0,-5,-6,0,-1,1,2,0,-2,0,-1,-1,-1,0,-1
KR_6739548723,420,1,-9,-3,-2,0,2,2,-1,2,1,-1,5,4,1,1,2,-1,2,1,0,5,-2,-2,0,2,0,0,0,1,1,0,-1,5,-1
KR_6679690257,420,-4,-43,-16,-5,-1,2,1,-4,7,3,-1,1,0,0,0,0,1,0,1,0,2,-278,-1,-5,6,-5,0,0,-1,-1,0,-1,4,-1
KR_6582688990,420,0,-61,20,1,-2,2,0,-1,4,3,-8,12,4,11,0,11,1,1,2,0,4,34,2,-5,3,-5,0,-1,-1,-1,1,-1,1,-1
KR_6741993682,420,-3,4,-40,-3,2,1,3,0,0,0,-3,4,1,0,4,4,-2,3,1,0,-3,-13,-4,-4,8,-3,0,1,-1,1,1,1,3,-1
KR_6726135511,420,-4,-85,-36,-4,-4,5,1,1,1,2,-2,3,1,2,0,2,-1,1,0,0,4,-9,2,-4,2,-7,0,-1,-1,0,-1,-1,6,-1
KR_6743691345,420,-6,-73,-31,-13,-1,1,0,-1,2,1,-4,7,3,-4,4,0,-3,3,0,0,-8,-8,-2,-3,5,-5,0,-3,-1,-1,-1,-1,2,-1
KR_6692710461,440,-3,-41,-20,-10,-2,3,1,-4,6,2,-5,7,2,-1,2,1,2,1,3,0,-6,-2,-5,-2,7,-7,0,-1,-1,-1,-1,1,3,-1
KR_6652900737,420,3,51,-5,8,-1,4,3,-1,2,1,1,1,2,2,1,3,7,1,8,1,10,-91,-2,-1,3,2,0,1,-1,0,1,1,5,-1
KR_6747767555,440,-3,-92,1,-5,2,1,3,-3,3,0,-3,3,0,0,1,1,-1,1,0,0,-1,-36,4,-7,3,21,0,0,-1,0,-1,1,6,-1
KR_6545258680,420,-2,-138,-24,-8,0,2,2,2,0,2,-6,6,0,-4,6,2,0,3,3,0,1,-3,0,-3,3,1,0,-1,0,-1,-1,1,0,-1
KR_6715839800,420,-3,-74,-11,-1,0,2,2,0,3,3,-5,5,0,4,0,4,0,1,1,0,2,-6,-4,-2,6,1,0,0,-1,1,1,1,1,-1
KR_6613748615,440,-2,25,-39,-6,2,1,3,-4,6,2,0,2,2,-1,1,0,-3,5,2,0,-4,-10,-4,-1,5,2,0,-1,-1,-1,-1,-1,2,-1
KR_6496594010,420,-1,-47,-16,-6,0,3,3,-1,4,3,0,0,0,-4,4,0,-1,1,0,-2,-13,-136,-1,-2,3,0,0,-1,-1,-1,-1,-1,4,-1
KR_6660010367,420,-2,10,28,-4,-4,5,1,2,4,6,1,1,2,-3,3,0,0,0,0,0,-7,236,-1,-4,5,-2,0,-1,1,-1,-1,1,6,-1
KR_6745051148,420,-4,-90,0,-11,-2,4,2,-1,1,0,-1,6,5,-4,7,3,-3,3,0,0,-4,-3,1,-4,3,0,0,-4,1,-1,-1,-1,2,-1
KR_6729981078,420,-2,2,-8,-5,0,0,0,-6,7,1,1,0,1,1,2,3,-1,1,0,0,-4,26,3,-6,3,-4,0,-1,0,-1,-1,-1,0,-1
KR_6740739832,420,2,-44,0,6,4,2,6,-4,5,1,-1,1,0,3,3,6,4,1,5,-1,-9,-5,-1,-2,3,0,0,-1,-1,1,-1,-1,6,-1
KR_6721257820,420,1,8,-8,-3,1,0,1,-1,2,1,0,4,4,-1,2,1,-2,3,1,0,-2,-11,0,-6,6,-3,0,0,0,1,0,-1,0,-1
KR_6665741434,420,-2,-30,-20,-8,1,1,2,-2,3,1,2,4,6,-6,7,1,-3,4,1,0,-12,-6,5,-5,0,-2,0,-1,-1,0,-1,-1,5,-1
KR_6754574652,420,-6,-87,8,-20,-3,4,1,-6,8,2,-8,9,1,-3,7,4,0,1,1,-1,-8,-9,2,-2,0,2,0,-2,-1,-1,-1,-1,5,-1
KR_6754774967,420,2,24,28,8,0,1,1,2,2,4,3,1,4,3,0,3,0,0,0,0,5,-5,-1,-3,4,1,0,1,-1,1,1,-1,2,-1
KR_6617945648,420,2,16,17,7,-4,5,1,5,0,5,3,1,4,4,1,5,-1,1,0,0,10,-245,6,-6,0,2,0,1,-1,1,-1,-1,5,-1
KR_6374947486,420,0,13,14,1,2,2,4,-1,1,0,1,2,3,0,3,3,-1,1,0,0,2,0,0,0,0,2,0,0,-1,0,0,1,1,-1
KR_6761944003,420,0,-19,-8,2,-1,3,2,-1,3,2,3,1,4,-6,6,0,7,2,9,0,2,-5,-4,-2,6,6,0,-1,-1,0,-1,1,2,-1
KR_6682507737,420,-4,-91,32,-15,-2,3,1,0,0,0,0,3,3,-11,12,1,-2,2,0,1,-18,4,3,-4,1,-2,0,-2,-1,1,-1,1,3,-1
KR_6602686261,420,-1,-40,5,-5,1,2,3,1,0,1,0,0,0,-4,6,2,-3,4,1,0,-8,-4,0,-2,2,1,0,-3,0,-1,-1,-1,0,-1
KR_6635597811,420,3,57,-4,4,0,1,1,0,2,2,-2,4,2,5,2,7,1,4,5,-1,0,-10,0,-1,1,0,0,0,1,0,0,-1,1,-1
KR_6736291161,440,0,-60,12,-1,-3,6,3,-3,3,0,4,4,8,0,1,1,1,0,1,0,3,5,1,-4,3,-2,0,-1,-1,1,-1,-1,2,-1
KR_6551429881,420,3,21,3,7,0,2,2,3,2,5,0,0,0,2,1,3,2,1,3,0,3,-2,-6,-3,9,3,0,0,1,1,0,1,3,-1
KR_6739171568,420,1,81,12,-6,-6,7,1,6,0,6,-8,8,0,2,2,4,0,2,2,0,-12,4,2,-5,3,-1,0,0,-1,0,1,-1,3,-1
KR_6752189465,420,-3,-78,7,-8,-7,7,0,0,1,1,5,1,6,-8,9,1,2,1,3,0,-3,16,3,-3,0,-2,0,-2,1,0,-1,-1,2,-1
KR_6759793048,440,-4,-54,-16,-8,-5,5,0,0,3,3,-1,2,1,-1,1,0,-1,2,1,0,-4,-3,3,-6,3,6,0,0,-1,1,-1,-1,6,-1
KR_6508105585,420,0,-19,46,5,-3,3,0,3,0,3,3,0,3,-1,2,1,3,0,3,0,3,257,-5,-2,7,3,0,0,-1,-1,0,1,6,-1
KR_6650115227,420,-3,-13,13,-4,-3,3,0,0,1,1,0,1,1,-2,2,0,1,0,1,1,-1,4,-1,-2,3,-3,0,0,1,0,-1,1,4,-1
KR_6742862954,420,-1,-43,12,-1,-1,1,0,0,1,1,3,5,8,-1,3,2,-2,4,2,-1,-6,-16,-4,-2,6,1,0,1,-1,1,1,-1,3,-1
KR_6608399658,420,-2,-23,15,-12,-2,2,0,-8,9,1,-1,3,2,-4,4,0,3,0,3,-1,-15,-7,-5,-1,6,3,0,-2,1,-1,-1,-1,1,-1
KR_6761691527,420,3,51,-12,12,1,1,2,2,3,5,7,1,8,-1,4,3,3,1,4,0,10,-41,3,-5,2,0,0,1,1,-1,1,1,2,-1
KR_6760739779,420,2,94,9,-6,3,0,3,-3,5,2,-1,3,2,-3,4,1,-2,3,1,0,-10,-21,-1,-3,4,-1,0,1,1,-1,1,-1,6,-1
KR_6677497628,440,2,-74,-4,0,0,4,4,-4,6,2,2,2,4,1,1,2,1,0,1,0,-5,25,-4,-1,5,-7,0,-1,1,-1,-1,1,3,-1
KR_6633524147,420,-1,-50,4,-3,1,0,1,-2,2,0,-1,4,3,-2,2,0,1,0,1,0,-1,39,2,-4,2,1,0,-1,-1,1,-1,-1,3,-1
KR_6746429885,420,1,-55,-11,-10,-5,7,2,5,3,8,-5,5,0,-2,2,0,-3,3,0,-2,-2,3,-6,0,6,1,0,-2,-1,-1,-1,-1,3,-1
KR_6756265128,420,0,37,-34,-5,-6,9,3,4,2,6,0,3,3,-3,4,1,0,1,1,0,3,-5,-3,-1,4,0,0,-1,-1,0,-1,-1,4,-1
KR_6660819176,420,2,59,8,-3,-1,5,4,0,1,1,4,3,7,-7,10,3,1,3,4,2,-11,22,1,-2,1,1,0,0,1,1,-1,1,5,-1
KR_6673666285,420,-3,-17,8,-12,-4,4,0,-4,6,2,-1,4,3,-1,1,0,-2,2,0,0,-10,40,-5,0,5,-14,0,0,-1,-1,0,1,4,-1
KR_6711768830,420,-3,-61,2,-8,1,0,1,-3,3,0,-1,3,2,-3,4,1,-2,2,0,-1,-8,-16,-6,-1,7,1,0,-1,-1,-1,-1,-1,4,-1
KR_6717629016,420,-4,-147,-16,-8,-6,9,3,1,2,3,0,2,2,2,1,3,-5,5,0,0,-8,-13,-4,0,4,-2,0,-3,-1,-1,-1,-1,6,-1
KR_6002405159,420,-3,-12,-4,-7,-2,3,1,-1,3,2,-2,2,0,-2,4,2,0,0,0,0,-5,2,-2,-3,5,-5,0,0,-1,-1,0,-1,2,-1
KR_6725585636,420,-3,-64,-4,-2,-4,5,1,2,2,4,-1,4,3,2,2,4,-1,1,0,0,1,3,3,-6,3,-2,0,-2,-1,1,-1,1,5,-1
KR_6737005065,420,-5,-76,-32,-7,2,0,2,-1,3,2,-5,6,1,-3,4,1,0,0,0,-1,-10,-40,-1,-2,3,22,0,-2,-1,0,-1,-1,5,-1
KR_6639732780,420,-2,-50,-15,-8,-4,4,0,1,1,2,-3,5,2,-3,5,2,1,1,2,0,-1,-4,3,-4,1,3,0,-2,-1,0,-1,1,2,-1
KR_6764150045,440,-8,-103,-36,-16,-2,2,0,-2,7,5,0,4,4,-9,11,2,-3,3,0,-1,-10,1,-1,-3,4,-1,0,-3,-1,-1,-1,-1,4,-1
KR_6734180664,420,2,16,-12,-8,-6,6,0,0,2,2,2,1,3,-1,4,3,-3,3,0,0,-8,6,1,-4,3,1,0,-1,-1,-1,-1,-1,4,-1
KR_6577241571,420,-5,-46,0,-4,-3,4,1,-3,3,0,0,2,2,1,4,5,1,0,1,0,-1,-4,-2,-4,6,4,0,-1,1,-1,-1,-1,4,-1
KR_6635834685,420,-6,-86,-32,-16,0,1,1,-1,2,1,-4,5,1,-10,11,1,-1,1,0,-1,-14,201,4,-5,1,-1,0,-1,-1,1,-1,-1,4,-1
KR_6720853183,420,-2,-28,-16,-3,1,0,1,0,2,2,-4,5,1,-1,4,3,1,0,1,-1,0,79,-1,-2,3,1,0,0,-1,1,0,-1,4,-1
KR_6716461065,440,-1,-9,2,1,-5,5,0,-1,1,0,4,2,6,0,0,0,3,0,3,0,-3,-2,-2,-2,4,3,0,1,1,-1,1,-1,1,-1
KR_6646229447,420,-3,-32,-12,-6,0,0,0,1,4,5,-3,6,3,-3,4,1,-1,1,0,0,-11,-2,-4,-1,5,0,0,0,1,-1,1,-1,3,-1
KR_6647166812,440,-4,-62,-48,-8,1,2,3,2,6,8,1,4,5,-13,16,3,1,0,1,0,-11,-12,-3,0,3,2,0,0,1,-1,-1,-1,5,-1
KR_6727784304,420,-1,-73,-16,-4,-2,2,0,-6,6,0,-2,2,0,3,0,3,3,2,5,-1,-9,-10,-1,-2,3,3,0,-1,1,-1,-1,-1,5,-1
KR_6654754977,420,0,-35,6,3,-2,2,0,1,3,4,-1,1,0,1,4,5,4,1,5,2,12,0,1,-4,3,-1,0,-1,1,1,-1,1,2,-1
KR_6331083055,420,0,40,18,8,3,3,6,5,0,5,-1,3,2,1,1,2,0,1,1,0,8,6,2,-3,1,-3,0,2,1,1,1,1,3,-1
KR_6659795322,420,4,85,37,18,1,3,4,3,3,6,1,2,3,10,2,12,3,0,3,0,17,-7,-3,-3,6,7,0,3,-1,1,1,1,2,-1
KR_6759990305,420,-3,-70,-24,-9,-1,3,2,1,1,2,-4,4,0,-4,4,0,-1,2,1,0,-2,5,1,-3,2,0,0,-2,-1,1,-1,-1,6,-1
KR_6726437617,440,-6,-93,-40,-17,-5,5,0,0,1,1,-6,7,1,-3,3,0,-3,3,0,0,-17,-9,-6,0,6,2,0,-2,-1,-1,-1,-1,1,-1
KR_6609354320,420,-1,20,-8,-3,0,0,0,-5,6,1,2,0,2,2,1,3,-2,2,0,0,-4,14,-4,-2,6,4,0,0,1,-1,0,1,4,-1
KR_6728012430,440,1,-16,20,-1,-1,2,1,2,4,6,0,0,0,-2,4,2,0,1,1,0,-3,0,-2,-1,3,-1,0,0,0,-1,0,1,0,-1
KR_6684168798,420,-6,-65,-12,-16,-5,5,0,-2,7,5,-7,10,3,-4,7,3,2,3,5,-3,-11,0,1,-1,0,1,0,-1,-1,-1,-1,1,6,-1
KR_6632226827,420,-3,-35,-30,0,-4,5,1,1,2,3,1,2,3,0,3,3,2,0,2,0,6,-2,2,-3,1,-3,0,0,-1,1,-1,-1,6,-1
KR_6665206284,420,-3,-3,29,-3,2,1,3,-6,6,0,2,2,4,0,2,2,-1,1,0,1,-1,-8,3,-5,2,4,0,-2,0,-1,-1,1,0,-1
KR_6681955584,420,2,11,16,1,-1,3,2,0,2,2,-1,5,4,1,0,1,2,0,2,0,-1,-3,-4,-2,6,5,0,0,1,1,1,-1,4,-1
KR_6093778670,420,1,6,-23,-1,-1,4,3,-1,2,1,-3,4,1,3,3,6,1,0,1,0,2,1,0,-8,8,2,0,-1,0,-1,-1,-1,0,-1
KR_6757722420,420,-2,-37,-13,-10,2,0,2,-11,14,3,0,2,2,0,2,2,-1,1,0,-1,-8,6,-7,0,7,0,0,1,0,1,1,-1,0,-1
KR_6700185584,440,1,-28,35,10,4,3,7,0,2,2,2,5,7,-1,4,3,5,2,7,2,7,11,6,-8,2,-5,0,0,-1,-1,1,1,4,-1
KR_6757229320,420,-3,-55,-24,-13,-1,1,0,-10,10,0,-4,4,0,0,1,1,2,1,3,-3,-13,-11,-4,-3,7,2,0,-1,1,-1,-1,-1,6,-1
KR_6746882077,420,-3,26,-12,-5,5,1,6,-1,3,2,-1,1,0,-7,7,0,-1,1,0,0,-9,-4,0,-1,1,1,0,1,1,1,1,1,5,-1
KR_6754810407,420,0,30,-38,5,0,1,1,2,4,6,3,0,3,-2,4,2,2,0,2,-1,3,5,-4,-2,6,4,0,0,-1,1,1,-1,4,-1
KR_6737668836,420,-5,-95,-13,-7,-3,4,1,-6,6,0,-4,4,0,5,0,5,1,0,1,0,-2,28,-2,-2,4,3,0,-1,0,0,-1,-1,0,-1
KR_6535887164,420,-2,-48,-10,0,1,3,4,-6,10,4,1,3,4,4,0,4,0,1,1,2,2,-2,1,-4,3,-2,0,1,-1,-1,1,1,2,-1
KR_6579225254,440,-4,-92,-40,-8,-1,5,4,-3,4,1,-3,3,0,-3,4,1,2,1,3,0,-3,9,3,-5,2,0,0,-2,-1,-1,-1,1,1,-1
KR_6764398248,420,-4,-94,-26,-7,0,2,2,1,1,2,-5,6,1,-5,8,3,2,0,2,0,-8,-10,-1,-2,3,0,0,-3,-1,0,-1,1,2,-1
KR_6676362380,440,-2,28,-12,3,4,1,5,-2,2,0,2,3,5,-1,1,0,0,2,2,0,2,-2,-1,-3,4,-3,0,1,1,0,1,1,4,-1
KR_6559015504,420,-1,-19,-32,5,4,1,5,0,5,5,1,1,2,0,2,2,0,0,0,0,1,-49,1,-4,3,10,0,0,0,0,0,1,0,-1
KR_6674859598,420,-1,-21,-44,-14,-6,6,0,0,1,1,-5,5,0,-4,5,1,1,0,1,-2,-12,-5,-4,-1,5,-2,0,-1,-1,-1,-1,-1,2,-1
KR_6755157100,440,-7,-66,-51,-23,-5,5,0,-8,9,1,-5,5,0,-2,3,1,-3,3,0,-1,-21,-14,3,-5,2,2,0,-2,-1,0,-1,-1,2,-1
KR_6720517644,440,-1,37,20,2,-2,2,0,2,2,4,2,5,7,-1,3,2,1,1,2,1,0,-8,-1,-4,5,-1,0,0,-1,-1,0,1,6,-1
KR_6678257796,420,2,22,-33,2,2,1,3,-1,4,3,-1,3,2,2,0,2,0,1,1,0,6,20,-2,-2,4,1,0,0,-1,-1,1,1,1,-1
KR_6716609531,440,1,-58,-23,7,-3,3,0,2,1,3,4,1,5,1,3,4,3,0,3,0,0,50,2,-4,2,3,0,1,-1,1,-1,1,6,-1
KR_5920201123,440,-2,25,-20,0,-1,1,0,-1,1,0,2,2,4,-1,1,0,1,0,1,-1,2,14,-2,-2,4,-1,0,0,-1,-1,0,-1,2,-1
KR_6735105905,420,1,41,-24,11,3,1,4,3,1,4,4,1,5,-1,5,4,2,1,3,0,9,-8,3,-5,2,0,0,0,-1,-1,1,1,1,-1
KR_5540626677,440,-1,37,-30,-2,-4,4,0,1,2,3,3,0,3,3,1,4,-5,5,0,0,-3,-56,-2,-4,6,31,0,1,-1,0,1,1,4,-1
KR_6730829192,420,1,-9,8,5,2,1,3,-3,3,0,1,2,3,1,0,1,4,2,6,0,-2,6,-1,-4,5,4,0,1,1,0,1,1,5,-1
KR_6123321616,440,0,-72,-20,2,0,3,3,1,4,5,-3,5,2,5,2,7,-1,1,0,0,2,-2,-1,-3,4,2,0,0,0,0,0,-1,0,-1
KR_6749839003,420,0,-3,-9,0,4,1,5,-1,3,2,-3,4,1,-1,2,1,1,0,1,1,2,-29,3,-4,1,2,0,0,-1,-1,1,1,4,-1
KR_6701744507,420,-1,-22,-4,-3,0,2,2,-4,7,3,0,2,2,0,2,2,1,1,2,0,-4,24,3,-5,2,-3,0,-1,0,-1,-1,1,0,-1
KR_6002645474,420,-4,-57,-36,-5,0,1,1,-6,6,0,-4,6,2,4,1,5,1,3,4,1,-5,0,-5,-4,9,-2,0,1,-1,1,1,1,2,-1
KR_6422392384,420,-1,-79,-8,5,1,2,3,2,0,2,-2,3,1,6,1,7,-2,2,0,-1,11,0,2,-3,1,1,0,0,1,-1,0,-1,6,-1
KR_6733787847,420,-4,-19,8,-14,0,3,3,-9,9,0,-4,6,2,-2,2,0,1,2,3,0,-13,-12,-1,-1,2,-1,0,-2,0,0,-1,1,0,-1
KR_6602012063,420,1,32,-24,-3,0,1,1,-2,3,1,-1,4,3,2,0,2,-2,3,1,0,-10,-1,-3,-1,4,1,0,-1,0,-1,-1,-1,0,-1
KR_6756643403,420,1,-29,35,-5,1,3,4,1,1,2,4,0,4,-7,10,3,-4,4,0,0,-4,-9,-4,-3,7,0,0,1,1,-1,1,-1,1,-1
KR_6703115738,420,-2,-64,-32,-6,0,3,3,-1,4,3,0,4,4,-5,6,1,0,0,0,1,-7,-38,0,-5,5,11,0,-1,-1,1,-1,1,6,-1
KR_6742497249,420,-1,-84,-22,-8,1,2,3,-1,4,3,-7,7,0,0,4,4,-1,1,0,0,-3,8,3,-4,1,0,0,-1,1,-1,-1,-1,2,-1
KR_6757422460,420,-3,0,11,-5,-3,3,0,2,1,3,-3,6,3,0,1,1,-1,1,0,0,-7,-3,0,-3,3,1,0,-3,-1,-1,-1,1,5,-1
KR_6748164696,420,0,-26,-4,7,3,1,4,0,1,1,3,0,3,-1,1,0,2,2,4,0,4,68,1,-3,2,-1,0,-1,-1,-1,-1,1,6,-1
KR_6752480082,440,-2,7,0,0,-1,2,1,3,2,5,0,2,2,0,2,2,-2,2,0,0,-1,-95,0,-4,4,3,0,1,1,-1,1,-1,5,-1
KR_6648357010,420,1,47,-12,7,5,0,5,5,2,7,0,2,2,-2,4,2,-1,2,1,0,9,-4,1,-4,3,1,0,0,-1,1,0,1,1,-1
KR_6667171492,420,-1,-23,-12,-5,-1,2,1,-5,5,0,-2,5,3,3,4,7,0,1,1,0,-11,9,1,-4,3,-4,0,-2,-1,-1,-1,-1,5,-1
KR_6669397040,420,-1,-40,-3,3,0,2,2,-1,1,0,1,2,3,2,0,2,1,0,1,0,2,1,4,-9,5,-1,0,-1,1,-1,-1,1,4,-1
KR_6609473478,440,-6,-10,-40,-11,-2,3,1,-3,3,0,-5,5,0,1,3,4,-2,3,1,0,-6,-14,-6,0,6,-3,0,0,-1,-1,-1,-1,2,-1
KR_6762820087,420,3,-8,-7,1,3,0,3,-2,4,2,0,1,1,-1,1,0,1,0,1,0,-3,25,0,-2,2,-6,0,1,-1,1,1,1,6,-1
KR_6763063096,420,-2,-55,-20,-2,-1,2,1,0,1,1,-1,2,1,0,3,3,0,1,1,0,-5,-6,-3,-4,7,0,0,0,1,-1,0,-1,4,-1
KR_6672514607,420,-2,-78,11,-4,-2,2,0,-3,6,3,0,1,1,0,1,1,1,0,1,0,-2,-163,-1,0,1,-2,0,-2,1,0,-1,-1,1,-1
KR_6729767246,440,0,92,9,0,-3,5,2,1,6,7,0,5,5,-2,6,4,4,3,7,0,-5,-2,-3,-3,6,2,0,0,-1,1,0,1,3,-1
KR_6596030693,420,-6,-41,-61,-8,-1,4,3,-4,4,0,-6,8,2,3,1,4,0,0,0,0,-4,-2,-3,0,3,1,0,-2,-1,-1,-1,1,5,-1
KR_6735209610,420,-3,-5,2,-7,-3,3,0,1,5,6,-2,3,1,-1,1,0,-2,3,1,0,-13,21,0,-2,2,-1,0,-1,1,-1,-1,-1,4,-1
KR_6711582166,440,-3,-89,-8,-7,-2,6,4,4,2,6,-2,5,3,-2,7,5,-5,5,0,1,-4,15,1,-2,1,-1,0,-3,-1,1,-1,1,3,-1
KR_5915594377,420,-5,-31,-2,-8,-2,7,5,3,3,6,-4,5,1,-2,4,2,-3,4,1,1,-4,-234,-1,-2,3,3,0,-1,1,0,-1,1,2,-1
KR_6742978365,440,-7,-39,-15,-20,-8,10,2,-5,5,0,1,0,1,0,1,1,-8,8,0,-1,-17,-3,1,-2,1,1,0,-1,1,-1,-1,-1,3,-1
KR_6755231284,420,0,18,22,6,4,3,7,2,2,4,0,1,1,0,2,2,0,0,0,0,4,5,4,-4,0,0,0,2,0,0,1,1,0,-1
KR_6710820247,420,-2,-17,-5,-4,1,1,2,-4,6,2,-1,2,1,1,1,2,-1,2,1,0,-4,12,-2,-1,3,-3,0,0,1,1,-1,-1,3,-1
KR_6632424481,420,-1,-19,12,-1,2,0,2,-2,3,1,0,1,1,0,1,1,-1,2,1,0,1,-300,-2,-3,5,-1,0,0,-1,-1,0,-1,4,-1
KR_6739220766,440,-3,-126,9,-13,-2,5,3,-2,7,5,-4,4,0,-2,3,1,-3,4,1,-3,-4,1,-1,0,1,-2,0,-2,-1,1,-1,-1,5,-1
KR_6713283673,420,-2,18,-55,1,1,0,1,0,1,1,3,0,3,-4,4,0,1,1,2,0,-3,-503,2,-2,0,23,0,-1,-1,1,-1,1,3,-1
KR_6744116090,420,2,24,-8,5,1,1,2,-2,4,2,5,0,5,1,3,4,0,0,0,1,0,164,3,-6,3,3,0,0,-1,0,0,1,5,-1
KR_6214523186,440,3,103,2,10,7,1,8,2,5,7,4,3,7,-4,4,0,1,3,4,2,2,-272,-2,-5,7,-1,0,3,1,1,1,1,5,-1
KR_6689249981,440,-2,-49,-4,-10,-1,4,3,-3,4,1,-2,4,2,-3,7,4,-1,1,0,0,-8,-11,0,-2,2,0,0,0,-1,-1,0,-1,2,-1
KR_6757833422,420,-3,-46,-25,-1,-3,5,2,0,2,2,5,0,5,-2,3,1,-1,3,2,2,2,-1,-1,-4,5,-3,0,0,1,0,0,1,5,-1
KR_6689275861,420,3,4,19,6,3,1,4,2,0,2,1,3,4,0,1,1,0,1,1,0,4,2,-2,-2,4,0,0,-1,-1,-1,-1,-1,6,-1
KR_6711329516,420,1,-13,6,-4,0,2,2,3,0,3,-5,5,0,-1,2,1,-1,2,1,-2,-6,-33,-2,-2,4,4,0,0,1,-1,0,-1,1,-1
KR_6722777288,420,3,27,-4,0,3,1,4,1,2,3,-8,8,0,1,5,6,3,1,4,-1,0,222,5,-6,1,1,0,2,0,-1,1,-1,0,-1
KR_6683806095,420,-6,-96,-12,-9,-2,2,0,-3,5,2,-6,6,0,0,4,4,2,0,2,-1,-3,-8,0,-2,2,-5,0,-1,-1,1,1,-1,2,-1
KR_6761195075,420,-1,-34,-23,-1,-3,3,0,0,2,2,2,2,4,-1,3,2,1,0,1,0,-1,-7,-4,-1,5,1,0,0,0,-1,0,-1,0,-1
KR_6639226228,420,0,-1,32,-6,-1,4,3,-1,3,2,-6,7,1,3,1,4,-1,1,0,0,-2,-7,-5,-1,6,0,0,0,-1,-1,-1,1,4,-1
KR_6739856922,420,-1,-20,-20,-3,5,1,6,1,2,3,-3,4,1,-5,7,2,-1,1,0,0,-1,14,2,-2,0,1,0,1,1,1,1,-1,1,-1
KR_6622559359,440,0,57,-10,-4,2,2,4,-2,4,2,0,2,2,-5,5,0,1,0,1,0,-5,-1,-3,-2,5,-3,0,-1,-1,0,-1,-1,3,-1
KR_6374342575,420,0,-2,8,0,0,1,1,4,2,6,-1,6,5,-2,3,1,-1,2,1,0,-5,0,0,0,0,-2,0,1,-1,1,1,-1,3,-1
KR_6602406328,420,-1,17,-23,-7,-2,4,2,-2,4,2,-1,1,0,-3,4,1,1,0,1,0,-5,0,-2,-2,4,1,0,0,1,-1,0,-1,6,-1
KR_6374448559,420,0,63,16,5,8,0,8,-6,6,0,0,3,3,1,0,1,2,0,2,0,-3,0,0,0,0,7,0,0,1,1,1,1,6,-1
KR_6703518497,420,-3,-47,0,-8,-8,8,0,-2,6,4,-1,3,2,2,1,3,1,0,1,0,-2,-262,-1,0,1,-1,0,-2,1,-1,-1,-1,2,-1
KR_6652214147,420,-3,22,-21,-2,2,0,2,-3,5,2,1,0,1,-4,6,2,2,0,2,0,-6,23,-1,-2,3,1,0,-1,1,-1,-1,-1,3,-1
KR_6725131267,440,-2,-99,-20,-5,2,1,3,-2,2,0,-3,5,2,-2,4,2,0,0,0,-3,-8,-46,-4,-3,7,12,0,0,-1,-1,-1,-1,2,-1
KR_6322031033,420,-4,-35,12,-4,0,3,3,-4,5,1,0,0,0,-1,4,3,1,3,4,0,-3,5,6,-6,0,-1,0,0,-1,0,-1,1,1,-1
KR_6756685801,420,0,-64,28,4,3,1,4,0,1,1,-1,3,2,-1,2,1,3,1,4,0,5,-21,3,-4,1,-1,0,-3,-1,1,-1,1,2,-1
KR_6327853645,420,-8,-91,-89,-9,1,0,1,2,1,3,-3,3,0,-7,7,0,-2,3,1,-1,-9,-1,1,-2,1,-4,0,-4,0,-1,-1,-1,0,-1
KR_6682240218,420,-5,-35,-8,-13,-1,4,3,-7,8,1,-4,4,0,-2,4,2,1,1,2,0,-9,10,2,-5,3,-5,0,0,-1,-1,-1,1,2,-1
KR_6703789910,420,-5,-131,-20,-11,-4,4,0,-2,3,1,-7,8,1,0,0,0,2,1,3,0,-1,-266,-1,-2,3,0,0,-2,-1,-1,-1,-1,6,-1
KR_6468739125,420,2,18,19,0,0,2,2,-2,3,1,-2,4,2,5,1,6,-1,1,0,0,1,16,-3,-4,7,6,0,0,1,-1,1,-1,4,-1
KR_6663970539,420,2,-43,40,0,-5,5,0,0,3,3,1,4,5,2,2,4,2,1,3,0,5,-2,-5,-2,7,0,0,1,1,1,1,1,5,-1
KR_6653097134,420,-1,-47,-12,1,-2,4,2,3,0,3,3,3,6,-1,3,2,-2,4,2,-1,6,-26,1,-4,3,4,0,0,1,0,1,-1,1,-1
KR_6621219080,420,-2,51,-24,-4,-3,3,0,-3,7,4,-1,3,2,2,4,6,1,1,2,2,-2,33,0,-4,4,-21,0,-1,1,-1,-1,1,3,-1
KR_6697519439,420,-4,-63,-29,-7,-1,2,1,3,4,7,2,3,5,-6,9,3,-5,5,0,-3,-8,-16,-2,-4,6,-4,0,0,-1,-1,-1,-1,1,-1
KR_6692830067,440,-3,-102,4,-8,-8,8,0,-2,3,1,3,2,5,0,5,5,-1,2,1,0,-5,-18,-3,-1,4,1,-1,-3,-1,1,-1,-1,5,-1
KR_6655418107,420,-4,-69,-4,-8,-5,6,1,0,0,0,-3,5,2,0,2,2,0,2,2,0,-6,32,0,-3,3,-1,0,-1,-1,0,-1,1,5,-1
KR_6756401522,420,-2,-29,17,-7,-2,3,1,-9,9,0,0,2,2,4,4,8,0,1,1,0,-1,-13,3,-3,0,7,0,0,-1,1,0,-1,2,-1
KR_6462867485,420,-5,-86,-24,-15,-3,6,3,2,1,3,-6,7,1,-4,5,1,-4,4,0,0,-9,-3,-3,-2,5,4,0,-1,-1,-1,-1,-1,3,-1
KR_6759417594,420,0,62,0,4,1,2,3,0,1,1,1,0,1,2,3,5,0,1,1,2,9,-2,-2,-1,3,4,0,0,-1,1,0,1,6,-1
KR_6762406385,420,0,71,-20,3,-1,3,2,-4,4,0,4,3,7,3,3,6,1,0,1,0,-8,1,-1,-1,2,-1,0,1,1,1,1,1,5,-1
KR_6732172483,420,1,44,12,-1,2,1,3,-3,5,2,-2,2,0,1,2,3,1,2,3,0,-1,-127,-5,0,5,2,0,0,1,1,0,-1,1,-1
KR_6154756312,420,-1,-17,-44,1,1,0,1,-1,2,1,-1,2,1,-2,5,3,4,0,4,0,-4,52,-2,-2,4,-1,0,0,-1,1,-1,1,1,-1
KR_6669920501,440,-3,-73,-23,-12,-4,5,1,-3,5,2,-4,5,1,-1,2,1,0,1,1,0,-12,-373,-2,-1,3,-3,0,-1,1,-1,-1,-1,3,-1
KR_6726076352,420,-2,-53,-14,3,1,3,4,-2,5,3,6,2,8,3,0,3,-5,5,0,0,-2,-6,1,-3,2,-3,0,-3,-1,1,-1,-1,4,-1
KR_6647577457,420,-2,64,-13,-11,-2,4,2,-2,4,2,-5,6,1,-1,2,1,-1,1,0,0,-10,7,-5,-2,7,-3,0,-1,-1,-1,-1,-1,5,-1
KR_6580886713,420,-2,-60,-4,-7,-2,4,2,0,2,2,3,1,4,-7,8,1,-1,1,0,0,-8,-19,2,-8,6,-3,0,0,-1,1,-1,-1,3,-1
KR_6631176385,420,2,-25,-8,-1,2,0,2,1,4,5,1,4,5,0,0,0,-5,6,1,0,-4,-69,-1,-2,3,0,0,0,-1,0,0,1,3,-1
KR_6693159282,420,-1,-16,-24,2,2,1,3,2,2,4,-2,3,1,2,1,3,-2,3,1,0,9,-13,-5,-3,8,-2,0,-1,-1,-1,-1,-1,6,-1
KR_6727371650,440,1,72,-3,2,0,2,2,2,2,4,-1,3,2,-1,2,1,2,0,2,1,2,7,3,-7,4,-1,0,0,1,-1,0,1,2,-1
KR_6749880418,420,-3,-67,-5,-12,0,0,0,-2,6,4,-6,8,2,-5,5,0,1,0,1,-2,-10,5,-2,-1,3,0,0,-2,-1,-1,-1,-1,3,-1
KR_6749372423,420,-3,2,-10,-11,-5,5,0,-2,6,4,-1,5,4,-3,4,1,0,0,0,0,-8,0,-1,-3,4,-1,0,0,0,1,1,-1,0,-1
KR_6718521328,420,-4,-107,-4,-6,-1,1,0,0,4,4,-2,4,2,-3,4,1,0,1,1,-1,-1,4,-2,-4,6,-1,0,0,1,-1,0,-1,6,-1
KR_6740328797,420,-4,-91,-17,-9,-1,1,0,1,1,2,-4,6,2,-5,7,2,0,2,2,0,-1,-216,2,-4,2,1,0,-2,-1,-1,-1,1,3,-1
KR_6661345757,420,-2,-8,1,-8,-2,2,0,-2,5,3,1,1,2,-3,4,1,-2,3,1,-1,-6,-2,-3,-1,4,-2,0,-1,1,-1,-1,-1,3,-1
KR_6726494748,440,-4,-69,0,2,1,1,2,3,4,7,-1,2,1,-1,1,0,0,4,4,2,4,-5,-5,-1,6,0,0,-2,1,-1,-1,1,6,-1
KR_6703656735,420,-1,-39,24,3,-2,4,2,4,2,6,-6,6,0,6,2,8,1,1,2,0,0,13,-1,-3,4,1,0,-1,1,-1,-1,1,5,-1
KR_6762357526,420,-4,-14,-16,-7,-1,2,1,-2,2,0,2,1,3,1,3,4,-7,9,2,0,-9,-4,0,-2,2,-2,0,-1,-1,0,-1,-1,6,-1
KR_6755328229,420,-4,38,2,-6,-3,3,0,1,1,2,-6,9,3,2,0,2,0,0,0,-1,1,-7,2,-2,0,1,0,0,-1,-1,0,-1,4,-1
KR_6725512264,420,-4,-26,8,-8,-5,6,1,0,3,3,-1,6,5,-1,1,0,-1,1,0,0,-7,0,0,-5,5,0,0,-1,-1,-1,-1,-1,4,-1
KR_6621305186,420,-2,-13,32,0,-1,3,2,4,2,6,-3,4,1,0,1,1,0,1,1,0,0,10,4,-8,4,-3,0,0,1,1,0,-1,1,-1
KR_6602441292,420,-2,-88,13,-8,-2,3,1,-1,2,1,0,6,6,-4,4,0,-1,1,0,-2,-13,26,-2,-2,4,-3,0,-1,0,-1,-1,-1,0,-1
KR_6605806796,420,2,-6,7,-2,-1,1,0,3,1,4,-1,3,2,-1,1,0,-2,2,0,0,1,-10,1,-3,2,1,0,-1,-1,-1,-1,-1,4,-1
KR_6729183364,420,-3,-142,-4,-14,-3,3,0,-3,4,1,-2,8,6,-3,4,1,-3,4,1,-2,-7,-5,-3,-2,5,3,0,-2,1,-1,-1,-1,1,-1
KR_6687973510,420,1,29,-39,1,2,0,2,-2,5,3,-2,2,0,0,2,2,3,0,3,0,4,1,-6,-4,10,4,0,1,-1,1,1,-1,1,-1
KR_6605740457,420,1,-36,-12,-2,3,0,3,-1,2,1,0,4,4,-3,4,1,-1,1,0,0,-6,-2,-4,-5,9,-3,0,-1,-1,-1,-1,1,6,-1
KR_6751460926,440,-4,-32,2,-14,-2,3,1,-1,2,1,-6,7,1,-4,5,1,-1,2,1,0,-7,-7,-3,0,3,-2,0,-2,0,-1,-1,-1,0,-1
KR_6715297995,440,-5,-60,-8,-8,-1,1,0,1,4,5,-1,3,2,-1,3,2,-6,6,0,0,-4,10,0,-4,4,-3,0,-1,-1,-1,-1,-1,5,-1
KR_6762375085,420,-1,28,4,-8,3,1,4,-1,2,1,-4,5,1,-5,5,0,-1,1,0,0,-12,5,3,-4,1,-3,0,1,-1,1,1,-1,4,-1
KR_6728195237,420,2,31,-4,13,6,0,6,8,0,8,-3,3,0,4,2,6,-2,2,0,2,14,-4,-2,-2,4,-1,0,1,-1,1,1,1,4,-1
KR_6663859738,420,-5,7,-28,-4,-6,6,0,-2,2,0,1,3,4,3,1,4,0,1,1,0,-2,-4,0,-1,1,-1,0,0,-1,-1,-1,1,4,-1
KR_6705639721,420,-1,-21,11,-6,-2,2,0,1,1,2,-3,5,2,-2,5,3,0,0,0,0,-2,-5,-2,-3,5,-1,0,-1,-1,0,-1,-1,1,-1
KR_6659571145,440,0,-27,4,4,3,0,3,2,0,2,2,0,2,-3,3,0,0,0,0,0,1,14,3,-4,1,-1,0,0,-1,-1,-1,1,1,-1
KR_6683426017,440,-2,-39,8,-16,-1,2,1,-7,9,2,-3,6,3,-4,4,0,-1,1,0,-1,-16,6,1,-2,1,-2,0,-1,1,1,-1,-1,6,-1
KR_6718439132,440,-7,-141,-4,-26,-5,5,0,1,0,1,-3,3,0,-17,18,1,-2,2,0,-1,-20,-1,-3,0,3,-3,0,-1,-1,-1,-1,-1,2,-1
KR_6758815315,440,-3,-33,-3,-15,-3,5,2,-5,6,1,-2,6,4,-1,2,1,-4,5,1,-1,-19,-4,1,-5,4,-1,0,-1,-1,-1,-1,-1,2,-1
KR_6611941718,420,0,-41,16,2,3,1,4,2,3,5,-2,2,0,-1,2,1,0,2,2,0,-3,10,-3,-4,7,-2,0,-1,-1,-1,-1,1,1,-1
KR_6518528752,420,2,56,8,5,4,1,5,-3,7,4,1,1,2,3,2,5,0,0,0,1,0,1,0,-2,2,1,0,0,1,1,1,1,4,-1
KR_6749510049,420,-2,-9,34,-3,0,1,1,-3,4,1,1,2,3,-2,6,4,1,0,1,0,-7,-163,-2,-2,4,-1,0,-2,-1,1,-1,-1,3,-1
KR_6760339276,420,-2,0,12,-7,-3,4,1,1,2,3,-4,5,1,-1,4,3,0,2,2,0,-6,119,0,-5,5,2,0,0,1,1,0,-1,1,-1
KR_6763122715,440,-3,-25,-16,-1,-3,5,2,0,1,1,-3,4,1,4,1,5,1,3,4,0,1,-4,0,0,0,-1,0,-1,1,-1,-1,1,3,-1
KR_6722807165,420,0,-37,10,-2,1,0,1,0,1,1,-5,5,0,3,0,3,-1,1,0,0,0,16,-4,-2,6,2,0,-1,-1,-1,-1,-1,2,-1
KR_6596257281,420,-2,14,-4,-2,-1,2,1,-1,1,0,5,0,5,-3,3,0,-2,2,0,0,-3,-4,1,-3,2,-1,0,-1,1,-1,-1,1,2,-1
KR_6753652117,440,-4,-32,-16,-16,-1,2,1,-2,2,0,-6,12,6,-5,5,0,-2,4,2,0,-11,-304,-4,-1,5,0,0,-1,-1,0,-1,-1,2,-1
KR_6716776850,440,-6,-89,-24,-10,1,0,1,-4,4,0,-2,2,0,-5,5,0,0,1,1,0,-8,4,-5,0,5,0,0,-1,-1,1,-1,1,5,-1
KR_6763287181,420,-4,-73,-16,-9,-5,5,0,2,1,3,-4,6,2,-1,1,0,-1,1,0,0,-3,-12,-1,-2,3,-1,0,-1,-1,-1,-1,-1,5,-1
KR_6696949885,420,-1,-59,4,-2,2,1,3,-5,5,0,2,0,2,-4,5,1,3,0,3,1,-5,-6,-7,-2,9,-1,0,-2,1,1,-1,1,3,-1
KR_6720516469,420,-7,-87,-17,-8,-3,3,0,-4,5,1,3,1,4,-3,5,2,-1,3,2,0,-6,8,2,-3,1,-2,0,-1,-1,-1,-1,1,5,-1
KR_6746524522,420,2,-17,-19,4,2,2,4,4,0,4,-6,9,3,2,6,8,2,0,2,3,7,0,0,-1,1,0,0,0,-1,1,1,1,5,-1
KR_6736853439,440,-2,-52,-13,-2,2,0,2,-3,6,3,0,0,0,-2,5,3,1,0,1,0,1,-18,-3,-3,6,2,0,0,1,-1,0,1,2,-1
KR_6723819540,440,-2,-34,-8,-2,-5,5,0,-1,3,2,5,1,6,0,3,3,-1,2,1,0,0,-9,1,-6,5,2,0,-1,1,1,-1,-1,5,-1
KR_6740546239,420,3,38,16,9,-5,10,5,2,2,4,4,0,4,5,1,6,3,0,3,0,7,-6,1,-3,2,4,0,1,1,1,1,-1,4,-1
KR_6732822652,440,-2,-13,-22,4,-1,3,2,3,1,4,2,0,2,0,3,3,0,2,2,0,0,-6,-2,-3,5,1,0,0,-1,1,0,-1,2,-1
KR_6640556113,420,1,-14,-11,3,1,2,3,-1,2,1,-4,5,1,3,0,3,4,0,4,0,5,-15,3,-4,1,1,0,1,-1,1,1,1,4,-1
KR_6712428262,420,-1,1,-4,-9,-6,6,0,0,3,3,-2,4,2,-3,5,2,2,0,2,0,-11,-6,0,-3,3,-3,0,-3,-1,-1,-1,-1,1,-1
KR_6728265533,420,-3,12,-24,-10,-5,5,0,-1,1,0,-4,4,0,0,2,2,0,2,2,0,1,36,1,-3,2,-33,0,-1,-1,-1,-1,-1,1,-1
KR_6740628126,420,-1,-64,-10,0,1,1,2,1,0,1,1,4,5,-2,2,0,-1,2,1,-1,-4,-1,2,-3,1,-2,0,-1,-1,1,1,-1,3,-1
KR_6740739973,420,0,-8,24,-7,2,0,2,-2,4,2,-3,4,1,-1,2,1,-3,3,0,-1,-7,-5,-7,0,7,3,0,0,-1,-1,0,-1,3,-1
KR_6728859327,420,-4,-124,-38,-10,-1,4,3,2,1,3,-2,6,4,-10,11,1,1,1,2,1,-7,-8,-2,-1,3,-1,0,-3,0,-1,-1,1,0,-1
KR_6646124384,420,-1,-1,-15,-4,-3,3,0,-3,6,3,-2,3,1,1,2,3,3,1,4,0,-2,-2,-2,-3,5,0,0,0,-1,-1,-1,-1,5,-1
KR_6719826355,440,-5,19,-39,-10,-1,2,1,-5,5,0,-2,3,1,-1,1,0,-1,2,1,0,-5,327,-1,-3,4,-1,0,0,1,-1,0,-1,5,-1
KR_6676886652,440,0,1,-49,1,3,0,3,0,1,1,-2,3,1,2,4,6,-2,3,1,0,2,0,2,-4,2,2,0,0,-1,-1,0,1,1,-1
KR_6686278025,440,-4,-86,8,-13,-5,6,1,-3,4,1,0,0,0,0,0,0,-5,9,4,0,-10,136,0,-2,2,-2,0,-1,-1,0,-1,-1,4,-1
KR_6422832327,420,-2,-10,12,3,5,1,6,-4,7,3,-2,3,1,0,5,5,4,0,4,-1,4,-11,2,-8,6,-2,0,0,1,1,-1,-1,5,-1
KR_6757237074,420,-1,-47,4,-1,-1,3,2,2,1,3,-3,5,2,-1,1,0,2,1,3,0,-3,-9,0,-1,1,1,0,-2,-1,-1,-1,-1,1,-1
KR_6728752781,420,-1,8,2,3,2,1,3,-2,4,2,-2,2,0,3,0,3,2,0,2,0,4,-3,-3,-2,5,2,0,0,-1,1,0,1,4,-1
KR_6624901273,420,-1,-1,1,-7,-1,2,1,-1,1,0,-1,1,0,-4,5,1,0,0,0,0,-12,-14,-1,-5,6,1,0,0,-1,-1,0,-1,3,-1
KR_6751935900,420,-4,-37,-13,-13,-2,4,2,-2,2,0,-6,8,2,-2,3,1,-1,1,0,-1,-7,-20,0,-2,2,-2,0,-1,-1,-1,-1,-1,6,-1
KR_6744353512,420,-5,-67,-8,-12,0,1,1,-5,6,1,-1,6,5,-5,5,0,-1,2,1,0,-13,-13,0,-5,5,2,0,0,1,-1,-1,-1,4,-1
KR_6740634635,420,-2,-19,-32,0,2,1,3,-1,1,0,-1,3,2,1,0,1,-1,1,0,0,-1,0,-1,-2,3,1,0,-3,0,-1,-1,1,0,-1
KR_6724868075,420,3,37,-9,5,-1,2,1,4,0,4,2,2,4,-1,3,2,1,2,3,-2,3,-7,0,-1,1,1,0,1,1,1,1,-1,1,-1
KR_6738956274,420,0,37,-32,-8,2,0,2,-2,2,0,-1,3,2,-8,11,3,1,0,1,-1,-13,-9,-2,-2,4,3,0,-1,-1,-1,-1,-1,6,-1
KR_6707080803,420,-4,-32,-24,-7,-1,1,0,-1,4,3,-2,3,1,-2,6,4,-1,2,1,0,-10,207,-1,-4,5,22,0,-1,-1,1,-1,-1,4,-1
KR_6677081054,420,2,35,32,-5,2,0,2,-3,4,1,-1,4,3,-3,3,0,0,1,1,0,-5,-4,-5,-5,10,5,0,0,-1,-1,0,-1,5,-1
KR_6743828730,420,-5,-54,-37,-14,1,3,4,2,2,4,0,1,1,-5,6,1,-12,12,0,0,-8,3,-2,-2,4,-1,0,-1,-1,1,1,-1,2,-1
KR_6717565245,420,-1,-11,-16,-3,4,0,4,-1,2,1,-2,5,3,-1,1,0,-3,3,0,0,3,4,-3,-3,6,0,0,1,0,1,1,-1,0,-1
KR_6741923260,440,-1,-16,24,-8,1,2,3,-4,5,1,3,4,7,-7,7,0,-1,1,0,0,-2,7,-1,-4,5,-3,0,1,-1,0,1,-1,1,-1
KR_6712400018,440,-5,-37,-2,-4,-1,1,0,1,1,2,-1,2,1,-3,5,2,0,2,2,0,-4,1,-2,0,2,0,0,0,-1,0,-1,1,4,-1
KR_6601260303,420,-4,-25,-24,-8,-3,3,0,0,3,3,-3,3,0,0,2,2,-2,3,1,-1,-10,-2,-1,-5,6,-2,0,0,-1,-1,0,-1,6,-1
KR_6729288060,420,-5,-68,4,-11,-2,2,0,-4,5,1,2,1,3,-2,3,1,-5,5,0,0,-15,106,0,-3,3,0,0,-2,1,0,-1,1,6,-1
KR_6648787611,420,-3,-46,40,-3,-3,3,0,-1,2,1,0,2,2,1,0,1,0,0,0,0,1,2,0,-2,2,-7,0,-1,1,1,-1,-1,5,-1
KR_6727633034,420,-2,-136,16,-2,-3,4,1,2,4,6,-1,2,1,0,4,4,0,0,0,-1,4,-4,-4,-3,7,-2,0,0,-1,1,0,-1,6,-1
KR_6737335558,420,-2,8,0,0,0,3,3,2,2,4,0,4,4,-2,4,2,0,1,1,-1,1,3,0,-1,1,-2,0,1,-1,1,1,-1,2,-1
KR_6752194947,420,2,-18,21,7,2,3,5,0,2,2,-3,4,1,9,1,10,-1,1,0,0,12,17,-1,0,1,-2,0,2,1,-1,1,1,6,-1
KR_6752138810,420,-2,-52,-36,-3,-3,4,1,0,4,4,2,0,2,0,1,1,-2,2,0,0,2,-26,1,-5,4,-1,0,-1,0,1,-1,1,0,-1
KR_6752342020,420,-1,56,-20,-2,-1,1,0,1,4,5,-1,3,2,1,1,2,-2,3,1,0,8,95,-7,-2,9,8,0,0,-1,-1,0,-1,2,-1
KR_6694218536,440,0,5,-40,3,2,1,3,0,0,0,-1,1,0,0,2,2,2,0,2,0,3,-7,2,-5,3,-2,0,-1,1,-1,-1,-1,3,-1
KR_6735771515,440,-2,-89,-14,-1,1,0,1,-2,2,0,2,2,4,-2,2,0,0,1,1,0,-2,0,-3,-1,4,-1,0,-1,-1,1,-1,-1,2,-1
KR_6606225358,420,-1,41,0,-1,2,1,3,-4,5,1,0,1,1,-2,3,1,3,1,4,1,4,9,6,-8,2,0,0,0,0,1,1,1,0,-1
KR_6380994673,420,0,52,16,-7,-5,7,2,-1,2,1,0,0,0,-1,2,1,0,0,0,0,-6,0,2,-2,0,0,0,1,-1,1,1,-1,3,-1
KR_6756827418,440,-2,-45,-4,-15,-4,5,1,-1,6,5,-1,2,1,-7,8,1,-2,3,1,-1,-11,53,-1,-5,6,-30,0,0,-1,1,1,-1,4,-1
KR_6668510714,420,-1,-12,-25,7,3,0,3,1,4,5,1,3,4,3,0,3,-1,1,0,0,7,-30,4,-6,2,22,0,0,-1,1,0,1,5,-1
KR_6606840238,420,-3,-29,-5,-11,-4,4,0,0,1,1,-2,3,1,-5,5,0,0,2,2,-2,-12,-6,-3,-2,5,5,0,-1,-1,-1,-1,-1,1,-1
KR_6630330127,420,-5,-56,-20,-10,-1,6,5,0,1,1,-8,9,1,-2,4,2,1,1,2,0,-10,0,0,-2,2,-2,0,-1,-1,1,-1,1,3,-1
KR_6704011181,420,0,-50,-16,0,-3,4,1,6,1,7,-1,4,3,1,2,3,-3,6,3,0,1,6,1,-2,1,-2,0,0,1,1,-1,-1,4,-1
KR_6649402123,420,-2,33,-29,-2,-4,6,2,-3,4,1,1,2,3,-1,2,1,5,1,6,0,-2,3,2,-5,3,-3,0,-1,-1,-1,-1,-1,3,-1
KR_6726059482,420,2,-37,-16,0,-5,5,0,5,0,5,-1,4,3,3,1,4,-2,2,0,0,4,-20,0,-2,2,1,0,-2,-1,-1,-1,1,6,-1
KR_6579497666,420,2,8,-9,-1,7,0,7,-2,4,2,-4,4,0,-1,2,1,-1,1,0,-1,-4,2,2,-3,1,-2,0,-1,-1,-1,-1,-1,3,-1
KR_6354781086,440,-1,-5,-4,1,1,0,1,-2,6,4,5,1,6,-1,3,2,-2,3,1,0,2,0,0,0,0,0,0,0,1,-1,0,1,1,-1
KR_6537036160,440,-1,-43,-12,0,-1,2,1,1,1,2,0,4,4,0,1,1,0,1,1,0,2,-26,1,-5,4,1,0,-1,0,0,-1,-1,0,-1
KR_6664446402,420,-1,3,24,-11,0,1,1,-1,3,2,-4,4,0,-5,6,1,-1,3,2,0,-12,-9,-10,-2,12,3,0,-1,-1,-1,-1,-1,6,-1
KR_6742012226,420,-3,-70,-33,-8,1,1,2,-7,8,1,2,4,6,-3,3,0,-1,2,1,0,-5,112,0,-4,4,-8,0,0,-1,0,-1,-1,6,-1
KR_6723110519,420,-2,35,8,-3,2,0,2,-4,5,1,-5,10,5,4,1,5,0,1,1,0,-7,13,-2,-2,4,2,0,1,0,1,1,1,0,-1
KR_6734141695,440,-4,-49,-52,-4,-3,4,1,0,2,2,2,1,3,-1,2,1,-2,2,0,0,-5,0,-1,-4,5,4,0,-1,-1,1,-1,1,6,-1
KR_6679889881,420,-5,-65,-37,-10,-2,2,0,-3,5,2,-6,8,2,0,3,3,1,1,2,-1,-1,94,4,-7,3,-1,0,-2,-1,1,-1,-1,4,-1
KR_6691073165,440,-1,-21,-9,-4,0,0,0,-2,4,2,-1,2,1,-2,3,1,1,0,1,0,-11,2,2,-6,4,-3,0,-2,-1,1,-1,-1,4,-1
KR_6763604077,420,-2,60,3,-3,0,0,0,1,5,6,0,2,2,-5,5,0,1,0,1,0,-1,4,3,-4,1,-2,0,2,-1,1,1,1,6,-1
KR_6710414765,420,0,18,4,-2,-1,1,0,-2,3,1,0,2,2,1,3,4,0,2,2,0,-3,28,2,-6,4,-5,0,0,1,-1,0,1,1,-1
KR_6185554611,420,-4,-52,-15,-7,1,2,3,1,2,3,-6,7,1,-2,4,2,-1,1,0,0,-13,-17,-3,0,3,0,0,-1,0,-1,-1,1,0,-1
KR_6756138858,420,-7,-100,-27,-8,2,2,4,-3,3,0,0,0,0,-7,7,0,0,1,1,0,-9,-38,-1,-2,3,0,0,-3,-1,0,-1,-1,2,-1
KR_6684122015,420,0,19,-16,-6,-1,2,1,-5,5,0,-6,6,0,5,0,5,1,0,1,0,-4,23,-3,-3,6,0,0,0,0,-1,-1,-1,0,-1
KR_6616712766,420,-1,9,8,-10,-4,4,0,1,2,3,-1,2,1,-4,5,1,-2,2,0,0,-7,24,-2,-1,3,0,0,0,-1,0,0,-1,3,-1
KR_6752270718,420,-3,-7,6,-10,-6,7,1,-8,9,1,2,2,4,0,2,2,2,1,3,0,-3,-6,-6,0,6,1,0,-2,-1,1,-1,1,5,-1
KR_6713742370,420,0,-3,28,-3,2,2,4,-2,3,1,2,2,4,-2,4,2,-3,4,1,1,-6,-14,-2,0,2,-3,0,0,0,1,0,1,0,-1
KR_6729595239,420,-4,-39,45,-9,-7,7,0,-3,8,5,1,1,2,-1,4,3,1,1,2,0,-5,5,4,-8,4,-3,0,-1,1,-1,-1,-1,2,-1
KR_6759703444,440,-2,-32,12,-1,-1,1,0,1,0,1,0,1,1,-2,4,2,1,0,1,0,-2,1,-3,-2,5,3,0,-1,-1,0,-1,1,3,-1
KR_6696039199,420,-2,-37,21,-3,2,1,3,-3,4,1,2,1,3,-1,2,1,-3,4,1,0,-6,-18,-1,-5,6,3,0,0,0,1,0,-1,0,-1
KR_6705781739,420,-7,-34,-36,-15,-8,8,0,-5,8,3,-3,4,1,3,1,4,-2,2,0,0,-9,-12,2,-4,2,-2,0,1,-1,-1,-1,-1,1,-1
KR_6759130003,420,-2,-31,-20,-5,-3,4,1,-1,3,2,-2,3,1,0,0,0,1,0,1,0,-4,1,4,-8,4,2,0,0,0,-1,0,-1,0,-1
KR_6716657291,420,1,59,-3,-4,5,0,5,-2,3,1,-1,3,2,-2,4,2,-4,6,2,0,-9,-139,-1,-3,4,-1,0,4,-1,0,1,-1,5,-1
KR_6759160762,420,-3,51,-12,-8,-1,2,1,-6,8,2,0,3,3,1,3,4,-2,2,0,0,-5,15,-1,-7,8,-3,0,0,-1,-1,0,1,2,-1
KR_6747251823,420,0,36,-10,2,-2,2,0,-1,4,3,6,1,7,0,3,3,-1,2,1,0,8,1,-3,-2,5,1,0,-1,1,-1,-1,1,5,-1
KR_6754308331,420,1,88,-15,-1,2,0,2,-5,5,0,5,2,7,-3,3,0,0,0,0,0,-7,-7,-2,-1,3,0,0,0,0,0,0,1,0,-1
KR_6613796531,440,-3,-13,-32,-3,0,1,1,1,2,3,-6,6,0,1,1,2,1,4,5,0,10,-84,-2,-5,7,-2,0,0,-1,0,-1,1,6,-1
KR_6739058194,420,-1,-63,11,-2,-4,8,4,3,0,3,4,0,4,-4,4,0,-1,1,0,1,1,5,2,-4,2,-3,0,-2,-1,1,-1,1,1,-1
KR_6720192817,420,-2,-7,-32,-10,0,0,0,-1,2,1,-2,5,3,-6,6,0,-1,2,1,0,-9,-2,-1,-6,7,-2,0,0,-1,-1,0,-1,4,-1
KR_6707984017,420,-4,-44,20,-10,0,3,3,-2,3,1,-4,4,0,-4,7,3,0,1,1,0,-8,247,-2,0,2,5,0,-2,1,1,-1,1,1,-1
KR_6758456253,440,1,-21,23,4,2,0,2,4,1,5,4,2,6,-4,6,2,-2,2,0,0,2,-28,-3,-1,4,1,0,0,-1,1,-1,-1,3,-1
KR_6665273000,420,-2,-18,7,-7,-7,7,0,0,1,1,-1,2,1,0,1,1,1,0,1,0,0,2,-3,0,3,-1,0,-1,1,0,-1,-1,6,-1
KR_6599681639,420,-4,-19,-7,-8,1,3,4,-7,7,0,-1,4,3,-1,2,1,0,0,0,-1,-12,-5,0,-5,5,-1,0,-1,-1,-1,-1,-1,3,-1
KR_6595666928,420,-3,-90,-52,-7,0,1,1,-1,4,3,-4,6,2,-3,5,2,1,0,1,0,-2,-1,0,-3,3,-2,0,0,-1,-1,0,1,2,-1
KR_6663185929,420,0,11,-4,0,-5,5,0,4,1,5,2,0,2,2,1,3,-3,3,0,0,6,5,2,-2,0,-3,0,0,-1,1,0,-1,5,-1
KR_6731574846,440,-3,-120,32,-9,0,3,3,-1,3,2,2,0,2,-1,3,2,-9,11,2,0,2,-5,2,-2,0,-1,0,-2,1,1,-1,-1,3,-1
KR_6762317691,420,-5,-102,-12,-2,3,0,3,1,2,3,0,1,1,-5,5,0,-1,1,0,0,-2,-7,2,-6,4,-4,0,0,-1,1,0,1,4,-1
KR_6140351968,420,-1,-42,8,-3,-10,10,0,5,0,5,-1,3,2,3,1,4,0,0,0,0,-2,8,1,-7,6,-4,0,-1,1,-1,-1,-1,4,-1
KR_6679958024,420,-8,-9,-64,-19,-5,5,0,-3,3,0,-17,17,0,5,2,7,1,1,2,0,-12,23,0,-3,3,1,0,-3,0,-1,-1,-1,0,-1
KR_6740268643,420,-1,-16,1,-7,-4,4,0,-2,2,0,1,1,2,-1,1,0,-1,1,0,0,-11,4,-5,0,5,-1,0,-1,-1,-1,-1,-1,3,-1
KR_6612786082,420,-4,-45,-61,-4,-1,3,2,-11,12,1,4,1,5,1,3,4,3,2,5,0,1,7,5,-9,4,-3,0,-1,-1,-1,-1,-1,1,-1
KR_6105790968,420,-1,58,-12,-5,-4,4,0,-1,2,1,2,1,3,-2,3,1,0,0,0,-1,-7,-4,1,-4,3,5,0,0,-1,1,0,-1,5,-1
KR_6683002728,440,4,-1,23,11,2,2,4,1,3,4,5,0,5,6,1,7,-3,3,0,-1,4,3,-1,-2,3,2,0,0,1,0,1,-1,4,-1
KR_6391905258,420,-1,7,-32,-4,1,1,2,-3,6,3,-1,4,3,-1,3,2,0,1,1,0,-1,-4,-1,-5,6,3,0,-1,1,1,-1,1,2,-1
KR_6615483682,420,2,34,0,5,1,2,3,3,0,3,1,3,4,-1,2,1,1,2,3,0,8,17,1,-1,0,-4,0,1,-1,0,1,1,2,-1
KR_6755925176,420,4,9,31,9,2,2,4,5,2,7,1,1,2,1,0,1,0,1,1,0,6,5,1,-3,2,3,0,0,0,-1,1,1,0,-1
KR_6742081570,440,-5,-46,-18,-7,-6,6,0,-1,1,0,3,1,4,-3,4,1,0,1,1,-2,-5,-7,-2,-3,5,-4,0,0,-1,-1,0,-1,2,-1
KR_6332823261,440,2,19,-25,7,-1,3,2,2,1,3,-2,2,0,6,3,9,2,0,2,0,2,-26,1,-5,4,2,0,-1,-1,-1,-1,1,5,-1
KR_6567751514,420,1,9,9,0,0,2,2,5,2,7,-3,4,1,1,1,2,-3,5,2,0,-1,-5,-1,-2,3,1,0,0,0,0,0,-1,0,-1
KR_6376883314,420,-1,20,8,-1,0,1,1,-5,6,1,-1,1,0,5,3,8,0,1,1,0,-5,-250,3,-8,5,2,0,0,1,-1,0,1,1,-1
KR_6763895969,420,0,-59,4,7,-1,4,3,0,1,1,-1,2,1,6,0,6,3,0,3,0,11,14,4,-7,3,-2,0,0,1,1,0,1,2,-1
KR_6680458722,420,-5,-103,1,-8,-4,4,0,-4,5,1,0,1,1,0,5,5,0,2,2,0,-2,3,0,-1,1,0,0,-2,0,0,-1,1,0,-1
KR_6751010327,440,-2,-81,8,-10,-1,4,3,-2,3,1,-3,6,3,-1,2,1,-3,3,0,0,-11,-12,-5,-2,7,0,0,0,-1,1,-1,-1,5,-1
KR_6757804661,420,-2,1,-4,-9,3,0,3,-1,3,2,-1,4,3,-5,6,1,-5,5,0,0,-5,315,1,-1,0,20,0,0,1,-1,0,-1,2,-1
KR_6707011931,420,2,36,4,4,2,0,2,1,0,1,2,1,3,-1,2,1,0,4,4,0,1,-4,0,-4,4,2,0,0,1,1,0,-1,1,-1
KR_6752682620,440,-4,-86,-19,-1,0,1,1,-2,3,1,-1,1,0,1,2,3,1,1,2,1,-4,-283,3,-6,3,-7,0,-1,-1,1,-1,1,5,-1
KR_6762362375,420,-9,-73,-112,-14,-3,3,0,-3,3,0,-3,4,1,0,1,1,-5,5,0,0,-15,-191,-1,0,1,0,0,-4,-1,0,-1,-1,2,-1
KR_6751149109,420,-1,-15,3,-6,0,1,1,1,4,5,-2,6,4,-3,3,0,-2,2,0,0,-4,-11,-1,-1,2,0,0,-2,-1,-1,-1,1,1,-1
KR_6758091882,420,-1,15,-40,1,-2,4,2,2,5,7,-4,4,0,1,1,2,4,0,4,2,4,-10,2,-2,0,-1,0,0,-1,-1,1,1,2,-1
KR_6751937554,440,-3,51,-2,-2,0,2,2,1,0,1,0,5,5,-6,8,2,3,0,3,0,3,36,0,-2,2,-26,0,2,-1,1,1,1,3,-1
KR_6735036774,420,-2,-47,20,-5,0,0,0,1,0,1,-2,3,1,-1,2,1,-3,4,1,1,-3,-44,0,-1,1,-16,0,-1,-1,-1,-1,1,4,-1
KR_6652292646,420,-2,-50,8,-7,0,4,4,-2,5,3,0,1,1,-3,3,0,-2,2,0,0,-6,29,-4,-2,6,-18,0,-1,-1,1,-1,-1,2,-1
KR_6699052338,420,-2,4,-29,-12,-5,8,3,-2,3,1,-4,6,2,0,4,4,-1,1,0,-3,-16,3,-3,-2,5,-1,0,0,1,1,0,-1,5,-1
KR_6706171105,420,-4,-75,-23,-7,-4,5,1,-4,5,1,-1,3,2,0,3,3,2,0,2,0,2,0,-1,-1,2,2,0,0,1,-1,-1,-1,4,-1
KR_6607292651,440,-5,-77,-40,-7,0,7,7,-4,4,0,-2,4,2,2,0,2,-3,4,1,-1,5,-113,1,-5,4,-1,0,-1,-1,1,-1,-1,6,-1
KR_6733531891,440,2,21,-28,2,1,0,1,0,3,3,-3,4,1,1,0,1,3,1,4,0,7,-3,-1,-6,7,-1,0,0,-1,1,0,-1,5,-1
KR_6655533670,420,-4,-75,-19,-5,-4,4,0,2,0,2,-2,3,1,-3,3,0,2,3,5,0,3,-51,1,-5,4,9,0,-2,-1,0,-1,1,2,-1
KR_6746642037,420,1,-12,8,4,-5,5,0,4,1,5,-2,6,4,7,0,7,0,1,1,1,12,2,0,-4,4,-2,0,-1,0,-1,-1,1,0,-1
KR_6567957514,440,1,-21,-15,1,-3,3,0,0,4,4,3,2,5,2,1,3,-1,1,0,0,5,-5,0,-8,8,-1,0,0,-1,1,1,1,1,-1
KR_6682090563,420,4,101,0,6,4,0,4,3,1,4,-1,2,1,1,2,3,-1,2,1,0,6,-105,-4,-4,8,4,0,0,-1,-1,0,-1,3,-1
KR_6749463597,420,-1,3,-12,0,3,0,3,0,2,2,3,0,3,-6,6,0,0,0,0,0,-1,-6,-2,-2,4,1,0,0,-1,1,-1,-1,4,-1
KR_6630910567,420,-5,-16,19,-16,-7,7,0,-1,3,2,-2,4,2,-3,4,1,-3,3,0,0,-7,-168,2,-5,3,-6,0,-1,0,-1,-1,-1,0,-1
KR_6734694142,420,-4,-2,8,-6,-3,3,0,-4,5,1,1,2,3,2,0,2,-2,2,0,0,-9,-14,1,-5,4,-1,0,-1,-1,-1,-1,1,6,-1
KR_6753221733,440,0,-20,4,3,1,3,4,-1,2,1,4,3,7,0,3,3,-1,2,1,0,7,-6,3,-7,4,1,0,0,-1,1,0,1,3,-1
KR_6404100492,420,3,-34,-4,2,-2,5,3,0,4,4,2,1,3,1,3,4,1,0,1,-1,9,-3,4,-5,1,-3,0,0,-1,-1,0,-1,1,-1
KR_6668303103,420,-3,-88,-2,-3,-4,4,0,-2,2,0,1,0,1,1,3,4,1,1,2,0,-3,1,-4,-3,7,-4,0,-1,0,-1,-1,1,0,-1
KR_6740572720,420,2,-52,16,10,-2,2,0,4,3,7,3,1,4,7,0,7,-2,2,0,0,7,-3,2,-5,3,3,0,1,-1,1,1,1,3,-1
KR_6727040294,420,-1,97,-31,-3,-1,2,1,-2,5,3,0,3,3,1,1,2,-1,2,1,0,2,-137,4,-5,1,-2,0,0,-1,0,1,1,5,-1
KR_6711395107,420,-8,-49,-24,-13,-5,5,0,-2,2,0,-1,2,1,-1,3,2,-4,4,0,0,-7,9,4,-6,2,-7,0,-2,-1,-1,-1,-1,2,-1
KR_6733301579,420,-5,-90,-28,-13,-8,8,0,1,4,5,2,4,6,-5,6,1,-3,3,0,0,-7,4,1,-1,0,-1,0,-3,-1,-1,-1,-1,5,-1
KR_6747540439,420,-5,-73,-20,-8,-1,2,1,0,5,5,0,3,3,-4,5,1,-3,6,3,0,1,9,-1,-3,4,3,0,-2,-1,-1,-1,-1,5,-1
KR_6704396267,420,-8,-144,-5,-19,-4,5,1,-6,6,0,-5,7,2,-3,3,0,-1,2,1,-1,-12,-46,0,-4,4,20,0,-2,-1,-1,-1,-1,3,-1
KR_6326558035,440,-4,-26,4,-8,1,2,3,-4,4,0,-1,3,2,0,3,3,-4,5,1,0,-6,-2,1,-4,3,-2,0,-1,-1,0,-1,-1,4,-1
KR_6690611975,420,-1,94,-15,-7,2,0,2,-3,4,1,2,2,4,-9,9,0,1,0,1,-1,-6,3,3,-4,1,-1,0,-1,-1,-1,1,-1,5,-1
KR_6730535936,440,-3,-9,-3,-5,3,1,4,-2,4,2,3,1,4,-4,5,1,-5,6,1,0,-7,-7,0,-2,2,-1,0,0,1,1,-1,-1,4,-1
KR_6759180162,420,1,-51,42,2,2,1,3,2,0,2,1,2,3,-3,3,0,0,0,0,0,-1,-1,1,-3,2,-4,0,0,-1,1,0,-1,5,-1
KR_6755434156,440,-2,13,-18,-10,-3,3,0,-2,3,1,3,1,4,-7,8,1,-1,1,0,0,-8,0,1,-4,3,5,0,1,-1,1,1,-1,1,-1
KR_6675785096,440,1,28,-24,-3,3,0,3,1,1,2,-2,2,0,0,2,2,-5,6,1,0,-4,4,-3,-2,5,-1,0,1,-1,-1,1,-1,5,-1
KR_6613442785,420,2,11,25,-6,-3,6,3,1,1,2,-3,4,1,-1,3,2,0,0,0,-2,-6,7,1,-3,2,0,0,-1,1,-1,-1,-1,1,-1
KR_6714060857,440,-1,-26,15,2,1,1,2,2,0,2,7,1,8,-7,7,0,-1,4,3,0,-5,-1,-1,-1,2,-3,0,-1,0,1,-1,-1,0,-1
KR_6738353135,420,-6,-78,-37,-11,1,0,1,-4,7,3,-7,8,1,-2,2,0,1,2,3,-1,-1,-23,-2,-2,4,0,0,-1,-1,-1,-1,-1,2,-1
KR_6355433366,420,-1,-43,-12,-6,-6,7,1,0,3,3,3,1,4,1,2,3,-4,4,0,0,-3,0,0,0,0,0,0,-2,-1,-1,-1,1,3,-1
KR_6739903852,420,-5,-98,4,-12,-4,4,0,-4,8,4,-2,3,1,-1,2,1,-1,2,1,0,-9,-17,-3,-1,4,1,0,-1,-1,1,-1,-1,3,-1
KR_6630467168,420,3,31,-12,8,2,1,3,0,2,2,0,2,2,4,0,4,2,0,2,-1,7,23,2,-3,1,-2,0,1,1,1,1,-1,5,-1
KR_6732571614,440,-2,-20,-4,-4,-5,6,1,0,3,3,2,2,4,-2,3,1,1,2,3,0,-4,-7,-2,-1,3,2,0,3,-1,-1,1,1,3,-1
KR_6746593922,440,1,47,26,1,0,0,0,-2,3,1,-1,5,4,4,1,5,0,0,0,0,7,-8,-4,-1,5,0,0,2,-1,1,1,-1,5,-1
KR_6554615529,420,-4,-66,-9,-7,-5,5,0,4,4,8,-2,2,0,-4,6,2,0,0,0,0,-5,4,-1,-4,5,0,0,-1,1,-1,-1,-1,2,-1
KR_6742242867,420,-3,-35,-24,-10,-4,4,0,-10,11,1,4,1,5,4,0,4,-4,4,0,0,-5,-43,-1,-3,4,13,0,-1,-1,-1,-1,-1,1,-1
KR_6746321894,440,1,-46,24,3,0,2,2,-1,1,0,-1,4,3,3,1,4,2,0,2,0,5,8,2,-4,2,1,0,-1,-1,-1,-1,1,5,-1
KR_6531224206,420,1,20,-4,4,-7,7,0,-2,3,1,4,1,5,7,0,7,2,1,3,-1,9,-262,0,-4,4,-1,0,0,1,1,1,-1,1,-1
KR_6604475750,420,-3,-43,-20,-4,-4,4,0,1,6,7,-1,2,1,1,0,1,-1,1,0,1,7,-254,1,-3,2,-2,0,-2,-1,-1,-1,1,4,-1
KR_6668322345,420,-3,-75,-32,-4,-1,2,1,-6,6,0,1,0,1,1,2,3,1,6,7,0,-1,14,-1,0,1,-3,0,0,0,1,0,-1,0,-1
KR_6746065488,440,-3,-97,-8,-11,-7,8,1,-3,6,3,-1,3,2,-2,2,0,2,1,3,0,-3,6,-1,0,1,1,0,-1,-1,0,-1,-1,5,-1
KR_6761096237,440,-5,-99,19,-7,2,0,2,-1,2,1,1,2,3,-4,4,0,-5,5,0,0,-4,-4,1,-5,4,-4,0,-2,1,-1,-1,-1,3,-1
KR_6738056862,440,-8,-68,-15,-16,-4,4,0,-4,5,1,-6,8,2,0,1,1,-2,3,1,0,-1,-3,1,-6,5,1,0,0,-1,-1,-1,-1,1,-1
KR_6751155819,440,1,18,-28,3,0,2,2,-1,3,2,-2,4,2,2,5,7,4,1,5,1,-2,14,-2,0,2,4,0,1,-1,-1,1,1,2,-1
KR_6764143223,420,1,-2,3,0,0,2,2,1,1,2,-9,9,0,6,2,8,2,0,2,0,1,3,-1,-2,3,-3,0,1,-1,1,1,-1,4,-1
KR_6707897093,420,-1,-21,11,-4,0,0,0,4,1,5,0,2,2,-3,4,1,-5,6,1,0,-5,-48,4,-5,1,-2,0,-1,0,0,-1,1,0,-1
KR_6670728451,420,1,63,-2,10,3,0,3,1,2,3,1,1,2,1,3,4,4,1,5,0,7,-1,-2,-1,3,2,0,1,0,1,1,1,0,-1
KR_6719217079,420,-4,-36,-23,-4,-3,4,1,-4,4,0,2,0,2,-2,3,1,3,1,4,0,-5,2,1,-5,4,1,0,-1,0,-1,-1,1,0,-1
KR_6756579444,420,3,-66,-4,5,2,3,5,2,0,2,1,1,2,0,1,1,0,0,0,0,4,-7,-4,-1,5,3,0,0,-1,-1,1,-1,1,-1
KR_6720297766,420,-2,-21,-46,2,-1,1,0,2,1,3,2,0,2,1,1,2,-2,2,0,0,6,-2,10,-11,1,3,0,0,0,1,-1,-1,0,-1
KR_6124210416,420,3,-9,17,8,5,0,5,3,0,3,2,1,3,0,1,1,-2,2,0,0,2,-2,-1,-2,3,2,0,1,0,0,1,1,0,-1
KR_6740230515,420,-2,-27,12,-6,-1,2,1,5,2,7,-4,5,1,-4,4,0,-2,2,0,0,-5,4,3,-5,2,-8,0,0,0,1,0,-1,0,-1
KR_6754115066,420,-2,-10,-24,-8,3,0,3,-1,3,2,-2,3,1,-7,8,1,-1,1,0,-2,-18,18,1,-3,2,-2,0,0,-1,1,0,-1,3,-1
KR_6751869073,420,-2,0,4,-3,-6,7,1,2,1,3,2,1,3,1,3,4,-2,2,0,-1,1,213,3,-5,2,0,0,0,1,-1,-1,1,2,-1
KR_6739300481,420,-4,27,-49,-6,4,3,7,-6,6,0,0,2,2,-2,6,4,-2,3,1,-1,-2,-24,6,-8,2,-6,0,0,-1,1,1,-1,5,-1
KR_6687104054,420,0,-18,-8,-2,1,1,2,-5,5,0,0,2,2,2,2,4,0,2,2,0,-8,1,6,-8,2,-6,0,0,-1,-1,0,1,5,-1
KR_6607513826,440,-1,-19,-18,-1,4,0,4,1,1,2,2,0,2,-6,7,1,-2,2,0,-2,-10,105,0,-3,3,0,0,0,0,1,0,-1,0,-1
KR_6657987220,420,-1,-27,4,-2,-2,4,2,2,2,4,0,1,1,3,0,3,-5,5,0,0,2,-5,0,-5,5,-1,0,1,0,1,1,1,0,-1
KR_6750719274,440,-6,-84,-32,-15,-3,3,0,-6,10,4,-2,3,1,-4,4,0,0,0,0,-1,-15,-389,-2,-2,4,-2,0,-3,-1,-1,-1,-1,2,-1
KR_6756072698,420,-5,-109,-14,-17,-3,5,2,-2,3,1,-5,5,0,-3,4,1,-4,4,0,0,-12,-8,0,-2,2,1,0,-4,-1,0,-1,-1,5,-1
KR_6655338914,420,1,3,-1,7,3,0,3,2,3,5,1,3,4,1,4,5,0,1,1,2,15,1,-1,-4,5,1,0,-1,1,-1,-1,1,6,-1
KR_6650108258,420,0,-11,8,1,0,2,2,1,1,2,0,0,0,-2,3,1,2,1,3,0,0,2,8,-10,2,-2,0,-1,-1,1,-1,1,1,-1
KR_6301184784,420,2,15,-20,0,3,0,3,4,3,7,0,3,3,-4,4,0,-3,3,0,-1,-10,-12,-4,-4,8,4,0,0,0,1,0,-1,0,-1
KR_6747011795,420,-5,-39,-23,-17,-2,4,2,-2,4,2,-7,8,1,-2,4,2,-4,4,0,0,-18,225,-3,-1,4,-1,0,0,-1,-1,-1,-1,3,-1
KR_6762557545,420,-2,-38,-3,-10,2,1,3,-8,8,0,1,0,1,-4,5,1,-1,6,5,1,-19,-141,2,-5,3,-5,0,-1,-1,-1,-1,1,1,-1
KR_6759967431,420,-8,-81,-76,-18,-2,3,1,-1,2,1,-5,8,3,-9,12,3,-1,1,0,0,-8,-4,-2,-1,3,-2,0,-3,-1,-1,-1,-1,3,-1
KR_6723416106,420,-1,-70,34,-3,-1,2,1,-3,4,1,1,1,2,0,1,1,0,0,0,0,-5,268,1,-5,4,-1,0,0,1,-1,-1,-1,3,-1
KR_6753651449,420,1,55,-52,2,1,2,3,-4,5,1,1,1,2,0,0,0,4,2,6,0,4,3,-2,-1,3,0,0,2,0,0,1,1,0,-1
KR_6756457322,440,-6,-73,-44,-10,0,1,1,-2,4,2,-8,10,2,0,1,1,0,1,1,0,1,-24,0,-3,3,1,0,-3,-1,-1,-1,1,4,-1
KR_6683827232,420,-1,-53,48,-11,-2,5,3,-3,4,1,-1,4,3,-4,7,3,-1,2,1,0,-3,-5,0,-1,1,3,0,-1,1,0,-1,1,3,-1
KR_6640453622,420,-1,-1,-4,0,6,0,6,1,1,2,-1,4,3,-5,6,1,-1,1,0,0,1,-1,3,-5,2,-7,0,-1,1,1,-1,1,3,-1
KR_6730076976,420,-7,-141,-21,-19,-4,6,2,1,3,4,-11,11,0,-4,4,0,-1,2,1,-1,-8,-122,1,-8,7,-2,0,-2,-1,1,-1,-1,2,-1
KR_6757332819,440,1,-15,-4,3,-2,5,3,1,2,3,-4,5,1,1,2,3,7,0,7,0,6,116,-2,-3,5,3,0,0,-1,-1,0,-1,1,-1
KR_6674492538,420,-3,-34,-10,-4,-1,2,1,0,6,6,-3,3,0,0,0,0,0,0,0,0,6,11,1,-4,3,-4,0,-1,1,-1,-1,1,6,-1
KR_6647027702,420,0,-24,40,-6,-1,2,1,-1,2,1,-1,1,0,-1,1,0,-2,2,0,0,-4,3,-3,-1,4,-1,0,0,1,0,-1,-1,2,-1
KR_6679925491,420,-5,-59,-28,-6,1,1,2,-4,5,1,-2,5,3,-1,1,0,0,0,0,0,-2,-21,-3,-1,4,3,0,-1,-1,-1,-1,1,1,-1
KR_6756277729,420,-10,-75,-35,-17,-4,5,1,-2,2,0,-7,7,0,-4,7,3,0,4,4,0,-12,6,-1,-2,3,-2,0,-5,-1,-1,-1,-1,6,-1
KR_6433334398,420,3,25,-2,12,0,1,1,6,3,9,0,3,3,4,1,5,2,0,2,0,16,10,2,-4,2,-1,0,1,-1,0,1,1,2,-1
KR_6753117218,420,-2,-41,-34,-11,-2,4,2,1,5,6,1,1,2,-8,8,0,-3,3,0,-1,-13,3,0,-2,2,-2,0,0,-1,-1,-1,-1,2,-1
KR_6118860474,420,-4,-10,-38,-19,2,2,4,-1,1,0,-4,4,0,-14,14,0,-2,2,0,0,-22,-9,0,-3,3,-3,0,1,-1,0,1,-1,2,-1
KR_6662550752,420,-4,-98,4,-10,-3,3,0,0,0,0,-6,9,3,0,2,2,-1,1,0,-1,-6,-22,-9,-2,11,2,0,0,1,-1,0,-1,2,-1
KR_6631508759,420,-3,-46,-16,-7,0,3,3,-2,4,2,-2,4,2,1,2,3,-4,4,0,-3,-4,-124,2,-4,2,-2,0,-1,0,0,-1,-1,0,-1
KR_6601506779,420,-5,-82,-32,-10,-6,7,1,-1,2,1,1,1,2,-2,6,4,-2,2,0,-1,-7,-2,1,-4,3,-3,0,0,-1,-1,-1,-1,5,-1
KR_6738613616,420,-5,-62,-38,-3,1,2,3,-8,10,2,1,1,2,2,1,3,1,0,1,0,-1,-35,-6,-2,8,17,0,0,-1,-1,-1,1,4,-1
KR_6764474691,420,-4,-36,-16,-4,1,3,4,-1,4,3,0,2,2,-2,3,1,-2,3,1,1,-11,10,-5,-3,8,-4,0,-1,-1,-1,-1,1,1,-1
KR_6726419754,420,1,63,-4,6,0,1,1,1,2,3,-1,3,2,5,3,8,1,0,1,0,5,1,1,-3,2,-3,0,0,1,1,0,1,3,-1
KR_6743907858,420,1,40,12,-1,0,1,1,-2,2,0,2,1,3,0,2,2,-1,1,0,0,0,-7,1,-4,3,8,0,0,1,-1,0,-1,3,-1
KR_6761987989,420,1,52,46,-10,-2,2,0,-5,9,4,1,0,1,1,2,3,-5,5,0,-1,-18,3,1,-6,5,1,0,2,-1,1,1,-1,1,-1
KR_6761754488,420,1,46,36,7,5,1,6,2,1,3,2,1,3,0,2,2,-2,2,0,0,7,37,2,-2,0,-1,0,0,-1,0,0,-1,5,-1
KR_6711853168,420,-8,-57,-8,3,0,0,0,7,1,8,-1,1,0,0,0,0,-3,3,0,0,3,-22,1,-4,3,1,0,-3,0,-1,-1,1,0,-1
KR_6585012661,420,-1,46,-2,-12,3,1,4,-2,2,0,-2,2,0,-10,10,0,-1,1,0,0,-17,-42,1,-5,4,-2,0,0,-1,-1,1,1,4,-1
KR_6764154302,420,-2,-35,12,-8,-5,6,1,0,2,2,-4,5,1,2,3,5,-1,1,0,0,-5,-7,-4,-2,6,0,0,0,1,-1,-1,-1,4,-1
KR_6758021238,440,-1,26,-7,-1,-3,4,1,3,0,3,2,3,5,-2,5,3,-1,2,1,0,0,5,6,-6,0,-1,0,-2,1,-1,-1,-1,3,-1
KR_6661230375,420,2,-33,-18,1,1,0,1,2,2,4,2,2,4,-4,4,0,0,4,4,0,-1,-6,-1,-1,2,2,0,0,-1,1,0,-1,6,-1
KR_6609079055,420,-1,-59,-4,-2,-3,5,2,6,2,8,-3,4,1,-1,1,0,-1,2,1,1,2,0,-1,-1,2,2,0,-1,1,0,-1,1,5,-1
KR_6723674089,420,1,4,16,-3,2,3,5,1,1,2,-6,7,1,2,3,5,-2,2,0,-1,-5,-8,-1,-2,3,2,0,0,1,1,-1,-1,2,-1
KR_6567412978,420,0,-5,-20,-2,5,0,5,2,0,2,-9,10,1,2,3,5,-2,2,0,0,1,-2,-3,-1,4,-1,0,0,-1,-1,-1,1,1,-1
KR_6743976664,420,-7,-111,-1,-12,-3,3,0,0,4,4,-5,6,1,-4,7,3,0,0,0,-1,-8,10,-3,-1,4,-3,0,0,-1,-1,-1,-1,3,-1
KR_6462840074,420,3,72,16,8,1,3,4,-1,2,1,-1,4,3,4,1,5,5,1,6,0,5,0,-1,-2,3,4,0,2,1,-1,1,1,1,-1
KR_6611190653,420,3,-3,11,4,3,1,4,1,2,3,-1,3,2,0,3,3,1,0,1,0,0,127,2,-7,5,1,0,1,0,1,1,1,0,-1
KR_6760474633,440,-2,35,12,-9,0,3,3,0,1,1,8,3,11,-14,18,4,-3,3,0,4,-13,-3,-1,-3,4,-2,0,-2,-1,-1,-1,1,5,-1
KR_6651921587,420,-5,-101,-23,-12,-4,5,1,0,0,0,-2,3,1,-3,3,0,-3,3,0,0,-7,-5,-2,-2,4,3,0,-3,-1,-1,-1,-1,4,-1
KR_6764093023,420,0,5,0,-3,-2,4,2,5,0,5,-4,4,0,-2,2,0,0,0,0,0,1,-4,-3,-1,4,4,0,0,0,1,0,-1,0,-1
KR_6676404030,440,-1,41,21,-1,-1,1,0,2,2,4,-3,3,0,-2,3,1,3,3,6,0,-7,-5,1,-5,4,-1,0,2,1,1,1,1,1,-1
KR_6627534423,420,-2,-40,40,-7,0,2,2,0,2,2,1,3,4,-6,6,0,-2,2,0,0,-7,-6,2,-2,0,-2,0,-1,0,0,-1,-1,0,-1
KR_6669686421,420,-1,-98,4,-11,-1,3,2,-5,7,2,2,3,5,-6,6,0,-1,3,2,-2,-13,-15,-3,0,3,-2,0,-3,-1,1,-1,-1,4,-1
KR_6763432648,440,2,18,16,-2,1,3,4,3,2,5,-2,2,0,-6,8,2,2,0,2,0,-13,169,-2,-1,3,2,0,0,-1,1,1,-1,2,-1
KR_6631203074,420,-2,-20,8,-8,-2,2,0,1,2,3,-2,4,2,-4,5,1,-1,1,0,0,-8,-6,-2,-2,4,-4,0,-1,-1,-1,-1,-1,1,-1
KR_6375076773,420,0,44,28,-2,0,1,1,-5,5,0,3,2,5,0,0,0,0,1,1,0,-5,0,0,0,0,4,0,0,-1,1,0,1,3,-1
KR_6723274589,420,-5,-19,-17,-18,-1,1,0,-6,7,1,3,1,4,-13,13,0,-1,1,0,0,-16,2,3,-6,3,14,0,-1,-1,-1,-1,-1,6,-1
KR_6743510807,420,-2,-68,16,-2,-1,1,0,-7,9,2,3,2,5,0,3,3,3,1,4,0,2,8,-2,-2,4,1,0,-1,-1,1,-1,1,6,-1
KR_6590404063,420,2,-24,-32,-5,-5,5,0,3,2,5,-1,3,2,-2,2,0,0,0,0,-1,-9,-8,-3,-1,4,2,0,0,-1,1,0,-1,5,-1
KR_6744275307,420,-5,-39,-8,-15,-4,6,2,-6,6,0,-1,3,2,-4,5,1,0,0,0,0,-6,3,-3,-2,5,-2,0,-2,-1,-1,-1,-1,5,-1
KR_6754432457,420,2,1,-7,3,1,3,4,2,4,6,2,0,2,0,4,4,-2,2,0,-1,3,-14,-4,0,4,2,0,-1,0,-1,-1,-1,0,-1
KR_6664530586,420,-6,-106,7,-8,-2,2,0,-1,3,2,-4,4,0,-1,2,1,0,1,1,0,1,-2,0,-1,1,-2,0,-1,1,-1,-1,-1,3,-1
KR_6744014299,420,1,-46,20,3,1,0,1,3,2,5,-4,6,2,1,0,1,2,0,2,0,5,25,-3,-2,5,0,0,0,1,1,0,-1,2,-1
KR_6757939154,420,1,-2,12,-3,1,0,1,3,2,5,-4,4,0,-1,3,2,-2,2,0,0,-1,6,2,-4,2,-21,0,0,-1,1,0,1,2,-1
KR_6638232093,420,-4,-41,16,-13,-6,6,0,-4,5,1,-4,4,0,-2,2,0,3,1,4,-1,-2,-8,-7,-1,8,-3,0,0,0,-1,-1,-1,0,-1
KR_6421003433,420,0,-32,4,-1,1,0,1,-2,3,1,2,2,4,-3,5,2,1,1,2,0,-5,-14,-2,-4,6,-1,0,-1,-1,-1,-1,-1,4,-1
KR_6722774586,420,1,15,40,-4,-5,5,0,0,2,2,1,2,3,-1,4,3,1,0,1,0,-2,-46,1,-3,2,34,0,1,-1,0,-1,-1,1,-1
KR_6736349364,440,5,46,32,8,-1,3,2,2,2,4,5,3,8,1,4,5,1,0,1,0,4,-1,-1,-2,3,2,0,0,1,-1,1,1,3,-1
KR_6743094861,420,-6,-96,-16,-7,-3,4,1,-2,3,1,2,3,5,-7,7,0,3,3,6,0,-3,1,1,-2,1,0,0,-1,1,1,-1,-1,3,-1
KR_6487504633,420,-7,-75,-100,-12,-5,7,2,-3,4,1,-4,4,0,0,0,0,0,0,0,0,-12,85,-2,-1,3,-5,0,-2,-1,-1,-1,-1,1,-1
KR_6617457666,420,0,9,0,-1,0,3,3,2,1,3,1,0,1,-4,4,0,0,0,0,0,-2,8,4,-6,2,-5,0,0,-1,-1,0,1,2,-1
KR_6756634645,440,0,-7,11,-3,-1,2,1,1,1,2,0,2,2,-2,2,0,-1,1,0,0,-2,36,1,-5,4,-21,0,-1,1,-1,-1,-1,3,-1
KR_6681720932,420,1,-56,23,0,-3,3,0,1,1,2,2,2,4,-2,3,1,2,3,5,0,-3,-2,2,-3,1,2,0,0,1,1,0,-1,1,-1
KR_6751240582,420,-3,-31,-16,-6,4,0,4,1,0,1,-10,10,0,-1,1,0,0,2,2,0,0,10,-2,-2,4,2,0,0,-1,-1,-1,-1,1,-1
KR_6690479294,420,-2,-7,12,-3,-1,2,1,-3,6,3,-2,2,0,2,1,3,1,0,1,-2,-2,7,2,-4,2,-2,0,0,1,1,1,-1,5,-1
KR_6753189477,420,-4,-15,-8,-16,-1,2,1,-7,9,2,-2,2,0,-6,6,0,0,0,0,0,-21,-4,-4,0,4,3,0,0,0,-1,0,-1,0,-1
KR_6625181956,420,-3,-29,-8,-7,-1,3,2,-3,5,2,3,0,3,-6,7,1,0,1,1,0,0,406,0,-2,2,0,0,-1,1,1,-1,-1,2,-1
KR_6750437106,420,-4,-76,-19,-5,1,1,2,-3,5,2,-3,4,1,-1,1,0,1,0,1,0,-7,-14,-3,0,3,-3,0,0,0,-1,0,-1,0,-1
KR_6698018571,420,0,-21,-24,2,1,3,4,3,1,4,3,0,3,-3,5,2,-2,4,2,0,1,-334,-1,-2,3,-1,0,0,-1,-1,-1,-1,3,-1
KR_6756234013,440,-9,-67,-52,-30,-9,9,0,-3,4,1,-2,2,0,-13,13,0,-3,4,1,-1,-24,-13,-1,-1,2,0,0,-4,-1,-1,-1,-1,2,-1
KR_6756358203,440,-4,1,7,-3,-1,1,0,2,3,5,1,4,5,-3,3,0,-2,2,0,0,-4,-3,1,-5,4,-4,0,-2,-1,-1,-1,1,3,-1
KR_6759887748,420,-2,-45,0,-5,-2,3,1,-1,3,2,0,2,2,-1,3,2,-1,2,1,0,-5,4,0,-2,2,0,0,-2,-1,-1,-1,1,4,-1
KR_6722762522,420,0,12,-8,0,-1,1,0,2,3,5,-1,6,5,0,5,5,0,1,1,0,5,0,0,-3,3,6,0,0,-1,1,-1,1,1,-1
KR_6690488887,420,-7,-137,-53,-13,-5,5,0,-3,3,0,-1,2,1,-4,4,0,0,1,1,-1,-10,1,-1,-2,3,-3,0,-1,-1,-1,-1,-1,2,-1
KR_6739487500,420,-2,-44,-4,-5,2,0,2,0,2,2,-4,4,0,-3,5,2,0,1,1,0,-3,-6,0,-4,4,-4,0,-2,-1,-1,-1,-1,4,-1
KR_6691061614,420,-1,29,-23,1,1,0,1,0,1,1,2,1,3,0,1,1,-2,2,0,1,2,470,-2,-4,6,3,0,1,1,1,1,1,2,-1
KR_6655929479,420,-6,-83,-29,-3,-4,5,1,-3,4,1,5,2,7,-3,5,2,2,5,7,0,-8,-5,2,-2,0,2,0,0,-1,-1,1,1,4,-1
KR_6645924471,420,1,-33,10,1,3,0,3,-1,4,3,0,2,2,1,4,5,-2,3,1,-2,4,0,1,-5,4,1,0,0,1,-1,0,-1,2,-1
KR_6763797844,420,0,22,7,-2,1,2,3,-1,1,0,0,1,1,-3,4,1,1,0,1,-1,-4,56,2,-4,2,-14,0,0,-1,1,1,-1,4,-1
KR_6728678517,420,-1,-57,0,-11,-4,4,0,1,2,3,-6,7,1,-2,2,0,0,0,0,0,-4,1,-1,0,1,0,0,-2,0,-1,-1,-1,0,-1
KR_6684016215,420,-7,-90,-44,-15,0,1,1,-3,5,2,-8,8,0,-6,7,1,2,1,3,0,-10,-18,0,-2,2,-4,0,-1,-1,-1,-1,1,3,-1
KR_6758945840,420,-1,23,16,-4,-5,5,0,4,1,5,-2,3,1,0,2,2,-1,3,2,0,-2,-1,-3,-1,4,4,0,0,1,0,0,1,6,-1
KR_6632291815,420,-5,-2,-12,-7,-1,2,1,-2,4,2,0,1,1,-2,3,1,-2,3,1,0,-11,-10,-2,-2,4,0,0,0,-1,0,0,-1,3,-1
KR_6722354816,420,0,-53,-40,0,1,1,2,-5,7,2,0,1,1,2,2,4,2,0,2,0,-3,21,1,-5,4,-5,0,0,-1,-1,0,-1,6,-1
KR_6746210622,420,-1,-16,0,-12,0,3,3,1,3,4,-16,16,0,1,2,3,2,1,3,0,-3,33,-1,-2,3,3,0,0,-1,-1,-1,-1,5,-1
KR_6763199045,420,0,-82,-1,-6,0,2,2,-3,5,2,0,2,2,-6,7,1,3,1,4,0,-4,-17,1,-4,3,-3,0,-1,0,0,-1,-1,0,-1
KR_6674374219,440,-4,-58,-4,-9,0,2,2,-1,4,3,1,4,5,-9,9,0,0,0,0,0,-8,24,-4,-1,5,-2,0,-1,-1,-1,-1,-1,1,-1
KR_6739103145,420,0,-24,-12,3,2,1,3,0,2,2,0,1,1,0,1,1,1,0,1,0,3,-5,-3,-4,7,4,0,0,1,-1,0,1,6,-1
KR_6703726553,420,0,-9,-2,-5,2,2,4,-11,12,1,0,0,0,5,1,6,-1,2,1,0,0,-109,0,-5,5,-2,0,-2,-1,-1,-1,-1,2,-1
KR_6678932502,440,-2,-9,10,-5,3,2,5,-2,5,3,0,3,3,-4,5,1,-2,2,0,-1,-2,-4,-4,-2,6,-2,0,0,-1,1,-1,-1,3,-1
KR_6571342881,420,-3,23,13,-1,-5,6,1,-3,10,7,6,1,7,0,1,1,1,1,2,0,1,-21,3,-5,2,-3,0,0,1,-1,-1,1,3,-1
KR_6742377189,420,-2,-49,0,-9,-1,1,0,-3,3,0,-3,3,0,-2,2,0,0,1,1,0,-7,3,6,-8,2,-5,0,-1,-1,0,-1,-1,5,-1
KR_6650493422,420,-4,-27,-8,-7,-5,5,0,1,3,4,3,3,6,-7,7,0,1,0,1,0,0,-8,-1,-4,5,-3,0,0,0,0,-1,-1,0,-1
KR_6691282839,440,-8,-146,-24,-13,2,2,4,-6,7,1,-8,8,0,0,0,0,-1,2,1,-1,-6,-31,-2,-1,3,-2,0,-2,-1,-1,-1,-1,4,-1
KR_6763081337,420,0,-31,-10,7,0,2,2,1,2,3,2,1,3,1,2,3,3,1,4,0,8,241,-1,-4,5,-2,0,0,1,0,0,1,6,-1
KR_6682524739,420,0,-27,4,10,5,0,5,-2,3,1,5,3,8,2,3,5,0,3,3,0,3,0,1,-5,4,0,0,0,1,0,0,1,5,-1
KR_6704160256,420,0,-42,0,-3,0,2,2,1,1,2,3,1,4,-7,8,1,0,1,1,0,-5,3,6,-8,2,-2,0,0,-1,1,-1,-1,6,-1
KR_6641845421,420,0,-14,-8,-1,-2,2,0,-1,3,2,0,1,1,2,0,2,0,3,3,1,0,-11,-2,-3,5,2,0,-1,-1,-1,1,1,1,-1
KR_6670872598,420,1,28,24,2,3,3,6,-2,4,2,-2,2,0,3,0,3,0,4,4,0,0,-2,-3,-1,4,2,0,-1,1,-1,-1,1,5,-1
KR_6720125300,420,1,-85,5,0,0,0,0,0,3,3,-3,4,1,-3,4,1,6,0,6,0,5,-2,1,-4,3,-1,0,0,-1,1,-1,1,6,-1
KR_6732843504,420,0,47,-8,-1,-2,3,1,-2,2,0,-3,4,1,2,1,3,4,1,5,0,2,3,0,-3,3,5,0,1,-1,-1,1,1,3,-1
KR_6577067791,420,-1,-97,-32,-5,-1,3,2,-1,3,2,-6,8,2,0,3,3,3,0,3,-1,-5,15,-3,-3,6,2,0,-1,-1,0,-1,-1,6,-1
KR_6673050454,420,-5,-63,-20,-9,-4,5,1,0,0,0,-4,4,0,-1,6,5,0,5,5,0,3,-12,1,-5,4,0,0,-3,-1,-1,-1,-1,1,-1
KR_6593206131,420,-2,-65,-4,-4,-1,2,1,5,1,6,-4,4,0,-4,5,1,0,0,0,0,-1,-5,4,-7,3,-2,0,-1,-1,1,-1,-1,3,-1
KR_6704528099,420,-2,-32,16,-10,3,0,3,2,1,3,-11,11,0,-5,7,2,1,0,1,-1,-16,-7,0,-2,2,2,0,0,1,1,1,-1,2,-1
KR_6064043872,420,-2,-54,-64,-2,3,2,5,4,1,5,-4,4,0,1,2,3,-6,7,1,1,-5,203,4,-5,1,0,0,-2,1,0,-1,1,5,-1
KR_6727085976,420,-5,-53,-33,-4,-2,4,2,-2,4,2,4,0,4,0,2,2,-4,4,0,1,-7,3,1,-5,4,-3,0,-1,-1,1,-1,1,1,-1
KR_6762759086,420,-3,-26,0,-9,-7,7,0,-3,3,0,1,1,2,0,0,0,0,0,0,0,-5,7,2,-4,2,0,0,0,1,0,-1,-1,6,-1
KR_6638183396,420,-4,-42,-28,-8,-5,5,0,2,0,2,-4,6,2,-1,3,2,0,0,0,0,-1,-150,-1,-4,5,-1,0,-3,1,-1,-1,-1,2,-1
KR_6741506360,440,1,20,-16,2,-2,3,1,1,0,1,-2,2,0,3,1,4,2,2,4,-1,-2,-42,-7,-1,8,27,0,1,-1,1,1,-1,3,-1
KR_6696735971,420,-2,-96,25,1,4,0,4,-3,3,0,-2,6,4,-2,3,1,4,1,5,0,-5,-3,-2,-2,4,0,0,0,-1,0,1,1,6,-1
KR_6584935778,420,2,-44,16,-6,-5,5,0,0,5,5,4,2,6,-5,7,2,0,0,0,0,2,7,4,-9,5,-3,0,-1,-1,-1,-1,-1,2,-1
KR_6722383587,420,-2,-25,19,-5,0,3,3,-3,4,1,-6,7,1,4,4,8,0,2,2,-1,-7,6,-2,-3,5,2,0,1,-1,1,1,-1,2,-1
KR_6676986979,440,-1,66,-4,-2,6,1,7,-4,7,3,1,1,2,0,0,0,-5,5,0,1,-1,199,2,-2,0,0,0,0,-1,1,-1,1,4,-1
KR_6683007190,420,-3,-52,-16,-11,2,3,5,-1,2,1,-4,5,1,-4,6,2,-4,5,1,0,-13,0,2,-3,1,0,0,-1,-1,1,-1,-1,1,-1
KR_6740379782,420,-2,1,-42,5,0,2,2,-1,2,1,-1,4,3,8,2,10,-1,1,0,0,6,3,3,-4,1,-1,0,1,0,1,1,-1,0,-1
KR_6759273051,420,1,34,-12,4,4,1,5,0,2,2,3,1,4,-3,3,0,0,2,2,0,-5,-3,-1,-2,3,0,0,0,-1,1,0,1,4,-1
KR_6561985469,420,-4,5,11,-10,1,0,1,-2,4,2,-6,6,0,-2,4,2,-1,4,3,0,-13,-15,0,-3,3,2,0,-1,1,-1,-1,-1,2,-1
KR_6620079619,420,-3,-74,0,-11,-4,5,1,2,5,7,-6,6,0,-3,4,1,0,0,0,0,-9,24,-3,0,3,-1,0,0,-1,1,0,1,2,-1
KR_6764502640,420,1,42,8,-3,1,1,2,-3,4,1,2,0,2,-3,5,2,0,2,2,0,-10,19,-1,-1,2,0,0,0,-1,-1,0,-1,3,-1
KR_6315263964,440,-1,-26,3,-3,0,1,1,0,2,2,-1,1,0,-2,2,0,0,1,1,0,-5,-27,1,-3,2,-3,0,-1,-1,1,-1,1,6,-1
KR_6579435376,420,-1,-127,16,-12,-11,11,0,2,1,3,0,1,1,-3,4,1,0,1,1,-1,1,-5,-1,-1,2,1,0,-1,1,-1,-1,-1,1,-1
KR_6659835628,420,-7,-71,-32,-10,1,1,2,-10,12,2,2,1,3,-2,3,1,-1,3,2,0,-11,-427,-4,0,4,1,0,-2,-1,-1,-1,1,3,-1
KR_6755745534,420,-3,-53,-35,-3,4,3,7,-1,3,2,-3,4,1,-3,4,1,0,0,0,0,-4,3,0,-4,4,0,0,0,-1,1,1,-1,1,-1
KR_6692793511,420,-3,19,-27,-5,-1,2,1,-1,3,2,-3,3,0,-1,4,3,1,0,1,0,-8,31,-2,-4,6,-19,0,1,0,1,1,1,0,-1
KR_6703387468,420,1,11,12,-3,0,2,2,1,1,2,1,0,1,-3,3,0,-2,2,0,0,-4,-7,-1,-4,5,-3,0,0,0,1,0,-1,0,-1
KR_6432915571,420,-2,26,16,-11,-4,5,1,-4,4,0,1,1,2,-3,3,0,-1,2,1,0,-13,-8,-5,-1,6,2,0,-1,-1,-1,-1,-1,3,-1
KR_6545316903,420,-6,-102,-8,-11,-7,8,1,-2,2,0,1,4,5,0,3,3,-3,5,2,-2,1,10,0,-2,2,-1,0,-2,1,-1,-1,-1,3,-1
KR_6625265352,420,3,-48,-10,7,2,1,3,-2,4,2,1,2,3,5,0,5,1,1,2,0,7,4,3,-7,4,-4,0,0,0,1,0,1,0,-1
KR_6764530747,420,-5,-110,3,-6,-5,6,1,1,2,3,3,0,3,-3,4,1,-2,2,0,0,-4,287,3,-5,2,1,0,-1,-1,0,-1,-1,1,-1
KR_6755771178,420,-3,-54,-11,-2,2,2,4,-5,5,0,1,1,2,2,0,2,-2,3,1,0,-7,-266,1,-3,2,-1,0,0,-1,-1,-1,-1,6,-1
KR_6750826855,420,0,-90,8,-1,-2,3,1,0,2,2,-1,3,2,0,2,2,2,0,2,0,-6,-1,-2,0,2,3,0,0,0,-1,0,-1,0,-1
KR_6707334234,420,-3,-27,-20,-8,-2,4,2,-3,3,0,-1,3,2,-2,4,2,0,2,2,0,-11,1,-3,-1,4,1,0,0,-1,0,-1,-1,5,-1
KR_6744930299,420,-4,-12,-23,-11,3,1,4,-9,9,0,-5,5,0,-1,3,2,1,1,2,0,-4,-4,3,-5,2,-1,0,-1,-1,1,-1,-1,3,-1
KR_6686622572,420,0,13,1,-5,1,3,4,-2,3,1,-1,2,1,-2,3,1,-1,1,0,0,-7,11,-2,0,2,5,0,0,-1,0,1,1,5,-1
KR_6680503149,420,-2,-42,-20,-15,-5,5,0,2,2,4,-4,6,2,-3,6,3,-5,6,1,0,-8,-270,-1,-1,2,-2,0,-2,-1,-1,-1,-1,2,-1
KR_6754878727,440,0,32,-52,-2,3,0,3,0,4,4,-2,2,0,-3,5,2,0,0,0,0,-5,2,2,-4,2,2,0,0,0,0,1,-1,0,-1
KR_6746541883,420,-5,-34,-16,-5,1,2,3,1,2,3,-3,3,0,-2,3,1,-2,2,0,0,-5,-2,-1,-5,6,-1,0,-1,-1,0,-1,-1,3,-1
KR_6567886086,420,1,77,-24,0,0,0,0,-1,2,1,2,4,6,-3,5,2,2,0,2,-1,0,8,2,-3,1,1,0,2,-1,-1,1,-1,3,-1
KR_6335933352,420,1,-24,12,-3,1,2,3,-3,5,2,-1,4,3,0,3,3,0,1,1,0,-10,-9,-2,-2,4,1,0,0,-1,-1,0,-1,6,-1
KR_6722680847,420,-2,-64,-20,-7,-4,5,1,0,1,1,-2,2,0,-1,1,0,0,1,1,0,-3,8,-1,-3,4,-1,0,0,0,0,-1,1,0,-1
KR_6763744371,420,-1,-16,27,-6,1,0,1,-1,3,2,-3,5,2,-2,3,1,-1,2,1,0,-7,45,-3,-3,6,11,0,-2,-1,-1,-1,-1,6,-1
KR_6764639112,420,-3,-29,-4,-10,-1,1,0,0,2,2,-4,4,0,-5,5,0,0,1,1,0,-9,7,-4,0,4,0,0,0,0,0,0,-1,0,-1
KR_6753681815,420,4,54,-7,18,4,0,4,4,1,5,2,2,4,8,1,9,0,1,1,0,16,-53,5,-6,1,20,0,1,1,0,1,1,3,-1
KR_6700342998,440,2,46,-4,10,1,1,2,2,5,7,5,1,6,3,0,3,-1,1,0,1,6,1,1,-5,4,-1,0,1,0,-1,1,1,0,-1
KR_6694973938,440,-4,-89,-1,-11,-2,6,4,-4,5,1,1,0,1,-4,6,2,-2,4,2,-1,-2,7,0,-3,3,2,0,-2,0,-1,-1,-1,0,-1
KR_6601549379,420,-4,-43,-13,-9,-2,3,1,-1,4,3,-2,7,5,-3,5,2,-1,1,0,-1,-10,247,-3,-2,5,-1,0,-1,-1,-1,-1,-1,1,-1
KR_6727632518,420,0,-101,-12,-7,-5,7,2,-1,1,0,2,1,3,-3,7,4,0,2,2,0,4,-6,-3,-3,6,-1,0,-1,1,-1,-1,1,3,-1
KR_6702549352,420,-1,-34,24,-3,0,2,2,-5,6,1,-1,1,0,2,2,4,1,1,2,0,-4,0,6,-7,1,0,0,0,0,-1,-1,1,0,-1
KR_6760087720,420,-2,-4,-8,-3,-2,2,0,-2,4,2,1,2,3,0,1,1,0,0,0,0,1,-1,-1,-1,2,-2,0,0,1,1,0,-1,3,-1
KR_6756477147,420,2,9,10,-2,-1,2,1,-5,6,1,5,1,6,-1,4,3,0,1,1,0,-17,-13,-7,0,7,4,0,0,1,0,1,1,1,-1
KR_6594365886,420,2,48,4,5,-3,4,1,1,3,4,-1,3,2,7,0,7,1,1,2,0,-2,-3,-1,-1,2,1,0,2,0,-1,1,1,0,-1
KR_6690015792,420,-6,-55,-32,-11,-1,2,1,-5,6,1,-4,5,1,0,3,3,-1,1,0,0,-5,-14,-3,0,3,0,0,0,-1,-1,-1,-1,5,-1
KR_6719481354,440,-1,-43,-4,-1,-1,3,2,2,2,4,-2,2,0,0,0,0,0,1,1,0,-2,-4,-3,-2,5,3,0,0,-1,1,0,1,3,-1
KR_6258628040,420,5,11,33,9,1,1,2,10,0,10,3,3,6,-5,7,2,0,1,1,0,1,5,5,-6,1,2,0,0,1,1,1,1,4,-1
KR_6630509450,420,-3,-22,10,-6,1,1,2,0,4,4,-1,3,2,-5,5,0,-1,4,3,0,-6,-40,0,-4,4,26,0,0,-1,-1,0,-1,3,-1
KR_6763310584,420,0,-37,-5,-1,2,3,5,-1,3,2,-1,3,2,-1,3,2,0,0,0,-1,-1,0,3,-4,1,1,0,1,-1,0,1,-1,4,-1
KR_6749279769,440,2,5,-24,9,1,2,3,-2,3,1,1,2,3,7,1,8,2,2,4,-1,2,7,1,-3,2,1,0,0,-1,-1,-1,-1,1,-1
KR_6685130888,420,2,7,4,9,-2,4,2,0,1,1,7,0,7,2,0,2,2,0,2,0,8,-7,-2,-3,5,0,0,1,-1,1,1,-1,6,-1
KR_6645539233,440,0,81,32,-5,1,1,2,3,1,4,2,2,4,-12,13,1,1,0,1,0,-11,-1,-1,-2,3,1,0,-1,-1,0,1,1,3,-1
KR_6651007995,420,-4,-42,-46,-7,-3,3,0,-4,4,0,-1,2,1,0,2,2,1,0,1,0,-4,-210,-1,-2,3,-3,0,0,-1,-1,0,-1,5,-1
KR_6723998312,420,-2,79,1,-10,1,1,2,-5,6,1,0,2,2,-3,4,1,-3,4,1,-2,-16,27,1,-5,4,-4,0,0,-1,1,0,1,4,-1
KR_6591006346,420,-6,-122,-8,-12,-8,9,1,-1,2,1,0,1,1,1,5,6,-4,6,2,0,-12,10,-5,-1,6,3,0,-2,1,0,-1,1,2,-1
KR_6611944432,420,-5,-29,-47,-7,4,0,4,-4,6,2,-1,4,3,-5,5,0,-1,2,1,0,-11,-1,2,-5,3,0,0,-1,-1,-1,-1,1,3,-1
KR_6731298459,420,4,24,8,-2,0,2,2,-4,4,0,2,0,2,0,1,1,0,0,0,0,0,-7,-1,-1,2,3,0,-1,1,-1,-1,-1,2,-1
KR_6757492802,420,0,-12,-20,-2,2,1,3,-1,2,1,0,2,2,-2,2,0,-1,2,1,0,-1,-4,1,-4,3,2,0,0,-1,0,0,-1,5,-1
KR_5751771386,440,-5,-19,20,-9,-2,4,2,-1,6,5,-3,3,0,-2,6,4,-1,1,0,0,-10,257,-3,-2,5,1,0,-2,-1,-1,-1,-1,2,-1
KR_6612550698,420,-1,47,14,0,-2,2,0,5,1,6,2,1,3,-5,6,1,0,2,2,0,-2,8,-7,-1,8,-2,0,1,-1,1,1,-1,2,-1
KR_6667227378,420,-1,-13,4,-3,0,1,1,-2,4,2,2,2,4,-2,2,0,-1,2,1,-1,-7,-3,2,-5,3,1,0,0,1,-1,0,-1,4,-1
KR_6757367983,420,0,5,-32,-2,0,1,1,-1,2,1,-1,5,4,0,3,3,0,0,0,0,2,-3,-3,-4,7,-3,0,-1,-1,-1,-1,-1,2,-1
KR_6759321373,420,-1,46,7,2,-3,5,2,-1,3,2,-5,7,2,11,2,13,0,0,0,0,3,-6,-7,0,7,3,0,-1,-1,-1,1,1,2,-1
KR_6510815719,420,0,72,-44,-1,2,2,4,3,1,4,1,1,2,-2,5,3,-5,6,1,1,0,346,-3,0,3,0,0,0,-1,1,1,1,6,-1
KR_6723638379,420,0,-91,0,2,-3,3,0,2,5,7,1,2,3,3,0,3,-1,1,0,0,13,3,-1,0,1,2,0,-1,1,-1,-1,1,6,-1
KR_6659708229,420,-1,-69,-24,0,2,0,2,-6,7,1,2,3,5,2,1,3,0,0,0,0,1,-8,-1,-5,6,2,0,-1,-1,-1,-1,-1,5,-1
KR_6721547233,440,3,10,-3,4,-1,2,1,-4,5,1,9,0,9,2,0,2,-2,2,0,0,3,4,0,-1,1,-2,0,1,-1,-1,-1,-1,5,-1
KR_6753456805,420,0,37,-8,1,1,2,3,2,1,3,-7,7,0,3,0,3,2,0,2,0,6,4,0,-4,4,-3,0,0,-1,0,0,-1,3,-1
KR_6627310606,420,-4,-40,-3,-11,0,1,1,-5,6,1,2,3,5,-9,9,0,1,2,3,1,-11,9,3,-5,2,-4,0,-1,-1,1,1,1,3,-1
KR_6750378211,420,-3,-57,-7,-12,1,3,4,-1,4,3,1,4,5,-12,16,4,-1,4,3,0,-3,-7,-7,0,7,3,0,-2,-1,-1,-1,-1,1,-1
KR_6758990301,420,0,21,-36,4,-1,2,1,-3,6,3,1,1,2,6,2,8,1,0,1,0,10,1,-4,-3,7,-4,0,1,-1,1,1,1,4,-1
KR_6646919918,420,-3,-27,-6,-7,-2,2,0,-4,6,2,-3,6,3,2,0,2,0,0,0,0,-2,0,1,-3,2,-2,0,-2,1,-1,-1,-1,6,-1
KR_6710978355,420,-3,-111,26,-7,-3,3,0,-6,7,1,0,1,1,2,2,4,0,1,1,0,-4,1,-3,-4,7,-3,0,-1,-1,-1,-1,-1,4,-1
KR_6760544921,420,-1,9,4,-4,1,1,2,-1,2,1,-2,2,0,-2,3,1,0,1,1,0,-4,-7,1,-1,0,1,0,-1,1,-1,-1,1,3,-1
KR_6622481455,420,-6,-89,-7,-9,-2,2,0,0,5,5,-4,5,1,0,3,3,-3,4,1,0,-1,17,1,-8,7,-2,0,-2,-1,-1,-1,1,6,-1
KR_6759802505,420,-1,-24,12,-5,-5,5,0,-2,3,1,-3,5,2,4,1,5,1,2,3,0,4,-5,-3,0,3,0,0,-1,-1,-1,-1,1,6,-1
KR_6756731668,420,1,-44,-13,5,3,0,3,1,0,1,-1,1,0,-1,3,2,3,0,3,0,6,115,-2,-1,3,-1,0,0,1,-1,-1,-1,4,-1
KR_6756406409,420,1,-12,-2,6,1,1,2,-1,4,3,1,3,4,4,1,5,1,0,1,0,11,-109,0,-2,2,-3,0,0,-1,-1,1,1,3,-1
KR_6677687236,420,-1,-85,24,3,1,2,3,0,2,2,0,2,2,0,1,1,2,1,3,0,0,-2,0,-3,3,0,0,-1,1,1,-1,-1,6,-1
KR_6392026928,420,-4,-126,-54,-7,0,1,1,0,4,4,0,4,4,-4,4,0,-3,4,1,0,-6,-9,-4,-2,6,-2,0,0,-1,0,0,-1,1,-1
KR_6731071688,420,0,-12,16,2,0,0,0,-1,1,0,0,3,3,2,2,4,1,0,1,0,-1,-3,1,-4,3,-1,0,0,0,1,0,1,0,-1
KR_6647678034,440,1,-30,25,-2,0,0,0,-4,5,1,-4,4,0,2,1,3,4,1,5,0,-3,122,-6,0,6,0,0,0,1,-1,0,1,6,-1
KR_6719258870,420,-1,29,-13,-6,-3,3,0,-1,2,1,3,2,5,-5,5,0,0,1,1,0,-4,1,-3,-5,8,1,0,0,-1,-1,0,-1,2,-1
KR_6761845676,420,-2,55,20,5,-3,5,2,3,1,4,6,0,6,0,2,2,-1,1,0,1,3,9,-1,0,1,-2,0,-1,1,-1,-1,1,6,-1
KR_6653668791,420,-1,-94,-12,-2,-3,3,0,-7,8,1,5,2,7,2,1,3,1,0,1,0,3,-266,0,-2,2,-3,0,-1,-1,1,-1,1,1,-1
KR_6724114743,420,-5,-28,-48,-16,-7,7,0,-6,6,0,-5,5,0,0,1,1,2,0,2,0,-7,-4,-3,-4,7,-1,0,-2,-1,-1,-1,-1,3,-1
KR_6755494004,420,-2,-43,-4,-5,-1,4,3,5,1,6,-7,7,0,-1,2,1,-1,1,0,0,0,-4,-2,-4,6,4,0,-1,-1,1,1,1,4,-1
KR_6682750831,440,-3,-68,-20,-9,-1,2,1,-1,2,1,-11,13,2,3,2,5,1,0,1,0,1,-6,0,-3,3,1,0,-4,0,-1,-1,-1,0,-1
KR_6679659053,420,3,83,9,7,5,1,6,8,2,10,-3,5,2,1,1,2,-4,4,0,0,0,2,0,-4,4,2,0,0,0,-1,1,1,0,-1
KR_6465569105,420,-5,-55,-8,-2,2,2,4,-4,5,1,3,0,3,-3,4,1,0,0,0,1,-8,5,6,-7,1,-4,0,-2,-1,1,-1,1,5,-1
KR_6708623332,440,-2,-5,-8,-3,4,2,6,-2,5,3,-2,7,5,-4,4,0,1,1,2,0,-6,-8,-3,-2,5,-3,0,0,1,1,0,-1,3,-1
KR_6757247862,420,-1,2,-3,4,-2,4,2,1,2,3,6,0,6,-1,6,5,0,0,0,0,11,-7,-3,-3,6,3,0,-1,1,-1,-1,-1,4,-1
KR_6669116898,420,0,23,4,-9,-3,6,3,-1,3,2,-1,4,3,-2,4,2,-2,4,2,1,0,-161,1,-2,1,-2,0,0,-1,1,0,1,1,-1
KR_6660485968,420,0,9,-16,1,5,2,7,3,1,4,-4,5,1,-4,7,3,1,2,3,-2,2,1,-1,-2,3,-2,0,1,-1,-1,1,-1,1,-1
KR_6258654316,420,6,38,8,8,0,5,5,5,1,6,-1,1,0,1,1,2,3,0,3,-1,7,148,-1,-4,5,-5,0,0,1,0,0,-1,1,-1
KR_6731516615,420,-5,-77,-8,-16,0,3,3,-2,3,1,-5,8,3,-4,6,2,-5,5,0,-1,-13,-8,3,-7,4,-1,0,0,-1,-1,0,-1,3,-1
KR_6131690188,420,-2,-46,13,-7,-3,3,0,5,2,7,-4,6,2,-2,5,3,-3,3,0,0,-7,-14,-3,-4,7,-3,0,-1,-1,1,-1,-1,2,-1
KR_6660718906,420,-2,-18,-24,-5,-3,4,1,5,1,6,-6,6,0,0,0,0,-1,1,0,1,-3,5,3,-3,0,-2,0,0,-1,1,0,1,4,-1
KR_6686208677,420,-1,-66,11,-11,-1,4,3,-7,7,0,1,2,3,-3,4,1,-1,2,1,-1,-18,8,0,-2,2,-1,0,-1,0,-1,-1,-1,0,-1
KR_6658983594,420,-1,-73,4,2,-2,4,2,2,2,4,4,3,7,0,1,1,-2,2,0,0,1,-35,1,-6,5,9,0,1,1,1,1,-1,5,-1
KR_6727873272,420,-6,-137,-1,-4,-4,4,0,1,2,3,-5,8,3,1,1,2,3,1,4,0,2,-45,1,-5,4,14,0,-3,1,-1,-1,-1,6,-1
KR_6756461792,420,-4,-27,-3,-4,-2,2,0,0,1,1,2,0,2,-1,2,1,-3,3,0,0,-4,-6,-1,-3,4,-3,0,-1,0,0,-1,1,0,-1
KR_6618552833,420,-2,-78,20,-7,-2,4,2,0,1,1,-2,6,4,-1,4,3,-2,3,1,-1,-11,186,-1,-3,4,-2,0,-2,-1,-1,-1,-1,3,-1
KR_6761571510,440,0,22,19,2,-2,3,1,3,3,6,3,2,5,0,1,1,-2,4,2,-1,4,4,-1,-2,3,-1,0,2,1,0,1,-1,3,-1
KR_6654933175,420,0,-35,19,5,-3,5,2,4,2,6,0,2,2,4,1,5,0,0,0,0,6,395,-2,-2,4,1,0,0,1,1,0,-1,6,-1
KR_6762104621,420,-1,16,-8,-1,-1,3,2,1,1,2,1,0,1,2,5,7,-4,5,1,0,-2,28,1,-4,3,-17,0,0,1,-1,1,1,6,-1
KR_6735509054,440,-5,-108,-12,-7,-5,5,0,0,0,0,3,0,3,-4,5,1,-1,1,0,0,-8,-3,2,-6,4,-3,0,-2,-1,-1,-1,-1,2,-1
KR_6729294101,440,-2,-60,1,-9,-3,5,2,-4,4,0,0,1,1,1,1,2,-3,3,0,0,3,-10,-6,0,6,1,0,-2,-1,-1,-1,-1,4,-1
KR_6161563409,420,3,5,3,2,0,1,1,-5,7,2,3,2,5,1,1,2,3,1,4,0,4,-3,-2,-3,5,-6,0,-1,-1,-1,-1,-1,5,-1
KR_6762453989,420,-4,-28,-13,-9,-1,3,2,-7,8,1,-4,5,1,-2,2,0,5,0,5,0,-1,0,0,-3,3,0,0,0,1,0,0,1,6,-1
KR_6722418674,420,1,5,22,3,0,0,0,5,1,6,-1,3,2,-1,3,2,0,2,2,0,5,296,-1,-1,2,-3,0,0,1,-1,0,1,6,-1
KR_6753697199,420,0,24,-19,-1,-3,3,0,2,1,3,-6,7,1,6,2,8,0,0,0,0,6,36,6,-10,4,-3,0,0,-1,-1,-1,1,4,-1
KR_6754769779,440,-3,-121,36,-13,-3,3,0,2,0,2,-5,7,2,-7,7,0,0,1,1,-1,-6,-38,0,-1,1,35,0,-4,-1,-1,-1,-1,5,-1
KR_6645123068,420,-2,-38,8,-3,2,1,3,-2,2,0,-5,6,1,2,4,6,0,0,0,0,0,-3,-4,0,4,2,0,1,1,1,1,1,6,-1
KR_6620483503,420,-5,-174,-44,-7,-4,8,4,0,1,1,-1,3,2,-1,2,1,-1,1,0,-1,-4,-7,4,-7,3,0,0,-4,-1,-1,-1,-1,5,-1
KR_6716812824,440,0,-30,-16,1,1,1,2,-3,5,2,-8,8,0,11,3,14,0,1,1,-1,1,180,-6,-2,8,1,0,0,0,1,1,-1,0,-1
KR_6571332185,420,-4,-21,-16,-10,0,2,2,-2,8,6,-4,5,1,-3,4,1,-1,1,0,0,-13,-7,-1,-1,2,0,0,-3,0,-1,-1,-1,0,-1
KR_6737652132,440,-2,-60,19,-3,-2,2,0,0,1,1,1,0,1,-3,4,1,1,3,4,0,-5,21,6,-7,1,-6,0,-1,1,-1,-1,-1,6,-1
KR_6761854266,420,2,-7,16,7,0,2,2,4,3,7,1,2,3,1,6,7,1,3,4,0,12,7,4,-6,2,1,0,0,0,0,1,1,0,-1
KR_6227592805,420,-7,-89,-8,-11,-3,3,0,-6,8,2,-3,3,0,2,0,2,-1,1,0,0,-9,-31,1,-4,3,29,0,-1,1,1,-1,1,3,-1
KR_6733980844,420,-1,-90,16,-5,-7,8,1,0,2,2,3,2,5,-1,1,0,0,0,0,0,-5,-6,2,-5,3,-2,0,0,-1,1,0,1,6,-1
KR_6746130148,420,-2,-55,4,-2,-1,1,0,2,1,3,0,3,3,-1,2,1,-2,3,1,0,1,-197,-2,-4,6,0,0,-2,-1,-1,-1,1,2,-1
KR_6724747253,440,-8,-79,-24,-19,-5,6,1,-1,5,4,-3,3,0,-6,7,1,-4,7,3,0,-9,19,0,-2,2,-2,0,-2,-1,-1,-1,-1,5,-1
KR_6706407382,440,4,-8,19,4,0,1,1,1,0,1,-4,9,5,8,1,9,-1,2,1,0,-4,-311,0,-3,3,3,0,0,-1,-1,0,-1,2,-1
KR_6599034071,440,-2,-62,-16,-4,0,0,0,4,4,8,0,0,0,-6,8,2,-2,2,0,-1,-4,2,2,-8,6,2,0,0,1,0,0,-1,2,-1
KR_6660920648,420,2,-47,16,-5,2,3,5,5,1,6,-7,8,1,-4,4,0,-1,2,1,0,3,228,-3,0,3,1,0,-1,1,-1,-1,-1,4,-1
KR_6673061111,420,-1,16,-36,-2,-1,1,0,0,3,3,1,2,3,1,1,2,-3,6,3,-1,2,0,-5,-2,7,2,0,0,1,-1,1,-1,4,-1
KR_6692552234,420,-5,1,8,-14,-4,4,0,-1,2,1,-10,12,2,-1,3,2,2,0,2,-1,-19,2,-2,-1,3,4,0,0,1,1,1,-1,3,-1
KR_6664063505,420,-1,-45,-19,-5,1,3,4,-1,2,1,-8,8,0,3,1,4,0,0,0,0,-10,-19,1,-4,3,-3,0,-1,1,-1,-1,1,2,-1
KR_6606897664,420,-7,-67,-48,-13,-2,3,1,-4,5,1,-2,5,3,-2,3,1,-3,3,0,0,-9,2,3,-6,3,-1,0,-2,0,-1,-1,1,0,-1
KR_6764283361,420,-3,-19,-43,-5,0,1,1,-5,5,0,-2,6,4,0,5,5,2,1,3,0,-7,-20,3,-5,2,-7,0,0,-1,-1,0,1,1,-1
KR_6622953108,420,3,93,14,9,3,0,3,1,4,5,6,2,8,3,2,5,-4,5,1,0,3,-7,-1,-2,3,-1,0,1,1,-1,1,1,1,-1
KR_6727556234,420,0,44,12,0,-3,4,1,2,0,2,0,2,2,-3,6,3,4,1,5,0,2,116,1,-3,2,2,0,0,1,1,1,1,2,-1
KR_6753641784,440,-1,-29,-16,-1,2,0,2,-4,4,0,-2,3,1,2,3,5,1,1,2,0,1,-4,-3,-1,4,2,0,1,-1,1,1,1,1,-1
KR_6640740597,420,-3,-24,-48,-4,-1,1,0,-6,7,1,1,1,2,2,2,4,0,0,0,0,-2,-65,-1,-4,5,11,0,0,-1,0,0,-1,4,-1
KR_6618882359,420,-2,-5,-25,-3,-4,4,0,-1,2,1,2,2,4,-1,3,2,1,0,1,0,-2,0,-4,-1,5,5,0,-1,-1,-1,1,1,3,-1
KR_6750164472,440,0,-8,-23,5,3,0,3,5,2,7,-1,2,1,-1,2,1,-1,1,0,0,0,-4,-2,-1,3,2,0,1,0,0,1,1,0,-1
KR_6737022039,420,-2,-68,-20,0,-1,1,0,0,5,5,1,0,1,0,2,2,0,1,1,0,-1,-23,-5,-2,7,8,0,-2,-1,-1,-1,1,4,-1
KR_6747440854,420,0,-4,-28,1,1,1,2,1,2,3,1,4,5,0,1,1,-2,2,0,0,7,-22,0,-3,3,-6,0,0,0,1,-1,-1,0,-1
KR_6749665866,420,0,-12,12,-5,-4,5,1,5,1,6,-4,4,0,0,2,2,-2,3,1,2,2,-8,-2,-1,3,-2,0,-1,1,-1,-1,1,5,-1
KR_6542051166,420,2,62,-27,2,1,3,4,0,2,2,-2,2,0,2,1,3,1,0,1,0,0,-6,3,-6,3,2,0,1,1,1,1,-1,1,-1
KR_6624831698,420,2,-5,8,-2,2,0,2,-1,1,0,-4,5,1,1,1,2,0,1,1,0,0,-2,-2,-3,5,0,0,1,1,0,1,-1,5,-1
KR_6659623720,420,-3,8,1,-12,-3,5,2,0,1,1,-7,7,0,0,2,2,-2,3,1,0,-9,-259,-3,-3,6,2,0,0,-1,1,0,-1,5,-1
KR_6755627283,420,-3,-6,16,-5,-3,4,1,1,3,4,1,0,1,-4,5,1,0,2,2,0,-1,2,-2,-3,5,-4,0,0,1,1,0,-1,2,-1
KR_6723013772,420,-1,4,-31,-5,-1,5,4,0,6,6,-4,6,2,1,1,2,-1,1,0,0,-3,7,-4,-2,6,1,0,0,1,-1,0,-1,6,-1
KR_6552964192,420,-1,-68,-22,-9,2,0,2,-10,10,0,-3,3,0,2,2,4,0,1,1,-1,-1,-26,4,-8,4,6,0,0,-1,1,1,-1,5,-1
KR_6762307530,420,-5,-110,-8,-7,1,1,2,-1,2,1,-6,6,0,0,0,0,-1,1,0,1,-3,-11,-3,-1,4,-1,0,-2,0,-1,-1,1,0,-1
KR_6673897218,440,0,34,3,6,2,3,5,3,4,7,-4,5,1,1,3,4,4,3,7,1,13,-294,0,-3,3,2,0,0,1,-1,-1,1,5,-1
KR_6739314756,420,0,-98,-16,1,-1,1,0,0,2,2,1,1,2,1,0,1,0,2,2,0,-1,77,-3,-2,5,3,0,-1,-1,0,-1,-1,1,-1
KR_6752247080,420,-3,-51,-31,-9,-1,4,3,-3,4,1,-6,7,1,0,3,3,1,1,2,1,-5,1,-1,-2,3,5,0,-1,-1,-1,-1,1,6,-1
KR_6695427113,420,-2,-57,5,-3,-2,2,0,-1,1,0,-4,5,1,1,2,3,3,0,3,0,-6,0,4,-6,2,-2,0,-1,-1,-1,-1,1,2,-1
KR_6601045478,440,0,50,-8,-8,0,2,2,-1,4,3,-5,6,1,1,2,3,-3,3,0,0,-4,7,0,-1,1,-1,0,0,-1,-1,0,-1,6,-1
KR_6418783692,420,-5,-79,-20,-11,-6,6,0,2,2,4,0,3,3,-7,8,1,0,0,0,0,-10,21,2,-2,0,0,0,-2,1,-1,-1,1,2,-1
KR_6750300786,420,-5,-61,-12,-7,-2,5,3,0,1,1,-4,5,1,1,1,2,-2,4,2,0,-5,-5,-1,-4,5,-2,0,-1,0,0,-1,1,0,-1
KR_6734211476,440,3,42,10,7,2,0,2,-1,1,0,0,2,2,1,0,1,5,0,5,0,6,3,1,-5,4,3,0,1,0,1,1,1,0,-1
KR_6757778394,420,-1,-45,-12,-6,1,1,2,3,0,3,-6,6,0,-5,6,1,1,1,2,0,3,-27,-8,-3,11,-3,0,-1,-1,-1,-1,-1,3,-1
KR_6568308161,420,-3,-41,-25,-7,-5,5,0,-3,5,2,1,1,2,-3,5,2,3,0,3,0,-2,-31,-7,-1,8,4,0,-2,-1,-1,-1,1,2,-1
KR_6756281443,420,-2,-29,5,-5,-1,1,0,1,3,4,1,1,2,-5,5,0,-1,1,0,0,-4,4,4,-4,0,-2,0,0,1,1,0,-1,1,-1
KR_6743985923,440,-4,-58,-4,-9,-1,4,3,0,4,4,0,1,1,-7,7,0,-1,1,0,-1,-7,3,-3,-1,4,2,0,0,-1,-1,-1,-1,1,-1
KR_6592183193,440,0,-54,-14,3,-3,4,1,0,3,3,2,0,2,3,1,4,1,1,2,1,5,3,0,-4,4,0,0,0,-1,1,1,1,2,-1
KR_6764094246,440,1,67,8,0,4,1,5,0,1,1,-2,2,0,1,3,4,-3,5,2,1,-6,-4,1,-3,2,-1,0,1,-1,-1,1,1,5,-1
KR_6707550856,420,-1,-88,20,0,-1,1,0,5,1,6,-2,3,1,0,3,3,-2,2,0,1,0,125,4,-6,2,3,0,0,1,0,0,1,1,-1
KR_6741268625,420,-2,-24,3,-1,-4,4,0,3,2,5,-2,5,3,1,3,4,1,3,4,0,4,110,-1,-4,5,-2,0,1,0,1,1,-1,0,-1
KR_6712788540,420,1,-13,0,-1,-4,5,1,1,0,1,3,0,3,0,2,2,-1,1,0,0,1,-45,-3,0,3,1,0,0,1,1,0,-1,2,-1
KR_6592343957,440,-3,-27,-12,-4,0,1,1,0,8,8,-3,5,2,-1,2,1,0,2,2,0,-2,-6,3,-4,1,-3,0,-1,-1,0,-1,-1,2,-1
KR_6748827258,420,0,-9,-21,0,0,2,2,-2,2,0,1,2,3,-1,8,7,2,1,3,0,0,7,5,-7,2,-2,0,0,1,-1,0,-1,5,-1
KR_6754573780,420,0,-77,-3,-2,-7,7,0,1,2,3,3,1,4,2,0,2,-1,1,0,0,0,7,-1,-4,5,-5,0,-2,0,-1,-1,-1,0,-1
KR_6755964501,420,-4,-99,17,-15,-4,4,0,-3,3,0,-2,5,3,-7,7,0,1,0,1,-2,-16,163,-1,-1,2,-1,0,-4,-1,1,-1,-1,1,-1
KR_6693954228,420,-2,-71,-48,-4,-11,12,1,2,1,3,1,1,2,1,3,4,3,1,4,-1,5,-8,0,-4,4,-2,0,0,1,-1,-1,-1,3,-1
KR_6391678106,420,-1,7,-9,-1,-1,1,0,-5,6,1,3,4,7,3,0,3,-1,1,0,0,-4,-1,0,-2,2,-1,0,1,-1,-1,1,1,6,-1
KR_6622364839,420,-8,-153,-10,-17,-6,8,2,-6,6,0,-1,2,1,-2,4,2,-2,2,0,-1,-8,-9,-3,0,3,4,0,-2,-1,0,-1,-1,2,-1
KR_6094741510,440,0,-11,-1,-1,-1,1,0,-2,2,0,0,6,6,0,1,1,2,0,2,0,0,-127,2,-3,1,-3,0,0,0,1,0,-1,0,-1
KR_6615844810,440,-2,-81,4,-3,-4,5,1,7,3,10,-2,6,4,-3,4,1,-1,1,0,-1,-11,7,0,-6,6,4,0,0,-1,1,0,-1,1,-1
KR_6542015246,420,-3,-66,-8,-11,-7,8,1,1,2,3,-3,8,5,-4,4,0,2,0,2,-1,-3,-11,-1,-1,2,0,0,-1,1,1,-1,-1,3,-1
KR_6132329406,440,0,-6,4,-1,-1,4,3,-1,2,1,3,0,3,-2,3,1,0,0,0,-1,3,-2,0,-3,3,-2,0,-2,-1,-1,-1,-1,5,-1
KR_6599794313,420,0,-8,13,-3,-3,5,2,-4,5,1,0,5,5,3,3,6,1,1,2,1,-1,-145,3,-5,2,-8,0,2,1,-1,1,1,6,-1
KR_6728334164,420,-1,-43,7,-3,1,2,3,0,1,1,-1,2,1,-3,4,1,0,0,0,0,-5,-9,1,-4,3,1,0,0,-1,1,0,1,1,-1
KR_5915670245,420,-2,-51,0,-10,-7,7,0,-2,6,4,-1,3,2,-1,2,1,1,0,1,1,-6,-1,-3,-2,5,-4,0,-1,1,1,-1,1,3,-1
KR_6760534908,420,-3,-118,-8,-12,-4,4,0,0,3,3,-4,6,2,-2,4,2,-2,2,0,-3,-6,-48,-2,-2,4,36,0,-1,1,-1,-1,-1,6,-1
KR_6565871584,420,3,-35,0,10,3,1,4,-2,4,2,4,1,5,6,1,7,-1,5,4,0,9,9,0,-1,1,5,0,0,1,-1,0,1,6,-1
KR_6750920988,420,-1,-23,-8,-3,0,1,1,-2,3,1,2,3,5,-1,1,0,-2,2,0,0,-3,-4,2,-6,4,-3,0,-1,-1,-1,-1,1,3,-1
KR_6709335016,420,-3,-82,-36,-9,0,0,0,-7,9,2,-3,3,0,-1,3,2,2,2,4,0,-4,7,1,-6,5,-2,0,0,-1,-1,0,1,2,-1
KR_6758798606,420,0,-34,-22,8,4,1,5,4,0,4,0,1,1,-1,3,2,1,2,3,0,5,-183,5,-6,1,-1,0,-1,-1,1,-1,1,4,-1
KR_6619526279,440,-10,-138,-31,-24,2,4,6,-9,10,1,-3,6,3,-14,14,0,0,1,1,-1,-27,-2,-1,0,1,1,0,-3,1,1,-1,-1,3,-1
KR_6722767711,420,0,-2,-44,5,-1,2,1,-3,8,5,3,1,4,6,2,8,0,0,0,0,11,-7,1,-2,1,0,0,-1,1,-1,-1,1,6,-1
KR_6622461360,420,-4,-66,-20,-1,-6,6,0,5,0,5,-4,7,3,6,4,10,-2,3,1,0,5,11,3,-4,1,-2,0,-2,1,-1,-1,-1,4,-1
KR_6748604192,420,-5,71,8,-11,1,0,1,-2,2,0,0,0,0,-8,8,0,-2,2,0,0,-11,23,-3,-3,6,-31,0,-1,1,1,-1,-1,3,-1
KR_6641009301,420,-1,-39,-24,-1,-1,1,0,1,1,2,-4,5,1,3,1,4,0,0,0,0,6,-16,-3,-2,5,-4,0,0,-1,0,0,-1,2,-1
KR_6582894378,420,-6,-10,-37,-5,-3,3,0,-4,6,2,-1,3,2,2,1,3,1,0,1,0,1,88,-1,-2,3,0,0,-2,-1,-1,-1,1,4,-1
KR_6699493146,420,3,40,-16,5,-1,3,2,1,2,3,2,0,2,2,4,6,1,0,1,0,1,4,-3,-1,4,5,0,1,-1,1,1,1,6,-1
KR_6761089451,440,3,54,36,-2,-1,3,2,1,0,1,-1,4,3,1,1,2,-2,3,1,0,-4,-3,0,-3,3,-1,0,1,1,1,1,-1,2,-1
KR_6636601482,420,-3,9,-1,-7,-1,2,1,0,2,2,-3,5,2,-3,3,0,0,0,0,0,-11,-145,-5,-1,6,3,0,-1,-1,-1,-1,-1,2,-1
KR_6513950148,420,-4,15,-16,-4,-3,4,1,0,5,5,-2,6,4,1,1,2,0,2,2,0,2,-333,5,-8,3,-1,0,0,-1,0,0,-1,3,-1
KR_6736454417,420,-1,-8,12,-2,0,1,1,4,0,4,-4,6,2,-2,2,0,0,0,0,0,3,-8,0,-4,4,-2,0,-1,-1,1,-1,-1,2,-1
KR_6738247636,440,-2,24,-11,7,-3,3,0,0,1,1,3,1,4,4,0,4,3,0,3,0,6,-3,2,-7,5,8,0,1,-1,1,1,1,6,-1
KR_6724971807,420,3,-1,5,3,-3,3,0,3,0,3,1,1,2,2,1,3,0,2,2,0,6,-7,-2,-3,5,1,0,0,1,1,1,-1,2,-1
KR_6674158169,420,0,1,8,-4,-4,4,0,3,3,6,0,2,2,-3,5,2,0,0,0,0,-1,0,1,-4,3,1,0,-1,-1,1,-1,-1,2,-1
KR_6693788152,420,0,-88,-1,2,-3,4,1,-1,3,2,4,0,4,1,1,2,1,1,2,0,8,-102,2,-4,2,1,0,-1,1,1,-1,1,6,-1
KR_6497379937,420,1,-7,-4,-4,0,2,2,-2,4,2,-1,3,2,-1,1,0,0,0,0,0,-6,-28,0,-3,3,3,0,0,1,1,0,1,3,-1
KR_6739182688,420,-1,29,0,-5,-1,1,0,0,3,3,-3,5,2,1,6,7,-2,3,1,0,-3,-433,-1,-3,4,2,0,-1,0,1,-1,1,0,-1
KR_6746458968,420,0,13,3,1,3,2,5,-1,3,2,3,3,6,-6,7,1,2,0,2,1,-5,123,-1,-2,3,-1,0,0,-1,1,-1,1,6,-1
KR_5968237743,420,-1,-33,0,-1,0,1,1,0,1,1,-4,5,1,1,2,3,2,0,2,0,1,-1,4,-6,2,0,0,-1,1,0,-1,-1,1,-1
KR_6756543473,420,-1,-13,18,-2,0,2,2,-2,3,1,-1,1,0,2,3,5,-1,1,0,0,1,10,9,-10,1,-2,0,0,1,0,1,-1,5,-1
KR_6602634452,420,-3,-13,6,-11,-1,1,0,-7,8,1,-1,3,2,1,2,3,-3,3,0,0,-7,-16,-4,-2,6,2,0,0,-1,1,0,-1,6,-1
KR_6624504843,420,3,66,-9,11,2,1,3,5,1,6,3,1,4,0,2,2,1,0,1,0,14,9,3,-5,2,1,0,0,1,0,0,1,4,-1
KR_6729694579,420,-1,-53,24,-7,1,0,1,-3,5,2,1,1,2,-2,2,0,-4,4,0,0,-8,-14,1,-4,3,6,0,0,1,1,0,-1,5,-1
KR_6732795083,420,3,49,12,-3,1,1,2,0,5,5,-1,3,2,-2,7,5,-1,1,0,0,-6,-122,-1,-4,5,1,0,0,-1,1,0,1,6,-1
KR_6747221308,420,-6,-26,-15,-14,-2,2,0,-5,6,1,-7,8,1,0,1,1,0,1,1,0,-8,7,-2,-3,5,-3,0,0,0,-1,0,-1,0,-1
KR_6652097774,420,-2,-51,5,-8,3,0,3,-1,2,1,-5,6,1,-5,6,1,0,0,0,-1,-8,212,-4,0,4,0,0,0,-1,-1,1,-1,6,-1
KR_6679315425,420,-3,-73,-4,-7,1,0,1,1,0,1,-3,4,1,-2,3,1,-4,4,0,0,-8,-5,2,-5,3,0,0,-1,-1,-1,-1,-1,3,-1
KR_6511828822,420,-3,-58,-20,-4,1,0,1,3,0,3,-7,8,1,-3,4,1,2,0,2,0,2,-137,-1,-1,2,1,0,-2,-1,1,-1,-1,4,-1
KR_6755202318,420,0,-24,32,-3,-2,4,2,0,2,2,-1,2,1,-2,4,2,2,0,2,0,-3,19,1,-5,4,-1,0,0,-1,-1,0,-1,2,-1
KR_6645915787,420,0,15,16,1,-4,5,1,3,0,3,4,3,7,-1,5,4,-1,2,1,2,5,-6,-8,0,8,0,0,0,-1,0,0,1,6,-1
KR_6727125033,420,-4,-134,20,-12,-8,8,0,-1,2,1,-2,4,2,-1,2,1,0,1,1,0,-1,-10,-2,-2,4,-1,0,-1,1,1,-1,-1,4,-1
KR_6699549267,420,-3,-18,-27,-2,1,3,4,3,1,4,-6,8,2,-1,5,4,1,0,1,-1,5,1,2,-2,0,3,0,0,-1,0,-1,-1,6,-1
KR_6645614682,420,-6,-58,-4,-7,-2,4,2,5,0,5,0,1,1,-5,6,1,-5,5,0,0,-10,-261,1,-5,4,-4,0,-1,1,0,-1,1,2,-1
KR_6749465980,420,-1,71,-23,1,-1,3,2,2,2,4,1,1,2,-1,1,0,0,2,2,0,3,0,-4,0,4,2,0,2,1,1,1,1,1,-1
KR_6603155871,420,-3,-39,-4,-8,0,1,1,-6,6,0,1,3,4,-5,8,3,2,0,2,0,-12,-136,-1,-3,4,-1,0,0,1,-1,-1,1,5,-1
KR_6627918267,420,3,-31,4,2,-2,4,2,-1,2,1,-1,1,0,3,2,5,3,0,3,0,2,46,-3,-1,4,-12,0,0,1,-1,0,-1,4,-1
KR_6714252711,420,2,-17,-11,2,1,0,1,-2,5,3,0,2,2,2,1,3,1,2,3,-1,6,-11,-4,0,4,1,0,-1,-1,1,-1,-1,1,-1
KR_6759057848,440,-4,-98,-8,-8,2,0,2,3,2,5,-4,7,3,-5,6,1,-4,4,0,0,-7,-3,-2,-4,6,-2,0,-1,-1,0,-1,-1,1,-1
KR_6744119934,420,1,24,20,0,0,2,2,4,1,5,1,2,3,-2,4,2,-3,3,0,-1,-4,245,0,-4,4,0,0,0,-1,1,0,1,4,-1
KR_6747232145,440,-4,3,-32,-5,-3,3,0,-1,2,1,5,1,6,-6,6,0,0,3,3,0,-9,-18,-2,-1,3,-1,0,-1,0,-1,-1,-1,0,-1
KR_6684176773,420,-6,-75,-26,-5,-10,10,0,0,1,1,1,1,2,2,1,3,2,2,4,0,1,-121,-1,0,1,0,0,-2,0,-1,-1,-1,0,-1
KR_6749678993,420,0,-20,-3,2,-1,2,1,1,2,3,1,4,5,1,2,3,0,1,1,0,5,297,1,-5,4,0,0,0,-1,1,1,1,5,-1
KR_6601457476,420,-2,-23,-4,1,-2,2,0,5,1,6,0,1,1,0,1,1,-2,3,1,0,3,345,3,-7,4,-1,0,0,1,-1,-1,-1,2,-1
KR_6346598352,420,-7,-118,-20,-8,-2,3,1,1,4,5,0,1,1,-4,6,2,-3,3,0,0,-3,0,-3,-1,4,-1,0,-3,-1,-1,-1,1,3,-1
KR_6718454394,420,0,-6,4,-4,-2,3,1,0,1,1,-2,3,1,-2,3,1,2,0,2,-1,-3,2,7,-7,0,1,0,1,1,1,1,-1,4,-1
KR_6582154418,420,-2,-76,-5,-7,-4,4,0,1,4,5,1,1,2,0,3,3,-5,6,1,0,-10,-56,-4,-4,8,23,0,-1,-1,-1,-1,-1,2,-1
KR_6607754056,440,-2,6,-8,-11,-5,7,2,-1,6,5,3,1,4,-4,5,1,-4,4,0,0,-11,-29,1,-5,4,-3,0,-1,-1,1,-1,-1,5,-1
KR_6645598057,420,-2,-53,-4,-6,1,2,3,-1,3,2,-4,5,1,1,0,1,-3,3,0,0,-4,-24,0,-3,3,-2,0,-2,1,-1,-1,-1,5,-1
KR_6592084570,440,-7,-101,-49,-9,0,2,2,4,1,5,-4,4,0,-7,7,0,-2,2,0,0,-9,-44,6,-7,1,-5,0,-2,-1,-1,-1,1,5,-1
KR_6674422638,420,-1,17,-36,-1,8,0,8,-1,1,0,-5,5,0,-2,2,0,-1,1,0,0,-1,-7,-4,-2,6,0,0,0,-1,-1,1,1,5,-1
KR_6660580545,420,0,-20,-13,0,0,0,0,-1,4,3,-1,2,1,2,1,3,0,1,1,0,-3,-2,1,-5,4,-2,0,0,-1,1,0,-1,4,-1
KR_6727406274,420,0,-81,0,-6,0,1,1,-3,6,3,-5,6,1,1,2,3,1,2,3,0,-1,-9,-5,-1,6,4,0,-3,0,1,-1,-1,0,-1
KR_6575341570,420,-1,-38,8,1,4,1,5,-2,3,1,2,0,2,0,4,4,-3,4,1,0,-3,97,4,-5,1,-3,0,1,-1,1,1,1,6,-1
KR_6550558190,440,-3,-49,-10,-12,1,1,2,-2,3,1,-4,4,0,-6,6,0,-1,1,0,0,-9,-8,3,-6,3,-1,0,-1,-1,-1,-1,-1,2,-1
KR_6761937059,420,-2,-32,-32,-6,-3,3,0,1,0,1,2,2,4,-1,1,0,-5,6,1,-1,-10,16,1,-2,1,-1,0,-1,0,0,-1,-1,0,-1
KR_6724892261,420,-4,-39,-35,-9,1,2,3,-4,7,3,-2,6,4,0,3,3,-4,4,0,0,-5,103,-1,-2,3,2,0,-1,1,-1,-1,-1,3,-1
KR_6717869928,420,4,26,0,0,-1,4,3,-1,6,5,1,0,1,1,3,4,0,0,0,0,-3,35,-2,-1,3,-13,0,2,-1,1,1,-1,1,-1
KR_6644214158,420,2,6,4,-2,-2,4,2,0,1,1,-5,6,1,1,3,4,4,0,4,0,-5,135,4,-4,0,0,0,1,0,-1,1,1,0,-1
KR_6735158872,420,-3,-34,-27,-10,4,3,7,-1,2,1,-2,4,2,-11,11,0,0,0,0,-1,-21,-9,-2,-2,4,0,0,-1,-1,1,-1,-1,5,-1
KR_6380979226,420,1,-12,19,2,0,2,2,0,3,3,5,1,6,0,2,2,-3,3,0,0,3,18,7,-10,3,-2,0,1,-1,-1,1,1,5,-1
KR_6480649742,420,-4,-95,-36,-6,-1,3,2,0,3,3,-4,6,2,-1,2,1,0,0,0,0,2,-41,-3,-1,4,13,0,0,1,1,0,-1,6,-1
KR_6726082568,440,1,22,-20,3,2,0,2,4,0,4,-4,4,0,0,2,2,1,0,1,0,5,-2,0,-2,2,1,0,0,-1,0,0,-1,5,-1
KR_6688013055,420,-7,-52,-36,-9,-3,6,3,-2,3,1,0,5,5,-4,4,0,0,0,0,0,-10,6,3,-4,1,-2,0,-2,-1,0,-1,-1,2,-1
KR_6638792072,420,-4,-69,-16,-13,2,1,3,-6,6,0,-1,3,2,-6,6,0,-2,2,0,0,-16,-7,-2,-3,5,-1,0,-2,1,-1,-1,-1,4,-1
KR_6755273813,440,-3,-40,-16,1,-4,6,2,9,1,10,1,0,1,-1,5,4,-4,7,3,0,6,-26,3,-3,0,-1,0,0,-1,0,-1,1,1,-1
KR_6726556011,420,-8,-26,-44,-12,-7,7,0,1,2,3,1,2,3,-6,7,1,-1,1,0,0,-6,-5,-1,-3,4,-1,0,-3,1,-1,-1,-1,6,-1
KR_6742339794,420,-2,-32,-45,-5,2,0,2,-2,2,0,-4,6,2,0,2,2,-1,1,0,0,-2,-1,1,-2,1,0,0,0,1,-1,-1,-1,2,-1
KR_6509894672,420,1,-17,0,0,4,0,4,-2,5,3,-1,5,4,-3,6,3,2,0,2,0,1,-16,1,-3,2,4,0,0,1,1,0,-1,3,-1
KR_6592293626,440,-4,-55,-28,-6,-1,2,1,2,4,6,1,2,3,-6,9,3,-2,2,0,1,-2,11,-1,-6,7,0,0,-2,1,-1,-1,1,5,-1
KR_6700188039,420,-2,-35,-1,-12,1,1,2,-4,5,1,-1,1,0,-6,6,0,-2,2,0,0,-16,12,0,-3,3,-5,0,-1,-1,1,-1,-1,1,-1
KR_6752870362,420,0,87,16,-1,-1,2,1,-4,5,1,-2,3,1,1,0,1,5,3,8,1,-10,-4,0,-2,2,0,0,1,-1,-1,1,1,3,-1
KR_6763960093,420,3,49,19,9,3,1,4,4,0,4,0,1,1,1,0,1,1,2,3,0,11,36,3,-6,3,-18,0,-1,-1,1,-1,1,2,-1
KR_6755285916,420,-6,-106,-37,-14,-5,5,0,-2,4,2,-4,5,1,-1,3,2,-2,2,0,0,-8,-8,1,-3,2,-1,0,-2,-1,-1,-1,1,6,-1
KR_6617630293,420,-3,-113,-60,2,3,0,3,1,1,2,-5,11,6,2,2,4,1,1,2,0,8,10,1,-3,2,-3,0,-3,-1,-1,-1,-1,4,-1
KR_6743224926,420,1,-35,23,5,-4,5,1,4,0,4,2,0,2,2,0,2,1,0,1,0,4,19,2,-2,0,-1,0,-1,0,-1,-1,1,0,-1
KR_6742399541,420,-2,-158,11,3,1,1,2,-2,4,2,-4,5,1,6,2,8,2,0,2,0,8,-4,2,-3,1,0,0,-1,0,0,-1,1,0,-1
KR_6701455625,420,-3,-78,-16,-12,-2,3,1,-1,2,1,-4,5,1,-5,5,0,0,1,1,0,-5,2,-3,-6,9,-3,0,-2,1,-1,-1,-1,5,-1
KR_6739130740,420,-4,-47,-19,-9,-3,3,0,-4,4,0,-1,5,4,-1,1,0,0,0,0,0,-6,1,-1,-1,2,-2,0,-2,-1,0,-1,-1,4,-1
KR_6650211344,420,2,-38,-11,11,3,0,3,-2,3,1,3,1,4,4,0,4,3,0,3,0,9,5,2,-4,2,0,0,1,0,1,1,1,0,-1
KR_6746051464,420,2,51,27,-2,1,1,2,-2,2,0,-2,2,0,1,2,3,0,1,1,0,-2,-9,-8,0,8,-1,0,0,1,1,0,1,1,-1
KR_6596430048,440,-1,56,0,-6,1,1,2,-2,2,0,-5,9,4,0,3,3,0,0,0,1,-6,-46,-4,-1,5,3,0,1,1,1,1,1,1,-1
KR_6758659329,420,-2,-27,-28,-3,3,1,4,1,3,4,1,0,1,-4,4,0,-4,4,0,0,-10,-7,1,-5,4,-2,0,-1,-1,0,-1,-1,1,-1
KR_6710360220,420,0,-18,36,-6,-1,3,2,-6,6,0,5,1,6,-3,5,2,-1,1,0,0,-15,3,-1,-3,4,-1,0,0,1,1,-1,1,4,-1
KR_6695655511,420,-6,3,-10,-13,-5,6,1,-4,5,1,-1,4,3,-2,2,0,-1,2,1,-1,-9,389,-1,-1,2,-2,0,0,1,1,-1,-1,1,-1
KR_6197660945,420,-4,-33,20,-1,-2,5,3,0,0,0,0,2,2,1,0,1,0,0,0,-1,4,-157,-4,0,4,3,0,2,1,1,1,-1,5,-1
KR_6596073544,420,1,-10,4,5,0,1,1,1,4,5,0,4,4,4,3,7,0,1,1,0,9,22,1,-2,1,2,0,0,-1,-1,1,1,3,-1
KR_6705141775,420,-6,-76,-20,-9,2,1,3,0,1,1,-5,7,2,-6,7,1,0,1,1,0,-15,-3,-5,-2,7,-2,0,-2,-1,-1,-1,-1,2,-1
KR_6707912041,440,-1,32,0,-5,-1,1,0,1,0,1,-1,1,0,-2,3,1,-2,2,0,0,-4,270,1,-5,4,-2,0,0,-1,0,1,1,3,-1
KR_6643026347,420,-4,-178,-24,-1,-2,2,0,3,0,3,-7,8,1,4,2,6,1,0,1,0,0,-19,-2,-1,3,1,0,-1,-1,0,-1,-1,5,-1
KR_5535601323,420,-2,-58,-19,-5,-1,2,1,0,2,2,-2,4,2,-2,3,1,0,1,1,0,-4,-2,4,-5,1,1,0,-1,-1,0,-1,-1,2,-1
KR_6716360448,420,-2,22,-24,-12,-3,5,2,-2,3,1,-5,5,0,-2,5,3,0,1,1,-1,-21,-1,-3,-2,5,1,0,1,-1,-1,1,-1,6,-1
KR_6575814666,420,-3,1,-31,-4,-5,6,1,-8,9,1,-2,5,3,9,0,9,2,1,3,0,7,108,4,-8,4,-4,0,-1,0,-1,1,-1,0,-1
KR_6665018150,420,0,-27,11,-3,2,4,6,1,2,3,-3,4,1,-4,4,0,1,0,1,0,-9,-19,0,-4,4,5,0,-1,1,-1,-1,1,3,-1
KR_6629444831,420,-1,74,-2,-2,8,0,8,0,0,0,-3,4,1,-4,5,1,-3,3,0,0,-15,263,-3,-2,5,1,0,1,-1,1,1,1,3,-1
KR_6725240483,420,-3,-50,-25,-6,2,0,2,-3,3,0,0,2,2,-6,9,3,1,0,1,0,-8,-14,-3,-3,6,0,0,-1,-1,-1,-1,1,6,-1
KR_6743614373,440,-4,-14,-43,-7,-2,2,0,-2,6,4,-5,6,1,2,1,3,0,2,2,-1,-9,274,-1,-4,5,-3,0,-1,-1,-1,-1,-1,2,-1
KR_6304307852,440,-4,5,-20,-8,-2,4,2,-4,4,0,-2,5,3,0,2,2,0,0,0,1,-7,-26,2,-3,1,0,0,0,0,-1,-1,1,0,-1
KR_6761616833,420,-3,33,-16,-4,-5,7,2,-1,3,2,1,3,4,1,3,4,0,0,0,1,9,2,1,-5,4,-2,0,-1,-1,-1,-1,1,1,-1
KR_6680527401,420,-1,47,23,-5,2,2,4,-7,8,1,-1,1,0,1,4,5,0,3,3,0,-5,36,0,-3,3,-13,0,0,-1,-1,1,-1,5,-1
KR_6728177854,440,0,27,20,-2,1,2,3,3,1,4,-2,2,0,-4,5,1,0,2,2,-2,-7,0,1,-4,3,3,0,1,0,0,1,-1,0,-1
KR_6757895659,420,-5,-83,-2,-11,0,2,2,-7,7,0,-2,4,2,-3,4,1,1,0,1,0,-10,-3,-2,-1,3,2,0,-1,0,1,-1,-1,0,-1
KR_6191306670,440,-3,-71,20,-12,-10,11,1,4,4,8,-3,4,1,-2,2,0,-1,1,0,0,-12,-1,3,-6,3,-3,0,0,-1,-1,-1,-1,3,-1
KR_6602845720,420,-3,-30,6,-9,-5,6,1,-4,4,0,-1,2,1,-1,2,1,2,0,2,0,-9,-9,4,-4,0,2,0,0,-1,-1,-1,-1,6,-1
KR_6736940663,420,0,-49,-60,0,2,0,2,0,2,2,2,0,2,-3,7,4,-1,1,0,0,-4,3,-3,-3,6,-1,0,-1,-1,-1,-1,-1,4,-1
KR_6719739545,440,1,6,-23,4,1,1,2,3,1,4,1,1,2,-1,2,1,0,0,0,0,3,-133,0,-3,3,2,0,-2,-1,-1,-1,1,3,-1
KR_6756896915,420,1,-21,-12,2,1,3,4,-2,2,0,0,3,3,1,1,2,2,1,3,-1,-1,1,6,-10,4,-4,0,-1,-1,-1,-1,-1,6,-1
KR_6518451551,420,-4,-92,35,-9,3,0,3,-6,6,0,0,4,4,-2,5,3,-4,4,0,0,-5,-9,-4,-4,8,-2,0,-1,1,0,-1,1,2,-1
KR_6001825231,420,2,10,13,2,4,1,5,4,0,4,2,0,2,-4,5,1,-4,4,0,1,3,6,-1,-5,6,-2,0,0,1,1,1,1,4,-1
KR_6612811840,420,-1,-52,26,-7,0,0,0,0,7,7,-5,8,3,-4,7,3,2,0,2,0,-3,-459,-3,-1,4,1,0,-2,1,1,-1,-1,3,-1
KR_6667481155,420,0,-36,20,-2,1,0,1,0,3,3,1,1,2,2,2,4,-6,7,1,0,-5,0,3,-4,1,-3,0,-1,0,0,-1,1,0,-1
KR_6731494802,440,-1,31,24,-3,-4,6,2,5,4,9,-1,1,0,2,1,3,-5,8,3,-1,-14,23,0,-2,2,1,0,4,-1,1,1,-1,4,-1
KR_6625086481,420,-4,-101,-20,-2,5,0,5,2,0,2,-3,5,2,-4,5,1,-2,2,0,0,-6,7,-3,-4,7,-1,0,-2,-1,-1,-1,1,1,-1
KR_6762266121,420,-3,-119,-8,-1,-3,3,0,-1,4,3,0,1,1,4,0,4,-1,2,1,0,2,4,2,-4,2,1,0,-1,0,-1,-1,-1,0,-1
KR_6734708344,420,-3,-65,-8,-9,-5,5,0,-4,5,1,4,4,8,-6,7,1,2,0,2,0,-10,402,4,-8,4,-9,0,0,0,-1,0,-1,0,-1
KR_6578375677,420,-1,42,-4,-13,0,2,2,-7,8,1,1,1,2,-4,9,5,-3,4,1,1,-13,-1,-4,-1,5,1,0,-1,-1,-1,-1,1,1,-1
KR_6754596852,420,-4,-113,-32,-11,-6,7,1,2,1,3,-2,4,2,-4,5,1,-1,1,0,0,-5,0,-1,-5,6,-2,0,0,1,-1,-1,-1,6,-1
KR_6514283060,420,0,14,0,1,3,0,3,-4,5,1,-3,5,2,5,1,6,0,1,1,0,-2,0,1,-4,3,1,0,1,-1,1,1,-1,2,-1
KR_6742682488,420,-7,-33,-16,-19,-6,7,1,0,3,3,0,1,1,-4,6,2,-9,9,0,0,-17,-8,-4,0,4,0,0,-2,-1,-1,-1,1,4,-1
KR_6643330667,420,-3,-57,20,-5,-3,3,0,-1,4,3,-3,3,0,1,0,1,1,1,2,0,-1,13,-2,-2,4,0,0,0,1,0,-1,1,4,-1
KR_6743567786,440,5,60,48,12,2,1,3,1,2,3,7,2,9,2,2,4,0,1,1,0,7,2,-1,-5,6,3,0,2,-1,1,1,-1,6,-1
KR_6707096412,420,-2,-58,16,-10,2,1,3,-1,3,2,-2,2,0,-7,7,0,-2,3,1,-1,-21,-11,-2,-1,3,-1,0,-2,-1,1,-1,-1,4,-1
KR_6738672844,420,1,53,-1,-3,-2,5,3,-1,3,2,-5,5,0,2,4,6,3,0,3,-1,3,-16,-1,-2,3,-1,0,-1,-1,-1,1,-1,6,-1
KR_6720069714,420,0,-64,20,-1,-2,3,1,1,1,2,0,4,4,2,1,3,-2,3,1,0,-1,-5,-3,-2,5,1,0,0,0,-1,0,1,0,-1
KR_6739211815,420,-6,-39,-36,-14,-4,4,0,-5,5,0,-6,6,0,0,2,2,1,0,1,0,-11,-28,-1,-3,4,0,0,0,-1,1,-1,-1,6,-1
KR_6599624912,420,3,70,-11,8,8,0,8,0,3,3,3,1,4,-6,7,1,3,1,4,0,-3,-2,-1,-7,8,1,0,1,-1,1,-1,1,1,-1
KR_6746666311,420,0,5,4,2,0,1,1,4,1,5,-7,7,0,5,0,5,0,2,2,1,11,434,4,-8,4,-19,0,0,1,0,0,1,1,-1
KR_6643614646,420,1,-15,-10,4,3,1,4,3,1,4,-3,4,1,-2,2,0,3,1,4,-1,-1,6,2,-5,3,0,0,2,-1,1,1,-1,1,-1
KR_6669188430,420,-4,19,-36,-9,1,1,2,2,1,3,-3,4,1,-2,3,1,-7,7,0,0,-5,26,10,-10,0,0,0,0,1,1,0,-1,2,-1
KR_6762101400,420,1,-29,0,10,2,0,2,3,4,7,8,0,8,-2,2,0,-1,1,0,1,2,2,1,-4,3,1,0,0,1,1,1,1,6,-1
KR_6714361388,420,-3,-46,-8,-11,0,3,3,-6,7,1,-1,1,0,-4,4,0,0,1,1,0,-12,4,1,-2,1,1,0,0,-1,1,-1,-1,4,-1
KR_6597252949,420,0,-27,0,4,3,1,4,1,3,4,4,0,4,1,0,1,-5,6,1,0,-1,-3,-5,-2,7,-1,0,0,0,1,1,1,0,-1
KR_6402674326,420,-5,-30,-16,-14,-3,6,3,-4,5,1,-2,4,2,-5,5,0,0,0,0,0,-20,2,0,-1,1,-3,0,0,-1,-1,0,-1,3,-1
KR_6746702614,420,-3,-11,-12,-9,-1,1,0,-1,5,4,-6,6,0,-2,2,0,1,0,1,0,-6,-13,-3,-2,5,3,0,0,-1,-1,-1,-1,3,-1
KR_6647626636,440,-5,-119,-54,-10,0,1,1,-5,5,0,-4,5,1,-1,4,3,0,0,0,0,-6,-3,-1,-1,2,-2,0,-1,-1,0,-1,-1,6,-1
KR_6756255309,420,-2,62,0,-2,0,3,3,2,2,4,-6,6,0,-2,3,1,4,0,4,0,-11,18,5,-9,4,3,0,0,1,-1,0,1,6,-1
KR_6764454525,420,0,-21,-7,1,0,1,1,5,0,5,-1,2,1,-3,5,2,0,1,1,1,1,-7,-7,-2,9,2,0,0,-1,1,0,1,6,-1
KR_6754617002,420,1,-10,16,-5,-5,6,1,-2,2,0,-3,4,1,1,2,3,4,1,5,-1,-2,1,-3,-1,4,2,0,0,-1,1,1,-1,2,-1
KR_6380854220,420,-2,-70,0,-2,3,1,4,-2,3,1,-3,3,0,0,3,3,0,0,0,0,-1,-2,-3,-5,8,2,0,0,0,0,-1,-1,0,-1
KR_6757244485,420,0,-21,10,0,-3,3,0,2,3,5,6,1,7,-1,2,1,-4,5,1,0,-8,-2,4,-5,1,-3,0,-1,-1,-1,-1,-1,2,-1
KR_6657898822,420,-1,8,12,-3,-2,2,0,-4,4,0,-1,3,2,4,3,7,0,2,2,0,0,-297,-3,0,3,-1,0,0,-1,0,0,-1,2,-1
KR_6664137179,420,1,-45,30,5,-1,3,2,1,4,5,4,2,6,2,1,3,-1,1,0,0,-1,-9,-1,-2,3,-1,0,-4,1,-1,-1,1,6,-1
KR_6730555779,420,-8,-127,-17,-19,-4,4,0,-1,2,1,-5,5,0,-9,9,0,0,1,1,0,-10,-248,-3,-5,8,1,0,-3,-1,1,-1,-1,3,-1
KR_6761650656,420,-6,-129,-28,-7,-1,4,3,-3,4,1,-2,4,2,-1,4,3,0,0,0,-1,-2,20,0,-4,4,-1,0,-1,0,1,-1,-1,0,-1
KR_6692855406,420,-4,-94,-76,-7,1,2,3,0,3,3,-7,10,3,-2,2,0,1,0,1,0,0,393,0,-5,5,1,0,-1,1,-1,-1,-1,5,-1
KR_6755607970,420,0,-56,4,1,1,0,1,1,0,1,4,0,4,-1,1,0,-4,5,1,0,-1,182,-5,-2,7,2,0,0,1,1,0,1,2,-1
KR_6754127210,440,-2,-151,-13,5,3,2,5,-3,5,2,4,0,4,2,0,2,-1,2,1,0,13,-3,7,-9,2,-6,0,-1,1,-1,-1,1,3,-1
KR_6749207820,420,-3,10,16,-4,-2,3,1,0,1,1,-2,3,1,-1,3,2,1,1,2,-1,-5,-4,0,-4,4,-2,0,1,-1,1,1,-1,4,-1
KR_6710184217,420,-1,-35,-16,3,3,0,3,4,3,7,-5,7,2,2,1,3,-1,2,1,-1,14,2,1,-3,2,2,0,-2,1,1,-1,-1,4,-1
KR_6728396502,420,-1,-55,9,-3,1,0,1,-4,6,2,2,1,3,-1,4,3,-1,1,0,0,-7,11,5,-10,5,-3,0,0,0,1,0,-1,0,-1
KR_6571273503,420,-2,-19,-29,-2,0,2,2,-1,4,3,-2,6,4,-2,3,1,3,0,3,0,7,118,1,-2,1,-3,0,0,-1,1,-1,-1,3,-1
KR_6761196271,420,2,4,23,2,-1,1,0,2,1,3,3,0,3,-1,3,2,-1,2,1,0,0,0,1,-4,3,-2,0,0,0,1,1,-1,0,-1
KR_6737182163,440,0,16,24,0,3,2,5,-2,3,1,1,2,3,-1,6,5,-1,3,2,0,5,-50,-3,-2,5,24,0,0,0,1,1,-1,0,-1
KR_6710736827,420,-1,-31,40,0,1,0,1,0,1,1,1,3,4,-2,5,3,0,2,2,0,-6,71,0,-3,3,-1,0,0,0,1,0,1,0,-1
KR_6598210814,440,1,30,-5,-3,1,3,4,-4,4,0,-1,1,0,1,0,1,0,0,0,0,-6,11,2,-3,1,2,0,1,-1,1,1,1,1,-1
KR_6695023721,420,-3,-30,5,-6,-2,2,0,-4,5,1,1,2,3,2,0,2,-3,5,2,0,-3,0,0,-4,4,2,0,0,1,-1,0,1,3,-1
KR_6338578240,440,-3,30,-3,-6,-4,6,2,-1,4,3,-1,3,2,0,1,1,0,0,0,0,-15,2,2,-6,4,-1,0,0,1,1,0,-1,6,-1
KR_6681465695,440,0,-3,4,0,2,1,3,-2,3,1,2,0,2,-1,1,0,-1,3,2,1,-1,0,-2,-5,7,2,0,-1,0,0,-1,1,0,-1
KR_6764449428,420,0,29,-7,-10,0,1,1,-1,2,1,-3,3,0,-5,6,1,-1,2,1,0,-4,14,-5,0,5,-21,0,1,0,1,1,-1,0,-1
KR_5921343066,440,-5,-54,-36,-8,2,0,2,-1,2,1,-3,3,0,-4,4,0,-2,2,0,0,-6,-8,0,-2,2,-5,0,1,-1,1,1,-1,2,-1
KR_6717897020,420,-3,-57,20,1,-1,3,2,2,0,2,0,0,0,0,0,0,0,0,0,0,0,-9,0,-5,5,-5,0,0,-1,0,-1,-1,2,-1
KR_6759908741,420,0,11,27,-3,-4,5,1,1,0,1,-2,2,0,3,1,4,-1,3,2,0,-5,233,-1,-3,4,3,0,0,1,-1,0,-1,5,-1
KR_6738279932,420,-2,-69,-34,-12,-1,2,1,1,0,1,-6,7,1,-5,5,0,-1,3,2,-2,-15,245,-1,-1,2,-1,0,-1,-1,1,-1,-1,1,-1
KR_6692890789,420,-4,-75,-4,-13,-6,6,0,2,1,3,-1,2,1,-8,8,0,0,1,1,-1,-10,-2,2,-5,3,-1,0,-3,-1,-1,-1,-1,4,-1
KR_6756040161,420,-3,-35,5,-1,1,0,1,1,3,4,1,3,4,-8,8,0,4,0,4,0,-9,45,-1,-3,4,-20,0,1,0,1,1,1,0,-1
KR_6675705753,420,-6,-74,-8,-8,-2,5,3,-1,4,3,-5,8,3,1,2,3,-1,2,1,1,-1,12,-2,-2,4,-1,0,-1,-1,1,-1,1,4,-1
KR_6590493186,420,-3,-38,20,-8,0,0,0,2,3,5,1,1,2,-9,11,2,-2,2,0,0,-8,-9,0,-4,4,3,0,-2,-1,1,-1,-1,1,-1
KR_6730778107,420,1,-67,9,11,2,2,4,4,4,8,5,0,5,0,2,2,0,1,1,0,7,-8,-2,-2,4,4,0,0,1,-1,-1,1,2,-1
KR_6626067069,420,-3,-20,-31,-3,-3,5,2,-1,3,2,3,2,5,-2,3,1,0,1,1,0,-2,359,-2,-3,5,0,0,0,1,1,1,1,1,-1
KR_6693180595,420,1,-11,28,1,4,2,6,-3,5,2,3,0,3,-1,4,3,-2,3,1,-1,-4,-4,2,-3,1,2,0,0,1,-1,1,-1,5,-1
KR_6711805061,440,-3,-12,4,-9,0,0,0,-3,3,0,-2,2,0,-3,4,1,-1,1,0,0,-11,39,0,-6,6,-7,0,0,1,-1,0,-1,2,-1
KR_6763681402,420,-1,42,20,1,-5,6,1,1,0,1,5,0,5,1,4,5,-1,1,0,0,0,24,3,-4,1,0,0,1,1,1,1,-1,6,-1
KR_6763765183,420,-1,20,1,0,1,0,1,1,2,3,1,3,4,-3,3,0,0,0,0,0,-2,-113,-2,-3,5,1,0,0,-1,1,1,1,1,-1
KR_6720754903,440,-5,-30,-31,-7,3,0,3,-3,3,0,2,3,5,-10,10,0,1,1,2,-1,-16,24,-2,-3,5,-32,0,0,0,-1,-1,-1,0,-1
KR_6635923503,420,-5,-67,-35,-6,-5,6,1,1,1,2,1,3,4,-2,2,0,-1,1,0,0,1,-4,-3,-1,4,0,-1,-1,1,-1,-1,-1,1,-1
KR_6719174386,420,0,-8,20,-5,-2,2,0,6,3,9,-3,6,3,-5,6,1,-1,2,1,0,-16,-2,0,-1,1,0,0,0,1,1,1,-1,4,-1
KR_6691296285,440,2,-5,34,-1,4,1,5,0,1,1,-2,5,3,-2,3,1,-1,1,0,0,-6,-5,0,-5,5,-3,0,1,-1,1,1,1,1,-1
KR_6737547424,440,-5,-91,9,-5,-2,2,0,-2,10,8,0,0,0,3,4,7,-4,7,3,0,7,-1,2,-3,1,-2,0,-2,1,0,-1,1,4,-1
KR_6701718932,420,-9,-157,-39,-9,-2,6,4,1,3,4,-6,6,0,-3,3,0,1,0,1,0,-8,-49,-4,-3,7,8,0,-6,1,-1,-1,1,2,-1
KR_6746326639,420,-3,-103,-16,-2,-4,6,2,2,0,2,-4,4,0,3,1,4,1,1,2,1,4,-1,2,-5,3,-2,0,0,1,-1,-1,1,5,-1
KR_6681775255,440,-4,-15,16,-1,-2,4,2,2,1,3,-1,2,1,0,3,3,0,3,3,1,2,-6,-3,-1,4,2,0,0,-1,1,0,1,4,-1
KR_6508617091,420,-4,12,-13,-10,-2,4,2,-8,8,0,1,1,2,-1,2,1,0,2,2,0,-11,-1,-2,0,2,-4,0,0,-1,0,0,1,1,-1
KR_6759485793,420,4,60,11,5,-3,3,0,2,4,6,5,1,6,0,6,6,1,0,1,0,6,5,0,-4,4,1,0,0,1,-1,0,1,1,-1
KR_6680338375,440,2,43,-40,-5,-1,3,2,4,1,5,-8,10,2,0,6,6,0,3,3,3,5,4,5,-5,0,2,0,0,-1,-1,0,1,3,-1
KR_6650378257,420,1,62,-8,-1,1,1,2,-1,2,1,-1,2,1,3,2,5,-3,3,0,-1,-7,5,-1,-3,4,-2,0,1,0,0,1,-1,0,-1
KR_6717344733,420,-1,15,-24,3,0,0,0,1,1,2,2,1,3,1,3,4,-1,1,0,0,7,-6,3,-5,2,1,0,0,1,0,0,-1,2,-1
KR_6727622445,440,0,17,-1,0,8,1,9,-2,4,2,1,1,2,-9,15,6,2,0,2,1,-7,-11,-3,-2,5,1,0,0,-1,-1,1,1,5,-1
KR_6754761152,420,0,-38,-24,-6,-2,3,1,-1,1,0,-3,4,1,0,5,5,0,1,1,0,-5,241,1,-6,5,-3,0,0,1,-1,0,-1,5,-1
KR_6759566517,420,0,38,-48,3,1,3,4,-2,4,2,5,0,5,-2,4,2,1,1,2,0,-1,-2,0,-3,3,0,0,-1,-1,-1,-1,-1,2,-1
KR_6720309120,420,3,25,86,1,2,1,3,-5,5,0,6,1,7,0,1,1,-2,2,0,0,-3,176,2,-3,1,0,0,-2,-1,1,-1,1,5,-1
KR_6645490208,420,-1,9,24,-3,2,1,3,0,4,4,-4,6,2,3,5,8,-4,5,1,1,-7,8,4,-4,0,-3,0,0,-1,1,1,1,5,-1
KR_6755086267,420,-2,-99,20,-4,0,7,7,0,2,2,0,2,2,-3,8,5,-1,2,1,1,-11,-1,0,-2,2,-1,0,-1,0,-1,-1,1,0,-1
KR_6757738212,420,1,38,-24,0,2,2,4,2,1,3,0,0,0,-3,4,1,-1,1,0,0,6,3,2,-2,0,-1,0,2,-1,1,1,-1,6,-1
KR_6643201906,420,-2,9,-35,5,1,2,3,4,2,6,-1,3,2,1,3,4,0,1,1,0,7,19,-1,-2,3,-5,0,2,-1,1,1,1,2,-1
KR_6744635007,420,-2,38,-19,-4,5,0,5,-4,4,0,-7,7,0,0,1,1,2,0,2,0,-2,10,-1,0,1,0,0,-1,-1,-1,-1,1,6,-1
KR_6652545757,420,1,25,8,0,0,0,0,3,1,4,1,2,3,-1,3,2,-3,4,1,0,0,-4,1,-5,4,-1,0,-1,-1,1,-1,1,1,-1
KR_6688155513,420,1,27,-13,8,4,2,6,2,3,5,0,1,1,0,3,3,2,1,3,0,1,4,-1,-4,5,-1,0,0,-1,1,1,1,3,-1
KR_6749119010,440,1,-17,3,-10,-9,10,1,-2,4,2,-5,6,1,5,1,6,1,2,3,-1,-9,3,1,-4,3,1,0,-2,-1,0,-1,-1,3,-1
KR_5904616842,420,2,-42,-9,2,-1,3,2,1,3,4,3,2,5,-3,4,1,2,2,4,0,-1,1,1,-5,4,1,0,0,-1,0,0,-1,4,-1
KR_6742232085,420,-5,4,-16,-1,2,0,2,2,2,4,-1,4,3,-5,5,0,1,1,2,0,-3,-1,1,-2,1,0,0,-1,-1,1,-1,1,4,-1
KR_6633822047,420,-1,-42,2,-4,-2,2,0,0,2,2,-2,3,1,1,3,4,-1,2,1,0,-8,-58,0,-3,3,25,0,0,-1,-1,-1,-1,5,-1
KR_6691264435,440,-1,22,-12,-1,-4,6,2,-2,5,3,6,0,6,-2,3,1,1,0,1,0,3,-8,-4,-2,6,4,0,-1,-1,1,-1,-1,4,-1
KR_6740259197,420,-2,-76,7,0,0,2,2,-1,2,1,0,1,1,1,1,2,0,0,0,-1,-3,7,6,-7,1,-2,0,0,1,1,0,-1,5,-1
KR_6601055003,420,0,14,-20,1,-5,5,0,3,1,4,-1,1,0,4,0,4,0,0,0,0,3,-2,3,-4,1,0,0,0,1,-1,0,-1,4,-1
KR_6736566728,420,-1,-43,20,-6,-2,2,0,1,0,1,0,0,0,-5,7,2,0,1,1,-1,-7,231,-2,-1,3,0,0,0,-1,0,0,-1,4,-1
KR_6760337074,420,1,9,9,3,1,0,1,3,3,6,-1,1,0,-3,6,3,3,1,4,0,9,13,4,-6,2,0,0,0,-1,1,-1,-1,2,-1
KR_6661779364,420,-2,-13,4,-11,2,1,3,-5,7,2,-1,2,1,-1,2,1,-6,7,1,0,-16,-6,2,-3,1,-2,0,-1,-1,-1,-1,-1,1,-1
KR_6627046872,420,3,68,0,-7,-3,3,0,-3,5,2,4,2,6,-5,5,0,0,6,6,-4,-23,-5,-2,-6,8,7,0,1,-1,1,1,-1,5,-1
KR_6754520546,440,2,33,28,4,4,0,4,-3,8,5,0,1,1,1,3,4,2,0,2,2,8,2,-1,-3,4,0,0,0,-1,0,-1,1,6,-1
KR_6731658088,420,2,-54,-7,3,3,1,4,1,1,2,4,1,5,-4,4,0,-1,1,0,0,-4,12,-2,-4,6,-7,0,0,1,1,0,-1,2,-1
KR_6764655102,420,-4,20,-16,-10,-4,4,0,-3,5,2,-2,2,0,0,0,0,-1,4,3,0,-11,6,0,-1,1,0,0,-1,1,-1,-1,-1,3,-1
KR_6258697530,420,-2,28,-14,-6,-1,3,2,-2,4,2,-1,4,3,-1,4,3,-1,4,3,-2,-4,2,2,-6,4,1,0,-2,-1,-1,-1,-1,3,-1
KR_6646131945,420,-7,-83,4,-17,-7,7,0,-5,5,0,-6,7,1,-1,1,0,2,2,4,0,-2,-329,-4,0,4,-3,0,-2,-1,-1,-1,-1,1,-1
KR_6764162908,420,-5,-42,12,-14,-1,1,0,-1,4,3,-6,6,0,-5,8,3,-1,3,2,0,-16,132,-1,-3,4,0,0,-2,-1,1,-1,1,2,-1
KR_6764233656,420,-2,-28,16,2,3,0,3,6,2,8,0,1,1,-6,6,0,-1,1,0,1,-3,-13,0,-3,3,3,0,-1,-1,-1,-1,1,1,-1
KR_6749126549,420,-1,59,-20,1,1,1,2,-3,4,1,4,1,5,-1,5,4,0,0,0,0,-9,21,1,-4,3,1,0,0,1,1,1,1,3,-1
KR_6616054853,420,0,10,26,-10,1,0,1,0,2,2,-5,5,0,-6,6,0,0,1,1,0,-11,-9,-4,-2,6,0,0,2,-1,1,1,-1,4,-1
KR_6646326960,420,-6,-78,-8,-12,-5,5,0,1,1,2,-1,4,3,-7,7,0,0,1,1,0,-5,-9,-5,-2,7,4,0,-4,-1,0,-1,-1,1,-1
KR_6761435516,420,-2,-55,31,-6,-2,2,0,-2,3,1,-1,4,3,-1,3,2,0,0,0,-1,-1,-5,-1,-2,3,0,0,-1,1,-1,-1,-1,3,-1
KR_6613413630,420,2,18,-9,1,2,1,3,-2,3,1,-2,3,1,2,3,5,1,0,1,0,-3,-9,-4,-1,5,3,0,-1,1,0,-1,-1,6,-1
KR_6697407303,440,-2,-84,18,-1,1,1,2,-3,5,2,3,0,3,-2,3,1,0,0,0,1,-6,2,1,-2,1,0,0,0,-1,0,0,1,4,-1
KR_6611458671,420,-2,-56,-10,-7,-3,4,1,-4,5,1,-1,1,0,0,3,3,1,0,1,0,-5,17,-5,-3,8,-3,0,-1,1,-1,-1,-1,5,-1
KR_6692827264,420,1,20,36,0,-2,2,0,0,3,3,2,3,5,1,1,2,-1,2,1,0,2,-98,3,-7,4,-8,0,0,-1,-1,0,-1,3,-1
KR_6651120852,420,-5,-74,-28,-12,-3,5,2,-10,10,0,1,2,3,0,1,1,0,1,1,-2,-7,-22,-3,-2,5,-2,0,-2,-1,-1,-1,-1,6,-1
KR_6731409979,420,-1,-62,-17,-7,-4,6,2,-3,3,0,-4,5,1,4,0,4,0,2,2,1,-4,45,-1,-2,3,2,0,0,-1,1,-1,1,4,-1
KR_6733035360,420,1,-63,52,2,1,2,3,-1,3,2,2,3,5,2,4,6,-2,3,1,1,-2,-2,1,-5,4,5,0,-2,-1,-1,-1,1,5,-1
KR_6699562413,440,-1,-41,8,3,3,0,3,3,0,3,0,1,1,-4,4,0,1,0,1,0,2,1,-2,-3,5,2,0,1,1,1,1,1,1,-1
KR_6602726916,420,-4,-36,-22,-9,-4,4,0,0,1,1,-3,4,1,-4,4,0,2,1,3,0,-4,-3,0,-2,2,-2,0,-1,1,-1,-1,-1,2,-1
KR_6760726455,440,0,69,-8,2,-1,1,0,-6,9,3,2,1,3,7,3,10,0,2,2,0,7,4,1,-6,5,8,0,1,-1,-1,1,1,6,-1
KR_6747507643,440,-4,-6,-8,-15,-5,5,0,-5,6,1,-5,6,1,-2,8,6,2,0,2,-3,-4,4,-4,0,4,-2,0,-1,1,-1,-1,-1,3,-1
KR_6524116711,420,-2,3,-29,-12,-5,5,0,-6,6,0,1,4,5,-6,6,0,4,0,4,-4,-20,-7,0,-4,4,-4,0,-1,-1,-1,-1,-1,5,-1
KR_6713314133,420,0,-56,8,-3,1,2,3,2,2,4,-7,8,1,0,3,3,1,1,2,0,0,-176,-1,-3,4,16,0,-1,-1,0,-1,-1,2,-1
KR_6738464257,420,0,-7,32,1,0,3,3,0,1,1,4,0,4,-3,5,2,0,1,1,2,0,-169,1,-4,3,1,0,-1,1,1,-1,1,3,-1
KR_6695611338,420,0,-15,-22,6,2,0,2,-5,5,0,1,1,2,7,0,7,1,1,2,0,8,-21,-1,-1,2,1,0,0,1,0,0,1,6,-1
KR_6734778305,440,-8,-91,-60,-10,-1,1,0,-4,5,1,-4,6,2,1,0,1,-2,2,0,0,-7,-47,-5,-1,6,17,0,-2,-1,-1,-1,1,5,-1
KR_6537374798,420,1,8,83,-5,-1,1,0,1,0,1,-5,5,0,0,1,1,0,0,0,0,1,6,2,-4,2,2,0,1,0,0,1,-1,0,-1
KR_6762886922,440,-5,-141,-29,-13,-3,4,1,-8,8,0,-2,4,2,0,0,0,0,0,0,0,-7,-10,-2,0,2,-1,-1,-2,-1,-1,-1,-1,3,-1
KR_6754912903,440,-3,-49,-31,-8,-3,3,0,-4,5,1,-2,2,0,1,3,4,0,1,1,0,-5,1,-2,-1,3,0,0,-1,1,-1,-1,1,3,-1
KR_6653204401,420,0,7,-22,-7,0,1,1,-1,2,1,0,1,1,-6,7,1,0,1,1,0,-9,-3,-3,0,3,0,0,0,-1,-1,0,-1,4,-1
KR_6692863147,440,-1,-10,-32,-7,5,1,6,-4,4,0,-6,6,0,-1,3,2,-1,1,0,0,-12,1,-4,-4,8,1,0,1,1,0,1,-1,6,-1
KR_6374393704,420,4,-11,-17,7,-1,1,0,-2,3,1,2,1,3,6,0,6,2,0,2,0,6,0,0,0,0,1,0,0,-1,1,-1,-1,3,-1
KR_6647130654,440,-3,-17,4,-15,2,0,2,-10,12,2,0,1,1,-6,8,2,-1,1,0,0,-19,122,5,-8,3,-6,0,0,0,-1,1,-1,0,-1
KR_6760503322,420,-6,-41,-20,-23,-3,4,1,0,2,2,-9,10,1,-7,7,0,-4,4,0,-2,-22,-12,-7,-3,10,-8,0,-2,-1,-1,-1,-1,6,-1
KR_6749388840,420,-1,-22,0,0,0,1,1,2,1,3,-5,5,0,2,3,5,1,1,2,0,-4,129,-2,0,2,3,0,-1,-1,1,-1,-1,5,-1
KR_6594260557,420,0,4,47,4,-1,3,2,2,6,8,2,2,4,1,1,2,0,1,1,2,3,5,1,-1,0,-1,0,0,1,0,0,1,4,-1
KR_6454236418,420,-1,-25,22,-2,0,1,1,-1,3,2,0,1,1,-1,3,2,0,1,1,0,-1,-1,2,-5,3,0,0,0,-1,1,0,-1,4,-1
KR_6142021548,420,1,-50,-5,-3,1,3,4,0,5,5,0,3,3,-3,6,3,-1,2,1,0,-1,6,-2,-1,3,-2,0,0,1,-1,0,1,1,-1
KR_6693322827,420,-1,-44,7,-6,-3,3,0,-4,4,0,-5,5,0,2,0,2,4,1,5,0,0,5,1,-4,3,-2,0,0,1,-1,-1,-1,2,-1
KR_6624928656,420,2,-3,0,1,1,0,1,0,0,0,-6,9,3,3,2,5,3,2,5,0,6,-22,-1,-4,5,-2,0,0,-1,1,0,-1,1,-1
KR_6689220596,420,0,31,16,-4,3,0,3,-2,3,1,-2,5,3,1,0,1,-4,4,0,-1,-4,-20,-2,-1,3,-1,0,0,0,-1,1,-1,0,-1
KR_6682543761,420,2,40,14,5,-2,3,1,4,5,9,6,2,8,-2,3,1,-1,1,0,-1,-2,288,2,-7,5,1,0,-1,1,0,-1,-1,6,-1
KR_6630995729,420,-2,7,-25,0,0,2,2,1,2,3,1,1,2,-2,4,2,0,0,0,0,-2,4,6,-7,1,3,0,0,-1,1,0,1,3,-1
KR_6652857901,420,-2,-37,-32,-11,1,2,3,-8,9,1,-1,2,1,-1,4,3,-2,2,0,-3,-14,19,1,-5,4,3,0,0,1,1,-1,-1,3,-1
KR_6674747203,420,-3,-79,0,-10,-3,4,1,3,0,3,0,3,3,-2,4,2,-8,8,0,0,-4,10,-1,-2,3,-3,0,-1,-1,-1,-1,-1,4,-1
KR_6721143489,420,-7,-90,-20,-10,-2,5,3,-1,3,2,-1,3,2,-5,6,1,-1,1,0,0,-6,239,-1,-2,3,0,0,-2,-1,0,-1,-1,1,-1
KR_6420512949,420,-1,28,-17,-5,-2,3,1,-1,3,2,1,1,2,-3,4,1,0,2,2,-1,-4,-6,3,-5,2,-5,0,2,-1,1,1,-1,5,-1
KR_6753187121,440,2,-46,-4,8,0,0,0,1,0,1,-1,3,2,1,0,1,7,0,7,0,6,5,2,-8,6,-3,0,0,-1,1,0,1,4,-1
KR_6499903811,420,-4,-74,-10,-8,-4,4,0,-2,7,5,-5,5,0,0,1,1,3,1,4,0,-1,-32,4,-4,0,17,0,-3,1,-1,-1,-1,3,-1
KR_6655319208,440,-1,24,20,3,-3,3,0,2,5,7,5,1,6,-1,2,1,0,0,0,2,11,15,0,-3,3,-3,0,0,0,-1,0,1,0,-1
KR_6637189241,420,-6,-86,-18,-13,0,0,0,-4,7,3,-7,8,1,0,4,4,-2,3,1,0,-4,-12,-4,0,4,-1,0,-2,-1,1,-1,1,1,-1
KR_6738279876,420,0,-24,-26,2,0,3,3,0,2,2,4,0,4,1,2,3,-3,3,0,0,4,-47,1,-6,5,14,0,0,-1,-1,-1,-1,5,-1
KR_6717682242,420,-7,-117,-46,-11,-1,2,1,1,3,4,-3,3,0,-3,4,1,-5,5,0,1,-3,11,3,-5,2,-5,0,-1,0,0,-1,1,0,-1
KR_6764091461,420,-1,-7,-28,-9,3,1,4,-7,8,1,-2,2,0,-2,5,3,-1,2,1,0,-9,8,-5,-1,6,3,0,-1,1,-1,-1,-1,1,-1
KR_6644226452,420,2,32,-15,-2,-1,2,1,0,1,1,-3,3,0,0,2,2,2,0,2,0,0,-4,-7,-1,8,5,0,0,0,1,0,-1,0,-1
KR_6634474414,420,-3,-59,-24,0,-2,5,3,2,1,3,3,0,3,-2,5,3,-1,2,1,0,0,-53,-1,-1,2,15,0,-1,-1,1,-1,-1,6,-1
KR_6714127441,420,-2,14,-44,-8,0,0,0,-1,3,2,0,4,4,-8,8,0,1,1,2,0,-12,-262,-4,-2,6,5,0,-1,-1,-1,-1,1,6,-1
KR_6722280087,420,-1,60,-28,-8,5,0,5,-4,4,0,-1,4,3,-2,3,1,-6,6,0,0,-12,2,1,-4,3,1,0,-1,-1,-1,-1,-1,1,-1
KR_6520896245,440,0,18,-16,0,2,3,5,0,1,1,-1,3,2,0,1,1,-1,4,3,0,-3,3,-3,-1,4,0,0,-1,-1,-1,-1,1,6,-1
KR_6668381838,420,-4,-42,-14,-3,0,1,1,-4,5,1,-3,4,1,4,2,6,0,0,0,0,-11,-4,-2,-1,3,5,0,0,0,-1,0,1,0,-1
KR_6761583364,420,-4,-76,25,-4,0,1,1,1,3,4,-1,2,1,-5,5,0,1,0,1,0,-3,5,2,-3,1,-1,0,0,0,1,0,-1,0,-1
KR_6719351887,440,-3,-24,-16,-3,-3,3,0,-2,4,2,3,2,5,-1,3,2,0,1,1,0,0,18,1,-5,4,1,0,0,-1,1,0,1,2,-1
KR_6683139707,420,-1,-2,16,-5,3,1,4,-2,3,1,-3,4,1,2,4,6,-5,6,1,0,-6,0,2,-3,1,-2,0,0,0,1,-1,1,0,-1
KR_6714579730,420,-1,-16,-2,0,6,0,6,-1,2,1,-2,3,1,-1,4,3,-2,3,1,0,-3,-22,-3,-2,5,4,0,0,1,1,0,1,1,-1
KR_6761117442,420,-2,-34,-8,2,0,1,1,0,0,0,2,1,3,0,3,3,0,1,1,0,2,8,-1,-1,2,1,0,1,-1,1,1,1,3,-1
KR_6058069562,420,-3,-37,-35,-10,3,0,3,-3,3,0,-3,4,1,1,1,2,-8,8,0,0,-21,-24,-2,-5,7,-1,0,-1,-1,1,-1,1,4,-1
KR_6639217532,420,-3,-75,-4,-1,1,2,3,1,0,1,3,0,3,-2,4,2,-4,4,0,0,2,-5,1,-2,1,1,0,-1,1,-1,-1,1,4,-1
KR_6720208493,420,-1,-62,-32,1,-7,8,1,-1,2,1,3,1,4,3,2,5,3,0,3,0,11,39,-2,-1,3,-10,0,0,-1,-1,-1,1,3,-1
KR_6612761813,420,-1,7,-24,0,0,1,1,-2,4,2,3,3,6,0,2,2,-1,2,1,0,-4,-1,0,-4,4,5,0,0,-1,0,0,1,3,-1
KR_6670469351,420,-1,0,-2,-3,0,0,0,1,2,3,-3,3,0,2,0,2,-3,3,0,0,-4,41,3,-7,4,-26,0,0,1,1,1,-1,5,-1
KR_6750009097,440,2,4,8,-6,2,1,3,3,1,4,-6,9,3,-3,4,1,-2,6,4,1,-5,-23,-5,0,5,3,0,-2,0,-1,-1,1,0,-1
KR_6733429362,420,-3,-98,0,-7,1,1,2,3,1,4,-8,9,1,0,3,3,-3,4,1,0,-5,-4,-5,0,5,1,0,0,-1,-1,0,-1,1,-1
KR_6759297503,440,-1,-39,-25,-11,-8,8,0,2,2,4,-1,4,3,-5,6,1,1,0,1,0,-6,11,1,-4,3,-2,0,0,1,-1,-1,-1,1,-1
KR_6714797429,420,-4,41,-31,-16,-3,3,0,-7,7,0,3,1,4,-7,7,0,-2,3,1,0,-16,-13,1,-3,2,-1,0,0,-1,-1,-1,-1,6,-1
KR_6754168895,420,-2,-76,4,-6,0,1,1,1,1,2,-2,4,2,-5,6,1,0,1,1,0,-6,-29,-3,-3,6,-3,0,-2,1,-1,-1,-1,6,-1
KR_6724842349,440,4,14,-8,6,5,0,5,3,2,5,2,3,5,-4,6,2,0,3,3,0,2,12,7,-8,1,-2,0,2,0,-1,1,-1,0,-1
KR_6717757802,420,-5,-12,-45,-5,-2,2,0,-2,2,0,-1,2,1,-1,1,0,1,1,2,0,-2,-4,-2,0,2,-1,0,0,-1,-1,0,-1,1,-1
KR_6723892961,420,-5,-101,8,-8,-4,4,0,0,3,3,-4,4,0,0,1,1,0,0,0,0,1,-6,0,-2,2,1,0,-3,1,-1,-1,-1,3,-1
KR_6726179385,440,-8,6,-96,-8,-1,1,0,-2,2,0,-2,4,2,-3,3,0,0,2,2,0,-7,-10,-1,-1,2,0,0,-2,0,-1,-1,-1,0,-1
KR_6737050133,420,1,23,28,3,2,1,3,-1,3,2,-2,3,1,1,0,1,3,0,3,0,2,-9,-1,-2,3,3,0,1,0,-1,1,1,0,-1
KR_6650276827,420,0,29,0,7,-2,3,1,1,2,3,3,2,5,2,2,4,3,2,5,0,7,-5,-1,-2,3,2,0,2,-1,1,1,-1,1,-1
KR_6754167097,420,0,2,-12,-3,-1,1,0,-1,4,3,1,2,3,-1,3,2,-1,3,2,0,-5,-125,-2,-3,5,0,0,0,-1,0,-1,-1,4,-1
KR_6714729245,420,1,18,-16,1,1,0,1,-4,6,2,-2,2,0,7,0,7,-1,1,0,1,4,0,1,-4,3,0,0,0,-1,1,0,1,6,-1
KR_6739160982,420,-2,-72,0,1,-2,2,0,3,1,4,-2,2,0,-2,4,2,4,1,5,0,3,-49,0,-5,5,-1,0,0,-1,-1,-1,-1,2,-1
KR_6734304724,440,-1,-17,-17,-9,-1,2,1,-3,3,0,-6,6,0,-2,3,1,3,0,3,0,-8,-4,-3,-3,6,-5,0,1,-1,1,1,-1,2,-1
KR_6424752169,420,-2,13,-32,-3,-1,2,1,-1,3,2,1,2,3,2,0,2,-4,5,1,1,2,-199,1,-3,2,2,0,-1,-1,-1,-1,1,5,-1
KR_6001762769,420,-3,-29,-30,-2,-2,3,1,-5,9,4,4,0,4,4,2,6,-3,3,0,-1,0,22,3,-7,4,-3,0,-1,-1,-1,-1,-1,2,-1
KR_5968075418,420,1,-63,-19,2,-4,4,0,3,4,7,0,0,0,3,4,7,0,1,1,0,4,4,4,-6,2,2,0,-1,-1,-1,-1,-1,3,-1
KR_6750846338,420,-1,-25,16,-7,-4,4,0,0,5,5,-2,4,2,0,2,2,-1,1,0,0,-1,-5,0,-3,3,-2,0,0,-1,1,1,-1,4,-1
KR_6696932236,420,-3,-61,6,-6,0,2,2,-2,3,1,-1,2,1,-1,4,3,-2,3,1,-1,-9,166,1,-2,1,1,0,0,-1,-1,-1,-1,2,-1
KR_6698479689,420,-3,-50,-16,3,0,3,3,0,3,3,2,2,4,1,2,3,0,1,1,4,17,13,8,-10,2,-8,0,-1,1,-1,-1,1,6,-1
KR_6621397141,420,2,54,12,-3,-1,1,0,-1,1,0,-1,5,4,-1,1,0,1,0,1,0,-10,40,-1,-3,4,-14,0,0,1,1,0,-1,2,-1
KR_6144774519,420,-2,-34,-17,-4,2,0,2,-5,7,2,-2,2,0,-3,4,1,4,1,5,0,-7,-5,-2,0,2,1,0,-4,-1,1,-1,1,4,-1
KR_6083280650,440,-4,-51,6,-6,-3,3,0,2,3,5,1,1,2,-3,6,3,-3,4,1,0,-8,4,-5,-2,7,-3,0,0,-1,-1,0,1,5,-1
KR_6515426613,420,-4,-83,-39,-16,-1,2,1,-5,6,1,-6,8,2,-3,3,0,-1,2,1,-2,-15,-304,-4,-3,7,1,0,0,-1,1,-1,-1,3,-1
KR_6595994034,420,-5,-38,-20,-7,-3,3,0,4,2,6,-6,6,0,-2,4,2,0,2,2,0,5,2,-4,-1,5,1,0,0,-1,-1,0,-1,6,-1
KR_6659247780,420,1,-29,4,5,0,1,1,0,1,1,4,1,5,0,0,0,1,0,1,0,1,3,0,-3,3,0,0,-1,-1,-1,-1,1,6,-1
KR_6672533798,420,1,-5,5,4,0,0,0,3,2,5,2,1,3,-2,3,1,1,0,1,0,2,-11,-1,-3,4,2,0,-1,1,1,-1,1,5,-1
KR_6746544189,420,-5,-130,-44,-13,2,0,2,-2,2,0,-8,9,1,-6,6,0,1,1,2,-3,-13,-11,-4,0,4,0,0,-2,-1,-1,-1,-1,1,-1
KR_6679742267,420,-2,-67,-11,-6,1,2,3,-2,2,0,-3,5,2,-1,2,1,-1,1,0,0,-1,0,0,-4,4,0,0,0,0,0,0,-1,0,-1
KR_6646961689,420,-5,-66,-5,-5,-1,3,2,4,2,6,-2,6,4,-4,6,2,-2,3,1,0,-2,-358,1,-2,1,-2,0,-1,-1,1,-1,1,4,-1
KR_6678933991,420,-4,-30,-19,-3,-3,3,0,0,2,2,1,2,3,-1,2,1,0,0,0,0,6,13,1,-3,2,3,0,-1,-1,1,1,1,6,-1
KR_6687103832,420,0,-43,-60,5,0,1,1,6,1,7,3,1,4,-3,3,0,-1,1,0,0,9,1,-3,-5,8,-3,0,-1,-1,-1,-1,1,1,-1
KR_6487518550,420,0,102,24,-3,-1,3,2,2,1,3,-2,4,2,-1,2,1,-1,1,0,0,-2,1,3,-6,3,-4,0,0,0,-1,0,-1,0,-1
KR_6743420936,420,-2,-25,24,-9,-1,1,0,-1,1,0,1,2,3,-6,6,0,-2,2,0,0,-10,-167,-8,0,8,11,0,-2,-1,0,-1,-1,5,-1
KR_6752592080,420,-5,-35,-33,-12,-2,5,3,0,1,1,-8,10,2,0,2,2,-2,2,0,0,-5,-10,-5,-1,6,1,0,-2,-1,-1,-1,-1,1,-1
KR_6504313497,420,0,-56,23,-2,-1,1,0,0,1,1,2,2,4,-2,2,0,-1,1,0,0,-4,1,1,-2,1,-3,0,-1,-1,1,-1,-1,4,-1
KR_6410760639,420,-2,16,-10,-9,1,2,3,1,2,3,-5,5,0,-6,8,2,0,0,0,-1,-5,-8,-4,-2,6,3,0,0,-1,-1,0,-1,5,-1
KR_6548420915,420,1,-22,-20,0,1,3,4,1,2,3,1,1,2,2,1,3,-5,6,1,0,1,-3,0,-3,3,-4,0,-1,-1,0,-1,-1,2,-1
KR_6728163776,420,-2,-96,-27,0,3,1,4,-1,3,2,-1,2,1,-1,2,1,0,1,1,1,-2,86,1,-2,1,-1,0,0,-1,1,0,1,2,-1
KR_6570036885,420,-3,-101,3,-7,0,1,1,2,4,6,0,2,2,-8,9,1,-1,2,1,-1,-11,3,2,-4,2,-1,0,-1,-1,-1,-1,-1,1,-1
KR_6727904770,420,-3,-70,0,-10,-4,4,0,-3,7,4,-1,3,2,-4,4,0,2,0,2,1,-3,2,-1,-3,4,-1,0,0,1,-1,0,1,6,-1
KR_6746557947,440,-4,-15,8,-11,1,2,3,1,3,4,2,0,2,-4,6,2,-11,11,0,0,-11,-18,-4,-2,6,1,0,-1,-1,-1,-1,-1,6,-1
KR_6618330668,420,-4,-67,13,-16,-8,8,0,-1,2,1,-4,9,5,-2,4,2,-1,3,2,-2,-7,3,-4,0,4,1,0,0,-1,-1,-1,-1,3,-1
KR_6484146579,420,2,-7,15,2,3,1,4,-1,3,2,-1,4,3,1,2,3,0,1,1,-1,-3,9,-2,-4,6,-3,0,2,-1,1,1,-1,2,-1
KR_6661154619,420,-2,-49,-36,-5,-4,6,2,4,1,5,-2,2,0,-5,6,1,2,0,2,-1,0,-17,0,-3,3,7,0,-1,-1,-1,-1,-1,2,-1
KR_6153964651,420,2,37,4,3,3,3,6,0,2,2,-2,3,1,1,1,2,1,0,1,0,2,22,2,-7,5,0,0,0,0,0,0,1,0,-1
KR_6749220628,440,-2,-33,5,-10,-5,5,0,-1,4,3,-1,3,2,-2,3,1,-1,1,0,0,-14,4,0,-2,2,-4,0,-1,0,-1,-1,-1,0,-1
KR_6764491794,420,-2,-62,-27,-7,-4,4,0,2,1,3,1,2,3,-4,5,1,-2,2,0,0,-7,3,-5,-2,7,-3,0,-3,-1,-1,-1,-1,1,-1
KR_6692638149,420,1,16,25,-1,0,3,3,-2,4,2,-2,2,0,5,2,7,-2,3,1,0,3,2,-1,-2,3,2,0,1,-1,-1,-1,-1,1,-1
KR_6630973310,420,-4,-17,3,-7,-1,1,0,-5,5,0,0,2,2,-1,4,3,0,1,1,0,-6,-5,1,-2,1,-2,0,-1,1,-1,-1,-1,3,-1
KR_6753471802,440,-4,-143,1,-7,-4,4,0,-1,1,0,-4,6,2,2,2,4,0,0,0,0,-2,-32,-2,-2,4,14,0,-1,1,0,-1,-1,1,-1
KR_6759010538,440,-3,14,-12,-11,-2,2,0,-8,10,2,-3,6,3,-2,3,1,4,2,6,-1,-16,0,-2,-1,3,-1,0,-2,-1,0,-1,-1,1,-1
KR_6721222497,420,-1,12,-8,-7,1,1,2,-4,4,0,-5,6,1,-1,4,3,2,2,4,0,-2,3,0,-3,3,-1,0,-1,1,-1,-1,-1,5,-1
KR_6731902696,420,-3,-11,-6,-3,-2,2,0,1,2,3,0,0,0,-2,3,1,0,0,0,0,-6,128,1,-4,3,-1,0,0,1,-1,0,1,3,-1
KR_6653229105,420,-4,40,-24,-5,4,0,4,-8,8,0,3,1,4,0,2,2,-4,4,0,0,-13,55,1,-3,2,1,0,0,-1,-1,-1,-1,6,-1
KR_6695334810,440,-5,-41,-17,-13,-2,3,1,-1,3,2,-3,3,0,-2,3,1,-5,7,2,0,-10,-16,-4,-3,7,2,0,-4,-1,-1,-1,-1,2,-1
KR_6717330218,420,-2,-70,-32,-1,-2,4,2,0,1,1,-2,3,1,2,0,2,1,1,2,0,0,-2,-1,-4,5,-2,0,0,1,-1,-1,1,4,-1
KR_6750812651,420,-2,-6,-6,-10,-1,2,1,-2,4,2,0,5,5,-7,10,3,0,2,2,0,-25,260,-5,0,5,-2,0,-1,-1,-1,-1,-1,1,-1
KR_6743088783,420,-7,-96,-49,-6,-3,4,1,-1,2,1,3,2,5,-5,7,2,0,2,2,0,3,26,2,-5,3,0,0,-1,-1,-1,-1,1,4,-1
KR_6719787881,440,2,-1,12,9,-2,3,1,3,1,4,0,0,0,8,3,11,0,1,1,0,11,6,5,-8,3,2,0,2,1,1,1,1,5,-1
KR_6729092650,420,-3,-47,-11,-12,-6,6,0,-7,7,0,0,4,4,1,2,3,0,2,2,-2,-3,-258,0,-2,2,-1,0,-2,1,-1,-1,-1,2,-1
KR_6751591152,420,-6,-66,-35,-12,-1,3,2,-5,5,0,1,2,3,-10,10,0,3,1,4,0,-12,3,1,-3,2,1,0,-1,0,-1,-1,-1,0,-1
KR_6508484621,420,-3,-21,-4,-3,0,3,3,1,0,1,-2,3,1,0,3,3,-2,2,0,0,-2,223,-7,-5,12,5,0,0,1,0,0,-1,2,-1
KR_6331575044,420,-1,13,-12,-1,0,0,0,2,3,5,-2,4,2,1,8,9,-2,2,0,0,0,-2,-1,-2,3,-5,0,0,-1,-1,0,1,4,-1
KR_6617653195,420,-5,-56,-44,-12,-4,4,0,-3,4,1,1,4,5,0,3,3,-6,6,0,0,-4,19,-1,-3,4,-2,0,-1,0,-1,-1,-1,0,-1
KR_6690848197,440,-3,-9,-16,-8,0,1,1,-3,5,2,-3,5,2,-4,5,1,2,0,2,-1,-16,-219,-6,-5,11,-3,0,-1,-1,-1,-1,-1,5,-1
KR_6754183893,440,-2,-46,-35,1,1,0,1,1,1,2,0,2,2,3,3,6,-4,4,0,0,-1,7,-7,-4,11,7,0,-2,-1,-1,-1,1,5,-1
KR_6496908632,420,-4,-63,-7,-5,-6,6,0,1,1,2,-1,2,1,2,1,3,-1,2,1,0,-2,7,-5,0,5,-1,0,-1,-1,-1,-1,-1,5,-1
KR_6565832781,420,0,-37,-4,-4,-3,5,2,-2,3,1,-2,3,1,2,2,4,1,0,1,0,-1,-24,1,-5,4,5,0,-1,-1,-1,-1,1,2,-1
KR_6754993721,440,-1,-83,0,-2,-2,5,3,2,3,5,-2,2,0,2,0,2,-2,2,0,0,-13,-14,2,-5,3,-1,0,-1,1,1,-1,-1,3,-1
KR_6739860919,440,-1,54,0,9,3,2,5,0,1,1,-3,5,2,4,1,5,5,1,6,3,14,17,2,-3,1,-5,0,1,1,-1,1,1,2,-1
KR_6692170346,420,-3,-30,-20,-8,-1,1,0,1,0,1,-2,4,2,-7,8,1,1,0,1,-1,-2,8,0,-3,3,-2,0,-1,1,0,-1,-1,3,-1
KR_6691861533,440,-3,-60,0,-4,1,2,3,-4,4,0,1,1,2,-1,1,0,-1,2,1,0,-3,7,-1,-7,8,1,0,-2,1,0,-1,-1,6,-1
KR_6710603486,420,2,18,36,-2,0,2,2,-3,4,1,1,1,2,-1,2,1,1,0,1,0,-7,-16,-5,-1,6,0,0,2,1,-1,1,-1,5,-1
KR_6760619271,440,-4,-62,-9,-12,-2,3,1,-9,10,1,0,2,2,-1,3,2,0,0,0,0,-11,-19,-4,-1,5,1,0,0,-1,0,-1,1,3,-1
KR_6670959594,420,-1,-13,-65,4,1,3,4,1,5,6,-2,2,0,3,2,5,1,1,2,1,5,1,-4,-1,5,2,0,-1,0,-1,1,1,0,-1
KR_6665444331,420,-4,-7,-35,-1,-1,3,2,1,2,3,-2,5,3,1,1,2,0,0,0,0,-2,-6,0,-1,1,0,0,0,-1,-1,-1,-1,6,-1
KR_6616500396,420,-3,-20,17,-7,6,2,8,-3,3,0,-5,6,1,-4,4,0,-1,2,1,1,-10,16,4,-5,1,-1,0,-1,-1,1,-1,1,6,-1
KR_6688936470,420,-10,-160,-19,-17,-3,4,1,-1,3,2,-9,10,1,-4,5,1,0,0,0,0,-11,136,0,-3,3,0,0,-4,-1,-1,-1,-1,6,-1
KR_6617808963,420,2,0,23,5,-2,2,0,-6,7,1,5,0,5,4,1,5,4,0,4,0,3,-175,-2,-1,3,0,0,0,1,0,-1,-1,4,-1
KR_6757310950,420,2,61,-40,9,-2,5,3,3,1,4,2,1,3,4,1,5,2,0,2,2,11,7,-2,-1,3,-2,0,2,1,-1,1,1,2,-1
KR_6742652810,420,-1,-58,15,-3,1,3,4,0,3,3,-6,6,0,1,0,1,1,1,2,-1,2,-7,1,-3,2,-3,0,0,-1,1,0,-1,4,-1
KR_6682655240,420,-5,-75,-16,-9,-3,4,1,0,1,1,-2,4,2,1,2,3,-5,6,1,-1,-6,12,4,-7,3,0,0,-2,-1,-1,-1,-1,2,-1
KR_6756809170,420,-1,-10,9,-2,-2,3,1,-3,3,0,-2,3,1,3,0,3,2,1,3,0,5,139,-6,-2,8,5,0,-1,1,-1,-1,1,1,-1
KR_6757831789,420,-3,12,12,-14,-4,5,1,-2,3,1,-7,7,0,2,2,4,-3,4,1,0,-16,-272,-1,-3,4,-3,0,-1,1,1,-1,-1,2,-1
KR_6706298119,440,-1,-22,40,-7,0,1,1,-1,5,4,2,2,4,-7,7,0,-1,3,2,-1,-13,-16,-4,0,4,3,0,-1,0,0,-1,-1,0,-1
KR_6695806106,420,0,-8,-4,-5,-1,2,1,1,3,4,0,2,2,-1,2,1,-4,4,0,0,-5,269,3,-6,3,0,0,0,0,0,0,-1,0,-1
KR_6714481419,420,0,-9,9,-3,-6,6,0,0,0,0,0,3,3,1,1,2,2,0,2,-1,1,-2,0,-4,4,-1,0,1,1,-1,-1,-1,2,-1
KR_6617291377,420,-4,-37,-4,-12,-5,5,0,-3,4,1,-2,4,2,-3,6,3,1,1,2,0,-8,-22,0,-5,5,4,0,2,-1,-1,-1,-1,6,-1
KR_6738503292,420,2,-17,-12,6,3,1,4,1,0,1,-7,7,0,6,0,6,3,0,3,0,6,-2,-3,-3,6,0,0,1,1,-1,1,-1,1,-1
KR_6648814768,420,-4,-45,12,-9,-6,8,2,-1,2,1,-1,1,0,1,0,1,-2,2,0,0,-8,106,3,-4,1,-2,0,1,-1,1,-1,-1,1,-1
KR_6613310264,420,3,-6,31,1,-3,5,2,1,1,2,-3,5,2,5,1,6,1,1,2,0,13,13,1,-2,1,2,0,-1,-1,1,1,-1,3,-1
KR_6602343148,420,-4,-59,-20,-12,-1,4,3,-6,6,0,1,3,4,-4,5,1,-2,3,1,0,-7,-1,0,-3,3,2,0,-3,-1,-1,-1,-1,2,-1
KR_6740509135,420,2,59,-8,9,0,2,2,1,0,1,5,1,6,3,3,6,0,1,1,0,7,1,-4,-2,6,8,0,-1,1,1,1,-1,5,-1
KR_6725526828,420,0,-65,0,-7,0,1,1,-2,4,2,1,3,4,-7,10,3,1,0,1,-1,-10,169,2,-4,2,-1,0,0,1,-1,0,-1,2,-1
KR_6581564844,420,-4,23,-57,2,-1,3,2,0,1,1,1,0,1,3,0,3,-1,1,0,-1,2,1,2,-3,1,-2,0,0,1,-1,-1,-1,1,-1
KR_6764000279,420,3,17,-16,5,4,0,4,1,1,2,-1,3,2,3,0,3,-2,3,1,0,2,-1,-2,-2,4,-2,0,0,1,1,0,-1,1,-1
KR_6668998321,440,-6,8,-11,-13,-3,4,1,-2,3,1,-1,2,1,-6,7,1,-1,1,0,0,-11,-5,1,-4,3,1,0,-2,1,-1,-1,-1,3,-1
KR_6756243557,420,-1,-29,-3,4,-1,3,2,-3,4,1,1,1,2,8,0,8,-1,2,1,0,5,160,0,-4,4,4,0,1,-1,-1,1,1,2,-1
KR_6730586832,420,-1,-68,0,0,-5,7,2,0,2,2,1,1,2,2,0,2,2,0,2,0,5,-5,-2,0,2,0,0,-2,-1,-1,-1,1,4,-1
KR_6692790815,440,1,-97,0,-2,-1,1,0,1,1,2,-2,3,1,1,2,3,-1,1,0,0,5,-24,-6,0,6,1,0,0,-1,-1,0,-1,1,-1
KR_6576258471,440,-1,-48,25,7,2,3,5,2,3,5,2,1,3,-1,2,1,2,1,3,1,8,226,0,-1,1,4,0,-1,1,1,1,1,4,-1
KR_6657959687,420,2,69,0,1,0,2,2,1,0,1,1,2,3,1,1,2,-2,2,0,0,-1,17,1,-2,1,1,0,0,-1,1,0,1,6,-1
KR_6705691773,420,2,34,16,1,-2,3,1,0,1,1,2,2,4,0,1,1,1,0,1,0,-1,5,-1,-1,2,2,0,0,0,-1,0,1,0,-1
KR_6332672810,440,-5,-81,8,-16,-2,3,1,-8,9,1,-3,6,3,-1,3,2,-2,2,0,0,-19,4,2,-5,3,-2,0,0,1,0,-1,-1,4,-1
KR_6705860470,420,2,10,-16,7,3,1,4,-5,5,0,4,1,5,4,0,4,1,0,1,0,4,11,0,-3,3,-1,0,1,0,-1,1,1,0,-1
KR_6578523764,420,-3,-97,-4,-16,1,2,3,-4,6,2,-4,5,1,-6,9,3,-3,4,1,-1,-13,355,-1,0,1,-3,0,-3,-1,0,-1,-1,6,-1
KR_6722928699,420,-1,33,-4,-9,1,1,2,0,1,1,0,2,2,-9,11,2,-1,1,0,0,-14,-6,1,-4,3,2,0,-1,0,0,-1,1,0,-1
KR_6759361551,440,1,-62,8,9,-5,5,0,6,0,6,0,3,3,3,1,4,5,0,5,1,16,10,3,-7,4,-7,0,-1,0,-1,-1,1,0,-1
KR_6758262396,420,2,33,6,3,-1,2,1,5,1,6,-3,6,3,1,2,3,1,0,1,0,6,3,-2,-1,3,1,0,-1,1,1,-1,-1,5,-1
KR_6737695218,440,-2,-80,16,-7,3,1,4,-1,1,0,-4,4,0,-1,4,3,-4,6,2,0,-8,36,1,-4,3,-1,0,-2,-1,1,-1,-1,1,-1
KR_6723780210,420,-2,-30,-20,-2,2,1,3,0,2,2,4,1,5,-4,5,1,-4,4,0,0,-4,-391,0,-1,1,1,0,0,0,0,-1,-1,0,-1
KR_6689891168,420,-5,-78,-5,-8,1,2,3,1,1,2,-7,9,2,-2,3,1,-1,1,0,-1,-4,-1,0,-3,3,-1,0,-2,1,-1,-1,-1,5,-1
KR_5532787998,420,-2,-67,11,-7,-7,7,0,1,3,4,1,1,2,-3,4,1,1,1,2,0,-1,-10,-3,-1,4,-2,0,-3,-1,-1,-1,-1,4,-1
KR_6758704899,420,0,-40,8,5,6,0,6,4,0,4,-1,3,2,-5,5,0,1,1,2,0,-3,5,4,-4,0,1,0,1,0,1,1,1,0,-1
KR_6584310943,420,0,-21,13,3,0,2,2,-2,3,1,6,0,6,-2,2,0,1,2,3,0,-2,1,-1,-5,6,2,0,0,1,-1,-1,1,6,-1
KR_6692731154,420,-1,-6,15,-14,-3,4,1,-1,1,0,3,2,5,-11,11,0,-2,2,0,0,-14,-4,1,-2,1,-1,0,-2,-1,1,-1,-1,4,-1
KR_6141697372,420,0,-35,-8,4,-3,5,2,0,3,3,2,0,2,4,0,4,1,1,2,0,3,62,2,-5,3,-42,0,-1,-1,0,-1,1,1,-1
KR_6757817067,420,-2,-17,-27,-1,-4,4,0,1,2,3,-3,3,0,4,0,4,1,0,1,0,2,90,1,-3,2,2,0,-1,-1,-1,-1,-1,6,-1
KR_6606153418,420,-5,-100,-60,-12,-2,3,1,-3,3,0,1,1,2,-5,5,0,-3,4,1,0,-9,-137,-2,-3,5,-3,0,-2,-1,-1,-1,-1,1,-1
KR_6751922361,420,4,-9,1,6,4,2,6,-2,5,3,-1,3,2,1,2,3,4,1,5,0,7,0,-1,-3,4,2,0,1,-1,-1,1,1,5,-1
KR_6739956242,420,5,29,-12,12,3,3,6,1,2,3,7,0,7,2,2,4,-1,1,0,0,6,14,1,-4,3,1,0,1,-1,-1,1,-1,4,-1
KR_6759587088,420,1,-19,-28,2,-4,5,1,-2,2,0,3,0,3,5,0,5,0,1,1,0,5,8,-1,-4,5,2,0,0,-1,1,0,-1,2,-1
KR_6660509129,420,-3,-49,-12,1,-1,1,0,-2,2,0,-6,6,0,8,1,9,2,0,2,0,7,-18,-3,-2,5,4,0,-1,1,1,-1,-1,1,-1
KR_6577407825,440,-3,-37,-13,-3,1,1,2,-3,5,2,2,4,6,-2,3,1,-1,1,0,0,-1,1,3,-5,2,0,0,0,-1,1,1,-1,5,-1
KR_6118169670,440,-2,-33,28,-7,-2,2,0,-1,4,3,-4,4,0,-1,1,0,1,0,1,0,-8,-5,0,-3,3,2,0,0,-1,-1,-1,-1,4,-1
KR_6618175555,420,0,4,32,-5,-1,1,0,2,1,3,-3,4,1,-2,2,0,-1,2,1,0,-7,-7,2,-6,4,0,0,0,-1,1,0,-1,5,-1
KR_6118751391,420,0,-62,-4,-5,-6,6,0,-3,3,0,0,2,2,4,1,5,0,2,2,-1,0,-287,3,-5,2,0,0,-1,1,-1,-1,-1,5,-1
KR_6740754986,420,-2,-5,-19,-7,1,2,3,-2,5,3,-2,6,4,-1,2,1,-3,3,0,0,-5,5,-1,-1,2,-5,0,0,-1,1,1,1,6,-1
KR_6736439082,440,-3,11,-32,-9,-2,4,2,-4,4,0,1,1,2,-3,3,0,-1,3,2,0,3,11,3,-6,3,3,0,-1,1,-1,-1,1,1,-1
KR_6748906098,420,-1,-43,12,-12,-5,5,0,-3,5,2,-4,5,1,0,1,1,0,1,1,0,-4,-6,1,-1,0,-1,0,0,-1,0,0,-1,2,-1
KR_6680536644,420,0,14,9,-2,2,2,4,-4,4,0,-2,3,1,3,4,7,-1,2,1,0,-1,-61,1,-4,3,0,0,0,0,1,0,-1,0,-1
KR_6750525706,440,-3,-17,-18,-13,-4,8,4,-5,5,0,-2,2,0,-3,3,0,1,2,3,0,-17,14,-1,-4,5,1,0,0,-1,-1,-1,1,3,-1
KR_6726329290,420,-2,-21,-8,0,-3,3,0,7,0,7,-2,2,0,-1,3,2,-1,1,0,0,2,-2,0,-2,2,2,0,0,1,-1,0,-1,6,-1
KR_6685191611,440,-1,-77,1,-3,-1,1,0,1,3,4,-1,1,0,-2,4,2,0,1,1,0,-3,0,1,-1,0,-2,0,-1,1,-1,-1,-1,5,-1
KR_6752483116,440,-6,-80,-24,-24,-6,8,2,0,1,1,-7,7,0,-2,2,0,-9,10,1,0,-14,-1,-4,-2,6,-2,0,-1,-1,1,-1,-1,1,-1
KR_6724759941,440,0,19,-41,-5,-3,3,0,-5,6,1,1,3,4,0,2,2,2,1,3,0,-5,2,-1,-1,2,2,0,2,-1,0,1,1,4,-1
KR_6761020537,420,-5,-116,-28,-9,-4,4,0,1,0,1,0,2,2,-6,9,3,0,3,3,0,-3,-8,-1,-3,4,-1,0,-1,-1,-1,-1,-1,3,-1
KR_6689864413,420,-4,-25,12,-10,-1,2,1,1,1,2,-8,8,0,-2,3,1,0,1,1,0,-12,4,-3,-2,5,-2,0,0,-1,1,0,-1,4,-1
KR_6751349238,420,0,-8,19,-5,0,0,0,-4,4,0,-2,2,0,2,1,3,-1,1,0,0,-6,-6,0,-5,5,6,0,0,-1,1,0,-1,2,-1
KR_6381804158,420,0,18,40,-3,-1,1,0,2,1,3,-2,4,2,2,3,5,-4,4,0,-1,-6,-360,-1,-5,6,-4,0,0,1,-1,0,-1,3,-1
KR_6732024702,420,-2,-26,12,-8,-2,3,1,1,1,2,-7,8,1,0,2,2,0,1,1,-1,-4,-18,2,-4,2,1,0,0,-1,1,1,-1,5,-1
KR_6700990106,440,-2,11,6,-2,0,2,2,5,0,5,0,3,3,0,1,1,-7,7,0,0,-5,-12,-3,-2,5,0,0,-1,1,1,-1,1,6,-1
KR_6763834631,420,-3,-19,3,-4,-2,3,1,-1,5,4,-1,5,4,0,1,1,0,0,0,0,5,-230,-2,-1,3,1,0,-2,-1,1,-1,1,6,-1
KR_5921417671,440,-5,-104,-13,-8,-1,3,2,-1,1,0,-3,3,0,-4,7,3,1,0,1,1,-9,-9,-3,-1,4,6,0,-2,1,1,-1,1,2,-1
KR_6753912084,420,-2,8,22,6,-12,14,2,1,1,2,4,2,6,10,1,11,3,0,3,1,15,4,0,-3,3,3,0,-2,0,-1,-1,-1,0,-1
KR_6701132141,420,-4,-13,-76,-12,0,4,4,-3,3,0,-1,1,0,-7,7,0,-1,2,1,0,-13,231,-4,0,4,3,0,-2,-1,-1,-1,-1,2,-1
KR_6505104613,420,4,31,10,15,5,0,5,9,0,9,-1,2,1,1,1,2,1,1,2,0,11,3,-1,-3,4,5,0,1,1,1,1,1,1,-1
KR_6675004999,420,2,61,-32,-5,0,2,2,-3,8,5,-4,5,1,2,1,3,0,0,0,0,-5,-4,-1,-3,4,-1,0,0,-1,-1,0,-1,1,-1
KR_6750600992,440,-2,-92,-4,-5,-2,3,1,6,1,7,0,3,3,-8,11,3,-1,1,0,0,-17,-6,-5,-1,6,1,0,-1,-1,-1,-1,-1,5,-1
KR_6761842870,420,-3,-93,-35,-2,3,1,4,-1,2,1,-4,5,1,0,1,1,0,1,1,0,-5,-5,-1,-4,5,0,0,-2,1,0,-1,-1,2,-1
KR_6449811900,420,-4,11,-48,-4,0,4,4,-5,6,1,2,2,4,-3,4,1,2,1,3,0,-1,-358,-1,-1,2,1,0,-2,-1,-1,-1,-1,4,-1
KR_6720970370,420,-2,-51,18,-4,3,3,6,-4,4,0,-6,6,0,4,1,5,-1,1,0,0,-6,32,1,-2,1,-24,0,0,-1,-1,1,-1,1,-1
KR_6749926377,420,1,-63,20,6,-5,6,1,3,1,4,4,1,5,1,1,2,3,3,6,0,7,-1,2,-2,0,-3,0,-4,1,1,-1,1,3,-1
KR_6644354647,420,-1,-79,8,-10,-4,5,1,-2,4,2,-5,8,3,0,0,0,1,2,3,0,-13,-174,-4,-1,5,-18,0,-2,-1,-1,-1,1,2,-1
KR_6760040513,420,1,-26,-17,2,0,2,2,1,4,5,2,3,5,-2,2,0,1,0,1,0,4,4,-4,-1,5,-3,0,-1,1,-1,-1,1,2,-1
KR_6612404269,420,4,36,28,-1,0,1,1,0,3,3,1,4,5,-1,1,0,-1,2,1,-1,-8,-4,-6,-1,7,1,0,0,-1,0,0,-1,2,-1
KR_6750948601,420,-5,-47,10,-20,-7,8,1,2,0,2,-3,3,0,-13,15,2,1,0,1,0,-14,10,-2,-3,5,3,0,-1,1,0,-1,-1,3,-1
KR_6422325807,420,3,38,8,6,0,3,3,7,2,9,0,2,2,0,5,5,-1,1,0,0,4,18,-2,-1,3,1,0,2,-1,0,1,1,5,-1
KR_6757450777,420,0,38,-15,-3,0,1,1,-5,5,0,-2,3,1,2,0,2,2,1,3,1,0,-19,1,-7,6,5,0,1,1,-1,1,1,3,-1
KR_6762182072,420,-1,-53,-30,-6,0,1,1,3,0,3,-10,12,2,1,1,2,0,1,1,-1,6,-12,-2,-2,4,1,0,-1,-1,1,-1,-1,3,-1
KR_6508349879,440,-4,-118,36,-8,-2,2,0,-1,5,4,0,2,2,4,0,4,-9,10,1,0,-12,7,1,-4,3,-2,0,-1,1,1,-1,1,3,-1
KR_6755101628,440,-2,-160,-11,5,-4,5,1,5,0,5,6,1,7,0,2,2,-2,3,1,1,6,6,-4,0,4,0,0,-3,-1,0,-1,1,4,-1
KR_6726091836,420,1,16,-11,5,-5,6,1,10,1,11,4,0,4,-1,3,2,-3,3,0,0,9,9,2,-5,3,-4,0,-1,-1,-1,-1,1,6,-1
KR_6760793933,440,-2,14,-8,2,-3,4,1,1,0,1,0,1,1,4,0,4,0,0,0,1,6,3,-2,-3,5,-2,0,0,0,-1,-1,1,0,-1
KR_6654850417,420,-6,-118,-12,-9,-9,9,0,-1,3,2,2,2,4,-2,3,1,1,1,2,0,-12,-3,2,-5,3,-3,0,-1,-1,-1,-1,1,5,-1
KR_6740885584,420,-6,-8,-8,-12,-3,4,1,-4,6,2,-10,10,0,4,2,6,1,1,2,0,-12,-98,2,-3,1,-14,0,-2,-1,-1,-1,-1,6,-1
KR_6717225942,420,-5,-137,-8,-13,-3,5,2,-2,4,2,-3,5,2,-4,7,3,-1,2,1,-2,-11,-52,-4,0,4,11,-1,-5,-1,0,-1,-1,2,-1
KR_6763358318,420,-4,45,-21,-7,4,0,4,-3,3,0,-7,7,0,-1,6,5,0,0,0,-1,-9,-99,1,-5,4,1,0,-1,1,-1,-1,-1,5,-1
KR_6611739292,420,1,-39,-19,1,2,0,2,0,5,5,1,1,2,0,3,3,-2,3,1,0,1,5,-1,-1,2,0,0,0,1,-1,0,1,3,-1
KR_6726029636,420,1,16,-4,-1,-2,2,0,-4,6,2,1,2,3,-2,6,4,6,2,8,1,1,29,-1,-6,7,4,0,0,-1,0,0,1,6,-1
KR_6699592492,420,-7,-146,16,-15,-5,5,0,-4,4,0,-1,1,0,-3,4,1,-2,3,1,0,-15,4,1,-5,4,-2,0,-3,-1,0,-1,-1,2,-1
KR_6419567297,420,-1,-39,-4,0,0,3,3,1,0,1,1,0,1,-1,1,0,-1,1,0,0,-3,-13,0,-1,1,-3,0,0,-1,-1,0,1,4,-1
KR_6612155548,420,-4,10,0,-11,2,1,3,-3,3,0,-2,3,1,-6,6,0,-2,2,0,1,-12,15,-3,0,3,-3,0,0,-1,1,1,1,3,-1
KR_6735992762,440,-3,15,4,-8,-7,7,0,1,2,3,-2,2,0,-1,2,1,1,1,2,0,-12,-6,-7,-2,9,3,0,0,-1,-1,0,-1,2,-1
KR_6742035130,440,-4,-81,12,-3,-3,4,1,1,1,2,3,1,4,-5,7,2,1,1,2,-1,3,10,3,-6,3,-3,0,-1,1,1,-1,-1,1,-1
KR_6751783313,420,-5,-10,-5,-3,2,0,2,-9,11,2,-2,5,3,6,3,9,0,2,2,0,5,8,-2,-1,3,-3,0,-1,-1,-1,-1,1,5,-1
KR_6750313408,420,-2,-28,-32,-6,0,3,3,-1,6,5,0,3,3,-2,5,3,-3,3,0,0,1,-10,-3,-3,6,-1,0,-1,0,1,-1,1,0,-1
KR_6645483810,420,0,-85,11,-6,-1,4,3,-3,4,1,-3,4,1,0,2,2,1,1,2,-1,-4,-11,-1,-4,5,-4,0,0,-1,0,-1,-1,3,-1
KR_6525418739,420,-2,3,-32,0,0,2,2,-2,3,1,1,3,4,0,5,5,1,1,2,-1,-11,-2,-1,-1,2,-1,0,-1,-1,-1,-1,-1,1,-1
KR_6597741994,420,-12,-166,-140,-11,0,2,2,-4,4,0,-5,6,1,0,2,2,-2,3,1,-1,-10,-12,-3,-1,4,0,0,-5,-1,-1,-1,-1,1,-1
KR_6712144247,420,-1,-14,-4,-5,-1,2,1,-9,10,1,2,1,3,0,0,0,3,0,3,0,-6,26,4,-7,3,3,0,-1,-1,1,-1,1,3,-1
KR_6727181387,420,-5,-55,-8,-12,-5,5,0,-2,3,1,-5,7,2,-2,2,0,2,0,2,-2,-7,-13,-2,-5,7,0,0,-2,-1,-1,-1,-1,1,-1
KR_6738036417,440,-3,-69,7,-6,-1,2,1,-2,2,0,0,2,2,-2,3,1,-1,1,0,1,-2,-22,0,-3,3,-2,0,-1,-1,1,-1,1,4,-1
KR_6642276889,420,0,7,28,3,4,2,6,-2,4,2,-3,3,0,4,1,5,0,2,2,1,11,-5,1,-4,3,4,0,0,1,1,1,1,6,-1
KR_6751359474,420,0,-45,12,0,-1,3,2,4,0,4,1,3,4,-4,5,1,0,5,5,0,3,3,-4,-3,7,-1,0,0,-1,-1,1,1,2,-1
KR_6741197190,420,1,6,23,-1,-2,2,0,-3,4,1,-1,2,1,7,2,9,-2,2,0,0,1,8,1,-2,1,0,0,-1,1,-1,-1,1,2,-1
KR_6683045068,420,-3,11,-22,-7,1,0,1,-4,6,2,0,5,5,-3,3,0,-1,1,0,-1,-15,-3,-2,0,2,1,0,-1,-1,-1,-1,-1,1,-1
KR_6755531738,420,2,24,-37,0,-1,1,0,1,3,4,0,2,2,0,1,1,0,2,2,-1,-6,-9,-5,-1,6,0,0,1,-1,1,1,-1,2,-1
KR_6744673485,420,-2,-87,-18,-11,1,2,3,-2,4,2,-6,8,2,-5,6,1,1,1,2,0,-11,-5,3,-3,0,-1,0,-2,-1,1,-1,-1,2,-1
KR_6684942460,420,1,-67,-22,4,-1,2,1,3,2,5,-5,5,0,3,3,6,4,0,4,0,10,53,-3,-3,6,4,0,1,-1,-1,-1,-1,6,-1
KR_6689429259,420,-1,-3,22,-3,-3,4,1,-3,3,0,-3,4,1,7,0,7,-1,1,0,0,-5,2,2,-6,4,-2,0,0,1,-1,-1,-1,6,-1
KR_6750134454,440,2,-2,10,3,-4,7,3,4,2,6,5,1,6,-3,5,2,1,2,3,1,-1,0,2,-5,3,-2,0,0,1,-1,0,1,5,-1
KR_6757904622,420,-1,-18,11,-1,-3,6,3,-2,3,1,-1,5,4,4,3,7,1,1,2,0,10,-43,1,-5,4,1,0,-2,1,1,-1,-1,6,-1
KR_6729370673,420,1,-18,-1,8,4,0,4,-2,6,4,-1,5,4,4,0,4,3,1,4,0,8,2,1,-5,4,-4,0,-1,1,-1,-1,1,1,-1
KR_6625181245,420,0,-61,2,-2,1,0,1,-2,3,1,2,1,3,-3,3,0,0,0,0,0,-4,6,-3,-4,7,0,0,0,-1,0,0,-1,3,-1
KR_6182031644,420,-4,-46,0,-6,0,2,2,-5,6,1,4,0,4,-4,4,0,-1,1,0,0,0,10,1,-4,3,-3,0,0,1,1,1,-1,5,-1
KR_6729707092,440,-3,-86,-28,-13,-9,9,0,-1,4,3,0,3,3,-1,4,3,-2,3,1,-3,-11,228,0,-3,3,-1,0,-1,0,0,-1,-1,0,-1
KR_6616136107,420,-4,-34,-17,-7,-1,2,1,-1,1,0,3,1,4,-8,13,5,0,0,0,0,-3,-10,-1,-3,4,1,0,0,-1,1,-1,-1,3,-1
KR_5690123627,420,-2,46,-8,-1,0,1,1,5,0,5,-7,8,1,5,1,6,-4,5,1,-2,3,3,3,-6,3,-3,0,0,0,0,0,-1,0,-1
KR_6737638747,420,-1,-38,12,-3,-1,1,0,-5,6,1,0,2,2,3,4,7,0,1,1,-2,-3,2,2,-2,0,-1,0,0,1,-1,1,-1,3,-1
KR_6657456213,420,-3,5,-14,-2,0,2,2,4,3,7,-4,4,0,-1,4,3,-1,1,0,0,4,0,1,-5,4,0,0,0,0,-1,0,1,0,-1
KR_6748825643,420,-3,-38,-40,-6,-3,5,2,0,3,3,2,3,5,-3,4,1,-2,3,1,-1,-6,6,0,-2,2,1,0,0,-1,-1,0,-1,6,-1
KR_6708009167,420,-1,-6,-34,0,5,0,5,-2,5,3,3,2,5,-4,5,1,-2,2,0,0,-3,-11,-5,-2,7,-1,0,0,-1,-1,-1,-1,4,-1
KR_6711512926,420,-3,-38,12,-3,-3,4,1,3,2,5,2,3,5,0,2,2,-5,5,0,0,-3,-2,-3,-4,7,1,0,0,1,1,-1,-1,5,-1
KR_6625134787,420,-4,-48,8,-8,-4,4,0,-1,5,4,3,0,3,-2,9,7,-4,4,0,0,-11,-4,0,-5,5,1,0,0,-1,-1,1,-1,3,-1
KR_6576890943,440,-5,-52,-12,-12,-6,6,0,1,1,2,-6,7,1,0,3,3,-1,1,0,0,-5,6,-3,-5,8,0,0,1,1,-1,-1,-1,3,-1
KR_6265373010,420,1,-18,-15,1,2,2,4,0,3,3,2,5,7,-2,3,1,-1,1,0,0,3,-20,6,-9,3,3,0,0,1,0,0,-1,6,-1
KR_6758126613,420,-2,-13,-3,-1,-4,5,1,0,4,4,5,0,5,-3,3,0,1,0,1,0,-1,-9,-5,0,5,3,0,0,-1,-1,0,-1,1,-1
KR_6752300152,440,-3,-67,-22,-16,-3,3,0,-1,5,4,-8,9,1,-3,8,5,-1,4,3,-1,-4,1,-5,0,5,0,0,-1,0,1,-1,-1,0,-1
KR_6764344238,440,-3,-15,-4,-10,-1,1,0,-2,3,1,-3,4,1,-2,5,3,-2,2,0,0,-11,-3,-3,-3,6,0,0,0,1,0,-1,-1,5,-1
KR_6763288670,440,-3,-70,-4,-13,-1,4,3,-7,7,0,-5,6,1,0,1,1,0,0,0,0,-5,-39,-4,-2,6,26,0,-4,1,-1,-1,-1,6,-1
KR_6606872263,440,3,26,-8,0,3,2,5,-2,6,4,-2,2,0,-1,2,1,2,0,2,1,1,20,-5,-2,7,-1,0,-1,-1,-1,-1,1,3,-1
KR_6702454305,440,0,-6,-13,2,3,0,3,-1,2,1,0,4,4,2,2,4,-2,3,1,0,-2,5,3,-5,2,0,0,0,0,-1,-1,-1,0,-1
KR_6643462838,420,0,-23,10,3,-4,5,1,-2,3,1,-2,4,2,6,1,7,5,0,5,0,14,-1,1,-5,4,1,0,-1,-1,0,1,1,3,-1
KR_6659256236,420,0,-97,48,-7,-2,3,1,0,3,3,-1,3,2,-3,3,0,-1,3,2,-1,-3,-47,0,-2,2,16,0,-2,-1,1,-1,-1,1,-1
KR_6602416269,420,2,76,-40,4,1,3,4,4,2,6,-3,4,1,3,2,5,-1,3,2,1,4,-3,1,-3,2,1,0,1,-1,1,1,1,2,-1
KR_6699133967,420,-2,-38,5,0,-1,2,1,8,1,9,-5,5,0,0,1,1,-2,3,1,0,5,7,3,-4,1,-1,0,0,1,0,-1,1,2,-1
KR_6729590898,420,-7,-80,-39,-14,-2,2,0,-9,9,0,-2,3,1,0,3,3,-1,3,2,0,-2,3,2,-4,2,0,0,0,0,1,-1,-1,0,-1
KR_6639740531,420,-1,-54,0,-3,-7,8,1,3,2,5,1,1,2,-2,4,2,2,0,2,0,-8,-263,3,-3,0,-3,0,-2,1,1,-1,-1,3,-1
KR_6747781291,420,-2,-23,-16,-2,-1,3,2,0,2,2,-3,4,1,1,2,3,1,0,1,0,3,11,-2,-3,5,-1,0,0,-1,-1,0,1,6,-1
KR_6752379214,420,-2,-37,0,-7,1,0,1,-2,5,3,-1,1,0,-4,5,1,-1,3,2,0,-7,-1,5,-6,1,-3,0,-2,-1,1,-1,-1,6,-1
KR_6760439228,420,0,-64,7,-4,0,2,2,3,1,4,1,8,9,-6,6,0,-2,4,2,0,-5,-4,3,-10,7,2,0,0,1,-1,-1,-1,3,-1
KR_6577133540,420,-4,2,16,-13,2,1,3,-4,6,2,1,2,3,-10,12,2,-2,3,1,0,-14,12,4,-6,2,-5,0,0,-1,0,-1,1,4,-1
KR_6675360788,420,0,-45,8,-5,1,3,4,-8,8,0,6,0,6,-4,5,1,0,0,0,0,-14,-15,-7,-1,8,3,0,0,1,0,-1,-1,6,-1
KR_6702011948,420,2,59,36,1,-1,2,1,3,0,3,-3,5,2,2,0,2,0,0,0,0,-3,11,0,-1,1,1,0,-1,1,-1,1,1,4,-1
KR_6763641251,420,1,10,-1,-6,0,2,2,-2,4,2,-5,5,0,1,1,2,0,1,1,0,-7,-3,4,-7,3,-2,0,-1,1,-1,-1,-1,3,-1
KR_6739662473,420,-11,-177,-36,-15,-1,1,0,-7,7,0,-4,4,0,1,1,2,-4,4,0,0,-11,-4,-2,-3,5,1,0,-2,-1,-1,-1,-1,3,-1
KR_6567928298,440,-13,-225,-90,-42,-10,11,1,-4,5,1,-12,12,0,-9,9,0,-7,10,3,-1,-36,-13,-4,0,4,-2,0,-5,-1,-1,-1,-1,1,-1
KR_6709638754,420,0,-3,-35,0,2,0,2,1,2,3,-7,7,0,-1,5,4,5,1,6,0,6,-4,1,-3,2,-3,0,-1,-1,-1,-1,-1,5,-1
KR_6704591596,420,0,-9,-5,4,1,1,2,3,2,5,-1,3,2,4,4,8,-3,4,1,0,12,1,-2,-2,4,0,0,-1,1,-1,-1,1,5,-1
KR_6709351418,420,-7,-40,-15,-11,-3,4,1,0,2,2,-1,3,2,-5,7,2,-2,3,1,0,-16,-11,-2,-3,5,-3,0,0,-1,1,1,-1,2,-1
KR_6727712300,420,-3,-73,20,1,-3,5,2,2,1,3,-2,4,2,2,1,3,2,1,3,0,13,-333,2,-4,2,-3,0,-1,-1,-1,-1,1,6,-1
KR_6678796383,420,-1,30,-24,-3,-3,4,1,1,0,1,4,0,4,-5,7,2,0,1,1,1,-5,13,4,-7,3,-6,0,0,-1,-1,1,1,2,-1
KR_6337418232,420,1,-5,-24,1,0,4,4,4,2,6,-2,2,0,2,0,2,-3,5,2,0,3,-3,-8,0,8,4,0,-1,1,-1,-1,-1,5,-1
KR_6584782438,420,0,14,4,1,-3,3,0,0,1,1,3,1,4,-2,3,1,3,0,3,0,3,-14,2,-5,3,1,0,0,0,-1,-1,-1,0,-1
KR_6621152274,420,-1,-99,12,0,-1,4,3,9,1,10,-6,9,3,0,1,1,-2,2,0,-1,1,-13,-1,-4,5,1,0,-3,1,-1,-1,-1,3,-1
KR_6737703277,440,0,40,0,1,-3,4,1,-2,4,2,2,1,3,1,1,2,3,1,4,1,4,3,-4,-2,6,-1,0,0,-1,1,1,1,6,-1
KR_6606718201,420,3,50,16,6,1,0,1,1,0,1,4,0,4,-3,4,1,3,0,3,0,6,-12,3,-4,1,-3,0,1,1,0,1,1,3,-1
KR_6683993990,420,-2,-59,10,1,-1,3,2,6,1,7,0,3,3,-4,7,3,0,3,3,-1,1,-7,0,-4,4,2,0,-1,0,1,1,-1,0,-1
KR_6749945562,420,-7,-35,16,-29,-7,8,1,-4,6,2,-9,12,3,-4,4,0,-5,5,0,0,-11,-5,0,-1,1,-1,0,-3,-1,-1,-1,-1,3,-1
KR_6212851296,440,-3,-81,15,-12,0,1,1,-2,2,0,-7,7,0,-4,5,1,1,3,4,0,-22,1,3,-7,4,-2,0,-1,-1,-1,-1,-1,3,-1
KR_6601170196,440,1,31,-7,1,3,0,3,-3,3,0,6,0,6,-3,3,0,-2,3,1,0,-7,235,-1,-2,3,0,0,1,1,1,1,-1,5,-1
KR_6700395470,420,-3,-14,0,-1,-3,3,0,-1,2,1,3,0,3,0,1,1,0,1,1,0,-2,1,-2,-2,4,0,0,0,-1,1,0,-1,5,-1
KR_6649456978,440,-10,-113,-16,-17,-6,6,0,-7,7,0,-1,1,0,-4,4,0,1,0,1,0,-11,1,1,-2,1,-2,0,-2,0,-1,-1,-1,0,-1
KR_6742427659,420,1,1,-8,-2,-3,4,1,-1,1,0,0,1,1,2,1,3,0,1,1,-1,1,0,1,-6,5,0,0,-1,1,1,-1,-1,4,-1
KR_6754818938,420,0,23,2,3,2,2,4,-1,3,2,1,1,2,5,2,7,-4,7,3,1,1,-29,-2,-1,3,6,0,0,0,-1,1,1,0,-1
KR_6658454665,420,0,-3,-19,-4,3,1,4,-2,3,1,-1,3,2,-3,3,0,-1,2,1,1,-2,-9,3,-4,1,0,0,0,1,1,0,1,2,-1
KR_6687002533,420,-2,13,-20,-4,3,0,3,-1,3,2,-1,2,1,1,2,3,-6,7,1,0,-3,-4,1,-7,6,-3,0,0,-1,1,0,1,6,-1
KR_6729911515,420,-1,91,-9,-6,0,0,0,-3,3,0,0,2,2,-2,4,2,-1,1,0,0,-6,115,5,-6,1,2,0,1,1,-1,1,-1,1,-1
KR_6679296459,420,0,4,2,-2,-2,3,1,-5,5,0,0,4,4,-3,3,0,8,0,8,0,-3,-2,-4,-2,6,0,0,-1,-1,-1,-1,1,3,-1
KR_6617290376,440,2,65,-8,7,4,0,4,-6,8,2,1,1,2,0,3,3,8,0,8,0,6,-10,-1,-1,2,1,0,2,-1,1,1,1,4,-1
KR_6608006665,420,-4,-29,16,-17,-1,1,0,-3,4,1,-4,4,0,-6,7,1,-3,4,1,-1,-18,1,-1,-4,5,0,0,-2,-1,-1,-1,-1,4,-1
KR_6096578381,420,-5,-4,-42,-17,-4,5,1,-7,8,1,0,2,2,-3,3,0,-3,6,3,0,-23,-6,-2,-3,5,3,0,-2,-1,-1,-1,-1,5,-1
KR_6687840013,420,-1,37,5,-1,1,1,2,-2,8,6,-2,2,0,0,4,4,2,0,2,0,2,6,2,-9,7,-3,0,-1,-1,-1,-1,1,1,-1
KR_6609712194,420,-3,-25,14,5,-4,4,0,0,2,2,9,4,13,0,1,1,0,0,0,0,16,-7,0,-2,2,0,0,0,-1,1,1,1,3,-1
KR_6746452502,420,1,-54,-14,7,1,0,1,3,2,5,-1,2,1,3,0,3,1,0,1,0,12,-6,-3,-2,5,1,0,0,-1,-1,0,1,4,-1
KR_6717830046,420,-4,-18,-28,-10,-6,7,1,1,1,2,-2,3,1,-3,5,2,0,1,1,-1,-4,-11,1,-4,3,0,0,-1,1,-1,-1,-1,1,-1
KR_6729224280,420,-7,-103,-31,-11,0,1,1,2,0,2,-1,4,3,-7,7,0,-5,5,0,0,-13,1,-2,-2,4,0,0,-1,-1,-1,-1,-1,1,-1
KR_6682209080,420,1,32,0,8,-2,3,1,0,2,2,1,0,1,10,0,10,-1,1,0,1,6,5,1,-3,2,-2,0,1,1,1,1,1,4,-1
KR_6567867339,420,-8,-37,-29,-19,-2,2,0,-5,5,0,-3,3,0,-4,7,3,-5,6,1,0,-13,-5,0,-2,2,-1,0,-1,-1,-1,-1,-1,2,-1
KR_6658220594,420,-3,-40,-28,-9,1,3,4,-3,5,2,-3,3,0,1,0,1,-5,5,0,0,-5,270,-3,0,3,3,0,0,-1,-1,0,-1,1,-1
KR_6728999053,420,-1,-14,0,-5,-2,4,2,-1,1,0,-4,5,1,2,1,3,0,0,0,0,-3,-4,-1,-1,2,1,0,-1,-1,-1,-1,-1,2,-1
KR_6601109749,440,1,27,4,1,2,2,4,0,3,3,-3,4,1,3,0,3,-1,1,0,0,-2,4,0,-2,2,-2,0,0,0,-1,-1,-1,0,-1
KR_6636264626,420,1,-31,2,1,-1,2,1,3,3,6,3,1,4,-4,4,0,0,1,1,0,-4,4,-2,-1,3,2,0,-1,-1,1,-1,1,1,-1
KR_6105717009,420,-5,0,34,-18,0,0,0,-5,7,2,0,1,1,-11,14,3,-2,2,0,0,-26,-3,-1,-6,7,-2,0,0,1,1,1,1,3,-1
KR_6581439414,420,-1,38,-40,-5,2,1,3,-6,7,1,6,0,6,-5,5,0,-2,2,0,-1,-7,-1,1,-4,3,-2,0,-1,-1,-1,-1,1,1,-1
KR_6112115284,420,-6,-80,-56,-5,1,1,2,-2,3,1,-5,5,0,1,0,1,0,6,6,-1,0,157,-5,-2,7,-3,0,0,-1,-1,-1,-1,5,-1
KR_6667032479,420,-7,-157,-33,-17,-1,1,0,-7,8,1,-3,3,0,-5,6,1,-1,2,1,0,-14,12,2,-5,3,-3,0,-2,-1,-1,-1,-1,5,-1
KR_6584478238,420,-1,-43,12,-3,-3,3,0,-1,2,1,-1,2,1,1,3,4,1,2,3,0,1,-9,4,-8,4,4,0,-1,-1,-1,-1,1,3,-1
KR_6751496658,440,-3,-9,4,-4,1,1,2,0,2,2,1,4,5,-6,6,0,0,0,0,0,-9,-29,2,-5,3,-4,0,-2,-1,-1,-1,1,3,-1
KR_6754754320,440,-4,-51,-8,-11,1,2,3,-8,9,1,-3,5,2,-4,6,2,3,0,3,0,-11,173,3,-4,1,-2,0,1,-1,-1,-1,1,4,-1
KR_6711684746,420,-3,-45,-24,-10,2,1,3,1,1,2,-9,9,0,-2,2,0,-2,2,0,0,-6,-79,-4,0,4,3,0,-2,-1,-1,-1,-1,4,-1
KR_6542117588,420,-2,-110,3,0,-1,3,2,0,2,2,-2,5,3,3,2,5,0,1,1,-2,-1,0,-1,-2,3,2,0,-1,-1,1,-1,-1,2,-1
KR_6724574333,440,-3,-38,28,-15,1,0,1,-1,1,0,-2,4,2,-11,12,1,-2,2,0,0,-11,-7,-2,-1,3,2,0,-1,-1,1,-1,-1,1,-1
KR_6740782115,420,-3,-26,9,-5,0,2,2,-2,3,1,2,1,3,-5,7,2,0,0,0,0,-8,57,1,-4,3,-23,0,0,0,-1,0,1,0,-1
KR_6720555491,420,2,-34,24,7,2,1,3,5,2,7,0,2,2,1,5,6,-1,2,1,1,-4,-3,0,-3,3,-1,0,0,-1,0,0,1,5,-1
KR_6730492950,420,-8,-75,-23,-14,0,2,2,-2,2,0,-6,6,0,-1,3,2,-5,5,0,0,-11,-227,-3,-3,6,-1,0,-2,-1,-1,-1,-1,6,-1
KR_6607200246,420,0,4,16,-6,4,0,4,2,1,3,-3,4,1,-7,8,1,-2,3,1,1,-10,-13,-3,0,3,0,0,-2,-1,-1,-1,1,5,-1
KR_6683070214,420,-3,-25,17,-1,5,0,5,-1,3,2,0,2,2,-5,5,0,0,0,0,0,-4,7,-3,-2,5,-1,0,0,1,0,-1,1,6,-1
KR_6760976893,420,-1,-19,-32,-6,2,1,3,-3,4,1,8,3,11,-9,9,0,-4,4,0,0,-9,-4,0,0,0,0,0,0,1,-1,1,1,4,-1
KR_6645000208,420,-2,-98,5,-7,-5,5,0,1,2,3,-2,4,2,0,0,0,-1,1,0,0,-2,-1,-1,0,1,-1,0,-2,-1,-1,-1,-1,1,-1
KR_6745661531,420,0,-56,8,-1,-1,1,0,2,1,3,-2,3,1,1,1,2,-1,2,1,0,3,-43,-3,-2,5,16,0,0,-1,1,-1,1,4,-1
KR_6745039227,420,-1,-35,19,-2,0,1,1,-1,5,4,-2,3,1,1,2,3,0,2,2,0,-4,-6,-3,0,3,1,0,1,-1,0,1,-1,5,-1
KR_6720450727,440,-1,-25,-12,-5,-4,4,0,-2,4,2,4,1,5,-2,4,2,-1,2,1,0,-7,390,-2,0,2,-9,0,0,1,-1,0,1,4,-1
KR_6633762221,420,0,22,-28,0,5,1,6,0,3,3,-7,7,0,1,3,4,1,1,2,0,-1,-7,-1,-2,3,-2,0,0,1,-1,0,1,6,-1
KR_6660498485,420,-4,-46,-36,-6,2,0,2,-2,4,2,-4,6,2,-1,5,4,-1,1,0,0,-1,-17,3,-6,3,0,0,-1,-1,-1,-1,-1,3,-1
KR_6739761220,420,-3,-65,-12,-7,3,0,3,-3,5,2,-2,7,5,0,2,2,-5,5,0,-2,-7,-12,-3,0,3,2,0,-1,-1,-1,-1,-1,1,-1
KR_6741430858,440,2,-69,13,7,-1,1,0,4,1,5,1,0,1,2,1,3,1,1,2,0,6,1,0,-6,6,26,0,0,1,1,-1,-1,2,-1
KR_6534496290,420,1,-28,-16,4,4,0,4,-1,3,2,-1,4,3,2,1,3,0,0,0,0,5,49,-4,-1,5,0,0,-1,1,0,-1,1,4,-1
KR_6670922830,420,1,37,24,1,-2,4,2,3,0,3,1,2,3,0,4,4,-1,2,1,0,-2,253,-1,-4,5,1,1,3,-1,1,1,1,4,-1
KR_6689667209,440,-4,-1,-33,-6,-2,2,0,-1,2,1,1,0,1,-6,7,1,2,0,2,0,-5,-7,1,-5,4,1,0,-1,-1,0,-1,-1,2,-1
KR_6710767498,420,-2,-76,0,-1,-3,3,0,-2,2,0,-1,4,3,5,1,6,0,1,1,1,3,9,-2,-2,4,-2,0,-1,-1,-1,-1,1,6,-1
KR_6724025926,420,-3,-80,-21,-15,-6,6,0,-2,4,2,-4,5,1,-2,3,1,-1,1,0,0,-12,7,-4,-2,6,-4,0,-3,-1,-1,-1,-1,1,-1
KR_6757290526,440,-4,-9,-15,-11,0,2,2,-2,4,2,-6,7,1,-2,5,3,-1,2,1,0,-7,-7,-5,0,5,2,0,1,-1,0,1,-1,3,-1
KR_6635856893,420,-3,-45,-24,-4,-1,4,3,0,3,3,-1,1,0,0,2,2,-2,3,1,0,2,-1,1,-2,1,0,0,0,0,-1,-1,-1,0,-1
KR_6674273196,420,-2,16,-36,-3,1,3,4,2,3,5,-2,3,1,-3,6,3,-1,2,1,0,-3,0,-1,-3,4,-3,0,0,-1,-1,0,-1,1,-1
KR_6759310881,420,-1,-41,24,-3,-4,4,0,1,2,3,-2,3,1,1,0,1,1,0,1,0,5,32,-5,0,5,1,0,0,0,-1,0,-1,0,-1
KR_6740844007,420,0,22,-19,-2,-4,4,0,-1,2,1,0,4,4,1,0,1,2,0,2,0,7,6,-2,-1,3,-2,0,-1,-1,1,-1,-1,5,-1
KR_6508900819,420,0,41,14,0,5,0,5,1,3,4,-3,7,4,-3,5,2,0,2,2,0,4,23,4,-7,3,1,0,-1,-1,-1,-1,-1,3,-1
KR_6724913638,440,-5,-17,-16,-3,-6,6,0,1,0,1,3,2,5,-1,2,1,0,0,0,0,-2,0,-2,-2,4,0,0,-2,-1,-1,-1,-1,5,-1
KR_5872868493,420,2,-30,9,3,5,0,5,-1,2,1,3,0,3,-3,5,2,-1,3,2,0,2,4,2,-4,2,2,0,1,-1,1,1,-1,4,-1
KR_6762952338,440,-5,-22,3,-8,2,1,3,-3,3,0,1,4,5,-3,6,3,-5,6,1,0,-11,-8,-2,0,2,1,0,-1,-1,0,-1,-1,5,-1
KR_6641764258,420,-3,-11,32,-2,0,1,1,3,2,5,0,3,3,1,2,3,-6,6,0,0,2,0,5,-6,1,0,0,-1,-1,-1,-1,1,4,-1
KR_6601242647,420,-2,-63,28,-12,-3,3,0,-2,4,2,-3,4,1,-3,4,1,-1,1,0,0,-8,6,-3,0,3,-2,0,-1,-1,-1,-1,-1,5,-1
KR_6740151212,420,0,-54,20,-1,4,0,4,3,3,6,0,4,4,-6,6,0,-2,2,0,0,1,5,2,-7,5,-2,0,-1,1,-1,-1,-1,1,-1
KR_6673115291,420,-1,-12,-4,-5,4,0,4,-1,2,1,-1,4,3,-6,6,0,-1,4,3,0,-11,-6,-4,-2,6,5,0,-1,-1,-1,1,-1,2,-1
KR_6670654865,420,-2,-72,8,-7,1,0,1,0,1,1,-3,6,3,-5,6,1,0,1,1,0,-10,-10,-5,-2,7,4,0,0,-1,1,0,-1,3,-1
KR_6684045832,420,-5,-27,26,-13,-2,2,0,-7,8,1,-3,4,1,1,1,2,-2,2,0,-1,-17,-77,-2,-2,4,-2,0,0,1,-1,0,-1,4,-1
KR_6715632406,420,2,99,-16,2,4,0,4,8,2,10,0,1,1,-7,8,1,-3,3,0,0,-6,0,2,-5,3,-1,0,2,1,-1,1,1,3,-1
KR_6754587723,420,-5,-71,-11,-6,-4,6,2,-5,5,0,8,1,9,-5,7,2,0,0,0,0,-5,-5,0,-2,2,1,0,-2,0,0,-1,-1,0,-1
KR_6746537058,420,-2,-14,-16,-2,-1,2,1,-1,3,2,4,0,4,-2,3,1,-2,2,0,0,-1,7,2,-4,2,-2,0,0,-1,1,0,-1,5,-1
KR_6620162080,420,2,42,-1,2,-4,4,0,0,1,1,0,1,1,7,0,7,-1,2,1,0,5,113,-1,-1,2,-2,0,0,-1,1,0,-1,5,-1
KR_6642404625,420,-3,-23,4,-1,1,1,2,0,2,2,1,0,1,-3,6,3,0,1,1,0,-8,7,4,-5,1,-5,0,-2,-1,1,-1,-1,5,-1
KR_6762835268,420,-4,-2,-24,-4,0,3,3,-5,5,0,-1,2,1,3,3,6,-1,1,0,0,-6,-8,0,-2,2,-2,0,0,-1,0,1,-1,4,-1
KR_6757631290,440,-3,-58,-4,-4,-2,2,0,2,1,3,3,0,3,-7,7,0,0,2,2,0,-6,-7,1,-5,4,5,0,-1,-1,-1,-1,1,2,-1
KR_6736390900,440,-2,-63,-16,-4,5,1,6,-4,5,1,-2,3,1,-3,4,1,0,1,1,0,-11,0,-2,-2,4,1,0,-1,-1,0,-1,1,1,-1
KR_6741768039,420,-6,-73,0,-10,-4,4,0,-5,6,1,1,2,3,0,3,3,-2,2,0,0,-2,-22,1,-4,3,1,0,-2,-1,1,-1,1,6,-1
KR_6747084607,420,-1,47,-64,-5,-5,5,0,-4,4,0,-2,4,2,7,0,7,-1,2,1,0,4,-6,0,-3,3,0,0,0,-1,-1,1,-1,1,-1
KR_6482038527,420,-3,33,-40,-3,0,2,2,-4,6,2,-2,4,2,2,1,3,1,0,1,0,0,9,2,-7,5,-2,0,0,-1,0,0,-1,3,-1
KR_6755133927,440,-2,2,-2,1,0,0,0,0,1,1,1,0,1,1,1,2,-1,3,2,0,3,-19,4,-5,1,14,0,0,-1,-1,0,-1,5,-1
KR_6547811330,420,-2,15,-3,-3,-3,7,4,1,0,1,-3,3,0,2,0,2,0,0,0,1,-1,-14,-7,-2,9,2,0,0,-1,1,0,1,3,-1
KR_6753614835,440,-2,-46,-20,-8,0,2,2,-4,6,2,-1,6,5,-1,2,1,-2,5,3,0,-9,-1,-2,-1,3,2,0,-1,0,-1,-1,1,0,-1
KR_6348425379,420,-2,-36,-40,-5,0,2,2,-3,7,4,-3,4,1,2,0,2,-1,2,1,0,5,-41,-1,-3,4,34,0,0,-1,1,0,-1,5,-1
KR_6753128387,440,4,-22,7,10,4,2,6,1,2,3,9,0,9,-1,1,0,-3,3,0,0,0,-1,-2,-5,7,-2,0,1,1,1,-1,1,6,-1
KR_6762011019,420,-3,-122,12,-6,1,2,3,0,1,1,2,2,4,-9,9,0,0,0,0,0,-11,3,0,-4,4,-1,0,-1,-1,1,1,-1,6,-1
KR_6737639317,420,-3,-14,-32,-7,2,1,3,-4,5,1,0,3,3,-1,2,1,-4,4,0,0,0,31,-3,-1,4,-9,0,0,-1,-1,-1,-1,6,-1
KR_6583716602,420,-4,-4,-83,-3,-3,4,1,-1,1,0,-1,2,1,2,0,2,0,0,0,0,2,-3,-1,-2,3,0,0,0,-1,-1,-1,-1,2,-1
KR_6622413476,420,1,-12,-8,5,-2,6,4,1,3,4,2,2,4,4,1,5,0,0,0,1,7,-321,-3,-2,5,6,0,-1,-1,0,-1,1,2,-1
KR_6733973248,420,4,82,4,4,3,2,5,-1,1,0,-5,6,1,8,0,8,-1,1,0,0,3,63,7,-10,3,-3,0,1,1,-1,1,1,6,-1
KR_6731925089,420,-3,-52,-30,-2,3,0,3,-2,6,4,-2,2,0,1,5,6,-2,3,1,-1,2,5,0,-3,3,-5,0,-1,-1,-1,-1,-1,2,-1
KR_6698746491,420,3,64,-1,7,2,2,4,0,5,5,3,0,3,2,2,4,0,1,1,0,1,179,-2,-1,3,0,0,1,-1,-1,1,1,5,-1
KR_6650460679,420,2,5,20,6,6,2,8,1,2,3,-3,3,0,2,2,4,0,0,0,1,6,-3,-4,-1,5,1,0,0,1,0,0,1,6,-1
KR_6631366414,420,0,-24,35,1,-1,1,0,2,1,3,1,5,6,1,2,3,-2,3,1,0,-3,-4,-3,-2,5,-2,0,0,-1,0,0,-1,4,-1
KR_6599748611,420,2,-16,-20,10,0,1,1,-1,5,4,7,0,7,5,2,7,-1,2,1,-1,7,-6,1,-5,4,2,0,2,0,1,1,-1,0,-1
KR_6752699560,420,1,-12,-19,6,-1,2,1,2,1,3,-1,2,1,6,0,6,0,1,1,0,8,-51,0,-2,2,37,0,0,0,-1,0,-1,0,-1
KR_6669712479,420,-2,-33,0,-3,-1,4,3,0,1,1,1,0,1,-2,3,1,-1,1,0,0,0,-1,4,-5,1,-1,0,-1,1,-1,-1,1,6,-1
KR_6757573548,420,-4,-44,-36,-2,-2,6,4,1,2,3,1,1,2,-2,4,2,0,2,2,1,3,0,0,-4,4,1,0,0,1,0,-1,1,1,-1
KR_6510869544,420,1,72,5,4,4,0,4,1,3,4,-2,4,2,1,2,3,0,1,1,0,-2,192,0,-4,4,-3,0,0,0,1,1,1,0,-1
KR_6002482252,420,1,57,-44,0,1,3,4,-3,4,1,3,1,4,2,0,2,-3,4,1,0,2,-42,1,-7,6,19,0,-3,-1,-1,-1,-1,2,-1
KR_6740880233,420,0,24,-3,5,-1,2,1,3,2,5,5,1,6,-3,3,0,1,1,2,0,-6,30,4,-5,1,-1,0,1,1,1,1,-1,5,-1
KR_6719318499,420,3,38,22,-2,8,0,8,-1,2,1,-4,4,0,-1,1,0,-4,4,0,0,-4,-2,-2,0,2,0,0,-1,-1,-1,1,1,3,-1
KR_6746427790,440,-1,-134,2,-1,0,1,1,2,2,4,-3,4,1,3,1,4,-3,3,0,0,2,8,-2,-1,3,-21,0,-1,-1,0,-1,1,6,-1
KR_6650728114,420,-1,-17,-21,-3,-2,2,0,-2,4,2,1,4,5,0,1,1,0,1,1,0,4,-25,-1,0,1,12,0,0,-1,0,-1,-1,4,-1
KR_6650614492,420,-6,7,8,-10,-1,3,2,-1,3,2,-1,1,0,-3,5,2,-4,4,0,0,-6,-3,-3,-1,4,-4,0,0,-1,-1,-1,-1,6,-1
KR_6676942059,420,1,-10,15,2,-4,4,0,2,0,2,5,2,7,-1,4,3,0,3,3,-1,-1,-7,0,-5,5,7,0,0,1,1,-1,-1,4,-1
KR_6381605562,420,1,17,4,1,0,2,2,0,2,2,3,0,3,-1,2,1,-1,1,0,0,-4,-7,-2,-4,6,0,0,0,-1,1,0,1,1,-1
KR_6658328566,420,-1,-14,-2,0,-4,4,0,1,1,2,0,2,2,4,1,5,-1,3,2,0,1,2,0,-3,3,0,0,0,0,1,0,1,0,-1
KR_6558791765,420,1,24,26,0,2,0,2,-2,4,2,-2,3,1,2,0,2,0,0,0,0,-3,-16,0,-1,1,0,0,0,-1,1,0,-1,5,-1
KR_6602361870,420,0,47,-16,-4,1,1,2,0,2,2,-4,6,2,1,1,2,-2,2,0,0,-2,2,1,-4,3,-5,0,0,-1,-1,0,1,1,-1
KR_6764123890,440,-5,-92,-16,-12,-1,2,1,-5,7,2,3,0,3,-10,11,1,1,1,2,0,-12,22,4,-7,3,-6,0,-2,-1,-1,-1,-1,4,-1
KR_6695134468,420,-5,-75,-13,-10,0,3,3,-1,4,3,-9,9,0,3,0,3,-3,4,1,-1,2,7,1,-5,4,-2,0,-2,-1,-1,-1,-1,1,-1
KR_6679919672,420,-3,-22,-12,-6,-7,7,0,-1,2,1,5,0,5,-3,5,2,0,4,4,0,-9,-24,-3,-3,6,3,0,-1,1,-1,-1,-1,5,-1
KR_6494760227,440,-10,-154,-30,-15,-4,4,0,1,0,1,-2,4,2,-9,11,2,-1,1,0,1,-11,-2,-1,-2,3,-2,0,-4,-1,-1,-1,1,2,-1
KR_6735862057,420,0,-11,-1,2,-2,3,1,5,0,5,-6,8,2,2,1,3,3,0,3,0,4,-15,4,-5,1,-2,0,0,-1,-1,0,-1,6,-1
KR_6741881264,420,-3,-8,5,-9,1,2,3,-3,5,2,-1,3,2,-4,8,4,-2,2,0,-2,-18,294,-5,-1,6,-5,0,0,-1,0,1,-1,3,-1
KR_6751166880,440,-4,-27,-10,-4,-4,4,0,1,2,3,3,2,5,-2,3,1,-2,4,2,1,5,-471,0,-4,4,-1,0,1,-1,1,1,1,1,-1
KR_6693734022,420,-1,-12,20,-9,0,2,2,-2,3,1,-1,1,0,-8,9,1,2,1,3,0,-6,-2,-5,-3,8,-3,0,-1,-1,-1,-1,-1,2,-1
KR_6761239426,420,-1,-31,4,-1,2,1,3,-2,4,2,0,2,2,-3,3,0,2,2,4,0,1,4,1,-4,3,-2,0,-1,0,1,-1,-1,0,-1
KR_6759265539,440,2,40,-11,5,0,2,2,-3,5,2,1,0,1,7,1,8,0,2,2,0,3,-1,1,-2,1,1,0,1,-1,-1,1,-1,3,-1
KR_6428348264,420,0,2,20,0,1,0,1,6,1,7,-6,6,0,-1,1,0,0,1,1,-1,-7,6,0,-1,1,-3,0,0,1,-1,0,-1,2,-1
KR_6755340088,420,0,-26,4,0,3,3,6,-1,2,1,-1,1,0,-1,2,1,0,0,0,0,0,13,-2,-1,3,-3,0,0,0,0,0,-1,0,-1
KR_6739643388,420,-1,19,24,0,-1,2,1,0,5,5,5,3,8,-2,3,1,-2,3,1,0,-2,-5,3,-5,2,0,0,0,-1,1,1,1,2,-1
KR_6602378683,420,-2,-13,-44,-6,0,3,3,-5,8,3,2,0,2,-3,4,1,0,0,0,-1,-9,6,-4,0,4,0,0,-1,0,0,-1,-1,0,-1
KR_6682847033,440,-1,7,0,-3,-1,3,2,-2,4,2,-2,4,2,2,5,7,0,1,1,-1,-6,7,3,-7,4,-3,0,1,-1,0,1,-1,5,-1
KR_6759957744,420,3,60,12,2,2,1,3,0,1,1,-1,4,3,2,1,3,-1,2,1,0,-5,4,-2,0,2,-1,0,2,1,1,1,1,3,-1
KR_6582118368,420,-7,-68,-47,-10,-2,2,0,2,0,2,2,0,2,-11,11,0,-1,1,0,0,-5,0,3,-4,1,0,0,-1,1,-1,-1,-1,5,-1
KR_6755341041,440,4,38,26,2,-3,5,2,0,1,1,-2,3,1,2,0,2,5,2,7,2,5,-1,-1,-1,2,-1,0,1,0,1,1,1,0,-1
KR_6763340741,420,-4,-91,-20,-8,-8,8,0,5,1,6,-5,6,1,0,0,0,0,0,0,0,0,6,-2,0,2,-3,0,-1,-1,1,-1,-1,3,-1
KR_6754075536,420,0,11,9,-6,-2,2,0,1,1,2,-5,5,0,2,1,3,-2,2,0,0,-1,-59,-1,-3,4,-3,0,0,1,1,0,-1,3,-1
KR_6072733892,440,6,23,40,26,6,0,6,3,2,5,8,2,10,7,5,12,2,3,5,0,18,1,1,-2,1,0,0,1,0,1,1,1,0,-1
KR_6508541044,420,-3,-8,-3,-13,1,0,1,-4,6,2,-5,6,1,-4,4,0,-1,2,1,-2,-13,-308,0,-2,2,0,0,-2,1,1,-1,-1,2,-1
KR_6742380360,420,-5,1,-10,-11,-5,5,0,-6,7,1,-1,3,2,-1,2,1,2,1,3,0,-5,5,0,-3,3,0,0,-1,1,-1,-1,1,2,-1
KR_6736182549,420,-5,-110,-23,-10,-1,4,3,-1,1,0,-8,8,0,1,0,1,-1,1,0,-1,0,-10,2,-4,2,3,0,-2,-1,-1,-1,-1,6,-1
KR_6645579213,420,-6,-87,-20,-11,-5,5,0,-3,5,2,-1,3,2,-1,4,3,-1,2,1,0,-10,-3,3,-6,3,-1,0,-4,-1,-1,-1,-1,6,-1
KR_5915722470,420,0,29,0,-2,4,0,4,-1,1,0,1,0,1,-2,2,0,-4,4,0,0,-7,4,5,-6,1,2,0,-2,-1,0,-1,1,4,-1
KR_6697011508,420,2,88,-12,1,4,0,4,-6,7,1,4,2,6,0,1,1,-1,1,0,0,-5,-6,-2,0,2,0,0,2,1,1,1,-1,4,-1
KR_6749283259,440,0,-1,5,-2,1,2,3,3,2,5,-3,4,1,-5,8,3,2,1,3,0,-2,261,-2,0,2,0,0,1,-1,-1,1,1,5,-1
KR_6740019532,420,-5,-99,4,-11,-4,7,3,-5,6,1,-6,8,2,1,1,2,3,0,3,2,3,17,0,-4,4,2,0,-1,1,0,-1,1,1,-1
KR_6741189287,440,-4,-86,-16,-10,2,3,5,5,3,8,-9,9,0,-5,10,5,-3,4,1,1,1,-3,-1,-2,3,1,0,-2,-1,0,-1,-1,2,-1
KR_6748737899,420,-4,-55,-26,-10,-1,2,1,-1,1,0,-3,6,3,-5,5,0,0,1,1,0,-4,-9,-3,-1,4,0,0,-2,-1,1,-1,1,3,-1
KR_6715147386,440,-2,-124,21,-12,-1,1,0,-2,4,2,-5,5,0,-4,6,2,0,2,2,-1,-16,-9,-4,-1,5,0,0,-2,0,1,-1,-1,0,-1
KR_6722020900,420,-4,-47,-10,-11,-1,1,0,-9,9,0,-2,6,4,2,1,3,-1,2,1,0,-11,13,-5,-1,6,-4,0,0,-1,-1,0,-1,5,-1
KR_6754581215,420,-6,-103,-40,-10,0,4,4,-3,4,1,-4,6,2,-3,8,5,0,3,3,0,-3,6,5,-8,3,-6,0,-3,-1,-1,-1,-1,1,-1
KR_6098063235,420,-3,-50,16,-13,-5,6,1,-3,3,0,-7,7,0,0,1,1,2,1,3,-1,-7,-10,4,-6,2,-2,0,-1,0,-1,-1,-1,0,-1
KR_6718710992,420,-3,-57,-44,-3,1,0,1,-1,1,0,-3,5,2,0,0,0,0,0,0,0,0,7,5,-7,2,-7,0,-1,-1,-1,-1,-1,5,-1
KR_6568095989,420,5,89,40,4,2,1,3,-3,3,0,1,2,3,-3,5,2,7,1,8,-1,-2,-20,-4,-1,5,2,0,0,1,1,0,-1,2,-1
KR_6731391897,420,0,-27,40,-6,0,1,1,0,3,3,-4,4,0,-1,2,1,-1,1,0,0,-5,91,0,-4,4,0,0,0,0,-1,0,-1,0,-1
KR_6761990705,420,-1,11,-24,2,-1,4,3,-1,2,1,3,3,6,0,4,4,1,0,1,0,-2,-5,3,-4,1,-2,0,1,-1,-1,1,1,1,-1
KR_6750609791,440,-2,-83,5,1,-3,3,0,2,2,4,1,6,7,2,1,3,-1,3,2,0,-1,-6,0,-6,6,-3,0,-1,1,-1,-1,-1,1,-1
KR_6724802690,440,-1,-16,-20,2,3,0,3,0,3,3,0,1,1,1,1,2,-2,2,0,0,6,9,4,-7,3,-1,0,0,0,1,0,-1,0,-1
KR_6634096944,420,-5,-92,-27,-4,1,0,1,-2,4,2,0,2,2,0,4,4,-3,4,1,2,0,18,0,-3,3,-4,0,-2,1,0,-1,1,6,-1
KR_6760875866,440,1,-86,12,3,1,1,2,0,1,1,-1,4,3,1,0,1,2,0,2,0,3,-2,3,-4,1,-3,0,-2,1,0,-1,-1,1,-1
KR_6723072096,420,-2,-77,-16,-5,-2,2,0,0,2,2,3,1,4,-6,7,1,0,1,1,1,-7,6,-2,-1,3,-2,0,0,-1,-1,0,1,2,-1
KR_6609121358,420,0,-17,-24,-1,1,3,4,5,2,7,-2,4,2,-4,4,0,-1,1,0,0,-5,146,7,-8,1,-17,0,0,-1,0,0,1,6,-1
KR_6724767547,420,2,4,-32,6,3,2,5,-1,4,3,0,1,1,4,5,9,0,0,0,0,12,4,3,-4,1,-5,0,0,1,-1,1,1,5,-1
KR_6567826355,420,-6,-60,-20,-10,-1,2,1,-4,5,1,1,2,3,-7,8,1,1,0,1,0,-9,3,-5,-3,8,1,0,0,-1,-1,0,1,6,-1
KR_6613361728,420,-5,-114,1,-12,1,1,2,-1,4,3,-2,4,2,-8,9,1,-2,2,0,1,-13,-15,-2,-1,3,0,0,-3,0,0,-1,-1,0,-1
KR_6067295403,420,-3,-40,-20,0,-1,2,1,-4,4,0,1,2,3,4,0,4,0,0,0,-1,2,-14,2,-4,2,-2,0,-1,1,0,-1,-1,1,-1
KR_6759522574,440,-3,-36,-48,-8,2,1,3,-1,3,2,-5,6,1,-4,7,3,0,3,3,-1,-6,18,-2,-2,4,-2,0,-1,-1,-1,-1,-1,3,-1
KR_6738510141,420,-3,-62,0,-19,-6,6,0,-2,2,0,-6,7,1,-1,3,2,-4,6,2,0,-6,-1,0,-2,2,-3,0,-3,-1,-1,-1,-1,2,-1
KR_6634617129,420,0,39,-10,-1,-2,2,0,2,1,3,0,2,2,0,6,6,-1,2,1,0,0,-9,-7,-1,8,2,0,0,-1,0,0,1,6,-1
KR_6526459467,420,2,64,8,3,-1,2,1,2,3,5,6,2,8,-2,4,2,-2,4,2,-1,1,-35,-2,-1,3,6,0,2,1,1,1,-1,6,-1
KR_6418741761,420,-5,-27,-4,-10,-2,3,1,-2,2,0,-3,3,0,0,1,1,-3,4,1,-1,-14,-48,-2,-4,6,-2,0,0,-1,1,-1,-1,4,-1
