matchId,queueId,Diff_LV,Diff_CS,Diff_jglCS,Diff-K,Diff-K-top,K-WIN-top,K-LOSE-top,Diff-K-jug,K-WIN-jug,K-LOSE-jug,Diff-K-mid,K-WIN-mid,K-LOSE-mid,Diff-K-ad,K-WIN-ad,K-LOSE-ad,Diff-K-sup,K-WIN-sup,K-LOSE-sup,invadeKill,Diff-A,Diff_WARDplaced,Diff-ControlWARDplaced,LOSE_controlWARDPlaced,WIN_controlWARDPlaced,Diff_WARDkill,Diff_Inhibitor,Diff_TOWERkill,Diff_FirstDRAGON,Diff_FirstHERALD,Diff_Firsttower,Diff_FirstBLOOD,dragonType,result
KR_6760161102,420,-3,-20,8,-4,-4,4,0,3,1,4,-5,5,0,2,2,4,0,1,1,0,-1,1,3,-4,1,-2,0,-1,-1,1,-1,1,4,-1
KR_6751738917,420,0,-14,12,3,4,0,4,3,0,3,4,0,4,-4,5,1,-4,5,1,0,4,-1,2,-3,1,-2,0,-2,-1,1,-1,-1,3,-1
KR_6748559243,440,-1,-5,-15,-4,-2,5,3,1,1,2,0,1,1,-3,4,1,0,0,0,0,-7,215,1,-3,2,-2,0,1,-1,1,1,1,2,-1
KR_6760831642,420,0,-46,-16,-10,1,1,2,-4,4,0,-8,8,0,1,1,2,0,0,0,0,-13,44,-3,-2,5,-21,0,0,-1,0,0,-1,2,-1
KR_6752103365,420,-1,-107,-9,-7,-1,2,1,2,1,3,-2,5,3,-5,5,0,-1,1,0,0,-12,2,-4,0,4,2,0,0,-1,0,0,-1,5,-1
KR_6728288212,420,-3,-28,-42,-2,1,0,1,-6,6,0,-2,3,1,0,1,1,5,0,5,0,-1,4,-4,0,4,-2,0,0,-1,-1,-1,1,5,-1
KR_6759772918,420,-4,-29,8,-10,1,0,1,-4,4,0,-7,7,0,0,2,2,0,0,0,-1,-6,-8,-2,-2,4,3,0,0,-1,1,1,-1,4,-1
KR_6724672932,420,4,21,37,4,6,0,6,1,0,1,-1,2,1,-1,3,2,-1,1,0,0,-1,-205,-3,-1,4,-2,0,1,1,1,1,1,1,-1
KR_6654950756,420,-1,32,5,3,-1,2,1,1,1,2,0,2,2,3,1,4,0,1,1,0,7,34,0,-3,3,-5,0,0,1,-1,-1,1,2,-1
KR_6751337548,420,2,8,-12,5,3,4,7,-4,4,0,-1,3,2,5,1,6,2,3,5,0,12,-244,-1,-1,2,0,0,2,-1,1,1,1,4,-1
KR_6712705799,420,-1,38,14,1,-1,2,1,-1,4,3,-2,3,1,-1,6,5,6,1,7,1,4,-7,1,-6,5,4,0,-2,1,1,-1,-1,6,-1
KR_6731300981,420,-2,4,4,0,0,2,2,2,2,4,-3,3,0,0,0,0,1,1,2,0,-3,6,0,-2,2,-3,0,0,1,-1,0,-1,3,-1
KR_6722844118,420,-7,-206,-28,-10,-5,6,1,2,1,3,-7,7,0,-2,2,0,2,1,3,2,2,-8,-1,-1,2,-1,0,-1,0,0,-1,1,0,-1
KR_6720612916,420,1,-36,13,3,1,1,2,6,0,6,1,0,1,-1,1,0,-4,4,0,0,4,-9,3,-7,4,0,0,2,-1,1,1,1,3,-1
KR_6749369774,420,-3,-59,-25,-7,0,2,2,-10,11,1,5,3,8,-2,3,1,0,0,0,0,1,6,2,-3,1,0,0,-2,-1,-1,-1,-1,3,-1
KR_6641714858,420,0,-27,22,4,0,2,2,2,1,3,3,5,8,0,0,0,-1,4,3,0,14,11,-3,-1,4,1,0,-1,1,-1,-1,-1,1,-1
KR_6739216325,440,1,-91,0,9,-2,2,0,6,0,6,3,2,5,2,1,3,0,1,1,0,10,-3,-2,-1,3,2,0,1,1,0,1,1,6,-1
KR_6660827165,420,-4,-74,-16,-1,1,1,2,1,2,3,-3,5,2,1,0,1,-1,3,2,0,5,10,0,-3,3,1,0,0,-1,1,-1,1,1,-1
KR_6651004465,420,-1,-31,-12,1,1,0,1,0,1,1,2,0,2,-1,2,1,-1,1,0,0,-1,-48,-2,-1,3,27,0,-1,0,-1,-1,-1,0,-1
KR_6700046647,420,1,23,8,-3,-6,6,0,1,2,3,-2,4,2,4,1,5,0,1,1,0,5,-1,0,-2,2,-4,0,-2,0,-1,-1,1,0,-1
KR_6728329568,420,0,-109,28,0,-3,3,0,0,4,4,3,1,4,1,2,3,-1,2,1,0,5,-111,0,-4,4,-2,0,0,-1,1,-1,-1,2,-1
KR_6762152579,420,-4,-57,-5,-6,1,3,4,0,4,4,0,0,0,-2,4,2,-5,5,0,0,-11,-6,1,-2,1,0,0,-1,0,-1,-1,-1,0,-1
KR_6746888134,420,-4,-32,-36,-9,-2,5,3,-3,5,2,0,1,1,-3,4,1,-1,1,0,-1,-11,-7,-2,-1,3,2,0,-2,-1,-1,-1,-1,5,-1
KR_6643662380,420,-6,-95,-20,-10,-6,7,1,-1,3,2,1,4,5,-2,2,0,-2,2,0,0,-8,-2,-1,-1,2,1,0,-2,-1,1,-1,-1,2,-1
KR_6763194801,420,-4,-2,-24,-13,-6,8,2,-2,2,0,3,0,3,-1,3,2,-7,7,0,0,-5,43,-6,-2,8,-11,0,-1,-1,1,-1,-1,4,-1
KR_6755954743,420,-2,-57,-32,-5,2,2,4,1,2,3,-7,7,0,0,1,1,-1,1,0,0,-3,-22,0,-4,4,0,0,0,-1,-1,-1,1,6,-1
KR_6729345717,420,-5,-92,-21,-1,-4,5,1,3,0,3,1,4,5,0,3,3,-1,1,0,0,4,260,-2,-2,4,-2,0,-1,-1,0,-1,-1,6,-1
KR_6762249421,420,2,-48,-8,10,-3,5,2,4,1,5,4,0,4,2,0,2,3,0,3,1,15,-167,0,-3,3,14,0,0,1,-1,0,1,3,-1
KR_6661583229,420,2,72,28,-1,1,2,3,-1,6,5,-2,2,0,2,2,4,-1,2,1,0,2,-358,-1,-1,2,3,0,0,1,-1,-1,-1,6,-1
KR_6762890048,420,-4,-87,-44,-13,1,1,2,-6,6,0,0,2,2,-3,4,1,-5,5,0,0,-11,4,-1,-1,2,-2,0,-3,0,1,-1,-1,0,-1
KR_6724617005,420,-2,-78,8,-6,-6,6,0,-1,1,0,3,2,5,-3,4,1,1,2,3,0,0,44,1,-3,2,-17,0,-1,1,1,1,-1,6,-1
KR_6738393496,440,-1,-75,-10,3,-1,3,2,3,5,8,1,2,3,-2,3,1,2,0,2,0,0,101,-2,-1,3,-2,0,-1,1,1,-1,-1,2,-1
KR_6733758977,420,-2,-48,-40,2,2,0,2,-1,3,2,6,0,6,-5,7,2,0,1,1,0,4,-139,4,-5,1,-1,0,-1,1,-1,-1,-1,6,-1
KR_6755613480,420,0,-52,16,-2,4,0,4,0,2,2,2,4,6,-9,9,0,1,1,2,0,-9,-47,0,-3,3,21,0,0,0,-1,-1,-1,0,-1
KR_6740847465,420,-6,-136,-8,-24,-13,14,1,-3,5,2,0,2,2,-10,12,2,2,1,3,0,-10,-9,-3,-1,4,1,0,-4,-1,-1,-1,-1,4,-1
KR_6757726931,420,-1,68,-39,0,-1,1,0,4,5,9,0,3,3,-3,6,3,0,1,1,0,-8,-285,-1,0,1,1,0,0,-1,-1,1,-1,6,-1
KR_6762272650,420,-2,-132,-24,-4,-2,3,1,5,2,7,-1,3,2,-4,4,0,-2,3,1,0,7,-43,-4,0,4,20,0,-4,-1,-1,-1,-1,4,-1
KR_6761772401,420,-3,0,-33,-6,1,0,1,-5,9,4,2,1,3,-3,4,1,-1,1,0,-1,-4,26,-3,-1,4,-29,0,-1,-1,-1,-1,-1,2,-1
KR_6764093449,440,-3,-56,-36,-1,-6,8,2,0,0,0,3,10,13,1,4,5,1,3,4,0,0,-2,3,-3,0,-2,0,-1,-1,0,-1,1,5,-1
KR_6738240907,420,-1,8,-6,-1,2,0,2,0,0,0,1,0,1,-2,3,1,-2,6,4,0,-5,-25,0,-4,4,2,0,-1,-1,-1,1,-1,1,-1
KR_6756027102,420,-5,-107,-31,-8,-3,4,1,-3,4,1,-5,7,2,-1,2,1,4,0,4,-2,-6,114,-3,0,3,-4,0,-2,-1,0,-1,-1,2,-1
KR_6762948552,420,2,47,14,2,3,0,3,1,1,2,-1,3,2,-5,8,3,4,0,4,2,5,-4,1,-3,2,1,0,1,0,1,1,1,0,-1
KR_6748331880,420,-3,-100,-7,-6,0,2,2,1,1,2,-1,1,0,-1,6,5,-5,6,1,1,7,-3,1,-4,3,1,0,0,-1,-1,-1,1,4,-1
KR_6732035981,420,-2,-64,-54,-4,1,2,3,-4,5,1,-1,2,1,0,1,1,0,1,1,0,-6,-3,-1,-3,4,1,0,-2,1,-1,-1,-1,3,-1
KR_6749793736,420,4,77,20,7,1,1,2,2,1,3,4,2,6,3,3,6,-3,3,0,-2,-1,0,-1,-2,3,5,0,2,-1,-1,1,-1,1,-1
KR_6744444375,420,1,-20,-11,5,1,1,2,4,0,4,0,4,4,-1,2,1,1,1,2,0,5,12,-5,-1,6,0,0,-1,-1,0,-1,1,2,-1
KR_6703562622,420,-4,-124,4,-6,-4,5,1,-2,4,2,0,3,3,-1,4,3,1,1,2,0,-13,-1,-1,-2,3,-3,0,-2,1,-1,-1,1,5,-1
KR_6724238114,420,-2,-45,-24,-8,-2,4,2,1,2,3,-2,7,5,-5,5,0,0,0,0,0,-3,11,-1,-2,3,-1,-1,-1,-1,-1,-1,-1,1,-1
KR_6758787039,420,-2,-11,-1,-6,-2,2,0,-3,4,1,0,1,1,0,2,2,-1,1,0,0,-5,-3,1,-3,2,-2,0,1,1,1,1,-1,1,-1
KR_6760793488,420,0,-10,0,0,3,1,4,-2,4,2,-1,2,1,1,2,3,-1,1,0,0,1,-4,3,-5,2,-4,0,0,-1,1,0,1,2,-1
KR_6723239037,420,4,-56,-8,5,-5,5,0,4,1,5,2,0,2,1,1,2,3,0,3,1,8,6,0,-3,3,4,0,0,1,-1,-1,1,2,-1
KR_6727477833,420,-4,-2,-4,-9,-4,5,1,-4,4,0,4,1,5,-3,5,2,-2,2,0,-1,-11,-5,0,-3,3,-1,0,-1,-1,-1,-1,-1,4,-1
KR_6700911184,420,-5,-77,-26,-2,-3,3,0,-7,7,0,2,2,4,3,1,4,3,0,3,1,-1,5,-1,-2,3,0,0,1,-1,-1,1,1,6,-1
KR_6755460849,420,-3,-87,-24,-4,-4,4,0,1,2,3,0,1,1,0,1,1,-1,2,1,0,3,-2,5,-7,2,1,0,-1,-1,0,-1,1,5,-1
KR_6764063155,420,-1,-14,27,1,-6,7,1,-1,2,1,7,1,8,2,1,3,-1,1,0,0,8,4,1,-4,3,0,0,0,1,1,1,-1,4,-1
KR_6762440933,420,-2,-34,-28,-5,-2,3,1,-5,6,1,3,2,5,-1,2,1,0,0,0,0,-2,-2,1,-4,3,5,0,0,-1,0,0,1,2,-1
KR_6736846682,420,-4,-132,0,-6,-3,4,1,6,0,6,-2,2,0,-4,5,1,-3,3,0,-1,-3,-9,-1,-1,2,-2,0,-1,1,1,1,-1,6,-1
KR_6731884164,420,0,2,17,1,3,0,3,1,0,1,-3,7,4,-1,2,1,1,1,2,0,1,-2,0,-3,3,-2,0,-2,-1,-1,-1,1,2,-1
KR_6652986713,420,-2,-52,8,-2,1,0,1,5,1,6,-7,7,0,1,1,2,-2,3,1,0,1,1,4,-5,1,-2,0,0,0,0,0,1,0,-1
KR_6763496205,420,-3,-45,-32,-16,-1,4,3,-2,3,1,-1,3,2,-4,8,4,-8,8,0,0,-9,0,1,-1,0,-1,0,0,-1,1,-1,-1,3,-1
KR_6655697556,420,2,-36,-17,6,-1,1,0,3,2,5,0,1,1,2,1,3,2,0,2,0,6,-7,-6,-1,7,3,0,0,1,-1,0,-1,3,-1
KR_6764176332,420,-2,-41,12,-8,-3,3,0,0,1,1,2,3,5,-5,6,1,-2,2,0,0,-8,-3,-4,-5,9,4,0,-1,1,1,-1,-1,4,-1
KR_6690335862,440,-4,-54,4,-7,-4,6,2,0,4,4,-4,6,2,0,3,3,1,0,1,1,7,-6,-4,-1,5,1,0,0,1,-1,0,-1,6,-1
KR_6728047628,420,-2,-74,-4,-6,-1,3,2,-5,5,0,0,1,1,0,1,1,0,0,0,1,-5,-4,-1,-2,3,2,0,-1,-1,-1,-1,1,2,-1
KR_6681390614,420,-3,-40,18,-6,-3,5,2,1,1,2,-5,5,0,2,0,2,-1,1,0,0,-2,11,2,-5,3,2,0,0,-1,-1,-1,-1,5,-1
KR_6657078858,420,-3,-28,7,-5,-5,5,0,-1,1,0,4,0,4,-3,3,0,0,0,0,0,0,-1,-2,-2,4,1,0,-2,1,-1,-1,-1,4,-1
KR_6753101704,420,-4,-60,0,0,-3,3,0,1,3,4,-2,2,0,1,4,5,3,0,3,0,-1,3,5,-10,5,4,0,1,-1,1,1,-1,6,-1
KR_6744499842,420,-4,-91,22,0,-1,3,2,2,3,5,-1,6,5,-1,4,3,1,0,1,0,3,4,4,-4,0,-1,0,-1,-1,1,-1,-1,2,-1
KR_6746355359,420,2,-15,39,2,-4,7,3,-2,4,2,2,0,2,3,0,3,3,2,5,0,6,-4,-2,0,2,-2,0,-2,-1,-1,-1,-1,2,-1
KR_6731419579,420,-2,-38,12,-2,0,2,2,2,2,4,-3,5,2,0,6,6,-1,1,0,0,-3,5,1,-5,4,-5,0,-2,1,1,-1,1,5,-1
KR_6708586394,420,1,89,-20,6,3,1,4,-6,6,0,10,1,11,0,1,1,-1,1,0,0,-11,3,-1,-1,2,-1,0,1,-1,1,1,1,4,-1
KR_6744266508,420,-3,17,-28,-10,-1,2,1,-4,5,1,0,1,1,-4,6,2,-1,1,0,0,-6,24,3,-6,3,3,0,0,-1,-1,1,-1,6,-1
KR_6685200447,420,-2,-66,4,-7,-5,6,1,-1,2,1,0,2,2,0,0,0,-1,2,1,0,-4,-3,-1,-1,2,4,0,-3,1,1,-1,-1,4,-1
KR_6679947035,440,3,75,30,4,1,0,1,1,3,4,-2,3,1,5,3,8,-1,2,1,0,1,5,-1,-3,4,0,0,0,-1,1,0,-1,4,-1
KR_6607749423,420,0,-28,-8,6,1,0,1,-2,5,3,1,1,2,4,3,7,2,1,3,0,6,5,-2,0,2,0,0,-1,1,-1,-1,1,4,-1
KR_6730918159,420,0,-38,-19,8,0,4,4,9,0,9,2,1,3,-2,2,0,-1,1,0,0,12,-13,0,-2,2,2,0,0,1,1,1,-1,6,-1
KR_6731129670,420,-4,34,-51,-11,-2,4,2,-6,7,1,0,4,4,0,2,2,-3,3,0,-2,-16,8,1,-3,2,-1,0,-2,0,0,-1,-1,0,-1
KR_6745476509,420,-2,20,-13,-1,0,1,1,2,4,6,-3,3,0,4,0,4,-4,5,1,-1,-10,11,7,-9,2,1,0,1,-1,1,1,-1,6,-1
KR_6683990487,420,-1,-4,-23,1,-2,2,0,2,0,2,0,2,2,2,3,5,-1,4,3,0,0,40,0,-1,1,-3,0,-2,-1,-1,1,-1,6,-1
KR_6642878052,420,-5,-55,0,-7,-1,4,3,1,0,1,-7,7,0,0,2,2,0,0,0,0,-3,17,-7,-1,8,-2,0,-1,-1,1,-1,1,6,-1
KR_6757980580,420,1,-45,0,-4,4,1,5,-3,5,2,-1,2,1,-2,2,0,-2,3,1,0,-2,3,1,-3,2,2,0,0,0,1,-1,-1,0,-1
KR_6756734655,420,0,-9,-14,-3,-3,3,0,0,0,0,1,1,2,0,2,2,-1,1,0,0,-1,-386,1,-1,0,-2,0,0,-1,-1,-1,-1,2,-1
KR_6753100883,420,0,15,12,-4,-3,5,2,2,4,6,-1,2,1,-2,2,0,0,0,0,0,-4,-14,0,-4,4,2,0,0,1,1,0,-1,1,-1
KR_6762636096,420,1,-15,28,0,0,1,1,1,3,4,-1,4,3,-2,2,0,2,0,2,0,0,17,0,-4,4,-4,0,0,-1,1,1,1,1,-1
KR_6764232585,420,-1,-69,-12,-3,2,0,2,0,1,1,-3,3,0,-2,2,0,0,0,0,0,-4,-3,-2,-2,4,0,0,0,-1,1,0,1,4,-1
KR_6739477572,420,-3,-65,-36,-2,-1,1,0,1,3,4,2,3,5,-1,5,4,-3,3,0,0,-3,-10,0,-2,2,1,0,0,1,1,0,-1,1,-1
KR_6727243936,420,0,80,-3,-7,-5,9,4,-4,4,0,0,3,3,1,1,2,1,2,3,0,-12,72,0,-4,4,-13,0,0,-1,-1,0,-1,2,-1
KR_6651358550,420,-2,1,36,-6,-1,2,1,-5,5,0,0,1,1,1,0,1,-1,1,0,0,-9,1,0,-1,1,0,0,-1,0,1,-1,-1,0,-1
KR_6730114613,420,-8,-34,-7,-9,0,1,1,0,3,3,-3,4,1,-4,5,1,-2,2,0,0,-17,-3,-2,-2,4,-4,0,-2,-1,1,-1,-1,1,-1
KR_6727707479,420,-2,-36,-12,-3,1,0,1,-6,6,0,0,1,1,0,1,1,2,1,3,0,-2,-26,3,-6,3,-3,0,0,1,1,0,-1,1,-1
KR_6748674864,440,-6,-43,-28,-7,-1,2,1,7,0,7,-9,9,0,-2,6,4,-2,2,0,0,1,-3,-2,-1,3,1,0,-1,-1,-1,-1,1,4,-1
KR_6742212420,420,-3,-14,-20,-3,-2,3,1,1,0,1,-3,3,0,0,2,2,1,0,1,1,-1,-1,3,-4,1,-1,0,0,-1,0,0,1,6,-1
KR_6760482846,420,0,12,19,-1,-3,3,0,-3,3,0,3,2,5,0,3,3,2,0,2,0,0,-30,2,-4,2,3,0,0,1,1,0,1,4,-1
KR_6760537952,420,-5,-34,-24,-15,-4,6,2,-5,5,0,-9,10,1,4,1,5,-1,2,1,0,-6,-8,-1,0,1,-1,0,-1,-1,-1,-1,-1,3,-1
KR_6652208612,420,-5,-70,-2,-8,-1,1,0,6,0,6,-8,9,1,-1,4,3,-4,6,2,0,-10,-5,5,-9,4,-4,0,-2,-1,-1,-1,1,5,-1
KR_6713721381,420,-1,-2,-48,-7,1,0,1,3,0,3,-2,4,2,-6,6,0,-3,3,0,-1,-14,-23,-6,0,6,7,0,-1,-1,-1,-1,-1,2,-1
KR_6659666313,420,-1,-18,-20,-3,-4,5,1,2,4,6,2,2,4,-2,2,0,-1,1,0,0,-3,-6,-4,-1,5,-1,0,0,-1,-1,-1,1,5,-1
KR_6718735701,420,-1,4,0,-1,1,2,3,1,1,2,3,0,3,-3,6,3,-3,4,1,0,-1,-2,-2,-1,3,0,0,0,-1,0,0,-1,3,-1
KR_6657412905,420,-5,-44,-20,-5,-1,2,1,-1,3,2,0,3,3,-4,5,1,1,0,1,0,0,79,1,-2,1,2,0,0,0,-1,0,1,0,-1
KR_6760959631,420,0,52,20,-1,3,2,5,-4,5,1,-1,2,1,0,2,2,1,0,1,0,0,10,1,-1,0,-1,0,0,1,0,0,-1,3,-1
KR_6724260235,420,-1,-6,28,-11,-2,3,1,-1,1,0,4,2,6,-8,8,0,-4,4,0,0,-13,9,1,-3,2,0,0,-2,1,-1,-1,-1,4,-1
KR_6756839301,440,-3,-1,-9,-1,1,1,2,2,3,5,-5,6,1,1,1,2,0,1,1,0,9,-4,0,-3,3,-4,0,-1,1,-1,-1,-1,4,-1
KR_6723671445,420,-2,-24,6,-2,-1,3,2,-1,2,1,1,1,2,1,1,2,-2,3,1,0,-1,344,-6,-4,10,8,0,0,-1,-1,0,1,1,-1
KR_6752168850,420,-11,-158,-72,-8,0,1,1,-1,1,0,-1,5,4,-5,5,0,-1,2,1,-3,-16,-25,-2,0,2,2,0,-3,-1,-1,-1,-1,5,-1
KR_6752101073,420,2,-11,-20,5,-5,6,1,2,1,3,-1,2,1,4,0,4,5,0,5,-1,6,1,5,-9,4,-5,0,0,1,0,1,-1,4,-1
KR_6724484746,420,0,67,23,1,-3,3,0,-2,5,3,1,0,1,3,1,4,2,0,2,0,3,1,0,-2,2,2,0,0,0,0,0,1,0,-1
KR_6729273877,420,-7,-121,16,-13,0,1,1,0,0,0,1,2,3,-12,12,0,-2,2,0,-1,-12,-8,-1,-2,3,4,0,-1,0,1,-1,-1,0,-1
KR_6740962875,420,-1,-14,-21,-5,-5,5,0,-4,5,1,2,1,3,0,4,4,2,4,6,-2,-1,-3,6,-8,2,0,0,-1,-1,-1,-1,-1,2,-1
KR_6748900980,420,1,41,33,-1,-1,4,3,1,1,2,0,3,3,0,4,4,-1,1,0,1,-5,-41,4,-5,1,22,0,-1,-1,-1,-1,1,4,-1
KR_6747441548,420,0,22,-8,1,-8,8,0,5,3,8,4,1,5,-2,2,0,2,0,2,-1,6,-2,3,-7,4,-1,0,2,1,1,1,-1,4,-1
KR_6752806930,420,4,14,20,16,8,1,9,1,0,1,-1,2,1,7,2,9,1,1,2,0,18,266,2,-2,0,0,0,2,1,1,1,1,1,-1
KR_6744131924,420,-2,-110,-19,-3,0,3,3,0,1,1,-7,8,1,-1,3,2,5,0,5,0,10,5,2,-3,1,0,0,-5,-1,-1,-1,-1,2,-1
KR_6756212017,420,-1,-25,-12,2,4,1,5,4,4,8,1,1,2,-4,5,1,-3,3,0,0,-8,2,0,-3,3,-3,0,1,-1,1,1,1,4,-1
KR_6720760064,420,1,3,-12,-3,-4,6,2,4,0,4,2,0,2,0,0,0,-5,5,0,-1,-5,40,2,-4,2,-15,0,1,1,-1,1,-1,3,-1
KR_6756329228,420,0,31,-8,2,0,1,1,-5,5,0,-2,5,3,9,1,10,0,4,4,0,5,5,0,-1,1,-2,0,0,1,1,1,1,3,-1
KR_6763709011,420,-1,-19,14,-4,0,1,1,-4,6,2,2,1,3,-4,4,0,2,0,2,0,-5,-8,-7,-1,8,-1,0,0,-1,1,1,-1,3,-1
KR_6729483441,420,3,27,-2,3,2,4,6,0,1,1,-1,2,1,5,2,7,-3,3,0,0,1,26,0,-4,4,-4,0,0,-1,0,-1,1,1,-1
KR_6753981950,420,0,-6,12,-10,-6,7,1,7,6,13,0,1,1,-2,2,0,-9,10,1,-2,-15,-10,-2,-4,6,-4,0,-1,-1,1,-1,-1,5,-1
KR_6742170991,420,-3,24,-7,-9,-3,3,0,-3,5,2,-4,4,0,1,0,1,0,1,1,0,-3,-47,2,-4,2,33,0,0,-1,1,-1,-1,3,-1
KR_6738393984,420,-1,0,-3,-3,-1,2,1,0,0,0,1,0,1,-2,3,1,-1,1,0,0,-2,-31,-8,-1,9,-1,0,0,1,1,0,-1,1,-1
KR_6728136408,420,-1,21,-12,-1,-5,5,0,0,1,1,2,1,3,-1,1,0,3,1,4,1,2,-216,2,-2,0,0,0,-1,1,-1,-1,1,3,-1
KR_6715047137,420,-1,-49,-12,1,1,2,3,1,0,1,0,1,1,0,4,4,-1,2,1,1,9,-5,1,-2,1,0,0,0,0,-1,0,1,0,-1
KR_6739966605,420,5,83,13,6,4,1,5,5,0,5,-2,2,0,-2,2,0,1,0,1,0,2,224,-1,-1,2,1,0,1,0,1,1,1,0,-1
KR_6662246268,420,0,-58,-5,0,-3,5,2,2,2,4,0,3,3,2,6,8,-1,1,0,0,0,-9,2,-4,2,3,0,1,0,1,1,-1,0,-1
KR_6752004380,420,-2,-64,-26,3,-3,3,0,4,0,4,2,1,3,1,1,2,-1,3,2,0,10,-5,-1,0,1,-1,0,0,-1,-1,0,-1,3,-1
KR_6661071394,420,1,-27,-20,2,-2,2,0,4,1,5,0,3,3,1,1,2,-1,1,0,0,7,118,-1,-2,3,0,0,-2,-1,-1,-1,1,2,-1
KR_6760950319,420,-1,-25,0,-3,-5,8,3,-1,3,2,0,1,1,1,1,2,2,1,3,0,2,43,-2,-1,3,-21,0,-3,0,0,-1,-1,0,-1
KR_6759653456,440,-1,-14,8,-10,1,0,1,-4,4,0,0,4,4,-4,5,1,-3,4,1,0,-10,-19,-2,-4,6,-3,0,-1,-1,0,-1,-1,6,-1
KR_6750053996,440,-8,-119,-32,-23,-1,2,1,-2,3,1,-6,7,1,-13,14,1,-1,3,2,-2,-21,206,0,-1,1,-2,-1,-5,-1,-1,-1,-1,5,-1
KR_6683980062,420,0,4,-20,-1,-2,2,0,-4,5,1,1,1,2,2,3,5,2,1,3,0,0,-3,-1,-2,3,1,0,-1,1,-1,1,1,6,-1
KR_6729212817,420,-7,-113,-6,-18,-7,7,0,-3,3,0,-4,4,0,-2,2,0,-2,2,0,0,-13,15,0,0,0,0,0,-1,-1,-1,-1,-1,1,-1
KR_6742250012,440,-3,-29,-20,-7,-2,3,1,-1,1,0,-3,3,0,-2,4,2,1,0,1,0,-5,-11,-2,-1,3,2,0,1,1,0,1,-1,6,-1
KR_6762641908,420,-4,-17,-19,-8,-6,7,1,1,1,2,2,1,3,-3,3,0,-2,2,0,0,-6,8,0,0,0,1,0,0,-1,-1,1,-1,5,-1
KR_6657702044,420,-2,-75,-40,-3,0,0,0,-5,5,0,2,3,5,-1,2,1,1,0,1,-2,-2,2,1,-3,2,-2,0,1,-1,0,-1,-1,4,-1
KR_6757297736,420,0,-63,-20,0,-1,1,0,1,1,2,0,2,2,0,3,3,0,2,2,0,-1,-15,-7,0,7,-1,0,0,0,1,0,-1,0,-1
KR_6760593868,440,1,43,-27,7,2,0,2,3,3,6,1,3,4,1,3,4,0,1,1,0,1,-69,-4,-2,6,33,0,1,-1,1,1,1,1,-1
KR_6654396939,420,-3,-107,-28,-3,1,2,3,1,0,1,0,2,2,-1,1,0,-4,4,0,0,-8,-18,-3,0,3,-1,0,-1,-1,-1,-1,1,6,-1
KR_6764429023,420,-4,-92,-24,-6,1,2,3,1,2,3,-8,9,1,-1,3,2,1,0,1,0,2,54,-6,-1,7,-1,0,-2,-1,-1,-1,-1,5,-1
KR_6721934728,420,-2,-44,19,-1,-1,4,3,-3,4,1,2,0,2,1,0,1,0,0,0,0,0,-6,2,-5,3,2,0,-1,1,-1,-1,-1,2,-1
KR_6761673682,420,-4,-88,9,-9,-1,3,2,2,1,3,0,1,1,-7,8,1,-3,3,0,0,-2,-7,-1,-3,4,-1,0,0,-1,-1,-1,-1,1,-1
KR_6760706332,420,-5,-39,5,0,4,2,6,-2,2,0,0,1,1,-4,6,2,2,3,5,0,-1,-1,0,-5,5,3,0,0,1,-1,-1,1,3,-1
KR_6688908913,420,1,-26,36,-1,-5,5,0,-1,1,0,4,0,4,3,1,4,-2,3,1,0,-2,47,-2,-1,3,-7,0,-1,0,0,-1,1,0,-1
KR_6728795351,420,-6,-72,-47,-12,-3,3,0,-1,3,2,-6,6,0,-4,7,3,2,0,2,0,-3,-22,2,-2,0,2,0,-1,0,1,-1,-1,0,-1
KR_6743700891,420,-2,5,12,-1,-2,5,3,-2,4,2,2,3,5,2,3,5,-1,1,0,0,-6,-5,-1,-2,3,-1,0,-2,-1,-1,-1,1,5,-1
KR_6756537535,420,-7,-5,-84,-16,-3,5,2,-10,10,0,1,1,2,-3,4,1,-1,1,0,0,-10,3,3,-4,1,-2,0,-1,0,0,-1,-1,0,-1
KR_6760099802,420,0,-16,42,-1,3,0,3,0,3,3,-4,4,0,0,1,1,0,1,1,0,-6,140,-2,-2,4,-3,0,0,-1,1,0,-1,1,-1
KR_6692023361,420,0,-34,12,-3,-3,3,0,0,1,1,-3,3,0,2,2,4,1,0,1,0,1,24,0,-5,5,-4,0,0,1,1,0,1,1,-1
KR_6752928121,420,-1,-30,16,-1,-2,3,1,0,1,1,4,0,4,-3,5,2,0,0,0,0,-3,-40,-2,-2,4,16,0,-1,1,0,-1,-1,4,-1
KR_6749422346,440,-4,-77,-12,-18,-3,3,0,-3,3,0,-5,7,2,-6,6,0,-1,1,0,-1,-16,-434,-1,0,1,2,0,-1,-1,0,-1,-1,3,-1
KR_6624612456,420,-1,-22,8,-2,-2,4,2,1,4,5,1,2,3,-1,2,1,-1,1,0,-1,-2,3,-4,-2,6,2,0,-1,1,-1,-1,-1,1,-1
KR_6736822093,420,0,19,8,-1,-1,2,1,1,2,3,1,2,3,-2,2,0,0,1,1,0,-4,-6,0,-3,3,-3,0,0,1,1,0,-1,1,-1
KR_6727452074,420,3,34,12,3,-2,2,0,0,1,1,2,0,2,1,2,3,2,0,2,0,6,-1,-1,-4,5,2,0,1,1,1,1,-1,4,-1
KR_6763396131,440,-5,-111,-24,-7,0,0,0,0,1,1,3,1,4,0,3,3,-10,11,1,0,-4,139,1,-3,2,-3,0,-1,-1,-1,-1,-1,5,-1
KR_6671373176,420,-1,-46,3,-4,-3,5,2,0,3,3,0,4,4,-2,4,2,1,1,2,0,3,4,1,-5,4,-1,0,0,-1,0,-1,-1,5,-1
KR_6738570627,420,-2,-93,8,-10,-6,7,1,-2,4,2,0,6,6,0,4,4,-2,2,0,1,-3,-13,-1,-2,3,-1,0,-1,1,-1,-1,1,3,-1
KR_6751399148,420,0,-23,21,-3,-4,5,1,-1,3,2,-1,4,3,1,2,3,2,0,2,-1,1,5,-1,-2,3,1,0,-2,1,-1,-1,-1,6,-1
KR_6763176047,420,0,-38,20,-1,0,1,1,-1,2,1,1,0,1,0,0,0,-1,1,0,0,-1,-9,-1,-1,2,2,0,-1,0,1,-1,-1,0,-1
KR_6733864085,420,-2,-106,34,-8,-1,2,1,2,0,2,-8,8,0,0,0,0,-1,1,0,0,-2,5,1,-3,2,3,0,0,-1,0,0,-1,5,-1
KR_6741514724,420,-6,-144,-20,-9,-4,6,2,1,1,2,-1,4,3,-3,4,1,-2,2,0,0,1,3,4,-4,0,0,0,-1,-1,-1,-1,-1,3,-1
KR_6748910310,440,-2,-59,-6,-9,-4,4,0,-3,3,0,2,0,2,-3,3,0,-1,1,0,0,-9,-8,-3,-2,5,1,0,0,1,-1,0,-1,1,-1
KR_6705586703,420,-2,-69,30,-7,4,2,6,0,0,0,-5,6,1,-3,5,2,-3,3,0,1,-5,10,2,-5,3,1,0,-1,1,-1,-1,1,3,-1
KR_6727053971,420,0,-20,-12,-4,-2,2,0,-1,2,1,-4,4,0,1,1,2,2,0,2,0,1,40,-4,0,4,-18,0,-1,-1,-1,-1,1,5,-1
KR_6751635787,420,-4,31,-21,-9,1,0,1,-2,3,1,1,1,2,-7,7,0,-2,2,0,0,-9,4,1,-2,1,-3,0,1,0,-1,1,-1,0,-1
KR_6704799190,440,2,-29,-16,7,3,0,3,0,2,2,3,0,3,1,4,5,0,0,0,0,3,2,-3,-5,8,0,0,0,-1,-1,-1,1,3,-1
KR_6720804816,420,-1,14,21,-13,-1,1,0,-2,2,0,-9,9,0,-1,3,2,0,2,2,0,-15,-2,-1,-2,3,2,0,-1,-1,-1,1,-1,4,-1
KR_6695094544,420,-5,20,-16,-10,-1,3,2,3,5,8,-4,4,0,-8,10,2,0,2,2,0,-2,-43,3,-3,0,20,0,0,0,-1,0,1,0,-1
KR_6740756687,420,-1,-8,-10,1,1,1,2,3,6,9,-2,4,2,1,3,4,-2,4,2,0,11,-12,-3,-3,6,6,0,0,1,-1,0,1,5,-1
KR_6714797567,420,1,-3,12,-3,0,1,1,3,1,4,-6,6,0,0,1,1,0,2,2,-1,-4,-11,-5,-2,7,0,0,0,1,-1,0,-1,5,-1
KR_6655226112,420,-3,-39,12,-11,0,2,2,-2,5,3,-3,3,0,-4,6,2,-2,5,3,-1,-10,1,0,-4,4,-4,0,-1,-1,1,-1,-1,5,-1
KR_6699857713,420,-3,-7,8,-13,-1,1,0,-5,6,1,-4,5,1,0,1,1,-3,4,1,0,-13,-11,7,-8,1,1,0,1,0,1,1,-1,0,-1
KR_6754985364,420,4,-28,24,10,-5,6,1,3,0,3,3,2,5,9,3,12,0,0,0,0,16,4,2,-2,0,0,0,2,1,1,-1,-1,3,-1
KR_6681410533,420,-1,-35,21,-11,-3,4,1,0,1,1,-2,2,0,1,2,3,-7,7,0,-1,-10,4,3,-3,0,-1,0,0,1,0,-1,-1,4,-1
KR_6743667474,440,-1,7,0,-3,0,0,0,1,3,4,-1,1,0,-3,3,0,0,1,1,0,1,-3,-3,-1,4,3,0,0,-1,1,0,-1,6,-1
KR_6704299836,420,0,-103,84,-8,-5,7,2,-1,3,2,2,1,3,-3,3,0,-1,2,1,-1,-10,-5,-1,0,1,0,0,-2,-1,-1,-1,-1,5,-1
KR_6684222614,420,-3,-11,-12,-11,4,0,4,3,1,4,-6,7,1,-11,12,1,-1,2,1,0,-9,-7,4,-6,2,-4,0,-1,-1,0,-1,-1,2,-1
KR_6684078492,420,1,-43,-12,2,0,1,1,-6,6,0,-1,2,1,5,0,5,4,0,4,0,4,5,7,-8,1,-6,0,0,0,1,0,1,0,-1
KR_6740068501,420,-8,-94,-44,-10,-3,3,0,1,2,3,-2,4,2,-2,2,0,-4,4,0,-1,-8,288,2,-2,0,0,0,-1,-1,-1,-1,1,1,-1
KR_6703491769,420,-2,-8,2,-8,0,0,0,-3,4,1,-2,4,2,-3,5,2,0,1,1,0,-8,-17,1,-8,7,-4,0,-1,-1,-1,-1,-1,3,-1
KR_6759117482,440,-3,22,40,-5,-4,7,3,2,0,2,-1,5,4,2,1,3,-4,5,1,0,-11,10,-3,0,3,-1,0,0,-1,-1,-1,-1,5,-1
KR_6736709783,420,-2,-36,4,-7,2,0,2,-7,8,1,-5,5,0,2,1,3,1,1,2,1,-6,4,0,-3,3,-8,0,1,-1,1,1,1,4,-1
KR_6738278782,420,1,42,-9,-5,1,1,2,-5,8,3,-2,2,0,3,1,4,-2,2,0,0,-2,11,-2,-3,5,-3,0,1,-1,0,1,-1,2,-1
KR_6763193447,420,-3,-17,-4,-7,-4,6,2,-1,1,0,-6,8,2,4,1,5,0,1,1,0,5,2,-2,0,2,-1,0,-1,-1,1,-1,1,2,-1
KR_6763810579,420,-2,-3,-8,-1,-1,2,1,0,3,3,0,1,1,-1,4,3,1,0,1,1,-2,-1,-1,-5,6,2,0,0,-1,1,1,1,5,-1
KR_6753299505,440,3,4,33,8,0,4,4,4,1,5,0,2,2,1,0,1,3,0,3,2,5,45,0,-1,1,-32,0,1,1,1,1,1,3,-1
KR_6761676603,420,-2,-64,17,-6,-2,3,1,1,2,3,0,3,3,0,5,5,-5,6,1,0,-4,-7,-3,-1,4,1,0,0,-1,1,0,-1,3,-1
KR_6711554478,420,-3,-17,-8,-8,0,2,2,-5,6,1,-2,4,2,-2,3,1,1,2,3,0,-12,-94,-6,0,6,-1,0,0,-1,-1,-1,1,5,-1
KR_6760128822,420,-4,-78,-33,-7,0,3,3,-6,7,1,-1,3,2,-1,2,1,1,2,3,-2,-2,1,0,-3,3,1,0,0,-1,-1,0,-1,5,-1
KR_6760893501,420,-6,-89,-30,-15,1,3,4,4,3,7,-13,13,0,-7,7,0,0,3,3,-4,-19,190,-3,-1,4,0,0,-2,0,-1,-1,-1,0,-1
KR_6691448518,420,-4,-149,3,-5,-5,5,0,-2,4,2,1,5,6,1,1,2,0,0,0,0,2,-11,-2,-1,3,1,0,-1,1,1,-1,1,3,-1
KR_6745048864,420,-6,-48,-40,-12,-1,1,0,0,1,1,-7,7,0,-1,2,1,-3,3,0,0,-8,11,3,-4,1,0,0,-3,1,-1,-1,1,4,-1
KR_6763083119,440,-2,-70,7,-6,-5,5,0,1,0,1,-8,8,0,2,1,3,4,1,5,0,5,-372,-5,-1,6,-3,0,0,1,-1,0,-1,1,-1
KR_6651148739,420,-1,-76,-1,-5,0,0,0,0,3,3,-2,2,0,-3,4,1,0,0,0,0,-4,0,1,-4,3,-3,0,-1,1,-1,-1,-1,1,-1
KR_6744666317,420,-5,-51,27,-14,0,1,1,-2,2,0,-6,6,0,-2,3,1,-4,4,0,0,-21,16,-2,-3,5,-2,0,1,-1,1,1,-1,5,-1
KR_6749727195,420,1,36,8,-1,-1,1,0,-2,3,1,3,1,4,1,0,1,-2,4,2,0,-4,33,3,-3,0,-39,0,1,1,1,1,-1,2,-1
KR_6729994260,440,-2,-149,-22,-5,-1,1,0,2,0,2,-1,1,0,-6,6,0,1,5,6,-1,-7,-2,-3,-1,4,-1,0,1,-1,0,1,-1,3,-1
KR_6725921549,420,-4,-29,-7,-9,0,0,0,-4,4,0,-3,4,1,1,2,3,-3,4,1,0,-15,-9,0,-2,2,0,0,-2,-1,-1,-1,-1,4,-1
KR_6738161387,420,-2,25,4,-7,1,0,1,-3,3,0,1,1,2,-2,2,0,-4,4,0,0,-9,-104,-6,0,6,1,0,-1,-1,-1,-1,-1,5,-1
KR_6713221729,420,1,66,31,-2,3,1,4,0,3,3,0,2,2,-2,2,0,-3,3,0,-1,-15,-7,1,-2,1,-2,0,2,0,1,1,-1,0,-1
KR_6729658869,420,2,-15,-21,1,-1,3,2,-1,2,1,2,1,3,0,2,2,1,1,2,0,7,8,-1,0,1,1,0,0,1,-1,1,1,5,-1
KR_6659830734,420,0,-58,40,-1,-3,5,2,4,0,4,-1,5,4,-5,5,0,4,1,5,0,1,2,1,-2,1,-1,0,-1,0,1,1,-1,0,-1
KR_6697347533,420,0,-47,12,2,-2,2,0,1,1,2,1,1,2,3,2,5,-1,1,0,0,4,-6,-2,-1,3,-1,0,-1,1,0,-1,-1,4,-1
KR_6729295015,420,-2,8,4,2,1,2,3,-1,2,1,1,1,2,1,2,3,0,0,0,-1,-4,-9,-7,-2,9,1,0,-1,-1,0,-1,-1,1,-1
KR_6746382134,420,2,-45,-19,2,0,1,1,-3,5,2,2,0,2,2,1,3,1,0,1,0,0,10,-1,-4,5,3,0,0,-1,1,0,-1,2,-1
KR_6740059463,440,0,-6,-2,1,2,2,4,-4,9,5,-1,3,2,3,2,5,1,2,3,0,-7,3,4,-4,0,2,0,0,-1,0,0,1,3,-1
KR_6736269306,420,-9,-89,-36,-7,-3,4,1,0,3,3,-1,1,0,-4,5,1,1,2,3,0,-6,18,-1,-2,3,-29,0,-1,-1,1,-1,1,5,-1
KR_6745746142,420,-7,-29,-24,-13,0,0,0,0,1,1,-8,9,1,-6,7,1,1,0,1,0,-12,-2,0,-2,2,-2,0,0,-1,1,0,-1,3,-1
KR_6756198577,420,3,2,-12,2,2,1,3,-3,3,0,2,0,2,0,1,1,1,1,2,0,1,55,1,-3,2,-22,0,0,-1,0,1,-1,6,-1
KR_6738966461,420,0,-32,0,0,-3,3,0,-2,5,3,1,1,2,3,4,7,1,1,2,1,0,-16,-2,0,2,4,0,0,-1,1,1,1,5,-1
KR_6722736095,420,-2,-62,-36,2,0,2,2,-3,4,1,-2,3,1,4,2,6,3,0,3,0,9,-296,1,-4,3,2,0,1,0,1,1,1,0,-1
KR_6736781573,420,-2,4,13,-4,-5,5,0,-1,3,2,4,2,6,-2,3,1,0,0,0,-2,-4,-6,-2,-2,4,0,0,1,-1,-1,1,-1,5,-1
KR_6723188136,420,-1,-34,9,-6,0,3,3,-1,1,0,0,2,2,-5,9,4,0,2,2,-1,-6,-219,1,-2,1,2,0,-1,-1,-1,-1,-1,4,-1
KR_6759580030,420,-2,-58,11,-3,-3,4,1,0,3,3,-1,4,3,-1,3,2,2,0,2,2,3,-13,1,-6,5,5,0,0,-1,-1,-1,1,3,-1
KR_6751106907,420,1,10,9,-4,3,1,4,3,2,5,-2,6,4,-6,7,1,-2,2,0,0,-1,-11,1,-5,4,1,0,-1,-1,1,-1,1,6,-1
KR_6674457526,420,2,40,18,6,1,0,1,1,2,3,-1,2,1,3,0,3,2,0,2,1,6,6,5,-8,3,-5,0,1,-1,1,1,1,6,-1
KR_6658290598,420,-4,35,0,-4,0,0,0,-5,8,3,2,1,3,-1,4,3,0,0,0,1,-7,10,-1,-3,4,-1,0,0,-1,1,1,1,1,-1
KR_6751537114,420,0,-46,11,-1,-3,3,0,0,2,2,1,3,4,1,0,1,0,0,0,0,2,109,-2,-2,4,-2,0,-1,-1,-1,-1,-1,4,-1
KR_6715381932,420,-2,2,0,-7,2,2,4,0,3,3,-1,1,0,-7,10,3,-1,2,1,0,-2,10,0,-1,1,-1,0,-1,-1,1,-1,-1,6,-1
KR_6724149755,420,-4,-52,-1,-10,0,0,0,-6,6,0,3,1,4,-2,3,1,-5,5,0,-1,-15,-9,-6,-1,7,-1,0,-1,-1,-1,-1,-1,4,-1
KR_6763549364,420,0,-35,-4,1,1,1,2,-3,4,1,0,2,2,1,2,3,2,3,5,0,8,10,4,-5,1,-1,0,0,-1,0,0,1,5,-1
KR_6663153406,420,1,63,-4,0,-1,1,0,-1,3,2,-1,2,1,4,1,5,-1,2,1,0,-2,-14,2,-6,4,-1,0,1,-1,1,1,-1,5,-1
KR_6723756856,420,-1,34,-4,-2,-5,6,1,1,3,4,1,1,2,0,2,2,1,1,2,0,2,38,-1,-1,2,-27,0,-1,-1,1,-1,1,6,-1
KR_6759646537,420,-4,-59,4,-14,2,0,2,-6,8,2,-6,8,2,-3,4,1,-1,3,2,-3,-18,257,-1,0,1,1,0,-1,-1,1,-1,-1,2,-1
KR_6651324886,420,-4,-46,-24,-10,-5,6,1,0,1,1,-4,4,0,1,2,3,-2,2,0,-1,-16,26,-4,-1,5,-5,0,-2,-1,-1,-1,-1,3,-1
KR_6762467778,420,3,29,0,11,1,2,3,1,2,3,7,0,7,2,2,4,0,2,2,1,9,-59,-1,-1,2,30,0,1,-1,0,1,1,2,-1
KR_6759061728,420,4,38,-9,1,-1,2,1,-3,3,0,-1,4,3,0,1,1,6,2,8,0,0,-26,-2,-1,3,4,0,0,-1,-1,1,1,3,-1
KR_6731477704,420,3,-22,31,4,0,3,3,6,0,6,0,0,0,-3,4,1,1,0,1,0,1,-2,-1,-1,2,1,0,0,-1,1,1,1,2,-1
KR_6729087459,420,1,30,13,1,0,1,1,3,0,3,2,2,4,0,2,2,-4,4,0,0,0,1,-1,0,1,1,0,0,1,1,0,-1,3,-1
KR_6755414017,420,-3,-4,-13,-5,3,1,4,-2,2,0,-2,4,2,-3,4,1,-1,1,0,-1,-10,0,1,-3,2,-3,0,-1,-1,-1,-1,-1,5,-1
KR_6736642555,420,-2,-103,-45,1,1,1,2,-1,1,0,2,0,2,-1,2,1,0,0,0,0,-1,-411,6,-6,0,-1,0,-1,-1,-1,-1,-1,1,-1
KR_6719566599,420,-4,-26,0,-11,-2,2,0,-3,5,2,-1,1,0,-2,4,2,-3,3,0,0,-17,12,-3,-2,5,-3,0,-1,-1,-1,-1,-1,5,-1
KR_6736670240,420,-1,-30,-24,3,2,0,2,-1,2,1,-2,8,6,3,1,4,1,0,1,0,-1,5,3,-6,3,0,0,-1,1,1,-1,1,6,-1
KR_6763908200,420,-2,12,15,-9,1,1,2,2,4,6,-1,3,2,-11,12,1,0,1,1,0,-9,-1,1,-4,3,-2,0,-1,1,1,-1,-1,1,-1
KR_6755482272,420,0,-58,6,-7,2,2,4,-2,6,4,0,3,3,-7,7,0,0,0,0,0,-8,-2,-4,-2,6,-1,0,-1,1,1,-1,1,5,-1
KR_6757574696,420,-5,-49,-7,-8,2,2,4,-7,8,1,-5,5,0,2,0,2,0,1,1,0,2,-30,-1,-3,4,10,0,0,1,-1,0,-1,4,-1
KR_6708614498,420,0,25,-8,2,-2,4,2,3,3,6,-1,3,2,3,1,4,-1,3,2,0,-3,295,5,-8,3,0,0,1,1,1,1,-1,1,-1
KR_6733720311,420,1,4,24,9,2,1,3,3,4,7,2,2,4,1,2,3,1,1,2,0,4,8,1,-5,4,0,0,1,1,-1,1,1,2,-1
KR_6727983336,420,-6,-35,-35,-14,-4,5,1,-3,4,1,-1,7,6,-2,2,0,-4,4,0,-1,-15,2,-2,-1,3,0,0,-1,0,-1,-1,-1,0,-1
KR_6704846154,420,-6,-18,0,-11,-1,1,0,5,1,6,-2,2,0,-5,5,0,-8,8,0,0,-17,-1,5,-5,0,-5,0,1,-1,1,1,-1,6,-1
KR_6721837017,420,0,-51,36,0,-3,4,1,1,0,1,3,2,5,0,3,3,-1,1,0,0,0,10,0,-1,1,2,0,1,1,0,1,1,2,-1
KR_6730649818,420,-4,-5,-16,-4,-2,4,2,-1,1,0,-4,4,0,2,0,2,1,0,1,0,0,-6,3,-7,4,-3,0,0,-1,1,1,1,4,-1
KR_6742093836,420,-4,-73,-8,-8,0,0,0,-5,7,2,-5,5,0,2,1,3,0,0,0,0,-6,257,-2,-2,4,1,0,0,1,1,-1,1,6,-1
KR_6715745956,420,-5,-53,8,-11,-2,2,0,2,1,3,-1,4,3,-7,7,0,-3,3,0,0,-4,2,3,-3,0,-3,0,-2,-1,-1,-1,-1,1,-1
KR_6703432653,420,-2,-87,-16,-10,-4,5,1,-11,12,1,3,1,4,1,2,3,1,0,1,-1,3,-16,-2,-2,4,4,0,-1,-1,1,-1,-1,5,-1
KR_6722985835,420,-2,-45,13,-8,2,0,2,-4,4,0,-1,1,0,-5,5,0,0,1,1,0,-11,-50,0,-3,3,14,0,0,1,-1,0,-1,4,-1
KR_6738150799,440,0,-38,12,-5,0,2,2,-1,2,1,-2,3,1,-3,5,2,1,0,1,0,-5,-9,3,-4,1,-2,0,0,-1,-1,0,-1,3,-1
KR_6749375549,440,-2,-16,-28,0,-4,6,2,0,1,1,2,1,3,-1,2,1,3,0,3,0,2,3,0,0,0,0,0,-1,-1,-1,-1,1,2,-1
KR_6726951702,420,-6,-79,-24,-14,-4,5,1,-6,8,2,-6,6,0,3,2,5,-1,5,4,0,-1,-6,3,-4,1,-1,0,-2,-1,1,-1,1,4,-1
KR_6716665463,420,-2,-8,-4,-3,-9,10,1,1,0,1,1,2,3,1,7,8,3,0,3,0,8,-7,-4,0,4,2,0,-1,-1,-1,-1,1,3,-1
KR_6721795209,420,4,-29,9,4,5,0,5,-2,2,0,-1,1,0,0,2,2,2,0,2,0,2,13,-3,-2,5,-3,0,0,0,1,1,-1,0,-1
KR_6760834541,420,-4,-73,-16,-3,-3,3,0,4,2,6,0,0,0,-5,5,0,1,0,1,-1,3,-9,-3,-3,6,-1,0,-1,1,1,-1,-1,1,-1
KR_6739492900,420,-2,22,-52,-8,4,1,5,2,3,5,-5,7,2,-8,8,0,-1,2,1,1,-2,-5,-4,-3,7,-4,0,-1,-1,1,1,1,2,-1
KR_6726257415,420,0,-44,-1,3,1,1,2,2,0,2,-6,6,0,3,3,6,3,0,3,0,1,-7,-3,-2,5,4,0,0,0,0,0,1,0,-1
KR_6706076185,420,-6,-80,10,-7,-4,5,1,6,1,7,-6,7,1,-4,4,0,1,0,1,0,-1,-8,-4,-1,5,-1,0,-1,1,1,-1,-1,3,-1
KR_6756210691,420,-3,-12,0,-3,-3,5,2,2,3,5,-7,7,0,2,2,4,3,0,3,0,-6,3,0,-2,2,-5,0,-2,1,-1,-1,1,3,-1
KR_6764235073,420,-6,-20,-19,-14,-1,2,1,-2,2,0,-1,1,0,-7,8,1,-3,3,0,0,-18,-3,-1,-2,3,-1,0,-1,-1,1,-1,-1,6,-1
KR_6731411892,420,2,20,-1,1,3,1,4,3,0,3,0,1,1,-6,7,1,1,1,2,0,0,-1,1,-2,1,0,0,1,-1,1,1,-1,6,-1
KR_6759760292,420,0,-82,12,-1,0,2,2,1,1,2,-5,8,3,2,2,4,1,0,1,0,-2,3,2,-4,2,-2,0,-1,1,1,-1,-1,1,-1
KR_6745198590,420,-4,-47,-12,-5,0,2,2,-4,7,3,-2,3,1,4,1,5,-3,4,1,0,-1,-7,-4,-1,5,2,0,-1,-1,-1,-1,1,4,-1
KR_6762668110,420,-4,-63,11,-10,-2,6,4,1,2,3,0,5,5,-8,8,0,-1,1,0,-1,-9,13,2,-4,2,-2,0,0,-1,-1,-1,-1,3,-1
KR_6671514879,420,-1,-36,-24,-6,4,1,5,-2,5,3,-4,7,3,-2,2,0,-2,3,1,0,-8,-7,-2,-2,4,-3,0,0,-1,-1,-1,1,3,-1
KR_6732462053,420,-3,-32,-28,5,-2,4,2,1,0,1,4,4,8,2,1,3,0,0,0,-1,5,0,1,-4,3,-2,0,0,1,0,0,-1,1,-1
KR_6749958172,420,2,-11,2,-3,-2,4,2,-2,3,1,-7,11,4,3,0,3,5,0,5,0,4,-3,-1,-1,2,-1,0,-2,0,0,-1,1,0,-1
KR_6748600784,420,-3,-5,-32,-4,2,1,3,-1,5,4,-7,7,0,-2,4,2,4,2,6,0,1,5,-1,-1,2,-2,0,-1,-1,-1,-1,1,3,-1
KR_6731428884,420,-1,-57,-11,-3,1,0,1,-7,7,0,3,1,4,0,1,1,0,0,0,0,-2,-3,1,-4,3,3,0,1,-1,1,1,-1,2,-1
KR_6748873242,420,-1,-46,1,-3,4,1,5,-1,3,2,0,1,1,-3,4,1,-3,3,0,0,-7,26,4,-6,2,-3,0,-1,-1,1,-1,-1,1,-1
KR_6684735261,420,0,30,-24,7,-4,5,1,0,1,1,4,0,4,7,3,10,0,1,1,0,8,14,6,-11,5,2,0,1,1,1,1,1,6,-1
KR_6700233184,420,-6,-81,5,-9,-4,5,1,-2,5,3,0,0,0,-2,9,7,-1,1,0,0,-7,-4,-1,-6,7,0,0,0,-1,1,-1,1,6,-1
KR_6757507969,420,0,4,-16,1,1,0,1,0,2,2,0,2,2,0,3,3,0,1,1,0,-2,-1,-3,-3,6,1,0,0,1,0,0,-1,1,-1
KR_6688899168,420,-3,-113,16,-4,-3,3,0,-1,1,0,2,2,4,1,0,1,-3,5,2,0,-3,-10,-2,-2,4,2,0,-1,1,-1,-1,-1,4,-1
KR_6743436813,420,0,-19,-10,-4,-2,2,0,2,0,2,1,1,2,-2,3,1,-3,3,0,0,-4,1,-6,0,6,4,0,-1,-1,-1,-1,-1,2,-1
KR_6752893015,440,1,-102,-16,-2,3,1,4,1,3,4,-1,4,3,-6,8,2,1,3,4,-1,-8,13,-1,-4,5,-2,0,0,1,0,0,-1,3,-1
KR_6739668221,420,2,18,24,1,-2,4,2,-1,2,1,5,2,7,-2,3,1,1,1,2,-1,5,117,-5,0,5,4,0,0,1,1,1,-1,6,-1
KR_6735269139,420,-2,-32,24,-6,-1,3,2,-4,7,3,0,1,1,0,4,4,-1,4,3,0,-7,14,2,-2,0,1,0,0,-1,-1,0,1,3,-1
KR_6731589707,420,0,4,-2,-3,-3,4,1,-3,6,3,1,5,6,3,1,4,-1,4,3,0,2,44,-6,0,6,-16,0,-1,1,-1,-1,1,4,-1
KR_6762885639,420,-1,8,-16,-3,2,0,2,2,1,3,-3,5,2,-2,3,1,-2,2,0,0,-7,-1,5,-6,1,-2,0,0,-1,1,1,1,1,-1
KR_6760453744,420,-4,-51,-43,-6,1,1,2,-3,4,1,-11,11,0,4,0,4,3,0,3,1,1,-7,-6,0,6,5,0,-2,1,-1,-1,1,2,-1
KR_6763121530,420,-5,-16,4,-8,-2,5,3,0,1,1,-5,5,0,2,0,2,-3,3,0,0,-3,-3,1,-4,3,-2,0,-1,-1,-1,-1,-1,2,-1
KR_6740214014,440,-6,-88,-14,-18,-7,10,3,-8,8,0,1,0,1,-3,3,0,-1,1,0,0,-14,0,-4,0,4,2,0,-1,-1,-1,-1,-1,4,-1
KR_6690943058,440,-4,-24,8,-10,-4,4,0,-1,1,0,5,1,6,-9,10,1,-1,2,1,-1,-11,12,6,-7,1,-6,0,-1,-1,-1,-1,-1,1,-1
KR_6702753553,420,-5,12,-42,-13,-5,7,2,0,1,1,-3,4,1,-6,8,2,1,6,7,0,-10,-2,1,-2,1,-4,0,-3,-1,-1,-1,-1,4,-1
KR_6755046235,420,-2,-113,-30,-7,1,3,4,-2,3,1,0,2,2,-5,5,0,-1,2,1,-1,-12,8,-4,-1,5,1,0,-2,1,-1,-1,1,4,-1
KR_6673207368,420,2,70,-23,0,-5,6,1,-3,4,1,7,0,7,-1,4,3,2,1,3,1,-3,23,-2,0,2,0,0,2,0,-1,1,1,0,-1
KR_6742607308,420,-1,-86,-8,-2,0,1,1,7,0,7,-3,5,2,-4,7,3,-2,2,0,-1,-5,-4,-3,-3,6,2,0,-1,-1,1,-1,-1,3,-1
KR_6651021049,420,0,-45,20,-10,2,2,4,-3,7,4,-3,4,1,-5,6,1,-1,3,2,-2,-12,-182,-3,-2,5,0,0,0,-1,0,1,-1,4,-1
KR_6757847580,420,4,39,12,6,1,1,2,3,0,3,2,2,4,0,0,0,0,0,0,0,1,-2,-3,0,3,-1,0,0,-1,-1,0,1,5,-1
KR_6741753971,420,-2,-18,-3,1,-3,5,2,1,0,1,2,0,2,0,2,2,1,0,1,2,8,-227,2,-3,1,2,0,0,-1,-1,0,1,4,-1
KR_6714727814,440,-5,41,-33,-15,-1,5,4,-4,4,0,-3,4,1,-3,7,4,-4,4,0,0,-13,6,1,-1,0,0,0,-1,0,-1,-1,-1,0,-1
KR_6637077173,420,-5,3,1,-6,0,0,0,-1,3,2,-2,2,0,-4,5,1,1,0,1,0,-7,18,-3,-2,5,-3,0,0,-1,1,0,1,2,-1
KR_6762691452,420,0,-48,0,1,1,3,4,1,0,1,-2,3,1,-3,4,1,4,0,4,0,0,-5,-4,-1,5,4,0,-1,0,0,-1,1,0,-1
KR_6733173984,420,3,-38,4,9,1,1,2,4,6,10,-1,1,0,4,3,7,1,0,1,0,4,2,0,-3,3,1,0,0,-1,-1,-1,1,6,-1
KR_6686935285,420,-4,-20,-10,-10,1,1,2,-4,4,0,-9,9,0,2,2,4,0,1,1,0,-10,167,-1,-2,3,1,0,-1,1,1,-1,-1,2,-1
KR_6757320473,420,-1,-2,4,-2,0,3,3,-1,2,1,-1,4,3,-2,3,1,2,0,2,0,-5,-10,-7,-2,9,5,0,1,-1,1,1,-1,1,-1
KR_6645578343,420,-3,-38,-7,-11,-3,5,2,-1,6,5,-1,4,3,-3,3,0,-3,3,0,0,-4,-5,-1,-5,6,-3,0,-1,1,0,-1,-1,5,-1
KR_6756843182,420,-4,-14,-48,-5,-7,7,0,-3,3,0,3,1,4,0,2,2,2,0,2,-1,-18,11,-2,0,2,0,0,-2,-1,-1,-1,-1,6,-1
KR_6764035982,420,-3,-43,-33,-14,0,1,1,0,0,0,-7,9,2,-7,10,3,0,3,3,-1,-10,-5,-1,-2,3,-2,0,0,-1,-1,-1,-1,3,-1
KR_6724412316,420,-2,-10,0,1,-7,8,1,2,0,2,1,2,3,2,2,4,3,2,5,0,0,3,4,-4,0,-1,0,1,1,-1,-1,1,4,-1
KR_6760574075,420,0,15,2,1,3,0,3,-2,4,2,0,3,3,-1,1,0,1,0,1,0,-2,-23,0,-3,3,1,0,0,1,1,1,1,2,-1
KR_6688983693,420,-6,-73,-4,-4,-2,3,1,-7,7,0,1,1,2,2,1,3,2,2,4,0,1,3,-1,-3,4,2,0,0,1,1,1,1,2,-1
KR_6741918665,420,-5,35,-12,-13,-2,3,1,-3,4,1,-1,2,1,-3,4,1,-4,4,0,1,-9,-10,-1,0,1,1,0,-1,-1,-1,-1,1,4,-1
KR_6743184993,420,-8,-45,-90,-10,-5,5,0,-4,6,2,-3,4,1,1,1,2,1,3,4,0,-2,-22,1,-4,3,5,0,-2,0,-1,-1,-1,0,-1
KR_6735000236,420,1,76,-28,1,0,0,0,-1,1,0,2,0,2,2,0,2,-2,3,1,0,5,24,-1,-1,2,2,0,-1,1,-1,-1,-1,4,-1
KR_6761432615,440,-5,-89,-10,-19,-6,9,3,-2,2,0,2,3,5,-10,10,0,-3,3,0,-1,-11,-3,-1,-1,2,-1,0,-2,-1,-1,-1,-1,2,-1
KR_6754411921,420,-1,-25,-29,2,0,4,4,-3,3,0,2,1,3,5,0,5,-2,2,0,0,4,-2,-2,-2,4,-1,0,0,-1,0,0,-1,1,-1
KR_6650648478,420,-2,-48,-8,-1,0,1,1,-4,5,1,1,1,2,2,1,3,0,1,1,0,-1,-4,-2,-1,3,-1,0,0,0,-1,0,-1,0,-1
KR_6746202452,420,-2,-70,-24,-10,1,3,4,-2,3,1,-1,2,1,-7,8,1,-1,2,1,0,-5,4,1,-2,1,-4,0,1,-1,-1,1,-1,4,-1
KR_6703669093,420,0,-84,15,-3,-4,6,2,4,0,4,-3,3,0,-1,1,0,1,0,1,0,-3,7,3,-5,2,2,0,-1,-1,1,1,-1,6,-1
KR_6704561459,420,0,31,-20,-4,2,3,5,-1,5,4,-2,4,2,-2,5,3,-1,2,1,1,-4,-2,0,-4,4,-1,0,0,-1,-1,1,1,2,-1
KR_6665482116,420,-1,-15,20,4,1,0,1,2,0,2,2,1,3,-1,2,1,0,2,2,0,2,-1,1,-4,3,0,0,0,1,0,0,-1,5,-1
KR_6759749608,420,0,-28,16,-4,-3,4,1,-1,2,1,0,3,3,-1,3,2,1,0,1,-1,-4,2,3,-3,0,-2,0,-1,1,0,-1,-1,2,-1
KR_6748677308,420,-4,-111,-5,-14,-3,4,1,-6,8,2,-4,6,2,0,2,2,-1,1,0,-1,-13,231,-1,0,1,-1,0,-1,-1,-1,-1,-1,5,-1
KR_6672803966,420,1,-64,-28,-2,-3,5,2,1,2,3,1,0,1,0,1,1,-1,3,2,-1,1,8,3,-5,2,1,0,-1,0,0,-1,-1,0,-1
KR_6764255492,420,1,-20,36,1,3,2,5,0,4,4,-3,5,2,0,2,2,1,1,2,0,-10,-2,0,-1,1,3,0,1,1,0,1,1,5,-1
KR_6671483811,420,-4,13,-36,-8,-4,4,0,-1,1,0,0,2,2,0,4,4,-3,4,1,0,-2,5,4,-5,1,-4,0,0,1,-1,0,1,5,-1
KR_6748731087,420,0,37,4,1,1,1,2,0,1,1,-3,4,1,4,1,5,-1,1,0,0,4,10,-2,0,2,0,0,1,1,0,1,-1,4,-1
KR_6751927714,420,-4,-53,8,-12,2,1,3,-6,6,0,-3,5,2,-3,4,1,-2,2,0,0,-11,-4,-4,-2,6,0,0,-1,-1,-1,-1,-1,4,-1
KR_6677367678,420,-4,-36,24,-15,-3,4,1,0,2,2,-1,1,0,-11,13,2,0,0,0,0,-14,-8,-1,-2,3,-2,0,-1,-1,-1,-1,-1,4,-1
KR_6726485953,420,-2,-43,0,-2,1,1,2,-1,4,3,0,3,3,-3,3,0,1,2,3,0,0,169,-4,-5,9,-3,0,-1,0,1,-1,-1,0,-1
KR_6684117541,420,0,66,34,-9,3,0,3,-3,5,2,-3,4,1,-5,7,2,-1,2,1,-1,-7,36,2,-6,4,-24,0,2,-1,-1,1,-1,3,-1
KR_6734883363,420,-2,-40,-16,-7,-1,2,1,-5,6,1,-3,4,1,2,3,5,0,1,1,0,-3,-15,-4,0,4,6,0,1,-1,1,1,-1,1,-1
KR_6760510328,420,-2,31,27,-4,-3,5,2,2,1,3,1,0,1,-4,7,3,0,1,1,-1,1,1,4,-5,1,2,0,0,0,1,1,-1,0,-1
KR_6727709179,420,-3,-30,7,-6,-1,3,2,0,1,1,-2,5,3,-2,3,1,-1,2,1,0,-7,-4,-1,-3,4,-4,0,-1,-1,0,-1,1,2,-1
KR_6650787511,420,1,7,19,4,4,0,4,-2,3,1,-2,2,0,3,3,6,1,2,3,0,7,-12,-7,-3,10,5,0,0,-1,-1,0,1,4,-1
KR_6755946126,420,-2,31,-26,-6,1,1,2,-7,8,1,2,2,4,0,4,4,-2,2,0,-1,-3,4,4,-5,1,-4,0,0,1,-1,0,-1,5,-1
KR_6757776305,420,5,19,-16,15,1,1,2,0,2,2,3,3,6,7,1,8,4,1,5,0,23,-176,-1,-2,3,1,0,1,1,1,1,1,6,-1
KR_6751940112,420,-3,8,-16,-6,3,1,4,-1,1,0,0,2,2,-5,10,5,-3,3,0,0,-8,-9,2,-3,1,-1,0,1,-1,1,-1,1,4,-1
KR_6743652190,420,-2,-36,16,-3,-1,1,0,3,2,5,-3,3,0,0,2,2,-2,4,2,0,-1,-11,1,-5,4,1,0,-1,-1,-1,-1,-1,4,-1
KR_6708545437,420,-3,-54,-70,-3,-3,4,1,0,3,3,4,2,6,-2,3,1,-2,2,0,-1,1,3,2,-6,4,-5,0,-1,1,-1,-1,-1,5,-1
KR_6761507741,420,-1,-43,1,-6,-5,6,1,0,5,5,-2,4,2,1,2,3,0,1,1,0,-3,-3,-2,-3,5,3,0,-1,1,0,-1,-1,2,-1
KR_6731950369,440,3,-14,8,-1,-3,5,2,-1,2,1,0,1,1,1,0,1,2,1,3,0,2,-5,3,-6,3,0,0,0,1,1,-1,1,1,-1
KR_6760341443,420,-4,-28,-22,-14,-1,2,1,1,3,4,-4,7,3,-8,9,1,-2,3,1,0,-8,276,2,-4,2,-2,0,-4,-1,1,-1,-1,6,-1
KR_6744661109,420,-2,22,-43,-3,-4,4,0,7,1,8,-2,4,2,-2,2,0,-2,4,2,-1,-6,-35,2,-3,1,1,0,1,-1,1,1,-1,3,-1
KR_6668925048,420,0,-31,-41,-3,-1,2,1,0,2,2,-2,3,1,2,0,2,-2,2,0,-2,-1,-42,0,-2,2,26,0,0,1,1,1,-1,2,-1
KR_6723479867,420,0,-63,-4,12,0,4,4,0,1,1,8,1,9,5,1,6,-1,1,0,0,15,5,2,-5,3,-4,0,0,1,-1,-1,1,6,-1
KR_6751399637,420,1,-52,0,1,0,3,3,-2,2,0,2,3,5,1,1,2,0,2,2,0,3,-301,-2,0,2,2,0,-1,-1,-1,-1,-1,6,-1
KR_6755241915,420,3,56,56,3,1,2,3,-4,5,1,3,1,4,4,1,5,-1,2,1,0,-2,5,1,-2,1,-3,0,1,0,-1,1,1,0,-1
KR_6702377195,420,0,22,0,1,0,2,2,-1,2,1,0,4,4,1,1,2,1,1,2,0,0,9,4,-6,2,-1,0,3,1,1,1,1,5,-1
KR_6733582833,420,-2,27,-12,-6,-1,1,0,-2,5,3,-1,1,0,-1,1,0,-1,2,1,0,-7,125,1,-5,4,-5,0,0,0,1,0,-1,0,-1
KR_6699089132,440,-4,-78,0,-6,1,0,1,-1,1,0,-3,3,0,-1,5,4,-2,2,0,0,-2,0,-3,-1,4,3,0,-2,1,-1,-1,-1,2,-1
KR_6735549718,420,0,22,-12,-2,0,2,2,-2,3,1,2,0,2,-1,1,0,-1,1,0,0,-5,40,-2,-3,5,-31,0,0,1,-1,0,1,2,-1
KR_6734635595,420,-5,-43,-38,-6,0,1,1,-6,7,1,5,1,6,-2,5,3,-3,3,0,0,-5,1,-3,-1,4,-1,0,-3,-1,-1,-1,-1,5,-1
KR_6749793197,420,-3,-12,16,-9,0,0,0,-2,2,0,-3,5,2,-4,7,3,0,2,2,0,-10,-6,-1,-1,2,0,0,0,-1,0,-1,1,2,-1
KR_6645701265,420,-3,9,27,2,8,0,8,-2,5,3,0,2,2,-4,4,0,0,0,0,0,-9,6,-3,-1,4,-2,0,0,1,0,1,-1,1,-1
KR_6748975454,420,0,-44,-32,7,-3,5,2,2,1,3,3,0,3,4,0,4,1,0,1,0,6,110,-2,-4,6,3,0,0,-1,1,1,-1,1,-1
KR_6732808530,420,-4,-66,8,-13,0,2,2,-6,7,1,-4,6,2,-2,2,0,-1,1,0,0,-15,290,-8,0,8,-4,0,-1,0,1,-1,-1,0,-1
KR_6746731401,420,-4,-77,-12,-14,-4,5,1,1,3,4,0,1,1,-8,10,2,-3,4,1,-1,-10,2,-2,0,2,-4,0,-3,-1,1,-1,-1,6,-1
KR_6726597040,420,-5,-41,-4,-8,-3,4,1,0,1,1,-1,3,2,-4,4,0,0,0,0,0,-9,0,2,-5,3,1,0,-2,0,-1,-1,-1,0,-1
KR_6687647512,420,1,-45,24,-3,-7,7,0,-1,2,1,2,1,3,1,1,2,2,1,3,0,5,-8,-3,-2,5,0,0,1,1,1,1,-1,6,-1
KR_6691259072,420,-1,12,0,3,-2,4,2,-1,2,1,1,0,1,5,1,6,0,1,1,0,1,42,3,-6,3,-18,0,1,1,-1,1,1,4,-1
KR_6726245329,420,2,5,27,-3,4,0,4,-2,3,1,-1,5,4,-7,7,0,3,0,3,0,-2,1,-2,-6,8,-5,0,0,-1,-1,0,-1,4,-1
KR_6666629586,420,2,52,24,-3,1,0,1,3,2,5,-7,8,1,-1,3,2,1,0,1,0,-7,1,2,-6,4,3,0,2,1,1,1,1,5,-1
KR_6752473966,420,0,-10,-44,3,-2,2,0,0,5,5,3,1,4,-2,5,3,4,0,4,0,3,-1,-4,-2,6,4,0,-2,-1,-1,-1,1,1,-1
KR_6762909766,420,1,-14,19,-3,0,1,1,-3,4,1,1,1,2,-1,4,3,0,3,3,0,-5,-5,-2,-5,7,-3,0,0,-1,-1,0,-1,3,-1
KR_6762555796,420,1,-39,4,9,5,0,5,-2,3,1,4,5,9,2,1,3,0,0,0,0,4,-2,0,-5,5,-4,0,1,0,0,1,1,0,-1
KR_6762215130,420,-2,32,-28,-2,0,3,3,-3,4,1,0,3,3,1,2,3,0,0,0,0,-4,2,1,-1,0,-1,0,0,-1,-1,-1,1,1,-1
KR_6684615277,420,-3,-23,-11,-5,-5,6,1,2,2,4,-4,4,0,2,1,3,0,3,3,0,-3,-7,-4,-1,5,-1,0,-1,1,-1,-1,1,1,-1
KR_6648984203,420,-3,-57,2,-7,3,1,4,-3,4,1,-5,5,0,-3,6,3,1,0,1,1,-3,-351,-1,-4,5,-1,0,-2,-1,1,1,1,5,-1
KR_6652893295,420,-2,-63,4,-4,1,1,2,-1,2,1,-2,4,2,-1,1,0,-1,1,0,0,1,-17,-5,-2,7,1,0,0,-1,1,0,-1,5,-1
KR_6732982708,420,-3,-39,-11,-3,-3,6,3,2,1,3,0,1,1,1,0,1,-3,4,1,0,1,3,0,-1,1,2,0,-2,1,0,-1,-1,1,-1
KR_6747437816,420,-5,-30,-20,-16,0,1,1,-8,8,0,-5,6,1,-3,4,1,0,0,0,-1,-15,-61,-4,-3,7,5,0,0,-1,1,-1,-1,3,-1
KR_6744138941,420,-4,-92,-5,-6,-2,4,2,-2,8,6,2,1,3,-2,3,1,-2,2,0,0,-8,0,-1,-1,2,-3,0,-2,1,-1,-1,-1,4,-1
KR_6755119551,420,-1,55,12,-9,-10,10,0,2,3,5,2,1,3,0,5,5,-3,6,3,2,-5,-43,-1,-2,3,12,0,-1,0,0,-1,1,0,-1
KR_6763475986,420,2,117,-9,-3,0,0,0,-2,4,2,-6,7,1,1,3,4,4,0,4,0,-3,-3,-6,0,6,5,0,0,-1,-1,0,1,6,-1
KR_6752128992,420,-3,-21,27,-7,-2,3,1,-3,3,0,-3,5,2,2,0,2,-1,2,1,0,-5,2,-1,-2,3,3,0,0,1,1,1,-1,5,-1
KR_6751298128,420,-5,-63,-12,-12,-4,4,0,-2,5,3,-3,3,0,-2,4,2,-1,4,3,-1,-9,1,-1,-2,3,-1,0,0,-1,1,-1,-1,2,-1
KR_6732485191,420,1,-2,54,-3,0,1,1,2,2,4,0,4,4,-2,2,0,-3,4,1,0,-6,-115,-2,0,2,2,0,0,-1,1,0,-1,2,-1
KR_6755438192,420,3,-45,24,6,3,0,3,0,3,3,5,1,6,-1,5,4,-1,2,1,0,3,2,-4,0,4,0,0,0,0,-1,1,-1,0,-1
KR_6727981741,420,2,19,0,0,5,0,5,-4,5,1,0,3,3,-1,2,1,0,2,2,0,-6,7,-2,0,2,0,0,-1,-1,-1,-1,1,3,-1
KR_6760749998,420,0,-6,4,-4,0,2,2,-1,2,1,-1,2,1,1,0,1,-3,3,0,0,-7,-11,1,-5,4,2,0,0,-1,-1,0,1,1,-1
KR_6741301235,420,3,61,12,-4,-1,1,0,-1,4,3,-1,1,0,0,1,1,-1,2,1,0,-1,22,0,-3,3,3,0,0,-1,-1,0,-1,1,-1
KR_6704682924,420,-3,16,-18,-2,2,0,2,-1,3,2,-4,4,0,-2,2,0,3,0,3,0,-2,-38,-3,0,3,14,0,0,-1,0,1,1,3,-1
KR_6755202026,420,2,38,-62,3,1,0,1,-1,2,1,-1,4,3,4,2,6,0,1,1,0,4,15,1,-1,0,0,0,0,1,0,0,-1,2,-1
KR_6670263795,420,-3,-64,-19,4,0,4,4,-2,2,0,-1,4,3,3,2,5,4,0,4,3,16,1,3,-4,1,1,0,0,0,1,1,1,0,-1
KR_6726519121,420,3,12,8,-2,-2,5,3,1,2,3,-2,5,3,1,1,2,0,1,1,0,4,-1,-3,-1,4,1,0,0,1,-1,-1,-1,1,-1
KR_6721448165,420,-2,-60,1,-6,0,1,1,2,0,2,3,2,5,-8,11,3,-3,3,0,0,-2,7,-3,-2,5,-1,0,0,-1,0,-1,-1,5,-1
KR_6627070932,420,-3,-65,-48,-7,-7,8,1,5,4,9,-9,9,0,2,0,2,2,0,2,1,3,-6,-2,-1,3,0,0,0,1,-1,0,1,3,-1
KR_6655141038,420,0,-40,16,-3,-7,7,0,-1,5,4,3,1,4,1,0,1,1,0,1,0,0,3,-4,-1,5,4,0,-1,-1,-1,-1,-1,1,-1
KR_6723745767,420,0,26,4,1,2,1,3,0,1,1,0,2,2,-3,4,1,2,0,2,0,-2,1,-1,-4,5,2,0,0,1,0,0,-1,2,-1
KR_6737709574,420,-3,-76,-8,-12,-7,7,0,-7,7,0,0,1,1,2,2,4,0,3,3,-1,-9,2,-3,-1,4,-1,0,-2,-1,-1,-1,-1,5,-1
KR_6746358583,420,-1,-55,-4,2,2,1,3,-7,7,0,0,2,2,2,0,2,5,0,5,0,2,-16,-6,0,6,9,0,-1,1,1,-1,1,6,-1
KR_6734058175,420,3,53,12,3,5,0,5,-4,4,0,6,0,6,-1,1,0,-3,3,0,0,-3,2,-1,-2,3,1,0,0,-1,-1,1,1,5,-1
KR_6760784316,420,-3,-14,15,2,-1,2,1,5,4,9,0,3,3,-2,2,0,0,1,1,0,6,-5,-2,-4,6,4,0,0,1,-1,0,1,5,-1
KR_6758858554,420,-3,-92,-16,-3,-3,3,0,3,1,4,-4,6,2,-3,5,2,4,0,4,-1,4,-2,-3,-1,4,0,0,-1,-1,1,-1,-1,5,-1
KR_6760727800,420,-5,-23,-15,-9,0,1,1,-2,2,0,-6,6,0,1,1,2,-2,2,0,0,-6,-14,0,-1,1,-2,0,0,-1,-1,0,-1,6,-1
KR_6703505073,420,-3,-30,-8,6,-2,4,2,4,0,4,1,3,4,0,2,2,3,1,4,0,3,9,-1,-1,2,-1,0,0,0,1,-1,-1,0,-1
KR_6722585765,420,-3,-142,4,-14,-3,3,0,-3,5,2,-4,5,1,-2,5,3,-2,3,1,0,-8,27,-1,-3,4,-17,0,-2,0,-1,-1,-1,0,-1
KR_6755120989,420,-1,1,-12,-3,1,0,1,0,2,2,-9,10,1,3,2,5,2,0,2,0,2,5,-4,0,4,4,0,-1,-1,-1,-1,-1,6,-1
KR_6722900250,420,2,66,20,5,1,2,3,0,3,3,3,0,3,3,0,3,-2,2,0,0,4,-15,-5,-1,6,5,0,-1,-1,-1,-1,1,5,-1
KR_6756542899,420,0,35,-84,7,0,1,1,1,1,2,-4,5,1,5,1,6,5,0,5,0,11,-43,1,-2,1,27,0,3,-1,-1,1,-1,1,-1
KR_6742979622,420,-4,-15,-16,-12,-3,5,2,0,1,1,-1,2,1,-5,6,1,-3,4,1,0,-7,-2,0,-1,1,0,0,-1,-1,-1,-1,1,2,-1
KR_6721001250,420,-5,-50,-43,-2,-1,3,2,0,1,1,-2,4,2,-1,3,2,2,0,2,0,0,-2,4,-6,2,0,0,0,-1,1,0,1,5,-1
KR_6686047937,420,-14,-78,-56,-12,2,0,2,-3,3,0,-4,4,0,-1,1,0,-6,6,0,0,-7,-16,-5,-1,6,-3,0,-5,-1,-1,-1,1,5,-1
KR_6730856400,420,0,-8,-8,0,-2,4,2,-3,4,1,0,1,1,5,0,5,0,0,0,0,5,-20,1,-2,1,0,0,0,0,1,0,1,0,-1
KR_6724384449,420,-1,-104,-2,-6,2,1,3,-3,5,2,-5,7,2,0,2,2,0,2,2,0,0,-266,3,-4,1,-1,0,0,-1,-1,0,-1,5,-1
KR_6758585951,420,-5,-59,-29,-11,-2,2,0,-4,4,0,-4,4,0,-1,1,0,0,2,2,0,-6,115,1,-2,1,0,0,-1,-1,1,-1,-1,1,-1
KR_6762990017,420,-5,-12,12,-13,-2,4,2,-1,2,1,-5,5,0,-5,5,0,0,0,0,0,-12,3,0,-4,4,1,0,0,-1,0,0,1,1,-1
KR_6729778666,420,-5,-116,12,-10,-3,4,1,-1,1,0,1,3,4,-6,6,0,-1,1,0,0,-10,10,1,-5,4,0,0,-2,-1,-1,-1,-1,6,-1
KR_6742671588,420,-3,6,-32,-10,-1,1,0,2,2,4,0,3,3,-8,9,1,-3,4,1,0,-7,-3,-3,0,3,-1,0,0,-1,1,0,1,5,-1
KR_6762784190,420,-2,38,-20,-6,1,2,3,-1,1,0,-4,4,0,-2,2,0,0,0,0,0,-3,11,-2,-2,4,-3,0,0,-1,0,0,-1,3,-1
KR_6710247779,420,-3,6,-23,-7,2,3,5,-5,7,2,2,1,3,-5,7,2,-1,1,0,1,-15,12,0,-2,2,-2,0,-1,-1,-1,-1,1,2,-1
KR_6757892577,420,-4,-82,-32,-4,-3,3,0,0,0,0,4,2,6,-4,4,0,-1,2,1,-3,-8,-1,1,-1,0,0,0,-1,1,-1,-1,-1,3,-1
KR_6740957358,420,-2,-39,-12,0,-4,4,0,-2,2,0,1,1,2,4,1,5,1,0,1,1,5,-20,0,-2,2,1,0,0,-1,1,-1,1,1,-1
KR_6699223366,420,3,1,-9,8,2,0,2,0,1,1,0,1,1,6,0,6,0,0,0,2,13,-4,7,-7,0,0,0,1,0,1,1,1,0,-1
KR_6735218490,420,-4,-86,-4,-11,-6,8,2,4,0,4,0,1,1,-8,11,3,-1,3,2,-1,-8,-7,2,-4,2,0,0,-2,-1,0,-1,-1,2,-1
KR_6759665459,420,-1,25,-24,-5,1,3,4,-2,5,3,-4,4,0,-1,2,1,1,4,5,0,-5,5,0,-3,3,-5,0,-1,-1,-1,-1,-1,3,-1
KR_6727829406,420,-3,-65,28,-2,-4,5,1,1,0,1,2,3,5,-1,2,1,0,0,0,0,-3,0,-1,-1,2,3,0,0,1,0,0,1,5,-1
KR_6745949711,420,-1,-1,2,-5,-7,7,0,-2,6,4,-1,4,3,5,1,6,0,0,0,0,2,-15,1,-1,0,0,0,-1,1,-1,-1,1,4,-1
KR_6757961508,440,-3,11,28,-9,-4,5,1,-1,1,0,2,2,4,-4,5,1,-2,3,1,0,-8,-205,-3,-2,5,1,0,-1,-1,-1,-1,-1,5,-1
KR_6758252771,420,-2,-8,-48,-8,-9,9,0,3,0,3,1,2,3,-3,4,1,0,2,2,-1,0,-25,2,-4,2,5,0,-1,1,-1,-1,-1,3,-1
KR_6656431274,420,-2,-102,12,-3,-1,4,3,2,0,2,4,0,4,-7,7,0,-1,1,0,0,-11,4,1,-4,3,1,0,0,-1,0,0,1,2,-1
KR_6729557180,420,-3,-58,-8,-8,5,0,5,-5,6,1,1,2,3,-8,8,0,-1,1,0,-1,-17,-6,-1,-2,3,0,0,-1,1,-1,-1,-1,2,-1
KR_6723905134,420,-6,-70,4,3,1,1,2,1,4,5,0,0,0,-1,2,1,2,1,3,0,-3,63,2,-5,3,-29,0,-3,-1,-1,-1,1,3,-1
KR_6740183251,420,-5,-50,-16,-13,-2,3,1,-5,5,0,0,1,1,-6,6,0,0,2,2,0,-8,-3,-4,0,4,-1,0,-2,1,0,-1,-1,2,-1
KR_6729180756,420,1,-63,12,2,0,2,2,0,2,2,0,1,1,-1,6,5,3,0,3,0,4,-8,-3,-3,6,1,0,-1,0,1,-1,-1,0,-1
KR_6751265202,420,4,81,27,2,1,2,3,-3,5,2,2,1,3,1,2,3,1,0,1,0,6,31,-1,-5,6,3,0,2,1,-1,1,-1,1,-1
KR_6757030769,420,-3,-25,12,-4,3,0,3,-2,3,1,-5,6,1,1,0,1,-1,1,0,0,-9,-27,2,-4,2,3,0,0,1,-1,1,1,6,-1
KR_6725213321,420,-4,-118,-24,-6,-2,2,0,-2,4,2,2,1,3,-4,5,1,0,0,0,-1,-4,-5,0,-2,2,-1,0,-1,-1,1,-1,-1,1,-1
KR_6741858565,420,0,30,-17,-7,0,2,2,-2,2,0,-2,4,2,-3,3,0,0,0,0,0,-11,-14,3,-3,0,1,0,0,0,1,1,-1,0,-1
KR_6759088624,420,-2,37,-16,-7,-2,2,0,-1,1,0,2,3,5,-6,6,0,0,0,0,0,-11,1,-2,0,2,-1,0,0,-1,1,0,-1,2,-1
KR_6706864761,420,-3,-20,4,-9,2,0,2,-3,5,2,-7,9,2,0,2,2,-1,3,2,0,-12,-5,-1,-1,2,0,0,-2,1,1,-1,1,1,-1
KR_6746077424,440,1,-58,0,3,-2,3,1,0,3,3,2,2,4,4,1,5,-1,2,1,0,6,-5,-2,-2,4,2,0,-1,-1,-1,-1,-1,5,-1
KR_6652809165,420,0,-60,0,-5,1,0,1,1,1,2,-4,5,1,-1,3,2,-2,3,1,0,-2,-3,0,0,0,-1,0,-1,-1,1,-1,-1,4,-1
KR_6743841682,420,-1,71,28,-4,-3,3,0,-2,5,3,4,0,4,-2,4,2,-1,1,0,0,-5,4,2,-4,2,0,0,0,1,-1,0,-1,3,-1
KR_6744243287,420,-6,-101,-27,-14,-1,1,0,-4,6,2,-6,8,2,-3,5,2,0,2,2,0,-8,-5,-3,-1,4,-2,0,-2,0,-1,-1,-1,0,-1
KR_6757904666,420,-2,-60,-4,-6,-2,3,1,3,4,7,-2,3,1,-3,7,4,-2,3,1,-1,-5,-1,5,-8,3,-3,0,-1,-1,-1,-1,1,1,-1
KR_6683283357,420,-2,29,-4,0,-1,2,1,2,4,6,-7,8,1,3,5,8,3,0,3,2,1,10,-5,-2,7,-5,0,0,-1,0,0,1,1,-1
KR_6538388673,440,-4,-68,-55,-16,-5,5,0,-2,3,1,-4,4,0,-4,7,3,-1,1,0,0,-19,-4,-1,-3,4,-3,0,-4,-1,-1,-1,1,6,-1
KR_6756163466,420,-1,-28,-10,-3,-3,6,3,-2,2,0,0,3,3,0,1,1,2,1,3,0,0,-118,-3,-2,5,0,0,-2,-1,-1,-1,1,3,-1
KR_6728774117,420,-4,-47,-24,-3,-2,3,1,-1,3,2,-2,3,1,0,1,1,2,0,2,0,2,16,0,-1,1,3,0,-1,1,-1,1,1,2,-1
KR_6754081753,420,1,53,-44,3,1,2,3,-1,3,2,5,0,5,-4,6,2,2,1,3,-1,-8,-8,-4,0,4,2,0,2,1,1,1,-1,6,-1
KR_6762239086,440,-1,36,-10,-1,-4,4,0,-1,2,1,-3,3,0,6,1,7,1,1,2,0,6,-7,0,-7,7,4,0,0,0,0,-1,-1,0,-1
KR_6698644336,420,1,-92,96,1,0,1,1,3,0,3,-3,4,1,1,0,1,0,1,1,0,3,7,-1,-2,3,2,0,0,1,1,-1,1,2,-1
KR_6645772072,420,-3,-34,-20,-14,2,0,2,-5,6,1,-2,3,1,-4,4,0,-5,5,0,-1,-23,-5,-2,-2,4,-3,0,-1,-1,1,-1,-1,2,-1
KR_6763708101,420,-6,-127,40,-13,-5,6,1,-1,2,1,-5,7,2,-2,3,1,0,0,0,1,-9,-12,2,-4,2,-3,0,-3,-1,1,-1,1,6,-1
KR_6742040558,420,-1,-38,16,-10,-6,6,0,-1,2,1,-1,4,3,-1,2,1,-1,1,0,-1,-3,0,-2,-1,3,-1,0,0,1,0,0,-1,4,-1
KR_6738403311,420,-3,-44,-11,-13,-5,6,1,-4,6,2,1,2,3,-4,5,1,-1,2,1,0,-6,83,-6,-1,7,-3,0,-2,0,-1,-1,-1,0,-1
KR_6701804078,420,-5,-48,-13,-7,0,1,1,-1,1,0,-4,5,1,-2,3,1,0,0,0,0,-3,8,-3,-3,6,-4,0,-2,-1,-1,-1,1,4,-1
KR_6746486323,420,-5,-41,-38,-11,0,3,3,-3,3,0,-3,3,0,-2,3,1,-3,3,0,0,-8,2,0,-3,3,-2,0,-1,-1,-1,-1,-1,3,-1
KR_6697397005,420,0,51,28,-2,3,2,5,-9,9,0,3,1,4,-1,4,3,2,0,2,-1,-9,-188,0,-2,2,2,0,-2,0,-1,-1,-1,0,-1
KR_6751235001,420,-3,47,-39,-7,0,0,0,-3,3,0,-4,7,3,1,0,1,-1,4,3,0,3,-2,0,-3,3,0,0,0,1,1,0,-1,5,-1
KR_6741121290,440,-3,-45,-21,3,0,1,1,-3,6,3,1,1,2,6,2,8,-1,2,1,0,6,-180,-1,-1,2,1,0,-1,-1,-1,-1,1,3,-1
KR_6752237070,420,-4,-77,-4,-11,0,4,4,-3,3,0,-2,5,3,-4,5,1,-2,2,0,-2,-15,-7,1,-3,2,1,0,0,0,-1,0,-1,0,-1
KR_6707500079,420,-1,-79,-4,-3,1,0,1,1,0,1,-5,5,0,0,2,2,0,2,2,0,-5,23,4,-5,1,-7,0,0,-1,-1,0,-1,6,-1
KR_6761039674,420,1,16,-32,-1,2,0,2,-2,5,3,2,1,3,-2,3,1,-1,1,0,0,-7,353,2,-3,1,2,0,0,0,1,0,-1,0,-1
KR_6693987698,420,5,105,20,5,1,3,4,2,3,5,2,3,5,-1,5,4,1,1,2,-1,-3,-11,-9,0,9,4,0,0,1,-1,0,-1,5,-1
KR_6732844140,420,-6,-97,-4,-4,-3,5,2,1,3,4,-1,1,0,-2,2,0,1,1,2,0,1,-58,0,-5,5,25,0,-2,0,0,-1,-1,0,-1
KR_6695676025,440,-4,8,0,-5,-4,6,2,1,4,5,-2,3,1,0,3,3,0,0,0,0,-4,264,0,-3,3,-2,0,-1,1,-1,-1,-1,4,-1
KR_6704678399,420,-3,-67,-36,-9,-3,4,1,-3,4,1,-1,3,2,-2,3,1,0,1,1,-1,-7,-1,-1,-3,4,-2,0,-2,0,-1,-1,-1,0,-1
KR_6637223776,420,0,39,0,-4,-2,4,2,1,3,4,4,0,4,-6,7,1,-1,1,0,0,-5,47,0,-2,2,-17,0,1,-1,1,1,1,4,-1
KR_6735030719,420,-1,-53,17,-6,-7,8,1,0,1,1,0,0,0,1,1,2,0,0,0,0,-1,23,-1,-2,3,1,0,-2,1,-1,-1,1,3,-1
KR_6751750242,420,1,-30,17,3,4,0,4,0,0,0,-3,3,0,2,5,7,0,1,1,0,3,-30,-3,0,3,8,0,1,1,0,1,-1,1,-1
KR_6758206829,420,4,50,0,5,-2,2,0,0,1,1,1,1,2,4,2,6,2,4,6,0,2,-13,-4,0,4,1,0,0,0,1,0,1,0,-1
KR_6744183217,420,0,-68,9,-1,-1,2,1,1,3,4,6,0,6,-7,7,0,0,2,2,0,-3,-3,1,-5,4,2,0,-1,-1,1,-1,-1,3,-1
KR_6729590091,440,-3,-54,-11,-12,-1,2,1,0,1,1,0,1,1,-10,11,1,-1,3,2,0,-6,-2,0,-5,5,-1,0,0,-1,1,0,-1,3,-1
KR_6756359821,420,-1,-25,12,-8,3,0,3,-1,2,1,-5,6,1,-2,3,1,-3,3,0,0,-7,1,0,-2,2,-2,0,0,-1,1,-1,1,5,-1
KR_6754105097,420,-5,-35,-12,-9,-1,1,0,-1,3,2,-9,9,0,3,0,3,-1,2,1,0,-3,128,0,-5,5,2,0,0,-1,0,0,-1,5,-1
KR_6684537729,420,0,-5,32,-3,-1,1,0,2,0,2,-1,1,0,-1,3,2,-2,2,0,0,-7,3,2,-2,0,-1,0,0,-1,0,0,-1,6,-1
KR_6672642261,440,-1,-56,33,-7,-2,3,1,-1,4,3,2,0,2,-3,7,4,-3,3,0,-2,-8,-3,2,-2,0,-1,0,-1,0,0,-1,-1,0,-1
KR_6761188450,440,-1,-32,24,2,-1,2,1,-1,4,3,3,3,6,1,4,5,0,1,1,-1,-4,7,5,-7,2,-2,0,-1,0,1,-1,-1,0,-1
KR_6756585307,420,0,5,-2,6,-3,4,1,2,2,4,5,0,5,0,2,2,2,1,3,0,13,3,1,-3,2,-1,0,-2,-1,1,-1,-1,3,-1
KR_6727620756,420,1,58,16,-2,-3,4,1,1,1,2,0,1,1,1,1,2,-1,1,0,0,-1,-3,-2,0,2,1,0,0,1,-1,0,-1,3,-1
KR_6760971824,420,-1,-39,12,-5,-2,3,1,1,0,1,2,2,4,-5,5,0,-1,2,1,0,-8,2,-3,-1,4,-1,0,0,-1,1,0,1,3,-1
KR_6745173251,440,2,34,6,6,1,2,3,1,0,1,2,2,4,2,1,3,0,1,1,0,8,172,1,-4,3,-22,0,0,1,0,0,1,4,-1
KR_6759933412,420,-2,-44,0,-5,-2,2,0,1,0,1,-4,5,1,0,3,3,0,1,1,0,-2,-2,1,-3,2,3,0,1,0,1,1,-1,0,-1
KR_6690875057,440,-4,-23,0,-8,-2,3,1,1,1,2,-3,6,3,-4,6,2,0,2,2,0,-3,7,5,-6,1,4,0,1,-1,0,-1,1,5,-1
KR_6725422741,420,-1,17,5,-3,-1,3,2,0,3,3,-1,2,1,2,2,4,-3,4,1,1,1,344,-6,-1,7,3,0,-1,-1,-1,-1,1,6,-1
KR_6762893909,420,-2,-78,-21,8,-4,6,2,4,1,5,3,0,3,4,0,4,1,1,2,1,22,0,0,-5,5,2,0,-1,1,-1,-1,1,1,-1
KR_6756537862,420,-5,-89,0,-8,-3,4,1,0,2,2,-3,3,0,-3,3,0,1,0,1,-1,-4,6,5,-8,3,-3,0,-3,-1,-1,-1,-1,5,-1
KR_6763751550,420,-7,-109,-20,-14,3,0,3,-1,2,1,-6,6,0,-5,5,0,-5,5,0,0,-8,-1,-2,-2,4,-2,0,-3,-1,-1,-1,-1,6,-1
KR_6652153525,420,3,14,7,4,2,1,3,-3,3,0,3,0,3,1,2,3,1,0,1,0,4,-126,1,-3,2,-2,0,0,1,1,0,1,2,-1
KR_6747277686,440,-1,-11,-8,-3,-3,3,0,1,3,4,-2,3,1,0,2,2,1,4,5,1,3,6,-1,-3,4,1,0,0,-1,1,0,1,1,-1
KR_6757505315,420,-4,-90,-28,-5,-1,1,0,0,1,1,-2,2,0,0,4,4,-2,2,0,0,-4,-26,1,-4,3,22,0,0,-1,-1,0,-1,5,-1
KR_6639868281,420,-2,15,-8,0,-3,5,2,-1,2,1,2,1,3,2,0,2,0,1,1,0,2,2,0,-1,1,1,0,0,1,0,0,-1,3,-1
KR_6641639776,440,1,-80,28,-4,2,1,3,-2,3,1,2,0,2,-3,3,0,-3,3,0,0,-8,-1,4,-7,3,-6,0,-1,1,1,-1,-1,5,-1
KR_6751674726,420,-2,-24,-12,-3,-2,2,0,3,0,3,2,0,2,-5,5,0,-1,1,0,0,-4,10,2,-4,2,0,0,0,-1,0,0,1,1,-1
KR_6659671941,420,0,44,16,1,1,1,2,4,4,8,-2,3,1,-3,9,6,1,1,2,0,-7,277,1,-3,2,2,0,0,1,1,0,-1,4,-1
KR_6630925127,420,1,51,20,-1,2,0,2,1,0,1,-1,4,3,-2,3,1,-1,1,0,0,-3,-27,-4,-1,5,0,0,0,0,0,0,-1,0,-1
KR_6730304376,440,-4,19,8,-13,-6,7,1,-2,4,2,0,3,3,0,3,3,-5,6,1,0,-20,-22,-3,-2,5,3,0,0,1,1,0,1,1,-1
KR_6728410857,420,-4,-41,-16,-4,-1,2,1,-2,6,4,0,2,2,-3,5,2,2,1,3,0,-4,-1,0,-2,2,0,0,0,-1,1,0,-1,4,-1
KR_6678407007,420,-1,29,-20,-6,0,1,1,-3,3,0,-3,4,1,1,1,2,-1,2,1,0,-8,323,-1,-2,3,-3,0,0,-1,-1,0,-1,4,-1
KR_6751973217,420,-4,27,20,-10,-3,3,0,-6,8,2,-3,3,0,1,0,1,1,0,1,0,-4,-13,-1,-1,2,4,0,-2,-1,-1,-1,-1,6,-1
KR_6741455175,420,-2,-62,-15,4,3,3,6,2,2,4,-2,2,0,1,0,1,0,0,0,1,9,-7,1,-2,1,-2,0,-2,0,1,-1,1,0,-1
KR_6747485985,420,-5,-19,-44,-12,-2,5,3,-2,2,0,-5,5,0,0,2,2,-3,3,0,0,-9,0,0,-2,2,0,0,-2,-1,1,-1,-1,5,-1
KR_6665631337,420,-7,-47,-19,-12,-3,3,0,1,1,2,0,1,1,-9,9,0,-1,1,0,-1,-15,-16,1,-1,0,0,0,-4,-1,-1,-1,-1,1,-1
KR_6755969765,420,0,-59,-8,-7,-2,5,3,1,0,1,1,0,1,-10,12,2,3,1,4,0,-4,-13,-2,-3,5,1,0,-1,1,-1,-1,-1,3,-1
KR_6744634396,420,-6,-49,9,-7,-4,4,0,-1,3,2,2,0,2,0,5,5,-4,6,2,3,-2,0,1,-2,1,0,0,-4,-1,-1,-1,1,2,-1
KR_6763522780,420,1,-15,-3,-2,-6,6,0,4,3,7,0,1,1,1,3,4,-1,1,0,-3,-7,-4,-2,-3,5,-2,0,0,-1,1,1,1,3,-1
KR_6683411999,420,-4,-36,-7,0,-2,5,3,2,1,3,2,1,3,0,2,2,-2,3,1,0,6,282,2,-2,0,-1,0,-1,-1,1,-1,1,1,-1
KR_6693822677,420,-5,-32,-44,-7,-11,11,0,1,0,1,-2,3,1,4,1,5,1,0,1,0,-2,-1,1,-1,0,2,-1,-2,0,-1,-1,-1,0,-1
KR_6739462515,420,-3,12,-36,-8,-3,5,2,3,2,5,-8,10,2,0,0,0,0,1,1,1,-2,8,-1,-3,4,2,0,1,-1,1,1,1,1,-1
KR_6722851546,420,1,14,4,-3,-2,4,2,3,1,4,-3,6,3,-2,3,1,1,0,1,1,2,-136,0,-4,4,-4,0,0,1,1,-1,1,2,-1
KR_6651294167,420,-1,13,6,1,0,2,2,2,1,3,-6,9,3,4,0,4,1,0,1,0,1,3,-1,-3,4,-5,0,0,-1,0,0,1,4,-1
KR_6757629415,420,2,-16,-12,0,0,0,0,-5,5,0,2,1,3,3,2,5,0,1,1,-1,-2,-3,-3,-1,4,3,0,0,-1,-1,0,-1,5,-1
KR_6742993378,420,-5,-118,-7,-9,-4,5,1,0,1,1,0,1,1,-6,7,1,1,0,1,-1,-5,53,0,-5,5,-6,0,-2,-1,1,-1,-1,1,-1
KR_6711747263,420,-1,6,-20,6,-4,4,0,5,0,5,0,3,3,4,1,5,1,0,1,0,10,-1,0,-3,3,-2,0,0,0,1,0,-1,0,-1
KR_6752061800,420,-3,-43,-12,-3,-1,2,1,0,3,3,-3,4,1,4,1,5,-3,3,0,-1,1,-12,2,-2,0,-1,0,-1,1,-1,-1,-1,3,-1
KR_6697356716,420,-5,-99,-44,-5,-7,8,1,-1,3,2,5,0,5,-1,5,4,-1,1,0,0,-2,-121,-1,-2,3,0,0,-3,-1,-1,-1,-1,5,-1
KR_6757628705,420,-3,-44,-29,-9,-4,4,0,1,3,4,-4,6,2,-3,7,4,1,1,2,0,-1,-3,-2,-1,3,1,0,-1,-1,1,-1,-1,5,-1
KR_6749517873,440,2,17,20,5,1,1,2,0,1,1,1,2,3,5,2,7,-2,2,0,0,2,362,-2,-1,3,-1,0,1,-1,1,1,-1,2,-1
KR_6532786271,420,0,-69,5,0,0,1,1,2,5,7,-2,2,0,0,2,2,0,2,2,1,2,230,-3,-3,6,0,0,0,1,0,0,1,6,-1
KR_6752857380,420,-8,-131,-16,-16,-8,8,0,1,1,2,-8,8,0,0,2,2,-1,2,1,-2,-4,-2,0,-3,3,-3,0,-3,0,-1,-1,-1,0,-1
KR_6659521328,420,0,5,12,-1,2,3,5,-3,5,2,-4,6,2,1,0,1,3,0,3,0,7,-6,-4,-2,6,0,0,-1,-1,-1,-1,-1,1,-1
KR_6677823458,440,0,5,-24,-6,1,0,1,-2,3,1,-1,3,2,-3,5,2,-1,4,3,0,-6,10,2,-4,2,1,0,1,-1,1,1,-1,2,-1
KR_6729614565,420,1,-6,-8,5,0,2,2,0,5,5,0,1,1,4,0,4,1,2,3,1,6,14,-3,-1,4,-3,0,-1,1,-1,-1,1,5,-1
KR_6759571868,420,0,-24,13,-3,-6,7,1,3,0,3,-3,5,2,1,1,2,2,1,3,0,2,9,-6,-1,7,4,0,-1,-1,1,-1,-1,2,-1
KR_6659701793,420,1,-13,7,2,1,1,2,1,2,3,3,0,3,-1,2,1,-2,2,0,0,-1,5,-3,-1,4,-1,0,0,-1,-1,0,-1,2,-1
KR_6762398314,420,2,25,8,2,1,1,2,4,2,6,0,2,2,-2,5,3,-1,1,0,0,2,-18,0,-4,4,4,0,1,1,0,1,-1,6,-1
KR_6353380778,420,-5,-91,21,-1,-2,2,0,3,1,4,-5,6,1,3,0,3,0,1,1,1,7,0,0,0,0,4,0,-3,1,-1,-1,1,2,-1
KR_6747252172,420,-3,-90,12,-10,-1,2,1,-2,4,2,-5,8,3,-3,6,3,1,0,1,-2,-24,-2,-2,-3,5,-4,0,0,-1,1,-1,-1,6,-1
KR_6693825573,420,-2,-39,-24,2,-2,4,2,3,1,4,-3,5,2,4,1,5,0,0,0,0,1,-7,-3,-2,5,0,0,2,1,1,1,1,5,-1
KR_6742004007,420,-1,-30,0,3,1,1,2,-2,4,2,-2,2,0,7,2,9,-1,1,0,0,5,0,1,-3,2,3,0,0,-1,1,1,1,4,-1
KR_6757304269,420,-5,-32,-12,-12,-1,2,1,2,1,3,-3,5,2,-8,10,2,-2,2,0,0,-10,-7,-2,-6,8,-3,0,0,1,1,0,1,2,-1
KR_6746485957,420,-5,-41,-36,-17,-7,7,0,0,0,0,-7,7,0,-2,2,0,-1,1,0,-1,-7,10,0,-3,3,1,0,-1,1,-1,-1,-1,3,-1
KR_6756865062,420,-2,-87,15,-3,-3,3,0,2,3,5,-2,4,2,0,4,4,0,2,2,1,2,-270,-4,-4,8,-1,0,-1,1,-1,-1,1,5,-1
KR_6760275480,420,1,-1,44,-8,2,1,3,0,2,2,-7,9,2,-3,5,2,0,0,0,0,-10,-27,-8,-2,10,-2,0,-2,-1,1,-1,-1,2,-1
KR_6735172082,420,-3,-57,-28,-12,1,0,1,-6,9,3,-1,3,2,-6,6,0,0,0,0,-1,-10,-23,2,-5,3,-1,0,0,-1,0,-1,-1,6,-1
KR_6727805929,420,-2,-95,-16,-4,2,1,3,0,0,0,-3,4,1,-2,5,3,-1,3,2,0,-2,-2,0,-4,4,3,0,0,-1,1,0,1,5,-1
KR_6651512799,420,0,1,-24,0,0,0,0,-2,4,2,2,1,3,-2,2,0,2,0,2,0,1,31,2,-4,2,-18,0,0,-1,1,0,-1,6,-1
KR_6723714887,420,-4,-34,-12,0,-1,2,1,-7,8,1,5,2,7,0,3,3,3,1,4,0,-7,1,2,-4,2,3,0,-3,-1,-1,-1,1,2,-1
KR_6704747657,420,-2,-66,14,-7,-5,5,0,-1,1,0,0,4,4,-3,3,0,2,1,3,-1,-10,-7,-6,0,6,-2,0,-1,1,1,-1,-1,5,-1
KR_6711639457,420,-1,-1,0,0,0,1,1,-6,8,2,8,0,8,0,3,3,-2,4,2,2,-1,-4,-2,-2,4,0,0,0,-1,0,0,1,5,-1
KR_6753892692,440,1,16,-4,-10,0,2,2,0,2,2,-2,4,2,-5,5,0,-3,3,0,0,-9,-5,-3,-1,4,-4,0,-1,-1,-1,-1,-1,3,-1
KR_6741846960,420,-6,-48,-32,-7,0,1,1,0,4,4,-6,7,1,3,2,5,-4,4,0,1,-5,-3,1,-2,1,-1,0,-1,-1,0,-1,1,5,-1
KR_6631927912,420,5,105,-19,6,-2,4,2,2,0,2,4,1,5,3,0,3,-1,1,0,0,10,-14,0,-3,3,0,0,1,-1,1,1,1,5,-1
KR_6710034562,420,-2,-14,-13,-7,-2,4,2,1,2,3,-5,7,2,-2,4,2,1,1,2,0,-7,8,-1,-1,2,-4,0,2,-1,1,1,-1,3,-1
KR_6686625243,420,-3,-51,-40,-7,-5,5,0,-4,5,1,0,0,0,4,1,5,-2,2,0,0,1,-191,-1,-1,2,2,0,0,-1,0,0,-1,5,-1
KR_6758941724,420,-4,-50,0,-8,-5,5,0,0,1,1,-2,2,0,-3,6,3,2,0,2,0,-5,22,0,-3,3,-15,0,0,-1,0,0,1,3,-1
KR_6741360640,420,-5,-33,-48,-9,-1,2,1,-2,2,0,-4,6,2,0,3,3,-2,2,0,-1,-9,312,-1,-2,3,-23,0,0,1,-1,1,-1,6,-1
KR_6702924960,420,-5,-88,-20,-9,5,0,5,0,0,0,-4,6,2,-10,10,0,0,1,1,0,-7,-39,-2,-1,3,31,-1,-2,-1,-1,-1,-1,3,-1
KR_6749378313,420,-1,-27,32,-1,-4,4,0,5,2,7,-2,3,1,1,1,2,-1,1,0,0,-1,-11,-1,-1,2,0,0,0,0,1,1,-1,0,-1
KR_6733749364,420,-3,-5,5,-9,-1,1,0,2,1,3,2,1,3,-11,12,1,-1,1,0,-1,-8,-3,-2,0,2,-2,0,-1,-1,-1,-1,-1,1,-1
KR_6754057354,420,2,-52,-36,4,3,1,4,-5,7,2,6,2,8,0,2,2,0,1,1,-1,8,-330,1,-6,5,2,0,0,1,-1,0,-1,4,-1
KR_6759137628,420,-3,-47,7,-1,0,2,2,-1,3,2,-2,5,3,3,1,4,-1,3,2,1,6,17,-2,-3,5,5,0,0,0,0,-1,-1,0,-1
KR_6653395421,420,-2,-99,-12,3,0,1,1,1,5,6,1,3,4,0,2,2,1,1,2,0,4,-4,4,-5,1,-2,0,0,-1,1,-1,1,2,-1
KR_6711717452,440,-2,-84,-20,-2,0,2,2,0,0,0,1,0,1,0,2,2,-3,5,2,0,2,41,1,-2,1,-12,0,0,0,-1,0,-1,0,-1
KR_6638622148,420,-5,-71,-22,-10,-2,3,1,-8,9,1,-4,6,2,5,1,6,-1,1,0,0,0,-269,1,-2,1,1,0,-2,1,-1,-1,-1,6,-1
KR_6762369039,420,-1,-25,32,-3,2,1,3,-1,5,4,-1,3,2,-8,10,2,5,0,5,0,-8,-2,-1,-3,4,0,0,0,1,0,0,1,2,-1
KR_6683964223,420,-1,-54,-8,-3,-1,1,0,-6,8,2,1,2,3,0,2,2,3,0,3,0,3,0,3,-4,1,-2,0,-1,1,-1,-1,-1,1,-1
KR_6760106642,420,-3,-35,-39,-2,-4,4,0,-4,6,2,2,1,3,3,2,5,1,0,1,0,-2,-1,-3,-1,4,4,0,0,0,-1,-1,-1,0,-1
KR_6649358510,420,2,-38,16,-1,1,0,1,-3,3,0,0,1,1,-1,1,0,2,0,2,0,-5,33,2,-4,2,-22,0,0,-1,1,0,1,1,-1
KR_6756913537,420,2,-13,-30,2,0,0,0,-2,3,1,6,0,6,0,5,5,-2,3,1,0,-4,120,-2,-1,3,-1,0,1,1,1,1,1,4,-1
KR_6746692374,420,-8,-95,-8,-14,-4,5,1,-1,2,1,-6,6,0,-5,5,0,2,0,2,1,-6,-13,-2,-1,3,-1,0,-3,-1,1,-1,1,2,-1
KR_6760792007,440,-3,22,15,-6,-1,3,2,-6,8,2,-1,1,0,1,0,1,1,1,2,0,-7,-32,-2,-1,3,0,0,0,0,0,-1,-1,0,-1
KR_6755071788,440,2,33,12,3,1,1,2,5,1,6,0,2,2,-3,4,1,0,0,0,0,-3,-4,0,-4,4,-3,0,0,-1,1,0,1,5,-1
KR_6756214316,420,-2,-17,16,-2,-3,4,1,1,2,3,3,1,4,-1,1,0,-2,4,2,0,2,-109,-3,0,3,-2,0,-2,-1,-1,-1,-1,1,-1
KR_6738784400,420,1,-5,-20,1,3,2,5,-1,2,1,-4,5,1,3,0,3,0,0,0,-1,-1,-5,-2,-2,4,3,0,-1,1,0,-1,-1,6,-1
KR_6763782693,420,-1,33,12,-2,1,1,2,-3,4,1,0,0,0,2,0,2,-2,3,1,0,-3,24,3,-4,1,-2,0,0,-1,1,0,1,1,-1
KR_6738041106,420,-1,16,5,-1,-1,3,2,-1,6,5,-1,1,0,1,1,2,1,1,2,0,0,20,-1,-2,3,-1,0,-2,1,-1,-1,1,3,-1
KR_6650985055,420,0,46,-9,0,4,0,4,-4,4,0,0,2,2,-1,1,0,1,0,1,0,-8,-178,-3,-1,4,-2,0,0,1,-1,-1,1,2,-1
KR_6666785974,420,0,-2,-12,-3,-3,3,0,4,0,4,-4,5,1,-1,2,1,1,1,2,-1,0,-14,-3,-2,5,6,0,0,-1,-1,0,-1,2,-1
KR_6727428100,420,-3,-35,-16,-3,-1,1,0,2,0,2,-2,3,1,-3,3,0,1,1,2,0,-3,6,-4,-1,5,1,0,-1,-1,-1,-1,1,4,-1
KR_6711408653,420,2,18,-24,3,0,3,3,-2,3,1,1,2,3,5,1,6,-1,3,2,0,4,-14,0,-3,3,9,0,1,-1,-1,1,1,4,-1
KR_6697480670,420,-3,-55,-26,-13,1,1,2,3,2,5,-5,6,1,-8,8,0,-4,4,0,0,-6,6,0,-3,3,-1,0,-1,-1,-1,-1,-1,1,-1
KR_6685740357,420,0,41,22,2,0,3,3,0,2,2,0,2,2,0,2,2,2,0,2,0,-4,16,-1,-3,4,1,0,1,-1,1,1,1,5,-1
KR_6762091529,420,-3,-31,16,-9,-2,3,1,-1,3,2,0,0,0,-1,3,2,-5,5,0,1,-7,-265,2,-5,3,-1,0,-1,-1,-1,-1,1,3,-1
KR_6676913500,420,-2,-91,-8,-10,2,1,3,-4,4,0,-1,4,3,-7,7,0,0,2,2,0,-8,232,1,-2,1,-6,0,-2,-1,0,-1,-1,3,-1
KR_6694414888,420,-1,-77,2,-4,-3,5,2,0,2,2,-2,5,3,1,0,1,0,0,0,0,-6,-1,3,-4,1,-6,0,-4,-1,-1,-1,1,2,-1
KR_6762165042,420,-3,26,-46,2,3,0,3,-2,4,2,0,2,2,2,4,6,-1,2,1,1,2,-1,-4,-1,5,1,0,2,-1,1,1,1,6,-1
KR_6693048110,420,-2,33,-45,3,1,0,1,0,1,1,1,1,2,-1,2,1,2,0,2,-1,0,-6,-7,0,7,6,0,0,1,-1,0,-1,4,-1
KR_6699961178,420,-5,-114,-12,-6,-2,4,2,-4,5,1,3,2,5,-2,2,0,-1,2,1,1,0,-7,-4,-1,5,1,0,-1,-1,1,-1,1,2,-1
KR_6733821116,420,-4,-40,-31,-3,-4,4,0,-1,3,2,-1,4,3,2,0,2,1,0,1,0,5,6,2,-2,0,-2,0,-3,-1,-1,-1,1,4,-1
KR_6720319737,420,-5,-51,-2,-8,-4,7,3,-4,7,3,0,1,1,-1,4,3,1,1,2,2,-4,-4,-1,-2,3,4,0,-3,0,-1,-1,1,0,-1
KR_6761290617,420,-1,-76,-8,-6,-5,10,5,2,2,4,6,1,7,-5,6,1,-4,5,1,-2,-10,1,-2,0,2,0,0,-2,1,-1,-1,-1,3,-1
KR_6715844584,420,-3,-64,-4,-3,-6,7,1,1,1,2,0,1,1,2,0,2,0,0,0,0,5,-1,0,0,0,0,0,-1,-1,-1,-1,1,5,-1
KR_6727446507,420,2,-4,-8,-8,-2,3,1,3,0,3,-4,6,2,-3,5,2,-2,2,0,0,-8,-3,-1,-1,2,-1,0,0,1,-1,-1,1,6,-1
KR_6744872948,420,-2,-103,4,-8,-5,5,0,0,2,2,3,0,3,-4,4,0,-2,3,1,0,-8,6,-2,-5,7,0,0,-1,-1,-1,-1,-1,6,-1
KR_6646840119,420,-1,-10,16,-3,1,1,2,-6,7,1,-2,3,1,1,4,5,3,1,4,0,1,2,-2,-2,4,-3,0,0,0,-1,1,-1,0,-1
KR_6718585775,440,0,6,17,-3,-4,5,1,0,1,1,-1,5,4,1,1,2,1,1,2,1,-10,18,-6,-5,11,5,0,0,-1,1,1,1,3,-1
KR_6700945642,420,-1,-73,4,-10,-6,7,1,1,1,2,-2,3,1,-4,6,2,1,0,1,0,-8,-57,-6,-1,7,18,0,-1,-1,-1,-1,1,6,-1
KR_6763976134,420,2,6,-8,2,-5,6,1,1,3,4,2,1,3,2,1,3,2,0,2,0,7,-8,0,-2,2,3,0,1,1,1,1,1,5,-1
KR_6763253131,420,1,52,-8,-3,-2,2,0,-2,2,0,2,1,3,-1,1,0,0,0,0,0,-4,-278,-2,-1,3,1,0,0,1,-1,0,-1,3,-1
KR_6729671468,420,-2,29,-8,0,-3,3,0,1,0,1,5,0,5,-3,5,2,0,0,0,0,4,422,-4,-1,5,-4,0,-1,1,-1,-1,-1,4,-1
KR_6742296633,420,3,39,1,2,-1,3,2,1,3,4,-1,4,3,2,0,2,1,1,2,-1,-1,-6,5,-7,2,-1,0,0,1,-1,0,-1,1,-1
KR_6751144474,420,-5,-130,23,-14,-4,4,0,-2,4,2,-6,6,0,-2,3,1,0,2,2,0,-16,-10,2,-4,2,-1,0,-2,-1,-1,-1,-1,1,-1
KR_6762722799,420,0,5,32,-6,-1,1,0,-1,3,2,0,4,4,-1,5,4,-3,3,0,0,-7,-3,-5,-3,8,-4,0,-1,-1,-1,-1,-1,1,-1
KR_6762880595,420,-4,-24,8,-7,-1,1,0,-3,4,1,-2,7,5,-1,3,2,0,2,2,1,-8,1,2,-5,3,-4,0,0,1,0,0,1,2,-1
KR_6732676643,420,0,-104,-4,3,1,1,2,0,1,1,1,2,3,3,0,3,-2,2,0,0,7,-3,3,-4,1,-3,0,-1,1,1,-1,-1,3,-1
KR_6729837353,420,-3,30,32,-14,1,1,2,-4,5,1,-4,4,0,-6,6,0,-1,1,0,0,-12,-14,-4,-1,5,1,0,-1,-1,-1,-1,-1,5,-1
KR_6760132966,420,0,-14,-4,-2,2,1,3,-1,4,3,-3,5,2,-1,3,2,1,1,2,0,3,-7,2,-4,2,5,0,0,1,0,0,-1,2,-1
KR_6753944149,420,-4,-26,0,-8,1,0,1,-1,2,1,-5,6,1,2,2,4,-5,5,0,1,-8,13,2,-5,3,-6,0,0,-1,1,0,1,2,-1
KR_6751975849,420,-5,-125,-16,-10,-3,5,2,-3,3,0,1,2,3,-5,9,4,0,2,2,-2,-7,-11,5,-5,0,-2,0,-2,0,-1,-1,1,0,-1
KR_6760911776,440,-4,-36,-20,-6,-2,3,1,-4,4,0,1,0,1,0,2,2,-1,1,0,0,-4,-10,-4,-1,5,1,0,-1,-1,-1,-1,-1,4,-1
KR_6755479088,420,-1,-35,8,-7,-1,1,0,-3,4,1,0,1,1,-4,4,0,1,0,1,0,-8,-25,-1,-2,3,0,0,0,0,-1,0,-1,0,-1
KR_6702846399,420,-2,17,-22,-3,1,0,1,0,3,3,1,4,5,-6,6,0,1,2,3,0,-6,-8,1,-5,4,3,0,1,-1,1,1,-1,3,-1
KR_6715629232,420,-7,-62,-30,-11,-6,6,0,-2,3,1,-1,2,1,1,2,3,-3,3,0,0,-3,-97,1,-2,1,-1,0,-2,-1,-1,-1,-1,4,-1
KR_6619286624,420,-8,-84,-84,3,-1,3,2,3,2,5,-5,5,0,5,5,10,1,1,2,1,5,3,-6,-1,7,2,0,-4,-1,-1,-1,1,1,-1
KR_6706394577,420,-3,-12,-28,-9,-4,4,0,-2,2,0,-6,6,0,4,2,6,-1,1,0,1,2,-9,-5,0,5,3,0,-1,-1,-1,-1,1,2,-1
KR_6738209611,420,-6,-122,23,-17,-9,9,0,0,1,1,-2,3,1,-5,5,0,-1,1,0,0,-6,7,0,-3,3,-4,0,-2,1,-1,-1,-1,5,-1
KR_6722045669,420,-3,-30,-19,-3,-5,6,1,-2,4,2,-1,1,0,3,0,3,2,0,2,1,7,0,-3,-1,4,2,0,-1,-1,-1,-1,1,4,-1
KR_6712391945,420,-4,-47,-56,-14,-5,8,3,-1,2,1,-3,5,2,-4,5,1,-1,4,3,-3,-16,15,0,-1,1,0,0,-2,-1,-1,-1,-1,5,-1
KR_6753350980,420,-1,-44,-4,-3,-4,4,0,1,1,2,3,0,3,0,1,1,-3,4,1,0,-4,-9,1,-5,4,2,0,0,-1,1,0,-1,6,-1
KR_6731925232,440,-5,5,-35,-14,1,2,3,-6,7,1,-3,5,2,-3,4,1,-3,4,1,0,-14,-213,-2,-2,4,-3,0,-1,-1,-1,-1,-1,5,-1
KR_6713316173,420,1,-7,-25,2,2,0,2,2,0,2,-3,3,0,2,0,2,-1,1,0,0,6,44,3,-5,2,-20,0,0,1,-1,1,1,5,-1
KR_6744209264,420,-2,-69,-28,-2,-2,3,1,1,3,4,-1,2,1,-1,1,0,1,1,2,0,-2,0,2,-3,1,2,0,-2,-1,-1,-1,1,3,-1
KR_6749011108,420,-5,-108,-35,-9,-2,2,0,-2,4,2,1,0,1,1,0,1,-7,9,2,0,-7,-17,-3,0,3,3,0,-2,-1,-1,-1,1,5,-1
KR_6760863598,420,1,8,20,0,-6,6,0,0,3,3,3,0,3,4,2,6,-1,3,2,0,-1,2,-3,-1,4,-3,0,-1,1,1,-1,-1,2,-1
KR_6740507423,420,0,2,24,1,-1,2,1,4,3,7,0,2,2,-6,8,2,4,0,4,-1,4,14,3,-4,1,0,0,0,1,-1,-1,-1,5,-1
KR_6727095293,420,-7,-37,-7,-6,-3,4,1,-4,4,0,-2,2,0,1,2,3,2,0,2,0,-3,40,1,-3,2,-15,0,-2,-1,0,-1,-1,2,-1
KR_6760332434,420,-2,52,-4,-6,-2,2,0,2,5,7,-2,2,0,-4,4,0,0,3,3,0,-3,6,-2,-3,5,-5,0,1,-1,1,1,-1,2,-1
KR_6644857481,420,-4,-25,4,1,-3,4,1,3,1,4,2,0,2,0,0,0,-1,4,3,0,2,46,-2,-2,4,-14,0,-1,-1,1,-1,1,4,-1
KR_6747446091,420,2,-23,-8,1,0,0,0,0,6,6,6,0,6,-5,6,1,0,0,0,0,5,1,-1,-1,2,-2,0,0,-1,1,-1,-1,1,-1
KR_6714976034,420,0,49,-3,-3,2,1,3,-2,2,0,2,0,2,-2,3,1,-3,6,3,0,-1,-4,0,-4,4,-4,0,-1,1,1,-1,-1,3,-1
KR_6755732458,420,1,-1,-4,5,5,0,5,3,0,3,1,0,1,-2,2,0,-2,3,1,0,3,-4,-3,0,3,-1,0,0,-1,-1,1,1,4,-1
KR_6693910304,420,-6,-67,12,-18,0,1,1,-4,4,0,-5,5,0,-5,6,1,-4,5,1,0,-14,0,-3,-2,5,-1,0,-1,-1,-1,-1,-1,4,-1
KR_6629277205,420,-2,4,14,-7,-1,2,1,1,0,1,1,3,4,-7,9,2,-1,2,1,-1,-6,3,1,-3,2,0,0,-1,-1,1,-1,1,3,-1
KR_6747875589,440,1,43,28,4,0,1,1,0,1,1,0,3,3,-2,6,4,6,0,6,0,7,-7,4,-6,2,6,0,0,1,-1,0,1,3,-1
KR_6744079976,420,5,31,4,2,0,2,2,1,2,3,1,1,2,-1,6,5,1,2,3,-1,-1,0,1,-3,2,2,0,1,0,1,-1,1,0,-1
KR_6652044776,420,-1,-19,12,-3,0,0,0,-1,2,1,-3,3,0,1,0,1,0,1,1,0,0,6,-6,-4,10,0,0,-1,1,-1,-1,1,3,-1
KR_6761287003,420,-2,21,-2,-5,-4,5,1,-1,6,5,-1,4,3,2,2,4,-1,2,1,1,-1,-2,-5,0,5,2,0,0,1,-1,1,1,5,-1
KR_6651198179,420,0,-23,-9,2,0,2,2,2,3,5,-2,3,1,-1,3,2,3,2,5,0,10,-6,-1,-1,2,3,0,-2,0,0,-1,1,0,-1
KR_6755552597,420,-2,-34,0,-3,-2,4,2,1,1,2,-5,8,3,0,1,1,3,0,3,1,0,25,2,-6,4,-1,0,0,1,1,0,1,3,-1
KR_6763367179,420,-1,-2,-1,1,-2,3,1,0,2,2,2,1,3,1,0,1,0,0,0,0,6,11,1,-3,2,1,0,0,1,1,0,-1,6,-1
KR_6707617081,440,-2,-105,0,-13,-5,5,0,2,0,2,-2,4,2,-7,8,1,-1,3,2,0,-9,9,4,-4,0,0,0,-3,1,-1,-1,-1,5,-1
KR_6763034082,420,-1,-32,13,0,2,1,3,-2,3,1,-3,4,1,2,1,3,1,1,2,-1,4,4,1,-2,1,3,0,-1,-1,1,-1,-1,4,-1
KR_6667210593,420,-4,-94,21,-7,-2,3,1,0,0,0,-4,4,0,0,0,0,-1,2,1,0,0,-1,2,-5,3,0,0,0,1,-1,-1,-1,6,-1
KR_6749240147,440,-3,-52,-20,-6,-2,4,2,1,2,3,-6,6,0,0,4,4,1,2,3,0,-2,25,0,-3,3,0,0,-1,-1,1,-1,1,6,-1
KR_6744143266,420,0,19,9,-3,-1,2,1,-2,4,2,0,2,2,1,2,3,-1,1,0,0,-6,-28,3,-5,2,-2,0,2,-1,1,1,-1,4,-1
KR_6756355857,420,-1,60,8,-2,1,2,3,-3,5,2,6,0,6,-4,5,1,-2,2,0,0,-10,362,1,-2,1,-18,0,1,0,1,1,1,0,-1
KR_6761120050,440,-6,-125,-26,-7,-1,2,1,-1,5,4,-2,3,1,-5,6,1,2,1,3,0,1,20,4,-5,1,-1,0,-2,1,-1,-1,1,2,-1
KR_6631747997,420,0,61,-12,-3,5,3,8,-4,4,0,-6,11,5,3,0,3,-1,3,2,0,-8,10,-5,-1,6,0,0,1,1,-1,1,1,1,-1
KR_6684938803,420,-1,-16,4,0,1,2,3,0,1,1,-1,2,1,-2,4,2,2,0,2,0,-3,-7,-4,-1,5,1,0,1,-1,1,-1,1,1,-1
KR_6685956564,440,-4,-18,-12,-6,-1,4,3,2,3,5,-5,5,0,2,1,3,-4,5,1,0,-14,-16,1,-3,2,-5,0,0,1,-1,0,-1,3,-1
KR_6738521809,420,-6,-124,20,-16,-6,8,2,-3,3,0,-6,7,1,1,2,3,-2,3,1,0,-13,1,-4,0,4,2,0,-1,-1,1,-1,-1,2,-1
KR_6654454299,420,-1,-19,-8,-2,5,0,5,0,4,4,-3,4,1,-4,7,3,0,1,1,0,-4,-219,-4,0,4,0,0,0,-1,1,1,1,1,-1
KR_6699000060,420,0,45,-17,2,-2,2,0,1,0,1,-2,4,2,5,0,5,0,1,1,0,2,-4,1,-5,4,4,0,-1,1,1,-1,1,4,-1
KR_6699918675,420,0,-16,16,-4,3,1,4,3,0,3,-3,7,4,-6,7,1,-1,2,1,0,-12,-3,-1,-3,4,-1,0,0,-1,1,-1,-1,2,-1
KR_6753974347,440,-4,-10,4,-1,0,1,1,2,0,2,-3,6,3,-3,5,2,3,2,5,0,2,1,-1,-1,2,-1,0,-1,1,0,-1,1,1,-1
KR_6757173983,420,-2,-34,-9,-3,1,1,2,-4,4,0,3,1,4,-3,4,1,0,2,2,-1,-2,-14,-4,-3,7,3,0,1,1,-1,1,-1,5,-1
KR_6748497017,420,-1,-63,8,-3,2,3,5,-4,6,2,3,1,4,-4,4,0,0,3,3,1,-7,-2,-4,-2,6,1,0,-1,-1,0,-1,1,4,-1
KR_6655118145,420,-1,-77,-24,3,-3,3,0,5,6,11,1,1,2,-1,6,5,1,0,1,1,0,7,5,-8,3,-2,0,0,1,1,-1,1,4,-1
KR_6759536123,420,-5,-8,12,-6,3,0,3,2,2,4,-8,9,1,-3,5,2,0,1,1,3,5,5,-5,-2,7,-4,0,-2,1,-1,-1,1,3,-1
KR_6759766985,420,-1,-97,-32,-12,-1,2,1,-3,3,0,-3,3,0,-3,3,0,-2,3,1,0,-7,-207,-6,-1,7,2,0,-2,-1,-1,-1,-1,1,-1
KR_6754778843,420,-2,-56,-29,-8,3,0,3,-3,5,2,-3,6,3,-5,6,1,0,0,0,0,-1,0,2,-2,0,3,0,-2,-1,-1,-1,-1,5,-1
KR_6731160243,420,-2,-5,4,-1,-1,1,0,-1,2,1,1,1,2,1,0,1,-1,1,0,0,-2,3,0,-2,2,2,0,1,1,1,1,1,3,-1
KR_6754990550,420,-4,33,-92,9,5,1,6,-3,3,0,10,0,10,-2,2,0,-1,1,0,0,-6,-22,-2,0,2,2,0,-1,-1,-1,-1,1,6,-1
KR_6755486529,420,-2,25,-17,-5,-1,2,1,0,1,1,0,1,1,-2,3,1,-2,2,0,-1,-8,44,-3,-3,6,-31,0,0,-1,0,1,-1,2,-1
KR_6730384043,440,0,29,-20,-1,0,1,1,-1,1,0,2,0,2,-2,5,3,0,0,0,1,-2,-9,-4,0,4,3,0,0,-1,0,0,1,4,-1
KR_6747172628,420,-1,-18,-18,-7,-6,7,1,1,1,2,3,3,6,-3,4,1,-2,3,1,0,1,11,-1,-3,4,-1,0,0,1,-1,-1,-1,4,-1
KR_6749741549,420,-2,-59,-30,2,-4,6,2,-1,2,1,-2,3,1,9,1,10,0,1,1,0,8,6,0,-2,2,-1,0,-1,1,-1,-1,1,3,-1
KR_6743840495,440,-3,-18,-2,-5,1,1,2,-4,5,1,-1,3,2,0,3,3,-1,2,1,0,-3,124,-4,-2,6,1,0,0,-1,-1,0,-1,4,-1
KR_6762595962,420,-6,-102,23,-17,-5,6,1,-5,6,1,-4,5,1,0,1,1,-3,4,1,0,-15,2,-1,0,1,-1,0,-4,-1,-1,-1,-1,5,-1
KR_6730787054,440,-4,-108,-16,-3,-6,7,1,2,3,5,0,4,4,-4,5,1,5,0,5,-1,0,55,-2,0,2,-12,0,-1,-1,0,-1,-1,5,-1
KR_6760451257,420,0,25,14,-7,-2,5,3,4,0,4,-2,5,3,-6,9,3,-1,2,1,0,-18,-1,-1,-2,3,-3,0,1,-1,-1,1,-1,4,-1
KR_6695715057,420,1,48,21,-1,1,4,5,-4,4,0,-1,2,1,4,0,4,-1,1,0,0,-3,9,2,-5,3,0,0,0,1,-1,-1,-1,1,-1
KR_6749061341,420,-6,-40,-52,-12,-7,8,1,-1,3,2,1,0,1,-5,6,1,0,2,2,-1,-7,-7,-7,-2,9,0,0,-2,-1,-1,-1,-1,5,-1
KR_6651049912,420,-2,3,-4,-3,1,0,1,-2,3,1,-4,4,0,3,2,5,-1,2,1,0,0,33,4,-6,2,-3,0,0,1,1,1,-1,2,-1
KR_6720706159,420,-2,10,-20,-12,-2,2,0,-2,2,0,-3,6,3,-3,5,2,-2,4,2,0,-11,139,1,-1,0,0,0,0,-1,0,-1,-1,6,-1
KR_6724472949,440,-4,-26,-5,-4,0,0,0,-1,1,0,0,0,0,-1,1,0,-2,2,0,0,-6,20,1,-6,5,-3,0,-1,-1,1,-1,-1,6,-1
KR_6704934928,420,-1,-16,-3,-8,0,0,0,-3,5,2,-1,2,1,-1,3,2,-3,3,0,-2,-11,37,0,-4,4,-33,0,1,-1,0,1,-1,4,-1
KR_6629766042,420,-1,-8,-16,-1,2,1,3,-2,2,0,-1,3,2,-1,3,2,1,2,3,0,-3,7,-5,-1,6,4,0,-1,-1,-1,-1,-1,2,-1
KR_6736721001,420,-4,-41,-40,-5,-1,3,2,2,3,5,-5,7,2,-1,3,2,0,0,0,0,-3,-5,0,-5,5,-1,0,0,-1,-1,0,-1,4,-1
KR_6667410819,420,-3,-108,24,-3,-6,6,0,1,1,2,7,1,8,-4,8,4,-1,1,0,0,-3,23,0,-6,6,-1,0,-2,-1,1,-1,-1,3,-1
KR_6755569594,420,0,14,-12,1,0,0,0,-1,4,3,-2,3,1,5,0,5,-1,1,0,0,5,-5,2,-4,2,4,0,1,1,-1,1,-1,5,-1
KR_6728589713,420,0,-11,-42,2,1,0,1,-3,4,1,0,1,1,2,1,3,2,1,3,0,5,29,1,-5,4,-27,0,-1,-1,0,-1,-1,3,-1
KR_6761236495,420,4,11,48,1,1,1,2,-1,3,2,5,2,7,-4,5,1,0,0,0,0,-5,17,4,-7,3,1,0,0,1,1,1,1,5,-1
KR_6715378299,420,-8,-168,-35,-20,-7,9,2,0,0,0,-4,6,2,-8,8,0,-1,1,0,0,-10,-9,1,-4,3,-2,0,-6,-1,0,-1,-1,3,-1
KR_6752909609,420,1,-6,28,-1,3,1,4,5,2,7,-2,3,1,-4,5,1,-3,6,3,-3,-2,2,6,-8,2,3,0,-1,1,-1,-1,-1,2,-1
KR_6756525680,420,2,87,36,0,3,2,5,0,2,2,2,3,5,-4,6,2,-1,3,2,0,-3,-5,-2,-1,3,-2,0,1,-1,1,1,-1,1,-1
KR_6671130968,420,1,-26,28,-2,2,2,4,-3,5,2,5,2,7,-8,10,2,2,0,2,0,2,190,-5,-3,8,4,0,0,1,1,-1,1,5,-1
KR_6670111376,420,0,30,-30,-4,2,1,3,0,1,1,-9,11,2,2,0,2,1,0,1,2,2,35,7,-9,2,-3,0,-1,0,-1,-1,-1,0,-1
KR_6731717667,420,0,37,0,-2,3,0,3,0,1,1,-4,6,2,-1,4,3,0,0,0,0,3,418,2,-2,0,2,0,-1,1,-1,-1,1,4,-1
KR_6759708844,440,-2,46,4,1,2,1,3,-3,5,2,-1,3,2,2,0,2,1,3,4,0,-6,-6,-3,0,3,-1,0,0,-1,-1,0,1,1,-1
KR_6749895418,420,-2,-52,20,-8,1,1,2,-3,3,0,-4,4,0,1,0,1,-3,3,0,0,-12,-153,1,-3,2,3,0,-1,1,-1,1,-1,5,-1
KR_6762954478,420,-3,-95,-36,-5,-3,4,1,-2,3,1,1,2,3,2,3,5,-3,4,1,0,-6,0,-5,-3,8,-3,0,-2,0,-1,-1,-1,0,-1
KR_6753784615,420,-1,87,-28,3,2,0,2,-6,7,1,-2,2,0,8,0,8,1,0,1,0,8,36,2,-5,3,-29,0,1,1,-1,1,1,3,-1
KR_6762673186,420,-7,-65,0,-8,1,1,2,-2,3,1,-1,2,1,-5,5,0,-1,1,0,0,-6,-14,-3,0,3,0,0,-2,1,1,-1,-1,2,-1
KR_6736631703,420,1,69,15,4,4,1,5,1,0,1,-1,3,2,2,0,2,-2,2,0,0,2,-21,0,-5,5,-2,0,0,-1,-1,1,1,1,-1
KR_6697063146,420,-2,-39,-32,-5,-2,2,0,1,2,3,-4,4,0,-2,3,1,2,0,2,0,-2,399,1,-4,3,2,0,0,1,-1,0,-1,3,-1
KR_6719039234,420,2,12,28,7,4,1,5,-4,4,0,4,1,5,5,0,5,-2,2,0,0,9,-156,-2,-1,3,-2,0,1,-1,1,1,1,1,-1
KR_6762855976,420,0,8,8,-2,1,1,2,1,2,3,-7,9,2,1,1,2,2,0,2,0,4,9,-2,0,2,1,0,0,1,-1,1,-1,3,-1
KR_6751381581,440,-3,-3,-28,-4,2,3,5,-5,5,0,1,1,2,0,3,3,-2,3,1,0,-5,4,2,-2,0,-1,0,-1,-1,-1,-1,1,5,-1
KR_6673237230,420,-4,-40,-16,-8,-1,4,3,-1,3,2,-1,2,1,-2,3,1,-3,4,1,0,-8,-6,0,-5,5,-6,0,-2,-1,-1,-1,-1,4,-1
KR_6746574502,420,-7,-53,3,-14,-5,5,0,-2,3,1,-7,10,3,0,1,1,0,1,1,0,-9,-16,0,-4,4,1,0,-1,1,-1,-1,-1,2,-1
KR_6752711266,420,-4,-71,16,-6,-4,4,0,-3,4,1,-3,4,1,5,2,7,-1,2,1,0,-1,14,6,-6,0,-2,0,-2,1,-1,-1,-1,2,-1
KR_6694808988,420,-1,-32,-2,-2,2,3,5,0,3,3,-1,2,1,-1,3,2,-2,2,0,0,-7,-2,-3,-1,4,2,0,0,-1,0,0,1,6,-1
KR_6734208380,420,-2,-15,-8,-1,1,3,4,-2,5,3,-2,4,2,2,1,3,0,2,2,1,3,255,1,-2,1,23,0,0,0,0,0,1,0,-1
KR_6762452053,420,-1,-50,-13,-6,-2,4,2,-3,4,1,-1,1,0,-2,3,1,2,1,3,0,-4,4,-2,-1,3,-1,0,0,-1,1,0,-1,3,-1
KR_6761313490,440,0,-13,-12,-2,-3,4,1,2,2,4,1,3,4,-1,1,0,-1,1,0,0,-1,5,1,-4,3,-2,0,0,-1,-1,-1,-1,4,-1
KR_6656987363,420,-2,-107,44,-7,-2,2,0,1,0,1,-1,4,3,-3,4,1,-2,2,0,-1,-7,-201,-3,-1,4,-3,0,-3,-1,-1,-1,-1,4,-1
KR_6732789802,420,-6,-67,-30,-15,-5,5,0,-6,7,1,-1,1,0,-4,5,1,1,1,2,0,-4,-76,0,-1,1,-4,0,-3,-1,-1,-1,-1,6,-1
KR_6757354153,420,0,-61,16,3,-1,5,4,7,1,8,3,0,3,-4,6,2,-2,3,1,0,2,-4,1,-2,1,-1,0,-1,-1,1,-1,-1,2,-1
KR_6750988011,440,-2,-7,-36,-7,0,3,3,-3,8,5,0,4,4,-5,7,2,1,1,2,-1,-5,-16,-1,-3,4,4,0,-1,-1,0,-1,-1,3,-1
KR_6696531339,420,0,-39,28,1,0,2,2,2,1,3,-4,4,0,3,2,5,0,2,2,0,2,-6,-2,-3,5,-3,0,-2,-1,-1,-1,1,2,-1
KR_6697279517,420,4,-17,8,15,1,0,1,4,2,6,1,1,2,8,4,12,1,0,1,0,18,3,0,-3,3,3,0,2,1,1,1,1,2,-1
KR_6749132829,420,-1,10,7,1,1,1,2,-4,4,0,-1,3,2,3,1,4,2,1,3,0,1,8,0,-2,2,1,0,0,-1,-1,0,1,2,-1
KR_6759402296,440,-4,-60,12,-2,-1,4,3,-2,4,2,1,4,5,-1,3,2,1,0,1,0,-3,-3,0,-2,2,-3,0,-1,1,-1,-1,1,1,-1
KR_6750672631,420,-4,-24,-28,-23,-2,3,1,-4,5,1,0,3,3,-12,14,2,-5,5,0,0,-11,2,-1,-1,2,-2,0,-1,-1,1,-1,1,2,-1
KR_6647157582,420,2,36,5,12,6,0,6,6,1,7,1,5,6,0,6,6,-1,4,3,0,6,-210,3,-3,0,-2,0,0,1,1,0,1,6,-1
KR_6700005074,420,-3,-55,29,0,2,0,2,0,2,2,-2,4,2,0,1,1,0,0,0,2,0,208,1,-2,1,-1,0,1,1,1,1,1,2,-1
KR_6744735686,420,0,105,-13,-2,0,1,1,-5,6,1,-1,6,5,0,1,1,4,0,4,0,0,-30,-1,-3,4,-2,0,0,-1,1,1,1,6,-1
KR_6687165312,420,-2,-38,2,-9,-6,6,0,-1,5,4,1,2,3,0,3,3,-3,4,1,0,-10,-5,2,-2,0,-2,0,1,-1,1,-1,-1,2,-1
KR_6763019871,420,-2,-27,-16,-4,-1,1,0,-2,4,2,3,0,3,-5,6,1,1,2,3,0,-6,26,0,-3,3,0,0,0,0,0,0,-1,0,-1
KR_6758298666,420,0,-41,16,-2,0,0,0,-7,8,1,0,2,2,3,0,3,2,0,2,0,-3,48,-3,-3,6,2,0,2,-1,-1,1,1,3,-1
KR_6732472543,420,-1,58,-19,0,-2,7,5,1,1,2,0,2,2,1,3,4,0,1,1,0,3,-4,-3,-2,5,0,0,1,1,0,1,-1,5,-1
KR_6744955466,440,0,7,-36,-1,-4,4,0,0,2,2,6,1,7,-6,8,2,3,0,3,-1,-8,-1,-1,-3,4,2,0,1,-1,1,1,-1,6,-1
KR_6757613873,420,0,20,56,-11,-2,4,2,-6,6,0,5,1,6,-5,6,1,-3,3,0,0,-11,-140,-4,-1,5,0,0,0,-1,-1,0,-1,1,-1
KR_6740986477,420,-2,-28,8,-4,1,3,4,2,0,2,-3,3,0,-1,2,1,-3,4,1,0,-2,-401,-1,-1,2,-1,0,-1,-1,-1,-1,-1,5,-1
KR_6763484690,420,1,36,21,6,-1,1,0,9,1,10,-2,2,0,-1,3,2,1,1,2,0,9,-14,-2,-3,5,4,0,0,1,0,0,-1,2,-1
KR_6692991005,420,-2,-61,-17,2,0,1,1,-2,4,2,-4,5,1,6,2,8,2,2,4,0,8,-25,-1,-3,4,8,0,-2,-1,-1,-1,1,1,-1
KR_6740922226,420,2,18,-4,7,-1,4,3,0,4,4,4,0,4,5,1,6,-1,2,1,1,8,-274,0,-1,1,-1,0,0,1,1,1,1,3,-1
KR_6748519832,420,-8,-97,-4,-8,0,2,2,3,1,4,-5,5,0,-4,4,0,-2,4,2,0,-13,-12,0,-2,2,1,0,-1,-1,1,-1,-1,6,-1
KR_6655057725,420,-2,19,35,-8,0,1,1,-1,3,2,-6,9,3,-1,1,0,0,1,1,0,-8,3,5,-6,1,-2,0,0,-1,1,0,-1,4,-1
KR_6735482101,420,-3,-8,-26,-6,5,0,5,1,2,3,-6,6,0,-4,4,0,-2,2,0,0,-7,-2,3,-6,3,-2,0,-1,-1,-1,-1,1,2,-1
KR_6749136344,440,-2,-51,15,-6,-2,4,2,-1,11,10,-1,2,1,-2,2,0,0,0,0,0,-5,-5,1,-5,4,5,0,-1,1,-1,-1,1,5,-1
KR_6653706524,420,-4,99,-95,-3,3,2,5,0,1,1,-1,1,0,-5,7,2,0,2,2,0,-8,1,1,-3,2,-2,0,-1,0,-1,-1,-1,0,-1
KR_6761348038,420,2,46,-18,2,2,0,2,-2,3,1,4,1,5,-2,3,1,0,3,3,-2,-7,-11,7,-7,0,-1,0,0,-1,1,0,-1,1,-1
KR_6737029724,440,5,41,-16,16,6,1,7,3,1,4,4,1,5,3,2,5,0,0,0,1,15,38,4,-4,0,-1,0,0,-1,-1,0,1,1,-1
KR_6740729626,420,-6,22,-9,-21,-2,2,0,-7,8,1,-5,5,0,-5,7,2,-2,5,3,-3,-13,-24,-5,-1,6,2,0,-1,-1,-1,-1,-1,6,-1
KR_6746729731,420,-2,-30,4,-8,-3,3,0,-1,4,3,-3,3,0,3,1,4,-4,5,1,1,1,-19,2,-3,1,2,0,-2,-1,-1,-1,1,6,-1
KR_6730867652,420,-4,-121,-4,1,3,1,4,4,1,5,-2,3,1,-3,5,2,-1,1,0,0,-4,-6,5,-5,0,1,0,-1,-1,1,-1,1,3,-1
KR_6647891609,420,-2,5,-30,-4,4,0,4,-4,5,1,0,0,0,0,1,1,-4,4,0,0,-7,44,5,-8,3,-39,0,0,1,1,0,-1,4,-1
KR_6757204666,420,-4,-123,-26,-5,0,1,1,-1,2,1,-1,3,2,-2,4,2,-1,2,1,0,-4,6,5,-9,4,-2,0,-2,1,0,-1,-1,2,-1
KR_6753556640,420,1,15,4,1,1,2,3,-4,5,1,1,0,1,3,1,4,0,0,0,0,3,-13,2,-4,2,1,0,-1,-1,-1,-1,1,2,-1
KR_6743356757,440,-7,-155,-12,-22,-6,9,3,-3,4,1,-4,6,2,-6,8,2,-3,3,0,0,-8,21,-2,-2,4,-5,-1,-3,-1,1,-1,-1,5,-1
KR_6654059637,420,-4,-25,-22,-8,-5,5,0,-1,4,3,3,1,4,-3,3,0,-2,3,1,0,-10,-357,1,-2,1,-2,0,0,1,0,-1,1,2,-1
KR_6752303202,420,-2,-44,-28,-2,-3,5,2,-1,1,0,8,1,9,-7,7,0,1,0,1,-2,-6,4,0,-4,4,-2,0,-2,-1,1,-1,-1,5,-1
KR_6703980405,420,-4,-82,-8,-8,3,3,6,-4,4,0,-3,4,1,-1,2,1,-3,3,0,0,-13,-7,-5,0,5,-2,0,-1,0,0,-1,1,0,-1
KR_6635786828,420,-3,-49,-28,-1,0,1,1,5,0,5,-12,12,0,2,1,3,4,2,6,0,7,-703,-3,-2,5,0,0,-1,1,-1,-1,-1,6,-1
KR_6732292946,420,-9,-113,-16,-18,-9,9,0,-2,3,1,-7,7,0,-2,4,2,2,0,2,0,-11,-286,-4,0,4,-1,0,-3,1,-1,-1,-1,5,-1
KR_6761648958,420,-4,-85,-44,-7,-3,5,2,-7,8,1,-5,5,0,7,1,8,1,2,3,-2,-6,195,-3,-4,7,-1,0,-2,1,-1,-1,-1,6,-1
KR_6762847052,420,-5,-23,-4,-14,-3,5,2,-7,8,1,-2,4,2,-3,3,0,1,1,2,0,-10,-248,-3,-1,4,0,0,-1,-1,-1,-1,-1,1,-1
KR_6764181263,420,-3,-86,-24,-7,-3,3,0,-2,4,2,-1,4,3,-1,4,3,0,2,2,-1,-3,-36,-2,-1,3,17,0,-2,1,-1,-1,-1,3,-1
KR_6740183440,420,2,-31,-24,-2,1,1,2,-5,10,5,2,1,3,2,1,3,-2,2,0,0,-10,306,-2,-2,4,-1,0,0,1,0,0,1,3,-1
KR_6714288073,420,-1,-12,-2,-9,-2,4,2,-1,5,4,-4,6,2,-2,4,2,0,0,0,0,-12,284,4,-4,0,-2,0,0,-1,0,-1,-1,2,-1
KR_6755227566,420,0,-20,7,7,9,0,9,-1,1,0,-3,7,4,1,1,2,1,1,2,0,0,0,0,-2,2,0,0,0,0,0,0,1,0,-1
KR_6756523193,420,-1,-31,-24,-5,-3,3,0,-2,3,1,2,0,2,-2,5,3,0,1,1,0,-8,-3,1,-2,1,3,0,-1,-1,-1,-1,-1,4,-1
KR_6642865097,420,-4,-46,13,-14,-3,6,3,-1,2,1,-4,5,1,-4,5,1,-2,2,0,-1,-7,7,4,-4,0,-2,0,-2,0,0,-1,-1,0,-1
KR_6636241501,420,-6,-129,-53,-11,1,3,4,-6,6,0,-4,8,4,-2,3,1,0,0,0,-3,-13,-8,4,-6,2,-2,0,0,-1,1,-1,-1,1,-1
KR_6743628727,420,0,-11,8,-1,2,1,3,-1,2,1,-7,9,2,5,1,6,0,2,2,0,0,9,-3,-1,4,2,0,0,0,0,1,1,0,-1
KR_6705264106,420,3,-58,24,-1,-1,1,0,1,3,4,1,1,2,-1,2,1,-1,1,0,-1,0,5,4,-4,0,0,0,1,1,1,1,-1,2,-1
KR_6646156644,420,-4,-47,-26,-7,-3,3,0,-1,3,2,-5,5,0,2,1,3,0,2,2,0,-3,10,-3,-2,5,1,0,-1,1,-1,-1,1,6,-1
KR_6726321216,420,-3,-82,-32,-8,-1,2,1,0,3,3,-2,5,3,-4,5,1,-1,2,1,0,-3,-7,0,-2,2,-1,0,0,-1,0,-1,-1,3,-1
KR_6649969488,420,-3,-44,-13,-11,-2,2,0,-3,5,2,-5,5,0,-1,3,2,0,3,3,-2,-5,3,2,-3,1,1,0,0,-1,1,-1,-1,3,-1
KR_6760665573,440,-3,31,8,-4,-4,4,0,0,3,3,-1,2,1,0,1,1,1,0,1,0,4,8,-2,-4,6,1,0,1,1,-1,-1,-1,3,-1
KR_6763245181,420,2,41,30,9,2,3,5,0,1,1,2,2,4,1,1,2,4,1,5,1,5,-7,0,-3,3,-1,0,2,-1,0,1,1,3,-1
KR_6640926847,420,-1,-78,4,-8,-4,5,1,1,2,3,-8,12,4,0,1,1,3,1,4,-1,1,-109,-1,-3,4,-1,0,-1,-1,-1,-1,-1,6,-1
KR_6753353344,420,0,0,-19,1,-1,3,2,1,4,5,-3,4,1,2,0,2,2,0,2,0,6,16,-1,-3,4,-8,0,1,1,-1,1,-1,6,-1
KR_6675195035,420,-6,-64,-28,-13,-4,4,0,1,1,2,-4,6,2,-3,4,1,-3,4,1,0,-16,10,-3,-1,4,-1,0,-3,-1,-1,-1,-1,6,-1
KR_6737904192,420,-4,-49,-9,-13,3,1,4,-2,2,0,-1,3,2,-10,10,0,-3,3,0,-2,-14,8,1,-1,0,1,0,-1,-1,-1,-1,-1,4,-1
KR_6739488998,440,-1,-20,-13,-1,8,1,9,0,0,0,-7,7,0,-2,3,1,0,2,2,0,-4,0,0,-3,3,-1,0,2,-1,1,1,-1,5,-1
KR_6740946789,420,1,78,16,4,-4,5,1,2,1,3,1,0,1,3,1,4,2,1,3,0,8,-55,-3,0,3,2,0,0,1,-1,-1,-1,5,-1
KR_6762013294,420,-2,7,-16,-6,-2,2,0,-2,3,1,0,2,2,-2,5,3,0,0,0,0,-10,1,0,-2,2,-1,0,-1,0,-1,-1,-1,0,-1
KR_6762659544,440,0,3,8,-3,-1,1,0,0,1,1,-6,7,1,4,0,4,0,0,0,-1,2,206,-2,-3,5,-2,0,0,1,-1,0,-1,1,-1
KR_6663260169,420,-1,-43,-9,-2,-1,4,3,1,3,4,-1,3,2,-2,4,2,1,0,1,0,1,-4,-2,-2,4,0,0,-2,-1,-1,-1,-1,4,-1
KR_6752065168,420,-1,-31,-6,-4,0,0,0,-1,2,1,-13,14,1,7,1,8,3,0,3,0,0,-7,-3,-3,6,-3,0,-1,-1,-1,-1,1,1,-1
KR_6743865547,420,1,-30,74,2,4,0,4,0,0,0,0,3,3,1,1,2,-3,3,0,1,-4,-8,3,-3,0,-1,0,1,0,0,1,1,0,-1
KR_6661677110,420,-1,2,-20,-3,-1,3,2,3,3,6,-1,3,2,-1,2,1,-3,5,2,0,-3,-4,-5,0,5,7,0,0,-1,-1,0,1,5,-1
KR_6764005207,420,-3,-10,-24,-4,1,1,2,2,2,4,-6,7,1,0,4,4,-1,1,0,0,0,-26,0,-4,4,1,0,0,-1,1,-1,-1,2,-1
KR_6697735027,420,-3,-32,-22,-12,-2,3,1,-1,2,1,-1,3,2,-7,7,0,-1,1,0,0,-12,-4,-1,-2,3,0,0,-2,1,-1,-1,-1,3,-1
KR_6736957000,420,-1,-90,20,-12,2,6,8,-8,8,0,-3,3,0,-5,6,1,2,2,4,-1,-11,-11,-1,0,1,-1,0,-2,1,1,-1,-1,5,-1
KR_6710811539,420,-2,44,-19,-2,1,2,3,0,1,1,-1,2,1,-2,3,1,0,1,1,0,-2,-9,1,-2,1,-1,0,0,1,0,1,-1,3,-1
KR_6737855398,420,-1,-54,-1,-2,-1,5,4,-2,6,4,0,2,2,0,2,2,1,2,3,0,-2,2,1,-1,0,-1,0,-1,1,1,-1,-1,6,-1
KR_6762068972,420,-2,11,-17,-6,2,1,3,-3,3,0,-2,6,4,0,1,1,-3,3,0,0,-3,5,1,-4,3,3,0,0,-1,1,0,-1,2,-1
KR_6730066658,420,-2,-58,20,-9,-4,4,0,1,1,2,-2,5,3,-5,5,0,1,0,1,0,-10,-115,1,-2,1,1,0,-2,-1,-1,-1,1,1,-1
KR_6691381107,420,-8,-81,-44,-13,-3,5,2,-1,2,1,0,3,3,-3,3,0,-6,7,1,-1,-14,-27,0,-3,3,-1,0,-3,1,-1,-1,-1,4,-1
KR_6693574574,420,5,49,39,7,5,0,5,4,1,5,3,1,4,-6,7,1,1,2,3,1,0,-35,-2,-2,4,20,0,1,0,0,1,1,0,-1
KR_6645322301,420,0,0,3,0,1,1,2,5,2,7,2,1,3,-9,10,1,1,1,2,0,1,9,-2,-1,3,2,0,2,-1,1,1,-1,4,-1
KR_6728300633,420,-3,-88,-3,-1,2,1,3,-3,6,3,4,0,4,-1,2,1,-3,3,0,1,1,0,-1,0,1,0,0,-1,-1,-1,-1,1,6,-1
KR_6752536053,420,-3,-27,7,-3,4,0,4,-1,3,2,2,1,3,-8,9,1,0,1,1,1,-10,-186,-3,0,3,-2,0,-2,-1,-1,-1,1,2,-1
KR_6740786532,420,-2,-32,-35,1,3,1,4,-2,2,0,2,2,4,-1,1,0,-1,1,0,1,-2,-11,1,-3,2,-2,0,-1,0,-1,-1,1,0,-1
KR_6717263961,420,-3,31,-6,-9,-2,3,1,-5,5,0,0,1,1,-4,6,2,2,0,2,0,-7,-2,1,-2,1,-2,0,0,1,-1,0,1,3,-1
KR_6750624592,420,-5,-42,-8,-21,1,1,2,-5,5,0,-2,4,2,-13,14,1,-2,3,1,-2,-25,0,1,-2,1,-2,0,-1,-1,0,-1,-1,5,-1
KR_6752011938,420,-2,-33,-12,-11,-1,2,1,0,2,2,-3,5,2,-4,5,1,-3,6,3,0,-8,14,1,-3,2,-5,0,-2,-1,-1,-1,-1,2,-1
KR_6717047250,420,2,5,8,6,1,2,3,0,3,3,2,1,3,2,1,3,1,0,1,-1,5,3,2,-2,0,4,0,1,1,-1,1,-1,2,-1
KR_6675988168,420,-2,-21,14,-5,-3,3,0,0,1,1,-2,4,2,0,2,2,0,0,0,0,1,-134,-2,-2,4,3,0,0,-1,-1,-1,1,5,-1
KR_6749250475,420,-1,-76,-19,0,0,0,0,3,1,4,-1,4,3,-2,5,3,0,0,0,0,4,2,2,-3,1,-3,0,0,-1,-1,0,-1,2,-1
KR_6697964542,420,-2,-10,36,-1,0,2,2,-2,2,0,-4,5,1,4,2,6,1,1,2,0,0,-20,0,-1,1,2,0,0,0,1,1,-1,0,-1
KR_6663683085,420,-4,16,2,-9,-1,2,1,-5,9,4,-3,3,0,0,3,3,0,0,0,0,-15,-225,-2,-2,4,1,0,0,-1,0,0,1,1,-1
KR_6762599439,420,-4,-1,-40,-2,-5,6,1,1,3,4,0,1,1,2,3,5,0,0,0,0,4,-77,0,-2,2,-24,0,0,1,-1,-1,-1,1,-1
KR_6724213309,420,1,-6,0,4,0,1,1,-3,3,0,-1,1,0,9,1,10,-1,2,1,0,10,17,-3,-1,4,4,0,0,1,-1,0,1,5,-1
KR_6756011942,420,-4,-63,-26,-8,0,1,1,0,4,4,-7,7,0,-2,4,2,1,2,3,0,-6,70,2,-3,1,2,0,-1,-1,0,-1,-1,2,-1
KR_6723810923,440,1,-10,-19,1,-2,3,1,-2,3,1,0,1,1,3,1,4,2,0,2,1,3,-11,0,0,0,4,0,1,-1,-1,-1,1,1,-1
KR_6763088427,420,-3,-48,-12,-6,-5,5,0,-3,3,0,0,2,2,2,1,3,0,0,0,0,-3,-108,1,-2,1,-1,0,-3,1,1,-1,-1,4,-1
KR_6684670611,420,-6,-147,0,-18,-4,4,0,-3,3,0,-3,5,2,-8,9,1,0,0,0,-1,-13,-5,-4,-1,5,2,0,-4,-1,-1,-1,-1,6,-1
KR_6627689578,420,0,-51,-17,10,-2,2,0,4,1,5,-1,5,4,4,0,4,5,0,5,2,22,13,-3,-3,6,4,0,0,1,1,-1,1,5,-1
KR_6737307581,420,-2,-16,0,3,-4,4,0,6,0,6,1,0,1,0,3,3,0,0,0,0,5,67,-2,-1,3,19,0,-1,-1,-1,-1,-1,3,-1
KR_6760678676,420,0,49,0,1,-1,2,1,0,1,1,-2,3,1,2,0,2,2,0,2,0,-2,3,2,-5,3,6,0,0,-1,1,0,1,3,-1
KR_6695959789,420,3,25,13,12,3,2,5,4,1,5,3,2,5,2,1,3,0,1,1,0,15,187,-2,-2,4,1,0,1,1,1,1,1,2,-1
KR_6624401575,420,-5,-41,-22,-11,-2,2,0,0,5,5,-3,4,1,-5,5,0,-1,2,1,0,-14,-10,1,-3,2,1,0,0,1,1,-1,1,2,-1
KR_6752233239,420,-4,-101,3,-1,-4,5,1,1,0,1,0,2,2,2,1,3,0,1,1,0,1,29,2,-2,0,-10,0,-1,0,0,-1,1,0,-1
KR_6752523874,420,-9,-114,-56,-8,-3,4,1,-1,1,0,-2,3,1,0,2,2,-2,2,0,0,-7,4,2,-3,1,-2,-1,-4,-1,-1,-1,-1,3,-1
KR_6733918713,420,2,-2,2,-2,5,0,5,1,0,1,-2,2,0,-1,3,2,-5,5,0,0,-8,28,0,-1,1,2,0,0,0,1,0,1,0,-1
KR_6702535951,420,0,14,-33,5,-1,2,1,5,0,5,6,2,8,-4,4,0,-1,1,0,1,6,0,4,-5,1,2,0,1,-1,1,1,1,2,-1
KR_6703517061,420,-5,-74,-13,-13,-2,4,2,-6,9,3,-4,4,0,-1,6,5,0,0,0,0,-1,3,-3,-2,5,-3,0,-1,-1,-1,-1,-1,1,-1
KR_6686006856,440,1,12,8,-3,4,1,5,-5,7,2,3,1,4,-3,4,1,-2,3,1,1,-5,-3,4,-6,2,-2,0,0,-1,-1,1,1,5,-1
KR_6717407964,420,-3,-12,4,-13,-1,4,3,-3,3,0,-5,7,2,-5,7,2,1,1,2,0,-11,-486,-1,-1,2,0,0,-2,-1,-1,-1,1,3,-1
KR_6763871682,420,1,-60,-23,0,-2,4,2,0,3,3,3,4,7,0,2,2,-1,1,0,-1,0,-15,1,-3,2,0,0,-1,0,1,-1,-1,0,-1
KR_6665548827,420,-5,-26,-28,-11,-7,9,2,1,2,3,-2,4,2,-5,6,1,2,0,2,0,1,-13,-5,0,5,3,0,-1,1,0,-1,1,6,-1
KR_6732380571,420,1,47,5,2,3,1,4,-1,3,2,0,4,4,1,1,2,-1,1,0,0,-3,-15,-1,-3,4,-5,0,0,-1,-1,-1,1,2,-1
KR_6723755363,420,1,12,52,-13,-4,4,0,-2,4,2,-7,8,1,0,1,1,0,0,0,-1,-10,-37,-4,-3,7,0,0,1,1,-1,1,-1,1,-1
KR_6752609751,420,-1,-41,13,1,1,0,1,3,0,3,-1,2,1,-2,4,2,0,2,2,0,-4,-2,-1,-3,4,-1,0,0,1,1,0,1,6,-1
KR_6691295705,420,-1,-38,-12,1,4,2,6,-1,4,3,-2,3,1,3,0,3,-3,5,2,0,3,3,-3,-3,6,-2,0,-2,-1,-1,-1,-1,1,-1
KR_6763941507,420,0,-69,23,5,-3,4,1,8,2,10,-2,5,3,0,2,2,2,0,2,1,0,-4,4,-6,2,-2,0,-1,1,-1,-1,1,3,-1
KR_6749772350,420,0,-98,6,-5,-1,2,1,-2,3,1,0,1,1,-3,3,0,1,0,1,0,-4,-9,1,-2,1,1,0,0,1,1,-1,-1,3,-1
KR_6743791146,440,0,35,20,-1,1,2,3,2,5,7,-4,5,1,-2,6,4,2,1,3,0,5,-116,-1,-2,3,1,0,1,-1,1,1,-1,6,-1
KR_6635171481,420,3,-49,5,-2,4,0,4,0,1,1,-4,4,0,-5,5,0,3,0,3,-1,-3,-2,2,-4,2,0,0,0,1,1,0,-1,1,-1
KR_6647410430,420,0,-20,-27,1,3,2,5,-1,1,0,-2,2,0,1,1,2,0,0,0,0,0,-28,2,-3,1,8,0,0,-1,1,0,1,5,-1
KR_6645278198,420,0,-41,12,-4,-2,4,2,-2,3,1,-1,4,3,0,0,0,1,0,1,0,-6,-4,-3,0,3,1,0,-1,0,-1,-1,1,0,-1
KR_6710260351,420,-4,-43,-36,-13,-8,10,2,-3,5,2,-2,3,1,-1,1,0,1,0,1,-1,-13,-2,-3,0,3,2,0,-2,-1,-1,-1,-1,4,-1
KR_6726326387,420,-5,-52,4,-7,-3,3,0,-2,5,3,1,1,2,-2,2,0,-1,1,0,-1,-4,-8,-2,-1,3,-1,0,-1,1,-1,-1,-1,3,-1
KR_6743239269,420,-5,-70,15,-12,2,2,4,-4,4,0,-4,5,1,-6,7,1,0,0,0,-1,-14,-7,-2,-2,4,-1,0,-2,-1,-1,-1,-1,2,-1
KR_6762340650,420,-1,-83,-17,-1,0,1,1,3,2,5,-5,6,1,0,2,2,1,0,1,0,0,-38,-1,-8,9,5,0,0,0,-1,1,-1,0,-1
KR_6706406468,420,2,66,0,8,1,2,3,0,3,3,1,0,1,5,0,5,1,1,2,0,7,6,0,-4,4,5,0,2,-1,-1,1,1,3,-1
KR_6640709019,440,-6,-94,44,-21,-4,4,0,-5,5,0,-6,6,0,-9,9,0,3,0,3,-1,-23,70,-3,0,3,-2,0,-3,-1,-1,-1,-1,5,-1
KR_6751462166,420,0,-2,0,-1,1,2,3,1,1,2,-5,6,1,2,1,3,0,0,0,0,-3,4,0,-4,4,-1,0,1,-1,1,1,-1,5,-1
KR_6763544910,420,-5,-61,-8,-21,-6,7,1,3,1,4,-4,4,0,-9,10,1,-5,6,1,0,-13,267,-1,-2,3,0,0,-3,1,-1,-1,-1,3,-1
KR_6760510865,420,-4,-61,-16,-11,3,1,4,-3,3,0,-2,3,1,-8,9,1,-1,2,1,0,-8,-3,-2,-2,4,1,0,-1,1,-1,-1,-1,3,-1
KR_6759419971,420,-4,-29,-6,-12,-1,2,1,-2,2,0,1,2,3,-8,9,1,-2,2,0,0,-11,-3,2,-4,2,1,0,-1,-1,-1,-1,1,6,-1
KR_6645422004,420,3,144,27,5,1,2,3,2,2,4,2,0,2,0,0,0,0,1,1,0,1,6,3,-5,2,3,0,1,1,1,1,-1,6,-1
KR_6748506855,420,-1,14,32,-11,-3,3,0,-2,2,0,-2,2,0,-3,4,1,-1,1,0,-2,-11,-1,-3,-2,5,3,0,-1,-1,-1,-1,-1,3,-1
KR_6752058581,420,-2,-149,4,-8,-5,8,3,-2,3,1,1,0,1,-1,1,0,-1,1,0,0,-8,-7,-1,0,1,-4,0,-1,1,1,-1,-1,6,-1
KR_6757142955,420,-6,-113,-44,-13,2,0,2,0,2,2,-15,15,0,3,1,4,-3,3,0,0,-8,-5,-1,-3,4,-1,0,-1,-1,0,-1,-1,4,-1
KR_6728352774,420,-5,-59,6,-8,-2,4,2,-5,6,1,4,1,5,-2,4,2,-3,3,0,-1,-10,1,-1,-1,2,-3,0,-2,-1,-1,-1,-1,4,-1
KR_6739390160,440,-2,-84,-19,-3,-2,3,1,-1,3,2,-5,5,0,-1,4,3,6,1,7,0,5,1,-1,-4,5,-1,0,0,-1,-1,0,-1,6,-1
KR_6712669607,440,-2,-34,-9,-4,-2,2,0,1,4,5,-2,2,0,2,3,5,-3,4,1,0,0,-47,-1,-3,4,16,0,-1,-1,1,-1,1,5,-1
KR_6760204646,420,0,-25,-16,5,1,1,2,0,2,2,1,2,3,1,3,4,2,0,2,-1,2,-1,0,-2,2,-1,0,1,1,-1,1,-1,5,-1
KR_6722216204,420,2,-13,0,5,-2,2,0,5,0,5,0,2,2,1,3,4,1,0,1,0,9,-4,-1,-1,2,2,0,0,-1,1,1,1,6,-1
KR_6706908553,440,-1,26,-25,-1,5,2,7,-3,6,3,-3,4,1,0,6,6,0,1,1,0,1,-5,0,-2,2,-1,0,-2,-1,0,-1,-1,5,-1
KR_6682595420,420,-1,-25,17,4,2,0,2,0,0,0,-2,5,3,2,0,2,2,0,2,0,3,-43,-4,-3,7,31,0,0,1,1,-1,1,3,-1
KR_6718066611,440,2,26,-4,-1,0,1,1,0,1,1,-4,4,0,1,0,1,2,0,2,0,1,1,-1,-3,4,1,0,0,-1,-1,0,-1,3,-1
KR_6713655618,420,1,-58,22,6,3,2,5,4,1,5,-1,3,2,0,0,0,0,0,0,0,0,-3,-1,0,1,0,0,0,-1,1,0,1,1,-1
KR_6667279957,420,0,-4,8,-1,-1,1,0,-1,4,3,-2,4,2,2,1,3,1,1,2,0,-1,0,1,-3,2,1,0,0,1,1,0,1,5,-1
KR_6702934282,420,-1,43,-2,-6,0,2,2,-1,1,0,1,2,3,-7,8,1,1,0,1,0,-7,8,-2,-1,3,-1,0,1,-1,-1,1,-1,6,-1
KR_6762351174,440,2,80,-12,8,4,2,6,-1,2,1,3,1,4,2,1,3,0,0,0,1,4,-44,-1,0,1,28,0,0,-1,-1,0,1,1,-1
KR_6742114431,420,-4,0,0,-12,-2,3,1,-2,3,1,-7,7,0,-1,4,3,0,1,1,0,-10,-303,-1,-4,5,-4,0,-1,-1,0,-1,-1,3,-1
KR_6752506721,420,-2,-32,-8,-2,-4,5,1,1,1,2,1,1,2,0,1,1,0,2,2,0,0,43,-1,-2,3,-19,0,-1,1,0,-1,-1,2,-1
KR_6750409415,420,5,76,4,3,3,5,8,-3,5,2,1,0,1,0,3,3,2,1,3,0,-1,4,3,-4,1,0,0,3,1,1,1,1,1,-1
KR_6697364537,420,-5,-70,35,-9,-1,4,3,-2,3,1,-2,2,0,-5,5,0,1,0,1,0,-3,9,0,-1,1,0,0,-1,1,0,-1,-1,6,-1
KR_6758162260,420,1,-30,39,-6,1,0,1,-2,3,1,3,1,4,-11,11,0,3,0,3,0,-9,-3,0,0,0,-1,0,-2,1,-1,-1,-1,6,-1
KR_6760156568,420,-4,-91,-20,-10,-4,4,0,-1,1,0,-2,4,2,-3,6,3,0,0,0,0,-3,-15,-2,-2,4,-1,0,-1,0,-1,-1,-1,0,-1
KR_6671438314,420,2,27,-8,2,2,0,2,0,1,1,3,0,3,-6,9,3,3,0,3,0,-1,-14,0,0,0,1,0,1,1,0,1,-1,1,-1
KR_6756484105,420,-1,11,-24,9,7,0,7,-2,3,1,1,1,2,4,1,5,-1,1,0,0,2,5,-3,-1,4,2,0,0,-1,0,0,1,2,-1
KR_6751432507,440,-3,-24,-4,-2,-5,5,0,2,2,4,3,1,4,-2,3,1,0,1,1,2,6,310,-2,0,2,0,0,0,-1,1,0,1,5,-1
KR_6764077972,420,-6,-21,-16,-9,-4,5,1,-1,5,4,-5,5,0,2,0,2,-1,1,0,-1,-1,-48,-5,0,5,23,0,-1,1,-1,-1,-1,2,-1
KR_6740115975,420,-3,2,-1,-5,-2,4,2,-2,3,1,0,0,0,0,0,0,-1,1,0,0,-3,-217,-7,0,7,-3,0,-1,-1,1,-1,-1,5,-1
KR_6694572270,420,-5,-116,-16,-13,-6,7,1,0,2,2,-8,8,0,4,1,5,-3,3,0,0,0,-428,-2,0,2,-1,0,0,-1,-1,-1,-1,1,-1
KR_6740825716,420,3,29,6,7,8,0,8,1,0,1,-2,2,0,-2,3,1,2,0,2,0,3,-7,-4,0,4,4,0,-1,1,-1,-1,1,1,-1
KR_6729186189,420,-4,-70,-22,-6,-6,6,0,-2,4,2,-2,2,0,1,1,2,3,1,4,0,3,-5,0,-3,3,-1,0,-1,1,-1,-1,-1,3,-1
KR_6761299523,420,-2,-22,-30,-3,-1,1,0,0,2,2,-1,4,3,-1,4,3,0,0,0,-1,-7,-144,-1,-2,3,-2,0,-1,-1,-1,-1,-1,5,-1
KR_6692074783,420,-1,7,-43,-6,-2,4,2,-8,9,1,0,2,2,5,0,5,-1,1,0,0,-5,1,-1,-2,3,2,0,-1,1,-1,-1,-1,6,-1
KR_6751903992,420,3,42,48,2,4,3,7,-1,1,0,2,0,2,0,4,4,-3,3,0,0,-9,-11,2,-2,0,-1,0,2,-1,0,1,-1,5,-1
KR_6761223523,420,0,-7,-26,1,7,0,7,1,0,1,1,1,2,-8,11,3,0,1,1,0,2,-3,1,-1,0,0,0,-1,1,1,-1,1,4,-1
KR_6762782229,420,-4,-114,-52,-8,-4,7,3,-3,4,1,-2,4,2,6,2,8,-5,7,2,0,-6,1,4,-6,2,-3,0,-4,-1,-1,-1,-1,3,-1
KR_6733720556,420,-4,-65,-35,-5,-4,4,0,-2,8,6,-1,2,1,1,2,3,1,1,2,0,-2,-2,2,-2,0,1,0,-2,1,-1,-1,1,2,-1
KR_6764134882,420,1,-20,2,-2,3,1,4,-1,1,0,-9,11,2,3,1,4,2,1,3,-1,-3,13,-4,-1,5,0,0,0,-1,1,0,-1,5,-1
KR_6630095219,420,0,45,19,-5,3,2,5,-1,2,1,-6,6,0,-1,2,1,0,2,2,0,-8,494,3,-6,3,1,0,0,-1,1,0,-1,4,-1
KR_6759400609,420,-1,-60,-13,-3,-9,11,2,0,2,2,2,0,2,3,0,3,1,0,1,0,0,5,-1,-2,3,0,0,-1,1,1,-1,-1,6,-1
KR_6708915005,420,-1,-40,-19,-5,1,1,2,-2,2,0,-3,4,1,0,0,0,-1,1,0,1,-2,2,1,-3,2,0,0,0,-1,1,1,1,2,-1
KR_6760534719,440,-8,-3,-27,-26,-3,4,1,-13,13,0,-6,6,0,-1,1,0,-3,3,0,0,-30,-7,-4,0,4,3,0,-1,-1,0,-1,-1,6,-1
KR_6729357601,420,0,-17,8,-4,0,2,2,0,4,4,1,1,2,-8,9,1,3,2,5,-2,-14,35,-2,0,2,-34,0,1,-1,1,1,-1,5,-1
KR_6743663253,420,-4,-84,8,-11,-2,2,0,-3,4,1,-2,4,2,-2,3,1,-2,3,1,0,-6,-6,0,-1,1,-1,0,-1,-1,-1,-1,-1,2,-1
KR_6731451950,420,-2,-128,16,-5,-1,3,2,4,0,4,0,1,1,-8,9,1,0,2,2,0,-5,-3,3,-5,2,-1,0,-3,-1,-1,-1,1,6,-1
KR_6734283913,440,-4,-30,-3,-12,0,0,0,2,3,5,0,0,0,-2,3,1,-12,12,0,1,-13,53,3,-4,1,0,0,-1,-1,1,-1,1,2,-1
KR_6750006932,420,1,43,15,0,8,2,10,-5,5,0,-5,6,1,0,0,0,2,1,3,-1,-8,8,-1,-3,4,5,0,1,-1,0,1,-1,6,-1
KR_6756244692,420,0,-46,-8,-5,-2,5,3,-2,2,0,0,2,2,0,1,1,-1,1,0,0,0,-1,-1,-1,2,-1,0,-1,1,-1,-1,-1,4,-1
KR_6758917833,420,2,61,10,-2,-1,3,2,3,0,3,-2,4,2,-1,2,1,-1,2,1,0,-5,6,1,-6,5,-3,0,1,-1,0,1,1,5,-1
KR_6753370782,420,0,-13,12,-5,3,0,3,-1,7,6,0,4,4,-5,7,2,-2,2,0,0,-7,-9,4,-7,3,1,0,0,-1,1,0,1,3,-1
KR_6730956111,420,1,-62,24,-2,1,0,1,2,0,2,2,2,4,-7,7,0,0,3,3,0,-5,39,2,-2,0,-1,0,0,1,1,0,-1,6,-1
KR_6748103230,420,-3,-17,-42,-5,-1,3,2,-4,4,0,1,4,5,-2,2,0,1,0,1,0,0,-176,-1,-1,2,-3,0,-1,-1,-1,-1,-1,5,-1
KR_6705614859,420,0,-1,2,-1,2,0,2,2,0,2,-1,1,0,-4,4,0,0,0,0,0,-1,-6,0,-1,1,-1,0,0,1,0,0,-1,5,-1
KR_6707343459,420,-1,-43,-6,1,0,0,0,4,1,5,1,1,2,-5,8,3,1,0,1,0,3,-22,2,-2,0,35,0,0,1,0,0,-1,6,-1
KR_6764249491,420,3,17,3,14,3,1,4,-3,3,0,9,0,9,5,2,7,0,4,4,2,13,-448,-1,-2,3,-1,0,0,0,1,1,1,0,-1
KR_6755376796,420,0,49,-56,4,3,1,4,2,2,4,2,2,4,-3,3,0,0,0,0,0,0,7,-1,-1,2,2,0,1,0,0,1,1,0,-1
KR_6751769562,420,-2,-85,8,-7,-2,2,0,1,2,3,-5,6,1,-1,1,0,0,0,0,0,-1,-5,0,-1,1,1,0,0,0,1,0,1,0,-1
KR_6727539955,420,-3,-77,60,-7,1,1,2,5,0,5,-10,10,0,-1,3,2,-2,2,0,1,-3,6,5,-6,1,-3,0,-2,-1,-1,-1,1,3,-1
KR_6756267757,420,-3,-118,-8,-7,-1,1,0,1,5,6,-1,4,3,-5,5,0,-1,1,0,-1,-3,-5,-2,0,2,-2,0,0,-1,1,-1,-1,4,-1
KR_6749027710,420,3,25,13,3,1,3,4,2,2,4,2,0,2,-1,3,2,-1,2,1,0,-5,-1,-1,-1,2,-3,0,3,1,1,1,-1,4,-1
KR_6672251334,420,1,-21,9,-5,7,0,7,-3,4,1,-1,1,0,-7,8,1,-1,3,2,0,-8,6,5,-7,2,-1,0,1,-1,1,1,1,1,-1
KR_6755421845,420,-3,-31,-3,-3,0,0,0,-1,1,0,-4,6,2,3,0,3,-1,1,0,0,2,-200,4,-6,2,0,0,0,1,-1,0,1,1,-1
KR_6729684132,420,0,-70,12,1,-4,5,1,4,1,5,2,3,5,-3,4,1,2,1,3,1,8,2,1,-2,1,0,0,-1,-1,-1,-1,1,1,-1
KR_6760190514,420,0,-29,6,-2,1,0,1,-6,6,0,5,2,7,-1,3,2,-1,2,1,0,-3,-1,-5,-1,6,4,0,0,1,0,0,-1,6,-1
KR_6693058187,420,-5,-57,-44,-2,-2,2,0,-3,3,0,-4,4,0,2,1,3,5,0,5,0,0,-9,1,-4,3,1,0,-2,-1,-1,-1,-1,6,-1
KR_6758070356,420,0,-3,19,-3,-4,6,2,4,0,4,1,1,2,-3,3,0,-1,2,1,0,-4,-3,-6,-3,9,-4,0,-3,0,-1,-1,-1,0,-1
KR_6738668099,420,2,-21,8,7,1,0,1,0,4,4,-4,5,1,5,2,7,5,0,5,0,18,-23,-2,-4,6,5,0,0,1,1,0,-1,5,-1
KR_6750776875,420,-9,-134,-40,-18,-1,1,0,-9,10,1,-6,8,2,-1,4,3,-1,1,0,-1,-18,3,3,-3,0,-1,0,-3,1,0,-1,-1,6,-1
KR_6728466583,420,0,27,1,-6,-5,5,0,-1,4,3,-2,5,3,2,0,2,0,3,3,0,-2,34,-1,-2,3,-24,0,0,0,1,1,-1,0,-1
KR_6747092767,420,-3,-25,-20,-6,-6,10,4,-1,2,1,-4,6,2,3,3,6,2,3,5,-2,1,247,3,-5,2,0,0,-1,1,-1,-1,-1,3,-1
KR_6764122526,420,-1,-16,8,-4,-2,3,1,3,1,4,-2,3,1,-2,2,0,-1,1,0,0,-4,9,0,-2,2,0,0,1,0,1,1,1,0,-1
KR_6747515747,420,-1,22,-25,5,0,1,1,7,2,9,1,1,2,-5,6,1,2,2,4,0,6,10,-3,-3,6,1,0,1,1,1,1,1,2,-1
KR_6735452002,420,-3,-8,0,-4,2,2,4,-3,3,0,-5,5,0,1,1,2,1,0,1,1,-1,1,-3,-3,6,-1,0,1,-1,1,1,1,3,-1
KR_6739093927,420,-1,-5,-1,-5,-2,3,1,-4,5,1,-2,4,2,2,5,7,1,0,1,0,-6,-569,-4,-2,6,2,0,-1,-1,-1,-1,1,6,-1
KR_6742702571,420,4,-35,5,7,0,2,2,7,0,7,0,1,1,-2,2,0,2,0,2,0,5,1,1,-3,2,3,0,0,1,1,1,1,3,-1
KR_6744911497,420,-8,-89,7,-18,-2,3,1,-6,8,2,1,1,2,-5,6,1,-6,6,0,-2,-17,-5,-3,-1,4,1,0,-3,1,-1,-1,-1,6,-1
KR_6753741542,420,-4,-43,-11,-10,1,1,2,-3,5,2,-5,7,2,-6,9,3,3,1,4,-1,-12,0,-2,-1,3,5,0,-1,-1,1,-1,-1,6,-1
KR_6758814512,420,-1,-60,-6,0,0,0,0,-1,3,2,-1,1,0,2,0,2,0,1,1,0,1,-31,5,-8,3,-5,0,0,0,-1,0,-1,0,-1
KR_6750980987,420,-3,-101,-8,-3,-3,4,1,-1,1,0,-2,3,1,1,1,2,2,1,3,0,2,-13,-2,-1,3,-1,0,-2,-1,1,-1,-1,2,-1
KR_6749452002,420,3,49,8,10,1,2,3,2,1,3,2,0,2,4,1,5,1,0,1,0,5,-1,4,-4,0,-1,0,2,1,1,1,1,4,-1
KR_6764404635,420,-3,26,-20,-4,4,0,4,-2,4,2,-2,3,1,-6,8,2,2,1,3,1,-2,4,-3,-2,5,2,0,0,-1,1,1,1,6,-1
KR_6733336841,420,-5,-113,-12,-9,1,2,3,-2,2,0,-5,6,1,1,1,2,-4,6,2,0,-11,0,3,-4,1,-1,0,-2,-1,0,-1,-1,2,-1
KR_6722569832,420,-2,7,-16,-12,0,1,1,-6,6,0,-4,5,1,-1,2,1,-1,1,0,0,-9,3,-2,-1,3,-3,0,-1,-1,-1,-1,1,1,-1
KR_6754452527,420,0,15,17,-1,0,3,3,-1,4,3,-1,5,4,0,2,2,1,1,2,-1,-4,-2,-2,-4,6,2,0,0,-1,1,1,-1,4,-1
KR_6655007209,420,-2,14,-15,-2,1,2,3,-1,3,2,-3,4,1,1,2,3,0,1,1,0,-1,-129,2,-6,4,-1,0,0,1,1,1,-1,6,-1
KR_6738607498,420,-2,-62,-16,3,0,1,1,3,0,3,-4,6,2,3,1,4,1,1,2,0,6,-9,1,-2,1,-1,0,0,-1,1,0,1,4,-1
KR_6764281689,420,-2,-57,-2,4,-2,2,0,1,1,2,-4,4,0,8,1,9,1,0,1,0,7,3,1,-3,2,3,0,1,1,1,1,1,4,-1
KR_6663493744,420,-8,-75,-30,-8,-3,3,0,1,4,5,-3,3,0,-3,3,0,0,0,0,0,-9,-15,-3,-1,4,0,0,-2,-1,-1,-1,-1,6,-1
KR_6755102033,420,2,48,20,-2,0,0,0,2,1,3,0,2,2,0,1,1,-4,4,0,0,-4,-21,0,-3,3,3,0,0,-1,-1,0,-1,4,-1
KR_6742116483,420,-6,-83,1,-13,-4,4,0,-6,6,0,-1,2,1,-2,4,2,0,0,0,0,-8,-11,1,-3,2,-2,0,-1,-1,-1,-1,-1,6,-1
KR_6734980475,420,-1,-60,-24,2,0,1,1,2,0,2,4,1,5,-5,6,1,1,1,2,1,4,-2,-3,-4,7,0,0,0,-1,1,1,1,6,-1
KR_6722406150,420,-1,85,2,-8,0,2,2,3,0,3,-12,15,3,0,0,0,1,0,1,-2,2,10,-1,-2,3,-3,0,-1,-1,0,-1,-1,5,-1
KR_6706814679,420,-1,25,8,-1,7,0,7,-1,1,0,-4,5,1,-6,6,0,3,1,4,0,2,-140,0,-2,2,15,0,1,-1,1,1,-1,6,-1
KR_6684714000,420,-1,-40,7,-3,-2,3,1,-1,5,4,-1,4,3,0,2,2,1,0,1,0,3,-230,1,-1,0,-1,0,1,-1,1,-1,1,4,-1
KR_6726331002,420,-2,-115,0,1,1,0,1,5,0,5,-7,7,0,3,2,5,-1,1,0,0,3,5,5,-6,1,-6,0,-1,1,1,-1,-1,4,-1
KR_6733761746,420,-5,-106,-29,-7,1,1,2,2,2,4,-3,5,2,-6,8,2,-1,2,1,-1,-5,50,0,-4,4,-4,0,-3,-1,-1,-1,-1,6,-1
KR_6690314800,440,-4,-72,-32,-14,0,1,1,-3,3,0,-6,7,1,-3,4,1,-2,2,0,-1,-9,0,-1,-1,2,-3,0,-2,-1,-1,-1,-1,2,-1
KR_6761125718,420,-2,-21,-3,1,-3,3,0,1,2,3,-1,1,0,2,0,2,2,0,2,0,5,0,-3,-3,6,1,0,0,0,1,0,-1,0,-1
KR_6671444304,420,0,-20,-8,2,0,2,2,1,4,5,-5,6,1,6,1,7,0,2,2,1,6,14,1,-3,2,-2,0,1,-1,1,1,1,5,-1
KR_6743228728,420,-3,-49,-4,-13,1,0,1,-1,2,1,-4,5,1,-6,6,0,-3,4,1,1,-11,-11,4,-6,2,1,0,-1,-1,0,-1,1,2,-1
KR_6744710367,420,-2,7,-5,-9,-3,5,2,-1,3,2,1,0,1,-5,5,0,-1,1,0,0,-7,-1,1,-6,5,1,0,-1,1,-1,-1,1,6,-1
KR_6742373980,420,-1,55,-12,-3,-1,4,3,-2,5,3,-1,2,1,2,3,5,-1,1,0,0,-6,-3,1,-3,2,2,0,0,-1,-1,0,-1,5,-1
KR_6653631130,420,-2,-7,-80,-4,-2,2,0,0,2,2,3,0,3,-4,4,0,-1,1,0,0,-4,-132,-4,0,4,1,0,-1,-1,0,-1,1,3,-1
KR_6750632471,440,-1,-29,0,-5,-1,6,5,0,2,2,2,0,2,-3,5,2,-3,4,1,0,-6,-286,2,-2,0,-2,0,-1,-1,0,-1,1,5,-1
KR_6762117265,420,0,24,-19,-3,1,3,4,-4,5,1,1,5,6,0,2,2,-1,2,1,0,-12,-7,0,-5,5,-1,0,0,-1,-1,0,1,3,-1
KR_6696073752,420,-6,-79,-48,-23,-10,11,1,-6,8,2,-3,5,2,-2,4,2,-2,2,0,0,-17,4,1,-4,3,-3,0,-3,0,-1,-1,-1,0,-1
KR_6723950966,440,1,-15,-18,-5,-4,5,1,-1,2,1,4,0,4,-2,2,0,-2,6,4,0,-2,-7,1,-5,4,3,0,-2,-1,-1,-1,-1,4,-1
KR_6753334380,420,-3,29,0,-6,3,2,5,-3,4,1,0,2,2,-5,7,2,-1,3,2,2,-2,-7,-1,-5,6,0,0,-1,-1,-1,-1,1,1,-1
KR_6741019575,420,-2,-22,-15,-3,0,3,3,2,2,4,-2,3,1,-2,3,1,-1,1,0,0,-3,1,0,-2,2,-1,0,0,-1,1,0,-1,6,-1
KR_6743166650,420,-6,-123,-14,-14,-4,4,0,1,1,2,-5,5,0,-5,6,1,-1,3,2,-1,-10,16,-4,-1,5,2,0,-1,-1,1,-1,-1,4,-1
KR_6740380165,420,-1,-109,76,-2,-3,4,1,3,0,3,-5,5,0,2,0,2,1,0,1,1,1,23,1,-1,0,-2,0,-2,1,1,-1,1,5,-1
KR_6762523873,420,0,-9,-27,-9,1,2,3,-5,6,1,-3,3,0,-5,6,1,3,1,4,0,-15,-1,-3,-1,4,2,0,0,-1,1,1,1,1,-1
KR_6694977083,420,0,-12,-3,0,0,0,0,0,0,0,-1,2,1,1,2,3,0,2,2,1,7,16,-1,-4,5,-25,0,-1,1,-1,-1,1,6,-1
KR_6755243442,420,1,29,-24,0,-3,5,2,-2,4,2,-1,4,3,3,0,3,3,0,3,0,1,-4,-2,0,2,0,0,0,-1,-1,0,-1,6,-1
KR_6744000403,420,3,33,33,2,2,2,4,0,2,2,-1,3,2,0,1,1,1,0,1,0,-6,4,1,-3,2,3,0,-1,0,0,-1,1,0,-1
KR_6640261568,420,-2,-145,-4,-1,0,3,3,0,1,1,-2,7,5,2,1,3,-1,1,0,0,8,5,-3,-3,6,2,0,0,-1,-1,0,1,2,-1
KR_6735051601,420,3,-22,36,6,3,1,4,4,1,5,0,1,1,-1,2,1,0,2,2,0,1,25,0,-3,3,-3,0,1,1,-1,1,1,1,-1
KR_6737964101,440,-1,-67,8,-1,-2,2,0,2,0,2,0,3,3,-2,4,2,1,0,1,0,2,0,3,-3,0,0,0,1,1,1,1,-1,3,-1
KR_6749900246,420,2,12,0,-1,2,0,2,-1,4,3,-4,4,0,-1,4,3,3,3,6,1,0,-7,-7,0,7,4,0,1,-1,-1,1,1,2,-1
KR_6750797634,420,-1,-63,-9,-6,-1,2,1,-2,3,1,-4,4,0,1,0,1,0,2,2,-2,-12,0,0,-3,3,2,0,-3,-1,-1,-1,-1,3,-1
KR_6679592917,420,-6,-45,-56,-12,-7,7,0,-1,2,1,-3,3,0,-1,4,3,0,2,2,0,-4,114,4,-5,1,0,0,-1,-1,-1,-1,1,5,-1
KR_6704026396,420,-5,-70,16,-9,-7,9,2,3,1,4,-1,2,1,-5,8,3,1,0,1,-1,-7,-3,2,-2,0,-2,0,-1,1,-1,-1,1,1,-1
KR_6749022366,420,-2,-53,-36,-1,-1,2,1,-1,2,1,-3,5,2,2,1,3,2,1,3,2,5,-11,1,-1,0,2,0,-1,1,-1,-1,1,3,-1
KR_6698444240,420,-2,0,13,-6,3,1,4,2,0,2,-3,4,1,-3,4,1,-5,6,1,0,-3,-1,2,-3,1,-1,0,-1,0,-1,-1,1,0,-1
KR_6723618605,420,1,-43,14,6,1,0,1,2,0,2,1,3,4,0,1,1,2,2,4,0,6,1,3,-5,2,2,0,0,1,1,0,1,3,-1
KR_6736751416,420,5,13,49,7,2,4,6,0,1,1,2,1,3,3,0,3,0,0,0,0,3,0,-2,-4,6,5,0,1,1,1,1,-1,1,-1
KR_6762597015,420,-2,-45,-20,-6,-1,2,1,-5,8,3,-1,4,3,1,4,5,0,2,2,1,-3,-16,-1,-3,4,1,0,-2,0,1,-1,1,0,-1
KR_6619980236,420,-1,10,-8,-10,-2,3,1,-2,2,0,0,3,3,-3,6,3,-3,3,0,0,-11,41,0,-1,1,-25,0,1,1,-1,1,1,5,-1
KR_6664433495,420,-3,21,-32,-6,1,1,2,-5,10,5,1,2,3,-2,2,0,-1,2,1,0,-2,-10,-3,-2,5,-1,0,0,-1,-1,0,1,5,-1
KR_6730367561,420,-5,-56,-2,-11,-4,5,1,-1,2,1,3,1,4,-9,12,3,0,2,2,0,4,1,3,-3,0,3,0,-1,1,1,-1,1,5,-1
KR_6667324955,420,0,27,32,4,-2,3,1,-2,2,0,4,0,4,2,1,3,2,0,2,0,5,-6,2,-2,0,1,0,1,0,0,1,-1,0,-1
KR_6755942539,420,-10,-84,-56,-13,-2,2,0,-2,5,3,-5,5,0,0,1,1,-4,4,0,0,-9,-1,1,-2,1,-4,0,-2,-1,-1,-1,1,2,-1
KR_6690524814,420,1,-17,40,-2,1,0,1,1,0,1,-1,3,2,-4,8,4,1,0,1,0,-3,6,0,-4,4,-1,0,0,1,1,0,-1,6,-1
KR_6744348467,420,-2,-14,-6,0,-5,7,2,3,0,3,-2,3,1,5,0,5,-1,2,1,0,4,8,-2,-3,5,-1,0,-1,1,-1,-1,-1,1,-1
KR_6729385588,420,2,33,40,-5,-3,4,1,4,1,5,-2,2,0,-3,3,0,-1,3,2,0,-2,-14,-2,-1,3,2,0,1,-1,1,-1,-1,2,-1
KR_6746331436,420,-1,-50,4,3,2,1,3,2,0,2,5,0,5,-7,10,3,1,0,1,1,-3,-15,1,-2,1,2,0,-1,1,1,-1,1,3,-1
KR_6697104402,420,-1,87,7,-6,-2,3,1,-2,4,2,4,3,7,-4,4,0,-2,4,2,0,-11,-7,-5,-3,8,-1,0,-1,-1,-1,-1,-1,5,-1
KR_6742175858,420,-2,-58,14,-8,-4,4,0,-2,2,0,2,2,4,-2,2,0,-2,2,0,0,-4,-2,1,-2,1,0,0,0,1,-1,-1,-1,1,-1
KR_6762286388,420,-2,20,-2,1,4,0,4,-2,3,1,0,1,1,2,1,3,-3,3,0,0,0,13,-1,-3,4,-4,0,1,-1,1,1,1,6,-1
KR_6759347840,420,1,-66,-25,-2,-3,3,0,2,2,4,0,0,0,-4,5,1,3,0,3,-1,3,-11,-1,-2,3,-1,0,0,-1,1,0,-1,5,-1
KR_6659267281,420,-5,-73,-37,-10,-2,4,2,-2,2,0,2,1,3,-8,9,1,0,0,0,-1,-13,3,0,-3,3,-1,0,-2,-1,1,-1,-1,1,-1
KR_6762106676,420,0,-33,20,-9,0,2,2,-3,5,2,-4,7,3,1,1,2,-3,4,1,-1,-3,-5,-3,-2,5,3,0,-1,-1,1,-1,-1,2,-1
KR_6725434473,420,-3,-97,-23,-6,-2,3,1,0,0,0,1,2,3,-6,7,1,1,3,4,0,-7,-5,2,-2,0,0,0,-1,-1,0,1,-1,3,-1
KR_6758817769,420,-1,-16,36,-8,-4,4,0,2,2,4,-6,7,1,1,2,3,-1,2,1,0,-6,-22,1,-3,2,1,0,-1,1,-1,-1,-1,3,-1
KR_6734859366,420,-1,12,-3,-8,-3,5,2,-7,8,1,-1,4,3,0,1,1,3,0,3,0,-1,120,0,-4,4,-1,0,-2,1,-1,-1,-1,1,-1
KR_6739214218,420,0,-21,31,-2,-1,2,1,3,3,6,-2,2,0,-2,3,1,0,1,1,0,1,27,-1,-3,4,1,0,0,-1,1,1,1,4,-1
KR_6747107046,420,-7,-149,-26,-3,0,0,0,0,2,2,-3,3,0,0,1,1,0,0,0,0,1,-52,-1,-2,3,20,0,-4,-1,-1,-1,-1,6,-1
KR_6656505396,420,0,-49,23,2,-2,2,0,-1,2,1,1,4,5,3,0,3,1,0,1,0,5,-2,-1,-2,3,4,0,0,0,-1,-1,-1,0,-1
KR_6751138814,420,-5,-133,-12,-13,-9,9,0,0,5,5,-2,4,2,-2,3,1,0,2,2,-1,-3,33,0,-3,3,-15,0,-1,0,0,-1,-1,0,-1
KR_6764507842,440,-9,-65,7,-2,2,2,4,-4,4,0,7,1,8,-6,6,0,-1,1,0,0,-7,-124,-3,0,3,0,0,0,0,-1,-1,-1,0,-1
KR_6735199598,420,2,-44,-8,3,-2,2,0,0,3,3,2,1,3,2,1,3,1,1,2,0,1,0,3,-4,1,1,0,-2,1,-1,-1,1,3,-1
KR_6764081737,420,-5,-13,-39,-19,-2,3,1,-1,2,1,-7,8,1,-7,7,0,-2,4,2,0,-14,170,-5,-1,6,-1,0,-1,-1,-1,-1,-1,6,-1
KR_6713139512,420,-2,-48,-20,-10,-2,4,2,-2,4,2,-5,5,0,-2,3,1,1,0,1,0,-4,-8,0,-1,1,1,0,0,0,-1,1,-1,0,-1
KR_6707067292,420,-5,-36,-76,-9,2,1,3,-6,6,0,-2,2,0,-3,3,0,0,0,0,0,-10,0,1,-2,1,0,0,1,-1,-1,1,1,1,-1
KR_6650778361,420,-5,-90,-56,-4,-2,4,2,-2,4,2,-2,3,1,1,1,2,1,0,1,0,1,5,-1,-2,3,-1,0,-3,0,-1,-1,-1,0,-1
KR_6720302251,420,3,24,-4,5,4,0,4,1,1,2,-3,5,2,-2,4,2,5,2,7,0,-6,-4,-2,-1,3,2,0,1,-1,1,1,1,4,-1
KR_6741920077,420,-5,-20,-8,-9,-9,9,0,1,3,4,-3,4,1,3,4,7,-1,2,1,1,-1,-2,-3,-4,7,-3,0,-1,-1,1,-1,1,1,-1
KR_6754230704,420,-4,-79,-1,-9,2,1,3,-1,1,0,-11,11,0,0,1,1,1,0,1,0,-4,-9,-1,-1,2,-2,0,-2,-1,-1,-1,-1,3,-1
KR_6731267075,420,-2,-13,-22,3,-6,7,1,1,3,4,1,1,2,4,1,5,3,1,4,1,7,45,0,-4,4,-11,0,-2,-1,1,-1,1,5,-1
KR_6652388650,420,-4,-1,-12,-6,-5,5,0,-4,6,2,-1,1,0,2,2,4,2,0,2,0,1,-19,-4,-2,6,0,0,-2,-1,-1,-1,1,2,-1
KR_6629526555,420,-4,-80,20,-5,0,2,2,-4,5,1,1,0,1,-4,6,2,2,0,2,-1,-6,4,2,-3,1,-2,0,-2,-1,0,-1,-1,4,-1
KR_6746199014,420,-2,11,12,-4,-3,4,1,-1,2,1,1,2,3,2,0,2,-3,3,0,-2,0,6,2,-5,3,-2,0,0,0,1,0,-1,0,-1
KR_6747970579,420,-1,-15,-4,1,1,1,2,-3,3,0,0,6,6,3,1,4,0,1,1,0,8,-2,-1,-2,3,0,0,-1,1,0,-1,1,2,-1
KR_6736573487,420,-4,-49,-51,-6,0,1,1,2,2,4,-8,9,1,2,1,3,-2,3,1,1,-3,17,-1,-1,2,0,0,0,-1,-1,-1,1,1,-1
KR_6749012212,420,-4,-25,-37,-6,0,2,2,-3,6,3,-5,5,0,3,1,4,-1,4,3,0,2,-15,0,-3,3,-1,0,0,1,0,-1,1,5,-1
KR_6723409628,420,-3,-60,-12,-12,-2,4,2,3,1,4,-2,6,4,-10,10,0,-1,1,0,-1,-7,0,2,-4,2,-3,0,-3,-1,-1,-1,-1,3,-1
KR_6685915665,420,-1,-18,17,-1,-1,1,0,-2,4,2,-2,2,0,1,1,2,3,0,3,0,4,-345,0,-3,3,-2,0,0,-1,1,0,-1,1,-1
KR_6720996802,420,-4,-54,-12,-11,-3,4,1,-4,5,1,-3,4,1,-1,3,2,0,2,2,0,-6,-102,1,-4,3,-3,0,-1,-1,-1,-1,-1,3,-1
KR_6729393829,420,0,-33,-12,-3,-4,4,0,3,0,3,2,0,2,-2,5,3,-2,2,0,0,-1,0,1,-3,2,-4,0,0,1,0,0,1,2,-1
KR_6646709361,420,-1,2,24,-7,0,3,3,0,2,2,-6,8,2,1,1,2,-2,2,0,0,-2,32,0,-5,5,3,0,-1,1,-1,-1,1,5,-1
KR_6758889057,420,2,28,32,5,-1,1,0,3,1,4,-1,2,1,5,0,5,-1,2,1,0,6,-8,-1,-4,5,-1,0,2,1,1,1,1,3,-1
KR_6731700815,420,2,38,-9,-2,1,1,2,0,2,2,-1,4,3,-1,1,0,-1,2,1,0,-2,-61,0,-2,2,4,0,0,1,0,1,1,2,-1
KR_6762177210,420,0,-10,-4,-2,0,1,1,-5,6,1,5,0,5,-1,1,0,-1,1,0,-1,-5,11,1,-3,2,-5,0,0,1,-1,0,-1,3,-1
KR_6683993475,420,0,-86,11,4,-2,5,3,7,2,9,0,1,1,1,0,1,-2,2,0,0,2,7,-1,-6,7,-3,0,-1,-1,-1,-1,-1,1,-1
KR_6763545227,420,-5,-128,1,-13,-1,1,0,-6,8,2,-1,4,3,-3,4,1,-2,3,1,-2,-13,14,-3,-1,4,-3,0,-2,0,0,-1,-1,0,-1
KR_6685863401,420,0,42,10,-1,0,2,2,-2,6,4,2,1,3,-2,5,3,1,0,1,0,-1,5,0,-5,5,-3,0,0,0,1,0,1,0,-1
KR_6711890351,420,-3,-19,-17,-7,-3,3,0,-4,4,0,1,1,2,-6,6,0,5,0,5,0,-6,-5,-1,-1,2,1,0,-1,-1,-1,-1,-1,3,-1
KR_6644547893,420,5,8,64,11,6,0,6,6,1,7,-5,13,8,2,0,2,2,1,3,1,12,19,0,-3,3,0,0,1,0,1,1,1,0,-1
KR_6746162666,420,-3,-31,-12,-5,1,3,4,-2,3,1,-2,6,4,-1,5,4,-1,4,3,1,-5,21,-1,0,1,2,0,-1,0,-1,-1,1,0,-1
KR_6762045302,420,-5,-91,4,-16,-1,8,7,-2,3,1,-10,11,1,-4,6,2,1,1,2,0,-6,7,2,-5,3,-2,0,-2,1,-1,-1,1,5,-1
KR_6628548909,420,2,-2,-24,2,5,0,5,1,1,2,2,4,6,-3,4,1,-3,3,0,0,-7,12,-2,-1,3,0,0,0,0,1,0,-1,0,-1
KR_6683775190,420,-3,-39,16,-4,-1,1,0,-2,2,0,0,1,1,0,1,1,-1,1,0,0,-5,2,-2,0,2,0,0,-1,-1,1,-1,1,4,-1
KR_6742448533,420,-2,-129,12,-3,0,1,1,0,4,4,-1,4,3,1,1,2,-3,3,0,0,-5,-38,2,-3,1,1,0,-1,0,1,-1,1,0,-1
KR_6759833489,420,-6,17,-16,-13,3,1,4,-8,8,0,-1,2,1,-5,7,2,-2,3,1,1,-12,-153,-2,-4,6,-4,0,0,-1,-1,-1,1,1,-1
KR_6745781738,420,1,24,-4,-3,-1,3,2,-4,6,2,-1,3,2,2,1,3,1,0,1,0,-7,12,0,-3,3,1,0,0,1,-1,-1,1,3,-1
KR_6734782226,420,-6,-94,-28,-10,2,2,4,0,0,0,-12,12,0,0,1,1,0,0,0,0,-5,27,-2,0,2,-18,-1,-7,-1,-1,-1,-1,6,-1
KR_6679742379,420,-2,-48,-4,5,0,2,2,-1,1,0,-3,5,2,10,0,10,-1,1,0,0,9,-232,1,-5,4,-1,0,0,-1,1,1,1,1,-1
KR_6759907859,420,-3,-96,-22,-10,0,1,1,-2,3,1,-1,5,4,-2,3,1,-5,6,1,-1,-13,-26,-2,-3,5,-1,0,0,-1,1,-1,-1,4,-1
KR_6731603711,420,-2,-45,8,-7,-5,5,0,2,1,3,-4,4,0,-1,4,3,1,0,1,0,2,-3,0,-5,5,-1,0,0,1,1,0,-1,5,-1
KR_6678114068,420,-2,-14,-4,-10,-1,2,1,0,2,2,0,0,0,-7,8,1,-2,2,0,-1,-10,0,-2,-3,5,-3,0,-1,-1,-1,-1,-1,5,-1
KR_6753601264,420,0,-31,-4,4,-3,3,0,2,2,4,-3,3,0,8,0,8,0,2,2,-1,7,-9,1,-3,2,3,0,-1,-1,0,1,-1,1,-1
KR_6761964083,440,3,125,12,6,0,5,5,6,0,6,3,0,3,-2,5,3,-1,1,0,0,7,4,2,-2,0,0,0,1,1,0,1,-1,6,-1
KR_6722398973,420,-1,-20,-20,-1,2,1,3,3,3,6,-4,7,3,-3,4,1,1,1,2,0,2,6,1,-3,2,0,0,-2,-1,-1,-1,-1,6,-1
KR_6754970008,420,0,-57,20,-2,-5,5,0,2,0,2,1,3,4,-1,1,0,1,0,1,0,4,0,3,-4,1,1,0,-1,-1,0,-1,-1,4,-1
KR_6747108094,420,0,-15,11,-1,-3,3,0,1,0,1,-7,7,0,2,2,4,6,0,6,0,-2,-11,-2,-2,4,-1,0,0,-1,-1,-1,1,6,-1
KR_6632875881,420,2,15,11,-4,0,1,1,-5,5,0,-1,1,0,0,1,1,2,0,2,0,-4,85,-4,-1,5,0,0,-1,-1,-1,-1,1,2,-1
KR_6754320420,420,2,63,4,-2,3,1,4,-1,1,0,-8,10,2,3,0,3,1,0,1,1,-4,2,0,-1,1,0,0,0,-1,-1,1,1,6,-1
KR_6726593832,420,-3,3,-6,-9,-2,2,0,-5,6,1,1,3,4,-2,3,1,-1,1,0,0,-12,-10,1,-5,4,-2,0,1,-1,-1,1,-1,1,-1
KR_6743843883,420,-8,-52,-78,-16,-2,3,1,-3,4,1,-6,8,2,-6,7,1,1,1,2,0,-7,1,-2,-1,3,0,0,-3,-1,0,-1,-1,4,-1
KR_6759191105,420,-1,-46,16,1,-2,2,0,3,0,3,1,2,3,0,3,3,-1,2,1,0,1,-14,-1,-3,4,-1,0,-1,1,0,-1,1,5,-1
KR_6700171312,420,-5,-65,-14,-14,-1,2,1,-8,12,4,-2,3,1,-3,4,1,0,4,4,-1,-4,-15,-1,-2,3,-2,0,-1,-1,-1,-1,-1,3,-1
KR_6724778022,420,4,45,-20,15,1,1,2,7,0,7,2,3,5,2,1,3,3,1,4,0,10,8,2,-2,0,0,0,2,-1,1,1,1,5,-1
KR_6662094752,420,1,-30,16,1,-4,4,0,1,1,2,3,0,3,0,2,2,1,0,1,0,3,-26,4,-5,1,0,0,-1,1,-1,-1,-1,4,-1
KR_6762761540,420,-3,-77,-16,-9,-6,6,0,1,3,4,-4,4,0,0,2,2,0,2,2,0,-7,18,-3,-2,5,0,0,-2,1,-1,-1,1,6,-1
KR_6731490751,420,-4,-27,-52,-9,-3,5,2,-5,5,0,0,2,2,-2,2,0,1,0,1,0,-10,-365,1,-3,2,-5,0,0,-1,-1,-1,-1,6,-1
KR_6717480290,420,1,33,8,-3,0,1,1,-3,6,3,0,2,2,-1,1,0,1,0,1,0,-5,-3,-2,-2,4,2,0,0,1,-1,0,1,5,-1
KR_6653473163,420,-1,15,-24,-11,-5,6,1,-5,5,0,-1,3,2,-1,1,0,1,0,1,0,-7,40,-4,0,4,-17,0,0,-1,-1,-1,-1,6,-1
KR_6660187661,440,1,-69,23,-7,-6,6,0,1,1,2,-5,7,2,3,1,4,0,0,0,0,-6,5,1,-5,4,-1,0,-1,-1,1,-1,-1,3,-1
KR_6730495695,420,-3,-129,-21,-11,-5,5,0,-3,3,0,1,2,3,0,4,4,-4,5,1,0,-4,-3,0,-4,4,-1,0,-4,1,-1,-1,-1,6,-1
KR_6756571833,420,-4,-47,-36,-11,2,1,3,2,0,2,-8,8,0,-9,10,1,2,0,2,0,-9,0,0,-2,2,-1,0,-2,-1,-1,-1,-1,3,-1
KR_6728892260,420,-3,-65,-11,-8,-3,4,1,-1,2,1,-1,6,5,-3,4,1,0,1,1,0,-3,-7,-1,-2,3,-2,0,-1,-1,-1,-1,-1,4,-1
KR_6728715615,440,1,42,34,1,2,3,5,-2,2,0,2,1,3,1,5,6,-2,6,4,0,3,-4,-3,-4,7,3,0,1,1,1,1,-1,2,-1
KR_6724143069,420,7,124,25,12,4,3,7,1,2,3,3,2,5,3,2,5,1,3,4,0,2,-12,0,-2,2,-1,0,2,0,0,1,-1,0,-1
KR_6763892970,420,-1,-89,-35,1,-3,6,3,-4,4,0,10,0,10,-3,6,3,1,0,1,0,6,2,1,-2,1,0,0,-1,1,0,-1,-1,3,-1
KR_6642343876,440,1,50,-12,2,2,2,4,3,1,4,2,2,4,-2,5,3,-3,3,0,0,-4,3,-2,-2,4,0,0,-1,-1,0,-1,-1,3,-1
KR_6758515885,420,-6,-90,-4,-19,-3,7,4,-1,3,2,-6,7,1,-8,9,1,-1,2,1,0,-21,-3,-2,-1,3,1,0,-2,-1,-1,-1,-1,2,-1
KR_6662787223,420,-3,3,-28,-13,-2,4,2,-7,8,1,-2,2,0,0,1,1,-2,2,0,0,-10,-1,-2,-2,4,-3,0,-1,-1,-1,-1,-1,3,-1
KR_6703124701,420,6,22,20,7,2,0,2,0,2,2,2,1,3,0,0,0,3,1,4,0,4,3,1,-2,1,1,0,0,1,0,0,-1,6,-1
KR_6747314645,420,5,69,4,9,5,1,6,-2,4,2,0,3,3,4,2,6,2,2,4,0,2,14,1,-1,0,2,0,0,1,0,0,-1,5,-1
KR_6749238062,420,0,-12,8,1,2,2,4,1,2,3,-1,2,1,-1,3,2,0,1,1,0,1,-97,2,-3,1,-2,0,0,1,0,0,-1,5,-1
KR_6756796865,420,-1,-72,-8,4,5,2,7,0,2,2,-3,5,2,2,2,4,0,0,0,1,11,0,1,-1,0,2,0,0,1,1,0,1,5,-1
KR_6730728519,420,0,-2,-9,-5,2,3,5,1,4,5,1,0,1,-6,6,0,-3,3,0,0,-10,21,0,-3,3,-1,0,1,-1,1,1,1,2,-1
KR_6741850233,420,-4,-77,-12,-6,-3,3,0,2,5,7,-5,6,1,-1,2,1,1,0,1,0,6,-64,-4,-2,6,-11,0,0,-1,0,-1,-1,1,-1
KR_6764235845,420,0,-18,-1,1,1,1,2,-1,2,1,-2,3,1,-1,2,1,4,0,4,0,0,-15,-4,-2,6,1,0,0,1,-1,0,-1,4,-1
KR_6755178236,420,-1,-30,2,-5,0,3,3,1,4,5,-4,5,1,-4,5,1,2,0,2,-1,-4,29,-3,-2,5,-38,0,-1,-1,0,-1,-1,6,-1
KR_6742275111,420,-5,-53,-16,-6,-5,6,1,0,2,2,0,2,2,-5,7,2,4,0,4,0,1,-14,0,-3,3,1,0,-1,0,1,1,1,0,-1
KR_6750244800,420,-5,-81,4,-8,-4,4,0,-4,6,2,-1,4,3,1,4,5,0,1,1,0,-6,-5,-3,-2,5,-4,0,-2,1,1,-1,-1,3,-1
KR_6729564694,420,-3,26,-36,-2,1,0,1,-2,2,0,-2,2,0,2,1,3,-1,1,0,0,-2,3,2,-4,2,-6,0,0,-1,-1,0,1,6,-1
KR_6722023800,420,-4,-80,-8,-6,-5,6,1,2,1,3,0,1,1,-2,3,1,-1,1,0,0,0,-35,-1,-1,2,32,0,-5,-1,0,-1,1,1,-1
KR_6663067954,420,0,42,48,1,1,0,1,1,2,3,-3,3,0,1,0,1,1,0,1,0,5,-222,1,-4,3,2,0,0,-1,-1,0,1,1,-1
KR_6676226231,420,-6,-63,-44,-10,0,1,1,-4,4,0,-3,4,1,-4,4,0,1,1,2,0,-9,-19,1,-3,2,-2,0,-5,-1,-1,-1,-1,1,-1
KR_6755684650,420,-2,-67,22,-8,0,1,1,0,0,0,-5,5,0,-1,2,1,-2,2,0,0,-4,29,0,-5,5,-21,0,0,-1,-1,0,-1,4,-1
KR_6751241131,420,-5,-67,4,-11,0,1,1,0,1,1,1,1,2,-11,12,1,-1,1,0,-1,-13,1,-7,-1,8,-1,0,-1,0,0,-1,-1,0,-1
KR_6644324999,420,4,17,32,6,1,1,2,4,2,6,3,2,5,-3,3,0,1,0,1,0,9,3,-1,0,1,-1,0,1,-1,1,1,1,4,-1
KR_6660032295,420,-1,-11,14,-4,-1,2,1,0,1,1,-2,3,1,-1,2,1,0,0,0,0,-5,-264,3,-7,4,0,0,0,-1,1,1,-1,5,-1
KR_6720507443,420,-3,-38,-3,-5,-4,6,2,0,2,2,-4,5,1,0,2,2,3,0,3,-1,3,50,7,-7,0,-35,0,0,-1,-1,-1,-1,4,-1
KR_6675874733,420,-2,-89,19,0,0,1,1,3,2,5,-5,5,0,4,6,10,-2,3,1,0,-7,3,-5,0,5,2,0,0,1,0,0,-1,6,-1
KR_6758851297,420,-6,-64,-14,-17,-2,3,1,-3,3,0,-6,6,0,-1,2,1,-5,5,0,-1,-9,-163,3,-5,2,-3,0,-1,-1,1,-1,-1,4,-1
KR_6747372150,420,-1,7,-12,-4,1,0,1,-6,6,0,3,1,4,-2,4,2,0,1,1,0,-10,6,0,0,0,0,0,0,1,-1,0,-1,4,-1
KR_6759082633,420,-5,-67,-48,-12,-5,5,0,-3,3,0,1,1,2,-4,4,0,-1,2,1,0,-6,4,1,-5,4,-5,0,1,1,1,1,-1,6,-1
KR_6726992876,420,-2,2,0,1,1,1,2,0,4,4,3,2,5,-4,6,2,1,1,2,0,-1,2,0,-5,5,0,0,-1,-1,-1,-1,-1,2,-1
KR_6738990925,420,-4,-7,-33,-17,2,1,3,-2,3,1,-11,11,0,-5,5,0,-1,1,0,0,-11,-6,-4,-1,5,1,0,-2,-1,-1,-1,-1,5,-1
KR_6751292782,440,0,-13,-37,-5,2,0,2,1,3,4,-2,3,1,-8,9,1,2,0,2,0,-8,3,-2,-4,6,-4,0,-1,-1,1,-1,-1,2,-1
KR_6750599463,420,-5,-32,9,-11,0,3,3,-4,5,1,-2,2,0,-4,6,2,-1,2,1,0,-10,0,1,-3,2,-1,0,0,-1,1,-1,1,2,-1
KR_6627188920,420,0,19,-1,3,-1,1,0,0,2,2,-1,2,1,4,1,5,1,0,1,-1,2,-16,-2,-1,3,1,0,0,-1,-1,0,-1,2,-1
KR_6763246454,420,-1,19,24,-3,0,3,3,3,1,4,-1,4,3,2,0,2,-7,8,1,1,1,1,4,-6,2,-2,0,-1,1,-1,-1,1,2,-1
KR_6760627621,420,-3,-68,-8,-7,-2,2,0,2,2,4,-6,7,1,0,2,2,-1,2,1,0,-3,-6,-4,-1,5,1,0,0,-1,0,0,1,5,-1
KR_6733550632,420,-2,-12,-20,-8,-6,7,1,-1,3,2,-3,4,1,1,1,2,1,0,1,0,2,3,0,-4,4,4,0,0,-1,0,0,-1,6,-1
KR_6690525814,440,0,1,2,-2,5,1,6,2,1,3,-1,2,1,-7,7,0,-1,1,0,0,-5,-16,-3,-2,5,3,0,-1,1,1,-1,-1,4,-1
KR_6751294410,440,3,3,-40,11,-3,4,1,2,1,3,6,0,6,3,0,3,3,0,3,0,8,-4,4,-6,2,-1,0,0,1,1,0,-1,6,-1
KR_6762830940,420,-2,-89,24,-8,-6,8,2,-1,5,4,-6,7,1,3,3,6,2,1,3,-1,4,-19,0,-2,2,1,0,-1,1,1,-1,-1,5,-1
KR_6754265890,420,-2,-3,-19,1,-2,5,3,0,2,2,-2,2,0,4,4,8,1,1,2,0,4,22,5,-5,0,0,0,-1,-1,0,-1,1,3,-1
KR_6712558100,420,-4,-123,-12,-2,0,4,4,0,2,2,2,1,3,-6,6,0,2,0,2,-1,3,-9,2,-6,4,1,0,-2,0,-1,-1,-1,0,-1
KR_6750681557,420,1,-6,5,6,-2,2,0,3,1,4,6,2,8,0,4,4,-1,2,1,0,3,-41,2,-3,1,25,0,0,-1,-1,0,-1,4,-1
KR_6755435128,420,-1,-37,15,-5,0,3,3,0,1,1,3,2,5,-7,8,1,-1,2,1,0,-5,-252,-4,-2,6,0,0,-1,-1,-1,-1,-1,2,-1
KR_6749907554,420,-1,-42,-14,3,-4,4,0,-1,3,2,-1,4,3,6,2,8,3,0,3,1,13,1,-1,-2,3,-6,0,0,1,-1,-1,1,4,-1
KR_6729190983,420,0,-1,-27,-5,1,0,1,-6,6,0,2,1,3,-3,3,0,1,1,2,1,-3,102,-1,-2,3,-3,0,1,-1,0,1,1,1,-1
KR_6756034020,420,-5,-81,-5,-12,-1,2,1,-3,3,0,-3,5,2,-2,7,5,-3,3,0,0,-13,-18,-1,-2,3,-2,0,-2,0,-1,-1,1,0,-1
KR_6716716908,420,-2,-8,-20,-2,4,0,4,-1,4,3,-3,3,0,-1,5,4,-1,4,3,0,-2,9,0,-2,2,-3,0,1,-1,1,1,-1,2,-1
KR_6717600004,420,-1,-23,-16,0,-2,2,0,-2,3,1,6,2,8,-1,2,1,-1,1,0,0,-1,-14,5,-6,1,1,0,0,-1,1,0,-1,4,-1
KR_6738304055,420,0,-18,-31,2,3,0,3,0,1,1,1,1,2,-2,2,0,0,1,1,-1,-2,3,1,-4,3,5,0,-1,1,-1,-1,-1,1,-1
KR_6696921096,420,0,-85,56,1,-1,1,0,2,2,4,-1,1,0,2,0,2,-1,3,2,0,6,-5,-4,0,4,-1,0,-1,1,1,-1,-1,2,-1
KR_6708794170,420,-6,-72,20,-10,0,1,1,-2,4,2,1,3,4,-5,6,1,-4,6,2,-2,-10,26,6,-8,2,-3,0,-1,0,0,-1,-1,0,-1
KR_6743585843,440,-2,-65,22,-7,-2,3,1,0,1,1,-6,6,0,1,1,2,0,2,2,0,4,3,3,-4,1,0,0,0,0,1,0,1,0,-1
KR_6699848004,420,-4,-78,-43,-7,3,1,4,-5,7,2,-7,11,4,2,2,4,0,0,0,0,0,-383,2,-4,2,0,0,-3,1,-1,-1,1,6,-1
KR_6637423515,420,-3,-45,-53,-6,0,4,4,1,3,4,-1,2,1,-6,7,1,0,1,1,0,-6,-2,2,-2,0,-3,0,-2,-1,-1,-1,1,5,-1
KR_6750454920,420,-6,-119,8,-16,-5,6,1,-4,5,1,-4,7,3,-4,6,2,1,1,2,0,-14,2,1,-2,1,0,0,-2,-1,1,-1,-1,2,-1
KR_6730644919,420,0,-19,-12,0,5,0,5,1,0,1,-1,4,3,-3,3,0,-2,2,0,0,-1,-13,-3,0,3,3,0,0,0,-1,0,-1,0,-1
KR_6731674706,420,-2,-34,-1,-12,-1,6,5,-1,2,1,-3,4,1,-3,5,2,-4,4,0,-1,-12,14,0,-2,2,1,0,-1,-1,-1,-1,-1,6,-1
KR_6746284959,420,-7,-22,-83,4,1,1,2,-5,5,0,1,2,3,8,0,8,-1,1,0,0,1,-100,-5,0,5,-1,0,0,-1,-1,1,1,3,-1
KR_6755062748,420,-5,-28,-5,-9,-1,2,1,-1,1,0,-4,5,1,-4,4,0,1,1,2,0,-6,-12,-2,0,2,3,0,0,-1,1,0,1,1,-1
KR_6759695603,420,0,39,-12,-3,2,2,4,-1,7,6,-2,5,3,2,2,4,-4,4,0,0,-8,227,3,-7,4,-2,0,0,-1,1,1,1,6,-1
KR_6702930370,420,-4,-110,4,-4,-1,4,3,-4,8,4,-4,4,0,-2,3,1,7,4,11,0,9,-3,3,-4,1,-1,0,-2,1,-1,-1,-1,2,-1
KR_6749665632,420,-1,-6,-8,-2,6,0,6,-4,4,0,-5,5,0,0,1,1,1,1,2,1,-6,1,-1,-6,7,-4,0,0,0,1,-1,1,0,-1
KR_6761751796,420,-2,-82,-19,-11,-2,5,3,-1,3,2,-2,3,1,-5,5,0,-1,2,1,-1,-11,-4,-1,-1,2,0,0,-1,-1,1,-1,-1,3,-1
KR_6652719072,420,-6,-84,8,-13,-1,3,2,0,4,4,-2,2,0,-10,10,0,0,0,0,0,-12,-6,-1,-3,4,2,0,-2,1,-1,-1,-1,5,-1
KR_6730668181,420,-2,27,9,-3,-3,3,0,0,2,2,-1,1,0,1,1,2,0,1,1,0,2,-127,0,-2,2,1,0,1,1,1,1,-1,6,-1
KR_6736117415,420,1,-2,5,3,2,0,2,1,0,1,-1,1,0,1,0,1,0,0,0,1,1,15,3,-3,0,-3,0,1,1,1,1,1,2,-1
KR_6663484387,420,-4,-74,-26,-12,-5,5,0,-2,4,2,-1,4,3,-2,4,2,-2,3,1,0,-7,-140,-1,-5,6,21,0,-2,-1,-1,-1,-1,3,-1
KR_6726678978,420,3,32,28,2,2,1,3,-1,2,1,-3,4,1,4,3,7,0,0,0,0,1,-13,1,-4,3,0,0,0,-1,-1,-1,1,5,-1
KR_6753664997,420,1,31,-21,3,0,3,3,2,0,2,-1,4,3,1,2,3,1,0,1,0,5,5,4,-5,1,1,0,0,1,0,0,-1,1,-1
KR_6740554422,420,-4,-35,-4,-14,-3,4,1,-4,6,2,1,0,1,-3,5,2,-5,5,0,-1,-7,-8,-2,0,2,-2,0,-2,-1,0,-1,-1,1,-1
KR_6712101109,420,0,-67,32,4,0,1,1,1,3,4,5,0,5,-2,3,1,0,4,4,1,6,-9,1,-2,1,-1,0,0,1,-1,0,1,6,-1
KR_6738847331,420,1,68,8,0,1,2,3,0,3,3,2,0,2,-3,3,0,0,0,0,1,-4,-5,-3,-2,5,2,0,0,-1,-1,1,1,4,-1
KR_6689210354,420,-2,5,-16,-6,5,2,7,-4,4,0,-5,7,2,-1,2,1,-1,2,1,0,-8,209,-1,-1,2,-2,0,1,1,1,1,1,6,-1
KR_6734473835,420,-1,-19,-5,-5,-3,3,0,0,6,6,-2,3,1,-1,3,2,1,1,2,2,4,10,5,-8,3,-1,0,1,1,-1,1,1,6,-1
KR_6645492969,420,0,10,-8,-5,2,0,2,-3,5,2,1,0,1,-4,4,0,-1,1,0,0,3,1,-1,-2,3,0,0,0,1,-1,0,1,1,-1
KR_6715360679,420,0,-25,-13,-3,-4,6,2,3,1,4,5,3,8,-4,5,1,-3,3,0,-3,-9,-18,-5,-2,7,3,0,-1,1,-1,-1,-1,6,-1
KR_6764380751,420,-4,-101,8,-7,1,0,1,-5,6,1,-1,2,1,-2,3,1,0,1,1,0,-4,-7,-2,0,2,-1,0,-2,-1,-1,-1,-1,3,-1
KR_6753750789,420,-4,-7,4,-11,-2,2,0,-5,6,1,1,1,2,-4,5,1,-1,1,0,0,-15,19,1,-5,4,-1,0,0,-1,-1,0,-1,3,-1
KR_6729470722,420,-2,21,12,-6,-1,1,0,-1,2,1,-1,4,3,0,3,3,-3,3,0,0,-5,4,0,-3,3,-2,0,0,-1,1,0,-1,1,-1
KR_6722555151,420,-7,-78,-30,-5,-3,3,0,-1,3,2,-3,4,1,-1,5,4,3,0,3,0,0,-1,-1,0,1,2,0,-3,-1,-1,-1,-1,4,-1
KR_6682792906,420,-3,-29,-7,-11,0,0,0,-9,13,4,1,4,5,-4,5,1,1,0,1,0,-4,-6,-5,-1,6,4,0,-2,1,0,-1,1,1,-1
KR_6740252413,440,-1,19,-21,-3,-2,3,1,1,6,7,1,1,2,-2,4,2,-1,1,0,0,0,3,-3,-4,7,0,0,2,-1,1,1,1,3,-1
KR_6721402695,420,3,115,20,-2,0,0,0,-6,8,2,-1,1,0,5,2,7,0,2,2,0,-5,28,0,-4,4,-26,0,0,-1,-1,1,1,5,-1
KR_6745994942,420,-3,-12,12,-3,-6,6,0,0,4,4,4,1,5,2,1,3,-3,5,2,0,-8,-278,-2,-5,7,-25,0,0,1,0,0,1,6,-1
KR_6713267342,420,-6,-62,-14,-8,-1,1,0,3,3,6,-5,5,0,-5,5,0,0,0,0,0,-1,-8,-2,-2,4,-3,0,-1,-1,1,-1,-1,2,-1
KR_6739993082,420,1,110,0,9,1,0,1,3,3,6,1,2,3,1,3,4,3,0,3,0,4,252,1,-3,2,0,0,2,1,-1,1,1,5,-1
KR_6738742424,420,2,15,29,-4,1,1,2,-5,5,0,0,0,0,1,0,1,-1,2,1,0,-3,12,1,-1,0,-1,0,0,-1,-1,1,1,2,-1
KR_6762694130,420,-4,-77,-19,-8,4,0,4,-2,2,0,-9,9,0,-2,2,0,1,2,3,0,-2,-3,0,-1,1,-3,0,-2,0,-1,-1,-1,0,-1
KR_6744149796,420,1,52,-8,-2,4,1,5,1,0,1,-2,5,3,-2,3,1,-3,3,0,0,-6,8,3,-5,2,-2,0,0,-1,1,0,-1,6,-1
KR_6659775968,420,1,-57,19,7,1,3,4,-2,4,2,9,2,11,-1,5,4,0,1,1,1,5,10,4,-4,0,-2,0,-1,1,-1,-1,1,4,-1
KR_6722376965,420,-1,-14,-19,-6,4,0,4,-1,3,2,-1,2,1,-3,4,1,-5,7,2,-1,-5,-3,-1,-2,3,3,0,0,0,0,0,-1,0,-1
KR_6695309144,420,-3,-98,-32,-1,-1,1,0,-1,5,4,2,1,3,0,2,2,-1,1,0,0,4,-17,0,-5,5,4,0,-1,1,-1,-1,-1,5,-1
KR_6755515600,420,-2,-66,-32,1,0,1,1,-2,3,1,1,3,4,1,3,4,1,0,1,-1,7,-3,4,-7,3,-1,0,0,-1,-1,-1,-1,3,-1
KR_6760204002,420,-1,29,8,-11,0,1,1,-4,5,1,-8,8,0,-1,2,1,2,0,2,0,-2,-29,-6,-2,8,1,0,1,-1,1,1,1,6,-1
KR_6754917323,420,-3,-5,7,-4,0,3,3,0,3,3,3,0,3,-4,6,2,-3,4,1,0,-8,-2,3,-4,1,-4,0,-2,-1,1,-1,-1,5,-1
KR_6737987392,420,-5,-69,-16,-11,-2,3,1,-2,5,3,-2,4,2,-2,3,1,-3,3,0,0,-7,103,-2,-1,3,3,0,-1,-1,-1,-1,-1,1,-1
KR_6728751269,420,-6,-137,-1,-12,-2,2,0,-3,7,4,-5,8,3,-2,4,2,0,0,0,-2,-4,-202,-1,-2,3,0,0,-3,-1,0,-1,-1,4,-1
KR_6726533053,420,-3,-57,-28,-4,0,1,1,1,0,1,0,4,4,-5,7,2,0,2,2,0,2,-4,2,-4,2,2,0,0,-1,1,0,-1,1,-1
KR_6736554217,420,-4,-79,24,-9,-2,2,0,0,2,2,-4,5,1,-2,2,0,-1,1,0,0,-6,-24,-2,-5,7,8,0,0,1,0,0,-1,2,-1
KR_6737941931,420,-4,5,3,-17,-2,3,1,-9,9,0,-4,6,2,-1,5,4,-1,1,0,0,-14,-3,-4,-1,5,-1,0,-2,-1,-1,-1,-1,4,-1
KR_6681489178,420,-2,5,-12,4,-1,2,1,2,2,4,9,2,11,-4,8,4,-2,2,0,0,5,5,2,-8,6,3,0,0,1,-1,1,1,6,-1
KR_6725251626,420,2,-12,16,1,0,0,0,4,2,6,2,1,3,-1,3,2,-4,4,0,0,-1,1,1,-6,5,0,0,0,-1,0,1,-1,3,-1
KR_6733488981,420,-5,-60,-6,-7,-4,4,0,-8,8,0,1,3,4,2,0,2,2,2,4,-1,-1,0,2,-3,1,1,0,-1,1,-1,-1,1,4,-1
KR_6733646869,420,-2,-46,31,-5,0,1,1,-2,3,1,1,2,3,-4,4,0,0,0,0,0,-4,-4,3,-3,0,-2,0,0,-1,0,0,1,1,-1
KR_6700699662,420,1,6,-32,0,-2,3,1,-3,4,1,7,0,7,-1,3,2,-1,1,0,0,-1,-9,0,-2,2,1,0,1,1,-1,1,-1,5,-1
KR_6762717161,420,1,-34,0,0,0,2,2,1,1,2,4,0,4,-2,2,0,-3,3,0,0,-4,-17,0,-6,6,-2,0,-1,-1,-1,-1,1,3,-1
KR_6700556155,420,0,35,-16,0,-2,5,3,0,0,0,1,0,1,-2,2,0,3,1,4,0,1,65,-1,-1,2,2,0,0,0,-1,1,-1,0,-1
KR_6757550748,420,-3,-17,11,-6,0,4,4,0,3,3,-3,4,1,-5,6,1,2,1,3,0,2,276,0,-3,3,4,0,-1,1,-1,-1,-1,5,-1
KR_6664313124,420,0,48,-20,-4,-2,2,0,0,2,2,-3,5,2,0,4,4,1,0,1,0,-7,0,0,-2,2,-1,0,0,0,1,-1,1,0,-1
KR_6762680253,420,-4,-14,20,-21,-4,5,1,-2,4,2,-5,5,0,-9,9,0,-1,3,2,-1,-17,-342,-4,0,4,-2,0,-2,-1,-1,-1,-1,2,-1
KR_6762712344,420,0,37,-19,4,0,0,0,-1,1,0,-2,6,4,7,2,9,0,2,2,1,9,91,1,-3,2,-2,0,0,1,-1,0,1,6,-1
KR_6684988957,420,2,-54,6,3,-5,6,1,4,1,5,0,6,6,0,4,4,4,0,4,-1,6,3,-3,-1,4,3,0,0,0,-1,-1,-1,0,-1
KR_6757025658,420,-1,20,4,-3,1,0,1,-4,4,0,6,0,6,-5,9,4,-1,2,1,0,-11,-10,0,-3,3,1,0,0,1,1,0,-1,3,-1
KR_6711205955,420,-6,-7,-34,-25,-7,9,2,-5,6,1,-2,6,4,-4,5,1,-7,7,0,0,-25,-1,1,-2,1,0,0,-3,-1,-1,-1,-1,2,-1
KR_6764391255,420,-5,-29,-5,-12,0,0,0,-4,4,0,-3,5,2,-3,5,2,-2,2,0,0,-9,220,-2,-2,4,-13,0,-1,1,-1,-1,-1,6,-1
KR_6746347116,420,-2,32,12,-9,-1,2,1,-1,3,2,1,3,4,-7,9,2,-1,2,1,0,-15,2,1,-3,2,-1,0,-1,1,1,-1,1,5,-1
KR_6753331673,420,-4,-41,-52,-9,0,1,1,-7,8,1,-1,5,4,0,2,2,-1,1,0,0,-11,208,1,-4,3,5,0,0,1,-1,-1,-1,2,-1
KR_6760460998,420,1,8,-28,-3,3,3,6,2,5,7,-6,8,2,-1,1,0,-1,2,1,0,-8,9,0,-1,1,-1,0,0,1,1,0,1,3,-1
KR_6725859427,420,0,38,-36,1,-5,5,0,2,0,2,0,3,3,4,1,5,0,0,0,0,4,115,0,-2,2,0,0,-1,1,-1,-1,1,5,-1
KR_6759774772,420,-1,21,-21,2,2,2,4,2,1,3,2,0,2,0,2,2,-4,5,1,0,2,-2,3,-4,1,2,0,-1,-1,1,1,1,4,-1
KR_6678344524,440,3,-60,-4,2,7,1,8,-1,2,1,2,1,3,-5,5,0,-1,2,1,0,-3,-27,7,-7,0,-1,0,1,1,1,1,-1,6,-1
KR_6658029616,420,-3,16,-36,-12,-1,3,2,-2,4,2,-6,6,0,-4,5,1,1,0,1,0,-9,-1,-1,-2,3,1,0,0,-1,-1,1,-1,2,-1
KR_6743071698,420,1,52,-9,3,7,0,7,0,2,2,-4,6,2,-1,1,0,1,0,1,1,6,28,-4,-1,5,3,0,-1,-1,0,-1,1,5,-1
KR_6753094152,420,-5,-16,-4,-11,-4,5,1,0,0,0,2,0,2,-8,9,1,-1,1,0,0,-16,5,-2,-2,4,-4,0,-1,-1,1,-1,-1,3,-1
KR_6761097883,420,1,0,28,-2,0,0,0,1,1,2,-3,5,2,1,0,1,-1,1,0,0,-1,-2,-2,-2,4,1,0,0,1,0,0,-1,6,-1
KR_6753878839,420,-1,-55,-43,-10,-8,10,2,-3,5,2,5,0,5,-4,7,3,0,1,1,-1,-4,-5,-3,-4,7,-2,0,-3,-1,-1,-1,-1,1,-1
KR_6754123049,420,0,28,-7,-2,0,2,2,-1,4,3,-4,4,0,0,0,0,3,1,4,0,-5,-5,-2,-5,7,-4,0,0,-1,-1,0,-1,4,-1
KR_6730677380,420,-3,-17,-28,0,1,2,3,5,0,5,-3,3,0,-3,3,0,0,2,2,0,-1,-12,0,-3,3,-2,0,-1,-1,1,-1,-1,3,-1
KR_6676013518,420,-7,-28,-68,-1,-3,3,0,1,1,2,-1,2,1,0,2,2,2,1,3,-1,1,-22,-2,-2,4,4,0,0,-1,-1,-1,-1,2,-1
KR_6683638308,420,-2,-38,-2,1,-4,5,1,-1,2,1,4,0,4,0,1,1,2,2,4,0,5,-257,0,-2,2,1,0,0,0,1,1,-1,0,-1
KR_6733342886,420,0,-8,28,-2,-8,9,1,-3,8,5,2,2,4,4,1,5,3,2,5,1,7,-2,-2,-3,5,3,0,-2,1,-1,-1,1,5,-1
KR_6761188109,420,2,-10,4,2,0,1,1,-1,2,1,1,2,3,2,1,3,0,1,1,1,3,6,1,-5,4,-2,0,0,0,-1,0,1,0,-1
KR_6747891960,420,-2,16,6,1,1,1,2,-2,2,0,6,1,7,0,1,1,-4,4,0,0,-5,-24,2,-4,2,-3,0,0,-1,0,0,1,2,-1
KR_6731420200,420,2,-6,16,-1,-7,7,0,2,1,3,2,0,2,0,2,2,2,0,2,-1,3,-11,-6,0,6,0,0,0,-1,-1,1,-1,4,-1
KR_6745023234,420,3,-25,32,4,-1,1,0,2,0,2,5,2,7,-2,5,3,0,1,1,-1,-9,-6,-1,-2,3,4,0,-1,1,-1,-1,-1,4,-1
KR_6740093338,440,-4,-68,-20,-7,-8,8,0,1,2,3,0,2,2,1,1,2,-1,3,2,0,-2,5,1,-2,1,-2,0,-1,-1,0,-1,-1,5,-1
KR_6712324153,420,-2,22,-27,-4,0,5,5,-1,3,2,-3,3,0,0,1,1,0,3,3,0,-4,5,4,-5,1,-1,0,0,0,1,1,1,0,-1
KR_6762454269,420,-2,-40,-36,1,0,2,2,-4,6,2,0,2,2,6,2,8,-1,1,0,0,-1,0,2,-4,2,5,0,-1,1,-1,-1,-1,6,-1
KR_6688261852,420,-4,-44,-3,-11,-5,5,0,1,3,4,0,3,3,-6,7,1,-1,3,2,0,-5,18,-3,-2,5,3,0,0,-1,1,0,1,3,-1
KR_6754838260,420,-2,-57,20,-17,-3,5,2,-3,4,1,-7,8,1,-3,3,0,-1,3,2,0,-12,430,-6,-1,7,-1,0,-2,-1,0,-1,-1,1,-1
KR_6760213140,420,-3,-70,-36,-3,1,1,2,0,0,0,1,0,1,-2,3,1,-3,3,0,0,-8,7,0,-4,4,-3,0,-1,-1,1,-1,-1,4,-1
KR_6760752793,420,-3,-82,-24,-8,-2,3,1,-5,6,1,1,2,3,-2,3,1,0,2,2,0,-8,-17,2,-4,2,-3,0,-1,1,1,-1,-1,4,-1
KR_6758593275,420,-5,-54,-13,-9,-5,5,0,-1,2,1,0,2,2,2,2,4,-5,5,0,0,-6,-5,0,-3,3,-2,0,-2,1,0,-1,-1,5,-1
KR_6713375051,420,-1,-59,7,-2,0,0,0,3,1,4,0,2,2,-4,4,0,-1,1,0,0,-1,5,-1,-1,2,-3,0,-1,-1,0,-1,1,1,-1
KR_6758581588,420,-2,-3,-25,-2,-2,3,1,3,0,3,-5,5,0,1,0,1,1,1,2,0,3,-21,2,-5,3,5,0,0,-1,-1,0,-1,2,-1
KR_6702837171,420,-1,19,-28,2,-7,7,0,2,0,2,3,0,3,2,1,3,2,0,2,1,7,5,0,-2,2,-2,0,0,-1,-1,1,1,1,-1
KR_6693350695,420,1,-43,-36,1,1,1,2,-1,1,0,-2,2,0,3,3,6,0,0,0,-1,7,-3,0,-3,3,-1,0,1,0,0,1,-1,0,-1
KR_6687257817,420,2,52,-19,7,-2,4,2,1,3,4,3,1,4,4,1,5,1,1,2,0,6,-13,4,-5,1,-1,0,0,1,0,-1,1,3,-1
KR_6755574476,420,-3,-87,-24,-3,1,0,1,-2,2,0,1,0,1,-2,2,0,-1,3,2,0,-2,-14,-6,0,6,3,0,-1,-1,-1,-1,-1,1,-1
KR_6698625106,420,-5,109,-84,-14,-7,7,0,-2,2,0,1,3,4,-6,7,1,0,0,0,0,-10,-2,1,-1,0,2,0,-3,-1,-1,-1,-1,3,-1
KR_6739851141,420,1,-22,24,1,3,1,4,-2,5,3,-4,4,0,1,0,1,3,1,4,0,-2,-2,-6,0,6,2,0,-1,-1,1,-1,-1,5,-1
KR_6707012159,420,0,-33,21,-2,3,0,3,2,0,2,-1,2,1,-4,5,1,-2,3,1,0,-7,-115,3,-6,3,-2,0,-1,-1,-1,-1,1,5,-1
KR_6732598464,420,-3,-70,-41,0,-2,3,1,4,0,4,-2,2,0,0,0,0,0,0,0,0,6,-7,-5,-2,7,4,0,-1,0,1,-1,1,0,-1
KR_6762813778,420,-5,5,-4,-10,0,2,2,-2,4,2,-4,4,0,-3,4,1,-1,4,3,0,-8,0,-2,-1,3,-1,0,-1,-1,1,-1,-1,1,-1
KR_6759508550,420,-2,-32,-10,-9,-3,3,0,-4,6,2,-8,12,4,6,3,9,0,0,0,-1,-6,-219,2,-2,0,3,0,-3,0,-1,-1,-1,0,-1
KR_6657367524,420,-4,-17,-28,-8,0,3,3,-5,5,0,-1,1,0,2,2,4,-4,5,1,0,-8,-117,-1,-5,6,1,0,-2,-1,-1,-1,1,2,-1
KR_6753584585,420,-3,-28,-20,-7,-3,5,2,-4,4,0,0,2,2,0,3,3,0,0,0,0,-3,30,-4,-1,5,-27,0,-1,-1,-1,-1,-1,1,-1
KR_6756812136,420,2,27,4,1,-1,1,0,1,1,2,2,0,2,-1,2,1,0,1,1,0,0,10,1,-4,3,-3,0,0,0,-1,0,1,0,-1
KR_6735526952,420,-1,-8,-12,2,1,0,1,-2,5,3,3,0,3,-1,4,3,1,0,1,2,3,3,2,-4,2,0,0,-1,-1,-1,-1,1,2,-1
KR_6638429044,420,1,-10,3,-1,0,0,0,2,0,2,2,0,2,-1,1,0,-4,4,0,0,-4,-10,2,-3,1,-2,0,0,1,-1,0,1,1,-1
KR_6661012083,420,-2,-21,-20,-13,-3,3,0,-5,5,0,-4,4,0,-1,2,1,0,1,1,0,-6,-170,-1,-3,4,1,0,-2,-1,-1,-1,1,6,-1
KR_6752829489,420,3,-92,40,3,-1,3,2,-1,3,2,2,0,2,4,1,5,-1,1,0,0,5,-61,-5,-1,6,31,0,0,-1,1,0,-1,2,-1
KR_6749889645,420,2,59,-8,1,3,0,3,-3,4,1,-1,3,2,0,1,1,2,1,3,0,0,-5,-3,-1,4,0,0,0,-1,-1,0,-1,5,-1
KR_6757475244,420,-1,14,-20,-1,-3,4,1,1,3,4,2,2,4,1,4,5,-2,2,0,0,4,-4,1,-3,2,-1,0,-1,-1,-1,-1,1,4,-1
KR_6735663707,420,1,-22,-20,-2,3,2,5,-6,9,3,-2,2,0,3,0,3,0,1,1,2,14,-1,1,-1,0,1,0,-2,-1,-1,-1,1,5,-1
KR_6762370029,420,-2,27,4,-8,-2,4,2,-5,5,0,-5,5,0,-2,4,2,6,0,6,0,4,39,-2,0,2,-11,0,-1,-1,1,1,-1,1,-1
KR_6745291554,420,-1,-25,-4,6,-2,3,1,0,5,5,1,5,6,6,1,7,1,1,2,0,9,11,0,-2,2,-2,0,-1,-1,1,-1,1,5,-1
KR_6657891162,420,-4,-27,-111,-10,0,2,2,2,0,2,0,2,2,-12,13,1,0,0,0,0,-6,-8,-3,-3,6,-2,0,-3,0,-1,-1,-1,0,-1
KR_6723329994,420,0,-14,8,-3,-1,1,0,-2,4,2,-1,1,0,1,0,1,0,2,2,0,-2,3,-1,-4,5,4,0,0,0,0,0,-1,0,-1
KR_6731769654,440,0,26,-1,-3,-2,2,0,-1,3,2,0,4,4,-1,1,0,1,3,4,0,-2,-28,-4,0,4,2,0,1,1,-1,1,-1,3,-1
KR_6753591412,420,-3,-60,-17,-6,-2,3,1,0,1,1,-1,2,1,-4,5,1,1,0,1,0,-3,-10,-3,-2,5,-2,0,-1,1,1,-1,-1,1,-1
KR_6742791998,440,1,-11,4,-1,-5,5,0,1,2,3,0,1,1,4,0,4,-1,2,1,0,5,4,3,-6,3,1,0,0,1,-1,1,-1,6,-1
KR_6757942806,420,-2,-77,0,-5,-5,5,0,0,1,1,-3,5,2,2,1,3,1,1,2,0,1,12,-3,0,3,0,0,-1,-1,1,-1,-1,4,-1
KR_6751383149,420,2,18,16,-1,1,3,4,0,2,2,3,0,3,-3,6,3,-2,2,0,0,-10,-7,2,-5,3,-2,0,0,1,1,0,-1,4,-1
KR_6727620850,420,-3,-27,4,-15,-1,2,1,0,0,0,-2,6,4,-7,10,3,-5,5,0,0,-15,1,-5,-4,9,-1,0,0,-1,-1,0,1,2,-1
KR_6742714541,420,-5,-72,-28,-12,6,0,6,-4,5,1,-5,6,1,-4,4,0,-5,6,1,0,-9,24,2,-4,2,-33,0,-1,-1,1,-1,-1,2,-1
KR_6759698539,420,-2,-96,-20,-6,-3,5,2,-3,4,1,0,2,2,-3,4,1,3,1,4,0,-7,7,-1,-3,4,3,0,0,-1,-1,-1,1,5,-1
KR_6764582617,420,-2,-19,-20,-7,-6,9,3,-3,4,1,-1,4,3,5,4,9,-2,3,1,1,-7,2,0,-4,4,0,0,-2,-1,-1,-1,1,1,-1
KR_6619381611,420,1,-56,0,0,-2,4,2,-2,3,1,3,1,4,1,2,3,0,1,1,0,1,-7,-2,-4,6,1,0,-1,-1,1,-1,-1,3,-1
KR_6749791376,420,-8,-120,25,-18,-1,2,1,-4,4,0,-5,6,1,-4,4,0,-4,4,0,-1,-14,-4,-2,0,2,2,0,-3,-1,-1,-1,-1,5,-1
KR_6759178059,420,-2,-41,-66,-2,0,1,1,-7,8,1,4,1,5,-2,4,2,3,0,3,0,-2,10,-2,-1,3,-2,0,1,1,-1,-1,-1,3,-1
KR_6695342791,440,-7,-64,20,-16,0,3,3,-3,5,2,-4,5,1,-5,6,1,-4,4,0,0,-15,-20,-4,-1,5,1,0,-2,-1,-1,-1,-1,5,-1
KR_6759024456,420,-2,-12,-13,-4,2,1,3,1,2,3,-4,5,1,-5,5,0,2,1,3,0,0,-4,-4,-1,5,-1,0,-1,-1,0,-1,-1,5,-1
KR_6762943526,420,-5,-11,-12,-11,1,1,2,-1,2,1,0,3,3,-6,6,0,-5,5,0,0,-10,-1,0,-3,3,-2,0,0,1,1,0,-1,6,-1
KR_6753671632,420,0,6,-23,6,-3,5,2,3,1,4,6,1,7,0,3,3,0,0,0,-1,1,-67,4,-5,1,23,0,0,1,1,0,-1,1,-1
KR_6727608078,420,0,-65,-7,-6,1,1,2,0,5,5,0,2,2,-4,4,0,-3,3,0,0,-7,-5,0,-3,3,2,0,-1,-1,-1,-1,-1,1,-1
KR_6748724071,420,1,-83,7,0,3,2,5,3,2,5,1,5,6,-7,11,4,0,1,1,-4,-3,-3,0,-4,4,-1,0,-1,1,1,-1,-1,3,-1
KR_6753824030,420,-1,-26,24,3,-4,4,0,3,2,5,-2,3,1,-2,4,2,8,1,9,0,8,3,2,-3,1,2,0,-2,-1,-1,-1,-1,1,-1
KR_6764205575,420,-3,-33,-8,-8,-1,5,4,0,1,1,-7,8,1,0,1,1,0,1,1,0,7,7,3,-3,0,-2,-1,-3,-1,-1,-1,-1,1,-1
KR_6747338369,420,0,4,-36,3,-11,11,0,5,0,5,4,0,4,3,0,3,2,0,2,1,15,-6,-1,0,1,1,0,-1,1,-1,-1,1,1,-1
KR_6639775042,420,-4,-34,-11,-7,-2,4,2,-1,1,0,-6,8,2,0,0,0,2,0,2,0,-10,23,-1,-1,2,2,0,0,-1,-1,0,1,2,-1
KR_6728302374,420,-1,-42,32,-3,3,2,5,1,2,3,-7,10,3,-1,5,4,1,0,1,0,1,-3,2,-2,0,-3,0,0,1,1,-1,1,5,-1
KR_6694320463,420,2,48,20,-3,-1,1,0,0,4,4,2,0,2,-4,4,0,0,4,4,0,-8,30,2,-3,1,-31,0,-1,1,-1,1,-1,3,-1
KR_6764539597,420,-4,7,-20,-6,0,2,2,-2,3,1,-2,2,0,-1,5,4,-1,2,1,0,-3,139,2,-4,2,1,0,0,1,0,0,-1,4,-1
KR_6727564547,420,-2,1,-26,-7,0,3,3,-3,3,0,4,2,6,-1,3,2,-7,9,2,-1,-1,387,0,-1,1,0,0,0,-1,1,0,-1,1,-1
KR_6761394915,420,-2,28,-4,3,1,1,2,-4,4,0,4,0,4,1,1,2,1,1,2,0,1,-33,-2,-2,4,19,0,0,1,-1,0,1,5,-1
KR_6641711439,420,5,-48,32,8,1,4,5,4,1,5,4,0,4,-2,2,0,1,0,1,0,6,4,-1,-2,3,-1,0,-1,1,-1,-1,-1,1,-1
KR_6762467061,420,-5,-21,-16,-14,-3,3,0,-2,5,3,-1,5,4,-2,5,3,-6,6,0,2,-15,-18,-2,-2,4,0,0,-2,1,-1,-1,1,2,-1
KR_6732287648,420,-3,-28,-20,-6,0,0,0,-2,2,0,-3,4,1,-3,3,0,2,1,3,0,-5,-9,-4,-3,7,-3,0,1,-1,1,1,-1,2,-1
KR_6749940772,420,-2,-108,-4,-9,-1,5,4,-2,5,3,3,1,4,-7,9,2,-2,2,0,-1,-10,-404,2,-3,1,-2,0,0,1,0,-1,1,6,-1
KR_6763324374,440,-4,-19,24,-8,2,1,3,-5,5,0,-6,6,0,-4,6,2,5,0,5,-2,-17,-6,-3,-1,4,2,0,-1,-1,0,-1,-1,3,-1
KR_6723470002,420,-2,-97,20,-17,-13,13,0,-5,5,0,1,2,3,0,1,1,0,2,2,-1,-3,8,-2,-1,3,0,0,0,0,0,-1,-1,0,-1
KR_6728593603,440,-4,-100,-27,-10,-6,6,0,-3,4,1,0,1,1,1,3,4,-2,3,1,-1,-2,-3,3,-6,3,-2,0,-2,1,-1,-1,-1,5,-1
KR_6739380389,420,0,29,-7,9,-3,4,1,0,2,2,2,2,4,6,2,8,4,0,4,1,8,4,-1,-3,4,2,0,0,1,-1,0,1,2,-1
KR_6761354942,420,-3,-89,-23,-11,-1,3,2,-2,3,1,-8,9,1,-2,2,0,2,0,2,0,-7,4,4,-4,0,-1,0,-1,-1,-1,-1,-1,6,-1
KR_6761228665,420,-5,-41,-35,-11,0,0,0,0,1,1,2,0,2,-9,9,0,-4,4,0,0,-17,3,2,-4,2,-1,0,-1,0,-1,-1,-1,0,-1
KR_6699106796,440,-1,-2,1,-1,0,2,2,-1,2,1,5,2,7,-4,9,5,-1,2,1,0,-3,-3,1,-4,3,1,0,0,-1,1,0,1,3,-1
KR_6754212817,420,-1,-48,5,0,0,1,1,0,5,5,0,1,1,2,2,4,-2,2,0,0,4,14,5,-6,1,2,0,0,1,-1,0,1,2,-1
KR_6698467612,420,-1,-41,4,-7,-5,7,2,0,2,2,2,3,5,-4,6,2,0,1,1,0,4,2,-3,-2,5,-3,0,-2,1,-1,-1,-1,5,-1
KR_6723244124,420,0,-39,-7,-3,-1,5,4,0,2,2,-1,2,1,1,3,4,-2,2,0,-1,4,102,-5,-1,6,2,0,0,0,-1,-1,-1,0,-1
KR_6757978091,420,0,43,15,0,5,0,5,0,1,1,-4,4,0,0,1,1,-1,1,0,0,0,36,1,-6,5,-18,0,0,-1,1,-1,-1,6,-1
KR_6674082777,420,1,9,-16,7,6,0,6,2,3,5,-4,4,0,1,1,2,2,3,5,0,7,269,-2,-2,4,2,0,1,1,-1,1,1,6,-1
KR_6730006670,420,-3,42,-16,-11,2,2,4,-3,3,0,-3,4,1,-6,7,1,-1,2,1,0,-8,-1,2,-4,2,-4,0,-1,1,0,-1,-1,4,-1
KR_6749910189,420,0,46,12,-9,1,2,3,-1,1,0,3,0,3,-10,12,2,-2,4,2,0,-14,6,1,-2,1,1,0,0,1,-1,0,-1,1,-1
KR_6743203782,440,-5,-83,-38,-5,-1,2,1,-4,6,2,-2,2,0,0,4,4,2,0,2,0,-3,2,-2,-1,3,0,0,-2,-1,-1,-1,1,2,-1
KR_6706509644,420,-3,-66,-12,-7,-1,2,1,-2,2,0,-1,1,0,-4,5,1,1,0,1,0,-3,17,-2,-4,6,-3,0,-1,-1,0,-1,-1,3,-1
KR_6647427040,420,-2,-41,8,-4,-1,2,1,0,1,1,-1,3,2,-1,3,2,-1,1,0,0,0,49,1,-2,1,0,0,-1,1,-1,-1,-1,2,-1
KR_6760532277,420,1,44,-40,-2,-2,4,2,1,2,3,-4,4,0,-1,2,1,4,1,5,0,-5,-282,3,-4,1,-2,0,1,-1,-1,1,1,6,-1
KR_6756008332,420,-7,-132,8,-14,-10,10,0,0,4,4,-4,5,1,1,2,3,-1,2,1,-1,-7,40,0,-3,3,-13,0,-3,0,0,-1,-1,0,-1
KR_6717861862,420,-4,-63,-11,-5,-2,3,1,-3,4,1,0,1,1,0,1,1,0,0,0,0,-5,2,2,-3,1,2,0,0,1,1,0,-1,4,-1
KR_6720435610,420,0,-38,5,-1,-1,1,0,-2,4,2,-2,2,0,3,1,4,1,0,1,0,2,10,2,-3,1,-2,0,1,1,-1,1,-1,1,-1
KR_6745477946,420,-2,-5,-2,-6,-2,2,0,-2,3,1,0,1,1,-2,3,1,0,2,2,0,-3,-2,-2,-5,7,0,0,0,-1,1,0,-1,1,-1
KR_6692539059,420,0,12,20,-7,2,0,2,1,1,2,-7,8,1,-2,2,0,-1,2,1,1,-7,-3,3,-6,3,0,0,0,-1,1,0,1,3,-1
KR_6752910545,420,-1,-36,-20,-3,-1,2,1,1,1,2,-2,2,0,0,1,1,-1,2,1,0,-2,5,1,-2,1,2,0,-3,1,-1,-1,-1,6,-1
KR_6693663055,420,-2,7,4,-1,-2,3,1,3,3,6,-1,1,0,-3,7,4,2,0,2,0,4,41,-1,-6,7,-24,0,-1,1,-1,-1,-1,3,-1
KR_6759278629,420,-1,-1,-16,-10,2,2,4,-3,4,1,-2,4,2,-8,8,0,1,0,1,0,-14,-256,-2,-1,3,1,0,-3,0,-1,-1,1,0,-1
KR_6717324100,420,-1,-9,-8,4,0,1,1,1,1,2,2,1,3,0,4,4,1,1,2,0,8,3,-1,-2,3,-3,0,0,-1,-1,-1,1,6,-1
KR_6762558646,420,-2,-32,16,-6,-3,4,1,0,4,4,-4,7,3,1,1,2,0,0,0,0,0,83,-1,-2,3,0,0,0,1,-1,-1,-1,1,-1
KR_6754946196,420,4,17,-8,11,3,1,4,-1,5,4,4,2,6,5,1,6,0,3,3,1,12,-7,0,-4,4,0,0,0,-1,1,1,1,3,-1
KR_6750656045,420,-5,-56,8,-16,-3,3,0,-2,3,1,-5,6,1,-5,7,2,-1,2,1,0,-21,-4,1,-3,2,-3,0,0,1,-1,-1,-1,3,-1
KR_6726426201,420,1,15,-12,1,2,0,2,1,4,5,-4,6,2,-1,1,0,3,1,4,0,1,11,0,-5,5,-3,0,0,-1,-1,0,-1,4,-1
KR_6703829535,420,-1,-2,6,-7,1,3,4,1,2,3,-9,10,1,0,1,1,0,0,0,-1,-2,348,0,-3,3,-1,0,0,1,1,0,-1,2,-1
KR_6749919264,420,-1,5,8,-8,3,1,4,-9,9,0,0,4,4,-4,7,3,2,1,3,2,-8,-235,-2,0,2,-20,0,-2,-1,-1,1,1,1,-1
KR_6733436111,420,-1,2,-32,-6,0,0,0,-7,8,1,-3,5,2,5,1,6,-1,2,1,0,-3,7,1,-7,6,-6,0,-1,1,-1,-1,1,4,-1
KR_6739153427,420,-1,-53,21,-1,2,1,3,4,0,4,-4,4,0,-1,5,4,-2,3,1,1,0,7,-3,-2,5,-2,0,-2,0,-1,-1,1,0,-1
KR_6621950357,420,-2,-21,28,-8,2,1,3,0,3,3,-7,7,0,-3,5,2,0,0,0,0,-9,8,-1,-1,2,-2,0,-2,-1,-1,-1,-1,6,-1
KR_6753320469,420,8,84,14,25,6,3,9,-1,3,2,1,2,3,8,0,8,11,2,13,1,12,7,0,-2,2,0,0,1,0,-1,1,1,0,-1
KR_6750899706,420,-5,36,-36,-9,-5,5,0,-3,4,1,-1,3,2,0,1,1,0,0,0,0,-6,-21,1,-4,3,-2,0,0,-1,0,0,-1,3,-1
KR_6733761651,420,0,11,4,0,2,0,2,-2,3,1,-1,3,2,1,0,1,0,1,1,0,-2,5,1,-2,1,0,0,0,-1,0,0,1,5,-1
KR_6751251807,420,1,39,-20,4,-1,3,2,0,2,2,-2,2,0,0,2,2,7,0,7,2,0,6,-1,-3,4,2,0,-2,0,-1,-1,1,0,-1
KR_6738119573,420,-4,-5,-1,-2,1,0,1,-3,6,3,-2,4,2,0,1,1,2,4,6,0,2,1,-3,-1,4,0,0,1,-1,-1,1,1,2,-1
KR_6753963129,420,0,-32,-8,-2,-2,3,1,1,0,1,2,1,3,-5,5,0,2,1,3,0,0,134,0,-5,5,0,0,0,1,1,0,-1,3,-1
KR_6755602185,420,-1,-40,8,3,-1,1,0,1,2,3,0,1,1,2,2,4,1,0,1,1,3,-7,1,-6,5,-1,0,-1,-1,-1,-1,1,6,-1
KR_6649138362,420,-2,-11,-12,2,1,2,3,1,2,3,-7,8,1,3,0,3,4,0,4,0,8,3,-3,0,3,1,0,0,-1,0,1,-1,1,-1
KR_6762984283,420,-5,-53,-39,-10,-4,4,0,-2,2,0,0,2,2,-4,4,0,0,2,2,0,-7,-32,1,-6,5,-1,0,0,0,0,-1,-1,0,-1
KR_6730277190,420,1,-58,-32,0,1,1,2,-2,6,4,-3,6,3,3,0,3,1,0,1,-3,-2,-9,-3,0,3,-1,0,-1,-1,-1,-1,-1,1,-1
KR_6748958129,420,-1,-82,13,-5,-1,2,1,2,3,5,-1,4,3,-6,8,2,1,2,3,-1,-7,-38,-3,-1,4,25,0,0,1,-1,-1,-1,1,-1
KR_6749182455,440,-1,-41,0,-2,-1,2,1,-4,4,0,0,1,1,2,0,2,1,1,2,0,-4,-38,-4,-1,5,34,0,0,0,-1,0,-1,0,-1
KR_6763170742,420,-1,-71,8,-2,0,2,2,-1,3,2,1,0,1,-4,4,0,2,1,3,0,-7,0,0,-4,4,-2,0,0,1,0,0,-1,4,-1
KR_6762300826,420,1,4,0,-4,-2,2,0,1,0,1,-4,8,4,3,1,4,-2,2,0,0,-6,1,3,-3,0,-1,0,0,-1,-1,0,-1,3,-1
KR_6757933346,440,-3,-20,-16,-8,-4,4,0,1,4,5,-1,3,2,-3,5,2,-1,1,0,-1,-8,2,0,-6,6,-2,0,-2,-1,-1,-1,-1,1,-1
KR_6707646406,440,1,-29,-22,4,0,1,1,1,2,3,0,2,2,5,0,5,-2,5,3,4,7,292,1,-4,3,1,0,2,1,1,1,1,3,-1
KR_6719381378,420,-4,2,-20,-18,0,1,1,-3,4,1,-10,10,0,-4,4,0,-1,3,2,1,-7,6,2,-4,2,-2,0,-2,1,1,-1,1,1,-1
KR_6647315204,420,-2,31,50,-6,-1,2,1,-3,6,3,0,0,0,-1,2,1,-1,1,0,-1,-10,-248,-1,-2,3,-1,0,-1,-1,1,-1,-1,2,-1
KR_6736417138,420,-5,-41,-12,-9,1,0,1,-7,7,0,1,1,2,-1,3,2,-3,3,0,0,-11,-12,0,-1,1,0,0,-1,-1,-1,-1,-1,3,-1
KR_6715136897,420,-1,-63,6,-2,-1,2,1,0,0,0,-4,4,0,2,2,4,1,1,2,0,2,26,-1,-3,4,3,0,0,-1,-1,0,-1,3,-1
KR_6756590708,420,1,-9,12,8,2,2,4,-4,6,2,5,2,7,1,4,5,4,0,4,0,-3,-26,-1,-3,4,0,0,1,1,-1,1,1,2,-1
KR_6759988041,420,-1,-21,-28,5,0,0,0,3,3,6,1,3,4,0,2,2,1,0,1,0,6,64,0,-3,3,0,0,0,1,1,0,1,4,-1
KR_6706850759,440,-5,-64,-6,-10,-9,11,2,-7,8,1,1,2,3,-2,3,1,7,0,7,1,-7,-8,0,-1,1,3,0,-2,-1,0,-1,1,2,-1
KR_6743223167,420,-1,12,24,-12,-2,3,1,-3,3,0,0,5,5,-7,8,1,0,1,1,-2,-19,-1,1,-2,1,2,0,-1,-1,1,-1,-1,3,-1
KR_6706482250,420,3,12,16,1,4,3,7,2,3,5,-3,3,0,-3,4,1,1,0,1,-1,-14,-1,-2,0,2,0,0,-2,-1,-1,-1,-1,6,-1
KR_6753330648,420,-1,-64,8,-3,5,1,6,-3,6,3,0,4,4,-4,5,1,-1,4,3,0,-6,-435,-6,0,6,-1,0,0,1,-1,1,-1,6,-1
KR_6652830073,420,-7,-102,-66,-14,-6,7,1,0,0,0,-2,3,1,-3,3,0,-3,5,2,-2,-5,-50,-3,0,3,9,0,-3,-1,-1,-1,-1,1,-1
KR_6643884149,420,0,-32,24,2,-2,2,0,6,2,8,-2,2,0,1,0,1,-1,1,0,1,12,-6,-1,-2,3,-1,0,0,-1,-1,0,1,3,-1
KR_6634131432,420,-1,-63,1,-4,-1,3,2,-1,2,1,-7,7,0,5,2,7,0,3,3,0,6,-3,0,-2,2,-3,0,-1,-1,-1,-1,-1,4,-1
KR_6761773870,420,-5,-74,-34,-10,-3,3,0,-2,3,1,-2,3,1,-2,4,2,-1,2,1,0,-5,14,2,-3,1,-2,0,0,0,0,0,-1,0,-1
KR_6761109804,420,-2,43,15,0,0,2,2,-3,3,0,1,2,3,0,1,1,2,1,3,0,0,6,-2,-2,4,4,0,1,-1,1,1,1,3,-1
KR_6684106599,420,-4,-57,26,-16,2,1,3,-4,4,0,-4,4,0,-8,10,2,-2,3,1,0,-13,-15,0,-1,1,-1,0,-2,-1,1,-1,1,6,-1
KR_6763142042,420,-4,-44,-32,-13,-4,5,1,-4,6,2,2,3,5,-8,9,1,1,4,5,-2,-5,-10,-3,0,3,-1,0,0,-1,-1,-1,-1,3,-1
KR_6744025382,420,-1,-22,1,1,0,0,0,-2,3,1,-1,1,0,1,2,3,3,0,3,0,0,-115,-1,-3,4,2,0,0,1,1,0,1,5,-1
KR_6636205952,420,0,-59,-1,-11,2,2,4,-6,6,0,-3,6,3,-2,2,0,-2,2,0,1,-12,2,-2,-3,5,-4,0,-1,1,1,-1,1,5,-1
KR_6667929071,420,2,-8,3,4,-1,1,0,6,1,7,4,0,4,-2,4,2,-3,4,1,0,-1,30,0,-1,1,-27,0,-1,1,1,-1,1,6,-1
KR_6759274260,420,-5,-71,-60,-6,-1,4,3,-1,4,3,-3,4,1,-4,4,0,3,3,6,0,-2,-164,1,-3,2,-2,0,-3,-1,-1,-1,1,6,-1
KR_6683262810,420,0,-6,-21,-2,0,1,1,-2,4,2,-3,4,1,0,2,2,3,0,3,1,1,6,-1,-4,5,0,0,0,-1,1,0,1,3,-1
KR_6756318541,420,0,29,-12,4,-1,3,2,2,2,4,-2,3,1,6,1,7,-1,1,0,0,6,6,2,-3,1,-1,0,1,-1,1,1,1,1,-1
KR_6746115019,420,-8,-83,-40,-17,-5,6,1,-3,3,0,-6,8,2,-1,3,2,-2,2,0,0,-10,-11,0,-1,1,-1,0,-4,-1,-1,-1,1,3,-1
KR_6666786577,440,-9,-34,-4,-25,-3,5,2,-6,6,0,-6,7,1,-7,8,1,-3,3,0,0,-17,-165,-1,0,1,1,0,-3,-1,-1,-1,1,5,-1
KR_6760943204,420,-2,-30,-2,-7,0,2,2,-2,3,1,-3,6,3,0,1,1,-2,2,0,0,-3,-16,0,-3,3,-3,0,0,-1,1,0,-1,5,-1
KR_6753365524,420,-5,-121,8,-16,2,1,3,-2,4,2,-2,3,1,-4,4,0,-10,10,0,-1,-25,-10,-2,0,2,0,0,-1,-1,0,-1,-1,5,-1
KR_6748419465,420,1,-2,35,0,-1,1,0,-1,2,1,-1,3,2,1,0,1,2,0,2,0,-1,7,0,-1,1,0,0,2,0,-1,1,-1,0,-1
KR_6762218562,420,-2,35,-19,0,-1,2,1,-2,4,2,6,0,6,-2,3,1,-1,1,0,0,-5,-11,-3,0,3,0,0,0,-1,0,0,1,6,-1
KR_6743097133,420,-3,-16,28,-3,-3,4,1,0,1,1,-3,4,1,3,0,3,0,2,2,0,-3,-303,2,-3,1,-3,0,-1,1,-1,-1,-1,5,-1
KR_6718523588,420,0,-82,-40,3,2,0,2,3,2,5,3,0,3,-3,5,2,-2,3,1,0,1,25,6,-7,1,2,0,-2,-1,-1,-1,-1,1,-1
KR_6751185809,440,0,-1,36,-1,2,1,3,-2,3,1,2,2,4,-2,6,4,-1,4,3,0,-6,9,1,-1,0,-1,0,-2,-1,-1,-1,1,1,-1
KR_6688733151,420,-1,54,-4,-6,-1,1,0,-3,4,1,4,0,4,-4,4,0,-2,2,0,0,-9,-5,-3,-1,4,-1,0,-1,-1,-1,-1,-1,4,-1
KR_6741364306,420,-2,12,-26,-2,-1,2,1,-2,5,3,2,0,2,-6,7,1,5,0,5,0,1,-54,-6,-3,9,21,0,-1,1,-1,-1,1,2,-1
KR_6754177574,420,0,1,-4,3,1,1,2,0,2,2,1,0,1,0,1,1,1,3,4,1,9,-246,-1,-3,4,-3,0,0,-1,-1,0,1,3,-1
KR_6753844095,420,0,5,-8,-5,3,1,4,1,3,4,-3,3,0,-4,7,3,-2,2,0,-2,-5,6,3,-5,2,-5,0,-3,-1,-1,-1,-1,2,-1
KR_6722663057,420,3,120,-4,4,3,2,5,1,1,2,-1,4,3,2,3,5,-1,3,2,0,2,60,-1,-2,3,-14,0,0,-1,1,1,1,1,-1
KR_6720477263,420,4,-10,51,9,-1,3,2,2,0,2,3,0,3,2,0,2,3,1,4,0,14,-7,-2,-1,3,3,0,0,0,0,0,1,0,-1
KR_6695266245,420,-5,-110,-40,-7,-1,3,2,-3,3,0,-4,4,0,-2,3,1,3,1,4,0,-5,4,-3,0,3,0,0,-4,-1,-1,-1,1,2,-1
KR_6763472835,420,-2,1,-20,-5,-1,1,0,0,1,1,-1,1,0,3,0,3,-6,6,0,0,-4,-5,3,-3,0,0,0,0,1,-1,-1,-1,1,-1
KR_6763034097,420,-7,-99,-8,-20,-5,5,0,0,2,2,-2,5,3,-13,13,0,0,1,1,-1,-11,10,-3,0,3,-4,0,-2,-1,-1,-1,-1,1,-1
KR_6678140868,420,1,98,-20,0,0,2,2,1,1,2,-1,2,1,0,1,1,0,1,1,0,5,170,-2,0,2,0,0,1,1,-1,1,-1,2,-1
KR_6750811899,420,-2,-11,-11,-5,-9,9,0,0,1,1,5,1,6,-1,5,4,0,0,0,0,-7,5,-2,-1,3,-7,0,-1,-1,1,1,-1,1,-1
KR_6707619444,420,-5,-55,8,-10,-11,12,1,-2,5,3,4,1,5,-3,3,0,2,0,2,1,-4,6,0,-4,4,-1,0,-1,0,-1,-1,1,0,-1
KR_6762379979,420,2,-8,25,2,2,0,2,-2,5,3,0,2,2,1,1,2,1,0,1,0,1,115,1,-2,1,0,0,1,1,-1,-1,1,3,-1
KR_6685008227,420,-6,-90,-57,-15,-4,5,1,-8,9,1,-1,2,1,-4,6,2,2,0,2,0,-5,-1,-1,-2,3,1,0,-1,-1,0,-1,1,1,-1
KR_6755204226,420,-2,-22,-9,-2,-2,2,0,-1,1,0,1,1,2,-1,1,0,1,0,1,0,-1,-6,-1,-1,2,1,0,0,1,1,0,-1,2,-1
KR_6704945409,420,-5,-8,-18,-5,-1,1,0,-3,3,0,0,1,1,-4,5,1,3,1,4,1,1,-6,-1,0,1,0,0,-1,0,-1,-1,1,0,-1
KR_6728328466,420,-7,-88,-8,-16,-5,5,0,-3,5,2,-1,3,2,-3,4,1,-4,4,0,-1,-19,8,0,-1,1,-3,0,-1,-1,1,-1,-1,4,-1
KR_6761155213,420,0,-17,-6,6,2,1,3,0,3,3,4,2,6,-1,5,4,1,0,1,-1,2,-371,-1,-5,6,1,0,0,-1,-1,0,-1,2,-1
KR_6686420076,420,1,-5,0,-2,1,1,2,-6,6,0,2,1,3,1,3,4,0,0,0,0,-6,-4,-4,0,4,0,0,0,-1,1,0,-1,4,-1
KR_6762259811,420,-1,-27,-8,-4,-4,4,0,-1,3,2,1,5,6,1,1,2,-1,1,0,0,-2,2,-4,0,4,1,0,0,0,-1,1,1,0,-1
KR_6743614090,420,0,-44,28,-4,-3,5,2,1,3,4,0,1,1,-1,3,2,-1,3,2,0,2,-3,-6,-1,7,4,0,-1,1,1,-1,-1,6,-1
KR_6759552269,440,-6,6,-12,-8,-5,5,0,-1,3,2,-5,6,1,2,1,3,1,1,2,0,1,-1,-3,-2,5,2,0,-1,-1,-1,-1,1,6,-1
KR_6658764753,420,-3,-44,-24,-2,-1,2,1,-1,3,2,-1,1,0,0,4,4,1,1,2,0,-3,2,3,-4,1,-3,0,0,1,-1,0,1,5,-1
KR_6753902144,420,-5,-139,-28,-13,-1,1,0,-1,2,1,-7,8,1,-3,3,0,-1,1,0,-1,-3,-1,-2,0,2,-2,0,-2,-1,0,-1,-1,5,-1
KR_6682891026,420,-3,15,-8,-4,5,0,5,-5,6,1,-6,6,0,-2,3,1,4,0,4,1,-4,1,6,-6,0,-1,0,0,-1,-1,-1,1,3,-1
KR_6764278156,440,-8,-149,4,-22,-7,7,0,0,0,0,-10,11,1,-1,3,2,-4,5,1,0,-8,-5,2,-3,1,1,0,-4,-1,-1,-1,-1,3,-1
KR_6649464504,420,-3,-38,-28,-7,2,0,2,-5,5,0,1,1,2,-2,8,6,-3,3,0,-1,-6,8,-2,-2,4,-1,0,-1,0,1,-1,-1,0,-1
KR_6735453121,420,-3,-35,-16,-3,-3,3,0,3,1,4,-3,5,2,0,2,2,0,0,0,0,2,3,0,-4,4,-5,0,0,0,0,0,1,0,-1
KR_6763451565,440,3,-1,5,3,0,0,0,8,2,10,-7,7,0,2,1,3,0,1,1,1,-2,9,1,-5,4,-3,0,1,-1,0,1,1,2,-1
KR_6731168694,420,0,10,13,-3,2,2,4,-1,3,2,3,2,5,1,1,2,-8,8,0,-1,-7,-27,1,-6,5,-4,0,0,1,1,1,-1,5,-1
KR_6711239433,420,-6,-105,-33,-20,-10,11,1,-6,6,0,-4,4,0,0,2,2,0,1,1,-2,-14,285,0,-2,2,-3,0,-2,0,-1,-1,-1,0,-1
KR_6754244824,420,0,-17,-4,-5,-1,4,3,-4,4,0,1,2,3,-2,4,2,1,2,3,0,1,-5,-1,-2,3,-2,0,-2,-1,0,-1,1,5,-1
KR_6741335005,420,-5,-96,20,-9,-7,8,1,-2,2,0,-3,4,1,2,1,3,1,0,1,0,-3,-13,-3,-2,5,1,0,-3,1,1,-1,-1,5,-1
KR_6761575031,440,-5,-84,2,-12,-2,2,0,-9,10,1,8,1,9,-7,7,0,-2,2,0,-1,-15,0,-4,-1,5,-1,0,0,0,-1,-1,-1,0,-1
KR_6764206749,440,-4,-41,-2,-3,-8,8,0,3,0,3,3,2,5,0,1,1,-1,1,0,0,2,-132,0,-1,1,-15,0,-2,0,-1,-1,-1,0,-1
KR_6753137778,420,-3,-76,6,2,0,2,2,2,3,5,7,0,7,-3,5,2,-4,5,1,0,-2,-7,-3,-3,6,-2,0,-1,-1,1,-1,-1,2,-1
KR_6695335629,420,-2,-65,-22,4,2,2,4,6,4,10,-7,10,3,2,0,2,1,0,1,0,1,341,-5,0,5,3,0,0,0,0,1,-1,0,-1
KR_6753538421,420,-1,11,1,-2,1,0,1,-3,3,0,0,1,1,0,2,2,0,0,0,0,-4,-458,-4,-2,6,5,0,0,-1,0,0,-1,5,-1
KR_6755669149,420,7,61,28,19,1,2,3,3,1,4,7,0,7,5,0,5,3,0,3,0,15,-9,-1,-3,4,2,0,1,1,1,1,1,6,-1
KR_6713665732,420,-1,14,-14,0,-6,7,1,1,2,3,1,3,4,3,3,6,1,0,1,0,4,7,0,-6,6,3,0,-1,1,0,-1,-1,1,-1
KR_6683205494,420,-3,-117,-16,-9,-2,2,0,-1,2,1,-7,7,0,0,2,2,1,1,2,0,-5,0,-2,-1,3,1,0,-1,1,-1,-1,-1,1,-1
KR_6743314491,440,-2,-40,-4,-4,-3,4,1,-1,2,1,-2,4,2,-2,3,1,4,1,5,0,-6,0,1,-2,1,-2,0,-1,1,0,-1,-1,5,-1
KR_6736964149,420,3,-7,-32,0,-3,4,1,2,0,2,3,2,5,-1,5,4,-1,1,0,1,1,173,1,-2,1,-3,0,-1,1,-1,-1,1,4,-1
KR_6637289187,420,-6,-120,-12,-8,-3,3,0,2,0,2,-3,6,3,-4,4,0,0,1,1,0,-7,-11,0,-4,4,-1,0,-1,0,0,-1,-1,0,-1
KR_6752506987,420,-2,-113,-33,-4,-1,5,4,1,0,1,-5,5,0,2,2,4,-1,2,1,0,1,-6,2,-2,0,-1,0,0,-1,0,-1,-1,6,-1
KR_6685506074,420,-1,-48,14,-4,1,1,2,3,3,6,-5,6,1,-3,3,0,0,1,1,-1,0,-14,4,-4,0,3,0,-1,-1,-1,-1,-1,6,-1
KR_6754017780,420,-1,-51,-2,-10,1,2,3,-2,2,0,-4,6,2,-2,4,2,-3,3,0,0,-9,24,3,-4,1,-1,0,0,1,-1,-1,-1,3,-1
KR_6651246101,420,-4,-52,0,-4,3,1,4,0,1,1,-2,3,1,-5,7,2,0,1,1,0,-5,384,-2,-1,3,-6,0,-1,1,0,-1,-1,2,-1
KR_6737617997,420,-1,-2,-4,-6,1,1,2,1,2,3,1,2,3,-7,9,2,-2,5,3,-1,0,-347,2,-2,0,-1,0,-2,-1,-1,-1,-1,5,-1
KR_6635923838,420,-4,-81,-15,-8,-2,2,0,-1,1,0,0,2,2,-5,5,0,0,0,0,0,-8,3,3,-7,4,-5,0,-1,-1,-1,-1,-1,4,-1
KR_6762674768,420,1,-22,38,5,-1,2,1,5,1,6,1,3,4,2,1,3,-2,2,0,0,2,-1,-3,-1,4,1,0,0,0,-1,0,-1,0,-1
KR_6749316640,420,-6,7,-15,-11,-2,3,1,1,2,3,-5,6,1,-6,7,1,1,0,1,0,-9,345,1,-3,2,-3,0,-2,-1,1,-1,1,4,-1
KR_6739785349,420,0,45,2,2,-2,2,0,0,1,1,-1,3,2,3,2,5,2,0,2,0,3,-17,2,-3,1,0,0,0,-1,1,0,1,2,-1
KR_6760742143,420,-5,-36,0,-10,-2,3,1,-3,5,2,2,1,3,-8,8,0,1,3,4,0,-11,12,1,-4,3,-3,0,0,1,1,-1,1,5,-1
KR_6759057293,420,3,-68,4,5,2,1,3,3,0,3,0,2,2,-4,7,3,4,0,4,0,3,2,-6,-2,8,-3,0,0,0,-1,0,-1,0,-1
KR_6651982127,420,-2,-22,-32,-3,1,0,1,2,2,4,-4,4,0,-1,1,0,-1,1,0,-1,-1,-12,0,0,0,0,0,-1,0,0,-1,-1,0,-1
KR_6658373362,420,-5,-74,0,-12,-1,3,2,1,1,2,0,7,7,-11,12,1,-1,1,0,0,-14,111,3,-3,0,-3,0,-3,-1,1,-1,1,3,-1
KR_6635197541,420,-1,37,37,-5,-8,8,0,6,1,7,-1,2,1,2,2,4,-4,6,2,0,7,-1,-4,0,4,-3,0,-1,0,-1,-1,-1,0,-1
KR_6729639837,420,0,46,12,-7,-3,3,0,-5,6,1,3,2,5,-3,5,2,1,3,4,-3,-4,-444,-3,0,3,-1,0,-2,-1,-1,-1,-1,1,-1
KR_6656602964,420,2,-11,24,0,-3,3,0,0,1,1,-2,3,1,5,4,9,0,2,2,0,5,-262,2,-3,1,0,0,1,-1,-1,1,-1,3,-1
KR_6668975591,420,4,86,3,0,0,0,0,-2,6,4,0,4,4,0,2,2,2,0,2,0,1,131,-1,-5,6,2,0,0,1,-1,0,1,1,-1
KR_6757066600,420,-4,-98,-8,-9,-2,2,0,-2,3,1,-4,4,0,-1,3,2,0,0,0,0,-20,-204,-4,-2,6,-3,0,0,0,-1,0,-1,0,-1
KR_6706248238,420,-5,-71,-27,-13,-2,3,1,4,4,8,-5,5,0,-6,7,1,-4,7,3,-1,-8,-9,2,-4,2,-2,0,0,-1,0,0,-1,2,-1
KR_6764009894,420,3,-5,59,3,-2,4,2,-2,3,1,4,0,4,2,1,3,1,2,3,0,2,3,-4,-2,6,-3,0,1,0,0,1,1,0,-1
KR_6727765326,420,-4,-75,-20,-10,3,0,3,-4,6,2,-5,5,0,-4,6,2,0,0,0,-1,-6,-11,-5,0,5,-4,0,-2,-1,-1,-1,-1,1,-1
KR_6705314008,420,0,5,0,6,-2,3,1,7,2,9,1,3,4,0,0,0,0,0,0,1,8,301,3,-4,1,-1,0,-1,1,1,-1,1,4,-1
KR_6753364511,420,-2,-50,-44,2,0,2,2,1,1,2,3,0,3,-2,3,1,0,2,2,0,1,-19,5,-6,1,0,0,0,0,-1,0,1,0,-1
KR_6706488227,420,-2,66,10,-3,-3,4,1,-1,4,3,-2,3,1,2,1,3,1,1,2,0,-2,-31,-1,-4,5,5,0,-1,-1,-1,-1,1,3,-1
KR_6730458696,420,-4,-14,-59,-10,-2,2,0,2,6,8,-5,7,2,-3,4,1,-2,5,3,0,-4,-212,2,-6,4,-2,0,-1,-1,-1,-1,-1,5,-1
KR_6722459483,420,-4,-37,-27,-4,-6,9,3,1,0,1,0,2,2,2,0,2,-1,2,1,0,3,12,3,-3,0,1,0,-1,-1,0,-1,-1,3,-1
KR_6702548584,420,-1,-31,-11,-5,-1,4,3,-6,8,2,1,0,1,2,3,5,-1,1,0,0,-6,6,4,-4,0,-1,0,-1,0,-1,-1,1,0,-1
KR_6736809657,420,0,-80,10,-5,3,1,4,-1,1,0,-5,6,1,-1,4,3,-1,2,1,1,-7,2,0,-1,1,0,0,0,-1,0,1,1,5,-1
KR_6735209823,420,0,31,46,-3,-3,5,2,0,3,3,7,0,7,-3,4,1,-4,5,1,0,-7,-351,0,-2,2,-6,0,2,-1,1,1,-1,5,-1
KR_6742330577,420,-3,-43,8,-12,-3,5,2,-4,6,2,0,4,4,-4,4,0,-1,1,0,0,-10,39,1,-4,3,-11,0,0,0,1,-1,-1,0,-1
KR_6764269087,440,-3,-73,-10,-14,2,1,3,3,1,4,-12,12,0,-3,4,1,-4,4,0,0,-5,-44,-2,-5,7,18,0,-2,-1,0,-1,-1,4,-1
KR_6754801982,420,0,11,17,1,4,0,4,3,0,3,1,4,5,-1,1,0,-6,6,0,0,2,3,-4,-1,5,0,0,1,-1,1,1,-1,5,-1
KR_6753936284,420,-6,13,-62,-11,-4,6,2,0,2,2,-3,7,4,-4,4,0,0,0,0,0,-3,-42,-1,-1,2,16,0,-1,0,-1,-1,-1,0,-1
KR_6663282660,420,-7,-42,-13,-14,2,0,2,-4,5,1,-2,4,2,-8,11,3,-2,3,1,0,-15,-120,1,-3,2,-5,0,-2,-1,1,-1,-1,1,-1
KR_6755202783,420,-1,28,-4,3,-1,2,1,3,0,3,1,0,1,0,0,0,0,1,1,0,6,3,-1,-3,4,-5,0,0,-1,1,0,-1,4,-1
KR_6724553978,420,-5,-31,-4,-10,-5,5,0,1,1,2,-2,4,2,-4,4,0,0,1,1,0,-6,-20,-2,-2,4,0,0,-2,1,-1,-1,-1,5,-1
KR_6716071850,420,2,38,-3,-4,-1,1,0,-2,4,2,-2,3,1,1,1,2,0,0,0,0,-2,-359,-5,-1,6,0,0,-1,-1,-1,-1,-1,5,-1
KR_6753647708,420,-1,-7,4,-4,0,1,1,1,3,4,-5,6,1,0,2,2,0,1,1,0,-4,0,3,-5,2,2,0,0,0,1,-1,1,0,-1
KR_6729434712,420,-1,21,28,-5,4,2,6,1,0,1,-11,13,2,1,1,2,0,1,1,0,-9,8,-5,0,5,1,0,0,1,1,1,-1,2,-1
KR_6725499893,420,-1,-47,0,2,0,2,2,-1,3,2,0,3,3,4,0,4,-1,2,1,1,0,2,1,-5,4,-4,0,0,1,1,0,1,1,-1
KR_6757209573,420,-2,-65,-13,0,1,2,3,6,0,6,4,1,5,-1,1,0,-10,10,0,0,0,8,2,-6,4,2,0,0,0,1,-1,-1,0,-1
KR_6738037291,420,-3,-99,-10,-10,-2,3,1,1,2,3,-1,3,2,-7,8,1,-1,2,1,0,-6,-1,2,-5,3,1,0,-1,-1,-1,-1,-1,5,-1
KR_6754051141,420,-3,-51,36,-7,-1,1,0,0,0,0,-2,2,0,-2,5,3,-2,2,0,0,-7,-10,-2,-1,3,1,0,-2,1,1,-1,-1,5,-1
KR_6645182345,420,-2,-42,-20,-8,-2,2,0,-3,4,1,-2,2,0,2,3,5,-3,3,0,0,-3,-10,-3,0,3,0,0,-1,-1,-1,-1,1,3,-1
KR_6731074068,420,-3,-63,12,-10,3,1,4,1,3,4,1,0,1,-15,15,0,0,3,3,0,-25,0,-4,-1,5,2,0,-1,-1,-1,-1,-1,3,-1
KR_6649052493,420,2,82,24,-7,-2,4,2,0,3,3,-2,3,1,-1,4,3,-2,3,1,-1,-8,1,0,-2,2,1,0,1,-1,1,1,-1,4,-1
KR_6763694549,420,-3,-55,-1,-7,2,1,3,-2,2,0,-2,2,0,-5,5,0,0,0,0,0,-6,1,1,-3,2,-1,0,-1,-1,-1,-1,-1,6,-1
KR_6657152215,420,0,-24,-12,-1,1,1,2,-4,4,0,1,2,3,2,4,6,-1,1,0,-1,-6,10,-2,-5,7,-2,0,0,-1,0,0,-1,6,-1
KR_6738832564,420,-3,-26,8,-9,2,1,3,-3,4,1,-1,1,0,-4,4,0,-3,3,0,0,-12,2,1,-2,1,-1,0,-1,-1,-1,-1,-1,5,-1
KR_6733350539,420,-1,-5,12,-9,-1,3,2,1,1,2,-5,5,0,-4,4,0,0,2,2,0,-4,2,0,-4,4,2,0,0,1,1,0,-1,6,-1
KR_6749176172,420,-4,-8,-4,-12,1,2,3,-11,11,0,3,2,5,-5,5,0,0,0,0,-1,-10,-12,0,-2,2,1,0,-1,1,-1,-1,-1,4,-1
KR_6682406674,420,-6,-53,-28,-8,0,3,3,-3,6,3,-1,2,1,-3,5,2,-1,2,1,0,-17,-5,1,-4,3,-1,0,-2,1,-1,-1,-1,1,-1
KR_6757911850,420,-2,-12,-10,-2,-6,6,0,-1,3,2,-1,2,1,6,2,8,0,1,1,2,8,77,4,-4,0,-11,0,1,1,1,1,1,5,-1
KR_6734901251,420,-3,-50,-4,-8,0,1,1,-2,5,3,0,3,3,-5,10,5,-1,1,0,0,-6,-4,-1,-3,4,0,0,-2,-1,-1,-1,-1,4,-1
KR_6720585623,440,-8,-40,-44,-21,-5,7,2,-6,6,0,-1,4,3,-3,3,0,-6,6,0,0,-23,-7,-3,0,3,1,0,-2,-1,-1,-1,1,4,-1
KR_6754946189,420,-1,-52,0,-8,-3,3,0,-7,8,1,4,1,5,-7,7,0,5,1,6,0,-5,2,2,-3,1,0,0,-1,-1,-1,-1,-1,2,-1
KR_6747530688,420,-1,-124,20,-4,-8,9,1,6,0,6,2,1,3,-3,7,4,-1,5,4,0,4,-310,-1,-2,3,-1,0,0,1,-1,-1,-1,3,-1
KR_6739114503,420,-4,-26,6,-11,-3,5,2,-2,2,0,-4,4,0,-3,3,0,1,0,1,-1,-3,18,-1,-2,3,0,0,-1,1,-1,-1,-1,2,-1
KR_6726715259,420,-4,-114,-22,-8,-6,7,1,-2,3,1,-2,7,5,3,2,5,-1,1,0,-1,2,-42,-1,-1,2,14,0,-2,0,-1,-1,-1,0,-1
KR_6642903344,420,-3,-27,12,-6,-2,4,2,-1,1,0,-2,2,0,1,1,2,-2,2,0,0,-3,-10,1,-4,3,-2,0,0,1,1,0,1,2,-1
KR_6679308435,420,1,29,0,1,1,0,1,2,1,3,0,1,1,-1,2,1,-1,1,0,0,-3,9,2,-5,3,2,0,0,1,1,1,1,1,-1
KR_6733081314,420,1,0,37,0,-3,4,1,1,3,4,3,3,6,0,3,3,-1,1,0,0,-1,-13,-1,-2,3,1,0,1,1,1,1,1,1,-1
KR_6731860844,420,-5,-107,-17,-8,-3,3,0,0,2,2,-2,3,1,-3,3,0,0,0,0,0,-4,-8,1,-6,5,-4,0,-1,-1,-1,-1,-1,6,-1
KR_6719150593,420,1,35,25,0,4,2,6,-1,2,1,-6,7,1,3,1,4,0,1,1,1,0,10,2,-2,0,1,0,1,1,0,1,1,2,-1
KR_6730507283,420,-3,-33,-8,-12,-1,3,2,1,2,3,-1,3,2,-5,7,2,-6,6,0,0,-16,-9,0,-2,2,1,0,-1,-1,1,-1,-1,3,-1
KR_6706289034,420,2,129,32,-7,3,1,4,-1,2,1,-5,7,2,-2,5,3,-2,4,2,0,-12,-4,-3,0,3,5,0,0,-1,-1,0,1,2,-1
KR_6759823218,420,-4,-43,-19,-7,-2,3,1,3,0,3,-2,3,1,-4,4,0,-2,2,0,0,-5,-8,2,-4,2,2,0,-1,-1,-1,-1,-1,2,-1
KR_6728170377,420,-2,0,20,-8,4,1,5,-5,5,0,-6,8,2,0,1,1,-1,1,0,-1,-9,5,2,-5,3,-3,0,0,-1,1,1,-1,5,-1
KR_6754356746,420,-1,25,-8,-4,1,2,3,4,0,4,2,0,2,-8,10,2,-3,4,1,-1,-18,223,-2,-3,5,-1,0,0,1,0,1,-1,1,-1
KR_6749832675,420,-3,-26,-1,-2,1,3,4,2,1,3,0,2,2,-1,2,1,-4,4,0,0,-5,1,0,-2,2,-1,0,0,-1,1,-1,1,1,-1
KR_6763569940,420,0,28,28,-2,2,2,4,1,0,1,-5,5,0,-3,6,3,3,1,4,-1,-3,-8,-1,-2,3,0,0,1,1,1,1,-1,3,-1
KR_6743849925,420,-3,-91,-13,-6,1,0,1,-4,4,0,-3,5,2,0,1,1,0,0,0,0,-7,4,-1,-2,3,-3,0,0,-1,1,0,1,5,-1
KR_6757411410,440,2,45,-17,5,0,0,0,2,4,6,2,0,2,1,1,2,0,1,1,0,-1,2,2,-8,6,-3,0,-1,0,-1,-1,1,0,-1
KR_6731230535,420,-4,30,-36,-9,2,0,2,-4,6,2,-2,2,0,-6,10,4,1,2,3,1,-7,-8,0,-1,1,1,0,-1,1,-1,-1,-1,1,-1
KR_6744276820,420,-1,-4,-28,1,6,0,6,-1,1,0,-2,3,1,-3,3,0,1,0,1,-1,-9,-3,-1,-1,2,-1,0,-1,-1,-1,1,-1,4,-1
KR_6745174558,420,0,50,-4,-2,-1,1,0,-4,5,1,0,3,3,-1,2,1,4,1,5,1,2,1,0,-1,1,-1,0,0,1,-1,0,1,1,-1
KR_6762234851,420,0,-18,-16,1,-6,8,2,3,1,4,3,0,3,2,0,2,-1,2,1,0,0,1,-2,-2,4,0,0,1,1,-1,1,-1,2,-1
KR_6762347384,420,-2,36,-28,-1,1,2,3,-1,2,1,-2,2,0,1,3,4,0,0,0,0,-7,19,0,-4,4,-1,0,1,-1,-1,-1,1,4,-1
KR_6747614863,420,-1,8,-12,-6,0,2,2,-4,6,2,-2,4,2,0,2,2,0,0,0,2,-3,-3,-1,-4,5,-3,0,0,-1,1,0,1,5,-1
KR_6759028862,420,-3,-50,0,-12,-5,5,0,5,0,5,-7,7,0,-5,5,0,0,0,0,0,-8,-2,-1,-2,3,-2,0,-1,-1,-1,-1,-1,1,-1
KR_6749110967,420,-5,-95,-40,-8,-2,4,2,-1,3,2,-1,2,1,-1,3,2,-3,4,1,0,-3,108,0,-2,2,-1,0,-1,0,1,-1,-1,0,-1
KR_6680958326,420,0,-16,-48,-3,-3,5,2,3,1,4,3,0,3,-6,7,1,0,1,1,-1,0,-1,0,-2,2,2,0,-3,1,1,-1,-1,2,-1
KR_6685686918,420,-8,-111,-64,-23,-2,2,0,-6,8,2,-3,6,3,-10,10,0,-2,2,0,-1,-23,28,-4,-3,7,-26,0,-2,-1,1,-1,-1,1,-1
KR_6754759913,420,-2,-32,-17,-8,2,0,2,-4,6,2,-3,4,1,-3,4,1,0,0,0,0,-12,-3,-4,-2,6,-3,0,-2,-1,-1,-1,-1,1,-1
KR_6644810110,420,-6,-66,-28,-16,-2,4,2,-3,7,4,-4,6,2,-4,5,1,-3,3,0,0,-14,-251,-2,-1,3,-5,0,-3,-1,0,-1,-1,4,-1
KR_6761129389,420,-3,-81,4,-8,-2,3,1,2,1,3,-2,3,1,-6,6,0,0,0,0,0,-7,-228,1,-3,2,-4,0,-1,-1,-1,-1,-1,1,-1
KR_6724795661,440,-9,-197,-70,-23,-8,9,1,0,2,2,-1,3,2,-10,11,1,-4,4,0,-1,-10,-2,-1,-1,2,-4,0,-6,-1,-1,-1,-1,2,-1
KR_6752074691,420,-1,-42,1,-3,-1,1,0,-1,3,2,-1,2,1,-1,4,3,1,3,4,0,2,-2,-5,-2,7,-2,0,1,-1,1,1,1,2,-1
KR_6756585613,420,-5,-53,0,-14,-5,5,0,2,1,3,-5,5,0,-4,5,1,-2,3,1,-1,-6,-48,-2,-2,4,31,0,0,-1,0,0,-1,6,-1
KR_6739113139,420,0,-13,-24,4,1,0,1,-1,4,3,2,0,2,1,1,2,1,0,1,0,4,0,-1,-3,4,0,0,0,-1,-1,0,1,1,-1
KR_6760315156,420,-4,-115,8,-14,3,3,6,-1,4,3,-3,3,0,-9,10,1,-4,4,0,0,-11,34,-2,-1,3,0,0,-2,-1,-1,-1,-1,4,-1
KR_6722226548,420,-1,-20,27,1,-2,3,1,4,0,4,2,2,4,-4,4,0,1,0,1,0,-3,40,1,-2,1,-33,0,1,0,1,1,-1,0,-1
KR_6647543003,420,1,-58,-4,3,0,1,1,3,0,3,-1,2,1,-2,2,0,3,1,4,-1,3,-11,-1,-3,4,0,0,0,1,-1,0,-1,6,-1
KR_6761999248,420,-2,17,-32,-9,-3,3,0,-2,3,1,-3,3,0,0,2,2,-1,1,0,0,-4,-9,0,-2,2,3,0,-1,0,-1,-1,-1,0,-1
KR_6735355115,440,-6,-75,1,-15,-4,5,1,-1,3,2,1,1,2,-9,9,0,-2,2,0,0,-9,-269,2,-2,0,0,0,-2,-1,-1,-1,-1,3,-1
KR_6717352157,420,-1,-19,-4,-6,1,3,4,-3,5,2,-2,3,1,4,0,4,-6,6,0,1,-15,6,3,-5,2,-1,0,-1,0,-1,-1,1,0,-1
KR_6717751801,420,-7,-99,0,-17,0,3,3,-3,3,0,-5,7,2,-7,7,0,-2,2,0,-1,-18,25,-3,0,3,-19,0,-2,-1,-1,-1,-1,4,-1
KR_6721911114,440,3,36,24,8,2,2,4,0,4,4,-1,1,0,4,2,6,3,0,3,1,8,24,2,-3,1,-4,0,0,1,-1,-1,1,4,-1
KR_6666998706,420,-4,-77,-20,-10,-5,5,0,-2,3,1,-2,5,3,0,0,0,-1,1,0,-1,-3,-350,1,-5,4,-3,0,0,-1,1,-1,-1,1,-1
KR_6748951073,420,0,12,-6,2,-3,3,0,-3,5,2,5,0,5,4,2,6,-1,1,0,1,9,4,-7,-2,9,1,0,0,0,-1,-1,1,0,-1
KR_6760505882,420,0,53,12,-2,3,1,4,-3,4,1,2,0,2,3,0,3,-7,8,1,0,-1,34,5,-8,3,-16,0,0,1,0,0,-1,6,-1
KR_6650309730,420,0,24,4,2,1,1,2,0,1,1,3,1,4,-2,5,3,0,2,2,0,-4,48,5,-8,3,-14,0,-1,1,1,-1,1,3,-1
KR_6730477224,420,-8,-122,-47,-8,-4,5,1,2,1,3,-1,4,3,-6,7,1,1,0,1,-1,-5,-1,2,-5,3,-2,0,0,0,1,0,-1,0,-1
KR_6719023998,420,1,-75,9,7,0,3,3,8,1,9,-2,4,2,-1,1,0,2,1,3,0,6,-43,4,-4,0,23,0,0,1,1,-1,-1,4,-1
KR_6744361478,420,1,-74,-4,0,-1,2,1,4,6,10,-2,2,0,2,1,3,-3,3,0,0,0,6,-1,-2,3,0,0,0,1,-1,-1,1,5,-1
KR_6706376355,420,1,-10,-16,2,0,2,2,3,3,6,-2,6,4,0,3,3,1,1,2,0,-2,-5,-4,-3,7,5,0,-1,-1,1,-1,-1,3,-1
KR_6662604536,420,-1,-47,-24,1,0,1,1,0,1,1,-3,3,0,4,1,5,0,0,0,1,5,-4,-3,-3,6,4,0,0,1,1,0,1,1,-1
KR_6751998830,420,3,-43,2,4,0,1,1,-1,2,1,-1,1,0,5,0,5,1,0,1,0,1,7,-3,-2,5,1,0,-2,1,-1,-1,1,2,-1
KR_6662851168,420,2,29,4,3,-2,2,0,2,1,3,-4,6,2,4,2,6,3,0,3,0,4,9,3,-5,2,-2,0,1,-1,1,1,1,6,-1
KR_6749049073,440,-5,-101,-8,-13,-2,3,1,-5,5,0,-5,7,2,1,3,4,-2,2,0,-2,-13,2,-3,-1,4,-1,0,-1,-1,-1,-1,-1,2,-1
KR_6751145311,420,1,-20,8,1,1,1,2,3,1,4,-2,3,1,0,4,4,-1,2,1,0,3,-3,-3,-2,5,2,0,-1,1,-1,-1,1,2,-1
KR_6747483665,420,-8,-61,-38,-14,-3,4,1,-4,7,3,-2,3,1,-2,3,1,-3,3,0,0,-6,3,3,-3,0,-5,0,-3,-1,-1,-1,-1,5,-1
KR_6740997479,420,0,-5,-16,3,-2,4,2,0,6,6,3,2,5,2,0,2,0,0,0,0,3,29,5,-5,0,-8,0,0,1,0,0,1,5,-1
KR_6722700577,440,-1,-37,12,-11,-2,5,3,-2,4,2,-1,4,3,-6,9,3,0,1,1,-1,-9,-101,3,-5,2,-5,0,0,1,1,-1,-1,3,-1
KR_6760440033,420,-1,14,-23,1,-2,3,1,1,2,3,3,2,5,-6,8,2,5,1,6,0,-2,40,1,-3,2,-4,0,0,1,1,0,-1,6,-1
KR_6654468800,420,-2,-23,6,-1,-3,3,0,0,2,2,-2,3,1,4,0,4,0,1,1,0,4,5,4,-4,0,2,0,-1,1,0,-1,1,1,-1
KR_6750469491,420,2,18,1,0,3,1,4,-2,2,0,2,3,5,-2,7,5,-1,2,1,0,-2,23,7,-7,0,-3,0,0,-1,1,1,-1,6,-1
KR_6652133390,420,-10,-115,-28,-18,-5,7,2,-3,4,1,-6,6,0,-5,5,0,1,0,1,-2,-16,-4,-2,-1,3,0,0,-3,-1,0,-1,-1,4,-1
KR_6749954060,420,-2,41,-28,-6,2,1,3,1,1,2,-1,4,3,-4,5,1,-4,4,0,0,-8,-11,0,0,0,0,0,0,-1,-1,-1,-1,1,-1
KR_6742964626,420,-3,-26,-7,-4,1,2,3,-1,4,3,5,2,7,-8,8,0,-1,1,0,0,-6,-247,0,-6,6,-1,0,-2,-1,0,-1,-1,3,-1
KR_6760769744,420,1,4,-12,-3,1,2,3,0,1,1,2,5,7,-5,7,2,-1,1,0,-1,-12,292,2,-5,3,-1,0,0,1,1,0,-1,1,-1
KR_6659605597,420,-1,-29,4,-4,-3,4,1,1,3,4,1,4,5,-5,7,2,2,1,3,-1,-2,-7,0,-2,2,0,0,1,1,-1,1,-1,1,-1
KR_6681572030,420,-3,-17,-16,-5,-2,4,2,-1,3,2,-6,6,0,2,1,3,2,0,2,-1,-3,-10,-1,-3,4,2,0,-1,-1,-1,-1,-1,1,-1
KR_6743911755,420,0,20,-11,-3,-3,3,0,2,1,3,0,0,0,-2,3,1,0,0,0,0,-2,0,-3,-3,6,0,0,0,-1,-1,0,-1,1,-1
KR_6633010406,420,2,69,-18,2,-1,1,0,0,1,1,7,0,7,-3,3,0,-1,1,0,0,-2,-11,-4,0,4,2,0,0,-1,0,0,1,1,-1
KR_6757542540,420,-6,-81,-18,-9,-2,2,0,-7,10,3,0,2,2,-1,2,1,1,0,1,0,-3,-3,-2,0,2,-1,0,-2,-1,0,-1,-1,2,-1
KR_6738402989,440,-7,-106,-11,-17,-4,6,2,-1,1,0,1,0,1,-1,1,0,-12,15,3,0,-14,-34,-5,-1,6,3,0,-2,-1,1,-1,-1,6,-1
KR_6710037462,440,-2,18,-23,-5,-4,4,0,2,2,4,1,2,3,-1,1,0,-3,3,0,0,-2,-6,0,-2,2,0,0,0,1,-1,0,1,6,-1
KR_6761184346,440,-2,20,-29,-3,0,1,1,0,1,1,1,3,4,-4,4,0,0,0,0,1,1,-2,4,-5,1,3,0,0,0,0,0,1,0,-1
KR_6717444222,420,0,-7,15,5,-1,4,3,1,0,1,-1,3,2,2,2,4,4,1,5,0,3,293,-3,-2,5,0,0,1,-1,-1,-1,1,3,-1
KR_6748111913,420,-2,-49,-29,-8,4,2,6,4,0,4,-8,8,0,-5,7,2,-3,4,1,-1,-8,-8,2,-3,1,-2,0,-1,-1,1,1,-1,2,-1
KR_6676487872,420,0,-18,23,-2,-1,3,2,2,0,2,0,1,1,-2,3,1,-1,1,0,0,0,-58,1,-3,2,23,0,-1,1,-1,-1,-1,5,-1
KR_6707171191,420,-5,50,-32,-10,-5,5,0,-3,4,1,-2,3,1,1,0,1,-1,1,0,-2,-15,42,0,-3,3,-17,0,-2,0,-1,-1,-1,0,-1
KR_6743554137,420,0,-31,-16,0,-6,6,0,3,4,7,3,2,5,-2,2,0,2,2,4,0,7,146,-1,-2,3,0,0,1,-1,1,1,1,6,-1
KR_6696575912,440,-6,-54,-12,-6,0,1,1,-2,4,2,-4,4,0,0,1,1,0,0,0,0,0,39,4,-4,0,-16,0,0,-1,-1,0,-1,3,-1
KR_6752305744,420,2,-11,-15,8,2,1,3,1,1,2,-2,2,0,1,4,5,6,0,6,0,9,6,0,-1,1,0,0,0,1,1,1,1,1,-1
KR_6762888592,420,-2,-19,-6,-9,-1,1,0,-1,1,0,-5,5,0,-2,3,1,0,2,2,0,-7,15,-3,-3,6,-4,0,0,-1,-1,0,-1,2,-1
KR_6711814139,420,-3,-94,-24,-4,0,4,4,-1,3,2,0,3,3,-1,3,2,-2,2,0,0,-4,7,1,-3,2,-1,0,0,0,1,0,-1,0,-1
KR_6755173383,420,1,-41,0,2,5,0,5,0,1,1,-2,2,0,-1,2,1,0,0,0,1,-3,-7,1,-3,2,0,0,0,0,-1,0,1,0,-1
KR_6683422571,420,-1,-14,12,0,-4,4,0,-2,6,4,-1,1,0,7,4,11,0,0,0,0,4,-7,1,-3,2,2,0,0,1,1,-1,1,5,-1
KR_6689111228,420,-4,-36,-16,-15,-3,4,1,-3,6,3,0,2,2,-5,6,1,-4,6,2,-3,-21,-27,-1,-1,2,-1,0,-1,1,-1,-1,-1,6,-1
KR_6734298836,420,-5,-118,16,-12,-2,2,0,-3,4,1,-2,3,1,-5,5,0,0,1,1,0,-9,2,5,-10,5,0,0,-3,0,-1,-1,-1,0,-1
KR_6737782535,420,-1,-36,9,-3,0,3,3,0,1,1,-1,4,3,-1,2,1,-1,3,2,0,-3,1,-1,-1,2,0,0,0,-1,-1,-1,1,6,-1
KR_6762625426,420,1,16,-24,4,2,2,4,-2,2,0,5,1,6,0,2,2,-1,3,2,0,0,-7,-6,0,6,-1,0,0,-1,-1,0,-1,4,-1
KR_6644429272,420,-6,-62,-19,-14,0,2,2,0,1,1,-13,14,1,-1,4,3,0,1,1,-2,-7,6,3,-3,0,-6,0,-3,-1,-1,-1,-1,2,-1
KR_6759614388,440,-1,10,-10,3,2,0,2,0,3,3,-2,3,1,0,2,2,3,1,4,3,10,34,0,-4,4,-15,0,0,-1,-1,0,1,3,-1
KR_6721944109,420,-7,-106,-64,-15,-5,5,0,-1,2,1,-1,3,2,-8,10,2,0,0,0,0,-8,-13,-3,-3,6,19,0,-3,-1,-1,-1,-1,6,-1
KR_6763383788,420,-5,-46,-19,-7,-1,2,1,-6,6,0,-1,1,0,-2,5,3,3,2,5,0,-6,-413,-3,-2,5,0,0,0,-1,-1,-1,-1,5,-1
KR_6687309631,420,-2,27,-14,-2,4,0,4,-2,5,3,1,2,3,-5,7,2,0,1,1,0,-7,84,-8,-2,10,5,0,2,1,0,1,-1,2,-1
KR_6763501549,420,-5,-133,-7,-6,0,2,2,-3,4,1,-3,7,4,1,3,4,-1,3,2,0,1,22,-2,-1,3,0,0,-2,-1,-1,-1,1,5,-1
KR_6711182704,420,-1,-25,32,-3,-4,5,1,-2,4,2,-1,4,3,3,3,6,1,4,5,0,3,-303,-2,-2,4,2,0,-1,-1,1,-1,-1,6,-1
KR_6728390385,420,0,2,16,2,0,1,1,3,1,4,2,0,2,-3,3,0,0,1,1,0,2,-11,-4,-1,5,5,0,0,1,1,1,1,1,-1
KR_6759954606,420,-6,-29,-36,-7,-2,4,2,-2,3,1,-3,4,1,0,1,1,0,0,0,0,-3,0,2,-3,1,0,0,-2,-1,-1,-1,-1,4,-1
KR_6744262232,420,-5,-63,-4,-9,0,2,2,-4,6,2,-6,7,1,4,2,6,-3,4,1,0,1,7,5,-8,3,-2,0,0,0,0,-1,-1,0,-1
KR_6727140655,420,1,49,6,-3,0,1,1,-6,6,0,2,5,7,1,0,1,0,1,1,0,-4,13,-3,-1,4,2,0,1,1,1,1,1,3,-1
KR_6747244627,420,-4,-6,-48,-9,-2,4,2,0,6,6,-9,11,2,3,2,5,-1,2,1,-1,-6,1,-4,-1,5,-1,0,-2,-1,1,-1,-1,6,-1
KR_6720519431,440,-1,79,0,2,1,1,2,0,0,0,0,0,0,3,2,5,-2,2,0,0,3,-5,-2,-2,4,2,0,0,1,-1,0,1,5,-1
KR_6706498304,420,0,23,-12,0,5,1,6,-3,3,0,-1,3,2,-3,3,0,2,0,2,1,0,-5,-2,-2,4,1,0,1,-1,1,1,1,6,-1
KR_6763595864,420,0,-46,-7,9,5,0,5,0,3,3,1,2,3,1,1,2,2,1,3,0,7,-8,-1,0,1,4,0,0,1,-1,-1,1,4,-1
KR_6759209780,420,-2,38,0,-5,-1,3,2,1,1,2,-4,6,2,-2,3,1,1,1,2,0,-7,21,0,-2,2,-1,0,-2,1,-1,-1,-1,3,-1
KR_6649556810,420,-2,-63,20,2,1,2,3,-1,1,0,-2,5,3,4,1,5,0,1,1,0,10,5,3,-4,1,2,0,0,-1,1,0,1,6,-1
KR_6723068904,420,-1,15,-31,3,1,3,4,1,0,1,-4,5,1,3,1,4,2,0,2,0,5,3,4,-4,0,-2,0,0,1,0,1,1,6,-1
KR_6735023705,420,-3,-73,-20,-17,-5,5,0,-3,4,1,0,0,0,-5,5,0,-4,5,1,-3,-21,14,-4,-3,7,-5,0,-2,-1,-1,-1,-1,4,-1
KR_6682867810,420,0,-2,-4,-2,-3,4,1,-3,6,3,2,1,3,0,1,1,2,0,2,0,-6,11,2,-4,2,-5,0,1,-1,-1,1,1,6,-1
KR_6763894781,420,-6,-91,-32,-10,0,2,2,-2,2,0,3,1,4,-2,2,0,-9,10,1,-2,-14,-8,-2,-1,3,-2,0,-1,-1,-1,-1,-1,6,-1
KR_6761414090,420,-2,-20,-27,-5,0,2,2,0,2,2,1,2,3,0,3,3,-6,6,0,0,0,-23,-1,-3,4,-8,0,0,-1,1,0,-1,6,-1
KR_6690369615,420,-1,-59,-32,-1,0,1,1,1,1,2,4,0,4,-4,4,0,-2,3,1,0,1,-5,0,-3,3,-1,0,-1,-1,1,-1,-1,2,-1
KR_6690022219,420,-5,-130,0,-12,3,1,4,-4,4,0,-1,1,0,-7,9,2,-3,3,0,0,-12,12,-2,-2,4,0,0,-2,-1,1,-1,1,4,-1
KR_6694459865,420,0,39,32,-7,0,1,1,1,1,2,-1,2,1,-7,8,1,0,1,1,0,-14,-111,1,-6,5,1,0,0,1,1,0,1,4,-1
KR_6744082240,420,-7,-80,-24,-7,1,0,1,-3,3,0,0,2,2,-5,7,2,0,2,2,0,-4,30,-1,-2,3,0,0,-4,-1,1,-1,-1,3,-1
KR_6748704163,420,2,25,37,2,4,1,5,2,1,3,-5,8,3,3,2,5,-2,2,0,0,-6,-20,-8,-1,9,2,0,2,1,1,1,1,5,-1
KR_6679903595,440,-6,-54,-24,-23,-5,5,0,-5,6,1,-12,15,3,-1,5,4,0,1,1,0,-22,-1,-7,0,7,1,0,-6,-1,-1,-1,-1,1,-1
KR_6753347086,420,-2,1,-4,-8,-5,5,0,-1,1,0,2,0,2,-3,5,2,-1,1,0,0,-3,36,-3,-3,6,-28,0,-1,-1,0,-1,1,6,-1
KR_6729390922,420,4,8,56,2,1,1,2,-1,3,2,5,1,6,-1,2,1,-2,3,1,0,-1,-5,-1,-1,2,0,0,1,1,1,1,1,1,-1
KR_6748398896,420,1,7,12,4,-2,2,0,2,0,2,1,2,3,3,0,3,0,1,1,0,6,4,-1,-3,4,5,0,0,1,0,0,1,2,-1
KR_6732964084,420,-1,-62,-39,2,-3,4,1,-1,3,2,1,3,4,6,1,7,-1,2,1,0,9,-12,0,-3,3,1,0,-2,1,1,-1,-1,1,-1
KR_6761719509,440,-1,33,0,-4,-1,2,1,-1,2,1,-4,4,0,2,1,3,0,0,0,0,-1,6,3,-4,1,2,0,0,0,-1,0,1,0,-1
KR_6703192166,420,-1,16,4,-4,-4,4,0,-4,5,1,-2,2,0,4,1,5,2,0,2,0,5,-6,1,-4,3,-2,0,0,1,0,0,1,6,-1
KR_6761217729,420,-1,-19,-4,7,2,0,2,-2,6,4,1,2,3,5,1,6,1,2,3,0,8,1,-3,-3,6,-1,0,0,-1,-1,0,1,3,-1
KR_6747657609,420,-4,-69,16,-11,-5,5,0,-1,3,2,-1,5,4,-5,6,1,1,3,4,0,-11,0,1,-2,1,-2,0,-1,0,-1,-1,-1,0,-1
KR_6706916005,420,-3,-80,-3,-3,1,1,2,2,1,3,0,3,3,-4,4,0,-2,3,1,1,-3,-33,-1,-3,4,3,0,-2,-1,0,-1,1,5,-1
KR_6727761160,420,2,2,-12,0,4,1,5,-7,7,0,-3,4,1,6,0,6,0,1,1,-1,-3,6,1,-3,2,-2,0,0,0,-1,1,-1,0,-1
KR_6729161636,420,-1,-20,3,3,2,1,3,-4,5,1,4,0,4,-2,4,2,3,2,5,0,2,3,1,-5,4,-2,0,-1,-1,1,-1,1,3,-1
KR_6751884420,420,0,25,-8,-1,-3,4,1,2,0,2,0,3,3,-1,3,2,1,0,1,1,7,-7,-2,-4,6,-2,0,0,-1,-1,0,1,6,-1
KR_6671324537,420,-1,40,-8,-5,-1,1,0,0,2,2,0,1,1,-3,4,1,-1,1,0,0,-1,-32,0,-1,1,28,0,1,-1,1,1,-1,5,-1
KR_6730808963,420,-6,-124,-40,-8,-5,6,1,-1,3,2,0,1,1,-2,3,1,0,0,0,0,2,-24,-2,0,2,-2,0,-5,1,-1,-1,-1,2,-1
KR_6763207158,420,-4,-101,21,-8,3,0,3,-1,1,0,-5,5,0,-3,3,0,-2,2,0,0,-8,-184,-5,0,5,-1,0,-1,-1,1,-1,1,3,-1
KR_6706188304,420,2,19,-14,-3,-2,2,0,7,1,8,-9,12,3,2,2,4,-1,3,2,0,-3,0,2,-5,3,3,0,0,-1,-1,-1,-1,5,-1
KR_6728280757,420,-3,-58,-44,-7,-4,5,1,-4,8,4,-1,3,2,1,2,3,1,0,1,0,0,-37,-4,-2,6,25,0,-1,-1,-1,-1,-1,6,-1
KR_6755380417,420,2,-14,88,-7,-2,2,0,7,0,7,-6,6,0,-4,4,0,-2,3,1,0,-1,46,5,-5,0,-24,0,-1,1,1,-1,1,4,-1
KR_6759133022,420,-1,-2,4,-2,-5,5,0,-2,4,2,0,1,1,-1,1,0,6,0,6,0,-2,-2,2,-4,2,-4,0,0,1,1,-1,1,6,-1
KR_6714752094,440,1,16,-1,-2,-1,1,0,-3,5,2,0,1,1,4,3,7,-2,4,2,0,5,6,-3,-2,5,-1,0,1,-1,1,1,1,4,-1
KR_6676916927,420,-3,-39,-8,-2,1,1,2,-2,4,2,-2,3,1,2,1,3,-1,3,2,0,2,6,3,-5,2,0,0,0,-1,1,0,-1,3,-1
KR_6764270079,420,-1,29,-32,2,6,0,6,-2,4,2,0,2,2,0,1,1,-2,2,0,1,1,-17,1,-6,5,3,0,-1,-1,-1,-1,1,2,-1
KR_6718072001,420,1,12,-34,5,2,4,6,-3,3,0,2,0,2,4,0,4,0,1,1,1,3,16,2,-3,1,1,0,0,-1,-1,1,1,1,-1
KR_6730649558,420,-1,-22,24,-7,-3,3,0,1,3,4,-4,6,2,0,1,1,-1,3,2,0,-13,5,-2,-2,4,1,0,1,-1,1,1,-1,5,-1
KR_6693032211,420,-3,9,8,-4,1,2,3,-2,2,0,-1,5,4,-2,3,1,0,0,0,0,3,2,3,-4,1,-2,0,-1,-1,-1,-1,1,2,-1
KR_6746389479,420,-3,-50,11,-8,-4,5,1,-1,3,2,-2,2,0,-2,2,0,1,0,1,0,-8,-3,-4,-3,7,1,0,0,-1,1,0,-1,1,-1
KR_6664065432,420,3,14,15,7,2,1,3,2,2,4,-3,5,2,6,0,6,0,0,0,0,5,13,-1,-2,3,0,0,0,0,1,-1,-1,0,-1
KR_6697060185,420,0,56,-32,2,-1,3,2,-2,5,3,-4,4,0,10,0,10,-1,1,0,0,6,1,0,-2,2,2,0,-1,1,1,-1,-1,5,-1
KR_6745125479,420,0,-70,-2,-2,3,0,3,0,1,1,3,2,5,-6,9,3,-2,3,1,0,-1,-2,-1,-5,6,1,0,0,-1,0,-1,-1,3,-1
KR_6732999313,420,1,-15,-13,5,0,2,2,0,2,2,3,2,5,1,1,2,1,0,1,0,10,-290,4,-5,1,-3,0,0,1,-1,0,-1,4,-1
KR_6757656527,420,-1,25,20,-4,1,1,2,-3,3,0,-1,4,3,-1,2,1,0,0,0,0,-5,-267,4,-4,0,-1,0,-2,1,-1,-1,1,4,-1
KR_6752302084,420,-4,-15,-44,-14,-6,8,2,-1,3,2,-3,6,3,-3,5,2,-1,2,1,-1,-9,-10,-3,0,3,0,0,-1,-1,-1,-1,1,2,-1
KR_6713106000,420,-1,18,12,4,-1,3,2,-5,5,0,0,0,0,2,2,4,8,0,8,0,9,5,-1,-2,3,0,0,0,0,0,0,-1,0,-1
KR_6689905371,440,-2,-23,6,-11,-5,7,2,-5,6,1,-1,2,1,-1,1,0,1,0,1,-1,-10,-12,-2,-3,5,1,0,1,-1,-1,1,-1,5,-1
KR_6724479044,420,-1,81,-11,-6,4,0,4,-3,3,0,-4,7,3,-2,2,0,-1,1,0,-1,-6,-2,-5,-1,6,0,0,1,1,1,1,-1,5,-1
KR_6764321807,440,-2,15,24,-7,0,1,1,3,1,4,-6,6,0,-3,5,2,-1,4,3,-1,-16,-38,-4,-1,5,1,0,0,1,0,0,1,1,-1
KR_6697223757,420,1,9,4,4,0,2,2,0,2,2,8,2,10,-4,4,0,0,0,0,0,-6,347,0,-4,4,0,0,0,0,0,0,-1,0,-1
KR_6754898236,440,-7,-40,12,-10,-4,4,0,2,2,4,-2,3,1,-4,10,6,-2,3,1,0,-7,-15,-1,-3,4,1,0,-1,-1,-1,-1,-1,3,-1
KR_6649595005,420,-2,-77,-16,-12,-7,9,2,2,1,3,-7,7,0,2,0,2,-2,2,0,0,2,-40,-6,0,6,19,0,-1,-1,1,-1,-1,3,-1
KR_6658335772,420,-1,-107,3,-7,-1,2,1,-3,4,1,-3,3,0,0,1,1,0,1,1,0,-7,-5,-4,-3,7,-3,0,0,-1,-1,0,1,4,-1
KR_6738285905,420,-4,-140,7,-7,-1,4,3,-2,4,2,0,2,2,-3,4,1,-1,2,1,-1,-4,279,1,-4,3,-1,0,-2,1,0,-1,-1,2,-1
KR_6704855979,420,2,34,16,8,-3,4,1,8,2,10,-1,3,2,3,2,5,1,4,5,0,5,4,3,-4,1,3,0,0,-1,-1,-1,1,3,-1
KR_6697945411,420,-9,-87,18,-7,-7,7,0,3,1,4,1,3,4,0,4,4,-4,5,1,0,1,6,2,-5,3,-4,0,-2,1,-1,-1,1,6,-1
KR_6629846542,440,2,-32,12,9,-4,6,2,0,1,1,5,1,6,4,0,4,4,2,6,0,19,-109,-2,-1,3,1,0,-1,-1,-1,-1,1,5,-1
KR_6751581656,420,-5,-101,-16,-15,-1,4,3,-2,2,0,-7,8,1,-4,4,0,-1,1,0,0,-9,-4,2,-4,2,-3,0,0,-1,1,-1,-1,1,-1
KR_6738954458,420,-4,-53,-8,-6,-3,4,1,2,1,3,1,2,3,-4,5,1,-2,2,0,0,-7,14,-5,-2,7,0,0,-1,-1,-1,-1,-1,4,-1
KR_6753727299,420,-4,-41,9,-5,0,1,1,-1,3,2,0,4,4,-4,4,0,0,1,1,0,-9,-2,-1,-3,4,2,0,-1,1,-1,-1,1,2,-1
KR_6755517904,420,-4,-53,-36,-5,-2,2,0,-3,6,3,-1,3,2,-1,4,3,2,1,3,0,0,-3,0,-2,2,-3,0,1,0,-1,1,-1,0,-1
KR_6678143086,440,-1,-2,27,-5,-4,4,0,2,2,4,6,0,6,-10,11,1,1,4,5,1,-2,-11,0,-3,3,0,0,0,0,1,-1,1,0,-1
KR_6663415072,420,0,-28,-27,0,-2,2,0,-2,3,1,1,0,1,3,0,3,0,1,1,0,2,221,2,-3,1,-2,0,1,1,-1,1,-1,4,-1
KR_6744956748,420,-3,50,4,-7,0,1,1,0,3,3,0,1,1,-4,6,2,-3,5,2,0,1,36,0,-2,2,-17,0,-2,-1,-1,-1,-1,6,-1
KR_6747171961,440,-5,-94,-36,-8,1,3,4,-1,2,1,-1,3,2,-2,4,2,-5,5,0,0,0,-85,-2,-2,4,2,0,0,-1,-1,0,1,2,-1
KR_6735418356,420,-4,-53,0,-10,-4,5,1,-5,6,1,-1,3,2,-3,3,0,3,0,3,0,-19,-1,-4,-1,5,1,0,-2,-1,-1,-1,-1,6,-1
KR_6748144286,420,-3,-19,10,-9,-2,5,3,-2,2,0,-8,10,2,3,1,4,0,1,1,1,-13,10,-2,-3,5,-2,0,-1,1,-1,-1,1,4,-1
KR_6759668765,420,-2,-51,37,-5,0,2,2,0,3,3,-2,2,0,-1,4,3,-2,2,0,-1,-8,243,1,-3,2,0,0,0,1,1,-1,-1,6,-1
KR_6737704063,420,-4,-114,8,-11,2,1,3,-2,3,1,-7,7,0,-4,7,3,0,2,2,-1,-11,105,-2,-3,5,-4,0,-1,1,-1,-1,-1,1,-1
KR_6741147893,420,1,50,31,8,-1,1,0,-3,3,0,3,0,3,9,0,9,0,1,1,0,4,-5,3,-5,2,0,0,0,1,-1,1,1,1,-1
KR_6743935458,420,2,33,4,2,1,2,3,0,1,1,0,4,4,0,2,2,1,1,2,-1,4,-7,-2,-1,3,3,0,0,0,1,0,-1,0,-1
KR_6629634993,420,-5,-27,-43,-13,-2,3,1,-3,6,3,-5,5,0,-2,2,0,-1,2,1,0,-10,-5,-2,-2,4,3,0,-1,-1,-1,-1,-1,2,-1
KR_6644494504,420,-5,-47,-17,-10,0,0,0,-1,2,1,-6,8,2,0,1,1,-3,3,0,-1,-9,-17,0,-2,2,3,0,-3,-1,1,-1,-1,3,-1
KR_6748060397,420,0,45,-37,-1,3,1,4,-1,1,0,-3,5,2,2,0,2,-2,2,0,0,-2,44,-2,-1,3,-24,0,0,-1,0,1,-1,4,-1
KR_6756460475,420,-2,-15,8,-12,2,2,4,-1,5,4,-8,10,2,-4,5,1,-1,2,1,0,-19,-4,3,-3,0,-3,0,-3,-1,-1,-1,-1,3,-1
KR_6742248032,420,-2,-41,-32,-2,-1,2,1,0,5,5,-1,2,1,-2,5,3,2,0,2,-1,1,-146,-5,0,5,-1,0,-2,-1,-1,-1,-1,6,-1
KR_6745053274,420,-4,-69,-11,-9,2,0,2,0,3,3,-5,7,2,-2,2,0,-4,4,0,0,-8,0,6,-7,1,-5,0,-1,1,-1,-1,-1,6,-1
KR_6760983339,440,2,70,4,4,2,1,3,0,0,0,6,0,6,-8,10,2,4,0,4,0,-1,7,-1,-5,6,-1,0,-1,-1,1,-1,-1,1,-1
KR_6754074015,440,-8,-129,16,-21,-5,6,1,-11,12,1,2,1,3,-4,4,0,-3,3,0,0,-15,-3,-4,-3,7,-2,0,-1,1,-1,-1,-1,1,-1
KR_6763192231,440,-1,10,0,5,-3,4,1,0,3,3,5,0,5,3,0,3,0,0,0,0,4,46,0,-2,2,-15,0,0,0,0,0,1,0,-1
KR_6714796740,440,-3,-67,-3,-11,1,2,3,-3,4,1,-5,5,0,-6,6,0,2,0,2,0,-8,3,1,-6,5,-5,0,0,1,1,0,-1,5,-1
KR_6684223232,420,2,-1,22,2,6,0,6,4,3,7,-2,4,2,-4,5,1,-2,3,1,-2,-7,73,-2,-4,6,2,0,-1,-1,-1,-1,-1,5,-1
KR_6696097089,420,1,-27,20,3,-3,4,1,0,6,6,2,3,5,3,1,4,1,2,3,0,5,-377,-6,-3,9,0,0,0,-1,1,0,-1,4,-1
KR_6761284823,420,-3,-58,1,-7,-4,5,1,1,0,1,1,1,2,-5,5,0,0,1,1,0,-5,-7,0,-3,3,1,0,1,-1,-1,1,-1,5,-1
KR_6763640595,420,0,-2,-16,0,3,1,4,3,2,5,-4,4,0,-1,3,2,-1,2,1,0,3,0,2,-2,0,-3,0,0,1,0,0,1,3,-1
KR_6704257150,420,-2,-31,-36,-6,-3,3,0,-3,6,3,1,3,4,-2,3,1,1,1,2,0,-6,0,-1,-3,4,-1,0,-2,-1,-1,-1,-1,6,-1
KR_6751374164,440,1,29,-36,4,-2,4,2,1,2,3,2,2,4,1,2,3,2,2,4,0,10,-11,-1,-3,4,3,0,1,0,1,1,-1,0,-1
KR_6759404271,420,-1,-55,-4,5,5,1,6,3,0,3,-6,7,1,3,2,5,0,1,1,0,2,8,5,-8,3,-1,0,0,-1,1,0,1,1,-1
KR_6753985305,420,-2,-53,-6,1,1,0,1,0,2,2,1,4,5,-1,4,3,0,0,0,-1,-2,0,0,-4,4,2,0,-2,-1,0,-1,-1,1,-1
KR_6764280424,420,0,32,-17,2,1,0,1,0,6,6,-2,3,1,3,0,3,0,2,2,1,9,-10,1,-3,2,-1,0,0,-1,1,1,1,3,-1
KR_6758008189,420,-1,5,0,-13,-3,4,1,-1,4,3,0,2,2,-4,8,4,-5,6,1,-1,-8,-14,-3,-4,7,1,0,0,-1,-1,-1,-1,6,-1
KR_6760083796,420,1,61,26,-3,-2,3,1,-5,5,0,0,3,3,5,4,9,-1,1,0,0,-3,17,-1,-3,4,4,0,0,1,1,1,-1,2,-1
KR_6753803346,420,2,7,-24,3,-1,2,1,4,2,6,-3,3,0,4,0,4,-1,2,1,2,6,-5,0,-1,1,0,0,0,1,-1,1,1,6,-1
KR_6651022297,420,3,-66,8,6,-1,2,1,5,3,8,-1,4,3,3,0,3,0,0,0,-1,9,6,2,-2,0,2,0,0,-1,1,0,-1,3,-1
KR_6698285026,420,-2,-17,-22,-4,4,1,5,0,0,0,-2,4,2,-4,6,2,-2,2,0,-1,-4,12,1,-1,0,-1,0,0,-1,-1,-1,-1,5,-1
KR_6749121308,420,-5,-24,-40,-15,1,1,2,-1,2,1,-5,6,1,-9,11,2,-1,1,0,-1,-17,2,-7,-1,8,0,0,-1,-1,0,-1,-1,4,-1
KR_6756962361,420,0,71,12,-2,1,3,4,-7,8,1,2,0,2,3,3,6,-1,2,1,0,0,2,2,-4,2,0,0,1,-1,1,1,-1,6,-1
KR_6753776959,420,0,38,0,4,-3,4,1,0,3,3,7,1,8,0,2,2,0,0,0,0,5,-322,1,-2,1,-17,0,-1,1,-1,1,1,4,-1
KR_6739956934,420,-1,20,-10,-3,-1,2,1,-3,4,1,1,5,6,0,4,4,0,0,0,0,-4,454,0,-2,2,3,0,1,1,0,1,1,5,-1
KR_6734957714,420,-3,-29,4,-4,-6,6,0,3,1,4,4,1,5,-5,9,4,0,2,2,1,4,30,-2,-3,5,-23,0,-2,1,1,-1,1,3,-1
KR_6759148393,420,-2,-19,5,-4,-6,8,2,6,0,6,0,2,2,-3,3,0,-1,1,0,-1,-5,1,-4,0,4,0,0,0,0,1,0,-1,0,-1
KR_6704330725,420,-2,-10,4,-7,-2,4,2,-2,2,0,-7,7,0,5,1,6,-1,2,1,0,-1,-43,-2,-3,5,9,0,-1,-1,0,-1,1,5,-1
KR_6764267781,440,-5,-29,-39,-10,-1,2,1,4,2,6,-7,7,0,-3,5,2,-3,3,0,0,-2,-8,-2,-2,4,-2,0,0,0,0,0,1,0,-1
KR_6746152347,440,5,49,-24,14,-2,4,2,2,0,2,3,2,5,5,1,6,6,0,6,0,7,-3,-4,-1,5,2,0,1,-1,1,1,-1,5,-1
KR_6745108931,420,-4,32,-16,-5,1,0,1,-4,5,1,-4,4,0,1,4,5,1,3,4,1,-2,-12,1,-1,0,-1,0,-1,1,0,-1,1,2,-1
KR_6761065079,420,0,80,16,-7,0,1,1,-2,4,2,-3,4,1,-2,3,1,0,1,1,0,-8,45,3,-6,3,-22,0,0,1,1,0,-1,6,-1
KR_6746740305,420,-3,-8,-10,0,-2,3,1,-2,3,1,2,1,3,1,2,3,1,1,2,0,0,2,3,-7,4,-3,0,-1,1,-1,-1,1,5,-1
KR_6354462998,420,3,24,4,0,-4,4,0,-1,2,1,4,0,4,1,0,1,0,2,2,0,3,0,0,0,0,4,0,0,0,0,1,1,0,-1
KR_6753943385,420,1,5,-23,4,4,0,4,-5,6,1,3,1,4,3,1,4,-1,1,0,0,-5,17,-2,-2,4,0,0,0,0,0,0,-1,0,-1
KR_6728230722,420,-2,84,-28,-2,2,0,2,-2,7,5,2,0,2,-4,6,2,0,0,0,0,-3,6,-3,-3,6,0,0,0,-1,-1,1,-1,1,-1
KR_6762894608,420,1,37,8,4,1,0,1,-1,2,1,1,2,3,1,2,3,2,0,2,0,0,-4,2,-5,3,0,0,0,0,1,1,1,0,-1
KR_6730632475,420,-3,-98,8,-3,0,1,1,-1,1,0,-1,4,3,2,1,3,-3,3,0,0,-4,-210,1,-2,1,2,0,0,0,1,0,1,0,-1
KR_6684284220,420,-2,39,13,-9,-2,2,0,-1,1,0,-7,8,1,0,0,0,1,1,2,0,0,5,3,-4,1,-1,0,-1,1,-1,1,-1,6,-1
KR_6715570008,420,-2,-29,-10,-10,-2,3,1,-3,5,2,-1,1,0,-3,4,1,-1,1,0,0,-6,-17,1,-2,1,0,0,-1,-1,-1,-1,-1,5,-1
KR_6728378650,420,-2,-40,-2,-6,0,1,1,-3,5,2,0,2,2,-3,3,0,0,3,3,0,-9,-10,-2,-4,6,-1,0,0,-1,0,0,-1,5,-1
KR_6756671330,420,-1,18,9,-3,-1,4,3,-7,9,2,2,2,4,2,0,2,1,0,1,0,1,-13,4,-5,1,-2,0,0,1,-1,-1,1,1,-1
KR_6712734674,440,-2,10,7,-1,-3,4,1,1,3,4,-1,3,2,-2,4,2,4,2,6,2,7,12,-3,0,3,1,0,-1,1,-1,-1,1,6,-1
KR_6752158347,420,-4,6,-26,-12,-2,4,2,-4,4,0,1,1,2,-6,11,5,-1,1,0,-1,-14,1,2,-2,0,-1,0,1,-1,1,1,-1,6,-1
KR_6760998228,420,-1,-14,-31,-4,0,2,2,-2,5,3,3,0,3,-4,4,0,-1,1,0,0,-3,4,-1,-2,3,-2,0,-1,1,-1,-1,-1,1,-1
KR_6763731479,420,-7,-141,-7,-9,-7,7,0,0,4,4,-2,4,2,0,1,1,0,0,0,0,0,158,-1,-3,4,-4,0,-2,-1,1,-1,1,4,-1
KR_6713073071,420,-6,-56,-40,-9,-4,4,0,-3,4,1,-2,2,0,-2,3,1,2,0,2,0,-4,-93,-3,-1,4,-3,0,-2,-1,0,-1,-1,2,-1
KR_6705389425,420,2,-47,-8,4,1,0,1,1,2,3,-2,4,2,4,0,4,0,0,0,0,7,322,-4,0,4,-1,0,1,1,0,1,1,3,-1
KR_6706452358,420,-5,-105,-16,-12,1,4,5,-1,1,0,-4,4,0,-4,4,0,-4,4,0,0,-6,2,-1,-1,2,0,0,-1,-1,-1,-1,-1,3,-1
KR_6732438717,420,-4,-31,-16,-7,-5,5,0,-1,2,1,-1,1,0,2,0,2,-2,3,1,0,-3,3,5,-5,0,-3,0,-1,-1,-1,-1,-1,4,-1
KR_6728715217,440,0,-11,-20,0,5,0,5,-5,5,0,-1,2,1,-1,1,0,2,0,2,0,-11,-11,-2,-1,3,2,0,2,1,1,1,-1,3,-1
KR_6693534333,420,-4,-32,-28,-18,0,2,2,-8,10,2,-5,6,1,-4,5,1,-1,4,3,-1,-6,123,2,-3,1,-1,0,-1,-1,1,-1,-1,1,-1
KR_6761095575,440,-2,-3,-8,-7,-3,3,0,0,1,1,-9,9,0,5,1,6,0,1,1,0,5,5,0,0,0,0,0,0,1,0,-1,-1,6,-1
KR_6751971446,440,-1,-89,24,2,2,2,4,-2,7,5,5,2,7,-3,5,2,0,2,2,0,-2,0,-3,-2,5,2,0,0,1,-1,-1,-1,2,-1
KR_6761927810,440,0,-42,-36,3,-4,4,0,0,5,5,-3,7,4,6,1,7,4,2,6,0,8,22,0,-1,1,1,0,2,0,0,1,-1,0,-1
KR_6748944176,440,-2,-20,0,1,2,0,2,-1,3,2,-1,1,0,-4,6,2,5,0,5,0,-1,-29,0,-2,2,3,0,0,1,1,0,1,6,-1
KR_6757591885,420,-1,-24,-8,-2,0,1,1,-1,3,2,0,2,2,0,7,7,-1,1,0,0,-5,-4,-1,-1,2,2,0,-1,-1,-1,-1,1,6,-1
KR_6744794864,420,-3,-63,-12,-5,-2,4,2,0,4,4,-4,6,2,3,2,5,-2,4,2,0,2,3,1,-2,1,0,0,-1,-1,1,-1,-1,2,-1
KR_6662950518,420,3,4,-8,6,1,1,2,3,1,4,2,1,3,-2,3,1,2,0,2,0,6,108,0,-3,3,-1,0,1,1,-1,1,-1,5,-1
KR_6702384442,420,-7,-136,-12,-18,-7,7,0,-1,3,2,-6,9,3,-4,5,1,0,1,1,0,-9,-2,-4,0,4,1,0,-2,-1,-1,-1,1,5,-1
KR_6685815359,420,-2,-57,27,-1,-3,3,0,5,1,6,-1,1,0,1,1,2,-3,3,0,0,5,12,-2,-4,6,-4,0,0,1,1,0,1,6,-1
KR_6732195806,420,-4,-103,-4,-9,-1,2,1,1,3,4,2,1,3,-7,8,1,-4,4,0,-1,-16,6,-2,-1,3,1,0,-1,-1,0,-1,1,1,-1
KR_6734873277,420,-1,-16,2,-6,-7,9,2,-1,3,2,4,1,5,0,1,1,-2,2,0,-1,-8,4,5,-6,1,-2,0,0,-1,1,-1,-1,1,-1
KR_6762962588,420,-3,2,-15,-13,-6,7,1,-2,4,2,-5,5,0,0,1,1,0,1,1,0,-8,-2,-2,-1,3,-1,0,-1,-1,-1,-1,-1,1,-1
KR_6762325588,420,-4,-80,-21,-15,-4,5,1,-4,5,1,-5,7,2,-2,5,3,0,2,2,0,-5,3,-1,-1,2,2,0,-1,-1,1,-1,-1,1,-1
KR_6741770848,420,1,-30,9,0,-2,3,1,-1,1,0,1,2,3,2,2,4,0,0,0,2,4,7,-1,-4,5,-1,0,0,1,-1,0,1,4,-1
KR_6689800170,420,0,-38,-4,2,1,2,3,0,2,2,-4,6,2,3,1,4,2,1,3,0,5,8,0,-2,2,1,0,0,-1,0,-1,-1,3,-1
KR_6660937589,440,-5,-70,-16,-9,1,2,3,1,2,3,-5,7,2,-4,4,0,-2,2,0,0,-16,4,-1,-2,3,2,0,0,0,1,-1,-1,0,-1
KR_6715760276,420,-2,-67,-8,0,0,4,4,3,0,3,1,2,3,-3,5,2,-1,3,2,0,5,4,3,-4,1,-5,0,-1,-1,-1,-1,1,4,-1
KR_6752350432,420,-3,-31,-16,-3,4,0,4,2,3,5,-5,7,2,-3,3,0,-1,1,0,0,1,180,3,-3,0,-2,0,0,-1,0,1,-1,3,-1
KR_6749192603,420,3,41,12,13,6,1,7,1,3,4,3,1,4,0,2,2,3,0,3,0,10,170,0,-1,1,3,0,1,-1,1,1,1,3,-1
KR_6684561991,420,-2,53,-4,-10,3,0,3,-4,5,1,-2,2,0,-6,6,0,-1,2,1,0,-12,-6,0,-3,3,-5,0,1,-1,-1,1,-1,1,-1
KR_6753343364,420,4,59,16,7,-3,4,1,6,0,6,-1,3,2,5,0,5,0,2,2,0,8,-42,2,-5,3,31,0,0,1,0,-1,-1,4,-1
KR_6764426404,440,3,-16,24,8,2,0,2,5,0,5,-5,7,2,2,0,2,4,0,4,0,7,-3,0,-3,3,4,0,0,-1,1,0,-1,3,-1
KR_6749428819,420,-2,-110,20,-5,-3,4,1,1,2,3,0,2,2,-1,2,1,-2,2,0,0,-2,-13,-2,-2,4,-2,0,-1,0,-1,-1,-1,0,-1
KR_6592914403,420,-2,-58,-1,-9,-2,2,0,4,1,5,-3,4,1,-8,8,0,0,2,2,0,-5,180,0,-3,3,-2,0,-1,0,1,-1,-1,0,-1
KR_6757635812,420,1,-35,3,1,0,2,2,-2,3,1,3,1,4,0,2,2,0,0,0,0,-2,-15,-1,-4,5,21,0,0,1,1,0,-1,6,-1
KR_6747171550,420,4,40,12,11,2,2,4,3,1,4,2,3,5,5,0,5,-1,1,0,-1,8,1,-2,-3,5,2,0,2,1,1,1,-1,4,-1
KR_6759795050,420,-2,-50,-46,-8,1,1,2,-3,4,1,-7,7,0,-2,3,1,3,0,3,0,-12,-184,-2,-4,6,0,0,-2,1,1,-1,-1,4,-1
KR_6728848259,420,-4,-141,19,-6,1,1,2,2,3,5,-1,3,2,1,2,3,-9,10,1,0,-1,-1,0,-1,1,-4,0,-1,-1,-1,-1,-1,6,-1
KR_6713727184,420,-1,-28,3,-8,1,1,2,3,0,3,-3,4,1,-8,8,0,-1,1,0,0,-6,8,2,-2,0,0,0,-1,0,-1,-1,-1,0,-1
KR_6691820751,420,2,5,32,3,1,0,1,1,1,2,-1,4,3,0,2,2,2,0,2,0,-1,15,3,-3,0,2,0,0,-1,1,0,-1,3,-1
KR_6664517479,420,0,20,-16,-9,1,4,5,-4,5,1,2,0,2,-4,4,0,-4,4,0,1,-10,1,1,-4,3,-1,0,-1,-1,1,1,1,6,-1
KR_6762739330,420,-2,15,-7,-3,0,1,1,1,3,4,0,3,3,-3,3,0,-1,2,1,0,-6,-159,-3,0,3,2,0,0,-1,-1,0,1,6,-1
KR_6723078150,420,-3,-11,28,-10,2,1,3,-2,2,0,-2,4,2,-6,8,2,-2,2,0,0,-22,-13,-3,-4,7,0,0,1,-1,1,1,1,2,-1
KR_6735228344,420,-1,48,-40,-7,4,2,6,-4,5,1,-3,5,2,-4,4,0,0,0,0,0,-10,4,3,-3,0,-1,0,-1,1,-1,-1,1,3,-1
KR_6693074614,420,1,-27,-2,7,3,2,5,2,0,2,2,1,3,-1,2,1,1,0,1,0,10,-7,-2,-1,3,-2,0,0,-1,1,0,1,5,-1
KR_6640889290,420,-2,-75,-4,0,1,3,4,1,3,4,3,1,4,0,4,4,-5,5,0,0,0,-3,0,-3,3,2,0,0,1,1,-1,-1,4,-1
KR_6657312629,440,1,-4,10,4,-3,5,2,4,3,7,6,0,6,-4,5,1,1,1,2,3,2,-1,1,-2,1,2,0,0,-1,1,1,1,3,-1
KR_6727203024,420,-2,38,-2,-1,-2,4,2,-6,6,0,-1,3,2,1,1,2,7,0,7,0,-1,-4,-2,-1,3,2,0,-1,1,-1,-1,-1,6,-1
KR_6751864374,420,-1,-55,-24,4,1,0,1,2,2,4,-1,2,1,2,1,3,0,1,1,1,8,23,-1,-2,3,0,0,1,1,-1,-1,1,1,-1
KR_6729692946,420,1,-50,76,-1,1,1,2,-2,7,5,-3,3,0,0,2,2,3,1,4,0,0,0,-3,-2,5,0,0,0,-1,-1,0,-1,4,-1
KR_6762839732,420,0,44,-19,0,1,2,3,-3,6,3,-6,6,0,4,0,4,4,0,4,0,0,5,-1,0,1,-1,0,0,-1,0,1,1,2,-1
KR_6739115506,420,-3,66,-29,-9,-2,3,1,-4,5,1,-4,5,1,0,2,2,1,0,1,0,-3,4,2,-2,0,-3,0,0,-1,-1,0,1,2,-1
KR_6735770121,420,-1,-26,12,-7,1,0,1,0,1,1,2,1,3,-7,7,0,-3,3,0,0,-9,14,-1,-1,2,1,0,-1,1,-1,-1,-1,5,-1
KR_6748688424,420,-2,58,-12,-3,1,1,2,0,4,4,-3,5,2,3,5,8,-4,6,2,0,2,36,4,-5,1,-31,0,-1,-1,-1,-1,1,5,-1
KR_6747427665,420,3,-7,-4,8,-1,2,1,0,3,3,5,1,6,1,1,2,3,2,5,0,2,17,4,-5,1,3,0,0,0,1,1,1,0,-1
KR_6761327364,420,-2,-56,0,-7,-1,2,1,0,1,1,2,2,4,-5,7,2,-3,3,0,0,-10,-5,2,-5,3,2,0,0,-1,1,0,-1,4,-1
KR_6750586365,420,1,-1,-28,-5,-3,4,1,1,2,3,-3,3,0,0,0,0,0,0,0,-1,0,7,-2,-1,3,1,0,0,-1,-1,1,-1,1,-1
KR_6760511357,420,-2,-18,-7,-6,2,2,4,-3,4,1,1,1,2,-1,4,3,-5,5,0,0,-3,112,-4,-2,6,-4,0,0,-1,-1,-1,-1,5,-1
KR_6757897660,420,1,25,-12,1,0,1,1,-2,3,1,3,1,4,3,3,6,-3,4,1,2,6,9,2,-2,0,1,0,0,1,1,1,1,5,-1
KR_6742015100,420,-4,-31,-24,0,-3,3,0,2,1,3,0,1,1,-1,2,1,2,0,2,0,1,7,2,-3,1,-1,0,0,0,-1,-1,-1,0,-1
KR_6740884433,420,-1,-18,-26,-6,-3,3,0,2,1,3,-1,3,2,0,1,1,-4,4,0,0,-4,0,2,-3,1,-1,0,0,0,1,-1,-1,0,-1
KR_6732038561,440,-3,-21,-14,-9,-5,5,0,-1,4,3,0,2,2,0,3,3,-3,3,0,0,-8,-431,-4,0,4,1,0,-3,-1,-1,-1,1,2,-1
KR_6748882912,420,1,55,4,-1,2,1,3,0,1,1,-5,6,1,0,4,4,2,1,3,-1,-1,-20,3,-4,1,1,0,2,-1,1,1,-1,3,-1
KR_6681214689,420,-2,-1,-8,-6,-1,2,1,3,2,5,1,2,3,-9,10,1,0,2,2,-1,-12,-8,-1,-2,3,0,0,-1,-1,1,-1,-1,2,-1
KR_6755143612,420,0,-21,29,0,1,1,2,2,0,2,1,3,4,0,1,1,-4,4,0,2,-1,-20,1,-2,1,-3,0,1,1,1,1,1,4,-1
KR_6653102368,420,-10,-123,-24,-13,0,0,0,-2,2,0,-6,6,0,-2,4,2,-3,3,0,0,-15,49,-3,-1,4,-1,0,-5,-1,-1,-1,-1,4,-1
KR_6734978890,420,0,29,-22,-1,-5,5,0,0,4,4,-1,4,3,4,1,5,1,2,3,0,4,29,1,-3,2,-16,0,0,0,-1,0,-1,0,-1
KR_6645624030,420,0,-13,-35,-8,0,1,1,-8,10,2,-1,4,3,1,1,2,0,1,1,0,-6,-33,-2,-2,4,4,0,0,-1,1,-1,-1,2,-1
KR_6644453424,420,-5,20,-22,-7,-2,3,1,-7,9,2,2,1,3,0,1,1,0,2,2,0,-8,-5,2,-2,0,-2,0,0,-1,-1,-1,1,1,-1
KR_6757303052,420,-1,20,-18,-5,-1,2,1,-4,8,4,-1,2,1,-3,4,1,4,1,5,1,6,18,2,-3,1,-2,0,0,1,0,0,1,4,-1
KR_6761862898,420,-3,-98,2,-8,-3,4,1,1,1,2,-5,6,1,1,0,1,-2,2,0,0,-4,2,-2,-4,6,0,0,-1,0,-1,-1,-1,0,-1
KR_6764249763,420,0,73,-32,-1,-1,2,1,2,0,2,-3,3,0,0,4,4,1,0,1,0,3,2,0,-3,3,3,0,1,-1,-1,1,-1,4,-1
KR_6745498409,420,3,35,16,3,4,0,4,2,1,3,1,2,3,-1,3,2,-3,3,0,0,-4,44,3,-3,0,-20,0,-1,-1,1,1,1,4,-1
KR_6709900519,420,0,-27,-4,-7,-5,5,0,0,3,3,1,2,3,-1,2,1,-2,3,1,0,-4,380,0,-3,3,-21,0,-1,1,-1,-1,-1,6,-1
KR_6762435070,420,-2,17,-25,2,0,2,2,3,1,4,-1,4,3,1,1,2,-1,1,0,0,-3,-150,2,-6,4,1,0,1,0,1,1,1,0,-1
KR_6734560978,420,1,-11,-12,0,2,0,2,1,0,1,0,1,1,-2,7,5,-1,1,0,0,0,23,4,-5,1,-1,0,1,-1,1,1,-1,4,-1
KR_6731503278,420,-3,-37,-3,-5,-1,1,0,1,0,1,-8,8,0,3,0,3,0,1,1,0,-1,-6,1,-2,1,-1,0,0,1,1,0,1,3,-1
KR_6763220554,440,-6,-66,-13,-11,-4,5,1,0,1,1,-2,4,2,-4,5,1,-1,3,2,0,-5,18,1,-1,0,1,0,0,-1,1,0,-1,1,-1
KR_6634693159,420,-5,-94,-36,-6,1,0,1,0,1,1,-5,6,1,-1,1,0,-1,1,0,0,0,-2,0,-2,2,-2,0,-2,-1,-1,-1,-1,4,-1
KR_6757022231,420,-2,10,-4,-6,4,0,4,-4,4,0,-5,5,0,-1,1,0,0,2,2,0,-8,-160,-3,-2,5,3,0,-1,-1,1,-1,-1,2,-1
KR_6632067817,420,-4,-8,0,-6,-5,5,0,3,1,4,2,4,6,-2,2,0,-4,4,0,0,-2,-1,-3,-2,5,-1,0,-2,1,-1,-1,1,6,-1
KR_6750216785,420,0,52,24,-4,-1,3,2,1,4,5,0,3,3,-6,9,3,2,2,4,0,-10,5,0,-1,1,0,0,1,-1,1,1,-1,6,-1
KR_6754684948,420,-1,-102,-4,-9,-2,2,0,-3,3,0,-2,3,1,-2,2,0,0,0,0,0,-6,-158,1,-2,1,-2,0,-2,-1,-1,-1,-1,3,-1
KR_6740797295,420,3,36,-12,3,-1,3,2,-1,5,4,4,0,4,0,2,2,1,0,1,0,1,-8,-1,-3,4,2,0,1,1,-1,-1,-1,6,-1
KR_6632827159,420,-4,-62,-52,-10,0,2,2,-1,2,1,0,2,2,-8,9,1,-1,2,1,0,-14,9,-3,0,3,0,0,-1,1,-1,-1,1,4,-1
KR_6758229281,420,-1,-19,-12,-5,-2,2,0,0,1,1,0,1,1,-2,4,2,-1,4,3,0,-3,116,-3,-1,4,-1,0,0,0,1,0,-1,0,-1
KR_6646291774,420,-5,-75,-16,-11,-3,4,1,-2,7,5,-5,5,0,-4,4,0,3,1,4,-1,-3,-450,-2,-1,3,-1,0,0,-1,-1,-1,-1,5,-1
KR_6694331020,420,1,28,-8,0,0,2,2,0,1,1,-3,4,1,3,2,5,0,2,2,0,1,-5,-1,0,1,0,0,0,-1,0,1,-1,3,-1
KR_6744386645,420,-1,-65,-8,-1,2,1,3,-4,4,0,3,1,4,3,0,3,-5,5,0,0,2,-15,1,-3,2,-1,0,0,1,1,0,1,2,-1
KR_6760783497,420,-5,-4,-40,-13,1,0,1,-3,4,1,-1,1,0,-3,4,1,-7,8,1,0,-10,-3,-1,-3,4,0,0,0,-1,1,1,1,6,-1
KR_6756238775,420,2,8,-20,8,2,2,4,4,0,4,-1,3,2,3,1,4,0,2,2,0,4,0,0,-3,3,4,0,-1,1,-1,-1,-1,3,-1
KR_6743694494,420,-1,-38,-20,0,-1,2,1,3,1,4,1,2,3,-2,3,1,-1,1,0,0,2,-49,-4,0,4,20,0,1,1,-1,1,-1,6,-1
KR_6762195741,420,-3,-92,4,-14,-3,3,0,1,0,1,-7,7,0,0,4,4,-5,6,1,-1,-11,-10,-3,-2,5,2,0,-3,-1,-1,-1,-1,1,-1
KR_6754935960,420,-8,-116,-60,-15,-8,8,0,0,0,0,-3,6,3,1,4,5,-5,6,1,-2,-7,-6,2,-3,1,0,0,-3,-1,-1,-1,-1,5,-1
KR_6734609170,420,-2,-78,-9,-1,-3,5,2,-2,2,0,0,2,2,4,3,7,0,0,0,0,-11,-5,0,-2,2,-1,0,-3,-1,-1,-1,1,5,-1
KR_6734445613,420,3,28,24,-6,-1,4,3,-2,7,5,-2,3,1,0,6,6,-1,3,2,0,-2,14,1,-1,0,2,0,1,1,1,1,-1,4,-1
KR_6731532456,420,1,-26,9,2,2,1,3,3,2,5,-2,5,3,-2,5,3,1,0,1,1,-1,-183,1,-2,1,1,0,0,1,-1,-1,1,6,-1
KR_6739443778,440,0,-24,-8,-5,-1,1,0,-3,4,1,-2,9,7,-1,1,0,2,2,4,-1,-13,-1,-2,0,2,-1,0,1,0,1,-1,-1,0,-1
KR_6744251724,420,-9,-104,1,-15,-2,3,1,0,4,4,-8,8,0,-4,5,1,-1,1,0,1,-5,-1,3,-7,4,-6,0,-1,-1,-1,-1,1,3,-1
KR_6713465541,420,-3,-82,12,-8,-2,4,2,2,0,2,-6,6,0,-2,2,0,0,3,3,-1,2,-2,2,-2,0,-2,0,-2,-1,1,-1,-1,3,-1
KR_6695689482,420,3,13,-4,12,4,1,5,3,3,6,0,3,3,4,3,7,1,0,1,0,15,308,4,-4,0,1,0,2,1,1,1,1,6,-1
KR_6661440055,420,-3,-13,-35,-12,-1,3,2,3,2,5,1,4,5,-11,11,0,-4,4,0,0,-13,0,-1,-2,3,1,0,-1,-1,1,-1,-1,4,-1
KR_6760170369,420,1,-65,28,2,0,2,2,-2,3,1,1,2,3,0,1,1,3,2,5,0,4,4,-1,-3,4,2,0,-1,-1,-1,-1,1,4,-1
KR_6710713883,420,-2,-67,90,-8,-7,7,0,0,2,2,0,2,2,-4,4,0,3,0,3,0,-8,-26,-4,0,4,3,0,-3,0,1,-1,-1,0,-1
KR_6739301921,440,-1,11,-20,-3,1,1,2,-2,2,0,-5,5,0,4,1,5,-1,4,3,0,-3,-4,-3,-2,5,3,0,0,0,1,0,-1,0,-1
KR_6715332917,440,-4,-34,10,-10,1,2,3,-1,4,3,-1,3,2,-8,9,1,-1,1,0,0,-12,-103,0,-3,3,-4,0,0,-1,1,-1,-1,2,-1
KR_6749236715,440,-2,27,7,-13,-2,3,1,0,2,2,0,1,1,-5,6,1,-6,6,0,0,-19,16,-1,-1,2,0,0,0,-1,1,-1,1,2,-1
KR_6729322519,420,0,-111,-4,1,0,1,1,0,3,3,2,1,3,-1,2,1,0,0,0,0,7,-90,0,-2,2,3,0,0,-1,-1,-1,1,3,-1
KR_6743240595,420,-3,-56,-23,-8,-2,3,1,-2,4,2,-4,4,0,0,0,0,0,0,0,0,-6,5,5,-6,1,-2,0,0,0,-1,0,-1,0,-1
KR_6736953004,420,-5,-115,-18,-10,-1,2,1,2,0,2,-4,4,0,-3,4,1,-4,4,0,0,-3,-2,3,-6,3,-1,0,-1,0,1,-1,-1,0,-1
KR_6742727224,420,-10,-93,-8,-14,-1,3,2,-2,3,1,-2,4,2,-5,5,0,-4,4,0,-1,-19,-6,-3,0,3,-1,0,-2,-1,-1,-1,-1,2,-1
KR_6756633475,420,-2,-49,-4,-6,1,2,3,-12,13,1,4,0,4,1,0,1,0,1,1,-1,-11,-8,-1,-3,4,-2,0,-1,0,-1,-1,-1,0,-1
KR_6729206820,420,-3,-52,-31,-4,-1,2,1,-6,7,1,-2,3,1,5,0,5,0,0,0,0,4,-17,2,-6,4,7,0,0,-1,0,0,-1,3,-1
KR_6756967690,420,-7,-140,-3,-15,0,1,1,-2,2,0,-11,11,0,-2,3,1,0,1,1,-1,-9,10,-1,0,1,-1,0,-1,-1,0,-1,-1,6,-1
KR_6711316702,420,0,24,32,-2,3,1,4,-4,5,1,-3,6,3,2,4,6,0,2,2,0,-15,-38,-5,0,5,9,0,0,-1,1,0,1,4,-1
KR_6695732631,440,4,87,-12,-1,2,1,3,0,4,4,3,1,4,-6,6,0,0,1,1,0,-3,6,0,-3,3,1,0,0,-1,-1,-1,1,4,-1
KR_6668853894,420,-6,-91,16,-17,-5,6,1,-4,4,0,-4,5,1,-3,4,1,-1,1,0,0,-17,224,2,-5,3,-2,0,-1,-1,-1,-1,-1,1,-1
KR_6763726362,420,-4,-118,0,-6,-2,4,2,4,1,5,1,1,2,-9,10,1,0,1,1,0,-3,60,3,-5,2,1,0,-3,0,1,-1,-1,0,-1
KR_6756552326,420,-3,18,2,-11,0,3,3,-1,6,5,-3,3,0,-6,7,1,-1,2,1,0,-23,-37,0,-2,2,16,0,-1,-1,1,-1,-1,6,-1
KR_6760144803,420,-8,-52,-80,-6,6,1,7,-2,2,0,-4,4,0,-5,5,0,-1,1,0,-1,-4,-9,1,-5,4,-6,0,-2,-1,-1,-1,-1,1,-1
KR_6696170407,420,-3,23,-12,-8,-5,5,0,0,1,1,-2,4,2,0,0,0,-1,1,0,0,-5,301,0,-2,2,2,0,-1,1,-1,1,-1,6,-1
KR_6644768794,420,2,41,-28,5,0,1,1,-5,5,0,5,0,5,2,1,3,3,1,4,0,0,-8,2,-3,1,-2,0,0,-1,1,0,-1,1,-1
KR_6745738948,420,0,13,18,-4,2,0,2,-3,3,0,0,0,0,-4,5,1,1,0,1,0,-5,-25,-1,-2,3,7,0,0,-1,0,0,-1,2,-1
KR_6729194462,420,-2,-73,-9,-12,-10,10,0,-2,4,2,0,2,2,0,4,4,0,3,3,1,-3,-4,-1,-2,3,2,0,-2,-1,-1,-1,1,5,-1
KR_6729993276,420,-5,-35,-21,-9,-3,4,1,-3,6,3,1,3,4,1,3,4,-5,6,1,0,-10,9,0,-2,2,0,0,0,1,1,-1,1,5,-1
KR_6723957687,420,-3,27,-32,-4,1,1,2,0,1,1,2,0,2,-3,4,1,-4,5,1,0,-7,-7,0,-2,2,-2,0,0,-1,0,0,-1,6,-1
KR_6762006861,420,-1,0,4,-8,0,1,1,-9,10,1,2,4,6,-1,2,1,0,1,1,0,-14,-467,-3,0,3,21,0,0,-1,0,0,-1,5,-1
KR_6699448475,420,-5,-32,-31,-16,-3,3,0,-1,3,2,-6,10,4,-4,4,0,-2,3,1,0,-7,-1,5,-5,0,-2,0,-3,-1,-1,-1,-1,2,-1
KR_6743043105,420,0,-8,16,-3,-1,2,1,0,2,2,-1,1,0,0,1,1,-1,1,0,0,-3,-25,-5,-1,6,-1,0,0,1,-1,0,-1,6,-1
KR_6757595648,420,-5,-19,-33,-10,-1,2,1,-7,8,1,-5,6,1,1,3,4,2,2,4,0,-8,143,-5,-2,7,2,0,-2,0,-1,-1,1,0,-1
KR_6725012298,440,-2,-57,-4,3,6,0,6,-1,3,2,1,3,4,-3,3,0,0,1,1,-1,-7,-7,0,-2,2,2,0,0,1,1,0,-1,3,-1
KR_6764213608,420,-3,10,-3,-9,-4,4,0,-1,1,0,0,0,0,-3,3,0,-1,1,0,0,-7,3,2,-4,2,-2,0,-1,-1,-1,-1,-1,2,-1
KR_6693045715,420,-3,-17,-23,-9,-9,10,1,1,1,2,1,0,1,-1,2,1,-1,2,1,0,-3,373,0,-2,2,0,0,-1,1,1,-1,-1,4,-1
KR_6730394090,440,1,-5,0,3,-4,6,2,2,0,2,1,2,3,4,0,4,0,0,0,0,6,35,2,-2,0,0,0,-1,-1,-1,-1,-1,4,-1
KR_6762371069,420,-9,-119,-54,-17,-5,6,1,-1,1,0,-3,5,2,-3,7,4,-5,5,0,-1,-21,2,-1,0,1,-2,0,-3,0,-1,-1,-1,0,-1
KR_6743791123,420,-2,-6,9,-4,0,1,1,-5,7,2,-1,2,1,2,2,4,0,0,0,0,-7,8,-1,-4,5,1,0,0,-1,0,0,-1,6,-1
KR_6738897681,420,-4,-93,-37,-5,-2,3,1,0,3,3,-2,2,0,1,3,4,-2,2,0,1,-3,7,-2,-1,3,-1,0,-2,-1,1,-1,1,2,-1
KR_6667126623,420,-2,-65,6,-1,-4,5,1,1,0,1,-1,2,1,0,0,0,3,0,3,0,2,-36,2,-4,2,10,0,-1,1,-1,-1,1,1,-1
KR_6751355397,420,-2,-40,16,-3,1,1,2,1,1,2,-2,6,4,-2,3,1,-1,2,1,0,-2,-36,-4,-2,6,20,0,-1,-1,1,-1,1,1,-1
KR_6659281526,420,2,41,-11,9,5,1,6,0,4,4,1,1,2,3,1,4,0,0,0,0,4,7,5,-7,2,-7,0,1,1,0,1,1,5,-1
KR_6732777057,420,-2,-17,-23,-1,-3,4,1,-1,2,1,0,2,2,4,0,4,-1,1,0,0,2,7,0,-4,4,-3,0,0,1,1,0,-1,6,-1
KR_6756228195,420,-4,-72,20,-11,-4,4,0,1,2,3,-3,4,1,-5,5,0,0,0,0,-1,-7,1,-1,-3,4,-2,0,0,0,-1,0,-1,0,-1
KR_6675688365,420,-12,-89,-98,-11,0,0,0,-1,1,0,-6,6,0,-1,1,0,-3,3,0,0,-8,-22,-2,-1,3,0,0,-4,-1,-1,-1,-1,6,-1
KR_6660361747,420,-10,-42,-128,-1,0,1,1,-2,2,0,1,6,7,-1,1,0,1,1,2,-2,-2,-198,-4,0,4,-3,0,-2,-1,-1,-1,-1,6,-1
KR_6757454523,420,-2,5,-8,-4,0,1,1,-1,2,1,-5,5,0,-3,4,1,5,1,6,0,1,7,1,-2,1,0,0,1,1,1,1,1,3,-1
KR_6763637098,420,0,-4,14,-2,-3,3,0,0,0,0,2,0,2,0,2,2,-1,2,1,0,0,10,-5,-4,9,-2,0,0,1,-1,0,1,5,-1
KR_6761982786,420,-2,-103,8,-7,0,1,1,-4,7,3,-4,5,1,0,3,3,1,0,1,0,4,-1,0,-1,1,-1,0,0,-1,1,0,-1,4,-1
KR_6755162658,420,-2,-37,-9,-3,-4,4,0,2,2,4,1,1,2,-1,2,1,-1,1,0,0,-5,5,-2,-1,3,4,0,-1,0,0,-1,-1,0,-1
KR_6725086792,420,-3,-108,7,-1,-5,6,1,-1,4,3,-2,2,0,5,1,6,2,0,2,0,7,-5,0,-3,3,0,0,-2,1,-1,-1,-1,4,-1
KR_6669482386,420,-3,-65,-16,-4,2,0,2,-2,3,1,2,0,2,-3,3,0,-3,3,0,0,-5,-456,-1,0,1,33,0,-1,-1,1,-1,1,4,-1
KR_6749987976,420,-2,-40,-25,-4,0,2,2,2,1,3,3,1,4,-5,6,1,-4,4,0,0,-2,4,5,-5,0,-1,0,-1,0,-1,-1,1,0,-1
KR_6744649046,420,-2,-95,30,-6,0,4,4,1,1,2,1,2,3,-8,8,0,0,1,1,0,-9,-7,-4,-1,5,-2,0,0,-1,1,-1,1,5,-1
KR_6755049196,420,-3,-76,10,-12,-11,12,1,-1,2,1,3,3,6,-1,3,2,-2,2,0,-1,-1,1,1,-1,0,-1,0,-2,-1,-1,-1,-1,1,-1
KR_6730118327,420,-2,-63,49,-10,-1,3,2,-1,5,4,-6,6,0,1,0,1,-3,4,1,0,-11,-5,1,-4,3,0,0,-1,1,-1,-1,-1,5,-1
KR_6749706319,440,-1,-64,16,-1,-1,3,2,4,0,4,-3,3,0,-1,1,0,0,1,1,0,7,-2,1,-4,3,0,0,-1,1,1,-1,1,1,-1
KR_6695883534,420,-2,3,4,6,-3,4,1,3,0,3,1,3,4,3,3,6,2,0,2,1,0,11,5,-7,2,-1,0,0,-1,-1,1,1,4,-1
KR_6719196339,420,-1,-58,4,-8,-4,6,2,0,2,2,-1,2,1,-4,4,0,1,1,2,-1,-7,-9,-4,0,4,-1,0,-2,-1,-1,-1,-1,1,-1
KR_6713408281,420,-2,-25,-23,-1,-6,8,2,2,4,6,-3,3,0,5,1,6,1,0,1,-1,1,17,0,-1,1,0,0,-1,1,-1,-1,-1,6,-1
KR_6760592658,420,0,5,-24,1,8,0,8,-3,4,1,-1,4,3,1,1,2,-4,4,0,0,-3,-4,-3,0,3,2,0,1,-1,1,1,-1,1,-1
KR_6759233551,420,-2,-21,-27,-8,0,1,1,0,3,3,-7,9,2,-2,5,3,1,0,1,-3,-18,-92,1,-2,1,-2,0,-1,-1,1,-1,-1,3,-1
KR_6735123290,420,-4,-40,-36,-7,-7,7,0,5,0,5,1,0,1,-4,5,1,-2,2,0,0,-2,8,-3,-1,4,-2,0,0,1,0,-1,-1,5,-1
KR_6727667628,420,3,50,12,9,2,2,4,-3,3,0,0,3,3,10,0,10,0,0,0,0,3,10,-3,-1,4,3,0,1,-1,-1,1,1,3,-1
KR_6737067183,420,-3,-45,-12,-6,0,2,2,0,2,2,-3,3,0,-1,2,1,-2,2,0,0,-10,7,4,-6,2,-2,0,1,-1,1,1,-1,3,-1
KR_6734238394,420,1,-45,-28,4,-4,6,2,4,3,7,4,1,5,-1,2,1,1,0,1,-1,1,143,-5,-1,6,3,0,-2,1,1,-1,-1,4,-1
KR_6647246083,420,0,49,15,-3,0,1,1,-1,3,2,2,4,6,-1,4,3,-3,5,2,0,-2,406,1,-1,0,-1,0,0,-1,1,1,-1,3,-1
KR_6756590537,420,-4,-44,4,-10,-2,3,1,-5,5,0,0,3,3,-1,2,1,-2,2,0,0,-7,1,3,-4,1,-2,0,-1,-1,-1,-1,-1,5,-1
KR_6731366249,420,-4,-21,-31,-5,0,1,1,-6,6,0,4,0,4,-6,6,0,3,1,4,0,-4,5,0,-1,1,-1,0,-1,-1,1,-1,-1,3,-1
KR_6763099186,420,3,0,-4,4,6,0,6,3,2,5,-9,14,5,2,1,3,2,2,4,0,14,32,2,-4,2,1,0,-1,-1,-1,-1,1,2,-1
KR_6759288498,440,0,94,-29,-1,5,0,5,-3,4,1,-3,4,1,0,0,0,0,0,0,0,-1,3,-2,0,2,0,0,1,-1,-1,1,-1,5,-1
KR_6741225564,420,1,-6,3,0,-1,5,4,0,4,4,3,1,4,-1,3,2,-1,1,0,0,0,0,1,-2,1,3,0,0,-1,1,-1,-1,4,-1
KR_6738116798,420,-2,-19,-17,-8,-9,9,0,-2,4,2,2,0,2,2,2,4,-1,2,1,0,-1,8,0,-5,5,2,0,0,0,1,0,-1,0,-1
KR_6730170608,420,1,42,-11,0,2,1,3,0,1,1,3,2,5,-5,9,4,0,1,1,1,8,7,0,-2,2,-1,0,0,-1,1,-1,1,3,-1
KR_6758958830,420,-2,-47,20,-1,0,2,2,3,1,4,-2,4,2,-3,4,1,1,1,2,0,2,50,4,-4,0,-18,0,0,1,0,0,1,6,-1
KR_6754142898,420,-3,-77,-32,5,1,2,3,6,1,7,0,4,4,-2,2,0,0,1,1,0,10,-7,-3,-2,5,4,0,1,-1,-1,1,-1,5,-1
KR_6759704084,420,-1,-32,-8,-3,5,2,7,-1,3,2,0,2,2,-3,5,2,-4,4,0,0,-1,-8,-2,-2,4,1,0,-3,1,-1,-1,1,2,-1
KR_6723725519,420,-1,-33,-8,-4,0,0,0,-1,2,1,-3,3,0,-2,3,1,2,0,2,0,2,-14,-1,-3,4,2,0,0,-1,-1,0,-1,4,-1
KR_6714208106,420,-1,10,0,-10,0,2,2,-2,5,3,1,2,3,-4,7,3,-5,5,0,0,-12,-14,-5,0,5,3,0,-1,-1,0,-1,1,1,-1
KR_6731441340,420,-3,-33,28,-10,-6,6,0,-3,3,0,-2,3,1,1,0,1,0,1,1,0,-4,-6,-4,0,4,1,0,-3,-1,-1,-1,-1,4,-1
KR_6741359601,420,-1,26,-17,-6,-3,4,1,-2,3,1,-3,6,3,1,5,6,1,1,2,0,-3,16,-6,-1,7,2,0,-2,-1,-1,-1,-1,3,-1
KR_6647061014,420,-5,-49,-14,-8,3,1,4,-6,7,1,-1,3,2,-3,3,0,-1,2,1,0,-5,2,5,-7,2,-5,0,-2,-1,-1,-1,1,3,-1
KR_6751993288,440,0,-50,2,1,1,0,1,2,3,5,-2,3,1,0,3,3,0,0,0,-1,0,21,2,-3,1,0,0,0,0,1,0,-1,0,-1
KR_6729250296,420,-8,-126,0,-20,0,2,2,-8,8,0,-3,5,2,-6,7,1,-3,3,0,1,-14,-28,-2,0,2,18,0,-2,1,0,-1,1,6,-1
KR_6697362449,420,-3,17,7,-6,-4,4,0,1,3,4,1,1,2,-2,3,1,-2,2,0,0,-9,3,1,-3,2,-2,0,-1,0,0,-1,1,0,-1
KR_6673548824,420,-3,-105,-24,-7,-6,8,2,3,1,4,-1,2,1,-3,3,0,0,1,1,0,-2,-6,-3,-1,4,1,0,-4,1,-1,-1,-1,5,-1
KR_6648427976,420,0,9,16,-5,0,1,1,-2,4,2,-1,2,1,-2,2,0,0,0,0,-1,-12,-2,-1,-1,2,-1,0,0,-1,-1,0,-1,6,-1
KR_6691593981,420,-4,-34,-5,-12,0,2,2,3,1,4,-1,1,0,-7,7,0,-7,7,0,0,-13,-50,-4,-1,5,23,0,0,-1,-1,0,-1,4,-1
KR_6754136918,420,-2,-65,7,-7,0,3,3,-4,6,2,-2,3,1,-4,6,2,3,0,3,0,-6,-168,0,-3,3,-3,0,1,-1,1,1,1,6,-1
KR_6661321735,420,4,-9,-12,8,1,1,2,9,1,10,3,0,3,-3,3,0,-2,2,0,0,0,-52,-2,-3,5,24,0,0,1,1,1,1,1,-1
KR_6756102169,420,3,-11,30,-1,0,1,1,-1,4,3,4,1,5,-4,4,0,0,1,1,0,-2,0,-3,-3,6,-5,0,0,-1,0,-1,-1,3,-1
KR_6749924262,440,8,-11,80,-4,3,1,4,0,0,0,3,0,3,-2,3,1,-8,9,1,0,-3,-21,-2,-2,4,3,0,1,0,1,1,-1,0,-1
KR_6739114316,420,0,13,4,-5,3,0,3,2,0,2,-2,5,3,-6,6,0,-2,2,0,0,-14,-3,-1,-2,3,-4,0,-1,-1,-1,-1,-1,1,-1
KR_6760160441,420,-2,-91,-32,-4,1,0,1,7,0,7,2,2,4,-6,9,3,-8,8,0,0,-3,-22,2,-7,5,21,0,-2,0,1,-1,1,0,-1
KR_6661445914,420,-4,6,-76,-5,-2,4,2,-3,3,0,2,1,3,-1,3,2,-1,1,0,0,-7,-28,1,-3,2,-1,0,-1,-1,-1,-1,-1,1,-1
KR_6762608817,420,2,56,-5,1,1,1,2,1,3,4,-3,4,1,1,1,2,1,0,1,0,3,34,-3,-2,5,-10,0,0,1,-1,1,-1,6,-1
KR_6728243886,420,-3,-26,-32,-2,5,1,6,-3,4,1,-3,5,2,-4,4,0,3,1,4,0,1,150,-1,-4,5,3,0,-1,1,-1,-1,1,6,-1
KR_6691382816,420,-2,-36,-26,-9,1,4,5,-2,2,0,-2,4,2,-4,4,0,-2,2,0,-1,-7,-4,0,-2,2,-5,0,-1,1,-1,-1,-1,6,-1
KR_6748309627,420,0,-40,-11,0,2,0,2,-3,4,1,3,2,5,0,2,2,-2,2,0,0,5,-6,-1,-9,10,-1,0,-1,-1,1,-1,-1,3,-1
KR_6753828072,420,-1,39,8,-9,-6,7,1,2,1,3,-4,5,1,-1,2,1,0,0,0,0,-8,21,-3,-2,5,-1,0,0,-1,-1,0,-1,3,-1
KR_6720388223,420,-5,-118,-20,-12,1,0,1,-4,4,0,1,2,3,-9,11,2,-1,3,2,0,-11,-16,-7,-1,8,17,0,-2,-1,-1,-1,-1,4,-1
KR_6757851816,420,-3,-25,-11,-9,2,1,3,-5,6,1,-3,6,3,-1,1,0,-2,2,0,0,-8,-21,-4,-1,5,2,0,-1,-1,-1,-1,-1,1,-1
KR_6726658798,420,0,-10,-15,-4,2,1,3,-8,9,1,-1,3,2,1,1,2,2,1,3,0,-4,-5,-4,-2,6,4,0,-1,-1,-1,-1,-1,4,-1
KR_6685350404,420,-8,-116,-48,-16,-1,2,1,-3,3,0,-5,10,5,-2,2,0,-5,5,0,0,-5,-25,-3,-1,4,-2,0,-3,1,-1,-1,-1,1,-1
KR_6745047987,420,0,-12,-10,0,1,1,2,-3,6,3,1,2,3,-1,3,2,2,0,2,0,-1,-4,1,-3,2,-2,0,0,-1,1,0,1,3,-1
KR_6761620553,420,-4,-21,-16,-9,-1,2,1,-6,7,1,0,0,0,0,1,1,-2,2,0,1,-2,12,2,-3,1,-2,0,0,1,-1,0,1,3,-1
KR_6723054881,420,-1,13,-8,-4,-5,5,0,2,1,3,3,1,4,-2,2,0,-2,2,0,0,-6,4,1,-4,3,-1,0,0,-1,0,0,-1,6,-1
KR_6748867154,420,-8,-61,-20,-18,-4,4,0,1,0,1,-3,3,0,-7,7,0,-5,5,0,0,-9,-3,-4,0,4,-3,0,-1,-1,-1,-1,-1,6,-1
KR_6762321412,420,-1,-32,12,-8,-1,4,3,-2,2,0,-1,3,2,-5,6,1,1,3,4,0,-6,-12,1,-4,3,0,0,0,0,0,0,-1,0,-1
KR_6752255281,420,0,-17,-12,-1,0,2,2,0,2,2,0,4,4,-2,3,1,1,0,1,0,1,22,-5,-2,7,0,0,1,-1,-1,-1,-1,4,-1
KR_6685988948,420,-1,-31,-76,2,-2,5,3,-2,3,1,2,3,5,5,0,5,-1,2,1,-2,4,7,2,-5,3,2,0,1,-1,0,1,-1,3,-1
KR_6742587613,420,1,-36,-14,5,3,1,4,-2,4,2,1,0,1,1,1,2,2,2,4,2,1,28,-1,-1,2,-1,0,0,-1,1,1,1,5,-1
KR_6662355973,420,3,5,16,-1,0,2,2,3,1,4,-1,2,1,-3,3,0,0,0,0,0,-6,-159,-2,-2,4,-3,0,0,-1,-1,0,-1,6,-1
KR_6761333292,420,-1,-6,-10,-2,-4,5,1,-1,2,1,3,0,3,-1,1,0,1,0,1,-1,-5,-4,1,-3,2,-3,0,-1,1,-1,-1,-1,2,-1
KR_6752823094,420,2,65,-16,-2,-3,4,1,-7,7,0,6,0,6,2,1,3,0,0,0,1,3,57,1,-4,3,-32,0,0,-1,1,0,1,3,-1
KR_6747927519,420,-4,-42,-17,-7,-6,6,0,-2,5,3,5,2,7,-2,4,2,-2,2,0,0,-1,310,-5,0,5,-26,0,0,-1,-1,0,1,6,-1
KR_6706638689,420,-2,37,-32,-1,-4,7,3,-1,3,2,-3,7,4,4,1,5,3,0,3,0,4,-27,-1,0,1,13,0,0,0,0,1,1,0,-1
KR_6759749887,440,3,36,16,2,-3,3,0,0,1,1,4,1,5,-1,1,0,2,1,3,0,6,1,-2,-2,4,-1,0,0,1,1,0,-1,1,-1
KR_6690948481,420,0,-35,11,0,0,2,2,2,1,3,-4,4,0,-2,2,0,4,1,5,0,5,-5,-2,-1,3,0,0,-2,-1,1,-1,-1,2,-1
KR_6699601153,440,-2,-30,9,-1,-1,1,0,-3,4,1,1,1,2,1,5,6,1,1,2,0,-2,-11,-1,-5,6,1,0,-1,1,-1,-1,1,3,-1
KR_6760923150,420,3,20,-12,6,3,1,4,2,2,4,4,0,4,0,2,2,-3,3,0,1,3,3,2,-4,2,0,0,2,1,-1,1,1,6,-1
KR_6742509917,420,-6,-181,-32,-7,-1,2,1,-2,3,1,-5,7,2,1,1,2,0,1,1,0,5,17,4,-7,3,0,0,-1,-1,-1,-1,-1,6,-1
KR_6753799003,420,1,1,20,-3,-2,3,1,-3,5,2,3,2,5,-1,3,2,0,1,1,0,-4,0,-1,0,1,0,0,1,1,1,1,-1,3,-1
KR_6683191535,420,0,12,-4,3,-5,5,0,4,2,6,2,4,6,-1,5,4,3,0,3,0,11,369,0,-3,3,1,0,0,1,-1,0,1,1,-1
KR_6734700635,420,0,-9,10,4,1,0,1,0,3,3,5,1,6,0,0,0,-2,2,0,0,0,289,0,0,0,0,0,-3,1,-1,-1,1,1,-1
KR_6713782792,420,-3,-82,3,-9,-1,2,1,-3,4,1,-3,6,3,-1,4,3,-1,1,0,0,-9,-10,0,-1,1,-2,0,-2,1,1,-1,-1,1,-1
KR_6755979386,420,1,-48,-4,3,0,3,3,1,0,1,1,2,3,0,2,2,1,1,2,0,3,10,0,-1,1,1,0,-1,1,-1,-1,-1,6,-1
KR_6762611710,420,-2,-3,4,3,-2,4,2,-2,4,2,2,0,2,4,0,4,1,1,2,0,4,7,3,-4,1,-1,0,0,1,0,0,1,2,-1
KR_6762036064,420,0,6,8,-5,-1,3,2,0,1,1,-2,3,1,0,0,0,-2,2,0,0,-6,8,3,-3,0,0,0,0,1,1,0,1,6,-1
KR_6720357605,420,-1,-48,24,-4,1,1,2,1,1,2,-4,5,1,-3,5,2,1,0,1,0,-7,0,4,-5,1,-5,0,0,1,1,0,1,5,-1
KR_6737700701,420,-2,47,7,-12,-5,6,1,-6,8,2,1,2,3,1,1,2,-3,5,2,-1,-12,2,-4,-1,5,1,0,0,-1,-1,1,-1,2,-1
KR_6733228495,420,0,-14,-8,-3,4,0,4,-1,2,1,-5,6,1,0,2,2,-1,1,0,0,-2,-14,6,-6,0,2,0,0,-1,-1,-1,-1,6,-1
KR_6726476723,420,-2,-31,27,-6,3,0,3,-3,4,1,-3,3,0,-2,4,2,-1,2,1,0,-3,8,3,-8,5,-5,0,0,-1,1,0,-1,4,-1
KR_6761046244,440,-2,11,-22,-4,4,0,4,-1,1,0,1,2,3,-1,1,0,-7,7,0,0,-6,4,0,-2,2,1,0,-2,-1,-1,-1,-1,3,-1
KR_6637157059,420,0,27,-8,-7,3,1,4,-8,10,2,1,1,2,-2,2,0,-1,4,3,-1,-10,-13,-1,-1,2,-2,0,-1,-1,1,-1,-1,2,-1
KR_6710743143,420,1,46,37,-6,4,2,6,-1,3,2,-2,3,1,-2,2,0,-5,5,0,0,-15,-2,0,-1,1,1,0,0,-1,-1,1,1,5,-1
KR_6761540155,440,-6,-66,-24,-8,-3,3,0,-6,7,1,6,1,7,1,2,3,-6,7,1,0,-13,-6,0,-1,1,-1,0,-3,-1,-1,-1,1,1,-1
KR_6676778222,420,0,31,8,-3,-4,4,0,-1,3,2,1,1,2,-3,7,4,4,1,5,0,-6,1,3,-5,2,-1,0,1,1,1,1,1,3,-1
KR_6723805384,420,-2,-9,-8,-3,-2,2,0,-2,3,1,1,1,2,-2,3,1,2,0,2,-1,-5,6,-2,-1,3,-6,0,0,-1,-1,0,-1,1,-1
KR_6743031942,420,0,-5,16,-6,-2,3,1,1,1,2,1,1,2,0,2,2,-6,6,0,-1,-7,-22,-1,-1,2,5,0,0,-1,0,0,-1,3,-1
KR_6760326484,420,-6,-41,-1,-16,-3,4,1,-1,1,0,-6,8,2,-3,6,3,-3,3,0,0,-7,1,0,-3,3,2,0,-2,-1,-1,-1,-1,2,-1
KR_6658976489,420,-2,5,-36,-3,0,1,1,-2,2,0,0,3,3,-1,1,0,0,0,0,0,-1,-1,0,-2,2,1,0,0,1,-1,0,-1,3,-1
KR_6718234804,420,-6,-101,-30,-11,-7,7,0,-2,5,3,-1,2,1,-1,3,2,0,1,1,0,-7,263,-3,-1,4,2,0,-2,-1,-1,-1,-1,1,-1
KR_6731101266,420,-3,-16,-12,-5,-2,3,1,-1,1,0,-4,6,2,-1,2,1,3,0,3,0,11,-3,-2,0,2,-1,0,-1,-1,-1,-1,-1,5,-1
KR_6705156723,420,-4,6,-37,-7,-1,2,1,0,2,2,-5,7,2,-1,2,1,0,0,0,0,-3,5,1,-5,4,2,0,-1,-1,-1,-1,1,3,-1
KR_6707120177,420,-3,-137,-15,-9,-3,4,1,1,1,2,-6,7,1,0,0,0,-1,1,0,0,-1,-10,-5,-1,6,-4,0,-3,-1,-1,-1,-1,6,-1
KR_6762651333,420,-1,46,6,-1,-1,2,1,-4,4,0,2,2,4,3,0,3,-1,2,1,0,-4,6,0,-1,1,-3,0,1,1,-1,1,1,5,-1
KR_6683837308,420,-3,-29,-2,-13,1,0,1,0,1,1,-4,5,1,-3,6,3,-7,7,0,0,-6,-197,0,-2,2,0,0,-1,-1,-1,-1,-1,3,-1
KR_6720741914,420,-4,-71,-4,-19,-2,3,1,1,1,2,-6,7,1,-12,12,0,0,0,0,0,-15,10,-1,-3,4,2,0,-1,-1,-1,-1,-1,1,-1
KR_6645719577,420,1,21,-32,4,0,2,2,-2,3,1,2,3,5,3,1,4,1,0,1,0,7,-190,3,-4,1,0,0,-2,0,-1,-1,-1,0,-1
KR_6754920570,440,-5,-93,-8,-11,-2,3,1,-6,7,1,-4,5,1,0,2,2,1,1,2,0,0,-1,-3,-2,5,0,0,-1,1,0,-1,1,6,-1
KR_6761028367,420,-1,-30,-1,-10,2,1,3,-5,5,0,0,1,1,-4,4,0,-3,3,0,-1,-17,19,2,-3,1,-3,0,-2,-1,-1,-1,-1,3,-1
KR_6762579433,420,-2,-16,-16,5,-2,4,2,1,1,2,11,0,11,-4,4,0,-1,1,0,0,2,-8,-4,0,4,0,0,1,1,0,1,-1,6,-1
KR_6637110965,420,-6,25,-48,-13,-5,5,0,-3,5,2,0,2,2,-3,7,4,-2,3,1,-2,-18,-6,-2,-2,4,3,0,-1,-1,-1,-1,-1,4,-1
KR_6754437247,420,-4,-13,-50,-11,-7,7,0,-1,4,3,-2,3,1,-1,3,2,0,0,0,0,-7,2,-1,-6,7,-5,0,-3,-1,-1,-1,-1,3,-1
KR_6736287163,420,0,-34,-19,1,2,1,3,1,2,3,-2,2,0,0,0,0,0,2,2,0,5,-1,1,-4,3,0,0,-1,1,1,-1,-1,3,-1
KR_6690279259,440,0,-53,-8,2,1,2,3,-5,6,1,3,2,5,3,0,3,0,0,0,0,1,-5,-1,-3,4,-1,0,-2,1,-1,-1,1,6,-1
KR_6742149138,420,-1,0,-10,1,-2,3,1,2,4,6,6,0,6,-5,6,1,0,0,0,0,-6,-137,4,-7,3,-2,0,-1,-1,-1,-1,-1,3,-1
KR_6726331151,420,0,20,-17,3,1,0,1,-2,6,4,5,1,6,0,2,2,-1,2,1,0,0,-13,1,-4,3,2,0,-1,-1,-1,-1,1,3,-1
KR_6751994053,420,0,-39,-26,-1,-1,2,1,-1,3,2,0,4,4,1,0,1,0,2,2,1,4,-52,0,-1,1,24,0,1,1,0,1,1,2,-1
KR_6743344876,420,-4,-106,-9,-1,-4,4,0,-1,3,2,4,1,5,0,0,0,0,2,2,0,3,-1,-2,-2,4,0,0,-1,-1,0,-1,-1,5,-1
KR_6763256122,440,-3,-29,-28,-10,2,0,2,0,4,4,-6,6,0,-5,7,2,-1,5,4,0,-5,-12,-4,-2,6,2,0,-1,1,-1,1,-1,5,-1
KR_6708851991,420,-2,-43,-40,-2,-7,7,0,0,1,1,-2,4,2,0,1,1,7,0,7,0,1,-4,-2,-1,3,1,0,-1,0,-1,-1,-1,0,-1
KR_6646926031,420,-5,-61,-12,-14,-1,1,0,-5,5,0,-4,5,1,-1,3,2,-3,3,0,1,-16,-3,-2,-2,4,1,0,-2,-1,0,-1,1,3,-1
KR_6658250787,420,-2,-5,-22,3,1,2,3,2,3,5,3,2,5,3,1,4,-6,7,1,0,6,5,2,-4,2,-1,0,0,1,0,0,-1,3,-1
KR_6704716107,420,1,74,-28,1,6,0,6,-1,2,1,-4,5,1,-1,1,0,1,0,1,0,-3,-27,2,-3,1,2,0,0,-1,0,1,1,2,-1
KR_6684265705,420,-4,-3,-42,-4,-1,2,1,1,1,2,-4,6,2,-1,1,0,1,0,1,0,-1,-12,-2,-1,3,1,0,-2,-1,-1,-1,1,4,-1
KR_6742004321,420,-1,64,-6,-7,5,1,6,0,2,2,0,2,2,-9,12,3,-3,5,2,1,-16,18,-3,0,3,1,0,1,-1,0,1,1,1,-1
KR_6742938402,440,-1,-47,8,-4,-2,2,0,0,1,1,-6,7,1,-1,1,0,5,1,6,0,-1,32,-2,-1,3,-18,0,0,1,-1,0,1,5,-1
KR_6621327272,420,-6,-58,-52,-10,2,3,5,2,0,2,1,3,4,-14,16,2,-1,2,1,1,-6,33,-3,0,3,-8,0,-1,-1,-1,-1,1,6,-1
KR_6721020616,420,-5,-30,-7,-11,-3,3,0,0,2,2,-4,4,0,-5,6,1,1,0,1,0,-12,10,-2,-2,4,-13,0,-1,1,0,-1,-1,4,-1
KR_6763040775,420,1,10,-24,-3,5,0,5,-1,2,1,-7,7,0,0,1,1,0,0,0,1,-4,-9,-2,-2,4,4,0,1,-1,0,1,1,1,-1
KR_6653538513,420,-4,-34,-23,-7,2,1,3,-2,3,1,-2,4,2,-6,6,0,1,0,1,-1,-11,-6,-4,-2,6,3,0,-1,-1,-1,-1,-1,5,-1
KR_6739260582,440,-7,-115,-55,-18,-4,4,0,-6,7,1,-9,9,0,0,4,4,1,2,3,0,-4,9,-1,0,1,0,-1,-4,-1,-1,-1,-1,4,-1
KR_6737722311,420,0,1,23,0,-3,5,2,1,1,2,6,0,6,-1,3,2,-3,3,0,-1,2,-16,-4,0,4,3,0,-2,1,1,-1,-1,6,-1
KR_6699877126,420,-3,-15,1,-4,1,0,1,-1,1,0,1,0,1,-7,10,3,2,0,2,0,-5,-172,-2,-3,5,4,0,0,-1,-1,-1,1,6,-1
KR_6751953613,420,-1,40,16,-6,-3,4,1,1,1,2,0,2,2,-3,4,1,-1,2,1,0,-4,-3,2,-3,1,2,0,0,1,-1,0,-1,4,-1
KR_6731781532,420,-2,35,-20,-1,2,0,2,0,1,1,4,3,7,-5,8,3,-2,2,0,0,6,41,5,-9,4,-27,0,0,-1,0,0,1,1,-1
KR_6755995211,420,-2,47,-16,1,-2,2,0,0,1,1,5,0,5,-1,2,1,-1,1,0,0,-4,9,0,-5,5,-6,0,0,-1,0,-1,-1,4,-1
KR_6760670052,440,-12,-203,-48,-32,-5,5,0,-2,2,0,-7,8,1,-17,18,1,-1,2,1,0,-28,-1,-10,0,10,0,0,-4,-1,-1,-1,-1,4,-1
KR_6760815525,420,-1,-18,-8,2,1,0,1,-1,6,5,3,2,5,-2,3,1,1,1,2,0,-4,312,1,-3,2,4,0,0,-1,-1,0,-1,1,-1
KR_6743152812,440,-3,-67,-24,-8,-5,5,0,-2,2,0,-5,6,1,2,2,4,2,0,2,0,-8,267,-2,-2,4,0,0,0,1,-1,-1,1,4,-1
KR_6761212675,420,-4,40,-24,-11,-7,7,0,0,1,1,-3,4,1,-1,4,3,0,2,2,-1,-7,4,0,-4,4,-6,0,-1,1,-1,-1,-1,1,-1
KR_6713913388,420,-2,11,-24,-2,0,2,2,-3,3,0,-1,1,0,1,0,1,1,0,1,0,-2,11,6,-11,5,-11,0,-1,1,-1,-1,-1,1,-1
KR_6762050637,420,-9,-72,-53,-17,-3,4,1,-7,7,0,-4,4,0,-3,6,3,0,0,0,0,-6,330,-2,-3,5,5,0,0,0,0,0,-1,0,-1
KR_6713821710,420,0,0,4,-1,-2,3,1,5,0,5,-3,3,0,2,2,4,-3,4,1,1,3,-18,-3,-2,5,4,0,0,1,-1,0,1,4,-1
KR_6762036365,420,-5,-10,-38,-7,-2,3,1,-2,4,2,2,2,4,-3,3,0,-2,2,0,0,-3,-8,-1,-1,2,-2,0,-2,1,-1,-1,1,4,-1
KR_6686960892,420,0,-73,16,-2,-1,1,0,-1,3,2,1,2,3,1,2,3,-2,3,1,0,1,-1,2,-4,2,-3,0,-1,1,-1,-1,-1,5,-1
KR_6749750942,420,0,12,8,-6,-5,5,0,-5,7,2,0,2,2,5,1,6,-1,2,1,-1,-2,5,2,-2,0,2,0,-2,-1,-1,-1,-1,5,-1
KR_6643397690,420,0,0,0,-6,2,0,2,2,5,7,-3,4,1,-4,4,0,-3,4,1,0,-11,-12,0,-1,1,-4,0,0,-1,0,0,-1,2,-1
KR_6754789627,420,4,77,27,2,4,2,6,2,0,2,-4,6,2,1,2,3,-1,1,0,0,-2,-49,-1,-1,2,2,0,1,1,1,1,1,2,-1
KR_6752053248,440,-1,-27,12,-2,0,4,4,-2,3,1,0,3,3,-1,4,3,1,0,1,-1,-7,8,0,-5,5,-3,0,1,0,0,1,-1,0,-1
KR_6750587009,420,0,-4,-12,-2,-1,4,3,1,1,2,5,0,5,-5,6,1,-2,2,0,1,-1,10,-2,-2,4,-1,0,-1,1,-1,-1,1,4,-1
KR_6761833793,420,-3,-53,-2,-5,-3,4,1,1,4,5,1,3,4,-2,7,5,-2,2,0,1,6,6,1,-4,3,-2,0,-1,0,-1,-1,-1,0,-1
KR_6670356238,420,-8,-102,-38,-11,-2,2,0,-3,4,1,-7,9,2,1,3,4,0,1,1,1,-2,14,4,-5,1,-4,0,-3,-1,-1,-1,1,1,-1
KR_6723126726,420,0,-27,12,-3,-1,2,1,1,0,1,0,2,2,-2,2,0,-1,1,0,0,-3,27,-2,0,2,-31,0,-1,0,0,-1,1,0,-1
KR_6731454434,420,-6,-83,-42,-13,-6,7,1,0,3,3,-7,8,1,-2,2,0,2,0,2,0,-18,2,0,-5,5,2,0,-1,0,1,-1,-1,0,-1
KR_6756775616,420,-4,-61,-16,-4,-1,2,1,-4,6,2,2,1,3,-1,3,2,0,1,1,0,-7,4,0,-2,2,-3,0,0,1,0,0,-1,3,-1
KR_6739014945,420,1,26,16,2,-4,4,0,1,0,1,1,2,3,2,0,2,2,1,3,0,6,403,-1,-4,5,1,0,-1,1,-1,-1,1,2,-1
KR_6744852036,420,0,29,12,0,-3,3,0,1,0,1,0,3,3,2,2,4,0,0,0,0,0,-2,-2,-2,4,1,0,1,1,-1,1,-1,6,-1
KR_6629689561,420,5,55,0,4,1,0,1,1,2,3,-4,7,3,3,3,6,3,0,3,0,-6,-22,-8,0,8,3,0,2,1,1,1,-1,2,-1
KR_6658083795,420,-1,14,-4,-6,-3,3,0,-1,2,1,0,3,3,-3,3,0,1,0,1,0,-5,-8,-3,-1,4,3,0,0,0,0,0,-1,0,-1
KR_6701955476,420,-3,-9,-24,-9,-3,4,1,-2,3,1,-3,4,1,-1,3,2,0,0,0,2,4,12,-4,-2,6,-1,0,-1,-1,0,-1,1,1,-1
KR_6662319965,420,2,-3,8,-1,1,1,2,0,2,2,-5,5,0,0,0,0,3,0,3,1,1,-6,-1,-3,4,1,0,2,-1,-1,1,1,3,-1
KR_6728431451,420,-3,-78,8,-2,0,2,2,-3,4,1,-2,4,2,3,2,5,0,1,1,2,4,0,1,-5,4,-3,0,-1,1,-1,-1,1,2,-1
KR_6683357844,420,-3,31,-16,2,-3,3,0,0,2,2,4,0,4,1,2,3,0,0,0,0,-2,-3,-4,-5,9,2,0,-1,1,-1,-1,-1,5,-1
KR_6726845169,420,-8,-66,-52,-17,-4,4,0,-7,7,0,-2,3,1,-2,2,0,-2,3,1,-2,-18,-8,1,-3,2,-2,0,-3,-1,-1,-1,-1,3,-1
KR_6655730025,420,0,32,-32,0,1,1,2,-1,3,2,-4,4,0,3,0,3,1,0,1,0,0,407,-3,-4,7,8,0,0,-1,1,0,1,6,-1
KR_6723681781,440,2,6,0,1,1,2,3,1,3,4,2,2,4,-1,1,0,-2,2,0,0,1,-11,-2,-5,7,1,0,1,0,1,1,-1,0,-1
KR_6751656241,420,2,34,12,9,-1,3,2,5,1,6,3,0,3,2,2,4,0,4,4,0,11,-5,0,-3,3,-2,0,0,-1,-1,1,-1,1,-1
KR_6735529296,420,-2,11,-24,2,-1,3,2,2,1,3,-1,3,2,-2,6,4,4,0,4,1,9,2,-2,-6,8,2,0,-1,0,0,-1,1,0,-1
KR_6753108555,420,-2,26,4,-7,1,1,2,-3,3,0,1,2,3,-4,6,2,-2,2,0,0,-5,19,2,-4,2,-3,0,0,0,-1,0,1,0,-1
KR_6744287088,420,3,71,12,1,-2,2,0,1,2,3,-3,5,2,5,0,5,0,1,1,0,3,0,-2,0,2,2,0,1,-1,-1,1,-1,3,-1
KR_6698046591,420,-1,-25,3,-5,1,2,3,-2,2,0,-2,2,0,-2,2,0,0,0,0,-1,-10,4,0,-4,4,-2,0,1,-1,1,1,-1,1,-1
KR_6763729045,420,3,71,-8,5,2,1,3,-6,6,0,6,0,6,3,0,3,0,1,1,1,-1,6,0,-1,1,-2,0,1,0,-1,1,1,0,-1
KR_6762371181,420,0,20,-24,-1,2,0,2,-3,3,0,2,0,2,-2,3,1,0,0,0,0,-7,7,-1,-2,3,-1,0,1,0,0,1,-1,0,-1
KR_6741641769,440,3,53,-20,4,-1,1,0,1,3,4,5,2,7,-1,1,0,0,0,0,0,3,0,0,-2,2,1,0,0,-1,1,0,-1,4,-1
KR_6763544414,420,-2,-6,33,-5,-1,2,1,-1,1,0,-2,2,0,-1,2,1,0,1,1,0,-3,-1,2,-4,2,1,0,1,1,-1,1,1,3,-1
KR_6764140135,440,-2,-117,5,-7,3,2,5,-1,4,3,0,3,3,-9,10,1,0,1,1,0,-8,-39,-1,-2,3,13,0,-3,0,0,-1,-1,0,-1
KR_6754304812,420,0,-7,32,0,1,1,2,-1,2,1,0,0,0,1,1,2,-1,1,0,0,-2,12,3,-6,3,5,0,0,-1,1,0,-1,4,-1
KR_6703674289,440,0,24,-39,-3,0,1,1,-6,8,2,3,2,5,0,0,0,0,1,1,0,-5,191,-2,-3,5,0,0,0,-1,-1,0,-1,1,-1
KR_6753003405,420,-2,27,-8,-3,1,4,5,-3,5,2,-4,4,0,2,2,4,1,4,5,1,2,-5,1,-3,2,5,0,1,-1,0,1,1,4,-1
KR_6741470769,420,-2,74,-8,-2,3,0,3,0,4,4,-7,8,1,0,6,6,2,0,2,0,3,-6,0,-2,2,-2,0,0,-1,1,1,1,6,-1
KR_6756920623,420,-4,-18,-8,-10,-2,3,1,-1,2,1,-4,4,0,-4,4,0,1,0,1,0,-12,6,2,-4,2,0,0,-1,-1,-1,-1,-1,4,-1
KR_6678512383,420,0,18,17,4,0,2,2,1,0,1,5,0,5,0,1,1,-2,3,1,-1,0,-47,1,-2,1,4,0,0,0,-1,-1,-1,0,-1
KR_6723755727,420,-1,-15,-12,-3,0,1,1,3,4,7,-4,5,1,-1,4,3,-1,2,1,0,-4,-7,1,-6,5,5,0,0,1,-1,0,1,1,-1
KR_6742697524,420,-2,-24,-2,2,0,2,2,-1,2,1,2,4,6,1,1,2,0,1,1,0,-12,180,-1,-2,3,-2,0,-1,1,-1,-1,-1,4,-1
KR_6762673973,420,2,-16,40,-3,1,2,3,1,2,3,0,1,1,-4,6,2,-1,3,2,0,-6,-9,-3,-2,5,0,0,0,1,0,0,-1,5,-1
KR_6689399674,420,1,48,2,3,3,1,4,-2,3,1,2,2,4,-1,2,1,1,1,2,0,1,6,-2,-2,4,1,0,1,0,1,1,-1,0,-1
KR_6734016256,420,-1,-29,25,-4,1,2,3,1,0,1,-6,7,1,-1,4,3,1,0,1,-1,-4,6,3,-6,3,-3,0,0,-1,1,0,-1,3,-1
KR_6706976305,420,-1,-21,8,5,-1,2,1,2,0,2,-2,2,0,6,2,8,0,0,0,0,8,7,-1,-2,3,3,0,0,-1,1,1,1,4,-1
KR_6762507182,420,1,11,-8,3,1,2,3,0,1,1,3,1,4,-1,5,4,0,0,0,0,-3,-17,2,-3,1,-1,0,0,0,0,0,1,0,-1
KR_6731087748,420,-1,-15,30,1,3,0,3,2,1,3,-4,4,0,-2,5,3,2,1,3,1,6,44,-1,0,1,1,0,0,1,0,1,1,5,-1
KR_6727180315,420,-1,-77,-8,1,-4,4,0,3,3,6,1,0,1,-1,2,1,2,1,3,0,-1,-43,1,-6,5,8,0,-1,-1,-1,-1,1,5,-1
KR_6756705906,420,-2,-72,8,-2,-1,3,2,2,1,3,0,2,2,-1,6,5,-2,3,1,-1,0,1,3,-3,0,-1,0,-1,-1,-1,-1,-1,6,-1
KR_6697550911,420,0,97,9,-5,1,3,4,-4,5,1,-4,4,0,3,3,6,-1,2,1,0,-8,2,-7,-3,10,-1,0,2,1,1,1,1,5,-1
KR_6758841045,420,-4,-25,48,-11,-1,2,1,-4,4,0,-3,4,1,1,3,4,-4,7,3,1,-18,-3,-9,-3,12,3,0,0,-1,1,-1,1,1,-1
KR_6743412130,420,2,19,-15,-4,2,2,4,-6,6,0,-1,4,3,0,2,2,1,1,2,-1,-3,-25,-2,0,2,2,0,1,-1,1,1,-1,3,-1
KR_6710164781,440,-6,-182,-10,-20,-2,4,2,-2,3,1,-13,13,0,-3,3,0,0,0,0,0,-13,-5,0,-3,3,1,0,-3,-1,-1,-1,-1,4,-1
KR_6731127162,420,-10,-233,-48,-7,-1,3,2,-5,6,1,2,3,5,-1,1,0,-2,2,0,0,-2,-51,0,-1,1,25,0,-3,-1,0,-1,-1,2,-1
KR_6764193566,420,1,0,23,-5,-5,5,0,8,2,10,-5,8,3,-4,7,3,1,2,3,2,1,11,-1,-5,6,4,0,1,-1,1,1,1,1,-1
KR_6732594119,420,1,35,-23,5,6,1,7,-7,7,0,4,0,4,5,0,5,-3,3,0,0,3,-6,1,-1,0,2,0,1,1,0,1,1,1,-1
KR_6736406466,420,-1,34,-24,-5,3,1,4,1,1,2,-5,6,1,0,2,2,-4,4,0,-1,-9,126,0,-2,2,-12,0,-1,-1,-1,-1,-1,1,-1
KR_6761377842,420,-3,-108,3,0,1,1,2,1,2,3,0,0,0,-1,1,0,-1,2,1,0,-4,-3,-1,-1,2,0,0,-1,-1,-1,-1,1,6,-1
KR_6736346369,420,-7,-62,-8,-13,-3,3,0,2,4,6,-4,4,0,-4,6,2,-4,5,1,0,-11,-17,2,-4,2,-7,0,-1,0,-1,-1,1,0,-1
KR_6678244397,420,-2,-24,4,-8,2,2,4,-1,2,1,-8,8,0,-1,3,2,0,2,2,0,-7,2,5,-7,2,2,0,1,-1,1,1,1,5,-1
KR_6708418055,420,0,8,8,0,-1,3,2,1,3,4,-1,1,0,0,1,1,1,1,2,0,1,-9,-6,-1,7,3,0,1,-1,1,1,1,1,-1
KR_6762269558,440,-2,-24,4,-4,3,1,4,-6,7,1,-2,4,2,2,0,2,-1,1,0,0,3,-6,0,-4,4,-1,0,0,1,-1,0,-1,2,-1
KR_6761291241,420,-1,1,-2,-9,-2,3,1,-2,6,4,-2,4,2,-3,5,2,0,1,1,0,-13,-295,-1,-2,3,1,0,0,1,-1,-1,-1,4,-1
KR_6746788188,420,-3,-28,-25,-4,3,1,4,0,1,1,1,2,3,-6,7,1,-2,2,0,0,4,0,0,-2,2,1,0,-1,-1,1,-1,1,1,-1
KR_6675441360,420,2,38,-12,3,1,2,3,0,3,3,3,2,5,-1,1,0,0,0,0,0,-2,-6,4,-6,2,0,0,-1,1,-1,-1,1,5,-1
KR_6682740169,420,1,65,15,-4,-4,6,2,-1,2,1,0,3,3,6,1,7,-5,6,1,-1,1,-2,-1,-4,5,3,0,1,-1,0,1,-1,1,-1
KR_6760694969,420,-7,-108,4,-18,-7,7,0,0,1,1,2,0,2,-12,12,0,-1,2,1,-2,-16,-1,3,-5,2,1,0,-1,-1,1,-1,-1,4,-1
KR_6760722124,420,2,-5,-16,9,1,2,3,1,1,2,-1,3,2,6,0,6,2,0,2,1,9,-4,-2,-2,4,0,0,0,1,-1,-1,1,1,-1
KR_6729071257,420,-3,-5,-50,-7,0,1,1,-6,6,0,-5,6,1,5,0,5,-1,1,0,0,-4,-96,1,-1,0,-1,0,0,1,-1,-1,1,6,-1
KR_6758194016,420,-1,-18,4,-3,-1,3,2,-1,1,0,0,1,1,1,1,2,-2,5,3,0,1,-406,-3,0,3,-1,0,0,-1,-1,-1,-1,1,-1
KR_6736143502,420,-4,-9,-22,0,-3,3,0,-3,4,1,7,0,7,-1,3,2,0,1,1,0,-2,-254,4,-4,0,-2,0,0,1,-1,0,-1,6,-1
KR_6729706016,440,-4,-8,-14,-6,-1,3,2,-8,8,0,2,1,3,1,0,1,0,0,0,0,-6,3,-1,-2,3,-2,0,-2,1,-1,-1,-1,1,-1
KR_6752894658,420,3,40,8,3,-1,1,0,-3,3,0,2,1,3,3,1,4,2,1,3,0,6,7,-5,-1,6,6,0,0,-1,-1,0,-1,2,-1
KR_6734351935,440,-2,1,-60,1,1,2,3,1,2,3,1,3,4,0,1,1,-2,3,1,1,3,-23,5,-8,3,-4,0,0,-1,-1,0,1,6,-1
KR_6689647088,420,-3,-6,-44,-11,-4,4,0,-8,8,0,-1,2,1,3,1,4,-1,2,1,0,-3,3,2,-5,3,-3,0,0,-1,1,0,-1,1,-1
KR_6762879077,420,-1,-74,-6,-1,2,0,2,1,1,2,-1,3,2,-4,7,3,1,1,2,0,-1,1,-1,-1,2,-1,0,0,-1,1,-1,1,1,-1
KR_6760593714,420,-1,0,-16,-2,-3,3,0,1,2,3,0,2,2,1,0,1,-1,4,3,0,4,223,1,-2,1,0,0,0,-1,0,0,-1,4,-1
KR_6749247619,420,-4,-125,-3,-5,0,2,2,-2,5,3,4,0,4,-5,6,1,-2,5,3,0,-1,186,1,-2,1,-2,0,0,-1,1,-1,-1,2,-1
KR_6734188050,440,-1,-14,12,0,-2,6,4,1,0,1,3,1,4,0,3,3,-2,4,2,0,-3,-38,1,-4,3,14,0,-2,-1,-1,-1,-1,5,-1
KR_6748826911,420,1,66,-25,-5,1,2,3,-4,6,2,-4,4,0,1,3,4,1,1,2,-1,-5,-22,-3,0,3,3,0,0,-1,-1,1,-1,2,-1
KR_6762735166,420,2,38,35,4,2,1,3,2,2,4,-4,5,1,1,1,2,3,3,6,-1,6,-3,-1,0,1,-1,0,1,-1,-1,1,-1,6,-1
KR_6717186210,420,-3,-22,-37,-10,-3,4,1,0,1,1,-6,7,1,4,2,6,-5,7,2,-1,-6,-8,-1,0,1,-2,0,0,1,-1,-1,-1,2,-1
KR_6660204564,420,-3,-4,-22,-7,-4,5,1,2,3,5,3,1,4,-7,8,1,-1,1,0,0,-3,-10,-9,-1,10,2,0,-2,0,-1,-1,-1,0,-1
KR_6682394258,420,-1,4,-8,-4,-5,6,1,2,0,2,-5,5,0,1,2,3,3,0,3,0,3,2,-1,0,1,2,0,1,-1,-1,1,-1,3,-1
KR_6761085200,420,1,13,12,1,-5,6,1,0,1,1,7,0,7,-1,2,1,0,0,0,-1,-3,-1,3,-3,0,1,0,1,1,-1,-1,-1,6,-1
KR_6677683350,420,1,-23,4,3,1,0,1,-1,4,3,-4,5,1,5,2,7,2,0,2,0,2,37,-1,-2,3,-14,0,-1,-1,-1,-1,1,1,-1
KR_6732246374,420,0,-28,0,-5,-2,3,1,1,2,3,6,1,7,-5,5,0,-5,5,0,0,-3,-6,-5,-2,7,1,0,0,-1,1,1,-1,5,-1
KR_6668112863,420,-2,-28,-40,-4,2,0,2,1,2,3,0,1,1,-8,8,0,1,3,4,0,-1,-21,0,-2,2,0,0,0,-1,0,-1,-1,6,-1
KR_6697124575,420,-5,-103,-24,-7,-1,2,1,-2,2,0,-6,6,0,2,2,4,0,2,2,0,-4,7,-2,0,2,0,0,-1,-1,-1,-1,-1,5,-1
KR_6672135670,420,-2,-2,20,-9,-5,6,1,3,1,4,0,2,2,-3,4,1,-4,4,0,-1,1,-11,-5,0,5,3,0,-1,-1,-1,-1,-1,6,-1
KR_6728691251,420,-2,-36,-42,-8,-3,4,1,-2,5,3,0,1,1,-5,5,0,2,0,2,-1,-6,2,-3,-1,4,-2,0,-2,1,-1,-1,-1,5,-1
KR_6759812277,420,-3,1,0,0,-1,1,0,0,3,3,5,3,8,-2,3,1,-2,4,2,0,0,-24,1,-6,5,0,0,-1,0,1,-1,1,0,-1
KR_6733697781,420,0,68,-75,4,-2,2,0,-2,3,1,3,0,3,3,1,4,2,1,3,0,2,166,1,-2,1,2,0,2,0,-1,1,1,0,-1
KR_6729911737,420,-1,79,-98,-8,-1,2,1,0,2,2,-2,4,2,-5,5,0,0,0,0,0,-4,7,0,-1,1,-2,0,0,-1,-1,0,-1,2,-1
KR_6753725237,440,-3,-60,-16,-11,-1,2,1,-3,6,3,2,3,5,-1,4,3,-8,9,1,-1,1,-1,-3,-3,6,-2,0,-2,-1,-1,-1,-1,6,-1
KR_6681580829,440,-3,-43,-38,-5,1,2,3,-3,3,0,0,1,1,-5,6,1,2,1,3,1,0,135,1,-7,6,-3,0,-1,-1,-1,-1,1,2,-1
KR_6744600210,440,0,-7,-17,-1,1,3,4,-3,3,0,0,1,1,-2,2,0,3,0,3,-1,-4,2,0,-4,4,-8,0,-1,1,0,-1,-1,4,-1
KR_6756830975,420,-5,-157,-12,-10,-1,2,1,0,2,2,-6,8,2,-2,2,0,-1,6,5,0,-2,-7,-2,-3,5,-3,0,-3,-1,-1,-1,-1,6,-1
KR_6686648196,420,-3,-54,-28,-5,1,0,1,1,1,2,-1,1,0,-1,2,1,-5,7,2,0,0,8,5,-6,1,-4,0,0,-1,0,-1,-1,5,-1
KR_6684274973,420,-4,59,-7,-12,-3,4,1,-7,7,0,2,1,3,-3,5,2,-1,1,0,0,-12,-7,-1,-3,4,-4,0,-2,1,-1,-1,-1,2,-1
KR_6764086749,420,0,-52,14,0,3,0,3,-1,2,1,-3,3,0,2,0,2,-1,1,0,0,4,-45,-1,-6,7,33,0,0,-1,-1,-1,1,2,-1
KR_6725645857,420,-4,-42,-40,-5,2,3,5,-2,2,0,-2,5,3,-2,2,0,-1,1,0,1,0,-5,-2,0,2,0,0,0,0,1,-1,1,0,-1
KR_6734953286,420,-2,-45,-32,-7,-5,5,0,1,1,2,2,1,3,-3,3,0,-2,5,3,0,-3,154,-1,-3,4,0,0,1,1,1,1,-1,3,-1
KR_6681741743,420,-2,-65,-8,0,-1,4,3,0,4,4,2,2,4,0,0,0,-1,1,0,1,7,-8,-2,-1,3,2,0,0,-1,1,1,1,5,-1
KR_6733295786,420,-2,51,-29,-6,-1,1,0,-3,4,1,-1,2,1,0,4,4,-1,4,3,0,-8,9,1,-3,2,-3,0,0,0,-1,-1,-1,0,-1
KR_6761450626,420,0,-19,16,-10,-1,2,1,1,0,1,1,2,3,-7,9,2,-4,4,0,0,-10,-153,-2,-2,4,-1,0,0,-1,0,0,-1,3,-1
KR_6747989153,420,-6,-41,-21,-12,-6,6,0,0,1,1,1,1,2,-6,6,0,-1,2,1,-2,-12,-11,-6,-1,7,5,0,-1,-1,-1,-1,1,5,-1
KR_6747146170,420,1,40,-28,-4,1,0,1,-3,4,1,4,0,4,-4,6,2,-2,4,2,0,-4,-1,-2,-3,5,-1,0,0,1,-1,0,1,5,-1
KR_6762122862,420,-4,-58,6,-1,3,1,4,-4,4,0,1,2,3,-2,5,3,1,0,1,0,-4,2,-1,-3,4,2,0,0,1,1,1,1,5,-1
KR_6703803862,420,-3,-70,0,-11,-4,4,0,1,2,3,-3,6,3,-5,5,0,0,0,0,0,-3,32,2,-3,1,-2,0,-2,-1,0,-1,-1,5,-1
KR_6760765474,420,3,16,4,5,-1,3,2,5,3,8,0,1,1,4,0,4,-3,3,0,0,3,-5,2,-4,2,0,0,1,-1,-1,1,1,4,-1
KR_6702605102,420,2,-6,12,-2,1,0,1,0,0,0,0,4,4,-3,8,5,0,0,0,0,2,-3,-3,-2,5,3,0,-1,1,-1,-1,-1,2,-1
KR_6756285299,420,-2,13,28,-13,-3,4,1,0,1,1,-1,5,4,-6,8,2,-3,3,0,0,-25,-209,2,-5,3,-6,0,1,-1,1,1,-1,3,-1
KR_6747096784,420,-3,-24,2,-10,3,0,3,-2,3,1,-6,6,0,-4,5,1,-1,1,0,0,-12,13,1,-6,5,-2,0,-3,-1,-1,-1,1,2,-1
KR_6715333750,420,0,-71,-16,1,-4,4,0,5,0,5,1,1,2,0,2,2,-1,1,0,0,7,-4,5,-6,1,-3,0,-1,-1,0,-1,-1,4,-1
KR_6696216955,420,-7,-90,-45,-9,-2,4,2,-4,4,0,-5,6,1,1,2,3,1,0,1,-1,-6,-11,-2,-1,3,0,0,-1,-1,-1,-1,-1,4,-1
KR_6687196584,420,3,-90,12,3,0,1,1,-2,3,1,9,2,11,-3,7,4,-1,1,0,0,1,-21,-7,-1,8,-4,0,1,-1,1,1,1,6,-1
KR_6656646792,420,-1,-25,-32,-4,-7,8,1,2,3,5,1,0,1,0,1,1,0,3,3,-1,0,11,4,-6,2,-2,0,-3,-1,-1,-1,-1,1,-1
KR_6759383726,420,-1,45,4,3,-4,7,3,2,3,5,2,1,3,0,5,5,3,3,6,4,19,1,3,-4,1,0,0,-1,1,-1,-1,1,5,-1
KR_6760198147,420,-3,-105,0,-9,-2,3,1,-1,2,1,-7,7,0,1,5,6,0,1,1,0,-11,-4,-10,0,10,-1,0,-1,-1,-1,-1,1,2,-1
KR_6748981362,440,-3,-15,-4,-9,-2,2,0,1,3,4,-7,9,2,0,3,3,-1,2,1,0,-7,4,2,-2,0,-2,0,0,0,0,0,-1,0,-1
KR_6727355601,420,-3,-71,28,-15,-3,3,0,3,0,3,-7,8,1,-5,5,0,-3,3,0,0,-11,-134,0,-4,4,-6,0,-3,-1,-1,-1,-1,4,-1
KR_6749947106,420,2,73,12,0,2,0,2,-1,1,0,1,3,4,1,1,2,-3,3,0,0,-9,41,0,-1,1,21,0,0,0,0,1,1,0,-1
KR_6715354949,420,-6,-10,-22,-26,1,2,3,-3,3,0,-6,7,1,-6,6,0,-12,13,1,0,-18,-13,-2,-1,3,2,0,-2,-1,-1,-1,-1,4,-1
KR_6757470674,420,0,-33,10,2,4,1,5,3,0,3,-3,5,2,-3,4,1,1,0,1,0,-2,-7,2,-2,0,-1,0,-1,1,0,-1,-1,4,-1
KR_6699164961,420,-6,-101,-32,-10,-2,2,0,0,0,0,-3,3,0,-4,4,0,-1,1,0,0,-5,-5,-1,-2,3,-2,0,-2,-1,-1,-1,-1,3,-1
KR_6763119904,420,0,-68,18,2,0,2,2,-1,2,1,-6,7,1,6,1,7,3,0,3,0,9,-2,-4,0,4,-1,0,0,1,1,-1,-1,2,-1
KR_6533458841,420,-4,-121,6,-7,-3,4,1,0,4,4,-1,3,2,-1,5,4,-2,5,3,0,-6,1,2,-4,2,-2,0,-1,-1,-1,-1,1,4,-1
KR_6742494069,420,4,88,-8,2,-1,4,3,-5,5,0,1,3,4,6,0,6,1,1,2,0,1,-4,-3,0,3,1,0,2,-1,-1,-1,1,6,-1
KR_6731239803,420,0,-20,-16,4,-2,3,1,1,2,3,0,4,4,6,0,6,-1,2,1,0,4,49,3,-5,2,0,0,0,1,1,-1,-1,5,-1
KR_6738839594,420,0,-56,-5,4,1,0,1,4,1,5,0,2,2,1,2,3,-2,4,2,1,5,-10,-3,0,3,-2,0,1,1,1,1,1,1,-1
KR_6741120069,420,1,-66,4,2,5,1,6,-4,5,1,0,3,3,0,2,2,1,0,1,0,0,-6,-1,-1,2,0,0,0,0,0,0,-1,0,-1
KR_6709868318,420,2,-8,32,-1,-1,4,3,-4,5,1,-1,3,2,4,2,6,1,1,2,0,-5,-9,0,-2,2,-2,0,1,1,1,1,1,1,-1
KR_6684860775,420,-4,-75,-16,-9,3,1,4,-2,3,1,-8,8,0,1,4,5,-3,4,1,0,2,4,2,-5,3,-4,0,-2,-1,-1,-1,-1,1,-1
KR_6750662010,420,-5,-110,-17,-13,-2,2,0,2,1,3,-3,3,0,-8,9,1,-2,3,1,0,-10,29,-3,-1,4,-2,0,-2,-1,-1,-1,-1,2,-1
KR_6648322596,420,-5,-86,-28,-11,-4,4,0,-3,4,1,-4,4,0,1,1,2,-1,1,0,0,-4,1,-3,-2,5,0,0,-1,-1,-1,-1,-1,5,-1
KR_6763152358,420,-3,-48,-10,-2,0,1,1,-1,3,2,0,1,1,0,3,3,-1,2,1,0,-4,39,0,-4,4,-3,0,-1,-1,1,-1,1,1,-1
KR_6727375836,420,-7,-58,-64,-11,0,2,2,-1,2,1,-4,5,1,-2,4,2,-4,6,2,0,-7,-19,-2,-2,4,2,0,0,-1,1,0,1,4,-1
KR_6748600534,420,-3,-34,-12,-6,-3,3,0,1,1,2,3,2,5,-4,4,0,-3,3,0,0,-8,-3,-1,-2,3,2,0,-2,-1,-1,-1,-1,2,-1
KR_6746348149,420,1,-22,13,2,-1,2,1,-1,1,0,-5,7,2,4,0,4,5,0,5,0,12,-174,3,-5,2,1,0,0,1,1,0,-1,4,-1
KR_6761710230,420,0,-48,-3,-9,-5,6,1,-4,7,3,1,1,2,0,3,3,-1,1,0,0,-6,0,-2,0,2,1,0,-3,1,-1,-1,-1,2,-1
KR_6681672915,420,3,34,29,-2,2,1,3,-3,4,1,6,0,6,-8,8,0,1,0,1,0,-6,-2,1,-3,2,-1,0,1,-1,0,1,-1,3,-1
KR_6753028690,420,-5,-57,-16,-4,1,0,1,0,3,3,-3,4,1,-2,5,3,0,1,1,0,-6,-3,3,-4,1,2,0,-2,-1,0,-1,1,2,-1
KR_6723397621,420,-4,-90,-12,-8,-3,6,3,-5,5,0,2,1,3,-1,3,2,-1,1,0,1,-8,-4,-1,0,1,0,0,-2,-1,0,-1,1,1,-1
KR_6732950426,420,0,62,15,-2,-5,5,0,-5,5,0,-2,2,0,8,0,8,2,1,3,1,-1,-49,-3,-1,4,4,0,1,0,1,1,1,0,-1
KR_6763310124,420,-4,15,19,-3,-2,2,0,0,1,1,0,2,2,1,0,1,-2,2,0,0,-3,75,5,-5,0,1,0,0,-1,-1,0,1,5,-1
KR_6728509886,420,-5,-44,-20,-14,-2,3,1,-4,5,1,-4,5,1,-1,6,5,-3,4,1,-2,-21,-3,1,-3,2,-2,0,-2,-1,-1,-1,-1,5,-1
KR_6736345324,420,-3,-35,-55,-6,1,0,1,-6,9,3,-2,2,0,0,5,5,1,0,1,0,-4,-42,-1,0,1,0,0,-3,1,-1,-1,-1,4,-1
KR_6753951694,420,1,35,12,-3,-1,2,1,2,1,3,-1,2,1,-1,2,1,-2,2,0,0,0,3,3,-3,0,-1,0,1,1,-1,1,-1,1,-1
KR_6722550726,420,-1,-48,21,2,3,0,3,-3,6,3,0,2,2,2,1,3,0,1,1,0,2,4,1,-3,2,3,0,-1,1,-1,-1,1,1,-1
KR_6679874590,440,-1,-36,-22,4,-3,4,1,-4,5,1,1,2,3,10,0,10,0,1,1,0,3,4,-2,-1,3,0,0,1,-1,1,1,1,4,-1
KR_6722585381,420,-1,6,9,-1,2,0,2,1,3,4,-5,7,2,2,2,4,-1,3,2,1,-9,22,-3,0,3,-2,0,0,1,-1,-1,1,5,-1
KR_6731677737,420,-1,-13,12,-3,-2,4,2,-1,4,3,-1,4,3,1,2,3,0,1,1,-4,-10,-5,-2,0,2,0,0,0,1,1,-1,-1,3,-1
KR_6727193100,420,-1,-39,-12,-5,-5,6,1,0,2,2,6,2,8,-3,3,0,-3,3,0,-1,3,-294,0,-4,4,19,0,0,-1,1,0,-1,4,-1
KR_6752219394,420,-2,-26,19,-6,-1,1,0,1,1,2,-4,4,0,-1,1,0,-1,1,0,0,-6,64,2,-4,2,-4,0,0,1,0,0,-1,3,-1
KR_6741286294,420,1,22,4,-1,2,2,4,0,2,2,-3,4,1,1,1,2,-1,2,1,0,-6,-6,-4,-2,6,0,0,-1,0,-1,-1,1,0,-1
KR_6741688503,420,-4,16,-4,-6,1,2,3,4,2,6,0,2,2,-6,8,2,-5,8,3,0,-10,-2,0,-1,1,2,0,1,-1,0,1,-1,5,-1
KR_6743419395,420,2,-40,40,0,0,1,1,0,4,4,0,4,4,-2,4,2,2,1,3,-1,2,33,1,-4,3,1,0,-2,1,1,-1,-1,5,-1
KR_6691162643,420,-5,-46,8,-12,-6,6,0,2,0,2,-5,8,3,-1,3,2,-2,2,0,0,-3,14,1,-3,2,-2,0,-2,-1,-1,-1,-1,5,-1
KR_6741358548,420,1,-36,-3,4,-3,5,2,2,1,3,7,1,8,0,1,1,-2,3,1,0,-1,0,-2,-2,4,2,0,-1,1,1,-1,1,6,-1
KR_6743698818,420,-2,-20,-68,0,-1,2,1,-2,2,0,3,1,4,0,2,2,0,1,1,-1,6,-2,-4,-1,5,1,0,-1,-1,0,-1,-1,6,-1
KR_6762794919,420,2,26,28,0,1,0,1,2,2,4,3,0,3,-3,5,2,-3,5,2,0,-6,6,0,0,0,-1,0,0,-1,1,1,-1,1,-1
KR_6760704327,420,-1,-11,-13,-8,-5,5,0,4,2,6,-3,6,3,-5,7,2,1,0,1,1,6,-11,-4,0,4,3,0,1,-1,1,1,1,2,-1
KR_6730616145,420,1,37,5,-5,0,0,0,-5,6,1,0,1,1,-1,1,0,1,1,2,0,-7,-7,-5,-4,9,-2,0,0,-1,-1,-1,-1,4,-1
KR_6682748421,420,-1,-15,3,-1,-4,7,3,0,2,2,-2,4,2,3,0,3,2,0,2,-1,9,8,8,-9,1,-2,0,-1,1,1,-1,-1,1,-1
KR_6739746213,420,-3,36,-12,-5,-6,6,0,-1,2,1,2,2,4,1,1,2,-1,1,0,0,-5,-36,-2,-3,5,2,0,1,-1,1,1,1,5,-1
KR_6740862835,420,-3,53,-15,-4,-2,3,1,-4,5,1,3,3,6,0,1,1,-1,1,0,0,-2,0,1,-2,1,-2,0,0,-1,-1,0,1,4,-1
KR_6751585792,420,-2,1,20,-4,-2,2,0,-4,6,2,0,2,2,1,1,2,1,0,1,0,-3,239,1,-4,3,-3,0,0,1,1,0,1,5,-1
KR_6761225011,420,-2,13,24,-2,2,2,4,-1,2,1,-4,7,3,0,2,2,1,0,1,0,-5,44,0,-5,5,-20,0,0,1,1,1,-1,1,-1
KR_6754637446,420,-5,-179,-10,-1,-1,2,1,0,3,3,2,0,2,-2,2,0,0,0,0,0,-1,0,2,-5,3,-2,0,-1,-1,0,-1,1,3,-1
KR_6742014658,420,2,0,11,6,4,3,7,1,2,3,-2,4,2,3,0,3,0,0,0,0,0,-5,-2,0,2,2,0,0,-1,1,0,1,4,-1
KR_6660633315,420,0,100,16,0,4,1,5,2,1,3,1,0,1,-7,9,2,0,1,1,0,-7,-9,0,-3,3,-3,0,0,-1,1,-1,-1,2,-1
KR_6724421583,420,-2,-45,14,-7,-5,5,0,-3,3,0,5,1,6,-6,6,0,2,1,3,-2,-8,-10,-5,-2,7,1,0,-1,-1,-1,-1,-1,3,-1
KR_6759849402,440,1,-9,11,7,0,1,1,1,3,4,-1,5,4,5,2,7,2,0,2,1,17,6,6,-10,4,0,0,0,-1,0,-1,1,5,-1
KR_6753700273,420,1,32,0,-1,-1,2,1,1,5,6,3,2,5,-7,7,0,3,0,3,-2,-4,5,-1,-3,4,0,0,0,1,-1,-1,-1,4,-1
KR_6695766248,440,2,-84,24,-4,-2,3,1,0,1,1,-3,3,0,-1,2,1,2,1,3,0,-5,0,-2,-5,7,-3,0,0,1,-1,0,-1,4,-1
KR_6756349345,420,-2,-69,12,-2,-1,1,0,0,3,3,0,3,3,1,2,3,-2,4,2,0,-7,-38,-2,0,2,27,0,-2,0,0,-1,-1,0,-1
KR_6759306285,420,-6,-10,-70,-12,-1,1,0,-4,5,1,0,3,3,-1,1,0,-6,7,1,0,-12,-28,-4,0,4,-1,0,0,0,0,0,-1,0,-1
KR_6689707383,440,-1,-53,-24,0,-3,3,0,1,1,2,-2,4,2,3,4,7,1,0,1,0,5,-179,-2,-3,5,1,0,-1,-1,-1,-1,1,5,-1
KR_6745827858,440,1,15,8,3,0,0,0,-3,4,1,9,2,11,-5,8,3,2,0,2,0,3,-18,-1,-2,3,-5,0,1,1,1,1,1,2,-1
KR_6711166014,440,0,3,3,-5,0,3,3,-3,4,1,3,0,3,-4,10,6,-1,1,0,-1,-4,5,-1,-4,5,2,0,0,1,1,1,-1,6,-1
KR_6712388640,420,-1,-86,-21,-2,0,0,0,-3,4,1,1,4,5,-8,8,0,8,0,8,0,-4,-2,-2,-5,7,3,0,0,-1,-1,-1,1,4,-1
KR_6761490157,420,2,-54,-20,4,1,0,1,4,1,5,-1,3,2,0,0,0,0,0,0,0,5,-7,3,-5,2,0,0,0,-1,-1,0,-1,2,-1
KR_6668097304,440,1,73,-14,7,0,1,1,-1,2,1,7,1,8,1,0,1,0,0,0,0,7,4,-6,-3,9,1,0,-1,1,-1,-1,-1,4,-1
KR_6757170264,420,-5,-44,-7,-16,-4,6,2,0,4,4,-9,9,0,-3,7,4,0,4,4,-1,-1,-2,0,-3,3,4,0,-4,0,-1,-1,-1,0,-1
KR_6752578943,420,-3,-46,16,-11,-6,6,0,1,2,3,-1,2,1,-1,2,1,-4,4,0,0,-8,6,-1,-1,2,-3,0,-1,-1,1,-1,-1,6,-1
KR_6699869699,420,-8,-180,-24,-8,1,3,4,0,1,1,-3,3,0,-6,6,0,0,1,1,0,-3,5,-2,-2,4,-2,0,-3,-1,-1,-1,1,4,-1
KR_6762786855,420,-3,-17,-28,-6,1,2,3,1,1,2,-3,4,1,-2,3,1,-3,5,2,-1,-3,18,-1,-1,2,-1,0,0,-1,-1,-1,-1,6,-1
KR_6729760128,420,3,13,32,4,-1,2,1,3,0,3,-2,3,1,4,1,5,0,1,1,0,7,41,3,-5,2,-23,0,2,1,1,1,1,1,-1
KR_6651516995,420,-1,-61,8,7,2,0,2,-1,1,0,-1,3,2,1,0,1,6,0,6,0,8,10,-2,-2,4,5,0,0,1,0,-1,1,4,-1
KR_6729236889,420,-2,88,3,3,4,0,4,-4,6,2,1,2,3,2,2,4,0,1,1,0,2,3,1,-3,2,3,0,0,-1,1,0,1,2,-1
KR_6638094156,420,-2,-45,8,-9,-6,6,0,2,1,3,-1,3,2,1,0,1,-5,5,0,0,0,7,2,-5,3,-1,0,-1,0,-1,-1,-1,0,-1
KR_6672863591,420,-3,-5,8,-3,-2,2,0,-1,1,0,0,2,2,-4,4,0,4,1,5,0,-6,-18,-1,-2,3,-1,0,-1,-1,-1,-1,1,5,-1
KR_6761260775,420,1,20,-4,-1,0,2,2,-3,3,0,1,1,2,-1,2,1,2,0,2,0,-5,10,0,-2,2,-5,0,0,-1,-1,-1,-1,3,-1
KR_6751999939,420,0,19,-4,2,-1,1,0,3,1,4,3,1,4,-5,5,0,2,0,2,0,-1,-5,-1,-1,2,1,0,0,0,1,0,-1,0,-1
KR_6730126459,420,-5,-4,-19,-4,0,1,1,-2,2,0,-1,3,2,5,1,6,-6,6,0,0,-5,-2,-4,-2,6,-1,0,1,1,1,-1,-1,3,-1
KR_6747330322,420,1,5,-8,3,1,0,1,-3,6,3,2,0,2,0,3,3,3,1,4,0,-1,1,-1,-1,2,1,0,1,-1,-1,1,-1,1,-1
KR_6760641392,440,-1,-28,4,1,0,1,1,3,7,10,3,0,3,-6,9,3,1,1,2,0,7,13,-2,-2,4,2,0,-3,-1,-1,-1,1,6,-1
KR_6747325569,420,3,26,21,4,2,1,3,2,3,5,3,0,3,-3,4,1,0,2,2,0,2,-438,0,-3,3,-2,0,0,-1,0,0,1,4,-1
KR_6646941178,420,-1,8,13,2,-3,3,0,-1,4,3,2,1,3,2,1,3,2,0,2,0,0,13,0,-4,4,2,0,2,1,1,1,-1,5,-1
KR_6758907931,440,-5,-27,-20,-15,-3,6,3,-2,3,1,-5,5,0,-4,4,0,-1,2,1,0,-11,-361,-1,-1,2,2,0,0,-1,1,-1,1,6,-1
KR_6736690418,420,-3,-11,-8,-1,0,1,1,0,2,2,-1,2,1,-2,4,2,2,0,2,0,-4,-36,-2,-2,4,7,0,0,-1,0,0,-1,3,-1
KR_6706962761,420,3,6,-10,8,1,2,3,6,1,7,-2,2,0,3,1,4,0,3,3,0,9,-10,4,-6,2,1,0,-1,1,-1,-1,1,4,-1
KR_6720242500,420,0,-5,-18,2,1,0,1,4,2,6,-2,4,2,-1,3,2,0,0,0,0,-3,-11,-1,-3,4,0,0,0,-1,1,0,-1,4,-1
KR_6641978246,420,3,41,0,6,-1,3,2,2,0,2,2,3,5,3,0,3,0,1,1,0,9,-7,0,-2,2,4,0,1,-1,1,1,1,1,-1
KR_6760287416,420,0,-30,-4,-2,-1,5,4,-5,5,0,0,1,1,-6,6,0,10,2,12,0,-4,3,-3,-1,4,4,0,1,1,-1,-1,-1,4,-1
KR_6729248833,420,-1,-30,4,-6,1,1,2,-2,4,2,-5,7,2,0,0,0,0,0,0,0,-12,-37,-2,-2,4,15,0,0,-1,0,0,-1,2,-1
KR_6741194770,420,-4,-31,-32,-5,-2,3,1,-2,6,4,-4,5,1,2,2,4,1,2,3,0,-1,18,0,-2,2,2,0,0,-1,1,-1,1,5,-1
KR_6745803443,420,-2,-34,-4,0,-2,5,3,4,1,5,2,3,5,-1,6,5,-3,5,2,0,2,1,4,-5,1,-2,0,-2,-1,-1,-1,1,6,-1
KR_6745065205,420,-1,-9,12,-8,0,2,2,-3,3,0,-3,3,0,-3,3,0,1,0,1,0,-10,29,-4,-2,6,-12,0,0,-1,1,-1,-1,1,-1
KR_6751319841,420,3,46,1,3,1,2,3,-5,8,3,6,4,10,0,3,3,1,0,1,1,2,5,6,-8,2,-2,0,1,-1,1,1,1,5,-1
KR_6695050067,420,0,20,-20,2,-2,2,0,2,1,3,1,4,5,1,1,2,0,1,1,0,0,9,-1,-1,2,2,0,0,-1,-1,1,1,3,-1
KR_6761582302,420,-1,30,8,-5,6,0,6,-3,4,1,-3,4,1,-3,3,0,-2,4,2,0,-9,-14,-4,0,4,0,0,0,1,0,-1,1,6,-1
KR_6739951059,420,2,16,-20,10,0,2,2,0,1,1,3,0,3,2,2,4,5,0,5,0,17,11,3,-3,0,0,0,2,1,1,1,1,6,-1
KR_6745113843,420,-1,-74,-16,1,0,5,5,-4,5,1,-4,4,0,8,1,9,1,0,1,1,5,-1,3,-6,3,0,0,0,1,-1,-1,-1,5,-1
KR_6731311079,420,4,-21,-12,4,0,1,1,0,2,2,0,0,0,-1,3,2,5,0,5,0,3,7,4,-4,0,-1,0,1,-1,0,1,-1,6,-1
KR_6743953965,420,-2,-28,-4,-5,1,1,2,-1,2,1,-2,2,0,-6,7,1,3,0,3,0,-10,308,-1,-2,3,0,0,-1,1,1,-1,1,2,-1
KR_6760276574,420,-1,-63,-16,-2,-10,10,0,2,0,2,3,5,8,0,1,1,3,2,5,0,-1,-5,0,-3,3,0,0,-1,-1,-1,-1,-1,4,-1
KR_6740009606,440,-4,-112,-6,-14,1,0,1,-4,7,3,-3,3,0,-8,10,2,0,0,0,-1,-14,-9,-6,-3,9,0,0,-3,-1,1,-1,-1,5,-1
KR_6744789498,420,0,18,-4,-3,2,2,4,-3,4,1,-2,2,0,2,3,5,-2,2,0,-1,-12,-18,1,-4,3,3,0,2,-1,0,1,-1,1,-1
KR_6671305506,420,-2,11,8,2,1,1,2,-4,5,1,-2,4,2,5,1,6,2,2,4,0,3,1,-3,0,3,-6,0,0,0,0,0,1,0,-1
KR_6738938772,420,0,19,-4,-2,1,3,4,-5,5,0,-5,5,0,7,0,7,0,1,1,0,-5,-52,-4,-1,5,27,0,1,0,-1,1,1,0,-1
KR_6745736986,420,-1,45,14,0,-1,2,1,1,2,3,-2,2,0,1,1,2,1,0,1,0,-1,25,-2,0,2,-2,0,1,-1,-1,1,1,4,-1
KR_6717790418,420,-1,34,-4,-1,2,1,3,-1,2,1,0,1,1,-1,3,2,-1,3,2,0,-4,3,0,-1,1,-2,0,0,-1,-1,0,-1,4,-1
KR_6717677184,420,-4,-81,-24,-9,1,1,2,-3,7,4,-4,4,0,-3,4,1,0,0,0,0,-18,-182,-1,-3,4,3,0,-3,-1,0,-1,1,1,-1
KR_6660994216,420,-1,-84,-20,-2,-8,9,1,4,2,6,-1,2,1,0,1,1,3,0,3,-1,4,16,5,-8,3,-3,0,0,-1,-1,-1,-1,5,-1
KR_6746414444,420,0,-36,12,11,5,1,6,-1,1,0,4,1,5,3,1,4,0,0,0,0,8,-288,-1,-2,3,2,0,0,-1,0,0,1,1,-1
KR_6753215463,420,0,-48,-40,0,-7,8,1,1,0,1,0,2,2,5,0,5,1,0,1,0,3,6,1,-4,3,1,0,0,-1,-1,-1,-1,2,-1
KR_6684171953,420,1,0,20,1,4,1,5,-1,2,1,1,0,1,-3,3,0,0,0,0,-1,-6,5,1,-1,0,0,0,0,-1,1,1,-1,4,-1
KR_6682683049,420,-6,-18,-29,-15,1,1,2,-3,6,3,-5,7,2,-6,8,2,-2,3,1,0,-8,199,0,-3,3,-2,0,-5,-1,-1,-1,-1,6,-1
KR_6741474850,420,-3,-37,8,-9,-1,1,0,-3,3,0,3,2,5,-4,4,0,-4,4,0,0,-13,374,2,-4,2,-1,0,0,1,1,-1,-1,1,-1
KR_6649217666,440,-2,-14,-20,0,4,0,4,1,2,3,-3,7,4,-2,5,3,0,2,2,3,4,175,-5,-2,7,-1,0,0,-1,-1,1,1,3,-1
KR_6720469007,420,-1,-20,8,-4,1,2,3,-5,5,0,2,1,3,-2,4,2,0,0,0,0,-5,-292,-2,0,2,34,0,-1,-1,-1,-1,-1,4,-1
KR_6751153640,420,0,3,0,1,5,0,5,2,1,3,-4,4,0,-2,2,0,0,0,0,0,-4,4,3,-5,2,-4,0,0,0,-1,-1,-1,0,-1
KR_6753803241,420,1,62,-4,4,2,2,4,5,0,5,0,2,2,-3,9,6,0,0,0,0,-2,-5,-2,-4,6,2,0,0,-1,1,0,-1,2,-1
KR_6681585377,420,-5,-127,-24,3,-1,2,1,4,0,4,4,0,4,-1,4,3,-3,3,0,0,2,1,5,-6,1,-1,0,-1,1,1,-1,-1,2,-1
KR_6755217020,420,-6,-20,-8,-6,-6,7,1,-1,2,1,2,3,5,-1,3,2,0,1,1,0,-6,1,-4,-1,5,-2,0,1,1,-1,1,1,1,-1
KR_6760550422,420,-2,-57,-10,3,-1,2,1,1,1,2,2,3,5,0,3,3,1,1,2,0,5,-17,0,-2,2,7,0,0,0,-1,0,1,0,-1
KR_6762757775,420,1,35,4,-1,0,2,2,-1,1,0,3,2,5,-5,8,3,2,1,3,0,-4,1,1,-4,3,-1,0,-1,-1,1,-1,1,6,-1
KR_6764468436,420,-2,-101,8,-12,1,1,2,-3,4,1,1,4,5,-11,11,0,0,3,3,-1,-15,-7,-1,-2,3,0,0,-2,-1,0,-1,-1,5,-1
KR_6739901398,420,-2,-91,-8,-6,2,0,2,0,1,1,-6,6,0,-4,7,3,2,4,6,0,-5,170,0,-2,2,-6,0,-1,1,0,-1,-1,1,-1
KR_6728178913,420,-2,-50,-21,-5,0,0,0,1,1,2,-2,2,0,0,1,1,-4,5,1,0,-6,4,0,-3,3,-2,0,0,-1,-1,0,1,3,-1
KR_6728623940,420,6,11,16,-2,1,0,1,0,0,0,-3,3,0,0,3,3,0,2,2,1,-2,195,-2,-1,3,0,0,0,1,1,1,1,1,-1
KR_6658976017,420,-1,1,-19,-2,0,0,0,-2,2,0,-4,5,1,3,0,3,1,1,2,-1,1,-5,1,-2,1,0,0,-1,-1,1,-1,-1,2,-1
KR_6761823680,420,-2,-11,3,-7,-1,3,2,-1,2,1,-6,7,1,0,2,2,1,1,2,0,-7,0,2,-2,0,-1,0,-1,1,0,-1,1,4,-1
KR_6731321741,420,-7,-67,-23,-17,-1,3,2,-4,5,1,-5,7,2,-5,7,2,-2,3,1,1,-20,-5,-1,-1,2,0,0,0,-1,1,-1,1,2,-1
KR_6746050183,440,-2,-60,25,-8,1,1,2,1,0,1,-8,9,1,-4,5,1,2,1,3,0,-10,-10,-4,0,4,1,0,0,1,-1,-1,-1,3,-1
KR_6676973947,420,1,104,8,-1,3,0,3,-2,3,1,4,5,9,-6,7,1,0,1,1,0,-23,0,-2,-2,4,-1,0,2,-1,1,1,1,5,-1
KR_6760065555,440,-3,-81,-24,-5,-4,4,0,2,2,4,0,2,2,-3,3,0,0,0,0,0,-5,-4,-3,-2,5,1,0,-1,-1,-1,-1,-1,4,-1
KR_6712436476,420,-7,-20,3,-8,-3,6,3,0,4,4,-2,4,2,2,1,3,-5,5,0,1,-1,-1,-1,-2,3,4,0,-1,-1,-1,-1,1,4,-1
KR_6728894270,420,-5,-43,-23,-18,2,2,4,-10,10,0,-1,3,2,-9,9,0,0,2,2,0,-16,356,-2,-3,5,1,0,-2,-1,-1,-1,-1,6,-1
KR_6729141031,420,-2,-39,16,-19,-9,10,1,-3,3,0,1,2,3,-10,11,1,2,0,2,0,-8,-3,2,-2,0,-1,0,-3,1,1,-1,-1,2,-1
KR_6757703366,440,-3,-75,39,2,-6,8,2,4,2,6,3,1,4,-1,1,0,2,0,2,2,7,-3,4,-4,0,-3,0,-1,1,0,-1,1,4,-1
KR_6673655159,420,-9,-109,-46,-17,-1,2,1,-6,8,2,-9,11,2,-1,2,1,0,2,2,0,-5,-7,-4,-1,5,1,0,-3,-1,-1,-1,-1,5,-1
KR_6683785853,420,1,12,4,-1,6,0,6,2,0,2,-2,2,0,-6,8,2,-1,2,1,0,0,-10,-3,-3,6,1,0,1,0,-1,1,1,0,-1
KR_6680361139,420,-4,-84,-11,-9,3,1,4,-3,3,0,-5,6,1,-5,5,0,1,0,1,0,-13,-1,-4,-6,10,-4,0,0,-1,-1,-1,-1,4,-1
KR_6724102812,420,-1,-14,-24,-3,3,0,3,0,2,2,-3,4,1,-5,5,0,2,3,5,0,-9,0,-2,-2,4,-2,0,-1,-1,-1,-1,1,3,-1
KR_6733258998,420,-5,-109,-4,-10,0,3,3,-4,5,1,-4,4,0,-4,7,3,2,1,3,-1,-9,324,1,-1,0,1,0,-3,1,-1,-1,-1,3,-1
KR_6695620534,440,-6,-67,-36,-10,-1,2,1,0,5,5,-3,4,1,-5,10,5,-1,4,3,1,-12,-336,-2,-1,3,2,0,-1,-1,0,-1,1,2,-1
KR_6719994922,420,-1,-58,5,-2,5,1,6,-3,3,0,-5,5,0,0,3,3,1,0,1,0,-5,3,2,-4,2,-4,0,-1,-1,1,1,-1,1,-1
KR_6646798155,420,-6,-66,-12,-15,-7,9,2,-1,2,1,-2,7,5,-2,2,0,-3,3,0,-1,-11,-150,-2,-2,4,-1,0,-4,1,-1,-1,-1,4,-1
KR_6670441242,420,-4,-142,-11,-5,-1,1,0,3,3,6,-1,4,3,-7,7,0,1,0,1,0,-8,1,-2,-3,5,-1,0,-1,1,0,-1,1,4,-1
KR_6752338487,420,-1,-43,-9,5,1,1,2,2,1,3,0,4,4,2,3,5,0,0,0,0,4,72,4,-6,2,-2,0,0,1,0,0,1,5,-1
KR_6733656591,440,-2,-98,-13,-5,-1,1,0,1,3,4,-3,6,3,-1,4,3,-1,1,0,0,-1,-3,-1,-1,2,-2,0,-1,-1,-1,-1,1,3,-1
KR_6749747467,420,1,31,36,-6,-2,3,1,-4,6,2,1,2,3,1,0,1,-2,2,0,1,-1,-28,3,-4,1,2,0,0,1,-1,0,1,3,-1
KR_6738442643,420,-1,-111,0,5,-3,4,1,3,0,3,7,0,7,-1,1,0,-1,1,0,0,2,-5,2,-4,2,2,0,-2,1,-1,-1,1,4,-1
KR_6739014619,420,-8,-146,-60,-22,-9,10,1,-7,8,1,0,1,1,-8,8,0,2,0,2,-1,-8,-36,-4,0,4,-4,-1,-5,-1,-1,-1,-1,6,-1
KR_6682415615,420,-5,-14,-4,-6,4,0,4,-6,6,0,-1,1,0,0,2,2,-3,6,3,0,-13,-301,0,-3,3,-2,0,0,-1,-1,-1,1,1,-1
KR_6696188331,420,0,3,13,0,-6,7,1,7,0,7,-1,6,5,2,0,2,-2,5,3,-1,3,-10,-2,-3,5,-3,0,-1,0,1,-1,-1,0,-1
KR_6735176423,420,-5,-86,-4,-11,-8,9,1,-2,3,1,0,1,1,0,3,3,-1,3,2,0,2,0,-2,-1,3,1,0,-2,1,-1,-1,-1,6,-1
KR_6651104381,420,0,-13,28,-1,1,2,3,-1,1,0,3,2,5,-5,6,1,1,1,2,0,-4,3,1,-1,0,1,0,0,1,0,0,-1,5,-1
KR_6750226247,440,0,13,-4,1,7,3,10,0,4,4,2,1,3,-8,8,0,0,1,1,-1,3,198,2,-5,3,1,0,-1,-1,1,1,-1,4,-1
KR_6714758190,420,-2,39,-24,2,-2,3,1,3,1,4,2,1,3,0,1,1,-1,2,1,0,0,192,3,-5,2,0,0,0,-1,0,0,-1,6,-1
KR_6734427149,420,-1,-53,-23,4,-1,2,1,-1,5,4,0,1,1,4,1,5,2,0,2,0,10,177,5,-5,0,0,0,-1,1,-1,-1,1,2,-1
KR_6727240130,420,-2,5,16,-1,3,2,5,0,3,3,-2,6,4,-1,1,0,-1,1,0,0,-8,-26,-1,0,1,0,0,-2,-1,-1,-1,-1,6,-1
KR_6729860167,420,-2,-69,-20,-4,0,2,2,-1,3,2,-5,5,0,4,0,4,-2,2,0,0,-1,-40,5,-6,1,13,0,-1,1,-1,-1,1,4,-1
KR_6747584262,420,0,-59,8,6,1,3,4,-1,1,0,0,2,2,5,0,5,1,0,1,0,2,142,-3,0,3,-23,0,0,1,1,-1,-1,5,-1
KR_6728755139,420,2,10,32,9,6,0,6,1,3,4,5,0,5,-2,3,1,-1,2,1,1,0,9,3,-5,2,0,0,1,-1,1,1,1,3,-1
KR_6664705334,420,-4,-6,0,-5,0,3,3,0,0,0,-1,3,2,-4,4,0,0,1,1,1,0,12,8,-9,1,0,0,0,1,1,0,1,6,-1
KR_6761835267,420,-1,14,8,-2,-5,6,1,3,0,3,-2,3,1,1,1,2,1,2,3,0,3,6,1,-4,3,-4,0,0,1,-1,1,-1,4,-1
KR_6762613121,420,-3,-1,-12,0,-2,2,0,1,0,1,-1,3,2,2,4,6,0,4,4,0,1,3,2,-3,1,4,0,-1,1,0,-1,-1,3,-1
KR_6760551108,420,-3,1,-36,-1,1,0,1,-2,3,1,-1,1,0,1,2,3,0,0,0,0,-3,2,-1,-1,2,-5,0,0,-1,-1,0,1,6,-1
KR_6682771635,420,1,6,-16,-5,-6,9,3,-1,2,1,1,3,4,1,0,1,0,2,2,0,-2,8,0,-2,2,-2,0,0,1,-1,-1,-1,3,-1
KR_6744283793,420,1,27,-10,3,0,2,2,-1,4,3,0,5,5,1,1,2,3,0,3,0,5,0,4,-4,0,-1,0,2,-1,1,1,1,4,-1
KR_6762681957,420,3,-39,13,8,1,1,2,1,1,2,4,0,4,1,0,1,1,0,1,0,7,138,-1,-1,2,3,0,0,1,-1,0,-1,2,-1
KR_6723898143,420,-2,83,-12,-10,2,0,2,-1,4,3,0,4,4,-6,8,2,-5,6,1,0,-11,38,2,-5,3,-14,0,-1,-1,-1,1,-1,2,-1
KR_6705192989,420,-1,-109,-8,1,-1,2,1,2,0,2,1,1,2,-2,3,1,1,0,1,0,0,-7,-1,-1,2,2,0,0,-1,1,0,1,1,-1
KR_6642890670,420,-2,-119,8,-5,-1,3,2,-3,4,1,0,2,2,-2,2,0,1,1,2,1,-4,0,-4,-4,8,1,0,-1,-1,1,-1,1,5,-1
KR_6725795721,420,-1,-21,16,-5,-2,4,2,0,3,3,-1,2,1,-2,2,0,0,0,0,0,-5,11,0,-2,2,2,0,-1,1,-1,-1,-1,1,-1
KR_6741675601,420,-1,40,-34,4,-1,1,0,2,2,4,-4,5,1,6,1,7,1,2,3,1,4,6,-2,-1,3,-1,0,1,1,1,1,1,1,-1
KR_6745933766,420,-2,-57,12,-6,4,0,4,0,2,2,-1,2,1,-7,8,1,-2,2,0,0,-10,-207,-4,-1,5,-1,0,0,-1,1,1,1,5,-1
KR_6745932491,420,-8,-116,-20,-24,-7,7,0,0,1,1,-4,5,1,-8,9,1,-5,6,1,0,-17,3,-2,-1,3,-2,0,-1,-1,-1,-1,-1,6,-1
KR_6756564076,420,-4,-59,-64,-8,2,0,2,-7,7,0,1,2,3,-2,2,0,-2,2,0,-1,-13,-17,-2,0,2,20,0,-1,-1,-1,-1,-1,1,-1
KR_6746762360,420,-7,29,-72,-1,-3,3,0,-1,1,0,-1,4,3,4,1,5,0,1,1,0,1,-13,-4,-1,5,1,0,-2,0,-1,-1,1,0,-1
KR_6747235595,440,-1,-5,-28,-6,-2,3,1,-5,5,0,-6,8,2,2,5,7,5,2,7,-1,-6,-23,0,-1,1,-3,0,0,-1,1,1,1,1,-1
KR_6712357510,420,-2,-42,-5,-6,2,2,4,0,1,1,-2,4,2,-5,7,2,-1,3,2,0,-7,6,1,-2,1,2,0,-1,0,-1,-1,-1,0,-1
KR_6673500186,420,-3,-36,-31,-11,1,0,1,-6,8,2,-5,8,3,0,4,4,-1,1,0,0,-1,-411,0,-2,2,-3,0,-2,-1,-1,-1,-1,3,-1
KR_6732773849,420,2,-29,28,-1,2,1,3,0,2,2,4,4,8,-3,9,6,-4,6,2,0,-4,-11,1,-6,5,5,0,-1,1,-1,-1,-1,2,-1
KR_6749880923,420,2,-52,-21,-1,2,2,4,-9,10,1,-2,5,3,6,2,8,2,2,4,0,1,14,0,-2,2,0,0,-1,0,-1,-1,-1,0,-1
KR_6740877242,440,-2,-106,-28,-8,-2,5,3,6,1,7,-3,3,0,-8,8,0,-1,3,2,1,-3,13,-3,-1,4,-5,0,-2,-1,0,-1,1,4,-1
KR_6759545716,420,-3,-4,8,-1,-3,4,1,2,3,5,-2,3,1,-1,5,4,3,0,3,-1,0,9,3,-4,1,-4,0,-1,1,0,-1,-1,3,-1
KR_6762684849,420,0,12,-12,3,1,2,3,3,1,4,-2,3,1,2,0,2,-1,2,1,0,1,221,-1,-2,3,5,0,0,0,1,0,1,0,-1
KR_6756055916,420,-4,0,-12,-15,-2,3,1,-4,5,1,-12,13,1,0,2,2,3,0,3,-1,-12,-11,-1,-3,4,-7,0,-1,-1,-1,-1,-1,4,-1
KR_6738453439,420,-2,-37,-7,-4,-2,2,0,1,0,1,-2,3,1,-1,4,3,0,1,1,0,-1,197,0,-3,3,-1,0,0,1,-1,0,1,4,-1
KR_6722732183,420,1,-23,-20,4,1,2,3,8,0,8,-7,8,1,2,0,2,0,1,1,0,12,2,-2,0,2,0,0,0,1,0,-1,-1,2,-1
KR_6755993291,420,-3,-50,-13,0,1,3,4,-3,3,0,-2,2,0,-1,1,0,5,0,5,0,3,0,0,-2,2,2,0,0,-1,-1,0,1,2,-1
KR_6754310774,420,-5,-57,7,-4,-4,4,0,0,2,2,2,0,2,-2,3,1,0,0,0,-1,-2,3,2,-2,0,0,0,-1,-1,0,-1,-1,1,-1
KR_6719234306,420,1,-11,36,-1,-1,2,1,1,1,2,4,0,4,-3,3,0,-2,2,0,0,-6,1,2,-5,3,-2,0,0,1,0,0,1,3,-1
KR_6762142474,420,-7,-61,-36,-4,0,4,4,-1,2,1,-1,1,0,-1,1,0,-1,1,0,1,-4,-2,-1,0,1,0,0,-1,1,0,-1,1,1,-1
KR_6657908708,420,-5,-105,-8,-21,0,0,0,-7,8,1,-6,10,4,-7,10,3,-1,1,0,-2,-18,3,0,-5,5,0,0,-2,-1,1,-1,-1,6,-1
KR_6745609193,420,-3,-83,-2,-9,-1,2,1,-1,2,1,-5,5,0,-3,5,2,1,0,1,0,-5,4,5,-6,1,1,0,0,1,1,-1,-1,3,-1
KR_6749770143,420,-1,39,-16,-4,1,0,1,1,1,2,-2,5,3,-6,6,0,2,1,3,-1,-4,0,1,-4,3,-2,0,-1,-1,1,1,-1,3,-1
KR_6714431261,420,3,33,-4,2,-3,5,2,-1,3,2,2,1,3,-1,3,2,5,0,5,0,3,0,1,-3,2,1,0,2,-1,1,1,1,1,-1
KR_6746335212,420,-4,-51,24,-11,1,2,3,1,2,3,-5,8,3,-7,7,0,-1,2,1,0,-20,-6,-5,-1,6,0,0,-1,-1,1,-1,-1,1,-1
KR_6761686582,420,-1,-22,0,-3,-2,4,2,3,1,4,-4,6,2,1,0,1,-1,2,1,0,9,3,1,-4,3,0,0,-1,0,1,-1,-1,0,-1
KR_6658521864,420,-7,-176,-12,-6,-2,2,0,-1,3,2,-2,5,3,-2,3,1,1,2,3,-1,-4,-8,-6,-3,9,-2,0,-3,-1,-1,-1,-1,5,-1
KR_6762667483,420,-2,-9,-12,0,-2,5,3,0,1,1,2,4,6,-2,3,1,2,0,2,1,1,8,3,-4,1,-4,0,-2,-1,-1,-1,1,2,-1
KR_6747528942,420,-4,13,-29,-4,1,1,2,0,1,1,-1,3,2,-4,4,0,0,1,1,1,-1,-2,0,-3,3,-1,0,1,1,1,1,1,1,-1
KR_6661632370,420,0,53,11,-8,1,0,1,1,0,1,-7,7,0,-2,6,4,-1,3,2,0,-16,19,-2,0,2,4,0,0,0,-1,1,-1,0,-1
KR_6734850643,420,0,-3,-4,8,-1,3,2,3,3,6,6,0,6,0,2,2,0,1,1,0,11,44,5,-6,1,1,0,-1,-1,-1,-1,1,1,-1
KR_6732637258,420,-3,-50,-28,-7,-3,3,0,-1,1,0,-2,4,2,0,0,0,-1,1,0,0,-3,-8,-2,-1,3,-1,0,-1,-1,-1,-1,-1,1,-1
KR_6622842646,420,-5,-70,8,-10,0,1,1,-2,3,1,-10,10,0,1,2,3,1,1,2,-1,-8,1,2,-4,2,1,0,-2,-1,-1,-1,-1,6,-1
KR_6756064842,420,2,30,8,5,0,0,0,2,0,2,3,1,4,0,3,3,0,2,2,0,0,5,2,-3,1,-1,0,0,-1,1,1,-1,5,-1
KR_6738406973,420,-3,-37,-21,-2,-3,4,1,-4,4,0,-5,6,1,7,0,7,3,0,3,0,8,5,4,-6,2,0,0,-2,1,0,-1,1,2,-1
KR_6756526827,440,-4,-12,-38,-8,-2,3,1,-2,2,0,-3,4,1,0,0,0,-1,1,0,0,-1,2,1,-3,2,-1,0,-1,-1,-1,-1,1,3,-1
KR_6762226847,420,-6,-73,15,-6,-1,3,2,-1,2,1,-1,3,2,-1,2,1,-2,2,0,0,-5,10,2,-4,2,0,0,-2,-1,0,-1,1,3,-1
KR_6653964344,440,-8,-60,-46,-13,-4,5,1,1,5,6,-2,2,0,-6,8,2,-2,4,2,0,-17,1,-2,-3,5,-5,0,-2,-1,-1,-1,1,2,-1
KR_6741741204,440,-6,-91,-15,-12,-1,5,4,-6,6,0,-3,3,0,1,2,3,-3,4,1,-1,-3,-7,2,-2,0,0,0,-2,-1,-1,-1,-1,2,-1
KR_6748770884,440,-4,-114,-13,-5,2,1,3,1,3,4,-4,5,1,-5,6,1,1,1,2,0,1,49,3,-4,1,-20,0,-2,1,1,-1,1,6,-1
KR_6752167182,420,-2,24,-3,-2,0,2,2,-4,6,2,3,1,4,-1,1,0,0,1,1,1,-1,-7,-5,0,5,-1,0,0,-1,-1,0,1,5,-1
KR_6712068622,420,-2,29,-46,-2,-1,1,0,-2,5,3,-1,3,2,1,1,2,1,0,1,0,-2,-22,-1,-1,2,-2,0,0,-1,-1,-1,1,1,-1
KR_6751030014,420,-1,12,-5,-3,-6,6,0,0,2,2,3,3,6,0,3,3,0,1,1,0,-5,-9,-2,0,2,1,0,-1,1,-1,-1,1,4,-1
KR_6724113618,440,0,1,-4,-1,-6,11,5,2,0,2,-1,4,3,3,4,7,1,2,3,0,13,5,3,-5,2,0,0,-1,0,-1,-1,1,0,-1
KR_6676572239,420,1,14,-20,5,-3,3,0,2,0,2,3,1,4,3,3,6,0,0,0,0,7,-20,1,-2,1,0,0,0,1,-1,1,1,5,-1
KR_6703212811,420,-1,10,-14,-8,-2,3,1,-1,3,2,3,1,4,-1,2,1,-7,8,1,0,-8,-1,-1,-1,2,0,0,0,-1,1,0,-1,2,-1
KR_6662973425,440,-2,-41,-8,-1,0,2,2,-1,3,2,6,0,6,-4,5,1,-2,3,1,0,-3,-116,1,-2,1,0,0,0,-1,1,0,1,6,-1
KR_6723886002,420,-1,23,12,-7,3,0,3,-8,9,1,0,0,0,-2,4,2,0,3,3,0,-15,18,1,-2,1,-1,0,0,0,1,0,1,0,-1
KR_6732374838,420,-1,-46,-5,-5,0,1,1,0,3,3,2,1,3,-2,3,1,-5,7,2,0,-8,11,0,-1,1,-3,0,-1,0,-1,-1,-1,0,-1
KR_6677024129,420,1,-38,16,2,-1,3,2,3,0,3,-7,7,0,9,0,9,-2,2,0,0,8,6,0,0,0,-1,0,-1,1,1,-1,-1,2,-1
KR_6761687097,420,0,-29,16,-3,-6,7,1,-1,3,2,5,0,5,-1,2,1,0,0,0,0,5,0,-1,-1,2,-2,0,-1,0,-1,-1,1,0,-1
KR_6642876847,420,-3,-9,-21,1,0,2,2,-2,2,0,4,0,4,-3,5,2,2,1,3,0,3,5,4,-4,0,0,0,0,1,1,-1,-1,6,-1
KR_6697135349,420,-5,-1,-32,-7,1,1,2,-2,4,2,0,2,2,-2,4,2,-4,5,1,0,-9,-222,2,-2,0,0,0,1,-1,-1,1,-1,3,-1
KR_6749995273,420,-1,-8,4,-3,-5,5,0,-2,3,1,-4,7,3,2,0,2,6,0,6,0,8,14,0,-5,5,0,0,0,1,-1,-1,-1,2,-1
KR_6760925567,420,-5,-67,-16,-15,-4,4,0,-7,8,1,0,2,2,-2,4,2,-2,3,1,0,-9,1,0,-3,3,0,0,-1,-1,-1,-1,-1,2,-1
KR_6759414313,420,-1,-1,-47,5,0,0,0,1,4,5,3,4,7,0,1,1,1,0,1,0,11,190,-2,-3,5,0,0,-1,1,-1,-1,-1,4,-1
KR_6686493893,420,-4,-75,0,-9,-5,5,0,0,3,3,-5,5,0,1,1,2,0,1,1,0,-2,3,-6,-1,7,-2,0,0,1,-1,-1,-1,3,-1
KR_6761142669,420,-6,-21,-22,-6,-1,1,0,-1,2,1,0,3,3,-3,5,2,-1,3,2,0,-7,6,-1,-2,3,1,0,-1,-1,0,-1,1,3,-1
KR_6644062050,440,-2,-20,-24,-6,-6,6,0,-2,3,1,-1,2,1,4,0,4,-1,3,2,0,3,-8,-1,-1,2,2,0,-1,-1,-1,-1,1,2,-1
KR_6762698590,420,-1,-52,-4,-10,-1,1,0,-4,4,0,-2,2,0,-1,4,3,-2,5,3,0,-13,4,-2,-1,3,-1,0,0,-1,-1,-1,-1,1,-1
KR_6764031700,440,1,-9,-10,3,3,3,6,1,3,4,7,0,7,-7,8,1,-1,1,0,0,0,0,-3,0,3,1,0,0,1,1,-1,1,6,-1
KR_6697242415,420,-6,-125,8,-6,-3,4,1,-3,3,0,-1,4,3,-2,4,2,3,3,6,-1,0,-8,1,-5,4,0,0,-3,-1,-1,-1,-1,6,-1
KR_6709610475,440,-4,-80,-4,-11,-9,10,1,2,0,2,7,0,7,-9,10,1,-2,2,0,0,-3,-200,0,-3,3,1,0,-1,-1,-1,-1,-1,4,-1
KR_6754710119,420,1,53,-24,-4,1,0,1,-1,2,1,0,2,2,-3,8,5,-1,3,2,0,-4,-2,-3,0,3,-1,0,0,1,-1,0,-1,6,-1
KR_6718055529,420,1,43,4,-3,-2,3,1,2,2,4,0,3,3,-1,5,4,-2,4,2,1,3,-4,1,-6,5,2,0,0,-1,1,0,1,1,-1
KR_6764184649,420,-3,-17,5,-8,1,0,1,1,1,2,-2,3,1,-3,3,0,-5,5,0,0,-10,-21,-3,-2,5,2,0,0,-1,0,0,-1,2,-1
KR_6763052783,420,-1,74,-16,-4,-4,4,0,1,1,2,1,1,2,0,2,2,-2,4,2,0,1,-4,-1,-2,3,0,0,0,-1,-1,0,-1,2,-1
KR_6681470731,420,-3,18,-118,-5,-8,10,2,5,0,5,1,0,1,4,0,4,-7,8,1,0,3,2,0,-2,2,1,0,-1,-1,-1,1,-1,1,-1
KR_6737679672,420,1,-29,-16,-1,2,2,4,0,1,1,0,3,3,-2,5,3,-1,2,1,0,-5,222,-2,-4,6,-2,0,0,0,0,0,1,0,-1
KR_6717900632,420,-1,-38,5,-10,-3,3,0,-4,4,0,-5,5,0,2,3,5,0,3,3,-1,-9,33,-6,-1,7,-4,0,0,-1,1,0,-1,2,-1
KR_6697061137,420,2,-37,-21,0,-2,3,1,-3,4,1,3,0,3,0,2,2,2,0,2,0,-4,0,1,-4,3,1,0,-1,-1,1,-1,-1,1,-1
KR_6758292513,420,4,-6,3,15,5,3,8,5,1,6,-1,1,0,0,4,4,6,0,6,2,16,23,3,-4,1,-1,0,1,1,1,1,1,6,-1
KR_6760796610,420,2,13,16,3,-1,1,0,-1,2,1,2,1,3,2,3,5,1,1,2,-2,-1,140,3,-6,3,-2,0,-1,1,-1,-1,-1,5,-1
KR_6757093277,420,-1,-60,16,-2,5,1,6,-4,4,0,2,3,5,-2,2,0,-3,3,0,0,-10,1,1,-4,3,2,0,-1,1,0,-1,1,4,-1
KR_6711178437,420,-7,-156,-19,-13,-7,8,1,-4,5,1,1,3,4,-4,7,3,1,3,4,0,-5,-30,-5,-3,8,-3,0,-1,0,0,-1,-1,0,-1
KR_6730099883,420,1,72,28,1,0,1,1,-1,2,1,-2,6,4,2,2,4,2,2,4,0,-6,-4,0,-4,4,0,0,0,1,0,1,1,2,-1
KR_6759758052,440,-1,-37,18,-5,2,0,2,-1,3,2,2,0,2,-4,5,1,-4,6,2,0,-7,-1,0,-6,6,1,0,-1,0,-1,-1,-1,0,-1
KR_6755446685,440,2,-26,-12,6,0,2,2,0,1,1,-2,3,1,-1,4,3,9,0,9,0,11,-5,-3,-3,6,3,0,0,1,-1,-1,1,4,-1
KR_6756871172,420,0,-52,-24,3,2,0,2,2,4,6,1,1,2,-2,2,0,0,2,2,0,1,4,-6,0,6,2,0,0,0,-1,-1,1,0,-1
KR_6736525302,420,1,74,-60,6,0,2,2,0,3,3,0,2,2,4,0,4,2,1,3,0,6,-356,-1,-1,2,-2,0,1,1,-1,-1,1,3,-1
KR_6725839119,420,-2,-33,9,2,2,0,2,-2,3,1,-2,4,2,3,0,3,1,0,1,0,4,-2,-1,-2,3,2,0,0,-1,1,1,1,3,-1
KR_6758018294,440,-4,64,-62,-10,-2,3,1,-2,2,0,-7,7,0,2,0,2,-1,1,0,0,-5,-3,1,-3,2,-1,0,0,0,-1,0,-1,0,-1
KR_6700074068,420,1,84,20,1,2,1,3,-1,4,3,4,0,4,-3,4,1,-1,2,1,0,1,32,2,-3,1,-3,0,0,0,0,1,1,0,-1
KR_6752286604,420,-3,-71,-5,0,3,0,3,2,4,6,0,4,4,-3,3,0,-2,2,0,0,-7,1,-3,0,3,-1,0,-1,1,1,-1,1,1,-1
KR_6759441282,420,-4,-47,-44,-5,-2,2,0,-3,4,1,-1,1,0,0,2,2,1,0,1,0,2,-1,-2,-3,5,0,0,0,-1,-1,0,-1,2,-1
KR_6631496209,420,0,-4,24,-5,-3,3,0,-2,3,1,2,1,3,0,4,4,-2,2,0,0,0,-44,1,-3,2,15,0,-2,-1,1,-1,-1,1,-1
KR_6651606545,420,1,52,27,1,-2,2,0,3,0,3,5,2,7,-3,5,2,-2,3,1,0,-4,2,3,-3,0,0,0,0,1,-1,1,1,2,-1
KR_6754074070,420,-3,-15,0,-5,0,3,3,0,2,2,-1,2,1,-4,7,3,0,4,4,0,-9,-6,-1,-3,4,-5,0,0,-1,-1,0,-1,6,-1
KR_6697050026,420,-3,-98,-15,-3,-2,3,1,3,2,5,-2,4,2,-1,4,3,-1,1,0,0,1,5,0,0,0,-2,0,0,-1,-1,0,1,4,-1
KR_6746675043,420,-9,-140,-44,-13,-2,3,1,-3,3,0,-5,8,3,0,3,3,-3,4,1,0,-9,-20,0,-2,2,2,0,-2,-1,-1,-1,1,6,-1
KR_6739938003,420,2,114,14,0,2,3,5,-3,3,0,-4,8,4,4,2,6,1,4,5,-2,-5,0,5,-6,1,-5,0,2,-1,-1,1,-1,4,-1
KR_6729411278,420,2,-6,-8,-1,-1,4,3,-2,5,3,-3,4,1,3,2,5,2,1,3,0,5,-44,-2,-2,4,19,0,-1,-1,-1,-1,-1,3,-1
KR_6735062011,420,-5,-66,-16,-10,-1,2,1,-7,7,0,-1,5,4,1,3,4,-2,3,1,0,-5,3,2,-2,0,-3,0,0,1,0,0,-1,4,-1
KR_6752533111,420,-2,-38,-26,-3,0,2,2,-1,1,0,-4,6,2,1,3,4,1,2,3,-1,-4,-137,0,-1,1,0,0,-2,-1,-1,-1,-1,6,-1
KR_6747204567,420,-2,-75,0,-5,-3,3,0,-7,8,1,0,4,4,5,0,5,0,1,1,0,-2,18,0,-4,4,-1,0,0,1,-1,-1,-1,6,-1
KR_6689704731,420,-2,-11,-7,-8,-5,7,2,0,4,4,1,2,3,-4,4,0,0,1,1,0,-7,-3,-4,-3,7,-1,0,0,-1,0,0,1,5,-1
KR_6750810364,420,0,-77,12,0,1,0,1,3,1,4,-4,5,1,-3,5,2,3,0,3,0,2,50,-2,-2,4,-4,0,0,-1,0,0,-1,1,-1
KR_6685966482,420,-4,-81,-20,-11,-1,1,0,0,1,1,-7,7,0,-3,3,0,0,0,0,0,-4,38,-3,-2,5,-7,0,-1,-1,-1,-1,-1,3,-1
KR_6756642436,440,0,27,0,2,-2,5,3,-1,2,1,-3,3,0,6,0,6,2,0,2,0,14,-4,0,-2,2,-1,0,-1,-1,-1,-1,-1,2,-1
KR_6750764818,420,-8,-78,-1,-13,-3,3,0,3,0,3,-4,4,0,-9,9,0,0,0,0,0,-9,1,2,-5,3,2,0,-2,1,1,-1,-1,4,-1
KR_6653895324,420,-1,10,-40,4,-4,6,2,3,1,4,5,1,6,-1,3,2,1,1,2,0,8,13,6,-10,4,1,0,-1,1,-1,-1,-1,5,-1
KR_6715155826,440,-1,-46,16,-10,-3,4,1,-3,4,1,-6,6,0,2,5,7,0,3,3,-1,-2,-3,0,-1,1,0,0,-1,1,-1,-1,-1,3,-1
KR_6688612046,420,-3,-128,-72,-5,-1,3,2,0,2,2,-1,7,6,-6,6,0,3,2,5,0,-2,-96,-3,-2,5,-1,0,-2,1,-1,-1,1,1,-1
KR_6723767501,420,0,-67,29,0,-1,1,0,0,0,0,-2,3,1,1,2,3,2,1,3,0,-1,14,0,-3,3,1,0,0,0,-1,0,1,0,-1
KR_6661420808,420,4,3,24,8,3,2,5,0,1,1,1,1,2,4,1,5,0,1,1,0,1,-5,0,-1,1,0,0,0,-1,-1,0,1,5,-1
KR_6720632526,420,-6,-115,-56,-11,0,3,3,-2,2,0,-4,4,0,-3,3,0,-2,2,0,0,-11,2,-1,-1,2,-1,0,-1,-1,-1,-1,-1,5,-1
KR_6762284429,420,4,35,43,2,3,1,4,-1,5,4,3,4,7,-5,6,1,2,0,2,0,-1,-113,-2,-3,5,1,0,1,-1,1,1,1,1,-1
KR_6744706841,420,2,-38,53,-1,-4,6,2,2,0,2,5,1,6,-1,2,1,-3,3,0,0,-2,-154,-1,-4,5,-2,0,-1,1,1,-1,-1,6,-1
KR_6525006746,420,-1,-11,16,-2,-1,2,1,3,2,5,1,1,2,-6,7,1,1,0,1,0,4,-163,-5,-2,7,-2,0,-3,-1,-1,-1,-1,3,-1
KR_6686166045,420,1,9,17,9,-1,5,4,0,2,2,6,0,6,7,0,7,-3,4,1,1,12,9,-6,-1,7,0,0,1,1,-1,1,1,1,-1
KR_6763713718,420,-1,43,-15,-6,-2,4,2,0,0,0,1,2,3,-3,4,1,-2,2,0,0,-8,2,-2,0,2,1,0,0,-1,0,-1,1,1,-1
KR_6748758542,420,-5,-43,-24,-19,-4,4,0,-2,4,2,-10,10,0,0,3,3,-3,3,0,-1,-15,0,-5,0,5,3,0,0,-1,1,-1,-1,1,-1
KR_6726460934,440,-5,-119,-7,-7,-3,4,1,0,4,4,-7,9,2,1,1,2,2,0,2,0,-7,-7,-1,-2,3,1,0,-2,-1,1,-1,-1,1,-1
KR_6758605303,420,-4,-64,-20,1,-5,5,0,7,0,7,1,0,1,-1,2,1,-1,1,0,1,5,-1,0,-3,3,-2,0,-3,1,-1,-1,1,1,-1
KR_6619837917,440,-2,-5,-3,-7,2,1,3,-1,5,4,-3,5,2,-1,2,1,-4,4,0,-1,-8,-30,-1,-4,5,2,0,1,0,-1,1,-1,0,-1
KR_6638393935,420,-1,-81,-26,1,4,2,6,3,2,5,1,0,1,-2,5,3,-5,5,0,0,6,-4,1,-5,4,0,0,1,1,1,1,1,2,-1
KR_6759384315,420,-6,-23,-36,-15,-1,1,0,4,1,5,-6,6,0,-11,13,2,-1,2,1,-1,-12,-8,-1,-2,3,-3,0,-2,1,-1,-1,-1,3,-1
KR_6762696444,420,5,19,32,11,3,1,4,2,1,3,6,1,7,0,1,1,0,0,0,0,4,-417,-1,-2,3,0,0,1,1,-1,1,1,4,-1
KR_6743185629,440,-5,-80,16,-11,-9,9,0,1,2,3,-3,6,3,-2,4,2,2,0,2,0,-4,0,0,-2,2,2,0,-3,-1,-1,-1,-1,5,-1
KR_6642045973,420,-1,-2,4,-5,-1,1,0,-1,3,2,1,0,1,-2,4,2,-2,3,1,0,-6,24,-1,-1,2,-22,0,-1,1,-1,-1,1,6,-1
KR_6711539236,420,0,-70,24,4,-1,3,2,1,3,4,-2,3,1,6,1,7,0,0,0,-1,10,-6,2,-5,3,-1,0,0,0,-1,0,1,0,-1
KR_6736846307,420,2,11,25,1,-1,2,1,-1,2,1,2,1,3,0,2,2,1,0,1,0,-1,-22,-1,-2,3,1,0,-3,0,-1,-1,-1,0,-1
KR_6730393827,420,-7,-28,-55,-17,0,0,0,0,1,1,-10,11,1,-6,6,0,-1,2,1,0,-8,-76,2,-5,3,-1,0,-2,-1,-1,-1,-1,4,-1
KR_6728036468,420,-5,-69,-32,-12,-6,6,0,0,2,2,-4,5,1,0,1,1,-2,4,2,-1,-6,-12,1,-1,0,0,0,-4,-1,1,-1,-1,2,-1
KR_6683603011,440,-2,14,-28,-5,-7,8,1,3,0,3,-1,2,1,-2,2,0,2,0,2,-2,-11,2,0,0,0,-1,0,0,-1,1,0,-1,1,-1
KR_6699907477,420,-2,43,-28,-9,-2,5,3,-4,6,2,0,0,0,-1,2,1,-2,4,2,0,-1,3,1,-2,1,1,0,1,1,-1,1,1,3,-1
KR_6759473755,420,2,30,4,-1,4,1,5,-1,6,5,-4,5,1,-3,3,0,3,1,4,0,0,-3,2,-4,2,0,0,1,0,1,1,-1,0,-1
KR_6622982116,420,3,19,16,-2,-1,1,0,1,3,4,-3,8,5,1,2,3,0,0,0,0,-3,10,-3,-5,8,3,0,1,-1,-1,1,-1,6,-1
KR_6728066411,420,-1,-54,8,-2,-4,4,0,1,3,4,3,1,4,-1,2,1,-1,1,0,0,-4,-30,-1,-1,2,0,0,-2,0,-1,-1,-1,0,-1
KR_6754073785,420,-2,22,-59,-6,-1,1,0,0,1,1,-3,3,0,-1,2,1,-1,1,0,0,-5,1,2,-4,2,1,0,-1,0,-1,-1,1,0,-1
KR_6691253683,440,-2,-21,-20,-11,3,0,3,-1,1,0,-1,3,2,-12,12,0,0,0,0,0,-10,19,-5,0,5,4,0,-1,-1,-1,-1,-1,5,-1
KR_6717171736,420,1,-16,8,8,-4,4,0,-2,5,3,1,0,1,10,0,10,3,0,3,0,11,0,2,-2,0,-1,0,0,-1,1,1,1,6,-1
KR_6746282170,420,-2,38,8,1,-1,3,2,-2,7,5,5,2,7,-1,3,2,0,3,3,-1,-5,-6,-1,-1,2,1,0,-1,-1,1,-1,-1,5,-1
KR_6751312845,440,-4,88,24,-12,3,3,6,-7,7,0,-4,7,3,-6,6,0,2,1,3,0,-14,5,-5,0,5,1,0,2,-1,1,1,1,1,-1
KR_6711785553,420,1,-21,28,0,-4,4,0,-3,5,2,-1,1,0,5,0,5,3,2,5,0,1,28,5,-6,1,-1,0,0,1,1,0,1,3,-1
KR_6740710285,420,-10,-174,-47,-22,-2,3,1,-3,4,1,-4,4,0,-11,11,0,-2,3,1,0,-18,-294,0,-2,2,19,0,-4,-1,1,-1,-1,4,-1
KR_6733801484,420,0,34,40,2,2,0,2,5,0,5,1,0,1,-2,3,1,-4,4,0,0,3,-11,-4,-1,5,4,0,-1,0,1,-1,1,0,-1
KR_6695005691,420,-8,-90,-4,-18,-4,4,0,-5,5,0,-5,7,2,-3,6,3,-1,2,1,-1,-7,-3,-3,0,3,1,0,-1,-1,-1,-1,-1,6,-1
KR_6670259523,420,-4,-5,-3,-9,1,1,2,1,3,4,-5,7,2,-3,3,0,-3,3,0,0,-11,-1,-4,0,4,0,0,-1,1,1,-1,-1,4,-1
KR_6748974788,440,-3,4,-32,-7,-2,3,1,-3,4,1,-2,4,2,1,1,2,-1,1,0,0,-6,11,5,-10,5,-7,0,0,-1,-1,0,-1,2,-1
KR_6761678095,420,2,37,20,1,0,0,0,5,2,7,0,0,0,-3,4,1,-1,3,2,1,-4,130,-2,-2,4,3,0,0,-1,-1,1,1,6,-1
KR_6754005323,420,1,-23,-1,0,2,2,4,-1,2,1,-5,5,0,4,0,4,0,0,0,0,1,21,-2,-2,4,-11,0,0,-1,1,0,-1,3,-1
KR_6716292114,420,-3,-78,-2,-12,-2,3,1,-1,3,2,-1,3,2,-5,9,4,-3,3,0,1,-5,-6,-6,-2,8,-3,0,-2,-1,1,-1,1,4,-1
KR_6685675904,440,-6,-68,-8,-8,-3,3,0,0,1,1,0,1,1,-3,3,0,-2,2,0,0,-4,-1,-2,-1,3,0,0,-2,0,-1,-1,-1,0,-1
KR_6432023468,420,0,-13,-1,0,-3,4,1,6,3,9,0,2,2,1,1,2,-4,6,2,0,1,105,2,-3,1,-4,0,-1,0,-1,-1,1,0,-1
KR_6683407138,420,-4,-143,-20,-2,-5,5,0,3,0,3,1,0,1,3,1,4,-4,4,0,-1,5,3,4,-6,2,-3,0,-1,0,0,-1,-1,0,-1
KR_6732598840,420,-2,-96,8,-6,0,2,2,0,2,2,-3,4,1,-2,2,0,-1,1,0,0,-10,-1,3,-4,1,-5,0,-2,-1,0,-1,-1,3,-1
KR_6680863589,420,-2,6,-11,-2,-1,2,1,-4,6,2,-2,2,0,2,1,3,3,1,4,0,-7,-8,-4,0,4,-2,0,1,-1,-1,1,1,2,-1
KR_6761783508,420,-2,-72,-36,-5,-3,4,1,-5,6,1,-3,3,0,2,2,4,4,3,7,0,-2,-117,-1,-3,4,-1,0,0,-1,1,0,-1,6,-1
KR_6653548795,420,-7,-27,-114,-17,-6,6,0,-3,5,2,2,0,2,-11,11,0,1,2,3,0,-12,6,1,-3,2,-2,0,-1,0,-1,-1,1,0,-1
KR_6762058644,420,-4,-91,8,-13,-1,2,1,0,0,0,-3,5,2,-8,8,0,-1,1,0,-1,-11,161,1,-1,0,-4,0,-2,-1,0,-1,-1,6,-1
KR_6752093658,420,-3,-7,-26,-8,-3,3,0,-5,6,1,2,0,2,-1,5,4,-1,3,2,0,-9,-102,-3,-4,7,-2,0,0,0,1,0,1,0,-1
KR_6764515369,440,2,52,13,4,4,0,4,-3,4,1,5,0,5,-2,2,0,0,1,1,0,-3,126,2,-4,2,1,0,0,0,-1,0,1,0,-1
KR_6741434315,420,1,12,28,4,0,1,1,2,0,2,1,1,2,1,2,3,0,0,0,-2,-1,32,-1,-5,6,-20,0,0,-1,0,0,-1,2,-1
KR_6762630060,420,1,-65,-4,3,0,2,2,1,1,2,2,3,5,0,2,2,0,0,0,0,3,10,1,-3,2,0,0,0,0,0,0,-1,0,-1
KR_6746801073,420,-3,-40,-45,-1,4,0,4,-1,2,1,-8,9,1,2,1,3,2,0,2,0,5,-10,1,-2,1,2,0,0,-1,-1,-1,-1,3,-1
KR_6663365557,420,-1,-36,-26,0,-1,2,1,6,1,7,-4,5,1,0,3,3,-1,2,1,0,3,-7,7,-7,0,-2,0,0,-1,-1,0,1,3,-1
KR_6648921468,420,1,55,-28,8,4,0,4,3,0,3,-8,8,0,4,0,4,5,0,5,0,9,-16,1,-3,2,6,0,1,0,-1,1,1,0,-1
KR_6711466163,420,-2,-41,-33,-1,-4,5,1,1,2,3,-1,4,3,4,0,4,-1,1,0,0,3,-74,-3,-2,5,3,0,-1,-1,0,-1,-1,1,-1
KR_6764493978,420,0,4,24,3,2,0,2,0,5,5,-4,6,2,0,2,2,5,2,7,1,1,8,-2,-2,4,-4,0,1,-1,1,1,1,1,-1
KR_6738055421,420,-3,65,4,-8,0,0,0,-2,3,1,-5,5,0,-1,3,2,0,0,0,0,-12,51,0,-5,5,32,0,1,-1,-1,1,-1,6,-1
KR_6750284976,420,-1,-44,8,-3,-2,3,1,1,3,4,-1,3,2,-1,1,0,0,0,0,0,1,-286,0,-2,2,0,0,0,1,1,0,1,3,-1
KR_6758521078,420,-2,-60,4,-1,-1,3,2,1,1,2,-3,4,1,2,1,3,0,0,0,0,7,5,-2,-3,5,2,0,-2,1,-1,-1,-1,4,-1
KR_6742305431,420,-1,-91,-16,0,-2,3,1,2,2,4,3,1,4,-4,4,0,1,1,2,-1,-2,7,-4,-3,7,2,0,-1,1,-1,-1,-1,2,-1
KR_6739907596,420,-5,-26,35,-5,-4,6,2,1,1,2,0,2,2,-3,8,5,1,0,1,0,-5,4,0,0,0,-1,0,-1,-1,-1,-1,1,3,-1
KR_6758526953,420,2,-52,-7,4,3,0,3,2,1,3,-4,5,1,1,0,1,2,1,3,0,0,-48,-3,-4,7,24,0,0,-1,0,0,-1,1,-1
KR_6724027713,420,-4,-120,-21,-8,-3,4,1,2,0,2,-6,8,2,-1,2,1,0,3,3,0,1,3,0,-3,3,-5,0,-1,1,0,-1,1,5,-1
KR_6722959094,420,-3,30,-16,-4,-2,2,0,1,0,1,1,4,5,0,2,2,-4,4,0,0,-4,-2,0,-6,6,-3,0,0,-1,-1,0,1,6,-1
KR_6707701804,440,-2,19,-26,-4,2,3,5,-6,9,3,0,4,4,0,5,5,0,1,1,0,-10,3,2,-6,4,-2,0,0,-1,-1,0,-1,2,-1
KR_6743270468,420,-4,-64,-8,-5,-4,4,0,3,4,7,-1,3,2,-2,2,0,-1,1,0,0,-2,15,3,-4,1,0,0,-2,-1,-1,-1,-1,5,-1
KR_6640883887,420,-3,41,-19,-9,2,1,3,-4,5,1,-3,4,1,-3,6,3,-1,1,0,0,-5,-43,2,-3,1,19,0,-1,-1,-1,-1,1,3,-1
KR_6688726097,420,-4,-69,-34,-7,1,1,2,-1,3,2,-2,2,0,-3,5,2,-2,2,0,0,-2,-4,-2,-2,4,-4,0,0,0,-1,0,-1,0,-1
KR_6676343288,420,-2,-112,-24,-7,2,1,3,0,4,4,0,3,3,-8,8,0,-1,2,1,0,-4,-15,0,-7,7,5,0,-1,0,-1,-1,-1,0,-1
KR_6757296211,420,-4,-48,28,-13,-3,5,2,-2,3,1,2,0,2,-10,10,0,0,3,3,1,-12,7,-1,-1,2,0,0,0,1,1,-1,1,3,-1
KR_6760490105,420,-1,3,6,1,1,0,1,-4,5,1,0,3,3,3,0,3,1,1,2,0,-4,6,1,-4,3,1,0,-1,1,1,-1,-1,1,-1
KR_6762368259,420,-3,-35,9,1,-2,3,1,0,2,2,0,1,1,2,2,4,1,1,2,1,2,29,-3,0,3,-11,0,0,1,-1,0,1,6,-1
KR_6759514125,420,1,23,24,2,0,0,0,0,1,1,2,1,3,1,1,2,-1,1,0,0,0,-10,3,-5,2,0,0,0,-1,-1,0,1,1,-1
KR_6741973469,420,1,35,-13,-3,0,0,0,-3,5,2,0,2,2,1,0,1,-1,1,0,0,-4,8,0,-3,3,4,0,0,1,-1,0,1,3,-1
KR_6750115608,420,-8,-105,-3,-14,0,2,2,-7,8,1,-1,2,1,-6,9,3,0,1,1,0,-6,-8,-1,0,1,-2,0,-1,0,-1,-1,-1,0,-1
KR_6707054385,420,0,36,24,3,1,0,1,0,2,2,0,2,2,-1,6,5,3,1,4,0,-4,-10,-3,0,3,2,0,0,1,1,1,1,1,-1
KR_6635299340,420,-4,-82,8,2,0,2,2,-1,1,0,-1,3,2,4,2,6,0,1,1,0,5,0,3,-3,0,-2,0,0,1,1,0,-1,6,-1
KR_6711058014,420,1,-22,4,3,3,1,4,-1,3,2,3,3,6,-3,6,3,1,0,1,1,-2,-1,-3,-3,6,1,0,-1,1,-1,-1,1,5,-1
KR_6750031724,440,-10,-141,-12,-20,-5,6,1,-3,5,2,-9,9,0,-3,5,2,0,1,1,0,-11,-2,-2,0,2,-1,0,-2,-1,-1,-1,1,2,-1
KR_6678789796,420,-2,-19,8,-1,-1,1,0,-3,4,1,-3,4,1,5,1,6,1,1,2,0,5,0,2,-3,1,0,0,0,1,1,0,1,6,-1
KR_6746613136,420,-1,-21,8,-2,4,2,6,-1,1,0,-1,1,0,-8,9,1,4,0,4,1,1,14,-1,-1,2,0,0,1,0,1,1,1,0,-1
KR_6686537448,420,-1,-40,4,-7,1,2,3,0,2,2,-1,2,1,-7,7,0,0,0,0,0,-7,-5,-7,-3,10,-4,0,-2,-1,1,-1,-1,2,-1
KR_6758824168,420,-3,-32,15,-7,-4,6,2,1,0,1,-1,5,4,0,3,3,-3,3,0,-1,-3,-264,0,-4,4,23,0,0,-1,1,0,-1,6,-1
KR_6725204020,420,-1,-35,11,-4,1,4,5,-1,6,5,0,2,2,0,8,8,-4,5,1,-1,-3,-5,-1,0,1,2,0,-3,-1,-1,-1,-1,4,-1
KR_6736788979,420,-3,75,-28,-7,-2,2,0,-4,4,0,-1,1,0,0,1,1,0,1,1,0,-6,79,-3,-1,4,30,0,0,-1,-1,-1,1,2,-1
KR_6733460094,420,-1,-94,-30,-1,3,1,4,0,2,2,-3,3,0,-1,1,0,0,1,1,0,-5,-7,-2,-5,7,-3,0,0,0,0,0,1,0,-1
KR_6732149345,440,2,24,-9,0,2,2,4,2,3,5,-2,5,3,-1,4,3,-1,1,0,0,-10,2,-1,-1,2,2,0,0,1,-1,0,-1,4,-1
KR_6733932274,420,-2,-71,8,-4,1,2,3,-1,2,1,1,0,1,-4,4,0,-1,4,3,0,-8,1,4,-5,1,2,0,-1,-1,-1,-1,-1,3,-1
KR_6750336216,420,-2,6,-20,-2,0,2,2,-4,6,2,0,2,2,1,5,6,1,2,3,-1,-9,0,1,-3,2,-2,0,0,-1,0,1,-1,3,-1
KR_6758941353,420,1,-24,2,-3,0,2,2,-6,6,0,0,2,2,1,3,4,2,1,3,-1,-3,2,-3,0,3,2,0,0,-1,0,0,-1,3,-1
KR_6682653959,420,2,51,2,16,12,0,12,3,2,5,0,2,2,1,0,1,0,1,1,0,13,-34,1,-1,0,4,0,-2,1,-1,-1,1,2,-1
KR_6732909359,420,-3,-49,2,-11,-1,1,0,-2,3,1,0,1,1,-8,9,1,0,1,1,0,-7,75,1,-3,2,0,0,-1,1,-1,-1,1,2,-1
KR_6760457704,420,-2,-18,4,-5,-3,3,0,-3,4,1,1,2,3,1,0,1,-1,1,0,0,-2,12,-2,-2,4,-1,0,-1,1,-1,-1,-1,5,-1
KR_6648809303,420,-3,5,-2,-5,-2,2,0,-3,4,1,-4,4,0,2,3,5,2,1,3,0,-6,-7,-3,0,3,-2,0,0,-1,1,0,-1,6,-1
KR_6721490907,420,-1,75,-24,0,1,1,2,-4,4,0,0,2,2,2,3,5,1,1,2,0,-4,22,1,-6,5,-4,0,2,-1,0,1,-1,3,-1
KR_6741792399,440,-1,57,-3,0,2,1,3,0,1,1,0,1,1,-4,4,0,2,0,2,0,4,-2,-4,-1,5,2,0,0,1,-1,1,1,1,-1
KR_6747237822,440,-1,-97,20,0,-1,4,3,3,0,3,-3,4,1,2,0,2,-1,2,1,0,2,-1,3,-6,3,-2,0,-2,1,-1,-1,-1,6,-1
KR_6754889505,420,-4,-122,-28,-5,2,0,2,-2,3,1,-5,6,1,2,3,5,-2,2,0,1,-1,12,-2,-4,6,-1,0,0,-1,-1,0,-1,1,-1
KR_6742692885,420,-1,49,12,-1,-7,8,1,0,1,1,0,1,1,6,0,6,0,0,0,0,5,-10,1,-3,2,2,0,1,1,1,1,-1,2,-1
KR_6752023279,420,1,-61,17,0,-3,3,0,5,0,5,-4,6,2,4,1,5,-2,4,2,0,1,37,2,-4,2,-19,0,0,1,0,0,-1,1,-1
KR_6727707545,420,-1,-37,36,-6,-5,5,0,2,4,6,1,0,1,-2,2,0,-2,4,2,-1,-2,-6,-2,-2,4,-1,0,1,-1,1,-1,-1,5,-1
KR_6762092035,420,0,41,-8,-4,3,2,5,-2,2,0,1,1,2,-5,6,1,-1,1,0,0,-3,-1,-2,0,2,4,0,0,-1,-1,0,1,4,-1
KR_6673695626,420,-1,-40,20,-5,-3,3,0,-1,2,1,-3,4,1,2,2,4,0,0,0,0,-8,206,-1,-2,3,27,0,0,1,-1,0,-1,1,-1
KR_6706715583,420,-4,-84,4,-8,-1,1,0,-1,3,2,-4,4,0,2,0,2,-4,4,0,0,-2,-46,-2,-1,3,23,0,-3,-1,-1,-1,1,4,-1
KR_6732358144,420,-3,-34,-32,-3,-1,1,0,0,3,3,-1,3,2,0,2,2,-1,3,2,-2,-3,-5,-1,-4,5,0,0,0,-1,-1,0,-1,1,-1
KR_6729418179,420,1,22,0,-2,4,2,6,-1,4,3,1,2,3,-4,6,2,-2,2,0,0,-13,-295,1,-4,3,3,0,2,-1,-1,1,1,3,-1
KR_6703887424,420,-2,32,-3,-5,-1,1,0,1,2,3,-2,3,1,-1,1,0,-2,2,0,0,-2,233,0,-2,2,1,0,0,0,1,-1,1,0,-1
KR_6626944524,420,-5,-88,-10,-8,-4,6,2,1,2,3,-3,5,2,-1,2,1,-1,1,0,1,-5,-7,-1,-2,3,2,0,-4,1,-1,-1,1,4,-1
KR_6712205411,420,-2,45,-28,-6,-1,2,1,-4,4,0,1,3,4,-1,3,2,-1,1,0,0,-6,35,0,-2,2,0,0,1,-1,1,-1,-1,3,-1
KR_6722856035,420,-2,-58,-20,-3,-4,6,2,-1,3,2,-2,3,1,0,5,5,4,0,4,1,5,14,-2,0,2,1,0,-1,-1,-1,-1,1,3,-1
KR_6693021868,420,-3,20,12,-4,-1,1,0,0,2,2,-1,2,1,-1,1,0,-1,1,0,0,-1,-10,-3,0,3,-2,0,0,-1,0,0,1,6,-1
KR_6744238817,420,-1,-97,13,-10,-2,4,2,-6,8,2,1,2,3,-4,5,1,1,0,1,-2,-5,5,-8,0,8,-3,0,1,-1,1,1,-1,5,-1
KR_6697472925,420,-2,54,-24,5,4,1,5,-5,6,1,1,1,2,4,0,4,1,1,2,0,9,0,-1,-1,2,-1,0,1,-1,-1,1,1,3,-1
KR_6762279635,420,-1,-10,17,-9,-1,2,1,-2,2,0,-6,8,2,0,1,1,0,0,0,0,-10,-8,1,-3,2,-1,0,-1,0,1,-1,-1,0,-1
KR_6662860496,420,-4,-75,-40,-8,-2,5,3,0,3,3,-6,6,0,1,2,3,-1,2,1,-1,1,-2,3,-3,0,0,0,-1,-1,-1,-1,-1,2,-1
KR_6716177606,440,-10,-151,-52,-3,-1,2,1,-1,2,1,-8,9,1,8,0,8,-1,1,0,1,7,-7,2,-2,0,-2,0,-4,-1,-1,-1,1,3,-1
KR_6651184659,420,-1,2,8,-11,-4,4,0,-1,2,1,-8,8,0,2,1,3,0,0,0,0,-6,8,6,-6,0,5,0,-1,0,-1,-1,-1,0,-1
KR_6721083895,420,-2,-96,12,-6,-1,1,0,3,1,4,-1,3,2,-8,8,0,1,0,1,-2,-7,-6,-3,-3,6,4,0,-1,-1,-1,-1,-1,6,-1
KR_6652278251,420,0,-11,-7,1,-1,1,0,3,2,5,-4,5,1,2,0,2,1,0,1,0,6,2,3,-6,3,0,0,1,1,0,1,-1,3,-1
KR_6747205874,420,-3,0,-24,-5,2,0,2,-1,3,2,-1,1,0,-2,3,1,-3,3,0,0,-6,-120,3,-4,1,-17,0,-2,-1,1,-1,-1,4,-1
KR_6748005078,420,-3,-14,24,-8,-2,3,1,4,1,5,0,3,3,-1,3,2,-9,9,0,0,-13,9,-1,-4,5,-3,0,0,-1,-1,0,-1,3,-1
KR_6717113952,420,2,-9,0,2,0,8,8,-2,3,1,-2,3,1,4,2,6,2,0,2,2,9,394,2,-3,1,1,0,0,-1,-1,-1,1,4,-1
KR_6757483404,440,-7,-118,-20,-10,-3,3,0,0,4,4,0,0,0,-7,8,1,0,0,0,0,-6,11,0,-2,2,1,0,-1,-1,-1,-1,-1,6,-1
KR_6658438029,420,-2,43,28,-6,-1,2,1,0,1,1,-4,7,3,-2,3,1,1,1,2,0,-3,-9,-1,-2,3,-1,0,0,1,-1,1,1,2,-1
KR_6670021612,420,-1,53,-20,-4,4,0,4,-1,2,1,0,6,6,-1,2,1,-6,6,0,0,-7,142,-1,-1,2,2,0,0,-1,-1,0,1,3,-1
KR_6705525401,420,-2,-89,-18,-3,-1,3,2,-5,5,0,1,0,1,3,0,3,-1,2,1,0,-4,-4,-1,-4,5,-3,0,0,-1,-1,0,-1,6,-1
KR_6739557559,440,-3,-70,8,-8,-6,6,0,-1,3,2,-2,3,1,0,2,2,1,1,2,0,-8,-1,-1,-3,4,0,0,-1,0,-1,-1,-1,0,-1
KR_6700880220,420,2,6,-4,4,-1,2,1,2,1,3,6,0,6,-5,6,1,2,1,3,0,3,6,-4,-1,5,0,0,0,-1,1,1,-1,5,-1
KR_6697614655,420,-4,-102,-10,-4,5,1,6,3,1,4,-11,12,1,0,1,1,-1,1,0,-2,-2,3,-3,-3,6,-3,-1,-4,-1,-1,-1,-1,1,-1
KR_6759648013,440,2,53,-4,1,1,1,2,-3,4,1,3,1,4,-2,5,3,2,0,2,1,5,-5,0,-5,5,-2,0,0,0,-1,0,1,0,-1
KR_6734789335,420,0,-59,-12,2,1,1,2,-1,6,5,-3,6,3,1,0,1,4,0,4,0,2,120,0,-2,2,2,0,-1,1,0,-1,1,6,-1
KR_6762014908,420,4,-8,10,10,0,2,2,0,3,3,-4,6,2,11,2,13,3,1,4,0,11,3,0,-2,2,-1,0,0,1,-1,1,1,5,-1
KR_6750113864,440,-6,-94,-54,-9,-4,4,0,-2,3,1,-2,4,2,-1,5,4,0,0,0,1,2,-5,-3,-2,5,-3,0,0,-1,-1,-1,1,1,-1
KR_6742713129,420,-2,22,-12,-3,2,2,4,-5,6,1,-1,2,1,1,1,2,0,0,0,0,-3,127,2,-3,1,-1,0,0,-1,-1,1,1,2,-1
KR_6683607684,420,-1,-22,-28,-3,-7,8,1,2,2,4,-2,5,3,5,3,8,-1,2,1,0,2,-1,1,-3,2,0,0,-2,-1,0,-1,1,4,-1
KR_6742758415,420,-2,-49,-12,-4,2,0,2,2,7,9,-10,10,0,2,2,4,0,1,1,0,0,439,2,-7,5,-2,0,0,1,1,-1,-1,1,-1
KR_6673266153,420,-1,-28,21,1,5,0,5,1,0,1,3,1,4,-6,7,1,-2,2,0,0,-6,-28,-2,-2,4,-3,0,1,-1,1,1,-1,4,-1
KR_6685163306,420,4,43,12,7,1,0,1,-2,5,3,6,0,6,3,3,6,-1,2,1,2,8,-2,-2,-2,4,0,0,0,1,1,0,1,3,-1
KR_6752633752,420,-3,-38,-26,-2,-1,3,2,3,0,3,0,4,4,-3,5,2,-1,2,1,1,2,2,1,-4,3,-3,0,-2,1,-1,-1,1,6,-1
KR_6630846027,420,-1,74,-13,-5,-2,3,1,0,2,2,-6,6,0,5,1,6,-2,3,1,0,-1,16,1,-2,1,-1,0,1,-1,0,1,-1,2,-1
KR_6731696362,420,-2,51,-4,-7,0,0,0,-4,5,1,3,1,4,-4,6,2,-2,3,1,0,-10,-186,0,-1,1,1,0,0,-1,-1,1,-1,6,-1
KR_6733678446,420,0,-16,16,-3,0,2,2,1,3,4,0,3,3,-4,7,3,0,0,0,0,-10,-25,2,-2,0,-1,0,-1,1,-1,-1,1,4,-1
KR_6704848601,440,2,-7,8,3,1,1,2,-2,6,4,4,0,4,2,1,3,-2,2,0,0,3,3,-1,-1,2,1,0,0,0,1,0,1,0,-1
KR_6764379813,420,1,0,12,3,-1,2,1,-2,6,4,4,0,4,0,1,1,2,0,2,0,6,-327,-1,-2,3,-4,0,0,1,-1,1,1,1,-1
KR_6644251606,420,-10,-115,-24,-11,-5,5,0,-3,5,2,1,1,2,-3,4,1,-1,1,0,-1,-6,4,0,-5,5,-4,0,-2,-1,-1,-1,-1,3,-1
KR_6756723625,440,1,-54,12,-2,1,1,2,5,1,6,-2,2,0,-4,5,1,-2,2,0,0,-4,-213,1,-2,1,0,0,-1,-1,-1,-1,-1,2,-1
KR_6713761162,420,-4,-91,-15,-13,-1,1,0,-3,4,1,-4,4,0,-4,5,1,-1,1,0,0,-11,0,0,-3,3,5,0,0,-1,1,0,-1,4,-1
KR_6748417082,420,-1,9,-8,-9,-2,4,2,-4,6,2,-3,4,1,1,1,2,-1,1,0,0,-6,-1,-2,-1,3,2,0,-1,-1,-1,-1,1,2,-1
KR_6703167283,420,-3,67,-33,-2,-1,4,3,0,1,1,-2,3,1,1,5,6,0,0,0,0,-1,14,2,-2,0,-3,0,0,-1,-1,-1,-1,4,-1
KR_6630250885,420,-5,-6,-29,-13,-6,8,2,-1,1,0,-4,7,3,-1,2,1,-1,3,2,0,-9,8,1,-2,1,1,0,-1,1,-1,-1,-1,3,-1
KR_6760006143,420,1,-12,12,0,1,1,2,-2,2,0,-4,5,1,2,1,3,3,0,3,0,0,-8,0,-4,4,-3,0,-1,-1,-1,-1,1,1,-1
KR_6764076924,420,-3,-38,20,-8,1,1,2,3,0,3,-2,2,0,-5,8,3,-5,5,0,0,-8,-4,-1,-1,2,-4,0,0,1,-1,-1,-1,1,-1
KR_6721735740,420,-4,23,-14,-9,-4,6,2,-5,6,1,4,2,6,-2,2,0,-2,2,0,-1,-8,-1,0,-5,5,-2,0,-1,0,-1,-1,-1,0,-1
KR_6764432075,420,-5,-57,4,-14,-4,5,1,0,0,0,0,4,4,-9,10,1,-1,2,1,0,-15,-3,-3,0,3,0,-1,-5,-1,-1,-1,-1,6,-1
KR_6724285052,420,-3,-76,-8,-11,-2,3,1,0,3,3,-8,10,2,-1,1,0,0,0,0,0,-7,1,2,-3,1,-2,0,0,-1,1,0,-1,4,-1
KR_6649244227,420,0,-5,12,-3,-1,3,2,2,1,3,-2,2,0,-4,8,4,2,1,3,0,1,41,0,-2,2,-17,0,-1,0,-1,-1,-1,0,-1
KR_6745822483,420,-5,-34,0,-11,-6,7,1,-3,5,2,3,1,4,-3,6,3,-2,2,0,1,-7,-7,2,-4,2,0,0,-3,-1,-1,-1,1,5,-1
KR_6750051079,420,0,-37,8,4,3,1,4,3,2,5,-2,4,2,-2,8,6,2,2,4,1,11,-22,-2,-1,3,-2,0,-1,0,0,-1,1,0,-1
KR_6759614427,420,1,11,-4,-5,-1,3,2,-3,3,0,-3,4,1,-2,2,0,4,1,5,0,-7,24,3,-7,4,-31,0,0,-1,1,0,-1,1,-1
KR_6753851909,420,0,-39,12,-4,-2,7,5,-1,5,4,1,2,3,-3,3,0,1,0,1,1,-10,5,0,-2,2,0,0,0,-1,1,-1,1,4,-1
KR_6747734885,420,-4,-24,-16,-12,-5,6,1,-6,7,1,-1,2,1,1,0,1,-1,1,0,0,-5,-25,1,-3,2,-1,0,-2,1,-1,-1,-1,3,-1
KR_6694749006,420,1,37,-24,2,1,1,2,1,0,1,0,2,2,0,2,2,0,1,1,0,2,4,-1,-1,2,-1,0,0,1,-1,0,1,5,-1
KR_6733402196,420,-1,-69,-44,-6,-3,3,0,0,2,2,-3,4,1,2,0,2,-2,2,0,0,-5,6,0,-1,1,1,0,0,-1,1,0,1,4,-1
KR_6713026268,420,2,8,4,-2,2,5,7,-5,6,1,1,2,3,1,2,3,-1,2,1,-1,-5,-3,2,-4,2,-1,0,0,-1,0,0,-1,1,-1
KR_6705738960,440,0,-38,16,-5,0,0,0,0,4,4,-1,1,0,-2,5,3,-2,3,1,0,-8,-6,-2,-1,3,2,0,0,-1,1,1,1,6,-1
KR_6749033129,420,-5,-103,-28,-7,-2,3,1,0,0,0,0,1,1,-5,7,2,0,0,0,0,-5,2,2,-7,5,1,0,-2,1,-1,-1,-1,6,-1
KR_6688093548,420,-3,-39,18,-8,-2,4,2,0,1,1,-5,7,2,-4,6,2,3,1,4,0,-3,-2,-6,-2,8,0,0,0,-1,0,-1,-1,4,-1
KR_6758214671,420,-3,-80,-4,-12,-6,10,4,-5,5,0,-3,4,1,1,0,1,1,0,1,0,-8,-20,-4,-1,5,2,0,-1,1,-1,-1,-1,5,-1
KR_6763730336,420,0,-48,57,-4,2,0,2,-2,2,0,-1,2,1,-3,4,1,0,3,3,0,-1,2,-4,-2,6,5,0,-1,0,-1,-1,-1,0,-1
KR_6689269230,420,-6,-130,13,-13,-1,2,1,-8,12,4,-2,3,1,-2,6,4,0,2,2,0,-12,3,-2,-3,5,1,0,0,1,1,-1,1,1,-1
KR_6754531961,420,-7,-94,-12,-7,-2,6,4,-1,1,0,0,2,2,-4,4,0,0,0,0,0,-10,3,1,-3,2,-4,0,-2,1,1,-1,-1,6,-1
KR_6739570167,420,-1,-74,-20,-7,-8,9,1,0,1,1,-3,4,1,0,5,5,4,0,4,0,4,-3,-1,-5,6,2,0,-3,0,-1,-1,-1,0,-1
KR_6759118235,420,1,67,11,7,0,4,4,3,1,4,0,4,4,3,2,5,1,0,1,0,4,502,-2,0,2,2,0,0,-1,1,0,1,5,-1
KR_6722685166,420,1,-33,-8,1,1,1,2,1,0,1,-2,2,0,1,5,6,0,1,1,0,2,6,1,-3,2,0,0,0,-1,-1,0,-1,2,-1
KR_6718489187,420,-9,-123,-26,-5,-5,5,0,2,2,4,2,1,3,-5,5,0,1,1,2,0,-4,-38,-2,-2,4,13,0,-3,-1,-1,-1,1,3,-1
KR_6736504146,420,3,1,-1,3,3,0,3,-7,7,0,4,1,5,2,0,2,1,1,2,0,0,5,3,-7,4,-4,0,1,-1,1,1,1,6,-1
KR_6759679939,420,-5,-81,-26,-5,0,2,2,-2,3,1,0,2,2,-2,4,2,-1,1,0,0,-10,7,-2,-2,4,-2,0,0,-1,1,0,-1,5,-1
KR_6746838753,420,-3,-52,-51,-5,2,4,6,-3,3,0,-7,8,1,4,0,4,-1,2,1,0,0,-15,-5,0,5,0,0,-3,-1,-1,-1,1,5,-1
KR_6746704840,420,5,62,32,8,1,2,3,0,0,0,4,1,5,0,3,3,3,0,3,0,1,228,-5,0,5,2,0,0,1,1,-1,1,5,-1
KR_6691644096,420,2,4,5,-1,0,0,0,0,3,3,-2,5,3,-1,1,0,2,0,2,0,2,36,2,-4,2,1,0,1,0,1,1,1,0,-1
KR_6738391023,420,-1,17,-31,0,4,1,5,-1,2,1,-1,2,1,-3,4,1,1,1,2,0,-3,2,1,-3,2,2,0,0,1,-1,-1,-1,5,-1
KR_6723507376,420,1,30,16,2,1,0,1,-1,3,2,0,0,0,3,4,7,-1,4,3,0,7,0,2,-3,1,0,0,-1,1,-1,-1,-1,1,-1
KR_6758217450,420,-2,30,-16,-3,-2,2,0,1,0,1,-1,1,0,-3,4,1,2,2,4,1,-2,-38,-3,-1,4,33,0,-1,-1,-1,-1,1,3,-1
KR_6724330646,420,-1,-43,4,-4,-2,2,0,1,1,2,-3,5,2,0,2,2,0,0,0,-1,-1,-7,2,-3,1,-1,0,-2,-1,-1,-1,-1,4,-1
KR_6686985998,420,-4,-81,16,-8,0,0,0,-1,2,1,0,3,3,-4,5,1,-3,3,0,0,-7,-4,0,-2,2,2,0,-1,-1,-1,-1,-1,6,-1
KR_6734621485,440,-4,-125,-19,-14,1,6,7,-3,4,1,-1,3,2,3,1,4,-14,14,0,0,0,-3,-3,0,3,0,0,-3,-1,-1,-1,-1,5,-1
KR_6704111996,420,0,-58,4,4,-3,4,1,-2,4,2,3,0,3,5,1,6,1,1,2,0,6,-50,1,-1,0,25,0,-2,-1,-1,-1,-1,5,-1
KR_6742754018,420,0,-36,-2,0,6,0,6,1,1,2,-2,2,0,-5,5,0,0,1,1,0,0,-121,-1,-1,2,0,0,-1,-1,1,1,-1,1,-1
KR_6661757069,420,2,15,32,1,-3,4,1,6,3,9,2,0,2,-3,4,1,-1,1,0,0,-4,-96,4,-5,1,-14,0,-1,1,-1,-1,-1,3,-1
KR_6728399129,420,0,-6,-8,0,-5,6,1,1,2,3,-1,3,2,6,0,6,-1,1,0,0,8,10,7,-7,0,2,0,1,1,-1,-1,1,1,-1
KR_6712121554,420,4,45,25,8,6,0,6,0,3,3,6,2,8,-2,6,4,-2,3,1,0,0,24,-3,-2,5,0,0,1,-1,1,-1,-1,1,-1
KR_6683121636,420,0,2,-4,4,-2,2,0,1,2,3,1,2,3,8,3,11,-4,4,0,1,3,234,-1,-1,2,1,0,1,1,0,1,1,2,-1
KR_6742710658,420,-6,-38,-4,-16,1,1,2,0,2,2,-2,2,0,-11,12,1,-4,4,0,-3,-24,-14,0,-3,3,-4,0,-1,-1,0,-1,-1,6,-1
KR_6704622190,420,-3,-55,-11,-9,-3,3,0,-6,6,0,0,2,2,1,1,2,-1,2,1,0,-13,0,0,-1,1,2,0,-1,1,-1,-1,-1,3,-1
KR_6749292976,420,1,5,0,-2,0,2,2,3,0,3,-4,4,0,-6,6,0,5,2,7,0,-6,-99,0,-2,2,2,0,-1,-1,-1,-1,-1,1,-1
KR_6681163586,420,1,59,35,-1,-2,3,1,2,0,2,1,0,1,1,0,1,-3,3,0,0,0,-5,-3,-1,4,0,0,0,-1,0,1,-1,5,-1
KR_6754310197,420,-2,11,-40,1,0,0,0,4,0,4,-2,4,2,3,1,4,-4,4,0,0,-1,-9,-2,-1,3,2,0,0,-1,-1,-1,1,6,-1
KR_6740017038,420,-3,-53,-22,-3,-2,2,0,3,2,5,-2,2,0,-3,6,3,1,0,1,0,4,-18,2,-4,2,1,0,-1,1,-1,-1,-1,4,-1
KR_6764176599,420,3,-36,12,9,3,1,4,2,1,3,0,3,3,7,0,7,-3,3,0,1,5,-34,3,-3,0,15,0,0,1,1,0,1,5,-1
KR_6722352216,420,0,47,4,-8,-1,5,4,1,2,3,-5,6,1,-2,3,1,-1,3,2,0,1,13,1,-2,1,2,0,1,-1,0,1,-1,5,-1
KR_6695820534,420,-3,-4,-75,-7,-4,6,2,0,2,2,-5,5,0,-2,3,1,4,3,7,-1,-3,-5,0,-1,1,0,0,-1,-1,-1,-1,-1,2,-1
KR_6753746141,420,-2,-10,4,-5,3,3,6,2,0,2,-7,7,0,-2,3,1,-1,3,2,0,0,-1,-1,-2,3,-3,0,-2,0,-1,-1,-1,0,-1
KR_6645692186,420,0,-49,4,6,4,3,7,0,1,1,1,2,3,0,1,1,1,0,1,0,3,-7,-3,-2,5,1,0,0,1,0,0,1,6,-1
KR_6762861223,420,0,-19,-7,-1,-2,4,2,1,5,6,0,1,1,-3,5,2,3,0,3,0,2,-296,-5,-1,6,2,0,-1,1,0,-1,-1,6,-1
KR_6723231928,420,0,7,2,0,-4,5,1,0,3,3,0,2,2,5,3,8,-1,2,1,-3,1,5,2,-3,1,-1,0,0,-1,-1,-1,-1,6,-1
KR_6728636310,420,-1,-15,-13,1,0,1,1,-3,7,4,1,2,3,-2,6,4,5,0,5,1,8,-2,3,-5,2,1,0,0,1,-1,0,1,3,-1
KR_6697300523,420,-1,-40,16,0,3,1,4,-2,2,0,2,2,4,-3,3,0,0,1,1,1,0,309,-3,0,3,1,0,0,1,-1,0,1,3,-1
KR_6762468367,440,-4,-50,-20,-2,-4,4,0,0,2,2,1,4,5,1,4,5,0,1,1,0,1,-25,0,0,0,-2,0,0,1,0,1,-1,1,-1
KR_6755370559,420,2,19,40,-1,4,1,5,1,1,2,-1,3,2,-1,6,5,-4,6,2,0,-10,-10,-2,-1,3,1,0,0,0,1,1,1,0,-1
KR_6749775133,420,-1,-30,34,-1,-2,4,2,2,0,2,0,3,3,-3,5,2,2,1,3,0,0,23,-5,0,5,-3,0,-1,-1,-1,-1,1,3,-1
KR_6763542935,420,1,-29,0,-1,-1,2,1,0,2,2,-3,5,2,1,3,4,2,3,5,0,-2,-7,2,-3,1,1,0,0,-1,-1,-1,1,6,-1
KR_6750869890,440,-1,-60,-12,0,1,2,3,-1,6,5,-3,5,2,-3,6,3,6,1,7,0,-4,-8,1,-3,2,-2,0,0,-1,1,-1,1,3,-1
KR_6697118360,420,-10,-124,-14,-23,-4,5,1,-1,3,2,-11,12,1,-2,3,1,-5,5,0,0,-12,235,-1,-1,2,1,0,-1,0,-1,-1,-1,0,-1
KR_6738218337,420,0,22,24,-1,-1,2,1,3,1,4,-1,2,1,-2,2,0,0,2,2,0,3,-109,2,-3,1,0,0,-1,-1,-1,-1,1,4,-1
KR_6742087240,420,-6,-127,-12,-15,-1,3,2,-1,1,0,-9,10,1,-5,5,0,1,0,1,0,-8,-2,-4,-1,5,-1,0,0,1,-1,-1,-1,1,-1
KR_6754391772,440,-2,-20,-13,-9,-2,2,0,-5,5,0,-5,5,0,1,1,2,2,1,3,0,-4,7,-5,-4,9,1,0,1,-1,-1,1,-1,6,-1
KR_6699934131,420,-1,1,-4,-5,-3,3,0,2,1,3,1,0,1,-6,7,1,1,0,1,-2,-8,162,-2,-1,3,2,0,0,-1,-1,0,-1,1,-1
KR_6733548539,420,3,20,12,15,0,2,2,0,3,3,3,3,6,10,0,10,2,1,3,0,8,-14,0,-2,2,0,0,1,-1,-1,1,-1,1,-1
KR_6752388183,420,-5,-6,-48,-6,-2,4,2,0,4,4,-2,4,2,-2,3,1,0,2,2,-1,-8,4,2,-2,0,-3,0,-2,-1,-1,-1,-1,4,-1
KR_6662270620,420,-1,-51,-13,-6,0,2,2,3,1,4,1,1,2,-4,4,0,-6,6,0,0,-9,346,-2,-1,3,0,0,-1,-1,1,-1,1,3,-1
KR_6738681744,420,-7,-88,-40,-15,-14,15,1,0,2,2,3,0,3,-3,3,0,-1,1,0,0,-12,-323,-1,-1,2,-2,0,-4,-1,-1,-1,-1,3,-1
KR_6756812632,440,-1,2,10,-2,-5,5,0,1,2,3,3,2,5,-1,1,0,0,0,0,0,2,-1,3,-5,2,6,0,-1,1,0,-1,1,2,-1
KR_6754125487,420,-2,-103,7,-3,-3,4,1,6,1,7,-6,6,0,-1,1,0,1,0,1,0,6,-9,-3,-1,4,-2,0,-1,-1,-1,-1,-1,5,-1
KR_6755291491,420,6,85,24,14,8,0,8,2,4,6,0,0,0,4,2,6,0,1,1,0,2,-4,0,-1,1,1,0,1,1,1,1,1,2,-1
KR_6732586497,420,-1,-64,-15,-4,1,3,4,-4,6,2,0,4,4,-3,4,1,2,1,3,0,-1,8,-2,0,2,-1,0,-2,-1,0,-1,1,4,-1
KR_6741403545,420,2,56,24,5,1,1,2,2,0,2,3,3,6,-2,7,5,1,0,1,0,-7,-4,0,-2,2,1,0,0,-1,1,1,1,5,-1
KR_6740320671,440,-3,-55,-4,-7,0,3,3,0,2,2,-7,10,3,-3,5,2,3,0,3,-1,0,15,0,-2,2,3,0,0,-1,1,-1,-1,6,-1
KR_6757835774,420,-3,-77,-12,-1,1,1,2,-1,3,2,-2,2,0,0,3,3,1,0,1,0,0,-49,-5,-1,6,39,0,-2,-1,-1,-1,-1,3,-1
KR_6751885172,420,0,29,2,-1,4,0,4,4,1,5,-1,3,2,-6,8,2,-2,6,4,0,-4,3,-3,0,3,0,0,0,1,-1,1,-1,4,-1
KR_6750498812,420,2,-68,12,2,-2,4,2,5,1,6,-4,5,1,2,0,2,1,0,1,0,7,-3,1,-4,3,-2,0,-1,1,1,-1,1,1,-1
KR_6759324786,420,2,44,4,6,1,1,2,-1,1,0,0,1,1,4,1,5,2,2,4,0,4,4,-1,-2,3,0,0,0,1,-1,-1,1,4,-1
KR_6747626857,420,2,8,0,6,2,2,4,3,5,8,4,2,6,-2,2,0,-1,2,1,0,1,-16,-10,0,10,4,0,0,-1,1,0,-1,3,-1
KR_6763535662,420,-2,-5,32,-1,0,0,0,1,1,2,-2,5,3,1,2,3,-1,1,0,0,2,-11,3,-5,2,-7,0,0,1,-1,0,-1,3,-1
KR_6635698474,420,0,-5,-24,-6,-3,4,1,-1,2,1,0,1,1,-5,5,0,3,0,3,0,-6,17,4,-6,2,3,0,0,-1,-1,0,-1,5,-1
KR_6751276198,420,-5,-40,-8,-9,0,2,2,0,0,0,-5,6,1,-1,4,3,-3,3,0,0,-2,12,4,-4,0,0,0,-1,1,0,-1,-1,5,-1
KR_6650373676,440,1,-15,19,0,1,0,1,2,0,2,-3,3,0,1,1,2,-1,1,0,0,4,-7,-3,-2,5,0,0,-1,1,-1,-1,-1,3,-1
KR_6756672372,420,0,-1,9,-6,0,0,0,-2,4,2,-2,4,2,-2,2,0,0,1,1,0,-10,9,-2,0,2,-1,0,-1,-1,0,-1,-1,4,-1
KR_6736752497,420,-3,-76,-16,-7,-2,2,0,-2,4,2,2,0,2,0,2,2,-5,5,0,0,-4,-28,0,-3,3,26,0,-2,-1,-1,-1,-1,4,-1
KR_6754175945,420,-2,26,4,-5,-1,1,0,0,1,1,-2,2,0,-2,4,2,0,1,1,0,-3,-8,3,-5,2,0,0,1,0,1,1,-1,0,-1
KR_6761353600,420,0,-10,-8,7,0,3,3,6,0,6,4,1,5,-1,2,1,-2,2,0,0,4,-48,4,-6,2,23,0,0,1,0,0,-1,2,-1
KR_6733303864,420,-1,10,-16,1,3,4,7,-3,4,1,-2,3,1,3,2,5,0,1,1,0,-2,-37,-1,-1,2,0,0,1,-1,1,1,1,4,-1
KR_6645297913,420,-2,-9,-36,-6,3,2,5,-4,4,0,-1,2,1,-2,2,0,-2,5,3,0,-5,-5,-1,-1,2,-1,0,0,0,-1,0,1,0,-1
KR_6647782908,420,1,-3,4,1,-2,3,1,4,1,5,-3,3,0,0,2,2,2,0,2,0,1,11,-3,0,3,-2,0,0,-1,1,1,-1,3,-1
KR_6749805096,420,1,60,-7,-4,1,0,1,-5,6,1,0,1,1,1,3,4,-1,2,1,0,-8,-300,-2,-2,4,-7,0,0,-1,-1,0,-1,1,-1
KR_6754127351,420,2,-20,40,1,3,0,3,0,2,2,-1,5,4,2,2,4,-3,3,0,-1,-3,13,3,-5,2,-5,0,-1,-1,-1,-1,-1,2,-1
KR_6707301526,420,-3,-47,-11,-9,1,0,1,-4,6,2,-2,3,1,-4,5,1,0,2,2,0,-12,-2,0,-3,3,1,0,0,1,1,0,-1,2,-1
KR_6763912486,420,0,-79,-8,-2,-1,1,0,-3,6,3,1,2,3,1,2,3,0,2,2,0,1,-3,-1,-2,3,-2,0,-1,-1,-1,-1,-1,6,-1
KR_6750360204,420,0,-64,8,0,0,5,5,1,2,3,0,1,1,-2,3,1,1,0,1,-1,-4,3,-1,-1,2,1,0,0,-1,1,-1,-1,2,-1
KR_6734581310,440,-2,-74,8,-4,-1,3,2,2,0,2,0,0,0,0,1,1,-5,6,1,-1,-2,4,5,-7,2,-2,0,-1,1,1,-1,-1,5,-1
KR_6726222727,420,-3,-91,20,-4,0,1,1,4,1,5,-1,3,2,-5,5,0,-2,2,0,0,-2,5,-2,-1,3,-4,0,-2,-1,1,-1,1,2,-1
KR_6703435548,420,-5,4,-9,-6,-2,4,2,-2,5,3,-2,4,2,0,4,4,0,1,1,1,-2,-3,1,-4,3,-1,0,-2,-1,-1,-1,1,2,-1
KR_6763389496,440,-2,-82,14,-8,-3,4,1,0,2,2,1,0,1,-5,5,0,-1,1,0,0,-8,-363,-3,-1,4,-3,0,0,-1,-1,-1,-1,1,-1
KR_6684809630,420,-1,-22,15,1,-2,4,2,-1,3,2,3,2,5,1,1,2,0,0,0,0,-4,18,-1,-2,3,-4,0,0,-1,1,0,1,5,-1
KR_6755186131,420,0,-13,-7,5,0,1,1,0,2,2,2,0,2,2,2,4,1,0,1,0,5,-7,-7,-2,9,0,0,0,1,1,0,1,4,-1
KR_6748748385,420,-3,-57,-17,-1,5,2,7,1,2,3,-1,3,2,-6,6,0,0,0,0,0,-7,2,1,-4,3,-1,0,-1,-1,-1,-1,1,5,-1
KR_6723660487,420,-3,-33,-2,-11,-4,4,0,-1,5,4,-4,4,0,-3,4,1,1,0,1,0,-9,-133,0,-5,5,-2,0,0,-1,-1,0,-1,5,-1
KR_6640022794,420,1,13,-36,1,-1,1,0,0,2,2,-1,2,1,3,1,4,0,1,1,0,0,345,-2,-2,4,1,0,1,-1,-1,1,1,1,-1
KR_6758928243,420,-6,18,-26,-14,1,1,2,-4,7,3,-4,5,1,-5,6,1,-2,2,0,0,-11,7,-4,-2,6,0,0,-1,0,-1,-1,-1,0,-1
KR_6741874586,420,0,79,-2,1,5,0,5,-5,6,1,2,2,4,0,2,2,-1,1,0,0,-3,40,7,-8,1,-5,0,1,1,1,1,1,2,-1
KR_6694769618,420,-1,-71,4,-2,-1,2,1,-2,7,5,1,0,1,1,5,6,-1,1,0,0,-1,-58,-4,-3,7,15,0,-1,1,0,-1,1,5,-1
KR_6678455207,420,-4,-92,-12,-10,-3,7,4,2,0,2,-5,6,1,-4,6,2,0,2,2,-1,-4,95,-5,0,5,-2,0,-1,-1,-1,-1,-1,3,-1
KR_6704983049,420,-1,-12,3,-10,-3,4,1,-4,4,0,-1,2,1,-1,3,2,-1,1,0,0,-9,1,2,-3,1,0,0,0,0,1,0,-1,0,-1
KR_6751568506,420,-2,-54,32,-8,-6,7,1,0,3,3,0,2,2,-2,4,2,0,1,1,-1,-8,8,2,-4,2,0,0,-2,1,1,-1,-1,1,-1
KR_6763402486,420,1,26,17,2,4,0,4,1,1,2,-2,3,1,-3,3,0,2,0,2,0,2,-16,2,-3,1,5,0,2,1,1,1,-1,2,-1
KR_6753142218,420,-4,-98,-20,-6,3,1,4,-3,5,2,-4,5,1,-1,2,1,-1,3,2,0,-2,3,-3,0,3,-2,0,-1,-1,-1,-1,1,5,-1
KR_6729148914,420,-2,0,4,-2,2,1,3,-1,2,1,0,0,0,0,1,1,-3,3,0,0,-1,-13,-3,0,3,0,0,0,-1,0,-1,-1,4,-1
KR_6689919838,440,-3,-32,-4,-5,-7,7,0,0,3,3,-3,4,1,5,1,6,0,0,0,0,-2,4,0,-4,4,-1,0,0,-1,-1,-1,-1,6,-1
KR_6671020146,420,-2,3,4,-9,1,0,1,-4,5,1,-1,1,0,-5,6,1,0,1,1,-1,-9,-194,-4,-3,7,-2,0,-1,0,-1,-1,-1,0,-1
KR_6718100260,440,-5,-71,-20,-8,-2,3,1,0,2,2,0,5,5,-6,7,1,0,0,0,0,-7,-13,-3,-1,4,2,0,0,0,-1,-1,1,0,-1
KR_6761065737,420,-3,-48,-30,-8,-2,3,1,-2,5,3,-6,6,0,0,0,0,2,0,2,0,-3,10,-2,-1,3,0,0,-1,-1,-1,-1,-1,1,-1
KR_6723386358,420,-3,-87,-8,-6,-3,4,1,0,1,1,-3,4,1,2,0,2,-2,2,0,0,-3,-18,2,-3,1,0,0,0,1,-1,-1,-1,3,-1
KR_6711335794,440,-7,-53,-8,-12,-1,2,1,0,2,2,-3,4,1,-7,10,3,-1,3,2,0,-12,9,-1,-1,2,-2,0,0,1,-1,-1,-1,6,-1
KR_6711496978,420,-5,43,3,-10,-2,3,1,0,4,4,2,2,4,-7,8,1,-3,3,0,-1,-12,1,-3,-1,4,-1,0,0,-1,1,1,1,1,-1
KR_6745090965,420,-2,-19,-26,-2,-4,4,0,1,1,2,1,1,2,0,0,0,0,1,1,0,-3,7,0,-1,1,0,0,1,-1,0,1,-1,6,-1
KR_6741423730,420,-2,25,-63,-2,1,1,2,-5,8,3,3,0,3,-1,3,2,0,1,1,0,-6,163,-4,-2,6,-2,0,0,-1,0,0,-1,6,-1
KR_6696402620,420,1,-22,0,2,4,2,6,-1,2,1,-2,4,2,1,2,3,0,2,2,0,6,4,3,-5,2,-2,0,0,0,1,0,-1,0,-1
KR_6730884726,420,3,51,36,1,1,0,1,0,4,4,6,0,6,-7,9,2,1,0,1,0,1,12,3,-5,2,0,0,0,1,0,0,-1,2,-1
KR_6684271045,420,-3,-43,-8,-5,-3,4,1,0,2,2,2,4,6,-3,6,3,-1,1,0,-1,-6,-2,1,-3,2,0,0,-2,-1,0,-1,-1,1,-1
KR_6725551600,420,-3,-12,-8,-2,1,0,1,-1,3,2,-7,8,1,5,0,5,0,2,2,1,2,2,-4,-1,5,-2,0,0,1,-1,0,1,4,-1
KR_6760579724,420,-4,-72,-32,-9,-1,3,2,0,2,2,-3,6,3,-5,7,2,0,1,1,0,-10,-13,-4,0,4,1,0,0,-1,1,1,-1,4,-1
KR_6763678259,420,-2,-128,-25,-2,1,1,2,2,1,3,-3,4,1,-1,1,0,-1,2,1,0,-1,-12,2,-3,1,0,0,-2,-1,1,-1,-1,5,-1
KR_6626027129,420,3,51,31,3,0,2,2,2,1,3,2,2,4,0,1,1,-1,1,0,0,1,-33,-3,-2,5,1,0,0,0,-1,-1,1,0,-1
KR_6737653726,420,-2,-27,-5,-1,-5,5,0,1,0,1,0,2,2,-1,2,1,4,2,6,1,-1,0,5,-7,2,0,0,-1,-1,-1,-1,1,1,-1
KR_6735717023,440,-6,-4,16,-9,-3,4,1,-5,6,1,2,2,4,-2,3,1,-1,2,1,0,-9,0,0,-4,4,-2,0,0,1,0,0,-1,6,-1
KR_6762823688,420,4,115,-2,16,5,1,6,-4,6,2,10,0,10,3,1,4,2,0,2,1,8,11,1,-2,1,-1,0,2,0,1,1,1,0,-1
KR_6713132009,440,1,-6,8,-1,-1,1,0,1,2,3,2,1,3,-2,4,2,-1,1,0,0,4,27,3,-5,2,-3,0,0,1,-1,0,-1,1,-1
KR_6691615263,420,-1,35,-8,-9,1,0,1,-3,6,3,-1,1,0,-3,4,1,-3,3,0,0,-8,27,-1,-3,4,-28,0,0,-1,1,-1,-1,3,-1
KR_6741416863,420,-1,25,5,-3,-5,6,1,3,0,3,1,2,3,-2,3,1,0,0,0,0,-1,16,-2,-1,3,-1,0,-2,-1,0,-1,-1,4,-1
KR_6757267225,420,-4,-75,12,-6,-5,6,1,-2,2,0,0,1,1,-1,4,3,2,0,2,0,2,-6,-1,-4,5,1,0,-2,-1,-1,-1,1,3,-1
KR_6752048183,420,2,-52,12,8,-2,3,1,4,1,5,-1,2,1,4,2,6,3,0,3,1,14,-24,5,-5,0,-1,0,2,-1,1,1,1,6,-1
KR_6743271381,420,-1,10,8,-2,-5,5,0,0,3,3,2,0,2,2,1,3,-1,1,0,0,1,6,-1,-3,4,0,0,-1,1,0,-1,-1,5,-1
KR_6665568319,420,-2,-3,-8,-3,2,1,3,1,0,1,-2,3,1,-4,4,0,0,3,3,-1,1,-237,3,-5,2,1,0,-1,-1,1,-1,-1,1,-1
KR_6725474751,420,3,27,-8,5,0,2,2,3,2,5,3,1,4,-3,4,1,2,0,2,0,4,1,-4,-1,5,-2,0,0,1,-1,-1,-1,1,-1
KR_6755552155,440,-3,13,19,-10,-5,6,1,-1,4,3,-3,4,1,-1,3,2,0,0,0,0,-5,1,-3,-2,5,-1,0,0,-1,-1,0,-1,5,-1
KR_6714390077,440,-7,-98,-44,-8,-4,5,1,-3,4,1,0,6,6,-3,4,1,2,2,4,-1,0,24,3,-5,2,-14,0,-2,-1,-1,-1,1,5,-1
KR_6728367917,420,-2,-5,13,-3,-1,2,1,0,1,1,-4,4,0,-2,2,0,4,1,5,-1,-2,30,2,-2,0,-19,0,-1,0,0,-1,-1,0,-1
KR_6685015506,420,1,29,-32,-7,0,1,1,-4,4,0,-5,5,0,4,0,4,-2,2,0,0,-5,293,5,-6,1,0,0,0,1,-1,1,1,1,-1
KR_6644788827,420,-5,-32,-24,-7,1,0,1,2,3,5,-5,9,4,-3,4,1,-2,3,1,0,-9,378,7,-9,2,-2,0,-1,-1,-1,-1,1,3,-1
KR_6706040502,420,2,11,-20,7,-4,4,0,4,2,6,-1,2,1,7,1,8,1,0,1,0,16,-42,4,-5,1,27,0,0,1,1,-1,1,3,-1
KR_6714997801,420,2,34,-9,3,2,1,3,1,1,2,-1,1,0,2,2,4,-1,1,0,0,0,-9,0,-2,2,3,0,1,-1,-1,1,1,3,-1
KR_6748013975,420,-2,-6,0,-4,4,0,4,-1,2,1,-8,9,1,0,1,1,1,0,1,0,-7,-3,3,-4,1,0,0,0,1,-1,0,1,5,-1
KR_6749842246,440,0,-41,-7,-1,1,1,2,2,0,2,2,2,4,-6,7,1,0,1,1,1,1,5,-2,-1,3,0,0,0,-1,1,0,1,6,-1
KR_6700279658,420,0,-2,4,1,1,3,4,-1,2,1,-2,3,1,1,1,2,2,0,2,0,5,10,-3,-2,5,2,0,0,1,0,0,1,3,-1
KR_6689045465,420,1,15,16,-2,1,4,5,-2,4,2,-1,1,0,0,0,0,0,1,1,0,-5,-18,1,-2,1,-1,0,1,0,0,1,-1,0,-1
KR_6749454642,420,-2,3,-36,-7,0,4,4,-2,4,2,0,1,1,-2,4,2,-3,3,0,0,-10,0,1,-4,3,-1,0,-1,1,-1,-1,-1,3,-1
KR_6738492670,420,-3,-77,-8,-9,2,3,5,-6,6,0,-2,2,0,-2,3,1,-1,2,1,0,-9,26,-7,-3,10,-1,0,0,-1,1,-1,-1,6,-1
KR_6696570260,420,-6,-163,-16,-17,0,2,2,-4,5,1,1,2,3,-11,11,0,-3,3,0,0,-13,-26,-3,-3,6,-3,0,-3,-1,-1,-1,-1,1,-1
KR_6725746223,420,2,-35,-3,-1,0,0,0,-1,1,0,3,0,3,-3,3,0,0,1,1,0,-2,-4,-2,-1,3,1,0,0,-1,1,-1,-1,4,-1
KR_6720504121,420,-3,-6,-31,-1,2,4,6,-3,3,0,0,1,1,-1,3,2,1,2,3,0,-4,1,1,-1,0,0,0,-1,-1,1,-1,1,2,-1
KR_6657966994,420,2,-23,8,1,0,1,1,0,1,1,3,1,4,0,1,1,-2,2,0,0,-2,3,3,-4,1,1,0,0,-1,0,0,1,5,-1
KR_6690129246,420,3,50,8,7,2,1,3,0,0,0,0,3,3,2,1,3,3,0,3,0,6,2,0,-3,3,0,0,0,-1,1,1,1,3,-1
KR_6678305339,420,2,-3,5,-2,0,2,2,0,3,3,0,2,2,-4,4,0,2,0,2,-1,1,23,-1,-3,4,-1,0,1,1,-1,1,-1,1,-1
KR_6753710979,420,0,0,28,1,1,1,2,0,2,2,2,3,5,-3,4,1,1,0,1,0,-4,7,0,-1,1,-3,0,2,1,1,1,-1,2,-1
KR_6731309816,420,2,4,11,5,1,0,1,2,2,4,0,4,4,-1,3,2,3,0,3,0,8,-287,3,-5,2,2,0,-1,1,-1,-1,1,3,-1
KR_6627131235,420,-1,9,-6,-4,-6,6,0,3,0,3,6,2,8,-5,5,0,-2,3,1,0,-5,-12,-5,0,5,-2,0,-1,0,1,-1,-1,0,-1
KR_6686669440,420,1,91,-32,-3,0,3,3,-5,6,1,3,1,4,-1,2,1,0,2,2,0,-3,2,-2,-1,3,-1,0,0,-1,-1,1,1,5,-1
KR_6685617065,420,-4,-37,-107,-3,-4,5,1,0,5,5,3,1,4,1,1,2,-3,3,0,-1,11,-5,-3,0,3,2,0,-2,0,-1,-1,-1,0,-1
KR_6655838049,420,-1,-66,-15,-6,4,0,4,-3,4,1,-5,6,1,1,1,2,-3,3,0,0,-5,-22,5,-8,3,-1,0,-1,-1,1,-1,-1,2,-1
KR_6642246874,420,-5,-83,-11,-9,-2,3,1,2,3,5,-3,3,0,-5,6,1,-1,1,0,0,-10,-1,-3,-1,4,2,0,0,1,-1,-1,-1,6,-1
KR_6730301186,420,1,-30,24,3,-2,2,0,4,5,9,1,0,1,1,0,1,-1,1,0,0,5,10,0,-2,2,1,0,0,-1,-1,-1,1,6,-1
KR_6655640167,420,-1,-9,4,4,0,1,1,-11,11,0,8,0,8,3,1,4,4,0,4,1,4,3,-4,-5,9,3,0,0,-1,1,0,1,4,-1
KR_6756205758,420,-5,-92,-38,-6,-1,4,3,-2,2,0,0,0,0,-2,2,0,-1,3,2,0,-3,-9,0,-3,3,-1,0,-1,-1,0,-1,-1,6,-1
KR_6698703637,420,-2,-21,-12,-4,2,1,3,1,4,5,-5,6,1,-2,4,2,0,3,3,0,-4,-246,4,-5,1,13,0,-2,1,0,-1,-1,2,-1
KR_6728555029,420,-2,-10,0,-4,1,2,3,-1,2,1,-1,3,2,-3,3,0,0,0,0,0,4,-10,-1,-2,3,2,0,-1,-1,-1,-1,-1,5,-1
KR_6729284423,420,-3,-22,-9,-17,0,1,1,-3,4,1,0,3,3,-13,16,3,-1,1,0,-2,-22,-10,-2,0,2,-3,0,-1,-1,1,-1,-1,2,-1
KR_6647174747,420,-6,-38,-2,0,3,1,4,-2,4,2,1,3,4,-1,5,4,-1,2,1,0,5,0,2,-5,3,2,0,-1,-1,1,-1,1,3,-1
KR_6755737382,420,-4,-25,8,-7,0,2,2,0,1,1,-7,8,1,0,2,2,0,0,0,0,-8,-12,-1,-2,3,0,0,-2,1,1,1,-1,1,-1
KR_6748045817,420,4,37,12,10,1,2,3,1,2,3,0,1,1,4,1,5,4,0,4,0,13,277,-1,-2,3,20,0,2,-1,1,1,1,2,-1
KR_6758611731,440,-2,29,-24,-9,-3,3,0,-6,6,0,1,2,3,-1,3,2,0,0,0,0,-8,-9,-5,-1,6,3,0,-1,-1,-1,-1,-1,3,-1
KR_6733397702,440,-1,-84,-19,-3,-3,3,0,-3,3,0,0,2,2,3,1,4,0,1,1,0,-1,2,-2,-3,5,-1,0,-2,-1,-1,-1,-1,1,-1
KR_6758245967,440,-2,-21,4,-1,-2,5,3,-2,7,5,3,1,4,2,2,4,-2,4,2,-1,-5,8,1,-4,3,-1,0,0,1,-1,0,-1,3,-1
KR_6686235780,420,-6,-46,-52,-11,-5,6,1,-1,2,1,-3,3,0,-2,5,3,0,0,0,0,-5,5,0,-1,1,-1,0,-1,0,-1,-1,-1,0,-1
KR_6718090980,420,-2,-11,20,-7,1,2,3,0,1,1,-9,9,0,3,2,5,-2,2,0,-1,3,-19,0,-2,2,0,0,-2,-1,0,-1,-1,4,-1
KR_6671344267,420,0,-131,2,1,-2,4,2,3,1,4,-4,5,1,4,1,5,0,3,3,0,10,23,4,-6,2,5,0,0,1,1,-1,1,5,-1
KR_6744524623,420,-2,-64,28,-8,-4,4,0,0,0,0,-9,9,0,2,1,3,3,1,4,-1,-11,-24,0,-2,2,0,0,-2,1,-1,-1,-1,3,-1
KR_6630130194,420,-4,-69,2,-13,-3,4,1,-3,3,0,-5,6,1,0,1,1,-2,2,0,0,-8,-7,-5,0,5,2,0,0,1,1,1,-1,2,-1
KR_6731703590,420,-4,3,-21,-5,0,4,4,0,1,1,-2,4,2,-1,2,1,-2,2,0,0,-3,-131,2,-5,3,-5,0,-1,0,0,-1,-1,0,-1
KR_6729296990,420,-4,18,-53,-9,1,0,1,-2,4,2,-3,3,0,-6,8,2,1,1,2,-1,-15,-5,0,-2,2,-2,0,0,-1,0,0,-1,4,-1
KR_6758951504,420,-1,-49,-16,-4,-1,3,2,1,0,1,-5,7,2,0,0,0,1,0,1,0,7,106,1,-2,1,-4,0,0,-1,1,1,-1,6,-1
KR_6694956410,420,-1,16,4,-8,-1,2,1,-2,2,0,3,1,4,-4,5,1,-4,4,0,0,-14,5,0,-1,1,-2,0,-3,-1,-1,-1,1,1,-1
KR_6754271683,420,-4,-79,14,-6,-2,5,3,-1,1,0,1,1,2,-4,4,0,0,2,2,0,-3,-11,0,-3,3,2,0,-1,-1,-1,-1,-1,6,-1
KR_6744259877,420,-4,-22,-56,-13,1,0,1,0,1,1,0,4,4,-16,17,1,2,1,3,0,-20,-3,-2,-3,5,-1,0,-3,-1,-1,-1,-1,1,-1
KR_6689413058,420,2,45,4,5,2,1,3,4,0,4,4,0,4,-5,6,1,0,1,1,0,-4,3,-1,-2,3,0,0,0,1,1,0,-1,4,-1
KR_6752972501,440,1,6,21,-2,-2,5,3,3,0,3,-2,7,5,2,1,3,-3,7,4,-1,2,-4,-1,-4,5,0,0,-1,-1,-1,-1,-1,2,-1
KR_6756056319,420,-3,-49,0,-10,-8,8,0,-1,2,1,-5,6,1,4,1,5,0,1,1,1,4,201,-3,-3,6,3,0,-2,-1,1,-1,1,6,-1
KR_6755959258,420,1,-28,9,-1,-3,3,0,0,2,2,1,0,1,0,2,2,1,0,1,0,-4,-29,-2,-5,7,2,0,0,-1,-1,1,1,6,-1
KR_6759287396,420,-4,-106,5,-10,-7,7,0,1,3,4,1,1,2,-4,5,1,-1,2,1,-2,-3,1,3,-3,0,-3,0,0,1,-1,-1,-1,5,-1
KR_6762085829,420,-3,-131,4,-10,1,1,2,-4,4,0,-7,9,2,0,0,0,0,0,0,0,-11,5,7,-9,2,-1,0,-2,0,1,-1,-1,0,-1
KR_6762006296,420,1,-5,-38,2,1,3,4,3,0,3,2,1,3,-4,4,0,0,0,0,-2,-2,-6,-5,-2,7,-1,0,0,-1,1,-1,-1,2,-1
KR_6761236215,420,-4,-68,24,-8,-3,3,0,1,1,2,-3,3,0,-3,6,3,0,0,0,0,-3,0,-1,-1,2,0,0,0,1,0,-1,-1,4,-1
KR_6747214545,440,-4,-13,-24,-6,-2,4,2,1,1,2,-4,4,0,-1,4,3,0,0,0,0,-2,-299,-3,0,3,3,0,0,-1,-1,0,-1,6,-1
KR_6704692821,420,-4,-129,-21,-6,-8,9,1,4,1,5,0,0,0,-1,3,2,-1,1,0,0,1,220,-4,-1,5,0,0,-2,-1,-1,-1,1,1,-1
KR_6753613036,420,-4,-72,4,-8,0,3,3,-2,4,2,-2,4,2,-3,3,0,-1,1,0,0,-8,6,-3,-1,4,-6,0,-2,1,-1,-1,-1,1,-1
KR_6752433076,420,-1,-39,-3,-4,0,1,1,-1,5,4,-1,4,3,-1,1,0,-1,3,2,0,2,18,0,-4,4,-5,0,1,0,0,1,-1,0,-1
KR_6730286120,420,-2,-58,-20,-7,-4,4,0,-5,6,1,0,1,1,0,1,1,2,1,3,1,0,-323,-2,-1,3,-1,0,-1,-1,-1,-1,1,5,-1
KR_6754915389,420,-1,5,-29,-10,1,1,2,-6,6,0,-1,5,4,-3,3,0,-1,1,0,0,-16,-41,-3,-1,4,0,0,-1,-1,0,-1,-1,2,-1
KR_6726593090,420,-1,9,-28,-3,1,0,1,-7,7,0,1,2,3,0,0,0,2,0,2,0,-1,321,1,-2,1,0,0,0,-1,-1,0,1,6,-1
KR_6650003954,420,0,-29,8,-4,2,2,4,-4,5,1,1,1,2,0,1,1,-3,3,0,-1,-8,4,-1,-1,2,0,0,1,-1,-1,-1,-1,6,-1
KR_6730463593,440,-5,-80,-36,-9,1,0,1,-1,3,2,-5,6,1,-3,3,0,-1,1,0,1,-10,-26,1,-2,1,-1,0,0,-1,1,0,1,3,-1
KR_6749064142,440,-4,-63,-45,-14,-2,4,2,-2,3,1,-1,2,1,-7,7,0,-2,2,0,-1,-24,14,-5,-3,8,-3,0,0,-1,0,-1,-1,4,-1
KR_6747955433,420,-1,-6,-20,1,-1,2,1,0,2,2,-1,1,0,-2,5,3,5,1,6,-1,4,5,0,-2,2,2,0,1,-1,-1,1,-1,6,-1
KR_6691995908,420,1,-88,20,-9,-7,7,0,-2,5,3,-1,4,3,2,0,2,-1,4,3,0,0,6,-1,-1,2,-2,0,0,1,1,-1,-1,4,-1
KR_6761715721,420,4,34,-4,10,8,0,8,2,1,3,-7,9,2,3,2,5,4,0,4,1,13,-1,0,-3,3,4,0,0,1,0,1,1,2,-1
KR_6699156876,420,0,-9,-11,-7,0,2,2,2,2,4,-6,10,4,-3,4,1,0,1,1,0,-16,20,-4,-2,6,-4,0,1,-1,1,1,1,6,-1
KR_6733504734,420,3,35,15,7,6,0,6,-2,3,1,-6,6,0,2,0,2,7,0,7,0,11,-7,-5,-1,6,-2,0,1,0,0,1,1,0,-1
KR_6749070066,420,-4,9,1,-9,0,4,4,-1,2,1,0,2,2,-7,8,1,-1,1,0,0,-14,-14,0,-2,2,0,0,1,-1,-1,-1,-1,1,-1
KR_6662521617,420,1,17,5,-3,3,0,3,-7,8,1,-1,3,2,2,1,3,0,1,1,0,-9,4,-1,-3,4,-1,0,1,-1,-1,1,-1,5,-1
KR_6706348524,420,-8,-27,-96,-10,-3,3,0,-3,8,5,0,1,1,-1,3,2,-3,3,0,0,-9,-18,2,-3,1,-1,0,-1,-1,-1,-1,1,5,-1
KR_6739304300,420,-2,12,0,-4,2,2,4,-3,4,1,0,2,2,0,2,2,-3,3,0,0,-3,430,1,-2,1,-5,0,1,-1,1,1,1,5,-1
KR_6740213805,420,-1,-48,4,-3,1,1,2,0,2,2,-1,1,0,-4,5,1,1,3,4,0,-5,-10,0,-2,2,-1,0,0,1,-1,1,1,1,-1
KR_6751334244,420,-2,-63,-20,-4,-2,2,0,2,1,3,1,2,3,-5,6,1,0,1,1,-1,-3,-88,0,-2,2,-1,0,-4,-1,-1,-1,-1,3,-1
KR_6746207627,420,-2,-20,0,-1,0,3,3,1,1,2,-1,2,1,-2,4,2,1,1,2,0,2,-6,0,-3,3,2,0,0,1,0,-1,-1,6,-1
KR_6745852767,420,3,-13,22,6,4,0,4,-1,2,1,6,1,7,-3,8,5,0,1,1,0,-2,-66,-6,0,6,14,0,0,-1,-1,1,-1,5,-1
KR_6758968627,420,-6,-122,-12,-11,-4,4,0,-3,4,1,-3,3,0,1,0,1,-2,2,0,0,-7,-3,-6,0,6,4,0,-1,-1,-1,-1,-1,2,-1
KR_6739902216,420,-7,-122,-20,-14,-10,10,0,3,2,5,-3,4,1,-2,7,5,-2,2,0,0,-4,-2,-1,-2,3,-1,0,-1,-1,-1,-1,-1,4,-1
KR_6724814583,440,-3,53,-16,-6,1,1,2,-4,5,1,-6,6,0,0,3,3,3,1,4,0,1,-110,2,-5,3,-3,0,1,-1,-1,1,-1,3,-1
KR_6685886672,420,0,26,-40,0,-1,3,2,-1,2,1,2,0,2,0,1,1,0,1,1,0,4,17,1,-2,1,-3,0,0,-1,-1,0,1,2,-1
KR_6756599380,420,-1,-60,-16,-4,0,6,6,-3,8,5,-2,5,3,0,1,1,1,0,1,-2,5,-21,-1,-3,4,2,0,0,-1,-1,-1,-1,2,-1
KR_6717104052,420,-6,-106,4,-7,0,2,2,-1,3,2,-4,4,0,-1,1,0,-1,2,1,1,-5,6,1,-2,1,-2,0,0,-1,0,0,1,1,-1
KR_6712516238,420,-4,-49,-8,-5,-2,3,1,1,1,2,-1,1,0,-1,4,3,-2,3,1,0,-2,0,-1,-6,7,-1,0,-1,-1,-1,-1,-1,1,-1
KR_6755505153,420,-2,-44,-41,-3,1,0,1,0,1,1,-3,3,0,0,1,1,-1,1,0,0,0,37,1,-3,2,-3,0,-1,-1,-1,-1,-1,6,-1
KR_6727972046,420,-1,22,-9,1,1,5,6,2,0,2,0,1,1,0,2,2,-2,2,0,0,8,-1,1,-2,1,1,0,-1,-1,-1,-1,1,1,-1
KR_6711990180,420,2,75,0,8,0,2,2,1,4,5,2,2,4,1,1,2,4,0,4,0,8,14,1,-2,1,-2,0,2,1,-1,1,1,4,-1
KR_6756470912,420,0,43,4,-2,-1,1,0,-3,3,0,1,5,6,2,1,3,-1,1,0,0,-12,1,-4,0,4,0,0,0,-1,-1,-1,1,2,-1
KR_6763692092,420,-2,-59,-45,-3,-4,4,0,1,3,4,1,4,5,2,0,2,-3,3,0,0,8,212,2,-2,0,-1,0,-1,-1,-1,-1,-1,5,-1
KR_6722977415,420,-4,0,4,-1,-5,5,0,-3,3,0,4,0,4,2,0,2,1,0,1,0,1,-8,0,0,0,1,0,-1,0,1,-1,1,0,-1
KR_6761381590,420,-3,-84,-16,-12,-2,3,1,-2,2,0,0,2,2,-5,5,0,-3,3,0,-2,-17,1,2,-3,1,2,0,0,-1,0,-1,-1,5,-1
KR_6739932069,420,4,-17,12,8,1,0,1,0,2,2,-1,1,0,7,0,7,1,1,2,0,11,-1,0,-2,2,0,0,0,0,-1,0,1,0,-1
KR_6645646336,420,-2,-72,-25,-8,2,1,3,-1,1,0,0,4,4,-10,10,0,1,1,2,-1,-14,-6,-4,-2,6,3,0,-3,-1,1,-1,-1,3,-1
KR_6758169243,440,-1,15,-4,-6,-3,3,0,1,1,2,2,0,2,-3,5,2,-3,3,0,0,-4,-8,0,-4,4,0,0,1,-1,1,1,1,3,-1
KR_6734917184,420,-3,49,-20,-8,-4,4,0,-2,5,3,-2,3,1,1,3,4,-1,3,2,0,-10,-25,-2,-2,4,7,0,-1,-1,-1,-1,-1,2,-1
KR_6748793192,420,1,-29,0,3,-1,2,1,-2,5,3,1,6,7,4,2,6,1,2,3,2,11,2,4,-4,0,1,0,1,-1,1,1,1,4,-1
KR_6646816099,420,-5,-88,4,-13,-1,1,0,1,2,3,-5,6,1,-4,4,0,-4,4,0,-1,-11,-4,-3,0,3,2,0,0,1,0,0,-1,5,-1
KR_6646292442,420,2,44,36,4,-2,2,0,1,1,2,0,2,2,6,2,8,-1,1,0,0,6,8,2,-6,4,1,0,0,-1,1,0,1,6,-1
KR_6646715808,420,-2,-27,-10,-4,-6,6,0,1,1,2,2,0,2,0,1,1,-1,1,0,0,-2,-4,0,-4,4,4,0,0,-1,1,0,-1,5,-1
KR_6720474579,440,-2,-35,19,-4,-3,3,0,3,1,4,0,1,1,0,2,2,-4,4,0,0,-3,3,1,-3,2,0,0,-1,-1,1,-1,-1,6,-1
KR_6680368697,420,-2,-15,-22,-2,-1,1,0,-2,3,1,1,2,3,-3,6,3,3,0,3,0,-3,105,3,-5,2,1,0,0,1,0,0,-1,1,-1
KR_6727500212,420,-2,-14,-12,-7,2,0,2,-1,2,1,3,3,6,-6,6,0,-5,5,0,0,-14,1,-1,0,1,0,0,-1,-1,1,-1,-1,3,-1
KR_6681543291,420,1,-7,38,0,1,2,3,1,0,1,0,2,2,-2,3,1,0,2,2,0,1,-4,2,-3,1,0,0,0,1,1,1,1,3,-1
KR_6655928988,420,-2,-39,-28,-6,3,1,4,-5,5,0,-1,1,0,0,1,1,-3,4,1,1,-7,-3,-2,-1,3,1,0,0,1,1,1,1,2,-1
KR_6685606229,420,2,-38,29,4,-3,4,1,-3,4,1,2,1,3,5,0,5,3,0,3,0,8,1,-2,0,2,0,0,1,1,1,1,1,4,-1
KR_6759715949,420,-1,-18,-33,-1,5,0,5,-2,4,2,0,4,4,-3,6,3,-1,2,1,0,-10,-15,-1,-4,5,1,0,0,1,1,1,-1,4,-1
KR_6739585130,420,1,-3,8,3,1,1,2,-1,4,3,4,1,5,-2,3,1,1,0,1,0,2,54,0,-4,4,-2,0,-1,-1,-1,-1,-1,2,-1
KR_6705446104,440,-4,-88,-64,-6,-4,6,2,-1,1,0,-4,8,4,1,2,3,2,0,2,-1,5,11,-2,0,2,1,0,-2,0,-1,-1,-1,0,-1
KR_6723653227,420,0,-56,19,-5,-4,5,1,3,1,4,0,0,0,-2,4,2,-2,2,0,-1,-5,0,1,-3,2,1,0,-2,-1,1,-1,-1,4,-1
KR_6743285929,420,-1,7,36,10,3,2,5,0,4,4,-4,5,1,10,0,10,1,2,3,1,12,130,1,-2,1,2,0,3,1,1,1,1,6,-1
KR_6764380384,420,3,38,-12,5,1,1,2,-2,2,0,4,1,5,3,1,4,-1,4,3,-1,0,44,2,-2,0,-18,0,1,0,0,1,-1,0,-1
KR_6733475892,420,-1,-1,-24,-3,1,1,2,2,1,3,1,1,2,-7,10,3,0,0,0,0,-6,46,4,-5,1,-22,0,0,-1,-1,1,1,5,-1
KR_6751989739,420,-1,-17,-52,-6,5,0,5,-4,4,0,-5,5,0,-2,3,1,0,0,0,0,-7,43,-2,-1,3,-2,0,-1,1,-1,-1,1,4,-1
KR_6733009450,420,-1,-14,4,-7,4,0,4,-6,9,3,2,0,2,-8,9,1,1,1,2,1,-13,4,2,-5,3,-3,0,-1,1,-1,-1,1,4,-1
KR_6704496492,440,-5,-83,-32,-6,-4,4,0,6,0,6,0,2,2,-1,2,1,-7,7,0,0,2,-1,-1,-2,3,0,0,-2,0,0,-1,1,0,-1
KR_6699526614,420,-1,15,-29,0,-1,1,0,1,3,4,-1,4,3,1,1,2,0,1,1,0,-3,-119,3,-7,4,3,0,0,-1,1,0,-1,1,-1
KR_6763715748,420,-4,-101,-33,-2,-2,2,0,-3,3,0,1,0,1,1,2,3,1,0,1,-1,0,-2,-1,-1,2,-3,0,-4,-1,1,-1,-1,1,-1
KR_6676810244,420,-3,-87,-33,-8,1,2,3,-7,11,4,-1,2,1,-1,3,2,0,0,0,0,-6,-6,-4,-2,6,1,0,-1,-1,-1,-1,-1,5,-1
KR_6663274420,420,-8,-46,-32,-17,-5,6,1,-6,6,0,-3,3,0,-3,3,0,0,0,0,0,-12,-8,0,0,0,1,0,-2,0,-1,-1,-1,0,-1
KR_6715546080,420,0,-37,20,-4,-2,5,3,-3,5,2,6,2,8,-3,4,1,-2,3,1,-2,-10,-3,1,-3,2,1,0,0,0,1,1,-1,0,-1
KR_6761096014,420,2,-16,28,7,4,1,5,3,2,5,3,1,4,-3,3,0,0,0,0,0,-1,-2,2,-3,1,1,0,0,1,-1,-1,1,6,-1
KR_6685099746,420,-1,-16,32,-5,-2,4,2,0,1,1,3,2,5,-6,8,2,0,2,2,0,-6,-45,-4,-1,5,17,0,-1,1,1,-1,-1,2,-1
KR_6761630642,420,-1,-53,-22,-4,-4,5,1,-4,5,1,1,2,3,3,2,5,0,2,2,0,-2,395,0,-2,2,-1,0,0,-1,0,0,-1,3,-1
KR_6658626699,420,-1,22,-12,-5,1,0,1,-1,3,2,1,2,3,-5,5,0,-1,1,0,0,-2,-1,1,-3,2,0,0,-1,0,0,-1,-1,0,-1
KR_6743327147,420,-3,-52,2,-9,3,0,3,-3,3,0,-1,4,3,-8,8,0,0,1,1,0,-5,-24,-1,-3,4,-1,0,-2,1,-1,-1,-1,2,-1
KR_6760038062,420,0,37,17,-5,-1,2,1,1,3,4,-1,1,0,-1,1,0,-3,3,0,1,-3,5,5,-6,1,-3,0,1,-1,0,1,1,4,-1
KR_6727957523,420,1,-20,20,-3,-1,3,2,2,0,2,2,1,3,-5,6,1,-1,1,0,-1,-1,106,1,-4,3,-2,0,0,-1,-1,-1,-1,4,-1
KR_6700356003,420,-6,-72,-16,-13,-2,3,1,1,4,5,0,4,4,-5,5,0,-7,8,1,0,-17,290,1,-5,4,-3,0,-2,-1,1,-1,-1,5,-1
KR_6739192830,420,-4,-37,16,-3,0,1,1,0,2,2,0,0,0,2,3,5,-5,6,1,0,-5,-538,-3,0,3,1,0,0,-1,-1,0,-1,1,-1
KR_6627337329,420,0,0,0,-2,-2,3,1,2,1,3,-3,3,0,-1,1,0,2,1,3,0,-1,0,0,0,0,0,0,0,0,0,-1,-1,0,-1
KR_6759181701,420,-2,44,-8,-9,-2,2,0,-1,3,2,-1,4,3,-4,5,1,-1,4,3,0,-14,-6,-6,-3,9,1,0,-1,1,-1,-1,-1,3,-1
KR_6759837819,440,-6,-40,0,-11,-7,8,1,0,2,2,2,2,4,-3,6,3,-3,4,1,-2,-8,-5,-4,0,4,2,0,-1,0,1,-1,-1,0,-1
KR_6732308728,420,-1,3,4,-1,-3,4,1,2,0,2,-2,4,2,2,0,2,0,0,0,1,2,113,3,-9,6,5,0,2,1,1,1,1,3,-1
KR_6745180480,420,-6,-64,-47,-10,4,0,4,-3,3,0,-3,3,0,-6,6,0,-2,2,0,0,-8,-13,-3,0,3,-1,0,-2,-1,1,-1,-1,5,-1
KR_6757389242,420,-2,-39,-24,-5,-3,5,2,-1,2,1,0,3,3,0,1,1,-1,1,0,0,-5,-15,0,-3,3,-2,0,0,1,0,0,1,6,-1
KR_6756178242,420,-1,-55,-3,-3,5,2,7,-1,4,3,4,1,5,-8,9,1,-3,3,0,-1,-11,-3,-2,-2,4,-4,0,-1,-1,0,-1,-1,5,-1
KR_6759750270,420,-1,28,-8,-4,2,0,2,-6,7,1,2,0,2,-1,4,3,-1,1,0,0,-8,4,2,-2,0,0,0,0,1,-1,0,1,1,-1
KR_6676416279,420,0,-78,-24,0,2,4,6,-1,1,0,0,3,3,-3,6,3,2,0,2,0,4,4,4,-5,1,-5,0,1,-1,-1,1,-1,4,-1
KR_6762808176,420,-6,-5,-50,-14,3,0,3,-15,15,0,3,1,4,-4,5,1,-1,1,0,0,-14,-39,-1,-3,4,-3,0,-1,-1,1,-1,1,1,-1
KR_6636005595,420,-3,-28,32,-15,-1,2,1,-4,6,2,-2,3,1,-9,10,1,1,0,1,0,-24,10,1,-2,1,-2,0,-1,1,-1,-1,-1,6,-1
KR_6761195078,420,0,30,-32,4,-4,5,1,-2,2,0,2,2,4,6,1,7,2,1,3,0,5,-325,3,-9,6,4,0,1,-1,1,1,1,2,-1
KR_6732839228,420,-2,-78,20,-6,2,1,3,1,0,1,-5,5,0,-2,3,1,-2,2,0,0,-7,6,1,-5,4,-4,0,0,1,-1,0,-1,1,-1
KR_6742517910,420,-4,-77,-48,-12,0,1,1,2,1,3,-3,5,2,-4,4,0,-7,7,0,-1,-16,-11,-1,-1,2,3,0,-2,1,-1,-1,-1,6,-1
KR_6741181863,420,-2,-29,-12,-7,0,3,3,-2,3,1,-3,5,2,-1,4,3,-1,1,0,0,-13,-5,0,-1,1,0,0,0,1,0,0,-1,2,-1
KR_6722200716,420,-3,-26,16,-6,-6,6,0,-4,5,1,3,1,4,0,1,1,1,2,3,0,-3,-28,0,0,0,1,0,0,-1,-1,0,1,6,-1
KR_6724160197,420,3,-50,34,3,-1,3,2,0,1,1,2,3,5,-2,3,1,4,0,4,0,-3,-2,-3,0,3,0,0,2,-1,1,1,1,6,-1
KR_6728817745,420,-1,-9,4,-1,8,0,8,-1,3,2,-5,5,0,-5,6,1,2,0,2,0,-7,-14,-1,-3,4,5,0,-1,-1,1,-1,1,1,-1
KR_6762753162,420,-8,-122,-12,-15,-1,1,0,-3,3,0,-8,8,0,-3,4,1,0,1,1,0,-9,-14,2,-4,2,-4,0,-2,0,-1,-1,-1,0,-1
KR_6751558004,420,-4,-70,-12,-11,-3,7,4,-6,7,1,-7,9,2,2,0,2,3,0,3,-1,-3,-4,-1,0,1,1,0,-1,-1,1,-1,1,1,-1
KR_6709548239,420,-1,-26,-20,-2,2,1,3,0,2,2,-3,7,4,-2,3,1,1,0,1,3,-1,4,-1,-3,4,-1,0,-2,-1,-1,-1,1,5,-1
KR_6738981418,420,-10,-144,-31,-30,-7,7,0,-2,4,2,-6,8,2,-6,7,1,-9,10,1,0,-12,-279,0,-2,2,-2,0,-2,-1,-1,-1,1,5,-1
KR_6730804612,420,-3,-116,-16,-4,2,1,3,1,1,2,-5,6,1,-2,2,0,0,1,1,0,0,38,-2,-2,4,0,0,-1,-1,-1,-1,-1,1,-1
KR_6756532612,420,-3,-83,8,-11,3,0,3,-1,1,0,-9,9,0,-2,3,1,-2,3,1,0,-12,2,2,-6,4,-2,0,0,0,1,0,-1,0,-1
KR_6651872094,420,-1,-41,4,-1,4,0,4,-2,3,1,-3,3,0,1,3,4,-1,1,0,0,-5,-298,-1,-2,3,2,0,0,-1,1,1,1,3,-1
KR_6760369940,420,4,39,19,3,-2,2,0,0,3,3,6,1,7,0,2,2,-1,2,1,0,1,18,-1,-1,2,0,0,0,1,0,0,1,2,-1
KR_6729820900,420,1,-48,11,6,1,2,3,0,2,2,0,2,2,0,0,0,5,0,5,0,7,5,-4,0,4,2,0,2,0,-1,1,1,0,-1
KR_6699175643,420,-1,-41,21,-6,-3,3,0,-1,3,2,1,4,5,0,3,3,-3,3,0,0,-6,-286,-1,-2,3,2,0,-1,-1,-1,-1,1,6,-1
KR_6759903088,440,-2,-36,13,-17,3,3,6,0,3,3,-7,7,0,-8,9,1,-5,7,2,-1,-22,384,-2,0,2,-2,0,1,1,-1,-1,-1,1,-1
KR_6751416181,440,-2,34,12,-6,2,0,2,-8,8,0,-4,5,1,2,1,3,2,4,6,-1,-8,-2,-12,0,12,3,0,1,0,-1,1,-1,0,-1
KR_6741691187,420,2,59,-20,0,2,0,2,-4,5,1,0,2,2,3,0,3,-1,2,1,-1,-3,45,-2,-4,6,-27,0,1,-1,1,1,-1,1,-1
KR_6760883306,420,-3,-67,24,-7,-4,4,0,-2,2,0,3,2,5,-5,6,1,1,0,1,0,-10,15,0,-3,3,-1,0,-1,1,-1,-1,-1,6,-1
KR_6730796712,440,0,-44,-3,3,2,1,3,-1,2,1,1,1,2,-1,3,2,2,0,2,1,0,0,-2,-1,3,0,0,0,0,1,-1,1,0,-1
KR_6660583145,420,-3,-15,-16,-5,-3,3,0,-1,1,0,1,3,4,-1,1,0,-1,1,0,0,-3,-2,-1,-3,4,2,0,-2,-1,-1,-1,-1,2,-1
KR_6680109287,420,-7,-176,-13,-16,-8,9,1,0,1,1,-1,1,0,-2,4,2,-5,5,0,0,-5,-4,2,-4,2,-2,0,-2,-1,1,-1,-1,2,-1
KR_6735073662,420,-3,-12,-32,-6,-1,2,1,0,1,1,-1,1,0,-4,5,1,0,0,0,0,-8,2,-2,-1,3,0,0,0,-1,-1,-1,-1,2,-1
KR_6749658471,420,-3,-55,-25,-5,-3,4,1,-1,1,0,0,1,1,-1,1,0,0,0,0,-1,-2,15,1,-4,3,1,0,-2,-1,1,-1,-1,3,-1
KR_6759076837,420,-4,-111,-25,-3,-2,3,1,3,0,3,-6,7,1,1,0,1,1,0,1,0,-2,-12,2,-4,2,-2,0,-1,0,1,-1,-1,0,-1
KR_6733311980,420,-1,-60,-28,-1,-1,3,2,2,2,4,0,2,2,-1,3,2,-1,1,0,0,0,-4,2,-4,2,-2,0,1,0,1,1,-1,0,-1
KR_6752592524,420,-1,-43,-30,-1,2,0,2,-3,4,1,3,0,3,-2,3,1,-1,1,0,0,-8,47,-3,-2,5,-6,0,1,0,0,1,-1,0,-1
KR_6698723367,420,-2,73,-76,-1,-4,7,3,-2,2,0,0,1,1,3,1,4,2,0,2,0,-5,3,1,-3,2,-1,0,0,-1,-1,-1,1,2,-1
KR_6762772411,420,-1,0,-12,-4,2,1,3,-5,6,1,-2,3,1,1,0,1,0,0,0,0,1,1,-3,0,3,-5,0,1,-1,-1,1,-1,1,-1
KR_6651566368,420,-1,-6,-31,-10,-1,3,2,1,1,2,-10,11,1,-3,3,0,3,0,3,-1,-6,-14,0,-4,4,1,0,-1,-1,-1,-1,-1,1,-1
KR_6689568712,420,-2,7,-8,-5,3,0,3,-1,4,3,-4,4,0,0,0,0,-3,3,0,0,-5,4,1,-2,1,-1,0,0,-1,0,-1,-1,6,-1
KR_6762500923,420,-2,0,8,-3,-1,3,2,-2,3,1,1,1,2,1,3,4,-2,3,1,0,1,-10,-2,-1,3,3,0,0,-1,-1,0,1,2,-1
KR_6754174794,420,-8,-64,-16,-15,-2,3,1,-2,2,0,-1,2,1,-9,9,0,-1,3,2,0,-15,-7,0,-7,7,4,0,-3,-1,1,-1,-1,6,-1
KR_6734073406,420,-5,-51,-32,-14,-2,2,0,-6,7,1,0,2,2,-6,8,2,0,0,0,0,-11,-2,0,-3,3,1,0,-1,0,0,-1,-1,0,-1
KR_6752429491,440,2,31,-12,2,2,0,2,2,0,2,0,6,6,-7,7,0,5,1,6,0,-1,-1,-1,-1,2,-4,0,0,1,1,1,-1,1,-1
KR_6604032535,420,-2,-94,-8,-5,-3,3,0,0,1,1,-1,4,3,-1,3,2,0,0,0,0,-1,-499,-3,-2,5,1,0,0,0,0,0,-1,0,-1
KR_6685995973,420,1,3,-12,4,1,0,1,-1,1,0,2,0,2,2,1,3,0,0,0,0,3,12,2,-5,3,9,0,0,1,-1,0,1,2,-1
KR_6711460155,420,-2,-25,28,-1,0,3,3,-2,6,4,3,2,5,-4,5,1,2,1,3,-1,5,3,4,-4,0,-1,0,0,1,0,0,-1,3,-1
KR_6739093410,420,2,47,8,-2,2,1,3,-2,5,3,-2,3,1,2,3,5,-2,3,1,1,3,-14,-1,-2,3,1,0,0,1,0,-1,1,4,-1
KR_6754347512,420,1,44,-5,-1,-2,3,1,0,2,2,1,0,1,-1,6,5,1,1,2,0,3,5,-1,-1,2,-2,0,-1,1,0,-1,-1,5,-1
KR_6764339920,420,0,41,48,4,-2,3,1,3,1,4,0,3,3,3,2,5,0,0,0,0,2,-5,-8,-4,12,-4,0,0,-1,1,1,1,4,-1
KR_6741432873,420,-3,-10,16,-4,-1,1,0,-1,3,2,-2,2,0,-1,1,0,1,1,2,0,-3,-7,-2,-2,4,1,0,0,1,1,0,1,2,-1
KR_6762600396,420,3,9,-26,1,-1,6,5,1,1,2,0,2,2,1,1,2,0,1,1,0,3,13,2,-4,2,1,0,1,0,1,1,1,0,-1
KR_6731186017,420,-2,16,28,-13,-4,4,0,-3,3,0,-3,4,1,-1,2,1,-2,3,1,0,-10,-10,-1,-3,4,2,0,-1,-1,1,-1,-1,1,-1
KR_6684719090,420,1,22,6,2,1,2,3,0,3,3,1,3,4,0,2,2,0,0,0,0,4,-3,-2,-1,3,0,0,0,-1,1,0,1,2,-1
KR_6737532575,420,0,-16,8,-5,4,0,4,1,2,3,1,0,1,-10,11,1,-1,1,0,0,-7,-7,0,-4,4,-1,0,0,1,1,-1,1,5,-1
KR_6738394520,420,-1,-69,-17,-1,0,2,2,1,3,4,-3,3,0,0,2,2,1,1,2,1,-8,3,-4,-1,5,2,0,0,-1,1,0,1,4,-1
KR_6643961186,420,1,-84,-12,10,-1,3,2,1,3,4,0,2,2,6,2,8,4,0,4,0,12,247,3,-5,2,1,0,1,-1,0,1,-1,4,-1
KR_6652956599,420,-4,-26,-8,-9,-1,3,2,-1,4,3,-1,4,3,-4,4,0,-2,2,0,0,-9,280,-1,0,1,25,0,1,1,1,-1,-1,3,-1
KR_6687271344,420,-2,-86,-24,-1,0,2,2,-4,5,1,2,3,5,0,5,5,1,2,3,0,10,-2,-1,0,1,-4,0,-1,1,0,-1,1,4,-1
KR_6723849791,420,-1,-40,-19,0,0,2,2,-2,3,1,-1,3,2,2,2,4,1,0,1,0,7,0,2,-3,1,-2,0,-1,1,0,-1,-1,2,-1
KR_6686205641,420,-6,-38,27,-14,1,1,2,-2,2,0,-6,6,0,-7,7,0,0,0,0,0,-11,0,1,-4,3,-1,0,-3,-1,-1,-1,-1,4,-1
KR_6758505021,420,-4,-69,19,-12,-7,8,1,-2,2,0,4,1,5,-7,7,0,0,1,1,0,-8,159,-1,0,1,2,0,-2,-1,1,-1,-1,2,-1
KR_6759223395,420,0,46,-8,-5,3,0,3,-2,4,2,0,4,4,-6,9,3,0,3,3,-1,-3,-8,1,-4,3,3,0,-1,-1,-1,1,1,2,-1
KR_6762869654,420,-3,-49,-20,-7,0,1,1,-4,7,3,-2,3,1,2,3,5,-3,6,3,0,-9,-11,3,-4,1,-3,0,-1,-1,0,-1,1,3,-1
KR_6708151671,420,1,-5,2,2,-4,5,1,0,3,3,-1,3,2,3,2,5,4,1,5,0,4,-8,1,-5,4,2,0,-2,1,-1,-1,-1,6,-1
KR_6729546942,420,-3,-77,27,-3,1,3,4,1,1,2,-3,3,0,-2,3,1,0,2,2,0,-4,-36,-2,-1,3,27,0,0,-1,1,0,1,2,-1
KR_6687844329,420,3,-31,24,0,2,0,2,2,0,2,-6,8,2,1,1,2,1,1,2,0,1,131,-3,-1,4,5,0,1,1,-1,-1,-1,4,-1
KR_6749716056,420,2,3,25,13,2,3,5,1,1,2,0,2,2,2,2,4,8,0,8,0,9,7,2,-3,1,1,0,1,0,1,1,1,0,-1
KR_6641989425,420,0,-74,-44,1,-2,3,1,3,0,3,1,2,3,-2,3,1,1,1,2,0,6,106,-1,-2,3,1,0,-1,-1,-1,-1,-1,1,-1
KR_6704067247,420,2,66,-16,-2,0,3,3,2,0,2,3,1,4,-7,8,1,0,1,1,0,-5,-5,0,-2,2,0,0,1,1,-1,1,-1,5,-1
KR_6729912734,420,-2,-49,-6,-2,3,1,4,-1,3,2,-1,5,4,-1,3,2,-2,3,1,0,-2,-4,1,-4,3,-1,0,1,-1,1,1,-1,1,-1
KR_6762114038,420,-3,-21,-7,-17,-2,3,1,-3,3,0,0,4,4,-12,15,3,0,3,3,0,-18,-104,0,-2,2,0,0,0,-1,-1,-1,-1,3,-1
KR_6753879473,420,-4,-43,9,-6,-2,2,0,-5,6,1,1,1,2,3,4,7,-3,3,0,1,-6,-1,0,-3,3,1,0,0,-1,-1,0,1,5,-1
KR_6723474339,420,-1,29,-60,-7,2,1,3,-5,7,2,-1,2,1,-2,3,1,-1,1,0,0,-7,351,-4,0,4,-2,0,0,-1,-1,0,-1,1,-1
KR_6724551602,420,-2,34,12,0,2,2,4,-2,3,1,-1,1,0,-1,1,0,2,1,3,0,4,-3,-1,-3,4,2,0,0,1,1,0,1,2,-1
KR_6736312127,420,-2,-36,-8,-7,1,1,2,-3,5,2,-4,6,2,0,0,0,-1,1,0,1,-5,0,0,-2,2,0,0,0,-1,-1,-1,1,5,-1
KR_6754524792,440,-1,-8,-4,10,-1,4,3,5,0,5,6,0,6,-1,2,1,1,0,1,0,12,-11,3,-4,1,3,0,-1,1,0,-1,1,2,-1
KR_6744300635,420,-3,-60,-31,-7,-1,3,2,-2,5,3,-2,4,2,-2,6,4,0,1,1,0,-6,-15,-1,-1,2,1,0,-3,-1,-1,-1,-1,6,-1
KR_6729255184,420,-1,-99,0,-4,2,0,2,-8,9,1,-4,4,0,5,4,9,1,0,1,0,1,5,-2,-1,3,-1,0,-1,1,-1,-1,1,2,-1
KR_6760993575,440,3,34,20,5,-3,4,1,-1,2,1,2,0,2,2,3,5,5,1,6,0,4,17,0,-2,2,0,0,2,0,0,1,-1,0,-1
KR_6657961131,420,2,21,60,-6,0,2,2,-2,3,1,-5,8,3,1,4,5,0,2,2,1,-4,-18,-1,-3,4,-1,0,0,-1,-1,0,1,1,-1
KR_6737640364,420,-3,-100,16,-6,-3,3,0,0,2,2,-5,7,2,2,5,7,0,2,2,1,-3,1,-4,-4,8,1,0,-3,-1,-1,-1,1,2,-1
KR_6764062509,440,-1,10,0,0,-2,5,3,-1,6,5,-3,4,1,6,1,7,0,1,1,0,3,7,1,-3,2,1,0,-1,1,-1,-1,1,2,-1
KR_6743306128,420,0,-127,-13,5,-4,4,0,5,0,5,1,1,2,0,2,2,3,0,3,-1,9,-9,-1,-1,2,0,0,-1,1,0,-1,-1,2,-1
KR_6763875571,420,-3,48,-39,-7,-5,5,0,-2,2,0,-4,4,0,1,1,2,3,1,4,0,-6,-94,1,-5,4,-4,0,-2,-1,1,-1,-1,3,-1
KR_6692919323,420,-4,-11,-35,-19,-4,6,2,-13,13,0,1,3,4,0,3,3,-3,3,0,-2,-10,-9,1,-4,3,2,0,-2,-1,-1,-1,-1,4,-1
KR_6703402536,420,1,15,-4,1,-2,2,0,1,4,5,3,0,3,-1,3,2,0,1,1,1,-2,-43,1,-4,3,24,0,-1,-1,-1,-1,1,3,-1
KR_6761434516,440,0,-38,-40,1,-1,1,0,0,2,2,0,4,4,2,2,4,0,2,2,0,1,10,1,-3,2,-3,0,0,1,-1,-1,1,6,-1
KR_6737581382,420,-1,-11,-17,-5,1,0,1,-2,3,1,1,1,2,-7,7,0,2,0,2,0,0,-1,0,-1,1,1,0,0,-1,1,1,-1,2,-1
KR_6743571712,420,-2,2,-27,-6,2,0,2,-3,4,1,1,2,3,-6,6,0,0,1,1,-1,-6,-5,1,-5,4,0,0,-2,-1,1,-1,1,6,-1
KR_6759256685,420,3,22,-12,6,-1,2,1,0,2,2,-2,6,4,7,0,7,2,0,2,0,17,-112,2,-2,0,1,0,-1,1,-1,-1,1,5,-1
KR_6681793817,440,-3,-39,-16,-8,-1,1,0,-3,4,1,-3,6,3,1,0,1,-2,2,0,0,-8,73,-2,-4,6,-3,0,0,1,1,0,-1,3,-1
KR_6740128836,420,-3,-66,-24,-4,-4,4,0,-1,3,2,0,1,1,0,1,1,1,0,1,0,4,-11,-1,-2,3,-4,0,0,-1,0,-1,-1,2,-1
KR_6760499468,420,-2,-78,13,-3,0,1,1,0,0,0,0,0,0,-3,4,1,0,0,0,0,-2,-1,1,-3,2,-2,0,0,1,-1,0,-1,5,-1
KR_6761314426,440,-5,-99,-20,-13,-4,5,1,0,0,0,-3,4,1,-6,12,6,0,1,1,0,-3,-2,7,-9,2,0,0,-2,-1,0,-1,-1,3,-1
KR_6718565118,420,-2,-36,-40,1,1,0,1,-5,6,1,-2,3,1,-1,5,4,8,0,8,1,9,-359,0,-5,5,1,0,-1,-1,-1,-1,1,3,-1
KR_6668436404,420,-2,41,-30,-6,0,0,0,-3,4,1,-4,7,3,-2,2,0,3,0,3,0,-7,3,4,-5,1,3,0,1,0,1,1,1,0,-1
KR_6742899357,440,-2,6,-32,-5,1,2,3,-2,3,1,-2,3,1,-3,3,0,1,2,3,-1,-6,2,0,-2,2,1,0,0,-1,-1,-1,-1,6,-1
KR_6703215415,420,-4,-39,-38,-7,0,1,1,-6,8,2,4,1,5,-3,4,1,-2,5,3,0,-9,-30,2,-5,3,-2,0,-1,0,-1,-1,1,0,-1
KR_6761514091,420,-3,-12,-13,-5,-6,6,0,3,6,9,-4,6,2,1,1,2,1,0,1,0,-1,275,-6,-1,7,3,0,-2,1,-1,-1,1,6,-1
KR_6756319714,420,-3,31,-20,-3,3,1,4,-2,5,3,-5,7,2,1,2,3,0,3,3,1,-7,2,5,-6,1,-4,0,1,1,-1,1,1,6,-1
KR_6731484302,420,-5,-113,-29,0,-3,4,1,5,1,6,-6,6,0,6,0,6,-2,3,1,2,11,-14,-1,-3,4,-6,0,-2,-1,-1,-1,1,4,-1
KR_6737708835,420,-3,-43,-29,-4,-5,5,0,2,2,4,-4,5,1,0,2,2,3,0,3,0,8,-6,-2,0,2,0,0,-2,-1,0,-1,1,1,-1
KR_6764005907,420,0,113,-10,-4,-3,4,1,-2,4,2,-1,6,5,1,2,3,1,1,2,0,-2,11,0,-1,1,3,0,0,-1,-1,0,1,5,-1
KR_6737735474,420,0,-27,36,-8,1,1,2,1,0,1,-3,3,0,-5,5,0,-2,2,0,0,-11,-27,-1,0,1,-5,0,-1,-1,1,-1,-1,4,-1
KR_6748756056,420,-2,-26,-16,-4,-4,4,0,3,1,4,-1,2,1,1,3,4,-3,3,0,0,6,-8,-3,0,3,1,0,0,1,-1,-1,1,4,-1
KR_6759491098,420,-4,-30,-15,-8,2,0,2,0,5,5,-2,4,2,-5,7,2,-3,3,0,-1,-7,0,-1,-2,3,-1,0,0,-1,-1,-1,-1,6,-1
KR_6753512442,420,-2,-82,9,-4,-2,4,2,-1,2,1,0,2,2,0,0,0,-1,1,0,0,-6,2,-1,-2,3,-2,0,0,1,1,0,-1,4,-1
KR_6745958700,420,1,43,4,-2,1,2,3,-2,4,2,-3,5,2,1,1,2,1,2,3,1,4,299,-2,-2,4,0,0,-1,1,-1,-1,1,1,-1
KR_6727079266,420,-3,-24,-43,-6,-3,4,1,-3,3,0,-1,1,0,-1,1,0,2,0,2,0,-5,9,-1,-1,2,-1,0,0,0,-1,0,-1,0,-1
KR_6644430475,420,-2,15,16,-8,-3,3,0,-4,6,2,4,2,6,-3,4,1,-2,2,0,-1,-10,4,1,-1,0,0,0,-2,1,1,-1,-1,6,-1
KR_6757945543,420,2,48,24,4,1,1,2,3,1,4,6,0,6,-7,9,2,1,1,2,1,-6,-27,3,-4,1,0,0,0,1,0,1,1,6,-1
KR_6763355269,420,-1,-45,-12,1,1,0,1,-4,7,3,1,3,4,2,2,4,1,1,2,-2,7,-2,0,-2,2,-2,0,0,1,-1,-1,-1,1,-1
KR_6726869335,420,2,40,-12,9,2,0,2,1,0,1,6,1,7,1,2,3,-1,1,0,0,4,-7,3,-5,2,-2,0,0,1,1,1,1,1,-1
KR_6690729873,420,-1,53,-4,-4,-5,6,1,0,1,1,2,0,2,-2,3,1,1,1,2,0,1,564,-3,-1,4,-4,0,-2,-1,-1,-1,1,3,-1
KR_6741518640,420,-7,-96,-40,-11,-4,6,2,-10,10,0,5,1,6,-2,3,1,0,0,0,-1,-3,1,-4,-2,6,0,0,-1,-1,0,-1,-1,1,-1
KR_6763875030,420,0,36,-8,7,1,1,2,2,4,6,2,4,6,3,1,4,-1,2,1,2,9,6,2,-2,0,5,0,0,1,1,1,1,2,-1
KR_6681697486,440,-1,-10,4,-3,-3,6,3,5,0,5,1,0,1,-4,5,1,-2,2,0,0,-7,-6,-4,-3,7,-1,0,-1,1,1,-1,-1,5,-1
KR_6712212897,420,1,2,-16,3,3,0,3,-1,3,2,-1,2,1,1,1,2,1,0,1,1,4,-273,0,-1,1,11,0,0,-1,-1,0,1,1,-1
KR_6707861410,420,-2,-108,-20,-4,-1,2,1,3,5,8,0,3,3,-5,7,2,-1,2,1,0,-2,-20,-1,-2,3,2,0,-2,0,1,-1,1,0,-1
KR_6699470318,420,2,27,-9,-3,2,2,4,-3,4,1,-3,4,1,1,0,1,0,0,0,0,-8,-16,2,-4,2,1,0,0,-1,-1,-1,1,3,-1
KR_6762275915,420,-2,-44,-9,-5,-3,3,0,0,2,2,0,0,0,-2,3,1,0,0,0,0,-7,-200,1,-6,5,1,0,0,-1,1,0,-1,4,-1
KR_6764000403,420,-2,8,0,-14,-3,4,1,-5,8,3,-1,1,0,-3,4,1,-2,2,0,0,-11,-14,-2,0,2,2,0,0,-1,-1,-1,-1,5,-1
KR_6678754756,420,1,0,16,0,-6,6,0,-2,3,1,-1,1,0,6,2,8,3,0,3,0,-1,-13,-3,-3,6,-3,0,-1,1,-1,-1,-1,3,-1
KR_6736175290,420,-1,-3,-24,-1,0,0,0,-3,4,1,-1,3,2,3,1,4,0,0,0,0,0,4,1,-5,4,-4,0,0,1,1,-1,-1,1,-1
KR_6700676818,420,-6,-54,-81,-9,-8,8,0,1,0,1,-2,2,0,1,0,1,-1,1,0,0,-5,-6,-1,-1,2,1,0,-2,-1,-1,-1,-1,4,-1
KR_6750890494,420,-1,-61,-16,-1,-1,2,1,1,1,2,0,0,0,-2,2,0,1,0,1,0,1,8,2,-3,1,0,0,0,-1,-1,0,-1,4,-1
KR_6747281273,420,-3,8,-4,-12,-3,3,0,2,1,3,-6,8,2,-3,4,1,-2,2,0,0,-11,-11,-2,-2,4,1,0,0,-1,-1,-1,-1,3,-1
KR_6697068214,420,3,24,-33,8,8,0,8,0,1,1,-5,7,2,4,2,6,1,1,2,0,12,4,3,-4,1,-1,0,1,1,-1,1,-1,5,-1
KR_6752329466,420,-1,-45,52,-7,-4,4,0,-4,6,2,-1,2,1,2,0,2,0,0,0,-1,-7,-4,-5,-2,7,2,0,0,-1,1,0,-1,6,-1
KR_6652130974,420,-3,35,-10,-8,1,0,1,-2,4,2,3,0,3,-2,2,0,-8,8,0,0,-12,304,1,-1,0,-1,0,-3,-1,0,-1,1,1,-1
KR_6760659860,420,2,-36,24,5,-5,5,0,7,1,8,0,4,4,3,3,6,0,0,0,1,-3,-2,-1,-4,5,1,0,-2,1,-1,-1,1,5,-1
KR_6706436722,420,2,-13,32,2,-3,5,2,-1,1,0,3,4,7,2,1,3,1,0,1,0,2,30,3,-4,1,8,0,1,1,1,1,1,1,-1
KR_6647477078,420,1,29,14,0,-4,4,0,3,0,3,0,2,2,0,0,0,1,0,1,0,0,-9,-3,0,3,-1,0,0,-1,0,1,1,2,-1
KR_6756081816,420,-3,20,16,-13,3,1,4,1,1,2,-5,5,0,-6,8,2,-6,7,1,0,-14,-23,-3,0,3,1,0,-2,1,0,-1,-1,4,-1
KR_6730194625,420,7,33,28,1,5,1,6,-2,3,1,3,1,4,-6,7,1,1,0,1,1,-2,-4,-3,-2,5,1,0,1,1,1,1,1,5,-1
KR_6748920157,420,-1,-93,-24,5,-1,1,0,4,3,7,0,2,2,1,2,3,1,0,1,0,10,-24,-3,-5,8,22,0,-1,1,1,1,-1,2,-1
KR_6764055034,420,-3,-15,0,-3,0,2,2,0,3,3,0,4,4,-1,1,0,-2,2,0,-1,-7,-10,1,-2,1,-1,0,-1,-1,0,-1,-1,4,-1
KR_6732678697,420,-1,-14,1,-3,0,1,1,-3,3,0,3,2,5,-2,4,2,-1,1,0,0,0,-4,1,-2,1,1,0,-1,-1,1,-1,1,4,-1
KR_6726536835,440,0,-93,-27,0,-4,6,2,1,0,1,5,1,6,1,0,1,-3,3,0,-1,2,-2,-3,0,3,0,0,0,-1,-1,-1,-1,2,-1
KR_6649143608,420,-5,-46,8,-9,-6,6,0,3,2,5,1,3,4,-8,9,1,1,0,1,0,-2,41,3,-8,5,-14,0,0,-1,0,-1,-1,4,-1
KR_6756214492,420,-3,-121,28,-7,-1,3,2,-1,2,1,-5,7,2,-2,3,1,2,2,4,0,-6,0,1,-3,2,-4,0,-1,1,-1,-1,-1,3,-1
KR_6759102284,420,-5,-25,-36,-2,-2,4,2,-3,3,0,1,3,4,-3,7,4,5,0,5,0,-1,0,-1,-2,3,-1,0,-1,-1,-1,-1,1,2,-1
KR_6740266413,420,-2,-16,-35,-2,-1,1,0,-5,7,2,0,4,4,3,2,5,1,1,2,0,4,-19,-1,-3,4,3,0,0,0,-1,-1,-1,0,-1
KR_6747967697,420,-4,-55,-5,-9,0,4,4,-1,4,3,-7,8,1,0,2,2,-1,1,0,1,-11,0,2,-5,3,1,0,-2,-1,1,-1,1,4,-1
KR_6751059423,420,-3,-79,-28,-8,1,3,4,2,1,3,-11,12,1,0,4,4,0,0,0,-1,-5,-25,-1,0,1,0,0,-1,-1,0,-1,-1,1,-1
KR_6726608638,420,-4,-56,-56,-5,1,3,4,-2,2,0,-4,4,0,-1,4,3,1,0,1,0,-2,-104,-2,-5,7,0,0,-1,-1,1,-1,1,3,-1
KR_6751912452,440,-1,-28,24,3,0,1,1,-4,7,3,2,1,3,3,0,3,2,1,3,0,2,-297,-1,-1,2,2,0,-1,1,0,-1,1,4,-1
KR_6729471647,420,0,46,-4,1,-1,1,0,2,3,5,-5,5,0,1,4,5,4,1,5,0,1,42,-6,0,6,-27,0,1,1,1,1,-1,5,-1
KR_6655035459,420,-2,-23,0,0,-1,3,2,2,3,5,-4,7,3,3,0,3,0,3,3,0,0,-178,4,-6,2,1,0,-1,0,-1,-1,1,0,-1
KR_6744280387,420,-5,-38,-15,-10,-4,4,0,-1,5,4,0,1,1,-2,3,1,-3,3,0,0,-3,-4,0,-3,3,-3,0,1,-1,-1,1,-1,2,-1
KR_6752067135,420,0,-59,29,3,1,0,1,7,0,7,-3,3,0,-2,2,0,0,0,0,0,1,-2,-1,0,1,0,0,0,-1,1,-1,-1,3,-1
KR_6644159158,440,-2,77,-12,-3,-3,3,0,-2,4,2,1,4,5,1,1,2,0,0,0,-1,-12,-2,-3,-3,6,-4,0,0,-1,1,0,-1,2,-1
KR_6747214840,420,1,-26,20,-5,-4,6,2,-2,6,4,1,0,1,-3,5,2,3,1,4,0,-2,-4,2,-3,1,-2,0,0,-1,1,0,-1,4,-1
KR_6703876296,420,-3,-29,12,-14,-5,6,1,-2,3,1,-6,8,2,0,1,1,-1,1,0,0,-4,-25,1,-1,0,0,0,-3,1,-1,-1,-1,6,-1
KR_6752151856,420,-4,-82,-20,-12,-1,5,4,-6,6,0,-6,6,0,0,3,3,1,0,1,-3,-10,-11,-2,0,2,2,0,-3,-1,-1,-1,-1,1,-1
KR_6686795171,420,-4,-49,-18,-5,-2,2,0,-3,4,1,0,2,2,-1,2,1,1,0,1,0,-5,-5,-1,0,1,2,0,0,-1,1,0,-1,4,-1
KR_6751166687,420,-1,-8,-23,-2,3,0,3,1,2,3,-3,3,0,-2,5,3,-1,2,1,0,-7,-4,0,-4,4,3,0,0,-1,0,0,1,4,-1
KR_6633024491,440,1,15,10,-1,-1,1,0,-1,2,1,-1,3,2,-1,4,3,3,1,4,0,-1,12,-4,-2,6,-3,0,0,1,-1,-1,-1,6,-1
KR_6673427873,420,2,-21,0,0,-3,3,0,0,1,1,0,1,1,2,1,3,1,0,1,0,2,-14,-1,-2,3,3,0,1,1,-1,1,-1,2,-1
KR_6741285439,420,0,-29,4,3,0,1,1,2,3,5,-1,2,1,0,1,1,2,0,2,0,9,-36,-4,-1,5,12,0,0,-1,1,0,1,2,-1
KR_6721904303,420,-5,-23,-14,-4,0,1,1,1,1,2,-6,6,0,1,1,2,0,0,0,0,-8,-10,0,-2,2,-2,0,-3,-1,-1,-1,1,3,-1
KR_6752594731,420,-1,-68,12,1,7,0,7,-3,3,0,0,3,3,-4,6,2,1,1,2,0,-3,4,3,-6,3,0,0,1,-1,1,1,1,5,-1
KR_6746020588,420,-4,37,-37,-11,2,0,2,-5,5,0,-4,5,1,-2,2,0,-2,2,0,0,-12,1,1,-4,3,-1,0,-1,-1,1,-1,-1,1,-1
KR_6761107402,420,0,13,3,2,-1,3,2,0,4,4,-3,3,0,7,0,7,-1,3,2,-1,-11,-7,0,0,0,0,0,0,-1,0,0,-1,6,-1
KR_6697392629,420,0,-11,-14,-1,0,2,2,0,0,0,0,1,1,0,0,0,-1,1,0,0,1,24,3,-3,0,1,0,0,-1,0,0,1,5,-1
KR_6659494721,420,-7,-50,-32,-12,-4,4,0,-6,6,0,2,2,4,-2,2,0,-2,2,0,0,-10,-3,-2,-3,5,-1,0,-1,-1,0,-1,-1,2,-1
KR_6723598903,420,-2,-29,-28,-1,1,5,6,-1,2,1,0,2,2,-1,4,3,0,1,1,-1,2,210,-6,0,6,-2,0,0,-1,-1,0,-1,5,-1
KR_6723467389,420,-2,-75,8,-6,4,0,4,-1,3,2,-6,6,0,-3,3,0,0,2,2,0,-9,-7,-4,-2,6,0,0,1,1,1,1,-1,2,-1
KR_6750910884,420,2,48,4,5,1,0,1,-1,1,0,1,1,2,3,0,3,1,1,2,1,7,-1,2,-2,0,1,0,0,1,1,1,1,2,-1
KR_6739797686,420,-1,-64,14,0,-1,1,0,0,1,1,-3,4,1,3,0,3,1,0,1,0,3,-5,-1,-2,3,0,0,-1,-1,1,-1,-1,1,-1
KR_6687904174,420,-6,-60,-45,-15,-3,6,3,-1,3,2,-4,5,1,-4,6,2,-3,3,0,-2,-7,-13,-4,0,4,2,0,-2,-1,-1,-1,-1,2,-1
KR_6755783782,420,-6,-97,-32,-13,4,1,5,1,2,3,0,1,1,-7,8,1,-11,12,1,0,-12,2,4,-5,1,-4,0,-5,-1,1,-1,-1,1,-1
KR_6761289262,420,-2,-53,8,0,-2,2,0,0,2,2,1,3,4,1,0,1,0,0,0,0,2,41,2,-5,3,-21,0,-2,0,0,-1,-1,0,-1
KR_6749795325,420,-4,-63,-8,-7,-2,2,0,-3,4,1,2,2,4,-1,3,2,-3,3,0,0,-4,-6,-1,-1,2,-1,0,-1,0,-1,-1,-1,0,-1
KR_6763959211,420,0,-64,-23,-4,-1,3,2,-2,2,0,0,2,2,-1,1,0,0,0,0,-1,-5,70,-2,-2,4,-4,0,-2,-1,1,-1,-1,3,-1
KR_6755654186,420,0,47,36,0,1,2,3,-1,3,2,1,2,3,-1,5,4,0,1,1,0,0,1,-2,-2,4,-4,0,0,1,1,0,1,4,-1
KR_6750806914,420,-1,5,-24,-3,1,0,1,-6,7,1,2,1,3,0,1,1,0,2,2,0,1,5,-2,-3,5,-1,0,-1,1,-1,-1,-1,2,-1
KR_6760782554,420,-4,-66,-47,-7,-3,3,0,-2,4,2,-3,5,2,2,0,2,-1,3,2,1,1,-226,1,-4,3,-2,0,-1,-1,1,-1,1,3,-1
KR_6743807347,420,0,-49,28,5,1,2,3,1,2,3,6,0,6,-2,4,2,-1,2,1,0,6,2,0,-2,2,-1,0,1,1,1,1,1,2,-1
KR_6683671656,420,-1,32,-11,-4,-1,1,0,-2,2,0,-2,4,2,-4,6,2,5,0,5,0,-7,-7,-5,0,5,0,0,0,-1,-1,-1,-1,2,-1
KR_6733238814,420,1,59,40,4,1,0,1,0,1,1,3,1,4,0,3,3,0,1,1,0,-4,1,2,-2,0,0,0,1,-1,1,1,1,5,-1
KR_6704327167,420,-2,-32,0,0,-2,3,1,0,1,1,1,2,3,1,0,1,0,2,2,0,6,2,-3,0,3,4,0,0,1,-1,-1,1,4,-1
KR_6645180048,420,-2,-24,-8,-5,0,2,2,-2,4,2,3,0,3,-5,5,0,-1,1,0,0,-7,-6,-2,-1,3,3,0,-1,-1,-1,-1,-1,2,-1
KR_6700302135,420,1,-53,-17,1,1,0,1,-1,2,1,-1,2,1,2,4,6,0,2,2,0,0,-28,-2,-1,3,0,0,0,0,1,0,-1,0,-1
KR_6706164015,420,-5,-23,-5,-10,-5,5,0,-1,2,1,-3,3,0,-1,4,3,0,0,0,0,-7,-7,0,0,0,0,0,-1,-1,0,-1,-1,3,-1
KR_6764154813,440,0,-44,7,-7,0,2,2,-3,3,0,-3,5,2,0,3,3,-1,1,0,-3,-19,4,1,-3,2,-4,0,-1,0,0,-1,-1,0,-1
KR_6707247773,420,-7,-149,-28,-17,-5,5,0,-2,2,0,-2,5,3,-9,10,1,1,1,2,1,-12,-11,-3,-3,6,-7,0,-1,0,1,-1,1,0,-1
KR_6744367829,420,-4,-65,5,-8,-1,4,3,-3,4,1,3,2,5,-5,5,0,-2,2,0,0,-11,-5,-2,-2,4,0,0,0,-1,1,-1,1,3,-1
KR_6699798462,420,-4,-36,8,-7,2,1,3,-2,3,1,-3,4,1,-3,3,0,-1,1,0,0,-7,-179,-2,0,2,1,0,-1,-1,-1,-1,-1,4,-1
KR_6710554247,420,-3,38,-8,-7,-3,3,0,1,3,4,-3,6,3,-1,4,3,-1,3,2,2,-7,-164,-1,-3,4,0,0,0,1,-1,0,1,5,-1
KR_6756280132,420,-1,-9,12,-7,-4,6,2,-1,3,2,-2,7,5,0,3,3,0,1,1,0,-13,1,3,-4,1,0,0,2,-1,1,1,-1,2,-1
KR_6731115702,420,3,51,-4,4,4,2,6,0,2,2,1,3,4,3,0,3,-4,4,0,0,-3,6,-5,0,5,-4,0,2,1,1,1,-1,2,-1
KR_6681625423,420,-1,-52,-12,1,-3,3,0,2,2,4,1,2,3,0,1,1,1,0,1,0,2,29,-1,-2,3,-3,0,-1,-1,1,-1,-1,2,-1
KR_6731300476,420,-4,-19,-4,-18,0,1,1,-5,5,0,-5,5,0,-7,9,2,-1,1,0,-3,-21,-13,-2,-3,5,2,0,-2,-1,-1,-1,-1,4,-1
KR_6756634546,420,2,59,4,3,4,0,4,-2,3,1,-1,2,1,1,0,1,1,0,1,1,-1,4,-7,-1,8,7,0,1,1,-1,-1,1,4,-1
KR_6744529358,420,3,47,4,-2,0,3,3,-4,6,2,3,1,4,-3,3,0,2,1,3,-1,-3,-5,3,-6,3,-1,0,1,1,1,1,-1,1,-1
KR_6724321895,420,0,5,8,-5,-3,4,1,3,1,4,1,2,3,-3,4,1,-3,4,1,0,-7,5,0,-2,2,1,0,0,0,1,0,1,0,-1
KR_6762897558,420,1,-11,32,8,2,3,5,0,0,0,2,4,6,3,1,4,1,1,2,0,5,-2,-5,0,5,3,0,0,1,1,0,1,6,-1
KR_6762868927,440,-2,-15,-42,9,2,3,5,0,0,0,4,0,4,0,1,1,3,3,6,0,2,228,0,0,0,0,0,0,0,-1,0,1,0,-1
KR_6731568795,420,-2,31,8,-9,1,1,2,-1,3,2,-8,10,2,-1,2,1,0,0,0,0,-9,-2,0,-5,5,3,0,0,0,0,0,-1,0,-1
KR_6764086120,440,0,-17,23,-1,3,1,4,1,1,2,-12,17,5,1,4,5,6,0,6,-1,-1,4,1,-1,0,0,0,-1,0,1,-1,-1,0,-1
KR_6751664988,420,-1,-15,-20,3,-1,3,2,-3,4,1,-1,2,1,8,6,14,0,0,0,0,8,67,3,-4,1,-4,0,1,-1,0,1,1,6,-1
KR_6758824613,420,1,25,39,5,0,1,1,3,1,4,1,1,2,0,2,2,1,2,3,-1,0,-167,-6,-1,7,-1,0,0,-1,1,1,-1,3,-1
KR_6741024569,420,0,-43,-17,2,1,2,3,7,0,7,-3,3,0,-3,7,4,0,2,2,0,4,-3,0,-7,7,2,0,0,1,1,1,1,2,-1
KR_6763727906,420,1,-29,-34,4,1,3,4,2,0,2,1,2,3,1,0,1,-1,1,0,-1,4,25,2,-4,2,-2,0,0,1,1,-1,-1,2,-1
KR_6752422899,420,-2,-77,40,-6,-4,4,0,0,0,0,-1,3,2,1,3,4,-2,3,1,-1,-4,7,0,-1,1,-2,0,0,-1,-1,-1,-1,1,-1
KR_6760431954,420,-6,-70,-38,-1,-5,5,0,1,2,3,6,1,7,-3,4,1,0,2,2,0,0,101,0,0,0,0,0,-2,-1,-1,-1,1,5,-1
KR_6747213985,420,-5,-117,-8,-13,-1,3,2,0,3,3,-15,16,1,3,1,4,0,2,2,0,-3,-8,-3,-1,4,1,0,-1,-1,0,-1,-1,4,-1
KR_6704032927,420,3,-4,24,-8,0,2,2,-6,6,0,0,4,4,-2,4,2,0,2,2,0,-8,-6,0,-2,2,2,0,-1,-1,1,-1,-1,1,-1
KR_6746573117,420,-1,-5,-8,0,-4,6,2,5,0,5,1,2,3,-1,1,0,-1,2,1,0,4,-7,1,-5,4,4,0,-1,1,0,-1,1,3,-1
KR_6659479499,420,1,3,0,-3,-4,5,1,-1,2,1,3,4,7,0,3,3,-1,1,0,0,-10,-10,-3,-3,6,1,0,-1,-1,0,-1,1,6,-1
KR_6630182072,420,-4,-27,-24,-5,-1,1,0,-3,3,0,2,2,4,-6,7,1,3,1,4,0,-7,-4,-2,0,2,2,0,0,1,0,0,-1,2,-1
KR_6745300531,420,0,48,-15,1,2,0,2,-2,5,3,-1,1,0,2,0,2,0,2,2,0,-1,112,-3,-2,5,9,0,2,-1,1,1,1,1,-1
KR_6749175960,440,-3,-29,-4,-7,-2,2,0,-3,4,1,1,4,5,2,3,5,-5,5,0,0,-6,18,-1,-1,2,-1,0,0,-1,0,0,1,1,-1
KR_6729309962,420,0,-25,-24,3,4,0,4,-3,5,2,1,1,2,0,2,2,1,2,3,0,4,3,1,-3,2,0,0,0,-1,0,0,1,1,-1
KR_6640723117,420,-1,82,-28,1,0,1,1,-1,4,3,0,1,1,1,2,3,1,0,1,0,6,-1,-3,0,3,2,0,0,1,1,0,-1,3,-1
KR_6683901944,420,2,22,-1,4,3,1,4,2,0,2,0,3,3,1,1,2,-2,2,0,0,8,-36,-3,-2,5,32,0,-1,-1,-1,-1,1,6,-1
KR_6737609693,420,-1,7,2,-4,2,0,2,-7,7,0,4,1,5,-2,3,1,-1,2,1,0,-7,4,-1,-1,2,-1,0,-1,-1,-1,-1,-1,2,-1
KR_6717721237,420,-3,-31,-4,-8,1,1,2,-2,2,0,-1,1,0,-4,4,0,-2,3,1,0,-6,-5,4,-4,0,-7,0,0,1,-1,-1,-1,6,-1
KR_6763942287,420,-5,-63,-26,-8,-1,1,0,-2,3,1,-1,4,3,-2,3,1,-2,2,0,0,-8,-316,0,-2,2,0,0,-2,1,-1,-1,-1,1,-1
KR_6730293501,420,-2,3,-14,-9,-2,3,1,-1,2,1,1,1,2,-6,7,1,-1,1,0,-2,-9,2,-3,-1,4,0,0,-1,-1,-1,-1,-1,1,-1
KR_6760413951,420,-3,-26,20,-10,-7,7,0,1,1,2,-2,2,0,0,1,1,-2,2,0,0,-3,3,4,-6,2,-6,0,0,-1,-1,-1,1,6,-1
KR_6748325879,420,-2,44,-10,-5,-2,3,1,-2,5,3,-2,6,4,4,2,6,-3,3,0,0,-11,-5,2,-6,4,0,0,-1,-1,-1,-1,1,2,-1
KR_6758872990,440,3,44,12,-3,0,2,2,-7,10,3,0,4,4,-2,5,3,6,2,8,-2,-10,-2,-1,0,1,-1,0,0,-1,-1,0,-1,5,-1
KR_6762430405,420,-1,-38,4,-3,-3,3,0,0,2,2,-2,7,5,1,1,2,1,0,1,0,2,5,3,-7,4,0,0,0,-1,-1,0,1,6,-1
KR_6658449632,420,-1,-76,-6,0,-1,3,2,2,2,4,6,3,9,-6,8,2,-1,2,1,3,2,1,-3,0,3,-3,0,-1,1,1,-1,-1,4,-1
KR_6710316620,420,1,18,-20,0,2,1,3,0,6,6,3,3,6,-5,5,0,0,0,0,-1,4,13,1,-4,3,-2,0,0,1,-1,-1,-1,5,-1
KR_6700138976,420,1,-4,-11,0,-2,3,1,1,2,3,1,1,2,0,0,0,0,1,1,0,2,0,0,-1,1,3,0,0,1,-1,-1,1,3,-1
KR_6685242350,420,-3,-4,-20,-2,-2,2,0,2,0,2,-5,5,0,1,0,1,2,0,2,0,7,-3,0,-2,2,0,0,0,-1,1,-1,-1,5,-1
KR_6760600734,420,0,28,-7,-5,0,3,3,-3,5,2,1,3,4,-1,3,2,-2,2,0,0,-11,-7,-1,-1,2,-1,0,0,-1,0,0,1,2,-1
KR_6684168458,420,-3,19,-43,-5,-1,2,1,-7,9,2,2,2,4,1,2,3,0,1,1,-3,-8,7,5,-6,1,-2,0,0,-1,-1,-1,-1,4,-1
KR_6760118211,420,-1,-7,11,1,0,2,2,2,1,3,1,3,4,-2,2,0,0,0,0,0,-3,-165,-1,-4,5,1,0,0,1,1,-1,1,4,-1
KR_6753769847,420,0,74,-1,-5,-2,3,1,1,1,2,1,4,5,-5,5,0,0,0,0,-2,-4,-4,0,-2,2,-2,0,1,-1,1,1,-1,2,-1
KR_6757118565,420,-3,-95,-28,-2,-2,4,2,-1,2,1,0,4,4,2,0,2,-1,2,1,0,-3,-31,2,-4,2,3,0,-1,-1,1,-1,1,3,-1
KR_6758853666,420,-3,-33,0,-6,-2,3,1,-4,6,2,-1,9,8,2,0,2,-1,1,0,-1,1,-13,-3,0,3,3,0,-1,1,-1,-1,-1,3,-1
KR_6739519311,420,3,77,-32,5,2,2,4,-3,6,3,-1,4,3,6,1,7,1,2,3,0,1,-28,1,-2,1,3,0,0,1,-1,1,1,2,-1
KR_6725033194,420,2,-29,-14,5,0,3,3,0,1,1,3,1,4,2,0,2,0,0,0,0,1,4,0,-2,2,0,0,-1,-1,-1,-1,1,5,-1
KR_6734966176,440,-5,42,-52,-5,0,2,2,-4,5,1,0,4,4,-4,4,0,3,0,3,0,-4,-19,-1,-3,4,0,0,0,1,-1,0,-1,1,-1
KR_6751298149,420,0,8,-20,2,2,0,2,-1,4,3,3,0,3,0,5,5,-2,3,1,-1,2,-8,2,-3,1,0,0,-1,-1,-1,-1,-1,4,-1
KR_6683541195,420,-1,-50,8,-2,-1,1,0,-1,1,0,1,3,4,5,2,7,-6,7,1,-1,-6,2,1,-2,1,0,0,-1,1,-1,-1,-1,2,-1
KR_6747108537,420,-2,-46,-13,0,0,0,0,1,0,1,1,3,4,-2,7,5,0,1,1,1,9,-22,6,-8,2,-2,0,-1,-1,0,-1,1,1,-1
KR_6729465038,420,0,-93,24,-4,-6,6,0,0,0,0,1,1,2,-1,5,4,2,0,2,1,-1,-4,0,-1,1,0,0,-2,1,-1,-1,1,6,-1
KR_6723400967,420,-2,-14,20,-10,2,0,2,-4,6,2,-2,2,0,-5,5,0,-1,2,1,0,-10,-12,2,-4,2,-2,0,0,1,1,-1,-1,3,-1
KR_6730779587,420,-6,-37,-56,-1,-4,4,0,-1,3,2,-1,2,1,1,4,5,4,2,6,1,12,3,-1,-2,3,1,0,-1,0,0,1,1,0,-1
KR_6750708635,440,-1,-32,29,-7,-3,3,0,-1,2,1,-4,5,1,2,4,6,-1,3,2,0,-10,28,-5,0,5,-1,0,0,1,1,1,1,2,-1
KR_6665631916,420,-3,-2,-16,-4,-3,4,1,1,0,1,-3,3,0,1,0,1,0,1,1,0,-2,-2,0,-2,2,-3,0,0,0,0,0,-1,0,-1
KR_6737293195,420,-4,-22,-33,-8,-1,1,0,-1,1,0,1,6,7,-6,7,1,-1,1,0,0,-13,39,10,-13,3,-18,0,0,-1,-1,1,-1,2,-1
KR_6722705748,420,-4,-59,-29,-6,-3,4,1,-3,3,0,-3,4,1,3,0,3,0,1,1,-1,-4,-4,-6,-1,7,0,0,-1,1,-1,-1,-1,4,-1
KR_6761171751,420,0,53,17,-2,-1,3,2,1,1,2,-3,3,0,1,4,5,0,1,1,0,-3,3,-2,0,2,1,0,0,-1,1,0,-1,5,-1
KR_6705505718,420,-1,-82,1,-3,0,1,1,-2,2,0,1,3,4,1,6,7,-3,4,1,0,1,3,3,-4,1,-1,0,0,-1,-1,-1,1,5,-1
KR_6763788621,420,0,57,-8,-5,1,1,2,3,0,3,0,1,1,-9,10,1,0,0,0,0,-10,2,-6,-2,8,-2,0,0,-1,1,-1,-1,6,-1
KR_6703296267,420,-3,-36,-20,0,3,0,3,2,2,4,0,0,0,-6,7,1,1,0,1,0,3,12,4,-5,1,-5,0,0,1,1,0,1,5,-1
KR_6727901293,420,-3,-86,-37,-3,-1,3,2,-4,4,0,3,1,4,0,3,3,-1,2,1,0,-1,4,3,-3,0,-2,0,-3,-1,-1,-1,-1,2,-1
KR_6748367941,420,0,-32,16,-6,2,1,3,-3,3,0,-2,4,2,-2,2,0,-1,1,0,-2,-7,-8,2,-6,4,-3,0,-1,-1,-1,-1,-1,6,-1
KR_6762999712,420,0,3,-19,-1,-1,1,0,-2,3,1,3,0,3,-3,3,0,2,2,4,0,-4,-19,-4,-3,7,1,0,0,1,-1,0,-1,5,-1
KR_6622839225,420,-1,-47,-16,1,2,1,3,-1,2,1,-2,3,1,2,0,2,0,1,1,1,5,8,1,-3,2,-1,0,-2,0,0,-1,1,0,-1
KR_6750166611,420,2,-47,20,3,1,0,1,3,2,5,3,1,4,-1,1,0,-3,3,0,0,2,-41,1,-3,2,28,0,0,-1,-1,-1,-1,3,-1
KR_6763337778,420,-4,-6,-24,-9,2,0,2,-4,5,1,-4,7,3,-3,5,2,0,0,0,0,-9,-1,1,-1,0,1,0,-2,-1,0,-1,-1,4,-1
KR_6751569331,420,-2,-90,-12,-4,-6,6,0,0,1,1,2,1,3,1,0,1,-1,2,1,0,-1,-110,-4,-1,5,2,0,0,0,1,-1,-1,0,-1
KR_6762809984,420,5,120,8,12,-3,4,1,4,1,5,3,0,3,4,0,4,4,0,4,3,17,19,-7,-2,9,1,0,2,1,-1,1,1,6,-1
KR_6693568636,420,-5,-81,-31,-7,0,2,2,0,3,3,-1,2,1,-3,3,0,-3,3,0,0,-6,103,-1,-2,3,4,0,-1,-1,1,-1,-1,5,-1
KR_6718911411,420,2,27,20,-2,0,1,1,-2,3,1,3,1,4,-4,4,0,1,1,2,0,-3,-1,2,-5,3,-1,0,-1,1,1,-1,-1,2,-1
KR_6731143523,420,0,-81,4,-6,-1,2,1,3,0,3,-1,3,2,-8,9,1,1,0,1,-1,-5,2,-1,-3,4,0,0,-1,0,1,-1,-1,0,-1
KR_6593319175,420,-1,-7,-12,-2,4,0,4,-6,6,0,-1,2,1,-1,2,1,2,2,4,0,-7,8,-1,-2,3,-2,0,-1,-1,-1,-1,1,6,-1
KR_6717006832,420,-1,30,9,-3,0,4,4,1,2,3,-2,4,2,-1,1,0,-1,1,0,1,-4,-6,-3,-1,4,-2,0,0,1,-1,0,1,1,-1
KR_6742270394,420,0,41,2,1,7,0,7,0,0,0,-2,6,4,-5,6,1,1,0,1,1,-8,2,-2,-2,4,0,0,-1,-1,1,-1,1,3,-1
KR_6686122779,440,-2,-39,-37,-1,1,1,2,-3,4,1,-2,2,0,0,2,2,3,1,4,0,3,-75,1,-5,4,-4,0,-1,-1,-1,-1,1,6,-1
KR_6751570341,420,3,-79,16,1,0,1,1,1,2,3,0,3,3,0,2,2,0,1,1,0,4,-109,-4,-2,6,3,0,0,1,-1,-1,-1,5,-1
KR_6669827663,420,-1,12,-16,-5,-2,4,2,-4,4,0,-1,4,3,3,2,5,-1,2,1,0,0,-8,-1,-2,3,2,0,0,-1,1,1,-1,6,-1
KR_6686068556,420,-2,34,-23,-5,-4,4,0,1,1,2,-2,3,1,1,1,2,-1,1,0,0,1,-1,0,-2,2,1,0,1,-1,-1,-1,1,6,-1
KR_6750237114,420,2,13,-8,4,-3,3,0,0,1,1,8,2,10,-1,2,1,0,2,2,0,1,22,0,-2,2,0,0,1,-1,1,1,1,2,-1
KR_6727543635,420,-2,-5,15,-7,2,0,2,-4,4,0,-3,5,2,-1,2,1,-1,1,0,0,-8,-103,1,-3,2,-1,0,1,0,1,1,1,0,-1
KR_6711894790,420,-1,-29,4,-3,0,1,1,-2,3,1,-2,2,0,0,2,2,1,0,1,-1,0,-1,2,-4,2,0,0,-1,-1,-1,-1,-1,3,-1
KR_6734939592,420,0,-46,52,-6,1,0,1,6,0,6,-7,7,0,-4,4,0,-2,3,1,0,-6,-13,-1,-1,2,-4,0,0,-1,-1,0,-1,4,-1
KR_6759540589,420,2,26,24,5,-6,7,1,3,0,3,1,0,1,4,1,5,3,0,3,1,8,-4,0,-3,3,3,0,0,1,-1,-1,1,3,-1
KR_6760508582,440,-3,-80,-2,-3,-1,1,0,-4,6,2,-1,2,1,1,0,1,2,2,4,0,5,2,-2,0,2,0,0,-1,1,-1,1,-1,6,-1
KR_6644213118,420,-2,-5,-8,-9,-2,3,1,-5,6,1,1,2,3,0,4,4,-3,3,0,1,-9,4,-2,-1,3,0,0,-1,-1,1,-1,1,2,-1
KR_6740437280,420,-1,-11,20,-1,-2,2,0,0,4,4,-1,1,0,2,0,2,0,1,1,0,3,-26,-2,-1,3,22,0,0,-1,1,0,1,3,-1
KR_6739354493,420,-3,-39,-1,-7,-1,2,1,-4,5,1,2,2,4,-4,4,0,0,0,0,0,-10,165,-1,-3,4,-1,0,0,0,-1,0,1,0,-1
KR_6759116266,420,-1,-42,-32,-2,4,0,4,0,5,5,-1,4,3,-6,8,2,1,1,2,-1,-3,10,0,-3,3,0,0,0,-1,1,0,-1,4,-1
KR_6764044914,420,-3,-53,47,-1,-1,1,0,-3,3,0,2,2,4,1,0,1,0,0,0,0,-4,29,-1,-3,4,-3,0,0,1,-1,0,1,1,-1
KR_6717999428,420,-3,-37,-28,-7,-3,4,1,-2,4,2,0,3,3,-2,3,1,0,0,0,0,-5,-11,0,-3,3,3,0,-1,-1,-1,-1,-1,1,-1
KR_6761157217,420,2,70,0,-8,-1,4,3,2,0,2,-11,14,3,1,1,2,1,0,1,0,-4,10,1,-5,4,-1,0,0,1,-1,1,1,1,-1
KR_6676452425,420,0,9,-16,-6,3,2,5,0,3,3,-3,3,0,-1,3,2,-5,5,0,0,-9,245,1,-5,4,-1,0,1,-1,1,-1,-1,4,-1
KR_6711126890,420,0,37,-19,3,5,0,5,0,2,2,-4,6,2,1,1,2,1,0,1,0,1,-1,-4,-1,5,-3,0,0,-1,-1,1,1,3,-1
KR_6676255199,420,-3,-7,-51,-10,-3,3,0,-7,8,1,-1,2,1,2,2,4,-1,2,1,0,-12,6,6,-6,0,0,0,0,-1,-1,0,-1,2,-1
KR_6762086133,420,2,22,-21,3,2,3,5,-3,4,1,-2,2,0,5,1,6,1,2,3,-1,1,-14,-1,-2,3,3,0,0,-1,1,1,-1,1,-1
KR_6754031104,420,-5,-83,-12,-8,-4,4,0,1,1,2,-3,7,4,-2,6,4,0,3,3,0,5,-302,1,-1,0,-1,0,-1,-1,-1,-1,1,4,-1
KR_6750781143,420,1,20,0,4,4,1,5,1,2,3,-3,3,0,2,1,3,0,2,2,0,6,-7,0,-4,4,5,0,0,1,0,1,1,6,-1
KR_6665708508,420,-2,-20,-16,-8,2,0,2,-1,2,1,-4,5,1,-4,5,1,-1,2,1,0,-6,238,1,-4,3,-3,0,0,1,-1,0,-1,1,-1
KR_6734864317,420,-6,-89,4,-15,-5,6,1,0,1,1,0,2,2,-6,6,0,-4,4,0,0,-7,5,-5,-2,7,-7,0,-3,-1,-1,-1,1,3,-1
KR_6711198465,420,3,-14,20,6,3,1,4,0,3,3,0,3,3,3,0,3,0,1,1,0,7,-302,5,-8,3,-2,0,0,1,1,1,1,2,-1
KR_6749693469,420,-1,-24,54,-3,-4,5,1,1,1,2,-4,6,2,5,0,5,-1,2,1,0,3,4,1,-2,1,-1,0,1,1,1,-1,-1,2,-1
KR_6723000457,420,-1,18,-3,-7,2,1,3,-1,4,3,-1,4,3,-7,7,0,0,0,0,0,-12,201,-1,-1,2,-27,0,0,1,-1,-1,-1,2,-1
KR_6709784905,420,0,31,-16,5,1,0,1,-1,4,3,-2,4,2,7,1,8,0,1,1,0,10,-1,-1,-2,3,1,0,-1,0,-1,-1,1,0,-1
KR_6748733372,420,-7,-57,-12,-25,-1,1,0,-2,3,1,-7,8,1,-11,12,1,-4,4,0,0,-23,36,-2,-2,4,-35,0,-5,-1,1,-1,-1,6,-1
KR_6748790902,420,-2,2,8,-6,2,2,4,1,1,2,-4,5,1,-5,7,2,0,1,1,0,-4,4,-2,-2,4,-2,0,0,0,-1,0,1,0,-1
KR_6643711778,420,-5,-26,-30,-16,-2,2,0,-2,3,1,-4,4,0,-7,9,2,-1,1,0,0,-17,-2,-5,-2,7,1,0,-2,-1,-1,-1,-1,3,-1
KR_6731214493,420,2,-58,21,2,2,0,2,3,0,3,1,4,5,-3,4,1,-1,3,2,-1,-4,-10,-3,-2,5,-2,0,0,1,-1,-1,-1,3,-1
KR_6717159788,420,1,6,17,1,-6,7,1,5,3,8,5,0,5,-3,5,2,0,4,4,0,2,-7,-1,-1,2,3,0,1,-1,-1,1,-1,2,-1
KR_6662853815,420,0,73,-21,0,4,1,5,-3,8,5,3,1,4,-1,5,4,-3,4,1,2,-9,3,-4,-3,7,1,0,1,-1,0,1,1,1,-1
KR_6727858776,420,-1,-9,2,-7,-1,1,0,1,2,3,-4,5,1,-3,3,0,0,0,0,0,-5,-11,-2,-3,5,2,0,-1,1,-1,-1,-1,1,-1
KR_6728564599,440,3,49,20,-2,0,0,0,-5,5,0,4,1,5,-2,3,1,1,0,1,0,-6,-16,-2,0,2,1,0,1,1,0,1,1,6,-1
KR_6753693820,420,0,-2,-13,-2,-1,2,1,-3,4,1,1,2,3,-1,1,0,2,0,2,0,0,5,1,-4,3,0,0,0,0,0,-1,1,0,-1
KR_6758777825,420,1,38,-24,2,0,0,0,0,5,5,1,3,4,0,2,2,1,1,2,0,0,5,1,-4,3,-3,0,0,-1,-1,-1,1,5,-1
KR_6646973234,420,1,-36,-24,2,1,0,1,-4,4,0,1,3,4,5,0,5,-1,2,1,0,3,298,-4,-1,5,-1,0,0,-1,-1,-1,-1,2,-1
KR_6723784848,420,-3,16,-8,-10,0,2,2,-2,2,0,-2,4,2,-7,8,1,1,1,2,0,-7,-285,-2,-2,4,-4,0,0,-1,-1,-1,-1,2,-1
KR_6714680545,440,-3,-91,-8,-5,0,1,1,0,3,3,-3,4,1,-2,5,3,0,2,2,0,-5,-14,-4,-1,5,-1,0,-2,-1,1,-1,-1,4,-1
KR_6735816801,420,-1,-58,-8,-9,-1,2,1,-3,4,1,-9,9,0,1,2,3,3,1,4,0,-8,-19,-1,-3,4,3,0,0,-1,0,0,-1,6,-1
KR_6751045949,440,-4,-51,-64,-6,-3,4,1,0,1,1,-4,4,0,1,3,4,0,1,1,1,-1,-4,0,-2,2,-2,0,-1,1,0,-1,1,5,-1
KR_6751487467,440,-1,2,28,-11,-2,2,0,-2,3,1,-5,8,3,-2,5,3,0,2,2,-1,-14,-15,-3,-1,4,3,0,0,-1,1,-1,-1,2,-1
KR_6744218242,420,1,14,20,-4,-2,2,0,2,0,2,-1,1,0,0,1,1,-3,3,0,0,-6,-18,-10,0,10,4,0,1,-1,0,1,-1,1,-1
KR_6735304593,420,-3,-126,-10,-4,0,2,2,1,2,3,-1,2,1,-4,4,0,0,1,1,0,-4,-2,2,-6,4,0,0,-1,-1,-1,-1,-1,2,-1
KR_6721291671,420,-3,-86,-12,-9,-4,5,1,-1,4,3,0,1,1,-2,3,1,-2,3,1,-2,-5,-50,-4,0,4,1,0,-2,0,-1,-1,-1,0,-1
KR_6724074570,440,-5,-162,-20,-10,-1,3,2,-7,7,0,-3,3,0,-1,5,4,2,1,3,0,-5,58,-3,-4,7,-24,0,-1,0,1,-1,-1,0,-1
KR_6729294838,420,-3,-82,20,-3,0,1,1,-1,4,3,4,1,5,-7,7,0,1,0,1,0,-1,-232,1,-2,1,-3,0,-1,-1,1,-1,1,4,-1
KR_6693294036,420,-2,-6,11,4,-5,6,1,2,3,5,3,0,3,0,3,3,4,2,6,0,2,0,-2,-5,7,-1,0,-1,0,0,-1,-1,0,-1
KR_6757369409,440,0,1,22,5,-1,8,7,5,0,5,-2,3,1,3,0,3,0,1,1,0,10,-11,-1,-3,4,0,0,1,1,-1,-1,1,6,-1
KR_6737455566,420,0,-40,0,3,-2,3,1,3,4,7,0,2,2,2,1,3,0,1,1,0,1,-48,-4,0,4,22,0,-1,0,-1,-1,-1,0,-1
KR_6763575220,420,2,-33,12,2,0,3,3,2,0,2,3,0,3,-1,2,1,-2,3,1,0,4,4,-1,-4,5,1,0,-1,1,1,-1,-1,2,-1
KR_6760887755,420,0,-28,-8,-5,-2,4,2,-1,1,0,-1,3,2,-6,10,4,5,2,7,-2,-9,-1,1,-2,1,-4,0,-1,-1,0,-1,-1,5,-1
KR_6671840158,420,-8,-130,-39,-10,-2,2,0,2,3,5,-4,6,2,-3,7,4,-3,4,1,0,2,-15,0,-3,3,-1,0,-3,0,-1,-1,-1,0,-1
KR_6741041096,420,-3,-75,-9,-5,-5,6,1,2,3,5,-2,3,1,0,1,1,0,0,0,-1,2,0,1,-4,3,-1,0,0,-1,0,-1,-1,2,-1
KR_6739858540,420,-2,-104,7,-4,2,2,4,-1,2,1,-1,2,1,-1,3,2,-3,3,0,0,-6,-12,-2,-2,4,-1,0,-1,-1,-1,-1,1,5,-1
KR_6761091230,420,0,6,-32,1,0,1,1,4,4,8,1,1,2,-4,5,1,0,0,0,0,-1,8,-1,-4,5,-2,0,0,-1,1,-1,-1,2,-1
KR_6731500442,420,-4,-73,-16,-7,1,4,5,-1,3,2,-1,3,2,-5,9,4,-1,1,0,1,7,1,1,-3,2,2,0,-3,1,-1,-1,1,1,-1
KR_6751344631,420,1,-12,-9,3,1,2,3,5,0,5,5,1,6,-9,10,1,1,0,1,0,3,-8,0,-1,1,-2,0,2,-1,1,1,-1,3,-1
KR_6715445357,420,1,13,-12,7,-4,5,1,2,2,4,-1,3,2,7,0,7,3,1,4,-1,9,28,-6,0,6,-11,0,1,0,-1,1,-1,0,-1
KR_6733118132,420,-1,-21,17,-1,-1,2,1,-4,4,0,3,1,4,-1,1,0,2,2,4,0,4,-8,0,-1,1,2,0,-1,0,0,-1,1,0,-1
KR_6699333738,420,4,28,12,7,4,0,4,-2,3,1,6,0,6,0,4,4,-1,1,0,0,3,1,1,-3,2,-4,0,1,1,-1,-1,-1,2,-1
KR_6658381013,420,2,9,-32,1,5,0,5,0,4,4,-1,1,0,-3,3,0,0,1,1,0,0,-3,-5,0,5,-2,0,2,1,0,1,1,6,-1
KR_6699878601,420,-3,-11,-16,-11,-5,5,0,-4,4,0,-1,1,0,-1,3,2,0,0,0,0,-8,3,1,-2,1,-1,0,-1,-1,-1,-1,-1,4,-1
KR_6738154315,420,0,30,-3,-8,6,0,6,-7,8,1,-1,2,1,-5,6,1,-1,2,1,-3,-23,2,0,-4,4,1,0,0,-1,1,-1,-1,2,-1
KR_6760027976,420,-1,-86,54,4,8,6,14,1,0,1,-2,3,1,-4,4,0,1,3,4,2,-7,-1,1,-4,3,1,0,-1,-1,1,-1,1,6,-1
KR_6735647089,420,-1,-43,-1,2,-2,3,1,-1,1,0,4,1,5,1,0,1,0,1,1,0,1,0,-3,0,3,1,0,0,0,0,0,-1,0,-1
KR_6757844619,420,-1,-79,5,-6,-4,4,0,-1,1,0,3,3,6,-3,3,0,-1,1,0,0,-5,1,1,-1,0,0,0,0,1,1,0,1,6,-1
KR_6723799199,420,0,50,33,-3,2,1,3,-2,6,4,0,1,1,-3,3,0,0,2,2,2,-1,10,6,-8,2,0,0,2,1,-1,1,1,2,-1
KR_6761051463,420,-2,1,4,-1,-6,6,0,5,2,7,0,0,0,1,1,2,-1,1,0,0,5,19,0,-1,1,-14,0,0,0,0,-1,-1,0,-1
KR_6667421220,420,-2,-8,-36,1,-4,4,0,1,0,1,0,5,5,4,0,4,0,0,0,0,7,6,1,-2,1,-1,0,0,1,-1,-1,1,1,-1
KR_6697916915,420,1,-90,-24,1,-5,5,0,1,3,4,-2,3,1,4,4,8,3,1,4,-1,-1,224,-4,-2,6,1,0,0,-1,-1,0,-1,3,-1
KR_6727182776,420,-3,-94,-19,-4,1,0,1,-2,5,3,1,2,3,-4,9,5,0,3,3,0,-6,-26,0,-2,2,-1,0,-1,-1,1,-1,-1,5,-1
KR_6702932767,420,-5,-8,15,-9,-4,4,0,-2,2,0,-3,6,3,-1,4,3,1,1,2,0,-5,128,0,-2,2,0,0,0,1,0,-1,-1,4,-1
KR_6756244883,420,1,-37,-16,0,2,0,2,0,1,1,-4,6,2,1,3,4,1,0,1,0,0,2,0,-3,3,-3,0,-2,0,-1,-1,1,0,-1
KR_6755303113,420,0,43,-20,-3,0,1,1,0,0,0,-3,3,0,-2,3,1,2,1,3,1,-5,-140,3,-9,6,0,0,2,-1,1,1,1,5,-1
KR_6683406522,420,-5,-105,4,-13,-1,3,2,0,5,5,-5,8,3,-4,4,0,-3,3,0,-1,-11,6,-1,-3,4,2,0,-1,1,1,-1,-1,1,-1
KR_6712240464,420,2,37,0,4,6,0,6,-1,4,3,1,2,3,0,3,3,-2,2,0,1,-1,4,2,-2,0,1,0,1,-1,0,1,1,2,-1
KR_6712882289,420,0,4,0,2,4,1,5,-8,10,2,-1,2,1,4,1,5,3,1,4,0,-4,-3,0,-2,2,0,0,0,0,0,0,1,0,-1
KR_6729881624,420,6,68,20,8,7,0,7,0,0,0,0,5,5,-1,3,2,2,1,3,1,-8,-7,-2,-1,3,-1,0,2,-1,0,1,1,3,-1
KR_6694189715,420,-2,-40,36,1,-3,4,1,-1,5,4,3,3,6,4,3,7,-2,2,0,1,-8,-55,2,-4,2,20,0,0,1,-1,-1,1,5,-1
KR_6756827870,420,2,-22,20,1,0,1,1,0,3,3,0,1,1,0,0,0,1,0,1,0,-1,-29,-2,-1,3,6,0,0,0,1,0,-1,0,-1
KR_6763973414,420,3,46,3,-2,-3,4,1,0,5,5,0,2,2,1,0,1,0,1,1,1,4,20,3,-3,0,-1,0,-1,-1,1,1,1,6,-1
KR_6717901229,420,1,17,-8,1,0,2,2,0,4,4,-1,1,0,1,2,3,1,1,2,0,-2,-3,-3,-3,6,3,0,-2,-1,-1,-1,1,3,-1
KR_6707676405,420,-2,-41,8,-6,-4,5,1,1,2,3,-5,6,1,3,1,4,-1,2,1,-1,0,-10,-2,-3,5,-3,0,-1,-1,-1,-1,-1,2,-1
KR_6762098131,420,-1,79,-24,3,0,1,1,-1,2,1,1,1,2,1,0,1,2,0,2,0,4,-120,-1,-3,4,4,0,0,0,-1,0,-1,0,-1
KR_6636962789,420,-1,-16,4,-2,1,2,3,-3,4,1,0,2,2,0,6,6,0,2,2,0,-6,57,3,-6,3,11,0,1,-1,1,1,-1,1,-1
KR_6749250588,420,-5,-80,-48,-6,-6,6,0,-3,3,0,2,1,3,2,1,3,-1,2,1,0,-5,-10,-5,-2,7,4,0,-3,0,-1,-1,1,0,-1
KR_6708539968,420,-4,-10,-12,-16,0,3,3,-1,2,1,-7,7,0,-7,10,3,-1,1,0,-1,-17,-23,-2,0,2,-1,0,0,-1,-1,1,-1,1,-1
KR_6745115366,420,-3,-4,-23,-1,-2,6,4,-1,1,0,4,1,5,2,4,6,-4,4,0,-1,-3,7,-1,-1,2,2,0,0,-1,1,0,-1,1,-1
KR_6763291407,420,1,81,29,-2,1,1,2,-2,3,1,8,3,11,-6,8,2,-3,5,2,2,-3,2,1,-3,2,0,0,3,1,-1,1,1,1,-1
KR_6739715557,420,-2,29,-4,-7,4,0,4,2,1,3,1,3,4,-11,11,0,-3,3,0,1,-1,-241,-4,-1,5,0,0,-1,-1,-1,-1,1,2,-1
KR_6739618405,420,2,-36,4,5,3,2,5,-2,4,2,4,1,5,-1,2,1,1,3,4,1,5,-308,2,-4,2,-2,0,0,-1,1,1,1,6,-1
KR_6739667166,420,-2,-53,-12,-4,2,0,2,-1,3,2,-7,7,0,1,3,4,1,1,2,1,2,-25,0,-2,2,2,0,-1,-1,1,-1,1,3,-1
KR_6673478315,420,-3,-53,12,-10,-2,3,1,-2,5,3,0,1,1,-4,4,0,-2,4,2,0,-11,156,-3,-1,4,-1,0,0,-1,0,0,-1,1,-1
KR_6733904826,420,-2,-30,20,-6,-6,7,1,2,0,2,2,0,2,-5,5,0,1,0,1,0,-6,4,-2,0,2,-4,0,-1,-1,0,-1,-1,3,-1
KR_6722696778,420,-3,-64,3,-18,-2,4,2,-2,2,0,-7,8,1,-9,10,1,2,2,4,-1,-8,394,-2,-1,3,3,0,-2,-1,1,-1,-1,1,-1
KR_6669525099,420,-3,-31,-39,-8,0,1,1,-4,4,0,-5,7,2,5,0,5,-4,4,0,0,-7,-37,2,-3,1,-1,0,0,-1,0,-1,-1,6,-1
KR_6679766420,420,-2,-5,-23,-8,0,1,1,-9,10,1,-1,5,4,1,4,5,1,3,4,0,-5,-313,0,-4,4,1,0,0,-1,-1,-1,-1,2,-1
KR_6758256132,440,0,-53,-12,-3,4,1,5,1,1,2,-2,3,1,-5,6,1,-1,1,0,0,-9,5,0,-4,4,-6,0,0,-1,-1,0,1,6,-1
KR_6716604467,420,-2,-46,14,-1,3,1,4,3,0,3,-1,1,0,-5,6,1,-1,1,0,-1,-5,-8,-3,-1,4,-5,0,-1,-1,-1,-1,-1,3,-1
KR_6694021674,420,-3,1,-12,-2,-4,4,0,-1,3,2,3,1,4,3,0,3,-3,3,0,0,-6,-17,5,-6,1,-6,0,-2,1,-1,-1,1,4,-1
KR_6734528197,440,-1,-54,12,-2,0,2,2,2,2,4,-1,4,3,-2,4,2,-1,3,2,0,4,3,3,-7,4,-3,0,0,0,0,0,1,0,-1
KR_6728551922,420,-2,-32,-6,-4,1,1,2,1,4,5,1,5,6,-3,4,1,-4,5,1,1,-6,1,2,-4,2,0,0,-1,1,-1,-1,1,3,-1
KR_6720705327,420,1,19,0,3,-1,1,0,0,1,1,4,2,6,0,1,1,0,1,1,0,-4,-13,2,-4,2,-1,0,-1,-1,-1,-1,-1,4,-1
KR_6729403357,420,-2,-5,25,-3,-2,3,1,-2,3,1,-1,3,2,1,0,1,1,0,1,0,-1,34,0,-3,3,-2,0,0,-1,-1,0,1,4,-1
KR_6754708410,420,-3,8,-48,-7,-1,2,1,-6,8,2,2,1,3,-2,3,1,0,1,1,0,-11,2,2,-6,4,-1,0,2,-1,1,1,1,4,-1
KR_6764302995,420,-4,-82,-36,-7,-4,5,1,-4,5,1,4,0,4,-3,4,1,0,1,1,0,-4,-16,4,-5,1,-5,0,-1,0,0,-1,-1,0,-1
KR_6751922998,420,0,40,-55,2,-1,2,1,-4,5,1,3,0,3,4,0,4,0,0,0,0,2,8,3,-7,4,2,0,0,-1,-1,0,-1,4,-1
KR_6746236395,420,-2,-12,-11,-5,0,2,2,1,1,2,-8,9,1,2,1,3,0,0,0,0,-1,-24,-7,-1,8,3,0,1,-1,1,1,-1,3,-1
KR_6749658184,420,-2,-12,-12,-2,-1,2,1,-1,3,2,-4,5,1,2,4,6,2,4,6,-1,-8,-5,-1,-2,3,5,0,0,1,1,0,-1,6,-1
KR_6741738043,420,-5,-40,-24,-8,-2,3,1,4,3,7,-5,5,0,-5,6,1,0,0,0,0,-4,2,2,-4,2,0,0,0,-1,1,0,-1,4,-1
KR_6687347708,440,-2,-14,12,-9,-3,4,1,-1,2,1,-7,7,0,1,2,3,1,0,1,0,1,-2,6,-7,1,-3,0,-1,0,-1,-1,-1,0,-1
KR_6762827216,420,-6,-61,-16,-12,-2,3,1,1,2,3,-7,9,2,-3,3,0,-1,2,1,0,-16,105,2,-4,2,-3,-1,-5,-1,-1,-1,1,4,-1
KR_6730553994,420,-2,19,-32,-2,-1,4,3,2,3,5,-1,4,3,-2,2,0,0,1,1,0,-4,3,0,-1,1,2,0,0,-1,0,0,1,4,-1
KR_6753100839,420,-7,-87,-14,-4,-4,4,0,-2,2,0,-5,6,1,7,0,7,0,0,0,0,-2,2,-2,-3,5,1,0,-1,-1,-1,-1,1,6,-1
KR_6715451694,420,-1,-92,-8,2,0,2,2,-2,5,3,-2,4,2,1,1,2,5,0,5,0,4,-5,1,-2,1,0,0,-1,0,1,-1,1,0,-1
KR_6715631447,420,-4,-48,-4,-6,-2,2,0,-3,5,2,-3,5,2,2,0,2,0,0,0,0,-7,-6,-1,-1,2,-1,0,0,-1,1,-1,-1,2,-1
KR_6647564491,420,-1,23,17,6,4,1,5,2,1,3,-4,4,0,5,3,8,-1,1,0,0,5,7,4,-4,0,-1,0,0,1,-1,1,-1,2,-1
KR_6689726287,420,-1,-5,11,-4,1,1,2,1,0,1,-5,6,1,1,0,1,-2,2,0,0,-2,-49,-3,-3,6,23,0,-1,-1,-1,-1,-1,6,-1
KR_6749171186,440,-3,-83,-6,-8,-3,4,1,0,2,2,-5,6,1,0,5,5,0,1,1,0,-8,-7,-4,-1,5,1,0,-1,0,0,-1,-1,0,-1
KR_6758894131,420,-7,-140,-30,-11,0,2,2,-3,3,0,-4,6,2,-4,4,0,0,1,1,-1,-12,-3,-2,-1,3,0,0,-4,1,-1,-1,-1,3,-1
KR_6734297202,420,-2,-18,42,-1,-1,3,2,5,0,5,-1,3,2,-1,4,3,-3,5,2,0,1,-59,-1,-1,2,-3,0,0,1,1,0,1,1,-1
KR_6760148746,440,-3,34,20,-6,-6,7,1,-2,4,2,-1,2,1,2,0,2,1,0,1,0,-5,-4,2,-6,4,-1,0,-2,1,-1,-1,1,5,-1
KR_6727740362,420,1,-2,-28,-1,3,0,3,-3,3,0,1,1,2,0,2,2,-2,3,1,0,-2,-11,2,-5,3,-2,0,0,-1,1,0,-1,4,-1
KR_6703847501,420,-1,40,20,-5,-2,2,0,-1,4,3,-2,6,4,-2,2,0,2,0,2,0,-7,5,1,-2,1,1,0,1,0,1,1,-1,0,-1
KR_6731068219,420,0,-63,21,1,-2,2,0,3,0,3,5,0,5,-3,4,1,-2,3,1,0,-4,382,-6,0,6,21,0,0,1,1,1,-1,5,-1
KR_6762535863,420,0,-40,20,4,0,0,0,4,0,4,-1,2,1,1,1,2,0,0,0,0,4,11,0,-2,2,0,0,0,-1,0,0,1,6,-1
KR_6651717301,420,-1,-12,23,-4,-1,1,0,-6,8,2,0,2,2,-1,2,1,4,2,6,0,-7,242,4,-5,1,0,0,0,1,0,0,-1,3,-1
KR_6727490576,420,0,-41,-8,-2,5,0,5,-3,4,1,0,1,1,-3,4,1,-1,1,0,0,-7,11,1,-5,4,-3,0,-1,0,-1,-1,1,0,-1
KR_6764532936,420,-1,-107,-7,-3,-2,3,1,-1,2,1,-1,4,3,-2,4,2,3,1,4,0,-2,-252,-1,-1,2,-2,0,0,-1,-1,0,1,1,-1
KR_6753889470,420,0,-40,0,0,-3,4,1,-1,3,2,-1,3,2,2,1,3,3,1,4,1,3,-7,-2,-8,10,0,0,0,-1,-1,0,1,1,-1
KR_6646924839,420,-4,-70,-40,-6,-3,4,1,-4,4,0,0,1,1,0,2,2,1,0,1,0,-5,-238,0,-2,2,-7,0,-1,1,-1,-1,1,5,-1
KR_6758905560,420,-3,-26,20,-8,-7,7,0,4,0,4,0,0,0,-4,5,1,-1,2,1,1,-6,22,-1,-1,2,2,0,-1,-1,1,-1,1,3,-1
KR_6702990415,420,-3,-131,25,-7,-5,6,1,3,2,5,-6,7,1,1,0,1,0,0,0,0,-2,-12,-1,-4,5,-3,0,-3,0,-1,-1,1,0,-1
KR_6698765570,420,-1,-75,29,-2,-1,4,3,6,1,7,1,2,3,-6,7,1,-2,2,0,0,-4,-2,2,-5,3,-3,0,-2,1,-1,-1,-1,1,-1
KR_6760856374,440,-3,-31,-39,-5,-6,6,0,1,0,1,-1,2,1,0,2,2,1,0,1,0,-3,9,-2,-1,3,-5,0,-1,1,0,-1,-1,4,-1
KR_6706006090,420,-6,-132,9,-16,-4,5,1,-4,4,0,1,1,2,-3,3,0,-6,6,0,0,-13,4,1,-1,0,-1,0,-2,-1,-1,-1,-1,1,-1
KR_6680062785,420,-1,-102,39,2,3,0,3,0,3,3,-3,6,3,-2,4,2,4,1,5,0,2,-6,2,-2,0,0,0,-2,1,1,1,1,1,-1
KR_6728842676,420,-4,-22,-3,-12,-2,3,1,-2,6,4,-4,4,0,-1,1,0,-3,4,1,0,-17,-121,-2,0,2,-2,0,-1,-1,-1,-1,-1,6,-1
KR_6756971684,420,-5,-92,-42,-17,-3,3,0,2,1,3,-12,13,1,-6,6,0,2,2,4,0,-7,-335,1,-2,1,-3,0,-1,-1,0,-1,-1,2,-1
KR_6763493063,420,1,99,-8,-1,2,0,2,-4,4,0,0,3,3,1,1,2,0,0,0,0,-4,-2,0,-3,3,4,0,0,1,-1,0,1,6,-1
KR_6664356443,420,-5,-90,-4,-2,-2,4,2,1,4,5,-1,2,1,-1,4,3,1,1,2,-1,-4,7,-4,-3,7,1,0,0,-1,-1,-1,-1,3,-1
KR_6642453732,420,-1,-77,24,-8,0,2,2,-2,3,1,0,1,1,-3,5,2,-3,3,0,0,-7,8,6,-8,2,-4,0,-1,0,-1,-1,-1,0,-1
KR_6718648118,420,-7,-13,-73,-11,-1,1,0,-1,3,2,-5,5,0,-3,4,1,-1,2,1,0,-4,12,2,-5,3,-2,0,0,-1,-1,0,1,1,-1
KR_6764499094,420,1,-13,-34,-2,-3,3,0,-2,2,0,-3,3,0,3,0,3,3,0,3,0,5,-1,-1,-3,4,2,0,1,-1,-1,1,1,4,-1
KR_6724590879,420,-2,48,0,-3,-4,4,0,0,0,0,2,0,2,0,1,1,-1,1,0,0,-1,32,0,-1,1,-12,0,0,1,-1,-1,-1,5,-1
KR_6729910815,420,-5,-6,-9,-7,6,0,6,-5,5,0,1,3,4,-5,7,2,-4,6,2,0,-14,-2,1,-1,0,-1,0,-1,-1,-1,-1,1,5,-1
KR_6730566456,420,-3,-80,8,-5,-1,2,1,0,4,4,-1,5,4,-4,6,2,1,0,1,-1,-7,-8,-1,0,1,-1,0,0,-1,-1,-1,-1,4,-1
KR_6764081949,420,0,-11,8,-6,-3,4,1,2,1,3,-5,6,1,0,2,2,0,0,0,0,-4,-2,-3,-4,7,0,0,1,-1,-1,1,-1,4,-1
KR_6720552369,440,1,-26,3,-3,0,3,3,-1,3,2,-2,2,0,3,1,4,-3,4,1,0,1,21,-1,-2,3,1,0,0,-1,-1,0,-1,3,-1
KR_6651389469,420,-1,15,-13,-4,-2,3,1,-4,6,2,-4,5,1,5,3,8,1,1,2,0,4,-8,-3,-1,4,0,0,0,-1,0,0,1,6,-1
KR_6737677503,420,-3,7,15,-2,1,1,2,-3,4,1,0,1,1,3,0,3,-3,3,0,0,-1,34,0,-3,3,21,0,0,1,0,-1,1,4,-1
KR_6732144578,420,-5,-45,-36,-12,-4,4,0,0,0,0,-6,7,1,-1,3,2,-1,1,0,0,-3,-3,-1,-2,3,3,0,-2,-1,-1,-1,1,1,-1
KR_6734209573,440,-2,-123,6,-4,-3,6,3,3,2,5,-1,2,1,-3,8,5,0,0,0,1,-3,-2,0,-3,3,0,0,-1,1,1,-1,1,3,-1
KR_6731640930,420,-1,73,-24,-2,4,0,4,-2,4,2,-4,5,1,-1,3,2,1,1,2,0,-14,233,2,-3,1,0,0,0,-1,1,0,1,3,-1
KR_6732201260,420,-2,13,7,-1,-3,4,1,1,1,2,2,1,3,-1,5,4,0,1,1,0,3,-463,2,-4,2,-5,0,-1,1,-1,-1,-1,2,-1
KR_6646059644,420,-5,-61,-8,-8,-1,1,0,-4,6,2,2,3,5,-1,5,4,-4,6,2,2,-8,-5,-3,0,3,1,0,-2,-1,-1,-1,-1,6,-1
KR_6746082971,420,-4,-69,36,-10,-6,7,1,1,1,2,2,2,4,-4,7,3,-3,4,1,0,2,444,3,-4,1,-2,0,-1,1,1,-1,-1,6,-1
KR_6749612202,420,-2,-3,-7,-5,-1,1,0,-2,2,0,0,2,2,-3,3,0,1,0,1,0,-4,-23,-2,-3,5,8,0,0,-1,1,0,1,5,-1
KR_6635111247,420,-1,71,-28,-3,-1,1,0,-3,4,1,-2,2,0,7,1,8,-4,5,1,-1,0,-2,-2,-1,3,0,0,0,-1,-1,1,-1,2,-1
KR_6745463116,420,-1,-12,-47,1,1,1,2,-4,4,0,2,0,2,1,0,1,1,0,1,0,3,11,2,-5,3,-7,0,1,1,-1,1,1,5,-1
KR_6657730055,420,2,-12,8,6,1,2,3,-4,4,0,3,3,6,6,0,6,0,1,1,0,11,-9,0,-4,4,-3,0,-1,-1,1,1,1,6,-1
KR_6684664679,420,-3,-98,-12,-4,-1,2,1,3,2,5,-2,2,0,-2,3,1,-2,2,0,0,-3,2,-3,0,3,1,0,-1,-1,-1,-1,-1,1,-1
KR_6756310718,420,5,41,72,2,7,5,12,4,0,4,-8,13,5,-1,2,1,0,0,0,1,-4,3,2,-3,1,-2,0,2,1,-1,1,1,3,-1
KR_6692925601,420,5,88,8,7,-1,1,0,-1,2,1,-6,8,2,14,2,16,1,2,3,0,7,13,1,-2,1,0,0,0,1,1,1,1,6,-1
KR_6745218620,420,-3,-29,2,-1,-3,3,0,0,3,3,-2,3,1,1,1,2,3,2,5,0,6,1,1,-2,1,1,0,-1,-1,1,-1,1,5,-1
KR_6708595214,420,-2,-40,-4,-10,-3,4,1,-1,1,0,3,3,6,0,0,0,-9,10,1,-1,-12,-41,3,-5,2,12,0,0,-1,0,-1,-1,2,-1
KR_6704211239,420,-5,-40,-16,-9,0,4,4,-2,2,0,-5,6,1,0,3,3,-2,2,0,-1,-7,8,0,-1,1,-2,0,-2,-1,1,-1,-1,2,-1
KR_6737982327,420,-3,5,-41,2,-1,3,2,0,0,0,2,4,6,1,4,5,0,0,0,0,9,50,4,-7,3,-21,0,1,-1,1,1,1,5,-1
KR_6762592804,420,-1,-36,-7,-9,-4,5,1,0,0,0,-4,6,2,-1,7,6,0,0,0,-1,-12,-2,1,-3,2,-1,0,0,0,1,0,-1,0,-1
KR_6724493641,420,-1,-7,-31,0,-1,2,1,-1,1,0,0,3,3,1,1,2,1,2,3,0,0,-44,2,-4,2,21,0,0,-1,1,0,1,4,-1
KR_6639734020,420,-2,-66,-27,-11,-2,2,0,-1,2,1,-1,1,0,-2,4,2,-5,5,0,-1,-10,122,-1,-1,2,-3,0,-1,-1,-1,-1,-1,2,-1
KR_6711724099,420,-4,-61,-16,-5,-1,2,1,2,2,4,-7,7,0,3,2,5,-2,2,0,0,1,-462,-9,0,9,1,0,0,-1,-1,-1,-1,2,-1
KR_6739271164,420,-7,-85,-7,-15,-2,3,1,-3,3,0,1,0,1,-7,9,2,-4,4,0,0,-16,279,3,-6,3,-5,0,-3,-1,-1,-1,1,2,-1
KR_6743314102,440,-4,-37,-12,-2,-2,2,0,0,4,4,-4,6,2,3,0,3,1,2,3,0,3,1,-1,0,1,0,0,-1,0,0,-1,-1,0,-1
KR_6740282656,420,1,-86,-12,4,1,1,2,-3,4,1,6,0,6,-2,2,0,2,0,2,0,10,8,-5,-1,6,2,0,0,1,1,1,-1,3,-1
KR_6740000497,420,-4,-37,-28,-6,-8,8,0,1,4,5,0,2,2,2,8,10,-1,2,1,0,-1,53,3,-5,2,-12,0,1,0,1,1,1,0,-1
KR_6697050050,420,-4,-17,-16,-12,5,1,6,-3,3,0,-3,3,0,-8,8,0,-3,3,0,-1,-17,-34,1,-2,1,8,0,-2,0,1,-1,-1,0,-1
KR_6704162681,420,-2,-38,16,-4,-7,7,0,1,0,1,3,1,4,0,3,3,-1,1,0,-1,2,3,1,-4,3,-4,0,-1,0,0,-1,-1,0,-1
KR_6694158398,420,-1,-44,-4,1,-1,4,3,-3,4,1,2,0,2,1,2,3,2,0,2,0,-1,-8,-1,-1,2,1,0,-1,1,-1,-1,-1,5,-1
KR_6759833609,440,-1,-44,-4,2,-2,2,0,1,3,4,2,1,3,1,1,2,0,2,2,0,-2,2,4,-5,1,-3,0,0,-1,1,0,-1,2,-1
KR_6755391322,440,-5,-61,-19,-11,-2,3,1,1,6,7,-4,5,1,-4,6,2,-2,2,0,0,-8,-1,0,-2,2,-2,0,-1,-1,-1,-1,1,1,-1
KR_6669339267,420,-4,22,13,-9,-6,7,1,2,1,3,-3,3,0,-1,3,2,-1,1,0,0,0,17,3,-5,2,1,0,0,0,-1,0,1,0,-1
KR_6681443612,420,1,-61,56,-3,-4,5,1,-1,1,0,4,1,5,-2,2,0,0,0,0,-1,-7,-5,0,-3,3,2,0,1,1,1,1,-1,2,-1
KR_6757927526,420,-3,-41,28,-8,-5,5,0,-1,5,4,-1,4,3,-1,3,2,0,2,2,0,-6,1,-3,-3,6,1,0,-1,0,1,-1,-1,0,-1
KR_6754987033,420,-2,36,4,-3,1,2,3,2,0,2,-4,5,1,0,3,3,-2,2,0,0,-2,-23,-2,-4,6,-4,0,-1,-1,1,-1,1,1,-1
KR_6703507266,420,0,-79,-17,7,1,1,2,0,3,3,3,0,3,3,2,5,0,2,2,-1,7,-80,3,-3,0,0,0,0,-1,1,0,-1,1,-1
KR_6755197890,420,-3,-102,4,-4,-1,4,3,3,0,3,-6,8,2,-1,2,1,1,1,2,2,6,-8,-2,-2,4,1,0,0,-1,0,0,1,4,-1
KR_6729333949,420,-1,32,-26,-3,2,0,2,-6,6,0,1,2,3,1,3,4,-1,1,0,0,-1,6,1,-4,3,-1,0,0,-1,0,0,1,4,-1
KR_6755933518,420,-3,-24,-8,-16,-4,5,1,-4,4,0,-2,4,2,-4,4,0,-2,2,0,0,-18,-232,-2,-2,4,2,0,-2,-1,1,-1,1,4,-1
KR_6650417164,420,-2,-23,-40,-3,1,0,1,0,1,1,0,1,1,-4,5,1,0,2,2,0,-1,-270,-4,-1,5,2,0,-1,-1,-1,-1,-1,6,-1
KR_6749240695,420,-5,-7,4,-7,-4,6,2,0,1,1,0,3,3,0,1,1,-3,3,0,-1,-5,-374,1,-2,1,2,0,-2,-1,-1,-1,-1,1,-1
KR_6715359471,420,2,-10,22,-3,-7,9,2,-1,1,0,4,5,9,0,1,1,1,1,2,0,-2,-232,-4,0,4,3,0,-1,1,-1,-1,1,3,-1
KR_6758869639,420,-2,-43,-20,-1,-4,4,0,-2,3,1,-4,4,0,8,0,8,1,1,2,0,7,9,4,-6,2,3,0,0,-1,-1,1,-1,1,-1
KR_6729714998,420,-6,-107,-16,-13,-7,8,1,-1,2,1,2,1,3,-7,7,0,0,2,2,0,-14,176,-5,-1,6,1,0,-3,1,-1,-1,-1,6,-1
KR_6735010612,420,-5,14,-12,-8,-1,2,1,-2,3,1,-2,3,1,-3,4,1,0,2,2,0,-11,-40,3,-4,1,-5,0,-2,0,-1,-1,-1,0,-1
KR_6761600586,420,-5,-10,-20,-9,0,3,3,-1,4,3,-5,6,1,-1,2,1,-2,3,1,0,-6,5,4,-6,2,-8,0,-2,-1,0,-1,-1,6,-1
KR_6739683363,420,2,-7,12,1,1,1,2,3,0,3,-1,4,3,-3,5,2,1,0,1,0,1,308,-4,-2,6,0,0,0,1,-1,0,-1,4,-1
KR_6756790401,420,1,-5,-21,1,2,1,3,0,4,4,0,3,3,0,2,2,-1,1,0,0,4,-121,-2,0,2,-3,0,-1,-1,0,-1,1,3,-1
KR_6762733139,420,-1,-7,0,-1,2,0,2,5,1,6,-7,9,2,-2,5,3,1,0,1,0,-3,-4,-9,0,9,-2,0,-1,-1,0,1,1,4,-1
KR_6646187346,420,1,67,12,-3,3,1,4,-1,3,2,5,2,7,-5,6,1,-5,5,0,0,-10,-366,1,-3,2,17,0,0,-1,-1,-1,1,6,-1
KR_6627816147,420,2,84,28,-2,2,1,3,1,1,2,1,3,4,-3,4,1,-3,3,0,0,1,4,-2,-2,4,6,0,0,1,1,-1,-1,4,-1
KR_6703316600,420,-2,-55,-24,-3,-2,2,0,0,3,3,-1,2,1,1,1,2,-1,2,1,0,0,128,-2,-1,3,-4,0,-2,-1,1,-1,-1,5,-1
KR_6744200960,420,1,19,36,0,-2,5,3,2,2,4,3,1,4,-4,4,0,1,1,2,0,-2,-2,-1,-1,2,-1,0,0,0,0,0,-1,0,-1
KR_6647319597,420,1,50,-19,7,-2,2,0,1,0,1,4,0,4,2,0,2,2,0,2,0,12,-13,2,-4,2,4,0,1,-1,-1,1,-1,6,-1
KR_6732452162,420,0,-78,-4,1,-1,1,0,0,2,2,3,0,3,-1,3,2,0,2,2,0,2,17,0,-2,2,-5,0,0,1,0,-1,1,2,-1
KR_6757108385,420,-2,0,0,-8,-2,3,1,-2,3,1,-1,1,0,-2,3,1,-1,1,0,0,-5,-3,1,-4,3,0,0,0,-1,1,-1,-1,1,-1
KR_6743412196,420,-1,5,-16,-5,-4,5,1,0,3,3,2,1,3,1,2,3,-4,4,0,0,-2,4,3,-3,0,0,0,0,0,-1,0,-1,0,-1
KR_6762971526,420,0,12,-48,0,-5,7,2,0,4,4,4,0,4,5,0,5,-4,5,1,-1,0,5,3,-5,2,-5,0,-1,-1,-1,-1,-1,3,-1
KR_6730640804,440,-6,-105,-24,-5,-5,6,1,2,0,2,-5,7,2,4,1,5,-1,3,2,0,6,9,-3,-3,6,1,0,-3,-1,-1,-1,1,5,-1
KR_6677966514,420,1,-17,32,8,0,2,2,-3,4,1,5,1,6,5,0,5,1,0,1,0,0,19,-5,0,5,0,0,0,1,1,1,1,6,-1
KR_6747369385,420,0,81,-5,1,4,1,5,-1,3,2,5,1,6,-5,8,3,-2,2,0,1,0,-4,0,-2,2,-1,0,0,1,1,1,1,3,-1
KR_6742500269,420,-6,2,-28,-12,0,1,1,-3,3,0,-4,4,0,-3,4,1,-2,2,0,-1,-9,3,-1,-1,2,-3,0,0,0,-1,-1,-1,0,-1
KR_6731381903,420,-1,-51,0,-7,0,1,1,-4,4,0,2,3,5,-2,3,1,-3,3,0,0,-10,-28,-1,0,1,1,0,0,0,1,-1,-1,0,-1
KR_6712280697,420,0,26,-5,-1,-2,3,1,-1,1,0,2,1,3,1,2,3,-1,2,1,0,0,3,2,-5,3,-5,0,0,1,-1,1,1,3,-1
KR_6749100419,420,-2,-77,-2,-4,0,0,0,1,2,3,-1,3,2,-4,10,6,0,1,1,0,-5,-1,3,-3,0,-2,0,-1,-1,1,-1,-1,4,-1
KR_6703824515,420,-3,9,0,-6,1,3,4,-1,1,0,-2,4,2,-4,6,2,0,1,1,0,-13,3,0,-1,1,-2,0,-1,-1,1,1,1,5,-1
KR_6760939682,440,-2,24,4,-4,2,1,3,0,2,2,-2,3,1,-3,4,1,-1,1,0,-1,-5,43,0,-1,1,-33,0,0,-1,0,0,-1,3,-1
KR_6749933943,420,-2,-10,-4,-1,-4,6,2,0,2,2,3,0,3,1,0,1,-1,1,0,0,0,-2,-1,-1,2,2,0,0,-1,0,0,1,2,-1
KR_6706366127,420,-4,-19,-11,-6,5,0,5,1,4,5,-10,10,0,0,0,0,-2,4,2,0,-4,1,-1,-1,2,-3,0,-2,-1,0,-1,1,6,-1
KR_6711688844,420,-9,-143,-12,-17,0,4,4,-2,2,0,-7,7,0,-5,5,0,-3,3,0,0,-8,-28,-2,-2,4,3,0,-3,-1,-1,-1,-1,5,-1
KR_6759399778,420,-1,-26,-8,-2,4,0,4,2,1,3,1,2,3,-5,5,0,-4,4,0,0,-2,-3,2,-3,1,3,0,0,1,-1,1,1,5,-1
KR_6732068913,420,-3,-12,-8,-4,-1,2,1,0,2,2,-5,6,1,1,3,4,1,1,2,0,1,-375,-2,-1,3,1,0,-1,-1,-1,-1,-1,1,-1
KR_6762156629,440,-3,-73,1,-11,-1,2,1,-4,5,1,-4,6,2,0,5,5,-2,3,1,-1,-9,-46,-1,-2,3,27,0,0,-1,1,0,-1,4,-1
KR_6751879410,420,3,40,0,5,-4,4,0,1,2,3,0,5,5,2,1,3,6,0,6,0,-2,16,2,-3,1,2,0,0,-1,1,0,1,1,-1
KR_6686458011,420,0,-25,0,-3,0,1,1,0,1,1,-2,4,2,0,3,3,-1,1,0,0,-4,-31,-2,0,2,22,0,1,-1,1,1,-1,2,-1
KR_6738515319,420,4,47,0,9,2,1,3,-1,4,3,4,1,5,1,0,1,3,2,5,0,5,3,4,-5,1,4,0,-1,1,-1,1,-1,3,-1
KR_6743302362,440,-8,-134,-12,-23,-3,4,1,1,0,1,-6,7,1,-11,11,0,-4,4,0,-1,-26,-10,1,-2,1,0,0,-4,-1,-1,-1,-1,2,-1
KR_6762384825,420,-1,16,48,-12,-3,3,0,0,1,1,-3,6,3,-4,6,2,-2,2,0,0,-9,14,-1,-4,5,1,0,-1,-1,0,-1,-1,4,-1
KR_6760426649,440,-2,-76,36,-1,-2,4,2,8,1,9,-3,5,2,-2,2,0,-2,3,1,0,3,-6,1,-4,3,-1,0,-1,0,-1,-1,-1,0,-1
KR_6739708561,420,-2,16,-23,-10,1,1,2,-4,5,1,1,1,2,-3,3,0,-5,5,0,0,-8,-21,-2,-2,4,1,0,-1,-1,1,-1,-1,4,-1
KR_6651215246,420,-3,-121,-13,-6,-1,1,0,-1,4,3,-2,2,0,-3,4,1,1,3,4,0,-9,-1,-4,-1,5,-1,0,-1,-1,-1,-1,1,5,-1
KR_6757197009,420,-4,-12,-24,-8,-2,3,1,-9,10,1,-1,3,2,4,2,6,0,1,1,0,0,-3,-4,-1,5,1,0,-1,-1,-1,-1,-1,4,-1
KR_6730178347,420,-4,25,-26,-1,2,1,3,2,1,3,-7,9,2,2,1,3,0,1,1,0,7,14,2,-5,3,0,0,-2,0,1,-1,1,0,-1
KR_6761684890,420,-3,-22,11,-7,-3,4,1,2,2,4,0,1,1,-4,4,0,-2,2,0,0,-8,-2,0,-4,4,-2,0,-1,-1,-1,-1,-1,1,-1
KR_6738572246,420,1,-42,21,2,-2,2,0,2,2,4,-3,4,1,4,2,6,1,1,2,0,2,4,0,-9,9,2,0,1,1,-1,1,1,3,-1
KR_6742440745,420,-3,-45,-17,-10,-4,5,1,-2,3,1,1,1,2,-4,6,2,-1,1,0,0,-5,-1,-1,-3,4,-1,0,0,1,1,-1,-1,5,-1
KR_6759475442,420,-3,-37,-16,-5,-2,4,2,2,2,4,0,3,3,-4,4,0,-1,1,0,0,-7,-112,-6,-1,7,0,0,-1,-1,1,-1,-1,2,-1
KR_6762360596,420,0,-14,-4,0,1,2,3,0,2,2,2,1,3,-3,5,2,0,1,1,0,-1,4,2,-4,2,1,0,0,1,-1,0,-1,1,-1
KR_6645251306,420,-2,-33,-21,-7,0,0,0,-4,4,0,1,0,1,0,3,3,-4,4,0,0,-9,3,-1,-2,3,1,0,-1,-1,-1,-1,-1,5,-1
KR_6667364348,420,-6,-3,-60,-14,-2,5,3,-7,7,0,-5,7,2,3,0,3,-3,3,0,0,-5,-9,-7,0,7,-1,0,-1,-1,-1,-1,-1,3,-1
KR_6721879628,420,-4,18,-28,-26,-5,5,0,-3,4,1,-1,4,3,-7,9,2,-10,10,0,0,-17,1,4,-5,1,-4,0,-4,-1,-1,-1,-1,6,-1
KR_6754807259,420,-6,51,-39,-12,-1,2,1,-6,6,0,-5,6,1,0,2,2,0,0,0,0,-7,-28,-2,-1,3,23,0,0,0,-1,1,-1,0,-1
KR_6761748432,420,4,7,8,11,5,1,6,2,1,3,2,1,3,-1,3,2,3,0,3,0,10,-6,0,-4,4,2,0,2,1,1,1,1,6,-1
KR_6708271436,440,-1,102,-24,0,4,0,4,-1,4,3,-1,3,2,0,3,3,-2,3,1,-1,3,0,4,-6,2,0,0,0,-1,0,0,-1,4,-1
KR_6702228746,420,0,-57,-12,5,-2,4,2,3,1,4,5,0,5,0,1,1,-1,2,1,2,8,-1,1,-3,2,-1,0,-1,-1,0,-1,1,1,-1
KR_6661460633,420,1,8,-1,-4,-2,2,0,-5,5,0,-4,4,0,7,0,7,0,1,1,0,-2,-29,0,-2,2,3,0,0,0,1,0,-1,0,-1
KR_6749339771,440,1,-53,0,-4,-3,4,1,-3,5,2,2,1,3,1,1,2,-1,2,1,-1,-4,4,1,-2,1,-2,0,0,-1,-1,0,-1,3,-1
KR_6744263940,420,-5,-106,-31,-15,-3,3,0,-1,1,0,-12,14,2,1,4,5,0,0,0,0,-4,-10,-3,0,3,0,0,-2,0,0,-1,-1,0,-1
KR_6728666203,420,-1,54,-4,-1,1,1,2,-2,3,1,-1,3,2,-2,3,1,3,0,3,0,-8,2,-1,-8,9,2,0,0,1,-1,0,-1,2,-1
KR_6748770105,420,1,85,-48,1,-2,4,2,-3,5,2,0,1,1,4,4,8,2,0,2,-1,-1,-1,-1,-1,2,2,0,0,-1,0,1,-1,3,-1
KR_6760559072,420,0,-136,5,-4,-4,6,2,-3,3,0,0,3,3,0,2,2,3,1,4,0,-3,-2,-2,0,2,1,0,-2,0,0,-1,-1,0,-1
KR_6738499957,420,0,-31,8,2,0,1,1,2,1,3,2,0,2,-1,1,0,-1,1,0,0,2,9,2,-3,1,-2,0,0,1,1,1,1,1,-1
KR_6694656467,420,-5,-12,15,-8,-3,3,0,-2,5,3,0,1,1,-1,4,3,-2,3,1,0,-5,-8,-1,-2,3,4,0,1,-1,1,1,-1,1,-1
KR_6696453289,420,-4,24,-4,-2,-3,5,2,-2,5,3,0,2,2,3,4,7,0,1,1,0,-4,-1,-2,-5,7,3,0,-1,1,1,1,1,3,-1
KR_6704229545,420,-1,16,19,0,1,1,2,-1,2,1,-1,3,2,0,1,1,1,0,1,0,-2,-3,1,-3,2,-1,0,0,1,-1,0,1,3,-1
KR_6747805136,420,-2,-99,-12,-6,-1,1,0,-1,2,1,-1,3,2,-2,3,1,-1,1,0,-2,-9,-6,0,-5,5,0,0,0,-1,1,0,-1,4,-1
KR_6687678900,420,-3,-52,-4,-2,-1,1,0,-1,2,1,0,0,0,0,2,2,0,0,0,1,-2,-350,3,-4,1,0,0,0,-1,-1,0,1,2,-1
KR_6742437560,420,-1,48,48,-3,-1,1,0,-2,3,1,0,1,1,-1,2,1,1,2,3,0,-6,-150,1,-3,2,1,0,0,1,-1,0,1,1,-1
KR_6759764507,440,-2,-41,14,1,0,2,2,-3,5,2,0,4,4,1,4,5,3,1,4,0,3,154,3,-7,4,-1,0,-1,-1,1,-1,-1,4,-1
KR_6762821170,420,1,10,7,3,0,1,1,1,2,3,-4,5,1,3,3,6,3,1,4,-1,7,-10,0,-2,2,-3,0,0,1,1,1,-1,5,-1
KR_6762306532,420,-3,-56,10,-10,-6,8,2,3,3,6,-4,5,1,-4,4,0,1,0,1,1,-2,-13,-2,-2,4,4,0,-2,-1,0,-1,1,3,-1
KR_6764233077,420,2,-20,16,12,5,0,5,3,0,3,0,4,4,2,1,3,2,0,2,0,13,14,-1,-1,2,-3,0,0,0,0,0,1,0,-1
KR_6683689885,420,-4,-5,-4,-6,-5,5,0,6,0,6,-1,2,1,-4,5,1,-2,3,1,0,-3,-61,-3,0,3,29,0,0,1,1,0,-1,2,-1
KR_6713906426,440,-8,-143,-12,-22,-4,6,2,-4,4,0,-3,6,3,-9,10,1,-2,2,0,-1,-14,-5,4,-5,1,-4,0,-1,-1,1,-1,-1,4,-1
KR_6725180614,420,-2,75,4,-6,0,1,1,-5,5,0,1,0,1,0,0,0,-2,2,0,0,-6,-139,-3,-1,4,0,0,0,-1,1,0,1,5,-1
KR_6679800544,420,3,45,12,13,13,1,14,3,1,4,0,1,1,-2,3,1,-1,1,0,0,5,30,-2,0,2,4,0,4,1,1,1,1,1,-1
KR_6681937676,420,-2,48,-31,1,0,1,1,0,1,1,5,0,5,-2,4,2,-2,2,0,0,-1,33,2,-7,5,-21,0,0,-1,1,0,1,1,-1
KR_6706062821,420,-5,-65,0,-6,-5,6,1,-2,2,0,-2,3,1,1,3,4,2,0,2,0,2,1,-4,-2,6,-1,0,-1,-1,-1,-1,-1,1,-1
KR_6660140342,420,-2,-43,-11,-5,-2,3,1,-5,7,2,-1,3,2,1,3,4,2,0,2,0,-8,-221,3,-3,0,-2,0,-1,0,-1,-1,-1,0,-1
KR_6763569883,420,-4,-63,-2,-14,-6,8,2,-2,3,1,-2,4,2,-4,5,1,0,0,0,0,-13,-176,-4,-1,5,1,0,-1,-1,-1,-1,1,6,-1
KR_6743761799,440,-1,-28,15,-5,3,1,4,0,2,2,-2,5,3,-6,6,0,0,0,0,0,-9,-2,-1,0,1,0,0,0,-1,0,-1,-1,6,-1
KR_6749096116,420,-5,-90,4,-22,-3,5,2,-10,11,1,-1,2,1,-6,9,3,-2,4,2,-1,-19,-249,-4,0,4,2,0,-1,-1,-1,-1,-1,5,-1
KR_6714225610,420,-5,-43,-42,-10,0,1,1,-4,5,1,-2,4,2,-4,5,1,0,1,1,0,-6,-19,1,-4,3,-1,0,0,0,-1,-1,-1,0,-1
KR_6759590588,420,0,-33,0,0,0,0,0,-1,1,0,0,0,0,1,1,2,0,3,3,0,-2,4,-2,-3,5,1,0,-1,-1,0,-1,1,2,-1
KR_6742557222,420,0,65,6,-4,2,2,4,-1,1,0,-4,7,3,-1,1,0,0,2,2,0,-8,-43,-4,-1,5,0,0,0,-1,1,0,1,1,-1
KR_6726308615,420,1,35,-24,6,0,0,0,1,2,3,2,2,4,3,0,3,0,1,1,0,7,2,4,-6,2,-2,0,0,1,0,0,1,4,-1
KR_6737870525,420,-2,73,-32,-10,-5,6,1,-3,6,3,0,2,2,-3,4,1,1,1,2,-2,-9,-5,-3,-2,5,2,0,-1,-1,-1,-1,-1,4,-1
KR_6764242015,420,-2,-21,13,-4,-1,1,0,-6,6,0,0,1,1,3,0,3,0,0,0,0,-5,4,0,-1,1,1,0,-1,-1,-1,-1,-1,5,-1
KR_6538430993,440,-4,-69,0,-4,3,2,5,-1,1,0,-4,4,0,-1,1,0,-1,4,3,0,-1,3,1,-1,0,-2,0,0,-1,0,0,-1,1,-1
KR_6683898787,420,1,10,12,-2,3,1,4,-1,1,0,-6,6,0,3,0,3,-1,1,0,0,-2,20,2,-4,2,2,0,1,-1,-1,1,1,5,-1
KR_6742688538,420,-2,-33,52,-13,0,0,0,4,1,5,-3,4,1,-5,5,0,-9,9,0,0,-18,-4,-1,-1,2,-1,0,-2,-1,-1,-1,-1,3,-1
KR_6752215107,420,-3,-39,0,-1,-9,10,1,3,2,5,9,1,10,-3,3,0,-1,2,1,1,-5,2,3,-3,0,-2,0,-1,-1,-1,-1,1,1,-1
KR_6711218663,440,0,67,-2,1,-3,4,1,3,1,4,3,0,3,-2,7,5,0,0,0,0,-3,-1,-3,-3,6,3,0,0,-1,0,0,1,4,-1
KR_6732552637,420,-3,-87,-31,-7,-4,5,1,10,0,10,-4,5,1,-5,5,0,-4,4,0,1,-11,219,0,-3,3,0,0,-4,-1,1,-1,1,5,-1
KR_6764014918,420,-7,-80,-11,-15,0,0,0,-5,5,0,-9,12,3,-1,3,2,0,0,0,-1,-13,311,-4,-1,5,1,0,-2,-1,-1,-1,-1,5,-1
KR_6744248821,420,-5,-106,-36,-10,0,2,2,-6,10,4,4,1,5,-5,7,2,-3,3,0,-1,-13,46,3,-4,1,1,0,-2,-1,1,-1,1,5,-1
KR_6733369833,420,1,-7,8,4,0,1,1,4,0,4,1,0,1,-3,4,1,2,2,4,0,0,-159,-1,-3,4,0,0,-1,-1,1,-1,-1,6,-1
KR_6736885294,420,0,13,16,-1,7,0,7,-1,3,2,0,4,4,-6,6,0,-1,1,0,-1,-9,-13,-2,-2,4,1,0,1,-1,1,1,-1,3,-1
KR_6757221647,420,-6,-53,-39,-15,0,1,1,-3,3,0,-8,8,0,-5,5,0,1,0,1,0,-8,-271,0,-1,1,15,0,-2,-1,-1,-1,-1,5,-1
KR_6750164452,420,-3,-50,-41,1,1,2,3,-3,4,1,1,1,2,2,1,3,0,1,1,1,7,-6,-4,-1,5,2,0,0,-1,-1,-1,1,1,-1
KR_6762667610,420,-3,-28,-16,1,0,2,2,-4,6,2,-2,4,2,1,3,4,6,0,6,0,3,-18,-4,-1,5,1,0,0,-1,0,0,-1,3,-1
KR_6723380089,420,-4,-36,20,-5,0,1,1,-4,4,0,-2,3,1,6,3,9,-5,5,0,0,-2,-26,-3,-2,5,-1,0,0,1,1,-1,1,4,-1
KR_6742120627,440,2,6,-8,3,2,0,2,-1,3,2,2,3,5,1,2,3,-1,2,1,0,-1,10,1,-4,3,0,0,-1,1,0,-1,-1,3,-1
KR_6741256909,440,-4,-60,-8,-3,0,0,0,-2,3,1,-5,6,1,0,3,3,4,0,4,0,-5,-68,-1,0,1,0,0,-1,1,0,-1,1,1,-1
KR_6734732597,420,2,2,16,0,-4,4,0,0,0,0,3,1,4,1,5,6,0,0,0,0,-2,-23,2,-2,0,-1,0,1,1,-1,1,-1,5,-1
KR_6646274204,440,-2,-37,-20,-2,2,1,3,-3,4,1,2,2,4,-1,3,2,-2,2,0,0,-1,20,-2,-1,3,-4,0,0,0,0,-1,1,0,-1
KR_6627249772,420,0,-47,6,-9,-1,1,0,-8,9,1,-4,4,0,2,3,5,2,0,2,0,-2,8,1,-3,2,-2,0,0,-1,0,1,1,3,-1
KR_6742580468,420,1,22,26,-3,-4,6,2,0,4,4,-2,2,0,0,4,4,3,0,3,0,-6,-2,-1,-3,4,0,0,0,1,-1,-1,-1,2,-1
KR_6713960318,440,-6,-35,-56,-15,-1,3,2,-1,2,1,-6,8,2,-1,4,3,-6,8,2,0,-5,29,0,-2,2,-2,0,0,0,-1,-1,1,0,-1
KR_6739305946,440,-2,-12,-8,-7,-2,5,3,1,2,3,-3,5,2,-6,7,1,3,1,4,0,-7,-2,-2,-1,3,-3,0,-1,1,-1,-1,-1,1,-1
KR_6686423953,420,2,-1,-8,4,3,0,3,2,0,2,0,1,1,-2,6,4,1,1,2,0,5,-145,-1,-4,5,3,0,-1,0,0,-1,-1,0,-1
KR_6759773137,420,0,-12,16,1,0,3,3,-1,3,2,0,4,4,2,0,2,0,1,1,0,-1,-8,0,-1,1,-3,0,0,0,-1,0,-1,0,-1
KR_6635077134,420,-1,35,-23,-3,-6,6,0,2,1,3,3,2,5,-1,1,0,-1,2,1,0,8,-269,2,-2,0,-1,0,0,1,-1,0,-1,4,-1
KR_6753635266,420,-5,-37,-11,-4,-4,4,0,-1,4,3,-1,3,2,3,4,7,-1,3,2,-1,-6,12,0,-1,1,0,0,-1,1,-1,-1,-1,1,-1
KR_6728805076,420,-3,-78,-13,-8,-1,1,0,-3,5,2,4,0,4,-9,10,1,1,0,1,-4,-12,2,-1,-3,4,3,0,-4,-1,-1,-1,-1,1,-1
KR_6706832800,420,3,32,-30,4,1,1,2,-4,7,3,-1,5,4,5,0,5,3,0,3,0,9,-12,-6,-1,7,0,0,1,1,0,1,-1,5,-1
KR_6743649427,420,4,105,12,5,2,4,6,1,1,2,4,0,4,-4,7,3,2,1,3,1,1,40,-6,-2,8,-7,0,1,0,1,1,1,0,-1
KR_6727694895,420,-3,-88,23,1,-4,5,1,3,3,6,2,0,2,-1,2,1,1,2,3,0,-6,-10,-6,0,6,2,0,-2,1,1,-1,1,6,-1
KR_6710117383,440,-8,-117,-27,-10,2,0,2,-1,3,2,0,2,2,-8,8,0,-3,3,0,0,-9,2,-3,-3,6,-5,0,-1,-1,-1,-1,1,4,-1
KR_6759510351,420,-4,-64,-14,-12,-5,7,2,-2,3,1,-2,6,4,-3,3,0,0,2,2,0,-9,0,-1,-3,4,-3,0,-2,-1,-1,-1,-1,3,-1
KR_6717804326,420,-3,4,-16,-7,-4,4,0,-3,3,0,-1,2,1,1,2,3,0,0,0,0,-3,0,-4,0,4,4,0,0,-1,1,-1,1,4,-1
KR_6729488824,440,-3,-16,-36,-10,1,0,1,0,1,1,-6,7,1,-5,6,1,0,1,1,0,-4,22,1,-3,2,-2,0,-1,-1,-1,-1,1,3,-1
KR_6684029816,420,0,-30,0,-1,2,1,3,-1,4,3,3,1,4,-4,5,1,-1,1,0,1,-1,-3,-2,-3,5,-2,0,1,0,0,1,1,0,-1
KR_6730447612,420,-5,-6,-8,-11,-5,5,0,-3,4,1,2,1,3,-5,5,0,0,0,0,0,-5,-15,-3,-2,5,0,0,-1,-1,0,-1,-1,2,-1
KR_6647583924,420,0,-8,16,-2,-2,4,2,2,1,3,1,1,2,-1,3,2,-2,2,0,0,-3,-5,0,-2,2,-3,0,0,1,0,0,1,4,-1
KR_6679315606,420,-2,-90,-12,1,1,0,1,0,1,1,1,2,3,-2,2,0,1,0,1,0,2,5,-1,-3,4,-2,0,-1,-1,1,-1,-1,3,-1
KR_6652688800,420,0,-49,-16,-2,-3,4,1,-1,1,0,-3,5,2,5,0,5,0,0,0,0,0,40,4,-5,1,-1,0,-1,-1,-1,-1,1,5,-1
KR_6750646757,420,-6,-21,-44,-19,-4,6,2,-4,7,3,-9,9,0,-1,3,2,-1,1,0,-1,-5,-12,-6,0,6,3,0,-3,-1,-1,-1,-1,5,-1
KR_6734548744,420,-1,0,-21,-8,1,2,3,-2,5,3,-1,1,0,-6,6,0,0,1,1,-1,-17,-6,0,0,0,-1,0,1,1,-1,-1,-1,1,-1
KR_6705273274,420,-2,-24,3,-4,-1,1,0,0,1,1,-5,6,1,1,0,1,1,2,3,0,-2,-4,-1,0,1,0,0,-1,1,-1,-1,-1,1,-1
KR_6760902121,420,3,-56,-12,4,4,1,5,-1,3,2,-2,2,0,2,0,2,1,0,1,0,6,-10,1,-3,2,0,0,0,1,-1,-1,1,6,-1
KR_6712131838,420,-2,-13,12,-4,-4,5,1,0,2,2,3,1,4,-1,1,0,-2,2,0,0,-1,-5,2,-2,0,0,0,-1,0,1,-1,1,0,-1
KR_6759187717,420,3,14,28,8,1,2,3,6,1,7,-3,4,1,3,2,5,1,1,2,0,7,-2,1,-1,0,2,0,1,1,-1,1,1,5,-1
KR_6760697077,420,-1,0,30,-5,0,1,1,-5,5,0,0,3,3,-1,2,1,1,1,2,0,-12,-243,1,-5,4,-1,0,0,-1,-1,0,1,3,-1
KR_6762555751,420,-4,-34,-58,-8,-1,3,2,-2,4,2,0,4,4,-2,3,1,-3,3,0,1,-13,8,-3,-2,5,0,0,-1,1,-1,-1,1,6,-1
KR_6708446241,420,-1,-130,-8,-4,0,2,2,-1,4,3,5,2,7,-6,6,0,-2,3,1,-1,-1,0,0,-4,4,-2,0,-1,1,-1,-1,-1,6,-1
KR_6693344781,420,-2,-24,-16,-3,3,0,3,-3,4,1,-3,3,0,-1,3,2,1,0,1,-1,-1,-7,-2,0,2,1,0,0,-1,0,0,-1,6,-1
KR_6743486811,420,3,42,20,3,0,1,1,-2,2,0,-2,2,0,-3,4,1,10,2,12,0,-2,10,-2,-1,3,-2,0,0,1,-1,1,-1,1,-1
KR_6761006935,420,-1,-40,17,0,3,1,4,2,1,3,-2,5,3,-3,3,0,0,3,3,1,-2,-7,2,-2,0,1,0,-3,1,1,-1,1,5,-1
KR_6662131136,420,-5,-37,-17,-12,0,1,1,0,2,2,-3,5,2,-7,9,2,-2,2,0,-1,-10,-34,0,-1,1,13,0,0,-1,-1,0,-1,2,-1
KR_6749635477,420,-5,-113,-8,-4,-5,5,0,1,3,4,0,3,3,0,1,1,0,1,1,0,-4,-17,0,-3,3,27,0,-2,-1,-1,-1,1,1,-1
KR_6741265967,420,3,45,-11,0,0,1,1,1,3,4,0,5,5,-2,3,1,1,1,2,0,6,-2,2,-3,1,0,0,0,-1,0,0,-1,5,-1
KR_6643457810,440,-8,-61,-71,-14,-1,2,1,0,1,1,-1,3,2,-6,7,1,-6,7,1,0,-11,-4,-1,-3,4,1,0,-2,-1,0,-1,-1,6,-1
KR_6749888779,420,2,72,-20,-2,-4,4,0,2,1,3,2,1,3,-3,3,0,1,1,2,0,-5,-125,-3,-1,4,2,0,-1,0,-1,-1,1,0,-1
KR_6697481413,420,-1,4,12,-4,-1,6,5,-2,2,0,4,2,6,-4,5,1,-1,1,0,0,-7,-11,-6,-1,7,-2,0,-1,-1,1,-1,-1,3,-1
KR_6763399884,420,-1,21,0,-7,-1,3,2,-3,6,3,3,1,4,-7,8,1,1,0,1,-1,-10,-3,0,-3,3,0,0,-1,1,-1,-1,-1,6,-1
KR_6664524064,420,-3,-52,-24,-8,-2,2,0,-4,5,1,1,3,4,-4,5,1,1,2,3,0,-6,11,1,-4,3,-4,0,0,-1,-1,0,1,4,-1
KR_6726471552,420,-2,-40,-6,-1,-2,4,2,3,2,5,3,1,4,-1,2,1,-4,4,0,0,-4,-86,0,-5,5,-3,0,-1,-1,0,-1,-1,3,-1
KR_6737295269,420,2,-47,2,2,2,0,2,3,2,5,-12,13,1,9,1,10,0,1,1,-1,9,1,2,-2,0,0,0,-1,-1,-1,-1,-1,2,-1
KR_6730714511,420,0,12,-20,1,3,0,3,0,2,2,-2,3,1,-1,2,1,1,2,3,0,-5,-7,2,-4,2,-3,0,0,0,1,-1,-1,0,-1
KR_6751559492,420,1,-28,-4,-1,-3,6,3,-4,6,2,0,1,1,5,0,5,1,3,4,0,6,7,-2,-2,4,-2,0,0,1,-1,1,1,2,-1
KR_6748841486,440,-6,-78,-28,-14,-1,4,3,-1,3,2,1,6,7,-7,10,3,-6,6,0,0,-9,1,4,-5,1,4,0,-2,-1,-1,-1,-1,5,-1
KR_6763938321,420,-1,2,20,2,-2,2,0,-4,4,0,-1,5,4,7,0,7,2,0,2,0,2,-14,1,-1,0,2,0,2,1,-1,1,1,3,-1
KR_6755137422,420,-3,-38,-9,-5,-4,4,0,-2,2,0,-2,3,1,3,0,3,0,2,2,0,-1,23,2,-4,2,-19,0,0,-1,0,-1,1,2,-1
KR_6762699740,420,0,13,-17,5,5,0,5,3,1,4,0,3,3,-1,4,3,-2,4,2,0,5,30,1,-4,3,3,0,0,-1,1,0,1,5,-1
KR_6750543279,420,0,-52,0,-1,2,0,2,9,1,10,-5,6,1,-7,7,0,0,1,1,0,-5,-1,1,-3,2,1,0,0,-1,1,-1,-1,2,-1
KR_6764303993,420,2,-56,12,1,3,1,4,0,0,0,-2,3,1,-1,4,3,1,0,1,0,7,8,4,-6,2,0,0,0,1,-1,-1,1,5,-1
KR_6739674901,420,5,24,20,2,2,0,2,4,1,5,0,1,1,-5,5,0,1,0,1,0,-4,8,1,-6,5,-5,0,-1,0,-1,1,-1,0,-1
KR_6704556746,440,-3,-46,-23,-9,0,2,2,3,2,5,-4,4,0,-2,4,2,-6,6,0,-1,-7,3,-3,0,3,-4,0,1,-1,-1,1,-1,1,-1
KR_6730731808,420,0,51,0,4,2,1,3,6,0,6,0,1,1,-6,7,1,2,1,3,0,-3,-16,-4,-4,8,0,0,1,-1,-1,1,1,4,-1
KR_6712944045,420,-2,53,-20,-10,-2,2,0,-6,6,0,-1,2,1,-1,4,3,0,2,2,0,-13,-474,-8,-2,10,-1,0,-2,-1,-1,-1,-1,3,-1
KR_6647079342,420,-1,-22,8,7,-2,3,1,-1,2,1,2,2,4,8,1,9,0,0,0,0,7,164,-1,0,1,1,0,0,0,-1,0,-1,0,-1
KR_6746967875,420,0,-61,2,1,3,3,6,1,1,2,2,1,3,-2,4,2,-3,3,0,0,0,-2,-2,0,2,1,0,1,1,1,1,1,3,-1
KR_6748006466,420,-1,-29,24,-10,-7,8,1,-4,4,0,3,0,3,-2,3,1,0,1,1,-2,-7,-137,-2,-1,3,2,0,-1,1,-1,-1,-1,3,-1
KR_6722658359,420,-5,-77,12,-10,-2,3,1,-2,2,0,-4,5,1,3,1,4,-5,5,0,0,-13,3,-2,-1,3,-2,0,0,1,1,0,-1,6,-1
KR_6731683627,420,-6,-92,12,-12,-2,2,0,-2,3,1,-1,2,1,-2,4,2,-5,5,0,0,-10,-3,0,-3,3,1,0,-4,0,-1,-1,-1,0,-1
KR_6757442951,440,-2,-40,-14,-4,6,1,7,-2,3,1,-7,7,0,1,1,2,-2,2,0,0,3,-1,3,-5,2,0,0,-1,0,1,-1,-1,0,-1
KR_6758953561,420,1,-7,-4,6,-1,1,0,-1,1,0,-5,6,1,12,0,12,1,0,1,-1,12,4,5,-6,1,1,0,-1,1,-1,-1,-1,2,-1
KR_6735284037,420,-5,-60,-24,-9,-2,4,2,1,1,2,0,2,2,-7,7,0,-1,2,1,0,-8,-49,-4,-1,5,20,0,-2,-1,1,-1,-1,5,-1
KR_6693759752,420,2,-87,0,3,1,0,1,-1,3,2,2,1,3,0,3,3,1,1,2,0,1,-3,2,-4,2,0,0,0,-1,-1,0,1,5,-1
KR_6663355348,420,-3,-101,19,-7,-1,1,0,0,2,2,-6,6,0,0,1,1,0,0,0,0,3,9,2,-3,1,1,0,-1,-1,-1,-1,-1,4,-1
KR_6735708121,420,1,23,-13,4,2,0,2,3,1,4,-3,4,1,2,0,2,0,0,0,0,6,41,1,-2,1,-4,0,1,-1,-1,1,1,4,-1
KR_6683129785,420,-3,61,-52,8,2,1,3,-4,4,0,-1,3,2,8,1,9,3,0,3,0,7,6,1,-1,0,1,0,2,-1,1,1,1,6,-1
KR_6683501865,420,-3,-75,5,-15,-6,7,1,1,2,3,-1,4,3,-9,9,0,0,1,1,-2,-14,-11,-3,-4,7,2,0,0,-1,1,-1,-1,1,-1
KR_6742858862,420,-3,-73,4,-6,-2,3,1,1,1,2,-1,1,0,-3,3,0,-1,1,0,0,-4,4,1,-2,1,0,0,0,1,-1,0,-1,4,-1
KR_6744073978,420,-9,-76,13,-20,-6,6,0,-1,2,1,-12,14,2,-4,5,1,3,1,4,-1,-17,-1,-1,-3,4,-1,0,-2,-1,-1,-1,-1,3,-1
KR_6737988319,420,0,-37,9,-4,0,5,5,-1,4,3,-7,8,1,1,1,2,3,0,3,-1,-1,-58,-2,-2,4,19,0,0,-1,1,0,-1,5,-1
KR_6763961630,420,-2,-23,-15,-8,5,0,5,-1,2,1,-11,13,2,1,0,1,-2,2,0,-1,-11,-11,-1,-6,7,-3,0,1,1,-1,1,-1,2,-1
KR_6764535570,420,-1,-60,-40,-7,1,0,1,1,1,2,-6,9,3,-3,3,0,0,1,1,0,3,-6,-1,-3,4,0,0,-2,-1,-1,-1,-1,3,-1
KR_6737647253,440,-4,-22,-7,-9,-1,1,0,-7,8,1,-4,5,1,-3,4,1,6,1,7,1,-3,2,-5,-3,8,-3,0,0,-1,-1,0,1,2,-1
KR_6741201984,420,-1,2,14,-10,1,0,1,2,3,5,-9,9,0,-2,3,1,-2,2,0,1,-4,-5,0,-3,3,-4,0,0,-1,1,-1,1,6,-1
KR_6695513026,420,-2,-36,16,-8,-3,3,0,2,2,4,-1,2,1,-5,5,0,-1,3,2,0,-4,-2,-1,-3,4,3,0,0,1,1,0,-1,1,-1
KR_6737298262,420,-7,-136,-36,-11,0,1,1,-2,3,1,-1,5,4,-6,9,3,-2,2,0,0,-4,40,0,-5,5,-18,0,-2,-1,-1,-1,-1,6,-1
KR_6751292267,420,-5,-73,-24,-9,0,2,2,2,3,5,-4,4,0,-7,7,0,0,1,1,-1,1,5,2,-2,0,0,0,0,-1,1,0,-1,5,-1
KR_6747529581,420,-4,-53,12,-11,-5,7,2,0,2,2,-5,6,1,2,1,3,-3,3,0,-1,-11,-211,1,-1,0,-1,0,-2,-1,-1,-1,-1,5,-1
KR_6689978770,420,-8,-67,-11,-25,-4,4,0,-2,2,0,-4,6,2,-14,14,0,-1,1,0,0,-23,13,0,-1,1,-1,0,-1,-1,1,-1,-1,2,-1
KR_6758767807,420,0,-29,12,-6,-2,2,0,-2,3,1,-2,5,3,0,7,7,0,1,1,-1,4,-5,1,-3,2,-1,0,0,1,0,0,-1,1,-1
KR_6758522485,420,0,85,-4,1,1,1,2,3,1,4,-2,3,1,-5,7,2,4,2,6,0,4,-12,0,-3,3,3,0,1,1,-1,-1,-1,1,-1
KR_6733289459,420,-3,-88,12,1,-1,1,0,2,0,2,-1,2,1,1,0,1,0,0,0,0,4,6,0,-1,1,-2,0,0,1,0,-1,1,5,-1
KR_6722150137,420,-5,-52,-11,-7,-2,5,3,1,2,3,0,4,4,-3,5,2,-3,3,0,0,-6,-3,-1,-2,3,0,0,-2,-1,0,-1,1,5,-1
KR_6726690241,420,-5,-81,-32,-5,-8,9,1,1,2,3,0,2,2,3,2,5,-1,1,0,-1,4,0,1,-4,3,1,0,0,-1,-1,-1,-1,5,-1
KR_6751410028,420,2,-18,1,6,1,6,7,3,2,5,4,1,5,-1,3,2,-1,1,0,-2,-2,-8,-4,-1,5,-1,0,1,-1,1,1,-1,5,-1
KR_6714620657,440,-1,3,-20,-7,3,1,4,-3,4,1,-5,5,0,1,1,2,-3,3,0,0,-15,-42,-1,-4,5,23,0,-1,1,-1,-1,1,5,-1
KR_6748642601,420,-1,-47,24,-4,1,1,2,0,3,3,-1,4,3,-2,3,1,-2,3,1,-1,-7,-3,1,-5,4,-2,0,0,1,0,0,-1,5,-1
KR_6761919147,420,-1,-34,-26,-1,1,0,1,-3,7,4,-1,3,2,2,0,2,0,0,0,0,-3,99,-1,-4,5,-3,0,0,-1,0,0,1,4,-1
KR_6707771829,440,2,24,-8,0,2,0,2,-4,6,2,0,1,1,0,6,6,2,2,4,0,-2,-22,-1,-6,7,3,0,0,-1,-1,0,1,6,-1
KR_6762307759,420,0,-23,3,-4,-2,3,1,2,1,3,1,1,2,-1,5,4,-4,4,0,0,-5,-32,-1,-5,6,-6,0,-2,0,-1,-1,-1,0,-1
KR_6764081037,420,-6,-121,2,-17,-3,5,2,-1,3,2,-6,9,3,-5,7,2,-2,2,0,0,-13,1,0,-3,3,-2,0,-2,0,-1,-1,-1,0,-1
KR_6735250315,440,-2,-31,-39,-10,-4,4,0,-3,4,1,-4,4,0,1,0,1,0,2,2,0,-10,10,4,-7,3,0,0,-1,-1,-1,-1,-1,1,-1
KR_6747132520,420,-6,-17,-60,-16,-3,4,1,-12,12,0,-1,3,2,1,0,1,-1,1,0,-1,-8,54,-3,0,3,-21,0,-2,-1,0,-1,-1,5,-1
KR_6703967645,420,-3,-68,35,-5,2,2,4,-3,4,1,-4,4,0,2,0,2,-2,2,0,0,-4,-8,-1,-1,2,-4,0,-3,1,-1,-1,-1,6,-1
KR_6742144812,420,-1,33,-36,-6,7,1,8,-5,5,0,-4,4,0,-3,3,0,-1,1,0,0,-18,-4,-1,0,1,1,0,0,-1,-1,1,1,4,-1
KR_6694982002,420,-4,18,8,-16,-4,5,1,-4,5,1,0,5,5,-9,9,0,1,1,2,0,-14,-14,3,-4,1,0,0,-1,0,1,-1,-1,0,-1
KR_6645556997,420,-4,-123,-16,-4,3,0,3,1,1,2,-1,4,3,-5,5,0,-2,3,1,0,-1,-1,0,-3,3,-2,0,-1,-1,-1,-1,1,1,-1
KR_6751963645,420,-2,8,-1,-8,-1,3,2,-1,1,0,-4,5,1,-2,3,1,0,0,0,0,-8,46,0,-1,1,-19,0,0,1,1,-1,-1,1,-1
KR_6737346886,420,2,-79,36,6,-1,2,1,-5,5,0,3,2,5,8,0,8,1,0,1,0,6,-165,4,-4,0,-8,0,-2,1,-1,-1,-1,3,-1
KR_6754203623,420,0,0,-16,5,5,0,5,1,2,3,-4,5,1,3,0,3,0,0,0,0,5,0,2,-3,1,0,0,0,1,-1,1,1,1,-1
KR_6662156533,420,-4,-7,0,-14,-1,4,3,-4,5,1,1,2,3,-4,8,4,-6,7,1,-1,-17,-4,-1,0,1,0,0,1,1,-1,1,-1,4,-1
KR_6761031964,420,-5,-33,-11,-5,-2,4,2,1,2,3,-3,3,0,-1,2,1,0,1,1,0,-3,-115,7,-8,1,-7,0,0,0,0,-1,-1,0,-1
KR_6723356725,420,-2,42,9,-4,-3,3,0,-1,1,0,1,1,2,-1,1,0,0,0,0,-1,-5,-7,-2,-2,4,4,0,0,1,-1,-1,-1,1,-1
KR_6757955523,420,-2,-49,18,3,0,0,0,6,0,6,1,4,5,-4,7,3,0,0,0,0,1,-34,-5,0,5,23,0,0,1,0,-1,1,5,-1
KR_6760250863,420,-7,-119,-47,-1,-5,6,1,-1,4,3,0,3,3,3,2,5,2,0,2,0,7,-435,0,-2,2,-1,0,-1,-1,1,-1,1,1,-1
KR_6760772297,420,2,4,34,2,1,0,1,1,3,4,-3,3,0,4,3,7,-1,2,1,0,2,1,7,-8,1,1,0,0,1,1,0,-1,5,-1
KR_6727296197,420,-1,-5,-21,-3,0,2,2,2,2,4,-1,3,2,-3,3,0,-1,2,1,0,3,-4,-3,-1,4,2,0,0,-1,-1,0,-1,5,-1
KR_6748900614,440,1,-43,16,1,-1,1,0,6,0,6,-1,6,5,-3,6,3,0,1,1,0,0,-223,-5,-1,6,2,0,-2,-1,0,-1,-1,2,-1
KR_6682411843,440,-3,-23,-15,-6,-3,3,0,-4,4,0,-9,10,1,6,0,6,4,0,4,0,0,2,-2,-2,4,2,0,-2,1,-1,-1,-1,5,-1
KR_6744846646,420,-7,-119,-20,-17,-4,5,1,-1,1,0,-11,11,0,0,2,2,-1,2,1,0,-7,-6,-2,0,2,-2,0,-1,1,-1,-1,-1,3,-1
KR_6758139384,420,0,47,8,-6,5,2,7,0,1,1,-10,11,1,-1,1,0,0,1,1,-1,-10,211,-4,-2,6,1,0,1,-1,1,1,-1,4,-1
KR_6745226490,420,-1,-64,1,-4,-1,2,1,1,1,2,0,1,1,-3,3,0,-1,1,0,0,-5,-11,1,-3,2,-5,0,0,-1,1,1,-1,6,-1
KR_6654919388,420,-2,-50,-4,-1,0,2,2,3,3,6,-2,6,4,-1,1,0,-1,1,0,0,2,-4,-2,-4,6,-1,0,0,-1,1,0,-1,4,-1
KR_6755071394,420,-3,-70,-3,-10,1,4,5,0,0,0,-7,7,0,-4,6,2,0,3,3,0,-3,11,2,-2,0,-1,0,-2,-1,-1,-1,1,3,-1
KR_6761013241,420,0,9,-9,-2,1,2,3,-2,2,0,0,1,1,-2,2,0,1,3,4,0,-4,3,1,-1,0,2,0,-2,-1,-1,-1,-1,5,-1
KR_6757156766,420,-3,-62,-4,-16,-5,6,1,-2,3,1,1,2,3,-7,7,0,-3,3,0,-2,-20,-5,-3,-1,4,1,0,-3,1,-1,-1,-1,5,-1
KR_6744269725,420,-1,7,-15,-2,-1,3,2,1,0,1,-3,4,1,-1,2,1,2,1,3,-1,0,-14,0,-1,1,0,0,-2,-1,-1,-1,-1,5,-1
KR_6682700674,420,-1,-38,-4,-3,-2,4,2,2,2,4,-4,7,3,-2,5,3,3,1,4,-1,-10,-4,-3,-2,5,0,0,0,-1,0,0,-1,2,-1
KR_6743245043,420,-6,-95,-10,-10,-1,1,0,0,3,3,-4,4,0,-3,4,1,-2,2,0,0,-6,-3,0,-4,4,0,0,-3,-1,-1,-1,-1,1,-1
KR_6748478155,420,2,-66,12,-1,-4,4,0,-2,2,0,3,1,4,0,5,5,2,0,2,0,1,2,2,-4,2,-1,0,0,-1,1,-1,-1,1,-1
KR_6756415677,420,-2,-51,24,5,0,2,2,-1,4,3,1,0,1,1,4,5,4,0,4,1,9,67,1,-3,2,11,0,0,1,-1,-1,1,1,-1
KR_6762588646,420,1,-15,7,-7,-7,8,1,1,2,3,-3,5,2,2,2,4,0,0,0,-2,1,4,0,-3,3,0,0,-2,1,-1,-1,-1,3,-1
KR_6762402945,420,-9,-94,-19,-8,-1,1,0,0,1,1,-2,3,1,-5,5,0,0,1,1,0,-13,-9,-2,0,2,3,0,0,-1,-1,-1,-1,2,-1
KR_6752607196,420,-2,13,-16,-2,1,1,2,-1,4,3,-2,3,1,3,1,4,-3,3,0,0,4,-4,-5,-2,7,0,0,0,1,1,0,1,6,-1
KR_6728099127,420,-2,-73,12,1,0,1,1,5,0,5,-2,4,2,-2,3,1,0,1,1,0,4,9,-3,-3,6,-3,0,-2,-1,-1,-1,-1,3,-1
KR_6705978533,420,-2,-131,12,-7,5,2,7,-3,3,0,-2,2,0,-6,7,1,-1,2,1,-1,-17,-1,1,-5,4,-2,0,0,-1,1,-1,-1,5,-1
KR_6659974692,420,-6,-49,-35,-12,-1,3,2,-3,3,0,-3,3,0,-5,6,1,0,2,2,0,-10,-9,-4,0,4,1,0,-1,-1,1,-1,-1,6,-1
KR_6652203406,420,-5,-87,-5,-9,-5,5,0,-1,1,0,-3,7,4,-3,4,1,3,1,4,0,-7,-4,-2,-2,4,-1,0,-2,-1,-1,-1,-1,3,-1
KR_6725567395,420,-5,-129,7,-11,-3,4,1,2,1,3,2,1,3,-8,9,1,-4,4,0,0,1,7,2,-3,1,-5,0,-1,-1,0,-1,-1,4,-1
KR_6743332987,420,-6,-80,0,-14,-4,5,1,-6,7,1,-2,4,2,-1,3,2,-1,2,1,0,-10,37,-1,0,1,-18,0,-1,-1,1,-1,1,5,-1
KR_6672343715,420,0,-16,-12,4,2,0,2,3,2,5,-4,4,0,2,1,3,1,1,2,0,10,-31,3,-6,3,4,0,1,-1,1,1,1,2,-1
KR_6744781931,420,-3,17,0,-5,1,1,2,-3,6,3,-3,5,2,0,2,2,0,0,0,0,-4,-8,-3,-1,4,2,0,-2,-1,0,-1,-1,2,-1
KR_6752157265,420,0,-16,24,-2,0,2,2,1,1,2,-5,5,0,2,2,4,0,0,0,1,1,-2,-2,-4,6,0,0,0,-1,-1,0,1,2,-1
KR_6747916005,420,2,-17,28,-2,-4,4,0,5,1,6,-3,4,1,-1,1,0,1,0,1,0,3,27,-5,-1,6,-1,0,-1,0,-1,-1,-1,0,-1
KR_6726331329,440,-3,-3,-22,-2,-4,5,1,-1,4,3,1,1,2,5,3,8,-3,3,0,0,-4,-4,0,-4,4,3,0,0,1,-1,0,1,2,-1
KR_6747331294,420,-4,-75,-4,-10,-5,5,0,-2,5,3,-5,6,1,4,0,4,-2,2,0,0,-3,0,-1,-3,4,-2,0,-3,-1,-1,-1,-1,3,-1
KR_6736205988,420,0,13,-12,2,2,1,3,4,1,5,-4,4,0,0,0,0,0,1,1,0,3,-9,-2,-4,6,0,0,0,-1,1,-1,1,1,-1
KR_6753354788,420,-2,41,-12,-5,-5,6,1,0,0,0,-2,7,5,2,5,7,0,3,3,-2,3,2,0,-1,1,-1,0,1,0,0,1,-1,0,-1
KR_6727346941,420,0,2,3,-8,-3,4,1,2,1,3,-5,9,4,-4,6,2,2,0,2,0,-7,-39,-4,-1,5,23,0,0,-1,1,1,-1,6,-1
KR_6763725710,420,-9,-149,12,-22,-5,7,2,2,1,3,-11,11,0,-4,5,1,-4,4,0,0,-13,-7,-2,-2,4,0,0,-1,-1,1,-1,-1,4,-1
KR_6750731282,420,-3,-43,23,-3,-1,2,1,-1,2,1,2,2,4,-4,6,2,1,1,2,0,-3,-34,-1,-4,5,17,0,-1,0,0,-1,-1,0,-1
KR_6642554801,420,-1,-12,-26,-4,-3,4,1,0,1,1,-2,3,1,0,1,1,1,0,1,0,0,-27,-2,-1,3,1,0,0,-1,1,-1,-1,3,-1
KR_6758492848,420,-2,-28,-24,-2,1,0,1,3,0,3,-5,5,0,0,1,1,-1,2,1,1,5,-24,-4,-1,5,2,0,-1,-1,0,-1,1,4,-1
KR_6715307269,420,-2,-47,-16,-8,0,1,1,-4,4,0,0,2,2,-1,5,4,-3,3,0,1,-8,-368,0,-4,4,2,0,0,-1,-1,-1,1,2,-1
KR_6748191396,420,-1,2,-2,-1,-2,3,1,1,1,2,5,1,6,-5,6,1,0,1,1,0,1,5,-5,-1,6,3,0,-1,1,-1,-1,1,6,-1
KR_6750973440,420,-2,-10,-8,-5,1,1,2,-1,1,0,1,3,4,-1,2,1,-5,5,0,0,-10,-102,-2,-5,7,-8,0,-1,-1,-1,-1,-1,1,-1
KR_6753384556,420,-6,-124,-36,-13,-6,6,0,3,0,3,-5,5,0,-4,7,3,-1,1,0,-1,-1,4,4,-4,0,-1,0,-1,-1,1,-1,-1,1,-1
KR_6749961894,420,-5,-22,-44,-7,-8,9,1,-2,4,2,1,2,3,3,1,4,-1,3,2,0,-1,4,-2,-2,4,0,0,-1,1,-1,-1,1,2,-1
KR_6764463000,420,0,-15,5,2,-6,7,1,3,0,3,0,5,5,2,1,3,3,0,3,-1,5,-49,3,-4,1,16,0,-2,-1,1,-1,-1,3,-1
KR_6762033146,420,0,34,-19,-2,1,1,2,-3,4,1,-3,3,0,2,3,5,1,3,4,2,3,0,2,-6,4,-1,0,0,0,0,-1,1,0,-1
KR_6760077242,420,-3,-16,7,-3,-5,5,0,-2,2,0,4,1,5,-1,6,5,1,1,2,1,1,1,0,-4,4,4,0,0,1,1,-1,1,4,-1
KR_6660128108,420,-2,-77,-16,0,-1,2,1,3,2,5,-5,6,1,1,1,2,2,1,3,1,-3,-18,2,-4,2,2,0,0,0,1,0,1,0,-1
KR_6751807751,420,-1,-46,28,-10,-1,3,2,0,2,2,2,1,3,-11,13,2,0,0,0,0,-8,2,-1,-3,4,-3,0,-1,-1,1,1,-1,6,-1
KR_6758029213,420,0,-59,9,0,-3,4,1,3,0,3,-1,3,2,-1,6,5,2,2,4,0,-2,-25,-1,-2,3,1,0,0,0,1,0,1,0,-1
KR_6759004552,420,-3,-44,-36,-5,-1,3,2,0,2,2,-3,4,1,0,3,3,-1,3,2,0,-3,206,-1,-2,3,-1,0,-1,-1,-1,-1,-1,3,-1
KR_6707275174,420,2,10,20,-1,0,1,1,-3,3,0,-1,3,2,4,0,4,-1,1,0,0,-2,33,1,-6,5,-14,0,-1,-1,-1,-1,1,6,-1
KR_6752279187,420,-3,23,15,-8,-2,3,1,-3,5,2,-2,6,4,0,4,4,-1,1,0,0,-4,-6,-1,0,1,0,0,1,-1,0,1,-1,3,-1
KR_6731099219,420,-1,-97,-7,-8,-10,10,0,1,1,2,2,1,3,-3,5,2,2,0,2,0,8,-65,2,-4,2,1,0,-3,-1,-1,-1,-1,4,-1
KR_6715252587,420,-3,-23,-57,2,1,2,3,-7,8,1,1,4,5,4,1,5,3,0,3,0,0,0,-1,0,1,-1,0,1,-1,0,1,1,5,-1
KR_6738337757,420,-2,-7,0,-3,1,2,3,3,0,3,-5,7,2,0,2,2,-2,4,2,1,-6,-4,0,-3,3,-1,0,0,0,-1,0,1,0,-1
KR_6749043563,420,-3,-53,10,-7,-3,3,0,1,2,3,-3,6,3,-1,2,1,-1,1,0,0,-10,20,5,-6,1,-1,0,-1,1,-1,-1,-1,3,-1
KR_6753291808,420,3,-13,-11,7,-4,5,1,1,1,2,4,2,6,5,1,6,1,2,3,0,13,8,2,-2,0,1,0,2,1,1,1,-1,5,-1
KR_6754251978,420,0,70,-21,0,0,0,0,-1,2,1,5,1,6,-3,3,0,-1,2,1,0,-8,0,0,-1,1,1,0,1,-1,-1,1,1,3,-1
KR_6758130631,420,2,-12,-6,2,0,1,1,1,1,2,1,1,2,1,1,2,-1,1,0,0,5,-21,-1,-1,2,1,0,0,1,-1,0,1,5,-1
KR_6643740023,420,1,24,-22,5,10,0,10,3,3,6,-1,5,4,-4,4,0,-3,3,0,0,-9,130,-1,-3,4,-1,0,0,-1,1,1,1,1,-1
KR_6681884525,440,-5,-51,-11,-11,-3,3,0,-3,3,0,2,0,2,-2,3,1,-5,6,1,0,-9,-13,-3,-2,5,-1,0,-2,-1,1,-1,1,5,-1
KR_6740101304,420,0,18,-24,-6,2,0,2,-6,7,1,3,1,4,-6,7,1,1,2,3,-1,-12,-7,-1,-2,3,0,0,0,-1,-1,0,-1,6,-1
KR_6738466552,420,1,5,4,3,4,0,4,1,2,3,4,2,6,-6,9,3,0,1,1,0,2,-9,2,-5,3,0,0,1,1,1,1,-1,3,-1
KR_6723335410,420,-2,-97,8,-2,-5,6,1,2,4,6,-3,5,2,1,2,3,3,1,4,0,5,5,-2,-3,5,0,0,-1,1,0,1,-1,5,-1
KR_6697584808,420,2,40,35,-4,-1,1,0,-2,3,1,-4,5,1,-1,1,0,4,0,4,0,-3,-7,-1,-2,3,-5,0,0,-1,0,0,-1,5,-1
KR_6640871396,420,1,-26,4,1,2,1,3,-3,3,0,-4,5,1,4,0,4,2,0,2,0,1,-7,-2,-2,4,-2,0,-1,-1,-1,-1,1,4,-1
KR_6697398618,420,-5,-55,-7,-12,-3,3,0,0,1,1,1,0,1,-7,7,0,-3,4,1,0,-8,-3,2,-7,5,-3,0,0,-1,1,1,-1,5,-1
KR_6726186245,420,-2,23,27,-16,0,2,2,-3,5,2,2,3,5,-11,11,0,-4,4,0,0,-13,-8,-2,-3,5,-2,0,-2,-1,-1,-1,-1,1,-1
KR_6648960671,420,-3,-73,-6,-3,0,1,1,1,1,2,-2,6,4,-4,4,0,2,1,3,0,7,-7,-2,-1,3,3,0,-1,1,-1,-1,-1,4,-1
KR_6760693793,420,-2,-37,-4,-2,1,1,2,2,0,2,5,4,9,-4,6,2,-6,7,1,0,-5,93,-2,-1,3,-1,0,0,-1,1,-1,1,2,-1
KR_6741951222,420,-3,-39,23,-6,-2,4,2,-1,7,6,-3,5,2,1,1,2,-1,4,3,0,-4,-303,-3,-1,4,-13,0,-1,0,0,-1,-1,0,-1
KR_6753525596,420,-2,49,15,-8,-5,6,1,-3,4,1,1,1,2,-2,3,1,1,1,2,0,-8,-118,0,-2,2,-3,0,0,-1,-1,-1,-1,2,-1
KR_6740999149,420,-5,-129,-19,-9,-4,5,1,-1,3,2,1,4,5,-2,3,1,-3,3,0,1,3,7,-3,-1,4,-2,0,-3,-1,-1,-1,1,3,-1
KR_6748796558,420,1,10,7,5,-2,5,3,-2,3,1,4,1,5,3,1,4,2,0,2,0,-2,16,0,-4,4,2,0,1,1,1,1,1,2,-1
KR_6757072479,420,-5,-14,20,-17,-2,5,3,-3,5,2,-6,6,0,-5,6,1,-1,1,0,-1,-12,-4,-2,-1,3,0,0,-1,-1,1,-1,-1,1,-1
KR_6668519385,420,-3,-99,-4,-3,-4,4,0,2,1,3,0,4,4,-1,1,0,0,2,2,-1,2,-3,-3,0,3,-1,0,-3,1,-1,-1,-1,3,-1
KR_6676439533,420,-3,-12,-36,-2,2,1,3,5,0,5,-4,4,0,-2,3,1,-3,3,0,0,1,0,1,-8,7,-3,0,0,-1,1,-1,-1,2,-1
KR_6712082473,420,-2,-29,8,1,-3,3,0,-3,4,1,2,0,2,2,0,2,3,0,3,0,2,-4,1,-2,1,-1,0,1,1,-1,1,-1,1,-1
KR_6740950394,420,-2,-61,-12,-7,0,2,2,-4,4,0,-5,5,0,1,3,4,1,1,2,0,-6,-8,-1,0,1,0,0,-1,0,0,-1,-1,0,-1
KR_6657641826,420,0,15,-25,6,3,1,4,2,2,4,1,0,1,-1,2,1,1,2,3,3,16,2,0,-3,3,1,0,0,-1,-1,0,1,4,-1
KR_6730502610,420,-6,-105,-12,-10,0,0,0,-1,4,3,-10,10,0,-1,1,0,2,1,3,0,-3,-8,-3,0,3,1,0,-2,-1,-1,-1,-1,4,-1
KR_6759179105,420,1,-49,12,-2,-2,2,0,0,2,2,1,0,1,-1,3,2,0,2,2,0,0,-54,-4,-1,5,17,0,0,1,-1,-1,1,1,-1
KR_6709722525,420,-6,-54,-16,-8,-4,4,0,-3,4,1,-1,1,0,1,2,3,-1,1,0,0,-7,-10,2,-4,2,-1,0,-3,-1,-1,-1,-1,3,-1
KR_6723530579,420,-3,-82,9,-5,1,1,2,-2,3,1,-5,5,0,1,4,5,0,0,0,-1,-6,-12,-2,-3,5,2,0,-1,0,-1,-1,-1,0,-1
KR_6760555298,420,-2,-60,-9,-6,-2,3,1,2,0,2,-2,4,2,-2,2,0,-2,2,0,0,-5,4,3,-5,2,-6,0,0,1,0,0,-1,2,-1
KR_6764356818,420,-5,-46,-33,-11,1,1,2,-1,2,1,-8,8,0,-4,4,0,1,1,2,-1,-5,36,3,-5,2,2,0,-1,-1,1,-1,-1,1,-1
KR_6699813516,420,-2,11,20,-3,-2,4,2,0,4,4,1,2,3,-2,3,1,0,0,0,1,-4,2,1,-2,1,0,0,0,0,-1,1,1,0,-1
KR_6649274034,420,-1,-42,-16,-2,-4,5,1,1,2,3,0,3,3,-1,1,0,2,0,2,0,2,11,-1,0,1,5,0,1,1,1,1,-1,1,-1
KR_6732938266,420,-3,-117,-7,1,-2,2,0,-2,4,2,1,2,3,3,0,3,1,0,1,0,4,45,-4,-2,6,-22,0,-1,-1,-1,-1,-1,6,-1
KR_6731471607,420,-1,-36,-16,-4,0,1,1,3,3,6,-10,10,0,2,1,3,1,0,1,0,-1,7,0,-1,1,0,0,-1,1,-1,-1,-1,5,-1
KR_6691224260,440,-4,-82,-17,-7,-3,4,1,-5,6,1,0,4,4,1,2,3,0,2,2,0,-11,6,-5,-1,6,-2,0,-3,1,0,-1,-1,5,-1
KR_6686682286,420,2,19,18,4,-1,3,2,3,1,4,3,2,5,-2,3,1,1,0,1,-1,-1,10,0,-1,1,-2,0,0,-1,-1,0,-1,2,-1
KR_6747361311,420,-2,-10,1,0,-1,2,1,-2,3,1,0,1,1,1,1,2,2,0,2,0,0,60,-3,-2,5,-2,0,0,0,0,0,1,0,-1
KR_6704876846,420,-3,-15,-4,-3,-5,5,0,1,1,2,-3,4,1,3,2,5,1,0,1,-1,-1,-5,-1,-3,4,-1,0,0,1,-1,0,-1,4,-1
KR_6747406528,420,-1,-13,-6,-2,-6,6,0,-1,3,2,1,1,2,5,1,6,-1,3,2,2,4,2,-4,0,4,0,0,0,-1,0,0,1,1,-1
KR_6759104826,420,-1,25,6,-1,2,0,2,-1,3,2,2,5,7,-4,4,0,0,1,1,0,-1,3,1,-4,3,-2,0,1,-1,1,1,1,2,-1
KR_6689883824,420,-5,-141,-16,-6,-1,2,1,-1,2,1,-3,4,1,1,1,2,-2,3,1,0,6,8,3,-6,3,-6,0,-1,1,-1,-1,-1,2,-1
KR_6639825115,420,-9,-169,-32,-14,-2,3,1,0,3,3,1,2,3,-12,12,0,-1,1,0,0,-9,1,-1,-3,4,-2,0,-3,-1,-1,-1,-1,4,-1
KR_6741430295,420,-2,-82,-12,-3,0,1,1,1,2,3,-3,4,1,-1,2,1,0,1,1,0,-1,-9,-5,0,5,-3,0,0,-1,1,-1,-1,4,-1
KR_6764106722,420,-5,-45,-41,-10,2,1,3,-1,3,2,-2,7,5,-7,8,1,-2,3,1,1,-14,4,1,-3,2,1,0,-1,-1,-1,-1,1,6,-1
KR_6760871891,420,2,25,11,3,0,2,2,2,0,2,2,0,2,-3,5,2,2,1,3,0,2,-16,2,-4,2,2,0,1,1,-1,1,1,2,-1
KR_6739075058,420,1,-3,2,8,1,1,2,2,0,2,0,6,6,4,0,4,1,0,1,3,13,3,1,-2,1,2,0,1,1,0,1,1,2,-1
KR_6681069318,420,5,92,11,15,0,2,2,3,2,5,9,1,10,1,1,2,2,0,2,0,12,67,-1,-2,3,-21,0,2,1,1,1,1,5,-1
KR_6752995495,420,4,-44,19,1,3,1,4,3,2,5,-2,3,1,-2,3,1,-1,3,2,0,15,0,-1,-3,4,-1,0,2,-1,1,1,1,3,-1
KR_6749469324,440,-5,-26,-18,-7,1,0,1,2,3,5,-3,5,2,-6,8,2,-1,1,0,1,-1,-1,-4,-1,5,0,0,0,-1,1,0,1,6,-1
KR_6692489707,420,-5,-24,-15,-10,2,0,2,-8,10,2,-5,6,1,1,2,3,0,0,0,-1,-9,-41,-4,-3,7,26,0,-2,-1,-1,-1,-1,3,-1
KR_6739242887,420,-4,-16,8,-9,-2,3,1,-2,2,0,4,2,6,-6,6,0,-3,3,0,0,-9,50,-1,-2,3,1,0,0,0,-1,0,1,0,-1
KR_6703040450,420,2,61,-19,0,1,4,5,1,4,5,0,2,2,-5,6,1,3,0,3,-1,10,-272,3,-3,0,1,0,0,-1,0,1,-1,6,-1
KR_6762031471,420,-3,-57,-12,-5,-1,1,0,2,0,2,-4,4,0,0,3,3,-2,3,1,0,-5,262,-1,-4,5,7,0,0,1,1,0,-1,1,-1
KR_6735182693,420,-1,-15,8,-1,-1,4,3,4,1,5,-3,4,1,-4,5,1,3,0,3,0,0,41,5,-9,4,0,0,0,-1,-1,0,-1,3,-1
KR_6731875815,420,0,6,-3,6,7,0,7,-2,3,1,-2,2,0,6,0,6,-3,3,0,0,1,-12,1,-1,0,0,0,-1,1,1,1,-1,3,-1
KR_6738636534,420,2,0,20,-2,-2,2,0,-4,6,2,3,0,3,2,2,4,-1,1,0,-1,-4,-3,-5,-1,6,-1,0,0,-1,1,0,-1,3,-1
KR_6756149793,420,0,31,0,1,-2,5,3,-3,5,2,1,1,2,1,3,4,4,0,4,0,1,5,0,-2,2,1,0,-1,-1,0,-1,-1,1,-1
KR_6705980330,420,0,23,-20,0,2,1,3,-2,3,1,-7,8,1,3,0,3,4,0,4,0,-1,-2,-3,0,3,2,0,0,-1,1,0,-1,6,-1
KR_6730248377,420,-2,22,0,-12,-6,8,2,-2,4,2,-2,3,1,-1,6,5,-1,2,1,0,-4,-1,2,-3,1,2,0,0,-1,-1,0,-1,2,-1
KR_6757359909,440,0,20,12,3,-1,3,2,-3,3,0,2,0,2,0,2,2,5,0,5,1,0,-11,1,-6,5,0,0,0,1,-1,0,1,1,-1
KR_6759907989,420,-2,3,28,-1,-2,4,2,1,1,2,2,1,3,-1,5,4,-1,1,0,0,2,11,3,-6,3,0,0,1,-1,1,1,-1,2,-1
KR_6757785837,420,-1,-52,-8,-3,-3,4,1,0,1,1,2,3,5,0,2,2,-2,2,0,-1,-2,11,5,-7,2,-1,0,-1,1,-1,-1,-1,3,-1
KR_6750204212,420,-3,-2,1,-12,1,1,2,-8,9,1,-3,4,1,-2,3,1,0,0,0,-1,-12,-4,3,-4,1,-2,0,-1,-1,0,-1,-1,3,-1
KR_6763448115,420,-4,-52,-4,-5,1,3,4,-7,7,0,2,3,5,-1,5,4,0,1,1,2,-6,-2,-4,-1,5,-1,0,0,-1,1,0,1,1,-1
KR_6738504831,420,-3,-59,-12,-4,0,1,1,0,2,2,-1,2,1,-1,3,2,-2,6,4,0,2,13,-5,0,5,0,0,-1,-1,-1,-1,-1,2,-1
KR_6758069960,440,0,-43,8,-1,-2,2,0,0,0,0,0,0,0,0,0,0,1,1,2,0,0,-165,0,-3,3,-4,0,-1,0,0,-1,-1,0,-1
KR_6742387349,420,-2,-34,-16,0,-1,1,0,0,2,2,-2,4,2,3,0,3,0,1,1,0,2,-1,-1,-2,3,0,0,0,-1,1,0,-1,6,-1
KR_6718958873,420,1,20,-24,-6,4,0,4,-6,7,1,-2,4,2,-3,5,2,1,0,1,0,-5,7,0,-1,1,-1,0,-1,0,-1,-1,1,0,-1
KR_6713199541,420,-4,-86,19,-16,1,3,4,2,0,2,-4,5,1,-13,14,1,-2,2,0,0,-15,3,3,-6,3,2,0,-1,-1,1,-1,-1,1,-1
KR_6649983596,420,-4,-30,16,-10,-1,2,1,0,0,0,-2,2,0,-4,7,3,-3,5,2,0,-8,16,-4,-1,5,-1,0,0,-1,1,1,1,6,-1
KR_6759006302,420,-1,36,12,-7,-2,2,0,-2,3,1,-2,2,0,0,1,1,-1,1,0,0,-6,0,0,-3,3,2,0,1,1,-1,1,-1,5,-1
KR_6760577115,440,-3,-68,20,-6,-1,2,1,-2,4,2,-7,8,1,1,3,4,3,1,4,0,-5,-3,-2,0,2,-1,0,-1,-1,-1,-1,1,3,-1
KR_6690007667,420,0,11,3,3,-1,1,0,2,2,4,5,1,6,-1,4,3,-2,2,0,0,6,-8,-2,-2,4,1,0,0,-1,-1,0,-1,6,-1
KR_6734075471,420,-2,-93,0,-1,-3,3,0,6,0,6,0,2,2,-3,3,0,-1,1,0,0,8,44,1,-1,0,1,0,-1,1,0,-1,-1,2,-1
KR_6756355322,420,-4,-94,-3,-8,-4,4,0,3,2,5,-2,3,1,-5,6,1,0,0,0,0,-6,-271,-2,-2,4,4,0,0,0,0,0,1,0,-1
KR_6751436926,420,0,37,-4,-1,4,0,4,-1,2,1,0,1,1,-4,4,0,0,1,1,0,-5,-2,2,-4,2,-2,0,0,1,0,-1,-1,6,-1
KR_6752783771,420,2,84,0,5,2,0,2,0,3,3,5,0,5,-1,4,3,-1,1,0,0,4,2,2,-6,4,1,0,0,-1,-1,0,1,2,-1
KR_6745367165,420,-3,-9,-32,-8,-4,6,2,-2,3,1,1,2,3,0,4,4,-3,3,0,0,-9,12,0,-3,3,0,0,-4,1,-1,-1,-1,5,-1
KR_6763882765,420,-4,-65,8,-8,0,4,4,1,1,2,-2,4,2,-7,7,0,0,0,0,-1,-6,-8,0,-5,5,2,0,0,0,1,0,-1,0,-1
KR_6697089352,420,-1,-16,16,-2,-8,8,0,-1,7,6,3,0,3,4,1,5,0,1,1,0,7,9,6,-7,1,-2,0,0,1,-1,0,-1,1,-1
KR_6696972870,420,3,53,28,5,-2,2,0,3,1,4,5,0,5,-1,2,1,0,1,1,-1,2,545,2,-4,2,-2,0,2,-1,-1,1,-1,5,-1
KR_6763772864,420,-3,-40,0,-7,-2,3,1,0,1,1,-3,3,0,-2,2,0,0,0,0,0,-6,3,5,-7,2,-4,0,-1,-1,-1,-1,-1,1,-1
KR_6697455669,420,0,-65,-3,5,0,2,2,2,2,4,-2,3,1,4,1,5,1,1,2,0,7,107,4,-5,1,1,0,1,1,1,1,1,6,-1
KR_6743915089,420,0,-96,44,-5,3,0,3,-6,8,2,3,1,4,-4,6,2,-1,1,0,-1,-6,-40,1,-2,1,14,0,-3,1,-1,-1,-1,6,-1
KR_6750822581,440,0,-52,15,-6,-3,6,3,2,1,3,-2,2,0,-1,2,1,-2,2,0,-1,-3,26,3,-4,1,-19,0,0,-1,0,0,-1,5,-1
KR_6738476089,420,-4,-72,0,-3,-3,4,1,0,3,3,-1,1,0,2,0,2,-1,3,2,0,1,7,1,-3,2,-2,0,-1,-1,0,-1,-1,2,-1
KR_6686551671,420,-5,-31,-9,-11,-2,3,1,-5,6,1,4,2,6,-7,9,2,-1,2,1,0,-6,-8,-2,-2,4,1,0,-1,-1,1,-1,1,1,-1
KR_6727409694,420,0,-124,12,-4,-1,2,1,3,0,3,-5,5,0,-2,5,3,1,4,5,-1,-3,-3,1,-2,1,-3,0,0,-1,0,0,-1,1,-1
KR_6686607207,420,-2,-114,8,3,2,0,2,2,1,3,-7,9,2,4,1,5,2,0,2,2,21,-7,-1,-1,2,-2,0,-1,1,1,-1,1,5,-1
KR_6700486726,440,-6,-35,-34,-15,-1,2,1,0,1,1,-2,2,0,-9,9,0,-3,5,2,0,-9,-49,-2,-1,3,13,0,-2,-1,0,-1,-1,2,-1
KR_6728726881,420,-1,-64,53,2,-1,1,0,-1,1,0,-3,4,1,7,1,8,0,0,0,0,1,-5,3,-4,1,-2,0,0,1,1,0,1,6,-1
KR_6757962515,420,-2,-55,2,-2,-2,3,1,-4,4,0,0,0,0,6,0,6,-2,3,1,1,1,0,0,-4,4,-1,0,-2,0,-1,-1,1,0,-1
KR_6714324251,420,0,-46,-9,8,5,1,6,3,0,3,1,2,3,1,2,3,-2,4,2,-1,13,233,-1,-1,2,-4,0,0,-1,1,-1,-1,5,-1
KR_6697548735,420,-2,-86,20,-3,0,3,3,1,0,1,-3,5,2,0,2,2,-1,4,3,0,-7,-1,3,-5,2,-2,0,-2,-1,-1,-1,-1,1,-1
KR_6750700058,420,0,46,8,0,-2,2,0,-4,4,0,1,1,2,3,1,4,2,0,2,0,-3,-17,-5,-1,6,0,0,0,-1,-1,0,1,6,-1
KR_6761110171,420,-2,-45,13,-9,-4,5,1,1,0,1,-1,2,1,-5,7,2,0,0,0,0,-8,8,-1,-3,4,-3,0,-1,-1,-1,-1,-1,4,-1
KR_6740751492,420,0,13,27,-6,2,2,4,-4,5,1,-1,1,0,-1,1,0,-2,2,0,-2,-12,-26,3,-3,0,0,0,1,1,1,1,-1,3,-1
KR_6685344796,420,-1,-20,36,-5,3,1,4,0,3,3,-4,4,0,-3,5,2,-1,2,1,-1,-11,33,0,-4,4,0,0,-1,1,-1,-1,-1,1,-1
KR_6708706319,420,-4,-76,-59,-3,-5,5,0,1,1,2,1,2,3,1,0,1,-1,3,2,0,1,-4,2,-3,1,1,0,-2,0,1,-1,-1,0,-1
KR_6764433874,420,-2,-32,-24,-4,-8,8,0,-2,3,1,1,3,4,4,0,4,1,2,3,0,-4,-217,-5,-3,8,6,0,-1,1,1,-1,-1,4,-1
KR_6741594459,420,3,68,-42,2,3,0,3,-2,3,1,3,1,4,0,2,2,-2,3,1,-2,-3,312,0,-1,1,23,0,-1,-1,-1,-1,-1,5,-1
KR_6720430406,420,2,89,8,-3,-1,2,1,-1,2,1,-4,6,2,2,2,4,1,0,1,0,-5,4,2,-4,2,1,0,0,1,-1,-1,-1,6,-1
KR_6755085007,420,0,-34,12,-4,-5,7,2,-3,3,0,4,5,9,2,3,5,-2,2,0,-1,0,4,-2,-1,3,-1,0,-1,1,0,-1,-1,2,-1
KR_6763714712,420,-3,-52,12,-10,-1,4,3,-3,3,0,1,3,4,-6,9,3,-1,2,1,0,0,3,-3,-2,5,-3,0,-3,-1,1,-1,-1,4,-1
KR_6762598602,420,3,75,3,6,5,0,5,0,1,1,3,3,6,-2,4,2,0,3,3,0,-2,-1,2,-2,0,-2,0,1,-1,-1,1,1,1,-1
KR_6732873209,420,-5,-68,-16,-5,0,2,2,1,1,2,-4,5,1,-3,3,0,1,0,1,0,2,7,0,-4,4,0,0,0,-1,1,-1,-1,2,-1
KR_6683072097,420,-1,-47,-8,-12,-1,1,0,2,2,4,4,1,5,-16,16,0,-1,1,0,-1,-5,3,-2,0,2,1,0,-2,-1,0,-1,-1,4,-1
KR_6729176963,420,-3,33,-24,-3,0,2,2,-3,5,2,-3,3,0,3,0,3,0,2,2,1,-6,-7,5,-7,2,-1,0,-1,1,-1,-1,1,4,-1
KR_6675051766,420,3,-17,12,4,4,0,4,6,3,9,-5,5,0,-3,5,2,2,0,2,0,9,-1,-1,-3,4,1,0,0,1,1,0,1,5,-1
KR_6754579604,420,-3,-52,-45,-8,-1,3,2,-4,5,1,-5,6,1,-1,2,1,3,0,3,0,-3,37,-4,0,4,-32,0,-1,-1,0,-1,-1,4,-1
KR_6760819168,440,-5,18,-12,-21,2,3,5,-6,6,0,-9,9,0,-1,3,2,-7,7,0,1,-14,-7,-1,-1,2,1,0,-1,-1,-1,-1,1,1,-1
KR_6645992806,440,-1,31,-16,-4,1,0,1,-2,6,4,4,1,5,-6,7,1,-1,1,0,-1,-9,-1,0,-2,2,-1,0,1,-1,-1,1,-1,2,-1
KR_6661925396,420,-1,-47,20,1,-2,2,0,3,1,4,-5,7,2,1,2,3,4,2,6,0,10,12,3,-6,3,-2,0,-1,-1,0,-1,1,1,-1
KR_6729344040,420,0,0,-21,-2,3,1,4,1,1,2,-2,4,2,-4,4,0,0,0,0,0,-4,228,0,-6,6,0,0,-1,-1,1,-1,1,1,-1
KR_6709598621,420,0,6,4,-1,0,0,0,-6,6,0,1,2,3,2,5,7,2,2,4,1,-7,45,-1,-3,4,3,0,0,-1,-1,0,1,4,-1
KR_6648793802,420,-9,-105,-60,-23,-1,3,2,-9,10,1,-7,7,0,-6,7,1,0,0,0,-1,-19,10,0,-4,4,-5,0,-1,0,0,-1,-1,0,-1
KR_6659047976,420,-2,32,-24,0,0,1,1,1,0,1,0,0,0,1,2,3,-2,2,0,0,4,-6,0,-2,2,3,0,0,0,-1,0,-1,0,-1
KR_6750591720,420,-2,-6,-15,-2,-2,5,3,-1,3,2,0,2,2,0,3,3,1,0,1,0,-2,-3,-6,0,6,-1,0,-2,1,-1,-1,-1,3,-1
KR_6751537750,420,-5,-73,8,-13,0,2,2,-8,11,3,-1,4,3,-4,6,2,0,1,1,-2,-20,-10,-3,-3,6,1,0,-1,-1,0,-1,1,5,-1
KR_6646436697,420,-1,-45,-8,1,-3,3,0,3,1,4,6,0,6,-4,4,0,-1,3,2,0,-2,11,0,-4,4,-3,0,-1,1,1,-1,1,2,-1
KR_6671710103,420,-1,5,12,-3,1,3,4,-1,3,2,-3,6,3,1,2,3,-1,2,1,0,-6,292,-1,0,1,18,0,0,1,-1,-1,-1,3,-1
KR_6643755305,420,1,27,8,5,2,0,2,0,0,0,4,1,5,-2,2,0,1,0,1,0,0,17,0,0,0,-21,0,-1,-1,-1,-1,1,5,-1
KR_6723221284,420,-1,-17,17,-2,1,0,1,0,1,1,-3,4,1,1,1,2,-1,2,1,0,4,-165,2,-3,1,3,0,0,1,0,-1,1,6,-1
KR_6736310296,420,-6,-99,-24,-14,-11,11,0,-5,6,1,1,2,3,1,1,2,0,1,1,0,-11,-4,-4,-2,6,3,0,-2,1,-1,-1,-1,3,-1
KR_6753114671,420,-2,-38,39,-9,-1,1,0,1,1,2,0,2,2,-7,9,2,-2,3,1,0,-5,147,0,-5,5,0,0,1,1,1,1,-1,6,-1
KR_6761279278,440,-2,-9,6,-6,-2,5,3,0,1,1,3,0,3,-4,7,3,-3,3,0,-1,-5,-7,5,-5,0,-1,0,-1,-1,-1,-1,-1,2,-1
KR_6685757257,440,-5,8,-19,-15,-2,2,0,-4,5,1,-9,10,1,0,1,1,0,2,2,0,-16,387,2,-2,0,2,0,0,-1,-1,-1,1,6,-1
KR_6761668852,440,-2,-15,20,-2,0,1,1,-2,4,2,-1,1,0,1,0,1,0,2,2,-1,-6,4,2,-4,2,-1,0,0,1,1,0,-1,1,-1
KR_6670893114,420,1,-56,13,3,-2,2,0,8,0,8,-1,2,1,0,1,1,-2,2,0,0,6,32,1,-4,3,1,0,0,0,1,1,-1,0,-1
KR_6749252037,420,1,15,-9,8,8,1,9,-2,2,0,-2,5,3,2,2,4,2,1,3,0,5,-3,-3,0,3,1,0,1,-1,0,1,1,5,-1
KR_6680769157,420,-2,41,-34,-1,0,0,0,-2,3,1,-1,2,1,1,2,3,1,0,1,0,1,14,3,-6,3,-5,0,0,-1,1,0,-1,6,-1
KR_6734990441,420,-4,-43,15,-6,0,1,1,-3,4,1,-2,3,1,0,4,4,-1,3,2,0,-7,-4,4,-4,0,0,0,0,-1,1,1,-1,1,-1
KR_6761464189,440,-8,-141,-20,-7,-2,2,0,0,3,3,-1,1,0,-4,5,1,0,2,2,0,-10,-2,2,-2,0,1,0,-1,0,0,-1,-1,0,-1
KR_6733198268,420,3,14,28,3,5,1,6,-2,5,3,1,2,3,-1,3,2,0,3,3,0,-2,-179,2,-4,2,-4,0,1,1,1,1,-1,3,-1
KR_6739173654,420,-1,12,-16,8,2,2,4,0,4,4,-1,5,4,2,1,3,5,0,5,0,7,4,0,-2,2,0,0,1,1,-1,1,1,1,-1
KR_6755162685,440,-3,-80,-4,-10,-1,1,0,-1,4,3,-3,3,0,0,1,1,-5,6,1,1,-8,99,-2,0,2,0,0,0,0,-1,-1,1,0,-1
KR_6730316477,440,-2,-10,-1,-6,-2,4,2,-1,3,2,2,4,6,-5,6,1,0,1,1,0,-10,0,-6,0,6,1,0,1,-1,1,-1,1,6,-1
KR_6687631010,420,-3,-103,-42,-5,-3,3,0,0,0,0,-1,1,0,-3,4,1,2,1,3,0,-2,-81,-2,-2,4,1,0,0,-1,-1,-1,1,2,-1
KR_6756703329,420,0,-58,-4,6,0,1,1,2,1,3,-2,3,1,5,0,5,1,0,1,-1,10,-22,-2,-6,8,3,0,0,0,1,0,-1,0,-1
KR_6698711622,420,-2,-44,-8,-5,-3,3,0,-2,3,1,-1,4,3,-1,3,2,2,4,6,0,-2,12,-3,-2,5,1,0,-2,-1,-1,-1,-1,5,-1
KR_6705688460,420,-1,-58,-4,0,0,2,2,1,2,3,4,1,5,0,1,1,-5,5,0,0,0,1,2,-3,1,2,0,0,0,1,0,-1,0,-1
KR_6711254224,420,0,-2,0,1,0,3,3,-1,2,1,-3,3,0,3,4,7,2,0,2,0,3,6,3,-4,1,-3,0,1,1,-1,1,1,1,-1
KR_6753868316,420,-1,-26,-1,0,-5,5,0,0,2,2,3,1,4,0,2,2,2,0,2,0,1,28,1,-2,1,2,0,0,-1,1,0,1,6,-1
KR_6756122287,420,-3,-57,-8,-3,1,3,4,1,0,1,-4,7,3,-1,2,1,0,0,0,-2,2,5,1,-2,1,-3,0,-1,-1,1,-1,-1,6,-1
KR_6732987215,420,-6,-47,-8,5,-2,2,0,0,2,2,1,5,6,5,0,5,1,0,1,0,7,-18,5,-6,1,0,0,-4,-1,-1,-1,-1,1,-1
KR_6760932090,420,-7,-61,-24,-15,-3,3,0,-7,7,0,-2,2,0,-2,3,1,-1,3,2,0,-13,-12,1,-3,2,-2,0,-1,-1,1,-1,1,6,-1
KR_6761098373,420,-3,-21,-12,-4,-2,4,2,0,4,4,-7,8,1,5,0,5,0,1,1,0,10,-2,-4,0,4,2,0,-1,-1,-1,-1,1,3,-1
KR_6755099608,420,-4,-34,23,-13,-2,4,2,2,0,2,-6,7,1,-6,8,2,-1,4,3,-1,-6,32,-2,0,2,-22,0,0,0,0,-1,-1,0,-1
KR_6648981113,420,0,32,1,-2,3,1,4,-2,2,0,-3,7,4,-1,3,2,1,2,3,0,-1,3,3,-5,2,-2,0,0,-1,0,0,-1,5,-1
KR_6760995884,420,-1,-44,-29,-4,-1,2,1,0,3,3,-4,7,3,0,1,1,1,0,1,0,0,-3,0,-3,3,1,0,0,1,-1,-1,-1,1,-1
KR_6750172320,420,-1,-47,-16,-1,2,0,2,-1,4,3,3,3,6,-2,2,0,-3,3,0,-2,-7,6,2,-4,2,-6,0,0,-1,-1,0,-1,1,-1
KR_6655073112,420,0,-20,-4,-2,-4,4,0,4,4,8,0,2,2,-3,4,1,1,0,1,0,1,1,2,-4,2,1,0,-1,1,-1,-1,-1,1,-1
KR_6734183819,420,1,-38,-10,8,-4,4,0,0,2,2,8,1,9,3,1,4,1,1,2,0,8,-7,-2,0,2,3,0,0,-1,0,-1,-1,5,-1
KR_6736535753,420,1,5,-12,-1,-3,3,0,0,1,1,0,1,1,1,1,2,1,1,2,0,0,21,-2,0,2,0,0,-1,-1,-1,-1,1,1,-1
KR_6708605898,420,-4,-99,-34,-13,-3,4,1,3,1,4,-7,8,1,-2,2,0,-4,4,0,-1,-3,-3,-3,-3,6,2,0,0,-1,0,-1,-1,4,-1
KR_6757962150,420,-1,-38,24,-11,-3,4,1,-2,3,1,-6,10,4,-1,3,2,1,3,4,0,-7,8,0,-4,4,0,0,-2,-1,1,-1,-1,2,-1
KR_6732803860,420,0,42,2,2,5,0,5,-2,4,2,0,1,1,-1,1,0,0,0,0,0,-7,302,0,-3,3,1,0,0,1,-1,0,1,2,-1
KR_6760796019,440,3,3,28,-1,4,1,5,3,1,4,-5,7,2,-3,3,0,0,0,0,0,2,8,-5,0,5,2,0,0,0,1,0,-1,0,-1
KR_6756761521,440,0,-5,8,-8,-2,3,1,-3,3,0,-8,8,0,2,1,3,3,0,3,-2,-5,31,1,-5,4,-16,0,0,0,1,0,-1,0,-1
KR_6741725142,420,-2,-55,0,-4,0,0,0,2,2,4,-5,6,1,-1,3,2,0,0,0,0,-3,3,1,-3,2,-3,0,-3,-1,-1,-1,-1,3,-1
KR_6640812933,420,-3,-37,-19,-1,-5,5,0,2,0,2,0,3,3,2,1,3,0,2,2,0,4,25,-1,-3,4,-3,0,0,-1,1,0,-1,4,-1
KR_6740125522,420,-3,-26,29,-5,0,2,2,0,0,0,-7,8,1,3,2,5,-1,1,0,0,-5,17,1,-3,2,-4,0,0,1,1,1,-1,5,-1
KR_6745569875,420,-3,-11,-20,0,-3,4,1,1,1,2,0,2,2,-1,3,2,3,0,3,0,0,-7,0,-2,2,0,0,0,1,1,0,-1,1,-1
KR_6731207211,420,1,88,24,-1,2,1,3,-2,2,0,-2,5,3,1,1,2,0,0,0,0,0,1,2,-5,3,2,0,0,1,-1,1,-1,4,-1
KR_6733806448,420,-2,-11,-16,-7,1,2,3,-8,9,1,-4,5,1,0,2,2,4,0,4,0,-4,-33,-4,-3,7,-1,0,-2,0,-1,-1,-1,0,-1
KR_6725146945,420,-3,-36,-2,-7,-3,4,1,0,2,2,0,1,1,-2,2,0,-2,4,2,1,-4,-380,3,-5,2,-2,0,0,0,-1,-1,1,0,-1
KR_6762974185,420,-1,-11,-20,-7,3,1,4,0,1,1,-6,7,1,-2,4,2,-2,2,0,-2,-8,-16,-2,0,2,2,0,-2,-1,-1,-1,-1,3,-1
KR_6761137653,420,-5,-18,-11,-10,-4,4,0,-3,4,1,0,4,4,-1,2,1,-2,2,0,0,-3,147,4,-5,1,-3,0,-2,-1,-1,-1,-1,4,-1
KR_6760761450,420,1,6,-49,-3,2,1,3,-5,6,1,-3,3,0,4,1,5,-1,2,1,0,-1,5,0,-4,4,-2,0,-1,-1,-1,-1,1,1,-1
KR_6734372799,420,-6,-118,-4,-12,0,1,1,1,0,1,-6,6,0,-4,4,0,-3,3,0,0,-4,2,0,0,0,-1,0,-1,0,0,-1,-1,0,-1
KR_6731097479,420,0,-55,55,-1,4,0,4,3,2,5,-2,2,0,-5,5,0,-1,3,2,0,-1,27,1,-1,0,-1,0,-1,0,1,-1,1,0,-1
KR_6761151702,420,-9,-108,-12,-16,3,0,3,-6,6,0,-5,5,0,-6,9,3,-2,3,1,0,-16,2,0,-2,2,-2,0,-3,0,-1,-1,1,0,-1
KR_6700464173,440,3,5,4,10,-2,2,0,0,4,4,-1,3,2,12,2,14,1,1,2,0,8,8,3,-6,3,-3,0,2,-1,1,1,1,6,-1
KR_6677602315,420,0,19,-4,0,1,2,3,-4,4,0,-1,2,1,4,1,5,0,0,0,0,0,5,2,-3,1,-2,0,0,-1,0,0,-1,6,-1
KR_6759689307,440,-1,-61,0,-2,-2,2,0,2,0,2,1,5,6,-4,4,0,1,1,2,1,-3,2,-3,0,3,-2,0,-1,1,0,-1,1,2,-1
KR_6723397252,420,-2,49,-12,-3,3,0,3,1,0,1,-7,11,4,0,3,3,0,2,2,-1,-1,-3,3,-5,2,-2,0,0,1,-1,-1,-1,6,-1
KR_6640612670,440,-2,-60,-8,1,-1,3,2,3,3,6,-3,5,2,0,5,5,2,0,2,0,5,-8,-2,-2,4,-1,0,1,-1,1,1,-1,6,-1
KR_6759878572,420,0,-56,-4,-2,1,0,1,1,1,2,0,4,4,-3,4,1,-1,2,1,-1,-5,-15,-2,-2,4,-3,0,0,1,1,1,-1,2,-1
KR_6658338759,420,0,-61,3,-3,-2,2,0,2,3,5,-1,3,2,0,0,0,-2,2,0,0,0,2,1,-5,4,0,0,-2,1,-1,-1,1,5,-1
KR_6761438363,420,1,-36,-4,7,-2,3,1,2,0,2,3,1,4,5,0,5,-1,2,1,0,14,-34,3,-4,1,22,0,-1,-1,-1,-1,1,1,-1
KR_6761575773,420,-2,-51,-25,2,-3,5,2,1,2,3,2,3,5,3,0,3,-1,2,1,0,10,-6,-4,0,4,-1,0,-1,-1,-1,-1,1,3,-1
KR_6756321520,420,-4,-29,-28,-10,-7,8,1,0,0,0,2,2,4,-3,5,2,-2,2,0,-1,-5,327,0,-2,2,-2,0,-1,-1,-1,-1,-1,5,-1
KR_6734761786,420,-2,-36,4,-3,-4,4,0,3,0,3,-1,3,2,-3,4,1,2,3,5,-1,4,8,2,-7,5,-1,0,0,0,1,0,-1,0,-1
KR_6638300845,440,-5,-57,-18,-6,-3,3,0,0,4,4,-2,2,0,-1,2,1,0,2,2,0,-1,12,-9,-3,12,-7,0,0,0,0,0,-1,0,-1
KR_6733363646,440,-4,-61,-4,-3,4,0,4,-5,8,3,-1,4,3,1,1,2,-2,3,1,0,0,-2,0,0,0,0,0,-1,0,0,1,-1,0,-1
KR_6626708886,420,-1,-29,12,-2,1,0,1,0,3,3,1,2,3,-3,5,2,-1,2,1,0,-7,3,0,-2,2,0,0,-1,-1,-1,-1,-1,2,-1
KR_6718140268,420,-1,-30,2,0,1,0,1,-1,3,2,0,1,1,-1,2,1,1,0,1,0,4,-5,-1,-4,5,-3,0,-2,-1,-1,-1,-1,3,-1
KR_6710140940,420,0,-29,8,-3,0,2,2,1,0,1,2,1,3,-5,5,0,-1,1,0,0,-5,-40,6,-7,1,29,0,0,1,0,0,-1,3,-1
KR_6685782823,420,-5,-23,-20,-8,0,3,3,-3,4,1,-3,6,3,-1,2,1,-1,1,0,0,-12,-9,-7,0,7,1,0,-1,-1,-1,-1,1,4,-1
KR_6738595126,420,-5,-49,-2,-22,-6,6,0,-5,7,2,2,3,5,-7,8,1,-6,8,2,-1,-21,314,-1,-2,3,-1,0,-1,-1,1,-1,-1,6,-1
KR_6751509744,440,-2,-60,-25,2,-3,4,1,1,4,5,0,0,0,5,2,7,-1,1,0,0,3,0,1,-1,0,-1,0,-1,1,-1,-1,-1,4,-1
KR_6762915650,420,-2,40,0,-4,-1,2,1,2,1,3,-6,7,1,0,2,2,1,0,1,-1,-1,3,-3,-1,4,3,0,1,1,-1,1,-1,6,-1
KR_6722687858,420,-3,-43,-29,-15,0,1,1,0,0,0,-5,6,1,-9,13,4,-1,1,0,0,-16,-37,-1,-2,3,10,0,-1,0,-1,-1,-1,0,-1
KR_6756757798,420,-1,11,7,-4,-1,3,2,0,1,1,-2,6,4,2,0,2,-3,3,0,0,-4,-11,-1,-2,3,-1,0,-2,1,-1,-1,1,3,-1
KR_6706417248,420,-5,-44,-24,-11,-5,7,2,2,1,3,-2,4,2,-6,6,0,0,1,1,0,-13,-4,-5,-2,7,-3,0,0,-1,1,0,-1,3,-1
KR_6759269504,420,-5,-149,-29,-9,1,1,2,2,0,2,-2,5,3,-7,7,0,-3,3,0,0,-14,-8,1,-3,2,0,0,-3,-1,-1,-1,1,5,-1
KR_6731624775,440,-2,66,8,-13,-2,2,0,3,9,12,-6,7,1,-9,10,1,1,2,3,0,-19,-3,0,-2,2,1,0,2,-1,1,1,1,3,-1
KR_6685353813,420,2,38,6,0,-2,2,0,-5,6,1,5,1,6,1,0,1,1,0,1,0,-1,-38,-1,-1,2,28,0,0,-1,0,0,-1,2,-1
KR_6759330667,420,2,66,12,-1,-2,3,1,-1,4,3,1,2,3,1,2,3,0,2,2,0,-1,27,-2,-1,3,-3,0,0,-1,-1,1,-1,4,-1
KR_6751536440,420,2,24,-28,-1,1,3,4,1,2,3,-4,6,2,-2,5,3,3,2,5,0,1,6,-1,-2,3,1,0,-2,0,-1,-1,-1,0,-1
KR_6739939896,420,-3,-53,-4,-5,-13,13,0,-1,2,1,8,2,10,1,1,2,0,1,1,-1,3,-278,-3,-2,5,-3,0,-1,-1,-1,-1,-1,4,-1
KR_6752603126,420,0,20,-8,4,0,3,3,1,1,2,2,3,5,2,0,2,-1,1,0,0,6,-39,2,-4,2,29,0,1,1,0,1,1,6,-1
KR_6731830455,420,-1,0,-36,2,2,3,5,-1,3,2,1,0,1,2,0,2,-2,2,0,0,-4,-7,-2,0,2,1,0,1,1,1,1,1,1,-1
KR_6679292886,420,-1,-80,32,-10,-1,2,1,-5,5,0,-6,9,3,3,1,4,-1,2,1,0,-6,253,0,-3,3,-3,0,-1,1,1,-1,-1,4,-1
KR_6760214637,420,-3,-14,-16,-8,6,1,7,-4,4,0,-8,9,1,-1,1,0,-1,1,0,0,-10,-22,1,-2,1,-1,0,1,-1,1,1,-1,6,-1
KR_6646084536,440,-2,-60,-24,1,-3,4,1,0,1,1,3,3,6,1,1,2,0,0,0,1,7,2,-1,-4,5,1,0,0,-1,-1,-1,1,6,-1
KR_6751368432,420,1,81,0,-3,1,3,4,-1,2,1,-6,7,1,-1,1,0,4,1,5,0,1,-4,3,-6,3,3,0,2,-1,1,1,1,5,-1
KR_6759044004,420,-2,-45,-23,-3,-3,3,0,1,1,2,2,0,2,-1,1,0,-2,2,0,0,-1,10,-2,-2,4,3,0,-1,-1,-1,-1,-1,6,-1
KR_6662692200,420,-2,-19,-48,-1,1,1,2,-1,2,1,-4,5,1,-1,3,2,4,0,4,0,-3,-5,0,-4,4,3,0,-1,0,-1,-1,-1,0,-1
KR_6737306180,420,-1,38,-4,-1,0,1,1,2,0,2,-4,5,1,0,2,2,1,1,2,0,-3,13,1,-4,3,0,0,1,1,-1,1,-1,6,-1
KR_6752862543,420,0,27,-8,-4,-4,6,2,-4,6,2,1,2,3,2,1,3,1,0,1,0,-2,-232,-8,0,8,7,0,0,-1,-1,0,-1,4,-1
KR_6726936830,420,-4,-81,-2,-10,-1,2,1,-1,3,2,-6,6,0,-1,1,0,-1,2,1,0,-8,-6,-1,-2,3,-4,0,-2,1,-1,-1,-1,2,-1
KR_6727776114,420,-4,-124,-44,-3,-2,2,0,-2,3,1,1,1,2,1,0,1,-1,1,0,0,0,-2,-1,-4,5,0,0,0,-1,0,0,1,4,-1
KR_6720397895,420,-2,-84,-2,-10,0,0,0,-1,2,1,-3,8,5,-6,7,1,0,2,2,-1,-13,12,-2,0,2,0,0,-2,-1,0,-1,-1,4,-1
KR_6699983132,420,0,-48,-7,2,-1,1,0,-1,1,0,3,3,6,0,1,1,1,1,2,0,3,-8,-2,-1,3,4,0,1,-1,1,1,1,2,-1
KR_6762338688,420,-1,24,24,-2,-4,5,1,-1,2,1,-3,5,2,5,0,5,1,3,4,0,1,10,-1,-1,2,2,0,-1,-1,1,-1,-1,4,-1
KR_6693023047,420,-1,-55,8,1,-1,3,2,1,1,2,-1,4,3,1,1,2,1,1,2,0,3,-2,4,-6,2,-3,0,-1,1,-1,-1,1,5,-1
KR_6713661976,420,-7,-26,-52,-8,-1,3,2,1,2,3,-1,5,4,-6,8,2,-1,1,0,0,-9,-257,2,-4,2,1,0,0,1,0,0,1,6,-1
KR_6730501969,420,-2,12,-32,-4,-3,3,0,-2,3,1,-3,3,0,3,0,3,1,0,1,0,-3,-2,7,-10,3,2,0,-1,-1,-1,-1,1,4,-1
KR_6764036171,440,-4,-41,-12,-7,-1,3,2,0,1,1,-4,5,1,-2,3,1,0,0,0,0,-6,-227,-2,-1,3,-1,0,-1,-1,1,-1,1,1,-1
KR_6759441545,420,2,28,0,3,3,1,4,1,4,5,-4,5,1,3,0,3,0,1,1,1,4,-40,0,-2,2,21,0,-1,-1,-1,-1,1,2,-1
KR_6687065620,420,0,14,4,1,-1,1,0,3,2,5,1,1,2,1,1,2,-3,3,0,0,1,11,8,-11,3,-1,0,1,1,1,1,-1,3,-1
KR_6759316385,440,0,-13,-12,0,-2,3,1,2,1,3,6,0,6,-5,6,1,-1,1,0,0,-4,6,0,-1,1,-3,0,0,0,0,0,1,0,-1
KR_6716304047,420,-7,-98,26,-23,-4,4,0,0,1,1,-11,11,0,-2,2,0,-6,7,1,0,-19,2,-1,-2,3,-2,0,-2,-1,-1,-1,-1,2,-1
KR_6703254201,420,-2,2,12,-9,-1,1,0,-3,5,2,-1,2,1,-3,3,0,-1,1,0,0,-10,16,-1,-6,7,-4,0,-1,0,-1,-1,-1,0,-1
KR_6631994566,420,2,88,0,-2,-1,1,0,0,4,4,-1,7,6,0,2,2,0,1,1,-1,-6,-8,-4,-1,5,-1,0,0,-1,0,0,-1,6,-1
KR_6763462308,420,-2,7,-10,-7,2,1,3,-3,5,2,-4,5,1,0,5,5,-2,2,0,-2,-23,19,1,-3,2,2,0,0,1,1,1,-1,5,-1
KR_6754177947,420,-1,-86,-20,-1,4,0,4,2,0,2,0,2,2,-3,3,0,-4,4,0,0,-4,-4,1,-2,1,0,0,-1,-1,1,-1,1,5,-1
KR_6761395189,420,-2,-33,4,1,3,2,5,-2,2,0,4,0,4,-3,5,2,-1,2,1,0,-7,-7,1,-4,3,-1,0,-1,1,0,-1,1,5,-1
KR_6726476311,420,-1,-16,-8,-7,-2,2,0,1,2,3,3,3,6,-9,9,0,0,1,1,0,-20,-13,-1,-1,2,0,0,1,-1,0,1,1,6,-1
KR_6726260988,420,-4,-47,-11,-6,-1,2,1,0,3,3,1,3,4,-5,5,0,-1,1,0,0,-8,21,3,-5,2,-8,0,0,-1,1,-1,-1,2,-1
KR_6747167805,440,0,-21,23,1,-4,5,1,3,1,4,-1,3,2,1,4,5,2,1,3,0,3,-7,2,-3,1,-4,0,-1,1,0,-1,-1,2,-1
KR_6735335839,420,-3,-57,-11,-7,-1,4,3,-4,6,2,-2,3,1,-1,2,1,1,0,1,-1,-6,-7,-1,-4,5,1,0,-2,-1,-1,-1,-1,1,-1
KR_6727379948,420,-1,-14,16,-8,1,2,3,3,0,3,-1,2,1,-10,11,1,-1,2,1,1,-5,9,2,-4,2,-6,0,0,1,1,1,1,1,-1
KR_6729469803,420,-2,-72,-36,-5,-4,5,1,1,1,2,-3,4,1,1,1,2,0,0,0,0,-2,7,0,-2,2,-5,0,-2,-1,-1,-1,-1,5,-1
KR_6726422262,420,3,-8,5,8,5,0,5,2,0,2,3,0,3,-3,4,1,1,0,1,1,6,10,4,-5,1,2,0,-1,0,0,-1,1,0,-1
KR_6733928625,420,1,-2,12,3,1,2,3,-2,2,0,1,1,2,3,2,5,0,0,0,0,-1,5,-3,-3,6,2,0,0,1,-1,1,1,6,-1
KR_6754040136,420,1,-104,9,-1,0,0,0,1,2,3,2,0,2,-1,3,2,-3,4,1,1,0,-4,0,-3,3,0,0,-1,1,-1,-1,1,4,-1
KR_6724065796,420,-1,-49,-3,-4,-1,3,2,0,0,0,2,1,3,4,0,4,-9,10,1,0,-5,16,0,-1,1,1,0,1,-1,1,1,-1,3,-1
KR_6708295912,420,3,26,18,3,1,2,3,-1,2,1,-1,5,4,3,0,3,1,0,1,0,2,-262,-1,-1,2,0,0,0,-1,1,0,1,4,-1
KR_6756494290,420,-5,-44,4,-8,1,0,1,-1,2,1,-2,2,0,-5,5,0,-1,1,0,0,-8,19,2,-3,1,-3,0,-1,1,1,-1,-1,5,-1
KR_6733939242,440,0,34,16,-3,1,1,2,0,1,1,-4,5,1,-1,5,4,1,1,2,0,-5,-1,-3,-3,6,5,0,1,-1,1,1,-1,2,-1
KR_6721922539,420,-1,18,0,-2,0,1,1,-3,5,2,1,3,4,0,3,3,0,0,0,-1,-13,17,-1,-2,3,-2,0,0,-1,0,1,-1,2,-1
KR_6759091098,440,-1,-57,0,-8,-2,5,3,-1,3,2,-6,6,0,1,3,4,0,0,0,0,-4,259,-1,-2,3,-1,0,0,1,-1,0,1,4,-1
KR_6762708461,420,-6,-96,-12,-2,-3,4,1,0,0,0,1,0,1,0,2,2,0,2,2,0,5,-6,2,-6,4,4,0,-1,-1,-1,-1,-1,1,-1
KR_6709227020,420,-3,-30,-27,-5,-7,7,0,0,2,2,1,1,2,3,0,3,-2,2,0,0,-1,6,2,-9,7,-7,0,-1,-1,-1,-1,-1,5,-1
KR_6763024168,420,2,6,76,-2,0,1,1,0,1,1,1,1,2,-1,4,3,-2,4,2,0,-4,5,3,-5,2,-3,0,0,0,1,0,-1,0,-1
KR_6643624264,420,-2,-21,-8,1,1,0,1,-1,2,1,4,1,5,-3,4,1,0,0,0,0,4,-4,1,-2,1,-2,0,0,-1,1,0,-1,5,-1
KR_6756611614,420,3,-17,-8,6,1,0,1,1,2,3,1,2,3,1,0,1,2,0,2,0,9,40,-2,-3,5,4,0,0,0,-1,0,-1,0,-1
KR_6651474716,420,-2,-51,-3,-5,5,0,5,-3,3,0,-3,5,2,-3,3,0,-1,1,0,0,-1,-6,-5,0,5,3,0,-1,0,0,-1,1,0,-1
KR_6761997647,420,-3,-118,-12,-8,0,0,0,-2,4,2,-4,4,0,-3,3,0,1,0,1,0,-7,-13,-3,-1,4,2,0,-3,-1,-1,-1,-1,4,-1
KR_6699595757,420,-7,-87,-9,-12,-4,4,0,-2,5,3,-2,2,0,-3,4,1,-1,1,0,0,-5,-259,4,-6,2,-4,0,-1,-1,-1,-1,-1,6,-1
KR_6737264978,420,0,22,12,-4,3,0,3,-2,3,1,0,2,2,-2,5,3,-3,3,0,0,-13,-4,2,-6,4,1,0,0,-1,1,0,1,3,-1
KR_6756280795,420,-4,-34,22,-14,-1,2,1,-4,5,1,-5,7,2,-4,6,2,0,2,2,0,-11,12,-1,0,1,-29,0,0,-1,1,-1,-1,4,-1
KR_6750150438,440,2,7,0,6,-1,2,1,5,0,5,2,0,2,0,3,3,0,3,3,0,5,-11,-4,-1,5,3,0,0,0,-1,0,-1,0,-1
KR_6749880101,440,0,49,-12,-1,1,1,2,-8,9,1,-1,2,1,5,2,7,2,2,4,0,-7,29,1,-4,3,-34,0,1,-1,-1,1,-1,2,-1
KR_6646861482,420,-2,-15,-3,-4,-1,1,0,1,1,2,1,1,2,-4,4,0,-1,1,0,0,-5,-2,-2,-2,4,-1,0,-1,-1,-1,-1,-1,3,-1
KR_6728463718,420,-2,-38,12,-11,-3,3,0,0,1,1,-5,8,3,-3,4,1,0,1,1,-3,-16,-2,-5,-1,6,1,0,-2,-1,-1,-1,-1,4,-1
KR_6649370596,420,0,27,-4,3,2,1,3,-1,1,0,-7,9,2,4,0,4,5,0,5,0,9,-26,1,-4,3,3,0,1,1,0,1,-1,2,-1
KR_6659729318,420,0,76,-1,2,2,1,3,-2,5,3,1,2,3,1,3,4,0,2,2,0,0,38,4,-8,4,-13,0,0,1,1,1,1,1,-1
KR_6740107634,420,-1,-42,12,-1,-2,2,0,1,0,1,-2,4,2,2,0,2,0,3,3,0,8,9,-2,-1,3,-3,0,-2,-1,-1,-1,1,4,-1
KR_6762003689,420,1,-1,20,2,-2,3,1,-2,3,1,1,1,2,5,0,5,0,1,1,0,0,-17,-1,-2,3,4,0,0,1,0,0,-1,6,-1
KR_6745439151,420,0,-52,6,5,3,1,4,0,3,3,-2,4,2,2,1,3,2,2,4,0,2,-19,1,-3,2,18,0,0,1,-1,1,1,5,-1
KR_6744997429,420,-3,-48,-20,-6,1,2,3,-3,4,1,-2,5,3,-1,5,4,-1,2,1,0,-7,-213,4,-6,2,-29,0,0,-1,0,0,1,6,-1
KR_6739681444,420,-2,6,-12,-4,2,2,4,0,3,3,-3,5,2,-2,2,0,-1,3,2,0,-1,364,-2,0,2,-2,0,0,-1,-1,1,-1,3,-1
KR_6750944994,420,-3,24,-7,-8,2,3,5,-1,3,2,-4,6,2,-9,11,2,4,1,5,-1,-8,-4,2,-2,0,1,0,1,1,-1,-1,-1,1,-1
KR_6660108377,420,-3,-3,-20,-1,-1,2,1,6,2,8,2,3,5,-4,6,2,-4,4,0,0,-6,23,3,-5,2,-1,0,-1,-1,0,-1,-1,2,-1
KR_6736375336,420,-3,-28,24,-10,1,1,2,-2,2,0,-6,6,0,-2,5,3,-1,1,0,-1,-14,1,3,-5,2,-3,0,0,-1,-1,-1,-1,6,-1
KR_6683331070,440,-1,-131,4,-11,-4,4,0,-1,3,2,-2,2,0,-4,7,3,0,0,0,0,-10,2,2,-2,0,-2,0,-2,0,-1,-1,-1,0,-1
KR_6656553717,420,0,42,8,4,-1,1,0,5,1,6,0,0,0,0,2,2,0,1,1,0,4,-1,1,-2,1,3,0,0,-1,-1,0,1,1,-1
KR_6755094928,420,2,63,31,7,-1,2,1,-1,2,1,5,2,7,1,1,2,3,0,3,0,8,4,1,-3,2,2,0,1,0,0,1,1,0,-1
KR_6685417212,420,3,51,12,9,4,0,4,5,1,6,-2,9,7,3,1,4,-1,1,0,0,0,-7,3,-5,2,1,0,2,1,1,1,1,5,-1
KR_6764366785,440,-3,28,-7,-2,3,1,4,-3,3,0,0,2,2,-2,3,1,0,1,1,0,-4,18,-2,-1,3,1,0,0,0,-1,0,-1,0,-1
KR_6763005900,420,-4,-10,-12,-7,3,0,3,-2,2,0,-5,5,0,-3,4,1,0,0,0,0,-4,-1,4,-4,0,1,0,0,-1,1,1,-1,3,-1
KR_6712733271,420,-2,-52,-28,-3,-1,7,6,0,0,0,1,1,2,-1,3,2,-2,3,1,0,-16,-5,-6,-1,7,-2,0,-1,-1,1,1,1,1,-1
KR_6686360046,420,-3,-82,-2,-20,-4,6,2,-7,8,1,0,1,1,-5,8,3,-4,4,0,-1,-18,7,0,0,0,-2,0,-2,-1,-1,-1,-1,6,-1
KR_6726425465,420,2,19,16,-2,-2,3,1,2,1,3,-6,7,1,4,2,6,0,1,1,-1,-6,-6,-5,-4,9,0,0,0,-1,1,0,-1,3,-1
KR_6727624179,420,-1,-22,-20,-1,5,0,5,-2,2,0,-3,3,0,1,2,3,-2,3,1,0,2,26,1,-7,6,2,0,0,-1,-1,1,-1,4,-1
KR_6683230223,420,4,59,65,6,7,0,7,-1,1,0,0,1,1,0,2,2,0,0,0,1,-1,-4,-2,-3,5,0,0,0,1,-1,1,1,2,-1
KR_6689105212,420,-2,-99,4,-3,0,0,0,0,2,2,-3,3,0,-2,4,2,2,1,3,-1,-6,-6,-1,-2,3,0,0,0,1,1,0,-1,5,-1
KR_6755406009,420,-3,-68,-12,-15,-5,7,2,2,0,2,-5,6,1,-8,9,1,1,1,2,-2,-19,-1,1,-2,1,1,0,0,-1,0,-1,-1,3,-1
KR_6726664550,420,1,-30,-24,2,0,3,3,2,2,4,1,0,1,2,2,4,-3,4,1,0,2,-32,-10,-1,11,23,0,0,-1,1,0,1,2,-1
KR_6699675302,420,-5,29,20,-9,-2,4,2,-3,3,0,-3,5,2,-1,2,1,0,0,0,0,-9,0,2,-5,3,1,0,-1,1,-1,-1,-1,3,-1
KR_6728330460,420,-6,-27,-36,-8,2,0,2,-4,5,1,-4,5,1,-4,6,2,2,2,4,1,1,-3,-4,-3,7,1,0,-1,-1,-1,-1,1,4,-1
KR_6690926237,420,-6,-65,-12,-12,0,2,2,-2,6,4,-5,7,2,3,1,4,-8,8,0,0,-15,11,-1,-1,2,-1,0,-1,0,-1,-1,-1,0,-1
KR_6727292095,420,0,-74,8,-2,0,3,3,2,0,2,-2,4,2,-3,4,1,1,1,2,0,6,-1,0,-2,2,-2,0,0,1,-1,-1,-1,2,-1
KR_6751022076,440,-3,-43,4,-5,-9,10,1,1,1,2,1,4,5,2,1,3,0,2,2,-1,0,-4,4,-5,1,-1,0,-1,0,0,-1,-1,0,-1
KR_6684898224,420,0,-23,-12,-3,2,0,2,0,2,2,3,1,4,-5,5,0,-3,3,0,0,-2,-340,-1,-2,3,-1,0,-1,-1,0,-1,-1,1,-1
KR_6747162788,420,1,-58,8,-1,-2,2,0,0,3,3,0,2,2,2,3,5,-1,1,0,0,2,0,-1,-2,3,-1,0,-1,-1,-1,-1,-1,2,-1
KR_6733713755,420,1,53,20,3,7,0,7,-7,8,1,-3,4,1,4,1,5,2,0,2,0,1,-259,3,-7,4,1,0,1,1,-1,-1,1,2,-1
KR_6703161354,420,0,68,12,-10,0,1,1,-1,1,0,-2,2,0,-2,3,1,-5,5,0,0,-11,-11,-6,-2,8,0,0,0,-1,1,0,-1,1,-1
KR_6751885483,420,-3,-21,-4,-1,-4,5,1,0,2,2,0,4,4,1,0,1,2,0,2,1,6,-22,-8,0,8,2,0,-2,0,0,-1,1,0,-1
KR_6733175016,420,0,39,-32,-3,-4,4,0,3,0,3,-2,3,1,-1,1,0,1,0,1,0,3,1,-1,0,1,1,0,0,-1,-1,1,1,6,-1
KR_6753582812,420,-4,-14,6,-1,-2,3,1,1,4,5,0,3,3,-1,4,3,1,1,2,0,-1,-102,0,-4,4,-3,0,0,1,-1,0,1,3,-1
KR_6745402541,420,-1,20,10,0,-1,1,0,1,2,3,-1,3,2,0,1,1,1,0,1,0,4,128,-3,-3,6,-2,0,-1,-1,-1,-1,-1,1,-1
KR_6760317127,420,-1,35,11,-7,0,1,1,0,0,0,-2,4,2,-7,10,3,2,0,2,0,-6,-9,-2,-2,4,-3,0,0,-1,-1,-1,1,5,-1
KR_6663175016,420,-1,-66,8,-5,-3,3,0,0,3,3,-1,1,0,-1,2,1,0,1,1,0,-3,8,0,-7,7,-6,0,0,-1,-1,0,1,3,-1
KR_6723167402,420,-2,-49,-24,-9,-3,4,1,-5,6,1,-4,4,0,3,1,4,0,2,2,0,-9,-4,1,-2,1,0,0,0,-1,0,0,1,3,-1
KR_6740172278,440,-1,4,-22,5,-2,5,3,5,0,5,-2,4,2,0,2,2,4,0,4,0,13,0,1,-7,6,3,0,-1,1,-1,-1,1,4,-1
KR_6728006009,440,4,0,-1,4,4,1,5,2,1,3,-2,3,1,0,2,2,0,0,0,0,1,6,-1,-3,4,-1,0,1,-1,1,1,-1,5,-1
KR_6748719828,440,-2,-74,0,-6,0,2,2,0,2,2,1,1,2,-5,8,3,-2,2,0,0,-4,43,1,-2,1,-6,0,0,1,0,0,1,5,-1
KR_6723220837,420,-4,-139,-3,-7,-2,3,1,5,2,7,-7,8,1,2,0,2,-5,6,1,0,-1,1,-2,-1,3,2,0,-1,-1,0,-1,-1,6,-1
KR_6760753491,440,-1,-4,-7,-8,1,1,2,-3,4,1,-2,3,1,-5,5,0,1,4,5,0,-9,-14,-2,-2,4,3,0,0,0,1,0,-1,0,-1
KR_6723088692,420,0,-26,14,-2,0,0,0,-2,4,2,0,1,1,-2,7,5,2,0,2,0,-2,5,0,-4,4,-4,0,0,1,0,0,-1,5,-1
KR_6736913427,420,3,107,0,7,1,3,4,0,2,2,2,3,5,4,2,6,0,0,0,0,1,10,-2,-2,4,1,0,1,1,1,1,1,2,-1
KR_6740012433,420,0,-8,12,0,2,4,6,1,2,3,-2,3,1,-1,1,0,0,0,0,0,-3,225,1,-2,1,-3,0,-1,1,-1,-1,1,5,-1
KR_6758573600,420,-4,-25,-12,-10,-1,4,3,-2,2,0,0,3,3,-6,8,2,-1,1,0,-1,-8,9,2,-3,1,-1,0,1,1,0,-1,-1,3,-1
KR_6749878622,420,1,-61,19,-3,-1,2,1,-1,2,1,1,0,1,-3,4,1,1,0,1,0,3,-48,3,-4,1,11,0,-3,0,-1,-1,-1,0,-1
KR_6754436686,420,-3,-77,16,2,-2,5,3,3,1,4,3,1,4,-1,2,1,-1,1,0,0,1,0,4,-4,0,-3,0,-3,-1,-1,-1,-1,6,-1
KR_6763198103,440,-4,-65,12,-10,-3,4,1,-1,1,0,-1,4,3,-5,5,0,0,1,1,-1,-4,8,-4,0,4,-1,0,0,0,0,0,-1,0,-1
KR_6704533194,420,-1,-109,7,-3,-5,5,0,-1,2,1,3,0,3,0,1,1,0,0,0,0,2,117,2,-3,1,-1,0,0,1,-1,-1,-1,5,-1
KR_6763671277,420,-4,-86,-37,-6,-3,3,0,-2,2,0,-1,5,4,0,0,0,0,0,0,-1,-4,-1,-4,-3,7,-1,0,-1,-1,1,-1,-1,4,-1
KR_6749992542,420,3,-34,-1,1,4,1,5,-3,6,3,-3,4,1,2,3,5,1,0,1,0,-6,-12,-7,-2,9,4,0,0,1,0,1,-1,2,-1
KR_6733211837,420,-5,6,-40,-13,1,1,2,-6,6,0,-7,7,0,-1,1,0,0,0,0,0,-13,38,0,-1,1,-27,0,0,-1,1,1,-1,2,-1
KR_6759497759,440,-7,-94,-4,-12,-9,9,0,-2,5,3,0,1,1,1,5,6,-2,2,0,0,-7,-10,-3,0,3,1,0,-1,-1,-1,-1,-1,3,-1
KR_6742543553,420,-3,38,12,-3,-1,2,1,-6,7,1,2,1,3,0,2,2,2,0,2,0,-9,-6,-3,0,3,1,0,-1,1,1,-1,1,2,-1
KR_6754060039,420,0,36,-16,1,4,1,5,-7,8,1,0,2,2,3,1,4,1,0,1,0,-1,169,2,-5,3,-3,0,0,-1,0,1,1,4,-1
KR_6705685435,420,1,53,-15,-1,2,2,4,-1,1,0,-2,4,2,0,4,4,0,0,0,0,-7,-2,-2,-3,5,3,0,2,0,0,1,-1,0,-1
KR_6642062661,420,2,57,-12,5,6,1,7,1,2,3,0,2,2,-2,2,0,0,0,0,0,-3,-9,-5,-2,7,3,0,1,1,-1,1,1,3,-1
KR_6753712874,420,3,39,24,4,0,2,2,1,0,1,-1,1,0,1,1,2,3,1,4,0,5,4,3,-4,1,-5,0,0,0,0,0,1,0,-1
KR_6759120674,420,-4,-47,-44,-11,-2,3,1,-3,5,2,-1,5,4,1,1,2,-6,6,0,0,-14,46,-4,-3,7,-18,0,0,-1,1,0,-1,5,-1
KR_6727668373,420,-4,1,-52,0,1,3,4,-3,3,0,1,4,5,3,1,4,-2,3,1,0,-3,-2,0,-4,4,-1,0,0,-1,-1,0,1,6,-1
KR_6683920354,420,-4,-15,12,-8,-3,3,0,-3,3,0,0,1,1,0,2,2,-2,4,2,0,-8,-8,-1,-3,4,1,0,0,-1,-1,-1,-1,3,-1
KR_6649733368,440,-2,-4,-11,-3,-1,3,2,0,2,2,0,3,3,0,1,1,-2,2,0,0,-5,-5,0,-2,2,0,0,-1,1,-1,-1,1,1,-1
KR_6762695587,420,-8,-16,-9,-6,3,0,3,-5,6,1,-5,5,0,1,1,2,0,0,0,0,-7,17,-4,0,4,1,0,-1,0,-1,-1,-1,0,-1
KR_6751413175,440,-4,-9,-20,-17,1,1,2,-2,3,1,-6,7,1,-6,7,1,-4,6,2,0,-16,-8,-4,-2,6,2,0,-1,-1,0,-1,-1,2,-1
KR_6675241308,420,2,60,-4,-5,-1,3,2,-3,5,2,-4,4,0,3,0,3,0,2,2,0,-13,31,-1,-3,4,3,0,1,1,-1,1,-1,1,-1
KR_6760649531,420,1,55,-12,3,2,0,2,-1,3,2,5,0,5,-2,5,3,-1,1,0,0,2,28,3,-5,2,2,0,0,0,-1,1,1,0,-1
KR_6703954666,420,0,-12,20,0,0,1,1,6,0,6,2,0,2,-6,6,0,-2,4,2,0,1,-10,-3,0,3,1,0,-1,-1,0,-1,1,3,-1
KR_6740352984,420,-2,26,-8,-7,4,1,5,-1,2,1,-2,4,2,-6,6,0,-2,2,0,0,-12,-5,0,-4,4,1,0,-1,0,0,-1,1,0,-1
KR_6711776364,440,-2,-67,-16,-5,1,3,4,3,2,5,-2,2,0,-5,8,3,-2,2,0,0,11,6,1,-3,2,-2,0,-2,1,-1,-1,-1,6,-1
KR_6762514878,420,-1,-50,4,-4,0,0,0,-2,2,0,-5,5,0,3,2,5,0,1,1,0,0,32,3,-4,1,0,0,0,-1,-1,0,-1,1,-1
KR_6760475628,440,-3,48,4,-4,4,0,4,-1,2,1,-4,5,1,-4,8,4,1,1,2,0,-12,-186,-1,0,1,-1,0,-1,-1,-1,-1,-1,6,-1
KR_6743035343,420,-4,-77,-4,-7,-5,5,0,-1,6,5,-1,3,2,-2,3,1,2,2,4,0,-3,-269,3,-6,3,-5,0,-1,-1,0,-1,-1,5,-1
KR_6651598879,420,-4,-63,-32,-6,2,1,3,1,0,1,-7,8,1,-2,3,1,0,1,1,0,-4,7,-1,0,1,-3,0,-1,-1,1,-1,-1,4,-1
KR_6731193241,420,-2,-15,-12,-7,-1,4,3,-4,6,2,0,1,1,-2,2,0,0,1,1,0,-1,-230,1,-2,1,-1,0,-1,-1,-1,-1,-1,5,-1
KR_6740781923,420,-4,-143,8,-8,-3,3,0,0,0,0,-5,5,0,0,3,3,0,0,0,0,-6,-4,-4,-4,8,-1,0,-2,0,1,-1,-1,0,-1
KR_6758257009,420,-1,2,24,0,-1,3,2,-1,1,0,2,1,3,1,3,4,-1,2,1,0,4,-5,-1,-4,5,4,0,0,-1,1,1,1,3,-1
KR_6756886779,420,1,-50,44,-1,-2,3,1,4,2,6,1,2,3,-4,4,0,0,1,1,0,4,25,0,-4,4,-4,0,-1,-1,-1,-1,1,2,-1
KR_6743990390,420,-6,-94,4,-13,0,0,0,-6,7,1,-4,5,1,-1,2,1,-2,3,1,0,-11,-29,-2,-2,4,0,0,-1,1,1,1,-1,3,-1
KR_6728506374,420,-3,-14,-26,-7,1,2,3,-2,2,0,-2,4,2,-3,7,4,-1,1,0,-3,-13,0,0,-2,2,-3,0,-1,1,-1,-1,-1,3,-1
KR_6696141328,420,4,-97,96,3,3,2,5,2,1,3,-1,3,2,-3,7,4,2,2,4,-1,6,7,-3,0,3,-1,0,-1,1,1,1,-1,3,-1
KR_6715597650,420,1,26,-12,-3,0,4,4,0,1,1,0,1,1,-1,3,2,-2,5,3,-1,-5,-3,2,-2,0,0,0,2,0,0,1,-1,0,-1
KR_6764010436,420,-5,-78,16,-10,5,1,6,1,0,1,-7,7,0,-5,5,0,-4,4,0,0,-9,52,-2,0,2,-22,0,-3,-1,-1,-1,-1,3,-1
KR_6756656251,420,0,-61,30,-4,-2,2,0,3,0,3,2,0,2,-7,7,0,0,0,0,0,0,-12,-4,0,4,3,0,-1,-1,-1,-1,-1,1,-1
KR_6733465718,420,-2,-7,4,-8,-1,2,1,-3,6,3,1,0,1,-4,6,2,-1,2,1,0,-6,-119,0,-4,4,-5,0,0,-1,1,0,-1,3,-1
KR_6762535578,420,3,40,11,0,0,0,0,-1,1,0,-6,8,2,6,1,7,1,0,1,0,-2,-5,-3,-1,4,4,0,1,0,0,1,-1,0,-1
KR_6749835345,420,-1,-24,-15,-3,-4,5,1,-2,2,0,-2,2,0,5,0,5,0,2,2,1,4,297,2,-2,0,-3,0,-1,-1,-1,-1,1,3,-1
KR_6711493343,420,-3,-36,55,-14,1,2,3,-2,5,3,-2,3,1,-7,7,0,-4,5,1,-1,-15,326,-2,0,2,-1,0,-1,1,-1,-1,-1,3,-1
KR_6759270178,440,-6,-77,-4,-13,0,1,1,0,5,5,-3,4,1,-5,6,1,-5,6,1,0,-9,-36,2,-4,2,13,0,-1,-1,1,-1,-1,5,-1
KR_6747596257,420,1,-1,28,-3,1,2,3,-5,5,0,3,0,3,0,1,1,-2,3,1,0,-3,-126,0,-6,6,-2,0,0,0,0,0,1,0,-1
KR_6694075551,420,-1,2,4,-1,-1,1,0,1,5,6,4,0,4,1,2,3,-6,9,3,1,-7,256,2,-3,1,0,0,0,1,0,0,1,1,-1
KR_6759554080,420,1,-26,-2,-2,-10,10,0,4,3,7,0,3,3,2,2,4,2,0,2,0,8,-4,1,-4,3,0,0,0,-1,-1,-1,-1,5,-1
KR_6658248936,420,1,-43,24,2,0,0,0,1,7,8,3,1,4,0,0,0,-2,3,1,0,3,38,0,-3,3,-20,0,1,-1,1,1,1,1,-1
KR_6760514879,420,-3,-101,-59,-5,-5,7,2,0,4,4,-1,5,4,1,2,3,0,1,1,-1,6,2,1,-2,1,1,0,0,0,0,0,-1,0,-1
KR_6751547895,420,-4,-83,-17,-2,3,1,4,2,0,2,-1,3,2,-6,7,1,0,0,0,0,-6,-9,-1,-1,2,0,0,-2,1,-1,-1,-1,2,-1
KR_6743610223,420,-5,-23,-36,-19,-5,6,1,-1,3,2,-7,8,1,-7,7,0,1,0,1,0,-17,-4,-4,0,4,-2,0,-1,-1,-1,-1,-1,6,-1
KR_6763763006,420,-3,-21,-20,-6,-1,1,0,-1,2,1,1,1,2,-2,4,2,-3,4,1,0,-8,12,0,-3,3,-4,0,0,1,1,-1,1,2,-1
KR_6675212293,420,-1,-18,-8,-8,0,3,3,5,2,7,-7,8,1,-5,7,2,-1,2,1,-1,-6,25,3,-4,1,-2,0,-1,-1,-1,-1,-1,6,-1
KR_6731331761,420,-3,-22,24,-4,0,2,2,5,1,6,-2,2,0,-6,7,1,-1,1,0,0,-2,-163,0,-2,2,4,0,-1,-1,-1,-1,-1,4,-1
KR_6753622262,420,4,-17,16,7,0,2,2,-1,3,2,2,1,3,6,2,8,0,0,0,3,4,1,0,-5,5,-4,0,0,0,-1,0,1,0,-1
KR_6691483153,420,0,44,-27,-2,3,0,3,-3,4,1,2,1,3,1,1,2,-5,7,2,0,-1,-10,-3,-3,6,1,0,0,-1,0,0,1,4,-1
KR_6740086060,440,1,-72,-12,6,5,2,7,7,1,8,-3,3,0,-5,7,2,2,1,3,0,5,-50,-3,-5,8,23,0,1,-1,1,1,-1,1,-1
KR_6760984007,420,-1,8,-36,0,3,1,4,-1,2,1,-2,4,2,1,1,2,-1,1,0,0,-6,207,-3,-3,6,0,0,0,1,1,-1,1,5,-1
KR_6744976596,420,0,-87,-20,-1,-3,3,0,4,1,5,-2,3,1,1,0,1,-1,1,0,1,3,136,1,-4,3,0,0,0,1,1,0,1,5,-1
KR_6700071367,420,-3,-14,-25,-10,-5,6,1,-2,2,0,0,1,1,0,2,2,-3,3,0,0,-12,-255,0,-2,2,16,0,-1,-1,-1,-1,-1,3,-1
KR_6756947907,420,-1,-62,4,0,-1,1,0,0,3,3,3,0,3,-3,8,5,1,2,3,0,0,8,7,-9,2,-6,0,0,0,1,0,1,0,-1
KR_6753712691,420,-2,-35,-18,-3,-3,3,0,-4,5,1,-5,5,0,7,2,9,2,1,3,1,6,-11,-5,-6,11,3,0,-1,0,-1,-1,1,0,-1
KR_6704302155,420,-3,-25,4,-7,-2,2,0,-5,7,2,4,0,4,-3,5,2,-1,2,1,-1,-5,9,-1,0,1,-1,0,-1,1,0,-1,-1,4,-1
KR_6689477652,420,2,29,17,1,-4,5,1,1,3,4,5,1,6,-3,6,3,2,0,2,0,5,5,-4,-1,5,0,0,0,-1,-1,0,-1,5,-1
KR_6729790768,420,-5,-122,0,-7,-1,3,2,-4,6,2,1,2,3,-5,7,2,2,1,3,0,-8,6,-6,0,6,1,0,0,1,-1,-1,-1,5,-1
KR_6647999491,420,-3,-1,-28,-9,2,1,3,-5,5,0,-2,3,1,-2,4,2,-2,2,0,0,-13,-1,1,-2,1,-1,0,0,-1,-1,0,1,1,-1
KR_6750749081,420,-2,41,12,-4,-3,4,1,-3,5,2,1,2,3,1,4,5,0,1,1,1,-1,-5,-2,-1,3,-5,0,1,1,-1,1,1,3,-1
KR_6759303711,420,-2,-23,-3,-7,-8,8,0,3,1,4,-1,3,2,2,1,3,-3,3,0,0,-4,-6,-2,-2,4,1,0,-1,1,1,-1,-1,5,-1
KR_6625841345,440,-1,-48,20,-4,0,1,1,-1,3,2,0,3,3,-2,2,0,-1,2,1,-1,-3,9,1,-1,0,0,0,0,1,0,0,-1,4,-1
KR_6680195745,420,-1,-7,-16,-5,-1,4,3,-5,6,1,0,4,4,0,1,1,1,0,1,0,-15,3,-1,-3,4,-3,0,-1,1,-1,-1,1,5,-1
KR_6732362596,420,0,-18,24,-4,0,3,3,-2,3,1,4,0,4,-7,8,1,1,0,1,0,-2,6,3,-6,3,3,0,0,-1,1,-1,-1,4,-1
KR_6755383970,420,0,-87,47,2,-2,2,0,6,1,7,0,4,4,-4,6,2,2,0,2,0,2,11,-2,-2,4,-3,0,-1,1,-1,-1,-1,3,-1
KR_6699659264,420,2,20,8,-1,-4,4,0,-4,4,0,7,0,7,1,0,1,-1,1,0,0,-2,0,-1,-3,4,-2,0,0,1,-1,-1,1,5,-1
KR_6636070461,420,-2,-52,-5,-2,0,2,2,0,1,1,-4,7,3,3,3,6,-1,1,0,0,-3,-3,4,-5,1,-4,0,-1,-1,0,-1,1,5,-1
KR_6755618684,420,-2,4,28,-6,-4,5,1,-2,3,1,3,0,3,0,2,2,-3,3,0,0,-3,-349,0,-2,2,1,0,0,-1,1,0,-1,3,-1
KR_6700147324,420,1,-27,43,6,5,0,5,0,4,4,1,1,2,-2,3,1,2,1,3,0,-1,3,6,-7,1,0,0,-1,-1,1,-1,1,6,-1
KR_6732473855,420,-1,-8,8,-7,-1,3,2,4,0,4,-7,8,1,0,1,1,-3,3,0,0,-4,-16,-2,-5,7,-6,0,0,-1,1,0,-1,1,-1
KR_6749722062,420,-5,-76,-20,-10,-2,2,0,1,0,1,-2,3,1,-8,10,2,1,1,2,0,-2,19,1,-5,4,1,0,-2,-1,-1,-1,-1,6,-1
KR_6763827342,420,-5,-108,-36,-4,2,1,3,-4,4,0,-1,1,0,-1,1,0,0,1,1,0,0,-219,-3,0,3,-2,0,-1,0,-1,-1,-1,0,-1
KR_6635076873,420,-1,-8,28,2,0,0,0,-4,4,0,-1,4,3,6,4,10,1,0,1,0,-2,12,-4,-3,7,0,0,0,-1,-1,1,-1,2,-1
KR_6754332691,420,-2,-39,-61,1,-1,1,0,3,2,5,-1,2,1,0,1,1,0,1,1,0,3,-128,-6,-2,8,-4,0,-1,-1,-1,-1,-1,4,-1
KR_6723086533,420,-3,-35,1,-6,-1,3,2,-1,1,0,-3,6,3,1,4,5,-2,3,1,0,-1,-11,-2,-1,3,2,0,0,-1,0,-1,-1,5,-1
KR_6756459021,420,-3,29,12,-11,-1,1,0,-1,2,1,-3,4,1,-6,7,1,0,2,2,0,-8,-1,-1,-2,3,4,0,1,1,1,1,-1,3,-1
KR_6753747328,420,-3,6,32,-10,0,2,2,-2,3,1,-1,2,1,-8,10,2,1,1,2,0,-15,140,-2,-2,4,-1,0,1,1,-1,-1,-1,4,-1
KR_6746388831,420,-1,-10,-24,0,1,1,2,2,2,4,1,1,2,-4,8,4,0,0,0,0,0,-240,1,-3,2,1,0,0,-1,-1,0,1,3,-1
KR_6725977379,420,-5,-106,0,-5,-7,7,0,-1,3,2,0,2,2,3,3,6,0,2,2,0,-3,4,-3,0,3,-2,0,-1,1,-1,-1,1,3,-1
KR_6691462408,420,-6,-81,-12,-16,-7,7,0,-1,3,2,-4,5,1,0,0,0,-4,4,0,0,-4,4,0,-1,1,-1,0,-2,-1,-1,-1,-1,1,-1
KR_6697016847,420,0,-1,-16,-8,1,0,1,-4,5,1,1,1,2,-4,5,1,-2,4,2,0,-3,10,-1,-1,2,0,0,-1,-1,-1,-1,-1,3,-1
KR_6751335845,420,0,27,-23,-1,-1,2,1,-1,2,1,4,2,6,-3,3,0,0,3,3,0,-4,453,-1,0,1,1,0,1,1,1,1,-1,5,-1
KR_6762119767,420,-2,-62,15,-5,-2,3,1,2,1,3,-1,2,1,-4,6,2,0,1,1,0,-4,-7,-3,-2,5,3,0,-1,-1,0,-1,-1,6,-1
KR_6657006762,420,-7,-49,5,-8,-2,3,1,-1,2,1,1,0,1,-4,6,2,-2,2,0,0,-6,167,-4,0,4,-1,0,-2,-1,-1,-1,1,5,-1
KR_6621240340,420,-2,97,-100,0,8,0,8,0,2,2,-1,2,1,-7,7,0,0,0,0,0,-9,2,-1,0,1,-5,0,0,-1,0,-1,-1,6,-1
KR_6730571130,420,-2,-39,-20,3,1,3,4,-1,3,2,-1,3,2,3,1,4,1,0,1,1,5,30,-4,-1,5,3,0,-1,-1,0,-1,1,5,-1
KR_6688466880,420,0,-3,56,-9,-2,2,0,3,0,3,-4,5,1,-2,4,2,-4,4,0,-1,-14,20,1,-3,2,-2,0,0,-1,1,0,-1,5,-1
KR_6748044016,420,-5,-98,-32,-7,0,0,0,-5,5,0,0,2,2,-2,3,1,0,0,0,0,-9,8,2,-5,3,-3,0,-1,-1,0,-1,1,6,-1
KR_6703036298,420,-4,-68,-4,-16,-3,5,2,-1,2,1,-4,4,0,-6,10,4,-2,4,2,0,-10,-24,-6,0,6,-1,0,-2,-1,-1,-1,-1,6,-1
KR_6717249337,420,-3,-16,-36,-6,-7,7,0,-2,3,1,1,2,3,3,0,3,-1,1,0,0,0,14,-1,0,1,0,0,-1,-1,-1,-1,-1,5,-1
KR_6753178028,420,1,-24,-8,3,-5,6,1,5,0,5,3,0,3,2,1,3,-2,2,0,0,8,-9,-3,-5,8,-9,0,-1,1,-1,-1,-1,3,-1
KR_6764240855,420,-4,-32,-10,0,0,2,2,-2,2,0,-1,4,3,2,1,3,1,0,1,0,2,-219,4,-5,1,-4,0,-2,-1,-1,-1,1,1,-1
KR_6761616281,440,1,-66,-14,3,-2,4,2,1,2,3,5,3,8,-1,7,6,0,1,1,0,7,4,-1,-2,3,1,0,-1,-1,0,-1,1,6,-1
KR_6757454014,420,-4,-64,-36,-3,2,0,2,0,0,0,-1,4,3,-3,4,1,-1,1,0,0,2,22,5,-5,0,-2,0,-1,-1,-1,-1,-1,5,-1
KR_6745355347,420,-2,-16,-25,-5,-1,1,0,-1,2,1,1,0,1,0,2,2,-4,4,0,0,-3,-30,-5,-2,7,13,0,0,1,1,0,1,1,-1
KR_6690321314,420,0,49,28,-7,3,0,3,-1,2,1,-2,4,2,-7,8,1,0,3,3,0,-12,14,-1,-3,4,-1,0,0,1,-1,0,-1,5,-1
KR_6729427454,420,-4,-8,-11,-4,1,2,3,-2,3,1,-4,7,3,-1,2,1,2,0,2,1,3,-8,-5,0,5,-2,0,1,-1,1,1,1,3,-1
KR_6760335757,420,-3,-60,1,-16,-6,6,0,3,2,5,-1,2,1,-8,8,0,-4,4,0,-1,-14,31,1,-2,1,-12,0,-2,-1,-1,-1,-1,5,-1
KR_6729219795,420,-6,-49,-30,-18,-1,2,1,-3,4,1,-3,3,0,-7,10,3,-4,7,3,-2,-13,4,0,-1,1,0,0,-1,-1,-1,-1,-1,1,-1
KR_6750211634,420,-3,-81,-33,-6,0,2,2,-2,3,1,-3,6,3,-2,4,2,1,0,1,0,-8,-26,-1,-1,2,1,0,-1,-1,-1,-1,1,5,-1
KR_6761935565,440,-1,-74,-3,3,-4,4,0,-2,2,0,7,1,8,-1,2,1,3,0,3,0,-1,-32,0,-4,4,38,0,-1,0,0,-1,1,0,-1
KR_6726042564,420,-4,-44,-1,-15,0,4,4,-4,4,0,-5,6,1,-4,5,1,-2,2,0,0,-14,4,-1,-2,3,0,0,-3,-1,-1,-1,-1,1,-1
KR_6638350356,420,-5,-22,-12,-6,-1,2,1,0,3,3,0,1,1,0,4,4,-5,6,1,0,-8,-54,1,-4,3,-2,0,0,-1,-1,0,-1,2,-1
KR_6759595599,420,2,-11,-7,3,2,0,2,3,1,4,2,2,4,-1,9,8,-3,3,0,0,5,-4,-2,-1,3,2,0,1,1,-1,1,-1,3,-1
KR_6738266274,420,-1,5,-20,1,2,0,2,0,3,3,1,1,2,-2,2,0,0,0,0,1,6,-6,3,-4,1,0,0,1,1,1,1,1,5,-1
KR_6759685114,420,1,46,-8,1,-2,4,2,-1,3,2,0,0,0,0,2,2,4,0,4,0,0,1,-2,-2,4,0,0,-1,1,-1,-1,1,2,-1
KR_6743085556,420,-3,-158,47,-13,-2,2,0,-2,3,1,-3,3,0,-6,6,0,0,1,1,0,-14,-3,-1,-1,2,-1,0,-1,1,1,-1,1,6,-1
KR_6698074275,420,1,27,12,0,-1,2,1,2,0,2,2,1,3,-2,3,1,-1,1,0,0,-1,-129,-2,-2,4,2,0,0,1,-1,-1,1,1,-1
KR_6761130179,420,-2,-20,21,2,-2,2,0,1,1,2,2,2,4,1,2,3,0,1,1,0,1,-10,-2,0,2,1,0,0,0,0,-1,1,0,-1
KR_6757338710,440,0,-56,12,-2,-1,4,3,0,3,3,-2,4,2,2,1,3,-1,1,0,-1,4,-4,-5,-5,10,1,0,0,0,1,1,-1,0,-1
KR_6762127701,420,-1,7,-30,-4,1,0,1,-2,3,1,3,1,4,-2,4,2,-4,5,1,0,-9,-2,-2,-1,3,1,0,0,0,-1,0,-1,0,-1
KR_6737932776,420,-2,-79,-8,-3,1,0,1,-3,7,4,-1,2,1,-1,1,0,1,0,1,2,-2,-14,-5,0,5,-1,0,-1,-1,0,-1,1,2,-1
KR_6750846617,420,-2,-44,-12,-7,1,1,2,-5,5,0,-4,4,0,1,1,2,0,0,0,0,-2,15,-3,-2,5,0,0,-1,-1,-1,-1,-1,6,-1
KR_6695792300,440,-1,-1,-8,-2,-1,2,1,1,1,2,-2,2,0,-1,4,3,1,1,2,1,1,-7,-2,-3,5,-2,0,-1,-1,-1,-1,1,5,-1
KR_6626597509,420,-6,-96,0,-15,-1,3,2,-4,4,0,1,5,6,-3,3,0,-8,8,0,-1,-14,-5,0,-2,2,-3,0,-2,-1,-1,-1,-1,5,-1
KR_6661972820,420,-3,5,3,3,-1,1,0,5,1,6,3,1,4,-3,8,5,-1,1,0,1,7,36,2,-4,2,-33,0,-1,1,-1,-1,1,1,-1
KR_6685253894,420,-6,57,-26,-12,0,1,1,-2,3,1,-6,7,1,-3,3,0,-1,1,0,-1,-11,20,-3,0,3,0,0,2,-1,1,1,-1,4,-1
KR_6730097874,420,-1,-65,34,-3,2,0,2,2,1,3,-2,2,0,-4,4,0,-1,4,3,-1,-2,-55,-2,0,2,22,0,-1,1,-1,-1,-1,6,-1
KR_6647111120,420,0,14,-2,-9,1,2,3,-2,4,2,-3,4,1,-7,7,0,2,0,2,0,-18,292,-5,0,5,4,0,1,-1,1,1,1,6,-1
KR_6715332542,420,-4,-11,-3,-8,-6,6,0,-3,5,2,0,3,3,2,3,5,-1,1,0,0,1,-7,-1,-1,2,-1,0,0,1,1,-1,-1,3,-1
KR_6759637047,420,1,-17,0,2,-5,5,0,1,1,2,-2,2,0,4,0,4,4,0,4,0,10,15,-2,-5,7,-2,0,-1,1,0,1,1,6,-1
KR_6753604112,420,0,18,-28,-2,-3,5,2,1,1,2,-4,5,1,3,1,4,1,0,1,0,2,-373,0,-2,2,1,0,-1,-1,-1,-1,1,1,-1
KR_6734119646,420,1,-73,28,11,0,1,1,8,0,8,2,3,5,0,1,1,1,1,2,0,7,120,5,-6,1,-1,0,0,-1,1,1,1,1,-1
KR_6761168758,420,-6,-96,0,-14,-6,6,0,-6,6,0,-1,2,1,0,3,3,-1,2,1,0,-12,0,3,-3,0,-2,0,-2,-1,1,-1,-1,5,-1
KR_6698034749,420,-7,-103,-132,-8,-4,6,2,-1,1,0,0,2,2,-3,3,0,0,1,1,0,-2,-22,0,-1,1,3,0,-4,-1,-1,-1,-1,4,-1
KR_6726622435,420,-9,-162,-16,-12,-3,3,0,-5,5,0,-3,5,2,0,0,0,-1,1,0,0,-4,-115,2,-3,1,-6,0,-1,1,1,-1,-1,6,-1
KR_6734753265,420,-3,-73,8,-7,1,0,1,0,3,3,-5,6,1,-2,3,1,-1,2,1,-1,-9,-246,-2,-1,3,-3,0,-1,-1,1,-1,-1,3,-1
KR_6736332941,420,2,44,-35,3,-1,1,0,2,4,6,5,4,9,-2,5,3,-1,1,0,0,-2,1,1,-3,2,-1,0,1,1,0,1,1,5,-1
KR_6745358198,420,-3,-13,28,-13,1,1,2,-6,6,0,-3,5,2,-1,1,0,-4,4,0,0,-20,7,-3,-2,5,-3,0,0,-1,-1,-1,-1,3,-1
KR_6727859903,420,1,38,10,9,4,1,5,1,3,4,-2,6,4,1,2,3,5,2,7,0,4,-4,3,-6,3,0,0,0,1,1,1,-1,3,-1
KR_6702667897,440,-2,-24,8,-3,-4,7,3,-4,6,2,2,0,2,4,2,6,-1,1,0,0,-3,-22,0,-2,2,0,0,0,1,-1,1,1,5,-1
KR_6757588687,420,-1,-21,0,-3,0,2,2,-2,6,4,3,0,3,-6,10,4,2,0,2,0,-6,-339,4,-5,1,-1,0,-1,-1,1,-1,-1,3,-1
KR_6738827977,420,-2,-59,-4,-5,1,2,3,-1,3,2,-4,4,0,-1,3,2,0,0,0,0,-5,22,-1,-1,2,2,0,-2,0,-1,-1,1,0,-1
KR_6729548628,420,-7,-91,-17,-9,0,3,3,-3,3,0,-3,4,1,-3,3,0,0,0,0,0,-14,5,0,-3,3,-2,0,-1,-1,0,1,-1,3,-1
KR_6697650994,420,-3,46,-68,-6,0,2,2,1,3,4,-2,2,0,-2,2,0,-3,5,2,0,-6,3,0,0,0,-5,0,-1,-1,-1,-1,-1,1,-1
KR_6724950973,440,-5,-52,-28,-11,-7,7,0,-2,3,1,-1,6,5,0,2,2,-1,2,1,-1,3,0,1,-5,4,-3,0,0,0,0,-1,-1,0,-1
KR_6760176748,420,1,-10,4,4,-2,2,0,-1,2,1,6,0,6,0,4,4,1,2,3,1,11,289,1,-1,0,-2,0,2,-1,0,1,1,6,-1
KR_6728278791,420,-3,13,-20,-5,-1,6,5,3,4,7,-5,6,1,0,2,2,-2,2,0,-2,0,3,-1,-1,2,0,0,2,-1,1,1,-1,6,-1
KR_6722446407,420,-1,-2,11,-7,1,1,2,0,2,2,-2,3,1,-7,8,1,1,3,4,0,-10,1,-2,-1,3,-3,0,0,-1,1,1,-1,3,-1
KR_6657997351,420,0,-42,-32,0,3,0,3,3,0,3,-3,3,0,-3,4,1,0,2,2,0,1,117,-3,-4,7,-4,0,1,-1,0,1,-1,6,-1
KR_6744430061,420,-6,-6,-39,-2,1,3,4,1,1,2,-2,2,0,0,0,0,-2,2,0,0,-3,0,2,-4,2,-1,0,0,0,-1,-1,-1,0,-1
KR_6764047446,420,0,68,-6,-5,2,1,3,-1,3,2,-3,7,4,-2,3,1,-1,1,0,0,-14,-29,0,-6,6,25,0,1,-1,1,1,-1,4,-1
KR_6760448987,420,0,-18,26,-4,-4,5,1,-2,2,0,-1,2,1,1,1,2,2,0,2,0,-2,1,-3,-3,6,1,0,-1,-1,-1,-1,1,6,-1
KR_6745023136,440,1,110,-23,5,0,1,1,-1,2,1,4,1,5,2,0,2,0,2,2,1,-1,-28,0,-2,2,-3,0,0,1,-1,1,1,3,-1
KR_6754196890,420,-3,-59,-12,0,-2,2,0,1,1,2,2,2,4,0,3,3,-1,2,1,1,6,-5,-1,0,1,0,0,-1,-1,1,-1,1,3,-1
KR_6727342151,420,-4,-78,-4,-6,-4,4,0,3,1,4,2,1,3,-4,4,0,-3,4,1,0,-1,3,3,-4,1,-4,0,-2,-1,1,-1,1,3,-1
KR_6761082645,420,5,81,-2,7,7,1,8,-2,6,4,5,1,6,-5,6,1,2,1,3,2,5,12,4,-5,1,-1,0,0,0,0,1,1,0,-1
KR_6746423597,420,-3,-39,4,-4,3,0,3,3,0,3,-1,2,1,-5,6,1,-4,5,1,0,-13,-35,-3,-1,4,21,0,-2,1,-1,-1,1,5,-1
KR_6748679470,420,-1,-63,-15,-10,4,1,5,-6,6,0,-8,9,1,-1,5,4,1,0,1,-1,0,-395,4,-5,1,-2,0,-2,-1,-1,-1,-1,1,-1
KR_6685897318,420,2,-66,84,5,1,3,4,3,0,3,0,3,3,3,1,4,-2,2,0,0,5,9,1,-1,0,0,0,0,0,1,1,-1,0,-1
KR_6728586317,440,-1,-79,-11,-7,1,1,2,-3,5,2,-1,1,0,1,1,2,-5,5,0,0,-7,-26,-2,0,2,0,0,0,1,0,0,-1,6,-1
KR_6731251904,420,-8,-101,16,-20,0,1,1,-1,3,2,-9,10,1,-10,11,1,0,0,0,-1,-18,-7,-2,-1,3,-4,0,-5,1,-1,-1,-1,5,-1
KR_6721980223,420,2,-8,19,2,0,0,0,5,3,8,-5,8,3,2,1,3,0,0,0,1,5,-3,4,-5,1,2,0,0,1,0,0,1,3,-1
KR_6752554484,420,2,110,32,6,0,3,3,2,3,5,2,2,4,3,0,3,-1,2,1,1,9,3,-1,-4,5,-1,0,2,1,-1,1,1,5,-1
KR_6649032656,420,2,5,-5,-1,-1,3,2,0,2,2,-5,6,1,1,2,3,4,0,4,0,2,153,-3,-6,9,0,0,1,1,-1,1,1,5,-1
KR_6649702867,420,-3,-82,-20,-11,-3,5,2,-2,2,0,2,1,3,-9,9,0,1,0,1,-1,-8,2,3,-4,1,1,0,0,1,-1,0,-1,6,-1
KR_6746670213,440,-8,-104,-22,-20,-1,2,1,-4,7,3,-5,7,2,-8,8,0,-2,3,1,0,-21,1,-2,-1,3,-3,0,-3,1,-1,-1,1,2,-1
KR_6729362427,420,-1,-76,-4,-3,-2,2,0,-4,4,0,2,0,2,0,1,1,1,0,1,0,-6,168,2,-5,3,-3,0,0,0,0,0,1,0,-1
KR_6630304468,420,-2,-16,16,-4,5,0,5,-3,6,3,-2,5,3,-3,3,0,-1,2,1,0,-13,-5,-3,-1,4,1,0,-2,-1,1,-1,1,4,-1
KR_6750092867,420,0,16,15,-8,-2,6,4,-2,3,1,0,5,5,-2,2,0,-2,2,0,-1,-12,-1,-2,-1,3,-4,0,0,1,-1,0,-1,6,-1
KR_6733644143,440,2,2,-25,-5,3,2,5,1,0,1,-2,5,3,-4,5,1,-3,6,3,-1,-13,1,-2,0,2,1,0,-1,0,1,-1,-1,0,-1
KR_6760065178,420,-3,-67,-18,-9,1,2,3,-6,7,1,3,0,3,-8,9,1,1,4,5,0,-12,5,-2,0,2,-1,0,-2,0,-1,-1,-1,0,-1
KR_6764437011,420,0,-29,-20,3,1,2,3,1,1,2,-4,4,0,2,1,3,3,0,3,1,9,-7,2,-5,3,1,0,-1,1,1,-1,1,2,-1
KR_6728540232,420,-3,3,6,-5,-3,3,0,-1,1,0,-1,2,1,0,1,1,0,0,0,0,-3,-41,-4,0,4,23,0,1,-1,1,1,1,6,-1
KR_6749246070,420,0,-82,-16,4,0,2,2,0,2,2,-4,5,1,4,4,8,4,0,4,0,6,-3,2,-3,1,-1,0,1,-1,-1,-1,1,5,-1
KR_6732344477,420,2,12,19,0,5,0,5,-3,4,1,-3,4,1,-1,1,0,2,2,4,0,-10,4,2,-6,4,0,0,1,1,-1,1,-1,6,-1
KR_6737653712,420,-1,48,-40,1,2,0,2,-2,4,2,-2,3,1,5,4,9,-2,2,0,0,0,4,0,-2,2,-2,0,0,-1,0,0,1,3,-1
KR_6733472928,420,-3,-27,4,-3,-2,2,0,2,1,3,-1,6,5,0,0,0,-2,3,1,0,-1,9,0,-4,4,-4,0,-1,-1,0,-1,1,2,-1
KR_6694084733,420,-3,-16,-8,-1,-2,2,0,0,1,1,2,2,4,4,3,7,-5,6,1,0,0,12,1,-1,0,0,0,0,1,0,0,1,6,-1
KR_6712266122,420,2,-39,50,7,1,0,1,0,1,1,5,0,5,0,1,1,1,1,2,0,2,-6,-2,0,2,-1,0,0,0,0,0,1,0,-1
KR_6730169943,420,-3,-94,5,3,0,3,3,0,1,1,1,1,2,-2,3,1,4,1,5,1,4,6,2,-5,3,-5,0,-1,1,0,-1,1,5,-1
KR_6676826609,420,2,21,4,-1,0,0,0,3,2,5,-2,2,0,-4,4,0,2,1,3,0,-3,1,-1,-2,3,0,0,1,-1,1,1,1,1,-1
KR_6733620845,440,-1,43,-40,-4,1,0,1,-7,7,0,1,1,2,1,0,1,0,1,1,1,-2,-8,1,-5,4,3,0,0,-1,0,0,1,6,-1
KR_6691802794,420,-4,-30,20,-9,-1,2,1,0,3,3,-5,6,1,-2,2,0,-1,1,0,0,-7,-5,0,-1,1,-1,0,-2,-1,0,-1,-1,1,-1
KR_6668445763,420,1,63,12,-3,5,1,6,-1,3,2,-4,5,1,-1,2,1,-2,2,0,-1,-5,-2,0,-1,1,0,0,1,-1,-1,1,-1,4,-1
KR_6687999702,420,-6,-97,24,-14,0,0,0,-2,2,0,-3,3,0,-9,10,1,0,0,0,0,-9,-6,-2,-1,3,-1,0,-3,0,-1,-1,-1,0,-1
KR_6728534752,420,-2,-24,8,-2,-3,4,1,-2,2,0,1,2,3,2,1,3,0,0,0,0,1,-254,-1,-5,6,-2,0,0,0,0,-1,1,0,-1
KR_6748705227,420,-1,-5,-11,-1,-1,2,1,0,3,3,-1,3,2,0,2,2,1,0,1,0,3,30,-2,-3,5,-3,0,-1,1,-1,-1,1,1,-1
KR_6710211336,420,-1,2,-8,-1,0,1,1,-2,3,1,-1,2,1,2,3,5,0,1,1,0,1,14,-2,-3,5,4,0,-1,1,-1,-1,-1,6,-1
KR_6654983942,420,-5,-104,-56,1,-1,2,1,1,0,1,2,1,3,-1,3,2,0,1,1,0,3,5,5,-6,1,0,0,0,0,0,0,1,0,-1
KR_6735221903,420,-3,-46,8,-3,-1,2,1,0,1,1,7,1,8,-8,8,0,-1,2,1,0,-8,15,-3,-2,5,0,0,-1,1,0,1,1,5,-1
KR_6758544392,420,-2,-57,17,-9,-3,5,2,-4,5,1,1,1,2,-3,3,0,0,0,0,0,-13,312,-4,0,4,2,0,-1,-1,-1,-1,1,5,-1
KR_6723597778,420,-3,21,-53,-2,-3,3,0,4,2,6,-2,5,3,1,3,4,-2,3,1,0,-5,-6,-1,-1,2,-1,0,-1,-1,-1,-1,1,1,-1
KR_6538331749,440,-5,-82,-20,-11,0,0,0,-8,9,1,-5,5,0,0,2,2,2,1,3,0,-9,-2,-5,-2,7,0,0,0,-1,-1,0,-1,6,-1
KR_6742001100,420,2,49,0,2,2,1,3,-1,2,1,2,0,2,-4,5,1,3,0,3,0,0,-203,1,-6,5,1,0,0,-1,0,0,-1,6,-1
KR_6764293273,420,-1,-26,-12,3,-3,4,1,-2,2,0,3,1,4,3,5,8,2,1,3,-1,-3,7,1,-3,2,-1,0,0,0,0,-1,-1,0,-1
KR_6756260216,420,-1,62,-52,4,-4,6,2,1,2,3,2,1,3,1,4,5,4,0,4,0,9,-8,0,-3,3,3,0,0,-1,1,0,-1,6,-1
KR_6727906840,420,-5,-121,-20,-8,-4,5,1,0,1,1,0,2,2,-3,6,3,-1,1,0,0,2,-3,-1,0,1,-1,0,-3,-1,1,-1,-1,4,-1
KR_6750675272,420,0,6,3,-1,3,1,4,-2,2,0,-1,3,2,-1,2,1,0,0,0,0,-2,-16,0,-2,2,3,0,-1,0,-1,-1,-1,0,-1
KR_6763373274,420,-3,-76,4,2,-3,5,2,2,0,2,-1,2,1,5,2,7,-1,1,0,0,2,5,3,-4,1,2,0,-1,-1,0,-1,1,4,-1
KR_6731841714,420,-1,3,-22,0,-3,3,0,-3,3,0,0,1,1,4,0,4,2,1,3,0,3,2,2,-4,2,-1,0,0,1,-1,0,-1,4,-1
KR_6718990015,420,3,58,26,3,1,1,2,1,2,3,2,4,6,-3,4,1,2,2,4,0,-5,3,-1,0,1,0,0,0,1,0,0,-1,1,-1
KR_6749402321,420,-7,-7,-14,-10,-3,4,1,0,4,4,-2,3,1,0,3,3,-5,6,1,0,-9,-1,4,-5,1,-1,0,-1,1,1,-1,1,5,-1
KR_6724849328,420,1,61,4,-2,0,1,1,2,0,2,-4,4,0,0,1,1,0,0,0,0,-2,-105,3,-4,1,1,0,0,1,-1,-1,-1,2,-1
KR_6763242829,440,-4,-58,-9,-4,0,3,3,-1,1,0,2,2,4,-4,4,0,-1,1,0,0,-3,2,1,-1,0,0,0,0,-1,0,0,-1,1,-1
KR_6742199523,420,-1,60,-21,-4,1,1,2,1,2,3,-5,8,3,-1,1,0,0,1,1,0,-5,10,-1,-1,2,-5,0,-1,1,-1,-1,1,3,-1
KR_6745935082,440,-1,-9,-36,-2,-1,2,1,-1,2,1,-4,6,2,1,1,2,3,1,4,0,1,12,1,-1,0,2,0,0,-1,-1,0,1,3,-1
KR_6763741520,420,1,-22,-1,4,1,0,1,-2,2,0,3,2,5,0,2,2,2,2,4,0,5,197,3,-4,1,-2,0,-1,0,0,-1,-1,0,-1
KR_6663317636,420,-8,-95,-45,-18,-3,3,0,-2,2,0,1,0,1,-10,11,1,-4,4,0,0,-15,98,3,-3,0,1,0,-2,-1,-1,-1,-1,4,-1
KR_6749680624,420,-4,55,-11,-12,-2,2,0,-4,5,1,3,0,3,-2,2,0,-7,7,0,-1,-20,36,-4,-1,5,-29,0,0,-1,1,1,-1,2,-1
KR_6760055298,420,-3,5,24,-12,0,1,1,-6,7,1,-2,3,1,-4,6,2,0,0,0,0,-23,-25,-1,-2,3,-2,0,-1,1,-1,-1,-1,5,-1
KR_6746712803,420,0,-40,30,-3,1,0,1,2,1,3,2,2,4,-8,8,0,0,0,0,0,-8,-4,0,-2,2,-1,0,-2,-1,0,-1,-1,2,-1
KR_6728906559,420,-1,33,4,2,-1,2,1,0,5,5,1,1,2,0,0,0,2,0,2,0,5,-29,1,-4,3,-3,0,0,1,0,0,-1,1,-1
KR_6684149341,420,2,13,32,5,-2,2,0,-2,4,2,4,0,4,4,1,5,1,1,2,2,9,-5,0,-3,3,3,0,1,1,1,1,1,1,-1
KR_6755134863,420,-6,48,-28,-15,-7,7,0,-1,3,2,-2,3,1,-2,6,4,-3,5,2,0,-4,-1,-3,0,3,3,0,0,-1,-1,-1,1,6,-1
KR_6764462570,420,0,-26,4,-6,0,3,3,-4,4,0,1,1,2,-2,2,0,-1,1,0,-1,-6,-9,-2,-5,7,-2,0,0,-1,-1,0,-1,5,-1
KR_6714094169,420,-6,-44,-10,-10,3,2,5,-3,4,1,-3,4,1,-7,8,1,0,1,1,0,-9,-499,-3,-1,4,30,0,-1,1,-1,-1,-1,1,-1
KR_6753055575,420,-5,-95,-4,-14,-5,6,1,-1,1,0,-8,8,0,0,1,1,0,1,1,0,-4,-9,-1,-2,3,0,0,-1,-1,-1,-1,-1,3,-1
KR_6745374290,440,-4,-71,-16,-11,-7,8,1,-9,12,3,-1,1,0,1,1,2,5,0,5,0,-4,6,-1,-1,2,-1,0,-2,-1,0,-1,-1,2,-1
KR_6760637396,420,0,-65,12,-3,-2,3,1,-1,3,2,-1,4,3,3,0,3,-2,2,0,0,-4,0,-4,-4,8,-1,0,0,1,0,0,-1,5,-1
KR_6751156208,440,3,-38,8,-2,-1,3,2,2,0,2,-1,3,2,0,1,1,-2,2,0,-1,-8,-1,-3,-1,4,-1,0,0,-1,1,0,-1,1,-1
KR_6711411786,420,3,4,4,6,1,2,3,4,0,4,0,3,3,0,2,2,1,1,2,0,5,-107,3,-5,2,-1,0,1,1,1,1,-1,2,-1
KR_6712302799,420,-1,-15,13,-4,-3,3,0,2,3,5,-3,3,0,0,1,1,0,1,1,0,-5,-1,-4,-1,5,0,0,-1,-1,-1,-1,1,5,-1
KR_6697503564,420,-6,-126,-12,-8,-3,4,1,-3,3,0,0,1,1,0,0,0,-2,2,0,0,-5,-14,-6,-1,7,-1,0,-4,-1,-1,-1,-1,4,-1
KR_6682521883,420,-2,-66,1,-5,-2,3,1,-3,3,0,-1,3,2,-2,3,1,3,0,3,1,-7,7,-2,-1,3,0,0,-1,-1,1,-1,1,5,-1
KR_6761368280,440,-2,43,16,-8,0,3,3,-3,4,1,-4,5,1,0,2,2,-1,1,0,0,-5,-13,-4,-2,6,4,0,0,-1,-1,0,-1,4,-1
KR_6736711538,420,0,33,-4,-2,-2,4,2,-4,4,0,3,2,5,0,5,5,1,1,2,-1,-8,13,-1,0,1,1,0,0,1,-1,0,-1,6,-1
KR_6755049098,420,-4,14,-28,-2,3,1,4,1,3,4,-4,4,0,-1,1,0,-1,1,0,-1,-1,-6,3,-4,1,-3,0,0,-1,-1,-1,-1,1,-1
KR_6739055909,420,4,-14,-20,7,-1,2,1,3,0,3,3,0,3,1,1,2,1,0,1,0,8,1,0,-3,3,2,0,0,1,1,0,1,5,-1
KR_6743824668,420,1,-28,-20,0,2,1,3,1,2,3,0,2,2,-1,1,0,-2,2,0,0,-1,-44,-2,-1,3,18,0,0,-1,-1,-1,-1,6,-1
KR_6724477533,420,1,10,28,4,2,0,2,1,0,1,0,1,1,3,0,3,-2,2,0,0,3,-121,4,-6,2,1,0,0,1,0,0,1,3,-1
KR_6748884168,420,2,-37,11,2,0,0,0,3,2,5,-1,4,3,1,3,4,-1,1,0,0,0,-441,-2,-2,4,2,0,0,-1,1,-1,-1,6,-1
KR_6736986592,440,1,-82,64,-1,-3,3,0,3,1,4,-2,7,5,1,3,4,0,0,0,-1,-1,90,-5,0,5,10,0,-1,1,-1,-1,-1,1,-1
KR_6721076604,420,1,-24,-28,-7,1,0,1,-2,2,0,-5,7,2,-1,3,2,0,1,1,0,-8,13,-1,-3,4,-1,0,-1,-1,1,-1,-1,5,-1
KR_6719481322,420,-6,-92,-36,-20,-4,4,0,-9,9,0,-1,3,2,-4,4,0,-2,2,0,0,-17,-7,-5,0,5,-1,0,-2,-1,-1,-1,-1,1,-1
KR_6761356197,420,0,17,0,-3,1,0,1,2,6,8,-2,3,1,-1,3,2,-3,4,1,1,0,-3,0,-4,4,-2,0,0,-1,-1,0,1,6,-1
KR_6720763075,420,-4,-19,-56,-7,-1,2,1,1,2,3,-5,8,3,-1,1,0,-1,1,0,0,-6,-2,4,-6,2,-1,0,0,-1,-1,0,-1,5,-1
KR_6642086740,420,-1,-28,-8,0,2,2,4,-3,4,1,-1,4,3,-1,5,4,3,1,4,0,-2,-7,5,-6,1,3,0,-1,1,1,-1,-1,3,-1
KR_6760649901,420,-1,14,-16,-6,-3,5,2,-2,5,3,2,2,4,-1,2,1,-2,2,0,0,-10,9,-3,-1,4,-1,0,-1,-1,-1,-1,-1,1,-1
KR_6704743557,440,-9,-76,-53,-19,-3,6,3,-3,4,1,-6,9,3,-4,6,2,-3,4,1,0,-17,-1,-3,-3,6,-1,0,-4,-1,-1,-1,-1,3,-1
KR_6753389729,420,-5,-88,-2,-16,-4,4,0,-6,6,0,1,3,4,-5,5,0,-2,2,0,0,-11,207,-1,-1,2,1,0,0,1,1,-1,-1,3,-1
KR_6762158692,420,-3,-17,-9,-6,-4,4,0,-9,11,2,5,4,9,0,3,3,2,2,4,0,0,-4,-2,-3,5,0,0,0,-1,-1,-1,1,1,-1
KR_6759680302,420,-3,-64,4,-2,1,1,2,-4,4,0,1,1,2,0,3,3,0,3,3,0,1,14,3,-6,3,-4,0,-1,1,1,-1,1,1,-1
KR_6691837243,420,-3,-31,-28,-9,-6,7,1,-2,4,2,-3,3,0,2,5,7,0,2,2,0,-5,-3,-2,-3,5,-3,0,-2,1,-1,-1,-1,1,-1
KR_6730423362,420,-3,-67,-12,-4,-1,2,1,-3,4,1,-2,3,1,0,4,4,2,0,2,0,-1,-5,-3,-2,5,-1,0,-3,-1,-1,-1,-1,3,-1
KR_6710654693,420,-2,-37,-15,-4,-5,7,2,-4,5,1,4,0,4,-1,5,4,2,0,2,0,7,-27,-1,-3,4,0,0,1,-1,1,1,-1,6,-1
KR_6756996401,420,1,-8,0,-3,1,1,2,-4,4,0,-4,6,2,3,2,5,1,0,1,0,-4,-2,-1,-3,4,0,0,0,1,-1,1,-1,5,-1
KR_6740910294,420,-5,-98,4,-20,-7,9,2,-1,2,1,-4,4,0,-2,3,1,-6,7,1,0,-17,-6,-1,-2,3,1,0,-4,-1,-1,-1,-1,4,-1
KR_6739830006,420,-5,-123,-31,-7,-2,3,1,3,4,7,-3,3,0,-3,3,0,-2,3,1,1,1,437,0,-1,1,-2,0,0,-1,1,-1,1,2,-1
KR_6661711304,420,-2,4,-25,-13,0,0,0,-1,3,2,-3,5,2,-6,7,1,-3,4,1,0,-11,-108,-1,-2,3,1,0,-1,-1,1,-1,-1,4,-1
KR_6755312002,420,0,-13,-12,0,0,0,0,2,3,5,-2,3,1,3,2,5,-3,3,0,0,2,-12,-1,-2,3,18,0,0,-1,0,0,1,2,-1
KR_6718954293,440,-2,28,2,-9,6,0,6,-1,2,1,-2,3,1,-8,8,0,-4,4,0,0,-20,297,1,-4,3,-1,0,1,1,0,-1,1,1,-1
KR_6658072287,420,0,-29,1,1,1,0,1,0,2,2,-1,3,2,1,2,3,0,1,1,0,0,8,5,-5,0,1,0,-2,-1,-1,-1,-1,2,-1
KR_6722470613,420,-2,23,0,-6,-8,11,3,0,2,2,2,0,2,0,1,1,0,0,0,0,-5,-2,-1,0,1,2,0,0,1,1,-1,1,2,-1
KR_6729714423,420,-4,-28,-4,-9,-2,3,1,-3,3,0,-2,4,2,-3,4,1,1,1,2,0,-12,-11,-3,-2,5,1,0,-1,-1,1,-1,1,4,-1
KR_6692168265,420,0,17,-4,0,1,0,1,1,3,4,4,0,4,-3,3,0,-3,3,0,0,-1,0,2,-3,1,0,0,0,0,0,1,-1,0,-1
KR_6593475909,420,-4,-67,8,-7,-1,3,2,-1,2,1,4,1,5,-8,8,0,-1,1,0,0,-8,-39,-1,0,1,-1,0,-3,-1,-1,-1,-1,1,-1
KR_6759730134,420,-8,-92,-36,-18,-10,11,1,-3,4,1,1,0,1,-3,5,2,-3,4,1,0,-8,-5,-1,-4,5,0,0,-3,-1,-1,-1,-1,4,-1
KR_6683359721,420,-3,-71,-16,1,-1,1,0,3,2,5,0,3,3,-1,2,1,0,0,0,0,10,21,3,-5,2,0,0,-1,1,0,-1,1,1,-1
KR_6737242669,420,-3,-61,5,-1,-1,1,0,1,0,1,1,1,2,-2,2,0,0,0,0,0,1,4,2,-2,0,-2,0,-1,-1,-1,-1,-1,4,-1
KR_6729493346,420,-5,-23,23,-18,-4,5,1,-2,4,2,-4,4,0,-6,7,1,-2,3,1,0,-12,2,-1,-1,2,1,0,-2,0,1,-1,-1,0,-1
KR_6635930172,420,2,2,24,3,-2,2,0,1,0,1,1,1,2,1,1,2,2,3,5,0,6,8,1,-2,1,-4,0,0,0,0,0,-1,0,-1
KR_6756285197,420,-3,-56,0,1,1,1,2,-1,3,2,4,1,5,-3,4,1,0,0,0,0,4,12,1,-4,3,-7,0,-1,-1,-1,-1,-1,5,-1
KR_6685395124,420,1,-17,-12,2,0,4,4,-2,3,1,2,1,3,4,0,4,-2,2,0,0,4,100,-2,-1,3,2,0,0,1,-1,0,-1,6,-1
KR_6663124003,420,-5,-102,-12,-16,-3,5,2,1,0,1,-5,6,1,-7,7,0,-2,2,0,0,-5,-40,1,-3,2,21,0,-2,0,-1,-1,-1,0,-1
KR_6732672243,420,-1,33,-28,-6,0,1,1,0,2,2,-1,3,2,-2,2,0,-3,3,0,0,-3,177,0,-3,3,-1,0,1,0,1,-1,-1,0,-1
KR_6694106692,420,-6,-76,-14,-19,-7,8,1,-5,5,0,-6,7,1,0,1,1,-1,1,0,-1,-9,0,-3,-1,4,-1,0,-3,-1,-1,-1,-1,5,-1
KR_6740037392,420,-3,-21,-4,-3,4,1,5,1,5,6,-6,9,3,-2,5,3,0,2,2,1,-2,-198,-5,-1,6,0,0,1,-1,1,1,1,1,-1
KR_6693765606,440,-1,24,-15,-1,-2,3,1,7,5,12,-4,5,1,-3,4,1,1,0,1,0,3,-12,-8,-1,9,4,0,0,-1,0,0,-1,1,-1
KR_6685196685,420,-3,-15,-7,-2,-1,2,1,2,2,4,2,1,3,0,3,3,-5,5,0,-1,3,40,3,-3,0,-24,0,-1,1,-1,-1,-1,4,-1
KR_6729750495,420,-3,-55,-4,-5,-2,3,1,-1,3,2,-1,2,1,0,2,2,-1,1,0,0,-2,-4,-4,0,4,2,0,-1,-1,-1,-1,1,1,-1
KR_6762866600,420,0,14,16,1,-5,6,1,7,0,7,-2,3,1,0,1,1,1,1,2,1,5,8,4,-7,3,1,0,-1,1,-1,-1,1,4,-1
KR_6750403955,420,-2,-44,-20,-6,1,0,1,-5,6,1,-4,6,2,2,0,2,0,1,1,0,-8,2,-4,-1,5,2,0,0,-1,1,0,-1,5,-1
KR_6726562114,420,-2,-48,-16,-3,-2,4,2,3,0,3,-5,6,1,2,3,5,-1,1,0,0,1,-3,-2,-4,6,4,0,-1,-1,-1,-1,-1,1,-1
KR_6729829463,420,-9,-128,-30,-10,-3,3,0,2,2,4,-7,8,1,-1,1,0,-1,3,2,-1,-12,-3,-3,-1,4,0,0,-3,-1,-1,-1,-1,1,-1
KR_6647869236,440,-4,-88,-4,-1,2,3,5,-1,2,1,-3,6,3,4,1,5,-3,3,0,1,-9,-41,-1,0,1,23,0,-1,-1,1,-1,1,5,-1
KR_6753674168,420,3,39,4,7,1,3,4,1,1,2,3,0,3,-2,3,1,4,1,5,0,10,5,1,-3,2,-3,0,2,1,1,1,1,4,-1
KR_6738048300,440,-5,-15,-30,-11,-4,7,3,0,4,4,-1,2,1,-3,3,0,-3,3,0,0,0,391,-2,0,2,1,0,-2,-1,1,-1,1,4,-1
KR_6732758801,420,-1,39,-8,2,6,2,8,-2,3,1,2,2,4,-3,3,0,-1,1,0,0,-4,-6,4,-6,2,2,0,0,0,0,0,1,0,-1
KR_6734462972,440,-7,-99,-12,-17,-5,5,0,-7,9,2,1,2,3,-1,2,1,-5,5,0,0,-11,-17,-4,-1,5,-2,0,-1,-1,1,-1,-1,3,-1
KR_6760834147,420,-4,-65,0,-12,-5,6,1,0,1,1,-3,6,3,-4,5,1,0,2,2,0,-3,-5,-3,-1,4,1,0,-2,0,0,-1,-1,0,-1
KR_6764051282,420,0,-12,0,-5,-2,3,1,-1,3,2,-1,4,3,-1,2,1,0,2,2,0,-2,2,-1,-1,2,3,0,0,-1,0,0,-1,3,-1
KR_6670079719,420,-4,-50,0,0,-3,5,2,5,2,7,-7,8,1,4,2,6,1,0,1,1,8,2,0,-6,6,2,0,0,-1,0,0,1,6,-1
KR_6739462377,420,-4,-2,21,-9,-4,5,1,-1,2,1,-2,5,3,-1,4,3,-1,1,0,0,-5,2,0,-1,1,-1,0,0,-1,-1,0,-1,4,-1
KR_6730715152,440,-3,-43,11,-4,-3,4,1,0,1,1,-3,5,2,4,0,4,-2,2,0,0,-1,-37,2,-4,2,22,0,0,-1,1,0,1,2,-1
KR_6732547967,420,-1,-44,32,-3,-1,1,0,0,1,1,0,1,1,-2,2,0,0,0,0,0,-5,4,-2,-1,3,0,0,0,-1,0,0,-1,4,-1
KR_6739954500,420,-4,-67,-26,-13,-5,5,0,-1,1,0,-2,3,1,-1,1,0,-4,4,0,-1,-12,13,-1,-1,2,-1,0,-1,-1,-1,-1,-1,2,-1
KR_6734345828,420,1,15,-4,2,-1,1,0,-1,2,1,4,2,6,-2,3,1,2,0,2,0,3,16,0,-1,1,-1,0,0,-1,1,0,1,4,-1
KR_6726540422,420,-3,-45,17,-13,-2,3,1,-2,2,0,-5,6,1,-2,3,1,-2,5,3,0,-7,3,0,-5,5,-1,0,-1,1,-1,-1,-1,3,-1
KR_6706505907,420,-4,-32,-16,-8,-4,5,1,-7,7,0,6,2,8,1,1,2,-4,5,1,0,-5,-268,1,-2,1,0,0,-1,-1,-1,-1,-1,5,-1
KR_6648512690,420,-1,6,-44,0,7,2,9,-5,5,0,0,1,1,-2,3,1,0,1,1,0,-5,-2,0,-3,3,0,0,1,-1,1,1,1,6,-1
KR_6663329559,420,-4,-85,28,-13,-1,2,1,3,0,3,-13,13,0,-1,6,5,-1,1,0,-1,-8,-6,-2,0,2,1,0,-1,-1,1,-1,-1,4,-1
KR_6757171485,420,2,36,-8,6,-2,2,0,-2,3,1,-2,4,2,11,0,11,1,0,1,0,2,4,2,-8,6,3,0,1,1,0,1,1,5,-1
KR_6699796813,420,-1,-70,-48,-4,-6,7,1,-4,5,1,-1,1,0,7,2,9,0,0,0,0,-1,7,2,-3,1,2,0,1,1,1,1,1,1,-1
KR_6759610954,420,-2,40,-4,-5,1,1,2,1,1,2,5,0,5,-10,11,1,-2,2,0,-1,-10,-61,0,-1,1,-1,0,0,-1,-1,-1,-1,4,-1
KR_6757507307,420,3,43,32,-1,0,2,2,-6,7,1,1,3,4,4,3,7,0,2,2,1,-1,-234,-7,0,7,3,0,1,1,1,1,1,5,-1
KR_6697123790,420,2,-2,-12,2,0,0,0,4,2,6,-1,2,1,-2,5,3,1,0,1,0,0,-7,3,-4,1,-2,0,1,-1,1,1,1,6,-1
KR_6726695291,420,-3,-56,-33,-4,-2,5,3,-1,2,1,-2,5,3,3,0,3,-2,3,1,0,0,2,1,-4,3,-2,0,-2,1,-1,-1,-1,5,-1
KR_6750211568,420,0,-45,-30,8,-2,3,1,5,2,7,8,0,8,-5,7,2,2,1,3,0,6,228,-1,0,1,0,0,1,-1,1,1,1,2,-1
KR_6729369152,420,0,-5,-31,-2,2,3,5,-3,3,0,1,1,2,-4,5,1,2,2,4,0,-5,9,1,-5,4,0,0,0,0,-1,1,1,0,-1
KR_6704771298,420,-2,-82,10,1,1,2,3,0,2,2,3,3,6,1,2,3,-4,4,0,0,2,2,1,-3,2,0,0,0,1,1,-1,1,5,-1
KR_6751798435,420,-1,9,-10,2,-3,5,2,0,4,4,5,0,5,-1,5,4,1,0,1,0,3,4,0,-2,2,-2,0,-1,1,-1,-1,-1,1,-1
KR_6728121721,440,-3,-72,12,-11,2,1,3,1,2,3,-4,6,2,-9,12,3,-1,1,0,0,-10,-43,-1,-3,4,19,0,-1,1,0,-1,-1,2,-1
KR_6762757497,420,0,12,-5,-4,2,2,4,-2,5,3,-2,3,1,2,2,4,-4,4,0,0,-5,-6,0,-4,4,0,0,0,0,-1,0,-1,0,-1
KR_6758509910,420,1,-46,0,4,0,0,0,0,2,2,1,2,3,3,0,3,0,2,2,0,5,-5,4,-8,4,4,0,0,1,-1,-1,1,6,-1
KR_6683877265,420,-3,6,-3,-12,-2,2,0,-2,3,1,-3,3,0,-4,5,1,-1,1,0,-1,-14,-1,-2,0,2,-1,0,0,-1,-1,0,-1,4,-1
KR_6739938377,420,-2,-26,22,-7,-3,3,0,3,3,6,-3,5,2,-3,4,1,-1,1,0,0,-9,-8,3,-5,2,-1,0,0,-1,-1,0,1,6,-1
KR_6758082571,440,-3,-3,-16,-2,1,2,3,-6,6,0,3,2,5,-4,5,1,4,2,6,0,3,1,-2,-5,7,-1,0,0,0,1,1,-1,0,-1
KR_6646906309,420,-2,-15,24,-8,-5,6,1,1,1,2,2,2,4,-6,7,1,0,0,0,0,-6,335,1,-3,2,0,0,0,-1,-1,0,-1,3,-1
KR_6643575147,420,-1,54,-20,-9,-2,2,0,-4,4,0,-2,3,1,-1,3,2,0,0,0,-1,-16,16,-3,-1,4,-1,0,-1,-1,1,-1,-1,6,-1
KR_6743626139,420,1,-25,4,-4,0,2,2,-5,5,0,-1,2,1,0,10,10,2,3,5,0,-3,-172,0,0,0,0,0,-1,-1,-1,-1,1,6,-1
KR_6634068171,420,-2,-6,-12,-8,-2,4,2,-3,3,0,3,0,3,-6,7,1,0,1,1,0,-10,8,0,-1,1,2,0,0,1,1,0,1,4,-1
KR_6729245948,420,-1,13,28,-3,2,0,2,-4,6,2,4,1,5,-4,5,1,-1,1,0,0,-2,-10,-2,0,2,-1,0,-1,0,-1,-1,1,0,-1
KR_6762689796,420,0,-30,-10,-2,-2,4,2,1,1,2,1,1,2,1,3,4,-3,5,2,0,-1,241,1,-3,2,0,0,0,-1,-1,0,-1,3,-1
KR_6708239635,440,-8,-115,-20,-13,-7,7,0,1,2,3,-2,2,0,-5,7,2,0,1,1,0,-12,-5,-6,-2,8,0,0,-2,-1,-1,-1,1,2,-1
KR_6746433602,420,-1,62,-23,-6,6,0,6,-10,12,2,-3,4,1,2,1,3,-1,1,0,0,-7,192,-2,-3,5,7,0,0,-1,-1,-1,1,4,-1
KR_6723021570,420,-1,20,-24,5,2,1,3,2,2,4,0,1,1,-5,6,1,6,0,6,1,5,-8,-7,-1,8,3,0,0,1,0,0,1,5,-1
KR_6655092454,420,2,90,16,2,3,1,4,-1,5,4,8,0,8,-9,10,1,1,2,3,0,-7,20,-2,0,2,-5,0,1,-1,1,1,-1,1,-1
KR_6757599277,420,-1,40,-20,-8,3,0,3,-5,6,1,-4,7,3,0,3,3,-2,3,1,-1,-10,3,2,-3,1,1,0,0,1,-1,0,-1,2,-1
KR_6697152110,420,-3,-66,-22,-8,-3,5,2,-1,1,0,2,0,2,-5,6,1,-1,1,0,0,-6,-6,1,-2,1,1,0,-2,-1,0,-1,-1,5,-1
KR_6749567101,420,-2,-11,-5,-8,-3,3,0,0,2,2,-2,3,1,-4,6,2,1,0,1,1,0,1,5,-6,1,2,0,0,-1,1,-1,1,5,-1
KR_6752047192,420,0,-2,-40,6,0,0,0,3,0,3,-1,3,2,1,1,2,3,0,3,0,11,3,-1,-4,5,0,0,0,0,-1,0,-1,0,-1
KR_6632857615,440,-2,-40,-9,1,1,2,3,-2,3,1,-3,3,0,3,4,7,2,0,2,0,0,-21,-3,-2,5,-3,0,0,0,-1,1,1,0,-1
KR_6764416046,420,-3,-54,-29,-4,-1,2,1,4,1,5,-4,4,0,-2,3,1,-1,1,0,0,-2,4,-1,-1,2,-1,0,-1,-1,1,-1,-1,1,-1
KR_6754169024,420,2,77,-19,-1,-2,3,1,-3,3,0,0,2,2,3,0,3,1,1,2,0,-1,385,-1,-4,5,3,0,1,0,-1,1,1,0,-1
KR_6658078416,420,0,-45,-17,-1,1,0,1,-2,2,0,3,1,4,-4,4,0,1,1,2,1,4,-24,0,-4,4,1,0,0,-1,-1,0,1,3,-1
KR_6743559698,420,-1,-11,67,-10,2,1,3,-10,11,1,-1,2,1,0,0,0,-1,1,0,-1,-9,-4,1,-3,2,4,0,0,0,0,-1,-1,0,-1
KR_6759379419,440,-2,3,-2,-7,0,2,2,-6,6,0,1,0,1,1,4,5,-3,3,0,0,-5,-10,0,-2,2,0,0,0,-1,0,-1,1,4,-1
KR_6759520516,420,1,2,12,0,1,1,2,-2,2,0,0,0,0,0,0,0,1,0,1,0,-1,-19,-4,-2,6,3,0,-1,0,-1,-1,1,0,-1
KR_6701583158,420,0,27,17,-5,-2,2,0,-2,2,0,1,0,1,-1,1,0,-1,1,0,0,-3,34,-3,-4,7,-18,0,-1,-1,0,-1,1,4,-1
KR_6704007618,420,-1,-45,-9,-3,-1,3,2,-5,7,2,-1,3,2,2,1,3,2,0,2,0,1,18,-1,-1,2,0,0,-1,-1,-1,-1,-1,1,-1
KR_6724222151,420,-1,-39,16,-1,2,0,2,0,1,1,-3,3,0,-3,3,0,3,3,6,0,1,0,1,-3,2,1,0,-1,-1,1,-1,1,5,-1
KR_6759194858,420,-4,75,-12,2,0,1,1,2,1,3,-2,2,0,4,0,4,-2,2,0,1,4,6,-1,-3,4,3,0,0,0,0,0,1,0,-1
KR_6742484493,420,-1,-55,-4,-10,-1,4,3,2,2,4,-1,3,2,-8,9,1,-2,4,2,0,-6,-10,-1,0,1,0,0,-1,-1,-1,-1,-1,1,-1
KR_6716347977,420,-5,-64,-19,-10,-5,6,1,-4,4,0,-3,6,3,2,0,2,0,2,2,0,-4,-9,-8,0,8,-1,0,0,-1,1,0,1,2,-1
KR_6708660139,420,-6,-83,-56,-13,0,2,2,-3,6,3,-12,12,0,4,1,5,-2,2,0,0,5,-7,0,-3,3,-3,0,-2,-1,-1,-1,-1,5,-1
KR_6741714626,420,-1,-3,-48,3,-2,2,0,-1,2,1,2,0,2,5,2,7,-1,3,2,0,1,-18,2,-4,2,3,0,1,1,-1,1,-1,5,-1
KR_6748356538,420,0,-39,-13,-6,-2,3,1,-3,4,1,-4,6,2,3,0,3,0,1,1,0,2,18,-1,-1,2,-1,0,0,-1,0,1,1,2,-1
KR_6733072689,420,1,1,-15,-1,0,2,2,-2,3,1,3,2,5,1,2,3,-3,3,0,0,-3,-89,2,-4,2,-5,0,0,1,-1,0,1,2,-1
KR_6757858273,420,-3,-35,-35,-4,2,0,2,1,1,2,1,0,1,-7,7,0,-1,2,1,0,-4,1,4,-7,3,-1,0,0,-1,-1,0,-1,3,-1
KR_6735006149,420,-4,-72,-12,-4,-3,3,0,-1,2,1,0,0,0,0,0,0,0,0,0,0,-1,19,-3,-3,6,-3,0,-2,-1,-1,-1,-1,3,-1
KR_6697968875,420,-2,-67,-24,-10,-2,6,4,-4,5,1,5,2,7,-7,8,1,-2,2,0,0,-4,16,-4,-2,6,2,0,0,-1,1,0,-1,2,-1
KR_6763178046,420,1,34,-9,3,0,2,2,0,2,2,0,1,1,3,0,3,0,2,2,0,5,1,-1,0,1,2,0,0,-1,-1,-1,-1,1,-1
KR_6753023726,420,-1,19,12,-4,4,0,4,-3,3,0,-1,1,0,-3,3,0,-1,3,2,0,-3,15,1,-3,2,-1,0,-1,1,1,-1,-1,6,-1
KR_6725894346,420,6,-2,32,0,4,0,4,-1,4,3,1,1,2,-2,2,0,-2,2,0,0,-5,2,-2,-3,5,2,0,0,-1,-1,0,-1,6,-1
KR_6755098667,420,2,-37,-6,6,0,4,4,2,1,3,6,0,6,-3,4,1,1,0,1,-1,4,-321,4,-6,2,1,0,0,1,1,1,-1,2,-1
KR_6688139416,420,-1,-16,-8,-4,-1,2,1,0,2,2,-8,8,0,4,1,5,1,0,1,0,-1,4,1,-1,0,-2,0,-1,-1,-1,-1,-1,1,-1
KR_6757729244,420,0,47,4,1,-1,2,1,-3,4,1,-4,5,1,2,2,4,7,0,7,0,0,14,0,-4,4,-4,0,0,0,-1,0,1,0,-1
KR_6759420324,420,-4,-92,-5,-4,-1,1,0,0,1,1,-3,4,1,2,1,3,-2,2,0,1,2,-8,0,-4,4,1,0,0,-1,1,1,1,4,-1
KR_6757061560,420,-1,73,-24,-1,0,2,2,-2,2,0,-2,3,1,2,0,2,1,1,2,0,-4,4,-2,-1,3,5,0,-1,1,-1,-1,-1,5,-1
KR_6726320009,420,-3,-106,-26,-6,-1,3,2,-8,10,2,-1,5,4,4,1,5,0,4,4,1,1,-2,-2,0,2,0,0,-2,1,0,-1,1,1,-1
KR_6752546927,420,-1,5,-4,-8,-1,1,0,2,1,3,-7,7,0,-1,4,3,-1,3,2,0,-2,-202,-3,-6,9,-2,0,0,1,-1,0,-1,2,-1
KR_6754239105,420,-4,10,-37,-4,2,3,5,-1,2,1,2,2,4,-3,4,1,-4,4,0,0,-4,-98,2,-8,6,-3,0,0,-1,-1,-1,1,3,-1
KR_6756157779,420,-3,-76,-1,-11,-2,3,1,0,3,3,-6,6,0,-3,3,0,0,1,1,-1,-7,-32,-1,-2,3,-2,0,0,-1,-1,-1,-1,3,-1
KR_6734593322,420,2,29,-23,6,-2,5,3,0,2,2,4,0,4,4,0,4,0,1,1,1,4,-8,-1,-2,3,2,0,2,-1,-1,1,1,4,-1
KR_6760432426,440,-1,-17,-9,0,4,1,5,3,1,4,-6,7,1,0,3,3,-1,1,0,0,-5,1,2,-2,0,-2,0,-1,1,-1,-1,1,1,-1
KR_6752066046,420,0,36,12,-2,-1,3,2,-3,3,0,-2,2,0,3,1,4,1,0,1,0,2,6,4,-5,1,0,0,0,1,1,0,-1,6,-1
KR_6745263123,420,-2,24,0,5,9,0,9,-2,3,1,-4,6,2,2,1,3,0,0,0,3,-1,-48,-4,-1,5,13,0,0,-1,1,1,1,5,-1
KR_6742241211,420,-5,-50,-8,-8,-1,1,0,1,0,1,-9,10,1,1,2,3,0,0,0,0,-2,-129,1,-2,1,1,0,-1,-1,1,-1,-1,2,-1
KR_6764115132,440,-5,-59,-3,-5,2,1,3,-3,4,1,2,0,2,-9,9,0,3,0,3,0,-6,-27,0,-4,4,2,0,-1,1,0,-1,1,4,-1
KR_6760656594,420,-5,-8,-7,-5,-14,14,0,-2,2,0,3,2,5,8,0,8,0,1,1,0,-1,3,-1,-2,3,0,0,-2,1,-1,-1,-1,6,-1
KR_6760270942,420,2,-18,-8,0,3,0,3,0,2,2,2,1,3,-5,5,0,0,0,0,0,-7,-3,-5,-1,6,1,0,-1,-1,-1,-1,1,3,-1
KR_6697161365,420,-1,7,16,5,-2,4,2,3,2,5,1,1,2,4,0,4,-1,2,1,0,6,6,2,-5,3,-3,0,-1,1,-1,-1,1,4,-1
KR_6705090805,420,-1,-46,4,5,1,1,2,0,4,4,-2,2,0,4,0,4,2,1,3,1,7,218,0,-3,3,6,0,1,-1,-1,1,1,3,-1
KR_6740260184,440,-3,-21,-16,-5,-2,3,1,-3,4,1,-4,5,1,4,1,5,0,0,0,0,-5,-4,2,-3,1,-2,0,-1,-1,-1,-1,-1,5,-1
KR_6703001761,420,-1,-63,0,-3,0,1,1,-1,2,1,-1,3,2,0,0,0,-1,1,0,0,-1,-19,5,-7,2,-6,0,0,-1,0,0,-1,6,-1
KR_6751402819,420,-2,54,-28,-3,0,2,2,-2,3,1,-3,5,2,4,2,6,-2,2,0,0,-6,8,-2,0,2,2,0,1,-1,-1,-1,1,6,-1
KR_6760712942,440,-3,-57,4,0,-2,2,0,0,2,2,4,1,5,1,5,6,-3,3,0,0,11,-6,5,-7,2,-3,0,-1,-1,0,-1,1,4,-1
KR_6749319976,420,2,50,1,12,-5,5,0,2,2,4,3,1,4,8,0,8,4,0,4,0,10,13,3,-5,2,-4,0,0,-1,-1,1,1,1,-1
KR_6754990504,420,0,-4,5,0,1,1,2,-5,8,3,6,2,8,-1,3,2,-1,1,0,0,-6,0,1,-3,2,2,0,0,1,0,0,-1,3,-1
KR_6749784584,420,1,-38,4,7,2,0,2,-2,3,1,4,2,6,-1,3,2,4,0,4,-1,4,0,4,-4,0,0,0,0,1,0,-1,-1,5,-1
KR_6723248270,420,0,53,4,-2,-2,2,0,2,2,4,0,0,0,2,1,3,-4,4,0,0,-5,11,1,-2,1,-1,0,0,1,1,1,1,4,-1
KR_6747674989,420,-5,-80,-53,-7,-6,7,1,-3,5,2,-4,6,2,8,1,9,-2,2,0,0,-2,-4,0,-3,3,5,0,-2,-1,-1,-1,-1,3,-1
KR_6686215492,420,-2,-66,-21,-2,-2,3,1,-1,4,3,4,1,5,-2,4,2,-1,1,0,2,7,5,-4,-3,7,-1,0,-2,1,0,-1,1,3,-1
KR_6736868743,420,2,23,12,5,2,0,2,-1,1,0,-2,3,1,7,0,7,-1,2,1,0,10,85,1,-2,1,2,0,2,1,-1,1,1,6,-1
KR_6754142533,420,-2,-24,24,-6,0,3,3,-2,3,1,-2,3,1,-3,5,2,1,0,1,0,-9,-5,-1,-2,3,-2,0,0,-1,1,-1,1,3,-1
KR_6678107320,440,1,-43,4,0,2,0,2,0,4,4,0,1,1,2,3,5,-4,5,1,0,0,4,0,-2,2,1,0,0,-1,0,0,-1,3,-1
KR_6759389272,420,0,60,17,0,-5,8,3,5,0,5,-3,3,0,2,2,4,1,3,4,0,-4,0,2,-5,3,1,0,0,-1,0,0,1,4,-1
KR_6632936411,440,0,-9,-12,-4,-6,6,0,-1,6,5,-4,6,2,2,0,2,5,2,7,0,-10,-4,-1,0,1,0,0,1,0,0,1,-1,0,-1
KR_6764506887,420,3,3,3,3,-5,5,0,-1,1,0,0,2,2,6,1,7,3,0,3,0,11,6,1,-4,3,-1,0,1,1,-1,1,-1,2,-1
KR_6736296786,420,-7,-115,-10,-14,2,1,3,0,3,3,-6,6,0,-5,6,1,-5,5,0,0,-7,-5,-2,-1,3,-4,0,-4,-1,-1,-1,1,6,-1
KR_6734028868,420,-3,46,-44,-11,0,3,3,-4,6,2,-2,3,1,-4,4,0,-1,1,0,0,-7,4,0,-2,2,0,0,0,-1,1,0,-1,6,-1
KR_6707459173,420,-2,-64,4,0,0,0,0,1,2,3,-1,2,1,0,3,3,0,0,0,0,-1,-42,2,-8,6,28,0,-1,-1,0,-1,1,6,-1
KR_6753369018,420,1,-61,44,0,0,0,0,-2,5,3,-3,4,1,3,0,3,2,0,2,1,8,3,-6,-2,8,1,0,-1,1,-1,-1,1,4,-1
KR_6681341042,420,-1,-29,-1,1,1,0,1,-2,3,1,2,4,6,-1,3,2,1,0,1,0,-5,5,3,-4,1,2,0,-1,1,-1,-1,-1,6,-1
KR_6670289806,420,0,-23,12,0,0,2,2,0,3,3,-4,5,1,1,2,3,3,1,4,3,15,-4,0,-5,5,3,0,0,-1,0,0,1,3,-1
KR_6730921967,420,-1,-73,-20,-1,0,0,0,-3,4,1,2,3,5,-2,3,1,2,1,3,0,-3,-55,-1,-2,3,35,0,-1,-1,1,-1,-1,3,-1
KR_6761561010,440,1,116,8,-5,-3,4,1,-3,4,1,-1,5,4,0,1,1,2,0,2,0,-7,-318,1,-3,2,-8,0,1,1,1,1,-1,1,-1
KR_6758938983,420,-4,-88,20,-7,-3,3,0,1,1,2,-1,3,2,-2,3,1,-2,2,0,0,-3,-4,-1,-3,4,3,0,0,0,0,0,-1,0,-1
KR_6669102521,420,1,-21,31,-1,3,1,4,-3,4,1,0,3,3,-3,5,2,2,0,2,0,-8,2,-1,0,1,-2,0,-1,1,0,-1,-1,6,-1
KR_6762502570,440,-1,22,-4,0,1,0,1,0,1,1,-2,2,0,0,1,1,1,1,2,0,0,10,1,-2,1,-4,0,0,1,1,0,1,2,-1
KR_6721718625,420,0,10,0,1,1,0,1,1,2,3,3,1,4,-1,5,4,-3,3,0,0,-1,12,-2,-1,3,-31,0,0,-1,1,0,1,1,-1
KR_6668765986,420,-4,-41,-27,-14,-6,6,0,-3,8,5,-2,3,1,1,1,2,-4,4,0,0,-17,-287,1,-2,1,-2,0,-2,-1,1,-1,-1,2,-1
KR_6736881793,420,3,93,-12,5,7,0,7,-3,3,0,-5,6,1,5,0,5,1,2,3,0,0,16,1,-4,3,0,0,1,-1,1,1,1,3,-1
KR_6763589653,420,-2,-97,-31,4,-2,3,1,5,0,5,-6,6,0,5,0,5,2,0,2,1,11,-29,7,-10,3,18,0,0,0,1,0,1,0,-1
KR_6739977605,420,-3,-49,-12,-10,0,1,1,0,6,6,-6,6,0,-3,3,0,-1,1,0,0,-8,102,-2,0,2,-3,0,-2,1,-1,-1,-1,4,-1
KR_6763908881,420,-2,4,-4,-6,-5,6,1,1,0,1,-2,3,1,1,0,1,-1,2,1,1,-5,5,3,-5,2,-4,0,-1,-1,-1,-1,1,4,-1
KR_6754543516,420,-7,-68,-32,-15,0,2,2,-5,6,1,-2,3,1,-5,5,0,-3,3,0,0,-12,-19,3,-5,2,-2,0,-3,-1,-1,-1,1,5,-1
KR_6751482173,420,2,1,32,5,1,0,1,5,3,8,-2,6,4,1,0,1,0,0,0,0,11,8,4,-8,4,-8,0,0,0,1,0,-1,0,-1
KR_6673421213,420,1,-57,-4,3,-3,3,0,-1,2,1,2,3,5,0,1,1,5,3,8,0,4,-51,0,-2,2,18,0,0,1,1,0,-1,6,-1
KR_6721376988,420,-4,14,9,-11,-1,3,2,-8,8,0,-1,3,2,1,1,2,-2,2,0,0,-6,-41,5,-6,1,20,0,0,-1,-1,-1,-1,6,-1
KR_6747254158,420,0,41,-48,-4,-3,4,1,1,0,1,-2,7,5,-1,5,4,1,0,1,0,4,16,1,-5,4,0,0,1,1,-1,-1,1,2,-1
KR_6747469452,420,-3,0,-20,0,-2,2,0,2,2,4,0,2,2,-1,3,2,1,1,2,0,4,0,-1,-1,2,-1,0,0,1,-1,0,-1,3,-1
KR_6684096151,420,2,59,35,11,11,1,12,-2,6,4,3,1,4,0,3,3,-1,3,2,0,4,7,4,-5,1,-2,0,0,-1,0,1,1,1,-1
KR_6735725254,420,-2,20,0,-5,0,3,3,0,1,1,-1,2,1,-5,6,1,1,0,1,0,-12,160,-1,0,1,-1,0,-1,-1,-1,-1,-1,6,-1
KR_6663006575,420,-2,58,-36,-2,1,1,2,-4,4,0,-2,2,0,2,0,2,1,0,1,0,-2,3,0,-4,4,2,0,0,1,0,0,1,4,-1
KR_6759502549,420,-5,-84,-8,-8,-1,1,0,-3,3,0,-2,2,0,-3,5,2,1,1,2,1,-3,-19,2,-3,1,0,0,0,-1,-1,-1,1,6,-1
KR_6661997120,420,2,10,-9,8,1,0,1,7,0,7,-3,5,2,2,1,3,1,4,5,1,7,-3,2,-5,3,-2,0,0,1,0,1,1,3,-1
KR_6706627871,420,-3,3,-24,-1,-2,3,1,2,2,4,2,2,4,-3,4,1,0,4,4,0,2,1,0,-1,1,-3,0,-2,-1,-1,-1,1,2,-1
KR_6721978665,420,1,50,-3,2,5,1,6,0,1,1,2,1,3,-5,7,2,0,1,1,0,-2,3,0,-5,5,1,0,-1,-1,1,-1,-1,1,-1
KR_6746221677,420,-2,5,-45,-3,1,1,2,-2,3,1,2,1,3,-5,7,2,1,0,1,0,-3,4,1,-1,0,1,0,-1,-1,1,-1,-1,1,-1
KR_6682740378,420,-8,-77,-39,-12,-12,13,1,1,0,1,0,1,1,-3,4,1,2,1,3,0,-6,-13,-2,0,2,-1,0,-1,1,1,-1,-1,2,-1
KR_6763620042,420,2,102,-27,-2,4,0,4,-4,4,0,0,1,1,-1,3,2,-1,2,1,0,-11,-4,-3,-2,5,1,0,0,1,0,0,1,6,-1
KR_6749247706,420,2,23,-18,2,-2,2,0,4,2,6,2,0,2,-5,6,1,3,1,4,1,6,60,-1,-1,2,1,0,0,1,-1,0,1,3,-1
KR_6748395420,420,-2,25,14,-6,1,1,2,-11,12,1,4,1,5,0,4,4,0,0,0,0,-5,-109,-2,-2,4,-3,0,0,1,1,0,1,2,-1
KR_6757457922,420,1,23,-24,0,-1,2,1,-1,3,2,-4,5,1,2,3,5,4,1,5,0,-3,-8,3,-3,0,5,0,0,1,1,1,1,1,-1
KR_6649265839,420,-5,-108,14,-8,1,1,2,-1,2,1,-6,6,0,-2,2,0,0,1,1,1,-3,-8,1,-3,2,2,0,-1,1,-1,-1,1,4,-1
KR_6763585701,420,-1,-29,-1,0,-2,5,3,0,1,1,1,1,2,2,1,3,-1,2,1,0,6,12,-3,-3,6,1,0,0,1,-1,-1,-1,3,-1
KR_6732077187,440,-3,-99,-22,-7,1,2,3,-1,3,2,-1,2,1,-3,4,1,-3,3,0,0,-7,14,-3,0,3,-3,0,0,0,1,0,-1,0,-1
KR_6762732924,420,-6,-106,-18,-20,-5,6,1,-3,6,3,-1,2,1,-5,8,3,-6,6,0,0,-6,-4,2,-3,1,-1,0,-1,1,1,-1,-1,2,-1
KR_6734135143,420,-6,27,-10,-13,-3,3,0,-3,3,0,-3,6,3,-5,6,1,1,3,4,0,-5,3,0,-2,2,0,0,-1,-1,-1,-1,-1,4,-1
KR_6734136118,420,-7,-94,-19,-15,-2,2,0,1,2,3,-10,10,0,-2,4,2,-2,2,0,0,-7,9,0,-2,2,-2,0,-2,-1,1,-1,-1,5,-1
KR_6717489820,440,-2,-77,-28,-5,-2,3,1,0,6,6,-4,4,0,5,2,7,-4,5,1,1,3,258,2,-3,1,-2,0,-1,-1,0,-1,1,3,-1
KR_6743517840,440,-1,-19,-23,0,-2,2,0,2,2,4,2,1,3,-4,4,0,2,0,2,0,-1,-14,-1,-3,4,1,0,-1,1,-1,-1,1,6,-1
KR_6761109379,420,-2,-20,9,-7,-4,5,1,-3,7,4,0,2,2,-2,2,0,2,1,3,0,1,2,1,-3,2,-1,0,0,-1,-1,0,1,3,-1
KR_6756735857,420,0,-14,-28,3,0,2,2,1,1,2,2,4,6,0,2,2,0,1,1,0,2,5,-2,0,2,-1,0,0,-1,1,0,1,5,-1
KR_6685835428,440,-3,-49,18,1,-5,6,1,7,0,7,-2,4,2,1,2,3,0,0,0,0,4,115,0,0,0,0,0,-2,-1,-1,-1,1,1,-1
KR_6622703755,420,-5,-128,26,-9,0,3,3,-5,5,0,3,2,5,-5,5,0,-2,4,2,-1,-16,1,0,-2,2,-3,0,-2,-1,0,-1,-1,4,-1
KR_6662952638,420,-3,10,5,-4,-1,3,2,-1,5,4,1,1,2,0,2,2,-3,3,0,0,-2,-138,1,-2,1,1,-1,-2,1,-1,-1,-1,6,-1
KR_6661260823,420,-1,-37,-14,-6,-4,6,2,2,2,4,0,2,2,-4,6,2,0,0,0,0,-3,-5,-3,-1,4,3,0,0,1,-1,0,-1,4,-1
KR_6762554980,420,-1,-18,-12,-7,0,2,2,-1,1,0,1,0,1,-6,8,2,-1,1,0,0,-5,56,-2,0,2,-1,0,0,-1,-1,0,-1,6,-1
KR_6761789580,440,-4,-12,-20,-5,-1,2,1,-4,6,2,-4,6,2,0,1,1,4,3,7,0,-14,-23,-3,0,3,-1,0,0,1,0,0,-1,5,-1
KR_6706085824,420,-1,1,-20,-4,-1,4,3,-6,8,2,-5,5,0,8,0,8,0,0,0,-1,0,-11,-3,-2,5,2,0,-1,-1,-1,1,-1,4,-1
KR_6761658372,420,-1,-1,34,-10,-2,3,1,3,1,4,-4,6,2,-7,8,1,0,3,3,0,-11,-3,-3,-4,7,-1,0,-1,-1,-1,-1,-1,5,-1
KR_6695613392,440,-4,29,12,-9,0,1,1,-6,7,1,0,1,1,-6,6,0,3,1,4,0,-11,209,0,-2,2,0,0,-1,0,1,-1,-1,0,-1
KR_6729291171,420,-2,-23,-12,-3,0,0,0,-4,5,1,0,3,3,1,3,4,0,2,2,0,-1,3,-1,-1,2,1,0,-3,-1,-1,-1,1,5,-1
KR_6748407600,420,2,65,-12,3,-3,7,4,7,2,9,0,4,4,1,1,2,-2,2,0,0,7,4,-1,0,1,-1,0,1,-1,1,1,1,4,-1
KR_6760992815,420,2,3,-27,7,4,1,5,2,1,3,0,0,0,0,2,2,1,0,1,0,6,-1,5,-5,0,6,0,1,1,0,1,1,5,-1
KR_6728472600,420,3,45,15,0,3,0,3,-1,1,0,-5,7,2,4,0,4,-1,1,0,0,1,-5,0,-2,2,1,0,0,-1,1,0,-1,6,-1
KR_6763327891,420,-2,-77,-5,-8,-4,4,0,-1,2,1,-1,2,1,-4,6,2,2,0,2,0,-3,4,-2,-5,7,-4,0,-2,-1,-1,-1,1,6,-1
KR_6763768470,420,-6,-130,-56,-11,-3,5,2,-3,4,1,-2,2,0,-1,1,0,-2,2,0,0,-8,1,0,-5,5,4,0,-1,-1,-1,-1,-1,2,-1
KR_6763342588,440,-4,-65,-31,-6,-4,4,0,1,1,2,-4,7,3,1,5,6,0,1,1,1,0,62,-2,-1,3,1,0,-1,-1,-1,-1,1,2,-1
KR_6762899140,420,-3,-65,20,-1,0,1,1,-3,4,1,2,2,4,1,2,3,-1,1,0,0,1,-1,8,-10,2,1,0,-1,1,1,-1,1,2,-1
KR_6719371210,420,3,18,16,4,0,1,1,2,0,2,2,0,2,-1,2,1,1,1,2,0,2,-25,1,-5,4,2,0,0,-1,-1,0,1,3,-1
KR_6755014793,420,-5,-23,-4,-17,-3,4,1,-9,10,1,-2,2,0,0,1,1,-3,3,0,0,-12,-8,-2,0,2,-2,0,0,0,-1,-1,-1,0,-1
KR_6690571229,440,-5,-31,-9,-17,1,1,2,-4,4,0,-3,3,0,5,0,5,-16,18,2,-1,-22,2,5,-6,1,0,0,-2,1,0,-1,-1,5,-1
KR_6762910081,420,-2,-19,0,-6,-2,4,2,-1,3,2,-2,3,1,-2,5,3,1,0,1,0,0,5,-2,-3,5,1,0,-1,-1,1,-1,-1,6,-1
KR_6748016634,420,-1,37,-17,-3,1,3,4,-6,6,0,-2,3,1,1,0,1,3,1,4,0,-8,225,-2,-1,3,4,0,-1,1,-1,-1,1,6,-1
KR_6712354885,420,-4,-136,-28,-3,0,3,3,0,6,6,3,0,3,-6,6,0,0,0,0,0,4,-12,-4,-2,6,-3,0,-1,-1,-1,-1,1,4,-1
KR_6748611250,420,-3,-70,16,-14,-3,4,1,0,2,2,-3,6,3,-2,5,3,-6,7,1,0,-11,6,0,-2,2,6,0,-2,-1,1,-1,-1,5,-1
KR_6748685938,420,-2,-37,-9,-5,2,2,4,-1,1,0,-6,8,2,-1,3,2,1,1,2,-1,-6,3,0,-4,4,0,0,-1,-1,-1,1,-1,1,-1
KR_6752119739,440,0,25,18,-4,-2,3,1,-3,5,2,2,1,3,-1,4,3,0,0,0,0,0,1,0,-4,4,-2,0,0,-1,0,1,-1,2,-1
KR_6731103188,420,-5,-37,-33,-9,-5,6,1,-3,3,0,3,0,3,-2,2,0,-2,2,0,0,-8,-9,-4,-2,6,5,0,-1,-1,-1,-1,-1,6,-1
KR_6757878158,440,-2,70,18,-6,-1,2,1,-3,4,1,2,3,5,-5,7,2,1,1,2,0,-4,5,1,-5,4,-3,0,0,1,-1,0,1,1,-1
KR_6698562864,420,-1,-23,-16,-4,0,4,4,4,0,4,-5,5,0,-2,2,0,-1,2,1,0,-4,5,6,-8,2,-8,0,-1,-1,0,-1,-1,4,-1
KR_6738975926,420,-4,-55,-4,-10,-9,10,1,2,5,7,0,4,4,-1,5,4,-2,2,0,0,0,-2,-6,0,6,3,0,0,-1,1,-1,-1,4,-1
KR_6738065745,420,-3,-83,-16,-8,-4,5,1,-1,2,1,1,1,2,-2,3,1,-2,2,0,-1,-9,0,-4,-3,7,0,0,-1,1,-1,-1,-1,2,-1
KR_6703597377,420,-1,-25,-44,-3,3,0,3,-3,4,1,1,0,1,-3,3,0,-1,1,0,0,-9,241,-3,0,3,0,0,0,1,-1,0,1,6,-1
KR_6683176544,420,-1,-112,-31,0,0,2,2,2,2,4,-1,1,0,1,3,4,-2,2,0,0,-1,-5,0,0,0,3,0,-2,-1,1,-1,-1,6,-1
KR_6729611037,420,-3,-25,-20,-7,2,0,2,-3,4,1,0,0,0,-4,6,2,-2,2,0,0,-9,7,-3,0,3,-3,0,-1,-1,1,-1,-1,4,-1
KR_6651246049,420,-5,-159,-4,-13,-5,5,0,1,1,2,-5,7,2,-3,4,1,-1,1,0,-2,-4,4,-3,-1,4,-2,0,-3,-1,-1,-1,-1,6,-1
KR_6744308617,420,-1,-46,-20,0,2,0,2,1,2,3,3,0,3,-7,7,0,1,0,1,0,-3,-1,0,-6,6,0,0,0,-1,0,0,-1,5,-1
KR_6750201819,420,-3,-76,-16,-4,1,0,1,-2,2,0,-6,7,1,6,0,6,-3,3,0,0,-6,-3,5,-6,1,-5,0,0,-1,-1,0,-1,4,-1
KR_6757312253,420,-1,36,-7,-6,-1,1,0,-1,3,2,-3,4,1,3,0,3,-4,4,0,0,0,5,4,-5,1,-2,0,1,1,-1,1,-1,3,-1
KR_6651292356,420,-3,30,10,-3,2,1,3,-5,7,2,0,3,3,-1,5,4,1,0,1,-1,-5,-8,1,-4,3,-1,0,1,0,-1,1,-1,0,-1
KR_6761006528,420,0,12,-6,-3,-1,2,1,-2,3,1,-5,6,1,3,0,3,2,0,2,-1,4,-24,-5,-1,6,7,0,0,-1,-1,-1,-1,4,-1
KR_6743534070,420,-4,-85,-15,-3,-2,3,1,-2,2,0,1,1,2,0,0,0,0,0,0,0,-2,-12,2,-4,2,-1,0,-2,-1,0,-1,-1,4,-1
KR_6750566698,420,-2,-38,-21,2,-1,1,0,-1,3,2,-4,7,3,3,2,5,5,1,6,1,7,-304,-1,-1,2,-1,0,-1,-1,-1,-1,1,4,-1
KR_6758094366,420,-3,-2,-12,-6,0,1,1,-5,5,0,-3,3,0,1,3,4,1,0,1,0,-4,4,-1,-1,2,0,0,1,-1,1,1,-1,5,-1
KR_6764222182,440,-4,-41,4,-10,3,3,6,2,0,2,-5,6,1,-10,13,3,0,0,0,0,-11,6,6,-11,5,4,0,-2,-1,0,-1,-1,1,-1
KR_6738838135,420,3,-62,8,1,-3,7,4,1,3,4,6,0,6,-3,4,1,0,0,0,1,3,-11,1,-2,1,1,0,0,-1,0,-1,1,3,-1
KR_6661103351,420,-1,-39,0,5,2,2,4,1,2,3,-4,7,3,3,3,6,3,0,3,-2,10,17,3,-3,0,1,0,0,-1,1,0,-1,1,-1
KR_6758726298,420,-6,-17,-20,-3,-1,3,2,-2,5,3,2,0,2,0,4,4,-2,2,0,0,-4,-1,2,-2,0,1,0,-1,0,0,-1,-1,0,-1
KR_6750870703,420,0,17,8,-7,-7,7,0,0,1,1,3,0,3,-1,3,2,-2,2,0,0,-3,-11,4,-6,2,2,0,-1,-1,-1,-1,-1,3,-1
KR_6762304950,440,-7,36,-60,-7,-2,6,4,1,0,1,0,0,0,0,1,1,-6,6,0,0,-4,-4,-4,0,4,1,0,0,-1,1,0,1,2,-1
KR_6745126480,420,-7,-134,16,-11,-2,2,0,0,3,3,-4,5,1,-3,3,0,-2,2,0,1,-4,57,5,-6,1,-5,0,-2,1,-1,-1,-1,1,-1
KR_6764430795,420,0,-6,-24,-4,2,1,3,0,3,3,1,2,3,-7,7,0,0,0,0,0,-10,291,-2,-3,5,1,0,-1,-1,-1,-1,-1,5,-1
KR_6758691493,420,-2,-20,-11,-7,1,0,1,-3,3,0,-6,7,1,2,0,2,-1,4,3,0,-10,-12,-2,-1,3,0,0,0,-1,1,-1,1,6,-1
KR_6742752387,420,0,-11,-16,0,-3,5,2,0,1,1,3,1,4,-1,1,0,1,0,1,0,-2,-2,0,-3,3,3,0,-1,-1,0,-1,-1,3,-1
KR_6731122774,420,-4,-44,-15,-6,-2,2,0,-1,4,3,-4,5,1,0,0,0,1,0,1,0,0,-3,-4,-1,5,1,0,0,0,1,-1,1,0,-1
KR_6752940520,420,-3,22,-36,-1,-1,2,1,1,3,4,0,2,2,-2,6,4,1,0,1,0,3,-46,-3,0,3,23,0,0,-1,-1,0,-1,6,-1
KR_6747831312,440,-1,-12,-24,1,-5,6,1,-1,1,0,4,0,4,1,0,1,2,3,5,0,-1,-3,2,-2,0,-1,0,0,1,1,-1,1,2,-1
KR_6694127373,420,-3,-53,8,-14,1,1,2,-2,2,0,-3,6,3,-2,3,1,-8,9,1,-2,-15,-13,-2,-3,5,3,0,-2,-1,-1,-1,-1,3,-1
KR_6745981812,420,-3,-1,8,-6,-1,4,3,-2,2,0,-3,4,1,1,1,2,-1,3,2,0,-9,0,-1,-1,2,0,0,-3,-1,-1,-1,-1,5,-1
KR_6671024000,420,-9,-161,-20,-28,-10,10,0,-2,5,3,-5,7,2,-9,9,0,-2,4,2,0,-23,-9,-5,0,5,4,0,-2,-1,-1,-1,-1,2,-1
KR_6715297602,420,2,-24,-16,7,3,0,3,2,2,4,1,3,4,5,6,11,-4,4,0,-1,9,303,0,-1,1,3,0,1,1,-1,1,-1,3,-1
KR_6757742577,420,1,-14,-24,-1,3,0,3,-1,3,2,3,1,4,-7,8,1,1,2,3,0,1,-118,-1,-2,3,2,0,-1,-1,-1,-1,1,2,-1
KR_6753014365,440,-5,-72,-20,-17,-4,5,1,-3,5,2,-2,4,2,-6,10,4,-2,2,0,1,-14,-4,-4,-1,5,-2,0,-1,0,0,-1,1,0,-1
KR_6704234931,420,-3,-31,-35,-7,-2,3,1,-3,7,4,1,1,2,-2,4,2,-1,1,0,0,-9,0,1,-3,2,0,0,0,0,0,0,1,0,-1
KR_6743070603,420,-3,-85,8,-8,-1,3,2,2,2,4,-7,9,2,-1,1,0,-1,3,2,0,1,19,-2,0,2,-1,0,-1,-1,-1,-1,-1,1,-1
KR_6757293044,420,-1,44,-32,-7,0,3,3,-6,6,0,0,2,2,0,2,2,-1,2,1,0,-3,-9,-1,-2,3,1,0,-1,-1,-1,-1,-1,6,-1
KR_6753918843,420,-4,-15,-15,-11,-3,4,1,-3,3,0,-1,3,2,-3,7,4,-1,1,0,-1,-9,-3,-1,-1,2,-1,0,-2,-1,-1,-1,-1,3,-1
KR_6749895299,420,-5,-18,-30,-19,-4,6,2,-2,2,0,-13,13,0,1,2,3,-1,1,0,0,-13,21,-1,-3,4,1,0,-2,-1,-1,-1,-1,4,-1
KR_6683344124,420,2,-26,-10,-3,-1,6,5,1,3,4,-5,5,0,2,5,7,0,0,0,-2,8,-33,-2,-3,5,1,0,-3,-1,-1,-1,-1,2,-1
KR_6754887759,420,-8,-116,-60,-22,-6,7,1,-9,9,0,1,1,2,-3,3,0,-5,5,0,0,-10,-15,-6,0,6,1,0,-2,0,0,-1,-1,0,-1
KR_6753522814,420,0,-49,7,1,0,2,2,-3,4,1,4,0,4,1,3,4,-1,1,0,2,-2,23,0,-3,3,-2,0,-2,-1,0,-1,1,5,-1
KR_6760849443,440,-1,-20,0,-5,1,1,2,0,0,0,-1,2,1,-7,9,2,2,0,2,0,-9,29,1,-4,3,-22,0,-1,0,1,-1,1,0,-1
KR_6758232976,420,-3,-49,0,-2,2,0,2,-1,2,1,1,1,2,-4,5,1,0,1,1,0,2,205,-3,-2,5,4,0,0,1,1,0,1,2,-1
KR_6706728485,420,-4,-52,12,-4,-3,3,0,0,3,3,0,0,0,2,6,8,-3,4,1,0,-6,-202,-2,-4,6,-1,0,-3,1,0,-1,1,6,-1
KR_6757510357,440,0,30,-8,2,-1,2,1,-4,4,0,-2,5,3,10,1,11,-1,2,1,0,-2,52,0,-3,3,-29,0,0,1,1,0,1,3,-1
KR_6746796137,420,-11,-98,-24,-22,-7,8,1,4,0,4,0,0,0,-1,1,0,-18,18,0,0,-14,338,2,-3,1,-3,-1,-3,-1,1,-1,-1,6,-1
KR_6752690007,420,-2,-112,4,-9,2,1,3,-2,4,2,-2,2,0,-1,3,2,-6,6,0,1,-8,4,-2,0,2,-2,0,0,-1,1,1,1,1,-1
KR_6752932948,420,-2,-50,4,-9,-3,3,0,-2,3,1,-2,2,0,-2,4,2,0,0,0,0,-4,22,2,-7,5,-5,0,0,-1,1,0,-1,4,-1
KR_6743502568,420,4,-28,-11,7,0,0,0,2,0,2,0,1,1,5,2,7,0,2,2,0,8,-21,0,-4,4,3,0,0,-1,-1,0,1,2,-1
KR_6761141229,420,-5,-46,-12,-13,-3,4,1,-2,2,0,-6,6,0,-1,2,1,-1,5,4,-2,-10,2,-7,0,7,-4,0,-1,-1,-1,-1,-1,5,-1
KR_6683100623,420,-3,-32,-8,-5,1,3,4,-4,5,1,3,2,5,-4,5,1,-1,2,1,1,-8,1,1,-2,1,-1,0,0,1,1,-1,1,3,-1
KR_6718246457,420,-1,-36,8,0,5,1,6,0,4,4,0,2,2,-4,4,0,-1,1,0,0,-5,-3,0,-2,2,0,0,1,-1,1,1,1,4,-1
KR_6728386211,420,-4,-58,-36,-1,-2,4,2,0,2,2,-1,6,5,1,1,2,1,0,1,0,3,-4,0,-2,2,2,0,0,0,-1,-1,1,0,-1
KR_6715292799,420,-6,-99,-48,-14,-5,7,2,-3,4,1,-6,6,0,-2,6,4,2,0,2,-1,-9,2,0,-2,2,-5,0,-1,-1,0,-1,-1,1,-1
KR_6758630667,420,-2,36,-20,-3,-1,3,2,-6,7,1,-3,4,1,5,0,5,2,0,2,0,1,-34,1,-5,4,26,0,1,1,-1,1,1,6,-1
KR_6707576457,420,-2,-8,24,-6,5,0,5,-3,4,1,-6,9,3,-3,4,1,1,0,1,0,-6,-314,1,-4,3,-1,0,0,-1,1,1,1,5,-1
KR_6708832414,420,-1,18,-16,-9,2,2,4,-3,4,1,0,2,2,-6,8,2,-2,3,1,0,-9,34,2,-2,0,-20,0,-1,0,-1,-1,1,0,-1
KR_6733995902,420,-4,-72,0,-10,0,3,3,1,1,2,-5,5,0,-4,4,0,-2,4,2,-1,-6,-7,-3,-1,4,-2,0,1,-1,1,1,-1,4,-1
KR_6762386654,420,1,-28,3,-6,-4,5,1,-1,1,0,3,1,4,-1,2,1,-3,3,0,-2,-10,-3,0,-4,4,-1,0,-2,1,-1,-1,-1,2,-1
KR_6657310097,420,-4,-105,-16,-4,2,0,2,1,2,3,-3,5,2,-1,3,2,-3,6,3,-2,1,-2,-1,-3,4,3,0,-1,0,-1,-1,-1,0,-1
KR_6705180954,420,-1,16,-2,0,0,2,2,0,4,4,0,3,3,2,0,2,-2,2,0,0,-7,-11,-2,-1,3,1,0,-1,-1,-1,1,1,4,-1
KR_6731995232,420,0,-22,20,-5,2,1,3,0,1,1,-1,3,2,-6,6,0,0,0,0,0,-4,31,4,-6,2,-1,0,0,0,-1,0,-1,0,-1
KR_6753052283,420,-2,-79,-20,-8,-5,8,3,4,3,7,-4,4,0,-3,5,2,0,0,0,0,-5,-3,-2,-3,5,-4,0,0,-1,-1,-1,-1,3,-1
KR_6676396677,420,-2,-34,-8,-9,-8,9,1,-6,7,1,0,1,1,4,4,8,1,0,1,0,-2,-359,-5,-2,7,0,0,-1,-1,-1,-1,1,1,-1
KR_6744575277,420,-6,-78,24,-18,-1,3,2,1,4,5,-10,10,0,-2,4,2,-6,7,1,-1,-4,299,-4,0,4,1,0,-3,-1,-1,-1,-1,5,-1
KR_6738068671,420,4,52,-29,5,2,2,4,-2,3,1,0,6,6,6,2,8,-1,2,1,0,6,-72,-3,-4,7,7,0,1,-1,-1,1,-1,5,-1
KR_6733411170,420,-2,30,-8,-8,-2,4,2,-2,3,1,1,3,4,-5,5,0,0,1,1,1,-10,-217,2,-2,0,-18,0,0,1,-1,1,1,4,-1
KR_6759593126,420,-6,-62,12,-18,-5,5,0,3,2,5,-3,4,1,-5,7,2,-8,9,1,1,-14,3,-1,-1,2,0,0,-1,0,1,-1,1,0,-1
KR_6722611036,440,-5,-52,-31,-7,-2,4,2,-2,3,1,2,2,4,-5,5,0,0,1,1,0,-9,-5,-3,-1,4,-5,0,-2,-1,0,-1,-1,1,-1
KR_6713847886,420,-5,-20,-48,-3,-1,2,1,-2,3,1,2,2,4,-1,1,0,-1,1,0,0,-4,-3,0,-3,3,-1,0,-1,0,1,-1,1,0,-1
KR_6694392640,420,-7,-72,-47,-11,-3,3,0,-6,6,0,-1,3,2,0,0,0,-1,1,0,-4,-20,2,4,-4,0,-2,0,-1,-1,-1,-1,-1,4,-1
KR_6717462950,420,-2,-66,5,-6,0,1,1,-1,4,3,-2,5,3,-2,2,0,-1,3,2,0,4,-25,2,-3,1,0,0,0,1,0,-1,-1,1,-1
KR_6739624044,420,-3,11,20,-3,-1,3,2,2,1,3,1,2,3,-5,6,1,0,1,1,0,-2,3,-3,-2,5,1,0,0,-1,-1,0,1,2,-1
KR_6742739843,420,-2,11,-16,-3,-1,4,3,-4,4,0,-4,6,2,6,1,7,0,0,0,0,-8,-4,-1,-3,4,-4,0,0,1,-1,-1,1,4,-1
KR_6745326698,420,-4,-32,-5,-6,-5,6,1,-1,1,0,0,1,1,2,3,5,-2,3,1,1,-4,22,-1,-3,4,1,0,-1,0,-1,-1,1,0,-1
KR_6760013613,420,-3,-55,-27,-9,-7,9,2,1,3,4,-4,5,1,0,5,5,1,0,1,0,0,-6,3,-3,0,4,0,-2,0,1,-1,-1,0,-1
KR_6762021565,420,0,54,0,-1,4,0,4,-4,7,3,-2,2,0,2,5,7,-1,1,0,0,2,-297,-6,0,6,3,0,0,1,-1,1,-1,4,-1
KR_6760382615,420,-2,-16,-13,-9,2,0,2,-1,1,0,-2,3,1,-12,14,2,4,0,4,-1,-3,125,0,-2,2,1,0,0,-1,0,-1,-1,3,-1
KR_6762736762,420,0,-26,-16,1,0,2,2,1,1,2,3,1,4,-1,4,3,-2,4,2,0,-1,4,5,-7,2,-3,0,-1,0,-1,-1,-1,0,-1
KR_6754500218,420,0,-37,8,-3,2,1,3,2,0,2,-1,2,1,-6,7,1,0,1,1,0,-2,80,-2,-1,3,5,0,-1,-1,1,1,1,3,-1
KR_6727692232,420,-1,1,7,-7,0,1,1,-2,2,0,-3,4,1,-1,3,2,-1,2,1,1,-8,15,-5,-1,6,2,0,0,-1,-1,0,1,2,-1
KR_6746111905,420,-2,-22,6,-4,1,2,3,-3,5,2,1,1,2,-3,5,2,0,0,0,0,-5,28,0,-3,3,-2,0,-1,1,-1,-1,1,6,-1
KR_6762413463,420,-8,-113,-23,-12,-3,6,3,-3,5,2,-3,3,0,0,5,5,-3,4,1,0,-4,22,1,-3,2,-7,0,-3,-1,0,-1,1,5,-1
KR_6733723107,420,-2,-34,12,-4,1,1,2,0,2,2,-6,7,1,1,2,3,0,1,1,0,2,9,2,-7,5,-6,0,0,0,0,0,-1,0,-1
KR_6703959297,420,-2,-36,-10,-9,-1,2,1,1,4,5,1,3,4,-9,11,2,-1,1,0,1,0,-5,-1,0,1,1,0,-1,1,-1,-1,1,4,-1
KR_6724479681,420,3,22,12,0,-1,2,1,-1,4,3,8,0,8,-3,4,1,-3,3,0,-2,-8,-3,-4,-1,5,-1,0,1,1,-1,1,-1,4,-1
KR_6644318974,420,2,69,-24,-2,-3,7,4,1,2,3,-2,3,1,1,1,2,1,0,1,0,-5,-2,2,-3,1,1,0,-1,-1,-1,-1,-1,2,-1
KR_6705166501,420,-2,-36,-24,-8,-5,7,2,-2,3,1,-1,3,2,1,5,6,-1,1,0,1,4,-3,-3,0,3,-1,0,-1,1,-1,-1,1,4,-1
KR_6751773947,420,0,6,-42,0,0,1,1,-4,4,0,3,2,5,-2,5,3,3,1,4,-1,-6,5,-2,-1,3,2,0,0,0,-1,0,-1,0,-1
KR_6631549983,420,-1,-23,48,-3,-1,1,0,1,2,3,1,0,1,-2,2,0,-2,2,0,0,-5,-5,-1,-1,2,-3,0,-2,-1,-1,-1,-1,6,-1
KR_6717390144,420,-1,-48,-1,-5,2,1,3,-2,2,0,-4,5,1,-2,3,1,1,0,1,-1,-6,6,-6,0,6,0,0,-2,-1,0,-1,-1,1,-1
KR_6755515251,420,-1,-87,8,-3,-1,2,1,-5,6,1,4,2,6,-1,1,0,0,1,1,1,-8,-65,-4,-3,7,19,0,0,-1,1,0,1,3,-1
KR_6651227735,420,-2,-15,12,-10,-6,6,0,-2,4,2,-2,5,3,0,2,2,0,0,0,0,-6,-8,-3,-4,7,1,0,-1,0,-1,-1,-1,0,-1
KR_6742679840,420,2,-8,20,-3,-4,4,0,3,4,7,2,5,7,-1,1,0,-3,5,2,1,-2,132,0,-2,2,-4,0,0,1,-1,0,1,6,-1
KR_6705637724,420,1,38,24,-5,1,0,1,1,1,2,0,1,1,-2,3,1,-5,5,0,0,-6,-1,-1,-3,4,-2,0,-1,-1,0,-1,-1,6,-1
KR_6742600279,420,-2,-19,-28,-12,-1,1,0,-4,5,1,1,1,2,-7,9,2,-1,1,0,-2,-17,-20,-7,-3,10,-2,0,0,1,-1,-1,-1,1,-1
KR_6760903689,440,3,29,-14,0,0,2,2,1,0,1,-3,5,2,1,2,3,1,0,1,0,0,31,-4,-3,7,4,0,0,-1,0,-1,1,3,-1
KR_6753003534,420,-2,-91,-18,-10,0,1,1,-3,5,2,-8,8,0,2,3,5,-1,1,0,0,-5,-14,-2,-2,4,-1,0,0,-1,0,-1,-1,2,-1
KR_6686935132,420,-2,-38,3,-5,2,2,4,3,0,3,-6,6,0,-2,5,3,-2,2,0,0,-3,-6,-4,-1,5,1,0,-1,-1,1,-1,1,1,-1
KR_6697284455,420,-3,-5,-12,-1,0,1,1,1,3,4,6,1,7,-4,5,1,-4,4,0,1,1,-1,-3,-1,4,0,0,0,-1,0,0,1,6,-1
KR_6759569891,440,0,45,20,-1,-7,8,1,0,1,1,3,2,5,5,1,6,-2,3,1,1,-7,0,-1,0,1,0,0,0,1,1,1,1,6,-1
KR_6694570947,420,-2,18,-22,-6,0,1,1,-9,10,1,1,0,1,0,3,3,2,0,2,0,-4,155,0,-2,2,0,0,-1,1,-1,-1,-1,2,-1
KR_6762510801,420,3,38,20,9,0,2,2,-2,3,1,7,1,8,3,2,5,1,1,2,0,3,310,-2,0,2,2,0,0,1,1,1,-1,6,-1
KR_6677356575,420,-1,-42,-19,-1,0,1,1,-3,5,2,-1,2,1,2,2,4,1,4,5,0,2,-2,-4,0,4,0,0,1,1,-1,1,-1,4,-1
KR_6685994628,420,4,69,33,8,5,0,5,-1,6,5,3,1,4,2,4,6,-1,1,0,1,-5,6,1,-7,6,-3,0,0,1,-1,1,1,2,-1
KR_6712502141,420,-6,-34,-16,-13,-3,3,0,-1,1,0,-4,5,1,1,1,2,-6,6,0,0,-10,-1,-2,-4,6,1,0,0,1,-1,-1,-1,4,-1
KR_6761057653,440,0,42,-28,-7,4,0,4,-4,5,1,1,0,1,-8,12,4,0,1,1,0,-2,26,2,-3,1,-14,0,-2,-1,-1,-1,1,2,-1
KR_6724840223,420,-1,-67,4,-1,-1,2,1,3,2,5,-2,3,1,3,0,3,-4,5,1,0,1,177,0,-5,5,23,0,-1,1,0,-1,1,4,-1
KR_6754858184,420,0,63,-1,-11,-4,5,1,-3,3,0,0,1,1,-2,3,1,-2,2,0,-1,-7,13,3,-5,2,-1,0,1,0,0,1,-1,0,-1
KR_6751676913,420,-1,-13,3,-1,-1,4,3,2,4,6,3,5,8,1,7,8,-6,9,3,3,5,2,-2,-2,4,0,0,0,1,0,1,1,5,-1
KR_6679274177,420,1,46,0,3,4,0,4,-1,3,2,-1,1,0,-2,3,1,3,0,3,1,6,3,-2,-5,7,-1,0,0,0,-1,1,1,0,-1
KR_6677798881,420,-1,3,-12,-16,-3,5,2,-7,7,0,1,1,2,-4,6,2,-3,3,0,-2,-24,21,-2,-2,4,-4,0,1,-1,-1,1,-1,6,-1
KR_6704874123,440,-4,-40,-18,1,0,4,4,-1,2,1,2,1,3,3,5,8,-3,3,0,1,3,2,-2,-1,3,0,0,0,0,1,-1,1,0,-1
KR_6723242796,420,-2,-134,18,-10,1,2,3,-7,10,3,-3,3,0,-4,6,2,3,1,4,0,-1,-27,-1,-2,3,-2,0,-2,1,1,-1,-1,1,-1
KR_6643716093,420,1,-33,-15,0,4,2,6,0,1,1,5,0,5,-3,3,0,-6,7,1,-1,-5,0,0,-1,1,-1,0,0,-1,0,-1,-1,6,-1
KR_6762210452,420,1,39,-4,-3,-5,6,1,1,2,3,4,1,5,-1,3,2,-2,2,0,-1,-2,-3,0,-2,2,2,0,-1,1,1,-1,-1,1,-1
KR_6720564974,440,-5,-80,-17,-6,-1,1,0,-6,6,0,-2,2,0,1,4,5,2,1,3,0,-9,-3,-1,0,1,0,0,-1,-1,-1,-1,-1,1,-1
KR_6718992717,420,3,-15,-5,4,-1,2,1,-3,4,1,5,0,5,5,3,8,-2,3,1,0,4,7,-2,0,2,0,0,0,0,-1,1,1,0,-1
KR_6742343851,420,-5,-52,-52,-8,-1,2,1,-2,2,0,-4,6,2,0,6,6,-1,2,1,-1,-5,-4,-4,-3,7,0,0,-1,-1,-1,-1,-1,4,-1
KR_6751637661,420,1,60,-12,-4,-2,2,0,-2,2,0,-1,2,1,-2,3,1,3,0,3,0,-5,-170,1,-3,2,3,0,0,0,-1,1,1,0,-1
KR_6741308750,420,0,7,31,1,1,1,2,0,2,2,0,2,2,0,4,4,0,3,3,0,3,-5,1,-1,0,0,0,0,1,1,-1,-1,3,-1
KR_6762979013,420,0,34,-9,-2,-1,3,2,-2,3,1,-2,5,3,3,2,5,0,0,0,0,0,15,7,-9,2,-4,0,0,-1,-1,-1,-1,6,-1
KR_6750282052,420,0,5,11,1,2,0,2,-3,3,0,0,3,3,1,1,2,1,0,1,1,6,17,0,-1,1,-1,0,0,-1,-1,0,1,1,-1
KR_6763447169,420,1,-9,12,0,-2,2,0,1,2,3,4,0,4,-1,3,2,-2,2,0,-1,-1,-6,-4,-2,6,3,0,2,-1,1,1,-1,6,-1
KR_6762126068,420,-4,28,-7,-13,0,1,1,-2,4,2,-6,8,2,-2,2,0,-3,3,0,0,-12,-11,-2,-1,3,0,0,-1,-1,1,-1,-1,5,-1
KR_6734863847,420,-1,-34,-28,-4,-3,3,0,0,1,1,2,2,4,-3,3,0,0,0,0,0,0,1,2,-7,5,-3,0,-1,-1,-1,-1,-1,4,-1
KR_6718630547,420,-5,-78,-17,-11,-6,8,2,-3,3,0,-1,2,1,-4,5,1,3,0,3,-1,-3,34,-5,0,5,5,0,-3,-1,-1,-1,-1,5,-1
KR_6762770650,420,-1,-27,36,-3,-1,6,5,2,0,2,-1,2,1,-3,4,1,0,1,1,0,-6,-266,-2,-1,3,0,0,-1,0,1,-1,-1,0,-1
KR_6742018634,420,-2,-54,-13,-1,3,0,3,0,1,1,-2,5,3,-2,3,1,0,1,1,0,-5,-520,4,-4,0,11,0,-1,-1,1,-1,1,1,-1
KR_6729774830,420,-5,-82,16,-11,-4,6,2,-1,2,1,-6,6,0,0,2,2,0,1,1,1,-13,-9,-4,-2,6,1,0,0,1,-1,-1,1,3,-1
KR_6729799252,440,4,27,17,7,4,0,4,2,4,6,0,3,3,-1,3,2,2,0,2,0,7,-6,-1,-1,2,0,0,2,-1,1,1,1,2,-1
KR_6732531413,420,-3,-111,-52,-6,-8,12,4,-1,1,0,0,1,1,2,0,2,1,0,1,-1,2,55,1,-5,4,3,0,-2,1,-1,-1,-1,6,-1
KR_6703928506,420,3,18,11,1,1,2,3,-4,6,2,4,0,4,5,3,8,-5,6,1,0,-2,4,-2,-3,5,0,0,0,1,1,1,-1,1,-1
KR_6706626431,420,-1,-45,-20,-1,-4,5,1,-1,2,1,-1,5,4,4,0,4,1,0,1,0,1,-42,1,-2,1,25,0,1,-1,-1,1,-1,6,-1
KR_6729565306,420,-2,-10,-24,-2,1,1,2,1,1,2,-5,6,1,-1,2,1,2,0,2,0,-2,-21,-1,-2,3,2,0,0,-1,1,0,1,4,-1
KR_6702763232,420,1,-37,15,6,3,0,3,1,2,3,0,2,2,1,2,3,1,0,1,1,2,-183,0,-1,1,2,0,0,1,1,0,1,1,-1
KR_6727903292,420,-1,-60,-29,-3,-4,4,0,-1,1,0,4,0,4,-2,2,0,0,0,0,0,-4,-18,-1,-2,3,-1,0,0,0,-1,1,-1,0,-1
KR_6730563620,420,0,15,16,-6,0,1,1,-4,4,0,-5,5,0,1,2,3,2,0,2,0,-7,-6,-2,-1,3,2,0,0,-1,-1,-1,-1,1,-1
KR_6728920208,420,-2,-33,-4,-5,2,2,4,4,1,5,-10,10,0,0,2,2,-1,2,1,0,-3,-25,-4,-1,5,-2,0,-1,-1,0,-1,-1,1,-1
KR_6354428636,420,-2,-39,-4,-6,4,0,4,-5,5,0,0,2,2,-4,6,2,-1,2,1,-1,-6,0,0,0,0,-1,0,-1,-1,1,-1,-1,4,-1
KR_6736664944,420,-3,-119,-12,-9,-4,4,0,1,3,4,-3,4,1,-3,6,3,0,0,0,-1,-9,-3,-2,-1,3,3,0,-1,1,-1,-1,-1,6,-1
KR_6713630704,420,-4,-72,-32,-8,1,1,2,-10,10,0,0,2,2,-1,4,3,2,0,2,0,-14,-32,-7,-2,9,-2,0,-1,0,-1,-1,-1,0,-1
KR_6758863157,420,-1,32,-2,-8,1,1,2,-8,8,0,3,0,3,-4,5,1,0,1,1,0,-6,-50,-7,-1,8,33,0,-1,-1,0,-1,-1,2,-1
KR_6759492099,440,0,20,-9,2,0,2,2,0,2,2,3,0,3,-1,3,2,0,0,0,0,-2,-7,-6,0,6,1,0,-1,-1,-1,-1,1,3,-1
KR_6759165201,420,1,54,8,-2,-2,2,0,6,0,6,-3,5,2,-2,3,1,-1,1,0,0,-1,-4,-3,-1,4,-3,0,-1,1,-1,-1,1,5,-1
KR_6702947029,440,-5,-34,-1,-17,0,1,1,-1,4,3,-4,6,2,-6,8,2,-6,8,2,-1,-14,15,1,-4,3,-1,0,-2,-1,1,-1,-1,4,-1
KR_6732677199,420,1,-11,4,8,1,1,2,4,1,5,-2,3,1,4,1,5,1,0,1,0,7,273,2,-4,2,1,0,-1,-1,1,-1,-1,1,-1
KR_6725226172,420,-3,-8,-31,-11,-1,2,1,-4,4,0,-4,4,0,-1,2,1,-1,1,0,-1,-6,-36,0,-4,4,20,0,1,1,-1,1,-1,3,-1
KR_6649808452,420,-1,-99,-4,2,7,3,10,-3,6,3,-1,1,0,0,1,1,-1,1,0,0,1,2,2,-4,2,-4,0,-1,1,-1,-1,1,2,-1
KR_6736315397,420,-3,-50,-20,-3,0,0,0,-2,2,0,-1,6,5,-1,1,0,1,0,1,1,2,-263,1,-1,0,1,0,0,-1,-1,0,1,5,-1
KR_6757901099,420,-6,-124,1,-8,-5,6,1,-2,3,1,0,1,1,1,0,1,-2,2,0,0,-3,6,1,-1,0,-2,0,-1,1,-1,-1,1,4,-1
KR_6744268076,420,-1,-71,25,-8,-2,4,2,-2,3,1,-3,3,0,-2,2,0,1,0,1,-1,-7,20,-2,-2,4,1,0,-1,0,-1,-1,-1,0,-1
KR_6688732679,420,1,41,-20,0,1,0,1,2,1,3,-2,3,1,2,0,2,-3,4,1,0,-1,-120,1,-3,2,-4,0,1,0,1,1,1,0,-1
KR_6712689371,420,-4,9,-5,0,-1,2,1,-2,5,3,3,1,4,1,2,3,-1,1,0,0,-2,13,-2,0,2,2,0,0,-1,-1,0,-1,6,-1
KR_6739165706,420,4,-31,0,9,4,0,4,3,1,4,0,2,2,-1,1,0,3,0,3,0,0,-12,2,-2,0,0,0,1,0,-1,1,1,0,-1
KR_6762843520,420,-2,-24,-28,-4,-5,6,1,-6,7,1,1,1,2,4,1,5,2,1,3,0,-9,15,0,-6,6,-5,0,0,1,-1,-1,-1,1,-1
KR_6745922658,420,2,-54,4,2,2,0,2,-2,3,1,1,3,4,2,0,2,-1,2,1,0,4,-12,1,-3,2,0,0,0,0,0,0,-1,0,-1
KR_6738232697,420,-2,-63,-16,-7,-3,4,1,4,1,5,-3,5,2,-3,4,1,-2,4,2,-1,-10,2,2,-3,1,-1,0,-2,0,1,-1,-1,0,-1
KR_6741927759,420,-5,-109,-4,-3,-4,4,0,3,3,6,-4,5,1,3,1,4,-1,1,0,0,1,35,-1,-4,5,-16,0,-1,0,-1,-1,-1,0,-1
KR_6726574316,420,-3,-106,-20,-11,-3,5,2,-2,2,0,-5,5,0,0,1,1,-1,1,0,-1,-5,-11,-3,-2,5,3,0,-1,-1,-1,-1,-1,4,-1
KR_6653048360,420,-5,-52,-96,-6,-2,2,0,0,2,2,0,1,1,-3,5,2,-1,1,0,0,-6,8,0,-4,4,-6,0,-1,-1,-1,-1,-1,5,-1
KR_6744742133,440,2,-43,44,7,-1,4,3,7,1,8,0,2,2,1,1,2,0,2,2,1,10,-5,-1,-3,4,0,0,0,1,1,1,1,3,-1
KR_6639818491,420,-5,-85,-4,-15,1,1,2,1,1,2,-6,7,1,-8,8,0,-3,3,0,0,-11,-5,-1,-1,2,-2,0,-2,1,1,-1,-1,4,-1
KR_6747101390,420,2,-5,5,4,-7,8,1,5,1,6,4,0,4,4,0,4,-2,2,0,-1,8,8,1,-5,4,-2,0,0,1,0,-1,-1,6,-1
KR_6705687055,420,2,80,28,6,0,2,2,3,0,3,1,2,3,2,0,2,0,0,0,0,18,-1,-4,-2,6,5,0,0,1,-1,-1,-1,3,-1
KR_6763763198,420,-5,-64,-31,-13,1,2,3,-4,7,3,-8,9,1,-1,1,0,-1,2,1,0,-12,-6,-2,-2,4,-2,0,-2,1,-1,-1,-1,4,-1
KR_6686610477,420,-2,-22,-35,1,3,0,3,1,2,3,0,2,2,-3,4,1,0,2,2,1,-3,-6,1,-3,2,-1,0,0,1,0,-1,1,6,-1
KR_6705153058,420,0,12,0,0,-2,4,2,0,5,5,0,1,1,-2,4,2,4,0,4,0,1,-116,4,-5,1,0,0,0,0,0,0,1,0,-1
KR_6706578508,420,-3,-38,-4,-5,-3,5,2,-1,3,2,-2,3,1,0,0,0,1,0,1,0,-2,-18,-4,0,4,2,0,-1,0,-1,-1,-1,0,-1
KR_6758534092,420,1,25,-16,1,2,1,3,1,1,2,0,1,1,-2,2,0,0,1,1,0,-4,34,2,-4,2,-5,0,0,-1,1,0,1,6,-1
KR_6724368749,440,1,-26,-20,3,4,0,4,7,1,8,1,0,1,-6,6,0,-3,4,1,0,2,-15,-1,-1,2,0,0,0,0,1,1,1,0,-1
KR_6656468131,420,0,-16,19,5,-3,5,2,1,3,4,0,1,1,5,0,5,2,1,3,0,7,-3,-2,-1,3,5,0,-1,1,1,-1,1,2,-1
KR_6654723983,420,-1,39,-19,-8,1,0,1,1,1,2,1,0,1,-10,11,1,-1,1,0,0,-9,20,0,-4,4,-4,0,-1,-1,1,-1,-1,3,-1
KR_6744236416,420,1,14,-12,2,-4,5,1,0,2,2,-2,4,2,4,4,8,4,0,4,0,3,3,-1,-1,2,0,0,1,-1,0,1,1,6,-1
KR_6727641741,420,0,22,20,-3,0,2,2,0,3,3,2,2,4,-7,9,2,2,0,2,0,-6,-6,-5,-1,6,3,0,0,-1,-1,1,1,6,-1
KR_6746267878,420,1,-31,2,1,-1,2,1,6,0,6,-1,1,0,-2,2,0,-1,1,0,-1,-1,-267,-4,-1,5,0,0,0,-1,-1,0,-1,3,-1
KR_6645934437,420,4,48,-7,6,1,0,1,1,4,5,0,2,2,-1,2,1,5,0,5,1,14,-7,0,-5,5,0,0,1,0,1,1,1,0,-1
KR_6762681468,420,2,-2,-8,6,1,2,3,1,4,5,5,0,5,0,0,0,-1,2,1,0,0,-25,0,-2,2,2,0,0,-1,1,0,-1,1,-1
KR_6761168378,420,2,5,8,5,-2,3,1,2,3,5,4,2,6,2,2,4,-1,2,1,0,-3,-19,-2,0,2,2,0,0,1,1,0,1,5,-1
KR_6737628240,420,0,24,8,3,-1,1,0,-1,2,1,9,0,9,-4,6,2,0,0,0,0,-6,-8,-1,-3,4,-2,0,0,-1,1,-1,1,1,-1
KR_6728071999,420,-1,9,8,-8,-1,2,1,0,2,2,-3,3,0,-4,5,1,0,1,1,-1,-11,-121,-4,0,4,3,0,-1,1,-1,-1,-1,4,-1
KR_6763097512,420,-2,26,-4,2,-1,1,0,-2,2,0,1,4,5,4,1,5,0,0,0,0,6,-7,5,-5,0,-2,0,0,1,0,0,1,1,-1
KR_6758005501,420,0,-21,-2,1,-4,5,1,2,3,5,-1,2,1,-2,5,3,6,1,7,0,5,-2,-6,0,6,2,0,-1,1,-1,-1,1,6,-1
KR_6752994679,420,1,-31,4,4,1,0,1,2,4,6,2,1,3,0,2,2,-1,1,0,-1,4,1,1,-2,1,1,0,-1,-1,0,-1,-1,5,-1
KR_6755448704,440,0,30,-16,5,0,2,2,0,1,1,-3,4,1,8,0,8,0,1,1,0,3,0,2,-4,2,-2,0,0,1,0,0,-1,5,-1
KR_6751753950,420,-4,-118,-12,-6,-5,7,2,0,1,1,2,0,2,3,5,8,-6,7,1,-1,0,-10,-1,-4,5,1,0,-1,-1,1,-1,-1,3,-1
KR_6687380297,440,3,27,-12,3,-3,3,0,-1,3,2,1,0,1,3,0,3,3,0,3,0,1,-4,-5,-1,6,5,0,1,1,0,1,1,3,-1
KR_6731117535,420,1,-29,-28,4,3,1,4,-3,3,0,1,1,2,0,3,3,3,0,3,0,5,-9,-1,-2,3,4,0,0,0,-1,0,1,0,-1
KR_6729186195,420,-4,-52,-16,-5,0,0,0,-1,1,0,0,1,1,0,2,2,-4,5,1,0,0,6,0,-4,4,-4,0,0,-1,1,0,-1,4,-1
KR_6732546870,420,-4,3,-38,-9,-9,9,0,-3,4,1,2,1,3,1,1,2,0,0,0,0,-6,-11,-2,-3,5,6,0,-1,-1,-1,-1,-1,3,-1
KR_6667227877,420,-1,-49,21,-5,4,0,4,-1,4,3,-9,10,1,2,1,3,-1,1,0,0,-2,-6,-1,-2,3,-1,0,-1,-1,-1,-1,-1,5,-1
KR_6696678571,420,-6,-101,-23,-20,-2,3,1,-8,8,0,-3,6,3,-4,4,0,-3,5,2,0,-17,-33,3,-5,2,-4,0,-2,-1,-1,-1,-1,3,-1
KR_6731469507,420,-2,-23,-20,0,1,0,1,0,1,1,-3,3,0,0,1,1,2,0,2,0,2,22,6,-7,1,-1,0,0,1,-1,0,-1,3,-1
KR_6658214891,420,-5,-130,0,-17,-9,9,0,-4,4,0,0,1,1,-5,6,1,1,0,1,0,-9,-6,-7,-3,10,2,0,-2,-1,-1,-1,1,6,-1
KR_6684432626,420,4,44,-43,6,2,0,2,1,0,1,5,0,5,-2,3,1,0,0,0,0,1,-1,-1,-1,2,1,0,1,-1,0,1,-1,3,-1
KR_6726492643,420,-1,-55,0,-4,-1,4,3,-6,7,1,2,3,5,1,4,5,0,0,0,0,4,287,7,-8,1,-7,0,0,1,1,0,-1,6,-1
KR_6703080961,420,-8,4,-99,-8,0,2,2,-3,3,0,-5,7,2,0,3,3,0,2,2,0,-1,-135,3,-3,0,-1,0,-2,-1,1,1,1,4,-1
KR_6749941660,420,-7,-42,-17,-7,0,3,3,-6,9,3,0,2,2,-2,3,1,1,1,2,0,-5,-99,1,-2,1,-1,0,0,-1,-1,-1,-1,4,-1
KR_6760049823,420,-4,35,-76,-14,1,0,1,1,2,3,-6,6,0,-9,10,1,-1,2,1,0,-8,-284,1,-3,2,-3,0,-1,0,1,1,-1,0,-1
KR_6744606603,420,-1,23,-12,-6,1,2,3,0,3,3,-3,6,3,3,3,6,-7,8,1,-1,-21,-8,-1,0,1,0,0,0,1,-1,1,-1,2,-1
KR_6701417924,420,1,-69,8,-1,0,1,1,2,1,3,-1,3,2,-2,3,1,0,1,1,-1,-2,0,-4,-2,6,-2,0,0,1,1,0,-1,4,-1
KR_6629420240,440,-2,-38,-16,-2,1,1,2,-2,3,1,1,4,5,-1,2,1,-1,3,2,-1,-9,-42,-2,-2,4,20,0,-1,-1,0,-1,-1,5,-1
KR_6724680948,440,-3,-31,20,-14,-4,7,3,-1,2,1,-6,7,1,-1,2,1,-2,2,0,0,-9,4,0,-3,3,0,0,-3,-1,-1,-1,1,5,-1
KR_6749703221,420,-3,19,-23,-5,-1,4,3,0,4,4,0,2,2,-4,5,1,0,4,4,0,-6,130,3,-4,1,-1,0,0,-1,-1,0,1,4,-1
KR_6728669772,420,-3,-23,-6,-3,2,0,2,-1,4,3,-1,2,1,-6,6,0,3,1,4,0,-6,3,6,-10,4,-1,0,-1,1,1,-1,-1,5,-1
KR_6743540649,420,-2,-87,-17,-11,-6,6,0,1,0,1,0,4,4,-5,5,0,-1,2,1,0,-9,-34,-3,0,3,9,0,-2,-1,-1,-1,-1,2,-1
KR_6713078242,420,-5,-72,-24,-6,-5,6,1,-1,4,3,-3,3,0,2,0,2,1,0,1,0,0,-9,-2,-1,3,2,0,-1,-1,1,-1,-1,2,-1
KR_6672569453,440,-1,-2,20,-12,0,3,3,-7,10,3,-1,2,1,-3,4,1,-1,3,2,1,-9,-175,-5,0,5,4,0,1,0,0,1,1,0,-1
KR_6649727077,420,0,5,15,1,-3,5,2,-1,3,2,0,0,0,4,0,4,1,0,1,-1,5,-16,-4,0,4,2,0,0,1,1,1,-1,4,-1
KR_6659543032,420,-1,-53,28,-4,-2,4,2,-1,4,3,-1,1,0,0,2,2,0,1,1,-1,-6,2,0,-2,2,0,0,-1,-1,1,1,-1,1,-1
KR_6753986930,440,-3,-2,0,-2,-6,9,3,0,2,2,-1,4,3,5,4,9,0,1,1,0,-1,2,0,-2,2,0,0,0,1,1,1,1,1,-1
KR_6741205580,420,-2,-72,-11,-1,2,1,3,-3,6,3,0,4,4,1,4,5,-1,1,0,-1,5,128,1,-6,5,-2,0,-2,1,-1,-1,-1,4,-1
KR_6663825862,420,-2,-43,-20,-3,-5,5,0,0,2,2,1,2,3,3,0,3,-2,2,0,2,5,0,1,-3,2,2,0,0,0,-1,0,1,0,-1
KR_6738811874,420,1,-23,12,-4,-1,3,2,0,2,2,2,1,3,-5,5,0,0,3,3,0,-3,-8,-8,-2,10,-3,0,0,1,1,0,1,6,-1
KR_6704621149,420,-4,-131,-16,-9,-9,9,0,-2,3,1,3,0,3,0,5,5,-1,3,2,1,8,34,0,-3,3,-13,0,-2,1,-1,-1,1,5,-1
KR_6743825280,420,0,-24,11,0,-4,5,1,3,1,4,2,1,3,-1,1,0,0,0,0,-1,-2,1,-2,-5,7,-1,0,-1,1,1,1,-1,5,-1
KR_6761809708,420,-1,-5,10,-4,3,1,4,-3,4,1,-2,2,0,-2,2,0,0,0,0,0,-3,-270,2,-3,1,-3,0,0,1,-1,1,-1,4,-1
KR_6697936655,420,-1,35,-18,0,0,0,0,-3,5,2,2,2,4,1,3,4,0,0,0,0,0,-21,-2,-4,6,1,0,1,-1,1,1,1,5,-1
KR_6761156054,420,2,0,-11,0,-4,5,1,0,2,2,-1,2,1,5,1,6,0,1,1,0,0,0,2,-4,2,2,0,-1,-1,-1,-1,1,3,-1
KR_6743591532,420,-6,-79,-1,-10,-1,2,1,0,1,1,-4,4,0,-3,3,0,-2,2,0,0,-8,-3,2,-5,3,5,0,-1,1,-1,-1,-1,4,-1
KR_6715552782,420,-2,-67,-36,-12,0,0,0,-2,2,0,-5,6,1,-4,4,0,-1,2,1,0,-7,3,-1,-5,6,10,0,-1,1,-1,-1,-1,2,-1
KR_6743746553,420,-6,-109,-40,-15,-2,4,2,-5,9,4,-7,7,0,1,1,2,-2,2,0,-1,-16,8,4,-9,5,0,0,-3,-1,-1,-1,-1,1,-1
KR_6652052913,420,-2,-34,-19,-3,-2,6,4,-2,3,1,-3,4,1,4,2,6,0,0,0,0,3,2,-1,-1,2,-1,0,-2,-1,1,-1,-1,2,-1
KR_6764218392,420,1,57,-2,7,0,1,1,0,2,2,5,0,5,5,0,5,-3,6,3,1,10,18,0,-4,4,-16,0,0,1,0,0,1,3,-1
KR_6760334243,420,-4,-41,-32,-7,-3,3,0,-2,3,1,-1,4,3,-1,1,0,0,0,0,0,-7,5,1,-3,2,0,0,0,0,1,0,-1,0,-1
KR_6685128087,420,-6,-82,-14,-8,-5,7,2,1,1,2,-3,5,2,1,1,2,-2,2,0,0,6,-1,-1,-3,4,-1,0,-2,-1,1,-1,1,5,-1
KR_6707056302,420,-1,7,-24,2,2,1,3,-2,3,1,1,3,4,-1,1,0,2,1,3,0,-2,6,1,-2,1,0,0,1,0,0,1,1,0,-1
KR_6645365271,420,-2,-36,5,-12,0,2,2,-2,3,1,-8,9,1,-2,4,2,0,0,0,0,-17,10,-4,-4,8,-1,0,-1,-1,-1,-1,-1,6,-1
KR_6710330844,420,2,15,-4,1,-1,4,3,3,0,3,1,0,1,-2,2,0,0,0,0,-1,-4,4,-1,-1,2,-2,0,0,0,-1,-1,-1,0,-1
KR_6761518846,420,1,8,4,-1,3,1,4,0,1,1,1,2,3,-4,4,0,-1,1,0,0,0,-11,-6,0,6,-2,0,0,-1,1,1,1,1,-1
KR_6683607748,420,-6,-69,-28,-7,-3,5,2,2,3,5,-3,5,2,-1,3,2,-2,2,0,0,-3,-538,0,-4,4,-2,0,-1,-1,-1,-1,-1,6,-1
KR_6756770090,420,1,30,32,-4,2,1,3,1,0,1,3,2,5,-4,6,2,-6,6,0,0,-15,6,4,-7,3,-2,0,-1,1,1,-1,-1,4,-1
KR_6763274763,420,-6,-37,-46,-11,-1,1,0,-1,6,5,-2,3,1,-5,7,2,-2,3,1,0,-10,-6,-1,-1,2,-1,0,0,-1,-1,-1,1,5,-1
KR_6636995078,420,-1,-89,16,-2,-4,6,2,0,1,1,1,1,2,-1,3,2,2,0,2,1,7,2,3,-5,2,-1,0,-1,1,1,-1,1,5,-1
KR_6751514452,420,-5,-44,16,-17,-5,5,0,-3,4,1,-9,10,1,0,4,4,0,0,0,0,-11,-16,-4,-2,6,-1,0,0,0,-1,-1,1,0,-1
KR_6740764422,420,-5,-53,-40,-14,-7,8,1,-3,3,0,-3,6,3,0,0,0,-1,1,0,0,-3,-224,1,-5,4,-2,0,-4,-1,1,-1,-1,5,-1
KR_6751833463,420,-3,-51,40,-12,1,0,1,2,2,4,-5,5,0,-6,7,1,-4,4,0,0,-12,-10,2,-4,2,-7,0,0,-1,1,-1,-1,4,-1
KR_6751183005,420,1,44,8,-2,-4,6,2,-1,3,2,2,1,3,3,0,3,-2,3,1,0,-3,-104,1,-2,1,-2,0,1,1,-1,1,1,4,-1
KR_6654953685,420,-1,70,-40,-2,1,0,1,-4,4,0,2,0,2,-2,3,1,1,0,1,0,-1,-3,-1,-2,3,-1,0,0,-1,1,0,-1,6,-1
KR_6744800915,420,-3,-63,-26,-2,-5,6,1,2,1,3,-1,2,1,1,4,5,1,1,2,-1,0,213,-1,-2,3,-4,0,-2,-1,-1,-1,-1,4,-1
KR_6729640745,420,-2,-31,0,-3,1,0,1,-1,1,0,3,2,5,-5,7,2,-1,1,0,3,-5,-9,-1,-2,3,5,0,-1,-1,1,-1,1,1,-1
KR_6703293853,420,-3,-19,-20,-17,5,1,6,-6,7,1,-3,3,0,-10,13,3,-3,3,0,-2,-23,20,2,-4,2,0,0,0,-1,1,-1,-1,5,-1
KR_6762897201,420,-3,-61,-8,-6,1,1,2,-2,2,0,-8,8,0,3,0,3,0,0,0,0,4,44,3,-4,1,-19,0,-2,-1,-1,-1,-1,1,-1
KR_6637582200,420,-3,-138,12,-8,1,2,3,-2,5,3,-1,4,3,-5,6,1,-1,1,0,0,-1,-18,-6,-1,7,-1,0,-1,-1,0,-1,-1,4,-1
KR_6759892038,420,0,46,-28,4,1,2,3,-1,3,2,3,0,3,2,2,4,-1,2,1,0,3,183,6,-7,1,-3,0,1,0,0,1,1,0,-1
KR_6717292199,420,-5,-24,-9,-11,-8,8,0,4,1,5,-7,7,0,1,1,2,-1,1,0,0,-1,-208,1,-2,1,-1,0,-1,-1,-1,-1,-1,4,-1
KR_6659639416,420,-5,7,-21,-14,-5,5,0,-3,5,2,-1,4,3,-4,4,0,-1,3,2,0,-12,5,-2,0,2,-2,0,-3,1,-1,-1,-1,4,-1
KR_6762464651,420,2,20,32,-1,1,2,3,-2,2,0,2,2,4,-4,5,1,2,3,5,0,-2,5,-3,-4,7,6,0,1,1,-1,1,-1,2,-1
KR_6713855955,420,-4,-69,-4,-9,0,0,0,2,2,4,-2,3,1,-4,9,5,-5,5,0,0,-5,371,-1,-2,3,1,0,-1,1,1,-1,1,3,-1
KR_6751506552,420,-3,-52,-20,-4,-2,3,1,3,1,4,-5,6,1,2,2,4,-2,3,1,0,7,-8,-1,-2,3,2,0,0,1,0,-1,1,3,-1
KR_6730567980,420,-1,16,-23,-3,2,0,2,-4,8,4,1,2,3,-2,2,0,0,1,1,0,-2,-6,-6,0,6,1,0,1,-1,1,1,-1,3,-1
KR_6730259463,420,0,54,-36,-1,1,1,2,-2,2,0,2,2,4,-3,4,1,1,1,2,0,-6,-34,0,-3,3,28,0,-1,-1,-1,1,1,4,-1
KR_6682462381,420,-2,40,-56,-11,-4,4,0,-4,4,0,6,1,7,-3,3,0,-6,6,0,-1,-9,1,1,-1,0,1,0,0,-1,-1,1,-1,3,-1
KR_6759162134,420,0,-93,-20,1,1,1,2,3,0,3,-4,4,0,3,0,3,-2,2,0,0,6,-5,2,-3,1,0,0,-1,1,1,-1,-1,1,-1
KR_6756184428,420,-6,-70,-28,-19,-5,5,0,-1,1,0,-2,3,1,-3,6,3,-8,8,0,0,-20,-1,-1,-3,4,1,0,-2,-1,-1,-1,-1,1,-1
KR_6760387726,420,-1,-33,-8,-1,3,0,3,-2,3,1,-1,3,2,-1,1,0,0,1,1,0,-3,-1,0,-3,3,3,0,0,0,0,0,-1,0,-1
KR_6757093799,420,1,45,14,7,-1,1,0,2,3,5,0,1,1,1,1,2,5,1,6,0,15,380,-2,-3,5,28,0,1,1,-1,1,1,4,-1
KR_6747514163,420,-3,32,-4,-6,1,1,2,-2,2,0,2,3,5,-8,9,1,1,0,1,0,-6,-17,1,-4,3,-2,0,2,-1,1,1,1,5,-1
KR_6763762775,420,0,28,12,-1,-2,2,0,-1,1,0,1,0,1,1,0,1,0,2,2,0,-1,26,4,-7,3,-14,0,0,1,1,0,-1,6,-1
KR_6749994222,440,0,-62,-9,2,0,1,1,0,4,4,-1,1,0,1,2,3,2,0,2,0,6,-65,3,-4,1,-4,0,-1,1,-1,-1,-1,1,-1
KR_6759787085,440,-2,-70,10,-12,-9,9,0,-2,5,3,-3,6,3,0,1,1,2,2,4,-2,-10,-10,-2,0,2,1,0,-2,-1,-1,-1,-1,3,-1
KR_6726127851,420,-6,-125,-21,-16,-1,1,0,0,5,5,-4,4,0,-11,14,3,0,3,3,0,-11,3,-6,-3,9,-5,0,-2,1,1,-1,-1,4,-1
KR_6752640857,420,-1,1,12,4,0,1,1,2,4,6,3,2,5,1,2,3,-2,2,0,0,-7,3,0,-3,3,1,0,0,-1,1,0,1,3,-1
KR_6712510941,420,-4,-29,-48,2,-1,3,2,1,0,1,3,1,4,-1,2,1,0,1,1,0,0,16,0,-1,1,0,0,0,-1,0,0,1,3,-1
KR_6726734664,420,-1,-122,12,-7,-2,3,1,-1,2,1,2,2,4,-7,9,2,1,0,1,0,2,57,0,-2,2,-4,0,-1,-1,1,-1,1,2,-1
KR_6748279170,420,0,-18,-20,3,0,2,2,2,0,2,1,1,2,0,2,2,0,0,0,0,2,10,5,-5,0,-1,0,0,-1,-1,0,1,6,-1
KR_6737819369,420,-2,-51,16,-8,-2,2,0,1,1,2,-6,8,2,-3,3,0,2,0,2,0,-2,2,4,-6,2,-2,0,-1,-1,1,-1,-1,5,-1
KR_6748921339,420,6,43,36,6,-4,4,0,2,3,5,4,0,4,3,2,5,1,0,1,0,4,5,-3,-1,4,-1,0,0,1,-1,0,-1,4,-1
KR_6660495600,420,-4,-17,-36,-4,-4,5,1,-4,7,3,1,1,2,2,0,2,1,2,3,0,1,4,3,-5,2,1,0,-1,-1,1,-1,1,4,-1
KR_6757414404,420,0,-4,-7,-1,-3,4,1,5,0,5,-1,2,1,-3,3,0,1,1,2,0,-1,-8,1,-2,1,1,0,0,-1,1,-1,-1,6,-1
KR_6728191632,420,1,-15,15,-3,-2,4,2,-2,2,0,0,3,3,0,1,1,1,2,3,1,1,106,-5,-4,9,3,0,-1,1,-1,-1,1,4,-1
KR_6754327293,420,-3,-64,0,-1,-7,7,0,3,1,4,3,1,4,-1,6,5,1,1,2,-1,10,-10,-3,0,3,30,0,0,-1,0,-1,-1,1,-1
KR_6734668742,420,-1,45,-13,4,2,0,2,2,0,2,1,1,2,0,2,2,-1,1,0,0,3,-195,-2,-3,5,3,0,1,1,-1,1,1,6,-1
KR_6750342731,420,1,-77,28,-2,4,0,4,2,1,3,-2,6,4,-2,2,0,-4,4,0,0,-6,161,-5,0,5,1,0,-1,1,1,-1,1,6,-1
KR_6738410576,420,1,45,-4,-1,-1,2,1,0,2,2,-4,4,0,5,1,6,-1,2,1,0,7,-9,-2,-1,3,3,0,0,1,0,0,1,2,-1
KR_6717981254,420,-7,-12,-42,-13,-2,2,0,-2,3,1,-4,5,1,-4,4,0,-1,1,0,0,-7,4,3,-4,1,-1,0,-1,1,-1,-1,-1,2,-1
KR_6723202932,420,-3,-55,12,-10,1,1,2,-1,4,3,-2,2,0,-7,9,2,-1,1,0,-1,-14,-16,0,-3,3,-3,0,-2,-1,1,-1,-1,5,-1
KR_6697994654,420,-2,35,0,-5,-1,4,3,-8,8,0,2,0,2,3,1,4,-1,2,1,0,3,7,3,-5,2,-1,0,0,0,0,0,-1,0,-1
KR_6694996288,420,1,37,27,10,2,4,6,0,3,3,4,1,5,1,2,3,3,1,4,1,4,-101,3,-5,2,-2,0,2,1,1,1,1,5,-1
KR_6737872277,420,1,12,36,3,-2,3,1,-2,4,2,3,0,3,4,0,4,0,1,1,0,5,14,2,-4,2,-2,0,0,1,-1,-1,1,5,-1
KR_6706284491,420,-2,-50,1,4,-1,3,2,5,2,7,-4,5,1,7,2,9,-3,4,1,0,11,-24,-3,-1,4,-3,0,-1,-1,0,-1,1,4,-1
KR_6670532750,420,2,-37,16,2,1,3,4,-2,6,4,2,0,2,0,2,2,1,1,2,0,4,25,-4,-1,5,1,0,0,-1,1,0,-1,4,-1
KR_6697309133,420,-3,-41,-16,-10,-8,8,0,-1,4,3,-3,3,0,2,2,4,0,1,1,-1,1,8,-1,-1,2,-1,0,-2,-1,-1,-1,-1,1,-1
KR_6689814137,440,-5,-67,-21,-19,-4,4,0,0,1,1,-2,2,0,-11,11,0,-2,2,0,-1,-22,1,1,-6,5,-7,0,-1,-1,-1,-1,-1,4,-1
KR_6760915866,420,-1,-71,31,5,0,2,2,1,1,2,1,0,1,2,0,2,1,0,1,0,1,-34,-1,-4,5,21,0,-1,1,1,-1,1,6,-1
KR_6665789271,420,0,1,28,-6,0,1,1,-2,4,2,1,1,2,-2,3,1,-3,3,0,0,-11,-106,-6,-3,9,0,0,0,1,1,0,-1,5,-1
KR_6671275165,420,-1,-16,-10,1,0,1,1,3,0,3,-6,6,0,3,1,4,1,1,2,0,2,38,0,-2,2,-19,0,0,0,-1,0,-1,0,-1
KR_6693892295,420,0,-54,-44,2,1,0,1,0,3,3,0,1,1,0,3,3,1,0,1,0,4,30,2,-4,2,-3,0,-1,1,0,-1,-1,4,-1
KR_6755077342,420,-3,19,-16,-13,-3,3,0,-5,6,1,3,1,4,-7,8,1,-1,1,0,0,-18,-40,1,-3,2,23,0,-1,1,-1,-1,-1,1,-1
KR_6747814107,420,2,15,-44,6,1,4,5,4,2,6,-1,4,3,-1,1,0,3,0,3,0,4,-32,-2,-1,3,18,0,1,0,1,1,-1,0,-1
KR_6649079682,420,-5,-66,-49,-10,-2,2,0,1,2,3,-3,5,2,-3,3,0,-3,3,0,0,-8,-91,2,-4,2,-4,0,-3,-1,0,-1,-1,2,-1
KR_6732641705,420,-3,-21,-24,-5,1,0,1,-2,3,1,1,3,4,-5,5,0,0,0,0,0,-8,-19,-1,-1,2,0,0,-2,1,-1,-1,-1,3,-1
KR_6734880302,420,1,-35,16,-8,-1,3,2,-1,3,2,-1,1,0,-4,4,0,-1,1,0,0,-3,4,-1,-1,2,0,0,-3,-1,-1,-1,-1,3,-1
KR_6736106240,420,1,4,-1,-2,-1,2,1,0,0,0,-4,5,1,1,2,3,2,0,2,0,1,4,-4,-2,6,-4,0,0,0,0,0,-1,0,-1
KR_6762174964,420,0,41,4,-6,-1,2,1,1,3,4,2,4,6,-5,5,0,-3,3,0,0,-12,-8,4,-4,0,0,0,0,1,-1,0,1,2,-1
KR_6746089011,420,-4,-101,-26,-5,-3,3,0,-3,3,0,3,2,5,-4,6,2,2,0,2,0,-3,15,5,-7,2,-4,0,-1,-1,-1,-1,1,6,-1
KR_6699067050,440,1,-3,-20,-7,1,1,2,0,3,3,-2,4,2,-6,6,0,0,1,1,-1,-5,-2,-3,-3,6,1,0,0,-1,-1,0,-1,2,-1
KR_6741445910,420,3,31,8,3,4,0,4,-2,2,0,-1,3,2,0,3,3,2,0,2,0,3,-16,3,-5,2,-1,0,0,0,1,0,-1,0,-1
KR_6734465219,440,-4,19,-42,-2,0,3,3,-3,4,1,4,0,4,-3,3,0,0,2,2,-1,-7,4,2,-5,3,1,0,0,0,-1,0,-1,0,-1
KR_6746133401,420,1,38,20,-2,1,3,4,-3,3,0,1,0,1,0,2,2,-1,1,0,0,-4,-3,2,-4,2,2,0,1,1,-1,1,-1,3,-1
KR_6740334156,440,-1,-35,-32,-7,-1,3,2,-6,7,1,1,2,3,-1,3,2,0,2,2,-1,-9,268,-4,0,4,1,0,0,-1,-1,0,-1,3,-1
KR_6664840923,420,1,-29,18,3,1,2,3,1,1,2,0,4,4,-1,3,2,2,0,2,0,7,28,-5,-3,8,-17,0,-1,-1,1,1,-1,5,-1
KR_6719894818,420,0,3,10,-7,-2,3,1,1,2,3,0,2,2,-1,3,2,-5,5,0,0,-2,-211,1,-2,1,-6,0,0,-1,0,0,1,5,-1
KR_6748353386,420,-4,-70,-2,-11,0,0,0,-4,4,0,-3,5,2,-3,4,1,-1,1,0,0,-4,-13,1,-5,4,1,0,-1,0,1,1,1,0,-1
KR_6728312770,420,-3,15,0,-4,-2,3,1,0,4,4,-2,3,1,0,1,1,0,1,1,0,-1,-7,-4,-3,7,7,0,-1,1,-1,-1,-1,3,-1
KR_6733497238,420,-2,-36,0,-2,1,0,1,0,1,1,-2,3,1,-1,2,1,0,1,1,0,-3,-3,-1,-1,2,0,0,-1,0,-1,-1,-1,0,-1
KR_6751996295,420,0,40,-11,4,2,0,2,-2,5,3,1,5,6,1,0,1,2,0,2,0,3,20,1,-6,5,-16,0,0,-1,-1,0,-1,3,-1
KR_6740094890,420,-5,-40,-5,-3,-3,7,4,-1,2,1,4,0,4,-1,3,2,-2,2,0,0,-9,2,3,-5,2,16,0,-1,-1,1,-1,1,2,-1
KR_6750688221,420,3,-10,42,3,4,3,7,0,0,0,0,7,7,0,0,0,-1,3,2,0,8,-3,-2,-1,3,3,0,0,-1,0,-1,1,3,-1
KR_6758235987,440,1,-46,4,6,3,0,3,2,1,3,1,0,1,0,1,1,0,1,1,0,5,2,5,-7,2,-4,0,0,-1,-1,0,1,6,-1
KR_6737883032,420,-6,-97,-17,-13,-4,5,1,-4,5,1,-1,2,1,-4,6,2,0,2,2,0,-13,-7,4,-7,3,-1,0,-1,-1,-1,-1,1,6,-1
KR_6762220815,420,-2,18,8,-7,-3,3,0,-1,5,4,-3,5,2,0,5,5,0,2,2,-1,-3,-5,-6,0,6,5,0,0,1,-1,1,-1,1,-1
KR_6704962729,420,-3,28,16,-1,2,1,3,0,2,2,-3,3,0,0,1,1,0,0,0,1,0,-199,-7,-1,8,9,0,0,1,-1,0,1,4,-1
KR_6705789528,440,-2,-67,11,-4,1,4,5,2,1,3,-6,6,0,0,2,2,-1,1,0,0,-7,2,-1,-4,5,-3,0,-2,1,-1,-1,-1,3,-1
KR_6693018105,420,-1,19,-5,2,-2,2,0,4,2,6,-3,3,0,1,4,5,2,1,3,0,4,-13,-5,-1,6,7,0,1,-1,1,-1,1,2,-1
KR_6696760795,420,3,-10,27,6,0,1,1,4,0,4,3,0,3,0,2,2,-1,2,1,0,8,-142,0,-5,5,-1,0,1,0,-1,1,1,0,-1
KR_6723975159,420,-2,9,-6,-8,0,1,1,1,1,2,-6,7,1,-4,4,0,1,0,1,1,-5,-13,-4,-3,7,3,0,0,-1,-1,-1,1,5,-1
KR_6748680683,420,-1,-35,-16,-3,-4,5,1,-2,4,2,1,2,3,0,2,2,2,0,2,0,-3,351,2,-4,2,3,0,0,-1,0,0,-1,2,-1
KR_6695925323,420,-2,-18,-24,-5,3,0,3,-3,3,0,-2,7,5,1,2,3,-4,5,1,0,-8,-3,-3,-2,5,1,0,-1,1,-1,-1,-1,5,-1
KR_6735086908,420,-2,-57,16,-5,-4,5,1,-1,5,4,2,0,2,-2,3,1,0,1,1,1,-1,-5,3,-5,2,1,0,-2,-1,1,-1,1,2,-1
KR_6763718124,420,-3,28,-4,-6,0,0,0,0,0,0,-1,3,2,-5,5,0,0,4,4,0,-4,134,3,-5,2,1,0,1,-1,0,1,1,1,-1
KR_6686376000,420,-1,-42,-5,-5,-2,2,0,0,3,3,-1,1,0,0,1,1,-2,3,1,0,-4,9,0,-4,4,2,0,0,-1,1,0,1,4,-1
KR_6739786686,420,0,-60,24,-4,-4,4,0,0,1,1,-3,6,3,-1,1,0,4,1,5,0,0,-265,3,-3,0,1,0,-1,-1,-1,-1,1,1,-1
KR_6727604649,420,-4,-112,-15,-15,-5,5,0,3,1,4,-1,1,0,-12,13,1,0,1,1,0,-7,4,0,-3,3,-2,0,-1,-1,-1,-1,-1,5,-1
KR_6743939848,420,0,1,-20,3,2,0,2,-1,1,0,2,0,2,2,2,4,-2,2,0,0,10,30,3,-4,1,1,0,2,-1,1,1,-1,2,-1
KR_6627151248,420,-1,-30,-9,-4,-3,3,0,-3,3,0,5,0,5,1,3,4,-4,4,0,0,0,0,-3,-1,4,-2,0,-1,-1,-1,-1,-1,2,-1
KR_6750959953,420,2,-30,32,2,0,2,2,0,1,1,-1,3,2,3,0,3,0,0,0,0,7,-2,2,-3,1,-3,0,1,1,0,1,-1,4,-1
KR_6753049342,420,-6,-65,-20,-12,-1,2,1,2,2,4,-4,5,1,-6,10,4,-3,3,0,0,-6,-13,-2,-1,3,-1,0,-1,-1,-1,-1,-1,2,-1
KR_6736400866,420,4,32,-1,-3,4,0,4,-1,2,1,0,2,2,-6,7,1,0,2,2,1,-5,12,0,-2,2,-3,0,3,1,-1,1,1,2,-1
KR_6736726296,420,-2,-26,16,-9,-2,2,0,-1,1,0,1,3,4,-2,3,1,-5,5,0,1,-3,5,6,-7,1,-2,0,-1,-1,-1,-1,1,5,-1
KR_6714197876,420,-1,-58,-8,-5,1,0,1,1,0,1,-3,5,2,-3,4,1,-1,1,0,0,-5,-8,1,-2,1,0,0,-2,1,-1,-1,-1,4,-1
KR_6683819678,420,-7,-46,-8,-12,-4,5,1,-3,3,0,-7,9,2,2,3,5,0,1,1,1,-2,230,2,-3,1,-1,0,-2,-1,1,-1,1,3,-1
KR_6762920778,420,-4,8,0,-4,-3,5,2,-2,7,5,-1,2,1,-1,3,2,3,1,4,0,3,-16,-3,-2,5,2,0,0,-1,1,1,-1,1,-1
KR_6729171908,420,4,65,47,0,-3,3,0,0,0,0,0,2,2,0,0,0,3,0,3,0,2,-18,-2,0,2,5,0,0,0,0,1,1,0,-1
KR_6749252890,440,4,-9,28,-5,-1,2,1,2,0,2,-3,4,1,-1,1,0,-2,3,1,1,-4,-15,-2,-2,4,-1,0,0,-1,1,0,1,5,-1
KR_6658430388,420,-3,95,-44,-1,0,3,3,-7,7,0,2,1,3,2,4,6,2,0,2,1,4,6,-6,-1,7,3,0,0,1,-1,-1,1,1,-1
KR_6758135274,420,0,-14,-4,1,-1,3,2,0,1,1,-1,1,0,0,2,2,3,2,5,0,0,287,0,-2,2,0,0,0,1,-1,0,-1,3,-1
KR_6729913591,420,2,-46,14,0,-5,5,0,0,1,1,0,4,4,3,1,4,2,1,3,0,4,15,-1,0,1,1,0,0,-1,1,-1,1,4,-1
KR_6646691617,420,1,-20,-20,3,0,0,0,0,1,1,-3,4,1,3,0,3,3,0,3,1,6,18,-3,-1,4,6,0,1,1,-1,1,1,5,-1
KR_6753239844,420,-3,-75,-4,-8,-6,6,0,-1,2,1,0,3,3,-1,5,4,0,0,0,0,-3,-24,4,-7,3,4,0,-1,-1,1,-1,-1,2,-1
KR_6751933050,440,-4,-6,12,-9,-1,2,1,1,2,3,-8,9,1,-2,2,0,1,2,3,0,-6,-15,0,-3,3,-2,0,0,-1,0,0,-1,6,-1
KR_6745468298,420,0,-49,-14,-4,-4,4,0,-5,8,3,0,3,3,2,1,3,3,1,4,-2,-8,4,0,-3,3,1,0,0,1,-1,1,-1,5,-1
KR_6754696511,420,-2,-68,-44,-5,2,1,3,-5,6,1,-1,4,3,-1,2,1,0,2,2,0,1,-12,-4,-2,6,3,0,0,-1,-1,0,1,6,-1
KR_6708841912,420,-3,-63,-28,-11,3,1,4,1,2,3,-6,7,1,-7,8,1,-2,2,0,0,-8,0,2,-3,1,-1,0,-2,0,-1,-1,1,0,-1
KR_6757099390,420,-4,-117,-1,-4,-4,4,0,1,0,1,0,5,5,-2,3,1,1,2,3,0,4,-4,-2,-2,4,1,0,-1,1,-1,-1,-1,3,-1
KR_6744410254,420,-6,-58,0,-15,0,0,0,-2,3,1,-11,13,2,0,4,4,-2,3,1,0,-13,70,0,-3,3,-1,0,1,-1,1,-1,-1,5,-1
KR_6755664745,420,-4,-19,5,-14,2,1,3,0,0,0,-7,7,0,-7,7,0,-2,2,0,0,-14,4,-2,0,2,-1,0,0,-1,1,1,-1,6,-1
KR_6743795092,420,-5,-84,-8,-15,-2,4,2,0,1,1,-3,5,2,-7,7,0,-3,3,0,0,-9,-16,-2,-1,3,1,0,-1,-1,-1,-1,-1,3,-1
KR_6741100896,420,2,28,-12,2,5,1,6,0,6,6,-4,5,1,2,4,6,-1,2,1,1,0,4,5,-6,1,-3,0,1,-1,1,1,1,1,-1
KR_6728373405,420,0,-3,-20,0,3,1,4,2,1,3,-1,2,1,-4,5,1,0,2,2,-1,-2,-123,-2,-4,6,-5,0,-1,0,-1,-1,-1,0,-1
KR_6760830046,420,-2,-34,-9,-5,2,1,3,0,1,1,-5,5,0,0,3,3,-2,2,0,0,-1,-28,0,-1,1,27,0,-2,-1,-1,-1,1,4,-1
KR_6763265186,420,-5,-98,-13,-3,-3,4,1,-2,2,0,3,1,4,-1,4,3,0,0,0,0,-1,-8,1,-3,2,3,0,0,0,1,0,1,0,-1
KR_6764286654,440,-3,5,8,-10,-5,5,0,0,0,0,-4,6,2,-2,3,1,1,0,1,-1,-8,-1,0,-2,2,-1,0,-1,1,-1,-1,-1,6,-1
KR_6762262326,420,0,46,32,-4,3,1,4,-5,6,1,1,2,3,1,0,1,-4,5,1,-3,-7,8,2,-5,3,1,0,-1,1,-1,-1,-1,1,-1
KR_6724600208,420,-6,-102,-8,-8,-5,5,0,-4,6,2,0,2,2,1,2,3,0,1,1,0,-7,-42,-4,-1,5,13,0,-1,-1,-1,-1,-1,3,-1
KR_6743729951,420,-1,-41,-38,-1,1,0,1,3,0,3,-2,4,2,-3,4,1,0,1,1,0,7,-13,6,-7,1,16,0,0,0,0,0,1,0,-1
KR_6709025142,420,-2,-6,-22,-1,4,0,4,-5,7,2,1,0,1,0,0,0,-1,1,0,0,-3,2,2,-6,4,-2,0,0,-1,-1,1,1,1,-1
KR_6644327074,420,-5,-99,-15,-10,0,1,1,-3,3,0,0,0,0,-6,6,0,-1,1,0,0,-10,-3,2,-5,3,-1,0,0,-1,1,-1,-1,5,-1
KR_6742111036,420,-1,28,8,-5,-2,2,0,1,1,2,-1,3,2,-3,4,1,0,1,1,0,-1,3,1,-2,1,0,0,-1,-1,-1,-1,-1,1,-1
KR_6744916572,420,2,0,28,-1,-2,2,0,-1,2,1,4,1,5,-1,3,2,-1,1,0,0,-5,11,1,-4,3,-3,0,-1,1,-1,-1,1,4,-1
KR_6763382968,420,1,-39,-14,1,1,3,4,1,2,3,-2,5,3,2,2,4,-1,1,0,0,7,-372,2,-2,0,1,0,0,-1,0,0,-1,6,-1
KR_6729154051,420,2,-126,-4,3,-2,3,1,1,2,3,2,0,2,2,2,4,0,0,0,0,3,4,-1,-1,2,-1,0,-1,1,-1,-1,-1,6,-1
KR_6760303386,420,3,27,12,2,0,1,1,2,5,7,1,0,1,-1,4,3,0,1,1,0,-3,-43,0,-1,1,10,0,0,1,1,0,1,1,-1
KR_6762191267,420,3,62,23,2,0,2,2,0,2,2,1,1,2,1,2,3,0,1,1,0,0,-9,1,-2,1,2,0,0,1,0,0,1,2,-1
KR_6687495427,420,-3,27,-40,-1,3,0,3,-4,5,1,-1,2,1,-1,2,1,2,1,3,0,-5,4,1,-2,1,-1,0,0,-1,-1,0,1,4,-1
KR_6761872965,420,2,-33,16,4,-1,3,2,2,1,3,6,1,7,-4,4,0,1,2,3,0,9,34,3,-5,2,0,0,0,1,0,-1,1,4,-1
KR_6742032039,420,-1,37,-4,0,2,2,4,-3,5,2,1,1,2,0,1,1,0,0,0,0,-3,-13,2,-3,1,1,0,0,0,0,0,-1,0,-1
KR_6685222599,420,-3,-8,-10,-7,0,0,0,-2,2,0,-2,4,2,1,1,2,-4,4,0,-1,-5,8,6,-8,2,-9,0,0,-1,-1,0,-1,5,-1
KR_6721922269,420,-1,33,-35,-4,4,1,5,1,3,4,0,2,2,-5,7,2,-4,5,1,1,-11,14,4,-4,0,-2,0,0,-1,1,1,1,5,-1
KR_6739375168,420,-2,-70,-16,-4,-4,6,2,3,1,4,5,1,6,-6,8,2,-2,3,1,2,0,0,0,-3,3,-4,0,-1,-1,1,-1,1,2,-1
KR_6751453916,420,-1,-1,-12,1,-5,6,1,0,1,1,4,1,5,2,2,4,0,2,2,0,4,404,-3,-1,4,-16,0,1,-1,-1,-1,-1,4,-1
KR_6760256626,420,1,34,40,4,4,2,6,1,0,1,3,4,7,-2,7,5,-2,4,2,-1,-5,0,1,-1,0,0,0,1,1,1,1,-1,3,-1
KR_6731935456,420,-1,-75,18,-4,2,2,4,3,2,5,-4,4,0,-5,5,0,0,0,0,-2,-7,11,-2,-1,3,-2,0,1,-1,1,-1,-1,2,-1
KR_6761077811,420,-4,-119,-48,-3,-1,1,0,-7,10,3,3,0,3,1,2,3,1,1,2,0,-1,-21,3,-5,2,29,0,0,1,-1,-1,1,5,-1
KR_6755050483,420,-3,-36,-20,-12,-5,6,1,0,4,4,0,2,2,-5,7,2,-2,2,0,0,-1,-28,2,-5,3,1,0,-2,-1,-1,-1,-1,2,-1
KR_6761281026,420,3,-30,17,2,4,1,5,2,0,2,-2,3,1,-3,4,1,1,2,3,1,-7,-8,-5,-2,7,-1,0,0,-1,1,1,1,1,-1
KR_6685503843,420,1,-26,44,2,-1,2,1,5,1,6,-1,4,3,-1,1,0,0,0,0,0,6,-37,-6,-2,8,25,0,0,1,0,0,1,5,-1
KR_6752177854,420,-2,-78,-16,-11,1,2,3,-7,7,0,-3,3,0,-1,3,2,-1,1,0,0,-12,1,0,-1,1,-2,0,-1,-1,-1,-1,-1,1,-1
KR_6747416063,420,-3,-51,-16,-4,3,1,4,-2,5,3,-3,5,2,1,0,1,-3,3,0,0,-2,306,-1,-1,2,1,0,-1,-1,-1,-1,-1,1,-1
KR_6697088111,420,-4,-72,-12,-9,1,3,4,0,1,1,-5,6,1,-4,4,0,-1,1,0,0,-7,75,1,-3,2,1,0,-3,-1,-1,-1,1,4,-1
KR_6617448287,420,-1,4,23,-8,-4,4,0,-5,5,0,-1,3,2,1,0,1,1,0,1,0,-7,-6,-1,-3,4,0,0,-3,1,-1,-1,-1,4,-1
KR_6688024709,420,-4,-3,0,0,0,4,4,-1,3,2,2,4,6,-1,4,3,0,2,2,0,-7,36,-3,-2,5,-10,0,0,-1,0,-1,1,2,-1
KR_6728785700,440,-7,-72,-43,-10,-6,7,1,1,3,4,-1,3,2,-2,2,0,-2,2,0,0,-1,-22,7,-7,0,-3,0,-1,0,-1,-1,-1,0,-1
KR_6733589310,420,-4,-23,-32,-8,-7,8,1,0,2,2,-2,4,2,2,1,3,-1,1,0,1,5,-7,0,0,0,0,0,-1,0,1,-1,1,0,-1
KR_6719497292,420,-5,14,-50,-5,-10,11,1,-3,5,2,3,0,3,2,2,4,3,1,4,0,-1,16,-3,-4,7,-2,0,-1,-1,-1,-1,-1,6,-1
KR_6759150668,440,2,-22,16,8,0,1,1,-1,1,0,2,2,4,5,1,6,2,2,4,0,0,-209,0,-2,2,-2,0,0,-1,0,0,1,6,-1
KR_6699867076,420,-3,-40,28,-15,-3,3,0,-1,1,0,-2,2,0,-7,9,2,-2,3,1,0,-8,28,-3,0,3,-24,0,0,-1,0,-1,-1,4,-1
KR_6678089139,420,-3,-66,4,-3,1,1,2,0,3,3,-6,8,2,2,1,3,0,0,0,0,5,-370,-2,-1,3,-1,0,-1,-1,-1,-1,-1,4,-1
KR_6741326495,420,-1,61,-13,-9,-1,3,2,2,2,4,-9,9,0,-2,2,0,1,1,2,0,-1,0,2,-3,1,0,0,0,-1,1,0,1,2,-1
KR_6741090284,420,0,24,16,-2,5,1,6,0,3,3,-1,3,2,-3,5,2,-3,4,1,0,-3,2,1,-2,1,-1,0,-1,-1,-1,-1,-1,6,-1
KR_6604815296,420,-3,-33,-31,-7,-2,2,0,-7,7,0,1,3,4,-2,5,3,3,0,3,0,-4,10,3,-4,1,-1,0,-2,1,-1,-1,1,2,-1
KR_6750702893,440,-2,-4,-21,6,1,1,2,-1,4,3,-3,4,1,9,0,9,0,0,0,0,11,169,2,-2,0,0,0,0,-1,1,-1,1,4,-1
KR_6734002420,420,-2,-53,-36,-7,-1,2,1,-3,4,1,0,3,3,-2,3,1,-1,1,0,0,-12,12,1,-4,3,-6,0,-2,-1,-1,-1,-1,6,-1
KR_6731711789,440,-6,-75,-20,-9,-4,5,1,3,1,4,-4,8,4,-2,4,2,-2,2,0,1,2,-14,-2,0,2,1,0,-1,-1,0,-1,1,3,-1
KR_6714474164,440,-2,24,-1,-6,-1,1,0,-8,8,0,1,1,2,2,4,6,0,1,1,1,-2,-1,-3,-1,4,3,0,-1,0,1,-1,1,0,-1
KR_6660945191,420,-3,0,-4,-3,-2,4,2,-2,3,1,6,4,10,-2,2,0,-3,3,0,0,-7,3,2,-8,6,-1,0,0,-1,-1,0,1,5,-1
KR_6738497622,440,-4,-66,0,-10,-3,6,3,-2,2,0,-3,5,2,-1,2,1,-1,1,0,0,-12,0,-2,0,2,1,0,-1,1,-1,-1,-1,4,-1
KR_6763731083,420,-2,-18,-30,-3,-2,5,3,0,2,2,2,2,4,-2,2,0,-1,2,1,1,-4,-20,1,-2,1,1,0,0,-1,1,1,1,4,-1
KR_6652940906,420,-2,-61,2,-5,0,3,3,1,0,1,-6,8,2,-2,2,0,2,2,4,0,-1,12,0,-4,4,0,0,0,-1,1,-1,-1,4,-1
KR_6759628129,420,2,14,-20,0,-4,6,2,-1,2,1,2,0,2,2,1,3,1,0,1,-1,1,-336,-2,-1,3,0,0,0,0,0,1,-1,0,-1
KR_6730824802,420,-2,-33,-37,-8,4,0,4,-9,16,7,-1,4,3,-1,3,2,-1,4,3,0,-4,44,3,-5,2,-12,0,-1,-1,-1,-1,1,4,-1
KR_6761326646,420,-2,12,-13,-1,-6,6,0,1,1,2,-2,3,1,7,3,10,-1,1,0,0,7,178,-2,0,2,-3,0,0,-1,-1,-1,-1,3,-1
KR_6658312717,420,2,6,-35,2,0,4,4,2,2,4,3,0,3,-2,5,3,-1,1,0,0,5,2,1,-2,1,-1,0,0,1,0,0,1,6,-1
KR_6758828790,420,1,-1,4,1,0,0,0,1,1,2,-4,4,0,3,1,4,1,1,2,0,4,5,-1,-4,5,6,0,-1,1,-1,-1,-1,5,-1
KR_6753336819,420,0,0,2,-3,2,1,3,-2,3,1,-3,4,1,0,0,0,0,0,0,0,-1,14,-1,-1,2,-1,0,0,1,1,0,-1,5,-1
KR_6745036709,420,-4,8,2,-2,2,3,5,-2,4,2,2,2,4,-4,5,1,0,0,0,0,-9,34,2,-8,6,-1,0,1,-1,-1,1,1,4,-1
KR_6652752751,420,-3,-47,-42,-5,2,1,3,4,0,4,-6,6,0,-3,3,0,-2,4,2,-1,4,-6,-1,-4,5,1,0,-2,-1,-1,-1,-1,3,-1
KR_6635314833,420,-7,-90,-7,-14,-7,7,0,-2,2,0,-5,6,1,1,4,5,-1,1,0,-1,-2,-465,2,-2,0,0,0,-3,-1,-1,-1,-1,5,-1
KR_6661394362,420,-2,-28,19,-1,-1,3,2,2,3,5,-1,3,2,0,0,0,-1,1,0,0,-1,-9,-5,-3,8,0,0,0,-1,0,0,1,3,-1
KR_6757132151,420,1,11,29,-3,-3,4,1,0,2,2,-2,3,1,2,2,4,0,0,0,0,4,0,2,-5,3,0,0,0,1,0,0,-1,2,-1
KR_6761765630,420,0,-28,4,2,-5,7,2,1,1,2,3,3,6,4,1,5,-1,1,0,0,4,-112,-3,-2,5,2,0,-1,0,1,-1,1,0,-1
KR_6730961179,420,-8,-77,-32,-16,-4,4,0,-6,7,1,1,3,4,-4,5,1,-3,5,2,-1,-7,-3,-2,-2,4,2,0,-1,1,-1,-1,-1,6,-1
KR_6738226783,420,-1,14,-25,-4,2,1,3,0,0,0,-1,3,2,-5,9,4,0,2,2,0,-3,-13,-9,0,9,2,0,-2,1,-1,-1,-1,2,-1
KR_6764140644,420,-2,-31,-1,-2,-4,7,3,1,1,2,1,1,2,-1,4,3,1,1,2,-2,-4,200,2,-3,1,-1,0,-2,-1,1,-1,-1,5,-1
KR_6764161660,420,5,131,-5,3,-1,3,2,2,3,5,-6,7,1,9,3,12,-1,1,0,0,-5,-59,-1,-1,2,4,0,1,-1,-1,1,1,6,-1
KR_6710312837,420,-4,-77,22,-4,-1,2,1,1,0,1,0,3,3,-3,3,0,-1,3,2,0,1,8,-3,-2,5,0,0,-1,-1,1,-1,1,5,-1
KR_6724894963,420,-4,-21,0,-10,-6,6,0,-1,2,1,0,1,1,-1,4,3,-2,3,1,0,-9,38,1,-2,1,-17,0,-1,1,1,-1,1,6,-1
KR_6747222390,420,-1,-121,-8,-15,-2,4,2,-1,3,2,-13,13,0,3,3,6,-2,4,2,-1,-2,-17,0,0,0,0,-1,-3,1,-1,-1,-1,4,-1
KR_6760153338,420,-4,2,8,-7,-1,2,1,-2,5,3,0,2,2,-3,3,0,-1,4,3,0,-8,-24,-2,-1,3,4,0,0,0,-1,-1,-1,0,-1
KR_6701552101,420,-1,-98,10,-8,-2,3,1,-2,7,5,0,3,3,-5,6,1,1,2,3,-3,-9,30,4,-6,2,-2,0,-2,-1,-1,-1,-1,2,-1
KR_6722297640,440,0,60,-14,0,-1,2,1,1,1,2,2,1,3,1,2,3,-3,3,0,0,-2,0,2,-4,2,1,0,0,-1,1,0,-1,4,-1
KR_6717394367,420,-4,20,-22,-8,1,2,3,0,1,1,-1,4,3,-6,8,2,-2,2,0,0,-2,3,4,-7,3,-6,0,-1,-1,-1,-1,-1,3,-1
KR_6658871618,420,-4,-93,-44,-6,-6,6,0,0,2,2,1,2,3,2,1,3,-3,4,1,-1,0,1,2,-2,0,-3,0,-1,1,-1,-1,-1,6,-1
KR_6733258689,420,-2,9,-12,-4,0,2,2,2,1,3,-6,6,0,0,0,0,0,0,0,-1,0,1,0,-1,1,-1,0,0,1,-1,0,-1,3,-1
KR_6754039369,420,-1,-88,4,5,-1,3,2,0,3,3,0,1,1,4,3,7,2,0,2,0,3,-2,0,-2,2,-1,0,0,1,-1,0,1,1,-1
KR_6639069059,420,-1,-59,-8,-4,-1,1,0,-2,3,1,-5,6,1,5,1,6,-1,2,1,0,0,-2,-2,-2,4,2,0,-1,-1,-1,-1,-1,4,-1
KR_6704010148,440,1,-75,3,-1,-2,2,0,-1,5,4,2,1,3,0,1,1,0,0,0,0,1,-17,-1,-1,2,1,0,0,-1,-1,0,-1,3,-1
KR_6721437129,420,0,-1,-16,-1,1,2,3,-1,2,1,-1,2,1,1,0,1,-1,1,0,0,-3,38,-2,0,2,-23,0,1,1,-1,1,-1,2,-1
KR_6736878484,420,-3,27,-19,-10,-3,3,0,-3,3,0,-5,5,0,1,2,3,0,1,1,0,-9,-8,-2,-3,5,2,0,0,-1,-1,-1,-1,4,-1
KR_6698583495,420,0,-94,24,1,-3,4,1,0,2,2,3,3,6,-2,3,1,3,0,3,0,6,-17,-2,-3,5,-2,0,-1,1,1,-1,-1,5,-1
KR_6717929632,420,-3,-44,6,-5,2,1,3,0,2,2,-3,3,0,-3,4,1,-1,1,0,0,-10,0,4,-5,1,-4,0,-1,1,1,-1,-1,3,-1
KR_6736017018,420,1,-18,-4,2,-1,2,1,1,3,4,1,1,2,1,0,1,0,2,2,0,3,63,-2,-1,3,-1,0,0,1,-1,0,-1,5,-1
KR_6745555860,420,-1,13,32,1,-1,1,0,0,0,0,5,1,6,-3,3,0,0,0,0,0,-3,-9,-2,-2,4,1,0,-2,-1,0,-1,1,1,-1
KR_6711194625,420,0,24,-10,1,1,2,3,-5,6,1,3,0,3,3,3,6,-1,2,1,0,-4,2,0,-4,4,-2,0,0,0,0,0,-1,0,-1
KR_6760413256,420,0,-59,37,-3,0,1,1,0,1,1,0,2,2,-3,4,1,0,0,0,0,-7,2,-1,-4,5,-1,0,-1,-1,1,-1,1,5,-1
KR_6664420596,420,0,-56,-42,4,-4,4,0,3,1,4,-2,3,1,5,1,6,2,0,2,2,10,-14,-1,-3,4,4,0,0,1,-1,-1,1,5,-1
KR_6734308475,420,1,-15,42,-2,-1,3,2,3,3,6,-5,5,0,1,0,1,0,0,0,0,-2,-2,2,-3,1,1,0,-1,0,1,-1,-1,0,-1
KR_6712334148,420,-1,16,-22,-2,1,3,4,3,3,6,0,3,3,-3,5,2,-3,5,2,0,-8,7,-1,-2,3,-2,0,0,-1,1,0,1,6,-1
KR_6726343292,420,-1,-109,1,-5,-3,3,0,0,3,3,-1,2,1,-2,3,1,1,0,1,0,-1,3,1,-5,4,-4,0,0,-1,0,0,-1,1,-1
KR_6762424892,420,-2,-6,-24,-1,-2,3,1,-1,2,1,-4,6,2,5,0,5,1,2,3,0,2,9,3,-3,0,1,0,0,1,1,0,1,3,-1
KR_6724932123,420,-5,-60,-20,-7,0,0,0,-2,2,0,-6,9,3,3,1,4,-2,2,0,0,-10,-3,-3,-2,5,-7,0,0,-1,-1,-1,-1,5,-1
KR_6756358046,420,-4,-40,8,-5,-8,9,1,1,2,3,0,3,3,-1,6,5,3,0,3,0,0,35,-1,-3,4,0,0,-1,-1,1,-1,-1,4,-1
KR_6763566917,420,3,-16,-5,5,-1,1,0,0,2,2,0,1,1,5,0,5,1,1,2,0,2,-11,-5,-2,7,3,0,0,-1,-1,-1,-1,2,-1
KR_6754177486,420,-1,-89,0,3,0,2,2,2,0,2,0,2,2,-3,4,1,4,0,4,0,7,-48,-3,-3,6,29,0,-1,1,-1,-1,-1,1,-1
KR_6718035309,420,-4,-1,-56,-5,0,2,2,1,4,5,1,2,3,-4,5,1,-3,3,0,0,-10,-6,-1,-1,2,1,0,0,-1,-1,-1,-1,2,-1
KR_6695043566,420,1,-1,0,-1,1,0,1,-2,2,0,-1,5,4,-2,2,0,3,0,3,0,-3,-62,-3,-1,4,29,0,0,-1,0,0,-1,3,-1
KR_6697493610,420,-1,27,-82,2,-1,2,1,-3,3,0,5,1,6,-1,4,3,2,0,2,0,1,-1,-2,0,2,1,0,-1,-1,-1,-1,1,5,-1
KR_6669054874,420,-3,-102,-22,-11,-1,3,2,-2,2,0,-7,9,2,-1,1,0,0,0,0,0,-7,-11,-8,-1,9,0,0,-1,-1,-1,-1,-1,5,-1
KR_6763592060,420,-5,-27,-32,-14,-1,2,1,-6,6,0,-1,4,3,1,1,2,-7,7,0,-1,-12,-4,-1,-5,6,0,0,0,-1,0,-1,-1,6,-1
KR_6730047515,420,-3,-72,-33,-6,-3,4,1,2,1,3,-6,6,0,3,0,3,-2,3,1,0,0,13,-1,-4,5,1,0,0,-1,-1,-1,-1,5,-1
KR_6730242293,420,-5,-36,-20,-9,-7,7,0,3,1,4,-5,6,1,1,1,2,-1,1,0,0,-5,10,6,-6,0,-1,0,-3,-1,1,-1,-1,6,-1
KR_6647136333,420,-4,-39,-16,-11,2,0,2,-3,4,1,-5,5,0,-4,5,1,-1,2,1,0,-7,8,-1,-4,5,-3,0,-2,1,0,-1,1,3,-1
KR_6761615292,420,-2,-60,-28,1,-3,3,0,-2,3,1,0,2,2,5,3,8,1,0,1,0,8,-1,-4,-1,5,-1,0,-1,1,-1,1,-1,4,-1
KR_6758338142,420,-2,-13,40,-1,0,3,3,-1,2,1,-4,6,2,4,1,5,0,1,1,0,5,4,4,-10,6,-4,0,1,1,1,1,1,1,-1
KR_6728785311,420,1,-12,4,0,2,1,3,-2,3,1,2,8,10,-1,3,2,-1,1,0,0,-2,-1,-2,-3,5,1,0,2,-1,-1,1,-1,5,-1
KR_6720052479,420,1,21,16,-5,2,1,3,-4,6,2,0,1,1,-1,3,2,-2,2,0,-1,-10,-2,4,-5,1,-1,0,0,1,1,0,-1,2,-1
KR_6729714682,420,1,26,12,3,-3,3,0,0,1,1,-1,2,1,5,0,5,2,1,3,0,6,9,-3,-1,4,2,0,1,1,0,1,-1,3,-1
KR_6762180662,420,-5,-52,-1,-20,-4,6,2,0,3,3,-2,5,3,-1,2,1,-13,14,1,-1,-16,-1,-1,0,1,1,0,-3,-1,-1,-1,-1,4,-1
KR_6757138236,420,-3,-118,-14,-6,1,1,2,2,2,4,-2,4,2,-6,6,0,-1,1,0,-1,-3,-9,2,-4,2,-3,0,-2,-1,-1,-1,-1,6,-1
KR_6705469676,420,-1,2,-12,-3,1,1,2,2,3,5,0,0,0,-1,4,3,-5,5,0,0,1,13,3,-5,2,-6,0,0,1,-1,0,-1,3,-1
KR_6635644956,420,-1,-53,-15,-6,0,1,1,0,7,7,-2,2,0,-4,4,0,0,2,2,0,-4,-3,0,-1,1,3,0,-1,1,-1,-1,1,4,-1
KR_6752147857,420,3,33,28,9,0,2,2,4,2,6,0,4,4,0,2,2,5,0,5,0,11,-3,0,-2,2,-1,0,2,-1,1,1,1,1,-1
KR_6743096472,440,-5,-52,-33,-12,-1,1,0,-4,5,1,-2,4,2,-3,3,0,-2,3,1,0,-8,40,0,-1,1,-6,0,0,0,0,-1,-1,0,-1
KR_6757656227,440,-4,6,2,-9,-3,4,1,0,1,1,3,0,3,-8,9,1,-1,1,0,0,-8,53,-2,-3,5,-8,0,0,0,0,0,-1,0,-1
KR_6638601301,420,-5,-73,-15,-8,-3,3,0,-2,2,0,0,2,2,-2,8,6,-1,4,3,-2,-7,-335,4,-6,2,3,0,-1,1,-1,1,-1,2,-1
KR_6708547276,420,0,61,-3,6,5,2,7,2,1,3,4,1,5,-5,5,0,0,0,0,-2,-9,-10,-2,-3,5,-3,0,1,-1,1,-1,-1,2,-1
KR_6756403970,420,-1,60,-16,-2,4,1,5,-5,8,3,-3,5,2,1,3,4,1,2,3,0,0,280,-2,-3,5,1,0,0,-1,-1,-1,1,5,-1
KR_6720302335,420,-3,-29,-19,-12,2,3,5,-1,1,0,-6,7,1,0,0,0,-7,8,1,0,-9,-10,-5,-1,6,0,0,-1,-1,0,-1,-1,2,-1
KR_6660672520,420,2,91,28,4,2,1,3,1,4,5,2,4,6,-2,2,0,1,1,2,0,-1,267,-1,0,1,0,0,1,-1,1,1,-1,3,-1
KR_6651662015,420,-3,-30,0,1,0,2,2,-1,3,2,3,0,3,0,1,1,-1,1,0,0,1,-132,-4,-1,5,2,0,-2,1,1,-1,-1,3,-1
KR_6748629495,420,-3,-72,12,-8,0,1,1,1,2,3,-5,6,1,-3,3,0,-1,2,1,-1,-10,3,0,-2,2,-4,0,0,1,0,0,-1,5,-1
KR_6706969980,440,-2,-54,12,-9,0,2,2,-5,5,0,1,3,4,-2,2,0,-3,5,2,2,-12,-4,-4,-2,6,1,0,0,-1,1,-1,1,5,-1
KR_6724141534,420,-1,-5,-7,11,0,1,1,1,4,5,4,2,6,5,2,7,1,1,2,0,3,10,3,-4,1,-4,0,0,1,-1,1,1,5,-1
KR_6743886423,420,-1,8,36,-10,-3,4,1,-3,8,5,2,1,3,-4,6,2,-2,2,0,0,-5,1,-3,0,3,1,0,-2,0,1,-1,1,0,-1
KR_6715561598,420,-2,-37,-8,-7,2,1,3,-3,4,1,-4,5,1,-2,2,0,0,1,1,0,-6,4,5,-6,1,-3,0,0,-1,-1,0,-1,4,-1
KR_6674044299,420,-10,-109,-66,-19,-2,2,0,-2,2,0,-2,2,0,-7,7,0,-6,6,0,-1,-16,-22,-1,-1,2,0,-1,-5,-1,-1,-1,-1,4,-1
KR_6760791066,440,-3,-11,12,-6,-3,3,0,-4,6,2,0,4,4,-1,1,0,2,0,2,0,-10,49,1,-4,3,-22,0,0,0,0,0,-1,0,-1
KR_6741612884,420,-2,-82,15,-5,-2,2,0,1,2,3,0,3,3,-4,5,1,0,0,0,0,-6,7,-4,-1,5,-4,0,-1,-1,-1,-1,-1,1,-1
KR_6660588417,420,1,-11,54,-7,-3,4,1,0,2,2,-2,3,1,-1,4,3,-1,3,2,0,-9,755,0,-2,2,-2,0,-1,0,0,1,1,0,-1
KR_6637100888,420,2,-20,52,1,-1,1,0,-1,2,1,4,0,4,-1,1,0,0,0,0,0,-2,-15,1,-2,1,1,0,0,1,-1,0,-1,6,-1
KR_6698405717,420,0,-15,-8,1,4,1,5,-2,3,1,5,1,6,-3,5,2,-3,3,0,0,-4,-10,2,-2,0,-1,0,1,0,0,1,-1,0,-1
KR_6762400655,420,-2,15,-39,-1,1,4,5,-3,5,2,-1,2,1,-1,3,2,3,1,4,1,-1,-3,-1,-2,3,1,0,0,-1,1,0,1,4,-1
KR_6729489404,420,-2,-23,-24,-5,-1,1,0,0,2,2,-3,3,0,-1,3,2,0,2,2,0,-6,7,-3,0,3,-2,0,-2,-1,1,-1,-1,3,-1
KR_6755245515,420,-4,-46,-21,-12,-2,2,0,-5,8,3,-1,3,2,-2,3,1,-2,2,0,-1,-14,12,-4,-1,5,-1,0,0,-1,-1,-1,-1,5,-1
KR_6752100162,420,-7,-71,-35,-20,-5,5,0,-3,7,4,0,0,0,-12,12,0,0,1,1,0,-13,4,-1,-1,2,3,0,-2,-1,-1,-1,-1,6,-1
KR_6763917939,420,2,-10,10,5,5,0,5,1,1,2,1,3,4,0,2,2,-2,3,1,0,11,-58,0,-4,4,-6,0,1,-1,0,1,1,5,-1
KR_6664007378,420,-5,-33,16,-13,-6,6,0,-4,6,2,-2,4,2,-2,6,4,1,2,3,0,-5,2,0,-1,1,0,0,0,-1,0,0,-1,4,-1
KR_6723696308,420,-4,-92,-28,-9,-1,3,2,-5,5,0,-2,4,2,-1,2,1,0,0,0,1,-4,15,1,-3,2,-7,0,-1,1,1,-1,1,3,-1
KR_6742378784,440,-4,-52,-16,-14,0,1,1,-6,6,0,-1,1,0,-5,6,1,-2,2,0,-1,-15,-90,-3,-4,7,-4,0,-2,-1,-1,-1,-1,1,-1
KR_6630148265,420,4,22,12,11,-1,2,1,-1,2,1,4,1,5,3,0,3,6,0,6,0,7,6,-1,-2,3,2,0,1,1,0,1,1,4,-1
KR_6720602576,420,-5,-8,12,-10,1,1,2,-3,5,2,-2,2,0,-4,4,0,-2,3,1,0,-12,-4,-3,0,3,0,0,-1,-1,1,-1,-1,1,-1
KR_6651634867,420,0,9,12,1,5,0,5,0,1,1,-1,2,1,-2,3,1,-1,2,1,0,3,155,-1,0,1,1,0,1,-1,1,1,1,2,-1
KR_6738553247,420,1,10,16,-1,-4,4,0,1,0,1,3,0,3,-3,5,2,2,0,2,0,1,8,-1,-4,5,-1,0,-1,0,-1,-1,-1,0,-1
KR_6759066399,420,0,-64,36,-11,1,0,1,1,2,3,0,1,1,-10,11,1,-3,6,3,0,-15,-56,1,-3,2,4,0,-1,1,-1,-1,-1,6,-1
KR_6761658062,420,0,43,-8,-2,0,0,0,0,2,2,-2,4,2,0,0,0,0,2,2,0,2,20,0,-2,2,-1,0,0,1,-1,0,-1,4,-1
KR_6697206416,420,-2,-41,6,-4,-4,5,1,-2,2,0,3,0,3,0,4,4,-1,1,0,0,-3,6,4,-8,4,-1,0,-1,1,-1,-1,-1,4,-1
KR_6755375392,440,-1,13,-16,0,4,1,5,2,4,6,0,0,0,-1,1,0,-5,6,1,-1,-7,4,3,-5,2,-4,0,1,-1,-1,-1,-1,5,-1
KR_6764047139,420,-2,-73,-5,-10,-1,2,1,-2,3,1,3,1,4,-7,10,3,-3,5,2,-3,-11,7,-1,-1,2,-2,0,-1,-1,1,1,-1,4,-1
KR_6763907236,420,-4,-63,-8,-9,-2,3,1,0,2,2,-6,6,0,2,1,3,-3,3,0,0,-5,10,2,-4,2,-2,0,-1,-1,1,-1,1,4,-1
KR_6756800524,420,-2,-39,12,-5,0,2,2,-2,3,1,-2,3,1,-1,3,2,0,0,0,0,-5,24,-4,-1,5,-4,0,0,-1,1,0,-1,1,-1
KR_6712625145,420,-2,-43,17,-5,-2,4,2,2,1,3,-1,3,2,-2,3,1,-2,4,2,0,-2,27,-3,-1,4,4,0,0,0,0,-1,-1,0,-1
KR_6736319614,420,0,-41,4,5,-2,4,2,0,1,1,-1,2,1,8,1,9,0,1,1,0,13,0,1,-5,4,-3,0,0,1,-1,1,-1,3,-1
KR_6715250301,420,-3,24,-4,-4,-2,2,0,0,4,4,4,0,4,-2,3,1,-4,4,0,0,2,-96,0,-4,4,2,0,-2,0,-1,-1,-1,0,-1
KR_6740259719,420,-1,26,-4,1,0,0,0,-4,5,1,0,1,1,4,2,6,1,1,2,0,0,4,1,-5,4,-3,0,1,-1,-1,-1,1,4,-1
KR_6757783127,420,-2,-47,8,-4,-2,4,2,-1,1,0,0,0,0,-2,3,1,1,0,1,0,0,-214,1,-3,2,0,0,0,-1,-1,0,-1,2,-1
KR_6697587634,420,-3,-74,-8,-3,0,1,1,2,0,2,1,2,3,-1,1,0,-5,7,2,0,-5,-24,-4,-1,5,0,0,0,1,1,0,-1,6,-1
KR_6750656350,420,-2,-103,-12,1,-3,3,0,0,1,1,4,0,4,2,1,3,-2,2,0,0,3,4,-1,-4,5,0,0,-1,-1,1,-1,-1,3,-1
KR_6711698044,420,-10,-185,-40,-24,-6,7,1,-5,7,2,-8,8,0,2,1,3,-7,7,0,0,-19,-50,-2,0,2,30,-1,-5,-1,-1,-1,-1,4,-1
KR_6764312638,420,2,10,-16,7,4,2,6,1,4,5,0,4,4,3,0,3,-1,1,0,0,5,-1,-3,-3,6,1,0,1,-1,-1,-1,1,3,-1
KR_6723665980,420,1,55,-4,0,3,1,4,-1,2,1,-1,1,0,0,0,0,-1,4,3,0,-1,39,-3,-2,5,2,0,-1,-1,-1,-1,-1,2,-1
KR_6695541344,420,0,-9,0,-10,1,2,3,-1,3,2,-3,5,2,-6,6,0,-1,1,0,0,-7,305,0,-1,1,-2,0,-2,1,1,-1,-1,2,-1
KR_6743146708,440,-5,-97,-15,-8,-2,2,0,-5,5,0,-4,5,1,1,5,6,2,0,2,0,-2,284,0,-2,2,-1,0,-1,0,0,-1,1,0,-1
KR_6762299863,420,0,-72,11,-2,-1,1,0,-2,5,3,-4,5,1,3,0,3,2,1,3,0,0,-7,-1,-1,2,3,0,-2,1,0,-1,-1,2,-1
KR_6729541065,420,-4,-68,-28,-10,-3,4,1,-1,1,0,1,0,1,-5,5,0,-2,2,0,0,-6,1,-1,-2,3,1,0,0,-1,1,0,-1,5,-1
KR_6725532015,420,-4,-33,4,1,1,4,5,-2,2,0,-7,8,1,8,1,9,1,1,2,0,6,9,2,-3,1,-4,0,-1,-1,0,-1,1,4,-1
KR_6699829601,420,-2,-89,-10,-7,-1,1,0,-4,7,3,-4,4,0,-1,5,4,3,0,3,0,-5,-41,-2,0,2,36,0,-2,-1,0,-1,-1,3,-1
KR_6755123235,440,-6,-125,-16,-21,-5,6,1,-6,8,2,-1,1,0,-8,9,1,-1,2,1,0,-19,-6,-2,-1,3,-4,0,-3,-1,-1,-1,-1,3,-1
KR_6709595892,420,-4,-59,-20,-2,-3,3,0,1,1,2,-1,2,1,2,0,2,-1,2,1,0,4,155,0,-4,4,1,0,-1,-1,1,-1,1,5,-1
KR_6759300113,420,3,22,1,8,1,0,1,2,1,3,1,2,3,5,0,5,-1,1,0,0,14,13,3,-5,2,2,0,0,-1,-1,0,1,5,-1
KR_6669832240,420,-2,-110,28,-2,-1,1,0,1,1,2,-2,2,0,0,1,1,0,0,0,0,-1,5,-2,-1,3,-2,0,-1,-1,-1,-1,-1,2,-1
KR_6680608710,420,2,23,-14,2,5,0,5,-2,2,0,2,2,4,-1,2,1,-2,3,1,0,0,-146,2,-6,4,3,0,0,-1,1,0,1,2,-1
KR_6728199980,420,4,-24,12,4,7,0,7,-5,7,2,1,0,1,0,1,1,1,1,2,0,-3,-1,-4,0,4,0,0,-1,1,-1,-1,-1,1,-1
KR_6741212380,440,-2,-80,-20,-7,-4,7,3,1,0,1,-3,3,0,-5,5,0,4,3,7,0,-7,17,-1,0,1,-2,0,-1,-1,-1,-1,1,4,-1
KR_6690247654,420,-1,-65,-12,0,0,2,2,1,1,2,1,1,2,-2,2,0,0,1,1,0,2,-27,7,-8,1,24,0,0,1,-1,-1,1,4,-1
KR_6753006945,420,-2,-18,-28,-4,-6,6,0,0,4,4,1,2,3,-2,5,3,3,3,6,0,-4,-144,1,-1,0,-1,0,0,-1,-1,-1,1,5,-1
KR_6762959519,420,-3,-2,-24,-6,2,1,3,-1,3,2,-5,6,1,-2,2,0,0,2,2,1,-3,0,-5,0,5,-1,0,1,-1,1,1,1,2,-1
KR_6756087321,420,4,44,5,2,-1,3,2,3,2,5,0,5,5,-3,3,0,3,0,3,0,4,-3,3,-4,1,3,0,0,-1,1,0,-1,3,-1
KR_6711281083,420,-1,20,0,-1,7,2,9,0,3,3,-1,5,4,-3,4,1,-4,4,0,2,-7,4,3,-5,2,-2,0,0,-1,1,1,1,6,-1
KR_6740252196,420,-1,-3,1,-9,-1,5,4,-1,2,1,-4,9,5,-5,5,0,2,0,2,0,-18,327,-5,-1,6,0,0,0,-1,-1,1,-1,1,-1
KR_6647496989,420,1,7,-2,1,-1,1,0,-1,1,0,0,4,4,2,1,3,1,0,1,0,-2,-3,0,-1,1,4,0,0,-1,-1,0,-1,5,-1
KR_6732364665,420,0,-127,5,-2,-2,3,1,1,3,4,-1,2,1,-1,2,1,1,1,2,-1,-1,36,-4,-2,6,-8,0,-1,-1,-1,-1,-1,1,-1
KR_6748457139,420,-7,-68,-76,-10,-1,1,0,-1,3,2,-5,8,3,-1,6,5,-2,2,0,0,-3,-4,0,-3,3,-4,0,-1,-1,-1,-1,1,1,-1
KR_6749128512,420,-2,-113,-20,2,-2,4,2,2,0,2,-1,2,1,2,1,3,1,0,1,0,10,12,0,-4,4,0,0,-1,-1,1,1,1,6,-1
KR_6759424758,420,-1,8,-23,-1,-2,3,1,0,4,4,-2,4,2,1,1,2,2,0,2,0,-1,-175,1,-3,2,4,0,1,0,1,1,-1,0,-1
KR_6726384441,420,1,77,-12,-3,0,2,2,-1,1,0,-3,4,1,1,1,2,0,1,1,0,-3,10,1,-5,4,3,0,0,-1,-1,0,-1,4,-1
KR_6701972928,420,-1,-37,-12,4,2,1,3,4,0,4,-1,3,2,0,0,0,-1,2,1,0,1,-507,4,-7,3,-2,0,1,-1,1,-1,1,2,-1
KR_6759059389,440,-6,-66,-32,-27,-8,8,0,-5,7,2,-1,3,2,-10,10,0,-3,3,0,0,-26,-2,-2,-2,4,0,0,-1,-1,0,-1,-1,6,-1
KR_6737717930,420,-2,-10,-37,0,1,1,2,-4,5,1,-1,1,0,4,3,7,0,2,2,0,0,12,-2,-3,5,-2,0,-2,-1,-1,-1,-1,1,-1
KR_6679871514,440,-9,-103,-19,-24,-7,7,0,-5,6,1,-3,4,1,-7,7,0,-2,3,1,0,-22,45,-1,-1,2,-22,0,-3,0,-1,-1,-1,0,-1
KR_6731651691,420,-2,8,-11,-13,0,0,0,-12,13,1,2,1,3,-4,4,0,1,0,1,0,-20,-2,-3,-1,4,-2,0,-2,-1,-1,-1,1,6,-1
KR_6764053740,420,-1,-67,39,-9,-2,2,0,3,0,3,-3,5,2,-5,5,0,-2,2,0,-2,-8,-6,-2,-2,4,3,0,0,0,1,0,-1,0,-1
KR_6734525315,420,4,12,16,9,2,1,3,1,3,4,2,4,6,4,3,7,0,0,0,0,8,1,2,-4,2,0,0,0,1,-1,-1,-1,5,-1
KR_6725074368,440,-1,-46,-5,-1,-3,4,1,2,5,7,-5,5,0,1,2,3,4,1,5,0,8,3,-1,-1,2,3,0,-1,0,0,-1,1,0,-1
KR_6754956350,440,-5,-56,-16,-14,-4,4,0,-4,5,1,-2,2,0,-3,6,3,-1,1,0,0,-18,103,-7,0,7,-3,0,-1,0,0,-1,-1,0,-1
KR_6715250714,420,2,-35,-11,8,1,2,3,0,2,2,3,2,5,4,1,5,0,1,1,0,0,-50,-5,0,5,27,0,-1,1,-1,-1,1,5,-1
KR_6708598690,420,-3,-41,-28,-7,2,0,2,-1,1,0,-7,8,1,-1,1,0,0,0,0,0,-2,7,-3,-2,5,-8,0,-3,-1,-1,-1,-1,6,-1
KR_6764252748,420,-4,-64,7,-14,-5,5,0,1,2,3,-5,8,3,-5,6,1,0,1,1,0,-10,-1,1,-1,0,0,0,0,-1,1,1,-1,3,-1
KR_6743759273,420,0,6,-15,-3,-3,3,0,-6,7,1,1,1,2,4,0,4,1,0,1,0,-5,5,5,-6,1,-5,0,-1,-1,-1,-1,1,3,-1
KR_6677745475,420,-3,-46,-18,-3,0,2,2,1,2,3,-5,5,0,1,3,4,0,0,0,0,-6,8,2,-3,1,-4,0,-3,-1,-1,-1,1,1,-1
KR_6761887541,440,-2,33,4,-7,0,0,0,-4,5,1,-2,6,4,-2,5,3,1,0,1,-1,-9,18,0,-4,4,-2,0,-2,-1,-1,-1,-1,4,-1
KR_6656893438,420,1,28,-2,4,1,3,4,-2,5,3,6,1,7,1,4,5,-2,3,1,0,-6,269,4,-4,0,-2,0,1,1,1,1,1,5,-1
KR_6753975018,420,-4,-75,24,-9,0,0,0,-3,4,1,-3,3,0,-2,2,0,-1,1,0,0,-4,-10,-3,-1,4,-3,0,-1,-1,-1,-1,-1,3,-1
KR_6670353423,420,0,-3,94,-8,-1,3,2,-6,6,0,0,3,3,-1,5,4,0,2,2,0,-5,-1,1,-1,0,-1,0,-1,1,0,-1,-1,3,-1
KR_6701382502,420,-6,-110,-64,7,0,0,0,4,0,4,5,0,5,0,3,3,-2,3,1,0,6,-41,1,-5,4,31,0,-1,-1,1,-1,1,3,-1
KR_6724254470,420,0,34,-33,2,-2,4,2,-4,4,0,4,1,5,4,0,4,0,1,1,0,4,-12,3,-3,0,0,0,0,1,-1,-1,1,4,-1
KR_6736277777,420,1,-25,4,-7,1,0,1,-1,4,3,-7,7,0,0,2,2,0,1,1,0,-5,2,0,-3,3,-2,0,-1,-1,1,-1,-1,4,-1
KR_6714686160,440,-2,57,-16,-4,-1,1,0,-2,3,1,-5,5,0,4,0,4,0,2,2,0,-1,1,0,-4,4,7,0,-1,1,-1,-1,-1,6,-1
KR_6758539717,420,1,91,-14,-4,1,1,2,-1,2,1,-6,6,0,3,0,3,-1,2,1,0,1,34,-5,-4,9,-29,0,2,-1,1,1,-1,3,-1
KR_6689654090,420,0,-68,-32,-1,1,1,2,1,2,3,2,0,2,-5,5,0,0,0,0,-1,-4,-2,0,-4,4,1,0,0,-1,1,1,-1,3,-1
KR_6696891348,420,-1,92,0,-3,0,1,1,-4,7,3,3,0,3,-2,3,1,0,2,2,0,0,-2,0,-2,2,0,0,0,-1,-1,0,1,5,-1
KR_6731671896,420,-2,-12,-5,-5,1,1,2,2,1,3,-4,5,1,-4,10,6,0,0,0,1,-6,6,-2,-2,4,-1,0,-1,-1,1,-1,1,5,-1
KR_6745474670,420,-1,-39,8,1,-2,3,1,1,1,2,-1,3,2,3,1,4,0,1,1,0,4,56,-2,-2,4,3,0,0,0,1,0,1,0,-1
KR_6724009344,440,-1,-21,-17,5,6,0,6,0,3,3,1,1,2,0,3,3,-2,2,0,-1,-5,7,0,-4,4,-4,0,1,-1,1,1,-1,1,-1
KR_6750487806,420,-2,-84,-7,-2,-1,1,0,-2,4,2,1,3,4,1,5,6,-1,2,1,-2,6,3,2,-4,2,-7,0,-2,-1,1,-1,-1,5,-1
KR_6622026221,420,-2,31,0,-4,-2,2,0,-3,4,1,-1,1,0,0,1,1,2,0,2,0,-5,4,-3,0,3,-5,0,-3,-1,-1,-1,-1,4,-1
KR_6706517884,420,0,22,-12,2,2,3,5,-3,4,1,3,1,4,1,2,3,-1,2,1,0,2,-464,-3,-1,4,-2,0,-1,-1,-1,-1,-1,5,-1
KR_6760710258,440,-3,-3,-4,-9,3,3,6,-2,2,0,-2,3,1,-5,6,1,-3,3,0,0,-12,-10,0,-2,2,2,0,0,-1,0,1,-1,2,-1
KR_6604007139,420,0,-45,32,1,-2,2,0,1,3,4,-2,3,1,0,1,1,4,1,5,0,7,-1,0,-1,1,0,0,-1,1,-1,-1,1,4,-1
KR_6733833326,440,-3,-64,8,-6,-1,1,0,0,2,2,-5,5,0,-1,1,0,1,1,2,0,-5,-9,0,-4,4,0,0,-1,-1,1,-1,1,2,-1
KR_6718089215,420,3,70,-12,3,1,0,1,-2,4,2,-2,2,0,3,2,5,3,0,3,0,0,-1,4,-6,2,2,0,2,1,-1,1,1,5,-1
KR_6763630628,420,1,21,24,1,1,2,3,0,3,3,0,1,1,0,2,2,0,0,0,0,-3,-15,1,-5,4,2,0,-1,1,-1,-1,-1,3,-1
KR_6748645841,440,-2,20,-4,-4,0,3,3,1,0,1,-5,8,3,0,2,2,0,1,1,0,1,-10,-1,-1,2,-2,0,0,0,0,-1,1,0,-1
KR_6642347092,420,0,23,-16,-1,1,0,1,-2,4,2,-1,2,1,0,0,0,1,0,1,0,-1,207,-1,-1,2,1,0,1,-1,-1,1,-1,2,-1
KR_6758876348,440,-3,-111,4,-2,-1,2,1,1,3,4,1,1,2,-4,4,0,1,1,2,0,-1,-29,-5,0,5,23,0,-2,-1,1,-1,-1,5,-1
KR_6744700588,420,-3,-104,-36,-5,-4,4,0,-3,4,1,3,1,4,-1,6,5,0,0,0,1,-3,16,-1,0,1,-1,0,-3,-1,0,-1,1,1,-1
KR_6763075624,420,-6,-46,-32,-15,-2,5,3,0,3,3,-3,5,2,-10,11,1,0,3,3,0,-8,-1,-1,0,1,-4,0,0,-1,-1,0,1,3,-1
KR_6656863297,420,1,67,20,-5,-1,1,0,-2,2,0,2,2,4,-4,4,0,0,0,0,0,-6,-3,0,-3,3,1,0,0,-1,0,0,1,1,-1
KR_6762695293,420,2,-52,-19,1,-3,4,1,-3,4,1,-1,3,2,5,4,9,3,2,5,1,6,-42,0,-1,1,16,0,-2,-1,-1,-1,1,5,-1
KR_6566738740,420,-2,10,-30,-2,0,1,1,3,0,3,1,2,3,-6,6,0,0,1,1,-1,-2,-15,-7,0,7,1,0,-1,-1,-1,-1,-1,3,-1
KR_6730054859,420,-1,-53,-16,-4,1,1,2,4,1,5,-1,1,0,-8,8,0,0,0,0,1,-5,-6,-4,-1,5,-4,0,-1,0,-1,-1,1,0,-1
KR_6754155965,420,0,-18,-31,7,-4,4,0,-1,1,0,2,1,3,2,0,2,8,1,9,0,7,-4,0,-2,2,-2,0,1,-1,-1,-1,1,3,-1
KR_6755349161,420,-1,-49,-4,-5,-3,4,1,-5,7,2,-3,4,1,-1,4,3,7,0,7,0,-13,345,-1,-2,3,2,0,-3,-1,-1,-1,-1,4,-1
KR_6693950400,420,-1,8,-14,-2,1,3,4,3,0,3,-3,3,0,-3,5,2,0,0,0,0,1,-9,2,-4,2,-2,0,0,-1,0,0,1,3,-1
KR_6761112678,420,-3,-43,16,-12,-2,3,1,-10,10,0,1,0,1,1,3,4,-2,2,0,0,-11,4,-1,-1,2,1,0,-1,1,-1,-1,-1,4,-1
KR_6738011110,420,1,-19,20,1,-1,2,1,-2,4,2,4,1,5,-1,2,1,1,0,1,-1,1,-4,-1,-3,4,0,0,0,-1,-1,0,-1,2,-1
KR_6741572624,440,-4,-130,-34,-4,-6,6,0,-4,8,4,2,2,4,1,2,3,3,0,3,0,3,0,-1,-1,2,1,0,-2,-1,-1,-1,-1,6,-1
KR_6739780341,420,0,-91,8,0,-1,1,0,2,1,3,2,1,3,-4,6,2,1,0,1,-2,-1,2,6,-6,0,1,0,0,1,1,0,-1,1,-1
KR_6752274224,440,-3,-88,7,-9,-4,5,1,-1,2,1,-2,4,2,-2,4,2,0,0,0,0,-5,-2,-3,-1,4,-3,0,0,1,-1,-1,-1,3,-1
KR_6736507071,420,-2,41,-23,-7,-2,3,1,-5,8,3,-5,9,4,2,2,4,3,0,3,1,8,28,-2,0,2,-3,0,1,-1,-1,1,1,4,-1
KR_6734225505,420,-3,-35,8,-9,-2,2,0,2,2,4,-5,5,0,-3,4,1,-1,2,1,0,-20,84,1,-1,0,-1,0,-1,0,1,-1,1,0,-1
KR_6701230792,420,-4,-40,0,-14,-1,5,4,-6,10,4,-3,4,1,-4,4,0,0,0,0,0,-21,37,3,-5,2,-2,0,0,1,0,-1,-1,1,-1
KR_6727670363,420,1,42,-20,-3,0,2,2,-2,7,5,1,1,2,2,1,3,-4,4,0,0,-7,201,2,-4,2,-2,0,-1,-1,-1,-1,-1,4,-1
KR_6762063943,420,2,-26,-24,-3,-8,9,1,2,2,4,2,4,6,2,0,2,-1,1,0,0,4,4,1,-5,4,2,0,-1,1,-1,-1,1,3,-1
KR_6743389770,420,-3,-22,32,-2,-2,2,0,-2,2,0,0,2,2,1,4,5,1,2,3,0,-7,-3,4,-8,4,-1,0,-1,1,1,-1,1,1,-1
KR_6671199142,420,-1,-22,-15,-8,-5,5,0,-2,3,1,-1,3,2,-1,4,3,1,1,2,0,-5,42,1,-2,1,-21,0,-1,-1,-1,-1,1,6,-1
KR_6737112812,420,-3,-69,-28,-8,-4,4,0,-1,4,3,0,2,2,-3,6,3,0,1,1,0,-5,164,-2,-4,6,1,0,-1,-1,-1,-1,1,3,-1
KR_6717337824,420,-2,-75,-20,1,-1,2,1,6,0,6,-3,8,5,-1,1,0,0,0,0,0,9,42,-1,-2,3,1,0,1,1,-1,-1,-1,4,-1
KR_6706264688,420,0,46,-41,-1,-2,3,1,0,1,1,-6,7,1,1,2,3,6,0,6,-1,5,-91,-2,0,2,-3,0,0,1,-1,-1,-1,3,-1
KR_6698650812,420,-6,-21,36,-18,0,1,1,-4,4,0,-8,8,0,-5,5,0,-1,2,1,-1,-15,-47,1,-3,2,19,0,-1,-1,1,-1,-1,3,-1
KR_6676289356,420,0,2,16,-12,-1,4,3,3,2,5,-11,12,1,-4,6,2,1,1,2,0,-9,344,6,-9,3,-1,0,1,1,1,1,1,6,-1
KR_6727904386,420,-7,-51,-52,-5,-6,6,0,-1,2,1,-4,4,0,6,2,8,0,0,0,0,6,-20,-1,-4,5,-4,0,-2,-1,-1,-1,-1,3,-1
KR_6693764908,420,-2,21,-16,-3,-1,4,3,-2,4,2,-1,4,3,1,2,3,0,0,0,0,-5,-6,0,-3,3,3,0,0,1,-1,-1,1,6,-1
KR_6742113634,440,0,-29,-39,-7,0,0,0,1,1,2,2,2,4,-8,10,2,-2,3,1,0,-12,-8,-5,0,5,1,0,-1,0,-1,-1,-1,0,-1
KR_6726627608,420,-3,-11,-16,-5,-2,4,2,3,0,3,0,0,0,-4,4,0,-2,2,0,0,1,-10,-1,-1,2,-1,0,-2,-1,-1,-1,-1,2,-1
KR_6645616499,420,-4,-49,-24,-5,-5,5,0,2,1,3,-1,1,0,-1,1,0,0,0,0,0,0,-9,0,-7,7,-7,0,-1,-1,0,-1,-1,2,-1
KR_6703591431,420,1,57,-8,2,3,1,4,-3,5,2,3,1,4,2,2,4,-3,3,0,0,-3,-4,-1,-4,5,2,0,0,0,-1,1,1,0,-1
KR_6735763351,420,1,-52,24,7,-1,2,1,5,1,6,0,2,2,4,1,5,-1,1,0,2,11,6,8,-11,3,1,0,0,1,-1,-1,1,5,-1
KR_6743917981,440,-2,-39,-4,-10,3,1,4,-2,4,2,1,4,5,-12,15,3,0,2,2,-1,-12,-4,-4,-1,5,4,0,-2,0,-1,-1,-1,0,-1
KR_6680169477,420,0,-20,-16,-4,1,1,2,0,0,0,0,1,1,-5,5,0,0,1,1,0,-6,-9,1,-4,3,-3,0,0,1,0,0,1,3,-1
KR_6729574141,420,-3,-9,-40,-7,-2,3,1,-7,8,1,1,0,1,1,2,3,0,1,1,0,-2,12,0,-5,5,-2,0,-1,-1,-1,-1,1,6,-1
KR_6749176781,440,-1,-62,-16,2,0,0,0,4,0,4,0,3,3,-2,2,0,0,1,1,1,2,-3,1,-3,2,-1,0,0,-1,-1,0,1,4,-1
KR_6723415836,420,3,67,-14,1,-3,4,1,-5,5,0,3,0,3,1,1,2,5,2,7,0,-1,433,-2,-1,3,-2,0,0,1,-1,-1,-1,2,-1
KR_6752282686,440,2,-25,35,-4,1,2,3,0,2,2,1,1,2,-3,3,0,-3,3,0,0,-5,9,4,-5,1,-1,0,0,-1,1,1,-1,5,-1
KR_6735061886,420,-2,-90,-15,-1,0,1,1,0,2,2,-4,4,0,2,1,3,1,0,1,0,2,17,4,-6,2,-27,0,0,0,0,-1,1,0,-1
KR_6701249485,420,-3,29,20,-9,-3,4,1,-2,5,3,0,2,2,-3,5,2,-1,1,0,0,-13,-1,-2,-1,3,-2,0,-1,-1,1,1,-1,2,-1
KR_6653003632,420,1,-66,-40,5,-3,3,0,2,2,4,0,4,4,4,0,4,2,1,3,0,12,66,2,-3,1,-1,0,1,-1,-1,1,1,3,-1
KR_6658508217,420,-3,-19,-12,-5,-1,4,3,-2,4,2,0,1,1,-1,2,1,-1,3,2,0,-5,-19,-2,-1,3,-2,0,-1,-1,1,-1,-1,3,-1
KR_6727522968,420,3,3,21,-2,-1,2,1,-1,2,1,-1,2,1,-1,6,5,2,1,3,0,-4,1,1,-3,2,2,0,2,1,1,1,1,5,-1
KR_6743242938,420,-2,-41,7,-3,1,1,2,1,2,3,0,1,1,-3,5,2,-2,3,1,-2,-4,3,-2,-3,5,-4,0,-1,-1,-1,-1,-1,6,-1
KR_6760343471,420,1,-84,0,8,-3,3,0,4,0,4,4,0,4,2,2,4,1,0,1,0,2,-159,-1,0,1,19,0,0,1,0,0,1,3,-1
KR_6761469609,420,2,-29,-12,0,-7,8,1,-1,2,1,3,1,4,1,0,1,4,0,4,0,-1,334,-4,-2,6,3,0,1,-1,1,-1,-1,1,-1
KR_6654993634,420,-3,-54,-23,-10,2,0,2,-6,7,1,-7,8,1,2,0,2,-1,2,1,0,-9,-37,3,-6,3,21,0,-1,-1,-1,-1,-1,3,-1
KR_6755180896,420,-2,-78,10,-5,-6,6,0,-1,3,2,1,1,2,1,3,4,0,0,0,1,1,5,2,-3,1,1,0,-1,-1,-1,-1,1,1,-1
KR_6661706978,420,0,30,-12,0,3,0,3,3,2,5,-3,6,3,-2,2,0,-1,1,0,0,-5,1,0,-3,3,1,0,0,-1,0,0,1,2,-1
KR_6651628815,420,-2,-77,-1,-3,-4,6,2,-1,2,1,1,3,4,1,1,2,0,0,0,0,-3,40,2,-7,5,-11,0,0,0,-1,0,-1,0,-1
KR_6714071516,420,-2,-3,-18,-3,1,3,4,-2,3,1,-1,6,5,1,6,7,-2,2,0,1,9,2,5,-9,4,-1,0,-1,-1,1,-1,1,2,-1
KR_6750308513,440,-6,-64,-44,-4,-3,4,1,-1,3,2,-2,2,0,3,0,3,-1,2,1,0,2,-17,-7,-1,8,7,0,-2,1,1,-1,1,6,-1
KR_6715905947,420,-8,-94,12,-20,-5,5,0,-5,6,1,-3,6,3,-5,6,1,-2,2,0,-1,-10,4,2,-2,0,-3,0,-2,0,1,-1,-1,0,-1
KR_6713955699,420,1,-16,24,8,5,0,5,-2,4,2,0,1,1,4,1,5,1,0,1,0,4,2,-3,-4,7,-1,0,0,1,-1,0,1,5,-1
KR_6628449377,420,2,23,8,8,-3,4,1,3,1,4,1,2,3,3,2,5,4,0,4,0,6,317,-3,-2,5,2,0,0,-1,1,1,-1,3,-1
KR_6651041138,420,-1,-69,-4,0,-1,1,0,-2,2,0,-1,4,3,4,1,5,0,2,2,0,-1,0,-1,-3,4,2,0,0,-1,0,0,-1,2,-1
KR_6695107440,420,0,2,22,-6,-4,5,1,-1,3,2,-1,4,3,3,3,6,-3,4,1,-2,-2,-8,-5,0,5,2,0,-1,-1,-1,-1,-1,3,-1
KR_6691658454,420,-7,-34,-82,-18,-2,5,3,-4,4,0,-8,9,1,-1,2,1,-3,5,2,0,-18,-7,-2,-1,3,-3,0,-1,-1,-1,1,-1,5,-1
KR_6713251286,420,-3,-82,7,-2,1,1,2,3,4,7,-1,1,0,-2,2,0,-3,3,0,0,2,-106,-2,-1,3,-2,0,0,1,-1,-1,-1,5,-1
KR_6749625230,420,0,-69,4,-6,-2,4,2,-2,7,5,5,1,6,-6,6,0,-1,2,1,-2,-2,-3,-1,-1,2,2,0,-3,0,-1,-1,-1,0,-1
KR_6763827725,420,2,45,42,4,2,2,4,0,3,3,2,0,2,-1,1,0,1,0,1,0,4,-44,-3,-2,5,3,0,0,0,1,1,1,0,-1
KR_6759965343,420,-1,27,-24,-1,0,1,1,-4,7,3,-2,3,1,4,1,5,1,2,3,0,3,5,-2,0,2,0,0,0,0,-1,-1,-1,0,-1
KR_6686115251,440,-2,-150,35,2,0,1,1,3,0,3,4,0,4,-6,9,3,1,1,2,0,-8,0,2,-5,3,-2,0,0,-1,1,-1,1,4,-1
KR_6706694122,420,-4,-87,-32,-5,-4,5,1,0,4,4,-1,4,3,-1,2,1,1,0,1,0,0,186,-2,-1,3,1,0,-1,-1,-1,-1,-1,3,-1
KR_6749803529,420,-5,-107,-29,1,6,2,8,2,0,2,-4,4,0,-2,2,0,-1,2,1,1,-4,-50,-2,0,2,14,0,0,0,0,0,1,0,-1
KR_6750610620,440,1,-30,-24,5,1,0,1,1,1,2,3,1,4,-2,4,2,2,0,2,0,8,230,-3,-2,5,1,0,0,0,-1,-1,1,0,-1
KR_6652726258,420,0,20,12,1,-1,3,2,-3,4,1,1,3,4,6,1,7,-2,2,0,0,9,2,-3,-3,6,-2,0,0,1,0,0,1,3,-1
KR_6753726126,420,-2,34,0,0,-3,4,1,-2,3,1,2,0,2,3,2,5,0,1,1,0,1,1,-2,-1,3,0,0,-1,1,-1,-1,-1,4,-1
KR_6730577932,420,0,5,-8,1,2,0,2,4,1,5,0,1,1,-3,3,0,-2,3,1,0,0,-11,1,-3,2,-1,0,-1,1,-1,-1,1,2,-1
KR_6661818764,420,-9,-175,-41,-17,-14,15,1,0,2,2,-3,6,3,0,10,10,0,3,3,1,3,-277,-2,0,2,1,0,-5,-1,-1,-1,1,1,-1
KR_6745668511,420,-4,-67,17,-9,-1,1,0,-3,3,0,-2,2,0,0,1,1,-3,4,1,0,-5,20,-3,-1,4,-35,0,-1,1,0,-1,-1,1,-1
KR_6639238282,420,-4,-44,-11,-6,-5,5,0,-3,3,0,-4,6,2,5,2,7,1,2,3,0,2,41,6,-6,0,-3,0,-1,0,-1,1,1,0,-1
KR_6739671813,420,-5,-111,-25,-17,-2,4,2,-2,3,1,-7,7,0,-6,7,1,0,0,0,-1,-16,11,0,-2,2,-1,0,-1,0,0,-1,-1,0,-1
KR_6763278381,420,-1,-28,16,0,2,2,4,-3,4,1,-1,4,3,2,0,2,0,1,1,0,-3,2,-2,0,2,0,0,0,-1,1,-1,-1,4,-1
KR_6752149035,420,-1,-37,-16,1,-1,2,1,-3,6,3,1,3,4,1,1,2,3,2,5,0,10,-5,-3,0,3,2,0,-1,-1,-1,-1,1,1,-1
KR_6722753907,420,2,-63,-21,2,2,1,3,-1,2,1,-4,5,1,3,1,4,2,0,2,0,-3,36,3,-6,3,7,0,0,0,-1,-1,1,0,-1
KR_6708938177,420,0,-29,-8,0,2,2,4,-1,1,0,-1,2,1,-2,4,2,2,1,3,0,-2,22,-2,-1,3,0,0,0,1,-1,0,-1,4,-1
KR_6699916371,420,-3,-36,3,-6,3,3,6,2,1,3,-7,7,0,-3,4,1,-1,2,1,-1,-5,-400,5,-6,1,-3,0,0,1,1,-1,-1,1,-1
KR_6750113519,420,-4,-88,-4,-12,-4,4,0,2,2,4,-1,4,3,-8,10,2,-1,1,0,0,-4,-321,-1,0,1,-3,0,-2,1,-1,-1,-1,4,-1
KR_6706273744,420,0,75,9,-5,2,0,2,-1,2,1,-6,6,0,-1,2,1,1,0,1,0,-2,-10,-2,0,2,0,0,3,1,-1,1,-1,5,-1
KR_6760728680,440,-4,24,8,-12,0,1,1,-2,2,0,-7,9,2,-3,5,2,0,0,0,0,-7,-1,-1,-4,5,-2,0,0,-1,1,0,1,4,-1
KR_6683681848,420,0,11,23,2,5,0,5,-6,6,0,0,2,2,4,0,4,-1,1,0,0,0,-4,-2,0,2,-2,0,0,1,1,0,1,4,-1
KR_6690891032,420,-5,-126,-8,-9,-2,5,3,0,3,3,1,1,2,-6,6,0,-2,3,1,0,-6,-1,4,-5,1,-4,0,-3,-1,1,-1,-1,6,-1
KR_6629043699,420,-6,-72,0,-16,1,4,5,-6,6,0,-2,3,1,-9,9,0,0,1,1,0,-14,522,-1,-3,4,-2,0,0,0,1,1,-1,0,-1
KR_6739035669,420,-2,5,-12,-3,-4,5,1,1,1,2,-2,2,0,2,1,3,0,0,0,0,1,-36,1,-2,1,-1,0,0,1,-1,-1,1,4,-1
KR_6729858571,440,1,-22,12,-7,-4,5,1,-2,4,2,-2,3,1,0,2,2,1,1,2,0,-1,-508,2,-2,0,-2,0,1,1,1,1,1,1,-1
KR_6685688407,420,-2,0,-24,-3,0,0,0,-2,3,1,1,0,1,0,1,1,-2,2,0,0,-3,-2,1,-7,6,-3,0,0,1,1,-1,-1,2,-1
KR_6762019970,420,3,85,0,3,0,3,3,3,2,5,-1,5,4,0,2,2,1,0,1,0,-2,-1,0,-3,3,-1,0,0,-1,0,1,1,3,-1
KR_6764221542,420,-1,34,-28,-4,0,2,2,-5,6,1,4,1,5,-2,2,0,-1,1,0,0,-9,-9,0,-5,5,-1,0,1,1,1,1,-1,2,-1
KR_6663661256,420,-1,-49,12,-2,0,0,0,-2,4,2,-2,5,3,0,1,1,2,0,2,0,3,1,-6,-3,9,-9,0,-1,1,-1,-1,1,6,-1
KR_6620080852,440,-3,-38,-18,-8,2,2,4,-9,9,0,-1,4,3,0,3,3,0,0,0,-2,-12,-2,-3,-1,4,0,0,0,1,-1,-1,-1,2,-1
KR_6706293741,420,-3,-45,0,-10,0,2,2,-1,4,3,-6,8,2,-1,2,1,-2,3,1,0,-1,-3,-1,-2,3,-8,0,-2,0,0,-1,1,0,-1
KR_6722108828,420,-9,-24,-34,-23,-1,3,2,-4,4,0,-4,4,0,-10,10,0,-4,4,0,-2,-26,-5,-1,-3,4,-1,0,-3,-1,-1,-1,-1,4,-1
KR_6729981308,420,-5,-91,-16,-12,-2,3,1,-3,3,0,-6,6,0,0,3,3,-1,3,2,0,-5,14,1,-1,0,-2,0,0,-1,1,-1,-1,3,-1
KR_6744749037,420,2,45,-24,5,-1,2,1,1,4,5,1,1,2,2,3,5,2,1,3,0,5,26,2,-4,2,-5,0,1,1,-1,1,1,4,-1
KR_6708498634,420,-2,-63,-69,-11,-3,8,5,1,5,6,-3,6,3,-5,8,3,-1,1,0,0,-8,-217,-2,-2,4,-2,0,-3,1,-1,-1,1,1,-1
KR_6729406076,420,-4,11,-32,-10,-1,2,1,-5,5,0,-2,5,3,0,2,2,-2,2,0,0,-8,105,-3,0,3,-1,0,0,-1,-1,0,1,5,-1
KR_6683762997,420,-7,-24,-75,-9,0,0,0,1,0,1,1,3,4,-9,9,0,-2,2,0,0,-6,-11,-1,-1,2,0,0,0,-1,-1,1,-1,5,-1
KR_6662248653,420,4,8,44,-1,1,2,3,1,3,4,-4,6,2,0,3,3,1,0,1,0,3,-10,-2,-1,3,-1,0,-1,1,-1,-1,-1,1,-1
KR_6744625260,420,0,-28,-13,6,0,2,2,-4,4,0,3,1,4,4,0,4,3,0,3,1,12,-40,0,-2,2,20,0,-1,-1,1,-1,1,5,-1
KR_6761392714,420,1,6,-4,-2,4,0,4,-2,3,1,-5,6,1,3,0,3,-2,2,0,0,0,216,5,-6,1,2,0,0,1,1,0,-1,1,-1
KR_6718054001,420,0,-5,24,-4,0,2,2,-4,4,0,1,0,1,-4,6,2,3,3,6,0,-7,-5,-2,-4,6,2,0,-1,1,-1,-1,1,5,-1
KR_6704049570,420,-1,-85,11,-3,0,1,1,3,1,4,0,2,2,-3,3,0,-3,5,2,0,-5,7,2,-2,0,-2,0,-1,1,-1,-1,-1,5,-1
KR_6689873580,440,-2,-49,-12,-2,1,2,3,-1,3,2,-4,5,1,-1,4,3,3,0,3,1,2,-7,0,-5,5,1,0,0,-1,-1,-1,1,2,-1
KR_6737755063,420,1,-7,0,3,3,3,6,-1,2,1,-6,6,0,6,1,7,1,1,2,-1,7,11,1,-3,2,2,0,0,-1,-1,-1,-1,6,-1
KR_6726403458,420,-3,-63,-24,0,-1,1,0,2,2,4,-3,6,3,0,1,1,2,1,3,0,-1,19,1,-2,1,-1,0,-2,-1,1,-1,1,5,-1
KR_6760451988,420,-2,2,15,-8,0,1,1,-3,4,1,0,5,5,-4,4,0,-1,2,1,-2,-15,-7,-5,0,5,-2,0,-1,1,-1,-1,-1,2,-1
KR_6760869669,420,0,-23,-24,3,-1,1,0,2,2,4,3,2,5,-1,2,1,0,2,2,0,7,-40,2,-2,0,14,0,1,1,1,1,-1,4,-1
KR_6747117914,420,2,-44,24,3,1,1,2,2,0,2,-2,2,0,1,1,2,1,0,1,0,5,-36,-2,-5,7,14,0,0,-1,-1,0,1,2,-1
KR_6693421587,420,-2,-49,-28,-5,2,0,2,-1,1,0,-3,5,2,-1,1,0,-2,4,2,0,-3,-4,-9,-1,10,-1,0,0,0,0,0,1,0,-1
KR_6685846066,420,-4,-8,-49,-8,1,2,3,-4,6,2,-4,4,0,0,2,2,-1,2,1,0,-8,-5,-6,-1,7,1,0,0,1,-1,0,1,2,-1
KR_6745584675,420,1,11,-8,-1,-1,3,2,2,2,4,0,1,1,-2,3,1,0,2,2,0,2,-1,3,-5,2,-3,0,0,0,1,0,1,0,-1
KR_6676382015,420,-4,-82,-12,-6,0,2,2,-2,5,3,-6,6,0,0,1,1,2,0,2,1,-3,-10,1,-6,5,0,0,-2,1,1,-1,1,5,-1
KR_6727221360,420,-1,-44,8,2,-3,4,1,4,1,5,-7,7,0,6,0,6,2,0,2,0,12,4,-1,0,1,-2,0,1,-1,0,1,-1,2,-1
KR_6645823945,420,-2,-14,-12,-9,0,0,0,-2,4,2,-5,5,0,-1,4,3,-1,1,0,-2,-6,-1,1,-2,1,-2,0,0,-1,-1,-1,-1,4,-1
KR_6695530182,440,-4,-75,-24,-6,-4,4,0,-3,7,4,0,2,2,0,2,2,1,0,1,0,-3,-6,1,-3,2,0,0,-1,0,0,-1,1,0,-1
KR_6755427043,420,1,-64,-32,-1,6,1,7,-4,5,1,-1,2,1,-3,5,2,1,0,1,0,-1,-12,1,-2,1,1,0,-1,1,-1,-1,1,6,-1
KR_6757246092,420,1,38,-5,1,3,1,4,-2,4,2,-8,8,0,5,1,6,3,1,4,2,8,-11,-1,-2,3,7,0,1,1,-1,1,1,1,-1
KR_6741910844,420,-2,-10,0,-5,0,1,1,2,0,2,-3,3,0,-1,2,1,-3,4,1,0,-7,-5,3,-4,1,-5,0,-2,-1,-1,-1,1,3,-1
KR_6752156801,420,1,35,14,-3,2,2,4,-1,1,0,0,2,2,-4,4,0,0,0,0,0,-6,-11,3,-5,2,1,0,0,1,1,1,-1,3,-1
KR_6724340019,420,-5,-45,-24,-7,-2,4,2,-2,3,1,1,2,3,-1,1,0,-3,4,1,0,-9,-39,-3,0,3,17,0,-1,1,0,-1,1,1,-1
KR_6735259279,420,-4,-22,11,0,-5,6,1,-1,1,0,0,4,4,6,0,6,0,1,1,-1,-2,40,4,-7,3,-19,0,1,-1,1,1,-1,2,-1
KR_6663052689,440,-7,-142,-24,-18,-4,5,1,-1,3,2,-7,8,1,-1,1,0,-5,5,0,0,-11,-5,-6,0,6,0,0,-4,0,-1,-1,-1,0,-1
KR_6650494623,440,-1,-5,-25,1,0,1,1,1,2,3,-2,2,0,2,0,2,0,2,2,0,2,473,0,-2,2,-1,0,0,-1,0,0,-1,1,-1
KR_6744004738,420,-2,28,-37,-11,-8,9,1,1,0,1,-2,4,2,-1,2,1,-1,1,0,0,-6,4,-3,0,3,0,0,0,-1,1,-1,-1,5,-1
KR_6756889181,420,-3,-29,-16,-6,2,0,2,2,2,4,-8,8,0,-1,2,1,-1,2,1,1,3,-7,0,-2,2,1,0,-1,-1,1,-1,1,2,-1
KR_6736079670,420,-6,-106,-44,-13,-1,3,2,0,2,2,-5,7,2,-4,6,2,-3,4,1,1,-3,11,3,-3,0,-1,0,-1,-1,1,-1,1,1,-1
KR_6707258311,420,2,13,31,1,1,0,1,-3,5,2,2,3,5,-2,2,0,3,0,3,0,1,12,2,-4,2,-3,0,-1,-1,-1,-1,-1,2,-1
KR_6667055000,420,-1,-19,-8,-5,-1,1,0,-4,6,2,-3,5,2,3,1,4,0,1,1,0,2,22,1,-2,1,-3,0,-1,1,-1,-1,-1,5,-1
KR_6739921175,420,-3,-23,-12,-11,1,0,1,-6,7,1,-2,2,0,-3,3,0,-1,2,1,0,-15,7,5,-8,3,-5,0,0,-1,-1,-1,-1,3,-1
KR_6683035287,420,0,-1,24,3,3,0,3,-4,5,1,1,1,2,-1,2,1,4,1,5,-2,0,164,-1,-3,4,7,0,0,-1,0,-1,-1,1,-1
KR_6663392264,420,-6,-143,6,-4,-3,3,0,3,1,4,-1,2,1,-1,2,1,-2,3,1,1,-1,-30,-5,0,5,3,0,-1,-1,1,-1,1,4,-1
KR_6743235671,440,-2,17,-5,-3,2,0,2,-1,3,2,2,4,6,-2,3,1,-4,5,1,0,-14,1,-4,0,4,-1,0,0,-1,1,-1,1,3,-1
KR_6713374699,420,-1,26,-16,-2,0,4,4,0,3,3,-5,5,0,0,1,1,3,0,3,0,2,-7,-1,-5,6,1,0,0,1,-1,-1,-1,6,-1
KR_6758543722,420,-5,-88,-25,-10,-1,3,2,-1,2,1,-2,2,0,-6,8,2,0,2,2,0,-6,-361,-1,-3,4,2,0,-1,-1,-1,-1,-1,1,-1
KR_6762905201,420,-5,-31,-14,-13,-3,4,1,-3,4,1,-6,6,0,3,1,4,-4,6,2,0,-7,-12,4,-5,1,0,0,-2,1,-1,-1,-1,3,-1
KR_6758920113,420,-1,8,-1,-6,-5,6,1,5,0,5,-6,6,0,-1,3,2,1,0,1,0,-7,-13,-4,0,4,4,0,-1,1,-1,1,-1,5,-1
KR_6742663484,420,1,-11,-14,-5,1,1,2,-4,6,2,1,1,2,-2,3,1,-1,1,0,0,-7,6,0,-1,1,1,0,1,1,-1,1,1,3,-1
KR_6729607350,420,-4,-54,-27,-13,-3,3,0,-2,4,2,-7,8,1,-4,7,3,3,1,4,-1,-4,-4,2,-3,1,1,0,-4,1,0,-1,-1,3,-1
KR_6647238312,420,-1,38,-28,-6,2,0,2,-5,6,1,-3,4,1,1,1,2,-1,1,0,-1,-8,-154,4,-5,1,4,0,0,0,0,0,-1,0,-1
KR_6739113496,420,-1,79,10,-10,-2,2,0,-3,4,1,0,1,1,-4,5,1,-1,2,1,0,-14,5,-2,0,2,1,0,0,1,-1,0,1,3,-1
KR_6728667079,440,-3,21,16,-12,4,0,4,-4,6,2,-8,9,1,-3,4,1,-1,1,0,-1,-18,-11,-2,-3,5,2,0,0,-1,1,-1,-1,2,-1
KR_6731764799,420,-5,-68,-32,-10,0,3,3,-4,5,1,-3,4,1,-4,9,5,1,0,1,0,-3,-17,-5,-3,8,3,0,-1,1,1,-1,-1,5,-1
KR_6651689877,420,-3,-60,-15,-7,-5,5,0,1,1,2,0,3,3,-4,4,0,1,1,2,0,2,-365,3,-3,0,1,0,-1,-1,-1,-1,-1,1,-1
KR_6749025386,440,1,-6,-15,-2,-1,2,1,0,3,3,1,1,2,-2,5,3,0,0,0,0,-4,19,2,-5,3,-1,0,1,-1,-1,1,1,3,-1
KR_6724032547,440,-4,-89,-23,-10,-8,9,1,-3,4,1,3,2,5,-1,5,4,-1,2,1,0,-11,237,-2,-3,5,-1,0,-1,1,0,-1,-1,2,-1
KR_6647256106,420,-4,-24,-8,-11,1,1,2,-2,3,1,-4,7,3,-6,6,0,0,1,1,0,-12,-102,1,-6,5,-6,0,-1,0,-1,-1,-1,0,-1
KR_6756978666,420,-10,-140,-51,-15,-1,3,2,-2,5,3,-5,6,1,-7,7,0,0,0,0,0,-15,14,0,-2,2,1,0,-3,-1,1,-1,-1,5,-1
KR_6762445871,420,3,31,12,2,3,2,5,0,2,2,-3,4,1,2,1,3,0,0,0,0,6,-1,-2,0,2,1,0,1,-1,-1,1,1,5,-1
KR_6712286819,420,2,16,-1,6,1,0,1,0,3,3,0,1,1,3,1,4,2,0,2,0,3,-4,-3,-2,5,5,0,0,-1,-1,0,-1,3,-1
KR_6685328569,420,-1,-102,-19,-2,3,0,3,-1,5,4,-7,7,0,4,1,5,-1,1,0,0,10,2,3,-6,3,3,0,-1,0,-1,-1,-1,0,-1
KR_6718356709,420,-3,-17,4,-13,1,1,2,2,1,3,-2,2,0,-7,9,2,-7,7,0,0,-16,-113,-4,-3,7,2,0,-1,-1,-1,-1,-1,2,-1
KR_6733830418,420,-1,-17,8,2,1,1,2,1,1,2,-3,5,2,2,2,4,1,0,1,1,1,2,6,-6,0,2,0,0,1,-1,-1,1,5,-1
KR_6693431331,420,-4,33,-3,-9,-2,3,1,-4,5,1,-3,5,2,-1,2,1,1,0,1,0,-6,-25,-2,-2,4,2,0,-1,1,-1,-1,-1,1,-1
KR_6764141491,420,-3,-12,-8,-8,0,1,1,-4,7,3,-4,5,1,-1,2,1,1,2,3,0,0,-6,-1,-1,2,-3,0,-2,-1,0,-1,1,2,-1
KR_6732537336,420,-3,-40,-9,-9,2,0,2,-2,4,2,-3,3,0,-5,7,2,-1,1,0,0,-17,-22,-3,-2,5,3,0,-1,-1,-1,-1,-1,5,-1
KR_6739003830,420,-4,-13,29,-10,-1,2,1,-1,8,7,-4,4,0,-4,6,2,0,0,0,-1,-9,17,1,-3,2,-3,0,0,-1,1,0,-1,3,-1
KR_6663880813,420,-5,-118,0,-16,-7,7,0,4,1,5,-3,5,2,-9,9,0,-1,1,0,0,-6,-14,-5,0,5,-3,0,-2,-1,0,-1,-1,4,-1
KR_6735348949,420,-3,-36,-4,-8,-5,5,0,0,1,1,0,1,1,-2,2,0,-1,1,0,-1,-7,-1,0,-3,3,-1,0,-1,-1,-1,-1,-1,2,-1
KR_6736094190,420,-5,-33,-18,-7,-2,2,0,-1,1,0,-2,2,0,0,1,1,-2,3,1,0,-2,-6,-1,-2,3,-2,0,-1,0,0,-1,-1,0,-1
KR_6726569275,420,0,-10,12,1,2,0,2,0,2,2,-1,3,2,-2,4,2,2,0,2,0,-1,-10,2,-3,1,0,0,0,1,1,0,1,6,-1
KR_6726741194,420,0,4,32,-3,2,0,2,-10,11,1,2,2,4,2,2,4,1,0,1,0,-5,38,4,-4,0,1,0,0,1,1,1,1,2,-1
KR_6644397892,420,-5,-152,3,-14,-4,4,0,-3,3,0,-4,6,2,-2,3,1,-1,1,0,0,-10,3,-2,-1,3,-3,0,0,1,-1,-1,-1,2,-1
KR_6759142893,420,-4,-132,-8,-10,-1,1,0,-4,6,2,-3,3,0,2,0,2,-4,4,0,0,-7,-14,-1,-1,2,1,0,-1,0,0,-1,-1,0,-1
KR_6758751565,420,-2,-55,4,-7,-4,5,1,3,1,4,-4,5,1,3,1,4,-5,5,0,0,-2,340,1,-4,3,28,0,-1,-1,1,-1,-1,3,-1
KR_6738492864,420,-2,-88,15,-6,-3,3,0,2,2,4,0,2,2,-5,5,0,0,0,0,0,-5,-2,0,-2,2,-1,0,0,1,1,-1,-1,2,-1
KR_6763262879,420,0,34,4,2,3,0,3,-1,2,1,-4,4,0,3,1,4,1,0,1,0,1,0,4,-6,2,0,0,2,1,-1,1,1,4,-1
KR_6759240194,440,-2,-108,-18,-1,-1,2,1,-1,5,4,2,0,2,1,1,2,-2,3,1,0,1,314,-1,-1,2,3,0,0,-1,1,0,-1,4,-1
KR_6741794285,420,-4,-54,0,-9,-5,6,1,1,3,4,-3,6,3,1,4,5,-3,3,0,1,-4,-14,-2,0,2,1,0,-1,-1,-1,-1,-1,4,-1
KR_6648082954,420,-1,-19,-4,-3,-1,2,1,-1,1,0,2,1,3,-4,5,1,1,2,3,0,-4,5,-6,-1,7,2,0,-1,0,-1,-1,-1,0,-1
KR_6755064353,420,0,-81,0,2,1,1,2,-1,2,1,0,0,0,2,1,3,0,0,0,0,1,-9,-5,-1,6,0,0,1,-1,1,1,-1,6,-1
KR_6760661525,420,2,19,23,2,2,1,3,0,6,6,-2,3,1,1,2,3,1,2,3,0,-5,27,3,-3,0,1,0,1,0,1,1,1,0,-1
KR_6651390050,420,2,40,0,-4,-4,4,0,0,3,3,1,3,4,0,2,2,-1,2,1,0,0,45,0,-5,5,2,0,1,-1,1,1,1,3,-1
KR_6741604947,420,-5,-110,-20,-9,0,1,1,-6,10,4,-2,6,4,-1,3,2,0,1,1,-1,-11,145,-2,-1,3,-2,0,-1,-1,-1,-1,-1,6,-1
KR_6758158505,440,-2,-41,-20,-7,3,0,3,2,1,3,-2,5,3,-8,8,0,-2,3,1,0,-13,-9,0,-1,1,3,0,-2,-1,0,-1,1,2,-1
KR_6686039477,420,-3,-48,-24,-9,-4,4,0,-1,2,1,1,2,3,-4,4,0,-1,1,0,0,-6,-251,-1,-3,4,-2,0,-1,1,-1,-1,-1,1,-1
KR_6759848705,440,-2,-19,9,-7,1,2,3,3,0,3,-1,1,0,-4,5,1,-6,6,0,0,-12,-45,-4,0,4,20,0,-1,-1,1,-1,-1,2,-1
KR_6749701042,420,-2,53,-18,-4,0,1,1,0,3,3,1,1,2,-4,8,4,-1,5,4,-1,-10,-13,-2,-2,4,2,0,-1,-1,1,-1,-1,3,-1
KR_6640177584,420,-3,12,-4,-1,-1,3,2,3,2,5,1,3,4,1,0,1,-5,5,0,0,2,1,0,-2,2,1,0,0,1,-1,0,-1,3,-1
KR_6726044592,420,-3,-78,-7,-3,-2,3,1,-1,6,5,0,0,0,0,2,2,0,1,1,0,1,19,2,-3,1,-1,0,-1,1,1,-1,-1,5,-1
KR_6655983948,420,0,-38,-19,2,5,0,5,1,0,1,2,1,3,-4,4,0,-2,3,1,0,1,118,-2,0,2,0,0,0,-1,-1,1,-1,1,-1
KR_6708405971,420,-5,-73,-37,-6,-10,15,5,0,2,2,1,1,2,2,3,5,1,0,1,0,13,230,1,-4,3,-1,0,-2,-1,-1,-1,1,5,-1
KR_6760688903,420,-4,-60,12,-7,2,1,3,-2,6,4,-3,5,2,-5,5,0,1,0,1,-1,-6,-6,3,-4,1,-2,0,0,1,-1,0,-1,2,-1
KR_6676485204,420,2,39,4,2,1,0,1,2,0,2,3,1,4,-2,3,1,-2,3,1,0,-1,13,4,-6,2,-3,0,0,1,-1,0,1,3,-1
KR_6652977819,420,-1,-33,16,-4,1,2,3,-1,1,0,-2,3,1,-3,4,1,1,0,1,0,-5,-236,-3,-1,4,-3,0,-2,0,1,-1,1,0,-1
KR_6726109484,420,-3,-99,0,-8,-3,3,0,6,2,8,-5,6,1,-7,8,1,1,1,2,0,-5,-48,-3,-2,5,22,0,-1,-1,1,-1,-1,4,-1
KR_6762594519,420,2,-30,36,-2,0,1,1,-4,6,2,1,1,2,-2,2,0,3,0,3,0,-4,2,3,-5,2,0,0,0,1,1,0,-1,3,-1
KR_6659632277,420,-2,1,-18,-8,0,2,2,-3,4,1,6,2,8,-5,11,6,-6,7,1,1,-5,-2,5,-7,2,-3,0,0,-1,0,0,1,6,-1
KR_6758548666,420,-2,-4,-26,-5,1,0,1,-3,5,2,-2,5,3,-2,5,3,1,1,2,0,-7,2,1,-4,3,-2,0,1,-1,0,1,-1,6,-1
KR_6754231572,420,-3,-15,-40,-7,-1,1,0,-2,4,2,-3,4,1,-3,3,0,2,0,2,0,-5,1,-4,0,4,0,0,0,0,0,0,-1,0,-1
KR_6764312986,420,-8,-131,-16,-20,-4,4,0,-4,4,0,-10,10,0,-2,4,2,0,0,0,0,-8,-9,-3,-2,5,-2,0,-2,-1,-1,-1,-1,6,-1
KR_6735031639,420,0,69,5,-1,2,3,5,6,1,7,-7,8,1,0,4,4,-2,3,1,-2,5,-106,-1,-2,3,0,0,1,-1,1,1,-1,6,-1
KR_6681401948,420,1,-54,24,2,2,2,4,2,1,3,3,2,5,0,3,3,-5,6,1,-1,-5,-7,-2,0,2,1,0,0,1,1,-1,-1,1,-1
KR_6750272739,420,-4,-85,42,-10,-6,6,0,0,1,1,-1,2,1,-2,3,1,-1,2,1,0,-11,6,-1,-6,7,-5,0,-1,-1,1,-1,-1,5,-1
KR_6700475792,420,-1,-46,56,-4,3,0,3,-3,3,0,-4,6,2,1,1,2,-1,2,1,0,-10,11,-2,-1,3,1,0,-4,-1,1,-1,1,2,-1
KR_6735144301,420,-2,-40,-32,-5,-3,3,0,5,2,7,-2,3,1,-2,3,1,-3,3,0,0,-6,128,3,-6,3,2,0,-1,-1,-1,-1,-1,2,-1
KR_6689849930,420,-2,-92,-8,-3,-4,5,1,-3,5,2,2,1,3,2,0,2,0,0,0,1,-11,-8,-3,-3,6,2,0,-2,1,-1,-1,1,1,-1
KR_6657620859,420,-1,-56,-18,-2,-1,1,0,-1,6,5,4,0,4,-7,8,1,3,0,3,1,1,321,-1,-3,4,1,0,0,1,-1,-1,1,4,-1
KR_6749626158,420,0,-61,-16,3,1,2,3,0,1,1,-3,5,2,5,1,6,0,0,0,0,10,6,-1,-2,3,0,0,-1,-1,1,-1,1,1,-1
KR_6743016480,440,2,-29,36,1,-3,3,0,0,0,0,2,2,4,-1,6,5,3,1,4,0,0,42,3,-3,0,-19,0,1,-1,1,1,-1,4,-1
KR_6760164668,420,-6,-90,-30,-8,3,0,3,0,0,0,-7,7,0,-4,4,0,0,1,1,1,-5,304,-5,-3,8,1,0,-3,-1,1,-1,1,3,-1
KR_6622104569,420,-5,-125,16,-1,1,1,2,1,0,1,-1,1,0,0,1,1,-2,4,2,0,1,-3,-1,-1,2,-6,0,-3,-1,-1,-1,1,5,-1
KR_6744691328,420,-2,0,-9,-10,0,2,2,-2,6,4,-10,10,0,2,0,2,0,2,2,0,-9,8,-3,-1,4,0,0,-2,-1,-1,-1,-1,3,-1
KR_6758845635,420,-4,-56,-8,-9,-4,6,2,-2,4,2,0,2,2,-1,1,0,-2,2,0,0,0,2,2,-4,2,-1,0,-4,-1,0,-1,-1,2,-1
KR_6722775976,420,1,40,-29,-5,0,1,1,-3,5,2,-4,4,0,2,1,3,0,0,0,0,-4,-24,-1,-1,2,3,0,0,0,0,0,1,0,-1
KR_6758504651,420,-1,34,-22,-5,-2,4,2,-4,5,1,-1,3,2,1,1,2,1,3,4,0,-1,-5,-2,-2,4,-2,0,0,1,0,1,1,6,-1
KR_6660182652,420,-2,53,-16,-11,-1,2,1,-1,3,2,0,2,2,-5,7,2,-4,4,0,0,-8,-2,0,-2,2,-1,0,0,-1,-1,0,-1,6,-1
KR_6754182490,420,-7,-153,-12,-8,-7,8,1,-4,5,1,-5,5,0,6,2,8,2,2,4,0,2,1,2,-2,0,1,0,-2,1,0,-1,-1,6,-1
KR_6746217317,420,2,87,7,6,6,0,6,0,1,1,-1,4,3,0,1,1,1,0,1,0,7,-4,-1,-2,3,4,0,2,1,-1,1,1,2,-1
KR_6749890099,420,-2,-77,16,-9,-1,2,1,1,4,5,2,1,3,-10,10,0,-1,1,0,-1,-10,-20,-7,-3,10,2,0,0,0,1,0,1,0,-1
KR_6684446534,420,2,36,-16,3,9,0,9,-4,4,0,0,1,1,-2,2,0,0,1,1,0,-4,-7,0,-1,1,-1,0,0,-1,0,1,1,2,-1
KR_6694059485,420,-4,-126,-32,-8,-7,7,0,1,0,1,0,0,0,0,1,1,-2,2,0,0,0,42,-2,-2,4,-25,0,-1,1,-1,-1,-1,6,-1
KR_6730753260,420,-4,-63,-8,-8,1,0,1,-1,4,3,0,2,2,-9,9,0,1,1,2,0,-10,0,0,-3,3,-2,0,-1,1,0,-1,-1,1,-1
KR_6684924748,420,-2,6,13,2,-2,5,3,3,1,4,-1,1,0,1,4,5,1,0,1,2,13,20,5,-7,2,-1,0,-1,1,-1,-1,1,6,-1
KR_6762890061,420,-1,-27,-20,-9,3,0,3,-5,5,0,-3,3,0,-1,2,1,-3,3,0,0,-9,8,-1,-2,3,-1,0,0,-1,1,0,-1,6,-1
KR_6757191662,420,-4,-27,-23,0,0,3,3,0,4,4,1,2,3,-1,2,1,0,1,1,0,6,1,0,-2,2,-5,0,-3,-1,-1,-1,1,3,-1
KR_6703166122,420,-4,12,-9,-14,-7,8,1,-3,4,1,-4,6,2,-1,2,1,1,1,2,1,-4,-8,-2,-1,3,-2,0,-1,-1,-1,-1,1,2,-1
KR_6760933499,420,-1,-17,-16,-3,1,2,3,3,2,5,-7,7,0,-2,3,1,2,0,2,0,-4,-1,-3,0,3,1,0,-2,1,1,-1,1,4,-1
KR_6759545182,420,0,-17,-4,-3,-1,3,2,-2,2,0,-1,3,2,-1,8,7,2,1,3,-1,-3,-52,-3,-2,5,18,0,-1,1,1,-1,-1,6,-1
KR_6754238241,420,-1,133,-29,-2,0,1,1,0,1,1,-2,3,1,1,0,1,-1,1,0,0,-4,3,1,-2,1,2,0,1,1,1,1,1,4,-1
KR_6757417601,440,-1,-79,21,-7,2,3,5,3,2,5,2,2,4,-10,10,0,-4,4,0,0,-8,-11,2,-2,0,1,0,1,-1,1,-1,1,2,-1
KR_6715209858,440,-2,-82,-13,-9,-3,3,0,-1,3,2,-4,4,0,-3,5,2,2,0,2,-1,-11,2,-2,0,2,0,0,0,-1,0,-1,-1,5,-1
KR_6723047883,420,-2,-24,12,-7,-3,3,0,-3,5,2,0,6,6,1,0,1,-2,2,0,0,-9,-2,-7,0,7,2,0,1,-1,1,1,-1,3,-1
KR_6752432089,420,1,86,28,-1,5,0,5,2,0,2,-1,1,0,-6,7,1,-1,2,1,0,-7,58,1,-2,1,-32,0,1,-1,1,1,1,2,-1
KR_6762211646,440,-4,-54,15,-10,-7,7,0,3,0,3,-3,4,1,-2,3,1,-1,1,0,0,-4,78,0,-3,3,-20,0,-1,0,-1,-1,-1,0,-1
KR_6647162127,420,-3,-80,-16,-4,-6,6,0,4,0,4,-3,5,2,-1,3,2,2,0,2,0,9,-4,-3,-2,5,1,0,-1,1,1,-1,-1,5,-1
KR_6749765196,420,0,31,11,-6,-1,2,1,-3,3,0,-6,7,1,3,0,3,1,1,2,0,-6,8,-4,-1,5,1,0,1,-1,-1,1,1,6,-1
KR_6644761182,420,-3,-56,7,-13,-2,2,0,-5,5,0,-2,5,3,-5,6,1,1,0,1,-3,-20,6,-1,-2,3,-1,0,-2,-1,-1,-1,-1,3,-1
KR_6755440896,420,3,23,2,7,5,0,5,4,0,4,1,0,1,-2,4,2,-1,2,1,0,6,9,3,-5,2,2,0,2,1,1,1,1,1,-1
KR_6755336369,420,0,20,8,0,4,0,4,-1,2,1,-4,7,3,1,2,3,0,1,1,0,-5,0,1,-6,5,-3,0,0,-1,1,0,-1,3,-1
KR_6747750413,420,-1,26,12,-1,4,0,4,0,1,1,-4,6,2,-1,2,1,0,1,1,0,-12,-3,2,-2,0,-1,0,-1,1,0,-1,1,3,-1
KR_6726526020,420,-5,-96,5,-14,-1,1,0,-3,4,1,-3,5,2,-6,6,0,-1,1,0,0,-6,-329,3,-6,3,1,0,-1,-1,-1,-1,-1,1,-1
KR_6757024066,420,1,-32,15,-1,3,1,4,5,3,8,-6,7,1,-4,5,1,1,0,1,0,-6,-165,-1,-4,5,18,0,-1,-1,-1,-1,1,4,-1
KR_6659661922,420,2,81,-8,-4,-1,2,1,0,5,5,6,0,6,-4,8,4,-5,5,0,-1,-4,-355,-2,-2,4,4,0,-1,1,-1,1,-1,1,-1
KR_6757677535,420,3,-20,64,-2,-1,3,2,-6,7,1,0,1,1,4,2,6,1,1,2,0,-2,5,-2,-1,3,0,0,2,1,1,1,-1,4,-1
KR_6619762689,440,-4,-39,-12,-11,1,2,3,-4,5,1,0,0,0,-6,6,0,-2,3,1,0,-10,-9,-2,-5,7,0,0,-1,0,-1,-1,-1,0,-1
KR_6740926713,420,1,78,29,0,3,0,3,2,1,3,-2,3,1,3,2,5,-6,10,4,0,-2,6,5,-6,1,1,0,0,1,1,1,1,6,-1
KR_6753267393,420,-2,-1,7,-2,1,1,2,1,0,1,1,0,1,-6,7,1,1,0,1,0,4,-17,-1,-1,2,-5,0,0,-1,1,0,1,1,-1
KR_6720920445,420,-5,-40,-29,-13,4,1,5,-3,3,0,4,0,4,-12,12,0,-6,6,0,0,-19,-38,-5,0,5,1,0,-2,-1,-1,-1,-1,3,-1
KR_6651146417,420,4,38,-5,7,1,1,2,-5,7,2,10,2,12,-2,4,2,3,1,4,0,-9,4,5,-5,0,1,0,2,1,0,1,-1,2,-1
KR_6688532789,420,0,-31,-12,1,-2,3,1,1,0,1,-1,4,3,6,0,6,-3,3,0,-1,0,-16,0,-2,2,5,0,0,1,1,0,-1,6,-1
KR_6759850102,420,-2,-99,-4,0,1,1,2,0,3,3,-5,5,0,3,3,6,1,0,1,0,4,1,1,-3,2,1,0,-1,1,-1,-1,-1,3,-1
KR_6724337419,420,-2,-24,0,-13,-8,8,0,-1,1,0,-8,9,1,1,1,2,3,2,5,0,-6,-2,0,-1,1,0,0,-3,-1,-1,-1,-1,1,-1
KR_6727227714,420,-5,21,-20,-17,-2,3,1,-8,8,0,-1,4,3,-3,6,3,-3,4,1,-3,-25,-8,-4,-6,10,7,0,0,-1,-1,-1,-1,2,-1
KR_6734298549,420,1,-9,0,4,2,0,2,1,2,3,-5,5,0,5,6,11,1,0,1,0,4,-8,0,-5,5,1,0,-1,0,0,-1,-1,0,-1
KR_6705628516,420,-1,-39,-12,2,1,1,2,0,2,2,0,3,3,8,2,10,-7,9,2,0,8,2,2,-5,3,-1,0,1,1,-1,1,1,1,-1
KR_6746632151,420,2,1,33,-2,-6,6,0,4,2,6,1,1,2,0,1,1,-1,2,1,-1,4,-10,-2,-3,5,2,0,0,-1,1,0,-1,4,-1
KR_6659738098,420,-6,-56,15,-19,-5,5,0,-2,3,1,-5,5,0,-3,6,3,-4,4,0,-1,-14,16,-3,-2,5,2,0,-2,-1,-1,-1,-1,2,-1
KR_6701045242,420,-3,-62,4,-3,-2,3,1,-4,5,1,1,2,3,1,1,2,1,0,1,0,-3,36,4,-6,2,-22,0,1,-1,1,1,-1,4,-1
KR_6740990437,440,1,-8,-24,3,2,0,2,-1,3,2,2,2,4,-1,1,0,1,0,1,0,-2,-263,-3,0,3,2,0,0,-1,0,-1,-1,6,-1
KR_6732396979,420,-3,-67,-37,-7,-2,4,2,1,1,2,0,0,0,-4,4,0,-2,2,0,0,-6,10,9,-9,0,-5,0,-1,1,-1,-1,1,6,-1
KR_6748444082,420,-5,-45,-6,-15,3,1,4,-4,6,2,-5,6,1,-8,9,1,-1,2,1,0,-21,19,-1,-2,3,-4,0,0,-1,-1,1,-1,1,-1
KR_6755928594,420,-1,-27,-2,-5,-2,3,1,-2,2,0,-7,7,0,4,3,7,2,1,3,-1,-1,15,0,-4,4,0,0,-1,-1,-1,-1,-1,5,-1
KR_6663214430,420,-4,-35,0,-13,-2,3,1,-1,4,3,-5,6,1,-2,3,1,-3,3,0,-3,-12,27,0,-4,4,-3,0,0,-1,-1,0,-1,2,-1
KR_6712582024,420,2,59,-24,-1,3,0,3,-3,6,3,1,1,2,-1,5,4,-1,3,2,1,1,-7,5,-5,0,1,0,2,-1,-1,1,1,2,-1
KR_6754609181,420,-1,38,12,-1,-3,5,2,-3,4,1,2,0,2,0,2,2,3,1,4,0,0,49,-2,-2,4,-14,0,0,1,-1,-1,1,6,-1
KR_6741518004,420,-4,-39,12,-15,0,1,1,-5,5,0,0,2,2,-6,7,1,-4,4,0,0,-17,4,-3,-2,5,1,0,0,-1,-1,0,-1,3,-1
KR_6715962847,440,-1,-19,8,-5,-3,5,2,-4,4,0,1,1,2,3,3,6,-2,4,2,0,-2,-6,0,-1,1,-1,0,-2,1,0,-1,-1,3,-1
KR_6708710118,420,-1,-4,7,-9,-1,2,1,1,2,3,-8,8,0,-1,1,0,0,0,0,0,-7,4,-1,-1,2,2,0,0,-1,-1,0,1,4,-1
KR_6630578429,420,-3,-13,9,-8,-7,8,1,-5,5,0,1,3,4,2,0,2,1,1,2,0,-10,-6,1,-2,1,2,0,-2,-1,1,-1,1,5,-1
KR_6764072976,420,-1,-9,0,1,2,0,2,4,0,4,-2,2,0,-4,4,0,1,0,1,0,4,1,0,-4,4,-1,0,0,0,1,1,1,0,-1
KR_6704994929,420,-7,-56,-18,-14,-3,3,0,0,0,0,-1,3,2,-9,10,1,-1,2,1,0,-10,38,0,-3,3,-15,0,-1,1,-1,-1,-1,4,-1
KR_6741846511,420,-2,-29,-15,-11,0,2,2,2,3,5,-6,6,0,-4,5,1,-3,4,1,0,-13,-318,-5,0,5,-11,0,-3,-1,-1,-1,1,2,-1
KR_6720006626,420,2,7,19,0,1,0,1,0,1,1,0,2,2,0,1,1,-1,1,0,-1,-4,-11,-3,-2,5,1,0,-1,-1,1,-1,-1,1,-1
KR_6733408465,420,-2,-35,12,-11,-2,3,1,-2,3,1,-6,6,0,-2,3,1,1,1,2,-2,-14,0,0,-2,2,2,0,-3,-1,-1,-1,-1,1,-1
KR_6717007063,420,2,26,8,-3,2,2,4,-1,2,1,-2,2,0,-4,6,2,2,0,2,0,-7,356,-1,-1,2,2,0,1,-1,-1,1,1,5,-1
KR_6729472414,420,-5,-168,7,-13,-4,5,1,-5,7,2,0,1,1,-4,5,1,0,1,1,0,-3,-13,-3,-3,6,-3,0,-4,0,-1,-1,-1,0,-1
KR_6755044722,420,-2,28,8,-4,-1,1,0,-2,4,2,-4,4,0,4,1,5,-1,1,0,0,-2,-9,-4,-3,7,-1,0,0,1,0,0,-1,3,-1
KR_6678287806,440,-4,-78,-26,-6,1,3,4,-1,2,1,-1,3,2,-3,3,0,-2,2,0,-2,-10,-1,-2,-4,6,0,0,-1,-1,0,-1,-1,5,-1
KR_6739068910,420,1,-15,4,2,1,1,2,-1,4,3,2,1,3,0,1,1,0,0,0,0,-3,4,0,-4,4,-3,0,0,1,0,0,1,5,-1
KR_6733657982,420,-1,52,-12,-4,-4,4,0,3,0,3,0,6,6,-4,6,2,1,0,1,0,-5,29,1,-5,4,-4,0,1,-1,1,1,1,4,-1
KR_6758292526,440,-7,-130,-4,-9,-1,1,0,-2,5,3,-5,7,2,2,0,2,-3,4,1,-1,-7,3,2,-2,0,0,0,-1,1,-1,-1,-1,2,-1
KR_6645831520,420,-7,-75,-4,-13,-2,2,0,-1,2,1,-3,5,2,-7,8,1,0,0,0,0,-10,4,-5,-3,8,-3,0,-1,-1,-1,-1,-1,4,-1
KR_6682183933,420,-3,-116,2,-9,-9,11,2,1,1,2,-3,8,5,3,1,4,-1,1,0,-1,-5,-6,-1,-2,3,1,0,-2,-1,-1,-1,-1,2,-1
KR_6752701744,420,0,52,-28,-3,2,1,3,-6,6,0,-1,1,0,4,1,5,-2,3,1,-1,-13,3,-3,-1,4,1,0,0,-1,-1,0,-1,5,-1
KR_6728048142,420,-2,-42,8,-4,4,0,4,2,1,3,-8,8,0,-2,3,1,0,1,1,0,-4,-10,1,-3,2,-1,0,0,1,1,-1,-1,4,-1
KR_6722889680,420,-5,-18,-19,-14,-3,5,2,-2,2,0,0,1,1,-9,10,1,0,2,2,0,-9,-8,2,-2,0,-2,0,-2,-1,1,-1,-1,6,-1
KR_6708304564,420,-4,-47,4,-4,-1,2,1,0,1,1,-2,3,1,-3,6,3,2,0,2,0,3,14,-2,-1,3,-2,0,-1,1,-1,-1,1,2,-1
KR_6726668395,420,0,20,4,-4,0,2,2,-2,2,0,1,3,4,1,3,4,-4,4,0,0,-2,-5,1,-2,1,-4,0,0,-1,-1,0,-1,2,-1
KR_6704780961,420,3,75,-6,4,-1,1,0,0,3,3,0,2,2,4,2,6,1,2,3,0,7,2,1,-3,2,1,0,0,1,-1,0,-1,6,-1
KR_6747228115,420,3,-11,0,6,-2,3,1,4,0,4,3,0,3,2,5,7,-1,3,2,0,8,15,-1,-3,4,-1,0,1,-1,-1,1,-1,5,-1
KR_6748806428,420,-1,2,4,2,1,0,1,-3,6,3,4,2,6,1,1,2,-1,2,1,0,-2,17,0,-2,2,-2,0,0,0,1,0,1,0,-1
KR_6763387227,420,-1,-32,-12,4,1,0,1,-1,2,1,-2,3,1,4,1,5,2,0,2,0,7,-7,0,-5,5,-2,0,0,-1,0,0,-1,1,-1
KR_6703945284,420,-3,-12,-16,-5,6,1,7,-3,3,0,-3,3,0,0,2,2,-5,5,0,-3,-13,-45,-2,0,2,7,0,1,-1,-1,1,-1,3,-1
KR_6696376208,420,-1,-39,23,-2,1,2,3,0,4,4,-4,6,2,-1,3,2,2,1,3,0,3,-289,2,-3,1,0,0,0,-1,1,1,-1,4,-1
KR_6701857544,420,3,39,20,3,2,0,2,-4,5,1,-3,3,0,7,0,7,1,1,2,0,3,8,1,-6,5,2,0,1,1,-1,1,1,5,-1
KR_6744048675,420,1,13,32,1,-1,1,0,-1,4,3,1,2,3,1,3,4,1,2,3,0,4,-10,-1,0,1,0,0,-2,0,-1,-1,1,0,-1
KR_6704681774,440,-4,11,0,-14,-3,3,0,-3,4,1,-8,8,0,0,1,1,0,2,2,-1,-19,6,-1,-3,4,-2,0,0,1,1,0,-1,1,-1
KR_6703082868,420,-1,-5,-3,-4,3,0,3,-5,6,1,0,1,1,-1,3,2,-1,2,1,0,-8,7,3,-4,1,0,0,0,-1,0,0,-1,6,-1
KR_6718830248,420,-3,2,-12,-11,-5,5,0,-2,4,2,-3,4,1,-2,4,2,1,1,2,0,-4,-252,0,-2,2,-5,0,0,-1,-1,-1,-1,4,-1
KR_6759511679,420,0,-45,16,-6,-1,3,2,0,4,4,0,4,4,-2,5,3,-3,3,0,0,-15,5,4,-5,1,-4,0,0,0,1,0,1,0,-1
KR_6753330464,420,-1,-12,-24,-7,1,0,1,-4,5,1,-1,2,1,-2,2,0,-1,1,0,0,-4,-18,-3,-2,5,-2,0,0,-1,-1,-1,-1,3,-1
KR_6723198562,420,0,52,4,-3,1,0,1,-1,3,2,0,0,0,-1,2,1,-2,2,0,-2,-5,198,-5,0,5,-5,0,0,1,1,0,-1,6,-1
KR_6715603449,420,-7,-74,-11,-17,-2,4,2,-3,4,1,-3,3,0,-6,6,0,-3,4,1,0,-15,-16,-3,-1,4,-2,0,-3,-1,-1,-1,-1,4,-1
KR_6760394126,420,-3,43,-32,-6,-1,1,0,-1,3,2,-1,2,1,-4,4,0,1,2,3,0,-3,124,0,-4,4,-1,0,-1,1,-1,-1,1,6,-1
KR_6737620295,420,2,51,8,12,6,1,7,1,1,2,-3,3,0,5,1,6,3,0,3,0,10,210,-1,-1,2,18,0,0,-1,-1,1,-1,2,-1
KR_6738558629,440,-4,-97,-28,-14,0,3,3,0,1,1,-6,8,2,0,1,1,-8,9,1,-1,-1,6,1,-2,1,2,0,-2,-1,-1,-1,-1,2,-1
KR_6722893084,420,2,54,13,-2,-1,1,0,-4,5,1,2,0,2,-1,5,4,2,3,5,-1,-9,-1,-1,-4,5,1,0,0,-1,-1,0,-1,4,-1
KR_6745650164,420,-1,-70,40,-2,0,3,3,-1,2,1,-1,3,2,0,0,0,0,0,0,0,-1,5,-1,-4,5,-4,0,-1,1,-1,-1,-1,2,-1
KR_6725060298,420,-2,-3,-46,0,4,2,6,-2,4,2,4,1,5,-3,5,2,-3,3,0,0,-4,-6,-4,0,4,0,0,1,1,1,1,1,2,-1
KR_6727090616,420,2,-15,-4,2,0,3,3,-1,3,2,1,2,3,1,2,3,1,1,2,0,1,21,-1,-4,5,-17,0,0,-1,-1,0,-1,4,-1
KR_6742887497,440,-4,-111,-24,-11,-1,1,0,-4,5,1,1,1,2,-6,8,2,-1,1,0,0,-11,-32,1,-2,1,-2,0,0,1,-1,0,1,5,-1
KR_6713168340,420,3,95,22,13,2,0,2,-1,2,1,4,0,4,3,1,4,5,0,5,-1,6,1,-3,-3,6,2,0,1,1,-1,1,-1,6,-1
KR_6751141876,420,0,-4,-11,-4,-1,3,2,0,3,3,-6,9,3,2,0,2,1,1,2,0,4,19,4,-5,1,0,0,0,-1,1,-1,-1,1,-1
KR_6763445976,420,3,-63,24,11,1,2,3,-3,3,0,3,0,3,1,3,4,9,1,10,0,14,5,2,-2,0,0,0,0,0,1,1,-1,0,-1
KR_6713396235,420,2,84,21,10,9,0,9,0,2,2,0,3,3,0,3,3,1,0,1,3,6,-65,-1,-1,2,1,0,1,0,0,1,1,0,-1
KR_6645773684,420,-3,-2,-20,-13,1,2,3,-4,5,1,-3,6,3,-1,5,4,-6,6,0,-1,-6,-13,-3,0,3,0,0,-1,-1,-1,-1,-1,5,-1
KR_6669423459,420,0,-76,16,-7,1,0,1,-7,8,1,4,1,5,-4,4,0,-1,1,0,0,-12,17,0,-4,4,0,0,0,-1,-1,0,-1,3,-1
KR_6751362870,440,-3,-46,-11,-8,-2,2,0,-3,4,1,2,2,4,-2,3,1,-3,3,0,1,-7,3,4,-9,5,-3,0,-1,0,-1,-1,1,0,-1
KR_6762393737,420,2,29,-7,8,5,0,5,3,3,6,-1,2,1,0,0,0,1,1,2,0,5,-9,0,-2,2,0,0,0,1,1,0,1,6,-1
KR_6759310564,440,1,-7,-24,4,4,1,5,2,0,2,-2,3,1,1,2,3,-1,1,0,0,5,0,-1,-2,3,-7,0,0,-1,-1,1,-1,6,-1
KR_6647081999,420,-2,-70,-20,-2,-1,1,0,-2,2,0,-1,2,1,0,0,0,2,0,2,0,0,-2,-2,-4,6,-1,0,0,-1,-1,0,1,1,-1
KR_6762588297,420,-1,48,-16,-4,-4,5,1,-1,2,1,3,1,4,-2,3,1,0,1,1,1,-8,0,2,-5,3,1,0,0,-1,1,1,1,5,-1
KR_6749025638,420,-4,-65,-22,-10,-1,1,0,1,4,5,-1,3,2,-1,2,1,-8,8,0,0,-7,-488,-1,-3,4,-32,0,-1,0,-1,-1,-1,0,-1
KR_6731993691,420,-1,-59,22,0,-1,3,2,2,0,2,2,1,3,-4,7,3,1,0,1,0,2,6,-1,-2,3,0,0,-1,1,0,-1,-1,1,-1
KR_6704150739,420,-8,-165,-24,-15,-6,6,0,-6,6,0,-4,5,1,-2,2,0,3,0,3,-1,-11,-12,-5,-1,6,-2,0,-3,1,1,-1,-1,5,-1
KR_6742932043,420,-2,-100,-6,-6,4,0,4,-3,3,0,-3,5,2,-2,3,1,-2,3,1,0,-5,4,-1,-1,2,-2,0,-2,-1,1,-1,-1,4,-1
KR_6677043649,420,-8,-62,-8,-23,-1,2,1,-14,15,1,-6,8,2,-2,3,1,0,0,0,0,-17,6,-3,-1,4,-2,0,-2,-1,1,-1,-1,4,-1
KR_6762572304,420,-6,-51,4,-5,-3,5,2,0,1,1,1,2,3,-2,5,3,-1,2,1,-1,-7,-51,-4,-2,6,18,0,-1,-1,-1,-1,-1,4,-1
KR_6761096582,420,-3,-97,16,-2,-1,3,2,-4,7,3,5,1,6,-3,4,1,1,1,2,0,2,-4,-2,-2,4,-1,0,-1,-1,-1,-1,-1,1,-1
KR_6762983949,420,-7,-69,-16,-18,-2,3,1,-1,2,1,-4,5,1,-10,13,3,-1,2,1,0,-18,-11,-2,-1,3,-1,0,-1,-1,-1,-1,-1,1,-1
KR_6762762559,420,1,-59,0,4,2,0,2,0,3,3,3,0,3,0,3,3,-1,1,0,0,8,-5,-1,-2,3,3,0,0,0,-1,0,-1,0,-1
KR_6753991690,420,-5,-2,32,-9,-4,4,0,-1,3,2,2,1,3,-7,8,1,1,1,2,0,-6,-11,0,-3,3,1,0,-2,1,-1,-1,1,5,-1
KR_6686068276,420,-5,-43,4,-13,2,0,2,-6,6,0,-4,6,2,-4,5,1,-1,4,3,0,-13,-6,1,-3,2,-1,0,-1,-1,1,-1,1,4,-1
KR_6651054335,440,-3,-86,-30,-3,-1,4,3,-6,7,1,0,1,1,2,3,5,2,1,3,0,3,-1,-2,-2,4,2,0,-3,-1,-1,-1,1,5,-1
KR_6755640912,420,-4,-101,6,-14,-1,2,1,0,2,2,-5,7,2,-5,8,3,-3,3,0,0,-9,-386,-4,-1,5,-4,0,-1,-1,-1,-1,-1,4,-1
KR_6760751016,440,-3,-91,-32,-6,-2,3,1,-4,4,0,-2,2,0,2,1,3,0,1,1,0,-6,1,1,-2,1,1,0,-1,-1,0,-1,-1,4,-1
KR_6677747671,420,-2,42,2,-4,1,2,3,0,1,1,0,1,1,-3,4,1,-2,2,0,1,-4,-3,-1,-3,4,-1,0,-1,-1,1,-1,1,3,-1
KR_6676428307,420,-4,-68,-3,-5,-1,1,0,1,0,1,-2,2,0,-4,5,1,1,0,1,0,-3,-12,3,-5,2,-4,0,-1,1,-1,-1,-1,4,-1
KR_6431852610,420,-2,9,-4,-4,0,0,0,-1,2,1,-1,3,2,-3,5,2,1,1,2,0,2,-101,0,-1,1,0,0,0,1,-1,0,1,2,-1
KR_6740227052,420,-3,33,-4,-5,-1,1,0,-3,4,1,5,1,6,-1,1,0,-5,5,0,-1,-11,-11,-3,-1,4,0,0,0,0,1,0,-1,0,-1
KR_6729612294,440,1,22,-8,-5,0,2,2,-4,5,1,-2,2,0,0,2,2,1,0,1,0,-2,4,1,-2,1,-3,0,0,-1,0,0,-1,3,-1
KR_6643492670,420,3,-13,20,1,-5,6,1,1,0,1,2,3,5,1,1,2,2,1,3,0,2,1,0,-1,1,1,0,1,-1,1,1,1,6,-1
KR_6740889353,420,-1,-45,-2,-9,-1,1,0,-5,8,3,0,3,3,-4,5,1,1,0,1,0,-7,61,-1,-3,4,0,0,0,-1,-1,-1,-1,2,-1
KR_6670206303,420,-2,-39,3,-12,-1,1,0,-3,4,1,-2,5,3,-6,6,0,0,1,1,0,-16,-39,-2,-1,3,10,0,-1,-1,0,-1,1,1,-1
KR_6726716187,420,0,-42,7,-4,0,0,0,-2,3,1,-5,7,2,2,0,2,1,0,1,0,-1,30,2,-2,0,-16,0,2,-1,1,1,-1,2,-1
KR_6740760884,420,0,58,-12,0,2,4,6,1,0,1,-4,6,2,-1,2,1,2,0,2,-1,0,1,-2,-2,4,2,0,1,1,-1,1,-1,2,-1
KR_6659765676,420,-4,9,-8,-5,-1,2,1,-1,2,1,-1,4,3,-2,3,1,0,0,0,0,-1,1,-4,-2,6,3,0,0,1,0,0,1,3,-1
KR_6747949631,420,2,-45,9,7,4,0,4,1,0,1,5,1,6,-3,3,0,0,1,1,0,11,7,5,-8,3,2,0,0,1,-1,0,-1,3,-1
KR_6737850749,420,-3,-12,-8,-10,-1,2,1,0,3,3,-4,4,0,-2,3,1,-3,3,0,0,-10,3,-1,-5,6,1,0,0,-1,-1,-1,-1,6,-1
KR_6706586451,420,-8,-127,-4,-15,-1,1,0,-1,3,2,-6,6,0,-5,5,0,-2,2,0,1,-5,-14,-2,-1,3,1,0,-2,-1,1,-1,1,6,-1
KR_6701611634,420,2,54,-7,0,-2,4,2,0,4,4,1,4,5,1,3,4,0,0,0,0,-2,10,0,-5,5,0,0,0,0,-1,0,1,0,-1
KR_6712606941,420,4,67,21,13,-2,2,0,-1,5,4,3,1,4,10,0,10,3,0,3,0,7,11,2,-3,1,-1,0,0,-1,-1,0,1,6,-1
KR_6644692391,420,-1,27,-35,2,0,1,1,-3,3,0,3,1,4,2,1,3,0,0,0,0,0,-1,2,-3,1,2,0,0,1,0,0,1,3,-1
KR_6742831562,420,-1,-90,18,-7,-2,3,1,0,2,2,-4,4,0,-1,1,0,0,1,1,-1,-6,-12,-1,-2,3,-1,0,-3,1,1,-1,-1,5,-1
KR_6737677467,420,0,5,4,1,0,0,0,-1,4,3,-3,4,1,3,2,5,2,1,3,0,4,24,0,0,0,2,0,0,-1,-1,-1,1,2,-1
KR_6751063230,420,-4,-11,-41,-3,-5,5,0,-4,7,3,3,4,7,3,0,3,0,0,0,0,3,-5,-2,-2,4,1,0,0,1,-1,1,-1,2,-1
KR_6760396856,420,-3,29,4,-4,0,1,1,-2,2,0,-2,4,2,-1,3,2,1,2,3,0,-1,248,1,-4,3,4,0,1,1,0,1,-1,6,-1
KR_6690485090,440,-2,-113,12,-3,5,0,5,-2,3,1,-3,3,0,-3,4,1,0,1,1,0,-6,11,-1,-4,5,-1,0,0,-1,1,1,-1,4,-1
KR_6652860525,420,-1,-15,7,1,1,0,1,1,2,3,-1,3,2,0,2,2,0,0,0,1,5,-2,-1,-4,5,2,0,0,-1,1,0,1,5,-1
KR_6738004672,420,6,79,3,9,2,2,4,7,0,7,1,1,2,-2,2,0,1,0,1,0,6,-5,-3,-1,4,1,0,1,1,0,1,-1,5,-1
KR_6740095141,420,4,87,11,4,1,0,1,0,1,1,-4,5,1,3,0,3,4,1,5,0,2,10,1,-1,0,1,0,-1,1,-1,-1,1,2,-1
KR_6745047598,420,-3,-6,-8,-15,3,0,3,1,1,2,-7,8,1,-9,9,0,-3,4,1,0,-9,16,-1,-1,2,-1,0,0,-1,1,-1,-1,5,-1
KR_6762233125,420,1,-1,16,-4,-4,4,0,-2,4,2,2,1,3,0,3,3,0,1,1,0,-11,-5,-1,-2,3,-1,0,-1,0,-1,-1,1,0,-1
KR_6681816574,420,-3,-4,22,-5,-6,8,2,0,4,4,-4,4,0,4,2,6,1,0,1,0,-5,167,5,-5,0,-2,0,0,1,-1,-1,1,3,-1
KR_6625106402,420,1,48,29,2,2,0,2,1,1,2,3,3,6,-2,7,5,-2,2,0,1,9,-2,0,-2,2,1,0,2,-1,0,1,1,6,-1
KR_6753060128,420,0,-36,-24,0,-2,3,1,0,2,2,2,1,3,0,3,3,0,1,1,0,0,4,1,-3,2,0,0,0,0,0,0,-1,0,-1
KR_6732443728,420,2,30,20,2,-1,1,0,3,0,3,-4,5,1,2,1,3,2,1,3,2,6,3,-1,-1,2,0,0,1,1,1,1,1,2,-1
KR_6760821722,420,-2,-54,0,-14,-5,7,2,-12,13,1,1,0,1,0,1,1,2,0,2,0,-17,8,4,-5,1,-2,0,0,0,0,0,-1,0,-1
KR_6724527091,420,-4,-27,-34,-14,1,0,1,0,5,5,-6,6,0,-6,8,2,-3,3,0,0,1,5,1,-3,2,-2,0,0,-1,-1,0,-1,3,-1
KR_6762945819,420,-6,-28,-20,-17,-5,5,0,-4,5,1,-2,4,2,-3,4,1,-3,3,0,-1,-18,-6,3,-5,2,0,0,-2,-1,-1,-1,-1,4,-1
KR_6754294711,420,3,-32,28,-1,-1,2,1,4,2,6,-3,4,1,-1,3,2,0,0,0,0,0,-21,1,-2,1,-1,0,0,0,1,0,-1,0,-1
KR_6727357016,420,2,93,0,1,2,0,2,0,1,1,0,1,1,3,1,4,-4,4,0,0,-4,-1,2,-4,2,2,0,1,-1,1,1,1,5,-1
KR_6724880744,440,-1,-22,-16,0,1,2,3,-3,3,0,0,2,2,0,2,2,2,0,2,0,5,-248,0,-2,2,1,0,0,-1,-1,-1,1,6,-1
KR_6751408994,440,-3,-27,0,-9,-2,3,1,-4,6,2,-1,1,0,-2,3,1,0,0,0,0,-6,8,-2,-2,4,-5,0,0,1,0,0,1,3,-1
KR_6657707832,420,0,-63,28,5,3,0,3,2,1,3,1,0,1,1,1,2,-2,2,0,0,2,-21,1,-5,4,0,0,0,1,0,0,1,6,-1
KR_6763870126,420,2,-3,16,9,4,0,4,3,1,4,3,2,5,-3,3,0,2,0,2,0,10,-14,2,-4,2,-2,0,1,1,1,1,1,5,-1
KR_6706359641,420,-5,-62,-13,-5,-5,6,1,6,1,7,-4,6,2,-2,6,4,0,1,1,0,7,8,0,0,0,2,0,-2,-1,-1,-1,1,4,-1
KR_6716087351,420,2,-34,24,1,5,1,6,-2,5,3,2,1,3,-4,6,2,0,0,0,0,-4,-8,3,-8,5,0,0,2,-1,1,1,1,3,-1
KR_6745406305,440,-1,5,-4,-8,6,3,9,-3,5,2,-4,4,0,-4,5,1,-3,5,2,1,-7,-117,1,-3,2,0,0,0,-1,-1,1,1,6,-1
KR_6752105442,420,-3,-74,-6,-7,-1,2,1,-2,2,0,-5,5,0,2,1,3,-1,1,0,0,-8,1,0,-3,3,1,0,0,1,0,-1,-1,5,-1
KR_6739854870,420,-3,-70,-16,-9,-4,5,1,1,3,4,-3,3,0,-1,3,2,-2,4,2,0,-1,-10,-4,-3,7,-1,0,-1,-1,-1,-1,-1,2,-1
KR_6763049054,420,-3,-27,-20,-5,-2,2,0,0,1,1,-4,4,0,0,3,3,1,0,1,0,2,-5,0,-2,2,-1,0,-1,-1,0,-1,-1,4,-1
KR_6750008150,420,-1,9,-16,-4,0,5,5,0,4,4,-6,8,2,2,1,3,0,2,2,0,0,116,2,-3,1,-1,0,-1,-1,-1,-1,1,2,-1
KR_6763844520,420,1,55,-8,1,-5,5,0,1,3,4,1,4,5,3,0,3,1,0,1,0,4,5,0,-4,4,3,0,-1,-1,-1,-1,1,2,-1
KR_6763053983,420,-3,15,-12,-10,-1,1,0,-2,4,2,-6,6,0,-1,5,4,0,0,0,0,-3,6,1,-5,4,0,0,0,-1,1,0,-1,4,-1
KR_6758208286,420,2,32,-20,7,4,2,6,4,1,5,1,1,2,0,5,5,-2,3,1,0,9,-3,3,-5,2,-2,0,1,-1,1,1,1,3,-1
KR_6700636220,420,0,12,4,-5,-1,3,2,2,1,3,-3,3,0,-2,2,0,-1,1,0,0,-2,-41,-6,-1,7,5,0,-1,-1,-1,-1,-1,4,-1
KR_6759119349,420,2,11,-4,2,5,0,5,-2,4,2,3,1,4,-3,3,0,-1,3,2,0,-2,-7,0,-3,3,4,0,2,-1,1,1,-1,2,-1
KR_6645269153,420,-7,-103,-20,-15,-3,3,0,2,2,4,-1,3,2,-6,7,1,-7,7,0,-3,-16,-1,-1,-3,4,-3,0,-3,-1,-1,-1,-1,4,-1
KR_6745621476,420,-1,43,-4,-1,-5,5,0,3,1,4,-2,2,0,2,1,3,1,1,2,1,3,-6,-1,-2,3,1,0,1,1,0,1,1,2,-1
KR_6690456989,420,-1,-66,12,0,-1,3,2,1,4,5,-1,2,1,1,5,6,0,1,1,0,-1,1,-1,-1,2,0,0,-1,-1,-1,-1,-1,6,-1
KR_6744350917,420,-1,-22,8,-3,-1,6,5,0,1,1,1,1,2,-2,5,3,-1,3,2,0,-2,-46,2,-2,0,22,0,0,-1,1,-1,1,3,-1
KR_6734055019,420,2,22,4,2,2,1,3,-1,3,2,-3,5,2,2,0,2,2,0,2,0,2,1,0,-1,1,-2,0,-1,-1,-1,-1,1,5,-1
KR_6715736055,420,-2,12,-4,-3,-1,4,3,0,4,4,-2,2,0,1,3,4,-1,1,0,0,-3,6,-4,-1,5,4,0,2,0,1,-1,-1,0,-1
KR_6649529210,420,0,8,-28,-7,0,2,2,-1,1,0,-3,4,1,-3,4,1,0,0,0,0,-6,196,-1,-2,3,0,0,0,-1,-1,0,-1,2,-1
KR_6742331069,440,-2,-60,-21,-10,-2,4,2,-1,1,0,0,0,0,-7,7,0,0,2,2,0,-15,-8,2,-7,5,-1,0,-2,-1,-1,-1,-1,3,-1
KR_6756459399,420,-4,-126,-52,-3,-2,3,1,3,1,4,-2,2,0,-1,7,6,-1,2,1,0,5,6,-2,0,2,2,0,-1,0,0,-1,-1,0,-1
KR_6681883665,440,0,-21,4,2,-5,5,0,3,2,5,-5,6,1,5,0,5,4,0,4,0,7,5,2,-2,0,0,0,0,0,0,0,-1,0,-1
KR_6750251351,440,0,-60,-12,-6,-6,6,0,3,2,5,1,1,2,0,1,1,-4,4,0,0,-5,-2,0,-1,1,-2,0,0,-1,-1,0,-1,5,-1
KR_6759102917,420,-2,-85,14,-5,6,0,6,-3,3,0,-2,2,0,-4,5,1,-2,2,0,0,-11,-115,-6,-1,7,-3,0,-2,1,1,-1,-1,3,-1
KR_6728839614,420,-10,-80,-1,-24,-3,3,0,-10,10,0,1,2,3,-3,6,3,-9,9,0,-1,-16,17,19,-24,5,1,0,-3,-1,-1,-1,-1,6,-1
KR_6646043174,420,-2,-10,-24,-4,-1,2,1,-3,5,2,0,3,3,-3,6,3,3,2,5,0,4,-273,0,-3,3,-8,0,0,-1,1,0,-1,3,-1
KR_6726811798,420,-1,-8,-4,-2,0,1,1,1,0,1,0,2,2,-3,7,4,0,2,2,0,-2,6,-4,0,4,1,0,0,1,-1,0,-1,5,-1
KR_6759249258,440,-3,-71,-55,0,5,2,7,0,1,1,-1,5,4,0,3,3,-4,4,0,0,1,7,-1,-4,5,-5,0,-1,-1,-1,-1,-1,5,-1
KR_6722013756,420,-4,-60,-18,-9,-1,2,1,-5,6,1,-5,9,4,5,2,7,-3,3,0,0,-3,-3,4,-5,1,1,0,0,-1,-1,-1,-1,5,-1
KR_6739595820,420,-3,-64,17,-7,0,0,0,2,0,2,-7,9,2,-3,7,4,1,0,1,0,-4,-451,4,-4,0,-1,0,-1,-1,-1,-1,1,3,-1
KR_6734109089,440,0,-100,20,0,1,1,2,0,2,2,1,0,1,-1,4,3,-1,2,1,0,-2,6,-4,-1,5,-2,0,-1,-1,-1,-1,-1,1,-1
KR_6750857392,420,0,-63,32,-1,2,1,3,-2,2,0,-1,3,2,2,2,4,-2,5,3,0,-4,3,1,-5,4,-3,0,1,1,-1,1,1,2,-1
KR_6744298086,420,-3,-72,36,-4,0,1,1,1,5,6,0,1,1,-2,3,1,-3,3,0,0,-8,-2,-5,-1,6,2,0,0,-1,-1,-1,1,1,-1
KR_6730098713,420,1,31,-15,-3,1,1,2,-1,4,3,0,1,1,0,3,3,-3,8,5,1,2,7,3,-3,0,-3,0,1,0,-1,1,1,0,-1
KR_6744380053,420,-1,44,-76,3,1,1,2,2,4,6,1,0,1,1,3,4,-2,5,3,0,6,0,1,-1,0,0,0,0,-1,-1,0,-1,5,-1
KR_6729351610,420,-4,-60,11,-7,-3,5,2,1,0,1,0,5,5,-2,3,1,-3,3,0,0,-2,-11,-1,0,1,0,0,-1,-1,-1,-1,1,3,-1
KR_6714996967,420,-1,-51,-11,-12,-1,3,2,-4,4,0,-1,3,2,-3,4,1,-3,3,0,0,-9,-27,-3,0,3,35,0,-3,-1,-1,-1,-1,4,-1
KR_6698408291,420,-3,-63,-24,-5,-1,4,3,-3,4,1,-3,5,2,2,0,2,0,2,2,0,-1,-12,-2,-2,4,-1,0,-1,1,-1,-1,1,3,-1
KR_6725431479,420,-1,-23,24,-5,1,1,2,-3,4,1,0,2,2,-3,4,1,0,1,1,-1,-11,-6,1,-3,2,-4,0,-2,1,-1,-1,-1,2,-1
KR_6686511991,420,-2,-59,24,-6,-2,5,3,1,5,6,-3,3,0,-2,3,1,0,2,2,0,-1,2,-6,-3,9,0,0,-1,1,0,-1,1,1,-1
KR_6761472562,440,0,-103,-14,-1,-4,4,0,1,1,2,1,0,1,0,3,3,1,0,1,0,5,-21,2,-4,2,4,0,-1,1,0,-1,-1,3,-1
KR_6722775377,420,-1,-48,-12,-9,4,2,6,0,4,4,-6,9,3,-1,3,2,-6,7,1,0,-8,-57,1,-7,6,-2,0,0,1,-1,-1,-1,1,-1
KR_6756583802,440,-4,5,-15,-11,-2,4,2,-5,5,0,2,0,2,-6,6,0,0,0,0,0,-14,-8,-2,-3,5,4,0,-1,-1,1,-1,-1,3,-1
KR_6727458852,420,-3,1,-21,-5,0,0,0,2,1,3,-1,2,1,-3,6,3,-3,4,1,2,-2,33,-1,-1,2,-29,0,-1,1,0,-1,1,6,-1
KR_6750914325,420,-2,-17,20,-9,-4,5,1,-2,5,3,-4,6,2,-1,2,1,2,1,3,1,0,-12,-2,-4,6,3,0,0,-1,1,-1,1,1,-1
KR_6752642887,420,-5,-37,-6,-8,1,4,5,1,0,1,-4,6,2,-3,3,0,-3,4,1,0,-11,35,3,-6,3,-3,0,0,-1,-1,0,1,1,-1
KR_6734048709,420,-1,16,15,-7,-3,6,3,-1,2,1,-3,3,0,1,2,3,-1,1,0,0,-2,-51,-5,-2,7,19,0,-1,1,-1,-1,-1,5,-1
KR_6741588466,420,0,-52,25,-7,2,0,2,1,2,3,3,0,3,-10,10,0,-3,4,1,0,-7,-3,-4,0,4,1,0,-2,-1,-1,-1,-1,3,-1
KR_6757816174,420,0,-31,-3,7,-3,5,2,0,2,2,1,1,2,6,2,8,3,0,3,4,18,-19,2,-4,2,2,0,0,1,0,1,1,6,-1
KR_6749786569,420,-3,-29,5,-10,-1,2,1,-1,4,3,-6,6,0,-1,2,1,-1,3,2,1,-5,-3,3,-3,0,1,0,-2,-1,1,-1,1,2,-1
KR_6709997206,440,-6,-169,-4,-9,-4,4,0,-4,4,0,-3,3,0,3,2,5,-1,2,1,0,-2,74,1,-3,2,1,0,-2,1,-1,-1,-1,6,-1
KR_6697970574,420,-1,38,4,2,2,0,2,1,0,1,3,2,5,-1,6,5,-3,4,1,0,8,17,0,-2,2,0,0,1,0,1,1,1,0,-1
KR_6729116711,420,-5,-49,-32,-9,-1,2,1,1,1,2,-7,7,0,-1,4,3,-1,2,1,0,-3,-1,-1,-2,3,-2,0,0,-1,1,0,-1,1,-1
KR_6752619415,420,-3,-69,13,-5,-2,2,0,2,1,3,3,2,5,-9,10,1,1,0,1,0,-6,34,0,-2,2,-15,0,-1,-1,1,-1,-1,1,-1
