matchId,queueId,Diff_LV,Diff_CS,Diff_jglCS,Diff-K,Diff-K-top,K-WIN-top,K-LOSE-top,Diff-K-jug,K-WIN-jug,K-LOSE-jug,Diff-K-mid,K-WIN-mid,K-LOSE-mid,Diff-K-ad,K-WIN-ad,K-LOSE-ad,Diff-K-sup,K-WIN-sup,K-LOSE-sup,invadeKill,Diff-A,Diff_WARDplaced,Diff-ControlWARDplaced,LOSE_controlWARDPlaced,WIN_controlWARDPlaced,Diff_WARDkill,Diff_Inhibitor,Diff_TOWERkill,Diff_FirstDRAGON,Diff_FirstHERALD,Diff_Firsttower,Diff_FirstBLOOD,dragonType,result
KR_6715732240,420,0,-38,4,-1,-1,3,2,2,3,5,-4,5,1,1,0,1,1,0,1,0,-5,12,4,-10,6,-7,0,0,-1,1,0,1,1,-1
KR_6764403199,420,-1,-86,-4,-5,-2,3,1,-5,7,2,0,3,3,-1,4,3,3,1,4,0,-1,21,0,-7,7,2,0,0,1,-1,0,1,1,-1
KR_6697929588,420,-2,-33,1,-1,3,1,4,5,2,7,-3,6,3,-6,7,1,0,0,0,-2,-2,-3,-3,-1,4,-2,0,-1,1,1,-1,-1,6,-1
KR_6749421566,420,-6,-59,-24,-12,-1,2,1,-4,6,2,-1,1,0,-1,6,5,-5,5,0,0,-5,271,0,-5,5,-2,0,0,-1,-1,0,-1,1,-1
KR_6738944202,420,0,-15,-19,3,4,0,4,2,0,2,1,0,1,-4,5,1,0,1,1,0,3,-189,-1,-7,8,4,0,-1,1,1,-1,1,3,-1
KR_6762380879,440,-2,-79,-8,-4,1,2,3,-3,3,0,-1,3,2,0,0,0,-1,1,0,0,-1,-6,-1,-5,6,1,0,1,0,1,-1,-1,0,-1
KR_6690765357,440,-1,-42,13,3,-2,4,2,2,2,4,9,0,9,-6,6,0,0,0,0,0,8,270,-1,-5,6,3,0,0,1,-1,-1,-1,3,-1
KR_6734070695,420,-4,-129,-14,-9,1,0,1,1,1,2,-4,5,1,-6,9,3,-1,4,3,0,-12,21,3,-5,2,-2,0,-2,0,-1,-1,-1,0,-1
KR_6763869606,420,-1,14,-12,-1,1,0,1,3,2,5,-4,6,2,-3,3,0,2,0,2,0,-8,-11,5,-12,7,3,0,1,-1,1,1,1,5,-1
KR_6711763250,420,-2,-79,12,-2,-3,3,0,0,1,1,-4,4,0,3,1,4,2,0,2,2,2,34,3,-7,4,-5,0,-1,1,1,-1,1,1,-1
KR_6691166863,420,-2,-33,-12,-7,1,1,2,-4,8,4,2,1,3,-5,5,0,-1,1,0,0,-9,-1,5,-8,3,-4,0,-1,-1,1,1,-1,2,-1
KR_6763978824,420,-2,16,-12,-10,-3,3,0,-3,3,0,-4,6,2,2,1,3,-2,2,0,0,-7,3,2,-6,4,-2,0,0,-1,1,0,-1,6,-1
KR_6745586088,420,-4,-83,-72,4,1,1,2,4,0,4,-1,2,1,0,3,3,0,2,2,1,6,164,-1,-3,4,-5,0,0,1,-1,1,1,4,-1
KR_6764775962,420,-6,-95,-34,-12,-8,9,1,1,2,3,1,1,2,-4,4,0,-2,3,1,0,-5,-5,3,-5,2,2,0,-4,-1,-1,-1,-1,3,-1
KR_6758456158,420,0,-32,12,-3,0,1,1,0,3,3,1,0,1,-6,6,0,2,0,2,0,-10,1,1,-5,4,-5,0,1,1,1,1,-1,5,-1
KR_6764366595,420,-3,-9,-32,-3,-4,4,0,-1,4,3,0,5,5,0,2,2,2,1,3,0,2,17,0,-5,5,-8,0,-1,-1,-1,-1,1,6,-1
KR_6640873612,420,2,2,0,0,2,1,3,-1,4,3,2,0,2,-3,3,0,0,0,0,0,-3,38,2,-10,8,-4,0,0,-1,-1,0,-1,2,-1
KR_6752736297,420,-4,-81,-24,-4,-1,2,1,1,0,1,-2,2,0,-1,2,1,-1,1,0,0,-3,-54,-7,0,7,17,0,-2,-1,-1,-1,-1,4,-1
KR_6761781299,420,-2,-36,10,-5,1,1,2,-5,8,3,-6,8,2,6,1,7,-1,2,1,-1,-8,3,-4,-3,7,1,0,0,-1,-1,1,-1,2,-1
KR_6762227820,420,-1,-35,3,-8,-1,2,1,-1,1,0,-4,6,2,-2,3,1,0,3,3,-2,-11,-64,0,-4,4,-1,0,0,-1,-1,0,-1,6,-1
KR_6759135573,440,-1,-14,-31,5,-1,2,1,1,1,2,3,1,4,4,1,5,-2,3,1,1,6,5,6,-6,0,0,0,0,-1,-1,1,1,6,-1
KR_6744950532,420,-4,-78,-6,-4,1,1,2,-1,4,3,-4,5,1,-3,3,0,3,1,4,-1,-2,2,1,-5,4,1,0,-1,-1,-1,-1,-1,6,-1
KR_6764523844,420,-5,-27,-32,-5,-1,3,2,-1,3,2,-1,1,0,-2,5,3,0,1,1,0,-6,178,2,-6,4,0,0,-1,1,-1,-1,1,4,-1
KR_6756459586,420,-2,-10,-12,-2,-6,8,2,0,2,2,0,1,1,2,2,4,2,1,3,0,-1,6,1,-5,4,-4,0,0,1,1,1,1,6,-1
KR_6754881814,420,-5,-156,24,-14,-7,8,1,-2,4,2,0,0,0,-5,6,1,0,0,0,0,-3,19,-8,-1,9,2,0,-4,1,-1,-1,-1,1,-1
KR_6762934758,420,-3,-12,-40,-3,-3,4,1,4,0,4,-2,2,0,-4,4,0,2,2,4,0,-2,-12,2,-5,3,-2,0,0,0,1,0,1,0,-1
KR_6638281758,420,-4,-69,-10,-13,-6,7,1,-1,2,1,0,0,0,-6,7,1,0,1,1,0,-16,-10,-3,-4,7,-1,0,-2,-1,-1,-1,-1,4,-1
KR_6758785509,440,-2,-7,-21,2,0,3,3,-2,5,3,3,1,4,1,2,3,0,4,4,1,3,5,1,-3,2,-2,0,0,-1,0,0,1,5,-1
KR_6744639052,420,-2,-27,-20,-2,-1,1,0,-2,2,0,-1,2,1,1,3,4,1,1,2,0,-1,7,1,-5,4,-2,0,0,-1,1,1,-1,3,-1
KR_6729434502,420,-6,-37,4,-17,-3,5,2,-8,8,0,-1,2,1,0,3,3,-5,6,1,0,-13,24,-3,-3,6,2,0,0,-1,0,-1,-1,2,-1
KR_6725538181,420,0,20,0,-7,-1,1,0,0,3,3,-3,3,0,-1,4,3,-2,2,0,0,-11,-148,-1,-6,7,-4,0,0,-1,-1,0,-1,3,-1
KR_6763691664,420,0,23,16,3,0,0,0,3,1,4,-2,4,2,1,5,6,1,5,6,0,-1,48,-2,-7,9,-18,0,2,-1,1,1,-1,1,-1
KR_6755717321,420,3,22,-15,5,2,0,2,0,3,3,-2,2,0,4,1,5,1,0,1,-1,2,11,-8,-3,11,6,0,-1,1,-1,-1,-1,1,-1
KR_6749562281,420,-6,-115,-36,-6,-1,2,1,0,2,2,0,2,2,-4,5,1,-1,2,1,0,-5,-54,-6,-2,8,22,0,-2,-1,1,-1,-1,2,-1
KR_6753076984,420,-6,-99,0,-20,0,1,1,-9,9,0,-3,4,1,-7,10,3,-1,1,0,0,-26,-3,1,-4,3,-1,0,-2,0,1,-1,-1,0,-1
KR_6724070532,420,-4,-2,-60,-2,-3,3,0,3,2,5,-2,6,4,0,2,2,0,1,1,-1,-7,23,1,-6,5,-7,0,-1,-1,-1,-1,-1,5,-1
KR_6758619700,440,-5,-82,-12,-11,0,1,1,0,1,1,-2,3,1,-8,8,0,-1,2,1,0,-12,26,3,-5,2,-3,0,-2,-1,-1,-1,-1,5,-1
KR_6714284428,420,-3,-27,-36,-6,1,2,3,-2,6,4,-6,6,0,1,1,2,0,0,0,0,-2,-10,0,-6,6,-3,0,-1,-1,-1,-1,-1,1,-1
KR_6729342875,420,0,-6,2,6,1,2,3,2,2,4,1,1,2,1,1,2,1,0,1,1,12,37,1,-7,6,-1,0,0,-1,1,0,1,1,-1
KR_6722698959,420,-1,-73,-36,-1,-3,3,0,1,3,4,-3,4,1,3,0,3,1,0,1,0,5,10,-4,-3,7,-2,0,-3,-1,-1,-1,-1,5,-1
KR_6760214971,420,-2,47,4,-6,-3,6,3,-1,3,2,1,1,2,-3,4,1,0,1,1,-1,-12,-2,-3,-2,5,1,0,0,1,-1,1,-1,3,-1
KR_6749050637,440,0,48,-37,3,3,0,3,-2,3,1,1,2,3,1,3,4,0,0,0,0,4,6,-2,-3,5,6,0,0,-1,-1,0,-1,3,-1
KR_6690886056,420,-2,-49,2,-5,-2,2,0,-4,6,2,0,1,1,2,2,4,-1,2,1,0,1,-2,-3,-3,6,-2,0,-1,1,-1,1,-1,6,-1
KR_6729533102,420,-3,-11,21,-7,-4,4,0,-2,7,5,-1,1,0,-1,3,2,1,0,1,0,-4,-2,2,-6,4,-6,0,0,1,-1,-1,-1,4,-1
KR_6724609086,440,0,19,17,-1,0,0,0,5,1,6,0,2,2,-6,7,1,0,0,0,0,-3,5,-2,-3,5,1,0,-1,1,-1,-1,-1,5,-1
KR_6219774417,420,-2,-32,-2,-5,-2,4,2,-2,3,1,-7,8,1,4,1,5,2,0,2,0,-14,12,8,-13,5,-4,0,2,-1,1,1,1,4,-1
KR_6756251375,420,0,-57,9,-3,2,1,3,3,0,3,-1,2,1,-6,7,1,-1,1,0,-2,-10,39,-1,-4,5,-1,0,0,-1,0,0,-1,2,-1
KR_6595828577,420,0,-81,7,-3,0,1,1,6,1,7,-1,2,1,-6,9,3,-2,2,0,0,-3,-2,-1,-6,7,-4,0,-1,-1,-1,-1,1,3,-1
KR_6751061004,420,1,50,8,-2,-2,3,1,2,1,3,2,2,4,-4,4,0,0,0,0,0,-4,-7,-3,-5,8,-1,0,0,1,-1,0,-1,6,-1
KR_6755845659,420,-2,-8,-18,-7,1,1,2,-6,7,1,-4,4,0,2,3,5,0,1,1,0,-3,23,-6,-1,7,1,0,-1,-1,-1,-1,-1,3,-1
KR_6761073827,440,0,-124,-22,1,3,2,5,3,1,4,-5,7,2,-1,4,3,1,2,3,0,4,-35,6,-7,1,11,0,-1,-1,-1,-1,1,6,-1
KR_6744464860,440,-1,-63,-11,-7,-2,5,3,2,3,5,0,2,2,-6,7,1,-1,2,1,0,-15,-8,1,-3,2,-1,0,0,0,1,-1,-1,0,-1
KR_6732869041,420,0,63,-40,3,4,1,5,2,0,2,-1,1,0,-4,5,1,2,1,3,1,-5,-20,-3,-5,8,15,0,0,1,-1,0,1,1,-1
KR_6723850525,420,-3,-59,-21,-4,-3,5,2,2,5,7,-3,4,1,-1,3,2,1,0,1,-2,-7,-29,-6,-3,9,1,0,-2,-1,1,-1,-1,2,-1
KR_6746251587,420,0,-35,-8,0,3,1,4,-1,3,2,-2,5,3,2,2,4,-2,4,2,0,-5,39,1,-3,2,-20,0,-1,-1,0,1,1,6,-1
KR_6759108136,440,-3,-41,8,2,-3,4,1,2,4,6,1,3,4,1,4,5,1,1,2,3,8,3,-3,0,3,1,0,-1,0,0,-1,1,0,-1
KR_6681175555,420,-1,-5,-12,-3,0,3,3,-2,3,1,-2,2,0,-1,3,2,2,3,5,0,-5,1,1,-6,5,-1,0,1,1,-1,-1,-1,3,-1
KR_6762353244,420,-1,-14,-24,-5,-6,7,1,0,2,2,-1,2,1,1,2,3,1,0,1,-1,3,15,-3,-7,10,-5,0,-2,1,-1,-1,-1,5,-1
KR_6739296339,420,-2,-41,6,-8,-5,5,0,-6,7,1,0,1,1,3,1,4,0,0,0,0,-7,6,-1,-2,3,4,0,1,1,-1,1,-1,2,-1
KR_6736775645,420,-6,-70,16,-11,-1,2,1,-4,5,1,1,1,2,-8,10,2,1,0,1,0,-10,5,0,-7,7,2,0,-2,-1,0,-1,-1,4,-1
KR_6719864959,420,0,-5,15,-5,0,3,3,-2,4,2,6,0,6,-6,8,2,-3,3,0,-1,-10,11,1,-8,7,-6,0,1,-1,1,1,-1,2,-1
KR_6764460728,440,-2,-20,-20,-2,1,1,2,2,0,2,2,3,5,-4,5,1,-3,4,1,-1,-5,4,-2,-4,6,-2,0,0,0,0,0,-1,0,-1
KR_6763179868,420,-3,-6,-26,-6,0,2,2,1,2,3,-6,7,1,3,0,3,-4,4,0,0,-2,-2,7,-9,2,-6,0,-2,-1,-1,-1,-1,6,-1
KR_6759000481,420,0,43,-16,8,2,0,2,1,2,3,1,1,2,2,2,4,2,0,2,1,6,10,3,-6,3,-3,0,0,-1,-1,0,1,5,-1
KR_6510150472,420,-2,-12,-12,1,0,1,1,3,3,6,-1,3,2,-1,6,5,0,0,0,0,2,-12,0,-8,8,0,0,0,1,-1,0,-1,2,-1
KR_6730901173,420,-7,-19,-26,-8,-1,1,0,-1,5,4,-1,1,0,-2,7,5,-3,3,0,0,-10,103,2,-9,7,-1,0,0,-1,0,-1,1,5,-1
KR_6758725211,420,0,0,-20,0,-1,1,0,-2,3,1,1,2,3,1,2,3,1,0,1,0,3,9,2,-7,5,-2,0,0,-1,1,0,-1,2,-1
KR_6754462591,440,-3,-22,-11,-10,-3,5,2,4,2,6,-10,12,2,-2,2,0,1,3,4,1,-9,-3,4,-7,3,1,0,-2,-1,1,-1,1,1,-1
KR_6665683628,420,-1,-63,10,3,-3,5,2,7,2,9,-1,1,0,1,0,1,-1,1,0,2,13,6,-3,-5,8,-5,0,0,-1,1,0,1,1,-1
KR_6739242587,420,-1,31,8,-4,-1,3,2,0,1,1,-3,3,0,0,1,1,0,2,2,0,-5,-4,5,-6,1,1,0,1,-1,1,1,1,6,-1
KR_6672396078,420,-7,-127,-39,-13,0,2,2,-5,7,2,-6,6,0,-2,5,3,0,2,2,0,-10,15,3,-8,5,-9,0,-3,-1,-1,-1,-1,5,-1
KR_6751566927,420,-1,-7,-12,4,1,1,2,4,1,5,-1,4,3,3,1,4,-3,3,0,0,13,-1,-3,-1,4,-4,0,1,1,-1,1,1,1,-1
KR_6755059974,420,-3,-86,-12,-14,-4,4,0,-4,6,2,0,2,2,-7,9,2,1,0,1,-2,-16,2,1,-5,4,-3,0,-2,-1,-1,-1,-1,6,-1
KR_6645545649,420,-8,-105,-15,-15,-4,5,1,-2,4,2,-9,9,0,-2,5,3,2,0,2,0,-15,0,-4,-4,8,-5,0,-3,-1,1,-1,-1,6,-1
KR_6764670858,420,2,9,-21,2,2,0,2,3,1,4,4,0,4,-4,8,4,-3,3,0,0,0,-220,2,-7,5,0,0,0,-1,1,0,1,3,-1
KR_6755618590,420,-4,-79,-15,-8,0,2,2,3,0,3,-6,6,0,-5,7,2,0,1,1,0,-6,-17,-9,-1,10,3,0,-1,-1,-1,-1,-1,5,-1
KR_6754377934,420,2,1,7,3,5,0,5,1,3,4,-3,4,1,0,4,4,0,1,1,-1,-7,6,3,-5,2,-2,0,3,-1,1,1,-1,1,-1
KR_6760219437,420,-3,45,-15,-4,-5,5,0,3,1,4,-2,4,2,2,0,2,-2,3,1,0,0,-101,0,-5,5,-1,0,-1,1,-1,-1,-1,5,-1
KR_6752745072,420,-1,16,-4,1,4,1,5,-1,1,0,-1,2,1,-3,6,3,2,0,2,0,1,-10,-5,-2,7,2,0,0,-1,0,0,1,2,-1
KR_6742297326,420,-4,-89,-16,-16,-2,2,0,-7,10,3,-3,4,1,-1,5,4,-3,4,1,-1,-10,2,-1,-4,5,4,0,-2,-1,0,-1,-1,4,-1
KR_6755700471,420,1,53,8,6,0,4,4,0,3,3,2,3,5,2,1,3,2,1,3,1,7,-4,3,-4,1,1,0,1,-1,1,1,1,5,-1
KR_6684131603,420,0,-26,-4,-2,-1,1,0,2,0,2,0,0,0,0,4,4,-3,4,1,0,4,0,4,-7,3,-1,0,-2,1,-1,-1,-1,6,-1
KR_6713043866,440,-5,-77,-12,-8,3,0,3,-4,6,2,-6,9,3,2,0,2,-3,6,3,0,-24,3,2,-7,5,3,0,-1,-1,0,-1,-1,6,-1
KR_6763035190,420,-5,-39,-32,-10,-6,6,0,-1,3,2,-2,3,1,-2,6,4,1,0,1,0,-7,3,-2,-5,7,-6,0,-3,-1,-1,-1,-1,1,-1
KR_6731482133,420,0,-9,-23,2,2,2,4,2,2,4,1,3,4,-4,7,3,1,1,2,1,-3,24,1,-4,3,-2,0,3,-1,1,1,1,3,-1
KR_6762593116,420,-2,-26,0,-5,0,2,2,0,1,1,-2,2,0,0,1,1,-3,4,1,0,-7,118,4,-8,4,-3,0,0,0,-1,-1,1,0,-1
KR_6714189583,420,-1,-14,-28,-4,-2,5,3,-4,5,1,0,2,2,2,0,2,0,0,0,0,1,-2,-6,-3,9,0,0,-1,-1,-1,-1,1,3,-1
KR_6675336778,420,-1,-71,25,-8,-2,4,2,-4,5,1,2,1,3,-5,9,4,1,0,1,0,-8,-170,0,-7,7,-5,0,-2,1,-1,-1,-1,6,-1
KR_6745568245,420,-1,36,12,-8,-1,1,0,-1,1,0,4,1,5,-7,7,0,-3,4,1,0,-9,-112,1,-4,3,2,0,-1,-1,1,-1,-1,1,-1
KR_6763143378,420,-2,-36,7,-5,-3,3,0,11,0,11,-6,6,0,-5,5,0,-2,3,1,-2,-11,-2,-1,-3,4,0,0,0,1,1,-1,-1,2,-1
KR_6759006689,440,-4,-13,7,-6,0,4,4,-2,3,1,0,0,0,-4,4,0,0,6,6,0,-16,-119,-2,-6,8,-1,0,-1,-1,-1,-1,-1,5,-1
KR_6763596918,420,-5,-36,-13,-5,0,0,0,-7,7,0,3,1,4,0,6,6,-1,1,0,0,-7,-377,5,-8,3,-5,0,0,-1,-1,0,1,6,-1
KR_6752091893,420,-4,-46,3,-12,1,1,2,-6,8,2,2,1,3,-9,9,0,0,5,5,0,-19,8,5,-9,4,-2,0,0,-1,1,-1,-1,3,-1
KR_6722828606,420,-3,-92,-40,-13,0,2,2,-3,4,1,-2,4,2,-7,8,1,-1,1,0,0,-13,-25,-4,-4,8,-1,0,0,-1,1,-1,-1,6,-1
KR_6665569740,440,-4,-26,-16,-12,-8,10,2,-4,6,2,0,2,2,-1,4,3,1,0,1,0,-9,-1,-2,-5,7,1,0,-1,-1,0,-1,-1,5,-1
KR_6744750354,420,-1,37,0,-5,0,2,2,-7,8,1,5,1,6,-3,3,0,0,0,0,0,-6,-24,6,-9,3,-2,0,0,1,0,0,1,1,-1
KR_6756868392,420,-3,-87,3,-8,-2,3,1,-2,3,1,1,1,2,-3,3,0,-2,3,1,-2,-13,-2,-1,-3,4,-4,0,-2,1,1,-1,-1,6,-1
KR_6738562864,420,2,22,24,2,-1,1,0,5,3,8,0,4,4,-2,4,2,0,2,2,0,12,47,-3,-7,10,-3,0,0,-1,-1,0,-1,2,-1
KR_6738101881,440,1,-46,5,4,3,0,3,0,2,2,0,1,1,1,0,1,0,1,1,0,7,2,-4,-5,9,6,0,-1,-1,-1,-1,1,1,-1
KR_6764411759,420,-1,-25,-4,-4,-1,1,0,-2,3,1,-1,2,1,-3,3,0,3,1,4,2,4,-3,2,-5,3,-3,0,-1,1,-1,-1,1,3,-1
KR_6757069429,420,1,9,6,-6,3,1,4,-6,8,2,-2,2,0,1,2,3,-2,2,0,0,-13,-3,1,-7,6,-1,0,0,-1,-1,-1,-1,3,-1
KR_6759184365,420,-7,-158,3,-20,-7,7,0,0,2,2,-7,9,2,-1,4,3,-5,7,2,-1,-14,3,0,-5,5,-3,0,-4,0,0,-1,-1,0,-1
KR_6755110679,420,-5,-109,-24,-9,0,2,2,-3,5,2,-7,11,4,0,3,3,1,0,1,-2,-12,12,-1,-3,4,0,0,-3,-1,-1,-1,-1,1,-1
KR_6723536691,420,0,-32,5,1,-3,3,0,-1,2,1,3,0,3,-1,4,3,3,0,3,-1,7,125,5,-10,5,-13,0,-1,-1,0,-1,-1,5,-1
KR_6724525911,420,2,-23,-10,2,1,1,2,3,1,4,-2,2,0,1,3,4,-1,2,1,0,3,1,-2,-6,8,-5,0,0,-1,-1,0,1,1,-1
KR_6740330833,420,-1,-14,11,-2,-1,3,2,3,1,4,-2,6,4,2,2,4,-4,4,0,0,-3,-238,0,-6,6,-1,0,0,-1,-1,0,1,1,-1
KR_6755232585,420,0,25,-20,1,1,0,1,-4,7,3,0,2,2,5,5,10,-1,2,1,0,-9,-12,4,-6,2,-4,0,-1,-1,-1,-1,-1,3,-1
KR_6744112870,420,-1,1,-4,-5,-3,4,1,1,1,2,-1,3,2,-3,5,2,1,0,1,0,-14,-3,2,-5,3,0,0,0,-1,1,0,-1,3,-1
KR_6703069337,420,1,5,-22,5,-2,4,2,2,3,5,0,6,6,-1,2,1,6,0,6,0,12,1,-4,-5,9,6,0,-1,-1,1,1,1,2,-1
KR_6759244192,420,-1,-24,47,-4,5,0,5,-3,3,0,-3,4,1,-2,3,1,-1,2,1,0,-6,21,-1,-7,8,-5,0,0,1,-1,-1,-1,4,-1
KR_6764397251,440,-3,-73,-16,-6,0,1,1,-5,6,1,0,0,0,-3,5,2,2,0,2,0,-10,-7,-2,-6,8,7,0,-1,-1,1,-1,-1,4,-1
KR_6763274217,420,-6,-82,16,-19,-3,4,1,-4,5,1,-3,4,1,-7,8,1,-2,2,0,0,-19,8,-4,-4,8,-1,0,-1,-1,1,-1,1,2,-1
KR_6707792802,420,-7,-128,-8,-8,-2,3,1,-1,2,1,-10,10,0,3,4,7,2,0,2,0,-2,0,1,-5,4,-7,0,-4,-1,-1,-1,-1,1,-1
KR_6761463749,420,-6,-67,-55,-11,1,2,3,-8,8,0,-1,5,4,0,2,2,-3,4,1,-1,-23,54,5,-6,1,-6,0,-3,1,-1,-1,-1,2,-1
KR_6712814019,420,-2,18,-20,-11,-2,3,1,-5,5,0,-4,7,3,-1,3,2,1,1,2,0,-19,-1,1,-7,6,-4,0,0,-1,-1,0,-1,6,-1
KR_6688524462,420,-5,-82,-5,-10,0,1,1,-1,4,3,-2,4,2,-4,4,0,-3,4,1,0,-9,66,-5,-5,10,1,0,-2,-1,-1,-1,-1,4,-1
KR_6390881579,420,-3,-73,1,-6,-2,3,1,3,3,6,-5,5,0,-4,4,0,2,0,2,0,-3,-4,1,-5,4,-6,0,-2,0,-1,-1,1,0,-1
KR_6752388126,420,-7,-7,-28,-16,-2,2,0,-1,1,0,-8,8,0,-4,5,1,-1,2,1,0,-7,-226,-1,-4,5,1,0,-1,1,-1,-1,-1,6,-1
KR_6642541629,420,-4,-28,-14,-7,1,2,3,-3,5,2,-2,2,0,-3,3,0,0,0,0,0,-12,-5,0,-5,5,2,0,-1,1,-1,-1,1,3,-1
KR_6734777274,420,-3,-25,-4,-8,-4,4,0,-2,3,1,-6,7,1,5,1,6,-1,1,0,0,-7,4,4,-7,3,-6,0,0,-1,1,0,-1,1,-1
KR_6751508969,440,-2,-79,23,0,0,1,1,1,3,4,1,1,2,-1,4,3,-1,3,2,1,4,-1,1,-6,5,-7,0,-2,-1,0,-1,1,3,-1
KR_6556860018,420,1,1,6,2,3,1,4,-3,5,2,1,4,5,1,2,3,0,1,1,1,6,9,-1,-2,3,-1,0,-1,-1,-1,-1,1,3,-1
KR_6745224950,440,-2,-3,8,0,2,0,2,-1,2,1,0,2,2,0,1,1,-1,1,0,0,1,3,4,-6,2,-6,0,0,-1,-1,-1,-1,4,-1
KR_6591303276,420,-2,47,9,-5,0,3,3,-4,7,3,1,1,2,-2,3,1,0,0,0,0,-8,-3,-3,-3,6,5,0,1,1,-1,1,-1,4,-1
KR_6609894907,420,-2,-30,27,-11,-4,4,0,-6,6,0,0,2,2,-1,2,1,0,1,1,0,-10,-7,-8,-2,10,-4,0,0,1,-1,0,1,6,-1
KR_6713107055,420,-1,-82,16,-3,-4,4,0,1,1,2,1,2,3,1,3,4,-2,4,2,0,-4,-2,1,-4,3,-2,0,0,1,-1,-1,-1,6,-1
KR_6738463520,420,2,3,36,0,1,1,2,-3,5,2,-1,1,0,1,3,4,2,4,6,0,-4,42,0,-7,7,-30,0,-1,1,-1,-1,1,2,-1
KR_6760024468,420,-2,-92,-20,-6,1,2,3,-5,7,2,1,2,3,-5,5,0,2,0,2,0,-17,13,0,-4,4,-6,0,0,-1,-1,-1,-1,5,-1
KR_6742302043,420,2,-15,-12,0,6,0,6,-3,5,2,-1,2,1,-2,3,1,0,1,1,0,-9,12,-1,-3,4,-2,0,1,-1,1,1,1,2,-1
KR_6665620616,440,-4,-38,13,-7,0,3,3,-1,3,2,0,0,0,-4,5,1,-2,2,0,0,-11,-10,-4,-5,9,-3,0,-1,0,-1,-1,1,0,-1
KR_6760820129,420,-3,-18,-36,-8,1,2,3,0,2,2,-9,11,2,0,4,4,0,1,1,-2,-14,-20,2,-8,6,3,0,-2,-1,-1,-1,-1,5,-1
KR_6718918469,440,-1,-7,16,-6,-1,2,1,2,3,5,-2,2,0,-4,5,1,-1,1,0,0,-7,1,0,-5,5,-9,0,0,0,0,0,1,0,-1
KR_6763722108,440,-2,-80,-24,-10,0,1,1,-4,5,1,-1,2,1,-5,5,0,0,1,1,0,-18,-23,-2,-3,5,3,0,0,0,1,-1,-1,0,-1
KR_6757477725,420,-1,6,-10,-4,3,1,4,-2,4,2,-1,3,2,0,1,1,-4,4,0,0,-9,-9,-2,-2,4,-1,0,-3,-1,-1,-1,1,5,-1
KR_6597424554,420,0,-38,-8,-3,-3,6,3,-2,5,3,2,2,4,0,7,7,0,1,1,2,-5,9,1,-6,5,-7,0,0,-1,-1,0,-1,1,-1
KR_6763539455,420,1,16,27,7,2,2,4,0,0,0,0,3,3,5,1,6,0,0,0,-1,4,-4,-2,-3,5,9,0,1,1,1,1,-1,4,-1
KR_6746543425,420,-3,10,-18,-6,-3,3,0,1,2,3,-1,5,4,-2,3,1,-1,2,1,-1,-8,18,2,-7,5,0,0,-1,-1,1,-1,-1,1,-1
KR_6764129478,420,1,-57,16,-7,-1,2,1,-3,5,2,-1,5,4,-1,4,3,-1,2,1,0,-11,-5,-1,-5,6,2,0,-1,-1,-1,-1,-1,1,-1
KR_6763494776,420,1,18,-7,5,1,1,2,1,1,2,6,3,9,-2,5,3,-1,1,0,0,1,-12,2,-6,4,-7,0,0,-1,1,0,1,4,-1
KR_6740841381,440,-1,27,16,-3,-1,1,0,-4,6,2,2,0,2,2,1,3,-2,4,2,2,-2,-10,-1,-3,4,8,0,-1,0,1,-1,1,0,-1
KR_6758730367,440,-3,-54,-6,-6,-1,1,0,-2,2,0,-5,6,1,1,2,3,1,2,3,0,-4,10,5,-8,3,-5,0,-2,0,-1,-1,1,0,-1
KR_6763274098,420,-3,-28,-23,-4,2,0,2,5,1,6,-6,8,2,-5,6,1,0,0,0,0,-7,8,2,-7,5,-3,0,-2,1,-1,-1,1,3,-1
KR_6730382914,440,-3,-61,-4,-9,-3,4,1,-1,4,3,0,3,3,-2,2,0,-3,3,0,0,-1,2,3,-8,5,-7,0,0,0,0,0,-1,0,-1
KR_6670455964,420,1,50,-6,-2,-1,1,0,3,2,5,-3,5,2,-1,4,3,0,1,1,-1,-5,-10,-7,0,7,0,0,1,-1,1,1,-1,1,-1
KR_6752052173,420,-3,-57,-12,2,0,3,3,1,2,3,-2,4,2,1,5,6,2,1,3,0,8,4,3,-10,7,-7,0,-1,1,1,-1,1,3,-1
KR_6713938352,420,1,-14,-20,2,4,2,6,0,2,2,-2,2,0,-2,5,3,2,1,3,-1,-3,-1,4,-10,6,3,0,1,0,1,1,-1,0,-1
KR_6685290500,420,0,4,-17,0,2,2,4,0,1,1,-1,4,3,0,1,1,-1,1,0,0,-2,-2,2,-9,7,6,0,-1,1,-1,-1,1,2,-1
KR_6722950556,420,-2,2,-5,-3,-3,5,2,0,3,3,0,3,3,2,1,3,-2,2,0,0,0,0,4,-6,2,2,0,0,1,-1,0,-1,3,-1
KR_6764696040,420,-3,8,-42,-5,-1,1,0,-1,3,2,-1,2,1,-2,3,1,0,0,0,0,0,4,0,-6,6,1,0,0,1,-1,0,1,6,-1
KR_6736357533,440,-5,-43,-37,-9,4,0,4,-4,4,0,-5,5,0,-5,5,0,1,1,2,0,-11,-13,-2,-4,6,4,0,-2,-1,-1,-1,-1,4,-1
KR_6755526647,420,-4,-71,-8,-9,-1,1,0,-2,3,1,-3,4,1,-1,4,3,-2,2,0,0,-16,6,0,-6,6,1,0,0,1,-1,-1,1,1,-1
KR_6764106611,420,0,-18,-5,2,4,0,4,2,2,4,-3,5,2,-4,5,1,3,1,4,0,9,4,5,-12,7,-1,0,1,-1,1,1,1,6,-1
KR_6763662035,420,-4,-35,-36,-14,-1,2,1,-4,5,1,0,1,1,-6,7,1,-3,3,0,-1,-12,14,-2,-3,5,-3,0,-2,-1,-1,-1,-1,6,-1
KR_6734682640,420,-3,-57,28,-7,-2,3,1,0,1,1,-3,3,0,-2,2,0,0,0,0,-1,-12,11,0,-7,7,-4,0,-1,1,-1,-1,-1,6,-1
KR_6530360651,420,-3,-13,-20,0,-1,1,0,-3,4,1,-2,3,1,5,1,6,1,1,2,0,10,3,6,-11,5,-1,0,-1,-1,-1,-1,1,1,-1
KR_6699663673,420,1,-3,16,-9,-1,3,2,-3,6,3,-8,10,2,2,3,5,1,0,1,0,-10,40,-3,-4,7,-29,0,-1,-1,-1,-1,-1,3,-1
KR_6663725208,420,1,-64,16,-2,-1,3,2,5,4,9,2,3,5,-7,8,1,-1,2,1,0,-12,23,-1,-7,8,-3,0,0,1,-1,0,1,2,-1
KR_6753830487,420,-1,-71,43,-7,1,1,2,1,0,1,-7,7,0,-3,3,0,1,0,1,0,-10,43,2,-7,5,-24,0,0,-1,1,-1,1,6,-1
KR_6755632321,420,3,-36,5,4,5,0,5,0,2,2,1,4,5,-2,5,3,0,1,1,0,0,6,0,-5,5,-3,0,-2,1,-1,-1,1,6,-1
KR_6742826399,420,-3,9,0,-9,-3,4,1,-5,6,1,-3,3,0,4,1,5,-2,3,1,0,-5,7,1,-5,4,-2,0,0,1,-1,0,-1,3,-1
KR_6742677604,440,-4,-41,12,-6,-1,3,2,-1,2,1,0,1,1,-1,2,1,-3,3,0,0,-3,-34,-4,0,4,2,0,-1,-1,1,-1,1,3,-1
KR_6751992943,420,-1,12,7,-5,-2,3,1,-2,5,3,-3,5,2,2,4,6,0,2,2,0,-4,4,3,-8,5,-3,0,1,-1,-1,-1,1,1,-1
KR_6749396157,420,-5,-92,-1,-12,-3,5,2,-4,7,3,0,4,4,-2,3,1,-3,3,0,0,-9,0,2,-5,3,-3,0,-1,-1,0,-1,-1,4,-1
KR_6752331407,420,1,-63,21,0,0,1,1,0,3,3,-4,6,2,4,6,10,0,2,2,1,10,-9,-5,-4,9,2,0,0,1,-1,0,1,1,-1
KR_6749548860,420,-1,-49,12,-8,1,2,3,0,3,3,-4,6,2,-6,7,1,1,0,1,0,-8,-309,-5,-1,6,-2,0,0,-1,-1,0,1,5,-1
KR_6601606796,420,-2,-19,8,-1,-3,4,1,-2,5,3,2,0,2,3,1,4,-1,1,0,0,-4,-7,2,-8,6,-1,0,0,1,1,0,-1,4,-1
KR_6734045105,420,4,-37,52,4,0,2,2,0,3,3,0,2,2,4,2,6,0,1,1,0,-1,22,4,-7,3,-3,0,2,-1,1,1,1,6,-1
KR_6762987059,420,-1,28,33,0,0,2,2,-2,4,2,1,0,1,-2,4,2,3,1,4,0,2,14,7,-10,3,-9,0,0,0,1,0,1,0,-1
KR_6731861764,420,-1,15,15,-3,1,4,5,1,1,2,-7,7,0,2,1,3,0,2,2,0,-3,-38,2,-5,3,-1,0,-1,1,1,-1,1,5,-1
KR_5615088556,420,1,-17,26,-1,4,0,4,1,3,4,-4,4,0,-1,3,2,-1,1,0,1,-4,-25,2,-9,7,1,0,-2,1,-1,-1,1,5,-1
KR_6734737531,420,0,-3,-36,5,-2,2,0,0,2,2,1,3,4,0,2,2,6,1,7,0,4,-37,-1,-6,7,31,0,1,1,-1,1,1,6,-1
KR_6760880843,440,-3,-75,9,-7,-2,2,0,-3,4,1,1,3,4,-1,1,0,-2,8,6,-1,-4,8,2,-5,3,-1,0,-2,-1,0,-1,-1,6,-1
KR_6732721865,420,-2,-4,16,-5,-1,3,2,-2,4,2,-2,2,0,-1,1,0,1,0,1,0,-7,5,0,-2,2,-4,0,0,1,-1,0,-1,6,-1
KR_6751342548,420,2,-35,-18,5,0,2,2,5,1,6,0,1,1,1,3,4,-1,2,1,0,12,-4,1,-6,5,7,0,0,1,-1,0,-1,6,-1
KR_6763958445,420,2,0,13,5,0,1,1,1,1,2,0,4,4,4,0,4,0,0,0,0,6,2,1,-4,3,-3,0,-1,1,-1,-1,-1,1,-1
KR_6650356341,420,-3,-68,-4,-6,1,2,3,-2,6,4,-5,6,1,3,2,5,-3,3,0,0,0,11,4,-9,5,-4,0,-1,1,0,-1,-1,1,-1
KR_6719618400,420,-2,-24,4,-10,0,1,1,1,2,3,-4,5,1,-5,7,2,-2,3,1,0,-6,-133,-1,-7,8,5,0,-1,-1,-1,-1,-1,2,-1
KR_6696996505,420,-1,21,2,-3,-2,4,2,-1,2,1,3,0,3,-3,4,1,0,1,1,0,-6,35,-6,-2,8,-11,0,0,-1,1,1,-1,2,-1
KR_6742502949,420,0,-29,20,-6,1,3,4,1,2,3,-1,2,1,-3,4,1,-4,5,1,-1,-2,4,2,-4,2,0,0,-1,1,1,-1,-1,6,-1
KR_6762651414,420,-1,-11,-16,-5,-3,4,1,-5,9,4,0,3,3,4,1,5,-1,2,1,0,-10,-5,-3,-5,8,-1,0,-1,-1,-1,-1,-1,2,-1
KR_6757500963,420,0,-64,-17,3,-3,3,0,6,0,6,-1,1,0,1,3,4,0,2,2,0,12,119,0,-4,4,1,0,0,1,1,1,-1,1,-1
KR_6674920480,420,-3,-5,4,-12,2,0,2,-3,4,1,-9,9,0,-1,3,2,-1,3,2,1,-9,-26,1,-4,3,-3,0,-1,-1,-1,-1,1,6,-1
KR_6763836794,420,-2,-61,-34,-4,-1,3,2,-4,4,0,-2,3,1,2,0,2,1,0,1,0,-1,217,-3,-3,6,-5,0,0,1,-1,-1,-1,3,-1
KR_6718999906,420,-4,-36,-15,-3,2,1,3,1,3,4,-2,4,2,-3,5,2,-1,1,0,0,0,328,0,-5,5,-4,0,1,-1,1,1,-1,3,-1
KR_6762923352,420,-2,-15,-17,-10,-1,2,1,-7,11,4,1,1,2,-3,5,2,0,0,0,0,-14,-1,-1,-8,9,-5,0,1,-1,1,-1,-1,2,-1
KR_6644075124,420,1,-108,-3,-4,-1,3,2,-3,4,1,-1,3,2,2,2,4,-1,2,1,0,4,8,1,-3,2,2,0,-2,-1,-1,-1,-1,3,-1
KR_6756289106,420,-4,32,-1,-10,-1,1,0,-3,5,2,-3,4,1,-2,4,2,-1,2,1,0,-15,-2,0,-3,3,-2,0,-1,1,1,-1,1,2,-1
KR_6678474687,420,0,18,4,0,2,0,2,0,4,4,-3,3,0,-1,4,3,2,0,2,0,-3,25,0,-3,3,5,0,1,0,1,1,1,0,-1
KR_6736653788,420,-4,-16,-25,-4,3,1,4,1,2,3,-2,4,2,-4,6,2,-2,4,2,-1,-8,-17,3,-8,5,-1,0,1,0,1,1,-1,0,-1
KR_6761308411,420,-4,-18,-7,-15,1,3,4,-6,6,0,0,0,0,-5,5,0,-5,5,0,0,-15,-13,-1,-3,4,1,0,-2,-1,-1,-1,-1,5,-1
KR_6743159414,420,-2,-37,-16,1,0,2,2,-2,4,2,0,1,1,0,4,4,3,1,4,0,1,-8,-1,-3,4,-1,0,1,0,1,1,1,0,-1
KR_6744054511,440,1,-17,-4,9,2,3,5,6,3,9,-1,1,0,1,2,3,1,3,4,1,2,-19,3,-4,1,3,0,0,1,1,1,1,6,-1
KR_6756205701,420,1,-34,1,3,-1,2,1,0,0,0,4,3,7,2,1,3,-2,2,0,1,-1,20,3,-6,3,-3,0,0,1,-1,0,1,3,-1
KR_6727535044,440,-1,-75,15,-2,3,1,4,2,0,2,3,2,5,-8,9,1,-2,2,0,1,1,4,1,-8,7,-2,0,1,-1,1,1,1,2,-1
KR_6684093413,420,-5,-115,23,-11,-3,4,1,0,2,2,3,1,4,-4,4,0,-7,7,0,-1,-16,-3,-2,-1,3,-3,0,-1,-1,-1,-1,-1,5,-1
KR_6614625379,420,-3,-25,0,-3,1,2,3,-2,5,3,0,5,5,0,4,4,-2,2,0,0,1,27,-1,-3,4,19,0,-1,1,1,-1,1,1,-1
KR_6735028739,420,-6,-16,-28,-8,-3,3,0,1,3,4,-4,10,6,-1,1,0,-1,1,0,0,-9,4,0,-4,4,-4,0,0,-1,-1,-1,1,4,-1
KR_6761562875,440,-4,-115,-20,-11,-2,5,3,3,0,3,-9,10,1,-1,1,0,-2,2,0,0,-1,0,-4,-1,5,0,0,-3,-1,-1,-1,-1,1,-1
KR_6763042112,420,0,13,4,-4,-2,3,1,3,1,4,1,0,1,-3,4,1,-3,3,0,0,-5,-4,-2,-4,6,-4,0,0,-1,-1,0,-1,6,-1
KR_6747332899,420,1,52,4,5,-3,5,2,5,3,8,0,1,1,4,1,5,-1,2,1,-1,6,50,0,-7,7,-31,0,-2,-1,-1,-1,-1,1,-1
KR_6723460220,420,-3,-56,-12,-13,0,1,1,-6,6,0,-1,4,3,-4,4,0,-2,3,1,-1,-19,-9,0,-4,4,-1,0,0,-1,-1,-1,-1,1,-1
KR_6634038155,420,-4,-16,-40,-2,2,1,3,-5,6,1,0,4,4,-1,3,2,2,0,2,0,-2,10,-2,-5,7,-4,0,-2,-1,-1,-1,1,4,-1
KR_6742273299,440,-2,20,-20,-3,-3,5,2,-1,2,1,1,3,4,0,0,0,0,0,0,0,-2,-33,1,-4,3,2,0,-1,-1,0,-1,-1,5,-1
KR_6696956733,420,0,-22,29,-3,0,3,3,1,2,3,-2,4,2,-2,6,4,0,1,1,-1,0,-1,0,-5,5,-3,0,0,-1,0,-1,-1,5,-1
KR_6670205437,420,-1,51,-50,-6,0,2,2,-2,3,1,0,3,3,2,4,6,-6,6,0,0,-9,-7,5,-7,2,0,0,-1,-1,-1,-1,-1,4,-1
KR_6731738753,420,-2,-21,-4,-4,0,2,2,1,1,2,-2,5,3,-2,5,3,-1,1,0,0,-6,9,-1,-2,3,-2,0,0,-1,1,-1,1,4,-1
KR_6738599637,420,4,22,-4,4,-1,3,2,2,0,2,1,3,4,2,2,4,0,2,2,0,5,8,0,-5,5,-1,0,1,1,1,1,-1,3,-1
KR_6760198781,420,-6,-53,7,-20,-8,8,0,-2,3,1,-3,4,1,-2,3,1,-5,5,0,0,-14,16,-1,-1,2,-2,0,0,-1,-1,-1,-1,2,-1
KR_6633359333,420,-3,-24,-20,-5,1,1,2,0,3,3,0,1,1,-3,4,1,-3,3,0,0,-6,-27,1,-4,3,4,0,-1,-1,1,-1,1,2,-1
KR_6716983239,440,-2,4,-29,-8,2,1,3,-1,2,1,-1,7,6,-1,3,2,-7,10,3,0,-11,-127,-2,-2,4,-5,0,-1,-1,-1,-1,1,4,-1
KR_6681137721,420,-1,-54,-10,-5,-6,6,0,3,1,4,-1,2,1,0,0,0,-1,1,0,0,0,0,3,-6,3,-4,0,-1,1,1,-1,1,4,-1
KR_6399798475,420,1,47,-12,5,-4,8,4,3,0,3,1,1,2,7,2,9,-2,2,0,0,15,-9,-1,-6,7,5,0,-2,-1,1,-1,-1,6,-1
KR_6737545495,420,-3,-7,0,-7,-3,3,0,1,3,4,-4,6,2,0,3,3,-1,2,1,0,-13,-3,-3,-6,9,-2,0,-1,-1,-1,-1,-1,5,-1
KR_6751846258,420,-2,-23,-20,-10,1,3,4,-3,6,3,-5,7,2,-5,6,1,2,1,3,1,-4,-34,-1,-5,6,6,0,0,1,-1,0,1,3,-1
KR_6705777293,420,3,9,5,-1,-1,4,3,4,1,5,-1,2,1,-1,3,2,-2,4,2,0,1,2,0,-8,8,-4,0,0,-1,-1,-1,1,1,-1
KR_6750175514,420,-5,-22,-7,-12,-2,3,1,-5,7,2,-5,6,1,0,1,1,0,2,2,0,-13,78,0,-3,3,-5,0,0,-1,-1,1,-1,6,-1
KR_6745948944,420,0,2,4,-1,0,2,2,0,2,2,-1,2,1,-1,7,6,1,1,2,0,-3,116,-1,-5,6,2,0,0,-1,-1,0,-1,3,-1
KR_6764401764,420,1,12,-18,1,-2,3,1,-6,7,1,6,2,8,0,3,3,3,1,4,-2,-2,3,2,-5,3,-4,0,0,-1,-1,-1,-1,5,-1
KR_6762053674,420,-5,-49,-8,-6,-7,8,1,-1,3,2,1,3,4,0,0,0,1,1,2,0,-8,276,3,-9,6,-6,0,-2,1,-1,-1,-1,6,-1
KR_6752148603,420,-2,-52,-32,0,-4,4,0,5,1,6,-1,3,2,0,1,1,0,2,2,1,7,1,3,-5,2,0,0,1,1,-1,1,1,5,-1
KR_6762861821,440,0,37,6,-3,-1,1,0,2,0,2,1,1,2,-1,2,1,-4,5,1,0,-12,3,2,-9,7,-1,0,-1,1,-1,-1,-1,1,-1
KR_6731946928,420,-3,-108,5,-4,-5,5,0,5,3,8,-4,7,3,0,2,2,0,0,0,1,-2,-13,-3,-6,9,3,0,0,-1,1,-1,1,3,-1
KR_6741608008,420,-2,-24,-9,-3,0,2,2,-3,3,0,-3,4,1,2,0,2,1,0,1,0,-1,0,0,-4,4,-3,0,0,1,-1,0,-1,5,-1
KR_6752532013,420,2,80,16,-2,1,0,1,-5,7,2,3,1,4,-3,5,2,2,1,3,0,-11,-2,-1,-4,5,-4,0,0,-1,1,-1,1,2,-1
KR_6508412866,420,-10,-127,-21,-13,0,1,1,-5,9,4,-2,3,1,-6,7,1,0,1,1,0,-5,-6,0,-5,5,-2,0,-3,1,-1,-1,-1,1,-1
KR_6671222794,420,-1,-55,4,0,-5,5,0,5,0,5,-2,4,2,2,1,3,0,2,2,2,9,24,1,-6,5,-4,0,-1,1,-1,-1,1,2,-1
KR_6757847674,420,-1,-35,-39,-1,-4,5,1,0,1,1,1,3,4,2,2,4,0,0,0,0,7,-107,5,-9,4,1,0,-1,-1,-1,-1,-1,3,-1
KR_6758184786,420,2,51,-22,-2,2,1,3,-2,7,5,-2,3,1,0,4,4,0,1,1,0,-10,1,2,-8,6,5,0,0,-1,-1,0,1,6,-1
KR_6688126671,420,-2,-31,2,-1,-4,6,2,6,1,7,-2,4,2,0,2,2,-1,2,1,-1,3,-5,3,-10,7,0,0,-2,0,-1,-1,-1,0,-1
KR_6756545943,420,-1,-5,-5,-5,-6,6,0,-2,3,1,1,0,1,4,1,5,-2,3,1,0,-6,-140,-1,-3,4,4,0,-2,-1,-1,-1,1,1,-1
KR_6719167184,420,4,30,20,3,0,3,3,-4,5,1,4,0,4,2,2,4,1,0,1,0,5,-103,-4,-5,9,0,0,-1,1,-1,-1,1,2,-1
KR_6764247191,420,-5,-91,-52,-11,-4,5,1,-6,7,1,1,4,5,-2,5,3,0,2,2,0,-13,-436,-3,-1,4,-12,0,-1,-1,-1,-1,-1,2,-1
KR_6764986407,420,0,-13,-25,5,-1,1,0,-1,1,0,3,1,4,5,0,5,-1,1,0,0,6,2,-1,-6,7,2,0,1,-1,-1,1,1,3,-1
KR_6689550784,420,-3,3,-31,-3,-3,3,0,-4,4,0,3,0,3,4,2,6,-3,4,1,1,-2,6,12,-12,0,2,0,-1,1,1,-1,1,3,-1
KR_6751756945,420,2,-19,1,3,-3,3,0,1,1,2,1,0,1,5,2,7,-1,1,0,1,12,22,1,-7,6,-1,0,-1,1,-1,-1,1,1,-1
KR_6755652915,420,-1,-73,21,1,0,3,3,2,1,3,1,2,3,-2,3,1,0,1,1,1,-2,1,3,-9,6,5,0,0,0,1,0,1,0,-1
KR_6702565229,440,-4,-56,-17,-18,-7,7,0,-3,5,2,3,2,5,-6,7,1,-5,5,0,-2,-29,8,1,-5,4,-1,0,-1,-1,-1,-1,-1,3,-1
KR_6763812839,420,0,14,18,-3,-1,1,0,2,1,3,-4,4,0,-1,2,1,1,1,2,0,-2,1,5,-6,1,1,0,1,1,-1,1,-1,4,-1
KR_6746702605,420,-2,-26,-4,-2,-3,3,0,3,1,4,3,1,4,-3,6,3,-2,2,0,-1,-4,18,-4,-1,5,-4,0,0,0,1,-1,-1,0,-1
KR_6704191110,420,-5,-43,-32,-16,-8,8,0,-5,6,1,-5,6,1,3,3,6,-1,3,2,1,-12,60,2,-3,1,-17,0,0,1,-1,1,1,5,-1
KR_6756986046,420,0,-11,0,-7,-6,6,0,-3,3,0,0,3,3,3,1,4,-1,1,0,-1,-9,-49,2,-9,7,-9,0,0,0,-1,0,-1,0,-1
KR_6737114214,420,-2,-101,-13,0,1,3,4,0,5,5,4,0,4,-3,4,1,-2,2,0,-1,0,-1,3,-9,6,-2,0,-1,-1,-1,-1,-1,2,-1
KR_6761246566,420,-3,14,-16,-6,3,3,6,-7,7,0,0,1,1,-2,3,1,0,1,1,-1,-21,250,-4,-1,5,-3,0,0,-1,1,0,-1,6,-1
KR_6755603401,420,-2,-1,-20,-2,1,1,2,-2,4,2,-1,2,1,-1,1,0,1,1,2,1,0,-4,-1,-5,6,-2,0,-1,-1,-1,-1,1,5,-1
KR_6629993188,420,-5,-61,-26,-5,3,0,3,-4,6,2,-2,4,2,3,0,3,-5,7,2,0,-6,-5,-1,-6,7,4,0,-1,-1,1,-1,-1,5,-1
KR_6759241141,440,1,-10,8,0,-4,4,0,1,1,2,4,0,4,-2,3,1,1,1,2,1,1,5,-3,-5,8,-2,0,0,-1,-1,0,1,2,-1
KR_6763909200,420,-4,-95,-28,-9,-3,5,2,-2,3,1,-4,5,1,0,1,1,0,2,2,-1,-7,-48,-2,-4,6,15,0,-3,-1,-1,-1,-1,5,-1
KR_6674979176,420,0,13,38,3,-2,3,1,5,1,6,-1,4,3,7,2,9,-6,6,0,-2,6,-1,2,-7,5,-1,0,0,-1,1,1,1,6,-1
KR_6643609219,420,0,17,-8,-2,-3,6,3,-2,4,2,0,3,3,3,1,4,0,0,0,0,0,10,-2,-4,6,5,0,1,-1,1,1,-1,4,-1
KR_6748821815,420,-2,-31,-28,-4,-5,5,0,0,1,1,2,3,5,-1,3,2,0,1,1,0,-1,-2,1,-4,3,-4,0,-2,-1,-1,-1,-1,3,-1
KR_6763404262,420,-2,-31,29,-5,1,1,2,0,1,1,-3,3,0,-4,6,2,1,0,1,0,-10,-2,4,-7,3,-3,0,-1,-1,1,-1,1,2,-1
KR_6759660903,420,1,-4,13,-3,0,0,0,-2,3,1,-2,3,1,1,1,2,0,0,0,0,-1,4,0,-5,5,2,0,-1,1,-1,-1,-1,2,-1
KR_6694336699,420,-1,-56,-3,-4,0,2,2,-2,4,2,2,0,2,1,1,2,-5,5,0,0,-5,5,1,-8,7,-4,0,-2,-1,1,-1,-1,2,-1
KR_6625421128,420,1,2,-20,7,0,1,1,1,3,4,-1,3,2,5,0,5,2,0,2,1,12,-13,1,-4,3,5,0,0,0,1,0,1,0,-1
KR_6764879647,420,-2,34,-32,-6,2,1,3,-5,6,1,0,3,3,-3,3,0,0,2,2,-4,-20,3,0,-3,3,-4,0,0,1,-1,1,-1,6,-1
KR_6658937986,420,-1,28,-14,-4,2,2,4,-1,2,1,-1,4,3,-3,4,1,-1,1,0,-2,-13,-35,1,-7,6,8,0,-1,-1,-1,-1,-1,6,-1
KR_6727590282,440,-3,-13,-12,-12,-2,4,2,-1,2,1,-1,1,0,-8,10,2,0,0,0,0,-10,33,1,-3,2,-14,0,0,0,1,-1,1,0,-1
KR_6761203843,420,-9,-51,-39,-14,-1,5,4,-7,9,2,-2,2,0,-3,3,0,-1,1,0,1,-26,-6,2,-7,5,-4,0,0,-1,-1,0,1,2,-1
KR_6729855736,420,-6,-30,4,-11,1,1,2,-3,7,4,-4,5,1,-3,8,5,-2,3,1,-2,-18,-62,2,-6,4,0,0,-2,1,-1,-1,1,6,-1
KR_6691352016,420,-4,-49,-16,-2,2,1,3,1,1,2,-5,5,0,1,2,3,-1,1,0,0,9,-23,2,-7,5,3,0,-1,-1,1,-1,-1,2,-1
KR_6759789376,440,-1,49,-36,-8,0,0,0,-7,7,0,1,3,4,-2,4,2,0,1,1,-1,-7,-18,-3,-2,5,1,0,1,-1,1,1,-1,4,-1
KR_6744872785,420,2,-18,20,1,-1,1,0,0,3,3,4,2,6,0,4,4,-2,2,0,-1,1,9,0,-4,4,1,0,0,-1,0,-1,-1,1,-1
KR_6736021693,420,-1,11,-20,1,0,2,2,-1,2,1,3,1,4,-2,3,1,1,0,1,0,-3,-2,-1,-5,6,6,0,0,-1,-1,0,1,6,-1
KR_6714318544,420,-4,-47,-36,-12,-3,3,0,-1,3,2,-2,2,0,-5,7,2,-1,1,0,0,-10,-1,2,-8,6,0,0,-2,-1,-1,-1,-1,6,-1
KR_6747657389,420,-3,-4,-52,0,1,3,4,-3,5,2,3,0,3,0,0,0,-1,1,0,0,-6,-3,-1,-2,3,3,0,0,-1,1,-1,1,1,-1
KR_6763227817,420,-1,-46,-4,-1,-1,2,1,1,2,3,4,2,6,-5,10,5,0,0,0,0,0,172,0,-4,4,19,0,0,1,1,-1,1,6,-1
KR_6745135807,420,-4,-39,-29,-7,-1,2,1,-4,6,2,-1,3,2,-1,2,1,0,2,2,-1,-3,-30,-1,-5,6,2,0,-1,-1,-1,-1,-1,1,-1
KR_6690832249,420,1,83,8,-6,-1,1,0,-3,5,2,0,1,1,-2,2,0,0,0,0,0,-11,-18,-5,-6,11,1,0,0,1,1,0,-1,6,-1
KR_6745245450,420,-8,-105,-24,-19,-7,7,0,3,1,4,-7,7,0,-5,5,0,-3,4,1,0,-10,2,2,-7,5,2,0,-1,-1,1,-1,-1,2,-1
KR_6658715511,420,-4,0,-16,-7,0,0,0,-2,5,3,-3,5,2,-2,4,2,0,1,1,0,-6,-9,1,-9,8,-2,0,-1,-1,1,-1,1,1,-1
KR_6755075901,440,-1,19,12,-9,-2,2,0,-3,3,0,-3,5,2,1,0,1,-2,2,0,0,-2,10,7,-9,2,-4,0,0,-1,-1,0,-1,3,-1
KR_6742998520,440,-9,-141,-1,-13,-3,4,1,-2,2,0,-4,4,0,-3,5,2,-1,1,0,0,-8,-6,1,-2,1,2,0,-2,-1,1,-1,-1,2,-1
KR_6734571836,420,1,-58,-7,5,7,1,8,-4,6,2,4,0,4,-2,6,4,0,0,0,2,12,14,4,-6,2,-1,0,0,-1,1,0,1,1,-1
KR_6705051890,420,3,-10,34,6,-1,2,1,6,1,7,0,2,2,1,1,2,0,0,0,0,4,-1,-1,-4,5,1,0,0,1,1,0,1,6,-1
KR_6758040472,420,0,33,1,-7,-2,4,2,-2,4,2,-2,4,2,0,2,2,-1,2,1,0,-3,-14,-3,-5,8,2,0,0,-1,-1,0,-1,2,-1
KR_6725072313,420,-2,-6,-20,-2,-4,6,2,3,1,4,-2,3,1,2,5,7,-1,1,0,0,-5,0,3,-7,4,2,0,-1,1,0,-1,-1,2,-1
KR_6399350512,420,-4,-10,-28,-9,-6,7,1,2,4,6,0,2,2,-4,5,1,-1,1,0,0,-8,217,-3,-5,8,-9,0,0,-1,1,-1,1,4,-1
KR_6763280437,440,-5,-18,8,-3,-1,1,0,0,1,1,-4,4,0,2,3,5,0,2,2,0,-1,2,3,-4,1,3,0,0,-1,-1,0,-1,2,-1
KR_6755254522,420,-2,-21,-20,-3,1,1,2,-5,6,1,-5,7,2,4,0,4,2,0,2,1,3,-36,-3,-5,8,3,0,0,-1,-1,-1,1,4,-1
KR_6755263241,420,-3,-62,12,-4,-1,2,1,-5,5,0,-2,2,0,5,3,8,-1,2,1,0,1,2,1,-4,3,-3,0,-2,1,-1,-1,1,1,-1
KR_6753418743,420,-4,-52,-3,-12,-3,3,0,-1,2,1,1,3,4,-5,5,0,-4,4,0,0,-11,34,-2,-5,7,-26,0,-3,-1,-1,-1,1,1,-1
KR_6731682347,420,2,20,-4,7,-3,3,0,3,1,4,0,0,0,8,1,9,-1,1,0,0,15,-13,-1,-4,5,4,0,0,-1,-1,1,1,3,-1
KR_6725016362,420,-7,-68,-16,-19,-6,6,0,-3,4,1,-3,6,3,-4,5,1,-3,4,1,-2,-19,7,3,-9,6,-8,0,-2,-1,-1,-1,-1,2,-1
KR_6761503522,420,5,87,23,8,0,2,2,1,0,1,4,1,5,-1,2,1,4,0,4,0,8,-2,-3,-4,7,1,0,3,-1,0,1,1,6,-1
KR_6633278603,420,1,20,5,4,4,1,5,4,0,4,-1,3,2,-3,4,1,0,0,0,0,-3,7,0,-5,5,-2,0,1,1,1,1,-1,3,-1
KR_6682577785,420,-3,-10,7,-5,2,1,3,0,1,1,-4,5,1,-4,5,1,1,1,2,0,-9,2,-1,-7,8,3,0,-1,1,-1,-1,1,6,-1
KR_6763547183,440,-2,63,-12,-9,2,0,2,-2,2,0,-2,4,2,-5,6,1,-2,3,1,0,-12,-4,-1,-3,4,1,0,0,1,-1,1,1,5,-1
KR_6742419096,420,-3,46,32,-14,-1,2,1,-3,7,4,1,1,2,-6,7,1,-5,5,0,0,-19,-12,-4,-2,6,-1,0,0,0,-1,-1,-1,0,-1
KR_6732573815,420,-5,-89,-8,-11,1,0,1,-4,4,0,-2,3,1,-6,6,0,0,0,0,0,-17,-11,-7,-1,8,0,0,0,1,-1,-1,-1,3,-1
KR_6762283522,440,-2,59,-4,-4,-2,3,1,2,2,4,-3,3,0,-2,4,2,1,1,2,1,-1,34,1,-3,2,-27,0,0,0,1,0,1,0,-1
KR_6757554462,420,-1,-22,13,-3,3,1,4,-3,4,1,-2,3,1,2,3,5,-3,3,0,0,-4,-5,1,-4,3,3,0,-1,1,-1,-1,1,3,-1
KR_6751507981,420,-4,-63,14,-9,-3,6,3,0,6,6,-4,7,3,-2,3,1,0,0,0,0,-12,-10,1,-3,2,5,0,-1,-1,0,-1,-1,1,-1
KR_6741784545,420,-5,-39,-8,-9,-3,3,0,-1,2,1,-4,4,0,1,2,3,-2,2,0,0,-3,-198,2,-5,3,-2,0,0,-1,-1,0,-1,3,-1
KR_6745789644,420,-6,-114,-48,-11,-1,2,1,-2,6,4,0,1,1,-7,7,0,-1,3,2,0,-9,-33,-5,-6,11,2,0,0,-1,-1,0,-1,2,-1
KR_6641278078,420,-4,-41,-16,-8,3,2,5,-2,4,2,0,1,1,-9,9,0,0,2,2,0,-11,2,0,-5,5,-2,0,-5,-1,-1,-1,-1,3,-1
KR_6757050657,420,0,-30,12,-3,2,1,3,-4,4,0,1,0,1,-3,4,1,1,1,2,0,-3,4,-3,-3,6,2,0,-1,1,-1,-1,-1,2,-1
KR_6761080328,420,-6,-85,4,-10,-3,4,1,0,2,2,-3,4,1,5,3,8,-9,12,3,0,-4,-15,4,-5,1,-1,0,-3,-1,-1,-1,-1,4,-1
KR_6754763528,420,1,26,21,-3,2,1,3,2,3,5,1,0,1,-7,8,1,-1,1,0,0,-15,-13,0,-4,4,0,0,0,1,-1,1,-1,3,-1
KR_6764619229,420,-1,-46,20,1,2,0,2,-1,2,1,2,1,3,-3,5,2,1,1,2,0,-6,7,4,-6,2,-5,0,-1,1,-1,-1,1,3,-1
KR_6757213335,420,-1,-61,0,-5,1,2,3,-3,4,1,-2,7,5,1,3,4,-2,4,2,0,-9,-1,0,-6,6,-3,0,0,1,-1,0,1,4,-1
KR_6752317920,420,-2,-96,-9,-6,-4,5,1,-7,7,0,7,2,9,-2,3,1,0,0,0,0,-5,15,-3,-5,8,-2,0,-1,0,-1,-1,-1,0,-1
KR_6749488788,420,-3,-69,-12,-6,-6,6,0,-2,3,1,-2,4,2,5,1,6,-1,1,0,0,2,-134,-2,-3,5,0,0,0,1,1,1,-1,3,-1
KR_6722145761,420,-4,-10,-16,-8,-3,4,1,-2,4,2,-1,3,2,-3,4,1,1,1,2,0,-6,-7,-2,-5,7,-5,0,-2,-1,-1,-1,-1,1,-1
KR_6713930626,420,0,-17,-9,5,4,0,4,1,1,2,2,0,2,-6,7,1,4,1,5,0,1,-3,-2,-3,5,-3,0,0,-1,-1,1,1,3,-1
KR_6722232137,420,-1,-82,-20,4,5,1,6,-3,3,0,2,0,2,0,2,2,0,1,1,0,1,8,3,-5,2,-2,0,-1,-1,1,-1,1,2,-1
KR_6763600027,420,-1,5,-11,0,-2,3,1,4,2,6,-2,3,1,-1,5,4,1,0,1,0,-1,-19,4,-7,3,-3,0,0,-1,-1,0,-1,1,-1
KR_6734321168,420,-9,-74,-84,-17,0,1,1,-2,3,1,-6,6,0,-3,3,0,-6,6,0,0,-12,-16,-2,-4,6,1,0,-3,-1,-1,-1,-1,4,-1
KR_6742094870,420,0,-71,16,1,0,0,0,-3,5,2,0,1,1,3,1,4,1,0,1,0,-1,-37,1,-7,6,17,0,-1,-1,-1,-1,-1,2,-1
KR_6758608338,440,4,8,16,10,1,2,3,6,1,7,0,1,1,0,2,2,3,0,3,0,10,11,0,-3,3,3,0,0,1,-1,-1,1,1,-1
KR_6752785039,420,0,39,-5,-8,-6,6,0,-2,3,1,1,6,7,-1,3,2,0,0,0,2,-6,24,0,-2,2,-6,0,-1,-1,-1,-1,1,6,-1
KR_6758646108,420,-2,-28,12,-6,-5,5,0,4,1,5,4,1,5,-7,7,0,-2,3,1,0,-5,-24,1,-4,3,-4,0,-1,1,1,-1,-1,5,-1
KR_6734247403,420,-1,-24,-22,-4,1,1,2,0,5,5,3,0,3,-4,7,3,-4,5,1,0,-4,-3,0,-6,6,-6,0,-1,-1,1,-1,1,2,-1
KR_6707513354,420,-3,-16,-64,-2,-1,3,2,2,2,4,-1,1,0,-1,2,1,-1,1,0,0,0,-94,0,-7,7,1,0,1,-1,1,1,-1,1,-1
KR_6759523513,420,2,-1,24,5,3,0,3,3,2,5,-1,2,1,0,4,4,0,1,1,0,3,0,-4,-3,7,-5,0,-1,-1,1,-1,-1,5,-1
KR_6447051507,420,3,-16,-3,6,3,0,3,-2,5,3,1,1,2,3,2,5,1,1,2,2,7,-8,-2,-5,7,5,0,0,1,-1,0,1,4,-1
KR_6732099053,420,-3,8,2,-15,0,1,1,-4,6,2,-1,3,2,-6,9,3,-4,4,0,0,-16,112,0,-4,4,-1,0,-1,0,-1,-1,-1,0,-1
KR_6475243544,420,-2,-30,21,-7,-4,4,0,2,3,5,-4,4,0,-2,5,3,1,1,2,0,-4,35,1,-6,5,0,0,0,0,1,1,-1,0,-1
KR_6722240488,420,-1,-40,9,-5,-3,4,1,1,1,2,1,3,4,-5,7,2,1,0,1,0,2,4,2,-8,6,1,0,-1,-1,-1,-1,-1,6,-1
KR_6756713411,420,-4,-40,-32,-6,-1,2,1,-2,3,1,1,1,2,-3,9,6,-1,3,2,0,3,-5,-8,-1,9,0,0,0,-1,0,0,-1,4,-1
KR_6720529235,420,-1,-1,-12,-3,2,2,4,1,4,5,1,2,3,-5,6,1,-2,2,0,0,-2,5,4,-8,4,-2,0,1,0,-1,1,1,0,-1
KR_6758512229,420,-4,-34,-12,-8,-4,6,2,-2,4,2,0,2,2,0,1,1,-2,2,0,0,-13,-10,-5,-4,9,0,0,-2,-1,-1,-1,-1,4,-1
KR_6733338712,420,-3,-11,-2,-9,-1,2,1,-3,6,3,2,0,2,-4,4,0,-3,3,0,0,-8,-10,0,-3,3,1,0,-2,1,-1,-1,-1,4,-1
KR_6764644669,420,-5,-80,-16,-7,-2,3,1,1,2,3,-4,5,1,-2,2,0,0,2,2,0,-4,23,-2,-4,6,-17,0,-1,1,-1,-1,-1,4,-1
KR_6753567441,420,-2,2,-40,3,-2,3,1,2,1,3,-2,5,3,4,0,4,1,0,1,0,7,23,3,-7,4,-29,0,-1,-1,-1,-1,-1,1,-1
KR_6701083464,420,-2,-7,2,-8,1,1,2,-2,4,2,-2,2,0,-4,4,0,-1,1,0,0,-15,-1,1,-5,4,4,0,-1,-1,1,-1,1,1,-1
KR_6762413970,420,-5,-14,-12,-11,-4,6,2,-5,7,2,-3,5,2,2,1,3,-1,1,0,0,-13,44,1,-5,4,-3,0,-1,-1,0,-1,-1,1,-1
KR_6745286339,420,2,48,-15,8,0,1,1,0,2,2,2,2,4,5,0,5,1,0,1,0,7,15,6,-8,2,-4,0,2,1,-1,1,-1,2,-1
KR_6686162130,420,-7,-84,-12,-12,-1,1,0,-1,2,1,-8,8,0,-2,3,1,0,0,0,0,-10,-70,0,-5,5,-4,0,-2,-1,1,-1,-1,5,-1
KR_6748846200,420,-4,-44,-12,-9,-4,6,2,-5,6,1,2,0,2,-2,5,3,0,1,1,0,-7,-3,-3,-1,4,-2,0,0,-1,1,0,-1,2,-1
KR_6761800784,440,-1,3,14,0,-5,5,0,-2,3,1,4,1,5,0,2,2,3,0,3,0,0,5,-2,-5,7,-2,0,0,0,1,0,-1,0,-1
KR_6748954982,420,-6,-103,-8,-8,1,1,2,-3,3,0,-2,3,1,-4,4,0,0,1,1,0,-7,0,0,-5,5,-5,0,-1,1,-1,-1,-1,6,-1
KR_6754066775,420,-1,-76,16,-1,1,1,2,1,6,7,-3,3,0,1,3,4,-1,3,2,0,-6,-5,-4,-4,8,-3,0,0,-1,-1,0,1,4,-1
KR_6750646259,420,-1,14,4,-6,-2,3,1,-4,5,1,-2,2,0,-3,5,2,5,0,5,0,-7,35,1,-4,3,-1,0,0,1,1,0,1,5,-1
KR_6757125639,420,-2,-45,-6,5,-4,4,0,5,0,5,0,2,2,0,3,3,4,1,5,1,18,4,1,-6,5,-1,0,-1,1,-1,-1,1,1,-1
KR_6665483864,420,1,-61,-36,-2,-3,3,0,-3,9,6,1,2,3,-1,3,2,4,0,4,-2,-7,0,-2,-4,6,2,0,0,-1,-1,-1,-1,5,-1
KR_6736413775,420,1,-2,4,2,0,3,3,1,0,1,1,4,5,0,2,2,0,0,0,-1,2,4,1,-6,5,-1,0,0,1,0,0,-1,6,-1
KR_6762537893,420,3,40,12,3,1,2,3,-2,4,2,3,3,6,0,3,3,1,1,2,0,5,8,0,-6,6,6,0,3,-1,1,1,1,6,-1
KR_6759208582,420,-3,0,9,-1,0,3,3,-4,4,0,2,3,5,2,1,3,-1,1,0,0,0,-4,-2,-5,7,7,0,-1,1,-1,-1,-1,4,-1
KR_6763827545,420,-1,-60,8,-7,0,1,1,1,6,7,-3,4,1,-6,7,1,1,2,3,0,-7,-5,-4,-3,7,0,0,-2,1,-1,-1,-1,6,-1
KR_6756360242,420,-1,-42,-16,-3,5,0,5,-3,4,1,-4,4,0,-5,5,0,4,1,5,0,2,-10,3,-6,3,2,0,-1,-1,1,-1,-1,4,-1
KR_6745813525,420,-4,48,-5,-5,-4,4,0,2,2,4,-1,2,1,-2,5,3,0,0,0,0,-11,-82,1,-5,4,-4,0,0,1,-1,0,1,1,-1
KR_6764994276,420,-1,26,-29,0,-3,3,0,1,2,3,-1,3,2,2,3,5,1,2,3,0,0,6,2,-5,3,1,0,0,-1,1,-1,1,2,-1
KR_6749118507,420,-1,37,-14,2,0,0,0,4,0,4,-1,4,3,1,1,2,-2,2,0,0,-4,-26,2,-8,6,4,0,0,1,-1,0,-1,1,-1
KR_6652786680,420,-2,66,4,-7,-3,4,1,-3,9,6,-1,1,0,1,1,2,-1,2,1,1,-7,2,-4,-4,8,-1,0,-2,-1,-1,-1,1,2,-1
KR_6628761343,420,0,-1,20,7,4,1,5,3,1,4,4,1,5,-5,6,1,1,0,1,0,10,-3,0,-5,5,1,0,0,-1,1,1,-1,1,-1
KR_6688130731,420,-3,-11,-24,-6,-5,6,1,-3,6,3,-1,2,1,3,1,4,0,0,0,0,-2,-6,-1,-4,5,4,0,-1,-1,-1,-1,1,3,-1
KR_6762566053,420,1,67,-11,0,3,1,4,0,2,2,-4,5,1,-1,2,1,2,0,2,0,-7,6,4,-8,4,-7,0,-1,1,-1,-1,1,2,-1
KR_6762786656,420,-1,12,4,-11,-5,6,1,0,2,2,-1,3,2,-6,7,1,1,0,1,0,-13,-127,1,-9,8,-21,0,0,-1,0,0,-1,6,-1
KR_6654616805,420,2,24,-24,1,1,0,1,2,4,6,-2,4,2,0,3,3,0,0,0,0,-6,-6,-1,-7,8,1,0,0,-1,-1,-1,-1,3,-1
KR_6762538255,420,-5,-75,-12,-10,-4,5,1,-3,3,0,-1,4,3,-2,3,1,0,1,1,0,-18,8,-1,-6,7,-2,0,-1,1,-1,-1,-1,3,-1
KR_6759197876,420,0,-42,-2,8,-3,4,1,0,3,3,1,1,2,4,1,5,6,0,6,0,11,-1,-1,-3,4,-2,0,1,1,-1,1,-1,6,-1
KR_6410669013,420,-3,-14,-18,-7,-5,6,1,-4,7,3,0,2,2,4,1,5,-2,2,0,0,-4,3,0,-8,8,-2,0,0,1,1,0,-1,5,-1
KR_6749461150,420,2,28,41,3,-7,7,0,2,1,3,1,1,2,5,0,5,2,1,3,0,10,4,-2,-4,6,-3,0,1,1,1,-1,1,3,-1
KR_6758948994,420,-2,15,2,-11,-3,4,1,-5,5,0,-3,6,3,-1,6,5,1,1,2,-1,5,-14,-5,-5,10,-1,0,0,-1,-1,-1,-1,2,-1
KR_6733458190,420,0,95,-27,0,0,0,0,-2,6,4,2,2,4,1,1,2,-1,1,0,0,-1,-4,1,-6,5,-3,0,0,-1,-1,0,-1,4,-1
KR_6757572445,420,-2,15,-3,1,1,2,3,2,2,4,-3,3,0,1,3,4,0,3,3,0,3,290,0,-3,3,2,0,1,1,-1,1,1,1,-1
KR_6763279875,420,-4,-16,-12,-10,3,0,3,0,3,3,-7,8,1,-4,5,1,-2,2,0,0,-9,-32,-2,-2,4,1,0,-1,-1,1,1,-1,6,-1
KR_6763416087,420,-3,5,12,-7,-1,2,1,-1,3,2,-2,3,1,-1,1,0,-2,2,0,0,-7,5,5,-8,3,-2,0,0,1,-1,0,-1,6,-1
KR_6730079627,420,0,-19,-11,3,1,0,1,0,2,2,3,1,4,-1,2,1,0,1,1,0,-1,-6,6,-7,1,-1,0,1,-1,1,1,1,6,-1
KR_6726438817,420,5,-9,-11,7,2,2,4,4,2,6,-1,4,3,-1,4,3,3,1,4,1,6,5,1,-7,6,4,0,0,-1,1,0,-1,5,-1
KR_6713860220,420,-6,-86,-9,-12,-1,2,1,-8,10,2,1,0,1,-4,4,0,0,1,1,0,-9,-4,1,-3,2,-1,0,-2,-1,1,-1,-1,4,-1
KR_6748330173,420,-2,-20,-19,-4,-3,4,1,3,2,5,0,3,3,-2,4,2,-2,3,1,0,-5,-18,-2,-4,6,-4,0,-1,1,0,-1,-1,6,-1
KR_6699555290,420,-2,-45,-15,-11,-1,4,3,1,0,1,-1,2,1,-2,2,0,-8,8,0,0,-14,-1,3,-7,4,-6,0,0,-1,1,1,-1,2,-1
KR_6710590442,420,-2,-21,27,-6,-1,4,3,-5,5,0,-3,5,2,0,2,2,3,2,5,0,-6,43,-1,-9,10,0,0,1,-1,1,1,-1,4,-1
KR_6738092280,420,-1,-69,25,-7,-2,3,1,-4,4,0,-3,4,1,2,2,4,0,0,0,0,-6,0,-6,-4,10,-6,0,0,-1,1,1,-1,1,-1
KR_6744362278,420,0,-13,-20,-6,-2,3,1,-6,8,2,3,1,4,0,2,2,-1,2,1,-1,-5,-9,-4,-3,7,1,0,-1,-1,-1,-1,-1,4,-1
KR_6764584859,440,-1,-29,2,-3,1,0,1,-2,4,2,-1,4,3,-5,5,0,4,1,5,-2,-1,-5,0,-8,8,2,0,1,-1,1,1,-1,3,-1
KR_6763363365,420,-3,-8,12,-11,-4,5,1,2,0,2,-6,6,0,-5,6,1,2,0,2,0,-13,0,1,-5,4,-2,0,-1,-1,-1,-1,-1,6,-1
KR_6674567657,420,-4,-103,11,-1,0,2,2,-1,2,1,0,4,4,0,0,0,0,0,0,0,3,2,-2,-5,7,-1,0,-1,-1,1,-1,-1,4,-1
KR_6691300559,420,0,-48,-12,3,0,1,1,-1,2,1,3,4,7,0,3,3,1,0,1,0,11,4,-4,-2,6,-4,0,1,1,1,1,-1,2,-1
KR_6725064571,420,-4,-89,1,-5,-1,2,1,3,2,5,-3,4,1,-3,4,1,-1,3,2,0,4,50,5,-7,2,-3,0,-1,0,0,-1,-1,0,-1
KR_6741381203,440,-7,-32,-20,-14,-4,4,0,0,3,3,-1,1,0,-10,10,0,1,1,2,-2,-14,-8,-4,-3,7,0,0,-3,0,-1,-1,-1,0,-1
KR_6613105442,420,1,13,23,-2,0,2,2,1,2,3,-2,4,2,-2,2,0,1,1,2,0,-12,-2,-1,-6,7,-1,0,1,-1,1,1,-1,4,-1
KR_6640129477,420,2,32,55,-2,1,1,2,-2,3,1,3,1,4,-5,6,1,1,0,1,0,-9,2,-2,-3,5,2,0,2,1,1,1,-1,5,-1
KR_6764974379,420,-2,-34,-24,-9,-12,12,0,1,2,3,-2,6,4,3,1,4,1,0,1,0,8,-5,-5,-2,7,-2,0,-3,-1,-1,-1,-1,4,-1
KR_6703198273,420,1,14,-27,6,-3,4,1,-1,5,4,9,2,11,1,1,2,0,0,0,0,11,-2,0,-6,6,-4,0,1,1,0,1,1,4,-1
KR_6695102068,420,-4,-45,-2,-10,-2,2,0,1,4,5,-3,5,2,-5,6,1,-1,1,0,0,-8,-7,-3,-4,7,0,0,-1,-1,-1,-1,1,4,-1
KR_6734781336,420,-7,-84,-17,-12,0,1,1,-5,9,4,-5,5,0,-4,7,3,2,1,3,0,-6,1,2,-9,7,-8,0,0,-1,0,-1,-1,6,-1
KR_6730641548,420,-4,-36,-24,-8,1,3,4,-7,9,2,0,3,3,-3,4,1,1,0,1,0,-1,-32,-3,-3,6,0,0,1,-1,-1,-1,-1,1,-1
KR_6763786601,420,-2,-54,-4,-3,1,2,3,-4,7,3,0,2,2,0,0,0,0,1,1,-1,0,-111,-7,-2,9,3,0,0,-1,1,0,-1,1,-1
KR_6751560004,420,-2,-50,-12,-3,2,0,2,0,2,2,-3,3,0,-1,3,2,-1,1,0,1,-1,-42,-4,-1,5,0,0,0,-1,1,1,1,2,-1
KR_6696789711,420,2,-28,-3,4,1,0,1,2,1,3,4,2,6,-3,3,0,0,1,1,0,4,35,-1,-3,4,-1,0,-1,1,1,-1,1,4,-1
KR_6733775536,420,-1,-56,32,-3,-3,4,1,2,4,6,1,2,3,-1,1,0,-2,3,1,-1,-1,21,3,-6,3,-5,0,-1,-1,0,-1,-1,6,-1
KR_6671194065,420,-1,9,-24,4,2,1,3,-2,5,3,-1,2,1,3,2,5,2,1,3,1,3,-5,1,-6,5,6,0,0,-1,-1,-1,1,6,-1
KR_6642263733,420,-3,-57,-16,-1,-1,2,1,0,1,1,-3,4,1,2,2,4,1,0,1,0,-3,2,1,-4,3,-2,0,0,-1,-1,0,-1,1,-1
KR_6764467038,420,-2,35,2,-1,6,0,6,-2,2,0,-2,4,2,-2,2,0,-1,3,2,0,-12,-6,-1,-5,6,5,0,0,-1,1,0,1,2,-1
KR_6722071954,420,1,-15,0,-7,-6,6,0,-3,3,0,1,1,2,3,0,3,-2,2,0,-1,-4,-108,-2,-3,5,2,0,0,-1,-1,1,-1,1,-1
KR_6755641719,420,1,10,4,1,4,1,5,-2,3,1,0,4,4,1,0,1,-2,3,1,1,1,-4,-1,-1,2,0,0,1,-1,1,1,1,6,-1
KR_6562599579,420,-3,-20,-12,-11,0,0,0,-5,7,2,-6,6,0,2,1,3,-2,2,0,0,-18,21,-8,-3,11,3,0,0,-1,1,0,-1,1,-1
KR_6644425984,420,0,49,-32,5,2,1,3,2,3,5,2,1,3,-1,7,6,0,1,1,1,5,7,3,-7,4,-1,0,1,-1,-1,1,1,1,-1
KR_6692629376,440,2,18,23,2,0,3,3,-3,4,1,-1,2,1,6,0,6,0,1,1,-1,6,-164,-1,-6,7,2,0,-1,1,-1,-1,-1,4,-1
KR_6691258983,440,-7,-64,-60,-10,-6,6,0,-2,4,2,1,0,1,-4,6,2,1,0,1,0,-1,4,0,-5,5,-3,0,-2,-1,-1,-1,1,4,-1
KR_6715236587,420,-8,-122,-34,-18,-7,7,0,-2,6,4,-3,3,0,-3,3,0,-3,4,1,0,-11,3,2,-4,2,-6,0,-2,1,-1,-1,1,4,-1
KR_6758607079,420,-1,34,-9,-7,1,2,3,2,0,2,-2,5,3,-1,3,2,-7,7,0,0,-1,-44,-4,-5,9,-1,0,-1,1,-1,-1,-1,3,-1
KR_6757359283,420,-3,-1,14,-15,-2,4,2,-6,7,1,-5,6,1,-2,2,0,0,1,1,0,-15,-9,-5,-3,8,1,0,0,-1,1,0,-1,4,-1
KR_6759990871,440,-7,-79,-16,-23,-10,11,1,0,0,0,-11,11,0,-2,3,1,0,0,0,0,-11,17,2,-5,3,-1,0,-3,-1,0,-1,-1,2,-1
KR_6736187668,420,-3,-45,-42,1,-1,4,3,1,1,2,4,1,5,-2,3,1,-1,1,0,0,2,1,1,-5,4,-1,0,0,-1,-1,-1,1,4,-1
KR_6761996883,420,-6,-61,-18,-9,-4,6,2,0,2,2,-2,3,1,-5,7,2,2,1,3,1,-8,4,-2,-4,6,-2,0,1,-1,-1,1,1,3,-1
KR_6751438857,440,-4,-83,17,-17,-3,6,3,2,1,3,-9,12,3,-4,4,0,-3,6,3,0,-10,-368,-1,-2,3,-2,0,-3,-1,-1,-1,-1,3,-1
KR_6749030742,420,-4,-63,-14,-10,-5,5,0,-6,7,1,2,0,2,-1,4,3,0,0,0,0,-7,-2,-3,-3,6,-2,0,-1,-1,-1,-1,-1,1,-1
KR_6742475787,420,-4,-71,16,-8,5,0,5,-2,4,2,-1,3,2,-5,8,3,-5,6,1,1,-5,-11,0,-6,6,0,0,-2,-1,1,-1,1,5,-1
KR_6713373299,420,0,-38,32,-5,-5,5,0,-3,5,2,1,0,1,-1,3,2,3,1,4,-1,-6,44,-3,-7,10,-20,0,-1,-1,-1,-1,-1,3,-1
KR_6745033519,420,-4,-53,-26,-15,-3,4,1,-4,5,1,-7,7,0,-1,3,2,0,0,0,0,-9,-42,-2,-4,6,1,0,-2,1,-1,-1,-1,6,-1
KR_6745132705,420,-8,-125,7,-9,0,1,1,-2,4,2,-2,5,3,-3,5,2,-2,3,1,0,-2,4,-5,-1,6,-3,0,-3,-1,1,-1,1,2,-1
KR_6678532543,420,1,-17,28,6,5,0,5,2,2,4,2,3,5,-3,4,1,0,2,2,0,0,-2,-3,-6,9,-2,0,-1,1,1,-1,1,5,-1
KR_6699499568,420,-5,-45,-11,-9,-1,2,1,-4,6,2,-3,3,0,0,2,2,-1,3,2,0,-7,3,-1,-6,7,-2,0,-1,-1,1,-1,-1,3,-1
KR_6721241210,420,-1,42,-28,-3,1,2,3,-3,6,3,-3,3,0,2,3,5,0,0,0,0,-6,-6,-1,-3,4,3,0,-1,-1,-1,-1,1,2,-1
KR_6536256943,420,-2,-49,-7,-10,-1,1,0,1,2,3,-2,2,0,-7,8,1,-1,2,1,0,-12,-114,-4,-6,10,1,0,-1,1,-1,-1,-1,1,-1
KR_6755233935,420,3,50,-6,5,2,1,3,6,1,7,1,1,2,-5,5,0,1,0,1,0,8,-2,5,-8,3,1,0,0,-1,-1,0,1,5,-1
KR_6685687687,440,1,26,-6,1,1,0,1,1,1,2,-1,2,1,-1,3,2,1,0,1,-1,-5,-9,-2,-4,6,3,0,1,1,-1,1,-1,6,-1
KR_6716200599,420,-5,-85,-20,-17,-2,5,3,-6,6,0,-12,12,0,1,1,2,2,4,6,0,-24,-17,2,-6,4,-4,0,-2,0,0,-1,-1,0,-1
KR_6648775711,420,0,8,-16,0,2,1,3,-3,3,0,3,5,8,-5,11,6,3,0,3,0,-9,0,-3,-6,9,2,0,0,-1,1,0,1,3,-1
KR_6730458017,420,-4,-55,-6,-8,-4,6,2,0,4,4,-3,3,0,-1,1,0,0,0,0,0,-7,-2,-2,-8,10,3,0,0,-1,1,-1,-1,3,-1
KR_6745328297,420,-4,-74,-37,-9,0,3,3,0,3,3,-5,6,1,-4,5,1,0,1,1,0,-8,10,3,-6,3,-6,0,-2,-1,-1,-1,1,1,-1
KR_6764331072,420,1,27,21,0,-4,5,1,-1,1,0,5,3,8,-1,1,0,1,1,2,1,6,1,1,-6,5,1,0,0,-1,-1,-1,1,3,-1
KR_6702840460,440,-2,80,-12,-9,-3,7,4,0,4,4,-4,4,0,-3,6,3,1,2,3,1,-17,-1,-3,-7,10,4,0,-1,-1,1,-1,1,1,-1
KR_6734376924,440,-4,-114,-3,-10,-3,4,1,3,1,4,-5,6,1,-3,6,3,-2,3,1,0,-19,-13,-6,-1,7,-1,0,-2,-1,1,-1,-1,5,-1
KR_6749379772,420,-9,-97,-25,-18,-8,9,1,-2,3,1,-2,3,1,-6,6,0,0,0,0,1,-21,-1,5,-8,3,-5,0,-4,1,1,-1,1,3,-1
KR_6667265969,440,-5,-5,-35,-17,-5,5,0,-2,6,4,-5,6,1,-4,7,3,-1,1,0,0,-16,-3,-5,-1,6,-2,0,-1,-1,-1,-1,1,1,-1
KR_6690580081,420,2,-7,-3,-7,0,1,1,-2,2,0,-1,2,1,-3,5,2,-1,2,1,0,-9,-17,-2,-4,6,4,0,0,1,-1,0,-1,2,-1
KR_6743861314,420,-1,19,-10,-2,-1,2,1,-1,6,5,-2,2,0,4,3,7,-2,2,0,1,11,-49,0,-4,4,24,0,-1,0,-1,-1,1,0,-1
KR_6633800439,420,-3,18,-27,-2,-3,4,1,-1,4,3,-1,3,2,3,1,4,0,3,3,0,1,-114,1,-6,5,-7,0,0,-1,1,1,1,2,-1
KR_6748432199,420,-4,-39,-13,-14,-2,3,1,-5,5,0,-3,4,1,-2,6,4,-2,2,0,-2,-21,-12,-6,-4,10,6,0,-1,-1,1,-1,-1,2,-1
KR_6763668110,420,-5,-16,-12,-10,0,0,0,-4,4,0,-5,5,0,0,3,3,-1,1,0,0,-14,54,-2,-3,5,-1,0,0,-1,1,-1,1,3,-1
KR_6743969687,420,-6,-36,-3,-15,-4,4,0,-9,9,0,-2,5,3,-2,3,1,2,0,2,0,-19,6,5,-10,5,-9,0,0,-1,1,1,1,5,-1
KR_6696101260,420,-6,-52,-28,-14,-7,8,1,0,2,2,-2,3,1,-6,7,1,1,0,1,-1,-12,-6,1,-5,4,2,0,-2,-1,1,-1,-1,6,-1
KR_6717467338,420,-1,-25,9,-2,-3,4,1,-1,3,2,-3,5,2,3,2,5,2,0,2,0,8,-11,-3,-5,8,1,0,0,1,-1,0,-1,4,-1
KR_6666916457,420,-7,-75,-88,-6,0,1,1,-4,6,2,2,2,4,-6,8,2,2,0,2,0,-6,-3,2,-7,5,-4,0,-4,-1,-1,-1,-1,1,-1
KR_6728602741,420,1,42,14,3,0,0,0,-4,7,3,3,1,4,2,2,4,2,0,2,0,-1,1,3,-7,4,0,0,1,1,1,1,1,2,-1
KR_6737808697,420,-2,-79,-12,-4,-1,1,0,3,1,4,-3,4,1,-1,1,0,-2,2,0,0,-4,3,2,-7,5,0,0,-1,-1,0,-1,-1,4,-1
KR_6726787133,420,-1,10,-6,-2,-3,3,0,1,4,5,0,1,1,-1,4,3,1,1,2,0,0,25,0,-5,5,3,0,-1,1,-1,-1,-1,1,-1
KR_6732400915,420,-2,-44,-6,2,-2,2,0,2,1,3,1,1,2,1,1,2,0,0,0,0,2,-70,0,-7,7,19,0,-1,1,0,-1,1,2,-1
KR_6723634486,440,-6,-85,-33,-7,-1,7,6,-1,2,1,0,2,2,-1,3,2,-4,7,3,0,2,-9,-1,-6,7,-1,0,-2,-1,-1,-1,-1,1,-1
KR_6749481944,420,-2,13,-20,-4,-1,2,1,0,5,5,-3,4,1,0,2,2,0,2,2,-2,-9,3,-3,-3,6,2,0,0,1,-1,-1,-1,4,-1
KR_6642243270,420,-1,-11,20,-4,-1,1,0,-2,3,1,1,2,3,0,3,3,-2,2,0,0,-8,-4,-6,-2,8,2,0,0,-1,-1,0,1,5,-1
KR_6446742516,420,5,46,24,6,2,1,3,-1,4,3,0,2,2,1,0,1,4,0,4,0,6,6,1,-6,5,2,0,3,-1,1,1,-1,2,-1
KR_6602052142,420,0,-6,-44,2,-1,2,1,-2,9,7,1,1,2,3,1,4,1,0,1,0,9,-9,7,-11,4,-3,0,-1,-1,-1,1,-1,6,-1
KR_6641650996,420,-2,2,-17,3,-2,2,0,2,3,5,-1,3,2,3,5,8,1,1,2,2,1,185,-1,-5,6,-3,0,0,-1,1,0,1,1,-1
KR_6763449642,420,-2,-46,4,1,-2,4,2,1,3,4,4,1,5,-1,3,2,-1,1,0,-2,5,-4,1,-5,4,1,0,1,1,1,1,-1,5,-1
KR_6741107281,420,-1,15,6,-1,1,0,1,-5,5,0,1,2,3,1,4,5,1,1,2,-1,-3,-2,-4,-1,5,0,0,1,1,-1,-1,-1,4,-1
KR_6696293303,440,0,37,28,-2,2,2,4,-1,5,4,2,2,4,-7,9,2,2,0,2,3,-2,-7,-1,-4,5,-2,0,-1,-1,0,-1,1,3,-1
KR_6761983025,440,-1,8,-24,-5,-1,1,0,-2,3,1,-4,6,2,2,1,3,0,2,2,0,-4,-11,-3,-2,5,0,0,1,-1,-1,1,-1,4,-1
KR_6692605774,420,-1,8,-5,-6,-2,3,1,0,6,6,1,3,4,-4,5,1,-1,1,0,1,-6,-7,-2,-3,5,-2,0,-1,-1,1,-1,1,1,-1
KR_6756185574,420,0,29,-24,-6,-1,3,2,1,3,4,-1,2,1,-6,8,2,1,0,1,-1,-5,21,-5,-3,8,-24,0,-2,-1,-1,-1,1,5,-1
KR_6725661884,420,2,3,10,8,2,1,3,4,2,6,1,2,3,1,4,5,0,1,1,0,6,4,2,-8,6,1,0,1,1,-1,1,1,3,-1
KR_6717596709,420,-2,-16,10,-3,-2,4,2,-3,6,3,4,1,5,-4,6,2,2,2,4,0,0,-2,-1,-5,6,2,0,-1,-1,-1,-1,1,4,-1
KR_6713712250,440,-2,14,-13,-9,3,0,3,-4,6,2,-1,4,3,-6,7,1,-1,1,0,1,-24,-11,-8,-2,10,-2,0,1,-1,1,1,1,1,-1
KR_6531151632,420,1,0,-2,8,-3,4,1,5,3,8,3,3,6,2,1,3,1,0,1,0,12,110,0,-5,5,-4,0,-1,1,-1,-1,1,1,-1
KR_6642606743,420,3,32,20,5,0,2,2,3,3,6,0,1,1,2,1,3,0,0,0,0,7,275,-3,-2,5,-11,0,1,1,-1,1,-1,4,-1
KR_6759981717,420,1,-7,2,-2,-1,1,0,-1,5,4,-2,3,1,2,0,2,0,1,1,0,-7,25,0,-5,5,3,0,0,-1,0,0,1,1,-1
KR_6760163103,420,2,-21,8,2,-2,5,3,1,2,3,0,1,1,2,1,3,1,1,2,0,6,8,-5,-4,9,3,0,-2,-1,1,-1,-1,2,-1
KR_6751117970,440,-6,-166,-17,-9,-2,2,0,0,2,2,-11,11,0,5,2,7,-1,2,1,-2,-13,2,0,-2,2,-2,0,0,-1,1,-1,-1,6,-1
KR_6746364519,440,-3,-56,-12,-7,1,0,1,1,2,3,-2,6,4,-4,6,2,-3,4,1,0,-12,3,5,-8,3,-3,0,-1,-1,-1,-1,1,6,-1
KR_6764082902,420,-2,-20,20,-4,-3,6,3,5,1,6,-2,4,2,-6,7,1,2,0,2,1,-5,-4,2,-8,6,3,0,1,-1,1,-1,1,1,-1
KR_6726976500,420,-2,2,-17,-6,-4,5,1,0,4,4,3,2,5,-4,6,2,-1,1,0,0,-7,4,-1,-6,7,-1,0,-2,1,-1,-1,-1,4,-1
KR_6754763255,420,-4,-53,-4,-13,-4,4,0,4,1,5,-2,2,0,-4,4,0,-7,7,0,0,-5,-66,5,-6,1,-2,0,-1,-1,1,-1,-1,1,-1
KR_6676405251,420,-1,-55,-32,-8,-2,2,0,-7,7,0,1,3,4,-1,2,1,1,1,2,0,-10,127,-1,-6,7,-1,0,-1,-1,-1,-1,1,4,-1
KR_6720228523,420,0,-34,8,-13,-6,6,0,7,0,7,-8,11,3,-3,4,1,-3,4,1,-4,-10,-9,-7,-2,9,-4,0,-2,-1,-1,-1,-1,5,-1
KR_6735146127,420,1,70,11,-11,1,0,1,-5,5,0,0,0,0,-7,7,0,0,1,1,-1,-18,5,-5,-4,9,0,0,-1,-1,-1,-1,-1,2,-1
KR_6761704515,420,-3,-58,-5,-8,-6,6,0,-1,2,1,-2,4,2,2,3,5,-1,3,2,0,-5,36,-1,-3,4,-12,0,-1,1,-1,-1,-1,4,-1
KR_6762871728,420,-5,19,-46,-7,1,1,2,3,0,3,-5,6,1,0,3,3,-6,6,0,0,1,-5,-3,-5,8,-7,0,-2,-1,1,-1,1,6,-1
KR_6751360518,420,-1,-1,-20,0,1,0,1,-2,5,3,1,0,1,-1,2,1,1,0,1,0,-2,-9,-1,-4,5,1,0,0,-1,-1,0,1,4,-1
KR_6667331631,420,0,12,-12,-1,0,3,3,3,2,5,0,5,5,-1,4,3,-3,3,0,-1,-5,-9,-2,-2,4,0,0,1,-1,1,1,-1,3,-1
KR_6761330975,440,-4,-136,10,-11,0,2,2,-9,9,0,-1,1,0,0,5,5,-1,2,1,0,-12,47,3,-7,4,-8,0,-3,1,-1,-1,-1,1,-1
KR_6753117982,420,-2,-53,12,2,0,2,2,0,2,2,3,2,5,-1,3,2,0,1,1,0,0,6,-4,-1,5,22,0,0,-1,-1,-1,-1,3,-1
KR_6758673127,420,1,-21,37,3,1,2,3,3,0,3,2,0,2,-1,4,3,-2,2,0,0,5,39,4,-7,3,-18,0,-1,1,1,-1,1,3,-1
KR_6748206039,420,-2,-65,18,0,1,0,1,1,1,2,-1,4,3,-1,2,1,0,1,1,-2,3,436,-3,-3,6,0,0,0,-1,1,-1,-1,3,-1
KR_6685225661,420,0,-7,-5,4,-2,2,0,1,0,1,2,0,2,2,0,2,1,1,2,0,8,-41,4,-5,1,28,0,-2,-1,-1,-1,1,1,-1
KR_6722653876,420,1,47,0,-3,1,2,3,-2,3,1,0,1,1,-2,4,2,0,1,1,0,-1,2,2,-6,4,3,0,0,1,0,0,1,2,-1
KR_6644033177,420,-2,6,-10,-7,-6,8,2,-1,5,4,3,1,4,-3,4,1,0,0,0,0,-2,24,2,-8,6,-3,0,-1,-1,1,-1,-1,6,-1
KR_6761121117,420,-1,-57,32,1,-1,1,0,-4,5,1,3,4,7,1,2,3,2,0,2,1,-2,3,-3,-4,7,0,0,0,1,1,0,1,3,-1
KR_6755495484,420,0,26,7,-4,-1,5,4,1,2,3,-4,4,0,-1,5,4,1,0,1,0,-10,-3,0,-7,7,5,0,1,1,-1,1,1,4,-1
KR_6757307196,420,0,20,13,9,2,2,4,2,2,4,0,2,2,2,0,2,3,0,3,0,13,-21,8,-10,2,0,0,0,1,1,0,-1,4,-1
KR_6642148370,420,-6,-56,-18,-7,-2,3,1,-1,2,1,-2,4,2,0,2,2,-2,3,1,0,-2,1,0,-4,4,-1,0,-1,-1,-1,-1,-1,5,-1
KR_6641238365,420,-3,-25,21,-3,2,3,5,0,1,1,-4,4,0,0,2,2,-1,1,0,0,0,-4,-2,-3,5,-2,0,-1,1,1,-1,1,2,-1
KR_6740363418,420,0,-65,-7,-1,1,0,1,2,5,7,-1,4,3,-5,8,3,2,1,3,0,9,10,-4,-7,11,6,0,-1,-1,1,-1,-1,5,-1
KR_6743849486,420,-2,-30,24,3,0,0,0,2,3,5,-2,5,3,2,0,2,1,0,1,0,5,214,6,-10,4,-1,0,0,1,1,1,1,5,-1
KR_6734471337,420,-2,-18,20,-5,-1,4,3,0,0,0,0,4,4,0,2,2,-4,4,0,0,-6,-6,0,-4,4,1,0,-1,1,-1,-1,1,1,-1
KR_6725727906,420,-6,-57,-52,-15,0,0,0,-8,8,0,-4,5,1,1,0,1,-4,6,2,0,-12,-1,0,-5,5,0,0,-2,-1,-1,-1,-1,4,-1
KR_6749629895,420,-6,-33,-37,-10,-2,2,0,0,2,2,-1,3,2,-6,7,1,-1,1,0,0,-15,-5,-3,-3,6,-2,0,-3,-1,-1,-1,1,4,-1
KR_6761863887,420,2,30,-32,0,1,1,2,0,1,1,1,4,5,-1,3,2,-1,1,0,0,-4,-11,-3,-2,5,10,0,-1,0,-1,-1,-1,0,-1
KR_6762735986,420,4,70,42,2,0,4,4,-4,7,3,3,6,9,1,1,2,2,1,3,0,-3,-1,-4,-1,5,3,0,0,1,-1,1,1,5,-1
KR_6708488216,420,4,-15,16,2,1,3,4,3,3,6,3,0,3,-3,4,1,-2,3,1,0,-3,-4,4,-7,3,0,0,1,1,0,-1,-1,2,-1
KR_6638800178,420,2,-1,29,1,-2,4,2,0,3,3,-1,2,1,4,0,4,0,0,0,0,0,6,4,-9,5,-6,0,1,1,-1,-1,1,4,-1
KR_6752760739,420,0,-70,-11,-8,0,3,3,-15,17,2,5,2,7,2,1,3,0,0,0,0,-7,22,5,-5,0,-5,0,-1,0,-1,-1,-1,0,-1
KR_6759095334,420,0,9,27,-6,0,1,1,0,4,4,0,2,2,-5,7,2,-1,2,1,0,-9,-7,-3,-6,9,-1,0,-1,1,1,-1,-1,3,-1
KR_6748707573,420,-2,-34,23,-3,-1,1,0,0,4,4,-2,3,1,1,3,4,-1,1,0,-1,-2,-27,-1,-5,6,4,0,-1,1,0,-1,-1,2,-1
KR_6744761123,420,-2,1,-4,3,7,0,7,4,2,6,-3,3,0,-4,5,1,-1,1,0,0,4,21,0,-2,2,-1,0,1,-1,1,1,1,3,-1
KR_6719035188,420,-5,-33,-40,-7,-2,4,2,-3,5,2,-2,4,2,4,0,4,-4,4,0,0,-1,4,2,-4,2,-1,0,-1,1,-1,-1,-1,5,-1
KR_6713077992,420,3,-18,5,6,3,1,4,2,1,3,0,5,5,-1,4,3,2,0,2,0,9,39,-6,-6,12,-17,0,0,-1,1,1,-1,3,-1
KR_6749426007,420,-1,-34,-10,4,3,1,4,-2,5,3,0,1,1,3,1,4,0,1,1,1,0,-45,3,-8,5,17,0,-1,-1,1,-1,1,1,-1
KR_6754076161,420,-2,-47,-14,-7,-4,5,1,-2,3,1,1,3,4,-2,3,1,0,3,3,0,-6,-97,2,-7,5,-3,0,-1,-1,1,-1,-1,2,-1
KR_6692050301,420,3,38,36,4,1,0,1,2,1,3,1,0,1,-1,4,3,1,0,1,0,4,3,3,-7,4,4,0,0,1,-1,-1,1,6,-1
KR_6764443963,420,2,-23,-23,6,4,1,5,0,1,1,-1,2,1,2,0,2,1,1,2,0,8,9,4,-8,4,-7,0,0,0,-1,1,1,0,-1
KR_6675743433,420,0,9,-47,-1,-2,2,0,-2,2,0,0,2,2,3,0,3,0,0,0,0,6,15,2,-7,5,-3,0,-1,-1,-1,-1,-1,3,-1
KR_6763499926,420,2,25,11,0,-1,3,2,-2,3,1,-2,4,2,3,4,7,2,1,3,0,-5,125,0,-3,3,3,0,1,-1,1,1,-1,6,-1
KR_6690404035,420,-1,-55,-4,-4,1,0,1,-2,6,4,1,4,5,-4,6,2,0,0,0,1,0,-6,-4,-6,10,-1,0,0,1,0,0,1,4,-1
KR_6685608482,420,-2,-64,2,1,1,2,3,0,3,3,-3,3,0,3,5,8,0,1,1,1,3,4,0,-5,5,-6,0,-1,0,-1,1,1,0,-1
KR_6751036492,420,0,-7,2,-6,0,2,2,-2,4,2,2,1,3,-6,7,1,0,2,2,0,-4,-1,2,-8,6,0,0,0,-1,-1,0,-1,2,-1
KR_6732794584,440,1,-53,8,-1,-2,3,1,2,3,5,-1,2,1,0,1,1,0,1,1,0,10,45,1,-6,5,4,0,1,-1,1,1,1,1,-1
KR_6714424221,420,0,15,3,2,2,0,2,-2,5,3,-1,2,1,1,1,2,2,2,4,1,6,1,-2,-2,4,0,0,0,1,-1,0,1,2,-1
KR_6763601112,420,-1,-24,-42,2,-1,2,1,-3,4,1,1,0,1,5,2,7,0,0,0,0,4,7,6,-9,3,-3,0,0,-1,-1,0,1,1,-1
KR_6757333017,440,-1,68,8,-3,-3,3,0,0,2,2,-2,2,0,2,1,3,0,0,0,0,2,5,1,-5,4,0,0,1,-1,1,1,-1,6,-1
KR_6762401843,420,-2,-37,-12,-10,-6,6,0,0,1,1,-7,7,0,3,1,4,0,0,0,-2,-7,-15,-1,-6,7,-1,0,-2,-1,-1,-1,-1,1,-1
KR_6763162230,420,-4,15,-42,2,4,0,4,3,3,6,-2,2,0,-2,5,3,-1,2,1,0,2,4,1,-7,6,4,0,2,-1,-1,1,1,5,-1
KR_6758863143,420,-1,-37,20,1,-2,2,0,3,1,4,0,4,4,4,0,4,-4,4,0,0,-1,-9,1,-8,7,8,0,0,-1,1,0,-1,3,-1
KR_6760580417,420,-4,-72,-4,-6,-1,3,2,0,1,1,0,3,3,-3,3,0,-2,2,0,0,-2,-9,0,-7,7,2,0,-3,1,-1,-1,-1,3,-1
KR_6728560586,420,-1,48,8,0,1,3,4,-7,9,2,4,1,5,3,1,4,-1,2,1,0,-6,0,1,-2,1,0,0,0,1,0,0,-1,2,-1
KR_6760038800,420,4,91,-9,8,7,0,7,-2,5,3,3,1,4,-1,1,0,1,1,2,2,1,-14,2,-10,8,5,0,1,-1,-1,1,1,1,-1
KR_6751260574,440,3,-23,20,8,4,0,4,-1,2,1,0,3,3,5,0,5,0,1,1,0,5,-8,-2,-4,6,-2,0,1,1,-1,1,1,3,-1
KR_6748085120,420,-4,-95,16,-16,-3,5,2,-9,11,2,2,1,3,-3,4,1,-3,4,1,0,-19,-33,3,-9,6,3,0,-2,-1,-1,-1,1,2,-1
KR_6724499842,420,-3,-17,-31,-8,-5,5,0,-4,7,3,2,4,6,-1,3,2,0,0,0,0,-4,-20,0,-4,4,-2,0,0,1,-1,-1,1,3,-1
KR_6756639706,420,1,-60,-20,8,1,0,1,6,0,6,0,3,3,2,2,4,-1,2,1,0,15,29,1,-5,4,3,0,0,1,-1,-1,1,6,-1
KR_6760039759,420,-3,-42,8,5,-3,4,1,0,3,3,5,2,7,4,6,10,-1,2,1,0,15,-9,-3,-6,9,2,0,2,-1,1,1,-1,5,-1
KR_6756790124,420,-3,-80,-23,-9,-3,3,0,-3,4,1,1,4,5,-3,6,3,-1,4,3,1,-11,8,-5,-4,9,-1,0,-2,-1,1,-1,1,1,-1
KR_6691016615,420,-5,-20,8,-4,-4,4,0,-2,3,1,1,3,4,1,1,2,0,1,1,0,-3,-23,-6,-3,9,5,0,0,-1,1,0,1,3,-1
KR_6731507380,420,-7,-16,-30,-21,-9,9,0,-8,9,1,0,0,0,-2,3,1,-2,2,0,0,-17,-9,-4,-1,5,2,0,-2,-1,-1,-1,-1,1,-1
KR_6656677654,420,-1,-57,-8,-3,0,3,3,-2,5,3,-3,3,0,2,2,4,0,0,0,0,0,-13,-1,-7,8,-9,0,0,-1,-1,0,1,4,-1
KR_6674603993,420,-2,-17,-20,-4,-5,5,0,0,1,1,0,1,1,0,4,4,1,0,1,0,-1,-10,-2,-3,5,7,0,0,-1,-1,0,-1,2,-1
KR_6764192239,420,-1,-11,-10,5,1,1,2,2,1,3,4,2,6,-2,6,4,0,4,4,1,3,-6,-1,-4,5,-1,0,0,-1,-1,-1,1,1,-1
KR_6741578445,420,-2,-8,33,-10,-1,2,1,-3,5,2,-3,3,0,-3,5,2,0,0,0,-1,-23,46,-4,-5,9,-6,0,0,-1,1,1,-1,2,-1
KR_6746681085,440,-2,33,-20,1,-4,4,0,5,2,7,2,0,2,-4,7,3,2,1,3,0,-3,222,-6,-2,8,1,0,-1,-1,-1,-1,-1,5,-1
KR_6762330784,420,0,-11,11,7,1,1,2,3,1,4,-1,3,2,3,0,3,1,0,1,0,11,20,-1,-3,4,1,0,0,-1,1,0,1,1,-1
KR_6752916066,440,1,-85,-27,-4,1,2,3,0,3,3,1,1,2,-6,8,2,0,1,1,-1,-6,-5,-1,-2,3,-1,0,-1,0,0,-1,-1,0,-1
KR_6712674279,420,-2,-31,-11,-10,-2,3,1,-4,5,1,0,2,2,-4,4,0,0,1,1,0,-10,-6,4,-8,4,2,0,-1,-1,0,-1,-1,4,-1
KR_6691852610,420,0,7,16,-9,2,1,3,-4,6,2,-3,5,2,-3,6,3,-1,1,0,-1,-11,12,-3,-3,6,-3,0,-2,-1,-1,-1,-1,2,-1
KR_6681958373,420,-3,-49,29,-4,0,0,0,-3,5,2,-3,3,0,2,0,2,0,0,0,0,-2,-8,-2,-3,5,1,0,-1,-1,1,-1,-1,1,-1
KR_6733475072,420,-1,-43,4,-3,-1,4,3,-1,3,2,-2,3,1,-1,3,2,2,0,2,0,-5,-5,-2,-3,5,6,0,-1,1,-1,-1,1,1,-1
KR_6563595743,420,-1,11,-9,1,3,0,3,2,2,4,-2,3,1,1,3,4,-3,4,1,0,6,5,5,-9,4,-7,0,0,-1,-1,0,-1,3,-1
KR_6750813328,420,-2,21,-27,2,0,0,0,-1,3,2,-2,4,2,1,1,2,4,0,4,0,6,133,2,-5,3,-3,0,0,-1,1,0,1,1,-1
KR_6750777935,420,-3,-62,-10,-6,-5,7,2,-3,4,1,0,3,3,2,2,4,0,0,0,-1,-4,-43,-7,-2,9,2,0,-1,1,-1,-1,-1,4,-1
KR_6735205056,420,1,42,-13,-2,3,1,4,1,0,1,-3,4,1,-2,3,1,-1,3,2,0,-13,-8,-3,-2,5,8,0,0,-1,0,0,1,6,-1
KR_6644269245,420,1,15,8,5,1,1,2,-2,3,1,3,2,5,5,2,7,-2,2,0,0,-2,327,3,-5,2,3,0,1,1,-1,1,-1,3,-1
KR_6756740898,420,-2,-37,-4,-3,-4,5,1,-2,3,1,-1,4,3,2,3,5,2,1,3,0,5,123,8,-12,4,-2,0,-1,1,-1,-1,-1,3,-1
KR_6760712345,420,0,-43,8,-3,0,3,3,-1,3,2,0,1,1,0,2,2,-2,4,2,0,-10,21,-1,-5,6,-3,0,-1,-1,-1,-1,-1,5,-1
KR_6711964773,420,-2,-29,3,-8,0,1,1,2,2,4,-1,3,2,-8,9,1,-1,2,1,2,-8,-8,-11,-2,13,3,0,-1,-1,1,-1,1,6,-1
KR_6748712109,420,0,22,-12,-2,-2,2,0,0,3,3,2,1,3,-2,3,1,0,0,0,0,0,0,-1,-3,4,0,0,-1,-1,-1,-1,-1,4,-1
KR_6648347734,420,2,-32,48,-3,-3,3,0,-3,4,1,2,1,3,0,1,1,1,1,2,-1,-1,159,8,-12,4,-25,0,-1,1,1,-1,-1,4,-1
KR_6719859728,440,1,-17,1,6,-3,5,2,10,0,10,1,2,3,-6,9,3,4,0,4,2,8,-6,-9,-2,11,3,0,0,1,-1,-1,1,2,-1
KR_6703091060,420,-2,-11,4,-6,-2,2,0,0,5,5,-2,2,0,0,5,5,-2,2,0,0,-6,-26,-2,-6,8,1,0,0,1,-1,-1,-1,1,-1
KR_6758762194,420,-1,-50,-21,-10,3,0,3,-1,1,0,-3,3,0,-7,9,2,-2,3,1,0,-7,9,2,-6,4,-5,0,-1,-1,1,1,-1,2,-1
KR_6746726828,440,-3,-16,0,-10,0,3,3,-6,6,0,1,4,5,-2,5,3,-3,3,0,0,-11,-18,-2,-5,7,1,0,0,-1,0,0,-1,3,-1
KR_6651138702,420,-7,-106,-32,-10,-3,3,0,-2,5,3,3,1,4,-6,6,0,-2,2,0,0,-16,-18,-3,-2,5,-2,0,-3,-1,1,-1,1,1,-1
KR_6764864557,440,0,60,17,2,-1,3,2,2,0,2,-5,9,4,6,2,8,0,2,2,2,3,3,1,-5,4,3,0,1,1,-1,-1,1,2,-1
KR_6759565641,420,1,-76,-3,-5,-1,3,2,-3,6,3,0,1,1,0,4,4,-1,1,0,0,-12,147,-3,-2,5,2,0,-1,1,-1,-1,1,6,-1
KR_6743360561,420,-6,-22,-24,-12,2,0,2,-1,5,4,-3,3,0,-5,5,0,-5,5,0,0,-13,2,-2,-4,6,-3,0,2,-1,1,1,-1,3,-1
KR_6711319888,420,2,7,36,6,4,1,5,1,3,4,1,4,5,1,3,4,-1,2,1,0,0,10,5,-9,4,1,0,2,1,1,1,1,1,-1
KR_6669882943,440,-2,-33,39,3,2,1,3,-1,3,2,4,3,7,-3,4,1,1,0,1,0,-5,133,5,-7,2,-2,0,0,0,1,0,1,0,-1
KR_6760432646,420,-1,-17,-20,-2,-3,3,0,0,2,2,-3,4,1,2,2,4,2,1,3,0,2,5,-4,-3,7,2,0,0,1,-1,1,1,5,-1
KR_6756297998,420,0,22,-6,-3,-1,2,1,4,0,4,-3,4,1,-1,3,2,-2,3,1,-1,-7,-35,-3,-3,6,0,0,0,-1,1,0,-1,1,-1
KR_6741994733,420,-2,-25,-11,-7,-3,4,1,-2,5,3,-3,3,0,3,1,4,-2,2,0,0,-4,6,6,-8,2,-1,0,-1,1,0,-1,-1,1,-1
KR_6761711082,440,0,-9,44,0,-3,4,1,-3,3,0,3,1,4,0,4,4,3,0,3,0,2,8,1,-8,7,-2,0,0,-1,1,-1,-1,1,-1
KR_6719967095,420,-1,-29,-20,3,4,1,5,5,1,6,-1,1,0,-6,7,1,1,1,2,0,-3,0,-1,-4,5,-3,0,1,-1,1,1,1,3,-1
KR_6648252736,420,-3,-59,-7,-14,-7,9,2,-3,4,1,-3,6,3,0,3,3,-1,2,1,0,-6,-1,-2,-4,6,-2,0,-1,-1,-1,-1,1,3,-1
KR_6730581947,420,0,-7,-10,-7,0,1,1,-3,8,5,-1,4,3,-4,6,2,1,0,1,0,-5,4,2,-7,5,-4,0,0,1,-1,0,-1,6,-1
KR_6508450151,420,2,-26,28,-3,0,2,2,1,7,8,0,2,2,-5,6,1,1,1,2,0,-1,7,6,-8,2,-3,0,0,1,-1,1,1,5,-1
KR_6761936477,420,-3,-46,-8,-6,1,2,3,-1,1,0,-7,7,0,0,2,2,1,1,2,0,-3,0,-2,-4,6,-4,0,-2,1,-1,-1,-1,2,-1
KR_6753082510,440,2,44,5,3,1,1,2,3,1,4,-2,4,2,0,1,1,1,0,1,0,7,4,-2,-5,7,-1,0,2,1,1,1,-1,1,-1
KR_6706648611,420,0,-26,-14,1,0,3,3,4,2,6,-3,5,2,-1,9,8,1,0,1,-1,1,-9,-4,-2,6,7,0,-1,0,-1,-1,1,0,-1
KR_6764208023,420,-1,46,4,-3,-1,4,3,0,2,2,0,1,1,-2,3,1,0,0,0,0,-2,0,-2,-4,6,6,0,1,1,1,1,1,6,-1
KR_6715476606,420,-3,-42,-22,2,-2,3,1,4,3,7,-3,3,0,4,0,4,-1,3,2,0,7,28,2,-5,3,-6,0,0,1,1,0,-1,1,-1
KR_6730355435,420,3,14,27,2,3,0,3,-4,5,1,0,0,0,4,2,6,-1,1,0,0,-3,0,-3,-4,7,-3,0,0,-1,-1,0,1,3,-1
KR_6747676644,420,-2,-54,-16,-5,2,1,3,-4,5,1,2,2,4,-4,7,3,-1,2,1,0,-5,-10,-2,-5,7,5,0,0,-1,1,0,-1,3,-1
KR_6761376193,440,-5,19,-28,-16,-4,5,1,-2,2,0,-1,4,3,-4,4,0,-5,5,0,2,-11,-1,-1,-5,6,-3,0,-1,-1,-1,-1,1,2,-1
KR_6710067779,420,-1,22,-68,3,-1,2,1,0,4,4,0,3,3,3,2,5,1,0,1,0,3,8,6,-10,4,3,0,-2,-1,-1,-1,1,5,-1
KR_6696939297,420,-5,-117,4,-9,-4,5,1,-1,2,1,-2,2,0,-3,6,3,1,2,3,0,-1,51,-1,-4,5,-3,0,-1,-1,-1,-1,-1,5,-1
KR_6749316544,420,2,52,12,3,1,2,3,4,0,4,3,0,3,-9,10,1,4,2,6,1,-7,14,0,-6,6,3,0,1,0,1,1,1,0,-1
KR_6755520357,420,-3,-61,-21,-12,-4,5,1,-1,3,2,-1,2,1,-7,10,3,1,1,2,0,-14,-4,-6,-2,8,0,0,-1,-1,-1,-1,-1,3,-1
KR_6756532455,420,-2,-54,-20,-5,-2,2,0,0,4,4,1,1,2,-4,6,2,0,0,0,-1,-5,3,2,-4,2,0,0,0,-1,-1,-1,-1,2,-1
KR_6755073329,420,-2,1,-36,-1,2,0,2,2,4,6,0,2,2,-1,6,5,-4,4,0,0,-7,7,3,-7,4,-1,0,0,1,1,0,1,5,-1
KR_6742027936,440,3,73,8,4,2,2,4,1,0,1,2,2,4,3,3,6,-4,7,3,0,13,3,0,-3,3,1,0,1,1,1,1,1,5,-1
KR_6760721515,420,1,82,15,-5,-4,5,1,-2,3,1,1,4,5,3,0,3,-3,4,1,0,-11,10,-5,-4,9,-1,0,1,-1,1,1,-1,2,-1
KR_6624495500,420,0,22,-4,0,-1,2,1,3,3,6,-2,2,0,2,2,4,-2,2,0,0,3,-7,-5,-2,7,5,0,0,1,-1,1,1,4,-1
KR_6726167887,420,-2,-71,-36,-3,-4,4,0,-1,4,3,-1,3,2,4,2,6,-1,1,0,0,0,-5,5,-9,4,0,0,0,1,-1,-1,-1,1,-1
KR_6762038290,420,-2,39,32,-9,-8,8,0,1,2,3,1,1,2,-3,5,2,0,2,2,0,-5,2,-1,-6,7,-1,0,-1,-1,-1,-1,1,5,-1
KR_6764490831,420,0,58,7,0,1,0,1,1,1,2,3,1,4,-5,6,1,0,1,1,0,-8,-42,3,-10,7,4,0,0,1,1,0,1,5,-1
KR_6762042254,420,-1,4,-10,-1,2,2,4,-3,6,3,-2,2,0,1,3,4,1,1,2,3,-6,-176,-1,-4,5,-7,0,0,1,-1,0,1,2,-1
KR_6731504457,420,0,-28,-3,1,-4,4,0,6,2,8,4,1,5,-5,5,0,0,0,0,0,0,0,3,-4,1,-3,0,-1,1,0,-1,1,1,-1
KR_6750437506,420,-5,-49,3,-8,0,2,2,-1,2,1,-3,3,0,-3,7,4,-1,3,2,0,0,-6,-1,-7,8,0,0,-1,-1,1,-1,-1,5,-1
KR_6757151589,420,-7,-67,-8,-15,-4,4,0,-1,2,1,-6,7,1,-2,5,3,-2,2,0,0,-15,18,-1,-5,6,1,0,-3,-1,-1,-1,-1,5,-1
KR_6765002345,420,0,33,-38,0,-1,1,0,2,1,3,-1,1,0,-1,1,0,1,0,1,0,0,16,-3,-2,5,4,0,-1,0,-1,-1,-1,0,-1
KR_6712506749,420,1,19,-23,4,3,3,6,0,1,1,0,3,3,1,0,1,0,0,0,0,-5,-11,-4,-3,7,-1,0,0,-1,-1,-1,-1,5,-1
KR_6641847146,420,1,81,-10,-4,-2,3,1,0,3,3,1,2,3,-2,2,0,-1,1,0,0,-2,-121,1,-10,9,0,0,0,-1,-1,0,-1,2,-1
KR_6760867255,420,-3,8,-49,-5,3,0,3,-2,4,2,1,2,3,-5,8,3,-2,2,0,0,-4,6,0,-5,5,-11,0,-1,-1,-1,-1,-1,5,-1
KR_6709269550,420,0,-11,4,-5,-2,2,0,0,2,2,-2,2,0,1,4,5,-2,2,0,0,-6,-212,-4,-4,8,0,0,0,-1,1,-1,1,6,-1
KR_6683067675,420,2,-7,18,6,5,1,6,1,7,8,-1,1,0,-3,3,0,4,0,4,1,-4,50,1,-5,4,-16,0,-1,1,-1,-1,1,1,-1
KR_6761513019,440,-3,30,-12,-3,-3,4,1,-4,5,1,0,1,1,3,2,5,1,0,1,0,1,-44,2,-7,5,3,0,1,-1,1,1,-1,2,-1
KR_6659322342,420,-1,-2,-27,-1,2,0,2,2,2,4,-4,6,2,0,4,4,-1,1,0,0,-11,48,2,-6,4,-20,0,0,-1,1,1,1,4,-1
KR_6756733532,420,-2,-33,-50,-5,-3,3,0,-2,6,4,-1,3,2,1,0,1,0,0,0,1,1,-1,-4,-5,9,0,0,-1,-1,-1,-1,1,2,-1
KR_6665445886,420,-2,-53,26,1,-2,4,2,-1,1,0,3,0,3,0,2,2,1,0,1,0,-4,-173,4,-7,3,3,0,-1,1,-1,-1,-1,3,-1
KR_6754994835,420,-1,-13,-28,-6,2,1,3,-4,4,0,-3,4,1,-1,2,1,0,0,0,0,-6,-15,-1,-4,5,-1,0,-2,-1,-1,-1,1,6,-1
KR_6715914425,420,5,49,-6,7,-1,2,1,4,1,5,5,2,7,0,2,2,-1,1,0,0,8,0,2,-6,4,2,0,1,1,1,1,1,5,-1
KR_6754776813,420,-2,-13,4,-6,-4,4,0,-1,3,2,2,1,3,0,2,2,-3,3,0,0,0,2,-1,-7,8,-1,0,-1,-1,1,-1,-1,6,-1
KR_6764722688,420,-3,-41,-26,2,1,3,4,3,2,5,-3,3,0,0,3,3,1,0,1,0,6,-29,4,-9,5,1,0,-1,-1,1,1,-1,4,-1
KR_6663778158,420,0,-36,7,4,0,3,3,-3,3,0,2,1,3,2,5,7,3,0,3,0,2,18,3,-9,6,-5,0,0,1,-1,-1,1,6,-1
KR_6761083086,440,-5,-49,16,-14,-2,5,3,-1,2,1,0,1,1,-9,9,0,-2,2,0,-1,-20,1,-1,-4,5,-4,0,-1,-1,0,-1,-1,4,-1
KR_6764711783,420,-3,-37,-24,-5,-6,6,0,-2,5,3,-2,3,1,6,2,8,-1,1,0,0,7,0,1,-7,6,5,0,1,-1,-1,1,1,1,-1
KR_6739016198,420,0,17,24,0,-3,5,2,0,3,3,-1,3,2,3,3,6,1,0,1,0,3,-2,0,-6,6,1,0,0,1,1,0,1,4,-1
KR_6764418199,420,-3,-29,17,-3,0,0,0,-1,3,2,0,1,1,-2,4,2,0,0,0,0,-4,-2,-5,-5,10,0,0,0,0,-1,0,-1,0,-1
KR_6759037534,420,-3,38,-11,3,1,2,3,-3,4,1,0,2,2,5,2,7,0,0,0,0,5,-10,2,-6,4,4,0,-1,1,-1,-1,1,3,-1
KR_6703192897,420,-4,-34,5,-9,-1,3,2,0,2,2,-5,6,1,-2,3,1,-1,2,1,0,-8,-3,-3,-2,5,-2,0,-1,-1,-1,-1,-1,4,-1
KR_6744635543,420,0,-36,20,-6,0,0,0,0,6,6,-1,1,0,-6,7,1,1,0,1,-1,-11,11,3,-7,4,-6,0,-1,-1,1,-1,-1,6,-1
KR_6757960904,420,-6,-66,-32,-13,-5,5,0,-2,2,0,-9,11,2,0,5,5,3,0,3,-2,-8,5,-2,-4,6,0,0,-2,-1,-1,-1,-1,5,-1
KR_6562536669,420,-1,11,-24,3,0,3,3,5,1,6,1,3,4,-1,3,2,-2,2,0,1,3,23,-4,-2,6,1,0,1,-1,1,1,1,4,-1
KR_6710248691,420,-1,36,27,-4,3,1,4,-2,5,3,-3,5,2,-1,1,0,-1,1,0,0,-2,-2,1,-6,5,1,0,1,1,-1,1,-1,6,-1
KR_6714099785,440,-4,-53,-20,-13,-5,5,0,2,2,4,2,1,3,-7,7,0,-5,6,1,0,-6,95,-1,-8,9,-4,0,-1,-1,0,-1,-1,3,-1
KR_6732513227,420,-2,-35,28,-5,-5,6,1,2,1,3,-1,3,2,-1,2,1,0,0,0,0,1,-1,2,-5,3,-1,0,1,1,1,1,1,5,-1
KR_6755126859,420,0,-6,8,-3,1,1,2,-2,4,2,1,3,4,0,1,1,-3,3,0,1,-12,-7,2,-5,3,6,0,-1,-1,-1,-1,1,6,-1
KR_6681507008,420,-4,-105,-5,-10,-2,3,1,-4,5,1,1,3,4,-3,3,0,-2,3,1,0,-8,-3,1,-8,7,4,0,-2,-1,-1,-1,-1,1,-1
KR_6749236300,420,0,-45,4,-5,4,0,4,-1,4,3,-1,2,1,-4,4,0,-3,3,0,0,-8,26,4,-7,3,-1,0,-2,1,1,-1,-1,2,-1
KR_6697938856,420,-3,-59,1,-7,2,3,5,-3,8,5,1,3,4,-5,8,3,-2,2,0,-2,-11,-4,-2,-5,7,-2,0,-1,-1,-1,-1,-1,2,-1
KR_6758662588,420,-10,-36,-32,-14,-1,2,1,-5,5,0,-2,2,0,-3,4,1,-3,4,1,0,-10,-2,0,-3,3,-4,0,-2,-1,-1,-1,1,3,-1
KR_6390928905,420,-9,-110,-4,-31,-6,6,0,-6,9,3,-4,6,2,-13,13,0,-2,3,1,-3,-30,-135,-5,-4,9,2,0,-3,-1,-1,-1,1,3,-1
KR_6675017644,420,0,-25,8,-3,-2,2,0,0,1,1,2,2,4,1,2,3,-4,5,1,0,1,22,0,-6,6,-1,0,0,-1,1,0,-1,4,-1
KR_6738267317,440,-5,-56,-28,-12,3,1,4,1,2,3,-3,4,1,-1,2,1,-12,13,1,0,-13,164,-7,-2,9,-1,0,-1,-1,1,-1,-1,4,-1
KR_6755183259,420,0,-20,0,0,0,2,2,-3,3,0,1,2,3,3,6,9,-1,2,1,1,10,-11,-5,-1,6,4,0,-1,1,-1,-1,1,2,-1
KR_6761489402,440,1,28,15,-2,0,0,0,1,0,1,1,2,3,-2,3,1,-2,2,0,0,-6,-2,-8,-2,10,3,0,2,1,1,1,1,4,-1
KR_6740393165,420,0,-50,8,-4,-2,4,2,6,0,6,-4,6,2,-6,13,7,2,0,2,-2,4,18,2,-7,5,-1,0,-2,-1,1,-1,1,4,-1
KR_6751533463,420,-5,-99,-9,-8,-1,3,2,1,2,3,-3,5,2,-5,6,1,0,1,1,0,-19,-1,-4,-3,7,0,0,-2,1,-1,-1,-1,2,-1
KR_6751110414,420,-1,13,-18,-1,-1,7,6,2,2,4,-2,3,1,2,3,5,-2,3,1,0,6,1,1,-5,4,2,0,1,-1,1,1,1,5,-1
KR_6752227717,420,1,-50,-24,-6,-1,2,1,0,3,3,-4,6,2,0,2,2,-1,1,0,0,-7,-13,2,-9,7,-5,0,-1,-1,-1,-1,-1,1,-1
KR_6711694974,420,-1,-4,-4,0,4,4,8,0,5,5,-1,2,1,-3,3,0,0,0,0,0,-2,29,2,-7,5,-2,0,0,-1,1,1,-1,5,-1
KR_6755373824,440,-3,-93,8,-4,2,0,2,-2,4,2,-2,3,1,1,1,2,-3,5,2,0,-5,2,-4,-3,7,-1,0,1,0,1,1,1,0,-1
KR_6736059605,420,-1,-32,7,-3,-2,4,2,-1,4,3,1,4,5,0,1,1,-1,1,0,0,-7,-4,4,-8,4,-2,0,-2,-1,0,-1,-1,1,-1
KR_6708420522,420,1,16,6,2,-1,3,2,-1,3,2,-1,3,2,2,0,2,3,1,4,0,5,0,3,-7,4,1,0,0,1,-1,0,1,4,-1
KR_6762457495,440,-1,-45,-20,-11,-6,6,0,-3,4,1,-3,6,3,-1,2,1,2,0,2,-1,-6,-1,-1,-3,4,-1,0,-1,-1,-1,-1,-1,2,-1
KR_6752371586,420,-2,-49,-12,0,2,0,2,-2,3,1,2,3,5,-2,3,1,0,0,0,0,-2,-4,1,-5,4,7,0,-1,-1,1,-1,1,3,-1
KR_6584721589,420,-2,-46,-24,2,-2,3,1,-1,4,3,0,3,3,3,2,5,2,2,4,0,2,-36,-1,-6,7,0,0,-2,1,-1,-1,-1,3,-1
KR_6764893401,420,-4,-87,-20,-10,-1,2,1,3,1,4,0,3,3,-16,17,1,4,1,5,-1,-11,2,-2,-6,8,-3,0,-1,1,-1,-1,-1,1,-1
KR_6746895541,420,-3,21,-28,-1,0,2,2,-2,3,1,-1,2,1,2,1,3,0,0,0,0,-5,-8,-1,-5,6,2,0,-1,-1,-1,-1,-1,2,-1
KR_6757302790,420,-2,-2,-11,1,5,0,5,-3,6,3,2,3,5,-3,4,1,0,1,1,0,0,-1,1,-7,6,0,0,0,-1,0,0,1,1,-1
KR_6732566251,440,-3,-47,-17,-7,-2,4,2,-2,5,3,-2,2,0,-3,3,0,2,0,2,0,3,-25,6,-12,6,-3,0,0,0,-1,-1,-1,0,-1
KR_6707959012,420,-7,-72,-39,-17,-2,3,1,-7,8,1,0,1,1,-6,7,1,-2,2,0,0,-15,31,0,-6,6,-17,0,-3,-1,-1,-1,-1,4,-1
KR_6761606016,420,-2,27,-15,-7,3,4,7,-1,5,4,-3,3,0,0,3,3,-6,6,0,0,-12,3,-3,0,3,-2,0,-3,-1,1,-1,1,5,-1
KR_6638360532,420,-3,-60,-60,-2,0,5,5,0,6,6,0,5,5,0,6,6,-2,3,1,-1,-2,11,7,-12,5,-9,0,-2,1,-1,-1,1,6,-1
KR_6763759651,420,-1,-20,6,-6,0,2,2,0,3,3,-1,4,3,-4,4,0,-1,2,1,0,-4,-1,1,-4,3,-4,0,-1,1,-1,-1,-1,4,-1
KR_6627309157,420,-2,38,-16,-3,-2,2,0,-1,3,2,-2,2,0,-1,2,1,3,2,5,0,-7,-4,-1,-8,9,-2,0,0,1,1,0,1,1,-1
KR_6687923973,420,0,59,24,-8,0,0,0,0,1,1,1,1,2,-9,10,1,0,2,2,0,-14,-1,-1,-3,4,0,0,-1,1,-1,-1,-1,6,-1
KR_6760069658,420,-4,-95,-31,-5,0,2,2,-3,3,0,-1,2,1,-3,3,0,2,0,2,0,-10,-11,-5,-3,8,-4,0,-2,0,1,-1,-1,0,-1
KR_6761186569,420,3,97,-5,6,4,0,4,-1,3,2,-1,3,2,3,3,6,1,0,1,0,4,10,1,-6,5,2,0,1,-1,-1,1,1,6,-1
KR_6704387041,420,-2,-4,-9,-2,-8,9,1,0,2,2,3,2,5,3,1,4,0,2,2,0,-2,-8,4,-5,1,-2,0,-1,1,-1,-1,1,2,-1
KR_6706403912,440,1,23,3,-3,2,1,3,0,2,2,-8,8,0,-1,1,0,4,2,6,0,5,-7,-3,-3,6,2,0,2,-1,-1,1,-1,2,-1
KR_6737485315,420,-2,71,-12,-6,1,2,3,0,1,1,-3,3,0,-4,4,0,0,0,0,0,-9,0,0,-5,5,-1,0,0,-1,-1,1,1,4,-1
KR_6695476627,420,-4,-94,0,-10,-1,2,1,0,4,4,-4,4,0,-4,5,1,-1,1,0,0,-6,-8,-5,-2,7,3,0,-2,-1,-1,-1,-1,3,-1
KR_6623301112,420,1,-8,16,0,-2,4,2,3,1,4,-2,4,2,7,2,9,-6,6,0,0,-5,269,-4,-8,12,-8,0,-1,1,-1,-1,-1,2,-1
KR_6691613411,420,-5,-2,-2,-12,-1,3,2,-1,2,1,-5,6,1,-2,3,1,-3,3,0,0,-9,-5,-1,-6,7,-2,0,-1,-1,-1,-1,1,4,-1
KR_6390836260,420,-4,-86,-25,-2,-1,4,3,-1,3,2,-1,3,2,0,2,2,1,0,1,0,-3,-1,-2,-4,6,2,0,-2,-1,-1,-1,-1,1,-1
KR_6724195773,440,1,-37,6,-5,-2,4,2,2,0,2,-1,1,0,-6,8,2,2,1,3,0,-8,-36,0,-7,7,1,0,0,-1,1,0,1,2,-1
KR_6747082970,420,1,28,15,-1,-3,4,1,-1,3,2,5,2,7,-4,4,0,2,0,2,-1,-1,-1,4,-8,4,-1,0,0,1,-1,0,-1,1,-1
KR_6648720609,420,-1,-31,17,-3,3,2,5,-7,9,2,0,3,3,0,3,3,1,1,2,1,-4,-30,1,-5,4,2,0,1,0,1,1,1,0,-1
KR_6611101691,420,-2,-10,-31,-4,-8,8,0,-2,3,1,1,1,2,3,0,3,2,0,2,0,2,-106,-3,-6,9,2,0,-1,-1,-1,-1,1,4,-1
KR_6764160304,420,-2,-10,13,-9,-2,4,2,-2,2,0,-3,4,1,1,0,1,-3,5,2,-1,-13,-2,-1,-4,5,-1,0,-1,-1,0,-1,-1,4,-1
KR_6759006384,420,-4,-55,-41,-6,-5,6,1,0,4,4,0,2,2,-1,6,5,0,0,0,-3,-4,-8,-4,-4,8,3,0,-1,1,-1,-1,-1,6,-1
KR_6762579265,440,-2,-1,-30,-9,-9,9,0,1,1,2,4,2,6,1,1,2,-6,6,0,0,-5,-58,-1,-2,3,5,0,0,-1,0,-1,1,4,-1
KR_6608418945,420,-5,-74,-27,-5,2,0,2,-2,3,1,-1,3,2,-3,4,1,-1,2,1,0,0,10,9,-11,2,-2,0,0,-1,1,0,-1,5,-1
KR_6629611835,420,-4,-16,-43,-10,4,2,6,-6,6,0,1,1,2,-8,8,0,-1,1,0,-2,-12,-4,2,-5,3,3,0,-1,-1,1,-1,-1,5,-1
KR_6751463833,420,-1,15,20,-2,0,1,1,-2,3,1,1,1,2,-1,4,3,0,0,0,0,-2,-4,0,-5,5,-3,0,0,-1,1,0,1,2,-1
KR_6688183233,420,-4,-57,8,0,0,1,1,-3,3,0,3,1,4,-1,2,1,1,2,3,1,-2,-26,-3,-4,7,0,0,1,1,-1,1,1,2,-1
KR_6647644722,420,-1,-52,-20,-4,-3,4,1,0,0,0,-3,4,1,3,1,4,-1,1,0,0,0,-27,-2,-5,7,1,0,-1,-1,1,-1,-1,5,-1
KR_6762602982,420,1,-9,-16,0,-5,6,1,2,1,3,-2,2,0,5,1,6,0,0,0,0,3,5,4,-7,3,-11,0,-1,-1,-1,-1,-1,3,-1
KR_6734168974,420,-1,-99,23,2,-1,3,2,5,1,6,-4,5,1,0,4,4,2,0,2,0,2,11,1,-6,5,-5,0,0,-1,1,1,1,3,-1
KR_6746745445,420,-1,14,-20,-5,-2,4,2,-1,3,2,-2,6,4,3,4,7,-3,3,0,0,-5,43,4,-9,5,-20,0,-1,1,-1,-1,-1,6,-1
KR_6761280766,420,-5,-51,0,-8,-1,1,0,-4,5,1,-2,3,1,-1,1,0,0,1,1,0,-7,14,1,-4,3,5,0,-1,-1,-1,-1,-1,4,-1
KR_6675014238,420,0,-55,-10,1,0,0,0,-1,3,2,6,2,8,-3,5,2,-1,3,2,0,3,-42,-3,-3,6,27,0,-1,1,-1,-1,1,2,-1
KR_6399648442,420,-1,-18,17,-6,-1,1,0,0,3,3,0,2,2,-1,6,5,-4,4,0,0,-9,4,1,-9,8,-4,0,-1,1,-1,-1,-1,3,-1
KR_6762495049,440,-2,-45,-7,-3,2,1,3,-6,6,0,1,1,2,0,3,3,0,2,2,0,-7,-6,1,-3,2,0,0,1,-1,1,1,-1,5,-1
KR_6763026970,420,-4,-46,-20,-8,-2,3,1,-3,4,1,0,2,2,-3,3,0,0,1,1,0,-2,-11,0,-5,5,-4,0,-3,0,-1,-1,-1,0,-1
KR_6734449615,440,3,-22,12,3,3,1,4,0,1,1,2,2,4,-1,3,2,-1,2,1,0,0,-4,-4,-2,6,-4,0,0,-1,-1,0,-1,1,-1
KR_6740049956,420,-5,-51,-3,-8,2,2,4,-2,2,0,-2,3,1,-6,6,0,0,0,0,0,-10,-10,1,-4,3,-1,0,1,0,1,-1,1,0,-1
KR_6721280434,420,1,-63,-4,5,-1,2,1,9,3,12,-1,2,1,-3,5,2,1,1,2,-1,5,21,2,-6,4,-3,0,0,0,-1,0,-1,0,-1
KR_6728931278,420,-3,-24,4,-7,0,0,0,-5,6,1,0,2,2,-1,4,3,-1,1,0,0,-9,4,-1,-3,4,-1,0,-1,-1,1,-1,-1,3,-1
KR_6719835083,440,-3,15,9,-10,0,1,1,-4,8,4,-1,2,1,-4,4,0,-1,1,0,-2,-15,1,5,-9,4,-7,0,-2,-1,-1,-1,-1,6,-1
KR_6751569403,420,-3,-49,4,-10,-1,2,1,0,1,1,-1,2,1,-7,9,2,-1,2,1,0,-8,1,2,-5,3,-3,0,-2,-1,-1,-1,-1,3,-1
KR_6762833332,420,-1,-49,16,-6,-1,2,1,-1,5,4,-2,3,1,-1,2,1,-1,1,0,-1,-8,-22,0,-8,8,1,0,-1,1,-1,-1,-1,2,-1
KR_6763215626,420,-1,-6,-3,-1,-2,2,0,1,1,2,-1,1,0,2,5,7,-1,2,1,0,1,-129,-4,-3,7,8,0,0,1,-1,-1,1,2,-1
KR_6702826558,420,0,-46,32,-2,-2,3,1,3,1,4,1,1,2,-4,5,1,0,0,0,0,4,9,0,-9,9,-5,0,0,-1,-1,0,1,2,-1
KR_6736298953,420,1,-32,42,4,-4,5,1,4,4,8,-1,4,3,6,3,9,-1,2,1,-1,12,6,-1,-5,6,3,0,0,1,-1,0,-1,3,-1
KR_6706416950,420,0,0,-1,-1,-1,3,2,2,3,5,1,2,3,-4,6,2,1,3,4,0,-4,50,-5,-3,8,1,0,0,-1,1,0,-1,1,-1
KR_6381900269,420,-2,-54,-24,-7,0,2,2,2,5,7,1,3,4,-10,10,0,0,1,1,-2,-9,-3,-2,-7,9,-3,0,-1,-1,-1,-1,1,3,-1
KR_6733908209,420,1,-20,20,-4,-2,2,0,3,3,6,-1,3,2,-3,4,1,-1,1,0,-1,-9,3,0,-4,4,-3,0,0,0,1,0,-1,0,-1
KR_6759560645,420,-1,-27,4,-2,-2,3,1,2,1,3,0,2,2,-1,5,4,-1,1,0,0,7,2,7,-11,4,-4,0,-1,-1,1,-1,-1,4,-1
KR_6742375167,420,-3,-45,-17,-4,-3,4,1,-1,3,2,1,2,3,-1,4,3,0,0,0,0,1,-2,2,-7,5,1,0,-2,-1,-1,-1,1,3,-1
KR_6751042486,420,-1,34,-33,-3,2,0,2,-7,7,0,2,2,4,2,4,6,-2,2,0,-1,-13,-17,2,-6,4,-6,0,1,-1,1,1,-1,5,-1
KR_6761308825,440,-2,50,1,-2,-2,4,2,1,2,3,1,0,1,-2,6,4,0,3,3,0,1,1,5,-7,2,2,0,0,1,-1,-1,-1,1,-1
KR_6611759625,420,0,26,0,2,2,1,3,1,2,3,-2,4,2,-3,6,3,4,0,4,0,3,6,-1,-6,7,-5,0,0,-1,-1,0,1,5,-1
KR_6623434796,420,-1,37,11,7,-2,2,0,7,2,9,0,0,0,2,3,5,0,0,0,0,13,-2,5,-9,4,0,0,-1,1,-1,-1,1,5,-1
KR_6746915523,420,-1,33,-2,-5,-6,7,1,2,0,2,-3,3,0,0,2,2,2,1,3,0,-9,3,1,-7,6,-3,0,-1,-1,-1,-1,1,1,-1
KR_6703759091,420,-1,2,8,-1,3,0,3,-3,3,0,1,3,4,-2,2,0,0,0,0,0,-5,4,6,-9,3,-7,0,-1,-1,0,-1,1,4,-1
KR_6650525558,420,-2,-68,12,-5,-2,4,2,0,1,1,0,3,3,0,3,3,-3,3,0,0,-3,-1,-1,-6,7,-4,0,-2,1,-1,-1,-1,5,-1
KR_6689160991,420,2,3,12,8,2,0,2,3,2,5,3,1,4,-1,3,2,1,0,1,1,4,-1,2,-6,4,-2,0,1,0,0,1,1,0,-1
KR_6674796293,420,-4,-59,-17,-12,1,0,1,-6,8,2,-7,8,1,0,4,4,0,0,0,0,-5,0,0,-6,6,-7,0,-1,-1,-1,-1,-1,6,-1
KR_6728232628,420,-8,-81,-36,-16,-4,4,0,-7,8,1,-4,4,0,1,3,4,-2,2,0,0,-6,-110,0,-6,6,-3,0,-2,-1,-1,-1,-1,2,-1
KR_6751478123,440,-1,-51,-14,6,4,0,4,-1,1,0,1,0,1,-2,2,0,4,1,5,0,4,-1,0,-4,4,1,0,0,1,-1,0,1,3,-1
KR_6703632715,420,0,14,2,-3,1,1,2,0,2,2,-7,9,2,1,3,4,2,0,2,1,9,-3,1,-6,5,2,0,-1,-1,0,-1,1,3,-1
KR_6727767763,420,1,56,36,-4,2,1,3,-5,6,1,0,1,1,4,1,5,-5,6,1,1,-9,-10,-3,-5,8,1,0,0,1,0,0,1,5,-1
KR_6567271302,440,-4,-95,-21,-12,1,1,2,-2,3,1,-4,8,4,-3,7,4,-4,4,0,0,-8,-2,-4,-1,5,0,0,0,-1,-1,-1,-1,4,-1
KR_6721762596,420,-4,-26,4,-10,0,2,2,3,3,6,-6,7,1,-6,8,2,-1,1,0,0,-19,-8,-5,-5,10,-6,0,0,1,-1,0,-1,2,-1
KR_6416962019,420,-2,-35,0,-5,-1,2,1,3,3,6,-5,5,0,-4,5,1,2,0,2,0,-6,-4,-2,-10,12,1,0,1,0,1,-1,-1,0,-1
KR_6752184121,420,-3,-74,18,-10,-3,3,0,-1,3,2,-3,3,0,-1,1,0,-2,2,0,0,-12,3,3,-6,3,-4,0,-1,1,-1,-1,-1,3,-1
KR_6714850276,440,-2,39,-16,-7,-1,2,1,-6,6,0,0,2,2,4,2,6,-4,4,0,0,-7,-1,-2,-4,6,2,0,-1,-1,-1,-1,1,1,-1
KR_6763598306,420,-1,-34,4,-4,-2,2,0,0,1,1,-2,3,1,-2,2,0,2,0,2,0,-1,-7,-1,-5,6,-2,0,-1,-1,-1,-1,-1,1,-1
KR_6727877909,420,-3,-48,0,-4,3,0,3,-2,8,6,-1,3,2,-3,5,2,-1,1,0,-2,-18,-11,-2,-6,8,1,0,0,1,1,-1,-1,2,-1
KR_6693876441,420,2,73,-27,0,-2,5,3,3,0,3,3,2,5,1,5,6,-5,5,0,-1,-5,308,-2,-4,6,-32,0,0,-1,-1,1,-1,4,-1
KR_6743702983,420,-1,-9,12,-3,0,2,2,-3,3,0,-4,5,1,3,1,4,1,0,1,0,-3,-20,1,-9,8,2,0,0,-1,1,0,1,1,-1
KR_6742290643,420,-3,8,-39,-11,2,2,4,-4,6,2,-1,2,1,-1,5,4,-7,7,0,-3,-23,4,-4,-2,6,-2,0,-1,-1,-1,-1,-1,4,-1
KR_6728775008,420,-3,-73,-6,-9,0,2,2,-4,4,0,-6,8,2,1,3,4,0,0,0,0,-10,-21,-1,-4,5,-6,0,0,-1,0,0,1,1,-1
KR_6732254320,420,1,29,5,-2,-3,4,1,-1,3,2,4,0,4,-3,5,2,1,0,1,0,-6,3,-4,-4,8,2,0,0,1,0,0,1,6,-1
KR_6719767708,440,1,48,-24,11,5,0,5,1,2,3,-1,3,2,2,1,3,4,2,6,0,13,-53,2,-8,6,28,0,1,-1,1,1,1,2,-1
KR_6726912396,420,-3,-39,-7,-1,4,0,4,-6,6,0,-1,2,1,1,1,2,1,0,1,0,-3,20,-4,-5,9,-2,0,0,-1,-1,0,1,6,-1
KR_6764141324,420,2,26,0,6,-1,1,0,0,2,2,1,1,2,6,1,7,0,1,1,0,8,-6,-3,-5,8,2,0,-1,1,-1,-1,1,2,-1
KR_6748227803,440,0,0,19,-10,0,2,2,-4,4,0,-4,5,1,-4,5,1,2,2,4,0,-10,4,-4,-1,5,0,0,-1,0,0,-1,1,0,-1
KR_6764081129,420,0,-23,-13,-3,5,0,5,-2,2,0,-2,4,2,-3,4,1,-1,1,0,0,-12,-4,-2,-7,9,-2,0,1,-1,0,1,1,2,-1
KR_6672107331,420,-2,-29,0,-6,-1,3,2,-2,3,1,0,0,0,-4,7,3,1,1,2,0,-9,138,2,-8,6,-3,0,-2,-1,-1,-1,-1,4,-1
KR_6743918218,420,-3,-37,-19,-3,-1,3,2,0,1,1,-2,2,0,-1,2,1,1,0,1,0,3,-14,-8,-3,11,4,0,0,1,0,0,-1,4,-1
KR_6685056366,420,1,-1,-24,0,3,0,3,-2,4,2,-1,1,0,0,1,1,0,1,1,0,-5,15,2,-5,3,1,0,0,0,0,0,-1,0,-1
KR_6747500757,440,-1,10,6,-1,0,1,1,-4,4,0,-3,4,1,3,2,5,3,2,5,3,6,-1,-6,-6,12,4,0,1,0,-1,1,1,0,-1
KR_6735175507,420,-3,-43,-24,-5,-1,3,2,-7,8,1,-1,3,2,4,2,6,0,1,1,1,5,4,-5,-1,6,0,0,0,-1,-1,-1,-1,5,-1
KR_6691760966,420,2,2,13,4,2,1,3,-2,3,1,-3,4,1,3,3,6,4,0,4,1,7,1,3,-8,5,0,0,-1,1,-1,-1,1,2,-1
KR_6753023553,420,-2,8,-12,-5,1,1,2,-1,3,2,-1,3,2,-2,3,1,-2,2,0,0,-6,37,0,-6,6,1,0,-1,-1,-1,-1,1,6,-1
KR_6748008236,420,-7,-44,-35,-17,1,0,1,-2,3,1,-2,5,3,-9,9,0,-5,6,1,0,-23,-36,-5,-2,7,19,0,-3,-1,-1,-1,-1,2,-1
KR_6653042459,420,-4,-29,7,-6,-2,3,1,-1,4,3,-2,5,3,-2,4,2,1,1,2,0,-9,-7,0,-9,9,-1,0,0,1,-1,-1,-1,2,-1
KR_6661697826,420,-1,-67,22,2,2,0,2,0,1,1,1,1,2,-2,4,2,1,0,1,0,-2,67,0,-5,5,-5,0,-1,1,-1,-1,1,1,-1
KR_6745068873,420,-1,-14,-4,-6,1,3,4,0,2,2,-4,7,3,-3,5,2,0,0,0,0,2,-23,3,-6,3,-9,0,-1,-1,1,-1,-1,3,-1
KR_6754545039,440,0,21,17,-8,0,1,1,-5,5,0,-3,5,2,-1,1,0,1,2,3,0,-11,-1,-5,-3,8,0,0,0,-1,1,0,-1,4,-1
KR_6756688996,420,1,-20,4,5,-4,5,1,5,0,5,0,3,3,2,4,6,2,0,2,0,8,1,-4,-5,9,1,0,0,1,1,0,1,5,-1
KR_6648193235,420,-1,11,-8,1,2,2,4,5,1,6,-4,6,2,-2,2,0,0,0,0,0,-7,-2,-4,-5,9,-5,0,1,1,1,1,1,1,-1
KR_6763093548,420,1,-21,-7,0,-1,2,1,-1,5,4,3,2,5,-2,4,2,1,0,1,0,1,2,2,-8,6,-2,0,-1,-1,-1,-1,1,3,-1
KR_6764195761,420,4,6,19,4,0,0,0,1,2,3,4,0,4,1,2,3,-2,3,1,0,2,6,1,-8,7,-3,0,2,1,1,1,1,5,-1
KR_6763247463,420,1,-12,-22,5,2,0,2,0,2,2,-2,5,3,3,0,3,2,2,4,0,10,-148,0,-6,6,2,0,0,1,-1,0,1,3,-1
KR_6763480944,420,-5,-98,-33,-8,-8,8,0,-1,4,3,5,1,6,0,1,1,-4,4,0,0,-3,19,-4,-2,6,8,0,-3,-1,-1,-1,1,6,-1
KR_6735476744,440,2,-24,32,9,-4,4,0,3,0,3,5,2,7,4,0,4,1,2,3,0,7,-2,-3,-3,6,0,0,-1,1,-1,-1,-1,6,-1
KR_6609089022,420,-2,-92,0,-5,1,2,3,1,2,3,-3,5,2,-2,3,1,-2,2,0,1,-7,6,2,-7,5,-4,0,-1,-1,-1,-1,1,3,-1
KR_6760334798,420,-1,-6,8,-4,-1,3,2,0,0,0,0,2,2,-2,6,4,-1,1,0,0,-7,33,-1,-5,6,-5,0,-1,-1,1,-1,-1,4,-1
KR_6761570147,440,-2,-26,-20,-4,-3,3,0,0,4,4,1,3,4,-2,5,3,0,1,1,0,-6,23,5,-10,5,0,0,-2,1,-1,-1,1,5,-1
KR_6750559116,420,2,15,0,1,1,0,1,1,3,4,-4,4,0,3,3,6,0,0,0,0,3,1,2,-5,3,-3,0,0,-1,1,0,-1,6,-1
KR_6761023498,420,0,-18,0,-5,1,1,2,-1,3,2,0,3,3,-5,6,1,0,1,1,0,-6,6,1,-4,3,2,0,-1,-1,1,-1,-1,3,-1
KR_6741055099,420,-3,-23,-22,-9,-1,2,1,-7,8,1,0,3,3,-2,5,3,1,1,2,0,-6,-7,2,-6,4,0,0,0,-1,-1,-1,-1,2,-1
KR_6675495908,440,-1,-69,12,-1,-3,3,0,-1,3,2,-1,2,1,1,3,4,3,2,5,0,0,9,1,-5,4,0,0,0,0,-1,0,1,0,-1
KR_6756654260,420,-3,-30,-11,-8,-4,6,2,-1,3,2,3,0,3,-5,5,0,-1,1,0,-2,-7,2,-3,-4,7,1,0,-1,0,1,-1,-1,0,-1
KR_6755814345,420,-3,34,-8,2,-1,2,1,2,3,5,0,2,2,2,4,6,-1,2,1,1,5,27,1,-5,4,-1,0,0,-1,-1,0,1,5,-1
KR_6736419082,440,-2,-49,19,-8,-2,4,2,-5,6,1,-1,3,2,-2,4,2,2,0,2,0,4,5,-3,-3,6,0,0,-1,-1,-1,-1,-1,6,-1
KR_6662274356,440,-7,-58,-62,-12,-1,2,1,-5,5,0,-1,3,2,-4,6,2,-1,1,0,0,-10,-3,0,-4,4,1,0,-1,0,0,-1,-1,0,-1
KR_6763455078,440,1,13,15,1,1,0,1,-1,3,2,-3,3,0,6,3,9,-2,5,3,1,-14,-239,1,-3,2,0,0,0,0,-1,0,-1,0,-1
KR_6748955947,420,-7,-12,5,-15,-5,8,3,-6,8,2,-1,1,0,-2,4,2,-1,2,1,-1,-15,-16,-2,-4,6,-2,0,-2,1,-1,-1,-1,1,-1
KR_6764825067,420,-5,-9,-30,-10,-1,3,2,-4,4,0,-3,4,1,0,1,1,-2,3,1,0,-5,-5,-4,-2,6,-1,0,0,-1,-1,-1,-1,5,-1
KR_6748642204,420,3,0,2,9,-3,4,1,2,3,5,3,0,3,4,1,5,3,0,3,0,23,3,1,-7,6,1,0,-1,-1,-1,-1,-1,5,-1
KR_6679173042,420,-2,15,-10,-2,-4,5,1,2,1,3,0,4,4,4,0,4,-4,4,0,0,-1,1,-1,-4,5,0,0,-1,1,-1,-1,1,3,-1
KR_6743270970,420,-2,-42,16,-5,0,1,1,-5,6,1,1,0,1,-3,3,0,2,1,3,0,-12,-48,-6,-3,9,29,0,0,0,1,0,1,0,-1
KR_6630000283,420,0,-119,-3,-3,-4,4,0,-7,9,2,5,2,7,2,3,5,1,3,4,0,8,-6,-4,-1,5,4,0,-1,1,-1,-1,1,3,-1
KR_6761891098,420,-1,8,24,-2,4,0,4,-4,5,1,4,2,6,-5,7,2,-1,1,0,0,-7,-22,-6,-2,8,4,0,0,-1,1,0,-1,1,-1
KR_6749997960,420,2,24,10,1,1,3,4,-2,3,1,2,0,2,-1,4,3,1,1,2,-1,-3,5,6,-11,5,1,0,0,-1,1,1,-1,3,-1
KR_6704897119,420,-3,-34,2,-6,1,0,1,1,1,2,-8,8,0,1,4,5,-1,1,0,0,-7,29,-3,-2,5,-4,0,-1,1,-1,-1,1,3,-1
KR_6726869052,420,-1,-10,-11,-2,-4,5,1,-6,7,1,3,1,4,4,1,5,1,0,1,0,9,10,-5,-2,7,3,0,-1,0,-1,1,-1,0,-1
KR_6762602637,420,0,24,24,-6,-3,3,0,-2,3,1,1,7,8,-4,5,1,2,1,3,1,-6,-7,-7,-2,9,0,0,-1,0,0,-1,1,0,-1
KR_6762048314,420,-2,-38,8,-3,-2,2,0,-2,4,2,2,2,4,-3,7,4,2,0,2,0,-8,10,5,-8,3,-2,0,-1,-1,1,-1,-1,4,-1
KR_6761506104,420,0,-33,4,-3,-2,3,1,0,1,1,-1,1,0,1,0,1,-1,1,0,0,-6,-8,2,-7,5,5,0,0,1,-1,0,-1,6,-1
KR_6643514202,420,-4,-57,0,-9,-1,3,2,-2,5,3,-6,8,2,-2,6,4,2,0,2,0,-10,-5,-3,-4,7,0,0,0,-1,0,0,1,5,-1
KR_6720723627,420,1,-10,-38,3,1,1,2,1,1,2,-1,5,4,1,1,2,1,2,3,0,5,-3,5,-7,2,-1,0,-1,-1,-1,-1,1,3,-1
KR_6729969089,420,-5,-59,-17,-12,-5,5,0,0,6,6,-5,6,1,-1,4,3,-1,1,0,0,-9,-25,1,-5,4,-3,0,-2,1,-1,-1,-1,5,-1
KR_6742033893,420,-1,-55,-28,-4,2,1,3,-10,10,0,2,0,2,2,3,5,0,0,0,0,-7,-4,-1,-2,3,-2,0,0,-1,-1,-1,-1,5,-1
KR_6749022232,420,-7,-53,-29,-12,-1,3,2,-7,10,3,2,1,3,-3,5,2,-3,4,1,0,-22,14,-4,-6,10,-9,0,0,1,1,-1,-1,2,-1
KR_6706717260,420,-2,-96,-10,-6,-3,4,1,1,3,4,-6,9,3,-4,8,4,6,0,6,-2,19,-289,1,-5,4,-4,0,0,-1,1,-1,-1,6,-1
KR_6743991633,420,2,-51,10,3,0,0,0,-1,5,4,0,2,2,4,2,6,0,3,3,0,11,-6,-4,-4,8,0,0,1,0,1,-1,-1,0,-1
KR_6649527304,420,-2,-30,13,-2,-1,2,1,-1,4,3,3,1,4,2,1,3,-5,5,0,-1,-3,23,3,-5,2,0,0,0,-1,1,0,-1,3,-1
KR_6754347876,420,-3,-34,4,-5,3,2,5,-4,4,0,-2,2,0,-2,4,2,0,2,2,0,-2,-37,-1,-6,7,-1,0,-1,1,-1,-1,-1,1,-1
KR_6763710643,420,0,-28,-15,2,3,0,3,-6,6,0,2,4,6,3,1,4,0,3,3,0,7,4,-1,-8,9,-3,0,-2,0,1,-1,-1,0,-1
KR_6738788546,420,0,54,9,1,5,0,5,3,3,6,-1,2,1,-2,5,3,-4,5,1,0,-4,-21,-2,-6,8,0,0,1,1,1,1,1,4,-1
KR_6764861652,420,0,106,11,-14,0,3,3,2,2,4,-4,5,1,-10,11,1,-2,3,1,0,-9,-15,-1,-5,6,1,0,0,1,-1,-1,1,1,-1
KR_6721094786,420,1,84,27,1,3,1,4,0,2,2,1,3,4,-2,3,1,-1,2,1,1,2,-4,0,-5,5,0,0,0,0,1,1,1,0,-1
KR_6674648209,420,1,15,20,-4,-1,2,1,1,0,1,-8,11,3,3,2,5,1,3,4,1,-4,4,-1,-4,5,-6,0,0,-1,-1,0,1,1,-1
KR_6730376428,420,-5,-117,-9,-10,-4,6,2,1,2,3,-1,4,3,-3,4,1,-3,3,0,-1,-5,-37,-1,-5,6,-1,0,0,-1,-1,-1,-1,4,-1
KR_6762676527,420,-3,4,4,-7,-3,4,1,-1,3,2,-2,3,1,1,3,4,-2,2,0,0,-7,2,-2,-5,7,-2,0,-2,-1,0,-1,1,4,-1
KR_6760900327,420,-2,-29,-7,-3,0,3,3,0,1,1,-2,4,2,-2,4,2,1,2,3,0,4,-3,3,-5,2,-2,0,0,0,-1,-1,-1,0,-1
KR_6759711138,420,-6,-40,39,-12,-4,5,1,-4,4,0,0,2,2,-2,6,4,-2,3,1,0,-11,-89,0,-5,5,0,0,-2,-1,-1,-1,-1,3,-1
KR_6760025086,440,-1,-7,8,-5,0,2,2,-8,8,0,1,2,3,2,1,3,0,1,1,0,-16,31,1,-8,7,6,0,0,1,1,0,-1,5,-1
KR_6704966096,420,-1,-34,-29,-4,-2,4,2,-5,6,1,2,2,4,0,1,1,1,2,3,0,-5,-10,-1,-8,9,5,0,-1,-1,-1,-1,1,4,-1
KR_6681738507,420,-2,-41,-26,-1,2,2,4,1,1,2,1,0,1,-4,5,1,-1,1,0,0,-3,-6,-2,-3,5,-2,0,0,-1,1,-1,1,4,-1
KR_6728585716,440,1,-15,28,-1,-3,5,2,-2,4,2,0,2,2,3,1,4,1,1,2,0,2,-9,0,-3,3,13,0,0,1,-1,-1,1,6,-1
KR_6744514860,440,-7,-85,-43,-12,-5,5,0,-1,4,3,-4,6,2,-2,3,1,0,1,1,0,-12,-6,0,-2,2,1,0,-1,0,-1,-1,-1,0,-1
KR_6748934691,420,0,-60,-8,-4,0,2,2,1,2,3,-6,6,0,1,1,2,0,0,0,0,-2,-27,-1,-2,3,-5,0,-1,1,-1,-1,-1,1,-1
KR_6752935802,420,-2,28,-5,8,3,1,4,-4,6,2,7,2,9,3,3,6,-1,1,0,0,2,-1,-3,-5,8,3,0,-2,1,-1,-1,1,6,-1
KR_6415969262,420,-1,-55,42,-2,-1,2,1,0,3,3,0,1,1,-2,3,1,1,1,2,0,-3,-7,1,-7,6,-3,0,-1,1,-1,-1,1,4,-1
KR_6704056150,420,1,39,-37,-6,-4,5,1,-4,5,1,0,4,4,2,2,4,0,0,0,-2,-8,-7,-1,-1,2,-1,0,2,-1,-1,-1,-1,2,-1
KR_6730885297,420,-3,54,-20,-6,-3,5,2,-2,4,2,-2,2,0,2,4,6,-1,2,1,0,-12,7,-2,-1,3,-16,0,0,1,1,1,1,6,-1
KR_6747835634,440,2,-5,0,1,1,2,3,0,2,2,-3,4,1,2,2,4,1,2,3,0,1,6,0,-2,2,0,0,-1,1,-1,-1,1,6,-1
KR_6759767241,440,-3,-22,4,-9,-3,4,1,-4,8,4,1,1,2,-1,2,1,-2,2,0,0,-17,1,1,-3,2,4,0,-2,1,-1,-1,-1,5,-1
KR_6727105420,420,0,30,4,-5,0,2,2,-2,2,0,-5,5,0,2,0,2,0,2,2,0,-12,5,2,-6,4,-1,0,-1,1,-1,-1,-1,6,-1
KR_6762515131,420,-1,12,-33,2,0,1,1,-1,3,2,2,6,8,1,0,1,0,1,1,0,1,9,4,-9,5,-1,0,0,1,1,0,-1,2,-1
KR_6754120261,420,-1,-55,12,-3,7,0,7,-4,5,1,-6,6,0,0,4,4,0,0,0,1,-5,16,-1,-7,8,-5,0,0,-1,1,1,-1,6,-1
KR_6764861275,420,-5,-44,-25,-13,-6,9,3,-1,4,3,0,4,4,-3,5,2,-3,3,0,0,-18,6,1,-9,8,0,0,-1,1,-1,-1,-1,2,-1
KR_6707919579,420,-7,-60,-3,-19,-5,6,1,-4,5,1,-4,4,0,-3,4,1,-3,3,0,0,-19,-7,1,-7,6,-4,0,-3,-1,-1,-1,-1,3,-1
KR_6763115899,420,-2,-5,-18,0,1,3,4,3,2,5,-5,6,1,0,4,4,1,0,1,0,-5,-12,-2,-3,5,2,0,-1,1,-1,-1,-1,6,-1
KR_6763702455,420,-1,40,-3,-6,-1,1,0,-4,4,0,-3,5,2,-1,5,4,3,0,3,0,-5,1,-2,-5,7,-2,0,0,-1,1,0,-1,4,-1
KR_6636881048,420,0,-14,-20,0,-3,3,0,5,1,6,3,1,4,-4,4,0,-1,2,1,0,1,6,0,-6,6,-6,0,0,-1,-1,-1,-1,5,-1
KR_6748016416,420,1,8,-10,5,4,0,4,4,1,5,2,0,2,-3,3,0,-2,2,0,0,6,23,0,-5,5,-1,0,0,1,-1,0,1,3,-1
KR_6757124527,420,-3,-35,-4,-7,-5,6,1,-3,9,6,-1,2,1,3,3,6,-1,1,0,0,-9,1,0,-5,5,3,0,-1,-1,1,-1,-1,2,-1
KR_6690448549,420,-3,-35,-18,-7,5,1,6,-2,2,0,-9,10,1,0,2,2,-1,1,0,0,-7,0,2,-7,5,2,0,-1,-1,-1,-1,-1,1,-1
KR_6754301928,420,-1,-8,-10,-6,-2,3,1,1,1,2,-5,5,0,1,3,4,-1,2,1,-1,-5,3,-4,-5,9,-1,0,0,-1,-1,0,-1,6,-1
KR_6756953549,420,2,25,18,8,8,2,10,-2,4,2,-3,4,1,6,1,7,-1,1,0,3,7,10,4,-6,2,-3,0,1,1,1,1,1,3,-1
KR_6730102081,420,0,-56,12,-1,1,2,3,1,1,2,-3,5,2,0,1,1,0,0,0,0,-1,3,3,-6,3,-1,0,0,-1,-1,0,-1,5,-1
KR_6734652570,420,-1,-15,0,0,7,0,7,-5,10,5,-3,5,2,1,2,3,0,2,2,-1,-8,-7,1,-5,4,-4,0,-1,-1,-1,-1,-1,2,-1
KR_6764970579,420,-11,-111,-20,-21,-4,4,0,1,0,1,-5,5,0,-13,16,3,0,1,1,0,-25,-7,0,-3,3,-2,-1,-5,-1,-1,-1,-1,1,-1
KR_6696241388,420,0,11,-18,8,4,1,5,0,3,3,0,6,6,3,3,6,1,2,3,3,11,-172,1,-6,5,22,0,2,-1,1,1,-1,6,-1
KR_6744438092,420,-4,-127,29,-14,-3,3,0,-3,3,0,-2,7,5,-2,4,2,-4,4,0,1,-24,-19,0,-5,5,2,0,-1,-1,1,-1,1,6,-1
KR_6708113794,420,0,-25,-4,-5,-2,2,0,-1,2,1,-3,3,0,-2,3,1,3,0,3,-1,-4,-20,-2,-7,9,-6,0,0,1,-1,-1,-1,5,-1
KR_6709687272,420,-2,-72,6,-9,0,2,2,1,2,3,0,3,3,-6,7,1,-4,4,0,-2,-14,-25,-1,-4,5,-4,0,-2,-1,-1,-1,1,1,-1
KR_6730403687,420,0,-35,12,0,0,0,0,0,3,3,-1,4,3,2,0,2,-1,2,1,0,1,-63,2,-2,0,22,0,0,1,-1,0,1,1,-1
KR_6544327978,420,-4,-39,-39,-8,0,1,1,-3,5,2,-2,2,0,-2,6,4,-1,1,0,0,-9,23,-1,-8,9,0,0,-1,-1,-1,-1,1,3,-1
KR_6763918090,440,-3,-79,-20,-10,-4,4,0,5,5,10,-2,3,1,-10,11,1,1,1,2,0,-9,1,1,-4,3,-5,0,-2,-1,-1,-1,-1,3,-1
KR_6689911299,420,-3,70,-35,-10,0,1,1,-5,7,2,-1,1,0,-4,7,3,0,0,0,0,-17,-11,-4,-2,6,5,0,-1,-1,-1,-1,-1,6,-1
KR_6749276766,420,-3,12,3,-9,-2,2,0,-4,4,0,1,3,4,-4,4,0,0,0,0,0,-9,7,3,-8,5,-3,0,-1,-1,-1,-1,-1,3,-1
KR_6763183603,420,0,-76,13,-4,-1,1,0,-1,2,1,0,2,2,-1,2,1,-1,2,1,0,-3,-12,-4,-7,11,0,0,-1,0,-1,-1,-1,0,-1
KR_6751182765,440,-1,-18,-1,0,-3,6,3,-8,9,1,3,4,7,8,0,8,0,3,3,0,0,7,6,-8,2,-3,0,1,0,-1,-1,-1,0,-1
KR_6756656653,420,3,57,43,-3,4,1,5,0,3,3,-4,6,2,-5,7,2,2,1,3,0,-8,-2,1,-5,4,-2,0,1,1,1,1,-1,4,-1
KR_6757693122,420,0,-40,-9,-1,0,3,3,-4,5,1,0,2,2,3,0,3,0,1,1,0,6,6,-1,-6,7,-5,0,1,1,1,1,1,5,-1
KR_6727063829,420,3,-52,15,5,1,2,3,7,2,9,-1,1,0,-1,1,0,-1,3,2,0,10,-8,-4,-7,11,-4,0,-1,1,1,-1,1,2,-1
KR_6628974366,420,1,-16,-20,3,0,0,0,4,1,5,-5,6,1,5,0,5,-1,2,1,0,2,4,1,-3,2,0,0,0,-1,1,0,1,2,-1
KR_6591357238,420,-6,-95,-47,-10,0,1,1,-3,3,0,-3,7,4,-2,5,3,-2,3,1,0,-8,3,5,-10,5,-5,0,-2,-1,-1,-1,-1,3,-1
KR_6759765045,420,-1,-13,-5,-3,1,2,3,4,1,5,-2,3,1,-4,5,1,-2,2,0,0,-2,-1,0,-5,5,-6,0,0,-1,1,0,1,3,-1
KR_6530024451,420,-2,-56,-28,-4,1,1,2,-4,9,5,-3,4,1,0,0,0,2,0,2,1,-9,-18,1,-6,5,0,0,0,-1,1,-1,1,4,-1
KR_6761863654,420,-3,24,-24,-7,-3,3,0,0,4,4,3,0,3,-7,8,1,0,0,0,-2,-6,5,-1,-5,6,-2,0,0,-1,-1,-1,-1,4,-1
KR_6759540086,420,1,-20,-8,-1,0,1,1,0,1,1,0,0,0,-2,4,2,1,2,3,0,-2,-175,4,-7,3,-4,0,-2,0,-1,-1,-1,0,-1
KR_6764453902,440,-3,-70,-19,-6,1,0,1,0,2,2,5,1,6,-11,11,0,-1,1,0,0,-5,265,-2,-2,4,-4,0,-2,-1,-1,-1,-1,5,-1
KR_6764816131,420,0,-23,-25,1,1,0,1,0,0,0,1,0,1,-1,6,5,0,0,0,0,4,0,0,-6,6,1,0,1,1,-1,1,-1,3,-1
KR_6697381468,440,-7,-93,-24,-6,-2,4,2,0,0,0,-4,5,1,0,4,4,0,1,1,0,-5,0,3,-6,3,-6,0,0,0,-1,-1,1,0,-1
KR_6732672834,420,-7,-53,0,-19,-5,5,0,-4,4,0,-5,6,1,-2,5,3,-3,4,1,0,-16,3,2,-6,4,0,0,-1,1,-1,-1,1,6,-1
KR_6759631242,420,0,-35,-32,-1,-1,3,2,-1,5,4,0,2,2,1,1,2,0,1,1,0,-3,-39,1,-6,5,3,0,-2,-1,-1,-1,1,3,-1
KR_6629947508,420,-8,-59,-27,-12,-2,2,0,-10,10,0,-3,4,1,2,2,4,1,1,2,1,-6,4,-2,-5,7,-4,0,-4,1,-1,-1,1,2,-1
KR_6744094308,420,-3,-37,16,-7,-3,4,1,-4,6,2,2,2,4,-1,2,1,-1,1,0,0,-7,154,4,-7,3,-21,0,-1,-1,1,-1,1,3,-1
KR_6728907280,420,2,-74,49,2,-2,3,1,-2,2,0,3,2,5,2,1,3,1,0,1,0,5,2,2,-5,3,2,0,0,0,1,0,-1,0,-1
KR_6723009409,420,0,-5,11,3,2,0,2,-6,6,0,3,0,3,1,2,3,3,2,5,0,-1,0,-4,-5,9,2,0,1,1,1,1,1,1,-1
KR_6720314618,420,0,-37,4,-2,-1,2,1,4,2,6,-3,6,3,-1,1,0,-1,2,1,0,-9,-14,-4,-3,7,0,0,-1,-1,-1,-1,-1,3,-1
KR_6625466753,420,-2,-16,-13,-5,-1,5,4,-1,4,3,-1,2,1,-5,6,1,3,0,3,1,1,9,3,-11,8,-3,0,0,-1,-1,-1,1,5,-1
KR_6732456565,420,3,29,46,6,5,0,5,-1,6,5,0,3,3,0,2,2,2,0,2,0,-3,-7,-1,-5,6,-1,0,0,0,-1,0,1,0,-1
KR_6761727182,440,1,-66,8,-5,1,3,4,-1,1,0,-6,9,3,3,1,4,-2,2,0,0,11,9,4,-7,3,-1,0,-3,-1,-1,-1,-1,4,-1
KR_6761783822,440,1,-67,20,3,-4,5,1,3,1,4,0,3,3,3,0,3,1,0,1,0,5,20,0,-4,4,-2,0,0,1,0,0,1,5,-1
KR_6763241792,420,0,7,36,0,-3,3,0,-1,7,6,2,2,4,-2,6,4,4,0,4,0,3,-4,-4,-3,7,0,0,-1,0,-1,-1,-1,0,-1
KR_6749431714,420,-3,-65,0,-3,0,4,4,4,0,4,-4,6,2,-3,3,0,0,1,1,0,-5,6,1,-5,4,3,0,-1,-1,1,-1,1,5,-1
KR_6761902617,420,2,37,7,-1,0,2,2,-3,5,2,0,1,1,1,2,3,1,2,3,0,2,-2,-4,-3,7,1,0,2,-1,1,1,1,5,-1
KR_6733065936,420,2,50,16,0,3,0,3,1,3,4,-2,4,2,-5,5,0,3,1,4,0,-5,15,-3,-3,6,8,0,1,-1,1,1,1,3,-1
KR_6755981173,420,-4,-67,-25,-14,0,3,3,-4,7,3,-4,6,2,-5,6,1,-1,3,2,0,-15,10,1,-5,4,-4,0,-2,1,-1,-1,-1,4,-1
KR_6759732646,420,-2,-9,-5,-5,2,1,3,2,2,4,-4,5,1,-1,4,3,-4,6,2,0,-2,15,-1,-3,4,-3,0,0,-1,1,-1,-1,6,-1
KR_6759589623,420,1,20,21,-2,-3,4,1,-1,5,4,1,0,1,-1,1,0,2,0,2,0,-4,8,0,-3,3,-6,0,-1,1,1,1,1,2,-1
KR_6720337621,420,1,35,-2,3,-1,1,0,-5,9,4,3,2,5,4,1,5,2,2,4,0,-6,4,2,-9,7,-1,0,0,-1,-1,0,-1,1,-1
KR_6754276053,420,-2,-62,0,-4,-2,3,1,2,3,5,0,2,2,-3,4,1,-1,2,1,0,-9,-32,2,-4,2,9,0,0,0,-1,0,-1,0,-1
KR_6704230192,420,-1,-60,-21,-6,2,0,2,-7,12,5,-1,3,2,-1,7,6,1,3,4,-1,-9,-30,-7,-2,9,1,0,-2,-1,-1,-1,-1,5,-1
KR_6750751081,420,0,-9,-12,0,4,0,4,0,1,1,0,1,1,-4,4,0,0,1,1,0,-5,-2,3,-5,2,0,0,-1,-1,1,-1,1,6,-1
KR_6763673822,420,0,-75,40,-7,-4,5,1,-4,7,3,1,1,2,0,3,3,0,1,1,-1,-2,32,-3,-5,8,3,0,-1,0,-1,-1,-1,0,-1
KR_6740203484,420,-2,3,0,-2,-2,2,0,-5,5,0,0,0,0,3,2,5,2,1,3,0,3,-30,-4,-5,9,11,0,-1,1,-1,-1,1,2,-1
KR_6710638757,440,-6,-55,-20,-10,-5,6,1,-5,7,2,-1,3,2,-2,7,5,3,0,3,-1,-19,4,-6,-5,11,6,0,-2,-1,-1,-1,-1,1,-1
KR_6704506815,440,-1,-57,12,-9,3,2,5,1,2,3,-8,8,0,-2,3,1,-3,4,1,-2,-8,8,0,-2,2,3,0,-1,-1,-1,-1,-1,5,-1
KR_6659908754,440,-1,-35,-24,2,-2,3,1,-1,3,2,1,1,2,3,0,3,1,0,1,0,3,21,1,-5,4,-18,0,0,1,0,0,1,5,-1
KR_6751245270,420,-4,8,-15,-12,-1,2,1,-5,5,0,0,3,3,-1,2,1,-5,7,2,0,-13,-29,-6,-4,10,2,0,-1,-1,-1,-1,-1,5,-1
KR_6758817548,420,-1,51,40,-6,-3,3,0,3,1,4,-7,7,0,-2,6,4,3,0,3,0,-8,2,3,-6,3,-1,0,0,1,-1,0,1,5,-1
KR_6762538572,420,2,54,-9,-2,-3,4,1,-3,6,3,0,3,3,6,0,6,-2,2,0,0,-3,8,4,-8,4,0,0,-1,1,-1,-1,1,6,-1
KR_6738584505,420,-3,11,-36,-6,-6,8,2,2,1,3,2,2,4,0,3,3,-4,5,1,0,-8,-151,1,-6,5,-3,0,0,-1,1,0,-1,2,-1
KR_6715107769,420,1,35,24,5,-3,4,1,2,1,3,1,2,3,5,2,7,0,0,0,1,8,12,2,-9,7,-4,0,0,1,-1,1,1,2,-1
KR_6690065792,420,1,-30,10,4,-2,2,0,3,0,3,-1,2,1,3,0,3,1,0,1,0,11,-132,1,-6,5,-3,0,-1,1,-1,-1,1,4,-1
KR_6731652967,420,0,11,4,2,-1,3,2,5,1,6,-3,7,4,0,2,2,1,1,2,0,-5,17,-1,-4,5,-6,0,0,0,1,0,1,0,-1
KR_6689023199,420,1,2,-4,-2,-2,2,0,1,2,3,-2,3,1,4,0,4,-3,4,1,-1,4,-133,2,-8,6,3,0,0,1,-1,0,-1,4,-1
KR_6696147218,420,-6,-33,-35,-12,2,1,3,-7,8,1,-2,3,1,-1,5,4,-4,5,1,-1,-15,-29,0,-7,7,-3,0,-1,0,-1,-1,-1,0,-1
KR_6754256698,420,-5,-32,-53,-6,-6,7,1,-4,4,0,1,1,2,3,1,4,0,0,0,0,-5,0,3,-7,4,1,0,1,-1,1,-1,1,2,-1
KR_6695420213,420,0,30,10,-3,3,1,4,2,6,8,-2,2,0,-6,7,1,0,1,1,0,-8,3,1,-6,5,-2,0,2,-1,1,1,-1,4,-1
KR_6758720923,420,-2,28,-2,-2,-2,2,0,-2,2,0,2,1,3,1,1,2,-1,3,2,1,-7,-7,0,-9,9,3,0,0,1,-1,1,1,4,-1
KR_6752123935,440,-1,-20,-10,-5,0,0,0,1,4,5,-2,2,0,-5,5,0,1,0,1,0,-5,-5,-4,-1,5,6,0,-1,-1,-1,-1,-1,5,-1
KR_6702735705,420,0,0,5,7,-1,1,0,8,1,9,0,2,2,-1,3,2,1,2,3,0,8,-4,1,-6,5,5,0,0,1,-1,0,1,6,-1
KR_6763830489,420,-7,-59,2,-10,-2,4,2,-5,8,3,-4,6,2,0,4,4,1,0,1,0,-10,-10,0,-4,4,-9,0,-1,-1,1,-1,1,1,-1
KR_6751323679,420,0,-59,29,-7,-1,4,3,-1,2,1,-8,8,0,-1,1,0,4,0,4,0,-3,-9,-4,-4,8,6,0,-2,1,-1,-1,-1,2,-1
KR_6695233715,440,-1,21,26,-13,-2,3,1,-3,4,1,-1,3,2,-7,8,1,0,2,2,1,-10,-36,-4,0,4,-5,0,-1,-1,-1,-1,1,3,-1
KR_6754064594,420,-1,-28,9,-7,-4,6,2,-2,4,2,-1,1,0,-1,3,2,1,1,2,-1,-4,110,0,-6,6,-3,0,-1,1,-1,-1,-1,1,-1
KR_6747730047,420,-2,-61,-45,-3,-1,2,1,0,1,1,-2,3,1,0,1,1,0,0,0,0,3,0,1,-4,3,-2,0,0,-1,-1,0,-1,2,-1
KR_6702738931,420,-1,11,-7,4,-1,3,2,-1,2,1,-1,3,2,5,0,5,2,1,3,0,7,0,1,-8,7,-5,0,0,1,-1,-1,1,2,-1
KR_6675040326,420,1,10,32,0,0,1,1,1,2,3,1,3,4,-1,2,1,-1,2,1,0,-5,12,-1,-4,5,3,0,-1,1,-1,-1,1,3,-1
KR_6679748667,420,-1,-53,-48,9,-3,4,1,4,1,5,1,2,3,2,2,4,5,0,5,0,19,-44,-2,-5,7,23,0,1,-1,1,-1,1,4,-1
KR_6759773743,420,-6,-63,-4,-9,-2,2,0,3,2,5,-3,3,0,-9,9,0,2,1,3,0,-5,0,-1,-5,6,-4,0,-1,1,-1,-1,1,3,-1
KR_6764823313,420,-5,-72,-12,-13,-6,7,1,-1,2,1,0,2,2,-6,6,0,0,0,0,0,-7,-11,-3,-6,9,-2,0,-1,-1,-1,-1,-1,3,-1
KR_6746968783,420,-1,-40,-7,-6,-4,5,1,-1,3,2,0,1,1,-1,4,3,0,0,0,0,-4,-131,-4,-4,8,4,0,0,-1,-1,-1,1,4,-1
KR_6712227866,420,-2,-69,-32,-3,-1,3,2,-3,5,2,-1,3,2,-2,5,3,4,0,4,0,1,14,-6,-4,10,-14,0,-1,1,-1,-1,1,2,-1
KR_6749075443,420,0,-8,-12,-8,-3,5,2,1,2,3,-1,2,1,-5,7,2,0,1,1,-2,-11,21,0,-7,7,1,0,1,-1,-1,-1,-1,5,-1
KR_6449620449,420,2,37,-3,11,4,0,4,-5,12,7,1,0,1,8,1,9,3,0,3,0,17,-30,3,-8,5,-5,0,-1,-1,-1,1,-1,5,-1
KR_6741716702,420,-3,-8,10,-5,-1,3,2,-1,1,0,-5,5,0,-2,3,1,4,0,4,0,-5,-8,-5,-2,7,2,0,-1,-1,1,-1,-1,3,-1
KR_6728269597,420,-2,29,2,-3,-1,4,3,1,2,3,-1,3,2,-2,4,2,0,1,1,1,-5,9,-2,-3,5,0,0,-1,-1,0,-1,1,5,-1
KR_6691187528,420,-3,4,5,-7,1,0,1,1,2,3,-8,9,1,0,3,3,-1,1,0,1,-5,3,7,-9,2,-2,0,0,-1,-1,-1,1,5,-1
KR_6757305119,420,-2,-100,25,-7,-3,5,2,-2,4,2,6,0,6,0,8,8,-8,8,0,1,-4,30,-2,-4,6,2,0,-2,1,1,-1,1,2,-1
KR_6762727033,420,-3,-54,8,-4,-1,1,0,-3,5,2,1,1,2,0,1,1,-1,1,0,0,-2,1,-1,-5,6,-7,0,0,-1,-1,0,1,6,-1
KR_6296479365,440,-1,-22,-5,0,-5,9,4,-3,5,2,4,0,4,4,2,6,0,1,1,0,2,-3,1,-7,6,6,0,0,0,0,0,1,0,-1
KR_6707801790,420,-1,-59,12,2,0,3,3,0,5,5,5,0,5,-1,2,1,-2,2,0,0,0,-4,2,-5,3,-3,0,-1,1,-1,-1,-1,2,-1
KR_6698111002,420,0,14,-12,-5,0,1,1,0,6,6,-5,6,1,0,1,1,0,5,5,0,2,-5,4,-5,1,-1,0,0,-1,-1,-1,1,3,-1
KR_6547289402,440,-4,-46,-28,-13,-1,3,2,0,0,0,-2,4,2,-3,4,1,-7,8,1,0,-10,-18,0,-4,4,-1,0,-1,-1,-1,-1,-1,2,-1
KR_6687515332,420,0,-40,20,-1,-3,5,2,7,1,8,1,2,3,1,5,6,-7,7,0,0,1,-3,2,-7,5,2,0,-1,1,1,-1,-1,2,-1
KR_6622189322,420,0,-22,-23,-8,1,1,2,-5,9,4,-1,2,1,-4,6,2,1,2,3,0,-5,-9,-7,-4,11,2,0,-1,-1,1,-1,-1,5,-1
KR_6732344507,420,0,-73,16,-5,-6,6,0,-2,4,2,5,1,6,-2,2,0,0,0,0,0,-5,-4,1,-6,5,5,0,-1,-1,-1,-1,-1,2,-1
KR_6746093529,420,0,-33,-8,-5,-2,3,1,-4,7,3,-3,5,2,6,2,8,-2,2,0,0,-3,-6,0,-9,9,0,0,0,-1,-1,-1,1,6,-1
KR_6745292307,420,2,95,-25,-1,1,3,4,-6,6,0,5,1,6,0,2,2,-1,1,0,0,-2,12,3,-9,6,-6,0,1,1,-1,1,-1,3,-1
KR_6755607269,420,-1,-93,-12,1,-2,3,1,3,0,3,3,1,4,-1,3,2,-2,2,0,0,0,-34,4,-7,3,-1,0,-2,0,1,-1,-1,0,-1
KR_6715272303,420,1,72,27,-3,-1,4,3,0,1,1,-3,4,1,1,1,2,0,1,1,0,-7,-22,-1,-6,7,-18,0,0,1,1,1,-1,5,-1
KR_6756970074,420,-2,-42,10,-3,-3,3,0,1,3,4,3,3,6,-4,5,1,0,0,0,0,-5,-39,-4,-2,6,1,0,-1,1,1,-1,1,1,-1
KR_6756294326,420,-1,-41,9,-5,0,2,2,-4,6,2,2,0,2,-2,4,2,-1,1,0,0,-6,6,-1,-4,5,3,0,0,-1,1,0,-1,3,-1
KR_6758713738,420,-3,-40,20,-8,-3,3,0,1,4,5,-3,4,1,-2,5,3,-1,1,0,0,-4,33,-2,-3,5,-11,0,1,1,1,1,-1,2,-1
KR_6746495022,420,-3,-21,24,-5,1,1,2,0,3,3,-1,2,1,-4,5,1,-1,1,0,0,-5,33,-7,-1,8,-2,0,0,-1,1,0,1,5,-1
KR_6742964777,420,-2,-64,10,-7,-7,7,0,0,1,1,-2,4,2,1,2,3,1,0,1,-1,-8,-29,-1,-4,5,2,0,-1,-1,-1,-1,-1,4,-1
KR_6601696900,420,-3,-34,-25,-4,-2,3,1,1,2,3,-4,5,1,2,0,2,-1,2,1,0,-6,4,-1,-5,6,-7,0,1,1,1,1,1,1,-1
KR_6696154627,420,-3,-60,-14,-11,-4,4,0,2,0,2,-4,6,2,-3,8,5,-2,2,0,0,-4,-10,-3,-4,7,4,0,-1,1,-1,-1,-1,5,-1
KR_6757772977,420,-4,-94,-42,-12,4,0,4,2,1,3,-4,7,3,-13,14,1,-1,4,3,-1,-12,12,0,-3,3,-4,0,-3,-1,-1,-1,-1,2,-1
KR_6608762377,420,0,58,-16,0,-1,1,0,1,2,3,-1,2,1,2,2,4,-1,1,0,-1,6,0,3,-7,4,-2,0,0,1,-1,1,-1,1,-1
KR_6764464139,420,1,31,11,8,-1,1,0,-2,4,2,3,3,6,6,1,7,2,0,2,0,3,-27,3,-8,5,0,0,2,1,1,1,1,1,-1
KR_6761174910,420,0,-19,-20,0,0,2,2,1,3,4,-1,1,0,-1,1,0,1,1,2,0,-6,14,0,-4,4,-1,0,0,1,-1,0,-1,2,-1
KR_6762461187,420,-3,-60,-5,-1,-2,4,2,0,1,1,0,1,1,1,1,2,0,0,0,0,4,14,5,-8,3,3,0,0,1,1,-1,-1,4,-1
KR_6692154817,420,-1,37,8,-3,-5,6,1,2,3,5,1,2,3,-2,3,1,1,1,2,0,8,1,1,-6,5,-5,0,-1,1,-1,-1,1,5,-1
KR_6756934043,420,-1,-4,2,-1,-3,4,1,2,2,4,-3,3,0,4,1,5,-1,1,0,0,5,-96,0,-6,6,-1,0,0,0,-1,0,-1,0,-1
KR_6743858630,420,0,-27,2,-5,-2,2,0,-3,5,2,-1,2,1,-1,2,1,2,0,2,1,-6,-90,0,-5,5,-9,0,0,-1,1,0,1,1,-1
KR_6764971066,420,1,-103,-2,0,1,0,1,0,2,2,3,2,5,-6,6,0,2,0,2,0,0,5,3,-6,3,1,0,0,-1,1,0,1,3,-1
KR_6750128095,440,-2,-18,-6,-3,2,0,2,-5,5,0,0,0,0,0,4,4,0,1,1,0,4,5,1,-5,4,-4,0,-1,-1,1,-1,-1,3,-1
KR_6584461465,420,-3,-16,-16,-10,-3,4,1,-5,5,0,1,3,4,-1,2,1,-2,2,0,1,-7,-3,5,-9,4,-6,0,0,-1,-1,0,1,6,-1
KR_6475741393,420,-3,-3,-8,-13,-1,1,0,-3,3,0,-3,3,0,-6,7,1,0,1,1,0,-25,-7,0,-7,7,-1,0,-1,-1,-1,-1,-1,3,-1
KR_6764105736,420,3,74,30,3,4,1,5,4,2,6,2,0,2,-7,8,1,0,0,0,0,-6,19,-2,-4,6,-9,0,2,1,1,1,1,1,-1
KR_6752170273,420,-2,-7,-28,-3,0,1,1,-1,5,4,-5,7,2,3,0,3,0,0,0,0,-1,8,-1,-5,6,1,0,-1,-1,-1,-1,-1,6,-1
KR_6762533637,420,-3,-35,12,-3,4,2,6,2,2,4,-1,5,4,-8,8,0,0,0,0,1,-8,4,-2,-4,6,1,0,-1,-1,-1,1,1,4,-1
KR_6763714425,420,-4,-39,-6,-8,-2,2,0,0,2,2,-2,4,2,-2,4,2,-2,2,0,0,-2,4,-5,-3,8,-4,0,0,-1,1,-1,-1,1,-1
KR_6749887632,420,3,28,20,2,2,1,3,-1,4,3,-1,2,1,2,1,3,0,3,3,0,-3,19,3,-8,5,-5,0,0,1,-1,0,-1,1,-1
KR_6757798243,420,-1,-12,-4,-4,0,1,1,-1,4,3,0,3,3,-2,5,3,-1,1,0,0,-10,-19,0,-5,5,2,0,-1,-1,1,1,1,3,-1
KR_6765033043,420,2,-14,-9,6,1,2,3,2,2,4,3,2,5,-1,4,3,1,1,2,0,9,5,1,-5,4,1,0,0,1,1,-1,1,5,-1
KR_6715017899,420,-2,-39,-8,-3,-2,4,2,1,1,2,-2,2,0,0,3,3,0,0,0,0,1,-58,-2,-6,8,13,0,-3,1,-1,-1,-1,6,-1
KR_6713125733,420,-3,-53,-13,-12,-4,4,0,-1,5,4,-1,2,1,-3,5,2,-3,3,0,-2,-17,-132,-3,-5,8,-4,0,-2,-1,-1,-1,-1,6,-1
KR_6760832333,420,1,-16,16,1,-6,6,0,0,4,4,5,1,6,3,3,6,-1,1,0,-1,10,2,-1,-3,4,1,0,-1,1,-1,-1,1,5,-1
KR_6764114695,420,-4,-100,-24,-11,-5,6,1,-3,3,0,-4,5,1,1,0,1,0,0,0,0,-2,117,1,-5,4,1,0,-2,-1,1,-1,-1,5,-1
KR_6755279976,420,-2,-1,-8,1,2,0,2,0,3,3,-3,3,0,2,1,3,0,0,0,0,6,-34,-1,-5,6,4,0,0,-1,-1,1,-1,4,-1
KR_6712486703,420,-6,-43,-38,-17,1,1,2,-3,5,2,-5,6,1,-5,5,0,-5,5,0,0,-14,-39,0,-6,6,10,0,-3,-1,-1,-1,-1,3,-1
KR_6763799700,420,-4,40,-12,-7,4,0,4,0,6,6,-1,2,1,-6,6,0,-4,5,1,1,-5,-1,6,-7,1,-3,0,0,-1,1,-1,1,5,-1
KR_6758553239,420,-2,-8,-32,-11,-1,1,0,-6,7,1,-3,4,1,-1,3,2,0,0,0,0,-11,75,-5,-3,8,-1,0,-2,-1,-1,-1,-1,6,-1
KR_6753400323,420,0,23,16,3,-1,2,1,4,0,4,-2,4,2,1,3,4,1,0,1,0,2,-5,-1,-4,5,0,0,0,-1,1,0,1,4,-1
KR_6740420314,420,-1,-5,-21,-8,-3,5,2,1,2,3,-4,5,1,1,3,4,-3,4,1,-1,-7,-120,4,-6,2,-1,0,-1,-1,1,-1,-1,3,-1
KR_6748889008,420,-1,18,-13,-1,0,1,1,1,1,2,2,1,3,-3,3,0,-1,2,1,0,-7,-8,2,-6,4,-2,0,-1,-1,-1,-1,-1,1,-1
KR_6744593188,420,-4,-72,-5,-11,-2,3,1,-5,7,2,3,5,8,-6,6,0,-1,2,1,0,-15,-17,1,-6,5,-5,0,-1,-1,1,-1,-1,6,-1
KR_6745226974,420,-4,-13,-11,-7,0,1,1,-4,5,1,2,1,3,-5,5,0,0,0,0,1,-9,0,-5,-3,8,0,0,-1,1,-1,-1,1,3,-1
KR_6762942188,420,4,-45,43,8,-3,3,0,8,2,10,2,0,2,2,3,5,-1,1,0,0,2,-20,5,-9,4,3,0,0,1,1,0,1,3,-1
KR_6763613738,420,1,-18,4,-6,-6,7,1,2,3,5,-1,1,0,-4,5,1,3,0,3,0,-7,5,-5,-4,9,5,0,1,1,-1,1,1,2,-1
KR_6475196239,420,-8,-74,-22,-17,-4,8,4,1,1,2,-8,9,1,-4,5,1,-2,3,1,0,-13,-10,-6,-2,8,0,0,-3,-1,-1,-1,-1,1,-1
KR_6751241178,420,-1,7,16,-1,-1,1,0,1,3,4,-2,3,1,0,4,4,1,2,3,0,-3,-42,-3,-4,7,4,0,-1,1,-1,-1,1,2,-1
KR_6651744711,420,-1,18,7,-6,-3,4,1,1,1,2,0,2,2,-2,4,2,-2,2,0,0,-2,53,-11,0,11,-1,0,-2,-1,-1,-1,-1,6,-1
KR_6720898834,420,5,76,28,14,-2,3,1,5,2,7,5,4,9,4,1,5,2,4,6,0,8,-52,2,-7,5,20,0,-1,-1,1,1,1,6,-1
KR_6760946980,420,-3,-87,8,-8,-1,2,1,-1,4,3,-2,5,3,-5,9,4,1,1,2,-3,-15,4,-2,-2,4,-1,0,0,-1,1,-1,-1,2,-1
KR_6662953626,420,1,-26,0,0,1,1,2,3,0,3,0,1,1,-2,5,3,-2,4,2,0,4,30,0,-7,7,0,0,-1,-1,-1,-1,-1,5,-1
KR_6628630360,420,-6,-26,-20,-5,-5,5,0,1,3,4,-2,3,1,-1,2,1,2,0,2,0,7,-147,-4,-2,6,-5,0,0,-1,-1,0,-1,4,-1
KR_6719679827,440,-3,-57,-16,-13,0,2,2,0,2,2,-3,5,2,-8,9,1,-2,3,1,-1,-10,-16,1,-6,5,-1,0,-2,-1,-1,-1,-1,5,-1
KR_6754341469,420,-4,-56,-22,-10,-1,1,0,-1,4,3,0,0,0,-2,4,2,-6,6,0,0,-8,-52,0,-3,3,13,0,-2,1,-1,-1,-1,5,-1
KR_6759617860,420,-1,9,7,0,-2,2,0,1,2,3,-3,4,1,0,0,0,4,1,5,3,8,7,4,-7,3,1,0,0,-1,-1,0,1,1,-1
KR_6684840353,420,-2,-82,0,-8,-1,2,1,-5,5,0,3,4,7,-4,5,1,-1,2,1,0,3,-2,1,-8,7,0,0,-3,1,-1,-1,-1,3,-1
KR_6747127631,420,2,35,22,0,5,0,5,0,2,2,-5,6,1,0,2,2,0,3,3,0,-1,16,5,-7,2,-3,0,1,-1,1,1,-1,3,-1
KR_6623155796,440,-5,-69,24,-22,-5,6,1,-5,5,0,-5,6,1,-6,7,1,-1,2,1,-2,-24,-320,-4,-3,7,-1,0,-2,-1,-1,-1,-1,1,-1
KR_6702807784,420,2,-21,-16,-1,-4,5,1,3,0,3,4,1,5,-3,3,0,-1,2,1,0,-7,1,1,-5,4,1,0,-2,1,-1,-1,1,5,-1
KR_6648463903,420,-3,-50,6,-7,-1,4,3,-2,7,5,-1,4,3,-2,2,0,-1,1,0,0,1,-2,0,-6,6,-3,0,-1,-1,-1,-1,-1,4,-1
KR_6759909262,420,1,-16,24,9,-1,2,1,1,5,6,-4,4,0,11,0,11,2,1,3,0,11,10,0,-4,4,-1,0,-3,0,-1,-1,1,0,-1
KR_6758815342,420,0,-15,15,1,1,1,2,-1,2,1,1,2,3,-1,2,1,1,0,1,0,-2,13,-2,-6,8,0,0,-1,1,1,-1,-1,3,-1
KR_6661558795,420,-4,-27,-2,-12,0,0,0,-6,8,2,0,1,1,-6,7,1,0,0,0,-1,-16,8,-11,-3,14,5,0,-1,-1,0,-1,-1,2,-1
KR_6415566044,420,-3,-10,-4,-7,-3,4,1,0,1,1,-3,5,2,-3,3,0,2,0,2,0,-8,-58,1,-4,3,-1,0,-2,-1,1,-1,-1,3,-1
KR_6742159550,420,-4,-39,28,-14,-6,6,0,0,1,1,4,2,6,-10,11,1,-2,4,2,0,-14,39,3,-6,3,-20,0,-2,0,-1,-1,1,0,-1
KR_6683141436,420,0,31,-23,5,1,0,1,4,1,5,5,1,6,-5,8,3,0,0,0,2,2,1,0,-5,5,-4,0,1,-1,1,1,1,1,-1
KR_6718943980,440,-1,-33,-6,-12,-1,2,1,3,3,6,-6,6,0,-4,6,2,-4,4,0,0,-15,-61,-1,-2,3,-3,0,0,-1,1,-1,-1,2,-1
KR_6724911241,440,-3,42,4,-6,-3,4,1,-3,3,0,-1,2,1,-2,4,2,3,1,4,1,-8,0,-2,-3,5,5,0,0,1,-1,-1,1,1,-1
KR_6720306211,420,1,-14,4,1,2,1,3,1,0,1,-1,3,2,-1,4,3,0,0,0,0,1,33,4,-9,5,-1,0,0,1,-1,0,-1,2,-1
KR_6724799635,420,-5,-62,15,-14,-5,5,0,-3,7,4,-4,4,0,-6,6,0,4,1,5,-1,-15,7,-6,-3,9,-2,0,-1,-1,-1,-1,-1,2,-1
KR_6760994642,440,1,-21,0,-5,-3,5,2,-2,6,4,-1,3,2,1,1,2,0,1,1,1,-13,-1,-3,-2,5,-1,0,-1,-1,0,-1,1,2,-1
KR_6747820497,420,2,45,0,7,0,3,3,1,2,3,0,0,0,3,0,3,3,0,3,0,9,1,0,-5,5,2,0,0,1,1,0,1,3,-1
KR_6691820229,420,-6,-43,-6,-11,1,0,1,-1,3,2,-2,2,0,-7,8,1,-2,3,1,0,-16,-1,-1,-2,3,-2,0,-2,-1,1,-1,-1,4,-1
KR_6752108459,420,-3,-64,-14,-6,0,3,3,-1,5,4,0,1,1,-4,4,0,-1,1,0,0,-4,-4,0,-4,4,-1,0,-1,1,-1,-1,-1,4,-1
KR_6760533826,420,1,61,-6,-6,-1,3,2,0,3,3,-6,6,0,0,4,4,1,1,2,0,-3,-27,0,-6,6,3,0,1,-1,-1,-1,1,6,-1
KR_6758718073,420,-7,-71,-40,-16,-7,9,2,0,1,1,-7,8,1,0,0,0,-2,2,0,1,-8,-24,5,-7,2,-4,0,-2,-1,-1,-1,1,4,-1
KR_6657759594,420,-4,-47,-56,-1,-2,3,1,-3,4,1,1,0,1,3,1,4,0,1,1,0,1,49,-2,-5,7,-2,0,-3,-1,-1,-1,-1,4,-1
KR_6765020704,420,-4,-38,12,-8,-2,3,1,-2,3,1,-5,7,2,1,0,1,0,0,0,0,-7,3,1,-5,4,-4,0,-2,1,-1,-1,-1,5,-1
KR_6702452183,420,0,-86,1,0,-5,5,0,-1,4,3,1,1,2,4,0,4,1,1,2,0,-1,-8,3,-10,7,1,0,-1,-1,1,-1,1,6,-1
KR_6730028691,420,-3,-82,-46,-6,1,2,3,-1,4,3,-1,2,1,-5,6,1,0,0,0,1,-7,3,5,-9,4,-7,0,-1,-1,1,-1,1,6,-1
KR_6677429268,420,-3,8,-20,-8,-2,2,0,-1,4,3,-5,5,0,-1,2,1,1,2,3,0,-8,-3,1,-2,1,-1,0,0,-1,-1,-1,-1,2,-1
KR_6762914386,420,-3,-25,32,-3,-2,2,0,0,2,2,1,1,2,-2,4,2,0,1,1,0,-4,-3,1,-4,3,2,0,0,1,-1,-1,-1,3,-1
KR_6755090712,420,2,62,29,8,8,1,9,2,0,2,2,1,3,-4,8,4,0,1,1,0,8,6,2,-7,5,-3,0,1,1,1,1,1,6,-1
KR_6670109639,420,-2,-14,-1,-3,3,0,3,-1,3,2,-3,4,1,-2,2,0,0,1,1,-2,-3,-31,2,-7,5,-3,0,-2,1,1,-1,-1,3,-1
KR_6764051084,420,1,-28,-16,1,0,2,2,1,0,1,-2,4,2,5,3,8,-3,4,1,0,0,-14,-2,-7,9,3,0,0,1,1,0,-1,2,-1
KR_6741760772,420,0,5,10,0,-2,2,0,0,3,3,0,1,1,4,1,5,-2,2,0,0,-3,-2,1,-5,4,2,0,1,-1,1,1,-1,6,-1
KR_6687052755,440,1,17,-31,-2,4,1,5,-3,5,2,1,0,1,-4,4,0,0,0,0,0,-11,7,-3,-5,8,3,0,-1,1,1,-1,-1,4,-1
KR_6762484893,420,1,7,0,1,-4,7,3,11,0,11,-6,6,0,0,2,2,0,0,0,0,4,-130,-3,-6,9,5,0,0,-1,-1,-1,-1,5,-1
KR_6761331959,420,-1,-27,1,-3,-2,2,0,-1,4,3,-5,7,2,4,1,5,1,0,1,0,3,8,8,-10,2,-3,0,-1,-1,-1,1,1,1,-1
KR_6713035886,420,-1,-53,-24,2,0,2,2,0,2,2,4,0,4,-1,2,1,-1,2,1,0,9,-9,-3,-5,8,0,0,1,1,-1,1,-1,6,-1
KR_6749899563,420,0,-16,-33,0,4,1,5,0,1,1,-7,8,1,2,1,3,1,0,1,0,2,-11,-9,-2,11,5,0,0,-1,-1,0,-1,1,-1
KR_6608930523,420,-1,-43,14,4,-3,5,2,1,1,2,0,2,2,5,1,6,1,1,2,1,14,-118,-3,-5,8,0,0,-1,1,-1,-1,1,4,-1
KR_6763194742,420,-3,-34,-29,2,-3,3,0,4,2,6,-2,4,2,1,3,4,2,1,3,0,6,77,-4,-4,8,4,0,-1,-1,1,-1,-1,2,-1
KR_6561905813,440,-5,-89,-34,-9,-1,1,0,-1,2,1,0,2,2,-5,6,1,-2,3,1,0,-3,-5,-4,0,4,-3,0,-1,-1,0,-1,-1,2,-1
KR_6754203015,420,-2,-9,-20,0,2,0,2,2,3,5,0,2,2,-2,7,5,-2,4,2,0,3,-38,2,-4,2,17,0,0,-1,-1,-1,-1,6,-1
KR_6754323115,420,-2,19,3,-3,-7,7,0,0,2,2,-1,3,2,4,1,5,1,0,1,0,-3,-23,-6,-2,8,7,0,0,-1,1,1,-1,1,-1
KR_6756341658,420,4,15,-23,6,3,4,7,4,3,7,0,3,3,1,5,6,-2,4,2,1,-3,-27,-1,-4,5,0,0,0,-1,1,1,1,6,-1
KR_6712327961,420,0,4,-5,-5,-1,1,0,0,1,1,-5,6,1,0,1,1,1,1,2,0,-3,-7,-5,-3,8,-1,0,0,-1,-1,-1,1,6,-1
KR_6391163897,420,-1,23,16,-4,1,0,1,4,3,7,2,2,4,-7,8,1,-4,4,0,0,-5,5,-4,-2,6,-3,0,1,-1,1,1,-1,6,-1
KR_6759383382,420,-3,-76,10,-8,-1,2,1,-1,1,0,-5,5,0,1,1,2,-2,2,0,0,-5,17,6,-9,3,-5,0,-2,-1,1,-1,-1,2,-1
KR_6742352922,420,-4,-80,28,-12,0,2,2,-2,3,1,-1,2,1,-6,6,0,-3,3,0,0,-13,-2,-2,-4,6,-1,0,-3,1,-1,-1,-1,3,-1
KR_6760237380,420,3,52,34,1,-1,2,1,-3,4,1,4,1,5,2,1,3,-1,3,2,0,-2,-2,0,-3,3,4,0,-1,1,-1,-1,-1,1,-1
KR_6749640790,420,0,14,-4,6,0,2,2,0,2,2,2,0,2,5,0,5,-1,2,1,1,12,0,6,-8,2,-1,0,1,-1,1,1,1,2,-1
KR_6761621723,420,-3,-13,-4,-10,-3,3,0,-1,4,3,-3,3,0,-1,2,1,-2,2,0,0,-8,102,-4,-4,8,-1,0,0,1,-1,1,-1,2,-1
KR_6715069847,420,0,-14,40,3,0,1,1,-1,4,3,-2,2,0,-2,4,2,8,0,8,0,-5,-32,-2,-4,6,9,0,0,1,-1,0,-1,5,-1
KR_6660291320,420,0,14,-12,2,0,3,3,2,8,10,1,0,1,0,4,4,-1,2,1,-2,-6,1,3,-5,2,-1,0,-2,0,0,-1,-1,0,-1
KR_6695638297,420,2,-51,12,5,1,1,2,2,2,4,6,0,6,-3,3,0,-1,2,1,1,5,12,3,-6,3,1,0,0,1,1,0,1,2,-1
KR_6754017877,420,-6,11,-26,-12,0,3,3,-4,4,0,-2,3,1,-3,3,0,-3,4,1,1,-10,-135,0,-5,5,-1,0,-3,-1,-1,-1,1,6,-1
KR_6740997678,420,-6,-26,-41,-7,0,1,1,2,2,4,-10,10,0,-3,4,1,4,1,5,1,-3,-14,-1,-6,7,5,0,0,-1,-1,-1,1,1,-1
KR_6764504723,420,1,28,15,4,-3,4,1,0,2,2,1,2,3,4,1,5,2,4,6,1,7,2,-2,-6,8,-2,0,-1,1,1,-1,1,5,-1
KR_6761610122,420,3,14,16,6,6,0,6,-2,4,2,1,2,3,0,3,3,1,1,2,-1,-7,-30,-2,-3,5,7,0,2,1,1,1,-1,6,-1
KR_6762699862,420,-1,-15,3,-3,1,0,1,-3,4,1,-2,2,0,-1,2,1,2,0,2,0,2,25,-1,-6,7,-2,0,0,-1,1,-1,1,1,-1
KR_6757449278,420,0,30,-17,-4,-1,2,1,-1,3,2,0,1,1,-1,2,1,-1,1,0,0,-2,5,1,-8,7,-2,0,0,-1,1,0,-1,5,-1
KR_6755441017,420,-5,-25,-27,-12,-1,1,0,-2,3,1,-1,5,4,-3,4,1,-5,7,2,0,-11,-327,3,-10,7,-9,0,-1,0,-1,-1,-1,0,-1
KR_6745217730,420,-2,48,-8,-1,1,0,1,-3,3,0,0,2,2,3,4,7,-2,2,0,0,2,-3,-7,-4,11,2,0,-2,-1,-1,-1,1,3,-1
KR_6744606090,420,0,-17,-10,-1,-3,3,0,-2,3,1,-1,1,0,5,1,6,0,0,0,-1,3,-42,-3,-7,10,2,0,0,1,-1,1,-1,3,-1
KR_6756969828,420,-4,-48,-32,-11,-2,2,0,-2,4,2,-1,1,0,-8,10,2,2,0,2,0,-10,14,-5,-6,11,5,0,-2,-1,-1,-1,-1,1,-1
KR_6729046493,420,-2,-25,-16,-5,-1,2,1,2,1,3,-7,7,0,3,1,4,-2,2,0,0,-2,1,0,-2,2,4,0,-1,1,-1,-1,-1,5,-1
KR_6711271235,420,-1,-18,13,-11,-7,9,2,-1,3,2,-1,2,1,-1,2,1,-1,1,0,-1,-4,-5,0,-6,6,-6,0,0,-1,-1,0,-1,6,-1
KR_6697421394,420,4,29,9,7,-2,3,1,7,1,8,-3,4,1,1,1,2,4,1,5,0,6,4,-2,-4,6,1,0,0,1,-1,0,-1,3,-1
KR_6742676789,420,-1,-18,13,-1,0,0,0,2,1,3,4,0,4,-6,7,1,-1,1,0,0,4,0,4,-5,1,1,0,-1,-1,-1,-1,-1,1,-1
KR_6751299836,420,-1,-23,-12,-4,0,1,1,-1,5,4,-3,3,0,-2,4,2,2,2,4,0,4,-4,1,-4,3,1,0,0,0,-1,0,1,0,-1
KR_6755747649,420,0,-101,-18,-4,3,0,3,-4,5,1,-3,6,3,0,0,0,0,3,3,0,-1,-4,-6,-1,7,-3,0,-2,-1,-1,-1,-1,1,-1
KR_6763731957,440,-4,-9,-25,-7,-3,5,2,2,2,4,-3,4,1,-2,3,1,-1,1,0,1,5,10,-2,-2,4,-2,0,-2,-1,-1,-1,1,5,-1
KR_6736620741,420,-3,-57,-8,-8,-3,3,0,-3,4,1,1,2,3,-4,4,0,1,0,1,-1,-12,100,0,-7,7,4,0,0,1,-1,-1,-1,6,-1
KR_6746514493,420,-3,-27,-5,-4,2,0,2,-5,6,1,0,4,4,-1,3,2,0,0,0,-1,-5,4,-4,-6,10,0,0,1,1,1,1,-1,1,-1
KR_6739066102,420,-1,15,6,-8,0,2,2,-4,6,2,-3,4,1,1,1,2,-2,4,2,0,-5,-3,0,-5,5,0,0,-2,1,-1,-1,1,6,-1
KR_6659046016,420,-7,-67,-22,-15,-6,6,0,-1,3,2,-3,4,1,-3,6,3,-2,2,0,0,-17,376,0,-2,2,1,0,-1,1,-1,-1,-1,1,-1
KR_6675051250,420,-4,-16,-16,-2,0,1,1,-2,4,2,-4,5,1,4,0,4,0,1,1,2,3,-81,1,-6,5,-2,0,0,-1,-1,-1,1,1,-1
KR_6762915428,420,-3,-19,-8,-9,-2,3,1,-4,6,2,-3,6,3,0,4,4,0,3,3,0,-9,-3,-7,-4,11,0,0,-2,-1,-1,-1,-1,4,-1
KR_6743105563,420,-7,-114,-35,-14,-5,5,0,1,3,4,-1,8,7,-2,7,5,-7,8,1,0,-12,37,-2,-4,6,-3,0,-1,-1,-1,-1,-1,2,-1
KR_6640015677,420,1,-28,13,0,1,1,2,-2,3,1,3,0,3,1,2,3,-3,3,0,0,-1,0,3,-9,6,0,0,0,1,-1,0,-1,3,-1
KR_6631392288,420,-4,-35,4,-11,-3,4,1,-2,3,1,-1,1,0,-2,5,3,-3,3,0,0,-8,9,-3,-4,7,1,0,-1,-1,-1,-1,-1,6,-1
KR_6762747944,420,-3,-76,4,-8,-3,3,0,0,5,5,-5,6,1,0,3,3,0,2,2,-2,-11,111,-4,-2,6,-5,0,-1,-1,-1,-1,-1,2,-1
KR_6714263512,440,-3,18,-24,-13,1,0,1,-6,7,1,-2,5,3,-2,3,1,-4,5,1,0,-15,7,-5,-4,9,-2,0,-1,-1,-1,-1,-1,1,-1
KR_6742228232,420,-1,53,-12,-13,-3,5,2,-5,7,2,4,0,4,-11,14,3,2,0,2,-1,-19,417,1,-5,4,7,0,-2,-1,-1,-1,1,1,-1
KR_6740624285,420,-1,40,-24,0,0,4,4,2,3,5,-1,2,1,-3,4,1,2,1,3,0,3,0,-2,-3,5,1,0,0,-1,1,0,-1,4,-1
KR_6697034856,420,-2,-3,14,0,-2,3,1,1,2,3,3,1,4,-2,2,0,0,1,1,-1,-6,6,0,-1,1,-2,0,1,-1,1,-1,-1,5,-1
KR_6758116257,420,1,88,7,-2,-1,2,1,-1,3,2,4,1,5,-4,5,1,0,0,0,0,-4,37,4,-6,2,-26,0,1,-1,0,1,-1,1,-1
KR_6727225876,420,-3,-2,-12,-8,-4,6,2,-2,7,5,-1,2,1,-2,5,3,1,2,3,0,-17,-6,0,-10,10,1,0,0,1,-1,1,-1,2,-1
KR_6753414891,420,0,-40,6,1,-5,6,1,2,5,7,2,1,3,2,1,3,0,1,1,0,3,-2,2,-5,3,1,0,0,-1,1,0,-1,3,-1
KR_6756309604,420,-2,-61,20,-13,-1,2,1,1,0,1,-6,6,0,-3,4,1,-4,4,0,0,-7,5,-1,-4,5,-3,0,-1,-1,-1,-1,-1,1,-1
KR_6761790756,440,-5,-48,0,-18,1,7,8,-12,13,1,-3,3,0,-1,2,1,-3,3,0,-1,-22,-33,1,-2,1,-3,0,-1,0,0,1,-1,0,-1
KR_6760309035,420,1,-66,-3,-5,-7,8,1,1,3,4,3,1,4,-1,4,3,-1,1,0,-1,-2,32,-5,0,5,0,0,0,1,-1,-1,-1,5,-1
KR_6747363091,420,-3,-25,-1,-2,-1,1,0,-2,3,1,0,2,2,1,1,2,0,1,1,-2,-6,3,7,-12,5,-6,0,1,-1,1,1,-1,4,-1
KR_6734973597,420,-3,9,-22,-2,3,2,5,-4,5,1,-1,1,0,-1,1,0,1,1,2,1,-3,-21,2,-6,4,-1,0,0,-1,-1,-1,1,5,-1
KR_6714052510,420,-1,-49,16,-5,-2,2,0,-2,5,3,-2,4,2,1,3,4,0,0,0,0,-5,31,-1,-4,5,-9,0,0,1,1,0,1,5,-1
KR_6758810377,420,-3,0,-13,-4,-3,5,2,0,3,3,-1,1,0,0,1,1,0,0,0,0,-4,4,3,-6,3,-1,0,0,1,-1,0,1,4,-1
KR_6762028300,420,-2,11,0,-2,-2,2,0,-2,4,2,1,2,3,1,3,4,0,1,1,0,-3,0,1,-5,4,-1,0,0,-1,1,-1,1,5,-1
KR_6635059866,420,-9,-78,-20,-17,-5,5,0,-2,2,0,-4,6,2,-5,7,2,-1,1,0,-2,-19,-8,0,-7,7,-4,0,-2,-1,-1,-1,-1,2,-1
KR_6741144565,420,-2,-14,-3,-11,-3,3,0,2,0,2,-5,8,3,-6,6,0,1,1,2,0,-13,-20,-4,-3,7,0,0,0,-1,0,0,-1,1,-1
KR_6727888495,440,-4,-30,-23,-7,-1,5,4,0,0,0,-1,1,0,-3,5,2,-2,3,1,0,-10,2,2,-6,4,1,0,-3,-1,-1,-1,1,5,-1
KR_6391794252,420,-2,-63,-7,0,1,1,2,1,2,3,-1,4,3,-1,8,7,0,4,4,0,2,-23,-2,-4,6,0,0,0,1,1,-1,-1,6,-1
KR_6438125021,420,-1,-4,5,-1,1,2,3,2,0,2,-2,5,3,-2,2,0,0,1,1,0,0,30,-2,-4,6,-7,0,1,1,-1,1,-1,5,-1
KR_6697238807,420,-3,-49,-16,-4,-2,2,0,-5,5,0,0,3,3,3,0,3,0,1,1,0,-6,-126,2,-8,6,-1,0,-2,0,-1,-1,-1,0,-1
KR_6757098389,440,0,43,14,6,0,3,3,0,4,4,1,2,3,1,1,2,4,0,4,-1,6,-4,-3,0,3,1,0,0,-1,-1,-1,-1,6,-1
KR_6737675817,420,-4,-30,1,-13,-3,4,1,-2,3,1,-5,5,0,-2,5,3,-1,1,0,0,-12,27,1,-4,3,-2,0,0,-1,1,0,1,5,-1
KR_6749134964,420,-2,-10,-39,-4,1,3,4,-2,4,2,-1,2,1,2,3,5,-4,8,4,1,-1,8,6,-9,3,-4,0,0,-1,-1,1,1,5,-1
KR_6755486367,420,-5,2,-6,-14,-3,4,1,-9,9,0,-3,3,0,-1,2,1,2,1,3,0,-10,-6,-2,-8,10,-4,0,-1,1,-1,-1,1,3,-1
KR_6622248254,420,-4,20,-33,-11,-1,2,1,-2,5,3,-1,3,2,-4,6,2,-3,4,1,2,-16,-1,1,-5,4,-4,0,-4,-1,-1,-1,1,5,-1
KR_6740073713,420,1,-8,0,2,1,1,2,1,2,3,0,4,4,1,0,1,-1,2,1,0,4,4,0,-6,6,-2,0,-1,1,-1,-1,1,6,-1
KR_6763608880,420,0,1,-27,-2,5,1,6,-1,2,1,-1,4,3,-5,7,2,0,0,0,0,-3,3,0,-8,8,2,0,1,-1,1,1,-1,3,-1
KR_6762997414,420,-1,28,-5,-1,3,0,3,-4,4,0,0,1,1,0,5,5,0,1,1,0,-5,-5,-1,-4,5,-1,0,0,1,1,1,-1,3,-1
KR_6760814780,420,-2,27,-21,-5,2,1,3,-2,6,4,0,2,2,-3,3,0,-2,2,0,-1,-7,-3,4,-6,2,-7,0,-1,-1,-1,-1,-1,4,-1
KR_6753276730,420,-3,-53,17,-5,-2,2,0,-3,3,0,4,0,4,-1,1,0,-3,4,1,0,-2,22,-1,-5,6,0,0,-1,1,1,-1,-1,6,-1
KR_6758241054,440,1,-26,24,-2,-3,3,0,1,1,2,3,2,5,0,2,2,-3,3,0,0,7,28,-6,-5,11,-20,0,0,1,-1,0,-1,3,-1
KR_6713211367,420,1,-4,9,-1,1,1,2,0,4,4,-4,5,1,2,2,4,0,0,0,-1,-7,342,2,-3,1,-2,0,0,1,1,0,-1,1,-1
KR_6704148640,420,-6,-56,-48,-15,-2,2,0,-2,3,1,-8,8,0,-5,8,3,2,0,2,-1,-15,-12,-2,-3,5,-4,0,-2,-1,-1,-1,-1,6,-1
KR_6749780189,420,1,93,-13,2,4,1,5,0,4,4,1,1,2,0,1,1,-3,5,2,0,-5,-5,-3,-5,8,5,0,2,1,-1,1,1,3,-1
KR_6756795551,420,3,25,23,2,1,2,3,-2,6,4,2,0,2,1,1,2,0,0,0,0,-1,-13,-3,-4,7,0,0,1,-1,-1,1,1,5,-1
KR_6728749453,440,-3,-16,-10,-8,-12,12,0,-2,3,1,2,0,2,3,3,6,1,4,5,1,-11,-285,-1,-5,6,0,0,-1,-1,0,-1,1,3,-1
KR_6723011978,420,-3,14,-12,-8,-3,4,1,-1,1,0,5,1,6,-7,13,6,-2,2,0,0,-7,-29,5,-9,4,-6,0,0,1,-1,-1,-1,6,-1
KR_6746325306,420,5,32,6,10,6,0,6,5,1,6,0,1,1,0,1,1,-1,3,2,0,8,11,-2,-4,6,1,0,0,1,1,0,-1,5,-1
KR_6709313237,420,-5,-57,24,-12,-8,9,1,-1,4,3,0,1,1,-3,4,1,0,1,1,0,-5,-201,-2,-5,7,-1,0,-1,0,1,-1,-1,0,-1
KR_6699868573,420,1,21,4,0,2,1,3,-4,4,0,0,3,3,1,1,2,1,1,2,0,-3,-4,-6,-2,8,4,0,-2,-1,-1,-1,1,4,-1
KR_6754655145,420,1,-28,-23,-1,-2,3,1,0,4,4,0,1,1,-1,5,4,2,0,2,0,6,426,-4,-4,8,1,0,0,1,-1,0,-1,6,-1
KR_6753661413,420,1,5,-6,7,2,0,2,2,2,4,4,1,5,-2,3,1,1,1,2,0,8,-15,2,-4,2,2,0,1,-1,1,1,1,4,-1
KR_6658480761,420,-1,1,-17,3,-2,5,3,2,3,5,-4,5,1,5,3,8,2,0,2,0,9,24,5,-10,5,1,0,1,-1,1,1,1,4,-1
KR_6741498025,420,0,-47,-16,1,-3,3,0,-3,6,3,1,1,2,6,0,6,0,2,2,-1,2,-16,-2,-4,6,5,0,-1,1,-1,-1,-1,1,-1
KR_6707967811,420,0,31,22,1,-2,2,0,-1,3,2,-1,3,2,5,1,6,0,0,0,0,2,100,-1,-5,6,-1,0,1,1,1,1,-1,5,-1
KR_6242344005,440,-2,-28,-20,-6,-5,5,0,-6,9,3,6,0,6,1,2,3,-2,3,1,0,-9,2,-1,-3,4,0,0,0,-1,1,0,1,3,-1
KR_6752537411,420,-4,-89,13,-10,2,1,3,-12,12,0,-2,3,1,0,1,1,2,2,4,0,-11,-19,-3,-1,4,-2,0,-2,-1,-1,-1,-1,5,-1
KR_6684062585,420,2,24,6,-1,1,2,3,2,1,3,0,1,1,-3,7,4,-1,3,2,0,-5,51,-2,-3,5,-23,0,1,1,-1,1,-1,2,-1
KR_6721736777,420,-6,-46,-21,-17,-3,3,0,-2,2,0,-5,5,0,-4,5,1,-3,3,0,0,-13,-8,0,-4,4,-2,0,-2,-1,-1,-1,1,3,-1
KR_6704402044,420,-1,-3,-28,0,2,0,2,-2,2,0,0,3,3,3,1,4,-3,3,0,0,5,8,-1,-6,7,-5,0,-1,1,-1,-1,-1,6,-1
KR_6756854671,440,2,44,5,1,2,0,2,-1,2,1,-7,8,1,5,0,5,2,1,3,0,-1,-2,-5,-1,6,-2,0,1,-1,1,1,-1,3,-1
KR_6740195459,420,-1,-54,11,-7,-2,2,0,-6,7,1,-3,4,1,4,1,5,0,2,2,-1,-10,1,-3,-3,6,-1,0,-1,1,-1,1,-1,1,-1
KR_6741366458,420,-2,-43,-22,-8,2,0,2,0,1,1,-6,6,0,-4,6,2,0,1,1,1,-6,10,-3,-4,7,0,0,0,-1,-1,1,1,5,-1
KR_6621829472,420,-7,-33,-52,-14,-3,4,1,-1,3,2,-3,5,2,-6,7,1,-1,4,3,0,-18,-6,3,-4,1,0,0,-3,1,-1,-1,1,6,-1
KR_6747080014,420,-2,-14,-19,-1,1,0,1,0,1,1,1,1,2,-2,6,4,-1,2,1,0,1,8,3,-7,4,-1,0,-1,-1,1,-1,-1,4,-1
KR_6755697677,420,-1,-23,9,0,-1,3,2,-3,6,3,3,0,3,1,2,3,0,1,1,0,1,6,2,-4,2,-4,0,0,1,-1,1,-1,1,-1
KR_6762953601,420,-2,65,16,-4,1,0,1,0,2,2,-3,4,1,-3,3,0,1,0,1,0,-7,-37,-2,-1,3,0,0,1,-1,1,1,-1,1,-1
KR_6748355629,420,-2,30,-4,-2,-1,2,1,0,2,2,-5,8,3,3,2,5,1,3,4,-2,-6,3,1,-8,7,1,0,0,-1,1,1,-1,6,-1
KR_6672051660,420,-6,-68,4,-14,-7,8,1,-4,8,4,-3,4,1,0,3,3,0,0,0,0,-7,-2,-2,-4,6,-3,0,-2,1,-1,-1,1,5,-1
KR_6712285295,420,-4,-48,-32,-5,3,2,5,-3,4,1,-2,4,2,-1,1,0,-2,2,0,0,-10,107,-6,-3,9,4,0,0,-1,-1,-1,-1,2,-1
KR_6612164468,420,-4,-72,3,-10,0,1,1,1,1,2,-7,8,1,-2,3,1,-2,2,0,0,-9,-96,-4,-3,7,-5,0,-3,-1,-1,-1,-1,2,-1
KR_6698624640,420,-3,-38,-23,-8,-4,4,0,1,3,4,-3,4,1,-3,3,0,1,0,1,0,1,-52,-5,-1,6,20,0,-1,-1,-1,-1,-1,1,-1
KR_6733994311,420,-1,6,28,-1,2,0,2,-5,5,0,1,1,2,-1,1,0,2,0,2,0,-9,32,1,-6,5,3,0,0,1,1,0,1,1,-1
KR_6764617318,420,2,-20,15,2,7,0,7,3,1,4,-2,4,2,-5,6,1,-1,1,0,0,-9,35,-3,-2,5,-3,0,2,1,1,1,-1,4,-1
KR_6613136502,420,0,-2,-17,6,0,0,0,8,2,10,-5,5,0,1,1,2,2,0,2,-1,5,26,3,-11,8,-1,0,0,1,0,0,-1,2,-1
KR_6764962845,420,0,33,-23,7,2,2,4,-2,3,1,1,1,2,5,2,7,1,2,3,2,8,-8,1,-7,6,3,0,1,0,-1,1,1,0,-1
KR_6744121288,420,-2,-103,-28,2,5,0,5,-7,10,3,7,2,9,-4,6,2,1,1,2,3,-2,9,3,-10,7,2,0,-4,-1,1,-1,1,6,-1
KR_6764744607,420,-8,-65,-23,-9,-2,2,0,-4,4,0,-4,7,3,0,1,1,1,0,1,0,-9,6,-2,-6,8,-2,0,0,-1,-1,-1,-1,5,-1
KR_6756497209,420,0,10,-11,1,0,2,2,0,2,2,2,1,3,-1,1,0,0,0,0,0,2,32,0,-4,4,-3,0,0,1,-1,1,-1,5,-1
KR_6730136421,420,-2,-15,4,-5,-1,2,1,-2,3,1,-2,4,2,-2,5,3,2,2,4,0,-1,-3,-2,-3,5,-2,0,0,-1,0,-1,-1,6,-1
KR_6748337113,420,1,-33,-4,0,0,2,2,1,1,2,-3,4,1,2,1,3,0,0,0,0,-1,-24,1,-7,6,2,0,0,-1,1,0,1,3,-1
KR_6763250114,440,-2,-18,-12,0,-1,2,1,-3,5,2,2,0,2,4,0,4,-2,2,0,-1,-8,-138,-7,-4,11,7,0,0,1,1,0,-1,2,-1
KR_6719768070,440,-1,3,12,-1,2,3,5,1,2,3,-2,5,3,-2,4,2,0,0,0,0,4,23,-7,-3,10,2,0,1,0,1,1,-1,0,-1
KR_6722275388,420,-2,-48,-15,-4,-2,4,2,3,0,3,2,4,6,-5,6,1,-2,2,0,1,-4,-2,-1,-5,6,-2,0,-1,-1,1,-1,1,1,-1
KR_6745606273,420,-9,-123,-5,-24,-10,11,1,-6,6,0,-7,10,3,-1,3,2,0,1,1,0,-26,6,-2,-3,5,-4,0,-3,-1,-1,-1,-1,3,-1
KR_6730584981,420,0,-28,-16,2,1,1,2,2,3,5,1,1,2,-3,4,1,1,0,1,0,7,-3,1,-7,6,-3,0,0,-1,1,1,-1,5,-1
KR_6745044050,420,-1,-24,-32,-1,2,0,2,1,2,3,-1,2,1,0,1,1,-3,3,0,0,3,6,0,-7,7,-6,0,1,1,-1,1,1,1,-1
KR_6702612092,440,0,17,15,3,2,2,4,1,4,5,-2,3,1,1,2,3,1,0,1,-1,10,-36,-3,-7,10,2,0,0,-1,1,0,-1,6,-1
KR_6731406464,420,-2,-27,-12,-2,-3,3,0,-1,4,3,1,1,2,1,2,3,0,0,0,0,2,1,-1,-7,8,-3,0,0,-1,-1,0,-1,4,-1
KR_6758070561,420,-1,-58,-12,0,3,2,5,0,1,1,-1,3,2,-3,3,0,1,1,2,0,-7,-26,-1,-5,6,-2,0,0,-1,1,-1,1,4,-1
KR_6761791293,420,3,17,31,10,-1,2,1,2,1,3,3,3,6,4,0,4,2,0,2,0,16,21,8,-10,2,-2,0,0,-1,-1,1,-1,3,-1
KR_6740077218,420,0,40,-1,-3,1,3,4,-2,3,1,-6,7,1,4,1,5,0,0,0,0,2,-6,-1,-4,5,1,0,1,-1,1,1,-1,4,-1
KR_6688632269,420,-1,13,-12,2,0,2,2,-3,5,2,2,2,4,3,1,4,0,1,1,2,3,-11,2,-7,5,0,0,-1,1,-1,-1,1,6,-1
KR_6758310390,420,-5,46,-48,-15,-2,6,4,-1,3,2,-3,4,1,-6,7,1,-3,3,0,0,-15,-4,2,-4,2,2,0,0,0,0,1,1,0,-1
KR_6741241561,420,-3,-24,12,-5,-3,4,1,-8,9,1,3,5,8,3,0,3,0,0,0,0,-5,1,7,-7,0,-2,0,-1,-1,1,-1,1,6,-1
KR_6750669809,420,0,31,-33,3,2,3,5,3,0,3,1,1,2,-1,5,4,-2,2,0,0,-6,4,8,-12,4,-2,0,-1,-1,-1,-1,-1,6,-1
KR_6757031933,420,-4,-48,-24,-2,-5,6,1,1,2,3,-1,3,2,3,5,8,0,0,0,1,8,-37,-2,-4,6,13,0,-1,1,-1,-1,-1,1,-1
KR_6755374864,420,-1,-60,-1,-2,-2,3,1,2,3,5,0,2,2,-3,4,1,1,1,2,0,1,-6,-1,-6,7,-1,0,0,1,1,0,-1,4,-1
KR_6706594579,420,-1,-3,12,-2,-1,4,3,-3,7,4,-1,2,1,1,1,2,2,0,2,-2,-8,-5,-2,-6,8,-1,0,0,1,-1,0,-1,2,-1
KR_6756199050,420,-5,-104,-3,-10,-3,5,2,0,1,1,-2,2,0,0,2,2,-5,5,0,-3,-12,13,2,-6,4,2,0,-2,-1,1,-1,-1,3,-1
KR_6764888329,420,-5,-41,2,-12,3,2,5,-5,5,0,-8,10,2,-2,3,1,0,0,0,0,-8,11,3,-6,3,-2,0,-2,1,-1,-1,-1,4,-1
KR_6762343482,420,-2,17,2,-1,2,0,2,0,2,2,-1,3,2,0,3,3,-2,2,0,0,-3,11,4,-6,2,1,0,-1,-1,1,-1,-1,4,-1
KR_6758985276,440,-1,-19,3,-5,1,0,1,-4,5,1,-2,6,4,-2,7,5,2,0,2,0,-7,-12,-5,0,5,2,0,-1,-1,0,-1,-1,4,-1
KR_6761692785,420,1,-25,19,-1,1,0,1,3,4,7,3,3,6,-3,5,2,-5,6,1,-2,-12,-9,-1,-6,7,5,0,0,1,-1,0,-1,5,-1
KR_6758667339,440,3,40,-37,7,5,3,8,1,1,2,-5,7,2,4,0,4,2,1,3,0,-2,8,1,-3,2,0,0,0,1,1,1,1,5,-1
KR_6711012050,420,2,-2,-14,4,2,0,2,2,2,4,1,3,4,-2,4,2,1,1,2,-2,-2,-28,2,-8,6,20,0,1,1,1,-1,-1,1,-1
KR_6751708144,440,1,-21,20,1,-4,6,2,0,2,2,4,2,6,-1,2,1,2,2,4,-2,3,-233,1,-5,4,1,0,0,1,1,0,-1,1,-1
KR_6727590714,440,-1,-65,8,-4,-3,3,0,2,1,3,-2,7,5,-1,3,2,0,4,4,-1,3,-5,6,-9,3,-1,0,0,1,-1,-1,-1,6,-1
KR_6763392876,420,-2,2,-25,-6,-1,2,1,0,5,5,-5,5,0,0,4,4,0,2,2,-1,-6,-9,-3,-6,9,4,0,-1,-1,-1,-1,-1,5,-1
KR_6679441754,420,0,3,-10,-5,-1,3,2,-3,6,3,1,3,4,-1,2,1,-1,1,0,0,-3,-5,-5,-4,9,2,0,0,-1,-1,-1,1,1,-1
KR_6764595128,420,-2,10,-12,-1,2,2,4,3,2,5,-3,3,0,-4,8,4,1,0,1,0,-2,11,4,-8,4,1,0,-1,1,-1,1,1,2,-1
KR_6761787783,420,-2,-70,1,-1,-1,3,2,-4,8,4,8,5,13,-6,6,0,2,0,2,-2,4,-3,-5,-4,9,5,0,-1,1,-1,-1,-1,2,-1
KR_6626972790,420,-7,-27,-15,-20,-3,3,0,-1,4,3,-4,6,2,-8,8,0,-4,5,1,0,-14,-8,-1,-6,7,-3,0,-1,1,-1,-1,-1,3,-1
KR_6741552830,420,-3,-60,-19,-6,-1,2,1,-1,3,2,-3,3,0,-2,5,3,1,0,1,0,-15,28,-1,-6,7,-1,0,1,1,1,1,-1,5,-1
KR_6339243871,420,-1,-12,15,-4,-3,3,0,2,3,5,-2,3,1,-1,1,0,0,0,0,0,-10,-15,-3,-4,7,-1,0,0,1,-1,0,1,1,-1
KR_6741496208,420,1,26,0,6,5,0,5,-1,1,0,1,2,3,1,0,1,0,1,1,0,2,19,4,-8,4,1,0,0,1,1,1,-1,6,-1
KR_6759763848,440,-2,-81,1,-1,-6,7,1,2,2,4,-3,3,0,6,1,7,0,1,1,0,7,-9,4,-4,0,2,0,-1,1,-1,-1,1,1,-1
KR_6722762555,420,-4,-34,-20,-3,0,3,3,4,0,4,-8,10,2,2,3,5,-1,4,3,0,2,-12,0,-5,5,-3,0,0,-1,1,-1,-1,5,-1
KR_6740475044,420,-5,5,-44,-13,1,0,1,-8,8,0,-3,3,0,0,2,2,-3,3,0,0,-16,33,-6,-1,7,-11,0,-1,-1,-1,-1,-1,5,-1
KR_6755477653,440,-3,-39,-37,-1,5,5,10,2,3,5,-1,2,1,-4,5,1,-3,4,1,0,-1,9,0,-6,6,-3,0,0,1,-1,0,1,2,-1
KR_6740596751,420,-7,-132,-24,-9,-1,3,2,-2,4,2,-5,5,0,-1,1,0,0,0,0,0,-2,-5,-4,0,4,-1,0,-3,0,-1,-1,-1,0,-1
KR_6728786434,420,-5,-46,0,-10,1,0,1,-2,4,2,-6,6,0,-2,4,2,-1,1,0,-1,-10,10,-5,-3,8,-19,0,1,-1,1,-1,-1,3,-1
KR_6762717619,420,-2,20,-34,-3,0,0,0,4,4,8,-1,2,1,-4,5,1,-2,2,0,0,1,42,9,-11,2,-29,0,0,1,1,-1,-1,3,-1
KR_6731361765,420,-4,-85,11,-9,-4,5,1,-3,4,1,0,1,1,-2,2,0,0,0,0,0,-3,-29,-2,-7,9,-8,0,-1,-1,-1,-1,-1,3,-1
KR_6734413512,420,-2,-36,24,-10,-1,1,0,-3,5,2,-3,3,0,-3,5,2,0,1,1,0,-11,-9,-8,-2,10,4,0,0,-1,1,-1,1,1,-1
KR_6731343396,420,0,12,17,-2,2,1,3,-2,2,0,3,1,4,-5,7,2,0,0,0,0,-7,-2,0,-7,7,-2,0,1,-1,1,1,-1,1,-1
KR_6752697437,420,-1,-53,8,-5,0,3,3,0,2,2,-2,3,1,-4,5,1,1,0,1,0,-4,43,-3,-3,6,0,0,-2,0,1,-1,1,0,-1
KR_6757329884,420,-3,8,-12,-3,2,0,2,0,1,1,0,2,2,-3,5,2,-2,2,0,0,0,-7,0,-5,5,4,0,-2,-1,-1,-1,1,5,-1
KR_6646923414,420,0,-12,12,-5,-3,3,0,-3,5,2,0,2,2,1,4,5,0,2,2,0,-6,2,1,-6,5,-3,0,0,0,-1,0,1,0,-1
KR_6748073365,440,0,-55,-10,4,-1,2,1,2,1,3,5,2,7,-2,7,5,0,1,1,0,8,8,4,-6,2,1,0,0,1,0,0,1,3,-1
KR_6744377278,420,-1,-27,4,2,-3,3,0,1,2,3,0,3,3,5,2,7,-1,1,0,0,8,49,4,-8,4,-27,0,-2,1,-1,-1,1,6,-1
KR_6669868031,420,-3,9,-20,-5,-4,4,0,-2,3,1,4,2,6,-1,3,2,-2,3,1,0,-6,79,-5,-7,12,1,0,0,-1,-1,1,1,5,-1
KR_6763797269,420,0,-6,-5,6,-5,7,2,2,1,3,-3,6,3,6,1,7,6,0,6,0,10,5,5,-8,3,1,0,0,1,-1,-1,1,1,-1
KR_6728480233,420,-2,15,-4,-6,4,0,4,-13,13,0,5,0,5,-2,4,2,0,0,0,0,-15,-15,2,-7,5,3,0,-1,-1,-1,-1,-1,3,-1
KR_6764563569,440,4,51,28,10,3,2,5,5,0,5,3,1,4,-3,5,2,2,0,2,1,4,20,3,-5,2,1,0,0,0,0,1,1,0,-1
KR_6686037739,420,1,-22,5,-3,-2,3,1,-3,3,0,2,2,4,1,1,2,-1,1,0,0,-4,7,1,-4,3,0,0,1,1,1,1,-1,4,-1
KR_6737677213,420,0,7,-37,0,1,2,3,0,1,1,-5,5,0,5,0,5,-1,1,0,0,3,12,4,-7,3,0,0,0,0,-1,-1,-1,0,-1
KR_6747749021,440,1,16,4,2,0,1,1,-1,2,1,-1,2,1,4,1,5,0,0,0,0,3,39,4,-7,3,-2,0,0,1,1,0,-1,6,-1
KR_6643615654,420,2,-41,-8,9,-2,3,1,5,2,7,3,3,6,2,3,5,1,0,1,0,10,-3,5,-6,1,1,0,1,-1,0,1,-1,3,-1
KR_6634088652,420,-3,-34,-4,-3,0,1,1,-3,4,1,0,3,3,0,2,2,0,1,1,1,-4,-1,-3,-5,8,-2,0,-1,1,1,-1,1,5,-1
KR_6760936050,420,-1,-49,6,0,-1,3,2,0,1,1,1,1,2,-4,7,3,4,0,4,0,5,118,2,-5,3,-4,0,0,0,1,0,-1,0,-1
KR_6755062205,420,-2,-56,13,-8,-4,4,0,-3,4,1,-5,5,0,3,2,5,1,0,1,-1,-6,-1,-1,-3,4,-1,0,-1,1,-1,-1,1,4,-1
KR_6529876636,420,-4,-53,1,-11,-2,2,0,-4,7,3,1,1,2,-4,7,3,-2,4,2,0,-16,-73,-2,-5,7,0,0,0,-1,-1,-1,-1,6,-1
KR_6756230081,420,-2,3,-5,-2,-1,2,1,-1,3,2,0,1,1,0,3,3,0,0,0,0,-4,-3,0,-5,5,-1,0,-1,0,1,-1,1,0,-1
KR_6764547375,420,-1,-47,-4,-2,1,1,2,-3,5,2,1,1,2,0,2,2,-1,2,1,0,-1,0,1,-9,8,1,0,-1,-1,-1,-1,-1,6,-1
KR_6746605183,420,-3,-7,14,-5,-1,1,0,4,3,7,1,2,3,-9,10,1,0,1,1,0,-8,-9,0,-6,6,3,0,-1,1,-1,-1,-1,1,-1
KR_6593833718,420,2,27,17,-2,5,1,6,-2,4,2,-4,5,1,0,2,2,-1,1,0,0,-6,12,0,-7,7,-5,0,0,-1,-1,0,1,3,-1
KR_6703584205,420,-1,-39,53,-4,0,1,1,1,2,3,0,2,2,-5,8,3,0,0,0,0,-12,-2,1,-5,4,0,0,-1,-1,1,1,1,1,-1
KR_6756492180,420,-3,-27,-28,-6,-3,5,2,1,3,4,-3,4,1,0,2,2,-1,1,0,1,-5,-108,-3,-3,6,4,0,-2,-1,-1,-1,1,2,-1
KR_6705603907,420,-1,27,11,-11,-1,1,0,-3,8,5,-1,2,1,-8,8,0,2,1,3,-1,-15,9,0,-5,5,0,0,-1,1,-1,-1,-1,1,-1
KR_6734362262,420,-1,-8,-8,-5,0,2,2,0,3,3,-1,2,1,-4,5,1,0,1,1,0,-9,-2,2,-6,4,-6,0,-2,-1,-1,-1,-1,2,-1
KR_6762918304,420,0,82,4,-3,3,2,5,-4,7,3,-5,5,0,5,4,9,-2,2,0,0,-10,-9,-1,-5,6,2,0,1,-1,-1,1,-1,1,-1
KR_6756287633,420,2,57,-4,1,10,0,10,-2,5,3,-4,4,0,-1,3,2,-2,3,1,0,-13,-1,1,-8,7,-4,0,0,-1,0,1,-1,5,-1
KR_6661484837,420,-2,-90,8,-9,0,1,1,2,3,5,-2,3,1,-9,10,1,0,0,0,0,-6,5,-1,-4,5,-6,0,-1,1,-1,-1,-1,6,-1
KR_6633552018,420,-5,-42,-24,-8,-1,1,0,-8,10,2,0,2,2,0,1,1,1,1,2,0,-7,-11,-1,-8,9,1,0,0,-1,1,0,1,2,-1
KR_6730992777,420,-3,-117,-12,-1,-5,7,2,2,1,3,3,0,3,-2,6,4,1,1,2,0,6,-207,-2,-4,6,4,0,-1,1,-1,-1,-1,6,-1
KR_6755529305,440,-1,27,0,-13,-5,5,0,-6,9,3,0,0,0,-1,3,2,-1,1,0,0,-12,54,2,-8,6,-23,0,0,0,1,1,-1,0,-1
KR_6759932168,420,0,-17,-25,1,-1,3,2,2,1,3,4,0,4,-4,4,0,0,1,1,0,5,3,0,-5,5,-2,0,1,1,1,1,1,3,-1
KR_6756548619,420,-7,-103,-30,-16,-4,5,1,-4,5,1,-3,5,2,-8,9,1,3,0,3,0,-12,8,-2,-4,6,-6,0,-3,1,1,-1,1,5,-1
KR_6686184359,420,-2,5,-1,3,2,1,3,2,0,2,1,4,5,-2,4,2,0,2,2,0,-2,-3,-5,-5,10,5,0,0,1,1,1,1,6,-1
KR_6764512307,420,0,3,-8,-4,-3,4,1,0,2,2,-1,1,0,-1,2,1,1,0,1,0,-1,14,-6,-2,8,-10,0,0,1,-1,0,-1,1,-1
KR_6732161066,420,-5,-18,-43,-13,-2,2,0,-5,7,2,-2,4,2,-5,6,1,1,1,2,-2,-11,-4,-2,-4,6,-9,0,-1,-1,1,-1,1,5,-1
KR_6747263311,420,-3,62,16,-11,-1,3,2,-7,9,2,-2,4,2,-1,5,4,0,1,1,0,-18,-14,-1,-5,6,-4,0,0,0,-1,0,-1,0,-1
KR_6730705512,420,-5,-40,-24,-13,-5,7,2,-2,4,2,-1,2,1,-2,2,0,-3,3,0,0,-9,44,0,-3,3,-20,0,-1,1,-1,-1,-1,4,-1
KR_6727415478,440,2,25,-23,9,3,0,3,2,6,8,2,3,5,0,0,0,2,2,4,0,13,5,0,-4,4,-1,0,-2,1,0,-1,1,1,-1
KR_6762009629,420,0,-28,-8,1,5,0,5,4,0,4,-2,4,2,-7,7,0,1,0,1,0,-2,32,-3,-1,4,-17,0,0,-1,0,1,1,6,-1
KR_6609534745,420,2,27,-8,-2,-1,1,0,-1,4,3,-3,7,4,1,2,3,2,1,3,1,-5,-7,-9,-5,14,3,0,1,-1,1,1,1,5,-1
KR_6704814148,420,-3,-53,-12,-16,-7,7,0,-1,2,1,-7,9,2,-3,5,2,2,1,3,0,-10,-109,-2,-4,6,-5,0,0,1,-1,-1,-1,5,-1
KR_6762961656,420,0,3,-10,-4,0,0,0,3,1,4,-5,5,0,-1,4,3,-1,2,1,0,1,30,-2,-4,6,-24,0,1,-1,1,1,1,1,-1
KR_6743893136,420,-1,-11,-12,1,-7,7,0,2,0,2,0,1,1,5,2,7,1,1,2,1,3,124,-9,-3,12,9,0,1,-1,1,1,1,4,-1
KR_6762938300,420,-3,-32,12,-3,-2,5,3,0,4,4,-2,2,0,2,3,5,-1,2,1,0,1,-20,-2,-4,6,4,0,-1,-1,-1,-1,1,3,-1
KR_6755491026,420,1,88,-8,-3,0,2,2,-5,5,0,5,0,5,-3,3,0,0,2,2,0,-11,-13,-5,-5,10,0,0,1,1,1,1,1,6,-1
KR_6648604424,440,-1,10,-18,-3,-3,3,0,1,1,2,-3,4,1,1,0,1,1,1,2,0,1,-42,1,-8,7,2,0,-1,-1,-1,-1,1,3,-1
KR_6760030975,420,2,22,-20,1,0,2,2,0,2,2,2,3,5,-2,3,1,1,0,1,0,1,1,-2,-4,6,2,0,-1,0,-1,1,-1,0,-1
KR_6749019084,420,-4,-63,-40,-7,0,3,3,1,2,3,-3,4,1,-6,6,0,1,2,3,-2,-7,0,-1,-9,10,0,0,-1,-1,1,-1,-1,1,-1
KR_6719979649,420,-3,-49,-37,-4,-4,4,0,-2,3,1,-3,3,0,4,0,4,1,0,1,0,9,3,0,-7,7,-8,0,0,-1,1,-1,1,1,-1
KR_6736263459,440,-2,-90,16,-9,-9,10,1,4,2,6,1,1,2,-5,6,1,0,2,2,0,-4,5,5,-9,4,-3,0,-2,1,1,-1,-1,2,-1
KR_6758042686,420,-2,-78,-21,-6,-3,4,1,1,0,1,-2,4,2,-3,6,3,1,0,1,0,4,1,3,-6,3,-4,0,-1,-1,-1,-1,-1,2,-1
KR_6756499513,420,1,6,20,8,2,1,3,0,2,2,1,1,2,2,6,8,3,2,5,1,10,0,5,-9,4,3,0,1,1,0,1,1,5,-1
KR_6761345060,440,-3,-52,-8,-15,-1,3,2,-13,14,1,0,2,2,-3,4,1,2,1,3,0,-14,-15,-2,-1,3,-2,0,-1,-1,-1,-1,1,5,-1
KR_6762843591,420,-1,31,-52,-1,0,0,0,0,2,2,2,1,3,-2,4,2,-1,1,0,0,1,-10,1,-6,5,3,0,0,-1,-1,0,1,2,-1
KR_6707937370,420,-4,-75,-28,-14,-5,7,2,0,3,3,-2,3,1,-5,7,2,-2,3,1,-2,-11,3,-2,-2,4,-3,0,0,-1,-1,-1,-1,1,-1
KR_6762981886,420,-4,-38,-23,-7,-2,3,1,0,4,4,-3,5,2,0,1,1,-2,3,1,0,0,-8,-2,-4,6,-1,0,-2,-1,-1,-1,-1,1,-1
KR_6754427696,420,-5,-62,-19,-7,0,1,1,0,4,4,-4,7,3,-2,3,1,-1,1,0,0,-7,-7,-4,-4,8,-3,0,-2,0,-1,-1,-1,0,-1
KR_6646897210,420,-4,-84,-12,-17,-5,9,4,-1,3,2,-1,5,4,-10,11,1,0,0,0,-1,-2,-226,-2,-1,3,3,0,-2,-1,-1,-1,-1,3,-1
KR_6756037283,420,2,0,1,3,-1,2,1,-2,2,0,-1,3,2,8,0,8,-1,2,1,-1,1,111,0,-4,4,3,0,0,1,-1,-1,-1,2,-1
KR_6621038204,420,-4,-33,-16,-6,-1,1,0,-1,1,0,-2,3,1,-2,4,2,0,0,0,0,-9,-2,1,-6,5,-1,0,0,1,-1,-1,-1,6,-1
KR_6688612152,420,-4,-17,7,-6,-4,4,0,-4,6,2,3,2,5,2,2,4,-3,3,0,0,-2,3,2,-4,2,-1,0,0,-1,1,1,1,3,-1
KR_6744540612,440,-4,-59,-12,-7,-6,6,0,-1,2,1,2,1,3,-2,2,0,0,0,0,0,0,-2,-1,-4,5,-2,0,-1,-1,1,-1,-1,2,-1
KR_6743180619,420,3,40,5,6,-1,2,1,0,1,1,0,2,2,6,0,6,1,0,1,0,9,-95,5,-9,4,-1,0,2,1,1,1,1,2,-1
KR_6759598449,420,-2,-34,-36,-3,-1,1,0,-2,3,1,-1,2,1,-1,2,1,2,0,2,0,4,97,-2,-3,5,2,0,-1,1,-1,-1,-1,1,-1
KR_6739240539,420,-2,-53,20,-8,-7,7,0,1,4,5,3,1,4,-4,6,2,-1,1,0,0,-4,-356,-3,-4,7,-3,0,-1,-1,-1,-1,-1,2,-1
KR_6627779597,420,1,-26,15,0,2,0,2,-1,2,1,-2,2,0,0,2,2,1,2,3,0,-4,8,-2,-3,5,-1,0,1,1,1,1,1,5,-1
KR_6761507373,440,-5,-18,-29,-15,0,0,0,0,0,0,-2,3,1,-7,8,1,-6,6,0,0,-10,3,-1,-4,5,1,0,-3,-1,-1,-1,-1,4,-1
KR_6736485746,420,2,-44,-9,1,2,1,3,-2,2,0,3,3,6,0,2,2,-2,2,0,1,0,12,-2,-7,9,1,0,0,-1,1,1,-1,2,-1
KR_6760485865,420,-6,-95,-8,-9,-3,3,0,1,3,4,-3,3,0,0,2,2,-4,4,0,0,-5,-19,-1,-3,4,-3,0,0,-1,1,0,-1,4,-1
KR_6746496370,420,0,-24,3,0,-2,5,3,0,1,1,5,3,8,-4,5,1,1,1,2,0,-7,-1,0,-4,4,-3,0,1,1,-1,1,-1,5,-1
KR_6763586352,420,0,17,-22,1,3,0,3,2,0,2,-2,2,0,-1,2,1,-1,1,0,0,1,-120,0,-4,4,-1,0,0,-1,1,0,1,2,-1
KR_6677504051,420,-1,-72,17,-6,-3,4,1,-3,3,0,1,3,4,0,4,4,-1,3,2,0,-11,39,-1,-2,3,-2,0,-2,-1,-1,-1,-1,5,-1
KR_6764720920,420,-6,-77,-48,-16,-2,4,2,-2,6,4,-2,3,1,-7,9,2,-3,6,3,0,-16,15,4,-8,4,-6,0,-1,-1,1,-1,1,5,-1
KR_6747463855,420,1,17,-4,-4,2,1,3,-3,3,0,-3,6,3,0,0,0,0,0,0,0,-1,34,-4,-4,8,6,0,0,0,1,0,-1,0,-1
KR_6719386521,420,-4,-59,-9,-9,0,3,3,-8,10,2,-1,2,1,-1,2,1,1,0,1,0,-8,-317,-3,-3,6,-3,0,-1,-1,-1,-1,-1,5,-1
KR_6751648317,420,-2,-40,4,-5,-4,4,0,-4,6,2,-2,5,3,6,1,7,-1,3,2,0,0,-7,-1,-2,3,0,0,-1,1,-1,1,-1,6,-1
KR_6718199081,440,-4,-73,20,-10,1,2,3,-4,5,1,-1,2,1,2,2,4,-8,8,0,0,-20,0,-3,-6,9,0,0,-1,-1,-1,-1,-1,2,-1
KR_6756716785,420,-1,-22,-3,0,1,2,3,1,0,1,1,1,2,0,2,2,-3,4,1,0,0,2,-1,-5,6,1,0,0,1,1,0,1,3,-1
KR_6759666415,420,-1,-9,-2,-4,1,0,1,-4,7,3,1,3,4,1,1,2,-3,3,0,0,-10,-163,0,-5,5,-10,0,-1,-1,-1,-1,-1,3,-1
KR_6640029577,420,-4,-3,-16,-12,-1,3,2,-5,6,1,-3,4,1,-2,4,2,-1,2,1,0,-12,-111,-1,-5,6,4,0,0,1,-1,-1,-1,6,-1
KR_6761957844,420,-6,-122,-24,-14,-3,4,1,-3,3,0,-3,3,0,-2,3,1,-3,4,1,-1,-12,16,0,-5,5,-7,0,-2,1,-1,-1,-1,1,-1
KR_6449632410,420,-2,-88,4,-3,1,1,2,-1,4,3,-1,2,1,-3,6,3,1,1,2,0,-3,-3,3,-13,10,0,0,1,-1,1,1,1,6,-1
KR_6399263678,420,-3,-15,-27,1,-1,3,2,-1,1,0,1,2,3,1,2,3,1,0,1,0,2,-6,0,-6,6,0,0,-1,1,-1,-1,-1,5,-1
KR_6756387557,420,-1,-20,0,1,-2,2,0,1,4,5,0,3,3,4,1,5,-2,3,1,0,-6,15,3,-6,3,-2,0,0,-1,1,0,1,3,-1
KR_6705567224,420,-2,-45,-12,-3,4,1,5,-4,4,0,-2,3,1,-1,2,1,0,0,0,0,-1,2,-1,-3,4,0,0,0,-1,1,-1,-1,5,-1
KR_6740391040,420,-1,-18,-16,-4,-4,4,0,1,0,1,0,1,1,0,2,2,-1,1,0,0,-5,5,3,-7,4,1,0,0,1,-1,0,-1,2,-1
KR_6755398755,420,3,-28,54,3,-2,4,2,2,4,6,0,2,2,1,3,4,2,0,2,0,4,3,3,-8,5,4,0,-2,1,-1,-1,-1,4,-1
KR_6709299832,420,1,15,-1,-5,2,3,5,-2,3,1,-1,3,2,0,2,2,-4,5,1,0,-14,-35,1,-5,4,5,0,0,-1,1,-1,1,5,-1
KR_6762935406,440,-1,40,-6,-3,0,1,1,-1,2,1,2,1,3,-4,7,3,0,0,0,0,-3,-11,-3,-3,6,4,0,1,-1,1,1,-1,5,-1
KR_6675431462,420,-3,-53,31,-7,1,0,1,1,2,3,-2,3,1,-4,5,1,-3,3,0,1,-10,-68,2,-9,7,-4,0,-1,-1,1,-1,1,1,-1
KR_6756812636,420,-1,-100,4,0,1,2,3,-1,2,1,8,3,11,-2,6,4,-6,6,0,-2,1,45,-5,-4,9,-2,0,-1,-1,1,-1,1,3,-1
KR_6760881906,420,-4,-60,-24,-12,-3,3,0,-3,7,4,-4,4,0,-2,2,0,0,1,1,0,-13,-13,-1,-5,6,-5,0,-2,1,-1,-1,-1,3,-1
KR_6759580098,420,1,-60,3,3,5,1,6,-3,5,2,-1,5,4,2,2,4,0,2,2,0,3,-1,-1,-3,4,-2,0,1,0,1,1,1,0,-1
KR_6728076858,420,-2,-10,-29,-1,-2,2,0,-1,5,4,0,0,0,2,4,6,0,0,0,0,3,-101,-1,-5,6,-14,0,-2,-1,-1,-1,1,5,-1
KR_6742290243,420,-2,-9,-31,-7,-1,2,1,1,6,7,-1,2,1,-7,8,1,1,0,1,0,-8,-321,1,-4,3,-2,0,-1,-1,-1,-1,1,3,-1
KR_6728912564,440,-1,-9,20,-1,-6,7,1,-2,3,1,3,3,6,2,3,5,2,2,4,0,1,-10,-6,-2,8,-2,0,-1,-1,-1,-1,-1,1,-1
KR_6637171426,420,0,-15,-9,7,2,1,3,1,3,4,2,2,4,1,1,2,1,0,1,0,9,3,-1,-4,5,5,0,1,-1,1,1,-1,2,-1
KR_6737514830,440,0,-93,-7,-1,-4,4,0,-2,2,0,-2,4,2,7,1,8,0,1,1,0,-2,-9,-3,-2,5,0,0,-1,-1,1,-1,-1,4,-1
KR_6761862867,420,0,-18,18,-5,-3,3,0,-3,3,0,3,3,6,-2,5,3,0,0,0,-1,-3,-2,1,-5,4,2,0,0,-1,1,0,-1,6,-1
KR_6688656506,420,1,37,8,-1,2,0,2,-9,10,1,5,0,5,1,4,5,0,1,1,0,-11,35,-2,-5,7,-33,0,1,-1,1,1,1,2,-1
KR_6636508046,420,-1,-5,24,-5,-2,2,0,1,5,6,1,2,3,-3,3,0,-2,2,0,0,-7,-147,0,-13,13,6,0,-1,-1,1,-1,1,2,-1
KR_6749592956,420,-7,-34,6,-13,-6,6,0,-9,10,1,-3,4,1,3,3,6,2,0,2,0,-19,366,-2,-4,6,0,0,-1,1,1,-1,-1,4,-1
KR_6763660054,420,1,-1,-16,4,-1,2,1,-3,4,1,-2,2,0,9,1,10,1,1,2,0,6,9,-2,-3,5,3,0,0,1,-1,0,1,6,-1
KR_6750837267,420,-1,12,24,-3,-1,2,1,0,3,3,-2,2,0,1,2,3,-1,1,0,0,-3,1,1,-8,7,-9,0,-1,1,-1,-1,1,1,-1
KR_6763251984,420,-4,10,-8,-10,2,1,3,-7,7,0,-7,8,1,1,1,2,1,0,1,0,-12,8,0,-2,2,-2,0,0,1,-1,-1,1,2,-1
KR_6763353654,420,1,-13,0,3,0,3,3,3,2,5,5,1,6,-3,3,0,-2,2,0,0,2,1,-4,-5,9,-3,0,0,-1,-1,0,1,6,-1
KR_6752866791,440,-3,34,-4,-12,3,0,3,-7,8,1,-2,3,1,-6,6,0,0,1,1,0,-18,-8,2,-5,3,-1,0,-1,1,-1,-1,-1,1,-1
KR_6740899742,420,-6,-36,-5,-9,0,2,2,-5,8,3,-5,5,0,1,1,2,0,0,0,0,-9,5,-1,-3,4,-1,0,-1,-1,1,1,-1,3,-1
KR_6761246382,420,0,-35,-4,3,0,1,1,5,2,7,-4,4,0,2,1,3,0,1,1,0,0,-1,1,-9,8,1,0,0,-1,-1,1,1,4,-1
KR_6638648183,420,-4,-53,-24,-4,-2,2,0,2,4,6,-2,5,3,-2,3,1,0,0,0,1,-13,5,3,-9,6,-5,0,0,-1,1,-1,1,5,-1
KR_6530402980,420,-2,-59,3,-5,-1,2,1,2,2,4,-6,6,0,-1,3,2,1,0,1,0,-2,-6,-4,-4,8,0,0,-1,-1,-1,-1,-1,2,-1
KR_6435847209,420,-2,-21,-32,-1,-3,4,1,0,0,0,3,5,8,-2,4,2,1,1,2,0,14,-130,-3,-5,8,-3,0,-1,-1,-1,-1,-1,5,-1
KR_6764667230,420,-5,-56,-19,-17,-7,7,0,1,2,3,-8,10,2,-4,6,2,1,0,1,0,-4,-1,-2,-3,5,-6,0,-3,-1,-1,-1,-1,3,-1
KR_6435888880,420,-1,-54,12,-2,0,1,1,-2,6,4,5,0,5,-5,5,0,0,0,0,0,-4,-5,-3,-4,7,-6,0,-3,-1,1,-1,1,6,-1
KR_6758694105,420,-4,-30,-16,-11,0,2,2,-3,5,2,-8,10,2,0,3,3,0,0,0,0,-8,98,0,-3,3,-1,0,-2,-1,-1,-1,-1,2,-1
KR_6730902317,420,-4,-40,-9,-13,-3,7,4,-3,5,2,-3,3,0,-5,6,1,1,3,4,-2,-19,-4,-4,-7,11,-7,0,-1,-1,-1,-1,-1,2,-1
KR_6761748519,420,-4,7,4,-10,-1,4,3,-1,2,1,-5,5,0,1,2,3,-4,5,1,0,-10,4,5,-7,2,-1,0,0,0,-1,-1,-1,0,-1
KR_6618114999,420,1,-39,-27,0,-3,3,0,-1,4,3,1,3,4,3,1,4,0,0,0,-1,9,68,1,-7,6,1,0,-1,-1,-1,-1,-1,6,-1
KR_6702678866,420,-2,-7,-38,-2,3,0,3,-2,3,1,-2,5,3,0,3,3,-1,1,0,-1,-5,9,0,-4,4,-3,0,0,-1,-1,0,-1,3,-1
KR_6751590608,420,-1,64,-9,2,0,2,2,-4,7,3,4,3,7,1,1,2,1,0,1,0,0,-2,2,-6,4,-5,0,1,1,1,1,1,1,-1
KR_6760003154,420,-4,20,-7,-8,0,3,3,-2,4,2,-4,4,0,0,2,2,-2,2,0,0,-7,-21,1,-9,8,1,0,-1,1,-1,-1,1,2,-1
KR_6757228582,420,0,17,56,-7,3,0,3,-1,2,1,-3,3,0,-6,9,3,0,1,1,0,-17,0,-2,-2,4,-3,0,-1,-1,1,-1,-1,6,-1
KR_6734213402,420,-5,-1,-8,-6,-4,6,2,2,0,2,-6,7,1,5,0,5,-3,4,1,1,-1,-3,3,-5,2,0,0,0,-1,-1,0,1,6,-1
KR_6743819588,420,-4,-99,-13,-11,-4,5,1,0,2,2,-3,7,4,-3,4,1,-1,2,1,0,-3,13,0,-7,7,-6,0,-3,-1,-1,-1,-1,3,-1
KR_6735984489,420,-10,-140,-53,-23,-3,4,1,-11,11,0,-6,7,1,-1,5,4,-2,2,0,-2,-16,-56,-5,-1,6,-1,0,-4,-1,-1,-1,-1,6,-1
KR_6699852610,420,-10,-101,1,-19,-12,12,0,0,5,5,-7,8,1,1,1,2,-1,1,0,0,-10,-6,-1,-4,5,-2,0,-2,1,-1,-1,1,5,-1
KR_6691168410,420,-1,-15,-33,1,3,1,4,-3,6,3,1,1,2,0,2,2,0,0,0,-1,-1,1,0,-6,6,-1,0,1,-1,1,1,-1,4,-1
KR_6764385278,420,-1,-31,12,-3,0,1,1,0,2,2,0,2,2,-3,6,3,0,0,0,0,-10,62,-2,-6,8,-2,0,0,-1,-1,0,-1,1,-1
KR_6624663522,420,4,22,-8,1,3,1,4,-2,8,6,0,0,0,1,2,3,-1,2,1,0,4,0,1,-2,1,2,0,1,-1,-1,1,-1,2,-1
KR_6749954841,420,-1,13,-15,5,-2,2,0,2,1,3,2,2,4,3,0,3,0,0,0,0,11,-5,1,-6,5,1,0,1,1,-1,1,1,4,-1
KR_6654634824,420,-2,0,1,-3,1,3,4,5,1,6,-4,5,1,-4,7,3,-1,1,0,0,-4,4,-3,-6,9,-8,0,-1,-1,-1,-1,1,4,-1
KR_6751213088,420,-3,-33,6,-7,-3,3,0,-4,6,2,-3,3,0,3,0,3,0,1,1,0,-8,-16,-4,-3,7,2,0,-2,1,-1,-1,-1,6,-1
KR_6698078408,420,-2,-24,-1,-1,-1,4,3,-2,3,1,-6,7,1,8,2,10,0,2,2,0,2,-152,4,-8,4,-1,0,0,-1,1,-1,1,1,-1
KR_6641643101,420,-3,-6,4,-9,0,2,2,-3,4,1,1,1,2,-4,4,0,-3,3,0,0,-12,-8,1,-6,5,1,0,-1,-1,-1,-1,-1,6,-1
KR_6754426151,420,1,75,0,-1,0,1,1,2,0,2,1,3,4,-3,5,2,-1,1,0,0,0,-21,-3,-4,7,7,0,0,-1,-1,0,-1,3,-1
KR_6676474792,420,-6,-77,-15,-1,-3,3,0,0,2,2,2,3,5,3,2,5,-3,3,0,0,-10,-1,-2,-2,4,1,0,-3,-1,-1,-1,1,5,-1
KR_6734063937,420,-2,-19,-8,-5,-2,3,1,0,3,3,6,2,8,-9,10,1,0,1,1,0,-14,-5,2,-6,4,1,0,0,-1,1,-1,-1,1,-1
KR_6745665559,420,-2,48,-18,-5,0,2,2,-4,6,2,3,3,6,-1,2,1,-3,3,0,0,-6,-6,-1,-6,7,-1,0,-1,-1,1,-1,-1,1,-1
KR_6749021393,420,-3,-37,-3,-9,-2,2,0,2,1,3,0,2,2,-8,9,1,-1,1,0,0,-14,-115,-5,-2,7,-2,0,0,-1,-1,-1,-1,3,-1
KR_6640826177,420,0,-25,-13,4,2,2,4,3,4,7,-1,2,1,-2,3,1,2,0,2,0,3,7,0,-6,6,-5,0,0,1,1,1,-1,6,-1
KR_6764629677,420,-1,29,-3,-2,-3,3,0,3,2,5,0,2,2,2,3,5,-4,7,3,-1,-4,-2,-4,-3,7,-3,0,0,-1,-1,1,-1,1,-1
KR_6695298361,420,-2,-8,0,-5,-2,2,0,0,4,4,2,0,2,-2,3,1,-3,3,0,-1,-11,5,-2,-2,4,-2,0,0,1,-1,-1,-1,2,-1
KR_6648084982,420,0,-2,-16,-6,1,1,2,-3,5,2,-2,3,1,-4,8,4,2,0,2,-2,-2,11,-5,-5,10,6,0,-1,-1,-1,-1,-1,4,-1
KR_6744155117,420,-1,-11,-34,3,0,3,3,1,2,3,-2,3,1,7,2,9,-3,3,0,0,4,-1,0,-5,5,1,0,0,-1,-1,1,1,2,-1
KR_6749437712,420,0,-18,7,-1,3,0,3,-1,1,0,3,1,4,-7,8,1,1,0,1,0,-4,3,-2,-3,5,0,0,-1,1,-1,-1,-1,6,-1
KR_6762115601,420,1,-26,-5,-2,-2,3,1,2,0,2,2,0,2,-6,6,0,2,1,3,-1,-4,119,4,-6,2,-3,0,-1,-1,-1,-1,-1,1,-1
KR_6659299431,420,0,-65,-23,0,3,3,6,1,1,2,-1,1,0,-1,1,0,-2,2,0,0,-3,-11,-2,-2,4,-6,0,-2,1,1,-1,1,1,-1
KR_6706460072,420,-1,-23,-36,-3,1,0,1,-3,5,2,-1,2,1,0,2,2,0,1,1,0,-4,1,4,-9,5,2,0,-1,-1,-1,-1,-1,2,-1
KR_6744266156,420,1,25,-10,1,-3,3,0,5,1,6,-3,3,0,4,0,4,-2,4,2,0,6,125,-3,-5,8,2,0,2,1,1,1,-1,3,-1
KR_6691860131,420,0,-48,-1,-2,-4,5,1,0,1,1,-1,3,2,2,1,3,1,2,3,0,-5,2,-4,-4,8,-3,0,-1,1,-1,-1,-1,6,-1
KR_6764861899,420,-3,-60,-2,-2,-2,3,1,1,2,3,2,2,4,-3,3,0,0,0,0,0,-3,8,2,-8,6,-5,0,-1,1,-1,-1,-1,1,-1
KR_6763319460,420,-2,6,-4,-5,1,1,2,-3,5,2,-1,3,2,-2,4,2,0,0,0,0,1,-16,-3,-2,5,1,0,0,-1,-1,0,-1,6,-1
KR_6724019806,420,-4,7,-12,-8,-4,4,0,-3,7,4,0,1,1,-1,2,1,0,1,1,0,-4,2,-1,-2,3,3,0,-2,-1,1,-1,-1,5,-1
KR_6741673950,420,-4,-75,8,-2,-4,4,0,3,1,4,-2,5,3,3,1,4,-2,2,0,0,5,42,2,-6,4,-2,0,-1,0,1,-1,1,0,-1
KR_6764294050,420,-7,-85,-19,-10,-2,2,0,-5,5,0,0,1,1,-2,2,0,-1,1,0,0,-8,-6,-2,-6,8,-1,0,-1,-1,1,-1,-1,1,-1
KR_6724880031,420,-1,23,21,-1,3,1,4,-2,5,3,-1,3,2,-1,1,0,0,1,1,0,-11,4,8,-8,0,-1,0,0,1,1,0,1,1,-1
KR_6726623725,420,-2,-33,16,-2,0,1,1,-2,3,1,0,1,1,-1,3,2,1,0,1,0,-6,-39,-4,-3,7,4,0,0,1,1,-1,-1,6,-1
KR_6642367586,420,3,30,-4,2,1,3,4,2,1,3,-1,2,1,3,0,3,-3,3,0,1,5,-1,-4,-4,8,-3,0,-1,1,-1,-1,1,4,-1
KR_6750986785,440,-1,-2,-8,-5,1,1,2,-5,5,0,1,0,1,0,0,0,-2,4,2,0,-8,73,4,-7,3,-1,0,1,-1,-1,1,-1,1,-1
KR_6741918310,420,0,-28,-7,5,-3,4,1,1,3,4,3,3,6,1,2,3,3,0,3,-1,7,-6,-3,-4,7,0,0,0,1,0,0,-1,2,-1
KR_6764224755,420,-2,-111,-28,-6,-3,3,0,3,1,4,-4,6,2,-3,5,2,1,0,1,0,4,-27,-1,-4,5,-2,0,-3,-1,-1,-1,-1,5,-1
KR_6720785984,420,-3,-73,-24,-1,-3,3,0,3,0,3,1,1,2,-2,4,2,0,1,1,0,6,-8,-3,-8,11,1,0,-2,-1,1,-1,1,1,-1
KR_6686154223,420,-1,-19,-8,3,1,2,3,-3,6,3,1,2,3,0,1,1,4,1,5,-1,0,-8,-2,-3,5,5,0,0,1,1,1,-1,5,-1
KR_6694779766,420,-5,-1,-4,-3,2,2,4,-1,5,4,-2,2,0,-2,2,0,0,1,1,1,-2,4,-1,-3,4,-2,0,-2,-1,-1,-1,1,5,-1
KR_6755139076,420,4,19,-12,0,2,2,4,0,2,2,-6,10,4,5,0,5,-1,3,2,-2,-2,12,2,-4,2,0,0,1,1,1,1,-1,1,-1
KR_6753707050,420,-6,-73,17,-17,-4,4,0,-5,5,0,-6,6,0,-2,4,2,0,1,1,0,-10,-44,-3,-2,5,-3,0,-3,-1,-1,-1,-1,4,-1
KR_6754928373,420,-2,21,-8,-1,2,0,2,1,2,3,-5,5,0,1,1,2,0,1,1,0,3,-15,4,-6,2,-1,0,0,1,-1,-1,-1,1,-1
KR_6760991779,420,-3,-28,-32,-7,-3,4,1,0,1,1,-1,1,0,0,2,2,-3,3,0,0,-9,-13,-1,-5,6,1,0,-1,-1,-1,-1,-1,4,-1
KR_6684503010,420,-4,-23,-40,-3,0,0,0,-4,4,0,-1,2,1,2,1,3,0,3,3,0,-3,9,0,-4,4,-4,0,-2,-1,-1,-1,1,6,-1
KR_6630393352,420,2,9,-14,3,2,0,2,0,0,0,1,4,5,-2,5,3,2,0,2,0,6,10,7,-9,2,-1,0,-1,-1,-1,-1,-1,6,-1
KR_6749687220,420,-1,-18,-16,-4,-1,1,0,0,4,4,-4,6,2,1,3,4,0,1,1,1,-2,-19,-3,-4,7,1,0,-1,-1,-1,-1,1,3,-1
KR_6764991685,420,4,53,-8,5,1,1,2,0,2,2,-1,2,1,5,1,6,0,1,1,0,12,5,5,-8,3,-4,0,0,1,1,1,-1,5,-1
KR_6617653595,420,-5,-69,-16,-5,2,1,3,-3,7,4,-3,4,1,-2,5,3,1,2,3,-1,-8,52,3,-7,4,-3,0,-2,1,-1,-1,-1,5,-1
KR_6717524733,420,-6,-66,8,-16,1,1,2,-3,3,0,-6,7,1,-7,9,2,-1,2,1,0,-14,-74,-7,-2,9,1,0,-2,-1,1,-1,-1,4,-1
KR_6447119060,420,-9,-82,-23,-17,-5,5,0,-4,7,3,-3,4,1,-3,4,1,-2,4,2,0,-16,-12,-4,-4,8,-3,0,-2,-1,-1,-1,-1,1,-1
KR_6639181142,420,-6,-74,-4,-17,-2,3,1,-2,4,2,-1,2,1,-11,11,0,-1,2,1,0,-18,-7,-3,-5,8,-1,0,-3,-1,-1,-1,1,3,-1
KR_6764668904,440,-1,35,-24,-6,-2,3,1,-1,3,2,2,3,5,-1,7,6,-4,4,0,0,-10,1,2,-8,6,3,0,1,-1,-1,1,-1,2,-1
KR_6747782711,420,0,4,40,-9,-2,3,1,-4,6,2,-5,7,2,3,2,5,-1,2,1,1,-4,9,0,-6,6,6,0,0,1,-1,-1,1,6,-1
KR_6763413230,440,3,33,4,8,5,0,5,0,1,1,3,0,3,-5,6,1,5,0,5,0,1,-1,0,-4,4,2,0,1,-1,1,1,1,4,-1
KR_6760573023,420,-4,-121,7,-10,-7,7,0,0,2,2,-1,2,1,-1,2,1,-1,1,0,0,-10,-11,-3,-2,5,-1,0,-3,-1,-1,-1,-1,2,-1
KR_6730844892,420,-5,-21,-22,-12,-2,2,0,2,1,3,-5,8,3,-7,8,1,0,3,3,-2,-15,-12,-2,-5,7,4,0,-2,-1,-1,-1,-1,3,-1
KR_6382004782,420,2,-19,-10,2,-2,3,1,-4,4,0,6,0,6,2,4,6,0,1,1,1,11,-29,-5,-4,9,10,0,-1,1,-1,-1,1,5,-1
KR_6723004851,420,-1,31,-4,0,0,1,1,0,1,1,-1,4,3,1,1,2,0,0,0,0,-4,-11,-1,-7,8,5,0,0,1,-1,0,1,6,-1
KR_6728690630,420,-2,44,24,-8,-1,3,2,-3,3,0,-1,3,2,-3,3,0,0,1,1,0,-9,5,6,-10,4,-4,0,0,0,1,0,-1,0,-1
KR_6755583509,420,-3,-21,-10,-2,3,0,3,-1,3,2,0,2,2,-2,4,2,-2,2,0,0,-2,-11,-2,-4,6,0,0,-1,-1,1,-1,1,1,-1
KR_6762641356,420,-5,-101,-5,-8,-2,3,1,0,1,1,0,1,1,-4,4,0,-2,2,0,0,-9,5,1,-3,2,-2,0,-1,-1,1,-1,-1,1,-1
KR_6757637438,420,-2,17,-26,7,4,0,4,-4,6,2,3,1,4,0,2,2,4,0,4,2,7,4,-1,-6,7,-2,0,-1,1,-1,-1,1,1,-1
KR_6644438218,420,1,31,-4,5,-2,5,3,1,1,2,-3,4,1,7,0,7,2,0,2,1,9,13,5,-8,3,-3,0,2,-1,1,1,1,3,-1
KR_6763264788,420,0,75,18,-4,1,3,4,-6,7,1,1,0,1,2,2,4,-2,4,2,1,-6,-1,-2,-6,8,-4,0,1,-1,-1,1,1,6,-1
KR_6756652306,420,-3,21,-4,-5,-1,1,0,-3,4,1,-2,4,2,-1,3,2,2,0,2,0,-6,0,-3,-2,5,-1,0,-2,1,-1,-1,-1,4,-1
KR_6758922312,420,-4,-64,-25,-1,1,1,2,2,1,3,-3,7,4,-2,3,1,1,0,1,0,3,-8,2,-8,6,5,0,-1,-1,1,-1,1,4,-1
KR_6763105522,420,0,-25,-17,-5,1,1,2,2,1,3,-4,4,0,-2,3,1,-2,2,0,0,-10,-14,-3,-3,6,0,0,0,-1,-1,0,-1,2,-1
KR_6760373999,420,0,-81,1,-2,-1,4,3,1,3,4,2,1,3,-4,7,3,0,1,1,0,3,-1,-2,-7,9,2,0,-2,-1,-1,-1,1,1,-1
KR_6662022701,420,-2,-10,-16,-7,-1,2,1,-3,6,3,-4,7,3,1,2,3,0,1,1,0,-15,7,4,-7,3,-7,0,0,-1,1,-1,-1,3,-1
KR_6756776928,420,-2,-59,13,3,-1,2,1,0,2,2,1,0,1,3,2,5,0,0,0,0,6,-2,1,-9,8,4,0,-2,-1,1,-1,-1,6,-1
KR_6759817075,440,-1,-24,24,-7,-4,6,2,2,0,2,-2,3,1,-1,3,2,-2,2,0,-1,-3,11,-1,-2,3,-1,0,-1,-1,0,-1,-1,2,-1
KR_6756238894,420,5,70,-11,10,2,2,4,-4,4,0,7,1,8,4,5,9,1,1,2,0,0,0,2,-10,8,5,0,2,1,-1,1,1,1,-1
KR_6764140621,420,-1,-85,4,-4,-5,5,0,1,4,5,-2,2,0,3,2,5,-1,1,0,0,0,110,0,-4,4,2,0,0,1,-1,0,-1,1,-1
KR_6668786918,420,-1,7,7,-6,0,2,2,-6,8,2,0,3,3,0,3,3,0,0,0,0,-8,41,2,-8,6,-3,0,2,-1,1,1,-1,2,-1
KR_6735275854,420,-2,-28,20,-11,-1,2,1,-2,2,0,-3,4,1,-3,9,6,-2,3,1,0,-7,1,-4,-5,9,-6,0,-1,-1,-1,-1,-1,1,-1
KR_6742346682,420,-3,-40,-4,-12,1,2,3,2,0,2,-5,7,2,-9,9,0,-1,1,0,-1,-15,4,2,-8,6,-4,0,-2,-1,-1,-1,-1,3,-1
KR_6719921917,420,-4,-53,-1,-15,-2,3,1,-4,4,0,-3,4,1,-4,8,4,-2,2,0,1,-14,11,6,-9,3,-6,0,-1,0,1,-1,1,0,-1
KR_6764166861,420,2,17,23,1,-1,2,1,5,3,8,-3,4,1,2,0,2,-2,2,0,0,1,-32,-3,-3,6,4,0,0,1,-1,0,-1,1,-1
KR_6742525886,440,-1,67,24,-7,0,1,1,-4,4,0,0,0,0,-2,2,0,-1,1,0,0,-12,4,0,-5,5,-2,0,0,-1,1,0,1,4,-1
KR_6765053161,420,-6,-46,2,-19,0,1,1,-4,6,2,-4,5,1,-8,8,0,-3,4,1,0,-20,-13,-2,-2,4,-2,0,0,0,-1,-1,-1,0,-1
KR_6763627471,420,-3,-67,-28,-7,-2,3,1,-2,4,2,0,2,2,-2,4,2,-1,1,0,0,-5,33,1,-4,3,-24,0,-2,1,-1,-1,-1,3,-1
KR_6730665131,420,-9,-122,-27,-14,-1,2,1,-5,5,0,-5,8,3,-2,2,0,-1,1,0,0,-16,-53,-7,-3,10,2,0,-6,-1,-1,-1,-1,4,-1
KR_6753462826,420,3,18,9,-1,0,1,1,1,2,3,0,3,3,-2,4,2,0,0,0,0,-12,3,1,-6,5,6,0,0,1,-1,0,1,5,-1
KR_6702756493,420,-2,-17,19,1,-4,5,1,1,2,3,-2,3,1,3,1,4,3,3,6,0,10,17,7,-7,0,-3,0,0,1,-1,0,-1,3,-1
KR_6759343765,420,0,27,8,0,4,0,4,0,1,1,0,2,2,-5,5,0,1,0,1,0,-1,26,1,-4,3,2,0,2,-1,1,1,1,5,-1
KR_6746211379,420,0,-28,-4,-3,-1,1,0,3,0,3,0,2,2,-4,7,3,-1,1,0,0,-8,8,-1,-6,7,-8,0,-1,1,1,-1,-1,6,-1
KR_6339126914,420,-6,-97,-24,-13,-4,4,0,1,2,3,-2,6,4,-7,8,1,-1,1,0,1,-15,6,-3,-4,7,-5,0,-1,-1,-1,-1,1,3,-1
KR_6764936401,420,-3,-46,6,-3,1,0,1,-5,6,1,2,2,4,-1,1,0,0,0,0,0,-2,-1,-3,-4,7,4,0,-3,-1,-1,-1,1,1,-1
KR_6509446110,420,2,8,17,-4,1,0,1,2,2,4,-2,3,1,-2,4,2,-3,3,0,0,-13,0,2,-11,9,4,0,0,-1,1,0,-1,1,-1
KR_6416930931,420,0,-33,-16,-8,-2,2,0,-3,5,2,-1,2,1,-4,5,1,2,0,2,0,-10,-16,-4,-3,7,-1,0,-2,-1,-1,-1,-1,4,-1
KR_6749306217,420,-2,-37,-26,-1,-1,1,0,-4,6,2,5,0,5,-1,3,2,0,1,1,-1,-1,1,1,-5,4,2,0,0,1,-1,1,-1,1,-1
KR_6759769068,420,1,101,-12,-9,-1,1,0,1,1,2,0,2,2,-8,12,4,-1,3,2,1,-21,-6,-1,-5,6,-4,0,0,1,1,1,1,5,-1
KR_6679219928,420,-4,-74,-28,-9,-1,2,1,-2,5,3,0,1,1,-3,4,1,-3,3,0,0,-6,6,1,-6,5,-6,0,0,1,-1,-1,-1,5,-1
KR_6763440169,420,2,22,9,3,0,1,1,1,3,4,0,0,0,3,1,4,-1,1,0,-1,6,-83,1,-6,5,1,0,-1,0,0,-1,-1,0,-1
KR_6715487264,420,-1,10,-22,-3,0,2,2,-2,4,2,2,1,3,-3,5,2,0,1,1,0,-5,-14,-3,-5,8,-2,0,0,1,-1,0,-1,2,-1
KR_6756877737,420,3,-30,32,2,0,0,0,-2,5,3,-2,4,2,8,2,10,-2,2,0,0,6,18,1,-5,4,3,0,-1,1,-1,-1,-1,3,-1
KR_6751166975,420,-2,-33,-21,-7,1,3,4,-3,8,5,-4,5,1,-1,5,4,0,4,4,-2,-25,-32,3,-10,7,-4,0,1,-1,1,1,-1,6,-1
KR_6716287324,420,0,26,4,-3,-1,3,2,1,3,4,-1,3,2,-3,5,2,1,0,1,1,-1,15,-1,-5,6,-5,0,0,-1,-1,1,1,6,-1
KR_6688485109,420,-1,-37,-4,-4,4,0,4,3,2,5,-6,6,0,-7,7,0,2,0,2,0,-17,-5,2,-6,4,-2,0,0,1,-1,-1,-1,2,-1
KR_6714651775,440,-2,-41,-28,2,1,0,1,0,2,2,-2,2,0,1,1,2,2,0,2,0,6,22,-1,-2,3,-2,0,-1,0,0,-1,1,0,-1
KR_6759946529,440,-2,-40,0,-4,-9,9,0,0,2,2,3,0,3,1,2,3,1,1,2,0,-2,6,-2,-4,6,-3,0,0,-1,1,-1,1,4,-1
KR_6735348370,420,-2,-1,5,-5,0,2,2,-5,5,0,-2,3,1,1,2,3,1,1,2,0,-7,-46,0,-5,5,-3,0,1,-1,-1,1,1,6,-1
KR_6759463296,420,1,12,8,-1,0,1,1,2,2,4,-3,6,3,2,0,2,-2,2,0,0,4,7,-5,-2,7,-4,0,0,-1,-1,0,-1,1,-1
KR_6759672698,420,1,30,-24,1,-2,3,1,-4,6,2,6,0,6,0,2,2,1,0,1,0,1,-105,2,-5,3,1,0,1,-1,-1,1,1,6,-1
KR_6735378749,420,-3,-12,17,-11,-3,4,1,-4,4,0,0,3,3,-4,4,0,0,0,0,-1,-18,-1,4,-8,4,-4,0,-1,0,-1,-1,-1,0,-1
KR_6760150236,420,3,7,29,3,1,0,1,6,0,6,-7,8,1,3,5,8,0,2,2,0,7,23,3,-7,4,-2,0,1,0,-1,1,-1,0,-1
KR_6760490139,420,0,-3,-14,2,4,1,5,-2,5,3,-3,6,3,2,2,4,1,1,2,0,8,-9,0,-5,5,-3,0,-1,-1,1,-1,1,3,-1
KR_6763518947,420,0,-22,3,-5,-5,6,1,-2,3,1,2,2,4,-1,1,0,1,0,1,0,3,4,-3,-5,8,-7,0,-1,-1,-1,-1,-1,1,-1
KR_6669821238,420,-4,-68,-7,-13,-5,5,0,-5,6,1,-2,3,1,0,2,2,-1,2,1,-1,-7,-1,-1,-8,9,-1,0,-2,-1,-1,-1,-1,2,-1
KR_6727042706,420,-1,-60,35,-7,0,2,2,-3,4,1,0,1,1,-5,5,0,1,0,1,0,-5,-1,-1,-4,5,-3,0,-1,0,-1,-1,-1,0,-1
KR_6732401668,420,0,-61,-8,-1,0,3,3,-3,3,0,0,3,3,-1,2,1,3,0,3,0,4,13,0,-4,4,-1,0,0,-1,1,1,1,2,-1
KR_6761444531,420,-1,-43,9,-2,-2,3,1,1,1,2,0,2,2,-1,7,6,0,0,0,0,-3,-6,0,-5,5,3,0,0,0,-1,-1,-1,0,-1
KR_6763808396,420,-1,-45,-27,2,0,1,1,0,3,3,0,6,6,2,2,4,0,0,0,0,1,0,5,-10,5,-5,0,0,-1,-1,0,1,6,-1
KR_6505042408,420,-6,-31,-29,-12,1,0,1,-6,9,3,1,1,2,-4,6,2,-4,6,2,0,-11,-14,0,-5,5,-2,0,-2,-1,-1,-1,-1,1,-1
KR_6730764296,420,-6,-12,-13,-12,-2,2,0,-5,7,2,-6,6,0,1,1,2,0,1,1,0,-23,-29,-2,-6,8,0,0,-2,-1,-1,-1,1,6,-1
KR_6712054557,420,-5,-23,-20,-11,-4,5,1,-2,5,3,-3,6,3,-1,2,1,-1,2,1,-2,-17,-36,-5,-2,7,3,0,0,1,-1,0,-1,4,-1
KR_6712960614,420,-6,-54,-11,-10,0,1,1,-6,7,1,-1,5,4,-1,2,1,-2,4,2,0,-9,9,-6,-3,9,3,0,-2,-1,-1,-1,1,3,-1
KR_6764875876,440,-4,-128,-7,1,-4,4,0,1,5,6,8,2,10,0,3,3,-4,4,0,-1,-4,1,2,-6,4,-9,0,0,0,-1,-1,-1,0,-1
KR_6602182749,420,1,21,11,-1,-1,1,0,0,3,3,1,2,3,0,0,0,-1,1,0,0,-7,151,0,-7,7,-2,0,1,-1,1,1,1,3,-1
KR_6733760677,420,0,-71,-9,-2,-3,5,2,5,0,5,-3,4,1,-2,4,2,1,0,1,0,-3,-27,-1,-3,4,-2,0,0,-1,1,0,-1,4,-1
KR_6757345691,420,-5,-57,-24,-11,2,0,2,5,2,7,-16,18,2,-2,4,2,0,1,1,-1,0,-29,2,-4,2,19,0,-1,-1,1,-1,-1,5,-1
KR_6741728704,420,-3,-11,-27,-1,-4,4,0,6,1,7,2,3,5,-4,5,1,-1,3,2,0,-1,-3,1,-3,2,-1,0,0,0,-1,-1,-1,0,-1
KR_6760220267,420,-1,7,8,-3,-1,1,0,-4,6,2,-2,4,2,4,2,6,0,1,1,0,-8,2,2,-7,5,-4,0,1,-1,1,1,-1,2,-1
KR_6758573316,420,0,-40,-12,-5,-2,3,1,1,2,3,-3,3,0,-1,3,2,0,0,0,0,-4,18,1,-6,5,-5,0,-1,1,-1,-1,1,1,-1
KR_6676091812,440,-3,-36,4,-6,-1,4,3,2,1,3,0,2,2,-4,5,1,-3,4,1,0,-5,180,-2,-4,6,-3,0,-1,-1,-1,-1,-1,1,-1
KR_6671270995,420,0,1,-16,6,3,5,8,0,1,1,3,1,4,1,2,3,-1,1,0,1,9,-5,1,-5,4,-5,0,1,-1,1,1,1,1,-1
KR_6721253087,420,-2,-8,-8,-9,-1,1,0,-5,5,0,-1,3,2,-3,5,2,1,1,2,0,-11,-2,-4,-3,7,0,0,0,-1,1,1,-1,5,-1
KR_6752664258,420,-4,-24,-16,-6,1,2,3,-5,7,2,-5,7,2,3,0,3,0,2,2,-3,-7,2,0,-5,5,-4,0,-2,-1,0,-1,-1,5,-1
KR_6725604503,420,-2,5,-25,-7,0,2,2,-2,4,2,-1,3,2,-3,7,4,-1,2,1,-1,-8,55,-2,-4,6,-21,0,0,-1,-1,-1,-1,5,-1
KR_6761225917,420,-4,-76,20,-7,-2,2,0,-2,5,3,-1,4,3,-2,5,3,0,0,0,0,-14,4,1,-7,6,-1,0,0,1,1,0,-1,4,-1
KR_6763691818,420,-2,6,-27,-6,2,1,3,-5,5,0,0,3,3,-2,3,1,-1,1,0,0,-19,8,-3,-6,9,-4,0,-2,-1,-1,-1,-1,2,-1
KR_6760465783,420,-1,-54,16,-8,-4,4,0,-1,3,2,0,1,1,1,1,2,-4,5,1,0,-9,0,0,-5,5,-6,0,1,-1,-1,1,-1,1,-1
KR_6764873528,420,-1,51,-36,-1,4,0,4,-3,3,0,-2,3,1,-1,4,3,1,0,1,0,0,7,0,-5,5,0,0,0,-1,-1,-1,1,3,-1
KR_6742202949,420,4,-3,36,5,-5,6,1,2,1,3,6,0,6,1,0,1,1,0,1,0,0,6,0,-4,4,2,0,1,-1,1,1,1,1,-1
KR_6762613272,420,-5,-37,-10,-18,-3,6,3,0,1,1,-5,8,3,-5,6,1,-5,5,0,0,-23,-7,4,-8,4,-8,0,-3,-1,-1,-1,1,2,-1
KR_6763333869,420,-1,58,-19,3,-1,2,1,3,0,3,-2,4,2,4,2,6,-1,1,0,0,8,-1,1,-7,6,0,0,-1,-1,-1,-1,1,2,-1
KR_6663992253,440,-7,-166,-36,-11,-9,9,0,-4,8,4,1,0,1,3,0,3,-2,3,1,0,2,-4,-2,-4,6,-4,0,-2,-1,1,-1,-1,5,-1
KR_6738342234,420,-4,-20,-12,-11,0,0,0,-6,6,0,-2,2,0,-1,2,1,-2,3,1,0,-22,57,-3,-3,6,-4,0,-2,-1,-1,-1,-1,1,-1
KR_6739398113,420,-4,-42,-24,-11,-5,5,0,-1,1,0,-5,8,3,1,3,4,-1,1,0,0,-19,-42,-4,-3,7,-1,0,-1,-1,-1,-1,1,4,-1
KR_6729738153,420,1,46,-4,5,-1,4,3,-1,4,3,2,1,3,4,0,4,1,1,2,0,5,-13,2,-6,4,0,0,0,1,-1,0,1,3,-1
KR_6756908065,420,-4,-29,-38,-1,1,1,2,0,2,2,0,2,2,-3,4,1,1,0,1,0,6,18,7,-10,3,4,0,0,-1,-1,0,-1,6,-1
KR_6648413828,420,-2,-113,8,0,0,0,0,4,2,6,0,1,1,-4,4,0,0,1,1,1,-3,35,1,-6,5,-3,0,-1,-1,-1,-1,1,4,-1
KR_6707960493,420,-1,-44,-20,5,0,1,1,6,4,10,1,0,1,-3,4,1,1,0,1,0,2,55,2,-8,6,3,0,-1,-1,-1,-1,1,3,-1
KR_6764310704,440,-3,10,-44,-3,0,1,1,-2,3,1,4,0,4,-4,5,1,-1,1,0,0,-2,-7,-1,-2,3,-2,0,-1,-1,-1,-1,-1,2,-1
KR_6755501404,440,-2,-12,-9,-8,0,0,0,-4,4,0,-1,1,0,1,2,3,-4,5,1,0,-7,8,3,-5,2,-5,0,0,-1,1,0,-1,4,-1
KR_6763298977,420,1,29,0,-1,1,0,1,-1,2,1,1,4,5,-3,3,0,1,0,1,0,-5,-19,0,-6,6,0,0,0,1,1,0,1,2,-1
KR_6740585117,420,1,53,7,-3,2,0,2,-3,9,6,0,3,3,-1,4,3,-1,1,0,0,-7,-52,3,-7,4,20,0,0,-1,-1,0,1,1,-1
KR_6717599976,420,-5,-107,14,-6,-3,5,2,-1,3,2,1,2,3,-3,4,1,0,0,0,0,1,34,0,-5,5,0,0,-1,-1,-1,-1,-1,5,-1
KR_6742481041,420,-7,-50,-36,-12,-2,5,3,-1,2,1,-4,5,1,-2,2,0,-3,3,0,0,-8,-4,-2,-1,3,-3,0,-1,-1,-1,-1,-1,6,-1
KR_6745263709,440,-1,-14,-4,-2,4,0,4,0,2,2,-5,6,1,-3,3,0,2,2,4,0,-9,-15,0,-3,3,-2,0,-1,0,0,-1,-1,0,-1
KR_6650592781,420,1,47,-29,3,4,0,4,-3,6,3,0,2,2,3,1,4,-1,1,0,0,-2,-25,4,-8,4,-2,0,1,-1,-1,1,1,4,-1
KR_6764204159,420,-6,-24,-1,-14,-3,3,0,-5,5,0,-2,4,2,-3,4,1,-1,3,2,0,-14,-9,-3,-2,5,3,0,0,-1,1,-1,-1,2,-1
KR_6756460678,420,0,-16,4,4,-2,3,1,3,3,6,3,4,7,-1,4,3,1,1,2,-1,-2,-18,-7,-2,9,3,0,1,1,1,1,-1,3,-1
KR_6639852732,420,-7,-30,-21,-8,2,2,4,-11,11,0,0,1,1,-1,5,4,2,0,2,1,-7,8,2,-9,7,-1,0,-3,-1,-1,-1,1,1,-1
KR_6747468910,440,1,-15,36,-2,1,0,1,-3,3,0,-1,1,0,0,0,0,1,0,1,0,-4,1,1,-5,4,-4,0,0,-1,-1,-1,-1,2,-1
KR_6475339772,420,4,14,-20,6,-1,3,2,7,0,7,2,1,3,-3,4,1,1,2,3,0,5,-3,1,-4,3,1,0,1,-1,1,1,-1,3,-1
KR_6744488649,440,0,7,13,1,-2,2,0,-3,3,0,-1,4,3,4,2,6,3,0,3,0,2,-2,-3,-3,6,-1,0,-1,1,1,-1,1,5,-1
KR_6749592539,420,-3,3,-9,-2,1,0,1,1,1,2,-5,6,1,4,1,5,-3,5,2,0,-10,-24,6,-10,4,2,0,-1,-1,-1,-1,1,4,-1
KR_6718134044,420,-7,-138,29,-8,-2,2,0,1,3,4,1,1,2,-8,8,0,0,0,0,0,-9,25,2,-7,5,-3,0,-2,-1,1,-1,-1,4,-1
KR_6760864614,420,2,18,-4,3,-4,6,2,-4,4,0,8,1,9,3,0,3,0,2,2,1,-1,1,-2,-4,6,-2,0,-1,1,-1,-1,1,1,-1
KR_6633963116,420,1,13,28,1,1,0,1,2,3,5,-1,3,2,0,2,2,-1,2,1,1,-3,16,3,-7,4,-3,0,1,-1,1,1,1,3,-1
KR_6642471432,420,-3,-96,-1,-4,-1,1,0,1,3,4,1,3,4,-2,2,0,-3,3,0,0,-7,-53,-2,-4,6,16,0,-2,-1,-1,-1,-1,3,-1
KR_6734210993,420,0,-45,12,-6,-3,4,1,-1,1,0,3,2,5,-4,8,4,-1,1,0,0,-22,-1,-2,-5,7,-3,0,0,-1,1,0,1,6,-1
KR_6734740781,420,0,16,1,-3,-3,5,2,6,0,6,-4,8,4,-1,1,0,-1,1,0,1,2,12,-1,-4,5,7,0,-1,-1,-1,-1,1,6,-1
KR_6699747638,420,-4,-107,2,-5,-3,3,0,2,4,6,2,0,2,-4,5,1,-2,4,2,0,-3,-14,1,-6,5,-6,0,-1,-1,-1,-1,-1,3,-1
KR_6661605865,420,2,-5,13,2,-1,1,0,-1,4,3,6,2,8,-1,3,2,-1,1,0,0,-3,101,-4,-2,6,3,0,0,1,1,1,-1,5,-1
KR_6761312856,420,-5,-50,-31,-5,-4,6,2,-3,5,2,-2,4,2,3,1,4,1,0,1,0,-1,23,-6,-5,11,1,0,-1,1,-1,-1,-1,2,-1
KR_6670677550,420,-3,-11,16,-1,0,2,2,0,2,2,-1,3,2,-1,2,1,1,2,3,0,0,-10,-3,-5,8,2,0,-1,1,-1,-1,1,3,-1
KR_6683468231,420,-3,-4,-53,-4,-1,2,1,-2,4,2,-2,3,1,2,0,2,-1,1,0,0,-1,119,-1,-4,5,2,0,-1,-1,-1,-1,-1,5,-1
KR_6695050265,420,-6,-84,7,-9,-1,2,1,-2,7,5,0,2,2,-8,9,1,2,0,2,0,-15,-8,-4,0,4,3,0,-2,-1,0,-1,1,3,-1
KR_6628656515,420,-4,-49,-15,-4,-3,3,0,-3,7,4,-2,5,3,3,2,5,1,0,1,0,-11,9,3,-6,3,-1,0,-2,1,-1,-1,1,4,-1
KR_6764472038,420,-3,-114,-21,-6,-2,3,1,-1,4,3,-6,6,0,1,1,2,2,2,4,0,-3,13,1,-6,5,0,0,-3,-1,-1,-1,-1,6,-1
KR_6762419439,420,0,-65,-11,0,1,2,3,-3,5,2,3,1,4,3,0,3,-4,4,0,0,-5,-13,6,-8,2,-6,0,0,1,1,1,-1,4,-1
KR_6748158186,420,-4,14,-15,-6,-1,3,2,-2,2,0,2,4,6,-3,7,4,-2,2,0,-1,-6,1,-2,-3,5,3,0,0,0,-1,0,-1,0,-1
KR_6734769569,420,-1,-12,-18,-6,2,0,2,2,1,3,-13,13,0,3,1,4,0,1,1,1,-3,-3,-3,-6,9,5,0,0,-1,1,1,1,3,-1
KR_6762062617,420,-2,-1,5,-13,-2,3,1,-4,6,2,-4,4,0,-3,4,1,0,3,3,0,-16,3,-2,-4,6,2,0,0,1,-1,0,-1,3,-1
KR_6539037863,420,-1,-2,16,2,-3,3,0,-3,5,2,5,0,5,2,1,3,1,0,1,0,6,-15,1,-7,6,0,0,-1,-1,1,-1,-1,2,-1
KR_6621681116,420,-1,-39,16,-3,-2,2,0,1,1,2,-1,1,0,-2,3,1,1,0,1,0,-4,0,-4,-3,7,0,0,0,1,1,0,-1,1,-1
KR_6754521921,420,0,-48,12,-7,-2,3,1,1,2,3,2,3,5,-9,12,3,1,0,1,-1,-17,-19,1,-5,4,-3,0,-2,-1,-1,-1,-1,2,-1
KR_6693714058,420,-4,-34,-42,-12,1,2,3,0,3,3,-6,8,2,-7,7,0,0,0,0,0,-8,6,2,-5,3,0,0,-3,-1,-1,-1,-1,1,-1
KR_6641802124,440,1,-3,-24,10,-1,1,0,0,2,2,6,0,6,5,0,5,0,1,1,1,15,-5,0,-6,6,6,0,0,1,-1,1,1,2,-1
KR_6643686952,420,-4,-33,34,-4,-3,3,0,1,1,2,-2,6,4,1,1,2,-1,2,1,0,1,-19,2,-7,5,-3,0,0,1,1,0,1,5,-1
KR_6750459995,420,-3,-59,4,-12,1,4,5,1,1,2,-8,8,0,-6,6,0,0,0,0,0,-2,2,-2,-1,3,0,0,-1,-1,-1,-1,-1,5,-1
KR_6754867232,420,-3,-38,-11,-7,-2,3,1,-2,4,2,-1,5,4,0,3,3,-2,2,0,0,-14,-6,-1,-3,4,2,0,0,0,0,0,-1,0,-1
KR_6754355182,420,0,36,0,-4,1,0,1,1,2,3,-4,5,1,-3,4,1,1,0,1,0,-6,18,-3,-4,7,2,0,0,-1,-1,-1,-1,1,-1
KR_6410601012,420,-1,-36,-13,3,1,0,1,0,1,1,3,1,4,-3,7,4,2,2,4,0,2,4,3,-6,3,0,0,0,-1,1,0,-1,4,-1
KR_6678048963,420,1,-32,-9,4,2,1,3,-2,8,6,1,2,3,1,1,2,2,1,3,0,3,-7,4,-6,2,0,0,-2,0,-1,-1,1,0,-1
KR_6415163692,420,1,21,23,-4,-2,2,0,1,0,1,0,2,2,-1,1,0,-2,2,0,0,-1,34,-4,-2,6,2,0,1,-1,1,1,-1,4,-1
KR_6628506703,420,4,41,35,6,2,1,3,3,1,4,-2,4,2,0,2,2,3,0,3,0,1,161,-2,-3,5,3,0,1,1,1,1,-1,4,-1
KR_6757829373,420,-5,-86,0,-6,-2,4,2,-1,5,4,0,3,3,-2,6,4,-1,1,0,-1,-11,-2,0,-6,6,4,0,0,-1,1,0,-1,2,-1
KR_6764658600,440,2,55,-12,-1,4,0,4,0,2,2,-8,8,0,3,0,3,0,1,1,0,3,3,1,-5,4,-1,0,-1,0,-1,-1,-1,0,-1
KR_6764723944,420,-2,-34,2,-7,-4,4,0,1,0,1,-2,3,1,-2,6,4,0,1,1,0,-12,55,-1,-3,4,-22,0,-1,-1,-1,-1,-1,1,-1
KR_6730294930,440,-3,-38,-12,-7,2,2,4,-3,4,1,-6,6,0,0,1,1,0,0,0,0,-9,-4,0,-5,5,-1,0,0,-1,-1,-1,1,5,-1
KR_6764103708,420,1,-69,33,1,0,1,1,2,4,6,1,0,1,-2,2,0,0,1,1,0,4,5,0,-6,6,-4,0,-1,1,1,-1,-1,1,-1
KR_6764247039,420,-4,-79,-3,-11,-1,3,2,0,1,1,0,0,0,-4,5,1,-6,9,3,-1,-2,-3,-7,-1,8,2,0,-3,1,-1,-1,-1,2,-1
KR_6752214723,420,-1,7,-15,2,1,0,1,2,3,5,0,3,3,1,11,12,-2,6,4,-2,1,3,6,-7,1,-1,0,-1,-1,-1,-1,-1,5,-1
KR_6748930755,420,1,106,-5,1,6,0,6,-1,6,5,-2,4,2,-1,3,2,-1,2,1,-1,8,1,-3,-5,8,0,0,0,-1,-1,1,-1,4,-1
KR_6745594167,420,3,-23,11,3,0,0,0,4,2,6,2,1,3,-2,6,4,-1,2,1,0,5,-2,-2,-4,6,-3,0,0,-1,-1,0,1,4,-1
KR_6754946932,420,2,42,-4,3,2,1,3,1,1,2,-1,1,0,1,1,2,0,0,0,1,4,13,2,-5,3,0,0,1,-1,0,1,1,2,-1
KR_6741402287,420,0,-3,1,0,-1,1,0,2,3,5,-2,3,1,1,0,1,0,0,0,0,2,-6,0,-4,4,2,0,-2,1,-1,-1,1,6,-1
KR_6761640939,420,-4,-67,20,-7,0,1,1,-2,2,0,0,2,2,-3,4,1,-2,2,0,0,-17,-2,6,-7,1,1,0,0,1,-1,-1,-1,1,-1
KR_6719989778,420,-2,-25,20,-1,3,0,3,1,1,2,-1,4,3,-6,8,2,2,2,4,0,-5,-24,1,-8,7,-8,0,-2,-1,1,-1,1,5,-1
KR_6761491923,420,-1,-55,35,-4,-1,1,0,0,3,3,-4,6,2,0,1,1,1,0,1,0,-4,-2,2,-7,5,5,0,0,1,-1,0,1,4,-1
KR_6624743687,420,-1,-19,25,-10,1,0,1,-4,9,5,-2,3,1,-3,6,3,-2,2,0,0,-21,2,-3,-4,7,5,0,1,-1,1,-1,1,5,-1
KR_6705498686,420,-4,-112,12,-12,-4,5,1,-2,6,4,0,2,2,-4,7,3,-2,2,0,0,-5,3,2,-8,6,-9,0,-3,-1,-1,-1,-1,1,-1
KR_6761626742,440,-1,-29,-11,-5,1,2,3,-4,6,2,-8,9,1,1,0,1,5,5,10,-1,2,-14,-4,-3,7,0,0,-2,-1,-1,-1,1,4,-1
KR_6744715984,420,-3,-57,-12,-8,2,1,3,1,4,5,0,2,2,-7,7,0,-4,4,0,0,-10,10,0,-3,3,-6,0,-1,1,1,-1,-1,2,-1
KR_6751333741,440,-2,-47,-48,-1,0,1,1,-3,5,2,-2,6,4,4,1,5,0,1,1,0,-4,2,0,-3,3,-1,0,-1,-1,1,-1,1,4,-1
KR_6762464292,420,-3,-14,-6,-11,-5,5,0,-4,4,0,-1,3,2,0,2,2,-1,1,0,0,-1,17,0,-5,5,5,0,0,-1,1,-1,-1,1,-1
KR_6759957801,420,-1,-54,37,-7,0,3,3,-2,3,1,-1,1,0,-6,7,1,2,1,3,0,-1,0,-1,-5,6,0,0,-1,-1,-1,-1,1,6,-1
KR_6761582055,440,-1,-30,9,2,-2,6,4,-6,6,0,7,0,7,6,2,8,-3,3,0,0,2,-256,0,-2,2,0,0,0,1,-1,0,-1,1,-1
KR_6726366279,420,-4,-112,10,-12,-6,6,0,0,2,2,-2,6,4,0,2,2,-4,4,0,-1,-9,103,0,-4,4,-4,0,-1,1,0,-1,-1,3,-1
KR_6756573142,440,-7,-65,-28,-19,-3,4,1,-8,9,1,-4,5,1,-4,4,0,0,2,2,0,-19,-4,-1,-1,2,2,0,-1,0,0,-1,1,0,-1
KR_6758563710,420,0,34,36,-3,-2,3,1,-1,5,4,6,0,6,-4,4,0,-2,2,0,0,-8,-112,-5,-1,6,3,0,-1,-1,1,-1,-1,1,-1
KR_6743937246,420,1,-6,-4,-2,1,4,5,0,2,2,1,1,2,-4,6,2,0,1,1,0,-1,0,2,-5,3,0,0,-2,1,-1,-1,1,3,-1
KR_6726252824,420,2,40,-8,-2,1,1,2,1,2,3,0,3,3,-2,5,3,-2,3,1,0,-8,18,-4,-1,5,2,0,1,-1,-1,1,-1,6,-1
KR_6724940932,420,-4,-57,-16,-4,1,1,2,-2,2,0,0,2,2,-3,3,0,0,3,3,0,-10,8,5,-9,4,-5,0,0,-1,1,-1,-1,4,-1
KR_6759515215,420,1,6,-8,6,2,1,3,5,2,7,3,2,5,0,5,5,-4,4,0,0,8,14,6,-7,1,-2,0,1,0,1,1,-1,0,-1
KR_6727667400,440,-3,11,-5,-9,2,0,2,-3,4,1,-2,4,2,-5,6,1,-1,2,1,-1,-16,279,-2,-7,9,-3,0,-1,-1,0,-1,1,1,-1
KR_6738810097,420,-4,-27,-43,-4,1,1,2,-4,4,0,-4,4,0,1,6,7,2,1,3,0,-3,-9,-4,-4,8,-3,0,-1,-1,1,-1,1,5,-1
KR_6724853946,440,-8,-105,-30,-8,-1,1,0,0,2,2,-2,7,5,-2,2,0,-3,7,4,0,-9,-20,0,-4,4,-2,0,0,-1,0,-1,1,2,-1
KR_6702588710,420,2,81,33,-2,2,0,2,3,1,4,1,1,2,-6,6,0,-2,3,1,0,-5,-7,-4,-5,9,3,0,2,1,1,1,-1,5,-1
KR_6671420484,420,-3,-66,1,-14,-6,7,1,-2,4,2,0,4,4,-5,7,2,-1,2,1,0,-28,-7,-7,-3,10,-1,0,-1,1,-1,-1,-1,3,-1
KR_6742426139,420,-3,-29,-16,-5,1,1,2,-1,1,0,-2,2,0,-2,2,0,-1,1,0,0,-6,9,5,-9,4,-9,0,-2,-1,1,-1,-1,6,-1
KR_6744076450,420,0,-52,-22,0,0,2,2,2,0,2,1,3,4,-3,4,1,0,1,1,0,3,-1,-5,-5,10,0,0,-1,-1,1,-1,1,6,-1
KR_6697909054,420,-2,-7,-24,6,1,1,2,1,1,2,0,1,1,5,4,9,-1,2,1,0,3,-6,-4,-1,5,3,0,0,1,1,0,1,1,-1
KR_6762716962,420,-5,-65,6,-6,0,2,2,-3,6,3,1,3,4,-3,3,0,-1,1,0,1,-15,7,2,-6,4,2,0,0,-1,1,0,1,5,-1
KR_6762522216,420,-1,-23,13,-4,-1,1,0,4,2,6,-3,6,3,-4,5,1,0,1,1,0,6,-1,1,-6,5,-3,0,-1,-1,1,-1,1,4,-1
KR_6720415869,420,0,-27,3,-4,-4,5,1,-2,3,1,-4,4,0,2,1,3,4,0,4,-1,3,7,-10,0,10,0,0,0,1,-1,-1,-1,2,-1
KR_6749343899,420,-4,-61,-4,-13,-1,3,2,-3,3,0,-5,6,1,-4,6,2,0,1,1,0,-16,-14,-4,-2,6,-4,0,0,0,-1,-1,-1,0,-1
KR_6697635173,420,-1,-27,3,2,-1,4,3,3,1,4,-2,3,1,-2,3,1,4,0,4,0,10,-1,0,-6,6,1,0,0,-1,-1,-1,-1,2,-1
KR_6381941620,420,1,-17,-29,-4,2,1,3,-4,6,2,-6,6,0,2,0,2,2,0,2,0,-4,12,1,-8,7,0,0,-1,1,-1,-1,1,3,-1
KR_6743325351,420,-5,-38,-15,-14,-2,4,2,-2,6,4,-1,2,1,-4,7,3,-5,5,0,0,-10,9,-1,-3,4,-6,0,-1,0,-1,-1,-1,0,-1
KR_6749619710,420,-6,-11,-32,-11,0,2,2,-3,4,1,-4,5,1,-3,4,1,-1,2,1,0,-12,-3,0,-5,5,-3,0,0,-1,1,0,-1,2,-1
KR_6536027280,420,-2,-28,-6,-10,-1,3,2,-1,6,5,-3,3,0,-7,7,0,2,0,2,0,-16,-15,-2,-4,6,2,0,-1,1,-1,-1,1,6,-1
KR_6713760459,440,0,-56,-41,4,0,3,3,3,0,3,-1,3,2,0,1,1,2,0,2,0,11,4,2,-8,6,0,0,0,1,-1,0,1,3,-1
KR_6688045947,420,-1,-9,15,-7,-2,4,2,-5,9,4,-1,1,0,1,2,3,0,1,1,0,-2,37,-2,-4,6,-12,0,-1,-1,-1,-1,-1,6,-1
KR_6754827661,420,0,-3,-6,-2,0,1,1,4,1,5,0,1,1,-6,6,0,0,2,2,0,2,17,-3,-2,5,-8,0,0,1,-1,0,-1,5,-1
KR_6751423046,420,-3,-76,11,-4,0,3,3,1,2,3,-1,2,1,0,2,2,-4,4,0,1,-5,-5,-1,-2,3,-1,0,-1,-1,-1,-1,1,4,-1
KR_6632407549,420,-1,-3,-15,-6,-3,4,1,-1,2,1,-5,8,3,4,1,5,-1,1,0,0,-2,9,6,-8,2,-5,0,0,-1,-1,-1,-1,6,-1
KR_6749544144,420,-1,14,2,-9,0,0,0,1,0,1,1,1,2,-10,10,0,-1,1,0,-1,-6,-27,3,-9,6,-4,0,0,-1,-1,1,-1,4,-1
KR_6758483048,420,-2,-46,0,4,3,0,3,3,4,7,-1,2,1,0,0,0,-1,1,0,2,18,46,1,-5,4,-3,0,-2,-1,1,-1,1,2,-1
KR_6701284999,440,-3,-71,-36,-3,-4,4,0,5,0,5,-2,5,3,-1,1,0,-1,1,0,0,1,-7,-3,-6,9,7,0,0,0,-1,0,1,0,-1
KR_6603410327,420,0,29,30,-1,-2,2,0,0,1,1,3,2,5,-2,4,2,0,0,0,0,0,-82,-4,-3,7,5,0,0,-1,1,1,-1,6,-1
KR_6749407266,420,-5,-83,20,-7,3,0,3,-6,7,1,-1,1,0,-2,3,1,-1,2,1,-1,-10,40,-3,-2,5,4,0,0,-1,1,-1,-1,5,-1
KR_6747417122,420,-2,1,0,3,-1,2,1,-1,2,1,-2,3,1,5,1,6,2,0,2,0,10,-7,0,-6,6,1,0,0,1,-1,-1,-1,6,-1
KR_6728847119,420,-3,-8,-14,-6,-1,3,2,-4,5,1,-2,2,0,1,4,5,0,2,2,1,-8,-3,1,-8,7,-3,0,0,-1,1,1,1,6,-1
KR_6717644543,420,-6,-83,4,-18,-1,4,3,-6,9,3,-4,7,3,-5,8,3,-2,2,0,-1,-19,-16,-2,-2,4,-3,0,-1,-1,1,-1,-1,5,-1
KR_6690696643,420,-4,-9,7,-6,-5,10,5,1,3,4,-1,1,0,-2,2,0,1,2,3,0,-15,13,-2,-5,7,-10,0,1,-1,-1,1,1,3,-1
KR_6685698982,440,-3,-51,-40,-6,-4,5,1,-4,4,0,0,1,1,4,2,6,-2,4,2,0,-9,-79,-3,-2,5,-8,0,0,0,-1,-1,-1,0,-1
KR_6762153674,420,0,85,18,-4,3,3,6,-5,5,0,-1,2,1,-1,2,1,0,0,0,0,-9,15,-2,-6,8,2,0,0,-1,1,1,-1,2,-1
KR_6760416187,420,0,-9,-10,5,2,2,4,-2,4,2,-1,7,6,4,1,5,2,0,2,1,13,8,3,-8,5,1,0,0,-1,1,1,1,4,-1
KR_6763406396,420,-1,12,-16,-5,0,2,2,-2,4,2,-1,2,1,-1,2,1,-1,3,2,-1,-10,-3,0,-7,7,-1,0,-1,-1,1,-1,-1,1,-1
KR_6633496731,420,-4,-46,12,-6,2,2,4,-4,5,1,-1,3,2,-3,6,3,0,2,2,-1,-2,3,5,-10,5,2,0,1,-1,1,1,-1,3,-1
KR_6728130664,420,-1,-18,-4,-2,-3,3,0,-1,3,2,1,2,3,1,0,1,0,0,0,0,1,-6,-2,-4,6,5,0,0,-1,0,0,-1,2,-1
KR_6764606186,420,0,11,7,0,0,3,3,-3,5,2,1,3,4,3,0,3,-1,2,1,1,-2,-12,-3,-2,5,5,0,1,1,-1,1,-1,3,-1
KR_6748843973,420,-2,11,-55,4,0,4,4,3,2,5,-2,2,0,3,0,3,0,0,0,0,8,-5,1,-5,4,1,0,-2,-1,-1,-1,1,3,-1
KR_6764644065,420,-2,-17,-4,5,2,0,2,-3,4,1,2,3,5,4,2,6,0,2,2,0,6,-2,6,-10,4,0,0,0,-1,0,0,1,4,-1
KR_6713802211,420,1,10,-8,-1,0,1,1,0,2,2,0,2,2,1,3,4,-2,4,2,-1,-2,4,-1,-5,6,-1,0,0,1,-1,-1,-1,3,-1
KR_6643801669,420,-1,-41,-24,-6,-1,2,1,0,1,1,-2,5,3,-5,6,1,2,0,2,0,-3,5,2,-6,4,-2,0,1,-1,1,-1,-1,1,-1
KR_6610249505,420,-3,-76,-36,-5,1,1,2,-3,4,1,0,2,2,0,3,3,-3,3,0,0,-6,44,-4,-3,7,5,0,0,-1,1,-1,-1,6,-1
KR_6399421205,420,-4,-54,-13,-7,-1,2,1,0,3,3,-1,4,3,-3,3,0,-2,5,3,0,-8,35,-5,-3,8,-18,0,-1,-1,-1,-1,1,5,-1
KR_6746630507,420,-5,-86,-69,-9,-3,3,0,-1,2,1,5,3,8,-7,8,1,-3,4,1,-1,-12,-8,1,-3,2,0,0,-3,-1,-1,-1,-1,5,-1
KR_6701489600,420,3,8,11,1,0,3,3,-2,4,2,0,1,1,3,1,4,0,0,0,0,-3,-1,-1,-5,6,1,0,1,1,1,1,1,2,-1
KR_6752930835,420,-1,-14,-26,-2,0,2,2,4,1,5,-4,5,1,-1,4,3,-1,3,2,-1,-3,5,-1,-5,6,-1,0,-2,-1,-1,-1,-1,5,-1
KR_6758733529,420,1,-14,-14,1,0,2,2,2,2,4,-2,5,3,1,1,2,0,3,3,0,6,-107,8,-13,5,0,0,0,-1,1,1,-1,3,-1
KR_6761410735,440,1,17,16,4,1,2,3,2,2,4,0,3,3,1,3,4,0,0,0,0,5,7,1,-4,3,-4,0,0,0,0,1,1,0,-1
KR_6641738477,420,1,16,15,-1,0,1,1,-1,4,3,-3,3,0,3,3,6,0,0,0,0,2,-5,-1,-7,8,3,0,1,-1,1,1,1,4,-1
KR_6730177301,440,1,11,26,-2,-3,3,0,0,3,3,-2,3,1,2,4,6,1,2,3,0,-15,-6,-6,-3,9,0,0,1,-1,0,1,-1,4,-1
KR_6763597681,420,0,-40,7,-7,-1,1,0,0,2,2,-3,5,2,-2,3,1,-1,1,0,0,-12,4,-1,-2,3,0,0,-1,-1,-1,-1,1,6,-1
KR_6756460765,420,-3,-39,40,-8,-1,1,0,-6,10,4,-2,4,2,0,4,4,1,2,3,0,-3,-13,-2,-5,7,1,0,0,-1,1,0,-1,4,-1
KR_6624592918,420,-2,-55,-16,-2,-6,7,1,5,0,5,2,2,4,-2,3,1,-1,1,0,0,7,-3,-3,-1,4,0,0,-2,-1,-1,-1,-1,3,-1
KR_6763313888,420,-2,-70,-12,-7,-2,2,0,-5,8,3,-7,9,2,4,2,6,3,1,4,0,4,-4,-6,-2,8,1,0,-1,-1,-1,-1,-1,1,-1
KR_6465565055,420,-3,-36,-3,-2,-2,4,2,2,1,3,-2,3,1,0,0,0,0,0,0,0,0,45,2,-7,5,-7,0,0,1,1,0,1,4,-1
KR_6757026606,420,-1,-43,16,-1,3,0,3,-4,5,1,-1,3,2,1,3,4,0,0,0,-1,-5,4,1,-4,3,-3,0,-1,-1,1,-1,-1,3,-1
KR_6743081951,420,-1,-61,1,-5,0,2,2,-4,6,2,0,2,2,-8,10,2,7,0,7,-1,-4,-2,-1,-8,9,-3,0,0,-1,1,0,-1,4,-1
KR_6764788071,440,-3,-4,-12,-11,-2,5,3,-4,7,3,-1,3,2,-4,6,2,0,1,1,0,-17,-41,-2,-9,11,1,0,-1,-1,1,-1,1,6,-1
KR_6692058546,420,-5,-83,-6,-7,-5,5,0,-1,2,1,-3,4,1,0,3,3,2,1,3,-1,-3,2,4,-10,6,0,0,0,-1,-1,-1,-1,2,-1
KR_6642104667,420,-3,-71,-4,-2,1,1,2,-3,5,2,0,2,2,0,3,3,0,1,1,0,4,-7,1,-6,5,1,0,0,1,-1,0,1,4,-1
KR_6742009015,420,-4,-13,-16,-7,0,1,1,-1,2,1,-6,9,3,-2,2,0,2,1,3,1,-7,-35,-2,-2,4,-1,0,-1,-1,-1,-1,1,6,-1
KR_6727468194,440,-3,-12,-50,-4,2,0,2,0,4,4,-1,2,1,-4,6,2,-1,3,2,0,-5,-107,1,-6,5,-2,0,0,-1,1,0,1,5,-1
KR_6711109482,420,1,40,-24,1,2,2,4,1,1,2,0,3,3,0,3,3,-2,2,0,0,-4,-299,-4,-4,8,3,0,0,-1,-1,0,-1,6,-1
KR_6759966601,420,-5,-121,-25,-7,-1,2,1,-2,4,2,2,1,3,-6,6,0,0,0,0,0,-7,-2,-2,-6,8,-9,0,0,-1,1,0,-1,5,-1
KR_6754426304,440,-2,-51,-40,-9,-3,6,3,2,0,2,-6,7,1,1,1,2,-3,4,1,0,-3,-7,-2,-3,5,2,0,-1,-1,-1,-1,1,3,-1
KR_6753019950,420,-4,-30,-12,-8,-4,5,1,-4,6,2,2,2,4,0,4,4,-2,2,0,0,-9,-20,-3,-4,7,0,0,0,1,-1,0,-1,1,-1
KR_6737892167,440,-2,-84,4,-4,1,0,1,1,2,3,-1,2,1,-3,5,2,-2,3,1,0,-3,2,3,-9,6,-6,0,0,1,1,0,-1,6,-1
KR_6762140877,420,-3,6,-18,-3,-1,2,1,-2,6,4,3,2,5,-2,6,4,-1,3,2,0,-4,0,1,-5,4,0,0,0,-1,-1,0,1,1,-1
KR_6747973920,420,1,41,-36,4,-2,5,3,5,0,5,3,3,6,-2,6,4,0,0,0,0,6,5,0,-2,2,2,0,0,-1,-1,-1,1,4,-1
KR_6742931992,440,-4,-15,-8,-4,-4,4,0,-1,2,1,0,1,1,0,1,1,1,0,1,0,1,-4,-1,-3,4,1,0,-1,-1,1,-1,-1,6,-1
KR_6754046401,420,-1,-16,-11,0,-1,2,1,0,3,3,2,1,3,-3,3,0,2,0,2,-1,-6,-28,-4,-6,10,2,0,-1,1,-1,-1,-1,1,-1
KR_6711183163,420,-6,-22,0,-6,1,0,1,-3,7,4,-4,4,0,-2,3,1,2,1,3,0,-10,1,-3,-3,6,-2,0,0,-1,1,-1,-1,2,-1
KR_6764261529,420,1,23,0,-3,2,3,5,-1,4,3,1,1,2,-3,3,0,-2,2,0,-1,-8,41,-3,-4,7,-18,0,1,-1,1,1,-1,5,-1
KR_6763431038,440,7,98,-8,18,2,0,2,7,3,10,2,1,3,5,0,5,2,1,3,1,18,12,1,-8,7,1,0,1,1,1,1,1,5,-1
KR_6720824969,420,-3,6,-3,-12,5,1,6,-8,9,1,-3,5,2,-6,7,1,0,3,3,0,-21,1,0,-3,3,1,0,0,-1,-1,-1,-1,1,-1
KR_6758211890,420,-2,-79,3,-3,-4,4,0,1,1,2,2,2,4,-5,6,1,3,1,4,0,6,25,3,-6,3,-3,0,-1,-1,-1,-1,-1,5,-1
KR_6724774979,440,1,7,-14,1,1,0,1,-1,1,0,-1,1,0,3,1,4,-1,1,0,0,-2,7,-1,-5,6,0,0,0,1,-1,0,1,3,-1
KR_6751221688,420,-1,50,-16,-4,2,3,5,-3,5,2,-4,6,2,2,6,8,-1,2,1,1,4,19,2,-6,4,1,0,-2,-1,-1,-1,1,6,-1
KR_6761337241,420,-1,-33,4,-2,0,1,1,0,3,3,-1,4,3,0,1,1,-1,2,1,0,-4,-18,-3,-3,6,-1,0,0,-1,-1,0,1,2,-1
KR_6726384581,420,-4,-28,-6,-16,0,6,6,-6,10,4,-2,5,3,-2,2,0,-6,8,2,0,-12,-3,0,-4,4,-3,0,-2,-1,1,-1,-1,5,-1
KR_6763023419,420,-2,-19,-5,-13,-3,4,1,-2,4,2,-1,2,1,-4,6,2,-3,4,1,0,-13,-123,0,-8,8,-1,0,-2,-1,-1,-1,-1,1,-1
KR_6746884445,420,2,0,9,1,2,0,2,-3,4,1,-2,2,0,2,4,6,2,1,3,0,-3,-8,-3,-7,10,-5,0,-2,1,-1,-1,1,1,-1
KR_6763849987,420,-4,-21,10,-18,-3,3,0,-8,9,1,-2,2,0,-3,5,2,-2,3,1,0,-19,10,0,-4,4,-3,0,-1,1,1,-1,-1,3,-1
KR_6676167883,420,-4,10,-2,-6,-6,7,1,0,2,2,1,1,2,-1,2,1,0,2,2,0,-5,4,2,-5,3,-6,0,0,1,0,0,1,1,-1
KR_6737572581,420,2,4,-26,1,6,1,7,-2,5,3,-3,5,2,0,3,3,0,1,1,-1,2,-20,4,-7,3,1,0,1,-1,1,1,-1,3,-1
KR_6686479481,420,1,25,-12,2,1,0,1,1,3,4,0,2,2,0,0,0,0,0,0,0,-2,92,-1,-7,8,4,0,0,-1,1,0,1,4,-1
KR_6739810309,420,3,22,-2,7,0,1,1,1,2,3,1,1,2,-2,5,3,7,0,7,0,12,-8,-6,-5,11,5,0,2,-1,-1,1,1,1,-1
KR_6740289721,420,-3,3,16,-5,2,0,2,-1,4,3,-4,4,0,-3,5,2,1,1,2,0,-17,25,1,-4,3,9,0,-1,0,1,-1,1,0,-1
KR_6741855223,420,-2,-72,-1,-2,-5,6,1,5,2,7,-3,5,2,1,1,2,0,0,0,1,8,0,0,-9,9,-5,0,0,-1,-1,-1,1,2,-1
KR_6731462470,420,-4,-28,-32,-4,1,0,1,5,2,7,-2,2,0,-6,6,0,-2,4,2,0,-5,-10,-5,-2,7,0,0,-2,-1,1,-1,1,5,-1
KR_6763286497,420,-2,-20,-12,-5,-5,5,0,0,3,3,2,2,4,-1,2,1,-1,1,0,0,-5,-37,1,-7,6,-2,0,-1,-1,1,-1,-1,6,-1
KR_6756978124,420,-2,9,36,-10,-3,3,0,-2,4,2,0,4,4,-4,4,0,-1,1,0,0,-9,0,0,-7,7,1,0,-1,-1,1,-1,1,2,-1
KR_6758771907,420,-9,-65,-19,-16,-2,3,1,-3,4,1,-1,3,2,-9,9,0,-1,2,1,1,-14,-11,-3,-4,7,7,0,-1,-1,-1,-1,1,3,-1
KR_6759402584,420,1,28,28,-3,4,1,5,-4,4,0,-8,9,1,5,0,5,0,0,0,0,3,-9,0,-4,4,-2,0,0,-1,-1,-1,-1,4,-1
KR_6762891447,420,-5,7,-24,-8,1,1,2,-3,10,7,-3,5,2,-2,3,1,-1,3,2,0,-20,-3,3,-6,3,0,0,0,0,1,-1,1,0,-1
KR_6715670543,420,-4,-41,-25,-7,-3,3,0,-3,4,1,0,1,1,-1,5,4,0,0,0,0,-4,-107,1,-5,4,-4,0,-1,-1,1,-1,-1,3,-1
KR_6744494627,420,-5,-6,-60,-5,-7,8,1,0,6,6,3,2,5,-1,5,4,0,0,0,0,-1,-2,-3,-6,9,0,0,-1,-1,1,-1,-1,1,-1
KR_6762077461,420,-3,8,-40,-11,-3,4,1,-4,6,2,0,5,5,-5,6,1,1,1,2,-1,-12,16,3,-6,3,4,0,-3,-1,-1,-1,-1,6,-1
KR_6758488374,420,-6,-55,9,-10,-6,7,1,0,1,1,-1,2,1,-1,2,1,-2,2,0,0,-16,130,-4,-4,8,-1,0,-2,-1,-1,1,-1,6,-1
KR_6726704324,440,1,-3,25,-1,2,1,3,1,1,2,-2,2,0,-3,4,1,1,0,1,1,7,1,-3,-5,8,-2,0,-1,-1,-1,-1,1,2,-1
KR_6756677209,420,-2,-37,8,-6,2,0,2,2,0,2,-4,5,1,-6,6,0,0,1,1,1,-7,272,0,-4,4,2,0,0,1,-1,0,1,5,-1
KR_6741596016,420,-5,-37,-28,-7,-2,2,0,0,2,2,-2,6,4,-2,8,6,-1,1,0,-1,-6,-5,1,-8,7,-3,0,0,-1,1,-1,-1,4,-1
KR_6756694123,420,-4,6,9,-15,-2,3,1,-2,4,2,0,1,1,-7,8,1,-4,6,2,0,-17,2,1,-7,6,0,0,-1,-1,0,-1,-1,1,-1
KR_6686922432,440,1,30,17,-4,-2,2,0,-2,3,1,-4,5,1,3,1,4,1,2,3,0,4,-1,-1,-2,3,-4,0,-1,-1,-1,-1,1,4,-1
KR_6732281876,420,-6,-94,-4,-12,-4,5,1,3,0,3,-2,2,0,-10,10,0,1,0,1,0,-10,2,0,-7,7,0,0,-2,-1,1,-1,-1,1,-1
KR_6597463433,420,-5,-109,-32,-19,-5,8,3,-5,7,2,-6,8,2,-1,3,2,-2,2,0,0,-5,-18,-4,-5,9,-2,0,-4,-1,-1,-1,-1,1,-1
KR_6657119733,420,2,30,-1,0,-3,4,1,0,4,4,-1,2,1,3,1,4,1,1,2,0,2,-91,2,-8,6,0,0,0,1,-1,1,1,3,-1
KR_6756848444,420,1,-22,0,1,-3,4,1,1,2,3,0,1,1,3,1,4,0,0,0,0,5,8,-3,-5,8,-3,0,-1,1,-1,-1,-1,6,-1
KR_6668997142,420,-3,6,11,-6,-1,6,5,-1,2,1,-5,6,1,1,5,6,0,1,1,1,-1,-6,2,-7,5,7,0,0,1,-1,0,1,6,-1
KR_6762628107,420,3,43,0,1,1,1,2,-1,2,1,3,2,5,0,4,4,-2,2,0,0,1,-42,-5,-4,9,16,0,1,1,1,1,-1,1,-1
KR_6667128459,440,-2,43,0,-2,-2,3,1,-7,7,0,4,0,4,1,2,3,2,0,2,0,-4,-5,6,-7,1,-4,0,0,1,1,1,1,4,-1
KR_6684019236,420,-3,-32,-16,-12,-2,2,0,3,2,5,-4,6,2,-8,8,0,-1,2,1,0,-10,-5,-2,-7,9,0,0,0,-1,-1,-1,-1,4,-1
KR_6764827548,420,-2,7,-28,-4,-2,4,2,0,1,1,-1,8,7,0,1,1,-1,2,1,-1,-7,5,1,-3,2,-3,0,-1,-1,-1,-1,-1,4,-1
KR_6610647738,420,-1,10,29,2,-2,6,4,2,1,3,4,0,4,-1,2,1,-1,1,0,0,-2,-2,3,-8,5,-6,0,0,1,1,-1,1,2,-1
KR_6760767621,420,2,-18,20,8,1,2,3,3,0,3,-1,2,1,4,0,4,1,1,2,2,8,1,0,-3,3,4,0,0,1,-1,1,1,2,-1
KR_6759636055,420,-1,-35,16,-1,0,1,1,2,0,2,-3,5,2,1,2,3,-1,1,0,0,5,8,-1,-6,7,-1,0,0,-1,1,0,1,2,-1
KR_6759929302,420,-4,-48,-43,-13,0,2,2,-5,5,0,-5,5,0,-3,3,0,0,0,0,0,-14,-8,-5,-6,11,-1,0,-2,-1,-1,-1,-1,3,-1
KR_6680653241,420,-1,13,-12,-2,-3,3,0,-3,6,3,-1,5,4,4,3,7,1,1,2,0,2,-27,1,-4,3,3,0,1,1,-1,1,-1,5,-1
KR_6714359674,420,-4,-92,-48,-8,-2,6,4,-4,5,1,-2,4,2,0,2,2,0,2,2,0,1,-4,1,-4,3,-3,0,-3,-1,-1,-1,-1,1,-1
KR_6415249336,420,-1,-13,-8,-4,2,0,2,-6,7,1,-2,6,4,2,0,2,0,0,0,0,3,5,1,-6,5,-4,0,-2,-1,1,-1,-1,3,-1
KR_6639221112,420,-3,-29,1,-17,-1,3,2,-6,7,1,-2,2,0,-6,7,1,-2,2,0,1,-18,9,0,-6,6,-1,0,0,-1,0,-1,1,5,-1
KR_6760215972,420,0,-27,4,-4,-7,7,0,2,2,4,0,3,3,4,0,4,-3,3,0,0,2,45,3,-6,3,-19,0,1,0,-1,1,1,0,-1
KR_6720503783,420,-3,13,-17,-8,-3,5,2,-3,5,2,-2,7,5,0,4,4,0,2,2,1,-2,-35,1,-6,5,-4,0,-4,1,-1,-1,1,4,-1
KR_6765005923,420,-4,-83,-18,-3,-5,6,1,2,1,3,2,4,6,-2,4,2,0,1,1,0,-5,-2,1,-10,9,-7,0,-3,1,-1,-1,-1,3,-1
KR_6748885313,420,3,27,4,2,-3,3,0,4,1,5,1,2,3,0,3,3,0,0,0,0,5,4,-1,-5,6,2,0,1,-1,-1,1,1,5,-1
KR_6740565261,420,-1,-153,20,5,1,0,1,4,0,4,-4,4,0,3,2,5,1,1,2,0,9,-1,-5,-4,9,3,0,0,1,1,-1,1,2,-1
KR_6758923393,420,-4,-51,-18,-7,-7,7,0,-4,5,1,3,0,3,1,1,2,0,1,1,0,-1,1,1,-5,4,-4,0,-3,-1,-1,-1,-1,2,-1
KR_6748939868,420,-4,-30,-16,-10,-5,6,1,-1,3,2,-1,2,1,-1,2,1,-2,2,0,0,-3,5,4,-8,4,-1,0,-1,1,-1,-1,1,1,-1
KR_6758263538,420,3,14,8,10,1,4,5,4,0,4,3,2,5,2,1,3,0,2,2,0,14,1,5,-6,1,0,0,0,1,1,-1,1,6,-1
KR_6764975646,420,-1,5,-6,-4,0,2,2,1,1,2,0,1,1,-5,7,2,0,1,1,0,-1,6,6,-13,7,-6,0,0,1,0,0,-1,5,-1
KR_6761605191,420,1,15,-1,3,0,4,4,3,2,5,1,2,3,0,3,3,-1,1,0,-2,4,43,6,-11,5,-5,0,0,1,1,1,-1,3,-1
KR_6751224849,420,-5,5,-36,-15,0,4,4,-4,5,1,-8,9,1,-3,4,1,0,2,2,0,-12,137,-5,-2,7,-17,0,1,-1,0,1,-1,3,-1
KR_6691229123,420,-2,7,-32,-2,-1,2,1,-1,4,3,2,1,3,-3,3,0,1,0,1,0,-3,5,2,-6,4,0,0,0,-1,-1,0,1,6,-1
KR_6755541298,420,-3,0,-28,0,-1,2,1,-2,4,2,-4,4,0,6,0,6,1,0,1,2,2,3,0,-6,6,4,0,0,1,1,0,1,5,-1
KR_6738329222,420,-1,-18,19,-6,-3,3,0,4,4,8,-3,3,0,-3,7,4,-1,2,1,-2,-9,-5,-3,-5,8,2,0,0,-1,1,0,-1,1,-1
KR_6749488031,420,-2,-57,-33,-1,2,1,3,2,2,4,-5,7,2,-1,3,2,1,0,1,0,2,4,2,-6,4,0,0,-3,1,-1,-1,1,1,-1
KR_6754986129,420,-1,-6,0,3,0,2,2,-1,3,2,-2,2,0,6,0,6,0,0,0,0,7,2,-4,-1,5,6,0,2,1,-1,1,-1,2,-1
KR_6702815386,420,3,-9,0,6,7,0,7,0,3,3,1,2,3,-2,4,2,0,0,0,0,-7,-9,-1,-7,8,1,0,-1,1,-1,-1,1,2,-1
KR_6762951935,420,3,-6,40,-3,-2,2,0,-5,7,2,2,0,2,1,4,5,1,1,2,0,3,15,-6,-3,9,4,0,-1,1,-1,-1,-1,3,-1
KR_6752222169,420,2,-31,16,0,3,1,4,-6,7,1,6,2,8,-3,4,1,0,1,1,0,-1,-20,-3,-6,9,7,0,0,0,1,1,1,0,-1
KR_6755323017,420,-4,-58,-11,-6,-2,2,0,0,3,3,-2,4,2,-4,5,1,2,0,2,0,-5,-32,-1,-5,6,-3,0,0,0,-1,-1,-1,0,-1
KR_6577903499,420,-2,21,12,-9,-2,2,0,-2,2,0,-3,4,1,-3,4,1,1,0,1,0,-12,3,2,-7,5,-3,0,1,-1,-1,1,-1,2,-1
KR_6756969896,420,-2,2,-17,-1,0,2,2,-2,3,1,-1,3,2,1,1,2,1,0,1,0,0,3,5,-8,3,-7,0,1,1,1,1,-1,3,-1
KR_6749584003,420,-1,4,12,-7,-5,7,2,-1,3,2,-1,5,4,0,2,2,0,1,1,0,-3,4,2,-4,2,2,0,-1,-1,-1,-1,1,1,-1
KR_6744133460,420,-3,-36,-12,-6,-2,5,3,-1,2,1,-3,3,0,-1,6,5,1,0,1,0,0,6,3,-6,3,0,0,-2,-1,-1,-1,-1,2,-1
KR_6694805565,420,-5,-62,-4,-8,5,0,5,-3,4,1,-6,6,0,-3,4,1,-1,3,2,0,-10,-8,-1,-4,5,-2,0,-2,-1,1,1,1,6,-1
KR_6749372028,420,-1,-50,20,-3,1,0,1,-1,4,3,1,1,2,-2,3,1,-2,2,0,0,-3,-264,-2,-4,6,-3,0,0,-1,1,0,-1,6,-1
KR_6714521264,440,-3,-35,-8,-6,-4,4,0,-1,2,1,-2,6,4,1,2,3,0,2,2,0,-6,-2,-1,-5,6,3,0,-1,1,-1,-1,1,6,-1
KR_6749168661,420,-1,-58,17,-8,-1,2,1,-8,9,1,1,1,2,-1,3,2,1,0,1,-2,-15,21,-2,-3,5,1,0,-1,-1,-1,-1,-1,3,-1
KR_6688616617,420,0,-41,24,-4,-2,3,1,5,0,5,-3,8,5,-4,4,0,0,2,2,0,-1,48,0,-5,5,1,0,0,-1,1,-1,1,3,-1
KR_6748157545,420,1,-29,28,0,0,2,2,-1,3,2,0,1,1,2,1,3,-1,1,0,-1,2,35,-2,-3,5,-2,0,0,1,0,0,-1,6,-1
KR_6723006820,420,-1,-35,2,3,0,0,0,-3,4,1,-1,4,3,2,2,4,5,0,5,2,7,137,-6,-7,13,-2,0,0,1,1,0,1,1,-1
KR_6764962609,420,-1,-6,0,-8,0,2,2,-6,7,1,-2,2,0,-1,5,4,1,2,3,-1,-12,-24,-3,-5,8,-1,0,1,1,1,-1,-1,6,-1
KR_6752128019,420,-2,-15,-28,-3,0,2,2,-2,3,1,9,0,9,-9,13,4,-1,1,0,-1,-9,61,-6,-5,11,0,0,-1,-1,-1,-1,1,1,-1
KR_6749750169,420,1,6,15,0,-4,4,0,-3,6,3,6,1,7,-1,1,0,2,2,4,0,-1,-50,-3,-3,6,28,0,1,-1,1,1,1,4,-1
KR_6391697791,420,1,-22,-4,0,2,1,3,0,2,2,-1,1,0,-3,6,3,2,0,2,-1,2,11,3,-10,7,-4,0,-1,-1,1,-1,-1,1,-1
KR_6729811436,420,-5,-57,-24,-10,-1,3,2,-2,5,3,-2,3,1,-5,6,1,0,1,1,-1,-12,-1,-2,-4,6,-3,0,-1,1,1,-1,-1,5,-1
KR_6679049709,420,2,28,29,-5,-1,2,1,-1,3,2,-2,3,1,-1,1,0,0,1,1,0,-5,-10,1,-6,5,1,0,0,1,-1,0,-1,1,-1
KR_6764697147,420,3,40,10,2,1,1,2,3,1,4,3,0,3,-5,7,2,0,0,0,0,-1,3,-1,-4,5,-2,0,1,1,-1,1,-1,2,-1
KR_6760268758,420,-1,-34,12,-8,-1,1,0,-1,2,1,-1,5,4,-3,5,2,-2,2,0,-1,-11,6,3,-4,1,2,0,-1,-1,-1,-1,-1,4,-1
KR_6756592966,420,-3,-3,-16,0,0,4,4,-6,7,1,1,1,2,3,2,5,2,2,4,0,-6,21,5,-8,3,-5,0,1,-1,1,1,1,5,-1
KR_6762912906,420,-3,3,37,-5,2,0,2,-5,6,1,0,2,2,1,3,4,-3,3,0,0,-7,39,-5,-5,10,2,0,0,-1,1,0,-1,4,-1
KR_6762786800,440,-1,-19,-10,-2,-2,2,0,-2,2,0,-2,2,0,0,1,1,4,0,4,0,4,74,6,-8,2,-2,0,-1,-1,-1,-1,-1,3,-1
KR_6722113448,420,3,31,-24,9,-1,5,4,6,0,6,5,1,6,-1,3,2,0,1,1,0,21,-14,2,-4,2,-1,0,0,-1,-1,-1,1,1,-1
KR_6688246730,420,2,-42,12,4,2,2,4,2,3,5,-2,3,1,2,1,3,0,1,1,0,0,137,-4,-2,6,2,0,1,-1,1,1,1,5,-1
KR_6430289260,420,0,-42,-9,1,-5,6,1,3,2,5,4,2,6,-2,4,2,1,0,1,-1,9,3,2,-9,7,-1,0,-1,-1,0,-1,1,3,-1
KR_6736758710,440,0,40,18,2,4,0,4,1,2,3,0,2,2,0,3,3,-3,5,2,2,7,1,-2,-4,6,0,0,0,-1,1,0,1,3,-1
KR_6764117094,440,-5,1,-23,-10,2,3,5,-4,4,0,0,0,0,-2,3,1,-6,6,0,0,-16,-8,2,-5,3,-2,0,0,-1,-1,-1,1,3,-1
KR_6226736302,420,-1,35,-26,-5,1,0,1,-5,11,6,-1,3,2,1,2,3,-1,2,1,0,-20,-3,2,-7,5,2,0,-1,-1,-1,-1,-1,5,-1
KR_6691277550,420,0,-92,-8,1,-3,5,2,1,1,2,0,2,2,-1,3,2,4,1,5,-1,7,-1,6,-10,4,-3,0,1,1,-1,1,-1,4,-1
KR_6647607028,420,-4,-84,-19,-13,0,0,0,2,1,3,-8,8,0,-2,5,3,-5,5,0,0,-27,0,-2,-3,5,-1,0,0,1,-1,-1,-1,6,-1
KR_6720435367,420,-5,-65,-48,-5,-1,2,1,-3,5,2,-1,3,2,-2,5,3,2,0,2,1,3,-13,-2,-5,7,17,0,-2,1,-1,-1,1,6,-1
KR_6732608540,420,-5,-58,-39,-10,1,0,1,-2,6,4,-3,4,1,-7,7,0,1,1,2,0,-11,-11,-8,-1,9,3,0,-1,-1,1,-1,-1,6,-1
KR_6750977169,420,-7,-52,-20,-10,-2,3,1,-2,4,2,-2,4,2,-2,2,0,-2,2,0,0,-16,23,-2,-4,6,-1,0,-1,1,1,-1,-1,2,-1
KR_6731468060,420,-1,-14,-28,-8,-6,6,0,1,5,6,2,1,3,-4,6,2,-1,3,2,0,-5,-112,-7,-3,10,2,0,-1,-1,-1,-1,-1,6,-1
KR_6648026521,420,-3,-51,-19,-12,-4,4,0,-3,10,7,-5,7,2,0,2,2,0,0,0,-1,-8,-21,-4,-3,7,6,0,0,-1,1,-1,-1,5,-1
KR_6660098693,420,1,25,14,2,-1,1,0,-1,2,1,1,1,2,2,1,3,1,1,2,0,3,-4,4,-9,5,3,0,0,1,1,0,1,5,-1
KR_6761608931,440,-3,3,-23,-14,2,0,2,-1,3,2,-6,6,0,-7,9,2,-2,4,2,-1,-15,-6,-1,-3,4,0,0,-4,-1,-1,-1,1,3,-1
KR_6694683723,420,1,23,-4,5,-2,4,2,1,1,2,-2,3,1,6,0,6,2,1,3,1,11,-1,0,-6,6,0,0,1,1,-1,1,1,1,-1
KR_6758340703,420,-6,-82,-8,-16,-1,2,1,0,3,3,-5,8,3,-7,7,0,-3,3,0,-1,-21,-5,2,-8,6,0,0,-3,1,1,-1,-1,6,-1
KR_6740519797,420,-3,-36,5,-9,0,2,2,0,2,2,-1,2,1,-7,8,1,-1,1,0,0,-9,23,8,-12,4,-5,0,-2,0,1,-1,-1,0,-1
KR_6730194052,420,0,-13,-63,4,1,2,3,0,1,1,0,3,3,3,1,4,0,1,1,0,8,120,0,-4,4,-1,0,-2,1,-1,-1,-1,5,-1
KR_6752812141,420,0,-38,-13,-7,-2,6,4,-2,5,3,-5,6,1,-2,2,0,4,0,4,0,-4,6,3,-5,2,0,0,0,-1,-1,-1,-1,6,-1
KR_6674937335,420,0,79,12,-5,0,1,1,-4,6,2,1,0,1,-2,4,2,0,2,2,0,-7,-12,-2,-3,5,-4,0,0,-1,-1,1,1,3,-1
KR_6758638929,420,-1,7,2,0,0,2,2,-2,5,3,0,3,3,0,0,0,2,0,2,0,2,4,1,-3,2,0,0,-1,-1,1,1,1,2,-1
KR_6710940641,420,-1,-41,16,-7,-7,7,0,1,3,4,-1,6,5,-1,2,1,1,0,1,0,-2,-4,-3,-2,5,6,0,0,-1,-1,0,-1,1,-1
KR_6764280932,420,-2,57,-28,-1,2,0,2,1,0,1,2,0,2,-3,5,2,-3,4,1,0,-2,16,8,-10,2,2,0,1,-1,1,1,1,3,-1
KR_6712356171,420,0,11,-5,-5,-4,5,1,0,3,3,-6,9,3,4,0,4,1,0,1,-1,16,0,-1,-4,5,-5,0,0,1,-1,0,-1,1,-1
KR_6749632480,420,0,-44,-9,5,1,1,2,1,3,4,5,4,9,-2,5,3,0,0,0,-1,8,-5,-4,-4,8,-1,0,0,0,-1,0,-1,0,-1
KR_6757306537,420,1,-24,16,0,0,1,1,1,2,3,-2,3,1,0,6,6,1,0,1,0,2,-4,0,-8,8,5,0,0,1,-1,-1,1,1,-1
KR_6695366842,420,-4,-48,-25,-14,0,0,0,-3,3,0,-6,6,0,-4,5,1,-1,1,0,-1,-22,48,-2,-5,7,-29,0,-2,-1,-1,-1,-1,3,-1
KR_6758599846,420,-4,36,-27,-12,-2,3,1,-14,14,0,0,3,3,1,3,4,3,3,6,0,-20,-5,-2,-4,6,3,0,0,-1,0,0,1,3,-1
KR_6741765187,440,-4,-2,-20,-9,-4,6,2,-1,1,0,-4,4,0,-2,3,1,2,0,2,-1,-19,19,-4,-4,8,-2,0,-2,-1,-1,-1,-1,1,-1
KR_6709279565,420,-2,-84,-10,-10,-6,7,1,1,2,3,-4,4,0,-2,4,2,1,0,1,0,1,-9,-2,-8,10,-3,0,-2,1,1,-1,-1,4,-1
KR_6707562267,420,0,69,16,3,4,1,5,3,5,8,-5,6,1,1,6,7,0,1,1,0,-3,1,0,-4,4,2,0,1,-1,1,1,1,1,-1
KR_6762407939,420,-5,26,-15,-12,1,2,3,0,1,1,1,2,3,-9,9,0,-5,5,0,0,-18,-19,-2,-4,6,-1,0,1,-1,1,1,-1,2,-1
KR_6753416345,420,0,-22,14,-5,-1,1,0,1,3,4,-3,3,0,-1,1,0,-1,1,0,0,-7,-5,0,-4,4,-3,0,0,-1,-1,-1,-1,1,-1
KR_6752870370,420,-4,-66,-20,-6,-2,3,1,-3,4,1,0,1,1,0,1,1,-1,1,0,0,-2,13,-1,-5,6,4,0,-1,1,-1,-1,-1,4,-1
KR_6714599059,440,-5,-97,12,-10,-8,8,0,-4,6,2,-2,2,0,1,1,2,3,0,3,0,-3,1,0,-7,7,-6,0,-1,-1,-1,-1,-1,3,-1
KR_6764275224,420,-4,-89,8,-5,-2,4,2,-1,3,2,-1,2,1,-5,7,2,4,0,4,0,-3,18,7,-10,3,-6,0,-1,-1,1,-1,-1,5,-1
KR_6728353760,420,-2,-67,19,-5,3,1,4,0,1,1,-3,7,4,-4,5,1,-1,2,1,0,-6,5,3,-9,6,0,0,-1,-1,-1,-1,1,5,-1
KR_6752305450,440,-1,9,12,-7,-2,4,2,1,0,1,-5,5,0,0,2,2,-1,2,1,0,-12,-9,-2,-2,4,-2,0,0,-1,0,0,1,2,-1
KR_6675001444,420,1,-7,-1,-2,2,1,3,0,1,1,-9,11,2,4,1,5,1,0,1,0,3,59,-2,-5,7,25,0,1,-1,-1,1,-1,3,-1
KR_6728204105,420,-3,-14,-17,-4,0,2,2,-1,6,5,-3,4,1,2,2,4,-2,3,1,1,0,5,0,-3,3,0,0,0,1,1,0,1,4,-1
KR_6724862684,420,0,53,-17,-2,3,0,3,-2,2,0,-2,3,1,5,4,9,-6,6,0,0,1,-5,3,-6,3,-3,0,0,-1,-1,0,1,3,-1
KR_6728591469,420,-3,-14,-19,-2,4,0,4,-3,3,0,1,0,1,-4,6,2,0,1,1,0,-5,19,4,-9,5,-6,0,-1,-1,-1,-1,1,2,-1
KR_6701503290,420,-5,-5,-48,-7,0,0,0,-1,3,2,-3,4,1,-2,4,2,-1,1,0,0,-7,-5,-2,-3,5,2,0,0,-1,1,0,-1,6,-1
KR_6748872380,440,1,5,-1,-3,0,0,0,1,0,1,2,2,4,-6,7,1,0,0,0,0,-7,0,1,-3,2,0,0,1,-1,1,1,1,4,-1
KR_6760884672,440,-4,-63,-24,-12,-2,2,0,-5,5,0,-2,4,2,-3,5,2,0,2,2,0,-8,-10,-3,-1,4,-3,0,-1,-1,-1,-1,-1,5,-1
KR_6752025492,420,-3,-80,8,-5,-1,2,1,3,0,3,-6,7,1,-1,4,3,0,0,0,0,-2,-14,-6,-4,10,-1,0,0,-1,-1,-1,1,1,-1
KR_6760812460,420,-2,-24,-44,3,3,1,4,-3,4,1,0,2,2,4,1,5,-1,3,2,0,3,13,-3,-3,6,-2,0,0,-1,-1,-1,-1,1,-1
KR_6763453576,420,-1,-39,-23,-2,-2,3,1,-1,1,0,-1,3,2,-3,3,0,5,1,6,0,3,-3,2,-7,5,2,0,0,0,1,0,1,0,-1
KR_6763156514,420,0,13,-8,1,2,4,6,-1,3,2,-1,1,0,0,1,1,1,1,2,0,3,-2,1,-7,6,1,0,-1,1,-1,-1,1,5,-1
KR_6711333848,420,-6,-42,-20,-12,-2,2,0,-1,1,0,-6,8,2,-1,4,3,-2,3,1,0,-11,-18,-5,-3,8,4,0,-2,-1,-1,-1,-1,2,-1
KR_6764138009,440,-1,-71,0,-1,-4,5,1,6,0,6,0,2,2,-3,4,1,0,1,1,0,6,-1,0,-2,2,4,0,-1,-1,1,-1,-1,1,-1
KR_6735248016,420,-2,36,-15,-3,-4,5,1,3,1,4,1,2,3,0,5,5,-3,5,2,0,4,-13,-2,-3,5,3,0,0,1,-1,1,1,1,-1
KR_6751069143,420,-1,-31,-20,-2,-3,5,2,0,2,2,1,3,4,-3,4,1,3,0,3,0,-3,4,2,-9,7,0,0,-1,0,-1,-1,-1,0,-1
KR_6762860496,420,3,-14,-4,7,-2,4,2,2,1,3,0,1,1,9,0,9,-2,3,1,0,19,23,3,-9,6,-6,0,0,1,-1,-1,1,5,-1
KR_6693408997,420,2,-33,17,5,0,1,1,1,2,3,2,2,4,1,2,3,1,0,1,2,17,25,3,-8,5,28,0,-1,1,-1,-1,1,3,-1
KR_6665524055,420,-3,-21,-19,-2,0,2,2,2,3,5,1,0,1,-3,3,0,-2,2,0,1,-5,-4,-5,-5,10,-2,0,1,-1,1,1,1,1,-1
KR_6760304088,420,-1,30,4,0,1,1,2,-1,3,2,-2,4,2,3,1,4,-1,1,0,0,-5,41,-5,-3,8,-17,0,0,-1,-1,1,1,2,-1
KR_6227459574,420,-2,-89,21,-2,-5,6,1,3,1,4,-4,5,1,3,0,3,1,2,3,0,7,7,-1,-2,3,-1,0,-2,1,1,-1,-1,4,-1
KR_6724823611,420,-3,15,35,-9,-1,1,0,2,4,6,-2,4,2,-2,4,2,-6,6,0,0,-9,28,-3,-6,9,-2,0,-2,0,-1,-1,1,0,-1
KR_6754498734,420,0,1,-28,0,2,0,2,-2,3,1,0,4,4,2,2,4,-2,2,0,-1,-3,41,0,-6,6,-3,0,-2,-1,-1,-1,-1,1,-1
KR_6706369713,440,-6,-72,-34,-9,-1,2,1,0,4,4,-6,7,1,-2,5,3,0,2,2,0,-6,-2,-2,-5,7,-5,0,0,1,-1,0,-1,2,-1
KR_6757063751,420,-1,-48,20,-6,3,0,3,-5,8,3,0,1,1,-3,6,3,-1,1,0,0,-4,5,-3,-2,5,-5,0,0,1,1,-1,1,6,-1
KR_6688637748,420,-2,-87,21,-9,-1,2,1,-3,5,2,-4,5,1,-1,1,0,0,0,0,0,-12,5,4,-9,5,-5,0,-2,1,-1,-1,1,5,-1
KR_6727884795,420,-3,-26,3,-7,1,1,2,-5,6,1,-2,4,2,-2,3,1,1,1,2,0,-14,1,1,-7,6,-1,0,-1,0,0,-1,-1,0,-1
KR_6719052145,420,0,-61,-1,7,2,1,3,6,0,6,-1,3,2,-1,2,1,1,0,1,0,12,0,-1,-3,4,2,0,-1,-1,1,1,-1,5,-1
KR_6759903824,440,2,15,11,1,2,0,2,1,1,2,-1,4,3,0,4,4,-1,1,0,0,-2,1,2,-5,3,-3,0,0,0,1,0,-1,0,-1
KR_6759275498,420,-1,-123,-8,3,-1,1,0,4,0,4,2,2,4,-2,4,2,0,1,1,0,8,1,4,-6,2,-1,0,-1,-1,-1,-1,-1,3,-1
KR_6739236609,420,0,-34,27,0,2,2,4,0,1,1,3,2,5,-4,5,1,-1,1,0,0,-2,-41,-2,-4,6,14,0,0,0,-1,0,1,0,-1
KR_6754064460,440,4,54,5,15,5,2,7,5,1,6,2,0,2,1,7,8,2,1,3,0,11,416,1,-1,0,0,0,3,0,1,1,1,0,-1
KR_6675295987,420,-1,20,20,1,-2,4,2,2,0,2,-1,2,1,2,1,3,0,2,2,1,9,5,2,-5,3,-3,0,0,1,-1,-1,1,3,-1
KR_6745356845,440,3,-35,40,7,5,2,7,2,5,7,4,1,5,0,0,0,-4,4,0,0,-5,-1,1,-3,2,-1,0,0,0,1,0,1,0,-1
KR_6675605914,420,-1,-49,31,0,-3,3,0,0,2,2,3,2,5,-1,4,3,1,0,1,0,-1,54,-2,-3,5,-1,0,-1,1,-1,-1,1,4,-1
KR_6755680337,420,-1,-35,-2,6,-2,2,0,-2,3,1,2,2,4,6,1,7,2,0,2,0,10,30,4,-7,3,0,0,-1,0,-1,-1,1,0,-1
KR_6694007253,420,-1,-1,-20,1,0,2,2,-1,1,0,-2,2,0,2,1,3,2,0,2,0,2,-7,-6,-4,10,5,0,0,-1,1,0,1,6,-1
KR_6704126206,420,-3,-92,-20,-14,3,1,4,-4,6,2,-2,2,0,-11,12,1,0,1,1,0,-13,-9,-4,-3,7,1,0,-2,-1,-1,-1,-1,4,-1
KR_6668144722,420,-4,-62,-25,-11,-5,6,1,-3,5,2,-1,3,2,-1,1,0,-1,2,1,0,-10,8,-1,-5,6,-5,0,-1,-1,-1,-1,-1,4,-1
KR_6742158434,420,0,6,-26,-4,0,3,3,-1,2,1,3,0,3,-4,4,0,-2,2,0,1,-6,6,0,-4,4,-6,0,-1,-1,1,-1,1,1,-1
KR_6745323449,420,-7,-171,0,-10,-5,5,0,3,1,4,-5,5,0,-2,3,1,-1,2,1,0,-2,15,1,-8,7,-9,0,-1,-1,0,-1,-1,3,-1
KR_6751135945,420,-5,-72,-27,-3,-6,6,0,-1,3,2,2,1,3,1,2,3,1,1,2,0,0,9,1,-7,6,0,0,-2,1,-1,-1,1,3,-1
KR_6760593340,420,-5,17,-1,-6,-1,2,1,-2,2,0,-2,6,4,1,2,3,-2,2,0,0,-10,-5,0,-7,7,-1,0,0,1,0,-1,-1,4,-1
KR_6750491433,420,0,81,-32,-5,2,1,3,-2,3,1,0,3,3,-4,4,0,-1,3,2,0,-16,5,2,-5,3,-6,0,-1,1,1,1,1,1,-1
KR_6665330638,420,-2,-61,-24,-9,-1,1,0,2,2,4,-1,1,0,-7,7,0,-2,3,1,0,-14,-2,3,-9,6,2,0,-1,-1,-1,-1,-1,3,-1
KR_6764199273,420,0,-8,-7,2,0,0,0,3,2,5,2,2,4,-2,5,3,-1,2,1,0,7,-305,-5,-2,7,3,0,-2,-1,-1,-1,1,6,-1
KR_6679864885,420,1,26,-17,-1,2,1,3,-3,6,3,-1,3,2,1,1,2,0,0,0,0,4,-43,4,-6,2,22,0,-3,1,-1,-1,-1,1,-1
KR_6755039323,420,-4,-64,-34,-5,-4,6,2,-4,6,2,2,1,3,1,1,2,0,0,0,-1,7,-35,0,-6,6,0,0,-4,-1,-1,-1,-1,3,-1
KR_6691262753,440,-4,3,2,-12,-5,6,1,-3,4,1,-2,2,0,-1,1,0,-1,2,1,0,-13,-7,2,-5,3,-1,0,1,1,1,1,-1,3,-1
KR_6741714924,420,2,12,19,0,0,0,0,-3,3,0,4,1,5,0,2,2,-1,1,0,-1,-4,1,1,-6,5,6,0,0,1,-1,0,-1,5,-1
KR_6763396095,440,-2,-42,2,6,2,0,2,-1,2,1,1,0,1,-1,2,1,5,2,7,1,8,3,-1,-4,5,4,0,0,-1,-1,1,1,5,-1
KR_6731882847,420,-3,-5,-43,-6,4,0,4,-2,3,1,-7,7,0,-1,2,1,0,0,0,0,-2,-5,3,-8,5,-3,0,0,1,-1,-1,1,6,-1
KR_6760836278,420,-2,-47,-11,-9,0,3,3,3,0,3,-9,9,0,-2,3,1,-1,1,0,0,-2,-1,0,-6,6,2,0,-1,1,-1,-1,-1,6,-1
KR_6756820439,420,0,-43,-23,2,-2,2,0,1,0,1,-1,2,1,4,0,4,0,1,1,0,6,2,1,-5,4,2,0,-1,1,-1,-1,-1,5,-1
KR_6755040142,420,2,-2,20,-2,-1,3,2,-1,4,3,-1,2,1,0,2,2,1,1,2,-2,-1,-1,-1,-5,6,4,0,0,1,1,1,-1,1,-1
KR_6764136473,420,1,53,16,3,2,0,2,-1,3,2,-7,7,0,3,1,4,6,0,6,1,-4,25,-1,-4,5,1,0,2,1,-1,1,1,5,-1
KR_6745721592,420,-3,-57,-19,-12,-6,7,1,-3,4,1,-1,2,1,-5,5,0,3,0,3,0,-9,-5,-4,0,4,2,0,-1,-1,-1,-1,1,6,-1
KR_6757426865,420,-5,-62,20,-10,-3,3,0,-4,4,0,-2,3,1,-1,8,7,0,1,1,0,-12,-125,-1,-5,6,-1,0,-1,1,1,-1,1,3,-1
KR_6737481472,440,-1,13,-47,4,-2,7,5,4,1,5,4,0,4,-1,1,0,-1,4,3,0,6,-13,3,-6,3,4,0,0,-1,1,0,1,4,-1
KR_6670217646,440,-1,51,13,-5,-1,2,1,-1,3,2,-3,4,1,1,3,4,-1,2,1,0,-8,1,-7,-3,10,-2,0,1,-1,-1,1,1,3,-1
KR_6724893570,420,-5,-65,-44,-3,1,0,1,0,3,3,-1,1,0,-4,5,1,1,0,1,0,-3,5,3,-7,4,-3,0,-2,-1,-1,-1,-1,6,-1
KR_6735289475,420,0,-79,9,-8,3,1,4,-3,3,0,-2,2,0,-5,6,1,-1,2,1,0,-14,-31,-5,-6,11,4,0,-3,1,-1,-1,-1,4,-1
KR_6645975306,440,-3,-65,-12,-3,-5,5,0,0,1,1,0,3,3,1,3,4,1,0,1,0,5,0,-3,-4,7,-2,0,-1,1,-1,-1,1,6,-1
KR_6728063098,420,0,-15,-8,3,1,1,2,-2,2,0,0,2,2,3,3,6,1,0,1,0,8,-3,-3,-5,8,0,0,0,1,1,0,-1,5,-1
KR_6709253962,420,-1,-51,-36,-9,-1,5,4,-5,8,3,0,1,1,-4,4,0,1,0,1,-2,-10,44,3,-7,4,-8,0,-1,-1,1,-1,-1,4,-1
KR_6710642718,440,1,-35,-13,-4,-4,4,0,7,2,9,-1,5,4,-5,8,3,-1,2,1,0,3,-2,-2,-4,6,4,0,-1,-1,-1,-1,1,1,-1
KR_6714111691,420,1,21,-23,1,-2,2,0,8,0,8,0,1,1,-5,6,1,0,1,1,1,1,7,2,-9,7,1,0,-2,-1,-1,-1,1,3,-1
KR_6757873101,420,-1,15,16,2,-1,3,2,5,0,5,-2,4,2,4,1,5,-4,4,0,1,5,-8,-5,-4,9,-1,0,0,1,-1,0,1,4,-1
KR_6505077322,420,1,-12,31,-2,0,1,1,0,2,2,1,3,4,2,0,2,-5,7,2,0,-2,1,-6,-5,11,-2,0,-2,-1,1,1,-1,5,-1
KR_6693945535,420,-2,-5,-8,-4,0,2,2,0,2,2,0,1,1,-4,4,0,0,0,0,0,-6,-252,2,-4,2,25,0,-1,-1,-1,-1,1,4,-1
KR_6682365673,420,-2,-44,-5,-6,-2,3,1,-2,4,2,0,2,2,-4,4,0,2,1,3,0,2,-51,-6,-2,8,33,0,-2,-1,-1,-1,1,4,-1
KR_6751148278,440,-1,-33,0,-2,3,0,3,-5,5,0,1,3,4,1,1,2,-2,4,2,-1,-7,4,1,-4,3,-1,0,-1,1,0,-1,-1,5,-1
KR_6696416440,420,-8,-104,-48,-12,-5,5,0,-2,3,1,-3,4,1,-2,3,1,0,0,0,0,-15,-10,0,-2,2,1,0,-3,-1,-1,-1,-1,1,-1
KR_6756208427,440,-3,-10,-8,-6,-2,3,1,0,2,2,-3,3,0,0,2,2,-1,1,0,0,-8,6,4,-6,2,0,0,0,-1,-1,0,-1,6,-1
KR_6759304576,420,-7,-82,-40,-17,-5,5,0,-8,9,1,-1,2,1,-3,4,1,0,1,1,0,-23,-23,-5,-4,9,-1,0,-1,-1,-1,-1,-1,2,-1
KR_6761332901,420,-5,7,-48,-5,1,2,3,0,3,3,-3,5,2,-4,4,0,1,0,1,0,-9,0,4,-8,4,-3,0,-1,-1,-1,-1,-1,6,-1
KR_6753014184,420,1,-36,-14,3,-3,3,0,1,2,3,-1,2,1,2,3,5,4,0,4,1,-2,-2,5,-9,4,-1,0,-1,-1,1,-1,1,4,-1
KR_6435829394,420,-1,-91,28,-5,-6,7,1,-1,4,3,5,0,5,-2,2,0,-1,3,2,0,-6,-1,-3,-3,6,2,0,-3,1,-1,-1,-1,3,-1
KR_6740451941,420,-1,-30,-39,1,2,0,2,-2,4,2,0,5,5,-1,6,5,2,1,3,0,6,-100,-3,-6,9,2,0,-2,-1,-1,-1,1,5,-1
KR_6728173139,440,-3,12,-67,-4,-2,2,0,1,0,1,0,3,3,-2,4,2,-1,3,2,0,-6,2,2,-4,2,2,0,0,1,-1,-1,1,6,-1
KR_6756764211,420,-1,13,-15,-7,-4,5,1,2,1,3,-2,4,2,-3,4,1,0,0,0,0,-11,-149,-1,-5,6,-1,0,1,-1,1,1,-1,4,-1
KR_6701337300,420,-3,-1,-19,-4,-3,4,1,0,3,3,4,3,7,-4,4,0,-1,1,0,0,-5,9,5,-7,2,-1,0,-1,-1,-1,-1,1,2,-1
KR_6699568642,420,-3,-62,5,-3,0,2,2,-3,5,2,2,2,4,-4,6,2,2,2,4,0,-9,-1,3,-9,6,1,0,-1,1,-1,-1,-1,4,-1
KR_6759866362,440,-1,16,24,-13,-3,6,3,-1,2,1,1,0,1,-7,8,1,-3,4,1,-1,-9,1,2,-5,3,-2,0,0,-1,0,0,-1,1,-1
KR_6758529059,420,0,-1,-19,-2,0,1,1,1,3,4,-1,3,2,0,0,0,-2,2,0,-1,1,110,0,-7,7,-3,0,0,-1,0,0,-1,6,-1
KR_6763739078,420,-2,-51,25,-1,-1,1,0,0,2,2,-2,2,0,2,0,2,0,0,0,0,2,1,7,-11,4,-2,0,-1,1,1,-1,-1,4,-1
KR_6759792492,440,1,55,-4,-1,-1,2,1,1,2,3,-1,3,2,-2,3,1,2,2,4,0,-3,5,5,-8,3,0,0,-1,-1,-1,-1,1,5,-1
KR_6717505669,420,-3,-43,6,-8,-1,1,0,-2,4,2,-4,7,3,-1,3,2,0,1,1,-2,-8,-38,-2,-4,6,-2,0,-2,-1,-1,-1,-1,1,-1
KR_6758715444,420,-5,-8,-8,-10,-4,4,0,-4,5,1,0,1,1,-1,3,2,-1,1,0,0,-6,-6,-2,-5,7,-1,0,-1,-1,-1,-1,-1,6,-1
KR_6764196634,420,1,-17,40,-3,-4,4,0,3,4,7,-5,7,2,0,6,6,3,0,3,0,5,-210,-9,-2,11,3,0,0,1,-1,-1,1,1,-1
KR_6756473698,420,-1,-31,20,-8,-1,3,2,-4,6,2,-3,5,2,1,1,2,-1,1,0,1,-9,7,2,-4,2,2,0,-1,1,-1,-1,1,6,-1
KR_6764769007,420,-1,-4,-8,-4,-1,1,0,-7,9,2,3,0,3,0,2,2,1,0,1,0,2,10,-1,-4,5,1,0,0,0,-1,0,1,0,-1
KR_6679580243,420,-6,-148,-10,-10,0,2,2,-4,7,3,-3,4,1,-2,3,1,-1,1,0,0,-17,49,0,-5,5,-28,0,-1,-1,1,-1,-1,6,-1
KR_6753636551,420,3,48,-10,8,5,1,6,5,1,6,2,1,3,-3,6,3,-1,1,0,0,8,11,5,-8,3,0,0,2,1,1,1,1,5,-1
KR_6721292119,420,4,67,38,9,0,2,2,1,4,5,4,1,5,7,3,10,-3,3,0,1,1,-5,1,-5,4,-3,0,1,1,1,1,1,3,-1
KR_6747478786,420,-3,-13,-20,-9,0,1,1,-4,6,2,-1,3,2,-3,3,0,-1,3,2,0,-14,-4,-2,-4,6,2,0,0,0,-1,0,-1,0,-1
KR_6752980639,420,-4,-60,-29,-12,-1,1,0,-6,6,0,0,2,2,-3,3,0,-2,2,0,0,-11,3,0,-4,4,-6,0,-1,-1,-1,-1,-1,2,-1
KR_6755716910,420,-1,-41,24,-5,4,1,5,-3,4,1,-6,6,0,-1,5,4,1,0,1,0,-12,-20,3,-7,4,-4,0,0,-1,1,0,1,1,-1
KR_6763319135,440,-3,-84,-17,-5,-1,2,1,-4,6,2,2,3,5,-3,5,2,1,1,2,0,-3,-12,-3,-2,5,5,0,-2,0,-1,-1,-1,0,-1
KR_6755102706,440,2,-27,0,7,-1,1,0,1,3,4,1,1,2,3,2,5,3,0,3,0,12,10,-1,-4,5,-2,0,0,0,0,0,-1,0,-1
KR_6750094452,420,2,-19,-6,4,-5,7,2,0,3,3,4,0,4,3,0,3,2,0,2,-1,18,14,-1,-6,7,3,0,-1,1,0,-1,-1,6,-1
KR_6741970549,420,-1,83,-1,1,3,1,4,1,1,2,1,3,4,-3,4,1,-1,1,0,0,-3,-4,-2,-4,6,1,0,1,-1,-1,1,1,6,-1
KR_6744388607,440,-1,-19,-12,-8,3,1,4,-4,5,1,-4,4,0,-2,4,2,-1,1,0,1,-17,22,9,-11,2,-4,0,1,1,1,1,1,1,-1
KR_6748629791,420,-2,8,-12,-3,3,0,3,3,0,3,-2,3,1,-8,8,0,1,0,1,0,-4,-121,1,-3,2,-2,0,0,-1,-1,0,1,5,-1
KR_6732439292,420,-3,-51,10,-11,-1,1,0,-2,2,0,-3,5,2,-5,6,1,0,1,1,1,-14,-3,-4,-4,8,-2,0,-2,1,-1,-1,1,1,-1
KR_6433990520,420,-5,-120,-25,-3,-1,2,1,-1,2,1,4,0,4,-5,6,1,0,0,0,-1,-5,-9,-3,-4,7,0,0,-1,-1,-1,-1,-1,1,-1
KR_6746395780,420,-2,-4,-16,3,3,0,3,0,1,1,0,2,2,0,0,0,0,0,0,0,1,-11,-1,-4,5,0,0,0,1,-1,0,-1,3,-1
KR_6678503538,420,1,-65,37,0,-2,3,1,1,2,3,0,0,0,2,3,5,-1,2,1,0,4,-1,2,-9,7,6,0,0,1,1,0,-1,4,-1
KR_6751619294,420,-4,-17,-17,-8,-2,4,2,1,2,3,2,4,6,-8,10,2,-1,1,0,0,-2,-30,-2,-6,8,7,0,-3,-1,-1,-1,-1,3,-1
KR_6734148913,420,-3,-5,-16,-13,-3,3,0,-2,6,4,0,3,3,-4,10,6,-4,4,0,0,-17,12,3,-5,2,-1,0,0,1,-1,1,1,2,-1
KR_6713749177,420,5,39,-4,5,0,0,0,2,1,3,7,1,8,-3,4,1,-1,2,1,-1,6,94,-2,-3,5,5,0,1,1,1,1,-1,2,-1
KR_6656560726,420,0,75,0,-3,1,0,1,2,1,3,-6,8,2,3,0,3,-3,4,1,0,-4,-1,2,-6,4,0,0,2,1,1,1,-1,2,-1
KR_6744076592,420,1,15,-3,-5,0,2,2,-4,7,3,-1,3,2,-2,6,4,2,0,2,0,-11,35,-3,-5,8,-25,0,1,-1,1,1,-1,4,-1
KR_6764325652,420,0,-14,20,-3,-1,3,2,-1,3,2,0,2,2,4,1,5,-5,5,0,0,-12,5,-2,-3,5,4,0,1,0,1,1,-1,0,-1
KR_6743672007,420,-5,-59,-24,-12,-1,1,0,-4,4,0,-5,5,0,-1,2,1,-1,1,0,0,-9,96,-2,-4,6,-4,0,0,-1,1,0,-1,5,-1
KR_6762808759,420,-2,43,28,-9,0,4,4,-4,4,0,1,1,2,-4,4,0,-2,3,1,0,-19,-5,0,-6,6,-1,0,0,-1,1,1,-1,5,-1
KR_6693535145,420,-1,10,28,-5,3,0,3,-5,6,1,-4,4,0,1,2,3,0,0,0,0,-9,-13,-4,-2,6,3,0,0,1,1,-1,-1,3,-1
KR_6757734277,440,-4,-44,-41,-10,-6,7,1,1,3,4,0,1,1,-3,5,2,-2,3,1,-3,-6,-1,4,-8,4,1,0,-1,-1,0,-1,1,4,-1
KR_6762578332,420,-1,18,-6,-4,-1,1,0,5,0,5,-6,6,0,1,3,4,-3,5,2,0,3,10,2,-4,2,-3,0,-2,-1,-1,-1,-1,4,-1
KR_6759669408,420,1,-6,-18,-2,-1,3,2,0,2,2,1,0,1,-1,1,0,-1,1,0,0,0,-28,4,-5,1,28,0,-1,-1,-1,-1,-1,2,-1
KR_6748075572,420,1,30,15,-1,-3,3,0,4,1,5,0,1,1,-3,5,2,1,0,1,0,-1,27,-3,-2,5,-8,0,0,1,-1,-1,-1,1,-1
KR_6763645968,420,6,81,35,13,3,1,4,-3,6,3,2,2,4,5,1,6,6,0,6,1,12,-149,4,-9,5,2,0,2,1,-1,1,1,5,-1
KR_6748011918,420,-2,-58,-4,-2,1,2,3,0,3,3,-3,4,1,2,0,2,-2,3,1,0,2,-9,0,-5,5,2,0,-2,-1,-1,-1,1,3,-1
KR_6624737194,420,-2,9,1,-14,-2,2,0,-1,5,4,-7,8,1,-5,8,3,1,2,3,0,-13,-1,0,-5,5,1,0,0,1,1,1,-1,1,-1
KR_6764256739,420,-5,-43,-12,-7,1,2,3,-3,6,3,-3,3,0,-4,5,1,2,0,2,-1,-1,8,2,-7,5,-3,0,1,-1,1,1,-1,6,-1
KR_6761502776,420,-4,-71,-15,-13,-4,5,1,-5,7,2,1,2,3,-8,10,2,3,1,4,-2,-11,-3,-4,-2,6,1,0,-1,-1,1,-1,-1,5,-1
KR_6761477067,420,1,-52,12,-1,-1,1,0,-1,3,2,-1,1,0,0,2,2,2,0,2,-1,-2,0,1,-6,5,-4,0,0,1,-1,0,-1,1,-1
KR_6719614509,420,-3,11,-17,-7,-1,3,2,0,1,1,-11,12,1,4,1,5,1,1,2,1,-7,-8,1,-5,4,1,0,0,1,-1,0,1,3,-1
KR_6437998344,420,-5,-49,-19,-7,1,0,1,-4,6,2,-1,2,1,-1,4,3,-2,4,2,0,-14,-1,1,-7,6,0,0,0,-1,1,-1,-1,4,-1
KR_6665355998,420,-1,-7,-11,-1,2,2,4,4,1,5,-4,7,3,-3,5,2,0,3,3,0,3,-28,1,-3,2,-2,0,0,1,-1,-1,1,6,-1
KR_6764384456,420,-2,44,-10,4,0,1,1,3,3,6,0,2,2,1,2,3,0,2,2,0,6,18,2,-7,5,-3,0,0,0,1,0,-1,0,-1
KR_6654622779,420,-2,-15,16,-9,1,0,1,-3,8,5,-3,4,1,-4,5,1,0,0,0,-1,-14,-4,0,-4,4,2,0,-2,-1,-1,-1,-1,3,-1
KR_6687819648,440,0,16,4,-4,-5,5,0,-3,4,1,1,1,2,2,0,2,1,0,1,0,0,-7,-4,-2,6,2,0,-1,1,-1,-1,-1,1,-1
KR_6764112785,420,-2,-32,-21,-5,-1,3,2,-1,2,1,-2,3,1,-1,4,3,0,0,0,0,-9,-5,0,-7,7,1,0,-1,-1,-1,-1,-1,1,-1
KR_6707359350,440,-1,-80,16,-6,4,1,5,-3,3,0,-1,2,1,-6,7,1,0,2,2,0,-3,-6,-6,-3,9,0,0,0,-1,1,-1,-1,6,-1
KR_6749038381,420,-6,17,-49,-10,-2,3,1,-5,6,1,0,1,1,-1,1,0,-2,3,1,0,-9,1,-2,-4,6,-2,0,-1,-1,-1,-1,-1,1,-1
KR_6752992388,440,-1,-12,-10,-3,4,0,4,-5,6,1,-1,3,2,0,3,3,-1,2,1,1,-9,113,2,-2,0,1,0,-1,-1,-1,-1,1,2,-1
KR_6758851502,420,3,-12,49,9,4,0,4,5,0,5,1,2,3,-1,2,1,0,1,1,0,15,-12,3,-7,4,4,0,0,0,1,0,1,0,-1
KR_6763821486,420,1,9,16,1,9,0,9,-2,3,1,-2,2,0,-1,4,3,-3,5,2,0,-3,-7,-1,-2,3,0,0,1,-1,0,-1,1,1,-1
KR_6616246904,420,-5,-53,-10,-12,1,1,2,-3,4,1,-1,5,4,-3,4,1,-6,6,0,0,-21,-5,-1,-7,8,-3,0,-1,-1,1,-1,1,4,-1
KR_6762905730,420,0,-27,9,2,-3,3,0,-1,3,2,-1,5,4,0,4,4,7,0,7,0,4,4,3,-4,1,1,0,0,1,-1,0,1,1,-1
KR_6661653081,420,-4,-70,-42,1,1,1,2,0,1,1,-1,6,5,1,6,7,0,0,0,3,12,0,9,-12,3,2,0,-1,1,1,-1,1,6,-1
KR_6761681348,440,-3,-24,12,-8,0,2,2,-5,9,4,-2,2,0,-3,5,2,2,0,2,0,-8,-15,-1,-4,5,0,0,-1,1,-1,-1,1,6,-1
KR_6759317205,440,-3,-99,-2,-12,-5,7,2,0,1,1,1,0,1,-8,8,0,0,0,0,-1,-11,-3,1,-2,1,-1,0,0,0,0,-1,-1,0,-1
KR_6583462339,420,-4,14,-1,-2,3,1,4,0,2,2,-4,4,0,0,3,3,-1,1,0,0,-8,19,1,-4,3,0,0,0,1,-1,0,1,3,-1
KR_6719496336,420,-7,-64,-23,-12,3,1,4,-7,8,1,-5,6,1,-1,2,1,-2,2,0,0,-9,17,-3,-2,5,0,0,-2,-1,-1,-1,-1,3,-1
KR_6762557174,420,-1,-24,16,-4,2,1,3,-2,4,2,-3,5,2,-2,3,1,1,0,1,0,-12,23,-2,-4,6,-1,0,1,-1,1,1,-1,5,-1
KR_6757275527,420,-1,23,6,-6,-2,2,0,-1,3,2,-1,2,1,1,5,6,-3,5,2,-1,-7,0,-2,-5,7,0,0,0,1,-1,0,-1,5,-1
KR_6743503259,420,-4,-86,5,-18,-1,3,2,-8,8,0,0,4,4,-7,8,1,-2,2,0,-1,-15,7,-4,-2,6,0,0,-1,-1,1,-1,-1,5,-1
KR_6655454149,420,-2,9,-16,-9,-2,2,0,0,3,3,-2,3,1,-6,7,1,1,0,1,0,-13,39,4,-9,5,-26,0,0,-1,1,1,1,3,-1
KR_6725062754,420,-3,-66,-16,0,2,1,3,1,3,4,-2,3,1,-1,3,2,0,1,1,0,2,0,2,-6,4,-1,0,-2,-1,-1,-1,1,2,-1
KR_6721581003,420,-2,-15,-40,-5,-1,2,1,-1,3,2,2,0,2,1,0,1,-6,6,0,1,-8,-2,-2,-3,5,-1,0,-1,-1,-1,-1,1,2,-1
KR_6756154078,420,-2,-16,-44,-2,1,3,4,1,2,3,0,1,1,-3,4,1,-1,1,0,-1,1,3,2,-5,3,-6,0,0,-1,-1,-1,-1,4,-1
KR_6746837546,420,-2,2,-25,5,0,0,0,4,2,6,1,1,2,1,1,2,-1,2,1,0,4,3,1,-5,4,-4,0,2,-1,1,1,1,6,-1
KR_6684810664,420,1,17,6,-2,-1,1,0,-1,3,2,0,2,2,-1,4,3,1,0,1,0,-6,6,5,-7,2,-5,0,0,-1,1,0,-1,1,-1
KR_6529641962,420,-3,-23,-4,-13,1,2,3,-1,2,1,-8,10,2,-4,7,3,-1,2,1,0,1,-60,-4,-2,6,16,0,0,1,-1,-1,-1,2,-1
KR_6733965752,420,0,37,-30,7,4,2,6,3,2,5,-3,3,0,4,0,4,-1,2,1,0,6,-1,6,-9,3,4,0,0,1,1,1,1,6,-1
KR_6734014612,420,-2,-5,0,-9,-5,5,0,-4,7,3,0,3,3,2,3,5,-2,3,1,0,-5,-18,-3,-4,7,2,0,-1,-1,-1,-1,-1,4,-1
KR_6756214862,420,-5,-74,-4,-10,-9,9,0,0,0,0,-1,6,5,0,2,2,0,0,0,0,1,-14,-4,-1,5,3,0,-2,-1,-1,-1,-1,6,-1
KR_6761691439,420,-1,6,-8,-3,1,2,3,-2,3,1,1,2,3,-6,9,3,3,0,3,0,-1,21,-2,-5,7,3,0,-1,-1,-1,1,-1,4,-1
KR_6668659372,440,-2,-11,-28,-2,5,2,7,1,4,5,-3,4,1,-1,3,2,-4,6,2,0,-7,-10,-5,0,5,1,0,-1,-1,0,-1,1,5,-1
KR_6705939705,420,-5,-60,-37,-15,-4,4,0,-2,4,2,-2,4,2,-5,8,3,-2,2,0,0,-17,-7,-1,-4,5,1,0,-2,1,-1,-1,1,4,-1
KR_6659584602,420,-3,30,-12,-7,-2,3,1,-2,3,1,0,1,1,-1,2,1,-2,2,0,0,-8,134,4,-6,2,5,0,-2,-1,1,-1,-1,3,-1
KR_6604039002,420,-3,8,-32,-12,-3,5,2,-5,6,1,-2,2,0,-2,2,0,0,2,2,0,-13,114,-4,-3,7,6,0,0,-1,1,1,1,4,-1
KR_6754888724,420,-2,-15,-6,-1,-2,3,1,-3,4,1,2,1,3,0,0,0,2,1,3,0,4,-7,-1,-5,6,-3,0,0,-1,-1,-1,-1,1,-1
KR_6740922919,420,-1,29,-23,1,6,0,6,0,3,3,-2,4,2,-3,5,2,0,1,1,0,-1,-5,1,-6,5,-1,0,0,1,1,-1,1,2,-1
KR_6759657056,440,-5,-37,-47,-10,1,3,4,1,2,3,-2,2,0,-10,11,1,0,0,0,0,-16,5,-1,-9,10,-1,0,-1,-1,1,1,-1,5,-1
KR_6632423656,420,-5,-67,-10,-11,-1,1,0,-4,5,1,-6,7,1,0,1,1,0,1,1,0,-14,66,-1,-5,6,3,0,-1,-1,-1,-1,-1,4,-1
KR_6760181694,420,0,-69,25,-1,-1,2,1,0,0,0,0,1,1,-2,2,0,2,1,3,0,1,2,1,-6,5,-3,0,-2,-1,1,-1,-1,3,-1
KR_6754114866,420,-1,-41,6,1,-1,2,1,2,1,3,-2,5,3,2,1,3,0,0,0,0,11,3,2,-8,6,-4,0,-1,-1,1,-1,-1,2,-1
KR_6749530020,420,-1,24,-14,-4,-3,3,0,1,0,1,-3,4,1,4,3,7,-3,5,2,-1,-4,-15,0,-8,8,-3,0,0,-1,1,1,-1,5,-1
KR_6547194374,440,-2,-18,-12,-2,-4,4,0,2,1,3,-3,4,1,3,4,7,0,2,2,0,-4,2,3,-6,3,-3,0,0,1,1,0,1,1,-1
KR_6759629793,440,-3,-76,7,-5,-3,3,0,-3,5,2,6,2,8,-4,4,0,-1,2,1,0,-5,9,-3,-1,4,1,0,0,1,1,0,-1,2,-1
KR_6734530807,420,-5,-35,-10,-7,-3,4,1,-1,5,4,-5,6,1,0,1,1,2,2,4,-1,-6,7,-4,-3,7,1,0,-1,-1,-1,-1,-1,5,-1
KR_6755088755,420,-3,-59,-19,-9,-3,4,1,1,2,3,-6,6,0,-3,5,2,2,0,2,0,-8,5,-3,-4,7,-2,0,-2,1,-1,-1,-1,2,-1
KR_6754914234,420,0,-9,-25,-2,1,2,3,-3,3,0,1,1,2,0,4,4,-1,1,0,0,-5,-23,-3,-2,5,-4,0,0,-1,-1,0,1,6,-1
KR_6747129851,440,-1,-47,-5,-3,0,2,2,-5,6,1,4,3,7,-3,3,0,1,2,3,0,0,-10,-4,-5,9,6,0,0,1,-1,0,-1,4,-1
KR_6720675546,420,-7,-87,-15,-6,-2,2,0,1,2,3,4,0,4,-9,9,0,0,0,0,0,-9,2,0,-6,6,-4,0,-1,-1,1,-1,1,1,-1
KR_6727983885,420,0,28,5,0,0,3,3,-3,6,3,5,1,6,0,4,4,-2,3,1,0,-9,-34,-5,-3,8,3,0,-1,-1,1,-1,-1,1,-1
KR_6728414531,420,1,8,33,-6,-1,2,1,3,1,4,0,3,3,-5,6,1,-3,3,0,0,-10,7,0,-7,7,-4,0,-1,-1,-1,-1,-1,3,-1
KR_6762901193,420,1,-1,20,-5,0,3,3,4,4,8,-3,4,1,-5,7,2,-1,1,0,0,-2,15,-4,-4,8,-2,0,1,0,-1,1,1,0,-1
KR_6737308108,420,1,-30,19,-1,1,1,2,1,4,5,-1,6,5,-1,3,2,-1,2,1,0,3,-23,0,-6,6,3,0,1,1,1,1,1,5,-1
KR_6748956112,440,0,12,5,-2,-1,1,0,1,2,3,0,1,1,-2,3,1,0,0,0,0,-9,11,-3,-7,10,-2,0,0,-1,1,0,1,5,-1
KR_6760718223,420,-3,-123,-6,-3,-1,5,4,-3,6,3,-2,6,4,-1,2,1,4,1,5,-1,0,5,1,-6,5,-2,0,-2,-1,1,-1,-1,4,-1
KR_6761775391,420,2,60,-29,4,1,0,1,2,2,4,2,3,5,-1,2,1,0,1,1,0,-3,9,1,-4,3,-1,0,1,-1,0,1,1,6,-1
KR_6741322530,420,3,43,-38,3,-3,3,0,3,2,5,3,2,5,1,2,3,-1,2,1,-2,12,-45,2,-7,5,4,0,0,1,1,0,-1,6,-1
KR_6707164528,420,-3,-41,-44,-11,-1,2,1,1,2,3,-1,4,3,-6,6,0,-4,4,0,0,-17,1,1,-7,6,-8,0,-1,1,-1,-1,-1,6,-1
KR_6749894240,420,-1,-98,36,-4,-2,2,0,-3,7,4,3,0,3,-2,3,1,0,0,0,-2,-7,-9,-5,-4,9,2,0,-2,-1,-1,-1,-1,5,-1
KR_6753552200,420,1,-65,-9,-1,3,0,3,0,4,4,-1,3,2,-3,5,2,0,1,1,0,-3,-8,-2,-6,8,-2,0,1,-1,1,-1,-1,4,-1
KR_6760646314,420,0,32,0,-8,3,0,3,-3,4,1,-2,2,0,-6,6,0,0,0,0,0,-18,-57,1,-4,3,4,0,1,-1,1,1,-1,3,-1
KR_6726441551,420,0,28,-4,-4,-1,2,1,-3,4,1,-2,4,2,1,0,1,1,1,2,0,1,8,1,-4,3,-1,0,0,0,-1,0,-1,0,-1
KR_6749860165,420,-3,1,-8,-5,-2,4,2,-2,3,1,1,1,2,-1,2,1,-1,1,0,0,-6,3,-2,-3,5,-3,0,-1,0,-1,-1,1,0,-1
KR_6684115197,420,-2,16,7,-4,-3,3,0,-1,4,3,0,2,2,0,2,2,0,1,1,0,-10,-7,-2,-5,7,1,0,-1,-1,-1,-1,1,6,-1
KR_6748704347,420,-3,54,-10,-3,-3,3,0,-2,5,3,0,2,2,2,1,3,0,0,0,1,-3,-15,1,-4,3,3,0,0,0,1,0,1,0,-1
KR_6728109815,420,0,-15,23,-3,0,1,1,-6,7,1,-5,6,1,4,0,4,4,0,4,0,-7,34,7,-7,0,-3,0,1,1,-1,1,1,6,-1
KR_6746678977,420,1,-19,-4,2,1,1,2,0,2,2,-1,1,0,1,2,3,1,1,2,-1,4,109,1,-7,6,-8,0,1,-1,1,1,-1,4,-1
KR_6749248121,420,-2,-38,-16,-3,2,1,3,1,0,1,-5,8,3,-3,3,0,2,0,2,0,4,7,0,-4,4,-3,0,-1,-1,-1,-1,-1,4,-1
KR_6591847061,420,-6,-116,-41,-8,-1,2,1,0,3,3,-2,2,0,-4,5,1,-1,1,0,1,-11,-6,-2,-2,4,-1,-1,-5,-1,-1,-1,1,4,-1
KR_6720382529,420,-3,-38,0,-9,-2,4,2,-1,5,4,1,2,3,-5,5,0,-2,2,0,0,-6,-12,-7,-1,8,-4,0,1,-1,-1,-1,-1,5,-1
KR_6751682215,440,0,-35,23,-5,-2,4,2,3,0,3,-6,8,2,0,3,3,0,1,1,0,-9,-7,1,-6,5,-1,0,0,0,1,0,-1,0,-1
KR_6724977088,440,-1,-31,-4,-1,-3,5,2,-1,2,1,10,0,10,-5,6,1,-2,3,1,0,6,7,2,-5,3,2,0,0,0,-1,0,-1,0,-1
KR_6366193788,420,-4,-1,-8,-4,-4,5,1,1,1,2,-2,3,1,0,2,2,1,1,2,-1,0,0,0,0,0,-4,0,-1,-1,-1,-1,-1,5,-1
KR_6763390385,420,1,-41,-2,1,-1,2,1,0,5,5,1,1,2,0,3,3,1,0,1,-1,-1,3,2,-6,4,0,0,-1,-1,-1,-1,-1,6,-1
KR_6705481440,420,1,4,-12,2,3,1,4,2,4,6,-4,5,1,3,1,4,-2,2,0,0,-3,-110,0,-5,5,-4,0,0,-1,-1,0,-1,3,-1
KR_6399190925,420,2,17,4,3,-3,6,3,-1,2,1,7,2,9,-2,5,3,2,1,3,0,-6,-5,-2,-3,5,3,0,1,1,1,-1,1,1,-1
KR_6757051341,420,-2,-63,-16,-6,-5,5,0,2,0,2,-2,5,3,-3,5,2,2,0,2,0,0,1,-3,-3,6,-1,0,-2,-1,-1,-1,-1,4,-1
KR_6759830852,420,-5,-23,-2,-7,-4,5,1,2,0,2,0,1,1,-4,5,1,-1,1,0,0,-3,-2,0,-6,6,0,0,0,-1,-1,0,-1,4,-1
KR_6747731068,420,-4,10,-8,-7,1,1,2,-4,5,1,-4,5,1,0,0,0,0,1,1,0,-9,-32,-1,-5,6,-3,0,0,-1,-1,0,-1,3,-1
KR_6759202128,420,5,22,15,4,3,0,3,-3,4,1,3,1,4,0,1,1,1,0,1,0,-1,-7,0,-5,5,3,0,0,-1,1,0,1,5,-1
KR_6624146280,420,-3,-45,12,-9,-4,4,0,-3,6,3,-2,3,1,0,5,5,0,2,2,-1,-6,0,-1,-6,7,-4,0,-2,1,-1,-1,-1,5,-1
KR_6764581696,420,1,75,-10,7,2,1,3,-1,2,1,1,2,3,1,3,4,4,0,4,1,6,-29,1,-5,4,1,0,1,1,1,1,1,6,-1
KR_6709168171,420,1,-29,17,-1,-1,2,1,3,2,5,-3,5,2,-2,4,2,2,1,3,0,7,7,2,-11,9,-3,0,1,-1,1,1,1,5,-1
KR_6754190889,420,0,-35,-6,2,0,1,1,-3,6,3,0,2,2,2,6,8,3,0,3,0,-3,-6,1,-8,7,-1,0,0,-1,-1,0,1,2,-1
KR_6747134934,420,-2,-33,-47,0,-2,5,3,-6,6,0,3,1,4,3,2,5,2,0,2,0,-3,18,-3,-2,5,1,0,0,1,1,0,1,6,-1
KR_6710992461,420,-4,-98,4,-13,-1,1,0,0,0,0,-2,2,0,-9,9,0,-1,1,0,0,-14,-248,-3,-4,7,-1,0,-2,-1,-1,-1,-1,5,-1
KR_6664920892,420,0,2,-3,4,1,1,2,-1,1,0,6,0,6,-1,5,4,-1,1,0,0,5,32,0,-4,4,3,0,1,-1,-1,1,1,1,-1
KR_6741679755,420,-1,-22,4,-5,-4,4,0,3,1,4,-3,5,2,0,3,3,-1,1,0,0,5,32,2,-6,4,1,0,0,0,1,0,1,0,-1
KR_6626236337,420,-7,-35,-34,-11,1,1,2,-4,4,0,-7,9,2,2,2,4,-3,3,0,0,-11,-15,3,-10,7,-5,0,-2,-1,0,-1,1,1,-1
KR_6755573042,420,0,-1,-16,1,1,2,3,1,1,2,0,2,2,1,2,3,-2,2,0,0,1,-6,-2,-7,9,-6,0,0,-1,1,0,-1,1,-1
KR_6712944129,440,-2,-34,-6,-5,-2,3,1,-7,8,1,-1,3,2,1,1,2,4,0,4,0,3,8,0,-5,5,1,0,0,-1,-1,0,-1,2,-1
KR_6764993393,420,-13,-167,-10,-19,-3,4,1,-2,3,1,-13,13,0,-1,1,0,0,1,1,0,-16,-132,0,-2,2,-2,-1,-7,-1,1,-1,-1,3,-1
KR_6730450484,440,-4,-63,-10,-15,0,1,1,-6,8,2,-5,8,3,1,1,2,-5,5,0,0,-9,0,-6,-2,8,-2,0,-2,0,-1,-1,-1,0,-1
KR_6738438057,420,0,-14,-15,1,3,1,4,0,1,1,-2,2,0,-4,4,0,4,1,5,1,3,-2,1,-5,4,-2,0,0,-1,-1,1,1,4,-1
KR_6758689114,420,5,65,8,8,5,2,7,0,1,1,2,1,3,-2,4,2,3,0,3,-1,7,-20,-3,-5,8,1,0,0,1,1,1,-1,1,-1
KR_6625589729,420,-5,-21,-10,-8,-3,4,1,0,3,3,-3,3,0,-2,4,2,0,0,0,0,1,20,0,-5,5,-6,0,-4,-1,-1,-1,1,3,-1
KR_6764020442,420,2,26,18,5,2,1,3,0,2,2,1,1,2,2,2,4,0,1,1,0,2,34,-1,-8,9,3,0,0,1,1,1,-1,4,-1
KR_6682111058,420,0,-119,-2,-3,-4,4,0,4,3,7,6,1,7,-10,11,1,1,1,2,-1,-6,128,-3,-2,5,1,0,-2,1,-1,-1,-1,6,-1
KR_6749354164,420,-1,2,-33,-1,1,0,1,-2,7,5,-3,4,1,2,2,4,1,0,1,1,-5,-7,1,-6,5,3,0,-1,-1,-1,-1,1,4,-1
KR_6575541131,420,-2,-7,-24,-6,4,0,4,-5,6,1,-2,3,1,-1,1,0,-2,3,1,-3,-7,7,1,-7,6,0,0,0,0,-1,-1,-1,0,-1
KR_6697646338,440,-2,-53,20,-2,2,0,2,-1,2,1,2,1,3,-5,9,4,0,0,0,0,-5,2,-2,-4,6,1,0,0,-1,1,0,-1,1,-1
KR_6646094028,440,1,-38,27,-6,1,2,3,1,0,1,-2,2,0,-7,8,1,1,0,1,0,-9,-2,-2,-5,7,1,0,1,1,1,1,1,3,-1
KR_6672172791,420,2,-37,18,5,1,0,1,4,1,5,3,0,3,-2,3,1,-1,1,0,0,4,-5,-3,-2,5,-1,0,-1,-1,-1,-1,1,3,-1
KR_6742406340,420,2,27,-16,6,0,2,2,0,4,4,2,1,3,2,0,2,2,0,2,0,8,-4,4,-9,5,3,0,0,-1,-1,-1,1,5,-1
KR_6713003716,420,1,-14,0,5,-3,4,1,-1,4,3,1,1,2,5,2,7,3,0,3,0,7,2,0,-5,5,-6,0,1,1,-1,1,-1,6,-1
KR_6665044765,420,0,24,12,-4,3,1,4,-4,7,3,-1,2,1,-1,2,1,-1,1,0,0,-4,-96,-2,-4,6,15,0,-1,1,-1,-1,1,1,-1
KR_6530097370,420,3,35,12,1,0,2,2,-5,7,2,-1,3,2,6,4,10,1,0,1,0,11,-8,-4,-5,9,-3,0,0,-1,-1,0,-1,6,-1
KR_6762464624,420,2,20,5,0,0,3,3,2,0,2,0,1,1,0,1,1,-2,4,2,0,1,-14,2,-5,3,2,0,0,-1,1,0,-1,2,-1
KR_6763772337,420,0,-45,10,3,4,0,4,3,0,3,-4,4,0,1,1,2,-1,4,3,0,3,15,-1,-4,5,-1,0,-2,1,-1,-1,-1,2,-1
KR_6764172290,420,-3,-22,13,-9,-2,2,0,2,2,4,-2,4,2,-4,5,1,-3,3,0,-1,-12,16,2,-6,4,0,0,0,0,1,0,-1,0,-1
KR_6749175490,420,-1,-31,16,-5,0,0,0,-3,3,0,-2,2,0,0,0,0,0,0,0,0,-7,-2,-1,-2,3,2,0,-1,1,-1,-1,-1,4,-1
KR_6726345747,420,-6,-95,4,-11,-4,4,0,0,3,3,-2,3,1,-3,4,1,-2,3,1,0,-10,30,0,-6,6,-3,0,-2,-1,-1,-1,1,3,-1
KR_6749530735,420,0,0,-24,-1,4,0,4,0,3,3,1,0,1,-5,6,1,-1,4,3,0,-4,291,-2,-4,6,1,0,0,-1,1,-1,1,2,-1
KR_6749604336,420,0,-20,-14,1,4,0,4,-1,2,1,-3,4,1,0,1,1,1,1,2,0,-7,0,-2,-7,9,3,0,0,-1,-1,-1,1,4,-1
KR_6508481050,420,-2,-40,4,-8,4,1,5,-8,9,1,-1,5,4,-2,3,1,-1,1,0,0,-14,-4,-1,-4,5,-5,0,-3,-1,-1,-1,1,6,-1
KR_6627998053,420,0,13,12,0,6,0,6,-1,3,2,-3,4,1,1,2,3,-3,3,0,0,-1,10,0,-2,2,0,0,1,1,-1,-1,-1,1,-1
KR_6742655620,420,-2,-13,-22,-9,3,3,6,-10,12,2,-3,4,1,2,3,5,-1,2,1,-3,-11,0,3,-9,6,0,0,1,-1,1,1,-1,3,-1
KR_6708852697,440,-1,7,8,-4,1,1,2,-6,6,0,-1,1,0,2,0,2,0,1,1,0,-5,25,-5,-5,10,-3,0,0,1,-1,0,-1,5,-1
KR_6741874030,420,-5,-43,-47,-9,-4,4,0,-2,3,1,0,1,1,-3,6,3,0,1,1,0,-2,-6,1,-6,5,0,0,0,-1,-1,-1,-1,4,-1
KR_6702553006,420,-2,-36,10,-6,-1,2,1,-2,4,2,2,1,3,-3,6,3,-2,3,1,-1,-9,2,5,-8,3,4,0,0,-1,-1,-1,-1,5,-1
KR_6339058605,420,-4,-9,-4,-5,1,1,2,1,1,2,-6,6,0,2,0,2,-3,3,0,0,-7,-2,-3,-3,6,-4,0,-1,1,-1,-1,-1,3,-1
KR_6716620838,420,-1,-8,-51,3,-1,3,2,-2,6,4,0,2,2,2,0,2,4,1,5,0,-3,-2,-3,-6,9,-4,0,-2,-1,-1,-1,-1,3,-1
KR_6705121542,440,-2,-107,7,-8,-2,7,5,2,5,7,-1,3,2,-6,7,1,-1,2,1,-2,-11,-15,0,-3,3,-2,0,-2,-1,0,-1,-1,3,-1
KR_6711697152,420,-2,-45,-9,-5,2,2,4,-3,5,2,-1,1,0,-2,4,2,-1,2,1,0,-5,-7,-4,-3,7,1,0,0,-1,-1,0,1,2,-1
KR_6756602655,420,-2,-19,-8,-5,3,1,4,-3,4,1,-3,3,0,-2,5,3,0,0,0,0,-12,8,3,-8,5,-7,0,0,-1,-1,-1,1,6,-1
KR_6339008220,420,-4,4,-13,-9,-2,2,0,-6,6,0,-1,1,0,-1,3,2,1,1,2,1,-16,10,2,-8,6,-11,0,0,1,0,0,1,3,-1
KR_6760441741,440,0,-14,10,-5,-5,5,0,3,1,4,-5,6,1,4,4,8,-2,3,1,-1,1,8,0,-7,7,2,0,-3,1,-1,-1,-1,5,-1
KR_6761989300,440,-2,-43,16,-3,-6,6,0,2,1,3,-1,2,1,-2,6,4,4,0,4,0,-6,6,5,-8,3,-2,0,-2,0,1,-1,1,0,-1
KR_6336375993,420,-6,-12,-43,-7,-3,3,0,-2,5,3,2,0,2,-4,5,1,0,1,1,0,-1,-12,1,-7,6,1,0,-1,1,-1,-1,-1,5,-1
KR_6763288269,440,0,13,8,-2,-1,1,0,1,2,3,-4,7,3,2,2,4,0,0,0,0,0,-16,0,-3,3,16,0,1,-1,1,-1,1,2,-1
KR_6719396903,420,0,18,19,-3,2,0,2,-1,4,3,-2,2,0,-2,6,4,0,1,1,0,-5,9,-1,-7,8,2,0,0,0,0,0,1,0,-1
KR_6742607183,420,-1,25,24,-6,-4,5,1,0,3,3,-1,1,0,-2,5,3,1,2,3,0,-10,-136,-3,-4,7,-12,0,1,1,-1,1,1,6,-1
KR_6760951683,420,2,-1,-36,7,2,2,4,1,2,3,4,1,5,2,2,4,-2,3,1,0,9,-49,-2,-4,6,19,0,-1,-1,-1,-1,1,1,-1
KR_6727168484,420,-2,-53,-6,-7,-2,4,2,-2,2,0,-4,7,3,1,5,6,0,0,0,0,-13,-4,-5,-2,7,0,0,-2,1,-1,-1,-1,6,-1
KR_6751701472,420,-3,5,0,-7,-3,5,2,-1,4,3,3,0,3,-4,7,3,-2,2,0,-1,-10,-26,0,-7,7,-1,0,-1,1,-1,-1,-1,5,-1
KR_6714279131,440,-3,-53,11,-5,-1,3,2,2,2,4,0,2,2,-6,6,0,0,2,2,0,-3,1,-2,-8,10,-3,0,0,1,1,0,1,5,-1
KR_6662061717,420,-5,-117,2,-14,-8,8,0,-1,3,2,-2,5,3,-2,3,1,-1,2,1,0,-8,-188,4,-6,2,-1,0,-2,1,-1,-1,-1,5,-1
KR_6718029923,420,1,-3,-16,-3,-3,4,1,1,7,8,1,0,1,-1,6,5,-1,1,0,0,4,16,-4,-4,8,0,0,0,1,1,-1,-1,5,-1
KR_6752241922,420,1,-54,7,3,-4,6,2,4,4,8,3,0,3,1,1,2,-1,2,1,-2,4,4,0,-6,6,3,0,1,0,1,1,-1,0,-1
KR_6715390149,420,-2,-24,-20,-4,4,2,6,1,2,3,-5,7,2,-3,3,0,-1,1,0,0,-13,-2,-2,0,2,1,0,-3,-1,-1,-1,-1,3,-1
KR_6735077161,420,1,-37,-2,2,-1,1,0,3,0,3,-1,5,4,1,2,3,0,0,0,0,6,-8,-3,-3,6,4,0,0,1,-1,0,-1,5,-1
KR_6623372464,420,-1,23,16,-13,0,2,2,-4,6,2,-2,3,1,-5,10,5,-2,3,1,0,-20,-37,-6,-6,12,-4,0,-1,1,-1,-1,-1,4,-1
KR_6730159978,420,2,38,0,11,-2,3,1,0,2,2,5,1,6,8,1,9,0,2,2,0,8,-17,2,-4,2,3,0,1,1,-1,1,1,4,-1
KR_6757945198,420,0,55,25,-5,-2,3,1,-5,6,1,-4,6,2,4,2,6,2,1,3,1,-3,5,-1,-2,3,-5,0,-2,1,-1,-1,1,1,-1
KR_6758881722,420,1,48,-2,3,0,2,2,2,2,4,-2,3,1,4,2,6,-1,2,1,0,2,8,4,-8,4,-4,0,1,-1,1,1,1,4,-1
KR_6765050375,420,1,-12,10,4,3,1,4,7,0,7,-4,4,0,-3,5,2,1,0,1,0,12,3,-2,-2,4,1,0,0,-1,1,0,1,3,-1
KR_6761599558,440,-2,28,-49,-4,-1,2,1,2,1,3,-2,5,3,0,2,2,-3,4,1,-1,0,-38,-2,-5,7,-4,0,0,0,-1,1,-1,0,-1
KR_6763933681,420,-2,72,-4,-8,-2,3,1,-3,4,1,-1,2,1,-4,9,5,2,0,2,0,-19,-60,-1,-3,4,5,0,-1,0,-1,-1,-1,0,-1
KR_6758463171,420,3,1,38,3,-2,4,2,4,2,6,0,1,1,-1,1,0,2,1,3,0,4,440,-2,-5,7,1,0,0,1,-1,1,-1,1,-1
KR_6744591796,420,0,-15,3,1,-2,2,0,0,2,2,2,2,4,0,1,1,1,1,2,0,5,33,5,-9,4,3,0,0,-1,1,1,-1,1,-1
KR_6764388667,420,0,-17,-2,1,-3,3,0,1,2,3,-3,4,1,5,1,6,1,2,3,0,6,-7,-3,-3,6,-2,0,1,-1,1,1,1,2,-1
KR_6699802017,420,-3,-28,-23,-9,-3,4,1,-2,3,1,-6,6,0,0,3,3,2,0,2,0,-8,0,-1,-8,9,-4,0,-1,-1,-1,-1,-1,5,-1
KR_6583496325,420,-1,-8,-8,-5,-4,4,0,-3,4,1,-1,2,1,3,1,4,0,0,0,0,-1,7,-2,-4,6,1,0,-2,-1,-1,-1,1,2,-1
KR_6382077182,420,-2,-103,-7,-5,-4,4,0,-2,3,1,0,4,4,0,6,6,1,0,1,0,-4,4,-1,-6,7,-8,0,-2,1,-1,-1,-1,4,-1
KR_6749947282,420,4,-12,0,8,1,2,3,6,4,10,-1,3,2,-1,4,3,3,0,3,-1,4,253,-4,-5,9,3,0,1,1,1,1,-1,6,-1
KR_6745533676,420,-2,-19,1,-9,-2,2,0,-2,2,0,-4,4,0,-1,5,4,0,1,1,0,-7,18,1,-4,3,-2,0,0,1,1,0,-1,1,-1
KR_6610011213,420,1,36,17,2,0,1,1,3,3,6,-1,2,1,1,2,3,-1,3,2,0,3,-4,0,-3,3,-2,0,0,1,1,1,-1,6,-1
KR_6717518853,420,-1,18,19,-1,2,2,4,-7,9,2,3,2,5,1,3,4,0,0,0,0,0,-2,2,-6,4,-6,0,2,1,-1,1,-1,6,-1
KR_6755195741,420,-3,15,-20,-5,-7,7,0,-3,3,0,1,4,5,2,0,2,2,0,2,0,-4,2,-1,-3,4,1,0,0,-1,-1,0,-1,1,-1
KR_6691214776,420,3,70,7,4,0,1,1,1,0,1,0,3,3,2,0,2,1,0,1,0,4,-2,-1,-3,4,1,0,0,-1,1,-1,-1,6,-1
KR_6749419988,440,-1,59,-16,1,-2,4,2,2,2,4,3,0,3,0,2,2,-2,2,0,0,-1,32,5,-5,0,-1,0,1,-1,1,1,-1,5,-1
KR_6697292271,440,-2,-58,5,-8,1,2,3,-6,8,2,-1,1,0,-3,4,1,1,0,1,0,-13,7,4,-10,6,-3,0,0,-1,1,0,-1,2,-1
KR_6719836808,420,-4,3,-17,-11,-1,1,0,-3,4,1,-1,3,2,-2,4,2,-4,4,0,-1,-9,18,3,-7,4,-4,0,0,-1,-1,-1,1,1,-1
KR_6475797056,420,-1,-38,-4,0,-1,1,0,-5,5,0,7,0,7,-2,2,0,1,1,2,-1,1,-10,0,-5,5,-1,0,0,-1,-1,0,-1,3,-1
KR_6719000376,420,-7,-69,-56,-11,-7,7,0,2,4,6,-2,2,0,-3,5,2,-1,3,2,0,-1,-12,-4,-2,6,4,0,-1,-1,-1,-1,1,2,-1
KR_6755819913,420,-1,-21,-13,-7,-1,2,1,6,1,7,-7,7,0,0,2,2,-5,8,3,1,-1,9,-3,-2,5,2,0,-1,-1,1,-1,1,1,-1
KR_6758587245,420,1,20,10,2,0,1,1,4,4,8,-3,7,4,0,1,1,1,0,1,0,9,-1,2,-6,4,1,0,-1,1,-1,-1,-1,4,-1
KR_6731635621,420,-2,-73,-44,-8,-4,5,1,1,2,3,-4,4,0,-1,6,5,0,1,1,0,-2,251,-1,-4,5,-5,0,0,1,-1,-1,-1,6,-1
KR_6763575018,420,-5,-53,16,-15,1,1,2,-3,5,2,-6,9,3,-5,6,1,-2,3,1,-1,-15,-6,-6,-2,8,1,0,-2,1,-1,-1,-1,4,-1
KR_6761632826,420,-4,23,-36,0,1,1,2,0,0,0,1,1,2,-4,6,2,2,0,2,0,-6,-4,-2,-6,8,-1,0,0,0,-1,0,1,0,-1
KR_6727941852,440,-6,-32,-13,-15,-1,1,0,-1,2,1,-5,5,0,-8,10,2,0,1,1,-1,-20,-2,2,-6,4,-1,0,-3,0,-1,-1,-1,0,-1
KR_6659327560,420,-3,-1,-4,-10,-1,1,0,-1,3,2,3,4,7,-8,10,2,-3,3,0,0,-7,-3,-6,-4,10,4,0,-2,1,-1,-1,-1,3,-1
KR_6758759715,420,-4,-51,3,-15,-1,2,1,-6,6,0,-1,3,2,-7,8,1,0,0,0,0,-22,-6,-4,-1,5,1,0,-2,0,-1,-1,-1,0,-1
KR_6710303316,420,0,26,12,-2,1,1,2,2,0,2,1,0,1,-3,3,0,-3,3,0,0,-7,-14,-7,-1,8,1,0,0,-1,-1,0,1,3,-1
KR_6761028131,420,1,44,-13,-3,1,0,1,-8,9,1,1,0,1,1,2,3,2,0,2,0,1,-15,0,-6,6,-1,0,0,-1,-1,0,-1,3,-1
KR_6727532292,420,0,-46,36,6,-1,4,3,5,1,6,-2,5,3,3,1,4,1,1,2,0,8,-99,5,-7,2,2,0,0,-1,1,0,-1,2,-1
KR_6717461778,420,0,59,16,-6,-3,5,2,-6,7,1,-2,2,0,4,0,4,1,0,1,0,-2,6,1,-3,2,1,0,1,1,-1,1,1,5,-1
KR_6764705070,440,1,-21,-2,-2,0,0,0,2,2,4,0,3,3,-1,2,1,-3,3,0,0,3,-16,8,-10,2,-1,0,-1,-1,0,-1,1,6,-1
KR_6699721104,420,-2,-56,7,-4,-2,2,0,1,2,3,-6,6,0,-1,3,2,4,0,4,0,-8,-1,0,-7,7,-9,0,0,-1,1,-1,1,5,-1
KR_6749642484,420,0,-13,-10,-1,1,1,2,-2,3,1,-2,8,6,1,2,3,1,1,2,0,-6,7,1,-4,3,-4,0,-1,0,-1,-1,-1,0,-1
KR_6762588686,440,-4,-34,-8,-10,1,1,2,-2,4,2,-4,5,1,-6,7,1,1,1,2,-1,-6,4,2,-5,3,-1,0,0,0,0,-1,-1,0,-1
KR_6764985414,440,-1,-29,1,2,-1,3,2,-2,4,2,5,1,6,-3,5,2,3,1,4,0,6,4,0,-4,4,-3,0,0,1,-1,-1,-1,6,-1
KR_6734522233,440,1,-39,-20,6,3,1,4,-1,3,2,3,2,5,2,1,3,-1,1,0,0,5,-1,-2,-5,7,4,0,0,1,0,0,-1,4,-1
KR_6616329121,420,-3,-36,0,-9,-3,3,0,1,0,1,-5,5,0,0,1,1,-2,3,1,0,-12,-1,2,-5,3,-1,0,-1,0,-1,-1,-1,0,-1
KR_6757748621,420,-2,-74,-8,-9,-5,5,0,-4,6,2,0,7,7,1,3,4,-1,3,2,1,-4,-1,0,-5,5,-3,0,-2,1,-1,-1,1,6,-1
KR_6755822873,420,-4,-57,-7,-4,-3,4,1,2,10,12,0,4,4,-4,4,0,1,1,2,0,1,5,-1,-4,5,4,0,-1,1,-1,-1,-1,3,-1
KR_6678676538,420,-2,-32,7,-6,-5,6,1,3,0,3,1,2,3,-3,5,2,-2,3,1,-1,-10,184,-1,-3,4,-3,0,-1,0,1,1,-1,0,-1
KR_6696181626,420,-1,9,35,-7,-2,3,1,4,0,4,-2,4,2,-4,5,1,-3,5,2,1,0,1,4,-7,3,0,0,-2,-1,1,-1,1,6,-1
KR_6736826807,420,0,-69,-33,-9,1,2,3,-1,2,1,-1,6,5,-8,8,0,0,0,0,0,-9,6,2,-6,4,-2,0,-1,-1,1,-1,-1,5,-1
KR_6732624778,420,-5,11,-16,-14,-5,6,1,0,1,1,-1,1,0,-5,8,3,-3,3,0,0,-17,161,1,-5,4,-1,0,-2,-1,0,-1,1,1,-1
KR_6762675974,420,-4,-78,-24,-15,-7,7,0,-1,7,6,-4,5,1,-2,2,0,-1,2,1,0,2,37,-5,-5,10,0,0,-1,-1,-1,-1,-1,2,-1
KR_6339158837,420,-3,-13,7,-3,-3,4,1,-3,6,3,0,2,2,4,2,6,-1,1,0,2,2,-4,2,-8,6,-2,0,-1,-1,1,-1,1,2,-1
KR_6751260941,420,-4,-77,-4,-18,-1,1,0,-5,5,0,-4,7,3,1,5,6,-9,9,0,-1,-16,-3,-4,-1,5,-3,0,-1,-1,-1,-1,-1,2,-1
KR_6763015419,420,0,-5,13,-6,1,1,2,-4,5,1,-2,4,2,0,3,3,-1,1,0,0,-8,6,-5,-4,9,-3,0,0,-1,-1,0,-1,6,-1
KR_6739836848,440,-1,-37,-16,-4,-2,3,1,-3,6,3,-2,7,5,2,5,7,1,1,2,-1,10,43,0,-1,1,1,0,-3,1,-1,-1,-1,3,-1
KR_6724693559,440,-1,-11,-16,-5,-1,2,1,-1,3,2,-2,2,0,-1,3,2,0,0,0,0,-5,-12,0,-6,6,-2,0,0,-1,-1,0,-1,6,-1
KR_6735282641,420,3,-40,24,4,-2,3,1,5,1,6,1,1,2,3,1,4,-3,3,0,0,11,14,-2,-7,9,2,0,-1,1,-1,-1,1,2,-1
KR_6752340805,420,-2,-58,-20,-7,0,1,1,-3,5,2,-4,4,0,1,2,3,-1,1,0,0,-11,3,10,-11,1,-2,0,1,-1,1,1,-1,3,-1
KR_6745181077,420,2,20,0,-2,4,0,4,-5,10,5,-2,3,1,-1,4,3,2,0,2,0,6,-10,0,-8,8,0,0,0,-1,1,0,1,3,-1
KR_6759327759,420,-4,-30,-13,-7,-4,5,1,-4,9,5,2,2,4,0,2,2,-1,2,1,0,-5,-16,-1,-7,8,1,0,-3,-1,-1,-1,-1,2,-1
KR_6750063953,420,3,-4,20,14,2,1,3,-1,5,4,4,2,6,2,3,5,7,0,7,1,19,10,-1,-4,5,0,0,1,1,1,1,1,2,-1
KR_6752925422,420,-2,-61,4,0,-1,3,2,2,0,2,-2,3,1,1,3,4,0,1,1,0,0,1,0,-4,4,3,0,0,1,1,0,1,3,-1
KR_6515741969,420,1,-3,-15,-2,-1,3,2,0,2,2,4,2,6,-4,5,1,-1,2,1,-2,0,-14,-1,-7,8,0,0,1,1,1,1,-1,3,-1
KR_6638400601,420,-6,-18,-53,-14,-2,5,3,-7,8,1,1,1,2,-4,5,1,-2,2,0,0,-9,-5,-3,-5,8,-2,0,-4,-1,-1,-1,-1,5,-1
KR_6637449353,420,1,7,4,-2,0,1,1,-1,1,0,-1,2,1,0,2,2,0,0,0,0,-2,-5,1,-5,4,-2,0,0,1,1,0,-1,3,-1
KR_6737262905,420,4,33,-29,3,4,2,6,2,1,3,2,1,3,-5,8,3,0,0,0,0,-3,1,4,-7,3,4,0,0,-1,1,-1,1,1,-1
KR_6761723054,420,-1,18,-19,-4,-3,4,1,2,1,3,2,1,3,-3,6,3,-2,3,1,0,-4,1,0,-2,2,2,0,-1,-1,1,-1,-1,3,-1
KR_6759609282,440,2,8,15,3,0,4,4,1,1,2,2,1,3,-1,8,7,1,0,1,0,6,1,2,-5,3,-1,0,0,1,1,1,1,6,-1
KR_6662091725,440,0,-21,21,-2,1,4,5,-2,4,2,0,0,0,0,1,1,-1,2,1,0,-5,-35,-5,-4,9,2,0,0,1,1,1,1,6,-1
KR_6685369887,420,-4,-4,19,-8,-6,8,2,0,1,1,0,2,2,0,4,4,-2,3,1,-1,-20,-1,5,-8,3,-2,0,0,-1,1,1,-1,2,-1
KR_6731221869,420,0,18,13,-2,1,0,1,-6,6,0,-3,5,2,5,0,5,1,1,2,0,-5,-5,-1,-3,4,3,0,1,1,-1,1,1,5,-1
KR_6684772696,420,-2,-25,-26,-7,-2,3,1,2,2,4,-7,7,0,-1,5,4,1,1,2,-1,2,10,3,-7,4,-1,0,0,-1,1,1,-1,3,-1
KR_6745619385,420,-1,-19,-4,3,0,1,1,3,0,3,0,2,2,1,4,5,-1,2,1,-2,-4,8,5,-6,1,-9,0,1,1,1,1,-1,6,-1
KR_6761750805,420,-2,-15,-31,3,-1,3,2,2,2,4,3,1,4,1,2,3,-2,2,0,0,7,-3,-6,-1,7,0,0,0,1,-1,0,1,4,-1
KR_6764914130,420,-2,-96,-11,-4,-2,3,1,-3,4,1,1,2,3,2,3,5,-2,2,0,0,5,79,-5,-3,8,-4,0,-1,-1,1,-1,-1,1,-1
KR_6705212474,420,1,-43,9,2,-4,4,0,2,2,4,1,1,2,2,1,3,1,0,1,0,11,10,4,-10,6,1,0,-1,-1,1,-1,1,6,-1
KR_6755741964,420,0,-20,-15,-1,5,0,5,-2,4,2,-1,2,1,-1,2,1,-2,2,0,0,-5,-6,-2,-6,8,2,0,0,-1,-1,-1,1,6,-1
KR_6742226261,420,-5,-110,-23,-13,-2,5,3,-3,5,2,-2,4,2,-8,8,0,2,1,3,-1,-7,-2,-1,-7,8,2,0,-1,-1,1,-1,-1,6,-1
KR_6765061061,420,0,-23,11,-4,0,0,0,-1,2,1,-1,1,0,-2,2,0,0,0,0,0,-5,-8,5,-6,1,-3,0,1,-1,1,1,-1,2,-1
KR_6755219533,420,-1,-2,-9,-5,1,0,1,-7,7,0,2,4,6,0,1,1,-1,3,2,0,-1,-134,-2,-5,7,2,0,0,0,-1,0,-1,0,-1
KR_6758187641,420,0,17,7,1,2,1,3,1,2,3,-3,3,0,-2,8,6,3,0,3,0,2,-375,2,-6,4,2,0,0,-1,-1,0,1,4,-1
KR_6618376757,420,2,44,-28,6,-4,5,1,0,4,4,5,0,5,3,1,4,2,0,2,0,16,16,3,-5,2,-6,0,1,-1,-1,1,1,6,-1
KR_6764471758,420,0,69,41,-1,3,1,4,2,2,4,0,2,2,-3,3,0,-3,6,3,0,-8,-6,-2,-1,3,5,0,0,-1,1,-1,1,2,-1
KR_6725008603,440,2,61,0,8,0,3,3,-3,4,1,2,2,4,8,0,8,1,0,1,2,13,4,-2,-2,4,1,0,1,-1,0,1,1,4,-1
KR_6562012390,420,1,-35,20,0,-1,2,1,3,1,4,-3,5,2,-1,1,0,2,0,2,-2,-2,20,1,-4,3,-1,0,-1,1,-1,-1,-1,6,-1
KR_6624130713,420,1,-68,-12,-3,-2,2,0,-6,6,0,3,3,6,2,3,5,0,2,2,-2,4,72,-1,-6,7,-3,0,0,-1,-1,0,-1,1,-1
KR_6714893677,420,0,-15,-8,-4,5,0,5,-3,3,0,-3,5,2,-1,1,0,-2,3,1,0,-3,39,5,-8,3,-6,0,0,-1,-1,0,1,4,-1
KR_6655355094,420,-2,-9,-12,-2,-3,4,1,-1,3,2,1,2,3,0,2,2,1,0,1,0,-7,1,4,-7,3,-1,0,2,-1,1,1,1,1,-1
KR_6609830531,420,2,-89,22,6,-2,3,1,4,1,5,-1,2,1,5,0,5,0,0,0,0,15,16,0,-5,5,2,0,1,-1,-1,1,1,1,-1
KR_6705386356,420,0,-83,4,0,-1,1,0,2,2,4,1,2,3,-2,6,4,0,3,3,0,0,4,2,-7,5,-2,0,-2,1,-1,-1,-1,5,-1
KR_6729146285,420,-4,-66,-9,-6,-5,5,0,3,3,6,2,3,5,-4,6,2,-2,2,0,1,-5,-11,-6,-3,9,1,0,-1,-1,-1,-1,1,5,-1
KR_6761729935,420,-3,-42,-52,-8,-4,4,0,-5,6,1,0,2,2,1,0,1,0,0,0,-1,-6,-10,-7,-2,9,3,0,0,-1,-1,0,-1,2,-1
KR_6750848555,420,-4,-39,-13,-6,1,0,1,-4,5,1,-4,4,0,1,1,2,0,2,2,0,-2,98,4,-9,5,0,0,-1,1,-1,-1,-1,3,-1
KR_6746458411,420,-3,-40,2,-5,2,2,4,-4,4,0,-3,3,0,0,3,3,0,2,2,0,-5,1,-3,-4,7,-2,0,2,-1,1,1,1,3,-1
KR_6711411902,420,1,1,32,-1,4,1,5,-5,5,0,0,0,0,2,0,2,-2,3,1,1,-11,25,-2,-4,6,2,0,0,1,1,0,1,6,-1
KR_6752715990,420,-2,-29,-40,-6,1,1,2,-3,4,1,0,3,3,-4,5,1,0,0,0,0,-5,14,1,-7,6,-2,0,-1,-1,-1,-1,-1,5,-1
KR_6760025683,420,-2,-53,-35,-14,-3,3,0,-2,9,7,-4,6,2,-2,4,2,-3,4,1,-1,-15,-14,-3,-2,5,4,0,-1,1,1,-1,-1,5,-1
KR_6760696147,420,-1,55,-32,2,0,2,2,0,5,5,3,2,5,0,0,0,-1,1,0,0,5,36,2,-4,2,-6,0,1,1,1,1,1,3,-1
KR_6762851378,420,-1,-41,28,-3,-3,4,1,-2,2,0,0,1,1,1,2,3,1,0,1,0,0,-240,-4,-1,5,-2,0,-1,-1,-1,-1,1,6,-1
KR_6729800228,420,2,61,9,-1,3,1,4,-7,9,2,0,2,2,0,5,5,3,0,3,0,-10,2,-5,-3,8,1,0,2,1,1,1,-1,3,-1
KR_6674966170,420,-3,-120,20,-9,1,1,2,-4,6,2,2,3,5,-8,8,0,0,1,1,0,-9,-1,1,-6,5,0,0,-2,1,-1,-1,1,1,-1
KR_6747298961,420,-2,10,0,2,-1,2,1,-1,4,3,1,0,1,0,0,0,3,0,3,0,3,-5,2,-4,2,-2,0,0,-1,1,0,1,3,-1
KR_6759191482,440,-2,-26,4,-2,-3,4,1,1,2,3,2,4,6,0,3,3,-2,4,2,0,-6,4,2,-6,4,2,0,0,-1,0,1,-1,1,-1
KR_6761344278,420,-3,16,-20,-13,-2,4,2,-1,2,1,-5,6,1,-4,5,1,-1,1,0,0,-20,-7,-5,-3,8,-1,0,0,-1,-1,1,-1,2,-1
KR_6740676913,420,4,-2,-20,6,0,2,2,3,2,5,0,2,2,2,1,3,1,0,1,1,14,37,-1,-4,5,1,0,0,1,-1,0,1,4,-1
KR_6758009303,420,-1,7,-4,-6,1,2,3,2,0,2,-2,3,1,-7,8,1,0,0,0,0,-5,-10,4,-6,2,1,0,2,1,1,1,-1,6,-1
KR_6762287822,420,-2,-44,-22,-9,1,0,1,0,1,1,0,5,5,-6,8,2,-4,4,0,0,-11,-20,3,-6,3,5,0,-1,-1,-1,-1,-1,4,-1
KR_6727941571,420,3,31,28,7,-4,6,2,-1,3,2,5,1,6,3,2,5,4,0,4,0,9,2,1,-6,5,0,0,1,1,1,1,1,3,-1
KR_6756546543,420,1,56,-4,-5,1,1,2,-1,2,1,-5,5,0,3,4,7,-3,3,0,0,-9,-19,-1,-2,3,-5,0,0,-1,-1,0,-1,3,-1
KR_6741365752,420,-2,-11,-47,-11,-1,1,0,-5,5,0,-6,8,2,-2,3,1,3,1,4,0,-5,1,8,-11,3,0,0,0,1,1,-1,1,3,-1
KR_6762423842,420,-1,-31,-10,-5,-3,5,2,-3,4,1,-2,5,3,2,0,2,1,0,1,0,11,12,-4,-4,8,-1,0,-1,1,-1,-1,-1,6,-1
KR_6643864815,420,0,20,-13,-3,0,1,1,-2,2,0,-1,2,1,0,2,2,0,1,1,0,-3,-4,-6,-2,8,2,0,0,-1,0,0,-1,6,-1
KR_6749677685,420,-3,-76,-12,4,2,1,3,1,0,1,-2,2,0,4,2,6,-1,1,0,0,0,-181,1,-8,7,2,0,-1,-1,-1,-1,1,2,-1
KR_6672804246,420,-2,3,-21,-1,0,2,2,1,0,1,1,0,1,-2,3,1,-1,1,0,0,-4,140,2,-9,7,-1,0,-2,1,1,-1,-1,6,-1
KR_6663341536,420,-5,-44,8,-15,-3,4,1,-6,8,2,-3,4,1,-2,2,0,-1,1,0,0,-21,-13,-4,-4,8,-3,0,-2,1,-1,-1,-1,3,-1
KR_6760616119,420,-4,12,-11,-10,-3,3,0,-1,2,1,-1,1,0,-5,6,1,0,2,2,1,-6,-3,-1,-5,6,-2,0,-1,1,1,-1,1,3,-1
KR_6728710675,420,-3,-57,-3,-5,3,1,4,-1,5,4,-2,4,2,-3,5,2,-2,2,0,0,-6,99,-2,-6,8,4,0,0,-1,1,1,1,2,-1
KR_6749190058,420,0,-7,-4,3,1,2,3,2,1,3,5,1,6,-4,4,0,-1,2,1,0,7,-5,-2,-4,6,4,0,0,1,1,0,-1,1,-1
KR_6746257885,420,-1,49,22,-4,2,0,2,0,1,1,3,2,5,-7,8,1,-2,4,2,0,-14,-6,1,-5,4,1,0,1,-1,1,1,-1,2,-1
KR_6764022546,420,-3,40,3,-6,-1,3,2,0,2,2,1,2,3,-2,5,3,-4,4,0,0,-4,-2,0,-5,5,3,0,-1,1,1,1,-1,4,-1
KR_6762334335,420,-3,105,32,-14,2,2,4,-2,3,1,-3,4,1,-9,9,0,-2,2,0,-1,-25,-3,-2,-4,6,-1,0,1,-1,-1,1,-1,5,-1
KR_6761938599,420,0,-31,24,-5,-2,3,1,-2,5,3,-1,2,1,0,3,3,0,0,0,-1,-14,-4,1,-5,4,0,0,0,-1,1,0,-1,2,-1
KR_6757052900,420,-1,30,-27,-2,3,0,3,2,1,3,-4,6,2,-4,8,4,1,0,1,0,0,-4,2,-6,4,-1,0,0,1,-1,0,-1,1,-1
KR_6676451552,440,-8,-79,-19,-18,-2,4,2,-3,5,2,-5,5,0,-4,5,1,-4,4,0,0,-18,-8,-1,-6,7,-2,0,-2,1,-1,-1,-1,6,-1
KR_6709324266,420,-9,-158,-47,-21,-3,5,2,-3,4,1,-7,8,1,-4,6,2,-4,4,0,0,-25,-16,-6,-2,8,-1,0,-4,-1,-1,-1,-1,3,-1
KR_6711326604,420,0,-58,-8,-7,1,1,2,1,2,3,-9,9,0,-2,5,3,2,0,2,0,-5,1,0,-7,7,-5,0,-1,-1,-1,-1,-1,3,-1
KR_6702783464,440,-1,-13,-36,3,3,1,4,-1,2,1,2,0,2,-1,3,2,0,2,2,0,-4,-30,-2,-6,8,12,0,1,1,-1,1,1,6,-1
KR_6744674882,420,-4,-25,-24,-6,0,1,1,1,2,3,-3,5,2,1,4,5,-5,5,0,0,-3,42,-1,-6,7,-8,0,0,-1,1,-1,1,5,-1
KR_6657104521,420,1,-29,12,-7,-1,2,1,-6,6,0,-1,4,3,-2,2,0,3,0,3,0,-3,149,0,-6,6,-1,0,-1,-1,1,1,-1,2,-1
KR_6748136421,420,1,-18,10,2,1,1,2,-4,4,0,3,1,4,1,4,5,1,0,1,0,1,2,1,-5,4,5,0,0,0,1,0,-1,0,-1
KR_6764537696,420,-3,-65,-23,-8,0,1,1,2,2,4,0,2,2,-2,4,2,-8,8,0,0,-4,-5,-1,-3,4,-2,0,-1,-1,-1,-1,1,4,-1
KR_6764336402,420,1,-14,34,-1,-5,5,0,3,2,5,1,1,2,0,1,1,0,0,0,0,7,8,-4,-4,8,2,0,-1,-1,1,-1,-1,4,-1
KR_6671323564,420,1,43,1,0,2,1,3,3,6,9,-2,3,1,-5,6,1,2,0,2,1,8,9,-2,-2,4,0,0,0,1,1,0,1,1,-1
KR_6744429068,420,1,14,-4,-1,-2,2,0,1,2,3,-3,7,4,1,1,2,2,1,3,0,-4,-155,2,-7,5,0,0,2,-1,1,1,-1,4,-1
KR_6749313108,420,-4,-20,10,-13,-4,4,0,-3,5,2,-1,2,1,-5,6,1,0,1,1,0,-20,-15,0,-5,5,0,0,-1,-1,0,-1,1,5,-1
KR_6757650655,420,-5,-62,11,-12,-1,2,1,-1,2,1,-1,2,1,-6,6,0,-3,4,1,0,-17,110,-3,-2,5,-3,0,-1,-1,-1,-1,-1,6,-1
KR_6707826789,420,-2,-72,-20,-11,-1,3,2,1,5,6,-8,11,3,-3,4,1,0,1,1,-2,-3,-3,4,-8,4,-3,0,-2,-1,-1,-1,-1,1,-1
KR_6758048920,440,-2,-115,11,-5,-1,3,2,-2,3,1,4,3,7,-6,6,0,0,0,0,0,-5,6,7,-8,1,-2,0,-2,0,1,-1,1,0,-1
KR_6706568458,420,0,39,-8,-2,-3,4,1,-3,5,2,-1,3,2,4,1,5,1,0,1,1,-7,-30,2,-6,4,1,0,0,0,-1,-1,1,0,-1
KR_6750702018,420,-5,-28,-43,-3,-1,3,2,-3,3,0,-3,3,0,2,1,3,2,0,2,1,-2,-64,2,-9,7,2,0,-1,-1,1,-1,1,5,-1
KR_6649294784,420,-2,-21,-18,-4,-2,3,1,0,1,1,0,4,4,-5,6,1,3,0,3,0,-4,193,-2,-3,5,-5,0,0,-1,-1,-1,-1,5,-1
KR_6735321158,420,-7,-31,-45,-15,-2,3,1,-9,9,0,-1,2,1,-1,3,2,-2,3,1,0,-11,-10,1,-5,4,-1,0,0,-1,-1,-1,-1,6,-1
KR_6737634567,420,-3,-37,8,-7,-1,4,3,-1,2,1,-7,7,0,1,1,2,1,0,1,0,-12,129,3,-5,2,-1,0,0,1,-1,-1,-1,1,-1
KR_6725645599,420,0,43,-6,-2,-1,1,0,-1,4,3,2,4,6,-1,2,1,-1,2,1,-2,-7,309,0,-7,7,1,0,-1,-1,1,1,-1,6,-1
KR_6685906369,420,-2,-6,-18,-9,-3,4,1,-1,1,0,-1,3,2,-3,6,3,-1,2,1,0,-14,-14,0,-3,3,1,0,0,-1,-1,0,-1,6,-1
KR_6746464671,440,2,43,-12,7,1,0,1,1,2,3,4,2,6,1,1,2,0,1,1,0,9,-1,4,-7,3,3,0,1,1,1,1,1,5,-1
KR_6735563623,420,-3,-54,8,-7,-1,1,0,2,1,3,-2,2,0,-2,4,2,-4,5,1,0,-1,75,-3,-3,6,3,0,-2,1,-1,-1,1,1,-1
KR_6641472000,420,1,-31,3,-1,1,1,2,-2,3,1,2,2,4,-5,9,4,3,0,3,-1,-5,5,5,-10,5,-6,0,0,-1,1,-1,1,4,-1
KR_6465546297,420,-2,7,5,-7,-2,3,1,2,0,2,-2,3,1,-6,8,2,1,1,2,0,-10,2,-2,-6,8,2,0,1,1,-1,1,-1,5,-1
KR_6728930709,440,2,61,39,3,-1,4,3,2,5,7,-1,4,3,2,1,3,1,1,2,0,-3,-28,2,-6,4,-6,0,2,-1,1,1,1,3,-1
KR_6740926831,420,-1,-17,7,0,2,1,3,-1,3,2,3,1,4,-3,5,2,-1,2,1,0,1,-225,1,-4,3,-4,0,0,1,1,0,-1,2,-1
KR_6761878995,440,2,-19,13,-2,-4,5,1,1,8,9,-1,2,1,3,1,4,-1,3,2,0,4,6,4,-6,2,-4,0,0,-1,-1,-1,1,3,-1
KR_6637746952,420,0,35,-13,2,1,3,4,-2,4,2,2,1,3,-1,3,2,2,1,3,0,9,0,0,-4,4,0,0,0,1,0,0,1,4,-1
KR_6750214539,420,-2,-23,-12,-5,-7,7,0,0,3,3,0,1,1,3,0,3,-1,1,0,0,-2,-27,1,-7,6,0,0,0,-1,-1,0,-1,1,-1
KR_6754402809,420,-3,-46,-13,-4,-1,2,1,-1,4,3,0,2,2,-2,3,1,0,0,0,0,-15,-44,-1,-6,7,-2,0,1,-1,1,1,1,1,-1
KR_6723067500,420,-5,-38,-12,-18,-4,5,1,-4,4,0,-1,3,2,-8,10,2,-1,1,0,0,-21,-1,-3,-4,7,-1,0,-2,1,-1,-1,-1,2,-1
KR_6764946480,420,-2,-99,13,-9,-1,2,1,1,2,3,-1,3,2,-7,7,0,-1,1,0,0,-2,-1,0,-8,8,-5,0,0,-1,1,0,-1,4,-1
KR_6694757745,420,-2,-6,-12,-4,1,1,2,-1,4,3,-2,3,1,-4,9,5,2,0,2,0,-7,-4,1,-8,7,0,0,0,-1,1,0,-1,1,-1
KR_6745912157,420,1,-2,2,7,-7,8,1,0,1,1,9,2,11,5,3,8,0,1,1,2,14,-4,-2,-4,6,3,0,-1,1,-1,-1,-1,2,-1
KR_6754225763,420,3,-27,17,2,0,2,2,1,2,3,-1,1,0,-2,3,1,4,0,4,1,2,18,2,-7,5,-4,0,3,1,1,1,1,6,-1
KR_6734396371,420,-3,15,-24,-2,-2,2,0,2,3,5,1,4,5,-3,6,3,0,2,2,0,4,-1,0,-6,6,-3,0,-1,-1,1,-1,-1,5,-1
KR_6749782174,420,-2,-10,-9,-8,1,0,1,-1,5,4,-5,5,0,-2,8,6,-1,1,0,0,-8,-3,-3,-3,6,-1,0,-1,-1,-1,-1,-1,6,-1
KR_6764920610,420,-2,-58,18,-8,-2,5,3,-2,4,2,0,3,3,-3,4,1,-1,2,1,0,-4,6,2,-6,4,-5,0,0,-1,1,1,1,4,-1
KR_6759036602,420,0,-52,-24,-4,-2,2,0,-5,7,2,-2,4,2,1,3,4,4,0,4,-2,2,-1,-6,-3,9,1,0,0,-1,1,0,-1,1,-1
KR_6758799731,420,-4,-41,-1,-8,-1,1,0,-2,3,1,-2,6,4,-4,5,1,1,0,1,0,-15,-5,-4,-5,9,-3,0,-1,1,-1,-1,-1,3,-1
KR_6707064050,420,-4,13,-32,-5,2,1,3,-3,9,6,-1,3,2,1,4,5,-4,5,1,0,-5,0,-2,-6,8,0,0,-1,-1,1,-1,1,5,-1
KR_6756726722,420,0,-1,-1,-7,2,1,3,1,0,1,-5,5,0,-2,3,1,-3,3,0,0,-8,-1,-1,-4,5,-1,0,-1,1,1,-1,1,6,-1
KR_6749847031,420,0,45,27,-1,-1,2,1,-2,4,2,1,1,2,1,2,3,0,2,2,0,-7,-9,0,-5,5,1,0,-1,-1,1,-1,1,6,-1
KR_6761213033,440,2,-21,7,1,-1,3,2,1,1,2,4,1,5,-3,5,2,0,1,1,0,-3,-12,-5,-2,7,3,0,0,-1,1,0,1,1,-1
KR_6719220764,420,-2,-24,33,-7,0,1,1,-6,9,3,0,4,4,-1,4,3,0,1,1,0,-10,-18,-4,-5,9,-6,0,-1,-1,1,-1,-1,1,-1
KR_6759084850,440,0,-43,-3,3,6,0,6,-1,2,1,-1,3,2,-1,2,1,0,4,4,0,0,39,1,-6,5,-3,0,0,1,0,0,-1,1,-1
KR_6741428859,420,-5,-64,3,-9,-1,2,1,1,3,4,-1,2,1,-3,3,0,-5,5,0,1,-9,18,-1,-7,8,-7,0,-1,-1,1,-1,1,2,-1
KR_6741284213,420,0,3,-8,-5,3,0,3,-2,3,1,-5,5,0,-2,3,1,1,0,1,0,-4,-2,-1,-4,5,-1,0,-1,1,-1,-1,-1,6,-1
KR_6764466618,420,3,-9,13,6,4,0,4,2,2,4,0,1,1,0,2,2,0,1,1,0,-1,6,3,-5,2,0,0,1,1,1,1,1,1,-1
KR_6737318393,420,-5,-12,1,-18,2,1,3,-5,6,1,-2,6,4,-11,13,2,-2,2,0,-3,-28,-6,2,-7,5,-5,0,-1,-1,1,-1,-1,2,-1
KR_6611122967,420,-6,-79,-1,-12,-3,4,1,-2,5,3,-2,2,0,-5,9,4,0,1,1,0,-12,15,-4,-2,6,-1,0,-2,-1,1,-1,1,1,-1
KR_6651690794,420,0,-32,-4,5,-1,2,1,0,3,3,-2,3,1,4,0,4,4,0,4,0,11,6,0,-7,7,2,0,-2,-1,1,-1,1,4,-1
KR_6749653546,420,-2,-45,13,-9,-4,6,2,1,1,2,2,2,4,-9,9,0,1,1,2,1,-10,-102,-3,-1,4,-2,0,-2,-1,1,-1,1,5,-1
KR_6758957910,420,-7,-123,-24,-9,-2,2,0,1,0,1,-5,6,1,-1,2,1,-2,2,0,0,-8,-16,-2,-1,3,0,0,-5,-1,-1,-1,-1,5,-1
KR_6749215090,420,-4,-47,-31,-9,-1,2,1,-3,5,2,1,1,2,-5,7,2,-1,1,0,0,-9,-2,-2,-3,5,-2,0,-2,-1,0,-1,-1,5,-1
KR_6643565959,420,-3,-18,-16,-10,-3,6,3,-4,5,1,-2,2,0,1,1,2,-2,2,0,1,-17,0,-4,-2,6,-2,0,-1,-1,1,1,1,4,-1
KR_6744801761,420,-2,-11,-3,-5,1,2,3,1,3,4,-6,6,0,0,4,4,-1,5,4,-1,-6,10,2,-4,2,1,0,0,1,1,-1,-1,6,-1
KR_6651806837,420,-1,-36,-24,-1,3,1,4,1,4,5,-3,6,3,-2,5,3,0,1,1,0,-8,15,-1,-8,9,3,0,-1,-1,-1,-1,1,3,-1
KR_6764553606,420,-5,-39,-43,-9,-1,3,2,-4,4,0,-1,2,1,0,1,1,-3,4,1,0,-9,-38,3,-6,3,4,0,-1,1,-1,-1,1,4,-1
KR_6690565948,420,-6,-96,-28,-14,-6,7,1,0,5,5,2,2,4,-8,11,3,-2,2,0,0,-5,3,4,-8,4,-1,0,-1,-1,1,-1,-1,6,-1
KR_6688409647,420,0,-5,8,-4,-8,9,1,1,2,3,3,1,4,-1,5,4,1,1,2,0,-1,-2,-1,-5,6,-3,0,-1,1,-1,-1,1,6,-1
KR_6745550557,420,-1,64,17,1,0,1,1,1,2,3,7,0,7,-7,9,2,0,2,2,0,1,123,2,-7,5,-3,0,-1,1,1,-1,1,1,-1
KR_6743577655,420,-3,-25,28,-10,-5,6,1,-1,3,2,-3,4,1,-1,2,1,0,0,0,0,-5,38,-4,-3,7,-14,0,1,-1,1,1,-1,5,-1
KR_6761423401,420,0,18,6,4,-8,9,1,2,2,4,2,0,2,8,1,9,0,1,1,-1,7,2,-1,-5,6,1,0,0,1,-1,-1,-1,3,-1
KR_6567234498,440,-6,-7,-22,-8,-5,7,2,-4,9,5,1,1,2,2,1,3,-2,2,0,-1,-2,24,-2,-3,5,-10,0,-1,0,-1,-1,-1,0,-1
KR_6691134261,420,-5,-86,24,-10,-4,5,1,-1,2,1,0,2,2,-4,4,0,-1,1,0,0,-12,0,-5,-6,11,-2,0,-1,-1,0,-1,1,3,-1
KR_6764948144,420,1,22,8,-2,6,0,6,-8,8,0,-6,7,1,4,1,5,2,0,2,-1,-5,3,1,-8,7,1,0,0,1,-1,0,-1,4,-1
KR_6762258715,420,-2,-25,-16,4,-4,6,2,4,0,4,2,2,4,1,2,3,1,1,2,2,17,12,-2,-6,8,-1,0,-1,1,-1,-1,1,6,-1
KR_6752378621,420,-5,-124,-24,-18,-10,13,3,-1,4,3,1,0,1,-6,7,1,-2,4,2,0,-10,-118,6,-10,4,-5,0,-4,1,1,-1,-1,3,-1
KR_6755794470,420,-1,-12,24,-2,-1,1,0,-1,4,3,1,2,3,-2,4,2,1,0,1,1,-2,0,2,-6,4,-2,0,1,-1,1,1,1,1,-1
KR_6763107358,420,1,117,-12,-1,-2,2,0,-2,2,0,0,1,1,1,1,2,2,0,2,0,1,14,-3,-2,5,2,0,1,1,-1,1,1,2,-1
KR_6703317807,420,-1,-63,-4,-8,-5,5,0,0,4,4,-2,2,0,-3,3,0,2,1,3,0,-5,1,2,-9,7,0,0,-1,-1,-1,-1,-1,5,-1
KR_6761904241,420,0,7,-2,0,4,2,6,-2,3,1,-5,6,1,3,1,4,0,0,0,-1,-3,-6,4,-7,3,7,0,1,1,1,1,-1,2,-1
KR_6758937148,420,2,1,11,4,0,0,0,-3,4,1,-2,2,0,2,1,3,7,1,8,0,6,-1,1,-5,4,-1,0,1,-1,-1,1,1,5,-1
KR_6734307169,420,-3,-36,-18,-4,-2,4,2,-1,3,2,-5,6,1,4,4,8,0,0,0,-1,-9,-11,-7,-1,8,-2,0,0,-1,-1,-1,-1,2,-1
KR_6760530475,420,2,25,36,1,5,0,5,2,2,4,-1,3,2,-3,3,0,-2,2,0,-1,-9,3,2,-6,4,-4,0,-2,1,-1,-1,-1,6,-1
KR_6740147546,420,0,17,-16,-1,1,1,2,1,1,2,-4,7,3,0,5,5,1,0,1,0,1,-4,-1,-7,8,1,0,0,-1,1,0,-1,3,-1
KR_6751895670,420,-2,-15,-33,5,-2,2,0,1,3,4,5,0,5,1,2,3,0,0,0,0,9,-3,2,-7,5,9,0,0,1,1,1,-1,3,-1
KR_6740676067,420,-2,-66,-30,-4,-3,3,0,-3,5,2,-8,9,1,6,0,6,4,0,4,-2,0,7,-2,-4,6,-1,0,-3,1,-1,-1,-1,4,-1
KR_6756723672,440,1,-58,-4,4,-2,2,0,5,1,6,-1,4,3,2,3,5,0,1,1,0,13,13,4,-10,6,-3,0,0,1,1,0,-1,6,-1
KR_6737564451,420,1,-29,-20,2,3,1,4,-4,4,0,1,3,4,0,4,4,2,0,2,1,8,68,0,-5,5,-1,0,-1,-1,-1,-1,1,3,-1
KR_6755213405,420,-1,-57,9,-1,-1,2,1,2,5,7,-1,2,1,-1,3,2,0,1,1,0,4,0,1,-4,3,-2,0,-2,1,-1,-1,-1,1,-1
KR_6695308371,420,-4,-46,-15,-11,2,3,5,-2,4,2,-6,7,1,-4,4,0,-1,1,0,0,-14,-3,2,-10,8,0,0,0,-1,1,-1,-1,6,-1
KR_6748595593,420,-4,-32,-17,-8,2,1,3,2,2,4,-8,11,3,-4,5,1,0,2,2,-1,-9,2,-2,-2,4,1,0,-2,0,1,-1,-1,0,-1
KR_6602406435,420,0,11,-3,6,0,2,2,2,5,7,0,4,4,5,1,6,-1,1,0,0,18,-1,0,-7,7,1,0,1,1,-1,-1,-1,1,-1
KR_6655664908,420,-2,-117,-12,2,1,3,4,3,1,4,4,3,7,-6,6,0,0,2,2,-1,11,-12,-2,-5,7,2,0,0,-1,1,-1,-1,1,-1
KR_6762745060,420,2,8,15,-1,-2,4,2,2,2,4,-4,6,2,5,1,6,-2,3,1,0,4,20,0,-6,6,0,0,0,-1,1,0,1,6,-1
KR_6695240428,420,-6,-74,14,-15,-3,8,5,0,1,1,-5,5,0,-5,8,3,-2,4,2,0,-14,-7,-3,-1,4,2,0,-1,-1,1,-1,-1,1,-1
KR_6746795697,420,-4,19,-28,-7,-1,2,1,-1,3,2,1,1,2,-6,7,1,0,2,2,0,-12,-9,1,-6,5,-1,0,1,-1,1,1,-1,1,-1
KR_6764974539,420,1,-64,4,1,-1,3,2,-3,4,1,-1,4,3,4,0,4,2,0,2,0,5,-328,-3,-4,7,1,0,-1,-1,-1,1,-1,1,-1
KR_6737694151,420,1,63,-9,1,2,2,4,-5,6,1,2,1,3,3,1,4,-1,3,2,0,-2,-9,-4,-5,9,0,0,1,-1,1,1,1,4,-1
KR_6725846766,420,-1,-30,2,-5,1,1,2,-1,3,2,0,0,0,-5,6,1,0,0,0,0,-5,-5,-6,-1,7,1,0,0,-1,1,0,-1,6,-1
KR_6706488380,420,-4,-16,-23,-11,0,1,1,-1,2,1,-4,5,1,-2,2,0,-4,4,0,0,-12,7,2,-6,4,-1,0,-2,-1,-1,-1,-1,5,-1
KR_6740751700,420,-2,-15,-25,2,0,0,0,3,2,5,-2,5,3,2,4,6,-1,1,0,1,9,-5,2,-7,5,4,0,-2,0,1,-1,1,0,-1
KR_6757098836,420,-1,-29,15,-6,-1,1,0,2,0,2,-2,2,0,-4,5,1,-1,3,2,0,-5,-81,1,-5,4,-8,0,0,-1,1,0,-1,4,-1
KR_6614518073,420,0,-8,-10,-5,-1,3,2,1,2,3,0,3,3,-4,6,2,-1,1,0,-1,-7,13,6,-11,5,-3,0,0,1,1,0,-1,5,-1
KR_6712367728,420,-3,10,4,-6,-2,2,0,1,0,1,-2,3,1,-1,1,0,-2,4,2,0,-9,-9,2,-7,5,-3,0,-1,-1,0,-1,-1,2,-1
KR_6765043105,420,-1,-28,-2,0,-3,3,0,-1,2,1,1,0,1,3,0,3,0,2,2,0,2,-7,-3,-5,8,7,0,-1,1,-1,-1,1,3,-1
KR_6760393973,420,3,26,0,2,-3,5,2,-2,5,3,0,2,2,3,1,4,4,0,4,0,-3,0,1,-5,4,0,0,-1,1,-1,-1,-1,4,-1
KR_6761618063,420,-2,11,-12,-6,2,1,3,-3,5,2,-5,6,1,0,3,3,0,0,0,0,-7,-34,0,-5,5,0,0,-2,1,-1,-1,-1,6,-1
KR_6616121871,420,0,8,-5,2,0,2,2,4,0,4,-2,2,0,1,1,2,-1,1,0,0,6,1,2,-5,3,-4,0,0,-1,-1,0,1,5,-1
KR_6728072677,420,-1,-3,-28,-4,-3,6,3,-2,3,1,2,1,3,1,1,2,-2,2,0,0,-8,-1,-1,-2,3,0,0,0,-1,-1,0,-1,6,-1
KR_6746712950,420,-5,-71,-5,-9,0,2,2,-5,6,1,-1,6,5,-6,9,3,3,3,6,-1,-6,31,3,-5,2,-6,0,0,-1,-1,-1,-1,1,-1
KR_6749989622,420,2,20,-15,7,3,0,3,-1,6,5,3,1,4,-1,5,4,3,0,3,0,3,-1,0,-5,5,3,0,1,1,1,1,-1,6,-1
KR_6751640766,440,0,21,-28,4,1,3,4,1,1,2,2,4,6,2,1,3,-2,2,0,1,-1,8,3,-6,3,-1,0,2,-1,0,1,1,6,-1
KR_6399493560,420,0,-59,-4,-4,-5,6,1,4,1,5,-2,3,1,-3,3,0,2,0,2,0,3,7,-2,-5,7,-1,0,-1,-1,-1,-1,-1,4,-1
KR_6749712222,420,-5,-116,19,-11,-2,2,0,4,2,6,-6,7,1,-6,6,0,-1,2,1,0,-4,-11,0,-6,6,-3,0,-1,-1,-1,-1,-1,4,-1
KR_6720461588,420,-3,-40,-8,-6,-1,2,1,-2,3,1,0,0,0,-3,5,2,0,2,2,0,-8,-8,-3,-3,6,1,0,-1,0,1,-1,-1,0,-1
KR_6730612136,440,-2,-12,-36,-1,-2,2,0,-3,3,0,2,0,2,2,2,4,0,0,0,0,-3,-20,-5,-1,6,1,0,0,-1,1,0,1,3,-1
KR_6755142200,420,0,38,-16,1,0,1,1,1,3,4,2,2,4,0,3,3,-2,3,1,0,-2,3,3,-6,3,-3,0,1,1,-1,1,-1,6,-1
KR_6745261480,420,-3,-57,-34,-4,2,0,2,-2,5,3,-3,3,0,0,1,1,-1,1,0,0,-3,8,4,-11,7,-2,0,0,-1,1,0,1,4,-1
KR_6621744855,420,-4,-57,-11,-7,-3,3,0,-4,5,1,0,1,1,-2,2,0,2,2,4,0,-11,-2,-3,-3,6,-5,0,0,-1,1,0,-1,3,-1
KR_6641198513,420,-3,-78,-13,-6,-2,3,1,-1,3,2,-2,3,1,0,2,2,-1,2,1,0,-5,20,-4,-3,7,2,0,-1,-1,-1,-1,1,2,-1
KR_6755556760,420,1,41,0,-1,-1,2,1,-2,6,4,-2,2,0,5,2,7,-1,1,0,0,-2,-13,-6,-3,9,4,0,0,0,0,0,1,0,-1
KR_6755865045,420,0,-13,-39,4,2,2,4,-3,5,2,4,3,7,4,0,4,-3,6,3,-1,4,10,5,-7,2,1,0,-1,1,-1,-1,-1,1,-1
KR_6762961695,420,-1,-15,-51,0,-2,3,1,-1,3,2,0,2,2,4,3,7,-1,2,1,0,5,-2,-1,-4,5,0,0,0,-1,-1,-1,1,5,-1
KR_6670030947,420,-1,-23,-32,-4,1,0,1,-1,2,1,-1,1,0,-2,2,0,-1,1,0,0,-2,2,4,-8,4,-5,0,0,-1,1,1,-1,4,-1
KR_6761910487,420,2,-30,19,0,-1,2,1,-6,8,2,3,0,3,3,1,4,1,0,1,-1,2,8,-1,-4,5,-5,0,0,1,-1,0,-1,2,-1
KR_6756855211,420,-5,-55,-40,-11,-2,3,1,-4,6,2,-3,5,2,-3,3,0,1,0,1,0,-15,-28,-2,-2,4,-1,0,0,0,0,0,1,0,-1
KR_6755326007,420,0,-6,-2,-4,-1,4,3,1,1,2,1,0,1,-8,11,3,3,1,4,0,-4,18,-2,-2,4,-2,0,-1,-1,1,-1,-1,6,-1
KR_6761128755,440,0,-65,-21,0,4,1,5,6,0,6,-6,7,1,-3,3,0,-1,2,1,0,4,-9,6,-9,3,-4,0,-2,0,-1,-1,-1,0,-1
KR_6758848664,420,2,13,0,4,1,2,3,2,1,3,1,1,2,1,3,4,-1,1,0,-1,-4,244,1,-7,6,5,0,-1,1,-1,-1,-1,2,-1
KR_6736841548,420,-2,-26,4,-5,-1,1,0,0,1,1,-2,3,1,-2,3,1,0,1,1,0,-9,-18,-1,-5,6,0,0,0,-1,1,1,1,4,-1
KR_6760490624,420,0,-24,0,-3,-1,1,0,1,0,1,-5,5,0,1,7,8,1,0,1,0,-2,-4,0,-3,3,1,0,0,-1,1,1,1,3,-1
KR_6720423183,420,3,33,-1,-2,0,0,0,0,3,3,-3,3,0,0,3,3,1,0,1,0,2,-6,-2,-6,8,5,0,2,-1,1,1,1,5,-1
KR_6722168043,420,0,-21,8,0,0,0,0,5,1,6,-3,4,1,-2,4,2,0,2,2,0,-6,28,-5,-3,8,-1,0,0,-1,1,0,1,1,-1
KR_6719188722,420,1,-14,-8,-1,1,1,2,0,2,2,0,1,1,0,3,3,-2,4,2,0,-2,-25,2,-8,6,3,0,0,-1,1,0,-1,5,-1
KR_6690812881,420,0,-7,4,2,1,0,1,1,4,5,3,0,3,0,5,5,-3,3,0,1,5,29,2,-9,7,-5,0,1,-1,1,1,1,4,-1
KR_6662188279,440,2,-81,0,7,8,1,9,1,4,5,3,0,3,-6,9,3,1,3,4,1,19,-2,-7,-2,9,2,0,-1,-1,1,1,1,5,-1
KR_6749289614,420,-1,-51,-5,-7,0,2,2,1,3,4,0,2,2,-8,9,1,0,1,1,0,-1,-121,-6,-2,8,-5,0,0,-1,1,-1,-1,6,-1
KR_6733551791,420,-4,-53,-34,-5,-3,5,2,1,0,1,0,2,2,-4,8,4,1,0,1,-1,-3,3,-3,-5,8,-2,0,-1,-1,-1,-1,-1,2,-1
KR_6726460649,420,1,-23,4,7,3,1,4,4,4,8,-2,5,3,2,2,4,0,0,0,0,22,-5,2,-6,4,0,0,1,1,1,1,1,2,-1
KR_6760404768,420,0,10,-36,1,0,3,3,0,3,3,2,1,3,-2,7,5,1,1,2,0,5,-5,-3,-2,5,5,0,0,-1,-1,-1,-1,6,-1
KR_6762754025,420,1,78,-9,-2,0,1,1,1,1,2,-5,9,4,1,1,2,1,1,2,0,5,6,-4,-5,9,1,0,-1,1,-1,-1,-1,5,-1
KR_6762399701,420,1,40,-12,4,-2,2,0,3,2,5,4,3,7,-2,3,1,1,2,3,0,-3,8,2,-5,3,2,0,1,-1,1,1,-1,4,-1
KR_6761802715,420,-2,-115,6,-4,-4,5,1,1,0,1,2,1,3,-3,3,0,0,0,0,0,-1,-3,1,-6,5,-2,0,-1,-1,-1,-1,-1,6,-1
KR_6762099295,420,-4,11,-3,-9,-2,3,1,0,4,4,-2,3,1,-3,4,1,-2,2,0,0,-12,-38,-1,-4,5,-1,0,0,-1,1,0,1,4,-1
KR_6710373540,420,-3,-140,-3,-12,-4,7,3,2,1,3,-3,6,3,-6,9,3,-1,2,1,0,-8,-28,-6,-5,11,-1,0,-2,-1,-1,-1,-1,3,-1
KR_6679013226,420,2,-60,11,3,0,0,0,-1,2,1,0,1,1,2,1,3,2,0,2,0,3,14,2,-8,6,-5,0,0,1,-1,0,1,2,-1
KR_6691993343,420,0,-8,-20,5,1,0,1,-5,7,2,2,1,3,6,1,7,1,3,4,0,9,-36,2,-5,3,-4,0,1,1,-1,1,-1,6,-1
KR_6690566819,420,0,20,-7,-2,0,0,0,-7,8,1,5,0,5,0,0,0,0,1,1,0,0,-1,1,-5,4,1,0,0,1,-1,0,1,3,-1
KR_6762052201,420,-6,-68,-6,-11,-3,4,1,-3,3,0,-3,6,3,0,2,2,-2,4,2,0,-7,-12,-1,-5,6,0,0,-4,0,-1,-1,1,0,-1
KR_6764592901,420,0,-65,-12,6,1,2,3,1,3,4,6,1,7,-3,4,1,1,2,3,2,3,-10,-3,-4,7,-2,0,0,-1,1,-1,1,2,-1
KR_6690610175,420,-1,61,-28,-6,3,1,4,-2,2,0,-1,2,1,-5,5,0,-1,2,1,0,-11,-6,-5,-1,6,-3,0,3,-1,-1,1,-1,3,-1
KR_6744699774,420,-2,-8,-3,-7,-1,2,1,-5,5,0,-2,5,3,1,3,4,0,1,1,1,-15,-31,-1,-3,4,-3,0,-2,-1,1,-1,-1,2,-1
KR_6746047164,420,-2,-57,29,-2,-4,4,0,3,1,4,-2,2,0,0,3,3,1,1,2,0,1,-3,-1,-5,6,4,0,0,1,-1,0,-1,2,-1
KR_6763719350,420,-12,-106,-98,-23,0,2,2,-5,6,1,1,2,3,-13,15,2,-6,6,0,-1,-16,1,-1,-2,3,-2,0,-2,-1,-1,-1,-1,5,-1
KR_6762997591,420,3,5,16,2,-2,2,0,2,1,3,0,0,0,1,1,2,1,1,2,0,3,-27,1,-4,3,4,0,0,-1,1,0,1,3,-1
KR_6756394646,420,-2,-82,-24,-6,1,0,1,5,0,5,-13,14,1,2,4,6,-1,1,0,0,2,-2,-1,-3,4,-3,0,-2,-1,-1,-1,-1,1,-1
KR_6755540532,440,1,12,-4,4,1,2,3,1,1,2,-1,3,2,2,1,3,1,1,2,0,3,-3,-1,-4,5,-3,0,0,-1,1,-1,1,4,-1
KR_6717969896,420,-2,-15,3,-1,-3,5,2,1,1,2,-2,3,1,1,3,4,2,0,2,0,7,2,1,-3,2,1,0,-2,-1,-1,-1,1,5,-1
KR_6762674370,420,-2,-34,49,-10,-1,2,1,-2,4,2,-4,4,0,-2,5,3,-1,1,0,0,-9,-8,4,-6,2,-4,0,-2,-1,-1,-1,-1,3,-1
KR_6737211572,440,-2,-40,-8,-5,1,0,1,-1,4,3,-2,6,4,0,4,4,-3,4,1,0,-10,-5,1,-3,2,0,0,0,1,1,1,-1,3,-1
KR_6728689382,440,-5,-85,-12,-9,-1,3,2,-5,7,2,-5,9,4,3,1,4,-1,5,4,1,-4,49,-3,-4,7,-2,0,-2,0,-1,-1,-1,0,-1
KR_6737284493,420,0,34,-50,-6,3,1,4,-2,5,3,6,0,6,-13,14,1,0,3,3,-2,-13,-20,-4,-4,8,0,0,1,-1,1,-1,-1,6,-1
KR_6696921390,420,-3,-114,-21,-2,1,0,1,-4,6,2,0,4,4,-1,4,3,2,0,2,-1,-10,3,-3,-2,5,-2,0,-1,1,-1,-1,-1,5,-1
KR_6697408783,420,-2,-57,-20,-6,1,1,2,-3,5,2,-2,4,2,0,1,1,-2,3,1,1,-9,-2,-3,-4,7,2,0,0,-1,1,0,1,4,-1
KR_6740404064,420,2,42,-26,7,2,0,2,3,3,6,-1,2,1,4,1,5,-1,1,0,0,12,-24,2,-8,6,2,0,0,-1,-1,0,-1,6,-1
KR_6719965524,420,-1,4,16,-5,-2,2,0,0,2,2,0,3,3,-3,3,0,0,0,0,0,-2,-115,0,-6,6,-2,0,-1,1,0,-1,-1,3,-1
KR_6665448118,420,-2,-47,0,4,-1,1,0,0,2,2,2,3,5,2,1,3,1,1,2,0,12,-4,-1,-6,7,1,0,-3,1,-1,-1,-1,6,-1
KR_6642196921,420,-2,-5,-12,-8,1,1,2,0,3,3,-1,2,1,-3,4,1,-5,5,0,0,-9,-22,-1,-5,6,-1,0,-1,-1,-1,-1,-1,6,-1
KR_6752316301,420,-3,8,-36,-1,-1,3,2,-3,6,3,4,0,4,1,3,4,-2,3,1,0,1,7,4,-7,3,0,0,0,0,1,0,-1,0,-1
KR_6759272686,420,-3,-63,6,-9,-5,5,0,-2,5,3,0,4,4,-1,1,0,-1,2,1,-1,-7,2,0,-5,5,-1,0,-1,-1,1,-1,-1,5,-1
KR_6735089998,420,0,-18,-35,-3,0,0,0,-3,4,1,1,1,2,-1,3,2,0,0,0,-1,0,-6,1,-5,4,-8,0,-1,-1,-1,-1,-1,2,-1
KR_6736376291,420,-11,-113,-122,-6,-3,4,1,-4,4,0,3,0,3,-2,2,0,0,0,0,0,-6,-36,-1,-4,5,-4,0,-2,-1,-1,-1,1,3,-1
KR_6754031820,420,-3,-37,-13,-11,-3,3,0,0,3,3,-1,2,1,-3,4,1,-4,4,0,0,-8,-270,-1,-6,7,4,0,-1,1,0,-1,-1,3,-1
KR_6649609524,420,1,2,8,4,0,0,0,-3,7,4,2,2,4,8,3,11,-3,3,0,0,3,176,-1,-5,6,7,0,0,1,-1,1,1,3,-1
KR_6573884713,420,-1,-56,-32,-7,-1,2,1,1,2,3,0,3,3,-8,10,2,1,0,1,0,-12,-5,-5,-2,7,2,0,-1,0,-1,-1,1,0,-1
KR_6742556145,420,-3,-68,0,-11,-1,1,0,-10,13,3,2,1,3,1,2,3,-3,3,0,0,-18,-26,-2,-4,6,-2,0,0,-1,1,0,-1,1,-1
KR_6764082822,420,-6,-96,-13,-12,-1,2,1,-2,2,0,-7,9,2,-2,2,0,0,2,2,0,-8,-9,-1,-3,4,-2,0,-2,-1,-1,-1,-1,3,-1
KR_6736620786,420,0,-34,4,-2,-1,2,1,1,1,2,-1,2,1,1,2,3,-2,3,1,0,-2,182,3,-9,6,-3,0,-1,-1,-1,-1,1,3,-1
KR_6645325520,420,-5,-45,-8,-8,-4,5,1,-2,6,4,-1,2,1,0,1,1,-1,1,0,0,-6,0,-1,-3,4,-1,0,-1,1,-1,-1,1,2,-1
KR_6727611153,420,0,0,-2,4,1,0,1,4,0,4,1,3,4,0,3,3,-2,4,2,0,5,-4,-2,-6,8,3,0,-1,-1,-1,-1,1,1,-1
KR_6742699498,420,-3,-67,7,3,-1,1,0,4,1,5,-2,2,0,1,2,3,1,0,1,1,9,-10,1,-6,5,5,0,0,-1,1,0,1,1,-1
KR_6743903608,420,-2,8,1,-7,0,1,1,-1,1,0,-4,5,1,0,2,2,-2,2,0,0,-15,6,-2,-5,7,-6,0,1,1,1,1,-1,1,-1
KR_6744044373,420,-3,-44,2,-15,-3,4,1,-2,2,0,-1,2,1,-3,3,0,-6,6,0,-1,-15,16,-6,-2,8,0,0,0,-1,1,0,-1,3,-1
KR_6678696069,440,5,-16,39,7,0,0,0,1,3,4,2,0,2,2,5,7,2,0,2,0,1,-4,-3,-4,7,-1,0,-1,-1,-1,1,-1,5,-1
KR_6712257310,420,-3,26,-9,-4,2,0,2,-4,7,3,-2,2,0,1,4,5,-1,2,1,0,-5,-3,-3,-5,8,2,0,0,-1,-1,-1,-1,4,-1
KR_6745175729,420,-1,-35,5,-4,-1,1,0,2,0,2,2,2,4,-4,7,3,-3,3,0,0,-2,-25,1,-7,6,0,0,0,1,-1,0,-1,4,-1
KR_6760989657,420,3,-6,21,2,-2,4,2,-1,2,1,-3,4,1,3,3,6,5,0,5,0,-3,1,1,-7,6,1,0,0,1,1,-1,1,5,-1
KR_6710122245,420,0,-52,-7,9,2,1,3,7,4,11,-1,4,3,0,4,4,1,0,1,2,20,0,1,-4,3,-2,0,1,-1,1,1,1,3,-1
KR_6764090976,420,3,-21,39,-2,-4,5,1,0,3,3,2,1,3,-1,2,1,1,3,4,0,-7,-5,-7,-2,9,1,0,-1,-1,-1,-1,-1,2,-1
KR_6648812650,420,2,25,-23,0,1,0,1,-3,6,3,1,1,2,0,1,1,1,0,1,0,-4,-18,-3,-3,6,0,0,0,1,-1,1,1,4,-1
KR_6740549056,420,-4,-77,-6,-5,-3,4,1,8,0,8,-4,5,1,-4,4,0,-2,2,0,0,-5,-8,4,-7,3,23,0,-1,-1,-1,-1,1,6,-1
KR_6752341902,440,-2,30,3,-14,-5,7,2,-5,5,0,-2,3,1,-5,7,2,3,3,6,0,-13,35,2,-5,3,-10,0,0,1,-1,-1,-1,3,-1
KR_6764037483,420,-2,66,-20,-3,-2,3,1,-2,2,0,-2,2,0,3,2,5,0,0,0,0,-6,-29,-2,-5,7,3,0,0,1,-1,0,1,1,-1
KR_6744411201,420,1,-11,1,-5,-1,1,0,-1,3,2,-7,7,0,4,1,5,0,0,0,0,-10,2,1,-6,5,-3,0,1,1,-1,1,-1,4,-1
KR_6663655686,420,-1,-64,4,5,-1,2,1,4,2,6,2,1,3,0,1,1,0,2,2,0,8,6,-6,-4,10,-3,0,0,0,1,0,-1,0,-1
KR_6609036017,420,0,-17,-3,-4,3,0,3,3,0,3,0,2,2,-9,9,0,-1,1,0,0,-9,-15,-6,-6,12,0,0,-1,-1,-1,-1,1,1,-1
KR_6682878408,420,0,-34,-22,-3,2,0,2,0,2,2,-1,4,3,-5,7,2,1,2,3,0,-13,4,2,-9,7,-4,0,0,-1,-1,-1,-1,3,-1
KR_6707755155,420,1,8,-29,6,1,0,1,1,4,5,1,0,1,4,3,7,-1,1,0,0,6,-2,-2,-3,5,3,0,0,1,-1,-1,-1,5,-1
KR_6509523290,420,0,-1,9,-9,-1,2,1,-3,4,1,1,1,2,-4,9,5,-2,3,1,1,-19,0,-1,-10,11,0,0,-1,-1,-1,-1,1,1,-1
KR_6764816754,420,3,12,-13,6,1,1,2,1,2,3,4,2,6,1,1,2,-1,1,0,0,5,-140,0,-6,6,0,0,-1,-1,-1,1,1,5,-1
KR_6736640583,420,-6,-122,-1,-11,-1,4,3,1,1,2,1,1,2,-3,6,3,-9,12,3,2,-6,6,-2,-3,5,2,0,-2,-1,1,-1,-1,2,-1
KR_6642069299,420,-1,-63,-27,0,1,0,1,5,3,8,2,3,5,-8,10,2,0,1,1,0,-5,1,2,-7,5,-2,0,-1,-1,1,-1,-1,4,-1
KR_6717913322,420,-2,-49,-14,-5,3,0,3,-4,5,1,-2,5,3,0,0,0,-2,2,0,0,-3,-13,2,-8,6,-9,0,-1,-1,-1,-1,1,1,-1
KR_6755781794,420,-2,-58,-16,2,2,2,4,-3,5,2,5,0,5,-3,4,1,1,0,1,1,4,-6,-4,-5,9,6,0,0,-1,-1,0,1,4,-1
KR_6678988721,420,0,11,17,-4,-4,6,2,2,1,3,-5,5,0,3,1,4,0,0,0,0,0,4,-4,-2,6,0,0,-1,-1,1,-1,-1,6,-1
KR_6748029204,420,-1,-31,0,0,4,1,5,-4,7,3,0,2,2,-2,5,3,2,0,2,0,-5,-38,4,-8,4,14,0,1,-1,1,1,-1,5,-1
KR_6758169624,420,1,67,-21,4,0,2,2,-3,8,5,3,0,3,6,2,8,-2,2,0,-1,4,17,-1,-4,5,1,0,0,1,-1,-1,-1,2,-1
KR_6752836432,420,0,-17,4,0,3,0,3,-5,5,0,-1,2,1,3,3,6,0,1,1,0,-6,-2,-1,-5,6,-2,0,0,-1,1,0,-1,5,-1
KR_6712440750,420,0,90,-24,-7,1,0,1,0,2,2,-4,5,1,-4,5,1,0,0,0,-1,-15,-285,0,-6,6,-1,0,0,-1,-1,0,-1,4,-1
KR_6744887143,420,0,-18,4,-1,-1,1,0,-1,3,2,-4,4,0,2,3,5,3,1,4,0,0,-51,-4,-2,6,18,0,-1,0,-1,-1,-1,0,-1
KR_6719052581,440,-6,-67,-20,-17,-6,6,0,3,3,6,-4,6,2,-6,6,0,-4,6,2,0,-17,-5,0,-4,4,1,0,-1,1,-1,-1,-1,5,-1
KR_6713211537,420,-4,-31,6,-11,-3,4,1,-2,6,4,0,5,5,2,4,6,-8,8,0,0,-10,-7,1,-7,6,-2,0,-4,1,-1,-1,1,6,-1
KR_6736605841,420,-2,-46,-33,3,-2,3,1,6,0,6,-1,2,1,0,1,1,0,0,0,0,10,3,1,-6,5,-5,0,-1,-1,-1,-1,-1,1,-1
KR_6762535343,440,-4,-57,-21,-19,-2,3,1,-8,9,1,-5,6,1,-1,4,3,-3,3,0,0,-20,4,-4,-1,5,-6,0,-1,-1,-1,-1,-1,2,-1
KR_6748015097,420,0,-25,29,1,1,0,1,3,1,4,0,3,3,-4,5,1,1,0,1,0,-1,-4,-3,-3,6,3,0,0,1,1,-1,-1,4,-1
KR_6660590786,420,0,11,23,-2,1,0,1,-3,3,0,1,1,2,1,2,3,-2,2,0,0,-3,18,0,-4,4,-4,0,-1,-1,1,1,1,5,-1
KR_6763676069,420,0,-22,15,0,1,1,2,0,3,3,-1,6,5,0,1,1,0,0,0,0,-12,-4,0,-7,7,2,0,0,-1,1,0,1,6,-1
KR_6678879657,420,-6,-16,-9,-14,-6,6,0,0,3,3,-1,3,2,-9,11,2,2,1,3,0,-18,2,2,-5,3,-3,0,-1,-1,1,-1,1,2,-1
KR_6692280390,440,-2,-62,-2,-4,1,1,2,2,3,5,-4,5,1,1,0,1,-4,5,1,0,-3,5,0,-6,6,-3,0,-1,-1,-1,-1,-1,2,-1
KR_6758918913,420,0,-42,17,-3,-3,5,2,-1,5,4,2,2,4,-1,3,2,0,0,0,0,0,13,2,-5,3,-5,0,-1,-1,1,-1,-1,4,-1
KR_6608498904,420,-3,-18,4,-8,-1,2,1,3,1,4,-7,8,1,-2,5,3,-1,2,1,0,-3,-10,-4,-2,6,1,0,-2,-1,0,-1,-1,1,-1
KR_6752983971,420,0,-24,-5,1,1,0,1,1,1,2,1,1,2,-1,2,1,-1,1,0,0,0,-4,-1,-3,4,0,0,-1,1,-1,-1,-1,6,-1
KR_6732464618,420,0,-13,-12,0,-2,2,0,-1,3,2,1,1,2,2,2,4,0,0,0,0,0,-35,-3,-5,8,4,0,0,1,-1,1,1,1,-1
KR_6758685709,440,-1,-46,-26,-3,-4,7,3,3,2,5,-1,4,3,1,2,3,-2,3,1,-1,-4,3,3,-9,6,-5,0,-2,1,1,-1,-1,1,-1
KR_6757696362,420,-4,29,20,-10,-1,2,1,-3,4,1,-1,8,7,-4,4,0,-1,2,1,0,-13,89,-4,-2,6,4,0,-2,0,-1,-1,-1,0,-1
KR_6737175526,420,-2,-10,-29,-5,5,1,6,-4,6,2,-2,2,0,-5,5,0,1,0,1,0,-9,333,-1,-5,6,-1,0,-1,-1,1,-1,-1,1,-1
KR_6751439503,420,-1,-1,-4,-3,2,1,3,0,4,4,-1,2,1,-5,7,2,1,0,1,0,-9,-25,1,-4,3,5,0,-2,-1,-1,-1,-1,6,-1
KR_6763538106,420,-2,-5,-12,-9,1,1,2,-3,5,2,-4,4,0,-3,3,0,0,1,1,0,-11,-19,-1,-6,7,3,0,0,-1,-1,0,-1,6,-1
KR_6752308410,420,4,38,9,1,1,1,2,1,3,4,5,2,7,-4,7,3,-2,2,0,-1,-10,-189,3,-6,3,-2,0,1,-1,1,1,-1,2,-1
KR_6752042669,420,-1,-30,3,-7,0,2,2,-1,3,2,0,0,0,-5,6,1,-1,1,0,-1,-6,0,-1,-6,7,-2,0,-3,1,-1,-1,-1,4,-1
KR_6746686917,420,-4,-18,-14,-12,4,1,5,-2,3,1,-5,5,0,-6,6,0,-3,3,0,-1,-8,2,1,-3,2,-8,0,-1,-1,0,1,-1,2,-1
KR_6724431530,420,-1,-47,-9,-3,1,2,3,-2,6,4,2,1,3,-3,4,1,-1,4,3,0,-6,103,1,-6,5,-5,0,1,1,1,1,-1,6,-1
KR_6713387101,420,-4,-104,-43,-6,-2,3,1,1,1,2,-1,3,2,-4,7,3,0,1,1,0,0,-6,2,-6,4,0,0,-1,1,0,-1,1,6,-1
KR_6764878950,420,4,18,0,11,1,1,2,5,4,9,1,4,5,1,2,3,3,0,3,-2,6,39,0,-5,5,1,0,1,1,-1,1,-1,4,-1
KR_6700820102,420,2,47,39,-2,4,1,5,-2,2,0,1,2,3,-3,3,0,-2,3,1,1,-6,-17,-7,-2,9,1,0,0,-1,1,1,1,3,-1
KR_6760162264,420,0,-34,37,5,-3,3,0,4,0,4,3,1,4,2,1,3,-1,1,0,0,10,5,0,-6,6,-2,0,-1,1,-1,-1,1,1,-1
KR_6752840447,420,0,-6,-18,1,3,1,4,-3,4,1,2,1,3,-3,3,0,2,0,2,0,4,26,9,-11,2,-5,0,-1,-1,-1,-1,-1,3,-1
KR_6737545544,440,-1,-62,-3,-6,-1,3,2,0,3,3,1,1,2,-8,9,1,2,1,3,-1,-8,-4,3,-9,6,0,0,0,-1,1,-1,-1,3,-1
KR_6669168518,420,-4,-22,-5,-4,-1,2,1,-1,3,2,0,3,3,-4,5,1,2,1,3,0,-6,-269,-1,-5,6,-1,0,-1,-1,1,-1,1,5,-1
KR_6733618419,420,-2,37,4,-5,1,2,3,0,3,3,-1,4,3,-4,5,1,-1,2,1,0,-12,-9,-1,-4,5,1,0,-1,-1,-1,-1,1,2,-1
KR_6675384081,420,-2,-19,-24,-1,0,1,1,1,4,5,3,1,4,-4,5,1,-1,1,0,0,0,-2,1,-7,6,-2,0,0,0,1,0,1,0,-1
KR_6636176446,420,-4,-57,20,-8,-3,3,0,2,3,5,-4,6,2,-3,7,4,0,3,3,-1,-4,12,0,-4,4,-4,0,0,-1,1,0,-1,1,-1
KR_6760492841,420,-1,5,8,-7,-2,3,1,-2,6,4,0,2,2,-2,3,1,-1,3,2,0,-10,-45,-2,-3,5,30,0,-2,-1,-1,-1,-1,6,-1
KR_6736217809,420,-1,-14,8,-7,1,0,1,0,5,5,-4,4,0,-3,5,2,-1,1,0,0,-10,-1,0,-6,6,-3,0,-1,1,-1,-1,-1,6,-1
KR_6739881778,440,-3,-96,-20,-2,-3,7,4,0,3,3,-1,1,0,4,1,5,-2,2,0,0,11,47,2,-4,2,-3,0,-4,1,-1,-1,1,1,-1
KR_6755996505,420,-3,-46,-5,-11,-9,10,1,2,3,5,-1,1,0,-3,3,0,0,1,1,0,-8,-6,-2,-5,7,-3,0,0,-1,1,-1,1,3,-1
KR_6746466829,420,-4,-102,9,-13,-9,9,0,-1,2,1,-1,3,2,1,1,2,-3,3,0,0,-10,-250,0,-4,4,-1,0,-2,-1,-1,-1,-1,4,-1
KR_6736253368,420,-2,-43,25,-11,0,3,3,-2,4,2,-3,5,2,-6,6,0,0,1,1,0,-17,2,-4,-2,6,-8,0,-1,-1,1,-1,-1,4,-1
KR_6757522032,420,-1,66,-24,-9,1,1,2,-4,5,1,3,1,4,-4,4,0,-5,5,0,0,-14,2,0,-5,5,-2,0,-1,-1,-1,-1,1,2,-1
KR_6555994786,420,0,7,12,-1,-2,2,0,0,4,4,3,0,3,-2,2,0,0,1,1,0,-7,-12,0,-4,4,-2,0,-1,0,1,-1,1,0,-1
KR_6764808266,420,-4,1,-4,-10,0,5,5,-5,7,2,0,1,1,-5,5,0,0,1,1,0,-15,-40,-4,-4,8,4,0,-1,-1,-1,-1,-1,1,-1
KR_6759492355,420,-1,-28,-11,-4,0,0,0,-1,3,2,-5,5,0,-1,4,3,3,1,4,-4,-8,-3,-2,-4,6,-2,0,-1,-1,-1,-1,-1,6,-1
KR_6740299061,420,0,25,-13,2,1,2,3,-2,5,3,2,1,3,-3,4,1,4,0,4,0,-5,9,4,-6,2,-2,0,0,1,1,1,-1,3,-1
KR_6763415687,420,-4,-37,-4,-11,-3,4,1,-1,2,1,-1,3,2,-7,7,0,1,0,1,0,-22,40,-7,-4,11,-23,0,-1,-1,-1,-1,-1,3,-1
KR_6697484884,420,-1,12,-9,-9,-1,2,1,-3,6,3,-2,4,2,-2,3,1,-1,2,1,0,-14,2,-1,-6,7,1,0,1,1,1,1,1,5,-1
KR_6609019219,420,2,-10,8,1,1,0,1,-3,3,0,2,4,6,0,3,3,1,0,1,-1,2,-3,2,-4,2,-1,0,0,-1,1,0,-1,5,-1
KR_6716153731,420,-6,-74,-9,-11,-2,2,0,-3,4,1,-1,2,1,-4,5,1,-1,1,0,0,-9,6,-1,-3,4,-2,0,0,-1,1,1,1,6,-1
KR_6742523099,420,-6,-11,-4,-7,-3,4,1,-2,2,0,0,3,3,0,2,2,-2,2,0,0,-8,7,-1,-7,8,-3,0,-3,1,-1,-1,-1,6,-1
KR_6702978187,420,-2,-6,7,0,0,2,2,1,5,6,-3,4,1,2,1,3,0,0,0,0,-5,8,8,-11,3,-2,0,0,1,-1,-1,-1,1,-1
KR_6714668974,420,2,42,6,5,1,1,2,4,3,7,-2,3,1,1,2,3,1,0,1,-1,7,2,-4,-2,6,-2,0,2,1,1,1,-1,4,-1
KR_6745878533,420,-1,-4,-8,-1,3,0,3,2,0,2,0,2,2,-4,6,2,-2,4,2,0,-9,20,-1,-3,4,-5,0,-1,1,1,-1,-1,1,-1
KR_6746564953,420,-1,-15,-2,1,3,2,5,-1,1,0,-2,3,1,0,3,3,1,1,2,-1,4,19,-2,-4,6,2,0,0,-1,-1,-1,-1,6,-1
KR_6755089803,420,2,83,1,5,1,3,4,2,3,5,-2,4,2,6,2,8,-2,3,1,1,10,-2,-2,-4,6,0,0,2,-1,-1,1,1,4,-1
KR_6748460186,420,-3,-78,19,-13,-3,4,1,-4,5,1,-1,2,1,-6,8,2,1,0,1,0,-16,16,1,-4,3,-2,0,0,1,-1,1,-1,4,-1
KR_6694594638,420,0,-36,19,6,2,1,3,1,2,3,1,3,4,-1,3,2,3,0,3,0,1,16,1,-8,7,-5,0,1,1,1,1,-1,6,-1
KR_6717987167,420,0,-46,-8,-3,1,1,2,1,2,3,2,2,4,-6,6,0,-1,1,0,0,-1,-48,1,-4,3,22,0,-1,-1,1,-1,-1,1,-1
KR_6763907831,420,-1,-4,23,-2,-1,1,0,-1,4,3,-4,4,0,6,4,10,-2,2,0,0,-1,24,0,-4,4,1,0,0,1,-1,0,1,4,-1
KR_6742954341,420,0,12,-12,3,0,3,3,-3,3,0,2,0,2,4,2,6,0,1,1,0,2,-6,1,-5,4,2,0,1,1,0,1,1,1,-1
KR_6757791025,420,-5,-27,0,-10,-4,4,0,-4,6,2,-3,5,2,2,3,5,-1,1,0,0,-10,-34,-1,-2,3,0,0,0,1,1,0,-1,6,-1
KR_6635534398,420,-2,-41,-27,-5,0,4,4,0,1,1,2,2,4,-4,4,0,-3,3,0,0,-12,-7,2,-5,3,-4,0,0,-1,1,0,-1,1,-1
KR_6759781240,420,-3,-30,0,-9,-2,2,0,-3,4,1,-1,2,1,-4,7,3,1,2,3,0,-10,4,-1,-5,6,-2,0,0,-1,-1,-1,1,2,-1
KR_6734583154,420,-5,-89,-25,-9,-2,5,3,0,3,3,-3,6,3,-2,3,1,-2,2,0,-1,-7,-23,-8,-1,9,-2,0,-1,-1,-1,-1,-1,4,-1
KR_6740020382,420,-2,-9,-9,-6,-2,2,0,-2,4,2,-2,3,1,-7,7,0,7,0,7,0,-5,-3,-1,-4,5,-1,0,0,0,-1,0,-1,0,-1
KR_6755400398,440,1,-116,4,5,3,3,6,2,2,4,-1,1,0,2,1,3,-1,2,1,0,4,14,-3,-3,6,-6,0,-1,-1,-1,-1,-1,6,-1
KR_6720730840,440,-2,-16,-16,-4,-3,5,2,-1,3,2,-1,2,1,-1,4,3,2,0,2,0,-1,-1,4,-7,3,0,0,0,-1,-1,-1,1,3,-1
KR_6676474476,440,-5,-139,-39,-7,-3,3,0,2,1,3,-3,6,3,-3,3,0,0,2,2,1,-3,-5,2,-8,6,3,0,-4,1,1,-1,1,2,-1
KR_6753920530,420,-1,-26,7,-6,-2,3,1,-3,5,2,-1,5,4,3,5,8,-3,3,0,0,-8,-1,-4,-8,12,-4,0,-2,0,-1,-1,-1,0,-1
KR_6761896284,420,-4,-41,11,-10,-3,3,0,-2,3,1,-3,6,3,-1,1,0,-1,2,1,0,-4,-137,1,-4,3,-5,0,0,1,-1,-1,-1,1,-1
KR_6722029840,420,0,-106,-12,2,1,1,2,5,2,7,-3,3,0,-1,2,1,0,1,1,0,1,7,0,-7,7,-6,0,2,-1,1,1,-1,5,-1
KR_6752278097,420,2,66,2,-2,2,1,3,-2,5,3,0,0,0,-2,4,2,0,0,0,-1,-5,-2,-3,-3,6,2,0,2,0,-1,1,-1,0,-1
KR_6688276350,420,0,30,24,-3,2,1,3,-3,4,1,-4,5,1,2,1,3,0,2,2,0,-5,14,2,-8,6,-9,0,1,1,-1,1,-1,2,-1
KR_6756858500,420,-5,-32,-22,-7,1,0,1,-4,4,0,-6,7,1,2,1,3,0,0,0,0,0,16,5,-8,3,-1,0,-3,-1,-1,-1,-1,2,-1
KR_6741889451,420,1,-25,-5,2,3,1,4,0,3,3,-1,7,6,1,2,3,-1,2,1,-3,5,-25,3,-8,5,-3,0,0,1,-1,0,-1,4,-1
KR_6752522000,440,-3,13,-14,-9,-2,4,2,-3,5,2,5,1,6,-6,10,4,-3,4,1,0,-8,4,-1,-1,2,2,0,0,0,1,-1,1,0,-1
KR_6757021683,420,0,-12,-13,3,0,0,0,1,3,4,1,2,3,0,6,6,1,1,2,0,3,-3,0,-5,5,2,0,0,-1,-1,0,1,1,-1
KR_6706831537,420,-2,33,-24,-7,-2,2,0,-4,8,4,-1,2,1,1,2,3,-1,1,0,0,-1,-21,-5,-2,7,0,0,0,1,-1,0,-1,3,-1
KR_6724819728,420,-4,-78,4,-4,0,3,3,1,0,1,-5,5,0,-3,8,5,3,0,3,2,4,-21,0,-4,4,1,0,0,1,1,-1,1,1,-1
KR_6747790228,420,-1,-31,1,-4,1,1,2,0,2,2,0,4,4,-5,6,1,0,0,0,0,-8,116,1,-5,4,0,0,-1,-1,1,-1,-1,5,-1
KR_6759675503,420,0,-45,16,3,-3,3,0,2,0,2,4,0,4,1,1,2,-1,1,0,0,11,-1,6,-7,1,-6,0,-1,1,1,-1,-1,3,-1
KR_6763480493,420,3,22,29,0,0,2,2,1,2,3,0,4,4,0,2,2,-1,1,0,0,-3,-42,2,-5,3,7,0,-1,1,-1,-1,-1,3,-1
KR_6695393604,420,2,44,8,2,1,1,2,0,3,3,1,1,2,0,1,1,0,0,0,0,7,7,4,-8,4,-6,0,2,-1,1,1,-1,6,-1
KR_6748213063,420,2,-4,4,-4,0,2,2,-2,2,0,-1,9,8,-2,2,0,1,0,1,0,-5,-1,-2,-1,3,1,0,0,-1,1,0,-1,6,-1
KR_6762857136,420,0,33,28,-3,2,2,4,-2,3,1,0,1,1,-4,4,0,1,0,1,0,-5,-5,5,-5,0,-7,0,-1,-1,-1,-1,1,5,-1
KR_6699833305,420,-4,-84,-4,-9,-1,1,0,-7,8,1,-1,4,3,-1,3,2,1,2,3,0,-12,-14,-6,-3,9,2,0,-1,-1,1,-1,-1,1,-1
KR_6606383233,420,0,11,9,-5,4,2,6,1,1,2,-2,2,0,-5,8,3,-3,3,0,1,-4,-4,1,-9,8,4,0,-1,-1,1,-1,1,2,-1
KR_6669620511,440,-3,-43,-12,-5,-1,2,1,0,3,3,-3,4,1,-2,2,0,1,1,2,0,-3,-4,-3,-4,7,3,0,0,-1,-1,-1,1,5,-1
KR_6754364120,420,-3,-21,5,-7,-6,6,0,2,1,3,-4,5,1,0,1,1,1,0,1,0,-6,-1,-6,-3,9,4,0,0,1,-1,0,1,6,-1
KR_6561422218,420,-3,5,8,-3,-1,3,2,-3,3,0,-1,4,3,-1,3,2,3,0,3,0,2,-23,-3,-3,6,7,0,0,1,1,1,1,6,-1
KR_6658266009,420,-2,-40,-5,-3,0,2,2,-1,2,1,0,3,3,-1,5,4,-1,5,4,0,-10,-8,2,-7,5,-3,0,0,-1,1,0,1,6,-1
KR_6736709661,420,-4,-93,2,-6,0,1,1,-4,6,2,1,0,1,-3,3,0,0,0,0,0,-10,2,-1,-5,6,2,0,0,-1,1,0,-1,4,-1
KR_6760930164,440,2,-2,8,8,1,0,1,-2,3,1,3,0,3,-1,1,0,7,1,8,-1,7,6,4,-8,4,-4,0,1,1,1,1,-1,2,-1
KR_6690360542,420,-5,-87,0,-8,-1,2,1,-7,7,0,-1,1,0,0,1,1,1,0,1,0,-4,114,1,-6,5,-6,0,-1,1,-1,-1,-1,5,-1
KR_6656662907,420,-3,-12,9,-11,-2,3,1,-2,6,4,-4,4,0,-3,6,3,0,2,2,0,-10,7,3,-6,3,-3,0,-1,1,-1,-1,1,3,-1
KR_6663493670,420,-4,-84,-38,-18,1,0,1,-3,3,0,-5,7,2,-10,10,0,-1,3,2,0,-15,4,3,-6,3,0,0,0,-1,-1,-1,-1,1,-1
KR_6758729950,420,0,33,5,8,0,2,2,4,1,5,-1,3,2,3,0,3,2,0,2,1,14,-4,0,-4,4,0,0,0,1,-1,1,1,4,-1
KR_6756106672,420,-4,-47,12,-11,-1,2,1,-2,4,2,-3,4,1,-5,5,0,0,0,0,0,-9,-3,1,-6,5,-5,0,0,-1,1,-1,-1,1,-1
KR_6765028750,420,-3,-51,-4,2,0,0,0,0,2,2,-1,5,4,2,2,4,1,0,1,0,7,4,-2,-3,5,3,0,-1,1,-1,-1,1,2,-1
KR_6744598010,420,4,4,-4,6,3,1,4,3,0,3,-1,3,2,1,7,8,0,2,2,0,8,-3,-1,-5,6,2,0,-1,1,1,1,1,3,-1
KR_6641852326,440,-1,-39,10,3,4,1,5,-2,2,0,-2,3,1,3,0,3,0,1,1,0,3,-8,1,-6,5,1,0,-1,1,-1,-1,1,4,-1
KR_6761069604,420,-1,-25,-12,-4,-2,4,2,5,1,6,0,2,2,-1,5,4,-6,8,2,-2,-10,7,-2,-3,5,-1,0,-1,-1,-1,-1,-1,5,-1
KR_6642539624,420,-1,40,-10,0,3,0,3,-4,7,3,0,1,1,1,2,3,0,1,1,0,-4,4,3,-5,2,3,0,0,-1,1,1,-1,1,-1
KR_6665070573,420,-5,-28,-47,-13,-2,3,1,-3,4,1,-4,5,1,-2,3,1,-2,3,1,0,-8,7,-2,-2,4,3,0,-1,-1,1,-1,1,5,-1
KR_6761695979,420,-4,-88,-22,-11,-3,4,1,-1,4,3,-2,6,4,-3,3,0,-2,2,0,0,-2,-34,-1,-5,6,-2,0,-3,-1,-1,-1,1,5,-1
KR_6713126980,440,1,53,-3,1,3,0,3,-4,4,0,5,1,6,-1,2,1,-2,5,3,0,-3,3,-2,-5,7,2,0,0,1,1,1,1,1,-1
KR_6754664218,420,-2,-83,16,-4,0,1,1,-3,4,1,0,0,0,-3,6,3,2,0,2,0,-5,-3,-5,-2,7,2,0,0,0,1,0,-1,0,-1
KR_6763892668,420,0,47,12,-4,-2,5,3,2,2,4,-1,2,1,-4,6,2,1,1,2,0,-6,259,-8,-6,14,4,0,1,1,1,1,1,2,-1
KR_6761175031,420,-5,-54,-28,-6,2,0,2,-4,4,0,-1,1,0,-5,7,2,2,0,2,0,-14,6,3,-9,6,-5,0,-1,-1,1,-1,-1,5,-1
KR_6705642821,420,1,-24,2,1,2,0,2,4,0,4,-1,5,4,-2,4,2,-2,3,1,2,9,2,3,-8,5,2,0,0,1,-1,0,1,1,-1
KR_6001957281,420,-3,-65,-16,-7,-3,5,2,1,3,4,-3,3,0,-1,1,0,-1,1,0,0,1,-16,-3,-2,5,0,0,0,1,1,-1,-1,5,-1
KR_6609137127,420,0,-17,7,0,0,1,1,0,5,5,-2,2,0,1,0,1,1,0,1,1,2,12,-3,-6,9,-2,0,0,1,-1,0,1,6,-1
KR_6759860210,440,-4,19,-8,-7,-1,5,4,1,0,1,-1,1,0,-4,5,1,-2,3,1,0,-7,-24,2,-6,4,-4,0,-1,-1,1,-1,1,3,-1
KR_6672109442,420,-4,-35,-54,-10,1,1,2,-1,5,4,-6,7,1,-2,2,0,-2,4,2,-1,-12,-8,-3,-3,6,2,0,0,-1,-1,-1,-1,4,-1
KR_6753391606,420,-3,-35,-36,-7,-4,4,0,1,1,2,-3,4,1,-1,7,6,0,1,1,0,-6,-1,0,-6,6,-5,0,-2,0,-1,-1,-1,0,-1
KR_6756519644,420,2,-7,-5,5,1,1,2,1,1,2,-3,3,0,5,2,7,1,0,1,0,6,-1,-2,-5,7,3,0,0,1,1,0,1,5,-1
KR_6743076568,420,-2,-23,-7,-7,1,2,3,1,3,4,-5,5,0,-6,7,1,2,0,2,0,-9,2,-3,-2,5,1,0,-1,-1,-1,-1,1,4,-1
KR_6749619772,420,-6,-128,-8,-11,-2,2,0,-4,5,1,-4,4,0,0,5,5,-1,1,0,0,-18,9,3,-4,1,0,0,-1,-1,-1,-1,1,2,-1
KR_6762108973,420,-4,-97,29,-15,-1,2,1,1,2,3,-4,4,0,-9,11,2,-2,2,0,0,-13,-5,-1,-5,6,1,0,-4,-1,-1,-1,-1,2,-1
KR_6763672809,420,-1,15,-28,0,2,2,4,-1,1,0,-1,2,1,-1,3,2,1,0,1,0,1,42,-1,-4,5,-1,0,0,1,-1,1,-1,1,-1
KR_6747958440,420,-5,3,-20,-12,0,3,3,2,1,3,-2,3,1,-8,8,0,-4,4,0,0,-5,-26,0,-5,5,1,0,0,-1,-1,-1,-1,6,-1
KR_6703621745,420,1,1,0,0,2,0,2,-4,6,2,-1,3,2,3,2,5,0,0,0,0,3,-1,-1,-4,5,1,0,-1,-1,-1,-1,1,6,-1
KR_6718080758,440,-2,-25,-34,-8,1,1,2,-5,7,2,-5,6,1,3,0,3,-2,3,1,0,-7,9,1,-5,4,2,0,-2,-1,-1,-1,-1,4,-1
KR_6760811063,420,2,-13,-12,7,1,1,2,1,1,2,0,2,2,4,1,5,1,1,2,0,8,-3,-2,-5,7,-4,0,-1,-1,-1,-1,-1,6,-1
KR_6758658786,420,0,9,4,4,-1,1,0,1,2,3,5,3,8,3,0,3,-4,4,0,0,-1,0,0,-5,5,-1,0,0,1,1,1,1,3,-1
KR_6748961731,420,2,-14,4,2,-1,2,1,0,3,3,0,2,2,4,2,6,-1,3,2,0,-2,-1,-3,-4,7,0,0,0,-1,-1,-1,1,2,-1
KR_6725030956,420,1,-10,-27,-4,-3,4,1,5,1,6,0,5,5,-2,3,1,-4,4,0,0,-7,-71,2,-9,7,4,0,0,0,1,-1,-1,0,-1
KR_6759171478,420,-4,-35,-10,-6,-1,4,3,-1,2,1,-1,2,1,-2,3,1,-1,1,0,0,-7,-8,-3,-5,8,-1,0,0,-1,0,0,1,6,-1
KR_6744340068,420,2,43,9,4,2,1,3,1,3,4,0,2,2,2,3,5,-1,1,0,0,5,-20,0,-6,6,-2,0,1,1,-1,1,-1,1,-1
KR_6753149045,420,-1,-19,8,-5,1,1,2,-1,3,2,-3,4,1,-3,4,1,1,0,1,0,-7,9,0,-8,8,-1,0,0,-1,-1,-1,1,4,-1
KR_6735000388,420,2,-8,-7,8,3,0,3,3,3,6,-3,7,4,6,0,6,-1,1,0,2,13,-143,1,-5,4,2,0,0,1,-1,0,1,2,-1
KR_6755035892,420,-4,-30,15,-11,0,1,1,0,2,2,-5,7,2,-6,6,0,0,1,1,0,-8,-7,-4,-3,7,-1,0,-2,1,-1,-1,-1,6,-1
KR_6759029108,420,-4,-49,-21,-9,1,2,3,-5,7,2,-5,5,0,-5,5,0,5,1,6,0,-15,7,-1,-3,4,-8,0,-1,0,1,-1,1,0,-1
KR_6762535710,440,-4,-35,-9,-7,0,4,4,0,1,1,4,4,8,-8,8,0,-3,6,3,-1,-10,24,0,-2,2,0,0,-2,-1,-1,-1,-1,1,-1
KR_6763798853,420,-5,-81,-55,-10,-4,4,0,1,3,4,-7,8,1,-1,5,4,1,0,1,0,0,159,1,-5,4,-24,0,-2,-1,-1,-1,-1,1,-1
KR_6714247899,420,-5,-111,-21,-8,-2,4,2,1,2,3,-6,7,1,-1,5,4,0,0,0,0,-4,-9,-4,-1,5,1,0,0,-1,-1,0,-1,3,-1
KR_6758706969,420,-3,-45,11,-8,-3,3,0,-1,2,1,1,3,4,-2,4,2,-3,3,0,-1,-4,-34,-3,-4,7,2,0,-1,0,-1,-1,-1,0,-1
KR_6758758087,420,-5,-93,-29,-11,-5,5,0,-4,6,2,-1,3,2,2,4,6,-3,5,2,-2,-2,2,-4,-3,7,2,0,-2,-1,-1,-1,-1,6,-1
KR_6723095625,420,-2,-9,-18,5,-3,5,2,1,4,5,1,0,1,0,3,3,6,0,6,0,10,-15,4,-7,3,7,0,1,-1,1,1,-1,1,-1
KR_6760619941,420,-4,-79,-16,-6,0,2,2,1,3,4,-2,2,0,0,2,2,-5,9,4,1,-9,1,-3,-1,4,2,0,-1,-1,-1,-1,1,4,-1
KR_6641154244,420,-1,-20,11,0,1,1,2,-1,1,0,-1,1,0,2,0,2,-1,1,0,0,5,-1,2,-4,2,-4,0,-1,-1,-1,-1,1,4,-1
KR_6617583862,420,-2,16,-20,-2,1,1,2,-2,4,2,1,4,5,-1,4,3,-1,1,0,0,-1,-7,-4,-5,9,-2,0,0,-1,1,0,-1,2,-1
KR_6614081427,420,3,39,24,5,4,0,4,-3,4,1,1,4,5,0,3,3,3,1,4,0,1,-46,-2,-4,6,18,0,0,1,1,1,-1,2,-1
KR_6698725876,420,0,3,34,-9,5,0,5,-1,3,2,-6,6,0,-7,9,2,0,2,2,0,-8,7,0,-8,8,-5,0,0,-1,-1,1,1,4,-1
KR_6705405634,420,-4,-75,-16,-9,-1,1,0,-1,5,4,-5,8,3,-1,3,2,-1,1,0,0,-4,251,3,-5,2,-1,0,-1,1,-1,-1,1,2,-1
KR_6744824025,420,-4,-26,-1,-5,3,1,4,1,3,4,-2,4,2,-6,7,1,-1,1,0,0,-11,1,-5,-4,9,2,0,1,-1,1,1,-1,2,-1
KR_6722853736,420,-1,-14,-7,-5,0,1,1,-4,6,2,-4,4,0,5,0,5,-2,3,1,0,-1,-2,-1,-4,5,-2,0,-1,1,-1,-1,-1,6,-1
KR_6731680019,420,-3,-45,-6,-15,-4,4,0,-6,9,3,1,1,2,0,3,3,-6,6,0,0,-19,-25,-2,-6,8,4,0,0,-1,-1,0,-1,2,-1
KR_6633163986,420,-1,6,-16,-1,3,2,5,-3,4,1,-2,6,4,0,3,3,1,0,1,0,-3,-1,0,-6,6,0,0,2,1,1,1,1,2,-1
KR_6759841424,420,-1,-16,-5,-2,-1,3,2,-6,9,3,3,2,5,2,1,3,0,1,1,0,2,14,2,-5,3,-4,0,0,0,0,0,-1,0,-1
KR_6750236230,420,1,15,8,3,3,1,4,1,2,3,-2,4,2,1,6,7,0,1,1,-1,-7,3,3,-10,7,3,0,1,-1,1,1,-1,2,-1
KR_6689827267,420,-1,-48,4,8,-1,1,0,0,5,5,-2,4,2,6,2,8,5,1,6,4,20,69,4,-8,4,0,0,1,0,1,1,1,0,-1
KR_6758737436,420,0,-25,4,3,-1,1,0,6,2,8,1,1,2,-3,4,1,0,1,1,1,1,9,3,-6,3,-2,0,-1,1,-1,-1,1,3,-1
KR_6746294559,420,-2,27,-16,-5,0,2,2,0,3,3,-2,7,5,-1,4,3,-2,2,0,0,7,-6,1,-4,3,0,0,1,-1,1,1,1,1,-1
KR_6660530969,420,-6,-101,7,-5,1,2,3,-2,4,2,-5,6,1,1,1,2,0,0,0,-2,1,-3,-1,-2,3,-4,0,-2,-1,0,-1,-1,6,-1
KR_6761481840,420,-4,18,0,-16,-4,4,0,-2,2,0,-5,5,0,-4,7,3,-1,3,2,0,-14,-125,2,-8,6,-8,0,-2,-1,-1,-1,-1,3,-1
KR_6668104904,420,-2,-30,-19,-3,-7,8,1,-1,4,3,-1,2,1,2,1,3,4,0,4,0,3,-18,2,-4,2,-3,0,1,-1,0,1,-1,6,-1
KR_6643681090,420,2,26,4,-4,1,0,1,-6,8,2,3,1,4,-1,2,1,-1,2,1,0,-10,5,-3,-5,8,0,0,0,-1,-1,0,1,3,-1
KR_6416925793,420,0,2,3,-6,-5,7,2,2,3,5,-4,6,2,3,1,4,-2,2,0,0,-3,-7,0,-9,9,3,0,-1,-1,-1,-1,-1,6,-1
KR_6762270086,420,-1,-41,2,1,3,0,3,1,3,4,-4,4,0,0,3,3,1,1,2,0,3,15,-3,-3,6,2,0,0,-1,1,0,1,4,-1
KR_6764991871,420,-3,-12,-27,-11,-4,4,0,-4,5,1,-1,4,3,2,3,5,-4,4,0,0,-12,-13,2,-6,4,1,0,1,1,-1,1,-1,4,-1
KR_6762997662,420,-1,-69,28,-1,-2,2,0,0,3,3,0,3,3,0,3,3,1,0,1,0,1,3,-3,-7,10,-5,0,0,1,-1,-1,-1,5,-1
KR_6759987965,420,0,-8,-26,0,0,0,0,-3,5,2,5,0,5,0,2,2,-2,4,2,0,1,-5,-1,-6,7,1,0,0,-1,-1,0,1,2,-1
KR_6723860448,420,0,-21,20,-10,-5,5,0,-2,3,1,1,3,4,-4,4,0,0,1,1,0,-8,-16,-4,-4,8,1,0,0,1,-1,0,-1,1,-1
KR_6755787351,420,-1,-25,-12,-1,-1,2,1,0,2,2,1,1,2,-3,4,1,2,1,3,0,1,-3,-1,-4,5,0,0,-1,1,-1,-1,-1,2,-1
KR_6761429365,440,-2,-69,-12,5,-4,5,1,-2,3,1,3,1,4,4,3,7,4,0,4,0,8,9,1,-6,5,-3,0,-2,1,1,-1,1,5,-1
KR_6700960428,420,0,36,0,5,-1,3,2,4,3,7,0,4,4,8,2,10,-6,6,0,2,1,1,3,-6,3,1,0,0,-1,1,1,1,2,-1
KR_6691269386,420,-2,-79,-12,-8,-3,5,2,3,1,4,-4,4,0,-3,6,3,-1,2,1,0,-7,-1,-7,-2,9,-2,0,-4,-1,-1,-1,-1,3,-1
KR_6679680071,420,2,-29,20,9,0,2,2,3,2,5,4,0,4,-2,5,3,4,0,4,2,16,-10,1,-7,6,-3,0,-1,1,1,-1,1,1,-1
KR_6660030927,420,3,77,-18,1,0,2,2,0,3,3,-2,6,4,-1,5,4,4,0,4,0,-1,5,0,-7,7,0,0,2,-1,1,1,1,1,-1
KR_6725546309,420,1,-17,12,6,-2,2,0,-3,5,2,9,0,9,3,5,8,-1,1,0,0,11,12,0,-4,4,-7,0,-1,-1,-1,-1,-1,2,-1
KR_6679555276,420,-4,8,-32,-5,-1,3,2,-2,2,0,0,2,2,-3,5,2,1,0,1,0,0,-129,0,-4,4,3,0,-1,-1,-1,-1,1,5,-1
KR_6760240250,420,0,-6,-9,-3,-2,4,2,0,0,0,-3,3,0,2,2,4,0,0,0,0,-1,6,1,-6,5,-5,0,1,1,-1,1,1,2,-1
KR_6707449933,440,-2,-21,-15,-2,0,1,1,2,3,5,0,1,1,-2,5,3,-2,3,1,0,6,12,-4,-7,11,-3,0,-1,1,-1,-1,-1,6,-1
KR_6734767465,420,-3,-41,16,-5,0,1,1,-1,3,2,-1,3,2,-1,3,2,-2,2,0,0,-13,4,-3,-4,7,-1,0,-1,1,-1,-1,-1,3,-1
KR_6531089896,420,-1,18,8,0,-2,3,1,1,4,5,-1,2,1,1,2,3,1,1,2,0,-2,-8,1,-7,6,-1,0,0,-1,1,0,1,6,-1
KR_6622352597,420,0,-17,-15,-4,3,0,3,-4,4,0,1,3,4,-3,5,2,-1,2,1,-1,-3,27,0,-2,2,-1,0,0,-1,1,-1,-1,3,-1
KR_6684726126,420,2,-3,-24,1,5,0,5,-1,2,1,-2,2,0,2,0,2,-3,4,1,0,4,-1,7,-8,1,-2,0,1,1,1,1,-1,2,-1
KR_6743110245,420,-2,-15,-17,-9,2,1,3,-3,3,0,0,2,2,-7,7,0,-1,2,1,0,-12,-46,-3,-1,4,16,0,-1,1,-1,-1,-1,5,-1
KR_6754554950,420,0,-30,9,-5,-1,2,1,-5,6,1,-2,2,0,0,4,4,3,1,4,0,-11,8,-3,-4,7,8,0,1,-1,-1,-1,1,2,-1
KR_6764823194,440,2,-33,-36,-1,-1,2,1,0,2,2,1,1,2,-2,3,1,1,2,3,0,0,1,4,-9,5,-5,0,-2,-1,-1,-1,-1,6,-1
KR_6755372652,420,1,6,3,6,3,2,5,0,3,3,2,2,4,2,1,3,-1,2,1,0,9,29,6,-8,2,-2,0,0,-1,1,-1,1,6,-1
KR_6762397092,420,-2,-38,-20,-8,-2,2,0,-4,8,4,0,2,2,0,3,3,-2,2,0,-1,-10,-34,0,-5,5,2,0,0,-1,0,0,-1,6,-1
KR_6755136580,420,0,25,4,-3,1,1,2,0,2,2,-1,1,0,-3,3,0,0,0,0,0,-3,-9,0,-6,6,-3,0,0,-1,1,0,-1,6,-1
KR_6709637036,420,-3,-77,-43,-7,1,1,2,-4,5,1,0,3,3,-2,4,2,-2,2,0,-3,-10,-9,-5,-5,10,3,0,0,-1,-1,-1,-1,2,-1
KR_6765000848,420,0,53,-50,7,2,1,3,5,2,7,-2,3,1,2,1,3,0,0,0,0,6,9,4,-10,6,-2,0,1,0,-1,1,1,0,-1
KR_6762358979,420,-2,-26,-28,-9,5,1,6,-2,5,3,-1,2,1,-10,10,0,-1,2,1,0,-19,0,-3,-3,6,-5,0,-1,-1,-1,-1,-1,3,-1
KR_6754144355,420,-5,1,-20,-7,-2,2,0,-3,4,1,-1,3,2,-3,4,1,2,0,2,0,-13,-5,-2,-2,4,1,0,-1,-1,0,-1,-1,6,-1
KR_6702669185,440,-7,-10,-48,-17,-2,3,1,0,1,1,-6,6,0,-3,4,1,-6,7,1,0,-11,-2,3,-9,6,0,0,-1,-1,-1,-1,-1,6,-1
KR_6676463080,440,-1,-32,23,-7,1,2,3,1,1,2,-4,5,1,-5,8,3,0,1,1,0,-9,7,1,-6,5,-1,0,0,1,0,-1,1,2,-1
KR_6754513402,420,-1,-8,-4,-9,-2,3,1,-4,7,3,0,2,2,-3,6,3,0,1,1,0,-12,36,-4,-5,9,-21,0,-1,-1,-1,-1,-1,1,-1
KR_6737144169,420,-1,-45,-29,-7,0,1,1,2,0,2,-2,3,1,-6,6,0,-1,3,2,-1,-7,27,1,-5,4,-14,0,-1,-1,-1,-1,-1,4,-1
KR_6755559846,420,-1,-24,30,-3,0,1,1,-3,4,1,-1,3,2,1,1,2,0,1,1,0,-8,5,1,-4,3,-1,0,-1,-1,-1,-1,-1,2,-1
KR_6640203694,440,-3,-88,-8,-12,2,0,2,-1,4,3,-4,6,2,-6,8,2,-3,3,0,0,-10,3,-2,-5,7,2,0,0,0,-1,-1,-1,0,-1
KR_6735917598,420,-2,-103,-13,-7,-4,6,2,0,1,1,-2,5,3,-1,7,6,0,1,1,1,0,4,-3,-5,8,-4,0,-2,1,-1,-1,-1,6,-1
KR_6744382543,420,-9,-103,-4,-22,-4,6,2,-3,4,1,-6,7,1,-12,13,1,3,0,3,0,-13,-5,-2,-4,6,4,0,-2,1,1,-1,-1,1,-1
KR_6739930884,420,-5,-95,-12,-9,-1,4,3,2,3,5,-1,3,2,-5,6,1,-4,7,3,1,-6,-8,-4,-1,5,7,0,-3,-1,-1,-1,1,4,-1
KR_6759928932,420,3,21,20,8,5,0,5,-3,5,2,2,0,2,1,0,1,3,0,3,0,3,-43,-3,-3,6,36,0,0,1,0,0,1,1,-1
KR_6629083317,420,0,30,8,0,7,0,7,0,4,4,-2,3,1,-5,5,0,0,0,0,0,-3,95,1,-4,3,1,0,-2,1,-1,-1,-1,4,-1
KR_6758706985,420,-4,-47,0,-10,-2,3,1,2,1,3,0,6,6,-6,7,1,-4,4,0,0,-11,0,-3,-4,7,-3,0,-1,-1,1,-1,1,6,-1
KR_6737204242,420,2,-20,-4,-1,-3,5,2,4,3,7,0,1,1,-2,4,2,0,0,0,-1,4,-15,-3,-3,6,3,0,0,1,-1,0,-1,2,-1
KR_6733340739,420,1,-11,9,-2,-2,2,0,-7,7,0,2,0,2,0,2,2,5,1,6,0,-2,4,-4,-1,5,2,0,0,-1,-1,1,1,3,-1
KR_6764035734,420,0,-51,8,5,-2,3,1,1,2,3,4,0,4,-1,1,0,3,0,3,0,7,49,-3,-5,8,-3,0,0,1,1,1,-1,4,-1
KR_6752796481,420,-2,-61,-17,-5,2,1,3,-4,4,0,5,1,6,-5,7,2,-3,3,0,0,-10,-16,-3,-7,10,0,0,-1,-1,1,-1,1,3,-1
KR_6741981951,420,4,24,21,9,3,0,3,-3,6,3,8,0,8,3,5,8,-2,3,1,0,2,-101,0,-6,6,4,0,2,1,-1,1,1,4,-1
KR_6738182055,440,1,-32,15,0,1,1,2,8,0,8,1,1,2,-5,5,0,-5,5,0,0,-2,-18,-4,-3,7,0,0,0,-1,-1,-1,-1,1,-1
KR_6751341350,420,-3,-47,3,-8,0,3,3,-3,4,1,-4,6,2,-3,3,0,2,0,2,0,-4,-8,-3,-3,6,3,0,-2,-1,-1,-1,1,4,-1
KR_6399892623,420,1,35,-15,11,-1,3,2,9,1,10,-1,4,3,4,2,6,0,2,2,4,16,-6,1,-7,6,1,0,1,1,1,1,1,1,-1
KR_6679635658,420,-1,46,0,6,2,0,2,1,1,2,1,2,3,2,2,4,0,1,1,1,15,-7,2,-5,3,2,0,0,1,-1,1,1,6,-1
KR_6755248591,420,-3,-6,-8,1,3,1,4,-6,6,0,1,1,2,0,1,1,3,0,3,0,-3,-5,1,-2,1,-2,0,0,0,0,0,-1,0,-1
KR_6755587269,420,-2,-32,-26,-4,-2,3,1,-1,3,2,0,4,4,1,1,2,-2,4,2,1,9,9,2,-6,4,-5,0,-1,0,-1,-1,1,0,-1
KR_6732102200,420,-1,-15,27,-6,0,2,2,-7,7,0,0,0,0,1,2,3,0,0,0,0,-8,7,3,-6,3,-3,0,0,-1,0,0,-1,4,-1
KR_6758971775,440,-3,-65,4,-3,-1,1,0,1,0,1,2,1,3,-5,5,0,0,0,0,0,0,-5,0,-3,3,-1,0,0,-1,1,0,1,5,-1
KR_6756818436,440,-3,17,-56,-6,-1,2,1,-1,2,1,-1,2,1,0,1,1,-3,5,2,0,-9,-169,5,-9,4,-2,0,0,-1,1,0,1,1,-1
KR_6679382477,420,-4,-5,-12,2,1,0,1,-2,8,6,-3,3,0,6,2,8,0,0,0,0,-1,5,5,-7,2,-4,0,-3,-1,-1,-1,1,3,-1
KR_6756559277,420,-2,-97,-6,-10,-1,3,2,-1,3,2,-5,6,1,-6,6,0,3,0,3,0,-6,-1,0,-8,8,-4,0,-3,-1,-1,-1,1,1,-1
KR_6762674516,420,-3,-48,-44,-9,-1,1,0,-3,4,1,0,1,1,-2,4,2,-3,4,1,0,-8,-8,1,-9,8,-1,0,-1,-1,-1,-1,-1,2,-1
KR_6562484386,420,1,-60,0,0,0,0,0,-3,5,2,2,0,2,0,3,3,1,1,2,0,-1,24,-1,-8,9,-3,0,0,1,-1,0,-1,6,-1
KR_6763664048,420,3,19,16,-1,3,0,3,0,0,0,-1,2,1,-3,3,0,0,1,1,0,-3,-2,1,-5,4,-5,0,1,-1,1,1,-1,4,-1
KR_6742331346,440,2,35,4,5,-5,7,2,-2,3,1,4,1,5,8,0,8,0,1,1,0,-7,292,-3,-6,9,-2,0,1,-1,-1,-1,1,5,-1
KR_6758655538,420,-2,-6,-20,-4,0,1,1,-3,3,0,-4,4,0,2,1,3,1,0,1,0,-4,-103,0,-5,5,3,0,0,-1,-1,0,-1,5,-1
KR_6763039659,420,-1,-26,-21,-5,1,4,5,-7,7,0,-1,3,2,1,3,4,1,0,1,-3,-9,3,-2,-7,9,-1,0,1,1,1,1,-1,6,-1
KR_6730899581,440,0,-10,-4,3,-3,3,0,2,0,2,-1,2,1,5,4,9,0,0,0,1,11,-5,3,-6,3,0,0,-1,0,1,-1,1,0,-1
KR_6732978918,420,-1,19,4,-1,-1,2,1,4,1,5,-2,6,4,-3,3,0,1,0,1,0,0,20,2,-6,4,-1,0,0,-1,1,0,1,5,-1
KR_6714816729,440,-2,-66,-14,-6,4,0,4,-5,5,0,-2,3,1,-2,3,1,-1,1,0,-4,-16,-2,0,-1,1,0,0,-1,-1,-1,-1,-1,6,-1
KR_6764012102,420,-2,3,-13,-11,3,1,4,0,2,2,-1,2,1,-11,14,3,-2,2,0,0,-17,-10,-1,-4,5,2,0,0,-1,1,-1,1,5,-1
KR_6756641766,420,-4,13,3,-6,-1,2,1,0,4,4,0,1,1,-5,6,1,0,2,2,0,-8,6,0,-6,6,2,0,0,-1,-1,0,1,4,-1
KR_6754534902,440,-1,-44,-8,-5,-3,3,0,-1,6,5,-2,2,0,0,4,4,1,1,2,-2,-7,-6,-4,-5,9,2,0,0,-1,-1,0,-1,4,-1
KR_6695525813,420,-1,12,32,-11,-7,8,1,1,4,5,-2,3,1,-1,2,1,-2,2,0,-1,-11,34,3,-5,2,1,0,-1,1,-1,-1,-1,5,-1
KR_6710364697,420,-3,-38,-38,0,-1,1,0,-1,4,3,2,0,2,1,1,2,-1,3,2,-1,8,-4,0,-6,6,0,0,1,-1,1,1,-1,4,-1
KR_6668748510,440,-3,-42,-8,-3,4,1,5,-8,9,1,-1,2,1,1,1,2,1,3,4,0,-6,34,-6,0,6,-1,0,-1,-1,-1,-1,-1,1,-1
KR_6754202053,420,-2,17,-24,-8,-1,2,1,-3,5,2,-3,3,0,-2,5,3,1,0,1,0,-15,-51,1,-5,4,-2,0,0,-1,-1,0,1,5,-1
KR_6665742486,420,1,24,-19,-1,-1,1,0,2,4,6,3,2,5,-2,3,1,-3,3,0,0,1,0,-1,-4,5,1,0,0,-1,-1,0,-1,6,-1
KR_6563913102,420,-7,2,-64,-16,-1,2,1,-11,14,3,-1,3,2,1,1,2,-4,4,0,-2,-25,-68,-1,-4,5,-1,0,0,1,-1,-1,-1,5,-1
KR_6753600779,420,0,-15,-20,-8,2,2,4,-6,11,5,0,2,2,-4,5,1,0,2,2,0,-15,-13,0,-7,7,3,0,-2,-1,-1,-1,-1,1,-1
KR_6759679915,420,1,11,-1,-2,-1,1,0,-2,2,0,-3,4,1,3,0,3,1,0,1,2,-1,8,1,-6,5,-1,0,0,-1,-1,0,1,5,-1
KR_6656402739,420,-5,-26,-29,-11,0,2,2,0,4,4,-6,6,0,-5,5,0,0,1,1,0,-14,-23,1,-8,7,3,0,-1,-1,-1,-1,-1,6,-1
KR_6727904430,420,1,4,15,4,-1,4,3,4,2,6,1,3,4,2,1,3,-2,3,1,-1,3,-4,1,-4,3,7,0,2,-1,1,1,-1,5,-1
KR_6691115754,420,0,-11,-20,-5,3,0,3,-5,6,1,-4,5,1,2,2,4,-1,1,0,0,-4,-47,-4,-4,8,25,0,-1,0,-1,-1,1,0,-1
KR_6731725916,420,-2,-51,-17,-2,-1,3,2,1,4,5,0,2,2,-4,8,4,2,1,3,0,4,-9,-2,-5,7,5,0,-1,0,-1,-1,1,0,-1
KR_6741613279,440,2,-30,52,0,0,0,0,3,0,3,-2,3,1,0,4,4,-1,2,1,0,-1,-5,2,-3,1,-1,0,0,1,-1,-1,-1,6,-1
KR_6745545324,440,-1,-22,4,4,-2,5,3,-1,3,2,6,0,6,-1,4,3,2,1,3,0,4,-23,3,-5,2,4,0,-1,0,1,-1,1,0,-1
KR_6639920402,420,-1,4,-24,0,-1,4,3,1,0,1,0,6,6,0,2,2,0,0,0,0,7,11,3,-8,5,-1,0,0,-1,1,1,1,2,-1
KR_6749831609,420,-2,-6,-39,-4,-3,3,0,-2,3,1,1,2,3,-2,5,3,2,0,2,0,6,-6,-6,-3,9,-1,0,0,1,-1,0,-1,4,-1
KR_6731583740,420,-2,-53,32,-7,-3,4,1,-1,2,1,1,0,1,-3,4,1,-1,1,0,0,-4,-11,-1,-4,5,1,0,-1,-1,1,-1,-1,6,-1
KR_6765037833,420,-2,-61,-8,-2,-1,3,2,0,3,3,3,2,5,-4,4,0,0,1,1,0,-3,-10,-3,-5,8,-3,0,-1,1,1,-1,1,5,-1
KR_6649564385,420,-1,-16,0,-1,-2,4,2,2,3,5,0,1,1,0,2,2,-1,1,0,-1,1,16,0,-4,4,-3,0,-1,0,-1,-1,-1,0,-1
KR_6661562021,420,0,39,8,0,1,0,1,-1,6,5,2,1,3,-3,5,2,1,1,2,0,4,-9,3,-6,3,-2,0,0,-1,1,-1,-1,4,-1
KR_6765013763,420,-4,-76,-27,-10,4,1,5,-10,12,2,-1,4,3,-3,3,0,0,0,0,0,-16,0,-2,-4,6,-4,0,-1,-1,-1,-1,1,3,-1
KR_6758077044,420,-2,-36,-8,-10,-5,6,1,2,1,3,-4,5,1,-4,4,0,1,0,1,0,-7,2,-1,-5,6,0,0,-2,-1,0,-1,-1,5,-1
KR_6727996366,440,1,4,15,5,-3,4,1,0,2,2,1,0,1,3,1,4,4,2,6,1,7,-23,-2,-4,6,-2,0,0,0,0,-1,1,0,-1
KR_6763635352,420,-2,-23,-28,-4,1,0,1,2,3,5,-3,3,0,-2,2,0,-2,2,0,0,-2,6,0,-6,6,-3,0,1,-1,1,1,-1,3,-1
KR_6760557822,420,-1,6,-15,-1,-1,2,1,0,2,2,2,2,4,-2,2,0,0,0,0,1,-2,0,3,-5,2,-2,0,1,1,0,1,1,4,-1
KR_6753095674,420,1,1,2,-1,-3,3,0,3,4,7,0,3,3,0,2,2,-1,3,2,-1,6,0,3,-6,3,-6,0,-2,0,-1,-1,-1,0,-1
KR_6738288317,420,-5,-24,-20,-8,1,1,2,-1,4,3,0,0,0,-7,8,1,-1,1,0,0,-4,183,-2,-4,6,-1,0,0,1,-1,0,-1,1,-1
KR_6704188828,420,-5,-129,10,-13,-3,4,1,-4,5,1,-2,3,1,-2,4,2,-2,3,1,0,-15,-15,-1,-7,8,-7,0,-2,1,1,-1,-1,5,-1
KR_6749222474,420,1,4,-12,-2,1,1,2,-2,4,2,0,3,3,-4,4,0,3,1,4,0,-9,110,-4,-4,8,1,0,-1,-1,-1,-1,-1,5,-1
KR_6756643495,440,0,-8,5,-3,0,1,1,0,2,2,-5,5,0,2,4,6,0,0,0,-1,-7,1,-2,-5,7,3,0,-1,1,1,-1,-1,4,-1
KR_6749536249,420,2,55,-2,1,2,2,4,2,1,3,-4,5,1,1,2,3,0,2,2,0,-3,-30,0,-3,3,3,0,1,1,0,1,-1,4,-1
KR_6733691611,420,-2,17,-11,-7,1,0,1,-6,8,2,2,4,6,-3,3,0,-1,1,0,0,-7,-27,4,-6,2,6,0,-1,1,-1,-1,1,2,-1
KR_6758815704,420,-3,25,8,-8,-1,1,0,-2,5,3,-3,5,2,-2,2,0,0,0,0,0,-7,-388,-4,-7,11,5,0,-1,-1,-1,-1,1,4,-1
KR_6749300525,440,-2,-31,-20,-2,2,2,4,-1,5,4,-2,5,3,-2,4,2,1,0,1,0,-11,-31,1,-7,6,17,0,-1,0,-1,-1,-1,0,-1
KR_6707878096,420,-2,-48,20,-5,1,0,1,-2,9,7,1,2,3,-4,6,2,-1,1,0,0,-7,-21,0,-8,8,-6,0,0,-1,1,0,-1,4,-1
KR_6710656249,440,1,15,36,8,-1,4,3,5,1,6,2,3,5,2,3,5,0,0,0,1,15,-2,1,-8,7,4,0,1,1,1,-1,1,6,-1
KR_6632375424,420,-4,-5,-24,-10,-4,7,3,-3,5,2,1,1,2,-6,7,1,2,0,2,0,-30,-17,9,-11,2,2,0,0,-1,1,-1,1,1,-1
KR_6756126763,420,0,-51,20,2,2,2,4,0,3,3,2,0,2,-2,4,2,0,1,1,0,0,-14,0,-4,4,2,0,0,-1,1,0,1,5,-1
KR_6732752956,420,-5,-17,-27,-14,-1,3,2,-4,4,0,-6,6,0,-4,5,1,1,1,2,0,-16,233,-2,-2,4,-4,0,0,-1,0,1,-1,1,-1
KR_6754444949,420,-2,-21,10,-5,0,1,1,-1,2,1,-5,6,1,3,1,4,-2,3,1,0,-2,-37,1,-7,6,-5,0,-1,1,-1,-1,1,5,-1
KR_6752463737,420,2,6,-31,2,0,3,3,2,5,7,-1,3,2,1,4,5,0,2,2,0,6,69,-7,-3,10,4,0,-2,-1,-1,-1,-1,4,-1
KR_6763649581,420,-2,-113,-1,-7,3,2,5,-1,4,3,-7,7,0,-1,6,5,-1,1,0,0,-3,-7,-4,-4,8,-1,0,-2,-1,1,-1,-1,6,-1
KR_6761079902,420,0,-111,-23,4,-1,2,1,4,3,7,1,1,2,0,2,2,0,1,1,1,7,-1,3,-7,4,1,0,-1,1,-1,-1,1,3,-1
KR_6741908983,420,-8,-1,-35,-14,-8,8,0,-3,4,1,2,0,2,-3,5,2,-2,2,0,0,-14,5,-4,-4,8,-5,0,-2,-1,-1,-1,1,5,-1
KR_6761574865,420,5,68,-3,16,0,2,2,2,3,5,3,1,4,10,0,10,1,1,2,4,22,14,1,-5,4,-2,0,1,-1,1,1,1,5,-1
KR_6609115740,420,-8,-91,-32,-14,-5,7,2,0,1,1,-3,4,1,-5,5,0,-1,1,0,0,-12,-32,3,-7,4,15,0,-2,1,-1,-1,1,3,-1
KR_6745156862,420,-1,-57,6,-4,-1,2,1,-6,9,3,-2,2,0,1,3,4,4,0,4,0,-16,-2,-1,-8,9,6,0,-1,1,-1,-1,1,1,-1
KR_6760873105,440,1,-34,18,-3,-6,8,2,0,3,3,0,1,1,5,0,5,-2,3,1,1,0,-4,2,-5,3,-2,0,0,0,0,-1,1,0,-1
KR_6749483632,420,-2,-41,0,-1,1,0,1,-3,4,1,2,2,4,-2,4,2,1,0,1,0,-3,17,-1,-5,6,0,0,-2,1,1,-1,-1,6,-1
KR_6683616068,420,-1,7,0,-3,-1,4,3,-5,7,2,-2,5,3,2,1,3,3,0,3,0,-11,6,-1,-9,10,-3,0,1,-1,-1,1,-1,1,-1
KR_6721836928,420,-3,-59,3,-5,2,1,3,-2,5,3,1,1,2,-8,9,1,2,0,2,-1,-13,3,-6,-2,8,-2,0,-1,-1,1,-1,-1,4,-1
KR_6739885989,420,-6,-44,-28,-6,-1,5,4,-2,3,1,-3,7,4,-1,1,0,1,1,2,-1,-9,0,0,-2,2,-1,0,-1,-1,1,1,-1,6,-1
KR_6719236834,420,-5,-79,-17,-4,-1,1,0,-3,5,2,0,0,0,0,0,0,0,1,1,0,3,-41,2,-9,7,0,0,-2,-1,-1,-1,-1,6,-1
KR_6755538755,420,-1,-14,-20,-6,-2,2,0,-8,9,1,6,0,6,-2,3,1,0,1,1,0,-11,1,-2,-3,5,-1,0,-1,-1,1,-1,1,4,-1
KR_6733827654,420,0,0,-16,-3,1,2,3,-3,5,2,0,3,3,-2,5,3,1,1,2,0,6,6,5,-9,4,4,0,0,-1,-1,-1,-1,1,-1
KR_6722560117,420,-4,-68,28,-5,0,3,3,-5,6,1,-1,2,1,1,2,3,0,2,2,1,-6,7,-3,-6,9,-2,0,0,1,1,0,1,4,-1
KR_6674706081,420,-2,-25,-20,-5,1,0,1,-5,9,4,-1,1,0,-2,4,2,2,0,2,1,-10,-13,3,-10,7,-1,0,0,-1,1,0,1,3,-1
KR_6763410016,420,3,38,-9,4,2,3,5,-1,4,3,-1,4,3,0,2,2,4,1,5,0,-5,-25,-2,-3,5,1,0,1,-1,1,1,-1,4,-1
KR_6764768004,440,-2,-36,-13,5,3,2,5,-1,1,0,1,0,1,3,2,5,-1,3,2,0,4,0,5,-10,5,-2,0,1,1,1,1,-1,6,-1
KR_6740554950,420,-7,-72,-40,-17,0,3,3,-5,6,1,-1,1,0,-11,11,0,0,0,0,0,-26,-4,3,-6,3,-5,0,0,1,1,-1,-1,2,-1
KR_6761821039,420,4,54,14,8,6,0,6,1,2,3,-4,7,3,5,2,7,0,0,0,0,-2,2,-3,-5,8,3,0,0,1,0,1,1,4,-1
KR_6764957399,420,0,13,-18,-3,0,0,0,-4,7,3,-2,4,2,0,2,2,3,0,3,0,-10,20,-4,-2,6,-29,0,1,1,-1,1,-1,3,-1
KR_6749934938,420,4,35,1,8,3,0,3,-1,1,0,-3,3,0,8,2,10,1,0,1,0,10,-5,-1,-5,6,1,0,2,0,-1,1,1,0,-1
KR_6741351939,420,-2,29,-20,-5,0,1,1,-2,3,1,-2,3,1,-2,2,0,1,0,1,0,-1,25,2,-7,5,0,0,0,-1,-1,-1,1,3,-1
KR_6710949952,420,-5,-64,0,-19,-1,3,2,-4,7,3,1,3,4,-15,16,1,0,1,1,-1,-17,269,-11,-1,12,2,0,-3,1,-1,-1,1,2,-1
KR_6636306959,420,-3,-17,-27,-12,-2,2,0,1,3,4,-5,6,1,-3,4,1,-3,3,0,-1,-14,-4,-2,-5,7,0,0,-2,-1,-1,-1,-1,2,-1
KR_6637854419,420,2,-73,-23,6,-6,8,2,1,1,2,0,2,2,9,0,9,2,0,2,-1,12,-8,1,-8,7,11,0,0,-1,-1,-1,-1,6,-1
KR_6764094432,420,-2,1,0,-3,-1,1,0,-3,5,2,-1,3,2,2,1,3,0,1,1,0,-3,120,2,-4,2,-1,0,0,1,0,0,1,6,-1
KR_6675750976,440,-4,-79,20,-14,-3,3,0,-3,4,1,-1,2,1,-3,4,1,-4,7,3,0,-10,-2,-2,-6,8,1,0,0,1,1,0,-1,1,-1
KR_6755832570,420,-5,17,-29,-6,-1,1,0,-2,3,1,-4,5,1,1,0,1,0,0,0,0,-3,3,-4,-4,8,-1,0,2,-1,1,1,-1,4,-1
KR_6743971995,420,-2,-63,-32,-2,-5,7,2,2,3,5,0,1,1,0,4,4,1,1,2,-1,4,-12,1,-7,6,7,0,-2,-1,-1,-1,-1,4,-1
KR_6548101938,420,-2,-5,12,-12,0,2,2,-3,7,4,-1,2,1,-8,8,0,0,0,0,0,-23,25,0,-8,8,0,0,-2,-1,-1,-1,-1,3,-1
KR_6759516554,440,1,10,-20,3,0,1,1,5,2,7,2,0,2,-2,3,1,-2,2,0,0,-4,5,4,-6,2,-7,0,1,0,1,1,1,0,-1
KR_6758114351,420,-4,16,-24,0,-2,4,2,6,1,7,1,3,4,-4,5,1,-1,1,0,1,-1,1,6,-9,3,-2,0,1,-1,-1,1,1,4,-1
KR_6725002537,420,-2,20,16,-10,-5,5,0,-5,7,2,3,1,4,-2,6,4,-1,4,3,-1,-10,-15,-9,-4,13,7,0,0,-1,1,0,-1,1,-1
KR_6764972052,420,-2,-94,-9,-1,0,1,1,0,6,6,0,1,1,-1,1,0,0,1,1,0,3,-2,3,-9,6,-1,0,0,0,-1,-1,1,0,-1
KR_6699516954,420,-3,-35,4,-5,-3,3,0,-1,3,2,0,2,2,-2,2,0,1,0,1,0,-6,-43,1,-6,5,18,0,-1,-1,1,-1,1,3,-1
KR_6754399027,420,-4,-40,-22,-10,-1,1,0,-8,8,0,-1,1,0,0,4,4,0,1,1,-1,-8,-7,-6,-3,9,-1,0,-2,1,-1,-1,-1,4,-1
KR_6690088282,420,-2,24,-8,-3,6,0,6,-6,8,2,2,2,4,-4,6,2,-1,1,0,0,-16,218,3,-13,10,2,0,-1,-1,1,-1,1,6,-1
KR_6672180243,420,-1,-57,16,-9,0,1,1,-1,3,2,-1,1,0,-8,8,0,1,3,4,0,-15,-3,-2,-3,5,1,0,0,-1,-1,-1,-1,2,-1
KR_6687806076,420,-3,-25,31,-7,-2,2,0,2,2,4,-3,3,0,-7,7,0,3,0,3,-1,-8,3,-4,-3,7,-3,0,0,1,-1,0,-1,2,-1
KR_6763698628,420,-2,-31,4,-4,-2,3,1,-1,5,4,0,1,1,-3,5,2,2,0,2,0,-2,-2,-2,-2,4,0,0,1,1,1,1,-1,1,-1
KR_6761351546,420,-6,-98,-11,-17,-7,8,1,-3,4,1,-1,3,2,-5,5,0,-1,1,0,0,-16,-7,-2,-2,4,0,0,-2,-1,-1,-1,-1,6,-1
KR_6725798977,420,-6,-39,-12,-5,-2,2,0,0,4,4,-4,5,1,-1,4,3,2,0,2,0,-4,23,-5,-5,10,-6,0,1,-1,0,1,1,6,-1
KR_6746646937,420,1,-4,-12,-6,0,1,1,-4,5,1,0,3,3,-2,3,1,0,0,0,0,-2,47,-4,-6,10,-21,0,-1,-1,-1,-1,-1,3,-1
KR_6758195743,420,-6,-131,0,-14,-2,4,2,-1,4,3,-6,6,0,-4,5,1,-1,1,0,-1,-6,10,1,-6,5,0,0,-2,-1,1,-1,-1,6,-1
KR_6734293643,420,-5,-45,-20,-7,-4,4,0,-3,3,0,3,3,6,-2,4,2,-1,1,0,0,-2,4,-1,-5,6,0,0,1,0,-1,-1,-1,0,-1
KR_6718269367,420,-3,-24,-20,-7,1,1,2,-3,3,0,-3,6,3,0,6,6,-2,3,1,-1,-13,69,-6,-7,13,-12,0,1,-1,-1,-1,1,2,-1
KR_6762341802,420,0,-31,-16,-3,1,1,2,-3,4,1,0,0,0,0,3,3,-1,2,1,0,-2,-6,2,-4,2,-1,0,1,-1,1,1,1,6,-1
KR_6757870120,420,-1,47,6,-3,1,1,2,-1,2,1,-1,2,1,-2,5,3,0,0,0,0,0,-4,-1,-4,5,8,0,1,-1,-1,1,1,4,-1
KR_6748203112,420,-1,3,-4,1,1,3,4,3,1,4,-1,3,2,-1,4,3,-1,1,0,0,7,-9,-1,-10,11,8,0,0,1,-1,-1,-1,5,-1
KR_6718258185,420,-5,-40,16,-6,0,1,1,-3,6,3,-1,2,1,0,2,2,-2,4,2,0,-3,-160,0,-7,7,10,0,0,-1,1,-1,1,1,-1
KR_6764460843,420,2,7,-9,6,-1,1,0,6,0,6,3,3,6,-1,4,3,-1,2,1,0,6,48,-1,-4,5,0,0,1,1,1,1,1,5,-1
KR_6719654601,420,0,-12,8,-2,-3,3,0,-1,4,3,0,0,0,1,5,6,1,0,1,0,-3,-2,-3,-3,6,5,0,1,-1,-1,1,1,4,-1
KR_6763318424,440,-2,-66,-12,-5,-2,3,1,-2,2,0,-1,3,2,-4,4,0,4,0,4,0,-3,-7,-1,-5,6,2,0,0,-1,-1,-1,-1,2,-1
KR_6747061879,420,1,-71,12,2,0,2,2,3,1,4,-5,7,2,4,1,5,0,2,2,0,7,8,5,-8,3,-2,0,0,1,1,0,1,6,-1
KR_6687318233,420,2,39,-8,8,0,1,1,1,2,3,-2,4,2,11,2,13,-2,3,1,1,11,-4,4,-6,2,-1,0,1,1,1,1,-1,4,-1
KR_6763236833,420,1,53,15,2,-1,1,0,-1,6,5,5,0,5,-1,4,3,0,2,2,0,-9,3,-1,-5,6,0,0,2,-1,-1,1,1,3,-1
KR_6748588763,420,-1,8,11,3,1,5,6,-4,4,0,4,0,4,2,2,4,0,0,0,0,4,-17,-2,-3,5,5,0,1,1,1,1,-1,2,-1
KR_6753099413,420,3,-33,24,4,-2,2,0,3,0,3,3,1,4,0,3,3,0,0,0,0,5,1,-3,-3,6,-3,0,0,0,-1,-1,-1,0,-1
KR_6762556189,420,1,3,-20,-2,0,2,2,1,4,5,2,2,4,-3,4,1,-2,2,0,-3,-11,5,4,-7,3,-1,0,-1,-1,0,-1,1,5,-1
KR_6721027446,440,0,4,6,-1,2,0,2,-4,4,0,2,0,2,-2,3,1,1,0,1,0,-4,6,-3,-4,7,-1,0,-1,1,-1,-1,-1,4,-1
KR_6657658509,420,3,20,45,4,0,3,3,-1,3,2,1,3,4,3,4,7,1,1,2,1,-1,4,2,-7,5,-3,0,-1,1,-1,-1,1,1,-1
KR_6683146309,420,-1,35,-20,-1,1,1,2,-5,6,1,2,0,2,2,2,4,-1,1,0,0,-1,1,3,-6,3,0,0,0,0,-1,0,1,0,-1
KR_6695212667,420,-3,22,31,-11,0,1,1,-6,9,3,-1,2,1,-2,2,0,-2,3,1,-2,-26,1,0,-7,7,-3,0,0,-1,0,0,-1,1,-1
KR_6699903970,420,-8,-103,-3,-16,-3,4,1,-3,4,1,-3,3,0,-4,5,1,-3,3,0,0,-15,3,0,-6,6,-6,0,0,-1,1,-1,-1,5,-1
KR_6757618867,420,-4,3,-6,-5,0,2,2,0,4,4,0,1,1,-4,7,3,-1,1,0,0,-8,23,4,-8,4,-1,0,-2,-1,-1,-1,-1,3,-1
KR_6762537273,420,0,-6,17,-4,-3,4,1,-1,2,1,-1,4,3,3,3,6,-2,2,0,-1,-7,0,0,-2,2,0,0,-1,-1,-1,-1,-1,1,-1
KR_6683544057,420,-3,-32,-28,-3,-5,5,0,4,2,6,0,1,1,-2,3,1,0,0,0,-1,2,3,0,-8,8,-7,0,0,-1,-1,-1,-1,3,-1
KR_6753869881,420,1,-111,-29,0,-2,4,2,-1,1,0,3,2,5,0,2,2,0,1,1,0,-7,-131,-3,-5,8,5,0,-2,-1,-1,-1,1,6,-1
KR_6761276692,420,-4,29,0,-13,2,0,2,-5,5,0,1,1,2,-7,9,2,-4,4,0,-3,-18,-31,-3,-4,7,4,0,0,-1,1,0,-1,2,-1
KR_6761933036,420,-2,-42,-2,-8,-1,2,1,-2,3,1,-2,2,0,-4,7,3,1,2,3,0,-8,-8,-2,-3,5,4,0,-1,-1,0,-1,-1,6,-1
KR_6699910069,420,0,38,24,-6,-4,4,0,-3,4,1,0,3,3,1,1,2,0,0,0,0,-9,-21,1,-6,5,-4,0,1,1,-1,1,-1,1,-1
KR_6750977295,420,-4,-76,3,-14,-8,8,0,-4,6,2,-3,3,0,-1,1,0,2,1,3,0,-16,-6,-4,-5,9,-2,0,-2,-1,1,-1,-1,6,-1
KR_6681963808,420,-3,-77,17,-7,3,1,4,-3,5,2,-6,6,0,-1,1,0,0,2,2,1,-4,6,-7,0,7,-3,0,0,-1,1,-1,1,3,-1
KR_6750083396,420,-2,-68,4,-6,-2,3,1,2,2,4,-3,3,0,-4,6,2,1,0,1,0,-4,106,0,-6,6,5,0,0,-1,1,0,-1,1,-1
KR_6761341990,440,0,17,0,6,2,0,2,4,0,4,4,1,5,-1,3,2,-3,3,0,0,10,-2,0,-5,5,4,0,-1,1,-1,-1,1,5,-1
KR_6744711896,420,2,21,3,4,1,0,1,1,1,2,3,2,5,-1,4,3,0,1,1,1,11,3,1,-7,6,3,0,1,-1,1,1,1,3,-1
KR_6763915639,420,3,46,-8,1,3,0,3,0,3,3,-2,5,3,-1,3,2,1,0,1,-1,-9,6,-1,-6,7,-4,0,1,1,1,1,-1,5,-1
KR_6660654737,420,4,37,7,3,3,1,4,2,3,5,3,1,4,-3,4,1,-2,3,1,0,2,-1,3,-9,6,2,0,0,-1,-1,0,-1,6,-1
KR_6761182006,420,-3,-32,-4,-4,3,2,5,1,3,4,-4,4,0,-4,5,1,0,0,0,-1,-9,-2,-4,-4,8,5,0,-2,-1,-1,-1,1,6,-1
KR_6755996081,420,-1,50,23,-3,2,2,4,0,2,2,-1,3,2,-2,4,2,-2,2,0,-1,-5,-5,-6,-4,10,8,0,1,1,1,1,-1,4,-1
KR_6738970668,420,-3,3,-15,-3,-8,8,0,1,3,4,2,1,3,2,0,2,0,1,1,0,9,162,-1,-4,5,6,0,-1,-1,-1,-1,1,4,-1
KR_6762055614,420,0,17,-4,-2,1,1,2,-2,4,2,-4,6,2,1,1,2,2,1,3,0,4,-10,4,-8,4,-4,0,0,1,-1,1,-1,4,-1
KR_6700766304,420,0,-51,7,-2,0,2,2,5,1,6,-1,2,1,-4,4,0,-2,3,1,-1,-1,-103,4,-9,5,-1,0,-2,-1,-1,-1,-1,3,-1
KR_6764828986,420,-2,3,-12,-6,2,1,3,-5,6,1,2,1,3,-4,4,0,-1,1,0,0,-7,3,1,-6,5,-1,0,-1,-1,-1,-1,1,3,-1
KR_6761242400,420,5,-1,12,0,1,2,3,2,3,5,-5,5,0,0,1,1,2,0,2,0,-2,20,2,-4,2,5,0,0,1,-1,-1,-1,1,-1
KR_6616323536,420,-4,-48,20,-4,-5,6,1,5,0,5,-4,5,1,1,1,2,-1,2,1,0,-2,7,5,-9,4,-1,0,0,1,-1,-1,1,6,-1
KR_6691019540,420,-7,-73,-7,-17,-3,5,2,-3,5,2,0,1,1,-9,9,0,-2,2,0,0,-16,-4,-2,-6,8,0,0,-1,-1,1,-1,1,2,-1
KR_6721756726,420,-2,1,-12,-2,-1,1,0,0,3,3,2,1,3,0,1,1,-3,4,1,0,1,-25,0,-3,3,-3,0,-1,-1,-1,-1,1,2,-1
KR_6764114674,420,1,53,12,-3,-7,7,0,-1,1,0,2,2,4,1,1,2,2,0,2,-1,0,-20,1,-4,3,4,0,-2,1,-1,-1,-1,1,-1
KR_6518356514,420,1,16,-12,2,-1,2,1,-1,3,2,7,1,8,-1,2,1,-2,2,0,0,1,12,4,-8,4,-6,0,0,-1,1,1,1,6,-1
KR_6761486310,420,-1,43,-16,1,2,0,2,-5,10,5,0,2,2,3,3,6,1,1,2,2,7,-6,-3,-3,6,2,0,-1,1,-1,-1,1,1,-1
KR_6745503561,420,0,-22,-32,-5,-4,4,0,-4,4,0,-2,3,1,6,0,6,-1,4,3,0,2,-28,-1,-4,5,-1,0,0,1,-1,-1,1,6,-1
KR_6720756585,420,2,6,36,2,-4,5,1,-3,4,1,5,2,7,4,0,4,0,1,1,0,5,-13,-3,-5,8,3,0,0,1,0,0,1,1,-1
KR_6634541530,420,3,31,-2,9,2,2,4,5,0,5,-3,3,0,1,5,6,4,1,5,0,5,-200,3,-6,3,2,0,-1,-1,-1,1,1,4,-1
KR_6619841317,420,-4,-21,-36,-8,-2,4,2,0,3,3,-4,6,2,-2,6,4,0,0,0,-2,-2,-6,-6,-4,10,-3,0,0,-1,-1,-1,-1,5,-1
KR_6750341841,420,0,-42,-34,0,5,0,5,-2,5,3,-8,8,0,7,0,7,-2,2,0,-1,6,4,4,-5,1,-5,0,-1,-1,-1,-1,-1,2,-1
KR_6752428265,420,0,8,28,-3,-6,6,0,-1,4,3,-1,2,1,3,0,3,2,0,2,0,-2,-18,-4,-2,6,2,0,0,1,1,0,-1,1,-1
KR_6722072131,420,-1,-24,-4,0,-4,4,0,0,0,0,1,4,5,3,0,3,0,0,0,0,0,4,1,-5,4,3,0,0,1,1,-1,1,2,-1
KR_6764048067,420,-3,-27,-24,-8,-4,4,0,-4,5,1,1,1,2,1,0,1,-2,2,0,0,-12,4,-3,-4,7,-1,0,0,-1,-1,0,1,4,-1
KR_6655966095,420,2,30,11,5,3,0,3,7,1,8,-6,6,0,2,1,3,-1,1,0,0,7,-3,0,-7,7,-4,0,1,1,1,1,1,5,-1
KR_6651819620,420,-6,-21,-24,-17,-3,3,0,-4,5,1,-5,5,0,-2,2,0,-3,3,0,0,-24,-4,0,-6,6,5,0,-2,-1,1,-1,-1,6,-1
KR_6675509886,420,-6,-81,-20,-12,-2,3,1,-3,4,1,-5,5,0,-3,4,1,1,0,1,0,-9,16,2,-7,5,5,0,-1,1,-1,-1,1,1,-1
KR_6742291040,420,-3,27,3,-5,2,0,2,0,0,0,-1,2,1,-2,2,0,-4,4,0,0,-12,-7,-3,-4,7,-2,0,-1,-1,1,1,-1,1,-1
KR_6760401959,440,2,34,-4,-1,2,1,3,2,2,4,-3,4,1,0,2,2,-2,2,0,0,0,-70,3,-7,4,22,0,1,-1,1,1,-1,1,-1
KR_6600258688,420,-1,-24,16,-2,2,1,3,-4,5,1,1,1,2,-1,4,3,0,1,1,1,2,3,2,-6,4,-1,0,0,-1,1,0,1,4,-1
KR_6609912556,420,-3,-28,-11,-2,0,2,2,0,6,6,2,1,3,-4,6,2,0,0,0,0,-4,-30,1,-6,5,0,0,1,-1,0,1,-1,5,-1
KR_6628544173,420,-2,21,-16,0,4,0,4,0,1,1,-4,5,1,-1,3,2,1,0,1,0,-3,-4,3,-5,2,0,0,0,-1,1,0,-1,3,-1
KR_6763208632,420,-5,-119,16,-20,-4,4,0,-5,8,3,-3,4,1,-7,7,0,-1,2,1,-4,-24,23,-1,-5,6,-6,0,-1,1,1,-1,-1,5,-1
KR_6723997815,420,-1,-93,44,-7,1,0,1,-2,2,0,-3,3,0,-3,4,1,0,1,1,1,-5,-104,-3,-4,7,0,0,0,-1,1,0,1,6,-1
KR_6732812400,440,-5,-32,-19,-12,-1,2,1,-4,4,0,-5,5,0,3,1,4,-5,6,1,0,-12,11,0,-2,2,-1,0,0,-1,1,0,-1,1,-1
KR_6764780548,420,-2,-57,-10,-8,-1,2,1,-5,6,1,-1,1,0,1,1,2,-2,2,0,-1,-12,15,-7,-4,11,0,0,-1,-1,1,-1,-1,3,-1
KR_6752553955,440,-10,-37,-56,-17,-6,7,1,-7,7,0,-1,3,2,-2,5,3,-1,2,1,0,-14,29,3,-9,6,-2,0,-3,-1,-1,-1,1,6,-1
KR_6753995743,420,1,39,8,-1,0,1,1,-3,3,0,2,0,2,1,2,3,-1,3,2,-1,-3,1,4,-8,4,5,0,0,1,-1,0,-1,4,-1
KR_6764526351,420,0,14,9,-2,1,0,1,2,0,2,-4,4,0,0,0,0,-1,1,0,0,2,-23,-2,-3,5,2,0,0,1,0,0,-1,6,-1
KR_6744571845,420,0,22,16,4,-4,5,1,4,1,5,3,3,6,2,3,5,-1,1,0,1,13,-3,-1,-2,3,2,0,0,1,1,0,1,5,-1
KR_6719774224,420,-3,-8,-24,-9,-2,3,1,-4,5,1,-2,3,1,-4,6,2,3,2,5,0,-13,-1,-5,-4,9,-4,0,0,-1,-1,-1,1,3,-1
KR_6744105717,440,-2,32,-20,-5,2,1,3,3,2,5,0,2,2,-10,11,1,0,0,0,-2,-18,231,0,-3,3,-1,0,-1,0,-1,-1,-1,0,-1
KR_6762650344,420,0,-27,-31,4,-2,5,3,0,5,5,0,2,2,4,1,5,2,0,2,0,11,10,5,-9,4,1,0,-1,0,-1,-1,1,0,-1
KR_6686049799,420,2,51,-20,4,-1,1,0,-1,7,6,2,0,2,5,1,6,-1,1,0,0,1,26,-2,-6,8,1,0,0,1,-1,1,1,1,-1
KR_6745238242,420,-4,-46,-12,-7,3,0,3,1,1,2,-9,10,1,-1,2,1,-1,2,1,0,-5,8,-1,-4,5,-5,0,-1,-1,-1,-1,-1,5,-1
KR_6760488641,420,2,50,-4,3,3,1,4,0,3,3,0,3,3,0,2,2,0,1,1,0,5,1,-2,-2,4,0,0,0,-1,-1,0,1,4,-1
KR_6676431019,420,-3,-12,-18,0,6,2,8,-2,3,1,-1,2,1,-3,5,2,0,1,1,1,-5,2,0,-4,4,-3,0,1,1,-1,1,1,5,-1
KR_6689795245,420,2,-28,0,8,1,2,3,5,0,5,2,2,4,-1,2,1,1,2,3,0,1,2,3,-8,5,5,0,0,0,1,0,-1,0,-1
KR_6763092189,420,1,40,8,3,6,0,6,-2,2,0,-2,4,2,0,3,3,1,2,3,1,-5,55,5,-9,4,-30,0,1,-1,-1,1,1,1,-1
KR_6678551017,420,-1,-41,-11,-2,1,1,2,0,5,5,-4,5,1,-1,4,3,2,1,3,1,8,11,4,-11,7,-4,0,1,-1,1,1,1,4,-1
KR_6630380305,420,-4,21,-16,-8,-3,3,0,1,2,3,-5,5,0,1,1,2,-2,3,1,-1,-8,-29,-1,-3,4,4,0,-1,-1,-1,-1,-1,6,-1
KR_6765317786,420,2,18,-4,-2,0,2,2,-3,6,3,-1,2,1,1,4,5,1,1,2,0,-4,34,2,-5,3,-1,0,-2,-1,-1,-1,-1,5,-1
KR_6743665146,420,0,8,0,4,4,0,4,-3,7,4,2,1,3,2,0,2,-1,2,1,0,1,-4,1,-3,2,4,0,0,-1,-1,0,1,3,-1
KR_6757599548,440,-3,-109,2,-2,-1,1,0,-1,1,0,-1,2,1,1,4,5,0,0,0,0,-3,-45,-1,-4,5,23,0,-1,-1,0,-1,1,3,-1
KR_6764433287,420,-2,-55,15,-1,-2,6,4,-2,4,2,-3,6,3,6,3,9,0,0,0,0,6,0,-3,-5,8,-4,0,-1,1,-1,-1,1,6,-1
KR_6755324424,420,-5,-18,-18,-5,-1,3,2,-1,2,1,-4,7,3,0,4,4,1,1,2,2,0,1,4,-7,3,-3,0,-1,-1,1,-1,1,5,-1
KR_6744214190,440,-3,-111,-36,-8,-1,1,0,-6,7,1,-2,3,1,4,0,4,-3,4,1,-1,-6,11,8,-13,5,-4,0,-1,1,-1,-1,-1,3,-1
KR_6699770813,420,0,5,16,-4,-1,2,1,-1,4,3,1,1,2,0,3,3,-3,3,0,0,-3,43,5,-7,2,-17,0,0,1,1,-1,-1,3,-1
KR_6756964361,440,-4,-32,-12,-9,-1,2,1,1,3,4,-3,5,2,-7,9,2,1,2,3,-1,-19,-8,-2,-2,4,-1,0,-1,-1,-1,-1,-1,5,-1
KR_6754340950,420,-2,20,9,-5,1,0,1,-5,7,2,1,1,2,-1,2,1,-1,3,2,0,-9,39,-1,-5,6,1,0,0,-1,1,0,-1,5,-1
KR_6764088425,420,-2,-82,0,-4,3,2,5,-1,2,1,0,5,5,-5,7,2,-1,2,1,0,-9,-15,0,-5,5,-4,0,-2,-1,-1,-1,-1,1,-1
KR_6762023605,420,-5,-46,-30,-2,3,0,3,-2,4,2,0,0,0,0,2,2,-3,3,0,0,-5,2,-2,-3,5,-6,0,0,-1,-1,-1,-1,5,-1
KR_6759604370,420,-1,-52,-4,-2,-2,2,0,1,1,2,-1,1,0,0,1,1,0,0,0,0,1,7,-4,-4,8,0,0,0,1,-1,0,-1,3,-1
KR_6743078561,420,-7,-64,-24,-14,-3,3,0,-4,4,0,0,6,6,-1,5,4,-6,6,0,0,-12,9,0,-8,8,-3,0,-1,-1,-1,-1,1,6,-1
KR_6764000382,420,2,-42,-5,-6,1,4,5,-2,4,2,-2,4,2,-3,5,2,0,0,0,-2,-14,4,-5,-3,8,2,0,0,1,-1,-1,1,2,-1
KR_6728680632,440,0,10,1,0,-4,4,0,2,2,4,5,1,6,-2,2,0,-1,1,0,0,1,-1,-1,-6,7,-1,0,-2,1,-1,-1,1,2,-1
KR_6738792922,420,4,66,24,7,-1,2,1,7,1,8,0,1,1,0,2,2,1,2,3,0,13,-9,-6,-2,8,9,0,0,-1,-1,-1,-1,4,-1
KR_6605007948,420,0,27,32,-1,4,0,4,-1,4,3,0,1,1,-4,5,1,0,1,1,0,-2,-7,3,-9,6,-2,0,0,1,1,1,-1,3,-1
KR_6562052670,420,-2,-16,25,-1,4,2,6,-2,3,1,1,3,4,-5,5,0,1,0,1,0,2,-3,-7,-4,11,7,0,0,1,1,0,-1,5,-1
KR_6685013647,420,3,10,12,6,0,1,1,1,0,1,2,2,4,4,1,5,-1,1,0,0,8,-6,-2,-3,5,1,0,0,-1,1,0,-1,5,-1
KR_6762863483,420,-1,-18,19,-8,0,1,1,-1,2,1,-7,9,2,-3,4,1,3,0,3,0,-2,-4,0,-4,4,-5,0,-1,1,-1,-1,-1,4,-1
KR_6751584312,420,0,22,-12,-9,0,1,1,-8,9,1,-1,4,3,0,4,4,0,0,0,-1,-15,-4,-3,-5,8,-1,0,0,-1,1,0,-1,6,-1
KR_6753683757,420,0,17,20,3,-3,3,0,-1,1,0,2,1,3,2,0,2,3,0,3,0,-1,1,-6,-2,8,-3,0,1,1,-1,1,1,1,-1
KR_6765455880,420,-3,15,0,-4,0,0,0,-1,4,3,-1,1,0,-1,2,1,-1,2,1,0,-2,9,2,-11,9,-2,0,0,1,1,0,-1,6,-1
KR_6650354821,420,-1,1,-4,-3,4,2,6,-5,6,1,1,0,1,-3,5,2,0,0,0,0,-7,-3,-1,-6,7,-2,0,1,-1,1,1,-1,3,-1
KR_6761293208,420,0,-41,4,3,0,0,0,3,3,6,1,0,1,-1,1,0,0,0,0,0,1,2,0,-3,3,1,0,-1,1,-1,-1,1,4,-1
KR_6744677711,420,-5,-55,-44,-7,-1,2,1,-2,2,0,-2,3,1,-1,3,2,-1,2,1,0,-3,10,-4,-4,8,-4,0,0,-1,-1,0,1,4,-1
KR_6746400989,420,0,74,20,-7,-2,2,0,0,2,2,-3,6,3,-1,1,0,-1,2,1,0,-6,-6,1,-6,5,-2,0,-1,1,-1,-1,-1,6,-1
KR_6642976179,420,-1,-37,-9,-4,-1,1,0,-1,5,4,-2,5,3,1,1,2,-1,1,0,0,-9,119,-1,-4,5,4,0,-1,1,-1,-1,-1,2,-1
KR_6752532933,420,1,8,8,9,-2,2,0,10,0,10,-1,3,2,1,3,4,1,0,1,0,9,-105,1,-4,3,-6,0,0,1,1,1,1,4,-1
KR_6760216462,420,-3,-84,2,-1,0,0,0,-4,4,0,5,0,5,-1,4,3,-1,1,0,0,-4,-4,3,-6,3,1,0,0,1,0,0,-1,6,-1
KR_6763200887,420,2,87,14,-3,2,0,2,-1,2,1,-4,4,0,0,2,2,0,0,0,0,-5,-47,-1,-4,5,-4,0,0,0,1,0,1,0,-1
KR_6763796933,420,-5,-52,-56,-13,-2,2,0,-3,3,0,-4,4,0,-2,3,1,-2,2,0,-1,-13,1,-6,-2,8,0,0,-4,-1,-1,-1,-1,2,-1
KR_6729012696,420,-1,26,15,-3,1,2,3,0,1,1,-5,7,2,1,4,5,0,1,1,0,-3,12,-1,-3,4,-2,0,1,1,1,1,1,6,-1
KR_6763848687,420,-3,-72,2,-4,2,0,2,2,1,3,-2,2,0,-5,5,0,-1,2,1,-1,-6,-11,-4,-5,9,2,0,0,1,1,-1,-1,6,-1
KR_6765251588,420,-4,-14,-9,-8,-1,1,0,-3,5,2,0,2,2,-6,8,2,2,1,3,0,-8,5,6,-8,2,4,0,-1,-1,-1,-1,1,2,-1
KR_6397789200,440,-5,-106,-35,-14,-4,4,0,-1,2,1,-9,11,2,-2,2,0,2,0,2,0,-9,235,-3,-1,4,3,0,-3,-1,-1,-1,-1,2,-1
KR_6734067739,440,2,32,-8,4,0,2,2,1,6,7,1,4,5,0,6,6,2,0,2,2,0,-15,0,-7,7,2,0,2,-1,1,1,1,1,-1
KR_6757872354,420,-2,-23,-12,1,0,1,1,5,1,6,0,3,3,-5,6,1,1,0,1,0,-1,0,-1,-4,5,-3,0,0,-1,-1,0,-1,3,-1
KR_6760008487,420,-1,-30,-12,-2,-4,5,1,0,4,4,2,0,2,0,4,4,0,0,0,0,0,5,-2,-3,5,-1,0,-1,-1,-1,-1,1,1,-1
KR_6730445551,440,-4,-55,-17,-8,1,1,2,-1,2,1,0,0,0,-9,10,1,1,0,1,0,-9,-25,-3,-1,4,-1,0,-1,-1,-1,-1,1,1,-1
KR_5748100176,420,-4,1,-18,-6,-4,4,0,-1,3,2,-1,2,1,5,0,5,-5,5,0,1,0,-3,-4,-8,12,0,0,-1,1,-1,-1,1,4,-1
KR_6761949800,420,-4,14,8,-14,0,2,2,-4,5,1,-7,9,2,-3,8,5,0,1,1,1,-7,-97,3,-9,6,-5,0,0,1,-1,0,1,1,-1
KR_6759337960,420,-2,-8,14,-5,-1,1,0,-4,5,1,-2,4,2,2,0,2,0,0,0,0,-2,-23,-2,-4,6,4,0,-1,1,-1,-1,-1,4,-1
KR_6763742512,420,-7,-2,-28,-17,1,1,2,-1,2,1,-9,10,1,-6,7,1,-2,2,0,0,-24,-4,4,-7,3,-2,0,0,-1,-1,-1,-1,4,-1
KR_6749040546,420,-4,-77,9,-13,-2,3,1,-4,5,1,0,2,2,-2,2,0,-5,5,0,0,-20,-29,-6,-3,9,1,0,-3,-1,-1,-1,-1,6,-1
KR_6671435246,420,1,-22,4,-3,1,0,1,3,3,6,-3,3,0,-5,9,4,1,1,2,1,4,5,-4,-3,7,4,0,-2,-1,-1,-1,1,4,-1
KR_6392375944,420,1,-14,4,3,4,1,5,-2,2,0,3,1,4,-1,2,1,-1,2,1,0,-1,7,1,-5,4,-7,0,0,-1,1,0,1,3,-1
KR_6752754905,420,3,25,29,-2,-2,2,0,-3,4,1,6,0,6,-3,5,2,0,1,1,0,-13,-195,1,-7,6,-7,0,1,-1,1,1,1,2,-1
KR_6762051154,420,-6,-70,-8,-6,-2,2,0,-1,5,4,2,2,4,-2,4,2,-3,3,0,0,-1,-14,-4,-1,5,0,0,-3,-1,1,-1,1,3,-1
KR_6761154663,420,3,17,29,4,-1,3,2,5,2,7,6,4,10,-5,6,1,-1,2,1,1,1,-3,-1,-3,4,-1,0,1,1,1,1,1,2,-1
KR_6763770387,420,-3,-23,-12,-4,-1,2,1,0,4,4,1,2,3,-2,6,4,-2,2,0,0,0,19,-5,-4,9,-5,0,0,1,-1,1,-1,4,-1
KR_6730488807,420,-1,-20,-12,-4,-4,6,2,0,2,2,-2,5,3,-1,5,4,3,0,3,0,-1,-1,4,-8,4,1,0,-2,-1,-1,-1,-1,4,-1
KR_6645560789,420,-4,-51,-4,-9,-1,3,2,2,4,6,-4,4,0,-5,6,1,-1,1,0,0,-10,94,-1,-4,5,-3,0,-1,1,1,-1,-1,6,-1
KR_6705907698,420,-7,-64,-40,-15,0,2,2,-8,8,0,-4,4,0,-2,4,2,-1,1,0,0,-19,-9,-5,-2,7,0,0,-3,-1,-1,-1,-1,3,-1
KR_6757124550,420,-3,-39,-10,-12,-3,5,2,1,2,3,-6,6,0,-1,2,1,-3,3,0,0,-14,3,-4,-4,8,-5,0,-1,-1,-1,-1,-1,2,-1
KR_6696386228,420,3,41,4,3,5,0,5,-2,2,0,-1,2,1,3,2,5,-2,2,0,0,-2,-10,-5,-2,7,0,0,-1,-1,-1,-1,-1,2,-1
KR_6750767859,420,0,-42,-8,0,0,3,3,-5,6,1,2,2,4,1,2,3,2,0,2,0,0,-3,-4,-6,10,1,0,0,1,-1,0,-1,4,-1
KR_6748709395,420,1,6,3,9,1,0,1,3,0,3,0,2,2,5,2,7,0,1,1,1,14,-2,-1,-3,4,8,0,0,1,0,0,1,1,-1
KR_6689986692,440,-3,-58,-47,-4,-2,4,2,3,1,4,-2,3,1,-1,3,2,-2,3,1,0,4,-19,3,-5,2,-1,0,-1,1,0,-1,1,6,-1
KR_6739226455,420,-5,-103,-20,-12,-2,3,1,-10,12,2,-1,3,2,0,2,2,1,0,1,0,-11,-26,-2,-3,5,1,0,-1,-1,-1,-1,1,2,-1
KR_6762584240,420,-4,-28,-4,-5,-1,3,2,-6,8,2,2,3,5,1,2,3,-1,1,0,-3,-12,3,4,-10,6,-1,0,-1,0,-1,-1,-1,0,-1
KR_6732896476,420,-3,-41,-17,-9,1,3,4,1,3,4,-7,7,0,-3,5,2,-1,1,0,-2,-4,4,0,-5,5,0,0,0,-1,-1,1,-1,4,-1
KR_6749976524,420,0,19,24,-3,-8,8,0,2,0,2,1,1,2,3,4,7,-1,1,0,1,-1,16,3,-7,4,5,0,1,1,1,1,1,4,-1
KR_6701373075,420,0,-38,-10,3,-1,2,1,3,0,3,-1,4,3,0,2,2,2,0,2,0,7,-24,-4,-3,7,-2,0,-1,-1,-1,-1,-1,4,-1
KR_6745821326,420,-2,-47,-19,-5,-4,5,1,-1,3,2,3,2,5,-2,4,2,-1,2,1,0,4,-1,-1,-2,3,0,0,-2,-1,1,-1,1,2,-1
KR_6735766174,420,-3,-21,-2,-7,0,3,3,0,2,2,-1,1,0,-1,3,2,-5,5,0,0,-4,-7,-1,-4,5,-3,0,0,1,-1,0,-1,1,-1
KR_6738411807,420,1,-15,6,-4,-2,3,1,-1,2,1,4,1,5,-5,6,1,0,0,0,-1,-2,6,1,-3,2,0,0,-1,-1,1,-1,-1,4,-1
KR_6762522180,420,2,57,19,-9,-2,2,0,-1,2,1,-5,5,0,-1,3,2,0,1,1,0,-17,4,-5,-5,10,1,0,0,1,1,1,1,2,-1
KR_6546133190,420,1,42,20,1,1,1,2,3,0,3,0,2,2,-3,3,0,0,0,0,1,3,-11,-5,-1,6,0,0,0,-1,-1,-1,1,2,-1
KR_6615852570,420,-2,-63,-17,-12,-6,6,0,2,6,8,-2,3,1,-5,6,1,-1,2,1,0,-7,23,3,-6,3,-2,0,-1,-1,-1,-1,-1,5,-1
KR_6761114730,420,-3,7,-13,-6,-1,1,0,-2,3,1,-3,5,2,0,1,1,0,0,0,0,-4,-8,-2,-4,6,2,0,0,-1,-1,-1,1,3,-1
KR_6751360958,420,-4,-83,-35,-3,-1,3,2,-2,2,0,-2,2,0,1,0,1,1,1,2,0,-5,-1,1,-4,3,-3,0,0,-1,-1,0,-1,3,-1
KR_6555563592,440,1,55,4,-5,2,2,4,-2,4,2,0,2,2,-3,4,1,-2,4,2,0,-15,5,-2,-1,3,-2,0,-1,-1,-1,-1,-1,3,-1
KR_6733427486,420,-3,1,-37,-13,1,2,3,2,0,2,-4,4,0,-4,7,3,-8,9,1,0,-15,-20,-4,-2,6,-2,0,-1,-1,-1,-1,-1,2,-1
KR_6713441708,420,-7,-57,-26,-13,0,1,1,-2,2,0,-3,3,0,-7,8,1,-1,2,1,0,-11,-8,-1,-2,3,2,0,-2,-1,-1,-1,-1,5,-1
KR_6617541902,420,0,35,22,-4,2,1,3,2,2,4,-9,9,0,1,1,2,0,0,0,-1,-7,0,-1,-7,8,-10,0,0,-1,-1,0,-1,1,-1
KR_6634387240,420,-1,-24,0,-3,-1,2,1,-4,5,1,2,2,4,-1,3,2,1,1,2,0,-2,4,-5,-3,8,3,0,0,-1,-1,0,1,3,-1
KR_6650814464,420,-1,52,-15,-6,0,2,2,-2,3,1,4,0,4,-3,4,1,-5,5,0,0,-20,-5,0,-6,6,-5,0,0,0,-1,-1,-1,0,-1
KR_6634048033,420,0,10,-28,1,-2,3,1,1,6,7,4,1,5,-1,2,1,-1,2,1,0,4,25,2,-5,3,-2,0,0,-1,1,1,-1,3,-1
KR_6761452555,420,1,-30,16,0,0,2,2,-6,6,0,5,1,6,-1,5,4,2,1,3,0,1,4,3,-6,3,-2,0,-1,0,-1,-1,-1,0,-1
KR_6762198124,420,-2,-28,1,4,-2,3,1,-3,7,4,2,3,5,5,1,6,2,2,4,0,7,15,0,-4,4,-1,0,0,-1,-1,-1,-1,6,-1
KR_6699201706,420,-2,-58,0,-12,0,1,1,-8,8,0,-1,1,0,-3,3,0,0,0,0,0,-11,104,-2,-3,5,-2,0,-2,1,-1,-1,-1,1,-1
KR_6698258898,420,4,62,8,1,2,0,2,-1,7,6,0,2,2,0,1,1,0,0,0,0,1,15,7,-7,0,-4,0,1,-1,1,1,-1,4,-1
KR_6642778290,420,-1,-17,12,-1,0,2,2,-7,7,0,3,0,3,3,0,3,0,0,0,0,-5,-31,2,-5,3,0,0,0,1,1,0,1,4,-1
KR_6762755894,420,-10,-73,-44,-18,-3,3,0,1,1,2,-11,13,2,-5,5,0,0,0,0,0,-7,-163,0,-5,5,-2,0,-4,-1,-1,-1,-1,6,-1
KR_6737794687,420,-1,-1,4,-3,-4,6,2,0,2,2,2,0,2,-1,3,2,0,2,2,-1,0,5,-1,-7,8,-4,0,0,1,1,0,-1,3,-1
KR_6619680317,420,-5,-33,-9,-13,0,2,2,-1,1,0,-2,3,1,-6,6,0,-4,5,1,0,-17,-1,1,-8,7,-5,0,-1,-1,-1,-1,-1,6,-1
KR_6701834251,420,-3,-43,-26,-1,-1,1,0,-2,4,2,0,4,4,1,6,7,1,0,1,0,-3,4,1,-5,4,0,0,-1,0,0,-1,-1,0,-1
KR_6678093244,420,4,7,20,6,-1,3,2,3,1,4,2,1,3,2,3,5,0,0,0,0,9,-3,-6,-4,10,3,0,0,-1,1,0,-1,4,-1
KR_6743696851,420,-1,15,15,-8,0,1,1,0,3,3,-2,3,1,-7,8,1,1,1,2,0,-7,-324,-3,-1,4,-3,0,-1,1,-1,-1,1,3,-1
KR_6764942176,440,-1,30,9,8,1,2,3,2,2,4,3,2,5,2,1,3,0,4,4,0,13,-10,-1,-2,3,0,0,0,0,1,1,1,0,-1
KR_6687437972,420,-2,-24,-32,-7,1,2,3,-5,5,0,1,5,6,-1,3,2,-3,3,0,-1,-10,-6,-1,-4,5,-1,0,-1,1,-1,-1,-1,3,-1
KR_6523072856,420,6,-33,-20,9,4,1,5,6,2,8,-2,3,1,1,2,3,0,1,1,-2,0,-47,-1,-3,4,20,0,1,0,-1,1,-1,0,-1
KR_6070527382,420,-2,36,-19,-1,1,2,3,-2,4,2,-2,4,2,0,1,1,2,1,3,0,-5,1,2,-9,7,-3,0,0,-1,1,1,1,1,-1
KR_6696932514,420,4,5,25,7,3,1,4,-1,5,4,3,0,3,0,1,1,2,2,4,0,12,-3,0,-6,6,-3,0,0,1,0,0,-1,2,-1
KR_6761409794,420,0,-29,18,-5,-4,4,0,3,4,7,-3,4,1,1,2,3,-2,3,1,-2,-12,318,7,-9,2,-4,0,-1,-1,-1,-1,-1,2,-1
KR_6760129260,420,1,33,-10,-4,2,1,3,0,2,2,0,1,1,-5,8,3,-1,1,0,0,-5,-3,0,-3,3,4,0,-1,-1,-1,-1,1,3,-1
KR_6718031537,420,0,31,14,-1,-1,6,5,-1,4,3,1,3,4,1,2,3,-1,3,2,0,-12,-5,2,-6,4,-5,0,1,-1,1,1,1,4,-1
KR_6572656982,420,-2,13,-1,3,-1,3,2,-2,4,2,3,1,4,2,5,7,1,0,1,0,3,-232,2,-4,2,-1,0,-1,-1,-1,-1,1,3,-1
KR_6536863093,420,-5,-73,-29,-11,-2,3,1,1,1,2,-4,5,1,-4,7,3,-2,3,1,0,-7,-13,-1,-4,5,-5,0,-3,1,-1,-1,-1,4,-1
KR_6759978349,420,-2,-95,12,-9,-5,6,1,-1,3,2,0,3,3,-2,3,1,-1,2,1,0,-8,-15,0,-3,3,-1,0,-1,0,-1,-1,-1,0,-1
KR_6738568535,420,-5,-107,-24,-15,-2,3,1,-5,5,0,-1,2,1,-6,7,1,-1,1,0,0,-13,-5,-4,-5,9,-4,0,-1,-1,1,-1,-1,5,-1
KR_6645329680,420,-2,-21,12,-4,-1,1,0,2,0,2,-2,5,3,-1,2,1,-2,2,0,0,-10,-3,-3,-3,6,-1,0,0,-1,1,1,1,6,-1
KR_6740376662,420,-3,-44,-18,-8,1,1,2,-2,4,2,-3,4,1,0,2,2,-4,4,0,0,-10,-24,0,-7,7,-1,0,-1,-1,1,-1,1,5,-1
KR_6762979827,420,-2,-49,11,-9,-7,8,1,4,1,5,2,0,2,-1,3,2,-7,9,2,0,-8,13,2,-8,6,-7,0,-2,-1,-1,-1,-1,3,-1
KR_6734465144,420,-3,-21,0,-4,-3,3,0,0,3,3,3,2,5,-2,3,1,-2,2,0,0,-2,-11,-1,-5,6,-2,0,0,-1,-1,0,1,6,-1
KR_6757630433,420,1,64,-1,-4,3,1,4,-8,8,0,2,2,4,-3,3,0,2,0,2,0,-5,230,5,-7,2,-3,0,-2,-1,1,-1,1,1,-1
KR_6652069298,420,-1,-11,18,-1,1,0,1,3,0,3,1,1,2,-3,4,1,-3,3,0,0,-3,-12,-2,-1,3,2,0,-2,-1,1,-1,1,5,-1
KR_6682931730,420,0,29,12,-6,6,0,6,-5,6,1,-5,6,1,-2,6,4,0,2,2,0,-20,-34,2,-8,6,1,0,1,0,-1,1,-1,0,-1
KR_6703374486,420,-5,-55,-12,-9,-2,3,1,1,1,2,-1,2,1,-5,6,1,-2,3,1,0,-11,-2,-2,-3,5,0,0,-3,1,0,-1,1,4,-1
KR_6721365263,420,0,62,-8,3,1,5,6,0,0,0,1,1,2,3,1,4,-2,3,1,0,1,-23,-2,-7,9,1,0,0,1,-1,-1,1,1,-1
KR_6756437950,420,-2,-26,-20,-1,-1,6,5,0,2,2,-1,5,4,0,4,4,1,0,1,0,-3,-12,0,-3,3,4,0,0,-1,-1,-1,-1,6,-1
KR_6430195134,440,2,47,20,1,4,0,4,2,2,4,-5,8,3,0,2,2,0,1,1,0,7,-20,-3,-5,8,1,0,1,1,1,1,-1,5,-1
KR_6762267738,420,-1,-1,-7,-10,-8,8,0,-1,2,1,-4,5,1,1,0,1,2,1,3,0,-6,9,1,-6,5,-3,0,0,0,-1,-1,-1,0,-1
KR_6734509426,420,0,-15,10,-7,1,1,2,-3,6,3,3,2,5,-5,5,0,-3,5,2,0,-10,-44,1,-4,3,1,0,0,-1,1,-1,-1,1,-1
KR_6762249822,420,1,-10,24,2,0,2,2,5,1,6,2,1,3,-5,5,0,0,0,0,0,5,9,5,-6,1,0,0,0,-1,0,0,-1,1,-1
KR_6688427350,440,-7,-47,-27,-15,-2,3,1,-4,7,3,-8,9,1,0,2,2,-1,2,1,0,-19,150,-3,-3,6,-2,0,-1,-1,-1,-1,-1,5,-1
KR_6735247124,420,-3,15,-15,-5,0,1,1,2,4,6,0,1,1,-7,7,0,0,0,0,0,-11,-46,-3,-3,6,5,0,0,-1,-1,0,-1,5,-1
KR_6762039730,420,-2,-107,-11,-7,-5,6,1,-1,2,1,-1,2,1,-2,2,0,2,0,2,1,0,2,2,-7,5,1,0,-1,-1,1,-1,1,6,-1
KR_6653576378,420,-1,-46,20,-1,-2,2,0,2,2,4,-2,4,2,1,3,4,0,1,1,0,-2,-2,1,-8,7,0,0,0,1,1,1,1,1,-1
KR_6757981736,420,-3,-21,-13,-2,1,1,2,-5,9,4,1,2,3,0,0,0,1,0,1,0,-6,-40,-1,-7,8,0,0,0,-1,-1,0,-1,1,-1
KR_6763831098,420,0,-19,-44,6,2,4,6,3,1,4,-1,4,3,-1,6,5,3,0,3,-1,10,5,0,-5,5,1,0,1,-1,1,1,-1,1,-1
KR_6688481725,420,3,2,28,3,-1,3,2,-1,2,1,0,3,3,1,2,3,4,0,4,0,4,194,-2,-6,8,0,0,0,1,1,1,-1,2,-1
KR_6714942180,440,-7,-80,-13,-17,-3,4,1,-1,1,0,-4,5,1,-1,6,5,-8,8,0,-2,-15,3,4,-6,2,-1,0,-2,-1,-1,-1,-1,5,-1
KR_6717818328,420,-1,-47,-30,-7,4,0,4,-4,7,3,-5,6,1,-2,2,0,0,2,2,0,-3,6,-2,-6,8,-8,0,0,-1,1,1,-1,6,-1
KR_6761751911,420,-1,-33,15,-4,0,1,1,0,6,6,-4,6,2,2,3,5,-2,2,0,1,-6,-3,0,-8,8,2,0,-1,-1,-1,-1,1,5,-1
KR_6470937499,440,-6,-87,-24,-11,-1,3,2,-2,5,3,-1,4,3,-5,6,1,-2,2,0,0,-10,-5,0,-5,5,1,0,-2,0,-1,-1,-1,0,-1
KR_6761847262,420,2,36,-7,2,1,2,3,-1,5,4,0,2,2,2,2,4,0,1,1,1,6,3,-1,-6,7,1,0,1,-1,-1,1,1,6,-1
KR_6669160257,420,3,-33,17,3,-3,4,1,2,2,4,1,0,1,3,2,5,0,1,1,1,4,-1,3,-8,5,5,0,-1,1,-1,-1,1,5,-1
KR_6652365767,420,-2,-20,0,-6,-1,3,2,2,2,4,-1,4,3,-4,5,1,-2,2,0,0,-12,5,4,-7,3,1,0,-2,-1,1,-1,-1,1,-1
KR_6726742814,420,-2,-12,-23,-1,-5,6,1,-1,2,1,0,3,3,7,3,10,-2,3,1,2,5,4,1,-4,3,5,0,1,1,1,-1,1,4,-1
KR_6742817127,420,4,18,17,3,2,0,2,2,2,4,1,3,4,-2,5,3,0,1,1,0,5,-19,-1,-4,5,-1,0,0,1,1,1,-1,1,-1
KR_6764204981,420,0,13,-7,0,-1,2,1,0,2,2,3,2,5,0,3,3,-2,4,2,1,10,-23,2,-6,4,2,0,0,-1,1,1,1,1,-1
KR_6760436630,420,-5,-112,-24,-15,-7,7,0,0,0,0,-2,3,1,-7,8,1,1,0,1,0,-8,-12,-3,-2,5,3,0,-4,-1,-1,-1,-1,2,-1
KR_6750210806,420,-2,5,8,-4,-3,4,1,-1,2,1,0,3,3,-2,3,1,2,2,4,0,3,-366,-3,-1,4,3,0,-1,-1,1,-1,-1,3,-1
KR_6715572872,420,-1,-1,-10,4,1,2,3,0,5,5,-3,3,0,4,1,5,2,1,3,0,3,392,-1,-5,6,0,0,1,1,-1,1,-1,6,-1
KR_6750265690,420,0,-18,-28,-2,5,0,5,-1,2,1,-4,6,2,-2,3,1,0,1,1,0,-12,2,3,-7,4,-5,0,0,1,-1,0,-1,2,-1
KR_6753609079,420,-1,15,38,-6,-4,4,0,-4,5,1,0,2,2,1,0,1,1,0,1,0,-5,25,-4,-4,8,3,0,0,1,-1,0,1,6,-1
KR_6761167475,420,1,-30,-7,4,1,0,1,3,1,4,-2,3,1,2,1,3,0,0,0,0,-1,-5,0,-4,4,2,0,-1,-1,-1,-1,1,3,-1
KR_6713596303,420,-4,4,-33,-4,4,0,4,-6,6,0,-3,5,2,0,2,2,1,0,1,0,-1,-6,-3,-6,9,-3,0,-1,-1,-1,-1,-1,1,-1
KR_6762874721,420,-1,46,-9,-1,-5,5,0,3,2,5,1,3,4,0,3,3,0,1,1,0,5,106,1,-4,3,4,0,1,-1,-1,1,-1,6,-1
KR_6643273605,420,-1,8,-8,-6,-1,1,0,-3,7,4,-2,3,1,3,1,4,-3,3,0,1,-5,-12,-1,-8,9,-2,0,0,-1,-1,0,1,3,-1
KR_6740251726,420,2,-21,13,3,2,0,2,2,2,4,0,1,1,2,0,2,-3,3,0,0,3,0,3,-8,5,-1,0,0,1,-1,-1,1,2,-1
KR_6694226407,420,-4,-24,11,-10,-3,4,1,-2,4,2,-3,4,1,-2,3,1,0,2,2,0,-13,-8,-2,-4,6,0,0,-1,-1,1,-1,1,3,-1
KR_6691063687,420,3,92,12,2,0,2,2,0,6,6,-1,2,1,4,1,5,-1,1,0,0,10,-3,2,-9,7,3,0,0,1,-1,0,1,3,-1
KR_6700121077,420,-1,-40,4,0,0,1,1,0,2,2,4,1,5,-1,3,2,-3,3,0,0,2,30,1,-6,5,-2,0,-1,-1,-1,-1,-1,5,-1
KR_6760846293,420,-1,-10,-4,-5,-1,3,2,-4,5,1,1,3,4,-5,8,3,4,0,4,0,-2,3,0,-6,6,5,0,0,1,1,-1,1,6,-1
KR_6754029396,420,-3,-13,-16,-5,-2,5,3,0,1,1,-6,6,0,5,3,8,-2,2,0,0,-2,283,2,-7,5,1,0,0,-1,1,1,-1,4,-1
KR_6748540738,420,-7,-58,-51,-13,-3,3,0,-4,6,2,3,1,4,-8,12,4,-1,1,0,0,-12,-10,-3,-2,5,3,0,-2,-1,-1,-1,-1,4,-1
KR_6595008876,420,2,13,10,5,2,1,3,6,1,7,-1,5,4,-2,4,2,0,0,0,0,9,5,-1,-4,5,-1,0,1,1,1,1,1,6,-1
KR_6645851826,420,2,15,-24,-1,2,1,3,4,0,4,-6,7,1,-2,4,2,1,1,2,0,1,94,-6,-2,8,0,0,1,-1,1,1,1,1,-1
KR_6759812497,420,-3,-94,-3,-7,-5,5,0,1,1,2,-1,2,1,3,1,4,-5,5,0,-1,2,3,0,-3,3,-1,0,-3,-1,1,-1,-1,6,-1
KR_6624640997,420,2,-14,25,7,1,2,3,0,1,1,0,2,2,4,1,5,2,0,2,2,10,-7,-2,-6,8,4,0,1,1,-1,1,1,5,-1
KR_6757086702,440,-4,-52,12,-7,-2,2,0,-2,2,0,-7,10,3,5,2,7,-1,1,0,-1,-14,-2,0,-2,2,-3,0,0,-1,1,-1,-1,2,-1
KR_6750859380,420,-2,-42,-32,-3,1,2,3,-3,6,3,3,2,5,-4,4,0,0,0,0,0,-8,-7,2,-6,4,-4,0,-2,-1,1,-1,-1,5,-1
KR_6626490155,420,-3,-41,-25,-1,-3,4,1,1,1,2,1,3,4,2,2,4,-2,3,1,-1,7,-9,0,-5,5,5,0,-2,1,-1,-1,-1,5,-1
KR_6747677404,420,0,16,-16,1,1,0,1,1,5,6,0,4,4,-2,6,4,1,0,1,0,-3,0,0,-5,5,4,0,0,-1,1,0,1,3,-1
KR_6765512411,420,1,50,-33,1,5,1,6,-1,3,2,-1,2,1,0,1,1,-2,2,0,0,3,-27,-6,-2,8,-3,0,1,-1,1,1,1,2,-1
KR_6741874625,440,-3,-40,-23,-3,2,3,5,-4,6,2,5,2,7,-2,3,1,-4,4,0,0,-7,-5,5,-8,3,4,0,-2,1,-1,-1,-1,6,-1
KR_6316706864,420,-4,-5,-8,-6,4,1,5,-6,6,0,-3,4,1,-2,2,0,1,0,1,0,-17,4,6,-10,4,-5,0,-1,1,1,-1,1,2,-1
KR_6734516222,420,1,-36,8,-1,3,2,5,-6,6,0,4,3,7,0,2,2,-2,2,0,3,-10,-26,1,-7,6,6,0,1,1,1,1,-1,1,-1
KR_6736571113,420,1,-13,5,-2,2,0,2,-3,6,3,3,0,3,-2,5,3,-2,7,5,-2,-8,4,4,-8,4,0,0,-1,1,-1,-1,-1,6,-1
KR_6692213983,420,1,-55,-52,4,-1,2,1,3,3,6,0,2,2,6,2,8,-4,6,2,0,15,-5,-3,-3,6,5,0,0,-1,-1,-1,1,1,-1
KR_6762212380,420,-2,-9,-21,-1,-1,3,2,-2,4,2,1,0,1,1,2,3,0,1,1,0,-7,6,4,-6,2,-1,0,0,-1,1,1,-1,6,-1
KR_6760470940,420,-3,6,-4,-5,2,2,4,-1,2,1,-3,3,0,-2,2,0,-1,1,0,0,-6,-3,0,-6,6,-2,0,0,1,1,0,1,4,-1
KR_6764409026,420,-2,-47,-24,2,-1,1,0,0,3,3,5,0,5,-1,2,1,-1,1,0,0,6,-5,2,-5,3,-2,0,-1,-1,-1,-1,1,1,-1
KR_6696877224,420,0,-39,0,3,0,1,1,4,0,4,2,1,3,-3,4,1,0,2,2,0,-1,-16,1,-6,5,4,0,0,-1,-1,0,1,2,-1
KR_6738454960,440,-2,12,-33,-2,4,1,5,0,5,5,-4,5,1,-1,6,5,-1,1,0,0,0,-10,0,-4,4,2,0,-1,-1,-1,-1,1,3,-1
KR_6752169339,420,1,15,-8,6,4,1,5,-3,4,1,2,2,4,1,2,3,2,1,3,0,8,22,5,-7,2,-2,0,2,-1,1,1,1,3,-1
KR_6743861173,420,-6,-15,-12,-9,2,0,2,-3,6,3,-2,2,0,-4,8,4,-2,3,1,0,-5,-64,1,-6,5,21,0,-1,-1,-1,-1,-1,4,-1
KR_6719534341,420,-5,-47,-24,-7,-1,2,1,3,2,5,-4,5,1,-5,8,3,0,1,1,0,0,-2,-1,-7,8,1,0,-2,-1,-1,-1,-1,3,-1
KR_6691677183,420,-3,34,-12,-3,-2,3,1,1,1,2,1,2,3,-3,7,4,0,1,1,0,-2,21,1,-8,7,4,0,1,-1,1,1,1,4,-1
KR_6681831273,440,5,9,24,5,0,2,2,1,1,2,0,1,1,2,3,5,2,0,2,0,3,-2,-2,-5,7,-3,0,1,1,1,1,1,4,-1
KR_6683120966,440,-1,-79,-36,2,0,6,6,1,1,2,-4,4,0,3,2,5,2,0,2,0,14,49,5,-8,3,-2,0,-1,1,-1,-1,-1,4,-1
KR_6764199033,420,-3,14,-20,-10,0,1,1,-2,4,2,2,4,6,-1,3,2,-9,9,0,-2,-11,-10,-2,-7,9,-1,0,-1,-1,-1,-1,-1,4,-1
KR_6617569297,420,-4,-28,10,-7,-5,6,1,2,2,4,1,1,2,-4,4,0,-1,2,1,0,-4,1,-3,-2,5,3,0,-1,1,-1,-1,-1,4,-1
KR_6749406365,440,-1,-63,-16,-6,-3,4,1,-3,3,0,2,2,4,-2,5,3,0,1,1,0,-7,-4,0,-3,3,4,0,0,-1,1,0,1,6,-1
KR_6654828884,420,0,45,9,-1,-2,3,1,1,6,7,1,1,2,-1,5,4,0,2,2,1,5,6,1,-5,4,-1,0,1,-1,-1,1,1,4,-1
KR_6714735667,420,-3,-85,-6,-13,-4,6,2,-3,7,4,-2,3,1,-4,4,0,0,0,0,0,-7,-242,4,-6,2,-1,0,-2,-1,-1,-1,-1,4,-1
KR_6764831845,420,-2,-54,-28,-2,1,1,2,1,1,2,-3,4,1,1,1,2,-2,3,1,0,1,-5,-5,-5,10,-4,0,0,0,1,0,-1,0,-1
KR_6438751721,420,1,-38,17,0,1,0,1,4,4,8,-4,4,0,0,1,1,-1,2,1,0,4,34,2,-10,8,3,0,-1,1,-1,-1,-1,4,-1
KR_6738317852,420,-1,-36,3,-2,-1,1,0,-3,6,3,2,0,2,0,1,1,0,1,1,0,1,-6,-2,-5,7,0,0,-2,-1,-1,-1,-1,2,-1
KR_6758793462,420,-2,25,-27,-4,1,0,1,-4,5,1,0,0,0,-2,2,0,1,0,1,0,-6,-29,-2,-5,7,26,0,1,1,-1,1,-1,3,-1
KR_6688598366,420,-1,-36,-4,-2,2,2,4,5,1,6,-8,11,3,-3,5,2,2,1,3,0,-7,14,-1,-4,5,0,0,1,0,1,1,-1,0,-1
KR_6765354756,420,-4,-48,0,-11,-3,3,0,-2,3,1,-3,5,2,-1,2,1,-2,3,1,0,-14,-46,-4,-3,7,13,0,-5,1,-1,-1,-1,3,-1
KR_6758458161,420,-3,29,-5,-3,5,0,5,-1,4,3,-4,4,0,-4,5,1,1,0,1,0,-4,16,0,-6,6,1,0,0,-1,-1,-1,-1,3,-1
KR_6654571005,440,-7,-150,-26,-8,-2,2,0,0,1,1,2,1,3,-7,8,1,-1,1,0,0,-9,-74,1,-7,6,-5,0,-2,0,0,-1,-1,0,-1
KR_6763008191,420,-2,-6,-9,-3,1,1,2,-5,5,0,3,2,5,-2,5,3,0,0,0,0,-4,5,3,-7,4,0,0,-1,-1,-1,-1,1,4,-1
KR_6642015040,420,0,17,0,-4,-2,2,0,2,3,5,3,1,4,-4,5,1,-3,4,1,0,-4,-10,-6,-5,11,0,0,-1,0,-1,-1,1,0,-1
KR_6662977711,420,1,6,0,-3,-1,1,0,0,2,2,0,3,3,-2,5,3,0,3,3,1,-12,4,5,-12,7,-3,0,0,-1,1,1,1,5,-1
KR_6761518229,420,-2,24,-2,-3,4,1,5,-1,2,1,-4,4,0,-3,6,3,1,0,1,2,-3,4,2,-6,4,-5,0,0,1,-1,0,1,3,-1
KR_6723904064,420,-6,-89,-57,-10,1,2,3,-5,5,0,-5,5,0,1,2,3,-2,2,0,0,-9,10,-1,-4,5,-2,0,-2,-1,-1,-1,1,4,-1
KR_6751831004,420,0,-5,12,6,0,1,1,2,2,4,4,1,5,-1,2,1,1,1,2,0,11,-7,0,-2,2,-2,0,0,-1,-1,0,1,1,-1
KR_6724731856,440,0,-73,-4,3,-3,3,0,-3,5,2,0,2,2,2,1,3,7,1,8,0,-1,7,-3,-5,8,2,0,-1,1,-1,-1,1,2,-1
KR_6759971190,440,-2,-5,-8,-4,2,1,3,1,4,5,0,3,3,-1,2,1,-6,6,0,0,-8,-20,3,-8,5,-3,0,-2,-1,0,-1,-1,1,-1
KR_6756638173,440,-3,-35,-18,-9,1,3,4,-3,6,3,-3,3,0,-2,4,2,-2,2,0,0,-14,-2,2,-3,1,-2,0,-1,0,-1,-1,-1,0,-1
KR_6742735288,420,0,10,0,3,4,0,4,-1,3,2,-2,3,1,-2,3,1,4,1,5,0,1,0,-2,-7,9,-3,0,0,1,1,0,1,1,-1
KR_6751851017,420,-4,-102,4,-10,-2,3,1,2,3,5,-1,1,0,-6,6,0,-3,3,0,0,-12,38,-5,-2,7,-3,0,-1,1,-1,-1,-1,5,-1
KR_6570042452,420,-6,12,-16,-14,-2,5,3,-2,4,2,-3,3,0,-3,6,3,-4,4,0,0,-12,137,-3,-4,7,3,0,-2,-1,-1,1,-1,4,-1
KR_6699348849,420,-1,-5,-21,-2,4,1,5,3,1,4,-4,4,0,-4,5,1,-1,1,0,-1,-6,-1,-2,-7,9,-3,0,-1,-1,-1,-1,-1,1,-1
KR_6751078536,420,-5,-28,-10,-17,-1,1,0,-2,2,0,0,2,2,-13,14,1,-1,2,1,0,-15,-6,-6,0,6,0,0,-2,-1,-1,-1,1,5,-1
KR_6751515056,420,-3,-18,-9,-2,-2,3,1,0,2,2,3,2,5,0,6,6,-3,4,1,1,3,-45,1,-7,6,1,0,-1,1,-1,-1,1,4,-1
KR_6677714124,420,-2,5,-12,-5,1,1,2,-1,3,2,-4,5,1,-2,5,3,1,0,1,0,-4,-13,-3,-4,7,0,0,-1,-1,-1,-1,-1,3,-1
KR_6763204814,420,-2,-14,-24,-4,0,1,1,0,1,1,-5,7,2,2,3,5,-1,1,0,0,-4,5,6,-9,3,-4,0,-1,-1,-1,-1,1,3,-1
KR_6755656662,440,-4,-32,-12,-11,1,1,2,-3,7,4,-10,14,4,2,0,2,-1,2,1,1,-11,35,7,-10,3,0,0,-1,1,-1,-1,1,5,-1
KR_6633387259,420,-1,75,15,-6,0,0,0,0,2,2,-2,4,2,-2,3,1,-2,3,1,0,-6,45,-4,-2,6,-42,0,1,-1,-1,1,-1,4,-1
KR_6752490144,420,2,17,16,-1,-2,2,0,-2,4,2,0,1,1,2,1,3,1,0,1,0,-2,24,6,-8,2,-3,0,0,-1,-1,0,-1,3,-1
KR_6763140740,420,-3,-36,16,-4,-4,4,0,-1,4,3,2,3,5,1,0,1,-2,2,0,0,-3,-3,-1,-9,10,-6,0,-1,1,1,-1,-1,6,-1
KR_6538507825,440,0,83,-48,-7,1,2,3,-8,10,2,1,3,4,1,5,6,-2,3,1,1,-3,-3,-2,-2,4,-4,0,0,-1,1,0,1,4,-1
KR_6748972434,420,3,-13,8,3,-1,2,1,-2,4,2,3,3,6,4,5,9,-1,3,2,0,-3,-50,-4,-3,7,13,0,0,-1,1,-1,1,2,-1
KR_6674675074,420,-4,-11,-44,-5,-3,3,0,1,6,7,-5,5,0,2,1,3,0,0,0,0,3,-4,2,-9,7,-6,0,0,-1,1,0,-1,5,-1
KR_6715008480,420,-1,-27,-36,-1,0,1,1,-2,3,1,1,1,2,1,1,2,-1,1,0,0,6,44,-1,-3,4,1,0,-1,1,-1,-1,-1,5,-1
KR_6764205361,420,0,-28,-9,-5,3,0,3,2,1,3,-2,3,1,-5,6,1,-3,3,0,0,-8,-1,1,-4,3,-4,0,0,-1,1,-1,-1,2,-1
KR_6743609207,420,2,-18,24,-2,3,1,4,3,2,5,-1,3,2,-7,8,1,0,2,2,0,-8,14,1,-4,3,-6,0,0,-1,1,1,1,4,-1
KR_6743345131,440,-2,32,0,-5,-2,2,0,-4,7,3,0,3,3,1,3,4,0,0,0,0,-1,12,-1,-6,7,-4,0,-2,1,-1,-1,-1,1,-1
KR_6752701650,420,-3,-56,-24,2,4,2,6,-2,5,3,1,2,3,0,3,3,-1,1,0,1,5,20,5,-9,4,-2,0,0,-1,-1,1,1,1,-1
KR_6747871184,420,-2,-15,-17,-2,-1,4,3,-2,3,1,-1,2,1,2,0,2,0,0,0,0,-3,5,-4,-4,8,1,0,0,0,-1,0,1,0,-1
KR_6624541678,420,-5,-50,-42,-5,2,2,4,-5,6,1,-2,4,2,0,3,3,0,1,1,0,-2,114,3,-7,4,-3,0,-1,-1,1,1,-1,5,-1
KR_6630100497,420,-3,-59,-28,1,-1,2,1,0,2,2,1,1,2,-2,3,1,3,0,3,0,8,3,0,-4,4,-1,0,0,1,-1,0,1,1,-1
KR_6548152841,420,-4,-88,1,-7,-4,4,0,1,4,5,2,0,2,-5,5,0,-1,1,0,0,-9,-8,-4,-3,7,3,0,-1,-1,1,-1,-1,3,-1
KR_6762828799,420,-4,-59,4,-11,-1,2,1,-3,4,1,0,2,2,-8,10,2,1,2,3,0,-10,2,-2,-4,6,-4,0,-1,-1,1,-1,-1,2,-1
KR_6743804856,420,-7,-27,-48,-15,-2,3,1,-3,5,2,-1,1,0,-5,5,0,-4,4,0,0,-13,5,-2,-8,10,-3,0,-1,-1,-1,-1,-1,2,-1
KR_6729255021,420,-3,22,-12,-10,-3,5,2,-6,7,1,3,1,4,-6,9,3,2,0,2,0,-9,-6,2,-8,6,1,0,0,-1,1,-1,-1,6,-1
KR_6717948865,420,1,-34,20,1,-3,4,1,-3,3,0,4,0,4,0,1,1,3,0,3,0,-3,-39,-3,-9,12,3,0,0,-1,1,0,1,2,-1
KR_6758997094,420,2,10,-32,-1,2,0,2,-2,4,2,-1,3,2,1,4,5,-1,3,2,0,-2,-2,-2,-4,6,1,0,1,-1,1,-1,1,5,-1
KR_6760840849,420,-1,-3,-5,-4,0,2,2,0,2,2,2,0,2,-4,5,1,-2,4,2,0,-5,15,-1,-4,5,0,0,0,0,-1,-1,-1,0,-1
KR_6758264125,440,-2,-10,13,-4,-3,3,0,1,2,3,1,2,3,-1,2,1,-2,5,3,-1,-4,21,-1,-4,5,-2,0,-1,-1,-1,-1,-1,1,-1
KR_6638151457,420,0,3,8,1,1,2,3,-1,1,0,-2,4,2,0,2,2,3,1,4,-1,2,-9,-5,-5,10,2,0,0,1,-1,0,1,2,-1
KR_6732775853,420,-3,-24,-24,-2,-1,1,0,1,3,4,0,1,1,-2,6,4,0,1,1,0,0,-6,-3,-3,6,-1,0,0,1,-1,0,-1,1,-1
KR_6763175516,420,1,-32,-12,7,-1,3,2,-4,4,0,4,0,4,5,1,6,3,0,3,0,16,-2,-3,-3,6,3,0,-1,1,-1,-1,1,4,-1
KR_6760126921,420,0,6,-24,0,2,1,3,-4,4,0,1,2,3,0,1,1,1,0,1,0,-6,5,3,-6,3,-6,0,0,-1,1,0,-1,3,-1
KR_6690900045,420,-1,-37,4,2,1,0,1,0,1,1,-2,3,1,2,3,5,1,1,2,0,5,0,0,-8,8,1,0,0,-1,1,0,1,5,-1
KR_6764713177,420,-1,-38,0,5,0,0,0,1,6,7,4,0,4,3,4,7,-3,3,0,-1,6,-9,-4,-3,7,1,0,0,-1,1,0,1,2,-1
KR_6744648905,420,-4,17,-24,-15,4,2,6,-7,7,0,-5,5,0,-7,8,1,0,1,1,0,-20,-26,1,-6,5,2,0,-1,-1,-1,-1,-1,2,-1
KR_6755837997,420,2,-5,-2,-1,0,0,0,5,1,6,-4,5,1,-2,5,3,0,1,1,0,-7,-2,-3,-5,8,0,0,0,-1,1,1,-1,5,-1
KR_6734912289,420,-1,-111,-50,-6,0,2,2,-6,8,2,1,3,4,1,1,2,-2,3,1,0,-3,-1,1,-5,4,-4,0,-1,-1,-1,-1,-1,6,-1
KR_6692791653,420,-1,-28,4,-13,4,1,5,-6,8,2,-6,6,0,-4,5,1,-1,2,1,-3,-19,-19,-5,-4,9,4,0,-1,-1,-1,-1,-1,3,-1
KR_6757744253,420,-1,-4,-16,5,3,0,3,2,1,3,0,2,2,0,1,1,0,1,1,1,1,-5,1,-6,5,-3,0,0,1,1,0,1,5,-1
KR_6683318973,440,-1,-48,13,-4,0,0,0,2,0,2,2,5,7,-2,4,2,-6,8,2,0,0,-5,-4,-4,8,3,0,0,1,1,1,-1,5,-1
KR_6765090997,420,-3,-13,-24,-9,-3,3,0,-5,6,1,-6,7,1,4,2,6,1,1,2,0,-12,-8,-3,-1,4,-1,0,-1,-1,-1,-1,1,3,-1
KR_6518280595,420,-2,-62,13,-7,1,1,2,-4,4,0,-1,2,1,-4,5,1,1,1,2,0,-13,6,0,-5,5,-7,0,0,1,1,0,1,3,-1
KR_6753801862,420,-6,-91,-33,-15,3,0,3,-5,5,0,-8,9,1,-6,6,0,1,1,2,0,-13,43,-3,-2,5,12,0,-3,-1,-1,-1,-1,3,-1
KR_6763292455,440,-3,72,-30,-9,-3,3,0,-7,7,0,1,2,3,-1,1,0,1,1,2,0,-9,8,-3,-5,8,5,0,-2,-1,-1,-1,-1,5,-1
KR_6682348054,420,-2,-20,4,-9,0,1,1,-1,1,0,-1,4,3,-6,9,3,-1,2,1,0,-10,-110,-4,-2,6,0,0,1,-1,1,1,-1,3,-1
KR_6760930229,440,1,-9,8,7,2,1,3,2,3,5,0,1,1,8,1,9,-5,7,2,2,11,-7,-4,-2,6,7,0,1,1,1,1,1,4,-1
KR_6728050931,420,-1,-19,38,-13,4,0,4,-4,8,4,-4,6,2,-5,7,2,-4,5,1,1,-10,-10,-5,-3,8,-2,0,-1,-1,-1,-1,1,5,-1
KR_6723173008,420,-4,10,-28,-11,0,2,2,-3,6,3,-5,7,2,-3,4,1,0,0,0,0,-14,-4,2,-5,3,-4,0,-1,-1,-1,-1,1,1,-1
KR_6744222508,420,-4,-67,-4,-5,-1,1,0,-1,3,2,-5,6,1,2,1,3,0,0,0,0,0,-28,-1,-4,5,26,0,-1,1,1,-1,1,4,-1
KR_6744292483,420,2,6,-24,2,2,1,3,1,2,3,-2,2,0,1,3,4,0,0,0,0,0,24,-1,-6,7,-26,0,0,-1,-1,1,1,2,-1
KR_6472390732,420,-5,-66,-29,-10,2,2,4,-6,8,2,2,0,2,-6,7,1,-2,2,0,0,-7,-5,-3,-6,9,-2,0,0,-1,1,-1,1,5,-1
KR_6761852419,420,-2,-7,-16,-5,-1,2,1,1,1,2,1,1,2,-2,4,2,-4,4,0,0,-2,33,-5,-4,9,1,0,-1,-1,-1,-1,-1,5,-1
KR_6527214680,420,0,-48,23,-4,-2,2,0,0,2,2,1,2,3,-1,4,3,-2,3,1,0,-11,11,1,-8,7,-5,0,-1,1,1,-1,-1,4,-1
KR_6629010931,420,0,-13,-16,-5,-2,2,0,4,3,7,-7,8,1,-1,3,2,1,0,1,0,2,115,3,-6,3,-4,0,0,1,1,0,-1,6,-1
KR_6757039588,420,-4,-37,-11,-10,2,3,5,-5,7,2,-2,2,0,-2,3,1,-3,4,1,0,-12,-22,-4,-3,7,4,0,-2,1,-1,-1,-1,2,-1
KR_6695803155,420,-1,-34,-23,-7,-1,1,0,-5,6,1,2,2,4,-3,5,2,0,0,0,0,-6,-173,-10,-2,12,5,0,-2,-1,1,-1,1,6,-1
KR_6646326400,420,-2,-33,-59,-2,1,0,1,-3,6,3,-1,1,0,1,3,4,0,1,1,0,2,-42,-1,-5,6,3,0,0,1,-1,0,1,5,-1
KR_6759821652,420,-3,-27,-2,-5,6,0,6,-3,3,0,-6,10,4,-2,3,1,0,0,0,0,-3,-19,1,-8,7,-4,0,-1,0,0,-1,-1,0,-1
KR_6731283213,440,1,-25,23,-1,0,1,1,-9,9,0,7,1,8,1,0,1,0,1,1,0,-5,-3,0,-3,3,5,0,0,0,0,0,1,0,-1
KR_6752783595,420,-1,-29,17,0,-2,5,3,-3,6,3,0,4,4,0,4,4,5,1,6,1,7,20,-1,-3,4,2,0,-1,1,-1,-1,1,6,-1
KR_6716101218,420,-6,-41,-16,-13,-2,2,0,-2,4,2,-4,6,2,-4,5,1,-1,1,0,0,-10,4,-6,0,6,-3,0,-1,-1,-1,-1,-1,4,-1
KR_6759805934,420,3,-2,36,2,-3,6,3,1,2,3,2,2,4,1,1,2,1,1,2,-2,-2,-52,1,-6,5,12,0,-1,1,-1,-1,-1,3,-1
KR_6709851556,420,-1,40,4,-1,-3,4,1,1,1,2,3,2,5,-1,3,2,-1,2,1,0,-7,4,0,-8,8,-3,0,0,0,-1,0,-1,0,-1
KR_6536998186,420,1,-6,5,-5,1,1,2,1,3,4,-3,4,1,-4,5,1,0,0,0,-1,-5,-14,-6,0,6,2,0,-1,-1,1,-1,-1,6,-1
KR_6765339320,420,-1,14,-4,-3,1,2,3,-2,4,2,2,1,3,-4,4,0,0,0,0,-1,-4,0,-1,-5,6,-3,0,0,0,0,1,-1,0,-1
KR_6749676177,420,-2,-41,-23,-7,-2,3,1,4,3,7,-5,8,3,-6,7,1,2,3,5,1,1,-4,2,-7,5,-2,0,-2,-1,-1,-1,1,4,-1
KR_6763980583,440,2,16,40,5,-2,2,0,0,4,4,11,0,11,-4,5,1,0,1,1,1,-5,0,0,-3,3,-1,0,3,-1,1,1,1,4,-1
KR_6737099133,420,0,-11,1,1,-1,3,2,-3,4,1,3,0,3,4,2,6,-2,3,1,0,4,13,0,-6,6,-7,0,-2,-1,-1,-1,1,4,-1
KR_6752691454,420,-5,-38,-12,-5,-1,2,1,1,0,1,-2,6,4,-1,5,4,-2,3,1,0,0,-4,-9,-3,12,6,0,-2,-1,-1,-1,1,6,-1
KR_6762693315,420,0,11,8,-11,-3,3,0,-2,4,2,-5,7,2,0,2,2,-1,2,1,0,-7,-15,-3,-3,6,3,0,0,-1,-1,-1,-1,2,-1
KR_6732735029,420,-5,-108,-32,-3,-2,2,0,4,0,4,0,1,1,-4,6,2,-1,1,0,-1,-5,3,-3,-3,6,0,0,-3,-1,1,-1,-1,3,-1
KR_6750353206,420,-2,9,12,-5,-2,4,2,0,1,1,-3,4,1,-1,2,1,1,0,1,0,-3,-11,0,-3,3,1,0,-1,-1,-1,-1,-1,1,-1
KR_6666380649,420,-1,6,-9,-6,-2,3,1,2,2,4,-6,6,0,0,1,1,0,1,1,0,-4,6,-1,-3,4,-4,0,0,0,0,0,-1,0,-1
KR_6764206216,420,0,58,7,5,2,3,5,4,0,4,0,4,4,-1,4,3,0,0,0,0,-3,37,-2,-4,6,-15,0,2,0,1,1,1,0,-1
KR_6759601220,420,-4,-4,-6,-10,-1,3,2,-9,10,1,2,2,4,-2,2,0,0,1,1,0,-10,-2,-5,-2,7,4,0,-2,0,-1,-1,-1,0,-1
KR_6746355096,420,-1,-23,4,1,-2,2,0,0,4,4,-2,3,1,5,0,5,0,0,0,-1,-3,-111,-1,-6,7,-8,0,-1,-1,1,-1,-1,2,-1
KR_6763775403,440,-1,-22,20,3,-1,2,1,1,2,3,3,3,6,-3,4,1,3,0,3,0,-4,-18,-4,-3,7,1,0,0,-1,1,1,1,5,-1
KR_6735867306,420,-1,-22,3,-4,1,3,4,2,2,4,-2,3,1,-5,7,2,0,1,1,0,-7,-1,1,-5,4,-1,0,0,-1,-1,1,-1,2,-1
KR_6650159963,420,-2,-56,12,-7,4,0,4,1,0,1,-1,2,1,-11,12,1,0,0,0,0,-8,4,4,-9,5,-3,0,-1,-1,-1,-1,-1,6,-1
KR_6674953867,420,-1,53,8,-6,1,0,1,0,5,5,-3,3,0,-3,3,0,-1,1,0,-1,-7,-4,0,-4,4,2,0,-1,-1,-1,-1,-1,1,-1
KR_6755821880,420,-3,-18,16,-7,-1,1,0,-3,4,1,-2,2,0,-1,1,0,0,1,1,0,-7,-2,-2,-3,5,-1,0,0,-1,1,0,-1,4,-1
KR_6616663491,420,-2,-6,-13,-3,-2,3,1,3,1,4,-4,4,0,0,1,1,0,3,3,0,-4,-115,0,-6,6,1,0,0,-1,0,0,1,3,-1
KR_6699328501,420,0,6,8,0,3,2,5,5,1,6,-3,3,0,-4,4,0,-1,2,1,0,-2,21,4,-6,2,0,0,-1,1,-1,-1,-1,3,-1
KR_6747033115,420,-5,-56,-22,-13,-2,3,1,-3,5,2,1,1,2,-5,6,1,-4,4,0,0,-15,-24,5,-12,7,-1,0,0,-1,1,-1,-1,4,-1
KR_6743770171,440,0,-39,0,6,-1,2,1,3,3,6,0,2,2,1,5,6,3,0,3,-3,8,1,0,-6,6,3,0,0,-1,0,-1,-1,5,-1
KR_6753307308,420,4,82,24,7,1,1,2,4,3,7,-2,4,2,0,2,2,4,0,4,0,4,-10,0,-4,4,4,0,0,1,-1,1,1,3,-1
KR_6700898893,420,-4,-13,-15,-9,-1,1,0,-1,2,1,-1,2,1,-6,9,3,0,1,1,0,-14,14,0,-7,7,-6,0,-2,-1,-1,-1,-1,1,-1
KR_6706438945,420,-1,-9,-16,-4,-3,4,1,-2,5,3,1,0,1,0,1,1,0,0,0,0,-9,-4,-2,-2,4,3,0,0,-1,-1,-1,-1,3,-1
KR_6744488746,420,-3,-50,-32,-1,1,1,2,-3,5,2,2,1,3,-1,2,1,0,0,0,0,-8,2,6,-11,5,-2,0,-1,-1,-1,-1,1,1,-1
KR_6747507583,420,0,-15,-12,-9,4,0,4,-7,9,2,-4,4,0,-1,2,1,-1,2,1,-2,-16,173,-1,-7,8,1,0,2,-1,1,1,-1,1,-1
KR_6689030947,420,0,-23,8,-7,-7,7,0,-1,3,2,-1,2,1,4,1,5,-2,3,1,0,-4,1,-2,-3,5,6,0,-1,1,-1,-1,1,3,-1
KR_6764120286,420,3,33,8,9,1,1,2,1,0,1,3,0,3,4,1,5,0,1,1,0,15,-11,2,-7,5,1,0,0,-1,-1,0,-1,1,-1
KR_6724743031,420,-3,-11,-4,-11,-3,3,0,-1,3,2,-9,9,0,3,0,3,-1,1,0,0,-4,20,0,-5,5,-1,0,0,-1,-1,1,-1,2,-1
KR_6749737738,420,-4,-88,-18,-9,-2,5,3,0,3,3,-6,6,0,1,3,4,-2,2,0,0,-2,168,-1,-2,3,-1,0,-4,-1,-1,-1,-1,3,-1
KR_6763248833,420,-3,-46,-24,1,0,1,1,1,2,3,-1,3,2,1,1,2,0,0,0,1,8,-30,3,-6,3,22,0,-2,1,-1,-1,1,6,-1
KR_6728205192,420,-4,6,18,-9,-1,1,0,-1,5,4,-4,5,1,-2,4,2,-1,1,0,-1,-6,-7,-3,-1,4,2,0,-1,-1,-1,-1,-1,4,-1
KR_6749991978,420,-1,-48,0,-2,-2,2,0,0,1,1,-1,3,2,0,3,3,1,1,2,0,1,-16,4,-9,5,1,0,-1,-1,0,-1,-1,5,-1
KR_6688517472,420,1,26,-25,2,3,0,3,0,2,2,0,3,3,-1,2,1,0,0,0,0,3,-1,2,-4,2,1,0,0,0,1,0,1,0,-1
KR_6763853315,420,-5,-98,-3,-6,-3,4,1,1,0,1,-3,3,0,-1,2,1,0,1,1,0,-1,20,1,-6,5,-2,0,0,-1,1,0,1,1,-1
KR_6511963733,420,-2,-29,-3,-8,-2,3,1,-5,5,0,2,1,3,-1,3,2,-2,2,0,-1,-16,7,-4,-2,6,0,0,0,-1,-1,0,-1,3,-1
KR_6629867019,420,-1,-12,-15,0,-3,5,2,2,2,4,2,2,4,-2,4,2,1,1,2,0,9,28,-1,-3,4,-1,0,-2,0,0,1,-1,0,-1
KR_6630740959,420,-1,-26,-20,-3,-2,3,1,5,3,8,-2,5,3,1,3,4,-5,5,0,0,-3,245,0,-6,6,-4,0,0,-1,1,0,-1,3,-1
KR_6764635771,420,2,37,2,4,3,1,4,2,1,3,-3,4,1,3,1,4,-1,1,0,0,2,-3,-2,-5,7,-1,0,0,1,-1,0,-1,6,-1
KR_6630272261,420,-2,-33,12,-15,0,2,2,-1,5,4,0,1,1,-12,12,0,-2,2,0,-1,-18,11,-3,-4,7,-3,0,-3,-1,-1,-1,-1,5,-1
KR_6498020842,420,-3,-46,-20,-9,-6,6,0,1,3,4,-1,1,0,-3,4,1,0,0,0,0,-3,25,0,-5,5,-3,0,-1,0,-1,-1,-1,0,-1
KR_6726791287,420,-2,-16,24,-11,1,1,2,-5,6,1,-1,1,0,-4,4,0,-2,2,0,0,-20,-3,-2,-6,8,1,0,-1,1,1,-1,-1,4,-1
KR_6646724949,420,-3,38,-30,-4,2,1,3,-4,5,1,-2,2,0,0,2,2,0,5,5,0,-7,-8,0,-7,7,7,0,-1,-1,-1,-1,1,2,-1
KR_6747263592,420,1,-38,25,-5,-3,4,1,-1,2,1,-2,4,2,0,3,3,1,0,1,0,-9,-8,0,-4,4,1,0,0,-1,1,1,-1,2,-1
KR_6699855001,420,1,2,14,-3,-5,6,1,-3,6,3,5,1,6,-1,2,1,1,1,2,0,-4,-8,0,-4,4,3,0,-1,1,1,1,1,4,-1
KR_6661463047,420,1,75,9,5,1,2,3,-2,3,1,-2,8,6,6,2,8,2,1,3,-1,-8,9,4,-5,1,-5,0,3,-1,-1,1,1,2,-1
KR_6745737402,420,-8,-44,-92,-15,-5,6,1,-3,3,0,-8,8,0,3,0,3,-2,3,1,-1,-14,-4,-1,-5,6,-4,0,-2,-1,-1,-1,-1,1,-1
KR_6679944246,420,-3,-59,-33,-11,-1,3,2,-2,4,2,-3,3,0,-5,7,2,0,1,1,-2,-17,-41,-1,-4,5,2,0,0,-1,-1,0,-1,5,-1
KR_6758639399,420,0,-17,-24,0,1,2,3,-3,10,7,-1,1,0,3,4,7,0,1,1,0,-8,3,1,-4,3,3,0,1,1,1,1,-1,3,-1
KR_6759381922,440,-8,-22,-64,-15,-8,8,0,-2,4,2,3,1,4,-6,7,1,-2,2,0,0,-6,14,9,-11,2,-10,0,-3,0,0,-1,-1,0,-1
KR_6750660665,440,-2,-104,-8,-4,-1,1,0,-1,2,1,-1,2,1,1,0,1,-2,2,0,0,-2,-5,-2,-4,6,-1,0,0,-1,-1,-1,-1,6,-1
KR_6762688070,420,3,15,6,0,1,3,4,-2,3,1,-1,2,1,1,0,1,1,1,2,0,2,12,-1,-5,6,-4,0,0,-1,-1,0,-1,1,-1
KR_6480502272,420,2,-19,-11,0,-2,2,0,1,1,2,3,2,5,-2,2,0,0,1,1,-2,-3,10,5,-10,5,-8,0,0,1,-1,-1,-1,3,-1
KR_6751253470,440,0,16,-4,6,0,3,3,0,3,3,-1,3,2,2,2,4,5,0,5,0,6,-30,-6,-3,9,-1,0,1,-1,-1,1,1,5,-1
KR_6690616562,440,-5,-65,-28,-11,-3,4,1,-3,6,3,-1,1,0,2,5,7,-6,8,2,0,-4,3,1,-7,6,-3,0,-2,1,1,-1,-1,2,-1
KR_6651613400,420,-5,-96,-45,-15,-5,5,0,-5,6,1,0,2,2,-4,7,3,-1,1,0,0,-20,-3,-1,-5,6,-3,0,-3,-1,-1,-1,-1,3,-1
KR_6731845469,420,-5,-84,-36,-5,-5,5,0,-2,2,0,1,1,2,-1,2,1,2,1,3,0,3,120,2,-9,7,-1,0,-1,-1,-1,-1,1,4,-1
KR_6624692986,420,-5,-35,-2,-6,-3,4,1,0,3,3,-1,2,1,-2,3,1,0,1,1,0,-9,-4,-4,-2,6,-6,0,-1,-1,-1,-1,-1,3,-1
KR_6713795700,420,-3,-66,-7,-9,-1,2,1,0,2,2,-5,8,3,-1,5,4,-2,3,1,0,-16,-2,2,-5,3,-3,0,-4,-1,-1,-1,-1,3,-1
KR_6762154894,420,1,-20,9,5,-1,3,2,-3,4,1,1,0,1,8,2,10,0,2,2,0,9,59,-1,-6,7,3,0,1,1,-1,1,1,3,-1
KR_6729710883,420,-2,9,-22,-1,2,1,3,-5,6,1,3,3,6,0,4,4,-1,1,0,0,6,-19,-1,-5,6,2,0,0,-1,1,0,1,5,-1
KR_6684678292,420,0,2,-24,-3,-3,5,2,1,3,4,-2,3,1,3,3,6,-2,2,0,0,-7,0,3,-8,5,-5,0,0,-1,0,0,-1,2,-1
KR_6668713085,420,1,19,4,0,-6,9,3,2,0,2,0,2,2,4,3,7,0,0,0,0,-2,-74,0,-8,8,-7,0,1,-1,-1,1,1,6,-1
KR_6750434818,420,-1,-33,-5,-2,2,2,4,0,1,1,2,1,3,-6,6,0,0,0,0,-1,-14,10,-1,-3,4,-5,0,-1,1,1,-1,-1,2,-1
KR_6762553148,420,-1,1,-8,-12,-1,2,1,-1,3,2,-3,7,4,-3,3,0,-4,4,0,0,-12,6,2,-7,5,-4,0,0,-1,-1,-1,-1,2,-1
KR_6707460540,420,-1,-33,57,-6,0,0,0,-3,7,4,1,1,2,-1,2,1,-3,4,1,-1,-14,21,-2,-8,10,1,0,-1,-1,1,-1,-1,1,-1
KR_6761585583,420,-6,-61,-33,-12,-2,3,1,-2,7,5,-1,3,2,-6,6,0,-1,1,0,0,-9,15,-1,-3,4,-3,0,0,-1,1,-1,-1,5,-1
KR_6699566146,420,-8,-147,-9,-10,-7,7,0,-2,3,1,-1,1,0,0,3,3,0,3,3,0,-7,-4,-1,-4,5,1,0,-1,-1,-1,-1,-1,2,-1
KR_6760218043,420,4,49,18,4,2,0,2,0,3,3,5,1,6,-2,5,3,-1,2,1,-1,3,-2,1,-2,1,1,0,0,-1,-1,-1,-1,1,-1
KR_6749614391,420,-4,44,-18,-9,0,3,3,0,1,1,-3,4,1,-5,7,2,-1,2,1,0,-6,16,-4,-1,5,-5,0,-2,-1,-1,-1,1,5,-1
KR_6747180473,420,-1,-75,-24,4,2,2,4,3,0,3,-4,4,0,2,3,5,1,0,1,0,5,-1,-1,-4,5,-3,0,-1,0,-1,-1,1,0,-1
KR_6582048559,420,0,52,-1,0,3,0,3,-4,5,1,0,1,1,2,2,4,-1,1,0,0,-5,-21,1,-6,5,-1,0,2,-1,1,1,-1,6,-1
KR_6758717052,420,0,25,0,1,-1,2,1,4,1,5,-3,4,1,1,2,3,0,0,0,0,1,5,2,-5,3,2,0,0,-1,-1,0,-1,1,-1
KR_6637599726,420,-1,-21,21,1,2,0,2,-3,4,1,-1,1,0,2,0,2,1,0,1,0,0,-22,-2,0,2,1,0,0,1,-1,0,-1,3,-1
KR_6711962966,420,-2,9,-20,-7,-4,4,0,-5,6,1,2,2,4,0,1,1,0,1,1,1,-12,0,-4,-3,7,-3,0,0,-1,-1,0,1,5,-1
KR_6617530291,420,-1,11,-14,-2,0,2,2,-1,1,0,-1,3,2,0,4,4,0,0,0,0,-3,120,-1,-4,5,3,0,-1,-1,-1,-1,1,2,-1
KR_6732332072,420,-1,-27,9,-7,-2,3,1,-3,3,0,3,1,4,-3,3,0,-2,2,0,0,-10,2,-1,-3,4,-1,0,1,-1,1,1,1,2,-1
KR_6570701329,420,-3,-52,-32,-1,-1,2,1,-2,3,1,2,3,5,1,2,3,-1,1,0,0,-5,-7,-3,-4,7,-1,0,-1,-1,-1,-1,1,3,-1
KR_6698785253,420,-6,-44,-35,-15,-3,3,0,-5,6,1,-4,5,1,-3,7,4,0,1,1,0,-15,-3,-2,-2,4,1,0,-1,0,0,-1,-1,0,-1
KR_6759888232,420,-1,-59,-5,-2,3,1,4,0,2,2,-6,7,1,1,8,9,0,1,1,-1,-5,14,-1,-5,6,-5,0,-1,1,-1,-1,-1,6,-1
KR_6618104407,420,-3,-34,6,-6,-5,5,0,-3,3,0,-1,2,1,-1,1,0,4,0,4,0,-1,45,0,-7,7,-9,0,-1,-1,-1,-1,-1,4,-1
KR_6764610271,420,1,-9,7,13,-2,4,2,4,0,4,4,0,4,4,1,5,3,0,3,4,22,27,-1,-4,5,-3,0,0,1,1,1,-1,4,-1
KR_6753099399,440,0,-7,11,0,-1,2,1,2,2,4,1,1,2,-1,4,3,-1,1,0,-1,-3,-4,-2,-3,5,-1,0,0,-1,1,0,-1,3,-1
KR_6763010721,440,-2,-4,-9,-4,-1,2,1,0,0,0,0,2,2,-2,4,2,-1,2,1,0,-7,22,5,-7,2,-6,0,0,-1,1,0,-1,3,-1
KR_6763336017,420,0,10,-16,-2,-1,2,1,-4,5,1,3,2,5,1,4,5,-1,3,2,0,-4,-116,1,-6,5,-4,0,1,-1,-1,1,-1,6,-1
KR_6763183709,420,-5,-23,-36,-10,-2,3,1,-1,1,0,-2,3,1,-4,6,2,-1,1,0,-1,-16,-7,0,-7,7,0,0,-2,-1,-1,-1,-1,6,-1
KR_6749712141,420,-7,-102,-30,-16,-7,8,1,0,2,2,-5,5,0,-2,2,0,-2,2,0,0,-10,1,2,-8,6,-4,0,-3,-1,-1,-1,-1,5,-1
KR_6732495521,420,0,-2,20,-7,1,1,2,-2,4,2,-2,5,3,-2,4,2,-2,2,0,0,-13,-3,-1,-6,7,0,0,-1,-1,1,-1,-1,5,-1
KR_6760681904,420,-4,-155,-23,-5,-4,4,0,0,2,2,0,2,2,-1,3,2,0,1,1,1,6,-7,-2,-3,5,-2,0,0,-1,-1,-1,-1,2,-1
KR_6763961817,420,7,96,49,9,1,0,1,6,2,8,1,1,2,3,4,7,-2,2,0,-2,4,9,6,-9,3,6,0,2,1,1,1,-1,6,-1
KR_6750216103,420,-3,-25,-23,-2,-3,5,2,0,4,4,-1,2,1,2,2,4,0,2,2,0,6,-13,-3,-3,6,2,0,-1,1,1,-1,-1,2,-1
KR_6697045661,420,0,56,11,2,7,1,8,-2,3,1,0,2,2,-3,3,0,0,2,2,0,-7,0,0,-3,3,-1,0,1,0,-1,-1,1,0,-1
KR_6755849089,420,-2,-51,4,-6,-3,5,2,3,1,4,-5,6,1,-2,2,0,1,0,1,0,2,-36,1,-3,2,9,0,-2,-1,-1,-1,1,6,-1
KR_6762912718,420,0,31,26,2,0,2,2,6,0,6,-1,3,2,-3,3,0,0,1,1,0,3,-123,2,-4,2,1,0,0,-1,0,0,1,6,-1
KR_6762541412,440,-1,8,-9,-1,-4,4,0,-2,4,2,4,1,5,2,2,4,-1,1,0,0,1,4,2,-2,0,1,0,1,-1,1,1,-1,5,-1
KR_6744105305,420,1,52,16,4,1,0,1,5,1,6,1,1,2,-3,3,0,0,2,2,2,1,6,5,-10,5,-2,0,-1,1,-1,-1,1,1,-1
KR_6620438504,420,-12,-154,-35,-25,-6,6,0,-3,4,1,-3,5,2,-13,13,0,0,2,2,0,-19,-12,-3,-1,4,0,0,-5,-1,-1,-1,-1,2,-1
KR_6711353966,420,-3,-39,-24,-10,3,0,3,0,1,1,-4,4,0,-4,5,1,-5,5,0,-1,-15,-8,-3,-4,7,-1,0,1,-1,1,1,-1,4,-1
KR_6738664017,420,0,-2,6,-4,2,0,2,-4,7,3,-5,5,0,4,1,5,-1,1,0,0,-2,9,0,-4,4,3,0,1,1,-1,1,1,5,-1
KR_6695183341,420,-7,-113,-20,-12,-2,2,0,-4,5,1,-4,4,0,-2,2,0,0,0,0,0,-12,-5,-5,-3,8,2,0,-1,-1,-1,-1,-1,6,-1
KR_6751390969,420,-3,-87,-38,-3,-8,8,0,2,0,2,4,1,5,-2,3,1,1,0,1,0,1,-4,0,-4,4,-2,0,-2,1,-1,-1,1,5,-1
KR_6654240709,420,-3,10,-7,-4,2,1,3,-1,2,1,-5,6,1,2,0,2,-2,2,0,0,-3,-6,2,-9,7,0,0,-1,-1,-1,-1,-1,1,-1
KR_6734516204,440,1,33,-11,4,6,0,6,-2,3,1,1,2,3,-1,3,2,0,0,0,0,-2,-7,-1,-5,6,0,0,0,0,1,-1,-1,0,-1
KR_6750074880,420,1,-25,-4,-4,0,2,2,-1,3,2,1,1,2,-5,8,3,1,3,4,-1,1,4,0,-6,6,-6,0,-1,1,1,-1,-1,1,-1
KR_6635272183,420,-2,20,-32,4,-5,5,0,2,0,2,1,2,3,4,1,5,2,0,2,0,13,-30,7,-7,0,-1,0,0,-1,1,1,-1,6,-1
KR_6726664944,420,-1,38,-47,-5,-5,7,2,-1,3,2,0,3,3,1,1,2,0,2,2,0,0,3,1,-4,3,-4,0,0,-1,-1,0,-1,6,-1
KR_6760656085,420,1,2,-26,10,0,1,1,2,2,4,1,3,4,7,0,7,0,1,1,0,8,40,3,-5,2,-21,0,0,-1,1,1,1,4,-1
KR_5752366031,420,1,46,-12,-3,0,1,1,-3,7,4,0,3,3,0,2,2,0,1,1,-3,-7,68,1,-8,7,-6,0,0,-1,1,1,-1,5,-1
KR_6765027433,420,0,40,-28,-1,0,3,3,-1,2,1,2,3,5,-1,3,2,-1,1,0,0,-10,3,1,-4,3,0,0,1,-1,1,1,-1,5,-1
KR_6755822455,420,-2,-19,-9,-7,1,1,2,-4,5,1,-1,4,3,-3,3,0,0,2,2,1,-10,-14,1,-6,5,-1,0,0,-1,0,1,1,4,-1
KR_6333714816,420,-5,-95,33,-11,-1,3,2,-4,7,3,-3,7,4,0,3,3,-3,3,0,0,-5,162,-1,-4,5,-3,0,-1,1,0,-1,-1,1,-1
KR_6745339493,440,-6,-6,-24,-10,1,1,2,-6,8,2,-1,1,0,-1,3,2,-3,4,1,0,-15,-2,-1,-4,5,2,0,0,-1,1,-1,-1,5,-1
KR_6741915236,420,-4,-5,0,-11,-4,4,0,-1,3,2,-4,6,2,-3,4,1,1,0,1,1,-10,4,1,-8,7,-8,0,0,1,1,-1,1,4,-1
KR_6758054844,420,-5,-69,-28,-13,-3,4,1,-1,4,3,-3,4,1,-6,6,0,0,1,1,0,-5,-11,4,-6,2,-3,0,-3,-1,-1,-1,-1,1,-1
KR_6746386840,440,-4,-111,-6,-8,-1,3,2,6,1,7,-9,10,1,-4,6,2,0,0,0,0,-3,235,-4,-1,5,1,0,-1,1,1,-1,-1,3,-1
KR_6718606224,420,0,-51,6,1,-1,2,1,1,2,3,4,2,6,-2,3,1,-1,1,0,0,0,-6,-1,-3,4,-3,0,1,1,-1,-1,-1,5,-1
KR_6762116595,420,-1,-28,-20,3,2,2,4,2,2,4,5,2,7,0,3,3,-6,6,0,2,16,-39,4,-7,3,21,0,-2,1,-1,-1,1,3,-1
KR_6756063521,440,0,-74,10,3,-1,2,1,-6,9,3,3,1,4,0,1,1,7,1,8,1,-1,-41,1,-5,4,-3,0,0,1,-1,1,1,3,-1
KR_6747868886,420,0,-27,24,3,1,0,1,2,1,3,4,1,5,-2,4,2,-2,3,1,0,1,-21,1,-7,6,-1,0,0,1,1,0,-1,2,-1
KR_6735792166,420,-3,-41,1,-2,1,1,2,0,2,2,0,1,1,-3,5,2,0,1,1,0,-5,7,6,-7,1,-10,0,0,1,-1,0,-1,2,-1
KR_6753839678,420,-3,-7,-4,-6,-1,1,0,-3,5,2,-1,2,1,-1,3,2,0,1,1,0,-14,8,4,-11,7,0,0,0,-1,-1,0,1,6,-1
KR_6761794455,420,-4,-70,-8,-3,5,1,6,-1,2,1,-4,4,0,-2,2,0,-1,1,0,1,-8,-6,-1,-4,5,-2,0,-1,0,1,1,1,0,-1
KR_6624653104,420,-1,2,-5,-4,3,1,4,-2,3,1,-2,4,2,-2,3,1,-1,1,0,0,-6,2,-1,-5,6,-7,0,-1,-1,-1,-1,-1,3,-1
KR_6699509321,420,-3,-26,-12,-6,-3,3,0,0,1,1,1,1,2,-6,6,0,2,2,4,0,-3,-9,-6,-4,10,2,0,-1,-1,-1,-1,-1,5,-1
KR_6713986528,420,-9,-83,-35,-21,-3,3,0,-10,10,0,-1,4,3,-8,9,1,1,0,1,0,-20,5,2,-5,3,-3,0,-1,0,-1,-1,1,0,-1
KR_6759876795,440,-1,-13,16,-5,2,0,2,0,1,1,-3,6,3,1,1,2,-5,5,0,0,-4,-14,5,-5,0,-1,0,-2,1,-1,-1,-1,2,-1
KR_6688129888,420,-1,-17,-16,-4,-1,1,0,-1,3,2,-4,7,3,1,2,3,1,1,2,-1,-6,-4,2,-7,5,1,0,0,1,-1,0,-1,2,-1
KR_6760380593,420,0,-22,4,1,0,2,2,2,3,5,0,1,1,-3,4,1,2,2,4,1,-3,-5,-4,-4,8,-1,0,0,-1,0,0,1,4,-1
KR_6608172636,420,-1,-35,-5,-10,0,1,1,0,1,1,-5,9,4,-6,9,3,1,1,2,0,-18,-16,-2,-6,8,-6,0,0,-1,-1,0,-1,3,-1
KR_6706043649,420,-1,24,-14,4,2,1,3,1,2,3,1,1,2,2,2,4,-2,3,1,0,2,-10,0,-7,7,4,0,1,-1,1,1,-1,6,-1
KR_6752714552,420,2,-21,16,0,1,0,1,-3,3,0,0,7,7,1,4,5,1,1,2,0,6,2,5,-9,4,-2,0,-1,-1,-1,-1,-1,2,-1
KR_6754569184,420,2,-27,12,-8,-1,2,1,3,1,4,0,0,0,-7,7,0,-3,4,1,0,-12,-11,-3,-3,6,-2,0,-1,-1,-1,-1,-1,1,-1
KR_6762537700,420,-7,-129,-4,-10,-1,3,2,-2,3,1,-3,4,1,-3,4,1,-1,3,2,-1,1,110,1,-4,3,-2,0,-2,1,1,-1,-1,3,-1
KR_6667765790,420,-5,-81,39,-18,-1,3,2,-4,8,4,-3,3,0,-11,11,0,1,0,1,-1,-19,-12,-2,-2,4,4,-1,-2,-1,-1,-1,-1,5,-1
KR_6753743385,420,-6,-85,-30,-10,-5,7,2,-1,4,3,-4,5,1,-1,3,2,1,1,2,0,-7,-23,-6,-3,9,2,0,-1,-1,0,-1,-1,4,-1
KR_6762632304,420,-1,-57,16,0,3,0,3,0,3,3,-1,2,1,-1,1,0,-1,1,0,2,-4,-5,1,-5,4,0,0,0,-1,1,-1,1,1,-1
KR_6687412835,420,-6,-122,-35,-9,0,0,0,0,6,6,-8,8,0,-4,9,5,3,3,6,1,3,118,2,-6,4,-9,0,-3,-1,-1,-1,1,1,-1
KR_6699027189,420,-1,-4,0,-1,2,0,2,-2,4,2,-1,1,0,0,2,2,0,0,0,0,-4,-29,0,-6,6,4,0,0,-1,0,0,1,3,-1
KR_6751003572,440,-6,-83,0,-10,-8,8,0,-3,4,1,3,3,6,-3,4,1,1,1,2,0,-6,1,2,-7,5,0,0,-3,1,-1,-1,-1,3,-1
KR_6761603129,420,-4,-91,-10,-4,-2,4,2,-2,2,0,2,0,2,-1,2,1,-1,1,0,0,-3,-14,5,-8,3,1,0,0,1,1,-1,-1,1,-1
KR_6660565684,420,1,-3,4,0,3,1,4,-1,4,3,0,0,0,-1,1,0,-1,2,1,1,-2,-15,0,-6,6,-4,0,1,-1,1,1,1,2,-1
KR_6755503258,420,3,74,-15,-5,1,1,2,-2,4,2,-4,5,1,-2,5,3,2,0,2,-3,-3,-9,-2,-4,6,1,0,0,1,-1,1,-1,5,-1
KR_6758969633,420,-1,-5,-15,-4,4,0,4,2,3,5,-3,6,3,-6,7,1,-1,1,0,0,-11,-23,8,-11,3,0,0,0,-1,1,-1,-1,3,-1
KR_6753783706,420,-3,-36,-17,-8,-1,5,4,0,1,1,1,1,2,-4,6,2,-4,6,2,0,-3,253,-6,-3,9,-1,0,0,-1,-1,0,-1,6,-1
KR_6713463186,420,1,-5,14,3,-5,5,0,8,1,9,-1,4,3,0,1,1,1,3,4,1,9,-4,2,-8,6,-6,0,-1,1,-1,-1,1,6,-1
KR_6760728473,420,0,-22,11,0,2,1,3,2,0,2,-2,4,2,-2,3,1,0,0,0,0,0,59,4,-9,5,-11,0,0,-1,1,0,-1,1,-1
KR_6748759077,420,0,71,-24,-2,3,1,4,-1,2,1,1,2,3,-6,7,1,1,1,2,1,-6,-21,3,-6,3,1,0,-1,-1,-1,-1,1,3,-1
KR_6760327324,440,-2,-40,-9,2,-1,3,2,-3,4,1,1,2,3,7,2,9,-2,2,0,0,4,7,0,-3,3,-2,0,-2,0,1,-1,-1,0,-1
KR_6759348234,420,-2,0,-12,-3,5,1,6,-4,6,2,2,1,3,3,0,3,-9,9,0,-4,-17,-3,-1,-2,3,-2,0,1,-1,1,1,-1,5,-1
KR_6759013789,420,2,32,-12,5,3,0,3,-4,6,2,5,2,7,6,0,6,-5,5,0,0,0,-53,-2,-5,7,18,0,0,0,-1,0,1,0,-1
KR_6742883631,420,-2,15,-15,-7,2,0,2,-6,7,1,0,0,0,-2,2,0,-1,2,1,0,-8,2,-2,-5,7,-3,0,-1,-1,1,-1,-1,2,-1
KR_6747139098,420,3,67,0,1,-1,4,3,0,3,3,0,1,1,2,3,5,0,0,0,0,-6,0,-1,-5,6,1,0,-1,1,-1,-1,1,1,-1
KR_6730578693,420,-6,-69,-68,-9,-1,2,1,-4,6,2,0,3,3,-3,3,0,-1,1,0,-1,-9,-4,-4,-2,6,2,0,-1,-1,-1,-1,-1,6,-1
KR_6763516687,440,-1,22,-21,-7,-2,2,0,0,2,2,-7,7,0,0,2,2,2,0,2,0,-8,3,0,-4,4,4,0,1,-1,1,1,-1,6,-1
KR_6761270294,420,-2,7,-12,-7,0,1,1,4,2,6,-2,4,2,-5,7,2,-4,4,0,0,1,-26,-3,-5,8,-4,0,-1,-1,-1,-1,1,1,-1
KR_6698015661,420,-1,-35,-23,-2,-3,5,2,-4,6,2,-1,4,3,5,2,7,1,1,2,-1,-5,38,2,-8,6,-7,0,-1,0,0,-1,-1,0,-1
KR_6755648635,440,3,86,20,4,6,1,7,-7,12,5,3,1,4,1,3,4,1,1,2,1,2,120,-4,-2,6,1,0,3,0,1,1,1,0,-1
KR_6761661807,440,0,-49,-4,2,0,2,2,1,0,1,6,0,6,-5,5,0,0,0,0,0,4,-2,3,-5,2,2,0,-1,0,0,-1,-1,0,-1
KR_6752963321,420,-4,-3,-52,-6,0,1,1,-6,6,0,-1,2,1,0,4,4,1,0,1,0,-5,-13,3,-8,5,-6,0,0,-1,-1,0,-1,3,-1
KR_6762950178,420,-3,26,-45,-4,-3,5,2,0,1,1,1,0,1,-2,2,0,0,0,0,0,-3,-274,6,-10,4,2,0,-1,-1,-1,-1,-1,1,-1
KR_6692366693,420,-6,-75,-28,-19,-3,4,1,-3,3,0,1,3,4,-13,13,0,-1,1,0,-2,-21,4,0,-3,3,-3,0,-2,-1,-1,-1,-1,4,-1
KR_6762446469,420,0,3,3,3,-1,3,2,0,1,1,2,0,2,2,1,3,0,1,1,0,0,37,-2,-5,7,-27,0,-1,-1,1,-1,-1,1,-1
KR_6331471287,420,0,4,-8,0,-2,5,3,2,1,3,-2,2,0,2,1,3,0,1,1,0,3,-3,-8,-2,10,-2,0,0,-1,0,1,1,5,-1
KR_6744184653,420,-2,-54,-6,-6,-1,4,3,1,0,1,4,1,5,-4,5,1,-6,7,1,0,-5,33,2,-9,7,-23,0,1,-1,0,1,-1,2,-1
KR_6764789431,420,-4,-6,-12,-10,-5,6,1,1,3,4,1,0,1,-5,6,1,-2,2,0,-1,-8,6,4,-5,1,2,0,-1,0,0,-1,-1,0,-1
KR_6494606340,420,-3,-74,-37,-11,-3,3,0,-9,10,1,-2,4,2,1,1,2,2,0,2,0,-5,19,1,-5,4,4,0,-2,-1,-1,-1,1,4,-1
KR_6629923167,420,1,15,-4,-1,1,0,1,-3,6,3,-3,3,0,4,2,6,0,0,0,0,3,10,2,-5,3,-7,0,0,1,-1,-1,-1,2,-1
KR_6760066148,440,2,42,12,4,0,1,1,1,1,2,1,1,2,2,0,2,0,1,1,0,-1,0,0,-2,2,0,0,0,1,-1,0,1,2,-1
KR_6579814209,420,-3,-48,4,-6,0,1,1,1,3,4,-1,2,1,-4,5,1,-2,4,2,0,-4,-69,-5,-3,8,-4,0,0,1,1,-1,-1,5,-1
KR_6752517190,420,1,33,-52,6,2,1,3,3,0,3,3,1,4,-3,3,0,1,1,2,0,6,7,-1,-3,4,0,0,0,-1,-1,-1,-1,2,-1
KR_6695097468,420,3,21,33,13,1,2,3,3,3,6,-1,2,1,10,3,13,0,0,0,0,11,-5,-2,-6,8,4,0,0,1,1,0,1,3,-1
KR_6675513630,420,-2,-22,13,-5,-3,5,2,5,0,5,-3,4,1,-3,3,0,-1,2,1,0,-3,-16,2,-8,6,-3,0,0,-1,-1,0,1,4,-1
KR_6761734951,420,-5,-51,-38,-17,-2,3,1,2,1,3,-2,2,0,-9,10,1,-6,6,0,-1,-15,111,-1,-3,4,2,0,-1,-1,1,-1,-1,1,-1
KR_6763869780,420,-7,-126,-19,-10,-4,4,0,-4,6,2,-4,4,0,3,0,3,-1,1,0,0,-6,-8,-3,-4,7,-2,0,-2,-1,1,-1,-1,6,-1
KR_6651869507,420,-2,-73,3,-8,1,1,2,-2,3,1,-5,6,1,-1,1,0,-1,1,0,0,-14,-8,0,-7,7,0,0,-1,-1,-1,-1,1,1,-1
KR_6759933785,420,-5,-39,-10,-6,0,3,3,-2,3,1,-6,7,1,1,2,3,1,0,1,2,1,1,-5,-6,11,-6,0,-1,1,-1,-1,1,4,-1
KR_6764699363,420,2,5,16,5,5,0,5,0,1,1,0,1,1,-2,8,6,2,0,2,0,1,-14,-3,-5,8,2,0,1,1,1,1,-1,2,-1
KR_6742920170,420,-5,-88,-26,-11,-1,1,0,-4,4,0,-5,5,0,-2,5,3,1,0,1,0,-12,-10,-1,-7,8,-6,0,-3,1,-1,-1,-1,2,-1
KR_6666922657,420,-1,15,8,0,3,1,4,-2,5,3,-2,5,3,1,4,5,0,1,1,-2,-17,-4,1,-6,5,2,0,0,-1,1,-1,-1,2,-1
KR_6609128711,420,-3,-59,-13,-7,-2,2,0,-1,6,5,-3,5,2,0,2,2,-1,3,2,0,-7,9,3,-10,7,-8,0,0,-1,1,0,-1,4,-1
KR_6730659861,420,0,1,-30,-2,0,1,1,-4,5,1,-3,4,1,5,0,5,0,0,0,0,2,2,-1,-1,2,1,0,0,-1,-1,0,-1,3,-1
KR_6696862580,420,1,26,36,0,-1,1,0,0,2,2,1,3,4,1,1,2,-1,1,0,1,4,6,3,-11,8,1,0,-1,1,1,-1,1,3,-1
KR_6751268612,420,2,23,-7,6,0,2,2,1,2,3,1,2,3,2,3,5,2,0,2,0,8,10,5,-11,6,-7,0,1,-1,1,1,-1,5,-1
KR_6371179164,420,1,73,5,-7,-1,1,0,-7,9,2,-5,7,2,2,2,4,4,0,4,-1,-6,0,0,0,0,-1,0,0,-1,-1,0,-1,3,-1
KR_6760490516,420,1,76,-11,9,5,0,5,-3,6,3,2,3,5,6,2,8,-1,1,0,2,7,7,7,-11,4,2,0,0,0,1,1,1,0,-1
KR_6752129743,440,-4,-18,-27,-17,-4,5,1,-3,4,1,-1,3,2,-9,9,0,0,2,2,1,-17,26,-4,-1,5,-8,0,-1,-1,-1,-1,1,4,-1
KR_6682460347,420,1,5,-16,7,0,1,1,-1,4,3,3,1,4,7,4,11,-2,2,0,1,20,-14,0,-6,6,7,0,0,1,1,0,1,1,-1
KR_6762769924,420,-2,-4,-24,-3,-2,3,1,0,3,3,-1,5,4,2,1,3,-2,4,2,1,-6,-1,1,-6,5,-2,0,1,-1,1,1,1,6,-1
KR_6757569613,420,-1,12,-4,-11,-3,4,1,-4,5,1,1,1,2,3,2,5,-8,8,0,0,-6,15,-3,-2,5,0,0,-2,0,-1,-1,-1,0,-1
KR_6755425811,420,-3,16,-20,2,-2,3,1,2,2,4,2,1,3,1,6,7,-1,2,1,0,-3,-20,1,-4,3,0,0,0,-1,1,1,-1,1,-1
KR_6764148606,420,2,-7,32,8,2,1,3,0,5,5,6,1,7,0,3,3,0,0,0,0,-3,5,3,-4,1,3,0,0,1,-1,0,1,3,-1
KR_6760565298,420,0,-27,-8,0,1,1,2,-3,6,3,1,2,3,0,4,4,1,1,2,1,-4,4,-3,-1,4,-4,0,1,-1,-1,1,-1,1,-1
KR_6731678061,420,2,-4,15,-1,-6,6,0,0,1,1,4,0,4,-1,5,4,2,0,2,0,5,-5,-1,-4,5,1,0,-2,1,-1,-1,-1,3,-1
KR_6655419167,440,-1,15,-11,-3,1,2,3,-4,4,0,-4,5,1,6,1,7,-2,2,0,-1,-11,3,10,-11,1,-4,0,0,-1,1,1,1,6,-1
KR_6752647608,420,-3,-116,-18,-7,-6,8,2,-1,2,1,-3,4,1,2,1,3,1,0,1,0,2,25,2,-6,4,-5,0,-1,-1,-1,-1,-1,2,-1
KR_6755636133,420,-2,-27,-5,-4,4,1,5,-1,3,2,-4,6,2,-2,4,2,-1,1,0,0,-2,-31,0,-6,6,-2,0,-1,0,-1,-1,1,0,-1
KR_6749117369,440,-1,-2,-16,-5,-1,4,3,-3,4,1,1,3,4,-1,1,0,-1,1,0,0,-10,-1,-1,-4,5,-6,0,-1,-1,-1,-1,1,5,-1
KR_6763143542,440,-3,-72,-7,-1,-2,2,0,-5,5,0,6,1,7,0,0,0,0,1,1,0,0,-22,-2,-4,6,1,0,1,1,-1,1,-1,1,-1
KR_6397754110,440,-7,-176,-24,-24,0,0,0,0,1,1,-4,4,0,-5,5,0,-15,17,2,-1,-28,-8,-5,-2,7,-1,0,-2,0,-1,-1,-1,0,-1
KR_6654764840,420,-5,-70,-9,-14,0,1,1,-4,4,0,-2,4,2,-10,10,0,2,1,3,0,-10,-1,-3,-3,6,0,0,0,0,-1,-1,1,0,-1
KR_6694525052,420,-2,-27,-20,-6,-4,4,0,-2,3,1,-2,2,0,1,3,4,1,1,2,0,1,0,0,-4,4,5,0,0,0,-1,-1,-1,0,-1
KR_6700799592,420,-2,-20,-8,-6,-4,5,1,5,1,6,-1,3,2,-6,6,0,0,0,0,0,1,-5,-5,-4,9,7,0,-1,-1,-1,-1,-1,6,-1
KR_6764352680,420,-2,-30,-16,-7,-1,3,2,-3,7,4,3,2,5,-6,9,3,0,2,2,0,-11,-16,-3,-5,8,-2,0,-1,1,-1,-1,-1,6,-1
KR_6700915663,420,1,55,4,3,-3,3,0,2,1,3,1,2,3,2,0,2,1,0,1,0,0,5,0,-4,4,1,0,0,1,-1,1,1,2,-1
KR_6758606056,420,-4,20,-21,-13,-2,3,1,-4,6,2,0,4,4,-8,9,1,1,1,2,0,-10,-1,-2,-2,4,-2,0,0,-1,-1,1,-1,4,-1
KR_6571232615,420,-1,-50,14,-16,-5,6,1,-2,10,8,-1,4,3,-3,6,3,-5,5,0,-4,-14,-8,0,-3,3,0,0,-2,-1,1,-1,-1,2,-1
KR_6759945892,420,1,16,3,0,-1,1,0,3,4,7,2,1,3,-5,6,1,1,0,1,0,0,-11,-1,-3,4,-1,0,0,1,-1,-1,-1,5,-1
KR_6482822998,420,0,-35,-8,0,-4,4,0,3,2,5,2,0,2,-2,3,1,1,0,1,0,1,-3,-3,-3,6,1,0,-1,-1,-1,-1,1,3,-1
KR_6743706423,440,2,24,7,2,-2,2,0,2,0,2,0,1,1,1,0,1,1,0,1,0,6,9,-1,-4,5,-2,0,0,1,-1,1,1,3,-1
KR_6760782239,420,-3,-25,-37,1,3,5,8,-1,2,1,-1,3,2,1,3,4,-1,2,1,0,3,1,1,-3,2,2,0,0,1,1,0,1,2,-1
KR_6754820398,420,1,21,8,1,-3,3,0,-1,1,0,2,3,5,3,3,6,0,1,1,0,3,-1,-6,-4,10,0,0,0,1,1,0,1,3,-1
KR_6764083312,420,0,27,-29,1,-5,6,1,-3,3,0,3,3,6,5,1,6,1,1,2,-1,2,4,1,-7,6,0,0,-1,0,-1,-1,-1,0,-1
KR_6698136804,420,2,-44,-22,7,2,2,4,2,0,2,2,2,4,1,2,3,0,0,0,-1,11,51,-3,-4,7,1,0,0,1,-1,-1,-1,2,-1
KR_6744509766,420,-4,-99,-57,-10,1,1,2,1,2,3,-1,2,1,-7,8,1,-4,6,2,0,-1,-43,-2,-1,3,-1,0,-1,-1,1,-1,-1,4,-1
KR_6741457640,440,0,74,-8,-8,-1,3,2,-2,5,3,0,1,1,1,2,3,-6,6,0,0,-9,-19,0,-5,5,-2,0,-1,1,1,-1,-1,2,-1
KR_6512328529,420,-6,-57,-50,-9,-2,4,2,-4,5,1,-2,3,1,2,2,4,-3,3,0,-1,-11,0,-2,-6,8,-1,0,-1,-1,1,-1,-1,6,-1
KR_6738217817,420,-4,-51,-35,-4,-1,1,0,-6,6,0,0,2,2,1,4,5,2,1,3,0,-5,-45,-5,-3,8,35,0,-1,-1,-1,-1,-1,6,-1
KR_6700755476,420,-2,-6,5,-6,4,0,4,-1,3,2,-1,4,3,-6,8,2,-2,3,1,0,-12,-1,-2,-5,7,-5,0,-1,-1,-1,1,1,5,-1
KR_6761575067,420,1,62,-12,-5,-1,1,0,0,4,4,-5,7,2,-1,4,3,2,1,3,0,-3,-13,-1,-5,6,4,0,0,-1,1,0,-1,4,-1
KR_6747361489,420,1,-2,24,7,0,2,2,2,1,3,5,2,7,5,1,6,-5,5,0,0,1,-9,-1,-4,5,1,0,0,1,-1,1,1,4,-1
KR_6755495886,440,-1,-54,19,-9,-4,4,0,1,1,2,-7,7,0,0,2,2,1,1,2,-1,-9,3,-5,0,5,4,0,1,-1,0,-1,-1,1,-1
KR_6765151100,420,0,7,16,-1,2,1,3,1,1,2,-2,3,1,-2,2,0,0,0,0,0,-6,2,-1,-6,7,-5,0,0,-1,0,0,1,4,-1
KR_6687317968,420,-3,-15,-24,-8,1,4,5,-8,10,2,-2,5,3,1,2,3,0,2,2,0,-7,-14,-8,-3,11,6,0,-1,-1,-1,-1,-1,1,-1
KR_6696461402,420,-2,16,-17,-5,0,1,1,0,5,5,0,2,2,-5,6,1,0,1,1,0,-13,-62,0,-5,5,0,0,0,1,-1,-1,1,5,-1
KR_6700263329,420,0,-35,26,2,1,1,2,3,4,7,5,1,6,-8,10,2,1,0,1,2,1,35,2,-6,4,-4,0,0,-1,1,0,1,4,-1
KR_6702284397,420,-5,-108,-25,-12,-2,2,0,-1,7,6,-8,8,0,-1,2,1,0,0,0,-2,-5,2,3,-5,2,2,0,-1,-1,1,-1,-1,2,-1
KR_6760009332,420,-2,-38,-26,-5,-1,2,1,-2,6,4,0,1,1,-5,5,0,3,1,4,0,-8,-9,-5,-1,6,3,0,-2,-1,-1,-1,-1,5,-1
KR_6691245004,420,-6,-132,-13,-8,-2,4,2,-1,3,2,-5,8,3,2,2,4,-2,2,0,-1,-3,-5,-2,-2,4,-5,0,-4,-1,-1,-1,-1,2,-1
KR_6538584805,440,2,-45,-11,6,3,2,5,1,0,1,2,0,2,2,3,5,-2,2,0,0,8,13,5,-10,5,-2,0,0,1,1,-1,-1,4,-1
KR_6753609096,420,0,-22,-14,-1,0,1,1,-2,3,1,0,1,1,-2,2,0,3,0,3,0,-4,-2,-3,-3,6,-3,0,0,-1,-1,-1,-1,5,-1
KR_6761582525,420,-1,-4,5,-5,-2,2,0,0,2,2,3,1,4,-5,5,0,-1,2,1,-1,-5,-5,-5,-4,9,1,0,0,-1,-1,-1,-1,5,-1
KR_6718524689,420,-1,-63,-4,-11,2,2,4,-2,3,1,-3,4,1,-6,6,0,-2,2,0,0,-10,8,3,-7,4,-3,0,0,-1,1,0,-1,3,-1
KR_6669338624,420,-5,-50,-25,-11,-2,3,1,-1,2,1,-7,10,3,0,2,2,-1,1,0,-1,-2,-108,-5,-4,9,1,0,-2,-1,-1,-1,-1,2,-1
KR_6762648026,420,-4,3,13,-13,-2,2,0,0,2,2,-10,10,0,1,1,2,-2,3,1,-1,-12,4,-3,-3,6,1,0,0,1,-1,-1,-1,2,-1
KR_6728991249,420,-3,-41,0,-1,-1,3,2,2,0,2,0,2,2,0,5,5,-2,3,1,0,4,16,0,-4,4,3,0,0,-1,1,-1,1,1,-1
KR_6684489891,420,1,14,10,-2,-4,4,0,0,2,2,2,1,3,-1,1,0,1,1,2,-2,-3,6,-6,-3,9,6,0,1,1,1,1,-1,1,-1
KR_6746262164,420,-2,-91,-16,-6,-5,5,0,5,6,11,-5,6,1,-1,2,1,0,2,2,0,2,0,-4,-5,9,-4,0,-4,1,-1,-1,-1,3,-1
KR_6747348049,420,-5,-45,-39,-11,-4,5,1,0,1,1,-2,3,1,-4,4,0,-1,1,0,0,-9,6,-1,-6,7,-2,0,-1,-1,-1,-1,-1,2,-1
KR_6762507619,420,-3,-18,16,-1,-4,4,0,4,2,6,-2,3,1,1,0,1,0,0,0,0,0,-51,2,-5,3,-3,0,1,0,1,1,1,0,-1
KR_6688517965,420,2,-70,4,2,2,2,4,-3,5,2,0,6,6,3,2,5,0,0,0,0,9,-269,-2,-5,7,1,0,-1,-1,1,-1,-1,1,-1
KR_6761911708,420,0,-8,18,-2,2,1,3,-1,2,1,-3,3,0,-1,3,2,1,1,2,0,-6,123,-9,0,9,-2,0,1,-1,1,1,1,4,-1
KR_6756471064,420,-4,-125,0,-9,-4,4,0,3,1,4,-1,2,1,-4,5,1,-3,3,0,0,1,148,1,-6,5,19,0,-3,-1,-1,-1,-1,5,-1
KR_6638987781,420,0,26,-16,5,0,1,1,-3,3,0,1,2,3,6,0,6,1,0,1,0,9,4,0,-4,4,-2,0,0,1,0,-1,1,3,-1
KR_6748562836,440,-1,-76,32,-10,0,2,2,0,3,3,-2,4,2,-6,8,2,-2,4,2,0,-9,-4,-2,-5,7,-2,0,-1,1,-1,-1,-1,4,-1
KR_6698899264,420,1,-63,-6,-3,-2,2,0,4,1,5,-1,1,0,-2,4,2,-2,3,1,-1,-3,24,-3,-4,7,3,0,-1,-1,-1,-1,-1,5,-1
KR_6759363293,420,-1,-30,-6,-3,-1,2,1,1,3,4,-2,3,1,2,2,4,-3,3,0,0,-2,10,3,-7,4,-6,0,0,-1,-1,-1,-1,6,-1
KR_6746205861,420,-2,-39,42,-1,2,0,2,-5,7,2,1,1,2,-1,1,0,2,1,3,0,-10,-164,-5,-2,7,5,0,-1,-1,-1,-1,-1,6,-1
KR_6764289890,420,-4,-72,-12,-7,-1,2,1,0,3,3,0,1,1,-2,7,5,-4,4,0,0,-3,13,2,-7,5,0,0,-1,-1,-1,-1,-1,4,-1
KR_6681192799,420,-5,-58,-8,-15,-5,6,1,-5,5,0,-3,6,3,0,1,1,-2,3,1,0,-4,57,0,-6,6,-24,0,-3,-1,-1,-1,-1,3,-1
KR_6762364860,420,-6,-88,6,-6,-4,4,0,1,3,4,0,5,5,-3,4,1,0,0,0,0,0,115,1,-7,6,-5,0,-1,1,-1,-1,-1,6,-1
KR_6570963170,420,-6,-64,-8,-16,-1,3,2,-5,8,3,-6,6,0,-1,3,2,-3,3,0,-2,-12,-8,-1,-2,3,2,0,-1,-1,-1,-1,-1,3,-1
KR_6675069839,420,2,6,-3,4,4,0,4,3,7,10,-2,2,0,1,2,3,-2,3,1,0,-4,9,3,-7,4,1,0,1,-1,-1,1,-1,4,-1
KR_6764070707,420,-1,4,24,3,-4,5,1,4,0,4,2,2,4,2,1,3,-1,1,0,0,6,9,0,-4,4,2,0,0,1,-1,0,-1,2,-1
KR_6762625965,420,-2,-26,25,-6,2,1,3,-5,5,0,-1,3,2,-1,4,3,-1,1,0,0,-7,4,-4,-4,8,7,0,0,-1,1,0,-1,3,-1
KR_6688377907,420,-2,-47,12,-3,0,4,4,0,1,1,-3,4,1,0,1,1,0,2,2,1,-3,6,1,-2,1,-4,0,-2,-1,-1,-1,1,1,-1
KR_6743215113,420,-3,-43,-32,-7,0,1,1,-2,6,4,0,1,1,-4,5,1,-1,2,1,0,-7,-2,4,-7,3,-3,0,0,-1,1,0,-1,5,-1
KR_6744226060,420,1,7,-8,1,0,0,0,2,6,8,1,1,2,-1,6,5,-1,2,1,0,0,8,-4,-5,9,1,0,0,1,-1,-1,1,3,-1
KR_6761186654,440,-2,-82,-8,-10,-3,3,0,-5,6,1,-2,4,2,1,1,2,-1,3,2,-1,-8,-7,-3,-2,5,-2,0,-3,-1,-1,-1,-1,2,-1
KR_6686985239,420,-4,-122,2,-2,-4,6,2,1,1,2,-1,5,4,0,1,1,2,0,2,0,-2,-1,-2,-2,4,-3,0,-1,-1,-1,-1,-1,3,-1
KR_6646724351,420,-3,-34,7,-20,0,1,1,-5,6,1,-3,3,0,-10,12,2,-2,2,0,0,-35,-7,-5,-3,8,-6,0,0,-1,-1,-1,1,3,-1
KR_6709980898,420,-3,-92,40,-11,-1,4,3,-3,4,1,-2,3,1,-6,8,2,1,2,3,0,-13,11,-1,-7,8,-7,0,-1,-1,-1,-1,1,6,-1
KR_6737758520,420,1,-9,-13,-1,4,0,4,-4,6,2,1,5,6,-4,6,2,2,0,2,-1,-10,3,2,-8,6,-1,0,0,1,-1,-1,-1,2,-1
KR_6732126418,420,0,27,40,-6,1,0,1,-5,5,0,1,0,1,-2,2,0,-1,1,0,0,-10,107,2,-7,5,-3,0,0,-1,1,0,-1,6,-1
KR_6734818203,420,-4,-12,0,-9,-1,3,2,-5,7,2,-1,2,1,-2,4,2,0,2,2,0,-17,2,-5,-4,9,4,0,-1,1,-1,-1,-1,3,-1
KR_6757045922,420,-3,-58,-27,-9,-6,8,2,-4,4,0,3,0,3,-1,3,2,-1,4,3,-2,-7,14,-6,-1,7,2,0,-1,1,-1,-1,-1,1,-1
KR_6762291572,420,2,50,0,2,1,2,3,0,2,2,0,2,2,1,3,4,0,1,1,1,5,-157,0,-6,6,23,0,-1,-1,1,-1,1,1,-1
KR_6755680900,420,-1,-12,-7,-4,-3,4,1,-5,6,1,-2,3,1,4,2,6,2,0,2,0,-14,0,-1,-4,5,4,0,0,1,-1,-1,-1,6,-1
KR_6750385589,420,-1,-36,10,-1,-5,6,1,1,2,3,-2,4,2,1,1,2,4,2,6,0,8,33,3,-6,3,-1,0,-1,0,-1,-1,-1,0,-1
KR_6760621547,420,-3,25,-35,0,1,0,1,-2,3,1,3,1,4,-1,3,2,-1,1,0,0,2,292,3,-7,4,-2,0,0,0,-1,0,-1,0,-1
KR_6685385764,420,-4,-41,-14,0,-3,5,2,2,2,4,4,1,5,-2,3,1,-1,2,1,0,5,13,5,-6,1,-3,0,0,1,1,1,-1,6,-1
KR_6764240223,420,-1,41,-44,0,-2,3,1,2,4,6,3,1,4,-3,6,3,0,0,0,0,-1,-2,1,-6,5,5,0,0,1,-1,0,-1,2,-1
KR_6697099752,420,1,42,-10,1,3,1,4,1,1,2,-1,4,3,-3,3,0,1,1,2,0,4,9,1,-4,3,1,0,0,-1,-1,0,1,5,-1
KR_6729934559,420,1,-18,-12,-1,-1,1,0,0,3,3,-1,3,2,2,2,4,-1,2,1,0,0,-15,-1,-4,5,3,0,-1,-1,-1,-1,1,3,-1
KR_6710131181,420,1,97,-28,1,0,0,0,0,2,2,1,2,3,-1,6,5,1,1,2,1,9,17,-1,-5,6,-4,0,1,-1,-1,1,1,4,-1
KR_6708631391,420,-3,-32,5,-7,-5,5,0,1,3,4,2,3,5,-1,3,2,-4,4,0,0,-2,127,-3,-5,8,-1,0,0,-1,1,-1,1,5,-1
KR_6465315225,440,-2,-48,-17,-5,-3,8,5,-1,1,0,1,0,1,-3,3,0,1,0,1,0,-2,-13,1,-4,3,2,0,-1,1,-1,-1,-1,6,-1
KR_6751465041,420,-3,-104,2,0,-2,4,2,0,5,5,-4,8,4,8,0,8,-2,3,1,0,6,8,3,-7,4,1,0,0,1,1,1,1,4,-1
KR_6758383826,420,-2,-39,0,-6,-2,3,1,-5,5,0,-3,4,1,6,1,7,-2,2,0,0,-4,18,2,-3,1,0,0,-1,-1,0,-1,-1,1,-1
KR_6758837130,420,-2,-45,-23,-7,4,0,4,-4,6,2,3,2,5,-10,11,1,0,2,2,0,-10,-3,-5,-3,8,2,0,1,-1,1,-1,-1,1,-1
KR_6763797209,420,-4,-98,-2,-7,0,4,4,2,3,5,-5,6,1,-1,2,1,-3,4,1,0,5,-29,0,-5,5,-3,0,-4,-1,-1,-1,-1,2,-1
KR_6718284068,420,0,-8,21,-6,-2,2,0,-2,5,3,-4,7,3,1,0,1,1,0,1,0,-5,44,3,-7,4,-28,0,-1,1,-1,-1,-1,1,-1
KR_6624392353,420,-3,0,-20,-4,-2,2,0,-4,5,1,1,2,3,3,1,4,-2,3,1,0,-8,-7,2,-8,6,-1,0,0,1,-1,-1,-1,4,-1
KR_6764430818,420,-8,-100,-32,-18,-7,10,3,-3,5,2,-2,4,2,-5,5,0,-1,2,1,-2,-16,5,-1,-1,2,-3,0,-2,1,-1,-1,-1,1,-1
KR_6752703592,420,0,-6,7,-3,-2,4,2,0,3,3,3,0,3,-3,5,2,-1,1,0,0,1,2,3,-5,2,1,0,0,1,-1,0,-1,2,-1
KR_6752350130,420,-3,-40,20,-4,-1,2,1,-3,3,0,-1,3,2,1,1,2,0,0,0,0,-6,4,-2,-5,7,-1,0,0,1,1,0,1,3,-1
KR_6763488900,420,3,38,0,6,6,0,6,-4,5,1,2,1,3,0,2,2,2,1,3,1,3,9,0,-6,6,2,0,1,1,-1,1,1,1,-1
KR_6732836490,420,1,-32,3,-2,-3,7,4,7,1,8,-4,4,0,0,2,2,-2,2,0,0,1,14,2,-4,2,-1,0,1,-1,-1,-1,-1,2,-1
KR_6764518388,420,0,-70,10,4,1,1,2,3,2,5,5,0,5,-3,3,0,-2,2,0,0,-3,-18,3,-7,4,2,0,0,1,0,0,1,3,-1
KR_6736781673,420,0,14,-20,-1,1,0,1,-1,3,2,-4,6,2,2,0,2,1,0,1,-1,2,239,-1,-3,4,0,0,0,-1,0,0,-1,4,-1
KR_6763442606,420,-1,8,-20,0,-3,3,0,1,4,5,1,7,8,0,3,3,1,0,1,0,10,-34,3,-7,4,11,0,-1,1,1,-1,-1,6,-1
KR_6666605381,420,-4,-47,3,-9,-4,5,1,0,4,4,-2,4,2,-5,6,1,2,0,2,-1,-13,-3,-2,-2,4,2,0,-1,-1,-1,-1,-1,3,-1
KR_6710988002,420,0,-17,-24,2,-1,2,1,0,4,4,0,2,2,8,0,8,-5,6,1,0,-1,-235,6,-9,3,-2,0,0,1,1,1,1,3,-1
KR_6669081932,420,0,-47,-31,5,-5,6,1,2,3,5,3,1,4,4,2,6,1,0,1,0,8,11,3,-7,4,-5,0,-1,-1,1,-1,1,4,-1
KR_6763239782,420,0,8,-9,3,1,0,1,0,1,1,3,0,3,-2,4,2,1,1,2,0,7,5,1,-6,5,-3,0,0,1,-1,0,-1,5,-1
KR_6734643827,420,-6,-56,-19,4,0,0,0,2,1,3,-3,3,0,1,2,3,4,0,4,0,4,7,-3,-3,6,1,0,-2,-1,-1,1,1,2,-1
KR_6758341739,420,4,60,16,2,4,0,4,2,3,5,-3,4,1,-1,5,4,0,2,2,0,-5,-167,4,-7,3,-19,0,1,-1,1,1,1,6,-1
KR_6758463815,420,-2,-77,8,-5,0,1,1,-3,6,3,-2,3,1,-4,5,1,4,1,5,-1,-5,1,1,-4,3,-1,0,-1,0,0,-1,-1,0,-1
KR_6697855255,420,-7,-63,-24,-17,-7,8,1,-4,6,2,-4,4,0,0,1,1,-2,2,0,-2,-12,-12,-4,-3,7,1,0,-2,-1,-1,-1,-1,5,-1
KR_6765475301,420,-1,-10,-25,-1,0,2,2,2,1,3,2,2,4,-1,4,3,-4,4,0,1,0,108,-6,-3,9,3,0,1,1,-1,1,1,4,-1
KR_6659701559,420,-4,-35,-20,-10,0,1,1,-3,5,2,0,1,1,-4,5,1,-3,3,0,0,-10,0,0,-6,6,-2,0,0,-1,-1,0,-1,2,-1
KR_6762496297,440,1,-3,6,0,0,2,2,2,1,3,-3,3,0,-1,3,2,2,0,2,0,-1,-38,3,-4,1,18,0,0,-1,-1,-1,1,6,-1
KR_6553567094,420,2,29,31,-2,3,0,3,-1,2,1,-2,3,1,-2,5,3,0,0,0,-1,-8,2,-2,-6,8,1,0,0,-1,1,1,-1,4,-1
KR_6760521435,440,-3,-82,-6,-10,0,4,4,1,1,2,-9,10,1,-2,2,0,0,2,2,-1,-6,-3,-1,-3,4,-2,0,-3,1,0,-1,-1,5,-1
KR_6696632692,420,-2,-43,-19,-4,0,4,4,3,4,7,-4,4,0,-1,4,3,-2,2,0,0,0,0,2,-5,3,1,0,-1,1,1,-1,-1,1,-1
KR_6764083013,420,-3,-12,-4,-13,0,3,3,-3,3,0,-4,4,0,-4,4,0,-2,2,0,-1,-13,-182,-5,-1,6,1,0,0,-1,-1,-1,-1,3,-1
KR_6760747054,420,-5,-24,-43,-10,-2,2,0,-4,5,1,0,1,1,-5,6,1,1,1,2,0,-9,0,-1,-3,4,0,0,0,-1,-1,-1,1,1,-1
KR_6621044378,420,-6,-73,3,-9,-4,4,0,-2,2,0,-2,2,0,-2,4,2,1,0,1,0,-10,-11,1,-6,5,-7,0,-1,1,1,-1,-1,1,-1
KR_6723469372,420,3,16,25,5,-1,3,2,1,1,2,4,0,4,-1,2,1,2,0,2,0,1,4,6,-10,4,1,0,0,0,-1,0,-1,0,-1
KR_6759863518,440,-3,-55,-17,0,-4,4,0,0,4,4,0,2,2,4,1,5,0,1,1,0,4,0,-3,-1,4,1,0,-2,-1,-1,-1,-1,3,-1
KR_6754451553,420,-5,-63,-26,-10,-1,2,1,-3,7,4,-2,3,1,-1,4,3,-3,3,0,0,-4,3,-2,-5,7,-2,0,-1,-1,-1,-1,1,5,-1
KR_6765452103,420,-1,-30,-20,-7,2,1,3,-1,3,2,0,2,2,-8,8,0,0,4,4,0,-6,7,1,-7,6,0,0,-1,1,-1,-1,-1,2,-1
KR_6742472050,440,-3,-26,14,-13,-2,3,1,-3,4,1,-3,4,1,-6,7,1,1,0,1,0,-19,7,-1,-2,3,1,0,0,-1,0,-1,-1,6,-1
KR_6609233345,420,-4,-93,-35,-2,-3,3,0,1,1,2,-3,3,0,2,3,5,1,0,1,0,6,-6,-2,-3,5,3,0,-2,1,-1,-1,1,2,-1
KR_6763502356,420,3,28,0,9,2,0,2,1,5,6,0,1,1,4,0,4,2,0,2,0,8,-1,-3,-6,9,6,0,0,-1,1,0,-1,1,-1
KR_6573813235,420,-3,-84,-22,-1,-5,5,0,5,5,10,0,2,2,-1,2,1,0,0,0,0,6,-12,-2,-4,6,0,0,1,-1,1,-1,1,5,-1
KR_6702787999,420,-1,-21,17,-4,0,0,0,1,3,4,0,2,2,-1,2,1,-4,4,0,0,-2,5,-2,-4,6,-1,0,0,-1,1,-1,-1,4,-1
KR_6761080441,420,4,29,25,-1,1,2,3,-2,4,2,3,1,4,0,2,2,-3,3,0,0,-2,4,-2,-3,5,1,0,0,-1,-1,1,1,5,-1
KR_6762903262,420,1,-60,0,-5,2,1,3,-1,6,5,-2,2,0,-4,5,1,0,2,2,0,-5,0,2,-10,8,-5,0,-1,-1,1,1,-1,5,-1
KR_6764930459,420,-3,-24,-8,-2,-1,3,2,0,1,1,-2,3,1,2,2,4,-1,1,0,-1,-9,18,-2,-5,7,-1,0,0,-1,1,-1,-1,6,-1
KR_6615972264,420,0,-37,8,-9,-1,1,0,-4,7,3,-2,2,0,-1,2,1,-1,1,0,0,-7,-33,0,-5,5,0,0,0,1,-1,0,-1,6,-1
KR_6755914969,420,0,-24,17,2,-1,1,0,1,3,4,1,1,2,0,3,3,1,1,2,0,3,-159,-1,-7,8,1,0,0,1,-1,-1,-1,5,-1
KR_6442808059,420,-5,-48,-27,-3,-2,3,1,-4,5,1,1,2,3,2,0,2,0,0,0,0,-9,-2,-3,-5,8,-6,0,-1,1,-1,-1,1,1,-1
KR_6744260903,440,-3,-25,0,-9,-7,7,0,2,0,2,-1,4,3,-1,2,1,-2,3,1,0,0,-5,1,-4,3,4,0,-2,1,-1,-1,-1,6,-1
KR_6750522080,420,-8,-116,-31,-10,-4,5,1,0,3,3,-3,3,0,-2,2,0,-1,3,2,-1,-10,-66,-6,-2,8,3,0,-2,-1,-1,-1,-1,5,-1
KR_6749580676,420,-4,-123,8,-8,-3,4,1,-1,3,2,-4,5,1,1,2,3,-1,1,0,-2,-9,2,1,-4,3,-6,0,-2,-1,-1,-1,-1,3,-1
KR_6687366032,420,-1,42,-13,3,5,0,5,-1,3,2,1,2,3,4,0,4,-6,7,1,0,3,4,1,-6,5,-5,0,-1,-1,-1,-1,1,1,-1
KR_6728069673,420,-2,9,-16,-7,1,2,3,-4,9,5,1,3,4,-2,5,3,-3,3,0,0,-17,2,-3,-5,8,-2,0,1,-1,-1,1,1,1,-1
KR_6611700247,420,1,15,-4,-2,2,0,2,0,0,0,-6,7,1,1,0,1,1,0,1,0,-4,-149,4,-6,2,-3,0,0,0,1,0,1,0,-1
KR_6595122513,420,-1,-26,-35,-1,3,0,3,0,4,4,-2,2,0,-1,2,1,-1,1,0,0,-6,-3,2,-8,6,-1,0,0,-1,1,0,-1,5,-1
KR_6740288040,440,1,23,18,-6,-2,3,1,-2,4,2,1,2,3,-2,8,6,-1,2,1,-4,-8,-35,0,-5,5,3,0,0,1,-1,0,-1,5,-1
KR_6757860812,440,-2,13,-39,4,-1,2,1,3,1,4,-1,4,3,2,4,6,1,1,2,1,6,-1,2,-6,4,1,0,-1,1,-1,-1,1,2,-1
KR_6744147159,420,-5,-35,11,-15,-1,6,5,-7,9,2,0,0,0,-6,6,0,-1,2,1,0,-23,-31,-1,-5,6,2,0,-2,1,1,-1,-1,3,-1
KR_6762423972,420,-5,-17,-6,-8,-2,4,2,0,2,2,-3,3,0,-1,1,0,-2,4,2,0,-11,3,0,-5,5,-5,0,-1,-1,-1,-1,1,1,-1
KR_6578699967,440,2,16,-2,6,1,1,2,1,1,2,-1,6,5,2,3,5,3,2,5,1,7,1,-1,-5,6,2,0,0,1,1,0,1,5,-1
KR_6696498282,420,-1,-3,21,-5,4,1,5,-5,6,1,-1,1,0,-4,6,2,1,0,1,-1,-12,20,-1,-5,6,-6,0,1,-1,1,1,-1,1,-1
KR_6676387876,420,-3,-94,-31,0,3,2,5,4,1,5,-3,4,1,-3,6,3,-1,2,1,1,7,0,0,-7,7,2,0,0,1,1,0,-1,5,-1
KR_6761382758,420,-5,-107,-9,-10,0,1,1,-1,2,1,-4,4,0,-4,7,3,-1,1,0,0,-9,0,1,-4,3,-7,0,-1,-1,-1,-1,-1,4,-1
KR_6738448977,420,1,74,-6,4,1,0,1,0,4,4,0,1,1,2,0,2,1,1,2,0,5,-29,0,-4,4,16,0,0,1,0,0,1,2,-1
KR_6747218338,420,-6,-84,-12,-7,-3,3,0,2,1,3,-6,8,2,-1,3,2,1,0,1,0,-11,1,4,-9,5,1,0,-1,1,-1,-1,-1,4,-1
KR_6748376895,420,-3,-54,-32,-3,-2,2,0,-3,6,3,-2,2,0,3,1,4,1,1,2,0,2,5,1,-6,5,2,0,-1,1,-1,-1,1,6,-1
KR_6588528062,420,-4,-24,-9,-11,5,0,5,-7,8,1,-4,5,1,-5,5,0,0,0,0,0,-3,16,4,-9,5,-7,0,-1,-1,-1,-1,-1,1,-1
KR_6746065831,420,-1,-21,32,-10,0,2,2,1,2,3,-9,10,1,-6,7,1,4,0,4,1,-7,-18,-1,-3,4,-1,0,-2,-1,0,-1,1,4,-1
KR_6763425185,420,0,-31,-15,-6,-4,6,2,-1,5,4,-4,7,3,1,1,2,2,0,2,0,-1,-4,-1,-3,4,2,0,0,1,1,1,-1,5,-1
KR_6763988953,420,-6,-110,-6,-6,-3,3,0,-1,3,2,1,1,2,0,2,2,-3,3,0,0,1,-39,0,-4,4,33,0,-2,-1,1,-1,1,2,-1
KR_6745344304,420,-4,-48,4,-11,-3,3,0,-6,6,0,-2,3,1,0,4,4,0,1,1,0,-9,3,2,-5,3,-2,0,0,-1,-1,1,-1,1,-1
KR_6761301820,420,-3,-1,-41,-9,-5,5,0,-5,5,0,3,2,5,1,3,4,-3,4,1,0,-1,-15,0,-6,6,-1,0,1,-1,1,1,1,6,-1
KR_6749330316,420,-3,-82,-11,-11,-4,4,0,-3,7,4,-4,4,0,0,2,2,0,1,1,-1,-12,6,-3,-7,10,-5,0,-3,-1,-1,-1,-1,6,-1
KR_6761697907,440,-2,-71,-4,0,-2,4,2,-1,3,2,3,2,5,1,4,5,-1,2,1,0,0,14,0,-6,6,-6,0,1,-1,1,1,-1,3,-1
KR_6764929251,420,0,13,29,-6,-1,2,1,-5,6,1,2,1,3,-3,4,1,1,0,1,0,-14,-1,-1,-6,7,4,0,0,-1,1,1,-1,2,-1
KR_6762759051,420,-5,12,-48,-14,3,2,5,-1,1,0,-2,3,1,-13,13,0,-1,2,1,0,-22,-1,1,-6,5,0,0,-2,-1,1,-1,-1,2,-1
KR_6765138026,420,-1,-41,20,-8,0,1,1,-1,4,3,-1,2,1,-6,6,0,0,1,1,0,-14,10,1,-5,4,1,0,-2,-1,1,-1,-1,5,-1
KR_6759838847,420,-1,57,21,-9,1,1,2,-2,3,1,-6,6,0,-2,2,0,0,0,0,-1,-13,-37,2,-6,4,-1,0,0,1,-1,0,-1,6,-1
KR_6744753626,420,-2,-26,-17,-13,1,1,2,-3,4,1,-7,7,0,-2,5,3,-2,2,0,-1,-15,-5,1,-6,5,-4,0,-1,-1,1,-1,-1,2,-1
KR_6760631600,420,-3,-73,12,-2,-4,5,1,1,2,3,0,2,2,2,1,3,-1,2,1,0,4,-3,4,-6,2,0,0,-1,0,-1,-1,-1,0,-1
KR_6689263894,420,0,-45,8,-3,1,1,2,1,3,4,0,2,2,-4,6,2,-1,1,0,0,0,-23,-2,-4,6,-1,0,-1,1,0,-1,1,4,-1
KR_6760749518,420,3,-11,5,1,-1,4,3,1,3,4,2,2,4,-1,4,3,0,1,1,0,10,5,5,-9,4,5,0,1,1,1,1,-1,6,-1
KR_6753814333,420,-1,-22,36,-7,-2,2,0,2,2,4,-4,5,1,-1,3,2,-2,2,0,0,-12,-5,-1,-3,4,-1,0,0,-1,-1,0,-1,3,-1
KR_6667982198,420,-1,12,16,2,-1,3,2,2,4,6,-5,5,0,2,1,3,4,0,4,0,5,0,2,-5,3,0,0,0,-1,1,-1,-1,5,-1
KR_6762284126,420,1,-38,-5,-4,1,0,1,-6,6,0,-1,3,2,2,2,4,0,0,0,0,-14,-3,-5,-3,8,0,0,0,-1,1,0,1,1,-1
KR_6759473424,440,1,47,-12,1,0,2,2,-3,4,1,0,4,4,0,5,5,4,1,5,-3,-6,-27,-3,-2,5,2,0,0,-1,0,1,-1,6,-1
KR_6731037624,420,-8,-81,-61,-9,-8,9,1,3,1,4,-4,5,1,0,4,4,0,1,1,-1,-10,155,0,-4,4,-3,0,-3,-1,-1,-1,-1,3,-1
KR_6690317003,420,-1,-2,3,-4,0,4,4,1,1,2,-2,8,6,-3,7,4,0,1,1,-1,-7,-4,7,-11,4,-3,0,-1,1,-1,-1,-1,5,-1
KR_6736605845,420,-3,-66,-18,-6,0,2,2,2,3,5,-4,7,3,-1,1,0,-3,3,0,-1,-3,4,1,-8,7,0,0,0,1,-1,0,-1,4,-1
KR_6687905762,420,0,23,-11,-6,0,3,3,-2,8,6,-2,4,2,-1,2,1,-1,2,1,0,-8,15,-6,-2,8,1,0,0,-1,-1,1,1,6,-1
KR_6609833494,420,-3,-117,-22,-6,-1,3,2,-3,9,6,5,3,8,-5,10,5,-2,3,1,-2,-11,31,0,-6,6,1,0,-2,-1,-1,-1,1,4,-1
KR_6695134513,420,-2,-1,-8,-2,1,0,1,0,2,2,0,1,1,-2,4,2,-1,1,0,0,-3,4,-3,-6,9,-2,0,-1,-1,1,-1,1,5,-1
KR_6742318678,420,1,-29,20,-2,-2,2,0,0,5,5,-1,5,4,0,3,3,1,0,1,0,2,4,2,-8,6,-7,0,-2,1,-1,-1,-1,5,-1
KR_6667424796,420,-6,-68,-27,-11,-1,3,2,-2,4,2,-1,4,3,-4,6,2,-3,3,0,0,-12,261,1,-6,5,7,0,-3,-1,1,-1,1,1,-1
KR_6694432203,420,2,33,-28,7,2,2,4,-1,1,0,2,0,2,1,3,4,3,0,3,0,11,7,1,-5,4,-2,0,0,-1,1,1,1,5,-1
KR_6762699053,420,-2,3,-24,-5,0,2,2,2,0,2,-2,5,3,-5,5,0,0,1,1,0,-6,1,-1,-6,7,-3,0,-1,-1,-1,-1,1,5,-1
KR_6728180786,420,-2,-24,0,-2,1,2,3,2,1,3,-3,7,4,-3,4,1,1,3,4,0,-2,-24,7,-12,5,4,0,-1,0,0,-1,1,0,-1
KR_6727994662,420,2,-14,-9,7,-4,4,0,-1,5,4,3,2,5,8,0,8,1,0,1,0,5,-64,3,-7,4,16,0,0,1,1,-1,1,4,-1
KR_6701893780,420,-8,-12,-32,-14,-6,6,0,-2,4,2,-4,4,0,-3,4,1,1,0,1,0,-7,21,-8,-3,11,-21,0,-3,1,-1,-1,1,1,-1
KR_6681558984,440,-1,12,-13,1,2,1,3,2,2,4,-2,4,2,-1,1,0,0,2,2,0,0,-11,-5,-3,8,1,0,0,1,-1,-1,-1,3,-1
KR_6763704802,420,-2,-71,-38,-4,1,0,1,-6,9,3,-4,7,3,4,1,5,1,0,1,-2,0,-13,-5,-5,10,-1,0,-1,-1,-1,-1,1,5,-1
KR_6737130925,420,0,17,23,-11,-2,3,1,-3,4,1,1,1,2,-4,4,0,-3,3,0,-2,-18,-54,-1,-6,7,-6,0,0,-1,-1,-1,-1,2,-1
KR_6667901665,420,1,30,12,0,-2,3,1,3,3,6,-1,2,1,0,2,2,0,3,3,1,-6,43,3,-9,6,-16,0,1,-1,-1,1,1,5,-1
KR_6675099474,420,-5,-84,-51,-13,3,0,3,-8,8,0,-3,3,0,-5,5,0,0,2,2,-2,-15,2,-1,-4,5,-1,0,-2,-1,-1,-1,-1,3,-1
KR_6700388246,420,-5,-80,-14,-7,0,1,1,-4,7,3,1,3,4,-1,3,2,-3,4,1,0,-9,-13,-3,-5,8,-5,0,-2,-1,-1,-1,-1,6,-1
KR_6707103234,440,-3,1,-19,-10,-3,5,2,-2,4,2,-1,1,0,-3,6,3,-1,2,1,0,-9,-2,-1,-5,6,0,0,-1,1,1,-1,1,5,-1
KR_6642902944,420,-1,-26,0,-1,-1,1,0,3,3,6,5,0,5,-8,8,0,0,2,2,0,-6,5,-3,-5,8,-2,0,-1,1,-1,-1,-1,5,-1
KR_6764015044,420,0,-14,32,0,0,3,3,1,4,5,-1,1,0,0,2,2,0,1,1,1,-2,23,0,-7,7,1,0,0,1,1,0,1,6,-1
KR_6763991880,420,-4,-8,-19,0,2,0,2,-4,10,6,1,2,3,0,6,6,1,0,1,0,-11,-27,-1,-6,7,-7,0,0,1,-1,1,1,2,-1
KR_6757109986,420,1,59,-4,1,2,0,2,3,2,5,-1,3,2,-2,4,2,-1,3,2,1,9,-10,-5,-3,8,10,0,0,1,1,0,1,1,-1
KR_6701761866,420,-4,-31,-34,-10,-1,3,2,-5,9,4,1,3,4,-5,6,1,0,1,1,0,-5,-9,-3,-3,6,3,0,-1,-1,-1,-1,-1,3,-1
KR_6734658027,420,-1,19,-16,-2,1,1,2,3,6,9,-1,3,2,-5,6,1,0,0,0,-1,-2,-4,-3,-3,6,0,0,-1,-1,1,1,-1,5,-1
KR_6745137920,420,-5,-13,-48,-13,0,3,3,-3,5,2,-4,6,2,-5,6,1,-1,2,1,0,-13,-13,-5,-2,7,-3,0,-1,-1,-1,-1,-1,2,-1
KR_6764928022,420,-4,-74,-21,-9,-2,3,1,-4,4,0,0,0,0,-2,5,3,-1,2,1,0,-7,10,-1,-5,6,0,0,-1,-1,-1,-1,-1,5,-1
KR_6749826719,420,-3,-4,-24,-17,-2,3,1,-3,7,4,-5,7,2,-5,5,0,-2,3,1,1,-14,-1,0,-2,2,1,0,0,-1,-1,-1,1,2,-1
KR_6756571956,420,-3,-104,-4,-8,-1,4,3,-3,3,0,0,6,6,-3,6,3,-1,1,0,-1,-6,6,0,-7,7,-5,0,-2,-1,-1,-1,-1,3,-1
KR_6651118650,420,-1,-101,-20,-7,-5,7,2,-2,3,1,-4,6,2,2,3,5,2,0,2,0,-4,-127,-3,-3,6,-3,0,-2,-1,1,-1,1,6,-1
KR_6751365315,420,-1,-5,25,-6,-1,2,1,-1,4,3,-1,2,1,-2,2,0,-1,1,0,-1,-10,-4,-3,-2,5,5,0,1,1,1,1,-1,5,-1
KR_6762356408,420,-3,-68,8,1,-2,3,1,0,0,0,3,1,4,1,2,3,-1,1,0,-1,4,2,3,-6,3,-3,0,0,0,1,-1,-1,0,-1
KR_6621605851,420,1,19,-15,-1,1,1,2,5,0,5,-7,7,0,-1,1,0,1,0,1,0,0,10,6,-9,3,-6,0,-2,-1,-1,-1,1,6,-1
KR_6609287914,420,-3,-50,12,-6,0,4,4,-2,6,4,-1,2,1,-3,3,0,0,0,0,0,-7,3,-2,-4,6,-1,0,0,-1,-1,0,-1,3,-1
KR_6760350079,440,-1,-106,28,0,-1,2,1,3,0,3,0,2,2,-1,3,2,-1,1,0,0,-4,-39,-1,-5,6,-3,0,-2,-1,-1,-1,-1,5,-1
KR_6628446726,440,-2,-52,35,-9,3,1,4,-1,2,1,3,0,3,-8,10,2,-6,6,0,-3,-7,-10,1,-3,2,3,0,0,-1,1,0,-1,3,-1
KR_6762238088,420,-5,-68,9,-13,-4,4,0,-1,2,1,4,1,5,-10,10,0,-2,2,0,0,-17,-12,-4,-5,9,-1,0,-2,-1,1,-1,1,3,-1
KR_6594662375,420,-2,-27,-4,-1,2,0,2,-3,6,3,-2,3,1,1,1,2,1,0,1,0,1,2,1,-10,9,3,0,0,1,-1,1,1,2,-1
KR_6762935355,420,-3,-86,1,-7,-2,4,2,-2,5,3,-1,2,1,-1,3,2,-1,1,0,0,-5,-7,1,-7,6,-5,0,0,-1,-1,0,-1,6,-1
KR_6711614559,420,-9,-102,-28,-22,-8,8,0,-4,6,2,-4,6,2,-7,8,1,1,2,3,-2,-12,14,-2,-4,6,2,0,0,0,-1,-1,-1,0,-1
KR_6763301827,440,5,1,10,14,0,1,1,8,1,9,7,0,7,-4,4,0,3,0,3,0,15,-11,8,-9,1,0,0,1,1,0,1,1,2,-1
KR_6765248643,420,-7,-95,-11,-9,-2,3,1,-1,2,1,-1,2,1,-2,6,4,-3,3,0,0,-3,6,3,-7,4,-5,0,-4,-1,-1,-1,1,3,-1
KR_6755099104,420,-2,13,-9,-1,-3,3,0,-4,6,2,4,2,6,0,5,5,2,1,3,1,-4,-8,0,-6,6,-3,0,1,-1,-1,1,-1,1,-1
KR_6761353878,420,-4,-25,4,-12,-7,7,0,-1,2,1,0,3,3,-2,4,2,-2,3,1,0,-12,-10,3,-7,4,-4,0,-1,1,-1,-1,1,3,-1
KR_6727740111,420,3,14,13,5,2,2,4,-2,4,2,-2,2,0,7,2,9,0,0,0,0,1,4,0,-4,4,-1,0,0,-1,1,-1,-1,2,-1
KR_6763213813,440,0,36,39,-9,-3,6,3,-5,6,1,-1,4,3,-3,6,3,3,0,3,0,-17,-3,-1,-6,7,1,0,0,-1,1,-1,-1,3,-1
KR_6723254075,420,0,38,-46,2,-1,2,1,-1,2,1,2,0,2,3,4,7,-1,3,2,-1,-5,212,-1,-9,10,2,0,1,-1,1,1,-1,1,-1
KR_6740121882,420,2,17,51,-2,0,0,0,2,3,5,-2,5,3,0,3,3,-2,5,3,0,2,115,-4,-1,5,6,0,1,-1,1,1,-1,2,-1
KR_6539790019,420,-2,-41,-16,-8,1,2,3,-3,4,1,-2,4,2,-4,4,0,0,0,0,0,-22,-14,-3,-4,7,2,0,0,-1,1,-1,-1,1,-1
KR_6718256840,420,-1,40,0,-4,-3,3,0,-1,1,0,-2,4,2,2,0,2,0,0,0,0,-3,-87,1,-6,5,-22,0,0,1,-1,-1,1,3,-1
KR_6756856307,420,-2,-80,0,-8,-3,3,0,-4,5,1,0,1,1,-1,1,0,0,0,0,0,-6,6,-2,-7,9,-3,0,-1,1,-1,-1,1,2,-1
KR_6751032320,420,-1,16,0,-9,-2,2,0,0,0,0,-1,1,0,-3,3,0,-3,3,0,0,-7,-77,-1,-4,5,4,0,-1,-1,1,-1,-1,4,-1
KR_6739974079,420,0,-17,0,-3,-1,3,2,-1,1,0,3,0,3,-4,4,0,0,1,1,1,0,-3,-4,-6,10,0,0,0,1,-1,0,1,5,-1
KR_6610144319,420,-6,-102,-28,-8,-3,5,2,-3,4,1,-4,5,1,1,4,5,1,1,2,0,-5,-333,-1,-4,5,-3,0,-3,-1,-1,-1,-1,1,-1
KR_6726674863,440,1,2,9,-2,0,0,0,0,0,0,2,1,3,-3,4,1,-1,2,1,0,-11,27,-3,-4,7,5,0,0,-1,-1,0,1,3,-1
KR_6764894220,420,-6,-67,-20,-10,1,0,1,-2,2,0,-6,6,0,0,4,4,-3,3,0,0,-11,-9,-2,-4,6,6,0,0,-1,-1,0,-1,5,-1
KR_6603232949,420,0,52,-15,1,0,1,1,-6,6,0,3,2,5,3,1,4,1,1,2,0,-1,2,-2,-5,7,-1,0,0,-1,1,0,-1,6,-1
KR_6763709514,420,-2,-5,-18,-5,-2,2,0,2,2,4,-1,5,4,-3,6,3,-1,2,1,0,-4,-3,-4,-2,6,-4,0,1,-1,-1,1,1,1,-1
KR_6753226943,420,-1,-49,12,-9,-1,1,0,-4,5,1,1,3,4,-3,3,0,-2,4,2,0,-9,-13,-2,-5,7,3,0,-1,-1,1,-1,-1,1,-1
KR_6713200006,420,1,30,16,-5,0,2,2,-2,4,2,-3,4,1,0,1,1,0,0,0,0,-3,-16,-3,-2,5,2,0,1,1,0,1,1,1,-1
KR_6741958772,440,0,2,-5,0,3,3,6,-2,3,1,1,1,2,-3,4,1,1,0,1,0,-3,2,-8,-2,10,3,0,-1,-1,1,1,1,3,-1
KR_6754770956,440,-1,-5,-5,-7,0,3,3,1,3,4,-2,3,1,-1,2,1,-5,5,0,2,4,12,-1,-3,4,0,0,-1,0,1,-1,1,0,-1
KR_6734527124,420,-2,-21,4,-8,-1,3,2,-1,4,3,-4,5,1,-1,1,0,-1,1,0,1,-3,132,1,-7,6,-4,0,-1,-1,-1,-1,1,4,-1
KR_6741786682,420,-3,-1,-13,-10,3,0,3,-6,6,0,1,3,4,-6,6,0,-2,2,0,0,-16,-17,2,-7,5,0,0,0,1,1,1,-1,1,-1
KR_6758765673,420,0,-26,4,1,2,1,3,-3,4,1,1,2,3,2,2,4,-1,2,1,0,-3,-5,-2,-3,5,2,0,0,-1,1,0,-1,6,-1
KR_6659313973,420,-1,-54,12,1,-6,6,0,0,3,3,4,1,5,3,0,3,0,1,1,0,-2,109,0,-4,4,2,0,-1,-1,1,-1,-1,1,-1
KR_6759365780,420,-2,-10,-25,-8,-2,3,1,-6,7,1,-2,3,1,2,2,4,0,1,1,0,-5,-24,3,-6,3,-2,0,0,1,-1,0,1,2,-1
KR_6745507314,420,0,-9,11,-1,-2,4,2,-2,6,4,-1,2,1,2,3,5,2,0,2,1,-9,5,-1,-6,7,-7,0,-1,-1,1,1,1,1,-1
KR_6732731566,420,-1,-16,44,-3,3,2,5,-4,4,0,-3,3,0,0,2,2,1,2,3,1,-8,-109,1,-9,8,0,0,1,1,1,1,1,6,-1
KR_6656023233,420,4,45,20,10,0,1,1,10,1,11,-1,4,3,1,0,1,0,1,1,0,18,31,2,-6,4,1,0,0,1,1,0,1,1,-1
KR_6761864485,420,-1,-41,4,-2,3,1,4,-3,3,0,-1,4,3,0,1,1,-1,2,1,0,-6,1,0,-4,4,-1,0,-1,1,-1,-1,-1,2,-1
KR_6763040070,440,2,-10,-14,2,-1,1,0,2,2,4,3,1,4,-3,5,2,1,1,2,0,11,3,-6,-4,10,0,0,-1,-1,-1,-1,-1,4,-1
KR_6765521791,420,1,39,-1,1,-2,3,1,3,1,4,1,5,6,-6,10,4,5,0,5,-2,-8,144,0,-4,4,-17,0,1,-1,-1,1,-1,2,-1
KR_6740574629,420,-6,-81,-31,-8,-2,4,2,1,3,4,-3,7,4,-4,4,0,0,2,2,1,-7,4,-3,-4,7,-5,0,-1,-1,-1,-1,1,4,-1
KR_6644404864,420,-1,-16,-8,0,2,0,2,1,3,4,-1,4,3,-1,2,1,-1,1,0,0,-3,-5,1,-10,9,-5,0,-1,-1,1,1,-1,3,-1
KR_6685653545,420,4,35,17,1,1,1,2,-1,7,6,-1,3,2,3,2,5,-1,2,1,0,-4,24,-1,-6,7,1,0,1,-1,1,1,1,2,-1
KR_6759826189,420,-2,5,-16,-12,-7,8,1,-4,4,0,0,2,2,-1,3,2,0,3,3,0,-8,-2,-6,-3,9,-4,0,-1,-1,-1,-1,1,5,-1
KR_6761102863,440,0,-103,20,-4,-2,3,1,0,1,1,0,6,6,1,2,3,-3,5,2,0,-4,-24,1,-4,3,1,0,0,-1,1,-1,-1,3,-1
KR_6722776447,420,0,10,-44,1,-2,3,1,3,0,3,0,1,1,-2,2,0,2,0,2,0,3,-111,-2,-4,6,-6,0,-1,0,-1,-1,1,0,-1
KR_6654779839,420,0,-16,-6,-5,0,2,2,-2,3,1,2,2,4,-3,3,0,-2,2,0,0,-5,-11,-1,-7,8,-2,0,-1,-1,1,-1,-1,2,-1
KR_6765279236,420,-5,-67,-12,-12,-1,1,0,0,2,2,-2,3,1,-5,5,0,-4,4,0,0,-22,27,-1,-5,6,-2,0,-1,-1,1,-1,-1,3,-1
KR_6723212795,420,-3,-111,-24,0,-1,1,0,3,1,4,6,3,9,-7,9,2,-1,1,0,-2,10,4,2,-5,3,2,0,-3,1,-1,-1,-1,3,-1
KR_6702003308,440,-2,-44,-20,-4,3,0,3,1,1,2,-5,5,0,0,3,3,-3,4,1,0,-3,-45,2,-4,2,18,0,-2,-1,1,-1,-1,5,-1
KR_6760527206,420,0,6,-20,0,1,2,3,-1,3,2,2,3,5,-1,2,1,-1,1,0,0,-2,22,1,-4,3,0,0,0,-1,1,1,-1,1,-1
KR_6675871490,440,1,16,-44,-1,-1,2,1,1,2,3,-5,6,1,-2,2,0,6,0,6,0,5,1,2,-8,6,-3,0,0,-1,1,1,-1,6,-1
KR_6700207461,420,-2,-35,-9,-6,0,3,3,-2,5,3,1,4,5,-5,6,1,0,0,0,0,-4,-38,-2,-4,6,6,0,-1,-1,-1,-1,-1,1,-1
KR_6749624989,440,-3,-56,-20,-9,-3,4,1,1,0,1,0,2,2,-4,4,0,-3,3,0,-1,-11,-5,-3,-4,7,1,0,0,1,-1,0,-1,2,-1
KR_6762567797,420,0,-53,-6,6,3,1,4,-1,5,4,0,2,2,3,0,3,1,1,2,0,14,11,3,-9,6,3,0,-1,1,-1,-1,-1,4,-1
KR_6728353661,420,0,-38,12,3,2,1,3,1,3,4,-3,3,0,3,2,5,0,2,2,-1,4,117,3,-8,5,0,0,1,1,1,1,-1,3,-1
KR_6742578903,420,-4,-105,-5,-12,-4,4,0,-2,5,3,-1,1,0,-2,3,1,-3,3,0,0,-5,-3,1,-4,3,-2,0,0,-1,-1,-1,-1,4,-1
KR_6642467606,420,2,-45,-28,9,-1,2,1,1,2,3,4,2,6,5,3,8,0,0,0,0,8,2,-1,-4,5,3,0,-1,1,-1,-1,1,6,-1
KR_6743747979,420,-5,2,-36,-7,-2,2,0,-5,7,2,1,2,3,0,3,3,-1,1,0,0,-9,-38,1,-4,3,-3,0,0,-1,-1,0,-1,3,-1
KR_6763055408,420,1,4,-5,3,1,1,2,-3,4,1,3,0,3,-3,6,3,5,0,5,0,-3,11,4,-9,5,0,0,-1,-1,1,-1,1,3,-1
KR_6695462251,420,1,35,-8,7,1,1,2,1,1,2,-1,2,1,6,0,6,0,0,0,0,6,-5,2,-5,3,4,0,-1,1,-1,-1,-1,2,-1
KR_6759393429,440,-3,-17,-8,-9,1,2,3,-5,6,1,-6,6,0,0,1,1,1,0,1,0,-15,-16,-4,-2,6,-5,0,-1,-1,1,-1,-1,6,-1
KR_6738592736,420,2,103,12,0,2,2,4,0,2,2,1,2,3,-1,4,3,-2,2,0,1,0,17,4,-8,4,-5,0,-1,1,-1,-1,1,2,-1
KR_6740527497,420,-2,-56,3,-4,-4,4,0,0,3,3,2,1,3,0,4,4,-2,2,0,0,-6,25,-2,-6,8,1,0,0,1,1,0,-1,5,-1
KR_6764812074,420,-1,-47,28,-6,-1,3,2,0,0,0,-2,3,1,-4,7,3,1,0,1,-1,-7,-16,-3,-3,6,3,0,-1,-1,0,-1,-1,5,-1
KR_6601771048,420,-9,-146,-15,-20,0,2,2,-3,4,1,-4,4,0,-11,11,0,-2,2,0,0,-33,-40,-4,-3,7,-2,0,-2,1,-1,-1,-1,1,-1
KR_6738292426,420,-1,-73,-28,-4,-2,3,1,-1,1,0,-3,9,6,2,0,2,0,0,0,-1,5,-73,-2,-3,5,29,0,-2,1,1,-1,-1,6,-1
KR_6606960487,420,0,32,4,-2,-5,6,1,3,1,4,-2,3,1,1,3,4,1,2,3,0,-1,-4,-3,-4,7,4,0,-1,1,-1,-1,-1,3,-1
KR_6758144697,420,-3,-2,4,-5,1,3,4,-5,9,4,2,1,3,-2,5,3,-1,1,0,0,-5,-18,-4,-4,8,-1,0,-1,1,-1,-1,1,5,-1
KR_6762688204,420,-1,14,-4,-7,1,2,3,0,3,3,-2,3,1,-1,5,4,-5,5,0,-1,-11,-5,3,-6,3,-3,0,-1,-1,1,-1,-1,6,-1
KR_6692186665,420,-2,22,0,-6,0,2,2,1,3,4,-1,2,1,-5,7,2,-1,3,2,0,-7,44,0,-6,6,-10,0,1,-1,-1,1,-1,6,-1
KR_6760259757,420,-2,28,-12,-7,4,0,4,-4,7,3,-4,4,0,-1,2,1,-2,3,1,0,-8,4,3,-8,5,0,0,1,1,1,1,-1,4,-1
KR_6602436951,420,2,67,10,-2,5,2,7,-4,4,0,2,1,3,-3,5,2,-2,2,0,-1,-2,-18,5,-7,2,0,0,0,1,0,-1,-1,2,-1
KR_6470919397,440,-6,-104,-8,-16,-11,11,0,-1,2,1,0,1,1,-2,4,2,-2,3,1,-1,-7,-2,-5,-2,7,0,0,-2,-1,-1,-1,-1,4,-1
KR_6623109721,420,-2,-32,-6,-7,1,2,3,-2,2,0,0,1,1,-2,2,0,-4,4,0,0,-8,-4,2,-5,3,-3,0,0,-1,1,0,1,6,-1
KR_6763577466,420,0,32,16,-3,2,1,3,-4,9,5,-2,2,0,1,1,2,0,1,1,0,-10,5,2,-6,4,-2,0,1,1,1,1,1,3,-1
KR_6472693561,440,-4,-42,3,-8,-6,8,2,-2,7,5,2,0,2,-3,4,1,1,0,1,0,1,-5,-1,-7,8,1,0,0,-1,1,-1,-1,5,-1
KR_6707006640,440,-5,-51,2,-11,-5,7,2,0,3,3,1,2,3,-2,3,1,-5,5,0,0,-13,-6,0,-5,5,-4,0,0,-1,-1,-1,-1,3,-1
KR_6764802298,420,-1,-41,21,3,-2,4,2,5,1,6,5,1,6,-2,2,0,-3,3,0,0,5,-6,-4,-5,9,22,0,0,1,0,0,-1,6,-1
KR_6744134717,420,-4,-87,-56,-9,-3,4,1,0,5,5,1,1,2,-7,10,3,0,2,2,0,0,3,1,-7,6,-2,0,-3,-1,-1,-1,-1,6,-1
KR_6670590199,420,-5,-53,-19,-14,-2,4,2,-8,8,0,1,1,2,-6,8,2,1,0,1,-2,-18,-7,-5,-6,11,3,0,-1,-1,-1,-1,-1,2,-1
KR_6755270184,420,1,6,5,1,-3,3,0,-1,2,1,2,2,4,1,0,1,2,0,2,0,1,-64,3,-6,3,-1,0,-2,-1,-1,-1,-1,5,-1
KR_6722585147,420,-3,-38,-11,-7,-2,5,3,-3,4,1,1,2,3,-3,3,0,0,0,0,0,-8,-11,-8,-1,9,2,0,1,-1,1,1,-1,6,-1
KR_6764747055,420,-5,-76,-18,-8,-3,3,0,-1,3,2,0,4,4,-5,7,2,1,0,1,0,-1,0,-1,-6,7,-8,0,-1,-1,-1,-1,-1,6,-1
KR_6753938281,420,-2,-15,-11,-3,2,0,2,-3,5,2,0,2,2,0,2,2,-2,2,0,1,-10,98,5,-7,2,-3,0,0,1,1,0,1,5,-1
KR_6637846764,420,0,14,-24,-1,2,1,3,1,2,3,-2,3,1,-1,3,2,-1,2,1,0,-5,-25,1,-9,8,3,0,0,1,0,0,-1,1,-1
KR_6681619122,420,-4,-22,3,-2,-1,3,2,0,1,1,-5,6,1,-2,4,2,6,0,6,2,1,-9,-2,-5,7,0,0,1,1,-1,1,1,6,-1
KR_6727737167,420,0,4,4,-8,-3,3,0,2,3,5,0,5,5,-4,4,0,-3,3,0,1,-2,-32,-5,-2,7,2,0,-2,-1,-1,-1,1,1,-1
KR_6740074604,420,-3,-13,-31,-2,5,0,5,-5,7,2,2,2,4,-3,3,0,-1,1,0,0,-8,-1,3,-6,3,1,0,-1,-1,-1,-1,-1,2,-1
KR_6761141425,420,-2,-27,-15,-2,-4,4,0,2,1,3,2,3,5,-1,2,1,-1,2,1,0,8,33,3,-9,6,-1,0,-1,1,-1,-1,1,5,-1
KR_6753253892,420,-5,-49,-20,-6,-1,3,2,-2,4,2,0,1,1,-1,2,1,-2,3,1,0,-6,4,-2,-4,6,-2,0,-2,-1,-1,-1,-1,1,-1
KR_6727701363,420,-3,-53,16,-11,0,2,2,-2,4,2,1,2,3,-7,8,1,-3,4,1,-1,-20,-3,-9,-2,11,-3,0,-3,-1,-1,-1,-1,4,-1
KR_6736815514,420,0,-48,-15,1,-2,3,1,0,3,3,-6,6,0,8,0,8,1,2,3,0,3,-11,-6,-1,7,6,0,-1,-1,-1,-1,-1,2,-1
KR_6754550932,420,-3,-45,-24,-2,-3,3,0,-3,4,1,1,2,3,3,1,4,0,0,0,0,-2,4,0,-4,4,-2,0,-1,0,-1,-1,1,0,-1
KR_6676413830,420,-4,2,7,-12,-1,2,1,-5,6,1,1,1,2,-7,9,2,0,0,0,-1,-9,-7,-5,-5,10,-2,0,-1,0,1,-1,-1,0,-1
KR_6693651811,420,-6,-77,-36,-5,-2,3,1,1,4,5,2,2,4,-2,3,1,-4,4,0,0,3,-8,1,-8,7,1,0,-3,-1,-1,-1,-1,3,-1
KR_6760584838,420,-5,-70,-16,-8,1,0,1,0,4,4,-4,4,0,-4,4,0,-1,4,3,0,-8,-8,-2,-5,7,-1,0,0,0,-1,0,-1,0,-1
KR_6759756636,440,-2,-8,-24,-5,1,0,1,-1,1,0,1,2,3,-4,5,1,-2,2,0,1,-7,-7,-2,-4,6,-9,0,0,1,-1,0,1,3,-1
KR_6733968745,420,-3,5,16,-8,-3,5,2,-2,3,1,-2,2,0,-2,3,1,1,1,2,-1,-14,-5,-2,-3,5,0,0,0,-1,-1,-1,-1,5,-1
KR_6685766183,420,1,-53,13,0,0,2,2,-4,8,4,2,0,2,1,1,2,1,0,1,0,4,8,7,-8,1,1,0,1,1,-1,1,1,6,-1
KR_6739647966,420,-4,-6,-31,-10,0,0,0,-4,4,0,-3,4,1,-3,3,0,0,1,1,0,-14,-8,-1,-4,5,-2,0,-1,-1,-1,-1,-1,6,-1
KR_6693848832,420,-4,-48,-20,-4,-2,3,1,-4,8,4,3,0,3,-1,2,1,0,0,0,0,-4,9,3,-8,5,-10,0,-2,-1,-1,-1,-1,3,-1
KR_6733365504,420,-4,17,33,-10,-3,4,1,-2,3,1,-5,9,4,-1,1,0,1,0,1,0,-19,-3,-3,-3,6,5,0,0,1,1,0,-1,4,-1
KR_6764555875,420,1,-43,4,2,0,2,2,-1,3,2,1,0,1,0,4,4,2,0,2,0,2,9,0,-4,4,-4,0,1,-1,1,1,1,3,-1
KR_6666577093,420,1,-6,15,4,-1,2,1,2,5,7,3,0,3,-2,6,4,2,1,3,0,0,7,-3,-5,8,-3,0,0,1,-1,-1,1,2,-1
KR_6760929905,420,-5,-17,-48,-8,0,2,2,1,2,3,-7,8,1,-1,6,5,-1,1,0,1,-6,-21,1,-8,7,-28,0,-1,-1,1,-1,1,5,-1
KR_6727906156,440,-2,-23,8,-7,1,0,1,-3,5,2,2,2,4,-5,5,0,-2,2,0,0,-12,-30,-3,-2,5,-1,0,1,1,0,-1,-1,6,-1
KR_6754381193,420,-3,-33,-20,-10,0,2,2,1,2,3,-7,7,0,-2,4,2,-2,2,0,0,-3,10,3,-5,2,-3,0,-3,-1,-1,-1,-1,5,-1
KR_6765612178,440,-4,-72,-15,-14,-2,3,1,0,3,3,-10,11,1,-1,3,2,-1,1,0,0,-19,121,3,-9,6,-1,0,-3,1,-1,-1,1,6,-1
KR_6752215435,420,4,-58,22,4,0,2,2,-1,3,2,3,1,4,2,3,5,0,1,1,0,5,-23,3,-6,3,21,0,0,1,1,-1,1,3,-1
KR_6751345418,420,-6,-102,-29,-17,-2,3,1,-3,5,2,-1,3,2,-11,13,2,0,0,0,0,-16,10,1,-6,5,0,0,-1,1,-1,-1,-1,6,-1
KR_6754828491,420,2,23,-12,8,2,1,3,4,1,5,2,0,2,-1,3,2,1,2,3,2,9,0,3,-8,5,2,0,1,1,1,1,1,6,-1
KR_6754919015,420,-3,16,-36,-5,0,1,1,-3,3,0,3,0,3,-4,4,0,-1,1,0,0,-10,6,1,-7,6,-2,0,-1,-1,-1,-1,-1,6,-1
KR_6759563262,440,-3,-72,-20,-4,0,2,2,1,3,4,-4,7,3,0,2,2,-1,1,0,-1,-6,-4,-3,-4,7,-1,0,-1,1,-1,-1,-1,4,-1
KR_6657946262,420,-4,-3,-25,-3,0,2,2,-2,3,1,2,0,2,-5,6,1,2,0,2,0,-1,57,4,-8,4,-10,0,0,-1,1,0,1,1,-1
KR_6759156629,420,-6,-48,-12,-11,-1,1,0,-2,4,2,-2,3,1,-6,6,0,0,3,3,0,-15,2,4,-7,3,-5,0,0,-1,1,0,-1,6,-1
KR_6749638827,420,-3,-11,6,-4,3,0,3,2,0,2,-5,6,1,-4,6,2,0,2,2,-1,-6,-1,-4,-5,9,3,0,-1,1,-1,-1,-1,2,-1
KR_6694910070,420,-3,37,-43,-9,0,1,1,-5,8,3,3,3,6,-5,9,4,-2,3,1,0,-11,-16,-1,-6,7,-4,0,0,-1,-1,1,-1,5,-1
KR_6762726060,420,2,-25,-16,3,-3,4,1,0,1,1,-1,3,2,5,1,6,2,0,2,0,15,4,3,-10,7,-2,0,0,-1,-1,0,1,5,-1
KR_6748170370,420,-1,-3,8,-6,0,0,0,-5,7,2,-2,4,2,3,4,7,-2,2,0,1,-7,10,-2,-5,7,6,0,0,-1,-1,-1,1,5,-1
KR_6646360145,420,-1,-17,-21,-7,-4,5,1,-4,6,2,1,3,4,0,1,1,0,0,0,0,-5,-3,-4,-3,7,2,0,-1,1,-1,-1,1,4,-1
KR_6675251979,420,-4,-91,0,-5,-1,2,1,-1,4,3,-1,2,1,-3,4,1,1,1,2,0,-5,-12,-6,-3,9,5,0,0,0,-1,0,-1,0,-1
KR_6762353458,420,0,-36,-16,-2,-4,4,0,2,1,3,-2,4,2,4,0,4,-2,2,0,2,8,90,-2,-5,7,-3,0,-1,-1,-1,-1,1,3,-1
KR_6714900420,420,-1,-69,-4,-1,-1,1,0,1,6,7,-3,3,0,2,2,4,0,2,2,0,-4,-18,-3,-2,5,-2,0,1,-1,0,1,1,2,-1
KR_6761014839,440,-2,-25,5,-7,-2,3,1,0,1,1,-3,4,1,-3,5,2,1,0,1,1,-4,-7,-5,-4,9,1,0,-1,-1,1,-1,1,1,-1
KR_6733295415,420,-2,22,14,-15,0,1,1,-3,5,2,-8,8,0,-3,4,1,-1,1,0,0,-19,-54,0,-4,4,-2,0,-1,-1,-1,-1,1,4,-1
KR_6762798950,420,-2,-28,-4,6,0,1,1,0,2,2,-3,3,0,9,0,9,0,0,0,0,12,36,2,-4,2,0,0,0,1,1,0,1,1,-1
KR_6765613512,420,0,31,5,-4,-3,5,2,1,3,4,-3,5,2,2,2,4,-1,2,1,0,-3,1,-2,-3,5,1,0,1,-1,1,1,1,2,-1
KR_6642317109,420,-7,-34,-29,-17,-2,2,0,-3,3,0,-6,6,0,-8,10,2,2,1,3,0,-11,-5,-5,-5,10,-3,0,-3,-1,1,-1,-1,5,-1
KR_6609208244,420,2,33,0,3,2,1,3,0,5,5,0,3,3,0,3,3,1,1,2,-1,0,-2,-2,-5,7,-4,0,1,-1,-1,1,-1,5,-1
KR_6754079351,420,-1,46,-32,3,-2,3,1,2,3,5,-1,1,0,4,1,5,0,0,0,0,4,-130,3,-6,3,-1,0,0,1,1,0,1,4,-1
KR_6743877016,420,-3,-61,-4,-7,1,2,3,-3,4,1,-2,2,0,-1,3,2,-2,3,1,0,-5,-4,2,-5,3,3,0,0,-1,1,-1,-1,5,-1
KR_6762665162,420,-2,-29,0,1,1,0,1,-1,3,2,0,3,3,-1,2,1,2,2,4,0,1,-4,-6,-2,8,1,0,0,-1,-1,0,1,3,-1
KR_6755082368,420,-1,-58,-9,-1,-1,2,1,2,1,3,-1,2,1,-3,6,3,2,2,4,0,2,-21,-2,-3,5,0,0,-1,-1,1,-1,-1,6,-1
KR_6746879075,420,-3,-17,-4,-4,-6,6,0,-1,2,1,-5,6,1,6,1,7,2,0,2,0,2,-5,-3,-3,6,-2,0,-2,1,1,-1,-1,1,-1
KR_6761893244,420,-2,20,-36,1,-3,4,1,4,0,4,3,1,4,-1,4,3,-2,2,0,0,-1,-6,-2,-5,7,5,0,-1,-1,-1,-1,1,6,-1
KR_6663055642,420,0,-13,4,4,1,0,1,2,2,4,1,5,6,-1,1,0,1,0,1,0,0,6,-5,-3,8,7,0,0,-1,1,0,1,2,-1
KR_6760710598,420,-2,-13,-10,-7,-4,5,1,-2,3,1,1,2,3,-2,2,0,0,1,1,0,-5,38,2,-6,4,3,0,0,-1,1,1,1,6,-1
KR_6757908466,420,1,14,-18,1,1,2,3,-2,4,2,3,2,5,2,0,2,-3,4,1,0,0,-9,-4,-4,8,-1,0,0,-1,1,1,1,5,-1
KR_6702473778,420,0,-28,-8,-1,-2,3,1,4,4,8,1,2,3,0,4,4,-4,5,1,0,-1,-61,-3,-2,5,13,0,0,-1,-1,-1,-1,5,-1
KR_6758392554,440,-4,37,-14,-11,1,2,3,-10,10,0,-1,3,2,-2,3,1,1,3,4,-1,-16,-39,-2,-5,7,1,0,1,-1,-1,-1,-1,5,-1
KR_6692740337,420,0,60,0,-4,2,0,2,-3,5,2,1,5,6,-3,4,1,-1,2,1,0,-3,0,4,-9,5,-2,0,1,-1,1,1,1,3,-1
KR_6749677581,420,-3,-50,-34,-5,1,1,2,-3,5,2,-5,7,2,1,2,3,1,3,4,0,0,-35,1,-8,7,0,0,0,-1,-1,0,1,6,-1
KR_6636382720,420,-2,-6,-3,-4,-3,4,1,2,1,3,0,0,0,-2,5,3,-1,3,2,-1,-7,-2,1,-3,2,-4,0,-1,-1,-1,-1,-1,4,-1
KR_6763109586,420,-2,14,1,-8,-2,3,1,0,3,3,-4,4,0,-2,2,0,0,2,2,0,-13,88,6,-8,2,-1,0,0,-1,-1,0,-1,6,-1
KR_6721349720,420,-2,12,4,-5,2,1,3,-3,4,1,-4,6,2,-3,5,2,3,0,3,-1,-11,6,0,-5,5,-6,0,-2,1,-1,-1,-1,5,-1
KR_6744590942,420,-4,31,-20,-8,0,2,2,-2,4,2,-8,9,1,2,2,4,0,0,0,0,-6,1,-4,-3,7,-2,0,0,1,1,1,-1,6,-1
KR_6687315648,420,3,44,-9,1,2,0,2,-1,4,3,6,0,6,-6,6,0,0,2,2,0,-3,-3,4,-7,3,0,0,1,1,1,1,1,4,-1
KR_6742306578,420,-1,43,-6,-6,-1,1,0,0,4,4,0,3,3,-5,5,0,0,2,2,0,0,-5,-3,-4,7,3,0,-1,1,-1,-1,1,2,-1
KR_6763438374,420,0,-31,4,-1,0,1,1,-2,4,2,-1,2,1,2,0,2,0,3,3,0,-2,-7,-5,-4,9,-4,0,-1,-1,-1,-1,1,6,-1
KR_6614836125,420,-5,-13,-4,-7,-3,4,1,1,1,2,-5,6,1,1,1,2,-1,2,1,0,-8,24,-2,-4,6,-1,0,1,1,1,1,1,5,-1
KR_6640031853,420,2,25,12,-3,4,0,4,0,1,1,-7,8,1,3,0,3,-3,4,1,0,-7,-17,3,-6,3,1,0,0,-1,1,0,-1,2,-1
KR_6690514084,440,0,26,18,-1,5,0,5,2,0,2,-6,8,2,-3,4,1,1,0,1,-1,1,1,-2,-1,3,0,0,0,-1,-1,1,-1,2,-1
KR_6629080688,420,-2,0,-2,-6,0,1,1,1,1,2,-4,6,2,0,3,3,-3,3,0,0,-3,4,1,-4,3,0,0,-1,-1,-1,-1,1,1,-1
KR_6606888726,420,-4,-46,2,-7,-1,1,0,1,1,2,-2,4,2,-6,7,1,1,0,1,0,-9,-4,2,-5,3,-6,0,0,-1,-1,-1,-1,1,-1
KR_6765111198,420,-2,-83,9,-10,-2,2,0,-1,2,1,0,3,3,-7,8,1,0,0,0,0,-6,-17,5,-9,4,-2,0,-1,-1,-1,-1,-1,6,-1
KR_6756173306,420,-1,-7,4,-9,-2,5,3,-2,2,0,-2,2,0,-2,2,0,-1,1,0,0,-8,-5,-1,-8,9,-2,0,1,-1,-1,1,-1,2,-1
KR_6413316264,420,1,-10,24,0,-2,3,1,7,3,10,1,0,1,-4,7,3,-2,2,0,1,-9,-1,4,-9,5,-3,0,-1,-1,1,-1,1,5,-1
KR_6664816330,420,-10,-76,-104,-13,-2,3,1,-4,4,0,-4,4,0,-3,6,3,0,0,0,0,-1,-10,-6,0,6,-3,0,-2,-1,-1,-1,-1,4,-1
KR_6763769604,420,1,-9,-9,6,0,0,0,-2,6,4,7,0,7,2,2,4,-1,1,0,0,7,4,6,-8,2,-1,0,1,1,-1,1,1,2,-1
KR_6737931160,440,-4,-60,-60,-6,-5,7,2,2,3,5,2,3,5,-2,4,2,-3,3,0,0,1,-6,1,-2,1,1,0,0,-1,1,-1,1,4,-1
KR_6760306387,420,-2,-73,24,-2,-1,3,2,2,2,4,1,2,3,-3,4,1,-1,1,0,0,-9,5,-1,-3,4,-1,0,1,1,1,1,1,4,-1
KR_6702023769,440,-1,-18,-10,-6,-2,3,1,0,1,1,8,3,11,-7,7,0,-5,5,0,1,1,-4,0,-3,3,0,0,0,-1,1,0,1,5,-1
KR_6698358546,420,-3,-62,-13,-13,-3,4,1,-1,3,2,-3,6,3,-5,5,0,-1,1,0,0,-13,-9,-1,-2,3,-1,0,-2,-1,1,-1,-1,5,-1
KR_6760484327,420,-3,4,-2,-8,-3,4,1,4,2,6,-3,3,0,0,4,4,-6,8,2,0,-5,11,2,-7,5,-3,0,0,1,-1,1,-1,6,-1
KR_6751953937,440,-4,-112,-7,-12,1,1,2,-4,6,2,-1,1,0,-7,7,0,-1,1,0,0,-17,3,0,-3,3,2,0,-1,1,-1,-1,-1,6,-1
KR_6571983961,420,-5,-48,-21,-12,-1,2,1,-7,8,1,1,1,2,-4,5,1,-1,1,0,0,-16,-10,-3,-6,9,2,0,-1,-1,-1,-1,-1,4,-1
KR_6743942426,420,-3,-23,-4,-1,-1,3,2,1,1,2,-3,4,1,1,3,4,1,0,1,1,-3,3,0,-7,7,0,0,-1,-1,-1,-1,1,4,-1
KR_6573471493,420,0,-37,11,-3,0,0,0,1,2,3,-3,5,2,-1,2,1,0,0,0,0,0,-32,7,-11,4,-2,0,1,1,-1,1,1,6,-1
KR_6752028997,420,0,-24,36,-7,0,1,1,-4,8,4,0,4,4,-3,3,0,0,0,0,0,-10,-9,-1,-4,5,-2,0,-1,1,-1,-1,-1,5,-1
KR_6563962899,420,-1,-21,9,-1,0,3,3,-2,5,3,-1,1,0,0,4,4,2,0,2,0,6,-7,-1,-2,3,-3,0,-2,-1,-1,-1,-1,2,-1
KR_6657918350,420,-3,-6,-10,-4,-4,5,1,-4,4,0,-5,6,1,5,1,6,4,0,4,0,-5,12,3,-4,1,-5,0,-1,-1,-1,-1,1,1,-1
KR_6590568292,420,-4,10,-15,-10,-4,5,1,-2,4,2,-1,2,1,-1,5,4,-2,2,0,0,-12,-7,-5,-5,10,-3,0,-1,1,-1,-1,1,4,-1
KR_6681229005,440,2,22,-13,4,7,2,9,-3,5,2,-3,4,1,0,2,2,3,0,3,0,2,2,3,-8,5,-6,0,0,-1,0,1,1,4,-1
KR_6750057479,420,-3,-65,-18,-11,2,1,3,-4,8,4,-2,3,1,-2,4,2,-5,5,0,0,-4,-7,2,-6,4,-1,0,-2,1,-1,-1,1,1,-1
KR_6720374835,420,0,-8,-4,7,2,0,2,2,3,5,5,1,6,-1,2,1,-1,2,1,0,3,3,-1,-6,7,-3,0,1,-1,1,1,1,6,-1
KR_6744359019,420,3,64,12,-4,3,1,4,0,4,4,-3,6,3,-4,6,2,0,1,1,1,-9,-8,-4,-3,7,2,0,1,-1,1,1,1,4,-1
KR_6758507049,420,-3,-46,16,-10,0,1,1,-2,3,1,-1,2,1,-8,8,0,1,0,1,0,-4,-2,7,-10,3,1,0,-2,-1,-1,-1,1,2,-1
KR_6632438366,420,-6,-36,-23,-11,-1,2,1,1,5,6,0,2,2,-13,13,0,2,1,3,0,-25,-9,-5,-8,13,0,0,-2,-1,1,-1,1,5,-1
KR_6696352834,420,0,-49,6,-3,-3,6,3,-3,4,1,-1,2,1,4,3,7,0,0,0,0,-3,-29,3,-7,4,2,0,-2,1,-1,-1,-1,6,-1
KR_6601822968,420,3,25,-22,5,3,1,4,0,2,2,-4,5,1,5,2,7,1,2,3,1,6,4,-3,-4,7,2,0,0,-1,-1,-1,1,2,-1
KR_6756245205,420,-3,-36,-20,-9,2,0,2,-9,10,1,0,5,5,-3,5,2,1,1,2,-1,-8,-6,-1,-4,5,3,0,0,-1,-1,1,-1,4,-1
KR_6737932126,420,-4,-17,12,-12,0,2,2,-4,4,0,-3,5,2,-2,3,1,-3,3,0,-1,-24,4,0,-5,5,4,0,-1,-1,-1,-1,-1,5,-1
KR_6759916973,440,-1,-29,-7,3,3,0,3,3,0,3,-3,3,0,1,0,1,-1,3,2,0,-1,16,5,-11,6,-6,0,1,-1,1,1,1,5,-1
KR_6759108834,420,3,-1,16,0,1,1,2,-2,3,1,-1,2,1,3,0,3,-1,4,3,0,-5,491,-2,-3,5,-2,0,0,1,1,0,-1,4,-1
KR_6728581126,420,-5,-61,-48,-6,-1,1,0,1,1,2,0,1,1,-4,4,0,-2,2,0,0,-4,-156,-4,-3,7,-1,0,-4,-1,-1,-1,-1,3,-1
KR_6652270553,420,0,-35,-4,-2,2,2,4,-4,5,1,-1,2,1,1,3,4,0,1,1,0,-2,-4,5,-7,2,2,0,0,-1,1,1,-1,5,-1
KR_6742972209,420,-8,2,-24,-16,-1,3,2,-5,6,1,0,1,1,-6,6,0,-4,4,0,0,-30,103,-1,-5,6,-4,0,-1,-1,-1,-1,-1,6,-1
KR_6736720360,420,0,24,-4,3,-1,2,1,-3,3,0,2,3,5,5,0,5,0,4,4,0,-2,9,2,-8,6,1,0,0,0,-1,0,1,0,-1
KR_6743674910,420,1,10,-13,5,3,2,5,-1,2,1,0,1,1,0,1,1,3,0,3,0,2,-8,-2,-4,6,-1,0,0,-1,-1,0,-1,2,-1
KR_6630275378,420,-5,3,-61,-12,-5,6,1,-6,7,1,-1,2,1,-2,4,2,2,0,2,0,-9,-113,-1,-3,4,0,0,0,-1,-1,-1,-1,1,-1
KR_6742232875,420,1,40,25,2,2,2,4,0,1,1,2,1,3,-3,3,0,1,0,1,0,-3,27,-1,-6,7,-2,0,0,-1,1,-1,1,3,-1
KR_6756851454,420,-1,10,-2,-4,2,1,3,1,3,4,-4,5,1,-2,5,3,-1,1,0,-1,-10,-5,3,-5,2,4,0,-1,-1,1,-1,-1,1,-1
KR_6764028139,420,-3,29,-35,-4,-3,5,2,-1,5,4,1,5,6,0,6,6,-1,2,1,-2,-3,11,5,-9,4,-5,0,0,-1,1,0,1,6,-1
KR_6746269713,420,-3,-17,-4,-7,-3,4,1,-3,4,1,0,1,1,-1,2,1,0,0,0,-1,-11,-5,-4,-4,8,-2,0,0,-1,-1,0,-1,6,-1
KR_6763681655,440,-4,22,-30,-10,-3,4,1,-7,7,0,1,1,2,-1,1,0,0,1,1,0,-8,-3,1,-4,3,-1,0,-1,-1,0,-1,-1,5,-1
KR_6756960647,440,-5,-13,-32,-15,-3,4,1,-8,8,0,-3,4,1,3,1,4,-4,4,0,-2,-19,400,-2,-5,7,-1,0,0,1,1,-1,-1,5,-1
KR_6757900489,420,-2,-55,-8,-6,1,1,2,-2,4,2,-1,5,4,-4,5,1,0,3,3,0,-6,-9,-4,-5,9,1,0,0,-1,0,-1,-1,2,-1
KR_6683070572,420,-1,-52,-4,1,2,0,2,4,0,4,-3,3,0,-4,6,2,2,0,2,0,3,6,4,-7,3,-1,0,-1,0,-1,-1,1,0,-1
KR_6761584532,440,5,5,4,3,5,1,6,-1,6,5,-4,6,2,1,0,1,2,0,2,0,-3,25,5,-7,2,-1,0,1,-1,1,1,-1,5,-1
KR_6762010899,420,-1,-130,-22,-2,-4,6,2,3,2,5,0,0,0,0,2,2,-1,1,0,0,0,4,5,-9,4,-2,0,0,1,1,-1,-1,3,-1
KR_6764050831,420,-1,10,8,1,-1,1,0,-1,2,1,-2,4,2,4,5,9,1,0,1,1,0,-6,0,-7,7,-1,0,0,0,1,0,1,0,-1
KR_6743042118,420,-4,-101,10,-16,0,3,3,-5,6,1,-3,3,0,-6,6,0,-2,3,1,0,-17,-4,-6,-2,8,-3,0,0,-1,1,-1,-1,4,-1
KR_6751214894,440,-2,7,12,-1,-2,2,0,2,1,3,-3,4,1,3,2,5,-1,2,1,0,6,-40,0,-8,8,0,0,-1,0,0,-1,1,0,-1
KR_6760470140,420,-2,18,-4,0,-1,1,0,-1,4,3,0,1,1,1,0,1,1,0,1,0,9,2,4,-9,5,6,0,0,1,-1,-1,1,2,-1
KR_6764357756,420,-1,-98,11,-7,-1,3,2,2,2,4,-3,7,4,-5,6,1,0,1,1,0,-2,5,-3,-2,5,0,0,-1,1,1,-1,-1,6,-1
KR_6698703862,420,1,-24,4,-1,1,0,1,4,1,5,-1,1,0,-4,5,1,-1,2,1,0,1,43,3,-6,3,-19,0,0,1,1,-1,1,1,-1
KR_6754785817,420,3,35,16,-4,0,1,1,-2,3,1,-1,1,0,-1,2,1,0,0,0,0,0,-2,0,-6,6,-1,0,-1,1,-1,-1,-1,1,-1
KR_6755340757,420,3,66,-18,0,3,2,5,1,4,5,0,2,2,-3,5,2,-1,2,1,-2,-10,-2,1,-5,4,4,0,-1,1,-1,-1,-1,6,-1
KR_6748395334,420,0,-28,-10,3,3,1,4,1,7,8,1,2,3,0,1,1,-2,3,1,0,4,-23,1,-6,5,2,0,-1,1,1,1,-1,3,-1
KR_6754459818,420,2,-56,12,7,-2,2,0,6,0,6,2,0,2,0,3,3,1,0,1,0,18,8,3,-5,2,3,0,0,1,0,1,1,3,-1
KR_6717798531,420,3,64,-2,1,3,1,4,2,2,4,5,1,6,-6,8,2,-3,3,0,0,-12,-145,5,-8,3,5,0,1,1,1,1,1,2,-1
KR_6644204044,420,-2,14,-3,0,0,1,1,0,4,4,-2,4,2,3,0,3,-1,1,0,0,0,-34,-2,-4,6,4,0,1,1,1,1,1,3,-1
KR_6642690828,420,-5,-66,-41,-10,-3,3,0,-3,5,2,-6,7,1,2,2,4,0,0,0,-1,-4,99,-1,-5,6,5,0,-2,1,-1,-1,1,2,-1
KR_6755730014,440,2,74,27,7,2,1,3,3,0,3,1,0,1,8,1,9,-7,8,1,-1,1,373,-1,-6,7,0,0,1,1,1,1,-1,3,-1
KR_6749927021,420,0,-8,3,-5,-4,5,1,-2,4,2,1,3,4,-3,5,2,3,0,3,0,-22,-18,1,-6,5,2,0,2,-1,1,1,1,2,-1
KR_6660689402,420,-2,-67,17,-4,-2,3,1,-3,6,3,4,0,4,-4,4,0,1,0,1,0,-11,56,-1,-6,7,-32,0,1,-1,1,1,1,5,-1
KR_6754418257,440,-3,-52,-8,1,2,5,7,-3,3,0,0,0,0,2,3,5,0,0,0,0,6,-2,-3,-5,8,-1,0,-1,1,1,-1,-1,6,-1
KR_6726622041,440,-1,25,15,-7,2,1,3,-4,5,1,-1,1,0,-1,3,2,-3,3,0,-2,-14,-36,-6,-4,10,1,0,-1,-1,-1,-1,-1,6,-1
KR_6730305965,420,-4,26,-36,-11,-3,4,1,-2,3,1,2,1,3,-5,5,0,-3,3,0,0,-12,102,-2,-3,5,3,0,0,-1,0,0,1,4,-1
KR_6706394176,420,1,16,-13,-4,1,3,4,-4,5,1,-2,3,1,0,0,0,1,0,1,0,-5,1,1,-6,5,2,0,0,1,-1,0,-1,1,-1
KR_6760420955,420,-2,-18,1,-5,3,3,6,-3,3,0,-1,3,2,-2,3,1,-2,2,0,0,0,-2,2,-5,3,1,0,0,1,1,1,-1,2,-1
KR_6746263683,420,-5,-53,-11,-1,1,1,2,-1,2,1,-1,2,1,1,1,2,-1,1,0,0,-8,-10,2,-7,5,3,0,-1,-1,1,-1,1,1,-1
KR_6754288251,440,-6,-103,-11,-12,-1,4,3,-2,5,3,-13,14,1,2,0,2,2,0,2,1,-14,20,0,-5,5,-5,0,-1,-1,-1,-1,1,2,-1
KR_6605399318,420,2,-53,-14,5,0,1,1,2,2,4,4,2,6,-2,3,1,1,0,1,0,11,13,-1,-7,8,23,0,-2,1,-1,-1,1,3,-1
KR_6729633955,420,-4,-13,-4,-6,-1,3,2,-1,5,4,-2,2,0,-3,7,4,1,2,3,0,-11,-16,-1,-6,7,3,0,0,-1,1,0,-1,6,-1
KR_6745564403,420,-2,-46,2,-1,3,2,5,-4,4,0,3,1,4,0,4,4,-3,4,1,-2,-9,-6,4,-6,2,3,0,-1,-1,-1,-1,-1,6,-1
KR_6604869124,420,-2,-10,4,-5,-4,4,0,-4,6,2,2,0,2,1,4,5,0,0,0,0,-6,2,-1,-9,10,-1,0,-1,1,-1,-1,1,6,-1
KR_6731654573,420,-2,-64,-7,0,1,2,3,-3,3,0,0,2,2,0,3,3,2,1,3,0,3,1,-1,-7,8,5,0,0,-1,1,0,1,5,-1
KR_6694907750,420,1,56,8,3,3,1,4,-3,5,2,0,2,2,1,2,3,2,1,3,1,8,74,-1,-4,5,-23,0,2,-1,1,1,1,4,-1
KR_6755171364,420,1,9,-14,6,0,2,2,2,3,5,1,2,3,4,0,4,-1,2,1,0,13,6,1,-6,5,1,0,0,-1,1,1,1,5,-1
KR_6753079290,420,-1,65,-32,-3,0,1,1,4,0,4,-5,7,2,-2,7,5,0,1,1,2,0,111,-2,-3,5,0,0,0,-1,-1,1,1,4,-1
KR_6700670944,420,-1,-20,0,0,1,0,1,-2,3,1,4,2,6,-3,4,1,0,1,1,0,4,-3,4,-9,5,0,0,0,1,1,0,-1,4,-1
KR_6749656968,420,-1,24,12,-1,0,2,2,2,1,3,-6,6,0,1,2,3,2,0,2,0,-8,2,5,-7,2,0,0,1,1,1,1,-1,1,-1
KR_6760709073,440,-8,-92,-16,-27,-6,8,2,-6,6,0,-6,6,0,-8,9,1,-1,4,3,-2,-35,-4,-4,-4,8,-1,0,-1,-1,1,-1,-1,3,-1
KR_6761737679,440,-1,-21,2,-3,2,0,2,-2,4,2,0,2,2,3,0,3,-6,7,1,0,0,-6,-4,-2,6,-1,0,-1,-1,0,-1,-1,5,-1
KR_6686765536,420,0,-6,-8,-4,-4,4,0,-3,3,0,4,2,6,-1,3,2,0,0,0,0,-4,0,0,-4,4,-1,0,0,-1,-1,0,-1,3,-1
KR_6759231852,420,1,-23,19,-2,5,0,5,1,2,3,-3,3,0,-1,6,5,-4,4,0,-1,-14,17,-1,-3,4,-3,0,1,1,0,1,-1,1,-1
KR_6655707434,420,-1,-4,12,2,0,0,0,0,4,4,4,5,9,1,1,2,-3,3,0,1,3,-3,4,-5,1,1,0,-1,1,-1,-1,1,1,-1
KR_6646213857,420,-2,-25,-28,-3,-1,1,0,0,1,1,-1,3,2,-1,1,0,0,0,0,1,2,-2,-1,-6,7,-5,0,-1,-1,-1,-1,1,1,-1
KR_6747817278,420,-8,-26,-21,-13,-2,4,2,-2,4,2,-8,10,2,-4,5,1,3,1,4,1,-7,-54,4,-5,1,11,0,-3,0,-1,-1,-1,0,-1
KR_6630831356,420,0,53,-32,-1,0,3,3,2,3,5,-1,5,4,-5,7,2,3,1,4,2,-2,5,3,-8,5,0,0,1,-1,0,1,1,1,-1
KR_6749596557,420,-1,-12,8,-3,-3,6,3,0,1,1,1,0,1,-3,6,3,2,1,3,0,6,5,-2,-8,10,-6,0,0,1,-1,0,1,4,-1
KR_6763872291,420,0,5,32,-3,-3,4,1,1,1,2,-3,5,2,1,1,2,1,2,3,0,6,-2,0,-7,7,-1,0,-2,-1,1,1,-1,3,-1
KR_6752845331,420,-5,-95,-34,-7,-2,4,2,-4,5,1,1,1,2,-3,3,0,1,1,2,0,-6,-4,-3,-3,6,1,0,-2,-1,-1,-1,-1,1,-1
KR_6683126293,420,-5,50,0,-18,-3,4,1,0,2,2,-1,1,0,-13,14,1,-1,3,2,-2,-21,-7,-3,-3,6,1,0,-2,0,-1,-1,-1,0,-1
KR_6696881378,420,0,-20,-23,-4,-3,3,0,-3,4,1,3,3,6,0,3,3,-1,3,2,0,-4,-125,1,-7,6,3,0,-1,-1,-1,-1,-1,6,-1
KR_6621490058,420,0,8,-1,-1,1,2,3,-9,10,1,0,2,2,5,0,5,2,1,3,0,-7,-21,-3,-9,12,-9,0,-1,-1,-1,-1,1,4,-1
KR_6738497852,420,-1,-93,7,-6,-4,4,0,-3,7,4,2,1,3,-2,4,2,1,0,1,0,-4,-3,-5,-5,10,-4,0,-2,-1,-1,-1,-1,2,-1
KR_6744155567,420,4,13,52,5,2,1,3,2,1,3,2,0,2,-2,4,2,1,0,1,0,0,135,4,-7,3,4,0,1,0,1,1,-1,0,-1
KR_6637834090,420,-7,-96,-40,-8,-2,3,1,-2,4,2,0,1,1,-2,3,1,-2,2,0,0,-11,-6,-2,-5,7,-2,0,-2,-1,-1,-1,-1,2,-1
KR_6715987759,420,6,25,7,12,5,1,6,4,3,7,-3,3,0,6,3,9,0,0,0,0,14,7,2,-9,7,-6,0,0,1,0,-1,-1,4,-1
KR_6760268599,420,0,-2,-16,-1,5,2,7,-4,7,3,-2,4,2,1,5,6,-1,3,2,-2,-10,-2,0,-9,9,-4,0,-1,-1,-1,1,-1,2,-1
KR_6615201733,420,-7,-133,3,-14,-5,5,0,1,3,4,-4,7,3,-6,6,0,0,0,0,0,-5,4,2,-7,5,-6,0,-2,-1,-1,-1,-1,6,-1
KR_6758929799,420,3,5,21,1,-5,5,0,0,4,4,8,1,9,1,5,6,-3,3,0,-1,1,3,-1,-6,7,3,0,0,1,1,1,-1,5,-1
KR_6756191122,440,-8,-73,-27,-27,-12,12,0,-4,4,0,-2,4,2,-6,7,1,-3,5,2,-1,-21,6,-4,-1,5,-2,0,-2,0,0,-1,1,0,-1
KR_6721059552,420,-5,-86,-30,-17,-6,8,2,-5,5,0,-3,4,1,0,4,4,-3,3,0,0,-16,-11,-3,-3,6,-5,0,-2,-1,1,-1,-1,3,-1
KR_6735468020,420,-2,4,-4,-5,-5,6,1,2,0,2,-6,6,0,2,1,3,2,1,3,0,-10,-42,-5,-3,8,1,0,-2,1,-1,-1,1,3,-1
KR_6691100799,440,-2,-57,9,0,-2,3,1,2,1,3,-2,2,0,2,3,5,0,0,0,0,-9,-41,0,-4,4,1,0,-3,1,-1,-1,1,3,-1
KR_6649367988,420,-5,-44,-7,-11,0,1,1,-5,5,0,-1,5,4,-4,6,2,-1,1,0,0,-8,-3,1,-6,5,-1,0,-1,-1,-1,-1,-1,3,-1
KR_6709106915,420,-2,3,2,-7,0,1,1,1,2,3,-1,2,1,-3,4,1,-4,4,0,0,-11,-7,-2,-3,5,4,0,1,-1,1,1,1,1,-1
KR_6615565816,420,-7,-105,-18,-20,-4,7,3,-5,5,0,-2,4,2,-6,7,1,-3,3,0,0,-26,-26,1,-5,4,-2,0,-5,-1,-1,-1,-1,3,-1
KR_6564197227,420,1,-6,-22,-1,-2,2,0,3,1,4,-2,2,0,1,3,4,-1,1,0,0,-2,-19,-1,-6,7,-2,0,0,0,-1,-1,1,0,-1
KR_6670877243,420,-2,-17,-4,-2,3,0,3,-7,8,1,-3,3,0,0,0,0,5,0,5,0,-3,-4,-2,-4,6,0,0,1,-1,1,1,1,5,-1
KR_6726522775,440,-1,-18,-12,-5,-5,6,1,-4,4,0,0,0,0,0,1,1,4,0,4,0,0,4,2,-4,2,0,0,-1,0,-1,-1,-1,0,-1
KR_6746240763,420,-1,5,-8,-5,0,2,2,2,1,3,1,3,4,-7,11,4,-1,2,1,0,-11,-13,-3,-2,5,-1,0,-2,-1,-1,-1,1,6,-1
KR_6690422780,420,-9,-65,20,-20,-4,5,1,-7,8,1,-3,3,0,-5,6,1,-1,3,2,0,-22,-10,-4,-4,8,2,0,-2,-1,1,-1,-1,2,-1
KR_6765490987,420,-1,-34,7,-3,-3,5,2,-4,5,1,-2,3,1,2,1,3,4,0,4,0,3,-7,3,-6,3,-2,0,-1,1,-1,-1,-1,5,-1
KR_6699357322,420,-1,-36,0,-8,-2,3,1,-1,3,2,3,1,4,-1,1,0,-7,8,1,0,-8,-281,0,-5,5,0,0,-1,-1,-1,-1,-1,5,-1
KR_6732835037,420,0,43,16,-1,0,3,3,2,2,4,-2,6,4,0,0,0,-1,2,1,0,-6,-11,3,-6,3,-9,0,2,1,1,1,1,2,-1
KR_6729752986,440,-6,-96,-25,-17,-2,4,2,-12,12,0,1,2,3,-2,2,0,-2,2,0,0,-20,-4,0,-3,3,-5,0,-2,-1,1,-1,-1,3,-1
KR_6750978582,420,1,33,-29,5,1,2,3,-1,2,1,3,1,4,5,0,5,-3,4,1,0,8,8,2,-6,4,2,0,0,0,1,-1,1,0,-1
KR_6699546826,420,-1,43,12,-6,-1,2,1,-2,3,1,-2,2,0,2,3,5,-3,4,1,0,-7,-10,-1,-5,6,1,0,0,-1,1,0,-1,1,-1
KR_6757138261,420,-5,-26,0,-4,0,1,1,-7,8,1,-4,6,2,11,1,12,-4,4,0,4,0,-5,4,-8,4,-7,0,-3,-1,1,-1,1,6,-1
KR_6765173327,420,-4,-14,-12,-17,-3,3,0,2,2,4,-7,7,0,-6,7,1,-3,3,0,0,-21,2,-5,-2,7,-7,0,-1,-1,0,-1,-1,6,-1
KR_6666886019,420,-1,2,-24,0,-3,6,3,4,3,7,-1,6,5,0,2,2,0,1,1,0,0,-5,0,-10,10,3,0,0,1,1,-1,-1,5,-1
KR_6755232452,420,-3,-34,0,-13,2,1,3,-1,3,2,-4,5,1,-5,6,1,-5,5,0,-2,-21,99,3,-7,4,-3,0,-1,-1,-1,-1,-1,3,-1
KR_6734551152,420,-2,0,7,-6,-2,3,1,-1,4,3,-1,1,0,-4,5,1,2,1,3,0,-12,-5,-3,-3,6,5,0,-1,-1,-1,-1,1,4,-1
KR_6763332153,420,1,67,24,2,1,2,3,-1,4,3,2,0,2,0,2,2,0,0,0,0,-3,-112,4,-8,4,3,0,0,0,0,1,-1,0,-1
KR_6707449722,420,2,22,-17,6,3,5,8,1,1,2,2,1,3,-1,6,5,1,1,2,1,4,3,2,-7,5,0,0,0,-1,1,1,1,4,-1
KR_6630511564,420,-4,-43,2,-6,-3,7,4,-5,6,1,2,1,3,-1,5,4,1,1,2,0,-15,-5,2,-8,6,2,0,-1,-1,-1,-1,-1,1,-1
KR_6637703880,420,0,-12,-1,-2,0,1,1,-2,5,3,-4,4,0,0,3,3,4,1,5,1,4,-5,2,-5,3,-3,0,2,1,1,1,1,3,-1
KR_6696443171,420,-2,-43,-4,4,2,0,2,5,3,8,1,0,1,-2,6,4,-2,2,0,-1,1,-396,3,-10,7,-1,0,-2,-1,-1,-1,-1,5,-1
KR_6622474692,420,-2,-44,-23,0,-2,3,1,3,1,4,2,0,2,0,2,2,-3,3,0,-1,-1,-15,2,-4,2,-5,0,-1,-1,-1,-1,-1,1,-1
KR_6763642008,420,0,48,2,-2,-1,3,2,3,1,4,-3,3,0,-1,3,2,0,0,0,0,-6,-8,-3,-5,8,4,0,0,-1,1,0,-1,6,-1
KR_6764201718,420,1,-20,-14,0,-1,2,1,-2,4,2,-2,3,1,0,2,2,5,0,5,0,5,6,1,-3,2,1,0,-1,1,-1,-1,1,4,-1
KR_6718298479,420,-4,-58,0,-13,0,1,1,-7,9,2,-2,4,2,-3,4,1,-1,1,0,0,-14,95,-3,-3,6,-3,0,-2,1,1,-1,1,5,-1
KR_6626166455,420,0,-21,8,-7,0,0,0,-5,7,2,-2,4,2,1,5,6,-1,2,1,1,6,-3,2,-7,5,-1,0,0,1,-1,-1,1,4,-1
KR_6609251020,420,-7,-127,-16,-18,-14,14,0,-4,7,3,4,1,5,-3,4,1,-1,1,0,0,-16,-2,1,-5,4,-3,0,-5,-1,0,-1,-1,3,-1
KR_6756202331,420,-5,-67,-1,-4,-2,3,1,0,4,4,1,1,2,-4,4,0,1,0,1,0,-3,11,-1,-3,4,-2,0,-1,1,1,1,-1,3,-1
KR_6760546060,420,1,26,-1,3,-1,3,2,0,2,2,3,1,4,0,3,3,1,0,1,0,4,6,7,-9,2,3,0,1,-1,-1,1,1,2,-1
KR_6760070083,440,3,29,-14,5,1,0,1,0,4,4,2,0,2,1,1,2,1,0,1,0,0,-5,5,-10,5,1,0,0,0,1,0,-1,0,-1
KR_6690649954,440,-4,-9,-31,-12,-1,4,3,-4,5,1,-5,5,0,0,3,3,-2,3,1,-3,-22,19,-1,-5,6,0,0,-1,-1,1,-1,-1,4,-1
KR_6759919857,420,1,-1,13,2,5,2,7,-2,4,2,2,0,2,-2,3,1,-1,1,0,0,-1,-8,-2,-7,9,3,0,0,1,-1,1,-1,1,-1
KR_6713698886,420,3,67,51,6,-1,2,1,4,1,5,1,3,4,3,3,6,-1,1,0,1,9,35,-2,-4,6,4,0,-1,-1,1,1,-1,6,-1
KR_6692133704,420,0,-2,-4,-3,-2,2,0,-2,4,2,1,3,4,0,7,7,0,0,0,0,5,-12,-2,-7,9,1,0,-1,-1,-1,-1,1,1,-1
KR_6716013047,420,-2,-7,-1,-2,-2,3,1,1,1,2,0,2,2,-1,3,2,0,0,0,0,1,-17,-1,-4,5,-1,0,0,-1,-1,0,-1,1,-1
KR_6764157030,420,1,-9,-4,3,1,0,1,-3,3,0,1,3,4,3,2,5,1,0,1,0,-1,-1,-4,-1,5,1,0,0,1,-1,0,-1,4,-1
KR_6734697803,420,-1,50,-20,-5,4,1,5,-5,6,1,1,1,2,-7,7,0,2,2,4,0,-27,-1,1,-6,5,-1,0,1,-1,1,1,1,6,-1
KR_6630133443,420,1,-43,1,4,1,0,1,0,3,3,2,1,3,3,1,4,-2,2,0,0,5,-228,-5,-3,8,4,0,0,1,-1,0,-1,3,-1
KR_6651967817,420,-2,-25,7,-11,0,0,0,-3,3,0,-3,4,1,-4,5,1,-1,1,0,0,-19,5,3,-5,2,2,0,0,1,-1,-1,-1,4,-1
KR_6754562596,420,-4,-58,11,-6,-2,5,3,-1,3,2,-2,3,1,2,2,4,-3,3,0,0,8,1,-1,-5,6,1,0,-1,-1,-1,-1,-1,4,-1
KR_6744201326,420,-1,-20,0,4,1,1,2,-1,3,2,3,1,4,2,5,7,-1,1,0,0,1,5,4,-6,2,2,0,0,1,1,0,1,2,-1
KR_6759731502,420,0,21,21,-1,0,0,0,3,1,4,-4,7,3,1,1,2,-1,1,0,0,-3,-11,-1,-6,7,3,0,1,1,-1,1,1,6,-1
KR_6755575012,440,2,65,69,-3,-1,3,2,1,0,1,1,4,5,-6,6,0,2,0,2,0,-4,2,2,-8,6,-4,0,-1,-1,1,-1,1,6,-1
KR_6762039442,420,1,55,12,1,-3,4,1,-3,6,3,1,0,1,7,0,7,-1,2,1,0,3,3,1,-6,5,5,0,0,-1,-1,1,-1,4,-1
KR_6744226884,420,-6,-97,-9,-12,-1,2,1,-5,7,2,-6,6,0,0,3,3,0,1,1,0,-10,-2,-3,-4,7,0,0,-2,-1,-1,-1,1,3,-1
KR_6759388200,420,-3,-55,-16,-6,-5,5,0,1,1,2,4,0,4,-5,10,5,-1,1,0,0,-9,-23,4,-8,4,5,0,-2,0,-1,-1,1,0,-1
KR_6761611453,440,-2,-45,-16,-3,2,1,3,0,2,2,-3,3,0,-1,4,3,-1,3,2,0,0,-1,-1,-5,6,-5,0,-1,-1,1,-1,1,1,-1
KR_6700307807,420,-3,-23,-7,-7,1,1,2,1,1,2,-4,5,1,-4,6,2,-1,2,1,-1,-6,27,-1,-5,6,0,0,-2,0,-1,-1,-1,0,-1
KR_6667557136,420,-5,-79,4,-10,-2,4,2,0,3,3,-5,5,0,-3,4,1,0,0,0,0,-9,5,-6,-3,9,-3,0,-2,1,-1,-1,-1,6,-1
KR_6706901744,420,1,31,12,-4,5,0,5,1,0,1,-8,9,1,-3,3,0,1,0,1,0,-17,-23,0,-5,5,-4,0,1,-1,1,1,1,4,-1
KR_6762803339,420,-1,-97,-23,1,0,3,3,3,0,3,-2,2,0,1,0,1,-1,2,1,0,2,20,2,-6,4,-7,0,-4,-1,0,-1,-1,2,-1
KR_6699460757,420,-2,-62,-18,-6,-6,6,0,-3,5,2,4,0,4,-3,6,3,2,0,2,0,-7,-2,-2,-5,7,-3,0,-1,-1,1,-1,-1,3,-1
KR_6746994896,420,0,7,-16,-5,0,2,2,-2,4,2,0,4,4,1,1,2,-4,4,0,0,0,15,3,-7,4,1,0,-1,-1,-1,-1,1,6,-1
KR_6555519037,420,-2,-49,-9,-9,0,1,1,-5,6,1,-2,3,1,-1,4,3,-1,2,1,0,-12,-15,0,-6,6,1,0,0,1,-1,-1,-1,1,-1
KR_6718241812,420,-2,44,-6,1,2,2,4,1,1,2,-1,2,1,-1,1,0,0,0,0,0,-3,-4,0,-2,2,2,0,-1,-1,-1,-1,-1,3,-1
KR_6761398478,420,-1,-53,-2,-2,2,2,4,-3,5,2,3,0,3,0,1,1,-4,5,1,0,1,-12,-4,-5,9,5,0,-2,-1,1,-1,-1,5,-1
KR_6636212943,420,-2,48,-24,0,4,3,7,-7,7,0,1,1,2,1,1,2,1,0,1,0,-3,-3,-1,-4,5,-1,0,0,1,-1,1,-1,6,-1
KR_6743836072,440,4,52,16,3,1,2,3,2,2,4,4,1,5,-4,6,2,0,1,1,-1,-1,-12,-4,-3,7,8,0,0,-1,1,1,-1,2,-1
KR_6577793075,420,-3,-6,-12,-2,-3,5,2,1,1,2,-3,3,0,1,0,1,2,0,2,0,5,-2,0,-9,9,2,0,-1,1,-1,-1,1,2,-1
KR_6724931750,420,-4,0,-32,1,-4,5,1,3,10,13,0,1,1,0,4,4,2,0,2,3,10,-176,-1,-7,8,16,0,-2,1,-1,-1,1,2,-1
KR_6756887406,420,-3,-48,16,-5,-2,4,2,-4,5,1,6,0,6,0,5,5,-5,5,0,-1,-17,-6,-5,-4,9,3,0,0,1,-1,-1,-1,2,-1
KR_6760548002,420,-2,-32,0,-3,0,0,0,2,4,6,2,1,3,-5,6,1,-2,2,0,0,-5,-1,-3,-2,5,-3,0,0,0,-1,-1,-1,0,-1
KR_6751497962,420,6,71,-1,15,4,0,4,1,0,1,-1,4,3,8,2,10,3,0,3,1,13,-265,1,-4,3,-1,0,2,1,-1,1,1,3,-1
KR_6601073786,420,-5,-70,-43,-7,-3,3,0,-3,5,2,-7,7,0,5,0,5,1,0,1,0,1,-50,-4,-2,6,24,0,-3,1,-1,-1,-1,2,-1
KR_6763152449,420,-1,-33,16,-1,-2,4,2,0,2,2,0,2,2,2,3,5,-1,2,1,0,-2,-3,-2,-3,5,1,0,0,1,1,1,-1,5,-1
KR_6730920410,420,-2,-22,-13,-2,-5,5,0,6,0,6,-2,3,1,-1,2,1,0,0,0,0,6,-3,-2,-5,7,-4,0,-1,-1,-1,-1,-1,1,-1
KR_6705972257,420,0,-12,-12,0,0,2,2,1,2,3,1,2,3,-3,4,1,1,0,1,0,-3,7,2,-7,5,2,0,0,1,1,0,-1,4,-1
KR_6684311184,420,-2,-9,-14,-5,2,1,3,-1,2,1,-3,3,0,-3,4,1,0,1,1,0,-12,-1,-2,-4,6,1,0,-1,-1,1,-1,1,2,-1
KR_6629020562,420,0,79,5,1,1,0,1,1,2,3,2,3,5,-1,3,2,-2,3,1,0,-4,-12,-5,-4,9,5,0,1,-1,0,1,1,4,-1
KR_6758736696,420,-4,-56,-47,-3,-4,4,0,-4,4,0,-1,1,0,5,0,5,1,1,2,0,3,0,3,-6,3,3,0,0,1,-1,0,1,1,-1
KR_6762994336,420,-3,40,8,-10,-3,3,0,-3,3,0,1,1,2,-4,9,5,-1,1,0,0,-16,4,1,-8,7,3,0,0,-1,-1,0,1,4,-1
KR_6747575168,420,-8,-45,-31,-15,-1,3,2,-3,5,2,-3,3,0,-5,7,2,-3,3,0,0,-14,-48,1,-6,5,-1,0,-2,-1,-1,-1,-1,3,-1
KR_6746299749,420,2,77,0,8,2,1,3,-2,5,3,4,3,7,4,1,5,0,0,0,0,3,15,3,-7,4,-8,0,0,1,1,1,1,5,-1
KR_6762171859,420,1,-48,-12,0,0,1,1,3,1,4,1,2,3,-1,3,2,-3,4,1,0,-4,-5,2,-7,5,-6,0,0,-1,1,1,-1,6,-1
KR_6756979897,420,-1,-38,-11,-4,1,1,2,0,1,1,-3,3,0,-2,2,0,0,0,0,0,-4,20,4,-6,2,-6,0,0,-1,1,0,-1,2,-1
KR_6747765158,420,-6,-74,0,-9,1,1,2,-4,4,0,0,2,2,-3,4,1,-3,4,1,0,-12,-9,-6,-3,9,-2,0,-1,-1,1,-1,-1,1,-1
KR_6764940143,420,-6,-32,-21,-15,-2,3,1,-3,4,1,-9,12,3,-3,4,1,2,0,2,-1,-19,-111,-1,-4,5,1,0,-1,-1,-1,-1,-1,2,-1
KR_6755366516,420,-3,-19,-61,1,2,3,5,1,0,1,1,3,4,-3,5,2,0,0,0,-1,13,5,1,-7,6,-2,0,0,-1,-1,-1,1,4,-1
KR_6741545488,420,-4,-5,-9,-4,0,3,3,-4,6,2,-3,4,1,0,1,1,3,1,4,0,3,-15,-1,-5,6,-6,0,-2,-1,-1,-1,1,4,-1
KR_6728361132,420,-4,-53,-5,-12,-4,4,0,-1,3,2,-1,3,2,-6,6,0,0,2,2,0,-7,-20,2,-6,4,-1,0,-1,-1,-1,-1,-1,5,-1
KR_6742929599,440,3,43,15,-2,2,0,2,-3,4,1,1,2,3,1,3,4,-3,3,0,0,0,-1,4,-5,1,0,0,1,0,1,1,1,0,-1
KR_6763717525,420,0,14,0,-6,1,2,3,2,3,5,-4,4,0,-3,4,1,-2,3,1,0,-6,-11,-1,-7,8,-1,0,0,-1,1,0,-1,4,-1
KR_6706334062,420,2,11,36,0,2,0,2,-1,1,0,4,2,6,-4,4,0,-1,2,1,0,-7,198,-1,-7,8,-6,0,1,-1,1,1,-1,1,-1
KR_6751289127,440,1,-61,-23,5,-1,5,4,3,1,4,2,1,3,1,1,2,0,2,2,1,2,6,1,-5,4,-6,0,-2,1,-1,-1,1,6,-1
KR_6636300515,420,-3,-67,-20,-1,-2,2,0,1,4,5,-3,4,1,3,1,4,0,0,0,0,3,-36,1,-4,3,0,0,-2,0,-1,-1,-1,0,-1
KR_6752780039,420,0,-84,30,1,1,2,3,-1,4,3,0,2,2,3,3,6,-2,3,1,-1,-3,-101,0,-5,5,-3,0,0,1,-1,-1,-1,5,-1
KR_6752348553,420,-1,-7,-12,1,4,2,6,0,0,0,2,1,3,-5,6,1,0,0,0,0,4,-1,-2,-5,7,5,0,1,-1,1,-1,1,2,-1
KR_6748289325,420,-4,-31,-24,-12,6,0,6,-9,9,0,-2,3,1,-6,7,1,-1,1,0,0,-3,-6,-2,-3,5,1,0,-2,-1,-1,-1,-1,5,-1
KR_6755376014,420,0,-55,9,0,-1,3,2,-3,5,2,4,3,7,-2,4,2,2,1,3,0,-5,-165,-1,-4,5,18,0,-2,-1,-1,-1,-1,6,-1
KR_6713421492,420,-4,-44,1,-11,0,3,3,2,1,3,-3,5,2,-1,2,1,-9,9,0,0,-10,-19,-5,-1,6,1,0,-1,-1,1,-1,-1,3,-1
KR_6760372006,420,-2,-8,-26,-5,4,1,5,-3,4,1,-5,7,2,4,0,4,-5,5,0,0,-5,49,4,-9,5,-40,0,0,-1,-1,-1,-1,2,-1
KR_6744626633,420,-3,-88,-19,-10,1,1,2,-3,5,2,-4,7,3,-5,6,1,1,1,2,-1,-4,-11,-3,-5,8,8,0,-3,-1,-1,-1,-1,2,-1
KR_6750818470,420,-1,-20,-16,3,0,2,2,1,2,3,2,2,4,3,1,4,-3,3,0,0,1,-3,4,-8,4,-6,0,-1,-1,-1,-1,-1,1,-1
KR_6754040234,420,-1,6,-12,-1,0,3,3,-1,4,3,4,0,4,-3,4,1,-1,1,0,0,-1,-4,-2,-3,5,-1,0,0,-1,1,-1,1,3,-1
KR_6738663572,440,-3,-38,-4,-6,-2,3,1,-1,5,4,-1,4,3,-1,4,3,-1,1,0,0,-5,2,5,-8,3,-1,0,0,-1,0,-1,-1,5,-1
KR_6687436289,420,-4,-41,-8,-8,-4,5,1,-1,5,4,-2,6,4,-1,3,2,0,0,0,0,-3,0,6,-10,4,-3,0,0,-1,-1,-1,1,2,-1
KR_6750973193,420,0,-48,23,-3,4,3,7,0,1,1,-3,4,1,-6,8,2,2,0,2,1,-7,13,8,-11,3,-7,0,-2,1,0,-1,1,4,-1
KR_6733560968,420,-2,-42,-19,-3,0,1,1,-1,7,6,1,2,3,-5,7,2,2,0,2,1,8,-9,-1,-2,3,0,0,0,-1,-1,0,1,3,-1
KR_6546084049,420,1,29,-16,-2,-1,3,2,2,2,4,2,0,2,-2,3,1,-3,3,0,0,1,-4,-3,-6,9,4,0,0,-1,1,1,-1,4,-1
KR_6425016328,420,2,31,-9,2,-1,2,1,0,4,4,5,1,6,-3,3,0,1,2,3,0,-4,12,0,-2,2,1,0,0,-1,-1,1,1,2,-1
KR_6724771661,420,-1,-42,13,-3,-4,6,2,2,1,3,-2,2,0,1,1,2,0,1,1,0,4,-8,1,-6,5,-3,0,-1,1,-1,-1,1,1,-1
KR_6756199981,440,2,-71,-8,-4,-1,4,3,0,1,1,4,4,8,-7,8,1,0,1,1,0,-7,-7,-3,-2,5,0,0,-1,1,1,-1,-1,5,-1
KR_6623946604,440,0,58,0,6,1,0,1,-5,6,1,1,0,1,7,2,9,2,1,3,0,5,0,1,-4,3,0,0,0,-1,0,0,1,1,-1
KR_6727649583,420,-2,-14,7,-5,-2,3,1,-2,5,3,-2,4,2,3,0,3,-2,3,1,0,-5,35,-2,-4,6,-9,0,-1,-1,-1,-1,-1,1,-1
KR_6654184599,420,-4,-104,-24,-11,-5,6,1,0,1,1,-4,4,0,-2,5,3,0,0,0,0,-5,2,0,-5,5,1,0,-1,-1,1,-1,-1,4,-1
KR_6756420335,420,1,46,-11,5,1,1,2,2,4,6,2,0,2,-1,2,1,1,1,2,0,0,0,2,-6,4,-1,0,0,-1,-1,0,-1,5,-1
KR_6447396690,420,4,-1,-4,5,2,0,2,-2,3,1,1,2,3,3,2,5,1,0,1,0,6,10,-5,-5,10,4,0,-1,-1,-1,-1,1,3,-1
KR_6755480969,420,-1,5,-20,-7,-1,2,1,-1,2,1,4,2,6,-6,7,1,-3,4,1,0,-1,1,0,-6,6,-3,0,-1,-1,-1,-1,-1,5,-1
KR_6755827928,420,-2,-2,8,-10,0,5,5,-2,6,4,-4,4,0,-1,3,2,-3,4,1,0,-5,-14,-3,-6,9,-1,0,-1,0,-1,-1,-1,0,-1
KR_6765446876,420,-2,-51,34,-1,-5,6,1,1,5,6,4,0,4,-1,3,2,0,0,0,2,-1,5,2,-11,9,-3,0,-1,1,-1,-1,-1,1,-1
KR_6685020167,420,-1,1,2,-4,0,0,0,-1,3,2,2,3,5,-3,6,3,-2,2,0,0,-3,-109,2,-8,6,-3,0,0,-1,1,0,-1,6,-1
KR_6764552600,420,3,6,-12,10,-2,5,3,1,1,2,7,0,7,3,0,3,1,1,2,0,13,-41,1,-8,7,2,0,-1,1,1,-1,-1,4,-1
KR_6745249304,440,-3,-33,-13,-7,-1,2,1,0,2,2,1,2,3,-5,5,0,-2,3,1,0,-12,21,-1,-3,4,0,0,0,-1,0,-1,-1,3,-1
KR_6739170041,420,-3,-57,16,-7,-2,3,1,-3,3,0,-4,4,0,3,1,4,-1,1,0,0,-4,-16,0,-6,6,1,0,-1,1,-1,-1,1,1,-1
KR_6751118044,420,-1,-12,-1,-7,-3,3,0,-6,6,0,-3,3,0,5,3,8,0,0,0,0,-5,-2,-1,-5,6,1,0,0,0,-1,1,-1,0,-1
KR_6762566108,420,0,-20,-17,1,2,2,4,-2,2,0,3,0,3,-2,4,2,0,2,2,1,-4,-4,-2,-8,10,1,0,-2,1,-1,-1,1,6,-1
KR_6764862285,420,1,46,21,-5,3,0,3,-1,3,2,-2,3,1,-3,6,3,-2,2,0,1,-9,30,-1,-5,6,-9,0,-1,-1,1,1,1,4,-1
KR_6726448389,420,-2,-42,-14,-6,1,1,2,-7,8,1,-4,6,2,1,2,3,3,0,3,-1,-9,18,-1,-6,7,-6,0,-1,1,-1,-1,-1,6,-1
KR_6754496774,420,0,-9,0,-5,-1,1,0,0,2,2,-3,5,2,-2,4,2,1,3,4,0,-7,22,-6,-2,8,4,0,0,-1,1,0,-1,6,-1
KR_6730004826,420,-5,52,-30,-10,-3,3,0,-3,3,0,0,1,1,-3,4,1,-1,2,1,-2,-12,7,0,-2,2,-1,0,1,1,1,1,-1,3,-1
KR_6698194160,420,0,-53,23,-5,-2,3,1,0,4,4,2,2,4,-3,3,0,-2,4,2,1,-6,-96,1,-6,5,-2,0,-1,-1,1,-1,1,4,-1
KR_6634522590,420,-1,-1,-9,0,-1,2,1,3,2,5,-3,3,0,1,1,2,0,0,0,0,-1,6,6,-8,2,-4,0,-1,1,1,-1,1,4,-1
KR_6754676181,420,-4,-61,-8,-17,-1,3,2,0,1,1,0,3,3,-9,10,1,-7,7,0,-1,-11,-24,-6,-1,7,-1,0,-2,-1,-1,-1,-1,1,-1
KR_6637917108,420,-1,-29,12,-7,-3,6,3,-3,5,2,0,4,4,0,1,1,-1,1,0,0,-4,-6,3,-8,5,-1,0,0,-1,1,-1,1,5,-1
KR_6750408896,420,-3,-24,6,-5,-1,2,1,-4,6,2,-1,3,2,1,1,2,0,2,2,-1,-7,-8,-2,-2,4,-2,0,-1,1,1,-1,1,5,-1
KR_6757983937,420,-1,-5,12,-7,0,1,1,-7,8,1,4,1,5,-4,5,1,0,0,0,0,-13,103,-6,-3,9,-2,0,0,-1,1,-1,-1,5,-1
KR_6763072816,420,1,7,24,2,3,0,3,-2,5,3,1,4,5,0,3,3,0,1,1,0,5,-2,-3,-8,11,0,0,0,-1,-1,-1,1,6,-1
KR_6742244294,420,-3,-87,-13,-5,0,2,2,-7,9,2,2,1,3,1,4,5,-1,3,2,-1,-5,-5,3,-7,4,-9,0,-1,1,-1,-1,-1,5,-1
KR_6762236750,420,-2,9,-13,-1,0,2,2,-1,1,0,-3,3,0,3,2,5,0,0,0,1,-1,1,2,-6,4,0,0,0,1,-1,-1,-1,4,-1
KR_6764300005,440,-2,-19,-20,-14,-4,5,1,-1,2,1,-4,4,0,-3,7,4,-2,2,0,0,-25,3,5,-5,0,-3,0,0,-1,1,1,-1,1,-1
KR_6564180216,420,-6,-8,-11,-13,2,3,5,-5,6,1,-9,11,2,-1,2,1,0,0,0,1,-21,-25,-2,-2,4,-1,0,1,-1,-1,1,1,1,-1
KR_6764626578,420,-6,-44,-32,-8,-2,2,0,-3,5,2,0,3,3,-4,4,0,1,1,2,0,-4,4,-1,-5,6,-3,0,-2,-1,1,-1,1,5,-1
KR_6654288152,420,-2,-36,7,-5,-1,2,1,-4,8,4,-1,2,1,0,2,2,1,0,1,0,-8,24,-4,-6,10,2,0,-1,-1,1,-1,-1,3,-1
KR_6577843640,420,0,-46,-5,-6,-4,5,1,1,2,3,-3,5,2,0,5,5,0,0,0,0,-1,3,-5,-5,10,-6,0,-1,-1,-1,-1,-1,4,-1
KR_6742130020,420,-2,-42,-47,-11,4,1,5,-4,6,2,-7,7,0,-3,4,1,-1,1,0,0,-7,0,-1,-4,5,-2,0,0,-1,-1,-1,-1,2,-1
KR_6758005465,420,-2,18,-9,-4,2,0,2,-3,3,0,-4,6,2,1,1,2,0,2,2,0,-14,-16,-8,-3,11,-1,0,0,1,-1,1,1,4,-1
KR_6757067948,420,0,-2,-6,-6,3,0,3,-3,3,0,-1,3,2,-1,6,5,-4,5,1,0,-14,-1,3,-7,4,4,0,1,-1,1,1,-1,1,-1
KR_6628972240,420,-3,-21,-28,3,-1,2,1,0,2,2,1,2,3,3,1,4,0,3,3,0,4,2,-3,-5,8,-6,0,-1,-1,-1,-1,1,6,-1
KR_6711253009,420,2,-29,-2,0,2,3,5,-4,4,0,-2,3,1,2,4,6,2,0,2,0,-2,4,0,-4,4,-2,0,0,-1,-1,0,-1,5,-1
KR_6628597535,420,-1,-7,12,-1,-4,5,1,6,0,6,-3,4,1,-1,5,4,1,0,1,0,4,0,0,-5,5,1,0,0,0,1,-1,1,0,-1
KR_6745091829,440,0,86,-28,0,-1,1,0,0,3,3,2,2,4,0,3,3,-1,2,1,0,-2,-43,-6,-1,7,22,0,1,0,1,1,1,0,-1
KR_6699963039,420,-2,-36,29,-7,-3,3,0,-3,4,1,-2,3,1,1,1,2,0,0,0,0,-2,-1,-2,-1,3,0,0,-3,1,-1,-1,-1,5,-1
KR_6666981386,420,-4,-146,12,-4,0,2,2,-7,9,2,0,1,1,3,2,5,0,1,1,0,-4,9,5,-11,6,-5,0,-2,-1,1,-1,1,6,-1
KR_6622369487,420,-2,-19,-15,-6,5,0,5,-2,6,4,-6,7,1,-1,3,2,-2,2,0,-1,-10,2,1,-7,6,-7,0,0,-1,-1,-1,-1,5,-1
KR_6758980233,440,-8,-88,-19,-10,0,3,3,-7,9,2,-4,4,0,3,1,4,-2,2,0,0,-12,3,1,-7,6,-6,0,-1,1,1,-1,-1,5,-1
KR_6699194820,420,1,40,0,2,-4,4,0,-1,2,1,0,2,2,6,0,6,1,1,2,0,6,51,-1,-4,5,-15,0,3,1,-1,1,-1,1,-1
KR_6476566241,420,-1,30,-13,-5,-2,2,0,-1,4,3,-4,6,2,3,2,5,-1,1,0,-1,-3,84,-4,-4,8,6,0,-1,-1,-1,-1,-1,5,-1
KR_6707049874,420,-2,-82,4,0,3,2,5,1,1,2,-5,8,3,0,2,2,1,0,1,0,6,-5,1,-7,6,2,0,-2,-1,1,-1,-1,4,-1
KR_6763265317,440,1,16,-10,5,2,0,2,-1,3,2,0,1,1,1,2,3,3,2,5,0,3,-4,2,-3,1,4,0,0,1,1,0,1,4,-1
KR_6749657921,420,-3,-53,35,-13,-3,3,0,-4,5,1,1,1,2,-7,9,2,0,2,2,0,-11,7,1,-8,7,-13,0,-1,1,1,-1,-1,5,-1
KR_6642991912,420,-3,-46,-21,-7,-3,3,0,-1,2,1,-5,6,1,1,2,3,1,0,1,0,-4,107,2,-6,4,2,0,-1,1,-1,-1,-1,4,-1
KR_6707417809,420,0,25,-43,0,-1,3,2,6,0,6,-2,3,1,5,1,6,-8,9,1,1,-4,7,6,-9,3,-3,0,0,-1,-1,-1,1,2,-1
KR_6550597346,420,0,-32,4,1,3,0,3,-1,4,3,0,0,0,-2,2,0,1,0,1,0,-2,52,2,-7,5,-5,0,0,1,-1,-1,1,2,-1
KR_6745438713,420,1,24,-4,1,3,3,6,2,2,4,5,0,5,-8,8,0,-1,2,1,-3,-7,2,-2,0,2,-1,0,-2,1,-1,-1,1,5,-1
KR_6763274578,420,0,-31,33,-2,-2,3,1,-3,4,1,-1,2,1,3,0,3,1,0,1,0,-2,-90,2,-10,8,-2,0,0,-1,-1,0,-1,4,-1
KR_6653851254,420,-4,-64,-3,-8,0,1,1,-8,11,3,-2,4,2,6,1,7,-4,4,0,-1,-20,-21,-1,-7,8,-2,0,-1,1,-1,-1,-1,6,-1
KR_6616115847,420,-5,-25,-20,-12,-7,7,0,-2,4,2,-3,3,0,1,2,3,-1,1,0,-1,-12,0,2,-6,4,2,0,-2,-1,-1,-1,-1,2,-1
KR_6705959740,420,-3,-92,-22,-9,-7,7,0,-2,3,1,1,0,1,-1,2,1,0,1,1,0,-14,2,-1,-3,4,-4,0,-1,-1,-1,-1,1,2,-1
KR_6717796362,420,1,-22,19,-1,-4,4,0,0,2,2,0,0,0,1,2,3,2,0,2,0,0,-1,0,-5,5,3,0,-1,1,-1,-1,1,5,-1
KR_6764602185,420,-1,3,2,-5,-2,5,3,2,1,3,-2,5,3,-2,2,0,-1,1,0,-1,-1,-2,-4,-3,7,0,0,0,-1,-1,0,-1,6,-1
KR_6747748688,420,-2,-58,-9,-11,0,1,1,0,2,2,-1,2,1,-6,9,3,-4,4,0,0,-11,10,2,-7,5,4,0,-1,-1,-1,-1,-1,5,-1
KR_6762164537,420,1,-1,0,2,3,1,4,-4,6,2,1,1,2,3,0,3,-1,2,1,1,3,7,2,-4,2,-2,0,1,-1,-1,1,1,5,-1
KR_6743027179,420,-5,-46,-13,-12,-2,3,1,-6,7,1,6,0,6,-7,7,0,-3,3,0,-1,-20,13,-3,-3,6,-1,0,-1,-1,0,-1,-1,4,-1
KR_6757993508,420,-5,-52,-24,-16,-3,4,1,0,2,2,-8,9,1,-3,5,2,-2,3,1,0,-14,-2,-4,-5,9,3,0,-2,-1,-1,-1,1,6,-1
KR_6732885268,420,-2,19,11,-4,1,2,3,-1,3,2,-1,2,1,-1,3,2,-2,2,0,0,-4,-57,-4,-2,6,11,0,0,1,-1,-1,1,6,-1
KR_6698257023,420,3,26,-8,7,-2,3,1,7,2,9,1,2,3,1,0,1,0,0,0,0,9,8,3,-9,6,-7,0,-1,-1,-1,-1,1,3,-1
KR_6764015500,420,1,-52,18,6,-3,3,0,3,3,6,0,3,3,5,1,6,1,1,2,0,11,313,6,-10,4,-7,0,0,1,1,0,1,2,-1
KR_6753855071,440,2,58,-12,4,-2,3,1,0,2,2,-1,3,2,6,2,8,1,2,3,0,4,-6,-2,-2,4,1,0,0,-1,0,-1,1,2,-1
KR_6758068300,420,-3,-30,4,-9,-1,2,1,-3,4,1,-1,1,0,-4,4,0,0,1,1,0,-14,23,-2,-3,5,-6,0,0,-1,-1,-1,-1,3,-1
KR_6763787461,420,2,-30,4,-4,1,1,2,-2,3,1,1,1,2,-3,3,0,-1,3,2,0,-10,8,3,-7,4,-1,0,0,-1,1,0,-1,1,-1
KR_6762349636,420,2,33,18,-1,2,0,2,-1,2,1,0,2,2,-1,5,4,-1,2,1,1,-4,1,-2,-4,6,0,0,-1,-1,-1,-1,1,5,-1
KR_6764731493,420,3,-14,29,3,2,3,5,1,3,4,-1,3,2,1,3,4,0,1,1,0,2,-177,3,-9,6,4,0,0,-1,0,0,-1,2,-1
KR_6708682984,420,0,40,7,-5,2,0,2,-2,6,4,-4,4,0,0,1,1,-1,1,0,0,-3,-13,-4,-3,7,3,0,0,-1,1,0,-1,6,-1
KR_6727862235,420,-2,8,12,-3,-1,1,0,0,1,1,0,3,3,-2,2,0,0,1,1,0,-1,-2,-3,-3,6,2,0,1,1,1,1,-1,2,-1
KR_6728417569,420,-2,-42,-55,1,-4,5,1,1,1,2,-3,5,2,6,1,7,1,2,3,0,9,54,1,-7,6,-25,0,0,1,-1,-1,-1,4,-1
KR_6717511824,420,0,73,10,-2,0,1,1,-1,2,1,-2,2,0,0,5,5,1,1,2,0,2,-1,-1,-8,9,9,0,0,1,-1,0,1,3,-1
KR_6681499386,440,2,12,9,-1,-3,3,0,1,4,5,-1,1,0,-4,5,1,6,1,7,0,8,16,3,-7,4,-1,0,1,1,-1,1,-1,3,-1
KR_6750768736,420,-2,-55,-9,-12,1,1,2,-5,8,3,-6,6,0,-1,3,2,-1,1,0,-1,-17,-1,-4,-3,7,5,0,-2,-1,-1,-1,-1,1,-1
KR_6762476953,420,0,-12,13,-3,4,1,5,-5,8,3,-3,4,1,0,4,4,1,1,2,0,-3,-1,-1,-8,9,-1,0,-1,1,-1,-1,1,1,-1
KR_6764045560,420,-5,-31,-26,-11,-3,3,0,-4,4,0,-3,4,1,-1,3,2,0,1,1,0,-10,-13,-5,-2,7,-2,0,-1,-1,-1,-1,-1,3,-1
KR_6620463509,420,-2,-63,6,-9,-4,6,2,-2,4,2,0,3,3,-5,7,2,2,1,3,0,-9,-15,0,-6,6,-4,0,-1,-1,1,-1,-1,3,-1
KR_6713662556,420,-1,-45,-24,-2,-1,2,1,0,2,2,-5,7,2,3,1,4,1,0,1,0,0,131,-1,-4,5,-1,0,-1,1,-1,1,-1,2,-1
KR_6764890052,440,0,51,-9,4,-4,7,3,1,2,3,4,4,8,0,5,5,3,0,3,1,3,4,5,-7,2,-1,0,1,0,-1,-1,1,0,-1
KR_6713300367,420,-1,-65,-24,-3,-4,5,1,1,3,4,1,1,2,2,1,3,-3,3,0,0,1,3,5,-9,4,-4,0,0,0,-1,0,-1,0,-1
KR_6741285583,420,1,-19,-12,-2,-1,2,1,2,5,7,-6,6,0,1,2,3,2,2,4,0,-4,-1,-4,-3,7,1,0,1,1,-1,1,1,5,-1
KR_6761955120,420,2,-24,40,4,-1,2,1,-3,4,1,3,2,5,-3,6,3,8,0,8,0,11,-36,1,-4,3,30,0,-2,1,-1,-1,-1,3,-1
KR_6731604667,420,-6,8,-11,-16,-1,4,3,1,1,2,-3,5,2,-12,13,1,-1,1,0,0,-19,37,0,-5,5,-26,0,-2,-1,-1,-1,-1,1,-1
KR_6753195694,440,-1,-87,11,-4,2,0,2,-1,3,2,1,2,3,-5,5,0,-1,2,1,0,-6,-13,0,-5,5,-4,0,-1,1,-1,-1,1,4,-1
KR_6761642729,420,-1,44,-27,3,1,3,4,2,6,8,-4,5,1,2,4,6,2,0,2,0,-1,187,0,-7,7,2,0,0,-1,1,0,1,1,-1
KR_5746587250,420,-4,11,-18,-8,1,2,3,2,3,5,2,1,3,-12,12,0,-1,3,2,0,-17,-2,2,-9,7,-1,0,-2,1,1,-1,-1,2,-1
KR_6736407357,420,-4,-71,-16,-14,1,2,3,-5,5,0,0,2,2,-8,8,0,-2,4,2,0,-11,3,1,-6,5,-8,0,-1,-1,1,-1,-1,3,-1
KR_6736321503,440,-4,-38,8,-11,-3,4,1,-2,6,4,-1,1,0,-5,7,2,0,1,1,0,-8,-298,-1,-2,3,-1,0,-2,-1,1,-1,1,6,-1
KR_6637444486,420,2,-20,9,3,8,0,8,-2,3,1,-1,2,1,-2,2,0,0,0,0,0,0,11,-1,-6,7,-8,0,1,1,1,1,-1,5,-1
KR_6483797397,420,-2,-32,-19,-3,2,1,3,-3,4,1,3,1,4,-4,6,2,-1,1,0,0,-11,30,2,-6,4,0,0,0,1,1,0,-1,5,-1
KR_6761254099,420,0,-24,-8,4,3,1,4,1,2,3,1,1,2,-1,3,2,0,2,2,2,3,-13,2,-6,4,-1,0,0,-1,1,0,1,4,-1
KR_6717709278,420,1,29,-4,-2,1,0,1,-2,4,2,-2,2,0,2,2,4,-1,2,1,0,-13,-17,-3,-3,6,-5,0,1,-1,1,1,-1,5,-1
KR_6741180778,420,-1,-40,8,-3,-3,4,1,-3,5,2,5,2,7,-4,8,4,2,0,2,0,9,-10,-1,-6,7,2,0,-2,-1,-1,-1,-1,1,-1
KR_6752572683,420,-1,-47,22,-4,0,2,2,-2,3,1,2,0,2,-3,5,2,-1,2,1,0,-10,8,5,-11,6,-6,0,-1,-1,-1,-1,-1,6,-1
KR_6683474166,420,-3,-39,-5,0,-1,2,1,-1,3,2,0,2,2,1,2,3,1,1,2,0,2,-4,-2,-4,6,3,0,0,-1,-1,-1,1,5,-1
KR_6761535287,420,1,-12,11,7,4,1,5,3,7,10,0,2,2,1,2,3,-1,1,0,1,10,-3,5,-6,1,2,0,0,1,1,1,1,1,-1
KR_6760118777,420,-2,21,-24,1,0,1,1,1,1,2,-1,1,0,1,2,3,0,2,2,0,-3,-3,4,-7,3,-1,0,0,-1,-1,-1,1,4,-1
KR_6751927910,420,-5,-65,-32,-11,-1,3,2,0,6,6,-1,2,1,-8,9,1,-1,2,1,0,-9,1,-4,-1,5,1,0,-2,-1,-1,-1,1,6,-1
KR_6740591580,420,-1,41,3,-7,1,3,4,-3,5,2,-2,2,0,0,2,2,-3,5,2,1,-10,-17,-1,-4,5,-1,0,0,-1,1,-1,1,5,-1
KR_6727920750,420,-4,-36,-29,-5,-4,6,2,-2,3,1,-1,2,1,2,1,3,0,1,1,0,-9,2,1,-6,5,-3,0,0,-1,1,1,-1,6,-1
KR_6756309114,420,0,42,-6,-3,-1,2,1,1,2,3,-1,2,1,-1,3,2,-1,1,0,0,-5,8,0,-5,5,-5,0,0,-1,-1,0,-1,1,-1
KR_6695267545,420,-1,-35,-20,-6,2,2,4,-8,10,2,-1,2,1,1,2,3,0,1,1,0,-10,31,0,-3,3,-2,0,0,0,1,-1,-1,0,-1
KR_6761426339,420,1,-60,-3,-2,-3,3,0,0,6,6,-2,5,3,2,0,2,1,2,3,0,4,35,2,-9,7,-1,0,-1,-1,-1,-1,-1,5,-1
KR_6764746968,420,-2,-48,-35,-7,-2,3,1,1,1,2,-3,3,0,-2,4,2,-1,1,0,0,-4,-2,2,-4,2,2,0,2,1,-1,1,-1,5,-1
KR_6689847687,420,-2,19,-8,-1,4,2,6,-2,2,0,-2,8,6,1,3,4,-2,2,0,0,4,9,1,-6,5,3,0,1,1,1,1,1,2,-1
KR_6725295213,420,-3,-50,-26,-6,2,1,3,-2,7,5,0,1,1,-5,6,1,-1,2,1,0,1,-14,-10,0,10,2,0,-1,-1,1,-1,-1,4,-1
KR_6763514676,420,-9,-67,-26,-21,0,3,3,-1,2,1,-7,8,1,-12,12,0,-1,1,0,0,-6,-4,-4,-2,6,-2,0,0,-1,-1,-1,-1,3,-1
KR_6654469421,420,2,97,11,4,0,1,1,-2,3,1,5,0,5,1,1,2,0,1,1,1,6,-2,6,-9,3,4,0,0,1,0,0,1,1,-1
KR_6736879557,420,-5,-8,0,-10,0,0,0,-1,1,0,-5,5,0,2,1,3,-6,6,0,-1,-10,0,5,-7,2,-1,0,-1,1,-1,-1,-1,2,-1
KR_6762576349,420,-4,17,-13,-10,-3,4,1,-4,5,1,-3,3,0,0,1,1,0,2,2,0,-5,0,1,-5,4,-2,0,-1,-1,-1,-1,1,5,-1
KR_6728354491,420,-2,-29,-23,-5,-3,3,0,-1,2,1,-2,2,0,1,4,5,0,2,2,0,0,-14,-4,-2,6,1,0,0,-1,-1,-1,-1,4,-1
KR_6764469100,420,-4,-28,1,-7,-3,4,1,-1,2,1,0,1,1,-2,3,1,-1,1,0,0,-3,-11,2,-4,2,-1,0,0,-1,0,0,-1,2,-1
KR_6760119274,420,-3,-13,-18,-9,-2,3,1,-2,2,0,3,2,5,-7,11,4,-1,1,0,0,-11,1,-4,-2,6,-3,0,0,1,-1,-1,-1,4,-1
KR_6751473940,420,-1,-29,-22,6,2,1,3,2,1,3,1,0,1,0,0,0,1,1,2,0,5,2,4,-8,4,-1,0,-1,-1,1,-1,1,2,-1
KR_6749082016,420,-1,5,-4,-4,-4,4,0,-1,3,2,0,0,0,2,0,2,-1,1,0,0,1,-4,1,-5,4,-8,0,0,-1,-1,0,1,2,-1
KR_6757075422,420,3,48,8,6,7,2,9,2,0,2,2,3,5,-4,6,2,-1,1,0,0,0,-3,1,-10,9,5,0,-1,1,1,1,1,1,-1
KR_6757114453,440,1,-39,0,-3,2,2,4,-2,3,1,-1,4,3,0,1,1,-2,4,2,0,-6,284,-3,-1,4,1,0,0,1,-1,0,-1,3,-1
KR_6748534245,440,-2,-56,-8,4,-2,4,2,-1,1,0,7,3,10,-1,5,4,1,1,2,0,2,-5,0,-3,3,0,0,-1,-1,1,-1,-1,3,-1
KR_6732617708,420,-1,-43,0,-12,2,1,3,-1,1,0,0,2,2,-11,12,1,-2,2,0,-3,-25,-6,1,-6,5,3,0,0,-1,1,0,-1,6,-1
KR_6687877898,420,-6,-25,-52,-21,-3,3,0,-4,5,1,-11,11,0,-3,3,0,0,1,1,0,-18,-2,-5,0,5,1,0,-3,-1,-1,-1,-1,5,-1
KR_6602429057,420,-1,-17,24,-7,2,0,2,-10,10,0,4,0,4,-2,2,0,-1,1,0,1,-8,-31,-2,-4,6,-6,0,0,-1,1,1,1,1,-1
KR_6760560928,420,-2,-63,-45,-10,-4,6,2,-2,3,1,1,1,2,-8,8,0,3,3,6,1,-6,-11,-6,-3,9,3,-1,-6,1,-1,-1,1,1,-1
KR_6761828731,420,2,-6,6,2,6,1,7,-4,6,2,2,2,4,0,5,5,-2,2,0,-1,-8,0,-4,-5,9,-3,0,0,1,1,-1,-1,1,-1
KR_6642379160,420,-5,-41,-26,-6,-4,4,0,0,0,0,0,1,1,-3,3,0,1,0,1,0,-2,-2,0,-4,4,-2,0,0,1,-1,0,-1,1,-1
KR_6725917516,420,0,-6,12,1,-2,3,1,0,3,3,3,1,4,1,5,6,-1,3,2,2,7,-1,-1,-7,8,-1,0,0,1,-1,0,1,5,-1
KR_6684722776,420,-2,-59,-23,-2,3,1,4,1,2,3,-4,5,1,-2,5,3,0,2,2,0,-6,-7,-2,-4,6,1,0,-1,-1,1,-1,-1,2,-1
KR_6729504734,420,1,1,-32,1,-8,8,0,6,1,7,-1,1,0,2,2,4,2,0,2,0,6,142,0,-6,6,3,0,1,-1,-1,1,-1,1,-1
KR_6653774361,420,1,42,-34,1,-1,2,1,0,3,3,0,5,5,2,0,2,0,0,0,0,1,-1,0,-5,5,-2,0,-1,1,-1,-1,-1,3,-1
KR_6759415903,420,-5,-61,-17,-9,-3,4,1,1,2,3,-3,9,6,-2,3,1,-2,2,0,0,-6,-6,0,-5,5,0,0,0,0,0,0,-1,0,-1
KR_6762115389,420,-1,8,-18,-7,0,0,0,0,1,1,-2,2,0,-4,4,0,-1,1,0,0,-7,-168,-2,-4,6,-8,0,0,-1,-1,0,-1,5,-1
KR_6762618801,440,0,-25,27,-2,-2,4,2,1,0,1,-2,3,1,1,0,1,0,3,3,-1,3,0,-2,-2,4,3,0,0,1,0,0,-1,2,-1
KR_6616558328,420,-2,-17,8,-4,-1,3,2,-3,5,2,0,3,3,0,2,2,0,0,0,1,2,20,-2,-6,8,-1,0,-1,1,-1,1,1,5,-1
KR_6472416237,440,1,49,-1,1,0,2,2,2,2,4,5,0,5,-3,4,1,-3,6,3,0,5,-9,3,-9,6,0,0,0,-1,-1,0,-1,4,-1
KR_6600693297,420,-12,-125,-42,-22,-1,2,1,-1,2,1,-9,12,3,-10,10,0,-1,3,2,-1,-24,-8,-6,-1,7,-1,0,-3,-1,-1,-1,-1,4,-1
KR_6617585445,420,3,76,-23,10,4,0,4,2,3,5,-1,3,2,6,1,7,-1,1,0,0,9,-5,4,-10,6,1,0,1,1,-1,1,1,3,-1
KR_6762149674,420,-3,25,-21,-3,1,1,2,-1,1,0,-1,2,1,0,2,2,-2,2,0,0,-3,-2,1,-4,3,-5,0,-1,1,1,-1,1,6,-1
KR_6657689778,420,2,93,39,4,0,4,4,-3,3,0,4,2,6,2,2,4,1,0,1,1,3,3,5,-9,4,1,0,3,1,1,1,1,2,-1
KR_6750810209,420,-2,-38,-8,-2,0,2,2,-2,4,2,-2,3,1,1,2,3,1,0,1,0,-1,26,-3,-5,8,-13,0,0,-1,1,0,-1,5,-1
KR_6604940349,420,1,-53,22,-2,4,0,4,-2,3,1,2,2,4,-5,6,1,-1,1,0,0,-5,9,4,-7,3,-2,0,0,-1,1,1,1,3,-1
KR_6756558163,420,1,-14,-32,9,-2,2,0,1,0,1,3,1,4,9,0,9,-2,3,1,1,7,-4,5,-8,3,1,0,0,-1,-1,-1,1,4,-1
KR_6602128285,420,-1,2,32,-2,-1,1,0,2,2,4,-1,2,1,-1,2,1,-1,1,0,0,-8,14,-1,-6,7,0,0,0,-1,1,-1,-1,5,-1
KR_6762566620,420,-1,-31,16,-6,-1,3,2,6,1,7,-1,4,3,-9,10,1,-1,2,1,0,-7,-1,-1,-7,8,-4,0,0,1,-1,0,-1,1,-1
KR_6724741164,420,-5,46,-24,-7,-3,3,0,-3,5,2,3,0,3,-1,3,2,-3,4,1,0,-8,-215,4,-7,3,-25,0,0,-1,1,-1,-1,4,-1
KR_6751325947,440,-3,-77,-21,-7,-4,5,1,0,1,1,0,0,0,1,1,2,-4,4,0,0,-4,11,1,-7,6,0,0,-2,-1,-1,-1,1,1,-1
KR_6624050339,440,-1,41,-5,-3,-3,3,0,2,1,3,-6,6,0,3,0,3,1,0,1,0,-3,6,6,-6,0,-1,0,0,1,-1,-1,1,3,-1
KR_6666811504,420,-10,-107,-69,-28,-6,7,1,-10,12,2,-3,4,1,-10,10,0,1,2,3,-1,-18,299,-3,0,3,-6,0,-2,-1,-1,-1,-1,5,-1
KR_6753023371,420,0,18,15,1,3,0,3,1,1,2,-2,2,0,0,0,0,-1,1,0,0,-1,2,1,-5,4,-2,0,0,1,1,1,1,2,-1
KR_6596333235,420,0,14,-4,3,0,0,0,-2,3,1,1,1,2,6,1,7,-2,3,1,0,0,-7,2,-6,4,-1,0,0,1,-1,0,1,3,-1
KR_6762930980,420,-2,-41,-2,-10,0,3,3,-1,3,2,-2,3,1,-5,7,2,-2,2,0,-1,-10,0,5,-10,5,-2,0,-1,-1,1,-1,-1,2,-1
KR_6760960060,420,-3,4,32,-5,-1,2,1,1,4,5,-5,5,0,1,3,4,-1,1,0,1,2,14,1,-3,2,1,0,-1,1,-1,-1,1,1,-1
KR_6754247256,420,-1,-2,11,2,6,0,6,-2,4,2,-1,2,1,-1,2,1,0,0,0,0,-9,-4,-2,-1,3,2,0,1,1,1,1,1,4,-1
KR_6695021396,420,3,-30,-19,5,2,4,6,-1,2,1,3,2,5,1,4,5,0,1,1,-2,-8,1,1,-5,4,2,0,0,-1,1,0,-1,2,-1
KR_6735416471,420,-4,-73,-9,-12,-4,6,2,-10,12,2,2,3,5,1,3,4,-1,2,1,0,-12,-15,-4,-5,9,0,0,-1,-1,-1,-1,-1,1,-1
KR_6752445810,420,-4,-128,-17,-5,-2,3,1,-1,2,1,-1,2,1,-3,4,1,2,2,4,0,0,-1,-1,-5,6,-5,0,-2,-1,-1,-1,-1,4,-1
KR_6740378885,420,-6,-34,-22,-11,-1,2,1,0,4,4,-7,8,1,-1,4,3,-2,3,1,0,-10,-16,-6,-4,10,-2,0,-2,-1,1,-1,-1,3,-1
KR_6696448091,420,-2,-93,-19,1,-2,4,2,5,0,5,-3,6,3,1,2,3,0,1,1,0,12,15,5,-8,3,-3,0,-1,1,-1,-1,1,4,-1
KR_6735729055,440,-9,-129,-52,-18,-2,3,1,-1,4,3,-5,5,0,-10,10,0,0,1,1,0,-16,14,-2,-3,5,-6,0,-4,-1,-1,-1,-1,3,-1
KR_6651858168,420,-2,65,-48,-3,1,1,2,-4,8,4,5,0,5,-6,8,2,1,0,1,0,-1,-84,4,-9,5,0,0,1,-1,-1,1,1,1,-1
KR_6729957095,420,-6,-66,-42,-8,-2,4,2,-4,5,1,1,4,5,-2,4,2,-1,2,1,0,-13,-3,3,-5,2,-1,0,-1,-1,-1,-1,-1,5,-1
KR_6760348434,420,-1,-6,3,-4,-4,7,3,-1,5,4,-2,4,2,1,2,3,2,1,3,0,-7,4,3,-3,0,-1,0,-1,1,-1,-1,1,1,-1
KR_6764734373,420,1,44,9,2,-2,2,0,1,1,2,0,1,1,4,2,6,-1,2,1,0,3,-24,-2,-3,5,7,0,0,1,-1,0,1,6,-1
KR_6749961612,420,0,77,29,-9,-3,5,2,2,1,3,0,2,2,-4,4,0,-4,4,0,0,-18,15,2,-7,5,-6,0,-2,-1,-1,-1,1,3,-1
KR_6758451049,420,0,-9,-11,-6,0,0,0,-4,4,0,-3,6,3,2,0,2,-1,1,0,0,-8,-20,0,-3,3,-4,0,-1,0,-1,-1,-1,0,-1
KR_6758777765,420,1,33,-4,3,1,0,1,1,2,3,-1,2,1,0,4,4,2,0,2,0,3,-2,2,-9,7,7,0,0,-1,0,0,-1,1,-1
KR_6739450482,420,-2,-51,-20,-8,0,2,2,-5,6,1,-1,3,2,0,1,1,-2,2,0,0,-3,-2,-2,-5,7,4,0,0,-1,-1,0,-1,6,-1
KR_6643879922,420,-2,-92,-26,-3,-1,1,0,-2,2,0,-2,4,2,3,3,6,-1,1,0,0,-2,225,-1,-6,7,-3,0,0,-1,-1,-1,1,6,-1
KR_6694001014,420,-1,16,-9,1,1,1,2,-2,2,0,0,2,2,3,1,4,-1,2,1,1,4,13,3,-5,2,-9,0,2,0,0,1,1,0,-1
KR_6758864995,420,-1,5,-29,-7,6,0,6,-9,11,2,-2,2,0,-1,3,2,-1,2,1,-1,-12,-30,-5,-1,6,0,0,0,-1,1,0,-1,2,-1
KR_6634624250,420,-3,-32,6,-1,-2,4,2,-3,4,1,5,0,5,-2,4,2,1,0,1,0,-5,-2,2,-6,4,0,0,-1,1,-1,-1,-1,1,-1
KR_6762802083,420,-5,-62,6,-12,2,0,2,-1,1,0,-5,6,1,-5,8,3,-3,4,1,-2,-22,-6,4,-8,4,-1,0,0,-1,1,-1,-1,2,-1
KR_6755756876,440,2,37,-16,0,4,1,5,0,3,3,1,2,3,-3,5,2,-2,3,1,0,-6,-46,-5,-3,8,14,0,-1,1,1,-1,-1,3,-1
KR_6731026419,420,-2,-31,-24,-2,2,1,3,1,1,2,-2,3,1,-4,4,0,1,1,2,0,0,-13,-2,-6,8,3,0,0,1,0,0,-1,3,-1
KR_6316399394,420,-4,-69,-14,-5,-1,1,0,3,0,3,-3,6,3,-5,6,1,1,0,1,0,0,-6,-1,-3,4,-1,0,-2,-1,1,-1,1,5,-1
KR_6758322003,420,-4,-68,-3,-9,0,1,1,-4,7,3,-4,4,0,-2,2,0,1,0,1,0,-8,341,-1,-5,6,-43,0,0,-1,-1,-1,-1,4,-1
KR_6759701452,420,-3,13,7,-2,1,1,2,2,4,6,0,2,2,-4,5,1,-1,1,0,0,-7,-4,-3,-5,8,-1,0,-1,1,1,-1,-1,1,-1
KR_6760982356,420,-7,-74,-24,-11,-1,1,0,-1,3,2,-1,3,2,-5,5,0,-3,3,0,0,-10,-22,0,-3,3,-1,0,-2,1,-1,-1,1,5,-1
KR_6688340972,420,-1,7,3,-1,4,0,4,5,1,6,-2,3,1,-7,7,0,-1,1,0,0,-14,-40,2,-11,9,10,0,0,-1,1,-1,1,1,-1
KR_6754326648,440,0,-19,-8,-1,1,3,4,-2,3,1,1,3,4,-1,4,3,0,2,2,0,2,242,0,-5,5,-2,0,0,0,-1,-1,-1,0,-1
KR_6623962388,420,-2,-2,-4,-1,-1,3,2,1,5,6,1,0,1,-3,6,3,1,0,1,0,1,13,0,-9,9,-5,0,-2,1,1,-1,1,5,-1
KR_6761242508,420,-1,-87,-32,-4,1,0,1,-1,4,3,-4,4,0,0,7,7,0,0,0,0,2,-8,-2,-4,6,1,0,-2,-1,-1,-1,-1,4,-1
KR_6726946873,420,-5,-12,13,-16,-4,5,1,-1,3,2,-10,10,0,-1,1,0,0,0,0,0,-17,0,-1,-2,3,-1,0,0,-1,1,-1,-1,4,-1
KR_6637991952,420,-7,-96,-17,-15,-2,3,1,-3,3,0,-4,4,0,-4,5,1,-2,2,0,0,-14,-5,-5,0,5,0,0,-3,-1,-1,-1,-1,4,-1
KR_6762626076,440,0,5,-3,2,1,0,1,4,1,5,2,2,4,-3,7,4,-2,2,0,0,-9,-5,-1,-5,6,4,0,0,-1,1,0,-1,1,-1
KR_6663874556,420,-3,-22,-20,-2,-2,3,1,1,2,3,2,0,2,-1,3,2,-2,2,0,0,1,-5,3,-5,2,-3,0,0,1,-1,1,1,1,-1
KR_6753353782,440,0,2,-20,6,1,1,2,5,0,5,0,5,5,1,2,3,-1,2,1,0,5,-4,2,-2,0,2,0,0,1,1,0,1,6,-1
KR_6756995340,420,-1,-46,10,-8,-3,4,1,-3,4,1,4,1,5,-6,7,1,0,0,0,-1,-10,2,-3,-4,7,0,0,-2,-1,-1,-1,-1,2,-1
KR_6762939272,440,3,32,0,0,-2,3,1,0,1,1,0,4,4,1,1,2,1,0,1,1,2,0,-4,-2,6,-4,0,1,1,1,1,1,3,-1
KR_6761792456,420,0,24,-16,-8,0,1,1,-7,8,1,-1,1,0,1,1,2,-1,2,1,0,-9,13,-6,-3,9,1,0,0,-1,-1,0,-1,1,-1
KR_6637660408,420,-4,-78,12,-10,-2,2,0,0,2,2,3,1,4,-8,9,1,-3,3,0,-1,-14,-2,0,-6,6,0,0,-2,-1,1,-1,-1,6,-1
KR_6758580772,420,-3,-13,-11,-14,-4,5,1,-7,10,3,-4,4,0,-2,3,1,3,1,4,0,-7,15,0,-3,3,0,0,0,1,0,0,-1,2,-1
KR_6750474156,420,-4,13,12,-9,-1,1,0,-2,6,4,-3,5,2,-2,4,2,-1,3,2,0,-7,1,-2,-4,6,1,0,-1,-1,-1,-1,-1,4,-1
KR_6560428914,420,-9,-101,-3,-22,-8,8,0,-1,2,1,-5,8,3,-5,5,0,-3,3,0,-2,-9,-14,-6,-5,11,-5,0,-3,-1,-1,-1,-1,2,-1
KR_6753679437,420,-8,-87,-60,-7,0,2,2,2,1,3,-2,2,0,-7,7,0,0,0,0,0,-8,48,5,-7,2,-24,0,-1,-1,1,-1,-1,3,-1
KR_6683864279,420,-1,-48,15,-3,2,1,3,-4,6,2,0,1,1,-1,1,0,0,0,0,0,-4,-5,-3,-3,6,1,0,-1,-1,-1,-1,-1,5,-1
KR_6749896782,420,-1,-61,-22,1,-1,2,1,2,1,3,0,3,3,1,5,6,-1,1,0,0,4,-13,-5,-4,9,3,0,0,1,-1,-1,1,5,-1
KR_6760739152,420,-2,69,-4,-6,-4,4,0,-9,9,0,1,0,1,5,1,6,1,1,2,1,-5,-27,-7,-4,11,4,0,-1,-1,-1,-1,1,6,-1
KR_6652503937,420,-8,-59,-30,-17,-4,4,0,-3,6,3,-3,3,0,-4,4,0,-3,3,0,-1,-26,187,1,-8,7,-4,0,-3,-1,-1,-1,-1,3,-1
KR_6741977683,420,-4,25,13,-10,-2,3,1,0,3,3,4,0,4,-11,11,0,-1,2,1,-2,-30,1,0,-5,5,-1,0,-2,-1,-1,-1,-1,3,-1
KR_6491549820,420,2,-1,-20,-1,2,4,6,4,2,6,-2,5,3,-5,7,2,0,2,2,0,1,-4,2,-6,4,-2,0,1,-1,1,1,1,1,-1
KR_6739537211,420,3,46,1,2,0,2,2,1,2,3,-4,5,1,0,1,1,5,1,6,0,3,6,2,-6,4,-3,0,0,1,-1,-1,-1,2,-1
KR_6730334769,420,-4,-65,-12,0,3,0,3,2,2,4,-3,5,2,0,0,0,-2,3,1,0,-1,-7,1,-5,4,-1,0,0,1,1,0,-1,5,-1
KR_6762948206,420,-1,-39,-34,3,-2,3,1,1,2,3,0,4,4,0,2,2,4,0,4,0,15,59,3,-9,6,-15,0,-1,1,-1,-1,-1,4,-1
KR_6723150389,420,-3,-7,9,-4,-2,2,0,-1,5,4,3,1,4,-2,4,2,-2,3,1,0,-1,-6,4,-6,2,3,0,0,-1,1,-1,-1,4,-1
KR_6735321807,420,-1,-16,0,-4,1,1,2,0,3,3,-4,6,2,1,5,6,-2,3,1,0,-9,48,-5,-2,7,4,0,1,1,-1,1,-1,5,-1
KR_6702414086,420,0,-66,0,3,0,2,2,-1,2,1,6,1,7,0,2,2,-2,3,1,0,9,22,3,-6,3,-1,0,1,1,1,-1,1,3,-1
KR_6760930116,420,-3,-41,-16,-3,2,1,3,-4,7,3,-1,1,0,0,5,5,0,0,0,0,-4,-25,1,-5,4,-4,0,2,1,1,1,-1,1,-1
KR_6712847056,420,-2,-59,-5,-1,-1,2,1,1,1,2,-1,2,1,0,1,1,0,1,1,0,3,3,-6,-4,10,-4,0,0,-1,-1,-1,1,1,-1
KR_6744857430,420,2,38,9,-1,-1,2,1,0,4,4,-1,1,0,2,2,4,-1,2,1,-1,-2,-80,1,-5,4,5,0,-1,1,-1,-1,-1,4,-1
KR_6764235230,420,-6,-42,-43,-15,-3,4,1,-5,5,0,-9,10,1,2,4,6,0,2,2,1,-1,-178,-4,-2,6,-5,0,-2,-1,-1,-1,1,2,-1
KR_6742152737,420,-1,-32,-12,0,0,2,2,-2,2,0,2,0,2,0,1,1,0,1,1,-1,-7,-42,2,-4,2,23,0,-1,1,-1,-1,-1,5,-1
KR_6755861067,420,-1,76,-24,-8,-4,4,0,-4,6,2,-5,8,3,5,0,5,0,2,2,-1,-16,-5,1,-10,9,2,0,-1,1,-1,-1,-1,1,-1
KR_6682844554,420,-1,-13,-11,0,1,2,3,-2,2,0,2,0,2,0,0,0,-1,1,0,0,-3,-64,-3,-8,11,7,0,0,-1,1,0,1,4,-1
KR_6728826991,420,3,56,5,11,-4,5,1,5,2,7,1,2,3,6,0,6,3,1,4,0,19,17,3,-4,1,1,0,1,1,1,1,-1,1,-1
KR_6763655098,420,-1,36,1,-3,0,2,2,1,5,6,0,4,4,-2,3,1,-2,2,0,1,0,1,1,-7,6,-3,0,0,1,1,0,1,4,-1
KR_6745044139,420,-4,-4,-12,-6,-4,4,0,-1,2,1,-2,2,0,0,2,2,1,0,1,-1,-1,-3,-4,-4,8,0,0,1,-1,-1,-1,-1,2,-1
KR_6538870189,420,-3,-58,6,-10,-5,7,2,-2,4,2,-1,3,2,-1,3,2,-1,1,0,0,-3,30,-3,-4,7,0,0,-1,-1,1,-1,-1,1,-1
KR_6701567461,420,-1,-16,-16,-5,-1,3,2,0,3,3,-2,3,1,-3,4,1,1,0,1,0,4,41,4,-7,3,-2,0,1,-1,1,1,1,5,-1
KR_6734623002,420,-1,14,-20,-3,-2,2,0,-2,5,3,6,1,7,-5,5,0,0,1,1,0,-12,-7,-7,-3,10,2,0,0,-1,-1,0,1,1,-1
KR_6760460570,420,0,15,14,0,4,2,6,-1,2,1,1,2,3,-3,3,0,-1,1,0,0,-4,-17,-2,-3,5,0,0,1,-1,1,1,1,4,-1
KR_6717472538,420,-6,-38,7,-15,-4,4,0,-6,7,1,4,0,4,-8,9,1,-1,1,0,0,-20,-2,1,-4,3,0,0,-2,0,1,-1,1,0,-1
KR_6741301032,420,0,25,-40,8,3,1,4,1,1,2,1,1,2,-1,5,4,4,0,4,0,9,5,2,-7,5,4,0,1,1,-1,1,1,3,-1
KR_6676300685,420,1,10,2,2,0,0,0,-3,4,1,0,1,1,5,0,5,0,1,1,0,-1,-97,2,-9,7,-2,0,0,1,1,0,-1,4,-1
KR_6705980216,420,-1,-75,-26,0,2,0,2,1,4,5,0,0,0,-3,5,2,0,0,0,0,-1,-9,0,-5,5,-2,0,-2,-1,-1,-1,-1,3,-1
KR_6680482413,420,-4,-14,-20,-9,-3,5,2,-6,8,2,-1,1,0,1,1,2,0,1,1,0,-6,32,-4,-3,7,-11,0,0,0,-1,-1,-1,0,-1
KR_6659952703,420,0,-17,28,-2,3,0,3,-6,8,2,2,2,4,0,0,0,-1,1,0,0,-4,-6,-4,-4,8,1,0,1,1,1,1,-1,5,-1
KR_6755719955,440,-8,-106,-24,-18,-8,8,0,0,1,1,-7,7,0,-3,4,1,0,2,2,-2,-23,56,-5,-2,7,0,0,-2,-1,0,-1,-1,4,-1
KR_6751248099,440,-5,-94,-4,-20,-8,8,0,-3,5,2,0,5,5,-6,9,3,-3,3,0,0,-15,-219,-4,0,4,1,0,-1,0,-1,-1,-1,0,-1
KR_6753946775,420,-3,3,12,-2,3,0,3,-1,6,5,0,2,2,-4,4,0,0,0,0,0,-8,-3,0,-5,5,1,0,0,-1,1,1,1,5,-1
KR_6759732283,420,0,16,-5,-1,0,2,2,3,1,4,-2,4,2,-2,4,2,0,0,0,0,-3,-39,2,-6,4,24,0,1,1,-1,1,-1,5,-1
KR_6764205647,420,-1,-21,5,0,1,2,3,-2,2,0,-2,2,0,2,0,2,1,0,1,0,-2,2,2,-8,6,-1,0,0,1,-1,0,-1,4,-1
KR_6708341618,420,0,-1,3,-1,0,0,0,4,2,6,-3,5,2,-2,4,2,0,1,1,0,0,-37,2,-7,5,-2,0,0,0,-1,0,-1,0,-1
KR_6757089934,420,-1,0,4,-13,-1,4,3,-1,8,7,-5,6,1,-6,8,2,0,1,1,-1,-11,-170,4,-7,3,-5,0,0,-1,1,-1,-1,6,-1
KR_6740493666,420,-1,10,-16,-2,-4,4,0,3,3,6,0,1,1,-1,4,3,0,1,1,0,5,-5,0,-7,7,2,0,-1,-1,-1,-1,1,3,-1
KR_6759313995,420,-3,2,5,-5,-2,2,0,-1,3,2,-4,6,2,3,1,4,-1,2,1,0,-4,-7,-2,-4,6,1,0,-1,-1,1,-1,1,2,-1
KR_6763979072,420,1,5,-8,-3,-5,5,0,1,3,4,-1,2,1,2,2,4,0,1,1,0,1,-2,-1,-5,6,0,0,1,1,1,1,1,2,-1
KR_6751486367,420,0,-22,7,5,2,2,4,2,0,2,0,5,5,1,2,3,0,0,0,0,5,-3,2,-9,7,5,0,0,1,-1,0,-1,6,-1
KR_6472655866,440,-4,-44,-35,-14,-3,4,1,-8,9,1,-2,3,1,1,0,1,-2,4,2,0,-22,55,3,-10,7,-2,0,-1,-1,1,-1,1,2,-1
KR_6755354801,420,-4,-114,-8,-10,0,2,2,4,3,7,-2,4,2,-9,11,2,-3,5,2,0,-9,14,6,-10,4,-6,0,-1,-1,-1,1,-1,2,-1
KR_6732741187,440,1,-2,16,-3,-2,5,3,-1,2,1,-3,3,0,4,1,5,-1,6,5,0,4,9,4,-6,2,-3,0,2,1,0,1,-1,4,-1
KR_6762253788,420,1,-6,16,0,-1,1,0,-2,4,2,-1,1,0,-3,3,0,7,0,7,1,5,-6,-2,-5,7,3,0,0,-1,1,0,1,6,-1
KR_6730968666,420,0,-6,22,-2,0,4,4,-1,6,5,-1,3,2,-2,3,1,2,1,3,0,4,-28,-6,-2,8,-1,0,-2,-1,-1,-1,1,4,-1
KR_6581249260,420,4,46,15,8,6,1,7,2,3,5,0,2,2,1,2,3,-1,4,3,1,10,4,-3,-2,5,1,0,0,0,-1,0,1,0,-1
KR_6602836026,420,-7,-31,-43,-12,0,1,1,-4,6,2,1,2,3,-3,4,1,-6,6,0,-1,-16,22,9,-12,3,-6,0,0,1,-1,-1,-1,4,-1
KR_6643970458,420,-1,12,4,1,-1,2,1,6,1,7,-2,3,1,-2,4,2,0,0,0,-1,5,-9,-2,-3,5,-1,0,0,1,1,1,-1,6,-1
KR_6732221161,420,0,-24,16,-3,2,3,5,-7,9,2,1,2,3,0,3,3,1,0,1,0,-11,0,-2,-4,6,2,0,0,-1,-1,0,1,3,-1
KR_6744047931,420,-3,-71,-27,-6,-4,4,0,-2,4,2,0,1,1,0,1,1,0,0,0,0,-3,-13,-1,-5,6,-1,0,-1,-1,1,-1,-1,1,-1
KR_6609649756,420,-3,6,8,-4,-2,3,1,-1,3,2,3,1,4,-3,6,3,-1,1,0,0,-7,2,-1,-7,8,-3,0,0,-1,-1,-1,-1,6,-1
KR_6463365380,420,0,-2,27,-1,0,2,2,-1,4,3,-4,5,1,2,4,6,2,0,2,0,-1,29,6,-7,1,-3,0,-1,1,1,-1,-1,4,-1
KR_6762264098,420,-3,-27,6,-10,2,3,5,-5,5,0,-2,2,0,-4,6,2,-1,1,0,-1,-13,20,-1,-4,5,-2,0,-2,0,-1,-1,-1,0,-1
KR_6743761250,440,-4,-99,16,-8,0,2,2,0,2,2,-3,4,1,-3,5,2,-2,2,0,0,-12,-3,1,-6,5,-1,0,-1,1,-1,-1,-1,4,-1
KR_6762750263,420,2,1,28,-2,0,1,1,1,1,2,-2,4,2,-2,6,4,1,1,2,1,-4,-13,2,-6,4,3,0,0,0,0,0,1,0,-1
KR_6761076498,420,-3,-113,5,1,0,2,2,-3,6,3,4,5,9,-2,3,1,2,0,2,0,-4,3,2,-6,4,-4,0,-1,1,-1,-1,-1,5,-1
KR_6756411857,420,1,26,13,0,-1,2,1,-2,4,2,5,2,7,0,2,2,-2,2,0,0,2,36,-7,-1,8,-18,0,-1,-1,1,-1,1,3,-1
KR_6701723341,420,0,10,-12,-6,-2,3,1,-8,11,3,2,1,3,2,2,4,0,0,0,0,-6,3,-1,-7,8,3,0,0,-1,-1,1,-1,2,-1
KR_6760353275,420,3,70,-4,-1,0,1,1,0,4,4,5,1,6,-5,8,3,-1,1,0,-1,-9,-47,-2,-4,6,25,0,1,1,1,1,-1,4,-1
KR_6739163953,420,-2,-39,-26,-8,-5,5,0,-1,4,3,-6,6,0,2,1,3,2,0,2,0,-1,-10,-3,-1,4,1,0,-2,-1,-1,-1,-1,3,-1
KR_6743626858,420,1,8,-12,0,-1,4,3,-3,4,1,-2,2,0,3,1,4,3,0,3,0,2,-1,-1,-5,6,-2,0,1,1,-1,1,1,5,-1
KR_6756477853,440,-5,55,-20,-8,-4,4,0,-5,8,3,-4,4,0,5,1,6,0,0,0,1,-13,7,5,-8,3,-7,0,1,-1,1,1,1,1,-1
KR_6681688563,420,0,-28,-12,-4,7,1,8,0,2,2,-3,3,0,-8,10,2,0,1,1,1,-2,0,5,-8,3,-7,0,-1,-1,0,-1,-1,2,-1
KR_6748231394,420,0,-56,-5,-2,3,3,6,1,3,4,1,2,3,-3,3,0,-4,5,1,0,-6,-2,0,-9,9,-1,0,1,-1,1,1,-1,5,-1
KR_6761249925,420,-4,-20,-16,-2,-2,3,1,-3,3,0,-5,6,1,7,0,7,1,0,1,0,3,0,-3,-4,7,7,0,0,1,1,-1,1,3,-1
KR_6759884842,420,0,94,20,-3,-1,2,1,-2,3,1,0,2,2,1,5,6,-1,3,2,0,-4,8,3,-5,2,-3,0,-2,1,-1,-1,-1,4,-1
KR_6761433119,440,-1,-18,12,-6,-2,2,0,-5,5,0,3,2,5,-6,8,2,4,0,4,-3,-15,-13,-1,-4,5,3,0,0,1,1,-1,-1,5,-1
KR_6755653682,420,-1,-33,-10,-9,-4,4,0,-2,3,1,0,1,1,-1,2,1,-2,3,1,0,-7,-2,1,-4,3,5,0,0,-1,1,1,-1,5,-1
KR_6680527968,420,-6,-39,-46,-13,-15,15,0,2,0,2,-2,2,0,4,3,7,-2,3,1,0,2,-4,-1,-7,8,-7,0,-2,1,-1,-1,-1,1,-1
KR_6546016893,420,2,62,-12,-1,2,2,4,-3,3,0,-2,4,2,0,0,0,2,0,2,0,3,1,3,-7,4,-4,0,1,1,1,1,-1,4,-1
KR_6685113165,420,0,22,13,1,1,1,2,-3,3,0,1,6,7,0,2,2,2,1,3,0,2,4,4,-9,5,-2,0,1,0,1,1,-1,0,-1
KR_6482633636,420,-2,-100,-12,-2,-1,2,1,4,2,6,-2,2,0,0,4,4,-3,3,0,1,2,-1,5,-6,1,-5,0,-1,-1,-1,-1,1,4,-1
KR_6637718653,420,-1,-19,26,-4,0,1,1,-2,4,2,-1,3,2,-3,5,2,2,1,3,0,-9,-13,-3,-5,8,5,0,-1,-1,1,-1,1,4,-1
KR_6746964574,420,2,15,-5,3,-3,5,2,2,2,4,-1,1,0,1,0,1,4,1,5,0,5,-58,3,-5,2,-3,0,1,1,1,1,1,4,-1
KR_6751133457,440,1,4,16,-8,0,3,3,-2,4,2,-5,7,2,-1,4,3,0,1,1,-3,-13,-4,0,-3,3,4,0,-1,0,-1,-1,-1,0,-1
KR_6663303506,420,-8,-64,-16,-20,-6,7,1,-6,6,0,-3,4,1,-5,5,0,0,0,0,-1,-31,-2,-7,-1,8,-3,0,-1,-1,-1,-1,-1,4,-1
KR_6685994497,420,-1,1,37,-6,2,2,4,-3,4,1,2,0,2,-6,7,1,-1,1,0,0,-4,-40,-1,-3,4,5,0,-1,-1,-1,-1,1,1,-1
KR_6580648431,420,0,-4,-21,-1,1,1,2,-1,3,2,4,0,4,-3,5,2,-2,4,2,0,-9,22,4,-9,5,5,0,1,-1,1,1,-1,1,-1
KR_6667876082,420,-6,-100,-11,-13,-2,5,3,-3,3,0,-5,5,0,1,2,3,-4,4,0,-4,-15,-4,-3,-4,7,-5,0,-3,-1,-1,-1,-1,2,-1
KR_6590527193,420,-3,-11,-17,-3,-4,4,0,-4,6,2,1,0,1,1,2,3,3,1,4,1,4,-4,4,-8,4,3,0,-1,-1,1,-1,1,3,-1
KR_6722588671,440,-5,-105,-4,-4,-5,5,0,-2,2,0,1,1,2,1,0,1,1,0,1,0,2,-10,-1,-3,4,-3,0,0,1,0,-1,-1,3,-1
KR_6749638370,420,-1,4,-16,-8,1,3,4,-3,3,0,-2,3,1,-5,5,0,1,0,1,0,-12,-4,-1,-5,6,-5,0,-1,-1,0,-1,-1,5,-1
KR_6756959462,420,-1,52,18,1,-4,4,0,8,2,10,1,1,2,-2,4,2,-2,2,0,0,1,-3,4,-9,5,-2,0,0,1,1,1,1,2,-1
KR_6664368605,420,-2,10,-24,-3,0,0,0,-1,1,0,0,0,0,2,2,4,-4,4,0,0,-7,-50,-6,-1,7,32,0,-2,-1,-1,-1,-1,4,-1
KR_6604294361,420,-2,-13,10,-17,-5,5,0,-4,4,0,0,1,1,-5,6,1,-3,4,1,-1,-22,-7,-3,-2,5,3,0,-1,-1,-1,-1,-1,5,-1
KR_6759127470,420,-1,-7,-39,-4,-4,4,0,-7,8,1,4,1,5,5,1,6,-2,3,1,0,2,-279,1,-4,3,2,0,0,1,-1,0,-1,2,-1
KR_6730615129,420,3,26,0,7,5,0,5,-2,5,3,0,2,2,3,0,3,1,0,1,0,1,2,6,-7,1,-1,0,0,-1,-1,1,1,6,-1
KR_6763497277,420,-2,-41,-40,-4,1,0,1,0,2,2,-2,4,2,-2,2,0,-1,1,0,0,-11,5,-3,-3,6,2,0,0,0,-1,-1,-1,0,-1
KR_6646251177,420,-6,-61,-35,-20,1,3,4,-4,7,3,-6,7,1,-11,13,2,0,1,1,0,-15,-44,-3,-2,5,0,0,-2,-1,1,-1,-1,2,-1
KR_6718490123,420,1,-42,4,2,1,1,2,7,0,7,-3,3,0,-3,3,0,0,0,0,0,2,0,-3,-5,8,-2,0,-2,-1,-1,-1,1,4,-1
KR_6763799210,420,2,-35,-25,9,-1,3,2,5,3,8,2,2,4,3,1,4,0,0,0,0,6,3,3,-6,3,-3,0,1,-1,1,-1,-1,2,-1
KR_6751225936,440,-5,-65,-36,-3,-4,4,0,4,3,7,-1,2,1,-2,4,2,0,0,0,0,6,33,3,-6,3,-17,0,0,-1,1,0,-1,1,-1
KR_6755188608,420,-3,-96,-8,-7,-2,2,0,1,1,2,0,1,1,-2,3,1,-4,7,3,0,-2,2,0,-6,6,1,0,-2,1,-1,-1,-1,3,-1
KR_6748424173,420,-1,5,13,0,-3,4,1,2,0,2,2,3,5,-1,1,0,0,0,0,0,1,13,2,-6,4,-4,0,0,1,0,-1,1,5,-1
KR_6734733237,420,-5,-97,-42,-4,-2,2,0,-9,10,1,1,1,2,4,0,4,2,0,2,0,6,-3,0,-8,8,-1,0,-3,-1,-1,-1,-1,5,-1
KR_6755039558,420,0,-69,11,0,1,1,2,-1,2,1,0,1,1,0,1,1,0,1,1,0,-3,-6,-3,-3,6,2,0,0,0,1,0,1,0,-1
KR_6760904883,420,0,-66,0,2,-2,2,0,2,2,4,1,3,4,1,0,1,0,0,0,0,4,-53,-3,-1,4,28,0,-1,1,-1,-1,1,1,-1
KR_6677155800,420,-2,-75,9,-12,-8,10,2,-3,4,1,-4,4,0,4,1,5,-1,3,2,0,-3,-2,-4,-2,6,2,0,0,-1,0,-1,1,5,-1
KR_6714056445,420,-1,3,5,-4,-2,5,3,2,4,6,3,2,5,-8,8,0,1,0,1,-1,-3,27,1,-4,3,-2,0,1,1,-1,1,-1,6,-1
KR_6702469461,420,-1,8,-3,-6,-2,3,1,-1,1,0,-4,5,1,0,1,1,1,3,4,0,-1,-1,-1,-4,5,-6,0,-1,-1,-1,-1,-1,4,-1
KR_6751321074,440,-1,-34,24,0,-1,3,2,1,1,2,-4,6,2,8,1,9,-4,4,0,0,6,-176,-1,-4,5,-2,0,-2,0,1,-1,-1,0,-1
KR_6758313801,440,-3,12,-32,-11,-1,2,1,-1,3,2,-8,10,2,-1,5,4,0,4,4,-1,-9,20,-5,-3,8,3,0,-2,-1,1,1,-1,1,-1
KR_6759215578,420,-3,-73,-34,-4,-1,2,1,0,2,2,8,2,10,-8,10,2,-3,3,0,-1,-6,-10,0,-6,6,2,0,0,-1,-1,0,-1,6,-1
KR_6756839376,420,-2,47,-21,-6,-1,2,1,-2,4,2,-2,4,2,-2,5,3,1,2,3,-1,-13,6,1,-6,5,-1,0,0,1,-1,-1,-1,3,-1
KR_6604639419,420,-3,-12,-16,-8,-5,5,0,0,1,1,-1,3,2,2,1,3,-4,6,2,0,-13,5,0,-9,9,2,0,-2,-1,1,-1,1,3,-1
KR_6732739640,440,3,33,13,12,1,1,2,0,0,0,-1,2,1,1,0,1,11,0,11,2,18,-5,-2,-4,6,1,0,1,1,-1,1,1,3,-1
KR_6760783759,420,-2,-28,-20,0,-2,3,1,1,1,2,-1,1,0,-1,2,1,3,1,4,0,1,-118,-8,-1,9,1,0,-1,-1,-1,-1,1,2,-1
KR_6583224822,420,-2,-24,5,-4,-4,4,0,-1,4,3,1,1,2,0,2,2,0,0,0,0,-1,-12,1,-7,6,2,0,0,1,-1,0,-1,4,-1
KR_6763938384,420,-3,-3,-36,5,-1,1,0,3,0,3,2,0,2,1,4,5,0,3,3,2,11,4,1,-4,3,2,0,0,1,1,0,1,2,-1
KR_6730937914,420,-6,-14,-28,-11,2,1,3,-1,2,1,-4,7,3,-1,2,1,-7,8,1,2,-8,-13,2,-6,4,-3,0,-2,-1,1,-1,1,3,-1
KR_6717744914,420,0,-43,-7,-1,1,3,4,-4,4,0,1,1,2,-1,5,4,2,0,2,0,-3,5,-2,-4,6,1,0,0,-1,-1,0,-1,6,-1
KR_6751778176,420,-7,-91,-4,-18,-7,8,1,0,1,1,-3,6,3,-4,7,3,-4,5,1,0,-10,1,-1,-4,5,-4,0,-1,-1,1,-1,1,4,-1
KR_6663865007,420,1,9,5,-2,8,2,10,-5,7,2,0,3,3,-3,4,1,-2,3,1,-1,-10,25,-7,-3,10,-3,0,1,-1,1,1,-1,5,-1
KR_6721297925,420,0,7,-24,-1,3,0,3,0,2,2,2,0,2,-5,6,1,-1,2,1,0,-1,-57,3,-7,4,-1,0,0,-1,-1,0,1,3,-1
KR_6751529892,420,-1,-30,26,0,-1,4,3,0,2,2,1,3,4,-1,6,5,1,1,2,0,-2,-20,-1,-5,6,2,0,1,1,1,1,1,1,-1
KR_6762499547,420,-1,-18,9,-9,-4,4,0,4,1,5,-4,4,0,-6,6,0,1,0,1,0,-5,2,1,-5,4,2,0,-1,-1,-1,-1,-1,1,-1
KR_6757002376,420,0,-19,-12,0,0,3,3,0,1,1,1,2,3,-2,3,1,1,0,1,-1,-1,-7,-5,-4,9,4,0,-1,1,-1,-1,-1,4,-1
KR_6742695327,420,-1,9,5,-1,-1,2,1,-1,3,2,-3,3,0,2,3,5,2,0,2,0,-2,145,5,-5,0,-1,0,-1,-1,-1,-1,1,6,-1
KR_6754479998,420,-3,-28,-23,-7,-4,5,1,1,1,2,-2,4,2,-2,2,0,0,1,1,0,-3,-4,-2,-5,7,-1,0,-1,-1,-1,-1,-1,5,-1
KR_6761351374,420,6,87,-4,15,2,1,3,7,1,8,2,0,2,4,2,6,0,0,0,0,18,-3,-2,-4,6,4,0,2,-1,-1,1,1,3,-1
KR_6631932227,420,-6,32,-63,-17,-1,1,0,-6,10,4,-4,4,0,-6,10,4,0,0,0,0,-11,42,4,-8,4,-13,0,-3,1,-1,-1,-1,4,-1
KR_6755828694,420,0,33,8,-6,0,2,2,2,0,2,-12,12,0,3,2,5,1,0,1,0,-4,-12,-1,-5,6,3,0,0,1,1,0,1,2,-1
KR_6721105406,420,-2,-56,-16,-5,2,3,5,0,3,3,-3,4,1,-5,5,0,1,0,1,-1,-8,9,0,-5,5,-2,0,-1,-1,1,1,-1,3,-1
KR_6755698949,440,-6,-65,-10,-17,1,0,1,0,0,0,-14,15,1,-4,6,2,0,0,0,0,-13,-5,-2,-2,4,-1,0,-2,1,-1,-1,-1,4,-1
KR_6748265737,420,-4,-30,-39,-12,-3,3,0,-5,5,0,-2,5,3,3,3,6,-5,5,0,0,-9,0,5,-8,3,-5,0,-2,-1,-1,-1,-1,3,-1
KR_6759778318,420,-4,-36,-12,-6,1,2,3,-4,5,1,-2,4,2,-1,4,3,0,1,1,0,2,-13,-3,-1,4,2,0,-2,1,-1,-1,-1,2,-1
KR_6734428829,440,1,-3,-15,-5,0,0,0,-4,4,0,-2,3,1,0,0,0,1,1,2,0,-8,98,1,-6,5,0,0,0,1,-1,0,-1,4,-1
KR_6758420695,420,1,17,20,6,1,0,1,1,4,5,0,0,0,5,1,6,-1,1,0,0,8,37,5,-8,3,3,0,0,1,0,0,-1,5,-1
KR_6741932637,420,0,-13,11,-2,-1,3,2,5,0,5,-4,5,1,-1,4,3,-1,1,0,0,-3,84,-2,-3,5,-22,0,1,0,1,1,-1,0,-1
KR_6747708651,420,-3,-53,5,-3,0,2,2,-4,7,3,-1,4,3,2,1,3,0,1,1,2,3,-4,-3,-6,9,2,0,0,1,-1,-1,1,3,-1
KR_6726874227,420,-9,-91,-29,-15,2,1,3,-8,8,0,-5,6,1,-3,4,1,-1,1,0,-1,-19,-3,1,-5,4,-1,0,-2,-1,1,-1,-1,3,-1
KR_6760667958,420,-5,-47,-11,-6,-3,3,0,-4,4,0,1,3,4,-1,1,0,1,0,1,0,-2,28,-1,-2,3,-28,0,-1,-1,0,-1,-1,4,-1
KR_6685219534,420,-1,-29,-1,-5,0,2,2,0,3,3,-1,3,2,-2,7,5,-2,2,0,-1,-5,-79,-4,-3,7,23,0,-1,-1,1,-1,-1,3,-1
KR_6750677016,420,0,-21,16,-4,2,0,2,-2,5,3,-1,6,5,-2,3,1,-1,1,0,-1,-4,-7,0,-6,6,-3,0,-2,1,1,-1,-1,5,-1
KR_6748380449,420,-3,13,20,-14,-3,4,1,-3,6,3,-4,5,1,-3,4,1,-1,2,1,0,-20,-6,-4,-7,11,1,0,0,-1,-1,0,-1,4,-1
KR_6688655446,420,-3,-13,16,-6,-3,4,1,0,2,2,5,1,6,-5,8,3,-3,3,0,0,-16,31,1,-7,6,-18,0,0,1,-1,1,-1,5,-1
KR_6760725825,420,1,-1,-6,0,2,4,6,0,2,2,2,2,4,-4,5,1,0,0,0,-1,6,-10,0,-8,8,2,0,-1,-1,-1,-1,-1,5,-1
KR_6761122101,420,2,35,12,6,3,1,4,4,1,5,4,1,5,-4,6,2,-1,1,0,0,-1,0,-3,-2,5,-4,0,-1,1,1,-1,1,1,-1
KR_6745059038,440,-6,-87,-4,-11,-7,7,0,-4,4,0,-1,3,2,0,1,1,1,0,1,0,-3,26,-3,-1,4,3,0,0,0,1,-1,-1,0,-1
KR_6763642288,420,-4,-66,-41,-14,-5,7,2,-6,7,1,2,2,4,-6,8,2,1,0,1,0,-12,-2,2,-6,4,-2,0,-2,-1,-1,-1,-1,5,-1
KR_6695228008,420,1,-5,-28,-1,1,2,3,-5,7,2,0,2,2,2,3,5,1,0,1,0,1,2,-1,-4,5,-2,0,0,-1,1,0,-1,2,-1
KR_6761657851,420,-2,-60,6,-10,0,1,1,-4,6,2,3,0,3,-7,8,1,-2,2,0,0,-18,0,-2,-4,6,4,0,1,1,1,1,1,4,-1
KR_6752384295,440,5,101,-8,9,1,2,3,-1,3,2,5,1,6,3,0,3,1,0,1,1,10,-39,-7,-3,10,4,0,1,-1,-1,1,1,1,-1
KR_6706577465,420,-4,-56,5,-6,-2,2,0,-5,5,0,-1,3,2,4,4,8,-2,4,2,0,-10,-10,-2,-4,6,-1,0,-2,-1,-1,-1,-1,6,-1
KR_6752279372,420,1,44,0,-2,1,2,3,-1,3,2,0,3,3,-2,2,0,0,0,0,0,-8,5,2,-7,5,-4,0,0,-1,1,1,-1,3,-1
KR_6763860158,420,-1,-49,7,1,2,1,3,1,1,2,-1,3,2,2,2,4,-3,4,1,0,-3,17,1,-6,5,-1,0,-1,-1,-1,-1,-1,5,-1
KR_6764381068,420,-4,-51,8,-6,-1,2,1,2,3,5,-5,5,0,-2,5,3,0,1,1,0,-2,-9,-2,-2,4,0,0,-1,-1,-1,-1,-1,4,-1
KR_6607867222,420,-3,-59,8,-7,-3,4,1,1,1,2,0,1,1,-2,5,3,-3,3,0,0,-3,0,-3,-6,9,-6,0,-1,1,1,1,1,4,-1
KR_6750082303,420,-2,-22,8,1,1,1,2,2,2,4,-1,3,2,0,2,2,-1,2,1,0,-3,17,0,-3,3,1,0,0,-1,-1,-1,1,1,-1
KR_6760820326,420,1,46,-4,7,1,0,1,0,1,1,1,1,2,2,1,3,3,0,3,0,5,9,1,-4,3,-4,0,0,1,1,0,1,4,-1
KR_6732125066,420,-2,-15,20,-4,1,0,1,2,2,4,1,3,4,-6,9,3,-2,3,1,0,-3,-67,5,-7,2,-3,0,0,1,1,-1,1,2,-1
KR_6602404455,420,-9,-129,-16,-14,-6,6,0,-5,6,1,-3,4,1,-1,4,3,1,0,1,-1,-9,213,3,-5,2,-9,0,-2,-1,-1,-1,-1,5,-1
KR_6700896833,420,-2,-26,-13,-1,-6,6,0,5,1,6,1,3,4,-3,6,3,2,1,3,-2,-2,-88,2,-4,2,4,0,-1,-1,1,-1,-1,6,-1
KR_6712506734,420,-4,-27,-14,-23,-1,3,2,-13,15,2,-1,3,2,-8,9,1,0,1,1,-3,-35,52,1,-7,6,-22,0,-2,-1,-1,-1,-1,4,-1
KR_6757647702,420,0,-41,-24,0,-2,3,1,1,0,1,0,8,8,1,3,4,0,1,1,0,4,1,2,-4,2,-1,0,-3,-1,-1,-1,-1,3,-1
KR_6688532755,420,-1,-49,23,-6,-2,4,2,-1,4,3,-2,6,4,0,2,2,-1,2,1,1,-12,-11,2,-7,5,-2,0,0,-1,-1,0,1,4,-1
KR_6758968579,420,-2,-66,6,-4,1,3,4,2,0,2,-1,1,0,-4,4,0,-2,2,0,0,-8,2,6,-8,2,2,0,0,-1,1,-1,1,1,-1
KR_6764212206,420,-2,-47,-39,-2,2,3,5,-2,2,0,-2,3,1,-2,4,2,2,0,2,0,-4,2,2,-4,2,-3,0,0,-1,-1,-1,-1,1,-1
KR_6725543710,420,-1,-29,27,-2,0,2,2,1,6,7,-2,7,5,-1,4,3,0,1,1,0,7,15,-5,-2,7,5,0,0,-1,-1,0,-1,4,-1
KR_6704373292,440,-2,-34,4,-3,-3,4,1,3,2,5,1,0,1,-3,3,0,-1,1,0,-2,3,-10,-5,-5,10,5,0,-1,-1,1,-1,-1,3,-1
KR_6743755279,420,-5,-29,-13,-8,2,0,2,-4,6,2,0,3,3,-5,7,2,-1,1,0,0,-4,-414,-1,-3,4,-3,0,0,1,-1,0,-1,1,-1
KR_6763693967,420,2,3,-6,3,-3,5,2,3,0,3,0,1,1,0,3,3,3,0,3,0,9,28,-3,-3,6,2,0,-1,1,-1,-1,-1,1,-1
KR_6765144679,420,-3,-21,-20,-5,-1,1,0,-2,5,3,-1,2,1,-2,2,0,1,1,2,0,-9,47,-1,-2,3,-1,0,-1,0,-1,-1,-1,0,-1
KR_6722890888,420,-4,-57,20,-13,-2,2,0,1,2,3,-1,2,1,-8,9,1,-3,3,0,0,-14,-2,0,-6,6,-4,0,0,-1,-1,-1,-1,3,-1
KR_6757035216,420,-3,31,31,-11,-1,1,0,-1,2,1,-3,3,0,-4,4,0,-2,2,0,0,-24,142,-3,-3,6,2,0,0,0,-1,-1,-1,0,-1
KR_6601104826,420,1,27,-4,0,-2,5,3,3,1,4,0,1,1,-2,4,2,1,0,1,0,-4,-59,-2,-7,9,17,0,-1,-1,1,-1,-1,1,-1
KR_6757539322,420,-4,-50,-29,-10,2,0,2,0,6,6,-4,6,2,-6,8,2,-2,4,2,0,0,7,4,-6,2,-2,0,-1,-1,-1,-1,-1,1,-1
KR_6761318787,420,-2,-43,-22,-2,0,1,1,-3,4,1,0,1,1,2,2,4,-1,2,1,0,-2,-10,-1,-6,7,5,0,1,1,1,1,-1,2,-1
KR_6698994349,420,0,27,16,4,1,1,2,0,3,3,2,2,4,-2,3,1,3,0,3,0,2,4,5,-6,1,-5,0,1,-1,1,1,-1,3,-1
KR_6608963423,420,2,6,-13,-2,0,0,0,2,2,4,-1,2,1,0,3,3,-3,4,1,0,4,5,3,-8,5,-5,0,1,-1,-1,1,1,2,-1
KR_6744096733,420,-2,31,-20,-6,1,0,1,-1,2,1,-7,8,1,0,2,2,1,1,2,0,-3,-10,-1,-1,2,7,0,-1,-1,0,-1,-1,3,-1
KR_6760921090,420,2,-41,2,8,-3,3,0,2,3,5,2,0,2,3,3,6,4,0,4,-1,18,-2,4,-6,2,5,0,-1,-1,1,-1,-1,6,-1
KR_6752313513,440,2,51,-36,1,-2,2,0,-3,3,0,5,1,6,0,2,2,1,0,1,0,-6,-49,-2,-4,6,6,0,-1,-1,-1,-1,1,3,-1
KR_6734298478,440,-2,-67,-24,-2,-4,5,1,3,0,3,0,2,2,0,0,0,-1,1,0,2,-2,78,0,-5,5,-4,0,-1,-1,-1,-1,1,1,-1
KR_6579908760,420,0,17,-20,-3,4,0,4,-3,5,2,-1,5,4,-4,6,2,1,0,1,-1,0,-1,5,-9,4,0,0,0,-1,-1,1,1,4,-1
KR_6691342335,440,2,24,-18,6,2,0,2,-5,5,0,0,1,1,14,0,14,-5,6,1,0,13,-16,8,-13,5,-4,0,3,-1,1,1,1,1,-1
KR_6722290936,420,-3,-21,4,-10,2,0,2,-2,5,3,-4,4,0,-2,2,0,-4,5,1,0,-15,-4,1,-4,3,-2,0,-2,-1,-1,-1,-1,3,-1
KR_6753742804,440,1,16,28,2,2,1,3,-1,3,2,2,2,4,-1,4,3,0,2,2,0,5,27,6,-7,1,-3,0,0,0,1,1,-1,0,-1
KR_6762525993,420,-3,-12,6,-9,-1,2,1,-3,6,3,-3,5,2,-1,2,1,-1,1,0,0,-14,1,-2,-3,5,3,0,-1,1,-1,-1,1,3,-1
KR_6728839790,420,-2,24,-9,-1,4,0,4,0,3,3,-2,5,3,-1,3,2,-2,2,0,-2,-13,-22,1,-9,8,-2,0,1,-1,1,1,-1,4,-1
KR_6755623138,420,2,6,-17,8,3,0,3,1,2,3,3,2,5,1,2,3,0,1,1,0,0,-4,-1,-5,6,-1,0,1,1,0,1,1,2,-1
KR_6731867786,420,-3,-46,18,-3,-3,4,1,1,3,4,-1,2,1,2,4,6,-2,2,0,0,3,27,-4,-2,6,-1,0,-1,-1,-1,-1,1,5,-1
KR_6636771720,420,-2,-29,-35,-4,-5,6,1,-1,3,2,0,1,1,1,1,2,1,0,1,0,3,5,5,-7,2,1,0,0,-1,-1,1,1,4,-1
KR_6705287128,420,1,20,-4,7,3,2,5,7,1,8,2,4,6,-6,6,0,1,1,2,3,12,12,-8,-5,13,0,0,0,0,1,0,1,0,-1
KR_6722326753,420,-2,-56,-14,-10,-1,1,0,-2,3,1,-1,1,0,-4,4,0,-2,2,0,0,-13,2,1,-2,1,-1,0,0,-1,-1,-1,-1,2,-1
KR_6748257525,420,2,74,16,-6,2,1,3,-5,6,1,1,2,3,-4,6,2,0,1,1,-1,-11,-11,-3,-4,7,5,0,2,0,0,1,1,0,-1
KR_6709971509,420,-1,-42,4,-1,1,1,2,1,2,3,-4,4,0,2,3,5,-1,1,0,0,5,-4,-3,-4,7,2,0,0,-1,1,0,-1,4,-1
KR_6756891648,440,2,20,36,-4,-2,3,1,-1,2,1,-4,5,1,-1,3,2,4,0,4,0,-7,18,0,-3,3,0,0,-1,-1,-1,-1,-1,6,-1
KR_6685324187,440,-1,47,-30,-3,-3,3,0,-1,1,0,2,4,6,-2,5,3,1,4,5,0,-12,19,2,-6,4,0,0,1,-1,0,1,1,4,-1
KR_6764259708,420,-1,-38,4,3,0,1,1,2,1,3,0,0,0,-1,2,1,2,0,2,0,5,-8,-3,-3,6,2,0,0,-1,1,0,-1,2,-1
KR_6695697130,420,-6,-79,-16,-12,-4,6,2,-9,11,2,3,4,7,-1,5,4,-1,2,1,0,-9,-41,1,-5,4,3,0,0,-1,-1,-1,-1,2,-1
KR_6761834696,420,3,-5,12,-1,1,0,1,-1,1,0,2,2,4,-3,4,1,0,0,0,0,-2,-6,0,-4,4,-2,0,-2,-1,1,-1,-1,4,-1
KR_6635402954,420,-1,29,-68,-5,3,1,4,-6,6,0,-3,6,3,1,6,7,0,1,1,0,-5,-3,0,-1,1,1,0,0,1,-1,-1,1,2,-1
KR_6686340045,420,-4,-101,12,-4,-1,4,3,-4,5,1,-2,3,1,2,4,6,1,1,2,0,-4,-5,1,-5,4,2,0,0,-1,-1,-1,-1,4,-1
KR_6472477054,440,-2,-42,-18,-1,-4,4,0,1,3,4,-3,3,0,5,1,6,0,1,1,0,3,14,-1,-8,9,1,0,0,-1,-1,-1,1,3,-1
KR_6764370684,420,1,-29,29,5,-2,3,1,4,0,4,0,2,2,1,3,4,2,1,3,0,22,2,1,-5,4,0,0,-1,1,1,-1,1,5,-1
KR_6727789949,420,1,55,-25,-1,2,1,3,1,1,2,-1,3,2,-4,4,0,1,0,1,0,2,6,3,-6,3,-2,0,-1,1,-1,-1,1,4,-1
KR_6750295250,420,-5,-41,-5,-12,-5,6,1,-3,4,1,0,4,4,-3,3,0,-1,1,0,0,-14,6,2,-6,4,-5,0,0,-1,1,1,-1,2,-1
KR_6763418664,420,0,2,16,2,-3,4,1,-1,2,1,-1,2,1,3,1,4,4,0,4,0,3,7,3,-6,3,0,0,1,1,-1,-1,1,6,-1
KR_6616016597,420,0,-24,18,1,-1,2,1,-1,1,0,0,2,2,2,3,5,1,0,1,0,0,-39,-2,-3,5,3,0,0,1,-1,0,-1,2,-1
KR_5752593407,420,-1,47,8,-5,-1,3,2,-2,5,3,-3,4,1,-1,5,4,2,0,2,0,0,17,-1,-8,9,-7,0,0,-1,-1,0,-1,5,-1
KR_6764579744,420,-1,-73,18,0,2,1,3,2,1,3,2,1,3,-4,5,1,-2,4,2,1,2,10,3,-9,6,-3,0,-2,-1,1,-1,1,2,-1
KR_6688468536,440,0,-16,-3,-10,-1,3,2,-7,9,2,-4,10,6,0,3,3,2,2,4,-1,-6,-2,-1,-3,4,3,0,-3,1,-1,-1,-1,6,-1
KR_6737851528,420,-4,7,-27,-11,0,1,1,-7,8,1,-5,7,2,0,2,2,1,0,1,0,-18,-26,3,-7,4,0,0,-1,-1,-1,-1,-1,6,-1
KR_6614933267,420,2,11,-3,2,6,0,6,-2,6,4,-2,5,3,0,3,3,0,0,0,0,0,4,1,-7,6,0,0,1,1,1,1,-1,2,-1
KR_6752005304,420,1,-60,-17,2,0,0,0,3,5,8,1,3,4,-4,5,1,2,1,3,1,2,-39,2,-8,6,39,0,-1,-1,1,-1,1,2,-1
KR_6743918809,440,0,12,-6,3,0,1,1,1,5,6,1,3,4,3,2,5,-2,3,1,0,0,7,-1,-7,8,-3,0,0,0,1,0,1,0,-1
KR_6741745037,420,-4,-63,-56,-14,-6,6,0,0,3,3,-7,7,0,-3,4,1,2,0,2,0,-9,-276,-3,-2,5,-1,0,-4,-1,1,-1,1,4,-1
KR_6761281459,420,-3,10,-51,1,-3,6,3,-6,7,1,1,2,3,7,0,7,2,0,2,0,7,287,5,-8,3,-3,0,-2,-1,-1,-1,-1,5,-1
KR_6689752694,420,-3,-90,-16,-5,-2,4,2,-1,3,2,0,2,2,-2,2,0,0,1,1,0,-5,-8,0,-7,7,-4,0,-3,-1,1,-1,1,1,-1
KR_6694515855,420,3,23,23,5,-2,2,0,1,1,2,10,1,11,-1,7,6,-3,4,1,0,-2,95,-2,-8,10,3,0,2,0,-1,1,-1,0,-1
KR_6483707442,420,0,-89,-3,-2,-4,7,3,-1,2,1,0,3,3,2,3,5,1,0,1,0,2,-11,-11,-2,13,0,0,-2,1,-1,-1,-1,6,-1
KR_6738765238,420,-2,6,18,-6,0,5,5,0,4,4,-1,3,2,-4,4,0,-1,1,0,0,-10,1,-1,-1,2,1,0,1,-1,1,1,-1,1,-1
KR_6760258645,440,-2,-12,-10,0,-3,4,1,0,3,3,0,3,3,5,1,6,-2,3,1,1,5,-6,-4,-2,6,3,0,-1,-1,0,-1,1,4,-1
KR_6754933903,420,-6,-121,-38,-12,-2,5,3,0,2,2,-3,4,1,-9,10,1,2,1,3,0,-12,-1,1,-5,4,-3,0,-3,-1,1,-1,1,6,-1
KR_6760566740,420,1,30,-4,-1,-1,2,1,-1,1,0,1,0,1,-1,4,3,1,0,1,0,-4,-5,2,-6,4,-5,0,0,-1,1,-1,-1,4,-1
KR_6757590722,440,0,6,18,5,-2,2,0,7,2,9,1,2,3,-4,4,0,3,1,4,0,15,3,4,-7,3,-2,0,-1,0,-1,-1,-1,0,-1
KR_6608410315,420,-1,-33,-15,-2,-1,1,0,0,1,1,2,0,2,-3,5,2,0,0,0,0,-2,18,7,-12,5,-7,0,1,1,1,1,1,5,-1
KR_6685636687,420,-7,-114,-28,-9,-1,2,1,-9,11,2,-1,4,3,1,2,3,1,0,1,0,-5,4,-3,-3,6,16,0,-2,-1,-1,-1,1,5,-1
KR_6750836776,440,-4,-4,-21,0,3,0,3,-2,2,0,-2,6,4,0,5,5,1,0,1,0,-2,-13,-2,-4,6,-3,0,-1,-1,1,-1,1,1,-1
KR_6739277800,420,-1,-52,5,-2,-4,4,0,-1,5,4,-1,2,1,3,2,5,1,1,2,1,1,2,0,-5,5,-5,0,-1,0,-1,-1,1,0,-1
KR_6700441271,420,1,-35,7,2,-7,7,0,0,4,4,5,2,7,3,1,4,1,0,1,0,1,-5,1,-6,5,1,0,-2,1,1,-1,-1,4,-1
KR_6687913611,420,0,32,-17,-5,-1,2,1,-3,5,2,-3,6,3,1,2,3,1,1,2,0,-11,5,2,-6,4,-2,0,1,1,1,1,1,1,-1
KR_6643648590,420,-4,-10,-12,-10,0,2,2,-2,4,2,-2,3,1,-5,6,1,-1,2,1,-1,-9,-174,3,-7,4,-4,0,-1,-1,1,-1,-1,2,-1
KR_6746657058,420,-3,7,-20,-5,1,1,2,-1,5,4,-1,2,1,-1,5,4,-3,5,2,0,-4,3,-2,-4,6,1,0,0,0,0,0,1,0,-1
KR_6763110738,440,-2,29,9,-6,-1,2,1,-6,6,0,1,2,3,1,1,2,-1,1,0,0,-4,-3,0,-8,8,2,0,1,1,1,1,1,5,-1
KR_6760006679,420,-1,-13,20,-3,-2,5,3,0,1,1,-7,8,1,5,3,8,1,2,3,-1,-1,-5,-1,-6,7,0,0,0,1,-1,0,-1,2,-1
KR_6762815707,420,1,-40,24,-3,-1,3,2,-3,3,0,1,2,3,-1,7,6,1,0,1,0,6,11,-2,-3,5,1,0,0,1,1,0,1,4,-1
KR_6733012968,420,-4,-53,-30,-6,-2,2,0,0,1,1,1,5,6,-5,5,0,0,1,1,0,-2,17,2,-6,4,2,0,-2,-1,-1,-1,1,5,-1
KR_6717121462,420,0,-25,-4,-3,-2,3,1,3,1,4,1,3,4,-1,2,1,-4,4,0,1,0,4,5,-7,2,0,0,-1,1,-1,-1,1,3,-1
KR_6763793269,420,-5,-29,13,-7,-1,1,0,-1,2,1,-3,3,0,-4,4,0,2,0,2,0,-7,-22,-1,-4,5,-5,0,0,-1,0,0,-1,1,-1
KR_6750877452,420,-1,29,-32,3,3,1,4,-1,2,1,0,2,2,2,1,3,-1,3,2,0,2,10,6,-11,5,-3,0,0,-1,1,0,1,5,-1
KR_6682456536,420,6,111,22,5,2,1,3,-5,7,2,5,2,7,2,3,5,1,1,2,0,12,-5,-7,-5,12,1,0,0,1,1,0,1,2,-1
KR_6764265943,420,-2,-86,-8,-2,-1,3,2,0,1,1,1,0,1,-1,4,3,-1,2,1,0,0,-16,-3,-5,8,-6,0,-1,-1,1,-1,-1,4,-1
KR_6736632863,420,-3,20,-20,-13,-2,6,4,-3,3,0,4,0,4,-2,3,1,-10,10,0,0,-19,-18,0,-4,4,-3,0,0,-1,0,1,-1,4,-1
KR_6760934574,420,-3,-18,-13,-3,1,2,3,-2,5,3,0,2,2,-1,3,2,-1,2,1,0,-9,-327,-3,-4,7,4,0,-1,1,-1,-1,-1,2,-1
KR_6607975799,420,0,-27,-11,-3,2,1,3,-2,6,4,3,0,3,-4,4,0,-2,2,0,0,-6,1,2,-5,3,-6,0,-2,1,-1,-1,1,3,-1
KR_6761059057,420,-4,-90,12,-5,-1,1,0,-2,2,0,-1,3,2,-2,3,1,1,0,1,0,-11,-1,2,-5,3,5,0,0,-1,0,0,1,5,-1
KR_6717679714,420,-2,-86,0,-2,-1,1,0,3,2,5,-1,3,2,-5,6,1,2,1,3,0,0,30,0,-5,5,24,0,-3,-1,-1,-1,-1,5,-1
KR_6757967721,420,-1,-84,-11,-2,-1,3,2,-4,4,0,-2,4,2,5,1,6,0,0,0,0,-2,4,4,-7,3,-6,0,-2,-1,0,-1,-1,3,-1
KR_6762839150,420,-4,-44,12,-5,-1,5,4,-4,4,0,0,3,3,0,4,4,0,2,2,0,-10,-2,0,-6,6,-3,0,-1,1,-1,-1,1,1,-1
KR_6758861543,420,3,23,-16,1,-1,2,1,-1,3,2,5,0,5,-1,4,3,-1,1,0,-1,11,0,-2,-5,7,2,0,-1,-1,-1,-1,-1,5,-1
KR_6640649982,440,-4,-131,-37,-4,0,1,1,-1,4,3,-2,4,2,-1,4,3,0,1,1,0,-7,7,-2,-3,5,2,0,-2,-1,1,-1,-1,3,-1
KR_6679254625,420,-7,-55,12,-23,0,0,0,-7,9,2,-5,6,1,-7,9,2,-4,4,0,0,-30,4,2,-4,2,1,0,-1,1,-1,-1,-1,5,-1
KR_6725029234,420,-6,-94,-20,-9,-2,3,1,3,0,3,-3,4,1,-7,9,2,0,2,2,0,-4,-42,-1,-3,4,20,0,-2,-1,-1,-1,-1,6,-1
KR_6699067462,420,0,-34,2,0,1,1,2,-4,6,2,-1,4,3,1,3,4,3,0,3,1,4,229,-2,-5,7,-1,0,0,-1,-1,-1,1,6,-1
KR_6695018772,420,-6,-54,-4,-16,-4,5,1,-4,4,0,-2,2,0,-5,7,2,-1,1,0,-1,-22,1,-2,-4,6,-5,0,0,-1,1,-1,-1,2,-1
KR_6760582279,420,-4,-108,6,-17,-8,9,1,-10,13,3,0,2,2,1,3,4,0,1,1,0,-15,-12,-9,0,9,2,0,-4,-1,-1,-1,-1,2,-1
KR_6717883626,420,-1,36,-32,-1,1,2,3,-2,3,1,2,2,4,0,1,1,-2,2,0,0,-1,-1,-1,-7,8,0,0,-1,-1,-1,-1,1,3,-1
KR_6741777531,440,-1,3,-16,-4,-7,7,0,2,0,2,2,2,4,1,0,1,-2,2,0,0,-2,1,4,-7,3,-1,0,-1,1,-1,-1,1,4,-1
KR_6751561186,420,-3,-84,8,-3,-2,3,1,-3,4,1,1,1,2,0,1,1,1,1,2,0,1,3,-3,-5,8,-2,0,0,-1,1,0,1,2,-1
KR_6532877480,420,-3,-42,-7,-9,-4,5,1,-6,7,1,1,2,3,2,0,2,-2,2,0,0,-12,-2,-6,-1,7,2,0,-1,1,-1,-1,-1,2,-1
KR_6745179809,440,3,-9,19,4,2,2,4,-1,1,0,-3,3,0,2,1,3,4,0,4,0,-2,3,-4,-2,6,0,0,1,0,-1,1,1,0,-1
KR_6740419878,420,1,14,23,-2,0,0,0,-2,6,4,6,1,7,-6,7,1,0,0,0,0,-7,7,1,-6,5,3,0,0,1,-1,0,1,5,-1
KR_6732873451,420,-4,-45,-22,-9,0,2,2,-4,6,2,-3,3,0,-1,4,3,-1,2,1,0,-7,2,-4,-2,6,1,0,0,-1,1,0,-1,1,-1
KR_6752715946,420,-2,32,-8,-7,-1,3,2,-1,2,1,0,2,2,-4,5,1,-1,1,0,0,-12,26,-1,-3,4,-4,0,1,-1,1,1,-1,3,-1
KR_6758438353,420,-1,-40,0,0,-2,2,0,-1,4,3,2,0,2,0,0,0,1,0,1,0,3,8,7,-10,3,-6,0,1,-1,-1,1,-1,2,-1
KR_6741817807,420,-5,-19,-3,-12,-1,2,1,-1,3,2,-3,4,1,-3,3,0,-4,4,0,0,-14,-9,-2,-9,11,-4,0,0,1,-1,-1,-1,2,-1
KR_6743990426,440,-3,13,0,-4,-2,3,1,1,2,3,-1,2,1,-1,5,4,-1,1,0,0,-4,-117,0,-6,6,-8,0,-1,-1,-1,-1,-1,1,-1
KR_6652538678,420,-5,-42,-31,-10,-1,2,1,0,1,1,-6,7,1,-2,4,2,-1,1,0,0,-14,2,3,-8,5,1,0,-2,-1,1,-1,-1,4,-1
KR_6759382152,420,-4,-5,-28,-3,2,1,3,0,2,2,-2,2,0,0,3,3,-3,3,0,1,2,2,3,-7,4,2,0,0,0,0,0,1,0,-1
KR_6761026131,420,0,-30,-20,-2,0,0,0,-2,4,2,-2,4,2,4,2,6,-2,2,0,0,-3,-45,4,-8,4,-5,0,-1,1,-1,-1,-1,3,-1
KR_6358149475,420,0,-43,-16,5,-3,3,0,3,0,3,2,0,2,1,1,2,2,1,3,0,9,0,0,0,0,0,0,-1,1,-1,-1,1,2,-1
KR_6742940193,420,-8,-72,-68,-15,-5,6,1,-2,4,2,-3,3,0,-4,5,1,-1,2,1,0,-4,-2,-5,-6,11,-6,0,-4,1,-1,-1,1,5,-1
KR_6747592164,420,2,-59,-16,8,1,2,3,0,1,1,0,3,3,4,1,5,3,0,3,0,15,-6,-2,-5,7,-3,0,0,-1,1,1,-1,5,-1
KR_6756044607,420,3,24,17,4,2,2,4,-6,6,0,3,1,4,1,3,4,4,3,7,-1,7,2,-1,-6,7,0,0,0,0,-1,-1,-1,0,-1
KR_6731604614,420,-3,-39,-17,-8,0,0,0,0,1,1,-4,6,2,-2,2,0,-2,2,0,0,-7,131,-1,-4,5,0,0,0,-1,-1,0,-1,4,-1
KR_6667857117,420,-3,-51,-12,-7,-3,4,1,4,2,6,-7,7,0,0,1,1,-1,1,0,0,-8,-30,5,-8,3,-2,0,1,1,1,1,-1,3,-1
KR_6747626835,420,-1,-40,-12,-5,-1,3,2,-3,4,1,1,2,3,-2,3,1,0,0,0,0,-6,3,5,-11,6,-4,0,0,-1,-1,0,-1,4,-1
KR_6756472161,420,-4,-88,8,-13,2,0,2,5,1,6,-4,4,0,-13,16,3,-3,3,0,0,-20,-4,1,-6,5,-2,0,-2,1,1,-1,-1,4,-1
KR_6763969392,420,2,29,-15,-1,2,2,4,0,5,5,-1,4,3,-2,5,3,0,0,0,1,0,-12,1,-8,7,4,0,1,0,-1,1,1,0,-1
KR_6752244334,420,0,-11,6,0,3,2,5,-2,5,3,-1,1,0,2,0,2,-2,2,0,0,-4,-6,2,-4,2,2,0,0,-1,1,-1,-1,4,-1
KR_6763301771,420,-1,20,-16,3,1,0,1,0,8,8,4,1,5,0,4,4,-2,2,0,1,2,-36,2,-4,2,-1,0,0,1,1,1,1,4,-1
KR_6711540240,420,-2,-51,23,-4,-3,4,1,-2,2,0,2,2,4,3,1,4,-4,7,3,0,-6,-3,-2,-5,7,5,0,0,-1,1,1,1,6,-1
KR_6664234282,420,-5,-17,-26,-6,1,1,2,2,3,5,0,1,1,-6,8,2,-3,5,2,-1,-15,-4,3,-9,6,-1,0,0,-1,1,1,-1,6,-1
KR_6147971434,420,-1,-69,-9,1,-2,3,1,5,0,5,0,1,1,0,5,5,-2,2,0,1,7,-3,2,-4,2,-3,0,0,0,-1,0,1,0,-1
KR_6632619139,420,-3,-46,-9,-3,-1,2,1,2,0,2,2,1,3,-6,8,2,0,0,0,2,-3,2,-1,-4,5,1,0,1,-1,0,1,1,2,-1
KR_6664761430,420,0,-17,7,-1,3,2,5,-4,5,1,-4,6,2,3,1,4,1,2,3,0,-6,38,-1,-7,8,-30,0,1,-1,-1,1,1,4,-1
KR_6662730494,420,-6,-80,-20,-10,-4,4,0,-1,3,2,-7,7,0,1,3,4,1,1,2,0,-1,4,5,-8,3,-1,0,-2,-1,1,-1,1,6,-1
KR_6660481951,420,-2,-34,-27,-10,3,0,3,-8,9,1,-1,2,1,-4,4,0,0,0,0,-3,-24,-11,0,-6,6,-2,0,-1,-1,-1,-1,1,6,-1
KR_6763126149,440,1,5,12,-4,5,2,7,0,1,1,1,1,2,-9,10,1,-1,1,0,0,-8,-48,-3,-4,7,13,0,0,1,1,-1,1,5,-1
KR_6751331862,440,1,-11,16,1,2,3,5,2,3,5,1,1,2,-5,7,2,1,0,1,0,-5,-17,-1,-7,8,1,0,1,-1,1,1,-1,4,-1
KR_6731112208,440,4,20,16,10,5,0,5,2,1,3,1,2,3,1,3,4,1,1,2,0,13,-9,-2,-3,5,2,0,2,-1,1,1,-1,3,-1
KR_6762596196,420,3,-37,8,11,3,1,4,0,5,5,3,4,7,1,1,2,4,0,4,0,16,2,3,-6,3,2,0,0,-1,-1,-1,1,1,-1
KR_6737602979,420,-3,-66,-22,1,0,1,1,2,2,4,0,1,1,-2,8,6,1,0,1,0,8,11,3,-8,5,-2,0,-1,-1,-1,-1,1,5,-1
KR_6739685786,420,3,-24,24,3,1,2,3,2,2,4,0,3,3,1,2,3,-1,2,1,0,-4,-1,2,-3,1,0,0,1,1,1,1,-1,4,-1
KR_6761302118,440,-2,11,-5,-6,-1,3,2,1,1,2,0,0,0,-3,5,2,-3,4,1,0,-6,-10,-2,-5,7,-3,0,0,-1,-1,0,1,3,-1
KR_6762971496,420,-1,-67,-20,4,0,1,1,-1,2,1,3,0,3,2,0,2,0,1,1,0,0,-4,2,-5,3,-1,0,-1,-1,1,-1,-1,3,-1
KR_6765310055,420,-1,-87,-3,-5,-1,2,1,-2,4,2,-2,4,2,1,3,4,-1,1,0,0,3,10,-3,-7,10,-2,0,-2,-1,-1,-1,-1,2,-1
KR_6657454842,420,3,-53,8,6,0,2,2,3,2,5,4,2,6,0,5,5,-1,1,0,0,3,-12,-7,-4,11,-1,0,-2,-1,-1,-1,-1,4,-1
KR_6760680694,420,0,-57,0,1,4,2,6,0,2,2,-2,3,1,0,2,2,-1,3,2,0,6,-1,-2,-6,8,3,0,-1,1,-1,-1,-1,3,-1
KR_6731465610,420,-1,25,-17,3,-5,5,0,7,4,11,2,3,5,1,4,5,-2,2,0,0,6,22,5,-9,4,-5,0,0,0,1,0,1,0,-1
KR_6667841844,420,-6,-68,-24,-18,1,1,2,-6,6,0,-7,7,0,-1,4,3,-5,5,0,0,-15,87,-5,-2,7,1,0,-3,-1,-1,-1,-1,5,-1
KR_6661421191,420,0,-62,-21,-1,-2,2,0,-3,6,3,1,3,4,4,0,4,-1,1,0,0,5,-4,-1,-6,7,1,0,1,-1,1,1,-1,1,-1
KR_6697703766,420,-1,-30,-27,-3,1,1,2,-2,3,1,-3,4,1,0,2,2,1,0,1,0,-4,-4,-1,-7,8,-9,0,2,-1,1,1,1,3,-1
KR_6755845094,420,-4,-60,8,-10,-2,4,2,-4,5,1,0,1,1,-2,2,0,-2,2,0,0,-13,-19,-6,-3,9,2,0,-2,-1,-1,-1,-1,4,-1
KR_6702076545,420,-2,2,-4,-4,-2,4,2,1,3,4,-3,6,3,2,3,5,-2,3,1,-1,-11,3,-1,-6,7,-3,0,2,-1,1,1,-1,4,-1
KR_6762914568,420,-2,-22,-20,0,0,2,2,-1,2,1,0,2,2,1,3,4,0,0,0,0,-1,13,0,-3,3,0,0,0,1,1,1,-1,2,-1
KR_6750376121,420,-2,-88,-32,-4,-1,3,2,-4,7,3,1,3,4,-1,3,2,1,0,1,-2,-9,33,0,-4,4,0,0,0,-1,1,1,-1,3,-1
KR_6754062649,420,-2,42,-9,-12,0,2,2,-9,10,1,-2,3,1,1,5,6,-2,2,0,0,-22,-1,-5,-3,8,1,0,0,1,-1,0,-1,4,-1
KR_6754879530,420,1,7,9,1,1,1,2,3,1,4,-4,4,0,1,2,3,0,0,0,0,0,-205,5,-12,7,1,0,1,-1,1,1,1,5,-1
KR_6755083363,420,-3,-69,-5,-3,-3,3,0,1,0,1,-3,4,1,0,1,1,2,1,3,0,-1,36,-3,-3,6,-9,0,-1,1,0,-1,-1,2,-1
KR_6757930281,420,-3,-20,16,-5,3,1,4,-1,3,2,-3,6,3,-4,8,4,0,0,0,0,-16,-4,-7,-3,10,-3,0,-1,-1,-1,-1,-1,2,-1
KR_6701565703,420,0,38,9,-2,-2,4,2,-5,9,4,1,1,2,5,0,5,-1,1,0,0,5,6,-6,-3,9,6,0,-1,-1,-1,-1,-1,4,-1
KR_6751073963,420,-1,5,1,5,0,1,1,2,3,5,-2,4,2,7,1,8,-2,2,0,0,-2,1,-1,-5,6,3,0,1,1,1,1,1,3,-1
KR_6678173312,420,2,25,20,3,4,2,6,1,1,2,-1,3,2,-2,4,2,1,0,1,0,2,-1,0,-6,6,-4,0,1,1,-1,1,-1,4,-1
KR_6468116315,420,5,50,13,4,0,3,3,-1,5,4,2,2,4,3,1,4,0,0,0,0,-4,2,3,-8,5,3,0,0,1,1,1,-1,1,-1
KR_6745256448,420,1,-2,-30,5,2,3,5,-3,4,1,2,0,2,2,2,4,2,0,2,0,6,7,5,-6,1,-2,0,1,-1,1,1,1,4,-1
KR_6758472891,420,-3,18,-12,-9,0,0,0,-3,6,3,-2,3,1,-4,4,0,0,1,1,0,-8,5,0,-7,7,0,0,0,1,-1,0,1,3,-1
KR_6755466381,420,-1,-122,-8,4,1,0,1,4,1,5,-1,2,1,0,0,0,0,0,0,0,5,-43,-2,-3,5,23,0,0,-1,1,0,-1,3,-1
KR_6750761957,420,-7,-20,-57,-12,0,1,1,-4,5,1,-3,3,0,-5,5,0,0,0,0,0,-6,108,-3,-2,5,-5,0,-1,-1,-1,-1,-1,1,-1
KR_6539495850,420,-4,-5,-20,-9,-2,4,2,-2,7,5,-3,5,2,-2,2,0,0,0,0,1,-2,-4,-4,-5,9,0,0,-3,-1,-1,-1,-1,2,-1
KR_6732611675,420,2,23,-6,7,5,0,5,4,3,7,-4,4,0,3,1,4,-1,2,1,0,7,1,0,-7,7,2,0,0,-1,-1,0,1,2,-1
KR_6739266622,420,-9,-104,-55,-27,-13,14,1,-6,8,2,0,2,2,-8,10,2,0,1,1,-1,-24,4,0,-2,2,-4,0,-3,-1,1,-1,-1,5,-1
KR_6763103114,420,2,1,5,-3,-1,1,0,-1,3,2,-2,5,3,-2,2,0,3,0,3,0,-11,93,-7,-2,9,-1,0,0,1,-1,-1,-1,5,-1
KR_6764505764,420,-6,-76,-7,-9,-5,8,3,-3,3,0,1,4,5,-3,6,3,1,0,1,0,0,-34,-3,-5,8,-2,0,-1,-1,1,-1,-1,3,-1
KR_6633529032,420,-1,15,8,0,3,0,3,3,3,6,-9,9,0,3,3,6,0,1,1,0,0,-69,5,-7,2,16,0,-1,1,1,1,1,2,-1
KR_6762491647,420,-4,24,-40,-12,-2,2,0,-2,4,2,-5,5,0,-2,5,3,-1,1,0,0,-15,142,-2,-6,8,-6,0,-1,-1,-1,-1,-1,6,-1
KR_6764058397,420,1,-18,-11,-1,-3,4,1,1,3,4,1,1,2,1,3,4,-1,2,1,0,1,-2,0,-6,6,-3,0,2,-1,1,1,-1,6,-1
KR_6763428719,420,-1,-35,-17,-3,-2,4,2,0,6,6,1,1,2,-1,2,1,-1,1,0,0,0,17,-2,-6,8,1,0,-1,1,-1,-1,1,1,-1
KR_6712765420,420,-5,-89,-45,-11,-3,4,1,0,5,5,-1,5,4,-6,7,1,-1,2,1,0,-1,-16,-2,-3,5,2,0,-3,-1,-1,-1,1,2,-1
KR_6763152761,420,-4,-75,0,-11,-2,2,0,-3,3,0,-3,3,0,-3,4,1,0,0,0,0,-11,3,2,-7,5,-5,0,-1,-1,1,-1,-1,2,-1
KR_6761382193,440,3,83,28,-4,-1,2,1,-1,2,1,2,3,5,-3,6,3,-1,3,2,0,-16,-12,0,-3,3,-1,0,0,-1,-1,1,1,4,-1
KR_6743261517,420,-2,41,17,-3,0,1,1,-2,6,4,0,1,1,-1,3,2,0,2,2,0,2,-6,3,-6,3,-2,0,0,-1,1,1,-1,4,-1
KR_6688355673,420,-1,4,13,-8,2,0,2,-1,3,2,-2,6,4,-3,5,2,-4,4,0,0,-12,-8,-8,-2,10,3,0,0,-1,-1,0,-1,3,-1
KR_6764745020,420,-2,31,-14,-1,-2,3,1,-2,6,4,0,0,0,3,1,4,0,1,1,1,5,-29,-7,-2,9,1,0,0,-1,-1,0,1,3,-1
KR_6764799435,440,-3,-12,-16,-3,-1,2,1,-3,5,2,0,1,1,0,4,4,1,0,1,0,-6,-15,2,-8,6,4,0,0,-1,-1,-1,1,2,-1
KR_6676866655,420,-5,-91,0,-15,-6,6,0,-5,9,4,-3,3,0,0,1,1,-1,1,0,0,-4,-28,-1,-4,5,-1,0,-2,-1,-1,-1,-1,3,-1
KR_6765186425,420,-6,23,-35,-8,-1,2,1,-3,4,1,-4,6,2,-1,4,3,1,0,1,0,-4,-41,-2,-6,8,2,0,1,-1,0,1,1,6,-1
KR_6741968806,440,-2,-77,-16,-2,0,1,1,-1,1,0,-1,1,0,0,2,2,0,1,1,0,1,-5,-1,-3,4,-1,0,0,1,-1,0,-1,5,-1
KR_6759990105,440,2,4,15,8,-3,6,3,-1,4,3,-1,2,1,4,2,6,9,1,10,0,7,-3,1,-4,3,-2,0,0,1,0,-1,1,3,-1
KR_6706325110,420,-3,-36,-20,-4,-1,2,1,-2,3,1,-4,4,0,3,1,4,0,1,1,0,2,130,-2,-5,7,6,0,0,-1,-1,-1,1,6,-1
KR_6721029360,420,-2,2,-17,-4,0,2,2,0,2,2,1,2,3,-4,6,2,-1,1,0,0,-3,25,4,-5,1,-20,0,0,-1,1,1,-1,3,-1
KR_6629508939,420,-4,-14,-24,-8,-7,7,0,-2,3,1,-2,3,1,3,2,5,0,1,1,-1,-4,-250,1,-6,5,-2,0,-3,-1,-1,-1,-1,2,-1
KR_6761968800,420,-1,-26,18,-8,1,3,4,-2,2,0,-1,3,2,-6,7,1,0,2,2,0,1,-9,1,-4,3,4,0,-1,-1,-1,-1,-1,1,-1
KR_6674930004,420,1,-12,0,0,1,1,2,0,5,5,1,1,2,-2,2,0,0,0,0,0,-4,-20,3,-8,5,-4,0,0,-1,1,-1,1,6,-1
KR_6757134131,440,3,17,-12,19,7,1,8,5,0,5,5,0,5,-2,3,1,4,1,5,0,11,-16,5,-5,0,0,0,1,1,0,1,1,4,-1
KR_6760163225,420,-2,-49,-1,-1,-1,3,2,1,1,2,-1,2,1,0,3,3,0,1,1,0,4,2,2,-8,6,1,0,0,-1,-1,-1,1,5,-1
KR_6760656967,420,1,-102,0,2,2,0,2,1,3,4,-2,2,0,1,1,2,0,1,1,0,-1,-9,-4,-3,7,0,0,-2,-1,-1,-1,1,6,-1
KR_6616636223,420,-5,-79,-19,-18,-2,2,0,-4,7,3,-8,9,1,-4,4,0,0,0,0,0,-11,-30,-2,-4,6,-5,0,-3,-1,-1,-1,-1,4,-1
KR_6645118815,420,0,-60,-24,-4,1,2,3,-2,6,4,-2,4,2,-1,1,0,0,1,1,0,-1,1,0,-5,5,-1,0,0,-1,-1,0,-1,6,-1
KR_6652096838,420,-8,-73,-5,-15,-1,3,2,2,1,3,-7,7,0,-6,10,4,-3,4,1,-2,-14,-9,0,-4,4,0,0,-2,-1,-1,-1,1,2,-1
KR_6624216339,420,-3,17,40,-9,-3,4,1,-3,6,3,-4,5,1,1,2,3,0,1,1,0,-1,-43,1,-8,7,3,0,-2,1,-1,-1,-1,5,-1
KR_6737676979,420,-3,-135,-40,2,4,0,4,-1,4,3,1,1,2,0,0,0,-2,2,0,0,5,-6,1,-4,3,-3,0,-2,-1,-1,-1,1,3,-1
KR_6743268400,420,-4,-4,-7,-10,-1,1,0,-2,4,2,-2,2,0,-4,4,0,-1,1,0,0,-11,0,-1,-4,5,-2,0,-1,-1,-1,-1,-1,3,-1
KR_6685342156,420,-6,-65,-33,-19,-7,7,0,-2,2,0,0,2,2,-11,12,1,1,0,1,-4,-14,18,5,-7,2,1,-1,-5,-1,-1,-1,-1,6,-1
KR_6687423875,420,-1,-78,-4,-5,6,0,6,-1,4,3,-5,7,2,-9,10,1,4,0,4,0,-21,-6,-1,-2,3,0,0,0,-1,1,1,-1,6,-1
KR_6463565239,420,2,3,40,3,3,1,4,-2,7,5,1,3,4,-1,3,2,2,0,2,-2,-2,-5,0,-5,5,-1,0,-1,-1,1,-1,-1,6,-1
KR_6607198873,420,2,-2,10,0,3,0,3,7,0,7,-5,9,4,-5,5,0,0,1,1,1,5,-18,3,-9,6,-4,0,0,1,1,0,1,1,-1
KR_6735633457,420,-1,13,-27,0,2,1,3,-4,6,2,-4,4,0,8,0,8,-2,3,1,1,4,8,2,-6,4,-4,0,-1,0,-1,-1,1,0,-1
KR_6763761118,420,-4,-28,-68,-10,0,0,0,-6,7,1,-2,3,1,1,4,5,-3,4,1,-1,-5,3,3,-7,4,-2,0,-1,0,0,-1,-1,0,-1
KR_6754511624,420,3,63,4,1,2,1,3,2,1,3,-4,5,1,0,2,2,1,0,1,0,5,-2,1,-5,4,-1,0,0,1,0,1,1,5,-1
KR_6645273549,420,1,-17,9,5,-1,1,0,1,0,1,1,1,2,1,1,2,3,1,4,0,3,-11,1,-3,2,-2,0,1,1,-1,1,1,5,-1
KR_6764842188,420,-1,9,-20,-6,-7,8,1,0,1,1,4,0,4,-1,1,0,-2,2,0,-1,1,8,3,-7,4,2,0,-1,-1,-1,-1,-1,3,-1
KR_6643325303,420,2,15,-1,5,2,2,4,-1,3,2,5,2,7,-2,5,3,1,0,1,0,8,-1,-3,-4,7,0,0,2,-1,1,1,1,1,-1
KR_6753786241,420,1,15,20,-4,-4,4,0,2,1,3,-3,4,1,3,2,5,-2,2,0,0,-5,8,-1,-4,5,2,0,0,-1,1,1,1,6,-1
KR_6689156801,420,-4,-33,-31,-6,-4,4,0,-2,6,4,-5,6,1,3,0,3,2,0,2,-1,1,-7,2,-5,3,9,0,0,1,-1,-1,-1,6,-1
KR_6764671768,420,-4,-9,-23,-1,0,1,1,4,0,4,-5,6,1,3,2,5,-3,7,4,0,1,4,9,-13,4,-4,0,0,1,1,-1,1,5,-1
KR_6763356834,440,0,-38,-8,-2,-4,4,0,-2,2,0,2,2,4,-1,2,1,3,1,4,0,0,-2,-7,-3,10,2,0,-1,-1,-1,-1,1,3,-1
KR_6754901642,420,-4,-116,-67,0,-4,4,0,1,0,1,-4,4,0,2,4,6,5,1,6,0,4,5,4,-9,5,1,0,-3,-1,-1,-1,1,2,-1
KR_6634674234,420,-2,-20,-29,-6,-6,6,0,2,2,4,-1,1,0,-1,1,0,0,0,0,0,4,4,-1,-5,6,1,0,-2,-1,-1,-1,-1,4,-1
KR_6691324363,440,2,43,-39,9,5,1,6,0,2,2,2,3,5,1,3,4,1,1,2,-1,8,0,7,-9,2,-2,0,1,0,-1,-1,-1,0,-1
KR_6669357493,420,-3,-53,-15,-3,-6,7,1,-2,2,0,4,1,5,-3,3,0,4,0,4,1,5,-1,-1,-3,4,1,0,-1,1,-1,-1,1,6,-1
KR_6668054509,420,-3,-13,-12,-8,0,1,1,-2,5,3,-6,6,0,0,3,3,0,2,2,0,-18,-14,0,-6,6,0,0,-1,-1,-1,-1,1,4,-1
KR_6764913899,440,-3,-59,-4,3,0,2,2,-1,1,0,-1,6,5,4,1,5,1,2,3,0,14,-18,-4,-3,7,5,0,0,1,-1,-1,-1,4,-1
KR_6761511968,420,0,-4,28,3,-3,4,1,-1,3,2,1,2,3,5,1,6,1,1,2,1,4,-81,2,-6,4,2,0,0,-1,-1,-1,1,5,-1
KR_6760591525,420,-1,-31,-2,0,-3,4,1,1,4,5,0,2,2,4,0,4,-2,2,0,0,0,9,1,-6,5,-5,0,-2,-1,-1,-1,1,5,-1
KR_6758811561,420,-2,9,-7,-5,-3,3,0,1,0,1,-3,3,0,0,1,1,0,0,0,0,-10,116,-4,-5,9,-6,0,0,1,0,0,1,1,-1
KR_6479795938,420,-2,-31,-3,-12,-2,4,2,-4,6,2,-1,4,3,-3,5,2,-2,3,1,0,-13,-29,-5,-2,7,2,0,-2,0,1,-1,-1,0,-1
KR_6762971146,420,-2,-9,-5,-3,-3,3,0,-4,6,2,2,0,2,1,2,3,1,0,1,0,-6,0,-2,-7,9,-4,0,0,1,-1,0,1,5,-1
KR_6624591107,420,-5,-62,-11,-9,0,1,1,-8,8,0,-2,3,1,-2,4,2,3,1,4,0,-9,-5,-2,-3,5,-2,0,-3,0,-1,-1,-1,0,-1
KR_6755496429,420,0,3,-31,-1,-1,2,1,1,2,3,0,2,2,-1,4,3,0,0,0,0,-3,-30,0,-3,3,-2,0,1,1,-1,1,-1,4,-1
KR_6736482675,420,-3,-40,4,-9,-3,3,0,-3,4,1,2,2,4,-6,6,0,1,0,1,0,-3,-2,-7,-6,13,-4,0,-1,-1,-1,-1,-1,4,-1
KR_6695565910,420,-4,-71,-17,-8,-3,3,0,-1,4,3,1,2,3,-4,5,1,-1,1,0,0,-2,28,-6,-2,8,-4,0,-2,-1,-1,-1,-1,1,-1
KR_6736371486,420,-1,-14,-19,-3,3,0,3,-2,3,1,2,0,2,-4,8,4,-2,2,0,0,-7,-1,-4,-5,9,1,0,1,-1,1,-1,-1,3,-1
KR_6626361434,420,0,-38,-4,-7,-3,4,1,2,1,3,-3,7,4,-3,6,3,0,1,1,-1,-14,25,0,-8,8,-6,0,1,-1,-1,1,-1,4,-1
KR_6722239548,420,-3,17,-11,-3,0,1,1,-1,7,6,-2,4,2,1,1,2,-1,4,3,0,-9,287,-5,-3,8,4,0,1,1,1,1,1,6,-1
KR_6761695502,420,-1,17,-34,-2,1,2,3,0,7,7,-2,5,3,-1,2,1,0,2,2,0,2,63,-3,-3,6,-17,0,1,-1,-1,1,-1,5,-1
KR_6734555747,420,0,-48,4,1,-2,2,0,1,1,2,0,2,2,2,0,2,0,0,0,0,2,5,1,-3,2,-2,0,0,-1,1,0,1,4,-1
KR_6730146405,420,-1,-60,17,1,-1,1,0,-2,5,3,1,0,1,2,3,5,1,0,1,0,1,-17,-1,-4,5,4,0,-1,-1,-1,-1,1,1,-1
KR_6761967296,420,-7,-41,-3,-23,-5,5,0,-7,8,1,-7,8,1,0,3,3,-4,4,0,-1,-27,-1,-3,-3,6,-1,0,-1,1,1,-1,-1,5,-1
KR_6738571716,420,-3,-52,-16,-3,-1,2,1,2,2,4,-5,6,1,0,2,2,1,1,2,0,0,1,1,-5,4,-1,0,-1,-1,-1,-1,-1,6,-1
KR_6765140784,420,1,33,-7,-4,0,1,1,-5,7,2,-2,2,0,0,0,0,3,1,4,0,-5,11,-1,-5,6,-5,0,2,-1,-1,1,1,5,-1
KR_6633115344,420,-6,-86,-47,-15,-8,10,2,-4,4,0,-5,8,3,0,3,3,2,2,4,0,-2,21,3,-8,5,1,0,0,1,-1,-1,-1,6,-1
KR_6722667721,440,-6,-83,-4,-15,-3,4,1,-1,3,2,0,5,5,-10,14,4,-1,1,0,0,-18,-1,-1,-5,6,-5,0,0,-1,-1,-1,-1,5,-1
KR_6762896107,420,-3,-14,-20,-11,-4,5,1,-7,9,2,-3,4,1,2,0,2,1,1,2,0,-6,8,1,-10,9,-3,0,-1,-1,-1,-1,-1,5,-1
KR_6762154367,420,0,-40,24,-3,-2,3,1,-2,8,6,-4,4,0,5,2,7,0,0,0,-2,-4,6,5,-9,4,1,0,0,1,0,0,-1,1,-1
KR_6759907645,420,-4,-22,23,-10,-6,7,1,1,5,6,-4,5,1,2,1,3,-3,3,0,-1,-3,0,-1,-4,5,1,0,0,-1,0,-1,-1,5,-1
KR_6705924306,420,-5,-28,-16,-2,0,0,0,0,4,4,-2,3,1,-2,3,1,2,2,4,0,-2,0,-5,-2,7,-3,0,0,-1,1,0,-1,1,-1
KR_6432077641,440,-5,-72,4,-8,-1,3,2,-6,6,0,2,0,2,-1,2,1,-2,5,3,0,-7,-9,0,-3,3,-1,0,-2,0,1,-1,-1,0,-1
KR_6614897295,420,-6,-107,-13,-12,-3,4,1,-5,5,0,-2,2,0,-2,4,2,0,0,0,0,-6,8,-1,-3,4,-5,0,-2,-1,-1,-1,-1,3,-1
KR_6750329737,420,2,64,28,8,4,0,4,3,3,6,4,1,5,-3,7,4,0,1,1,2,6,6,2,-4,2,-2,0,1,1,1,1,1,2,-1
KR_6759753793,420,-5,-112,-16,-12,-3,6,3,-2,3,1,-1,2,1,-4,6,2,-2,4,2,0,-12,7,5,-9,4,-8,0,-1,-1,0,-1,-1,1,-1
KR_6722067505,420,-5,-51,-19,-7,-2,3,1,-4,5,1,0,2,2,-2,3,1,1,1,2,-1,-10,-20,0,-6,6,-6,0,-2,-1,-1,-1,-1,3,-1
KR_6729532941,420,5,53,3,5,1,5,6,-1,3,2,-6,8,2,6,1,7,5,0,5,-1,3,11,-1,-3,4,-2,0,2,1,-1,1,-1,4,-1
KR_6763190620,420,-2,-47,-16,0,-2,2,0,5,2,7,-3,3,0,0,1,1,0,0,0,0,-1,50,-1,-4,5,-23,0,0,-1,-1,0,1,1,-1
KR_6763617828,420,0,-6,3,-1,2,2,4,0,4,4,-2,4,2,-1,2,1,0,0,0,1,4,3,3,-7,4,-5,0,-1,-1,1,1,1,2,-1
KR_6717356797,420,1,-6,33,0,-2,2,0,2,3,5,3,0,3,-1,2,1,-2,2,0,1,-6,35,-1,-5,6,1,0,1,1,1,1,1,1,-1
KR_6717889024,420,-2,48,7,-6,0,3,3,-1,5,4,-2,3,1,-2,4,2,-1,1,0,0,-12,17,5,-7,2,-6,0,1,-1,1,1,-1,2,-1
KR_6742293876,420,3,30,13,1,0,3,3,-2,5,3,-1,5,4,6,1,7,-2,2,0,-1,-1,8,4,-10,6,1,0,2,1,1,1,-1,3,-1
KR_6667824697,420,-2,-17,-19,-7,0,2,2,-2,2,0,-8,8,0,3,1,4,0,0,0,0,-2,-200,1,-5,4,-6,0,-2,-1,-1,-1,1,1,-1
KR_6741807585,420,-1,-5,-20,-6,0,1,1,-2,3,1,-4,4,0,1,1,2,-1,1,0,0,-5,0,3,-7,4,-2,0,0,-1,1,0,-1,5,-1
KR_6691440559,420,-1,-53,32,-4,-1,2,1,1,4,5,-2,2,0,0,4,4,-2,2,0,0,-7,343,0,-5,5,1,0,1,-1,1,1,-1,1,-1
KR_6747520081,420,-2,-10,9,-13,1,1,2,-4,6,2,-2,3,1,-5,7,2,-3,3,0,0,-14,-13,-4,-7,11,4,0,-2,-1,0,-1,-1,2,-1
KR_6762265129,420,0,-9,0,3,1,2,3,1,1,2,-2,3,1,3,1,4,0,1,1,0,2,13,2,-6,4,-4,0,0,1,1,0,-1,3,-1
KR_6757892607,420,0,26,-38,4,2,1,3,1,3,4,0,0,0,1,2,3,0,2,2,0,6,63,-3,-5,8,6,0,0,1,-1,0,1,6,-1
KR_6765206892,420,1,10,-4,0,1,1,2,4,4,8,-4,5,1,0,6,6,-1,2,1,-1,-2,188,1,-4,3,4,0,0,1,1,0,-1,4,-1
KR_6758755756,420,-3,-8,-4,-10,-2,5,3,-2,5,3,-9,9,0,3,0,3,0,0,0,0,2,-3,-2,-4,6,6,0,-2,-1,-1,-1,-1,1,-1
KR_6654043096,420,-1,6,4,-1,0,0,0,0,5,5,3,2,5,-1,1,0,-3,3,0,0,-3,88,1,-6,5,-1,0,-1,-1,-1,-1,-1,5,-1
KR_6602253478,420,-4,-53,-20,-7,1,1,2,-5,7,2,-1,2,1,-1,5,4,-1,1,0,-1,-14,-8,-2,-5,7,-5,0,0,-1,1,-1,-1,1,-1
KR_6730884652,420,-1,-9,-10,-5,1,1,2,0,4,4,-9,11,2,3,0,3,0,0,0,0,-3,-43,2,-7,5,14,0,-2,1,1,-1,-1,5,-1
KR_6765170917,420,-2,0,-32,-1,-2,2,0,0,2,2,-1,3,2,1,5,6,1,0,1,0,-1,180,-3,-3,6,0,0,1,1,1,1,-1,3,-1
KR_6687841537,420,-2,-12,-13,-12,-7,7,0,-3,5,2,-1,4,3,-1,2,1,0,1,1,0,-9,-5,-2,-6,8,1,0,-1,1,-1,-1,-1,1,-1
KR_6644834519,420,-4,25,-20,-2,-1,1,0,0,2,2,-1,2,1,-1,1,0,1,0,1,0,-5,-120,-4,-4,8,3,0,0,-1,-1,-1,1,6,-1
KR_6578543943,420,0,38,-12,-9,-1,2,1,0,1,1,-2,2,0,-5,5,0,-1,1,0,0,-11,33,-1,-2,3,0,0,-2,-1,-1,-1,-1,3,-1
KR_6765413900,420,-5,-58,-29,-8,1,1,2,-9,11,2,-2,4,2,0,1,1,2,1,3,0,-12,-204,-4,-4,8,5,0,-2,-1,-1,-1,-1,3,-1
KR_6695432966,440,1,97,12,0,-3,3,0,0,6,6,-1,3,2,4,1,5,0,2,2,0,-4,2,-1,-5,6,-3,0,1,1,1,1,1,6,-1
KR_6331184973,420,-4,-39,-8,-8,-3,3,0,-4,5,1,-2,4,2,0,3,3,1,0,1,0,-5,-17,0,-5,5,4,0,-1,-1,-1,-1,-1,1,-1
KR_6578774101,440,-3,-45,-3,-3,1,2,3,0,0,0,-3,6,3,1,1,2,-2,4,2,0,-10,-8,-1,-6,7,-1,0,0,-1,1,1,-1,3,-1
KR_6728124820,420,1,-38,12,-9,1,3,4,1,2,3,-3,5,2,-7,9,2,-1,2,1,0,-6,100,-5,-2,7,3,0,-1,-1,-1,-1,-1,5,-1
KR_6742974129,420,-2,7,-22,-7,1,1,2,-1,4,3,-4,10,6,-2,3,1,-1,1,0,-2,-7,8,-7,-4,11,5,0,1,1,-1,-1,-1,6,-1
KR_6763056085,440,-1,24,5,0,1,0,1,3,4,7,0,0,0,-3,3,0,-1,1,0,0,-2,-9,-6,-1,7,1,0,-1,-1,0,-1,1,4,-1
KR_6763022161,440,-2,-83,-8,0,-2,3,1,2,5,7,-1,3,2,5,2,7,-4,4,0,0,5,0,1,-4,3,-2,0,-1,0,-1,-1,1,0,-1
KR_6574205127,420,-4,-16,-8,-6,-2,2,0,0,1,1,-1,4,3,-4,5,1,1,0,1,0,-8,4,0,-7,7,-4,0,1,-1,1,1,-1,5,-1
KR_6740378990,420,-3,-41,-36,-5,-1,2,1,-5,7,2,2,3,5,0,3,3,-1,1,0,0,-3,2,3,-7,4,2,0,0,-1,-1,-1,1,3,-1
KR_6668650305,420,-3,-41,-12,-10,-5,6,1,-5,9,4,0,1,1,0,1,1,0,1,1,0,-2,-6,-4,-5,9,7,0,-2,-1,-1,-1,-1,2,-1
KR_6764782013,420,-2,7,-12,-3,-3,6,3,0,2,2,-1,3,2,1,0,1,0,0,0,0,3,1,5,-7,2,4,0,-1,1,-1,-1,-1,4,-1
KR_6763723960,420,-3,-63,4,2,-1,2,1,8,1,9,-3,3,0,-3,4,1,1,0,1,0,2,-120,-3,-2,5,7,0,0,-1,1,0,1,1,-1
KR_6744059368,420,0,-44,-24,-5,-3,3,0,1,3,4,-3,7,4,-2,3,1,2,1,3,0,2,108,1,-3,2,-2,0,-2,0,-1,-1,-1,0,-1
KR_6747479131,420,-1,-30,-2,0,3,1,4,-1,3,2,-5,5,0,4,0,4,-1,2,1,0,3,-18,2,-4,2,3,0,1,-1,1,1,-1,5,-1
KR_6664499758,420,-2,-16,-4,-11,1,1,2,-3,5,2,-3,4,1,-6,8,2,0,0,0,0,-10,-33,-3,-3,6,-2,0,0,-1,1,0,-1,4,-1
KR_6732713199,440,1,14,8,-1,0,1,1,-1,6,5,0,4,4,0,1,1,0,1,1,0,3,-5,-3,-2,5,1,0,0,-1,-1,-1,1,6,-1
KR_6760384502,420,-2,-14,8,-3,-2,3,1,0,2,2,-4,6,2,2,1,3,1,1,2,-1,-9,-37,-1,-7,8,7,0,0,1,1,0,-1,4,-1
KR_6763364109,420,-1,-41,12,-6,-2,3,1,-1,4,3,-4,8,4,2,2,4,-1,1,0,0,-4,8,-1,-5,6,4,0,0,1,1,-1,-1,2,-1
KR_6678267122,420,-7,-49,-8,-18,-4,5,1,-7,7,0,-1,1,0,-5,8,3,-1,2,1,-1,-16,7,6,-8,2,-4,0,-1,-1,-1,-1,-1,1,-1
KR_6761548701,420,1,-31,10,-7,-4,6,2,2,1,3,-3,5,2,-2,4,2,0,1,1,-2,-3,0,1,-5,4,0,0,0,1,1,0,-1,4,-1
KR_6726525452,440,2,21,23,-3,1,2,3,0,2,2,4,3,7,-3,4,1,-5,6,1,0,-8,-22,-5,-3,8,1,0,1,-1,1,1,-1,1,-1
KR_6669385372,420,-2,28,0,4,1,1,2,0,6,6,3,0,3,1,1,2,-1,1,0,0,-2,-18,-7,-6,13,0,0,1,-1,1,1,-1,1,-1
KR_6740041716,420,-2,-23,9,-4,1,2,3,2,0,2,-2,2,0,-4,6,2,-1,1,0,0,-5,-167,-3,-3,6,5,0,0,1,1,0,-1,2,-1
KR_6749686334,420,-2,-38,-4,-6,-2,5,3,0,2,2,-1,2,1,-5,5,0,2,2,4,0,-6,-1,0,-8,8,-2,0,-2,1,-1,-1,1,3,-1
KR_6731453152,420,-3,-44,-21,-2,3,0,3,-4,5,1,1,2,3,-3,6,3,1,0,1,0,0,1,4,-13,9,-4,0,0,-1,1,1,1,1,-1
KR_6331282548,420,-2,-13,0,-3,-6,6,0,-1,1,0,1,3,4,2,1,3,1,1,2,0,2,153,0,-6,6,0,0,0,0,-1,0,1,0,-1
KR_6629495260,420,-2,39,-80,-4,-1,3,2,-3,3,0,0,2,2,1,1,2,-1,1,0,-1,-1,10,4,-6,2,-2,0,-1,-1,-1,-1,-1,4,-1
KR_6729290068,420,2,14,0,2,-2,4,2,1,3,4,2,2,4,0,2,2,1,0,1,0,-1,-6,4,-7,3,-5,0,0,-1,1,0,1,5,-1
KR_6737201607,420,-1,3,-32,0,1,0,1,-1,2,1,0,0,0,0,0,0,0,0,0,0,-1,4,2,-7,5,-1,0,0,1,-1,0,-1,2,-1
KR_6370980863,420,-2,-54,2,-5,3,0,3,-1,2,1,-4,6,2,-3,5,2,0,0,0,0,-2,0,0,0,0,-1,0,-1,0,0,-1,-1,0,-1
KR_6764545644,420,2,34,18,3,-2,3,1,-3,8,5,4,0,4,4,0,4,0,1,1,0,3,-2,-2,-3,5,3,0,0,1,-1,0,1,5,-1
KR_6644185231,420,-5,-68,5,-7,0,1,1,-2,5,3,3,0,3,-5,6,1,-3,3,0,-1,-8,-27,-1,-2,3,-1,0,-1,1,-1,-1,-1,2,-1
KR_6720440096,420,-9,-92,-43,-26,-3,5,2,-1,1,0,-7,9,2,-10,13,3,-5,7,2,-1,-21,4,-6,-3,9,-6,0,-1,-1,-1,-1,1,2,-1
KR_6750007301,420,-1,50,-20,1,2,0,2,-5,5,0,-2,4,2,3,2,5,3,1,4,0,1,-24,0,-5,5,5,0,1,1,1,1,1,2,-1
KR_6715747775,420,-2,-4,20,-6,0,1,1,-5,8,3,-2,3,1,0,5,5,1,1,2,0,5,-7,-4,-3,7,3,0,0,1,1,1,-1,2,-1
KR_6716324988,420,1,86,12,-2,-2,3,1,0,1,1,-6,7,1,5,0,5,1,0,1,-1,-2,1,2,-8,6,-1,0,2,1,1,1,-1,3,-1
KR_6751216171,420,-1,-4,28,-6,-6,7,1,-1,1,0,1,1,2,-2,5,3,2,2,4,0,-8,11,4,-7,3,-4,0,-2,1,1,-1,-1,2,-1
KR_6761514926,440,-5,9,-46,-12,-3,5,2,1,0,1,-2,4,2,-6,6,0,-2,2,0,0,-12,-4,-1,-5,6,0,0,0,-1,-1,0,-1,5,-1
KR_6764482935,420,-3,-48,-1,-6,0,2,2,0,2,2,-4,4,0,-2,3,1,0,2,2,0,-2,-1,-1,-4,5,-1,0,-1,1,-1,-1,-1,4,-1
KR_6764570459,420,2,2,4,1,-7,7,0,6,0,6,-1,2,1,1,0,1,2,0,2,0,12,5,-4,-2,6,-2,0,-1,1,-1,-1,-1,2,-1
KR_6764797999,420,-3,-55,-3,-1,2,0,2,-1,3,2,-1,3,2,-2,3,1,1,0,1,0,0,11,-1,-5,6,-4,0,-1,-1,-1,-1,1,4,-1
KR_6752362821,420,-3,-35,30,-3,-4,7,3,-4,6,2,-1,2,1,4,1,5,2,2,4,0,-4,-11,-5,-2,7,2,0,-1,0,-1,-1,-1,0,-1
KR_6708561001,420,-2,-68,7,4,-3,4,1,3,1,4,-2,2,0,6,1,7,0,2,2,0,9,2,-1,-4,5,-3,0,1,-1,1,1,-1,3,-1
KR_6723192094,420,-3,9,21,2,-2,2,0,5,2,7,-3,4,1,1,6,7,1,1,2,2,15,-6,-4,-6,10,1,0,0,1,1,1,1,4,-1
KR_6718796207,420,3,-13,-8,6,-2,2,0,2,1,3,2,2,4,4,2,6,0,1,1,0,4,3,0,-6,6,-3,0,1,-1,1,1,-1,1,-1
KR_6639535629,420,5,42,6,10,-1,3,2,8,0,8,5,0,5,1,1,2,-3,3,0,0,13,28,3,-6,3,-4,0,2,-1,1,1,-1,4,-1
KR_6637960642,420,-4,-4,-3,-10,2,0,2,-2,2,0,-1,1,0,-6,7,1,-3,3,0,0,-17,-3,4,-8,4,0,0,-1,-1,0,-1,-1,2,-1
KR_6673062194,420,-1,20,16,-6,0,0,0,-5,5,0,0,1,1,0,5,5,-1,1,0,0,-4,-122,4,-11,7,-7,0,0,-1,1,0,-1,3,-1
KR_6581608705,420,-1,-25,-29,-4,0,1,1,0,4,4,0,2,2,-6,6,0,2,0,2,0,-3,-1,-5,-2,7,1,0,-1,1,-1,-1,-1,3,-1
KR_6754178926,420,1,-15,3,-1,4,0,4,-2,4,2,-3,3,0,0,2,2,0,0,0,0,-1,-8,-1,-4,5,-2,0,0,-1,0,0,-1,5,-1
KR_6553407121,420,-3,-6,-1,-5,0,2,2,-2,3,1,-4,5,1,-1,4,3,2,0,2,0,0,-3,-2,-3,5,4,0,-1,-1,-1,-1,-1,2,-1
KR_6732590000,440,4,48,3,0,4,2,6,-2,4,2,-8,9,1,0,2,2,6,1,7,-2,-6,-10,-5,-1,6,1,0,0,-1,0,-1,-1,5,-1
KR_6642899422,420,-1,13,17,-1,-3,3,0,1,2,3,1,1,2,0,5,5,0,1,1,0,-3,26,3,-7,4,0,0,0,1,-1,-1,1,4,-1
KR_6734007143,420,-4,-61,16,-10,-1,2,1,-1,2,1,-3,4,1,-3,6,3,-2,3,1,0,-10,1,0,-5,5,-3,0,-2,0,-1,-1,-1,0,-1
KR_6623907033,420,-4,-72,-3,-11,-3,4,1,-3,5,2,-2,2,0,-2,3,1,-1,1,0,-1,-12,-9,2,-7,5,4,0,-2,-1,-1,-1,-1,4,-1
KR_6761087320,420,-4,-23,-40,-1,1,2,3,-2,3,1,-2,3,1,-2,4,2,4,0,4,0,1,0,0,-3,3,2,0,-1,-1,-1,-1,1,5,-1
KR_6743311584,440,-4,-28,-23,-5,-1,3,2,-5,6,1,-1,2,1,1,0,1,1,0,1,0,-6,1,-2,-2,4,-3,0,0,-1,1,0,1,3,-1
KR_6409624426,420,-3,4,-8,-13,0,0,0,-9,11,2,-1,4,3,-5,7,2,2,0,2,0,-13,182,5,-7,2,1,0,-1,-1,-1,-1,-1,5,-1
KR_6761846620,420,-2,16,10,-1,5,0,5,-6,6,0,-1,1,0,2,1,3,-1,2,1,1,-6,-3,2,-5,3,-1,0,0,-1,1,0,1,2,-1
KR_6751480761,420,-4,-53,-43,4,-1,3,2,1,1,2,4,4,8,0,0,0,0,0,0,0,0,12,-4,-5,9,2,0,-2,-1,-1,-1,1,2,-1
KR_6759268644,420,-6,-23,-32,-15,-2,3,1,-3,4,1,-7,7,0,-2,4,2,-1,2,1,-1,-11,-115,2,-6,4,-7,0,-2,-1,-1,-1,-1,1,-1
KR_6759742796,420,1,32,8,-3,1,1,2,-3,4,1,-4,4,0,3,1,4,0,1,1,0,-4,4,6,-10,4,-3,0,0,1,1,0,1,1,-1
KR_6757836108,440,-3,-25,16,-4,-2,3,1,0,4,4,0,1,1,-2,3,1,0,4,4,0,-2,-1,-4,-2,6,1,0,-1,-1,-1,-1,1,6,-1
KR_6762936355,420,1,22,-1,0,-2,2,0,2,2,4,-4,4,0,3,0,3,1,1,2,0,-2,-83,-3,-2,5,0,0,0,-1,-1,0,-1,6,-1
KR_6761797468,420,-2,-59,-6,-8,-1,4,3,-5,5,0,-5,6,1,3,1,4,0,0,0,0,-4,-3,3,-5,2,-1,0,-1,1,-1,-1,1,1,-1
KR_6753890828,420,-1,-11,-22,-1,-3,3,0,0,3,3,2,3,5,0,2,2,0,2,2,1,5,-9,-2,-4,6,2,0,-2,-1,-1,-1,1,1,-1
KR_6752370982,420,-1,-94,8,-3,-6,6,0,1,4,5,1,4,5,1,2,3,0,0,0,0,-4,-9,0,-8,8,-2,0,-1,-1,1,-1,-1,2,-1
KR_6730749806,420,-5,-50,4,-10,-3,4,1,-5,7,2,3,0,3,-3,3,0,-2,3,1,0,-11,-6,2,-6,4,1,0,-3,1,-1,-1,-1,3,-1
KR_6722728089,440,-6,-2,-48,-9,2,0,2,-10,12,2,2,1,3,-3,4,1,0,1,1,0,-3,-7,-1,-4,5,0,0,0,-1,-1,-1,1,5,-1
KR_6762804452,420,-1,37,-32,-5,2,0,2,-4,6,2,-4,4,0,5,1,6,-4,5,1,1,-1,-5,4,-8,4,-1,0,-1,-1,-1,-1,1,6,-1
KR_6653978062,420,-2,-5,27,-3,-3,3,0,1,5,6,-2,4,2,3,1,4,-2,2,0,-1,-2,-5,-2,-3,5,6,0,-1,-1,-1,-1,-1,2,-1
KR_6602942084,420,-5,-15,-8,-3,-1,1,0,1,0,1,-1,4,3,-2,2,0,0,1,1,0,-8,7,0,-5,5,-2,0,-1,-1,-1,-1,1,6,-1
KR_6744223793,440,0,-59,-41,-4,-1,1,0,-3,3,0,-9,10,1,10,2,12,-1,1,0,0,2,-41,1,-4,3,19,0,-1,-1,-1,-1,-1,3,-1
KR_6673790149,420,0,40,0,-6,1,0,1,-1,5,4,-3,5,2,-5,7,2,2,2,4,-3,-9,4,-1,-6,7,3,0,1,-1,1,1,-1,1,-1
KR_6764757034,420,1,20,4,2,3,0,3,-1,2,1,1,0,1,-1,2,1,0,1,1,0,-3,-20,1,-4,3,-2,0,1,-1,1,1,-1,5,-1
KR_6761909968,420,-2,-49,4,-2,-5,6,1,1,3,4,-1,3,2,-1,3,2,4,0,4,1,2,14,-3,-4,7,-6,0,0,1,0,0,1,4,-1
KR_6751717666,420,0,19,4,-1,2,0,2,-3,5,2,-2,2,0,4,3,7,-2,3,1,0,0,-8,3,-5,2,2,0,-2,-1,1,-1,1,5,-1
KR_6749931082,420,0,-17,2,-2,1,1,2,6,3,9,-4,6,2,-4,4,0,-1,1,0,2,9,1,3,-6,3,3,0,-2,-1,1,1,-1,4,-1
KR_6748996017,420,1,23,9,-5,-3,4,1,-2,4,2,2,1,3,-2,4,2,0,0,0,-1,-9,8,-3,-1,4,-2,0,0,-1,0,0,-1,2,-1
KR_6757638845,420,-2,46,-16,-1,-3,3,0,-3,7,4,2,2,4,1,3,4,2,1,3,1,1,1,0,-4,4,5,0,-1,0,0,1,1,0,-1
KR_6759498620,420,-3,-37,-3,-8,-1,2,1,-6,8,2,-3,3,0,2,1,3,0,2,2,-1,-3,-11,-2,-3,5,2,0,-2,-1,-1,-1,-1,4,-1
KR_6759397084,420,2,-21,12,-3,1,1,2,0,5,5,-1,2,1,-2,3,1,-1,2,1,0,-3,-28,-3,-4,7,0,0,0,1,1,0,-1,5,-1
KR_5748340524,420,-7,-40,-43,-15,-6,6,0,-2,4,2,0,2,2,-6,6,0,-1,1,0,-1,-15,-9,-1,-9,10,-6,0,-1,-1,1,-1,-1,3,-1
KR_6622552736,420,-6,5,16,-11,-2,2,0,-2,4,2,-7,7,0,0,2,2,0,1,1,-1,-10,1,0,-5,5,0,0,0,-1,1,-1,1,6,-1
KR_6744776583,420,0,33,-4,-2,-2,3,1,-3,4,1,4,0,4,1,4,5,-2,2,0,0,-1,-36,4,-7,3,2,0,0,-1,-1,0,-1,3,-1
KR_6607374833,420,-2,4,-4,-5,-2,4,2,-4,7,3,4,2,6,0,1,1,-3,6,3,0,-7,-1,-3,-1,4,-1,0,-1,-1,1,-1,1,6,-1
KR_6682370413,420,-5,-133,-12,-11,-2,4,2,-2,2,0,-7,8,1,-1,5,4,1,1,2,-2,-12,-27,0,-3,3,-5,0,-1,-1,-1,-1,-1,2,-1
KR_6737175241,420,-3,15,0,-5,0,2,2,4,0,4,0,1,1,-4,5,1,-5,5,0,0,-10,-84,-3,-3,6,-27,0,0,-1,1,0,-1,2,-1
KR_6493733643,420,0,-21,-22,-3,-2,3,1,-2,5,3,-5,6,1,1,1,2,5,1,6,0,1,-5,-3,-7,10,-4,0,0,-1,-1,-1,1,5,-1
KR_6760888505,420,1,43,-8,1,-1,1,0,-1,5,4,1,1,2,2,3,5,0,0,0,0,10,38,3,-6,3,-18,0,0,-1,-1,0,1,4,-1
KR_6752478641,420,2,30,8,4,1,3,4,0,5,5,3,2,5,0,2,2,0,3,3,-1,-3,-14,1,-7,6,7,0,-1,1,-1,-1,-1,5,-1
KR_6735949269,420,-5,-105,-24,-7,0,1,1,2,3,5,-4,5,1,-1,1,0,-4,4,0,0,-12,26,1,-6,5,1,0,0,1,-1,-1,-1,5,-1
KR_6747277817,440,-3,13,12,-7,0,2,2,5,1,6,-3,4,1,-5,9,4,-4,4,0,1,-11,-7,-1,-1,2,4,0,0,-1,1,0,1,5,-1
KR_6744067516,420,1,-31,4,-3,1,1,2,-1,3,2,-1,2,1,-3,4,1,1,1,2,0,-5,5,1,-6,5,-1,0,-1,-1,-1,-1,-1,3,-1
KR_6642652182,420,-1,-13,-28,0,-2,2,0,1,2,3,3,1,4,-2,4,2,0,1,1,0,4,-33,-1,-6,7,-4,0,0,-1,-1,0,1,2,-1
KR_6601462435,420,-2,-2,-27,1,2,1,3,2,1,3,0,0,0,-3,3,0,0,1,1,1,8,-5,0,-4,4,0,0,-1,-1,1,-1,1,5,-1
KR_6745774907,420,3,66,11,3,5,1,6,4,1,5,-2,3,1,-3,3,0,-1,2,1,0,1,12,3,-5,2,0,0,2,1,1,1,-1,3,-1
KR_6762217496,420,-1,-29,-2,1,-1,2,1,1,2,3,-2,2,0,0,1,1,3,0,3,0,5,4,5,-6,1,-1,0,0,-1,1,-1,1,4,-1
KR_6700948609,420,-3,-4,-16,1,0,1,1,-1,2,1,1,0,1,2,4,6,-1,1,0,0,2,21,1,-5,4,0,0,1,-1,1,1,1,4,-1
KR_6754498249,420,3,3,4,4,-3,4,1,2,1,3,2,3,5,2,2,4,1,0,1,0,8,15,3,-6,3,-3,0,0,-1,-1,0,1,2,-1
KR_6745856111,420,-1,14,-23,2,2,1,3,-5,8,3,2,3,5,4,0,4,-1,1,0,1,10,1,3,-7,4,-5,0,0,-1,-1,0,1,2,-1
KR_6687047531,420,2,-19,20,-7,-3,5,2,-3,7,4,-2,3,1,-3,6,3,4,1,5,1,-9,2,-2,-5,7,-1,0,-1,-1,-1,-1,1,6,-1
KR_6615801777,420,-2,-49,-19,-7,-5,5,0,-2,3,1,0,2,2,0,5,5,0,1,1,0,-5,-37,1,-7,6,-4,0,-2,1,-1,-1,-1,1,-1
KR_6760665913,420,-2,-51,3,-7,1,0,1,-1,4,3,-1,3,2,-4,7,3,-2,2,0,-1,-7,16,-3,-4,7,2,0,-1,-1,0,-1,-1,1,-1
KR_6638351152,440,1,-40,21,-2,-3,3,0,2,2,4,1,2,3,-4,4,0,2,0,2,0,-3,0,-7,-2,9,-1,0,-1,-1,-1,-1,-1,1,-1
KR_6607167147,420,-7,-41,-44,0,-4,8,4,3,2,5,1,3,4,-1,3,2,1,2,3,1,4,1,4,-6,2,-1,0,-1,-1,-1,-1,1,6,-1
KR_6763335934,440,-3,-83,-44,-1,2,1,3,0,3,3,-3,3,0,-2,4,2,2,0,2,0,-1,-29,3,-6,3,-4,0,-1,-1,1,-1,-1,1,-1
KR_6693453576,420,-1,11,32,-6,-3,4,1,0,2,2,-1,2,1,-2,2,0,0,0,0,0,-10,9,-3,-4,7,4,0,0,-1,0,0,-1,2,-1
KR_6741429300,420,-3,-68,16,-6,-4,5,1,-2,4,2,2,3,5,-3,5,2,1,2,3,0,-4,-1,-10,-1,11,4,0,0,-1,1,-1,-1,1,-1
KR_6743722303,420,-3,-89,-17,-9,-2,3,1,-4,9,5,-1,1,0,5,2,7,-7,7,0,-1,-7,93,2,-6,4,-4,0,-3,0,-1,-1,-1,0,-1
KR_6763218752,440,4,3,-16,10,1,0,1,-1,3,2,5,2,7,3,2,5,2,0,2,2,14,-310,0,-2,2,6,0,0,0,-1,-1,1,0,-1
KR_6756539431,420,0,46,-4,-5,-3,4,1,1,2,3,-3,3,0,-2,3,1,2,2,4,0,-6,-9,-6,0,6,2,0,1,1,-1,1,-1,5,-1
KR_6759651955,420,-1,-30,20,2,-1,1,0,2,1,3,1,1,2,-1,6,5,1,0,1,0,7,-230,0,-4,4,-1,0,-1,1,-1,-1,1,4,-1
KR_6764824610,420,2,10,-7,-3,1,0,1,-1,1,0,-2,4,2,2,2,4,-3,3,0,0,-10,-8,-3,-1,4,3,0,0,0,-1,0,-1,0,-1
KR_6634395036,420,-3,-17,8,-8,-6,7,1,1,2,3,3,1,4,-1,3,2,-5,5,0,0,-1,15,-4,-4,8,-4,0,-1,-1,1,-1,-1,1,-1
KR_6694793247,420,-4,-27,-24,-17,1,0,1,-3,4,1,0,3,3,-10,11,1,-5,8,3,0,-18,-9,-10,-1,11,0,0,-1,-1,-1,-1,-1,1,-1
KR_6759094123,420,0,2,-20,2,-4,6,2,1,2,3,-1,2,1,1,0,1,5,0,5,0,11,-8,7,-9,2,0,0,1,1,1,1,-1,1,-1
KR_6689735141,420,1,26,4,-5,1,0,1,-3,6,3,1,1,2,-5,8,3,1,1,2,0,-11,-2,-3,-5,8,-2,0,-2,-1,-1,-1,-1,2,-1
KR_6743076338,420,-2,-66,-4,-8,1,0,1,-3,4,1,1,1,2,-6,8,2,-1,1,0,0,-18,-74,-1,-5,6,0,0,1,-1,0,1,1,3,-1
KR_6681302670,440,1,26,15,4,0,1,1,1,4,5,0,0,0,0,1,1,3,0,3,0,7,-32,3,-5,2,0,0,0,-1,1,0,-1,6,-1
KR_6756140179,440,-4,-37,0,0,1,3,4,1,2,3,5,0,5,-7,8,1,0,3,3,-2,11,3,-6,-6,12,-1,0,-1,-1,1,-1,-1,5,-1
KR_6621677648,420,-1,16,-5,-2,1,2,3,-3,4,1,2,2,4,0,4,4,-2,2,0,0,0,3,1,-8,7,-3,0,-1,-1,-1,-1,1,3,-1
KR_6764711952,420,-3,-47,-16,-13,-7,7,0,0,2,2,-3,5,2,2,1,3,-5,5,0,-1,-9,0,3,-8,5,-3,0,0,-1,1,0,-1,2,-1
KR_6662113060,440,-4,-23,-14,-5,-2,2,0,-4,4,0,-4,4,0,2,1,3,3,0,3,0,-4,0,-3,-4,7,3,0,0,1,-1,-1,-1,5,-1
KR_6738375052,440,-1,22,-32,-1,0,1,1,-3,4,1,1,1,2,2,0,2,-1,1,0,0,-2,-8,7,-10,3,-3,0,0,-1,-1,0,-1,5,-1
KR_6722586403,440,-1,15,-27,3,1,1,2,2,2,4,-2,3,1,2,2,4,0,1,1,1,5,-33,-1,-1,2,-2,0,1,-1,1,1,1,3,-1
KR_6588535892,420,-3,-32,16,-11,2,3,5,-8,10,2,0,1,1,-4,5,1,-1,1,0,0,-16,2,2,-10,8,-4,0,-2,1,-1,-1,-1,1,-1
KR_6764174892,420,1,-5,-10,-5,0,0,0,1,2,3,-4,5,1,-3,4,1,1,1,2,0,-3,-84,6,-9,3,-3,0,0,-1,0,0,1,6,-1
KR_6758848700,420,-1,-15,-1,-6,-1,3,2,1,1,2,-9,9,0,3,1,4,0,2,2,1,-1,-6,2,-6,4,-2,0,-2,1,-1,-1,1,2,-1
KR_6684785548,420,1,-1,8,6,4,0,4,1,4,5,0,3,3,1,2,3,0,0,0,1,8,-131,-2,-2,4,1,0,1,-1,1,1,1,3,-1
KR_6536797978,420,-7,-92,-21,-17,-5,5,0,-6,6,0,-2,3,1,-3,6,3,-1,3,2,1,-29,-22,1,-5,4,12,0,-2,-1,1,-1,1,5,-1
KR_6670684916,420,-1,-34,-10,1,-1,2,1,2,1,3,0,1,1,4,0,4,-4,4,0,0,7,8,-1,-3,4,0,0,0,-1,-1,-1,-1,1,-1
KR_6698211394,420,0,-17,-8,0,-1,2,1,3,2,5,-2,3,1,0,2,2,0,1,1,0,-3,-1,0,-4,4,-2,0,1,1,-1,1,1,6,-1
KR_6734607664,420,-3,-66,-16,-4,3,1,4,0,3,3,0,0,0,-9,9,0,2,0,2,-1,-6,-34,-2,-6,8,-1,0,0,-1,1,-1,-1,4,-1
KR_6759924060,440,-3,-85,-12,-12,-3,4,1,-2,6,4,0,5,5,-5,8,3,-2,2,0,-2,-16,2,2,-4,2,-1,0,-1,0,1,-1,1,0,-1
KR_6756598395,420,-1,20,5,-12,2,2,4,-4,8,4,-5,5,0,-3,5,2,-2,3,1,0,-23,-3,1,-6,5,-4,0,0,-1,-1,1,-1,1,-1
KR_6742162768,420,-4,-72,-2,-8,-5,5,0,-1,2,1,-3,4,1,0,5,5,1,0,1,0,-8,78,-5,-5,10,-5,0,-2,-1,-1,-1,1,3,-1
KR_6724114745,420,-1,-36,-40,-4,2,0,2,-2,5,3,-3,4,1,-1,3,2,0,1,1,1,-7,105,-1,-3,4,3,0,-1,-1,1,-1,1,1,-1
KR_6670706998,420,-1,1,-20,-6,1,1,2,-4,5,1,5,0,5,-6,8,2,-2,2,0,0,-16,5,5,-11,6,-1,0,-3,1,-1,-1,-1,3,-1
KR_6725597393,420,-3,-54,-7,-14,-3,3,0,-4,7,3,-2,2,0,0,1,1,-5,5,0,-1,-13,2,-5,-2,7,-1,0,-4,-1,0,-1,-1,2,-1
KR_6653704293,420,1,-55,0,-5,1,2,3,-2,2,0,-2,2,0,-3,6,3,1,2,3,0,-4,1,-1,-3,4,0,0,0,-1,-1,0,-1,1,-1
KR_6750817730,420,1,-25,3,2,-1,3,2,1,1,2,2,1,3,-1,2,1,1,0,1,0,3,0,0,-6,6,1,0,1,-1,1,1,1,1,-1
KR_6755735838,440,0,-31,-28,6,-2,4,2,0,1,1,2,1,3,5,2,7,1,1,2,0,10,-1,-2,-3,5,2,0,0,0,1,-1,1,0,-1
KR_6745265890,420,-3,36,-23,-7,0,1,1,-4,5,1,-1,2,1,-2,3,1,0,0,0,0,-6,-44,0,-5,5,-2,0,1,1,-1,-1,-1,3,-1
KR_6685312101,420,-4,12,-40,-6,-2,5,3,-7,9,2,-2,4,2,-1,2,1,6,1,7,2,0,5,-2,-6,8,-3,0,0,1,-1,-1,1,2,-1
KR_6748728056,420,-2,-8,4,-8,0,1,1,-1,2,1,-3,5,2,-5,5,0,1,0,1,0,-13,-4,-1,-4,5,2,0,-2,-1,1,-1,-1,6,-1
KR_6756101318,440,-6,-128,0,-10,1,3,4,0,1,1,-5,6,1,-2,4,2,-4,4,0,0,-9,23,-3,-3,6,-16,0,-2,-1,-1,-1,-1,3,-1
KR_6765181760,440,-4,-51,-15,-7,-5,5,0,-5,5,0,6,0,6,-2,3,1,-1,3,2,0,-10,9,1,-3,2,-2,0,-1,0,-1,-1,-1,0,-1
KR_6725865407,420,0,-4,8,-3,-2,3,1,-1,3,2,0,1,1,-1,4,3,1,1,2,0,-4,-2,1,-4,3,2,0,0,1,-1,0,-1,2,-1
KR_6470946604,440,3,56,32,1,1,1,2,2,4,6,-1,1,0,1,5,6,-2,2,0,0,-10,55,3,-8,5,-18,0,0,-1,1,-1,-1,3,-1
KR_6581877412,420,-3,-7,-39,-6,1,2,3,-5,7,2,-6,8,2,4,0,4,0,0,0,0,-4,6,-1,-5,6,-1,0,-1,-1,1,-1,-1,5,-1
KR_6730728367,420,-1,87,19,-6,-6,6,0,-1,1,0,4,1,5,-3,3,0,0,1,1,0,-10,-5,-5,-4,9,2,0,-1,-1,-1,-1,1,6,-1
KR_6763312904,420,0,2,-4,2,-2,3,1,0,0,0,3,3,6,2,2,4,-1,3,2,1,3,-20,2,-6,4,3,0,0,0,0,0,1,0,-1
KR_6629484797,420,-3,-67,-1,-9,-1,2,1,-2,3,1,1,3,4,-8,10,2,1,2,3,0,-4,0,3,-5,2,-3,0,-2,-1,-1,-1,-1,1,-1
KR_6764688230,420,-6,-78,3,-18,-3,3,0,-2,3,1,-4,5,1,-3,6,3,-6,6,0,0,-7,96,-6,-2,8,2,0,-2,0,-1,-1,1,0,-1
KR_6756460646,420,3,54,19,7,-2,2,0,0,8,8,2,2,4,2,1,3,5,0,5,0,4,94,12,-14,2,9,0,2,1,1,1,-1,5,-1
KR_6651181431,420,-6,-16,-21,-8,-2,5,3,-5,5,0,1,0,1,-2,5,3,0,1,1,0,-11,-115,-2,-6,8,1,0,-1,-1,-1,-1,1,1,-1
KR_6763128727,440,0,67,-28,5,4,2,6,1,3,4,1,1,2,2,0,2,-3,3,0,0,2,3,1,-3,2,-2,0,0,-1,1,1,1,5,-1
KR_6765266009,420,-3,-7,-1,-8,-2,4,2,-2,2,0,-1,3,2,-3,4,1,0,0,0,0,-7,14,-2,-3,5,-4,0,0,-1,-1,0,-1,6,-1
KR_6763094557,440,-3,-18,33,-5,-1,3,2,-2,4,2,1,0,1,-3,5,2,0,0,0,0,-6,6,7,-12,5,-1,0,0,-1,0,0,-1,2,-1
KR_6744052276,420,-5,-131,-21,-5,-1,1,0,0,4,4,2,2,4,-2,3,1,-4,5,1,1,-6,-39,2,-6,4,1,0,-2,1,-1,-1,1,5,-1
KR_6717679132,420,-3,-50,8,-6,-1,2,1,1,1,2,-2,4,2,-2,3,1,-2,2,0,0,-4,-142,-4,-1,5,-1,0,0,-1,-1,0,-1,5,-1
KR_6738728915,420,-4,17,-28,-9,-1,1,0,-4,6,2,-4,6,2,-1,5,4,1,3,4,0,-10,-2,1,-4,3,-2,0,1,-1,1,1,-1,2,-1
KR_6759382179,420,0,-15,11,-5,1,1,2,-2,9,7,-2,3,1,-2,3,1,0,0,0,0,-12,-1,2,-8,6,0,0,1,1,1,1,1,2,-1
KR_6756414157,420,-9,-124,-40,-20,-8,9,1,-3,3,0,-4,5,1,-4,5,1,-1,1,0,0,-19,10,2,-5,3,-6,0,-2,-1,-1,-1,-1,6,-1
KR_6758466114,420,-4,-72,-16,-12,-2,2,0,-3,4,1,-2,2,0,-5,7,2,0,0,0,0,-11,-8,1,-2,1,-3,0,-3,-1,0,-1,-1,5,-1
KR_6721314430,420,0,-42,-13,-1,2,1,3,-5,5,0,1,1,2,-2,2,0,3,2,5,1,-8,66,1,-5,4,-15,0,-1,-1,1,-1,1,3,-1
KR_6751526802,420,-7,-57,-32,-15,-7,7,0,1,4,5,0,7,7,-8,13,5,-1,2,1,-1,-9,25,-5,-4,9,0,0,-1,-1,-1,-1,-1,6,-1
KR_6759032936,420,-4,-86,4,-13,-5,5,0,-5,6,1,-2,2,0,-1,2,1,0,1,1,0,-9,-3,-4,-2,6,0,0,-2,-1,0,-1,-1,6,-1
KR_6742135255,440,1,32,-19,2,-1,4,3,-1,2,1,3,1,4,-1,3,2,2,2,4,-2,-4,11,3,-5,2,-1,0,1,-1,-1,1,-1,2,-1
KR_6657984243,420,1,-10,28,9,2,1,3,1,1,2,-2,4,2,8,2,10,0,1,1,2,13,-2,0,-4,4,3,0,-1,1,1,-1,1,5,-1
KR_6761301118,440,-3,-50,-14,2,-2,3,1,0,4,4,-1,2,1,3,2,5,2,0,2,0,9,-4,1,-4,3,3,0,0,1,-1,-1,-1,5,-1
KR_5568935855,420,-3,-41,-17,-5,-1,2,1,0,4,4,-4,6,2,-2,2,0,2,1,3,-1,-1,188,4,-9,5,-5,0,0,1,-1,-1,-1,1,-1
KR_6748260055,420,-3,-38,-13,-5,0,2,2,-1,2,1,-1,1,0,-2,3,1,-1,1,0,0,-6,-35,1,-5,4,16,0,0,1,-1,1,-1,3,-1
KR_6751991715,420,-2,-48,7,0,-2,3,1,1,4,5,1,0,1,0,2,2,0,0,0,0,-2,16,0,-6,6,5,0,-1,1,0,-1,-1,1,-1
KR_6633495959,420,0,-4,36,0,2,2,4,0,1,1,-8,9,1,5,2,7,1,1,2,0,3,-30,2,-4,2,-1,0,1,1,1,1,1,2,-1
KR_6755442173,420,0,-9,-15,-1,0,1,1,-1,3,2,-5,7,2,5,3,8,0,0,0,0,1,-30,-6,-2,8,-15,0,0,-1,-1,-1,-1,6,-1
KR_6659818301,420,-4,-15,7,-10,-1,3,2,-1,1,0,1,1,2,-10,10,0,1,0,1,0,-11,98,-4,-3,7,-2,0,-1,-1,-1,-1,-1,5,-1
KR_6745708125,420,2,-19,-19,1,0,4,4,-2,5,3,2,2,4,0,2,2,1,1,2,0,7,7,0,-5,5,-3,0,-1,1,-1,-1,1,5,-1
KR_6700095236,420,-5,-32,-25,-11,1,2,3,0,3,3,-9,9,0,-3,4,1,0,2,2,0,-14,-7,5,-7,2,1,0,-3,1,-1,-1,1,2,-1
KR_6760055904,420,2,71,-24,-2,2,1,3,-2,4,2,-4,5,1,2,2,4,0,1,1,-1,0,6,4,-8,4,-2,0,2,-1,-1,1,-1,1,-1
KR_6764870285,420,-3,-89,-47,-7,-2,2,0,-7,7,0,-3,4,1,5,1,6,0,0,0,-3,-17,-32,2,-4,2,-3,0,-1,1,-1,-1,-1,5,-1
KR_6755408096,420,-2,7,13,-9,0,1,1,1,1,2,0,3,3,-8,8,0,-2,2,0,0,-8,165,-2,-7,9,-5,0,2,-1,1,1,-1,4,-1
KR_6491521820,420,-6,-32,-20,-13,-5,7,2,-6,7,1,-3,4,1,0,1,1,1,0,1,0,-13,1,-4,-4,8,-4,0,-1,-1,1,-1,1,1,-1
KR_6728391301,420,-2,18,-19,-5,1,0,1,-3,4,1,-7,8,1,4,2,6,0,1,1,2,0,-1,4,-8,4,1,0,0,-1,-1,1,1,3,-1
KR_6752868983,420,-1,-16,-62,-10,-2,2,0,-1,3,2,-1,2,1,-5,6,1,-1,1,0,-3,-13,114,-4,-3,7,1,0,0,-1,-1,0,-1,1,-1
KR_6762002765,440,-2,-65,6,2,4,0,4,-1,2,1,1,3,4,-2,2,0,0,0,0,0,8,275,3,-7,4,0,0,-1,-1,-1,-1,-1,5,-1
KR_6755069463,440,3,-30,3,5,1,0,1,-1,4,3,1,0,1,4,0,4,0,0,0,0,12,-15,-1,-8,9,2,0,1,-1,1,1,-1,1,-1
KR_6695149652,420,-3,-16,-5,-8,2,2,4,-2,4,2,-5,8,3,-1,6,5,-2,2,0,0,-7,-7,1,-6,5,-2,0,-2,-1,-1,-1,-1,4,-1
KR_6762064523,420,-2,-27,-4,-3,-1,2,1,3,4,7,0,4,4,-7,8,1,2,0,2,0,-3,2,-3,-2,5,0,0,-1,0,1,-1,-1,0,-1
KR_6763858482,420,3,23,-19,8,4,0,4,9,0,9,-3,6,3,-1,5,4,-1,2,1,0,5,32,2,-5,3,-1,0,1,1,1,1,1,4,-1
KR_6764542984,420,-5,-120,0,-5,-1,1,0,1,2,3,-5,5,0,1,2,3,-1,1,0,0,-7,0,-3,-3,6,4,0,-1,-1,1,-1,1,1,-1
KR_6745463440,420,-1,50,-9,-5,1,1,2,-3,5,2,-1,2,1,-3,4,1,1,0,1,0,-7,-164,0,-4,4,2,0,-1,1,-1,-1,-1,1,-1
KR_6755739661,440,-1,-50,-12,3,2,2,4,-2,2,0,0,1,1,3,0,3,0,0,0,0,4,7,2,-4,2,-2,0,0,1,0,0,-1,2,-1
KR_6605087071,420,-5,-31,-20,-8,-1,1,0,1,2,3,-4,6,2,-5,6,1,1,0,1,-1,-9,-163,0,-6,6,4,0,-2,-1,1,-1,-1,2,-1
KR_6757087877,420,-2,-33,-28,-5,4,1,5,-4,6,2,-1,1,0,-6,8,2,2,0,2,0,-12,0,-2,-6,8,-4,0,-1,-1,-1,-1,-1,6,-1
KR_6672242238,420,-3,-5,4,-3,2,0,2,-5,6,1,0,1,1,3,1,4,-3,3,0,0,-5,-16,0,-8,8,1,0,-1,1,-1,-1,-1,1,-1
KR_6762079258,420,-1,6,-5,3,1,4,5,1,4,5,-4,5,1,5,0,5,0,3,3,2,10,8,7,-11,4,-4,0,0,1,-1,0,1,6,-1
KR_6732651082,420,-4,-6,-1,-6,-3,4,1,-3,5,2,1,0,1,-3,8,5,2,0,2,0,-10,-6,-1,-4,5,-1,0,-1,-1,-1,-1,-1,6,-1
KR_6756880299,440,-1,36,12,-7,-3,6,3,0,0,0,0,6,6,-3,4,1,-1,1,0,0,-3,8,4,-11,7,0,0,2,0,0,1,-1,0,-1
KR_6629573841,420,-2,-78,6,-3,-1,2,1,0,4,4,-2,7,5,0,2,2,0,0,0,0,7,15,-2,-5,7,-5,0,-1,1,-1,-1,-1,4,-1
KR_6751703260,420,-6,-77,-12,-10,0,1,1,-3,5,2,-2,2,0,-1,2,1,-4,4,0,0,-3,5,-3,-2,5,-1,0,-1,-1,-1,-1,-1,5,-1
KR_6759634258,440,1,-68,0,7,-2,3,1,1,1,2,0,0,0,0,4,4,8,0,8,0,11,37,0,-3,3,-3,0,1,0,1,1,1,0,-1
KR_6711299551,420,-4,-62,-10,-8,-3,4,1,1,3,4,-4,5,1,-4,5,1,2,0,2,1,-5,-1,-4,-7,11,-4,0,-1,-1,1,-1,1,5,-1
KR_6747238063,440,-3,-33,-1,-4,-8,11,3,0,0,0,0,2,2,4,0,4,0,3,3,0,6,36,2,-3,1,-3,0,-3,-1,1,-1,-1,3,-1
KR_6760192627,440,-2,61,-31,-2,3,0,3,1,1,2,-2,5,3,-2,2,0,-2,2,0,0,-5,-4,6,-7,1,-4,0,0,1,0,0,-1,6,-1
KR_6765447507,420,4,47,21,6,-1,1,0,3,1,4,1,3,4,0,2,2,3,0,3,0,1,-173,-2,-2,4,-2,0,1,1,1,1,-1,6,-1
KR_6723555638,420,-4,-27,-23,-6,-4,4,0,-5,5,0,0,2,2,3,2,5,0,1,1,0,-5,-2,1,-8,7,-6,0,0,-1,1,1,-1,4,-1
KR_6751509828,420,-4,-79,-11,-8,3,0,3,-7,10,3,2,2,4,-4,10,6,-2,3,1,0,3,-29,0,-9,9,3,0,-3,-1,-1,-1,-1,6,-1
KR_6644421492,420,2,33,-16,0,-3,3,0,1,2,3,-1,2,1,4,2,6,-1,1,0,-2,13,2,3,-8,5,-2,0,-1,-1,-1,-1,-1,2,-1
KR_6759528384,420,-2,-53,6,-8,-3,4,1,-1,4,3,-5,5,0,1,1,2,0,1,1,0,-9,-3,0,-5,5,-3,0,0,-1,-1,-1,-1,4,-1
KR_6331825065,420,0,-28,0,-7,-1,1,0,-3,5,2,-2,2,0,1,2,3,-2,2,0,0,-4,0,-4,-4,8,0,0,0,0,-1,0,1,0,-1
KR_6613958994,420,0,30,0,-3,0,2,2,2,0,2,2,2,4,-6,8,2,-1,1,0,0,-4,-201,-3,-2,5,3,0,2,-1,-1,1,1,5,-1
KR_6465158144,420,-3,-2,-28,-10,3,0,3,-8,8,0,1,2,3,-4,6,2,-2,2,0,0,-14,-254,-5,-3,8,-5,0,-1,-1,-1,-1,1,6,-1
KR_6667035536,420,0,1,-45,-4,0,0,0,-3,7,4,-2,3,1,-1,5,4,2,0,2,-1,-10,-2,-2,-7,9,-2,0,-1,-1,-1,-1,-1,4,-1
KR_6741808103,420,-1,-38,20,3,-1,3,2,1,2,3,-3,4,1,6,0,6,0,0,0,1,-1,1,-1,-4,5,5,0,1,1,-1,1,1,5,-1
KR_6764543977,420,-1,28,-1,3,-1,2,1,3,0,3,4,2,6,-4,5,1,1,0,1,1,7,9,0,-4,4,-4,0,1,1,1,1,1,5,-1
KR_6696848893,420,-1,-23,-13,0,-5,7,2,2,4,6,4,3,7,-1,1,0,0,0,0,0,-2,-99,-1,-4,5,0,0,0,-1,-1,0,-1,3,-1
KR_6757931398,420,-3,1,-56,-9,-5,6,1,-5,5,0,-2,2,0,2,1,3,1,1,2,0,-4,27,-4,-4,8,-2,0,0,-1,-1,-1,1,3,-1
KR_6740672813,420,-5,-91,-4,-15,-3,5,2,0,3,3,-5,7,2,-5,6,1,-2,3,1,-3,-14,-13,-1,-3,4,1,0,-2,-1,-1,-1,1,4,-1
KR_6654066709,420,-5,-4,-25,-14,-1,2,1,-1,3,2,-6,7,1,-6,6,0,0,1,1,0,-11,-3,-3,-3,6,-2,0,0,-1,-1,-1,-1,5,-1
KR_6762770278,420,0,80,5,-2,3,0,3,-1,1,0,-1,1,0,-3,6,3,0,1,1,0,-5,-8,-2,-4,6,5,0,0,1,1,-1,-1,5,-1
KR_6753343194,420,-2,56,18,-1,-1,3,2,1,3,4,0,1,1,0,6,6,-1,2,1,3,5,-1,-1,-3,4,1,0,0,1,-1,1,1,2,-1
KR_6761938176,420,-1,-15,28,-5,1,0,1,-5,7,2,-4,8,4,2,0,2,1,0,1,0,-2,4,2,-5,3,2,0,1,1,1,1,-1,3,-1
KR_6749947977,420,-4,-111,8,-8,-1,2,1,-2,3,1,-1,2,1,-2,3,1,-2,2,0,0,-7,-7,-3,-4,7,2,0,-1,-1,1,-1,1,2,-1
KR_6763535593,420,-7,-155,-44,-13,2,0,2,-6,8,2,0,2,2,-4,5,1,-5,5,0,1,-18,-8,-2,-5,7,-19,0,-4,-1,-1,-1,1,4,-1
KR_6752247957,440,-1,-52,4,-1,-2,2,0,3,4,7,-2,5,3,0,0,0,0,0,0,0,8,5,-1,-6,7,5,0,0,-1,0,0,-1,6,-1
KR_6760085301,420,0,11,31,-6,-1,2,1,0,0,0,-4,4,0,0,4,4,-1,2,1,0,-12,-125,-2,-5,7,-3,0,1,-1,1,1,-1,1,-1
KR_6747124844,420,-1,25,5,2,-6,7,1,3,3,6,5,2,7,-1,2,1,1,0,1,0,11,32,0,-6,6,3,0,0,1,1,1,-1,1,-1
KR_6758067104,420,0,52,-8,1,0,0,0,2,2,4,-2,2,0,2,1,3,-1,2,1,0,6,6,2,-9,7,1,0,-1,-1,1,-1,1,3,-1
KR_6729034211,420,2,-28,11,7,0,3,3,1,4,5,4,1,5,2,2,4,0,1,1,1,11,-19,-6,-2,8,0,0,1,1,-1,1,1,5,-1
KR_6762769940,420,0,-11,0,1,4,0,4,1,2,3,2,1,3,-5,6,1,-1,3,2,0,3,1,1,-6,5,0,0,0,1,1,0,-1,6,-1
KR_6753706569,420,2,90,-1,-6,0,2,2,-2,2,0,3,1,4,-4,6,2,-3,6,3,0,-8,5,3,-4,1,2,0,0,0,-1,-1,-1,0,-1
KR_6761129459,420,3,71,-20,7,-1,2,1,-1,3,2,0,2,2,3,1,4,6,0,6,0,13,3,0,-4,4,3,0,1,1,0,1,1,2,-1
KR_6602102710,420,0,-3,3,-1,-2,4,2,1,3,4,4,0,4,-4,6,2,0,2,2,0,6,4,2,-7,5,-1,0,1,1,1,1,1,5,-1
KR_6761544417,420,-1,35,13,-4,-1,5,4,2,2,4,2,5,7,-4,5,1,-3,3,0,1,-9,10,-4,-3,7,4,0,0,0,-1,0,1,0,-1
KR_6608682849,420,-4,-46,-5,-4,-1,5,4,-1,5,4,-5,6,1,3,1,4,0,1,1,0,9,13,6,-8,2,2,0,-1,1,-1,-1,-1,4,-1
KR_6638217810,420,-5,-12,-30,-10,2,0,2,-4,6,2,-1,3,2,-4,9,5,-3,3,0,1,-7,-76,0,-6,6,-2,0,-1,0,0,-1,1,0,-1
KR_6757036441,420,0,28,-20,9,-2,3,1,5,0,5,3,3,6,3,2,5,0,0,0,1,15,6,1,-4,3,2,0,0,1,1,1,1,5,-1
KR_6600660787,420,0,-12,0,2,1,0,1,2,3,5,-3,5,2,0,4,4,2,1,3,0,14,-4,-1,-5,6,2,0,0,-1,1,0,1,3,-1
KR_6710806058,420,0,-82,-28,-1,-3,3,0,10,0,10,-4,5,1,-3,7,4,-1,1,0,-1,7,-2,0,-5,5,2,0,-1,-1,-1,-1,-1,2,-1
KR_6756047614,440,-3,-31,-13,-9,1,2,3,-2,2,0,-6,7,1,-3,3,0,1,1,2,0,-18,-11,-1,-4,5,2,0,0,1,0,0,-1,2,-1
KR_6634442236,420,-1,-57,18,-1,-6,6,0,2,2,4,2,3,5,1,2,3,0,2,2,0,4,-13,2,-7,5,0,0,0,-1,1,1,1,3,-1
KR_6660711593,420,3,56,-12,10,4,3,7,-1,3,2,-1,3,2,7,0,7,1,1,2,0,12,4,3,-6,3,-2,0,0,-1,-1,-1,-1,6,-1
KR_6754537525,420,-3,-25,-12,-4,-3,3,0,1,1,2,2,2,4,-2,4,2,-2,2,0,0,-5,-11,1,-5,4,5,0,0,1,1,1,-1,2,-1
KR_6759743855,440,2,-12,26,7,0,1,1,2,1,3,-3,4,1,5,0,5,3,0,3,0,7,-18,-5,-2,7,3,0,1,0,1,1,1,0,-1
KR_6760516802,420,-2,-37,0,-10,-3,4,1,-3,6,3,0,3,3,-1,3,2,-3,3,0,0,-19,-8,-2,-1,3,1,0,-1,-1,-1,-1,-1,3,-1
KR_6762195223,420,-2,-61,0,-6,-6,6,0,-1,4,3,0,3,3,1,0,1,0,1,1,0,-3,-65,-5,-1,6,17,0,-1,-1,1,-1,1,3,-1
KR_6747170800,420,3,15,14,4,3,1,4,-3,8,5,2,1,3,2,2,4,0,1,1,0,-3,-1,1,-6,5,4,0,-1,1,-1,1,-1,1,-1
KR_6742141099,420,-3,-91,8,-13,-3,4,1,-1,1,0,-2,4,2,-8,9,1,1,1,2,-1,-14,-14,-5,-3,8,-2,0,-1,-1,1,-1,-1,4,-1
KR_6570091023,420,-2,11,-18,-9,-2,2,0,-4,6,2,-3,4,1,0,1,1,0,1,1,0,-3,-2,0,-5,5,-3,0,0,0,-1,0,-1,0,-1
KR_6725422025,420,-2,-1,9,-8,-5,5,0,0,3,3,-2,3,1,0,2,2,-1,1,0,0,-8,9,0,-6,6,-4,0,-1,1,-1,-1,-1,2,-1
KR_6648000483,420,1,-22,12,5,1,1,2,2,2,4,0,2,2,2,1,3,0,0,0,0,4,4,-5,-3,8,7,0,0,1,1,0,1,1,-1
KR_6762523375,420,-2,-1,-23,-7,0,1,1,-2,2,0,-1,2,1,-1,1,0,-3,4,1,0,-7,0,0,-6,6,-4,0,0,-1,-1,0,-1,2,-1
KR_6568906791,440,-1,25,8,-4,-5,8,3,4,2,6,0,2,2,1,0,1,-4,8,4,1,-5,8,2,-6,4,-1,0,0,-1,-1,1,1,1,-1
KR_6763414781,420,-3,-75,30,-9,1,1,2,-4,4,0,-3,4,1,-2,3,1,-1,1,0,0,-9,-6,-3,-4,7,-3,0,0,-1,1,-1,1,5,-1
KR_6761352278,420,-5,-131,-38,-11,-2,2,0,-8,9,1,-2,2,0,1,1,2,0,0,0,0,-5,-375,-3,-4,7,-1,0,0,-1,0,0,1,5,-1
KR_6765088669,440,0,21,10,-5,-1,5,4,-1,1,0,1,1,2,-4,4,0,0,0,0,0,-9,2,-3,-4,7,1,0,0,-1,0,0,-1,3,-1
KR_6629097110,420,-4,-8,1,-5,0,2,2,-6,7,1,3,1,4,1,2,3,-3,3,0,0,0,4,3,-7,4,3,0,1,-1,1,1,-1,3,-1
KR_6718215289,420,-5,-10,-48,-13,-2,2,0,-4,6,2,-5,5,0,0,2,2,-2,2,0,0,-9,-4,-9,-2,11,0,0,0,-1,-1,-1,-1,5,-1
KR_6765493481,420,-3,5,-39,-9,2,0,2,-9,11,2,0,2,2,-2,3,1,0,1,1,0,-5,-10,-2,-6,8,-2,0,-1,-1,-1,-1,-1,6,-1
KR_6734601171,420,-2,31,-32,-5,-1,2,1,2,1,3,-7,7,0,2,3,5,-1,4,3,-1,0,-65,2,-8,6,4,0,0,1,0,0,-1,4,-1
KR_6760783476,420,-3,-9,-47,-6,0,4,4,-3,5,2,2,2,4,-1,3,2,-4,5,1,-2,-5,-12,-2,-5,7,1,0,-3,-1,-1,-1,-1,6,-1
KR_6663830335,420,-7,-24,-21,-8,0,3,3,-2,2,0,-6,6,0,1,2,3,-1,1,0,0,-15,-130,1,-4,3,-1,0,0,-1,1,1,1,4,-1
KR_6759235312,420,-3,-24,-8,-3,-5,5,0,-1,4,3,3,0,3,1,0,1,-1,2,1,0,-9,-6,-4,-3,7,1,0,0,0,-1,0,1,0,-1
KR_6640775382,440,-5,-71,-31,-6,-1,1,0,0,1,1,1,4,5,-6,8,2,0,0,0,0,-9,-39,-6,-2,8,3,0,-1,0,-1,-1,1,0,-1
KR_6644061850,420,-2,-5,-24,4,3,2,5,-2,4,2,0,3,3,2,2,4,1,0,1,1,5,-13,-3,-4,7,3,0,2,-1,1,1,1,4,-1
KR_6746174914,420,0,-20,9,-1,2,1,3,1,4,5,-3,4,1,-2,3,1,1,0,1,0,-5,-6,3,-6,3,-2,0,0,-1,1,1,-1,4,-1
KR_6744878780,420,-5,-102,-19,-6,-1,1,0,-2,4,2,3,1,4,-4,4,0,-2,3,1,0,-4,-9,-1,-2,3,-2,0,-1,-1,1,-1,-1,4,-1
KR_6671476475,420,-5,-116,5,-12,0,2,2,-1,4,3,-3,4,1,-6,6,0,-2,2,0,0,-20,6,2,-6,4,-5,0,0,1,1,-1,-1,3,-1
KR_6636551257,420,0,19,-28,-1,-4,4,0,1,3,4,0,1,1,0,1,1,2,0,2,0,1,-1,0,-7,7,0,0,-1,-1,-1,-1,1,5,-1
KR_6744466445,420,-2,-18,28,-2,0,1,1,1,2,3,-1,3,2,-3,6,3,1,0,1,0,2,-2,-2,-5,7,5,0,0,1,1,-1,-1,5,-1
KR_6746218822,420,1,11,16,-5,-1,2,1,2,1,3,-4,5,1,-2,4,2,0,0,0,0,-6,-103,2,-7,5,1,0,-2,-1,-1,-1,-1,3,-1
KR_6707528695,420,-2,-9,-5,-3,-4,5,1,-2,3,1,1,1,2,3,0,3,-1,2,1,1,-2,6,0,-6,6,-2,0,-2,1,-1,-1,1,5,-1
KR_6723366595,420,-1,23,-8,-4,0,1,1,0,2,2,0,3,3,-4,4,0,0,1,1,0,-6,-7,-6,-3,9,3,0,0,-1,-1,-1,-1,3,-1
KR_6753334669,440,1,-9,15,8,2,1,3,0,2,2,0,2,2,5,3,8,1,2,3,0,7,9,5,-8,3,-1,0,1,-1,1,1,1,2,-1
KR_6546081020,420,2,76,-12,0,7,0,7,2,3,5,-1,1,0,-1,4,3,-7,8,1,0,4,0,3,-7,4,-4,0,1,-1,1,1,-1,2,-1
KR_6752522231,420,2,32,-16,8,2,0,2,3,1,4,-3,4,1,4,1,5,2,0,2,0,9,10,0,-6,6,1,0,1,-1,0,1,1,6,-1
KR_6760832604,420,-2,-50,11,-10,-5,5,0,-3,4,1,-7,7,0,1,1,2,4,0,4,-1,-11,-18,-1,-5,6,0,0,-1,1,-1,-1,-1,6,-1
KR_6617852095,420,-3,-63,-9,-9,3,1,4,-6,7,1,-4,6,2,-4,7,3,2,0,2,0,-12,-75,1,-3,2,-3,0,-1,-1,-1,-1,1,5,-1
KR_6764897840,420,0,5,-24,-3,1,0,1,0,1,1,-1,2,1,-3,7,4,0,1,1,0,-8,-7,-1,-4,5,4,0,0,1,-1,0,1,4,-1
KR_6744168491,420,0,-64,35,2,0,1,1,-1,2,1,2,1,3,0,4,4,1,0,1,-1,6,-5,-4,-4,8,1,0,0,1,1,0,-1,4,-1
KR_6758491577,420,0,-12,11,3,-2,3,1,4,1,5,1,4,5,2,2,4,-2,3,1,-1,6,13,-2,-2,4,-2,0,0,1,-1,0,-1,3,-1
KR_6751286707,420,-1,-40,4,3,7,0,7,-1,2,1,-1,3,2,-5,7,2,3,1,4,0,-7,0,2,-5,3,1,0,0,-1,1,1,1,5,-1
KR_6763334685,420,-2,5,-5,-2,-1,2,1,-4,6,2,2,2,4,2,0,2,-1,1,0,0,-2,107,-3,-2,5,-3,0,-1,1,-1,-1,-1,4,-1
KR_6332093150,420,-6,-59,-60,-8,2,1,3,-4,7,3,0,4,4,-6,7,1,0,0,0,0,-9,-9,0,-3,3,-5,0,-1,-1,1,1,1,4,-1
KR_6747200142,420,-2,-8,16,-5,2,1,3,-4,5,1,1,0,1,-3,4,1,-1,1,0,1,-9,-3,-3,-4,7,-3,0,-1,-1,1,-1,1,5,-1
KR_6676375123,420,-2,16,-9,-9,-1,2,1,-2,2,0,-6,8,2,0,0,0,0,1,1,0,-10,-18,1,-6,5,4,0,2,-1,1,1,1,1,-1
KR_6761676800,420,-2,-9,-28,-3,-4,4,0,1,3,4,-4,5,1,0,3,3,4,0,4,1,-3,-29,-3,-4,7,3,0,1,-1,-1,1,1,2,-1
KR_6616823128,420,-2,-67,19,-9,-4,4,0,-1,3,2,-1,3,2,-2,5,3,-1,1,0,0,-6,-8,-5,-4,9,1,0,-1,-1,1,-1,-1,6,-1
KR_6756144335,420,0,78,8,4,3,2,5,3,1,4,-1,1,0,-2,5,3,1,1,2,0,-3,6,1,-4,3,2,0,0,-1,1,0,1,3,-1
KR_6762931224,420,0,41,7,-2,4,1,5,-4,6,2,-2,4,2,-1,4,3,1,2,3,0,-3,-32,0,-2,2,-1,0,-1,1,-1,-1,-1,1,-1
KR_6752120258,420,-5,-4,-13,-10,1,3,4,-5,6,1,1,0,1,-3,3,0,-4,4,0,0,-12,-9,0,-5,5,0,0,-1,1,-1,-1,-1,4,-1
KR_6722145802,420,-5,-69,-20,-15,-4,4,0,2,2,4,-4,4,0,-5,5,0,-4,5,1,0,-10,-25,-6,-2,8,-2,0,-3,-1,-1,-1,1,3,-1
KR_6765135593,420,-2,-45,-6,-5,-1,2,1,0,1,1,-1,2,1,-2,5,3,-1,1,0,0,-9,-6,-5,-3,8,1,0,-2,-1,-1,-1,-1,1,-1
KR_6615854306,420,-6,-89,21,-7,-5,5,0,0,0,0,3,1,4,-5,6,1,0,0,0,0,-4,-7,-2,-4,6,-6,0,-2,-1,-1,-1,-1,1,-1
KR_6737371230,420,3,68,-16,12,-4,5,1,5,1,6,2,0,2,5,1,6,4,0,4,0,13,10,5,-8,3,-2,0,0,1,1,1,1,6,-1
KR_6629898396,420,-5,-90,-16,-10,-6,6,0,0,2,2,2,1,3,-3,3,0,-3,3,0,0,-7,2,4,-7,3,-2,0,-3,1,-1,-1,1,6,-1
KR_6740315634,420,-2,-83,-9,3,-1,2,1,1,4,5,1,0,1,0,3,3,2,0,2,-1,14,0,-1,-5,6,3,0,0,1,-1,-1,-1,2,-1
KR_6723342479,420,1,-31,-23,-7,2,0,2,-4,4,0,-2,2,0,-3,8,5,0,1,1,-3,-8,2,1,-6,5,0,0,0,1,-1,0,-1,4,-1
KR_6748265424,420,-6,-9,3,-11,-2,3,1,-4,5,1,-3,3,0,-2,5,3,0,0,0,2,-5,-7,-7,-2,9,4,0,0,1,-1,0,1,2,-1
KR_6756857683,440,-4,-68,-19,-11,0,3,3,-4,5,1,1,0,1,-3,6,3,-5,5,0,0,-7,13,1,-6,5,3,0,-1,-1,1,-1,-1,1,-1
KR_6765338480,420,-3,-29,24,-6,1,2,3,-5,5,0,2,1,3,-3,7,4,-1,1,0,0,-11,-6,1,-5,4,-3,0,-1,-1,1,-1,-1,4,-1
KR_6751873847,420,-2,-71,-28,-3,0,1,1,-5,6,1,-1,4,3,1,2,3,2,1,3,-1,-3,-12,-1,-6,7,0,0,-2,-1,-1,-1,-1,6,-1
KR_6754176035,420,-5,-75,-1,-14,0,1,1,2,1,3,-8,9,1,-7,7,0,-1,1,0,0,-22,195,-6,-2,8,1,0,-2,-1,-1,-1,-1,4,-1
KR_6753297574,420,4,44,18,7,3,0,3,2,2,4,2,1,3,1,2,3,-1,2,1,0,7,158,3,-8,5,-2,0,0,1,1,0,1,1,-1
KR_6756163258,440,2,-21,24,1,2,0,2,0,1,1,-5,7,2,4,0,4,0,0,0,0,0,3,3,-8,5,2,0,0,1,-1,0,-1,4,-1
KR_6723072714,420,1,40,8,0,1,2,3,5,1,6,0,0,0,-5,5,0,-1,2,1,0,1,-17,-1,-5,6,3,0,-1,1,-1,-1,-1,4,-1
KR_6635035887,420,-1,-28,20,-5,-1,2,1,0,2,2,2,2,4,-4,7,3,-2,3,1,0,-6,0,3,-7,4,-6,0,-2,-1,1,-1,-1,4,-1
KR_6761749616,420,0,-27,-22,-11,-1,3,2,-3,5,2,-1,2,1,-6,7,1,0,1,1,0,-22,0,0,-8,8,-2,0,-1,-1,-1,-1,-1,3,-1
KR_6765142316,420,-3,5,-20,-4,-1,3,2,-6,8,2,2,1,3,0,3,3,1,1,2,0,-3,-11,-2,-2,4,0,0,0,-1,-1,-1,-1,6,-1
KR_6756995760,420,-2,-25,-16,-9,-6,6,0,0,0,0,-3,4,1,1,0,1,-1,1,0,0,-3,5,3,-5,2,-2,0,-1,-1,1,-1,-1,3,-1
KR_6682385329,420,2,11,8,6,1,2,3,1,1,2,1,1,2,3,1,4,0,0,0,0,8,-5,-1,-6,7,-3,0,0,-1,1,0,1,4,-1
KR_6764244496,420,-3,-73,-13,5,-5,5,0,2,1,3,3,1,4,7,0,7,-2,2,0,1,12,-2,0,-4,4,2,0,-3,-1,-1,-1,1,6,-1
KR_6734152596,440,-2,-59,-4,-10,-2,4,2,-3,4,1,-2,4,2,-6,7,1,3,0,3,0,-16,-2,4,-8,4,0,0,0,-1,1,0,-1,6,-1
KR_6752601675,440,0,2,-16,-1,-4,4,0,3,2,5,-3,4,1,1,2,3,2,0,2,-1,5,-6,-3,-4,7,10,0,1,-1,1,1,-1,1,-1
KR_6700097829,420,-5,-9,-23,-12,-1,1,0,-4,5,1,0,1,1,-5,5,0,-2,2,0,0,-13,29,1,-5,4,-6,0,-2,-1,-1,-1,-1,3,-1
KR_6763884219,420,-6,-81,-29,-16,-1,4,3,-7,8,1,-6,6,0,-1,1,0,-1,2,1,-1,-13,-14,2,-6,4,-4,0,-1,-1,0,-1,-1,4,-1
KR_6765237133,420,-4,-33,27,-11,-1,2,1,0,1,1,-9,9,0,1,2,3,-2,2,0,0,-9,15,-1,-7,8,-5,0,-2,-1,-1,-1,-1,6,-1
KR_6692536140,420,1,19,16,-2,4,1,5,1,4,5,-8,9,1,1,2,3,0,0,0,0,-4,-11,-6,-2,8,7,0,3,1,0,1,1,4,-1
KR_6640185787,420,-3,-33,-11,-5,-3,5,2,-1,4,3,1,2,3,-3,5,2,1,2,3,-1,-4,6,7,-8,1,-4,0,-1,-1,1,1,-1,5,-1
KR_6763509424,420,-1,-36,-16,-4,-2,4,2,-5,6,1,-1,4,3,5,3,8,-1,1,0,0,-6,1,-4,-5,9,0,0,0,1,1,1,-1,3,-1
KR_6496852389,420,-3,-34,-12,-10,1,1,2,-3,6,3,-2,3,1,-5,5,0,-1,1,0,0,-12,-2,1,-7,6,-1,0,-1,-1,-1,-1,-1,5,-1
KR_6628499816,440,2,6,0,-6,-6,6,0,-3,4,1,-2,2,0,3,0,3,2,1,3,0,3,9,1,-4,3,1,0,0,1,-1,-1,-1,2,-1
KR_6756480280,420,0,-7,-17,6,6,0,6,-1,6,5,-1,2,1,2,3,5,0,0,0,0,8,-17,3,-8,5,-2,0,1,1,0,1,1,2,-1
KR_6696047173,420,-5,-38,-23,-11,-1,3,2,-5,5,0,-1,1,0,-3,3,0,-1,1,0,0,-16,1,-1,-4,5,1,0,-1,-1,-1,-1,-1,4,-1
KR_6678229707,420,-5,-15,8,-4,-3,3,0,-3,3,0,-1,3,2,2,3,5,1,0,1,0,-4,1,2,-6,4,-4,0,-1,-1,-1,-1,-1,1,-1
KR_6709798246,420,-1,-53,-4,4,-1,2,1,4,7,11,3,1,4,0,6,6,-2,2,0,2,6,-21,0,-5,5,-5,0,-1,-1,1,-1,1,3,-1
KR_6675152183,420,-1,-3,-19,2,-1,3,2,5,2,7,1,1,2,-2,4,2,-1,2,1,0,11,9,4,-6,2,-2,0,0,-1,0,0,1,3,-1
KR_6700158451,420,-1,-11,-17,5,-3,3,0,2,1,3,-1,2,1,4,1,5,3,0,3,0,10,-5,-3,-6,9,3,0,-1,1,-1,1,1,1,-1
KR_6724576026,420,-7,-48,-28,-9,0,1,1,-5,5,0,2,2,4,-4,4,0,-2,3,1,-2,-6,3,-3,-3,6,-1,0,-1,-1,-1,-1,-1,3,-1
KR_6743071292,420,-4,-9,-39,-7,0,2,2,-2,4,2,-1,3,2,0,1,1,-4,4,0,0,-3,-22,2,-7,5,-3,0,0,-1,-1,-1,-1,5,-1
KR_6762466625,420,-1,-1,-17,-1,0,1,1,4,3,7,-2,2,0,-2,3,1,-1,1,0,0,-4,55,6,-7,1,-33,0,0,1,1,0,-1,5,-1
KR_6676930905,420,1,-9,-7,0,0,1,1,-4,5,1,2,1,3,5,3,8,-3,3,0,-1,2,-1,-2,-3,5,4,0,0,1,1,0,-1,6,-1
KR_6642884668,420,-2,-81,-40,-7,-1,2,1,-1,1,0,1,3,4,-4,4,0,-2,3,1,0,-2,-10,-7,-3,10,3,0,-1,-1,-1,-1,1,6,-1
KR_6564019636,420,2,67,-11,-3,0,1,1,-4,7,3,0,3,3,2,2,4,-1,2,1,0,-10,-59,0,-7,7,4,0,-1,1,-1,-1,-1,2,-1
KR_6761681338,440,-4,45,-10,-8,3,0,3,-6,6,0,3,3,6,-8,11,3,0,1,1,0,-16,2,3,-9,6,-4,0,0,1,-1,-1,1,4,-1
KR_6762137424,420,1,-7,20,3,4,0,4,-1,2,1,-1,1,0,-1,1,0,2,0,2,0,-4,-40,-5,-4,9,3,0,0,1,-1,0,1,4,-1
KR_6687898708,420,-5,-116,-6,-10,-2,2,0,4,3,7,-5,7,2,-6,9,3,-1,2,1,0,-6,-3,5,-10,5,-3,0,-3,-1,1,-1,-1,1,-1
KR_6724995023,420,-4,-33,12,-10,-2,3,1,-7,10,3,0,3,3,-3,4,1,2,1,3,0,-15,-29,0,-7,7,-3,0,-2,-1,-1,-1,-1,4,-1
KR_6730835422,420,2,-47,28,7,-1,2,1,4,1,5,1,2,3,-1,2,1,4,0,4,0,9,118,-2,-3,5,1,0,1,1,1,1,1,5,-1
KR_6764258677,420,0,63,8,-4,-4,5,1,-3,5,2,1,3,4,3,1,4,-1,3,2,1,-9,6,0,-6,6,-5,0,1,-1,-1,1,1,6,-1
KR_6750153025,420,-2,-15,-38,-5,0,1,1,-4,4,0,1,5,6,-6,6,0,4,3,7,0,5,0,-3,-4,7,-3,0,0,1,-1,0,1,5,-1
KR_6642072920,420,1,0,28,0,-1,3,2,3,4,7,2,0,2,-4,6,2,0,2,2,-1,4,-258,-2,-1,3,0,0,-1,-1,1,-1,-1,3,-1
KR_6763908026,420,3,92,-32,8,2,1,3,0,7,7,2,3,5,6,1,7,-2,3,1,2,4,-198,3,-8,5,4,0,1,-1,1,1,1,4,-1
KR_6734470254,420,1,7,-27,6,1,1,2,5,2,7,-2,4,2,-1,4,3,3,1,4,0,0,-1,0,-5,5,-2,0,2,1,1,1,1,4,-1
KR_6731822040,420,0,-67,-4,-2,0,3,3,0,6,6,1,2,3,-2,5,3,-1,2,1,0,3,2,-1,-5,6,-1,0,-2,-1,-1,-1,-1,2,-1
KR_6757144411,420,-2,-23,-20,-6,-3,3,0,4,0,4,1,2,3,-6,6,0,-2,2,0,0,-5,-1,-7,-5,12,1,0,0,-1,1,0,-1,2,-1
KR_6729273445,420,-1,32,-2,-4,1,1,2,-2,3,1,3,1,4,-7,10,3,1,0,1,0,-12,52,-2,-8,10,0,0,2,-1,1,1,-1,4,-1
KR_6734712603,420,2,21,16,3,0,2,2,2,3,5,-3,3,0,3,3,6,1,2,3,0,8,-299,-2,-8,10,-1,0,0,-1,1,0,1,2,-1
KR_6717508132,420,-2,-52,-2,-4,-6,8,2,1,2,3,1,1,2,1,2,3,-1,2,1,0,-3,5,2,-6,4,-5,0,-3,1,-1,-1,-1,3,-1
KR_6727268541,420,0,-26,-52,8,1,0,1,8,2,10,1,1,2,0,2,2,-2,3,1,0,3,-5,0,-3,3,0,0,2,-1,1,1,1,3,-1
KR_6752234828,420,-1,-58,10,0,-5,6,1,1,1,2,1,2,3,4,0,4,-1,1,0,0,13,-8,7,-10,3,5,0,0,1,0,1,-1,1,-1
KR_6750509238,440,-4,-74,-33,4,4,0,4,0,0,0,6,1,7,-1,1,0,-5,5,0,0,9,4,3,-7,4,-1,0,0,0,0,0,1,0,-1
KR_6759512437,420,-4,-91,-4,-12,-2,5,3,-10,13,3,1,2,3,-2,8,6,1,0,1,-3,-12,3,-1,-4,5,-2,0,-3,-1,-1,-1,-1,2,-1
KR_6750575252,420,-3,-22,-39,0,-1,2,1,3,2,5,0,2,2,-2,5,3,0,0,0,0,0,-3,0,-4,4,-1,0,-2,1,1,-1,1,6,-1
KR_6760732523,420,1,44,-16,7,0,1,1,1,1,2,0,1,1,6,1,7,0,1,1,0,12,-14,2,-5,3,4,0,1,1,-1,1,-1,2,-1
KR_6762436972,420,-2,-36,36,-9,-3,5,2,2,2,4,-5,5,0,-3,5,2,0,1,1,1,-18,4,-2,-6,8,0,0,-3,-1,-1,-1,1,4,-1
KR_6714736969,420,-2,-69,11,-6,2,1,3,-1,4,3,-4,5,1,-5,7,2,2,0,2,0,-3,6,1,-7,6,-5,0,-1,-1,-1,-1,1,4,-1
KR_6758988293,420,-4,-56,-22,-8,0,1,1,-2,3,1,-1,4,3,-2,2,0,-3,3,0,0,-13,-41,2,-6,4,0,0,0,-1,1,1,-1,5,-1
KR_6667101767,420,1,16,10,3,-2,3,1,1,3,4,-2,3,1,4,1,5,2,0,2,1,10,6,3,-8,5,1,0,0,-1,-1,0,1,3,-1
KR_6688044914,420,-10,-140,-38,-17,-3,3,0,-4,6,2,-6,8,2,-3,3,0,-1,1,0,0,-12,12,-3,-2,5,-3,0,-2,-1,-1,-1,1,1,-1
KR_6696789817,420,-3,-85,10,-9,-2,3,1,-5,6,1,0,1,1,-3,3,0,1,1,2,0,-16,-3,1,-3,2,-2,0,-2,-1,1,-1,-1,1,-1
KR_6612183903,440,-3,-25,-16,-8,-3,6,3,-2,2,0,1,1,2,-3,5,2,-1,1,0,0,-3,24,-2,-4,6,-2,0,-1,1,0,-1,-1,5,-1
KR_6761297076,420,3,17,8,6,1,1,2,-2,4,2,4,0,4,3,0,3,0,2,2,0,5,-13,2,-5,3,3,0,1,1,1,1,-1,4,-1
KR_6646911841,420,3,-47,16,6,3,0,3,1,2,3,2,1,3,-2,4,2,2,1,3,0,0,2,-3,-5,8,-7,0,0,1,1,0,1,4,-1
KR_6654119738,420,-6,-40,-16,-15,-3,4,1,-8,10,2,-4,5,1,0,1,1,0,0,0,0,-27,-2,0,-7,7,-3,0,-2,-1,-1,-1,-1,2,-1
KR_6745709712,420,-3,-68,-1,-5,-5,5,0,2,1,3,0,0,0,-2,2,0,0,1,1,0,-3,-46,-3,-5,8,-2,0,-1,-1,-1,-1,-1,3,-1
KR_6764021543,420,2,5,21,-7,5,0,5,0,0,0,-6,7,1,-2,3,1,-4,4,0,0,-12,-16,-4,-2,6,0,0,1,-1,1,-1,1,1,-1
KR_6762359937,440,-1,-91,4,-8,-3,4,1,-2,3,1,0,2,2,-3,3,0,0,2,2,-1,-6,5,-1,0,1,0,0,1,-1,-1,1,-1,1,-1
KR_6751411013,440,1,26,0,-6,-1,1,0,-2,6,4,-1,3,2,-2,7,5,0,0,0,0,-12,-4,1,-5,4,-4,0,0,-1,-1,0,-1,6,-1
KR_6683769927,420,0,-40,-4,-5,-2,3,1,6,1,7,-4,4,0,-4,4,0,-1,1,0,0,-12,-119,0,-2,2,-5,0,-1,-1,1,-1,-1,6,-1
KR_6764940211,440,-1,-64,4,0,-2,4,2,6,2,8,-3,4,1,0,3,3,-1,2,1,0,0,0,0,-6,6,0,0,-1,-1,1,-1,-1,1,-1
KR_6753883077,420,0,40,-23,-4,1,2,3,-3,7,4,-2,2,0,0,3,3,0,1,1,0,-6,-34,2,-4,2,1,0,1,-1,-1,1,1,6,-1
KR_6669375493,420,0,1,-9,3,0,1,1,5,3,8,1,2,3,-3,6,3,0,1,1,0,5,46,-1,-4,5,2,0,0,1,1,1,1,5,-1
KR_6602141674,420,-1,0,0,-2,-3,3,0,1,3,4,3,2,5,-3,4,1,0,1,1,0,0,7,-2,-6,8,3,0,-1,-1,1,-1,-1,2,-1
KR_6742961498,420,-4,-21,-33,-4,-2,3,1,-2,2,0,0,2,2,1,4,5,-1,1,0,0,-3,20,0,-4,4,2,0,-1,-1,-1,-1,-1,4,-1
KR_6675434700,420,-1,22,3,-7,2,3,5,1,2,3,-1,3,2,-10,10,0,1,0,1,-1,-8,1,-2,-3,5,-2,0,0,-1,1,1,-1,2,-1
KR_6750469174,420,-3,-71,-23,-8,1,2,3,-4,6,2,-3,6,3,1,3,4,-3,4,1,0,7,116,1,-3,2,-1,0,-1,-1,-1,-1,-1,6,-1
KR_6756345417,420,-3,2,-10,-4,-4,5,1,3,3,6,-1,3,2,0,3,3,-2,2,0,3,11,-6,-1,-7,8,-1,0,-1,1,-1,-1,1,3,-1
KR_6765167936,420,-2,-38,12,-10,-3,3,0,-3,5,2,-2,6,4,-2,2,0,0,4,4,0,-13,-40,-1,-3,4,3,0,0,1,-1,-1,-1,1,-1
KR_6752470909,420,0,19,36,-7,-4,4,0,1,1,2,0,1,1,-5,6,1,1,0,1,-1,-10,-3,-1,-1,2,-1,0,-1,-1,-1,-1,-1,2,-1
KR_6759235900,420,-4,-32,-16,-16,-5,5,0,-3,6,3,-6,7,1,-1,1,0,-1,1,0,0,-7,-4,1,-5,4,-3,0,0,-1,-1,0,-1,5,-1
KR_6752914571,420,1,-6,-12,1,-1,3,2,2,4,6,1,1,2,-1,2,1,0,4,4,1,8,-13,0,-6,6,-5,0,-1,1,-1,-1,1,1,-1
KR_6764254629,420,1,1,15,6,0,2,2,2,2,4,4,1,5,1,2,3,-1,1,0,0,12,8,-1,-6,7,1,0,1,1,1,1,1,3,-1
KR_6709073309,420,-5,-24,10,-15,0,0,0,-10,10,0,-2,2,0,1,1,2,-4,4,0,0,-16,-8,-3,-4,7,-3,0,-1,-1,-1,-1,-1,3,-1
KR_6762801219,420,-4,-33,-12,-12,-3,3,0,-2,7,5,-2,3,1,-4,5,1,-1,2,1,0,-3,37,-3,-3,6,0,0,-2,-1,-1,-1,-1,3,-1
KR_6753899087,420,0,63,-17,1,0,2,2,-7,8,1,-1,3,2,6,3,9,3,1,4,0,6,4,3,-8,5,-1,0,0,-1,1,1,-1,4,-1
KR_6712540753,420,-6,-47,-24,-17,-2,2,0,-5,5,0,-8,8,0,-1,5,4,-1,4,3,0,-21,0,-1,-7,8,-5,0,-1,-1,1,-1,-1,5,-1
KR_6741371226,420,-5,-80,-9,-10,1,1,2,0,3,3,-7,7,0,-3,6,3,-1,2,1,0,-16,7,5,-8,3,3,0,-2,-1,-1,-1,-1,2,-1
KR_6764173865,420,-2,-21,22,-2,-5,5,0,2,1,3,-2,2,0,4,2,6,-1,3,2,0,5,-243,1,-4,3,2,0,-2,1,-1,-1,-1,4,-1
KR_6728209976,420,-2,-53,-8,-4,1,1,2,1,1,2,0,1,1,-6,6,0,0,0,0,-1,-9,18,-5,-3,8,-4,0,-2,-1,-1,-1,-1,5,-1
KR_6684674270,420,-2,-59,-26,-1,0,2,2,1,3,4,0,2,2,-3,6,3,1,1,2,0,-2,80,4,-8,4,1,0,-1,1,-1,-1,1,2,-1
KR_6759572010,420,-5,-85,-20,-4,-4,4,0,-1,2,1,2,0,2,-1,2,1,0,0,0,0,2,-330,1,-5,4,-3,0,0,-1,1,0,-1,3,-1
KR_6750095906,420,-2,3,-9,-1,2,3,5,-2,4,2,4,2,6,-2,3,1,-3,3,0,0,5,-6,-1,-3,4,0,0,-1,-1,0,-1,1,6,-1
KR_6765410196,420,1,-8,16,5,7,0,7,-1,2,1,-3,4,1,2,1,3,0,0,0,0,3,-8,-2,-2,4,1,0,-1,-1,-1,-1,1,2,-1
KR_6635169189,420,0,56,-12,2,-1,1,0,2,2,4,1,2,3,0,0,0,0,0,0,0,6,-30,5,-8,3,1,0,-1,1,-1,-1,1,4,-1
KR_6749700270,420,0,-14,-16,-2,0,3,3,-1,4,3,0,2,2,0,0,0,-1,1,0,0,-7,5,-1,-4,5,1,0,-2,1,-1,-1,-1,6,-1
KR_6729016472,420,-2,3,8,-6,0,2,2,-4,7,3,0,0,0,-1,3,2,-1,1,0,0,-10,35,1,-4,3,-5,0,0,-1,1,0,-1,6,-1
KR_6638359307,420,2,-36,-11,1,-2,5,3,-1,3,2,2,0,2,1,2,3,1,0,1,-1,6,11,1,-5,4,-2,0,0,-1,-1,0,-1,3,-1
KR_6703576103,420,1,-45,9,5,0,1,1,2,1,3,1,1,2,2,2,4,0,0,0,1,4,0,1,-4,3,2,0,-2,1,-1,1,1,4,-1
KR_6758000093,420,2,68,20,0,3,1,4,3,1,4,-7,8,1,-1,2,1,2,0,2,1,2,-3,0,-5,5,5,0,1,-1,1,1,1,5,-1
KR_6760629768,420,-3,-37,-28,-1,0,1,1,-4,7,3,-3,4,1,0,3,3,6,0,6,0,-2,56,6,-10,4,-3,0,1,1,0,1,1,2,-1
KR_6741886335,420,-3,-31,15,-7,-4,4,0,0,2,2,-4,7,3,0,3,3,1,0,1,0,-5,-2,-8,-1,9,-3,0,0,-1,-1,0,-1,4,-1
KR_6645102659,420,-1,39,1,3,3,2,5,5,0,5,-3,5,2,-1,5,4,-1,1,0,1,3,-5,5,-6,1,-1,0,1,1,1,1,1,6,-1
KR_6731381068,420,-3,-13,-39,-4,-3,4,1,-2,3,1,2,4,6,0,3,3,-1,2,1,0,9,34,-1,-6,7,-2,0,-2,1,-1,-1,-1,3,-1
KR_6641280537,420,-2,-40,24,-5,0,3,3,0,3,3,-4,5,1,-1,3,2,0,0,0,0,-7,-123,3,-6,3,-5,0,-1,-1,-1,-1,-1,5,-1
KR_6724980769,420,-1,-53,-6,5,4,2,6,-2,4,2,0,2,2,3,1,4,0,1,1,0,7,-33,2,-8,6,24,0,0,-1,1,1,-1,5,-1
KR_6762995147,420,-2,-3,-32,-2,1,1,2,-2,2,0,3,0,3,-4,6,2,0,0,0,0,-4,-23,1,-9,8,-2,0,-1,1,-1,-1,1,5,-1
KR_6763381991,420,-6,-116,-29,-15,-2,2,0,-6,7,1,-4,4,0,-2,6,4,-1,1,0,0,-7,4,2,-5,3,-6,0,-1,0,-1,-1,-1,0,-1
KR_6676344436,420,-1,-54,-22,-1,0,1,1,0,4,4,1,2,3,-1,2,1,-1,2,1,0,-2,-22,0,-5,5,1,0,-1,-1,-1,-1,1,3,-1
KR_6691299212,420,-2,-31,-53,-3,2,1,3,1,1,2,-4,7,3,0,0,0,-2,2,0,0,1,-33,-3,-3,6,-1,0,-1,-1,-1,-1,-1,2,-1
KR_6755481999,420,-3,-9,11,-8,3,0,3,1,1,2,-5,6,1,-6,6,0,-1,1,0,0,-13,-8,0,-3,3,-1,0,-1,1,-1,-1,1,3,-1
KR_6688453857,420,0,-2,-4,3,2,2,4,2,1,3,4,1,5,-4,5,1,-1,1,0,0,1,-6,0,-4,4,4,0,0,-1,-1,-1,-1,6,-1
KR_6763381662,420,-1,-26,-7,-4,2,2,4,-4,6,2,0,3,3,-3,5,2,1,2,3,0,-7,-3,-5,-2,7,1,0,1,-1,1,1,1,6,-1
KR_6718425896,420,-3,-10,11,-3,-1,3,2,-2,3,1,-1,3,2,0,2,2,1,0,1,0,1,-5,0,-7,7,3,0,-1,1,-1,-1,1,5,-1
KR_6756029136,420,2,-6,12,4,-1,2,1,1,2,3,5,1,6,-1,2,1,0,1,1,0,-1,-7,-1,-5,6,0,0,1,1,1,1,1,5,-1
KR_6496723408,420,-1,-18,-3,-1,-5,6,1,-2,3,1,-1,2,1,6,1,7,1,0,1,-1,3,10,6,-12,6,4,0,-1,1,-1,-1,-1,6,-1
KR_6754184379,420,-1,-30,16,-1,1,0,1,0,0,0,-4,7,3,-1,2,1,3,0,3,0,-7,56,-1,-2,3,3,0,0,1,1,1,1,5,-1
KR_6679791438,420,-6,-59,-28,-16,-2,5,3,-6,7,1,-2,6,4,-4,5,1,-2,4,2,1,-9,-15,-6,-1,7,4,0,-1,-1,1,-1,1,6,-1
KR_6763248951,420,-1,-21,-4,5,2,1,3,0,3,3,-3,5,2,7,0,7,-1,2,1,0,4,-18,0,-5,5,20,0,-1,1,-1,-1,1,4,-1
KR_6765020549,420,0,-9,23,-4,-3,3,0,-5,7,2,3,1,4,1,4,5,0,1,1,0,-5,-6,4,-6,2,-1,0,-1,-1,-1,-1,1,4,-1
KR_6752113001,420,-3,-46,13,-6,2,0,2,1,1,2,-7,8,1,-1,3,2,-1,2,1,0,-3,37,1,-4,3,-4,0,0,1,-1,-1,-1,6,-1
KR_6656629791,420,-4,-60,-44,-12,-2,4,2,-1,3,2,-4,8,4,-3,7,4,-2,3,1,0,-6,-21,-3,-6,9,3,0,-4,-1,-1,-1,-1,3,-1
KR_6762587234,440,-6,-47,-36,-6,-2,3,1,-1,1,0,-1,3,2,2,2,4,-4,4,0,0,-7,-2,-1,-6,7,6,0,-1,-1,-1,-1,-1,1,-1
KR_6617638888,420,-11,-94,-49,-21,-9,9,0,-1,1,0,-6,6,0,-4,7,3,-1,1,0,0,-15,-13,4,-5,1,-3,0,-3,-1,-1,-1,-1,6,-1
KR_6698396777,420,1,-33,10,-2,-3,4,1,2,1,3,-1,3,2,0,4,4,0,0,0,0,-4,-1,-3,-3,6,2,0,0,-1,0,1,-1,5,-1
KR_6762268390,420,1,-4,27,-3,-4,6,2,0,3,3,1,3,4,-2,8,6,2,0,2,0,-7,41,2,-6,4,-2,0,1,-1,1,1,1,1,-1
KR_6615660052,420,1,-11,2,5,3,0,3,0,4,4,-2,4,2,2,1,3,2,0,2,0,5,-5,-2,-4,6,-4,0,0,-1,0,0,1,1,-1
KR_6728147470,420,-1,-10,-2,-3,3,0,3,-2,5,3,0,1,1,-2,3,1,-2,2,0,1,3,12,-1,-4,5,-6,0,-1,-1,-1,-1,1,4,-1
KR_6694070486,420,-5,-122,-3,-3,-2,5,3,-1,6,5,1,2,3,-2,7,5,1,2,3,0,-1,-23,-3,-6,9,-11,0,-2,-1,-1,-1,-1,4,-1
KR_6764882801,420,-3,-1,-24,-7,4,0,4,-4,4,0,-6,7,1,-2,4,2,1,0,1,1,-4,-261,1,-4,3,-6,0,-1,-1,-1,-1,1,6,-1
KR_6743900874,420,-3,-21,-11,0,0,1,1,-1,4,3,-1,2,1,1,2,3,1,1,2,0,0,-8,-2,-6,8,2,0,0,-1,-1,0,-1,5,-1
KR_6621534960,420,4,20,28,-1,-1,1,0,-3,9,6,-2,4,2,3,0,3,2,0,2,-1,1,2,-1,-4,5,1,0,0,-1,-1,-1,-1,2,-1
KR_6759495882,420,1,48,-5,0,2,1,3,-4,5,1,-1,5,4,2,3,5,1,0,1,-1,-11,5,3,-6,3,2,0,1,-1,1,1,-1,2,-1
KR_6747627050,420,0,9,16,1,-1,2,1,5,1,6,-2,3,1,1,5,6,-2,2,0,0,-6,7,5,-6,1,-4,0,2,0,1,1,1,0,-1
KR_6604771180,420,-1,-20,-20,-4,3,1,4,-3,7,4,-5,5,0,-1,5,4,2,2,4,0,-12,1,-2,-6,8,-2,0,1,-1,-1,1,-1,2,-1
KR_6760989608,420,-1,-49,29,-1,3,1,4,-1,3,2,3,4,7,-3,6,3,-3,4,1,0,-8,-5,-1,-6,7,-6,0,-1,1,1,-1,1,6,-1
KR_6718484538,420,-4,-52,-2,-9,-3,4,1,-2,6,4,-2,4,2,1,0,1,-3,4,1,1,0,-10,3,-6,3,-2,0,0,-1,-1,-1,1,4,-1
KR_6691765042,420,2,-17,7,4,1,0,1,-2,4,2,1,1,2,4,1,5,0,0,0,0,3,7,-2,-5,7,-4,0,0,1,-1,0,-1,4,-1
KR_6701344913,420,-4,-25,5,-7,0,2,2,-4,4,0,1,2,3,-2,2,0,-2,2,0,0,-13,-4,0,-4,4,0,0,-1,-1,-1,-1,1,4,-1
KR_6760430675,420,-2,-22,-13,-2,-4,5,1,-1,3,2,0,3,3,2,2,4,1,3,4,0,9,-8,-3,-4,7,0,0,-3,-1,-1,-1,1,5,-1
KR_6678215147,420,-1,35,-36,-1,-1,3,2,2,2,4,-1,2,1,-1,3,2,0,0,0,0,1,0,2,-7,5,-3,0,0,-1,-1,0,-1,6,-1
KR_6643613293,420,-5,-56,-22,-18,-6,7,1,-3,4,1,-8,8,0,-2,2,0,1,0,1,-1,-26,5,1,-4,3,-2,0,-1,-1,-1,-1,-1,1,-1
KR_6677256219,420,1,50,24,7,3,1,4,1,4,5,1,0,1,0,4,4,2,0,2,0,5,-3,2,-6,4,6,0,1,-1,0,1,1,2,-1
KR_6760865028,420,-3,32,-22,-3,0,2,2,2,2,4,1,1,2,-5,10,5,-1,1,0,0,-18,-2,-3,-6,9,0,0,1,1,1,1,-1,2,-1
KR_6753628933,420,1,12,0,0,-1,3,2,1,3,4,1,4,5,-3,3,0,2,1,3,0,-4,224,-6,-4,10,-2,0,0,0,1,-1,-1,0,-1
KR_6748451134,420,-2,-41,12,-6,0,3,3,1,0,1,0,4,4,-7,8,1,0,0,0,-2,-15,1,3,-6,3,1,0,0,1,1,-1,-1,2,-1
KR_6653495809,420,-3,-134,-47,-3,-2,3,1,-3,6,3,-1,2,1,3,0,3,0,0,0,0,3,7,0,-2,2,-6,0,-2,1,-1,-1,-1,3,-1
KR_6750959900,420,-2,3,0,-4,-2,3,1,-2,3,1,0,2,2,0,4,4,0,0,0,0,-2,-5,3,-6,3,0,0,1,-1,1,1,-1,5,-1
KR_6604257784,420,1,31,-15,5,1,0,1,-3,6,3,4,0,4,1,1,2,2,0,2,0,13,20,4,-10,6,1,0,-1,1,-1,-1,-1,1,-1
KR_6755857566,420,-4,-4,-54,-13,-1,2,1,-6,8,2,1,3,4,-6,6,0,-1,1,0,-1,-29,-1,-1,-5,6,5,0,0,-1,-1,-1,-1,4,-1
KR_6679992369,420,3,9,24,4,5,0,5,1,5,6,0,2,2,-3,6,3,1,1,2,0,-3,6,2,-4,2,0,0,1,1,1,1,1,6,-1
KR_6706967988,420,-2,-57,24,-4,-1,3,2,0,0,0,0,3,3,-2,2,0,-1,2,1,0,-9,-3,-4,-4,8,-5,0,-2,-1,-1,-1,-1,6,-1
KR_6764039099,420,-4,-21,-2,-3,1,0,1,-2,5,3,0,2,2,0,3,3,-2,2,0,0,-2,-1,-1,-5,6,3,0,0,-1,-1,-1,-1,4,-1
KR_6752930680,420,2,49,-5,-5,4,0,4,-4,4,0,-2,4,2,-5,8,3,2,0,2,0,-13,6,-3,-2,5,-1,0,0,-1,-1,0,1,3,-1
KR_6617026997,420,-2,-62,-36,-11,-2,4,2,-1,5,4,-5,7,2,0,3,3,-3,3,0,-2,-8,-2,-2,-3,5,0,0,-2,-1,-1,-1,-1,5,-1
KR_6706374468,420,2,-15,8,1,-3,3,0,3,0,3,-2,3,1,-1,4,3,4,0,4,0,7,-7,-4,-6,10,1,0,1,-1,-1,1,1,2,-1
KR_6763825927,420,-2,-38,13,-4,-1,2,1,4,0,4,-5,6,1,-1,4,3,-1,1,0,0,-10,-42,-3,-4,7,21,0,-1,-1,1,-1,1,4,-1
KR_6751292567,420,-4,-27,-4,-9,-3,3,0,1,1,2,-4,7,3,-3,5,2,0,1,1,0,-7,18,2,-3,1,-1,0,-2,-1,-1,-1,1,4,-1
KR_6735873178,440,3,18,31,-3,0,3,3,-4,5,1,2,0,2,2,3,5,-3,6,3,0,-1,17,1,-6,5,6,0,0,0,-1,0,-1,0,-1
KR_6744204187,420,-4,-5,-32,-5,1,1,2,-2,5,3,-2,3,1,-1,4,3,-1,1,0,0,-2,-5,-1,-6,7,-1,0,0,-1,-1,0,1,4,-1
KR_6729006551,420,-5,-37,-52,-3,1,1,2,0,1,1,-3,6,3,0,4,4,-1,1,0,0,0,-11,-4,-2,6,-2,0,0,-1,-1,0,1,3,-1
KR_6752796713,420,1,-45,35,-5,-2,3,1,-2,5,3,0,1,1,-1,3,2,0,0,0,1,-11,149,2,-5,3,-3,0,0,1,1,1,1,3,-1
KR_6765628625,420,-5,-14,-22,-5,0,1,1,3,1,4,-5,7,2,-2,5,3,-1,1,0,-1,-9,-4,2,-7,5,-4,0,0,1,-1,0,-1,6,-1
KR_6740315661,420,-2,-16,-16,-9,0,3,3,-1,1,0,-1,2,1,-6,6,0,-1,1,0,0,-11,151,-1,-5,6,-1,0,-1,-1,-1,-1,-1,3,-1
KR_6659766548,420,0,11,-4,-2,-2,2,0,1,3,4,-3,5,2,3,1,4,-1,1,0,0,5,-20,-2,-4,6,2,0,0,-1,-1,0,1,5,-1
KR_6644926622,420,0,-12,8,-3,2,0,2,-9,9,0,4,1,5,2,4,6,-2,5,3,-2,11,-44,3,-4,1,24,0,-2,-1,-1,-1,-1,3,-1
KR_6667816307,420,-2,-24,0,-4,2,1,3,-1,5,4,1,3,4,-2,3,1,-4,5,1,0,-6,-13,-6,-1,7,3,0,0,-1,0,-1,1,5,-1
KR_6735121227,420,-1,-18,-21,9,-1,3,2,0,3,3,5,1,6,4,1,5,1,0,1,-1,9,10,3,-5,2,-4,0,0,-1,1,1,-1,3,-1
KR_6688417256,420,0,77,17,7,0,2,2,2,1,3,2,3,5,4,1,5,-1,1,0,0,11,3,3,-8,5,8,0,1,1,1,1,1,5,-1
KR_6763451823,420,-2,-44,-12,-7,2,2,4,-1,2,1,-2,3,1,-6,7,1,0,0,0,0,-9,-7,-4,-4,8,2,0,-2,1,-1,-1,-1,1,-1
KR_6764404105,420,-4,-21,-16,-11,-1,4,3,-3,4,1,-7,7,0,0,4,4,0,0,0,-2,-19,1,-2,-4,6,1,0,-3,-1,-1,-1,-1,5,-1
KR_6621415749,420,2,19,11,1,-1,2,1,0,1,1,2,0,2,0,1,1,0,0,0,0,7,10,-1,-5,6,-1,0,0,-1,-1,0,-1,6,-1
KR_6536915785,420,0,-60,-12,2,2,1,3,0,2,2,1,1,2,-1,1,0,0,0,0,0,5,-11,4,-8,4,1,0,0,-1,1,-1,-1,6,-1
KR_6752774872,420,-2,-59,-6,-6,2,0,2,2,2,4,-1,5,4,-8,8,0,-1,1,0,0,1,0,4,-7,3,-3,0,-1,1,1,-1,-1,1,-1
KR_6723821622,420,-1,10,-20,-3,2,1,3,-3,3,0,0,2,2,-3,4,1,1,0,1,0,-4,3,4,-6,2,-5,0,-1,-1,1,-1,1,5,-1
KR_6764206211,420,-3,-70,16,-6,-1,1,0,0,0,0,-3,5,2,-1,1,0,-1,1,0,0,-6,-38,-2,-5,7,-3,0,-2,1,-1,-1,-1,1,-1
KR_6691688402,420,2,39,-4,4,0,2,2,5,2,7,-2,5,3,0,3,3,1,1,2,0,5,-2,4,-8,4,-7,0,-1,0,0,-1,-1,0,-1
KR_6761668431,420,-2,41,3,-5,1,2,3,-1,3,2,-3,5,2,-2,5,3,0,0,0,1,-10,-9,-4,-3,7,5,0,-1,1,-1,-1,1,1,-1
KR_6721960912,420,-3,-58,0,-12,-2,2,0,0,3,3,-4,4,0,-6,6,0,0,1,1,0,-9,-134,0,-5,5,-4,0,0,1,-1,0,-1,1,-1
KR_6761993909,440,-4,19,-18,-6,-2,2,0,-2,2,0,-6,6,0,3,0,3,1,0,1,0,-10,-176,1,-8,7,0,0,0,1,-1,-1,-1,3,-1
KR_6743213247,420,-4,53,-24,-8,-1,3,2,-7,7,0,1,4,5,-1,1,0,0,0,0,0,-13,2,1,-6,5,-1,0,0,-1,-1,-1,-1,4,-1
KR_6588655131,420,0,-35,-2,2,-1,3,2,-1,3,2,3,0,3,0,3,3,1,2,3,0,-4,1,-8,-2,10,0,0,1,-1,1,1,-1,6,-1
KR_6762254043,420,1,31,8,2,0,4,4,1,0,1,2,2,4,-1,3,2,0,1,1,-1,5,1,-1,-4,5,0,0,-1,1,-1,-1,-1,2,-1
KR_6685467732,420,-1,-36,-12,-2,3,0,3,-2,6,4,-2,2,0,-1,1,0,0,0,0,0,-6,54,-4,-4,8,-3,0,0,-1,1,0,1,6,-1
KR_6630332779,420,0,-69,28,1,3,0,3,-2,3,1,-3,3,0,2,0,2,1,0,1,0,1,-37,3,-10,7,-2,0,-1,-1,-1,-1,1,5,-1
KR_6758400232,420,-2,-5,-35,-3,2,0,2,-1,2,1,0,0,0,-3,3,0,-1,1,0,1,-1,-5,-1,-5,6,-6,0,-2,-1,-1,-1,1,1,-1
KR_6646581696,420,-5,-68,-24,-18,1,1,2,0,2,2,-7,7,0,-9,11,2,-3,3,0,-3,-16,-8,-1,-7,8,0,0,-3,-1,-1,-1,-1,2,-1
KR_6629745760,420,-1,3,-27,1,-3,3,0,-1,3,2,3,2,5,3,0,3,-1,1,0,0,-1,-12,3,-9,6,2,0,0,-1,-1,-1,1,1,-1
KR_6742384757,420,1,44,11,-5,5,1,6,-8,9,1,1,2,3,-1,3,2,-2,3,1,1,-8,-36,3,-8,5,-4,0,0,0,1,1,1,0,-1
KR_6634594669,420,0,-7,-32,3,-1,1,0,0,3,3,8,2,10,-3,5,2,-1,1,0,0,5,7,1,-3,2,-4,0,1,-1,1,1,1,6,-1
KR_6409860360,440,0,15,8,-2,-4,4,0,0,3,3,1,2,3,3,0,3,-2,2,0,0,-5,-4,0,-3,3,-2,0,-1,1,-1,-1,-1,4,-1
KR_6764483316,420,-2,-6,4,-10,0,2,2,-3,3,0,0,2,2,-6,6,0,-1,3,2,0,-8,-153,4,-8,4,-9,0,-2,-1,-1,-1,-1,1,-1
KR_6657642430,420,-3,-3,-4,-11,-1,1,0,-3,4,1,-8,9,1,0,1,1,1,2,3,0,-5,1,-3,-5,8,-3,0,-1,-1,-1,-1,-1,4,-1
KR_6762857875,420,-2,-22,36,-7,-1,2,1,-1,3,2,-8,9,1,1,1,2,2,1,3,0,-8,1,-1,-4,5,-4,0,-1,0,-1,-1,1,0,-1
KR_6754534231,420,1,-44,-21,7,-1,2,1,0,3,3,1,2,3,5,0,5,2,0,2,0,4,-13,7,-12,5,-2,0,0,1,-1,0,1,2,-1
KR_6602240018,420,-3,-45,10,-6,-1,2,1,-2,5,3,-1,3,2,-3,6,3,1,0,1,0,-3,-14,3,-5,2,-4,0,0,-1,-1,0,-1,3,-1
KR_6758792780,420,-3,-56,37,-6,-6,7,1,3,2,5,0,3,3,-3,5,2,0,0,0,0,-5,7,3,-5,2,-4,0,0,0,1,1,-1,0,-1
KR_6706452087,420,0,-46,-8,0,1,0,1,-4,5,1,-3,4,1,3,3,6,3,0,3,0,-6,-1,-11,-2,13,8,0,-1,-1,-1,-1,1,3,-1
KR_6734386241,420,-1,-18,5,-9,1,3,4,-7,9,2,-2,5,3,1,2,3,-2,4,2,0,-11,-155,-1,-6,7,-5,0,-2,1,-1,-1,-1,5,-1
KR_6615562968,420,1,67,-17,-6,1,3,4,-2,2,0,2,2,4,-8,9,1,1,1,2,0,-13,269,2,-7,5,-5,0,-1,-1,-1,-1,-1,4,-1
KR_6740235515,420,-5,-44,20,-9,-2,2,0,1,1,2,-2,8,6,-3,10,7,-3,3,0,-1,-14,-171,-1,-3,4,-1,0,-5,-1,-1,-1,-1,6,-1
KR_6717432626,420,-2,-64,12,-4,1,2,3,1,3,4,-7,8,1,-3,6,3,4,0,4,1,-2,-1,-3,-3,6,1,0,-1,-1,-1,-1,1,4,-1
KR_6759308076,420,-4,0,-60,-6,1,1,2,-1,1,0,-3,5,2,-1,2,1,-2,2,0,-1,-2,-39,-3,-2,5,6,0,-1,-1,-1,-1,-1,3,-1
KR_6764673684,420,2,64,-24,6,2,2,4,5,1,6,4,1,5,-3,4,1,-2,3,1,0,6,-14,-6,-2,8,7,0,0,-1,1,1,1,4,-1
KR_6699885549,420,-3,-28,31,-11,0,1,1,0,4,4,-7,8,1,0,4,4,-4,4,0,0,-2,-11,-1,-5,6,0,0,-1,-1,-1,-1,1,1,-1
KR_6759738773,420,1,75,16,4,-1,1,0,3,1,4,2,2,4,-1,2,1,1,0,1,0,2,-16,-4,-2,6,5,0,0,1,1,1,1,4,-1
KR_6763197085,420,1,14,-36,-1,1,1,2,-3,4,1,1,1,2,1,1,2,-1,1,0,0,0,405,-4,-3,7,-25,0,1,0,-1,1,-1,0,-1
KR_6756337475,420,2,-25,16,-1,0,0,0,1,2,3,2,2,4,-2,3,1,-2,2,0,-1,2,26,-1,-2,3,3,0,0,-1,-1,0,-1,1,-1
KR_6735708906,420,-2,-66,24,-14,-8,8,0,2,2,4,-1,2,1,-6,6,0,-1,1,0,0,-17,0,2,-9,7,1,0,-2,1,-1,-1,-1,5,-1
KR_6739620115,420,1,24,21,7,-1,3,2,-2,5,3,3,0,3,7,0,7,0,1,1,0,16,-358,0,-6,6,0,0,0,-1,-1,-1,-1,4,-1
KR_6763336991,420,-1,6,10,-7,-1,2,1,1,2,3,0,1,1,-2,4,2,-5,7,2,0,-2,-8,4,-8,4,-4,0,0,1,-1,0,-1,5,-1
KR_6762047743,420,-2,-12,-1,-3,-2,3,1,2,1,3,-1,2,1,0,3,3,-2,2,0,0,-2,-41,0,-6,6,5,0,0,1,1,0,1,2,-1
KR_6708045222,420,-3,-27,-16,-6,-1,1,0,-2,3,1,0,3,3,-4,4,0,1,0,1,0,-6,-5,1,-8,7,-4,0,-1,-1,-1,-1,1,2,-1
KR_6761294446,420,-1,-2,16,-3,-1,3,2,2,2,4,-2,4,2,0,1,1,-2,2,0,0,1,2,2,-6,4,-4,0,-1,-1,1,-1,-1,2,-1
KR_6753745314,420,-6,-69,-28,-11,-5,7,2,1,1,2,-2,3,1,-2,4,2,-3,3,0,0,-9,-10,0,-3,3,-2,0,-2,-1,-1,-1,1,6,-1
KR_6743549954,420,-1,2,-22,0,-3,4,1,2,2,4,0,3,3,0,2,2,1,1,2,0,-3,-4,0,-7,7,4,0,0,-1,-1,0,-1,5,-1
KR_6763245904,420,2,66,-1,4,0,2,2,1,2,3,2,1,3,2,4,6,-1,2,1,0,-2,-186,-4,-5,9,2,0,0,1,1,1,1,1,-1
KR_6754443701,420,-5,-41,37,-11,-4,6,2,0,2,2,-1,3,2,-8,9,1,2,3,5,0,-3,0,-1,-5,6,5,0,-1,1,1,-1,-1,1,-1
KR_6764308447,420,-3,-81,-2,-4,-3,3,0,3,3,6,-4,5,1,-1,3,2,1,1,2,-2,-5,-2,-2,-3,5,-6,0,-1,1,-1,-1,-1,4,-1
KR_6675175321,420,-7,-55,-26,-10,-4,5,1,-6,7,1,-2,2,0,3,3,6,-1,1,0,0,-9,-32,0,-6,6,12,0,-2,1,1,-1,-1,2,-1
KR_6751994156,420,-2,13,-5,-1,2,2,4,-2,4,2,0,4,4,-1,3,2,0,2,2,1,-6,-27,3,-8,5,-2,0,0,1,1,1,1,5,-1
KR_6746761474,420,-4,-94,-14,-6,-2,3,1,5,3,8,0,1,1,-7,8,1,-2,5,3,0,-4,22,0,-3,3,2,0,-1,0,1,-1,-1,0,-1
KR_6647478058,420,-5,-32,7,-6,-2,4,2,-2,4,2,0,2,2,0,2,2,-2,2,0,0,-8,-4,-7,-2,9,-2,0,-1,-1,-1,-1,-1,4,-1
KR_6632204614,420,-2,-43,-1,-6,-2,2,0,-4,4,0,3,1,4,-3,5,2,0,0,0,-1,-8,192,-5,-4,9,2,0,-1,-1,-1,-1,-1,6,-1
KR_6610303620,420,-1,9,31,0,1,2,3,-1,2,1,-6,7,1,5,0,5,1,0,1,0,0,-16,-3,-5,8,4,0,1,1,-1,1,1,2,-1
KR_6751923920,420,4,13,25,4,-2,6,4,0,2,2,2,1,3,1,2,3,3,0,3,0,4,10,1,-4,3,0,0,0,-1,0,1,-1,5,-1
KR_6718214825,420,-2,-18,10,-10,1,0,1,-5,10,5,-1,4,3,-2,3,1,-3,3,0,0,-6,-71,-5,-3,8,1,0,-1,-1,1,-1,-1,3,-1
KR_6491197495,420,-3,-40,18,-6,-2,2,0,0,3,3,-1,1,0,-2,5,3,-1,1,0,0,-7,-6,-4,-7,11,4,0,-1,-1,1,-1,1,6,-1
KR_6706444729,420,0,0,-36,0,1,3,4,3,3,6,-3,6,3,-2,3,1,1,1,2,1,2,5,3,-7,4,-3,0,-1,-1,-1,-1,1,6,-1
KR_6761766813,420,-3,-41,-34,-6,-1,1,0,-3,4,1,2,1,3,-3,4,1,-1,3,2,0,-5,-11,2,-7,5,5,0,1,-1,1,1,-1,6,-1
KR_6741142208,420,-5,-111,-30,-10,-5,5,0,-2,5,3,-3,3,0,1,1,2,-1,2,1,0,-5,49,-1,-6,7,-1,0,-2,-1,-1,-1,-1,6,-1
KR_6733761036,440,-2,-89,-28,-4,-1,1,0,-1,2,1,-2,6,4,-1,2,1,1,0,1,0,-1,-6,1,-3,2,-2,0,-1,-1,-1,-1,1,5,-1
KR_6743028216,420,-3,-59,20,-8,-3,3,0,1,4,5,-1,5,4,-1,3,2,-4,4,0,0,-3,20,3,-9,6,-4,0,0,1,1,1,1,5,-1
KR_6687140319,420,-2,-12,-40,-4,-4,6,2,-3,5,2,3,2,5,0,1,1,0,0,0,-1,2,3,-1,-4,5,-2,0,0,-1,1,0,-1,6,-1
KR_6747526429,420,-3,-38,-19,-5,0,1,1,-2,3,1,-1,1,0,0,0,0,-2,3,1,0,-1,-6,1,-5,4,0,0,-1,-1,-1,-1,1,2,-1
KR_6758634538,420,-2,-43,20,-11,-8,9,1,0,2,2,0,4,4,-2,2,0,-1,1,0,0,0,-6,1,-4,3,3,0,0,1,-1,-1,-1,6,-1
KR_6763834900,420,-2,-31,-23,-4,-4,4,0,0,3,3,-1,3,2,-1,5,4,2,0,2,-1,-13,-25,-1,-4,5,-1,0,0,-1,-1,-1,-1,3,-1
KR_6727866331,440,-1,-49,-3,-2,0,4,4,-1,1,0,-4,5,1,1,2,3,2,2,4,0,4,14,0,-5,5,-2,0,0,-1,1,-1,1,1,-1
KR_6755847679,420,3,20,22,5,-3,3,0,4,0,4,-2,4,2,3,1,4,3,0,3,1,10,1,1,-4,3,-2,0,0,1,1,-1,1,3,-1
KR_6760616524,420,-3,-35,-22,-9,0,2,2,-2,3,1,-4,5,1,-2,5,3,-1,1,0,0,-17,-2,-5,-3,8,-2,0,0,-1,1,0,-1,6,-1
KR_6765504434,420,0,-29,-16,6,1,1,2,0,5,5,4,0,4,0,1,1,1,0,1,0,12,7,2,-7,5,0,0,0,-1,1,0,1,2,-1
KR_6645333122,420,2,56,-12,-6,-3,4,1,-1,2,1,-1,3,2,-1,4,3,0,1,1,1,-3,6,3,-10,7,0,0,-1,-1,-1,-1,1,3,-1
KR_6634962294,420,-2,15,5,-5,-2,2,0,0,2,2,0,2,2,0,1,1,-3,3,0,0,-3,9,2,-4,2,-1,0,-2,-1,-1,-1,1,6,-1
KR_6757946580,420,0,48,32,-2,-2,3,1,2,3,5,-1,2,1,-1,4,3,0,1,1,0,-2,-2,-6,-2,8,3,0,0,-1,1,0,-1,5,-1
KR_6762117435,420,1,-5,7,12,3,1,4,2,1,3,6,0,6,-2,4,2,3,0,3,1,8,8,1,-5,4,2,0,0,1,1,0,1,6,-1
KR_6721118646,440,-1,20,-8,-5,-1,4,3,0,0,0,0,1,1,-3,5,2,-1,3,2,0,-8,-38,2,-6,4,-1,0,-1,0,-1,-1,1,0,-1
KR_6683101902,420,0,47,1,0,0,1,1,-1,4,3,3,2,5,0,2,2,-2,2,0,0,-1,-60,-1,-4,5,1,0,0,1,-1,0,-1,6,-1
KR_6387965383,440,0,3,-28,-2,-2,4,2,2,1,3,-3,3,0,2,0,2,-1,3,2,0,5,-14,1,-6,5,0,0,-1,1,-1,-1,-1,2,-1
KR_6645661457,420,2,13,-3,1,-1,3,2,-1,3,2,2,6,8,1,0,1,0,0,0,0,3,-46,2,-8,6,15,0,0,1,1,-1,1,5,-1
KR_6763908104,420,-1,-18,0,-3,2,2,4,-4,8,4,0,1,1,0,2,2,-1,2,1,0,-9,4,1,-6,5,0,0,-2,-1,-1,-1,-1,4,-1
KR_6735899787,420,0,37,-5,1,1,2,3,-4,5,1,1,3,4,1,1,2,2,0,2,0,-1,300,-3,-5,8,3,0,-1,-1,-1,-1,-1,3,-1
KR_6493891083,420,-9,-152,-19,-15,-3,4,1,-2,4,2,-2,2,0,-4,5,1,-4,6,2,0,-12,-4,1,-5,4,-2,0,-3,-1,1,-1,-1,6,-1
KR_6217666494,420,-4,-134,-12,-10,1,2,3,-5,6,1,-3,3,0,-1,3,2,-2,3,1,0,-10,-4,-3,-3,6,3,0,-1,1,0,-1,-1,3,-1
KR_6679904891,420,0,-54,20,-1,4,1,5,-3,5,2,-4,4,0,1,1,2,1,1,2,0,2,-10,2,-3,1,-1,0,0,-1,1,-1,-1,2,-1
KR_6758961792,420,0,-43,4,3,-1,2,1,2,1,3,3,3,6,1,0,1,-2,2,0,0,12,8,0,-6,6,3,0,-1,-1,-1,-1,1,6,-1
KR_6677698543,420,-3,5,-4,-5,2,1,3,0,0,0,-4,7,3,-2,4,2,-1,2,1,0,-12,15,-6,-3,9,3,0,0,-1,1,1,-1,1,-1
KR_6764516058,440,-1,44,-5,1,0,1,1,-1,4,3,0,2,2,0,4,4,2,1,3,1,3,8,1,-6,5,-5,0,2,-1,1,1,1,4,-1
KR_6717593077,420,1,-16,7,-1,2,2,4,-3,5,2,0,2,2,-1,2,1,1,1,2,0,5,-5,1,-9,8,1,0,0,1,-1,0,1,2,-1
KR_6756114007,420,-1,-15,3,1,2,2,4,-1,4,3,2,2,4,0,2,2,-2,2,0,1,0,-7,-1,-4,5,-5,0,-1,-1,-1,-1,-1,5,-1
KR_6760317170,420,-5,-29,-12,-10,-1,1,0,-3,5,2,-3,4,1,-3,3,0,0,0,0,0,-7,-24,3,-6,3,1,0,-1,-1,-1,-1,-1,5,-1
KR_6756032255,420,-2,11,-29,-2,0,1,1,-5,6,1,-1,2,1,4,1,5,0,2,2,0,-5,-10,-3,-5,8,-4,0,0,0,-1,-1,-1,0,-1
KR_6760941586,420,-2,-61,-67,7,-1,4,3,0,2,2,1,3,4,5,1,6,2,0,2,0,12,5,-2,-3,5,1,0,-1,-1,-1,-1,-1,1,-1
KR_6744183062,420,-4,-51,0,-19,0,2,2,1,7,8,-10,10,0,-8,9,1,-2,2,0,-2,-24,-13,-2,-6,8,-2,0,-2,-1,0,-1,-1,5,-1
KR_6716234330,420,-3,-52,-16,-6,3,1,4,-4,8,4,-2,3,1,-3,4,1,0,2,2,0,-12,-6,-3,-2,5,-1,0,1,-1,1,1,-1,4,-1
KR_6668499350,420,-1,26,8,1,0,1,1,-3,4,1,1,4,5,3,1,4,0,0,0,0,4,43,-2,-6,8,3,0,1,-1,-1,1,1,6,-1
KR_6697997780,420,0,12,5,0,-2,2,0,-3,3,0,0,0,0,5,0,5,0,1,1,0,4,-7,-5,-4,9,3,0,-1,1,-1,-1,-1,1,-1
KR_6737642665,420,-3,54,-14,-13,0,2,2,-6,7,1,-2,2,0,-2,3,1,-3,4,1,0,-12,-8,-2,-4,6,0,0,0,-1,1,-1,-1,2,-1
KR_6763088788,420,0,18,7,-7,-2,3,1,-3,3,0,-3,4,1,0,6,6,1,1,2,0,-4,2,0,-3,3,0,0,0,-1,-1,1,1,6,-1
KR_6755445435,420,-4,-36,-16,-3,-2,5,3,0,3,3,-1,2,1,0,3,3,0,1,1,0,-3,-323,0,-4,4,7,0,1,-1,1,1,-1,5,-1
KR_6721303525,440,-1,-15,10,2,1,1,2,-1,1,0,1,4,5,2,4,6,-1,1,0,0,6,-1,-1,-5,6,-1,0,1,-1,1,1,-1,2,-1
KR_6652139940,420,-2,4,-36,-3,1,1,2,0,2,2,-3,4,1,-3,3,0,2,0,2,0,-6,10,0,-5,5,-2,0,0,1,1,0,1,4,-1
KR_6749369399,420,-2,-81,-7,-2,-1,2,1,-2,2,0,-2,3,1,3,1,4,0,0,0,0,9,12,1,-8,7,-6,0,0,1,-1,0,-1,6,-1
KR_6747776344,440,-3,-108,-1,-9,-6,6,0,-4,4,0,-3,6,3,5,1,6,-1,3,2,0,-8,4,3,-4,1,-3,0,0,-1,1,-1,-1,6,-1
KR_6753704247,420,-1,-39,-18,0,-3,3,0,3,4,7,2,0,2,0,2,2,-2,2,0,0,-8,-3,-1,-2,3,3,0,0,1,-1,-1,1,6,-1
KR_5746489420,420,-3,-5,-27,-5,1,1,2,-2,6,4,-1,1,0,-2,3,1,-1,1,0,0,-5,-30,-5,-7,12,-1,0,0,-1,-1,1,-1,3,-1
KR_6729328688,420,-2,-38,-46,-1,-5,5,0,-1,3,2,2,1,3,2,2,4,1,2,3,1,1,17,-2,-5,7,4,0,-2,1,-1,-1,1,1,-1
KR_6685383355,420,1,28,-21,-6,1,3,4,-1,3,2,-2,4,2,-3,3,0,-1,2,1,1,-7,-9,1,-7,6,-3,0,-1,-1,1,-1,1,2,-1
KR_6666604737,420,1,12,6,3,2,0,2,2,3,5,-1,2,1,-1,3,2,1,2,3,0,-4,114,-3,-6,9,6,0,1,1,-1,1,1,3,-1
KR_6755788304,420,-2,21,33,-8,-4,4,0,-3,4,1,-1,2,1,-1,5,4,1,0,1,1,-8,-33,-2,-4,6,1,0,-2,-1,-1,-1,1,4,-1
KR_6735211984,420,-3,28,28,-13,-4,4,0,-6,9,3,-1,1,0,0,2,2,-2,3,1,0,-9,-16,-5,-3,8,2,0,0,1,-1,-1,-1,4,-1
KR_6763789322,420,0,-20,-8,4,4,0,4,0,0,0,2,2,4,-2,3,1,0,0,0,0,-3,-86,-4,-2,6,4,0,0,-1,1,0,-1,4,-1
KR_6729828882,420,-4,-22,-21,-6,-1,2,1,-5,5,0,1,2,3,-3,4,1,2,0,2,1,-9,-19,-2,-5,7,3,0,0,1,-1,0,1,6,-1
KR_6553630786,420,-7,-45,-43,-16,-4,4,0,-5,6,1,-4,6,2,-2,3,1,-1,1,0,0,-12,-9,1,-7,6,0,0,-3,-1,-1,-1,-1,5,-1
KR_6722009470,420,-4,-34,13,-9,-2,2,0,-2,3,1,-2,3,1,-3,6,3,0,0,0,0,-8,50,3,-8,5,-27,0,-1,1,-1,-1,-1,4,-1
KR_6743521585,420,1,-74,4,-1,2,0,2,-2,4,2,2,0,2,-3,5,2,0,3,3,0,-3,9,4,-5,1,-3,0,-1,-1,1,-1,1,2,-1
KR_6763399600,440,-3,-19,-20,3,-2,3,1,4,5,9,-4,4,0,2,2,4,3,0,3,0,10,142,-9,-5,14,11,0,0,-1,1,0,1,3,-1
KR_6681111832,420,-3,-3,-24,-5,2,0,2,-3,5,2,-5,5,0,2,5,7,-1,2,1,0,0,13,-3,-8,11,1,0,0,-1,-1,0,1,4,-1
KR_6617180171,420,1,-45,-12,1,0,2,2,3,0,3,-6,8,2,3,1,4,1,2,3,0,-6,12,6,-7,1,-5,0,0,-1,-1,0,-1,5,-1
KR_6760853155,420,3,64,17,-1,-2,2,0,7,0,7,-1,2,1,-4,5,1,-1,1,0,0,-4,-3,-2,-4,6,0,0,0,1,-1,0,-1,1,-1
KR_6744204485,420,-3,-59,-33,-5,-1,1,0,6,1,7,0,0,0,-9,9,0,-1,1,0,0,-3,-249,5,-7,2,-9,0,0,-1,-1,0,1,2,-1
KR_6764349189,420,-2,2,-11,-9,-3,3,0,-2,4,2,-3,4,1,-1,5,4,0,0,0,0,-11,7,3,-9,6,-5,0,2,-1,1,1,-1,6,-1
KR_6765270929,420,0,-23,-12,-5,-1,1,0,1,2,3,-2,2,0,-4,6,2,1,1,2,0,3,8,0,-5,5,0,0,0,-1,1,0,-1,4,-1
KR_6764313319,420,-1,37,16,-3,2,0,2,-7,8,1,-2,4,2,2,1,3,2,0,2,1,0,-14,3,-6,3,0,0,1,0,0,1,1,0,-1
KR_6751481222,420,-4,-97,-12,-10,0,0,0,-2,5,3,1,4,5,-9,9,0,0,0,0,0,-18,-4,-6,-4,10,4,0,-1,1,0,-1,-1,2,-1
KR_6761352356,420,2,-16,-4,4,3,0,3,2,1,3,-2,4,2,2,1,3,-1,2,1,-1,8,-1,2,-5,3,3,0,0,1,-1,0,-1,5,-1
KR_6760387255,420,-2,-105,-8,-10,-8,8,0,4,3,7,0,2,2,-5,5,0,-1,1,0,0,-2,0,-1,-3,4,1,0,-3,-1,-1,-1,-1,5,-1
KR_6731216001,440,-1,-58,32,-2,2,2,4,-1,3,2,0,1,1,-1,4,3,-2,2,0,0,-3,7,3,-8,5,-8,0,1,1,-1,1,-1,5,-1
KR_6757071025,420,1,-49,3,1,-3,3,0,3,1,4,1,0,1,3,0,3,-3,3,0,0,5,-6,4,-6,2,-3,0,-2,-1,-1,-1,1,3,-1
KR_6463494386,420,-3,-91,5,5,2,0,2,4,1,5,2,1,3,-4,8,4,1,1,2,1,7,-218,1,-6,5,-5,0,-2,1,1,-1,1,6,-1
KR_6760825930,420,-1,-59,-4,-9,-7,10,3,0,5,5,1,2,3,-1,2,1,-2,2,0,0,-3,7,2,-4,2,-4,0,-1,-1,-1,-1,-1,5,-1
KR_6760063512,420,-2,-46,16,-8,-4,5,1,-1,2,1,-5,6,1,2,1,3,0,2,2,0,-8,-2,-3,-4,7,-1,0,0,1,-1,1,-1,2,-1
KR_6748121526,440,-8,-31,-22,-14,-4,4,0,-5,6,1,-9,9,0,4,2,6,0,1,1,0,-12,13,1,-5,4,-8,0,-2,-1,-1,-1,-1,5,-1
KR_6746612089,420,-3,-81,-13,-2,0,2,2,1,1,2,0,1,1,1,2,3,-4,4,0,0,-3,-9,-9,-4,13,2,0,-2,0,1,-1,1,0,-1
KR_6684328590,420,-2,-38,16,-8,-3,5,2,0,4,4,-1,3,2,-2,3,1,-2,3,1,0,-9,0,-1,-4,5,-3,0,-2,-1,-1,-1,1,4,-1
KR_5568172081,420,0,-9,-8,0,0,0,0,-7,7,0,1,1,2,2,1,3,4,1,5,0,0,-17,-4,-3,7,0,0,1,1,1,1,-1,2,-1
KR_6694803698,420,-6,-43,-8,-9,-6,6,0,1,1,2,-2,4,2,-1,4,3,-1,1,0,0,1,20,2,-5,3,-8,0,-2,-1,1,-1,-1,6,-1
KR_6744707169,420,-3,-12,-4,-7,-3,3,0,-1,5,4,-2,5,3,4,1,5,-5,5,0,0,-5,-5,-2,-3,5,-2,0,-1,-1,1,-1,1,5,-1
KR_6683697540,420,0,9,-12,1,1,1,2,2,2,4,2,1,3,-2,3,1,-2,3,1,0,-1,-230,1,-2,1,-30,0,0,-1,1,1,-1,4,-1
KR_6758664886,420,-1,-11,-1,1,1,3,4,3,0,3,2,1,3,-3,7,4,-2,3,1,0,5,-55,7,-8,1,18,0,-1,1,1,1,-1,6,-1
KR_6750452566,420,-2,-43,-2,-8,0,2,2,-3,7,4,-2,4,2,-3,4,1,0,1,1,-1,-9,24,6,-10,4,2,0,0,-1,-1,0,-1,2,-1
KR_6728069577,420,-4,-41,4,-6,-6,6,0,5,3,8,1,2,3,-3,5,2,-3,3,0,0,-1,-143,4,-7,3,11,0,-2,-1,-1,-1,-1,4,-1
KR_6758346340,420,1,7,3,3,0,2,2,1,2,3,-2,2,0,3,2,5,1,0,1,0,7,220,6,-8,2,4,0,0,1,0,1,1,1,-1
KR_6755229188,420,-1,-5,-4,1,-3,3,0,1,3,4,0,2,2,4,1,5,-1,1,0,0,3,-2,1,-5,4,4,0,0,1,-1,0,1,2,-1
KR_6731624798,420,-8,-112,-88,-16,-3,4,1,0,2,2,1,2,3,-8,9,1,-6,9,3,-2,-22,0,2,-8,6,-3,0,-5,-1,-1,-1,1,6,-1
KR_6675462682,420,-3,-34,-27,-3,-3,3,0,-2,4,2,0,4,4,1,3,4,1,0,1,-1,6,-8,-1,-6,7,8,0,0,-1,-1,0,-1,2,-1
KR_6744154042,420,-4,-17,-12,-10,0,1,1,-4,5,1,-8,8,0,-1,4,3,3,0,3,0,-7,20,-1,-5,6,0,0,-2,1,1,-1,-1,3,-1
KR_6689077633,420,1,-4,-12,3,6,0,6,-2,3,1,1,1,2,-3,3,0,1,0,1,0,2,28,-3,-3,6,4,0,0,-1,-1,-1,1,5,-1
KR_6732807746,440,-2,-14,-16,5,2,0,2,-4,5,1,4,3,7,1,4,5,2,0,2,-1,2,-93,-2,-4,6,3,0,-1,-1,0,-1,1,5,-1
KR_6709364412,420,-3,-27,-20,-9,2,1,3,0,4,4,-5,5,0,-4,4,0,-2,3,1,0,-13,-58,0,-5,5,0,0,-1,-1,1,-1,1,3,-1
KR_6758368888,420,1,27,-12,-11,0,3,3,1,3,4,-4,6,2,-8,8,0,0,1,1,0,-15,-1,-3,-2,5,0,0,0,0,1,1,-1,0,-1
KR_6721105998,420,-5,-49,-8,-13,-4,4,0,0,0,0,1,0,1,-4,4,0,-6,6,0,0,-16,-12,-7,-2,9,1,0,-1,1,0,-1,-1,5,-1
KR_6746874825,420,-1,-120,-17,-2,-5,9,4,2,2,4,1,0,1,1,1,2,-1,1,0,1,13,22,0,-5,5,-3,0,-1,-1,-1,-1,1,2,-1
KR_6765565352,420,1,57,8,3,1,0,1,2,5,7,2,2,4,-2,4,2,0,1,1,1,1,9,-1,-5,6,2,0,1,-1,1,1,1,5,-1
KR_6756811797,440,-1,0,7,-6,-5,5,0,0,1,1,3,1,4,-4,6,2,0,1,1,0,-9,0,-3,-5,8,5,0,1,1,-1,1,-1,4,-1
KR_6751265540,420,-6,-70,-23,-4,7,3,10,-7,7,0,0,1,1,-5,9,4,1,1,2,0,3,10,0,-4,4,4,0,-1,-1,1,-1,-1,6,-1
KR_6759647392,440,-2,-83,4,1,0,2,2,-2,3,1,6,0,6,-2,5,3,-1,2,1,2,1,3,-2,-3,5,-3,0,0,1,0,0,1,1,-1
KR_6739728330,440,-2,-96,40,-14,-4,5,1,4,1,5,-1,3,2,-9,9,0,-4,4,0,0,-16,21,1,-3,2,1,0,-1,1,1,1,-1,6,-1
KR_6754721825,420,-1,57,-32,1,-3,3,0,9,1,10,0,4,4,-5,8,3,0,1,1,0,2,198,2,-4,2,3,0,-1,-1,0,-1,1,1,-1
KR_6751241508,440,-2,-50,15,-7,-4,5,1,1,1,2,-8,10,2,2,4,6,2,1,3,0,-5,-10,-2,-2,4,-6,0,-2,-1,1,-1,-1,1,-1
KR_6738996978,420,0,24,4,-4,-3,5,2,0,2,2,0,2,2,-2,4,2,1,0,1,0,-5,-44,-1,-6,7,11,0,-1,-1,-1,-1,-1,4,-1
KR_6764707276,420,0,-26,20,-5,-2,2,0,1,1,2,-3,4,1,-2,2,0,1,0,1,0,-2,-8,-3,-2,5,2,0,0,-1,1,-1,-1,1,-1
KR_6759985115,420,-3,-48,8,-11,-1,2,1,-1,2,1,2,5,7,-5,6,1,-6,6,0,0,-11,-14,-5,-2,7,3,0,-1,-1,-1,-1,-1,1,-1
KR_6602428479,420,-4,-61,-9,-10,0,3,3,-7,7,0,-1,2,1,-3,3,0,1,0,1,-1,-9,-23,-3,-4,7,0,0,-2,-1,-1,-1,-1,2,-1
KR_6669925767,420,-1,35,31,-4,2,1,3,-7,8,1,0,1,1,0,2,2,1,2,3,0,-9,-20,-4,-1,5,-2,0,1,-1,0,1,-1,2,-1
KR_6698524617,420,-3,-66,23,-5,-1,3,2,4,1,5,-1,1,0,-8,9,1,1,1,2,2,-4,-5,-4,-2,6,-2,0,-3,-1,-1,-1,-1,2,-1
KR_6759063141,420,-4,77,-48,-11,0,0,0,-7,9,2,1,2,3,-3,5,2,-2,2,0,0,-9,128,2,-9,7,-1,0,2,-1,-1,1,-1,6,-1
KR_6729747503,420,0,-88,16,-4,-5,6,1,-2,5,3,0,2,2,1,1,2,2,1,3,0,-3,36,-3,-3,6,-1,0,-3,1,-1,-1,-1,5,-1
KR_6744961269,420,-1,6,-8,-7,-2,2,0,4,3,7,2,4,6,-4,4,0,-7,7,0,-1,-2,8,3,-8,5,-1,0,1,0,-1,1,-1,0,-1
KR_6764353375,440,-4,38,-2,-7,-1,3,2,-4,5,1,0,2,2,-3,3,0,1,0,1,0,-5,-1,3,-5,2,0,0,-1,-1,-1,-1,-1,5,-1
KR_6755781138,440,1,50,-5,-7,5,1,6,-5,6,1,0,1,1,-3,5,2,-4,5,1,0,-10,9,-2,-3,5,2,0,-1,-1,-1,1,-1,2,-1
KR_6749657329,420,1,-10,-13,2,2,0,2,-2,4,2,2,2,4,2,5,7,-2,5,3,0,5,15,7,-10,3,3,0,-1,-1,1,-1,-1,4,-1
KR_6732536230,440,-6,-68,-16,-22,0,1,1,-3,3,0,-4,5,1,-13,14,1,-2,2,0,0,-22,-2,-1,-2,3,1,0,-1,-1,-1,-1,-1,4,-1
KR_6668166726,420,-4,-67,-12,-4,1,4,5,-2,5,3,1,1,2,-4,6,2,0,0,0,0,-2,-10,-4,-2,6,-2,0,1,-1,1,-1,-1,3,-1
KR_6761635229,420,2,-18,9,-1,1,2,3,-4,4,0,1,5,6,1,3,4,0,1,1,0,-3,-16,3,-5,2,2,0,0,1,1,0,-1,3,-1
KR_6731555987,420,-3,16,-16,-13,-1,2,1,-3,3,0,-2,7,5,-6,7,1,-1,3,2,0,-16,33,2,-10,8,-6,0,-4,1,-1,-1,-1,1,-1
KR_6749861317,420,-4,8,-12,-5,4,1,5,-4,6,2,-2,4,2,-3,3,0,0,0,0,0,-10,103,0,-5,5,-3,0,-2,-1,-1,-1,-1,3,-1
KR_6761898664,440,-4,-88,-24,-13,-4,4,0,-3,4,1,4,0,4,-5,5,0,-5,5,0,0,-15,11,2,-9,7,-5,0,-1,-1,-1,-1,-1,1,-1
KR_6583210015,420,-4,-32,27,-12,-4,4,0,-6,6,0,1,5,6,-2,4,2,-1,1,0,-1,-15,18,-5,-1,6,4,0,0,1,-1,1,-1,3,-1
KR_6764820490,420,-3,-19,-21,-7,0,0,0,-3,3,0,-3,3,0,-1,4,3,0,0,0,0,-3,17,0,-6,6,-2,0,-1,1,-1,-1,-1,6,-1
KR_6717520980,420,0,-37,-10,2,-2,2,0,0,0,0,1,1,2,4,1,5,-1,1,0,0,4,-4,2,-9,7,-1,0,-1,-1,1,-1,-1,1,-1
KR_6667837277,420,-3,-49,-17,-7,2,1,3,-1,2,1,-2,3,1,-4,5,1,-2,2,0,-1,-8,2,3,-5,2,-4,0,-1,-1,0,-1,-1,3,-1
KR_6751078575,440,-6,-28,12,-14,0,2,2,-5,7,2,-4,7,3,-4,9,5,-1,4,3,0,-12,-22,1,-5,4,-2,0,-1,0,-1,-1,-1,0,-1
KR_6682793562,420,-5,-23,-21,-4,-4,4,0,-3,8,5,0,2,2,0,2,2,3,1,4,0,-7,-4,-3,-3,6,1,0,-1,-1,-1,-1,-1,6,-1
KR_6748598222,420,-1,-57,-4,3,4,0,4,3,2,5,0,1,1,0,4,4,-4,4,0,-1,0,24,-3,-3,6,-6,0,-1,-1,1,-1,-1,1,-1
KR_6747765790,420,-1,-13,-12,-5,-1,1,0,-5,6,1,-2,3,1,6,1,7,-3,3,0,0,-6,-23,5,-8,3,-2,0,0,1,1,1,-1,1,-1
KR_6645135231,420,-1,-5,4,2,2,0,2,0,4,4,3,2,5,-1,3,2,-2,2,0,0,2,-4,-5,-3,8,1,0,0,1,-1,0,1,4,-1
KR_6764055160,420,-3,-79,-19,-12,-1,2,1,-5,8,3,-4,6,2,-4,6,2,2,2,4,-1,-8,-1,-3,-6,9,-1,0,-5,-1,-1,-1,-1,6,-1
KR_6615919611,420,-7,-80,-43,-3,0,1,1,1,1,2,-4,5,1,-1,1,0,1,0,1,0,0,-32,-1,-4,5,0,0,0,-1,1,-1,1,5,-1
KR_6760761609,420,-1,56,-24,-1,0,1,1,-4,6,2,-1,2,1,2,3,5,2,0,2,0,4,50,1,-5,4,-14,0,1,-1,-1,1,-1,2,-1
KR_6439815666,420,-2,-43,-8,-1,-2,6,4,-1,2,1,-2,3,1,5,0,5,-1,2,1,-1,-4,2,3,-8,5,-1,0,-1,1,1,-1,-1,4,-1
KR_6762059424,420,-2,-9,-27,-4,1,3,4,-1,3,2,-3,4,1,-2,3,1,1,0,1,-1,-4,-22,-6,-2,8,3,0,0,-1,1,-1,-1,3,-1
KR_6491146552,420,-3,-60,32,-4,-2,3,1,0,2,2,-1,3,2,-1,3,2,0,0,0,0,1,6,-4,-4,8,1,0,0,1,-1,0,-1,5,-1
KR_6765184121,420,-8,-140,-27,-12,-5,5,0,-3,3,0,0,0,0,-3,7,4,-1,2,1,-1,-13,-24,-1,-4,5,0,0,-1,1,-1,-1,-1,6,-1
KR_6762823908,420,-2,-84,-8,-3,-1,3,2,3,0,3,-2,5,3,0,2,2,-3,3,0,1,5,-8,1,-6,5,-3,0,0,1,0,0,1,2,-1
KR_6740602623,420,3,20,-21,10,0,2,2,5,1,6,-1,1,0,4,2,6,2,2,4,0,10,5,4,-6,2,2,0,1,1,1,1,1,3,-1
KR_6600664519,420,-7,-83,-48,-19,0,1,1,-7,9,2,-6,7,1,-9,10,1,3,2,5,0,-15,-9,-8,-1,9,4,0,-2,-1,-1,-1,-1,3,-1
KR_6759564780,420,-1,35,24,-7,4,1,5,-2,4,2,-1,3,2,-6,6,0,-2,2,0,-1,-8,8,0,-3,3,1,0,3,1,1,1,-1,1,-1
KR_6759520245,420,-3,-54,-12,-1,0,1,1,-6,7,1,4,1,5,1,1,2,0,0,0,0,3,3,0,-8,8,-2,0,-1,-1,-1,-1,1,1,-1
KR_6621348519,420,-2,-60,-4,-2,-4,5,1,-1,6,5,2,1,3,1,3,4,0,0,0,0,-2,320,-1,-5,6,-1,0,0,1,-1,-1,1,2,-1
KR_6745905162,420,1,-39,-15,-6,-4,5,1,1,5,6,-2,2,0,-2,4,2,1,1,2,-3,-16,-3,6,-8,2,-5,0,-1,1,-1,-1,-1,1,-1
KR_6743916167,440,0,48,18,-2,-1,3,2,-2,3,1,-6,7,1,4,0,4,3,0,3,-1,3,8,2,-4,2,-4,0,1,-1,-1,1,-1,5,-1
KR_6751409980,440,-3,-59,-26,-6,3,1,4,-2,7,5,-1,3,2,-4,4,0,-2,3,1,0,-3,-3,3,-11,8,-3,0,0,1,-1,-1,1,5,-1
KR_6722357964,440,-1,-10,-3,0,1,1,2,-2,5,3,-1,1,0,2,1,3,0,0,0,0,5,22,-5,-4,9,9,0,-1,1,-1,-1,1,2,-1
KR_6761119969,420,1,26,12,-1,2,0,2,1,2,3,-2,4,2,-1,1,0,-1,1,0,-1,-10,149,-1,-6,7,-6,0,1,-1,-1,1,-1,3,-1
KR_6757212035,420,-3,-23,8,-8,1,2,3,-5,6,1,-2,3,1,-2,5,3,0,0,0,0,-8,0,-1,-3,4,2,0,1,1,1,1,-1,6,-1
KR_6682410441,420,-3,-52,4,-10,-5,5,0,-1,1,0,-2,4,2,0,2,2,-2,4,2,-1,-6,-6,-8,0,8,-7,0,-2,-1,-1,-1,-1,6,-1
KR_6602076252,420,-4,-76,-24,-9,0,2,2,0,2,2,-2,5,3,-5,5,0,-2,2,0,0,-11,-21,-6,-6,12,12,0,-1,-1,-1,-1,-1,1,-1
KR_6685325875,420,-2,-88,-5,-2,0,1,1,0,3,3,-2,4,2,2,1,3,-2,2,0,0,0,-10,1,-8,7,-3,0,-1,-1,-1,-1,-1,4,-1
KR_6719631733,420,0,-6,-31,-4,-1,3,2,-3,9,6,4,1,5,-4,6,2,0,0,0,0,-7,7,1,-5,4,1,0,0,-1,-1,0,-1,1,-1
KR_6698682523,420,0,6,0,-5,-5,5,0,-1,5,4,-4,4,0,6,2,8,-1,2,1,-1,-5,9,2,-9,7,-4,0,1,1,-1,1,-1,3,-1
KR_6659288607,420,2,58,-17,2,-2,2,0,1,3,4,1,3,4,2,1,3,0,1,1,0,8,-1,-2,-5,7,2,0,1,-1,-1,1,-1,3,-1
KR_6604114503,420,-2,-75,28,-3,1,0,1,0,5,5,-5,5,0,1,2,3,0,0,0,0,-3,-14,3,-8,5,0,0,-1,-1,1,-1,1,4,-1
KR_6744740260,420,-2,-27,21,-9,2,0,2,-3,5,2,-2,2,0,-5,5,0,-1,1,0,0,-17,-20,-1,-4,5,-4,0,0,-1,-1,-1,-1,6,-1
KR_6737176173,420,-2,-30,-8,0,1,1,2,5,0,5,-4,4,0,1,1,2,-3,4,1,1,1,-23,2,-6,4,-5,0,-1,-1,-1,-1,1,1,-1
KR_6763571502,420,-1,-60,-36,-3,-3,3,0,0,1,1,0,2,2,0,2,2,0,0,0,0,2,-1,1,-3,2,-3,0,-1,-1,-1,-1,1,4,-1
KR_6742046727,420,0,-33,16,-5,-4,6,2,-5,7,2,1,3,4,3,0,3,0,0,0,0,-3,26,2,-5,3,1,0,-3,-1,-1,-1,-1,3,-1
KR_6745485308,420,1,-10,-3,-7,-1,2,1,-1,3,2,-4,4,0,2,4,6,-3,4,1,0,-3,-146,-1,-3,4,-4,0,-1,-1,-1,-1,-1,6,-1
KR_6667783887,420,-3,-3,-51,-12,-1,3,2,-6,9,3,2,2,4,-5,5,0,-2,2,0,0,-6,-29,-3,-7,10,4,0,-1,-1,-1,-1,1,1,-1
KR_6744843707,420,-2,-3,0,-3,-3,4,1,2,3,5,-4,7,3,2,1,3,0,2,2,0,2,6,3,-7,4,-1,0,1,-1,1,1,-1,5,-1
KR_6764909404,420,-3,-6,-21,1,1,2,3,1,1,2,-5,8,3,2,0,2,2,0,2,0,-5,1,4,-8,4,-1,0,0,1,-1,-1,1,1,-1
KR_6751441125,420,1,8,-11,6,3,0,3,-4,7,3,-3,4,1,7,0,7,3,0,3,0,-3,-16,3,-11,8,8,0,2,1,1,1,1,3,-1
KR_6763692703,420,0,-48,28,-3,-4,4,0,-3,6,3,2,2,4,3,0,3,-1,1,0,-1,-7,6,0,-5,5,3,0,-1,-1,-1,-1,-1,3,-1
KR_6763665545,420,-2,-57,-38,-2,0,0,0,1,1,2,0,2,2,-3,8,5,0,1,1,0,4,-2,-1,-7,8,1,0,0,1,-1,-1,-1,3,-1
KR_6634570969,420,0,26,-7,-5,-2,3,1,0,4,4,-1,2,1,-2,3,1,0,1,1,0,-1,64,3,-7,4,-28,0,0,-1,-1,1,-1,5,-1
KR_6758864688,420,-5,-80,2,-10,-1,3,2,-3,3,0,-3,5,2,-2,4,2,-1,2,1,0,-8,-2,-1,-4,5,-3,0,-5,0,1,-1,-1,0,-1
KR_6754196364,420,-1,-26,-5,-6,2,0,2,-1,4,3,-5,7,2,-4,4,0,2,0,2,0,-3,-5,-1,-3,4,-4,0,0,-1,1,0,-1,5,-1
KR_6758601924,420,-3,4,-8,-11,-2,4,2,-2,4,2,-1,3,2,-4,5,1,-2,3,1,0,-12,-10,-8,-1,9,0,0,-3,0,-1,-1,1,0,-1
KR_6764235704,420,0,26,12,-6,1,1,2,-3,4,1,3,2,5,-3,3,0,-4,4,0,0,0,2,5,-8,3,1,0,-1,-1,1,-1,1,1,-1
KR_6743254358,440,-2,-32,18,-3,-4,5,1,-1,2,1,-2,3,1,2,1,3,2,0,2,0,-5,14,-1,-5,6,-3,0,1,1,-1,1,-1,2,-1
KR_6617774243,420,-1,-44,23,-4,-1,2,1,1,5,6,-1,4,3,-3,5,2,0,1,1,-2,0,-51,-1,-3,4,2,0,-2,1,-1,-1,-1,4,-1
KR_6679649379,420,-2,-5,6,-7,4,0,4,-5,8,3,-3,4,1,-2,4,2,-1,1,0,0,-17,2,-1,-3,4,-2,0,0,-1,-1,0,-1,4,-1
KR_6755409727,420,-1,44,-24,0,1,0,1,2,1,3,-5,5,0,0,3,3,2,0,2,0,1,-1,1,-4,3,0,0,0,-1,-1,1,1,6,-1
KR_6761863216,420,-5,33,-35,-11,-5,5,0,0,2,2,-6,7,1,-1,3,2,1,1,2,0,-10,-27,-4,-3,7,0,0,-2,-1,-1,-1,-1,4,-1
KR_6413539774,420,0,1,12,-5,-3,3,0,-6,7,1,0,2,2,3,1,4,1,0,1,0,-4,-7,-2,-8,10,6,0,0,-1,-1,0,1,3,-1
KR_6740849283,420,0,-47,5,3,2,1,3,3,2,5,-1,5,4,-1,3,2,0,0,0,0,-4,11,6,-10,4,-6,0,1,-1,1,1,1,5,-1
KR_6763625349,420,0,-52,25,-4,2,1,3,-4,4,0,1,2,3,-2,4,2,-1,1,0,-1,-2,1,-3,-2,5,0,0,-1,-1,-1,-1,-1,4,-1
KR_6740197591,420,-2,-3,8,-12,-3,3,0,-5,6,1,3,0,3,-3,4,1,-4,6,2,-1,-14,38,0,-4,4,-21,0,-2,-1,1,-1,-1,5,-1
KR_6669146905,420,-4,-32,-12,0,-5,5,0,-1,4,3,3,2,5,3,0,3,0,0,0,0,1,-17,5,-7,2,0,0,0,-1,1,1,1,3,-1
KR_6612550160,420,-3,-11,-40,0,0,2,2,-1,3,2,1,2,3,0,0,0,0,0,0,0,-11,0,2,-9,7,0,0,0,-1,1,0,-1,5,-1
KR_6761881666,420,1,-3,-9,-2,4,1,5,1,1,2,-5,5,0,1,3,4,-3,6,3,0,-8,12,7,-9,2,-4,0,1,-1,1,1,-1,1,-1
KR_6755322140,420,1,-17,-32,0,0,1,1,1,3,4,-1,1,0,1,8,9,-1,1,0,0,-1,19,-2,-3,5,1,0,-1,-1,-1,-1,-1,4,-1
KR_6754320940,420,2,-15,-12,5,-1,2,1,-4,4,0,1,0,1,6,4,10,3,1,4,0,5,0,-3,-5,8,-4,0,0,-1,-1,-1,1,4,-1
KR_6729449829,420,-8,-65,-36,-20,-1,3,2,-3,3,0,-9,9,0,-4,5,1,-3,3,0,-1,-14,-15,-6,-1,7,3,0,0,-1,1,-1,-1,5,-1
KR_6637704972,420,-2,-42,-33,1,-1,3,2,2,4,6,-4,5,1,2,4,6,2,0,2,0,7,8,-2,-4,6,-2,0,0,-1,-1,-1,1,2,-1
KR_6735460743,420,0,2,31,-3,-5,6,1,0,1,1,-1,3,2,3,1,4,0,0,0,0,-4,7,1,-5,4,1,0,0,-1,-1,0,1,5,-1
KR_6727691727,420,-8,-32,-4,-12,-4,4,0,-1,2,1,-6,6,0,0,5,5,-1,1,0,0,-9,9,4,-8,4,-4,0,0,-1,-1,-1,-1,1,-1
KR_6751124889,420,-1,50,-36,4,-1,3,2,-1,3,2,0,2,2,6,0,6,0,0,0,0,5,-11,-5,-3,8,8,0,0,-1,-1,0,1,4,-1
KR_6762866755,420,0,-8,-31,0,3,2,5,-7,7,0,0,1,1,3,1,4,1,0,1,0,3,8,-4,-2,6,3,0,-1,-1,-1,-1,1,2,-1
KR_6747734683,420,-3,17,-22,-5,0,2,2,-4,5,1,1,0,1,-1,3,2,-1,1,0,-1,-9,-9,-2,-2,4,-2,0,-1,-1,1,-1,-1,5,-1
KR_6675051092,420,-5,-110,11,-15,-8,8,0,-4,6,2,0,4,4,-6,7,1,3,0,3,0,-8,-42,-4,-2,6,0,0,-3,-1,1,-1,-1,6,-1
KR_6753808737,420,-2,-36,-7,-3,2,2,4,-1,3,2,-4,4,0,-2,4,2,2,2,4,0,-3,-1,2,-6,4,-1,0,-1,-1,1,-1,1,3,-1
KR_6731894597,420,-6,-13,-8,-12,-2,3,1,-1,5,4,-3,3,0,-5,5,0,-1,1,0,0,-8,8,3,-7,4,-5,0,0,-1,1,-1,-1,2,-1
KR_6755423279,420,-3,-52,19,-13,-1,2,1,-4,5,1,-1,6,5,-6,8,2,-1,1,0,0,-21,0,2,-8,6,2,0,0,-1,-1,-1,-1,3,-1
KR_6683415051,440,-3,-66,-17,-13,4,1,5,-5,5,0,-2,3,1,-6,8,2,-4,4,0,-1,-10,-5,-3,-3,6,1,0,-1,-1,0,-1,-1,1,-1
KR_6751615301,420,-6,10,-32,-16,-1,2,1,0,1,1,-1,2,1,-14,17,3,0,0,0,-1,-19,-7,1,-3,2,1,0,-1,1,0,-1,-1,3,-1
KR_6759671656,440,-5,-118,-25,-10,-3,6,3,-3,3,0,4,1,5,-9,9,0,1,0,1,0,-8,-4,-1,-2,3,-3,0,-3,-1,-1,-1,-1,1,-1
KR_6764168791,420,-1,-36,0,-6,-2,5,3,-1,3,2,-1,4,3,-1,3,2,-1,1,0,1,-2,-4,-1,-7,8,-7,0,0,1,1,0,1,6,-1
KR_6764482323,420,3,49,-6,5,2,2,4,5,4,9,-4,4,0,-2,5,3,4,0,4,0,5,3,2,-4,2,-3,0,0,-1,-1,1,1,4,-1
KR_6761443532,420,-6,-135,6,-10,-2,4,2,-1,3,2,2,2,4,-7,8,1,-2,2,0,0,-11,-2,-1,-4,5,0,0,-3,-1,-1,-1,-1,1,-1
KR_6683226464,420,-2,-91,0,-14,-3,4,1,-2,4,2,-3,4,1,-5,5,0,-1,2,1,0,-11,-5,-1,-4,5,-3,0,-1,-1,-1,-1,-1,1,-1
KR_6761419249,420,-3,-33,-11,-10,1,2,3,-5,8,3,-6,6,0,-4,5,1,4,1,5,-2,-14,9,4,-8,4,-6,0,-1,-1,-1,-1,-1,2,-1
KR_6700342284,420,-5,-15,-20,-10,4,0,4,-9,10,1,-2,3,1,-1,2,1,-2,2,0,0,-17,0,-6,-5,11,2,0,1,1,1,1,1,4,-1
KR_6667199032,420,-4,-5,1,-8,-3,4,1,2,0,2,-4,5,1,-2,3,1,-1,3,2,0,-3,0,-2,-5,7,1,0,-1,1,0,-1,1,5,-1
KR_6763815039,420,-1,0,-15,-1,0,3,3,-1,3,2,-1,2,1,4,3,7,-3,3,0,0,-5,2,-4,-5,9,-4,0,0,1,1,1,1,3,-1
KR_6757133931,420,2,-4,4,11,-1,3,2,0,4,4,7,0,7,5,0,5,0,0,0,0,12,-16,0,-3,3,-4,0,0,-1,1,0,1,2,-1
KR_6747355572,420,-3,4,-18,-5,-2,4,2,1,2,3,1,1,2,-6,7,1,1,1,2,1,-1,-9,-1,-5,6,7,0,-1,-1,1,-1,1,5,-1
KR_6764446190,420,1,-40,0,5,0,1,1,1,0,1,3,0,3,2,0,2,-1,1,0,0,4,-2,-3,-6,9,4,0,0,1,1,0,1,4,-1
KR_6758692677,440,-1,-6,16,0,-1,2,1,0,0,0,1,1,2,4,0,4,-4,6,2,-1,7,138,-1,-4,5,14,0,-1,1,-1,-1,-1,5,-1
KR_6764250433,420,-4,5,-20,2,-1,4,3,2,0,2,2,1,3,-1,2,1,0,1,1,0,0,4,2,-8,6,4,0,0,1,1,0,1,4,-1
KR_6738530703,420,0,11,-2,-6,4,2,6,-2,2,0,0,2,2,-7,7,0,-1,1,0,0,-11,-48,-1,-4,5,14,0,1,1,1,1,-1,5,-1
KR_6646389359,420,3,66,17,0,0,1,1,-1,2,1,-1,3,2,0,1,1,2,2,4,0,-1,4,-2,-6,8,-5,0,0,-1,1,1,1,5,-1
KR_6642577132,420,0,21,-20,3,0,4,4,4,5,9,0,2,2,-2,4,2,1,2,3,0,6,-1,0,-4,4,1,0,-1,-1,-1,-1,-1,1,-1
KR_6737145376,420,2,-23,16,-2,-3,3,0,1,0,1,-1,3,2,0,1,1,1,1,2,0,6,3,-2,-5,7,0,0,0,0,1,0,-1,0,-1
KR_6715704609,420,-1,-57,33,-2,0,2,2,1,1,2,0,3,3,-2,3,1,-1,1,0,1,0,26,0,-6,6,3,0,-2,0,-1,-1,1,0,-1
KR_6756435730,420,1,66,5,6,-2,3,1,0,2,2,1,1,2,4,3,7,3,0,3,0,10,22,-2,-3,5,0,0,-3,1,-1,-1,1,2,-1
KR_6699356876,420,2,-15,30,1,1,1,2,2,2,4,1,3,4,-4,4,0,1,1,2,1,-2,141,0,-5,5,2,0,-1,-1,1,-1,1,4,-1
KR_6713206157,420,-2,-57,-18,1,-1,2,1,3,0,3,0,2,2,1,6,7,-2,3,1,0,7,7,0,-6,6,1,0,-1,-1,1,-1,-1,4,-1
KR_6758890855,420,-5,-13,-4,-8,-1,1,0,2,2,4,-1,3,2,-7,8,1,-1,1,0,0,-6,0,0,-5,5,-6,0,-1,-1,0,-1,1,2,-1
KR_6746473871,420,-4,-4,-40,-4,1,2,3,1,2,3,-2,5,3,-4,5,1,0,0,0,0,2,7,2,-7,5,-2,0,-1,-1,1,-1,-1,3,-1
KR_6761261893,440,-3,-72,-8,0,-2,3,1,1,1,2,1,2,3,0,0,0,0,0,0,0,2,18,-1,-3,4,-2,0,0,-1,1,-1,1,3,-1
KR_6760016865,420,0,14,5,4,0,2,2,-1,1,0,6,2,8,-1,3,2,0,1,1,0,2,-3,0,-5,5,3,0,0,1,-1,0,1,1,-1
KR_6677637099,420,-4,-20,6,-9,-2,2,0,-2,5,3,-2,4,2,-4,5,1,1,0,1,0,-6,1,2,-7,5,4,0,-1,1,-1,-1,1,3,-1
KR_6646441551,420,-4,15,3,-6,-1,2,1,-4,7,3,0,2,2,1,0,1,-2,3,1,0,-8,-25,4,-8,4,2,0,0,0,1,-1,1,0,-1
KR_6750305450,420,-1,-10,-19,0,-1,2,1,1,2,3,-1,1,0,2,1,3,-1,1,0,-1,6,-118,0,-9,9,2,0,0,0,-1,0,-1,0,-1
KR_6632488038,420,1,-54,-12,1,-2,2,0,2,0,2,-1,1,0,1,3,4,1,1,2,0,2,6,2,-8,6,-2,0,0,-1,-1,0,1,6,-1
KR_6612392798,440,-1,-47,19,-3,0,2,2,3,1,4,-1,1,0,-4,5,1,-1,1,0,0,-2,26,0,-8,8,-8,0,0,-1,1,0,1,4,-1
KR_6765532031,420,-7,-6,-20,-12,-2,3,1,-3,3,0,0,2,2,-5,5,0,-2,2,0,0,-8,1,1,-3,2,-1,0,-2,-1,-1,-1,-1,3,-1
KR_6698798047,420,-3,-45,-12,-5,-1,4,3,-2,5,3,-3,5,2,1,2,3,0,1,1,0,-9,-2,-3,-2,5,-3,0,0,-1,-1,1,-1,3,-1
KR_6730881762,420,1,-11,16,-4,-2,4,2,1,2,3,-2,2,0,-1,3,2,0,0,0,-1,-3,47,3,-9,6,-4,0,0,1,1,0,-1,4,-1
KR_6751343318,420,-3,-12,-3,-9,-2,2,0,-6,6,0,-1,1,0,1,3,4,-1,2,1,0,-7,-15,-1,-4,5,2,0,-2,1,-1,-1,1,2,-1
KR_6637680958,420,3,-3,8,6,1,2,3,5,0,5,2,2,4,-2,9,7,0,0,0,1,12,7,4,-6,2,-2,0,1,1,1,1,1,4,-1
KR_6691208198,420,4,16,-20,1,3,0,3,-3,4,1,1,0,1,0,0,0,0,1,1,0,8,1,-3,-4,7,1,0,1,0,0,-1,-1,0,-1
KR_6711876480,420,-1,-19,-34,2,-2,2,0,-3,4,1,2,2,4,6,1,7,-1,1,0,1,5,7,4,-8,4,-5,0,-1,-1,-1,-1,1,4,-1
KR_6746095122,420,0,-7,20,0,2,2,4,-1,2,1,-1,4,3,1,1,2,-1,1,0,0,-3,3,-1,-6,7,-3,0,0,-1,1,0,-1,3,-1
KR_6716208963,420,-5,-41,-24,-7,2,3,5,1,1,2,-6,7,1,-4,6,2,0,0,0,1,-3,-25,-2,-2,4,0,0,0,-1,-1,1,1,3,-1
KR_6742388037,420,-1,-2,-10,-1,1,1,2,-1,4,3,-5,6,1,3,1,4,1,0,1,0,-1,-3,0,-8,8,2,0,0,1,-1,-1,-1,5,-1
KR_6634136428,420,0,12,23,-4,2,2,4,1,1,2,-1,1,0,-4,4,0,-2,3,1,0,-6,-32,0,-6,6,8,0,0,-1,-1,0,-1,1,-1
KR_6747320437,440,2,33,-3,8,2,4,6,3,2,5,-5,6,1,5,0,5,3,0,3,0,7,8,1,-2,1,-2,0,1,1,1,1,1,3,-1
KR_6603909570,420,-2,13,-28,-5,2,3,5,-3,5,2,-1,3,2,-3,6,3,0,1,1,0,-5,-17,3,-6,3,-3,0,-1,-1,1,-1,-1,4,-1
KR_6761810911,420,-1,-47,0,1,-3,3,0,3,0,3,1,0,1,0,1,1,0,0,0,0,2,10,-2,-4,6,-3,0,0,1,-1,0,1,6,-1
KR_6753284323,420,-4,-24,0,-10,0,1,1,0,1,1,-8,9,1,-1,7,6,-1,1,0,2,2,25,-2,-5,7,-5,0,-1,-1,1,-1,1,5,-1
KR_6759345992,420,6,69,8,10,3,2,5,1,1,2,2,2,4,1,5,6,3,1,4,-1,8,118,-4,-6,10,2,0,2,1,-1,1,-1,4,-1
KR_6615518024,420,-1,-39,-3,0,1,0,1,-2,8,6,2,2,4,-1,3,2,0,0,0,0,-9,-19,-2,-6,8,1,0,0,-1,1,0,-1,1,-1
KR_6186112151,420,-2,-13,-21,-6,1,0,1,-6,7,1,-2,3,1,1,0,1,0,0,0,0,-4,2,0,-6,6,-2,0,0,-1,1,-1,-1,4,-1
KR_6715573562,420,1,1,8,-6,-1,1,0,0,2,2,-2,3,1,-3,4,1,0,1,1,0,-2,-11,-2,-3,5,4,0,-1,-1,1,-1,-1,3,-1
KR_6744684263,420,-1,-11,-4,-7,-3,4,1,-1,3,2,1,2,3,-3,5,2,-1,2,1,-1,-10,5,-1,-3,4,-1,0,1,-1,1,1,-1,3,-1
KR_6764056895,420,-5,-59,-8,-18,-10,11,1,-2,4,2,-3,3,0,0,5,5,-3,3,0,-1,-10,-23,-3,-6,9,7,0,-1,-1,-1,-1,-1,6,-1
KR_6615613230,420,-1,-51,0,-4,2,1,3,1,3,4,-1,2,1,-6,8,2,0,0,0,0,-5,-4,-3,-3,6,-5,0,-1,-1,-1,-1,-1,3,-1
KR_6759745477,420,-4,-31,-15,-13,2,0,2,-2,2,0,-8,8,0,-4,5,1,-1,2,1,-2,-20,5,3,-5,2,-6,0,-2,-1,-1,-1,-1,6,-1
KR_6719721880,420,-1,-85,-7,-2,-3,3,0,0,3,3,4,3,7,-3,6,3,0,0,0,0,-2,2,2,-4,2,-6,0,-1,-1,1,-1,-1,2,-1
KR_6652048736,420,-1,-39,1,-4,-2,2,0,0,3,3,-1,4,3,-1,1,0,0,0,0,0,-1,-16,1,-8,7,4,0,0,-1,-1,0,-1,5,-1
KR_6754283553,420,1,42,-27,1,-2,4,2,1,1,2,1,1,2,1,4,5,0,0,0,0,-1,-15,1,-9,8,-1,0,-2,1,-1,-1,1,6,-1
KR_6379720497,420,-2,-45,7,1,2,1,3,2,4,6,-2,4,2,0,4,4,-1,1,0,0,-7,4,2,-5,3,-3,0,0,1,0,0,-1,3,-1
KR_6670323623,420,2,84,26,-2,1,1,2,-2,6,4,-1,4,3,2,2,4,-2,3,1,0,-3,23,-5,-4,9,10,0,0,0,-1,0,-1,0,-1
KR_6740498269,420,-2,1,-9,0,2,2,4,-2,2,0,1,3,4,0,1,1,-1,2,1,0,2,-2,-3,-6,9,3,0,-1,1,-1,-1,1,4,-1
KR_6692672302,420,-1,-79,28,1,-4,4,0,1,4,5,5,2,7,-2,6,4,1,0,1,2,7,-8,1,-6,5,2,0,-1,1,-1,-1,1,6,-1
KR_6761792154,420,-1,-38,16,-3,-1,3,2,-2,4,2,1,3,4,-1,5,4,0,2,2,0,-11,-52,-4,-3,7,13,0,-1,1,-1,-1,-1,2,-1
KR_6747920722,440,-5,-61,-11,-9,2,2,4,-1,1,0,2,2,4,-10,10,0,-2,2,0,0,-5,-64,7,-8,1,-8,0,-2,-1,-1,-1,-1,1,-1
KR_6683668220,420,0,-83,-23,7,0,3,3,5,1,6,3,0,3,-1,4,3,0,2,2,0,6,13,4,-7,3,2,0,0,-1,1,0,1,2,-1
KR_6753684534,440,-2,-36,56,-10,-1,1,0,0,1,1,0,1,1,-5,5,0,-4,4,0,0,-11,8,-2,-5,7,-5,0,1,1,-1,1,-1,1,-1
KR_6643467092,420,1,-90,0,0,-2,3,1,0,2,2,1,0,1,0,2,2,1,1,2,1,9,48,2,-8,6,-28,0,-1,-1,-1,-1,1,5,-1
KR_6721804841,420,0,-42,-4,-2,0,0,0,-2,6,4,1,0,1,-3,5,2,2,1,3,0,-8,1,-3,-5,8,-7,0,-1,-1,1,-1,-1,1,-1
KR_6698796305,420,-1,-40,28,-10,-1,1,0,-4,6,2,0,0,0,-3,4,1,-2,3,1,0,-10,111,-10,-2,12,4,0,1,-1,-1,1,1,3,-1
KR_6750492206,420,1,-40,-13,-3,1,0,1,-3,4,1,-1,2,1,-1,1,0,1,0,1,0,-5,-4,-2,-5,7,-9,0,-1,-1,0,-1,1,2,-1
KR_6728974235,420,-2,-22,-27,-2,0,3,3,-1,7,6,1,0,1,-1,2,1,-1,1,0,0,2,-1,-4,-3,7,-2,0,0,0,1,0,1,0,-1
KR_6760445448,420,-2,-32,-4,-12,-1,4,3,-3,3,0,-4,5,1,-1,3,2,-3,4,1,-1,-9,-7,-5,-3,8,-3,0,-4,-1,-1,-1,-1,2,-1
KR_6751380961,420,3,-5,8,4,0,3,3,7,0,7,-1,3,2,-4,7,3,2,0,2,1,6,5,0,-6,6,0,0,0,1,1,1,1,4,-1
KR_6762650446,420,-2,-50,-22,-9,3,0,3,0,4,4,1,1,2,-10,10,0,-3,3,0,-1,-7,-42,-4,-3,7,21,0,1,-1,1,1,-1,2,-1
KR_6432010138,440,-1,4,19,-9,0,6,6,-2,3,1,-2,5,3,-3,4,1,-2,4,2,0,-4,3,1,-4,3,-6,0,-1,-1,1,-1,-1,5,-1
KR_6646538131,420,-4,-39,15,-7,1,1,2,1,2,3,-4,6,2,-3,4,1,-2,3,1,0,-4,-4,-2,-2,4,-2,0,-1,-1,-1,-1,1,4,-1
KR_6762479152,420,-3,-51,-24,-10,-3,4,1,1,2,3,-2,4,2,-5,6,1,-1,2,1,0,-14,-4,-6,0,6,5,0,-1,-1,-1,-1,1,2,-1
KR_6684322248,420,-5,13,-49,-7,-5,6,1,-1,4,3,0,2,2,-1,1,0,0,1,1,0,-4,3,-1,-4,5,2,0,-1,1,-1,-1,-1,3,-1
KR_6763023105,420,-1,1,-52,-4,2,0,2,-1,4,3,-3,3,0,0,2,2,-2,3,1,0,-9,-109,3,-10,7,-5,0,-1,-1,-1,-1,1,6,-1
KR_6762628597,420,-1,-55,4,-3,-3,3,0,-2,4,2,1,3,4,-2,5,3,3,1,4,0,-1,14,-1,-4,5,-2,0,0,1,-1,0,1,5,-1
KR_6741718595,420,2,-41,12,-5,-7,7,0,2,1,3,1,1,2,-1,1,0,0,0,0,0,-1,107,-2,-4,6,1,0,-2,-1,-1,-1,1,2,-1
KR_6761232535,420,-2,-28,-28,-5,1,0,1,1,3,4,1,6,7,-6,7,1,-2,2,0,0,8,4,3,-7,4,-6,0,0,-1,-1,-1,-1,3,-1
KR_6739339660,420,0,0,-8,8,3,2,5,3,1,4,-2,2,0,2,1,3,2,0,2,0,16,2,0,-1,1,2,0,0,-1,1,0,1,5,-1
KR_6751404692,440,-2,-2,-13,-5,-1,2,1,3,1,4,-2,2,0,1,3,4,-6,6,0,-1,-3,2,-2,-5,7,-2,0,-1,0,-1,-1,-1,0,-1
KR_6725846232,420,1,6,6,3,2,0,2,1,1,2,0,1,1,2,2,4,-2,2,0,0,7,-6,-3,-5,8,5,0,0,-1,-1,0,-1,5,-1
KR_6758409388,420,-3,2,-20,-3,0,0,0,-3,4,1,0,1,1,0,3,3,0,3,3,1,3,-18,-1,-3,4,0,0,0,0,-1,-1,1,0,-1
KR_6494708439,420,-4,-58,-17,-10,3,0,3,-3,6,3,-1,2,1,-8,8,0,-1,1,0,0,-21,-146,-1,-4,5,2,0,-2,-1,-1,-1,-1,2,-1
KR_6755954620,420,-4,-33,16,-7,-5,6,1,0,1,1,1,0,1,1,3,4,-4,4,0,0,-4,-5,-2,-2,4,1,0,-1,-1,-1,-1,-1,3,-1
KR_6761689127,420,-3,-117,-7,-11,-3,4,1,0,3,3,0,3,3,-9,9,0,1,0,1,-2,-14,-5,2,-8,6,-3,0,-3,1,1,-1,-1,1,-1
KR_6332057582,420,-3,5,-3,-8,1,1,2,-3,6,3,-2,2,0,-3,4,1,-1,2,1,0,-9,-8,4,-8,4,-2,0,0,-1,1,0,-1,3,-1
KR_6686910590,420,0,-13,-8,1,0,1,1,-3,4,1,-1,3,2,3,2,5,2,0,2,0,1,2,0,-5,5,1,0,0,-1,1,0,-1,5,-1
KR_6660314850,420,1,6,-8,3,-2,4,2,-3,3,0,4,0,4,3,2,5,1,0,1,0,5,-8,4,-8,4,3,0,0,1,1,0,-1,5,-1
KR_6756912258,420,3,19,-7,0,0,2,2,0,2,2,-1,5,4,0,1,1,1,0,1,0,-2,8,3,-7,4,-2,0,-1,-1,1,-1,1,3,-1
KR_6765346513,420,-2,-30,4,-10,-2,4,2,0,2,2,-3,4,1,-3,6,3,-2,2,0,0,-16,-104,-1,-6,7,2,0,0,-1,1,0,-1,1,-1
KR_6762838824,420,-1,32,4,-12,-1,3,2,-5,6,1,-1,1,0,-5,8,3,0,0,0,0,-22,-96,-2,-4,6,-4,0,-1,-1,-1,-1,-1,2,-1
KR_6745138255,440,-9,-102,-54,-17,1,1,2,-7,7,0,-2,4,2,-3,5,2,-6,7,1,-1,-9,-23,4,-6,2,-5,0,-4,1,-1,-1,-1,4,-1
KR_6581999021,420,-3,-20,-23,0,-2,2,0,1,1,2,4,0,4,-5,9,4,2,1,3,-1,-1,-38,4,-9,5,0,0,-2,-1,-1,-1,-1,5,-1
KR_6598670935,420,4,83,4,1,-4,4,0,4,4,8,-1,2,1,0,3,3,2,0,2,0,1,-10,-5,-2,7,11,0,0,1,-1,0,-1,2,-1
KR_6681940201,420,1,17,34,-6,-2,2,0,7,2,9,-5,6,1,-4,5,1,-2,2,0,0,-5,-9,-3,-4,7,0,0,0,1,1,1,1,5,-1
KR_6747990018,420,-3,-65,16,-1,3,0,3,-5,5,0,3,0,3,-2,4,2,0,0,0,0,-5,14,4,-8,4,0,0,-2,1,0,-1,1,1,-1
KR_6762802496,420,-1,-22,-17,-2,2,0,2,-6,7,1,-2,3,1,3,2,5,1,0,1,0,-8,3,3,-8,5,-3,0,0,1,-1,-1,-1,4,-1
KR_6761764756,440,-1,-66,-6,0,0,2,2,0,2,2,-1,3,2,2,1,3,-1,4,3,0,0,-8,-1,-4,5,1,0,-2,-1,-1,-1,-1,6,-1
KR_6752832007,420,-5,-63,-29,-5,-3,4,1,3,2,5,-5,5,0,-2,4,2,2,1,3,0,-1,-1,-5,-1,6,-5,0,-1,1,-1,-1,-1,3,-1
KR_6761918548,420,-2,45,-5,-4,-1,2,1,-3,5,2,-2,4,2,0,4,4,2,2,4,-1,-2,-100,-1,-3,4,1,0,1,-1,-1,1,-1,1,-1
KR_6759127970,420,-3,-36,-32,-5,-5,5,0,1,2,3,2,2,4,0,4,4,-3,3,0,0,-4,7,1,-7,6,-6,0,-2,1,-1,-1,1,1,-1
KR_6765054206,420,-2,18,8,-6,-2,3,1,-1,3,2,-3,6,3,-2,2,0,2,0,2,0,-7,21,-3,-8,11,1,0,1,1,-1,-1,1,5,-1
KR_6640134507,420,-3,-27,-12,-7,-1,3,2,-3,3,0,-1,2,1,-2,3,1,0,0,0,0,-4,2,3,-8,5,-7,0,-1,-1,-1,-1,-1,4,-1
KR_6758060574,420,-5,-41,-32,-7,-4,4,0,-3,5,2,-3,3,0,3,3,6,0,0,0,0,-3,0,1,-7,6,-1,0,-3,1,-1,-1,-1,1,-1
KR_6590599375,420,2,19,-19,8,2,3,5,-1,1,0,4,0,4,1,3,4,2,0,2,0,8,-8,2,-5,3,-4,0,0,1,1,1,-1,4,-1
KR_6747338864,420,-4,47,-12,-6,-1,1,0,-4,4,0,-1,2,1,5,2,7,-5,5,0,0,-8,-4,1,-7,6,0,0,2,1,1,1,1,4,-1
KR_6761368106,420,2,0,-10,-2,3,1,4,3,1,4,-3,4,1,-5,6,1,0,1,1,0,-6,-16,-9,-1,10,4,0,-1,-1,1,1,-1,3,-1
KR_6745494744,420,-3,-61,-6,-16,-2,4,2,-4,4,0,-2,3,1,-5,5,0,-3,3,0,-1,-7,19,0,-7,7,-2,0,-1,1,-1,-1,-1,6,-1
KR_6748317015,420,0,-36,9,7,0,4,4,-1,2,1,7,1,8,-2,4,2,3,0,3,0,10,12,-1,-5,6,3,0,1,-1,1,1,1,2,-1
KR_6747562368,420,-4,-39,-42,-14,-3,4,1,-7,11,4,-1,1,0,-4,5,1,1,1,2,-1,-12,4,0,-5,5,-2,0,-1,-1,-1,-1,1,3,-1
KR_6658019107,420,-4,-60,-8,-3,-1,3,2,1,3,4,-4,5,1,5,4,9,-4,5,1,0,3,-1,2,-5,3,-4,0,-2,-1,-1,-1,-1,6,-1
KR_6755967440,420,-4,-79,11,-4,0,4,4,-1,3,2,1,1,2,-6,6,0,2,1,3,-1,-1,22,-5,-1,6,-1,0,-2,-1,-1,-1,-1,3,-1
KR_6763940311,420,1,-64,19,3,-5,5,0,4,3,7,1,2,3,1,1,2,2,0,2,0,13,-16,-3,-2,5,1,0,-1,1,1,-1,-1,6,-1
KR_6748481351,420,-1,-2,-2,-4,-3,3,0,0,1,1,-3,4,1,2,2,4,0,1,1,1,1,2,1,-6,5,-6,0,0,-1,1,0,1,5,-1
KR_6661451059,420,3,28,4,2,4,0,4,0,2,2,-1,4,3,-1,4,3,0,0,0,0,4,6,-1,-6,7,-2,0,0,1,-1,-1,-1,1,-1
KR_6743628533,440,-2,0,29,-8,-1,3,2,-3,7,4,0,6,6,-6,7,1,2,1,3,-1,-11,1,-4,-3,7,1,0,0,1,-1,-1,-1,3,-1
KR_6747103160,420,-2,-28,24,-8,-6,6,0,-3,4,1,0,0,0,2,3,5,-1,1,0,0,-5,-9,-4,-2,6,-1,0,0,-1,0,-1,-1,1,-1
KR_6751893561,420,-1,-99,-3,-3,0,3,3,0,2,2,0,4,4,-4,4,0,1,0,1,0,-1,3,4,-7,3,1,0,0,-1,-1,-1,-1,5,-1
KR_6743091156,420,-1,22,13,-5,1,3,4,-6,11,5,4,0,4,0,4,4,-4,4,0,0,-2,-7,-2,-5,7,0,0,-1,1,-1,-1,1,4,-1
KR_6765139394,420,-4,21,4,-11,6,1,7,-4,5,1,-10,11,1,-4,4,0,1,0,1,0,-12,-10,-2,-4,6,-3,0,-1,1,-1,1,1,5,-1
KR_6762139349,420,-4,-47,-12,-11,-1,2,1,1,0,1,-7,7,0,-4,4,0,0,2,2,0,-15,0,-3,-5,8,-6,0,-2,-1,-1,-1,-1,5,-1
KR_6600133873,420,-1,-10,16,-6,1,2,3,-2,5,3,0,3,3,-4,8,4,-1,1,0,0,-17,-1,-7,-3,10,-2,0,0,0,-1,0,-1,0,-1
KR_6735045452,420,-2,-19,24,-7,-2,3,1,-2,4,2,-2,2,0,1,2,3,-2,4,2,0,-11,-10,-4,-2,6,3,0,-1,-1,-1,-1,-1,2,-1
KR_6679300622,420,0,-30,-14,-2,-1,1,0,0,1,1,2,0,2,-2,3,1,-1,2,1,0,3,-9,-3,-7,10,0,0,0,1,-1,-1,-1,3,-1
KR_6763811638,440,-1,-66,-36,-3,-2,4,2,-2,2,0,5,1,6,-6,6,0,2,1,3,0,-11,80,1,-8,7,0,0,-1,-1,1,1,-1,4,-1
KR_6763889064,420,-5,-76,-52,-13,2,2,4,-3,3,0,-2,5,3,-9,11,2,-1,2,1,0,-16,-38,-3,-3,6,3,0,-1,-1,-1,-1,-1,4,-1
KR_6692357510,420,0,-10,14,-7,0,3,3,2,2,4,-1,3,2,-3,6,3,-5,7,2,-2,-11,-21,-1,-5,6,-7,0,1,0,-1,1,-1,0,-1
KR_6760967713,420,-2,-43,-2,-9,-3,3,0,4,1,5,-1,2,1,-6,8,2,-3,4,1,-1,-17,8,-1,-2,3,1,0,-3,-1,-1,-1,-1,5,-1
KR_6685118351,420,-6,-35,-32,-17,3,0,3,-4,4,0,-2,2,0,-11,15,4,-3,3,0,-1,-22,-1,-4,-1,5,1,0,-2,0,0,-1,-1,0,-1
KR_6314526098,420,1,19,9,1,-1,3,2,0,3,3,-1,2,1,-1,2,1,4,0,4,0,-1,-25,-3,-4,7,8,0,0,-1,1,1,-1,4,-1
KR_6694151363,420,-2,11,-2,1,4,1,5,3,0,3,-3,3,0,-2,2,0,-1,1,0,0,5,-3,0,-5,5,-4,0,1,-1,1,1,-1,5,-1
KR_6750120414,420,5,40,12,16,3,0,3,9,3,12,2,0,2,3,2,5,-1,2,1,0,20,-41,4,-7,3,21,0,0,1,1,1,1,4,-1
KR_6729592815,420,-2,-15,12,-3,-5,5,0,-3,5,2,2,1,3,3,1,4,0,0,0,0,-5,18,0,-5,5,-1,0,0,1,-1,0,-1,1,-1
KR_6748204964,420,2,16,-28,-1,-1,3,2,1,3,4,-2,3,1,-1,2,1,2,0,2,0,3,-1,3,-5,2,1,0,0,-1,1,1,-1,6,-1
KR_6465082151,420,-2,21,12,-1,4,0,4,-5,5,0,3,1,4,-3,4,1,0,0,0,0,1,-195,5,-8,3,-33,0,0,1,1,1,1,2,-1
KR_6748193329,420,-1,-21,-16,-2,3,1,4,-2,3,1,0,0,0,-1,3,2,-2,3,1,0,-3,4,6,-11,5,-4,0,0,1,-1,0,1,2,-1
KR_6759733787,420,-1,-7,4,0,0,3,3,-4,6,2,1,0,1,2,1,3,1,0,1,1,0,-5,-1,-5,6,-7,0,1,-1,1,1,1,1,-1
KR_6757921089,420,-3,-25,-4,-13,0,1,1,-3,5,2,-1,2,1,-4,4,0,-5,5,0,0,-10,-79,0,-5,5,0,0,-1,0,-1,-1,-1,0,-1
KR_6765181517,420,-4,-82,-4,-9,-1,1,0,-7,8,1,0,3,3,-1,5,4,0,0,0,0,0,-32,-1,-5,6,21,0,-2,-1,-1,-1,-1,5,-1
KR_6750887073,420,0,0,4,-4,-1,1,0,0,1,1,3,2,5,-6,6,0,0,0,0,0,-6,-8,-4,-4,8,0,0,0,-1,-1,0,1,6,-1
KR_6760545039,420,-1,-20,-14,-3,-4,5,1,1,4,5,-3,4,1,1,1,2,2,0,2,2,5,-106,0,-5,5,-2,0,-1,1,-1,-1,1,3,-1
KR_6764538794,420,1,-10,-5,-2,-1,3,2,0,2,2,-3,4,1,0,2,2,2,0,2,0,-1,-10,-2,-4,6,-2,0,1,-1,1,1,-1,1,-1
KR_6765402480,420,-1,-45,-15,1,2,2,4,-3,5,2,1,1,2,-1,1,0,2,0,2,0,2,-145,-1,-2,3,-3,0,-1,-1,-1,-1,-1,1,-1
KR_6742948140,420,1,34,-7,1,3,2,5,-1,5,4,-4,8,4,1,5,6,2,1,3,-1,-2,73,-1,-5,6,-1,0,-2,-1,-1,-1,-1,3,-1
KR_6543602918,420,-1,-23,-7,0,0,1,1,4,0,4,2,1,3,-5,6,1,-1,1,0,0,-4,-24,0,-5,5,-4,0,-1,1,-1,-1,1,1,-1
KR_6709892624,440,-4,-12,-6,-10,-2,2,0,-2,4,2,-3,3,0,-3,4,1,0,3,3,0,-9,-9,1,-8,7,-1,0,0,-1,-1,0,-1,6,-1
KR_6673930851,420,-2,-15,-9,-9,-4,4,0,1,1,2,-5,5,0,-1,5,4,0,1,1,0,-4,-36,0,-7,7,4,0,-1,1,-1,-1,1,6,-1
KR_6763315848,420,-1,44,16,-4,-2,2,0,0,2,2,0,4,4,0,2,2,-2,2,0,0,-7,36,-2,-5,7,0,0,0,0,-1,0,-1,0,-1
KR_6692388918,420,-4,-104,-13,-10,-1,1,0,3,0,3,-2,4,2,-9,9,0,-1,2,1,-1,-16,21,-3,-4,7,0,0,0,-1,-1,0,-1,3,-1
KR_6727796701,420,-1,14,8,-10,-2,3,1,-4,5,1,-2,4,2,-4,4,0,2,1,3,0,-12,11,2,-7,5,-6,0,0,-1,-1,0,-1,1,-1
KR_6615097005,420,-2,37,0,-6,-4,5,1,-2,5,3,-1,2,1,1,1,2,0,1,1,0,-4,2,1,-5,4,-7,0,-1,1,-1,-1,-1,1,-1
KR_6760380059,420,4,71,16,11,1,0,1,-5,6,1,3,0,3,2,2,4,10,0,10,1,5,127,3,-9,6,3,0,0,1,1,1,1,5,-1
KR_6724974628,420,-2,24,0,2,3,1,4,-2,3,1,0,0,0,-1,3,2,2,0,2,0,-2,10,1,-3,2,1,0,1,-1,-1,1,1,2,-1
KR_6746957630,420,1,15,-1,1,0,2,2,0,4,4,1,1,2,2,0,2,-2,4,2,0,2,9,3,-7,4,3,0,1,0,1,1,-1,0,-1
KR_6620194314,420,0,-11,6,-5,-1,2,1,1,2,3,-5,5,0,3,5,8,-3,3,0,0,-2,14,-2,-5,7,-1,0,-1,-1,-1,-1,-1,1,-1
KR_6742082884,440,-1,26,-40,2,-2,3,1,1,1,2,-4,5,1,5,2,7,2,2,4,0,4,-3,-3,-7,10,0,0,1,1,-1,1,1,4,-1
KR_6751936396,420,0,47,16,-7,0,2,2,-5,6,1,-5,5,0,-2,2,0,5,0,5,-2,-12,6,1,-6,5,-1,0,0,1,0,0,-1,2,-1
KR_6757836279,420,-1,15,-5,-8,-7,7,0,2,1,3,-3,4,1,2,4,6,-2,3,1,0,-10,18,-1,-2,3,-4,0,0,-1,-1,1,-1,3,-1
KR_6752845059,420,1,14,4,-5,1,1,2,-4,6,2,1,3,4,-2,2,0,-1,3,2,0,-6,258,-1,-4,5,2,0,-3,-1,-1,-1,-1,6,-1
KR_6703968098,420,-4,-55,1,-7,1,2,3,0,1,1,4,1,5,-9,10,1,-3,5,2,-1,-5,-14,0,-5,5,1,0,-3,-1,-1,-1,-1,4,-1
KR_6661367828,420,-2,17,-12,-4,-2,2,0,2,3,5,1,1,2,-1,6,5,-4,4,0,0,-4,10,6,-10,4,-1,0,1,-1,1,1,-1,5,-1
KR_6719155198,420,-2,-32,-8,3,-1,5,4,0,3,3,2,1,3,2,1,3,0,0,0,0,2,13,4,-5,1,-2,0,0,1,0,-1,-1,5,-1
KR_6617252782,420,2,37,-2,3,-2,3,1,1,0,1,5,2,7,0,1,1,-1,2,1,0,1,-2,2,-5,3,-1,0,1,1,-1,1,1,1,-1
KR_6669280454,420,-1,-19,-3,0,3,1,4,-1,4,3,2,3,5,-4,6,2,0,2,2,0,-4,4,3,-7,4,-3,0,-2,1,1,-1,1,3,-1
KR_6750035671,420,1,-10,-25,6,-4,4,0,5,0,5,5,1,6,0,2,2,0,1,1,1,18,-3,-4,-2,6,1,0,0,-1,0,0,1,5,-1
KR_6751437683,440,-2,-40,6,-5,1,1,2,2,2,4,-8,9,1,-2,2,0,2,0,2,0,-1,-6,-4,-4,8,-4,0,0,-1,1,0,-1,3,-1
KR_6679281276,420,-4,2,-5,-4,-2,3,1,-2,5,3,-1,3,2,-1,7,6,2,0,2,0,-2,-4,-2,-4,6,-1,0,-1,1,-1,-1,-1,5,-1
KR_6758045751,420,-6,-44,-51,-13,-2,3,1,-5,5,0,-4,5,1,0,1,1,-2,2,0,0,-13,-15,-3,-2,5,2,0,0,-1,-1,-1,-1,6,-1
KR_6692467444,420,3,44,-12,5,-2,3,1,-3,8,5,6,0,6,3,1,4,1,0,1,-2,3,77,-4,-4,8,1,0,1,1,-1,1,-1,6,-1
KR_6702215024,420,-2,-95,7,1,-2,5,3,-6,6,0,0,3,3,9,0,9,0,0,0,0,5,1,-2,-5,7,-2,0,-1,1,-1,-1,1,5,-1
KR_6741674617,420,-1,27,-39,-1,4,0,4,0,6,6,-1,4,3,0,3,3,-4,5,1,-2,-7,-11,-2,-4,6,9,0,1,1,-1,1,-1,3,-1
KR_6737904741,420,-2,6,3,-2,-1,1,0,5,5,10,-7,8,1,1,1,2,0,2,2,0,0,1,-3,-3,6,-2,0,0,1,-1,0,1,3,-1
KR_6750262322,420,-4,-54,-16,-10,-1,2,1,-2,2,0,-3,4,1,-4,6,2,0,0,0,0,-11,-8,-4,-2,6,6,0,0,-1,0,0,-1,2,-1
KR_6760350485,420,-4,-30,-35,-11,-7,7,0,1,3,4,-4,6,2,-1,3,2,0,1,1,0,-9,-9,0,-5,5,-4,0,-1,-1,-1,-1,-1,5,-1
KR_6729423270,440,0,-1,56,4,1,1,2,4,0,4,3,2,5,0,3,3,-4,4,0,0,-1,-14,7,-7,0,0,0,0,-1,1,0,1,1,-1
KR_6619695454,420,-5,-98,-38,-7,-3,4,1,-1,2,1,-1,4,3,-2,6,4,0,0,0,0,-3,4,-3,-6,9,0,0,-1,-1,-1,-1,-1,3,-1
KR_6700163468,420,-2,30,9,-4,-1,2,1,1,1,2,-4,5,1,-1,2,1,1,1,2,0,-1,2,-6,-1,7,-2,0,0,-1,-1,-1,-1,3,-1
KR_6757803271,420,-1,-41,13,-4,1,1,2,-3,3,0,0,1,1,0,3,3,-2,3,1,0,-10,-7,-6,-5,11,9,0,0,1,1,1,-1,1,-1
KR_6603207589,420,-1,-23,5,-2,0,0,0,4,1,5,-4,7,3,-2,5,3,0,1,1,0,-2,-10,1,-5,4,-4,0,1,1,1,1,-1,6,-1
KR_6630122139,420,2,-47,29,2,1,0,1,0,2,2,-2,2,0,1,4,5,2,1,3,0,0,1,1,-6,5,-2,0,-1,-1,1,-1,-1,5,-1
KR_6728654606,420,-7,-69,-40,-18,0,1,1,-5,5,0,-9,9,0,-3,4,1,-1,1,0,0,-11,14,-8,-1,9,-7,0,-2,-1,-1,-1,-1,1,-1
KR_6764019670,420,-1,15,-7,1,0,2,2,0,4,4,0,3,3,1,3,4,0,4,4,1,0,10,1,-6,5,1,0,-1,0,-1,-1,1,0,-1
KR_6740171212,420,-6,-56,-15,-14,1,1,2,-3,5,2,-4,6,2,-7,8,1,-1,1,0,0,-14,39,-3,-3,6,-19,0,-1,1,1,-1,-1,6,-1
KR_6697834014,420,-5,-47,-14,-11,-6,6,0,4,1,5,-5,7,2,-5,7,2,1,0,1,-1,-10,110,2,-7,5,4,0,0,-1,1,-1,-1,2,-1
KR_6761057428,420,1,-26,-14,8,0,0,0,1,0,1,-2,2,0,5,1,6,4,0,4,0,9,124,1,-6,5,4,0,1,1,-1,1,1,5,-1
KR_6735043321,420,-1,-67,2,-6,0,1,1,-8,10,2,3,1,4,-2,4,2,1,1,2,-1,-6,3,-4,-3,7,2,0,-3,-1,-1,-1,-1,1,-1
KR_6617177058,420,0,-50,-20,0,0,3,3,2,3,5,-2,5,3,0,1,1,0,1,1,0,4,5,4,-5,1,-4,0,0,1,-1,-1,-1,2,-1
KR_6763455515,420,-4,-62,3,-3,0,2,2,-3,4,1,3,0,3,-4,7,3,1,0,1,0,-7,20,2,-10,8,1,0,-1,-1,1,-1,-1,5,-1
KR_6759746970,420,-2,-1,-16,-6,0,2,2,0,2,2,-1,2,1,-5,5,0,0,2,2,0,-7,2,1,-3,2,-5,0,-1,-1,1,-1,-1,5,-1
KR_6740660203,420,-3,-23,-26,0,4,0,4,-6,8,2,2,0,2,-1,2,1,1,2,3,0,0,7,-2,-1,3,4,0,1,-1,-1,1,1,6,-1
KR_6693591450,420,-1,53,-36,-1,1,0,1,-1,4,3,2,1,3,0,4,4,-3,3,0,0,-2,39,0,-6,6,-27,0,1,-1,1,1,-1,6,-1
KR_6761727176,420,1,64,-5,-1,3,1,4,2,3,5,0,1,1,-7,7,0,1,1,2,0,-1,-28,-3,-2,5,1,0,1,-1,-1,1,1,5,-1
KR_6733541156,420,-2,-17,-4,-2,0,2,2,0,2,2,-2,3,1,-1,3,2,1,1,2,0,2,1,1,-6,5,-1,0,0,-1,-1,0,-1,1,-1
KR_6741739187,440,-1,64,-24,-2,-4,4,0,1,1,2,3,0,3,-3,3,0,1,1,2,0,-1,-25,-3,-4,7,-3,0,1,-1,1,1,-1,5,-1
KR_6678226934,420,0,5,7,-4,-2,3,1,1,1,2,0,1,1,-3,5,2,0,1,1,0,-1,-2,-3,-5,8,4,0,1,-1,-1,1,-1,4,-1
KR_6762447705,420,0,-4,-3,5,-5,7,2,4,0,4,1,1,2,5,1,6,0,3,3,1,8,-10,0,-6,6,0,0,0,1,-1,-1,1,3,-1
KR_6764163305,440,0,-11,16,-1,-1,1,0,-1,1,0,-2,4,2,0,1,1,3,1,4,0,-2,23,3,-7,4,-7,0,-1,-1,-1,-1,1,6,-1
KR_6765273474,420,3,15,-13,3,-3,4,1,1,2,3,3,0,3,1,1,2,1,0,1,0,5,-60,4,-5,1,13,0,0,1,-1,1,-1,5,-1
KR_6720686151,420,-4,25,24,-6,-1,2,1,-4,5,1,-1,2,1,1,5,6,-1,1,0,0,-5,102,-3,-4,7,1,0,0,1,-1,-1,-1,3,-1
KR_6747491905,420,-5,-44,-8,-8,-2,3,1,-4,7,3,-1,4,3,-1,2,1,0,5,5,0,-21,-12,-5,-3,8,-2,0,-1,0,-1,-1,1,0,-1
KR_6715554416,420,1,-47,-20,0,1,2,3,2,2,4,0,3,3,-4,4,0,1,0,1,0,-5,-4,0,-5,5,0,0,-1,-1,-1,-1,-1,2,-1
KR_6765863506,420,-1,19,-34,-6,2,0,2,-4,4,0,-4,5,1,0,1,1,0,0,0,0,-10,-42,-1,-6,7,5,0,0,1,-1,-1,-1,1,-1
KR_6759298006,420,-3,-25,-23,-2,0,2,2,-2,3,1,-2,3,1,0,3,3,2,1,3,1,-6,7,4,-8,4,-2,0,1,1,1,1,1,5,-1
KR_6733266121,420,-1,-44,-24,-3,0,0,0,1,1,2,-3,3,0,0,2,2,-1,2,1,0,-3,5,-2,-3,5,-6,0,-1,-1,-1,-1,-1,1,-1
KR_6506989574,420,-2,-95,-18,-5,0,2,2,-3,4,1,1,0,1,-3,3,0,0,1,1,0,-5,-227,0,-6,6,0,0,-3,-1,-1,-1,-1,1,-1
KR_6726952749,420,4,78,9,6,1,0,1,1,0,1,-1,2,1,4,0,4,1,3,4,0,9,-6,-2,-3,5,5,0,0,1,-1,1,-1,4,-1
KR_6695879497,420,-1,-25,-23,1,-3,6,3,1,1,2,1,1,2,6,1,7,-4,4,0,0,6,5,8,-10,2,-2,0,-1,1,-1,-1,-1,5,-1
KR_6765969094,420,-5,-60,-28,-6,-4,4,0,-3,4,1,-2,2,0,0,2,2,3,0,3,-1,-5,8,4,-9,5,-1,0,0,1,1,-1,-1,1,-1
KR_6746607310,420,2,30,3,2,1,1,2,2,1,3,0,2,2,0,3,3,-1,2,1,0,-3,11,1,-5,4,-2,0,0,1,1,0,-1,1,-1
KR_6764788198,420,5,32,40,12,-5,7,2,2,1,3,5,2,7,3,1,4,7,2,9,0,19,5,-2,-2,4,2,0,0,1,-1,-1,1,5,-1
KR_6765369251,420,0,30,4,3,1,1,2,0,4,4,-1,1,0,1,4,5,2,0,2,0,6,-14,-10,-2,12,6,0,0,-1,-1,0,1,4,-1
KR_6753428325,420,1,-51,14,2,-2,3,1,7,0,7,-3,3,0,-1,2,1,1,0,1,0,4,-1,-2,-1,3,1,0,1,1,-1,-1,-1,3,-1
KR_6761537239,420,-3,-14,-1,-6,-3,3,0,0,7,7,-2,3,1,-1,6,5,0,1,1,0,-5,5,-1,-4,5,2,0,1,1,-1,1,-1,4,-1
KR_6762357556,420,-1,9,0,-1,-1,3,2,-4,4,0,1,5,6,3,1,4,0,1,1,0,0,-4,-3,-3,6,4,0,-1,0,-1,-1,-1,0,-1
KR_6722344657,420,-6,-39,3,-15,-3,4,1,-10,11,1,0,3,3,-4,4,0,2,2,4,0,-18,-10,-1,-6,7,0,0,0,-1,1,0,-1,2,-1
KR_6677496229,420,1,32,35,-2,-1,1,0,0,3,3,-3,3,0,3,2,5,-1,1,0,1,-1,-12,0,-5,5,-1,0,1,0,1,1,1,0,-1
KR_6738519383,420,2,19,-35,2,1,3,4,2,2,4,0,1,1,-2,6,4,1,0,1,-1,8,-54,-4,-4,8,-3,0,-1,-1,-1,-1,-1,5,-1
KR_6676578901,420,1,8,-20,0,-5,6,1,1,1,2,7,0,7,1,3,4,-4,4,0,0,3,-35,-5,-3,8,6,0,-1,1,-1,-1,-1,6,-1
KR_6761463611,420,0,-18,8,-1,4,0,4,0,2,2,-4,6,2,-1,2,1,0,1,1,0,1,-7,-4,-3,7,1,0,0,1,1,0,-1,4,-1
KR_6691569527,420,-4,-65,4,-10,-7,7,0,0,0,0,-1,2,1,-1,1,0,-1,1,0,0,-2,-174,1,-9,8,-20,0,0,-1,1,0,-1,6,-1
KR_6733315018,420,0,32,-23,2,-1,2,1,1,3,4,0,0,0,-1,3,2,3,0,3,0,5,-3,1,-6,5,-20,0,-1,-1,-1,-1,-1,4,-1
KR_6713432187,420,1,-28,-12,5,0,0,0,-2,4,2,-2,4,2,6,1,7,3,0,3,-1,8,8,3,-10,7,4,0,2,1,0,1,-1,1,-1
KR_6712900261,420,1,38,24,-1,1,2,3,-1,3,2,0,2,2,-2,2,0,1,1,2,0,-1,7,0,-7,7,-1,0,1,0,1,1,1,0,-1
KR_6738852346,420,0,24,-11,4,3,0,3,1,1,2,-2,3,1,3,1,4,-1,3,2,0,6,-19,1,-6,5,1,0,0,-1,1,-1,-1,1,-1
KR_6766091193,420,-4,-40,10,-9,1,4,5,-1,3,2,-4,5,1,1,3,4,-6,7,1,0,-8,-50,3,-7,4,1,0,-4,1,-1,-1,-1,4,-1
KR_6765975410,420,-8,-60,-21,-9,-1,2,1,0,5,5,-4,6,2,-4,4,0,0,2,2,0,-9,0,4,-7,3,-1,0,-2,-1,-1,-1,1,5,-1
KR_6744177805,420,-1,-25,29,-8,0,1,1,-1,3,2,-4,5,1,-3,5,2,0,0,0,0,-14,1,0,-7,7,-6,0,-1,1,1,-1,-1,3,-1
KR_6555404367,420,-4,-14,-29,-13,-3,3,0,-9,9,0,-4,9,5,1,1,2,2,0,2,0,-9,26,-2,-3,5,5,0,-1,-1,-1,-1,-1,4,-1
KR_6639448120,420,-4,-44,-27,-12,-1,1,0,0,2,2,-6,9,3,-3,5,2,-2,2,0,0,-7,-32,-4,-3,7,-3,0,-2,-1,-1,-1,-1,2,-1
KR_6765115387,420,3,58,-11,0,-5,5,0,-3,6,3,4,1,5,4,0,4,0,2,2,0,-1,-125,-6,-2,8,2,0,0,1,-1,0,-1,2,-1
KR_6751003562,440,-1,-48,-6,-1,-1,4,3,-2,3,1,1,0,1,0,4,4,1,0,1,0,0,-4,-2,-4,6,-3,0,0,1,1,-1,1,3,-1
KR_6671868353,420,-2,-69,-3,-11,-1,4,3,-5,6,1,-1,1,0,0,2,2,-4,5,1,-1,-17,-51,-1,-6,7,-5,0,-1,-1,1,-1,-1,6,-1
KR_6743922998,420,-4,-53,3,-12,-1,4,3,-3,3,0,-2,3,1,-6,7,1,0,1,1,0,-17,4,-2,-6,8,-4,0,-2,-1,-1,-1,1,6,-1
KR_6760639117,420,-3,-10,3,-4,-1,2,1,-1,1,0,-4,5,1,3,0,3,-1,2,1,0,-2,-19,3,-7,4,3,0,-1,1,-1,-1,1,5,-1
KR_6758598021,420,-1,4,-20,-4,-1,1,0,-3,5,2,4,0,4,-3,4,1,-1,2,1,0,-4,4,-2,-2,4,4,0,0,1,-1,-1,1,2,-1
KR_6760211537,440,3,3,20,0,2,0,2,-2,3,1,-5,5,0,6,0,6,-1,2,1,0,6,3,2,-7,5,-2,0,0,1,1,0,-1,5,-1
KR_6647842893,440,1,-15,0,0,-1,4,3,-1,1,0,3,2,5,-1,2,1,0,0,0,0,5,-7,0,-5,5,3,0,0,-1,1,0,-1,5,-1
KR_6519134206,420,-2,-21,-4,1,-2,2,0,-1,2,1,2,2,4,3,2,5,-1,1,0,-1,8,4,2,-10,8,2,0,-1,1,-1,-1,-1,5,-1
KR_6630260837,420,-1,-83,28,-1,-1,4,3,2,0,2,2,1,3,-4,8,4,0,1,1,0,1,3,2,-7,5,-4,0,-1,-1,-1,-1,-1,3,-1
KR_6755975720,420,-2,48,-12,-5,0,3,3,-1,3,2,-2,4,2,-1,2,1,-1,1,0,0,-15,-112,-1,-5,6,0,0,-1,-1,-1,-1,-1,3,-1
KR_6762937686,420,-1,19,-17,1,-2,3,1,2,1,3,-4,4,0,3,0,3,2,0,2,0,3,7,2,-5,3,1,0,0,-1,-1,0,-1,1,-1
KR_6696944758,420,-5,-75,-55,-4,-1,4,3,-4,4,0,1,1,2,0,1,1,0,0,0,0,0,-2,-6,-1,7,-4,0,-2,-1,-1,-1,-1,6,-1
KR_6765878560,420,-2,6,-8,-6,-5,6,1,-3,3,0,3,1,4,-2,2,0,1,0,1,0,-9,31,-3,-3,6,5,0,0,-1,-1,-1,-1,2,-1
KR_6623267801,420,-2,20,-14,6,2,1,3,-1,2,1,2,1,3,1,2,3,2,0,2,0,3,-3,0,-6,6,-1,0,0,1,0,0,1,6,-1
KR_6758457317,420,0,-22,-13,-2,-1,2,1,2,1,3,2,2,4,-4,4,0,-1,2,1,0,3,34,1,-5,4,-2,0,0,-1,1,0,1,3,-1
KR_6751950931,420,-5,-90,-10,-7,-7,7,0,1,2,3,4,3,7,-4,6,2,-1,2,1,0,-6,-18,-1,-7,8,-3,0,-1,-1,0,-1,-1,4,-1
KR_6728039878,440,-4,-22,-17,-2,-3,4,1,0,2,2,-3,3,0,4,5,9,0,2,2,0,-3,4,6,-8,2,-3,0,1,1,1,1,-1,3,-1
KR_6757651016,420,-2,-23,32,-6,-4,4,0,0,2,2,-1,2,1,1,4,5,-2,2,0,0,-2,-4,-1,-3,4,-2,0,0,-1,-1,-1,1,6,-1
KR_6746610223,420,-4,-54,-33,-1,1,0,1,-2,7,5,-1,3,2,0,2,2,1,0,1,0,-3,-28,-2,-4,6,-1,0,-2,-1,-1,-1,1,1,-1
KR_6759958525,420,0,46,-14,1,4,0,4,2,3,5,-5,6,1,-1,4,3,1,0,1,0,5,6,6,-9,3,-7,0,0,-1,1,0,1,6,-1
KR_6758690923,420,2,-48,19,1,-2,5,3,-1,3,2,0,2,2,0,1,1,4,0,4,0,6,0,-8,-2,10,1,0,-1,1,1,-1,1,4,-1
KR_6731732981,420,-3,-43,12,-5,-1,1,0,-1,2,1,1,0,1,-3,4,1,-1,1,0,0,-4,25,4,-5,1,-5,0,0,-1,-1,0,-1,3,-1
KR_6709976064,440,-3,-53,5,-3,-3,5,2,0,2,2,3,1,4,-2,4,2,-1,2,1,0,-4,-18,-3,-6,9,0,0,-1,1,0,-1,-1,4,-1
KR_6762548634,420,2,-35,32,4,2,0,2,1,0,1,4,1,5,-3,7,4,0,0,0,0,4,0,-4,-3,7,-2,0,1,1,1,1,1,4,-1
KR_6734785851,420,-3,2,15,-7,-5,5,0,-3,6,3,0,2,2,0,5,5,1,2,3,0,-1,-6,-2,-2,4,-1,0,1,1,1,1,-1,1,-1
KR_6764509952,440,-3,-39,-29,-3,1,0,1,4,3,7,-2,3,1,-5,6,1,-1,1,0,0,-5,-13,1,-6,5,4,0,0,1,-1,-1,-1,1,-1
KR_6548230091,420,1,-40,24,-6,0,1,1,-2,6,4,-2,5,3,2,2,4,-4,4,0,-1,-3,66,6,-7,1,-1,0,1,-1,1,1,-1,2,-1
KR_6639099098,420,2,-50,23,0,-1,1,0,4,2,6,0,2,2,-2,5,3,-1,1,0,0,4,3,-1,-5,6,0,0,-1,-1,-1,-1,-1,6,-1
KR_6763330012,440,1,43,4,-2,1,0,1,-1,1,0,-1,2,1,1,0,1,-2,3,1,0,0,-3,0,-2,2,1,0,0,-1,-1,0,-1,5,-1
KR_6728697863,420,-4,-53,-18,-13,0,2,2,-6,7,1,0,3,3,0,8,8,-7,7,0,2,-10,21,0,-5,5,-2,-1,-3,-1,-1,-1,1,6,-1
KR_6634706540,420,5,39,-16,16,3,1,4,7,1,8,-1,3,2,3,0,3,4,1,5,0,21,-2,4,-7,3,2,0,0,1,0,1,1,3,-1
KR_6761237525,420,-4,-55,-32,-9,-2,3,1,-5,8,3,-4,6,2,0,4,4,2,1,3,2,-3,11,-4,-3,7,-8,0,-1,1,-1,-1,1,4,-1
KR_6765878629,420,-5,26,-14,-17,0,1,1,-7,10,3,-5,7,2,-6,6,0,1,0,1,0,-15,-5,-4,-2,6,0,0,0,-1,-1,-1,-1,5,-1
KR_6634340988,420,-6,-115,-8,-16,-2,2,0,-7,7,0,-2,2,0,-3,4,1,-2,3,1,0,-8,3,0,-5,5,-5,0,-1,-1,1,-1,-1,3,-1
KR_6761631503,420,0,52,-16,3,1,0,1,4,4,8,0,3,3,-1,3,2,-1,2,1,0,7,-34,4,-7,3,1,0,0,1,-1,0,1,1,-1
KR_6722853665,440,-1,17,-96,-5,1,6,7,-5,7,2,-3,3,0,0,3,3,2,0,2,1,-3,5,-2,-4,6,-6,0,-3,0,-1,-1,1,0,-1
KR_6741372735,420,-1,-42,-4,-4,0,1,1,-3,5,2,1,1,2,-2,3,1,0,2,2,0,-10,6,0,-4,4,-6,0,0,-1,1,0,1,5,-1
KR_6617727104,420,-5,-10,9,-6,0,3,3,-1,6,5,-2,3,1,0,2,2,-3,4,1,0,-5,-12,3,-6,3,2,0,-1,-1,1,-1,-1,2,-1
KR_6733890374,420,-1,1,-28,-1,-2,2,0,-4,4,0,0,0,0,5,0,5,0,0,0,0,2,-18,1,-4,3,-3,0,0,-1,-1,0,1,4,-1
KR_6740666657,420,1,47,-18,6,0,2,2,1,4,5,-2,4,2,5,2,7,2,0,2,0,22,-5,1,-6,5,1,0,0,1,1,0,1,6,-1
KR_6753127017,440,2,-62,-20,4,0,2,2,3,1,4,0,4,4,2,0,2,-1,4,3,0,-1,-16,-6,-1,7,-1,0,0,-1,1,0,1,4,-1
KR_6703004085,420,-3,-26,5,-13,-1,5,4,-2,4,2,-3,5,2,-9,10,1,2,0,2,-3,-11,248,2,-6,4,-2,0,-2,-1,1,-1,-1,3,-1
KR_6675064989,420,0,2,5,-1,5,1,6,-1,3,2,-2,4,2,-4,5,1,1,1,2,1,-11,3,1,-7,6,0,0,0,1,-1,-1,1,1,-1
KR_6738673311,420,3,-5,21,2,3,0,3,0,2,2,1,0,1,0,2,2,-2,3,1,0,-1,9,2,-6,4,1,0,0,-1,1,0,-1,4,-1
KR_6713463837,420,-1,-34,16,1,-1,1,0,2,1,3,0,4,4,0,3,3,0,0,0,0,0,-10,8,-12,4,-6,0,1,1,1,1,1,4,-1
KR_6752763991,420,-2,-50,-19,-7,-6,7,1,-4,4,0,1,1,2,5,1,6,-3,7,4,0,1,114,-2,-2,4,-2,0,-2,1,-1,-1,-1,1,-1
KR_6753972400,440,-2,-51,-20,-7,-4,7,3,0,4,4,1,0,1,-4,9,5,0,1,1,1,-6,-92,0,-2,2,-2,0,0,-1,0,-1,1,5,-1
KR_6759237638,420,-4,-63,-16,-1,2,2,4,2,3,5,0,2,2,-3,6,3,-2,2,0,0,-5,21,-2,-7,9,2,0,0,-1,1,1,1,2,-1
KR_6754906825,420,-5,-30,-47,-5,0,2,2,-3,3,0,1,3,4,-2,3,1,-1,3,2,0,-4,12,4,-8,4,1,0,-2,0,1,-1,1,0,-1
KR_6760147137,420,3,-44,5,1,1,2,3,0,1,1,-2,2,0,0,2,2,2,0,2,0,1,-17,0,-4,4,-2,0,-1,-1,-1,-1,-1,1,-1
KR_6757488534,420,3,-74,4,5,0,0,0,3,3,6,1,1,2,-1,3,2,2,0,2,0,3,18,2,-4,2,-3,0,1,1,1,1,1,4,-1
KR_6761133219,420,-3,-19,4,-5,2,1,3,-2,5,3,1,4,5,-6,7,1,0,0,0,0,-14,1,-3,-2,5,-6,0,0,-1,1,1,-1,4,-1
KR_6757426488,420,1,114,-4,-9,0,1,1,-5,5,0,-6,9,3,-2,3,1,4,1,5,0,-10,2,-2,-6,8,-4,0,0,-1,0,0,-1,4,-1
KR_6751115480,420,-5,-45,-20,-6,-4,4,0,-2,5,3,-1,1,0,0,4,4,1,2,3,0,-5,-21,3,-5,2,-1,0,-2,1,1,-1,-1,5,-1
KR_6738477614,420,0,9,-23,-3,2,1,3,-3,4,1,-3,3,0,0,2,2,1,0,1,-1,-8,-50,7,-14,7,19,0,0,1,-1,-1,-1,3,-1
KR_6759676654,420,-2,-12,-17,3,0,1,1,-1,4,3,-1,3,2,4,1,5,1,1,2,2,-7,-1,3,-6,3,5,0,-1,1,1,-1,1,1,-1
KR_6745213622,420,-3,-23,-11,-11,-1,3,2,0,1,1,-9,13,4,0,4,4,-1,1,0,-3,-4,-4,-5,-4,9,0,0,-3,-1,-1,-1,-1,1,-1
KR_6731801364,420,0,32,8,4,7,0,7,-2,5,3,2,2,4,-1,1,0,-2,2,0,0,-4,11,3,-7,4,-2,0,2,1,1,1,-1,1,-1
KR_6526629454,420,1,32,-36,4,0,1,1,4,5,9,3,0,3,-2,5,3,-1,1,0,0,4,-20,3,-8,5,-2,0,-1,-1,-1,-1,-1,5,-1
KR_6748618690,420,0,23,0,5,3,0,3,-2,5,3,0,3,3,1,3,4,3,0,3,0,7,-7,1,-9,8,8,0,2,0,1,1,-1,0,-1
KR_6713267492,420,-7,-124,-12,-13,-2,5,3,-6,7,1,-5,5,0,-1,2,1,1,0,1,-2,-14,-17,2,-6,4,-7,0,-2,-1,-1,-1,-1,2,-1
KR_6762365733,420,-1,-31,-8,-3,0,0,0,1,2,3,0,2,2,-4,5,1,0,0,0,0,-6,1,3,-11,8,-5,0,-3,-1,-1,-1,-1,2,-1
KR_6540295044,420,-4,-95,8,-7,-6,8,2,-4,6,2,0,2,2,2,0,2,1,0,1,0,0,-6,-2,-5,7,1,0,-2,-1,1,-1,-1,6,-1
KR_6735038446,440,-2,-22,4,0,-1,2,1,6,3,9,2,1,3,-4,4,0,-3,4,1,0,4,-36,-3,-1,4,-2,0,0,-1,1,1,1,5,-1
KR_6727450720,420,1,46,16,-9,-1,1,0,-6,6,0,2,3,5,-1,3,2,-3,3,0,-1,-12,-49,-8,-1,9,3,0,0,-1,-1,0,-1,6,-1
KR_6735117742,420,-2,36,-20,1,1,2,3,1,2,3,-6,7,1,5,2,7,0,0,0,0,2,1,-2,-2,4,0,0,0,-1,1,1,1,2,-1
KR_6746165976,420,-2,13,-57,-7,2,1,3,-2,4,2,-3,3,0,-4,5,1,0,0,0,-1,-8,99,0,-6,6,4,0,0,-1,1,0,-1,2,-1
KR_6752128763,440,-3,-117,-5,-4,-5,6,1,-2,3,1,1,1,2,1,0,1,1,1,2,0,-4,-7,2,-7,5,-3,0,-1,1,1,-1,-1,3,-1
KR_6710062062,420,0,25,-10,1,-3,3,0,1,4,5,0,1,1,3,0,3,0,1,1,0,9,-1,-4,-2,6,-1,0,-1,1,-1,-1,1,2,-1
KR_6667384303,420,0,20,-4,-9,-4,4,0,-3,4,1,-2,6,4,1,1,2,-1,1,0,0,-15,-5,-3,-5,8,1,0,0,-1,1,0,1,1,-1
KR_6713152613,420,-3,-4,-56,-11,0,2,2,-6,6,0,-2,3,1,-2,4,2,-1,2,1,0,-16,-36,-1,-9,10,3,0,-1,1,-1,-1,1,3,-1
KR_6730747224,420,-1,-15,-25,4,1,0,1,7,1,8,0,2,2,-2,4,2,-2,2,0,0,3,6,3,-5,2,-2,0,0,-1,1,0,1,4,-1
KR_6652435801,420,-4,-2,8,-5,-3,3,0,-2,4,2,-3,3,0,3,1,4,0,0,0,0,-5,-48,1,-5,4,-1,0,-1,1,1,-1,1,5,-1
KR_6759204392,420,-2,-35,-36,-6,-2,4,2,1,1,2,0,1,1,-5,6,1,0,0,0,0,-7,-7,-3,-3,6,1,0,0,-1,1,1,1,5,-1
KR_6712475557,420,-3,-18,-12,1,1,3,4,6,1,7,-1,3,2,-6,7,1,1,3,4,-1,-2,34,-5,-2,7,-3,0,0,1,-1,-1,-1,1,-1
KR_6765070667,420,-3,-66,-16,-7,-5,5,0,0,4,4,1,5,6,-3,4,1,0,1,1,0,-9,1,2,-4,2,-3,0,-2,-1,-1,-1,-1,3,-1
KR_6751963276,420,-3,-29,-4,-3,0,1,1,-3,4,1,-2,4,2,2,3,5,0,0,0,0,-6,94,2,-7,5,-5,0,0,1,-1,0,-1,1,-1
KR_6747100337,420,-2,-6,-6,-6,-2,4,2,-2,8,6,0,2,2,-2,5,3,0,1,1,0,-6,-3,-3,-3,6,2,0,0,-1,1,1,-1,2,-1
KR_6742782264,420,-8,-38,-72,-13,-3,4,1,-3,4,1,-4,5,1,-2,3,1,-1,1,0,0,-11,-4,0,-7,7,-2,0,-1,-1,-1,-1,1,5,-1
KR_6760580868,420,-1,-66,-13,-1,1,2,3,-2,3,1,-2,4,2,-1,3,2,3,0,3,1,3,9,1,-6,5,-4,0,-2,-1,-1,-1,1,1,-1
KR_6716540629,440,-2,-47,-22,6,4,1,5,-6,8,2,-3,4,1,6,1,7,5,0,5,0,3,-13,3,-5,2,-1,0,0,-1,1,-1,1,2,-1
KR_6700370150,440,0,-48,-19,0,-6,7,1,1,1,2,2,1,3,0,3,3,3,0,3,1,5,0,1,-4,3,4,0,0,1,-1,0,1,4,-1
KR_6750032052,440,-12,-147,-71,-25,-5,6,1,-3,5,2,-4,6,2,-9,9,0,-4,6,2,0,-16,8,0,-4,4,-5,0,-5,-1,-1,-1,-1,4,-1
KR_6601403946,420,-4,0,-28,0,-1,3,2,-3,6,3,4,1,5,1,3,4,-1,1,0,1,8,-93,6,-9,3,1,0,-1,-1,-1,-1,1,2,-1
KR_6642657370,420,-3,-6,-8,-6,-4,4,0,-2,7,5,-1,1,0,1,2,3,0,1,1,0,1,-10,-5,-2,7,-1,0,0,-1,0,0,-1,4,-1
KR_6737223211,420,-4,-8,-12,-13,-4,5,1,-7,8,1,-2,3,1,-1,2,1,1,0,1,0,-9,-2,-2,-5,7,0,0,0,1,-1,-1,1,6,-1
KR_6691790496,420,-2,-29,15,-6,-4,5,1,3,2,5,0,1,1,0,2,2,-5,5,0,0,2,18,1,-5,4,0,0,-2,1,1,-1,-1,6,-1
KR_6610302024,420,3,59,-8,1,4,0,4,1,4,5,1,3,4,-5,8,3,0,0,0,0,-6,-7,-4,-4,8,3,0,-1,-1,-1,1,1,4,-1
KR_6762484643,420,2,-5,15,0,-3,5,2,0,3,3,0,5,5,1,1,2,2,2,4,0,3,34,0,-3,3,0,0,-2,1,-1,-1,1,4,-1
KR_6757791870,420,-5,32,-16,-14,-4,4,0,-2,6,4,1,0,1,-5,6,1,-4,5,1,0,-15,-76,-2,-4,6,0,0,-1,1,-1,-1,-1,3,-1
KR_6760391316,420,-4,-51,-11,-2,0,0,0,-4,4,0,3,5,8,1,0,1,-2,3,1,0,7,4,3,-5,2,-1,0,-1,1,-1,-1,-1,5,-1
KR_6730124148,420,-4,-74,-51,-10,-2,3,1,-4,5,1,-4,7,3,4,0,4,-4,4,0,0,-4,0,0,-2,2,-2,0,0,-1,-1,-1,-1,5,-1
KR_6759859120,420,0,-62,-24,-6,0,2,2,-2,4,2,2,2,4,-5,8,3,-1,3,2,0,-11,10,4,-5,1,-4,0,-1,-1,-1,-1,1,4,-1
KR_6764618325,420,2,20,0,3,0,2,2,3,1,4,-1,2,1,0,3,3,1,0,1,0,1,-22,-2,-3,5,3,0,1,1,-1,1,1,3,-1
KR_6703635742,420,-1,-63,22,-1,3,2,5,-3,5,2,0,2,2,-3,3,0,2,2,4,-1,0,-3,-2,-3,5,-1,0,-2,0,-1,-1,-1,0,-1
KR_6685821040,420,-4,-94,-36,-9,1,2,3,-5,5,0,-6,7,1,-1,6,5,2,1,3,0,-1,38,-5,-1,6,-13,0,-1,-1,-1,-1,-1,5,-1
KR_6623937552,420,1,-5,-20,8,3,2,5,1,3,4,2,1,3,4,1,5,-2,3,1,0,5,-3,2,-7,5,5,0,0,-1,1,1,-1,2,-1
KR_6746098997,420,0,13,19,-1,1,0,1,2,4,6,-3,6,3,0,1,1,-1,2,1,0,-6,-46,5,-8,3,3,0,1,-1,1,1,1,3,-1
KR_6762416897,420,-4,-27,-8,-12,-6,7,1,-4,5,1,-1,2,1,-1,2,1,0,1,1,-1,-8,35,-4,-2,6,-10,0,-1,-1,-1,-1,-1,5,-1
KR_6765530288,420,-5,-62,-4,-12,-3,4,1,2,0,2,1,1,2,-10,11,1,-2,2,0,0,-13,-1,0,-4,4,-1,0,0,-1,1,-1,1,4,-1
KR_6747185652,420,-1,15,-16,-6,2,1,3,-3,4,1,-4,5,1,0,0,0,-1,4,3,-1,-12,-3,-1,-8,9,0,0,1,-1,1,1,-1,5,-1
KR_6751706579,420,-5,-101,10,-8,-7,8,1,-1,4,3,-3,3,0,2,4,6,1,1,2,0,-1,-5,-2,-5,7,-8,0,-2,0,-1,-1,1,0,-1
KR_6697631162,420,-3,53,4,-9,-2,4,2,-4,7,3,-2,3,1,-2,2,0,1,0,1,1,-12,-10,-3,-3,6,0,0,0,-1,1,0,1,1,-1
KR_6741335760,440,-3,-29,-8,-9,-7,8,1,-4,4,0,0,1,1,1,4,5,1,1,2,0,-7,16,0,-6,6,-12,0,-1,-1,-1,-1,-1,3,-1
KR_6746473506,440,-3,-11,-12,-5,0,0,0,-2,2,0,0,3,3,0,2,2,-3,4,1,0,-2,-10,-3,-2,5,3,0,-1,-1,1,-1,-1,4,-1
KR_6762318546,440,-8,-124,-28,-29,-2,5,3,0,3,3,-8,9,1,-17,17,0,-2,2,0,0,-17,32,-5,0,5,-22,0,-1,1,-1,-1,-1,6,-1
KR_6746344728,420,-2,20,25,-4,-3,3,0,3,3,6,-1,3,2,-3,3,0,0,0,0,0,-2,-19,-2,-4,6,-2,0,1,1,-1,-1,1,2,-1
KR_6754254221,420,-3,16,-48,-5,4,1,5,-2,5,3,0,3,3,-6,8,2,-1,2,1,-1,-2,1,2,-6,4,-6,0,-1,-1,-1,-1,-1,5,-1
KR_6753404298,420,-4,-5,-31,-10,-5,6,1,-1,4,3,-1,3,2,0,1,1,-3,3,0,0,-10,-116,0,-6,6,-3,0,-1,-1,-1,-1,-1,3,-1
KR_6759060770,440,-6,-52,-8,-5,-9,9,0,-1,2,1,6,1,7,-3,5,2,2,1,3,-2,-9,-2,-3,-4,7,3,0,-1,-1,-1,-1,-1,5,-1
KR_6717632163,420,-5,-42,-22,-7,1,1,2,-4,5,1,-3,4,1,-2,3,1,1,0,1,0,-3,-2,2,-7,5,-4,0,0,-1,1,-1,1,2,-1
KR_6728172969,420,-2,-57,-9,-1,0,4,4,1,2,3,1,3,4,-1,1,0,-2,3,1,0,5,-1,4,-9,5,-5,0,-3,1,-1,-1,-1,3,-1
KR_6758242539,420,-3,-47,-5,-6,1,0,1,-3,3,0,-5,5,0,0,2,2,1,0,1,-1,-11,2,-4,-3,7,-2,0,0,-1,-1,0,-1,1,-1
KR_6618029181,420,-7,-79,-43,-14,-3,4,1,-1,5,4,-8,8,0,-3,4,1,1,0,1,0,-20,6,-3,-4,7,-1,0,-1,-1,-1,-1,1,1,-1
KR_6717163898,420,1,42,0,0,1,0,1,1,2,3,6,0,6,-7,9,2,-1,1,0,0,-5,-18,2,-7,5,4,0,-1,1,-1,-1,-1,4,-1
KR_6747815676,420,-4,-44,-37,-6,-5,6,1,-2,6,4,0,2,2,1,0,1,0,2,2,0,-11,-7,-5,-2,7,0,0,0,-1,-1,-1,-1,4,-1
KR_6754531566,420,-2,-49,-13,0,0,3,3,2,3,5,-2,3,1,-1,3,2,1,1,2,0,2,2,-3,-3,6,6,0,-2,1,-1,-1,-1,5,-1
KR_6742797170,420,-1,-26,0,1,1,0,1,2,1,3,0,1,1,-1,4,3,-1,2,1,0,2,4,-4,-3,7,-1,0,-1,-1,-1,-1,-1,4,-1
KR_6760249804,420,-4,-2,-4,-14,-5,5,0,0,1,1,-2,2,0,-5,7,2,-2,4,2,0,-8,-7,-1,-3,4,4,0,0,-1,-1,-1,-1,4,-1
KR_6765795307,420,3,24,18,7,-1,2,1,4,3,7,0,3,3,3,0,3,1,0,1,0,11,-4,1,-5,4,1,0,0,1,-1,0,1,3,-1
KR_6760148905,420,-2,-87,26,-7,2,1,3,-1,3,2,-2,4,2,-4,5,1,-2,2,0,0,-14,-22,0,-5,5,-3,0,-1,-1,-1,-1,-1,1,-1
KR_6730892984,420,0,3,24,-2,-1,2,1,-3,4,1,-3,7,4,2,0,2,3,1,4,0,5,9,0,-3,3,-1,0,0,1,-1,1,1,4,-1
KR_6759199356,420,0,-47,11,2,-1,2,1,0,4,4,0,3,3,3,6,9,0,0,0,0,9,-2,0,-4,4,-2,0,1,1,1,1,1,1,-1
KR_6759373972,420,-3,-34,8,-5,-1,1,0,0,4,4,-2,3,1,-1,4,3,-1,1,0,0,1,4,1,-6,5,-3,0,0,-1,-1,0,-1,3,-1
KR_6539591476,420,-1,-11,-12,-3,2,2,4,0,3,3,-4,5,1,1,0,1,-2,2,0,0,-4,4,2,-7,5,0,0,0,-1,1,-1,1,3,-1
KR_6652307574,420,-3,-35,-55,-8,4,0,4,-7,10,3,0,2,2,-1,3,2,-4,5,1,0,-12,13,5,-10,5,-6,0,-1,-1,-1,-1,-1,3,-1
KR_6645716536,420,-4,-47,-24,-2,-2,2,0,-1,3,2,1,2,3,1,2,3,-1,2,1,0,-2,100,0,-4,4,-7,0,-1,-1,-1,-1,1,1,-1
KR_6758347723,420,-3,-27,-16,-7,3,1,4,-1,1,0,-3,6,3,-3,4,1,-3,3,0,0,-2,213,-1,-5,6,-2,0,-2,-1,-1,-1,-1,3,-1
KR_6762414580,440,-3,-3,4,-3,1,2,3,-1,4,3,-3,6,3,0,0,0,0,0,0,0,-2,-20,-8,-2,10,1,0,-1,1,-1,-1,-1,5,-1
KR_6736147314,420,-3,-2,5,-5,0,4,4,-5,5,0,1,0,1,-1,2,1,0,0,0,0,-9,11,3,-7,4,-1,0,-1,1,0,-1,-1,6,-1
KR_6688613245,420,1,-4,19,-1,2,1,3,3,0,3,-5,6,1,0,1,1,-1,1,0,0,-4,7,7,-11,4,-4,0,0,-1,1,0,1,1,-1
KR_6758779929,440,-4,-126,-4,-7,1,0,1,1,2,3,4,3,7,-7,7,0,-6,6,0,-1,-12,-11,5,-6,1,-7,0,-1,1,-1,-1,-1,2,-1
KR_6736200339,440,1,-18,-11,-2,3,1,4,-1,5,4,-7,8,1,4,2,6,-1,1,0,0,-7,168,-2,-1,3,-3,0,0,-1,-1,-1,-1,6,-1
KR_6765137238,420,-3,-30,-12,-14,-1,4,3,-4,7,3,-4,5,1,-5,7,2,0,1,1,-2,-15,15,-2,-6,8,-4,0,-1,-1,1,-1,-1,6,-1
KR_6751808883,420,-4,27,15,-10,1,1,2,-2,2,0,-5,6,1,-5,10,5,1,0,1,0,-7,21,2,-4,2,1,0,-1,1,1,1,-1,2,-1
KR_6763523382,420,2,9,20,1,2,0,2,-2,3,1,1,0,1,0,2,2,0,0,0,0,2,-4,1,-4,3,-1,0,0,-1,1,1,1,2,-1
KR_6689037661,420,-1,-25,-31,-5,-1,6,5,-2,2,0,-1,1,0,0,2,2,-1,1,0,0,-4,260,-4,-3,7,2,0,-3,1,-1,-1,1,2,-1
KR_6751201251,440,4,64,13,2,6,0,6,-3,4,1,2,2,4,-1,3,2,-2,2,0,0,-4,9,1,-5,4,-4,0,2,-1,1,1,-1,5,-1
KR_6730235587,420,-3,-82,-32,0,-3,6,3,2,1,3,-2,5,3,3,0,3,0,0,0,0,6,46,0,-6,6,-21,0,-1,1,-1,-1,-1,3,-1
KR_6678261675,420,-10,-128,-32,-25,-5,6,1,-3,4,1,-11,11,0,-5,5,0,-1,1,0,0,-29,-4,-1,-4,5,-4,0,-2,-1,-1,-1,-1,4,-1
KR_6718968508,420,-3,18,-43,-5,1,0,1,-3,6,3,-4,5,1,3,2,5,-2,3,1,1,5,11,2,-8,6,-3,0,0,1,-1,-1,-1,4,-1
KR_6764611603,440,-1,-27,-8,-2,-3,5,2,-2,2,0,-2,2,0,3,2,5,2,1,3,0,2,11,4,-8,4,-7,0,0,1,1,-1,1,3,-1
KR_6764369596,420,0,23,-15,-4,3,1,4,-3,4,1,-4,4,0,0,3,3,0,0,0,0,-11,24,2,-6,4,-4,0,0,-1,-1,0,1,4,-1
KR_6745026353,420,-5,-101,-3,-6,-3,3,0,-1,2,1,-2,2,0,0,0,0,0,0,0,0,-1,6,-8,0,8,-3,0,0,1,-1,-1,-1,5,-1
KR_6757179723,420,1,-5,16,-6,1,3,4,-2,6,4,0,2,2,-4,5,1,-1,2,1,-2,-6,-22,-4,0,4,1,0,-2,-1,-1,-1,-1,5,-1
KR_6756271617,420,-1,19,-11,3,4,0,4,0,1,1,0,2,2,0,2,2,-1,1,0,0,2,1,1,-4,3,-2,0,-2,-1,1,-1,1,2,-1
KR_6744356566,420,-1,-51,-16,-6,-1,3,2,1,1,2,-3,9,6,-4,5,1,1,0,1,0,-3,33,3,-6,3,1,0,-1,-1,-1,-1,1,6,-1
KR_6728240879,440,3,1,12,3,7,0,7,-2,2,0,0,1,1,-1,4,3,-1,2,1,0,10,-4,1,-5,4,3,0,-1,-1,1,-1,-1,2,-1
KR_6738567960,420,1,34,-8,-1,-1,1,0,1,6,7,0,2,2,-2,4,2,1,0,1,0,-1,106,-1,-3,4,0,0,1,1,1,1,-1,4,-1
KR_6756142756,420,-4,-73,-12,-7,-4,4,0,-3,4,1,0,1,1,1,2,3,-1,1,0,0,-4,0,2,-5,3,-2,0,0,1,-1,0,-1,2,-1
KR_6694795911,440,-3,-68,-23,-4,-2,4,2,-2,4,2,0,2,2,-2,4,2,2,0,2,-2,1,-86,2,-5,3,1,0,-1,-1,-1,-1,-1,1,-1
KR_6762977659,420,-3,-70,-8,-12,1,1,2,-1,2,1,-9,9,0,1,2,3,-4,4,0,0,-14,-7,-1,-5,6,-3,0,-1,-1,-1,-1,1,2,-1
KR_6761611860,440,-3,-31,16,-5,1,1,2,4,1,5,1,1,2,-11,11,0,0,2,2,0,-13,2,-4,-3,7,-5,0,0,-1,0,-1,1,2,-1
KR_6765617971,420,-4,-45,-3,-12,-3,4,1,-4,6,2,1,4,5,-6,6,0,0,1,1,-1,-18,-2,0,-5,5,-1,0,-1,-1,-1,-1,-1,4,-1
KR_6746111327,420,-3,32,-32,-6,-1,1,0,2,2,4,-2,3,1,-5,7,2,0,2,2,0,-9,-9,-1,-5,6,-4,0,0,-1,-1,0,1,1,-1
KR_6741226440,420,1,-8,4,3,0,1,1,0,3,3,-2,3,1,3,0,3,2,0,2,0,6,3,-3,-3,6,0,0,0,1,1,0,-1,5,-1
KR_6575985442,420,-2,-117,-8,-1,2,2,4,-3,6,3,0,2,2,2,0,2,-2,2,0,0,-6,1,-1,-5,6,-2,0,-1,1,-1,-1,1,6,-1
KR_6741393164,420,-3,-46,-13,-9,-2,4,2,-6,6,0,-2,4,2,0,5,5,1,1,2,0,-3,7,-1,-3,4,-1,0,0,-1,1,-1,1,4,-1
KR_6735048009,420,0,2,-8,0,2,0,2,1,7,8,-1,5,4,1,1,2,-3,4,1,0,-2,-29,3,-8,5,-2,0,0,1,-1,0,-1,6,-1
KR_6756392816,420,-2,-30,-4,-3,-5,5,0,-1,2,1,6,0,6,-1,7,6,-2,3,1,-1,5,-26,6,-10,4,3,0,0,1,-1,-1,-1,3,-1
KR_6684092865,420,-7,-80,7,-15,-3,4,1,-5,5,0,-3,5,2,-5,7,2,1,0,1,0,-8,-3,0,-5,5,-3,0,-1,1,0,-1,1,1,-1
KR_6697588475,420,-1,-44,-16,-14,-7,8,1,-6,8,2,0,4,4,-4,6,2,3,2,5,-1,-14,15,-4,-2,6,2,0,-2,1,-1,-1,-1,4,-1
KR_6671919384,420,0,11,4,-3,3,0,3,-3,5,2,0,3,3,-2,4,2,-1,1,0,0,2,60,-3,-4,7,8,0,-1,-1,-1,-1,-1,6,-1
KR_6726917019,420,-4,-30,-19,-9,-4,7,3,0,4,4,-2,4,2,-1,3,2,-2,2,0,-1,-4,8,2,-6,4,-2,0,-3,1,-1,1,-1,5,-1
KR_6746993741,420,-3,-36,13,-9,-1,2,1,-2,4,2,-1,2,1,-5,5,0,0,1,1,0,-8,4,4,-8,4,0,0,-1,-1,-1,-1,-1,3,-1
KR_6736669863,420,-6,-70,-32,-14,-4,4,0,-2,4,2,-2,4,2,-4,4,0,-2,3,1,0,-14,-18,-1,-5,6,2,0,-1,-1,-1,-1,-1,3,-1
KR_6738818318,420,2,-13,12,5,0,3,3,4,1,5,1,1,2,1,3,4,-1,4,3,0,5,0,2,-5,3,-1,0,2,1,1,1,-1,4,-1
KR_6681716991,420,-3,-65,-12,-8,-6,7,1,2,1,3,-3,3,0,0,1,1,-1,1,0,0,-1,-36,0,-4,4,0,0,-1,-1,-1,-1,-1,2,-1
KR_6759018210,420,1,57,-10,0,0,1,1,-1,3,2,0,2,2,1,3,4,0,2,2,0,-1,12,-1,-4,5,-1,0,-1,-1,-1,-1,1,4,-1
KR_6761125362,420,0,-52,5,-8,2,1,3,-2,4,2,-5,9,4,-4,4,0,1,1,2,-1,-7,3,0,-2,2,-1,0,-2,0,-1,-1,-1,0,-1
KR_6757862665,420,1,-10,3,-4,1,1,2,0,3,3,-3,3,0,-3,5,2,1,1,2,0,-6,4,-3,-6,9,1,0,0,-1,-1,0,-1,5,-1
KR_6759772931,420,-2,-28,-9,-9,0,0,0,-2,5,3,2,1,3,-7,10,3,-2,2,0,0,-13,-6,-2,-7,9,1,0,-1,-1,-1,-1,1,2,-1
KR_6765959670,420,3,31,-20,1,2,0,2,-2,5,3,3,1,4,-2,5,3,0,1,1,0,0,3,3,-8,5,0,0,1,-1,1,-1,-1,4,-1
KR_6763148279,420,-2,-11,-1,1,1,0,1,0,3,3,-1,1,0,1,0,1,0,1,1,0,-2,-5,-3,-5,8,-8,0,-1,-1,-1,-1,1,3,-1
KR_6720864464,420,-4,-34,-18,-11,1,1,2,-8,8,0,-4,5,1,0,2,2,0,1,1,1,-15,-44,2,-6,4,10,0,-1,-1,1,-1,1,5,-1
KR_6757010125,420,-6,-59,-33,-7,-4,6,2,3,0,3,0,1,1,-2,8,6,-4,4,0,-1,-3,5,6,-7,1,-2,0,-3,-1,1,-1,-1,5,-1
KR_6733070252,420,1,10,-11,3,1,0,1,4,1,5,-3,3,0,2,2,4,-1,3,2,0,7,-43,-1,-4,5,23,0,0,1,1,-1,1,3,-1
KR_6721085421,420,2,-31,-9,-4,0,4,4,2,1,3,1,2,3,-5,6,1,-2,2,0,0,-8,-113,1,-6,5,-2,0,0,1,1,0,-1,5,-1
KR_6739309899,420,-1,-4,-20,4,-4,5,1,2,0,2,6,0,6,-1,3,2,1,1,2,0,6,-203,-5,-4,9,4,0,0,-1,1,-1,1,5,-1
KR_6729577671,420,-2,-16,-26,-4,-2,4,2,-1,1,0,-1,6,5,1,1,2,-1,1,0,0,-8,9,2,-8,6,-8,0,0,-1,-1,-1,1,6,-1
KR_6662766754,420,-2,-43,-5,-2,0,1,1,-6,7,1,4,1,5,-2,2,0,2,0,2,0,-6,-41,0,-5,5,-3,0,0,0,-1,-1,1,0,-1
KR_6738659547,420,-3,9,14,-7,1,1,2,-3,5,2,-3,4,1,-1,3,2,-1,1,0,0,-3,-2,0,-3,3,-1,0,-1,-1,1,-1,-1,1,-1
KR_6764093854,420,3,26,17,1,3,1,4,-2,3,1,1,1,2,-1,2,1,0,1,1,0,-3,3,-1,-6,7,-1,0,0,-1,1,0,1,6,-1
KR_6634933107,440,-4,-29,-19,-9,-6,6,0,-1,1,0,0,2,2,-1,2,1,-1,3,2,0,-1,136,3,-6,3,-6,0,0,1,1,0,-1,5,-1
KR_6763263503,420,0,-57,0,-1,1,1,2,-3,4,1,0,1,1,2,2,4,-1,1,0,0,0,-45,3,-8,5,34,0,0,-1,-1,0,1,4,-1
KR_6749092056,420,-1,-34,-39,1,-5,6,1,0,4,4,1,4,5,3,2,5,2,2,4,0,6,-2,-1,-7,8,4,0,-1,1,-1,-1,1,2,-1
KR_6761122852,440,-2,30,-4,-5,-1,2,1,-5,6,1,-2,5,3,1,3,4,2,1,3,0,-10,1,-4,-3,7,0,0,1,1,1,1,-1,1,-1
KR_6749320846,420,-7,-145,-46,-14,-3,5,2,-2,3,1,-6,6,0,-2,6,4,-1,3,2,0,-9,9,0,-7,7,-4,0,-1,0,-1,-1,-1,0,-1
KR_6734326800,420,3,-30,39,4,0,0,0,2,3,5,4,3,7,-1,2,1,-1,1,0,0,8,42,-2,-7,9,1,0,-1,-1,-1,-1,-1,4,-1
KR_6708465357,420,-1,-5,-4,-10,4,0,4,-7,9,2,-4,5,1,-2,2,0,-1,3,2,0,-6,0,-5,-2,7,0,0,-1,-1,1,1,1,4,-1
KR_6700024859,420,-1,-53,-2,1,1,0,1,-1,3,2,0,0,0,1,1,2,0,0,0,0,2,-50,-3,-4,7,23,0,0,-1,1,0,-1,2,-1
KR_6634435690,420,2,-2,12,-3,0,5,5,1,2,3,-3,5,2,2,7,9,-3,3,0,-1,3,162,-1,-6,7,5,0,0,-1,1,-1,-1,4,-1
KR_6733793616,420,-2,-33,-23,-8,-7,7,0,-3,4,1,-3,4,1,2,3,5,3,0,3,-1,1,34,4,-7,3,-4,0,-2,-1,-1,-1,-1,4,-1
KR_6762327636,420,-1,-9,-5,-6,1,1,2,-6,7,1,0,1,1,-4,6,2,3,2,5,-1,-5,3,6,-14,8,3,0,-1,-1,-1,-1,1,2,-1
KR_6690959026,420,-2,-11,1,-6,-3,3,0,2,0,2,-1,4,3,-4,9,5,0,1,1,-1,-1,-3,-1,-5,6,-1,0,-1,-1,-1,-1,1,3,-1
KR_6615105021,420,1,-2,-4,3,2,0,2,0,2,2,7,1,8,-8,8,0,2,0,2,0,2,-4,-2,-4,6,3,0,0,-1,-1,1,1,3,-1
KR_6747214485,440,1,-2,-31,1,0,4,4,-2,2,0,-2,5,3,1,2,3,4,1,5,0,8,6,-1,-2,3,-5,0,0,1,-1,-1,-1,5,-1
KR_6743228700,420,-2,-39,12,-6,3,2,5,4,2,6,-9,10,1,-1,3,2,-3,3,0,2,-3,-8,1,-5,4,-5,0,-1,-1,0,-1,1,2,-1
KR_6766053753,420,-1,-5,-12,-6,-1,1,0,-5,8,3,1,2,3,1,0,1,-2,2,0,0,-6,-2,2,-5,3,0,0,0,-1,-1,0,-1,6,-1
KR_6763450708,420,-3,-79,8,-15,3,0,3,-7,8,1,-6,6,0,-5,8,3,0,1,1,0,-11,6,3,-7,4,-6,0,-3,1,-1,-1,1,5,-1
KR_6685679069,420,-1,-40,-7,-6,-1,5,4,0,3,3,-1,3,2,-2,6,4,-2,3,1,0,-4,5,2,-5,3,-2,0,0,1,-1,0,-1,4,-1
KR_6739781536,420,0,34,-24,2,2,0,2,0,3,3,-4,4,0,1,2,3,3,0,3,0,1,5,-5,-3,8,1,0,2,1,-1,1,1,5,-1
KR_6751474707,420,-2,-39,-2,-6,0,2,2,1,3,4,-4,5,1,-4,5,1,1,0,1,-1,-12,4,4,-7,3,-7,0,-2,-1,1,-1,-1,1,-1
KR_6731410490,420,-3,1,-8,-6,2,1,3,-6,10,4,-3,3,0,1,1,2,0,0,0,0,-5,4,6,-8,2,1,0,0,-1,1,0,-1,5,-1
KR_6731412988,440,-5,-42,-31,-13,-3,3,0,-8,10,2,-5,5,0,2,1,3,1,0,1,1,-6,99,0,-3,3,-2,0,0,-1,1,1,1,3,-1
KR_6754460322,420,-4,-23,-34,-14,0,3,3,-8,9,1,-4,7,3,-4,7,3,2,1,3,-3,-18,46,2,-4,2,-2,0,-3,-1,-1,-1,-1,6,-1
KR_6758964591,420,-2,-58,14,-6,-3,4,1,0,1,1,-5,6,1,0,4,4,2,0,2,0,-9,4,-1,-4,5,0,0,-2,-1,-1,-1,-1,5,-1
KR_6711939805,420,-6,-61,-60,-9,-2,3,1,-1,8,7,0,2,2,-4,4,0,-2,2,0,0,-7,-51,-7,-2,9,10,0,-2,-1,-1,-1,1,2,-1
KR_6722229347,420,-2,-6,-5,-2,0,3,3,-1,4,3,-2,2,0,1,1,2,0,1,1,0,4,-3,-3,-6,9,-1,0,-1,1,-1,-1,-1,1,-1
KR_6747054999,420,1,35,8,1,0,1,1,-2,4,2,4,3,7,-1,2,1,0,1,1,-1,6,1,2,-6,4,-6,0,-1,0,1,-1,-1,0,-1
KR_6726976613,420,-7,-134,-20,-19,-6,6,0,-2,3,1,1,1,2,-11,11,0,-1,1,0,0,-12,3,3,-8,5,-7,0,-3,-1,-1,-1,-1,6,-1
KR_6757714382,420,-3,19,-8,1,-1,3,2,6,0,6,0,1,1,-3,4,1,-1,2,1,0,2,-13,2,-4,2,-1,0,1,1,1,1,1,1,-1
KR_6737299849,420,-1,-17,-21,5,-1,3,2,-4,5,1,0,1,1,7,3,10,3,1,4,-1,15,0,-2,-3,5,4,0,0,1,-1,-1,-1,4,-1
KR_6763797070,420,-2,-46,-14,-9,3,0,3,-5,5,0,-4,8,4,0,3,3,-3,4,1,0,-8,12,0,-7,7,-8,0,0,-1,-1,-1,-1,4,-1
KR_6713716777,420,0,22,17,-5,-3,5,2,0,3,3,1,1,2,-3,5,2,0,2,2,1,-5,-1,-1,-3,4,-4,0,-1,1,-1,-1,1,4,-1
KR_6754011434,420,-2,0,-14,-4,-1,1,0,-2,4,2,-4,4,0,-1,4,3,4,0,4,0,0,20,-2,-4,6,-17,0,0,1,-1,0,-1,6,-1
KR_6745035415,440,-5,-90,-16,-11,-2,2,0,-1,1,0,-2,2,0,-1,2,1,-5,5,0,0,-10,51,-1,-4,5,-2,0,-2,-1,-1,-1,-1,5,-1
KR_6758807292,420,0,4,-13,-7,-2,3,1,0,3,3,-3,4,1,2,5,7,-4,4,0,0,-5,87,2,-3,1,2,0,-1,0,-1,-1,-1,0,-1
KR_6706207560,420,-1,-106,0,4,-1,2,1,3,1,4,4,1,5,-1,1,0,-1,1,0,0,2,-4,-3,-2,5,19,0,-3,-1,-1,-1,1,1,-1
KR_6743244919,420,1,9,-16,7,3,1,4,1,3,4,1,3,4,1,3,4,1,0,1,0,-2,-3,-2,-4,6,-1,0,1,-1,1,1,1,1,-1
KR_6758619118,420,-1,26,12,-2,1,2,3,-4,4,0,2,1,3,-2,4,2,1,3,4,1,-9,8,-3,-5,8,-6,0,0,0,-1,-1,1,0,-1
KR_6760630686,420,0,14,12,4,-1,2,1,5,0,5,-2,3,1,1,1,2,1,0,1,0,7,-192,1,-8,7,3,0,0,1,-1,0,1,4,-1
KR_6747531273,420,-2,-17,-8,-4,0,0,0,-1,3,2,0,1,1,-4,9,5,1,0,1,2,-2,-10,3,-8,5,-6,0,-1,-1,1,-1,1,1,-1
KR_6725474927,420,-5,-40,-24,-1,-6,7,1,2,0,2,1,1,2,2,2,4,0,0,0,0,5,-9,-2,-5,7,-2,0,-2,1,-1,-1,-1,1,-1
KR_6766071529,440,1,-57,28,1,-2,2,0,-5,5,0,1,3,4,7,4,11,0,3,3,1,5,-23,2,-5,3,3,0,0,0,0,-1,1,0,-1
KR_6727059190,420,0,-72,3,-6,-4,4,0,-3,6,3,-4,4,0,5,2,7,0,1,1,-1,-4,-5,-3,-6,9,-6,0,0,0,1,0,-1,0,-1
KR_6745430243,420,0,41,20,-3,1,2,3,-4,5,1,-1,4,3,-1,3,2,2,0,2,0,-3,-22,-2,-6,8,2,0,1,1,-1,1,-1,4,-1
KR_6751870824,420,-2,-68,-47,-11,-6,9,3,-6,8,2,-6,6,0,5,3,8,2,1,3,-5,-7,-342,1,-8,7,-2,0,0,-1,-1,-1,-1,3,-1
KR_6766046816,420,-4,-41,-7,-6,-1,5,4,1,3,4,0,4,4,-5,6,1,-1,1,0,2,-4,-5,1,-5,4,-3,0,-1,-1,-1,1,1,6,-1
KR_6757334697,420,-2,-47,14,-4,1,0,1,2,2,4,-2,3,1,-4,6,2,-1,1,0,0,-5,312,5,-8,3,-8,0,1,-1,1,1,-1,1,-1
KR_6702262912,420,-2,-12,-15,2,3,1,4,0,1,1,4,0,4,-5,5,0,0,0,0,0,3,-14,-4,-3,7,1,0,-1,-1,-1,-1,-1,1,-1
KR_6671203414,420,0,10,1,0,-1,2,1,2,2,4,5,2,7,-2,2,0,-4,5,1,0,-3,1,2,-7,5,3,0,-1,-1,1,-1,1,2,-1
KR_6638210986,420,-2,-39,8,-6,-5,6,1,0,2,2,-1,6,5,-1,4,3,1,0,1,0,-7,-2,-2,-5,7,-1,0,-1,1,-1,-1,1,6,-1
KR_6716520670,420,-3,-18,0,-5,1,2,3,2,2,4,0,3,3,-10,11,1,2,0,2,0,-12,-48,-2,-6,8,21,0,-1,-1,-1,-1,1,5,-1
KR_6743046419,420,-1,-22,-7,0,-5,7,2,-2,2,0,0,0,0,7,2,9,0,0,0,-1,7,-62,0,-4,4,0,0,-1,1,-1,-1,-1,6,-1
KR_6760501408,420,-6,-35,-32,-16,-2,3,1,-4,6,2,-1,6,5,-7,7,0,-2,3,1,0,-18,-23,-2,-5,7,1,0,-2,-1,-1,-1,1,1,-1
KR_6750719123,420,-3,-62,9,-3,3,0,3,0,2,2,-3,3,0,-4,5,1,1,2,3,0,-10,3,4,-9,5,-1,0,0,-1,-1,-1,-1,5,-1
KR_6757732528,420,-1,-48,-8,-7,-2,4,2,-2,4,2,-6,7,1,3,0,3,0,2,2,0,-3,9,-2,-3,5,-3,0,1,-1,-1,1,-1,4,-1
KR_6640134036,420,3,-32,14,7,1,0,1,0,4,4,3,1,4,0,4,4,3,0,3,0,2,12,5,-9,4,-3,0,0,1,1,0,1,6,-1
KR_6756176849,440,-1,51,-35,5,2,2,4,0,4,4,-3,3,0,6,0,6,0,1,1,2,14,-5,-1,-4,5,-2,0,1,-1,-1,1,1,1,-1
KR_6763107987,420,1,-48,8,-2,0,2,2,2,3,5,-3,5,2,-2,3,1,1,1,2,0,7,14,-4,-1,5,5,0,-1,-1,-1,-1,1,5,-1
KR_6751723808,420,-6,-75,4,-8,-3,3,0,0,0,0,-2,4,2,1,3,4,-4,4,0,0,-3,-5,2,-4,2,1,0,-2,-1,0,-1,1,4,-1
KR_6756009515,420,-2,4,1,-4,3,1,4,1,1,2,-7,8,1,-1,3,2,0,1,1,0,-9,20,-2,-7,9,5,0,0,-1,1,0,1,1,-1
KR_6748571414,420,3,42,-8,-1,-2,4,2,0,3,3,0,5,5,1,7,8,0,0,0,-3,-7,3,-5,-4,9,8,0,-1,1,-1,-1,1,6,-1
KR_6692553592,420,-6,-11,-4,-3,-1,2,1,1,5,6,-2,3,1,-2,6,4,1,0,1,3,-2,-2,-9,-5,14,-5,0,-1,1,-1,-1,1,3,-1
KR_6728684993,420,-2,-52,-9,-8,-4,5,1,0,1,1,0,1,1,-4,5,1,0,1,1,0,-5,-24,-5,-1,6,2,0,-1,1,-1,-1,1,1,-1
KR_6763538497,420,-5,-71,-16,-10,-6,7,1,-2,4,2,-1,2,1,-1,2,1,0,1,1,-1,-8,-5,4,-11,7,-1,0,0,-1,1,-1,-1,3,-1
KR_6719219638,420,-3,-22,-5,-13,-4,4,0,-2,3,1,-2,2,0,-1,4,3,-4,4,0,0,-9,-2,-1,-4,5,-1,0,-1,1,-1,-1,-1,4,-1
KR_6606491654,420,-2,8,4,-5,0,1,1,1,3,4,-1,5,4,-1,3,2,-4,4,0,0,-15,7,-3,-2,5,-2,0,-1,-1,-1,-1,-1,1,-1
KR_6760745298,420,-2,-49,-18,-1,0,2,2,2,2,4,-3,3,0,2,3,5,-2,3,1,0,6,-7,1,-4,3,-1,0,-1,1,-1,-1,1,6,-1
KR_6764673956,420,0,-3,33,0,-1,1,0,4,2,6,5,1,6,-6,9,3,-2,2,0,0,-7,9,0,-3,3,-6,0,1,1,1,1,-1,3,-1
KR_6653638726,420,3,38,-25,1,8,0,8,-5,5,0,2,1,3,-2,3,1,-2,2,0,0,-5,12,1,-5,4,-5,0,0,1,1,1,1,5,-1
KR_6760788338,420,0,-11,23,-6,0,2,2,-1,2,1,-1,3,2,-4,5,1,0,1,1,0,-12,-3,-3,-4,7,-3,0,2,-1,1,1,1,2,-1
KR_6596469233,420,0,-97,26,-3,-2,3,1,1,2,3,1,0,1,-1,2,1,-2,2,0,0,-3,8,-2,-2,4,-1,0,-1,1,-1,-1,-1,4,-1
KR_6764745188,440,-5,3,-24,-16,-5,5,0,-6,6,0,0,2,2,-3,6,3,-2,2,0,0,-20,-3,-2,-6,8,-2,0,-3,1,-1,-1,-1,3,-1
KR_6753571799,440,0,79,24,-2,1,2,3,-5,6,1,-1,3,2,2,3,5,1,1,2,-1,-9,149,0,-3,3,0,0,-1,0,-1,-1,-1,0,-1
KR_6736239239,420,-4,-90,-12,-11,-2,2,0,-4,5,1,-4,5,1,1,1,2,-2,2,0,0,-13,-8,-3,-3,6,-3,0,-1,-1,1,-1,-1,3,-1
KR_6738478564,420,6,28,16,7,3,0,3,-1,3,2,2,3,5,1,1,2,2,0,2,0,8,28,2,-11,9,0,0,1,0,1,1,-1,0,-1
KR_6764950833,420,-1,-72,-23,-3,-1,2,1,0,2,2,2,4,6,-3,5,2,-1,1,0,0,-12,-27,2,-9,7,-1,0,0,-1,1,1,-1,4,-1
KR_6713316729,420,-4,-33,-29,-12,-1,3,2,-2,4,2,-5,5,0,-3,7,4,-1,2,1,0,-14,-12,-1,-4,5,3,0,-4,-1,-1,-1,-1,3,-1
KR_6604949371,420,0,19,-3,0,-1,1,0,1,2,3,4,2,6,-1,1,0,-3,3,0,0,-8,-22,-3,-4,7,3,0,1,-1,1,1,-1,4,-1
KR_6752832371,440,0,-63,-3,-3,-2,2,0,1,3,4,0,0,0,-2,3,1,0,3,3,0,-2,2,1,-6,5,-3,0,0,1,-1,0,-1,1,-1
KR_6662704926,420,-5,-19,-4,-11,-4,4,0,-9,12,3,1,0,1,-1,4,3,2,0,2,0,-6,0,-3,-7,10,1,0,0,-1,-1,1,-1,1,-1
KR_6683321319,420,-1,-53,-19,3,7,1,8,-3,7,4,0,2,2,-2,3,1,1,0,1,0,-1,6,4,-10,6,-2,0,0,-1,-1,-1,1,3,-1
KR_6764800080,420,3,46,-1,7,2,0,2,1,1,2,0,1,1,2,2,4,2,1,3,0,7,-3,4,-6,2,0,0,0,1,1,0,-1,4,-1
KR_6660403340,420,0,-29,18,1,-2,2,0,4,1,5,0,3,3,-2,2,0,1,0,1,0,6,27,1,-7,6,1,0,0,-1,-1,-1,-1,2,-1
KR_6666862979,420,2,32,5,-1,-1,3,2,2,2,4,5,0,5,-2,2,0,-5,6,1,0,5,4,-3,-6,9,1,0,-1,-1,1,-1,-1,3,-1
KR_6760980750,420,0,-43,8,6,-2,2,0,2,0,2,0,2,2,0,6,6,6,0,6,0,18,-1,1,-7,6,6,0,-2,1,-1,-1,1,5,-1
KR_6703528373,420,-4,-98,-16,-5,-3,4,1,-1,6,5,0,2,2,-1,2,1,0,2,2,-1,-5,27,-8,-2,10,-11,0,-1,1,-1,-1,-1,3,-1
KR_6614809029,420,3,-58,43,5,0,2,2,4,1,5,5,1,6,-5,9,4,1,0,1,-1,4,143,-2,-5,7,-3,0,-1,-1,1,-1,-1,3,-1
KR_6749679075,420,-2,-4,-1,-7,-2,2,0,-1,2,1,-4,4,0,0,3,3,0,2,2,0,-4,-9,-1,-3,4,3,0,1,-1,-1,-1,-1,3,-1
KR_6739756511,420,-3,-51,-36,-5,2,2,4,-1,4,3,-3,4,1,-3,3,0,0,1,1,0,-3,-7,-1,-4,5,0,0,0,-1,-1,-1,-1,3,-1
KR_6724477089,420,-1,19,-5,-3,5,0,5,-3,3,0,-2,2,0,-3,4,1,0,1,1,1,-9,-121,3,-9,6,9,0,1,-1,-1,1,1,2,-1
KR_6759892597,420,-4,-49,-19,-14,-6,6,0,-3,3,0,0,2,2,-2,4,2,-3,4,1,0,-4,39,0,-5,5,-5,0,-2,0,-1,-1,-1,0,-1
KR_6700419429,420,0,-17,-12,2,-2,2,0,0,4,4,1,4,5,0,1,1,3,0,3,0,6,3,0,-5,5,-3,0,-1,1,0,-1,-1,2,-1
KR_6759270330,420,-3,-53,41,-1,6,0,6,-5,5,0,-2,4,2,0,4,4,0,0,0,1,-7,-4,-5,-3,8,1,0,0,1,1,1,1,6,-1
KR_6758867701,440,-1,-30,10,-5,3,3,6,-1,4,3,-1,5,4,-4,4,0,-2,2,0,0,-7,20,-3,-1,4,-4,0,-1,-1,-1,-1,1,2,-1
KR_6748033691,420,-3,-3,18,-4,0,0,0,-4,6,2,-3,5,2,-1,3,2,4,2,6,0,-6,-7,-4,-4,8,3,0,0,1,1,0,-1,5,-1
KR_6744412472,420,0,-22,-4,1,-3,5,2,3,3,6,-4,5,1,4,1,5,1,0,1,0,12,-5,1,-5,4,-1,0,-1,-1,-1,-1,-1,6,-1
KR_6679295341,420,-3,-57,29,-7,0,0,0,0,2,2,3,2,5,-1,1,0,-9,10,1,0,-8,2,-3,-4,7,-1,0,-2,0,-1,-1,-1,0,-1
KR_6756745893,420,-6,-21,8,-16,-2,2,0,-4,4,0,-4,5,1,-3,6,3,-3,3,0,1,-22,-1,2,-6,4,-1,0,0,-1,1,0,1,5,-1
KR_6765089471,420,-3,-53,-3,-8,-4,4,0,-2,6,4,1,3,4,-2,3,1,-1,4,3,0,-8,1,-1,-4,5,5,0,-1,0,-1,-1,-1,0,-1
KR_6746488755,420,1,76,-25,5,0,0,0,3,3,6,0,5,5,1,2,3,1,1,2,0,4,6,-2,-6,8,-2,0,0,0,0,-1,1,0,-1
KR_6759211795,420,-1,-14,8,-8,-2,3,1,-2,5,3,-3,3,0,-3,5,2,2,0,2,0,-7,-25,-4,-4,8,13,0,1,-1,0,1,-1,3,-1
KR_6591755984,420,0,-39,-15,0,2,0,2,2,3,5,-3,4,1,-2,4,2,1,1,2,0,4,-3,3,-7,4,5,0,0,-1,-1,0,-1,3,-1
KR_6740469413,440,0,25,-36,-4,-1,1,0,0,1,1,-2,5,3,2,0,2,-3,4,1,0,-7,-78,-4,-3,7,-3,0,1,-1,-1,1,-1,6,-1
KR_6764064940,420,-1,-23,-16,-2,-3,5,2,-2,2,0,-3,4,1,2,2,4,4,0,4,0,-3,2,0,-4,4,3,0,-1,-1,-1,-1,-1,4,-1
KR_6751962938,420,-1,-11,1,-1,-3,3,0,-6,6,0,0,2,2,3,0,3,5,0,5,0,0,-6,-4,-5,9,-3,0,0,1,-1,-1,1,3,-1
KR_6683938145,440,-2,19,-19,2,3,2,5,-4,4,0,1,2,3,2,2,4,0,2,2,1,9,12,2,-7,5,-6,0,-1,-1,-1,-1,1,1,-1
KR_6746655322,440,-5,-7,-24,-8,-5,6,1,-2,4,2,0,3,3,0,5,5,-1,1,0,0,2,9,-4,-1,5,2,0,-2,0,-1,-1,1,0,-1
KR_6700255285,420,-1,-29,12,0,-2,2,0,5,2,7,-1,2,1,-1,4,3,-1,2,1,0,2,-5,4,-8,4,-5,0,0,-1,-1,0,-1,5,-1
KR_6761263961,420,-2,-70,20,-3,-2,2,0,1,1,2,-2,5,3,-1,2,1,1,0,1,0,0,-6,-4,-3,7,0,0,0,-1,-1,0,-1,4,-1
KR_6766166918,420,-1,34,-1,-5,5,1,6,2,2,4,-2,5,3,-8,11,3,-2,2,0,0,1,-3,2,-6,4,-4,0,-2,-1,-1,-1,-1,2,-1
KR_6757702632,420,-1,4,-11,-10,1,0,1,-7,7,0,-5,6,1,1,2,3,0,1,1,0,-14,13,0,-4,4,0,0,1,-1,0,1,1,5,-1
KR_6741253012,420,0,-54,-16,1,-1,2,1,-4,5,1,-1,2,1,2,0,2,5,0,5,0,7,5,-4,-2,6,-1,0,-2,-1,-1,-1,1,6,-1
KR_6740540916,420,-3,15,0,-4,1,0,1,4,3,7,-4,4,0,-6,7,1,1,2,3,1,-2,-1,6,-9,3,-2,0,-1,-1,-1,-1,1,3,-1
KR_6762075039,420,1,10,4,5,0,1,1,3,0,3,2,0,2,-1,3,2,1,1,2,0,8,8,2,-8,6,2,0,1,-1,1,1,1,1,-1
KR_6762526186,440,1,52,0,6,7,2,9,1,0,1,2,1,3,-3,5,2,-1,2,1,0,11,25,-1,-4,5,-4,0,1,1,-1,1,1,6,-1
KR_6714158691,420,1,21,0,-5,0,2,2,0,2,2,-3,4,1,0,3,3,-2,2,0,0,-14,-90,0,-6,6,-5,0,1,-1,-1,-1,-1,2,-1
KR_6764193454,420,-1,-5,13,0,0,1,1,0,1,1,2,3,5,0,3,3,-2,5,3,0,-5,-18,-7,-5,12,-1,0,0,-1,-1,0,-1,5,-1
KR_6699050730,440,-2,-15,-29,2,-2,5,3,2,0,2,-3,5,2,3,1,4,2,4,6,1,19,1,0,-6,6,0,0,-3,-1,0,-1,1,2,-1
KR_6739444850,420,1,-40,-15,-4,2,1,3,-4,5,1,2,0,2,-3,4,1,-1,1,0,0,-12,-2,1,-7,6,-2,0,-1,1,-1,-1,-1,4,-1
KR_6728041783,420,-2,-65,-43,0,0,1,1,3,2,5,-2,2,0,-3,3,0,2,0,2,0,1,13,1,-3,2,-1,0,-1,-1,-1,-1,1,4,-1
KR_6744367629,420,-3,-107,24,-5,-4,4,0,1,3,4,-3,7,4,0,3,3,1,1,2,0,3,-2,-3,-6,9,2,0,-1,0,1,-1,-1,0,-1
KR_6744830085,440,-1,-60,8,-5,-4,5,1,-1,3,2,-1,4,3,2,1,3,-1,1,0,-1,-6,22,-2,-4,6,0,0,-1,1,-1,-1,-1,6,-1
KR_6757222358,420,2,1,28,-2,0,3,3,0,0,0,-2,5,3,-2,5,3,2,0,2,0,-7,112,1,-6,5,2,0,0,1,-1,0,-1,1,-1
KR_6649556137,420,-1,-11,-19,4,-1,3,2,-1,5,4,3,0,3,3,0,3,0,1,1,0,7,6,4,-8,4,5,0,0,-1,-1,-1,-1,5,-1
KR_6766138521,420,2,70,-7,10,3,1,4,0,3,3,4,3,7,5,3,8,-2,2,0,0,5,-19,1,-6,5,-1,0,1,-1,1,1,-1,1,-1
KR_6762646319,420,0,7,20,-7,-4,4,0,0,1,1,0,2,2,1,0,1,-4,5,1,0,-7,-7,1,-5,4,2,0,0,0,-1,0,-1,0,-1
KR_6677269144,440,-5,-68,-3,-9,-9,10,1,2,3,5,-3,4,1,-1,7,6,2,0,2,1,-1,0,0,-6,6,1,0,0,-1,-1,-1,-1,2,-1
KR_6739683407,420,-7,-51,-15,-11,0,1,1,-8,9,1,-4,5,1,4,0,4,-3,5,2,0,-12,-7,-3,-3,6,3,0,0,-1,-1,-1,-1,4,-1
KR_6758675754,440,-1,-14,-13,-4,2,0,2,5,0,5,1,1,2,-14,14,0,2,1,3,1,0,2,2,-4,2,-4,0,-1,-1,1,-1,1,1,-1
KR_6750279349,420,1,-8,28,1,0,1,1,1,3,4,-1,1,0,1,0,1,0,0,0,0,3,0,0,-4,4,2,0,-1,-1,-1,-1,-1,6,-1
KR_6707843016,420,-3,-95,-8,-10,-3,4,1,-6,6,0,-2,3,1,0,1,1,1,2,3,0,-8,-5,-4,-1,5,2,0,0,-1,-1,-1,1,5,-1
KR_6686684612,420,-2,-31,-9,-3,-2,2,0,1,3,4,1,1,2,-1,5,4,-2,3,1,0,10,6,6,-11,5,-3,0,0,1,-1,-1,-1,1,-1
KR_6757705649,420,-2,-23,-7,-5,-1,1,0,4,2,6,-7,8,1,-3,4,1,2,0,2,0,-4,-22,0,-5,5,-1,0,-1,-1,-1,-1,-1,1,-1
KR_6631028435,420,0,-3,4,-1,2,2,4,-3,4,1,-1,1,0,2,3,5,-1,1,0,0,-7,-2,-1,-4,5,2,0,0,0,0,0,1,0,-1
KR_6745875160,420,-2,139,-98,-8,-1,3,2,2,0,2,-5,7,2,0,2,2,-4,5,1,2,4,4,2,-4,2,-1,0,-1,-1,-1,1,1,4,-1
KR_6704966256,420,-1,-34,2,-4,0,2,2,1,3,4,-3,3,0,-2,5,3,0,0,0,-1,-1,-46,-4,-3,7,4,0,0,-1,1,1,-1,4,-1
KR_6638827568,420,-1,-35,-9,0,0,1,1,2,4,6,-3,3,0,-2,3,1,3,0,3,0,4,-3,-2,-5,7,0,0,-1,-1,-1,-1,1,4,-1
KR_6766203456,420,-1,11,22,-2,1,1,2,1,0,1,-1,2,1,-4,7,3,1,3,4,-1,0,-4,-2,-3,5,-3,0,0,1,1,-1,-1,1,-1
KR_6765714025,420,-2,7,-16,-3,-1,1,0,-2,3,1,2,0,2,-1,2,1,-1,1,0,0,-4,-154,1,-5,4,2,0,0,-1,1,0,1,3,-1
KR_6750102225,420,-1,-11,-32,2,3,0,3,-3,8,5,2,0,2,3,2,5,-3,3,0,0,3,-7,2,-5,3,2,0,0,1,-1,0,-1,3,-1
KR_6711155799,440,-3,4,-20,-10,2,1,3,-7,9,2,-2,4,2,-3,3,0,0,0,0,-1,-18,318,-6,0,6,-4,0,1,-1,1,1,-1,5,-1
KR_6735345931,440,-4,1,-8,-1,1,1,2,3,1,4,-1,1,0,-4,6,2,0,1,1,1,4,8,1,-5,4,-2,0,1,1,-1,-1,1,2,-1
KR_6595225210,440,4,40,24,6,-2,3,1,6,2,8,3,0,3,-1,7,6,0,0,0,1,7,45,-1,-4,5,-15,0,1,-1,1,1,1,1,-1
KR_6724576088,420,2,-6,-10,0,3,0,3,-2,3,1,0,1,1,-2,3,1,1,1,2,0,-2,1,2,-6,4,1,0,-1,-1,-1,-1,-1,1,-1
KR_6763924856,440,-10,-129,-83,-11,-3,3,0,1,1,2,-4,4,0,-5,7,2,0,1,1,-1,-5,-8,-2,-1,3,1,0,-5,-1,-1,-1,-1,2,-1
KR_6764736571,420,-1,-56,-27,-7,0,1,1,-2,3,1,-3,3,0,-2,2,0,0,0,0,0,-8,2,2,-6,4,0,0,-1,1,-1,-1,-1,1,-1
KR_6760543193,420,-1,46,-4,-4,-2,3,1,-1,2,1,-1,1,0,0,1,1,0,0,0,0,-5,117,-1,-4,5,-2,0,-1,1,-1,-1,-1,4,-1
KR_6437609005,420,0,60,-8,-1,-1,1,0,-2,2,0,2,0,2,0,1,1,0,0,0,0,-6,-66,0,-4,4,1,0,-1,1,-1,-1,1,6,-1
KR_6761622593,420,0,24,20,2,0,3,3,1,1,2,2,0,2,-1,3,2,0,0,0,0,1,-120,-1,-3,4,4,0,0,1,1,0,1,6,-1
KR_6763931642,420,-3,-37,-12,-6,-2,3,1,2,2,4,-2,4,2,-1,2,1,-3,5,2,0,-13,320,0,-4,4,2,0,-1,-1,-1,-1,1,4,-1
KR_6746298963,440,-6,-82,-14,-9,2,0,2,0,4,4,-5,5,0,-2,3,1,-4,5,1,-1,-14,3,-1,-6,7,-1,0,0,-1,1,-1,-1,1,-1
KR_6709197645,420,0,21,0,-1,2,1,3,1,3,4,0,2,2,-4,7,3,0,0,0,0,-6,-12,2,-7,5,-2,0,-1,-1,-1,-1,-1,4,-1
KR_6690909594,420,-7,-53,0,-15,-2,3,1,-6,7,1,-1,2,1,-3,3,0,-3,4,1,0,-18,-8,3,-5,2,-9,0,-3,-1,-1,-1,-1,6,-1
KR_6762376895,420,0,-30,-4,3,2,0,2,-3,6,3,0,2,2,5,5,10,-1,1,0,-2,-7,11,6,-8,2,-3,0,0,-1,1,1,-1,3,-1
KR_6718009724,420,-2,-18,-12,-9,-2,3,1,-1,2,1,-2,2,0,-3,5,2,-1,2,1,-1,-10,0,-1,-5,6,-6,0,-1,-1,1,-1,-1,6,-1
KR_6760552072,420,1,4,3,1,2,1,3,0,3,3,-1,2,1,-1,4,3,1,1,2,-1,-4,-1,0,-4,4,0,0,0,-1,1,1,-1,4,-1
KR_6764291299,420,-2,-50,-1,-7,-2,3,1,-4,4,0,-1,3,2,0,0,0,0,0,0,0,-8,-3,-4,-4,8,0,0,0,1,-1,1,-1,3,-1
KR_6757700587,420,-2,-20,0,-5,-6,6,0,0,2,2,2,1,3,-2,2,0,1,0,1,0,-8,43,-2,-4,6,-37,0,-1,1,-1,-1,-1,6,-1
KR_6692461369,420,0,12,13,0,3,1,4,2,1,3,-1,1,0,-4,6,2,0,0,0,0,-5,-2,3,-5,2,-3,0,0,0,0,1,1,0,-1
KR_6749159986,420,-2,-69,16,-4,-2,3,1,2,2,4,-3,4,1,-2,3,1,1,0,1,0,-9,13,4,-9,5,0,0,-1,1,-1,-1,1,1,-1
KR_6764779263,440,-3,8,28,-14,-2,2,0,-5,5,0,-3,3,0,1,4,5,-5,5,0,0,-16,-13,-3,-3,6,-2,0,0,1,1,0,1,4,-1
KR_6738225331,420,-1,-27,-19,-1,-1,4,3,2,2,4,-3,4,1,1,0,1,0,0,0,0,4,15,1,-4,3,0,0,-1,-1,-1,-1,-1,6,-1
KR_6628636228,420,0,12,-20,-4,-4,5,1,-4,8,4,-1,2,1,1,3,4,4,2,6,0,-1,-7,3,-7,4,5,0,1,-1,-1,1,-1,5,-1
KR_6728457667,420,1,16,1,-2,0,1,1,0,1,1,-5,7,2,0,2,2,3,0,3,-1,-1,134,-2,-1,3,1,0,1,-1,1,1,-1,5,-1
KR_6761458829,440,0,-8,-8,3,1,2,3,2,2,4,-2,3,1,2,2,4,0,3,3,0,-2,402,4,-9,5,-5,0,1,1,1,1,-1,6,-1
KR_6752521132,420,-1,-5,30,-11,0,0,0,1,2,3,0,3,3,-11,11,0,-1,1,0,0,-11,-123,-1,-5,6,-2,0,-1,-1,-1,-1,-1,6,-1
KR_6677838612,420,-6,-75,-29,-12,1,2,3,-1,1,0,-1,5,4,-10,11,1,-1,2,1,0,-17,13,8,-13,5,-5,0,-1,-1,-1,1,-1,4,-1
KR_6634046562,420,-1,-68,-6,5,1,0,1,2,4,6,1,2,3,1,2,3,0,0,0,0,4,6,1,-7,6,-4,0,0,-1,1,0,1,1,-1
KR_6683708887,420,-1,-24,-32,0,-1,3,2,0,1,1,-4,5,1,5,1,6,0,0,0,-1,9,-4,-4,-5,9,0,0,0,1,-1,0,-1,2,-1
KR_6765974010,440,-5,-43,-28,-6,-1,1,0,-1,1,0,-1,3,2,-2,4,2,-1,5,4,0,-7,113,-6,-4,10,-5,0,-1,-1,1,-1,1,5,-1
KR_6758726548,440,3,32,11,-5,-1,1,0,0,1,1,-4,4,0,-3,4,1,3,2,5,0,-5,4,-3,-2,5,1,0,0,-1,0,0,-1,4,-1
KR_6752085032,420,-1,-17,0,-7,-1,3,2,0,1,1,-5,7,2,-2,3,1,1,0,1,-1,-5,47,-1,-5,6,-21,0,-1,-1,-1,-1,-1,1,-1
KR_6625079332,420,-3,-87,-4,-7,-5,5,0,-2,3,1,-1,1,0,2,3,5,-1,2,1,0,-4,-4,-3,-2,5,1,0,0,-1,1,-1,-1,5,-1
KR_6750913601,420,-1,-17,-40,0,-3,3,0,3,3,6,0,1,1,0,1,1,0,1,1,0,4,10,2,-3,1,-1,0,-1,1,-1,-1,-1,6,-1
KR_6691012330,420,-3,-22,15,-11,-2,2,0,-3,5,2,0,3,3,-6,7,1,0,2,2,0,-5,-23,2,-5,3,11,0,-1,-1,-1,-1,-1,1,-1
KR_6762296512,440,-6,-115,-3,-16,-5,5,0,-5,6,1,-3,4,1,-2,3,1,-1,2,1,0,-9,-16,-3,-2,5,-2,0,-3,-1,-1,-1,-1,4,-1
KR_6732918660,420,-1,-9,-19,-3,3,0,3,-1,1,0,-2,5,3,-2,4,2,-1,1,0,0,-4,47,-2,-4,6,-16,0,0,0,1,0,1,0,-1
KR_6765687418,420,-5,-70,-2,-15,-5,5,0,-5,5,0,-4,4,0,0,2,2,-1,1,0,0,-17,-2,-5,-2,7,0,0,-2,-1,0,-1,-1,5,-1
KR_6741990407,420,2,11,20,1,0,0,0,1,2,3,0,0,0,1,2,3,-1,1,0,-1,-3,99,2,-6,4,5,0,0,0,0,0,-1,0,-1
KR_6642606615,420,-4,-37,8,-2,-3,3,0,1,2,3,4,1,5,-3,7,4,-1,1,0,2,-1,6,6,-10,4,-3,0,0,-1,0,-1,-1,2,-1
KR_6762823059,420,-3,1,-16,-8,3,0,3,-3,3,0,-2,2,0,-5,6,1,-1,1,0,0,-19,-3,0,-3,3,-3,0,0,-1,0,-1,-1,5,-1
KR_6752311941,440,-2,38,-34,-8,2,1,3,-3,4,1,-5,5,0,-7,7,0,5,1,6,0,-10,-24,0,-5,5,-4,0,-1,-1,1,-1,1,3,-1
KR_6759758515,440,-5,-98,-8,-10,-1,1,0,2,4,6,1,0,1,-7,9,2,-5,5,0,-1,-18,-41,1,-4,3,13,0,-2,-1,-1,-1,-1,2,-1
KR_6739011502,420,-4,44,-1,-12,-3,3,0,-3,4,1,0,2,2,-5,8,3,-1,3,2,0,-12,59,0,-7,7,-15,0,0,-1,1,1,-1,1,-1
KR_6759164462,440,0,-49,-3,0,-6,6,0,4,2,6,2,2,4,3,1,4,-3,3,0,0,7,14,1,-6,5,4,0,0,1,-1,0,1,1,-1
KR_6691090897,440,-3,-28,-60,-4,2,0,2,0,1,1,-1,5,4,-5,5,0,0,0,0,0,-8,-2,-4,-1,5,2,0,0,-1,0,-1,1,1,-1
KR_6736275622,420,-1,-45,-5,-9,-2,2,0,-4,7,3,-4,4,0,-1,1,0,2,0,2,0,-11,-33,-5,-5,10,1,0,-1,-1,-1,-1,1,5,-1
KR_6756587720,420,1,64,-28,-1,4,0,4,-2,3,1,-4,4,0,0,3,3,1,1,2,0,0,4,1,-7,6,-2,0,0,-1,-1,1,-1,5,-1
KR_6712183664,420,1,40,6,4,-2,2,0,1,2,3,3,0,3,1,1,2,1,1,2,0,0,-67,2,-10,8,-3,0,1,1,1,1,1,6,-1
KR_6756149751,420,2,0,12,4,5,0,5,-2,4,2,-2,3,1,2,2,4,1,1,2,0,3,-42,2,-8,6,23,0,0,0,0,0,1,0,-1
KR_6735693121,420,-3,-23,-2,-13,3,0,3,-2,3,1,-6,6,0,-7,7,0,-1,2,1,-1,-18,-25,0,-6,6,0,0,0,-1,1,1,-1,1,-1
KR_6731995399,420,2,41,8,-3,2,1,3,-1,3,2,0,1,1,-2,5,3,-2,2,0,0,-11,-30,-4,-6,10,1,0,0,-1,1,0,-1,5,-1
KR_6753617014,420,0,-4,17,0,-1,1,0,1,1,2,0,2,2,-1,5,4,1,1,2,0,-1,-5,2,-11,9,4,0,0,1,-1,0,1,6,-1
KR_6762243296,420,0,-10,7,-7,3,0,3,-3,6,3,-3,4,1,-5,5,0,1,1,2,0,-8,-1,-2,-2,4,0,0,0,-1,-1,0,-1,3,-1
KR_6585288636,420,-1,-20,-27,-3,3,1,4,-2,5,3,1,2,3,-6,6,0,1,0,1,0,-6,-9,-2,-4,6,1,0,0,-1,1,-1,-1,6,-1
KR_6766174029,420,-5,-96,-9,-13,-4,4,0,-1,3,2,-1,2,1,-2,3,1,-5,7,2,0,-16,-9,-7,-1,8,-3,0,-2,-1,-1,-1,-1,1,-1
KR_6755084026,420,-4,18,-1,-5,1,1,2,-5,5,0,-2,3,1,1,3,4,0,0,0,0,1,106,-2,-4,6,-5,0,-1,-1,1,-1,1,1,-1
KR_6762305747,420,-2,-67,-15,1,0,1,1,0,1,1,-2,4,2,0,2,2,3,1,4,0,5,6,1,-3,2,-3,0,1,-1,-1,-1,-1,6,-1
KR_6753884703,420,-3,24,-9,-6,0,3,3,-2,3,1,-5,7,2,2,3,5,-1,2,1,-4,-11,-24,1,-9,8,-4,0,0,-1,1,1,-1,1,-1
KR_6736983296,420,-3,-6,-8,-3,-5,6,1,7,3,10,0,1,1,-3,4,1,-2,3,1,0,3,-3,-4,-4,8,3,0,0,1,1,-1,1,3,-1
KR_6700482545,420,-2,-9,17,1,5,0,5,1,0,1,5,0,5,-9,10,1,-1,1,0,0,-11,103,3,-4,1,-2,0,0,1,1,-1,1,1,-1
KR_6750105524,440,0,-53,-16,-6,1,0,1,2,1,3,-3,5,2,-4,5,1,-2,2,0,0,-7,-4,-1,-4,5,3,0,-1,-1,1,1,-1,3,-1
KR_6730308397,420,1,-52,7,-2,-2,2,0,0,5,5,1,2,3,1,2,3,-2,2,0,0,-2,-29,1,-7,6,-5,0,-1,-1,-1,-1,1,1,-1
KR_6634928807,420,-3,-26,-14,-5,-3,3,0,-2,4,2,2,2,4,-3,7,4,1,1,2,0,-6,28,0,-9,9,-6,0,-1,-1,-1,-1,-1,3,-1
KR_6649554659,420,-2,-44,-17,-5,-1,2,1,-9,10,1,3,0,3,2,0,2,0,2,2,0,-12,23,-2,-6,8,0,0,0,-1,-1,-1,-1,2,-1
KR_6693509641,420,-1,2,-39,-2,1,1,2,0,2,2,2,0,2,1,3,4,-6,7,1,0,1,-17,-5,-4,9,4,0,0,-1,1,0,1,6,-1
KR_6391636029,420,-4,-45,7,-13,1,1,2,-6,6,0,-2,4,2,-6,8,2,0,0,0,0,-18,4,-1,-8,9,-4,0,0,-1,-1,0,-1,1,-1
KR_6755087439,420,-4,-27,9,-6,0,1,1,-2,5,3,2,2,4,-7,8,1,1,0,1,2,-2,-9,-1,-5,6,1,0,-1,-1,-1,-1,1,2,-1
KR_6730920841,420,0,21,18,-4,-3,3,0,0,3,3,-3,4,1,1,4,5,1,1,2,0,-3,2,-4,-1,5,1,0,0,-1,-1,0,-1,5,-1
KR_6719223580,420,-2,-39,-23,1,-1,1,0,-2,5,3,2,1,3,2,1,3,0,0,0,0,-2,-179,2,-8,6,-5,0,-1,-1,-1,-1,1,3,-1
KR_6761038708,420,0,50,-8,1,5,0,5,-4,4,0,-2,2,0,0,2,2,2,0,2,0,-1,5,5,-8,3,2,0,0,1,-1,1,1,6,-1
KR_6733897162,420,-1,24,-20,9,2,0,2,-2,2,0,1,2,3,8,1,9,0,1,1,-1,4,2,2,-8,6,-3,0,0,-1,-1,0,-1,4,-1
KR_6724239439,440,-4,-32,2,-1,3,0,3,-1,2,1,-2,4,2,0,1,1,-1,1,0,0,-3,-1,-2,-1,3,0,0,0,0,1,-1,-1,0,-1
KR_6518622034,420,-5,-44,-3,-8,-1,3,2,-4,6,2,-4,5,1,1,0,1,0,0,0,-2,-6,-10,-5,-2,7,-3,0,-2,-1,-1,-1,-1,2,-1
KR_6726233723,420,1,-21,-8,-1,3,0,3,1,2,3,-1,2,1,-2,6,4,-2,2,0,0,-4,-63,-1,-6,7,28,0,0,1,1,-1,1,4,-1
KR_6693904245,440,-2,-77,-20,-9,-4,4,0,-3,4,1,-1,2,1,1,2,3,-2,2,0,0,-3,-219,2,-7,5,1,0,1,-1,1,1,-1,5,-1
KR_6672262605,420,-2,-101,-13,-1,-1,2,1,2,2,4,-4,5,1,-1,2,1,3,0,3,0,6,-12,-9,-1,10,3,0,-2,1,-1,-1,-1,6,-1
KR_6765338249,420,-2,-85,5,1,-6,6,0,-1,2,1,-2,2,0,8,1,9,2,0,2,1,10,6,-3,-6,9,-1,0,0,-1,1,0,1,4,-1
KR_6762097870,420,-1,5,-5,0,0,1,1,-1,5,4,3,0,3,-1,1,0,-1,2,1,0,-2,4,0,-5,5,1,0,1,1,1,1,1,3,-1
KR_6763673661,420,2,5,-30,14,5,0,5,2,2,4,2,2,4,3,4,7,2,1,3,1,10,-22,-2,-5,7,1,0,0,-1,-1,0,1,1,-1
KR_6753149250,420,-5,-25,-8,-19,-7,7,0,-1,3,2,0,1,1,-12,12,0,1,1,2,0,-20,-228,8,-9,1,-5,0,-2,-1,-1,-1,-1,4,-1
KR_6688458572,420,-1,10,-11,-3,1,1,2,2,3,5,-3,5,2,-4,4,0,1,0,1,1,-10,-19,5,-7,2,-1,0,1,1,1,1,1,2,-1
KR_6750771272,420,-3,-18,-24,-7,0,1,1,-4,6,2,-1,3,2,-2,3,1,0,0,0,0,-10,7,3,-9,6,-3,0,0,-1,-1,0,1,4,-1
KR_6677405495,440,1,-9,8,6,-2,4,2,2,1,3,5,0,5,1,1,2,0,0,0,0,0,7,2,-5,3,3,0,1,1,1,1,1,2,-1
KR_6755421696,420,1,-26,-7,-7,-1,3,2,0,3,3,-1,1,0,-2,4,2,-3,4,1,-1,-9,9,-1,-7,8,-5,0,0,-1,0,0,-1,1,-1
KR_6701984821,420,-2,-57,-16,-12,-5,5,0,3,3,6,-1,3,2,-7,7,0,-2,2,0,-1,-6,6,-1,-8,9,5,0,-2,-1,-1,-1,-1,2,-1
KR_6759655257,420,-2,-23,-20,-6,0,3,3,-4,4,0,0,0,0,-2,2,0,0,0,0,-1,-8,-19,-2,-7,9,7,0,0,-1,-1,-1,-1,1,-1
KR_6721306701,420,1,-22,-12,-1,0,0,0,-1,3,2,1,3,4,-3,6,3,2,0,2,0,-1,6,-2,-3,5,-1,0,1,1,-1,1,-1,3,-1
KR_6670638246,420,-1,-6,-10,-3,-6,7,1,0,3,3,0,3,3,4,2,6,-1,1,0,1,1,-270,3,-7,4,-3,0,0,-1,1,-1,1,4,-1
KR_6695391028,420,-2,-48,-8,-9,0,3,3,-1,3,2,-1,4,3,-6,7,1,-1,2,1,0,-8,2,0,-6,6,3,0,0,-1,-1,0,-1,1,-1
KR_6696590379,420,-3,-91,-6,-5,-2,3,1,2,3,5,-3,4,1,-2,5,3,0,1,1,0,1,-5,-1,-5,6,1,0,-2,1,-1,-1,-1,1,-1
KR_6761179351,420,-5,28,-12,-13,0,2,2,-5,6,1,-2,2,0,-6,6,0,0,1,1,0,-17,29,4,-9,5,-2,0,-2,1,-1,-1,-1,2,-1
KR_6642349116,420,1,-12,22,2,2,1,3,-1,4,3,1,1,2,-1,2,1,1,0,1,0,-4,1,-2,-7,9,-1,0,-1,1,-1,-1,1,1,-1
KR_6763345320,420,-2,3,22,-4,-1,1,0,-3,6,3,-2,5,3,3,3,6,-1,1,0,0,0,-10,-6,-3,9,4,0,3,1,1,1,1,3,-1
KR_6733661080,440,-4,-84,-12,-4,-2,3,1,-1,1,0,-1,4,3,-1,2,1,1,1,2,0,-3,-9,2,-4,2,2,0,0,-1,0,0,1,5,-1
KR_6717316440,420,-1,-51,8,0,-2,2,0,1,3,4,-3,3,0,4,2,6,0,0,0,0,-4,6,2,-5,3,-2,0,0,1,-1,-1,1,6,-1
KR_6750182355,420,3,-26,48,2,-3,3,0,0,1,1,0,3,3,3,1,4,2,2,4,0,6,1,4,-6,2,1,0,1,1,-1,1,-1,2,-1
KR_6756705792,420,-5,-71,3,-5,-3,4,1,1,2,3,-2,3,1,-1,3,2,0,1,1,0,-7,10,-2,-4,6,1,0,-2,1,-1,-1,1,6,-1
KR_6730522527,420,-2,-41,8,-3,1,3,4,-1,3,2,1,2,3,-7,8,1,3,0,3,0,0,-46,1,-7,6,12,0,0,-1,-1,-1,1,6,-1
KR_6756959706,420,-3,-40,-8,-4,1,2,3,-1,4,3,-1,2,1,-2,4,2,-1,1,0,-1,-10,9,3,-8,5,1,0,-1,1,-1,-1,-1,3,-1
KR_6753913116,420,-3,-80,-31,-10,-3,5,2,-4,6,2,-3,3,0,-2,3,1,2,1,3,0,-4,-8,-2,-5,7,-2,0,-2,-1,1,-1,1,6,-1
KR_6760805933,440,-1,19,-5,-10,-2,4,2,-6,9,3,2,1,3,-1,5,4,-3,4,1,1,-18,8,2,-5,3,-6,0,0,-1,-1,0,-1,6,-1
KR_6762493047,420,0,62,9,2,1,1,2,1,4,5,0,2,2,1,3,4,-1,2,1,1,1,163,3,-9,6,-3,0,3,-1,-1,1,1,1,-1
KR_6716812348,440,-7,-44,1,-18,-1,2,1,-5,6,1,-7,8,1,-5,6,1,0,1,1,0,-18,-5,-5,-2,7,1,0,-3,-1,1,-1,-1,4,-1
KR_6755377006,420,1,22,6,-4,2,0,2,3,0,3,-11,11,0,2,2,4,0,2,2,0,-2,-19,-1,-3,4,0,0,0,-1,-1,1,-1,6,-1
KR_6669152163,420,-6,-81,-27,-17,3,0,3,-1,4,3,-5,5,0,-8,9,1,-6,8,2,-1,-20,-48,-2,-2,4,-2,0,-3,-1,-1,-1,-1,3,-1
KR_6605855356,420,-1,0,-35,-4,-3,4,1,-1,4,3,1,0,1,0,3,3,-1,1,0,0,2,24,0,-5,5,1,0,0,1,-1,0,-1,4,-1
KR_6763245845,420,-2,-47,11,-1,-1,3,2,-1,4,3,-1,2,1,3,1,4,-1,1,0,1,-2,-1,5,-9,4,1,0,-1,0,1,-1,1,0,-1
KR_6680217852,420,-3,-1,-19,-9,-3,5,2,-3,5,2,-2,2,0,-1,3,2,0,1,1,0,-10,17,-3,-3,6,2,0,-1,-1,1,-1,1,5,-1
KR_6757308647,420,-3,35,-4,-5,-1,2,1,-3,4,1,-3,3,0,2,1,3,0,2,2,0,-2,70,1,-8,7,23,0,-1,1,-1,-1,-1,3,-1
KR_6575529481,420,-2,-40,-12,1,0,2,2,3,1,4,-3,4,1,1,1,2,0,0,0,0,8,3,1,-6,5,-1,0,-1,1,-1,-1,-1,1,-1
KR_6708183226,420,0,34,24,-4,-1,3,2,-3,5,2,0,2,2,0,1,1,0,1,1,0,-9,2,-2,-9,11,-2,0,0,-1,1,-1,-1,5,-1
KR_6699010726,440,-5,17,15,-14,-2,3,1,-6,7,1,-2,2,0,-4,9,5,0,0,0,0,-17,-6,-2,-4,6,-2,0,1,-1,1,1,-1,1,-1
KR_6764507729,420,-1,26,-9,-1,1,1,2,4,1,5,-2,2,0,-4,4,0,0,0,0,0,4,0,-2,-6,8,-6,0,-1,1,-1,-1,1,5,-1
KR_6642439638,420,-3,-38,-25,-1,2,2,4,-2,4,2,-2,4,2,3,2,5,-2,4,2,0,-9,-21,0,-4,4,3,0,0,-1,-1,0,1,2,-1
KR_6412068933,420,1,19,-23,-6,5,0,5,-4,7,3,-2,5,3,-1,2,1,-4,4,0,0,-5,1,1,-5,4,2,0,0,-1,0,1,-1,5,-1
KR_6735507705,420,-3,0,-28,-6,-2,3,1,-4,7,3,-4,4,0,4,1,5,0,1,1,0,4,22,3,-7,4,-1,0,-1,-1,-1,-1,-1,1,-1
KR_6755865180,420,1,44,-12,-3,1,3,4,-4,5,1,2,0,2,0,2,2,-2,2,0,0,-8,-1,2,-6,4,-1,0,1,-1,1,1,1,3,-1
KR_6743443525,420,-2,-22,7,-5,-3,3,0,2,3,5,-2,4,2,-2,4,2,0,0,0,0,-2,-24,-2,-4,6,0,0,-2,-1,1,-1,-1,6,-1
KR_6637615778,420,-4,-7,-12,-8,1,0,1,-3,6,3,0,2,2,5,2,7,-11,12,1,-1,-3,-4,1,-4,3,-2,0,-1,-1,-1,-1,-1,5,-1
KR_6750387526,420,-3,-86,17,-10,4,1,5,-4,4,0,-2,3,1,-3,5,2,-5,5,0,0,-18,-14,-3,-2,5,26,0,-2,-1,-1,-1,-1,1,-1
KR_6765762960,420,-1,27,-18,-6,2,0,2,1,1,2,-4,4,0,-3,3,0,-2,2,0,0,-3,-34,-2,-4,6,8,0,2,1,-1,-1,-1,4,-1
KR_6677462044,420,0,-34,22,1,1,1,2,3,3,6,-1,2,1,-4,5,1,2,0,2,0,-5,-13,0,-6,6,4,0,0,1,1,0,1,3,-1
KR_6737893654,440,2,16,2,0,4,0,4,-4,5,1,5,2,7,-1,5,4,-4,4,0,0,3,1,-3,-5,8,6,0,0,-1,-1,0,-1,5,-1
KR_6650344706,420,-2,-9,11,-8,2,0,2,-1,5,4,-9,9,0,0,3,3,0,0,0,0,-2,-3,-6,-3,9,-6,0,-1,1,1,-1,-1,6,-1
KR_6742333031,440,1,11,-3,11,0,1,1,6,1,7,3,0,3,1,1,2,1,0,1,0,13,45,-1,-4,5,1,0,0,-1,1,0,1,1,-1
KR_6723519341,420,-2,4,-6,-2,-2,5,3,0,3,3,2,2,4,-1,3,2,-1,1,0,0,0,-127,-2,-5,7,3,0,1,1,1,1,1,4,-1
KR_6763801934,420,5,78,7,8,2,2,4,2,2,4,1,2,3,1,0,1,2,2,4,0,11,-5,-1,-3,4,6,0,1,-1,-1,1,-1,4,-1
KR_6403341222,420,-3,13,-14,-5,0,1,1,1,4,5,-7,8,1,0,3,3,1,0,1,0,-3,9,-3,-8,11,4,0,0,-1,-1,0,1,3,-1
KR_6754738004,420,-1,11,-13,2,3,1,4,2,1,3,-2,5,3,0,1,1,-1,1,0,0,-2,0,3,-9,6,2,0,1,1,1,1,1,1,-1
KR_6675787562,420,-5,-85,16,-16,-3,3,0,-3,6,3,0,1,1,-5,5,0,-5,5,0,0,-16,-353,1,-3,2,2,0,-3,1,-1,-1,-1,2,-1
KR_6624055871,420,-2,-10,9,-6,2,0,2,-2,5,3,-4,5,1,-2,2,0,0,0,0,0,-7,-26,1,-6,5,-2,0,0,-1,1,0,-1,3,-1
KR_6755839546,420,-6,-97,4,-17,-1,2,1,-5,5,0,-6,7,1,-1,4,3,-4,6,2,0,-16,-2,-2,-6,8,1,0,-2,-1,-1,-1,-1,6,-1
KR_6684929934,420,-6,-92,-15,-15,-1,5,4,-1,3,2,-5,6,1,-7,8,1,-1,1,0,0,-17,-4,-5,-6,11,-5,0,-2,-1,-1,-1,-1,6,-1
KR_6764819681,440,-1,69,-20,-4,1,3,4,-2,7,5,-1,3,2,0,3,3,-2,3,1,0,-6,-1,-7,-2,9,2,0,1,1,-1,1,1,5,-1
KR_6764800265,420,0,-76,-11,-3,-1,5,4,-3,5,2,3,1,4,-2,3,1,0,3,3,0,-2,-4,-5,-1,6,0,0,-3,1,1,-1,1,3,-1
KR_6612570630,440,-6,-17,-43,-11,1,0,1,-1,4,3,-2,3,1,-2,2,0,-7,7,0,0,-10,13,2,-4,2,-4,0,-3,-1,-1,-1,-1,2,-1
KR_6758739370,420,-8,-39,-10,-15,2,3,5,-1,3,2,-5,5,0,-12,12,0,1,1,2,0,-17,-7,-3,-3,6,-1,0,-4,-1,-1,-1,-1,4,-1
KR_6748743324,420,-6,-90,-4,-6,-2,3,1,-3,3,0,1,1,2,-1,1,0,-1,2,1,0,-7,-9,-2,-4,6,1,0,-1,-1,1,-1,1,4,-1
KR_6680097007,420,0,-6,-5,4,-4,5,1,4,2,6,-1,2,1,2,4,6,3,0,3,0,7,-1,2,-5,3,-1,0,0,1,1,1,-1,3,-1
KR_6680514459,420,1,51,4,0,3,2,5,-4,8,4,3,0,3,-1,3,2,-1,1,0,0,-6,-5,-3,-3,6,2,0,0,1,-1,1,1,2,-1
KR_6750927691,420,-3,-18,-32,-15,-5,5,0,-5,6,1,-7,8,1,-2,5,3,4,2,6,0,-3,-10,-8,0,8,3,0,-1,0,-1,-1,-1,0,-1
KR_6759520544,440,-1,-68,16,-1,-2,3,1,-1,3,2,1,2,3,-3,3,0,4,2,6,0,-4,1,-3,-1,4,2,0,1,-1,1,1,-1,1,-1
KR_6609081988,420,-2,-72,-20,-1,1,2,3,-2,6,4,1,0,1,-2,2,0,1,0,1,0,-5,0,-2,-6,8,6,0,0,-1,1,1,-1,2,-1
KR_6764019322,420,-2,6,-13,-4,-4,5,1,5,1,6,-2,4,2,-4,5,1,1,1,2,0,0,28,4,-8,4,-7,0,0,-1,0,1,-1,5,-1
KR_6740590013,420,-5,-82,-6,0,0,1,1,-1,3,2,-1,2,1,0,3,3,2,1,3,0,0,-17,-4,-3,7,-1,0,-1,-1,1,1,-1,6,-1
KR_6672231990,420,-1,19,-7,-4,-1,1,0,1,3,4,-7,8,1,6,3,9,-3,3,0,0,-9,-6,0,-8,8,-6,0,0,1,1,0,-1,2,-1
KR_6728442656,420,-3,-27,-7,-8,1,3,4,0,1,1,-2,2,0,-7,7,0,0,0,0,0,-13,-13,0,-3,3,-4,0,0,-1,-1,-1,1,6,-1
KR_6719875709,420,-2,47,-25,-8,-3,3,0,-3,5,2,-4,5,1,2,2,4,0,2,2,0,-11,-39,-8,-2,10,3,0,0,1,-1,1,1,3,-1
KR_6740467430,420,2,25,29,-3,3,0,3,2,1,3,-1,3,2,-5,7,2,-2,3,1,0,-5,-6,4,-8,4,1,0,1,-1,1,1,-1,6,-1
KR_6751694784,420,3,11,12,9,-1,1,0,3,0,3,1,2,3,5,0,5,1,0,1,0,10,-8,-2,-5,7,3,0,2,1,1,1,1,3,-1
KR_6765540398,420,-2,-73,9,-8,2,0,2,-5,6,1,-2,2,0,-2,4,2,-1,3,2,1,-4,-52,-5,-1,6,30,0,-1,-1,-1,-1,1,5,-1
KR_6765550506,420,1,24,-39,14,-1,2,1,7,2,9,4,0,4,3,0,3,1,1,2,1,15,0,1,-6,5,0,0,0,1,-1,0,1,6,-1
KR_6715744002,420,-5,-57,-24,-3,-3,3,0,-2,5,3,1,2,3,-3,5,2,4,0,4,0,0,6,2,-6,4,0,0,-2,1,-1,-1,1,4,-1
KR_6611248874,420,-3,-17,21,-11,-2,3,1,-1,4,3,1,3,4,-9,9,0,0,0,0,-1,-11,-5,-4,-3,7,2,0,-3,1,1,-1,-1,1,-1
KR_6751508154,420,1,62,7,0,-4,5,1,2,2,4,1,1,2,-1,1,0,2,0,2,0,1,38,4,-8,4,-4,0,1,-1,1,1,1,5,-1
KR_6756653567,420,-7,-106,-56,-14,-10,10,0,0,2,2,-6,9,3,2,2,4,0,1,1,-1,-3,241,-3,-4,7,-1,0,-5,-1,-1,-1,-1,4,-1
KR_6760463541,420,-1,-10,-11,-6,2,1,3,-3,4,1,-5,5,0,0,1,1,0,2,2,-2,-17,-7,-1,-4,5,3,0,-1,-1,1,-1,-1,5,-1
KR_6763195338,420,-2,-36,-12,-3,-2,3,1,-2,4,2,1,1,2,0,2,2,0,1,1,0,-6,-8,-4,-5,9,1,0,-1,-1,1,-1,-1,6,-1
KR_6764082991,420,-5,-76,10,-13,-1,2,1,-4,4,0,-9,10,1,2,3,5,-1,1,0,0,2,5,3,-8,5,-8,0,-1,0,-1,-1,-1,0,-1
KR_6754168626,420,1,-28,11,-3,0,1,1,-5,5,0,2,1,3,-1,4,3,1,1,2,0,2,-20,2,-5,3,0,0,0,-1,1,1,-1,6,-1
KR_6692286355,420,3,32,11,0,-2,3,1,6,2,8,-7,9,2,3,2,5,0,0,0,0,0,-3,-6,-2,8,-3,0,1,-1,-1,1,-1,5,-1
KR_6762143613,420,1,6,-16,-3,-1,1,0,1,2,3,3,1,4,-5,5,0,-1,2,1,0,-6,-2,0,-4,4,-2,0,1,-1,1,1,-1,2,-1
KR_6727955689,420,-4,-44,-8,1,-1,1,0,3,0,3,1,1,2,0,2,2,-2,2,0,0,3,23,4,-10,6,0,0,0,-1,1,0,-1,4,-1
KR_6765795760,440,-2,-84,-4,-9,0,1,1,-3,4,1,-3,3,0,-4,4,0,1,1,2,0,-4,-130,-2,-3,5,-4,0,0,-1,1,-1,-1,4,-1
KR_6763100118,420,1,24,-26,0,1,0,1,-1,1,0,1,0,1,0,3,3,-1,2,1,0,-5,-22,-6,-4,10,0,0,-1,-1,1,-1,1,3,-1
KR_6679152044,420,-3,-38,-21,-1,-1,1,0,-4,5,1,2,4,6,2,1,3,0,0,0,0,-1,-215,2,-8,6,-3,0,0,-1,-1,0,1,6,-1
KR_6634672936,420,-2,-8,-6,-5,2,2,4,1,2,3,-4,4,0,-3,3,0,-1,1,0,0,-7,2,8,-12,4,-5,0,1,-1,-1,-1,-1,2,-1
KR_6717807134,420,-1,-40,-27,-6,3,0,3,-8,11,3,-2,3,1,1,3,4,0,2,2,-1,-4,-164,-4,-1,5,2,0,1,-1,-1,1,-1,6,-1
KR_6760435864,420,-3,-61,-15,-2,-2,2,0,2,3,5,1,3,4,-3,3,0,0,1,1,0,4,-2,-2,-1,3,1,0,0,-1,-1,0,-1,1,-1
KR_6742090467,420,0,31,-20,0,0,1,1,-3,4,1,-2,2,0,2,2,4,3,1,4,0,2,-17,1,-5,4,16,0,0,-1,1,0,1,3,-1
KR_6755448685,420,2,0,11,0,2,0,2,-3,5,2,1,2,3,1,1,2,-1,2,1,0,-3,29,0,-4,4,-2,0,0,1,-1,0,-1,3,-1
KR_6752438663,420,-1,-90,-26,2,-1,3,2,-1,2,1,4,1,5,-1,3,2,1,1,2,0,-2,-3,1,-11,10,-3,0,-1,1,-1,-1,-1,3,-1
KR_6346044610,420,-3,-20,-5,-9,1,2,3,-3,6,3,-1,3,2,-4,4,0,-2,2,0,0,-13,3,3,-7,4,1,0,-1,-1,-1,-1,-1,2,-1
KR_6731662961,420,1,35,4,-5,-1,3,2,-9,9,0,-3,4,1,6,0,6,2,0,2,0,-3,4,-5,-1,6,4,0,1,-1,1,1,-1,6,-1
KR_6715426183,440,-1,-49,0,2,4,1,5,-1,4,3,-5,6,1,3,1,4,1,0,1,-2,-2,4,0,-5,5,-2,0,0,-1,1,1,-1,5,-1
KR_6645559814,420,1,43,-1,7,-1,1,0,2,2,4,0,2,2,3,1,4,3,0,3,0,13,-5,0,-7,7,4,0,-1,-1,-1,-1,-1,1,-1
KR_6759345605,420,0,-31,-40,-9,1,3,4,-5,7,2,-5,7,2,0,8,8,0,1,1,0,-15,1,0,-6,6,-1,0,-1,-1,1,-1,-1,2,-1
KR_6760498198,420,-2,7,-4,-5,-1,2,1,-3,6,3,1,0,1,-3,4,1,1,0,1,0,-4,-1,-4,-2,6,2,0,-1,-1,1,-1,1,3,-1
KR_6617679155,420,-8,-67,-31,-16,-7,9,2,-2,2,0,-3,4,1,-3,6,3,-1,3,2,0,-10,92,0,-5,5,-2,0,-3,1,-1,-1,-1,3,-1
KR_6754082464,420,-4,-70,-28,-3,-7,8,1,1,2,3,-1,3,2,0,3,3,4,0,4,0,10,11,-5,-4,9,0,0,-1,0,-1,-1,-1,0,-1
KR_6753422610,420,-1,-26,-7,-7,-3,4,1,1,0,1,-2,5,3,-1,2,1,-2,3,1,-1,-2,3,2,-6,4,-4,0,-2,-1,-1,-1,-1,3,-1
KR_6749398337,420,3,26,7,0,2,2,4,2,2,4,-4,6,2,0,4,4,0,0,0,0,-12,29,1,-8,7,0,0,1,-1,1,1,1,4,-1
KR_6733967032,420,-2,28,-16,-1,-1,2,1,-1,3,2,-3,3,0,3,2,5,1,0,1,0,3,11,3,-8,5,0,0,-1,-1,1,-1,1,5,-1
KR_6764804560,420,-1,-16,-12,1,5,0,5,1,0,1,0,1,1,-3,3,0,-2,2,0,0,-2,34,5,-7,2,-3,0,0,0,0,0,1,0,-1
KR_6720025250,420,-3,-12,-14,-2,-2,2,0,1,1,2,0,2,2,2,3,5,-3,4,1,0,-3,-3,5,-9,4,-4,0,0,1,-1,-1,1,5,-1
KR_6760866385,420,0,-40,20,-8,-1,2,1,-2,3,1,-1,2,1,-7,7,0,3,0,3,-1,-10,-11,-1,-6,7,-4,0,-1,1,1,-1,-1,3,-1
KR_6744086713,440,1,-11,-14,1,-2,4,2,3,2,5,-1,2,1,4,6,10,-3,9,6,-1,1,45,3,-8,5,2,0,1,-1,-1,-1,1,6,-1
KR_6760269995,420,1,-38,38,-3,0,0,0,0,3,3,-1,1,0,1,2,3,-3,3,0,0,-4,-1,-3,-6,9,-2,0,0,-1,-1,-1,1,2,-1
KR_6754171814,420,-2,-21,-29,-2,-1,1,0,0,4,4,-3,4,1,2,0,2,0,1,1,1,-1,3,0,-4,4,4,0,-1,-1,-1,-1,1,4,-1
KR_6736456972,420,-4,-39,-1,-7,-5,5,0,-3,6,3,-4,6,2,3,0,3,2,0,2,1,-2,-21,0,-9,9,0,0,0,1,-1,-1,1,3,-1
KR_6720633232,420,2,-46,31,-4,-1,4,3,-1,2,1,3,1,4,-6,7,1,1,0,1,0,-9,12,-6,-4,10,4,0,0,1,1,-1,-1,2,-1
KR_6758623114,420,-2,-157,16,-6,2,2,4,1,3,4,0,6,6,-4,5,1,-5,6,1,0,3,-8,-3,-4,7,6,0,-2,1,-1,-1,1,3,-1
KR_6686667720,420,1,-46,29,2,1,1,2,1,3,4,-1,2,1,2,0,2,-1,2,1,0,4,16,0,-7,7,-4,0,-1,-1,0,-1,-1,2,-1
KR_6654263895,420,1,34,6,-6,-1,3,2,-4,7,3,-1,4,3,0,5,5,0,2,2,0,-7,10,1,-6,5,-4,0,-1,1,1,-1,1,1,-1
KR_6738345230,420,-1,-16,3,-5,-1,4,3,0,1,1,-5,6,1,1,2,3,0,2,2,-1,-4,25,-1,-4,5,-5,0,-1,-1,0,-1,-1,3,-1
KR_6671296660,420,-1,-52,7,-4,3,0,3,0,3,3,-2,3,1,-4,5,1,-1,2,1,0,-12,-96,-3,-6,9,1,0,0,-1,1,1,-1,6,-1
KR_6756821641,420,-4,-97,5,-12,-2,4,2,-2,3,1,-1,2,1,-4,5,1,-3,5,2,0,-12,35,-1,-4,5,-5,0,-2,-1,-1,-1,1,6,-1
KR_6704448045,420,0,87,-20,-2,1,0,1,-4,7,3,2,1,3,0,6,6,-1,3,2,0,-3,-20,2,-5,3,-2,0,0,1,0,1,-1,2,-1
KR_6766019236,420,-3,-29,0,-7,-3,3,0,1,1,2,-5,5,0,0,3,3,0,0,0,0,-4,18,-1,-3,4,-1,0,0,-1,-1,0,-1,4,-1
KR_6750979625,420,1,-37,-8,-6,3,0,3,-3,3,0,-2,4,2,-4,6,2,0,0,0,-1,-8,5,-1,-5,6,-5,0,0,-1,1,-1,-1,6,-1
KR_6763626835,420,-4,-37,-10,-4,0,1,1,-5,10,5,2,0,2,-2,6,4,1,1,2,1,-8,-13,-5,-2,7,-1,0,0,-1,1,-1,1,1,-1
KR_6731125477,420,-6,-100,3,-10,-1,1,0,-1,4,3,-5,6,1,-4,5,1,1,0,1,0,-2,29,-1,-3,4,0,0,-3,-1,-1,-1,-1,4,-1
KR_6707329744,420,-4,-16,-13,-9,-5,5,0,1,1,2,-2,3,1,-2,4,2,-1,1,0,0,-10,-109,-3,-2,5,0,0,-1,-1,-1,-1,1,3,-1
KR_6761423692,420,-5,-58,-22,-9,-1,3,2,-8,12,4,-1,2,1,1,2,3,0,1,1,0,-14,3,4,-11,7,-3,0,0,1,1,1,-1,6,-1
KR_6738677610,420,-4,-93,-37,-2,0,3,3,-2,2,0,-1,2,1,3,1,4,-2,3,1,0,0,109,1,-7,6,-3,0,-2,-1,0,-1,-1,4,-1
KR_6700696353,420,0,-3,-4,3,0,0,0,0,2,2,0,2,2,2,0,2,1,0,1,1,2,2,1,-8,7,-1,0,0,1,1,0,1,4,-1
KR_6747274064,420,-3,24,-36,4,4,1,5,-4,4,0,1,3,4,1,0,1,2,0,2,0,3,-12,-2,-5,7,4,0,-2,1,-1,-1,1,6,-1
KR_6648396426,420,-3,-25,-13,-5,-4,4,0,1,4,5,0,1,1,-4,8,4,2,0,2,0,-4,1,-1,-4,5,2,0,-2,1,1,-1,-1,3,-1
KR_6686442446,420,-7,-43,-27,-15,0,2,2,-8,11,3,-2,3,1,-6,7,1,1,0,1,2,-14,1,0,-5,5,0,0,-1,-1,-1,-1,1,1,-1
KR_6756462918,420,-3,-43,7,-2,-3,3,0,-1,2,1,-1,1,0,1,1,2,2,0,2,0,-2,0,1,-6,5,-1,0,-1,1,-1,-1,1,2,-1
KR_6752940660,420,2,40,8,8,3,2,5,-1,4,3,2,1,3,6,0,6,-2,3,1,0,16,5,1,-3,2,5,0,1,1,-1,1,-1,3,-1
KR_6585320777,420,-1,57,-3,-4,1,2,3,-4,9,5,2,0,2,-3,5,2,0,1,1,1,-20,15,-6,-5,11,2,0,-1,1,1,-1,1,6,-1
KR_6691032805,420,3,73,-2,8,1,1,2,3,6,9,2,0,2,3,1,4,-1,1,0,0,11,31,-2,-5,7,0,0,1,1,1,1,1,6,-1
KR_6765246809,420,-3,-66,-28,-5,-3,4,1,-2,4,2,1,2,3,-2,2,0,1,0,1,0,0,6,2,-8,6,-6,0,-1,-1,-1,-1,-1,2,-1
KR_6696194970,440,0,3,-8,-6,8,1,9,-5,6,1,-5,5,0,-5,7,2,1,0,1,0,-8,156,-2,-3,5,0,0,0,-1,1,1,-1,5,-1
KR_6759522025,420,0,31,-7,-6,-2,2,0,-5,8,3,1,0,1,0,2,2,0,0,0,0,-8,4,-2,-4,6,-3,0,-3,-1,-1,-1,-1,2,-1
KR_6649257700,440,-3,-67,-41,-6,-4,4,0,-1,3,2,2,4,6,-2,3,1,-1,1,0,0,2,3,0,-4,4,-1,0,-2,-1,-1,-1,-1,6,-1
KR_6684754791,420,-3,7,-24,-6,1,0,1,1,1,2,-3,3,0,-6,8,2,1,1,2,0,-13,5,4,-7,3,0,0,-2,1,-1,-1,-1,5,-1
KR_6763032936,420,-2,-90,-9,-8,-4,4,0,0,2,2,-2,8,6,-3,3,0,1,0,1,-1,-1,-6,-1,-3,4,-5,0,-1,1,-1,-1,-1,6,-1
KR_6753407018,420,-7,-64,-3,-7,-2,2,0,-5,5,0,1,1,2,-1,3,2,0,2,2,1,-15,-208,-5,-3,8,4,0,-2,-1,-1,-1,1,6,-1
KR_6763983790,420,-4,-70,-9,-10,-6,6,0,-1,3,2,-3,3,0,0,1,1,0,1,1,0,-3,-6,2,-8,6,33,0,0,1,0,-1,1,3,-1
KR_6748060431,420,-3,-86,0,-8,-4,5,1,3,2,5,-4,5,1,-1,6,5,-2,4,2,0,-13,-37,-7,-4,11,-1,0,-2,-1,-1,-1,-1,4,-1
KR_6529101043,420,-2,36,1,-6,-1,2,1,-2,3,1,-1,2,1,-5,6,1,3,0,3,0,-4,-4,-2,-3,5,0,0,-1,-1,-1,-1,1,5,-1
KR_6621961507,420,-2,7,14,-12,-3,6,3,-4,7,3,-1,2,1,-3,5,2,-1,3,2,1,-13,-18,-5,-7,12,2,0,-1,-1,-1,-1,-1,4,-1
KR_6736497869,420,-4,-53,-29,-12,-6,7,1,-3,4,1,-4,5,1,0,0,0,1,1,2,-1,-11,-9,-1,-4,5,0,0,-1,1,-1,-1,-1,2,-1
KR_6759160894,440,-3,-29,12,-5,-3,4,1,-6,6,0,4,1,5,0,5,5,0,0,0,0,-8,-4,3,-8,5,-1,0,0,1,1,-1,-1,6,-1
KR_6704107425,420,-5,20,-7,-7,-3,3,0,0,3,3,-4,4,0,0,0,0,0,1,1,0,-5,9,-1,-6,7,-3,0,0,-1,-1,-1,1,5,-1
KR_6691597059,420,2,-23,2,3,2,1,3,0,2,2,4,1,5,-4,4,0,1,0,1,0,3,1,-1,-8,9,-6,0,1,-1,1,1,1,5,-1
KR_6617449603,420,-1,-97,-10,-5,-1,2,1,2,2,4,0,4,4,-6,6,0,0,1,1,0,-5,-6,-4,-4,8,-2,0,-1,1,-1,-1,1,5,-1
KR_6750332055,420,-2,-66,-42,2,0,2,2,-1,3,2,1,2,3,1,1,2,1,0,1,0,4,36,4,-7,3,-5,0,0,-1,-1,-1,-1,1,-1
KR_6757947097,420,-2,-11,-10,0,3,1,4,-2,5,3,-1,3,2,-3,5,2,3,0,3,1,-3,5,5,-8,3,-6,0,1,-1,1,1,1,1,-1
KR_6762049323,420,3,36,21,4,6,1,7,-1,2,1,-1,3,2,1,5,6,-1,1,0,0,5,44,4,-8,4,1,0,1,1,1,1,-1,4,-1
KR_6759251077,420,0,28,18,-3,1,2,3,-4,6,2,4,3,7,-5,5,0,1,2,3,0,-2,6,1,-7,6,0,0,1,0,1,1,1,0,-1
KR_6677865981,420,-1,-31,-28,2,0,0,0,0,2,2,-1,5,4,4,1,5,-1,1,0,0,5,24,7,-11,4,-4,0,0,-1,-1,0,-1,2,-1
KR_6760103175,420,-2,46,-9,-2,-4,5,1,0,3,3,-1,5,4,4,0,4,-1,2,1,0,-10,-19,2,-4,2,0,0,0,1,-1,1,1,3,-1
KR_6764345041,420,-5,-32,-69,-15,-5,6,1,-4,5,1,0,6,6,-6,6,0,0,1,1,-4,-12,7,2,-5,3,0,0,-3,-1,-1,-1,-1,1,-1
KR_6724938777,420,-1,-25,-17,-2,0,2,2,-4,6,2,2,1,3,0,3,3,0,3,3,0,-4,-4,0,-4,4,1,0,0,0,-1,0,1,0,-1
KR_6694692788,420,-3,-37,-10,-6,0,2,2,-5,9,4,-5,7,2,1,5,6,3,0,3,0,-2,-27,9,-13,4,1,0,-1,1,-1,-1,-1,2,-1
KR_6709157648,420,1,-14,-8,-1,-1,1,0,4,1,5,-4,5,1,2,1,3,-2,2,0,0,1,8,-5,-3,8,-2,0,0,-1,1,0,-1,2,-1
KR_6717096478,440,3,-5,0,3,1,0,1,2,0,2,-1,1,0,-2,3,1,3,0,3,0,1,0,-2,-5,7,3,0,1,0,-1,1,1,0,-1
KR_6558324084,440,0,-55,8,1,-1,2,1,0,4,4,2,2,4,1,4,5,-1,1,0,0,-4,-5,2,-4,2,0,0,-1,1,1,-1,1,3,-1
KR_6759958138,420,-4,-33,-22,-1,1,1,2,3,1,4,0,3,3,-4,5,1,-1,1,0,1,5,2,-5,-5,10,-6,0,0,-1,-1,0,1,6,-1
KR_6587294934,420,-5,-44,-14,-8,0,1,1,0,5,5,-1,3,2,-5,5,0,-2,3,1,-2,-19,-5,-2,-3,5,1,0,-1,-1,1,-1,-1,1,-1
KR_6762523726,420,-5,-37,-48,-1,0,2,2,-4,8,4,1,2,3,2,2,4,0,2,2,1,-6,0,1,-7,6,-6,0,0,-1,-1,0,1,3,-1
KR_6758122932,440,-1,-13,-16,-3,1,1,2,-8,8,0,0,1,1,0,1,1,4,0,4,0,-1,-39,-1,-5,6,4,0,0,0,-1,0,-1,0,-1
KR_6759262883,420,-4,-33,-8,-4,-5,5,0,2,1,3,0,1,1,-3,4,1,2,0,2,0,-3,-5,0,-5,5,1,0,-1,1,-1,-1,-1,2,-1
KR_6696095179,440,-2,42,14,-5,1,2,3,-2,2,0,3,0,3,-7,8,1,0,1,1,1,-5,-9,-5,-1,6,0,0,0,-1,0,0,1,5,-1
KR_6763993909,440,-6,-99,-3,-13,-2,2,0,-1,1,0,-3,3,0,-1,1,0,-6,6,0,0,-13,4,1,-4,3,2,0,-1,-1,-1,-1,-1,4,-1
KR_6709600500,420,-5,-104,-58,-9,-2,3,1,2,5,7,-3,3,0,-4,5,1,-2,3,1,-1,-8,110,1,-7,6,-2,0,0,0,-1,-1,-1,0,-1
KR_6687636072,420,-6,-49,-9,-20,-9,10,1,-5,6,1,-2,3,1,-2,4,2,-2,2,0,0,-23,7,0,-3,3,-2,0,-3,1,-1,-1,-1,6,-1
KR_6674990497,420,-2,-22,-2,0,-1,3,2,3,3,6,0,1,1,-1,5,4,-1,2,1,0,-4,5,0,-2,2,-1,0,-1,-1,1,-1,1,6,-1
KR_6659797793,420,-1,-43,-1,6,0,2,2,-1,3,2,1,2,3,6,3,9,0,1,1,3,10,-3,3,-7,4,0,0,-2,0,-1,-1,1,0,-1
KR_6762532129,420,-2,-60,-9,-1,-2,5,3,-1,4,3,2,0,2,2,1,3,-2,2,0,1,5,6,6,-9,3,1,0,0,-1,1,-1,1,4,-1
KR_6711561156,420,-3,-73,0,-5,-4,6,2,1,4,5,0,2,2,-1,2,1,-1,1,0,0,0,0,0,-5,5,-2,0,-1,1,-1,-1,-1,1,-1
KR_6763870190,420,-5,-67,-24,-12,-2,4,2,0,1,1,-2,3,1,-8,8,0,0,1,1,-1,-7,4,-5,-2,7,-4,0,-2,-1,-1,-1,-1,6,-1
KR_6637519608,440,2,40,-39,7,2,2,4,2,2,4,5,2,7,-2,4,2,0,1,1,0,5,23,-1,-5,6,-11,0,1,-1,1,1,-1,3,-1
KR_6763166195,420,-2,-53,-12,2,4,2,6,-1,2,1,2,1,3,-1,1,0,-2,3,1,0,3,13,5,-9,4,-5,0,0,-1,-1,0,1,3,-1
KR_6691956747,420,-2,-18,17,-1,0,0,0,-2,4,2,3,2,5,-2,2,0,0,1,1,0,5,-16,2,-12,10,-2,0,1,-1,-1,1,-1,2,-1
KR_6764717323,420,-2,-28,24,-5,0,2,2,-2,3,1,2,4,6,-2,5,3,-3,6,3,0,-8,29,-1,-2,3,0,0,0,1,0,0,-1,3,-1
KR_6751494986,420,-4,-4,-24,-4,-1,3,2,1,1,2,0,4,4,2,0,2,-6,6,0,0,2,4,-4,-2,6,-1,0,1,-1,1,1,1,5,-1
KR_6731467235,440,-2,19,-45,-6,-2,3,1,-4,5,1,3,0,3,-3,8,5,0,1,1,-1,-17,-12,-2,-4,6,-2,0,0,-1,-1,-1,-1,4,-1
KR_6702644957,420,3,21,24,0,2,1,3,-2,2,0,1,0,1,-1,4,3,0,0,0,-1,-7,-6,-3,-6,9,-2,0,1,1,-1,1,-1,5,-1
KR_6757358776,420,-5,15,-25,-13,-2,4,2,0,3,3,-6,7,1,-6,6,0,1,0,1,-1,-10,-8,2,-3,1,3,0,-1,-1,-1,-1,-1,2,-1
KR_6763203371,420,1,48,-12,0,-1,2,1,-2,2,0,4,0,4,-2,3,1,1,0,1,0,-2,-1,2,-4,2,0,0,1,1,1,1,-1,6,-1
KR_6669923372,420,-1,21,15,-4,-3,3,0,-2,5,3,2,0,2,-1,7,6,0,1,1,0,-3,-200,1,-5,4,1,0,-2,1,-1,-1,-1,5,-1
KR_6746085785,420,-4,-76,-28,-5,-1,1,0,-1,3,2,3,1,4,-8,8,0,2,2,4,1,3,7,5,-9,4,-2,0,-1,-1,1,-1,1,2,-1
KR_6759695016,420,-1,4,0,-6,3,3,6,-5,7,2,-1,2,1,-4,4,0,1,1,2,-1,-14,2,1,-6,5,3,0,-1,1,0,-1,-1,1,-1
KR_6750845839,440,-4,-42,-17,-7,-5,5,0,-4,5,1,2,1,3,1,4,5,-1,4,3,0,5,6,1,-7,6,-1,0,-2,0,-1,-1,-1,0,-1
KR_6696506796,420,-1,-79,20,-8,-5,7,2,1,4,5,3,1,4,-6,8,2,-1,2,1,0,-5,-213,2,-7,5,1,0,-2,1,1,-1,-1,3,-1
KR_6757746457,420,3,-30,14,3,0,2,2,0,2,2,3,0,3,-1,1,0,1,0,1,0,5,-1,2,-9,7,8,0,0,1,0,0,-1,5,-1
KR_6752709088,420,-4,19,-4,-22,-6,7,1,-3,3,0,-5,6,1,-5,8,3,-3,3,0,-1,-20,-106,-4,-1,5,-2,0,-1,-1,1,-1,-1,3,-1
KR_6646353821,420,-2,-44,-4,-3,0,1,1,-3,4,1,-2,3,1,1,0,1,1,1,2,-1,-1,5,1,-7,6,-6,0,0,-1,-1,1,-1,6,-1
KR_6736561381,420,-3,-21,-35,-3,-2,3,1,4,1,5,-3,6,3,-1,5,4,-1,1,0,-1,1,-8,-5,-4,9,1,0,0,-1,1,1,-1,4,-1
KR_6762507796,420,2,14,19,1,1,4,5,2,2,4,-1,3,2,-1,3,2,0,0,0,0,-3,5,-8,-1,9,1,0,0,-1,1,1,1,5,-1
KR_6697911355,420,-3,42,-23,-5,-4,6,2,1,3,4,2,1,3,-4,6,2,0,1,1,0,-10,1,-2,-5,7,-1,0,-1,1,-1,-1,1,1,-1
KR_6765925186,420,-1,-14,8,-6,-1,3,2,-1,2,1,-5,5,0,-3,3,0,4,0,4,0,-6,6,-1,-4,5,-1,0,0,0,0,0,-1,0,-1
KR_6746076046,420,1,21,-4,3,-3,5,2,1,0,1,1,1,2,-4,4,0,8,0,8,-1,9,-6,-1,-4,5,2,0,-1,-1,0,-1,-1,1,-1
KR_6721123067,420,-2,-57,-20,-7,0,1,1,-7,7,0,0,0,0,-1,4,3,1,2,3,0,-3,1,-3,-1,4,1,0,0,-1,1,0,-1,1,-1
KR_6747290610,420,0,-33,-11,-2,0,1,1,2,1,3,-2,5,3,-2,4,2,0,0,0,-1,-2,-25,0,-3,3,-1,0,-1,1,-1,-1,-1,6,-1
KR_6700273526,440,-4,-100,2,-7,2,0,2,-2,2,0,-1,2,1,-8,8,0,2,0,2,0,-14,0,0,-4,4,-1,0,-2,1,-1,-1,-1,6,-1
KR_6763204124,420,-3,28,-12,-5,1,2,3,-3,3,0,-1,3,2,-1,4,3,-1,1,0,0,-21,-1,2,-7,5,-3,0,0,-1,1,1,1,3,-1
KR_6765450596,420,-1,-28,-48,1,0,2,2,-3,3,0,5,0,5,-1,2,1,0,0,0,0,-1,-1,-2,-4,6,1,0,-1,-1,1,-1,1,2,-1
KR_6751290540,420,-1,36,-8,2,-1,1,0,1,3,4,-5,6,1,8,0,8,-1,1,0,0,-1,24,3,-5,2,0,0,1,-1,1,1,1,6,-1
KR_6563024548,440,-1,-68,28,-11,1,4,5,-3,5,2,-3,5,2,-4,6,2,-2,2,0,0,-4,2,-2,-1,3,-4,0,-2,-1,0,-1,-1,4,-1
KR_6745261760,440,-4,21,16,0,-5,6,1,2,4,6,2,4,6,3,1,4,-2,4,2,2,2,9,4,-5,1,-2,0,0,1,-1,-1,1,2,-1
KR_6736863705,420,0,35,12,-2,0,3,3,0,1,1,2,1,3,-5,8,3,1,1,2,1,0,-7,-4,-4,8,3,0,0,-1,-1,0,1,5,-1
KR_6720989850,420,-1,13,-9,-7,-3,3,0,-7,7,0,1,1,2,1,1,2,1,3,4,-1,-12,-10,-2,-2,4,6,0,0,1,-1,0,-1,2,-1
KR_6765610199,420,-6,-37,-22,-19,1,1,2,-12,16,4,-5,8,3,-4,5,1,1,0,1,-1,-21,-31,-4,-2,6,4,0,-1,-1,1,-1,-1,3,-1
KR_6728516057,440,2,-7,35,0,1,0,1,0,4,4,1,0,1,-1,4,3,-1,1,0,0,-1,-22,-1,-7,8,-2,0,0,1,-1,0,-1,3,-1
KR_6743194760,440,-3,-72,-18,-6,-3,3,0,1,7,8,-7,8,1,4,2,6,-1,1,0,0,-4,9,0,-2,2,-4,0,-1,1,-1,-1,-1,6,-1
KR_6747556889,420,3,25,20,2,1,2,3,-2,4,2,4,0,4,0,1,1,-1,4,3,2,1,-1,1,-7,6,-2,0,1,-1,1,1,1,3,-1
KR_6688839725,420,-5,8,-24,-8,3,1,4,-5,7,2,1,2,3,-4,5,1,-3,3,0,1,1,0,2,-8,6,-5,0,-1,-1,-1,-1,1,1,-1
KR_6752199843,420,0,48,-4,0,-1,3,2,-2,4,2,3,2,5,3,1,4,-3,5,2,1,0,2,1,-4,3,2,0,-1,-1,-1,-1,1,1,-1
KR_6758711248,440,-3,-25,-5,-9,-1,1,0,-2,2,0,3,2,5,-9,9,0,0,1,1,-1,-9,-4,-3,0,3,0,0,-1,-1,-1,-1,-1,1,-1
KR_6689886886,420,-3,-11,-11,-8,3,0,3,-5,10,5,-3,4,1,-2,3,1,-1,3,2,0,-8,1,1,-5,4,-5,0,-1,1,-1,-1,-1,3,-1
KR_6704723874,420,-1,35,-1,7,-2,2,0,3,1,4,5,2,7,2,2,4,-1,1,0,0,8,123,-1,-4,5,3,0,0,1,-1,-1,1,2,-1
KR_6728705721,440,1,-23,1,4,-1,2,1,3,1,4,-3,5,2,2,2,4,3,1,4,0,6,96,2,-7,5,1,0,-1,-1,1,-1,-1,4,-1
KR_6751261911,440,-2,-65,-23,-7,-2,2,0,-4,5,1,-3,3,0,2,3,5,0,2,2,1,-6,-12,-7,-3,10,-6,0,0,1,-1,-1,-1,4,-1
KR_6691852519,420,-5,-105,-13,-11,-2,3,1,-6,7,1,1,2,3,-5,7,2,1,0,1,0,-10,-16,-2,-6,8,4,0,0,1,-1,-1,1,4,-1
KR_6760302158,420,-5,-52,-16,-12,-4,6,2,-1,1,0,1,2,3,-8,10,2,0,0,0,0,-11,-12,-3,-2,5,3,0,-1,1,-1,-1,-1,1,-1
KR_6747574560,420,3,68,19,3,-2,3,1,-3,6,3,-1,2,1,2,4,6,7,1,8,-1,1,-274,-1,-4,5,-4,0,0,1,-1,1,-1,3,-1
KR_6680339182,420,-4,-32,-17,-10,2,0,2,-2,4,2,-2,3,1,-1,1,0,-7,7,0,-1,-4,10,11,-12,1,-8,0,0,1,-1,1,-1,1,-1
KR_6735556564,440,-4,-21,-16,-6,2,1,3,-2,4,2,0,3,3,-7,8,1,1,0,1,-1,-12,8,-1,-6,7,-4,0,-1,-1,-1,-1,1,3,-1
KR_6763962017,420,-2,-13,14,-9,0,1,1,-3,5,2,-1,3,2,-4,5,1,-1,1,0,-1,-12,-6,-3,-2,5,-5,0,0,0,1,1,-1,0,-1
KR_6667949732,420,2,11,-27,4,2,1,3,2,5,7,-1,3,2,3,1,4,-2,2,0,0,5,6,5,-11,6,-2,0,0,-1,-1,-1,-1,5,-1
KR_6762579785,420,-4,5,-43,-4,-1,2,1,0,2,2,-2,3,1,-1,1,0,0,0,0,0,-6,-2,-3,-7,10,-7,0,0,-1,-1,0,-1,3,-1
KR_6761171988,420,-2,-15,8,-3,0,1,1,3,1,4,-2,2,0,-4,5,1,0,3,3,0,-4,0,0,-5,5,-3,0,0,-1,1,0,-1,5,-1
KR_6763901979,420,-2,-20,-4,-6,-3,3,0,-1,3,2,-3,4,1,2,2,4,-1,1,0,0,3,0,-6,-4,10,5,0,0,1,0,0,-1,1,-1
KR_6603001525,420,-1,-11,-1,-4,2,0,2,-6,8,2,0,0,0,2,0,2,-2,5,3,0,3,-1,-4,-2,6,-1,0,0,-1,1,0,1,1,-1
KR_6693575059,420,-3,-18,21,-4,-4,5,1,-1,4,3,6,1,7,4,1,5,-9,10,1,0,-2,-3,4,-8,4,-1,0,-1,1,1,-1,-1,6,-1
KR_6765254565,420,3,10,8,8,0,2,2,5,3,8,1,2,3,3,1,4,-1,1,0,0,8,7,8,-14,6,-12,0,1,1,1,1,1,1,-1
KR_6760217748,420,-1,-59,-9,-3,-1,4,3,3,1,4,-2,4,2,-6,8,2,3,1,4,0,1,7,-7,-1,8,0,0,0,-1,-1,-1,-1,3,-1
KR_6610005253,420,-5,-23,-24,-8,-1,2,1,-6,7,1,0,1,1,-1,3,2,0,0,0,0,-12,4,3,-7,4,0,0,0,-1,-1,0,-1,5,-1
KR_6765241421,420,-1,-31,-19,2,2,1,3,0,2,2,2,3,5,-1,2,1,-1,1,0,0,0,-43,-2,-2,4,13,0,-1,-1,1,1,1,4,-1
KR_6760322886,420,2,19,12,-1,-5,5,0,-2,4,2,6,2,8,-1,3,2,1,0,1,-4,-9,18,7,-10,3,-4,0,2,1,1,1,-1,2,-1
KR_6644453115,420,-1,-32,8,-4,1,1,2,1,1,2,-5,5,0,-4,8,4,3,0,3,0,-1,4,2,-7,5,-6,0,-1,-1,-1,-1,-1,2,-1
KR_6761743837,420,-2,-22,-12,-3,-3,4,1,-3,7,4,1,0,1,1,1,2,1,2,3,0,0,-2,-3,-2,5,-2,0,-1,-1,1,-1,-1,4,-1
KR_6471396968,420,-4,-13,-32,0,0,2,2,2,0,2,0,1,1,-2,8,6,0,1,1,0,8,-35,3,-7,4,18,0,0,1,-1,-1,-1,3,-1
KR_6764519644,420,-5,-69,-25,-12,0,2,2,-1,2,1,0,1,1,-7,7,0,-4,4,0,0,-8,2,-5,-2,7,1,0,0,-1,-1,-1,1,2,-1
KR_6761199652,440,-5,-29,-16,-4,-2,4,2,-2,3,1,-1,3,2,-2,3,1,3,1,4,0,2,-113,3,-6,3,-1,0,-1,1,-1,-1,-1,6,-1
KR_6597422679,420,3,-30,-24,11,5,0,5,7,1,8,-2,4,2,1,1,2,0,0,0,0,11,-10,1,-7,6,6,0,1,1,-1,1,1,3,-1
KR_6751487520,440,-1,-52,-2,-2,-2,3,1,2,2,4,0,3,3,-3,4,1,1,2,3,0,-7,25,-4,-4,8,2,0,2,0,1,1,1,0,-1
KR_6530358406,420,0,23,-20,0,-7,8,1,0,5,5,7,0,7,0,3,3,0,0,0,0,-2,-14,3,-7,4,-8,0,-1,1,1,-1,-1,5,-1
KR_6766231659,440,-4,-80,-4,-6,-3,4,1,-2,4,2,0,2,2,-2,4,2,1,1,2,0,-9,234,3,-3,0,2,0,1,-1,1,1,-1,3,-1
KR_6709151863,420,4,-25,1,2,4,1,5,4,0,4,-6,8,2,1,0,1,-1,2,1,0,2,3,4,-9,5,2,0,0,1,1,1,-1,2,-1
KR_6696176570,420,-1,2,-15,5,-3,4,1,-1,2,1,-2,2,0,5,0,5,6,0,6,0,8,-66,2,-7,5,3,0,0,0,-1,0,-1,0,-1
KR_6669122796,420,-2,32,-7,-5,-1,2,1,-3,7,4,-2,3,1,-2,3,1,3,1,4,0,-10,37,0,-3,3,-19,0,-3,0,-1,-1,1,0,-1
KR_6764767625,420,-3,15,-50,0,4,1,5,2,2,4,1,0,1,-5,6,1,-2,3,1,0,5,3,0,-2,2,3,0,0,-1,1,1,-1,2,-1
KR_6718605940,420,-2,-60,11,-8,-4,7,3,0,2,2,-7,9,2,2,2,4,1,1,2,0,-9,-2,0,-3,3,-8,0,0,-1,-1,-1,-1,3,-1
KR_6708916648,420,-6,-146,1,-11,-2,2,0,-3,5,2,-5,6,1,1,2,3,-2,3,1,0,-3,150,3,-5,2,-5,0,-1,-1,-1,-1,-1,4,-1
KR_6755517623,420,-3,-9,3,-3,0,1,1,-3,3,0,-2,2,0,2,3,5,0,2,2,0,-6,16,-2,-3,5,-5,0,-1,-1,-1,-1,-1,2,-1
KR_6766084853,420,-3,-38,0,-9,1,1,2,-3,3,0,-3,3,0,-1,4,3,-3,3,0,0,-12,6,4,-7,3,-10,0,0,-1,1,1,-1,4,-1
KR_6759728168,420,1,12,-28,-3,-2,2,0,1,2,3,-2,5,3,1,2,3,-1,3,2,0,-7,-4,-1,-8,9,0,0,0,-1,-1,-1,-1,3,-1
KR_6570718101,420,3,83,28,1,0,1,1,0,2,2,0,4,4,2,1,3,-1,1,0,1,-4,-11,3,-8,5,4,0,1,1,1,1,1,2,-1
KR_6670146577,420,3,23,4,9,1,1,2,7,1,8,2,3,5,-4,4,0,3,0,3,1,11,125,5,-10,5,-1,0,1,1,1,1,1,6,-1
KR_6676373590,420,-2,-30,26,-4,1,1,2,0,2,2,-4,5,1,-1,3,2,0,1,1,0,-5,-3,-3,-4,7,0,0,0,0,1,1,1,0,-1
KR_6602771365,420,-3,9,8,-3,0,2,2,-4,6,2,1,1,2,1,2,3,-1,1,0,0,-3,-70,-1,-4,5,31,0,0,1,-1,-1,1,6,-1
KR_6692606605,420,-1,-29,-15,-4,-3,4,1,1,1,2,0,1,1,-1,3,2,-1,3,2,0,-6,-4,2,-7,5,1,0,0,-1,1,0,-1,6,-1
KR_6746708119,440,3,45,0,4,-3,4,1,3,1,4,3,0,3,1,1,2,0,1,1,0,7,-13,2,-4,2,2,0,1,1,1,1,-1,4,-1
KR_6359707115,420,-4,-73,20,-10,-2,3,1,-5,6,1,2,0,2,-4,5,1,-1,2,1,0,-19,0,0,0,0,-3,0,-2,-1,1,-1,-1,5,-1
KR_6600036942,420,-5,-36,-3,-8,-6,6,0,-1,2,1,1,0,1,-2,6,4,0,0,0,0,-3,-4,0,-6,6,-1,0,-1,-1,-1,-1,-1,1,-1
KR_6762380498,420,-2,-18,-11,-2,-2,4,2,-1,2,1,2,1,3,0,0,0,-1,1,0,0,-1,-4,0,-4,4,-1,0,0,-1,-1,0,-1,5,-1
KR_6752263897,440,-4,-84,4,-9,-2,2,0,1,4,5,-6,8,2,-8,8,0,6,0,6,0,-12,-2,0,-3,3,-4,0,-2,-1,1,-1,-1,6,-1
KR_6762103078,420,0,10,-6,-3,2,1,3,-4,5,1,1,1,2,-2,2,0,0,0,0,0,-5,5,0,-3,3,-4,0,0,-1,1,0,1,2,-1
KR_6736862665,440,-5,-17,-51,-5,-2,2,0,-5,7,2,1,1,2,-1,2,1,2,0,2,1,0,12,4,-9,5,-13,0,-1,0,-1,-1,1,0,-1
KR_6759646321,440,0,-50,-11,-3,-3,5,2,0,1,1,-2,5,3,3,1,4,-1,1,0,0,2,-1,-1,-3,4,0,0,0,-1,-1,0,-1,3,-1
KR_6752335676,420,2,-45,36,1,1,1,2,4,5,9,-5,8,3,2,1,3,-1,1,0,0,-7,31,-3,-4,7,5,0,0,-1,-1,-1,-1,3,-1
KR_6695300841,420,0,-28,-12,0,0,2,2,-2,4,2,1,1,2,1,2,3,0,0,0,0,1,0,2,-6,4,-6,0,-1,-1,-1,-1,-1,1,-1
KR_6751503635,440,-1,48,-10,-5,-1,3,2,-2,4,2,0,0,0,-1,3,2,-1,1,0,0,-4,6,1,-5,4,-1,0,0,1,-1,1,-1,4,-1
KR_6765637922,420,2,15,-19,2,3,1,4,1,1,2,-3,8,5,2,0,2,-1,1,0,0,6,326,0,-6,6,-1,0,0,1,-1,1,-1,6,-1
KR_6505090430,420,-1,-32,-40,-2,1,0,1,-1,7,6,0,1,1,-2,5,3,0,0,0,0,-6,-56,0,-5,5,27,0,-1,-1,1,-1,-1,3,-1
KR_6752726489,440,-1,22,-4,0,0,1,1,-2,4,2,-3,3,0,3,2,5,2,0,2,0,-1,5,-1,-2,3,-1,0,-1,-1,-1,-1,1,5,-1
KR_6716590797,420,-1,1,-41,-6,0,1,1,-4,5,1,0,2,2,-1,3,2,-1,1,0,-1,-8,4,3,-8,5,-5,0,0,1,1,0,-1,2,-1
KR_6726859126,420,0,39,10,4,7,2,9,4,3,7,-5,5,0,-1,3,2,-1,1,0,0,-2,0,4,-10,6,-1,0,0,1,1,0,-1,1,-1
KR_6758665177,420,3,32,12,8,3,0,3,1,3,4,0,2,2,3,5,8,1,1,2,0,9,-144,-1,-4,5,-1,0,2,1,-1,1,-1,3,-1
KR_6746693258,440,-4,-63,-23,-17,-7,8,1,-4,6,2,2,0,2,-6,7,1,-2,2,0,0,-16,-5,1,-7,6,-4,0,-2,-1,-1,-1,-1,3,-1
KR_6668169338,440,-5,-76,-36,-3,-5,6,1,1,2,3,-2,4,2,4,2,6,-1,2,1,0,4,-2,-2,-2,4,1,0,-1,-1,-1,-1,-1,3,-1
KR_6761219175,440,-1,-11,-32,-2,1,2,3,-2,6,4,-5,5,0,3,2,5,1,1,2,1,0,-7,5,-13,8,6,0,-2,-1,0,-1,1,2,-1
KR_6747278306,420,1,-20,32,3,-3,6,3,-2,2,0,7,1,8,1,2,3,0,1,1,0,4,37,4,-8,4,-1,0,0,1,1,-1,-1,5,-1
KR_6760025783,420,-2,-4,-40,-6,-1,3,2,-5,6,1,-1,1,0,1,0,1,0,0,0,0,-5,-2,0,-8,8,2,0,0,-1,-1,0,-1,5,-1
KR_6746417190,420,-1,-56,19,-5,-2,5,3,0,3,3,-4,5,1,1,3,4,0,1,1,-1,-4,17,7,-8,1,-7,0,-1,1,-1,-1,-1,5,-1
KR_6763070802,420,-2,-18,-1,-10,-1,2,1,-1,5,4,-7,8,1,-3,4,1,2,0,2,0,-8,-39,0,-4,4,1,0,-2,-1,-1,-1,-1,3,-1
KR_6760482795,420,-3,6,-24,-8,2,3,5,-2,4,2,-4,4,0,-1,3,2,-3,4,1,-2,-12,-7,-1,-5,6,-3,0,-1,1,1,-1,-1,2,-1
KR_6650597517,420,-5,-6,-11,-3,-4,4,0,-1,8,7,-2,3,1,6,1,7,-2,2,0,0,-4,-2,4,-7,3,1,0,0,-1,-1,-1,1,4,-1
KR_6747598428,420,3,12,12,5,2,1,3,0,1,1,0,3,3,1,6,7,2,0,2,0,1,-117,-1,-8,9,0,0,0,-1,1,0,1,5,-1
KR_6740264319,420,0,-9,4,-1,2,3,5,-1,3,2,2,0,2,-3,4,1,-1,3,2,0,-10,102,3,-9,6,3,0,0,-1,1,-1,1,3,-1
KR_6740333564,420,0,-52,-16,-1,1,3,4,2,1,3,1,1,2,-3,4,1,-2,2,0,0,-5,6,3,-7,4,1,0,-1,1,-1,-1,1,6,-1
KR_6585698350,420,-1,-33,-8,-7,-5,5,0,-1,1,0,-3,5,2,2,2,4,0,1,1,0,0,43,1,-3,2,-3,0,-1,-1,-1,-1,-1,1,-1
KR_6761758039,420,1,16,17,0,1,0,1,-1,5,4,-1,1,0,1,1,2,0,2,2,0,-3,9,1,-6,5,-4,0,0,-1,1,0,1,4,-1
KR_6692057783,420,2,-73,-20,3,1,0,1,0,3,3,2,1,3,2,3,5,-2,2,0,0,5,17,0,-4,4,-2,0,-1,0,-1,-1,-1,0,-1
KR_6762491863,440,-2,-5,17,-4,-1,3,2,-4,4,0,3,3,6,0,3,3,-2,4,2,0,-6,14,-3,-4,7,-2,0,0,1,0,0,1,6,-1
KR_6729437346,420,-1,-44,8,0,1,0,1,-1,4,3,5,3,8,-5,9,4,0,0,0,0,9,4,0,-7,7,-4,0,0,-1,1,-1,1,1,-1
KR_6758568572,420,0,6,-8,-1,-3,3,0,2,0,2,1,2,3,-1,3,2,0,1,1,-1,5,-2,0,-3,3,-1,0,0,0,-1,-1,-1,0,-1
KR_6761818151,440,0,-68,16,-5,5,0,5,-2,3,1,-6,7,1,0,3,3,-2,2,0,0,4,3,-2,-2,4,-2,0,-1,-1,-1,-1,-1,1,-1
KR_6728842930,420,-1,55,-40,3,-5,5,0,-1,3,2,1,0,1,4,1,5,4,0,4,0,7,16,1,-3,2,-4,0,0,-1,-1,-1,-1,3,-1
KR_6677796903,420,-6,-86,-62,-12,-1,3,2,-2,4,2,-2,3,1,-4,4,0,-3,3,0,0,-12,1,2,-6,4,-1,0,-1,-1,-1,-1,1,3,-1
KR_6751808398,420,-2,-21,-23,-1,0,1,1,-4,5,1,-2,5,3,2,1,3,3,0,3,0,-2,-126,-3,-4,7,4,0,0,1,-1,0,-1,1,-1
KR_6765823705,420,-3,35,-28,-13,-3,3,0,0,1,1,-3,5,2,-6,8,2,-1,2,1,1,-15,-4,-6,-3,9,4,0,0,1,1,1,1,1,-1
KR_6641810422,420,-9,-94,-12,-17,-1,3,2,-3,3,0,-10,11,1,-6,6,0,3,2,5,0,-10,-6,1,-5,4,-2,0,-2,-1,-1,-1,-1,5,-1
KR_6738416775,420,-5,-2,27,-20,-3,3,0,-7,9,2,-4,6,2,-5,6,1,-1,2,1,0,-21,-34,-1,-4,5,-2,0,-1,-1,-1,-1,-1,1,-1
KR_6757361038,420,3,-20,-2,7,1,0,1,2,2,4,3,3,6,1,0,1,0,0,0,0,8,4,1,-4,3,-3,0,1,-1,1,1,1,1,-1
KR_6764791632,420,-2,-60,-15,-5,-2,3,1,1,1,2,-2,3,1,-2,5,3,0,0,0,0,-6,4,4,-9,5,-3,0,0,-1,1,0,-1,3,-1
KR_6734103695,420,-2,8,7,-5,-4,4,0,4,1,5,-1,3,2,0,3,3,-4,4,0,0,-5,0,1,-4,3,1,0,-3,-1,-1,-1,1,4,-1
KR_6744109691,420,-1,-17,-24,-1,2,2,4,5,2,7,-4,4,0,-3,3,0,-1,3,2,0,-1,133,-1,-3,4,14,0,1,0,0,1,-1,0,-1
KR_6703992719,420,0,-12,21,-1,0,2,2,1,1,2,1,1,2,-4,6,2,1,1,2,0,-3,0,-3,-4,7,0,0,0,-1,-1,-1,1,4,-1
KR_6757088039,420,-1,-22,39,-7,0,3,3,-1,2,1,-1,3,2,-3,3,0,-2,2,0,0,-12,26,2,-9,7,-5,0,-2,1,-1,-1,1,6,-1
KR_6585315050,420,2,32,17,3,0,1,1,-2,3,1,-2,2,0,7,0,7,0,0,0,0,8,28,2,-5,3,0,0,1,1,-1,1,1,4,-1
KR_6360861027,420,-1,81,-24,0,0,1,1,-2,2,0,2,1,3,-1,1,0,1,0,1,0,-6,0,0,0,0,-7,0,1,-1,-1,1,1,2,-1
KR_6764859547,440,-1,-34,-16,1,0,1,1,0,0,0,2,1,3,5,3,8,-6,7,1,0,7,14,-1,-5,6,-4,0,0,1,-1,1,1,4,-1
KR_6759326111,420,-6,-60,-21,-11,-2,4,2,-6,6,0,-2,2,0,-3,7,4,2,1,3,0,-12,-25,1,-4,3,-2,0,0,-1,0,-1,1,4,-1
KR_6750644296,420,-3,-41,-28,-5,-2,2,0,2,0,2,-5,6,1,4,3,7,-4,4,0,1,-2,258,2,-7,5,1,0,-1,-1,-1,-1,1,2,-1
KR_6756909285,420,2,3,24,4,0,1,1,0,7,7,5,0,5,-2,2,0,1,1,2,0,2,1,7,-8,1,0,0,1,1,1,1,1,5,-1
KR_6764695473,420,-1,-34,-12,-2,-2,2,0,-1,2,1,0,4,4,2,1,3,-1,2,1,-1,1,2,3,-9,6,2,0,1,1,1,-1,-1,4,-1
KR_6758657058,420,-4,-67,0,-4,2,0,2,-1,4,3,-4,6,2,-2,3,1,1,4,5,1,0,-10,-1,-5,6,1,0,-2,-1,1,-1,1,3,-1
KR_6760515537,420,3,35,0,6,2,3,5,0,3,3,3,2,5,1,1,2,0,0,0,0,3,5,2,-6,4,0,0,2,1,1,1,-1,3,-1
KR_6692537081,420,-3,16,-26,-7,1,2,3,-5,7,2,0,1,1,-2,4,2,-1,2,1,0,-8,0,-3,-4,7,2,0,1,-1,-1,1,1,3,-1
KR_6745127315,420,-3,3,-4,-2,-3,4,1,-1,5,4,-2,3,1,4,0,4,0,0,0,1,3,35,-2,-4,6,0,0,0,1,1,0,1,5,-1
KR_6765482944,420,-2,-26,-7,-12,-2,2,0,-1,3,2,-3,3,0,-5,5,0,-1,1,0,0,-13,-6,-6,-3,9,4,0,0,1,-1,-1,-1,4,-1
KR_6739799660,420,-2,-86,0,0,-5,5,0,3,2,5,-1,1,0,3,1,4,0,1,1,0,8,11,3,-9,6,-4,0,-1,-1,-1,-1,1,3,-1
KR_6761658862,440,-3,-43,-4,-11,0,2,2,0,0,0,-3,4,1,-8,8,0,0,0,0,0,-12,-2,-3,-2,5,2,0,-2,-1,-1,-1,-1,3,-1
KR_6763933625,420,-2,-36,8,-1,1,1,2,-1,6,5,4,1,5,-4,4,0,-1,1,0,0,-6,-2,3,-11,8,1,0,1,1,1,1,-1,1,-1
KR_6738165729,420,-2,30,-7,-3,-2,2,0,-2,3,1,3,6,9,2,2,4,-4,5,1,0,-6,3,-1,-4,5,2,0,0,-1,1,0,1,1,-1
KR_6764564691,420,0,8,-32,-1,3,1,4,0,3,3,-1,5,4,-2,2,0,-1,2,1,0,-7,0,1,-5,4,3,0,0,1,-1,-1,1,3,-1
KR_6761506587,420,-6,-37,8,-14,-3,4,1,-1,3,2,-5,5,0,-4,7,3,-1,2,1,0,-15,-6,-5,-3,8,2,0,-3,-1,-1,-1,1,4,-1
KR_6739874015,420,-1,13,-4,-6,-1,1,0,0,2,2,-5,5,0,0,4,4,0,0,0,0,-8,23,0,-4,4,-4,0,0,1,-1,0,-1,6,-1
KR_6524675174,420,-1,-11,-16,0,0,1,1,-3,8,5,1,2,3,4,0,4,-2,2,0,0,1,-3,-5,-5,10,4,0,0,1,-1,-1,1,3,-1
KR_6761849197,420,-1,-56,-12,-9,-3,3,0,-4,5,1,-2,4,2,-1,1,0,1,0,1,0,-3,-2,-4,-3,7,-4,0,-1,-1,-1,-1,-1,3,-1
KR_6700339982,420,2,-4,-4,1,-1,3,2,0,1,1,1,2,3,2,2,4,-1,2,1,1,11,-10,-1,-2,3,4,0,0,-1,0,0,1,1,-1
KR_6742513454,420,2,21,-11,2,-2,2,0,2,0,2,4,0,4,-3,5,2,1,0,1,0,-1,7,3,-4,1,-5,0,1,-1,1,1,-1,5,-1
KR_6677732430,420,-2,-49,12,-5,-6,6,0,-1,2,1,0,3,3,-1,7,6,3,0,3,1,0,-52,-7,-2,9,1,0,-2,1,-1,-1,1,2,-1
KR_6722795616,420,0,-73,12,-1,-1,2,1,-1,4,3,-2,2,0,0,3,3,3,0,3,1,-4,-3,-5,-3,8,-4,0,0,1,-1,1,1,5,-1
KR_6758927065,420,-3,-110,-33,-11,-3,4,1,4,0,4,-1,4,3,-5,5,0,-6,6,0,-1,-5,0,-2,-5,7,-7,0,-1,-1,1,-1,-1,3,-1
KR_6745027337,440,-3,-32,-4,-5,-6,7,1,1,2,3,-2,2,0,1,2,3,1,0,1,0,6,-1,2,-7,5,1,0,-2,1,-1,-1,1,3,-1
KR_6046273131,420,3,-13,28,10,2,0,2,4,2,6,3,1,4,3,4,7,-2,2,0,0,11,2,4,-10,6,-3,0,0,-1,1,1,1,1,-1
KR_6714549817,440,-3,-80,-24,-6,-1,3,2,0,0,0,-4,7,3,-1,1,0,0,0,0,0,-3,-18,1,-6,5,-4,0,-1,-1,-1,-1,1,4,-1
KR_6207447942,420,0,43,3,1,-1,1,0,5,2,7,-3,6,3,-1,4,3,1,2,3,0,2,3,0,-7,7,2,0,0,1,-1,1,1,4,-1
KR_6614968634,420,-2,-85,13,-6,-2,4,2,4,0,4,-7,7,0,-1,3,2,0,0,0,0,-2,-5,-1,-4,5,4,0,-1,-1,1,-1,-1,6,-1
KR_6716807509,420,-2,-39,-5,-4,-4,6,2,0,4,4,-1,1,0,1,3,4,0,1,1,0,0,-3,2,-7,5,-1,0,-1,1,-1,-1,1,1,-1
KR_6761174871,420,-3,25,0,-6,0,0,0,-4,5,1,-2,7,5,2,1,3,-2,4,2,0,-10,-3,-4,-1,5,-4,0,1,1,-1,1,1,6,-1
KR_6742296223,420,0,-44,16,-8,0,1,1,-4,5,1,-8,11,3,3,1,4,1,2,3,0,-17,0,-2,-3,5,1,0,-1,1,1,-1,-1,5,-1
KR_6697403362,420,-2,-2,27,-7,0,2,2,-1,2,1,-3,3,0,-3,6,3,0,1,1,0,-7,-31,-12,-2,14,-2,0,-1,0,0,-1,-1,0,-1
KR_6764427780,420,-1,-12,-3,-13,-6,6,0,-3,5,2,1,0,1,-5,5,0,0,0,0,0,-15,4,0,-4,4,-6,0,0,-1,-1,-1,-1,1,-1
KR_6757888439,420,0,15,4,-2,-5,6,1,3,2,5,0,2,2,4,0,4,-4,4,0,0,-1,-13,0,-6,6,7,0,1,1,-1,1,-1,3,-1
KR_6729338952,440,-5,-52,-32,-13,-3,3,0,-7,7,0,-6,6,0,1,5,6,2,1,3,1,-9,-5,-4,-3,7,-4,0,-3,-1,-1,-1,1,6,-1
KR_6756042979,420,1,64,24,-2,-1,2,1,2,0,2,0,3,3,-3,3,0,0,5,5,0,-9,-24,-6,-3,9,7,0,0,-1,1,-1,-1,3,-1
KR_6724732279,420,-1,-22,-4,-4,1,2,3,-3,4,1,-9,9,0,4,2,6,3,2,5,0,5,-7,-7,-2,9,-2,0,0,-1,1,-1,-1,2,-1
KR_6716179183,420,1,-5,6,-8,-3,4,1,0,4,4,0,1,1,-6,6,0,1,0,1,0,-12,2,-5,-4,9,-4,0,0,-1,1,1,1,1,-1
KR_6748514303,420,-3,5,-7,-5,-2,3,1,-5,6,1,-1,3,2,1,2,3,2,0,2,0,-4,1,3,-7,4,-3,0,0,1,1,0,1,1,-1
KR_6685591090,420,-1,5,8,-4,0,1,1,0,2,2,-1,2,1,-3,7,4,0,3,3,0,-1,-5,-1,-3,4,0,0,-1,-1,-1,-1,1,6,-1
KR_6747452439,420,-4,-29,-3,-8,-3,4,1,-1,2,1,-3,4,1,-1,2,1,0,0,0,-1,-7,0,1,-3,2,-1,0,-3,-1,-1,-1,-1,5,-1
KR_6736609673,420,-2,-69,-36,-6,-3,3,0,-7,8,1,3,3,6,2,2,4,-1,2,1,-1,-2,-12,0,-4,4,0,0,-1,1,-1,-1,-1,5,-1
KR_6727184174,420,3,40,-6,1,-4,5,1,4,2,6,1,1,2,-2,3,1,2,0,2,0,1,9,3,-7,4,-2,0,1,-1,1,1,-1,6,-1
KR_6669767850,420,-4,6,16,-8,3,2,5,0,1,1,-2,5,3,-7,9,2,-2,4,2,0,-9,17,5,-7,2,0,0,-1,-1,-1,-1,1,3,-1
KR_6706318835,420,-1,-37,12,-9,-3,3,0,3,0,3,-6,7,1,-4,4,0,1,0,1,-1,-10,4,-2,-6,8,-6,0,-1,-1,1,-1,-1,1,-1
KR_6766145099,420,-2,-87,-5,-5,-1,2,1,0,2,2,-1,3,2,-5,6,1,2,0,2,0,-6,-20,-1,-1,2,-2,0,-1,1,-1,-1,1,1,-1
KR_6733631148,420,-2,-80,17,-2,-1,2,1,-3,4,1,3,1,4,-1,2,1,0,2,2,0,-2,116,-3,-4,7,2,0,-1,-1,-1,-1,-1,2,-1
KR_6742428531,420,-1,17,-7,-1,0,0,0,-1,4,3,0,2,2,-3,5,2,3,0,3,0,-6,25,-1,-4,5,7,0,0,-1,1,0,1,4,-1
KR_6648397929,420,-4,-32,43,-7,2,1,3,-1,6,5,-2,6,4,-5,6,1,-1,2,1,0,-5,-7,-4,-5,9,-4,0,0,-1,1,0,1,2,-1
KR_6642300447,420,0,-45,12,-2,-2,4,2,0,3,3,0,1,1,0,2,2,0,0,0,0,-3,193,1,-4,3,3,0,0,-1,1,-1,-1,3,-1
KR_6743091594,440,-7,-17,-32,-16,1,1,2,-6,7,1,-4,4,0,-5,6,1,-2,3,1,0,-15,7,3,-7,4,-4,0,-1,-1,1,-1,-1,5,-1
KR_6761320577,420,-1,-61,-1,-2,-1,1,0,1,2,3,0,1,1,-3,5,2,1,0,1,0,-3,-8,-1,-5,6,7,0,-1,1,-1,-1,1,3,-1
KR_6737278800,440,-4,-70,-1,-6,-1,1,0,0,3,3,0,0,0,0,2,2,-5,7,2,-1,0,37,2,-5,3,-32,0,0,-1,1,0,-1,4,-1
KR_6727946950,420,-4,-26,-42,-7,1,1,2,-4,6,2,-1,3,2,-2,3,1,-1,1,0,1,-2,-55,2,-3,1,36,0,-1,-1,-1,-1,1,3,-1
KR_6675851078,420,-4,-45,6,-6,0,1,1,-7,9,2,-1,1,0,2,3,5,0,0,0,2,-7,5,4,-8,4,-4,0,-1,1,1,-1,1,5,-1
KR_6693850304,420,-8,-61,-20,-9,-4,5,1,-1,3,2,0,3,3,-2,4,2,-2,3,1,0,-8,1,-6,-2,8,-4,0,-2,-1,-1,-1,-1,4,-1
KR_6759335306,420,-3,-3,9,-10,2,1,3,-5,6,1,-1,3,2,-7,7,0,1,0,1,0,-8,-9,-3,-3,6,3,0,-2,1,-1,-1,-1,1,-1
KR_6759548096,420,1,-32,12,3,-2,2,0,2,1,3,2,1,3,2,1,3,-1,1,0,0,8,16,4,-9,5,3,0,1,-1,1,1,-1,2,-1
KR_6753102575,420,-3,-15,-16,-6,1,2,3,-1,3,2,-3,3,0,-2,2,0,-1,2,1,0,-11,16,-4,-4,8,-2,0,-1,-1,-1,-1,1,6,-1
KR_6756205977,420,-4,-108,14,-14,-5,5,0,-3,5,2,1,3,4,-7,7,0,0,0,0,-2,-16,-57,1,-6,5,29,0,-2,-1,1,-1,-1,6,-1
KR_6602918200,420,-4,-97,-11,-5,-3,3,0,-4,5,1,0,2,2,3,0,3,-1,1,0,0,3,-34,-2,-3,5,25,0,-1,-1,-1,-1,1,5,-1
KR_6761119527,420,0,-14,-3,-2,2,2,4,-2,4,2,2,1,3,-3,4,1,-1,1,0,0,-5,4,-1,-5,6,-6,0,-1,1,-1,-1,1,4,-1
KR_6748397500,420,-1,2,10,2,0,1,1,3,2,5,-2,3,1,1,1,2,0,0,0,0,2,108,-2,-5,7,-3,0,1,-1,1,1,1,3,-1
KR_6761802814,420,-3,-25,4,-1,-3,4,1,0,2,2,3,1,4,0,1,1,-1,2,1,-1,4,8,4,-9,5,-1,0,-1,-1,-1,-1,-1,4,-1
KR_6741704220,420,-6,76,0,-13,-3,3,0,-3,6,3,1,1,2,-2,4,2,-6,6,0,0,-9,-17,6,-7,1,-3,0,0,-1,1,1,-1,2,-1
KR_6449086031,420,0,-38,-4,2,-2,3,1,-3,5,2,1,2,3,5,0,5,1,1,2,0,7,-13,-3,-4,7,6,0,-1,-1,-1,-1,-1,6,-1
KR_6668206794,440,-2,61,-10,-3,-1,1,0,-3,3,0,4,1,5,-4,4,0,1,1,2,-1,1,6,0,-4,4,0,0,0,0,1,0,-1,0,-1
KR_6617504729,420,0,45,0,-2,-5,5,0,1,3,4,-2,5,3,4,0,4,0,2,2,1,6,-27,-1,-6,7,4,0,-1,1,-1,-1,1,1,-1
KR_6761723687,440,-6,-87,-48,-6,-3,3,0,-1,3,2,2,0,2,1,2,3,-5,5,0,0,-8,-6,-7,-1,8,-6,0,-3,-1,-1,-1,-1,1,-1
KR_6765575811,420,-2,-22,-28,-5,-1,2,1,5,0,5,-3,4,1,-4,5,1,-2,3,1,0,-9,-5,-2,-4,6,-1,0,-1,-1,-1,-1,-1,2,-1
KR_6723825189,420,1,-36,16,-3,1,0,1,-1,3,2,-1,1,0,-2,2,0,0,0,0,0,-4,40,3,-10,7,-4,0,1,-1,1,1,-1,3,-1
KR_6362540447,420,3,13,-33,5,-4,5,1,5,2,7,1,0,1,4,0,4,-1,2,1,0,1,0,0,0,0,3,0,1,-1,-1,-1,-1,4,-1
KR_6696745662,420,-7,-72,-3,-18,-5,5,0,-7,8,1,-2,5,3,0,3,3,-4,4,0,0,-21,-8,-5,-5,10,-4,0,-1,-1,-1,-1,-1,3,-1
KR_6761544778,420,-2,-47,-18,-3,-7,7,0,2,3,5,1,1,2,1,0,1,0,0,0,-1,4,8,-1,-4,5,-2,0,-1,1,-1,-1,-1,2,-1
KR_6762444507,420,-3,-21,2,-4,1,1,2,1,1,2,0,1,1,-6,7,1,0,1,1,0,-9,-14,-2,-3,5,4,0,1,-1,1,1,-1,3,-1
KR_6668557139,420,-4,-87,-8,-14,-4,4,0,-2,7,5,-4,6,2,-1,4,3,-3,4,1,0,-19,434,2,-7,5,0,0,2,-1,-1,1,-1,3,-1
KR_6717233622,420,-1,-20,-15,0,1,0,1,0,3,3,1,3,4,-2,2,0,0,1,1,0,-1,2,4,-5,1,-2,0,0,1,-1,-1,1,2,-1
KR_6680142737,420,-2,-26,15,-4,-6,7,1,-1,2,1,-2,5,3,3,2,5,2,1,3,0,2,-4,0,-3,3,1,0,0,-1,-1,-1,1,3,-1
KR_6766121294,420,-3,8,-15,-5,0,2,2,-3,8,5,2,0,2,-2,4,2,-2,2,0,0,-4,39,2,-7,5,-26,0,-1,1,-1,-1,-1,5,-1
KR_6758171267,440,-1,10,3,-1,-2,2,0,0,2,2,1,2,3,2,5,7,-2,3,1,0,-5,-3,-2,-4,6,-1,0,0,0,0,0,-1,0,-1
KR_6726493938,420,-4,-39,-23,-1,-1,1,0,3,3,6,1,3,4,-3,4,1,-1,2,1,0,1,7,5,-9,4,5,0,-3,1,-1,-1,-1,2,-1
KR_6731155622,420,-6,-63,-24,-17,-2,2,0,-3,3,0,-4,6,2,-8,8,0,0,2,2,0,-18,-2,-2,-4,6,3,0,0,-1,-1,0,-1,2,-1
KR_6740529263,420,-2,-70,-1,0,-2,4,2,0,5,5,2,0,2,-1,2,1,1,0,1,0,0,-24,0,-3,3,3,0,0,1,1,0,1,2,-1
KR_6759912736,420,2,43,-24,10,0,1,1,3,1,4,2,2,4,3,1,4,2,1,3,1,12,-9,5,-9,4,3,0,-1,-1,1,-1,1,4,-1
KR_6657028169,420,-2,-53,-4,-3,-4,6,2,2,2,4,0,0,0,2,1,3,-3,5,2,0,-1,-5,-3,-3,6,-4,0,-2,-1,1,-1,1,4,-1
KR_6742272761,420,-3,11,-8,-4,-2,2,0,1,2,3,0,4,4,0,1,1,-3,5,2,0,-4,1,-1,-7,8,-3,0,0,0,1,0,1,0,-1
KR_6764569682,440,-1,-21,32,-7,-2,2,0,-2,2,0,-4,4,0,0,1,1,1,0,1,0,-9,-3,1,-6,5,-3,0,1,-1,1,1,-1,2,-1
KR_6765452810,420,-1,-38,2,0,5,0,5,-3,3,0,-2,5,3,-3,4,1,3,0,3,1,1,5,1,-4,3,0,0,2,-1,1,1,1,5,-1
KR_6730715479,420,-2,-81,28,-8,-3,3,0,-1,1,0,-2,3,1,-3,4,1,1,0,1,-2,-14,-9,-3,-5,8,4,0,-1,-1,-1,-1,-1,1,-1
KR_6635139774,420,-4,-96,-13,-6,-1,2,1,0,2,2,-2,2,0,-3,4,1,0,1,1,-1,-3,-33,-2,-4,6,1,0,0,1,1,0,-1,5,-1
KR_6755821987,420,-1,-4,-6,-11,-4,6,2,-2,4,2,-2,5,3,-4,5,1,1,0,1,-1,-15,-42,2,-4,2,-2,0,1,-1,1,1,-1,6,-1
KR_6758539313,420,2,42,0,0,-2,3,1,1,0,1,3,3,6,-4,4,0,2,1,3,0,-6,24,1,-6,5,-5,0,0,-1,1,0,1,5,-1
KR_6745434625,420,0,-21,12,-3,2,1,3,0,4,4,0,2,2,-9,10,1,4,0,4,-1,-6,-9,-6,-1,7,7,0,-2,1,-1,-1,-1,3,-1
KR_6733761218,440,-1,-16,0,-5,-1,3,2,-8,10,2,0,1,1,0,2,2,4,2,6,-1,-4,-2,2,-5,3,-3,0,0,-1,-1,0,-1,5,-1
KR_6757764040,420,-1,14,-16,1,-1,8,7,-8,10,2,0,3,3,6,3,9,4,0,4,1,6,7,4,-11,7,5,0,1,1,1,1,-1,1,-1
KR_6745718773,420,0,61,-17,9,-2,4,2,10,2,12,-2,6,4,2,1,3,1,0,1,3,9,6,5,-9,4,-2,0,0,-1,1,1,1,2,-1
KR_6696088311,420,-4,-81,11,-10,-2,3,1,1,2,3,-7,7,0,-2,2,0,0,0,0,-1,-15,-14,-1,-5,6,-3,0,-1,-1,-1,-1,-1,1,-1
KR_6713507593,420,-4,-56,-28,-5,-2,3,1,-3,4,1,0,1,1,-1,2,1,1,0,1,0,-6,0,-4,-3,7,-1,0,0,-1,-1,0,-1,5,-1
KR_6692619836,420,-2,3,16,3,0,2,2,4,1,5,1,1,2,-2,2,0,0,1,1,1,3,-4,-3,-4,7,0,0,0,-1,-1,0,1,2,-1
KR_6763947170,440,-1,-62,11,-8,1,2,3,0,1,1,1,2,3,-7,8,1,-3,4,1,0,-9,10,0,-5,5,-2,0,0,1,1,1,-1,3,-1
KR_6739647436,420,1,-7,12,4,-2,3,1,6,1,7,-2,3,1,2,1,3,0,0,0,0,-1,187,-1,-3,4,1,0,-1,1,-1,-1,1,3,-1
KR_6720042593,420,2,-18,11,3,-3,4,1,5,1,6,-2,5,3,0,3,3,3,0,3,0,-3,34,0,-4,4,0,0,-1,0,1,-1,-1,0,-1
KR_6742260460,420,-3,-50,4,-1,-1,1,0,1,5,6,-4,4,0,2,2,4,1,0,1,0,4,68,0,-7,7,-28,0,-1,-1,-1,-1,-1,3,-1
KR_6748337144,420,1,30,-12,3,-1,1,0,0,4,4,1,0,1,0,3,3,3,1,4,0,9,1,5,-9,4,1,0,-1,1,-1,-1,-1,1,-1
KR_6719275687,440,-4,-73,30,-6,-2,3,1,5,1,6,0,2,2,-2,3,1,-7,7,0,0,-5,3,4,-8,4,-4,0,0,1,1,0,-1,1,-1
KR_6715199070,440,0,-59,-3,4,2,1,3,3,3,6,-2,3,1,6,1,7,-5,5,0,-1,11,-6,1,-4,3,-3,0,0,-1,-1,-1,-1,4,-1
KR_6762784450,420,-2,24,11,-5,1,1,2,-3,4,1,1,2,3,-2,3,1,-2,2,0,0,-7,-8,-1,-5,6,1,0,-1,1,-1,-1,1,1,-1
KR_6699784787,420,1,-19,12,5,3,1,4,-1,3,2,-3,4,1,4,2,6,2,0,2,0,4,10,4,-8,4,-2,0,0,1,0,1,-1,3,-1
KR_6747900123,420,-1,12,5,-4,2,0,2,-2,3,1,-1,1,0,-2,2,0,-1,1,0,1,-2,10,7,-11,4,-4,0,1,1,1,1,1,2,-1
KR_6737640536,420,-1,6,34,-8,-2,2,0,2,3,5,0,4,4,-6,6,0,-2,2,0,0,-13,-2,-3,-3,6,0,0,0,1,-1,-1,-1,3,-1
KR_6737941411,440,1,6,-13,5,0,0,0,0,4,4,2,1,3,4,2,6,-1,2,1,0,5,0,3,-7,4,0,0,0,0,-1,0,-1,0,-1
KR_6735737124,420,-3,-130,6,-7,-2,5,3,-3,5,2,3,0,3,-6,7,1,1,0,1,1,-8,11,2,-5,3,-3,0,-1,0,1,-1,1,0,-1
KR_6676086720,420,-7,-80,-15,-7,2,1,3,-1,2,1,-3,4,1,-8,10,2,3,0,3,0,-4,-30,-8,-3,11,-1,0,-1,-1,-1,-1,1,1,-1
KR_6718335936,420,-4,-68,20,-7,-5,7,2,-1,3,2,1,2,3,-2,3,1,0,0,0,1,-11,3,0,-5,5,0,0,-1,1,1,-1,1,4,-1
KR_6675920470,420,2,36,-20,-2,4,1,5,-5,6,1,-1,3,2,-3,3,0,3,0,3,0,1,-2,-1,-6,7,2,0,0,-1,-1,-1,-1,5,-1
KR_6721959913,420,-2,18,-10,-7,1,2,3,-6,7,1,0,1,1,1,1,2,-3,3,0,-2,-18,13,-3,-5,8,-2,0,0,0,-1,-1,-1,0,-1
KR_6701971576,420,2,55,11,12,-2,2,0,2,1,3,1,1,2,11,0,11,0,2,2,0,16,31,5,-6,1,-3,0,0,1,-1,1,1,5,-1
KR_6756768532,420,-2,-29,-23,-5,1,0,1,1,0,1,1,3,4,-5,5,0,-3,3,0,0,-15,-2,-2,-7,9,-3,0,-3,1,0,-1,1,6,-1
KR_6755509656,420,0,34,5,-6,0,2,2,-1,2,1,-1,3,2,-2,4,2,-2,2,0,0,-4,1,7,-9,2,-5,0,0,-1,1,1,-1,5,-1
KR_6747730699,420,0,42,5,1,-2,2,0,1,2,3,0,2,2,3,1,4,-1,1,0,0,0,14,-4,-4,8,8,0,-1,1,-1,1,1,6,-1
KR_6765947518,420,6,16,8,7,0,1,1,8,0,8,-1,2,1,0,2,2,0,0,0,0,11,8,2,-7,5,-5,0,1,-1,1,1,-1,3,-1
KR_6758239774,420,-8,-35,-15,-11,0,1,1,-3,3,0,0,2,2,-6,6,0,-2,4,2,0,-7,13,6,-9,3,0,0,-1,-1,1,1,-1,4,-1
KR_6757478422,420,2,75,11,-1,0,0,0,2,1,3,-7,7,0,0,2,2,4,1,5,0,-4,-1,0,-4,4,-6,0,0,-1,1,1,1,5,-1
KR_6748311385,420,0,-54,8,-4,1,1,2,-2,2,0,-1,1,0,2,2,4,-4,4,0,0,-4,-2,2,-5,3,-2,0,0,-1,-1,-1,-1,6,-1
KR_6634615438,420,-3,-67,5,-7,-4,5,1,0,1,1,-1,5,4,-2,5,3,0,1,1,0,-8,-6,-3,-1,4,0,0,-3,-1,-1,-1,-1,6,-1
KR_6700033065,420,0,-45,4,-1,1,2,3,2,1,3,-2,3,1,-4,6,2,2,0,2,0,-12,0,-2,-5,7,-3,0,-1,-1,0,-1,-1,4,-1
KR_6734502948,420,-1,-9,-12,7,-2,4,2,-2,3,1,1,1,2,4,3,7,6,1,7,2,13,-1,-2,-6,8,-4,0,1,1,1,1,1,4,-1
KR_6686449519,420,0,-7,16,7,-3,5,2,0,3,3,9,1,10,1,1,2,0,0,0,1,19,0,-1,-5,6,-1,0,-2,-1,1,1,1,2,-1
KR_6685380503,420,-1,18,8,-12,-3,4,1,-4,7,3,-2,2,0,-4,5,1,1,2,3,0,-16,0,-6,-2,8,-2,0,0,-1,-1,-1,-1,1,-1
KR_6763274491,420,-3,-53,-17,-10,-4,7,3,-4,8,4,-1,2,1,-1,3,2,0,1,1,0,-6,14,-3,-3,6,-2,0,-3,0,-1,-1,-1,0,-1
KR_6693271932,420,0,12,-16,-7,2,1,3,-2,5,3,-5,7,2,-2,4,2,0,2,2,-1,-14,233,-2,-2,4,1,0,-1,1,-1,-1,-1,2,-1
KR_6733076515,420,2,26,8,6,-1,5,4,3,1,4,4,1,5,-2,3,1,2,2,4,0,8,46,2,-5,3,-1,0,0,1,-1,-1,1,2,-1
KR_6760532730,420,-2,-33,-23,-4,0,2,2,-1,5,4,-1,2,1,-1,3,2,-1,4,3,1,0,398,-1,-4,5,2,0,0,1,-1,0,1,6,-1
KR_6592568021,420,-1,-45,-32,-2,-2,2,0,1,0,1,-9,13,4,3,2,5,5,0,5,0,6,-7,-1,-6,7,0,0,-1,-1,-1,-1,-1,5,-1
KR_6759137698,420,-2,-16,-32,-4,1,2,3,2,1,3,0,2,2,-7,7,0,0,1,1,0,-1,8,1,-5,4,1,0,1,-1,1,1,-1,4,-1
KR_6606568798,420,-3,-1,-11,-3,-1,3,2,-2,4,2,-1,3,2,0,2,2,1,1,2,2,-3,-2,1,-8,7,2,0,0,-1,-1,0,1,6,-1
KR_6731381558,440,-8,-113,-32,-15,0,3,3,2,2,4,-12,12,0,-7,7,0,2,1,3,-2,-16,-3,-2,-5,7,-2,0,-4,-1,-1,-1,1,5,-1
KR_6652022828,420,-3,10,-14,0,0,1,1,0,4,4,-1,4,3,1,3,4,0,1,1,2,5,-5,0,-5,5,2,0,0,-1,1,0,1,6,-1
KR_6748082342,420,0,-34,15,0,-1,2,1,1,0,1,3,1,4,-4,6,2,1,0,1,0,1,3,-2,-7,9,8,0,0,-1,-1,0,1,5,-1
KR_6761397364,420,-4,-13,-4,-6,-3,3,0,-4,5,1,-3,4,1,0,2,2,4,1,5,0,-7,-64,-1,-4,5,1,0,-1,1,1,-1,-1,3,-1
KR_6761911039,420,0,-53,33,-8,-4,4,0,2,1,3,3,4,7,-8,9,1,-1,4,3,-2,-7,-2,-1,-2,3,-1,0,0,-1,1,-1,1,4,-1
KR_6738327792,420,-4,-60,11,-4,0,0,0,-2,6,4,0,1,1,-3,5,2,1,1,2,0,-2,-71,-1,-3,4,-25,0,-1,1,-1,-1,-1,2,-1
KR_6692327284,420,-4,23,-1,-4,-2,3,1,-4,7,3,-1,4,3,3,2,5,0,1,1,0,3,46,4,-8,4,-27,0,0,1,-1,1,-1,2,-1
KR_6685823334,420,0,-12,16,-4,-1,2,1,-3,4,1,-1,3,2,3,1,4,-2,2,0,0,-3,0,-2,-2,4,1,0,0,0,1,0,-1,0,-1
KR_6692003229,420,2,-40,13,2,4,2,6,-6,7,1,-4,4,0,5,1,6,3,1,4,0,9,99,-2,-5,7,1,0,-3,1,-1,-1,-1,3,-1
KR_6686406652,420,-2,-45,-4,-9,-3,4,1,-7,8,1,1,3,4,-2,3,1,2,1,3,0,-9,0,-3,-3,6,5,0,0,-1,1,0,1,2,-1
KR_6726868647,420,-4,-52,-20,-13,2,0,2,-7,10,3,-2,2,0,-7,7,0,1,1,2,0,-23,-9,-2,-6,8,-3,0,-1,-1,1,-1,-1,5,-1
KR_6756901407,420,4,-33,20,12,3,0,3,1,3,4,2,2,4,5,0,5,1,1,2,0,11,-50,-3,-5,8,27,0,1,-1,1,1,1,5,-1
KR_6733041100,420,-5,-98,-13,-10,0,1,1,-1,3,2,-1,4,3,-7,7,0,-1,1,0,0,-20,10,0,-4,4,-4,0,-2,-1,-1,-1,1,5,-1
KR_6646026249,420,0,10,18,-3,-2,4,2,-1,3,2,3,0,3,-3,3,0,0,1,1,0,2,-9,-5,-1,6,1,0,-1,1,1,-1,-1,2,-1
KR_6760448665,420,2,5,8,-2,2,0,2,-1,3,2,0,2,2,-3,4,1,0,0,0,-1,0,118,0,-6,6,-2,0,0,-1,-1,-1,-1,1,-1
KR_6654208256,420,-3,-51,-32,-9,-4,4,0,-2,6,4,-1,3,2,-4,6,2,2,1,3,0,-9,-4,-2,-4,6,0,0,-1,-1,-1,-1,1,6,-1
KR_6752401145,440,-2,-81,-6,-4,-2,2,0,-1,4,3,3,2,5,0,0,0,-4,6,2,1,3,-11,3,-5,2,-3,0,0,-1,-1,0,1,2,-1
KR_6697573759,420,-6,-53,-28,-10,5,1,6,-8,8,0,-4,4,0,-3,3,0,0,0,0,-2,-16,-1,-2,-3,5,-3,0,-1,-1,1,-1,-1,4,-1
KR_6732700476,440,1,-3,-3,7,-10,11,1,1,2,3,6,1,7,9,2,11,1,0,1,0,5,-2,-1,0,1,0,0,0,1,0,1,-1,1,-1
KR_6753772983,420,2,79,46,0,2,1,3,-3,4,1,-1,1,0,5,1,6,-3,3,0,0,1,-7,-1,-4,5,2,0,1,1,1,1,1,1,-1
KR_6758183996,420,-1,-3,-16,2,0,1,1,-3,3,0,0,2,2,3,1,4,2,1,3,0,4,-14,0,-5,5,-1,0,-1,1,1,-1,1,2,-1
KR_6712941103,420,-6,-55,-32,-14,-1,2,1,-4,6,2,-3,5,2,-3,5,2,-3,4,1,0,-12,-116,3,-7,4,-6,0,-3,-1,-1,-1,-1,5,-1
KR_6752699097,420,0,-43,8,1,0,1,1,-1,3,2,-1,2,1,3,1,4,0,0,0,-1,6,123,-1,-6,7,2,0,0,1,-1,-1,-1,2,-1
KR_6734996057,440,-3,-25,-24,-5,3,0,3,-1,3,2,-2,3,1,-5,6,1,0,2,2,0,-13,-1,-1,-3,4,-4,0,-1,-1,1,-1,-1,6,-1
KR_6750558143,420,1,15,1,0,1,2,3,-8,9,1,3,2,5,1,2,3,3,0,3,0,0,-2,-5,-4,9,-5,0,0,-1,0,0,-1,2,-1
KR_6740158147,440,-1,-11,-6,-5,0,2,2,6,1,7,-3,3,0,-4,4,0,-4,5,1,-1,-6,-17,-1,-4,5,0,0,0,-1,-1,0,-1,3,-1
KR_6761706715,420,-4,-38,-27,-9,-7,7,0,2,1,3,1,4,5,-3,6,3,-2,2,0,0,-9,-10,-10,-2,12,5,0,-1,-1,0,-1,1,4,-1
KR_6757340045,420,-6,-94,-36,-19,-7,8,1,-3,4,1,-3,5,2,-4,5,1,-2,2,0,-1,-17,22,1,-6,5,-6,0,-3,-1,-1,-1,-1,4,-1
KR_6758123592,420,-4,0,-3,-11,-5,5,0,1,0,1,-4,4,0,-2,5,3,-1,2,1,0,-4,13,1,-4,3,0,0,-1,-1,-1,-1,-1,4,-1
KR_6763065097,420,-1,-3,-13,4,4,0,4,-1,3,2,3,1,4,-1,1,0,-1,3,2,0,-2,-3,0,-4,4,0,0,1,-1,1,1,1,1,-1
KR_6691081094,420,-3,-82,-45,-4,1,1,2,-3,7,4,-1,1,0,-1,4,3,0,1,1,0,3,-7,-3,-5,8,-1,0,0,-1,-1,-1,1,3,-1
KR_6758911772,420,2,37,-15,6,2,1,3,4,0,4,1,2,3,-1,2,1,0,1,1,1,8,99,4,-5,1,-5,0,1,-1,1,1,1,1,-1
KR_6757164701,420,2,40,-11,4,2,1,3,1,2,3,1,1,2,0,6,6,0,1,1,0,2,-12,5,-7,2,-2,0,2,1,1,1,-1,2,-1
KR_6602496157,420,-7,-62,-68,-11,-3,3,0,-1,3,2,-8,8,0,1,0,1,0,0,0,0,-10,-41,-3,-3,6,-1,0,-1,-1,-1,-1,1,1,-1
KR_6709867796,420,1,-39,-5,1,-1,2,1,4,0,4,-2,3,1,1,3,4,-1,1,0,0,9,-5,-1,-5,6,-7,0,1,-1,1,1,-1,5,-1
KR_6741263848,420,0,9,-32,-1,-1,3,2,-1,4,3,4,0,4,-6,8,2,3,0,3,1,-4,4,8,-11,3,-3,0,-1,1,-1,-1,1,3,-1
KR_6757890920,440,-2,-79,-30,-3,0,2,2,-2,5,3,-1,1,0,1,2,3,-1,1,0,0,0,3,0,-9,9,-1,0,0,-1,1,-1,-1,4,-1
KR_6697799916,420,-6,13,-35,-5,-1,1,0,-2,5,3,-4,6,2,2,1,3,0,0,0,0,-1,-1,3,-5,2,2,0,-1,-1,-1,-1,1,2,-1
KR_6593633210,420,-4,-47,-27,-5,-1,3,2,-4,5,1,2,2,4,-2,3,1,0,1,1,-1,-9,-35,-1,-5,6,5,0,-1,-1,-1,-1,-1,3,-1
KR_6760845406,420,2,79,18,-1,5,0,5,-5,7,2,1,0,1,3,1,4,-5,5,0,0,-16,-1,1,-4,3,3,0,2,-1,1,1,1,2,-1
KR_6693643114,420,-3,23,-23,-5,4,1,5,-3,5,2,-1,3,2,0,1,1,-5,5,0,0,-2,-30,-3,-2,5,-2,0,-2,-1,-1,-1,-1,4,-1
KR_6759363556,420,-2,-44,-5,-2,3,1,4,1,1,2,-2,3,1,-4,5,1,0,4,4,0,0,17,-1,-4,5,0,0,1,-1,1,-1,1,6,-1
KR_6763555409,440,0,6,17,-1,-6,6,0,-1,1,0,2,2,4,4,1,5,0,0,0,1,1,1,1,-4,3,1,0,0,1,-1,0,1,5,-1
KR_6700857548,420,-5,-15,-15,-11,1,2,3,-3,5,2,-2,5,3,-6,6,0,-1,1,0,0,-11,-34,5,-9,4,-4,0,-2,0,0,-1,1,0,-1
KR_6748895412,420,0,4,-12,4,-2,2,0,-1,4,3,4,1,5,2,6,8,1,2,3,3,12,16,2,-7,5,-2,0,1,1,-1,-1,1,6,-1
KR_6719763730,420,-4,-103,15,-8,-4,5,1,2,1,3,-5,8,3,0,1,1,-1,2,1,0,-6,-43,-2,-6,8,-2,0,-1,1,1,-1,-1,2,-1
KR_6761687356,420,0,-3,-14,-1,1,3,4,1,0,1,-3,5,2,0,3,3,0,0,0,0,-6,11,-6,-1,7,1,0,1,-1,1,1,1,1,-1
KR_6734168651,420,3,34,-4,0,1,1,2,0,5,5,1,3,4,-2,2,0,0,1,1,0,-3,-5,-6,-5,11,11,0,0,-1,-1,0,-1,6,-1
KR_6647625244,440,-3,-35,-24,-5,-1,1,0,-3,4,1,1,2,3,-1,6,5,-1,2,1,-1,-8,-8,-2,-6,8,1,0,0,-1,1,0,-1,2,-1
KR_6761065949,420,5,19,-11,2,4,1,5,-4,5,1,4,0,4,-1,3,2,-1,2,1,0,-4,3,-3,-2,5,2,0,0,1,-1,1,-1,4,-1
KR_6602558956,420,-3,-29,-17,-7,-1,3,2,-6,6,0,-2,3,1,2,4,6,0,0,0,0,-7,45,1,-6,5,-24,0,0,-1,-1,-1,1,6,-1
KR_6651221254,420,0,-8,1,-5,3,1,4,-2,5,3,-3,6,3,-3,3,0,0,0,0,0,-10,-6,-1,-3,4,1,0,0,-1,1,1,-1,5,-1
KR_6745667383,420,-1,-57,11,-14,-4,4,0,0,4,4,-7,8,1,-2,2,0,-1,1,0,0,-8,-21,-1,-3,4,2,0,-1,-1,-1,-1,-1,2,-1
KR_6726299934,420,1,-10,8,1,-1,1,0,1,1,2,1,2,3,-1,2,1,1,1,2,0,-1,3,-1,-5,6,-4,0,-1,-1,-1,-1,-1,6,-1
KR_6675006619,420,-3,-51,-21,-9,-3,3,0,-4,8,4,-5,5,0,1,0,1,2,0,2,0,-2,1,2,-8,6,0,0,-1,0,-1,-1,1,0,-1
KR_6738308548,420,-2,-4,7,-5,3,0,3,-1,3,2,-2,4,2,-3,3,0,-2,4,2,0,-7,-13,-5,-8,13,1,0,0,1,1,1,-1,2,-1
KR_6696042223,420,-3,-56,-10,-7,-8,10,2,2,2,4,1,2,3,-3,3,0,1,0,1,0,-12,-5,-6,-3,9,-2,0,-1,-1,-1,-1,1,6,-1
KR_6555857907,420,0,35,-19,-2,6,0,6,-7,9,2,3,0,3,-2,4,2,-2,2,0,0,-6,-3,1,-5,4,-3,0,-1,-1,-1,-1,-1,2,-1
KR_6743696280,420,0,42,-6,-2,0,2,2,-3,6,3,4,0,4,-3,3,0,0,1,1,0,4,-1,0,-5,5,1,0,1,-1,-1,1,-1,3,-1
KR_6680885988,420,-2,-37,-22,-7,-2,3,1,5,1,6,0,4,4,-4,7,3,-6,8,2,-1,-4,135,4,-5,1,2,0,-1,-1,1,-1,-1,1,-1
KR_6717320517,440,-4,48,25,-6,-5,5,0,2,3,5,1,5,6,-1,7,6,-3,4,1,0,-14,6,-9,-2,11,-4,0,1,-1,0,1,1,5,-1
KR_6757700476,440,0,-40,7,0,-1,2,1,-2,4,2,3,4,7,-2,2,0,2,2,4,0,1,4,0,-4,4,-2,0,-1,-1,1,-1,-1,3,-1
KR_6726692841,420,-2,-53,7,-3,0,0,0,0,2,2,-3,4,1,-1,2,1,1,1,2,0,-1,225,-2,-4,6,-3,0,0,-1,1,-1,-1,6,-1
KR_6763676836,420,-1,-54,-22,-6,-4,4,0,0,3,3,-4,5,1,1,2,3,1,0,1,0,-6,-28,-2,-4,6,0,0,0,-1,-1,0,-1,6,-1
KR_6725484143,420,0,36,8,-2,0,1,1,0,2,2,1,2,3,-3,6,3,0,0,0,0,-5,0,-1,-4,5,0,0,0,1,0,0,1,6,-1
KR_6713208027,420,-3,-15,10,-4,3,1,4,-6,8,2,-2,5,3,1,2,3,0,0,0,0,1,10,-2,-4,6,-3,0,-1,1,-1,-1,-1,4,-1
KR_6732862984,420,0,-14,9,4,-1,2,1,0,1,1,-2,3,1,7,0,7,0,0,0,0,16,9,5,-9,4,-4,0,1,1,1,1,-1,6,-1
KR_6760929201,420,-2,-72,-8,-7,0,1,1,-2,3,1,-1,3,2,-4,5,1,0,1,1,0,-4,-23,-3,-4,7,1,0,-2,1,-1,-1,1,6,-1
KR_6738081394,420,0,44,11,1,-1,1,0,-2,2,0,2,3,5,2,2,4,0,0,0,0,6,7,-4,-2,6,4,0,-1,-1,1,-1,-1,5,-1
KR_6760923171,420,-1,-33,-12,-2,1,1,2,-3,4,1,1,1,2,-1,1,0,0,0,0,0,0,7,0,-6,6,1,0,0,-1,1,0,1,5,-1
KR_6748544599,420,4,-31,41,7,3,1,4,7,1,8,2,0,2,-6,6,0,1,1,2,0,7,-4,1,-7,6,-3,0,0,-1,1,1,1,5,-1
KR_6751184635,420,-3,-14,24,-7,0,1,1,2,1,3,-6,7,1,-4,5,1,1,0,1,0,-10,13,-7,-1,8,-3,0,-1,-1,-1,-1,-1,3,-1
KR_6732027522,420,-1,23,-14,-11,1,1,2,-4,4,0,-2,4,2,-8,9,1,2,0,2,0,-15,18,-6,-1,7,2,0,-2,-1,-1,-1,-1,3,-1
KR_6707783329,420,-4,-43,-4,-12,1,1,2,-6,8,2,-4,4,0,-3,6,3,0,0,0,0,-13,-14,0,-4,4,5,0,-2,-1,-1,-1,-1,5,-1
KR_6728702362,420,-1,-16,4,-4,-4,5,1,-1,3,2,0,2,2,2,1,3,-1,2,1,0,-3,40,-4,-3,7,-4,0,-1,-1,-1,-1,-1,6,-1
KR_6638188143,420,-1,-2,9,-6,-1,4,3,-1,1,0,1,1,2,-5,5,0,0,1,1,0,-11,24,-2,-3,5,1,0,-1,-1,1,1,1,3,-1
KR_6764952256,420,-1,-83,-9,-1,-2,2,0,-2,4,2,2,1,3,2,5,7,-1,1,0,1,2,5,4,-7,3,-4,0,0,1,1,0,1,6,-1
KR_6640973621,440,-2,-50,-14,-6,1,0,1,-6,6,0,-4,4,0,2,0,2,1,2,3,0,-8,-10,1,-5,4,3,0,0,1,-1,1,-1,6,-1
KR_6759752051,420,-2,-9,-36,-7,2,1,3,-3,6,3,3,3,6,-6,6,0,-3,3,0,1,-9,-8,1,-4,3,2,0,-1,-1,-1,-1,1,4,-1
KR_6761067282,440,-2,-30,8,-8,-2,5,3,-2,2,0,-2,4,2,-1,4,3,-1,1,0,0,-2,2,1,-6,5,1,0,0,-1,1,-1,-1,2,-1
KR_6607376441,420,-5,5,-3,-5,-4,5,1,-1,3,2,-1,6,5,3,1,4,-2,2,0,0,-4,-6,0,-5,5,-1,0,-2,-1,-1,-1,-1,2,-1
KR_6764923053,440,-3,-7,8,2,0,3,3,4,0,4,2,0,2,-1,2,1,-3,4,1,1,3,-1,2,-6,4,-4,0,0,1,1,0,1,3,-1
KR_6759237737,420,-6,-90,8,-11,-7,9,2,-4,5,1,0,2,2,-3,3,0,3,1,4,0,-5,-10,-5,-1,6,2,0,-3,1,-1,-1,-1,2,-1
KR_6752193811,420,-3,-162,-6,-14,2,1,3,2,0,2,0,2,2,-16,16,0,-2,3,1,-2,-11,-5,0,-4,4,-1,0,-2,-1,-1,-1,-1,1,-1
KR_6687562634,420,-2,-16,-16,-6,0,2,2,-2,4,2,-2,2,0,-3,3,0,1,1,2,0,-10,12,1,-7,6,-7,0,0,-1,-1,0,-1,2,-1
KR_6637271435,440,-5,-24,9,-18,-4,5,1,-3,3,0,-7,13,6,-2,4,2,-2,2,0,0,-19,-2,-4,-2,6,1,0,-1,1,-1,-1,1,6,-1
KR_6728199500,440,-4,-78,-32,-6,-1,1,0,0,2,2,-3,3,0,-2,4,2,0,0,0,0,-2,-40,-1,-8,9,-4,0,-2,1,-1,-1,-1,4,-1
KR_6536751853,420,1,37,12,-10,0,1,1,-2,5,3,-1,3,2,-1,4,3,-6,7,1,0,-10,-4,-2,-2,4,1,0,-2,1,1,-1,1,1,-1
KR_6736727931,420,3,24,-14,5,1,0,1,0,9,9,0,2,2,4,0,4,0,0,0,0,2,197,-1,-5,6,1,0,1,-1,1,1,1,3,-1
KR_6508903179,420,3,6,-24,3,1,1,2,2,5,7,1,1,2,-2,3,1,1,1,2,0,12,39,-1,-8,9,-1,0,0,1,-1,0,1,4,-1
KR_6747509170,420,0,36,-39,-3,-5,5,0,-1,3,2,-2,2,0,6,2,8,-1,1,0,0,14,0,4,-10,6,10,0,0,1,-1,-1,-1,1,-1
KR_6766252110,420,2,105,2,2,-1,3,2,-4,7,3,1,2,3,6,0,6,0,0,0,-1,-3,3,2,-5,3,-2,0,0,-1,-1,-1,-1,2,-1
KR_6740164084,440,-1,-18,-16,-1,5,0,5,0,2,2,-3,8,5,1,2,3,-4,4,0,-1,-13,-4,1,-4,3,1,0,1,-1,1,1,-1,2,-1
KR_6731736323,420,-2,-37,-25,-11,-1,2,1,-5,6,1,-2,2,0,-2,2,0,-1,1,0,0,-13,-20,-9,-2,11,8,0,-1,-1,-1,-1,-1,3,-1
KR_6758748924,420,1,-54,-11,1,0,4,4,-2,3,1,4,1,5,0,2,2,-1,3,2,0,-2,-6,-1,-5,6,9,0,0,-1,1,0,1,1,-1
KR_6720254840,420,1,9,-40,8,3,2,5,-1,4,3,5,0,5,0,2,2,1,0,1,0,13,1,0,-5,5,4,0,0,-1,1,0,-1,5,-1
KR_6697470213,420,3,-1,-12,4,4,0,4,-1,4,3,0,1,1,2,2,4,-1,1,0,0,4,-2,-1,-4,5,0,0,0,-1,1,1,1,6,-1
KR_6732993622,440,-1,-17,-21,-3,-2,3,1,2,3,5,-1,3,2,-3,3,0,1,0,1,0,-8,4,5,-10,5,-2,0,-1,1,-1,-1,-1,2,-1
KR_6762547927,440,-3,2,-18,-7,1,0,1,-4,7,3,-1,2,1,0,0,0,-3,6,3,-1,-16,-3,8,-11,3,3,0,-1,-1,-1,-1,-1,6,-1
KR_6750470259,420,-3,-36,-16,2,3,0,3,-4,4,0,2,1,3,0,6,6,1,0,1,0,1,-2,1,-4,3,0,0,0,1,1,0,1,5,-1
KR_6753580615,440,-1,-8,20,-1,3,0,3,-3,3,0,-6,8,2,1,2,3,4,0,4,0,7,21,-3,-1,4,-4,0,0,0,-1,1,-1,0,-1
KR_6650428478,420,3,52,-2,3,1,1,2,1,1,2,3,0,3,-3,4,1,1,0,1,0,3,8,1,-6,5,1,0,-2,-1,-1,-1,-1,4,-1
KR_6593604263,420,-2,-7,24,-9,0,2,2,1,3,4,-4,5,1,-4,5,1,-2,2,0,0,-10,-5,-8,-1,9,-4,0,-2,-1,-1,-1,-1,3,-1
KR_6764620509,420,0,-32,-21,-3,-5,5,0,1,4,5,-1,1,0,3,0,3,-1,2,1,0,0,-202,-7,-1,8,0,0,0,-1,-1,1,-1,1,-1
KR_6756156582,440,-4,-96,16,-12,1,2,3,1,0,1,-1,3,2,-12,13,1,-1,3,2,0,-7,9,-1,-4,5,-2,0,0,0,0,-1,-1,0,-1
KR_6625134011,420,1,6,-29,1,0,2,2,0,2,2,0,1,1,0,1,1,1,0,1,0,3,0,-1,-3,4,1,0,0,1,0,0,-1,3,-1
KR_6719599767,440,-2,-126,-37,1,0,0,0,2,1,3,-2,5,3,-1,4,3,2,1,3,0,9,-3,5,-11,6,3,0,0,-1,-1,0,-1,5,-1
KR_6765506291,420,-1,53,-21,4,1,2,3,0,2,2,3,3,6,0,2,2,0,1,1,0,0,-4,-1,-2,3,0,0,0,-1,-1,1,1,2,-1
KR_6758837669,420,-3,37,-33,-5,-1,4,3,4,3,7,-7,8,1,-1,2,1,0,0,0,1,-7,6,1,-5,4,6,0,0,-1,-1,0,1,3,-1
KR_6758113180,420,-3,-33,8,-11,-4,4,0,-1,3,2,-1,3,2,3,4,7,-8,8,0,0,-7,-18,4,-8,4,-2,0,-1,1,-1,-1,-1,3,-1
KR_6753729860,420,-2,-1,-8,-3,-1,2,1,4,4,8,-2,2,0,-5,5,0,1,0,1,-1,-3,-3,-5,-1,6,3,0,-1,-1,1,-1,1,6,-1
KR_6625287994,420,0,66,1,-2,2,2,4,-2,2,0,-3,3,0,-4,8,4,5,0,5,0,1,3,4,-8,4,1,0,0,1,-1,0,1,1,-1
KR_6745239147,420,-4,-56,-2,-14,2,0,2,-6,6,0,-2,4,2,-4,5,1,-4,4,0,0,-12,143,-3,-2,5,1,0,-3,1,-1,-1,-1,3,-1
KR_6764243976,420,-3,48,-34,-6,0,3,3,0,4,4,-6,8,2,1,0,1,-1,1,0,2,-12,6,2,-6,4,3,0,1,-1,-1,1,1,5,-1
KR_6738433748,420,-5,-65,-8,-10,3,1,4,-4,7,3,-1,2,1,-8,8,0,0,1,1,0,-19,-5,-2,-4,6,1,0,-1,-1,1,1,1,2,-1
KR_6766032329,420,-2,22,0,-7,-1,3,2,-2,2,0,-2,2,0,-2,2,0,0,0,0,0,-11,-14,-3,-2,5,0,0,0,0,-1,0,1,0,-1
KR_6758024918,420,2,33,34,5,-5,6,1,3,2,5,3,1,4,2,0,2,2,1,3,-2,8,5,3,-7,4,-3,0,-1,-1,-1,-1,-1,6,-1
KR_6757708111,420,5,36,20,10,2,2,4,4,3,7,-2,2,0,3,1,4,3,0,3,1,14,27,3,-6,3,-1,0,1,1,-1,1,1,3,-1
KR_6760326197,420,-4,-128,-10,-9,-1,2,1,-3,5,2,0,1,1,-4,4,0,-1,1,0,0,-2,4,-1,-5,6,-3,0,-1,1,-1,-1,-1,4,-1
KR_6607446381,420,-1,32,-19,-1,-2,3,1,-2,5,3,4,0,4,-3,5,2,2,0,2,0,2,-16,1,-6,5,2,0,1,-1,1,1,-1,5,-1
KR_6756844482,420,0,-1,-26,3,-1,1,0,4,4,8,-1,1,0,4,1,5,-3,5,2,0,5,2,4,-6,2,-1,0,2,1,-1,1,-1,4,-1
KR_6712979887,420,1,-48,-3,-1,-1,1,0,1,2,3,-1,3,2,-1,4,3,1,0,1,-1,12,40,5,-9,4,-32,0,1,1,-1,1,-1,3,-1
KR_6765702817,420,-3,-39,0,-9,-2,3,1,0,4,4,-1,3,2,-5,7,2,-1,1,0,0,1,-10,-2,-4,6,-1,0,-1,-1,-1,-1,-1,2,-1
KR_6671692327,420,-4,-36,-8,-2,-5,6,1,-7,9,2,8,1,9,5,1,6,-3,4,1,0,4,-6,1,-6,5,-2,0,0,1,-1,0,-1,3,-1
KR_6753959229,420,-3,-65,-19,-9,1,1,2,-3,4,1,-6,6,0,0,1,1,-1,2,1,0,-8,-6,4,-5,1,-1,0,0,-1,-1,-1,-1,6,-1
KR_6740354171,420,1,-46,0,1,2,2,4,1,3,4,-1,2,1,0,2,2,-1,2,1,0,0,-47,-3,-2,5,27,0,0,-1,-1,0,-1,6,-1
KR_6758973260,420,2,25,8,-4,4,2,6,1,1,2,-3,3,0,-5,5,0,-1,2,1,0,-12,5,-1,-4,5,-2,0,-1,1,-1,-1,1,1,-1
KR_6762704947,420,-2,-11,-13,-2,2,1,3,1,2,3,-6,6,0,0,5,5,1,0,1,0,6,-101,-3,-2,5,-1,0,0,1,-1,1,-1,1,-1
KR_6747701052,420,-6,-28,-45,-8,2,3,5,-4,5,1,0,2,2,-1,3,2,-5,5,0,1,-10,6,0,-5,5,-2,0,-1,-1,-1,-1,1,5,-1
KR_6345718606,420,-4,-49,-41,-6,-3,4,1,-1,5,4,-5,5,0,3,2,5,0,1,1,0,4,0,-3,-4,7,5,0,-2,-1,-1,1,-1,3,-1
KR_6758970868,420,-4,-6,-22,-14,3,1,4,-2,4,2,-4,7,3,-9,9,0,-2,3,1,-2,-26,9,2,-4,2,-1,0,-1,-1,-1,-1,-1,5,-1
KR_6762174089,440,-2,-41,14,-4,-2,3,1,-10,10,0,2,1,3,3,1,4,3,2,5,0,1,6,-2,-5,7,-4,0,-2,-1,0,-1,1,2,-1
KR_6258702828,420,2,-50,-41,4,-1,3,2,5,2,7,-4,4,0,1,2,3,3,0,3,0,6,4,-1,-4,5,0,0,1,-1,1,1,-1,3,-1
KR_6757402443,440,0,-34,-17,-1,1,1,2,5,0,5,0,2,2,-9,10,1,2,2,4,0,-1,8,5,-7,2,-2,0,1,-1,0,1,-1,3,-1
KR_6748590640,420,0,-25,-17,3,-2,3,1,-1,5,4,7,0,7,-1,1,0,0,0,0,0,7,-114,-4,-4,8,3,0,0,1,1,0,1,6,-1
KR_6753969216,420,-2,-17,-4,-6,1,2,3,-1,3,2,-2,3,1,-4,4,0,0,0,0,0,-8,-2,-2,-5,7,-1,0,-1,-1,1,-1,-1,4,-1
KR_6765800292,420,4,47,2,7,3,1,4,5,1,6,-5,6,1,3,2,5,1,2,3,0,8,-14,0,-2,2,2,0,0,1,1,0,1,3,-1
KR_6754976817,420,-2,-12,23,-2,-1,3,2,-3,3,0,2,0,2,-1,1,0,1,1,2,0,-6,-3,-1,-6,7,2,0,0,-1,1,0,-1,4,-1
KR_6686384136,420,-7,-111,-56,-10,-7,7,0,-2,5,3,1,2,3,0,2,2,-2,3,1,-1,-16,-26,-3,-2,5,2,0,-1,-1,-1,-1,-1,1,-1
KR_6704353601,420,-2,-72,-20,-4,-5,8,3,2,1,3,0,0,0,0,3,3,-1,1,0,0,-2,7,1,-5,4,-4,0,0,1,-1,-1,-1,1,-1
KR_6757280941,420,2,11,12,1,-1,2,1,1,2,3,0,5,5,4,0,4,-3,3,0,-1,5,1,-1,-5,6,5,0,1,-1,-1,1,1,5,-1
KR_6756963080,440,0,50,-16,-9,-1,1,0,-3,5,2,-1,3,2,-3,4,1,-1,1,0,0,-14,101,1,-4,3,-1,0,0,-1,0,0,-1,1,-1
KR_6732973059,420,-8,-106,-12,-15,-1,2,1,-7,8,1,-1,3,2,-1,2,1,-5,5,0,-1,-5,49,-1,-1,2,-8,0,-2,-1,-1,-1,-1,6,-1
KR_6706538518,440,-6,-104,-20,-8,-4,4,0,-1,2,1,0,6,6,-2,2,0,-1,5,4,0,2,-136,3,-3,0,-3,-1,-3,0,-1,-1,-1,0,-1
KR_6764017628,420,-8,-122,-12,3,-1,1,0,2,0,2,2,1,3,1,3,4,-1,1,0,0,0,37,5,-8,3,-41,0,-2,-1,1,-1,-1,6,-1
KR_6553915223,420,-1,27,-12,-2,-2,2,0,1,1,2,-3,4,1,1,2,3,1,0,1,0,-2,-8,-3,-5,8,1,0,0,-1,-1,1,-1,2,-1
KR_6760428875,420,0,-13,-6,5,1,1,2,1,2,3,0,1,1,3,0,3,0,0,0,0,6,313,1,-3,2,-2,0,0,-1,1,0,1,2,-1
KR_6765279887,420,-2,14,12,2,1,1,2,0,1,1,1,2,3,1,4,5,-1,2,1,0,2,-1,-1,-2,3,3,0,0,1,-1,0,-1,2,-1
KR_6761603560,420,0,-15,-5,3,-1,2,1,6,3,9,-1,5,4,-1,1,0,0,0,0,0,-1,-9,0,-4,4,2,0,0,-1,1,0,-1,1,-1
KR_6762446983,420,-1,-71,15,-3,-2,2,0,1,1,2,-5,6,1,1,3,4,2,0,2,-1,-3,5,-5,-2,7,-1,0,-1,-1,-1,-1,-1,3,-1
KR_6692003762,420,-5,-24,-24,-9,-1,3,2,-1,5,4,-3,4,1,-1,4,3,-3,3,0,0,-16,-114,4,-7,3,-2,0,-1,1,-1,-1,-1,2,-1
KR_6758505754,420,1,49,1,0,-2,3,1,-1,3,2,0,2,2,3,1,4,0,1,1,-1,5,-16,-3,-2,5,3,0,0,-1,1,0,-1,3,-1
KR_6710194220,420,-5,-163,20,-16,-8,8,0,-3,6,3,-4,5,1,-5,5,0,4,0,4,0,3,18,-3,-2,5,1,0,-2,-1,1,-1,1,4,-1
KR_6690429905,420,-2,-58,2,-9,-1,3,2,-1,4,3,-2,6,4,-4,4,0,-1,3,2,-2,-10,-4,3,-6,3,-3,0,-2,-1,1,-1,-1,4,-1
KR_6757495243,420,-2,51,-12,-4,0,0,0,-3,4,1,-1,2,1,2,2,4,-2,3,1,0,0,27,-1,-5,6,-12,0,1,-1,-1,1,1,5,-1
KR_6714696911,420,1,-10,33,1,2,1,3,0,3,3,0,2,2,0,0,0,-1,1,0,0,1,-9,-4,-5,9,0,0,0,1,1,1,1,6,-1
KR_6592380678,420,0,10,7,-4,-4,8,4,-1,3,2,0,1,1,1,4,5,0,1,1,0,-8,-5,-4,-2,6,-2,0,0,-1,0,0,-1,6,-1
KR_6727514497,420,-5,-33,-8,-12,-1,2,1,-5,5,0,-4,5,1,-1,4,3,-1,2,1,-1,-15,2,-4,-2,6,1,0,-1,-1,-1,-1,-1,2,-1
KR_6758817199,420,1,-3,-1,1,1,1,2,-4,4,0,0,2,2,4,1,5,0,0,0,0,-3,2,1,-7,6,0,0,-1,1,-1,-1,1,2,-1
KR_6752244830,420,-3,-47,-25,-10,3,1,4,-3,3,0,-1,2,1,-6,7,1,-3,3,0,0,-13,-8,-6,-4,10,-5,0,-1,-1,-1,-1,-1,4,-1
KR_6591739830,420,-3,-75,-10,-9,0,1,1,-7,8,1,0,3,3,-1,2,1,-1,1,0,0,-4,-3,-1,-4,5,0,0,0,0,-1,-1,1,0,-1
KR_6698538411,420,-10,-107,-58,-14,-2,2,0,-1,1,0,-3,3,0,-5,7,2,-3,3,0,0,-17,-5,0,-6,6,1,-1,-6,-1,-1,-1,-1,6,-1
KR_6652353064,420,-2,3,-13,-10,-3,4,1,0,3,3,-3,4,1,-5,7,2,1,2,3,0,-2,-2,1,-5,4,-5,0,0,-1,1,0,-1,6,-1
KR_6726985577,420,-2,-51,5,-1,-2,2,0,-1,3,2,-2,3,1,5,1,6,-1,4,3,0,2,-24,-7,-3,10,15,0,0,-1,1,1,1,5,-1
KR_6679304650,420,-3,-37,-18,-5,-3,5,2,1,1,2,-4,4,0,4,2,6,-3,3,0,0,-1,7,3,-7,4,-2,0,0,-1,1,0,-1,4,-1
KR_6737126973,420,-2,-45,9,-5,-2,2,0,-2,3,1,3,2,5,-5,6,1,1,2,3,0,-4,-23,-2,-4,6,5,0,-2,-1,-1,-1,-1,4,-1
KR_6704716047,420,2,10,-4,0,-2,4,2,5,2,7,-1,4,3,0,4,4,-2,3,1,-1,10,2,5,-9,4,0,0,0,-1,1,0,-1,5,-1
KR_6746701334,420,0,-21,3,-3,2,1,3,0,5,5,-1,3,2,-4,5,1,0,1,1,0,-1,0,0,-4,4,3,0,0,-1,1,0,-1,3,-1
KR_6711404461,420,0,19,0,1,3,2,5,1,2,3,-1,1,0,-3,4,1,1,0,1,0,-5,2,1,-5,4,-2,0,1,-1,1,1,1,3,-1
KR_6677099535,420,0,59,4,-1,0,1,1,-2,3,1,-2,2,0,2,3,5,1,1,2,0,4,-14,1,-4,3,1,0,0,0,1,0,-1,0,-1
KR_6760611373,420,-2,-17,-29,-3,2,1,3,-4,6,2,2,0,2,-3,5,2,0,6,6,0,-2,-1,0,-4,4,-4,0,0,-1,0,0,1,3,-1
KR_6764897380,420,-4,-52,-26,-6,1,1,2,-3,4,1,-5,6,1,0,1,1,1,0,1,0,-10,-4,0,-6,6,6,0,-1,1,-1,-1,1,5,-1
KR_6700474482,420,-4,-79,11,-9,1,2,3,-7,9,2,2,5,7,0,3,3,-5,6,1,-1,-24,-14,-10,0,10,3,0,-1,-1,1,-1,-1,2,-1
KR_6761095318,420,-3,-42,-10,0,4,1,5,-3,5,2,-3,4,1,0,3,3,2,0,2,3,7,19,2,-7,5,0,0,0,-1,1,0,1,3,-1
KR_6745495562,420,-3,1,-20,-6,2,0,2,-6,6,0,0,4,4,-1,1,0,-1,3,2,0,-5,8,2,-7,5,-1,0,0,1,-1,-1,1,5,-1
KR_6700080740,420,-1,-34,8,-5,0,1,1,-1,4,3,-5,6,1,2,1,3,-1,2,1,0,-3,176,-7,-4,11,-2,0,1,1,1,1,-1,5,-1
KR_6752815510,440,-2,-67,32,-12,3,2,5,-1,3,2,-2,2,0,-9,9,0,-3,3,0,0,-23,7,1,-3,2,-1,0,0,-1,1,-1,-1,3,-1
KR_6630450419,420,0,4,-29,-7,0,2,2,-1,4,3,-1,3,2,-4,4,0,-1,2,1,-1,-13,-12,-7,-2,9,5,0,0,-1,-1,-1,-1,5,-1
KR_6757163041,420,-1,50,6,-6,-1,3,2,1,1,2,-2,2,0,2,1,3,-6,7,1,0,-2,4,0,-5,5,-1,0,0,1,-1,0,1,3,-1
KR_6758167786,420,1,3,17,-3,0,2,2,0,2,2,-3,3,0,0,2,2,0,0,0,0,-8,10,-5,-3,8,3,0,1,-1,1,1,-1,4,-1
KR_6654560798,420,-6,-113,-41,-13,-5,5,0,-1,4,3,-2,3,1,-2,5,3,-3,3,0,-1,-9,-321,2,-5,3,-1,0,-1,-1,-1,-1,-1,1,-1
KR_6743362788,420,1,16,36,0,2,1,3,0,5,5,2,2,4,-1,3,2,-3,3,0,-1,1,-15,-3,-3,6,1,0,0,1,1,0,-1,3,-1
KR_6645490398,420,-1,12,-32,-7,-4,5,1,-2,3,1,2,0,2,2,1,3,-5,6,1,0,-5,2,-4,0,4,2,0,-1,1,-1,-1,-1,5,-1
KR_6711967746,420,2,33,-9,-2,2,2,4,2,3,5,1,2,3,-5,7,2,-2,3,1,-1,-6,5,1,-5,4,-4,0,-1,1,-1,1,-1,5,-1
KR_6734300442,420,-4,-95,-47,4,0,4,4,4,0,4,0,1,1,-2,4,2,2,2,4,2,1,-109,-2,-2,4,1,0,0,1,1,-1,1,3,-1
KR_6757162034,420,-4,-58,11,-15,0,1,1,-9,9,0,-5,6,1,-1,5,4,0,0,0,0,-8,-268,3,-5,2,-5,0,-2,-1,1,-1,1,1,-1
KR_6760577535,420,-6,-49,8,-13,3,3,6,-8,8,0,-2,5,3,-5,7,2,-1,1,0,0,-21,-5,-3,-4,7,-2,0,-1,-1,0,-1,-1,6,-1
KR_6692393640,420,-5,-62,-17,-13,-3,4,1,-4,5,1,-7,8,1,-4,7,3,5,0,5,-3,-33,-7,-3,-4,7,2,0,-1,-1,1,-1,-1,5,-1
KR_6703565444,420,3,-6,28,-1,2,1,3,-5,5,0,-3,3,0,3,4,7,2,1,3,0,-2,-8,3,-8,5,0,0,1,-1,1,1,1,3,-1
KR_6752179512,440,0,33,5,-1,-2,3,1,-1,3,2,6,2,8,-3,3,0,-1,1,0,0,-6,-4,-7,-1,8,-3,0,-1,-1,-1,-1,-1,2,-1
KR_6744457936,420,-1,-20,0,-1,3,1,4,-1,6,5,0,2,2,-4,8,4,1,1,2,0,-5,1,-4,-3,7,0,0,0,-1,1,-1,1,5,-1
KR_6706199905,420,0,-39,-2,3,-3,5,2,0,2,2,7,2,9,-5,6,1,4,3,7,1,9,2,0,-5,5,-2,0,0,-1,1,0,1,5,-1
KR_6732524841,420,1,-18,19,-1,-1,1,0,0,5,5,-3,4,1,2,0,2,1,0,1,0,-6,-2,-3,-5,8,1,0,0,1,-1,0,-1,5,-1
KR_6595282950,420,-2,-59,24,-5,-2,2,0,-3,8,5,2,1,3,-2,3,1,0,0,0,-2,-9,-9,-7,-7,14,3,0,0,1,-1,-1,1,5,-1
KR_6747012992,420,-1,19,24,-6,-1,1,0,-2,2,0,-2,4,2,-2,2,0,1,2,3,0,-6,1,-2,-2,4,-1,0,1,1,-1,1,1,3,-1
KR_6726820017,420,-1,-20,-19,1,-1,2,1,3,3,6,-4,4,0,1,1,2,2,1,3,1,4,-8,-2,-7,9,2,0,-1,-1,-1,-1,1,6,-1
KR_6759688025,420,0,3,24,-3,0,1,1,1,1,2,-4,5,1,-2,4,2,2,0,2,0,-3,1,1,-8,7,-5,0,0,-1,-1,0,-1,2,-1
KR_6760988353,420,-1,59,3,-1,0,2,2,-3,6,3,1,0,1,2,2,4,-1,2,1,0,-3,-122,4,-6,2,-2,0,0,-1,1,1,1,1,-1
KR_6684166181,420,-5,-69,-12,-10,-1,2,1,-5,8,3,-1,2,1,-3,7,4,0,0,0,1,-2,4,5,-9,4,-7,0,-1,1,1,-1,1,2,-1
KR_6762580526,420,0,-22,-8,3,-2,2,0,5,1,6,-2,5,3,0,3,3,2,1,3,0,2,-3,2,-7,5,-7,0,1,0,1,1,1,0,-1
KR_6699831644,420,-5,11,-12,-16,-3,4,1,1,1,2,-8,8,0,-3,4,1,-3,4,1,0,-24,-2,3,-6,3,-2,0,0,-1,-1,-1,-1,1,-1
KR_6760150073,420,-3,-23,15,-2,-3,5,2,0,3,3,-1,1,0,3,0,3,-1,1,0,0,3,37,1,-3,2,-19,0,-2,-1,-1,-1,-1,1,-1
KR_6743891085,420,6,34,0,9,1,0,1,5,3,8,0,2,2,2,2,4,1,2,3,0,13,133,4,-9,5,2,0,1,1,0,1,-1,2,-1
KR_6677668651,440,-1,-89,16,-1,-1,4,3,3,2,5,-2,3,1,0,5,5,-1,1,0,0,5,-41,4,-8,4,24,0,-4,-1,1,-1,-1,1,-1
KR_6752003354,420,-1,-44,4,-10,-3,4,1,-5,6,1,-1,1,0,-1,3,2,0,2,2,0,-4,1,0,-4,4,1,0,-1,-1,-1,-1,-1,1,-1
KR_6752442644,420,-2,5,4,-1,1,3,4,-1,2,1,1,5,6,-2,4,2,0,2,2,0,1,14,0,-4,4,0,0,0,1,-1,1,1,6,-1
KR_6730450765,420,-4,-14,13,-15,-1,1,0,-4,5,1,-5,6,1,-5,6,1,0,1,1,-2,-22,13,1,-8,7,-5,0,0,0,-1,0,-1,0,-1
KR_6629626558,420,-5,-75,22,-8,-5,7,2,2,3,5,-1,2,1,-4,6,2,0,0,0,0,0,-4,-1,-6,7,2,0,-3,-1,-1,-1,-1,2,-1
KR_6748573196,420,2,2,12,3,2,0,2,4,0,4,-1,2,1,-1,3,2,-1,2,1,0,0,128,-1,-8,9,3,0,1,1,1,1,1,4,-1
KR_6741294138,420,-5,-21,-20,-5,0,1,1,-2,3,1,0,2,2,-2,2,0,-1,2,1,0,-9,-37,0,-5,5,28,0,-1,1,0,-1,1,4,-1
KR_6759618583,420,0,-5,8,1,1,0,1,1,3,4,0,1,1,-2,5,3,1,1,2,0,2,-2,-1,-4,5,2,0,0,1,-1,0,1,5,-1
KR_6567115080,420,-3,-72,-29,-6,1,1,2,0,2,2,0,1,1,-4,4,0,-3,3,0,0,-5,36,1,-7,6,-22,0,-1,-1,-1,-1,1,2,-1
KR_6692431080,420,-2,-53,-20,-1,-2,2,0,1,0,1,1,1,2,1,3,4,-2,4,2,-1,2,4,3,-8,5,0,0,0,1,-1,1,-1,1,-1
KR_6715788730,420,-1,-28,-38,-4,-3,3,0,1,4,5,1,0,1,-2,3,1,-1,1,0,0,1,0,4,-8,4,-5,0,-2,1,-1,-1,-1,3,-1
KR_6694593718,420,-4,-62,14,-1,-2,3,1,-3,4,1,5,1,6,-1,1,0,0,1,1,-1,-7,-5,0,-4,4,-3,0,-1,-1,1,-1,-1,5,-1
KR_6735877483,420,-2,51,-20,-1,-2,2,0,1,3,4,1,0,1,-1,2,1,0,0,0,0,5,32,-1,-4,5,-33,0,0,1,-1,0,1,3,-1
KR_6746741787,420,-2,-64,-26,-8,-2,3,1,-2,2,0,-7,8,1,-1,3,2,4,0,4,-2,-12,-12,1,-6,5,-2,0,0,-1,0,0,-1,6,-1
KR_6760909305,420,-1,-4,-18,-3,1,2,3,-4,7,3,-1,2,1,2,2,4,-1,1,0,0,4,0,-2,-6,8,-5,0,-1,-1,-1,-1,1,6,-1
KR_6749360240,420,-4,-60,-17,-6,0,3,3,-7,9,2,1,2,3,-1,4,3,1,1,2,2,-3,-11,3,-10,7,-9,0,-1,0,-1,-1,1,0,-1
KR_6746297093,420,-4,-24,-16,-5,-3,3,0,2,0,2,0,2,2,-4,6,2,0,2,2,0,-4,18,0,-3,3,-2,0,0,-1,-1,0,-1,5,-1
KR_6727011274,440,-3,-25,-3,-8,0,1,1,-3,6,3,-5,6,1,-1,2,1,1,1,2,0,-4,-13,-4,-4,8,2,0,-2,1,-1,-1,-1,3,-1
KR_6757818827,420,-1,-50,20,-3,-7,7,0,4,1,5,0,1,1,-2,5,3,2,0,2,0,2,14,0,-7,7,3,0,-1,-1,1,-1,1,6,-1
KR_6661262449,420,4,-60,12,6,-1,3,2,5,1,6,6,0,6,-5,6,1,1,0,1,0,18,-41,1,-8,7,19,0,0,1,-1,-1,-1,6,-1
KR_6736868277,420,-2,-57,7,-5,6,2,8,-4,6,2,-2,4,2,-5,5,0,0,0,0,-3,-13,-118,-1,-9,10,-3,0,0,1,1,-1,-1,3,-1
KR_6619761570,420,-2,-45,-40,5,4,0,4,-1,2,1,2,2,4,-1,2,1,1,2,3,0,7,-3,-4,-7,11,3,0,0,0,0,0,-1,0,-1
KR_6766179339,420,-6,-101,-35,-20,-3,3,0,-4,5,1,-2,2,0,-8,9,1,-3,3,0,0,-18,-41,-5,-2,7,-1,0,-1,-1,-1,-1,-1,3,-1
KR_6762535313,420,-2,22,-12,-7,-3,5,2,-6,9,3,0,3,3,1,4,5,1,0,1,0,-8,-9,-1,-4,5,3,0,1,-1,-1,1,1,3,-1
KR_6756690017,440,-1,-48,12,1,0,1,1,1,0,1,0,3,3,-1,3,2,1,2,3,0,3,27,-2,-4,6,6,0,-1,-1,-1,-1,-1,2,-1
KR_6691357338,420,-1,-83,26,-8,-1,3,2,4,0,4,-6,8,2,-4,6,2,-1,2,1,-3,-10,8,-7,-5,12,-6,0,-3,-1,-1,-1,-1,4,-1
KR_6757505802,420,0,-35,-7,-1,1,0,1,1,1,2,-2,4,2,-1,3,2,0,1,1,1,2,-19,-2,-5,7,9,0,-1,-1,1,-1,1,3,-1
KR_6694483043,420,2,-70,20,1,-2,4,2,1,2,3,4,0,4,-2,5,3,0,1,1,0,4,9,1,-7,6,3,0,-1,-1,1,-1,-1,6,-1
KR_6708948214,420,-4,-62,11,-5,-1,2,1,-2,5,3,3,1,4,-4,4,0,-1,1,0,0,-8,-10,-3,-4,7,-4,0,-1,-1,1,-1,-1,3,-1
KR_6765095293,420,-5,-43,-12,-15,-4,4,0,-1,4,3,-2,4,2,-9,9,0,1,2,3,0,-12,-7,-2,-2,4,1,0,-1,-1,1,-1,-1,1,-1
KR_6753342377,420,-1,26,-9,-3,2,2,4,0,3,3,-1,4,3,-1,2,1,-3,4,1,0,-2,266,-4,-5,9,6,0,-1,-1,-1,-1,1,1,-1
KR_6759112189,420,-1,23,-16,-1,-1,3,2,1,2,3,-3,3,0,3,1,4,-1,3,2,0,-6,-13,5,-7,2,4,0,1,1,-1,1,1,2,-1
KR_6728992446,440,-5,-70,4,-7,-3,7,4,2,1,3,0,1,1,-6,6,0,0,0,0,0,1,101,0,-5,5,-5,0,-1,-1,-1,-1,-1,2,-1
KR_6670693845,440,-2,12,-25,0,-1,2,1,-3,4,1,0,2,2,4,3,7,0,2,2,0,-3,-3,3,-7,4,-1,0,-1,-1,0,-1,1,3,-1
KR_6715297925,440,3,50,16,2,0,4,4,-1,3,2,4,0,4,0,2,2,-1,3,2,0,0,-15,1,-4,3,-3,0,3,1,1,1,1,1,-1
KR_6761789936,420,-6,-63,-29,-8,-2,2,0,0,3,3,0,3,3,-4,4,0,-2,4,2,0,-8,7,-2,-6,8,-3,0,0,-1,0,-1,-1,1,-1
KR_6748293395,420,0,-34,1,2,4,0,4,-1,1,0,0,2,2,-3,3,0,2,0,2,0,-2,-1,1,-3,2,-4,0,0,-1,1,1,1,5,-1
KR_6702582964,420,-3,-12,14,-12,3,1,4,-3,5,2,-3,7,4,-6,6,0,-3,3,0,0,-18,18,-4,-3,7,2,0,1,-1,1,-1,-1,6,-1
KR_6508481554,420,-6,-75,-28,-17,-3,5,2,-4,6,2,-6,6,0,-2,2,0,-2,2,0,0,-21,-1,-5,-1,6,-5,0,-2,-1,-1,-1,-1,6,-1
KR_6747796813,420,2,12,25,6,0,1,1,1,1,2,-1,3,2,3,3,6,3,0,3,1,12,5,3,-8,5,-1,0,0,1,1,1,1,5,-1
KR_6761722130,420,-2,-91,-4,-12,-7,7,0,-2,2,0,-1,3,2,2,3,5,-4,5,1,0,0,2,3,-7,4,1,0,-2,1,-1,-1,-1,6,-1
KR_6758086224,420,-1,-31,8,-6,4,1,5,-4,5,1,0,0,0,-6,6,0,0,1,1,1,-10,1,2,-7,5,-3,0,0,-1,1,1,1,2,-1
KR_6655528357,440,-1,-12,-30,-7,1,1,2,-5,7,2,-1,2,1,-1,2,1,-1,2,1,-1,-15,-20,4,-7,3,1,0,-1,-1,1,-1,-1,6,-1
KR_6744466723,420,2,-22,-16,2,-3,3,0,1,2,3,1,1,2,3,3,6,0,2,2,0,-2,-246,0,-2,2,-1,0,0,-1,1,0,1,3,-1
KR_6731861185,440,-2,-104,-4,-4,-2,3,1,3,0,3,-3,4,1,-3,6,3,1,0,1,0,3,-70,2,-4,2,-1,0,-1,1,-1,-1,-1,5,-1
KR_6670786138,420,-3,-54,-16,0,-1,2,1,-1,4,3,1,0,1,1,4,5,0,3,3,0,-6,27,3,-11,8,-5,0,0,1,-1,-1,1,2,-1
KR_6763785037,420,-3,-34,-4,-2,-1,3,2,-1,2,1,-1,1,0,0,6,6,1,1,2,1,2,-56,1,-4,3,29,0,-2,-1,-1,-1,1,2,-1
KR_6757460231,420,-1,-6,-20,0,2,0,2,1,1,2,0,0,0,-5,7,2,2,0,2,0,-3,-56,0,-7,7,-3,0,-1,-1,1,1,-1,1,-1
KR_6763799581,440,-2,18,8,-3,1,0,1,-5,7,2,-2,4,2,2,2,4,1,0,1,0,-11,-8,-2,-4,6,-6,0,0,1,-1,1,1,6,-1
KR_6733287025,420,-5,13,-29,-14,-5,5,0,-4,6,2,1,4,5,-3,6,3,-3,3,0,0,-16,-5,6,-6,0,6,0,-1,1,-1,-1,1,2,-1
KR_6766079284,420,-4,-28,-5,-10,-2,2,0,0,2,2,-6,6,0,-1,3,2,-1,1,0,-1,-6,-8,-4,-2,6,-2,0,-1,-1,-1,-1,-1,2,-1
KR_6760003956,440,-2,19,-32,-7,-2,2,0,-1,2,1,-3,4,1,-1,5,4,0,1,1,0,-8,3,-6,0,6,0,0,2,1,1,1,-1,3,-1
KR_6764181485,420,0,-27,20,-1,3,2,5,-3,4,1,4,2,6,-5,6,1,0,2,2,0,-9,18,-2,-3,5,1,0,0,1,1,1,1,4,-1
KR_6677894043,420,-2,-50,14,-2,1,1,2,-1,2,1,1,1,2,-2,2,0,-1,1,0,0,-9,17,2,-7,5,-6,0,0,0,1,0,-1,0,-1
KR_6764042503,420,1,-13,-4,4,2,1,3,-4,5,1,0,3,3,4,1,5,2,1,3,0,4,47,4,-9,5,-4,0,0,1,-1,0,1,6,-1
KR_6661319198,420,-3,-76,-11,-8,-7,8,1,-3,5,2,4,1,5,-3,3,0,1,1,2,0,-4,35,1,-5,4,-6,0,-1,-1,-1,-1,-1,5,-1
KR_6736287410,440,-3,-3,-31,-1,0,1,1,1,0,1,0,6,6,1,0,1,-3,3,0,0,-10,81,-1,-2,3,-2,0,0,-1,-1,0,1,6,-1
KR_6754704702,420,0,-22,-4,-4,2,2,4,0,6,6,0,3,3,-4,5,1,-2,2,0,0,-4,3,0,-5,5,0,0,-1,-1,1,-1,-1,4,-1
KR_6720936402,420,-4,-110,-32,-4,-2,2,0,-6,6,0,2,1,3,3,3,6,-1,2,1,-1,-11,26,-3,-4,7,-21,0,-1,-1,1,-1,-1,6,-1
KR_6761993457,420,-3,14,-5,-6,-1,2,1,-1,2,1,-3,4,1,-2,3,1,1,0,1,-1,-6,129,-3,-5,8,4,0,0,-1,1,1,-1,4,-1
KR_6707575722,420,2,5,1,5,1,1,2,3,1,4,3,0,3,0,2,2,-2,3,1,0,5,-3,-1,-6,7,-3,0,0,1,-1,-1,1,2,-1
KR_6742548768,440,-3,-38,-25,-6,-3,5,2,0,3,3,1,1,2,-4,4,0,0,1,1,0,-8,10,-3,0,3,-3,0,0,0,-1,0,-1,0,-1
KR_6740561681,420,-7,-87,-19,-20,-7,7,0,-6,6,0,-3,3,0,-4,5,1,0,0,0,-4,-16,-6,-1,-3,4,-1,0,-2,-1,-1,-1,-1,4,-1
KR_6764009017,420,-2,-54,-9,-7,0,2,2,0,2,2,-5,6,1,0,4,4,-2,3,1,0,-5,114,-5,-4,9,1,0,-2,1,-1,-1,-1,5,-1
KR_6765438997,420,-3,-49,0,-4,3,1,4,-1,4,3,-7,7,0,1,2,3,0,1,1,0,0,-6,-3,-2,5,2,0,-1,0,-1,-1,-1,0,-1
KR_6726985659,440,-3,16,-8,-8,-2,4,2,0,4,4,1,1,2,-2,7,5,-5,5,0,0,-8,0,-3,-1,4,0,0,-1,-1,-1,-1,-1,1,-1
KR_6763189231,420,-2,-13,0,-6,-1,1,0,0,1,1,0,2,2,-5,7,2,0,0,0,-1,-7,-30,-3,-4,7,6,0,0,1,-1,0,-1,1,-1
KR_6762319212,420,-1,24,-26,-5,-2,2,0,-1,4,3,-8,12,4,4,4,8,2,0,2,-3,1,-10,-2,-6,8,-5,0,-1,-1,-1,-1,1,4,-1
KR_6687685374,420,1,59,-3,-1,0,1,1,0,2,2,0,1,1,-1,2,1,0,0,0,0,-1,-4,2,-8,6,2,0,0,1,-1,0,-1,6,-1
KR_6760930237,420,2,-10,-12,1,1,1,2,0,1,1,2,2,4,0,5,5,-2,2,0,0,13,-3,1,-5,4,-5,0,0,1,0,0,-1,5,-1
KR_6720549802,440,-5,-43,0,-11,0,3,3,-4,5,1,-2,4,2,-1,6,5,-4,4,0,0,-13,1,-1,-4,5,1,0,-1,-1,-1,-1,-1,5,-1
KR_6742983574,440,-4,-111,-4,-12,-5,8,3,6,2,8,-4,4,0,-1,1,0,-8,8,0,0,-13,-1,1,-3,2,-4,0,-2,-1,-1,-1,-1,1,-1
KR_6716852048,420,-2,-24,32,-11,1,3,4,-4,6,2,-6,8,2,-1,4,3,-1,2,1,-2,-15,-3,-2,-1,3,2,0,-2,-1,-1,-1,-1,4,-1
KR_6667157885,440,-3,-21,3,-9,-4,4,0,-5,6,1,0,2,2,-5,6,1,5,0,5,0,-13,8,2,-9,7,-5,0,0,0,-1,0,-1,0,-1
KR_6752601284,420,3,11,1,4,0,1,1,3,1,4,-1,2,1,-1,5,4,3,0,3,0,8,6,3,-7,4,-1,0,0,-1,1,0,-1,6,-1
KR_6758243969,420,-2,-38,-9,3,-3,3,0,-2,4,2,2,0,2,5,0,5,1,1,2,0,13,-5,3,-4,1,1,0,0,0,-1,0,1,0,-1
KR_6752194224,440,-4,-39,-56,-11,3,0,3,-8,10,2,-2,2,0,-2,4,2,-2,2,0,0,-6,131,-4,-3,7,0,0,-2,-1,-1,-1,-1,2,-1
KR_6756776167,420,-3,-76,9,-7,0,0,0,-3,6,3,-2,4,2,0,1,1,-2,2,0,-1,-10,-16,1,-4,3,-6,0,-1,0,-1,-1,-1,0,-1
KR_6740322703,420,-1,-31,-10,-3,0,0,0,1,2,3,-1,2,1,-4,8,4,1,0,1,0,-5,-1,-4,-5,9,1,0,-1,-1,1,-1,1,6,-1
KR_6516742423,420,2,-52,28,1,0,1,1,-1,3,2,-2,3,1,4,1,5,0,0,0,0,-6,-11,-1,-7,8,-2,0,-1,-1,1,-1,-1,5,-1
KR_6554016022,420,-1,-46,-13,1,0,0,0,-1,4,3,1,2,3,1,3,4,0,0,0,0,-5,51,10,-15,5,-8,0,0,-1,1,0,1,2,-1
KR_6680335539,420,1,18,1,-3,2,3,5,2,2,4,-2,2,0,-4,5,1,-1,2,1,-1,-7,-3,0,-8,8,-3,0,0,-1,1,-1,-1,3,-1
KR_6765983895,420,0,-32,-10,0,-1,2,1,1,0,1,1,1,2,-3,4,1,2,2,4,0,10,-260,1,-6,5,0,0,0,-1,0,-1,-1,4,-1
KR_6728113657,420,0,39,-12,-3,0,4,4,-2,4,2,-3,6,3,2,4,6,0,0,0,3,-7,-25,9,-9,0,1,0,1,-1,1,1,1,2,-1
KR_6764644542,420,-2,-49,2,-12,-1,2,1,-5,5,0,1,2,3,-5,6,1,-2,2,0,-1,-19,19,4,-6,2,2,0,-1,-1,1,-1,-1,4,-1
KR_6757092568,420,-1,16,8,-4,0,1,1,-4,4,0,1,2,3,-2,4,2,1,0,1,0,-3,8,6,-11,5,-1,0,0,0,-1,0,1,0,-1
KR_6757749021,420,-5,-106,-25,-2,-4,5,1,0,2,2,2,1,3,-2,3,1,2,1,3,0,-3,50,2,-4,2,1,0,-1,1,-1,-1,-1,2,-1
KR_6631463244,420,-6,-128,-43,-9,-2,2,0,-3,3,0,-4,4,0,-1,3,2,1,0,1,0,-11,-6,1,-6,5,3,0,-1,-1,-1,-1,-1,6,-1
KR_6764056880,420,-1,1,36,-6,-1,2,1,-2,4,2,-5,7,2,3,0,3,-1,1,0,0,-5,-1,-2,-4,6,-1,0,0,1,-1,1,-1,2,-1
KR_6683661419,420,-5,18,-12,-5,-3,5,2,0,2,2,-3,3,0,1,4,5,0,1,1,0,-3,-3,-2,-3,5,-2,0,0,1,1,1,1,6,-1
KR_6759378843,420,-2,38,7,-7,-1,1,0,1,3,4,1,2,3,-2,4,2,-6,7,1,0,-6,116,3,-6,3,-4,0,0,-1,-1,0,1,3,-1
KR_6762647988,420,1,-69,20,2,2,1,3,0,5,5,0,2,2,2,1,3,-2,2,0,0,-3,16,-1,-5,6,2,0,0,-1,1,1,-1,5,-1
KR_6763658892,420,2,-55,-8,5,1,1,2,2,0,2,7,1,8,-3,3,0,-2,2,0,0,3,-7,3,-7,4,1,0,1,-1,1,1,-1,1,-1
KR_6747969538,420,0,0,7,0,2,1,3,0,1,1,0,5,5,-1,6,5,-1,1,0,0,0,-3,1,-9,8,3,0,0,-1,1,1,1,2,-1
KR_6745438612,420,3,56,17,5,5,0,5,2,1,3,0,3,3,2,1,3,-4,4,0,1,8,4,3,-9,6,-6,0,1,-1,-1,1,1,6,-1
KR_6746265547,440,-3,31,22,-15,-1,3,2,-8,8,0,-1,4,3,-4,5,1,-1,3,2,-2,-27,4,-2,-1,3,0,0,0,-1,-1,-1,-1,5,-1
KR_6657996506,420,1,26,16,5,-1,3,2,4,3,7,3,0,3,-2,4,2,1,2,3,0,1,8,5,-7,2,-5,0,0,0,-1,-1,1,0,-1
KR_6683821771,440,-1,28,8,0,-1,2,1,5,3,8,0,5,5,0,2,2,-4,4,0,0,-7,10,0,-5,5,6,0,0,-1,1,1,1,1,-1
KR_6746270858,420,0,-89,-12,1,-1,1,0,-1,6,5,-1,1,0,4,0,4,0,0,0,0,3,11,2,-8,6,0,0,-1,1,-1,-1,1,1,-1
KR_6691795120,420,0,6,6,-1,1,2,3,3,1,4,-5,6,1,-1,2,1,1,0,1,0,1,-13,-1,-4,5,2,0,0,1,0,0,-1,5,-1
KR_6749093611,420,3,-2,8,8,1,0,1,0,3,3,4,3,7,3,0,3,0,2,2,0,5,-2,0,-3,3,0,0,1,1,1,1,-1,6,-1
KR_6765887239,420,-3,-31,-7,-5,-6,6,0,-5,6,1,0,1,1,0,1,1,6,0,6,0,1,118,-3,-3,6,6,0,0,1,-1,-1,-1,1,-1
KR_6631397698,420,0,41,-28,0,0,2,2,1,2,3,-2,2,0,-1,3,2,2,0,2,0,-3,18,-1,-6,7,-2,0,0,-1,-1,-1,-1,5,-1
KR_6046231693,420,0,34,-39,1,1,0,1,0,3,3,2,0,2,-2,4,2,0,1,1,0,-1,-35,7,-11,4,2,0,0,-1,-1,-1,1,3,-1
KR_6703353795,440,-6,-21,-22,-6,2,1,3,-1,1,0,1,1,2,-7,7,0,-1,1,0,0,-12,2,3,-5,2,2,0,-1,0,1,-1,1,0,-1
KR_6765183987,420,-2,-62,11,-8,-1,2,1,-4,5,1,-3,3,0,4,1,5,-4,4,0,0,-6,-128,-3,-4,7,-1,0,-1,-1,1,-1,-1,4,-1
KR_6757103797,440,0,16,2,-5,2,1,3,0,3,3,-2,3,1,-7,12,5,2,1,3,2,3,-2,1,-4,3,-5,0,0,-1,1,1,1,6,-1
KR_6763518331,420,-2,-12,4,-7,1,1,2,-1,1,0,-2,5,3,-2,3,1,-3,5,2,-2,-11,8,-5,-3,8,-5,0,0,-1,1,0,-1,5,-1
KR_6753290436,440,-2,13,-24,-5,6,0,6,-2,4,2,-5,5,0,-2,4,2,-2,3,1,0,-8,18,1,-5,4,0,0,-1,-1,-1,-1,-1,3,-1
KR_6752311809,420,-3,-60,24,-12,-1,3,2,-3,7,4,0,3,3,-7,9,2,-1,1,0,-4,-14,-283,3,-10,7,2,0,0,-1,-1,-1,-1,6,-1
KR_6750311274,420,2,76,-26,6,1,1,2,6,0,6,1,3,4,-2,2,0,0,0,0,0,5,2,0,-6,6,1,0,0,-1,-1,0,-1,5,-1
KR_6722682497,440,-3,-43,-20,-7,-5,6,1,0,3,3,1,0,1,-1,6,5,-2,7,5,0,-6,22,3,-8,5,3,0,-1,1,-1,-1,-1,1,-1
KR_6754519967,420,0,-13,-23,-2,-1,1,0,5,1,6,1,0,1,-3,6,3,-4,6,2,0,-2,11,0,-6,6,-2,0,-1,1,-1,-1,-1,5,-1
KR_6755817975,440,-4,-54,8,-9,-1,3,2,0,0,0,-2,4,2,-3,3,0,-3,3,0,0,-14,4,1,-2,1,-4,0,0,0,0,-1,-1,0,-1
KR_6691663027,420,0,10,41,-2,0,0,0,5,1,6,-4,5,1,-2,2,0,-1,4,3,0,-5,39,-5,-4,9,-3,0,0,1,1,0,1,1,-1
KR_6763696502,420,1,14,-1,2,4,0,4,1,2,3,3,3,6,-4,4,0,-2,2,0,0,-8,-9,-1,-4,5,-2,0,-2,-1,1,-1,-1,2,-1
KR_6761069268,440,0,46,-24,0,2,2,4,0,4,4,-5,7,2,3,0,3,0,3,3,0,-3,-2,-1,-3,4,-3,0,0,-1,-1,-1,1,1,-1
KR_6543229077,420,-1,51,-28,-14,-1,3,2,-3,5,2,-8,8,0,-1,4,3,-1,3,2,1,-16,-8,1,-5,4,-2,0,-2,-1,-1,-1,1,1,-1
KR_6713336842,420,-3,-57,-5,-8,-5,5,0,1,1,2,-1,1,0,-3,4,1,0,2,2,0,-5,-13,-1,-5,6,3,0,-1,-1,-1,-1,-1,1,-1
KR_6703596357,420,-3,-51,16,-6,-3,4,1,0,1,1,-3,3,0,0,0,0,0,0,0,0,-4,-1,0,-4,4,-4,0,0,-1,1,0,-1,2,-1
KR_6757037602,420,-1,8,2,8,1,2,3,6,3,9,0,3,3,1,4,5,0,3,3,1,15,5,9,-11,2,-7,0,-1,1,1,-1,1,1,-1
KR_6750865542,420,-7,-86,4,-15,-4,7,3,-5,6,1,-3,4,1,-2,2,0,-1,1,0,-1,-11,3,1,-5,4,-8,0,-2,-1,1,-1,-1,2,-1
KR_6753623235,440,-2,25,-25,-4,5,0,5,-2,3,1,-1,2,1,0,6,6,-6,7,1,2,-3,-12,-2,-4,6,4,0,1,-1,-1,-1,1,4,-1
KR_6507764305,420,-3,-33,-10,-2,3,3,6,-1,4,3,1,1,2,-1,3,2,-4,5,1,0,-2,12,2,-5,3,-1,0,-2,-1,-1,-1,-1,1,-1
KR_6758360256,420,-3,-102,-20,1,-5,8,3,-2,5,3,4,1,5,5,1,6,-1,1,0,0,-3,0,-2,-2,4,-5,0,-2,1,1,-1,-1,6,-1
KR_6696574821,440,-1,47,-8,1,4,0,4,-5,5,0,-2,2,0,4,0,4,0,2,2,0,-2,3,-2,-5,7,2,0,1,1,-1,1,1,6,-1
KR_6758290403,420,-3,-32,4,-7,-2,3,1,-3,4,1,2,2,4,-3,4,1,-1,1,0,0,1,-6,-2,-6,8,-2,0,-1,-1,1,-1,-1,2,-1
KR_6638899295,420,-4,-12,-47,-10,-4,4,0,6,0,6,-4,5,1,-5,6,1,-3,3,0,-2,-6,34,3,-5,2,-4,0,-2,-1,1,-1,-1,6,-1
KR_6581243200,420,-2,2,-28,-4,1,0,1,-2,3,1,0,2,2,-3,6,3,0,1,1,0,-6,-1,-5,-3,8,2,0,-1,-1,-1,-1,-1,3,-1
KR_6760538216,420,4,49,12,2,2,1,3,1,1,2,-1,3,2,1,3,4,-1,2,1,1,2,7,-1,-5,6,-5,0,3,1,1,1,1,6,-1
KR_6704411724,420,-2,-33,-47,-3,0,2,2,1,4,5,-4,5,1,-2,4,2,2,2,4,0,-2,3,1,-8,7,-1,0,0,1,-1,-1,1,1,-1
KR_6617926851,420,-1,-29,-35,-1,-4,4,0,5,0,5,-3,4,1,1,4,5,0,0,0,0,12,4,2,-4,2,4,0,-1,1,-1,-1,-1,2,-1
KR_6693537622,420,-3,-75,12,-6,-7,8,1,-2,7,5,0,1,1,2,4,6,1,1,2,0,4,15,4,-11,7,-5,0,-2,1,-1,-1,-1,3,-1
KR_6720590696,440,-4,-86,-4,-6,0,3,3,0,2,2,-1,4,3,-2,4,2,-3,3,0,-1,-2,-5,-4,-3,7,3,0,-2,-1,-1,-1,-1,3,-1
KR_6720661077,420,0,-5,13,-6,1,2,3,-1,2,1,-2,3,1,-2,4,2,-2,2,0,0,-1,-12,-3,-6,9,5,0,0,-1,-1,0,-1,2,-1
KR_6675039113,420,-4,-102,-25,-1,-2,2,0,0,2,2,-1,4,3,-1,3,2,3,0,3,0,-3,-1,-2,-4,6,-3,0,-1,-1,0,-1,1,1,-1
KR_6749679827,420,-2,-39,-24,0,0,5,5,-3,4,1,-1,2,1,4,3,7,0,0,0,0,1,-4,9,-10,1,-5,0,-1,-1,-1,-1,1,6,-1
KR_6743090731,440,0,-32,-28,2,4,0,4,-1,2,1,0,1,1,-3,3,0,2,2,4,0,-1,-3,3,-7,4,-2,0,-1,0,0,-1,1,0,-1
KR_6765344413,420,0,-45,-5,2,-8,10,2,4,1,5,-1,2,1,7,0,7,0,1,1,0,10,3,-1,-3,4,1,0,-2,1,-1,-1,1,4,-1
KR_6762363290,420,-2,106,-52,-7,3,0,3,-4,4,0,-4,5,1,-1,4,3,-1,4,3,0,-13,-19,2,-5,3,3,0,0,-1,-1,0,-1,3,-1
KR_6744336430,440,-1,-1,-32,-1,0,0,0,0,2,2,-6,8,2,5,4,9,0,2,2,0,5,5,-1,-5,6,3,0,1,0,-1,-1,1,0,-1
KR_6756306440,420,-1,3,16,1,1,2,3,0,3,3,-6,7,1,0,3,3,6,1,7,2,6,19,5,-8,3,-1,0,0,-1,-1,1,1,2,-1
KR_6765922558,420,-2,-22,9,-3,-1,1,0,6,1,7,-7,7,0,0,2,2,-1,1,0,0,0,0,-2,-3,5,0,0,0,0,1,-1,1,0,-1
KR_6700306894,420,-8,-78,-13,-4,2,3,5,-3,5,2,-2,4,2,-1,1,0,0,3,3,0,0,0,0,-3,3,-2,0,-2,-1,-1,-1,-1,5,-1
KR_6743336333,420,-1,11,-2,-6,-1,2,1,1,3,4,0,2,2,-3,4,1,-3,4,1,-1,-5,-6,1,-5,4,-2,0,-1,-1,-1,-1,-1,2,-1
KR_6730458790,420,-6,-49,-40,-14,-3,3,0,-2,4,2,-1,1,0,-4,5,1,-4,4,0,0,-10,-3,-1,-11,12,1,0,-1,-1,-1,-1,-1,3,-1
KR_6712156924,420,-5,-78,-38,-12,-4,5,1,-6,6,0,0,1,1,-2,2,0,0,0,0,-1,-9,-4,-3,-3,6,-5,0,-2,-1,-1,-1,-1,5,-1
KR_6728890297,420,-4,-49,-20,-5,-3,4,1,-3,4,1,-6,8,2,4,5,9,3,0,3,-1,-2,14,0,-4,4,0,0,1,-1,1,1,-1,6,-1
KR_6353009507,420,4,18,8,6,-4,5,1,0,2,2,4,1,5,5,1,6,1,2,3,0,9,0,0,0,0,0,0,-1,1,-1,1,1,3,-1
KR_6610492164,420,-1,29,-27,-1,-2,5,3,-2,4,2,1,0,1,4,0,4,-2,3,1,0,-3,-9,-3,-5,8,-4,0,0,-1,1,1,1,4,-1
KR_6528209667,420,-3,-24,-9,-5,-1,1,0,-3,6,3,-2,7,5,2,2,4,-1,1,0,0,4,2,0,-8,8,1,0,-1,-1,-1,-1,-1,3,-1
KR_6697296067,420,-2,6,-48,-3,-3,5,2,-4,11,7,-1,1,0,-2,2,0,7,2,9,-1,-6,-94,-7,0,7,-3,0,1,-1,-1,-1,-1,3,-1
KR_6756385623,420,-5,-49,11,-14,-3,3,0,1,1,2,-3,3,0,-9,10,1,0,1,1,-1,-22,4,-6,-3,9,-1,0,0,-1,1,-1,-1,1,-1
KR_6646456078,420,-2,-22,-4,-4,2,1,3,-4,4,0,-2,4,2,-1,2,1,1,0,1,0,-8,-9,2,-9,7,-3,0,-1,0,1,-1,1,0,-1
KR_6715855294,420,-1,-40,12,-2,1,1,2,3,1,4,-5,5,0,-3,4,1,2,1,3,0,-1,-9,-4,-3,7,-2,0,0,-1,1,0,-1,4,-1
KR_6756171054,420,0,-9,12,4,-2,4,2,-3,3,0,0,2,2,0,1,1,9,0,9,0,5,7,1,-5,4,-1,0,0,1,-1,-1,1,5,-1
KR_6758008821,420,-3,-36,-21,-2,0,2,2,-2,3,1,3,3,6,-2,2,0,-1,1,0,0,1,14,-1,-6,7,1,0,-1,-1,1,-1,-1,6,-1
KR_6748639615,420,-4,-76,-19,-14,-2,3,1,-4,6,2,-7,8,1,-1,1,0,0,0,0,0,-6,13,0,-5,5,-3,0,-2,0,-1,-1,-1,0,-1
KR_6764467687,420,-5,-60,-7,-4,1,0,1,-3,5,2,-2,3,1,1,0,1,-1,1,0,0,-8,5,2,-5,3,-6,0,0,-1,-1,0,-1,5,-1
KR_6747702802,420,-1,1,20,-5,1,3,4,2,1,3,-3,5,2,-3,5,2,-2,2,0,-1,-8,6,-1,-4,5,1,0,2,1,1,1,-1,5,-1
KR_6746111051,420,-1,-7,4,-5,3,2,5,4,0,4,-9,9,0,-1,2,1,-2,3,1,0,-8,1,2,-7,5,-5,0,-1,-1,-1,-1,-1,3,-1
KR_6758723067,440,0,15,34,-3,-1,1,0,-1,3,2,-2,4,2,2,6,8,-1,2,1,1,-9,-153,2,-5,3,0,0,0,1,1,1,1,2,-1
KR_6764866794,440,2,-20,0,9,2,2,4,6,1,7,0,5,5,-1,3,2,2,0,2,-1,8,7,3,-8,5,-3,0,1,1,1,1,-1,2,-1
KR_6764739509,420,0,23,4,2,0,3,3,5,2,7,-3,4,1,2,0,2,-2,3,1,1,4,-3,1,-6,5,-4,0,1,-1,1,1,1,6,-1
KR_6754092931,420,-1,-3,20,-4,2,0,2,-1,5,4,0,2,2,-3,6,3,-2,2,0,0,-11,-7,2,-6,4,0,0,0,1,-1,0,-1,6,-1
KR_6751713481,420,4,55,-9,5,0,4,4,1,6,7,0,1,1,0,1,1,4,0,4,-1,10,-11,2,-4,2,5,0,2,0,1,1,-1,0,-1
KR_6765176230,420,-2,-11,-8,-7,3,1,4,4,2,6,-9,9,0,-6,7,1,1,0,1,0,-5,6,-2,-5,7,-2,0,1,-1,1,-1,1,5,-1
KR_6669301162,420,-2,-42,-25,-3,-1,2,1,0,5,5,1,4,5,0,2,2,-3,3,0,0,-7,-14,-3,-4,7,0,0,0,-1,-1,0,1,6,-1
KR_6714231310,440,-3,-11,-16,-9,0,1,1,-2,4,2,-4,8,4,-1,3,2,-2,3,1,0,-3,-11,-1,-4,5,-1,0,-1,0,-1,-1,-1,0,-1
KR_6701312670,420,1,55,-5,-8,0,2,2,1,1,2,4,0,4,-11,11,0,-2,3,1,-2,-13,34,4,-6,2,-6,0,0,-1,-1,-1,-1,4,-1
KR_6766049826,420,-2,28,-17,-1,-4,5,1,-1,4,3,-1,2,1,2,2,4,3,0,3,-1,0,-5,-3,-5,8,4,0,-1,-1,1,-1,-1,2,-1
KR_6762933003,420,0,53,0,2,-1,2,1,2,2,4,-3,3,0,3,1,4,1,0,1,0,7,-13,-3,-4,7,3,0,0,-1,-1,-1,-1,3,-1
KR_6749166484,420,3,28,20,-4,2,0,2,2,2,4,-2,4,2,-6,6,0,0,1,1,0,-4,97,4,-8,4,2,0,1,-1,1,1,-1,4,-1
KR_6760005807,440,-4,3,-5,-14,3,0,3,1,4,5,-10,10,0,-5,6,1,-3,4,1,0,-12,2,-1,-3,4,0,0,0,-1,-1,1,-1,1,-1
KR_6508444771,420,-5,-41,-48,-7,-1,3,2,-3,3,0,-4,4,0,-2,4,2,3,2,5,-1,-12,11,0,-5,5,-3,0,-1,-1,-1,-1,-1,5,-1
KR_6754338364,420,-2,-29,7,-3,0,2,2,-4,7,3,-1,3,2,1,2,3,1,2,3,0,-1,-11,2,-6,4,3,0,0,1,1,0,-1,1,-1
KR_6764835430,420,0,-32,32,-2,-2,2,0,1,2,3,0,2,2,-3,3,0,2,0,2,0,1,3,0,-3,3,-7,0,0,1,1,0,-1,4,-1
KR_6733085312,420,-1,-47,7,7,-3,5,2,7,1,8,-4,4,0,0,3,3,7,0,7,1,9,1,-1,-3,4,3,0,-1,-1,-1,-1,1,5,-1
KR_6751966942,420,0,10,5,-5,0,1,1,-2,3,1,1,2,3,-1,1,0,-3,3,0,-1,-12,41,0,-5,5,-24,0,0,1,1,0,-1,5,-1
KR_6752011233,420,0,14,0,-6,1,1,2,4,1,5,-7,8,1,4,2,6,-8,9,1,1,-5,29,-1,-6,7,-3,0,0,-1,-1,-1,1,5,-1
KR_6757430444,420,-2,-53,-16,2,-3,4,1,0,3,3,2,1,3,2,1,3,1,0,1,0,5,-1,5,-7,2,1,0,-1,-1,1,-1,1,5,-1
KR_6761413644,440,-6,-92,-26,-17,-4,5,1,-2,3,1,-4,4,0,-5,9,4,-2,2,0,0,-12,10,-3,0,3,1,0,-2,-1,-1,-1,1,4,-1
KR_6734362978,420,0,12,-13,-5,1,5,6,5,3,8,-9,11,2,0,2,2,-2,4,2,-1,-9,-22,0,-7,7,0,0,1,-1,-1,-1,-1,4,-1
KR_6671982335,420,-1,-72,0,-3,-2,3,1,-3,3,0,-3,4,1,2,2,4,3,0,3,1,-5,-21,-3,-1,4,3,0,0,1,1,1,1,3,-1
KR_6762423354,420,-1,-16,-4,-3,0,3,3,0,1,1,-2,3,1,-1,2,1,0,0,0,1,-3,-6,-4,-3,7,-2,0,0,-1,1,0,1,1,-1
KR_6748054715,420,3,-7,8,2,4,0,4,-4,5,1,1,2,3,1,3,4,0,3,3,-1,-1,20,3,-6,3,2,0,0,1,0,1,-1,1,-1
KR_6700718629,420,2,-17,16,2,1,2,3,-3,3,0,0,3,3,2,0,2,2,0,2,0,-2,-5,-3,-4,7,-2,0,0,-1,-1,1,-1,1,-1
KR_6725403537,420,-1,-8,-24,-5,-1,3,2,0,3,3,-1,2,1,-3,3,0,0,1,1,0,1,134,0,-5,5,-1,0,-1,-1,-1,-1,1,2,-1
KR_6762323337,420,-1,-10,-8,-12,0,1,1,-7,8,1,-2,5,3,-4,6,2,1,0,1,0,-6,35,-5,-1,6,-13,0,0,-1,-1,0,-1,4,-1
KR_6595066187,440,2,0,-28,10,-2,5,3,7,3,10,-3,3,0,7,0,7,1,0,1,0,2,3,0,-4,4,1,0,1,-1,1,1,1,1,-1
KR_6765459784,420,-2,-75,16,2,-2,2,0,1,4,5,0,2,2,2,3,5,1,1,2,0,7,-4,-5,-4,9,-1,0,0,1,-1,0,-1,1,-1
KR_6759322806,440,-3,-4,0,1,5,0,5,2,4,6,1,2,3,-6,7,1,-1,2,1,0,-7,1,1,-3,2,-6,0,-2,-1,1,-1,1,1,-1
KR_6741305187,420,5,8,23,9,-2,4,2,5,2,7,-1,4,3,1,2,3,6,0,6,0,9,-21,-1,-4,5,3,0,1,-1,1,1,1,2,-1
KR_6755531333,420,1,21,25,1,4,0,4,2,1,3,0,2,2,-3,3,0,-2,3,1,-1,-4,5,-3,-7,10,-4,0,2,1,1,1,-1,3,-1
KR_6736335463,440,-3,-68,6,0,-4,4,0,3,3,6,3,0,3,-1,1,0,-1,1,0,0,4,85,5,-8,3,4,0,-2,-1,0,-1,1,3,-1
KR_6709065020,420,-4,-25,12,-8,-5,5,0,-3,4,1,-1,4,3,0,3,3,1,1,2,0,-3,7,-2,-3,5,-3,0,1,1,1,1,1,1,-1
KR_6763985663,420,-2,-62,-12,1,-2,2,0,2,4,6,-2,2,0,3,2,5,0,3,3,0,7,74,-1,-6,7,9,0,0,0,1,0,-1,0,-1
KR_6707856415,420,0,7,11,-7,-1,3,2,1,5,6,0,3,3,-6,6,0,-1,2,1,-1,-22,-2,-4,-4,8,-3,0,-1,-1,1,1,-1,3,-1
KR_6754674016,420,0,23,-14,-5,-2,4,2,-6,7,1,-2,3,1,6,0,6,-1,2,1,0,-9,-19,5,-8,3,-3,0,-2,1,-1,-1,1,5,-1
KR_6608819633,420,-1,-37,-16,-3,0,3,3,-2,4,2,-2,3,1,2,2,4,-1,1,0,0,1,2,4,-7,3,-5,0,-1,-1,-1,-1,-1,6,-1
KR_6718799378,420,-4,-88,-20,1,1,2,3,-3,6,3,1,2,3,1,1,2,1,0,1,0,7,30,3,-7,4,6,0,0,1,-1,1,-1,1,-1
KR_6746091753,420,-2,-51,11,-5,-3,5,2,0,4,4,-2,2,0,0,2,2,0,0,0,0,0,5,0,-4,4,-11,0,-2,-1,-1,-1,-1,4,-1
KR_6692557890,420,-6,-74,-35,-14,-5,5,0,-6,8,2,-1,1,0,-4,7,3,2,0,2,-1,-7,-15,0,-5,5,5,0,-1,-1,-1,-1,-1,5,-1
KR_6753048537,420,-3,-42,-16,-5,-1,2,1,-1,3,2,0,6,6,-3,6,3,0,2,2,0,-6,3,0,-5,5,1,0,0,-1,-1,-1,1,2,-1
KR_6744149799,440,-6,-67,1,-13,-2,2,0,-3,5,2,-6,6,0,-2,5,3,0,0,0,0,-16,28,-3,-5,8,6,0,-2,-1,-1,-1,-1,1,-1
KR_6714709611,420,-3,-29,-32,-5,2,3,5,-6,7,1,-1,3,2,3,3,6,-3,3,0,0,2,0,0,-5,5,1,0,-2,1,-1,-1,1,1,-1
KR_6691817373,420,1,-3,-6,2,0,2,2,-2,2,0,1,3,4,0,2,2,3,3,6,0,5,-24,4,-9,5,-3,0,0,-1,0,0,1,5,-1
KR_6730565245,420,1,31,3,6,0,2,2,3,1,4,-1,3,2,3,0,3,1,1,2,0,-3,-6,-3,-4,7,3,0,0,1,-1,0,1,1,-1
KR_6695748099,420,-4,-3,-43,-7,-3,3,0,4,2,6,-6,6,0,-3,4,1,1,2,3,0,-1,5,2,-6,4,-2,0,0,-1,1,0,1,2,-1
KR_6761020745,420,1,-1,-22,-6,-6,7,1,-2,4,2,3,2,5,0,1,1,-1,2,1,-1,-13,-1,-2,-3,5,-4,0,-1,1,-1,-1,-1,5,-1
KR_6711965821,420,-1,20,-32,1,0,1,1,4,2,6,-2,2,0,-1,1,0,0,0,0,0,2,3,2,-7,5,-4,0,-1,-1,-1,-1,1,2,-1
KR_6739456016,420,-3,-28,-44,3,3,0,3,-1,5,4,4,2,6,-4,5,1,1,3,4,1,0,-16,2,-7,5,2,0,-1,1,1,-1,1,3,-1
KR_6737079003,420,-5,-74,-9,-6,-2,4,2,0,3,3,0,2,2,-5,7,2,1,0,1,0,0,-25,0,-7,7,3,0,0,0,-1,0,-1,0,-1
KR_6702623788,440,0,65,12,2,1,1,2,-2,6,4,0,3,3,-1,2,1,4,0,4,0,5,9,0,-5,5,0,0,1,1,0,1,1,5,-1
KR_6758603300,420,-4,-40,-12,-10,-4,6,2,-2,3,1,0,2,2,-1,5,4,-3,4,1,0,2,9,4,-6,2,1,0,-2,-1,-1,-1,-1,1,-1
KR_6753834045,420,0,2,0,2,-3,4,1,1,2,3,2,1,3,3,0,3,-1,1,0,0,3,1,0,-7,7,3,0,0,-1,-1,0,1,3,-1
KR_6762621945,420,-5,-85,-8,-10,-3,3,0,-5,6,1,1,3,4,-2,4,2,-1,1,0,0,-18,240,-4,-3,7,-2,0,-1,-1,-1,-1,-1,3,-1
KR_6487092969,420,-6,-32,-9,-6,-3,3,0,-1,4,3,-1,2,1,-1,3,2,0,1,1,0,-5,23,-2,-4,6,-3,0,-2,-1,-1,-1,-1,5,-1
KR_6676583656,420,-4,-29,16,-13,-1,4,3,-3,5,2,1,3,4,-9,9,0,-1,1,0,0,-17,-30,-3,-6,9,-15,0,-1,1,1,-1,-1,2,-1
KR_6753765356,420,-1,-44,8,-2,-7,7,0,2,0,2,-2,4,2,4,0,4,1,0,1,0,9,3,0,-5,5,-4,0,-1,1,-1,-1,-1,2,-1
KR_6752721655,420,1,-14,16,2,-2,2,0,-4,7,3,4,1,5,3,0,3,1,0,1,0,-2,-8,-4,-6,10,-3,0,0,1,1,1,1,1,-1
KR_6763174344,420,-2,28,-12,-6,0,1,1,-4,5,1,-2,6,4,0,3,3,0,0,0,0,-15,-34,-4,-4,8,-3,0,1,-1,1,1,-1,4,-1
KR_6756835164,420,-1,61,-24,-3,3,1,4,-2,4,2,0,2,2,-3,5,2,-1,1,0,1,-8,-3,-2,-1,3,0,0,-1,-1,1,1,1,3,-1
KR_6468103274,420,1,2,8,4,-1,1,0,2,1,3,1,4,5,2,0,2,0,1,1,0,3,-6,-5,-3,8,4,0,2,-1,1,1,1,1,-1
KR_6714609346,440,1,-24,-5,-3,0,3,3,-1,2,1,1,4,5,-3,5,2,0,0,0,0,-9,10,3,-5,2,0,0,-2,-1,-1,-1,-1,3,-1
KR_6744646816,420,-3,-135,-12,-8,3,1,4,-4,5,1,-3,6,3,-4,5,1,0,0,0,-1,-12,15,4,-7,3,-4,0,-1,-1,1,-1,-1,4,-1
KR_6763839745,420,-1,39,-8,-4,-2,2,0,2,3,5,0,2,2,-3,5,2,-1,4,3,0,-1,-6,-1,-5,6,-3,0,0,1,-1,0,-1,2,-1
KR_6762223440,420,-5,-64,-9,-11,6,1,7,0,4,4,-11,11,0,-5,5,0,-1,2,1,-1,-11,-8,-1,-4,5,-3,0,-2,-1,1,-1,-1,4,-1
KR_6747459564,420,-2,5,-5,-1,-5,6,1,3,1,4,-1,2,1,3,2,5,-1,2,1,0,4,-243,2,-7,5,0,0,0,-1,0,0,-1,2,-1
KR_6702244524,420,-1,-60,-12,0,-3,5,2,0,3,3,1,0,1,4,0,4,-2,3,1,1,1,-2,1,-6,5,-2,0,0,1,-1,-1,1,5,-1
KR_6724594217,440,1,48,8,2,0,2,2,1,2,3,3,1,4,-3,3,0,1,1,2,1,5,5,-1,-4,5,-1,0,0,0,1,0,1,0,-1
KR_6763757430,440,-1,-12,-13,2,3,0,3,-1,5,4,1,3,4,0,2,2,-1,2,1,0,1,-8,0,-6,6,8,0,0,1,1,0,-1,6,-1
KR_6763690468,420,1,-65,32,2,-2,6,4,1,2,3,2,2,4,-1,5,4,2,0,2,0,6,-44,-2,-5,7,23,0,0,-1,1,0,1,1,-1
KR_6752145120,420,-4,32,-20,-10,1,1,2,-12,12,0,1,2,3,-1,4,3,1,0,1,0,-8,-1,-2,-5,7,-1,0,0,-1,-1,-1,-1,3,-1
KR_6567248418,420,-2,-63,-27,0,-1,1,0,-3,8,5,1,2,3,3,1,4,0,1,1,0,8,-57,2,-5,3,33,0,-1,1,-1,-1,1,2,-1
KR_6751830095,420,0,5,-12,-5,0,2,2,-2,3,1,1,3,4,-3,4,1,-1,2,1,0,-11,-11,2,-9,7,2,0,0,1,-1,0,-1,4,-1
KR_6674917201,420,3,12,-8,5,0,1,1,1,2,3,3,1,4,-2,3,1,3,0,3,1,5,-1,1,-8,7,3,0,-1,-1,-1,-1,1,6,-1
KR_6759568621,440,-1,-132,8,-8,0,2,2,-5,6,1,1,3,4,-5,8,3,1,0,1,-1,-10,-1,-1,-4,5,-1,0,-1,1,0,-1,-1,5,-1
KR_6758910924,420,-4,-55,13,-7,-2,3,1,1,2,3,-2,5,3,0,6,6,-4,5,1,-1,-11,-5,-2,-6,8,1,0,-1,0,-1,-1,-1,0,-1
KR_6760874830,420,-2,-6,-4,-7,-2,2,0,-4,5,1,0,3,3,0,4,4,-1,2,1,0,-10,-12,-6,-4,10,5,0,-1,-1,0,-1,-1,6,-1
KR_6700001738,420,1,15,28,3,1,1,2,2,4,6,0,3,3,-1,4,3,1,0,1,0,0,-7,0,-6,6,0,0,-1,1,1,-1,-1,5,-1
KR_6607225415,420,-5,-3,-40,-7,0,2,2,-8,9,1,1,0,1,0,1,1,0,0,0,0,-14,-23,-1,-6,7,-5,0,0,-1,1,0,-1,6,-1
KR_6640355453,420,-2,-16,-54,-7,-2,4,2,1,3,4,-3,4,1,-1,1,0,-2,2,0,-1,-7,-20,5,-10,5,16,0,-1,-1,1,-1,-1,4,-1
KR_6415031236,420,-5,-48,-16,-7,0,3,3,-2,3,1,0,1,1,-3,6,3,-2,3,1,-1,-4,-29,-2,-5,7,1,0,-2,0,-1,-1,-1,0,-1
KR_6689861815,420,-1,14,1,-2,4,2,6,0,1,1,-3,4,1,-5,7,2,2,0,2,0,-6,-2,-3,-4,7,2,0,0,1,-1,0,-1,4,-1
KR_6695807380,420,-7,-45,-39,-16,-10,10,0,-2,3,1,0,3,3,-1,3,2,-3,5,2,0,-10,-6,-7,-4,11,3,0,-3,-1,-1,-1,1,1,-1
KR_6555437382,420,-1,-3,0,1,-3,3,0,-1,5,4,4,0,4,1,1,2,0,0,0,0,2,-10,2,-5,3,-2,0,-1,-1,-1,-1,1,5,-1
KR_6723838602,420,-6,-53,-43,-17,-4,4,0,-1,4,3,-6,7,1,-6,6,0,0,1,1,0,-7,-5,-2,-3,5,-2,0,-2,-1,-1,-1,1,6,-1
KR_6671258404,420,-4,-62,-26,-14,-8,9,1,-2,3,1,1,0,1,-3,3,0,-2,5,3,-1,-6,-9,-6,-4,10,4,0,1,-1,-1,-1,-1,5,-1
KR_6634614453,420,-1,12,36,-5,3,0,3,-7,9,2,1,4,5,0,3,3,-2,2,0,0,-13,6,-3,-4,7,1,0,-1,1,1,1,1,1,-1
KR_6712214694,420,-1,-45,0,-5,-6,6,0,1,4,5,-2,3,1,1,2,3,1,0,1,0,-5,20,3,-9,6,-8,0,0,-1,1,1,-1,3,-1
KR_6739268248,420,-6,-39,-12,-3,-1,2,1,-4,4,0,-3,3,0,6,3,9,-1,1,0,0,1,-1,1,-5,4,-6,0,-1,-1,1,-1,1,3,-1
KR_6746280320,420,1,9,-13,4,0,1,1,-4,5,1,1,4,5,2,0,2,5,1,6,0,11,2,1,-3,2,2,0,0,-1,1,0,-1,3,-1
KR_6759604440,440,2,10,0,0,-2,5,3,0,1,1,1,1,2,-2,4,2,3,3,6,-1,-5,-47,1,-6,5,16,0,1,-1,1,1,-1,6,-1
KR_6738242311,420,-3,69,-15,-7,-1,3,2,-2,3,1,1,3,4,-4,5,1,-1,1,0,0,-7,-8,-4,-3,7,2,0,0,1,-1,0,-1,5,-1
KR_6733374355,420,-5,-77,-44,-6,-1,2,1,-1,2,1,-2,4,2,0,0,0,-2,3,1,0,-1,-8,-1,-4,5,8,0,-1,-1,-1,-1,-1,5,-1
KR_6639894379,420,-1,-26,12,-6,2,1,3,-4,6,2,-1,2,1,-3,6,3,0,0,0,0,-11,35,0,-6,6,0,0,-1,-1,-1,-1,1,5,-1
KR_6750290022,420,-6,-116,6,-7,-2,3,1,-4,4,0,-1,3,2,0,2,2,0,0,0,0,-6,-4,-1,-3,4,1,0,-3,-1,-1,-1,-1,4,-1
KR_6757163205,420,-5,-36,-48,-9,0,2,2,-2,4,2,-2,2,0,-5,6,1,0,2,2,1,-10,31,-2,-3,5,-1,0,-2,-1,0,-1,1,6,-1
KR_6465244531,420,4,48,4,5,3,1,4,-2,6,4,-1,4,3,1,1,2,4,1,5,-1,-1,0,0,-4,4,1,0,-1,1,-1,-1,-1,3,-1
KR_6611209513,420,0,29,16,-3,-1,1,0,-2,3,1,1,0,1,-1,1,0,0,0,0,0,-7,-1,-3,-3,6,-1,0,-1,-1,-1,-1,-1,5,-1
KR_6711987829,420,0,14,-12,-8,-3,4,1,-3,4,1,4,1,5,-6,7,1,0,3,3,0,-10,-3,8,-8,0,2,0,1,1,1,-1,1,5,-1
KR_6735955673,420,-2,-28,12,-7,-2,3,1,1,0,1,-2,5,3,-5,5,0,1,0,1,0,-8,1,1,-4,3,-2,0,-1,-1,-1,-1,1,4,-1
KR_6765705282,420,-1,40,9,-6,0,2,2,-1,2,1,-2,5,3,-4,6,2,1,0,1,0,-5,-10,-8,0,8,1,0,0,1,-1,0,-1,2,-1
KR_6765410636,420,-4,-39,-20,-8,-2,3,1,-4,4,0,-3,5,2,2,0,2,-1,1,0,0,-10,-30,-3,-6,9,2,0,-1,1,1,-1,-1,2,-1
KR_6740252394,420,-1,-32,44,-1,3,1,4,-3,4,1,-1,1,0,-1,3,2,1,0,1,0,2,-6,1,-6,5,0,0,0,1,1,0,1,2,-1
KR_6763917280,420,-2,-38,1,-8,-5,5,0,-1,2,1,0,2,2,0,2,2,-2,2,0,0,-7,7,3,-9,6,-2,0,0,-1,1,1,-1,3,-1
KR_6694644322,420,-1,-2,-60,0,-2,2,0,-1,2,1,-1,1,0,2,4,6,2,0,2,0,0,8,6,-11,5,-7,0,1,1,-1,1,1,6,-1
KR_6692302388,420,1,19,6,5,-1,4,3,5,4,9,2,2,4,0,0,0,-1,1,0,0,17,-50,-1,-4,5,23,0,0,-1,0,0,-1,2,-1
KR_6634721714,420,6,113,26,6,1,2,3,1,1,2,-1,1,0,2,1,3,3,0,3,0,6,-26,-2,-5,7,-24,0,2,1,-1,1,-1,3,-1
KR_6732571152,420,-7,-64,-19,-14,-6,6,0,-2,3,1,-4,4,0,-1,2,1,-1,2,1,0,-3,8,-6,-5,11,0,0,-3,-1,-1,-1,-1,2,-1
KR_6742813182,420,-1,-43,2,-7,-1,2,1,1,5,6,-4,5,1,-3,4,1,0,0,0,0,-5,-92,2,-7,5,-3,0,-1,-1,-1,-1,-1,6,-1
KR_6763378314,420,-2,-28,28,-6,0,1,1,1,0,1,-5,5,0,-2,3,1,0,0,0,0,-4,-3,-6,-2,8,-3,0,0,1,-1,-1,-1,3,-1
KR_6749461517,420,-2,-16,-29,-4,0,0,0,-2,4,2,-4,5,1,3,0,3,-1,1,0,0,-3,5,-3,-4,7,0,0,-1,-1,-1,-1,-1,3,-1
KR_6558273327,440,0,29,-2,-1,-2,2,0,1,2,3,2,1,3,-1,3,2,-1,1,0,0,-4,-18,0,-2,2,0,0,0,-1,-1,-1,1,3,-1
KR_6756731992,420,-1,-16,-41,-12,-5,5,0,-2,3,1,0,2,2,1,1,2,-6,7,1,-2,-16,282,-1,-4,5,2,0,-1,1,-1,-1,-1,3,-1
KR_6725753118,420,-5,-20,-6,-9,-2,7,5,2,0,2,-1,3,2,-3,4,1,-5,5,0,0,-7,11,-2,-4,6,-3,0,-1,1,1,-1,1,3,-1
KR_6742793743,420,-4,-89,-32,-12,-3,3,0,0,4,4,-3,5,2,-6,6,0,0,1,1,0,-13,-6,-3,-5,8,0,0,-2,-1,-1,-1,-1,6,-1
KR_6751436966,420,-6,-42,-4,-7,-2,3,1,-2,6,4,4,2,6,-3,5,2,-4,4,0,1,4,-1,0,-5,5,2,0,0,-1,-1,1,1,2,-1
KR_6743228875,420,-2,-50,-8,-7,-2,3,1,-5,6,1,-3,3,0,5,1,6,-2,2,0,0,-4,-229,3,-5,2,-4,0,0,-1,-1,0,-1,5,-1
KR_6717639292,420,-4,-77,-28,-10,-3,4,1,-4,7,3,4,1,5,-5,8,3,-2,2,0,0,-8,7,0,-5,5,-2,0,-1,-1,-1,-1,1,2,-1
KR_6744644514,420,0,-16,-8,-1,1,0,1,-4,6,2,1,1,2,3,2,5,-2,2,0,0,-1,-26,-5,-2,7,3,0,1,-1,1,1,1,4,-1
KR_6763641493,420,-1,-26,12,0,1,3,4,2,3,5,-3,3,0,1,3,4,-1,1,0,0,-3,3,-1,-6,7,-3,0,0,1,1,0,1,3,-1
KR_6754730963,420,-2,61,-2,-10,0,2,2,-6,6,0,-4,4,0,-1,4,3,1,0,1,0,-10,11,1,-8,7,-5,0,2,-1,0,1,-1,2,-1
KR_6737190050,420,0,25,5,-5,1,1,2,-2,2,0,-1,2,1,-1,3,2,-2,2,0,0,-9,-133,2,-5,3,7,0,-1,-1,-1,-1,-1,2,-1
KR_6617099307,420,-3,-86,15,-12,-3,3,0,0,4,4,-8,8,0,1,1,2,-2,2,0,0,-16,13,1,-5,4,-5,0,1,-1,1,1,-1,2,-1
KR_6765515491,420,-2,-46,6,-1,0,2,2,-1,4,3,0,2,2,1,2,3,-1,1,0,0,5,-12,-8,-3,11,0,0,-1,1,0,-1,1,2,-1
KR_6737842230,440,-3,-43,2,-8,-2,4,2,-5,5,0,-2,3,1,1,2,3,0,1,1,0,-5,2,8,-8,0,0,0,0,1,1,-1,1,2,-1
KR_6756618023,420,-2,-23,-11,-9,-1,2,1,-2,5,3,-3,9,6,-1,1,0,-2,2,0,0,-6,4,1,-4,3,2,0,-1,-1,1,-1,1,3,-1
KR_6735735429,420,-3,-7,-8,0,-1,2,1,0,3,3,2,1,3,3,1,4,-4,4,0,0,4,0,4,-10,6,-6,0,-1,0,-1,-1,-1,0,-1
KR_6671980482,420,-2,-19,-29,-8,1,0,1,-3,6,3,0,1,1,-2,5,3,-4,4,0,0,-17,-4,-4,-2,6,1,0,0,-1,1,1,-1,3,-1
KR_6752076948,420,-2,-38,-15,2,-4,4,0,6,0,6,-4,4,0,2,1,3,2,1,3,0,1,-3,1,-4,3,3,0,2,-1,-1,1,1,1,-1
KR_6762523711,420,-3,-44,-16,-6,2,1,3,-4,5,1,-2,3,1,-3,3,0,1,0,1,0,-8,-4,3,-6,3,2,0,-3,-1,-1,-1,-1,3,-1
KR_6739863182,420,3,18,-8,2,-1,1,0,0,2,2,2,6,8,1,2,3,0,2,2,1,3,-14,-8,-3,11,2,0,1,-1,-1,1,1,5,-1
KR_6718508363,420,-1,28,-12,-4,-1,2,1,1,4,5,-1,3,2,-2,4,2,-1,2,1,0,-3,97,-3,-2,5,2,0,0,-1,-1,0,1,5,-1
KR_6766018920,440,0,16,-16,2,-2,3,1,-1,2,1,3,0,3,-2,4,2,4,1,5,0,5,5,-1,-5,6,-3,0,0,-1,1,0,-1,6,-1
KR_6745493128,420,-1,-81,10,-4,-4,4,0,2,1,3,-3,4,1,3,1,4,-2,2,0,0,-4,-4,1,-8,7,-3,0,-1,-1,1,-1,-1,6,-1
KR_6712847067,420,-2,-55,-14,2,-2,2,0,-2,4,2,1,1,2,3,2,5,2,2,4,0,3,3,-3,-7,10,1,0,-1,1,-1,-1,1,3,-1
KR_6674965524,420,-3,-1,-37,-6,-1,2,1,1,4,5,-3,3,0,3,1,4,-6,8,2,-1,-12,13,-2,-4,6,-1,0,0,-1,0,1,-1,5,-1
KR_6745457893,420,0,-6,16,-4,-1,2,1,-3,5,2,0,1,1,1,1,2,-1,2,1,0,-2,-2,0,-5,5,3,0,-1,1,-1,-1,-1,5,-1
KR_6625478087,420,0,31,2,7,1,1,2,6,5,11,3,2,5,0,3,3,-3,4,1,3,5,0,2,-8,6,3,0,0,-1,1,0,-1,6,-1
KR_6762526298,440,5,32,5,10,0,1,1,0,3,3,3,2,5,3,5,8,4,1,5,-1,11,-13,0,-2,2,8,0,0,1,-1,0,-1,6,-1
KR_6709162528,420,-1,-45,-8,2,1,1,2,1,3,4,2,1,3,-3,5,2,1,0,1,0,2,-1,2,-5,3,2,0,0,0,1,0,1,0,-1
KR_6760094384,420,-3,-48,-20,-12,3,1,4,-2,5,3,-7,10,3,-7,7,0,1,0,1,0,-6,-21,5,-8,3,-1,0,-3,-1,-1,-1,-1,6,-1
KR_6678754224,420,-1,-9,-16,0,0,2,2,6,0,6,-5,8,3,-2,5,3,1,0,1,0,-6,1,3,-8,5,-2,0,0,-1,1,0,-1,3,-1
KR_6741355390,420,-1,-17,-24,-7,-2,3,1,0,1,1,0,1,1,-4,4,0,-1,1,0,0,-5,-22,-4,-1,5,2,0,-3,-1,-1,-1,-1,1,-1
KR_6688012482,420,-3,-81,8,2,-3,4,1,0,5,5,1,3,4,2,5,7,2,1,3,1,6,-23,2,-6,4,-1,0,1,0,1,-1,1,0,-1
KR_6763223104,420,-7,-79,-19,-11,0,1,1,-1,1,0,-8,9,1,-1,2,1,-1,2,1,0,-10,-4,-6,-1,7,0,0,-2,-1,-1,-1,1,1,-1
KR_6724390660,440,1,-22,16,-4,-1,1,0,-4,7,3,-2,2,0,0,4,4,3,0,3,0,-4,1,4,-5,1,-4,0,0,-1,1,-1,-1,4,-1
KR_6756311255,440,-3,38,-35,-6,1,0,1,0,2,2,2,2,4,-4,6,2,-5,5,0,1,-6,-17,4,-6,2,-1,0,0,-1,-1,0,1,3,-1
KR_6758564474,420,-1,-77,-13,-8,-3,4,1,-1,1,0,-1,2,1,-3,6,3,0,0,0,-1,-7,-1,0,-5,5,-4,0,0,-1,1,0,1,5,-1
KR_6763016535,440,-1,-10,-8,-4,0,2,2,1,1,2,0,2,2,-3,3,0,-2,2,0,-1,-7,4,-2,-3,5,-1,0,-1,-1,1,-1,-1,1,-1
KR_6763652510,420,1,52,4,0,1,2,3,-1,2,1,0,1,1,-4,8,4,4,1,5,0,-2,14,4,-8,4,-6,0,0,0,1,1,1,0,-1
KR_6746809070,420,1,9,-16,3,1,2,3,0,3,3,1,1,2,2,0,2,-1,1,0,0,7,12,2,-7,5,-1,0,0,-1,1,0,-1,1,-1
KR_6528919046,420,1,-22,-1,-3,0,2,2,-2,2,0,0,2,2,-1,2,1,0,0,0,0,-4,-13,-2,-4,6,-3,0,1,-1,0,1,-1,6,-1
KR_6509823871,420,-4,-88,-3,-6,-4,4,0,-1,4,3,3,0,3,-3,5,2,-1,1,0,0,-8,-17,-3,-5,8,-1,0,-2,-1,0,-1,-1,6,-1
KR_6759427526,420,4,40,0,11,1,2,3,2,1,3,5,3,8,2,6,8,1,2,3,2,12,-50,2,-7,5,14,0,2,1,1,1,1,4,-1
KR_6544771486,420,-5,-67,1,-12,0,3,3,-5,6,1,-5,6,1,-3,4,1,1,1,2,0,-6,-7,1,-5,4,-2,0,-3,-1,-1,-1,1,6,-1
KR_6743107748,420,-4,0,-15,-2,1,0,1,-5,5,0,3,1,4,-1,3,2,0,0,0,0,-3,10,-2,-5,7,2,0,0,-1,0,0,1,3,-1
KR_6751441873,440,-2,11,0,-7,-2,5,3,-1,2,1,3,3,6,-4,8,4,-3,4,1,0,-19,2,2,-5,3,-3,0,-2,0,-1,-1,1,0,-1
KR_6763009778,420,2,30,31,6,2,1,3,0,4,4,5,0,5,-2,3,1,1,1,2,1,2,-52,-1,-4,5,24,0,1,1,1,1,1,3,-1
KR_6758141868,420,0,15,-19,-2,-4,4,0,2,1,3,1,1,2,-1,2,1,0,0,0,0,5,-14,-2,-3,5,-1,0,-2,-1,1,-1,1,4,-1
KR_6759054567,440,0,35,-11,1,0,2,2,-5,5,0,4,1,5,1,1,2,1,0,1,-1,4,45,1,-6,5,-21,0,0,0,-1,0,-1,0,-1
KR_6675093939,420,-4,-82,3,-13,-4,4,0,1,2,3,0,2,2,-7,8,1,-3,3,0,0,-14,1,-3,-5,8,1,0,-1,1,-1,-1,-1,3,-1
KR_6677010639,420,-1,14,8,-3,-4,4,0,4,2,6,-2,2,0,-2,3,1,1,0,1,0,0,-6,-2,-4,6,-2,0,0,-1,1,1,1,1,-1
KR_6764623418,420,-3,-63,20,-10,-2,4,2,-2,5,3,1,2,3,-6,7,1,-1,1,0,0,-16,-16,1,-5,4,-3,0,-2,1,1,-1,-1,1,-1
KR_6757381102,420,-3,-13,-28,-2,2,3,5,0,1,1,-4,5,1,0,3,3,0,0,0,-1,-3,-3,-7,-4,11,3,0,-1,-1,-1,1,-1,3,-1
KR_6757037781,420,-3,9,24,-4,-2,3,1,-5,9,4,1,0,1,-1,4,3,3,1,4,0,-3,-4,-3,-5,8,-3,0,0,-1,1,0,1,1,-1
KR_6693815078,420,-8,-18,-122,-12,-1,2,1,-4,4,0,0,3,3,-4,6,2,-3,6,3,0,-9,-8,-2,-1,3,0,0,0,-1,-1,-1,-1,5,-1
KR_6727052635,420,-7,-55,-16,-14,-3,4,1,-1,3,2,-1,2,1,-5,9,4,-4,5,1,0,-10,-21,-2,-2,4,1,0,-2,-1,1,-1,1,3,-1
KR_6757625147,420,2,-61,-4,8,-3,3,0,2,2,4,4,2,6,5,1,6,0,0,0,1,14,0,1,-6,5,1,0,1,-1,1,1,1,4,-1
KR_6663899295,420,-2,15,10,-11,-4,6,2,-2,7,5,0,3,3,-3,4,1,-2,2,0,-1,-24,-6,-8,-4,12,3,0,0,-1,-1,-1,-1,4,-1
KR_6758033471,420,-5,-56,9,-21,-7,7,0,2,3,5,-5,6,1,-9,9,0,-2,2,0,-1,-23,-1,2,-8,6,-5,0,-1,-1,1,-1,-1,4,-1
KR_6713923566,440,4,50,-4,2,0,4,4,3,7,10,0,2,2,-1,1,0,0,0,0,2,10,8,-5,-2,7,3,0,3,1,1,1,1,1,-1
KR_6760907601,440,0,-88,-1,2,-2,3,1,-2,5,3,3,0,3,5,2,7,-2,2,0,0,8,-34,-3,-4,7,-1,0,-1,0,0,-1,-1,0,-1
KR_6727870084,420,-3,-71,20,-7,-4,6,2,-1,4,3,1,2,3,-2,6,4,-1,3,2,1,0,2,2,-7,5,-3,0,-2,-1,-1,-1,1,3,-1
KR_6741916900,420,-5,-20,10,-13,-4,4,0,-12,12,0,5,2,7,-2,2,0,0,1,1,1,-12,7,1,-6,5,-6,0,-1,-1,-1,-1,1,5,-1
KR_6755432410,420,-4,-52,-15,-7,3,2,5,-4,5,1,4,1,5,-8,10,2,-2,4,2,-3,-9,2,-3,-5,8,-4,0,-2,-1,-1,-1,-1,2,-1
KR_6763116200,420,-3,-11,-7,-9,-2,4,2,-3,4,1,2,0,2,-6,7,1,0,2,2,0,-7,-2,0,-3,3,-4,0,-3,-1,1,-1,-1,4,-1
KR_6655777910,440,-1,-49,6,-8,-5,5,0,-5,5,0,-3,4,1,6,0,6,-1,2,1,0,0,22,1,-7,6,-8,0,-1,1,-1,-1,-1,3,-1
KR_6748833841,420,-3,-22,-12,0,2,0,2,1,2,3,-4,6,2,1,1,2,0,0,0,0,-5,254,3,-6,3,1,0,1,-1,1,1,-1,4,-1
KR_6766102229,420,4,63,19,3,0,3,3,8,3,11,-3,5,2,-1,5,4,-1,1,0,-1,1,-29,-11,-4,15,-2,0,1,1,-1,-1,-1,5,-1
KR_6751285952,420,-2,16,-11,-5,0,2,2,-3,5,2,1,0,1,-2,3,1,-1,3,2,0,-9,-3,-1,-8,9,-5,0,0,1,-1,0,1,2,-1
KR_6670445397,420,-2,-76,-9,-4,-1,3,2,-4,5,1,1,2,3,0,4,4,0,4,4,0,4,-106,3,-10,7,-5,0,-1,0,-1,-1,-1,0,-1
KR_6755953705,420,-3,-32,-17,-4,-3,3,0,5,1,6,1,1,2,-6,7,1,-1,2,1,-1,-7,76,1,-5,4,-2,0,-1,-1,1,-1,-1,6,-1
KR_6753998412,420,0,-29,0,3,-2,4,2,2,1,3,-1,6,5,2,1,3,2,1,3,-1,0,-1,-2,-5,7,-3,0,0,-1,-1,0,-1,1,-1
KR_6765824539,420,4,43,32,6,4,0,4,3,2,5,0,2,2,1,2,3,-2,3,1,1,1,-4,3,-5,2,-3,0,1,1,1,1,1,2,-1
KR_6665182888,420,3,25,3,3,1,0,1,-3,8,5,4,0,4,0,1,1,1,0,1,0,5,-27,0,-5,5,24,0,1,-1,1,-1,-1,4,-1
KR_6675023318,420,-6,-135,-35,-11,-4,4,0,-1,3,2,-3,4,1,-3,6,3,0,0,0,0,-1,99,0,-4,4,4,0,-2,-1,1,-1,-1,4,-1
KR_6669609608,420,-2,-46,-12,-7,-4,4,0,-2,5,3,5,0,5,-2,6,4,-4,5,1,-1,2,47,1,-4,3,-15,0,-1,-1,-1,-1,-1,6,-1
KR_6734034707,420,-2,-9,24,-3,-1,4,3,-2,5,3,0,2,2,-1,4,3,1,0,1,0,5,1,0,-6,6,-4,0,0,-1,1,0,-1,3,-1
KR_6765485882,420,1,-11,26,0,-4,4,0,3,1,4,2,0,2,-7,9,2,6,1,7,0,1,-5,-4,-4,8,-2,0,0,-1,1,-1,-1,5,-1
KR_6046311569,420,0,-11,-1,-5,1,0,1,0,4,4,-3,4,1,-3,4,1,0,0,0,0,-3,127,-3,-7,10,-4,0,0,1,1,-1,-1,4,-1
KR_6679948408,420,1,-2,15,2,2,1,3,2,3,5,0,2,2,-2,3,1,0,1,1,0,0,3,-2,-3,5,-3,0,0,1,1,0,-1,5,-1
KR_6750443238,420,-4,-75,-20,-4,-1,2,1,-1,3,2,-1,4,3,-1,2,1,0,1,1,0,3,20,1,-7,6,-4,0,-1,-1,-1,-1,-1,6,-1
KR_6582842048,420,-2,32,-41,-6,0,1,1,-3,5,2,2,3,5,-3,3,0,-2,2,0,0,-7,16,2,-9,7,0,0,0,-1,-1,1,-1,3,-1
KR_6657961101,420,-6,-115,-53,-15,-2,3,1,0,4,4,-5,7,2,-7,8,1,-1,1,0,0,-13,0,-5,0,5,-1,0,-2,-1,-1,-1,1,6,-1
KR_6686628258,420,1,-24,10,-3,2,2,4,0,4,4,-3,3,0,-2,2,0,0,1,1,0,-13,-7,1,-8,7,4,0,-1,-1,1,1,-1,1,-1
KR_6713549351,420,-2,-54,-12,0,-1,2,1,-2,4,2,2,2,4,2,0,2,-1,1,0,1,5,-2,-1,-6,7,-2,0,-1,-1,1,-1,1,5,-1
KR_6750527545,420,0,37,0,-5,-1,3,2,-6,8,2,-1,1,0,3,0,3,0,2,2,0,-7,102,-4,-5,9,10,0,0,1,-1,0,1,4,-1
KR_6764613349,420,0,-15,0,1,2,0,2,0,0,0,4,0,4,-3,5,2,-2,2,0,0,-6,-2,3,-7,4,-3,0,-1,-1,-1,-1,-1,2,-1
KR_6749071232,420,-3,-22,-28,-8,-4,7,3,-5,7,2,-4,8,4,3,6,9,2,0,2,0,-5,-6,-4,-3,7,-3,0,0,-1,-1,1,1,5,-1
KR_6708513738,420,-2,-28,11,-11,-6,7,1,0,2,2,-1,4,3,-3,3,0,-1,3,2,1,-26,-9,2,-5,3,10,0,-2,1,-1,-1,1,2,-1
KR_6760412105,420,-2,-28,36,-5,-5,6,1,0,2,2,-1,1,0,0,2,2,1,0,1,0,-6,1,-5,-2,7,-3,0,0,-1,1,-1,1,4,-1
KR_6752044700,420,0,21,8,-1,1,1,2,-2,3,1,-2,2,0,1,1,2,1,2,3,0,1,6,6,-9,3,0,0,1,1,-1,1,-1,6,-1
KR_6759832768,420,0,21,4,-5,-3,6,3,-4,5,1,-3,7,4,0,1,1,5,0,5,-1,-10,-13,-1,-6,7,2,0,2,0,1,1,-1,0,-1
KR_6730046447,420,0,-8,-18,0,-1,2,1,1,2,3,0,3,3,0,0,0,0,1,1,0,-1,-26,-2,-2,4,0,0,-1,1,-1,-1,-1,6,-1
KR_6756573482,420,2,49,8,2,3,1,4,-1,2,1,2,1,3,-2,4,2,0,1,1,-2,-5,7,-1,-2,3,-1,0,0,-1,0,0,-1,6,-1
KR_6744417412,440,-2,-71,-16,-5,-1,2,1,2,3,5,-4,6,2,-5,9,4,3,2,5,-2,-13,4,-2,-4,6,5,0,1,-1,1,-1,-1,1,-1
KR_6765003587,440,-1,2,-23,-2,0,1,1,0,0,0,-8,8,0,1,6,7,5,2,7,0,-4,-2,3,-7,4,1,0,1,-1,1,1,1,4,-1
KR_6735461553,420,-2,-25,16,1,-4,4,0,0,2,2,0,1,1,3,0,3,2,0,2,2,5,-110,1,-9,8,-2,0,0,1,1,1,1,3,-1
KR_6759600428,440,3,28,4,3,-2,2,0,3,1,4,-1,2,1,3,0,3,0,2,2,0,6,48,6,-9,3,-2,0,1,-1,-1,1,-1,3,-1
KR_6760525061,420,0,6,-32,-2,1,2,3,-4,5,1,-3,3,0,4,2,6,0,1,1,0,0,-11,0,-4,4,6,0,0,1,1,0,1,6,-1
KR_6722120845,420,-2,-23,-45,5,-1,4,3,4,3,7,1,3,4,-1,5,4,2,0,2,3,16,-1,6,-9,3,-4,0,-2,1,-1,-1,1,4,-1
KR_6753492108,420,0,-94,18,-3,1,2,3,1,1,2,-2,3,1,-1,2,1,-2,2,0,0,-4,-3,-3,-2,5,-2,0,-3,-1,1,-1,-1,2,-1
KR_6694890215,420,2,28,3,5,4,0,4,-1,6,5,-2,2,0,3,2,5,1,1,2,0,6,14,3,-8,5,-2,0,1,-1,-1,1,-1,3,-1
KR_6759137808,420,-2,-8,9,-9,-2,5,3,-3,4,1,1,1,2,-3,3,0,-2,2,0,0,-11,-1,0,-4,4,0,0,0,-1,1,-1,-1,2,-1
KR_6666812054,420,-3,48,-4,-10,-1,1,0,-3,3,0,-1,3,2,-4,10,6,-1,1,0,-1,-10,-5,3,-8,5,3,0,1,0,-1,1,-1,0,-1
KR_6741295878,420,0,39,24,-2,0,3,3,-4,5,1,5,0,5,-2,5,3,-1,1,0,0,-3,-4,0,-2,2,3,0,-1,-1,1,1,1,1,-1
KR_6761809459,420,-4,-60,-5,-9,-3,4,1,-1,5,4,-7,7,0,-2,8,6,4,1,5,0,1,1,4,-6,2,-5,0,-2,-1,-1,-1,-1,3,-1
KR_6765636205,420,-1,-43,-12,-9,1,2,3,2,1,3,0,1,1,-9,10,1,-3,3,0,0,-16,-9,-1,-6,7,2,0,-1,-1,1,-1,1,2,-1
KR_6610558416,420,-2,-51,12,-6,-3,3,0,-3,4,1,2,1,3,-2,2,0,0,0,0,0,-13,-2,1,-6,5,-3,0,-1,-1,-1,-1,-1,5,-1
KR_6668956630,420,1,9,-20,0,-1,2,1,3,1,4,-1,3,2,0,1,1,-1,1,0,0,7,6,0,-7,7,-1,0,0,1,-1,0,1,1,-1
KR_6748999167,420,1,-13,7,1,-1,2,1,-3,3,0,1,1,2,1,1,2,3,1,4,0,1,2,-1,-2,3,1,0,0,-1,0,0,1,1,-1
KR_6736657444,420,-1,-58,-11,-6,-2,2,0,-1,4,3,-1,3,2,-2,5,3,0,1,1,0,-4,6,0,-5,5,-4,0,0,-1,-1,0,-1,5,-1
KR_6672019841,420,-1,-14,5,-4,-2,3,1,-5,6,1,-1,2,1,2,3,5,2,1,3,1,-1,0,-7,-2,9,1,0,-2,1,-1,-1,1,2,-1
KR_6725505514,420,-1,-11,-12,-6,1,1,2,-3,7,4,-5,6,1,1,0,1,0,0,0,0,-6,18,4,-6,2,-2,0,0,1,-1,0,1,6,-1
KR_6739173697,420,-5,-82,-24,0,-2,3,1,1,3,4,1,2,3,0,1,1,0,0,0,0,6,197,-2,-5,7,-4,0,0,-1,1,0,1,1,-1
KR_6684161751,420,1,65,16,-1,1,0,1,-1,3,2,-6,6,0,5,0,5,0,1,1,2,7,-1,1,-5,4,5,0,1,-1,1,1,1,1,-1
KR_6763435580,420,-2,-7,-12,1,5,1,6,1,3,4,-3,5,2,3,0,3,-5,5,0,0,-5,18,-1,-2,3,1,0,0,-1,1,1,1,2,-1
KR_6714658838,420,3,-39,24,6,-2,2,0,-1,2,1,2,0,2,8,1,9,-1,2,1,0,7,-106,8,-10,2,1,0,1,1,0,-1,1,6,-1
KR_6580246710,440,-5,-11,-32,-11,-1,1,0,3,3,6,-3,4,1,-9,12,3,-1,2,1,0,-11,-1,5,-8,3,-2,0,-2,-1,-1,-1,-1,1,-1
KR_6746433352,420,-2,-63,-8,-6,-1,2,1,-2,3,1,-3,4,1,0,3,3,0,0,0,0,-12,54,-5,-3,8,3,0,0,-1,-1,-1,-1,4,-1
KR_6741045311,420,-9,-110,-45,-16,-6,6,0,-8,10,2,-1,3,2,-1,1,0,0,0,0,-1,-14,-20,-8,-3,11,0,0,-1,-1,-1,-1,-1,4,-1
KR_6726992870,420,2,-9,-2,2,2,3,5,-2,4,2,-2,3,1,5,2,7,-1,2,1,1,-2,2,0,-4,4,2,0,0,1,1,0,1,1,-1
KR_6753305368,440,0,12,12,1,3,1,4,-2,3,1,0,3,3,-2,4,2,2,2,4,0,5,8,2,-6,4,-9,0,0,-1,1,0,-1,6,-1
KR_6748802727,440,-8,-107,-40,-9,-1,2,1,-3,3,0,-5,5,0,-2,3,1,2,0,2,0,-6,2,-2,-3,5,-2,0,-1,-1,0,-1,1,5,-1
KR_6743764312,420,-3,-39,11,-7,0,0,0,2,0,2,-1,1,0,-5,6,1,-3,3,0,0,-13,6,1,-4,3,-4,0,0,-1,1,0,-1,4,-1
KR_6715864453,420,0,29,-1,-6,-2,3,1,-5,9,4,2,2,4,-1,4,3,0,2,2,0,-6,-7,-1,-5,6,2,0,0,-1,-1,-1,-1,6,-1
KR_6728027328,420,-4,-28,-16,-9,-3,4,1,1,3,4,-5,5,0,-3,4,1,1,1,2,0,-4,-22,1,-4,3,4,0,-1,-1,0,1,-1,1,-1
KR_6749068227,420,0,17,-36,0,2,1,3,-1,1,0,-6,8,2,3,1,4,2,0,2,-1,-4,-27,-1,-7,8,26,0,1,1,-1,-1,-1,3,-1
KR_6737835161,420,-2,-8,24,-10,1,2,3,-4,5,1,-1,3,2,-5,8,3,-1,1,0,0,-12,-2,2,-6,4,-2,0,0,-1,1,1,-1,4,-1
KR_6652015183,420,-5,-40,4,-9,-4,5,1,-2,2,0,1,5,6,0,3,3,-4,4,0,0,-11,5,4,-7,3,1,0,-1,-1,1,-1,1,6,-1
KR_6761020478,420,-2,14,0,-1,-2,3,1,-3,7,4,5,0,5,-1,1,0,0,2,2,0,-3,3,2,-5,3,2,0,0,0,-1,0,-1,0,-1
KR_6742359321,440,-1,-46,5,1,-1,2,1,-4,5,1,-2,3,1,6,1,7,2,1,3,0,-2,-5,-5,-1,6,1,0,0,1,1,0,1,2,-1
KR_6759012067,420,-2,-11,-6,2,0,4,4,0,3,3,3,1,4,-4,4,0,3,0,3,-1,-2,4,-1,-8,9,0,0,0,-1,-1,-1,-1,2,-1
KR_6731506953,420,-1,-20,16,0,3,1,4,0,1,1,-3,3,0,2,0,2,-2,2,0,0,2,0,1,-4,3,-8,0,0,-1,1,1,1,5,-1
KR_6762984034,420,2,38,-4,3,-4,4,0,0,3,3,2,1,3,5,1,6,0,5,5,-1,5,-250,0,-3,3,5,0,0,-1,-1,1,-1,4,-1
KR_6697891160,420,4,-25,-5,4,1,1,2,0,2,2,-3,4,1,4,1,5,2,0,2,0,2,20,-7,-3,10,4,0,0,1,-1,-1,1,5,-1
KR_6679475383,420,-2,22,-49,-5,0,1,1,-11,12,1,2,2,4,4,4,8,0,0,0,0,-13,-116,-4,-5,9,1,0,-1,-1,-1,-1,1,6,-1
KR_6760809446,420,-3,-66,-12,-6,-1,1,0,-3,5,2,-2,2,0,1,2,3,-1,1,0,0,-5,-21,1,-5,4,-1,0,0,-1,1,-1,-1,4,-1
KR_6718178075,440,-1,53,-32,-2,0,4,4,-1,3,2,1,2,3,0,2,2,-2,2,0,0,-1,10,8,-11,3,-2,0,1,-1,1,1,1,5,-1
KR_6498346770,420,-3,-54,-47,-9,2,1,3,-3,4,1,-3,5,2,-5,7,2,0,1,1,-1,-16,9,-4,-4,8,-1,0,-1,1,-1,-1,-1,2,-1
KR_6752334312,420,1,8,15,-5,-1,1,0,1,2,3,1,3,4,-3,5,2,-3,4,1,0,-10,1,6,-8,2,0,0,0,1,1,-1,1,1,-1
KR_6698761331,420,-1,25,-4,-2,-1,2,1,-3,5,2,-3,5,2,-2,6,4,7,1,8,0,3,-34,-2,-5,7,1,0,0,0,1,1,1,0,-1
KR_6544814870,420,-1,88,-19,-8,2,2,4,2,1,3,-15,15,0,1,1,2,2,0,2,-1,-10,-32,2,-6,4,-2,0,-1,-1,-1,-1,-1,1,-1
KR_6728274468,420,0,-6,-4,-8,4,0,4,-4,6,2,-1,2,1,-8,8,0,1,2,3,-2,-16,-13,-1,-6,7,2,0,1,-1,-1,-1,-1,5,-1
KR_6760255433,420,0,-73,12,5,-3,5,2,1,2,3,2,3,5,1,2,3,4,0,4,0,11,-4,4,-8,4,-2,0,-2,1,-1,-1,-1,6,-1
KR_6505130362,420,-6,24,-37,-8,0,0,0,-3,5,2,-4,5,1,-2,4,2,1,0,1,0,-1,7,-3,-4,7,0,0,0,-1,1,0,-1,3,-1
KR_6660496017,420,-2,-27,-9,0,0,1,1,-4,4,0,3,1,4,0,0,0,1,2,3,0,3,2,-1,-5,6,1,0,-1,1,1,-1,1,2,-1
KR_6694886432,420,-2,-21,-15,-5,0,2,2,-9,10,1,1,1,2,1,1,2,2,0,2,0,-13,-2,-2,-5,7,2,0,0,-1,-1,0,1,6,-1
KR_6579351427,420,-3,-10,-4,-5,2,0,2,-3,3,0,2,2,4,-2,3,1,-4,4,0,1,-13,109,1,-6,5,38,0,0,-1,1,-1,1,4,-1
KR_6591943396,420,-2,26,-31,-2,-1,1,0,4,3,7,-5,6,1,-1,3,2,1,1,2,0,3,5,0,-6,6,-3,0,-1,-1,-1,1,-1,3,-1
KR_6765927452,420,-4,-50,-8,-7,-2,3,1,-2,3,1,-2,2,0,1,1,2,-2,2,0,0,-1,-5,-3,-4,7,-3,0,0,1,1,0,1,6,-1
KR_6666797059,420,2,31,-5,-2,2,1,3,-2,5,3,-2,2,0,1,3,4,-1,2,1,1,2,-10,0,-5,5,5,0,-1,-1,-1,-1,1,5,-1
KR_6759593393,420,2,6,18,5,8,2,10,-4,5,1,4,1,5,-4,5,1,1,0,1,0,-4,-2,1,-5,4,2,0,0,1,-1,1,-1,1,-1
KR_6697185670,420,-5,-61,1,-9,-3,4,1,1,2,3,-1,5,4,-5,7,2,-1,3,2,0,-15,12,4,-6,2,-6,0,-1,-1,1,-1,-1,2,-1
KR_6762074069,420,-4,-52,-34,2,-3,6,3,0,3,3,4,2,6,2,0,2,-1,1,0,-1,-3,256,3,-8,5,-2,0,-1,1,1,-1,-1,1,-1
KR_6766196203,420,0,45,20,0,-1,3,2,3,0,3,0,4,4,-2,3,1,0,0,0,0,2,-207,-1,-4,5,1,0,0,1,1,0,1,1,-1
KR_6625242866,420,-3,-54,-3,-8,-3,5,2,-1,3,2,-4,6,2,0,2,2,0,1,1,0,-7,-40,-7,-1,8,-1,0,-1,-1,-1,-1,-1,3,-1
KR_6727012038,420,0,-4,8,0,1,1,2,-5,5,0,0,1,1,4,1,5,0,1,1,1,2,-138,3,-8,5,-4,0,-1,-1,1,-1,1,5,-1
KR_6763832565,420,-3,-47,16,-10,-6,7,1,-6,6,0,2,0,2,-2,3,1,2,0,2,-1,-10,-54,3,-6,3,18,0,-2,-1,-1,-1,-1,3,-1
KR_6353130289,420,-2,-67,3,-3,-3,3,0,0,1,1,-3,3,0,1,1,2,2,0,2,0,-1,0,0,0,0,-7,0,-2,1,-1,-1,-1,5,-1
KR_6746550372,420,0,-6,-26,-5,-8,9,1,-2,3,1,-4,4,0,9,0,9,0,0,0,0,0,-6,-6,-4,10,0,0,-2,-1,-1,-1,-1,5,-1
KR_6756505722,420,4,-17,24,6,-2,4,2,0,3,3,9,1,10,1,3,4,-2,2,0,0,16,-23,-3,-3,6,12,0,0,1,1,1,-1,5,-1
KR_6700615509,420,-1,-1,-4,-9,-2,7,5,2,1,3,-2,4,2,-3,4,1,-4,4,0,-1,-16,-18,1,-5,4,-5,0,0,-1,-1,-1,-1,6,-1
KR_6740246025,420,-4,-83,20,-4,-3,3,0,-1,5,4,-1,3,2,-1,4,3,2,0,2,-1,-4,-2,-6,-3,9,-3,0,0,0,0,-1,-1,0,-1
KR_6761664239,440,1,-14,29,1,5,0,5,0,4,4,1,2,3,-5,8,3,0,1,1,0,2,51,3,-6,3,-1,0,1,-1,1,1,-1,1,-1
KR_6755138544,420,-3,-13,16,-2,-2,3,1,-1,6,5,0,3,3,2,2,4,-1,2,1,0,-3,0,2,-6,4,3,0,-1,-1,1,-1,-1,6,-1
KR_6715761415,420,-5,-32,-32,-11,-2,4,2,-2,5,3,1,2,3,-7,9,2,-1,2,1,-2,-14,-40,-5,-4,9,-1,0,-1,-1,1,-1,-1,4,-1
KR_6739297958,420,-8,-78,-4,-17,-5,5,0,-8,8,0,0,2,2,-2,4,2,-2,2,0,0,-17,-3,-1,-4,5,-3,0,-2,-1,-1,-1,-1,4,-1
KR_6720738997,420,2,2,57,4,0,0,0,3,1,4,5,1,6,-2,2,0,-2,2,0,0,1,40,4,-6,2,-1,0,1,1,1,1,1,3,-1
KR_6759791928,440,-3,-41,-17,-9,-2,2,0,-6,6,0,-1,4,3,2,2,4,-2,4,2,1,-6,-4,5,-8,3,0,0,0,-1,-1,-1,1,1,-1
KR_6761211504,420,-4,-84,-12,-9,-4,5,1,1,0,1,-2,4,2,-6,9,3,2,0,2,0,-6,-7,-6,-5,11,-1,0,-1,0,-1,-1,-1,0,-1
KR_6752246347,420,-3,15,9,-12,-4,4,0,-5,5,0,0,1,1,-3,4,1,0,0,0,0,-15,2,-5,-3,8,1,0,-1,1,-1,-1,-1,6,-1
KR_6751106328,420,-3,-12,-32,3,1,1,2,1,3,4,4,0,4,-3,4,1,0,0,0,1,1,-3,4,-9,5,-2,0,-1,0,-1,-1,1,0,-1
KR_6640956976,440,0,-96,-4,1,0,3,3,1,2,3,3,0,3,-3,3,0,0,0,0,-1,6,85,3,-5,2,-7,0,-1,-1,-1,-1,-1,4,-1
KR_6759359526,420,-2,-24,2,2,2,0,2,0,1,1,1,4,5,2,1,3,-3,3,0,2,7,-10,-1,-6,7,2,0,0,1,1,0,1,6,-1
KR_6548288944,420,-4,-12,-12,-6,4,3,7,-4,6,2,-3,4,1,-5,7,2,2,1,3,2,-2,-34,-2,-4,6,1,0,-1,0,-1,-1,1,0,-1
KR_6681346155,420,-3,-22,3,-11,-3,3,0,2,4,6,-1,2,1,-8,9,1,-1,1,0,0,-9,-2,-1,-6,7,-3,0,-3,-1,1,-1,1,4,-1
KR_6703266391,440,0,6,-4,-6,-1,1,0,-3,4,1,1,2,3,-4,5,1,1,0,1,0,-6,-8,2,-5,3,4,0,-2,-1,-1,-1,-1,2,-1
KR_6762063086,420,-4,-61,16,-12,1,3,4,-2,4,2,-4,4,0,-7,7,0,0,0,0,0,-11,-27,-4,-3,7,-1,0,-2,-1,-1,-1,-1,6,-1
KR_6762909573,420,-2,-29,-39,0,1,0,1,2,1,3,1,1,2,-2,6,4,-2,3,1,-1,0,-22,-2,-6,8,1,0,0,-1,1,-1,-1,5,-1
KR_6695646751,420,1,-3,30,6,-1,4,3,4,2,6,3,0,3,3,2,5,-3,4,1,0,4,34,5,-7,2,-2,0,-1,1,-1,-1,-1,4,-1
KR_6677804526,420,-1,12,4,1,1,2,3,-1,2,1,3,0,3,-1,3,2,-1,2,1,0,-2,-4,-3,-4,7,0,0,0,-1,-1,1,-1,5,-1
KR_6733225160,420,1,-11,-16,4,0,3,3,3,3,6,0,4,4,0,2,2,1,2,3,0,0,10,0,-5,5,-1,0,1,-1,1,1,-1,5,-1
KR_6754801906,420,-3,-16,-5,-7,-3,3,0,-4,5,1,-3,3,0,3,1,4,0,1,1,0,-3,-1,3,-8,5,3,0,-3,1,-1,-1,-1,1,-1
KR_6716668932,440,1,-59,9,3,-1,2,1,6,0,6,1,3,4,0,2,2,-3,4,1,0,2,-9,3,-6,3,-5,0,1,-1,-1,1,-1,5,-1
KR_6753989236,420,-1,-2,-4,-4,0,2,2,-2,4,2,1,1,2,-5,7,2,2,3,5,0,-6,1,-3,-3,6,2,0,0,0,1,0,-1,0,-1
KR_6711882032,420,-3,36,-47,-17,-2,4,2,3,4,7,-7,8,1,-5,7,2,-6,6,0,0,-50,-403,-4,-3,7,1,0,0,1,-1,1,1,5,-1
KR_6629448412,420,0,-4,7,2,0,1,1,1,3,4,-1,4,3,1,4,5,1,1,2,0,1,-2,5,-9,4,0,0,0,0,-1,0,1,0,-1
KR_6753706258,420,-3,-39,27,-7,1,1,2,-3,6,3,0,2,2,-4,4,0,-1,1,0,-2,-14,115,-6,-3,9,-1,0,-1,1,-1,-1,-1,1,-1
KR_6615464750,420,-1,-39,-24,-2,2,0,2,2,3,5,1,2,3,-5,6,1,-2,4,2,0,-3,-16,6,-10,4,-4,0,-1,-1,0,-1,1,4,-1
KR_6731565761,420,-3,-32,-6,-5,-4,5,1,-3,7,4,0,0,0,1,2,3,1,0,1,0,-4,23,-3,-3,6,-2,0,-1,-1,1,-1,1,3,-1
KR_6758143243,420,-9,-130,-51,-14,-1,3,2,0,2,2,-7,8,1,-4,6,2,-2,2,0,-1,-8,-2,2,-6,4,-10,0,-3,-1,-1,-1,-1,5,-1
KR_6751362704,420,-2,-10,-4,-4,-2,3,1,-1,1,0,7,2,9,-5,6,1,-3,3,0,0,-2,-3,0,-1,1,1,0,0,-1,0,0,-1,6,-1
KR_6730749372,440,-2,-17,-28,-2,-4,6,2,-2,4,2,-4,4,0,1,0,1,7,0,7,0,-2,-465,0,-2,2,0,0,-1,-1,1,-1,1,4,-1
KR_6738085545,420,-3,-6,-16,-5,-6,7,1,3,1,4,-1,4,3,-1,2,1,0,0,0,0,1,-8,-4,-2,6,-4,0,-2,-1,-1,-1,-1,6,-1
KR_6763507836,420,-4,-62,-6,-4,-5,5,0,0,3,3,-1,2,1,-2,7,5,4,2,6,1,-2,7,4,-8,4,-1,0,-2,1,-1,-1,1,5,-1
KR_6692484343,420,-2,-86,24,-11,-3,3,0,2,1,3,-1,3,2,-7,7,0,-2,3,1,2,-8,6,3,-7,4,0,0,-2,-1,-1,-1,1,2,-1
KR_6755429901,420,0,-16,-28,3,2,0,2,1,3,4,-3,3,0,3,3,6,0,1,1,0,2,-21,-1,-6,7,-2,0,-1,0,0,-1,-1,0,-1
KR_6662468617,420,-6,-106,-56,-10,2,1,3,-3,4,1,-9,9,0,-2,4,2,2,0,2,-2,-8,-5,-1,-4,5,-3,0,-3,-1,-1,-1,1,6,-1
KR_6729381447,420,-4,-46,-17,-6,2,1,3,-6,7,1,-3,3,0,-1,4,3,2,2,4,0,-1,-77,-3,-8,11,-1,0,-2,-1,-1,-1,1,4,-1
KR_6746823438,420,0,14,-6,-3,1,2,3,-2,3,1,-1,4,3,1,4,5,-2,2,0,0,-9,18,-2,-5,7,-8,0,2,-1,-1,1,1,3,-1
KR_6753290275,420,-6,-52,-19,-16,-2,2,0,3,0,3,-3,5,2,-14,16,2,0,1,1,-1,-18,-31,-2,-2,4,1,0,-2,0,-1,-1,-1,0,-1
KR_6712441360,440,-6,-91,24,-13,-3,5,2,-4,4,0,-2,4,2,-3,6,3,-1,2,1,0,-11,1,-2,-6,8,-4,0,-2,-1,-1,-1,-1,2,-1
KR_6733711102,440,0,-17,-1,-2,-3,3,0,-1,2,1,-3,4,1,3,0,3,2,0,2,0,-5,-32,3,-4,1,16,0,-1,-1,-1,-1,-1,1,-1
KR_6757068668,420,-3,11,6,-12,-1,1,0,-2,2,0,-2,2,0,-5,6,1,-2,2,0,0,-10,8,1,-6,5,-6,0,-1,-1,1,1,-1,4,-1
KR_6651035360,420,-2,-16,-31,-7,-2,2,0,0,4,4,-2,2,0,-3,5,2,0,0,0,0,-6,-4,-4,-4,8,-7,0,0,-1,-1,0,-1,4,-1
KR_6743047844,440,-4,-57,-8,-9,2,1,3,-6,8,2,-2,5,3,-4,6,2,1,1,2,1,-5,-17,0,-3,3,0,0,-1,1,0,-1,1,1,-1
KR_6746363417,440,-3,-35,4,-8,-6,6,0,-3,5,2,5,0,5,0,0,0,-4,5,1,0,-4,-11,-1,-7,8,4,0,-3,-1,0,-1,1,3,-1
KR_6582730352,420,-4,-60,-17,-16,0,3,3,-8,12,4,-1,3,2,-3,5,2,-4,4,0,-1,-17,4,2,-8,6,4,0,-1,1,0,-1,-1,6,-1
KR_6763143901,420,-6,-75,-9,-2,1,0,1,-3,6,3,0,3,3,-1,3,2,1,0,1,0,3,5,1,-8,7,-5,0,0,-1,1,-1,1,4,-1
KR_6756772113,420,0,-21,-34,0,0,2,2,-3,6,3,6,1,7,-1,3,2,-2,2,0,2,9,-12,8,-9,1,0,0,0,-1,-1,0,1,6,-1
KR_6750472663,420,0,2,-30,4,1,1,2,3,2,5,-5,6,1,6,1,7,-1,1,0,0,6,0,-6,-3,9,2,0,1,1,1,1,1,4,-1
KR_6681817932,420,-1,-80,6,-3,-3,6,3,3,2,5,2,3,5,-4,5,1,-1,1,0,0,2,2,3,-7,4,-2,0,0,1,-1,-1,-1,2,-1
KR_6762895112,420,-6,-85,-92,-5,-2,2,0,2,3,5,-3,3,0,0,3,3,-2,3,1,0,3,68,-3,-3,6,17,0,-2,0,-1,-1,-1,0,-1
KR_6742424584,420,2,9,-23,3,-2,4,2,2,2,4,1,0,1,2,4,6,0,0,0,0,7,3,3,-9,6,0,0,0,-1,-1,0,1,3,-1
KR_6761632894,420,0,2,4,0,0,3,3,-1,4,3,2,0,2,-1,2,1,0,2,2,0,-1,3,-1,-4,5,3,0,0,1,1,1,-1,2,-1
KR_6699879089,420,-2,-48,0,-2,0,3,3,4,2,6,-3,4,1,-2,2,0,-1,2,1,1,-8,-4,1,-6,5,1,0,-1,1,-1,-1,1,4,-1
KR_6757772794,420,-2,-14,-8,-5,1,1,2,1,2,3,0,1,1,-5,6,1,-2,2,0,-1,-8,-3,-4,-5,9,0,0,-1,-1,-1,-1,-1,3,-1
KR_6761099098,420,0,-14,19,-1,2,0,2,-1,1,0,2,0,2,-2,6,4,-2,2,0,0,3,-5,1,-4,3,-2,0,-1,1,1,-1,-1,1,-1
KR_6403245329,420,-4,-40,31,-8,1,1,2,-1,2,1,-1,3,2,-5,5,0,-2,3,1,-1,-15,-33,-7,-7,14,3,0,-1,-1,1,-1,-1,5,-1
KR_6704842052,420,-1,-16,-18,-1,-3,4,1,-3,3,0,6,2,8,-1,1,0,0,2,2,0,-3,11,0,-2,2,0,0,-1,0,0,-1,1,0,-1
KR_6729767464,420,-1,-43,-15,-8,1,3,4,-1,6,5,-8,8,0,-2,7,5,2,3,5,0,1,12,8,-10,2,-2,0,-1,-1,-1,-1,-1,6,-1
KR_6637190228,420,-3,-11,-16,-7,0,1,1,1,0,1,1,1,2,-9,10,1,0,0,0,0,-5,0,-2,-3,5,0,0,0,1,-1,0,-1,5,-1
KR_6758196718,440,-1,-8,-44,-10,1,2,3,-4,5,1,-5,6,1,2,3,5,-4,4,0,-1,-8,-3,-1,-1,2,0,0,0,-1,-1,0,-1,1,-1
KR_6741681688,420,-4,-93,24,-15,-1,2,1,-3,6,3,-7,7,0,-4,6,2,0,1,1,0,-6,7,-6,-1,7,1,0,-1,1,1,-1,1,3,-1
KR_6739161097,420,0,41,7,1,1,0,1,-1,2,1,5,1,6,0,5,5,-4,5,1,0,4,35,3,-6,3,-2,0,1,-1,1,1,-1,4,-1
KR_6747517020,440,-3,-68,-12,-13,-4,5,1,-7,8,1,3,0,3,-4,5,1,-1,3,2,0,-14,-21,2,-7,5,3,0,-1,-1,1,-1,-1,4,-1
KR_6743742242,420,-1,-10,8,-5,1,1,2,1,1,2,-5,5,0,-2,2,0,0,3,3,0,-5,28,-5,-4,9,-22,0,0,1,1,-1,-1,1,-1
KR_6686505360,420,0,10,-7,2,2,2,4,-1,3,2,-2,3,1,3,2,5,0,0,0,0,-2,-24,-2,-4,6,2,0,1,-1,1,1,1,1,-1
KR_6738177276,420,-2,-9,-2,2,-2,3,1,2,1,3,-2,3,1,3,6,9,1,0,1,3,8,35,4,-8,4,6,0,0,1,-1,0,1,6,-1
KR_6757655076,440,-5,-12,-16,-13,-3,4,1,-1,3,2,-3,5,2,0,2,2,-6,7,1,0,-18,-7,-5,-3,8,-1,0,-1,-1,1,1,1,3,-1
KR_6670827623,420,-5,-61,-9,-10,1,1,2,-2,4,2,-1,1,0,-8,10,2,0,1,1,0,-11,-292,1,-6,5,-2,0,-1,-1,1,-1,-1,2,-1
KR_6763647780,420,1,18,8,5,5,0,5,4,1,5,-3,3,0,0,6,6,-1,1,0,-1,1,-5,-3,-4,7,4,0,0,-1,1,0,1,3,-1
KR_6733970704,420,-2,-5,4,-7,1,0,1,-2,3,1,-2,3,1,-4,6,2,0,0,0,0,-8,-8,-4,-6,10,2,0,0,-1,1,-1,1,4,-1
KR_6752874201,420,-2,1,-13,-7,1,1,2,1,1,2,-6,7,1,-2,4,2,-1,2,1,0,-15,-17,-4,-6,10,-1,0,-1,0,-1,-1,-1,0,-1
KR_6736931349,420,-3,-31,-4,-3,1,1,2,4,2,6,-5,8,3,-3,5,2,0,1,1,0,-2,-21,6,-10,4,-5,0,-1,-1,-1,-1,-1,6,-1
KR_6760824113,420,-5,-33,-33,-8,0,1,1,-1,2,1,-6,8,2,0,3,3,-1,3,2,-1,-6,3,1,-5,4,-2,0,0,-1,-1,-1,-1,3,-1
KR_6676008747,420,-2,18,-8,-3,-4,4,0,-1,3,2,7,0,7,-4,6,2,-1,1,0,0,-6,6,0,-6,6,-2,0,1,-1,-1,1,1,1,-1
KR_6633272670,420,2,-9,8,2,-1,2,1,2,2,4,1,1,2,4,2,6,-4,4,0,0,10,6,2,-6,4,-3,0,0,-1,-1,0,-1,5,-1
KR_6763316779,420,-1,3,-21,2,1,0,1,-2,4,2,1,2,3,5,1,6,-3,5,2,0,-1,5,3,-7,4,-2,0,0,1,1,0,1,5,-1
KR_6694123267,420,-1,-50,-12,-2,-1,2,1,-5,7,2,-1,3,2,2,1,3,3,0,3,0,1,121,7,-10,3,-5,0,-1,1,-1,-1,-1,2,-1
KR_6755139207,420,-4,-23,-16,-1,-2,3,1,-1,3,2,0,3,3,-2,2,0,4,1,5,0,2,-4,-3,-3,6,5,0,-1,1,-1,-1,-1,4,-1
KR_6741316528,420,-5,-86,-25,-11,-4,4,0,-1,6,5,-3,7,4,-3,5,2,0,0,0,1,-4,-9,3,-7,4,-1,0,-1,-1,-1,-1,1,4,-1
KR_6740958856,420,0,92,-17,0,1,0,1,-4,6,2,3,0,3,1,3,4,-1,2,1,0,-1,4,-2,-4,6,2,0,0,1,-1,-1,1,6,-1
KR_6762761672,440,-3,-83,-11,-8,-2,3,1,-2,3,1,-2,3,1,-1,3,2,-1,1,0,0,-2,-4,0,-3,3,0,0,-2,1,-1,-1,-1,2,-1
KR_6428952846,440,1,-25,0,-1,-5,5,0,-1,2,1,3,2,5,1,1,2,1,0,1,0,8,59,1,-4,3,-1,0,-1,1,0,-1,1,4,-1
KR_6742625317,420,2,22,-26,2,2,1,3,0,3,3,2,2,4,-1,5,4,-1,2,1,0,9,-20,2,-6,4,-1,0,1,1,-1,1,-1,1,-1
KR_6721567883,420,-2,-102,1,-5,-4,5,1,-4,5,1,1,3,4,2,0,2,0,0,0,0,-3,18,-6,0,6,-4,0,-2,1,-1,-1,-1,6,-1
KR_6676556998,420,-2,-77,8,-1,-2,2,0,0,3,3,2,0,2,0,0,0,-1,1,0,0,-2,13,1,-4,3,-3,0,-1,-1,-1,-1,-1,4,-1
KR_6754757437,420,-4,-82,7,-7,0,5,5,1,2,3,-3,4,1,-2,3,1,-3,5,2,1,-4,-132,1,-7,6,-3,0,0,-1,1,-1,1,4,-1
KR_6744039300,420,1,-32,17,1,-2,4,2,-2,3,1,2,2,4,1,3,4,2,2,4,0,-6,6,0,-6,6,1,0,-1,0,0,1,1,0,-1
KR_6733138392,420,-3,-13,-4,0,-1,3,2,-3,5,2,0,2,2,2,1,3,2,1,3,2,3,14,0,-6,6,7,0,-1,1,-1,-1,1,5,-1
KR_6684970427,420,1,-46,0,-2,4,0,4,0,4,4,1,1,2,-5,8,3,-2,2,0,0,-6,1,1,-5,4,-2,0,-1,-1,0,-1,-1,2,-1
KR_6752038579,440,-4,-81,-48,-3,-8,8,0,1,3,4,2,4,6,1,1,2,1,0,1,-1,7,-8,1,-5,4,-1,0,-1,-1,-1,-1,1,4,-1
KR_6762581767,420,-1,21,-3,-1,-4,4,0,1,2,3,0,4,4,0,4,4,2,0,2,0,7,1,-1,-4,5,-5,0,-1,1,-1,-1,1,6,-1
KR_6751526449,440,-4,-94,0,-4,-4,4,0,1,1,2,-2,2,0,-2,10,8,3,0,3,0,-7,4,1,-8,7,3,0,-2,0,1,-1,-1,0,-1
KR_6759206308,420,-1,-54,-4,-3,-2,4,2,-1,2,1,3,0,3,-3,6,3,0,2,2,0,4,-46,0,-5,5,17,0,-2,1,-1,-1,1,6,-1
KR_6746038889,420,-4,-44,-7,-10,0,1,1,-5,5,0,-2,3,1,-3,3,0,0,2,2,-1,-18,4,-1,-5,6,-3,0,0,-1,1,0,-1,6,-1
KR_6759543723,440,-3,-63,-5,-2,-2,2,0,1,1,2,-2,4,2,3,1,4,-2,2,0,0,2,-4,-3,-3,6,-8,0,-1,-1,1,-1,-1,6,-1
KR_6692947001,420,-4,-23,4,-8,-5,6,1,-3,4,1,-3,5,2,2,3,5,1,0,1,0,-7,6,8,-14,6,0,0,0,1,-1,-1,1,3,-1
KR_6743975211,420,-5,-3,16,-19,-1,2,1,-3,7,4,-5,6,1,-10,10,0,0,1,1,0,-17,-4,-3,-2,5,-1,0,-2,-1,1,-1,1,2,-1
KR_6758433207,420,-1,4,16,-1,-1,3,2,0,4,4,-2,2,0,4,0,4,-2,2,0,0,4,4,1,-3,2,-2,0,2,-1,-1,1,1,3,-1
KR_6742879981,440,-7,-116,-20,1,-1,2,1,-3,4,1,1,2,3,2,3,5,2,1,3,0,-3,-20,-7,-1,8,1,0,-4,-1,-1,-1,1,5,-1
KR_6733830512,440,-5,-1,-22,-18,-5,6,1,-4,5,1,0,1,1,-6,6,0,-3,3,0,0,-27,-10,-5,-3,8,4,0,1,1,-1,-1,-1,6,-1
KR_6695954651,420,-1,-23,-2,-1,-1,4,3,3,1,4,0,4,4,-2,2,0,-1,2,1,0,-7,3,-4,-3,7,1,0,0,-1,-1,1,1,1,-1
KR_6757003224,420,-2,-38,22,1,-2,2,0,-1,4,3,2,0,2,4,0,4,-2,2,0,0,5,-1,0,-3,3,-3,0,0,1,-1,1,-1,3,-1
KR_6765639886,420,-3,-8,16,-9,-1,2,1,-5,7,2,-3,3,0,-1,2,1,1,0,1,0,-12,-7,-1,-4,5,1,0,0,1,1,0,-1,1,-1
KR_6675301687,420,0,27,16,-7,1,0,1,-5,6,1,2,1,3,-3,5,2,-2,3,1,0,-12,6,0,-5,5,-2,0,0,1,-1,0,1,6,-1
KR_6704143347,420,2,20,24,-1,2,1,3,2,1,3,-3,6,3,-1,1,0,-1,1,0,0,1,-7,-4,-2,6,1,0,-1,-1,1,-1,-1,5,-1
KR_6696536012,440,1,55,-1,-3,3,0,3,1,0,1,-2,5,3,-3,5,2,-2,2,0,0,-6,24,-3,-6,9,-7,0,-1,-1,1,1,1,3,-1
KR_6762461779,440,-3,-32,-28,-2,0,1,1,-1,2,1,0,3,3,-1,4,3,0,0,0,0,-5,-10,0,-6,6,-3,0,-1,1,-1,-1,1,1,-1
KR_6692314569,420,0,-5,-17,-6,2,0,2,0,2,2,-4,4,0,-3,6,3,-1,2,1,0,-6,106,4,-8,4,-8,0,2,-1,1,-1,-1,3,-1
KR_6656934775,420,-1,40,-4,-2,0,2,2,0,2,2,-3,4,1,-1,1,0,2,1,3,0,-5,3,-1,-5,6,-1,0,0,1,-1,0,-1,1,-1
KR_6737919482,420,-3,-70,28,-7,-2,3,1,-4,8,4,1,2,3,-3,4,1,1,0,1,-1,-15,-4,-7,-3,10,3,0,0,-1,1,-1,-1,4,-1
KR_6764444554,420,0,-19,-20,0,-3,4,1,4,3,7,-3,5,2,-2,3,1,4,0,4,0,1,-424,-2,-4,6,-4,0,1,-1,1,1,1,4,-1
KR_6758912561,420,-3,-28,-24,-8,-3,3,0,-4,6,2,2,0,2,-9,9,0,6,1,7,-1,-1,3,1,-2,1,1,0,-1,0,-1,-1,-1,0,-1
KR_6739020613,420,1,19,0,-1,1,2,3,0,1,1,-1,1,0,-1,2,1,0,0,0,0,-4,-5,2,-6,4,4,0,-1,1,-1,-1,-1,2,-1
KR_6711925112,420,-3,-40,-47,-10,-2,5,3,0,2,2,2,1,3,-6,6,0,-4,4,0,0,-11,-36,-2,-3,5,-6,0,-2,-1,-1,-1,-1,2,-1
KR_6760963782,420,-1,13,-13,-6,2,1,3,1,0,1,-1,2,1,-5,5,0,-3,4,1,1,-20,-6,1,-8,7,-1,0,1,-1,1,1,1,4,-1
KR_6717493741,420,-1,-14,-1,-20,0,2,2,-3,5,2,-7,8,1,-6,8,2,-4,5,1,-1,-14,15,1,-6,5,-5,0,-2,0,-1,-1,-1,0,-1
KR_6763339864,420,-2,-35,-28,-9,0,1,1,-2,3,1,-4,9,5,-1,1,0,-2,2,0,0,-3,3,2,-2,0,1,0,-2,0,-1,-1,1,0,-1
KR_6530425377,420,2,-13,32,6,3,1,4,3,3,6,6,0,6,-6,6,0,0,1,1,0,1,35,-1,-6,7,0,0,-1,-1,1,1,-1,5,-1
KR_6684117772,420,-4,-18,-48,-7,0,1,1,-1,2,1,-2,3,1,-4,7,3,0,1,1,-3,-18,4,-1,-6,7,3,0,-1,-1,-1,-1,-1,6,-1
KR_6703953985,420,1,-2,-20,1,3,1,4,1,3,4,-2,4,2,1,4,5,-2,2,0,0,-1,36,-1,-4,5,-5,0,0,-1,1,-1,1,5,-1
KR_6711984897,420,-1,20,-41,4,1,0,1,1,3,4,-1,3,2,1,2,3,2,0,2,0,3,146,0,-4,4,4,0,1,1,1,1,-1,3,-1
KR_6758972232,420,0,34,-20,6,-1,3,2,3,1,4,4,0,4,0,0,0,0,0,0,0,7,-3,2,-5,3,-3,0,0,1,-1,0,1,5,-1
KR_6727200253,420,-4,-2,27,-13,-3,3,0,-2,3,1,-6,6,0,-1,3,2,-1,1,0,0,-14,-39,1,-6,5,-5,0,-3,-1,1,-1,-1,2,-1
KR_6694841407,420,3,79,-6,6,5,3,8,-1,2,1,0,4,4,1,3,4,1,0,1,0,8,31,-1,-3,4,1,0,1,1,1,1,-1,6,-1
KR_6733682545,420,-9,-114,-20,-9,0,1,1,-2,4,2,-2,3,1,-3,3,0,-2,2,0,0,-11,-4,-1,-3,4,-1,0,-3,-1,-1,-1,1,4,-1
KR_6226930405,420,-5,-74,-13,-13,-1,2,1,-3,4,1,-4,5,1,-5,5,0,0,1,1,0,-21,-3,-1,-2,3,-3,0,-4,-1,-1,-1,-1,6,-1
KR_6151280441,420,1,-43,-21,5,-1,3,2,1,3,4,4,1,5,1,1,2,0,2,2,0,3,-1,0,-6,6,2,0,-1,-1,-1,-1,-1,1,-1
KR_6645973114,420,-2,-54,1,-9,2,0,2,-1,5,4,-4,4,0,-5,6,1,-1,1,0,0,-13,-11,-5,-3,8,4,0,-3,-1,-1,-1,-1,4,-1
KR_6733124736,420,-5,-23,-1,-16,1,2,3,-5,6,1,-5,6,1,-6,8,2,-1,1,0,0,-14,-2,-4,-2,6,2,0,-1,-1,-1,-1,-1,4,-1
KR_6652238609,420,1,-22,21,2,1,1,2,-1,3,2,0,1,1,1,0,1,1,0,1,0,6,4,2,-5,3,0,0,-1,-1,1,-1,1,4,-1
KR_6687929233,420,-2,-25,-22,-7,3,0,3,-4,5,1,-2,3,1,-3,4,1,-1,1,0,0,-15,-2,-3,-2,5,3,0,-2,-1,-1,-1,-1,1,-1
KR_6705186347,420,0,-38,-9,-1,-1,2,1,1,3,4,0,1,1,-1,2,1,0,1,1,0,-5,-4,1,-6,5,-1,0,0,-1,1,-1,-1,4,-1
KR_6761241713,440,1,27,13,4,5,0,5,-3,4,1,1,0,1,0,1,1,1,1,2,0,-3,2,1,-3,2,-1,0,1,-1,1,1,1,1,-1
KR_6669629713,420,-4,-46,-22,-1,1,0,1,1,1,2,-7,9,2,2,3,5,2,1,3,0,6,0,0,-4,4,1,0,0,-1,-1,-1,-1,4,-1
KR_6763220759,420,-6,-112,-23,-13,-2,2,0,-10,10,0,0,1,1,-2,3,1,1,0,1,0,-15,-20,5,-9,4,-7,0,-1,-1,0,-1,-1,5,-1
KR_6739689224,420,0,-4,-7,-1,-5,6,1,3,0,3,-2,4,2,2,2,4,1,0,1,0,9,2,0,-4,4,5,0,0,-1,1,1,-1,6,-1
KR_6764133212,420,-1,55,-1,4,-1,2,1,1,1,2,-1,4,3,4,1,5,1,1,2,0,3,188,-1,-6,7,-3,0,1,0,-1,1,-1,0,-1
KR_6720635226,420,2,90,9,10,7,0,7,2,3,5,3,0,3,-3,6,3,1,0,1,1,14,3,-1,-4,5,3,0,-1,1,-1,-1,-1,4,-1
KR_6686525598,420,-8,-70,-47,-6,1,2,3,-5,8,3,0,5,5,-4,8,4,2,1,3,0,-11,-9,2,-6,4,-4,0,-1,-1,1,-1,1,1,-1
KR_6704475510,420,-7,-145,-38,-21,-5,5,0,-8,9,1,1,1,2,-6,7,1,-3,4,1,-1,-22,40,1,-2,1,-24,0,-2,-1,-1,-1,-1,6,-1
KR_6634545239,420,-1,-25,-29,1,2,2,4,-2,3,1,-2,2,0,0,3,3,3,0,3,0,5,1,0,-5,5,-4,0,0,-1,-1,0,-1,6,-1
KR_6758658760,420,-5,-2,-37,-13,-3,5,2,-7,7,0,-3,4,1,-1,3,2,1,0,1,1,-19,0,-3,-3,6,1,0,-2,-1,-1,-1,1,3,-1
KR_6707604227,420,-4,-33,-4,-10,-1,2,1,-10,11,1,-1,2,1,3,1,4,-1,1,0,0,-17,102,2,-6,4,3,0,-1,-1,-1,-1,-1,3,-1
KR_6753722412,420,1,47,0,4,0,2,2,3,1,4,4,0,4,-4,6,2,1,2,3,0,-1,2,-3,-5,8,-1,0,1,1,-1,1,1,5,-1
KR_6762972547,420,-4,-40,-8,-4,0,2,2,-4,5,1,-1,3,2,0,2,2,1,1,2,0,-9,5,0,-6,6,-3,0,0,1,1,0,1,4,-1
KR_6762418197,420,-2,-60,-15,-1,-1,2,1,-1,1,0,3,3,6,-1,4,3,-1,2,1,0,-4,14,-4,-3,7,-5,0,0,-1,-1,1,-1,4,-1
KR_6755848370,420,-3,-10,18,-7,-4,4,0,2,4,6,1,0,1,-3,6,3,-3,3,0,0,-14,-3,-5,-2,7,1,0,0,-1,1,0,1,2,-1
KR_6758469293,420,-2,-75,-20,-1,2,2,4,-3,4,1,-1,1,0,1,3,4,0,1,1,0,-8,-63,-4,-3,7,20,0,-1,-1,-1,-1,1,3,-1
KR_6691318398,420,0,17,-17,-1,2,0,2,-3,4,1,3,1,4,-3,6,3,0,1,1,0,-6,328,0,-7,7,3,0,-1,-1,-1,-1,-1,6,-1
KR_6711946524,420,4,26,-16,7,2,0,2,2,5,7,1,0,1,0,2,2,2,0,2,0,9,200,0,-7,7,-1,0,0,1,1,1,1,6,-1
KR_6668678861,440,-5,-145,-16,-10,-4,5,1,0,1,1,-5,5,0,-1,3,2,0,3,3,0,-7,4,0,-2,2,0,0,-2,-1,0,-1,-1,3,-1
KR_6757664707,420,0,25,39,0,4,0,4,-2,4,2,-1,2,1,0,3,3,-1,2,1,0,-6,-7,-1,-5,6,-1,0,0,-1,1,1,1,6,-1
KR_6696970307,420,1,-6,-4,-3,-3,5,2,-1,2,1,-1,6,5,2,0,2,0,1,1,-1,6,-7,-4,-7,11,4,0,-1,0,-1,-1,-1,0,-1
KR_6760235088,420,-2,-20,9,-9,-2,2,0,-7,10,3,-3,4,1,1,0,1,2,0,2,-1,-4,-7,-2,-5,7,2,0,0,-1,-1,-1,-1,1,-1
KR_6741373338,420,2,38,6,5,0,1,1,-2,6,4,0,1,1,2,0,2,5,0,5,0,8,-5,-7,-4,11,4,0,0,-1,-1,0,-1,5,-1
KR_6757928864,420,1,-16,8,5,-3,5,2,-3,4,1,1,0,1,4,2,6,6,0,6,0,6,3,-1,-4,5,4,0,0,1,-1,-1,1,5,-1
KR_6746193876,420,-4,-23,8,-9,1,0,1,-4,5,1,-1,3,2,-4,6,2,-1,1,0,1,-10,-45,-1,-6,7,26,0,0,-1,-1,-1,1,4,-1
KR_6722489634,420,-2,-22,8,-11,-1,2,1,-3,4,1,-1,6,5,-3,3,0,-3,3,0,1,-15,8,6,-10,4,-4,0,1,-1,1,1,1,1,-1
KR_6763710149,420,3,-51,53,-2,-1,1,0,-1,2,1,-1,4,3,3,1,4,-2,2,0,0,-3,6,4,-7,3,-2,0,2,1,1,1,-1,6,-1
KR_6746839113,420,1,22,8,6,-2,2,0,2,1,3,3,0,3,1,1,2,2,0,2,-1,14,0,4,-9,5,5,0,0,1,1,0,-1,2,-1
KR_6596004311,420,1,16,-7,-1,-4,5,1,-1,2,1,0,4,4,5,1,6,-1,3,2,0,-3,7,3,-5,2,0,0,0,-1,1,1,1,3,-1
KR_6765933815,420,1,-21,-8,0,0,2,2,0,4,4,-2,3,1,2,4,6,0,1,1,0,-5,5,0,-5,5,-6,0,0,1,1,0,1,3,-1
KR_6719050180,420,-8,-41,-36,-11,-1,5,4,-2,5,3,-5,9,4,-1,2,1,-2,2,0,0,0,-5,-2,-3,5,-3,0,-3,1,-1,-1,-1,2,-1
KR_6684057667,420,-2,-22,-8,-6,-3,8,5,-4,4,0,0,1,1,0,3,3,1,0,1,0,-7,-6,-3,-3,6,-1,0,-1,1,-1,-1,-1,1,-1
KR_6656453574,420,-1,-19,-5,4,0,1,1,4,1,5,0,1,1,0,3,3,0,2,2,0,7,18,0,-6,6,-4,0,0,-1,1,0,1,2,-1
KR_6590889720,420,-4,-64,9,-11,-3,4,1,-4,4,0,-1,1,0,-2,3,1,-1,2,1,0,-14,-5,0,-5,5,1,0,-2,1,-1,-1,-1,1,-1
KR_6743842565,420,-6,-21,-28,-8,-4,4,0,-5,9,4,1,2,3,1,0,1,-1,4,3,0,-1,-162,-1,-7,8,24,0,-2,-1,-1,-1,1,6,-1
KR_6748981022,420,-3,5,-7,-7,-1,1,0,-2,3,1,0,1,1,-2,3,1,-2,2,0,0,-8,24,5,-8,3,-27,0,-1,-1,1,-1,1,6,-1
KR_6763038479,420,-6,-39,-21,-17,0,1,1,-2,4,2,-7,8,1,-6,6,0,-2,2,0,0,-11,-6,-1,-8,9,-1,0,-1,-1,-1,-1,-1,6,-1
KR_6649748396,420,1,61,21,-1,-2,2,0,-1,2,1,-1,4,3,0,6,6,3,0,3,0,-10,-25,0,-7,7,6,0,1,0,1,1,1,0,-1
KR_6703641627,420,-1,12,-12,-2,0,2,2,0,5,5,-3,4,1,1,1,2,0,1,1,1,-1,7,3,-10,7,-6,0,0,0,0,0,1,0,-1
KR_6761377194,440,-1,62,-45,1,-2,2,0,-1,5,4,-1,2,1,5,1,6,0,0,0,0,4,-156,5,-9,4,-1,0,-1,-1,-1,-1,1,6,-1
KR_6694742090,440,-8,-119,-12,-25,-2,3,1,-2,3,1,-10,10,0,-12,12,0,1,3,4,-2,-19,13,-7,-2,9,-3,0,-2,0,-1,-1,-1,0,-1
KR_6762599075,420,-1,-4,-1,-5,1,0,1,-5,6,1,-3,5,2,0,1,1,2,0,2,0,-4,-12,-3,-2,5,-2,0,0,-1,-1,0,-1,4,-1
KR_6748965302,420,1,59,12,0,0,1,1,1,4,5,7,1,8,-1,1,0,-7,8,1,0,-11,1,-7,-2,9,1,0,0,-1,1,-1,-1,6,-1
KR_6734200760,420,-5,-162,8,-15,-3,3,0,0,1,1,-5,6,1,-7,8,1,0,0,0,-1,-8,10,3,-5,2,-11,0,-2,-1,-1,-1,-1,3,-1
KR_6579300581,420,0,-14,-10,-6,0,0,0,0,1,1,0,4,4,-5,5,0,-1,1,0,0,-6,-17,2,-4,2,2,0,-1,-1,-1,-1,-1,5,-1
KR_6765355433,420,-3,-93,21,-9,-4,6,2,-1,4,3,-2,3,1,-1,1,0,-1,2,1,0,-7,8,-4,-2,6,-4,0,-1,1,1,-1,-1,3,-1
KR_6757223751,420,2,90,-30,2,-2,2,0,0,1,1,-3,3,0,4,1,5,3,0,3,0,3,-6,-6,-4,10,5,0,1,1,-1,1,-1,4,-1
KR_6761263087,420,0,1,-7,6,0,1,1,-1,5,4,-3,4,1,6,1,7,4,1,5,1,5,255,2,-3,1,3,0,1,0,0,1,1,0,-1
KR_6690923635,420,-3,35,-24,-5,-7,7,0,-4,5,1,3,1,4,2,1,3,1,0,1,0,1,6,6,-7,1,-2,0,-1,-1,-1,-1,1,5,-1
KR_6763788171,440,-1,10,-10,3,-2,2,0,-3,6,3,4,3,7,-1,3,2,5,0,5,0,-4,-33,1,-4,3,-1,0,-1,0,-1,1,1,0,-1
KR_6757474388,420,-2,-17,-11,-6,0,0,0,3,2,5,-2,2,0,-6,6,0,-1,1,0,0,-13,201,2,-7,5,-7,0,-1,-1,-1,-1,1,4,-1
KR_6727044664,420,-5,-28,-17,-18,-1,2,1,-5,5,0,-3,4,1,-7,7,0,-2,4,2,0,-20,-9,2,-7,5,-2,0,-1,-1,-1,-1,-1,1,-1
KR_6701360659,420,-1,-40,-12,-2,4,0,4,-1,1,0,-7,10,3,1,1,2,1,1,2,0,12,3,-3,-6,9,-1,0,0,-1,1,-1,-1,6,-1
KR_6757764125,440,-3,16,-12,-11,-4,6,2,-4,6,2,-1,2,1,1,2,3,-3,3,0,-1,-25,186,-5,-5,10,-7,0,-1,-1,1,-1,-1,5,-1
KR_6754057426,420,1,-21,16,7,-1,2,1,3,1,4,5,2,7,1,3,4,-1,3,2,3,10,4,6,-10,4,-3,0,-1,1,1,-1,1,3,-1
KR_6519779017,420,-3,6,-11,-6,-1,4,3,1,3,4,-4,5,1,-2,4,2,0,3,3,1,-18,-108,2,-6,4,0,0,-1,0,-1,-1,1,0,-1
KR_6710522021,420,-6,-84,-13,-6,-4,6,2,-2,5,3,1,2,3,-2,5,3,1,5,6,1,-5,-3,-5,-4,9,-4,0,-3,-1,-1,-1,1,4,-1
KR_6654486508,420,1,20,17,2,2,0,2,-2,4,2,1,0,1,-3,7,4,4,1,5,-1,4,69,-4,-6,10,5,0,0,-1,1,-1,-1,3,-1
KR_6719799793,420,0,-58,0,2,3,0,3,1,0,1,3,1,4,-4,4,0,-1,2,1,0,-4,18,-2,-4,6,-3,0,-1,-1,1,-1,1,2,-1
KR_6760626694,440,0,22,-12,-2,-2,3,1,4,1,5,-4,6,2,-2,3,1,2,0,2,-1,-4,8,-3,-4,7,-5,0,0,-1,1,1,-1,4,-1
KR_6723193444,420,-1,-5,0,8,0,0,0,1,3,4,4,0,4,0,1,1,3,0,3,0,10,-2,-2,-5,7,-2,0,1,-1,1,-1,1,1,-1
KR_6712013503,420,0,-41,3,8,-1,2,1,5,3,8,1,2,3,-1,3,2,4,3,7,0,10,-3,-2,-3,5,3,0,-2,-1,-1,-1,1,6,-1
KR_6739767657,440,-4,0,-10,-7,-7,9,2,3,1,4,-5,6,1,3,2,5,-1,2,1,1,4,-8,1,-4,3,3,0,-3,1,-1,-1,1,4,-1
KR_6753487251,440,-2,-121,8,-4,-8,9,1,3,1,4,1,3,4,1,2,3,-1,2,1,-1,0,-3,1,-3,2,3,0,-1,-1,1,-1,-1,3,-1
KR_6670357889,420,-3,-53,1,-12,4,1,5,-7,8,1,-1,6,5,-7,7,0,-1,2,1,0,-11,-8,-2,-4,6,0,0,-2,-1,-1,-1,-1,6,-1
KR_6752057628,420,-1,-32,28,1,2,1,3,0,4,4,-2,2,0,2,1,3,-1,1,0,0,-2,-10,0,-5,5,4,0,0,1,1,0,-1,5,-1
KR_6734595463,420,-4,44,-36,-11,1,3,4,-1,2,1,-5,5,0,-3,3,0,-3,3,0,0,-16,31,-1,-4,5,-26,0,0,-1,-1,0,1,6,-1
KR_6696753909,420,-4,-70,-4,-7,2,2,4,1,0,1,-2,6,4,-3,3,0,-5,7,2,0,-1,1,2,-5,3,0,0,-2,-1,-1,-1,-1,3,-1
KR_6760319510,420,-6,-76,-4,-16,-3,5,2,0,2,2,-7,8,1,-9,9,0,3,1,4,1,-22,4,3,-8,5,-2,0,-1,1,1,-1,-1,5,-1
KR_6680642047,420,-4,-30,-24,-10,-4,5,1,1,1,2,0,2,2,-6,6,0,-1,3,2,0,-13,5,-2,-5,7,0,0,-2,-1,-1,-1,-1,2,-1
KR_6689226002,420,-2,-32,-20,-8,1,0,1,-1,6,5,-4,5,1,-3,4,1,-1,1,0,0,-17,123,-6,-4,10,24,0,0,-1,1,0,-1,1,-1
KR_6721676123,420,-1,-31,-12,1,-2,3,1,-1,4,3,3,1,4,1,4,5,0,0,0,0,0,-5,1,-5,4,1,0,0,1,-1,-1,-1,3,-1
KR_6730397622,420,-1,14,-2,5,1,0,1,1,3,4,-2,3,1,2,2,4,3,2,5,1,11,-1,4,-12,8,-1,0,-1,-1,-1,-1,1,6,-1
KR_6619625859,420,-3,-72,-53,-8,-2,3,1,0,3,3,-1,3,2,-4,7,3,-1,1,0,-4,-16,-20,-8,-6,14,4,0,0,-1,1,-1,-1,3,-1
KR_6745391551,420,0,-36,-1,-1,-3,3,0,-1,2,1,6,1,7,0,4,4,-3,3,0,0,-4,-4,1,-7,6,2,0,0,0,-1,0,1,0,-1
KR_6699787068,420,-3,-51,7,-4,0,1,1,-2,2,0,-4,6,2,1,3,4,1,0,1,0,-2,-67,-3,-6,9,2,0,-2,-1,-1,-1,-1,5,-1
KR_6735926812,420,-5,-18,-6,-20,-1,2,1,-3,4,1,-4,4,0,-7,7,0,-5,6,1,-1,-28,-11,-6,0,6,4,0,-2,1,-1,-1,-1,3,-1
KR_6758058945,420,-4,13,-15,-16,-5,5,0,-6,6,0,-3,3,0,-3,3,0,1,0,1,0,-17,3,4,-6,2,-1,0,0,1,-1,-1,-1,5,-1
KR_6761451033,440,-1,7,27,-9,0,1,1,-7,7,0,-1,2,1,-3,3,0,2,2,4,0,-11,8,-4,-1,5,-1,0,-1,0,1,-1,-1,0,-1
KR_6763099706,420,-3,-14,7,-4,-4,4,0,2,3,5,1,0,1,0,1,1,-3,3,0,0,-8,43,2,-6,4,2,0,-2,1,-1,-1,-1,1,-1
KR_6755513539,420,-5,-99,12,-13,-6,6,0,-3,5,2,0,2,2,-3,4,1,-1,1,0,0,-12,-10,-1,-2,3,-2,0,-3,1,1,-1,-1,2,-1
KR_6702762191,420,-4,-54,-6,-11,1,0,1,-8,9,1,-4,6,2,-1,8,7,1,0,1,0,-3,-5,0,-4,4,5,0,-1,-1,-1,-1,1,3,-1
KR_6741968395,420,0,-39,40,-4,-1,3,2,4,1,5,0,1,1,1,1,2,-8,9,1,0,-13,8,-1,-6,7,1,0,1,-1,1,1,1,1,-1
KR_6614302149,440,-1,24,-31,-5,1,1,2,0,3,3,-5,8,3,-2,3,1,1,1,2,0,3,-5,-7,-2,9,5,0,1,-1,-1,1,-1,5,-1
KR_6749937577,420,1,43,-8,1,-1,4,3,-2,3,1,3,1,4,1,2,3,0,0,0,0,-1,5,3,-11,8,1,0,0,-1,-1,-1,-1,3,-1
KR_6691143590,420,-2,-43,-12,-9,-2,3,1,-5,6,1,-1,3,2,-1,2,1,0,0,0,0,-9,2,-2,-2,4,-1,0,0,-1,1,-1,-1,1,-1
KR_6757830193,420,-2,47,7,-5,1,3,4,-5,6,1,2,0,2,-3,4,1,0,1,1,1,-11,-2,-2,-4,6,-1,0,0,-1,1,1,1,6,-1
KR_6693580668,420,0,-24,52,-5,-4,4,0,-2,3,1,-1,2,1,2,9,11,0,1,1,0,-6,-7,3,-7,4,-4,0,0,-1,-1,1,1,3,-1
KR_6731210805,420,-1,-3,-12,-7,-4,4,0,-1,3,2,2,3,5,-1,2,1,-3,4,1,0,-12,-1,-3,-4,7,6,0,-1,-1,-1,-1,1,3,-1
KR_6747390321,420,-3,-64,3,-8,0,3,3,-1,4,3,0,3,3,-5,6,1,-2,2,0,0,-6,-4,-1,-6,7,-3,0,-2,-1,1,-1,-1,4,-1
KR_6752205355,440,-4,-42,-19,-13,2,2,4,-6,6,0,0,0,0,-7,7,0,-2,2,0,0,-19,310,-7,-2,9,-1,0,-1,-1,-1,-1,-1,6,-1
KR_6721353880,420,-2,-4,29,-7,-1,1,0,1,3,4,-1,2,1,-5,7,2,-1,2,1,-1,-2,1,-4,-3,7,-3,0,-2,1,-1,-1,-1,1,-1
KR_6765844954,440,-2,31,-20,-1,6,1,7,-2,2,0,1,0,1,-3,3,0,-3,4,1,0,1,2,-2,-5,7,0,0,0,1,-1,1,1,2,-1
KR_6743830465,420,0,-30,4,-2,0,0,0,0,4,4,-1,1,0,-2,2,0,1,1,2,0,-2,-216,5,-9,4,0,0,0,-1,-1,0,-1,6,-1
KR_6762756684,420,-1,-4,-23,-1,0,4,4,-2,3,1,2,1,3,-2,3,1,1,0,1,0,4,-38,0,-5,5,20,0,-1,-1,-1,-1,1,6,-1
KR_6762523164,420,-1,-6,2,-8,-3,6,3,-3,3,0,-5,7,2,3,2,5,0,3,3,0,-1,47,2,-5,3,2,0,0,1,-1,1,1,2,-1
KR_6762679123,420,-1,-4,7,-7,-1,4,3,-5,5,0,0,1,1,-3,6,3,2,1,3,0,-9,-6,-4,-2,6,-1,0,0,1,-1,0,-1,1,-1
KR_6760218431,420,-1,-41,-34,-2,-2,2,0,1,5,6,-3,4,1,0,2,2,2,1,3,-1,3,6,3,-7,4,-2,0,-1,-1,-1,-1,-1,6,-1
KR_6742201903,420,-2,-33,44,-7,-5,5,0,-1,2,1,1,1,2,-3,4,1,1,0,1,0,-4,-7,-4,-3,7,4,0,0,-1,0,1,-1,3,-1
KR_6726064999,420,-9,-99,-64,-22,-1,3,2,-8,9,1,-7,9,2,-5,5,0,-1,1,0,0,-21,-26,-4,-3,7,-2,0,-1,1,0,-1,-1,2,-1
KR_6595149453,440,-6,-60,-18,-11,-5,5,0,4,4,8,-6,6,0,-4,5,1,0,0,0,-2,-10,384,0,-6,6,-2,0,0,1,1,-1,-1,6,-1
KR_6437995166,440,-3,-68,-15,-1,-2,4,2,2,1,3,2,3,5,-3,3,0,0,1,1,0,-1,-6,-4,-1,5,1,0,-1,1,1,-1,-1,4,-1
KR_6759625393,420,-2,-27,8,0,-2,3,1,3,0,3,-3,5,2,-3,3,0,5,1,6,0,-2,-11,2,-10,8,-3,0,0,-1,-1,0,1,3,-1
KR_6763297535,420,-5,-23,-15,-7,-3,4,1,0,2,2,-3,3,0,0,4,4,-1,1,0,0,1,-170,-1,-6,7,-4,0,-3,0,-1,-1,1,0,-1
KR_6756222792,420,-4,-4,-6,-16,-3,4,1,-4,5,1,-6,7,1,-3,5,2,0,0,0,0,-22,4,0,-6,6,-2,0,-1,-1,-1,-1,-1,3,-1
KR_6601552089,420,-3,-10,-24,-7,1,2,3,-5,6,1,-1,3,2,-2,5,3,0,1,1,0,-6,-13,-2,-3,5,1,0,1,1,-1,1,-1,6,-1
KR_6675082852,420,-4,-23,3,-3,-2,2,0,3,2,5,-8,10,2,3,2,5,1,0,1,0,6,211,-1,-5,6,0,0,1,-1,1,1,1,4,-1
KR_6757929726,420,0,-19,12,-4,-1,3,2,5,1,6,-6,9,3,-3,5,2,1,0,1,0,-3,-11,1,-6,5,0,0,0,1,1,1,1,6,-1
KR_6763260526,420,1,26,-34,4,0,2,2,2,1,3,-2,3,1,4,1,5,0,0,0,0,5,127,3,-8,5,-1,0,0,1,-1,0,1,6,-1
KR_6697218947,420,-3,-45,-16,-4,3,1,4,-1,3,2,-4,11,7,-2,5,3,0,1,1,0,4,105,5,-10,5,-6,0,-1,-1,-1,-1,1,4,-1
KR_6582394324,420,-1,-17,35,-3,0,2,2,3,2,5,1,1,2,-5,6,1,-2,2,0,0,-6,254,5,-9,4,-4,0,0,1,1,-1,-1,6,-1
KR_6742942752,440,-8,-129,-24,-16,-2,2,0,-1,2,1,-3,3,0,-10,10,0,0,0,0,0,-14,-4,0,-5,5,-1,0,-3,1,-1,-1,-1,3,-1
KR_6747660182,420,0,-26,19,-6,-2,3,1,-3,5,2,1,0,1,-1,1,0,-1,1,0,-1,-6,2,4,-8,4,-5,0,0,-1,-1,0,-1,3,-1
KR_6675024525,420,1,25,16,-1,-2,4,2,0,6,6,3,1,4,-2,4,2,0,4,4,0,-1,-1,4,-6,2,0,0,-1,-1,1,1,-1,3,-1
KR_6765949628,420,-2,-47,-9,-2,0,5,5,-3,5,2,-2,3,1,2,1,3,1,0,1,-1,-7,-4,-2,-4,6,3,0,-1,-1,0,-1,-1,4,-1
KR_6750372928,420,-2,-43,-36,-1,-2,6,4,-1,3,2,-1,3,2,2,6,8,1,1,2,-2,-1,0,3,-7,4,0,0,0,-1,-1,-1,-1,6,-1
KR_6756935614,440,0,-16,-24,-2,1,0,1,-3,4,1,-1,1,0,2,4,6,-1,1,0,-1,-1,58,2,-5,3,-21,0,-1,0,-1,-1,-1,0,-1
KR_6718666358,420,-1,-26,4,0,-1,2,1,2,4,6,1,3,4,-1,4,3,-1,2,1,-2,-7,-12,-7,-4,11,4,0,1,1,-1,1,-1,6,-1
KR_6702452522,420,2,-13,35,4,-2,4,2,4,1,5,-5,5,0,4,0,4,3,1,4,2,2,2,-2,-6,8,-2,0,0,1,0,0,1,6,-1
KR_6746649246,420,-5,-17,-13,-3,-4,5,1,3,3,6,0,1,1,-1,6,5,-1,1,0,0,5,-3,-2,-4,6,3,0,-1,1,-1,-1,1,5,-1
KR_6758789884,420,-2,-37,0,-1,2,1,3,1,0,1,2,2,4,-6,6,0,0,2,2,0,-1,-5,2,-5,3,4,0,0,1,1,0,1,6,-1
KR_6652077462,420,-6,-33,-32,-11,0,2,2,-7,7,0,-3,4,1,-1,2,1,0,2,2,0,-10,-2,2,-6,4,1,0,-1,-1,1,-1,-1,5,-1
KR_6763393609,420,-3,18,-4,-6,0,2,2,-1,2,1,-2,3,1,0,1,1,-3,3,0,0,-3,-4,-5,-3,8,-4,0,0,-1,1,0,-1,2,-1
KR_6756464184,420,-3,-16,-4,0,-1,1,0,0,3,3,4,0,4,-1,4,3,-2,3,1,0,-6,2,4,-5,1,1,0,0,1,-1,0,1,3,-1
KR_6698355366,420,1,1,-22,2,6,0,6,0,4,4,0,1,1,-4,7,3,0,1,1,1,-4,13,6,-7,1,-4,0,-1,-1,-1,1,1,3,-1
KR_6548415190,440,-2,-33,5,-2,1,2,3,0,2,2,-1,2,1,-1,6,5,-1,2,1,-1,-10,-15,0,-5,5,-3,0,-1,-1,-1,-1,-1,3,-1
KR_6548489918,440,-7,-53,-11,-20,-5,5,0,-5,7,2,-4,5,1,-7,10,3,1,2,3,0,-8,-7,-2,-2,4,0,0,-2,-1,-1,-1,1,4,-1
KR_6639461317,420,-3,-26,5,-10,-2,2,0,-2,4,2,-1,2,1,-3,6,3,-2,3,1,0,-8,175,-3,-2,5,-4,0,-1,1,-1,-1,-1,5,-1
KR_6765823867,420,-2,-17,-15,-3,-3,4,1,2,3,5,-2,3,1,-2,8,6,2,0,2,-2,0,227,-1,-8,9,11,0,-3,1,1,-1,1,3,-1
KR_6679746272,420,-1,-49,9,-8,-1,1,0,-4,7,3,-4,6,2,1,2,3,0,2,2,-1,-7,39,-2,-6,8,-30,0,-1,-1,-1,-1,-1,3,-1
KR_6746787420,420,-2,15,-17,-15,-7,8,1,-7,7,0,-2,5,3,1,0,1,0,1,1,-1,-24,9,5,-8,3,1,0,0,0,1,0,-1,0,-1
KR_6675013571,420,-1,16,-8,-4,1,0,1,1,3,4,-7,7,0,1,1,2,0,1,1,0,-6,10,0,-3,3,-2,0,1,-1,1,1,1,3,-1
KR_6745784653,420,-7,-76,-59,-12,0,1,1,-9,9,0,0,1,1,-3,6,3,0,1,1,0,-7,-10,-6,-1,7,1,0,-2,-1,1,-1,-1,2,-1
KR_6725807444,420,-4,-40,7,-2,-2,3,1,2,2,4,-4,4,0,0,3,3,2,0,2,0,2,-8,-2,-4,6,-4,0,0,-1,1,0,-1,4,-1
KR_6752568287,420,-1,-52,-24,1,-3,5,2,1,2,3,3,2,5,-1,5,4,1,1,2,0,7,13,3,-6,3,3,0,-1,-1,-1,-1,-1,6,-1
KR_6429646665,440,1,-5,-8,1,3,3,6,-3,4,1,3,2,5,-1,6,5,-1,2,1,-2,-15,-336,-5,-1,6,1,0,1,0,-1,1,-1,0,-1
KR_6751086736,420,-1,1,-5,-3,-1,1,0,-3,6,3,-2,2,0,2,1,3,1,0,1,-1,-7,20,-2,-2,4,-3,0,0,-1,-1,1,-1,5,-1
KR_6731353541,420,-4,-83,1,-13,-1,3,2,-4,4,0,-2,3,1,-4,6,2,-2,2,0,0,-19,48,0,-4,4,-19,0,-2,1,-1,-1,-1,1,-1
KR_6721432356,420,0,44,-10,-1,1,2,3,1,3,4,-1,1,0,-1,2,1,-1,1,0,0,-5,-120,0,-4,4,-3,0,0,-1,-1,1,1,4,-1
KR_6487051781,420,-3,-16,-25,-5,3,0,3,2,4,6,-7,8,1,-3,4,1,0,0,0,0,-4,35,32,-39,7,1,0,-1,-1,-1,-1,-1,1,-1
KR_6736112678,420,-5,-56,28,-18,0,3,3,-3,3,0,-6,6,0,-6,7,1,-3,4,1,0,-20,-6,-2,-1,3,0,0,-2,-1,-1,-1,-1,2,-1
KR_6736667031,420,-2,-67,-16,-14,-3,8,5,-3,5,2,-3,4,1,-8,8,0,3,0,3,0,-18,-14,4,-8,4,-7,0,-2,-1,-1,-1,-1,3,-1
KR_6755685248,420,-1,55,-12,-11,0,2,2,0,0,0,-8,9,1,-3,5,2,0,1,1,0,-15,6,5,-10,5,-1,0,0,-1,-1,0,1,6,-1
KR_6698709478,420,-1,-11,-26,-4,-3,3,0,-6,8,2,2,4,6,5,2,7,-2,2,0,0,-1,-32,-1,-3,4,3,0,0,0,-1,0,1,0,-1
KR_6762853786,420,-3,-16,-3,-9,-2,2,0,2,0,2,-3,3,0,-3,4,1,-3,3,0,0,-13,12,2,-8,6,-5,0,0,0,-1,0,-1,0,-1
KR_6730850958,420,0,-44,-11,-4,-4,5,1,-7,10,3,6,4,10,-5,5,0,6,1,7,2,-14,3,-3,-4,7,-4,0,0,1,1,-1,1,5,-1
KR_6755287392,420,-6,-69,-54,-10,-2,2,0,-3,3,0,-4,6,2,4,1,5,-5,5,0,0,-7,1,1,-6,5,-4,0,-1,0,-1,-1,-1,0,-1
KR_6718250533,420,2,53,8,4,-1,3,2,4,1,5,2,1,3,0,1,1,-1,1,0,0,5,32,2,-6,4,-8,0,2,-1,1,1,1,3,-1
KR_6631506648,420,-2,-24,-16,-5,-4,5,1,5,1,6,-3,5,2,-2,3,1,-1,2,1,0,-4,5,2,-5,3,-4,0,0,-1,-1,-1,-1,1,-1
KR_6492332885,420,0,-25,-20,4,-1,3,2,0,2,2,1,3,4,3,2,5,1,2,3,0,6,-15,3,-8,5,1,0,1,0,1,1,1,0,-1
KR_6715728951,420,-2,-31,-8,-2,-8,8,0,7,2,9,-1,5,4,0,1,1,0,1,1,0,6,-7,2,-4,2,-4,0,0,-1,-1,0,1,6,-1
KR_6703079247,420,0,-55,10,-2,-1,1,0,3,1,4,0,3,3,-3,4,1,-1,1,0,0,-1,5,0,-5,5,-2,0,-1,1,-1,-1,-1,4,-1
KR_6763329930,420,0,-29,-20,10,0,3,3,0,3,3,5,1,6,5,0,5,0,1,1,0,14,-7,1,-6,5,4,0,0,-1,0,0,1,3,-1
KR_6657089485,420,0,-53,16,-1,0,1,1,1,3,4,3,0,3,-5,9,4,0,0,0,0,-1,1,-3,-4,7,2,0,1,1,-1,1,-1,4,-1
KR_6637333656,440,-7,-22,-74,-15,-1,2,1,-1,5,4,-1,3,2,-13,14,1,1,3,4,0,-16,4,-2,-4,6,-2,0,-1,-1,-1,-1,-1,1,-1
KR_6689725219,420,0,9,-20,-6,-3,3,0,-2,5,3,1,0,1,-2,4,2,0,0,0,0,-5,-9,-1,-8,9,0,0,0,-1,1,1,-1,3,-1
KR_6702686442,420,-6,-61,-1,-22,-1,1,0,-3,6,3,-7,7,0,-9,9,0,-2,3,1,0,-26,-8,-1,-7,8,-1,0,0,-1,1,-1,-1,6,-1
KR_6745290965,440,7,51,52,14,3,1,4,5,2,7,7,1,8,-1,5,4,0,2,2,0,7,21,7,-7,0,-1,0,2,1,1,1,1,1,-1
KR_6765016213,440,3,84,7,14,6,1,7,-3,4,1,3,1,4,7,5,12,1,1,2,1,9,0,3,-6,3,-1,0,2,1,1,1,1,6,-1
KR_6694209273,420,-2,-46,17,1,-2,3,1,3,3,6,0,3,3,0,4,4,0,2,2,1,2,-2,0,-6,6,-3,0,0,-1,1,0,1,2,-1
KR_6751774839,420,-2,-12,-11,-4,-5,6,1,4,1,5,-2,4,2,-1,4,3,0,1,1,0,-3,199,2,-7,5,0,0,0,-1,-1,1,-1,3,-1
KR_6759689501,420,-1,14,-11,2,0,2,2,2,1,3,0,2,2,0,6,6,0,2,2,0,2,-6,-2,-3,5,5,0,0,0,-1,-1,1,0,-1
KR_6764196931,420,1,-2,-11,-1,-4,8,4,0,3,3,3,0,3,1,2,3,-1,6,5,1,0,-10,0,-4,4,7,0,0,1,1,-1,1,3,-1
KR_6700767969,420,1,64,-8,-1,-2,3,1,-1,2,1,-1,1,0,1,3,4,2,0,2,0,1,3,0,-5,5,1,0,1,1,1,1,1,5,-1
KR_6500656514,420,-1,-8,4,-6,-1,2,1,1,3,4,3,2,5,-8,8,0,-1,2,1,0,-5,11,-1,-5,6,-2,0,-2,1,-1,-1,-1,6,-1
KR_6752766979,420,0,15,-1,0,0,0,0,4,0,4,-4,6,2,-3,4,1,3,0,3,0,-2,0,0,-4,4,3,0,0,-1,1,0,-1,3,-1
KR_6758950694,420,0,-52,8,-2,-1,1,0,5,1,6,-4,4,0,-1,2,1,-1,1,0,0,-2,-34,-2,-5,7,23,0,0,-1,1,0,-1,3,-1
KR_6764710124,420,5,90,33,4,4,0,4,-2,3,1,0,1,1,0,1,1,2,1,3,0,2,16,3,-9,6,0,0,1,1,1,1,1,5,-1
KR_6683051745,420,-3,-16,-16,-8,2,1,3,-6,7,1,0,4,4,0,3,3,-4,5,1,0,-14,-17,-5,-4,9,-2,0,0,-1,1,-1,-1,2,-1
KR_6745090515,420,0,65,-8,-4,-2,4,2,-2,2,0,-1,1,0,0,1,1,1,0,1,0,-6,24,3,-5,2,-4,0,1,-1,-1,1,1,4,-1
KR_6507562005,420,-5,-3,-13,-9,-5,5,0,-1,4,3,0,2,2,-1,1,0,-2,4,2,0,-7,12,-3,-4,7,11,0,-1,1,1,1,1,6,-1
KR_6743439828,420,-1,-31,-1,-12,2,0,2,-2,4,2,-2,3,1,-6,7,1,-4,4,0,0,-22,1,-2,-3,5,-2,0,0,1,-1,-1,1,6,-1
KR_6759877968,420,-7,-113,1,-12,-4,6,2,3,0,3,-5,7,2,-6,7,1,0,1,1,0,-4,8,-3,-5,8,0,0,-3,-1,-1,-1,1,1,-1
KR_6762180105,420,-2,18,17,-6,-1,4,3,-3,3,0,-3,4,1,2,1,3,-1,1,0,0,-9,27,-1,-3,4,-1,0,-1,-1,1,-1,1,4,-1
KR_6765586545,420,-2,-65,20,-10,-2,2,0,-1,3,2,2,3,5,-5,5,0,-4,5,1,0,-16,5,-3,-5,8,-4,0,-3,0,1,-1,-1,0,-1
KR_6758875909,420,-1,-16,4,1,0,2,2,-1,2,1,2,1,3,-1,6,5,1,0,1,2,1,0,-3,-4,7,5,0,0,-1,-1,0,-1,6,-1
KR_6685412452,420,-4,-131,-4,-10,-4,8,4,-5,5,0,1,2,3,-1,5,4,-1,2,1,-1,-9,4,-3,-2,5,-3,0,-2,-1,1,-1,-1,6,-1
KR_6751750745,420,-2,-10,29,-12,-3,4,1,-4,5,1,-1,2,1,-6,8,2,2,0,2,-1,-15,-11,0,-3,3,1,0,-2,0,-1,-1,-1,0,-1
KR_6686561980,420,2,22,4,-4,-2,3,1,5,1,6,-2,5,3,-4,6,2,-1,2,1,0,3,-1,-2,-4,6,4,0,0,1,-1,-1,1,2,-1
KR_6764101060,420,-4,34,-36,-7,0,0,0,2,3,5,-2,4,2,-7,7,0,0,1,1,0,2,3,0,-6,6,0,0,-1,-1,-1,-1,-1,2,-1
KR_6741755612,420,-2,-6,-12,-5,-1,2,1,0,2,2,2,1,3,-6,6,0,0,0,0,0,-9,-8,-2,-5,7,-2,0,-1,-1,-1,-1,1,3,-1
KR_6532254707,420,-4,-33,-7,-3,-4,4,0,0,4,4,-1,6,5,1,3,4,1,1,2,0,-2,8,-2,-5,7,-5,0,2,-1,-1,1,1,6,-1
KR_6745038450,420,-3,2,-7,-5,2,0,2,-1,6,5,1,2,3,-6,6,0,-1,2,1,0,-4,2,1,-7,6,-4,0,-1,-1,1,-1,1,4,-1
KR_6752301127,440,1,-12,12,-7,-3,7,4,-1,1,0,-4,5,1,0,3,3,1,0,1,0,-13,7,1,-6,5,-4,0,0,1,-1,0,-1,4,-1
KR_6758737123,420,-3,15,-4,-17,4,0,4,0,2,2,-9,10,1,-5,8,3,-7,8,1,1,-13,-5,-2,-5,7,-4,0,-2,-1,-1,-1,1,3,-1
KR_6669099008,420,-3,-39,-4,-10,-3,3,0,-5,7,2,-2,2,0,2,2,4,-2,2,0,0,-8,-7,-2,-3,5,0,0,-1,-1,1,-1,-1,6,-1
KR_6746960885,420,-4,-63,-28,-8,1,0,1,-4,5,1,-2,4,2,-1,1,0,-2,2,0,1,-14,-3,-2,-4,6,-3,0,0,0,-1,0,1,0,-1
KR_6731481573,440,-2,-48,-4,-1,0,1,1,3,2,5,-1,1,0,-3,5,2,0,0,0,0,0,5,-3,-2,5,-4,0,-1,1,-1,-1,1,4,-1
KR_6693225881,420,-3,11,-26,-7,-3,3,0,-3,3,0,-2,2,0,1,1,2,0,0,0,0,-6,-21,1,-4,3,6,0,0,-1,1,0,-1,5,-1
KR_6739242742,420,-2,-9,-11,-5,-2,2,0,-1,1,0,-2,2,0,0,2,2,0,1,1,0,-7,-3,-5,-4,9,-1,0,0,-1,1,0,-1,1,-1
KR_6759555568,420,3,2,12,6,-1,4,3,1,2,3,1,1,2,5,2,7,0,0,0,1,11,-113,-4,-3,7,-2,0,-1,1,-1,-1,1,1,-1
KR_6680076445,420,-2,-34,-47,-5,0,1,1,3,2,5,1,2,3,-9,11,2,0,2,2,0,-4,-4,-2,-4,6,0,0,0,-1,-1,-1,-1,6,-1
KR_6601322237,420,-2,-41,17,-5,2,3,5,0,3,3,-2,4,2,-6,7,1,1,0,1,0,-7,121,-4,-4,8,4,0,-1,1,-1,-1,1,5,-1
KR_6765381513,420,1,19,12,5,-6,6,0,10,1,11,3,0,3,1,5,6,-3,4,1,2,20,13,5,-6,1,-2,0,1,0,1,1,1,0,-1
KR_6758695489,420,0,52,12,2,1,1,2,-5,6,1,0,5,5,3,2,5,3,2,5,-1,0,-2,-6,-2,8,4,0,0,0,1,0,-1,0,-1
KR_6694745067,420,-3,-46,-9,-7,-1,1,0,-6,6,0,2,2,4,-2,4,2,0,3,3,0,-7,-25,3,-5,2,-6,0,-1,-1,-1,-1,-1,5,-1
KR_6756133765,420,-2,-17,-4,-1,4,0,4,-2,2,0,3,2,5,-5,6,1,-1,3,2,0,-4,12,-5,-3,8,-3,0,-1,-1,1,-1,1,1,-1
KR_6751186428,420,0,-4,25,1,-1,3,2,-3,4,1,4,2,6,2,3,5,-1,1,0,1,1,2,4,-10,6,1,0,0,-1,1,-1,1,1,-1
KR_6762568147,420,-3,7,16,-9,1,3,4,-4,5,1,-3,4,1,-2,3,1,-1,1,0,0,-10,2,0,-2,2,-5,0,-1,-1,-1,-1,1,5,-1
KR_6757908761,420,-8,-87,-13,-15,-2,3,1,0,3,3,-4,6,2,-10,10,0,1,0,1,1,-13,64,-2,-2,4,0,0,-3,1,-1,-1,1,2,-1
KR_6738626489,420,1,-1,-16,7,5,1,6,2,0,2,-1,3,2,-1,2,1,2,1,3,0,6,-1,-2,-3,5,6,0,2,-1,1,1,1,1,-1
KR_6747592358,420,3,12,-4,7,3,0,3,2,2,4,5,2,7,-3,5,2,0,0,0,0,9,17,2,-7,5,-4,0,0,1,-1,-1,-1,1,-1
KR_6734201786,420,-1,-6,0,-3,-2,3,1,2,2,4,0,3,3,-3,4,1,0,2,2,0,-2,-3,-3,-2,5,2,0,0,1,-1,0,-1,6,-1
KR_6765027969,420,-1,-15,-14,-4,4,0,4,-2,2,0,-4,5,1,-1,3,2,-1,2,1,0,-10,-4,1,-6,5,-1,0,0,-1,1,-1,-1,2,-1
KR_6762856276,420,-7,-92,-45,-11,0,2,2,-3,5,2,-6,7,1,-1,6,5,-1,1,0,0,-2,122,1,-4,3,0,0,0,-1,-1,1,1,3,-1
KR_6759044241,420,-2,-23,-9,-4,3,1,4,0,2,2,0,3,3,-5,7,2,-2,3,1,0,-10,-237,-2,-5,7,0,0,1,1,-1,-1,-1,3,-1
KR_6750761981,420,-2,-58,-55,-1,1,0,1,-1,1,0,-5,5,0,3,0,3,1,0,1,0,2,-9,-1,-4,5,-4,0,-1,-1,-1,-1,-1,6,-1
KR_6764873132,420,-1,12,32,5,3,1,4,1,3,4,1,3,4,0,1,1,0,2,2,0,3,28,2,-6,4,-1,0,-1,1,-1,-1,-1,5,-1
KR_6739236933,420,-5,-74,-16,-10,-4,5,1,-1,5,4,2,4,6,-2,3,1,-5,5,0,0,-11,-1,5,-9,4,-4,0,-3,-1,0,-1,-1,1,-1
KR_6760500672,420,1,41,0,-5,1,1,2,6,2,8,-2,4,2,-3,4,1,-7,8,1,1,-9,-20,-1,-4,5,2,0,0,-1,0,0,1,4,-1
KR_6747465538,420,2,-32,31,3,1,1,2,1,3,4,2,1,3,0,1,1,-1,1,0,0,7,5,-1,-4,5,4,0,0,1,1,1,1,1,-1
KR_6755234348,420,-4,-110,-22,-9,-5,7,2,2,2,4,-4,5,1,1,2,3,-3,3,0,1,0,9,1,-6,5,0,0,0,1,-1,-1,1,4,-1
KR_6765241915,420,-1,-38,-20,-10,-2,4,2,-6,6,0,0,0,0,1,3,4,-3,3,0,0,-7,0,1,-5,4,-8,0,0,-1,-1,0,-1,1,-1
KR_6758883033,420,-6,-21,-13,-16,-4,4,0,-4,7,3,1,1,2,-6,7,1,-3,3,0,0,-22,-11,2,-6,4,0,0,-2,-1,-1,-1,-1,6,-1
KR_6727460180,420,-2,-4,4,-4,-2,3,1,-5,7,2,1,1,2,3,1,4,-1,1,0,0,-5,8,5,-8,3,1,0,0,1,-1,0,-1,3,-1
KR_6720185407,420,4,62,7,4,0,3,3,0,1,1,0,1,1,4,0,4,0,1,1,0,7,4,0,-4,4,1,0,2,1,1,1,1,2,-1
KR_6757266007,420,-3,25,-37,-4,-1,3,2,-4,5,1,-2,2,0,3,1,4,0,1,1,0,-7,-1,1,-6,5,0,0,2,1,-1,1,1,5,-1
KR_6651911302,420,1,-25,13,2,0,2,2,1,3,4,5,0,5,-3,4,1,-1,1,0,0,7,0,-1,-5,6,0,0,-1,0,1,-1,-1,0,-1
KR_6747151834,440,-6,-93,8,-13,-1,2,1,-6,7,1,-2,3,1,-3,5,2,-1,3,2,0,-19,-1,2,-4,2,0,0,-2,0,0,-1,-1,0,-1
KR_6759962435,420,-4,-59,-43,-4,-2,3,1,-1,2,1,4,0,4,-2,4,2,-3,4,1,0,-9,13,0,-6,6,1,0,-1,-1,1,-1,-1,5,-1
KR_6679227822,420,0,-4,24,-3,0,1,1,-1,2,1,3,0,3,-6,6,0,1,0,1,0,-5,-4,0,-4,4,2,0,0,-1,1,0,-1,5,-1
KR_6699565052,420,1,-5,0,9,1,1,2,4,2,6,2,1,3,2,1,3,0,1,1,0,11,-12,-5,-4,9,4,0,-1,-1,-1,-1,1,5,-1
KR_6687819803,420,4,32,5,6,-1,1,0,1,3,4,5,1,6,1,6,7,0,1,1,1,3,12,0,-6,6,1,0,1,-1,1,1,1,2,-1
KR_6754231409,440,2,-47,16,-1,0,3,3,-6,9,3,5,2,7,-1,2,1,1,0,1,0,3,8,3,-6,3,-4,0,0,-1,1,1,1,5,-1
KR_6764773574,440,-2,-3,22,-2,0,2,2,-2,4,2,1,1,2,-4,4,0,3,0,3,0,-13,50,-1,-8,9,-4,0,-1,-1,-1,1,1,3,-1
KR_6752036019,440,0,-50,4,4,-5,7,2,7,1,8,0,3,3,-1,5,4,3,2,5,-1,13,-1,2,-3,1,0,0,0,1,1,-1,-1,1,-1
KR_6744472842,420,1,9,0,0,0,0,0,2,4,6,3,1,4,-2,6,4,-3,3,0,0,-1,7,4,-9,5,-3,0,1,-1,1,1,-1,1,-1
KR_6730760927,420,-2,14,-14,-2,0,1,1,-2,6,4,-2,2,0,1,1,2,1,0,1,0,-2,3,6,-11,5,-6,0,0,-1,-1,0,1,5,-1
KR_6755049832,420,1,-25,-8,0,1,1,2,-2,2,0,0,4,4,2,4,6,-1,4,3,0,-1,-32,-1,-3,4,-3,0,0,1,-1,0,-1,2,-1
KR_6745699239,420,-2,0,-18,-2,0,1,1,-2,5,3,2,6,8,-1,2,1,-1,1,0,0,-14,-128,-2,-8,10,-5,0,0,-1,-1,0,-1,6,-1
KR_6686228076,420,-1,-10,-24,-2,3,1,4,-4,5,1,4,3,7,-4,4,0,-1,1,0,0,-11,-2,-3,-5,8,-1,0,-1,-1,-1,-1,-1,1,-1
KR_6763972833,420,-2,-2,4,-1,-3,3,0,0,3,3,-6,7,1,9,0,9,-1,1,0,0,4,-4,6,-9,3,-9,0,0,1,-1,1,1,5,-1
KR_6762398709,440,-1,-54,-20,2,1,6,7,-3,6,3,-1,2,1,3,2,5,2,0,2,-2,2,1,9,-11,2,-6,0,-3,-1,-1,-1,1,4,-1
KR_6764815099,420,-4,-45,36,-8,-2,2,0,-1,4,3,-1,4,3,-2,3,1,-2,2,0,0,-12,2,4,-7,3,-4,0,0,-1,1,-1,-1,4,-1
KR_6691122297,420,-4,-35,-31,-6,-7,8,1,-3,3,0,2,0,2,1,2,3,1,0,1,1,-4,-36,-2,-4,6,-5,0,-2,1,-1,-1,1,1,-1
KR_6691283776,420,0,-20,-5,-1,-2,4,2,-2,4,2,3,2,5,0,2,2,0,1,1,0,1,-27,3,-5,2,3,0,-1,-1,-1,-1,1,6,-1
KR_6751062010,420,-5,-75,-4,-10,-1,2,1,-1,2,1,0,0,0,-4,7,3,-4,4,0,1,-7,11,0,-5,5,-3,0,-1,-1,-1,-1,1,2,-1
KR_6666845998,420,-2,-10,-59,-5,1,1,2,-6,7,1,-2,5,3,3,2,5,-1,2,1,0,1,3,3,-5,2,1,0,0,1,1,0,-1,5,-1
KR_6765117884,440,-3,-128,-1,-3,-2,2,0,-4,9,5,1,1,2,1,3,4,1,1,2,1,5,4,1,-2,1,-4,0,-2,-1,-1,-1,1,1,-1
KR_6717656935,420,-6,-40,-64,-13,-6,7,1,-1,6,5,-3,6,3,-1,2,1,-2,2,0,0,-1,-10,-3,-3,6,2,0,-1,-1,-1,-1,1,4,-1
KR_6744341735,440,-2,-84,15,-12,1,0,1,1,1,2,-5,5,0,-7,13,6,-2,2,0,-1,-19,0,-4,-5,9,3,0,-2,-1,-1,-1,-1,2,-1
KR_6630400216,420,0,14,-4,-1,0,0,0,0,0,0,-3,4,1,3,1,4,-1,3,2,1,-9,-8,0,-3,3,-2,0,0,1,-1,0,1,6,-1
KR_6635297011,440,1,38,-25,-1,-1,5,4,-3,5,2,0,0,0,-1,4,3,4,1,5,0,4,27,1,-5,4,-2,0,0,-1,1,0,-1,1,-1
KR_6747601140,420,0,-52,-20,-2,-4,4,0,2,0,2,-3,3,0,4,2,6,-1,1,0,0,7,-1,1,-5,4,-2,0,0,-1,-1,0,-1,5,-1
KR_6690750903,420,-4,-78,18,-9,-4,5,1,0,4,4,-1,2,1,-3,3,0,-1,1,0,0,-12,1,0,-2,2,-4,0,-4,1,-1,-1,-1,2,-1
KR_6702481600,440,-1,37,-34,-5,-2,3,1,3,1,4,-3,3,0,3,2,5,-6,7,1,0,-4,1,-4,0,4,-1,0,0,-1,0,0,-1,6,-1
KR_6743577351,420,-4,-29,12,-17,1,2,3,-1,1,0,-14,14,0,-3,3,0,0,0,0,0,-21,-5,1,-3,2,-2,0,-1,-1,-1,-1,1,2,-1
KR_6734151801,440,2,73,16,2,1,0,1,2,0,2,0,0,0,1,3,4,-2,3,1,0,2,-9,-5,-5,10,-2,0,2,-1,1,1,-1,5,-1
KR_6751672731,420,-5,-78,-36,-8,1,2,3,2,0,2,-5,9,4,-5,6,1,-1,2,1,2,0,8,-4,-5,9,-5,0,-1,-1,1,-1,1,3,-1
KR_6678420300,420,-3,24,20,-12,-5,5,0,-1,1,0,-3,3,0,-3,5,2,0,2,2,0,-15,1,-3,-4,7,-1,0,0,-1,-1,0,1,1,-1
KR_6690969831,420,-1,-33,-24,-6,0,1,1,1,3,4,-1,2,1,-4,5,1,-2,3,1,0,-7,1,2,-8,6,-4,0,1,-1,1,1,1,5,-1
KR_6693818378,420,-1,-19,-26,-5,-3,4,1,-1,4,3,-4,6,2,1,1,2,2,0,2,0,-10,26,-2,-5,7,-7,0,-1,-1,-1,-1,1,1,-1
KR_6710407979,420,1,10,-37,2,0,1,1,-1,2,1,1,1,2,4,0,4,-2,3,1,0,5,43,1,-5,4,4,0,1,-1,-1,-1,-1,5,-1
KR_6623552014,420,-4,-111,-2,-10,-1,3,2,-4,6,2,-3,4,1,-3,4,1,1,1,2,0,-8,25,-3,-1,4,-7,0,-2,-1,-1,-1,-1,4,-1
KR_6760709311,420,-2,1,2,-1,1,2,3,-1,2,1,-1,1,0,0,2,2,0,0,0,0,-4,1,-1,-3,4,0,0,0,1,0,0,1,5,-1
KR_6614945320,420,-4,-30,-28,-21,-1,4,3,-4,5,1,-6,6,0,-11,11,0,1,0,1,-1,-29,2,-3,-6,9,-3,0,-1,-1,-1,-1,-1,5,-1
KR_6730447113,440,-4,-27,-16,-3,0,4,4,-1,2,1,0,1,1,-1,2,1,-1,2,1,0,-7,1,2,-6,4,1,0,0,-1,0,1,1,3,-1
KR_6717274200,420,-6,6,-3,-10,-2,2,0,-3,4,1,-1,3,2,-4,5,1,0,0,0,0,-15,2,3,-6,3,0,0,-2,1,-1,-1,1,6,-1
KR_6753984118,420,3,30,44,-1,3,0,3,-9,9,0,5,2,7,0,0,0,0,0,0,0,-3,-10,-5,-2,7,1,0,1,0,0,1,-1,0,-1
KR_6756263243,420,-2,-27,-20,-9,-2,5,3,-4,6,2,-1,2,1,-2,3,1,0,1,1,0,-8,-10,-4,-3,7,2,0,-2,-1,-1,-1,-1,4,-1
KR_6741321356,440,0,13,-41,0,1,2,3,0,2,2,-2,2,0,1,3,4,0,0,0,0,2,3,1,-5,4,-2,0,1,-1,1,1,-1,6,-1
KR_6759785634,420,-2,44,24,-6,-3,3,0,-1,2,1,-2,5,3,-1,1,0,1,1,2,0,-1,4,2,-7,5,0,0,1,1,-1,1,-1,3,-1
KR_6701107728,420,-7,-88,-8,-12,-5,5,0,2,0,2,2,1,3,-9,10,1,-2,2,0,0,-14,2,3,-7,4,0,0,0,-1,-1,-1,1,4,-1
KR_6743935729,420,1,41,20,-4,-1,3,2,-4,5,1,1,1,2,1,0,1,-1,2,1,0,-5,-5,-1,-5,6,4,0,0,1,1,1,-1,2,-1
KR_6543249722,420,-2,-37,-6,-4,-1,4,3,-1,2,1,-1,2,1,0,0,0,-1,1,0,0,-3,9,-1,-7,8,0,0,-1,1,1,-1,-1,6,-1
KR_6746415245,420,2,-8,10,-4,0,5,5,-1,2,1,-2,2,0,-1,2,1,0,0,0,0,-9,-4,-4,-1,5,5,0,-1,1,1,-1,-1,6,-1
KR_6686774467,420,-2,-62,32,-5,1,1,2,0,4,4,1,0,1,-6,7,1,-1,2,1,0,-10,-15,0,-5,5,-4,0,0,1,-1,-1,-1,2,-1
KR_6697076482,420,-2,-5,-24,3,3,0,3,-3,5,2,-1,3,2,3,2,5,1,1,2,1,3,-18,1,-6,5,-3,0,-1,-1,1,-1,1,2,-1
KR_6730578761,420,-5,-81,-32,-8,3,0,3,1,3,4,-5,6,1,-7,8,1,0,1,1,0,-10,-1,1,-4,3,2,0,-1,1,-1,-1,-1,5,-1
KR_6737634767,420,1,-48,10,-1,-1,2,1,-4,5,1,2,3,5,3,4,7,-1,2,1,2,-3,-2,-3,-7,10,-3,0,-1,1,-1,-1,1,6,-1
KR_6744480934,420,-1,-81,12,-2,-2,3,1,-3,6,3,-2,5,3,5,0,5,0,0,0,0,-1,-27,-2,-5,7,24,0,-1,0,-1,-1,-1,0,-1
KR_6750436057,420,-5,-100,-1,-10,1,0,1,-6,8,2,-5,5,0,1,1,2,-1,2,1,0,-10,-7,-3,-3,6,1,0,-2,-1,1,-1,-1,5,-1
KR_6646719529,420,-2,-36,-26,2,0,1,1,1,2,3,4,1,5,-3,6,3,0,0,0,0,7,2,4,-9,5,-1,0,0,-1,-1,0,-1,2,-1
KR_6760878965,420,0,-31,4,-2,-3,4,1,-4,5,1,3,0,3,0,2,2,2,0,2,0,-4,31,-6,-5,11,-4,0,0,1,-1,0,-1,1,-1
KR_6760019961,420,-4,-64,-11,-11,1,1,2,-7,8,1,-2,6,4,-2,5,3,-1,1,0,0,-15,-8,-1,-2,3,-2,0,-1,-1,1,1,-1,5,-1
KR_6755032633,420,0,10,-20,0,-6,10,4,3,0,3,2,1,3,-1,1,0,2,0,2,-1,2,3,4,-8,4,3,0,0,-1,1,1,-1,1,-1
KR_6728942339,420,-1,-2,-9,1,0,1,1,1,4,5,-2,2,0,2,1,3,0,0,0,0,5,13,-1,-3,4,-3,0,-1,-1,-1,-1,-1,5,-1
KR_6735343696,420,-3,5,-46,-5,4,0,4,-4,4,0,2,0,2,-5,5,0,-2,3,1,0,-6,0,1,-6,5,-3,0,-1,-1,1,-1,1,6,-1
KR_6765212015,420,-4,-20,19,-6,0,4,4,-2,5,3,-2,2,0,0,2,2,-2,2,0,0,-8,-11,3,-5,2,2,0,-1,0,-1,-1,-1,0,-1
KR_6758109462,420,0,-16,3,1,0,1,1,-1,2,1,1,2,3,0,1,1,1,2,3,-1,0,263,1,-9,8,-2,0,0,1,-1,0,-1,5,-1
KR_6765569344,420,-1,19,24,-5,0,2,2,-5,7,2,0,2,2,0,2,2,0,0,0,0,-9,-65,-2,-3,5,19,0,-1,-1,-1,-1,-1,3,-1
KR_6766191218,420,-1,-31,-4,-7,-1,3,2,-5,8,3,-2,3,1,1,3,4,0,1,1,0,-11,3,2,-4,2,-1,0,-1,-1,-1,-1,1,3,-1
KR_6747518074,420,-3,-69,0,-4,0,1,1,-1,3,2,-1,1,0,-3,3,0,1,1,2,0,-6,-3,4,-7,3,-1,0,-1,-1,-1,-1,1,6,-1
KR_6763306926,420,1,-7,16,2,0,1,1,3,1,4,3,2,5,-2,7,5,-2,3,1,3,5,-20,-2,-4,6,-7,0,1,-1,-1,1,1,5,-1
KR_6757385014,420,-3,-91,-44,-5,-2,4,2,2,2,4,-4,5,1,0,0,0,-1,2,1,0,3,-6,1,-5,4,-3,0,-2,1,-1,-1,-1,4,-1
KR_6764782232,420,-2,-37,-20,-5,1,0,1,-1,3,2,-7,7,0,3,4,7,-1,1,0,0,-1,4,2,-6,4,-2,0,0,-1,-1,-1,-1,1,-1
KR_6758684262,420,-1,-7,10,-5,-2,2,0,-2,4,2,-1,2,1,2,2,4,-2,3,1,0,-5,-6,-4,-6,10,2,0,0,1,-1,-1,-1,6,-1
KR_6687082385,420,2,130,-24,9,3,1,4,6,1,7,-4,5,1,4,2,6,0,0,0,1,-1,9,3,-7,4,2,0,0,-1,1,1,1,6,-1
KR_6751835757,420,-2,-34,-8,2,2,0,2,1,2,3,-1,3,2,1,1,2,-1,1,0,0,3,51,1,-6,5,-4,0,0,-1,1,0,-1,3,-1
KR_6735956606,420,1,39,-11,-5,0,1,1,-3,5,2,0,2,2,-1,2,1,-1,1,0,0,-8,-5,-3,-2,5,5,0,-1,-1,-1,-1,1,1,-1
KR_6694413301,420,-8,-111,-20,-19,-5,6,1,-8,10,2,-3,5,2,-4,5,1,1,1,2,0,-9,-34,0,-6,6,0,0,-4,0,-1,-1,-1,0,-1
KR_6758385625,420,2,-32,0,3,3,1,4,-2,2,0,1,3,4,0,1,1,1,1,2,0,3,-2,5,-9,4,-2,0,1,1,1,1,1,4,-1
KR_6704362259,420,6,31,-20,7,4,0,4,0,3,3,-1,3,2,3,1,4,1,0,1,-2,-1,9,-1,-5,6,2,0,0,-1,0,0,-1,1,-1
KR_6736745205,420,3,-29,8,-3,4,2,6,-4,6,2,-1,3,2,-2,5,3,0,1,1,-2,-22,-8,0,-4,4,-3,0,0,0,1,-1,-1,0,-1
KR_6740238548,420,1,-52,-8,-1,6,1,7,0,2,2,-6,8,2,0,3,3,-1,2,1,0,-1,-7,3,-5,2,0,0,0,0,1,-1,-1,0,-1
KR_6761651742,420,-4,3,3,-5,-7,7,0,-2,2,0,6,0,6,-1,3,2,-1,2,1,0,-1,-6,-1,-3,4,-1,0,0,1,0,0,1,6,-1
KR_6760033762,420,0,-13,-22,2,-2,2,0,-1,3,2,-3,3,0,6,1,7,2,2,4,1,3,-16,-3,-3,6,1,0,0,-1,-1,1,1,5,-1
KR_6644522764,420,-2,-17,-13,-2,-1,1,0,-2,3,1,0,0,0,0,1,1,1,0,1,0,0,55,-4,-2,6,0,0,0,-1,1,0,-1,5,-1
KR_6735408511,420,-1,-52,0,5,-5,5,0,5,0,5,3,1,4,2,1,3,0,1,1,-1,11,3,3,-9,6,0,0,-1,-1,1,1,-1,4,-1
KR_6727980077,440,-2,-60,24,-4,-1,8,7,3,2,5,-1,5,4,-5,7,2,0,1,1,-1,-2,4,0,-1,1,0,0,-1,1,-1,-1,-1,2,-1
KR_6743275694,420,-2,-64,12,-2,1,1,2,4,1,5,0,1,1,-8,8,0,1,0,1,0,-1,12,-1,-3,4,-4,0,0,-1,1,-1,-1,2,-1
KR_6556341421,420,-6,-54,17,-14,-3,3,0,-5,6,1,-3,6,3,-4,5,1,1,1,2,-1,-29,-35,0,-3,3,-2,0,-1,0,1,-1,-1,0,-1
KR_6736797725,420,2,12,-17,3,2,0,2,-2,5,3,3,0,3,0,6,6,0,2,2,-1,-2,7,1,-7,6,-1,0,1,-1,1,1,-1,4,-1
KR_6572688355,440,-6,-20,-24,-15,-2,3,1,-2,2,0,-5,6,1,-4,5,1,-2,2,0,0,-9,-22,-6,-1,7,1,0,0,-1,-1,0,-1,1,-1
KR_6668919552,440,-2,3,-4,-4,1,0,1,3,1,4,0,3,3,-4,6,2,-4,4,0,0,-11,5,1,-4,3,-2,0,0,-1,1,0,1,4,-1
KR_6720044973,420,-2,-49,12,-1,-4,4,0,0,2,2,3,3,6,1,3,4,-1,1,0,0,2,-323,3,-6,3,2,0,0,-1,-1,-1,1,4,-1
KR_6494668698,420,-4,-38,-18,-10,-1,2,1,-4,6,2,0,4,4,-2,8,6,-3,4,1,0,-12,-9,-4,-3,7,-1,0,0,-1,-1,-1,-1,5,-1
KR_6761050876,440,-3,-39,-4,-2,2,0,2,2,3,5,2,2,4,-3,6,3,-5,5,0,0,-7,-7,-1,-4,5,-5,0,-1,0,0,-1,-1,0,-1
KR_6765705968,420,1,-15,3,-4,1,2,3,1,1,2,-1,4,3,-5,8,3,0,2,2,-3,-6,14,-2,-4,6,-5,0,-2,1,-1,-1,-1,5,-1
KR_6764741536,420,0,26,-3,9,5,2,7,0,4,4,4,1,5,1,3,4,-1,2,1,0,3,-6,1,-7,6,0,0,1,0,0,1,-1,0,-1
KR_6733584564,420,1,-6,14,-2,-2,2,0,1,3,4,3,2,5,-4,4,0,0,0,0,0,-6,-11,-6,-7,13,-4,0,0,-1,1,1,-1,3,-1
KR_6713876104,440,-2,-11,-2,-8,4,1,5,-3,6,3,1,2,3,-1,4,3,-9,9,0,0,-2,6,-1,-3,4,-5,0,-1,-1,-1,-1,-1,2,-1
KR_6486952212,420,-4,-37,-12,-6,-3,3,0,1,2,3,-1,1,0,-4,5,1,1,0,1,0,-3,-3,-5,-3,8,-1,0,-2,-1,-1,-1,-1,2,-1
KR_6753648948,420,2,45,9,0,1,1,2,-5,8,3,3,0,3,0,1,1,1,0,1,0,-3,-126,1,-6,5,-3,0,-1,1,-1,-1,1,4,-1
KR_6692389584,420,4,86,29,0,3,1,4,-4,6,2,3,1,4,-3,3,0,1,0,1,0,-13,6,0,-8,8,0,0,1,1,-1,1,-1,1,-1
KR_6756128793,440,1,-52,19,-1,3,2,5,3,3,6,-2,4,2,-3,5,2,-2,2,0,0,6,7,3,-6,3,-9,0,-1,1,1,-1,-1,4,-1
KR_6765164524,420,-1,6,-56,4,0,3,3,2,2,4,3,3,6,-2,3,1,1,0,1,0,8,38,5,-7,2,-1,0,1,0,-1,1,1,0,-1
KR_6743680336,420,-4,-31,-55,0,-1,2,1,3,3,6,-3,7,4,-3,4,1,4,2,6,0,0,1,3,-7,4,2,0,0,-1,1,-1,1,4,-1
KR_6762134402,420,-2,-36,8,-8,-6,7,1,-5,6,1,-1,4,3,1,2,3,3,1,4,0,-7,9,-5,-3,8,2,0,-2,1,-1,-1,-1,4,-1
KR_6737983087,420,3,74,5,2,1,0,1,-2,3,1,6,0,6,-1,2,1,-2,3,1,0,-1,40,4,-6,2,-13,0,-1,1,-1,-1,1,2,-1
KR_6727727632,420,-3,-47,-8,-2,-3,3,0,2,0,2,1,0,1,-2,4,2,0,2,2,0,-2,-22,-3,-2,5,3,0,-1,-1,1,1,-1,3,-1
KR_6762127397,420,4,60,7,11,-2,3,1,2,0,2,2,2,4,5,2,7,4,2,6,1,16,0,3,-5,2,4,0,1,1,-1,1,1,6,-1
KR_6765211287,420,-4,-84,-22,-9,-4,4,0,-4,8,4,-3,4,1,1,0,1,1,1,2,0,-1,56,0,-5,5,-11,0,-1,1,1,-1,1,6,-1
KR_6723142289,420,-2,-61,-18,1,-5,5,0,-2,3,1,2,1,3,6,3,9,0,1,1,0,-3,3,-2,-4,6,1,0,-1,1,-1,-1,1,6,-1
KR_6693167325,420,6,6,-11,13,-1,2,1,2,2,4,6,1,7,4,0,4,2,0,2,0,22,-19,0,-6,6,7,0,-1,1,-1,-1,-1,6,-1
KR_6609295969,420,1,-3,-12,0,0,1,1,4,1,5,-5,5,0,2,1,3,-1,2,1,0,-12,-7,-3,-3,6,0,0,0,1,1,0,-1,4,-1
KR_6751395395,440,-5,-57,-20,-12,0,0,0,2,2,4,-2,2,0,-2,2,0,-10,11,1,0,-5,10,1,-5,4,-7,0,0,-1,1,-1,-1,3,-1
KR_6722411204,420,-2,4,-5,-7,-3,3,0,-5,8,3,2,1,3,1,1,2,-2,2,0,0,-13,13,-3,-4,7,-1,0,0,-1,-1,0,-1,1,-1
KR_6746274441,420,1,-13,12,1,2,1,3,-2,5,3,1,2,3,-2,4,2,2,0,2,0,-1,5,-1,-8,9,-2,0,0,-1,-1,-1,-1,1,-1
KR_6756131287,420,-6,-113,-28,-12,-1,1,0,-1,1,0,-5,5,0,-5,8,3,0,1,1,0,-11,-12,-6,-1,7,-3,0,-1,-1,-1,-1,-1,1,-1
KR_6630203017,420,0,27,-28,0,5,0,5,-2,5,3,-1,6,5,-3,5,2,1,1,2,-1,-5,-2,2,-4,2,0,0,1,1,-1,-1,-1,6,-1
KR_6345834261,420,-3,-57,-8,-4,0,1,1,0,2,2,1,1,2,-4,4,0,-1,1,0,0,-6,-4,-2,-4,6,4,0,0,-1,1,-1,-1,4,-1
KR_6757897834,420,1,-12,24,0,-2,3,1,2,2,4,0,3,3,0,3,3,0,2,2,0,-2,5,-2,-4,6,-1,0,0,0,1,0,1,0,-1
KR_6760295848,420,1,25,9,0,-1,2,1,2,0,2,-4,4,0,2,0,2,1,0,1,0,2,-1,-2,-4,6,4,0,0,1,-1,0,-1,3,-1
KR_6763190015,420,0,-38,-5,-2,-3,4,1,0,3,3,-1,1,0,2,2,4,0,0,0,0,9,12,3,-5,2,-5,0,-3,-1,-1,-1,1,2,-1
KR_6757712257,420,-7,-144,5,-19,-4,5,1,-5,7,2,-4,8,4,-4,7,3,-2,2,0,0,-5,-1,5,-8,3,-4,0,-4,-1,-1,-1,-1,6,-1
KR_6753439773,420,-2,-4,12,-7,-3,4,1,6,0,6,-7,8,1,-4,5,1,1,0,1,0,-10,4,2,-9,7,-2,0,0,1,0,1,1,1,-1
KR_6759130336,440,-2,-31,-21,-12,-2,4,2,-2,3,1,-6,7,1,-1,3,2,-1,2,1,-2,-8,-264,-5,-2,7,-4,0,0,-1,-1,0,-1,2,-1
KR_6762656753,420,-1,-2,-18,1,0,0,0,0,2,2,0,2,2,0,2,2,1,0,1,0,4,120,-1,-7,8,1,0,-1,-1,-1,-1,1,6,-1
KR_6731915608,420,4,37,28,4,3,2,5,-1,4,3,0,2,2,3,1,4,-1,2,1,0,-2,2,2,-5,3,0,0,-1,-1,-1,-1,1,4,-1
KR_6686604301,440,-7,-64,-56,-17,2,2,4,-3,5,2,-2,3,1,-15,16,1,1,0,1,0,-16,-5,-1,-4,5,-1,0,-2,-1,0,-1,-1,3,-1
KR_6694905888,420,3,72,8,8,1,4,5,2,3,5,6,2,8,-1,4,3,0,1,1,-3,0,-8,-2,-2,4,3,0,3,-1,-1,1,-1,1,-1
KR_6764565539,420,-2,-54,12,-6,-3,4,1,1,1,2,-3,4,1,-1,1,0,0,1,1,0,0,13,0,-4,4,2,0,-1,-1,-1,-1,-1,5,-1
KR_6707474660,420,2,90,-40,10,6,2,8,-1,2,1,-3,4,1,10,1,11,-2,2,0,0,23,4,-1,-4,5,3,0,2,1,-1,1,1,3,-1
KR_6731403591,420,-1,31,-16,-6,-2,4,2,3,1,4,-1,2,1,-1,3,2,-5,5,0,-1,-6,-5,1,-5,4,1,0,-1,1,-1,-1,-1,1,-1
KR_6756654623,420,3,113,-6,4,0,3,3,1,0,1,-2,6,4,5,2,7,0,0,0,0,6,290,3,-6,3,-3,0,0,-1,-1,0,-1,4,-1
KR_6734696287,440,-4,-32,-4,-9,-4,6,2,-1,1,0,-2,4,2,-1,3,2,-1,2,1,0,-11,4,-9,-2,11,5,0,-2,0,-1,-1,1,0,-1
KR_6763772759,440,-4,7,0,-8,2,1,3,0,3,3,-4,6,2,-5,5,0,-1,1,0,0,-16,-12,0,-6,6,-3,0,0,-1,-1,0,1,6,-1
KR_6720466870,420,0,-25,-16,-4,5,0,5,-3,5,2,3,0,3,-1,2,1,-8,8,0,0,-11,5,0,-2,2,-5,0,1,-1,-1,-1,-1,3,-1
KR_6692135492,420,1,13,12,-5,-1,3,2,-2,3,1,0,2,2,-3,5,2,1,1,2,0,-3,3,1,-4,3,-2,0,-1,-1,-1,-1,-1,5,-1
KR_6758631925,440,-2,12,8,-7,4,0,4,-1,5,4,2,1,3,-5,7,2,-7,7,0,0,-9,7,6,-6,0,-4,0,1,-1,0,1,1,5,-1
KR_6759172579,420,1,-21,5,-4,-4,5,1,-2,5,3,3,3,6,0,1,1,-1,1,0,0,-1,-3,-5,-2,7,2,0,2,1,1,1,-1,6,-1
KR_6722183355,420,0,11,0,-6,3,2,5,-3,4,1,1,2,3,-3,3,0,-4,4,0,0,-15,32,-2,-5,7,-6,0,-3,-1,-1,-1,1,5,-1
KR_6758996021,420,1,-35,-15,-1,0,0,0,3,2,5,3,1,4,-4,5,1,-3,3,0,0,1,-13,0,-7,7,5,0,-1,0,-1,-1,-1,0,-1
KR_6707891971,420,-6,-98,-8,-3,-4,4,0,-1,3,2,-2,3,1,3,1,4,1,0,1,-1,5,7,2,-4,2,2,0,0,1,-1,1,-1,1,-1
KR_6666915291,420,1,-14,4,5,6,0,6,-4,6,2,-4,4,0,4,1,5,3,0,3,0,-1,-7,-1,-2,3,-1,0,1,-1,1,1,1,5,-1
KR_6760289305,420,3,-37,12,2,1,1,2,1,2,3,1,5,6,-3,6,3,2,0,2,0,3,0,-4,-2,6,-3,0,1,-1,1,-1,-1,1,-1
KR_6752145442,420,-7,-107,-20,-7,-2,3,1,1,2,3,-3,4,1,-2,2,0,-1,4,3,0,2,-5,2,-5,3,1,0,-1,-1,-1,-1,1,2,-1
KR_6756475648,420,-2,-37,-25,-2,-5,5,0,-1,2,1,2,1,3,2,2,4,0,2,2,0,1,2,2,-5,3,0,0,-1,-1,-1,-1,-1,5,-1
KR_6729175948,440,2,0,9,-2,0,3,3,0,3,3,-4,5,1,-3,4,1,5,0,5,-1,1,22,-1,-5,6,5,0,1,-1,1,1,-1,5,-1
KR_6761296540,420,-1,-18,-8,-5,2,0,2,1,1,2,-3,3,0,-4,6,2,-1,3,2,0,-4,-2,3,-7,4,0,0,1,-1,-1,1,-1,5,-1
KR_6763430768,420,-3,-53,-24,-7,-4,4,0,1,2,3,0,0,0,-2,2,0,-2,2,0,0,-6,-1,-1,-4,5,-2,0,-1,-1,-1,-1,-1,2,-1
KR_6766120356,420,-5,-35,-16,-6,0,2,2,-3,4,1,-1,1,0,-2,3,1,0,2,2,0,-7,12,-1,-3,4,0,0,-2,-1,-1,-1,-1,4,-1
KR_6735257310,420,-1,-24,-31,0,-1,2,1,0,2,2,-5,5,0,8,0,8,-2,2,0,0,4,0,1,-4,3,-1,0,1,1,-1,1,1,6,-1
KR_6670156558,420,0,-3,-3,1,3,0,3,-1,3,2,0,4,4,-1,1,0,0,2,2,1,-6,-39,2,-6,4,-1,0,0,1,-1,0,1,2,-1
KR_6698386428,420,-1,-12,-4,-1,1,0,1,-2,2,0,0,1,1,4,1,5,-4,4,0,0,3,-226,3,-8,5,-6,0,-1,-1,-1,-1,1,1,-1
KR_6579300275,420,1,-40,0,2,-2,2,0,3,1,4,-1,2,1,2,2,4,0,0,0,0,7,10,4,-9,5,0,0,0,1,1,0,-1,1,-1
KR_6765883275,440,3,36,-9,4,-1,2,1,0,1,1,-2,3,1,5,1,6,2,0,2,0,3,-14,1,-6,5,1,0,-1,1,-1,-1,1,3,-1
KR_6623672237,420,-4,-55,-30,-6,-5,6,1,-4,4,0,-1,2,1,3,3,6,1,0,1,0,-5,22,2,-6,4,-7,0,-2,1,-1,-1,-1,3,-1
KR_6736991571,420,-1,-10,-28,-1,3,1,4,-4,8,4,-1,2,1,4,5,9,-3,3,0,0,-6,1,-2,-4,6,0,0,-1,0,0,-1,1,0,-1
KR_6756524816,420,0,-56,-8,4,0,1,1,-2,2,0,1,2,3,6,1,7,-1,1,0,-1,1,116,1,-6,5,-4,0,1,-1,1,1,-1,2,-1
KR_6629536457,420,-3,-87,4,-2,-1,3,2,-2,4,2,-1,2,1,1,4,5,1,0,1,0,2,17,0,-4,4,-7,0,-1,1,-1,-1,-1,1,-1
KR_6609221430,420,2,15,-12,-2,0,1,1,1,1,2,-6,7,1,2,2,4,1,0,1,0,4,8,0,-4,4,-6,0,0,-1,-1,0,1,5,-1
KR_6749256060,420,-3,-11,-20,-2,-1,1,0,-1,4,3,1,5,6,-1,2,1,0,1,1,1,9,3,3,-6,3,-2,0,1,-1,1,1,1,5,-1
KR_6497760326,420,-1,-46,5,-2,1,0,1,2,3,5,0,0,0,-6,6,0,1,0,1,-2,-6,9,2,-7,5,-2,0,0,-1,1,1,-1,2,-1
KR_6686720933,420,-4,17,-8,-3,0,0,0,1,2,3,-3,6,3,-4,6,2,3,1,4,1,-9,-2,2,-8,6,3,0,-1,-1,-1,-1,1,5,-1
KR_6710319527,420,-3,-2,-11,-13,0,3,3,-7,7,0,0,2,2,-6,8,2,0,2,2,0,-15,1,-4,-5,9,-5,0,-1,1,0,-1,1,4,-1
KR_6743845889,420,0,0,-4,6,-2,3,1,0,4,4,4,1,5,4,1,5,0,3,3,0,10,6,-3,-5,8,3,0,0,-1,-1,0,1,6,-1
KR_6752884939,440,1,44,-7,0,3,0,3,-1,1,0,-1,1,0,0,1,1,-1,2,1,0,-4,3,-1,-4,5,2,0,1,1,1,1,-1,3,-1
KR_6692999029,420,-1,34,-22,-1,2,0,2,-3,3,0,2,3,5,0,4,4,-2,2,0,-3,-4,-3,-1,-3,4,-3,0,0,1,1,0,-1,1,-1
KR_6640909080,440,-3,-40,-7,-10,1,2,3,1,0,1,-4,4,0,-1,1,0,-7,7,0,-1,-13,-8,0,-6,6,0,0,-1,-1,-1,-1,-1,1,-1
KR_6760389119,420,-1,-84,5,-9,-3,4,1,-3,5,2,-2,4,2,0,3,3,-1,3,2,-1,-16,-8,-2,-3,5,0,0,0,-1,-1,0,-1,1,-1
KR_6765093920,420,-7,-52,-12,-13,-5,7,2,-2,4,2,-4,4,0,-2,4,2,0,0,0,0,-17,-13,1,-4,3,1,0,-1,-1,-1,-1,-1,2,-1
KR_6532232494,420,-3,-14,-10,-2,-1,2,1,-2,5,3,1,1,2,-3,3,0,3,2,5,0,-5,12,7,-9,2,4,0,-1,-1,1,-1,1,4,-1
KR_6762964187,420,-2,-27,20,-4,-1,3,2,-7,8,1,1,2,3,5,2,7,-2,3,1,0,3,-5,0,-5,5,-2,0,0,1,-1,0,1,3,-1
KR_6755564927,420,-3,24,-32,-4,-4,4,0,-7,7,0,1,1,2,7,1,8,-1,1,0,0,4,-7,-2,-3,5,3,0,0,1,1,0,-1,2,-1
KR_6761148973,420,-3,-29,-4,3,0,1,1,4,5,9,5,2,7,-1,3,2,-5,7,2,1,7,7,1,-7,6,-2,0,1,-1,1,1,1,5,-1
KR_6746006730,420,1,23,-8,6,2,2,4,3,4,7,-2,2,0,2,2,4,1,0,1,0,12,32,7,-9,2,-11,0,0,-1,0,0,-1,5,-1
KR_6724659683,440,-7,-117,-16,-14,-1,2,1,-5,6,1,-4,5,1,-3,5,2,-1,1,0,1,-14,21,0,-4,4,-4,0,0,1,-1,0,1,2,-1
KR_6669577411,420,0,14,-12,-5,1,1,2,-3,4,1,0,4,4,-1,7,6,-2,3,1,0,-14,-7,-7,-3,10,1,0,-1,-1,-1,-1,-1,3,-1
KR_6759325239,420,-1,33,16,-7,1,1,2,0,2,2,0,2,2,-5,5,0,-3,5,2,-1,-9,45,5,-6,1,-4,0,1,0,-1,-1,-1,0,-1
KR_6733486880,440,-3,-63,-32,-18,-3,3,0,-6,8,2,-5,9,4,-3,4,1,-1,2,1,-3,-23,-68,-8,-2,10,-1,0,-2,-1,-1,-1,-1,2,-1
KR_6610383762,420,2,42,18,4,2,0,2,0,4,4,2,1,3,-1,5,4,1,0,1,0,3,-12,1,-4,3,0,0,0,-1,-1,0,1,5,-1
KR_6736795936,440,0,-23,-24,7,1,0,1,6,0,6,0,0,0,-1,2,1,1,0,1,0,9,-28,0,-5,5,5,0,2,1,-1,1,-1,2,-1
KR_6734969994,420,-3,-7,-27,-5,2,1,3,-7,9,2,-1,1,0,0,3,3,1,0,1,0,-6,35,2,-5,3,-7,0,0,1,1,-1,1,1,-1
KR_6752588151,420,1,8,-8,-6,-1,2,1,-4,6,2,-1,1,0,0,5,5,0,0,0,0,-10,2,0,-5,5,-5,0,0,1,0,0,-1,6,-1
KR_6740180469,440,-2,-10,-12,-3,-3,4,1,1,2,3,0,0,0,0,1,1,-1,1,0,0,0,-201,-1,-2,3,0,0,0,0,0,0,1,0,-1
KR_6709136471,440,0,68,-15,-6,1,0,1,-7,9,2,-1,2,1,0,0,0,1,1,2,1,-8,-50,0,-3,3,16,0,0,-1,1,-1,1,5,-1
KR_6755412406,420,0,55,-16,2,4,0,4,0,0,0,-4,7,3,-2,6,4,4,0,4,0,1,-10,-7,-5,12,1,0,-1,-1,-1,-1,1,2,-1
KR_6745397418,420,-2,-85,-20,-4,0,2,2,-1,2,1,1,2,3,-5,6,1,1,0,1,0,1,-4,-4,-3,7,-6,0,-1,0,-1,-1,1,0,-1
KR_6692195746,420,-1,-61,5,4,-3,6,3,2,0,2,0,5,5,4,1,5,1,0,1,0,14,14,7,-11,4,1,0,-1,-1,1,-1,1,1,-1
KR_6758500131,420,-7,-58,-33,-14,-3,4,1,-4,5,1,0,2,2,-11,12,1,4,2,6,-1,-14,5,-1,-5,6,-3,0,-2,-1,1,-1,-1,4,-1
KR_6741708309,420,1,12,-32,4,4,1,5,6,2,8,-1,2,1,-4,6,2,-1,2,1,0,4,2,8,-10,2,3,0,2,1,-1,1,1,5,-1
KR_6712174730,420,-1,-102,16,-3,-4,7,3,1,2,3,1,1,2,-3,4,1,2,0,2,0,-5,-2,2,-4,2,-5,0,-2,-1,-1,-1,-1,5,-1
KR_6680920459,420,-2,15,-12,-5,-1,5,4,-3,7,4,1,2,3,-1,2,1,-1,2,1,0,-8,45,-1,-5,6,-13,0,1,-1,1,1,-1,1,-1
KR_6762480832,440,-2,-48,31,-2,-1,2,1,3,2,5,-1,1,0,-2,6,4,-1,3,2,0,-4,-7,1,-4,3,-3,0,0,1,-1,0,1,2,-1
KR_6717158722,420,1,-52,30,-2,-2,5,3,-3,5,2,-1,1,0,2,2,4,2,1,3,0,0,43,-6,-3,9,2,0,-1,1,-1,-1,-1,4,-1
KR_6711594517,420,4,41,-20,8,2,2,4,1,1,2,-4,5,1,7,0,7,2,0,2,0,17,-33,-1,-5,6,4,0,1,-1,1,1,1,3,-1
KR_6751648229,420,0,4,-19,1,-8,8,0,1,1,2,3,1,4,4,1,5,1,1,2,0,11,-2,2,-3,1,1,0,0,-1,1,-1,-1,6,-1
KR_6704792194,420,-1,-74,-13,-3,0,3,3,0,3,3,-1,3,2,-2,2,0,0,1,1,-1,-6,-4,1,-6,5,-4,0,0,-1,1,-1,-1,2,-1
KR_6548550517,440,0,-1,-10,-3,1,1,2,-2,2,0,-1,3,2,0,2,2,-1,1,0,0,0,-11,2,-8,6,-3,0,0,-1,1,-1,1,3,-1
KR_6698815397,420,-2,-57,-6,-9,1,2,3,1,2,3,-1,1,0,-9,9,0,-1,1,0,0,-7,-33,-8,0,8,5,0,-1,-1,1,-1,-1,6,-1
KR_6525054070,420,1,17,24,4,5,2,7,3,3,6,0,2,2,-4,5,1,0,0,0,0,-4,-9,0,-5,5,1,0,0,1,-1,1,1,2,-1
KR_6744576942,420,0,49,-24,-7,1,0,1,-4,7,3,3,1,4,-3,3,0,-4,4,0,0,-16,-2,-1,-8,9,4,0,0,-1,-1,0,-1,5,-1
KR_6756683689,420,0,-35,-26,3,-2,4,2,0,5,5,0,0,0,5,2,7,0,2,2,0,7,-14,-1,-4,5,6,0,1,-1,-1,1,-1,4,-1
KR_6611043216,420,-5,-90,11,-6,-3,4,1,-1,2,1,1,3,4,-2,7,5,-1,2,1,0,-8,16,4,-5,1,-5,0,0,0,1,0,1,0,-1
KR_6679320700,420,-5,-47,8,-7,-2,3,1,-2,7,5,-6,6,0,4,0,4,-1,1,0,0,8,-10,1,-4,3,-4,0,-3,-1,-1,-1,-1,6,-1
KR_6735832029,420,-3,-38,-20,0,-2,5,3,2,1,3,-4,7,3,3,3,6,1,2,3,-1,6,-26,3,-8,5,2,0,-2,1,-1,-1,-1,3,-1
KR_6684132105,420,-2,-29,-32,-1,-1,1,0,2,2,4,-7,8,1,4,2,6,1,1,2,2,5,40,1,-5,4,0,0,-1,-1,-1,-1,1,6,-1
KR_6754186510,420,0,-11,-22,-5,-2,2,0,-4,5,1,-2,3,1,4,2,6,-1,1,0,0,-2,-15,-2,-4,6,7,0,1,1,-1,1,1,2,-1
KR_6741039326,420,-3,-42,16,-6,1,3,4,-2,4,2,-3,4,1,-2,3,1,0,1,1,-2,-9,22,-2,-4,6,-2,0,-2,1,-1,-1,-1,6,-1
KR_6733492758,420,0,-30,-5,-1,-3,5,2,1,2,3,-1,5,4,0,5,5,2,0,2,0,1,-9,-1,-2,3,3,0,1,-1,1,1,1,4,-1
KR_6717805899,420,-4,-47,4,-10,-2,4,2,0,2,2,-9,9,0,-3,4,1,4,0,4,1,-13,16,-6,-2,8,-2,0,-3,0,-1,-1,1,0,-1
KR_6744264201,420,3,10,15,7,1,0,1,2,2,4,2,2,4,2,1,3,0,1,1,0,10,55,3,-8,5,-3,0,0,-1,1,0,-1,2,-1
KR_6753086209,420,-6,-108,-16,-11,-2,3,1,-3,4,1,-1,1,0,-3,5,2,-2,2,0,-1,-9,-7,-6,-2,8,1,0,0,1,-1,-1,-1,1,-1
KR_6685492972,420,-5,-93,-32,-8,-4,6,2,3,3,6,2,1,3,-6,9,3,-3,3,0,0,-5,3,0,-4,4,-5,0,-2,-1,-1,-1,-1,5,-1
KR_6694885353,420,-3,-45,22,-10,-2,3,1,-5,9,4,-2,2,0,0,4,4,-1,2,1,0,-10,-7,-1,-4,5,3,0,-1,1,1,-1,-1,1,-1
KR_6754752319,420,-3,-25,-12,-6,0,0,0,-6,6,0,2,0,2,-1,2,1,-1,1,0,0,-2,-20,-5,-3,8,8,0,0,-1,-1,-1,-1,1,-1
KR_6736071778,420,-1,43,-1,0,2,2,4,-3,5,2,-2,3,1,3,1,4,0,1,1,0,4,-5,2,-7,5,3,0,0,1,-1,-1,1,3,-1
KR_6754065030,420,-3,-106,-53,-3,-3,3,0,-4,6,2,2,3,5,2,1,3,0,0,0,0,3,-10,-1,-3,4,3,0,-1,0,-1,-1,1,0,-1
KR_6750703646,420,-4,5,-21,-7,-2,3,1,-1,3,2,-4,5,1,0,1,1,0,3,3,0,-4,4,-2,-4,6,-2,0,0,-1,-1,-1,-1,1,-1
KR_6723582560,420,0,2,-8,-1,3,0,3,2,2,4,1,1,2,-6,6,0,-1,1,0,0,3,3,-5,-2,7,-7,0,-1,-1,-1,-1,1,2,-1
KR_6691231352,420,4,76,39,1,3,0,3,-1,5,4,-2,3,1,1,0,1,0,0,0,0,0,119,0,-2,2,2,0,0,1,-1,1,-1,1,-1
KR_6680375539,420,-1,-28,-8,-2,1,2,3,-3,6,3,1,1,2,-3,6,3,2,0,2,0,1,44,1,-7,6,-15,0,1,-1,1,1,1,3,-1
KR_6724381647,420,0,-28,-2,-4,-1,3,2,0,4,4,2,1,3,-3,4,1,-2,2,0,0,-4,9,-1,-5,6,2,0,1,0,1,1,-1,0,-1
KR_6707560760,420,0,34,-1,4,-3,4,1,0,1,1,0,3,3,4,2,6,3,0,3,-1,8,53,3,-6,3,-17,0,0,1,-1,1,-1,3,-1
KR_6754298852,420,2,13,0,1,-1,4,3,1,4,5,1,4,5,1,2,3,-1,1,0,-1,-4,-1,-5,-6,11,6,0,0,0,1,0,-1,0,-1
KR_6690821863,420,-1,-40,-4,-5,-1,2,1,4,2,6,-1,3,2,-6,6,0,-1,3,2,0,-10,-2,-8,-3,11,4,0,1,1,0,-1,-1,4,-1
KR_6733236376,420,0,35,0,1,1,2,3,-1,1,0,1,1,2,-3,3,0,3,1,4,0,-3,1,3,-9,6,-5,0,0,-1,1,1,1,6,-1
KR_6760673004,440,3,55,7,7,5,1,6,-1,4,3,1,0,1,3,2,5,-1,1,0,0,-3,7,2,-5,3,2,0,0,1,-1,0,1,2,-1
KR_6758318856,420,-1,7,-27,3,-2,4,2,1,3,4,5,1,6,0,1,1,-1,1,0,0,3,1,3,-7,4,2,0,-1,1,-1,-1,1,5,-1
KR_6680136662,420,-1,-14,4,-6,1,2,3,-2,3,1,-2,2,0,-4,5,1,1,0,1,0,-8,207,1,-7,6,2,0,0,-1,1,1,-1,2,-1
KR_6754373785,420,-4,-49,-8,-9,-6,6,0,2,1,3,-2,3,1,-3,8,5,0,2,2,-2,-14,15,1,-4,3,-1,0,-1,1,1,-1,-1,1,-1
KR_6595312680,440,-7,-50,-36,-17,-12,13,1,1,1,2,-6,8,2,-1,3,2,1,0,1,0,-11,-17,-3,-3,6,1,0,-2,-1,-1,-1,-1,4,-1
KR_6695894301,420,-3,22,-25,-1,1,1,2,-1,6,5,-1,2,1,0,2,2,0,2,2,0,7,33,0,-9,9,0,0,1,-1,-1,1,-1,2,-1
KR_6429540163,420,-5,-36,-24,-8,-2,3,1,-7,7,0,-3,4,1,2,1,3,2,0,2,0,-4,-8,-5,-5,10,-1,0,-1,1,-1,-1,-1,1,-1
KR_6737615587,420,-4,-108,-7,-9,-5,5,0,-5,7,2,-4,6,2,0,4,4,5,0,5,-1,-9,-7,3,-8,5,-6,0,-2,-1,-1,-1,-1,2,-1
KR_6756595169,420,4,19,24,6,2,2,4,0,2,2,1,0,1,4,0,4,-1,1,0,0,7,-3,0,-7,7,5,0,0,1,-1,0,1,6,-1
KR_6764747124,440,2,25,16,5,8,0,8,-4,5,1,-3,5,2,3,2,5,1,0,1,0,2,0,0,-4,4,0,0,1,0,1,1,1,0,-1
KR_6756233466,420,-1,-28,-26,-7,2,1,3,-4,5,1,1,2,3,-3,3,0,-3,4,1,0,-11,-20,-2,-4,6,-7,0,0,-1,-1,-1,1,2,-1
KR_6699596794,420,0,8,15,2,5,1,6,-3,4,1,0,1,1,2,3,5,-2,2,0,1,3,5,2,-7,5,3,0,0,-1,-1,0,1,3,-1
KR_6735768434,420,1,63,-12,2,1,2,3,-1,2,1,-2,5,3,2,7,9,2,0,2,1,5,9,4,-9,5,-2,0,0,-1,1,0,1,2,-1
KR_6732432328,420,-2,-23,-8,-2,0,0,0,0,1,1,-1,1,0,-1,3,2,0,1,1,-1,-2,-19,0,-7,7,-1,0,0,-1,-1,0,-1,3,-1
KR_6762778273,420,-1,19,-6,-3,0,1,1,1,2,3,-1,3,2,-2,4,2,-1,1,0,-1,0,-6,-1,-5,6,4,0,0,-1,-1,0,-1,4,-1
KR_6751627378,420,-2,-25,28,-2,-1,4,3,1,2,3,-2,2,0,0,1,1,0,1,1,0,3,6,-1,-3,4,-3,0,0,1,-1,0,-1,3,-1
KR_6656839587,420,-1,-55,-17,-3,0,3,3,-3,4,1,1,0,1,0,1,1,-1,2,1,-1,-7,2,-3,-1,4,-7,0,0,-1,-1,-1,-1,3,-1
KR_6753636211,420,-2,-38,-14,-2,4,2,6,-4,5,1,1,4,5,-1,4,3,-2,2,0,-1,-8,-5,-4,-5,9,-4,0,0,-1,1,1,-1,6,-1
KR_6709105598,440,-5,-91,-4,-12,-3,3,0,-4,6,2,-9,9,0,1,1,2,3,0,3,0,-15,-4,-3,-5,8,-3,0,0,-1,1,-1,-1,2,-1
KR_6703873511,420,-1,-61,-42,-8,-11,11,0,0,5,5,-2,3,1,4,2,6,1,1,2,0,4,2,2,-6,4,-3,0,-3,-1,-1,-1,-1,3,-1
KR_6704272337,420,-5,-77,-15,-8,0,2,2,-2,3,1,0,3,3,-4,5,1,-2,2,0,0,-9,-6,1,-5,4,0,0,-2,-1,-1,-1,-1,3,-1
KR_6736390556,440,-5,-44,-3,-16,-7,8,1,-3,5,2,1,3,4,-2,5,3,-5,6,1,0,-14,80,-2,-4,6,-3,0,-2,1,1,-1,1,6,-1
KR_6753394069,420,-2,-38,3,-5,-7,7,0,-3,4,1,-1,4,3,3,4,7,3,1,4,-1,4,-5,-6,-1,7,3,0,-1,1,-1,-1,-1,1,-1
KR_6749525823,420,0,48,22,-5,3,2,5,0,2,2,-4,4,0,-4,4,0,0,2,2,0,-5,38,3,-4,1,-27,0,2,-1,1,1,-1,6,-1
KR_6707078649,420,-7,-60,-32,-16,1,0,1,-3,6,3,-9,9,0,-7,8,1,2,0,2,0,-12,-6,-6,-2,8,-4,0,-2,-1,-1,-1,-1,4,-1
KR_6750211287,420,-3,-60,-19,-8,-1,1,0,3,1,4,-9,9,0,-2,4,2,1,1,2,0,-5,-15,-5,-2,7,3,0,0,-1,-1,-1,1,1,-1
KR_6756247139,420,-2,-77,-10,1,-3,4,1,-1,4,3,-3,5,2,4,3,7,4,0,4,0,4,-9,-5,-3,8,-5,0,1,1,1,1,1,5,-1
KR_6669967370,420,2,0,-8,2,3,1,4,-3,6,3,-1,2,1,-3,5,2,6,0,6,0,-3,-15,-11,-4,15,0,0,1,1,-1,1,-1,1,-1
KR_6677501067,440,-2,15,-20,-7,-2,2,0,-3,3,0,-4,6,2,2,2,4,0,0,0,0,-3,-69,1,-3,2,0,0,1,-1,-1,1,-1,2,-1
KR_6748889168,420,-4,-18,4,-1,0,0,0,2,2,4,-1,4,3,-2,5,3,0,0,0,-1,-2,-2,2,-9,7,2,0,0,1,0,0,1,6,-1
KR_6757260385,420,-6,-110,-18,-7,1,1,2,-4,8,4,-3,4,1,-1,3,2,0,2,2,0,-13,18,-1,-1,2,-2,0,-4,-1,-1,-1,-1,2,-1
KR_6758746092,420,-4,-34,-39,-6,0,1,1,-1,2,1,-2,6,4,2,2,4,-5,5,0,0,-6,12,3,-8,5,-4,0,-2,-1,-1,-1,1,4,-1
KR_6753359520,420,-3,-80,9,0,-5,8,3,0,1,1,2,2,4,3,2,5,0,1,1,1,6,1,-1,-5,6,0,0,0,0,1,-1,1,0,-1
KR_6745481389,420,-3,-46,-40,-3,0,2,2,0,2,2,-4,6,2,-1,3,2,2,2,4,0,0,-10,-4,-5,9,-2,0,0,1,1,1,-1,6,-1
KR_6765640875,420,-4,-67,-5,-3,2,4,6,-2,2,0,3,5,8,-5,5,0,-1,4,3,1,0,-5,-5,-2,7,0,0,-2,0,-1,-1,1,0,-1
KR_6764862887,420,1,64,-12,0,2,1,3,-2,5,3,0,3,3,0,1,1,0,0,0,-1,-6,-11,0,-5,5,1,0,1,-1,1,1,-1,6,-1
KR_6682029043,420,-2,-20,-10,-9,1,1,2,-3,3,0,-2,2,0,2,2,4,-7,7,0,0,-9,-4,1,-4,3,5,0,0,1,1,-1,-1,2,-1
KR_6761381989,420,-2,-54,40,-8,-2,2,0,-5,6,1,-1,4,3,-3,3,0,3,0,3,-2,-19,160,4,-5,1,0,0,0,-1,1,0,-1,3,-1
KR_6647688145,440,-3,43,-14,-4,3,0,3,-7,8,1,1,1,2,-2,3,1,1,0,1,0,-10,3,2,-7,5,-5,0,-1,1,-1,-1,1,3,-1
KR_6759908304,420,-3,-58,3,-8,-1,2,1,1,3,4,-8,9,1,-1,1,0,1,0,1,0,-8,-9,-5,-3,8,2,0,-1,1,-1,-1,-1,4,-1
KR_6762006146,420,-4,-42,-5,-5,0,1,1,-1,2,1,-4,4,0,-2,5,3,2,2,4,0,-5,11,5,-13,8,-9,0,-1,1,1,-1,1,2,-1
KR_6741153460,420,3,15,11,5,5,1,6,0,2,2,-3,4,1,1,0,1,2,0,2,0,1,-9,-2,-4,6,3,0,0,-1,-1,-1,-1,4,-1
KR_6758605477,420,-1,-34,4,-15,-5,5,0,0,2,2,0,3,3,-8,8,0,-2,4,2,0,-6,-14,-4,-4,8,9,0,-3,1,-1,-1,-1,5,-1
KR_6751684552,420,-2,-25,-4,-1,-2,3,1,2,3,5,2,0,2,-2,5,3,-1,2,1,0,4,1,2,-5,3,-2,0,-1,1,-1,-1,1,5,-1
KR_6648167752,420,3,23,-8,-1,2,1,3,-2,4,2,-1,4,3,1,1,2,-1,1,0,0,-5,10,3,-7,4,0,0,1,1,1,1,1,1,-1
KR_6766181378,420,-1,-53,11,-5,-5,5,0,-2,4,2,-1,4,3,2,0,2,1,0,1,0,-6,46,10,-13,3,-12,0,-3,-1,-1,-1,-1,3,-1
KR_6751246323,440,-1,-26,-8,0,-1,4,3,2,1,3,-2,2,0,0,3,3,1,2,3,0,3,44,-1,-8,9,-28,0,0,-1,1,1,-1,6,-1
KR_6617128355,420,-1,-45,-16,-9,-5,5,0,-5,5,0,2,2,4,1,1,2,-2,2,0,0,-2,-12,-2,-3,5,3,0,-1,-1,-1,-1,-1,5,-1
KR_6713797600,420,1,20,16,2,1,1,2,1,3,4,-1,3,2,1,3,4,0,0,0,0,0,-9,-1,-6,7,0,0,0,1,1,-1,-1,2,-1
KR_6733000917,440,-2,-77,15,1,2,1,3,-1,5,4,2,0,2,-3,3,0,1,0,1,0,6,-3,4,-7,3,-3,0,0,1,-1,-1,1,3,-1
KR_6702694548,420,-3,-79,-36,-4,1,2,3,-3,4,1,-4,5,1,2,2,4,0,1,1,0,4,22,1,-8,7,-6,0,0,-1,-1,-1,1,4,-1
KR_6745801309,420,1,33,3,2,2,2,4,-2,5,3,1,2,3,0,1,1,1,0,1,0,-1,261,5,-10,5,-4,0,-2,1,-1,-1,1,1,-1
KR_6674687761,440,0,-25,-15,6,0,0,0,0,2,2,3,0,3,0,2,2,3,2,5,0,13,11,1,-3,2,1,0,0,1,1,0,-1,2,-1
KR_6531578615,440,-4,-118,-42,-6,0,2,2,-6,7,1,0,4,4,-2,3,1,2,0,2,-1,0,3,1,-6,5,-2,0,-1,-1,-1,-1,-1,1,-1
KR_6523553809,420,0,69,-24,5,1,1,2,-1,1,0,1,1,2,3,1,4,1,0,1,0,9,19,0,-6,6,4,0,2,1,-1,1,1,1,-1
KR_6700498859,420,-4,56,-21,-4,-2,2,0,0,7,7,0,3,3,0,1,1,-2,2,0,0,-10,4,2,-5,3,-4,0,1,-1,0,1,-1,5,-1
KR_6717540557,420,-2,-29,11,-1,-1,2,1,1,1,2,1,1,2,-3,3,0,1,0,1,0,0,0,-2,-6,8,-2,0,0,1,-1,0,-1,6,-1
KR_6692544052,420,2,17,-12,8,4,1,5,3,0,3,-2,2,0,3,2,5,0,1,1,0,9,12,3,-7,4,-3,0,1,1,1,1,1,1,-1
KR_6740060592,420,-3,-52,-18,-6,-1,2,1,-3,4,1,-2,4,2,1,1,2,-1,2,1,0,-6,4,-1,-4,5,-1,0,0,-1,-1,-1,-1,6,-1
KR_6609009400,420,-3,11,-21,-9,1,2,3,-5,7,2,-1,3,2,-4,8,4,0,0,0,0,-6,-9,-2,-4,6,2,0,-1,-1,-1,-1,1,1,-1
KR_6690423082,420,-1,-82,0,7,0,0,0,4,2,6,4,1,5,0,3,3,-1,2,1,0,10,51,3,-10,7,-1,0,-1,1,-1,-1,1,3,-1
KR_6748458243,420,-2,1,18,-4,0,4,4,2,2,4,1,0,1,-5,7,2,-2,2,0,1,-6,-4,-6,-2,8,2,0,0,-1,1,0,1,5,-1
KR_6688554976,440,-1,27,-23,-1,2,2,4,0,2,2,0,1,1,2,2,4,-5,5,0,2,0,10,8,-11,3,-5,0,0,-1,1,-1,1,1,-1
KR_6391678940,420,-2,-23,-7,-4,-1,4,3,2,2,4,-4,5,1,2,2,4,-3,3,0,0,6,19,-2,-4,6,-4,0,-2,-1,-1,-1,-1,2,-1
KR_6613151578,420,-2,-10,-40,-5,-2,3,1,-3,4,1,-3,4,1,1,3,4,2,0,2,1,5,5,-3,-7,10,4,0,-1,1,-1,-1,1,3,-1
KR_6763991515,420,0,-61,-36,-1,5,0,5,2,3,5,-3,5,2,-2,4,2,-3,3,0,0,1,234,-1,-4,5,1,0,-1,0,1,-1,-1,0,-1
KR_6764182326,420,0,61,-17,-2,-2,3,1,6,5,11,-4,5,1,-1,3,2,-1,1,0,0,-9,49,0,-9,9,-2,0,0,1,-1,0,1,2,-1
KR_6720787499,440,-4,-121,-21,-10,2,2,4,-5,7,2,4,0,4,-5,5,0,-6,8,2,-2,-11,108,-2,-3,5,-2,0,-2,-1,-1,-1,-1,4,-1
KR_6763193991,420,-4,-51,-12,-14,-1,3,2,-9,10,1,0,3,3,-2,6,4,-2,5,3,-2,-23,-5,3,-5,2,-7,0,-1,1,-1,-1,-1,4,-1
KR_6747236168,420,0,-32,-17,0,-1,3,2,2,0,2,-7,7,0,8,1,9,-2,4,2,1,6,-6,2,-6,4,0,0,-2,-1,1,-1,1,4,-1
KR_6749290229,420,0,-7,36,1,4,0,4,3,1,4,0,0,0,-4,4,0,-2,2,0,0,1,38,-7,-4,11,2,0,0,1,1,-1,1,2,-1
KR_6764517931,420,-4,55,-39,-11,-1,2,1,-3,5,2,-1,1,0,-3,5,2,-3,3,0,0,-13,-29,-2,-6,8,0,0,0,-1,-1,-1,-1,6,-1
KR_6764471394,420,0,35,14,3,0,1,1,0,4,4,2,3,5,1,1,2,0,0,0,0,4,-6,-3,-3,6,7,0,0,-1,1,0,-1,2,-1
KR_6609090897,420,-1,-46,7,-4,-3,4,1,0,3,3,1,3,4,-1,5,4,-1,1,0,0,-4,15,-5,-7,12,-2,0,0,1,1,0,-1,2,-1
KR_6741593902,420,2,29,-27,4,-3,3,0,2,3,5,4,2,6,1,5,6,0,1,1,0,8,-1,-3,-2,5,5,0,0,-1,-1,0,-1,3,-1
KR_6740500434,440,-2,22,8,-9,-2,2,0,1,1,2,-1,3,2,0,0,0,-7,8,1,0,-10,-6,-1,-1,2,2,0,-1,1,1,-1,-1,2,-1
KR_6345625733,420,2,-71,15,4,0,1,1,1,1,2,2,2,4,0,2,2,1,0,1,0,5,-127,0,-4,4,1,0,0,-1,1,-1,1,2,-1
KR_6755185924,420,-1,-7,-9,-3,0,3,3,-2,5,3,2,3,5,-2,3,1,-1,1,0,1,-8,1,-1,-3,4,-2,0,1,0,-1,1,1,0,-1
KR_6743183161,420,-3,13,9,-5,2,0,2,-3,4,1,-1,3,2,-3,4,1,0,1,1,0,-7,-18,-1,-5,6,5,0,0,1,1,0,-1,3,-1
KR_6591703677,420,2,-2,12,-1,0,2,2,3,2,5,-5,7,2,2,1,3,-1,1,0,0,-4,8,2,-12,10,2,0,1,-1,1,1,-1,4,-1
KR_6640193983,420,-2,-54,-32,-9,1,3,4,-1,4,3,-2,4,2,-6,7,1,-1,1,0,0,-5,21,2,-7,5,-3,0,0,-1,1,0,-1,3,-1
KR_6753536991,420,-7,-87,-32,-16,-2,2,0,-2,3,1,-13,14,1,-3,5,2,4,0,4,-1,-9,21,1,-6,5,-4,0,0,-1,-1,-1,-1,5,-1
KR_6717876439,420,1,9,45,8,2,4,6,10,1,11,0,0,0,-5,5,0,1,4,5,1,2,0,-1,-4,5,-1,0,1,1,-1,1,1,5,-1
KR_6766152793,420,-5,-55,20,-16,-6,7,1,-2,6,4,-3,3,0,-4,4,0,-1,3,2,0,-9,4,-3,-1,4,-3,0,-1,-1,1,-1,-1,2,-1
KR_6635045520,440,-1,-39,-17,0,-5,5,0,7,0,7,-2,3,1,5,0,5,-5,6,1,0,2,-107,0,-5,5,2,0,0,-1,-1,-1,-1,2,-1
KR_6715353515,440,1,38,-23,1,1,0,1,-3,7,4,2,0,2,2,5,7,-1,1,0,0,1,-5,2,-4,2,0,0,0,-1,-1,0,1,2,-1
KR_6669049068,420,-4,-46,-3,-8,1,2,3,-6,7,1,4,2,6,-6,8,2,-1,3,2,-1,-20,6,4,-9,5,1,0,0,-1,-1,-1,-1,4,-1
KR_6602911204,420,0,-18,-4,-6,0,2,2,-1,2,1,2,3,5,-5,6,1,-2,2,0,0,-2,-1,4,-9,5,-2,0,-2,-1,-1,-1,1,5,-1
KR_6744686689,420,-1,56,-2,-8,-3,4,1,-2,5,3,-1,2,1,-4,5,1,2,0,2,0,-11,-15,-2,-7,9,7,0,-1,-1,-1,-1,1,6,-1
KR_6759598514,420,0,17,10,-1,1,1,2,3,2,5,0,2,2,-4,5,1,-1,2,1,1,-1,2,1,-4,3,-2,0,1,-1,1,-1,1,6,-1
KR_6753623057,420,4,47,-1,5,2,1,3,1,2,3,0,1,1,2,2,4,0,1,1,0,2,29,2,-6,4,-5,0,0,-1,0,0,1,6,-1
KR_6716110677,420,1,22,8,-5,2,0,2,0,2,2,-6,6,0,0,3,3,-1,1,0,0,-9,-4,-2,-3,5,6,0,-1,-1,-1,-1,-1,2,-1
KR_6751723609,420,-4,-48,-21,-5,0,2,2,-4,6,2,0,3,3,-2,2,0,1,1,2,0,-10,121,2,-7,5,-1,0,1,-1,1,1,-1,5,-1
KR_6509515658,420,-2,-69,11,-4,2,1,3,-3,4,1,-2,4,2,-2,2,0,1,1,2,0,-9,21,-1,-6,7,-6,0,-1,-1,1,-1,-1,6,-1
KR_6668439526,420,-3,-50,-38,-7,0,0,0,0,1,1,-2,2,0,-2,5,3,-3,3,0,0,-7,-6,-4,-3,7,0,0,0,-1,-1,0,-1,5,-1
KR_6730948295,420,-2,12,-48,-4,-3,4,1,0,0,0,-2,4,2,-3,6,3,4,0,4,0,-1,-2,4,-6,2,2,0,-1,1,-1,-1,-1,1,-1
KR_6667306329,440,-3,-88,1,-6,-1,1,0,0,1,1,-1,1,0,-2,5,3,-2,2,0,0,-9,-7,1,-5,4,-4,0,-3,-1,-1,-1,-1,3,-1
KR_6699149007,420,-7,-160,-14,-19,-5,7,2,-2,3,1,-3,3,0,-9,9,0,0,1,1,-1,-18,2,-2,-2,4,-2,0,-2,-1,1,-1,-1,2,-1
KR_6752192013,420,-4,29,-37,-8,-5,7,2,5,0,5,-4,4,0,-3,3,0,-1,1,0,1,-9,-37,-1,-5,6,-1,0,-1,-1,-1,-1,1,3,-1
KR_6762391961,420,-1,-58,7,3,-2,2,0,-1,3,2,3,1,4,1,2,3,2,1,3,0,10,-4,-4,-3,7,4,0,0,1,-1,0,-1,3,-1
KR_6738334185,420,-3,-10,20,-10,-2,3,1,-4,5,1,-5,5,0,1,1,2,0,0,0,0,-10,-15,-1,-5,6,3,0,0,-1,-1,-1,-1,3,-1
KR_6741187964,420,-1,-10,-4,2,1,0,1,1,3,4,1,2,3,-3,6,3,2,0,2,0,4,-7,-2,-5,7,0,0,0,-1,-1,-1,1,6,-1
KR_6760334450,420,1,-17,25,-2,4,0,4,5,2,7,-6,7,1,-6,8,2,1,1,2,2,1,-1,1,-4,3,-2,0,1,-1,1,1,1,1,-1
KR_6657848201,420,-6,-69,-22,-8,-2,4,2,-2,5,3,-1,3,2,-2,3,1,-1,2,1,0,-6,-5,-2,-3,5,5,0,-2,-1,-1,-1,-1,4,-1
KR_6610604688,420,-5,-60,4,-7,-2,2,0,-3,5,2,2,1,3,-3,4,1,-1,1,0,0,-6,-7,-4,-3,7,1,0,-1,-1,1,-1,-1,1,-1
KR_6757180037,420,2,17,-8,5,1,0,1,-1,2,1,1,2,3,-1,2,1,5,0,5,0,4,5,3,-8,5,-2,0,1,0,1,1,1,0,-1
KR_6721189047,420,0,51,20,-3,2,2,4,-3,6,3,0,4,4,-2,3,1,0,2,2,1,-5,18,5,-6,1,-3,0,0,-1,1,0,1,2,-1
KR_6757839640,420,-1,0,11,-5,-1,2,1,-6,6,0,3,2,5,0,2,2,-1,1,0,0,-1,3,6,-11,5,-4,0,0,0,-1,0,-1,0,-1
KR_6670561238,440,-4,-51,-25,-11,0,1,1,-4,5,1,-6,8,2,-1,2,1,0,3,3,0,-11,40,-2,-1,3,-20,0,-2,-1,-1,-1,-1,5,-1
KR_6766146447,420,-2,-11,-30,2,2,0,2,-2,5,3,0,2,2,0,4,4,2,1,3,1,-3,-83,5,-10,5,-1,0,0,-1,1,1,1,5,-1
KR_6762006008,420,0,4,7,-7,2,2,4,-1,4,3,-5,5,0,-2,2,0,-1,1,0,0,-6,-23,-4,-5,9,-2,0,-1,-1,-1,-1,-1,3,-1
KR_6744606175,420,-10,-122,-41,-14,1,2,3,-1,4,3,-9,11,2,-2,2,0,-3,3,0,-1,-5,-34,0,-4,4,-1,0,-4,-1,-1,-1,-1,6,-1
KR_6762078339,420,-1,45,24,-7,-1,2,1,-3,6,3,1,1,2,-2,3,1,-2,3,1,0,-7,3,4,-6,2,2,0,-1,-1,-1,-1,1,2,-1
KR_6742775033,420,-7,-14,-28,-15,-2,2,0,-4,4,0,-8,11,3,0,1,1,-1,3,2,-1,-19,-113,1,-5,4,-2,0,-2,-1,-1,-1,-1,1,-1
KR_6742132267,420,-2,-25,-8,-6,-2,5,3,-3,3,0,-2,3,1,-1,3,2,2,0,2,0,0,1,2,-6,4,2,0,-1,1,-1,-1,-1,6,-1
KR_6725755200,420,1,-1,12,-1,-1,2,1,3,1,4,2,0,2,-3,4,1,-2,2,0,0,-3,-121,-1,-5,6,-2,0,-1,1,-1,-1,-1,4,-1
KR_6737137971,420,-5,-45,6,-10,-3,3,0,-2,3,1,4,0,4,-7,9,2,-2,2,0,0,-14,-108,-6,-5,11,-4,0,-2,-1,1,-1,-1,3,-1
KR_6730792395,420,-5,-96,-26,-8,0,4,4,-5,7,2,-4,4,0,1,3,4,0,0,0,0,-15,-6,-2,-4,6,-1,0,-2,1,-1,-1,1,3,-1
KR_6759705390,440,-1,17,-8,0,6,0,6,-1,4,3,-5,7,2,-1,4,3,1,0,1,1,6,100,-5,-2,7,-3,0,-1,1,-1,-1,1,3,-1
KR_6743771646,420,2,-17,24,-1,-3,4,1,3,3,6,-1,3,2,0,4,4,0,0,0,1,3,2,-3,-2,5,3,0,0,0,1,1,1,0,-1
KR_6760399160,420,-1,-17,8,3,2,1,3,3,1,4,-2,3,1,1,3,4,-1,3,2,0,-1,3,4,-8,4,-3,0,0,-1,-1,0,1,3,-1
KR_6761822230,420,1,78,-15,1,-1,2,1,-2,3,1,4,0,4,-1,2,1,1,1,2,0,-2,-7,0,-9,9,6,0,0,1,1,0,1,2,-1
KR_6737092465,420,0,-64,8,3,1,1,2,0,1,1,1,1,2,-1,1,0,2,0,2,0,5,192,1,-6,5,0,0,1,-1,1,1,-1,5,-1
KR_6700668333,420,0,10,-5,-3,-2,4,2,-1,5,4,-2,2,0,4,1,5,-2,3,1,0,4,-7,-1,-6,7,0,0,0,1,-1,1,1,2,-1
KR_6631469693,420,-1,34,11,-2,-2,2,0,-9,11,2,1,3,4,5,1,6,3,1,4,0,-6,217,-1,-6,7,5,0,0,1,-1,1,1,1,-1
KR_6744516359,420,2,-8,9,6,1,2,3,4,2,6,0,1,1,1,0,1,0,0,0,1,1,1,0,-5,5,3,0,2,-1,1,1,1,2,-1
KR_6739729378,420,-3,-55,4,-12,-2,4,2,-4,4,0,-1,2,1,-3,4,1,-2,3,1,0,-9,38,-1,-4,5,2,0,-1,-1,-1,-1,-1,1,-1
KR_6733648737,420,-2,-8,-16,3,-1,2,1,3,1,4,-2,3,1,1,5,6,2,0,2,0,5,15,5,-8,3,-1,0,-1,-1,-1,-1,-1,5,-1
KR_6675657584,420,-2,-12,-12,-2,0,0,0,1,4,5,1,4,5,-7,7,0,3,0,3,0,-4,8,-2,-5,7,-4,0,-1,1,0,-1,-1,2,-1
KR_6731321178,420,1,-4,19,-7,-2,4,2,-1,2,1,0,2,2,-5,6,1,1,0,1,-1,-10,4,0,-9,9,-2,0,-1,-1,-1,-1,-1,2,-1
KR_6699660364,420,2,38,26,4,0,2,2,1,0,1,2,0,2,0,1,1,1,0,1,0,4,-3,0,-3,3,0,0,0,-1,1,0,1,3,-1
KR_6530392876,420,-4,-23,-39,-20,-4,4,0,0,4,4,-10,10,0,-3,5,2,-3,4,1,-1,-24,-28,3,-9,6,-3,0,0,-1,0,-1,-1,5,-1
KR_6753024377,420,0,28,-3,-2,1,2,3,-1,2,1,-1,4,3,-1,3,2,0,0,0,0,2,-121,-2,-6,8,-4,0,-1,1,-1,-1,1,2,-1
KR_6739024309,420,0,-58,-13,-2,-2,2,0,-4,7,3,4,1,5,2,0,2,-2,2,0,0,-2,-3,0,-2,2,-1,0,-1,1,-1,-1,-1,2,-1
KR_6708234868,420,-1,28,-7,-2,3,0,3,-5,6,1,0,3,3,3,1,4,-3,3,0,0,-7,-6,-7,-2,9,1,0,0,1,1,0,-1,4,-1
KR_6754555325,420,-1,-32,-8,-2,-1,1,0,0,1,1,0,0,0,1,1,2,-2,2,0,0,1,-4,-1,-7,8,0,0,0,-1,0,0,-1,3,-1
KR_6681942235,420,1,-12,-8,-1,2,1,3,-1,3,2,0,5,5,-2,4,2,0,1,1,0,-3,3,-1,-5,6,-5,0,-1,-1,1,-1,-1,5,-1
KR_6543184860,420,-1,-34,12,-13,-5,6,1,0,2,2,1,3,4,-8,8,0,-1,1,0,-2,-27,51,-4,-5,9,-6,0,-1,-1,-1,-1,-1,5,-1
KR_6704736374,420,-2,23,-12,-9,-3,3,0,-3,4,1,-3,4,1,1,4,5,-1,1,0,0,-5,-5,0,-4,4,2,0,-1,-1,-1,-1,-1,6,-1
KR_6609045207,420,-4,-42,-40,-11,-2,3,1,-3,4,1,-6,6,0,1,4,5,-1,2,1,0,-11,-2,5,-8,3,1,0,-1,-1,-1,-1,-1,3,-1
KR_6761691113,440,-2,-34,-13,-2,-2,3,1,-1,4,3,0,1,1,1,4,5,0,0,0,0,7,-2,5,-7,2,-1,0,-2,1,-1,-1,-1,4,-1
KR_6743403313,420,0,-12,-8,-7,0,1,1,-3,4,1,-1,3,2,1,3,4,-4,4,0,-1,-8,-122,-4,-2,6,3,0,0,-1,1,0,-1,2,-1
KR_6654386509,420,-2,-19,22,-9,-1,2,1,1,2,3,-3,3,0,-5,5,0,-1,1,0,0,-12,-4,3,-6,3,1,0,-1,-1,1,-1,-1,3,-1
KR_6687850447,420,-6,-128,-49,-10,-1,3,2,-8,8,0,2,3,5,-4,5,1,1,1,2,0,-9,-7,-3,-3,6,-2,0,-4,-1,-1,-1,1,1,-1
KR_6640057438,420,-1,42,-22,-2,1,1,2,-1,6,5,-1,5,4,3,0,3,-4,4,0,0,-6,2,0,-5,5,-1,0,0,-1,-1,0,1,4,-1
KR_6762657632,420,2,85,7,6,1,1,2,5,0,5,-4,5,1,5,2,7,-1,1,0,1,10,10,3,-8,5,1,0,1,0,-1,1,1,0,-1
KR_6704875534,420,-4,-23,-15,-17,-1,3,2,-6,6,0,-4,5,1,-7,9,2,1,0,1,0,-24,8,2,-7,5,-6,0,-1,0,-1,-1,-1,0,-1
KR_6759746724,420,-3,-91,5,-4,-1,1,0,3,1,4,0,5,5,-6,6,0,0,0,0,0,-10,14,0,-3,3,-3,0,0,-1,-1,-1,1,1,-1
KR_6731825351,440,2,46,12,-1,1,1,2,3,0,3,-2,2,0,-2,6,4,-1,2,1,0,-6,-1,8,-12,4,5,0,1,-1,1,1,-1,5,-1
KR_6750788009,420,-5,-37,-53,-16,0,2,2,-1,2,1,-3,5,2,-11,12,1,-1,1,0,0,-23,17,1,-4,3,-5,0,0,-1,-1,-1,-1,5,-1
KR_6704660465,420,3,46,20,-2,-2,2,0,-2,3,1,1,1,2,-1,2,1,2,0,2,0,-3,-6,2,-7,5,3,0,-1,1,-1,-1,-1,1,-1
KR_6735299195,420,-4,-68,-22,-5,0,0,0,-4,6,2,1,1,2,1,0,1,-3,3,0,0,-4,-2,-3,-3,6,1,0,0,-1,1,-1,1,5,-1
KR_6746733122,420,0,19,-3,-2,1,1,2,1,1,2,-3,3,0,-1,5,4,0,0,0,1,-2,-1,-1,-6,7,3,0,0,1,1,0,1,4,-1
KR_6505290968,420,0,-56,2,-2,-3,4,1,-2,3,1,1,3,4,2,2,4,0,0,0,0,2,5,2,-6,4,1,0,0,-1,1,1,-1,4,-1
KR_6739116882,420,-3,-96,-27,-7,0,2,2,-3,3,0,-4,4,0,1,0,1,-1,1,0,0,-9,98,3,-4,1,-5,0,-1,-1,-1,-1,-1,3,-1
KR_6756249276,420,-2,-16,13,1,-2,2,0,4,2,6,2,2,4,-1,3,2,-2,2,0,0,6,22,1,-6,5,1,0,1,0,1,1,-1,0,-1
KR_6763537243,420,0,31,-3,-1,-3,3,0,3,1,4,-1,3,2,0,3,3,0,0,0,1,1,1,3,-8,5,-2,0,0,1,-1,0,1,1,-1
KR_6738132980,420,-1,-69,-12,-1,-3,4,1,-1,4,3,0,0,0,3,4,7,0,2,2,0,10,-3,-2,-5,7,1,0,-1,1,-1,-1,1,4,-1
KR_6637642688,420,-2,5,-16,-5,3,1,4,-1,2,1,-1,1,0,-5,6,1,-1,1,0,-1,-11,1,3,-7,4,1,0,-1,-1,1,-1,-1,5,-1
KR_6760015174,420,-1,0,6,-5,1,3,4,2,1,3,-4,4,0,-4,4,0,0,1,1,1,-15,28,2,-8,6,1,0,0,1,-1,-1,1,2,-1
KR_6391203254,420,1,-53,8,2,1,0,1,-2,6,4,2,1,3,2,3,5,-1,2,1,0,-1,2,2,-6,4,-2,0,0,-1,1,0,-1,3,-1
KR_6755033918,420,4,-14,-4,14,4,2,6,4,6,10,3,1,4,0,3,3,3,0,3,-1,13,8,2,-8,6,-5,0,1,1,-1,1,-1,1,-1
KR_6759192731,420,-2,-13,-43,-8,-1,1,0,-9,10,1,2,2,4,0,2,2,0,1,1,-2,-14,4,-1,-7,8,0,0,0,-1,1,1,-1,2,-1
KR_6654306659,420,-3,-15,-20,-4,-1,3,2,-3,7,4,-3,3,0,3,0,3,0,0,0,-1,-3,-64,-3,-4,7,-2,0,0,-1,-1,-1,-1,4,-1
KR_6718097097,420,4,11,20,6,0,1,1,0,4,4,-2,2,0,6,1,7,2,0,2,0,4,-13,-2,-5,7,5,0,2,1,1,1,-1,2,-1
KR_6666693342,420,0,-58,-8,-5,3,1,4,-1,2,1,-2,4,2,-4,8,4,-1,3,2,-1,-12,8,0,-3,3,-1,0,-1,-1,1,-1,-1,2,-1
KR_6721529175,420,-1,-43,16,-1,-1,2,1,-1,4,3,1,3,4,1,1,2,-1,3,2,0,-2,-7,-3,-5,8,3,0,0,-1,-1,0,-1,1,-1
KR_6761958362,420,-1,22,1,0,-2,2,0,-3,3,0,1,2,3,2,0,2,2,2,4,0,-1,0,1,-5,4,-4,0,1,-1,1,1,1,3,-1
KR_6764015790,420,1,6,-7,1,0,1,1,-1,1,0,-2,2,0,3,0,3,1,0,1,0,6,23,2,-5,3,-3,0,1,1,1,1,1,5,-1
KR_6646220186,420,-5,-60,-31,-18,-6,6,0,-2,2,0,-4,5,1,-5,5,0,-1,2,1,-1,-31,-4,1,-5,4,-1,0,0,-1,-1,-1,-1,2,-1
KR_6746645325,420,-1,-48,10,1,2,2,4,-1,5,4,1,5,6,1,2,3,-2,2,0,1,2,-5,-1,-6,7,3,0,0,1,-1,0,1,2,-1
KR_6736927483,440,2,47,9,7,3,4,7,0,1,1,0,2,2,1,1,2,3,0,3,0,7,14,-3,-4,7,1,0,1,0,1,1,1,0,-1
KR_6743641084,420,-1,-15,-13,-3,-2,3,1,-1,5,4,-1,2,1,0,4,4,1,1,2,0,-1,0,0,-6,6,-2,0,-1,1,-1,-1,-1,6,-1
KR_6757763008,420,0,9,10,-2,-1,1,0,0,1,1,1,2,3,0,2,2,-2,2,0,0,4,-1,4,-6,2,-1,0,0,-1,-1,0,-1,4,-1
KR_6762437819,420,-3,-12,-6,-10,-1,3,2,-6,8,2,0,4,4,-1,4,3,-2,4,2,0,-10,-24,-4,-1,5,-3,0,-1,-1,-1,-1,-1,2,-1
KR_6735070745,440,-1,2,16,-4,-2,2,0,1,0,1,-1,2,1,0,0,0,-2,2,0,0,-1,37,6,-8,2,-34,0,-1,1,-1,-1,-1,6,-1
KR_6723215162,420,1,58,-22,5,2,1,3,1,7,8,1,0,1,0,4,4,1,0,1,0,0,-25,0,-3,3,5,0,1,-1,1,1,1,3,-1
KR_6738008581,420,2,135,34,-7,4,0,4,-2,4,2,-1,2,1,-1,1,0,-7,7,0,0,-22,-58,-1,-6,7,1,0,1,-1,1,1,-1,6,-1
KR_6741293156,420,0,-3,0,3,4,0,4,1,4,5,-2,4,2,-2,3,1,2,0,2,0,-6,6,4,-9,5,2,0,0,-1,1,0,-1,3,-1
KR_6760954827,420,2,-20,14,2,0,2,2,2,1,3,3,0,3,-3,6,3,0,2,2,0,-2,0,-2,-3,5,-2,0,-1,1,1,-1,1,4,-1
KR_6730926779,420,1,-10,-9,4,-1,2,1,-1,3,2,2,5,7,4,3,7,0,0,0,0,10,-2,-5,-5,10,2,0,0,-1,-1,-1,1,5,-1
KR_6694814478,420,-4,-66,-25,-13,1,3,4,-6,7,1,-3,5,2,-3,7,4,-2,2,0,-1,-21,-24,-6,-3,9,25,0,-3,1,-1,-1,1,3,-1
KR_6750996413,420,-1,20,16,-2,3,0,3,2,0,2,-3,5,2,-3,7,4,-1,1,0,-1,2,35,-3,-6,9,-23,0,1,-1,1,1,-1,4,-1
KR_6596515703,420,-6,-58,20,-6,-3,3,0,2,0,2,-2,2,0,-1,3,2,-2,2,0,0,-5,134,-1,-5,6,-3,0,-1,-1,1,-1,1,1,-1
KR_6730675643,420,-1,5,2,-2,2,2,4,1,0,1,1,3,4,-6,6,0,0,0,0,1,0,-12,0,-4,4,-2,0,0,1,1,0,1,4,-1
KR_6761400926,420,2,-14,3,4,0,0,0,4,1,5,3,0,3,-1,4,3,-2,2,0,1,2,117,1,-9,8,3,0,1,0,1,1,1,0,-1
KR_6760601906,420,0,-3,-16,-4,-3,4,1,2,2,4,-4,4,0,-1,2,1,2,0,2,0,-4,5,-6,-4,10,-4,0,-1,1,-1,-1,1,6,-1
KR_6728121948,420,-3,-73,17,-6,-3,3,0,-1,4,3,0,2,2,-2,2,0,0,1,1,0,-7,-4,5,-9,4,-6,0,0,1,1,-1,1,2,-1
KR_6714163647,440,-3,-3,-16,-8,-8,11,3,-1,5,4,1,2,3,0,2,2,0,2,2,0,-1,-7,2,-5,3,1,0,-1,-1,-1,-1,-1,5,-1
KR_6634804993,420,0,21,0,3,5,0,5,0,3,3,1,2,3,-2,5,3,-1,1,0,2,8,22,5,-9,4,1,0,2,-1,1,1,1,2,-1
KR_6765047361,420,-2,-50,0,-6,-3,4,1,-6,7,1,5,0,5,-1,3,2,-1,3,2,0,-11,-9,-2,-1,3,3,0,-1,1,-1,-1,-1,2,-1
KR_6731374665,420,0,22,-4,3,1,2,3,4,2,6,-1,3,2,0,4,4,-1,2,1,-1,1,-9,-2,-5,7,6,0,1,1,-1,-1,-1,6,-1
KR_6709616755,420,1,2,18,-7,0,2,2,0,2,2,0,2,2,-4,5,1,-3,3,0,0,-5,25,3,-11,8,-10,0,0,-1,1,-1,-1,4,-1
KR_6746537469,440,-2,-2,-27,2,3,0,3,-6,7,1,-3,3,0,5,2,7,3,1,4,0,10,3,1,-4,3,-1,0,-1,-1,-1,-1,-1,3,-1
KR_6678700625,420,-2,-41,-4,-8,-1,4,3,-2,6,4,1,1,2,-7,8,1,1,0,1,0,-12,3,-1,-3,4,-2,0,-2,1,-1,-1,-1,1,-1
KR_6706275250,420,-1,-40,-8,-2,0,2,2,1,4,5,-1,3,2,-1,5,4,-1,1,0,0,-3,-6,1,-4,3,-1,0,-2,-1,-1,-1,1,1,-1
KR_6757956703,420,-1,-44,-11,-1,0,3,3,3,3,6,1,4,5,-2,3,1,-3,4,1,-1,-2,3,-2,-2,4,2,0,-2,-1,0,-1,-1,2,-1
KR_6691093422,420,1,-12,8,6,1,0,1,6,2,8,2,1,3,-2,4,2,-1,1,0,0,0,-6,2,-6,4,-5,0,1,1,-1,-1,1,3,-1
KR_6713249598,420,-4,-11,-12,-1,-1,3,2,0,2,2,-3,3,0,2,1,3,1,0,1,1,7,2,1,-3,2,-3,0,0,1,-1,0,1,3,-1
KR_6728322704,420,-1,-15,13,-3,3,1,4,-4,4,0,6,3,9,-8,11,3,0,1,1,2,-9,3,-2,-3,5,1,0,0,0,-1,-1,-1,0,-1
KR_6704694783,420,-5,-41,-21,-7,-3,4,1,2,2,4,-1,1,0,-2,4,2,-3,3,0,0,-1,-18,1,-4,3,3,0,0,-1,0,0,1,1,-1
KR_6596587218,420,-4,-53,-15,-9,-7,8,1,-1,2,1,0,4,4,-1,3,2,0,0,0,0,-15,2,2,-6,4,1,0,0,-1,1,1,1,4,-1
KR_6761970702,420,-5,-18,-18,-7,2,0,2,-3,3,0,-3,4,1,-3,5,2,0,1,1,2,-14,45,1,-3,2,-23,0,0,-1,1,0,1,5,-1
KR_6725555813,420,-5,-103,1,-9,-4,4,0,-2,5,3,-2,2,0,0,4,4,-1,1,0,-2,-6,-432,-4,-4,8,0,0,-1,1,-1,-1,-1,4,-1
KR_6668619574,420,2,54,-9,4,3,0,3,4,2,6,0,2,2,-2,3,1,-1,2,1,0,6,14,1,-6,5,-8,0,1,-1,1,-1,-1,6,-1
KR_6704527183,420,-5,-90,-41,-11,-7,7,0,1,4,5,2,4,6,-8,8,0,1,0,1,0,-14,258,-2,-4,6,1,0,-3,-1,1,-1,-1,5,-1
KR_6361138190,420,-2,-17,20,1,0,2,2,4,2,6,-2,2,0,2,0,2,-3,3,0,0,4,0,0,0,0,-1,0,-2,-1,1,-1,-1,2,-1
KR_6695687191,420,-4,-69,-27,-9,-7,7,0,0,3,3,3,0,3,-5,7,2,0,0,0,0,-6,5,1,-9,8,3,0,-2,-1,-1,-1,-1,4,-1
KR_6736755262,420,-3,8,-11,-7,-3,3,0,-4,7,3,-1,3,2,1,2,3,0,0,0,0,-10,-24,-2,-3,5,0,0,-1,1,-1,-1,-1,6,-1
KR_6692959223,420,-6,-109,-12,-13,-1,5,4,-1,4,3,-2,3,1,-9,9,0,0,1,1,-1,-6,12,1,-5,4,-3,0,-5,-1,-1,-1,-1,2,-1
KR_6623333239,420,-1,-87,-7,-11,-1,1,0,-1,2,1,-6,7,1,-6,10,4,3,0,3,-2,-10,-11,-4,-4,8,-2,0,0,-1,-1,-1,-1,5,-1
KR_6746562342,420,-2,-63,-1,1,-2,3,1,1,5,6,-4,6,2,2,0,2,4,2,6,0,2,56,2,-4,2,-4,0,0,1,-1,1,-1,4,-1
KR_6679438654,420,-2,-18,5,-14,1,0,1,-7,10,3,0,6,6,-6,8,2,-2,3,1,0,-15,300,-5,-5,10,-2,0,0,-1,1,1,-1,2,-1
KR_6766085042,420,-1,18,-8,-1,-2,2,0,1,2,3,2,0,2,-2,5,3,0,1,1,0,-3,11,5,-9,4,0,0,1,1,-1,1,-1,2,-1
KR_6269720385,420,2,43,-40,2,3,0,3,2,2,4,-2,4,2,0,4,4,-1,2,1,0,-4,125,4,-7,3,-1,0,0,-1,-1,-1,1,3,-1
KR_6763225318,420,-3,-14,-44,-3,2,0,2,-1,4,3,3,4,7,-2,3,1,-5,7,2,0,4,-1,3,-9,6,-4,0,-2,-1,-1,-1,-1,2,-1
KR_6740289281,420,1,81,15,0,-1,2,1,-1,3,2,3,0,3,4,2,6,-5,5,0,0,-2,-11,-5,-1,6,4,0,1,-1,-1,1,1,4,-1
KR_6730588769,420,0,51,23,1,-1,1,0,0,3,3,-3,5,2,4,2,6,1,0,1,0,1,10,6,-6,0,-2,0,-1,0,-1,-1,1,0,-1
KR_6692146013,420,-1,74,5,-9,-3,3,0,-5,6,1,0,3,3,-1,3,2,0,2,2,0,-12,-129,0,-6,6,-1,0,-1,1,1,-1,1,6,-1
KR_6765205058,420,-1,-29,2,0,0,1,1,-2,2,0,2,1,3,-2,4,2,2,0,2,1,-2,36,2,-6,4,-2,0,-1,-1,-1,-1,1,3,-1
KR_6728219856,440,-8,-102,-12,-12,-5,5,0,-4,5,1,-6,6,0,2,5,7,1,1,2,0,-9,-21,-1,-2,3,-3,0,-3,-1,-1,-1,1,1,-1
KR_6764725996,420,-1,15,12,-8,-2,2,0,-1,4,3,-1,3,2,-3,6,3,-1,1,0,0,-4,15,0,-4,4,3,0,0,1,-1,-1,-1,5,-1
KR_6690390773,420,-2,-32,2,-7,3,4,7,1,1,2,-3,6,3,-8,8,0,0,0,0,0,-20,5,0,-5,5,-1,0,0,-1,1,-1,-1,5,-1
KR_6745910977,420,5,70,8,5,3,0,3,-3,5,2,0,1,1,0,4,4,5,0,5,1,-3,-2,-5,-3,8,0,0,2,1,1,1,1,3,-1
KR_6755467473,420,-6,-94,-16,-13,0,2,2,5,1,6,-1,2,1,-8,9,1,-9,10,1,-1,-21,-13,2,-6,4,-5,0,-3,-1,-1,-1,-1,6,-1
KR_6733899206,420,2,-34,16,0,2,2,4,-3,4,1,-2,5,3,0,2,2,3,0,3,0,0,38,-2,-7,9,-16,0,0,1,-1,0,1,6,-1
KR_6747867200,420,3,28,4,4,1,0,1,-2,3,1,3,3,6,1,6,7,1,1,2,-1,1,-7,-2,-4,6,4,0,0,0,1,0,-1,0,-1
KR_6716030682,420,-1,-26,20,-4,-2,3,1,2,1,3,-4,6,2,-1,6,5,1,0,1,0,-4,-14,-5,-6,11,3,0,0,0,-1,-1,1,0,-1
KR_6757781039,420,-4,-8,-36,-6,-1,2,1,-5,8,3,0,3,3,-2,3,1,2,0,2,0,-4,-37,0,-4,4,3,0,0,-1,-1,-1,1,3,-1
KR_6760698924,420,-3,-61,-15,-6,1,1,2,4,1,5,-2,4,2,-7,7,0,-2,3,1,0,-1,2,3,-9,6,-8,0,-1,-1,-1,-1,-1,6,-1
KR_6753081427,420,-1,-8,-47,3,-3,5,2,5,1,6,-3,5,2,3,0,3,1,0,1,0,10,6,-1,-3,4,-4,0,1,1,1,1,-1,3,-1
KR_6758389181,420,-2,-31,-31,-7,-3,6,3,-2,5,3,-2,2,0,0,3,3,0,0,0,0,-1,2,-3,-1,4,-2,0,0,1,-1,0,1,1,-1
KR_6744163583,420,-8,-57,-33,-18,-2,3,1,-4,4,0,-8,9,1,-1,7,6,-3,4,1,-1,-14,-9,-3,-3,6,3,0,-2,-1,-1,-1,-1,5,-1
KR_6737862077,420,-5,-31,-1,-13,2,2,4,-6,6,0,-1,4,3,-4,6,2,-4,4,0,-2,-17,-7,-1,-3,4,-4,0,-5,-1,-1,-1,-1,5,-1
KR_6766227070,420,2,26,7,2,7,1,8,-1,4,3,-2,3,1,-1,5,4,-1,1,0,0,0,27,0,-6,6,4,0,2,-1,1,1,-1,6,-1
KR_6685246327,420,3,26,4,4,3,1,4,1,3,4,-4,9,5,2,0,2,2,2,4,0,6,8,4,-9,5,3,0,1,1,-1,1,1,2,-1
KR_6681406870,420,0,-29,19,-1,-2,3,1,0,3,3,0,1,1,1,3,4,0,0,0,0,6,4,-2,-6,8,-2,0,-1,1,-1,-1,-1,3,-1
KR_6753767419,420,-1,-49,4,6,0,2,2,4,3,7,0,2,2,-2,4,2,4,1,5,0,9,76,2,-7,5,-1,0,0,-1,1,-1,1,3,-1
KR_6640290620,420,1,-98,28,-2,-1,5,4,0,2,2,1,2,3,-1,4,3,-1,2,1,0,0,-4,-1,-4,5,1,0,-2,1,-1,-1,-1,5,-1
KR_6686490824,420,-2,-16,-3,-7,-2,2,0,0,0,0,-5,7,2,0,1,1,0,0,0,0,-12,21,-1,-6,7,2,0,0,-1,1,0,-1,3,-1
KR_6756885860,420,-3,-74,4,-5,-4,4,0,-1,3,2,-3,3,0,5,1,6,-2,2,0,0,-3,-3,1,-6,5,2,0,1,-1,1,1,1,2,-1
KR_6745216423,440,-4,-5,-25,-9,-5,6,1,4,6,10,-4,4,0,-1,1,0,-3,6,3,0,-11,-17,-3,-3,6,2,0,-1,-1,-1,-1,1,3,-1
KR_6763135033,420,1,-7,12,8,6,0,6,-4,5,1,0,3,3,5,3,8,1,0,1,0,4,-8,-4,-1,5,3,0,0,-1,0,1,1,1,-1
KR_6632857275,420,-3,-49,24,-5,0,0,0,1,2,3,-4,5,1,-2,3,1,0,0,0,0,-4,10,1,-6,5,-3,0,-1,1,1,-1,-1,4,-1
KR_6749139651,440,-4,-96,-63,-9,0,4,4,-2,3,1,-6,6,0,-2,3,1,1,1,2,0,-6,6,4,-8,4,2,0,-2,-1,-1,-1,-1,4,-1
KR_6645693391,440,2,9,-6,3,1,2,3,-3,4,1,1,0,1,4,0,4,0,5,5,0,0,-13,-1,-1,2,2,0,0,-1,-1,0,1,6,-1
KR_6740368741,440,-4,2,9,-10,1,0,1,-2,4,2,-1,4,3,0,0,0,-8,9,1,0,-12,0,0,-5,5,-2,0,0,-1,-1,-1,-1,2,-1
KR_6758535633,420,-2,-105,-14,-1,0,3,3,-2,3,1,0,2,2,0,2,2,1,0,1,0,2,-7,-5,-2,7,-4,0,-3,-1,-1,-1,-1,5,-1
KR_6506959079,420,1,-11,7,0,-3,4,1,2,2,4,0,3,3,-1,4,3,2,2,4,0,-1,4,-3,0,3,3,0,0,1,1,1,1,4,-1
KR_6526650150,420,4,81,21,4,-1,3,2,-2,2,0,0,1,1,7,1,8,0,1,1,0,7,24,4,-8,4,0,0,3,-1,1,1,-1,3,-1
KR_6746414342,420,-7,-92,5,-14,-4,4,0,-3,3,0,-1,5,4,-5,6,1,-1,1,0,0,-13,3,-2,-5,7,-7,0,-2,-1,1,-1,-1,2,-1
KR_6761245318,420,2,34,8,3,-4,4,0,4,0,4,1,3,4,2,1,3,0,1,1,0,3,4,4,-9,5,3,0,1,1,1,1,1,3,-1
KR_6701205021,420,0,46,8,-7,2,1,3,-4,5,1,-4,8,4,-1,3,2,0,0,0,0,-11,-160,-2,-2,4,1,0,0,-1,0,1,-1,2,-1
KR_6763881062,420,-3,-18,12,-10,-1,2,1,0,3,3,-2,2,0,-5,5,0,-2,2,0,-1,-15,-23,-7,-3,10,2,0,-1,-1,1,-1,-1,3,-1
KR_6728626820,440,1,3,22,1,0,1,1,-2,3,1,-1,3,2,1,1,2,3,2,5,0,0,-3,-3,-3,6,1,0,0,1,1,1,-1,6,-1
KR_6766131940,420,-3,29,7,2,3,0,3,1,1,2,-4,5,1,1,2,3,1,0,1,0,-1,3,1,-5,4,4,0,1,-1,1,1,1,1,-1
KR_6738164355,420,-3,2,-16,0,1,3,4,-4,7,3,0,1,1,4,2,6,-1,1,0,0,-4,-10,-5,-6,11,2,0,-1,1,-1,-1,1,4,-1
KR_6765684819,420,-1,47,-12,-1,0,2,2,-1,3,2,1,1,2,-2,4,2,1,1,2,0,-3,305,-3,-2,5,-2,0,0,1,-1,0,1,4,-1
KR_6720080017,420,-3,-39,9,-12,-1,3,2,-2,2,0,-2,5,3,-5,5,0,-2,2,0,0,-10,-6,-8,0,8,0,0,-1,-1,1,-1,-1,6,-1
KR_6755942252,420,-2,-64,14,1,0,1,1,3,1,4,2,3,5,-4,8,4,0,0,0,2,7,46,3,-6,3,4,0,-1,0,-1,-1,1,0,-1
KR_6754288638,440,0,-27,4,-2,-3,4,1,3,1,4,0,1,1,0,1,1,-2,3,1,0,2,13,-2,-3,5,-6,0,0,1,-1,0,-1,5,-1
KR_6743777565,420,-6,-50,-15,-10,-3,3,0,-4,5,1,1,0,1,-4,5,1,0,0,0,0,-9,-11,-2,-4,6,-2,0,1,-1,1,-1,-1,4,-1
KR_6763998362,420,0,-5,4,-3,-2,3,1,-1,4,3,-1,2,1,4,0,4,-3,5,2,0,3,25,-1,-6,7,1,0,-1,1,-1,-1,-1,5,-1
KR_6705914241,420,2,-26,8,-3,1,3,4,0,2,2,-2,3,1,-1,1,0,-1,1,0,0,-11,-1,0,-4,4,0,0,0,1,-1,1,-1,5,-1
KR_6732976578,420,-1,46,6,-2,4,0,4,-3,6,3,-1,2,1,-1,2,1,-1,2,1,0,-5,-135,1,-4,3,-2,0,-1,-1,-1,-1,-1,1,-1
KR_6750620593,420,-1,9,31,-8,-2,4,2,-2,4,2,-4,5,1,0,2,2,0,0,0,0,-5,-4,2,-5,3,1,0,1,0,-1,1,-1,0,-1
KR_6757771990,420,-2,-27,-15,-10,-2,4,2,-2,2,0,2,4,6,-1,3,2,-7,9,2,0,-21,-1,1,-6,5,-7,0,0,-1,-1,-1,-1,6,-1
KR_6685746926,420,-4,-46,19,-5,1,0,1,-5,7,2,0,1,1,0,1,1,-1,2,1,0,0,221,-4,-2,6,5,0,-1,1,-1,-1,-1,6,-1
KR_6763048908,420,0,-24,-15,0,5,0,5,3,2,5,-2,2,0,-3,3,0,-3,3,0,1,-3,7,3,-6,3,-4,0,1,1,-1,1,1,5,-1
KR_6752006516,420,-5,-19,-24,-11,-1,3,2,1,3,4,-8,9,1,-2,4,2,-1,2,1,0,-7,-161,-5,-1,6,28,0,0,-1,-1,0,1,4,-1
KR_6346108114,420,-4,6,15,-8,-4,4,0,-1,1,0,-2,3,1,-3,6,3,2,1,3,0,-5,-15,4,-8,4,1,0,-2,0,-1,-1,1,0,-1
KR_6760840095,420,-4,-79,-19,-9,2,0,2,-3,5,2,-5,6,1,-4,11,7,1,2,3,0,-9,0,0,-4,4,-1,0,-3,1,-1,-1,1,3,-1
KR_6757428039,420,0,58,-36,3,1,0,1,1,1,2,0,1,1,1,6,7,0,2,2,0,9,1,0,-5,5,-6,0,-1,-1,-1,-1,1,2,-1
KR_6713643894,420,-1,38,24,-6,-1,5,4,-8,10,2,1,1,2,1,1,2,1,0,1,0,-13,17,-1,-4,5,-3,0,-1,-1,-1,-1,-1,4,-1
KR_6766035561,420,-4,-27,4,-8,0,1,1,-1,3,2,-3,4,1,1,0,1,-5,6,1,1,-11,-7,-1,-5,6,-4,0,-1,-1,1,-1,1,1,-1
KR_6736480985,440,-1,-33,21,0,2,2,4,0,1,1,-1,2,1,1,1,2,-2,2,0,0,-1,-37,-2,-4,6,-3,0,-1,0,1,-1,1,0,-1
KR_6763088620,420,-4,-138,40,-9,-3,3,0,-7,8,1,-3,3,0,4,0,4,0,1,1,0,-6,-378,-5,-2,7,-1,0,-3,0,-1,-1,-1,0,-1
KR_6765650556,420,-1,-29,-18,-4,-2,3,1,2,2,4,-4,4,0,0,3,3,0,0,0,-1,-11,-6,-5,-3,8,-1,0,-1,1,-1,-1,-1,5,-1
KR_6738560985,420,-2,-42,-14,-3,1,0,1,-7,10,3,0,3,3,0,4,4,3,0,3,-1,3,9,-1,-4,5,-1,0,1,-1,1,1,-1,4,-1
KR_6468125145,420,-4,-54,-35,-12,-5,5,0,-3,3,0,-1,2,1,-4,7,3,1,0,1,0,-20,-4,-5,-4,9,-3,0,0,-1,-1,-1,-1,3,-1
KR_6758086986,420,-2,-66,18,-4,-4,6,2,0,2,2,0,1,1,-1,3,2,1,0,1,0,-4,12,1,-7,6,-7,0,0,1,1,1,1,4,-1
KR_6706585876,440,2,70,5,-3,-5,5,0,-7,7,0,3,1,4,8,1,9,-2,4,2,0,0,-12,0,-2,2,-1,0,0,-1,1,1,-1,4,-1
KR_6604931279,420,-1,-10,-9,-4,-1,2,1,1,2,3,-3,3,0,0,4,4,-1,1,0,0,-4,-7,-2,-3,5,8,0,-1,-1,-1,-1,-1,2,-1
KR_6180554101,420,-1,-55,23,-6,4,1,5,0,3,3,-2,4,2,-5,6,1,-3,3,0,0,-18,229,1,-7,6,-4,0,-1,-1,1,-1,-1,4,-1
KR_6755789524,440,-3,-57,21,-1,0,1,1,1,3,4,-3,5,2,0,1,1,1,0,1,0,0,17,-5,-3,8,-2,0,-1,-1,0,-1,-1,3,-1
KR_6762210728,420,-1,-71,26,1,0,0,0,2,3,5,4,3,7,-1,2,1,-4,4,0,0,-2,-2,-1,-2,3,1,0,0,1,1,0,-1,4,-1
KR_6676611839,420,-4,-38,-15,-12,-1,3,2,-1,4,3,-3,5,2,-1,4,3,-6,6,0,0,-13,-11,4,-10,6,-3,0,-1,-1,-1,-1,-1,3,-1
KR_6764751570,420,-4,-73,4,-6,-5,6,1,1,0,1,4,1,5,-6,13,7,0,0,0,-1,-7,0,3,-7,4,-5,0,-2,1,-1,-1,1,4,-1
KR_6752151504,420,2,-27,-9,4,2,0,2,-2,7,5,-1,3,2,6,1,7,-1,2,1,0,4,10,-5,-5,10,-4,0,1,-1,-1,1,1,1,-1
KR_6739965369,420,-6,15,-6,-18,-2,4,2,-2,2,0,2,0,2,-17,18,1,1,0,1,-3,-27,-10,-3,-2,5,3,0,-1,-1,0,-1,-1,2,-1
KR_6706473146,420,0,26,15,2,1,1,2,0,3,3,4,0,4,-1,3,2,-2,3,1,0,5,-123,5,-8,3,-7,0,-1,1,1,-1,-1,1,-1
KR_6678054335,420,-2,0,2,-8,1,1,2,-3,4,1,0,1,1,-5,5,0,-1,1,0,-1,-10,-1,-2,-5,7,1,0,0,1,-1,0,-1,6,-1
KR_6709766921,420,-1,58,0,3,2,1,3,0,1,1,0,5,5,2,4,6,-1,2,1,0,-11,-8,1,-5,4,1,0,1,-1,1,1,1,2,-1
KR_6635028495,420,-2,-6,-24,2,-1,2,1,0,1,1,2,2,4,0,3,3,1,0,1,0,6,25,-2,-6,8,-7,0,1,-1,-1,1,1,2,-1
KR_6692560192,420,-3,-40,-21,-5,0,2,2,-3,4,1,1,4,5,-4,5,1,1,0,1,0,-1,2,-3,-3,6,-2,0,-2,-1,-1,-1,1,1,-1
KR_6761782851,420,1,-28,16,2,-4,5,1,2,2,4,1,3,4,2,0,2,1,1,2,0,4,-2,-1,-4,5,2,0,-1,0,1,-1,1,0,-1
KR_6759934057,420,0,-38,8,2,-1,1,0,4,1,5,2,1,3,-2,7,5,-1,2,1,0,-2,26,3,-6,3,16,0,-1,1,1,-1,-1,6,-1
KR_6699015364,420,3,46,-12,4,-1,4,3,7,0,7,-1,3,2,-2,3,1,1,0,1,1,4,6,2,-8,6,-3,0,0,0,1,0,1,0,-1
KR_6728933672,420,0,7,7,0,1,0,1,-4,5,1,-2,3,1,3,1,4,2,1,3,0,4,-1,0,-6,6,2,0,0,1,-1,-1,-1,2,-1
KR_6751766609,420,0,-31,-24,-2,-1,1,0,-2,4,2,0,2,2,1,4,5,0,0,0,0,4,20,5,-9,4,-7,0,-1,1,-1,-1,-1,5,-1
KR_6720104939,420,-2,-56,1,-4,2,2,4,-4,5,1,1,1,2,-2,2,0,-1,1,0,0,-2,-1,-6,-2,8,-2,0,-2,-1,-1,-1,-1,1,-1
KR_6695924882,420,-2,-12,9,-2,0,3,3,-4,6,2,0,1,1,-1,3,2,3,0,3,0,-5,0,2,-8,6,2,0,0,0,-1,-1,1,0,-1
KR_6754721278,420,-2,-13,-18,-3,2,2,4,2,0,2,-5,5,0,-1,4,3,-1,3,2,0,3,-9,0,-5,5,-4,0,0,1,-1,0,-1,5,-1
KR_6744492890,420,0,74,-8,3,3,1,4,0,2,2,1,3,4,1,3,4,-2,4,2,1,-1,-3,2,-6,4,4,0,-1,0,1,1,1,0,-1
KR_6749971144,440,-2,-5,-27,-6,3,1,4,1,2,3,-2,6,4,-1,1,0,-7,10,3,0,-14,-16,-4,0,4,-1,0,-1,1,-1,-1,-1,4,-1
KR_6713051226,420,-4,-88,3,-10,-2,5,3,-3,4,1,-2,2,0,-2,5,3,-1,3,2,-2,-4,0,-2,-4,6,-3,0,-2,1,-1,-1,-1,6,-1
KR_6746071470,420,-2,-3,-19,-6,1,2,3,-2,4,2,-4,6,2,-3,5,2,2,0,2,0,-7,-5,-1,-8,9,1,0,0,1,1,-1,1,2,-1
KR_6619872552,420,-4,-44,-18,-12,-1,1,0,-3,6,3,-6,7,1,-2,7,5,0,1,1,0,-16,24,1,-5,4,-20,0,0,-1,1,0,-1,6,-1
KR_6697686822,420,-9,-53,-28,-16,-5,5,0,-3,3,0,-1,1,0,-4,4,0,-3,4,1,0,-16,-11,-1,-3,4,0,0,-2,0,-1,-1,-1,0,-1
KR_6685875643,420,-2,-51,-29,-5,-1,1,0,0,3,3,-6,7,1,1,1,2,1,0,1,0,-3,-24,-5,-5,10,6,0,-1,-1,1,-1,-1,3,-1
KR_6697418677,420,-2,-50,2,1,5,0,5,-2,3,1,0,0,0,-2,3,1,0,0,0,0,-5,-12,-3,-3,6,0,0,-1,-1,-1,-1,1,3,-1
KR_6727050050,420,-6,-112,3,-15,-6,6,0,0,2,2,-4,4,0,-2,3,1,-3,4,1,0,-13,32,-2,-3,5,-19,0,-5,1,-1,-1,-1,3,-1
KR_6753496252,420,2,86,48,-3,0,3,3,0,5,5,0,1,1,-2,2,0,-1,1,0,0,-11,5,1,-3,2,4,0,2,1,1,1,-1,1,-1
KR_6640304084,420,-3,-63,-1,-2,-1,2,1,3,1,4,0,2,2,1,0,1,-5,5,0,0,3,4,4,-6,2,-4,0,-1,-1,-1,-1,-1,6,-1
KR_6721506301,420,0,-29,26,-1,0,0,0,-2,5,3,3,2,5,-2,3,1,0,0,0,-1,1,14,3,-10,7,0,0,0,-1,-1,0,-1,6,-1
KR_6765244386,420,4,36,9,5,4,0,4,-1,5,4,-2,2,0,1,1,2,3,0,3,0,4,15,1,-8,7,-2,0,0,1,-1,0,1,6,-1
KR_6743619364,420,1,15,16,-5,3,0,3,4,2,6,-7,7,0,-1,4,3,-4,4,0,-1,-8,-7,2,-6,4,-3,0,-1,-1,-1,-1,-1,5,-1
KR_6732804138,420,3,26,34,-3,1,2,3,-2,5,3,2,3,5,-1,1,0,-3,3,0,0,-6,22,0,-4,4,2,0,-1,-1,-1,-1,1,2,-1
KR_6763491383,420,-1,-31,-12,-3,0,4,4,-2,4,2,-1,4,3,-1,4,3,1,1,2,-1,-6,4,1,-5,4,0,0,0,0,1,0,-1,0,-1
KR_6738091892,420,-4,27,-12,-9,0,2,2,-2,2,0,-6,6,0,0,4,4,-1,2,1,0,-12,-10,-1,-5,6,4,0,-1,-1,0,-1,-1,3,-1
KR_6744651904,420,-5,-94,-4,-9,1,2,3,-3,4,1,0,2,2,-6,9,3,-1,1,0,0,-11,50,0,-5,5,0,0,0,-1,1,-1,-1,2,-1
KR_6703437376,440,-3,-19,28,-3,-1,5,4,3,2,5,-1,2,1,-2,4,2,-2,4,2,-1,-6,-5,-4,-2,6,0,0,0,-1,-1,0,-1,1,-1
KR_6713844865,420,1,57,-20,-2,1,1,2,-2,6,4,-2,3,1,1,2,3,0,2,2,0,-8,-5,-6,-1,7,0,0,0,1,-1,0,1,4,-1
KR_6675049226,420,-4,-27,24,-12,-2,2,0,-1,3,2,1,1,2,-10,11,1,0,2,2,0,-7,1,-6,-3,9,2,0,0,1,1,-1,-1,1,-1
KR_6735081280,420,-4,-47,-8,-10,0,1,1,-2,4,2,-4,5,1,-5,5,0,1,0,1,1,-4,-7,1,-7,6,-2,0,0,-1,-1,0,1,2,-1
KR_6760054226,420,4,31,20,5,1,2,3,1,2,3,2,1,3,2,5,7,-1,2,1,0,5,3,1,-7,6,-2,0,2,1,1,1,1,6,-1
KR_6756026874,420,-8,-76,-32,-18,-5,5,0,-2,2,0,-4,5,1,-3,4,1,-4,5,1,0,-20,10,1,-2,1,-1,0,-1,-1,-1,-1,-1,2,-1
KR_6757980989,420,0,-12,-23,2,5,1,6,2,2,4,0,1,1,-1,3,2,-4,4,0,-1,-3,-42,-3,-3,6,-1,0,-1,-1,1,-1,-1,1,-1
KR_6640270136,420,-2,10,-4,-4,-1,1,0,1,2,3,-5,6,1,1,0,1,0,0,0,0,0,0,-1,-4,5,1,0,0,1,-1,-1,-1,5,-1
KR_6692981423,420,-3,-4,-64,-4,-1,3,2,-3,3,0,-1,3,2,-2,4,2,3,4,7,0,-11,-11,-1,-4,5,3,0,0,-1,-1,-1,-1,5,-1
KR_6760200510,420,-1,-27,-16,1,1,1,2,-1,1,0,-1,2,1,1,3,4,1,1,2,0,4,56,-4,0,4,1,0,1,0,-1,-1,-1,0,-1
KR_6765051114,420,-4,-64,-29,-1,1,0,1,-1,5,4,-3,5,2,1,3,4,1,0,1,0,-1,-1,5,-10,5,-1,0,-2,-1,1,-1,1,6,-1
KR_6764611998,420,-3,-28,-25,-1,-7,7,0,1,1,2,1,2,3,2,5,7,2,0,2,-1,14,16,-1,-6,7,0,0,-3,-1,-1,-1,-1,6,-1
KR_6613065492,420,-2,-60,-6,-7,-2,3,1,-4,6,2,1,5,6,-3,5,2,1,0,1,0,2,17,-1,-3,4,0,0,-1,1,-1,-1,-1,1,-1
KR_6744928112,440,0,32,0,2,-4,4,0,4,1,5,3,1,4,0,1,1,-1,2,1,2,7,-15,5,-7,2,6,0,1,-1,-1,1,1,6,-1
KR_6670626458,440,-3,-41,-41,-7,0,2,2,-1,1,0,1,5,6,-6,6,0,-1,1,0,0,-6,24,2,-4,2,-7,0,0,1,0,1,1,5,-1
KR_6728207377,420,0,-27,-9,-3,-1,2,1,-4,6,2,2,0,2,1,1,2,-1,2,1,-2,-5,1,-1,-2,3,1,0,-1,-1,-1,-1,-1,6,-1
KR_6736085239,420,-5,-49,-27,-11,1,2,3,-1,3,2,-1,2,1,-10,12,2,0,0,0,-2,-19,-5,0,-7,7,-2,0,0,-1,1,-1,-1,4,-1
KR_6613183736,420,-4,-78,-13,-13,3,0,3,-6,6,0,-1,3,2,-7,11,4,-2,3,1,-1,-23,-7,-2,-5,7,-2,0,-2,-1,-1,-1,-1,2,-1
KR_6681502548,440,0,62,16,-2,-5,5,0,3,0,3,-3,3,0,2,2,4,1,0,1,0,-2,-1,-1,-2,3,-2,0,1,-1,1,1,-1,2,-1
KR_6765307978,420,-5,-73,-2,-15,-6,7,1,-1,2,1,-7,8,1,-1,2,1,0,1,1,0,-12,19,-5,-4,9,-1,0,-2,-1,-1,-1,-1,1,-1
KR_6755331550,420,0,-10,16,-2,-3,5,2,1,2,3,-1,1,0,2,0,2,-1,1,0,0,3,-10,0,-2,2,0,0,0,1,1,0,-1,1,-1
KR_6761875845,420,-2,-18,-16,-4,-5,6,1,-1,2,1,6,1,7,-2,2,0,-2,4,2,0,8,-6,-4,-4,8,-1,0,-2,-1,-1,-1,-1,4,-1
KR_6759497491,420,3,18,-18,6,-1,1,0,7,0,7,-1,3,2,3,1,4,-2,2,0,0,8,-43,2,-9,7,19,0,0,-1,0,0,1,3,-1
KR_6733443083,420,0,13,-19,-6,2,2,4,-5,7,2,0,2,2,-1,2,1,-2,4,2,0,-16,-59,3,-7,4,19,0,-1,1,1,-1,1,3,-1
KR_6657474304,420,-2,-57,12,0,-2,2,0,-2,2,0,5,1,6,-2,6,4,1,0,1,0,2,2,2,-5,3,1,0,0,-1,1,0,-1,6,-1
KR_6507803763,420,-4,-59,-27,-10,-6,6,0,-4,4,0,-1,2,1,1,0,1,0,0,0,0,-6,0,-2,-6,8,1,0,-1,1,-1,-1,-1,2,-1
KR_6731022469,420,0,-65,-16,-6,-4,6,2,1,3,4,-2,6,4,2,2,4,-3,3,0,0,-4,-8,-3,-3,6,1,0,1,-1,1,1,-1,2,-1
KR_6752400221,420,-5,-47,6,-19,-3,3,0,-5,7,2,-3,5,2,-6,7,1,-2,2,0,-1,-15,-109,2,-7,5,-1,0,0,-1,0,-1,-1,2,-1
KR_6564039225,420,-3,48,3,-4,-2,2,0,-1,5,4,0,1,1,0,2,2,-1,1,0,0,-5,-2,-1,-10,11,5,0,-2,1,-1,-1,1,6,-1
KR_6731475433,420,-2,-33,-6,-7,-2,5,3,1,3,4,1,4,5,-3,4,1,-4,5,1,1,-4,-2,5,-11,6,1,0,-2,-1,0,-1,1,1,-1
KR_6668125720,420,0,-16,-32,-4,1,1,2,6,0,6,-2,3,1,-5,5,0,-4,4,0,-1,-5,-5,-2,-2,4,-1,0,0,-1,1,-1,-1,5,-1
KR_6764408387,420,-4,-93,-24,-9,-1,1,0,-7,9,2,-2,3,1,2,1,3,-1,1,0,0,-4,-8,1,-9,8,-4,0,-1,-1,1,-1,-1,4,-1
KR_6642524339,420,0,-57,-16,6,0,1,1,-1,4,3,0,1,1,3,2,5,4,0,4,0,11,-13,-2,-3,5,-1,0,-1,-1,-1,-1,1,3,-1
KR_6715954650,420,-8,-39,-34,-24,-6,6,0,2,2,4,-5,6,1,-15,16,1,0,1,1,0,-22,2,-2,-4,6,-1,0,-2,-1,-1,-1,-1,2,-1
KR_6686193479,420,-2,-59,8,-5,-1,1,0,-3,6,3,-3,4,1,2,0,2,0,1,1,1,-1,9,2,-6,4,-2,0,0,-1,1,0,1,6,-1
KR_6753533042,420,-5,-92,-16,-10,-3,3,0,0,2,2,-5,7,2,-3,3,0,1,0,1,-1,-3,-5,-3,-2,5,0,0,-2,-1,-1,-1,-1,4,-1
KR_6735885339,420,-4,-42,8,-8,-3,3,0,-7,7,0,0,2,2,0,2,2,2,0,2,0,-15,-12,4,-10,6,-5,0,-1,-1,-1,-1,-1,5,-1
KR_6756452279,420,0,-39,-12,-4,-1,1,0,2,1,3,4,1,5,-7,7,0,-2,3,1,0,-15,121,1,-5,4,0,0,1,-1,1,1,1,6,-1
KR_6731509021,420,-5,-46,-33,-3,1,1,2,-2,6,4,0,2,2,-1,3,2,-1,2,1,-1,-4,-39,0,-5,5,3,0,-2,-1,-1,-1,-1,4,-1
KR_6765939854,420,-3,-57,-8,-6,1,1,2,0,1,1,-5,8,3,0,2,2,-2,2,0,0,-15,-4,0,-3,3,0,0,0,-1,1,0,1,1,-1
KR_6737966195,420,-3,0,8,-14,0,0,0,4,4,8,-12,12,0,-5,6,1,-1,1,0,1,-18,-18,-12,-4,16,6,0,-2,-1,-1,-1,1,3,-1
KR_6757201434,440,-2,29,-32,-9,3,2,5,-5,7,2,0,3,3,-4,4,0,-3,5,2,-2,-16,0,-1,-3,4,-2,0,0,1,1,0,-1,1,-1
KR_6743348335,420,-4,-100,32,-8,-1,1,0,-5,6,1,0,2,2,-6,6,0,4,0,4,0,-15,22,-1,-4,5,-3,0,-3,-1,-1,-1,1,6,-1
KR_6684923070,420,0,21,-11,2,0,0,0,-1,1,0,2,0,2,0,1,1,1,0,1,0,-1,3,-1,-4,5,1,0,1,-1,1,1,1,3,-1
KR_6691475495,420,-1,-56,12,0,-2,3,1,-1,5,4,0,1,1,3,0,3,0,1,1,-1,-8,-6,-1,-5,6,0,0,0,1,-1,0,-1,1,-1
KR_6762812916,420,4,30,-1,12,4,1,5,4,1,5,-1,5,4,4,0,4,1,2,3,0,5,-10,-2,-5,7,3,0,2,1,0,1,-1,2,-1
KR_6735228130,420,-4,-80,0,-2,-3,3,0,-2,4,2,2,0,2,-2,4,2,3,1,4,2,5,-7,-1,-4,5,-1,0,0,-1,-1,0,1,6,-1
KR_6721542942,420,-7,-97,-73,-5,1,0,1,0,4,4,-3,5,2,-3,5,2,0,2,2,-1,1,-7,-3,-4,7,-3,0,-2,-1,-1,-1,-1,5,-1
KR_6756389815,420,-3,49,-11,-8,-3,6,3,2,3,5,0,2,2,-6,6,0,-1,1,0,0,-6,1,-3,-4,7,-1,0,-1,-1,1,-1,-1,2,-1
KR_6684022346,420,0,-10,-32,4,3,1,4,1,2,3,-3,6,3,3,1,4,0,0,0,0,7,2,0,-7,7,-1,0,-1,-1,-1,-1,1,6,-1
KR_6730426650,420,-3,7,-12,-4,-1,2,1,-1,5,4,0,1,1,-2,2,0,0,0,0,0,-9,7,-3,-5,8,1,0,0,1,-1,-1,-1,5,-1
KR_6751218125,420,-4,-35,-9,-1,-3,4,1,-1,3,2,3,0,3,-1,3,2,1,0,1,-1,0,10,2,-4,2,1,0,0,-1,1,0,-1,6,-1
KR_6759719924,440,0,-14,-8,-1,0,1,1,1,3,4,0,1,1,-2,5,3,0,4,4,0,-2,322,3,-3,0,-2,0,-1,-1,-1,-1,-1,3,-1
KR_6707304832,420,-2,-50,-3,2,0,3,3,-1,3,2,3,1,4,0,1,1,0,2,2,0,6,-1,0,-4,4,0,0,-1,-1,-1,-1,1,4,-1
KR_6429567336,440,2,20,11,3,3,0,3,1,5,6,-1,4,3,-2,5,3,2,0,2,0,3,1,3,-9,6,2,0,0,1,-1,1,1,2,-1
KR_6763521264,420,-1,-23,-32,-1,0,0,0,0,4,4,-1,2,1,2,1,3,-2,2,0,0,3,9,-1,-4,5,-3,0,-1,-1,-1,-1,-1,4,-1
KR_6700226200,420,-2,4,-36,-3,-4,4,0,0,2,2,1,2,3,0,4,4,0,0,0,-1,-1,3,-3,-3,6,-2,0,-1,1,-1,-1,-1,3,-1
KR_6735536168,440,0,31,-8,-4,0,0,0,-4,5,1,-1,3,2,2,2,4,-1,4,3,0,-9,-4,-2,-3,5,3,0,0,0,-1,0,1,0,-1
KR_6753960285,420,-2,25,-12,-2,-4,5,1,1,1,2,-2,5,3,1,1,2,2,2,4,0,-3,-3,-2,-5,7,0,0,0,-1,1,0,1,3,-1
KR_6692066989,420,0,-2,17,-1,3,0,3,-3,4,1,-1,4,3,-1,2,1,1,0,1,0,-9,-2,-7,-1,8,5,0,0,1,-1,0,1,1,-1
KR_6727016312,440,2,6,-20,4,1,4,5,3,2,5,1,1,2,0,1,1,-1,2,1,0,-1,10,-1,-7,8,-6,0,0,-1,0,1,-1,1,-1
KR_6656954203,420,0,-12,5,4,1,0,1,-2,6,4,0,3,3,5,1,6,0,0,0,0,5,-11,0,-6,6,-3,0,0,1,-1,0,-1,5,-1
KR_6611884828,420,-1,9,23,-3,-6,6,0,-1,2,1,2,0,2,1,1,2,1,1,2,0,-7,3,0,-3,3,-1,0,-1,1,1,1,-1,5,-1
KR_6584165396,420,-3,32,-25,-7,-2,4,2,-8,9,1,2,2,4,0,3,3,1,1,2,0,-10,-5,-1,-6,7,7,0,-1,-1,-1,-1,-1,6,-1
KR_6745360992,420,-3,-3,16,-10,-2,3,1,-3,6,3,-4,6,2,-2,2,0,1,3,4,0,-10,98,-4,-4,8,2,0,-1,-1,1,-1,-1,5,-1
KR_6760737326,420,-3,-48,0,-1,-2,3,1,1,0,1,-2,4,2,2,0,2,0,1,1,0,2,6,3,-4,1,-4,0,-1,1,-1,-1,1,6,-1
KR_6668409458,420,-6,-87,-28,-18,-5,5,0,-2,4,2,-7,9,2,-4,6,2,0,2,2,-1,-13,-3,-3,-5,8,-9,0,-2,1,-1,-1,-1,6,-1
KR_6755811594,420,-3,28,-16,-7,1,1,2,-4,4,0,0,0,0,-3,7,4,-1,1,0,0,-9,-40,0,-4,4,-2,0,0,-1,-1,-1,-1,3,-1
KR_6700662474,420,-7,-99,-3,-12,0,1,1,-6,7,1,-1,2,1,-5,6,1,0,1,1,0,-12,-25,-2,-5,7,2,0,-1,1,-1,-1,-1,3,-1
KR_6708982362,420,-1,-32,-20,-1,-2,6,4,2,1,3,2,1,3,-3,3,0,0,0,0,1,3,3,3,-5,2,-3,0,-1,-1,-1,-1,1,2,-1
KR_6736818635,420,0,-15,12,1,-2,3,1,1,3,4,-3,3,0,3,1,4,2,0,2,0,2,-10,-3,-7,10,6,0,-1,-1,-1,-1,1,6,-1
KR_6726775872,420,-4,-21,-16,-8,-4,4,0,-3,4,1,-3,5,2,1,1,2,1,0,1,0,-4,-2,2,-6,4,0,0,0,1,0,0,-1,5,-1
KR_6746587732,420,2,78,-28,11,4,0,4,-1,6,5,2,1,3,3,2,5,3,0,3,0,7,198,0,-5,5,3,0,0,-1,1,0,1,5,-1
KR_6667786938,420,-1,-40,-9,-7,0,3,3,-5,7,2,1,3,4,-3,3,0,0,1,1,-1,-8,-12,1,-4,3,-2,0,-1,0,1,-1,-1,0,-1
KR_6743021746,440,1,32,22,-6,6,1,7,-1,2,1,1,2,3,-8,8,0,-4,5,1,0,-13,-9,1,-4,3,-1,0,-1,-1,1,-1,-1,2,-1
KR_6753524341,420,0,-2,-14,-2,-2,4,2,0,6,6,1,1,2,-1,4,3,0,0,0,0,-3,21,-2,-9,11,1,0,0,-1,1,0,-1,2,-1
KR_6754484872,420,3,42,11,3,1,2,3,-4,4,0,0,0,0,4,3,7,2,1,3,0,6,-4,3,-6,3,1,0,1,0,1,1,1,0,-1
KR_6677467770,420,-3,-40,0,-7,-3,6,3,2,2,4,-2,2,0,-3,7,4,-1,3,2,-2,0,1,-3,-4,7,2,0,0,1,-1,-1,1,6,-1
KR_6745851197,420,-3,23,0,-7,-4,7,3,-2,3,1,-2,4,2,1,1,2,0,0,0,0,-8,0,1,-4,3,-2,0,0,1,1,0,-1,3,-1
KR_6748041056,420,1,25,4,-3,2,0,2,-7,8,1,3,0,3,-2,6,4,1,1,2,0,-6,4,3,-5,2,-6,0,0,1,1,1,1,3,-1
KR_6668492267,420,1,11,4,3,2,1,3,1,3,4,2,0,2,3,0,3,-5,6,1,0,2,2,3,-8,5,0,0,1,-1,1,1,1,5,-1
KR_6761660517,420,-2,28,-39,3,3,2,5,5,2,7,-6,6,0,1,0,1,0,1,1,0,-1,4,-1,-2,3,-3,0,2,1,-1,1,-1,6,-1
KR_6763957357,420,3,9,35,2,0,1,1,1,1,2,-3,3,0,4,1,5,0,2,2,0,3,38,3,-5,2,-1,0,0,-1,1,1,-1,6,-1
KR_6761543299,420,0,15,-12,-6,-3,3,0,-3,5,2,0,2,2,-2,2,0,2,1,3,0,-5,-2,1,-6,5,0,0,1,1,0,1,-1,5,-1
KR_6749660302,420,-1,-14,-2,-3,3,0,3,2,2,4,-1,2,1,-8,8,0,1,0,1,0,-10,-39,-1,-3,4,-3,0,0,-1,1,-1,1,1,-1
KR_6611270479,420,-1,19,-36,-3,-1,1,0,-4,7,3,-3,3,0,5,2,7,0,1,1,0,0,14,3,-10,7,-1,0,0,1,-1,-1,1,4,-1
KR_6577795864,420,0,53,3,-6,1,1,2,-4,4,0,2,1,3,-6,6,0,1,0,1,0,-14,21,-3,-4,7,-19,0,0,-1,1,1,-1,1,-1
KR_6735249835,420,-3,-80,-24,-5,1,1,2,-2,5,3,0,1,1,-4,5,1,0,0,0,0,-12,-7,0,-4,4,-1,0,0,-1,-1,0,-1,5,-1
KR_6509480330,420,4,3,24,0,-1,4,3,0,4,4,1,0,1,-2,3,1,2,1,3,0,4,11,-2,-5,7,-1,0,0,1,-1,0,1,3,-1
KR_6728279597,420,-6,-100,-27,-16,-1,2,1,-5,6,1,0,1,1,-10,15,5,0,0,0,0,-9,-2,2,-8,6,-2,0,-1,-1,-1,-1,-1,3,-1
KR_6544228948,420,-1,5,-32,-4,-2,3,1,0,6,6,-1,1,0,-2,4,2,1,0,1,-3,-11,3,-1,-5,6,2,0,1,-1,1,-1,-1,3,-1
KR_6605651098,420,0,-58,12,-2,3,0,3,-5,6,1,-1,4,3,-1,2,1,2,0,2,0,-6,36,-1,-4,5,0,0,-1,1,1,1,-1,1,-1
KR_6697673034,420,0,6,30,-4,4,0,4,-4,5,1,-1,3,2,-3,7,4,0,2,2,0,-10,1,4,-6,2,-2,0,0,-1,1,1,-1,1,-1
KR_6757359171,420,-3,-41,17,-10,-3,4,1,-2,3,1,0,2,2,-5,6,1,0,6,6,0,-9,-127,-1,-6,7,-1,0,-1,-1,-1,-1,-1,2,-1
KR_6730704267,420,-3,3,-3,-8,2,0,2,0,4,4,-7,7,0,4,3,7,-7,8,1,1,-3,-5,1,-6,5,7,0,1,-1,-1,1,1,4,-1
KR_6761971685,420,-1,-30,-6,-9,-4,5,1,-1,1,0,1,2,3,-6,7,1,1,0,1,0,-8,5,2,-6,4,-2,0,-2,1,-1,-1,1,6,-1
KR_6761333731,420,2,-44,16,-4,1,1,2,3,1,4,-4,5,1,-3,5,2,-1,1,0,0,-3,-2,-4,-5,9,-1,0,0,1,1,0,-1,3,-1
KR_6762852790,420,-1,-47,0,-13,-1,2,1,1,1,2,-4,4,0,-7,7,0,-2,5,3,-1,-11,-12,4,-5,1,2,0,0,-1,1,0,-1,1,-1
KR_6763352416,420,-4,-42,7,-10,-4,6,2,-2,3,1,-1,5,4,1,2,3,-4,4,0,-1,-9,10,-4,-7,11,-2,0,-2,-1,-1,-1,-1,3,-1
KR_6752357601,420,-1,-125,-4,-3,-1,1,0,0,1,1,-1,1,0,-1,1,0,0,0,0,0,-4,-2,-4,-1,5,1,0,-2,-1,1,-1,-1,3,-1
KR_6736258777,420,-7,-80,-24,-12,-3,3,0,-1,3,2,-4,4,0,-4,5,1,0,0,0,0,-11,-7,-1,-2,3,-2,0,-2,-1,1,-1,-1,5,-1
KR_6741718805,420,-3,-75,-32,-5,3,0,3,1,4,5,-8,9,1,-2,3,1,1,1,2,0,-4,3,-1,-6,7,-4,0,-2,-1,-1,-1,1,2,-1
KR_6697318360,420,-2,-19,4,-10,-1,2,1,-1,5,4,-2,5,3,0,2,2,-6,6,0,0,-13,-8,-2,-4,6,-4,0,-2,1,1,-1,1,3,-1
KR_6728402739,420,-8,-103,-24,-14,-3,3,0,-4,4,0,-3,3,0,-4,5,1,0,1,1,0,-9,5,-2,-3,5,-3,0,-2,-1,1,-1,-1,6,-1
KR_6611301834,420,-6,-73,6,-10,-2,2,0,-2,5,3,-2,2,0,-5,7,2,1,0,1,1,-20,6,3,-11,8,-5,0,0,1,1,0,1,4,-1
KR_6753916374,420,-1,-2,8,-5,-1,4,3,-2,3,1,1,2,3,-5,6,1,2,0,2,-1,-13,-9,5,-10,5,2,0,0,0,-1,0,-1,0,-1
KR_6765299874,420,-3,10,-10,-4,-2,3,1,-1,3,2,5,0,5,-7,10,3,1,0,1,0,-7,41,1,-9,8,-12,0,0,-1,1,0,1,3,-1
KR_6594961962,440,0,7,-11,-3,0,1,1,0,4,4,-2,3,1,-2,5,3,1,1,2,1,1,-57,-4,-4,8,18,0,0,-1,1,0,1,2,-1
KR_6746359624,420,-6,-102,-19,-9,1,1,2,-1,1,0,-11,12,1,1,1,2,1,0,1,0,-10,17,-3,-3,6,-9,0,-1,-1,-1,-1,-1,4,-1
KR_6744137944,420,-1,-34,-11,-11,0,0,0,-3,5,2,0,3,3,-6,7,1,-2,2,0,0,-4,-10,-1,-7,8,-4,0,0,1,-1,-1,1,3,-1
KR_6745360158,420,2,63,-23,6,3,0,3,2,5,7,1,2,3,0,1,1,0,0,0,0,6,5,3,-6,3,-2,0,-1,1,-1,-1,1,1,-1
KR_6692743643,420,-6,-101,-22,-18,-4,5,1,-8,10,2,-6,6,0,0,0,0,0,0,0,-1,-16,41,0,-5,5,-22,0,-3,-1,-1,-1,-1,1,-1
KR_6758004622,420,-1,24,-4,-6,-1,2,1,2,0,2,-2,3,1,-1,1,0,-4,5,1,0,-7,-22,2,-2,0,-3,0,1,0,-1,1,-1,0,-1
KR_6761570054,440,-4,-43,-20,-3,-1,2,1,2,1,3,-2,2,0,-1,3,2,-1,2,1,1,0,39,2,-7,5,-31,0,0,-1,1,0,1,1,-1
KR_6740509562,420,-4,-25,-9,-9,-3,3,0,-2,2,0,-3,3,0,0,4,4,-1,2,1,0,-10,-101,0,-7,7,-6,0,-1,-1,1,-1,-1,2,-1
KR_6551591564,420,1,38,4,5,-2,2,0,3,3,6,0,2,2,4,0,4,0,0,0,0,12,30,7,-11,4,-2,0,0,1,-1,0,-1,6,-1
KR_6736720970,420,2,6,20,-2,-2,2,0,3,3,6,0,2,2,-2,3,1,-1,4,3,0,-3,21,-3,-5,8,2,0,0,1,1,0,-1,1,-1
KR_6683767881,420,-1,8,-8,-1,2,2,4,-5,6,1,4,2,6,1,0,1,-3,4,1,-1,-10,236,3,-8,5,-7,0,0,-1,1,1,-1,1,-1
KR_6760126054,420,0,-63,-9,-1,4,0,4,3,1,4,-3,3,0,-5,5,0,0,1,1,0,-1,-3,4,-8,4,-1,0,1,1,-1,-1,1,5,-1
KR_6755824206,420,-3,-27,-13,-5,-1,3,2,-3,4,1,-2,2,0,1,1,2,0,0,0,0,-1,-4,-1,-4,5,-1,0,0,-1,-1,-1,-1,2,-1
KR_6762172973,420,0,-8,4,-1,-2,3,1,0,1,1,-5,5,0,4,1,5,2,1,3,0,5,-3,0,-6,6,-1,0,0,1,-1,-1,-1,1,-1
KR_6758503587,420,1,-13,-4,9,-4,5,1,4,2,6,8,1,9,0,0,0,1,1,2,0,6,-8,-1,-2,3,1,0,0,0,1,0,1,0,-1
KR_6640005703,420,-3,-22,-16,-5,0,1,1,-1,2,1,-2,4,2,-2,4,2,0,3,3,0,-3,-5,-4,-4,8,-2,0,-2,1,-1,-1,1,1,-1
KR_6660451654,440,-3,-14,-10,-7,1,3,4,0,4,4,-1,2,1,-6,6,0,-1,1,0,0,-7,6,-7,-2,9,-2,0,0,-1,-1,-1,1,1,-1
KR_6705675166,420,2,1,-8,8,0,4,4,4,0,4,4,1,5,0,1,1,0,0,0,0,10,-3,1,-3,2,2,0,0,1,1,1,-1,3,-1
KR_6762512502,420,-1,-8,-42,-8,-3,4,1,-7,7,0,1,3,4,1,2,3,0,1,1,0,-10,21,0,-5,5,0,0,-1,-1,-1,-1,-1,4,-1
KR_6760233224,420,-3,-40,15,-5,-4,5,1,1,2,3,-1,1,0,-2,4,2,1,0,1,0,1,0,-2,-4,6,1,0,-2,-1,0,-1,-1,5,-1
KR_6745065998,420,1,-66,24,0,2,2,4,5,5,10,-5,5,0,1,5,6,-3,3,0,-1,-2,26,-1,-3,4,-6,0,0,1,-1,-1,-1,6,-1
KR_6745080043,420,0,-17,8,-2,-1,5,4,0,2,2,1,2,3,-2,2,0,0,1,1,0,-1,-9,1,-5,4,1,0,-1,1,1,-1,1,3,-1
KR_6595923382,440,-1,20,-11,-16,2,1,3,-3,4,1,-9,10,1,-6,6,0,0,1,1,-1,-14,-10,0,-4,4,-1,0,0,-1,-1,-1,-1,1,-1
KR_6623457832,420,-6,-65,-27,-10,-4,5,1,1,1,2,-9,11,2,1,4,5,1,0,1,-1,-1,45,-3,-6,9,-30,0,-2,-1,-1,-1,-1,5,-1
KR_6763701645,420,-5,-45,35,-10,-1,3,2,-4,4,0,-5,8,3,-1,2,1,1,0,1,0,-10,5,-3,-3,6,-3,0,0,-1,1,0,1,3,-1
KR_6748608457,420,-4,-142,4,-3,2,0,2,3,3,6,-2,3,1,-2,5,3,-4,4,0,0,-3,39,1,-4,3,-1,0,-1,-1,1,-1,-1,2,-1
KR_6731374198,420,-4,-71,-44,-5,-4,5,1,-3,6,3,-2,3,1,1,0,1,3,0,3,-1,3,-70,-4,-2,6,10,0,0,-1,-1,-1,-1,4,-1
KR_6616250380,420,-2,50,-29,-3,-1,3,2,0,0,0,1,2,3,-2,2,0,-1,1,0,0,-6,-8,5,-8,3,0,0,-1,-1,-1,-1,1,2,-1
KR_6491823710,420,-6,-41,-32,-10,-1,3,2,-2,2,0,1,1,2,-3,5,2,-5,5,0,0,-7,-4,-1,-4,5,-5,0,-2,-1,-1,-1,-1,4,-1
KR_6753768751,420,-4,-36,19,-8,-2,3,1,-2,2,0,-3,4,1,3,0,3,-4,4,0,0,-6,3,-1,-5,6,-5,0,-1,-1,-1,-1,-1,6,-1
KR_6764173971,420,3,19,24,4,-5,7,2,-4,4,0,3,0,3,1,1,2,9,0,9,0,1,-6,1,-3,2,5,0,1,-1,1,1,-1,5,-1
KR_6760675346,420,-1,-30,11,-4,1,3,4,-4,4,0,0,2,2,-1,1,0,0,1,1,0,-6,4,0,-3,3,-1,0,-2,1,-1,-1,1,1,-1
KR_6759604357,420,1,38,-15,1,-1,2,1,-1,1,0,2,0,2,-1,3,2,2,0,2,0,1,-3,-2,-7,9,-2,0,0,1,-1,1,1,6,-1
KR_6760063054,420,-4,-99,-7,-10,-1,2,1,-1,2,1,-2,2,0,-4,4,0,-2,2,0,0,-16,-2,1,-5,4,2,0,-2,-1,-1,-1,-1,6,-1
KR_6766283186,420,-1,-17,-24,0,2,1,3,2,2,4,2,2,4,-5,6,1,-1,2,1,0,2,183,1,-4,3,-8,0,0,-1,-1,-1,-1,3,-1
KR_6740858324,420,-2,12,-28,-6,-6,6,0,-1,3,2,0,1,1,2,3,5,-1,2,1,0,1,-3,7,-10,3,1,0,-2,-1,-1,-1,-1,3,-1
KR_6746057146,420,3,62,5,2,-1,2,1,-2,3,1,4,2,6,2,1,3,-1,1,0,0,1,31,1,-3,2,-4,0,0,1,1,0,1,4,-1
KR_6634963884,420,0,11,-8,0,1,1,2,-2,5,3,-3,3,0,6,1,7,-2,4,2,-1,-9,3,-2,-7,9,3,0,-1,-1,1,-1,-1,5,-1
KR_6703549317,440,-5,-35,-12,-8,-1,2,1,-4,6,2,3,3,6,-6,10,4,0,4,4,0,0,11,0,-8,8,-5,0,-1,-1,0,-1,1,4,-1
KR_6761352555,420,-7,-60,-16,-18,-6,8,2,1,3,4,-10,10,0,-3,4,1,0,1,1,1,-4,-4,-3,-2,5,-12,0,-3,1,-1,-1,1,1,-1
KR_6751302053,420,1,-29,4,3,-3,3,0,8,1,9,1,3,4,-2,8,6,-1,1,0,2,16,1,-4,-2,6,-2,0,-1,0,-1,-1,1,0,-1
KR_6756155402,420,-1,-99,9,-6,-1,2,1,1,3,4,0,4,4,-4,5,1,-2,2,0,-1,-9,35,-3,-3,6,-3,0,-3,-1,1,-1,-1,3,-1
KR_6703470690,440,-4,-28,0,-5,1,3,4,-6,6,0,4,1,5,-6,6,0,2,1,3,-1,-7,40,-2,-6,8,-16,0,0,1,1,0,-1,6,-1
KR_6731499657,420,-5,-48,-8,-8,-1,3,2,2,3,5,-2,3,1,-7,9,2,0,1,1,-2,-11,23,0,-3,3,1,0,-1,-1,1,1,-1,3,-1
KR_6760657952,420,-1,-14,19,-1,4,0,4,-1,5,4,-2,2,0,0,4,4,-2,2,0,0,-8,-27,6,-8,2,18,0,-1,1,1,-1,-1,4,-1
KR_6634787627,420,1,14,12,4,-3,3,0,2,0,2,1,1,2,1,2,3,3,0,3,0,-1,-9,-2,-4,6,0,0,0,1,-1,1,-1,4,-1
KR_6756697720,420,3,-25,-27,1,2,0,2,-1,2,1,4,4,8,-2,3,1,-2,2,0,0,-6,1,2,-5,3,2,0,-1,-1,-1,-1,-1,2,-1
KR_6763238532,420,1,-53,8,-1,0,2,2,0,1,1,-1,1,0,1,0,1,-1,2,1,-1,-4,0,-3,-2,5,1,0,0,-1,0,0,-1,4,-1
KR_6756889366,440,1,-15,8,1,-5,5,0,-2,3,1,4,3,7,3,2,5,1,2,3,-3,4,25,0,-4,4,-6,0,-2,1,-1,-1,-1,4,-1
KR_6761189358,420,-3,-40,-11,-7,0,2,2,1,2,3,-5,6,1,-3,7,4,0,2,2,0,-10,-5,-1,-3,4,1,0,-1,-1,1,-1,1,3,-1
KR_6648479461,420,-4,-37,-37,1,-2,3,1,4,0,4,0,1,1,-3,4,1,2,0,2,0,5,-1,3,-5,2,-1,0,-1,1,1,-1,-1,3,-1
KR_6741092299,440,-5,-65,-25,-6,2,2,4,-9,10,1,1,2,3,-1,4,3,1,0,1,0,-12,-35,-9,-1,10,3,0,-1,-1,0,-1,1,5,-1
KR_6758907146,420,-3,35,-24,-3,-3,4,1,0,1,1,0,1,1,1,3,4,-1,1,0,1,-2,11,3,-6,3,-2,0,0,1,-1,0,1,2,-1
KR_6765259939,420,1,4,16,3,-1,2,1,-2,4,2,4,0,4,0,4,4,2,0,2,0,3,0,1,-6,5,-1,0,0,1,-1,0,1,4,-1
KR_6716374189,420,-2,-106,-16,-5,-3,4,1,2,3,5,1,0,1,-4,7,3,-1,2,1,1,-4,-4,3,-5,2,-1,0,-2,-1,-1,-1,1,1,-1
KR_6743635121,420,1,-37,-24,0,-2,3,1,1,2,3,3,1,4,1,2,3,-3,3,0,0,1,41,1,-5,4,-19,0,-1,1,-1,-1,-1,3,-1
KR_6744174095,420,-1,-79,17,-7,-1,2,1,-2,5,3,-1,1,0,-2,2,0,-1,2,1,0,-7,-7,2,-5,3,2,0,-1,1,-1,-1,-1,6,-1
KR_6750787900,420,-4,20,-36,2,1,1,2,2,2,4,-1,2,1,1,4,5,-1,2,1,0,6,4,4,-8,4,-1,0,0,-1,-1,0,-1,6,-1
KR_6634274767,420,0,4,20,-2,0,2,2,-3,6,3,-2,5,3,-1,3,2,4,2,6,-1,2,-8,-2,-4,6,-2,0,1,-1,-1,-1,-1,3,-1
KR_6764288502,420,0,-37,46,-5,-1,2,1,1,1,2,0,1,1,-5,6,1,0,0,0,0,-10,-4,-8,-3,11,-1,0,0,1,1,0,1,2,-1
KR_6690207875,420,2,58,8,4,-1,2,1,5,1,6,-3,4,1,1,0,1,2,1,3,0,8,5,4,-9,5,-2,0,0,1,1,-1,-1,2,-1
KR_6763217549,440,-2,-45,-16,-4,-1,1,0,0,2,2,1,1,2,-2,2,0,-2,2,0,0,-3,12,2,-7,5,-8,0,0,-1,1,0,1,2,-1
KR_6482121201,420,-3,-104,-20,-9,-2,3,1,-1,4,3,-5,7,2,-1,2,1,0,1,1,0,-4,-68,-1,-4,5,-5,0,-2,-1,0,-1,-1,1,-1
KR_6689025443,420,-1,-31,-28,-4,-1,1,0,0,1,1,-3,4,1,-1,1,0,1,0,1,0,-2,-27,-6,-2,8,4,0,-1,-1,-1,-1,-1,6,-1
KR_6739446167,420,-1,-42,8,-1,-5,6,1,-1,3,2,1,0,1,3,1,4,1,0,1,0,2,-2,6,-8,2,-5,0,0,1,-1,0,-1,4,-1
KR_6599589895,420,4,-52,1,10,5,1,6,1,3,4,7,0,7,-4,6,2,1,2,3,-1,4,-11,2,-5,3,-1,0,1,1,1,1,1,3,-1
KR_6719698380,420,3,-10,4,3,3,1,4,-2,2,0,-1,5,4,3,3,6,0,3,3,-1,2,6,3,-8,5,-2,0,0,-1,-1,0,-1,2,-1
KR_6648948808,420,2,35,-8,3,-1,4,3,3,0,3,0,4,4,0,3,3,1,1,2,-2,1,-12,1,-4,3,4,0,0,1,-1,-1,-1,3,-1
KR_6765323781,420,1,45,7,-3,2,1,3,1,4,5,-3,5,2,1,2,3,-4,4,0,0,-7,-2,-2,-3,5,-5,0,-1,-1,-1,-1,1,3,-1
KR_6597883260,420,-3,-62,-38,-9,-4,4,0,-2,4,2,-4,7,3,1,4,5,0,0,0,0,-9,0,0,-8,8,-3,0,-2,-1,-1,-1,-1,2,-1
KR_6762719446,420,0,-21,-3,2,0,2,2,1,1,2,-1,1,0,6,3,9,-4,4,0,0,8,3,4,-7,3,-4,0,-2,-1,-1,-1,-1,2,-1
KR_6652235474,420,0,3,-18,-1,0,1,1,1,2,3,-2,5,3,-1,7,6,1,0,1,-1,7,0,0,-8,8,1,0,-1,-1,-1,-1,1,2,-1
KR_6734180354,440,-4,-40,-12,-7,-1,1,0,-1,3,2,-5,5,0,0,2,2,0,0,0,0,-6,-5,2,-3,1,-2,0,0,-1,1,-1,1,2,-1
KR_6622449437,420,0,6,-2,-5,-8,9,1,-2,2,0,1,1,2,0,3,3,4,0,4,0,5,-16,-2,-2,4,1,0,0,1,-1,-1,1,1,-1
KR_6723021496,420,-2,-43,-18,-5,-9,9,0,6,3,9,3,0,3,-4,5,1,-1,1,0,0,7,-28,0,-5,5,1,0,-1,-1,1,-1,-1,6,-1
KR_6754577556,420,0,-58,12,-4,1,1,2,-3,3,0,-5,5,0,2,1,3,1,1,2,0,-2,-16,-2,-2,4,5,0,-1,1,-1,-1,-1,2,-1
KR_6758763126,420,1,23,4,0,0,1,1,5,2,7,1,4,5,-5,5,0,-1,1,0,0,3,-23,-2,-3,5,0,0,0,1,-1,0,-1,5,-1
KR_6751007511,420,0,-25,-5,-2,-1,6,5,2,1,3,2,0,2,-2,2,0,-3,3,0,0,-2,-2,-1,-4,5,3,0,-1,-1,1,1,1,5,-1
KR_6683900259,420,-1,-32,-11,-4,3,1,4,2,4,6,-8,13,5,0,2,2,-1,1,0,0,3,0,-3,-3,6,0,0,-1,-1,-1,1,-1,2,-1
KR_6743221142,420,1,6,4,2,3,1,4,1,3,4,3,2,5,-4,8,4,-1,3,2,0,-18,0,-5,-5,10,3,0,1,-1,-1,1,-1,5,-1
KR_6745647983,420,-2,-39,-9,4,4,0,4,1,3,4,0,2,2,-2,3,1,1,0,1,0,-1,-32,-1,-6,7,2,0,0,-1,1,-1,1,6,-1
KR_6734291053,440,-2,37,-12,-1,-1,2,1,-3,4,1,0,2,2,3,2,5,0,2,2,0,-3,0,0,-1,1,0,0,-1,-1,-1,-1,-1,1,-1
KR_6729671410,420,-2,-56,36,5,0,2,2,3,2,5,1,1,2,0,2,2,1,0,1,0,8,67,-2,-3,5,0,0,-1,1,-1,-1,1,5,-1
KR_6652642098,420,-4,17,-8,-10,0,1,1,-1,3,2,-3,5,2,-3,3,0,-3,4,1,0,-14,0,-2,-6,8,2,0,0,-1,1,0,-1,4,-1
KR_6757560006,440,-4,-91,-11,-2,0,4,4,-2,7,5,0,3,3,-1,4,3,1,2,3,1,5,-3,-4,-2,6,2,0,-2,-1,-1,-1,1,3,-1
KR_6760250323,420,2,85,16,2,1,1,2,1,3,4,-2,3,1,2,4,6,0,1,1,0,0,-16,6,-8,2,-5,0,0,0,1,0,1,0,-1
KR_6698358582,420,-2,-23,-3,-8,-5,5,0,-5,6,1,2,2,4,-2,3,1,2,3,5,0,-9,-14,-3,-2,5,1,0,-1,-1,-1,-1,-1,1,-1
KR_6606337189,420,-4,-90,-19,-17,-4,6,2,-4,4,0,-1,4,3,-12,12,0,4,1,5,-1,-22,-100,-8,-2,10,-4,0,-3,1,-1,-1,-1,4,-1
KR_6680821870,420,-1,-65,-9,-8,-5,6,1,-3,3,0,4,0,4,-5,6,1,1,1,2,0,-1,-120,1,-4,3,-4,0,-3,1,-1,-1,-1,4,-1
KR_6747772942,420,0,-63,-8,3,1,0,1,0,8,8,-1,2,1,5,2,7,-2,3,1,1,13,29,7,-11,4,-4,0,1,1,1,1,1,2,-1
KR_6750817477,420,-4,7,8,-12,-1,1,0,-5,6,1,-1,2,1,-5,7,2,0,0,0,0,-6,-10,-5,-2,7,2,0,-1,-1,-1,-1,-1,6,-1
KR_6746921065,420,0,-46,17,2,0,0,0,-1,4,3,5,2,7,-1,1,0,-1,2,1,2,4,32,-2,-7,9,1,0,0,-1,1,-1,1,3,-1
KR_6732382903,440,-1,-65,16,-2,1,1,2,2,1,3,-3,4,1,-4,4,0,2,0,2,0,-4,-4,-1,-3,4,-4,0,0,1,-1,-1,-1,2,-1
KR_6740567149,420,4,-19,6,4,5,0,5,0,3,3,3,0,3,-4,5,1,0,0,0,0,-4,-9,3,-7,4,3,0,2,-1,1,1,1,5,-1
KR_6762440441,440,-5,-48,-2,-14,0,1,1,-6,7,1,-1,5,4,-5,6,1,-2,4,2,0,-14,-1,5,-8,3,-10,0,-1,-1,-1,-1,-1,6,-1
KR_6755662320,440,-5,-122,-8,-14,-4,5,1,-4,4,0,-3,5,2,-2,3,1,-1,2,1,-2,-16,-2,0,-6,6,-6,0,-1,-1,-1,-1,-1,3,-1
KR_6751003321,440,-1,-37,-18,-3,-1,2,1,2,2,4,-3,7,4,-1,2,1,0,1,1,0,5,-3,-4,-1,5,-4,0,-1,-1,-1,-1,-1,2,-1
KR_6749529123,420,-3,-50,-13,-13,2,1,3,-3,6,3,-1,2,1,-11,12,1,0,2,2,0,-16,-17,-4,-5,9,-1,0,-1,1,-1,-1,-1,2,-1
KR_6744936846,420,-2,-33,-48,-6,-3,4,1,-2,4,2,-1,3,2,0,4,4,0,1,1,0,-1,-9,-1,-5,6,3,0,0,-1,-1,-1,-1,3,-1
KR_6759065245,420,-1,17,-8,-11,-4,4,0,-2,3,1,3,1,4,-5,5,0,-3,3,0,0,-13,3,-4,-1,5,2,0,-1,1,-1,-1,-1,5,-1
KR_6753123759,420,-3,-90,5,-2,-3,6,3,2,1,3,-2,3,1,-1,2,1,2,0,2,0,-4,-31,-1,-4,5,2,0,0,-1,-1,0,1,3,-1
KR_6680632599,420,-4,-56,-30,-5,1,0,1,-2,3,1,-1,4,3,-2,5,3,-1,2,1,0,0,-3,2,-7,5,1,0,0,-1,-1,0,-1,5,-1
KR_6744832402,440,1,-14,-8,0,2,2,4,0,3,3,-2,2,0,1,3,4,-1,1,0,0,-10,-14,1,-6,5,-1,0,-1,1,-1,-1,1,5,-1
KR_6759624871,420,-3,-99,1,-9,-4,5,1,-2,4,2,1,2,3,-3,6,3,-1,1,0,-1,-7,39,0,-6,6,1,0,-2,1,1,-1,-1,5,-1
KR_6662878690,420,0,-82,-4,-1,-3,5,2,5,1,6,0,2,2,-4,7,3,1,1,2,3,9,4,3,-6,3,-3,0,-1,-1,1,-1,1,6,-1
KR_6739246406,420,-4,-117,4,-1,-4,4,0,1,0,1,1,0,1,-2,4,2,3,0,3,-1,0,0,2,-7,5,-2,0,-2,1,-1,-1,-1,3,-1
KR_6764201929,420,-2,-52,-29,-11,-10,10,0,1,3,4,-7,7,0,2,2,4,3,1,4,0,6,15,2,-6,4,-7,0,-1,1,-1,-1,-1,6,-1
KR_6762433987,420,2,64,13,11,3,2,5,2,1,3,-1,1,0,2,1,3,5,0,5,0,4,2,-1,-1,2,4,0,3,1,1,1,-1,4,-1
KR_6722324113,420,-1,-52,8,-6,6,1,7,-1,2,1,-2,2,0,-6,6,0,-3,3,0,0,-16,-7,1,-4,3,-3,0,-1,0,-1,-1,1,0,-1
KR_6736303844,420,-3,-46,14,-5,-2,3,1,1,2,3,-4,5,1,1,2,3,-1,1,0,0,-7,-1,2,-6,4,0,0,0,1,1,0,-1,4,-1
KR_6729550403,420,2,28,-21,-2,2,1,3,2,2,4,-1,1,0,-2,3,1,-3,4,1,0,-7,27,1,-3,2,-7,0,-1,0,-1,-1,1,0,-1
KR_6747478908,420,-1,49,-12,-4,2,2,4,-2,3,1,-1,4,3,0,4,4,-3,3,0,3,-4,-12,-4,-6,10,5,0,0,-1,-1,0,1,3,-1
KR_6745039586,420,-3,-47,-36,-5,-5,9,4,-1,4,3,0,4,4,2,3,5,-1,1,0,-2,9,1,0,-6,6,-3,0,-1,-1,-1,-1,-1,5,-1
KR_6758388027,440,-5,-65,-15,-14,-4,4,0,-8,8,0,-3,4,1,2,1,3,-1,1,0,0,-12,5,-1,-4,5,1,0,0,-1,1,-1,-1,5,-1
KR_6763564281,420,2,16,-2,6,4,0,4,-6,7,1,7,0,7,2,2,4,-1,1,0,0,10,-3,-1,-5,6,0,0,0,1,1,-1,-1,6,-1
KR_6729571784,420,-2,-17,-35,-10,0,1,1,4,1,5,-9,10,1,-3,3,0,-2,2,0,0,-13,11,-5,-5,10,-3,0,-1,-1,-1,-1,-1,6,-1
KR_6764906282,420,0,30,20,-5,-3,4,1,-1,2,1,-2,3,1,1,2,3,0,0,0,0,-7,-12,-9,-4,13,3,0,1,-1,1,1,1,2,-1
KR_6744165059,420,-5,-73,-5,-3,-2,4,2,-2,2,0,-1,1,0,1,0,1,1,0,1,0,-6,-21,-3,-1,4,2,0,0,-1,-1,0,-1,5,-1
KR_6757192747,420,-3,-12,-27,-3,-3,4,1,5,1,6,-1,2,1,-6,8,2,2,0,2,0,4,-2,0,-7,7,3,0,-1,-1,1,-1,-1,6,-1
KR_6712309905,420,-3,-53,3,-8,-3,4,1,-3,8,5,0,2,2,-2,4,2,0,2,2,0,7,-228,3,-5,2,0,0,1,-1,1,1,1,2,-1
KR_6757027799,420,-1,-63,-3,-6,-2,2,0,-6,9,3,4,1,5,1,0,1,-3,4,1,0,-3,14,-1,-5,6,-2,0,-2,-1,-1,-1,-1,4,-1
KR_6764944449,420,-1,-36,-28,-4,-4,4,0,2,1,3,-1,1,0,0,0,0,-1,1,0,0,-2,-16,-3,-3,6,1,0,-1,-1,-1,-1,-1,2,-1
KR_6754339901,420,-1,29,-19,-11,0,1,1,-1,1,0,-1,4,3,0,2,2,-9,9,0,0,-5,-48,0,-6,6,-4,0,0,0,-1,-1,-1,0,-1
KR_6759317909,420,-2,-29,14,-4,-4,6,2,0,1,1,5,2,7,-2,3,1,-3,3,0,-2,-18,-41,-4,-4,8,-5,0,0,-1,-1,-1,1,3,-1
KR_6748437289,420,-4,-66,9,-13,3,1,4,-6,6,0,-1,2,1,-5,5,0,-4,7,3,0,-10,11,1,-5,4,-3,0,-1,-1,1,-1,-1,1,-1
KR_6751455554,420,5,-7,8,12,2,0,2,3,2,5,4,0,4,-1,3,2,4,1,5,0,13,13,1,-3,2,-1,0,1,0,1,1,1,0,-1
KR_6709392787,420,-1,-43,-7,5,-3,3,0,2,2,4,2,1,3,2,1,3,2,0,2,0,3,6,-6,-4,10,5,0,1,1,0,1,1,4,-1
KR_6666469126,420,-3,-29,-28,-5,1,2,3,3,2,5,-1,2,1,-8,10,2,0,0,0,0,-3,-5,-5,-3,8,1,0,-1,1,-1,-1,1,6,-1
KR_6765628082,420,-1,-45,-29,-9,-1,1,0,-6,7,1,-1,4,3,-1,2,1,0,0,0,0,-9,-19,4,-6,2,4,0,0,0,0,-1,-1,0,-1
KR_6763873422,420,0,-4,2,4,-3,4,1,7,2,9,1,1,2,-1,2,1,0,3,3,0,8,313,-1,-5,6,0,0,1,1,-1,1,1,5,-1
KR_6652701142,420,-4,-57,-46,-9,-3,3,0,-3,3,0,2,3,5,-1,2,1,-4,7,3,-2,-7,29,-6,-3,9,-20,0,0,-1,-1,-1,-1,3,-1
KR_6746857533,420,-2,-12,-22,-2,-1,2,1,-4,5,1,1,1,2,3,0,3,-1,3,2,1,-5,15,3,-5,2,-28,0,1,-1,1,1,-1,1,-1
KR_6612039084,420,-3,-63,-29,-1,-1,1,0,-2,3,1,1,3,4,-1,3,2,2,1,3,0,1,5,2,-6,4,-4,0,-1,-1,1,-1,-1,3,-1
KR_6760531026,420,-2,-4,-7,0,-4,4,0,0,3,3,-1,2,1,4,1,5,1,0,1,0,6,9,-3,-2,5,-1,0,0,1,-1,1,1,1,-1
KR_6723054464,420,-2,1,-21,-4,0,2,2,-1,4,3,0,3,3,0,1,1,-3,3,0,-1,-3,-6,-6,-2,8,1,0,0,-1,-1,0,-1,6,-1
KR_6646358015,420,-4,-52,-36,-7,-2,2,0,0,4,4,-2,2,0,-2,6,4,-1,1,0,0,-8,-3,1,-5,4,-6,0,-1,-1,-1,-1,1,6,-1
KR_6737841937,420,-2,-13,-44,-4,-1,1,0,-4,6,2,4,1,5,-2,3,1,-1,2,1,0,-7,-1,1,-5,4,0,0,0,0,-1,0,1,0,-1
KR_6730146692,420,0,11,8,-4,1,0,1,0,2,2,-3,4,1,-1,1,0,-1,2,1,0,-5,119,-3,-6,9,-2,0,0,1,-1,-1,1,2,-1
KR_6709786915,420,-1,-51,-3,1,0,2,2,3,3,6,-4,6,2,1,4,5,1,2,3,0,2,1,-2,0,2,0,0,-1,-1,1,-1,-1,3,-1
KR_6765910821,420,-2,-2,-18,-9,-2,3,1,-5,6,1,-1,1,0,-2,5,3,1,0,1,0,-11,-37,0,-4,4,1,0,-1,-1,-1,-1,-1,5,-1
KR_6665389631,420,0,14,-4,-5,-2,3,1,-4,4,0,2,0,2,-2,3,1,1,1,2,0,-9,329,-2,-3,5,3,0,1,-1,-1,1,-1,2,-1
KR_6686513590,420,2,16,22,-1,-1,4,3,-2,3,1,-1,4,3,3,3,6,0,1,1,0,3,4,5,-8,3,-6,0,0,1,1,1,-1,1,-1
KR_6762203843,440,-11,-185,-6,-30,-3,5,2,0,2,2,-13,13,0,-13,14,1,-1,2,1,0,-21,-8,-6,-2,8,0,0,-4,-1,-1,-1,-1,5,-1
KR_6727840560,420,-2,-42,-35,-3,2,0,2,-1,2,1,-2,2,0,0,0,0,-2,2,0,0,-2,-12,-4,-2,6,3,0,-1,-1,-1,-1,-1,4,-1
KR_6748565027,420,1,-15,7,4,1,1,2,1,1,2,2,2,4,-1,4,3,1,0,1,0,9,32,-1,-3,4,-18,0,1,1,1,1,1,1,-1
KR_6757176896,420,-2,-21,2,-3,-2,2,0,-1,2,1,0,0,0,1,5,6,-1,1,0,0,5,0,0,-4,4,-2,0,-1,1,-1,-1,-1,6,-1
KR_6761636520,420,-3,-81,-39,-3,4,1,5,6,2,8,-1,4,3,-12,12,0,0,0,0,0,-1,6,2,-6,4,-4,0,-1,-1,1,-1,-1,6,-1
KR_6762844362,420,-8,-35,-19,-20,-5,7,2,-8,9,1,-9,10,1,1,1,2,1,1,2,-2,-18,-7,-5,-3,8,1,0,-2,-1,-1,-1,-1,3,-1
KR_6735849449,420,-8,-118,-18,-14,1,1,2,-6,7,1,-5,7,2,-5,6,1,1,1,2,-1,-11,-3,-7,-2,9,-1,0,-3,-1,-1,-1,-1,4,-1
KR_6760398424,420,2,-15,-8,-1,-1,4,3,3,0,3,2,2,4,-2,3,1,-3,3,0,-1,-3,2,-1,-6,7,-5,0,-1,-1,1,-1,-1,4,-1
KR_6601354177,420,-3,-33,-17,-7,-2,4,2,2,4,6,-5,6,1,2,1,3,-4,7,3,0,-6,5,2,-6,4,-1,0,0,-1,0,-1,1,1,-1
KR_6650916565,420,-2,38,4,-3,-6,7,1,3,0,3,0,3,3,-1,1,0,1,1,2,0,-2,-7,-6,-3,9,-1,0,0,1,-1,-1,1,3,-1
KR_6686224725,420,1,-22,-28,4,2,2,4,2,2,4,1,1,2,-1,2,1,0,0,0,0,4,-7,-2,-4,6,0,0,0,-1,-1,-1,1,1,-1
KR_6742090297,440,2,-59,0,5,-1,2,1,6,2,8,3,0,3,-1,2,1,-2,2,0,0,7,-8,0,-5,5,5,0,2,1,1,1,1,6,-1
KR_6744050900,440,-3,3,0,-3,0,3,3,-2,3,1,0,1,1,-1,2,1,0,0,0,0,-6,-9,-2,-2,4,-1,0,-1,1,1,-1,1,6,-1
KR_6725816075,420,-4,-67,-5,-6,-4,4,0,0,1,1,0,3,3,-3,4,1,1,1,2,0,-2,-2,0,-3,3,-2,0,-2,-1,-1,-1,1,3,-1
KR_6695041431,420,-1,59,0,-1,-4,4,0,-4,7,3,7,1,8,1,4,5,-1,2,1,2,-1,-9,-4,-6,10,3,0,1,1,-1,-1,1,4,-1
KR_6748540938,420,0,-33,8,3,-1,3,2,3,2,5,3,3,6,-2,2,0,0,0,0,0,-2,-2,0,-1,1,-2,0,0,-1,1,1,-1,4,-1
KR_6741583550,420,1,76,2,-9,-3,3,0,-2,4,2,0,1,1,-4,4,0,0,0,0,0,-13,-1,3,-6,3,1,0,0,0,0,0,-1,0,-1
KR_6615880480,420,1,-13,-24,4,-2,2,0,3,0,3,0,3,3,2,1,3,1,0,1,0,9,9,2,-6,4,-4,0,0,-1,1,0,-1,2,-1
KR_6746172180,420,0,19,21,-3,-3,5,2,-1,2,1,0,2,2,0,1,1,1,0,1,1,1,-3,-5,-4,9,0,0,1,1,-1,1,1,4,-1
KR_6687483978,420,-1,-30,-9,0,-3,4,1,-4,5,1,5,1,6,-5,10,5,7,0,7,2,7,20,2,-7,5,-2,0,0,-1,1,1,1,1,-1
KR_6765193400,420,3,26,-3,9,2,1,3,3,0,3,0,0,0,2,1,3,2,1,3,0,10,2,2,-8,6,-3,0,1,1,1,1,1,5,-1
KR_6689071928,420,-1,-31,-9,-3,-5,7,2,1,3,4,2,1,3,1,2,3,-2,2,0,0,-3,-12,-2,-5,7,-5,0,0,-1,1,-1,1,3,-1
KR_6748589954,420,2,8,-20,-2,0,1,1,2,1,3,-1,2,1,-4,6,2,1,0,1,0,-8,-7,0,-5,5,1,0,0,1,-1,0,1,4,-1
KR_6734592825,420,-4,-38,-25,-8,-3,5,2,4,2,6,-5,7,2,-6,7,1,2,1,3,0,-14,-11,-8,-2,10,4,0,-3,1,-1,-1,1,1,-1
KR_6765717425,420,0,-46,8,2,0,1,1,1,0,1,2,2,4,-1,2,1,0,0,0,0,4,-94,3,-6,3,-4,0,-1,-1,-1,-1,-1,1,-1
KR_6758726703,420,-4,-77,-32,-13,-5,5,0,-5,6,1,2,3,5,-7,9,2,2,2,4,0,-13,-6,-6,-1,7,0,0,-4,-1,-1,-1,-1,4,-1
KR_6743087959,420,-3,-29,4,-4,0,1,1,-2,4,2,-1,1,0,-2,5,3,1,1,2,0,-9,-145,-6,-2,8,1,0,0,1,-1,0,1,6,-1
KR_6664064244,420,2,2,-16,5,1,1,2,2,1,3,0,2,2,0,4,4,2,0,2,0,9,7,1,-6,5,-1,0,0,1,-1,-1,1,5,-1
KR_6716817698,420,-2,11,-20,-2,-3,3,0,1,2,3,-3,5,2,2,2,4,1,2,3,1,1,0,0,-3,3,9,0,-1,-1,-1,-1,1,4,-1
KR_6726779087,420,2,17,-2,3,0,2,2,4,2,6,1,4,5,-3,5,2,1,1,2,0,6,-6,3,-6,3,5,0,0,1,-1,0,-1,1,-1
KR_6753531857,420,-5,-23,-63,-7,1,0,1,-2,6,4,-3,4,1,-3,3,0,0,1,1,0,-7,-20,-3,-4,7,3,0,-1,-1,1,-1,-1,3,-1
KR_6686594104,420,-1,-44,3,1,1,1,2,1,3,4,3,0,3,-1,2,1,-3,4,1,0,0,141,2,-6,4,-3,0,-1,1,1,-1,1,3,-1
KR_6763220066,440,-2,-20,-18,0,1,1,2,1,1,2,0,3,3,0,0,0,-2,3,1,0,-2,-12,-4,-6,10,-1,0,-2,-1,-1,-1,1,4,-1
KR_6688375434,440,-2,-33,-32,-7,0,0,0,-3,6,3,-1,2,1,1,2,3,-4,5,1,0,-13,0,6,-10,4,-7,0,-1,1,-1,-1,1,4,-1
KR_6740146293,420,-5,5,-16,-10,0,3,3,-7,7,0,-3,3,0,1,2,3,-1,3,2,0,-16,44,1,-7,6,-26,0,-2,-1,-1,-1,-1,4,-1
KR_6737952485,420,0,7,-10,1,-2,4,2,3,3,6,0,2,2,1,2,3,-1,2,1,0,2,-9,-4,-1,5,4,0,0,-1,-1,0,1,1,-1
KR_6758150931,420,-3,-17,-11,-3,-4,6,2,-1,2,1,-2,2,0,5,2,7,-1,1,0,0,5,-8,-3,-1,4,-2,0,-2,-1,-1,-1,-1,3,-1
KR_6743110480,440,5,21,18,6,2,0,2,2,0,2,-1,5,4,4,5,9,-1,1,0,0,12,3,-1,-6,7,0,0,1,0,-1,1,1,0,-1
KR_6702179080,440,-3,-4,-4,-13,-1,1,0,-4,6,2,-4,5,1,-4,5,1,0,0,0,-1,-14,67,-2,-4,6,1,0,-1,-1,-1,-1,-1,5,-1
KR_6759773365,420,0,-7,12,-4,0,1,1,1,1,2,-6,10,4,2,2,4,-1,1,0,-1,-2,-74,-5,-2,7,25,0,-1,-1,1,-1,-1,2,-1
KR_6280531002,420,-6,-66,-20,-6,1,1,2,-4,7,3,0,1,1,-2,2,0,-1,1,0,0,-6,-2,-1,-6,7,0,0,-1,-1,-1,-1,-1,6,-1
KR_6724574547,440,1,25,-24,2,-4,5,1,1,5,6,1,2,3,3,3,6,1,0,1,0,1,285,-4,-2,6,3,0,2,0,1,1,1,0,-1
KR_6742092548,420,-5,-71,-31,-10,-1,1,0,-6,8,2,-1,1,0,-4,5,1,2,0,2,-2,-15,-34,3,-8,5,-5,0,-2,-1,-1,-1,1,6,-1
KR_6633198776,420,-2,-40,-32,-5,2,1,3,1,4,5,-3,4,1,-4,8,4,-1,2,1,0,2,4,3,-6,3,-8,0,0,1,-1,0,-1,3,-1
KR_6712498548,420,-5,-74,-6,-12,-2,4,2,-1,1,0,-5,8,3,-5,6,1,1,0,1,0,-10,-23,5,-7,2,-4,0,-2,-1,1,-1,1,4,-1
KR_6725529690,420,-4,-126,-8,-8,-3,5,2,0,2,2,-1,1,0,-1,3,2,-3,4,1,0,-1,1,7,-10,3,-2,0,-1,1,1,-1,-1,1,-1
KR_6727165051,420,2,-22,-19,3,-1,2,1,7,1,8,-1,1,0,-4,5,1,2,1,3,0,8,-4,-1,-3,4,-1,0,1,-1,1,-1,-1,4,-1
KR_6764616082,420,-3,-79,-8,-12,-3,3,0,-1,1,0,-9,10,1,2,1,3,-1,2,1,-3,-22,-25,-1,-2,3,1,0,-1,-1,1,-1,-1,4,-1
KR_6650570118,420,1,-29,15,-1,1,0,1,-1,4,3,0,2,2,1,0,1,-2,2,0,0,-5,0,7,-13,6,-4,0,0,1,1,0,-1,3,-1
KR_6765706240,440,-4,-90,-16,-2,2,0,2,-2,2,0,-2,3,1,-3,4,1,3,1,4,1,-1,15,2,-9,7,0,0,-2,0,1,-1,1,0,-1
KR_6685516551,420,-4,-45,0,0,-2,4,2,3,2,5,-2,3,1,4,0,4,-3,3,0,0,0,4,3,-7,4,-2,0,-1,-1,-1,-1,-1,1,-1
KR_6759040469,420,-1,-37,-32,-5,2,0,2,-2,4,2,0,2,2,-5,6,1,0,0,0,0,-9,3,1,-7,6,1,0,-1,-1,-1,-1,1,3,-1
KR_6738366079,420,2,-35,20,7,4,1,5,1,2,3,2,0,2,0,3,3,0,0,0,1,8,-2,0,-8,8,8,0,0,1,-1,0,1,2,-1
KR_6637176957,420,-5,-93,4,-13,-1,1,0,0,4,4,-5,5,0,-6,8,2,-1,2,1,0,-14,-6,-2,-5,7,-2,0,-3,1,1,-1,-1,6,-1
KR_6725148727,420,-5,-1,-12,-12,-9,10,1,-2,3,1,-1,1,0,1,0,1,-1,1,0,0,-3,-4,1,-4,3,4,0,-1,-1,1,-1,-1,6,-1
KR_6760570102,420,-3,-63,-12,-10,-2,5,3,-3,5,2,-3,3,0,1,2,3,-3,7,4,0,-9,3,-2,-2,4,0,0,-2,-1,-1,-1,-1,4,-1
KR_6649771682,420,0,-37,-12,0,-1,3,2,3,1,4,1,1,2,-3,6,3,0,0,0,0,3,0,-1,-5,6,1,0,0,1,1,0,1,3,-1
KR_6765122812,420,-1,10,7,-1,-1,3,2,0,3,3,3,0,3,-2,7,5,-1,1,0,0,3,1,-2,-6,8,-2,0,0,1,-1,0,-1,1,-1
KR_6745397623,420,-4,-30,-18,-9,-9,9,0,-5,5,0,2,1,3,4,0,4,-1,1,0,0,-1,2,-1,-4,5,1,0,0,1,-1,-1,-1,6,-1
KR_6764562804,420,1,-54,-32,4,2,1,3,-1,3,2,0,0,0,5,0,5,-2,5,3,0,1,16,5,-10,5,-3,0,-1,-1,-1,-1,-1,2,-1
KR_6764279081,420,-7,-229,-18,-18,1,2,3,-11,11,0,6,1,7,-13,13,0,-1,2,1,-2,-20,-11,0,-2,2,0,0,-3,-1,1,-1,-1,5,-1
KR_6764258100,440,-7,-78,-1,-18,-6,9,3,1,0,1,-5,7,2,-1,5,4,-7,8,1,2,-6,0,3,-6,3,-1,0,-3,-1,1,-1,1,2,-1
KR_6758756272,420,-1,0,-4,4,5,2,7,1,4,5,1,2,3,-4,4,0,1,0,1,1,5,-154,4,-7,3,-5,0,-1,0,-1,-1,1,0,-1
KR_6721642001,420,-5,-53,-28,-13,-4,4,0,-2,3,1,1,0,1,-8,8,0,0,0,0,-1,-22,-5,2,-7,5,-7,0,-1,-1,1,-1,-1,6,-1
KR_6760861662,440,-3,-33,-24,-4,-2,3,1,-2,3,1,-2,3,1,-1,3,2,3,1,4,0,3,6,7,-9,2,-7,0,-1,-1,1,-1,-1,1,-1
KR_6730358023,420,-4,-93,-1,-6,0,1,1,0,2,2,-3,5,2,-3,5,2,0,0,0,0,0,8,4,-10,6,-1,0,0,-1,-1,-1,-1,1,-1
KR_6749647675,420,-5,-72,-12,-8,-2,2,0,-4,4,0,1,5,6,-3,5,2,0,2,2,1,8,7,4,-6,2,-5,0,1,1,-1,1,1,2,-1
KR_6642889991,420,-2,-62,-2,-11,-4,4,0,0,3,3,-2,2,0,-3,6,3,-2,2,0,-2,-12,0,-2,-5,7,-1,0,-2,1,-1,-1,-1,4,-1
KR_6678164293,420,2,52,12,4,2,1,3,1,2,3,-1,5,4,1,2,3,1,0,1,0,4,-135,-1,-5,6,-2,0,0,-1,1,0,1,2,-1
KR_6705762525,440,3,-96,-2,3,2,1,3,-4,9,5,-2,4,2,8,2,10,-1,1,0,0,8,3,1,-10,9,-1,0,-1,-1,1,-1,-1,4,-1
KR_6697202229,420,-2,-8,-3,-9,0,1,1,0,5,5,-4,5,1,-1,3,2,-4,4,0,1,-3,0,-4,-3,7,0,0,1,1,1,1,1,3,-1
KR_6733159765,420,-1,-16,-4,-4,-3,3,0,0,4,4,1,1,2,-1,2,1,-1,2,1,0,-3,3,2,-6,4,-5,0,0,1,1,0,-1,2,-1
KR_6761742524,420,-2,-43,-38,-5,2,2,4,-2,4,2,0,2,2,-2,4,2,-3,3,0,0,-10,-38,4,-8,4,-1,0,0,0,0,-1,-1,0,-1
KR_6725986673,440,0,-67,-33,0,-1,4,3,-5,6,1,-1,3,2,3,2,5,4,0,4,0,7,-3,-4,-5,9,0,0,-1,1,-1,-1,1,2,-1
KR_6702698771,420,1,36,-24,-2,3,0,3,-3,9,6,-5,5,0,3,1,4,0,1,1,0,0,6,-1,-4,5,-2,0,0,1,-1,0,-1,1,-1
KR_6698171975,420,-5,9,-16,-10,-2,3,1,-5,6,1,-2,2,0,-3,4,1,2,1,3,0,-8,-32,-4,-4,8,2,0,0,1,-1,-1,-1,2,-1
KR_6711431330,420,-3,-50,20,-12,1,0,1,-4,6,2,-1,2,1,-3,4,1,-5,5,0,0,-9,100,-1,-4,5,-3,0,-2,-1,-1,-1,-1,1,-1
KR_6693035867,420,3,3,27,6,-3,4,1,4,0,4,1,3,4,6,0,6,-2,2,0,0,3,11,-1,-6,7,-3,0,0,0,-1,-1,1,0,-1
KR_6764280695,420,-2,-67,10,0,-1,2,1,4,1,5,-1,4,3,1,3,4,-3,4,1,0,1,-39,-1,-4,5,18,0,-1,-1,-1,-1,1,5,-1
KR_6734360812,420,1,-58,16,3,-2,5,3,-1,5,4,1,4,5,4,3,7,1,1,2,1,11,17,0,-4,4,-2,0,-1,1,-1,-1,1,1,-1
KR_6758127349,420,-1,-16,4,-7,-1,1,0,1,1,2,-5,6,1,1,4,5,-3,3,0,0,-10,-12,-6,-2,8,-2,0,-1,1,1,-1,-1,1,-1
KR_6683712022,420,0,-36,20,-2,3,1,4,-2,2,0,-4,4,0,4,1,5,-3,3,0,0,-7,-6,11,-12,1,-6,0,0,1,1,0,1,3,-1
KR_6419111160,420,-5,-54,-21,-5,-8,8,0,1,5,6,3,1,4,0,2,2,-1,1,0,0,-1,-10,-6,-3,9,-3,0,-1,-1,-1,-1,-1,4,-1
KR_6485264718,420,-1,7,-9,-4,0,1,1,-6,8,2,4,2,6,-3,3,0,1,0,1,0,0,-9,-1,-7,8,3,0,0,-1,-1,0,1,1,-1
KR_6736512221,420,-3,-48,32,-15,-3,4,1,-4,7,3,-4,6,2,-3,3,0,-1,1,0,0,-8,6,-1,-4,5,0,0,-2,-1,-1,-1,-1,5,-1
KR_6700551722,420,0,-57,10,0,7,1,8,-4,5,1,-6,8,2,0,3,3,3,0,3,0,4,-13,-1,-4,5,6,0,-1,1,1,-1,1,5,-1
KR_6727727677,420,2,-59,-32,3,4,1,5,-2,5,3,-1,2,1,3,2,5,-1,4,3,0,7,14,3,-4,1,-4,0,-1,-1,-1,-1,-1,3,-1
KR_6703187591,440,5,115,8,8,6,0,6,-2,4,2,1,2,3,-3,3,0,6,0,6,0,2,-1,-1,-2,3,5,0,1,-1,0,1,1,1,-1
KR_6758872930,440,-3,-41,-16,-7,0,0,0,-1,2,1,-4,5,1,-3,5,2,1,0,1,0,-2,-7,-8,-2,10,4,0,-2,-1,-1,-1,-1,4,-1
KR_6713150584,420,-3,-20,-9,-9,-2,3,1,1,0,1,-2,3,1,-1,2,1,-5,5,0,-1,-10,-7,-5,-1,6,-1,0,0,-1,-1,1,-1,5,-1
KR_6761307370,420,-1,-52,15,2,-3,4,1,-3,6,3,1,2,3,3,2,5,4,0,4,0,6,-5,-3,-2,5,2,0,1,1,1,1,1,6,-1
KR_6765126129,420,-1,48,2,-5,-2,3,1,5,0,5,-10,10,0,5,0,5,-3,3,0,1,-3,-16,1,-8,7,-3,0,-2,1,-1,-1,1,6,-1
KR_6655474760,420,-3,-47,-36,-1,-2,2,0,0,1,1,1,4,5,0,2,2,0,0,0,0,-1,5,2,-5,3,-4,0,-1,-1,-1,-1,1,4,-1
KR_6624147938,420,-2,17,-5,0,1,2,3,-3,6,3,3,2,5,-3,4,1,2,2,4,3,-1,-2,-2,-2,4,-5,0,0,-1,1,-1,1,1,-1
KR_6753320604,420,-2,-8,8,-5,1,0,1,-5,5,0,1,2,3,-2,2,0,0,0,0,0,-9,-6,-4,-3,7,2,0,0,0,1,0,-1,0,-1
KR_6729806862,440,-1,-34,-23,-5,-2,5,3,-1,2,1,1,1,2,-3,3,0,0,1,1,0,-3,7,-1,-2,3,0,0,0,-1,1,0,-1,1,-1
KR_6748532389,420,-2,-19,-8,-7,0,1,1,-3,3,0,-4,4,0,-1,2,1,1,0,1,0,-9,-3,-6,-2,8,-3,0,-1,-1,-1,-1,-1,5,-1
KR_6758162935,420,-6,-88,-7,-17,-2,6,4,0,2,2,-2,5,3,-12,12,0,-1,1,0,0,-14,-10,-3,-1,4,-3,0,-2,-1,-1,-1,-1,5,-1
KR_6435326906,420,0,14,-19,-3,3,2,5,2,3,5,-5,5,0,-2,2,0,-1,3,2,0,0,20,-2,-2,4,-5,0,0,1,0,-1,-1,5,-1
KR_6764434398,420,-1,-5,-20,-3,1,0,1,-2,3,1,2,0,2,-1,1,0,-3,4,1,0,-8,0,-2,-2,4,1,0,0,-1,1,0,-1,6,-1
KR_6765968529,440,0,1,8,1,0,0,0,1,1,2,-1,2,1,1,1,2,0,1,1,0,-2,-1,1,-5,4,-5,0,-1,-1,1,-1,-1,1,-1
KR_6764466998,420,-3,-61,8,-11,-4,5,1,0,0,0,-5,5,0,-3,4,1,1,1,2,-2,-5,-71,-1,-4,5,-2,0,0,-1,-1,-1,-1,3,-1
KR_6701697757,420,-4,-34,-34,-7,-3,5,2,1,1,2,-2,4,2,0,3,3,-3,3,0,-1,-5,20,-2,-3,5,-4,0,0,-1,-1,-1,-1,4,-1
KR_6764593514,420,1,-63,34,1,-4,6,2,1,1,2,1,1,2,2,0,2,1,0,1,1,6,5,1,-5,4,2,0,-1,1,1,-1,1,1,-1
KR_6763799233,420,1,-13,-17,2,-2,3,1,0,1,1,3,1,4,1,2,3,0,0,0,0,2,6,-1,-6,7,-1,0,1,0,1,1,-1,0,-1
KR_6728506178,420,-3,-89,-4,-11,-5,7,2,-2,3,1,-1,1,0,-1,4,3,-2,2,0,0,-7,-115,-1,-3,4,-1,0,-3,-1,1,-1,-1,4,-1
KR_6735594378,440,-3,30,8,-7,-5,8,3,-5,6,1,2,0,2,2,2,4,-1,2,1,1,0,20,-5,-3,8,0,0,0,-1,1,-1,1,2,-1
KR_6736741188,420,0,-57,-23,-1,0,0,0,1,0,1,3,2,5,-3,4,1,-2,4,2,0,-3,-6,1,-7,6,1,0,0,-1,1,-1,1,5,-1
KR_6716705521,420,4,28,17,3,6,0,6,2,4,6,-2,3,1,-2,4,2,-1,1,0,0,-3,7,5,-7,2,0,0,-1,-1,1,-1,1,3,-1
KR_6693174453,420,-3,29,20,-4,-1,2,1,0,3,3,-3,5,2,0,3,3,0,0,0,0,-4,1,-2,-2,4,1,0,-1,-1,-1,-1,1,3,-1
KR_6757650831,420,0,-26,7,-4,-2,5,3,-1,3,2,-2,3,1,0,2,2,1,2,3,-1,-7,-81,-4,-1,5,-1,0,-1,1,-1,-1,-1,6,-1
KR_6703148206,420,-2,-13,-16,-10,-2,2,0,-1,1,0,-1,2,1,-4,5,1,-2,2,0,0,-8,34,1,-9,8,-1,0,0,-1,-1,0,-1,5,-1
KR_6618147890,420,-1,-41,-4,0,0,1,1,2,3,5,-5,7,2,-1,4,3,4,1,5,1,4,0,2,-4,2,2,0,-2,1,1,-1,1,1,-1
KR_6598015164,420,-6,-52,21,-16,-7,7,0,-5,6,1,0,0,0,-3,7,4,-1,1,0,0,-16,10,1,-7,6,-2,0,-2,1,1,-1,-1,4,-1
KR_6740956841,420,-2,-36,7,-4,-3,3,0,-1,2,1,2,1,3,-2,4,2,0,1,1,-1,-6,-14,-4,-2,6,3,0,0,1,1,0,-1,5,-1
KR_6698460795,440,0,-32,0,-4,0,0,0,2,3,5,0,2,2,-5,6,1,-1,1,0,0,-3,28,0,-4,4,-4,0,0,-1,1,-1,1,3,-1
KR_6715957758,420,0,-77,-8,4,-2,4,2,1,2,3,0,1,1,5,0,5,0,0,0,0,10,2,1,-3,2,1,0,-1,1,-1,-1,-1,4,-1
KR_6727939943,420,-6,7,-20,-18,0,1,1,0,3,3,-5,6,1,-10,12,2,-3,4,1,0,-17,-11,-1,-4,5,5,0,-1,-1,-1,-1,-1,4,-1
KR_6566944133,440,-4,-31,11,-7,-6,8,2,3,1,4,1,3,4,-6,8,2,1,1,2,-1,-7,14,0,-3,3,-3,0,0,1,-1,-1,-1,4,-1
KR_6649816055,420,-3,-33,-4,-9,-5,5,0,0,3,3,-4,4,0,-1,2,1,1,0,1,-1,-3,-7,-1,-4,5,1,0,0,1,-1,0,-1,5,-1
KR_6671053600,420,-3,5,-40,-2,3,2,5,0,2,2,2,3,5,-2,4,2,-5,5,0,0,-4,-7,4,-5,1,1,0,-1,1,-1,-1,1,2,-1
KR_6708290290,420,-4,2,0,-10,-4,6,2,0,4,4,1,0,1,-4,6,2,-3,4,1,0,-9,3,0,-3,3,-4,0,0,-1,1,0,-1,3,-1
KR_6754535299,420,0,-63,-2,-4,-1,1,0,2,2,4,-1,3,2,-4,5,1,0,1,1,0,3,6,6,-8,2,0,0,0,0,-1,-1,1,0,-1
KR_6712424775,420,-2,-59,-10,-2,2,2,4,-3,6,3,1,3,4,-2,3,1,0,0,0,-1,-4,-6,-2,-5,7,-1,0,-1,0,1,-1,-1,0,-1
KR_6729478790,420,-1,-7,-7,-1,-1,3,2,1,2,3,-1,2,1,1,4,5,-1,2,1,0,1,-7,1,-8,7,1,0,0,-1,-1,-1,-1,5,-1
KR_6740860144,420,-3,-13,0,-8,-1,2,1,-7,9,2,-2,2,0,2,2,4,0,0,0,-1,-5,-12,4,-8,4,3,0,-1,1,-1,-1,-1,3,-1
KR_6747715459,420,-5,-36,-28,-8,-4,4,0,-4,7,3,0,2,2,-2,2,0,2,0,2,0,-5,2,-2,-2,4,-2,0,-2,-1,-1,-1,-1,3,-1
KR_6749774010,420,-2,-26,-21,-6,-2,8,6,-1,2,1,-3,4,1,0,2,2,0,1,1,0,-8,-3,0,-4,4,-3,0,-2,-1,0,-1,1,2,-1
KR_6762657698,420,0,-32,28,-1,-7,7,0,1,1,2,0,0,0,5,0,5,0,1,1,0,3,-102,3,-5,2,-1,0,0,1,-1,0,1,2,-1
KR_6745183290,420,-3,-73,6,-8,-7,7,0,0,2,2,2,0,2,-3,4,1,0,2,2,-1,-5,-24,0,-3,3,-1,0,-1,0,-1,-1,-1,0,-1
KR_6634914296,420,-2,-7,-24,-4,0,2,2,-1,5,4,2,1,3,-7,7,0,2,1,3,-1,-14,-53,4,-9,5,2,0,1,1,1,1,-1,4,-1
KR_6680891596,420,-2,-49,-4,-5,0,3,3,-5,5,0,0,4,4,-1,3,2,1,1,2,-1,-7,22,-3,-5,8,-6,0,-1,1,-1,-1,-1,6,-1
KR_6622463659,420,1,-38,-12,-1,1,1,2,0,3,3,-1,3,2,-1,3,2,0,1,1,0,-7,31,-4,-5,9,-1,0,0,1,1,0,-1,3,-1
KR_6748746003,420,1,71,-14,7,-1,3,2,2,3,5,6,1,7,0,3,3,0,1,1,0,5,0,2,-2,0,0,0,1,-1,-1,-1,1,2,-1
KR_6742932505,420,-2,-9,16,-3,1,1,2,0,0,0,-4,8,4,3,1,4,-3,3,0,0,-6,10,3,-6,3,-3,0,0,1,1,0,1,5,-1
KR_6757940846,420,-1,-5,-13,-3,3,1,4,-2,2,0,-2,4,2,-1,2,1,-1,1,0,0,-7,-7,-2,-5,7,7,0,-1,-1,-1,-1,-1,2,-1
KR_6696981477,420,-3,9,5,-7,3,2,5,-5,8,3,-6,6,0,0,2,2,1,0,1,0,-8,143,-1,-3,4,-2,0,0,-1,0,0,-1,4,-1
KR_6766418589,420,0,-2,12,1,3,1,4,-1,2,1,-2,3,1,0,3,3,1,0,1,0,-4,-4,-7,-2,9,-4,0,0,1,-1,1,1,4,-1
KR_6698209847,420,-3,-56,0,-2,-2,4,2,-2,5,3,3,2,5,-1,4,3,0,1,1,-1,3,-14,0,-3,3,3,0,-1,-1,1,-1,-1,3,-1
KR_6758779289,420,0,-12,35,0,-3,7,4,0,0,0,0,1,1,4,0,4,-1,1,0,0,4,6,-1,-4,5,1,0,-2,1,-1,-1,-1,6,-1
KR_6628982671,420,0,36,-14,0,4,1,5,0,3,3,2,0,2,-5,7,2,-1,1,0,0,-5,2,4,-7,3,2,0,0,1,0,-1,1,4,-1
KR_6697557087,420,-3,-87,17,-4,1,0,1,2,1,3,-1,1,0,-2,2,0,-4,4,0,0,-4,-43,3,-7,4,-2,0,-1,0,-1,-1,-1,0,-1
KR_6766438565,440,-4,-70,-40,0,1,2,3,0,2,2,-1,2,1,-1,6,5,1,0,1,0,6,25,2,-3,1,-1,0,-1,-1,1,-1,1,4,-1
KR_6762115908,420,-1,-28,12,-3,-1,6,5,-1,4,3,-6,10,4,2,6,8,3,0,3,-1,-13,-9,-2,-2,4,5,0,0,-1,1,-1,-1,6,-1
KR_6275104789,420,-1,39,29,-11,-3,3,0,1,0,1,-2,2,0,-3,5,2,-4,5,1,0,-6,-7,-3,-7,10,3,0,-1,1,-1,-1,-1,6,-1
KR_6755197617,420,2,14,17,5,0,1,1,-3,4,1,0,0,0,8,0,8,0,0,0,1,8,56,2,-4,2,-3,0,1,1,-1,1,1,6,-1
KR_6555655143,420,0,-52,-23,0,-2,2,0,-3,3,0,1,1,2,1,1,2,3,0,3,0,3,6,3,-8,5,-3,0,0,-1,-1,-1,-1,6,-1
KR_6749148662,420,-1,1,-15,-6,-4,5,1,-6,7,1,0,2,2,6,3,9,-2,3,1,1,2,-6,-4,-5,9,4,0,-3,-1,-1,-1,1,5,-1
KR_6746199766,440,4,41,26,4,1,0,1,-3,4,1,-1,3,2,1,2,3,6,0,6,0,-1,15,6,-10,4,-1,0,2,1,1,1,-1,5,-1
KR_6740403452,420,4,83,-8,5,1,0,1,0,1,1,-2,3,1,7,0,7,-1,3,2,0,0,-13,-2,-2,4,1,0,3,-1,1,1,1,3,-1
KR_6743977564,420,-1,-77,8,-2,3,1,4,-1,4,3,1,1,2,-6,8,2,1,1,2,1,-2,13,1,-7,6,0,0,0,-1,1,-1,1,2,-1
KR_6679459268,420,0,-9,-4,-1,-2,2,0,-3,5,2,2,1,3,1,4,5,1,0,1,0,-2,-25,0,-6,6,4,0,0,-1,1,0,-1,6,-1
KR_6680124880,420,-1,26,-20,-4,2,2,4,4,2,6,-4,5,1,0,2,2,-6,7,1,1,-5,-5,1,-7,6,-3,0,1,-1,1,1,1,2,-1
KR_6758069111,420,0,-23,-4,-5,0,1,1,-4,5,1,1,6,7,-2,2,0,0,2,2,0,-7,10,-3,0,3,-1,0,0,0,1,0,-1,0,-1
KR_6761531924,420,0,-21,34,-6,5,0,5,1,0,1,-2,4,2,-10,11,1,0,0,0,0,-21,-8,0,-7,7,1,0,0,1,1,1,-1,6,-1
KR_6758843237,420,-3,4,-17,-1,0,1,1,-4,4,0,-2,4,2,4,0,4,1,0,1,0,-7,0,2,-3,1,1,0,0,-1,1,0,1,6,-1
KR_6766545487,420,-3,-32,-26,-6,0,0,0,-1,2,1,1,1,2,-7,8,1,1,1,2,0,-9,7,1,-6,5,-1,0,0,-1,1,0,-1,1,-1
KR_6686940736,420,1,40,22,-1,1,1,2,-2,4,2,0,3,3,0,4,4,0,0,0,0,-14,-155,-1,-7,8,7,0,0,-1,-1,0,1,3,-1
KR_6692962212,440,0,5,0,3,5,2,7,5,0,5,-5,6,1,-1,2,1,-1,2,1,0,10,6,1,-7,6,0,0,0,0,-1,1,-1,0,-1
KR_6738495293,420,4,68,16,5,2,3,5,-2,5,3,7,2,9,-1,2,1,-1,1,0,-1,2,-3,-2,-4,6,-1,0,2,0,1,1,-1,0,-1
KR_6722792524,420,-5,-60,-30,-8,-3,3,0,-3,3,0,-4,4,0,0,3,3,2,7,9,0,-8,-13,-5,-1,6,2,0,-2,1,-1,-1,-1,1,-1
KR_6763169162,440,-5,-31,-16,-12,-4,6,2,0,3,3,2,0,2,-9,12,3,-1,3,2,0,-13,-11,0,-1,1,-1,0,-3,0,0,-1,-1,0,-1
KR_6734639711,440,-3,27,-16,-4,1,1,2,0,4,4,1,2,3,-3,3,0,-3,4,1,0,-4,-30,0,-3,3,9,0,-1,-1,1,1,-1,6,-1
KR_6611550223,420,-2,-3,16,-7,0,0,0,-1,1,0,-2,2,0,-4,5,1,0,1,1,0,-7,180,-3,-5,8,-1,0,1,-1,1,1,-1,4,-1
KR_6272719929,420,-3,-30,0,-7,-6,6,0,-6,7,1,2,3,5,3,0,3,0,1,1,0,-6,5,2,-6,4,-10,0,-2,-1,-1,-1,-1,3,-1
KR_6749433270,420,-1,13,-16,-4,-2,2,0,2,3,5,-2,2,0,1,2,3,-3,4,1,0,-7,-23,0,-4,4,1,0,-1,1,-1,-1,1,1,-1
KR_6762162261,420,1,-35,28,-3,0,2,2,-1,1,0,0,1,1,-1,2,1,-1,1,0,0,-2,1,2,-6,4,-5,0,0,1,-1,1,-1,6,-1
KR_6715423472,420,-4,-111,-3,-6,0,2,2,-2,2,0,0,3,3,-3,6,3,-1,2,1,0,-5,-4,-3,-2,5,0,0,0,1,1,1,1,2,-1
KR_6723909268,420,-4,-2,8,-8,-1,2,1,3,2,5,-4,4,0,-3,4,1,-3,3,0,0,-7,-36,-5,-3,8,13,0,-1,1,-1,-1,1,3,-1
KR_6751178152,420,1,61,-63,-1,-3,5,2,2,2,4,-3,5,2,0,1,1,3,0,3,-1,7,36,1,-6,5,0,0,0,-1,1,0,-1,5,-1
KR_6766298671,420,3,36,11,6,4,1,5,2,0,2,1,0,1,-2,2,0,1,0,1,0,8,0,-1,-5,6,0,0,-1,0,-1,-1,-1,0,-1
KR_6762637317,420,-2,-28,-8,-5,1,4,5,0,4,4,-1,3,2,-5,7,2,0,1,1,1,1,-3,2,-6,4,-2,0,-1,1,1,-1,1,2,-1
KR_6755951378,420,-4,-52,-14,-5,0,2,2,-4,5,1,-2,3,1,-1,7,6,2,0,2,-3,-10,-10,-1,-3,4,0,0,-3,-1,-1,-1,-1,6,-1
KR_6760172920,420,1,49,14,4,2,3,5,-3,5,2,0,2,2,4,0,4,1,1,2,0,-6,6,2,-4,2,-2,0,4,0,1,1,-1,0,-1
KR_6705756327,420,-4,-127,6,-7,-6,6,0,0,3,3,-4,6,2,0,2,2,3,0,3,0,2,-8,1,-4,3,-2,0,-2,1,0,-1,-1,4,-1
KR_6648720099,420,-2,-73,33,-6,1,1,2,1,2,3,-5,5,0,-2,5,3,-1,1,0,0,-9,-2,3,-8,5,-6,0,0,0,-1,-1,-1,0,-1
KR_6760681596,440,-4,-74,15,-9,-2,3,1,-5,6,1,-4,4,0,2,1,3,0,1,1,-1,-8,-9,-2,-2,4,2,0,-2,-1,1,-1,-1,2,-1
KR_6756192462,440,-3,25,-8,-8,-1,4,3,-2,2,0,1,3,4,0,3,3,-6,7,1,-1,-10,-61,-1,-3,4,0,0,-1,0,0,-1,-1,0,-1
KR_6702965916,420,-2,21,-28,-7,-3,4,1,-2,2,0,-6,6,0,5,1,6,-1,1,0,0,-14,-7,-6,-5,11,-2,0,0,-1,-1,0,1,4,-1
KR_6727993383,420,-5,-72,8,-9,-6,7,1,-3,9,6,-1,3,2,-3,5,2,4,0,4,1,-9,2,-2,-2,4,2,0,-1,-1,1,1,1,2,-1
KR_6649153969,420,1,-8,-22,1,-1,4,3,0,3,3,0,5,5,2,0,2,0,1,1,0,5,91,-5,-5,10,2,0,0,-1,-1,-1,1,1,-1
KR_6760153908,420,2,-16,-4,0,1,0,1,1,2,3,-2,5,3,-1,4,3,1,1,2,0,3,-40,0,-4,4,8,0,-1,1,-1,-1,-1,5,-1
KR_6760307978,420,-1,2,-6,-7,0,2,2,-2,4,2,1,1,2,-5,7,2,-1,2,1,1,-11,1,-3,-4,7,-5,0,-2,1,-1,-1,1,6,-1
KR_6752711405,420,-6,-106,-13,-19,-3,5,2,-2,3,1,-1,2,1,-13,15,2,0,1,1,0,-19,-4,-1,-5,6,-4,0,-2,-1,1,-1,-1,5,-1
KR_6743744712,440,-2,-13,-28,-4,3,0,3,-3,4,1,-3,3,0,-1,2,1,0,3,3,0,-10,4,-2,-2,4,-3,0,-1,-1,-1,-1,-1,2,-1
KR_6270254909,420,0,13,-14,-3,1,1,2,0,2,2,1,5,6,-5,7,2,0,2,2,0,-5,19,-3,-3,6,-2,0,0,-1,1,0,-1,2,-1
KR_6760858466,420,0,3,-12,-4,0,1,1,-4,4,0,-1,6,5,2,2,4,-1,1,0,1,-1,8,4,-6,2,-4,0,0,1,-1,-1,1,2,-1
KR_6688726887,420,2,-17,0,8,2,0,2,3,4,7,5,1,6,-3,3,0,1,0,1,0,6,11,5,-8,3,0,0,-1,1,1,-1,1,3,-1
KR_6731549216,420,-4,-15,-28,-8,-4,4,0,0,1,1,0,2,2,-4,5,1,0,0,0,0,-3,0,2,-4,2,-3,0,-3,-1,-1,-1,1,4,-1
KR_6690114234,420,-3,-24,-4,-5,0,1,1,-1,5,4,-3,4,1,0,3,3,-1,2,1,0,-11,229,-1,-6,7,0,0,0,1,1,0,-1,6,-1
KR_6759682168,420,0,-36,24,5,2,1,3,5,4,9,2,1,3,-5,8,3,1,2,3,2,14,25,2,-6,4,3,0,1,-1,1,1,1,2,-1
KR_6619985547,420,-1,44,-19,-7,0,2,2,-3,4,1,-1,5,4,-3,4,1,0,1,1,0,-14,-2,-6,-1,7,-1,0,0,-1,-1,0,1,5,-1
KR_6731511032,440,-3,7,40,-7,-1,3,2,0,4,4,-3,3,0,-4,6,2,1,0,1,0,-9,6,1,-4,3,-1,0,1,-1,1,1,-1,4,-1
KR_6708510168,420,0,43,-17,-3,-2,3,1,-2,4,2,-1,3,2,2,1,3,0,2,2,0,-1,-22,4,-7,3,0,0,-1,1,-1,-1,-1,4,-1
KR_6755723818,420,-3,8,-41,-7,5,0,5,-4,5,1,-3,3,0,-2,3,1,-3,3,0,-1,-13,-2,1,-4,3,1,0,0,-1,0,0,-1,1,-1
KR_6763192048,420,1,19,9,0,0,3,3,0,3,3,-3,3,0,1,1,2,2,1,3,0,0,4,2,-7,5,1,0,1,-1,1,1,1,1,-1
KR_6603048183,420,-5,5,-3,-18,-2,2,0,-3,4,1,-3,5,2,-6,6,0,-4,6,2,0,-20,1,-1,-2,3,-1,0,-2,-1,-1,-1,-1,6,-1
KR_6728416965,440,-1,-111,8,-2,1,1,2,0,2,2,0,1,1,-1,2,1,-2,3,1,0,-5,4,0,-4,4,-6,0,0,-1,1,0,-1,6,-1
KR_6610573431,420,-2,-31,3,2,1,2,3,0,4,4,-1,1,0,1,2,3,1,1,2,1,4,-50,0,-5,5,14,0,0,1,-1,1,1,3,-1
KR_6753077072,420,-2,-24,-15,-6,2,2,4,3,0,3,-8,10,2,-1,3,2,-2,2,0,-2,-14,-14,-3,-4,7,-8,0,0,-1,-1,0,-1,1,-1
KR_6762903000,420,-1,-20,-8,-3,-1,2,1,2,0,2,-1,2,1,-1,1,0,-2,2,0,0,-1,-5,-5,-2,7,-1,0,0,-1,1,0,-1,6,-1
KR_6766161366,420,-2,12,5,-3,-4,6,2,-2,4,2,-2,4,2,6,1,7,-1,1,0,0,-4,4,-2,-2,4,-2,0,0,-1,0,0,1,3,-1
KR_6716811236,420,-4,-77,3,-14,-5,5,0,0,2,2,-2,2,0,0,3,3,-7,8,1,-1,-22,111,-4,-2,6,-6,0,-1,-1,-1,-1,-1,2,-1
KR_6728554629,420,-5,-12,-40,-11,1,1,2,-3,4,1,-3,3,0,-5,5,0,-1,1,0,0,-15,-8,0,-6,6,-3,0,-1,-1,1,-1,-1,5,-1
KR_6732600889,440,1,-45,0,0,1,3,4,-6,7,1,-2,2,0,-1,3,2,8,1,9,0,4,0,-3,-1,4,0,0,-1,-1,-1,-1,-1,6,-1
KR_6746946742,420,-1,-2,5,-8,-1,2,1,2,3,5,0,2,2,-8,11,3,-1,1,0,0,-10,-5,0,-5,5,-3,0,-1,-1,0,-1,-1,2,-1
KR_6744002953,420,-1,-9,-14,0,0,1,1,-3,5,2,-2,2,0,5,0,5,0,2,2,0,3,1,3,-7,4,-6,0,1,1,-1,1,1,3,-1
KR_6574485495,420,-1,-26,-8,-3,5,0,5,0,2,2,-2,2,0,-4,4,0,-2,3,1,0,2,-4,-1,-5,6,0,0,0,-1,1,-1,1,6,-1
KR_6761916824,440,2,17,9,6,0,2,2,-1,3,2,2,0,2,4,1,5,1,1,2,0,2,0,0,-3,3,-3,0,0,1,-1,1,-1,3,-1
KR_6700684177,420,-2,-16,17,-9,-1,1,0,-3,5,2,-1,3,2,-2,2,0,-2,2,0,0,-8,6,0,-3,3,0,0,0,1,1,1,-1,2,-1
KR_6675622464,420,-3,-22,32,-5,1,1,2,-6,7,1,0,2,2,0,4,4,0,0,0,0,-8,15,7,-9,2,1,0,0,0,0,0,-1,0,-1
KR_6632598820,420,-2,-57,22,-1,-4,4,0,2,0,2,4,0,4,-3,3,0,0,2,2,0,4,2,-3,-3,6,-4,0,-2,-1,-1,-1,-1,1,-1
KR_6760558282,420,-1,-37,20,0,2,0,2,1,4,5,-2,4,2,-1,1,0,0,1,1,0,-10,3,2,-5,3,-1,0,1,0,1,1,1,0,-1
KR_6747354291,440,4,69,-4,8,0,2,2,7,0,7,1,2,3,-2,4,2,2,0,2,0,1,-9,0,-5,5,2,0,1,1,-1,1,-1,6,-1
KR_6717502209,420,-5,-21,-9,-6,-2,2,0,-1,1,0,-1,3,2,-2,3,1,0,0,0,0,-4,5,-1,-4,5,-1,0,0,-1,-1,0,-1,2,-1
KR_6725315612,420,-1,22,35,1,-3,5,2,5,3,8,-2,3,1,2,3,5,-1,1,0,-2,1,-180,7,-10,3,-13,0,0,-1,-1,-1,-1,2,-1
KR_6705670022,420,-7,-103,-11,-17,0,1,1,-8,13,5,-3,3,0,-3,4,1,-3,4,1,0,-17,6,-1,-3,4,-8,0,-1,-1,1,-1,-1,4,-1
KR_6741962930,420,5,53,35,6,6,1,7,2,0,2,3,2,5,-6,6,0,1,0,1,0,-5,12,8,-8,0,-2,0,3,-1,1,1,1,5,-1
KR_6740284762,440,-2,40,-6,-8,-1,2,1,-1,7,6,-1,2,1,-5,5,0,0,1,1,0,-6,-17,5,-6,1,-5,0,0,0,-1,0,1,0,-1
KR_6750923526,440,3,-6,8,2,0,2,2,0,2,2,6,0,6,0,3,3,-4,4,0,-1,0,-4,-2,-1,3,3,0,-1,1,0,-1,-1,1,-1
KR_6724347081,420,1,30,8,3,2,1,3,-3,6,3,-1,4,3,1,0,1,4,2,6,0,0,-43,3,-4,1,31,0,0,1,-1,0,-1,6,-1
KR_6676697533,420,0,-7,-20,3,0,4,4,1,1,2,0,3,3,3,4,7,-1,1,0,0,1,8,-2,-6,8,-4,0,-3,-1,-1,-1,1,1,-1
KR_6762539378,420,3,49,34,3,2,1,3,2,3,5,-1,3,2,2,0,2,-2,4,2,0,7,37,0,-5,5,0,0,1,1,-1,1,1,4,-1
KR_6633449940,420,-3,-87,16,-10,2,1,3,-2,2,0,-3,3,0,-6,6,0,-1,1,0,-1,-21,7,1,-3,2,-4,0,-1,-1,1,-1,-1,4,-1
KR_6749755665,420,-1,-18,0,1,3,0,3,3,3,6,-3,3,0,-2,6,4,0,5,5,0,-3,-109,1,-5,4,2,0,-1,-1,1,-1,1,4,-1
KR_6759503200,420,-3,-35,-25,-7,0,1,1,-3,4,1,0,2,2,-3,4,1,-1,1,0,-1,-17,1,2,-7,5,-2,0,-1,-1,-1,-1,-1,3,-1
KR_6763873931,420,1,33,12,-1,0,2,2,0,1,1,1,1,2,0,2,2,-2,2,0,0,-5,0,2,-6,4,3,0,0,-1,1,1,-1,3,-1
KR_6750015477,420,-3,-32,-23,-3,2,1,3,-5,7,2,-3,3,0,1,3,4,2,2,4,1,-4,-21,-4,-2,6,6,0,0,1,-1,1,1,2,-1
KR_6716615814,420,1,-43,8,1,0,4,4,-1,2,1,5,1,6,-2,4,2,-1,1,0,-3,-6,-6,3,-5,2,-1,0,-1,-1,1,-1,-1,6,-1
KR_6760370250,420,-3,-6,12,-9,-4,4,0,2,3,5,-2,3,1,-4,4,0,-1,1,0,1,-10,25,-4,-3,7,-3,0,0,-1,1,0,1,3,-1
KR_6758236180,440,-2,-70,9,-3,-4,5,1,1,1,2,0,1,1,4,1,5,-4,5,1,0,2,-18,-5,-3,8,1,0,-2,-1,1,-1,-1,1,-1
KR_6763910548,420,1,-7,4,2,-1,1,0,-3,3,0,4,0,4,4,1,5,-2,3,1,0,2,2,5,-6,1,-3,0,1,-1,1,1,1,4,-1
KR_6749458041,420,1,38,11,-4,0,3,3,-1,4,3,-4,6,2,1,0,1,0,0,0,0,3,-369,4,-6,2,1,0,1,-1,1,1,-1,5,-1
KR_6617672099,420,-1,-5,16,-3,-1,2,1,3,1,4,-5,5,0,-1,2,1,1,0,1,0,0,0,-1,-4,5,-1,0,0,1,1,0,-1,5,-1
KR_6742014607,420,2,6,-24,6,-1,2,1,-1,4,3,2,0,2,3,1,4,3,0,3,-1,11,-6,-1,-9,10,6,0,0,1,1,0,-1,5,-1
KR_6758631752,420,-3,-17,-33,-12,0,3,3,-7,9,2,0,4,4,-4,5,1,-1,1,0,0,1,23,-2,-5,7,4,0,-1,-1,1,1,-1,4,-1
KR_6683116376,420,3,0,0,12,2,2,4,0,4,4,3,5,8,4,2,6,3,2,5,0,8,0,2,-10,8,3,0,0,1,-1,0,1,4,-1
KR_6760522152,420,2,18,50,2,3,2,5,-3,4,1,-1,2,1,3,3,6,0,0,0,0,1,-126,1,-4,3,0,0,-1,1,-1,-1,1,6,-1
KR_6746604952,420,-2,-55,0,-7,-3,4,1,-6,9,3,0,3,3,3,0,3,-1,2,1,-1,-17,-6,0,-5,5,1,0,-1,-1,1,-1,-1,2,-1
KR_6706880331,420,0,12,12,5,0,1,1,2,3,5,1,0,1,2,2,4,0,0,0,0,10,7,1,-6,5,-4,0,0,1,1,0,1,4,-1
KR_6756274198,420,1,47,2,5,1,1,2,2,2,4,0,2,2,0,7,7,2,0,2,0,-1,-16,1,-6,5,4,0,1,0,1,1,1,0,-1
KR_6759517370,420,3,45,21,7,0,3,3,0,2,2,1,1,2,3,0,3,3,2,5,0,6,0,1,-7,6,4,0,0,1,-1,-1,1,5,-1
KR_6726325163,420,-7,-75,1,-16,-7,7,0,-1,4,3,-4,4,0,-3,6,3,-1,1,0,0,-13,34,-1,-5,6,-7,0,-3,1,-1,-1,1,6,-1
KR_6765536285,420,-2,-83,19,0,-1,1,0,1,5,6,0,2,2,0,2,2,0,2,2,-1,-6,-11,2,-5,3,-6,0,0,0,1,-1,-1,0,-1
KR_6759647234,420,-7,-94,-41,-11,-2,2,0,-1,1,0,-3,4,1,-3,7,4,-2,3,1,0,-14,-6,2,-7,5,-5,0,-2,-1,1,-1,1,3,-1
KR_6744574365,420,-2,-33,-4,-1,-3,5,2,8,2,10,-5,8,3,0,2,2,-1,1,0,0,-6,-4,-2,-5,7,-6,0,0,1,1,0,1,3,-1
KR_6689949320,420,-1,-32,17,-1,-3,4,1,0,1,1,4,1,5,1,0,1,-3,3,0,0,1,-6,-2,-4,6,2,0,-1,1,-1,-1,1,6,-1
KR_6601705234,420,-2,-29,-1,-1,4,0,4,-1,2,1,-2,3,1,-2,3,1,0,0,0,0,-2,-47,5,-14,9,-1,0,0,1,-1,-1,-1,2,-1
KR_6764869775,420,-1,-45,-6,-4,1,3,4,-5,5,0,3,2,5,-3,4,1,0,2,2,0,-13,-212,0,-6,6,-6,0,2,-1,1,1,-1,1,-1
KR_6644467462,420,-4,-39,-40,-9,-2,3,1,-2,4,2,-1,5,4,-4,6,2,0,0,0,0,-3,-14,0,-7,7,-3,0,0,-1,0,-1,-1,6,-1
KR_6717648211,420,-5,-82,11,-6,-5,5,0,2,1,3,2,1,3,-4,11,7,-1,1,0,0,-7,-2,-2,-4,6,-3,0,-1,-1,0,-1,1,3,-1
KR_6763777835,420,-3,-58,-8,-12,-4,5,1,-1,2,1,1,2,3,-7,7,0,-1,2,1,-1,-17,-14,-11,-1,12,1,0,0,-1,-1,-1,-1,4,-1
KR_6645397831,420,-2,-64,11,-1,-1,4,3,2,1,3,5,1,6,-6,6,0,-1,1,0,0,-2,-1,5,-12,7,-1,0,-2,1,1,-1,-1,4,-1
KR_6750691315,420,-1,-40,-22,-6,2,0,2,-3,4,1,-2,4,2,-6,10,4,3,4,7,0,-5,111,5,-9,4,-5,0,1,-1,1,-1,-1,4,-1
KR_6760045269,420,-2,15,-32,-1,-4,5,1,-1,4,3,2,1,3,2,1,3,0,1,1,0,-7,-2,-5,-3,8,0,0,-1,-1,-1,-1,1,2,-1
KR_6491892115,420,-2,-41,4,-2,-3,3,0,1,1,2,-1,3,2,3,2,5,-2,2,0,0,6,0,1,-7,6,3,0,0,-1,-1,0,1,2,-1
KR_6700592558,420,2,-24,20,6,2,0,2,3,0,3,-2,3,1,0,3,3,3,0,3,0,6,6,3,-5,2,-1,0,0,0,1,1,1,0,-1
KR_6764041573,440,-1,18,4,0,-1,1,0,-5,6,1,2,3,5,-2,2,0,6,0,6,0,-1,-2,-4,-3,7,3,0,0,1,-1,-1,1,3,-1
KR_6696010084,420,-5,-63,-26,-14,-6,7,1,-2,3,1,-5,5,0,-2,4,2,1,2,3,0,-8,-353,2,-8,6,3,0,0,-1,-1,0,-1,1,-1
KR_6766181531,420,-3,-10,-10,0,5,0,5,-2,3,1,-3,7,4,2,0,2,-2,3,1,-1,3,12,3,-8,5,-1,0,-2,0,-1,-1,-1,0,-1
KR_6756147506,420,1,-35,-3,-1,-4,6,2,-2,4,2,-5,6,1,8,0,8,2,1,3,0,5,0,0,-7,7,7,0,-2,1,-1,-1,-1,6,-1
KR_6654561458,440,0,1,10,3,1,0,1,0,3,3,1,1,2,2,2,4,-1,1,0,0,1,-6,0,-5,5,-2,0,-2,1,-1,-1,1,6,-1
KR_6735329263,420,1,-30,-13,1,0,0,0,0,1,1,-6,6,0,4,1,5,3,0,3,0,6,-24,-1,-5,6,16,0,-1,-1,-1,-1,1,3,-1
KR_6756119830,420,-2,-27,24,-1,0,2,2,0,2,2,-2,4,2,1,2,3,0,0,0,0,-2,19,-2,-2,4,-3,0,0,1,-1,0,-1,4,-1
KR_6746875396,420,3,67,15,4,-7,7,0,5,2,7,7,1,8,0,4,4,-1,1,0,0,9,7,-2,-3,5,4,0,0,-1,-1,-1,-1,4,-1
KR_6659328576,420,-1,-61,-38,4,1,2,3,0,5,5,-1,2,1,3,0,3,1,0,1,1,5,0,4,-9,5,4,0,0,-1,-1,-1,1,6,-1
KR_6760388634,420,1,-10,3,-1,-1,2,1,-2,3,1,2,1,3,-2,8,6,2,0,2,-2,-2,265,4,-9,5,0,0,0,-1,0,1,-1,2,-1
KR_6651183427,420,0,23,17,-2,0,0,0,4,2,6,-3,3,0,-3,4,1,0,0,0,0,-1,2,3,-6,3,-3,0,0,1,1,0,-1,1,-1
KR_6678875425,420,2,-18,16,0,-2,2,0,2,1,3,-2,2,0,1,2,3,1,0,1,0,-2,8,-1,-8,9,-3,0,-1,1,1,-1,-1,6,-1
KR_6766207881,420,-2,-39,-4,-6,0,1,1,-2,3,1,0,2,2,-1,2,1,-3,3,0,0,0,-8,-3,-3,6,-2,0,0,0,1,0,-1,0,-1
KR_6272692124,420,-1,-39,3,-5,-2,2,0,-3,3,0,-2,4,2,3,0,3,-1,2,1,0,0,-18,1,-5,4,-5,0,-1,1,-1,-1,-1,6,-1
KR_6725559096,420,-2,-82,-16,-1,3,1,4,9,0,9,-6,6,0,-6,6,0,-1,1,0,0,-5,-64,-2,-4,6,23,0,-1,-1,-1,-1,-1,1,-1
KR_6656945144,420,-3,-12,7,-1,-1,3,2,0,3,3,-2,3,1,3,1,4,-1,1,0,0,5,-38,-3,-4,7,25,0,-1,-1,1,-1,1,6,-1
KR_6765512449,420,2,1,11,6,2,1,3,1,1,2,2,2,4,-1,5,4,2,0,2,0,0,-9,-2,-5,7,5,0,3,1,1,1,1,3,-1
KR_6672368522,420,-5,-20,-48,-11,0,0,0,-5,8,3,-4,4,0,0,5,5,-2,2,0,0,-7,155,4,-5,1,-2,0,-1,-1,-1,-1,1,2,-1
KR_6764319420,420,0,-58,8,-6,-4,8,4,-1,2,1,-1,5,4,-1,3,2,1,1,2,0,-9,2,2,-8,6,-4,0,-2,-1,-1,-1,-1,6,-1
KR_6601312632,420,1,87,35,6,-2,2,0,3,1,4,4,0,4,0,2,2,1,0,1,0,5,-11,1,-6,5,0,0,1,1,1,1,-1,6,-1
KR_6725991478,420,-4,-31,7,-5,-1,1,0,-3,3,0,1,1,2,-3,7,4,1,0,1,1,-2,-124,-3,-4,7,2,0,0,1,-1,0,1,1,-1
KR_6656510849,420,-2,-7,-12,-7,-2,2,0,-4,5,1,0,2,2,-2,4,2,1,1,2,0,-6,-5,2,-7,5,1,0,0,-1,0,0,1,4,-1
KR_6764961394,420,2,10,-12,4,3,1,4,0,5,5,0,2,2,0,3,3,1,0,1,0,-2,-5,-1,-3,4,0,0,-1,1,-1,-1,-1,1,-1
KR_6703404561,420,2,45,25,3,0,2,2,-2,3,1,4,1,5,1,2,3,0,2,2,0,1,-4,0,-8,8,-2,0,-1,-1,-1,-1,-1,6,-1
KR_6724467431,440,0,26,1,0,4,0,4,-4,5,1,2,1,3,-3,5,2,1,0,1,0,-4,-2,2,-4,2,1,0,0,0,-1,1,1,0,-1
KR_6762569386,420,0,-26,-3,-4,1,1,2,-2,4,2,-5,6,1,0,2,2,2,0,2,0,-4,7,-2,-4,6,-2,0,-1,-1,1,-1,1,6,-1
KR_6757689390,420,0,-32,-2,5,0,2,2,2,5,7,1,2,3,6,3,9,-4,4,0,-1,5,58,-1,-4,5,7,0,-1,1,1,1,-1,3,-1
KR_6563576325,420,-3,-14,-48,-3,-1,4,3,0,5,5,-1,4,3,0,6,6,-1,1,0,-1,0,-3,7,-10,3,-2,0,-2,-1,-1,-1,-1,4,-1
KR_6646980541,420,-6,-53,13,-12,-2,7,5,-1,3,2,-2,2,0,-7,7,0,0,2,2,-1,-11,1,-1,-7,8,-6,0,-2,-1,1,-1,-1,2,-1
KR_6761452071,420,-4,-51,-4,-6,2,4,6,-1,2,1,-5,6,1,-3,5,2,1,1,2,0,-6,1,1,-6,5,3,0,-1,0,1,-1,1,0,-1
KR_6760922695,420,0,4,-5,0,0,2,2,9,0,9,-5,5,0,-3,4,1,-1,2,1,0,8,35,2,-5,3,-3,0,0,-1,1,-1,1,5,-1
KR_6367220166,440,-12,-94,-42,-23,0,0,0,-13,13,0,-4,4,0,-7,8,1,1,1,2,-1,-28,0,0,0,0,-3,0,-1,1,0,-1,-1,4,-1
KR_6729959277,420,-5,-99,-12,-13,-1,1,0,-5,6,1,-2,2,0,-4,4,0,-1,2,1,0,-12,-112,-3,-2,5,-2,0,-1,-1,1,-1,-1,4,-1
KR_6753144477,420,-3,-7,-6,2,1,3,4,2,3,5,5,2,7,-6,6,0,0,0,0,1,-3,9,1,-3,2,-2,0,0,1,1,1,1,3,-1
KR_6761070120,420,2,-11,8,2,2,1,3,0,5,5,-1,3,2,-3,4,1,4,0,4,0,2,-39,1,-6,5,24,0,0,-1,1,1,1,5,-1
KR_6762094808,420,-3,-28,-5,-7,-3,4,1,-3,4,1,4,2,6,-1,3,2,-4,4,0,-1,-4,1,-1,-5,6,-4,0,-1,1,1,-1,-1,4,-1
KR_6746308566,420,-4,-65,18,-16,-2,2,0,-4,5,1,-3,6,3,-6,6,0,-1,2,1,1,-24,2,-1,-2,3,-4,0,-2,0,1,-1,1,0,-1
KR_6602959895,420,-4,-57,7,-13,-3,3,0,-2,4,2,-5,5,0,-3,4,1,0,0,0,0,-13,-23,-1,-4,5,1,0,0,-1,0,-1,-1,1,-1
KR_6750075633,420,0,-11,12,1,2,3,5,-2,3,1,-2,2,0,1,2,3,2,2,4,0,1,16,-3,-4,7,4,0,0,-1,1,0,1,5,-1
KR_6735908969,420,-3,20,-1,-4,-5,5,0,0,3,3,-2,4,2,1,0,1,2,0,2,0,-4,90,-4,-3,7,5,0,0,1,1,0,-1,5,-1
KR_6740853941,440,-6,-73,8,-17,-3,5,2,-3,5,2,0,2,2,-12,12,0,1,1,2,0,-7,16,4,-7,3,-3,0,-2,-1,1,-1,-1,3,-1
KR_6763760833,420,-5,0,-7,-8,0,5,5,-4,6,2,5,1,6,-5,5,0,-4,5,1,0,-8,-4,3,-7,4,-1,0,-1,1,-1,-1,-1,6,-1
KR_6728689400,420,-2,2,-23,-4,-3,3,0,-7,7,0,3,2,5,3,1,4,0,1,1,0,-1,-29,-3,0,3,2,0,0,-1,1,-1,-1,5,-1
KR_6764326794,420,-2,-23,-10,-6,-5,6,1,-3,7,4,0,0,0,2,0,2,0,2,2,0,-1,39,-3,-2,5,-19,0,-1,1,-1,-1,1,6,-1
KR_6597752210,420,-5,-57,20,-5,-1,3,2,-1,3,2,-3,4,1,0,3,3,0,1,1,0,-2,-15,-5,-5,10,2,0,-1,1,-1,-1,-1,1,-1
KR_6733836368,420,-1,-55,4,-3,4,0,4,-6,6,0,0,2,2,-1,3,2,0,0,0,0,-3,16,3,-7,4,-5,0,-1,1,1,-1,-1,1,-1
KR_6681891190,420,-1,33,-43,4,3,0,3,2,5,7,-3,4,1,1,1,2,1,0,1,0,3,14,6,-8,2,-1,0,-1,-1,-1,-1,1,2,-1
KR_6666299043,420,-1,-23,4,4,-1,2,1,1,3,4,-1,2,1,7,3,10,-2,2,0,2,15,4,0,-5,5,-1,0,-1,-1,1,-1,1,2,-1
KR_6762668159,420,-2,-49,32,-8,-1,1,0,3,4,7,1,2,3,-5,5,0,-6,6,0,0,-8,119,5,-9,4,-6,0,-1,-1,-1,-1,-1,4,-1
KR_6765724693,420,0,-39,32,-3,-2,3,1,-3,3,0,-1,3,2,1,1,2,2,0,2,0,1,-19,1,-7,6,3,0,0,1,0,0,1,2,-1
KR_6727123738,420,-4,-126,-28,-8,-6,6,0,-1,2,1,-3,4,1,-1,4,3,3,0,3,0,-1,-5,-3,0,3,2,0,-3,-1,0,-1,-1,2,-1
KR_6684436519,420,-1,-13,-17,-4,1,2,3,-3,3,0,-2,6,4,0,3,3,0,1,1,0,-2,-2,0,-4,4,-2,0,-2,-1,1,-1,1,1,-1
KR_6757779336,420,-2,-19,-15,-4,-6,6,0,-1,2,1,4,1,5,2,3,5,-3,3,0,-1,-6,-4,2,-6,4,2,0,-1,1,-1,-1,-1,4,-1
KR_6760612063,420,-2,-4,-12,1,-4,5,1,0,3,3,2,3,5,1,1,2,2,1,3,0,1,9,2,-3,1,2,0,1,-1,0,1,1,2,-1
KR_6754488336,440,-6,-50,7,-15,0,0,0,0,0,0,-3,8,5,-9,11,2,-3,3,0,-2,-10,40,1,-4,3,-2,0,-1,0,1,-1,-1,0,-1
KR_6681415604,440,-4,-12,-8,-11,-3,3,0,5,0,5,-7,7,0,1,0,1,-7,8,1,0,-5,4,0,-5,5,0,0,-1,0,1,-1,-1,0,-1
KR_6741912647,420,-4,-58,-2,-15,-2,2,0,-4,4,0,-2,2,0,-6,7,1,-1,4,3,-2,-22,9,-2,-5,7,-7,0,-1,1,1,-1,-1,1,-1
KR_6728236088,440,-5,-23,4,-9,-3,5,2,-2,4,2,-4,5,1,-1,3,2,1,1,2,0,0,2,3,-6,3,-2,0,-2,-1,-1,-1,-1,1,-1
KR_6755595685,420,2,21,-40,3,0,0,0,-1,3,2,4,1,5,-1,4,3,1,2,3,-1,-5,5,0,-5,5,2,0,0,-1,-1,0,-1,4,-1
KR_6682196453,420,0,20,1,0,0,1,1,-3,5,2,0,3,3,1,4,5,2,1,3,0,-5,3,-2,-5,7,-1,0,0,-1,1,0,-1,6,-1
KR_6739887169,420,-3,-10,1,-3,1,0,1,-4,5,1,-1,2,1,2,2,4,-1,4,3,0,-7,-7,0,-6,6,1,0,0,-1,1,0,-1,5,-1
KR_6757914711,420,0,-14,-23,2,0,2,2,1,4,5,0,3,3,0,3,3,1,2,3,0,-1,67,2,-7,5,-3,0,0,-1,-1,1,1,2,-1
KR_6601839685,420,-4,-19,20,-10,-1,3,2,1,3,4,-7,8,1,-3,3,0,0,0,0,0,-4,-37,-5,-5,10,2,0,-1,-1,1,-1,-1,4,-1
KR_6724558705,420,0,-43,16,-3,-1,4,3,-4,6,2,-4,4,0,4,0,4,2,0,2,1,-3,69,5,-7,2,-2,0,0,-1,-1,-1,1,5,-1
KR_6633157163,420,-3,-20,13,-3,0,2,2,1,0,1,-4,4,0,2,2,4,-2,3,1,-1,-6,2,1,-8,7,-6,0,-1,1,1,-1,-1,1,-1
KR_6702875523,420,-3,-22,-4,1,1,1,2,2,1,3,-2,2,0,-1,2,1,1,0,1,0,-2,27,0,-7,7,-1,0,0,-1,-1,0,-1,1,-1
KR_6761752404,440,0,-78,31,-5,2,0,2,-9,9,0,0,4,4,2,0,2,0,1,1,0,-6,-4,-5,-4,9,-1,0,-1,-1,1,-1,1,3,-1
KR_6761447539,420,-5,-66,-35,-11,-2,4,2,-8,9,1,-1,2,1,-1,3,2,1,1,2,-1,-2,-33,-3,-3,6,2,0,-1,-1,-1,-1,-1,4,-1
KR_6758802064,420,2,-27,0,10,4,1,5,-1,6,5,3,0,3,2,2,4,2,0,2,0,17,-160,3,-9,6,-3,0,-1,1,-1,-1,1,5,-1
KR_6751245872,420,-5,-83,-8,-16,-4,5,1,-3,7,4,-2,3,1,-6,7,1,-1,2,1,-1,-21,-2,4,-7,3,-5,0,1,-1,1,1,-1,3,-1
KR_6751993558,420,-1,14,-26,-5,3,0,3,5,1,6,-1,3,2,-9,9,0,-3,4,1,0,-15,47,0,-5,5,-21,0,0,-1,1,-1,-1,4,-1
KR_6706309393,420,-4,-51,-38,-4,-7,7,0,3,2,5,-1,1,0,1,2,3,0,0,0,0,11,-33,-5,-5,10,6,0,-1,-1,-1,-1,-1,2,-1
KR_6725327211,420,0,6,13,-7,1,0,1,-4,5,1,2,3,5,-5,5,0,-1,1,0,0,-16,0,-6,-5,11,4,0,-1,1,1,-1,-1,3,-1
KR_6756297436,420,-3,-17,-20,-7,2,2,4,1,2,3,2,3,5,-12,13,1,0,0,0,0,-6,-8,2,-7,5,-5,0,-2,-1,-1,-1,-1,4,-1
KR_6723152476,420,-5,-48,-3,-9,-10,10,0,-2,3,1,3,2,5,0,4,4,0,1,1,0,1,23,4,-7,3,0,0,-2,-1,-1,-1,-1,4,-1
KR_6765562968,420,-2,-14,-12,-3,3,0,3,-3,5,2,-4,6,2,2,1,3,-1,2,1,0,-3,1,1,-8,7,0,0,0,1,-1,-1,-1,4,-1
KR_6706796720,420,-5,-49,-4,-6,0,0,0,-2,5,3,-1,3,2,-1,2,1,-2,6,4,1,-10,27,2,-7,5,-1,0,0,1,1,1,1,3,-1
KR_6760467857,420,4,2,29,11,0,2,2,2,1,3,6,1,7,1,1,2,2,0,2,0,10,-3,0,-4,4,7,0,2,-1,1,1,1,5,-1
KR_6761328426,420,-3,1,-17,1,-5,5,0,2,3,5,0,1,1,3,0,3,1,0,1,0,8,-35,-2,-3,5,4,0,0,1,0,0,-1,6,-1
KR_6765627349,440,-4,46,-8,-9,1,0,1,1,2,3,-6,6,0,-2,2,0,-3,3,0,0,-6,-58,-2,-6,8,-6,0,0,-1,-1,0,-1,6,-1
KR_6753751697,420,0,26,-25,1,0,2,2,-2,4,2,1,2,3,0,4,4,2,1,3,0,-5,0,2,-4,2,0,0,1,-1,-1,1,-1,3,-1
KR_6749968804,420,2,0,45,3,-1,1,0,2,0,2,1,3,4,-1,3,2,2,0,2,0,4,1,-1,-4,5,5,0,0,0,-1,0,1,0,-1
KR_6687256139,420,-3,18,5,-10,-3,3,0,-1,2,1,-4,4,0,1,2,3,-3,5,2,0,-8,-6,-2,-4,6,1,0,0,-1,-1,-1,-1,4,-1
KR_6743342786,440,0,17,-8,0,3,0,3,4,0,4,-4,4,0,1,1,2,-4,6,2,0,4,0,3,-9,6,4,0,0,1,-1,0,1,1,-1
KR_6751899684,420,-5,-45,19,-6,-1,2,1,-5,7,2,0,2,2,-3,5,2,3,1,4,0,-6,-78,2,-6,4,-2,0,0,-1,1,0,-1,4,-1
KR_6732198432,420,2,30,8,7,5,2,7,-4,7,3,6,1,7,2,3,5,-2,3,1,3,4,0,5,-8,3,5,0,0,-1,1,1,1,2,-1
KR_6762944618,420,-6,-40,-28,-9,0,0,0,-8,9,1,-2,2,0,0,4,4,1,0,1,0,-6,-7,1,-4,3,0,0,-1,-1,-1,-1,1,2,-1
KR_6757860701,420,0,38,-21,0,3,1,4,1,0,1,0,1,1,1,1,2,-5,5,0,0,-1,-170,1,-3,2,4,0,0,1,-1,0,1,1,-1
KR_6749695807,420,-2,4,-8,-6,-1,3,2,4,1,5,-4,5,1,-5,8,3,0,0,0,0,-2,46,1,-6,5,-23,0,-1,0,0,-1,1,0,-1
KR_6716365477,420,-2,-66,-6,-2,0,0,0,-2,4,2,2,0,2,0,1,1,-2,2,0,0,-2,-22,-3,-4,7,2,0,-1,1,-1,-1,-1,5,-1
KR_6734129739,420,-2,-55,-13,0,4,2,6,-6,6,0,1,2,3,1,0,1,0,2,2,0,-3,21,3,-8,5,-3,0,-2,1,-1,-1,1,4,-1
KR_6759980677,420,-2,-30,-28,-3,7,0,7,-1,7,6,-7,7,0,-1,3,2,-1,1,0,0,-6,0,7,-8,1,0,0,-2,-1,-1,-1,1,3,-1
KR_6761028384,420,-4,-109,-4,1,-2,3,1,3,1,4,1,0,1,0,2,2,-1,2,1,0,0,34,-2,-4,6,5,0,0,0,1,-1,1,0,-1
KR_6727159579,420,3,9,16,1,0,1,1,-2,3,1,3,0,3,1,1,2,-1,1,0,0,-1,4,0,-4,4,0,0,0,1,-1,0,-1,4,-1
KR_6761839540,420,-4,-106,-21,-3,-2,3,1,2,1,3,-3,3,0,0,1,1,0,1,1,0,-2,42,-4,-5,9,-5,0,-1,1,-1,-1,-1,5,-1
KR_6744035601,420,-2,-51,2,-10,-1,4,3,-4,5,1,-2,5,3,-3,6,3,0,2,2,0,-4,-25,-5,-3,8,-1,0,-1,0,0,-1,1,0,-1
KR_6761253903,420,1,-29,8,5,-1,4,3,5,2,7,-1,2,1,1,3,4,1,0,1,0,10,-2,0,-7,7,3,0,-1,-1,1,-1,1,3,-1
KR_6718167109,420,1,24,-11,-1,1,1,2,-4,5,1,-1,2,1,3,0,3,0,1,1,0,1,-12,-2,-4,6,9,0,1,-1,-1,1,1,5,-1
KR_6757441521,420,4,92,15,15,2,1,3,3,0,3,1,3,4,5,2,7,4,0,4,1,15,7,4,-7,3,-4,0,2,1,1,1,1,3,-1
KR_6753234458,420,0,2,1,3,1,1,2,-1,2,1,0,1,1,-1,1,0,4,2,6,0,3,-29,-2,-8,10,1,0,-2,-1,-1,-1,1,4,-1
KR_6764065931,420,-1,32,-45,0,-8,8,0,2,2,4,1,1,2,1,3,4,4,1,5,1,4,-113,-3,-3,6,5,0,-3,-1,-1,-1,1,4,-1
KR_6760744187,420,-3,-43,-43,-9,-1,3,2,-4,6,2,-3,5,2,0,4,4,-1,2,1,1,-6,34,2,-5,3,-18,0,0,-1,-1,-1,-1,2,-1
KR_6752602990,420,1,10,-20,-3,-1,3,2,2,2,4,-1,5,4,0,0,0,-3,3,0,0,3,33,-4,-3,7,-17,0,0,-1,-1,1,-1,1,-1
KR_6764821206,420,-1,11,-20,-8,-2,2,0,-2,2,0,1,1,2,-4,7,3,-1,1,0,0,-12,-4,0,-7,7,4,0,0,-1,-1,-1,-1,1,-1
KR_6748247672,420,-1,-10,-24,0,0,0,0,2,4,6,-6,6,0,1,2,3,3,0,3,0,0,170,4,-6,2,-26,0,0,-1,-1,-1,1,2,-1
KR_6690548810,420,-4,20,-4,-5,1,1,2,0,6,6,-1,3,2,-3,4,1,-2,2,0,0,-12,-3,0,-5,5,-3,0,0,-1,1,1,1,5,-1
KR_6761377130,420,-2,-19,6,-3,-2,2,0,1,3,4,1,4,5,-5,6,1,2,1,3,0,-1,3,2,-5,3,-4,0,0,1,-1,-1,-1,5,-1
KR_6729295646,420,-3,-48,-18,-11,-6,7,1,1,2,3,-4,6,2,-2,4,2,0,2,2,-3,-6,-29,1,-5,4,-3,0,-3,-1,-1,-1,-1,2,-1
KR_6744192883,420,-1,10,46,-2,-2,3,1,0,2,2,-1,3,2,1,1,2,0,1,1,1,4,26,0,-6,6,-4,0,0,0,1,1,1,0,-1
KR_6738905225,420,1,-20,6,4,1,0,1,-1,3,2,3,1,4,0,3,3,1,0,1,0,3,7,-1,-4,5,-6,0,-1,1,-1,-1,-1,5,-1
KR_6743912347,440,-4,-10,-36,-8,-4,4,0,0,1,1,1,0,1,-3,5,2,-2,2,0,0,-11,7,3,-7,4,-2,0,0,-1,1,0,1,4,-1
KR_6766082446,420,-1,-14,37,-3,0,1,1,1,2,3,-6,7,1,1,1,2,1,0,1,0,1,0,2,-6,4,-1,0,-1,1,-1,1,1,4,-1
KR_6764646607,420,-4,-33,-24,-1,0,2,2,-6,8,2,0,3,3,3,0,3,2,0,2,0,2,10,0,-6,6,-2,0,-1,-1,-1,-1,1,6,-1
KR_6707631698,420,-2,-86,-33,-11,-1,2,1,-2,3,1,-5,5,0,-5,7,2,2,0,2,0,-9,-37,0,-5,5,28,0,-2,-1,-1,-1,1,1,-1
KR_6753616005,440,-2,-94,-25,-7,5,0,5,-2,3,1,-4,4,0,-9,9,0,3,0,3,-1,-6,3,-3,-5,8,-4,0,1,-1,1,1,-1,4,-1
KR_6698795146,420,-1,-9,-10,-10,0,5,5,-5,6,1,-4,4,0,0,3,3,-1,4,3,-2,-19,-34,-2,-3,5,-2,0,-2,-1,-1,-1,-1,4,-1
KR_6687478354,420,0,-54,8,3,-1,3,2,1,4,5,3,1,4,4,0,4,-4,6,2,1,14,-3,0,-6,6,2,0,0,-1,1,0,-1,2,-1
KR_6729968101,420,-2,-25,0,-2,-1,1,0,-4,4,0,0,3,3,2,2,4,1,0,1,-1,-2,3,-2,-5,7,-2,0,0,1,-1,0,-1,1,-1
KR_6763236902,420,-3,-58,29,-8,-5,7,2,3,2,5,-6,6,0,1,5,6,-1,1,0,0,-4,-8,-4,-4,8,-2,0,0,1,1,-1,-1,1,-1
KR_6722643319,440,-1,-12,-15,-1,1,0,1,-1,4,3,-5,6,1,1,2,3,3,0,3,0,-5,15,2,-5,3,-17,0,0,1,-1,0,1,3,-1
KR_6658077457,420,5,-29,35,4,3,0,3,-7,7,0,5,1,6,3,1,4,0,0,0,0,9,-26,-5,-5,10,2,0,0,1,1,-1,1,3,-1
KR_6525837325,420,2,66,-24,1,1,1,2,-1,1,0,-1,1,0,0,2,2,2,0,2,0,-1,-129,-3,-4,7,-5,0,0,-1,-1,0,-1,5,-1
KR_6670254687,420,-7,-73,-23,-20,-2,4,2,-5,6,1,-8,9,1,-7,8,1,2,2,4,-4,-19,1,-2,-3,5,-5,0,-1,-1,-1,-1,-1,3,-1
KR_6712567365,440,-3,-101,10,0,3,3,6,-2,3,1,0,2,2,2,3,5,-3,3,0,0,4,0,4,-5,1,-2,0,-2,0,-1,-1,1,0,-1
KR_6692972103,420,3,-47,11,12,1,1,2,1,3,4,5,2,7,2,2,4,3,1,4,0,13,8,3,-6,3,-2,0,0,1,1,0,1,2,-1
KR_6764750146,420,0,-1,-47,1,0,1,1,1,0,1,-2,4,2,2,4,6,0,0,0,1,1,116,2,-7,5,17,0,0,1,1,1,1,2,-1
KR_6765546486,420,-1,-24,-5,-14,-2,4,2,-4,4,0,-2,2,0,-5,6,1,-1,1,0,-1,-13,139,-3,-6,9,2,0,0,-1,-1,0,-1,1,-1
KR_6747911041,420,1,74,1,-2,0,1,1,0,4,4,0,1,1,-2,3,1,0,0,0,0,-4,-7,-6,-3,9,6,0,1,-1,1,1,1,5,-1
KR_6763613893,440,-6,-83,-4,-16,-7,8,1,-7,9,2,-5,6,1,1,1,2,2,0,2,0,-15,12,-1,-2,3,-1,0,-1,0,0,-1,1,0,-1
KR_6763039696,420,-7,22,-43,-11,1,2,3,0,2,2,-1,4,3,-9,9,0,-2,3,1,-1,-12,-9,0,-3,3,-1,0,-3,0,-1,-1,-1,0,-1
KR_6758582895,420,-2,-12,24,-6,-3,5,2,-1,3,2,0,2,2,-2,3,1,0,1,1,0,-11,3,2,-7,5,-2,0,0,1,1,0,-1,4,-1
KR_6762458528,420,-2,-11,-5,-3,1,0,1,1,1,2,2,2,4,-8,10,2,1,0,1,0,-3,3,-1,-2,3,-4,0,0,0,1,0,-1,0,-1
KR_6755945749,420,-4,-67,-7,-13,-2,2,0,-2,3,1,-4,5,1,-3,5,2,-2,2,0,0,-22,-1,-1,-4,5,-1,0,0,0,-1,0,-1,0,-1
KR_6729030362,420,1,32,0,5,-4,7,3,7,0,7,0,3,3,0,3,3,2,1,3,0,10,-8,0,-7,7,0,0,0,-1,1,1,1,1,-1
KR_6757597551,440,-4,-49,-54,-13,-4,4,0,-2,5,3,-4,7,3,-4,5,1,1,1,2,0,-13,-14,-5,0,5,-1,0,0,0,-1,-1,-1,0,-1
KR_6760363353,440,-6,-87,-26,-10,-3,3,0,-3,6,3,-3,8,5,1,3,4,-2,2,0,-2,-8,-286,0,-3,3,-2,0,-2,-1,-1,-1,-1,4,-1
KR_6674583780,420,2,15,2,1,-3,3,0,0,2,2,-4,4,0,6,0,6,2,0,2,1,4,5,3,-10,7,-2,0,2,1,1,1,1,2,-1
KR_6729786237,420,-5,-33,-22,-6,-1,2,1,-2,5,3,1,1,2,-3,6,3,-1,1,0,0,-6,-4,-3,-3,6,-5,0,0,1,-1,-1,-1,3,-1
KR_6753360047,420,-2,-67,-32,-7,-2,3,1,-4,5,1,-4,5,1,1,3,4,2,0,2,1,2,-4,0,-4,4,0,0,0,-1,0,0,1,6,-1
KR_6764164303,420,1,-24,-2,-2,-2,3,1,1,0,1,1,2,3,0,3,3,-2,3,1,0,-8,1,-2,-3,5,2,0,0,1,-1,0,1,6,-1
KR_6658679275,420,1,6,-1,-1,-2,2,0,1,3,4,0,0,0,0,4,4,0,2,2,0,-3,-3,-3,-8,11,0,0,-1,-1,1,-1,1,2,-1
KR_6703052838,420,0,-30,19,-1,-6,6,0,3,0,3,1,5,6,4,1,5,-3,5,2,0,-2,-21,3,-8,5,0,0,-2,-1,-1,-1,1,6,-1
KR_6758844571,420,-2,-2,-12,-10,-4,6,2,1,2,3,-1,2,1,-1,4,3,-5,5,0,0,-7,-54,0,-3,3,-2,0,-2,-1,-1,-1,-1,4,-1
KR_6710147307,440,-5,-56,-38,-10,2,2,4,-6,6,0,-1,4,3,-3,3,0,-2,2,0,0,-13,294,-4,-2,6,2,0,-2,-1,-1,-1,1,3,-1
KR_6739637703,420,-5,-23,12,-12,-3,3,0,-3,3,0,-2,2,0,-1,2,1,-3,4,1,-1,-13,7,0,-4,4,-2,0,0,-1,1,0,-1,1,-1
KR_6741607234,420,0,52,-13,-6,1,1,2,-2,3,1,0,4,4,-4,4,0,-1,1,0,0,-5,-48,-2,-3,5,4,0,1,-1,1,1,-1,2,-1
KR_6761455452,420,1,46,-8,-3,-1,2,1,-2,5,3,-1,3,2,-1,1,0,2,0,2,0,-9,28,2,-6,4,-3,0,1,-1,1,1,1,2,-1
KR_6677930327,420,-2,-79,-17,-6,-2,2,0,1,2,3,-3,3,0,-2,5,3,0,0,0,0,0,-9,-4,-4,8,-1,0,0,-1,1,0,-1,2,-1
KR_6765877857,420,0,-46,8,4,-1,2,1,1,2,3,3,1,4,0,3,3,1,0,1,0,7,7,2,-7,5,-1,0,2,1,1,1,1,5,-1
KR_6724817898,420,-4,-74,2,-15,-1,4,3,-2,3,1,-1,2,1,-7,8,1,-4,4,0,0,-20,21,0,-7,7,-6,0,-2,-1,-1,-1,-1,3,-1
KR_6719448802,420,-2,-20,17,-4,-1,2,1,0,3,3,-1,2,1,-2,4,2,0,0,0,0,-5,0,1,-6,5,-8,0,0,0,0,-1,1,0,-1
KR_6752923555,420,0,-12,-8,0,5,0,5,-2,3,1,3,2,5,-7,13,6,1,2,3,0,-1,8,0,-6,6,2,0,-1,-1,1,1,-1,1,-1
KR_6761541844,420,0,-52,-16,-5,1,1,2,1,3,4,0,2,2,-5,5,0,-2,2,0,0,-7,5,0,-5,5,-2,0,-1,-1,-1,-1,-1,2,-1
KR_6764344519,420,-1,5,-16,1,-2,2,0,3,0,3,2,0,2,-2,3,1,0,0,0,0,3,206,5,-7,2,-1,0,-1,1,1,-1,1,6,-1
KR_6722186513,420,-7,-112,-28,-12,-9,10,1,0,3,3,-6,7,1,1,0,1,2,0,2,0,-8,-109,-2,-5,7,1,0,-2,-1,0,-1,-1,1,-1
KR_6597879550,420,-1,11,3,0,1,1,2,-2,2,0,0,6,6,0,3,3,1,0,1,0,-6,22,0,-8,8,1,0,1,1,1,1,-1,6,-1
KR_6658973377,420,-1,52,4,-1,-2,2,0,0,2,2,2,1,3,1,2,3,-2,3,1,1,-2,4,5,-7,2,1,0,0,1,-1,0,1,3,-1
KR_6760438396,420,1,8,10,-4,0,2,2,-1,6,5,-1,4,3,-2,3,1,0,1,1,0,-5,-4,-5,-3,8,0,0,1,-1,1,-1,-1,1,-1
KR_6753795020,420,0,-10,-8,4,-2,4,2,2,4,6,-1,1,0,3,0,3,2,0,2,0,13,14,0,-7,7,-3,0,1,1,1,1,-1,3,-1
KR_6742468395,420,-1,-17,-1,-2,-1,2,1,0,1,1,1,1,2,-2,2,0,0,0,0,0,-1,-21,2,-7,5,-3,0,-1,1,1,-1,1,4,-1
KR_6760681455,420,-1,-60,-17,3,2,1,3,2,1,3,0,4,4,-1,3,2,0,1,1,0,8,7,-3,-2,5,0,0,0,0,1,0,-1,0,-1
KR_6734868890,420,3,46,21,0,6,0,6,-6,6,0,-2,3,1,2,1,3,0,1,1,1,-5,3,3,-10,7,-2,0,2,-1,1,1,1,3,-1
KR_6750963631,420,-2,-29,-24,-2,-5,6,1,2,0,2,3,0,3,-1,2,1,-1,1,0,-1,-5,-3,2,-6,4,1,0,-1,0,-1,-1,-1,0,-1
KR_6760732271,420,-1,-2,-12,-5,-2,3,1,0,1,1,-2,3,1,-3,5,2,2,0,2,0,-9,-1,-2,-6,8,1,0,0,-1,-1,0,-1,4,-1
KR_6646717467,420,-1,-33,20,1,0,1,1,0,6,6,3,1,4,-2,6,4,0,1,1,0,-5,-7,1,-7,6,2,0,0,1,-1,0,1,4,-1
KR_6713741063,420,2,28,-36,7,0,1,1,-2,2,0,0,1,1,9,1,10,0,3,3,0,9,25,4,-8,4,0,0,1,1,-1,1,-1,3,-1
KR_6656391262,420,-1,-30,-8,-7,-4,5,1,-2,4,2,-6,9,3,4,2,6,1,0,1,1,-3,-9,-8,-2,10,3,0,-1,-1,-1,-1,1,3,-1
KR_6760035456,420,1,34,-21,-4,-2,3,1,-2,3,1,-3,5,2,5,4,9,-2,2,0,0,-9,4,4,-7,3,-2,0,1,-1,0,1,-1,5,-1
KR_6765529225,420,0,-12,-20,2,1,1,2,3,1,4,5,1,6,-5,6,1,-2,2,0,0,-4,0,-3,-5,8,1,0,0,-1,1,0,-1,5,-1
KR_6763010836,420,-7,-97,-20,-9,-2,2,0,-3,4,1,0,2,2,-5,7,2,1,0,1,0,-7,-6,0,-3,3,-2,0,-2,-1,-1,-1,1,6,-1
KR_6756226278,440,-5,-66,-4,-23,-5,5,0,4,1,5,-11,11,0,-6,7,1,-5,6,1,0,-12,8,2,-4,2,-4,0,-3,-1,-1,-1,-1,5,-1
KR_6762079563,420,-1,-35,-39,2,3,1,4,0,3,3,-1,1,0,3,0,3,-3,3,0,0,1,0,0,-5,5,-3,0,0,-1,-1,0,1,5,-1
KR_6744021256,420,-1,49,-4,-2,-3,4,1,-2,2,0,2,0,2,4,2,6,-3,3,0,0,-8,-55,3,-8,5,-1,0,0,-1,-1,-1,1,1,-1
KR_6731333095,420,-4,-35,-28,-4,-4,6,2,2,2,4,-2,6,4,-2,3,1,2,0,2,1,2,-21,-8,-1,9,0,0,-1,-1,-1,-1,1,6,-1
KR_6748783109,420,-1,-23,4,2,3,1,4,-5,6,1,7,0,7,-3,3,0,0,0,0,0,1,-7,-1,-3,4,1,0,1,-1,-1,1,1,2,-1
KR_6763799680,420,1,14,-18,8,1,1,2,2,1,3,2,1,3,1,3,4,2,0,2,1,11,5,-2,-6,8,1,0,0,1,-1,1,1,5,-1
KR_6748643520,420,2,-6,32,5,4,1,5,4,3,7,-1,2,1,0,2,2,-2,5,3,1,8,15,-3,-5,8,0,0,1,-1,1,1,1,3,-1
KR_6755250652,420,-5,-57,-20,-8,1,2,3,1,3,4,-6,9,3,-3,3,0,-1,1,0,-1,-20,34,-2,-1,3,-4,0,-1,-1,0,-1,-1,4,-1
KR_6760926195,440,2,63,-10,3,-1,1,0,2,1,3,1,1,2,3,2,5,-2,4,2,0,2,-1,-5,-2,7,3,0,1,1,-1,1,1,4,-1
KR_6760077116,420,2,21,-12,4,-2,2,0,0,4,4,5,1,6,1,3,4,0,0,0,0,2,12,-7,-4,11,-1,0,0,-1,-1,0,1,5,-1
KR_6765593268,420,-1,27,-9,-4,-3,6,3,3,2,5,0,4,4,-1,2,1,-3,3,0,0,1,5,2,-5,3,2,0,0,1,-1,0,-1,1,-1
KR_6759370914,420,-2,-36,7,-6,-1,4,3,-1,3,2,-1,2,1,-2,5,3,-1,2,1,0,-7,-19,4,-9,5,6,0,-2,-1,-1,-1,-1,4,-1
KR_6653100583,420,2,42,-18,3,4,1,5,-4,5,1,-1,2,1,3,3,6,1,0,1,1,-1,-2,0,-4,4,0,0,0,0,-1,0,1,0,-1
KR_6762604161,420,-1,-35,-11,3,-3,3,0,3,0,3,-2,2,0,4,1,5,1,0,1,1,8,-142,1,-4,3,-3,0,0,-1,1,0,1,2,-1
KR_6729207733,420,-1,-64,-11,-5,1,1,2,-5,10,5,1,1,2,-1,4,3,-1,1,0,-1,-8,32,0,-9,9,-1,0,0,-1,1,0,-1,5,-1
KR_6655018992,420,0,-62,-9,4,2,2,4,2,1,3,-2,3,1,2,2,4,0,0,0,0,6,-1,-3,-1,4,1,0,0,-1,-1,-1,-1,6,-1
KR_6737825879,420,-1,0,4,-4,-1,3,2,-2,5,3,-1,2,1,-3,9,6,3,2,5,0,-1,-6,5,-8,3,4,0,0,-1,0,0,1,1,-1
KR_6761774233,420,-5,-21,-34,-9,-1,1,0,-1,4,3,-8,9,1,1,1,2,0,0,0,0,-7,5,0,-4,4,-2,0,1,-1,-1,-1,-1,2,-1
KR_6055850558,420,5,33,15,17,4,0,4,7,3,10,-2,3,1,9,0,9,-1,1,0,0,9,-14,2,-6,4,2,0,1,1,1,1,1,2,-1
KR_6630004639,420,-3,-37,-6,-4,1,2,3,-3,5,2,-1,2,1,-1,2,1,0,0,0,0,1,5,-3,-4,7,-5,0,0,-1,1,0,1,2,-1
KR_6743758051,440,1,70,-4,2,0,1,1,1,3,4,0,3,3,0,4,4,1,1,2,0,-3,-77,1,-5,4,-18,0,0,-1,0,0,-1,4,-1
KR_6758847489,420,0,34,-24,-4,3,0,3,-6,8,2,1,1,2,-4,8,4,2,1,3,0,1,-18,-4,-4,8,-1,0,1,1,0,1,1,6,-1
KR_6763493526,420,1,29,-8,-1,3,0,3,-1,2,1,-3,3,0,1,3,4,-1,2,1,0,-3,2,2,-7,5,-6,0,0,-1,1,0,1,6,-1
KR_6684448767,420,-3,-19,-12,-8,1,1,2,-5,6,1,-6,6,0,-2,3,1,4,0,4,0,-11,262,-3,-3,6,0,0,-1,-1,0,-1,-1,4,-1
KR_6750182283,420,-2,-13,-4,-10,1,2,3,-1,2,1,-6,7,1,-2,4,2,-2,2,0,0,-14,-13,-7,-1,8,1,0,1,-1,-1,1,-1,2,-1
KR_6724603824,420,-3,-30,2,-6,0,1,1,-2,5,3,2,0,2,-3,3,0,-3,4,1,0,-10,-7,-2,-6,8,4,0,-1,-1,0,-1,-1,6,-1
KR_6723689155,420,-8,-68,-40,-23,-6,7,1,-6,6,0,-6,6,0,-5,6,1,0,1,1,-1,-20,2,2,-5,3,-1,0,-2,-1,-1,-1,-1,4,-1
KR_6663711165,420,0,-54,-41,-6,0,2,2,1,2,3,-2,5,3,-2,3,1,-3,5,2,0,3,-1,3,-8,5,-2,0,-2,-1,-1,-1,-1,2,-1
KR_6744824502,420,-1,-68,37,3,0,2,2,-3,4,1,2,2,4,3,1,4,1,1,2,1,11,-8,-1,-2,3,3,0,1,-1,1,1,1,5,-1
KR_6615288576,420,3,41,4,0,-1,2,1,-6,7,1,-3,5,2,3,0,3,7,1,8,0,-2,12,-2,-5,7,1,0,1,1,1,1,-1,5,-1
KR_6656355034,420,1,31,18,-2,0,1,1,-4,4,0,1,3,4,-3,4,1,4,0,4,0,-6,7,-1,-5,6,5,0,1,-1,1,1,1,6,-1
KR_6667564824,420,0,40,-3,-2,0,0,0,-3,5,2,1,0,1,-1,2,1,1,0,1,0,-3,-8,-2,-5,7,6,0,0,-1,-1,0,-1,1,-1
KR_6753923317,420,-2,31,2,-4,0,2,2,-1,3,2,-3,6,3,-3,6,3,3,0,3,1,-12,329,2,-6,4,-2,0,1,-1,1,1,1,5,-1
KR_6740459592,420,-6,-19,-51,-14,-10,11,1,-5,5,0,-3,4,1,4,2,6,0,1,1,0,1,-8,-2,-2,4,-3,-1,-4,-1,-1,-1,-1,1,-1
KR_6746024367,420,-4,-113,-13,-16,-7,7,0,0,1,1,-3,8,5,-2,2,0,-4,4,0,0,-7,0,-3,0,3,-3,0,-1,-1,-1,-1,-1,2,-1
KR_6763578717,420,3,-7,12,1,-2,2,0,-1,4,3,4,1,5,-1,5,4,1,1,2,0,4,-4,6,-10,4,5,0,-1,1,-1,-1,-1,6,-1
KR_6683816238,420,-2,-80,-32,-2,-3,4,1,1,5,6,-1,1,0,1,5,6,0,1,1,2,7,-22,-2,-3,5,-1,0,-1,-1,1,-1,1,2,-1
KR_6680922678,420,0,1,-19,4,-1,1,0,-2,4,2,5,1,6,4,1,5,-2,2,0,0,9,42,4,-7,3,-3,0,0,-1,1,0,1,6,-1
KR_6763891060,420,0,-4,-23,-3,3,1,4,-4,6,2,-4,5,1,1,0,1,1,0,1,0,1,4,0,-5,5,0,0,1,-1,1,1,1,6,-1
KR_6600850265,420,-3,-33,-9,-6,3,2,5,-3,4,1,-3,3,0,-2,2,0,-1,1,0,-1,-14,12,6,-7,1,-7,0,0,-1,-1,0,-1,4,-1
KR_6730234747,420,1,30,23,-6,1,2,3,-3,4,1,-1,3,2,-3,4,1,0,0,0,0,-12,35,-6,-2,8,-14,0,-1,-1,-1,1,-1,2,-1
KR_6520587051,420,2,-10,22,-11,2,3,5,-2,3,1,0,0,0,-10,10,0,-1,2,1,-2,-18,-6,2,-7,5,0,0,0,-1,-1,-1,-1,2,-1
KR_6760727147,420,-1,-12,-48,0,2,1,3,-1,2,1,1,1,2,-2,3,1,0,1,1,0,5,398,3,-4,1,-5,0,1,-1,1,1,-1,4,-1
KR_6696911422,420,-2,-23,-16,-1,2,0,2,-1,4,3,-2,3,1,-1,2,1,1,1,2,0,0,17,3,-5,2,-1,0,0,-1,0,1,1,3,-1
KR_6729104684,420,0,36,4,0,0,2,2,0,1,1,-1,4,3,1,1,2,0,1,1,1,-7,93,-5,-6,11,-3,0,-1,1,-1,-1,1,3,-1
KR_6679124535,420,0,-44,32,0,2,0,2,1,1,2,-2,3,1,0,0,0,-1,2,1,0,4,-2,-1,-6,7,0,0,0,1,0,0,1,5,-1
KR_6750460784,420,0,2,12,-5,5,1,6,2,0,2,-5,6,1,-4,5,1,-3,4,1,0,-4,-15,2,-5,3,-2,0,0,1,1,-1,1,4,-1
KR_6737419774,420,-3,-15,-44,-5,-2,4,2,-1,3,2,0,1,1,-1,3,2,-1,1,0,0,-4,8,1,-5,4,-2,0,-2,1,-1,-1,-1,5,-1
KR_6759416586,420,-2,46,-40,1,-2,3,1,0,4,4,0,2,2,4,0,4,-1,1,0,0,2,-3,-2,-4,6,2,0,-1,1,-1,-1,1,5,-1
KR_6734296108,440,0,9,0,5,0,1,1,-3,4,1,7,2,9,1,0,1,0,1,1,0,7,-5,2,-7,5,0,0,1,-1,-1,1,1,2,-1
KR_6765626033,420,-2,-4,7,-2,3,0,3,0,2,2,-3,3,0,-1,2,1,-1,1,0,0,-6,-6,1,-4,3,-2,0,-1,-1,1,-1,-1,6,-1
KR_6766565766,420,-4,-56,-24,-12,-2,2,0,-5,6,1,-4,7,3,2,0,2,-3,3,0,-2,-21,18,1,-5,4,0,0,-2,-1,-1,-1,-1,2,-1
KR_6757512454,440,-3,18,15,-2,0,1,1,-2,2,0,-4,4,0,1,4,5,3,1,4,0,-1,-7,2,-3,1,2,0,0,-1,1,0,1,4,-1
KR_6762052215,420,-2,11,-8,0,2,0,2,-1,3,2,1,0,1,-2,4,2,0,2,2,0,0,-1,2,-8,6,4,0,0,-1,1,0,1,1,-1
KR_6740785292,440,-1,67,8,2,0,1,1,1,1,2,3,2,5,-4,5,1,2,0,2,0,-6,-35,0,-5,5,2,0,0,1,-1,0,-1,5,-1
KR_6683261202,420,-5,-76,-34,-11,4,1,5,-8,10,2,-2,8,6,-6,8,2,1,0,1,0,-19,-44,-4,-4,8,-1,0,-1,-1,-1,-1,1,5,-1
KR_6747488105,440,-2,-95,-28,-3,-2,3,1,3,1,4,0,1,1,-1,3,2,-3,3,0,0,-6,-8,0,-3,3,-5,0,0,-1,-1,0,-1,2,-1
KR_6725343506,420,2,-28,0,-7,-7,10,3,2,5,7,3,1,4,-7,9,2,2,1,3,-3,-17,28,-4,-2,6,-1,0,1,-1,-1,-1,-1,5,-1
KR_6752127146,440,0,-38,8,-5,-2,4,2,-1,3,2,-1,3,2,2,0,2,-3,3,0,0,-14,0,0,-6,6,1,0,-1,1,1,-1,1,5,-1
KR_6683148580,420,-3,-25,8,-9,-2,3,1,-4,4,0,-1,1,0,-3,5,2,1,0,1,0,-9,-5,-8,-3,11,-2,0,0,-1,-1,0,-1,5,-1
KR_6754391501,440,-2,20,-12,-7,1,3,4,-1,4,3,-4,5,1,1,1,2,-4,4,0,0,-11,19,2,-7,5,-6,0,-1,1,-1,-1,-1,5,-1
KR_6743559601,420,-2,-86,-9,0,0,2,2,-1,3,2,0,1,1,3,3,6,-2,2,0,0,3,-47,1,-5,4,10,0,-1,-1,1,-1,-1,1,-1
KR_6734036647,420,7,104,20,3,-5,6,1,2,4,6,6,1,7,0,1,1,0,1,1,0,-8,6,7,-9,2,-4,0,1,1,1,1,-1,6,-1
KR_6623412641,420,-3,-56,-6,-2,-5,7,2,1,2,3,-1,4,3,2,4,6,1,0,1,3,12,29,-2,-4,6,-4,0,0,0,-1,-1,1,0,-1
KR_6763104118,420,0,-63,4,-1,0,0,0,3,2,5,-5,5,0,1,2,3,0,1,1,-1,-2,-4,-2,-2,4,0,0,-1,-1,1,-1,-1,5,-1
KR_6761806045,440,1,20,32,-4,1,1,2,-5,5,0,-1,2,1,3,1,4,-2,2,0,0,-8,11,-1,-7,8,-1,0,1,-1,-1,1,-1,1,-1
KR_6667842677,420,3,45,-3,-3,2,1,3,-5,6,1,4,0,4,-2,4,2,-2,2,0,0,-9,-1,2,-4,2,-2,0,0,-1,1,1,1,6,-1
KR_6752519099,420,-1,-14,-20,-1,4,0,4,-1,4,3,-2,3,1,0,3,3,-2,3,1,0,2,-1,0,-5,5,-2,0,0,1,-1,1,1,2,-1
KR_6757768093,420,-2,11,6,-6,-2,2,0,2,2,4,-4,5,1,0,1,1,-2,2,0,0,-6,-131,6,-9,3,-2,0,-1,1,-1,-1,1,3,-1
KR_6675577422,420,-3,-20,8,-7,-1,2,1,0,2,2,-5,5,0,-1,2,1,0,0,0,0,-4,9,4,-7,3,-6,0,0,1,-1,-1,-1,4,-1
KR_6722530206,440,-2,12,-1,-5,1,1,2,-4,6,2,-2,3,1,1,3,4,-1,1,0,-1,-3,-1,-4,-3,7,4,0,1,0,1,1,-1,0,-1
KR_6762434870,420,3,6,19,3,4,0,4,-1,3,2,4,0,4,-5,6,1,1,0,1,-2,2,4,6,-10,4,0,0,2,1,1,1,-1,1,-1
KR_6646648622,440,0,26,-22,-1,1,1,2,-2,3,1,0,0,0,0,5,5,0,0,0,0,-3,7,1,-6,5,-4,0,1,-1,1,1,1,4,-1
KR_6755158733,420,-1,-21,25,-10,-5,7,2,1,2,3,-6,6,0,0,1,1,0,2,2,0,-7,3,-3,-4,7,-1,0,0,1,-1,1,-1,4,-1
KR_6747078751,420,-4,10,-20,-14,1,2,3,-5,5,0,-1,1,0,-5,5,0,-4,4,0,0,-16,-24,3,-6,3,3,0,-1,-1,-1,1,-1,3,-1
KR_6752303383,420,-2,-55,8,-10,-14,14,0,-1,1,0,5,0,5,0,2,2,0,0,0,0,-4,38,-1,-6,7,-21,0,-1,1,1,-1,-1,2,-1
KR_6686567366,420,0,-10,0,-2,-1,4,3,-3,4,1,0,1,1,3,2,5,-1,3,2,2,0,-2,1,-6,5,1,0,2,-1,1,1,-1,5,-1
KR_6746561027,420,0,34,22,-5,0,2,2,-2,4,2,-3,3,0,-1,3,2,1,1,2,0,-9,4,3,-6,3,-1,0,0,1,-1,0,1,3,-1
KR_6751446032,420,0,24,-16,0,-1,2,1,-2,3,1,1,4,5,2,1,3,0,0,0,0,6,-383,3,-5,2,2,0,1,1,-1,1,1,5,-1
KR_6726842250,420,-5,-74,-48,-3,-4,5,1,-1,5,4,-1,3,2,2,1,3,1,1,2,-1,1,-25,1,-7,6,9,0,-2,1,-1,-1,-1,4,-1
KR_6735927827,420,0,-17,28,-2,-1,2,1,4,4,8,3,1,4,-3,5,2,-5,5,0,0,-7,-37,0,-2,2,24,0,-2,-1,1,-1,-1,6,-1
KR_6744025547,420,-5,-107,5,-10,1,2,3,-6,6,0,-5,5,0,-1,1,0,1,0,1,0,-12,2,-7,-2,9,-3,0,-2,-1,-1,-1,1,3,-1
KR_6736703187,420,-2,-67,-20,-5,-3,6,3,0,4,4,1,1,2,-2,4,2,-1,1,0,0,-5,50,-5,-3,8,-4,0,0,-1,-1,-1,1,1,-1
KR_6764937518,440,3,41,10,4,-6,6,0,6,1,7,1,1,2,3,2,5,0,1,1,1,1,28,-1,-4,5,6,0,0,0,1,0,1,0,-1
KR_6704888331,440,-7,-89,-37,-15,-1,1,0,-5,5,0,-6,6,0,-2,3,1,-1,1,0,-1,-15,106,-2,-3,5,4,0,-1,0,1,-1,-1,0,-1
KR_6764243994,420,-1,9,-29,-2,0,1,1,-1,4,3,0,1,1,-1,4,3,0,2,2,0,2,-8,-2,-4,6,4,0,0,1,-1,-1,-1,3,-1
KR_6748052498,420,-2,2,-23,-1,1,1,2,-5,6,1,-2,6,4,6,0,6,-1,3,2,-1,8,-20,3,-5,2,1,0,0,1,-1,-1,-1,5,-1
KR_6765288869,420,-3,-26,5,-5,-4,5,1,-2,2,0,1,2,3,0,0,0,0,0,0,0,-8,-5,-3,-2,5,-2,0,0,-1,1,-1,1,5,-1
KR_6765742630,420,5,54,11,13,5,2,7,3,2,5,7,1,8,0,1,1,-2,3,1,1,5,-12,3,-7,4,2,0,1,1,1,1,1,3,-1
KR_6760369010,420,1,-20,15,0,2,2,4,-4,4,0,3,1,4,-1,2,1,0,1,1,0,-2,-316,-1,-6,7,8,0,0,0,1,0,-1,0,-1
KR_6752920334,420,-4,29,16,-15,0,2,2,-1,2,1,-4,5,1,-8,8,0,-2,3,1,-1,-16,-15,-2,-3,5,-6,0,0,-1,-1,-1,-1,1,-1
KR_6746959116,420,1,14,-35,1,0,0,0,0,3,3,2,2,4,0,2,2,-1,2,1,0,-1,-1,1,-8,7,5,0,0,1,-1,0,-1,2,-1
KR_6706759803,420,-1,-2,-23,-3,-1,3,2,3,3,6,-1,3,2,-3,5,2,-1,4,3,1,-4,-7,1,-6,5,2,0,-2,0,-1,-1,1,0,-1
KR_6600942821,420,-1,32,-25,-5,0,1,1,-2,2,0,-2,4,2,-1,5,4,0,2,2,1,-11,-5,-1,-6,7,0,0,0,-1,1,0,1,6,-1
KR_6758771135,420,2,-33,-16,4,-4,6,2,5,1,6,0,2,2,0,2,2,3,1,4,0,5,17,-4,-5,9,9,0,-1,0,-1,-1,1,0,-1
KR_6765169914,420,0,-25,28,-1,-4,4,0,0,2,2,0,2,2,2,1,3,1,0,1,0,1,-229,0,-4,4,0,0,-1,-1,1,-1,-1,1,-1
KR_6617746159,420,-3,27,0,-8,-6,7,1,-3,3,0,2,3,5,1,4,5,-2,2,0,0,-14,-3,0,-5,5,0,0,-1,1,-1,-1,1,3,-1
KR_6722448126,440,-4,-12,-32,-13,-2,4,2,-3,4,1,-4,4,0,-2,3,1,-2,2,0,0,-10,4,-1,-3,4,-6,0,-2,-1,-1,-1,1,4,-1
KR_6750848528,420,-1,-1,-14,-4,2,1,3,-3,3,0,-2,4,2,0,1,1,-1,1,0,0,-3,-1,-4,-3,7,3,0,0,-1,0,0,-1,6,-1
KR_6728061268,420,-1,-49,12,0,0,3,3,-6,8,2,-1,2,1,6,0,6,1,0,1,2,4,287,4,-7,3,-4,0,0,1,-1,-1,1,6,-1
KR_6763025134,420,3,16,0,5,0,2,2,6,1,7,-2,5,3,-1,4,3,2,0,2,0,3,3,4,-10,6,-4,0,1,-1,1,1,-1,5,-1
KR_6748815349,420,3,29,-3,7,2,0,2,-3,5,2,1,1,2,5,1,6,2,1,3,0,3,-86,8,-8,0,-1,0,0,1,1,0,-1,1,-1
KR_6668205096,420,0,18,-25,3,-1,1,0,7,2,9,1,6,7,-4,5,1,0,0,0,1,1,-6,-1,-4,5,2,0,0,0,0,0,1,0,-1
KR_6752995929,420,-2,-56,11,-5,-2,3,1,0,3,3,0,7,7,-2,4,2,-1,2,1,0,0,-1,-1,-5,6,0,0,-1,-1,1,-1,1,4,-1
KR_6764079827,420,-2,42,-16,-5,5,0,5,-1,3,2,-2,3,1,-7,7,0,0,0,0,-2,-20,-6,-2,-7,9,0,0,0,1,1,0,-1,1,-1
KR_6747842875,440,-2,15,-12,-7,-2,3,1,1,3,4,-1,2,1,-4,4,0,-1,2,1,0,-3,4,-5,-5,10,-2,0,-1,-1,-1,-1,-1,5,-1
KR_6757229230,420,0,-78,11,-5,4,0,4,-2,3,1,0,4,4,-6,7,1,-1,1,0,1,-6,22,-1,-4,5,1,0,-1,-1,1,-1,1,2,-1
KR_6605255908,420,-3,-51,19,-3,3,2,5,-4,8,4,-1,2,1,0,1,1,-1,1,0,0,3,18,-3,-5,8,-2,0,-1,-1,-1,-1,-1,2,-1
KR_6684711026,420,-2,-32,29,-13,1,1,2,-3,5,2,-4,4,0,-4,4,0,-3,3,0,0,-16,-12,-6,-1,7,-1,0,-1,-1,1,-1,-1,3,-1
KR_6756953122,420,-1,63,32,-1,-5,5,0,3,1,4,3,0,3,-4,6,2,2,0,2,0,1,22,2,-7,5,5,0,1,1,1,1,1,5,-1
KR_6562364769,420,-4,-55,-17,-8,-2,3,1,0,4,4,-5,7,2,-1,5,4,0,1,1,-1,-5,-13,3,-7,4,-4,0,-1,1,-1,-1,-1,1,-1
KR_6591616466,420,-1,-15,3,-1,3,0,3,4,0,4,-4,8,4,-4,4,0,0,0,0,0,-8,-5,4,-10,6,-4,0,1,1,1,1,1,4,-1
KR_6673934987,420,0,40,8,3,4,2,6,-5,6,1,3,1,4,-2,2,0,3,0,3,-1,-1,-8,-6,-1,7,5,0,0,-1,1,0,-1,5,-1
KR_6762228079,420,1,-11,17,0,-5,5,0,0,1,1,1,0,1,1,1,2,3,0,3,0,3,-7,-1,-4,5,-1,0,-3,1,-1,-1,-1,3,-1
KR_6568071171,420,2,30,7,1,-2,2,0,0,3,3,6,0,6,0,1,1,-3,4,1,0,7,-10,0,-2,2,-5,0,0,-1,1,1,-1,6,-1
KR_6739945346,420,-2,5,-40,-1,0,1,1,0,4,4,-3,5,2,1,3,4,1,1,2,0,-4,-39,1,-3,2,22,0,-1,1,-1,-1,1,5,-1
KR_6684634623,420,-2,-13,7,-4,0,2,2,-3,8,5,-1,2,1,3,5,8,-3,3,0,2,10,2,-1,-6,7,1,0,0,1,0,0,1,1,-1
KR_6756790925,440,-4,-4,-25,3,-3,5,2,-2,3,1,-1,3,2,2,2,4,7,0,7,0,6,-5,-5,-3,8,-2,0,-1,-1,0,-1,1,6,-1
KR_6695266367,420,0,-24,7,2,0,2,2,5,0,5,1,3,4,-3,3,0,-1,2,1,0,0,-7,-5,-3,8,2,0,-1,1,1,-1,1,4,-1
KR_6757867347,420,-2,0,20,-3,5,1,6,-8,8,0,2,2,4,-1,2,1,-1,2,1,0,-11,-12,-1,-4,5,-3,0,0,-1,1,1,-1,5,-1
KR_6755089417,420,-1,-21,-16,1,0,2,2,-6,8,2,6,0,6,1,4,5,0,1,1,1,16,-7,1,-5,4,1,0,-1,-1,-1,-1,1,4,-1
KR_6761763566,420,-2,-65,-12,-6,0,2,2,-4,5,1,1,3,4,1,3,4,-4,5,1,0,-9,-16,-5,-3,8,-2,0,-2,1,-1,-1,1,4,-1
KR_6743183058,420,-1,-105,8,-3,-2,2,0,-4,4,0,3,1,4,-1,2,1,1,0,1,0,-3,4,3,-9,6,-6,0,0,1,1,-1,-1,5,-1
KR_6736072650,420,-1,83,-12,-3,3,1,4,-2,3,1,-6,7,1,3,0,3,-1,2,1,0,-9,-6,0,-4,4,4,0,0,1,-1,1,1,1,-1
KR_6765589249,420,-1,-12,9,-1,-5,5,0,4,1,5,-1,1,0,2,1,3,-1,2,1,0,4,5,4,-7,3,0,0,0,1,1,1,-1,1,-1
KR_6736074865,420,-1,4,-24,0,-1,1,0,-2,4,2,4,2,6,-2,4,2,1,3,4,0,-4,29,3,-7,4,-2,0,1,-1,1,-1,-1,6,-1
KR_6714978469,420,-6,-105,-19,-7,-1,3,2,-4,6,2,0,1,1,4,2,6,-6,7,1,0,-8,-13,3,-9,6,1,0,-1,-1,-1,-1,1,5,-1
KR_6750876097,420,-4,-51,-12,-15,-4,4,0,-5,5,0,-7,9,2,-4,6,2,5,2,7,-1,-13,-1,-2,-6,8,-6,0,0,-1,1,0,-1,5,-1
KR_6734661991,420,1,-7,3,4,1,1,2,3,3,6,-1,3,2,0,0,0,1,0,1,0,10,18,-3,-3,6,-1,0,1,1,-1,1,1,4,-1
KR_6686937796,420,2,68,-1,3,-1,1,0,0,3,3,-3,4,1,6,0,6,1,1,2,0,6,5,2,-5,3,1,0,2,-1,1,1,-1,3,-1
KR_6715663366,420,-5,-68,13,-3,-7,7,0,-1,5,4,7,4,11,-3,5,2,1,1,2,0,-4,-4,-2,-2,4,1,0,0,1,-1,-1,1,4,-1
KR_6658539831,420,-3,18,4,-1,-1,3,2,0,2,2,0,0,0,-1,2,1,1,0,1,-1,3,-2,-4,-2,6,-6,0,-1,1,-1,-1,-1,1,-1
KR_6709669569,420,-1,-37,40,-5,-1,1,0,-2,4,2,-2,2,0,-1,1,0,1,1,2,0,-4,-9,0,-5,5,2,0,-1,-1,-1,-1,1,4,-1
KR_6652632921,420,-2,-35,12,-8,5,3,8,-3,5,2,-3,4,1,-7,7,0,0,1,1,0,-19,6,3,-6,3,-6,0,0,0,0,1,1,0,-1
KR_6750244060,420,-5,-55,2,-14,-4,5,1,0,4,4,-2,3,1,-6,6,0,-2,3,1,0,-12,-8,-1,-2,3,4,0,-1,-1,1,-1,-1,3,-1
KR_6756919026,440,1,57,9,-4,4,0,4,-5,7,2,-2,3,1,-2,2,0,1,0,1,0,2,29,-1,-4,5,-13,0,0,1,0,0,-1,1,-1
KR_6738033493,420,-7,-13,-28,-11,-1,1,0,-3,4,1,1,1,2,-3,4,1,-5,5,0,0,-16,-6,-2,-5,7,0,0,-2,-1,1,-1,-1,1,-1
KR_6761107569,440,-3,-89,-26,-3,-1,2,1,0,0,0,1,0,1,-1,2,1,-2,3,1,0,-2,154,0,-3,3,1,0,-1,1,-1,-1,1,4,-1
KR_6750997551,420,0,20,-16,3,-2,2,0,7,1,8,-2,3,1,0,1,1,0,0,0,-1,8,-3,4,-8,4,7,0,1,1,-1,1,-1,5,-1
KR_6679426155,420,-4,-35,-1,-2,-2,2,0,2,1,3,-1,3,2,-2,5,3,1,1,2,0,-4,-2,2,-7,5,1,0,-1,1,1,-1,-1,4,-1
KR_6671036555,420,-1,-21,32,-10,-3,7,4,-1,2,1,-10,11,1,2,0,2,2,3,5,-1,7,8,0,-7,7,1,0,-2,-1,0,-1,-1,3,-1
KR_6693622514,420,1,-8,-6,-8,1,1,2,-5,5,0,1,3,4,-5,7,2,0,1,1,0,-10,25,1,-6,5,-8,0,0,1,-1,1,-1,6,-1
KR_6706792148,420,1,93,-27,3,3,1,4,2,2,4,-1,2,1,3,4,7,-4,4,0,1,3,43,-1,-7,8,-22,0,2,-1,1,1,1,6,-1
KR_6752261394,420,-2,-21,3,-9,1,2,3,-3,6,3,-2,2,0,-5,5,0,0,0,0,0,-12,-8,-6,-3,9,-3,0,0,1,-1,0,-1,4,-1
KR_6693537878,420,0,32,16,-1,-2,3,1,2,2,4,0,4,4,-1,1,0,0,1,1,0,-6,127,1,-5,4,-1,0,0,1,1,1,1,2,-1
KR_6760478321,420,-7,-101,-14,-7,-4,5,1,-3,4,1,1,3,4,0,1,1,-1,3,2,1,-3,-3,-1,-3,4,-1,0,-2,-1,-1,-1,1,4,-1
KR_6686467360,420,-1,18,-29,1,2,0,2,-1,3,2,1,0,1,1,3,4,-2,2,0,0,0,-49,0,-6,6,-5,0,0,-1,-1,0,1,1,-1
KR_6671007423,420,1,36,-3,11,1,0,1,4,4,8,5,1,6,2,2,4,-1,3,2,0,7,8,2,-6,4,2,0,0,-1,-1,0,1,1,-1
KR_6760069935,420,-1,-9,-22,-6,-3,3,0,-5,10,5,2,0,2,2,2,4,-2,2,0,0,-6,-12,-3,-8,11,3,0,-1,-1,1,-1,1,5,-1
KR_6764605494,420,-2,-20,26,-6,1,3,4,-8,9,1,1,1,2,-1,2,1,1,0,1,0,-17,-37,-7,-5,12,2,0,-3,1,-1,-1,1,4,-1
KR_6741422661,420,0,-52,-1,-5,1,1,2,-3,6,3,1,3,4,-4,4,0,0,1,1,-1,0,35,2,-6,4,-1,0,0,-1,-1,-1,-1,6,-1
KR_6599498186,420,-4,-62,-37,-9,2,3,5,-5,7,2,-1,1,0,-1,1,0,-4,4,0,0,-12,-4,-2,-3,5,-1,0,-1,-1,-1,-1,1,1,-1
KR_6748948195,420,1,9,-10,1,2,0,2,2,1,3,-3,6,3,-2,5,3,2,1,3,-1,-1,-216,-2,-6,8,2,0,0,1,-1,0,-1,1,-1
KR_6758003036,420,4,21,-8,6,-1,1,0,4,2,6,1,0,1,0,3,3,2,1,3,0,10,0,-1,-4,5,2,0,2,-1,1,1,1,5,-1
KR_6758644963,420,-3,-14,14,-10,-1,2,1,0,4,4,-5,6,1,-3,5,2,-1,2,1,0,-12,-1,1,-5,4,-2,0,1,-1,1,1,1,1,-1
KR_6718233103,420,0,60,-29,-1,0,3,3,2,1,3,0,2,2,-5,6,1,2,0,2,0,-11,12,7,-9,2,-3,0,0,-1,1,-1,1,1,-1
KR_6752180446,440,2,-24,3,8,-6,8,2,3,1,4,3,2,5,5,1,6,3,1,4,0,5,-14,4,-9,5,4,0,-1,-1,1,-1,-1,1,-1
KR_6700653777,420,-2,-92,-16,-4,-1,1,0,0,9,9,-3,3,0,1,1,2,-1,1,0,0,0,-6,1,-5,4,-2,0,-3,-1,-1,-1,-1,5,-1
KR_6765201427,420,2,-31,9,4,-4,5,1,6,1,7,0,4,4,2,1,3,0,0,0,0,11,-3,-3,-3,6,3,0,-1,1,1,-1,1,2,-1
KR_6745944942,420,-3,-29,-13,-7,3,1,4,-7,7,0,1,0,1,-3,4,1,-1,2,1,0,-17,-10,-1,-5,6,-2,0,-2,-1,-1,-1,-1,4,-1
KR_6764347299,420,-3,-10,-14,-10,2,2,4,-5,8,3,-7,7,0,0,1,1,0,0,0,0,-9,1,2,-6,4,-3,0,0,-1,1,1,-1,6,-1
KR_6761817533,420,1,6,7,6,0,5,5,1,4,5,3,2,5,5,0,5,-3,4,1,-1,0,5,2,-7,5,-3,0,0,-1,0,0,-1,5,-1
KR_6761503433,440,-3,-19,-16,-2,-1,2,1,1,0,1,-1,3,2,0,2,2,-1,1,0,0,-2,16,0,-4,4,1,0,-1,1,-1,-1,-1,1,-1
KR_6733712642,420,-4,-46,-30,-7,-2,3,1,-4,7,3,-2,3,1,1,1,2,0,1,1,0,2,-52,-2,-3,5,5,0,-3,0,-1,-1,-1,0,-1
KR_6737788358,420,1,25,11,5,4,0,4,3,0,3,-2,3,1,0,4,4,0,0,0,0,1,7,-2,-5,7,-4,0,1,-1,1,1,1,6,-1
KR_6764459005,420,-1,-72,28,-5,0,2,2,-4,8,4,1,2,3,-2,5,3,0,1,1,-3,-13,-17,-3,-4,7,-2,0,0,-1,-1,0,-1,4,-1
KR_6507101573,420,-4,-42,-27,-9,0,3,3,-2,2,0,-3,4,1,-1,4,3,-3,5,2,2,-9,-5,0,-4,4,3,0,-1,-1,-1,-1,1,4,-1
KR_6736672310,420,-3,-14,4,-5,1,1,2,-2,4,2,0,1,1,-3,4,1,-1,2,1,0,-10,36,0,-8,8,-5,0,0,-1,1,-1,1,4,-1
KR_6765515860,420,1,-4,-20,-3,3,1,4,-5,5,0,-1,1,0,-4,5,1,4,0,4,0,0,5,4,-10,6,-1,0,1,-1,-1,1,1,2,-1
KR_6562159611,420,-5,-46,-18,-13,-3,4,1,2,0,2,1,2,3,-12,13,1,-1,2,1,0,-21,-25,-3,-4,7,2,0,-2,-1,1,-1,-1,2,-1
KR_6759326238,420,-1,10,-28,-1,-1,2,1,-3,3,0,0,2,2,2,4,6,1,2,3,0,-3,101,3,-6,3,0,0,0,-1,1,1,1,1,-1
KR_6678358542,420,-1,-38,8,-2,-2,2,0,1,3,4,1,1,2,-3,3,0,1,1,2,0,-5,130,2,-7,5,1,0,0,1,-1,0,-1,1,-1
KR_6765813930,420,2,31,0,2,0,0,0,3,2,5,-2,2,0,1,0,1,0,0,0,0,4,-4,0,-7,7,3,0,-1,1,-1,-1,1,1,-1
KR_6669556683,420,1,31,-34,2,3,0,3,-5,7,2,2,0,2,2,2,4,0,1,1,1,-2,16,6,-9,3,-7,0,-2,1,-1,-1,1,3,-1
KR_6718132189,420,-4,-57,-16,-11,1,2,3,-7,10,3,-4,9,5,1,5,6,-2,3,1,-4,-29,18,0,-6,6,-4,0,0,1,1,-1,-1,3,-1
KR_6759008948,440,-3,6,-21,-13,-1,2,1,-5,5,0,-3,5,2,-4,4,0,0,0,0,0,-7,-5,-5,-2,7,2,0,-1,0,1,-1,-1,0,-1
KR_6750852056,420,3,54,-13,9,4,2,6,4,1,5,-1,2,1,-3,5,2,5,0,5,1,4,-8,0,-3,3,3,0,1,-1,1,1,1,2,-1
KR_6755110826,420,-4,-35,20,-13,-3,4,1,-1,1,0,0,3,3,-6,7,1,-3,4,1,0,-9,-1,-6,0,6,3,0,0,-1,1,-1,1,6,-1
KR_6713223822,420,-6,-68,-16,-31,-5,5,0,-10,10,0,-8,11,3,-4,4,0,-4,6,2,1,-30,-11,-2,-1,3,2,-1,-5,0,-1,-1,1,0,-1
KR_6633100651,420,-3,-130,8,0,3,0,3,-3,4,1,1,3,4,-3,6,3,2,0,2,1,-2,-1,-6,-4,10,-1,0,-2,1,-1,-1,-1,2,-1
KR_6637369950,420,1,46,24,3,6,0,6,1,3,4,0,3,3,-2,2,0,-2,2,0,0,5,1,3,-6,3,-4,0,0,-1,1,-1,1,3,-1
KR_6743644858,420,-1,-1,4,-7,0,1,1,0,3,3,-6,6,0,0,2,2,-1,2,1,0,-8,1,-1,-5,6,1,0,0,1,-1,-1,1,3,-1
KR_6738571422,420,0,28,8,-3,-9,9,0,5,0,5,3,3,6,1,2,3,-3,5,2,0,5,15,2,-2,0,3,0,1,1,1,1,-1,2,-1
KR_6738371438,420,-1,21,-23,-8,0,1,1,-3,3,0,0,3,3,-5,6,1,0,0,0,-1,-18,13,4,-6,2,-7,0,0,-1,1,0,-1,5,-1
KR_6687984721,420,1,-16,34,7,1,2,3,-1,3,2,2,1,3,3,3,6,2,0,2,0,8,3,5,-8,3,3,0,1,-1,1,1,1,3,-1
KR_6698857083,420,2,-33,4,5,-1,2,1,0,1,1,5,0,5,0,3,3,1,1,2,0,2,0,3,-6,3,5,0,1,1,1,1,-1,5,-1
KR_6733520558,440,-4,-65,-8,-11,1,0,1,-6,8,2,0,1,1,-6,7,1,0,0,0,0,-12,-11,-5,-2,7,1,0,-1,0,1,-1,1,0,-1
KR_6627956555,420,-4,-67,-8,-6,-1,1,0,-3,4,1,1,1,2,-1,3,2,-2,5,3,0,-9,-8,-3,-4,7,-6,0,-1,0,-1,-1,-1,0,-1
KR_6730360815,420,-3,20,-32,-6,1,0,1,0,3,3,0,4,4,-6,6,0,-1,1,0,0,-16,4,2,-7,5,-2,0,-1,-1,1,-1,-1,3,-1
KR_6756891499,440,2,40,-18,1,4,0,4,-2,2,0,0,1,1,-2,3,1,1,4,5,2,2,-9,3,-5,2,-1,0,0,1,1,0,1,5,-1
KR_6762122996,420,0,1,7,-7,-3,3,0,2,2,4,0,0,0,-5,5,0,-1,1,0,0,-7,-14,-6,-4,10,-1,0,0,1,1,-1,-1,6,-1
KR_6766093857,420,1,-17,23,8,4,2,6,-1,4,3,5,0,5,-1,2,1,1,1,2,0,2,-16,-2,-4,6,2,0,0,1,-1,-1,1,3,-1
KR_6717656847,420,-5,-36,-42,-11,-1,3,2,-4,5,1,-1,3,2,-4,4,0,-1,1,0,0,-5,16,-9,-3,12,-3,0,0,-1,-1,-1,-1,4,-1
KR_6743859827,420,-2,-4,-16,-2,-1,1,0,1,0,1,1,2,3,-2,7,5,-1,2,1,0,3,31,0,-2,2,1,0,-1,-1,-1,-1,-1,1,-1
KR_6633727091,420,-1,-66,0,-1,3,0,3,-2,5,3,-3,3,0,1,1,2,0,0,0,0,-1,3,2,-9,7,-3,0,0,-1,1,0,-1,5,-1
KR_6756142295,420,-2,-16,-27,-11,3,2,5,-1,2,1,-9,11,2,-4,5,1,0,0,0,0,-8,-9,-3,-4,7,-2,0,0,-1,1,-1,-1,3,-1
KR_6713940659,420,-3,-4,30,-2,4,2,6,-3,8,5,-1,7,6,1,2,3,-3,4,1,0,-2,-3,-1,-5,6,1,0,-2,1,1,-1,-1,6,-1
KR_6751226955,420,4,1,20,3,5,2,7,3,1,4,1,1,2,-7,8,1,1,1,2,-1,-4,28,1,-3,2,-6,0,-1,-1,1,-1,-1,4,-1
KR_6658729707,420,-6,-170,-48,-7,-5,5,0,3,2,5,-1,2,1,-3,4,1,-1,1,0,0,2,-3,1,-5,4,-3,0,-1,-1,1,-1,-1,4,-1
KR_6765780679,420,-3,6,-27,-8,-2,4,2,0,5,5,-2,3,1,-2,3,1,-2,4,2,0,-10,6,2,-5,3,-6,0,-3,0,-1,-1,-1,0,-1
KR_6701582512,440,-3,-45,15,1,0,3,3,-1,3,2,-3,3,0,3,2,5,2,0,2,0,9,18,-3,-3,6,-8,0,-1,1,-1,-1,1,1,-1
KR_6648672599,420,1,-10,-20,5,-1,2,1,2,4,6,4,1,5,1,3,4,-1,1,0,0,6,0,1,-6,5,-3,0,0,1,1,1,1,2,-1
KR_6706624068,420,-1,48,-14,-2,-2,5,3,-2,3,1,-1,2,1,0,3,3,3,0,3,0,-4,1,0,-6,6,2,0,0,-1,1,0,1,5,-1
KR_6762227871,440,-5,-150,-36,-14,-2,2,0,0,4,4,-2,5,3,-5,7,2,-5,5,0,0,-5,2,0,-3,3,-5,0,-2,-1,0,-1,-1,6,-1
KR_6706947930,420,-4,-62,44,-12,-5,6,1,-4,5,1,-2,5,3,-4,6,2,3,1,4,0,-6,172,-3,-2,5,-1,0,-4,0,-1,-1,-1,0,-1
KR_6762701298,420,-1,-22,-21,-4,-4,5,1,-1,3,2,-1,2,1,1,1,2,1,1,2,0,1,-27,-1,-4,5,2,0,-3,-1,-1,-1,-1,6,-1
KR_6630910529,420,1,54,4,-5,3,0,3,1,3,4,1,1,2,-5,5,0,-5,5,0,0,-5,6,0,-7,7,4,0,1,-1,1,1,-1,6,-1
KR_6600919250,420,-4,-7,-34,-11,-2,2,0,-4,4,0,-4,4,0,-1,4,3,0,2,2,-3,-18,2,1,-6,5,3,0,-1,-1,1,-1,-1,1,-1
KR_6762664788,420,0,57,-8,-3,-1,4,3,0,3,3,0,3,3,-1,2,1,-1,1,0,0,-3,-11,0,-5,5,0,0,1,-1,-1,1,-1,2,-1
KR_6695529537,420,-1,-31,20,-6,-4,5,1,-1,2,1,-3,4,1,2,1,3,0,0,0,0,-3,1,4,-5,1,-1,0,-1,1,-1,-1,1,2,-1
KR_6729275982,420,1,-44,20,2,3,0,3,0,2,2,-1,5,4,0,6,6,0,1,1,0,-1,6,-4,-4,8,-5,0,0,-1,1,1,-1,6,-1
KR_6759620038,440,-3,-51,11,-3,-2,2,0,0,0,0,-2,2,0,0,2,2,1,4,5,0,-9,-2,-1,-3,4,-5,0,-2,1,-1,-1,1,2,-1
KR_6700768244,420,0,-51,0,2,4,2,6,0,1,1,-3,4,1,0,2,2,1,0,1,-1,2,-78,-2,-3,5,26,0,-3,-1,-1,-1,-1,2,-1
KR_6720342857,420,2,-9,20,8,0,2,2,1,2,3,7,1,8,4,4,8,-4,5,1,2,9,9,6,-11,5,-3,0,-2,-1,1,-1,1,6,-1
KR_6700047807,420,-5,35,1,-4,-2,2,0,0,5,5,-4,5,1,1,2,3,1,0,1,1,-14,2,3,-6,3,-4,0,0,1,0,-1,1,2,-1
KR_6748435348,420,-3,-59,8,-2,2,3,5,-5,6,1,4,1,5,-2,4,2,-1,2,1,0,-3,5,0,-6,6,-3,0,0,-1,1,-1,1,3,-1
KR_6670338408,420,-2,33,-4,-4,5,1,6,-2,5,3,-2,4,2,-4,6,2,-1,1,0,0,-13,-3,3,-7,4,3,0,1,-1,1,1,1,2,-1
KR_6765900819,420,-4,-27,-10,-8,1,0,1,0,2,2,-4,5,1,-4,5,1,-1,1,0,0,-3,2,-3,-2,5,-5,0,-2,-1,-1,-1,-1,6,-1
KR_6764144009,420,-1,-51,8,-3,-1,4,3,4,1,5,-1,2,1,-3,3,0,-2,2,0,0,1,-5,5,-9,4,-4,0,-2,0,0,-1,1,0,-1
KR_6763097352,420,0,-7,-32,-7,-1,2,1,-1,1,0,-3,4,1,-1,4,3,-1,1,0,0,-2,21,-4,-3,7,-1,0,-1,-1,-1,-1,-1,2,-1
KR_6748770309,440,1,-50,3,8,12,0,12,1,0,1,-2,4,2,-1,6,5,-2,4,2,0,10,-7,-3,-2,5,5,0,0,1,1,-1,-1,2,-1
KR_6751597905,420,-2,12,-5,-4,1,1,2,-4,6,2,1,1,2,-4,4,0,2,0,2,0,-2,13,-1,-4,5,-17,0,0,-1,1,-1,-1,2,-1
KR_6760256963,420,-8,-65,-41,-15,-3,4,1,-6,6,0,-7,8,1,-1,4,3,2,0,2,0,-17,-2,-1,-5,6,0,0,-2,1,-1,-1,-1,6,-1
KR_6684492485,420,-3,-31,-52,-8,-5,5,0,-1,3,2,1,2,3,-5,5,0,2,0,2,0,-11,-14,-3,-2,5,0,0,-1,-1,0,-1,-1,4,-1
KR_6277994099,420,-1,49,-4,-3,-1,3,2,-4,6,2,-1,1,0,1,0,1,2,1,3,0,0,-2,-6,-5,11,2,0,0,-1,-1,0,-1,1,-1
KR_6764228019,420,-2,-34,9,-9,2,1,3,-2,3,1,-1,2,1,-7,7,0,-1,2,1,0,-18,-4,-6,-5,11,-1,0,-1,-1,0,-1,1,4,-1
KR_6647134667,440,-4,-78,-16,-2,-1,3,2,-1,2,1,-2,2,0,0,2,2,2,0,2,0,0,1,0,-4,4,-1,0,0,-1,1,0,-1,2,-1
KR_6729830014,420,0,17,-11,2,-2,4,2,2,3,5,-1,3,2,4,3,7,-1,1,0,0,-5,-13,0,-8,8,5,0,1,1,1,1,1,5,-1
KR_6759720681,420,0,14,-12,1,-1,1,0,-1,2,1,-1,1,0,4,1,5,0,0,0,0,6,-21,4,-7,3,6,0,0,-1,1,0,1,2,-1
KR_6731215646,420,0,-64,0,-5,-1,2,1,-2,2,0,-1,5,4,1,1,2,-2,3,1,-1,-5,9,0,-4,4,1,0,0,0,1,-1,-1,0,-1
KR_6727965009,420,-2,-32,-3,1,2,0,2,0,3,3,-1,1,0,0,0,0,0,0,0,0,3,16,-1,-5,6,-1,0,0,-1,1,0,1,6,-1
KR_6766191917,420,-2,23,-12,2,-1,2,1,1,0,1,4,5,9,-2,3,1,0,0,0,0,-4,8,-4,-5,9,1,0,0,-1,-1,0,1,6,-1
KR_6766449765,420,-1,-58,4,-1,-1,1,0,-5,8,3,1,2,3,4,1,5,0,1,1,0,3,14,4,-6,2,1,0,-4,1,-1,-1,-1,3,-1
KR_6609124256,420,-3,-62,-3,-6,0,3,3,-2,4,2,-1,4,3,-2,4,2,-1,3,2,0,-3,-3,3,-6,3,-4,0,-2,-1,1,-1,1,3,-1
KR_6735856313,440,-2,-82,7,-6,-4,5,1,-3,7,4,-2,4,2,3,2,5,0,0,0,0,-8,5,6,-7,1,-2,0,-1,0,1,-1,-1,0,-1
KR_6762449433,440,-2,-17,-9,-5,2,1,3,-4,5,1,-1,2,1,-1,3,2,-1,1,0,0,-12,-4,-4,-3,7,0,0,-2,-1,-1,-1,1,2,-1
KR_6756206802,420,3,1,20,3,2,0,2,-3,4,1,3,1,4,0,2,2,1,1,2,0,3,-6,-1,-5,6,1,0,0,-1,1,1,1,2,-1
KR_6685251968,420,-6,-63,-20,-17,-8,9,1,-4,4,0,-2,5,3,-3,4,1,0,1,1,-1,-20,-47,-5,-2,7,-6,0,-1,-1,-1,-1,-1,6,-1
KR_6765182046,420,-1,-18,44,-8,-3,5,2,0,2,2,-3,3,0,-2,2,0,0,1,1,0,-12,0,-2,-2,4,-4,0,-3,1,-1,-1,1,5,-1
KR_6763551447,440,-6,-45,8,-15,-1,1,0,-2,6,4,-8,9,1,-1,1,0,-3,3,0,0,-14,-25,-9,-2,11,1,0,-2,-1,-1,-1,-1,2,-1
KR_6744120373,420,-3,-13,-20,-8,0,0,0,-3,3,0,-1,2,1,-3,4,1,-1,1,0,-1,-11,5,0,-5,5,-4,0,-1,-1,1,-1,-1,3,-1
KR_6743156442,420,-4,-19,12,-9,4,1,5,-7,7,0,-1,2,1,-5,6,1,0,2,2,0,-13,10,2,-5,3,1,0,-2,-1,-1,-1,-1,6,-1
KR_6741604088,440,0,-1,-32,-3,-1,1,0,-5,6,1,0,3,3,2,1,3,1,1,2,1,2,-1,-2,-3,5,1,0,2,-1,1,1,1,6,-1
KR_6749192787,420,2,-2,-14,0,-5,5,0,0,3,3,1,1,2,5,2,7,-1,2,1,0,3,237,-1,-3,4,0,0,0,1,-1,-1,-1,1,-1
KR_6764872429,420,1,-31,-16,0,1,1,2,1,1,2,0,2,2,-2,7,5,0,0,0,0,-1,-5,3,-5,2,0,0,-1,-1,1,-1,-1,2,-1
KR_6748609579,420,-2,-108,14,-5,0,0,0,4,1,5,-1,1,0,-6,10,4,-2,3,1,0,-4,-9,3,-6,3,4,0,-2,1,-1,-1,-1,3,-1
KR_6694703295,420,-4,46,-38,-9,0,4,4,-1,1,0,-6,6,0,-2,2,0,0,0,0,0,-15,2,3,-6,3,3,0,-1,-1,1,-1,-1,6,-1
KR_6705178254,420,-7,-52,-28,-9,-4,5,1,-5,6,1,2,1,3,-1,4,3,-1,1,0,0,-4,-27,3,-8,5,4,0,0,0,-1,-1,-1,0,-1
KR_6686607031,440,0,-12,-4,4,2,1,3,0,1,1,4,1,5,-1,3,2,-1,1,0,0,0,-10,0,-6,6,4,0,1,1,1,1,1,5,-1
KR_6696071488,420,-1,6,10,-7,0,1,1,0,1,1,-4,5,1,-2,2,0,-1,1,0,0,-11,-33,2,-7,5,-8,0,-2,-1,-1,-1,-1,3,-1
KR_6765102450,420,-6,-87,-2,-14,-1,2,1,-9,9,0,0,2,2,-1,6,5,-3,4,1,-1,-12,3,4,-7,3,-6,0,-1,1,-1,-1,-1,3,-1
KR_6601577565,420,-1,-45,-4,-6,-1,5,4,-1,1,0,-4,6,2,-1,3,2,1,1,2,0,-8,2,0,-2,2,-2,0,1,-1,-1,1,1,5,-1
KR_6731739463,420,0,-87,-1,-4,1,0,1,-1,4,3,-3,3,0,-1,2,1,0,2,2,0,-8,7,-3,-3,6,-6,0,-1,1,1,-1,-1,2,-1
KR_6751422823,420,-5,2,-27,-10,2,2,4,-5,5,0,-4,6,2,-1,2,1,-2,2,0,0,-21,-14,-4,-5,9,0,0,-2,-1,-1,-1,1,3,-1
KR_6688245303,440,-5,-83,5,-8,-2,4,2,-1,7,6,-2,5,3,-2,4,2,-1,1,0,-1,-10,2,-2,-2,4,-1,0,-1,-1,1,-1,-1,4,-1
KR_6753498555,420,0,51,16,-4,1,1,2,-3,3,0,1,0,1,-2,4,2,-1,2,1,1,-7,-22,-5,-2,7,-1,0,-1,1,-1,-1,1,5,-1
KR_6655977951,420,3,37,19,-4,4,1,5,-5,5,0,-2,7,5,-1,1,0,0,0,0,0,-7,12,6,-8,2,-2,0,-1,1,1,1,-1,3,-1
KR_6680051421,420,-1,32,-12,-2,5,2,7,-2,5,3,-5,5,0,0,2,2,0,1,1,0,-12,-1,-2,-3,5,-4,0,0,-1,-1,-1,1,4,-1
KR_6686570656,420,1,66,-5,-2,-1,3,2,1,1,2,0,1,1,-6,6,0,4,0,4,0,-3,4,3,-5,2,-1,0,0,-1,0,0,-1,5,-1
KR_6747428720,420,2,-11,7,-4,1,0,1,2,2,4,3,0,3,-5,5,0,-5,7,2,1,1,-2,5,-5,0,-1,0,-1,-1,1,-1,1,5,-1
KR_6605122725,420,-1,3,19,-1,-4,4,0,-2,7,5,1,3,4,3,3,6,1,0,1,1,10,-7,-3,-3,6,-2,0,-1,-1,1,1,1,3,-1
KR_6766571288,420,-5,-62,-2,-11,-2,4,2,0,3,3,-4,4,0,0,3,3,-5,6,1,0,-5,-54,0,-4,4,3,0,0,-1,-1,-1,-1,3,-1
KR_6645152747,420,-2,19,1,-5,-1,2,1,-6,6,0,-2,2,0,2,0,2,2,0,2,0,-4,-6,-3,-4,7,4,0,-1,1,-1,1,-1,3,-1
KR_6761614994,440,0,42,-1,-7,0,3,3,-3,3,0,-3,5,2,0,4,4,-1,2,1,0,-17,2,-3,-2,5,0,0,1,-1,-1,-1,-1,5,-1
KR_6764508590,420,0,34,-31,-3,-1,1,0,-9,9,0,2,1,3,2,3,5,3,1,4,1,-5,-179,0,-5,5,3,0,-1,-1,-1,1,1,5,-1
KR_6754152152,420,1,-12,24,2,2,0,2,2,2,4,-5,7,2,-2,5,3,5,5,10,0,-4,-2,-3,-4,7,-3,0,1,1,1,1,1,6,-1
KR_6729232108,420,-2,-49,-6,-4,1,2,3,1,2,3,-1,3,2,3,1,4,-8,8,0,0,3,-9,5,-5,0,0,0,-1,-1,-1,-1,1,6,-1
KR_6714950159,420,1,-19,4,-4,4,1,5,-3,4,1,1,0,1,-5,5,0,-1,1,0,1,-11,-6,-2,-4,6,-3,0,-1,-1,1,-1,1,3,-1
KR_6683559286,420,0,-14,32,-7,-4,6,2,-2,4,2,0,1,1,0,4,4,-1,1,0,-2,-5,-2,3,-7,4,-3,0,1,1,-1,1,-1,3,-1
KR_6738328928,420,1,-1,-2,0,-2,2,0,-1,3,2,0,1,1,-1,2,1,4,1,5,0,4,-10,1,-7,6,4,0,0,-1,-1,0,-1,6,-1
KR_6740521857,440,-6,-83,-9,-23,-8,9,1,-5,5,0,-2,5,3,-8,9,1,0,0,0,0,-14,0,0,-5,5,-3,0,-3,1,0,-1,-1,4,-1
KR_6765560984,420,-1,29,11,-4,-1,2,1,-1,5,4,-1,1,0,-1,5,4,0,1,1,0,-4,119,-2,-4,6,1,0,-1,1,1,-1,-1,2,-1
KR_6707257887,420,-2,66,-16,-6,-2,2,0,-2,3,1,-1,3,2,1,0,1,-2,2,0,-1,-14,-8,-1,-4,5,6,0,-1,-1,-1,-1,-1,4,-1
KR_6714960146,420,0,40,-32,0,-1,2,1,0,0,0,1,1,2,2,3,5,-2,2,0,0,1,138,0,-7,7,-1,0,0,-1,-1,-1,-1,4,-1
KR_6760597582,420,-3,-43,-8,1,1,1,2,-1,3,2,1,2,3,0,5,5,0,1,1,1,4,1,-3,-2,5,-4,0,0,0,1,0,1,0,-1
KR_6646683596,420,-8,-82,-24,-13,-2,4,2,-10,10,0,2,0,2,-2,3,1,-1,1,0,-1,-19,3,1,-7,6,-1,0,-1,-1,-1,-1,-1,1,-1
KR_6749895610,420,0,8,-25,-1,4,3,7,-2,3,1,0,1,1,-1,1,0,-2,2,0,0,-4,-10,4,-5,1,-2,0,-1,-1,1,-1,1,1,-1
KR_6753678329,420,-6,-65,-20,-11,-2,2,0,2,3,5,-2,3,1,-1,3,2,-8,9,1,0,-8,-7,2,-10,8,-6,0,-1,-1,-1,-1,-1,3,-1
KR_6756157549,440,-2,-74,16,-4,0,0,0,6,1,7,-6,6,0,-4,5,1,0,3,3,-1,-5,3,0,-3,3,-1,0,-1,-1,-1,-1,-1,3,-1
KR_6730385114,420,-3,-15,-12,-11,-1,1,0,1,3,4,-2,2,0,-6,8,2,-3,3,0,0,-12,33,0,-7,7,-30,0,-2,-1,-1,-1,-1,1,-1
KR_6750346592,440,4,28,7,0,-2,2,0,4,1,5,2,0,2,-6,6,0,2,1,3,0,5,1,-3,-4,7,7,0,1,-1,1,1,-1,4,-1
KR_6719496701,420,-1,29,-20,-1,4,0,4,0,1,1,-3,3,0,-2,3,1,0,1,1,0,-13,5,1,-8,7,-2,0,1,-1,-1,-1,1,3,-1
KR_6762295926,420,-3,21,-13,-8,-1,2,1,-2,2,0,-3,5,2,-3,5,2,1,0,1,0,-13,-14,0,-3,3,-1,0,1,-1,1,1,-1,2,-1
KR_6761700612,420,1,35,0,0,1,2,3,-3,5,2,2,3,5,1,4,5,-1,4,3,0,-1,-22,-3,-2,5,4,0,-1,1,0,-1,1,4,-1
KR_6603010080,420,-2,-37,-20,-2,5,1,6,-6,7,1,-1,4,3,0,1,1,0,0,0,0,-3,-10,-1,-4,5,-1,0,-1,-1,-1,-1,1,1,-1
KR_6679845127,420,-2,-28,16,-6,-2,3,1,-1,3,2,0,0,0,-3,7,4,0,3,3,0,-5,-2,-5,-4,9,-2,0,-1,1,0,-1,-1,3,-1
KR_6764827245,420,-5,-63,4,-13,-5,6,1,-2,4,2,-2,6,4,-2,2,0,-2,2,0,0,-7,-7,-1,-4,5,-4,0,-2,0,0,-1,-1,0,-1
KR_6738830376,420,-2,-23,-63,-3,-4,5,1,0,3,3,0,2,2,1,1,2,0,1,1,0,0,-438,-1,-4,5,-3,0,0,1,0,-1,1,2,-1
KR_6737191629,420,-2,16,-40,-10,2,0,2,-3,7,4,-2,3,1,-5,8,3,-2,2,0,0,-11,10,4,-9,5,-7,0,-1,-1,-1,-1,-1,1,-1
KR_6737587805,420,0,-25,-16,2,-5,5,0,1,3,4,2,1,3,2,0,2,2,0,2,0,5,11,0,-4,4,-2,0,-2,-1,-1,-1,1,5,-1
KR_6634768911,420,-3,8,-16,0,0,2,2,0,2,2,3,0,3,-3,3,0,0,0,0,-1,-1,0,0,-6,6,1,0,1,-1,1,1,-1,2,-1
KR_6695418890,420,-4,-17,16,-10,1,0,1,-3,5,2,0,1,1,-5,9,4,-3,4,1,-1,-14,-9,-1,-7,8,-3,0,-2,1,1,-1,-1,1,-1
KR_6746363170,420,-6,-44,20,-11,-2,2,0,-3,5,2,-4,4,0,-2,4,2,0,0,0,-2,-18,-9,-3,-6,9,-5,0,-2,-1,-1,-1,-1,5,-1
KR_6679111140,420,-6,-40,-68,-6,-2,2,0,0,3,3,-3,5,2,-3,5,2,2,0,2,0,-12,-5,-3,-3,6,-1,0,0,-1,-1,-1,1,6,-1
KR_6702394415,420,-3,26,26,-11,-6,7,1,1,1,2,-2,5,3,-3,5,2,-1,1,0,0,-11,-207,-4,-3,7,-14,0,-1,1,-1,1,1,4,-1
KR_6746407589,420,-1,42,-19,-2,0,0,0,-1,4,3,-2,4,2,1,2,3,0,1,1,0,3,-6,3,-7,4,6,0,2,1,-1,1,1,2,-1
KR_6739720785,420,-1,11,-24,-4,1,0,1,1,1,2,1,1,2,-4,7,3,-3,3,0,0,-4,3,3,-7,4,2,0,-1,-1,-1,-1,-1,2,-1
KR_6656025962,440,-2,-19,8,-6,0,4,4,-2,4,2,1,0,1,-3,7,4,-2,3,1,0,-6,-6,0,-4,4,-1,0,0,-1,-1,0,-1,4,-1
KR_6695222234,420,-4,10,-40,-8,3,2,5,-3,4,1,-1,3,2,-5,6,1,-2,2,0,1,-10,6,4,-8,4,-4,0,-2,-1,1,-1,1,4,-1
KR_6758324835,420,-6,-70,-57,-9,-3,4,1,2,1,3,-7,8,1,0,5,5,-1,1,0,1,-8,2,4,-10,6,-3,0,-1,-1,1,-1,1,3,-1
KR_6741873928,420,-1,-50,16,2,-3,3,0,0,3,3,-3,3,0,8,0,8,0,0,0,0,4,-3,-2,-3,5,0,0,-2,-1,1,-1,-1,1,-1
KR_6752364318,420,1,-37,8,-4,-2,3,1,0,3,3,-1,2,1,-1,4,3,0,1,1,0,-1,20,-3,-4,7,4,0,0,-1,-1,1,-1,6,-1
KR_6387918750,420,0,16,8,1,0,3,3,1,4,5,3,0,3,0,2,2,-3,3,0,0,-3,4,2,-7,5,-2,0,0,-1,1,0,1,3,-1
KR_6367337284,440,-3,-9,23,-5,-4,5,1,1,2,3,-2,4,2,3,0,3,-3,4,1,0,-6,0,0,0,0,5,0,-1,-1,-1,-1,1,2,-1
KR_6666201751,420,-1,-18,28,-3,-4,4,0,4,0,4,-1,5,4,-3,5,2,1,1,2,0,0,32,-1,-5,6,-15,0,0,1,-1,0,-1,5,-1
KR_6765584319,440,0,-14,-12,-3,3,3,6,-4,4,0,4,1,5,-4,4,0,-2,5,3,-1,-1,4,4,-9,5,-7,0,0,1,1,0,-1,2,-1
KR_6766138796,420,-3,-9,4,3,-1,3,2,-1,5,4,-1,3,2,4,1,5,2,0,2,0,7,-102,2,-6,4,0,0,0,0,0,0,-1,0,-1
KR_6760158827,420,3,-29,-6,4,-1,2,1,2,2,4,5,1,6,-3,4,1,1,0,1,0,5,100,-2,-4,6,2,0,0,1,-1,0,-1,4,-1
KR_6763080312,420,1,-26,-10,0,-1,3,2,-4,7,3,1,1,2,1,1,2,3,1,4,-2,-5,-5,8,-11,3,-2,0,0,-1,1,0,-1,6,-1
KR_6759705864,420,3,-33,7,6,5,0,5,2,4,6,-1,1,0,-2,6,4,2,0,2,0,1,6,3,-6,3,-3,0,0,-1,-1,0,1,5,-1
KR_6678630082,420,1,-13,-3,-1,4,0,4,2,3,5,-4,4,0,-2,3,1,-1,3,2,0,-6,3,1,-5,4,-4,0,1,0,-1,1,1,0,-1
KR_6705378687,420,-5,-114,0,-15,-2,4,2,-7,7,0,0,1,1,-4,5,1,-2,2,0,0,-26,-12,-5,-9,14,0,0,-1,-1,1,-1,-1,2,-1
KR_6728035018,420,-7,-70,-5,-7,1,1,2,-4,5,1,-2,5,3,-2,2,0,0,0,0,0,-9,13,-4,-1,5,-5,0,-1,-1,0,-1,-1,2,-1
KR_6626434887,420,-3,-44,12,-8,-3,3,0,-9,10,1,3,0,3,-1,3,2,2,1,3,0,-10,-1,-3,-5,8,-5,0,0,-1,1,1,-1,1,-1
KR_6762622707,420,-3,-26,-29,-2,-3,4,1,1,3,4,-1,1,0,0,2,2,1,0,1,-1,0,-22,-3,-3,6,-2,0,0,0,0,0,-1,0,-1
KR_6531649092,420,-5,-71,-40,-6,-3,5,2,2,5,7,-1,3,2,-4,6,2,0,2,2,0,-2,0,2,-7,5,-3,0,-3,1,-1,-1,1,2,-1
KR_6509405630,420,-4,-66,-26,-10,-3,3,0,2,1,3,-1,3,2,-8,9,1,0,1,1,0,-13,-28,-2,-4,6,0,0,0,-1,1,-1,1,1,-1
KR_6756179695,420,1,37,-13,-1,0,3,3,-3,7,4,-1,1,0,0,4,4,3,0,3,0,-2,-2,5,-7,2,1,0,0,-1,0,1,-1,3,-1
KR_6656899756,420,-2,-19,4,-1,1,1,2,-5,6,1,6,2,8,-3,6,3,0,1,1,0,2,-2,-1,-3,4,0,0,0,-1,1,1,-1,4,-1
KR_6407771415,420,-4,-58,-4,-11,-2,2,0,-8,8,0,1,0,1,-2,8,6,0,1,1,1,-7,-7,-4,-4,8,2,0,-1,-1,-1,-1,1,4,-1
KR_6627940699,420,-5,-47,-24,-11,-1,1,0,-6,7,1,2,2,4,-7,7,0,1,3,4,0,-8,-2,0,-7,7,-5,0,-2,-1,-1,-1,-1,4,-1
KR_6765588083,440,-1,15,21,-4,0,0,0,-5,5,0,2,0,2,1,0,1,-2,3,1,0,-8,16,3,-8,5,-2,0,0,1,-1,0,-1,5,-1
KR_6646459466,420,-1,-27,-31,3,0,2,2,0,5,5,0,4,4,4,2,6,-1,1,0,3,7,-6,0,-5,5,-2,0,-1,1,-1,-1,1,3,-1
KR_6659333033,420,-10,-129,-103,-22,-5,6,1,-10,12,2,-3,6,3,-3,4,1,-1,2,1,-3,-12,-144,1,-3,2,-3,-1,-4,-1,-1,-1,-1,1,-1
KR_6278082571,420,1,-13,-14,4,-3,3,0,4,1,5,-1,3,2,1,5,6,3,0,3,0,4,-292,1,-5,4,0,0,-1,-1,1,-1,-1,3,-1
KR_6759703512,420,1,-10,12,-3,1,0,1,-5,8,3,2,0,2,1,1,2,-2,2,0,0,-4,-3,-5,-3,8,-3,0,-1,-1,-1,-1,-1,5,-1
KR_6738435398,420,0,12,-11,-1,-2,2,0,-4,5,1,-2,2,0,6,0,6,1,0,1,0,6,12,-4,-5,9,-2,0,-1,1,-1,1,-1,5,-1
KR_6560427068,420,2,31,-8,3,7,1,8,-3,5,2,3,2,5,-4,4,0,0,0,0,0,-16,-4,1,-4,3,5,0,0,-1,0,1,1,4,-1
KR_6734470644,440,-2,-12,-7,-7,-4,4,0,2,0,2,-2,2,0,-6,7,1,3,1,4,-1,-6,12,0,-1,1,-3,0,-1,-1,-1,-1,-1,5,-1
KR_6697453014,440,3,51,36,7,0,4,4,4,3,7,-1,5,4,4,2,6,0,1,1,0,15,-72,2,-7,5,5,0,-1,-1,-1,-1,1,6,-1
KR_6761077792,420,-1,-32,-8,-6,-4,4,0,-1,5,4,-4,4,0,3,2,5,0,1,1,1,-4,-49,-6,-1,7,26,0,0,-1,-1,-1,1,6,-1
KR_6750561550,420,-2,-38,14,-6,-1,2,1,1,0,1,-3,6,3,-2,3,1,-1,2,1,0,-13,-48,2,-5,3,26,0,-1,-1,0,-1,1,6,-1
KR_6766220383,420,-5,-162,-21,-10,-4,5,1,2,0,2,1,6,7,-8,11,3,-1,1,0,-2,-2,5,0,-3,3,-5,0,-1,-1,0,-1,-1,1,-1
KR_6712203671,420,-2,-43,-14,-5,-2,3,1,5,1,6,-1,3,2,-6,6,0,-1,1,0,0,-11,-6,-3,-2,5,1,0,-1,-1,1,-1,-1,4,-1
KR_6703389733,440,1,33,20,-3,-1,3,2,-3,3,0,10,0,10,-12,14,2,3,2,5,-2,-20,210,3,-7,4,-3,0,1,-1,1,1,-1,1,-1
KR_6705346520,420,-3,-15,-21,-7,-2,4,2,0,1,1,-2,2,0,-1,6,5,-2,2,0,0,-3,-5,-4,-4,8,1,0,-2,-1,-1,-1,1,1,-1
KR_6740863173,440,0,4,-26,4,-4,4,0,-1,3,2,2,3,5,5,3,8,2,1,3,1,16,-9,-4,-4,8,1,0,1,0,0,1,1,0,-1
KR_6744101213,420,3,37,-4,9,6,0,6,2,1,3,1,3,4,2,4,6,-2,2,0,0,5,-435,1,-7,6,0,0,1,1,1,1,1,3,-1
KR_6734307015,440,-2,-30,-10,-5,-1,2,1,-1,4,3,-4,5,1,1,0,1,0,2,2,0,-4,4,0,-9,9,-4,0,0,-1,-1,0,-1,5,-1
KR_6746781616,420,-1,-12,19,1,-2,2,0,2,2,4,-1,3,2,4,0,4,-2,3,1,0,5,12,4,-6,2,-1,0,-1,1,1,-1,-1,1,-1
KR_6604203837,420,-5,-84,-28,-12,-2,2,0,-4,6,2,3,0,3,-9,9,0,0,0,0,-1,-15,-1,0,-8,8,-1,0,-1,-1,0,-1,-1,6,-1
KR_6762320821,420,0,-1,-8,-3,0,0,0,-3,4,1,2,0,2,-2,5,3,0,0,0,-1,-9,-8,-3,-4,7,1,0,0,-1,-1,0,-1,4,-1
KR_6751129722,440,0,-27,8,0,1,3,4,0,1,1,-3,4,1,3,2,5,-1,2,1,0,-2,38,-4,-6,10,-20,0,2,1,-1,1,1,1,-1
KR_6720992193,440,-2,-57,7,-3,1,1,2,2,2,4,1,1,2,-7,9,2,0,0,0,-1,-1,-48,1,-6,5,23,0,0,-1,1,0,-1,1,-1
KR_6750269882,420,-2,-89,-32,-6,-2,3,1,-3,3,0,2,1,3,-3,5,2,0,0,0,0,-5,37,-3,-1,4,2,0,-1,-1,-1,-1,-1,2,-1
KR_6764334332,420,-5,-81,-28,-6,-4,7,3,-4,6,2,-2,2,0,4,3,7,0,0,0,0,-1,18,-1,-5,6,-6,0,-1,-1,-1,-1,-1,2,-1
KR_6761638460,420,1,49,8,5,0,1,1,5,1,6,1,1,2,-1,5,4,0,1,1,0,-1,19,-9,-1,10,6,0,1,1,-1,1,1,2,-1
KR_6766187445,420,0,-83,12,-3,-4,5,1,0,5,5,3,0,3,0,4,4,-2,2,0,1,-5,3,0,-4,4,-1,0,-1,1,-1,-1,1,3,-1
KR_6745935482,420,1,-44,4,-1,0,0,0,-2,5,3,-2,3,1,1,1,2,2,0,2,0,3,22,-3,-4,7,1,0,-1,1,-1,-1,1,6,-1
KR_6751499488,420,0,-5,-2,-2,-3,4,1,0,1,1,1,2,3,-2,5,3,2,0,2,0,4,-1,-7,-3,10,2,0,0,-1,1,0,-1,4,-1
KR_6765637572,420,-2,-23,-23,-9,-2,4,2,-5,5,0,-1,1,0,-1,6,5,0,3,3,0,-13,7,3,-8,5,-4,0,-1,0,0,-1,-1,0,-1
KR_6756007117,420,2,-11,12,-2,1,2,3,2,2,4,1,1,2,-3,4,1,-3,3,0,0,4,2,-5,-4,9,2,0,0,-1,0,0,1,2,-1
KR_6739601119,420,0,-8,-43,2,4,0,4,-6,7,1,2,0,2,2,1,3,0,1,1,-2,-4,9,2,-10,8,3,0,-2,1,1,-1,-1,4,-1
KR_6761600739,440,-8,-140,-64,-22,-1,4,3,-5,7,2,-8,9,1,-6,7,1,-2,3,1,-1,-7,-12,-2,-3,5,0,0,-3,-1,0,-1,-1,3,-1
KR_6758047814,440,1,-29,-12,1,1,1,2,-1,1,0,-1,2,1,3,1,4,-1,2,1,0,4,-1,-1,-4,5,3,0,0,-1,-1,0,-1,6,-1
KR_6754543122,420,0,85,12,2,1,0,1,-3,4,1,2,3,5,0,0,0,2,1,3,-1,-4,-2,3,-5,2,-2,0,1,1,1,-1,-1,1,-1
KR_6758060476,440,-5,-40,-20,-12,-3,3,0,1,2,3,-2,4,2,-6,7,1,-2,2,0,0,-6,-5,1,-3,2,3,0,-2,0,0,-1,1,0,-1
KR_6275192817,420,-1,-28,0,-4,0,1,1,-5,6,1,1,2,3,0,2,2,0,0,0,0,-9,0,1,-5,4,-4,0,-1,1,-1,-1,1,4,-1
KR_6756206655,420,2,-9,20,0,0,3,3,-2,4,2,1,2,3,0,3,3,1,0,1,0,0,12,2,-6,4,3,0,1,-1,-1,1,-1,6,-1
KR_6757565293,420,-2,-40,-22,-10,-5,5,0,-2,4,2,-2,3,1,1,1,2,-2,2,0,0,-7,3,-2,-2,4,-2,0,0,-1,-1,-1,-1,6,-1
KR_6435402918,420,1,-15,14,9,5,0,5,3,2,5,1,2,3,0,3,3,0,1,1,0,9,-9,-2,-5,7,-1,0,1,0,1,1,1,0,-1
KR_6764943854,420,-1,-44,13,-10,0,2,2,-1,8,7,-4,6,2,-4,6,2,-1,2,1,0,-14,5,1,-5,4,-1,0,-1,-1,1,-1,-1,5,-1
KR_6745227657,420,-2,-11,-9,-2,-3,4,1,0,2,2,-4,5,1,5,0,5,0,0,0,0,-1,-1,3,-7,4,0,0,2,-1,1,1,1,1,-1
KR_6749892708,420,-6,-104,-7,-7,-2,2,0,-3,4,1,-1,2,1,-1,2,1,0,1,1,-2,-10,10,-1,-3,4,-2,0,-1,1,-1,-1,-1,3,-1
KR_6485516461,420,0,25,-3,0,3,2,5,-2,4,2,0,2,2,1,1,2,-2,2,0,0,-4,-2,6,-7,1,-5,0,-1,-1,-1,1,1,5,-1
KR_6755008566,440,1,-14,8,-10,-2,4,2,-7,7,0,-1,2,1,-1,8,7,1,1,2,-2,-12,-15,-4,0,4,-1,0,-1,-1,1,-1,-1,4,-1
KR_6684635048,420,-3,-36,-51,-3,-2,2,0,-3,5,2,0,2,2,3,2,5,-1,1,0,-1,5,40,0,-5,5,-1,0,-1,-1,-1,-1,-1,5,-1
KR_6648895062,420,-2,10,-8,-5,-2,3,1,0,1,1,-1,3,2,-1,2,1,-1,1,0,0,-8,-3,0,-6,6,0,0,0,-1,1,-1,1,4,-1
KR_6761358090,420,1,-19,14,-3,-2,3,1,4,1,5,-3,3,0,-1,2,1,-1,1,0,-2,-1,-10,1,-5,4,-4,0,0,0,1,0,-1,0,-1
KR_6695908174,420,0,-21,-8,2,0,1,1,1,2,3,-4,5,1,1,1,2,4,0,4,0,3,-13,5,-8,3,1,0,0,0,1,0,-1,0,-1
KR_6756855920,420,1,60,9,-5,-1,2,1,-5,6,1,-2,4,2,3,3,6,0,0,0,0,-3,-9,-6,-3,9,5,0,0,0,0,0,1,0,-1
KR_6713196750,420,-1,-15,-8,0,3,0,3,4,2,6,-2,5,3,-5,5,0,0,2,2,0,4,-5,4,-8,4,1,0,1,-1,1,1,-1,6,-1
KR_6686690648,420,-2,-2,12,-8,-3,4,1,-1,3,2,-2,6,4,-1,3,2,-1,2,1,0,-11,-12,-3,-3,6,2,0,-1,1,-1,-1,1,2,-1
KR_6765666650,420,-3,35,-5,-10,1,1,2,-3,3,0,-2,3,1,-3,4,1,-3,3,0,0,-15,4,1,-4,3,0,0,1,-1,1,1,-1,3,-1
KR_6714741787,420,-5,-83,-3,-17,-3,3,0,-4,7,3,-3,4,1,-4,5,1,-3,3,0,0,-21,-23,-5,-1,6,6,0,-2,-1,0,-1,-1,4,-1
KR_6756018049,420,0,54,12,-2,0,1,1,-1,4,3,-1,2,1,0,3,3,0,0,0,0,-5,-14,-3,-4,7,4,0,0,1,1,0,1,3,-1
KR_6760716592,420,0,-20,1,-4,0,3,3,-3,4,1,-5,7,2,4,0,4,0,0,0,0,-4,-4,-4,-3,7,4,0,0,1,-1,0,1,5,-1
KR_6749477942,420,1,55,5,0,2,3,5,0,2,2,1,3,4,1,3,4,-4,4,0,0,-5,-30,-6,-3,9,2,0,0,-1,1,1,1,1,-1
KR_6755520263,420,-2,-116,-44,-4,-1,2,1,0,3,3,-2,3,1,-1,2,1,0,0,0,-3,-7,-15,1,-6,5,0,0,-1,-1,1,-1,-1,2,-1
KR_6748475677,420,0,-20,-18,-4,-1,1,0,-3,4,1,-1,2,1,-1,2,1,2,0,2,0,-6,21,-3,-3,6,-20,0,0,-1,0,0,-1,2,-1
KR_6716151654,420,-4,-106,7,-9,-4,4,0,0,2,2,-1,4,3,-4,4,0,0,2,2,-1,-6,5,0,-4,4,-2,0,-1,-1,-1,-1,-1,6,-1
KR_6758765134,420,-5,-7,-32,-8,-3,4,1,-3,3,0,1,2,3,-3,4,1,0,1,1,0,-10,-32,-1,-4,5,1,0,-2,-1,-1,-1,1,5,-1
KR_6758808228,420,-4,-67,-17,-2,0,1,1,-1,1,0,0,0,0,-1,6,5,0,0,0,1,-3,-42,1,-8,7,10,0,-2,-1,-1,-1,-1,1,-1
KR_6761612206,420,0,57,9,1,1,1,2,-5,5,0,1,1,2,1,3,4,3,1,4,1,1,4,-5,-4,9,3,0,2,1,-1,1,1,2,-1
KR_6631385212,420,-1,-11,-28,-3,-2,2,0,3,2,5,-1,2,1,-2,2,0,-1,1,0,0,-2,1,1,-6,5,-3,0,-1,-1,-1,-1,1,4,-1
KR_6604084882,440,-2,-8,-4,-2,-4,4,0,0,7,7,4,1,5,-2,3,1,0,1,1,0,-8,-17,-2,-2,4,3,0,-1,-1,0,-1,1,6,-1
KR_6703943589,420,-2,-15,-16,-1,-2,2,0,2,1,3,-1,3,2,0,4,4,0,2,2,0,3,15,0,-8,8,-6,0,0,-1,1,0,1,1,-1
KR_6707215046,420,2,-17,-1,-1,3,2,5,-2,5,3,0,0,0,-3,7,4,1,0,1,0,-4,2,2,-7,5,-5,0,0,1,-1,0,-1,2,-1
KR_6743988190,440,-5,-74,-22,-10,0,0,0,-2,6,4,-1,4,3,-2,5,3,-5,5,0,0,-7,-6,2,-5,3,-1,0,-1,-1,-1,-1,1,3,-1
KR_6686390664,440,1,54,11,3,2,2,4,0,5,5,-1,3,2,4,5,9,-2,4,2,1,3,9,3,-6,3,-4,0,0,0,-1,1,1,0,-1
KR_6755661459,420,-1,-69,-16,-6,1,2,3,3,0,3,-1,2,1,-8,9,1,-1,1,0,-1,-6,-4,-2,-5,7,-6,0,-1,-1,-1,-1,-1,5,-1
KR_6756729367,420,-3,-35,-8,-11,0,0,0,-2,3,1,0,2,2,-7,9,2,-2,2,0,-1,-19,-12,-5,-3,8,1,0,-3,-1,1,-1,-1,3,-1
KR_6758483376,420,-4,-69,-25,-4,-3,3,0,1,4,5,2,2,4,-4,6,2,0,1,1,0,3,11,4,-9,5,-10,0,-1,-1,-1,-1,-1,3,-1
KR_6685204358,420,-7,-145,-6,-8,-2,2,0,0,3,3,-6,7,1,-1,2,1,1,0,1,-1,-7,-10,-3,-2,5,0,0,-5,-1,-1,-1,-1,6,-1
KR_6736024613,420,-4,-45,-20,-10,-8,8,0,2,0,2,-6,7,1,-1,5,4,3,1,4,0,0,-12,-6,-1,7,-2,0,-2,1,-1,-1,-1,1,-1
KR_6753195303,420,-4,-77,-27,-4,-4,5,1,0,2,2,3,2,5,-3,4,1,0,1,1,-1,3,-4,-1,0,1,0,0,-1,-1,1,-1,-1,5,-1
KR_6722604191,420,-2,-82,5,-6,2,3,5,-5,6,1,-1,3,2,-3,5,2,1,0,1,-2,-11,-4,0,-7,7,-4,0,-2,-1,1,-1,-1,4,-1
KR_6648415505,420,-3,-39,-32,-17,2,2,4,-4,5,1,-1,5,4,-10,12,2,-4,4,0,-1,-24,7,0,-5,5,1,0,-4,-1,-1,-1,-1,4,-1
KR_6757974998,420,0,32,28,-3,0,2,2,-1,3,2,-2,2,0,-3,5,2,3,0,3,0,-4,50,0,-4,4,4,0,0,0,0,0,-1,0,-1
KR_6682700350,420,1,39,12,-2,2,1,3,-2,3,1,1,4,5,-1,3,2,-2,2,0,0,2,-9,-3,-3,6,1,0,0,1,1,1,-1,1,-1
KR_6736928540,420,-3,-50,0,-2,-1,4,3,-1,1,0,2,0,2,-2,3,1,0,1,1,0,-1,111,-5,-3,8,-4,0,0,1,1,0,1,3,-1
KR_6716618744,420,-4,-40,-16,-4,-3,4,1,4,2,6,-2,4,2,-3,5,2,0,0,0,-1,-3,-15,-1,-5,6,0,0,-2,-1,1,-1,-1,1,-1
KR_6748641418,420,-3,-52,-16,-11,-2,3,1,-6,8,2,-3,4,1,1,0,1,-1,2,1,0,-6,3,3,-6,3,-2,0,0,1,-1,-1,-1,6,-1
KR_6736303491,420,-6,-87,-35,-16,-2,3,1,-7,9,2,-5,5,0,-3,4,1,1,0,1,0,-17,44,-6,-3,9,-2,0,-2,-1,-1,-1,-1,5,-1
KR_6765943603,420,-2,-53,-1,-4,2,1,3,-4,5,1,0,2,2,-2,3,1,0,1,1,0,-3,-7,-1,-7,8,-4,0,-2,-1,-1,-1,-1,4,-1
KR_6747729898,420,-4,-9,-15,-11,4,0,4,-5,8,3,-1,5,4,-10,12,2,1,1,2,-1,-19,-5,4,-8,4,-7,0,0,-1,1,0,-1,5,-1
KR_6701568341,420,-5,-72,-8,-6,-2,3,1,-2,3,1,-5,5,0,2,0,2,1,1,2,0,-14,3,0,-5,5,-2,0,1,-1,-1,1,1,3,-1
KR_6728783844,420,-3,-36,-3,-15,0,1,1,-3,4,1,-5,5,0,-6,6,0,-1,2,1,0,-19,-7,-2,-3,5,5,0,-2,-1,1,-1,-1,1,-1
KR_6761029832,440,-1,-76,29,0,4,1,5,-4,7,3,-2,3,1,2,0,2,0,3,3,1,-6,2,-1,-2,3,-2,0,-3,1,1,-1,1,3,-1
KR_6728235781,440,2,21,16,1,2,1,3,-3,3,0,5,6,11,0,1,1,-3,3,0,0,-4,-17,-2,-5,7,-2,0,1,-1,1,1,1,1,-1
KR_6675043859,420,-2,2,-21,-9,-3,5,2,-7,9,2,-3,4,1,1,4,5,3,1,4,0,-7,9,0,-4,4,1,0,-2,-1,1,-1,-1,1,-1
KR_6622122952,420,-1,49,-16,-3,0,1,1,-8,8,0,5,0,5,-1,7,6,1,2,3,-3,-8,1,4,-8,4,2,0,0,-1,-1,1,-1,2,-1
KR_6751064752,420,3,70,0,3,4,3,7,2,0,2,-2,8,6,-1,3,2,0,0,0,1,-1,314,2,-4,2,0,0,1,-1,1,1,1,6,-1
KR_6629521975,420,-2,-24,5,-9,0,1,1,-5,5,0,-2,2,0,-1,2,1,-1,2,1,0,-15,0,-1,-5,6,-5,0,-1,1,-1,-1,-1,4,-1
KR_6757935923,440,0,-56,28,-2,-5,6,1,4,1,5,0,2,2,-1,5,4,0,1,1,-1,5,36,4,-6,2,-21,0,-2,1,-1,-1,-1,3,-1
KR_6746701482,440,-1,-86,-3,-1,2,1,3,0,1,1,0,2,2,-3,6,3,0,1,1,0,1,2,0,-4,4,1,0,-1,-1,-1,-1,-1,1,-1
KR_6759640165,420,1,-49,8,6,-1,1,0,1,2,3,4,2,6,1,1,2,1,2,3,0,7,-4,-3,-3,6,6,0,0,1,-1,1,1,4,-1
KR_6761248467,420,1,0,-31,6,4,0,4,3,2,5,-3,5,2,2,4,6,0,0,0,0,10,0,2,-8,6,1,0,0,-1,-1,1,1,6,-1
KR_6744638052,420,-2,-80,16,-1,-2,3,1,2,0,2,-2,3,1,0,7,7,1,0,1,1,2,122,0,-5,5,4,0,0,1,-1,-1,1,6,-1
KR_6757221164,420,0,-52,40,0,0,1,1,-2,3,1,0,2,2,3,2,5,-1,1,0,0,2,-22,0,-3,3,19,0,0,1,1,1,-1,1,-1
KR_6765745790,420,-1,17,3,-5,-3,5,2,-3,4,1,-2,3,1,2,1,3,1,0,1,0,1,-17,-3,-4,7,4,0,-1,1,-1,-1,-1,2,-1
KR_6682821880,420,-3,-50,27,-9,-5,5,0,-8,10,2,3,2,5,2,2,4,-1,2,1,0,-14,62,1,-5,4,2,0,0,-1,1,0,1,4,-1
KR_6730272487,420,0,-64,-5,1,1,2,3,5,2,7,-3,4,1,-2,5,3,0,1,1,0,6,-4,-1,-5,6,-2,0,0,1,-1,0,1,4,-1
KR_6753637773,420,-4,1,-38,-4,-4,4,0,0,4,4,0,3,3,0,1,1,0,2,2,0,-3,138,-4,-4,8,-1,0,-2,-1,-1,-1,1,3,-1
KR_6752059326,420,-3,-41,-15,-5,-4,6,2,1,3,4,1,2,3,-5,5,0,2,0,2,0,-10,-7,-2,-3,5,5,0,0,-1,0,0,-1,4,-1
KR_6692358819,420,-2,-38,-4,-4,7,0,7,-1,2,1,-5,6,1,-4,5,1,-1,2,1,0,-5,9,0,-4,4,3,0,1,-1,1,1,-1,3,-1
KR_6749853534,420,-8,-101,-40,-13,-5,6,1,-3,3,0,-2,4,2,-1,5,4,-2,4,2,4,-3,9,3,-7,4,0,0,-2,-1,0,-1,1,4,-1
KR_6670240480,440,1,11,12,-1,-3,3,0,-3,4,1,4,1,5,-1,4,3,2,0,2,0,-5,90,-2,-6,8,-2,0,-1,1,-1,-1,1,1,-1
KR_6597950328,420,-4,29,-43,-10,-2,3,1,-3,5,2,-4,4,0,-1,4,3,0,1,1,0,-14,-9,-5,-2,7,0,0,-3,-1,-1,-1,1,1,-1
KR_6760676395,420,-3,-76,-15,-9,1,1,2,0,1,1,-6,6,0,-5,7,2,1,2,3,-1,-11,426,-5,-1,6,0,0,0,-1,1,-1,-1,6,-1
KR_6757330542,420,-2,33,-16,-3,-2,3,1,0,3,3,-1,2,1,-2,3,1,2,0,2,0,4,-29,2,-5,3,-1,0,1,-1,1,1,1,6,-1
KR_6271034487,420,1,63,-32,1,-3,3,0,2,1,3,2,1,3,-2,2,0,2,1,3,0,2,-6,4,-8,4,0,0,-1,1,-1,-1,1,4,-1
KR_6727308352,420,1,0,-16,-2,2,1,3,-3,4,1,-4,5,1,4,1,5,-1,1,0,-1,1,-5,4,-6,2,2,0,0,-1,1,0,-1,2,-1
KR_6742732516,420,1,-12,31,2,1,1,2,0,4,4,0,3,3,0,4,4,1,1,2,0,1,21,-1,-5,6,2,0,1,1,1,1,1,3,-1
KR_6686544798,420,-4,-14,-7,-4,-3,4,1,0,3,3,1,0,1,-2,4,2,0,3,3,0,-16,356,1,-6,5,0,0,-2,-1,-1,-1,1,6,-1
KR_6687736773,420,0,-1,-12,-1,1,1,2,-4,5,1,-2,4,2,3,4,7,1,1,2,0,-3,-31,-4,-3,7,-4,0,0,-1,1,0,-1,6,-1
KR_6624262432,420,-2,-29,-11,-7,3,2,5,2,3,5,-6,8,2,-4,4,0,-2,3,1,1,-1,-8,0,-3,3,-1,0,-2,-1,-1,-1,1,6,-1
KR_6749560047,440,-2,104,-21,-9,3,3,6,-4,6,2,-3,4,1,-1,8,7,-4,6,2,-1,-23,3,2,-9,7,-3,0,0,1,-1,1,-1,5,-1
KR_6604077044,440,-4,-115,-9,-7,1,1,2,-1,6,5,-1,4,3,-5,7,2,-1,2,1,0,-3,29,1,-4,3,-1,0,0,-1,1,0,-1,5,-1
KR_6729651546,420,-1,31,-52,-6,-1,2,1,-4,5,1,1,2,3,0,5,5,-2,3,1,1,-6,-15,-5,-4,9,-1,0,-1,-1,-1,-1,1,4,-1
KR_6609037273,420,0,9,-36,2,2,0,2,-2,3,1,-3,5,2,2,3,5,3,1,4,2,11,4,3,-6,3,1,0,0,-1,-1,0,1,5,-1
KR_6753592009,420,-5,-133,-28,-14,1,0,1,-6,7,1,0,4,4,-5,7,2,-4,4,0,0,-17,-20,0,-5,5,-2,0,-2,-1,1,-1,-1,5,-1
KR_6725309100,420,-4,-85,-11,-5,0,1,1,5,1,6,-2,5,3,-8,8,0,0,1,1,0,-1,14,1,-5,4,-20,0,-1,-1,1,-1,-1,6,-1
KR_6758747737,420,-1,-16,-24,2,-1,1,0,1,1,2,3,0,3,0,2,2,-1,1,0,0,-1,-4,-2,-4,6,1,0,-1,1,-1,-1,-1,4,-1
KR_6762714155,420,0,-19,14,-3,-4,4,0,-2,5,3,-1,3,2,3,1,4,1,0,1,0,1,1,4,-6,2,-1,0,0,1,-1,-1,1,3,-1
KR_6743885662,440,-2,-66,-20,-7,0,1,1,-10,11,1,2,0,2,1,1,2,0,0,0,-1,-5,-35,0,-3,3,0,0,0,-1,1,0,-1,2,-1
KR_6760773988,440,-1,-90,15,-4,1,2,3,-6,6,0,3,3,6,-3,7,4,1,0,1,0,-7,-39,-4,-2,6,-2,0,-2,1,-1,-1,-1,3,-1
KR_6601530033,420,0,-8,9,2,-3,5,2,3,2,5,-1,3,2,3,1,4,0,1,1,0,9,-12,-5,-4,9,-1,0,-1,1,-1,-1,-1,6,-1
KR_6729510622,420,0,15,4,-3,-1,3,2,-1,1,0,-4,4,0,2,2,4,1,0,1,0,0,-95,-3,-5,8,3,0,1,-1,1,1,1,5,-1
KR_6766533431,420,-2,-91,-12,2,-1,3,2,0,3,3,7,1,8,-3,6,3,-1,1,0,1,4,-4,1,-5,4,0,0,-1,-1,-1,-1,1,3,-1
KR_6754623291,420,-1,-1,24,-8,-2,3,1,-3,3,0,0,3,3,-2,3,1,-1,2,1,-1,-7,-5,2,-6,4,0,0,0,-1,1,0,-1,2,-1
KR_6757576105,420,-1,-5,-24,-4,-1,1,0,-2,2,0,0,0,0,-1,2,1,0,0,0,0,-8,1,1,-5,4,0,0,0,-1,-1,0,-1,5,-1
KR_6750315194,420,-2,-26,0,-8,0,2,2,-1,3,2,1,1,2,-9,9,0,1,0,1,0,-8,0,6,-9,3,1,0,0,-1,1,1,1,3,-1
KR_6641236136,420,-2,49,-43,1,3,2,5,0,3,3,-5,7,2,2,3,5,1,0,1,0,5,-8,1,-4,3,2,0,1,-1,1,1,1,4,-1
KR_6759874407,420,-3,-42,1,-3,0,1,1,-2,3,1,-5,6,1,3,0,3,1,0,1,-1,-2,-14,-3,-2,5,-1,0,-1,1,1,-1,-1,5,-1
KR_6685968479,420,-1,-23,-9,-7,-6,7,1,3,1,4,-6,6,0,1,2,3,1,1,2,0,2,-225,-1,-7,8,-4,0,-2,-1,-1,-1,-1,5,-1
KR_6744935067,420,-4,-33,-35,-3,-2,2,0,-6,6,0,2,1,3,2,0,2,1,0,1,-1,0,2,-3,-3,6,0,0,-2,1,-1,-1,-1,3,-1
KR_6761855090,440,5,37,8,15,-1,1,0,11,1,12,-1,2,1,4,1,5,2,0,2,0,11,16,3,-8,5,1,0,1,-1,0,1,1,5,-1
KR_6692548293,420,-6,13,4,-17,-7,7,0,-4,5,1,-3,5,2,-1,4,3,-2,2,0,-1,-14,47,-1,-3,4,-21,0,0,1,1,-1,-1,1,-1
KR_6629578359,420,-5,-23,3,-9,-2,2,0,-5,5,0,0,1,1,-1,2,1,-1,1,0,0,-9,-2,-4,-2,6,-8,0,-1,-1,-1,-1,-1,4,-1
KR_6697655944,440,-1,21,-15,-7,3,1,4,0,3,3,-2,4,2,-7,8,1,-1,2,1,0,-8,-48,-3,-2,5,24,0,1,-1,1,-1,-1,6,-1
KR_6748710570,440,0,-29,13,-5,0,1,1,1,2,3,0,0,0,-4,4,0,-2,3,1,-1,-5,-4,2,-4,2,0,0,0,-1,-1,-1,-1,3,-1
KR_6764223885,420,-1,-58,-28,-3,3,0,3,-2,5,3,-1,1,0,-5,6,1,2,1,3,0,-4,117,1,-5,4,-3,0,0,-1,-1,0,-1,1,-1
KR_6684113511,440,-1,-30,-12,0,4,0,4,-3,4,1,-1,5,4,2,3,5,-2,2,0,-1,-5,-12,-1,-4,5,-5,0,1,-1,1,1,-1,3,-1
KR_6717692687,420,-7,-134,-13,-17,-5,6,1,1,3,4,-1,1,0,-12,14,2,0,2,2,0,-12,-5,-3,-2,5,2,0,-2,-1,1,-1,1,6,-1
KR_6765735800,420,-1,39,-12,-8,-3,3,0,0,1,1,-3,5,2,-1,2,1,-1,2,1,0,-6,1,0,-6,6,-4,0,0,-1,-1,0,-1,5,-1
KR_6599602396,420,-5,-40,-28,-9,2,3,5,-4,5,1,-8,8,0,1,1,2,0,0,0,0,-14,8,0,-3,3,-4,0,-1,1,-1,-1,-1,2,-1
KR_6730862778,420,2,62,28,2,9,1,10,-4,6,2,1,1,2,-3,5,2,-1,2,1,0,-9,-17,0,-7,7,-3,0,-1,-1,0,-1,-1,4,-1
KR_6762255465,420,-3,-51,4,-11,1,0,1,2,2,4,-1,3,2,-11,12,1,-2,2,0,0,-12,-14,-2,-5,7,0,0,-1,-1,1,-1,-1,5,-1
KR_6731757582,420,1,-51,-4,1,-1,1,0,0,4,4,-2,4,2,5,1,6,-1,1,0,0,4,-4,0,-3,3,0,0,0,-1,-1,0,-1,6,-1
KR_6758290441,420,0,1,-8,2,0,1,1,0,1,1,0,3,3,4,2,6,-2,2,0,0,-1,-20,-2,-6,8,2,0,0,-1,1,0,-1,3,-1
KR_6751276083,440,0,44,37,-1,0,2,2,0,3,3,-6,7,1,4,2,6,1,0,1,1,-14,-34,-2,-3,5,-2,0,2,1,1,1,1,4,-1
KR_6748646825,440,-4,14,0,-9,-1,4,3,-2,5,3,2,0,2,-5,5,0,-3,3,0,-1,-13,-8,-4,-1,5,3,0,0,0,1,-1,-1,0,-1
KR_6696892676,420,-4,-50,-31,-15,-1,2,1,-9,12,3,0,2,2,-3,4,1,-2,2,0,0,-23,5,-4,-3,7,-5,0,-1,-1,-1,-1,-1,3,-1
KR_6711678288,420,1,75,27,3,5,0,5,-2,3,1,2,1,3,-5,5,0,3,0,3,1,-4,1,2,-6,4,6,0,0,-1,-1,0,1,3,-1
KR_6756637808,420,-1,48,-8,-2,-2,3,1,-1,2,1,-1,4,3,0,3,3,2,0,2,-1,1,4,2,-3,1,0,0,0,1,-1,0,-1,3,-1
KR_6621344233,420,-2,-43,12,-9,-1,3,2,-5,5,0,-1,3,2,-1,2,1,-1,1,0,0,-11,1,3,-8,5,-4,0,0,-1,-1,-1,-1,2,-1
KR_6763069696,440,-2,-64,0,0,-2,4,2,1,0,1,-1,3,2,1,2,3,1,1,2,0,6,9,3,-6,3,-1,0,0,-1,1,0,1,1,-1
KR_6748810010,440,-7,-151,-48,-11,-3,5,2,1,1,2,-5,5,0,-4,6,2,0,0,0,0,-8,14,2,-5,3,-6,0,-2,-1,-1,-1,-1,5,-1
KR_6763505561,420,-2,12,-28,-1,-2,2,0,0,3,3,0,2,2,0,0,0,1,0,1,0,5,-9,-4,-5,9,-2,0,-1,0,-1,-1,1,0,-1
KR_6696254328,420,-4,13,0,-8,-3,3,0,-6,8,2,-4,5,1,4,0,4,1,1,2,-1,-10,18,-5,-4,9,-1,0,0,1,-1,-1,-1,1,-1
KR_6761677019,420,0,-91,-9,1,-3,4,1,1,2,3,0,1,1,4,1,5,-1,3,2,-1,1,109,-3,-3,6,3,0,-3,1,-1,-1,-1,1,-1
KR_6764127976,440,-1,-16,8,1,1,1,2,-1,4,3,-2,3,1,-1,5,4,4,1,5,0,2,-31,-6,-2,8,7,0,0,-1,-1,-1,1,4,-1
KR_6763996067,440,-3,-41,-28,-15,0,1,1,-9,11,2,-3,4,1,-4,4,0,1,0,1,0,-19,-5,-2,-3,5,2,0,-1,-1,-1,-1,1,1,-1
KR_6757040969,420,-1,11,-16,-5,2,2,4,0,4,4,-2,4,2,-5,7,2,0,1,1,0,-6,2,0,-5,5,-2,0,-2,1,-1,-1,1,3,-1
KR_6559104409,420,0,-35,23,1,0,2,2,1,4,5,1,2,3,-4,4,0,3,2,5,0,8,1,-2,-2,4,-2,0,1,-1,1,1,-1,4,-1
KR_6741577762,420,2,-4,21,7,0,2,2,2,0,2,8,1,9,-2,4,2,-1,2,1,2,11,-23,-1,-4,5,2,0,1,1,1,1,-1,2,-1
KR_6764526277,420,-3,-22,-7,0,-2,2,0,-1,4,3,0,3,3,4,0,4,-1,1,0,0,-3,27,1,-7,6,3,0,0,1,1,-1,-1,6,-1
KR_6730449830,420,1,-5,4,-3,1,1,2,-4,6,2,-2,2,0,3,0,3,-1,3,2,0,-6,-35,-6,-2,8,14,0,0,-1,-1,1,-1,4,-1
KR_6632970682,420,1,17,-12,0,0,2,2,-1,2,1,2,2,4,1,0,1,-2,2,0,0,-1,4,1,-5,4,-4,0,0,1,-1,0,1,2,-1
KR_6716715831,420,-4,-54,-15,-4,2,1,3,-2,6,4,-1,2,1,-4,8,4,1,0,1,0,-17,117,6,-8,2,-4,0,-1,1,1,-1,1,6,-1
KR_6748143984,420,-2,-6,4,-8,-3,5,2,-2,4,2,3,0,3,-3,4,1,-3,4,1,0,-11,-5,-2,-5,7,-6,0,-1,-1,-1,-1,-1,5,-1
KR_6671125180,420,-2,2,-11,-11,-7,8,1,-2,3,1,-1,1,0,-2,3,1,1,0,1,0,-13,-10,-9,-2,11,7,0,0,-1,-1,-1,-1,1,-1
KR_6419272191,420,-2,-59,-16,-3,-2,2,0,-1,4,3,2,0,2,-3,3,0,1,0,1,0,-2,2,2,-7,5,0,0,1,-1,1,1,-1,3,-1
KR_6724881964,420,0,-18,20,0,-7,8,1,2,1,3,-4,4,0,6,1,7,3,2,5,0,5,-9,-1,-6,7,0,0,-1,1,-1,1,-1,3,-1
KR_6525976979,420,-3,-3,-4,-7,-3,4,1,-2,5,3,1,3,4,-2,3,1,-1,2,1,0,-11,49,1,-6,5,-1,0,-1,-1,1,-1,-1,4,-1
KR_6688946836,420,2,0,12,1,-1,4,3,2,0,2,0,0,0,2,0,2,-2,2,0,0,2,-5,2,-7,5,-3,0,0,1,1,1,1,3,-1
KR_6757563039,420,1,12,-14,-2,1,1,2,-2,3,1,-3,3,0,1,1,2,1,0,1,0,-1,-3,-2,-6,8,-3,0,0,1,1,0,-1,1,-1
KR_6764214447,420,-6,-114,5,-11,-2,3,1,-7,8,1,-4,8,4,-2,2,0,4,0,4,0,-3,-25,2,-4,2,3,0,-2,-1,0,-1,-1,6,-1
KR_6757149855,420,-1,-36,-11,1,-3,3,0,5,1,6,-3,5,2,4,4,8,-2,2,0,-1,9,38,1,-6,5,-1,0,1,-1,1,1,-1,1,-1
KR_6736010603,420,-3,-38,4,-3,-3,3,0,1,2,3,1,5,6,0,3,3,-2,3,1,0,0,5,-3,-4,7,2,0,0,1,-1,-1,-1,6,-1
KR_6738010591,420,-8,-87,-13,-13,-2,3,1,-6,6,0,-3,6,3,-2,2,0,0,0,0,0,-13,-8,2,-6,4,-4,0,-3,-1,-1,-1,-1,3,-1
KR_6737736406,420,-1,-18,-8,-5,-1,1,0,1,4,5,0,2,2,-3,4,1,-2,3,1,0,-3,19,6,-9,3,-8,0,0,-1,-1,0,-1,3,-1
KR_6758089601,420,1,-32,-8,5,4,0,4,-3,3,0,-3,3,0,1,3,4,6,1,7,0,4,-7,3,-5,2,21,0,0,1,1,0,-1,5,-1
KR_6676752449,420,-2,11,-28,-6,1,3,4,-1,1,0,-2,3,1,-4,6,2,0,0,0,1,-8,-5,0,-4,4,3,0,1,1,-1,1,1,4,-1
KR_6753941722,420,-3,-49,-10,-7,1,2,3,0,1,1,-2,3,1,-4,4,0,-2,2,0,0,-7,1,-3,-5,8,2,0,-1,-1,1,-1,-1,2,-1
KR_6764097319,420,0,-52,24,-1,2,2,4,1,1,2,-2,3,1,-2,5,3,0,0,0,0,-1,11,9,-12,3,-4,0,-2,1,-1,-1,1,4,-1
KR_6703470729,420,-2,-62,-17,-10,-1,1,0,-2,5,3,-6,6,0,-2,5,3,1,1,2,0,-11,-4,-1,-6,7,-4,0,-1,-1,-1,-1,-1,3,-1
KR_6441002265,420,-3,34,-5,-5,-2,2,0,-2,5,3,-5,5,0,4,0,4,0,1,1,0,-4,-79,3,-9,6,1,0,0,1,-1,0,1,3,-1
KR_6703346474,420,2,13,12,-4,-2,3,1,3,1,4,-3,3,0,-1,3,2,-1,2,1,0,-3,-28,-1,-8,9,-1,0,-1,-1,-1,-1,1,1,-1
KR_6700998732,420,1,4,11,1,-2,5,3,6,3,9,-2,4,2,-1,4,3,0,0,0,0,6,-1,5,-6,1,-3,0,1,1,1,1,1,5,-1
KR_6764383019,440,-3,-68,-12,-16,-3,4,1,-3,3,0,-1,3,2,-8,11,3,-1,2,1,-1,-18,5,0,-2,2,-4,0,-3,-1,-1,-1,-1,4,-1
KR_6683768372,420,-3,-29,-37,2,3,2,5,7,0,7,-2,3,1,-3,4,1,-3,3,0,1,5,3,3,-6,3,-6,0,-2,-1,-1,-1,1,5,-1
KR_6753790711,420,-3,-1,8,-10,1,1,2,-1,3,2,-9,9,0,-1,6,5,0,0,0,0,-9,5,0,-2,2,-2,0,-1,1,1,-1,-1,2,-1
KR_6685923150,420,-4,-43,-24,-3,-1,1,0,-2,4,2,-2,2,0,1,0,1,1,0,1,0,-6,51,-2,-6,8,0,0,0,-1,1,0,1,4,-1
KR_6744064842,420,-4,-44,0,-6,-4,5,1,0,4,4,0,0,0,-2,2,0,0,1,1,0,2,1,-1,-4,5,0,0,-1,1,-1,-1,-1,1,-1
KR_6748198935,440,1,-43,17,-5,0,3,3,-1,6,5,-2,2,0,-1,2,1,-1,2,1,0,-4,5,-1,-2,3,-3,0,0,-1,0,0,-1,4,-1
KR_6724324934,420,-2,-30,-4,-4,1,1,2,-8,8,0,-2,2,0,3,0,3,2,0,2,0,-4,-11,2,-4,2,1,0,0,1,-1,-1,1,1,-1
KR_6763950789,420,2,14,27,0,-3,5,2,0,1,1,-3,4,1,2,0,2,4,2,6,1,4,18,-4,-4,8,0,0,0,-1,1,0,1,6,-1
KR_6727894718,440,-11,-120,-75,-23,-7,9,2,-4,7,3,-3,3,0,-7,7,0,-2,2,0,-3,-26,-20,-3,-2,5,-3,0,-3,-1,-1,-1,-1,5,-1
KR_6600878794,420,0,-88,20,3,-6,6,0,3,3,6,-1,3,2,3,2,5,4,1,5,0,13,142,-3,-4,7,-3,0,0,-1,1,1,1,5,-1
KR_6757763543,420,2,30,-28,3,0,1,1,3,1,4,0,1,1,0,3,3,0,2,2,0,5,19,3,-6,3,-1,0,0,-1,0,0,1,5,-1
KR_6764632434,420,-2,-40,-13,-6,0,2,2,-1,2,1,-1,4,3,-5,7,2,1,0,1,1,-10,0,-1,-2,3,-2,0,0,-1,1,0,1,1,-1
KR_6679618241,420,-3,-31,-14,-9,-4,5,1,0,0,0,-6,7,1,1,1,2,0,0,0,0,-13,-5,1,-7,6,-4,0,-1,1,-1,-1,-1,4,-1
KR_6737075434,420,-3,2,-4,-2,-2,3,1,0,3,3,2,2,4,-2,3,1,0,1,1,0,0,7,1,-5,4,1,0,1,0,1,1,-1,0,-1
KR_6744283491,440,1,-45,24,-4,-3,4,1,-2,5,3,0,0,0,0,3,3,1,2,3,0,-2,-2,3,-6,3,0,0,0,1,1,0,-1,2,-1
KR_6760026905,440,-2,69,-23,4,-4,5,1,0,4,4,-1,4,3,5,0,5,4,0,4,-1,7,5,4,-4,0,1,0,1,0,-1,1,-1,0,-1
KR_6740346231,420,2,36,29,3,-1,3,2,0,3,3,-2,5,3,7,0,7,-1,2,1,1,4,9,6,-9,3,-2,0,2,1,1,1,1,2,-1
KR_6678062110,420,0,-49,-7,-1,-4,8,4,4,1,5,-1,3,2,1,3,4,-1,1,0,-3,1,4,-7,-4,11,-6,0,-1,-1,-1,-1,1,5,-1
KR_6737325578,420,-1,17,67,-13,-1,1,0,-1,3,2,-5,5,0,-6,10,4,0,3,3,-1,-10,5,-1,-3,4,1,0,1,-1,1,-1,-1,4,-1
KR_6761344632,420,0,-21,-5,1,-5,7,2,4,2,6,-2,2,0,0,3,3,4,1,5,0,8,10,0,-4,4,-2,0,1,1,-1,1,-1,5,-1
KR_6765631974,420,2,9,16,9,-2,5,3,1,2,3,3,0,3,6,2,8,1,0,1,-1,7,-1,-6,-5,11,-1,0,0,0,1,1,-1,0,-1
KR_6696486140,420,-1,-57,7,-4,1,2,3,-3,6,3,-1,6,5,0,2,2,-1,2,1,0,-5,-8,-4,-5,9,-5,0,0,-1,-1,-1,1,6,-1
KR_6744385842,420,0,39,-6,-1,2,0,2,-4,5,1,-2,3,1,1,2,3,2,0,2,0,-4,-54,-2,-1,3,2,0,0,-1,-1,0,1,5,-1
KR_6752571492,420,-7,-124,-50,-11,1,1,2,-5,5,0,-2,2,0,-5,5,0,0,0,0,0,-11,-12,-4,-4,8,-3,0,-2,-1,-1,-1,1,5,-1
KR_6758033813,440,-1,-87,-16,-6,0,1,1,0,1,1,-6,8,2,1,2,3,-1,1,0,0,-2,9,3,-8,5,-6,0,-1,-1,1,-1,-1,5,-1
KR_6758238123,420,0,-5,28,-5,3,2,5,1,4,5,-3,3,0,-4,6,2,-2,2,0,0,-16,8,5,-7,2,-1,0,0,-1,-1,0,-1,2,-1
KR_6686281516,420,1,-40,-24,6,-1,1,0,3,5,8,2,1,3,2,0,2,0,1,1,0,15,-24,3,-8,5,-1,0,-1,1,-1,-1,1,5,-1
KR_6742273528,440,1,33,8,1,3,0,3,-5,7,2,-1,2,1,6,1,7,-2,2,0,-4,-5,-25,5,-6,1,-2,0,0,-1,-1,1,-1,5,-1
KR_6730036043,420,1,16,-4,0,1,1,2,-3,6,3,-6,7,1,3,0,3,5,1,6,1,9,14,3,-8,5,-8,0,0,-1,1,1,1,3,-1
KR_6731180940,420,-4,-60,9,-11,-2,2,0,1,1,2,-4,6,2,-3,4,1,-3,5,2,1,-3,3,-2,-6,8,2,0,-1,-1,1,-1,1,1,-1
KR_6737043658,420,-7,-45,-38,-8,0,2,2,-1,3,2,-9,9,0,2,2,4,0,2,2,-1,-4,31,3,-7,4,-3,0,-2,-1,1,-1,-1,2,-1
KR_6734604896,420,1,42,0,0,0,2,2,2,2,4,-4,4,0,2,3,5,0,1,1,1,-5,-1,2,-6,4,-5,0,1,-1,1,1,1,2,-1
KR_6756780654,420,3,79,-20,6,1,0,1,4,1,5,0,1,1,2,0,2,-1,1,0,0,4,345,0,-2,2,2,0,2,1,-1,1,1,3,-1
KR_6745212057,420,0,-30,21,-6,1,1,2,-1,2,1,-3,6,3,-1,5,4,-2,2,0,0,-10,-15,-5,-4,9,0,0,0,-1,-1,0,-1,4,-1
KR_6700528154,420,1,47,-12,1,8,0,8,-4,5,1,-2,5,3,-2,3,1,1,0,1,1,0,10,4,-6,2,-1,0,1,-1,1,1,1,3,-1
KR_6742371111,440,1,-38,-12,-3,-6,6,0,-1,3,2,1,3,4,2,1,3,1,2,3,-4,-4,-9,-6,-2,8,6,0,0,1,-1,0,-1,4,-1
KR_6758065991,420,1,-13,-21,-3,0,2,2,-3,3,0,1,2,3,0,2,2,-1,2,1,0,2,-6,-3,-3,6,-1,0,0,-1,1,-1,-1,4,-1
KR_6665603319,420,-6,-69,-34,-12,-4,4,0,-4,4,0,-3,3,0,-1,1,0,0,1,1,1,-8,4,-1,-7,8,3,0,-1,-1,-1,-1,1,4,-1
KR_6757455124,420,-1,25,-4,-7,3,1,4,0,2,2,-11,11,0,0,2,2,1,0,1,-1,-8,-249,-4,-2,6,1,0,0,-1,-1,-1,-1,3,-1
KR_6704484300,420,-2,-38,-24,-8,1,3,4,-1,5,4,-4,4,0,-3,6,3,-1,2,1,0,-8,-3,-2,-8,10,4,0,0,-1,-1,0,1,5,-1
KR_6753002868,420,-2,-17,-24,-7,1,1,2,-7,7,0,-1,3,2,-2,3,1,2,0,2,0,-17,-50,1,-5,4,-2,0,-2,-1,1,-1,1,3,-1
KR_6728416686,420,-3,-7,2,-4,-2,3,1,-1,5,4,-1,2,1,1,3,4,-1,1,0,1,2,9,1,-8,7,-1,0,-1,1,-1,-1,1,3,-1
KR_6763848681,420,-3,-47,-24,-7,-1,2,1,-1,2,1,-2,4,2,-5,6,1,2,0,2,-1,-10,0,1,-6,5,-2,0,-1,-1,1,-1,-1,4,-1
KR_6749937339,420,3,44,4,2,-2,3,1,3,0,3,-1,2,1,2,3,5,0,1,1,0,4,3,0,-9,9,2,0,0,1,0,1,1,4,-1
KR_6759754137,420,-2,-3,4,-6,1,1,2,0,1,1,-5,6,1,-1,4,3,-1,2,1,0,-3,-29,-3,-6,9,1,0,0,0,1,-1,-1,0,-1
KR_6631208927,420,-1,-37,0,0,0,1,1,-1,5,4,3,1,4,-2,4,2,0,0,0,0,3,-3,-6,-4,10,0,0,-1,-1,-1,1,1,2,-1
KR_6742982646,420,3,4,-4,7,3,1,4,2,1,3,-1,4,3,1,1,2,2,4,6,-1,5,-9,-5,-1,6,5,0,0,1,-1,0,-1,5,-1
KR_6761121470,420,-1,-29,2,-1,-2,2,0,0,2,2,3,0,3,-1,3,2,-1,2,1,0,-2,8,-2,-4,6,-3,0,0,-1,-1,0,-1,2,-1
KR_6760998641,420,0,-37,7,0,-1,1,0,3,0,3,-1,1,0,-1,4,3,0,0,0,0,0,-55,-1,-5,6,1,0,-1,1,-1,-1,-1,3,-1
KR_6599848280,420,4,-2,40,-6,3,1,4,1,1,2,-7,7,0,-1,4,3,-2,4,2,0,-17,-47,-2,-5,7,19,0,1,-1,1,1,-1,1,-1
KR_6748183970,420,-2,-84,5,1,-1,1,0,3,0,3,0,1,1,-1,3,2,0,0,0,1,3,27,0,-3,3,2,0,-1,-1,1,-1,1,1,-1
KR_6759810907,440,-4,-9,-16,-11,-1,2,1,-5,8,3,2,2,4,-3,5,2,-4,4,0,0,-10,-171,3,-4,1,-3,0,0,-1,1,0,1,1,-1
KR_6747059818,420,-6,-32,-28,-12,-2,4,2,5,0,5,-2,3,1,-13,17,4,0,0,0,-3,-21,2,-1,-3,4,0,0,-2,1,-1,-1,1,5,-1
KR_6716724572,420,-2,0,-16,-12,-1,3,2,-8,9,1,0,1,1,0,0,0,-3,4,1,0,-14,41,-1,-5,6,-21,0,0,-1,-1,0,-1,5,-1
KR_6660899729,420,-1,-60,28,-4,-2,2,0,3,1,4,-5,6,1,-1,4,3,1,0,1,0,1,-11,-3,-4,7,1,0,-1,1,1,-1,-1,6,-1
KR_6763029420,440,-2,-81,-15,-7,-1,1,0,-7,8,1,1,1,2,-1,3,2,1,1,2,0,-6,-5,-1,-2,3,3,0,0,-1,1,-1,-1,1,-1
KR_6718743348,420,-1,-25,-23,-4,-5,5,0,2,2,4,-1,1,0,2,1,3,-2,2,0,0,4,2,0,-3,3,-3,0,0,-1,-1,-1,-1,3,-1
KR_6764154702,420,1,72,32,-5,3,0,3,-1,6,5,-3,3,0,0,5,5,-4,4,0,-1,-20,-3,4,-10,6,0,0,0,0,0,0,-1,0,-1
KR_6690788854,440,-5,-68,-27,-13,-3,6,3,0,0,0,-8,11,3,-1,1,0,-1,2,1,0,-4,-6,-1,-4,5,-2,0,-2,-1,-1,-1,-1,1,-1
KR_6766021992,420,-2,-21,6,1,2,1,3,-2,2,0,1,2,3,1,0,1,-1,1,0,0,-1,-3,-3,-3,6,2,0,0,1,-1,1,1,5,-1
KR_6766040864,420,-4,42,0,-7,0,2,2,0,3,3,-4,7,3,-1,2,1,-2,2,0,0,-11,-117,1,-4,3,-4,0,0,-1,1,-1,1,6,-1
KR_6713180248,420,-3,-22,-23,-11,-3,5,2,-3,8,5,-4,5,1,-2,2,0,1,0,1,0,-4,-10,-6,-1,7,1,0,0,1,-1,-1,-1,5,-1
KR_6766078645,420,-1,-29,28,1,1,0,1,0,5,5,0,5,5,-1,4,3,1,1,2,0,5,-297,-1,-4,5,2,0,-1,1,1,-1,-1,2,-1
KR_6764480353,420,-2,-28,-12,-5,3,0,3,0,2,2,-2,3,1,-5,8,3,-1,2,1,0,-2,-4,-3,-3,6,4,0,-2,-1,-1,-1,-1,6,-1
KR_6507169988,420,-1,-18,27,2,0,4,4,2,1,3,0,4,4,-1,4,3,1,1,2,1,4,-10,1,-4,3,-2,0,-1,1,-1,-1,1,2,-1
KR_6742235207,420,1,20,-25,1,4,3,7,0,2,2,-3,4,1,1,1,2,-1,3,2,0,-1,28,-5,-2,7,3,0,-1,-1,-1,-1,-1,2,-1
KR_6745781523,420,4,16,12,5,-1,1,0,1,4,5,1,1,2,3,4,7,1,1,2,0,0,41,-2,-3,5,-2,0,2,-1,-1,1,1,6,-1
KR_6747439684,420,3,54,15,5,6,2,8,-1,4,3,1,1,2,2,1,3,-3,5,2,0,-2,-12,-3,-4,7,6,0,1,-1,-1,1,-1,1,-1
KR_6736585768,440,-1,-1,-20,-4,3,1,4,-5,5,0,0,2,2,-3,6,3,1,0,1,0,-13,-4,-3,-3,6,0,0,0,-1,-1,-1,-1,1,-1
KR_6644655345,420,-5,-49,-15,-5,1,0,1,1,2,3,0,3,3,-5,7,2,-2,3,1,0,-1,0,-3,-5,8,4,0,-1,-1,-1,-1,1,4,-1
KR_6764683853,420,3,30,-21,4,0,1,1,-2,2,0,3,3,6,2,2,4,1,0,1,0,-1,-138,-1,-2,3,-2,0,0,0,1,0,1,0,-1
KR_6490624523,420,-5,-74,-4,-9,-3,4,1,-4,4,0,0,0,0,-2,2,0,0,1,1,0,-10,-5,-7,-2,9,2,0,-3,-1,1,-1,-1,4,-1
KR_6591591862,420,-2,-47,-8,-8,-8,10,2,-1,1,0,4,1,5,-3,4,1,0,1,1,0,-6,-6,-2,-5,7,2,0,-1,-1,-1,-1,-1,6,-1
KR_6718447324,420,-2,-27,16,-2,0,2,2,3,1,4,-2,3,1,-2,3,1,-1,3,2,0,2,22,1,-3,2,-1,0,0,-1,-1,1,-1,6,-1
KR_6765350639,420,1,-60,0,3,-1,1,0,2,3,5,1,0,1,0,1,1,1,0,1,0,2,10,2,-5,3,-1,0,-1,1,-1,-1,-1,2,-1
KR_6640285500,420,-3,-66,9,-8,0,0,0,-4,4,0,0,1,1,-3,6,3,-1,1,0,0,-14,-38,-3,-3,6,24,0,0,-1,0,0,1,2,-1
KR_6757104052,420,-2,-78,-4,-1,0,0,0,-2,7,5,-1,3,2,2,2,4,0,3,3,0,-5,43,0,-4,4,-19,0,-1,1,1,-1,1,1,-1
KR_6762722185,420,-3,8,-43,5,0,1,1,-3,4,1,2,2,4,1,2,3,5,0,5,0,7,-77,-3,-3,6,-17,0,0,-1,1,1,1,1,-1
KR_6719623594,420,-1,-26,0,-11,-2,2,0,-6,6,0,-3,5,2,1,1,2,-1,3,2,0,-16,-4,-4,-3,7,-1,0,1,1,-1,-1,1,3,-1
KR_6663753055,420,1,67,15,-7,5,0,5,-8,10,2,-4,6,2,1,2,3,-1,1,0,-1,-16,-2,-4,-5,9,-1,0,0,-1,1,1,-1,3,-1
KR_6705312912,420,-5,-75,-7,-6,-4,6,2,5,0,5,-1,3,2,-6,8,2,0,0,0,0,-1,-1,1,-5,4,0,0,-3,-1,-1,-1,1,3,-1
KR_6760687443,420,-2,-41,16,-4,-7,8,1,-2,7,5,1,1,2,2,1,3,2,1,3,0,0,-3,3,-6,3,3,0,-1,-1,1,-1,1,5,-1
KR_6638827245,420,-3,-79,-35,-3,1,1,2,0,1,1,0,3,3,-4,5,1,0,1,1,0,0,-3,-3,-6,9,2,0,-1,-1,1,-1,-1,4,-1
KR_6766148033,420,0,37,-7,3,1,1,2,0,4,4,6,2,8,-3,7,4,-1,1,0,0,-6,7,3,-6,3,-1,0,1,1,1,1,1,4,-1
KR_6744894789,440,1,-18,-2,3,0,3,3,6,3,9,3,3,6,-7,9,2,1,0,1,-1,-4,4,3,-6,3,-4,0,-1,-1,1,-1,1,5,-1
KR_6758975465,420,0,20,-8,-5,-1,2,1,-3,7,4,2,2,4,1,2,3,-4,6,2,0,-4,0,-2,-7,9,-5,0,0,1,0,0,-1,1,-1
KR_6761779631,420,-2,11,20,-6,0,2,2,-5,6,1,0,2,2,-1,2,1,0,2,2,0,-4,312,-5,-5,10,2,0,0,1,1,1,-1,2,-1
KR_6703671394,440,-3,15,3,-13,0,4,4,-2,3,1,1,7,8,-5,8,3,-7,7,0,-1,-13,13,2,-6,4,-3,0,1,0,1,-1,-1,0,-1
KR_6697097227,420,7,106,19,13,3,2,5,0,5,5,3,1,4,8,0,8,-1,1,0,0,1,-5,1,-4,3,2,0,2,-1,1,1,1,1,-1
KR_6742330912,420,0,60,-21,-3,3,1,4,-2,3,1,-5,6,1,1,1,2,0,1,1,0,-9,11,3,-7,4,-4,0,0,-1,-1,0,-1,1,-1
KR_6762982633,420,-1,19,-14,1,3,1,4,0,3,3,-1,2,1,0,2,2,-1,1,0,1,2,3,-3,-6,9,-1,0,0,1,1,0,1,4,-1
KR_6758664563,420,0,51,-15,-5,1,1,2,-2,2,0,-2,4,2,-3,5,2,1,1,2,0,-7,-19,0,-3,3,4,0,0,0,-1,0,1,0,-1
KR_6663884832,420,-9,-65,-73,-15,-3,3,0,-4,5,1,-2,3,1,-5,5,0,-1,1,0,-1,-13,-4,-3,-3,6,-5,0,-3,-1,-1,-1,-1,3,-1
KR_6717600909,420,-4,44,-24,0,-1,2,1,2,0,2,1,5,6,-3,4,1,1,1,2,0,2,-13,3,-11,8,3,0,0,-1,-1,0,1,4,-1
KR_6746336922,440,-3,-20,12,-6,-4,4,0,0,1,1,1,3,4,-2,4,2,-1,1,0,0,-6,-28,-5,-1,6,0,0,-1,-1,-1,-1,-1,1,-1
KR_6680611329,420,-2,10,12,-4,1,0,1,0,3,3,1,2,3,-5,6,1,-1,1,0,-2,-3,2,1,-9,8,4,0,0,-1,-1,0,-1,3,-1
KR_6742147173,420,1,2,-20,4,0,4,4,0,1,1,0,2,2,3,2,5,1,0,1,-1,8,-13,1,-5,4,0,0,1,-1,1,1,-1,4,-1
KR_6698030724,420,-3,-65,0,-3,0,0,0,0,3,3,-2,4,2,-2,3,1,1,0,1,0,-5,-1,3,-8,5,0,0,-1,-1,1,-1,-1,3,-1
KR_6723005078,440,-5,-49,-8,-11,-5,5,0,-2,3,1,-1,4,3,-2,4,2,-1,1,0,0,-10,-41,1,-3,2,-4,0,0,-1,1,-1,-1,3,-1
KR_6760203514,420,0,-25,4,-4,-3,5,2,0,3,3,-1,2,1,-2,5,3,2,2,4,1,-3,0,1,-5,4,-4,0,-1,0,-1,-1,1,0,-1
KR_6743647360,440,1,-20,36,4,1,1,2,-1,3,2,0,2,2,4,0,4,0,1,1,0,6,189,3,-6,3,-3,0,1,1,1,1,1,2,-1
KR_6737343730,420,-5,-35,-45,-13,-1,1,0,-6,7,1,-5,5,0,-1,4,3,0,0,0,-1,-9,-120,-4,-3,7,0,0,-1,-1,1,-1,-1,5,-1
KR_6762701679,420,1,-4,-17,6,0,1,1,2,1,3,0,1,1,5,3,8,-1,3,2,0,4,3,0,-8,8,-3,0,-1,1,-1,-1,1,6,-1
KR_6756012996,420,-4,-16,-20,-4,2,0,2,0,3,3,-1,3,2,-7,8,1,2,0,2,0,-1,-27,-5,-2,7,1,0,-1,-1,0,-1,1,2,-1
KR_6761513099,420,-2,-51,-38,-3,-1,3,2,1,2,3,-1,1,0,0,2,2,-2,3,1,0,0,-1,4,-8,4,-5,0,-1,-1,-1,-1,1,2,-1
KR_6761185412,420,0,-32,47,-4,-1,2,1,-3,4,1,0,2,2,-1,2,1,1,0,1,0,-8,5,2,-6,4,-1,0,0,1,1,0,1,4,-1
KR_6745168781,420,-4,-72,-8,-14,1,1,2,-9,9,0,-4,4,0,0,0,0,-2,2,0,-1,-16,-3,-4,-2,6,-1,0,-3,-1,-1,-1,-1,6,-1
KR_6704251352,420,0,9,-16,-11,3,0,3,-3,4,1,0,1,1,-4,4,0,-7,7,0,0,-16,-11,-4,-4,8,4,0,0,-1,-1,-1,-1,3,-1
KR_6605394180,420,-4,-64,-36,-4,-3,4,1,-2,5,3,1,2,3,-1,3,2,1,1,2,0,2,42,-5,-2,7,2,0,1,0,-1,-1,1,0,-1
KR_6724658638,440,-3,-83,20,-2,-1,3,2,1,1,2,-1,4,3,2,2,4,-3,4,1,0,1,-4,3,-5,2,-5,0,0,-1,1,0,1,4,-1
KR_6758559849,420,-2,-10,-19,4,1,1,2,-2,3,1,5,0,5,-1,3,2,1,1,2,0,3,2,-3,-6,9,0,0,0,-1,-1,-1,1,6,-1
KR_6762465487,420,3,35,10,2,1,1,2,2,1,3,-1,4,3,-1,2,1,1,1,2,0,8,-5,-3,-3,6,-1,0,1,-1,-1,-1,-1,5,-1
KR_6735291422,420,-1,-39,12,-3,1,1,2,-1,4,3,-3,4,1,1,1,2,-1,1,0,0,-5,-15,-2,-2,4,0,0,0,1,-1,0,1,4,-1
KR_6658639862,420,-1,-32,-6,-6,3,1,4,0,2,2,-7,8,1,-1,2,1,-1,2,1,0,-4,30,5,-6,1,-20,0,1,1,1,1,1,3,-1
KR_6712232924,420,0,-33,20,-7,-2,4,2,-5,6,1,2,3,5,0,2,2,-2,3,1,-1,-5,-12,-5,-1,6,-1,0,-1,1,1,1,-1,2,-1
KR_6740749290,440,-1,11,12,0,-1,3,2,-2,4,2,-2,4,2,3,2,5,2,0,2,0,-5,10,-3,-3,6,-3,0,1,1,1,1,-1,2,-1
KR_6670789122,420,-1,-29,24,-1,0,1,1,2,3,5,0,0,0,-4,4,0,1,0,1,0,-6,2,3,-6,3,5,0,0,1,1,0,1,3,-1
KR_6687019987,420,-5,-99,-36,-9,-5,6,1,-3,4,1,-1,3,2,1,3,4,-1,2,1,1,-6,279,-2,-4,6,2,0,-2,0,-1,-1,1,0,-1
KR_6729745406,420,3,6,1,0,2,1,3,-2,5,3,0,3,3,0,3,3,0,0,0,0,-4,-23,2,-6,4,3,0,0,1,-1,1,-1,5,-1
KR_6741716988,420,-1,-28,-9,-2,1,3,4,-2,3,1,5,0,5,-5,8,3,-1,3,2,0,5,-2,-1,-3,4,5,0,1,-1,1,1,-1,3,-1
KR_6761687573,420,-4,-6,12,-11,-4,4,0,1,3,4,-2,4,2,-1,2,1,-5,5,0,0,-9,-15,1,-6,5,-4,0,-1,0,-1,-1,1,0,-1
KR_6706772642,420,-2,-33,-8,2,1,1,2,5,1,6,2,1,3,2,1,3,-8,10,2,0,7,-167,1,-7,6,7,0,0,-1,-1,0,-1,2,-1
KR_6721760241,420,-3,-32,-21,-1,1,1,2,-5,6,1,1,3,4,2,4,6,0,0,0,0,-3,-3,1,-8,7,0,0,0,-1,1,1,1,2,-1
KR_6759187955,420,-4,-18,-62,-2,-1,2,1,-5,6,1,2,0,2,1,2,3,1,0,1,0,-6,0,0,-6,6,-3,0,-1,-1,-1,-1,1,3,-1
KR_6758371866,420,0,23,43,1,-2,2,0,0,1,1,0,3,3,2,1,3,1,0,1,0,1,-9,-3,-3,6,6,0,1,0,1,1,1,0,-1
KR_6597860073,420,-3,-87,-12,-6,-5,5,0,3,1,4,-5,5,0,1,2,3,0,1,1,0,-5,24,2,-6,4,-3,0,-2,-1,1,-1,-1,2,-1
KR_6764118570,420,1,19,-9,-1,4,1,5,-1,2,1,0,2,2,-5,6,1,1,1,2,2,2,-3,4,-6,2,-4,0,0,-1,0,0,1,6,-1
KR_6636967117,420,2,-2,4,6,-2,4,2,-1,2,1,3,1,4,6,0,6,0,0,0,0,9,-1,-1,-5,6,5,0,1,1,1,1,1,5,-1
KR_6753845914,420,-1,-44,4,1,1,1,2,-1,4,3,0,2,2,2,1,3,-1,2,1,0,4,-8,-3,-4,7,0,0,0,-1,1,-1,-1,4,-1
KR_6736012750,420,-2,37,19,-10,-6,6,0,-4,5,1,-1,4,3,1,2,3,0,0,0,0,-7,10,0,-5,5,1,0,0,1,1,-1,1,6,-1
KR_6754347253,440,1,-23,17,1,3,1,4,-2,3,1,-1,1,0,1,3,4,0,2,2,0,-3,2,2,-5,3,-2,0,0,1,-1,0,-1,2,-1
KR_6634668798,440,-4,-47,-28,1,1,2,3,2,1,3,-2,2,0,0,2,2,0,2,2,0,4,-13,-3,-6,9,4,0,1,-1,1,1,-1,2,-1
KR_6759154519,420,-1,0,0,-7,1,2,3,-3,3,0,-1,3,2,-4,4,0,0,0,0,0,-5,-349,-4,-2,6,3,0,-1,-1,-1,-1,1,4,-1
KR_6743120264,420,-5,-56,0,-12,-1,1,0,-8,11,3,-2,3,1,1,1,2,-2,2,0,-1,-14,22,1,-5,4,-5,0,-1,-1,1,-1,-1,2,-1
KR_6763831451,420,-2,52,-3,3,1,4,5,1,1,2,-2,4,2,3,0,3,0,1,1,0,5,-123,0,-4,4,3,0,-2,-1,-1,-1,1,2,-1
KR_6764874445,440,-4,-107,-5,-3,-1,3,2,-1,2,1,1,2,3,-2,2,0,0,0,0,0,1,0,0,-2,2,1,0,-1,0,0,-1,1,0,-1
KR_6650733039,420,-1,12,20,-2,-2,3,1,4,3,7,-1,3,2,-2,5,3,-1,1,0,2,2,-64,2,-9,7,2,0,-1,-1,-1,-1,1,3,-1
KR_6728283292,420,-1,-79,-9,-1,-3,5,2,0,2,2,1,2,3,0,2,2,1,1,2,0,3,-5,-4,-4,8,2,0,0,1,-1,-1,1,5,-1
KR_6732330604,420,3,-94,12,4,1,0,1,5,0,5,0,0,0,-5,6,1,3,0,3,0,7,-2,1,-4,3,17,0,0,1,-1,0,-1,3,-1
KR_6704194179,420,-5,-59,-60,-7,-3,4,1,-4,9,5,0,2,2,1,3,4,-1,4,3,-1,-5,31,1,-9,8,-4,0,1,-1,1,1,-1,4,-1
KR_6692225596,420,1,-13,-15,-2,1,1,2,-1,4,3,2,0,2,-3,3,0,-1,1,0,0,0,132,-6,-2,8,0,0,0,-1,-1,0,-1,6,-1
KR_6758725231,420,-3,0,-8,-4,-1,1,0,4,1,5,0,2,2,-4,5,1,-3,3,0,0,-3,12,0,-3,3,-1,0,-1,0,0,-1,-1,0,-1
KR_6749512813,420,1,-7,-27,5,3,0,3,-2,3,1,3,1,4,0,3,3,1,0,1,0,3,10,4,-5,1,-2,0,2,1,-1,1,-1,4,-1
KR_6764138862,420,-5,11,-8,-11,-3,4,1,-5,6,1,-2,2,0,-1,3,2,0,1,1,0,-6,52,1,-7,6,-18,0,0,1,-1,0,-1,5,-1
KR_6755227026,420,-2,-31,-17,-5,-4,4,0,2,1,3,-3,4,1,-3,6,3,3,1,4,-1,-7,-3,-1,-2,3,-1,0,0,1,-1,0,-1,5,-1
KR_6746863006,420,-3,-69,4,-4,-3,4,1,-1,1,0,2,0,2,-3,5,2,1,2,3,0,-2,0,0,-5,5,-3,0,-1,-1,-1,-1,-1,1,-1
KR_6761843526,440,3,-22,28,-2,1,1,2,0,3,3,-1,3,2,-3,4,1,1,2,3,-1,-7,-57,2,-5,3,33,0,0,1,-1,-1,-1,4,-1
KR_6703526994,420,-5,-26,3,-5,5,0,5,-1,2,1,-4,4,0,-5,8,3,0,0,0,0,-2,-9,1,-7,6,1,0,0,-1,0,-1,1,1,-1
KR_6746493203,420,2,24,1,4,5,1,6,5,1,6,2,3,5,-4,5,1,-4,4,0,0,-7,7,5,-10,5,0,0,0,1,0,1,-1,5,-1
KR_6275317055,420,-6,-7,3,-17,-3,4,1,-8,8,0,-3,6,3,-1,2,1,-2,2,0,0,-14,-113,-2,-1,3,-6,0,-2,1,1,-1,1,6,-1
KR_6742772486,420,-4,-4,-32,-8,-1,1,0,-1,6,5,-4,6,2,-1,2,1,-1,1,0,0,-7,13,1,-5,4,-9,0,-1,-1,1,-1,1,3,-1
KR_6742697751,420,2,-2,-7,-1,4,0,4,-4,5,1,1,0,1,-3,4,1,1,0,1,0,-6,7,1,-5,4,1,0,0,-1,1,0,1,2,-1
KR_6705091219,420,-1,4,-4,0,0,4,4,1,0,1,-4,5,1,1,1,2,2,1,3,0,-4,5,-2,-7,9,2,0,0,-1,1,1,-1,2,-1
KR_6699688794,420,-5,-102,1,-11,-2,5,3,-4,5,1,-1,2,1,-4,6,2,0,2,2,0,-13,-39,-1,0,1,24,0,0,1,-1,-1,-1,5,-1
KR_6742814568,420,-4,-25,4,-7,-2,2,0,-4,6,2,0,2,2,-1,2,1,0,1,1,0,-5,-14,0,-4,4,4,0,-1,-1,-1,-1,-1,6,-1
KR_6652095598,420,-2,-64,-15,-3,0,2,2,-4,4,0,3,0,3,-2,2,0,0,0,0,0,1,-9,-3,-1,4,3,0,-3,-1,-1,-1,1,2,-1
KR_6766210489,420,5,72,-7,13,2,2,4,6,1,7,2,1,3,-1,4,3,4,1,5,0,16,3,-1,-5,6,0,0,3,-1,1,1,-1,4,-1
KR_6656172705,420,-2,-28,8,-3,-3,3,0,0,1,1,1,0,1,-1,3,2,0,2,2,0,1,-11,-5,-1,6,1,0,-1,-1,-1,-1,-1,1,-1
KR_6686460410,420,1,10,18,2,3,0,3,0,2,2,-2,4,2,2,0,2,-1,5,4,0,10,3,3,-7,4,-3,0,3,1,1,1,-1,3,-1
KR_6763418595,420,-6,-71,-15,-13,-4,4,0,2,0,2,-8,8,0,-2,2,0,-1,2,1,-1,-5,1,2,-4,2,-1,0,-1,-1,1,-1,-1,6,-1
KR_6723716430,420,-4,-79,0,-2,-3,5,2,0,2,2,0,2,2,-1,5,4,2,0,2,1,5,-11,-7,-4,11,-3,0,-3,0,-1,-1,1,0,-1
KR_6688630671,420,-1,-64,-4,-8,-4,4,0,-4,5,1,0,3,3,1,3,4,-1,1,0,0,-10,-96,8,-12,4,-5,0,0,1,1,-1,-1,3,-1
KR_6759450062,420,-1,10,-7,-8,3,0,3,-3,6,3,-2,2,0,-6,7,1,0,1,1,-1,-14,-45,-3,-4,7,12,0,0,-1,0,0,-1,5,-1
KR_6761547620,440,2,-84,20,4,1,2,3,1,1,2,-2,4,2,3,1,4,1,1,2,0,0,-107,0,-6,6,-1,0,0,-1,-1,0,1,4,-1
KR_6700525461,420,1,1,-4,5,1,1,2,2,1,3,-3,4,1,5,0,5,0,0,0,0,12,11,5,-6,1,-2,0,-1,1,-1,-1,1,5,-1
KR_6686517733,420,2,91,-1,4,0,0,0,3,2,5,2,1,3,2,2,4,-3,3,0,1,4,36,0,-4,4,-1,0,0,-1,1,0,1,4,-1
KR_6703824009,420,1,-17,-21,-6,0,6,6,-1,4,3,-2,3,1,-1,3,2,-2,3,1,0,-8,-5,-2,-3,5,-3,0,0,-1,-1,0,-1,6,-1
KR_6708459205,420,-4,-40,-8,-13,0,3,3,-4,5,1,-4,6,2,-4,5,1,-1,1,0,0,-22,104,-6,-2,8,-2,0,-2,-1,-1,-1,-1,2,-1
KR_6760102333,420,2,6,0,2,3,0,3,-3,6,3,0,2,2,5,1,6,-3,4,1,-1,-6,10,-2,-5,7,2,0,0,-1,1,-1,-1,1,-1
KR_6734731926,420,-3,-61,2,-12,0,1,1,-3,4,1,-2,2,0,-3,3,0,-4,4,0,0,-14,-2,-4,-4,8,-6,0,-2,-1,-1,-1,-1,1,-1
KR_6754601650,420,0,-82,-4,-2,-1,1,0,5,0,5,-1,2,1,-4,6,2,-1,1,0,0,4,1,-3,-3,6,-5,0,-1,1,0,-1,1,1,-1
KR_6650640800,420,0,-38,-13,6,-1,2,1,0,2,2,6,2,8,-1,4,3,2,0,2,0,3,0,2,-6,4,2,0,1,-1,-1,1,1,2,-1
KR_6762522040,420,-2,-117,-16,-11,-6,7,1,5,4,9,-4,7,3,-9,9,0,3,0,3,0,-9,196,2,-6,4,-1,0,0,0,1,0,-1,0,-1
KR_6763776775,420,-7,-53,8,-20,-3,4,1,-3,4,1,-5,6,1,-7,7,0,-2,3,1,0,-14,-34,-2,-2,4,4,0,0,-1,0,-1,-1,1,-1
KR_6762269473,420,-2,25,-4,0,0,1,1,0,2,2,-5,7,2,3,0,3,2,0,2,1,2,-10,-1,-5,6,2,0,0,-1,-1,1,1,3,-1
KR_6747839868,420,-3,24,-21,-8,-3,4,1,-3,9,6,-1,3,2,1,1,2,-2,2,0,-1,-7,2,1,-9,8,1,0,0,-1,-1,-1,-1,4,-1
KR_6725437130,420,-1,-21,-12,2,-1,2,1,-2,5,3,3,2,5,-1,6,5,3,0,3,0,10,-21,-2,-6,8,1,0,0,-1,1,0,-1,2,-1
KR_6652821711,420,4,69,16,8,2,0,2,0,4,4,0,0,0,5,1,6,1,1,2,0,6,6,6,-9,3,1,0,0,1,-1,0,1,3,-1
KR_6659254178,420,-2,25,-24,-2,2,1,3,-2,5,3,-1,2,1,0,2,2,-1,1,0,0,-5,3,-1,-3,4,-2,0,0,1,1,0,-1,6,-1
KR_6757830346,420,5,57,28,5,5,1,6,0,2,2,2,0,2,-2,4,2,0,1,1,0,-4,0,1,-5,4,1,0,0,-1,-1,1,-1,3,-1
KR_6764976418,420,-1,10,4,2,1,0,1,0,2,2,0,4,4,1,2,3,0,1,1,0,7,20,1,-5,4,2,0,1,1,1,1,1,1,-1
KR_6650495303,420,-1,-46,-24,-7,-2,3,1,-1,1,0,1,2,3,-3,4,1,-2,2,0,0,-10,-29,-3,-4,7,0,0,-1,-1,1,-1,-1,5,-1
KR_6764078341,420,-2,-63,0,-4,-5,5,0,-2,4,2,3,0,3,0,2,2,0,1,1,1,0,2,0,-3,3,5,0,-1,1,-1,-1,1,2,-1
KR_6747221987,440,-3,-32,-70,-7,-4,5,1,-3,4,1,-1,3,2,1,1,2,0,0,0,0,-1,-1,-6,-2,8,2,0,0,-1,1,-1,-1,2,-1
KR_6738544768,420,-4,-52,-4,-13,-3,3,0,-3,5,2,-1,4,3,-3,4,1,-3,4,1,0,-18,-9,4,-8,4,-2,0,-1,-1,-1,-1,-1,3,-1
KR_6729453107,420,-3,-1,21,-4,-5,5,0,-5,6,1,2,4,6,2,2,4,2,2,4,-1,-6,0,3,-3,0,2,0,-1,0,0,-1,-1,0,-1
KR_6753033735,420,-1,20,-12,2,2,0,2,-1,3,2,1,2,3,1,1,2,-1,1,0,0,1,-241,-1,-3,4,3,0,0,1,-1,0,1,2,-1
KR_6761206160,420,1,6,-39,-5,-3,5,2,1,1,2,-1,1,0,-2,6,4,0,2,2,-2,2,94,-5,-1,6,-1,0,0,-1,-1,1,-1,6,-1
KR_6744321599,420,-1,-55,3,0,0,0,0,-1,5,4,0,1,1,1,0,1,0,0,0,0,1,14,-3,-5,8,-2,0,-1,1,-1,-1,1,5,-1
KR_6765188847,420,2,-4,25,-1,-5,8,3,0,3,3,2,1,3,1,3,4,1,2,3,-1,-4,5,3,-10,7,1,0,1,1,-1,-1,-1,4,-1
KR_6754840710,420,-1,31,23,-4,-2,2,0,2,1,3,1,3,4,-6,10,4,1,0,1,-1,-5,-3,3,-10,7,-4,0,-1,-1,-1,-1,-1,3,-1
KR_6633288566,420,-1,33,-4,-5,-2,3,1,-2,4,2,1,2,3,-1,2,1,-1,1,0,0,-6,0,-5,-2,7,-1,0,-1,-1,-1,-1,1,1,-1
KR_6732684688,420,-1,-60,-5,3,-3,4,1,1,3,4,-1,3,2,2,2,4,4,0,4,0,2,-3,-6,-2,8,1,0,-1,1,-1,-1,1,4,-1
KR_6764223382,420,-2,13,-31,-9,-4,4,0,-2,6,4,-2,4,2,-2,5,3,1,0,1,0,-5,4,-2,-4,6,-2,0,-1,-1,-1,-1,-1,2,-1
KR_6759840047,420,-7,-59,-48,3,0,0,0,2,2,4,-5,6,1,7,1,8,-1,5,4,2,5,1,-1,-5,6,1,0,0,-1,-1,-1,1,4,-1
KR_6726500162,420,1,88,5,-5,2,2,4,-2,3,1,0,3,3,-3,5,2,-2,5,3,0,-14,262,0,-4,4,0,0,0,1,-1,-1,1,4,-1
KR_6678996011,420,-3,-58,-20,-1,-2,2,0,-1,2,1,1,2,3,2,2,4,-1,1,0,0,-5,-32,-2,-3,5,3,0,-1,-1,1,-1,-1,4,-1
KR_6684178862,420,0,25,0,-10,1,3,4,-4,4,0,-2,4,2,-3,3,0,-2,3,1,0,-16,1,1,-2,1,-3,0,0,-1,-1,-1,1,3,-1
KR_6760747756,420,-6,-22,-52,-13,-2,2,0,-1,3,2,-5,5,0,-5,7,2,0,3,3,0,-7,0,0,-3,3,0,0,-1,-1,-1,-1,-1,2,-1
KR_6761283014,420,-1,-62,-9,0,1,2,3,-5,5,0,0,2,2,1,3,4,3,1,4,0,-1,0,3,-6,3,-4,0,0,-1,-1,-1,-1,3,-1
KR_6759763895,440,-2,-10,-12,-5,0,1,1,0,1,1,-7,9,2,2,0,2,0,0,0,0,-5,3,-3,-3,6,-1,0,0,0,-1,0,-1,0,-1
KR_6760239585,420,0,7,16,-1,-3,4,1,-2,3,1,2,1,3,2,0,2,0,0,0,-1,0,-4,-2,-4,6,-2,0,0,1,-1,0,-1,6,-1
KR_6754827470,420,-1,44,11,-8,0,1,1,2,1,3,-4,4,0,-4,6,2,-2,3,1,-1,-7,5,3,-5,2,1,0,0,1,-1,0,-1,1,-1
KR_6762515413,440,2,-41,16,-2,1,2,3,-3,4,1,-3,5,2,3,2,5,0,0,0,-1,-2,-7,-5,0,5,1,0,-1,-1,-1,-1,-1,3,-1
KR_6690710488,440,-3,-57,-14,-5,1,2,3,-3,6,3,-1,1,0,-2,3,1,0,2,2,0,-2,7,4,-9,5,0,0,-1,-1,1,-1,1,6,-1
KR_6658367618,420,0,-34,-13,1,-3,4,1,-2,3,1,6,0,6,0,7,7,0,2,2,-1,1,-2,4,-9,5,4,0,1,-1,1,1,-1,5,-1
KR_6763003414,420,-3,-95,-7,-7,0,1,1,-2,3,1,0,2,2,-5,5,0,0,1,1,0,-5,61,-5,-4,9,2,0,-3,-1,-1,-1,-1,3,-1
KR_6748513415,420,-4,-65,17,-8,-1,1,0,-3,4,1,1,1,2,-4,8,4,-1,3,2,0,-7,5,0,-5,5,2,0,-3,-1,-1,-1,-1,3,-1
KR_6649198959,420,0,-39,-4,0,0,3,3,-1,3,2,-1,1,0,3,1,4,-1,1,0,0,1,-2,8,-11,3,-3,0,1,-1,1,1,1,1,-1
KR_6748903249,440,0,66,-1,-4,-2,4,2,-10,11,1,2,2,4,4,0,4,2,0,2,0,-1,2,-1,-2,3,3,0,0,0,0,1,1,0,-1
KR_6760506794,420,-4,-70,-13,-11,-3,4,1,-3,3,0,-6,6,0,2,0,2,-1,2,1,0,-2,2,0,-6,6,-5,0,-1,-1,-1,-1,-1,1,-1
KR_6764867340,440,1,16,28,8,1,3,4,8,0,8,2,0,2,-2,5,3,-1,1,0,0,8,2,3,-4,1,-1,0,0,1,1,1,1,5,-1
KR_6745154696,420,-1,-12,0,1,-2,5,3,1,1,2,-1,2,1,4,0,4,-1,2,1,0,5,4,-2,-3,5,-2,0,0,-1,1,0,1,3,-1
KR_6666660369,420,2,34,4,5,7,1,8,1,3,4,0,2,2,-3,4,1,0,0,0,2,4,-125,2,-3,1,6,0,1,-1,0,1,1,1,-1
KR_6739323065,420,0,-35,-12,3,-2,4,2,-1,2,1,0,2,2,4,2,6,2,0,2,0,9,16,4,-7,3,-6,0,0,-1,-1,-1,1,1,-1
KR_6719639615,420,-4,-46,-19,-10,-2,2,0,-2,2,0,-7,8,1,0,1,1,1,0,1,0,-11,110,3,-7,4,-1,0,-1,-1,-1,-1,-1,4,-1
KR_6724500262,420,-5,-52,-24,-7,-3,3,0,0,3,3,-3,3,0,-1,3,2,0,2,2,0,-4,-23,3,-9,6,1,0,0,0,-1,-1,-1,0,-1
KR_6601232954,420,-3,-11,1,-11,0,1,1,-2,5,3,-8,9,1,0,1,1,-1,1,0,0,-12,-3,2,-5,3,-1,0,0,-1,-1,0,-1,6,-1
KR_6732493218,420,-1,-8,-15,4,2,0,2,1,3,4,-4,5,1,3,0,3,2,0,2,1,5,-11,4,-8,4,-2,0,-1,0,-1,-1,1,0,-1
KR_6644593375,420,-1,-48,-9,-1,0,0,0,4,0,4,0,2,2,-1,4,3,-4,4,0,-1,-2,-11,-5,-2,7,0,0,0,0,1,0,-1,0,-1
KR_6653935226,420,-4,-19,-17,-7,-1,3,2,-2,3,1,-1,2,1,-2,3,1,-1,2,1,0,-10,-34,-3,-5,8,19,0,-3,-1,-1,-1,-1,1,-1
KR_6734555436,420,-3,-78,-4,-12,-1,1,0,-2,3,1,-2,4,2,-5,5,0,-2,2,0,0,-11,-40,-7,-3,10,19,0,-1,-1,-1,-1,-1,4,-1
KR_6750156728,420,-2,-61,-4,-9,-3,3,0,0,3,3,-5,6,1,-2,3,1,1,0,1,0,-8,111,-1,-6,7,0,0,-1,1,-1,-1,-1,6,-1
KR_6731275765,420,-5,-25,-44,-6,-7,8,1,6,1,7,-1,2,1,-4,5,1,0,0,0,0,5,46,5,-7,2,-19,0,-2,-1,-1,-1,-1,5,-1
KR_6761386577,420,-1,23,-18,-4,-1,2,1,0,2,2,-2,3,1,-1,4,3,0,1,1,0,-5,-3,-2,-4,6,5,0,0,1,-1,0,1,5,-1
KR_6764283894,440,-5,-4,-8,-11,-2,2,0,-3,3,0,-6,7,1,0,0,0,0,1,1,0,-9,-1,-3,-4,7,1,0,-1,-1,-1,-1,-1,2,-1
KR_6742984939,440,2,6,-1,2,0,1,1,1,4,5,-1,2,1,2,4,6,0,0,0,0,0,-4,-1,-4,5,2,0,0,-1,1,0,1,2,-1
KR_6640140425,420,-1,-57,4,-13,-3,4,1,-5,6,1,-3,3,0,-2,8,6,0,2,2,0,-14,-8,-6,-2,8,-1,0,-1,-1,-1,-1,-1,3,-1
KR_6756848777,440,-2,-59,-6,-6,-4,4,0,2,1,3,-3,5,2,-2,3,1,1,0,1,-1,-13,-3,-3,-4,7,2,0,-1,-1,1,-1,-1,1,-1
KR_6731667137,420,-2,12,-19,-4,2,0,2,1,3,4,-8,8,0,1,1,2,0,1,1,0,-2,6,0,-7,7,-1,0,-1,0,-1,-1,-1,0,-1
KR_6753700832,420,-2,-27,-12,-5,-1,4,3,-2,2,0,0,3,3,-1,4,3,-1,1,0,0,-8,0,1,-5,4,-1,0,-1,-1,-1,-1,1,1,-1
KR_6562214097,420,-3,-13,-24,-11,-3,5,2,3,1,4,-2,3,1,-6,6,0,-3,4,1,-2,-23,-17,-4,-1,5,2,0,-2,-1,-1,-1,-1,2,-1
KR_6655836683,440,-4,7,-30,-9,-4,5,1,-3,5,2,-1,5,4,-1,2,1,0,2,2,0,-7,14,4,-6,2,-4,0,0,-1,1,-1,-1,5,-1
KR_6763327389,420,4,48,36,-1,-4,4,0,2,1,3,1,2,3,-3,4,1,3,1,4,0,-2,-57,-8,-1,9,3,0,0,1,-1,0,-1,4,-1
KR_6696819165,420,-3,-81,4,0,0,1,1,-3,4,1,1,0,1,2,2,4,0,0,0,0,1,374,2,-7,5,-9,0,-1,-1,1,-1,1,6,-1
KR_6725301865,420,-5,-79,-24,-11,-4,4,0,-4,6,2,2,2,4,-5,6,1,0,0,0,0,0,5,-5,-3,8,-1,0,-2,1,-1,-1,-1,1,-1
KR_6764779620,420,-1,15,-60,1,1,3,4,2,0,2,-2,3,1,0,0,0,0,0,0,0,4,-6,-3,-2,5,-1,0,0,-1,-1,0,1,5,-1
KR_6759336879,440,-3,-8,-25,-8,3,1,4,-7,8,1,1,0,1,-5,5,0,0,3,3,0,-14,-7,0,-4,4,-1,0,0,-1,-1,0,1,3,-1
KR_6684045563,440,-1,-10,-48,-1,-1,4,3,0,4,4,-3,6,3,4,1,5,-1,2,1,0,5,3,-4,0,4,1,0,-1,-1,-1,-1,1,4,-1
KR_6734192571,440,-1,61,34,-2,1,4,5,0,3,3,1,0,1,-1,1,0,-3,4,1,1,-6,-28,-1,0,1,0,0,0,-1,-1,-1,1,1,-1
KR_6763109814,440,0,2,12,-8,1,0,1,-4,7,3,-4,4,0,-2,4,2,1,0,1,-1,-11,-4,-7,-2,9,0,0,-1,0,0,-1,-1,0,-1
KR_6765739382,420,-1,-55,8,-8,0,0,0,1,0,1,-1,3,2,-7,7,0,-1,1,0,0,-17,5,3,-8,5,-4,0,0,-1,0,0,-1,1,-1
KR_6759676065,420,-2,-34,-19,-5,-2,3,1,-1,1,0,-4,5,1,-1,2,1,3,0,3,0,-3,19,-3,-2,5,1,0,0,-1,1,0,-1,3,-1
KR_6764194721,420,-1,-33,24,-5,-1,4,3,2,0,2,-3,3,0,-3,5,2,0,1,1,0,-11,185,3,-6,3,-1,0,-1,1,1,1,-1,4,-1
KR_6699892425,420,1,20,-16,-1,-2,6,4,8,1,9,-7,7,0,0,4,4,0,2,2,0,8,11,1,-5,4,-3,0,0,1,1,1,-1,2,-1
KR_6752256085,420,-2,-85,-24,1,2,0,2,0,0,0,-1,3,2,2,2,4,-2,4,2,0,8,43,2,-7,5,24,0,0,-1,1,-1,1,5,-1
KR_6753145813,420,-2,54,-13,-5,1,1,2,-9,9,0,0,3,3,1,2,3,2,1,3,0,-6,-32,1,-6,5,1,0,-1,-1,-1,-1,1,5,-1
KR_6666711175,420,-1,24,-7,-1,-4,7,3,-3,4,1,4,2,6,2,1,3,0,1,1,0,-2,221,-1,-2,3,2,0,-1,-1,-1,-1,1,3,-1
KR_6618164546,420,-2,-56,-27,-6,0,2,2,-3,5,2,0,1,1,-4,7,3,1,0,1,0,-11,-10,-1,-5,6,-2,0,-1,1,-1,-1,-1,1,-1
KR_6762583023,440,-2,0,0,-4,-1,2,1,1,1,2,-6,8,2,1,2,3,1,2,3,0,-7,4,2,-6,4,1,0,0,-1,-1,1,-1,3,-1
KR_6740221811,420,1,-12,-26,-2,1,0,1,-5,5,0,-1,2,1,2,1,3,1,0,1,0,1,98,-6,-4,10,4,0,0,-1,-1,0,1,5,-1
KR_6703949558,420,-5,-48,-20,-17,3,1,4,-15,16,1,-4,4,0,-3,4,1,2,0,2,2,-17,-36,-4,-4,8,6,0,-3,0,0,-1,-1,0,-1
KR_6740138728,420,0,-83,-2,10,-2,2,0,8,1,9,1,6,7,0,5,5,3,2,5,-2,19,-21,0,-4,4,1,0,-2,-1,-1,-1,-1,6,-1
KR_6704557570,420,-2,-90,-28,0,-4,4,0,2,1,3,-2,4,2,2,0,2,2,0,2,0,7,47,4,-7,3,-3,0,-1,-1,-1,-1,1,6,-1
KR_6765416178,420,-2,-56,12,-8,0,1,1,1,1,2,-5,6,1,-3,3,0,-1,1,0,0,-7,124,-1,-2,3,-3,0,1,-1,1,1,-1,1,-1
KR_6711656067,420,-2,-118,29,-6,-1,1,0,-1,5,4,-1,4,3,-4,7,3,1,2,3,-2,-1,89,-1,-4,5,-1,0,-5,1,-1,-1,-1,5,-1
KR_6634348949,420,-3,-27,-8,-2,1,0,1,0,2,2,4,0,4,-5,7,2,-2,3,1,0,-7,-9,3,-7,4,4,0,0,1,-1,0,1,5,-1
KR_6676127356,420,-5,22,-16,-11,-6,7,1,-2,5,3,-2,3,1,-1,1,0,0,0,0,1,-12,9,-2,-3,5,2,0,1,-1,1,1,1,5,-1
KR_6745687250,420,-5,-111,0,-15,1,4,5,-3,3,0,-3,5,2,-8,8,0,-2,2,0,0,-21,25,-4,-3,7,-3,0,-1,1,-1,-1,-1,4,-1
KR_6751092701,420,-1,63,2,-8,-1,1,0,-5,7,2,-2,3,1,1,1,2,-1,1,0,0,-15,4,-4,-5,9,-6,0,-1,-1,-1,-1,-1,2,-1
KR_6702223627,420,-4,-81,20,-7,-4,4,0,-6,6,0,-1,4,3,3,0,3,1,1,2,0,-4,-6,0,-3,3,-1,0,-3,1,1,-1,-1,3,-1
KR_6654434516,420,-5,-91,-3,-14,-4,5,1,-10,11,1,1,1,2,0,1,1,-1,1,0,0,-16,-1,-2,-5,7,0,0,-1,-1,-1,-1,-1,5,-1
KR_6753626118,420,-5,-40,-6,-15,-5,6,1,-3,4,1,-4,6,2,-2,4,2,-1,2,1,0,-11,1,1,-6,5,1,0,-1,1,-1,-1,1,6,-1
KR_6705289668,420,-3,-76,-4,-5,-7,8,1,-1,3,2,1,0,1,1,0,1,1,0,1,0,1,23,-1,-2,3,2,0,0,-1,-1,0,-1,4,-1
KR_6763810038,420,-2,9,12,-2,1,0,1,-4,5,1,0,2,2,-3,5,2,4,2,6,0,-2,-210,5,-7,2,-1,0,0,0,-1,0,1,0,-1
KR_6729811779,440,-3,-27,16,-11,-3,3,0,-2,5,3,-2,2,0,-2,3,1,-2,3,1,0,-12,-6,-4,-2,6,-2,0,0,-1,1,-1,-1,4,-1
KR_6750669817,420,-5,-10,-27,-9,1,1,2,-1,4,3,1,1,2,-5,5,0,-5,6,1,-2,-9,6,0,-3,3,-1,0,0,1,-1,0,-1,4,-1
KR_6765825175,420,-2,-56,19,-9,-3,4,1,-3,5,2,2,0,2,-5,8,3,0,0,0,0,-18,-3,-7,0,7,0,0,0,0,0,0,-1,0,-1
KR_6750326469,420,-2,7,-12,-8,-3,4,1,-2,5,3,-2,3,1,-1,3,2,0,1,1,-1,-10,2,-3,-1,4,5,0,0,-1,-1,-1,-1,6,-1
KR_6722115237,420,-6,-89,-20,-6,-2,3,1,-5,5,0,2,0,2,-1,2,1,0,0,0,0,-3,-2,-3,-3,6,5,0,-1,-1,-1,-1,-1,1,-1
KR_6766543806,420,-1,-64,8,-7,-2,3,1,-1,4,3,0,0,0,-5,6,1,1,0,1,0,-8,-50,-4,-4,8,13,0,0,1,-1,-1,1,6,-1
KR_6722744703,440,1,11,-16,-1,2,0,2,-3,6,3,5,0,5,-4,4,0,-1,1,0,0,-2,0,-4,-3,7,0,0,-1,-1,1,-1,-1,2,-1
KR_6630966846,420,-1,-38,-20,-1,0,2,2,-2,3,1,1,3,4,1,1,2,-1,2,1,0,-7,-5,1,-6,5,-4,0,0,0,0,-1,1,0,-1
KR_6716606011,420,-3,5,-4,-3,1,3,4,-2,3,1,0,2,2,-2,3,1,0,0,0,0,-8,2,2,-8,6,4,0,-1,1,-1,-1,-1,3,-1
KR_6710903795,420,-6,-133,-48,-6,0,1,1,-5,5,0,-2,2,0,1,0,1,0,0,0,0,-5,-35,-4,-2,6,0,0,-3,-1,0,-1,-1,3,-1
KR_6728092168,440,-3,30,22,-9,-2,7,5,0,1,1,1,2,3,-6,6,0,-2,2,0,-1,-20,12,2,-7,5,5,0,-2,-1,-1,-1,-1,1,-1
KR_6753460013,420,-5,-90,-44,-4,-3,5,2,-2,3,1,4,1,5,-3,4,1,0,1,1,0,-1,37,4,-6,2,-2,0,0,-1,1,-1,-1,2,-1
KR_6731653694,440,-6,-99,-32,-16,-4,4,0,3,0,3,-5,8,3,-5,6,1,-5,7,2,0,-7,19,2,-4,2,0,0,-2,-1,-1,-1,-1,2,-1
KR_6764736014,420,-2,-34,-8,2,-2,4,2,0,4,4,1,1,2,1,0,1,2,0,2,0,6,7,-3,-4,7,-3,0,0,-1,-1,0,1,6,-1
KR_6749257517,420,-4,-77,-18,-10,-2,2,0,-5,7,2,-2,6,4,-2,3,1,1,1,2,0,-15,8,0,-3,3,-1,0,0,-1,1,-1,1,6,-1
KR_6679444048,420,0,-67,28,1,0,0,0,-6,8,2,4,0,4,0,2,2,3,2,5,0,2,3,4,-7,3,1,0,-1,1,1,-1,-1,4,-1
KR_6756042881,420,-4,-31,-26,-10,0,2,2,0,3,3,1,1,2,-10,12,2,-1,2,1,0,-14,-66,-4,0,4,18,0,0,-1,-1,1,-1,6,-1
KR_6651144039,420,-1,-8,-20,-5,1,2,3,-1,2,1,-7,7,0,2,1,3,0,1,1,0,-1,3,-3,0,3,0,0,-1,1,-1,-1,-1,3,-1
KR_6758040486,420,-2,-35,-12,-1,5,0,5,-3,5,2,1,0,1,-5,6,1,1,2,3,0,-6,7,2,-8,6,-4,0,-1,-1,1,-1,-1,5,-1
KR_6646711132,420,-2,21,-10,-7,-2,4,2,-9,10,1,2,0,2,2,2,4,0,1,1,0,-6,12,1,-9,8,-2,0,0,-1,-1,-1,1,1,-1
KR_6745171223,420,-2,-7,8,0,-3,3,0,1,2,3,-3,5,2,0,2,2,5,0,5,0,5,22,3,-5,2,1,0,-1,-1,-1,-1,-1,1,-1
KR_6761627447,420,-4,-53,-16,-8,2,0,2,-2,4,2,-3,4,1,-1,3,2,-4,5,1,1,-11,-3,0,-4,4,-3,0,0,-1,1,1,1,4,-1
KR_6724529645,420,1,18,7,-3,1,4,5,3,4,7,-1,2,1,-5,6,1,-1,1,0,0,-5,46,3,-7,4,-18,0,0,0,-1,1,1,0,-1
KR_6563435312,420,-6,-52,-1,-16,-3,6,3,-1,2,1,-4,4,0,-4,6,2,-4,5,1,0,-22,0,-1,-5,6,-2,0,-1,-1,-1,-1,-1,6,-1
KR_6651657335,440,2,20,0,2,4,0,4,-5,7,2,0,2,2,0,1,1,3,1,4,0,-1,-2,2,-4,2,6,0,1,1,1,1,1,3,-1
KR_6705083082,420,2,89,-9,1,2,3,5,-8,10,2,7,0,7,0,2,2,0,2,2,-1,1,6,1,-3,2,-3,0,-1,-1,1,-1,-1,1,-1
KR_6711853642,420,-3,-57,4,-7,1,1,2,2,2,4,-2,2,0,-4,5,1,-4,4,0,0,-17,223,0,-6,6,-4,0,0,1,-1,1,-1,6,-1
KR_6760898627,420,-4,-33,-20,-3,-2,2,0,1,2,3,-4,4,0,2,1,3,0,1,1,0,5,-3,2,-4,2,-2,0,-1,-1,-1,-1,-1,6,-1
KR_6685055516,440,1,83,-12,5,0,0,0,2,1,3,1,1,2,2,2,4,0,0,0,0,6,-2,3,-5,2,0,0,0,1,-1,0,-1,4,-1
KR_6764849872,420,-1,17,6,-5,2,0,2,2,1,3,-8,12,4,1,2,3,-2,3,1,0,-4,1,-2,-3,5,-3,0,0,1,1,0,-1,1,-1
KR_6647015101,420,-4,-68,-30,-5,1,1,2,-3,6,3,0,2,2,-1,5,4,-2,2,0,1,-1,16,-2,-2,4,1,0,0,-1,1,0,1,6,-1
KR_6629069121,420,-4,-35,2,-12,-3,4,1,-7,7,0,-4,5,1,1,0,1,1,1,2,0,-3,-12,-6,-1,7,0,0,-2,-1,-1,-1,-1,2,-1
KR_6672026124,420,-3,-2,-30,-5,0,1,1,-6,8,2,-2,2,0,4,0,4,-1,2,1,0,0,-1,0,-4,4,-1,0,0,-1,-1,0,-1,1,-1
KR_6758182797,440,-1,-28,21,-4,-1,1,0,3,1,4,-3,5,2,0,0,0,-3,6,3,0,5,-6,-1,-4,5,0,0,-1,1,1,-1,1,6,-1
KR_6750427394,440,1,16,16,4,-1,6,5,-2,2,0,1,0,1,2,0,2,4,0,4,-1,5,-1,2,-5,3,-2,0,0,1,-1,1,-1,2,-1
KR_6753353203,420,-1,-47,-62,-7,0,1,1,-7,9,2,-4,6,2,5,1,6,-1,1,0,0,6,-6,-3,0,3,2,0,1,0,-1,1,1,0,-1
KR_6723953447,420,-2,-57,-24,-4,-1,1,0,1,2,3,0,5,5,-2,5,3,-2,3,1,0,-6,3,-4,-2,6,1,0,-1,-1,-1,-1,1,4,-1
KR_6765075916,440,-3,-97,28,-7,-1,2,1,-1,2,1,-3,4,1,-2,2,0,0,0,0,0,-6,0,-3,-1,4,-1,0,-2,-1,-1,-1,-1,6,-1
KR_6726552904,420,-3,-79,-21,-3,-1,1,0,0,4,4,3,1,4,-3,4,1,-2,2,0,0,3,-31,-1,-4,5,12,0,-1,-1,1,-1,1,4,-1
KR_6751555161,420,-1,-31,8,-1,0,2,2,3,1,4,0,1,1,-3,4,1,-1,1,0,1,-2,56,0,-6,6,-1,0,-1,-1,-1,-1,1,3,-1
KR_6748933260,420,-2,9,44,-7,-2,5,3,-1,1,0,-1,2,1,1,2,3,-4,4,0,0,-10,25,-2,-4,6,1,0,0,1,1,1,-1,1,-1
KR_6763796139,420,-4,-94,9,-8,-4,4,0,2,2,4,-5,5,0,1,0,1,-2,2,0,0,-4,-91,-3,-1,4,-1,0,-1,0,-1,-1,-1,0,-1
KR_6756582515,420,0,-2,-4,-7,-1,1,0,2,1,3,-3,4,1,-2,6,4,-3,3,0,0,-4,-5,-3,-5,8,-1,0,-1,-1,-1,-1,-1,5,-1
KR_6744877448,420,-3,-44,-41,-3,-3,5,2,-2,5,3,-3,4,1,4,2,6,1,1,2,-1,0,10,2,-6,4,-2,0,-1,-1,0,-1,-1,4,-1
KR_6725352196,420,0,-9,18,1,1,2,3,2,1,3,-4,6,2,3,1,4,-1,2,1,0,10,20,-1,-3,4,-1,0,2,-1,-1,1,-1,1,-1
KR_6724656928,420,0,43,-25,6,-1,2,1,2,1,3,4,1,5,0,3,3,1,2,3,0,6,5,0,-6,6,-2,0,-1,1,-1,1,-1,5,-1
KR_6746121056,420,-2,-40,11,-7,0,2,2,-6,7,1,-1,1,0,0,2,2,0,2,2,1,-4,11,-4,-3,7,-5,0,0,-1,1,0,-1,1,-1
KR_6703193103,420,2,-50,-19,2,2,1,3,-1,2,1,3,2,5,-4,4,0,2,1,3,0,2,-1,4,-6,2,0,0,-1,-1,1,-1,-1,6,-1
KR_6737896477,420,2,-30,0,1,5,1,6,2,4,6,-2,6,4,-4,8,4,0,2,2,0,-7,13,8,-12,4,-8,0,1,-1,1,1,1,4,-1
KR_6748170422,420,1,9,12,3,-1,2,1,5,1,6,-1,3,2,1,2,3,-1,1,0,0,-4,1,2,-7,5,0,0,-1,1,1,-1,-1,6,-1
KR_6755245170,420,-3,-68,-38,1,0,2,2,2,1,3,0,1,1,-1,4,3,0,0,0,0,-3,-1,-2,-3,5,-3,0,0,-1,1,0,1,6,-1
KR_6760217013,420,-5,-96,-20,-10,-3,3,0,-3,4,1,-2,5,3,-3,8,5,1,0,1,0,-6,3,2,-3,1,-2,0,-1,-1,1,-1,-1,5,-1
KR_6762777965,420,-3,-31,16,-13,-10,10,0,2,4,6,-1,2,1,-3,8,5,-1,2,1,0,0,-13,-8,-2,10,7,0,-1,-1,-1,-1,1,6,-1
KR_6723144516,420,-1,-54,-8,-7,-3,3,0,1,4,5,0,3,3,-3,4,1,-2,2,0,0,-7,12,-3,-4,7,0,0,-1,1,-1,-1,-1,1,-1
KR_6629684958,420,0,-12,-8,-4,3,1,4,1,6,7,-5,7,2,-2,3,1,-1,2,1,-1,0,-24,1,-4,3,0,0,0,-1,-1,-1,-1,3,-1
KR_6601143999,420,1,28,-17,-2,1,0,1,-1,1,0,-1,1,0,1,1,2,-2,2,0,0,-2,-31,1,-7,6,4,0,-1,-1,-1,-1,-1,1,-1
KR_6749530446,420,-5,-36,-8,-10,-5,6,1,-3,3,0,0,2,2,-1,4,3,-1,1,0,0,-3,4,-3,-3,6,3,0,0,-1,1,-1,-1,5,-1
KR_6655256239,420,-2,16,-19,-8,4,0,4,-1,5,4,-2,4,2,-8,11,3,-1,2,1,0,-13,-3,-4,-4,8,-1,0,-2,-1,-1,-1,1,4,-1
KR_6763252653,420,2,-43,-3,2,1,2,3,1,3,4,0,4,4,-1,3,2,1,0,1,0,0,-7,2,-6,4,-2,0,-1,0,-1,-1,1,0,-1
KR_6739030310,420,-3,-24,-28,2,-1,3,2,2,1,3,-4,9,5,4,0,4,1,0,1,0,-1,-1,-3,-5,8,0,0,-1,-1,-1,-1,1,3,-1
KR_6734161355,420,-3,-111,12,-9,-4,4,0,1,2,3,-1,3,2,-4,5,1,-1,1,0,0,-2,112,-3,-9,12,-7,0,1,-1,-1,-1,-1,3,-1
KR_6758983655,440,-6,-114,-32,-12,-4,6,2,3,0,3,-3,4,1,-8,9,1,0,3,3,-2,-19,-6,-6,-4,10,-2,0,-1,-1,1,-1,-1,3,-1
KR_6752641168,420,-1,62,-36,0,-2,3,1,2,1,3,0,1,1,1,2,3,-1,1,0,0,1,0,0,-5,5,4,0,0,1,-1,0,-1,3,-1
KR_6713402866,420,-7,-47,-44,-8,0,1,1,-6,7,1,-5,8,3,4,1,5,-1,2,1,0,-6,-29,1,-3,2,2,0,-3,1,-1,-1,-1,1,-1
KR_6742117561,420,-2,14,12,-1,-2,2,0,1,2,3,1,1,2,1,1,2,-2,3,1,1,3,-17,4,-9,5,-10,0,1,-1,1,1,1,5,-1
KR_6751489817,420,-2,3,-24,-2,6,1,7,-2,3,1,0,3,3,-6,7,1,0,0,0,-1,-6,7,-2,-4,6,-6,0,-1,0,-1,-1,-1,0,-1
KR_6755985542,420,-4,-52,0,-8,0,1,1,-5,6,1,-3,5,2,0,0,0,0,0,0,0,-3,-122,-3,-4,7,-14,0,0,0,-1,0,-1,0,-1
KR_6740861308,420,-3,0,-29,-4,0,1,1,0,2,2,-2,3,1,0,2,2,-2,3,1,0,1,1,1,-4,3,-2,0,-1,-1,-1,-1,1,6,-1
KR_6763049363,420,-7,-64,-5,-21,-1,1,0,2,2,4,-9,9,0,-10,11,1,-3,3,0,0,-21,187,-5,-2,7,-1,0,-1,-1,1,-1,-1,6,-1
KR_6684553049,420,-4,-71,0,-9,-1,3,2,-2,2,0,-3,5,2,-3,5,2,0,1,1,1,-19,3,0,-7,7,1,0,-3,-1,-1,-1,1,3,-1
KR_6671370746,420,-4,-29,12,-13,0,2,2,-1,3,2,0,2,2,-8,9,1,-4,4,0,0,-17,-16,-2,-5,7,-7,0,-1,-1,-1,-1,-1,5,-1
KR_6764855434,420,0,-16,-17,0,0,1,1,1,1,2,-1,3,2,-1,2,1,1,0,1,0,0,3,4,-8,4,-6,0,0,0,0,0,-1,0,-1
KR_6732582735,420,0,-34,21,3,-1,5,4,-2,3,1,2,5,7,3,0,3,1,0,1,0,4,2,4,-8,4,1,0,0,1,1,1,-1,6,-1
KR_6746266893,440,0,38,-16,-2,0,1,1,-2,5,3,-2,5,3,5,0,5,-3,5,2,0,2,2,0,-4,4,1,0,-1,1,-1,-1,1,5,-1
KR_6729376009,420,-4,-49,13,-12,-4,4,0,0,3,3,0,2,2,-9,10,1,1,1,2,1,-11,0,0,-3,3,4,0,-2,-1,-1,-1,1,2,-1
KR_6762464610,420,0,7,8,-5,1,2,3,-1,3,2,-4,5,1,-2,4,2,1,1,2,0,-3,0,0,-4,4,0,0,2,1,1,1,-1,5,-1
KR_6659303394,420,0,30,-17,1,5,0,5,-2,4,2,-5,7,2,4,0,4,-1,1,0,0,-5,-8,-1,-3,4,1,0,0,-1,0,1,1,3,-1
KR_6764898828,420,-3,-52,15,-13,-3,6,3,-5,5,0,0,2,2,-5,5,0,0,2,2,0,-9,-2,0,-3,3,2,0,-2,-1,-1,-1,-1,5,-1
KR_6751934991,420,-2,-59,-4,-4,-2,4,2,0,2,2,2,0,2,1,2,3,-5,5,0,0,-11,6,1,-5,4,-4,0,-1,1,-1,-1,1,1,-1
KR_6704916041,420,0,-50,-4,-2,0,3,3,-4,8,4,1,1,2,4,0,4,-3,4,1,0,4,-13,0,-4,4,-6,0,-1,-1,0,-1,1,3,-1
KR_6722204744,440,-3,-20,4,5,-1,6,5,-1,2,1,4,1,5,1,3,4,2,0,2,0,4,-47,0,-3,3,24,0,-1,-1,0,-1,-1,1,-1
KR_6760158962,420,-3,66,16,-8,1,1,2,-7,10,3,-2,6,4,0,2,2,0,1,1,0,-7,-12,2,-5,3,2,0,-2,-1,-1,-1,-1,2,-1
KR_6633028236,420,-2,-21,9,-9,-3,5,2,-3,4,1,-2,6,4,0,3,3,-1,2,1,0,-11,-46,0,-6,6,21,0,-1,-1,1,-1,1,1,-1
KR_6747976809,420,-2,-64,0,-8,-2,2,0,-3,4,1,-1,2,1,1,4,5,-3,4,1,0,-8,0,-1,-3,4,0,0,-1,1,-1,-1,-1,2,-1
KR_6622496270,420,0,-26,-7,1,-6,6,0,2,2,4,-3,6,3,6,0,6,2,0,2,1,10,6,-1,-4,5,1,0,-1,0,-1,-1,1,0,-1
KR_6625228648,420,-4,-47,5,-8,-3,3,0,2,2,4,0,1,1,-3,4,1,-4,6,2,0,-12,-4,-1,-3,4,4,0,0,-1,-1,-1,-1,2,-1
KR_6728060365,420,-2,17,11,0,2,0,2,-2,6,4,1,1,2,0,3,3,-1,1,0,0,-7,1,-2,-2,4,0,0,0,-1,0,1,1,6,-1
KR_6760653412,420,-4,-14,-22,-12,0,1,1,-5,5,0,-5,6,1,-3,4,1,1,0,1,0,-7,-229,5,-7,2,-24,0,-1,-1,0,-1,-1,2,-1
KR_6754088601,420,-1,-3,19,-9,-5,7,2,1,3,4,-2,3,1,-2,3,1,-1,1,0,0,-9,2,1,-4,3,-1,0,0,0,-1,0,1,0,-1
KR_6730962919,420,-1,11,-27,-1,2,2,4,-2,4,2,-1,2,1,-1,6,5,1,2,3,0,-4,7,6,-10,4,2,0,1,-1,1,1,-1,5,-1
KR_6759903252,420,-3,-92,0,-10,0,1,1,-9,14,5,-2,3,1,-2,4,2,3,0,3,-1,-6,-4,1,-6,5,1,0,-2,1,-1,-1,1,1,-1
KR_6725373999,420,0,17,-20,-9,-1,1,0,-6,7,1,-1,2,1,0,2,2,-1,1,0,0,-10,5,3,-7,4,-3,0,0,-1,-1,0,-1,3,-1
KR_6758922892,420,0,-29,-10,-2,1,3,4,0,2,2,0,3,3,-1,3,2,-2,4,2,-1,-1,-116,3,-6,3,-2,0,-1,0,-1,-1,-1,0,-1
KR_6761242228,420,-1,-39,8,-7,-1,4,3,-2,4,2,1,1,2,-3,6,3,-2,2,0,0,-10,11,-2,-3,5,-2,0,0,0,-1,0,-1,0,-1
KR_6731200969,420,1,-9,-4,6,3,0,3,1,0,1,4,2,6,-3,4,1,1,0,1,0,4,3,1,-6,5,1,0,0,1,1,-1,1,5,-1
KR_6755470790,420,0,13,-18,-3,-2,2,0,-3,4,1,1,0,1,1,2,3,0,0,0,0,-1,0,-4,-5,9,1,0,0,-1,-1,0,-1,5,-1
KR_6720095475,420,-2,14,-6,-4,0,1,1,0,2,2,1,1,2,-6,6,0,1,0,1,0,-10,-4,-2,-7,9,-4,0,-1,-1,-1,-1,1,5,-1
KR_6744548680,420,-2,-58,12,-2,-4,5,1,-2,5,3,0,1,1,4,1,5,0,0,0,-2,3,32,-4,-5,9,-13,0,-2,-1,1,-1,-1,3,-1
KR_6652805167,420,-4,5,0,-10,-1,2,1,-3,9,6,-4,5,1,0,2,2,-2,2,0,0,-9,-2,-3,-4,7,-5,0,-2,-1,-1,-1,1,6,-1
KR_6756281366,420,4,37,25,0,0,2,2,-1,4,3,-1,2,1,2,2,4,0,1,1,0,4,7,-4,-6,10,-4,0,1,1,-1,-1,-1,3,-1
KR_6742865607,420,-3,-56,-28,-5,-3,4,1,-1,5,4,1,1,2,0,2,2,-2,3,1,0,-2,-124,-1,-3,4,1,0,-1,-1,-1,-1,-1,1,-1
KR_6671044426,420,-1,-53,-13,-4,1,2,3,1,0,1,-3,4,1,-2,6,4,-1,2,1,0,-16,-7,-1,-4,5,-5,0,0,-1,1,0,1,6,-1
KR_6751850692,420,-1,-62,-32,-6,-4,6,2,-3,3,0,-6,8,2,6,1,7,1,0,1,-2,-4,0,-3,-1,4,-2,0,-1,-1,-1,-1,-1,1,-1
KR_6670446938,440,3,14,-7,7,1,0,1,1,0,1,-1,2,1,6,4,10,0,0,0,0,14,6,0,-8,8,-1,0,0,-1,-1,1,1,6,-1
KR_6760952748,420,-4,-9,-14,-15,-2,3,1,-6,6,0,-4,7,3,-1,3,2,-2,3,1,0,-25,5,-1,-3,4,2,0,0,1,1,0,-1,6,-1
KR_6700514685,420,-1,19,-6,0,0,1,1,-3,3,0,3,1,4,2,1,3,-2,2,0,0,2,-18,3,-7,4,0,0,0,1,-1,1,1,6,-1
KR_6762211231,420,-2,-117,20,-1,0,2,2,1,2,3,3,0,3,-3,5,2,-2,2,0,0,-1,-6,1,-6,5,-4,0,-1,1,1,-1,1,4,-1
KR_6760834879,420,-3,-57,-7,1,0,1,1,0,0,0,4,0,4,1,3,4,-4,4,0,0,-1,-11,-1,-5,6,1,0,1,1,1,-1,-1,5,-1
KR_6753048298,420,-1,-28,-8,-5,-3,4,1,2,0,2,-4,4,0,1,3,4,-1,1,0,0,-8,-93,-4,-5,9,3,0,0,1,-1,0,-1,2,-1
KR_6752813458,420,-1,-20,8,-9,-1,5,4,-4,5,1,-3,3,0,-3,5,2,2,0,2,-1,-4,-37,-3,-6,9,29,0,1,-1,1,1,-1,2,-1
KR_6749714871,420,-4,-37,-26,-11,1,0,1,-2,4,2,-1,3,2,-2,3,1,-7,7,0,0,-14,-29,-4,-1,5,-2,0,-2,-1,1,-1,-1,6,-1
KR_6701097860,420,-1,-53,-8,2,0,3,3,2,4,6,3,1,4,-3,4,1,0,0,0,1,2,-4,-3,-4,7,6,0,0,-1,0,0,1,1,-1
KR_6727598510,420,-4,-61,29,-14,-4,4,0,-1,6,5,-2,4,2,-4,4,0,-3,3,0,0,-9,-6,-7,-5,12,1,0,-1,1,-1,-1,-1,1,-1
KR_6633621525,420,-2,28,9,-12,-3,3,0,-2,5,3,-4,5,1,-2,3,1,-1,3,2,0,-19,2,4,-10,6,-4,0,-2,-1,-1,-1,1,4,-1
KR_6749789796,420,2,3,4,7,2,1,3,0,1,1,5,0,5,0,4,4,0,2,2,0,3,30,-1,-3,4,-12,0,-1,-1,-1,-1,1,6,-1
KR_6746795349,420,-5,-73,-11,-15,-2,3,1,-4,7,3,-2,4,2,-8,9,1,1,1,2,-1,-10,0,4,-11,7,-3,0,-4,1,-1,-1,-1,1,-1
KR_6706915668,440,-11,-125,-24,-15,-7,8,1,1,2,3,-2,4,2,-9,9,0,2,0,2,0,-4,-8,-1,-4,5,0,0,-4,-1,1,-1,-1,5,-1
KR_6679049568,420,-1,-15,18,0,2,1,3,-3,5,2,1,0,1,-2,4,2,2,2,4,0,-5,4,0,-5,5,0,0,-1,1,-1,-1,-1,3,-1
KR_6745313357,420,-3,-67,0,-10,0,1,1,-3,5,2,-3,4,1,-2,3,1,-2,2,0,0,-9,6,3,-6,3,-4,0,-1,-1,1,-1,-1,4,-1
KR_6732995366,420,-2,18,2,-4,-2,2,0,1,1,2,-3,5,2,0,4,4,0,1,1,1,-2,-10,-3,-4,7,-3,0,0,1,-1,-1,1,3,-1
KR_6686387358,420,-4,-76,-20,-4,-2,2,0,-1,4,3,1,1,2,-1,2,1,-1,1,0,0,-7,-32,-2,-5,7,-1,0,-1,-1,-1,-1,-1,3,-1
KR_6683302424,420,-3,-110,11,-15,-4,6,2,-4,6,2,-2,7,5,-4,5,1,-1,3,2,-1,-15,9,1,-5,4,0,0,-1,1,1,-1,-1,4,-1
KR_6696628925,420,-4,-50,23,-8,1,1,2,-2,5,3,0,0,0,-6,10,4,-1,2,1,-1,-10,0,-1,-3,4,1,0,-2,-1,0,-1,-1,1,-1
KR_6760439152,420,-2,3,4,-9,0,5,5,0,1,1,-2,3,1,-5,6,1,-2,2,0,0,-13,1,-4,0,4,0,0,0,-1,1,0,-1,5,-1
KR_6739556158,420,-1,-34,7,-2,1,1,2,-2,3,1,1,2,3,-3,3,0,1,0,1,0,-2,-11,-4,0,4,-2,0,-1,-1,1,1,-1,3,-1
KR_6743054554,420,0,-73,-16,-1,0,3,3,0,2,2,-3,4,1,0,4,4,2,1,3,1,7,-1,1,-4,3,-1,0,0,1,-1,-1,1,1,-1
KR_6722193110,420,1,33,-16,-4,0,1,1,-8,9,1,5,1,6,-1,3,2,0,0,0,0,-14,2,-4,-7,11,-4,0,1,-1,-1,1,-1,3,-1
KR_6752116489,440,1,19,-4,4,1,1,2,4,2,6,-2,5,3,-2,7,5,3,0,3,0,4,32,1,-6,5,-1,0,-1,0,1,1,1,0,-1
KR_6488711981,420,-1,87,-23,-12,-1,2,1,-3,8,5,-3,4,1,2,3,5,-7,7,0,0,-13,1,1,-7,6,7,0,1,-1,-1,1,-1,5,-1
KR_6750250280,420,1,-17,6,7,2,0,2,2,2,4,-1,4,3,3,2,5,1,0,1,0,3,-71,0,-4,4,20,0,-2,-1,-1,-1,-1,3,-1
KR_6755522644,420,-1,-55,-20,-2,-4,6,2,3,5,8,-3,4,1,2,1,3,0,0,0,0,12,-1,2,-8,6,-3,0,-2,-1,-1,-1,-1,4,-1
KR_6644661583,420,-6,-61,-24,-15,-3,4,1,-5,7,2,-2,5,3,-6,7,1,1,0,1,0,-12,-8,-2,-5,7,-2,0,-2,0,-1,-1,1,0,-1
KR_6755168325,440,-4,-33,-5,-9,1,2,3,-1,3,2,-1,1,0,-7,9,2,-1,2,1,0,-11,3,-1,-4,5,-4,0,-2,-1,1,-1,-1,3,-1
KR_6649288163,440,1,31,-12,-3,2,0,2,1,3,4,-1,2,1,-4,7,3,-1,2,1,0,-14,-1,2,-4,2,-1,0,0,-1,1,0,-1,4,-1
KR_6765259444,420,2,52,-4,2,5,1,6,2,0,2,0,3,3,-2,3,1,-3,4,1,0,6,-12,-1,-6,7,0,0,0,1,1,0,-1,2,-1
KR_6555230110,420,-2,-29,12,-6,5,1,6,-5,6,1,-1,3,2,-2,2,0,-3,3,0,0,-19,340,-1,-5,6,-2,0,0,1,1,1,1,1,-1
KR_6753941888,440,1,-32,4,-3,3,1,4,0,2,2,-4,5,1,-3,3,0,1,0,1,0,-13,-42,-2,-6,8,19,0,0,0,1,0,-1,0,-1
KR_6749945027,420,-2,-30,-10,-8,-6,7,1,-1,3,2,-2,3,1,0,2,2,1,0,1,-1,-1,-4,1,-6,5,-2,0,-2,-1,-1,-1,-1,1,-1
KR_6765718530,440,1,26,19,-3,0,0,0,3,2,5,-4,5,1,-1,1,0,-1,3,2,0,1,-9,5,-6,1,-2,0,0,0,-1,0,-1,0,-1
KR_6741828785,420,1,18,-5,-5,-1,3,2,-10,10,0,-3,6,3,6,2,8,3,0,3,0,-14,-37,4,-5,1,-1,0,0,0,-1,-1,1,0,-1
KR_6708535944,420,-2,-44,-8,2,8,0,8,0,0,0,-3,3,0,-2,2,0,-1,1,0,0,-3,-12,-5,-5,10,-1,0,-1,-1,1,-1,-1,1,-1
KR_6731713211,420,-5,-50,-21,-10,0,2,2,-5,7,2,-1,3,2,-4,4,0,0,0,0,0,-14,1,0,-6,6,1,0,-1,-1,1,-1,-1,3,-1
KR_6759335354,420,-4,-26,0,-16,-3,3,0,-7,8,1,-1,1,0,-3,3,0,-2,2,0,0,-15,-4,-2,-3,5,0,0,-1,-1,-1,-1,-1,4,-1
KR_6686482194,420,-2,-29,26,-2,-1,2,1,2,2,4,-3,5,2,0,3,3,0,1,1,1,11,29,-5,-2,7,-2,0,0,1,-1,-1,1,3,-1
KR_6750356447,420,1,9,27,-10,-6,6,0,-2,2,0,0,0,0,-1,8,7,-1,1,0,-2,-15,35,-1,-7,8,-15,0,-1,-1,-1,-1,-1,2,-1
KR_6744914330,420,-4,-43,-33,-5,-2,2,0,1,2,3,-3,4,1,1,1,2,-2,2,0,0,0,275,-1,-2,3,-1,0,-1,-1,-1,-1,1,2,-1
KR_6758393797,420,-2,-35,-4,-2,0,2,2,-1,2,1,2,0,2,-1,2,1,-2,4,2,0,-4,-2,-1,-6,7,2,0,0,0,-1,0,1,0,-1
KR_6721893136,420,-3,-36,8,-10,-3,4,1,-3,4,1,-1,2,1,-2,3,1,-1,1,0,0,-13,4,0,-4,4,2,0,-1,1,-1,-1,-1,6,-1
KR_6629981070,420,0,-65,-9,0,3,0,3,-1,4,3,0,1,1,-2,5,3,0,1,1,0,-5,0,4,-6,2,1,0,0,0,1,0,-1,0,-1
KR_6708641224,420,-3,-49,-7,-1,-2,2,0,1,2,3,0,1,1,0,1,1,0,0,0,1,5,-29,0,-7,7,-1,0,0,-1,-1,0,1,2,-1
KR_6761311671,420,0,-14,9,-7,-4,5,1,1,0,1,3,1,4,-5,5,0,-2,2,0,-1,-12,-3,-1,-4,5,1,0,0,1,0,0,-1,3,-1
KR_6756254893,420,-7,-28,-64,-20,-3,4,1,-10,12,2,-2,4,2,-4,6,2,-1,1,0,0,-16,-33,-7,0,7,-1,0,-2,-1,-1,-1,-1,6,-1
KR_6751278786,440,-4,-54,-17,-3,0,1,1,1,0,1,-5,8,3,-6,7,1,7,0,7,0,-5,-3,-1,-5,6,0,0,-1,-1,-1,-1,-1,1,-1
KR_6630725881,420,-2,-60,-1,-7,-1,5,4,-1,4,3,1,2,3,-8,12,4,2,0,2,0,-2,-8,-1,-5,6,-3,0,-2,-1,-1,-1,1,4,-1
KR_6690888141,440,-5,-46,-48,-7,0,1,1,-7,7,0,-6,6,0,4,0,4,2,0,2,0,2,6,3,-10,7,1,0,-1,-1,-1,-1,-1,1,-1
KR_6647785535,420,-1,-71,19,-4,4,0,4,1,4,5,1,4,5,-10,12,2,0,1,1,1,4,7,-1,-7,8,3,0,-2,-1,-1,-1,1,2,-1
KR_6740721105,420,1,-43,0,-2,-1,4,3,-1,4,3,0,5,5,0,2,2,0,0,0,0,-2,18,-5,-3,8,1,0,-1,1,0,-1,1,6,-1
KR_6761435263,420,2,-18,11,0,1,0,1,2,3,5,-6,7,1,0,2,2,3,0,3,0,-3,4,0,-6,6,0,0,-1,1,1,-1,-1,3,-1
KR_6750745385,420,-2,26,16,-7,-1,2,1,-1,3,2,0,2,2,-5,6,1,0,1,1,0,-8,-4,-3,-1,4,1,0,0,1,1,0,-1,4,-1
KR_6739863186,420,-5,-51,3,-15,-9,10,1,3,0,3,-5,6,1,-4,5,1,0,0,0,-1,-7,-1,-3,-5,8,-3,0,-2,-1,-1,-1,-1,6,-1
KR_6760197888,420,-3,-69,2,-9,-2,2,0,-5,7,2,-1,1,0,-1,4,3,0,3,3,0,-7,2,1,-5,4,-3,0,-1,1,-1,-1,-1,6,-1
KR_6746668748,440,-2,-33,-8,0,-2,4,2,0,3,3,4,2,6,-1,4,3,-1,2,1,0,3,-100,1,-5,4,3,0,-1,0,0,-1,-1,0,-1
KR_6763489832,420,-5,-48,-24,-9,0,2,2,-2,4,2,-1,2,1,-5,6,1,-1,1,0,0,-6,13,-1,-5,6,0,0,0,-1,1,-1,1,5,-1
KR_6705453681,420,-1,-46,13,-6,-4,5,1,0,2,2,-1,1,0,-1,6,5,0,4,4,-1,-2,12,1,-7,6,0,0,-2,-1,-1,-1,-1,3,-1
KR_6601095292,420,-1,60,-11,-4,-2,3,1,-2,2,0,0,2,2,0,1,1,0,2,2,0,-1,-48,-6,-2,8,2,0,0,-1,-1,0,-1,1,-1
KR_6704602500,440,-5,-54,-44,-5,1,3,4,-1,3,2,-3,5,2,-2,4,2,0,1,1,0,-8,-5,-2,-2,4,1,0,-2,-1,1,-1,-1,6,-1
KR_6702282029,420,-2,-83,16,-3,-3,3,0,0,3,3,0,2,2,0,3,3,0,0,0,0,-2,13,1,-5,4,-30,0,0,0,0,0,1,0,-1
KR_6618807594,420,-7,-92,-24,-16,-5,5,0,-1,4,3,-5,5,0,-5,6,1,0,0,0,-2,-14,-7,-1,-3,4,3,0,-2,-1,-1,-1,-1,4,-1
KR_6704089125,420,-3,-47,-23,-8,-5,7,2,-3,6,3,4,2,6,-1,3,2,-3,3,0,0,-4,12,-2,0,2,-4,0,-1,-1,-1,-1,1,6,-1
KR_6754563781,420,1,-14,4,2,0,2,2,4,0,4,0,3,3,-3,3,0,1,0,1,-1,1,6,-2,-1,3,5,0,0,1,-1,0,-1,1,-1
KR_6661380204,420,0,-47,5,2,0,1,1,4,2,6,0,6,6,-3,4,1,1,1,2,0,7,37,0,-2,2,-3,0,0,1,1,1,1,2,-1
KR_6733639671,420,2,7,-13,7,1,0,1,7,1,8,-2,4,2,6,2,8,-5,5,0,1,11,-69,3,-6,3,3,0,1,1,1,1,1,4,-1
KR_6744403710,420,-2,-36,-12,-8,1,0,1,-8,9,1,-6,6,0,6,1,7,-1,2,1,0,-6,0,6,-8,2,-5,0,0,1,1,-1,1,6,-1
KR_6748387674,420,-1,-17,20,-3,1,2,3,1,1,2,-2,2,0,-3,4,1,0,3,3,0,3,24,-4,-4,8,-1,0,-1,1,-1,-1,1,4,-1
KR_6734486321,440,-2,-32,10,-4,-3,7,4,2,2,4,-2,2,0,-2,5,3,1,0,1,0,6,-5,0,-2,2,4,0,-1,-1,1,-1,1,5,-1
KR_6656755863,420,-1,3,-20,0,3,2,5,0,5,5,-1,3,2,-2,2,0,0,2,2,0,-3,1,-1,-6,7,3,0,2,-1,1,1,-1,2,-1
KR_6652596668,420,1,-17,21,6,-1,3,2,5,1,6,3,3,6,0,2,2,-1,1,0,-1,2,5,6,-8,2,1,0,0,-1,1,0,-1,1,-1
KR_6763429745,440,-3,-82,1,-13,1,0,1,-2,3,1,-3,3,0,-3,3,0,-6,6,0,0,-16,-99,-3,-4,7,0,0,-1,-1,1,-1,1,6,-1
KR_6674026169,420,0,0,-18,3,1,1,2,6,1,7,0,3,3,-6,10,4,2,0,2,0,-6,54,0,-4,4,-1,0,0,-1,1,1,1,2,-1
KR_6717413455,440,-3,-89,0,-5,3,0,3,-2,3,1,-2,2,0,0,0,0,-4,4,0,0,-7,-16,-8,-2,10,1,0,-1,-1,-1,-1,1,1,-1
KR_6740613789,440,-4,13,-20,-5,-4,4,0,-3,3,0,0,5,5,2,0,2,0,6,6,0,-11,0,3,-8,5,2,0,-1,0,1,-1,-1,0,-1
KR_6562114007,420,-6,-114,23,-15,-2,3,1,0,0,0,-6,6,0,-6,6,0,-1,2,1,-2,-21,7,-2,-2,4,1,0,-3,-1,1,-1,-1,5,-1
KR_6723880980,420,0,-5,20,-7,-3,3,0,1,2,3,-2,2,0,-4,5,1,1,2,3,0,-10,0,-1,-2,3,-3,0,1,-1,1,1,1,2,-1
KR_6632506391,420,-3,-27,-24,-8,-7,8,1,-2,4,2,2,1,3,1,1,2,-2,3,1,-1,-8,3,3,-8,5,-8,0,0,-1,-1,-1,-1,6,-1
KR_6765475390,420,-2,-1,9,-3,-2,2,0,0,6,6,0,3,3,-2,3,1,1,0,1,0,-1,4,0,-4,4,-1,0,-1,0,-1,-1,-1,0,-1
KR_6724114919,420,-3,-2,-13,1,-1,2,1,3,0,3,-2,4,2,3,3,6,-2,3,1,0,4,24,0,-5,5,-6,0,-1,1,-1,-1,1,4,-1
KR_6651577187,420,-6,-67,-28,-14,-2,3,1,-6,8,2,-5,6,1,0,1,1,-1,2,1,0,-14,122,6,-7,1,-2,0,-3,-1,-1,-1,-1,5,-1
KR_6622380556,420,-2,-14,-24,-3,-1,3,2,-3,5,2,1,1,2,3,0,3,-3,3,0,0,1,-3,6,-14,8,-2,0,-2,-1,-1,-1,1,3,-1
KR_6762585618,420,1,-8,4,3,-4,4,0,2,0,2,2,1,3,-1,2,1,4,0,4,0,2,-5,0,-3,3,6,0,0,1,-1,0,-1,4,-1
KR_6729915959,440,3,21,27,6,2,1,3,7,1,8,0,1,1,1,0,1,-4,4,0,0,8,2,5,-7,2,-3,0,0,-1,1,0,-1,3,-1
KR_6759494648,420,1,-1,-25,15,-2,6,4,7,2,9,2,0,2,3,1,4,5,0,5,2,21,3,5,-7,2,-2,0,1,1,0,-1,1,3,-1
KR_6765644756,420,-5,-79,-4,-17,-5,5,0,1,1,2,-4,10,6,-10,13,3,1,0,1,0,-27,1,1,-5,4,2,0,-3,1,-1,-1,-1,6,-1
KR_6735442509,440,-1,-1,4,3,2,2,4,2,3,5,0,3,3,-4,5,1,3,0,3,0,1,17,1,-7,6,1,0,0,1,0,0,1,3,-1
KR_6738711552,420,-7,-104,-34,-10,3,0,3,-2,2,0,-7,8,1,-2,5,3,-2,2,0,-1,-20,94,-4,-2,6,3,0,-2,-1,1,-1,-1,3,-1
KR_6617804212,420,-1,-19,35,-3,-1,3,2,-1,3,2,-3,4,1,2,1,3,0,0,0,0,0,-4,2,-5,3,-1,0,0,1,-1,-1,-1,6,-1
KR_6684690538,420,-3,-79,16,-2,-1,1,0,-4,5,1,5,1,6,0,5,5,-2,2,0,0,3,-364,-6,-2,8,0,0,-2,1,-1,-1,-1,6,-1
KR_6661058032,420,-5,-74,-13,-18,-2,2,0,-3,3,0,-1,3,2,-9,9,0,-3,3,0,0,-21,-272,2,-7,5,6,0,-2,-1,-1,-1,-1,2,-1
KR_6744482574,420,-1,-48,2,-3,3,0,3,0,3,3,-2,4,2,-2,6,4,-2,3,1,0,-4,-7,-4,-3,7,-2,0,0,1,-1,0,-1,2,-1
KR_6761549953,420,-6,-58,-4,-11,-1,1,0,-4,4,0,1,0,1,-3,4,1,-4,5,1,0,-16,-6,0,-6,6,-1,0,-1,-1,1,-1,-1,3,-1
KR_6755031113,420,-3,-91,-21,-1,-2,4,2,1,5,6,0,3,3,1,4,5,-1,3,2,-1,-2,-7,-2,-2,4,3,0,-2,-1,-1,-1,-1,1,-1
KR_6679977911,420,-1,-5,4,-5,-1,1,0,-1,3,2,1,2,3,-3,4,1,-1,3,2,-1,-10,14,-2,-3,5,-3,0,-1,0,-1,-1,-1,0,-1
KR_6723758985,420,-3,11,-1,-4,3,1,4,4,2,6,-3,4,1,-7,7,0,-1,1,0,0,-4,3,-4,-1,5,4,0,-2,-1,-1,-1,-1,4,-1
KR_6702124989,440,-3,-88,-12,-11,-3,4,1,-6,7,1,-3,4,1,2,2,4,-1,1,0,0,-4,-47,-2,-2,4,28,0,-1,1,-1,-1,-1,1,-1
KR_6720488155,420,-3,-70,-14,-5,0,3,3,-2,4,2,-6,8,2,2,3,5,1,1,2,0,-1,-2,-4,-6,10,-2,0,0,1,-1,1,1,1,-1
KR_6696078071,420,-4,-12,-23,-6,1,0,1,2,5,7,-1,2,1,-7,10,3,-1,2,1,0,3,-9,-2,-3,5,-2,0,-2,-1,1,-1,1,2,-1
KR_6765686530,420,-4,-57,-29,-9,-2,2,0,-2,3,1,-2,4,2,-2,3,1,-1,1,0,0,-17,1,3,-8,5,-2,0,-2,-1,-1,-1,-1,4,-1
KR_6764818061,420,-2,-79,-23,-1,-2,5,3,-3,3,0,0,2,2,5,1,6,-1,2,1,0,2,-15,-3,-1,4,-4,0,-2,1,-1,-1,1,3,-1
KR_6635753874,420,-1,109,-24,-2,-1,2,1,2,4,6,-2,3,1,3,2,5,-4,5,1,1,9,-29,5,-9,4,0,0,1,-1,1,1,1,2,-1
KR_6725423317,420,-3,-57,-44,-2,-2,3,1,-5,6,1,3,3,6,2,0,2,0,1,1,0,1,0,-5,-3,8,-4,0,-1,-1,1,-1,-1,1,-1
KR_6761450041,420,1,-12,12,3,3,0,3,1,4,5,2,1,3,-2,3,1,-1,2,1,0,-3,-8,-4,-2,6,3,0,0,-1,0,0,1,1,-1
KR_6639795073,420,0,17,-1,-1,0,1,1,-3,3,0,1,1,2,2,3,5,-1,3,2,0,-3,38,1,-7,6,-4,0,-1,-1,1,-1,-1,4,-1
KR_6765868002,420,-1,9,-23,-2,3,1,4,-3,3,0,-2,4,2,0,4,4,0,1,1,-1,-9,-13,-5,-3,8,5,0,1,1,0,1,-1,4,-1
KR_6697812812,420,-2,-49,19,-2,1,0,1,4,5,9,-2,2,0,-5,5,0,0,0,0,0,-6,-13,-3,-3,6,-3,0,-2,0,1,-1,-1,0,-1
KR_6764731730,420,1,-18,-13,3,-2,2,0,5,1,6,-1,2,1,0,1,1,1,1,2,0,8,6,-4,-3,7,3,0,0,-1,-1,0,-1,4,-1
KR_6752039099,420,-5,-66,11,-18,-9,9,0,-5,6,1,0,1,1,-6,7,1,2,1,3,-1,-23,-1,-1,-5,6,-4,0,-4,-1,-1,-1,1,5,-1
KR_6750696782,420,0,-60,14,-5,0,0,0,-2,6,4,3,1,4,-2,5,3,-4,5,1,1,-5,-4,-1,-5,6,1,0,0,1,1,0,1,5,-1
KR_6717153123,420,1,-30,-7,4,-1,2,1,3,2,5,0,4,4,1,0,1,1,0,1,0,9,-21,5,-7,2,-2,0,0,0,1,0,-1,0,-1
KR_6725030931,420,-5,-49,-34,-7,-1,1,0,-1,1,0,3,0,3,-6,7,1,-2,2,0,0,-5,122,3,-7,4,0,0,-2,-1,1,-1,-1,4,-1
KR_6603952023,440,-4,1,1,-10,-1,1,0,-5,6,1,-1,1,0,-2,5,3,-1,3,2,0,-7,-4,3,-6,3,-2,0,-1,1,-1,-1,-1,6,-1
KR_6764555380,420,-3,-42,-33,-3,-2,2,0,1,1,2,0,2,2,-3,3,0,1,0,1,0,-5,55,4,-9,5,-1,0,-1,1,-1,-1,-1,4,-1
KR_6753300489,420,-2,8,0,-1,0,1,1,1,3,4,-2,2,0,-1,4,3,1,0,1,0,2,-18,0,-5,5,-7,0,0,1,-1,0,-1,5,-1
KR_6765785177,440,-1,-41,-17,-2,1,1,2,0,0,0,-2,2,0,0,0,0,-1,1,0,0,-5,5,-3,-6,9,0,0,0,0,-1,0,1,0,-1
KR_6765154450,420,0,-21,-20,-4,-1,4,3,-3,4,1,-3,3,0,4,1,5,-1,2,1,0,-7,-3,-4,-2,6,3,0,-1,0,-1,1,-1,0,-1
KR_6752092459,420,0,-83,4,-3,3,1,4,-2,3,1,-7,7,0,2,4,6,1,0,1,0,-3,-47,1,-5,4,-7,0,-1,0,-1,-1,1,0,-1
KR_6761282040,420,0,-109,22,3,1,2,3,2,0,2,1,0,1,0,1,1,-1,1,0,0,2,-23,-3,-2,5,4,0,0,-1,1,0,-1,2,-1
KR_6764238199,420,0,17,27,-2,-2,2,0,2,2,4,-1,1,0,1,4,5,-2,2,0,0,-4,6,-1,-4,5,-2,0,1,1,1,1,1,5,-1
KR_6737960387,420,1,6,9,-3,1,0,1,-3,5,2,-1,1,0,1,2,3,-1,1,0,0,-1,-11,4,-8,4,-1,0,-1,-1,-1,-1,-1,1,-1
KR_6730008274,420,1,48,4,7,-2,3,1,5,0,5,-1,4,3,3,1,4,2,0,2,4,12,12,5,-5,0,-3,0,0,-1,0,0,1,6,-1
KR_6709035569,420,-3,3,4,-9,0,3,3,-6,6,0,-3,4,1,-1,3,2,1,1,2,1,-4,10,3,-10,7,-7,0,0,-1,1,0,1,2,-1
KR_6735852476,440,0,26,44,-10,-1,3,2,0,0,0,-1,1,0,0,1,1,-8,8,0,0,-20,-2,-3,-3,6,-4,0,-1,-1,1,-1,-1,1,-1
KR_6036498277,420,-5,-30,-13,-9,1,1,2,0,7,7,-8,8,0,-1,2,1,-1,2,1,0,-9,-2,0,-4,4,-4,0,-1,1,-1,-1,1,2,-1
KR_6765240527,440,-5,-104,-44,-9,-4,4,0,-1,4,3,-5,5,0,0,2,2,1,0,1,0,-1,90,0,-1,1,9,0,-2,-1,1,-1,-1,1,-1
KR_6766467080,440,-6,-5,-32,-17,-2,3,1,-4,5,1,-3,9,6,0,0,0,-8,8,0,0,-23,27,3,-5,2,-1,0,0,-1,-1,0,1,1,-1
KR_6761690440,420,-2,-3,2,5,-2,2,0,1,1,2,-2,3,1,9,0,9,-1,2,1,0,8,-92,-1,-3,4,2,0,-1,1,-1,-1,1,3,-1
KR_6764812867,420,-2,-86,4,-6,-1,3,2,-4,5,1,-1,4,3,-1,2,1,1,1,2,0,-5,-11,-7,-2,9,2,0,0,-1,-1,-1,-1,3,-1
KR_6748680943,420,-1,6,-6,-11,-4,4,0,-3,6,3,1,1,2,-5,6,1,0,0,0,-1,-19,17,1,-10,9,-9,0,1,-1,0,-1,-1,4,-1
KR_6649779127,420,-2,-60,22,-5,-1,2,1,-3,3,0,3,0,3,-1,3,2,-3,4,1,0,-7,13,-5,-3,8,-2,0,0,-1,1,-1,-1,4,-1
KR_6765525867,420,-1,8,-1,-1,-1,1,0,1,2,3,-1,1,0,0,0,0,0,0,0,0,-1,2,1,-6,5,-1,0,0,-1,-1,0,-1,4,-1
KR_6752737035,420,3,31,23,4,-1,2,1,7,1,8,0,3,3,-2,5,3,0,2,2,0,0,25,-1,-6,7,-1,0,1,-1,1,1,1,2,-1
KR_6739287243,420,-8,-99,-36,-15,-5,5,0,-8,8,0,-2,5,3,-1,3,2,1,1,2,-1,-14,-59,-5,-2,7,0,-1,-5,-1,-1,-1,-1,2,-1
KR_6763904229,420,-1,-7,3,3,1,0,1,4,1,5,1,3,4,0,2,2,-3,3,0,0,5,1,-3,-1,4,-3,0,-1,0,-1,-1,-1,0,-1
KR_6721931042,420,-1,2,11,0,3,0,3,0,0,0,-7,8,1,4,2,6,0,2,2,0,-12,34,2,-7,5,-14,0,-1,1,-1,-1,1,3,-1
KR_6693942632,420,3,12,35,0,5,1,6,-4,6,2,0,1,1,-1,1,0,0,0,0,0,-3,-54,0,-5,5,11,0,1,1,1,1,-1,3,-1
KR_6732097512,420,-2,-59,-19,-11,0,0,0,-1,5,4,-3,5,2,-5,5,0,-2,2,0,0,-14,-8,4,-6,2,-2,0,-1,1,-1,-1,-1,6,-1
KR_6762366962,420,-5,-46,-18,-8,1,0,1,-2,8,6,0,0,0,-5,6,1,-2,2,0,0,-13,-4,0,-4,4,-2,0,-1,-1,0,-1,-1,5,-1
KR_6752615659,420,-4,-47,-19,-13,-1,4,3,-2,2,0,-5,5,0,-5,6,1,0,1,1,0,-9,0,-2,-4,6,5,0,-2,-1,0,-1,1,6,-1
KR_6701160381,420,-2,17,-24,-3,-2,3,1,0,5,5,-4,4,0,2,1,3,1,1,2,0,-6,-4,-4,-3,7,6,0,0,1,-1,-1,1,4,-1
KR_6751149812,420,-2,29,13,-2,-2,4,2,-2,3,1,3,2,5,-1,1,0,0,1,1,1,3,4,4,-10,6,-1,0,-1,1,-1,-1,1,3,-1
KR_6763903455,420,-2,-13,-15,-2,1,1,2,-3,5,2,-1,1,0,3,2,5,-2,3,1,1,2,160,2,-6,4,2,0,0,-1,1,-1,1,3,-1
KR_6750522069,420,-1,-13,0,2,1,3,4,5,3,8,0,0,0,-4,7,3,0,1,1,0,-3,-5,-2,-5,7,7,0,0,1,-1,-1,1,4,-1
KR_6738887165,420,0,-52,18,-1,-3,4,1,1,1,2,-3,4,1,3,2,5,1,1,2,0,3,126,4,-6,2,-5,0,-1,1,-1,-1,-1,4,-1
KR_6763367417,420,1,-8,4,-3,-3,6,3,-1,7,6,2,0,2,-3,4,1,2,1,3,0,2,2,-1,-7,8,-4,0,0,-1,-1,0,-1,2,-1
KR_6764669642,420,-3,-21,-19,-3,-1,3,2,2,1,3,-1,3,2,-5,7,2,2,0,2,3,9,-339,0,-5,5,2,0,-1,-1,-1,-1,1,2,-1
KR_6766180900,420,0,37,-4,2,-1,1,0,0,3,3,-2,3,1,3,2,5,2,0,2,0,2,3,9,-12,3,4,0,-3,-1,-1,-1,-1,2,-1
KR_6764686233,420,-3,-69,-8,-4,-4,4,0,-1,1,0,-2,2,0,1,1,2,2,0,2,1,-1,-4,-6,-1,7,1,0,-1,-1,1,-1,1,4,-1
KR_6740281057,440,-2,-22,-8,-1,-2,3,1,2,2,4,3,1,4,-3,4,1,-1,1,0,0,1,2,0,-6,6,-7,0,-1,1,1,-1,1,3,-1
KR_6743929635,440,-2,5,1,-3,-5,5,0,1,1,2,1,2,3,0,2,2,0,3,3,0,-1,12,-1,-4,5,5,0,0,1,-1,0,1,6,-1
KR_6763037140,420,-3,-30,-36,-10,-4,5,1,-1,2,1,-1,4,3,-2,6,4,-2,2,0,0,-12,-24,0,-3,3,-2,0,-2,1,-1,-1,-1,2,-1
KR_6656353799,420,-4,-9,-44,0,0,1,1,4,0,4,-2,3,1,-3,6,3,1,0,1,1,9,11,2,-9,7,-5,0,-2,1,-1,-1,1,4,-1
KR_6738476005,420,0,-60,8,5,3,0,3,1,1,2,0,0,0,2,0,2,-1,1,0,0,4,8,3,-7,4,-5,0,0,1,-1,0,1,2,-1
KR_6710182437,420,1,-7,-15,2,0,2,2,1,5,6,-2,5,3,-1,1,0,4,0,4,0,11,2,-2,-4,6,-1,0,3,-1,1,1,-1,1,-1
KR_6760622808,420,-5,-56,-61,-9,4,2,6,1,3,4,-3,4,1,-10,12,2,-1,2,1,0,-14,-13,0,-6,6,-5,0,-1,-1,-1,1,-1,3,-1
KR_6626449944,440,-1,-42,-36,-3,-2,2,0,-1,2,1,1,1,2,3,0,3,-4,4,0,0,-3,31,-4,-3,7,-6,0,0,-1,1,-1,1,4,-1
KR_6761463484,420,-2,9,-20,-1,-1,3,2,-1,6,5,3,3,6,-1,3,2,-1,1,0,0,-4,151,2,-4,2,1,0,0,-1,1,0,1,2,-1
KR_6760773123,420,-1,-68,3,4,0,1,1,6,1,7,-3,3,0,-1,2,1,2,1,3,0,5,26,-1,-4,5,-5,0,0,-1,-1,0,1,3,-1
KR_6714714665,420,2,80,-26,11,0,2,2,-2,2,0,3,0,3,8,1,9,2,1,3,0,9,-1,-1,-5,6,3,0,3,1,-1,1,1,2,-1
KR_6765387492,420,-4,-90,-4,-5,-4,4,0,0,0,0,-2,3,1,0,2,2,1,0,1,0,1,2,-1,-2,3,-1,0,-1,-1,-1,-1,-1,3,-1
KR_6718049204,420,-3,1,-57,-2,1,2,3,-7,7,0,-2,3,1,5,1,6,1,0,1,0,-1,-8,0,-6,6,-2,0,-2,-1,-1,-1,1,5,-1
KR_6728629576,420,0,42,4,1,0,1,1,3,2,5,0,2,2,-1,3,2,-1,1,0,0,-1,-114,2,-5,3,2,0,1,-1,-1,1,-1,6,-1
KR_6752117682,420,-5,-36,-6,-17,-1,2,1,-7,8,1,-6,8,2,-4,5,1,1,1,2,-2,-19,11,0,-5,5,-3,0,0,-1,-1,0,1,4,-1
KR_6750049706,440,0,24,-23,3,3,0,3,-5,6,1,4,1,5,1,2,3,0,1,1,0,-3,-6,1,-5,4,8,0,1,-1,-1,1,1,6,-1
KR_6762679279,420,-5,-70,-37,-5,-2,2,0,0,4,4,-1,4,3,-1,2,1,-1,2,1,0,-2,-24,0,-6,6,0,0,-1,-1,1,-1,1,1,-1
KR_6729917671,420,-6,-115,-19,-18,0,6,6,-2,3,1,-7,8,1,-4,5,1,-5,5,0,0,-12,9,6,-9,3,-6,0,-2,1,-1,-1,-1,6,-1
KR_6763630873,420,-2,-45,-23,-5,0,3,3,-5,6,1,0,4,4,1,3,4,-1,1,0,0,0,3,-2,-7,9,1,0,0,-1,1,-1,-1,5,-1
KR_6728753583,420,-5,-54,-16,-6,-3,4,1,1,2,3,2,1,3,-3,8,5,-3,4,1,0,-7,22,0,-5,5,0,0,-1,-1,-1,-1,1,4,-1
KR_6418786945,420,-2,-44,-11,-4,4,0,4,-3,4,1,-6,6,0,2,0,2,-1,1,0,-1,-3,-22,0,-4,4,2,0,-1,0,-1,-1,-1,0,-1
KR_6737944677,420,1,32,8,1,-1,1,0,2,3,5,-3,3,0,-1,3,2,4,0,4,0,-2,-3,2,-5,3,3,0,0,0,1,0,1,0,-1
KR_6759572819,420,-4,-37,-16,-9,-3,4,1,-2,3,1,0,1,1,-2,2,0,-2,2,0,0,-11,-46,0,-6,6,20,0,-1,-1,-1,-1,1,1,-1
KR_6759231775,420,-3,2,0,-5,-2,3,1,0,5,5,-5,8,3,2,1,3,0,4,4,0,-8,5,5,-10,5,-3,0,-1,1,-1,-1,1,3,-1
KR_6760614347,420,-1,17,24,-3,2,1,3,2,1,3,-2,2,0,-4,8,4,-1,1,0,0,-2,-116,0,-3,3,2,0,0,-1,0,1,-1,6,-1
KR_6731221133,420,-1,-38,25,-3,-3,3,0,0,3,3,2,1,3,-1,2,1,-1,2,1,-1,-5,-5,-4,-5,9,-1,0,1,-1,0,1,-1,1,-1
KR_6685589709,420,-5,-88,-20,-11,-1,3,2,-4,7,3,2,2,4,-6,7,1,-2,3,1,0,-14,-1,5,-9,4,-5,0,0,-1,-1,-1,-1,4,-1
KR_6652508565,420,-3,-10,-12,-5,4,1,5,1,3,4,-3,3,0,-4,4,0,-3,3,0,0,-11,-2,1,-4,3,-2,0,1,1,1,1,-1,5,-1
KR_6741312541,440,0,-18,32,0,3,0,3,-2,6,4,-2,3,1,1,4,5,0,1,1,0,-3,-36,-2,-5,7,20,0,0,-1,1,0,-1,1,-1
KR_6763932208,420,-3,-25,7,-6,-1,4,3,-3,4,1,0,4,4,2,2,4,-4,4,0,0,-7,0,-1,-4,5,-4,0,-1,-1,1,-1,-1,1,-1
KR_6610226327,420,1,-21,36,0,0,0,0,4,3,7,5,1,6,-6,8,2,-3,3,0,-1,0,-162,3,-5,2,0,0,1,1,1,1,-1,4,-1
KR_6687253381,420,-3,46,-15,-6,3,2,5,-1,4,3,-7,9,2,0,3,3,-1,3,2,0,-7,319,3,-8,5,-3,0,-1,-1,1,1,1,5,-1
KR_6758786048,420,-2,-70,9,4,5,0,5,2,2,4,-2,6,4,2,3,5,-3,4,1,0,-2,-163,2,-5,3,1,0,0,1,1,-1,-1,5,-1
KR_6719292061,420,0,-48,22,-4,-3,4,1,-2,2,0,2,0,2,1,2,3,-2,2,0,-1,-8,4,-4,-3,7,-6,0,0,-1,1,0,-1,6,-1
KR_6737581541,420,0,28,-18,-4,1,3,4,-3,3,0,1,1,2,-3,3,0,0,0,0,0,-12,-1,-2,-3,5,-2,0,0,-1,0,0,1,1,-1
KR_6719368375,420,3,39,-7,10,2,1,3,5,1,6,-4,7,3,4,0,4,3,2,5,1,18,-7,-1,-5,6,7,0,2,1,1,1,1,5,-1
KR_6761319428,420,-1,-45,-27,-1,-1,4,3,3,3,6,-1,2,1,-2,3,1,0,0,0,0,2,-7,-1,-4,5,-3,0,0,-1,-1,-1,-1,5,-1
KR_6679579382,420,-1,-44,5,-3,1,0,1,1,2,3,-1,2,1,-3,3,0,-1,2,1,0,-4,-7,-4,-2,6,-2,0,-1,1,-1,-1,-1,5,-1
KR_6713529640,420,1,48,15,4,3,0,3,4,3,7,2,3,5,-4,10,6,-1,2,1,3,10,38,4,-9,5,-18,0,2,-1,1,1,1,2,-1
KR_6652509072,420,-6,-23,-28,-13,-2,3,1,-1,1,0,0,0,0,-5,6,1,-5,5,0,1,-16,-8,-3,-6,9,1,0,0,-1,-1,-1,1,2,-1
KR_6760473852,420,-2,-16,12,-3,-2,2,0,-1,3,2,1,3,4,0,2,2,-1,1,0,0,2,-9,0,-4,4,3,0,-1,0,0,-1,1,0,-1
KR_6738892525,420,2,-13,12,5,4,2,6,0,4,4,-3,5,2,-1,2,1,5,1,6,0,4,-7,-3,-3,6,-2,0,0,-1,1,0,1,6,-1
KR_6706685679,420,0,20,-2,0,-1,3,2,-1,5,4,0,3,3,2,1,3,0,2,2,0,4,33,5,-6,1,-1,0,-1,1,-1,-1,1,3,-1
KR_6760190203,420,-2,41,11,-5,-3,4,1,0,2,2,-4,6,2,-2,4,2,4,0,4,0,3,0,0,-4,4,2,0,-1,-1,-1,-1,-1,5,-1
KR_6763750881,420,-4,-5,-21,-17,-3,4,1,-8,10,2,-2,2,0,-1,3,2,-3,4,1,0,-17,2,-1,-5,6,-5,0,2,1,1,1,-1,3,-1
KR_6738636551,420,-3,-48,-12,-5,0,1,1,-5,5,0,-2,3,1,0,1,1,2,0,2,0,-12,10,-1,-6,7,0,0,-1,-1,-1,-1,-1,6,-1
KR_6682203040,420,-4,-101,4,-9,-3,3,0,-8,10,2,0,2,2,2,1,3,0,3,3,0,-8,-3,-1,-4,5,-1,0,-3,-1,-1,-1,-1,4,-1
KR_6755667358,420,0,23,4,1,2,1,3,-1,3,2,0,1,1,0,1,1,0,0,0,0,0,-1,-2,-3,5,0,0,2,-1,1,1,-1,4,-1
KR_6752814882,420,-2,-35,20,-1,-1,2,1,0,4,4,-2,2,0,-1,5,4,3,0,3,0,3,-14,-2,-5,7,-5,0,-1,-1,1,-1,-1,1,-1
KR_6631494653,420,0,-31,15,3,-1,2,1,3,1,4,-2,2,0,2,3,5,1,0,1,0,10,5,3,-8,5,-6,0,1,-1,1,1,-1,2,-1
KR_6750291894,420,0,-38,-8,-7,0,1,1,1,2,3,-9,11,2,0,1,1,1,1,2,-2,-5,10,2,-5,3,-2,0,-1,-1,-1,-1,-1,5,-1
KR_6704598261,420,0,-16,-8,-5,0,2,2,-2,4,2,-3,7,4,1,2,3,-1,2,1,0,-2,18,-1,-5,6,-1,0,0,-1,-1,-1,1,4,-1
KR_6698070187,420,-1,-27,27,-7,-3,4,1,4,0,4,-3,6,3,-2,4,2,-3,3,0,0,-13,-16,-5,-3,8,-1,0,-3,-1,-1,-1,-1,2,-1
KR_6684438865,420,1,47,24,8,-3,4,1,5,2,7,1,2,3,2,1,3,3,0,3,0,7,1,0,-5,5,2,0,0,1,1,1,-1,3,-1
KR_6559062297,420,-3,0,11,-7,-2,4,2,2,1,3,-2,2,0,-1,2,1,-4,5,1,0,-5,-16,2,-5,3,5,0,0,-1,1,0,1,5,-1
KR_6761731579,440,-2,-14,4,-9,-3,4,1,-1,2,1,-3,4,1,-3,6,3,1,1,2,0,-4,-3,-5,-1,6,1,0,-1,-1,-1,-1,-1,4,-1
KR_6663153087,420,-3,-28,-6,-5,0,1,1,0,2,2,-5,8,3,0,2,2,0,0,0,0,-5,-1,-5,-1,6,-7,0,0,-1,0,0,-1,5,-1
KR_6655383130,440,-3,-63,-36,-9,1,3,4,-5,8,3,-1,1,0,1,3,4,-5,5,0,-1,0,0,-2,-3,5,2,0,-1,1,-1,-1,-1,6,-1
KR_6722618668,420,-6,-66,-23,-21,-5,5,0,-9,9,0,-6,7,1,0,2,2,-1,1,0,0,-20,-2,-3,-1,4,-3,0,-2,-1,-1,-1,-1,1,-1
KR_6753495414,420,-2,-21,-4,-6,-2,2,0,3,3,6,-2,4,2,-6,9,3,1,1,2,0,-15,5,3,-7,4,-5,0,0,-1,1,-1,1,2,-1
KR_6764916566,420,-7,-23,2,-18,1,1,2,-8,8,0,0,4,4,-8,9,1,-3,4,1,0,-23,14,-3,-3,6,-3,0,-2,-1,-1,-1,-1,5,-1
KR_6759896053,420,0,26,-29,1,3,0,3,-3,5,2,2,1,3,-3,4,1,2,3,5,1,-3,-19,0,-7,7,5,0,0,-1,1,0,1,5,-1
KR_6763319221,420,-3,-60,-13,-4,3,1,4,-1,1,0,-4,4,0,-2,2,0,0,1,1,0,-3,-22,1,-4,3,-1,0,0,-1,-1,-1,-1,1,-1
KR_6753604429,420,-4,12,-5,-7,0,0,0,0,2,2,0,1,1,-3,5,2,-4,5,1,0,-5,-8,4,-5,1,0,0,0,-1,-1,-1,-1,3,-1
KR_6743221647,420,-1,-27,-13,-3,-1,1,0,-1,2,1,0,2,2,0,3,3,-1,1,0,0,-1,-1,2,-4,2,-2,0,-1,1,-1,-1,-1,1,-1
KR_6763469681,440,-1,3,-13,0,1,1,2,1,0,1,1,3,4,0,1,1,-3,6,3,0,4,-5,1,-10,9,1,0,-1,-1,1,-1,1,4,-1
KR_6734676073,420,-3,10,-33,-3,-2,2,0,-2,3,1,1,1,2,1,0,1,-1,2,1,0,1,114,-4,-4,8,-1,0,0,1,-1,0,1,4,-1
KR_6752305830,420,-2,-54,16,-8,0,3,3,-1,2,1,2,0,2,-5,8,3,-4,4,0,-2,-10,-12,-7,-1,8,0,0,-2,-1,1,-1,-1,4,-1
KR_6757215418,420,-8,-55,-74,-8,0,1,1,-4,6,2,-1,6,5,-2,4,2,-1,1,0,0,-6,-16,3,-4,1,2,0,-1,-1,-1,-1,1,5,-1
KR_6761177198,420,-1,23,-8,-3,2,4,6,-2,4,2,-4,5,1,2,3,5,-1,1,0,0,-4,-2,2,-6,4,-4,0,0,-1,-1,1,-1,3,-1
KR_6764587336,420,-4,-37,-4,-6,-2,2,0,-1,2,1,-3,4,1,-3,3,0,3,1,4,0,-7,-6,-6,-2,8,6,0,0,-1,1,-1,1,2,-1
KR_6754534009,440,-4,-84,0,-12,-1,1,0,-3,6,3,-5,7,2,-3,4,1,0,0,0,-1,-10,-14,3,-7,4,-3,0,-1,-1,-1,-1,-1,2,-1
KR_6709699872,420,3,35,31,6,-1,2,1,6,1,7,-3,5,2,4,0,4,0,2,2,1,6,-108,0,-2,2,4,0,1,1,1,1,1,5,-1
KR_6632745134,420,-3,-17,-40,-5,0,2,2,-3,4,1,-1,1,0,1,6,7,-2,2,0,0,-5,-16,0,-5,5,-3,0,-2,-1,-1,-1,-1,4,-1
KR_6764676955,440,2,41,15,9,3,1,4,1,1,2,4,2,6,4,5,9,-3,3,0,0,-5,-4,-2,-2,4,5,0,1,1,1,1,1,3,-1
KR_6766521056,420,0,31,-13,-5,0,2,2,-3,5,2,-1,2,1,0,1,1,-1,1,0,-1,-7,33,-1,-6,7,-23,0,0,1,-1,0,-1,2,-1
KR_6611514703,420,-2,14,-14,-9,-1,3,2,-5,7,2,-2,4,2,-2,4,2,1,0,1,0,-11,12,-10,-1,11,2,0,0,1,-1,0,1,2,-1
KR_6763862587,420,-4,2,-40,-10,-2,3,1,-2,4,2,0,1,1,-4,5,1,-2,3,1,0,-10,-7,-3,-1,4,0,0,-3,-1,-1,-1,-1,6,-1
KR_6758265277,420,-3,-57,-2,-3,-2,2,0,-1,4,3,-1,1,0,1,1,2,0,3,3,0,-5,16,3,-6,3,1,0,0,-1,-1,0,1,2,-1
KR_6689984570,420,-4,-56,-5,-8,0,2,2,0,1,1,-8,8,0,-2,5,3,2,0,2,0,-4,-8,3,-6,3,-2,0,-3,-1,-1,-1,1,5,-1
KR_6764778550,420,-3,-11,5,-8,0,1,1,-3,3,0,3,1,4,-8,8,0,0,1,1,0,-14,-5,3,-6,3,-3,0,-1,-1,-1,-1,1,2,-1
KR_6743384186,420,-1,-45,2,-2,3,0,3,0,3,3,-1,4,3,-3,3,0,-1,1,0,-1,-5,9,-2,-8,10,-5,0,0,-1,-1,-1,-1,2,-1
KR_6763456576,440,2,-16,8,8,2,2,4,2,2,4,4,2,6,1,3,4,-1,1,0,0,8,-1,3,-7,4,0,0,0,0,0,0,1,0,-1
KR_6762496587,440,-2,-50,4,-7,2,3,5,0,1,1,-1,2,1,-2,3,1,-6,7,1,0,-10,-41,-3,-3,6,24,0,-2,-1,-1,-1,-1,1,-1
KR_6725974729,420,2,-15,-1,3,4,0,4,0,2,2,-2,3,1,0,0,0,1,0,1,-1,-1,-7,-3,-4,7,1,0,1,-1,1,1,-1,2,-1
KR_6701659311,440,0,-38,-20,1,1,3,4,0,0,0,-3,4,1,3,3,6,0,1,1,0,10,-3,2,-5,3,2,0,0,1,0,1,1,4,-1
KR_6758290241,420,-1,-71,-29,0,-4,6,2,2,3,5,0,2,2,1,1,2,1,0,1,0,9,4,0,-4,4,-1,0,-2,-1,-1,-1,-1,4,-1
KR_6747313924,420,-8,-50,8,-19,-6,6,0,-4,4,0,-3,4,1,-6,7,1,0,0,0,0,-15,-34,-4,-3,7,-3,0,-2,0,-1,-1,-1,0,-1
KR_6707202642,420,-2,-72,0,-4,2,0,2,0,2,2,-3,4,1,-2,3,1,-1,1,0,0,-9,-23,1,-9,8,-4,0,-1,-1,1,-1,-1,2,-1
KR_6705248418,420,0,-49,1,-4,-3,3,0,2,2,4,-4,5,1,1,2,3,0,1,1,0,-14,-119,-1,-3,4,0,0,0,-1,1,-1,1,3,-1
KR_6689080448,420,-2,-56,-8,-4,-1,1,0,3,1,4,0,3,3,-5,6,1,-1,2,1,0,-3,-6,-2,-3,5,6,0,-1,-1,-1,-1,-1,3,-1
KR_6710072113,420,2,20,42,-2,0,3,3,-5,5,0,4,1,5,1,3,4,-2,2,0,0,-13,116,0,-3,3,3,0,2,1,1,1,-1,2,-1
KR_6634840263,420,1,18,9,8,2,3,5,4,2,6,0,2,2,2,3,5,0,3,3,1,6,1,1,-6,5,-6,0,1,1,-1,1,1,3,-1
KR_6675374587,420,-6,-2,-23,-6,-2,4,2,-2,3,1,6,1,7,-6,8,2,-2,4,2,0,-5,2,-2,-3,5,0,0,0,-1,-1,1,1,1,-1
KR_6728208310,420,1,16,-8,5,2,0,2,0,1,1,-2,3,1,6,0,6,-1,1,0,0,5,20,1,-5,4,1,0,1,1,-1,1,-1,1,-1
KR_6508486643,420,0,-11,0,1,0,2,2,-2,4,2,3,1,4,-2,5,3,2,1,3,1,8,-12,-2,-6,8,2,0,0,-1,-1,1,1,3,-1
KR_6725930933,420,-1,-67,1,-9,-2,4,2,1,3,4,-4,7,3,-3,3,0,-1,2,1,0,-3,-2,-1,-5,6,-5,0,-1,-1,-1,-1,1,2,-1
KR_6755926753,420,0,17,12,-4,2,1,3,-1,3,2,-1,3,2,-3,4,1,-1,3,2,0,-8,-5,0,-5,5,1,0,0,-1,-1,0,1,4,-1
KR_6597989040,420,-4,-63,1,-9,-2,3,1,-1,2,1,-4,5,1,0,3,3,-2,2,0,0,-17,4,3,-6,3,1,0,-2,-1,-1,-1,-1,1,-1
KR_6695447473,420,2,5,20,4,6,1,7,-1,3,2,-4,7,3,-1,4,3,4,0,4,-1,-5,-67,-3,-3,6,-20,0,2,1,1,1,-1,3,-1
KR_6644762005,440,0,13,-9,-5,-1,3,2,-4,4,0,0,2,2,-1,3,2,1,0,1,0,-5,36,-1,-6,7,3,0,0,-1,-1,-1,-1,4,-1
KR_6696861363,420,-1,-16,3,-9,2,0,2,-7,8,1,2,1,3,-4,4,0,-2,2,0,0,-10,120,3,-7,4,-3,0,-1,1,-1,-1,1,4,-1
KR_6740587806,440,-7,-63,-36,-16,-3,3,0,-3,6,3,-6,6,0,-1,4,3,-3,4,1,-1,-11,-10,-1,-3,4,0,0,-1,-1,-1,-1,-1,1,-1
KR_6696067277,420,-1,-11,32,-4,4,1,5,-4,4,0,-4,5,1,1,1,2,-1,2,1,0,-9,-24,2,-4,2,5,0,-1,1,-1,-1,-1,5,-1
KR_6763658515,420,-1,-28,-12,0,2,1,3,-2,4,2,1,2,3,-2,6,4,1,1,2,1,2,-97,2,-7,5,-3,0,-1,-1,0,-1,1,1,-1
KR_6766218768,420,1,-50,-12,3,0,0,0,3,0,3,-2,3,1,1,2,3,1,1,2,0,4,-5,-1,-4,5,-1,0,0,-1,-1,0,-1,5,-1
KR_6766198917,420,-2,-64,2,-9,-1,2,1,-1,2,1,1,5,6,-4,4,0,-4,4,0,-1,-5,-88,3,-9,6,-5,0,0,-1,1,-1,-1,3,-1
KR_6755086456,440,-5,-19,4,-15,-3,5,2,1,1,2,-4,4,0,-5,7,2,-4,5,1,0,-15,-8,-2,0,2,-2,0,-2,-1,-1,-1,1,6,-1
KR_6763356283,440,-2,-44,0,-3,0,2,2,2,2,4,-2,3,1,-1,3,2,-2,4,2,0,0,9,4,-9,5,-1,0,0,-1,1,-1,-1,2,-1
KR_6763814671,420,-4,-64,-31,-10,-2,3,1,-4,6,2,-1,2,1,-2,3,1,-1,1,0,0,-9,112,-2,-1,3,0,0,-1,-1,-1,-1,-1,6,-1
KR_6762352481,420,-5,-52,0,-5,-3,4,1,2,0,2,-4,6,2,0,0,0,0,0,0,0,-14,12,1,-5,4,-1,0,-1,-1,1,-1,1,4,-1
KR_6646866478,420,-1,9,0,-4,-5,6,1,-2,3,1,2,2,4,1,3,4,0,1,1,1,-2,7,4,-8,4,-3,0,0,1,-1,0,1,2,-1
KR_6712616409,420,-1,30,-14,2,3,0,3,-1,6,5,1,1,2,2,1,3,-3,3,0,1,14,11,4,-6,2,-1,0,-1,1,-1,-1,1,3,-1
KR_6722081265,420,-3,-26,0,-12,-1,2,1,-2,5,3,-6,8,2,-2,3,1,-1,2,1,-1,-13,-7,-1,-4,5,-1,0,-1,-1,1,-1,-1,1,-1
KR_6632225349,420,-3,4,-8,-5,0,0,0,-3,8,5,-1,5,4,-4,4,0,3,1,4,0,2,25,-3,-4,7,6,0,-4,1,-1,-1,1,2,-1
KR_6755440503,440,-2,-81,24,1,-2,3,1,-2,3,1,0,2,2,4,0,4,1,0,1,0,3,-2,1,-5,4,2,0,-1,1,-1,-1,1,2,-1
KR_6761198202,440,-4,4,-20,-4,0,2,2,-5,8,3,1,1,2,-3,3,0,3,2,5,0,-9,-23,0,-2,2,3,0,0,-1,-1,1,1,6,-1
KR_6760145366,420,2,14,-12,0,7,0,7,-5,6,1,-2,2,0,2,1,3,-2,2,0,1,-6,-25,4,-10,6,0,0,0,1,-1,-1,1,4,-1
KR_6665544345,420,-4,-103,-8,-7,-5,5,0,0,2,2,-2,3,1,0,1,1,0,1,1,0,-3,0,-3,-5,8,2,0,-2,1,-1,-1,-1,3,-1
KR_6757040991,420,0,-46,25,2,-3,5,2,3,2,5,2,0,2,-3,4,1,3,0,3,0,-3,31,2,-9,7,-3,0,0,0,-1,0,-1,0,-1
KR_6562539363,420,-3,-8,-20,-14,-1,1,0,-9,10,1,-2,3,1,-4,4,0,2,0,2,0,-18,-43,-9,-1,10,-1,0,-1,0,-1,-1,-1,0,-1
KR_6735712341,420,-4,-69,0,-8,-4,5,1,-3,3,0,5,1,6,-7,7,0,1,0,1,0,-17,-16,3,-6,3,-3,0,-1,-1,-1,-1,-1,5,-1
KR_6702355058,420,-1,44,-5,-2,3,2,5,1,3,4,1,1,2,-4,6,2,-3,4,1,1,-15,-2,0,-4,4,0,0,-2,-1,-1,-1,1,5,-1
KR_6669913653,420,-1,-1,8,-1,-3,5,2,-2,3,1,-2,5,3,5,2,7,1,1,2,1,-3,-6,3,-6,3,4,0,0,-1,-1,-1,1,1,-1
KR_6706531501,420,-2,-64,0,-7,-2,2,0,0,0,0,0,1,1,-6,7,1,1,0,1,0,-11,-8,-2,-4,6,-4,0,-2,-1,1,-1,-1,4,-1
KR_6694073902,440,-2,-9,-34,-2,3,1,4,-1,3,2,-5,5,0,1,0,1,0,0,0,0,2,8,-1,-6,7,-10,0,-1,-1,-1,-1,-1,6,-1
KR_6755267912,420,2,22,28,-7,-1,2,1,-3,5,2,-3,6,3,0,3,3,0,0,0,0,-7,8,-4,-4,8,4,0,0,1,-1,0,-1,2,-1
KR_6762924699,420,0,60,-7,-1,-2,2,0,6,2,8,4,2,6,-5,6,1,-4,5,1,0,0,-6,-1,-4,5,0,0,0,1,-1,0,1,5,-1
KR_6726032467,420,-2,-44,4,-3,2,0,2,-3,5,2,0,2,2,-3,4,1,1,1,2,0,-8,43,6,-9,3,-3,0,-2,1,1,-1,-1,4,-1
KR_6761445700,420,0,33,12,-3,2,2,4,1,2,3,-4,4,0,0,4,4,-2,2,0,0,-5,-3,6,-6,0,1,0,-1,-1,1,-1,-1,5,-1
KR_6705458800,420,-7,-105,-37,-19,-5,7,2,-10,11,1,2,1,3,-4,11,7,-2,3,1,-1,-17,3,-3,0,3,1,0,-1,0,0,-1,1,0,-1
KR_6742983691,420,-4,-12,-22,-8,0,3,3,0,3,3,-1,3,2,-6,7,1,-1,2,1,0,-9,-4,-2,-7,9,-4,0,0,-1,1,-1,-1,5,-1
KR_6764028941,420,-2,-16,-22,-2,4,0,4,3,2,5,0,0,0,-9,10,1,0,0,0,0,-1,6,4,-8,4,-4,0,-1,-1,1,-1,-1,1,-1
KR_6766240989,440,-2,-61,0,-1,0,2,2,-2,4,2,-2,4,2,2,3,5,1,2,3,0,5,-13,-3,-1,4,5,0,-2,1,-1,-1,1,2,-1
KR_6748500100,420,2,-16,7,5,-1,2,1,5,1,6,-2,3,1,2,1,3,1,0,1,0,15,-1,-3,-4,7,4,0,1,1,1,-1,1,6,-1
KR_6745890819,420,-3,-29,-36,-14,-1,2,1,-1,6,5,-2,4,2,-9,9,0,-1,1,0,-2,-16,10,-2,-4,6,-4,0,-1,-1,-1,-1,-1,5,-1
KR_6651640488,420,-3,-121,-36,-3,-1,2,1,-2,3,1,-5,5,0,4,2,6,1,0,1,-1,0,-31,0,-9,9,3,0,0,-1,1,-1,-1,4,-1
KR_6725731691,420,-4,20,-27,-4,-1,2,1,-2,4,2,0,2,2,1,2,3,-2,2,0,0,-2,61,-1,-4,5,2,0,1,1,1,1,-1,6,-1
KR_6744418018,420,-5,-98,-16,-6,0,3,3,1,0,1,-3,5,2,-3,4,1,-1,1,0,1,-4,-36,3,-6,3,-2,0,-1,-1,-1,-1,1,6,-1
KR_6762944307,420,-3,-35,25,-6,-3,3,0,-1,2,1,1,2,3,-3,4,1,0,1,1,0,-10,-220,3,-5,2,-2,0,0,-1,-1,-1,1,4,-1
KR_6728135320,420,-3,-41,8,-6,3,1,4,-2,4,2,-1,4,3,-3,3,0,-3,4,1,0,-12,3,2,-8,6,-5,0,-1,-1,0,-1,-1,1,-1
KR_6741363626,420,-1,-33,40,-4,-1,1,0,3,1,4,-4,5,1,-1,4,3,-1,1,0,0,1,-4,-3,-4,7,0,0,-1,1,-1,-1,1,4,-1
KR_6751333348,440,0,-39,7,-1,0,0,0,4,0,4,-2,2,0,-6,6,0,3,0,3,0,3,-15,0,-4,4,-1,0,0,-1,-1,-1,1,1,-1
KR_6754944467,420,-5,-82,0,-13,-4,5,1,-4,4,0,-1,3,2,-1,3,2,-3,4,1,0,-8,0,2,-5,3,1,0,-2,-1,-1,-1,1,4,-1
KR_6660087687,420,0,40,12,-7,-1,2,1,-1,3,2,-6,6,0,0,2,2,1,1,2,0,-6,-14,-2,-9,11,1,0,0,1,-1,-1,-1,5,-1
KR_6756155381,420,-2,-79,10,-7,1,1,2,-2,2,0,0,1,1,-5,7,2,-1,1,0,0,-9,-25,-4,-1,5,13,0,-1,-1,0,-1,-1,2,-1
KR_6713609568,420,-1,10,-1,0,3,1,4,1,1,2,-4,5,1,-3,4,1,3,0,3,0,0,-11,-4,-4,8,3,0,-1,1,0,-1,-1,3,-1
KR_6755379311,420,-6,-98,-26,-12,1,0,1,-1,1,0,-12,13,1,1,1,2,-1,1,0,0,-9,-26,-2,-5,7,-1,0,-2,-1,-1,-1,-1,5,-1
KR_6761294384,420,0,-17,-8,-5,-3,3,0,3,0,3,-3,4,1,-3,4,1,1,2,3,-1,-5,-21,-1,-7,8,1,0,-1,-1,1,-1,-1,3,-1
KR_6591202554,420,2,24,28,7,1,1,2,5,3,8,1,2,3,0,2,2,0,1,1,0,3,6,-2,-7,9,3,0,-1,1,-1,-1,1,4,-1
KR_6745902594,420,3,-24,-13,9,5,0,5,-1,2,1,2,3,5,2,1,3,1,0,1,1,7,6,0,-5,5,-3,0,1,1,1,1,1,6,-1
KR_6763300698,440,-1,-25,-20,1,2,1,3,1,1,2,-2,3,1,0,2,2,0,0,0,0,2,-5,-1,-6,7,0,0,0,-1,1,0,-1,5,-1
KR_6702474893,420,-5,-28,-8,-9,-1,1,0,2,2,4,-5,6,1,-4,7,3,-1,1,0,-1,-15,-1,-3,-3,6,1,0,-3,1,-1,-1,1,1,-1
KR_6764895119,420,2,44,-17,9,1,3,4,-4,9,5,5,1,6,6,0,6,1,0,1,0,7,6,2,-9,7,1,0,1,-1,1,1,-1,5,-1
KR_6647080437,440,-5,-42,-10,-14,0,2,2,-8,8,0,-3,5,2,1,2,3,-4,5,1,0,-13,-1,0,-5,5,-4,0,0,-1,1,-1,-1,3,-1
KR_6753314353,420,-3,-70,-28,-10,0,1,1,0,3,3,-2,2,0,-5,7,2,-3,3,0,-1,-13,19,4,-6,2,-1,0,-2,-1,1,-1,-1,5,-1
KR_6749442152,420,1,14,-10,3,-2,4,2,4,2,6,2,1,3,-2,2,0,1,0,1,-1,0,5,1,-7,6,-1,0,0,1,1,1,-1,3,-1
KR_6764781287,420,1,11,-1,-9,-2,4,2,-1,5,4,1,1,2,-3,5,2,-4,5,1,-1,-9,1,4,-10,6,-8,0,-2,-1,-1,-1,-1,2,-1
KR_6659378537,420,2,33,24,0,-2,3,1,3,3,6,0,1,1,0,1,1,-1,1,0,0,-2,-119,0,-6,6,0,0,-1,-1,-1,-1,-1,6,-1
KR_6750478225,420,-5,-45,-20,-7,-2,3,1,1,4,5,1,2,3,-4,5,1,-3,5,2,1,-12,-305,-4,-3,7,5,0,-2,-1,1,-1,1,4,-1
KR_6743851959,440,-2,-91,-7,-7,-2,4,2,-3,6,3,-1,2,1,0,1,1,-1,2,1,-1,-1,-41,-3,-3,6,-2,0,-2,-1,-1,-1,-1,3,-1
KR_6718397451,420,0,23,5,1,-3,3,0,0,4,4,2,2,4,3,2,5,-1,1,0,0,-3,2,-2,-5,7,2,0,-1,-1,-1,1,-1,4,-1
KR_6696709855,420,-2,-92,-1,-2,1,2,3,0,5,5,-2,2,0,0,1,1,-1,1,0,-1,-9,8,3,-10,7,-1,0,0,-1,-1,0,-1,1,-1
KR_6633419430,420,-3,-69,-22,-5,-1,2,1,-5,9,4,2,1,3,-1,2,1,0,1,1,0,-1,3,-2,-3,5,-1,0,0,-1,1,1,1,6,-1
KR_6766397067,420,-3,-32,-18,-10,-3,3,0,-4,5,1,0,0,0,2,1,3,-5,6,1,-1,-10,-6,1,-5,4,2,0,-1,1,1,-1,-1,4,-1
KR_6716783322,420,-1,-14,3,-5,1,0,1,7,0,7,-1,4,3,-6,7,1,-6,6,0,0,-7,-45,4,-7,3,17,0,-2,-1,1,-1,-1,1,-1
KR_6765484336,420,-4,-35,-6,-9,-3,4,1,-2,3,1,2,1,3,-6,7,1,0,1,1,-1,-9,-31,-2,-3,5,-2,0,-3,-1,-1,-1,-1,3,-1
KR_6753794701,440,-2,-10,-14,-3,8,0,8,1,0,1,-1,1,0,-9,11,2,-2,2,0,0,-11,31,-3,-8,11,-1,0,-1,1,-1,-1,1,2,-1
KR_6750186836,420,1,-4,29,-6,-2,2,0,-1,6,5,-3,3,0,-2,5,3,2,1,3,0,-2,-1,-2,-3,5,1,0,0,1,1,0,-1,3,-1
KR_6679437893,420,0,-21,0,2,-2,3,1,2,2,4,0,4,4,0,0,0,2,2,4,0,7,-63,-3,-3,6,16,0,1,0,-1,1,1,0,-1
KR_6764988292,420,1,73,-8,4,4,0,4,-4,8,4,1,4,5,2,4,6,1,1,2,0,0,1,4,-8,4,5,0,2,-1,1,1,1,5,-1
KR_6759169091,420,-2,-7,-21,-9,-1,1,0,-5,6,1,1,1,2,-2,8,6,-2,2,0,0,-5,2,-3,-3,6,-1,0,0,0,-1,0,-1,0,-1
KR_6760124850,420,-1,10,7,5,-4,6,2,0,3,3,8,1,9,2,2,4,-1,3,2,1,9,-10,-5,-3,8,0,0,0,1,1,0,1,5,-1
KR_6703789366,420,-5,-59,-14,-8,-1,3,2,-3,3,0,0,4,4,-3,4,1,-1,3,2,0,-1,-318,3,-8,5,-2,0,-2,-1,-1,-1,-1,6,-1
KR_6666272065,420,0,-42,24,-5,-2,3,1,-2,5,3,0,2,2,-1,3,2,0,0,0,0,-4,11,-3,-3,6,1,0,-1,-1,1,1,-1,5,-1
KR_6763368453,420,0,32,12,2,-1,2,1,1,2,3,1,4,5,1,0,1,0,0,0,0,-3,6,4,-8,4,1,0,0,1,0,0,1,1,-1
KR_6677933719,420,1,9,20,5,0,1,1,4,1,5,-2,3,1,2,2,4,1,0,1,1,7,-88,4,-7,3,-4,0,0,-1,1,0,1,1,-1
KR_6601031011,420,2,2,13,5,1,2,3,4,0,4,-1,3,2,-1,2,1,2,0,2,0,7,35,0,-5,5,5,0,0,1,-1,0,-1,5,-1
KR_6762729276,420,3,1,28,1,1,4,5,1,3,4,2,0,2,-3,7,4,0,2,2,0,-6,93,5,-9,4,-3,0,-1,-1,-1,-1,-1,1,-1
KR_6692445941,420,-4,-13,-60,-12,-4,5,1,-1,1,0,-5,5,0,1,2,3,-3,3,0,0,-3,171,1,-5,4,0,0,-2,-1,-1,-1,-1,1,-1
KR_6704144149,420,-1,101,-32,-1,2,3,5,-6,6,0,1,2,3,-1,2,1,3,0,3,0,-11,104,-6,-6,12,-5,0,1,1,-1,1,1,3,-1
KR_6735411316,420,0,9,-26,5,0,1,1,-2,5,3,2,4,6,2,2,4,3,1,4,0,0,-6,-1,-4,5,3,0,1,1,-1,1,1,6,-1
KR_6762436579,420,-3,22,6,-7,4,0,4,-5,6,1,-3,4,1,-1,2,1,-2,2,0,0,-12,1,-1,-2,3,-3,0,1,-1,1,1,-1,2,-1
KR_6757315833,420,-4,-8,18,-17,-3,4,1,-2,3,1,-3,3,0,-8,9,1,-1,1,0,0,-16,-265,6,-8,2,-2,0,-2,-1,1,-1,-1,2,-1
KR_6759687109,420,6,63,16,7,3,4,7,-1,1,0,-1,2,1,2,2,4,4,1,5,-1,-4,-10,-3,-4,7,-3,0,0,1,-1,-1,-1,1,-1
KR_6729352058,420,2,31,11,11,3,1,4,1,1,2,-2,4,2,7,0,7,2,2,4,1,12,-2,3,-7,4,-2,0,0,1,-1,0,1,5,-1
KR_6763431471,420,-3,-26,-32,-8,2,3,5,-6,9,3,3,1,4,-5,5,0,-2,2,0,-3,-21,-5,0,-3,3,1,0,0,-1,1,-1,-1,5,-1
KR_6705372785,420,0,-40,12,-5,-2,2,0,-3,4,1,1,2,3,0,1,1,-1,1,0,-1,-8,23,-1,-4,5,-3,0,0,1,-1,-1,-1,1,-1
KR_6763243319,440,-2,-97,-6,-8,1,3,4,-4,5,1,-3,4,1,2,2,4,-4,5,1,0,1,-10,-2,-6,8,4,0,-1,-1,0,-1,-1,1,-1
KR_6726411526,420,0,8,-12,-6,0,2,2,-4,4,0,0,3,3,-6,9,3,4,1,5,-1,-8,1,-4,-2,6,-2,0,1,1,-1,1,-1,1,-1
KR_6758779958,420,-1,-49,20,-6,-2,3,1,-1,3,2,1,0,1,-2,3,1,-2,2,0,0,-1,-15,4,-8,4,4,0,-1,1,1,-1,-1,6,-1
KR_6764617194,440,-2,-29,2,-6,-2,2,0,5,1,6,-3,3,0,-5,6,1,-1,2,1,0,-9,4,-1,-2,3,1,0,0,1,-1,0,1,5,-1
KR_6712185066,420,-2,-24,-20,-3,0,2,2,1,1,2,-3,3,0,-1,2,1,0,1,1,0,-1,17,-6,-3,9,5,0,-2,-1,-1,-1,1,4,-1
KR_6677810578,420,-3,23,-11,-9,-4,4,0,-1,4,3,3,0,3,-6,8,2,-1,3,2,1,-8,5,-3,-6,9,-6,0,0,-1,-1,-1,1,6,-1
KR_6766136218,420,-1,-63,-7,-3,-2,3,1,0,3,3,-1,4,3,3,5,8,-3,4,1,0,-9,-6,-2,-5,7,0,0,2,-1,-1,1,-1,4,-1
KR_6652463314,420,-3,-3,15,-10,2,0,2,-3,7,4,-3,6,3,-2,4,2,-4,5,1,0,-9,-8,0,-2,2,-2,0,-1,-1,1,-1,-1,5,-1
KR_6743445826,420,-2,28,0,-3,1,2,3,2,1,3,-2,4,2,-1,2,1,-3,4,1,-1,-10,8,0,-6,6,-1,0,0,-1,-1,0,-1,1,-1
KR_6697208399,420,-5,-69,-32,-7,2,2,4,-1,3,2,-1,4,3,-8,9,1,1,0,1,0,-9,-38,-3,-4,7,11,0,-1,-1,-1,-1,1,4,-1
KR_6367281525,440,-3,42,-12,-10,2,0,2,-1,2,1,2,1,3,-13,15,2,0,2,2,0,-8,0,0,0,0,5,0,0,-1,-1,1,1,2,-1
KR_6753656064,420,1,-90,26,4,0,2,2,-1,3,2,2,0,2,1,1,2,2,0,2,0,5,9,-1,-3,4,14,0,-2,1,1,-1,1,3,-1
KR_6751987262,420,0,-34,28,-8,0,1,1,0,2,2,2,1,3,-7,7,0,-3,3,0,0,-9,-121,2,-8,6,5,0,0,1,-1,-1,-1,3,-1
KR_6756453567,420,-5,-47,-8,-8,-3,5,2,-3,4,1,-2,3,1,2,4,6,-2,2,0,-1,-8,-9,1,-6,5,-3,0,-2,1,-1,-1,-1,3,-1
KR_6759996377,440,-5,-43,-45,-10,2,1,3,-4,5,1,-1,4,3,0,0,0,-7,8,1,0,-11,5,2,-3,1,-11,0,-1,-1,1,-1,-1,5,-1
KR_6762536333,420,0,-24,-21,-1,5,4,9,-3,6,3,0,3,3,-4,7,3,1,3,4,3,6,113,2,-5,3,-3,0,1,1,1,-1,1,6,-1
KR_6745309532,420,2,-40,0,0,-1,2,1,0,5,5,0,1,1,2,2,4,-1,1,0,0,-1,-5,1,-5,4,4,0,0,1,1,0,-1,5,-1
KR_6756106888,420,-4,-35,-8,-9,-3,3,0,-5,9,4,3,0,3,-4,6,2,0,0,0,-2,-12,-1,0,-5,5,1,0,0,1,-1,0,-1,3,-1
KR_6725275093,420,3,5,-2,7,2,0,2,6,0,6,3,2,5,0,3,3,-4,5,1,1,5,-9,-3,-5,8,-1,0,0,1,1,1,1,2,-1
KR_6509143334,420,-1,-63,6,-2,0,3,3,-1,5,4,3,1,4,-3,3,0,-1,1,0,0,-5,-2,0,-5,5,1,0,-2,1,1,-1,1,1,-1
KR_6722080285,420,-1,-65,0,-2,-5,5,0,0,0,0,2,1,3,0,3,3,1,0,1,0,-1,19,6,-8,2,2,0,-1,1,-1,-1,1,2,-1
KR_6764517921,420,-3,-43,3,6,-3,4,1,4,1,5,2,1,3,3,0,3,0,0,0,0,10,166,3,-10,7,2,0,1,1,0,1,1,3,-1
KR_6760624020,420,2,-23,12,5,1,0,1,-1,1,0,2,3,5,3,4,7,0,1,1,0,2,-2,2,-4,2,2,0,0,-1,1,1,-1,4,-1
KR_6617558898,420,2,-19,8,6,0,1,1,-2,6,4,2,0,2,3,3,6,3,0,3,0,2,-7,0,-6,6,7,0,0,-1,-1,0,1,3,-1
KR_6758960453,420,1,-53,9,0,-3,4,1,-1,2,1,1,3,4,1,2,3,2,0,2,0,3,31,-3,-3,6,0,0,0,-1,-1,0,-1,4,-1
KR_6739795535,420,-3,-47,-28,3,1,1,2,2,1,3,1,1,2,-3,6,3,2,0,2,0,7,19,-4,-5,9,-3,0,0,-1,-1,-1,1,2,-1
KR_6579168813,420,-1,-10,-11,-5,0,1,1,-3,5,2,-1,3,2,1,1,2,-2,2,0,0,0,4,-1,-7,8,-1,0,0,-1,1,1,-1,6,-1
KR_6766452144,420,-3,-82,-43,-10,0,1,1,1,2,3,2,2,4,-13,14,1,0,1,1,0,-4,-22,-2,-6,8,3,0,-2,-1,-1,-1,-1,6,-1
KR_6755447086,420,-1,4,9,3,3,2,5,2,0,2,-3,7,4,2,2,4,-1,3,2,1,1,-8,2,-6,4,5,0,1,1,1,1,1,3,-1
KR_6743785825,420,0,11,24,-4,-2,2,0,1,4,5,-5,6,1,0,3,3,2,0,2,0,2,-208,-2,-3,5,2,0,0,-1,1,0,-1,6,-1
KR_6735524272,440,7,40,18,7,2,0,2,3,1,4,2,3,5,0,2,2,0,2,2,0,3,-2,-3,-3,6,1,0,0,1,-1,0,1,3,-1
KR_6722922401,420,-1,-76,-27,-8,-1,2,1,-1,4,3,-3,5,2,-1,3,2,-2,3,1,0,-5,-7,2,-8,6,2,0,0,-1,0,0,-1,4,-1
KR_6757603131,420,-2,-33,28,0,1,1,2,2,1,3,0,2,2,-2,3,1,-1,1,0,0,-6,-5,3,-6,3,2,0,1,1,0,1,1,5,-1
KR_6766465965,420,-1,-4,7,3,-3,6,3,5,0,5,2,1,3,-1,2,1,0,3,3,0,1,-4,5,-8,3,-5,0,0,1,-1,0,1,2,-1
KR_6764720187,420,1,21,15,-2,1,3,4,1,0,1,-1,3,2,-1,4,3,-2,2,0,3,8,-313,0,-6,6,-3,0,1,1,1,1,1,2,-1
KR_6734134175,420,-2,2,-4,0,3,2,5,1,5,6,-2,3,1,-2,10,8,0,1,1,2,4,-6,-4,-5,9,4,0,-2,-1,-1,-1,1,3,-1
KR_6764168385,420,-6,-54,-27,-10,-5,5,0,-10,10,0,0,0,0,6,0,6,-1,2,1,0,-5,3,-3,-4,7,-1,0,-1,1,0,-1,-1,5,-1
KR_6714746377,420,1,-17,8,-3,1,1,2,-8,10,2,4,3,7,1,6,7,-1,1,0,1,1,-38,4,-9,5,15,0,-1,1,0,-1,1,2,-1
KR_6751172554,420,-4,-55,-7,-13,-3,4,1,0,5,5,-6,6,0,-3,3,0,-1,1,0,0,-6,4,1,-6,5,-4,0,-2,-1,-1,-1,-1,2,-1
KR_6601385103,420,-3,-20,0,-2,-1,1,0,-5,9,4,2,1,3,-1,2,1,3,0,3,-1,-8,8,-1,-4,5,1,0,-2,0,-1,-1,-1,0,-1
KR_6758685749,420,0,13,-8,-2,-1,2,1,0,2,2,1,1,2,-3,10,7,1,1,2,0,-2,-16,-2,-4,6,3,0,1,-1,1,1,1,5,-1
KR_6765106560,420,-4,-53,15,-14,-2,3,1,-5,6,1,-5,6,1,-5,5,0,3,0,3,-1,-12,-20,0,-4,4,1,0,-1,1,1,-1,-1,6,-1
KR_6751361041,420,0,15,24,-6,1,0,1,-1,2,1,1,1,2,-8,10,2,1,1,2,0,-14,-2,-1,-7,8,2,0,0,-1,1,0,-1,4,-1
KR_6683864851,420,1,25,-28,3,0,2,2,4,0,4,-3,5,2,3,2,5,-1,1,0,0,0,135,6,-8,2,-2,0,1,0,0,1,-1,0,-1
KR_6750709945,420,0,-53,2,-4,1,3,4,1,3,4,-6,6,0,0,2,2,0,0,0,0,4,5,0,-4,4,4,0,-1,-1,-1,-1,1,3,-1
KR_6597771920,420,3,-15,-13,12,1,0,1,9,0,9,1,5,6,-2,2,0,3,0,3,0,26,-40,1,-7,6,17,0,0,1,0,0,-1,3,-1
KR_6602799879,420,-1,38,-16,-4,2,0,2,-1,4,3,1,3,4,-3,4,1,-3,3,0,0,-5,-14,0,-7,7,2,0,0,-1,1,-1,-1,5,-1
KR_6740280714,420,-3,-28,-14,-10,1,0,1,-1,3,2,2,0,2,-10,11,1,-2,2,0,0,-12,3,-4,-6,10,0,0,0,-1,1,-1,-1,2,-1
KR_6752183268,420,-3,-45,1,-8,-4,4,0,-3,3,0,1,3,4,-4,5,1,2,0,2,0,1,-106,-3,-4,7,-4,0,-1,1,-1,-1,-1,2,-1
KR_6755304355,420,0,17,24,-5,0,2,2,1,3,4,0,2,2,-3,5,2,-3,3,0,0,-10,-16,-4,-3,7,2,0,-1,-1,1,1,-1,5,-1
KR_6728509981,440,0,-25,8,-1,1,3,4,-2,2,0,-2,4,2,2,1,3,0,3,3,-1,3,-3,0,-4,4,1,0,0,1,0,0,-1,6,-1
KR_6758752550,420,-1,-27,-20,0,3,1,4,1,0,1,-2,4,2,-1,2,1,-1,3,2,0,8,7,0,-4,4,0,0,-2,0,0,-1,-1,0,-1
KR_6753953601,420,-4,-46,-3,-2,0,0,0,1,1,2,2,1,3,-4,4,0,-1,1,0,0,-3,-115,-2,-4,6,3,0,0,1,1,1,-1,6,-1
KR_6645991708,440,-3,-3,4,-1,-2,2,0,0,0,0,-1,2,1,3,4,7,-1,2,1,0,2,-8,5,-6,1,-2,0,-1,-1,1,-1,-1,5,-1
KR_6367403131,440,-4,-97,16,2,3,1,4,0,5,5,4,3,7,-5,10,5,0,2,2,0,-4,0,0,0,0,-8,0,-1,1,0,-1,1,5,-1
KR_6722840024,420,1,-16,4,2,1,1,2,0,3,3,0,3,3,1,0,1,0,0,0,0,3,-1,-1,-2,3,0,0,-1,-1,-1,-1,1,1,-1
KR_6744022550,440,-2,2,-20,-5,-1,1,0,1,6,7,-2,4,2,-4,7,3,1,0,1,0,-7,0,2,-5,3,4,0,-1,-1,0,-1,-1,6,-1
KR_6766042944,420,0,-8,5,1,0,3,3,3,2,5,-2,2,0,0,2,2,0,1,1,0,5,26,3,-9,6,2,0,1,-1,-1,1,-1,6,-1
KR_6749855265,440,2,14,16,-10,1,1,2,-6,8,2,-3,5,2,2,1,3,-4,4,0,-2,-15,-1,-1,-2,3,1,0,0,0,-1,0,-1,0,-1
KR_6748627995,420,-4,-10,13,-8,-3,7,4,-5,5,0,-1,5,4,1,3,4,0,1,1,0,-8,-7,-6,-1,7,2,0,0,1,1,-1,1,5,-1
KR_6736590061,420,2,87,0,-1,3,3,6,-1,1,0,-3,4,1,3,1,4,-3,3,0,0,-8,9,-1,-5,6,1,0,0,1,-1,-1,1,1,-1
KR_6758291090,420,-1,-5,-20,-4,1,1,2,-1,1,0,-2,5,3,1,2,3,-3,3,0,0,-7,4,0,-6,6,-2,0,0,1,-1,0,1,5,-1
KR_6738792491,420,-1,-27,-12,-5,-1,1,0,0,2,2,-2,4,2,-1,1,0,-1,1,0,0,-7,-4,-4,-6,10,2,0,-1,-1,-1,-1,-1,2,-1
KR_6596608586,420,-2,34,8,0,-2,3,1,-1,6,5,1,1,2,1,2,3,1,0,1,0,-9,4,0,-7,7,4,0,0,-1,1,0,1,4,-1
KR_6737889118,420,0,44,-41,-7,2,0,2,-3,4,1,-2,4,2,-1,3,2,-3,3,0,-2,-7,-8,-2,-4,6,2,0,0,-1,1,0,-1,2,-1
KR_6752309167,420,-5,-24,-3,-6,3,1,4,-3,5,2,-1,1,0,-3,3,0,-2,3,1,0,-7,2,2,-7,5,2,0,-1,-1,-1,-1,-1,5,-1
KR_6732488895,440,3,44,7,-1,0,3,3,-5,5,0,1,3,4,3,0,3,0,0,0,0,-6,-7,2,-7,5,8,0,1,1,1,1,-1,4,-1
KR_6747055469,420,-3,-30,-20,-5,1,1,2,-3,4,1,-2,3,1,-2,2,0,1,1,2,0,-6,-177,2,-7,5,-6,0,-1,-1,1,-1,-1,4,-1
KR_6733073072,420,1,82,27,4,0,2,2,1,3,4,5,0,5,-2,4,2,0,2,2,0,-7,88,-1,-4,5,-2,0,1,1,1,1,1,5,-1
KR_6764944740,420,-4,-25,-9,-10,-2,2,0,-1,2,1,-5,7,2,-1,3,2,-1,1,0,0,-10,2,-3,-3,6,-2,0,0,-1,1,0,-1,6,-1
KR_6671267030,420,-2,-109,-16,-3,1,1,2,1,1,2,-3,5,2,-3,4,1,1,0,1,0,0,23,-3,-4,7,3,0,-2,1,-1,-1,-1,1,-1
KR_6739303445,420,1,32,-34,0,-3,5,2,1,2,3,-1,2,1,1,2,3,2,0,2,0,2,-11,5,-10,5,-4,0,-1,-1,-1,-1,-1,3,-1
KR_6738505413,420,1,70,-5,-2,3,0,3,-2,4,2,-5,6,1,2,2,4,0,1,1,-1,-3,-1,0,-4,4,4,0,0,1,-1,0,-1,1,-1
KR_6742457276,420,-7,-34,-15,-11,4,1,5,-4,5,1,-8,8,0,-1,1,0,-2,2,0,-1,-9,-145,-2,-7,9,-4,0,0,-1,-1,-1,-1,1,-1
KR_6679645170,420,1,29,-13,3,4,0,4,-5,6,1,3,2,5,1,4,5,0,3,3,1,-5,-16,0,-8,8,0,0,1,-1,1,1,-1,3,-1
KR_6736805540,420,-3,-85,-12,-8,-5,6,1,-2,3,1,0,2,2,-3,7,4,2,0,2,0,-9,-5,1,-5,4,3,0,-2,-1,0,-1,-1,5,-1
KR_6723644203,420,-1,-25,-16,-4,0,1,1,0,2,2,-1,2,1,0,2,2,-3,3,0,0,-1,1,-1,-3,4,-5,0,0,-1,1,0,-1,1,-1
KR_6766547142,420,-1,-35,16,-5,2,1,3,-5,6,1,-2,3,1,-1,2,1,1,2,3,0,-7,124,-4,-4,8,-4,0,-1,-1,-1,-1,-1,2,-1
KR_6637052942,420,-2,-28,-36,-7,-2,3,1,-3,3,0,-3,4,1,-2,2,0,3,0,3,0,-5,-18,1,-6,5,13,0,0,-1,-1,0,1,5,-1
KR_6684961963,440,1,29,-12,-1,-1,1,0,-2,3,1,-1,2,1,0,4,4,3,3,6,0,-8,-18,-3,-8,11,7,0,3,1,-1,1,-1,2,-1
KR_6753643951,440,-3,-64,-23,-7,-1,1,0,2,2,4,-7,7,0,-1,4,3,0,1,1,0,-4,-8,-5,-4,9,4,0,-2,1,-1,-1,-1,2,-1
KR_6750594260,420,2,-20,-7,-1,-2,2,0,6,1,7,-4,6,2,-2,6,4,1,1,2,0,-3,-9,-5,-4,9,3,0,2,-1,1,1,-1,5,-1
KR_6529274792,420,1,-12,14,1,0,2,2,-1,3,2,-1,1,0,3,2,5,0,0,0,0,2,3,4,-9,5,-6,0,0,-1,1,1,-1,1,-1
KR_6755698277,440,1,10,16,-4,0,1,1,-3,3,0,0,3,3,-1,1,0,0,2,2,0,-5,-23,0,-6,6,1,0,0,1,1,-1,-1,5,-1
KR_6760582565,420,-1,-15,2,-4,1,2,3,-6,6,0,-3,5,2,-1,2,1,5,0,5,0,-14,1,3,-6,3,-5,0,-1,1,-1,-1,1,2,-1
KR_6760784298,440,0,23,-5,-3,1,4,5,-1,1,0,-8,9,1,4,1,5,1,2,3,0,-6,-64,3,-5,2,-1,0,2,1,-1,-1,-1,1,-1
KR_6709182540,420,-1,-2,-6,-7,3,1,4,-4,4,0,0,2,2,-5,7,2,-1,1,0,-1,-11,3,2,-10,8,-1,0,0,0,-1,0,-1,0,-1
KR_6738961527,420,-2,27,-15,-6,-1,4,3,-5,5,0,-1,2,1,1,1,2,0,1,1,0,-9,13,2,-6,4,-1,0,0,-1,-1,0,-1,2,-1
KR_6726651614,420,-1,-35,-4,-3,3,2,5,-4,5,1,1,1,2,-4,7,3,1,1,2,0,-6,-10,-1,-5,6,0,0,1,-1,1,1,1,4,-1
KR_6765599559,420,0,20,-6,-7,1,3,4,-2,4,2,-2,4,2,-1,3,2,-3,3,0,0,-10,-1,-4,-3,7,1,0,-1,-1,1,1,-1,2,-1
KR_6642115933,420,-3,-40,8,-7,1,2,3,-1,2,1,-3,6,3,-3,7,4,-1,4,3,0,-16,-3,-2,-7,9,0,0,1,-1,1,1,-1,5,-1
KR_6760531097,420,0,-62,27,-3,-1,1,0,-3,4,1,4,2,6,-3,4,1,0,2,2,0,1,-22,0,-6,6,3,0,-1,1,-1,-1,-1,1,-1
KR_6762346985,420,-2,-46,9,-3,0,2,2,-1,5,4,2,0,2,-4,4,0,0,0,0,0,-6,3,1,-6,5,2,0,0,1,1,1,-1,3,-1
KR_6672092305,420,-1,-88,1,0,1,3,4,-1,2,1,0,0,0,-2,3,1,2,0,2,0,-4,19,-1,-6,7,-5,0,0,-1,1,-1,1,1,-1
KR_6766101184,420,-3,-31,-12,-7,-3,4,1,2,3,5,-5,7,2,1,4,5,-2,4,2,1,-4,8,5,-6,1,2,0,-1,0,0,-1,1,0,-1
KR_6766484550,440,-5,-28,-12,-11,3,0,3,-4,7,3,2,1,3,-5,7,2,-7,9,2,-2,-21,-131,-4,0,4,-4,0,-2,1,-1,-1,-1,3,-1
KR_6753706465,420,1,59,21,0,-2,2,0,0,3,3,0,1,1,1,3,4,1,1,2,-1,-4,-9,3,-6,3,-1,0,1,-1,1,1,-1,5,-1
KR_6683576608,420,-1,12,9,5,-4,6,2,7,3,10,-1,2,1,2,1,3,1,0,1,0,5,3,0,-1,1,0,0,0,1,-1,-1,-1,5,-1
KR_6752948338,420,-4,-7,4,-11,-2,3,1,-1,3,2,-1,2,1,-2,6,4,-5,5,0,0,-11,102,1,-8,7,0,0,-3,-1,-1,-1,-1,1,-1
KR_6747081548,420,3,2,-20,-1,1,0,1,-1,1,0,-3,6,3,1,1,2,1,0,1,0,4,0,1,-5,4,-6,0,-1,1,0,1,-1,6,-1
KR_6766150789,420,-5,-18,-42,-3,-2,4,2,3,2,5,-7,7,0,2,2,4,1,1,2,1,2,25,0,-6,6,-4,0,-1,-1,-1,-1,1,4,-1
KR_6753559846,420,0,14,12,-3,-3,5,2,-2,7,5,4,0,4,0,4,4,-2,2,0,0,-1,20,4,-5,1,-2,0,-1,1,1,-1,1,1,-1
KR_6617484017,420,-5,-55,16,-8,-5,6,1,2,3,5,0,2,2,-3,3,0,-2,2,0,1,-6,159,4,-5,1,-3,0,-1,-1,1,-1,1,5,-1
KR_6717718531,420,0,27,-3,-4,-4,4,0,-7,8,1,0,2,2,3,0,3,4,1,5,1,-7,1,-2,-4,6,0,0,0,1,-1,1,1,4,-1
KR_6752365222,420,0,55,-8,-9,1,1,2,-8,9,1,-1,3,2,-1,3,2,0,2,2,-2,-14,2,2,-7,5,-3,0,0,-1,1,0,-1,4,-1
KR_6764465288,420,-3,-40,10,-6,1,0,1,-1,2,1,-6,8,2,0,0,0,0,0,0,0,-3,110,3,-6,3,-1,0,-1,1,-1,-1,-1,4,-1
KR_6740229140,440,1,9,9,0,-1,4,3,1,3,4,1,3,4,1,4,5,-2,4,2,-1,-3,2,-1,-2,3,1,0,-1,0,-1,-1,-1,0,-1
KR_6633434361,420,-7,-83,-40,-15,-3,3,0,-1,2,1,-4,5,1,-5,6,1,-2,2,0,-1,-16,-3,-1,-6,7,-1,0,-1,-1,-1,-1,-1,1,-1
KR_6766471831,420,-1,-42,4,-3,-1,2,1,2,4,6,-1,2,1,-1,2,1,-2,2,0,-2,-2,31,-4,-5,9,-2,0,0,-1,1,0,-1,1,-1
KR_6732821505,420,-2,-46,-23,-4,1,2,3,-2,3,1,0,2,2,-4,6,2,1,0,1,0,0,5,3,-6,3,-1,0,-2,1,-1,-1,-1,4,-1
KR_6742839620,420,-2,-81,-9,2,0,1,1,3,2,5,1,0,1,0,1,1,-2,2,0,0,5,113,-3,-5,8,3,0,0,-1,1,0,-1,4,-1
KR_6734696769,420,-2,5,-8,2,0,1,1,-6,7,1,1,2,3,4,0,4,3,3,6,0,1,-15,-1,-4,5,-1,0,0,1,1,1,1,1,-1
KR_6743228949,420,-2,2,8,-7,-1,5,4,-4,5,1,-2,2,0,0,2,2,0,1,1,0,0,-135,1,-7,6,-2,0,-1,-1,-1,-1,-1,3,-1
KR_6746643729,420,-5,-91,14,-19,-2,2,0,-3,6,3,-4,7,3,-8,8,0,-2,2,0,0,-11,-2,-4,-2,6,1,0,-2,-1,-1,-1,-1,2,-1
KR_6765408727,420,2,39,24,-1,3,1,4,-2,6,4,1,3,4,-4,5,1,1,2,3,0,-5,-7,-3,-3,6,0,0,0,0,-1,0,1,0,-1
KR_6701004206,420,0,48,-32,1,4,1,5,1,1,2,2,1,3,4,1,5,-10,10,0,0,-6,5,1,-6,5,-1,0,0,-1,-1,1,-1,1,-1
KR_6758045208,420,-8,-57,-28,-20,-2,2,0,-1,4,3,-10,10,0,-5,5,0,-2,3,1,-1,-14,-26,-1,-1,2,-2,0,-2,-1,-1,-1,1,2,-1
KR_6687796216,420,-6,-90,-28,-16,-1,2,1,-3,4,1,-11,12,1,-3,4,1,2,2,4,0,-13,-4,-3,-4,7,-2,0,-1,0,-1,-1,1,0,-1
KR_6738142443,420,0,-21,-16,-3,-3,3,0,-3,5,2,-2,5,3,6,2,8,-1,1,0,0,3,3,3,-5,2,-3,0,-1,-1,-1,-1,1,4,-1
KR_6568118805,420,-3,-89,24,-13,-1,4,3,-5,6,1,-2,2,0,-5,6,1,0,0,0,0,-13,-10,-3,-6,9,3,0,-2,-1,1,-1,1,5,-1
KR_6563467590,420,-8,14,-23,-20,-4,4,0,-12,13,1,-3,3,0,-1,2,1,0,0,0,0,-23,17,-2,-2,4,-2,0,0,-1,1,0,-1,6,-1
KR_6760381932,440,-2,-13,4,3,4,1,5,-1,1,0,1,4,5,-1,3,2,0,2,2,2,2,-13,5,-6,1,1,0,-1,1,1,-1,1,5,-1
KR_6652668910,420,-5,-16,-14,-13,-1,4,3,-5,6,1,-2,4,2,-2,3,1,-3,3,0,0,-14,-11,-2,-7,9,-4,0,-2,-1,1,-1,1,1,-1
KR_6765786610,420,-5,-95,16,-11,-9,9,0,-1,6,5,-5,6,1,2,3,5,2,0,2,0,-4,-9,0,-4,4,-2,0,-3,-1,-1,-1,-1,5,-1
KR_6601636671,420,-4,-27,-7,-8,2,4,6,-4,5,1,-5,6,1,0,2,2,-1,1,0,0,-10,-121,5,-11,6,-4,0,-1,-1,-1,-1,-1,1,-1
KR_6729984884,420,0,-51,16,0,-2,2,0,1,3,4,-1,2,1,2,3,5,0,2,2,0,5,11,-1,-2,3,-2,0,-1,1,-1,-1,1,3,-1
KR_6705463347,420,1,17,-8,-1,2,1,3,2,2,4,-2,3,1,-3,3,0,0,1,1,0,0,6,5,-9,4,-5,0,0,-1,1,1,1,5,-1
KR_6757960477,420,-1,-64,-11,-4,1,1,2,2,3,5,-6,8,2,2,2,4,-3,3,0,0,3,6,-1,-6,7,-2,0,-2,1,1,-1,-1,3,-1
KR_6658127853,420,-3,-44,-1,0,4,1,5,-1,3,2,3,0,3,-5,9,4,-1,1,0,0,2,-202,3,-9,6,-5,0,-1,-1,1,1,-1,2,-1
KR_6742820494,420,0,-19,4,0,1,0,1,-1,5,4,-1,3,2,-1,3,2,2,0,2,0,-4,-9,-2,-4,6,2,0,0,-1,-1,-1,-1,4,-1
KR_6710928270,420,-6,-20,-23,-16,-2,2,0,-8,8,0,-2,4,2,-2,3,1,-2,2,0,0,-14,26,-4,-4,8,-4,0,-3,-1,-1,-1,-1,2,-1
KR_6764215437,440,-5,-10,20,-13,-5,5,0,-1,3,2,-1,1,0,-6,6,0,0,0,0,-1,-12,16,0,-5,5,-4,0,0,1,-1,0,-1,6,-1
KR_6718477506,420,-5,-27,-23,-16,2,0,2,-7,7,0,-9,10,1,-2,2,0,0,1,1,0,-17,-5,-3,-4,7,-1,0,1,1,1,1,-1,4,-1
KR_6765902524,420,0,64,23,2,-1,2,1,3,0,3,1,1,2,1,2,3,-2,2,0,0,-8,-8,-4,-4,8,5,0,0,1,-1,0,1,2,-1
KR_6688706020,420,4,-2,4,-1,0,2,2,-4,8,4,4,2,6,-2,3,1,1,0,1,0,-3,-15,2,-3,1,0,0,0,0,-1,0,-1,0,-1
KR_6742221165,420,-4,27,16,-7,-1,2,1,-1,5,4,-5,5,0,-3,7,4,3,0,3,0,-14,-1,-4,-2,6,-4,0,1,0,-1,1,1,0,-1
KR_6765582456,440,-2,-11,-2,2,1,0,1,4,3,7,-4,5,1,0,7,7,1,4,5,0,-1,0,-2,-4,6,-5,0,0,-1,1,1,-1,5,-1
KR_6748673908,420,-4,-16,-12,-15,2,2,4,-5,5,0,-13,14,1,-2,4,2,3,0,3,-1,-11,286,-1,-4,5,-2,0,-1,1,-1,-1,-1,5,-1
KR_6759872511,420,-6,-63,-17,-14,-3,7,4,-6,7,1,0,3,3,-3,4,1,-2,2,0,-1,-26,-2,-2,-5,7,-4,0,-2,1,0,-1,-1,1,-1
KR_6729419024,420,3,28,-6,4,-1,2,1,3,0,3,0,3,3,3,4,7,-1,3,2,0,6,7,-2,-3,5,-3,0,1,-1,1,1,-1,5,-1
KR_6748281631,420,1,40,-4,3,-2,2,0,-1,3,2,2,2,4,0,2,2,4,0,4,3,9,7,-2,-3,5,-4,0,0,1,0,0,1,1,-1
KR_6762848933,420,-1,-25,-2,1,1,1,2,-2,4,2,0,5,5,1,1,2,1,0,1,0,-2,-2,0,-6,6,-3,0,-1,-1,-1,-1,1,5,-1
KR_6725140526,420,-2,-59,-19,-6,-2,2,0,-2,6,4,-2,2,0,3,2,5,-3,4,1,0,-3,-9,-3,-5,8,-4,0,-1,-1,-1,-1,1,6,-1
KR_6684088297,420,0,29,14,-5,2,0,2,-4,7,3,-1,3,2,-1,3,2,-1,3,2,0,-8,106,1,-6,5,-4,0,1,1,1,1,-1,3,-1
KR_6689880336,420,-1,33,-24,-2,1,2,3,-2,5,3,-2,4,2,0,1,1,1,0,1,0,-5,-2,-2,-10,12,0,0,0,-1,1,0,1,2,-1
KR_6710073597,440,1,45,-62,1,0,3,3,-2,3,1,-1,1,0,5,3,8,-1,5,4,0,6,21,6,-6,0,-1,0,1,-1,-1,1,1,6,-1
KR_6732971726,420,-2,-62,-1,-9,-2,3,1,2,3,5,-4,5,1,-6,7,1,1,0,1,0,-6,-23,-9,0,9,4,0,0,-1,1,-1,1,1,-1
KR_6597917745,420,0,-3,-4,-4,-1,3,2,1,4,5,-1,2,1,-1,2,1,-2,3,1,0,-6,-125,-1,-4,5,6,0,0,-1,0,0,-1,6,-1
KR_6744047173,420,-1,4,-3,-4,2,1,3,-6,7,1,1,2,3,-2,2,0,1,0,1,0,-2,-26,-2,-3,5,0,0,0,-1,1,0,-1,4,-1
KR_6747164746,420,1,-27,0,3,-1,3,2,0,2,2,3,2,5,3,0,3,-2,3,1,0,6,109,0,-4,4,18,0,0,-1,1,-1,-1,5,-1
KR_6763768175,420,2,-32,6,0,-1,2,1,-1,5,4,0,1,1,2,2,4,0,0,0,0,0,140,5,-13,8,-8,0,0,1,-1,0,-1,5,-1
KR_6567187056,420,0,-17,13,-2,3,0,3,-1,5,4,-2,2,0,-2,4,2,0,0,0,0,-7,-3,3,-8,5,0,0,0,1,-1,0,-1,3,-1
KR_6739380021,420,2,-7,-28,8,0,4,4,4,0,4,2,0,2,3,1,4,-1,2,1,-1,13,-8,0,-5,5,-3,0,0,-1,1,0,-1,3,-1
KR_6737786940,420,2,8,27,-2,-1,3,2,2,1,3,-1,3,2,-1,2,1,-1,3,2,0,-12,-7,0,-6,6,4,0,0,1,0,0,-1,2,-1
KR_6756180292,420,-4,-77,-28,-7,-2,4,2,0,4,4,0,2,2,-3,3,0,-2,3,1,0,-7,4,-3,-4,7,-9,0,-1,0,-1,-1,-1,0,-1
KR_6758558594,420,-5,-112,-12,-16,2,0,2,-1,7,6,-6,7,1,-7,9,2,-4,4,0,0,-9,0,-2,-2,4,-2,0,-2,-1,1,-1,-1,2,-1
KR_6754915049,420,-2,7,0,-9,-1,2,1,-1,2,1,-7,8,1,-1,4,3,1,0,1,-1,-14,9,1,-4,3,0,0,-2,-1,-1,-1,-1,2,-1
KR_6763810563,420,0,10,-12,1,1,1,2,0,4,4,4,2,6,-1,5,4,-3,4,1,-2,-12,31,-3,-2,5,-32,0,2,-1,1,-1,1,5,-1
KR_6706857531,420,0,-48,28,-3,7,1,8,-4,4,0,-6,6,0,1,3,4,-1,3,2,0,-2,5,-2,-3,5,-2,0,0,-1,1,1,-1,2,-1
KR_6701473116,440,1,-21,12,1,0,2,2,1,0,1,3,0,3,0,2,2,-3,6,3,0,3,-3,-5,-1,6,3,0,1,-1,1,1,-1,2,-1
KR_6628557084,420,-1,-20,-12,-1,0,0,0,3,1,4,-3,5,2,-1,1,0,0,0,0,0,-1,-107,-3,-4,7,-1,0,0,-1,1,0,-1,2,-1
KR_6744402025,420,-5,-39,-39,-16,-3,5,2,-1,4,3,-2,3,1,-9,10,1,-1,2,1,-1,-17,-4,4,-8,4,-7,0,-1,-1,-1,-1,-1,6,-1
KR_6763487405,420,-4,-60,5,-3,0,3,3,-1,3,2,-6,7,1,2,1,3,2,1,3,0,-12,4,4,-7,3,1,0,-2,1,1,-1,1,4,-1
KR_6762371395,420,0,-43,-17,1,3,2,5,2,0,2,-1,1,0,-4,6,2,1,1,2,0,-1,-121,0,-8,8,-2,0,0,-1,1,0,-1,5,-1
KR_6760095568,420,1,0,28,-1,-1,2,1,2,4,6,-2,2,0,2,0,2,-2,3,1,1,1,14,0,-4,4,1,0,0,1,1,0,1,6,-1
KR_6743965260,420,-1,-17,34,-7,-2,3,1,0,2,2,-3,3,0,0,4,4,-2,2,0,0,-15,147,1,-5,4,3,0,0,-1,-1,1,-1,1,-1
KR_6763708808,420,-5,-54,-3,-9,-4,4,0,0,2,2,-2,2,0,-2,3,1,-1,1,0,0,-4,5,2,-6,4,-5,0,-1,-1,1,-1,-1,6,-1
KR_6759991739,420,0,-35,-28,0,-5,6,1,0,2,2,4,1,5,0,2,2,1,0,1,-1,7,-5,2,-10,8,3,0,0,-1,1,1,-1,4,-1
KR_6754630805,420,-3,-21,-24,-5,0,0,0,-2,3,1,-5,7,2,0,8,8,2,1,3,0,-8,-12,0,-5,5,5,0,-1,1,1,-1,-1,5,-1
KR_6761949307,440,0,-38,0,4,-2,2,0,3,1,4,3,2,5,-2,6,4,2,1,3,0,5,-4,6,-8,2,3,0,1,1,1,1,1,3,-1
KR_6758276563,440,2,36,12,-2,0,1,1,3,0,3,-4,5,1,-1,2,1,0,5,5,-1,-6,-15,-1,-6,7,0,0,0,0,0,0,-1,0,-1
KR_6765997652,420,-5,-89,8,-9,-1,2,1,-2,2,0,-4,5,1,0,4,4,-2,2,0,0,-8,-111,1,-6,5,1,0,-1,-1,-1,-1,-1,4,-1
KR_6757576554,440,-1,-55,-27,-4,-5,5,0,0,0,0,0,2,2,0,2,2,1,0,1,0,7,4,0,-3,3,-2,0,0,-1,1,0,-1,5,-1
KR_6706683796,420,-2,2,-15,-3,-1,2,1,-7,8,1,0,3,3,4,1,5,1,0,1,0,2,-6,1,-7,6,0,0,-1,-1,-1,-1,-1,4,-1
KR_6751299666,420,0,-83,-12,-3,-1,4,3,0,4,4,2,1,3,-4,5,1,0,2,2,0,1,-20,-5,-4,9,1,0,-2,-1,-1,-1,1,5,-1
KR_6741709938,420,1,-21,4,-5,-2,3,1,0,3,3,-2,3,1,-1,2,1,0,1,1,0,-8,0,0,-5,5,1,0,-1,-1,0,-1,-1,4,-1
KR_6754941649,420,-2,17,-3,-4,0,1,1,-1,1,0,0,3,3,-3,3,0,0,1,1,0,-4,-1,-1,-4,5,4,0,1,1,1,1,1,2,-1
KR_6745255532,420,-3,-5,28,-8,0,1,1,-3,4,1,-4,5,1,3,0,3,-4,4,0,0,-6,1,-4,-3,7,2,0,-1,1,-1,-1,1,2,-1
KR_6756968350,420,-1,-66,-4,-5,0,4,4,-1,2,1,0,3,3,-1,3,2,-3,3,0,0,-4,7,1,-4,3,-3,0,-1,-1,-1,-1,-1,4,-1
KR_6707512590,420,-4,-59,-13,-2,-1,2,1,4,3,7,-3,4,1,-2,5,3,0,0,0,-2,6,150,0,-8,8,1,0,-1,-1,1,-1,-1,2,-1
KR_6755262395,420,0,23,13,-1,2,0,2,-5,6,1,2,4,6,-1,2,1,1,1,2,1,-14,-1,0,-5,5,2,0,0,1,1,0,1,3,-1
KR_6763330569,440,-3,-59,-9,0,-2,3,1,0,2,2,3,2,5,1,1,2,-2,2,0,2,3,7,3,-7,4,-4,0,0,-1,0,-1,1,6,-1
KR_6648439253,420,-6,-79,-60,-17,-4,4,0,-1,3,2,-3,7,4,-5,6,1,-4,5,1,-1,-17,-1,-3,-1,4,-7,0,-1,-1,0,-1,-1,3,-1
KR_6752353182,420,-3,-52,-9,-9,1,1,2,-3,7,4,-1,3,2,-6,8,2,0,0,0,0,-4,-23,0,-8,8,8,0,-1,-1,1,-1,-1,6,-1
KR_6658544586,420,-2,-14,0,-5,-1,1,0,-4,4,0,1,0,1,-1,5,4,0,0,0,0,-5,-1,0,-5,5,-2,0,0,1,1,0,-1,1,-1
KR_6757715843,420,-3,4,0,-14,-1,4,3,-1,3,2,-5,5,0,-7,7,0,0,1,1,0,-13,12,-1,-4,5,0,0,1,0,-1,1,-1,0,-1
KR_6753788284,420,-2,-42,-13,-6,2,0,2,3,1,4,-4,5,1,-7,8,1,0,1,1,-1,-15,-245,-1,-4,5,-7,0,-1,-1,1,-1,-1,4,-1
KR_6709780668,420,3,27,21,5,-3,4,1,1,2,3,8,0,8,2,3,5,-3,3,0,0,1,-39,0,-2,2,14,0,-1,-1,1,1,-1,6,-1
KR_6714304834,420,0,1,-15,1,2,1,3,-2,3,1,-1,1,0,-1,6,5,3,0,3,0,0,-42,-1,-4,5,21,0,0,1,1,0,1,4,-1
KR_6730585376,420,1,15,16,1,-2,2,0,-3,6,3,1,1,2,6,1,7,-1,1,0,0,-2,-46,3,-7,4,16,0,0,1,1,1,1,5,-1
KR_6646539048,420,3,1,16,5,9,0,9,1,1,2,-3,3,0,-6,6,0,4,1,5,-1,-6,-6,4,-6,2,2,0,-1,-1,1,-1,-1,4,-1
KR_6763354896,420,-3,-87,28,-7,-3,3,0,1,1,2,-2,4,2,-1,3,2,-2,2,0,0,-6,81,2,-6,4,-7,0,-2,1,1,-1,1,3,-1
KR_6507279870,420,3,-5,16,7,1,1,2,3,1,4,1,0,1,1,1,2,1,2,3,0,6,-4,-2,-2,4,3,0,0,1,1,0,1,6,-1
KR_6763376517,420,-1,-57,-4,1,0,2,2,0,6,6,-1,2,1,2,2,4,0,1,1,0,2,3,0,-2,2,3,0,-1,1,-1,1,-1,4,-1
KR_6764354667,420,-3,17,24,-3,0,1,1,1,3,4,1,1,2,-2,5,3,-3,3,0,0,-2,-16,-2,-3,5,26,0,-1,1,1,-1,1,4,-1
KR_6736376139,420,-2,-58,-5,-4,1,0,1,-6,7,1,0,4,4,-1,2,1,2,0,2,0,-3,41,2,-9,7,-1,0,-1,1,-1,-1,-1,4,-1
KR_6743115268,420,0,14,-5,2,-2,5,3,-3,4,1,-2,3,1,7,0,7,2,0,2,0,6,3,-1,-4,5,-1,0,1,1,-1,1,1,1,-1
KR_6760960000,420,-3,5,-44,-4,1,2,3,-2,3,1,-4,5,1,1,2,3,0,0,0,0,0,-1,1,-3,2,1,0,0,-1,-1,-1,1,6,-1
KR_6752411851,420,-1,-11,6,2,3,0,3,0,3,3,3,0,3,-2,5,3,-2,3,1,-1,-2,-1,-1,-2,3,2,0,1,-1,1,1,-1,6,-1
KR_6562285425,420,-3,-60,19,-4,-2,4,2,-1,3,2,1,3,4,-1,1,0,-1,1,0,2,6,-11,0,-5,5,-3,0,-1,-1,-1,-1,1,1,-1
KR_6634237150,420,-1,-64,-33,-4,1,0,1,-1,5,4,-2,3,1,-2,3,1,0,2,2,0,-4,-41,-3,-4,7,29,0,-1,-1,-1,-1,-1,3,-1
KR_6740334897,440,4,-29,16,10,0,1,1,6,1,7,3,0,3,1,0,1,0,1,1,0,14,6,-1,-6,7,-2,0,-1,0,-1,-1,1,0,-1
KR_6693992278,420,-3,-93,12,-6,3,0,3,-3,6,3,0,2,2,-8,9,1,2,1,3,0,-1,-3,0,-6,6,-1,0,-1,-1,1,-1,-1,6,-1
KR_6651556538,440,-3,-100,12,-5,-1,1,0,1,1,2,0,0,0,-4,5,1,-1,2,1,0,-4,-50,-1,-3,4,26,0,0,-1,1,-1,-1,3,-1
KR_6684804571,420,-1,-29,27,3,1,3,4,-2,4,2,-1,4,3,1,3,4,4,2,6,0,1,-3,-1,-4,5,2,0,-1,1,-1,-1,1,5,-1
KR_6654945182,420,-2,-64,2,-5,1,1,2,1,1,2,0,4,4,-6,7,1,-1,3,2,-1,-5,5,-1,-3,4,-3,0,0,-1,1,-1,-1,5,-1
KR_6765360939,420,0,-21,-15,-4,0,1,1,-4,6,2,-2,5,3,2,0,2,0,1,1,0,-3,-1,0,-3,3,3,0,1,0,0,1,1,0,-1
KR_6628078304,420,1,3,60,1,0,1,1,1,2,3,-2,4,2,-1,3,2,3,0,3,0,-1,0,3,-8,5,-1,0,0,1,1,0,1,2,-1
KR_6760144484,420,-4,-27,-9,-10,3,0,3,-4,6,2,-5,5,0,-1,1,0,-3,3,0,0,-17,-22,-1,-6,7,20,0,-1,-1,1,-1,1,4,-1
KR_6685020215,420,-3,18,4,0,1,3,4,0,3,3,-2,3,1,2,2,4,-1,1,0,0,1,19,2,-8,6,-8,0,1,-1,1,1,1,4,-1
KR_6575873951,420,-5,-64,-3,-21,-9,11,2,-8,10,2,-1,2,1,-1,2,1,-2,2,0,0,-14,-16,-5,-1,6,3,0,-3,-1,-1,-1,-1,5,-1
KR_6645238845,420,-4,-115,13,-15,2,3,5,-4,8,4,-2,2,0,-11,11,0,0,0,0,0,-15,-1,-3,-3,6,-2,0,-3,1,-1,-1,-1,6,-1
KR_6743530053,420,-1,-9,-12,-5,-4,5,1,-3,5,2,3,1,4,-1,3,2,0,0,0,0,1,1,4,-6,2,0,0,0,-1,-1,0,-1,4,-1
KR_6272932114,420,-10,-183,-8,-20,-4,4,0,-1,1,0,-5,5,0,-6,8,2,-4,5,1,-1,-16,-16,-2,-6,8,1,0,-5,-1,1,-1,1,1,-1
KR_6747551794,420,0,-72,24,-4,-5,5,0,8,0,8,1,0,1,-7,8,1,-1,2,1,0,-4,6,2,-7,5,-8,0,1,-1,1,1,1,6,-1
KR_6727091884,420,1,-24,-4,0,-1,3,2,-1,2,1,-2,2,0,4,3,7,0,1,1,0,-4,-10,1,-4,3,0,0,-1,-1,-1,-1,1,1,-1
KR_6618248885,420,-4,-90,17,-12,-10,10,0,-1,2,1,0,2,2,0,0,0,-1,2,1,0,-8,1,-4,-4,8,0,0,-1,-1,-1,-1,-1,6,-1
KR_6754440363,440,0,-36,9,-2,-4,7,3,1,2,3,1,2,3,-4,4,0,4,0,4,1,0,4,1,-8,7,-5,0,0,-1,-1,0,1,1,-1
KR_6657539349,420,2,26,-8,1,3,1,4,4,0,4,-2,5,3,-5,6,1,1,0,1,0,-2,0,8,-11,3,-3,0,0,1,1,-1,1,6,-1
KR_6748981328,440,3,22,18,5,-2,3,1,2,2,4,2,1,3,2,3,5,1,2,3,0,8,-9,-1,-6,7,-1,0,0,0,-1,0,-1,0,-1
KR_6736271903,420,-2,8,15,-1,-1,2,1,2,3,5,-1,3,2,-3,6,3,2,1,3,0,-3,-11,-4,-5,9,3,0,-1,-1,1,1,-1,3,-1
KR_6727298592,420,-2,-52,-4,-3,-2,3,1,-3,3,0,3,1,4,-2,8,6,1,0,1,0,-3,-11,-3,-4,7,2,0,-1,1,-1,-1,1,1,-1
KR_6755670836,420,0,-23,-29,-1,4,2,6,-1,2,1,0,2,2,0,3,3,-4,5,1,-2,-7,4,4,-7,3,0,0,-2,-1,1,1,-1,1,-1
KR_6746759415,420,-2,-42,-18,-6,0,4,4,-4,6,2,1,1,2,-3,5,2,0,0,0,0,-5,27,3,-7,4,2,0,0,1,1,-1,-1,1,-1
KR_6707317136,420,-2,-30,-19,0,-2,7,5,-1,4,3,-2,2,0,5,0,5,0,0,0,0,11,43,0,-4,4,-4,0,-1,-1,-1,-1,1,4,-1
KR_6709692687,420,-5,-34,8,-15,-5,5,0,-1,2,1,-2,4,2,-6,7,1,-1,1,0,-1,-21,0,-4,-2,6,-6,0,-2,-1,-1,-1,-1,3,-1
KR_6764272610,420,-1,1,0,0,-1,4,3,-1,2,1,5,3,8,-3,4,1,0,3,3,0,10,-8,-1,-5,6,2,0,-1,-1,-1,-1,-1,1,-1
KR_6678123851,420,-1,39,-12,-5,-2,2,0,-2,3,1,2,2,4,-1,3,2,-2,3,1,0,-3,-54,-6,-2,8,7,0,0,-1,-1,0,-1,5,-1
KR_6689958747,420,0,27,-12,1,-4,4,0,-2,4,2,1,1,2,1,1,2,5,2,7,0,2,1,-3,-4,7,1,0,0,0,-1,1,1,0,-1
KR_6763836248,420,-2,-1,-16,-11,-2,2,0,-5,6,1,-1,2,1,-2,3,1,-1,2,1,0,-3,-1,2,-4,2,-6,0,-1,-1,-1,-1,-1,6,-1
KR_6743109471,420,-7,-67,-62,-13,0,2,2,-7,8,1,-3,3,0,-5,5,0,2,1,3,-2,-11,4,3,-6,3,0,0,-2,-1,-1,-1,-1,5,-1
KR_6763606980,420,-2,-85,-16,-9,-2,3,1,-1,3,2,-4,6,2,-4,7,3,2,1,3,0,-9,-5,1,-6,5,-6,0,-2,0,-1,-1,1,0,-1
KR_6686510291,420,-4,-19,-1,-13,0,2,2,-3,5,2,-2,2,0,-9,9,0,1,1,2,-1,-20,-57,-4,-2,6,-4,0,-3,-1,-1,-1,-1,5,-1
KR_6757844311,440,3,23,8,8,2,1,3,-2,3,1,-5,5,0,8,1,9,5,0,5,0,8,-7,-5,-3,8,1,0,-1,-1,-1,-1,1,2,-1
KR_6749551944,420,-1,12,-9,-9,0,1,1,-5,6,1,-1,3,2,-2,3,1,-1,1,0,0,-11,12,4,-7,3,2,0,0,-1,0,0,-1,5,-1
KR_6718508023,420,0,34,-4,6,1,2,3,-2,2,0,0,3,3,6,0,6,1,0,1,0,5,-46,-1,-7,8,21,0,0,-1,-1,1,-1,4,-1
KR_6733998516,440,-3,-42,-32,-2,-4,4,0,-7,8,1,1,0,1,6,1,7,2,0,2,0,10,4,7,-8,1,-2,0,-1,1,1,-1,-1,6,-1
KR_6753563096,420,-5,-68,33,-8,-1,2,1,1,1,2,0,1,1,-10,12,2,2,1,3,-1,-9,160,-5,-4,9,-1,0,0,-1,1,-1,-1,5,-1
KR_6748612221,420,-4,-81,0,-8,-4,5,1,1,1,2,-3,4,1,-3,4,1,1,2,3,0,-4,0,-2,-2,4,-4,0,-1,-1,1,-1,-1,2,-1
KR_6763573705,440,-2,-85,-15,1,0,3,3,3,0,3,1,0,1,-3,6,3,0,0,0,0,2,5,1,-4,3,1,0,-2,-1,1,-1,1,4,-1
KR_6750367131,420,-4,-75,22,-5,-2,3,1,-3,5,2,5,2,7,-4,5,1,-1,2,1,0,-10,-114,-6,0,6,-3,0,0,1,-1,-1,1,3,-1
KR_6761374747,420,-1,-63,-16,5,-2,3,1,4,1,5,0,3,3,3,2,5,0,1,1,0,12,-9,-1,-6,7,4,0,0,-1,1,1,1,1,-1
KR_6765201470,420,0,0,24,0,-4,4,0,4,2,6,-2,5,3,4,2,6,-2,2,0,0,10,-13,-1,-5,6,6,0,0,-1,1,1,-1,4,-1
KR_6648856835,420,-1,-9,-21,3,-1,1,0,2,1,3,1,0,1,3,1,4,-2,2,0,0,6,-7,-2,-4,6,-5,0,0,-1,-1,0,1,3,-1
KR_6729806728,440,-3,-21,12,3,2,1,3,5,2,7,-2,2,0,-1,3,2,-1,1,0,0,5,4,3,-6,3,1,0,0,-1,0,-1,-1,2,-1
KR_6742153260,420,-4,-96,1,-10,-6,7,1,-5,7,2,2,1,3,-1,3,2,0,0,0,-1,-10,-23,-1,-3,4,-4,0,-2,-1,-1,-1,-1,6,-1
KR_6699365463,420,-4,-4,-39,-9,-6,6,0,-2,5,3,-1,4,3,-3,4,1,3,2,5,0,-2,-213,1,-4,3,1,0,-2,-1,-1,-1,-1,5,-1
KR_6726680415,420,-4,-11,-32,-14,-3,3,0,-3,3,0,-1,4,3,-5,6,1,-2,2,0,-1,-11,-2,2,-6,4,-1,0,1,-1,-1,1,-1,5,-1
KR_6688038221,420,-2,16,-32,-7,1,0,1,-3,4,1,-3,4,1,-2,5,3,0,1,1,0,-6,70,0,-6,6,2,0,-1,0,-1,-1,-1,0,-1
KR_6724828028,440,3,30,11,13,7,0,7,-1,5,4,1,1,2,1,0,1,5,2,7,0,12,37,-1,-1,2,-19,0,0,1,0,1,1,3,-1
KR_6744121037,440,-5,-56,10,-8,-3,6,3,-3,7,4,1,1,2,-1,4,3,-2,2,0,0,-4,11,11,-12,1,-6,0,-2,0,-1,-1,1,0,-1
KR_6743814230,440,0,-40,0,2,3,1,4,2,1,3,-3,5,2,1,3,4,-1,2,1,0,-1,-9,-1,-2,3,1,0,0,-1,1,-1,1,1,-1
KR_6693437469,420,-1,-81,2,-2,2,1,3,0,2,2,-1,3,2,-3,3,0,0,1,1,0,-1,-6,-3,-3,6,1,0,0,1,-1,-1,-1,4,-1
KR_6725100612,420,-4,-18,-30,-7,-1,1,0,-1,3,2,-3,5,2,-2,3,1,0,0,0,0,-3,3,2,-6,4,-5,0,0,-1,-1,0,1,2,-1
KR_6754239365,420,0,-19,-35,-6,-3,4,1,-3,5,2,0,2,2,1,2,3,-1,3,2,0,0,-212,3,-6,3,1,0,-1,-1,1,-1,-1,6,-1
KR_6750977535,420,-1,-35,-20,1,1,2,3,1,2,3,-1,1,0,-2,3,1,2,2,4,0,5,-24,3,-10,7,-3,0,0,-1,-1,0,-1,4,-1
KR_6754337378,440,-2,-20,0,-13,-1,2,1,0,3,3,-1,1,0,-10,10,0,-1,1,0,0,-16,-5,2,-3,1,1,0,-1,-1,-1,-1,-1,2,-1
KR_6728848950,420,2,73,0,0,2,3,5,0,3,3,3,0,3,-6,7,1,1,1,2,2,4,-4,2,-6,4,-5,0,0,0,0,0,1,0,-1
KR_6718367604,420,1,-49,-14,5,0,1,1,6,1,7,3,1,4,-4,9,5,0,1,1,0,-2,-44,-4,-4,8,19,0,-1,1,1,-1,-1,2,-1
KR_6741845959,420,-3,24,-21,-2,-1,4,3,-3,4,1,-1,1,0,4,0,4,-1,2,1,0,-3,6,4,-9,5,-3,0,-1,1,-1,-1,-1,2,-1
KR_6737383167,420,3,-10,1,2,-1,2,1,1,1,2,1,1,2,1,0,1,0,0,0,0,0,-128,2,-6,4,0,0,-2,-1,-1,-1,-1,1,-1
KR_6722940925,420,-1,-56,23,-2,-2,2,0,-3,5,2,2,1,3,1,3,4,0,0,0,0,7,11,2,-8,6,-5,0,-1,-1,1,-1,-1,6,-1
KR_6731372243,420,-5,-17,-17,-6,-2,4,2,2,3,5,-5,5,0,-1,1,0,0,0,0,0,-2,-3,-1,-3,4,-1,0,1,-1,0,-1,1,5,-1
KR_6696846216,420,-2,1,-28,-7,0,0,0,-11,13,2,2,0,2,1,1,2,1,0,1,-2,-7,1,1,-8,7,-2,0,-1,-1,-1,-1,1,3,-1
KR_6688535647,420,0,25,-7,-4,-1,2,1,5,2,7,-6,7,1,-1,5,4,-1,1,0,-2,0,1,-3,-4,7,4,0,0,0,1,0,1,0,-1
KR_6749107316,440,1,21,9,5,5,0,5,-2,5,3,-1,2,1,3,1,4,0,4,4,-1,-3,4,0,-3,3,2,0,1,1,-1,1,-1,1,-1
KR_6729383258,420,-4,-13,-28,-5,-6,7,1,1,0,1,1,1,2,-4,5,1,3,1,4,0,-7,39,1,-6,5,-15,0,-2,1,-1,-1,1,3,-1
KR_6746892588,420,-2,-68,-2,-3,-3,5,2,3,3,6,0,3,3,-2,3,1,-1,1,0,0,-1,-1,-4,-2,6,-1,0,0,1,1,0,-1,6,-1
KR_6697869525,420,1,-16,6,4,0,2,2,0,3,3,2,0,2,0,1,1,2,0,2,0,7,1,7,-10,3,-3,0,0,-1,1,0,1,5,-1
KR_6488751226,440,-2,31,-41,1,1,7,8,-2,3,1,2,2,4,1,1,2,-1,1,0,-1,5,16,6,-7,1,4,0,-1,0,0,-1,-1,0,-1
KR_6726488712,420,0,-15,8,-3,1,0,1,-1,3,2,-2,3,1,-1,4,3,0,1,1,0,0,-8,2,-7,5,3,0,0,-1,1,0,1,1,-1
KR_6602867615,420,-2,-105,5,5,0,2,2,-2,7,5,7,0,7,0,1,1,0,1,1,-1,8,-23,0,-4,4,-6,0,-1,1,1,-1,-1,2,-1
KR_6686137604,420,-3,-43,9,-14,-3,4,1,-4,7,3,-2,3,1,-2,2,0,-3,5,2,-1,-26,165,3,-8,5,0,0,-1,1,-1,1,-1,1,-1
KR_6763066525,420,-5,-55,4,-16,-2,2,0,0,1,1,-1,4,3,-4,5,1,-9,9,0,-2,-18,5,1,-5,4,-2,0,-2,-1,-1,-1,-1,1,-1
KR_6741413981,420,-9,-100,-36,-19,-6,7,1,-6,7,1,-3,4,1,-3,7,4,-1,1,0,-3,-11,-17,0,-9,9,-11,0,-1,-1,-1,-1,-1,4,-1
KR_6764111655,420,-2,-8,-24,-3,2,0,2,4,0,4,3,1,4,-6,7,1,-6,7,1,1,-5,-16,-2,-7,9,-6,0,-1,-1,-1,-1,1,3,-1
KR_6638733755,420,1,52,-4,-3,-1,2,1,-1,6,5,2,2,4,-2,4,2,-1,3,2,0,-13,-61,6,-7,1,4,0,0,-1,-1,0,-1,1,-1
KR_6418863194,420,-2,-24,5,-2,7,0,7,-5,9,4,-1,2,1,-4,7,3,1,0,1,0,-16,-2,-2,-4,6,0,0,2,-1,1,1,1,3,-1
KR_6407819731,420,-5,-10,-9,-13,-3,3,0,-1,3,2,1,2,3,-6,7,1,-4,5,1,2,-21,6,1,-7,6,1,0,-1,-1,-1,-1,1,4,-1
KR_6740895395,420,0,65,-41,2,3,1,4,-1,2,1,1,3,4,4,5,9,-5,6,1,0,-3,4,6,-9,3,-2,0,0,-1,1,0,1,4,-1
KR_6753122733,420,-1,-76,-36,7,7,2,9,-2,3,1,-4,4,0,6,1,7,0,2,2,0,25,14,3,-7,4,-5,0,1,1,-1,-1,1,5,-1
KR_6760080270,420,-1,-26,27,-5,-1,3,2,0,4,4,0,2,2,-1,2,1,-3,4,1,0,-7,15,-7,-3,10,-4,0,-2,-1,-1,-1,-1,2,-1
KR_6757622167,420,-2,31,-7,-3,3,1,4,-8,9,1,1,3,4,1,3,4,0,1,1,0,-10,0,1,-8,7,1,0,0,-1,-1,-1,1,1,-1
KR_6687937934,440,-1,-35,4,-5,-3,4,1,3,0,3,-1,2,1,-1,3,2,-3,6,3,-1,-1,0,-1,-3,4,1,0,-1,-1,-1,-1,-1,5,-1
KR_6753868612,420,2,-17,14,8,6,0,6,4,2,6,0,1,1,-3,6,3,1,2,3,0,4,-12,-1,-3,4,9,0,0,1,1,1,1,5,-1
KR_6694172677,420,-1,-21,-4,2,-1,3,2,-1,4,3,2,1,3,3,0,3,-1,1,0,0,7,-62,-5,-4,9,21,0,0,1,0,0,-1,6,-1
KR_6757818204,420,-1,-30,-29,1,-2,3,1,-2,6,4,-1,4,3,5,2,7,1,1,2,0,3,2,2,-6,4,-3,0,0,-1,1,0,-1,5,-1
KR_6732179301,420,-5,-13,-49,-7,-2,2,0,-1,4,3,-1,3,2,0,2,2,-3,3,0,0,-7,-14,-3,-5,8,-4,0,1,1,-1,1,1,5,-1
KR_6658605180,420,-2,-55,3,1,0,0,0,-3,3,0,-1,3,2,3,4,7,2,0,2,0,1,7,4,-7,3,-2,0,0,-1,1,0,-1,2,-1
KR_6734708474,420,0,12,12,-9,5,1,6,-9,10,1,-4,5,1,-2,4,2,1,0,1,0,-14,117,0,-6,6,-2,0,1,-1,-1,1,-1,3,-1
KR_6703242133,420,3,14,24,2,2,0,2,1,2,3,2,2,4,-2,2,0,-1,2,1,0,0,0,5,-8,3,6,0,-1,-1,1,1,1,2,-1
KR_6753119986,420,2,-29,8,1,-4,5,1,5,2,7,-1,3,2,-1,1,0,2,1,3,0,2,-15,-3,-6,9,4,0,-2,1,-1,-1,1,1,-1
KR_6716556854,420,-5,-26,8,-1,-2,4,2,0,4,4,0,0,0,0,1,1,1,1,2,0,-5,-115,-1,-4,5,-2,0,-1,-1,1,-1,1,1,-1
KR_6747483243,440,-1,12,4,-5,3,0,3,-2,4,2,-5,7,2,-1,2,1,0,1,1,0,-2,-21,0,-5,5,0,0,1,1,-1,1,1,1,-1
KR_6763314804,420,-2,-53,16,0,0,1,1,4,0,4,3,0,3,-10,10,0,3,2,5,-1,0,2,-2,-4,6,0,0,0,-1,1,0,-1,1,-1
KR_6748021534,420,-4,-37,-4,-19,-4,4,0,-3,3,0,-7,11,4,-4,4,0,-1,1,0,0,-13,-5,0,-3,3,-3,0,-3,-1,-1,-1,-1,5,-1
KR_6442792380,420,-2,-14,-21,-7,3,0,3,-3,4,1,-4,5,1,-3,4,1,0,0,0,0,-9,6,0,-6,6,-3,0,-1,1,-1,-1,1,6,-1
KR_6766138165,420,-3,-48,-10,1,1,0,1,0,4,4,0,2,2,0,2,2,0,2,2,0,-2,-21,6,-7,1,3,0,-1,1,-1,-1,1,2,-1
KR_6756605811,420,-9,-101,-24,-11,-2,6,4,-2,3,1,-2,3,1,-5,5,0,0,1,1,1,-5,5,-1,-6,7,-5,0,-2,-1,-1,-1,1,3,-1
KR_6749836591,420,0,65,16,-6,-1,1,0,-2,3,1,0,2,2,-3,5,2,0,2,2,1,-3,37,-4,-3,7,2,0,0,-1,1,0,1,6,-1
KR_6716352692,420,-2,-20,-19,-2,3,1,4,-3,6,3,-1,2,1,-1,1,0,0,0,0,0,-10,-17,-1,-9,10,1,0,-1,1,-1,-1,-1,3,-1
KR_6748367353,420,0,40,8,3,-1,1,0,2,0,2,-2,3,1,5,3,8,-1,1,0,0,0,116,1,-7,6,-1,0,0,1,-1,-1,-1,5,-1
KR_6752153525,420,-2,-47,-4,-1,0,2,2,1,1,2,1,1,2,-2,3,1,-1,1,0,0,-3,2,0,-7,7,-2,0,0,1,1,0,-1,3,-1
KR_6753056025,420,0,48,-12,-2,-2,2,0,-1,1,0,-2,4,2,4,0,4,-1,2,1,0,2,21,2,-7,5,1,0,2,1,1,1,1,3,-1
KR_6754865274,420,-3,-23,12,-6,0,1,1,0,3,3,-1,3,2,-4,6,2,-1,1,0,0,-3,3,-2,-3,5,2,0,0,0,0,-1,-1,0,-1
KR_6705043570,420,-2,-19,-8,-5,-3,4,1,1,6,7,-2,5,3,-2,4,2,1,1,2,0,-2,2,0,-7,7,-4,0,0,0,1,-1,1,0,-1
KR_6702432657,420,-3,-38,10,-13,-2,4,2,1,1,2,-2,4,2,-10,10,0,0,0,0,-3,-22,-23,-1,-4,5,0,0,-2,1,-1,-1,-1,5,-1
KR_6729578824,420,3,49,2,3,-1,2,1,2,0,2,1,3,4,3,1,4,-2,2,0,0,7,-8,-5,-2,7,4,0,0,1,-1,0,1,6,-1
KR_6762458061,420,-3,53,-19,-4,-1,4,3,-2,9,7,-1,3,2,-2,5,3,2,0,2,1,-1,10,4,-10,6,-2,0,0,-1,-1,-1,1,3,-1
KR_6662800961,420,2,48,16,0,0,3,3,-1,6,5,0,2,2,0,2,2,1,3,4,1,-3,6,-1,-4,5,1,0,0,1,-1,0,1,3,-1
KR_6753714361,420,-2,38,-8,-10,-3,6,3,1,2,3,-1,3,2,-1,5,4,-6,6,0,0,-12,-341,0,-3,3,3,0,-1,-1,1,-1,1,3,-1
KR_6757495731,420,5,13,11,9,2,0,2,3,1,4,3,0,3,0,3,3,1,0,1,0,0,-60,3,-5,2,0,0,0,1,1,0,1,1,-1
KR_6652404076,420,1,-20,31,-2,2,1,3,-1,4,3,1,3,4,-6,6,0,2,0,2,0,-3,3,-1,-6,7,-7,0,-1,-1,-1,-1,1,2,-1
KR_6667828886,420,-3,-4,-43,-8,2,0,2,-2,4,2,-9,9,0,1,4,5,0,1,1,-1,-7,5,-2,-3,5,-1,0,-1,-1,-1,-1,-1,6,-1
KR_6726177800,420,-3,-79,0,1,-1,2,1,-5,8,3,7,1,8,-1,1,0,1,0,1,-1,5,3,-2,-5,7,-1,0,-2,-1,-1,-1,-1,3,-1
KR_6766034383,420,-3,-99,0,-2,4,2,6,-4,6,2,-3,3,0,-1,3,2,2,0,2,0,-7,-42,-1,-1,2,10,0,-1,0,-1,-1,-1,0,-1
KR_6757522076,420,0,14,11,-1,2,2,4,-1,2,1,-5,5,0,2,2,4,1,1,2,0,-3,-32,-1,-3,4,-3,0,0,1,-1,0,-1,5,-1
KR_6728144479,420,-1,1,-15,-8,-1,2,1,-5,6,1,0,2,2,-1,4,3,-1,2,1,0,-12,-24,0,-6,6,1,0,0,-1,0,0,-1,2,-1
KR_6652655463,420,0,-6,0,-4,-1,2,1,-2,5,3,2,4,6,-1,2,1,-2,2,0,0,-11,-8,5,-7,2,-4,0,0,-1,1,1,-1,4,-1
KR_6735990992,420,-6,-73,-9,-11,-2,3,1,-2,4,2,1,1,2,-5,5,0,-3,3,0,-1,-15,2,3,-5,2,-3,0,-1,-1,1,-1,-1,4,-1
KR_6729679259,420,-3,8,-1,-10,-2,4,2,-5,6,1,-1,3,2,-2,4,2,0,0,0,-2,-19,7,-1,-4,5,-2,0,1,-1,1,1,-1,3,-1
KR_6747497083,420,-3,10,-12,-9,-4,6,2,-1,2,1,-2,3,1,-2,2,0,0,2,2,0,-13,-177,0,-8,8,3,0,1,-1,1,1,-1,4,-1
KR_6760066284,420,-2,-62,-47,-9,0,0,0,-1,3,2,-6,6,0,-4,4,0,2,0,2,0,-2,-1,-1,-4,5,1,0,0,-1,-1,-1,-1,2,-1
KR_6761083719,420,3,22,8,2,-4,4,0,-1,3,2,4,0,4,2,3,5,1,1,2,0,-1,5,2,-7,5,0,0,0,1,1,1,1,6,-1
KR_6685453769,420,0,-5,-9,-1,2,1,3,1,2,3,-8,8,0,3,0,3,1,1,2,0,3,-26,2,-6,4,19,0,-1,1,-1,-1,-1,6,-1
KR_6728729197,440,-4,-31,-21,-4,1,0,1,1,1,2,-6,6,0,0,0,0,0,2,2,0,-3,140,0,-5,5,1,0,0,-1,1,1,1,2,-1
KR_6716179679,420,-2,-4,-27,-7,-1,3,2,-2,5,3,0,2,2,-1,2,1,-3,4,1,0,-3,20,-4,-3,7,-6,0,0,-1,-1,-1,1,4,-1
KR_6684753424,440,-5,-54,-8,-11,-2,4,2,-2,3,1,0,3,3,2,0,2,-9,9,0,0,-9,-20,1,-5,4,-3,0,-1,1,1,-1,-1,5,-1
KR_6760299711,420,-1,-41,-8,4,-3,4,1,4,1,5,2,0,2,-1,2,1,2,0,2,0,18,-5,-4,-6,10,7,0,1,1,-1,1,1,3,-1
KR_6759784821,420,-6,-67,-5,-16,-1,2,1,-2,5,3,-7,8,1,-2,4,2,-4,6,2,0,-17,5,-3,-2,5,-1,0,-1,-1,0,-1,-1,2,-1
KR_6761453116,440,-5,5,-44,-11,3,1,4,-3,4,1,-8,9,1,-2,5,3,-1,1,0,4,-8,20,-7,-1,8,-4,0,-1,1,1,-1,1,5,-1
KR_6752480590,420,2,29,-7,6,4,1,5,1,1,2,0,1,1,0,3,3,1,3,4,1,10,-16,-1,-4,5,0,0,0,1,-1,0,1,4,-1
KR_6745613529,420,-4,-46,-20,-15,-4,4,0,-2,6,4,-3,3,0,-3,5,2,-3,3,0,-2,-19,-8,-3,-2,5,2,0,-2,1,-1,-1,-1,2,-1
KR_6759201866,420,-1,11,17,-2,2,0,2,0,1,1,-2,3,1,1,2,3,-3,5,2,0,1,130,4,-6,2,1,0,0,-1,1,0,1,5,-1
KR_6763281293,440,-4,-31,-40,-5,-3,5,2,-3,4,1,-2,2,0,-1,3,2,4,0,4,0,-6,3,0,-5,5,3,0,-1,-1,-1,-1,1,6,-1
KR_6724579456,420,0,-68,0,0,1,2,3,1,1,2,-3,8,5,0,3,3,1,0,1,0,6,-18,-1,-6,7,-2,0,-4,-1,-1,-1,1,1,-1
KR_6763824116,420,-4,-20,-16,-9,3,1,4,-3,6,3,-1,3,2,-2,3,1,-6,6,0,0,-11,2,6,-7,1,-5,0,-1,-1,1,-1,1,1,-1
KR_6764929373,420,2,-74,19,-2,-2,4,2,-3,4,1,5,0,5,-3,4,1,1,0,1,0,-6,-8,-4,-3,7,3,0,-2,1,-1,-1,1,3,-1
KR_6764260480,440,-1,0,-3,-4,2,0,2,-1,2,1,-4,4,0,2,2,4,-3,4,1,0,-7,-6,1,-7,6,-4,0,0,-1,-1,0,1,4,-1
KR_6738109357,420,-4,-56,-32,-4,3,1,4,-3,3,0,1,1,2,-2,3,1,-3,3,0,0,-3,21,1,-6,5,-1,0,-2,-1,-1,-1,-1,3,-1
KR_6725391732,420,-1,-8,-28,-6,-2,6,4,0,5,5,2,1,3,-4,7,3,-2,3,1,-1,-8,-10,1,-6,5,2,0,-1,-1,1,-1,1,4,-1
KR_6715136540,420,-1,-11,17,-2,-3,6,3,-1,5,4,1,2,3,0,2,2,1,1,2,0,-1,-9,-1,-5,6,1,0,1,1,-1,1,-1,4,-1
KR_6712728504,420,2,-73,0,6,-3,4,1,5,2,7,3,1,4,1,2,3,0,1,1,0,12,21,4,-10,6,3,0,1,0,1,-1,-1,0,-1
KR_6716031340,420,4,-34,12,10,3,1,4,2,2,4,2,2,4,1,4,5,2,3,5,0,6,6,-4,-2,6,-6,0,0,-1,1,0,-1,1,-1
KR_6652436679,420,0,-65,25,-2,-3,3,0,-1,2,1,1,2,3,4,1,5,-3,3,0,0,-6,-67,0,-7,7,-3,0,-1,1,-1,-1,1,3,-1
KR_6759650680,420,0,21,45,-6,-2,6,4,2,2,4,-4,9,5,-4,5,1,2,1,3,-1,2,3,-4,-3,7,-1,0,0,-1,1,1,-1,6,-1
KR_6716450787,420,1,35,-12,3,6,0,6,1,5,6,2,0,2,-6,7,1,0,1,1,0,-2,-20,1,-4,3,-3,0,1,0,0,1,-1,0,-1
KR_6656904444,420,-7,-130,-23,-10,-4,5,1,2,1,3,-3,4,1,-1,5,4,-4,4,0,0,-4,-11,-4,-2,6,1,0,-2,-1,-1,-1,-1,5,-1
KR_6751332486,420,1,-63,51,-2,0,1,1,1,0,1,1,2,3,-5,5,0,1,0,1,-2,0,2,3,-9,6,-3,0,-1,1,-1,-1,-1,3,-1
KR_6683424198,420,0,-22,16,-6,-3,3,0,-2,2,0,2,2,4,-1,3,2,-2,2,0,-1,-4,-13,-1,-5,6,-8,0,-1,1,-1,-1,-1,6,-1
KR_6718309341,420,-1,-65,11,-5,-4,4,0,1,2,3,0,2,2,-3,3,0,1,0,1,0,-6,-3,-1,-5,6,-3,0,0,-1,-1,0,1,2,-1
KR_6759166192,440,-4,-8,-18,-10,4,3,7,0,2,2,-7,8,1,-7,8,1,0,0,0,0,-13,-239,-3,-3,6,-2,0,1,-1,-1,1,1,4,-1
KR_6741925062,440,-6,-102,-9,-6,-1,3,2,-5,6,1,-2,2,0,-1,3,2,3,0,3,0,-14,-8,0,-5,5,3,0,-3,1,-1,-1,-1,3,-1
KR_6765365586,420,-2,-49,-11,-4,-1,2,1,4,0,4,0,3,3,-4,4,0,-3,3,0,0,1,-3,3,-9,6,-2,0,0,-1,-1,-1,1,6,-1
KR_6716365501,420,-7,-91,-12,-16,-6,6,0,-4,4,0,-4,5,1,0,2,2,-2,4,2,0,-14,-9,-1,-4,5,-4,0,-2,-1,-1,-1,-1,6,-1
KR_6742212406,420,-2,6,-16,1,1,0,1,-3,5,2,-2,2,0,4,2,6,1,0,1,1,5,-5,3,-5,2,0,0,0,1,-1,0,1,6,-1
KR_6759222371,420,1,-3,3,10,2,3,5,-2,3,1,2,4,6,7,0,7,1,1,2,0,7,2,0,-6,6,0,0,0,1,0,1,-1,3,-1
KR_6720394665,420,-1,19,28,0,-1,2,1,-4,5,1,6,0,6,-2,5,3,1,2,3,0,-4,-37,-2,-7,9,19,0,3,-1,1,1,1,5,-1
KR_6738681782,420,-9,-147,-43,-20,-5,5,0,-3,6,3,-6,8,2,-5,8,3,-1,3,2,0,-12,-18,-3,-2,5,-1,0,-3,-1,-1,-1,1,6,-1
KR_6706985260,420,-1,46,7,-7,4,1,5,-5,8,3,3,1,4,-9,10,1,0,1,1,0,-22,26,0,-6,6,-1,0,0,-1,-1,0,1,2,-1
KR_6765629457,420,-3,-64,18,-6,0,1,1,1,2,3,1,1,2,-6,7,1,-2,2,0,0,-11,125,-1,-6,7,-9,0,0,1,1,1,1,6,-1
KR_6761055644,420,0,-49,6,2,3,0,3,3,2,5,-5,5,0,-1,2,1,2,0,2,0,1,10,2,-4,2,5,0,1,1,0,1,1,3,-1
KR_6764107730,420,-2,-25,4,-6,1,0,1,3,3,6,-1,4,3,-7,10,3,-2,3,1,1,-5,-32,-7,-5,12,-3,0,-1,1,1,-1,-1,6,-1
KR_6710364586,420,0,-14,-4,1,2,1,3,2,4,6,-3,6,3,-2,3,1,2,0,2,0,-1,11,1,-6,5,-3,0,-1,-1,1,-1,-1,2,-1
KR_6747377542,420,2,65,16,2,-1,1,0,2,1,3,4,1,5,0,2,2,-3,6,3,0,2,-5,-1,-9,10,-3,0,1,-1,1,1,1,1,-1
KR_6751632837,440,0,-10,-20,0,-5,5,0,0,2,2,3,1,4,2,2,4,0,1,1,0,0,2,5,-8,3,-5,0,0,1,-1,-1,-1,1,-1
KR_6615415581,420,-4,-30,-13,-13,-4,4,0,0,2,2,-4,4,0,-3,5,2,-2,2,0,-1,-20,-8,0,-5,5,2,0,0,1,1,0,-1,2,-1
KR_6670188172,420,-1,-28,-27,0,-2,4,2,1,2,3,-1,4,3,3,3,6,-1,1,0,1,4,21,0,-4,4,-7,0,0,-1,1,0,1,6,-1
KR_6760444142,420,-1,-4,-4,-4,1,2,3,-3,4,1,-2,2,0,0,1,1,0,0,0,0,-1,17,-2,-4,6,-9,0,1,-1,1,1,-1,6,-1
KR_6654094049,420,-1,-66,-20,-2,-2,5,3,0,2,2,3,2,5,-3,5,2,0,3,3,0,0,117,-1,-4,5,1,0,-1,-1,1,-1,-1,6,-1
KR_6703007055,420,2,-37,0,3,-2,4,2,2,4,6,-1,2,1,7,0,7,-3,3,0,2,13,1,2,-10,8,-1,0,-1,1,-1,-1,1,6,-1
KR_6658734475,440,-5,-39,-38,-8,5,1,6,-2,6,4,-5,6,1,-6,7,1,0,1,1,0,-7,-1,-4,-2,6,1,0,-2,-1,-1,-1,1,5,-1
KR_6702272919,420,3,-14,-8,5,-3,4,1,3,0,3,5,1,6,1,3,4,-1,2,1,0,9,-119,-2,-3,5,2,0,-1,1,-1,-1,1,5,-1
KR_6273555367,420,0,24,16,3,-1,2,1,1,3,4,-1,1,0,0,1,1,4,0,4,0,7,12,-1,-6,7,-4,0,0,1,-1,-1,1,5,-1
KR_6644742759,420,-4,-35,-37,-9,-2,2,0,-4,6,2,0,0,0,-3,5,2,0,0,0,0,-9,7,5,-8,3,0,0,-1,-1,-1,-1,-1,4,-1
KR_6739231676,420,0,-23,19,7,0,2,2,-1,3,2,6,3,9,4,2,6,-2,2,0,0,10,-7,6,-6,0,1,0,2,-1,1,1,-1,6,-1
KR_6758744856,420,-1,-24,39,-6,-1,2,1,-1,3,2,-3,4,1,1,4,5,-2,3,1,0,-6,0,0,-7,7,1,0,0,-1,1,0,1,6,-1
KR_6678859159,420,-5,-114,-35,-10,-1,1,0,-10,11,1,3,0,3,2,4,6,-4,4,0,0,-9,12,0,-4,4,-5,0,-2,-1,-1,-1,1,1,-1
KR_6654925523,420,-1,-49,8,-6,-3,4,1,1,5,6,-3,3,0,0,3,3,-1,1,0,0,0,0,3,-5,2,-2,0,-4,-1,-1,-1,-1,3,-1
KR_6750503101,420,-1,70,41,-12,-2,4,2,-1,2,1,-2,4,2,-5,6,1,-2,2,0,0,-24,-24,0,-3,3,0,0,0,1,-1,-1,-1,1,-1
KR_6505957418,420,-3,-51,-16,-7,-1,2,1,0,3,3,-5,6,1,-1,2,1,0,0,0,0,-12,4,0,-2,2,2,0,0,1,-1,0,-1,6,-1
KR_6763555133,420,-1,-26,-30,-4,-1,2,1,1,4,5,-4,5,1,0,2,2,0,1,1,-1,-5,-6,-3,-3,6,2,0,-1,1,-1,-1,-1,4,-1
KR_6747014265,420,-5,-66,-12,-9,-2,3,1,-7,9,2,1,3,4,0,2,2,-1,1,0,0,-10,-22,0,-8,8,-8,0,-2,0,-1,-1,-1,0,-1
KR_6738095679,420,-1,45,20,3,-2,3,1,0,2,2,1,1,2,2,0,2,2,1,3,0,12,-16,-1,-4,5,9,0,0,-1,1,0,-1,2,-1
KR_6761856166,440,-1,-53,37,-7,-6,6,0,5,0,5,-1,3,2,-1,2,1,-4,4,0,0,-3,2,2,-4,2,-3,0,0,1,-1,-1,-1,1,-1
KR_6753905375,420,-1,-38,-12,2,2,1,3,-3,5,2,5,1,6,-1,4,3,-1,1,0,0,-1,-6,-1,-6,7,2,0,-1,1,1,-1,1,1,-1
KR_6689050011,420,0,48,7,2,0,2,2,-3,6,3,0,4,4,3,1,4,2,0,2,0,-5,-7,-4,-1,5,5,0,-1,1,-1,-1,1,5,-1
KR_6757157840,420,-2,-87,2,-5,-1,3,2,-3,5,2,-1,2,1,0,2,2,0,1,1,0,-11,0,0,-6,6,-2,0,-1,-1,1,-1,1,6,-1
KR_6762271770,420,-2,6,-17,-4,0,0,0,1,0,1,-1,2,1,0,2,2,-4,4,0,0,-3,2,0,-5,5,-3,0,-1,1,-1,-1,-1,3,-1
KR_6743921856,420,-5,-40,-16,-15,1,2,3,-1,2,1,0,3,3,-10,10,0,-5,5,0,0,-15,-6,-1,-7,8,-5,0,-2,1,-1,-1,1,6,-1
KR_6760620407,420,-2,12,-52,2,-1,3,2,2,3,5,-1,2,1,3,1,4,-1,2,1,0,1,5,4,-8,4,0,0,0,-1,1,1,1,3,-1
KR_6762900721,420,-1,-25,-4,1,1,1,2,-3,4,1,1,1,2,4,1,5,-2,2,0,0,-4,4,0,-5,5,-1,0,0,-1,1,0,-1,4,-1
KR_6738663493,420,0,29,-12,5,1,2,3,3,1,4,0,3,3,1,5,6,0,0,0,0,5,-1,-1,-9,10,-1,0,0,-1,1,0,-1,1,-1
KR_6760604437,420,-2,-100,-22,-11,-7,7,0,0,1,1,-4,5,1,-1,6,5,1,0,1,-1,3,0,-1,-4,5,1,0,-2,-1,-1,-1,-1,1,-1
KR_6731552516,420,-4,-37,9,-10,-3,3,0,-4,5,1,-1,2,1,-2,4,2,0,1,1,0,-18,-213,-3,-4,7,-1,0,0,-1,1,-1,-1,4,-1
KR_6737370134,420,2,35,16,2,2,0,2,-1,2,1,0,2,2,-3,7,4,4,2,6,0,-3,-193,4,-8,4,0,0,0,-1,1,0,1,6,-1
KR_6763272217,420,0,80,7,-5,1,0,1,-1,4,3,-2,5,3,-3,5,2,0,1,1,0,-9,-2,-3,-2,5,-5,0,1,1,0,1,1,5,-1
KR_6749078839,420,-1,1,13,0,-2,5,3,1,5,6,0,2,2,1,0,1,0,2,2,0,0,19,3,-6,3,2,0,1,0,1,1,1,0,-1
KR_6751470343,420,2,102,5,4,0,2,2,1,2,3,1,2,3,2,2,4,0,2,2,0,2,0,3,-5,2,-1,0,3,-1,1,1,1,1,-1
KR_6763418254,420,-1,8,7,-4,1,2,3,0,0,0,-5,6,1,-3,8,5,3,1,4,0,-1,5,3,-9,6,-4,0,1,-1,1,1,-1,4,-1
KR_6752059980,440,-4,-19,20,-4,-2,5,3,4,1,5,3,4,7,-7,9,2,-2,3,1,-2,-3,-8,0,-5,5,0,0,0,-1,1,-1,-1,1,-1
KR_6683689101,420,-2,20,-8,-3,2,1,3,-3,3,0,2,0,2,-5,5,0,1,0,1,0,-9,200,0,-4,4,-5,0,-1,-1,1,-1,1,5,-1
KR_6765529814,420,0,0,1,6,7,1,8,-1,4,3,-5,6,1,5,4,9,0,1,1,0,1,-1,-4,-3,7,-1,0,1,1,1,1,1,6,-1
KR_6634970611,420,0,5,-20,2,2,0,2,-4,6,2,-2,3,1,6,0,6,0,1,1,1,10,5,2,-7,5,0,0,0,-1,1,0,1,3,-1
KR_6753121621,420,-1,-19,44,-2,2,0,2,-1,2,1,-3,4,1,-1,1,0,1,3,4,0,-6,-7,-2,-5,7,-3,0,0,1,-1,0,1,6,-1
KR_6760956835,420,-5,-83,-40,-19,-4,5,1,-4,5,1,-1,3,2,-8,8,0,-2,3,1,0,-22,-41,1,-5,4,15,0,-4,-1,-1,-1,-1,1,-1
KR_6759815175,420,1,4,-10,7,0,1,1,4,0,4,-1,4,3,3,2,5,1,2,3,0,9,34,-2,-4,6,-7,0,1,0,1,1,1,0,-1
KR_6754462286,420,4,57,28,2,1,1,2,3,2,5,-1,1,0,-1,6,5,0,1,1,-1,0,17,-6,-7,13,-1,0,0,-1,1,1,-1,6,-1
KR_6739210687,420,-4,-45,9,-12,-5,6,1,-4,6,2,-1,3,2,-3,4,1,1,1,2,0,-6,-4,-3,-5,8,1,0,-1,1,-1,-1,1,2,-1
KR_6672578622,420,1,43,-33,-2,1,1,2,3,2,5,-4,4,0,-2,4,2,0,1,1,0,-1,-4,-3,-3,6,3,0,0,-1,-1,1,-1,2,-1
KR_6762223653,420,-2,-42,-47,-6,-1,1,0,0,4,4,-1,5,4,1,1,2,-5,5,0,0,-5,8,2,-6,4,0,0,0,-1,0,0,1,3,-1
KR_6755654879,420,-1,-29,-15,-7,0,0,0,-3,4,1,0,2,2,-2,2,0,-2,2,0,0,-3,-14,1,-10,9,-1,0,0,1,-1,0,-1,1,-1
KR_6745286076,420,-4,-28,-43,-7,-2,2,0,3,1,4,-3,4,1,-5,6,1,0,0,0,0,-6,-17,0,-5,5,0,0,-1,-1,-1,-1,-1,6,-1
KR_6696778600,420,1,45,-12,-5,-1,2,1,-3,6,3,0,3,3,-1,1,0,0,0,0,0,-2,2,5,-8,3,-3,0,-1,-1,-1,1,1,2,-1
KR_6743965685,420,0,-32,-12,2,0,0,0,-1,2,1,2,4,6,1,0,1,0,1,1,0,0,-10,-5,-5,10,-5,0,0,-1,-1,0,-1,2,-1
KR_6764897846,420,-2,-38,-32,-5,-4,5,1,4,1,5,0,3,3,-3,4,1,-2,4,2,0,2,3,-8,-3,11,0,0,-2,-1,-1,-1,1,4,-1
KR_6705407166,440,-1,-71,-12,1,-1,4,3,-2,2,0,-2,2,0,5,0,5,1,0,1,0,11,22,0,-2,2,1,0,-1,1,-1,-1,-1,3,-1
KR_6634072681,420,-3,-55,28,-1,-3,3,0,-5,6,1,3,2,5,4,4,8,0,1,1,0,0,4,-3,-3,6,-3,0,-2,1,-1,-1,1,3,-1
KR_6765577872,420,-5,-94,-23,-17,-5,7,2,-2,2,0,-4,5,1,-6,7,1,0,1,1,0,-11,2,-4,-3,7,0,0,-1,-1,-1,-1,-1,1,-1
KR_6632597895,420,-1,13,7,-7,0,0,0,-6,8,2,-1,2,1,1,1,2,-1,2,1,0,-8,-6,-3,-5,8,-2,0,0,-1,1,0,-1,3,-1
KR_6760908265,420,1,-32,22,1,-3,4,1,0,3,3,2,2,4,-4,5,1,6,0,6,0,0,-5,1,-5,4,3,0,1,1,1,1,-1,6,-1
KR_6762449061,420,-1,17,-5,1,1,2,3,-1,2,1,-1,1,0,1,2,3,1,0,1,0,-2,3,-3,-5,8,-1,0,-1,-1,-1,-1,1,5,-1
KR_6630886751,420,1,-67,32,-4,1,1,2,-6,9,3,-3,8,5,3,0,3,1,0,1,1,-4,25,-3,-6,9,4,0,0,1,1,-1,1,5,-1
KR_6758704064,420,-1,8,-24,-2,-1,2,1,-1,2,1,0,2,2,3,1,4,-3,3,0,0,1,-1,1,-5,4,5,0,0,-1,-1,-1,1,4,-1
KR_6751188230,420,-6,-129,29,-13,-3,4,1,-1,3,2,-1,5,4,0,1,1,-8,9,1,0,-14,19,0,-4,4,-1,0,0,-1,1,-1,-1,5,-1
KR_6724644529,420,-3,39,-24,-12,3,0,3,0,2,2,-7,7,0,-3,4,1,-5,6,1,0,-10,-2,-2,-4,6,1,0,2,-1,1,1,-1,3,-1
KR_6752013949,440,-2,-49,12,-4,-1,1,0,-1,1,0,2,3,5,-4,5,1,0,2,2,0,-2,0,2,-4,2,-6,0,0,0,1,0,-1,0,-1
KR_6424586859,420,0,33,-1,3,-1,2,1,-2,2,0,3,2,5,1,2,3,2,0,2,0,0,14,1,-9,8,-3,0,1,-1,1,1,1,3,-1
KR_6663217218,420,-4,-86,-8,-2,-2,4,2,2,0,2,-1,3,2,0,3,3,-1,1,0,0,-5,-8,0,-4,4,5,0,-1,-1,-1,-1,1,6,-1
KR_6706691161,420,-1,-8,-44,-1,4,0,4,1,4,5,-7,10,3,0,1,1,1,0,1,-1,1,-38,0,-6,6,2,0,-3,-1,-1,-1,-1,4,-1
KR_6762769981,420,-2,-43,0,-7,-6,6,0,0,2,2,-3,3,0,-2,4,2,4,0,4,1,-3,0,0,-6,6,-1,0,-1,-1,1,-1,1,1,-1
KR_6752421193,420,-4,5,10,-6,-1,1,0,-5,6,1,-3,4,1,4,2,6,-1,1,0,-1,0,3,-2,-3,5,-2,0,-1,1,-1,-1,-1,4,-1
KR_6766028206,440,0,-49,-16,1,6,0,6,1,2,3,0,1,1,-6,6,0,0,1,1,0,-5,0,-3,-3,6,1,0,1,-1,1,1,1,5,-1
KR_6700528781,420,0,-59,5,-1,4,1,5,-4,4,0,-6,7,1,3,0,3,2,1,3,0,-3,-3,-2,-3,5,-1,0,1,1,-1,-1,1,1,-1
KR_6602988799,420,0,-17,6,-1,-4,5,1,1,5,6,0,3,3,0,4,4,2,1,3,0,-2,-14,-14,-3,17,4,0,1,-1,1,1,1,6,-1
KR_6762963124,420,-4,-14,6,-7,-1,3,2,0,3,3,-2,4,2,1,0,1,-5,5,0,0,-10,0,2,-7,5,-1,0,-2,-1,1,-1,1,1,-1
KR_6765650536,440,0,7,-25,-2,0,1,1,0,3,3,-8,9,1,5,3,8,1,1,2,0,5,3,-1,-4,5,1,0,0,-1,0,-1,-1,3,-1
KR_6759976262,440,-3,-51,36,-8,-3,3,0,-2,3,1,1,2,3,-1,2,1,-3,4,1,0,-12,3,-3,-4,7,7,0,-1,-1,1,-1,-1,1,-1
KR_6722335226,420,-1,-68,-8,-6,0,1,1,0,1,1,-4,4,0,-4,5,1,2,2,4,0,-9,52,2,-8,6,-3,0,-2,1,-1,-1,1,2,-1
KR_6725471175,420,-2,21,-6,-7,-2,5,3,5,1,6,-7,8,1,1,1,2,-4,4,0,-1,-3,-16,7,-8,1,0,0,-1,-1,-1,-1,-1,5,-1
KR_6727360473,420,1,34,-16,5,-1,1,0,1,4,5,-3,3,0,3,3,6,5,0,5,0,7,0,-3,-4,7,-1,0,1,-1,1,1,-1,6,-1
KR_6763890130,420,3,-41,-16,7,1,0,1,4,0,4,4,0,4,-3,7,4,1,1,2,0,0,9,2,-4,2,-2,0,0,-1,1,0,-1,1,-1
KR_6763975827,420,0,-14,-32,9,-1,3,2,2,2,4,5,0,5,1,2,3,2,4,6,2,20,-6,1,-5,4,2,0,0,-1,1,1,1,6,-1
KR_6683042981,420,0,-16,41,2,-3,3,0,1,2,3,5,0,5,-1,6,5,0,1,1,0,-2,23,-1,-5,6,0,0,1,1,1,1,1,3,-1
KR_6760406428,420,-1,-22,-10,-2,-1,5,4,-3,6,3,-4,5,1,5,2,7,1,1,2,1,-1,147,1,-5,4,0,0,0,-1,1,-1,1,3,-1
KR_6618098388,440,-3,-47,-18,-7,1,1,2,-2,8,6,-1,5,4,-3,6,3,-2,4,2,-1,-3,4,-3,-4,7,-3,0,0,-1,1,-1,-1,6,-1
KR_6688197742,440,-3,10,-19,-9,2,0,2,-4,5,1,-5,5,0,-3,4,1,1,0,1,-1,-7,-19,1,-3,2,-1,0,-2,0,1,-1,-1,0,-1
KR_6687045170,420,-2,-23,-28,0,-3,4,1,2,3,5,1,1,2,0,1,1,0,1,1,0,4,13,3,-6,3,0,0,0,-1,-1,0,1,3,-1
KR_6710149050,420,-2,-72,20,-11,0,3,3,0,1,1,-4,5,1,-4,5,1,-3,4,1,0,-7,-61,-3,-2,5,17,0,1,-1,-1,-1,-1,1,-1
