matchId,queueId,Diff_LV,Diff_CS,Diff_jglCS,Diff-K,Diff-K-top,K-WIN-top,K-LOSE-top,Diff-K-jug,K-WIN-jug,K-LOSE-jug,Diff-K-mid,K-WIN-mid,K-LOSE-mid,Diff-K-ad,K-WIN-ad,K-LOSE-ad,Diff-K-sup,K-WIN-sup,K-LOSE-sup,invadeKill,Diff-A,Diff_WARDplaced,Diff-ControlWARDplaced,LOSE_controlWARDPlaced,WIN_controlWARDPlaced,Diff_WARDkill,Diff_Inhibitor,Diff_TOWERkill,Diff_FirstDRAGON,Diff_FirstHERALD,Diff_Firsttower,Diff_FirstBLOOD,dragonType,result
KR_6765256623,440,-1,-106,-28,-2,0,1,1,2,1,3,-1,3,2,-3,4,1,0,1,1,0,5,-9,4,-8,4,1,0,-2,-1,-1,-1,-1,2,-1
KR_6757053354,420,2,37,-28,7,0,2,2,0,1,1,5,2,7,1,3,4,1,2,3,-1,9,3,6,-8,2,-3,0,1,-1,1,1,1,5,-1
KR_6670779549,420,1,48,-4,2,0,1,1,3,1,4,6,2,8,-8,9,1,1,1,2,0,1,26,3,-5,2,1,0,1,-1,-1,-1,-1,5,-1
KR_6745155509,420,-4,15,-5,-3,-2,3,1,-2,2,0,4,0,4,-1,5,4,-2,2,0,0,-4,50,-1,-3,4,-22,0,-2,1,-1,-1,1,1,-1
KR_6732061585,440,-7,-75,-37,-16,-2,2,0,-5,5,0,-6,6,0,-3,3,0,0,0,0,0,-11,-3,3,-4,1,-2,0,-2,-1,-1,-1,-1,6,-1
KR_6765341766,440,1,0,-12,0,2,1,3,-3,6,3,1,1,2,1,3,4,-1,3,2,0,-4,45,3,-6,3,-21,0,0,-1,1,1,-1,4,-1
KR_6693594661,420,-1,-2,-24,-3,-5,6,1,-4,7,3,1,2,3,1,0,1,4,0,4,0,-3,-6,-4,-3,7,0,0,-1,1,-1,-1,1,4,-1
KR_6731937519,420,-1,-37,16,2,-4,4,0,6,1,7,0,1,1,-1,1,0,1,3,4,0,7,6,1,-4,3,0,0,0,1,1,0,1,2,-1
KR_6728692264,420,-1,-3,-8,0,0,1,1,-1,4,3,1,4,5,1,2,3,-1,2,1,0,3,-44,1,-3,2,15,0,0,0,-1,-1,-1,0,-1
KR_6626117294,420,-2,-92,16,-1,0,1,1,2,1,3,-2,4,2,-1,7,6,0,1,1,0,2,3,-4,-5,9,3,0,0,-1,1,0,1,5,-1
KR_6578935677,420,-3,-24,2,-5,-1,1,0,-2,6,4,4,1,5,-3,6,3,-3,4,1,0,-5,47,5,-8,3,-36,0,1,-1,-1,1,1,1,-1
KR_6717287557,420,2,-34,16,8,-2,3,1,3,2,5,5,1,6,2,5,7,0,0,0,2,11,32,4,-8,4,-1,0,-1,-1,1,-1,1,5,-1
KR_6716317295,420,2,30,32,3,1,2,3,1,2,3,1,3,4,-1,5,4,1,1,2,2,0,5,-2,-4,6,1,0,2,1,1,1,1,5,-1
KR_6742250299,420,1,-87,-15,-1,-6,9,3,6,1,7,-2,2,0,1,1,2,0,2,2,-1,7,75,-5,-3,8,7,0,0,-1,-1,-1,-1,4,-1
KR_6758772674,420,0,9,2,-4,-3,5,2,-4,4,0,1,1,2,2,0,2,0,1,1,0,-1,125,0,-4,4,-7,0,-1,1,1,-1,-1,5,-1
KR_6753136653,420,2,29,-4,5,2,3,5,1,0,1,1,2,3,1,1,2,0,1,1,3,11,-5,0,-2,2,-1,0,0,-1,-1,0,1,5,-1
KR_6754282620,420,-3,3,-15,-10,-2,5,3,1,3,4,0,1,1,-9,10,1,0,1,1,0,-3,-285,3,-5,2,0,0,-3,0,-1,-1,1,0,-1
KR_6746173499,420,2,12,26,3,5,0,5,-1,2,1,2,0,2,-1,1,0,-2,2,0,0,-2,-25,1,-4,3,1,0,1,-1,1,1,1,5,-1
KR_6606047755,420,-2,0,0,-5,-3,4,1,0,2,2,-2,4,2,1,1,2,-1,1,0,1,-4,-5,-3,-3,6,-1,0,-1,1,1,1,1,4,-1
KR_6701928742,420,-3,-42,-13,1,-2,3,1,2,1,3,-2,2,0,1,2,3,2,0,2,0,2,2,-3,-3,6,-2,0,-1,-1,1,-1,-1,3,-1
KR_6751162854,420,1,-3,19,4,5,2,7,-1,2,1,1,1,2,-2,3,1,1,1,2,0,1,-4,-2,-3,5,2,0,1,1,1,1,-1,3,-1
KR_6694978812,420,-2,-3,-12,0,1,1,2,0,2,2,1,0,1,-4,6,2,2,1,3,0,-2,5,-3,-2,5,-2,0,-1,-1,0,-1,-1,1,-1
KR_6758023700,420,2,-3,8,2,1,2,3,2,1,3,1,3,4,-2,5,3,0,2,2,0,1,8,3,-4,1,-3,0,0,1,-1,0,1,4,-1
KR_6762306528,420,-2,-44,-39,-6,1,1,2,0,5,5,1,0,1,-7,7,0,-1,1,0,0,-9,8,-3,-2,5,-1,0,0,-1,1,0,-1,2,-1
KR_6206540485,420,-2,-37,-40,-7,-7,8,1,-4,4,0,1,1,2,-1,1,0,4,0,4,0,5,3,2,-6,4,-3,0,-1,1,-1,-1,-1,1,-1
KR_6759704519,420,0,-80,-1,1,-1,2,1,4,0,4,-3,3,0,0,2,2,1,3,4,0,2,54,0,-1,1,-1,0,0,0,0,0,-1,0,-1
KR_6765454690,420,-4,13,-19,-8,1,2,3,0,1,1,1,1,2,-8,14,6,-2,2,0,0,-9,-4,-1,-3,4,4,0,0,-1,1,-1,-1,6,-1
KR_6762732705,420,-1,-30,-4,-9,0,0,0,-3,4,1,-3,3,0,-2,2,0,-1,1,0,0,-10,6,-1,-3,4,0,0,-1,-1,-1,-1,-1,5,-1
KR_6744982125,420,-1,-53,11,-1,-1,1,0,3,2,5,-6,7,1,2,4,6,1,0,1,0,-3,16,0,-7,7,5,0,-1,0,-1,-1,-1,0,-1
KR_6755646170,420,0,-6,-7,3,5,0,5,0,5,5,2,3,5,-3,3,0,-1,2,1,0,-7,-1,-3,-4,7,3,0,-1,-1,-1,-1,-1,2,-1
KR_6715282320,420,-2,-51,-4,2,-2,3,1,0,3,3,-1,4,3,3,0,3,2,0,2,0,3,-32,4,-6,2,19,0,-1,1,-1,-1,1,2,-1
KR_6763959048,420,1,29,20,-2,1,2,3,1,1,2,-3,3,0,-1,1,0,0,1,1,-1,-1,0,-5,-3,8,2,0,0,-1,-1,0,-1,1,-1
KR_6697923152,420,-2,-39,11,0,-2,2,0,-4,5,1,5,1,6,2,3,5,-1,1,0,0,4,-12,5,-5,0,-6,0,-3,-1,1,-1,1,6,-1
KR_6731488219,420,-2,-27,-32,-7,2,1,3,0,0,0,0,1,1,-5,6,1,-4,4,0,0,-6,4,-1,0,1,1,0,-2,-1,-1,-1,-1,1,-1
KR_6707227521,420,2,-39,4,2,0,1,1,3,0,3,2,0,2,2,1,3,-5,5,0,0,0,0,3,-6,3,-4,0,0,-1,-1,-1,1,4,-1
KR_6762587910,420,-4,-56,19,-7,-4,4,0,-3,5,2,2,2,4,-2,3,1,0,0,0,0,-3,2,-2,-1,3,0,0,-1,-1,1,-1,-1,3,-1
KR_6655995955,420,-1,23,-16,4,-2,3,1,1,3,4,2,2,4,1,2,3,2,0,2,0,9,5,1,-2,1,-2,0,-1,-1,0,-1,-1,6,-1
KR_6734187378,420,-8,-108,-17,-14,-5,5,0,-3,3,0,-4,7,3,-1,2,1,-1,2,1,0,-10,5,-6,-2,8,0,0,-4,-1,-1,-1,-1,3,-1
KR_6611955596,420,-2,0,-12,-2,-4,4,0,0,2,2,0,2,2,1,5,6,1,0,1,0,0,4,4,-7,3,1,0,0,1,-1,-1,1,3,-1
KR_6714186835,420,0,2,4,5,6,2,8,4,2,6,-3,4,1,0,1,1,-2,4,2,-1,3,-3,-3,-4,7,1,0,0,1,0,1,-1,6,-1
KR_6696452054,420,0,49,15,-2,0,2,2,0,1,1,6,1,7,-4,7,3,-4,4,0,-1,-9,-7,0,-5,5,5,0,0,0,-1,0,-1,0,-1
KR_6620950797,420,-2,12,24,-6,-2,2,0,-4,6,2,2,0,2,0,2,2,-2,3,1,0,-10,-3,-3,-2,5,1,0,0,-1,1,0,-1,3,-1
KR_6680026416,420,-2,-7,-27,-6,0,1,1,-4,6,2,-4,5,1,2,1,3,0,0,0,0,0,-14,0,-4,4,1,0,-1,-1,-1,-1,1,1,-1
KR_6767246614,420,-4,-10,-44,-10,-4,4,0,-1,2,1,-3,3,0,0,2,2,-2,3,1,0,-7,384,-4,0,4,2,0,-1,-1,-1,-1,-1,1,-1
KR_6767029769,420,0,-43,7,-10,0,2,2,-3,5,2,-1,2,1,-6,9,3,0,2,2,0,-7,-36,-9,-4,13,22,0,1,1,1,1,-1,4,-1
KR_6644247045,420,-3,-23,-28,0,-1,1,0,0,3,3,1,3,4,1,3,4,-1,1,0,2,6,-5,-2,-4,6,0,0,0,-1,-1,0,1,4,-1
KR_6710514460,420,2,-14,13,-3,-2,3,1,6,1,7,1,2,3,-8,10,2,0,0,0,0,-12,124,-1,-6,7,0,0,-1,-1,1,-1,1,1,-1
KR_6635264574,420,0,25,-28,4,0,1,1,1,0,1,2,2,4,2,1,3,-1,2,1,0,11,-7,-6,-3,9,3,0,0,-1,-1,0,1,3,-1
KR_6741526992,420,-1,59,-5,0,4,1,5,-2,4,2,-2,2,0,0,1,1,0,0,0,0,0,1,-1,-4,5,0,0,1,-1,1,1,1,2,-1
KR_6752392039,420,-2,-46,-17,-4,-2,3,1,3,1,4,-3,7,4,-3,4,1,1,2,3,0,1,18,-5,-4,9,2,0,0,-1,-1,0,-1,2,-1
KR_6759215542,420,-2,-80,-11,3,2,0,2,1,2,3,1,6,7,0,3,3,-1,3,2,1,15,-6,-7,-2,9,1,0,-1,-1,1,1,1,5,-1
KR_6764123271,420,-4,-11,12,-17,-9,9,0,2,1,3,-3,3,0,-6,8,2,-1,2,1,0,-6,-10,-1,-4,5,4,0,-1,1,-1,-1,-1,1,-1
KR_6734855697,420,-5,-53,-32,-5,-3,4,1,1,1,2,-1,2,1,-2,4,2,0,2,2,0,1,-257,1,-3,2,-3,0,-1,-1,-1,-1,-1,6,-1
KR_6264239684,420,-1,-7,-7,-1,-4,4,0,0,1,1,0,2,2,1,2,3,2,0,2,0,0,-5,-2,-2,4,5,0,-1,1,-1,-1,1,5,-1
KR_6620737533,420,1,56,18,-1,1,2,3,-3,5,2,1,0,1,0,2,2,0,0,0,1,3,-125,-2,-4,6,1,0,0,-1,-1,0,1,3,-1
KR_6736737198,420,0,-31,11,3,5,2,7,0,0,0,-1,3,2,-1,1,0,0,1,1,0,8,1,5,-5,0,0,0,-1,-1,0,-1,1,2,-1
KR_6724677043,420,-4,-1,-17,-2,6,1,7,1,1,2,2,3,5,-9,9,0,-2,3,1,0,-3,-6,0,-3,3,0,0,-1,-1,1,-1,1,1,-1
KR_6641425696,420,-1,-21,-8,1,2,2,4,1,1,2,2,0,2,-2,3,1,-2,3,1,0,-1,-3,2,-6,4,0,0,1,-1,1,1,1,1,-1
KR_6722946428,420,2,-14,3,0,-2,2,0,0,1,1,0,3,3,2,0,2,0,0,0,0,-3,-6,4,-7,3,2,0,0,1,0,0,1,2,-1
KR_6699362174,420,-2,-11,-48,-6,-5,5,0,-7,7,0,3,0,3,0,1,1,3,0,3,0,7,-8,-5,-4,9,2,0,-1,1,-1,-1,-1,1,-1
KR_6726224780,440,-5,-92,-32,-14,2,0,2,-4,4,0,-7,7,0,-4,5,1,-1,2,1,0,-16,-5,-2,-8,10,2,0,-2,-1,-1,-1,-1,1,-1
KR_6767604419,420,-3,-10,-3,-7,-1,1,0,-3,3,0,-1,2,1,-2,4,2,0,0,0,0,-10,0,2,-4,2,1,0,0,1,-1,-1,-1,5,-1
KR_6767904751,420,-1,-72,4,-11,-6,6,0,0,2,2,-1,2,1,-3,4,1,-1,2,1,0,-5,5,-2,-3,5,-7,0,-1,-1,-1,-1,-1,6,-1
KR_6734909930,420,2,16,34,-1,0,1,1,-1,7,6,-3,3,0,2,0,2,1,0,1,1,-3,3,0,-5,5,-1,0,0,1,-1,1,1,6,-1
KR_6757768849,440,1,-134,73,-1,0,2,2,3,3,6,-5,6,1,1,0,1,0,3,3,-2,-9,2,3,-3,0,3,0,-1,1,1,1,-1,1,-1
KR_6761580887,420,0,-29,4,-5,0,3,3,-5,6,1,4,0,4,-4,4,0,0,1,1,-1,-15,-3,0,-2,2,-4,0,0,-1,-1,0,-1,2,-1
KR_6673279206,420,0,-33,40,-1,1,1,2,-1,2,1,-6,7,1,3,0,3,2,0,2,0,1,4,-3,-2,5,-1,0,-1,-1,-1,-1,1,5,-1
KR_6636283938,420,-3,-13,16,-3,-1,1,0,1,2,3,1,1,2,-2,3,1,-2,3,1,0,-3,-5,1,-3,2,-1,0,-2,1,-1,-1,1,3,-1
KR_6757005285,420,-5,2,-60,-2,-2,6,4,-1,1,0,2,1,3,0,4,4,-1,2,1,0,0,-7,-2,-2,4,5,0,-2,-1,-1,-1,-1,3,-1
KR_6725811228,420,-1,37,-30,3,-1,3,2,1,2,3,-1,3,2,4,2,6,0,1,1,-1,8,-77,1,-6,5,-4,0,0,-1,-1,0,-1,5,-1
KR_6618737101,440,-4,-169,12,-10,-2,3,1,-2,4,2,1,2,3,-6,8,2,-1,1,0,-1,-17,10,1,-4,3,-1,0,-1,0,-1,-1,1,0,-1
KR_6719658115,420,-3,9,25,-10,3,1,4,-2,5,3,-9,9,0,-2,3,1,0,0,0,0,-14,19,-4,-3,7,-2,0,-1,-1,0,-1,-1,1,-1
KR_6715713601,420,-2,-19,-5,-3,1,2,3,5,2,7,-6,6,0,-3,4,1,0,2,2,0,7,32,-3,-4,7,-5,0,1,-1,1,1,-1,5,-1
KR_6763897082,420,3,0,36,0,1,1,2,-2,3,1,3,1,4,-2,2,0,0,1,1,0,-9,36,-3,-3,6,-31,0,1,-1,0,1,1,4,-1
KR_6752340568,420,0,-17,8,-1,-4,4,0,-4,5,1,5,0,5,-1,7,6,3,0,3,0,4,3,0,-4,4,2,0,-2,1,-1,-1,-1,3,-1
KR_6753046499,440,-3,-86,-27,-11,3,1,4,0,2,2,-6,7,1,-8,11,3,0,3,3,0,-10,-4,1,-5,4,-3,0,-2,-1,-1,-1,-1,1,-1
KR_6740431842,440,-4,-52,-8,-11,-3,3,0,-3,3,0,-1,2,1,-6,7,1,2,1,3,0,-24,-10,-2,-3,5,-1,0,-1,1,0,-1,-1,1,-1
KR_6708818725,440,-5,-38,-12,-10,-1,1,0,0,0,0,-4,5,1,2,2,4,-7,7,0,0,-11,-27,9,-13,4,1,0,-1,0,0,-1,-1,0,-1
KR_6489571985,420,2,-13,-8,4,-2,2,0,5,1,6,0,1,1,-1,2,1,2,1,3,0,7,81,4,-7,3,-2,0,1,1,-1,-1,-1,4,-1
KR_6760583985,420,0,-44,-12,0,7,0,7,-3,4,1,-6,6,0,1,3,4,1,2,3,0,3,0,2,-6,4,-2,0,1,-1,1,1,1,5,-1
KR_6758971106,420,-2,-55,-9,-5,-6,7,1,1,3,4,3,1,4,-5,7,2,2,0,2,-1,-4,1,1,-2,1,-1,0,-2,-1,0,-1,-1,3,-1
KR_6753160497,420,-5,-34,-36,-13,-1,2,1,-5,6,1,-4,5,1,-1,2,1,-2,3,1,0,-3,-14,-2,-2,4,7,0,-1,-1,-1,-1,-1,1,-1
KR_6754651998,420,-2,-11,-19,-5,-2,5,3,4,0,4,-4,4,0,-1,4,3,-2,2,0,0,2,-30,1,-6,5,-5,0,-2,1,-1,-1,-1,3,-1
KR_6764114618,440,-2,54,2,-5,1,0,1,-1,3,2,-1,2,1,-2,3,1,-2,2,0,0,-4,40,2,-3,1,-3,0,0,-1,0,-1,1,3,-1
KR_6599716757,420,0,16,-4,-3,3,1,4,0,4,4,2,1,3,-5,6,1,-3,3,0,0,-8,2,-1,-3,4,-2,0,-2,1,-1,-1,-1,1,-1
KR_6755978285,420,-2,0,7,-5,-2,3,1,0,1,1,0,2,2,-1,4,3,-2,3,1,0,-4,13,0,-7,7,1,0,-1,-1,-1,-1,-1,3,-1
KR_6767372585,420,-1,7,-16,-6,-1,2,1,-1,2,1,4,3,7,-3,4,1,-5,5,0,0,-8,-2,-1,-5,6,-4,0,0,0,0,0,-1,0,-1
KR_6693232494,420,-1,2,-1,-7,-2,3,1,1,1,2,1,3,4,-12,15,3,5,1,6,-1,-8,6,-5,-3,8,0,0,-1,-1,-1,-1,-1,5,-1
KR_6726855433,420,-3,-56,-11,-6,0,1,1,-1,3,2,2,3,5,-5,6,1,-2,3,1,0,-2,-4,0,-2,2,-2,0,0,-1,0,-1,-1,3,-1
KR_6575079778,420,-2,-27,36,-13,-5,6,1,-6,9,3,-1,2,1,0,3,3,-1,3,2,-1,-6,6,-2,-3,5,-2,0,-1,1,1,-1,-1,2,-1
KR_6741344427,420,2,-19,-16,1,1,0,1,-1,4,3,1,2,3,-2,6,4,2,1,3,0,2,11,3,-8,5,-1,0,0,-1,-1,0,-1,2,-1
KR_6767262323,420,-7,-56,-59,-12,-5,5,0,-3,3,0,3,1,4,-3,6,3,-4,5,1,-1,-4,1,0,-4,4,-3,0,-3,-1,-1,-1,-1,5,-1
KR_6762728751,440,-2,-45,-15,-2,0,1,1,-1,3,2,-3,6,3,3,0,3,-1,1,0,-1,-1,3,0,-1,1,-1,0,-2,0,0,-1,-1,0,-1
KR_6736207218,420,3,32,-25,7,2,2,4,2,2,4,0,1,1,2,1,3,1,1,2,0,5,-6,-3,-1,4,1,0,1,-1,1,1,1,5,-1
KR_6610240989,420,-2,-64,2,0,-2,3,1,4,3,7,2,0,2,-3,3,0,-1,1,0,1,2,56,0,-4,4,-2,0,-2,1,-1,-1,1,3,-1
KR_6751906929,420,-4,-89,3,-7,-6,6,0,1,2,3,-4,4,0,2,0,2,0,2,2,0,-1,26,0,-1,1,0,0,-1,-1,1,-1,1,3,-1
KR_6748049685,420,-3,-25,-13,-2,3,3,6,-1,2,1,1,1,2,-2,2,0,-3,3,0,1,-8,-7,1,-5,4,2,0,0,-1,1,-1,1,4,-1
KR_6730274234,440,2,60,10,5,-1,4,3,3,1,4,2,2,4,-2,5,3,3,2,5,2,7,-15,-7,-6,13,5,0,1,1,-1,1,1,4,-1
KR_6766633075,420,-1,-49,4,-4,-2,3,1,0,2,2,0,3,3,1,0,1,-3,4,1,0,-1,6,1,-1,0,1,0,0,1,0,0,-1,6,-1
KR_6752109631,440,-1,-89,-4,-4,1,0,1,0,4,4,-1,5,4,-4,6,2,0,1,1,-1,-6,-2,-2,-1,3,-2,0,-2,-1,0,-1,-1,4,-1
KR_6663661545,420,-3,-39,-60,-6,4,1,5,1,2,3,-4,5,1,-5,7,2,-2,3,1,0,-4,12,-4,-3,7,-6,0,1,-1,0,1,-1,6,-1
KR_6757579762,420,-2,8,-8,0,0,2,2,-2,2,0,0,1,1,2,2,4,0,0,0,0,-3,3,1,-3,2,-4,0,-1,-1,1,-1,1,1,-1
KR_6765359196,420,3,2,31,2,0,1,1,1,3,4,5,0,5,-7,9,2,3,1,4,0,-1,29,4,-6,2,-7,0,-1,1,-1,-1,-1,4,-1
KR_6751009021,420,-2,31,-16,1,3,1,4,-5,6,1,4,1,5,-2,3,1,1,0,1,0,-2,-15,-4,-3,7,-3,0,1,-1,1,1,1,4,-1
KR_6751379807,440,2,66,51,0,3,2,5,-2,2,0,-2,3,1,2,2,4,-1,1,0,0,-6,-3,-5,-4,9,4,0,0,1,1,1,1,3,-1
KR_6762183693,440,-2,-116,-20,-2,-7,9,2,4,3,7,1,3,4,-1,1,0,1,1,2,0,6,-41,1,-3,2,14,0,-1,0,-1,-1,-1,0,-1
KR_6765203523,440,-5,-92,-16,-5,-2,3,1,2,0,2,-1,3,2,-3,5,2,-1,2,1,0,-2,-108,2,-2,0,-1,0,0,-1,1,-1,-1,3,-1
KR_6751873871,420,2,-17,18,2,-1,2,1,-4,5,1,1,0,1,5,0,5,1,0,1,0,1,17,-9,-3,12,5,0,0,-1,1,0,1,2,-1
KR_6755565265,420,0,28,-4,2,1,1,2,-2,4,2,1,2,3,-1,3,2,3,0,3,0,-4,-6,5,-7,2,3,0,0,-1,-1,0,1,6,-1
KR_6719185443,440,-2,-43,-4,1,-3,4,1,0,3,3,5,0,5,0,1,1,-1,3,2,0,1,-19,1,-3,2,-1,0,-2,1,-1,-1,1,3,-1
KR_6763255005,420,-3,-27,4,-12,0,3,3,0,1,1,0,1,1,-7,7,0,-5,5,0,0,-16,9,4,-5,1,-3,0,-3,0,-1,-1,-1,0,-1
KR_6756306183,420,-2,-25,12,-3,-3,4,1,2,0,2,-5,6,1,3,0,3,0,1,1,0,11,61,-4,-2,6,0,0,-1,-1,-1,-1,-1,2,-1
KR_6759688404,420,-1,-16,35,3,4,0,4,-1,2,1,0,3,3,0,2,2,0,2,2,0,0,4,6,-8,2,-4,0,-1,-1,1,-1,1,1,-1
KR_6725496008,420,0,8,12,4,-3,4,1,-4,5,1,4,1,5,6,0,6,1,1,2,0,10,14,-1,-5,6,3,0,1,-1,1,1,1,3,-1
KR_6661081281,440,-3,-32,-13,-6,-1,1,0,1,6,7,-6,6,0,3,2,5,-3,4,1,0,-7,-20,-3,-4,7,1,0,-2,-1,-1,-1,-1,3,-1
KR_6637901295,420,-4,-21,-4,-5,-3,4,1,-7,7,0,6,1,7,0,6,6,-1,1,0,-1,-12,6,-1,-2,3,1,0,-1,-1,0,-1,-1,3,-1
KR_6648795455,420,0,4,-4,2,-3,5,2,0,3,3,1,2,3,2,0,2,2,0,2,0,7,0,2,-8,6,-1,0,-1,1,-1,-1,-1,1,-1
KR_6734152153,420,0,-31,-44,-2,1,0,1,-4,5,1,-6,9,3,7,0,7,0,1,1,0,1,-6,1,-6,5,-7,0,0,-1,1,0,1,1,-1
KR_6670848391,420,-3,-25,0,-9,0,1,1,4,0,4,-5,6,1,-8,8,0,0,0,0,-1,-4,1,1,-5,4,-3,0,0,0,-1,-1,-1,0,-1
KR_6759449563,420,2,-51,16,2,0,1,1,0,1,1,1,2,3,-1,3,2,2,0,2,0,3,-1,0,-5,5,0,0,0,1,1,0,1,1,-1
KR_6729647729,420,2,22,-13,2,1,1,2,-1,4,3,3,4,7,0,1,1,-1,2,1,0,3,-61,-3,0,3,18,0,1,0,0,1,-1,0,-1
KR_6683085499,420,-3,3,-8,-7,-6,7,1,-3,4,1,0,3,3,1,1,2,1,2,3,0,-8,5,-2,-1,3,-2,0,0,-1,1,0,1,3,-1
KR_6723728396,420,0,-20,36,-5,1,2,3,-3,3,0,1,2,3,-3,4,1,-1,2,1,0,-6,-52,-3,-5,8,18,0,0,0,-1,-1,-1,0,-1
KR_6764573837,420,-2,-79,4,-1,-5,8,3,1,1,2,-3,4,1,5,2,7,1,1,2,0,5,4,5,-7,2,-2,0,0,1,-1,-1,-1,2,-1
KR_6719521692,420,-4,-40,-12,-9,-3,4,1,4,0,4,-6,7,1,-4,7,3,0,0,0,-2,-15,-1,-3,-4,7,-5,0,0,-1,1,-1,-1,4,-1
KR_6698260361,420,-1,11,32,-9,-9,10,1,0,1,1,-3,4,1,0,2,2,3,0,3,0,-3,5,-1,-2,3,0,0,0,1,1,-1,-1,5,-1
KR_6726191811,420,2,38,-27,-2,4,1,5,-3,7,4,-1,3,2,-2,4,2,0,0,0,0,-6,41,3,-7,4,-8,0,0,0,1,1,1,0,-1
KR_6746236204,420,-2,-79,0,-9,-2,2,0,-2,3,1,-4,6,2,2,2,4,-3,6,3,0,-5,4,-1,-2,3,-4,0,0,-1,-1,-1,1,6,-1
KR_6665482701,420,-3,-47,-12,-10,-5,7,2,-2,2,0,-6,6,0,4,0,4,-1,1,0,0,-5,-204,0,-3,3,1,0,0,-1,0,0,-1,3,-1
KR_6327103810,440,0,-63,-9,7,1,2,3,0,1,1,2,3,5,4,2,6,0,0,0,0,14,-23,0,-4,4,2,0,0,1,1,0,1,5,-1
KR_6759531850,420,-1,-26,1,-6,-2,2,0,-6,6,0,-3,5,2,3,4,7,2,1,3,0,-1,-3,-3,-1,4,3,0,-1,1,1,-1,1,1,-1
KR_6759274885,440,-4,-35,10,-16,-1,1,0,-2,2,0,-9,10,1,-2,4,2,-2,3,1,0,-14,0,2,-2,0,4,0,-1,-1,-1,-1,-1,5,-1
KR_6742071492,440,-2,-76,-16,-9,2,4,6,-4,6,2,-6,8,2,-1,2,1,0,0,0,-1,5,-2,0,-3,3,-2,0,0,0,-1,0,-1,0,-1
KR_6767361376,420,-7,-64,-24,-23,-8,8,0,1,3,4,-5,5,0,-5,8,3,-6,6,0,0,-16,1,5,-6,1,-5,0,-3,1,-1,-1,-1,5,-1
KR_6765835068,420,-1,10,12,-3,1,1,2,-2,5,3,-2,4,2,1,3,4,-1,1,0,0,-4,-68,-2,-4,6,34,0,0,0,-1,0,1,0,-1
KR_6703764316,420,-7,-86,-64,-11,-4,4,0,-2,3,1,-2,6,4,-1,1,0,-2,3,1,0,-4,-66,1,-3,2,0,0,-1,1,-1,-1,-1,5,-1
KR_6761839167,420,0,-10,-12,-6,-2,2,0,-2,2,0,-1,1,0,1,0,1,-2,4,2,0,-4,-4,0,-3,3,1,0,-1,1,0,-1,-1,3,-1
KR_6731452545,440,2,14,-8,-4,-3,3,0,0,1,1,0,3,3,-1,2,1,0,1,1,0,-8,5,1,-4,3,-3,0,0,-1,0,0,-1,2,-1
KR_6740364076,420,-2,-32,8,-2,1,2,3,-3,4,1,-1,3,2,-1,2,1,2,0,2,0,-1,103,2,-7,5,1,0,-2,-1,-1,-1,-1,2,-1
KR_6763244508,420,1,74,-8,7,2,1,3,4,1,5,2,0,2,-1,4,3,0,0,0,0,3,-137,4,-9,5,1,0,1,1,0,1,1,1,-1
KR_6763210869,420,0,25,-12,2,-1,1,0,1,2,3,3,3,6,0,3,3,-1,1,0,0,4,-2,0,-2,2,2,0,1,1,-1,1,1,4,-1
KR_6706032571,420,-2,-46,-16,1,4,2,6,1,1,2,-2,3,1,-2,3,1,0,0,0,-1,-3,-13,1,-4,3,2,0,0,-1,1,1,-1,1,-1
KR_6733780733,420,-5,-110,-40,-13,0,2,2,-2,3,1,-6,7,1,-5,6,1,0,0,0,-1,-16,-7,-4,-2,6,0,0,0,-1,1,-1,-1,3,-1
KR_6713871028,440,-3,1,-4,-9,-3,4,1,3,2,5,-4,4,0,-4,5,1,-1,2,1,0,-11,84,-8,-1,9,5,0,0,1,-1,0,-1,4,-1
KR_6715538696,420,-4,-15,-28,-15,-3,4,1,-2,4,2,-5,6,1,0,3,3,-5,5,0,0,-12,-16,1,-4,3,2,0,-3,-1,-1,-1,1,3,-1
KR_6752610283,420,-4,-54,4,-6,3,0,3,0,1,1,-1,1,0,-9,10,1,1,0,1,0,-8,-1,0,-6,6,-6,0,0,-1,1,-1,1,6,-1
KR_6756980546,420,-2,-140,-1,-11,-1,4,3,-2,3,1,0,4,4,-8,8,0,0,0,0,0,-19,-1,5,-9,4,-2,0,-1,1,-1,-1,-1,3,-1
KR_6761436232,440,-2,24,-28,-6,-4,4,0,2,1,3,-2,3,1,-1,2,1,-1,1,0,0,-9,-2,4,-7,3,-3,0,0,-1,1,0,-1,1,-1
KR_6625357903,420,-4,-64,-57,-7,1,2,3,-4,6,2,-5,6,1,0,3,3,1,0,1,-1,-1,-12,-8,-2,10,5,0,-3,-1,-1,-1,-1,2,-1
KR_6749165207,420,2,-2,8,5,-4,5,1,5,1,6,3,0,3,-1,5,4,2,1,3,0,12,55,-2,-2,4,3,0,1,-1,1,1,-1,6,-1
KR_6695429000,420,-3,-38,-10,-8,-2,2,0,-3,4,1,-4,4,0,-1,3,2,2,0,2,-2,-9,-6,-1,-3,4,0,0,0,-1,-1,0,-1,1,-1
KR_6640446314,420,-2,7,-43,-5,0,2,2,-5,9,4,0,2,2,-2,6,4,2,0,2,-1,1,-1,-4,-1,5,-1,0,0,-1,1,0,-1,2,-1
KR_6761060248,420,0,19,7,-2,-2,2,0,0,2,2,2,0,2,-2,3,1,0,1,1,0,-2,89,0,-3,3,2,0,1,-1,1,-1,-1,2,-1
KR_6759972863,440,-8,-118,-34,-13,-1,3,2,0,1,1,-4,6,2,-6,7,1,-2,3,1,-1,-12,-3,0,-3,3,0,0,-2,-1,1,-1,-1,2,-1
KR_6757501247,420,-1,-5,-12,-3,1,3,4,-3,3,0,1,2,3,-2,2,0,0,0,0,0,-4,-1,-1,-2,3,-2,0,-1,1,-1,-1,-1,4,-1
KR_5944444538,420,-5,-7,13,-16,0,3,3,-2,4,2,-4,5,1,-6,6,0,-4,4,0,0,-22,-12,-3,-3,6,0,0,-1,-1,0,-1,1,5,-1
KR_6741230370,420,-1,22,24,-5,-4,5,1,0,1,1,3,0,3,-2,3,1,-2,2,0,0,-5,-10,0,-4,4,-2,0,1,-1,1,1,1,2,-1
KR_6758426234,420,0,-8,-11,0,0,2,2,-2,4,2,-2,3,1,1,4,5,3,0,3,-1,-5,-7,0,-6,6,0,0,1,-1,1,1,-1,6,-1
KR_6652457175,420,-4,-56,-11,-7,-1,2,1,0,2,2,-2,3,1,-4,4,0,0,0,0,0,-9,131,2,-4,2,-3,0,-1,1,-1,-1,-1,2,-1
KR_6766821222,420,-4,-98,1,-1,2,2,4,-1,2,1,3,0,3,-4,8,4,-1,1,0,0,-5,21,1,-5,4,6,0,0,0,-1,0,-1,0,-1
KR_6766086160,440,-1,49,28,-2,-2,3,1,1,3,4,0,2,2,-1,3,2,0,5,5,0,-1,4,4,-5,1,2,0,0,-1,1,0,1,4,-1
KR_6762408781,420,-3,-54,-16,-9,6,0,6,-6,7,1,-1,4,3,-7,7,0,-1,1,0,-1,-22,27,-2,-3,5,-3,0,-2,-1,-1,-1,-1,5,-1
KR_6754825641,420,1,7,24,-5,-1,6,5,-1,1,0,2,0,2,-5,6,1,0,0,0,0,-2,-4,2,-5,3,-1,0,-1,-1,1,-1,-1,2,-1
KR_6748616581,420,4,30,10,6,3,0,3,-1,4,3,2,1,3,2,2,4,0,0,0,0,4,-405,-1,-2,3,-1,0,1,0,0,1,-1,0,-1
KR_6676445865,420,-1,-35,-21,-7,5,1,6,-4,4,0,-3,4,1,-6,8,2,1,0,1,0,-14,-35,-1,-3,4,-1,0,-2,-1,-1,-1,-1,4,-1
KR_6678139014,420,-2,-13,-11,0,1,1,2,-1,3,2,4,2,6,-5,6,1,1,0,1,0,-5,27,-1,-2,3,-4,0,-1,0,1,-1,1,0,-1
KR_6758111947,420,2,-25,-12,3,3,0,3,0,2,2,-1,3,2,1,4,5,0,0,0,0,11,-8,-1,-3,4,2,0,-1,0,-1,-1,-1,0,-1
KR_6765665755,420,-4,-37,-24,-11,-1,5,4,3,3,6,-7,7,0,-4,4,0,-2,3,1,0,-1,-16,-2,0,2,2,0,-1,0,-1,-1,-1,0,-1
KR_6667714357,420,-1,0,-8,-7,-3,3,0,-7,7,0,1,1,2,2,1,3,0,0,0,-1,-11,-13,-6,-5,11,0,0,0,-1,-1,1,-1,1,-1
KR_6761521076,440,-1,-33,24,-2,-8,8,0,1,0,1,-3,3,0,7,0,7,1,0,1,0,-2,43,2,-6,4,-6,0,0,1,1,-1,1,1,-1
KR_6755142892,420,-6,-109,7,-15,-8,9,1,-4,4,0,-9,9,0,5,1,6,1,1,2,0,-15,7,1,-3,2,0,0,-1,-1,-1,-1,-1,2,-1
KR_6762642536,440,0,39,5,0,-3,4,1,1,1,2,2,2,4,-1,3,2,1,1,2,0,4,23,0,-3,3,-1,0,-1,-1,-1,-1,1,2,-1
KR_6649136455,420,-8,-64,-37,-7,1,1,2,-1,5,4,-3,3,0,-2,3,1,-2,2,0,0,-8,-28,3,-7,4,-5,0,-2,-1,-1,-1,-1,5,-1
KR_6726988874,440,-1,-9,8,-5,-1,2,1,-3,3,0,4,0,4,0,1,1,-5,5,0,0,-9,2,1,-3,2,1,0,0,-1,0,0,-1,4,-1
KR_6733006346,440,-7,-62,-4,-14,-4,6,2,-1,2,1,1,1,2,-8,9,1,-2,4,2,1,-12,-11,-1,-2,3,-3,0,-2,-1,1,-1,1,5,-1
KR_6694945115,420,-2,-47,4,-4,-3,3,0,-1,3,2,1,4,5,-3,3,0,2,3,5,0,-4,-404,0,-3,3,-2,0,-1,-1,-1,-1,-1,3,-1
KR_6756399271,420,1,-28,-16,-6,-1,3,2,-1,4,3,-2,3,1,0,1,1,-2,2,0,0,-8,-6,-1,-6,7,1,0,-1,1,-1,-1,-1,3,-1
KR_6765521204,420,-1,-24,-12,-1,0,0,0,-1,3,2,1,1,2,-1,2,1,0,1,1,0,-1,-26,-1,0,1,3,0,-1,0,-1,-1,1,0,-1
KR_6697445380,420,-1,-37,20,2,-1,3,2,2,4,6,0,1,1,0,4,4,1,1,2,0,-7,-4,-3,-3,6,4,0,0,1,1,0,-1,5,-1
KR_6763203564,440,0,-22,-4,-2,-1,1,0,1,1,2,2,1,3,-1,1,0,-3,3,0,0,-3,4,1,-4,3,-2,0,-2,-1,-1,-1,-1,3,-1
KR_6736829589,420,-3,-45,-2,-9,-3,3,0,-1,3,2,-2,3,1,0,0,0,-3,3,0,0,-3,43,1,-10,9,-20,0,-2,-1,-1,-1,-1,1,-1
KR_6630547203,420,0,-9,4,1,2,1,3,0,2,2,-2,2,0,1,3,4,0,1,1,0,-1,-1,-4,-4,8,4,0,0,-1,1,0,-1,1,-1
KR_6707849974,420,1,86,-28,2,2,1,3,3,3,6,0,3,3,-2,4,2,-1,2,1,0,0,303,2,-7,5,3,0,0,-1,-1,0,1,6,-1
KR_6661384003,420,-5,-70,-20,-10,0,0,0,-1,3,2,-1,1,0,-8,8,0,0,3,3,0,-7,-27,-4,-2,6,4,0,-1,1,-1,-1,-1,3,-1
KR_6664928808,420,-2,-23,-12,-5,-1,2,1,-3,4,1,-2,3,1,1,0,1,0,0,0,0,1,-8,-2,-6,8,-1,0,-1,1,-1,-1,-1,5,-1
KR_6766051144,420,-1,13,-4,1,-3,4,1,-3,3,0,5,0,5,2,0,2,0,1,1,0,3,9,3,-6,3,-5,0,0,1,0,0,-1,2,-1
KR_6701962468,420,-1,-50,0,-11,-3,5,2,-1,4,3,-1,3,2,-6,8,2,0,1,1,1,-11,-2,3,-5,2,1,0,-1,1,1,-1,1,3,-1
KR_6761550707,420,-1,-58,0,5,-1,2,1,6,1,7,-3,3,0,3,3,6,0,1,1,1,9,-12,8,-8,0,0,0,0,1,0,0,1,4,-1
KR_6732427991,420,-2,-108,8,-9,4,1,5,0,1,1,-6,7,1,-5,6,1,-2,2,0,-1,-11,2,-1,-5,6,-4,0,0,-1,1,-1,-1,4,-1
KR_6705583855,420,-3,-102,12,-14,-5,6,1,-7,7,0,-3,5,2,-1,3,2,2,0,2,-2,-15,-7,1,-6,5,2,0,-1,-1,1,-1,-1,6,-1
KR_6708699634,440,-3,-66,-1,-10,0,2,2,-2,2,0,1,1,2,-6,6,0,-3,4,1,0,-2,-18,-2,-5,7,2,0,-2,-1,-1,-1,-1,2,-1
KR_6655767434,420,-3,4,16,-12,-2,3,1,1,0,1,-1,1,0,-5,5,0,-5,5,0,-1,-23,3,-3,-3,6,-1,0,0,-1,1,-1,-1,4,-1
KR_6549009215,420,-1,-3,0,0,1,1,2,0,7,7,0,1,1,0,3,3,-1,1,0,1,-6,19,1,-6,5,-5,0,1,-1,1,1,-1,3,-1
KR_6695393792,420,-1,2,-44,-3,-1,2,1,-4,5,1,2,4,6,-1,3,2,1,0,1,0,-7,1,0,-2,2,-3,0,0,0,0,0,1,0,-1
KR_6666285394,420,-5,-73,-44,-11,1,3,4,-1,2,1,-3,4,1,-4,6,2,-4,4,0,0,-9,7,1,-4,3,1,0,-1,1,0,-1,-1,2,-1
KR_6756915318,420,-2,-90,-28,-8,-4,4,0,2,3,5,-6,8,2,-1,4,3,1,0,1,-3,8,-3,-3,-2,5,-4,0,-1,-1,-1,-1,-1,3,-1
KR_6649107250,420,-9,-126,-24,-18,-4,4,0,-1,7,6,-5,5,0,-6,8,2,-2,3,1,0,-11,8,3,-7,4,-4,0,-1,-1,1,-1,1,6,-1
KR_6745700506,420,2,60,-12,1,3,0,3,5,1,6,-3,4,1,-5,7,2,1,0,1,0,-2,-12,6,-10,4,-1,0,-1,-1,-1,1,-1,1,-1
KR_6756795489,420,2,-19,0,0,-3,3,0,-2,4,2,3,2,5,0,3,3,2,1,3,-1,-3,-1,0,-6,6,-6,0,1,1,1,1,-1,5,-1
KR_6742530111,440,-4,-6,-15,-2,3,1,4,1,2,3,-1,2,1,-5,5,0,0,0,0,0,-10,-12,1,-5,4,0,0,0,-1,1,1,-1,1,-1
KR_6672827234,420,0,-37,28,5,1,0,1,5,3,8,2,1,3,-3,5,2,0,1,1,0,0,-8,-1,-6,7,1,0,0,-1,1,0,1,1,-1
KR_6745147906,420,1,12,16,-1,-4,7,3,3,0,3,1,0,1,-2,3,1,1,1,2,0,-3,-102,-8,-1,9,9,0,-2,1,-1,-1,1,5,-1
KR_6737892548,420,-1,22,-16,-5,0,1,1,1,2,3,2,0,2,-2,3,1,-6,6,0,0,-5,10,1,-5,4,-3,0,-1,-1,-1,-1,-1,5,-1
KR_6338250071,420,-2,-25,-28,-3,1,1,2,-3,6,3,-3,3,0,1,4,5,1,0,1,0,0,-8,-1,-4,5,-2,0,0,-1,1,0,-1,3,-1
KR_6761092252,420,-3,-39,-20,-5,-1,1,0,-2,5,3,0,1,1,-3,4,1,1,1,2,0,-7,4,4,-9,5,0,0,-2,-1,-1,-1,1,5,-1
KR_6767683954,420,-4,-10,8,-2,2,0,2,-1,2,1,0,1,1,-2,3,1,-1,2,1,0,-3,-11,-1,-5,6,3,0,0,-1,-1,0,-1,5,-1
KR_6734427444,420,-4,-57,4,-12,-1,2,1,-5,7,2,-7,8,1,0,3,3,1,0,1,0,-13,14,-1,-6,7,-7,0,-1,1,-1,-1,-1,5,-1
KR_6706398413,420,-4,44,-96,-1,2,0,2,-2,2,0,0,3,3,-2,4,2,1,0,1,0,-7,3,-1,-3,4,1,0,1,-1,0,1,1,2,-1
KR_6767017019,420,-3,-50,-1,-6,-6,6,0,-4,5,1,5,0,5,1,1,2,-2,2,0,0,0,6,2,-4,2,2,0,1,-1,1,1,1,4,-1
KR_6720392267,420,-4,-13,-28,-3,2,2,4,-2,2,0,1,2,3,0,1,1,-4,4,0,-1,-9,-68,4,-7,3,11,0,0,-1,1,-1,-1,3,-1
KR_6612645814,440,-1,-40,-24,1,0,1,1,3,1,4,-3,5,2,0,0,0,1,0,1,0,3,-6,1,-4,3,1,0,0,-1,1,0,1,4,-1
KR_6755746428,420,0,-7,24,-3,-1,2,1,1,1,2,-4,5,1,1,0,1,0,0,0,0,3,24,-1,-2,3,-1,0,-1,1,-1,-1,-1,3,-1
KR_6729085562,420,1,-19,5,-2,4,0,4,1,4,5,-5,6,1,0,5,5,-2,3,1,-1,-7,-1,-2,-5,7,6,0,0,-1,1,-1,-1,5,-1
KR_6635246359,420,-5,-50,-4,-9,-5,7,2,-5,7,2,3,2,5,-2,5,3,0,1,1,0,-11,-12,-5,-4,9,0,0,-1,-1,1,-1,-1,1,-1
KR_6735099557,420,-2,20,22,-6,-1,1,0,-6,6,0,3,1,4,-1,3,2,-1,1,0,0,-7,-3,-1,-2,3,2,0,-1,1,-1,-1,1,1,-1
KR_6752427795,420,2,9,4,10,0,5,5,0,4,4,3,2,5,8,0,8,-1,2,1,0,7,18,2,-6,4,-3,0,0,-1,0,0,-1,6,-1
KR_6365697683,420,-3,-25,25,-7,-1,2,1,-3,4,1,-3,5,2,-1,1,0,1,0,1,0,-8,0,0,0,0,0,0,-2,1,-1,-1,1,4,-1
KR_6741814248,420,-5,-62,-16,-3,-1,3,2,3,1,4,-5,6,1,0,0,0,0,0,0,2,4,1,-3,-3,6,2,0,-1,-1,-1,-1,1,6,-1
KR_6722273190,420,-2,59,-12,-9,-3,4,1,-1,3,2,4,1,5,-9,9,0,0,0,0,0,-9,-16,-7,0,7,1,0,-1,-1,0,-1,1,4,-1
KR_6751245898,420,-5,0,-44,-12,-3,4,1,-2,5,3,-3,6,3,-4,4,0,0,0,0,0,-11,25,-1,-4,5,-2,0,-1,0,-1,-1,1,0,-1
KR_6741186682,420,-1,-19,-12,0,4,0,4,4,1,5,-5,5,0,-3,6,3,0,1,1,0,3,4,-3,-5,8,1,0,0,1,-1,-1,1,1,-1
KR_6614101832,440,-1,26,28,-8,0,0,0,-4,7,3,0,1,1,-3,3,0,-1,1,0,0,-10,5,0,-5,5,-3,0,0,0,-1,-1,-1,0,-1
KR_6721025490,440,-3,-44,-3,-3,1,1,2,-3,4,1,-2,6,4,0,2,2,1,1,2,0,-4,10,-1,-7,8,0,0,0,-1,-1,0,-1,4,-1
KR_6727076147,420,-3,-66,0,-4,-7,8,1,-2,3,1,3,0,3,0,5,5,2,2,4,1,-4,26,-3,-4,7,5,0,0,-1,-1,-1,1,4,-1
KR_6761561816,420,1,-16,8,5,-2,3,1,5,0,5,2,0,2,1,0,1,-1,1,0,0,5,39,-3,-3,6,-5,0,0,-1,-1,0,1,5,-1
KR_6642044989,420,-8,-73,5,-20,-4,5,1,-2,4,2,-6,6,0,-8,8,0,0,0,0,0,-17,-25,-5,-3,8,-1,0,-1,-1,1,-1,-1,3,-1
KR_6720654408,420,-3,-21,19,-5,-3,4,1,-1,4,3,-1,4,3,2,3,5,-2,3,1,0,-2,85,-1,-4,5,0,0,0,-1,1,-1,-1,4,-1
KR_6762605329,440,-1,-26,4,3,2,0,2,1,3,4,-1,1,0,0,1,1,1,0,1,0,-1,30,2,-6,4,-16,0,0,1,1,0,1,2,-1
KR_6761792094,420,-5,-41,-4,-10,-2,5,3,-7,7,0,-2,2,0,0,1,1,1,0,1,-1,-9,-32,0,-3,3,22,0,-1,-1,-1,-1,-1,5,-1
KR_6767466546,420,3,77,34,4,-2,5,3,-1,2,1,1,3,4,2,4,6,4,0,4,1,-1,6,-4,0,4,1,0,1,1,-1,1,1,5,-1
KR_6730054607,440,-2,-27,15,2,4,0,4,1,2,3,-3,6,3,-1,1,0,1,3,4,0,-2,-5,2,-5,3,-1,0,1,-1,1,1,1,6,-1
KR_6760444121,440,-5,-85,-35,-11,1,1,2,0,2,2,-1,4,3,-4,5,1,-7,8,1,0,-11,-6,-8,-3,11,1,0,0,-1,-1,0,1,6,-1
KR_6728263544,420,-3,-18,8,-7,-3,4,1,0,3,3,-2,4,2,0,5,5,-2,3,1,1,-8,-17,3,-9,6,0,0,0,1,-1,0,1,5,-1
KR_6658708947,440,-1,33,-2,-3,2,0,2,-6,7,1,1,3,4,0,1,1,0,1,1,0,-3,31,2,-4,2,-28,0,0,0,0,0,-1,0,-1
KR_6757423390,420,0,-25,-29,-1,-2,2,0,1,1,2,1,1,2,-2,5,3,1,0,1,-2,-7,7,-4,-3,7,1,0,0,-1,1,0,1,2,-1
KR_6713007804,420,-3,-56,-16,-9,-6,6,0,-4,7,3,3,0,3,-1,3,2,-1,2,1,-1,-4,4,-2,-7,9,0,0,-3,-1,-1,-1,-1,3,-1
KR_6762984949,420,1,15,16,0,2,0,2,-3,4,1,2,1,3,-2,4,2,1,0,1,0,-1,7,2,-10,8,-5,0,0,1,-1,0,-1,6,-1
KR_6624724071,420,-4,-4,12,-13,-3,4,1,-9,11,2,-1,3,2,0,3,3,0,2,2,0,-11,-7,0,-7,7,2,0,-1,1,1,-1,1,3,-1
KR_6723122536,420,-6,-24,16,-13,0,1,1,0,1,1,-3,3,0,-7,8,1,-3,3,0,-1,-10,-4,0,-4,4,6,0,0,-1,-1,-1,-1,2,-1
KR_6650113445,420,0,-25,16,2,-2,3,1,4,0,4,1,0,1,0,0,0,-1,1,0,0,0,-6,0,-5,5,-1,0,-1,-1,1,-1,1,3,-1
KR_6745406362,420,-5,-67,-3,-7,0,1,1,-1,4,3,0,0,0,-4,7,3,-2,2,0,0,-7,93,-6,-3,9,1,0,0,-1,-1,-1,1,2,-1
KR_6751725416,420,-3,-90,68,-11,-4,5,1,2,0,2,-1,4,3,-4,5,1,-4,6,2,0,-1,29,-1,-4,5,-1,0,-2,1,1,-1,1,5,-1
KR_6612562766,420,-1,6,0,-3,2,1,3,4,2,6,-4,7,3,-1,1,0,-4,4,0,1,-1,12,3,-5,2,1,0,-1,-1,-1,-1,1,6,-1
KR_6764791566,440,-1,-27,-20,2,-1,5,4,-1,2,1,-3,3,0,4,0,4,3,0,3,0,7,4,1,-4,3,3,0,-1,1,-1,-1,1,5,-1
KR_6761637891,420,3,-35,-6,7,0,1,1,5,2,7,0,4,4,2,6,8,0,1,1,0,10,24,-1,-2,3,-2,0,0,1,1,0,1,2,-1
KR_6737713375,420,-1,6,-6,1,1,0,1,-3,8,5,0,3,3,3,1,4,0,0,0,0,6,15,3,-7,4,1,0,0,1,-1,-1,1,5,-1
KR_6742046676,440,-2,22,-31,1,-3,4,1,-1,2,1,2,1,3,2,3,5,1,0,1,0,1,14,-3,-3,6,-1,0,-1,-1,0,-1,-1,2,-1
KR_6764605818,420,2,-50,0,5,4,1,5,1,0,1,1,2,3,-1,3,2,0,4,4,0,0,-8,-5,-2,7,5,0,1,-1,-1,1,-1,3,-1
KR_6766829506,420,-3,-80,0,-12,2,0,2,-3,3,0,-4,4,0,0,0,0,-7,7,0,0,-14,7,-3,-4,7,1,0,0,-1,1,1,-1,3,-1
KR_6638776708,420,3,13,20,2,2,0,2,-4,5,1,1,1,2,1,1,2,2,2,4,1,2,-19,1,-3,2,2,0,0,-1,1,0,1,1,-1
KR_6763163561,440,-4,-62,-46,-10,2,1,3,-2,4,2,-6,6,0,-4,6,2,0,0,0,0,-8,208,5,-6,1,-2,0,-3,1,-1,-1,-1,6,-1
KR_6766966294,420,-1,56,-16,-6,-1,2,1,0,1,1,-2,4,2,2,0,2,-5,5,0,1,-5,53,1,-3,2,-22,0,2,1,0,1,1,1,-1
KR_6755051558,420,-1,-15,-23,4,2,0,2,2,0,2,0,5,5,0,1,1,0,3,3,0,9,-13,5,-5,0,2,0,0,1,-1,-1,1,3,-1
KR_6767797820,420,-2,-123,-26,-6,0,2,2,-6,6,0,0,3,3,0,2,2,0,0,0,0,-4,-41,-4,-3,7,-5,0,-3,-1,-1,-1,-1,2,-1
KR_6764742278,420,0,-67,-24,2,-1,3,2,1,2,3,4,0,4,-4,5,1,2,0,2,0,3,-3,4,-9,5,-2,0,-1,1,-1,-1,1,2,-1
KR_6634885664,420,-3,-7,-16,-3,1,0,1,-3,3,0,-1,1,0,0,1,1,0,1,1,0,-7,31,3,-6,3,-1,0,-1,-1,-1,-1,1,1,-1
KR_6763363317,440,-2,-61,-29,-4,2,1,3,-3,4,1,2,1,3,-2,3,1,-3,6,3,0,-1,66,1,-6,5,-28,0,-1,-1,0,-1,-1,4,-1
KR_6724787942,420,-2,-66,-4,-11,-4,6,2,-2,5,3,-4,6,2,1,2,3,-2,2,0,0,8,-5,-3,-1,4,1,0,-2,-1,-1,-1,-1,4,-1
KR_6767478221,420,-4,-70,5,-10,-1,2,1,-4,6,2,-5,6,1,0,2,2,0,1,1,0,-6,-3,-3,-5,8,2,0,-2,1,-1,-1,-1,6,-1
KR_6722105073,420,-4,1,-8,-6,-3,3,0,-4,7,3,2,1,3,0,1,1,-1,3,2,0,-6,7,-2,-1,3,-2,0,-1,1,-1,-1,-1,6,-1
KR_6765461716,440,-2,-50,-9,-8,0,0,0,5,1,6,0,2,2,-6,7,1,-7,7,0,0,-10,11,2,-11,9,-3,0,-1,0,-1,-1,-1,0,-1
KR_6748138896,420,-4,-104,-24,-15,-3,3,0,-6,8,2,-7,7,0,2,2,4,-1,1,0,0,-8,-23,4,-6,2,-4,0,-2,-1,-1,-1,-1,6,-1
KR_6735280824,420,0,-50,16,-6,1,0,1,-1,3,2,0,1,1,-6,6,0,0,1,1,-1,-8,-18,-1,-1,2,0,0,-1,1,-1,-1,-1,3,-1
KR_6765860197,420,2,41,-12,1,-1,1,0,-3,3,0,3,2,5,1,2,3,1,1,2,0,-2,1,3,-5,2,1,0,2,1,1,1,1,5,-1
KR_6751705792,420,0,31,36,-6,3,0,3,-3,3,0,0,2,2,-4,6,2,-2,2,0,0,-12,-32,0,-5,5,24,0,0,-1,1,0,1,5,-1
KR_6755098740,420,-2,-48,-22,0,-3,5,2,1,1,2,1,3,4,2,1,3,-1,1,0,0,5,-142,2,-5,3,-3,0,0,-1,1,0,-1,6,-1
KR_6697936214,420,3,48,4,4,0,1,1,-1,4,3,2,0,2,1,1,2,2,0,2,0,2,-11,2,-4,2,5,0,0,0,-1,0,1,0,-1
KR_6651799722,420,-4,-59,-16,-7,-3,3,0,-3,7,4,-2,2,0,2,1,3,-1,2,1,0,-1,1,2,-3,1,-2,0,-1,1,-1,-1,-1,5,-1
KR_6719260431,420,-4,-1,-13,-11,-2,5,3,1,1,2,-9,11,2,1,2,3,-2,3,1,-1,-8,1,5,-8,3,1,0,-1,-1,0,-1,-1,3,-1
KR_6749027139,420,-3,-40,24,-11,-3,3,0,0,2,2,-4,4,0,0,2,2,-4,4,0,0,-5,32,1,-5,4,-8,0,-1,-1,0,-1,-1,4,-1
KR_6751006464,440,0,9,0,-3,0,1,1,1,1,2,-3,6,3,-2,4,2,1,0,1,0,-3,-17,3,-5,2,-2,0,-2,-1,-1,-1,-1,6,-1
KR_6658662540,420,2,12,34,3,1,0,1,-1,4,3,-5,6,1,5,0,5,3,0,3,0,5,-388,0,-3,3,3,0,0,1,-1,-1,1,6,-1
KR_6653795828,420,-4,-120,-4,0,0,3,3,2,2,4,-3,3,0,3,1,4,-2,3,1,0,7,-42,3,-5,2,24,0,-2,-1,-1,-1,-1,2,-1
KR_6747743827,420,-4,11,-3,-5,1,2,3,-4,6,2,1,1,2,-2,4,2,-1,1,0,2,1,-13,-3,-1,4,1,0,-1,0,1,-1,1,0,-1
KR_6655829151,420,3,39,0,-2,3,0,3,-1,3,2,1,0,1,-3,3,0,-2,2,0,0,-10,-6,1,-2,1,-2,0,0,-1,1,1,-1,5,-1
KR_6677672698,420,3,51,0,9,6,1,7,1,3,4,-3,5,2,1,1,2,4,0,4,0,12,-28,-1,-3,4,0,0,1,-1,1,1,-1,5,-1
KR_6765710168,420,-3,-49,-9,-1,-1,4,3,-3,7,4,-2,2,0,2,2,4,3,0,3,0,9,-10,-2,-3,5,2,0,0,-1,-1,-1,1,1,-1
KR_6733835206,440,-4,-54,-19,-13,-1,2,1,-3,7,4,-10,10,0,1,4,5,0,2,2,0,-8,42,-5,-1,6,-3,0,-1,-1,-1,-1,-1,3,-1
KR_6649326221,420,-2,-96,20,2,0,2,2,1,2,3,1,1,2,-2,3,1,2,1,3,0,1,28,-3,-3,6,-5,0,0,-1,1,0,1,1,-1
KR_6648051285,420,0,0,-28,0,2,3,5,-3,4,1,-2,2,0,3,0,3,0,0,0,1,8,-21,3,-4,1,0,0,0,1,-1,0,1,5,-1
KR_6750332521,420,-5,-70,-17,-6,-1,2,1,-1,7,6,0,2,2,-4,4,0,0,0,0,0,-17,-9,2,-4,2,-7,0,-1,-1,1,-1,1,4,-1
KR_6738846452,440,-3,-30,-23,-5,-3,4,1,0,4,4,-1,1,0,-2,4,2,1,0,1,0,-4,0,-4,-1,5,-3,0,0,-1,-1,0,1,3,-1
KR_6673920628,420,1,19,-20,2,0,3,3,1,1,2,2,2,4,-2,3,1,1,1,2,0,9,104,1,-5,4,2,0,0,-1,1,0,1,1,-1
KR_6632870467,420,-2,20,-16,0,0,0,0,0,2,2,-1,4,3,0,2,2,1,0,1,0,0,-1,-1,-3,4,0,0,-1,-1,-1,-1,-1,4,-1
KR_6767448000,420,2,10,22,3,2,1,3,4,1,5,0,0,0,-5,9,4,2,1,3,0,2,111,3,-4,1,3,0,0,0,0,1,1,0,-1
KR_6733685514,420,3,1,12,1,3,0,3,-2,3,1,1,0,1,2,2,4,-3,3,0,0,-2,3,-1,-3,4,-2,0,-1,-1,1,-1,-1,3,-1
KR_6761988877,420,-3,-57,-16,-4,-4,5,1,-1,2,1,1,1,2,0,3,3,0,2,2,0,1,2,3,-8,5,2,0,-1,0,-1,-1,-1,0,-1
KR_6672659667,420,-1,-26,4,-9,0,2,2,-1,3,2,-6,7,1,-2,3,1,0,0,0,0,-19,6,-4,-3,7,0,0,-1,-1,1,-1,1,2,-1
KR_6748832436,420,-3,-24,0,-7,-2,4,2,-3,3,0,-1,5,4,-1,1,0,0,0,0,0,-14,22,-4,-4,8,-7,0,0,0,-1,0,-1,0,-1
KR_6747871554,440,1,31,0,3,2,2,4,-2,4,2,-1,4,3,7,1,8,-3,3,0,1,1,-42,-4,-1,5,0,0,1,1,-1,1,1,3,-1
KR_6765249738,420,0,-31,19,-1,6,0,6,-4,4,0,-1,1,0,-3,3,0,1,1,2,-1,-8,-10,3,-5,2,-1,0,2,-1,1,1,-1,1,-1
KR_6731418170,420,-3,-27,-32,-6,-4,8,4,0,4,4,0,4,4,-2,2,0,0,3,3,0,8,-14,1,-2,1,-2,0,-1,-1,-1,-1,1,2,-1
KR_6730000743,440,-4,-87,-28,-9,1,2,3,-6,8,2,-4,4,0,-2,6,4,2,4,6,0,-5,-4,-3,-4,7,-1,0,-3,0,-1,-1,1,0,-1
KR_6756551127,420,2,65,-16,0,6,0,6,-6,6,0,-1,2,1,1,1,2,0,1,1,0,-2,132,3,-5,2,-3,0,1,-1,-1,1,1,5,-1
KR_6757369179,420,-4,59,-1,-13,-1,2,1,-2,3,1,-4,5,1,0,4,4,-6,8,2,-2,-11,-1,-1,-3,4,-1,0,0,-1,0,0,-1,3,-1
KR_6749195025,420,-1,-53,16,0,2,1,3,4,1,5,-2,4,2,-3,5,2,-1,1,0,-1,0,0,-1,-3,4,3,0,-1,1,-1,-1,-1,2,-1
KR_6723237353,440,1,60,-8,-1,-1,2,1,4,2,6,0,1,1,1,3,4,-5,5,0,-1,-4,-11,3,-6,3,5,0,1,0,1,1,-1,0,-1
KR_6642957277,420,1,6,-28,8,-6,6,0,5,0,5,4,0,4,2,3,5,3,2,5,1,19,9,0,-7,7,-1,0,-2,1,-1,-1,1,1,-1
KR_6672670858,420,-6,-52,-38,-9,-3,3,0,0,3,3,-4,5,1,-2,4,2,0,0,0,0,-8,24,-1,-2,3,0,0,0,-1,0,0,-1,1,-1
KR_6746302931,420,-3,-36,-32,3,0,2,2,-1,5,4,0,1,1,3,1,4,1,0,1,0,8,2,-3,-4,7,-3,0,-1,-1,-1,-1,1,5,-1
KR_6633006308,420,2,-9,-24,4,-1,1,0,0,1,1,3,1,4,0,2,2,2,0,2,0,7,206,-2,-6,8,-4,0,0,-1,1,0,-1,1,-1
KR_6689309938,420,-3,-66,-12,-17,-2,5,3,-4,7,3,-8,8,0,-2,5,3,-1,3,2,-3,-20,3,-1,-3,4,-2,0,1,-1,1,1,-1,1,-1
KR_6759997836,420,-8,-85,-31,-16,0,1,1,-4,7,3,-8,8,0,-2,3,1,-2,2,0,0,-10,3,3,-5,2,-3,0,-3,1,-1,-1,1,1,-1
KR_6746000943,420,-1,15,3,-2,-2,2,0,-2,2,0,3,4,7,-1,1,0,0,1,1,0,-9,12,0,-5,5,7,0,1,1,1,1,1,2,-1
KR_6739057008,420,-4,-105,12,-19,-3,3,0,-4,5,1,-5,7,2,-3,3,0,-4,4,0,0,-15,3,-2,-6,8,0,0,-1,-1,-1,-1,-1,5,-1
KR_6758099987,420,2,5,40,-2,1,0,1,0,0,0,-1,1,0,-3,3,0,1,1,2,0,-3,3,-1,-4,5,-2,0,0,1,-1,0,-1,2,-1
KR_6720329806,420,-5,-45,-20,-6,0,1,1,-3,4,1,0,2,2,-2,3,1,-1,3,2,0,-4,8,2,-5,3,-6,0,0,-1,-1,0,-1,6,-1
KR_6618181733,420,-1,1,-12,1,0,1,1,0,1,1,2,0,2,0,3,3,-1,1,0,0,2,10,6,-10,4,0,0,0,-1,-1,0,1,3,-1
KR_6764201179,420,0,5,-16,2,3,2,5,1,0,1,-3,4,1,2,0,2,-1,1,0,0,0,2,2,-5,3,-4,0,-1,1,-1,-1,1,1,-1
KR_6757669652,440,1,31,7,7,4,0,4,0,2,2,-3,4,1,-1,3,2,7,1,8,1,7,-13,-5,0,5,3,0,0,0,1,1,1,0,-1
KR_6724966137,440,3,2,1,12,2,1,3,0,3,3,6,1,7,2,0,2,2,0,2,0,13,9,3,-5,2,-5,0,1,0,1,1,1,0,-1
KR_6749884241,420,-3,16,-49,0,-4,5,1,3,0,3,4,1,5,-1,3,2,-2,3,1,0,4,-18,-1,-2,3,3,0,-1,0,0,-1,-1,0,-1
KR_6672006534,420,-4,-74,-4,-12,-1,2,1,-3,5,2,-5,6,1,-3,4,1,0,0,0,0,-16,-7,-8,-1,9,0,0,-2,-1,1,-1,1,3,-1
KR_6654542024,420,0,-78,5,0,1,1,2,-2,5,3,1,1,2,0,1,1,0,1,1,-2,0,-3,1,-4,3,2,0,0,-1,1,-1,-1,2,-1
KR_6760776465,440,2,-21,-1,4,-4,5,1,-1,2,1,0,1,1,3,1,4,6,0,6,-1,0,-5,-5,-3,8,6,0,2,0,0,1,-1,0,-1
KR_6631764933,420,-6,-28,-20,-16,-7,7,0,0,2,2,-3,3,0,-2,3,1,-4,4,0,0,-5,-1,-2,-6,8,-7,0,-2,-1,-1,-1,-1,4,-1
KR_6327167471,440,0,-74,-23,-2,-3,6,3,1,0,1,-3,5,2,4,1,5,-1,2,1,-1,9,11,2,-6,4,6,0,-4,-1,-1,-1,-1,6,-1
KR_6744717100,420,-1,-44,-4,-7,-6,7,1,4,1,5,0,2,2,-2,4,2,-3,4,1,0,5,-296,-3,-2,5,-1,0,-2,1,-1,-1,-1,1,-1
KR_6766962720,420,-1,-18,0,-2,-2,2,0,-7,8,1,4,4,8,4,1,5,-1,2,1,0,-2,8,2,-5,3,-3,0,0,1,1,0,-1,6,-1
KR_6767319774,420,-2,-15,-4,-2,2,1,3,0,0,0,-1,1,0,-4,4,0,1,0,1,0,-2,20,-1,-3,4,-3,0,-1,-1,1,-1,1,5,-1
KR_6762302892,420,-8,-65,-18,-10,-5,5,0,-4,4,0,-3,5,2,1,1,2,1,1,2,1,-6,-11,2,-4,2,-3,0,0,0,-1,0,1,0,-1
KR_6730985864,420,-2,-3,12,0,1,3,4,2,1,3,-4,7,3,-1,5,4,2,0,2,2,6,188,-5,-3,8,-7,0,0,0,1,1,1,0,-1
KR_6749576021,440,-4,-41,-26,-7,1,1,2,-1,3,2,-6,7,1,-2,4,2,1,0,1,0,-6,-6,-4,-1,5,2,0,0,-1,-1,0,1,5,-1
KR_6731742032,420,-2,-49,26,-4,-2,4,2,-1,1,0,1,1,2,-4,5,1,2,1,3,-1,0,-12,1,-5,4,4,0,-1,-1,1,-1,-1,1,-1
KR_6717011237,420,-1,-5,-8,-2,-3,3,0,3,2,5,-2,2,0,2,1,3,-2,3,1,0,-5,-7,-8,-1,9,-4,0,-1,-1,1,-1,-1,5,-1
KR_6754544290,440,-3,-9,-12,-1,-5,6,1,4,2,6,-3,6,3,0,4,4,3,0,3,0,7,5,1,-5,4,0,0,-1,0,-1,-1,-1,0,-1
KR_6760283645,440,0,-20,9,-1,4,1,5,1,3,4,-2,6,4,-8,8,0,4,4,8,0,-2,20,-1,-3,4,2,0,0,-1,1,-1,-1,6,-1
KR_6713741269,420,-3,-39,-19,1,1,1,2,-1,7,6,0,4,4,1,2,3,0,0,0,0,10,-4,7,-7,0,-4,0,0,-1,-1,1,1,2,-1
KR_6646207141,420,-6,-75,-19,-12,-3,3,0,-3,6,3,-3,3,0,-2,3,1,-1,3,2,0,-10,2,1,-4,3,-1,0,-2,-1,-1,-1,-1,5,-1
KR_6762280919,440,-2,4,-17,-6,0,1,1,-2,2,0,-1,2,1,-2,3,1,-1,2,1,-1,-9,-4,2,-3,1,1,0,-1,-1,1,-1,-1,1,-1
KR_6732701739,420,-5,-94,-25,-17,-1,3,2,-10,11,1,-2,2,0,-2,3,1,-2,2,0,0,-9,-4,-1,-2,3,-5,0,-2,-1,-1,-1,-1,3,-1
KR_6743408691,420,-4,-134,-15,0,-3,3,0,-1,3,2,5,3,8,4,0,4,-5,5,0,-3,3,-16,-1,-4,5,1,0,-2,-1,-1,-1,-1,6,-1
KR_6748818498,440,-2,49,-3,-8,-1,1,0,-3,3,0,-4,5,1,0,0,0,0,0,0,0,-6,-14,-2,-4,6,-4,0,0,-1,-1,0,-1,4,-1
KR_6743328498,420,-4,-87,-32,-13,-5,6,1,1,3,4,-3,3,0,-6,8,2,0,0,0,0,-9,-50,-5,-3,8,16,0,-1,1,-1,-1,-1,2,-1
KR_6763456900,440,0,38,-9,-2,1,1,2,-1,3,2,-1,2,1,1,3,4,-2,2,0,-2,-6,-14,-1,-3,4,-1,0,0,-1,-1,0,-1,5,-1
KR_6764561075,420,0,43,12,-7,-1,1,0,-3,3,0,-4,6,2,0,2,2,1,1,2,0,-16,3,-1,-4,5,-4,0,1,-1,1,1,-1,3,-1
KR_6760706011,420,-2,35,-45,-1,-2,2,0,-1,3,2,-3,3,0,5,0,5,0,0,0,0,1,3,4,-10,6,1,0,0,1,-1,0,1,1,-1
KR_6745315764,420,-3,-89,4,-4,-4,5,1,5,0,5,-3,4,1,0,1,1,-2,2,0,0,1,7,1,-6,5,-4,0,-1,-1,-1,-1,1,4,-1
KR_6633134163,420,0,-8,14,0,-1,1,0,3,2,5,1,2,3,-3,4,1,0,1,1,0,-1,-6,-1,-2,3,0,0,-1,1,1,-1,-1,5,-1
KR_6757185608,420,0,-36,-4,9,4,0,4,1,3,4,5,0,5,0,4,4,-1,1,0,1,-2,-1,1,-3,2,1,0,0,-1,1,1,1,4,-1
KR_6760495719,440,-3,-40,-18,-12,-2,3,1,-7,7,0,-4,4,0,-4,5,1,5,0,5,0,-3,1,2,-7,5,-5,0,-1,1,-1,-1,-1,5,-1
KR_6534555814,420,-2,18,-28,-2,5,1,6,-2,5,3,-2,4,2,-3,3,0,0,1,1,0,0,-132,-1,-3,4,-6,0,0,-1,1,-1,1,1,-1
KR_6762489011,420,-4,12,-26,-11,-5,5,0,1,3,4,-4,5,1,-3,3,0,0,0,0,0,-8,7,3,-7,4,-3,0,-1,-1,-1,-1,1,3,-1
KR_6764486113,420,4,65,28,6,2,0,2,-2,4,2,2,0,2,-2,4,2,6,1,7,0,1,-2,2,-6,4,4,0,0,1,1,1,-1,3,-1
KR_6767932480,420,4,36,-4,8,3,1,4,-1,1,0,6,1,7,-3,6,3,3,0,3,0,2,-3,-3,-3,6,1,0,1,1,1,1,1,6,-1
KR_6680264341,420,-2,-24,-20,-8,-4,7,3,1,2,3,2,1,3,-4,7,3,-3,3,0,0,-12,-18,6,-10,4,-2,0,1,1,-1,1,-1,1,-1
KR_6446777869,420,1,-36,25,3,2,0,2,-1,6,5,2,0,2,1,0,1,-1,1,0,0,0,-52,0,-7,7,17,0,-2,-1,-1,-1,-1,5,-1
KR_6763656488,420,-1,-49,-13,1,-1,2,1,-3,6,3,3,0,3,2,1,3,0,0,0,0,-4,8,4,-7,3,-1,0,-1,1,1,-1,-1,2,-1
KR_6738768119,440,-4,-29,-28,-9,-2,2,0,0,0,0,1,2,3,-7,8,1,-1,2,1,0,-8,-1,1,-2,1,0,0,-2,-1,-1,-1,1,4,-1
KR_6651877885,420,-6,-36,4,-10,0,3,3,0,0,0,-4,5,1,-4,7,3,-2,3,1,0,-12,-22,-4,-1,5,0,0,0,1,-1,0,-1,6,-1
KR_6688757426,420,-3,-92,-17,-13,-4,5,1,-7,8,1,-4,6,2,2,0,2,0,2,2,-1,-13,7,3,-4,1,-1,0,-2,0,-1,-1,-1,0,-1
KR_6749239958,420,-5,-35,3,-16,-4,4,0,1,1,2,-1,1,0,-11,11,0,-1,1,0,0,-20,-12,-7,-2,9,1,0,-1,-1,1,-1,-1,3,-1
KR_6755479986,420,-1,-40,20,0,3,1,4,2,2,4,-1,2,1,-5,6,1,1,0,1,0,-2,-14,-4,-1,5,4,0,-1,-1,0,-1,-1,5,-1
KR_6763654744,420,-8,-6,-24,-14,-4,5,1,-3,7,4,-1,3,2,-6,8,2,0,1,1,0,-20,2,0,-5,5,-4,0,-1,-1,0,-1,1,6,-1
KR_6614661937,420,-3,-109,-32,-2,-7,8,1,1,2,3,1,0,1,1,0,1,2,0,2,0,3,-267,-1,-2,3,-1,0,0,-1,-1,-1,-1,2,-1
KR_6589641087,420,1,-5,-2,-3,1,3,4,-3,8,5,-2,4,2,1,2,3,0,2,2,0,0,-1,0,-7,7,6,0,2,-1,0,1,-1,4,-1
KR_6749103592,420,-3,-67,1,-7,-5,8,3,0,2,2,-1,2,1,-3,6,3,2,1,3,-1,-7,0,-1,-7,8,0,0,-2,-1,0,-1,-1,3,-1
KR_6767527494,420,-3,-6,0,-6,4,0,4,-4,4,0,-5,7,2,3,6,9,-4,5,1,-1,-12,-93,-2,-4,6,-3,0,1,-1,1,-1,-1,3,-1
KR_6733259847,420,-3,-28,11,-8,-1,3,2,-1,2,1,-5,5,0,2,2,4,-3,3,0,0,-9,6,6,-8,2,3,0,1,1,-1,1,-1,6,-1
KR_6751753539,420,-2,-25,-4,-3,-2,3,1,-5,6,1,2,1,3,-2,4,2,4,0,4,0,-3,108,1,-6,5,5,0,0,-1,1,0,1,1,-1
KR_6736330176,420,-4,17,12,-5,-2,5,3,-1,1,0,-1,4,3,-1,4,3,0,3,3,2,0,-3,1,-3,2,0,0,-2,1,-1,-1,1,3,-1
KR_6751127606,420,1,-18,1,1,3,0,3,3,0,3,1,4,5,-5,5,0,-1,1,0,0,-3,11,-1,-2,3,-1,0,-1,-1,-1,-1,-1,5,-1
KR_6765839077,420,-1,-85,-16,3,0,0,0,-2,5,3,-1,4,3,6,0,6,0,1,1,1,7,-27,2,-4,2,22,0,0,1,1,0,1,5,-1
KR_6764938245,420,-1,-12,-4,0,0,2,2,-3,4,1,3,3,6,0,2,2,0,2,2,0,-4,7,0,-3,3,-6,0,1,1,-1,-1,-1,3,-1
KR_6728102268,420,-5,-86,19,-12,3,1,4,-1,2,1,-2,2,0,-13,14,1,1,0,1,0,-15,14,1,-4,3,0,0,-2,-1,1,-1,-1,1,-1
KR_6710337884,420,2,-7,15,5,0,2,2,-2,3,1,5,1,6,2,0,2,0,1,1,0,-1,6,2,-6,4,-1,0,0,1,-1,0,-1,6,-1
KR_6721941062,420,-4,35,32,-8,-1,1,0,-1,2,1,-2,4,2,-3,5,2,-1,2,1,0,-9,-31,0,-5,5,-3,0,0,1,1,0,1,4,-1
KR_6762769796,420,-2,-38,20,-2,0,1,1,1,1,2,-5,6,1,1,2,3,1,1,2,1,-5,305,-2,-3,5,0,0,-1,-1,1,-1,1,5,-1
KR_6740944139,420,-2,-34,7,-6,0,3,3,1,3,4,-2,2,0,-3,5,2,-2,2,0,0,-7,-98,2,-6,4,-3,0,-2,-1,1,-1,-1,5,-1
KR_6701983273,420,0,-38,24,-1,2,0,2,1,4,5,-1,4,3,-1,2,1,-2,2,0,0,-8,8,1,-3,2,-3,0,-1,1,1,-1,-1,3,-1
KR_6636513466,420,-5,-110,-2,-14,-2,2,0,-4,5,1,-2,2,0,-5,5,0,-1,2,1,0,-16,-9,-2,-1,3,1,0,-1,1,1,-1,-1,1,-1
KR_6735659096,420,-3,-5,-48,-6,0,1,1,-1,2,1,-7,7,0,2,0,2,0,0,0,0,-4,1,-2,0,2,2,0,-1,-1,-1,-1,1,5,-1
KR_6646446931,420,2,42,5,9,2,1,3,0,3,3,2,2,4,3,5,8,2,0,2,-1,6,230,1,-6,5,3,0,1,1,-1,1,-1,4,-1
KR_6581556250,420,1,8,-14,4,-1,2,1,7,3,10,-3,4,1,-2,2,0,3,2,5,1,2,308,-2,-3,5,4,0,-3,1,-1,-1,1,2,-1
KR_6751458023,440,0,-35,-16,6,-2,3,1,2,0,2,-1,1,0,6,0,6,1,0,1,0,10,8,5,-6,1,-1,0,-1,0,-1,-1,-1,0,-1
KR_6732366470,420,-1,31,-42,8,-1,1,0,-1,3,2,2,1,3,8,0,8,0,1,1,0,8,-7,-3,-5,8,7,0,0,-1,1,1,1,1,-1
KR_6756785870,440,-1,-23,36,-2,-3,3,0,7,0,7,0,0,0,-6,7,1,0,0,0,0,1,34,2,-6,4,-2,0,-1,-1,-1,-1,-1,4,-1
KR_6726319431,420,-1,-4,-6,-3,-1,2,1,1,3,4,0,1,1,0,4,4,-3,3,0,0,-5,-32,5,-8,3,-2,0,1,-1,1,1,1,4,-1
KR_6715716443,420,-6,-64,6,-24,-3,5,2,-10,10,0,-3,3,0,-8,9,1,0,1,1,0,-19,-5,-3,-3,6,-3,0,-2,0,1,-1,-1,0,-1
KR_6735135135,420,-5,-103,-13,-13,0,1,1,6,0,6,-5,7,2,-12,12,0,-2,3,1,-1,-20,1,-7,0,7,0,0,-2,1,-1,-1,-1,5,-1
KR_6709662935,420,-4,-29,-4,0,-4,4,0,-1,2,1,2,1,3,1,1,2,2,0,2,0,4,-147,-2,-2,4,0,0,-1,0,-1,-1,1,0,-1
KR_6767344160,420,-1,-79,3,-3,-2,2,0,-3,5,2,0,1,1,5,1,6,-3,6,3,0,-4,7,-2,-2,4,-5,0,0,-1,-1,-1,1,3,-1
KR_6673223567,420,-3,-37,-12,-12,1,3,4,0,1,1,-3,4,1,-3,4,1,-7,9,2,1,-6,35,2,-4,2,-28,0,-1,-1,-1,-1,1,1,-1
KR_6762093266,420,-3,-91,5,-11,-5,6,1,-3,3,0,-1,2,1,-2,2,0,0,4,4,0,-2,15,0,-4,4,-3,0,-1,-1,1,-1,-1,6,-1
KR_6632259496,420,-2,-99,-8,-2,-8,8,0,2,1,3,0,2,2,3,5,8,1,0,1,0,3,-17,-4,-5,9,4,0,-1,-1,-1,-1,1,4,-1
KR_6755007722,420,-2,-32,-9,-6,-4,4,0,1,3,4,3,2,5,-6,8,2,0,3,3,1,5,-7,-1,-4,5,-2,0,-1,1,-1,-1,1,5,-1
KR_6762242017,420,-2,-89,-19,-8,-4,5,1,-3,6,3,1,2,3,-1,5,4,-1,2,1,0,-1,-421,-1,-3,4,3,0,-1,-1,-1,-1,-1,5,-1
KR_6706997193,420,-2,-17,-9,3,2,1,3,-1,2,1,3,1,4,0,2,2,-1,2,1,0,2,77,0,-4,4,3,0,-1,-1,-1,-1,1,5,-1
KR_6705959350,420,-3,-26,-21,4,-1,2,1,2,0,2,1,2,3,2,3,5,0,1,1,0,8,0,-6,-6,12,2,0,-1,-1,-1,-1,-1,3,-1
KR_6746412044,420,-3,7,-11,-1,-2,3,1,1,2,3,0,1,1,2,0,2,-2,2,0,0,5,11,6,-9,3,2,0,0,1,1,1,-1,2,-1
KR_6722113893,420,3,20,-14,7,-2,5,3,3,1,4,1,1,2,3,0,3,2,0,2,0,13,-2,-1,-3,4,6,0,-1,1,1,1,-1,2,-1
KR_6739625995,420,-4,-42,-7,-5,1,1,2,-2,3,1,3,1,4,-7,7,0,0,0,0,0,-6,0,-1,-4,5,1,0,-1,-1,-1,-1,-1,4,-1
KR_6755275353,420,-2,71,-40,-9,-2,4,2,-2,2,0,-2,4,2,-3,4,1,0,0,0,-1,-9,5,0,-2,2,-4,0,0,-1,1,-1,-1,5,-1
KR_6764808461,440,-2,-22,4,-8,-6,8,2,-2,4,2,-2,4,2,3,0,3,-1,5,4,-2,-14,0,1,-9,8,2,0,-1,1,-1,-1,-1,1,-1
KR_6632115441,420,-4,-27,-10,-6,-4,4,0,-2,3,1,1,0,1,-1,1,0,0,0,0,0,-4,-8,1,-5,4,0,0,-1,-1,1,-1,-1,5,-1
KR_6760018655,420,4,7,14,4,1,1,2,0,2,2,1,2,3,2,1,3,0,1,1,1,4,2,-1,-2,3,0,0,1,1,1,1,1,4,-1
KR_6641270039,420,-1,44,-20,-8,0,3,3,-2,7,5,-5,5,0,1,3,4,-2,2,0,-2,-18,1,-1,-4,5,0,0,1,1,-1,1,-1,2,-1
KR_6604002054,420,1,17,-21,4,-1,2,1,-3,5,2,4,2,6,0,3,3,4,2,6,1,5,4,-1,-5,6,2,0,0,1,-1,-1,1,5,-1
KR_6686112932,420,-2,-25,-21,-1,1,2,3,-1,3,2,-2,3,1,0,3,3,1,1,2,0,2,-6,-7,-3,10,-3,0,-1,-1,0,-1,-1,6,-1
KR_6664921760,420,-3,-28,4,-14,-3,3,0,0,3,3,-1,3,2,-6,8,2,-4,4,0,0,-11,-11,-5,-2,7,1,0,-1,1,-1,-1,-1,1,-1
KR_6648380021,420,-3,-72,-9,-1,-2,2,0,3,0,3,4,1,5,-4,5,1,-2,4,2,0,-4,-5,-5,0,5,0,0,-1,0,0,-1,-1,0,-1
KR_6743376582,420,-4,19,-36,-5,5,0,5,-9,9,0,-1,1,0,0,2,2,0,0,0,0,-5,1,3,-8,5,4,0,0,-1,-1,0,-1,5,-1
KR_6762492921,420,-5,-71,-8,-8,-1,1,0,-1,7,6,-1,3,2,-3,4,1,-2,2,0,0,-6,-4,6,-10,4,6,0,-2,1,-1,-1,-1,1,-1
KR_6761098578,420,0,25,4,-7,3,2,5,-6,8,2,-3,4,1,-2,4,2,1,0,1,0,-8,0,3,-7,4,1,0,0,1,1,1,-1,5,-1
KR_6766169082,420,-1,10,-1,-8,-2,2,0,0,1,1,-7,8,1,-2,4,2,3,0,3,0,-10,0,0,-6,6,1,0,0,-1,-1,0,1,4,-1
KR_6744785355,420,-1,-89,36,-7,-5,5,0,1,1,2,0,1,1,-3,4,1,0,2,2,-1,-6,-11,-9,-2,11,2,0,-2,-1,-1,-1,-1,4,-1
KR_6722077678,420,-3,-72,4,-2,-1,1,0,-3,6,3,-1,5,4,3,1,4,0,1,1,0,3,-407,-5,-4,9,-2,0,0,-1,1,0,1,5,-1
KR_6759805944,420,-3,-21,-35,-10,-2,2,0,-2,3,1,-3,4,1,0,2,2,-3,3,0,-1,-11,-8,2,-7,5,-4,0,-1,-1,1,-1,-1,2,-1
KR_6754357753,420,0,-2,14,-3,3,0,3,-7,8,1,1,0,1,-1,2,1,1,0,1,0,-7,-1,1,-4,3,-3,0,-1,0,0,-1,-1,0,-1
KR_6554035238,420,-1,21,-18,-5,-1,3,2,-3,3,0,-2,7,5,0,2,2,1,0,1,0,4,-10,0,-7,7,4,0,0,-1,-1,-1,-1,1,-1
KR_6692630929,420,-4,-27,-8,-9,0,3,3,-1,4,3,-2,3,1,-1,4,3,-5,7,2,-2,-15,-8,-2,-1,3,-3,0,0,1,1,-1,-1,3,-1
KR_6711587545,420,-2,-20,-4,-2,0,2,2,1,1,2,-2,3,1,0,1,1,-1,1,0,0,-1,-28,2,-4,2,2,0,-1,1,-1,-1,1,1,-1
KR_6731622979,420,4,0,1,5,-2,3,1,2,1,3,5,1,6,-1,6,5,1,1,2,0,-2,-307,-1,-5,6,1,0,0,-1,1,0,1,5,-1
KR_6672069257,420,0,44,8,-3,-2,3,1,-5,6,1,2,0,2,0,4,4,2,1,3,0,-6,29,0,-6,6,-2,0,-1,1,-1,-1,1,2,-1
KR_6756956271,420,0,-41,4,1,-1,1,0,1,1,2,2,2,4,-2,3,1,1,0,1,0,3,13,4,-7,3,-2,0,-1,1,0,-1,1,5,-1
KR_6755254308,420,-4,-23,-22,-9,-4,4,0,-3,5,2,-2,7,5,0,3,3,0,1,1,0,-1,6,-2,-3,5,2,0,-3,0,0,-1,-1,0,-1
KR_6748416445,420,-4,-64,-9,-8,-3,4,1,0,2,2,1,3,4,-2,3,1,-4,4,0,0,-4,-7,3,-5,2,-2,0,-2,-1,-1,-1,-1,5,-1
KR_6685625513,420,-2,-19,68,-8,-1,2,1,-3,7,4,2,1,3,-3,4,1,-3,3,0,0,-7,19,6,-6,0,0,0,-1,1,1,-1,-1,1,-1
KR_6759278968,420,-1,-21,-12,-1,-1,2,1,3,1,4,1,1,2,-5,6,1,1,2,3,0,-1,-333,-2,-5,7,-1,0,1,1,-1,1,-1,1,-1
KR_6595233553,420,0,-13,-15,-2,0,3,3,-4,6,2,0,2,2,0,5,5,2,1,3,0,-2,3,0,-4,4,1,0,0,0,-1,-1,-1,0,-1
KR_6627791338,420,-1,-14,19,-1,-5,5,0,5,3,8,2,1,3,-2,3,1,-1,2,1,2,3,7,1,-6,5,-5,0,-1,-1,-1,-1,1,3,-1
KR_6750236050,420,-3,-39,-37,0,-2,2,0,1,2,3,0,1,1,0,4,4,1,1,2,0,9,-2,-2,-4,6,0,0,0,-1,-1,0,1,6,-1
KR_6755832960,420,-2,-32,-3,-4,-2,2,0,-5,6,1,-1,4,3,0,0,0,4,0,4,0,3,128,0,-3,3,-2,0,1,1,-1,1,-1,5,-1
KR_6183156799,420,-1,-47,-9,-7,3,2,5,-4,5,1,-4,4,0,-1,2,1,-1,2,1,0,-5,298,0,-7,7,3,0,-1,1,1,-1,-1,1,-1
KR_6606738955,420,0,0,-14,-4,3,1,4,-5,9,4,-9,11,2,5,2,7,2,4,6,0,-1,-106,0,-3,3,-2,0,0,-1,-1,1,1,2,-1
KR_6380868819,440,2,7,36,2,0,0,0,2,2,4,6,1,7,-5,5,0,-1,2,1,0,-6,141,-1,-4,5,-5,0,0,1,1,0,1,5,-1
KR_6759590535,440,-1,5,-24,3,6,1,7,-3,3,0,-1,4,3,2,4,6,-1,1,0,0,3,4,4,-5,1,-2,0,0,-1,-1,1,1,1,-1
KR_6551631315,420,-1,-21,-24,1,-1,4,3,-3,7,4,3,3,6,1,3,4,1,0,1,0,12,2,-2,-5,7,-2,0,-1,1,-1,-1,1,6,-1
KR_6764461686,420,1,-34,-8,-5,-2,4,2,1,4,5,0,1,1,2,1,3,-6,6,0,0,-12,-14,4,-4,0,-1,0,0,1,0,0,-1,6,-1
KR_6735572310,420,-3,-6,-20,-4,5,0,5,-3,4,1,-5,6,1,0,0,0,-1,1,0,0,-6,1,-1,-4,5,-1,0,-1,-1,-1,-1,1,1,-1
KR_6757369644,440,-1,-18,-20,-7,5,3,8,-2,3,1,1,2,3,-7,8,1,-4,5,1,0,-13,-25,-2,-1,3,-6,0,-1,-1,1,1,1,2,-1
KR_6760903874,420,-3,-41,12,-9,1,0,1,-6,6,0,-1,1,0,0,2,2,-3,3,0,0,-11,14,6,-9,3,-1,0,0,-1,0,-1,-1,4,-1
KR_6764243993,420,0,-27,-15,2,3,1,4,-2,4,2,-5,7,2,0,2,2,6,0,6,1,7,-3,-1,-4,5,3,0,-1,1,1,-1,1,2,-1
KR_6725924990,420,-1,-52,-42,-5,-8,9,1,2,1,3,5,1,6,-4,5,1,0,0,0,0,6,-6,-1,-1,2,-3,0,-2,1,-1,-1,-1,5,-1
KR_6764977659,420,-1,31,-20,0,2,2,4,0,2,2,0,1,1,-3,3,0,1,0,1,0,-1,9,-2,-4,6,3,0,0,-1,-1,0,1,6,-1
KR_6728366542,420,-2,-7,-28,-3,5,0,5,2,3,5,-4,4,0,-2,5,3,-4,5,1,0,-3,-14,3,-11,8,4,0,1,-1,1,1,1,2,-1
KR_6732958593,420,-2,71,0,-5,1,1,2,-8,8,0,-3,5,2,5,1,6,0,0,0,0,-5,-41,2,-5,3,-4,0,-2,1,-1,-1,1,6,-1
KR_6760387343,420,-1,-9,-53,0,3,0,3,-2,8,6,-2,5,3,2,2,4,-1,4,3,0,12,-8,-2,-7,9,-3,0,1,-1,-1,1,1,5,-1
KR_6764099047,420,0,-4,-4,-3,0,4,4,-2,2,0,6,1,7,-7,8,1,0,2,2,-1,-9,7,1,-4,3,1,0,0,1,1,1,-1,3,-1
KR_6767455104,440,0,-107,34,7,-3,4,1,3,1,4,3,1,4,0,4,4,4,0,4,1,19,11,6,-9,3,1,0,1,1,-1,1,1,2,-1
KR_6746474942,420,0,61,-27,-9,0,1,1,-4,5,1,-1,2,1,-3,4,1,-1,1,0,0,-10,45,1,-4,3,-21,0,1,1,0,1,-1,6,-1
KR_6647359877,420,-2,-6,-9,-10,-1,4,3,-7,7,0,2,0,2,-3,3,0,-1,2,1,-1,-14,-4,4,-4,0,-7,0,0,-1,1,-1,-1,5,-1
KR_6762823988,420,3,18,20,11,4,0,4,-1,5,4,7,1,8,-4,11,7,5,1,6,2,16,-5,-4,-1,5,2,0,2,-1,1,1,1,3,-1
KR_6768043747,420,-1,-2,12,-4,-3,4,1,-4,5,1,2,3,5,2,2,4,-1,1,0,0,-5,6,-1,-3,4,-4,0,0,-1,-1,0,-1,3,-1
KR_6762484627,420,1,-59,20,3,-2,4,2,5,3,8,-2,2,0,0,4,4,2,1,3,2,7,-2,-2,-2,4,-4,0,0,1,1,0,1,6,-1
KR_6695268362,420,3,69,28,6,3,0,3,1,2,3,0,2,2,-1,1,0,3,1,4,0,1,6,-1,-5,6,0,0,0,0,-1,0,1,0,-1
KR_6733679347,420,-4,-74,0,-10,-4,7,3,-3,4,1,-3,4,1,3,2,5,-3,4,1,0,-2,-2,2,-5,3,1,0,-2,-1,-1,-1,1,4,-1
KR_6605790691,420,-5,-37,-40,-13,-4,4,0,-3,5,2,-5,5,0,-6,7,1,5,1,6,0,-7,4,6,-7,1,-3,0,-2,1,-1,-1,-1,4,-1
KR_6762089187,420,0,-4,-12,-4,-3,3,0,-3,4,1,-6,7,1,7,1,8,1,0,1,0,0,10,-2,-4,6,-5,0,-1,0,-1,-1,-1,0,-1
KR_6756528675,420,-8,-66,-18,-13,-5,5,0,-3,4,1,-4,5,1,-1,4,3,0,0,0,0,-8,3,-2,-3,5,-2,0,-2,-1,-1,-1,1,5,-1
KR_6762779334,420,-1,-41,4,-9,1,2,3,-4,4,0,1,2,3,-1,3,2,-6,6,0,-1,-15,-8,-1,-1,2,-1,0,-1,-1,-1,-1,-1,1,-1
KR_6755253160,420,-2,10,-20,-5,6,2,8,-6,6,0,-2,4,2,-1,4,3,-2,2,0,0,-12,-8,-6,-2,8,-1,0,0,-1,-1,1,1,1,-1
KR_6739815311,420,3,34,12,3,2,0,2,2,3,5,2,2,4,-3,3,0,0,0,0,0,-2,38,1,-4,3,-26,0,2,-1,1,1,1,1,-1
KR_6605990070,420,-1,-25,-8,-2,0,0,0,3,0,3,-3,4,1,-2,2,0,0,0,0,0,-2,10,0,-4,4,-2,0,0,-1,0,0,1,6,-1
KR_6743272695,420,-6,-49,-10,-12,-2,2,0,-4,7,3,-2,2,0,-5,7,2,1,0,1,0,-6,-4,-2,-1,3,3,0,-1,1,-1,-1,-1,3,-1
KR_6682569351,420,-6,-68,15,-14,-2,4,2,-4,5,1,-5,6,1,-2,5,3,-1,2,1,-1,-17,-7,-5,-4,9,0,0,-1,-1,-1,-1,-1,1,-1
KR_6729250826,420,-1,38,-2,-8,0,0,0,-2,5,3,1,3,4,-6,7,1,-1,2,1,0,-12,-21,-1,-2,3,-3,0,0,-1,-1,-1,1,2,-1
KR_6755308261,420,0,-6,-13,5,-2,4,2,1,4,5,2,0,2,4,0,4,0,0,0,0,4,-1,1,-2,1,2,0,1,-1,1,1,1,6,-1
KR_6759866527,420,-2,-19,-17,1,0,4,4,3,1,4,-2,4,2,0,5,5,0,2,2,0,0,-43,2,-7,5,8,0,-2,1,1,-1,-1,5,-1
KR_6618744772,420,-3,17,-24,-7,2,0,2,0,0,0,-1,2,1,-4,4,0,-4,5,1,0,-7,20,-3,-4,7,-3,0,-1,-1,-1,-1,-1,6,-1
KR_6661716056,420,-2,-9,-18,-11,2,1,3,-6,8,2,-7,9,2,0,3,3,0,0,0,-1,-19,2,-1,-3,4,2,0,1,-1,1,1,-1,1,-1
KR_6761894068,440,4,13,4,8,-4,4,0,6,0,6,3,0,3,4,2,6,-1,3,2,0,10,0,-3,-5,8,5,0,1,1,1,1,1,4,-1
KR_6755361154,420,0,-36,-4,0,2,0,2,-7,10,3,-1,3,2,3,2,5,3,0,3,-1,-2,7,-1,-2,3,-2,0,-1,-1,0,-1,-1,5,-1
KR_6644002234,440,-5,-71,-28,-13,-6,6,0,-3,4,1,-1,3,2,2,0,2,-5,5,0,0,-10,-2,-5,-3,8,2,0,-1,-1,-1,-1,1,5,-1
KR_6764226853,420,-4,-51,-16,-9,1,0,1,1,1,2,-4,4,0,-6,7,1,-1,1,0,0,-8,2,0,-4,4,0,0,0,-1,1,0,-1,5,-1
KR_6755384638,420,-1,-8,8,-7,3,0,3,5,0,5,-2,3,1,-7,8,1,-6,8,2,0,-10,212,-4,-3,7,1,0,-1,-1,1,-1,-1,6,-1
KR_6764393078,440,-3,35,0,-10,0,2,2,2,2,4,-8,9,1,-3,4,1,-1,2,1,0,-8,-10,-4,-1,5,-1,0,-1,1,0,-1,-1,1,-1
KR_6672644828,420,-5,-110,-4,-9,-2,2,0,1,1,2,-2,2,0,-4,4,0,-2,2,0,-1,-13,141,-4,-2,6,2,0,-3,-1,-1,-1,-1,1,-1
KR_6690754686,420,2,51,-3,6,2,0,2,-1,2,1,2,3,5,2,2,4,1,0,1,0,9,3,-3,-1,4,-1,0,-1,1,0,-1,1,1,-1
KR_6742163892,420,-2,-27,-4,-8,-1,1,0,-3,3,0,-1,3,2,0,5,5,-3,3,0,0,-5,0,-5,-3,8,6,0,-1,1,-1,-1,-1,1,-1
KR_6649547454,420,-2,-72,-8,0,-2,2,0,2,2,4,2,1,3,-1,2,1,-1,1,0,0,3,108,0,-6,6,4,0,0,-1,0,0,-1,1,-1
KR_6625243337,420,-4,-26,-44,-7,-7,8,1,4,2,6,-3,3,0,-3,3,0,2,0,2,1,-2,3,-1,-6,7,-1,0,-2,-1,-1,-1,1,6,-1
KR_6729872751,440,-2,17,-29,-8,3,1,4,0,4,4,-7,8,1,-4,5,1,0,1,1,-1,-13,-28,0,-3,3,-5,0,0,0,-1,0,-1,0,-1
KR_6710269738,420,1,30,-12,-4,0,0,0,-1,2,1,-4,5,1,1,1,2,0,0,0,0,-1,-7,1,-5,4,0,0,1,-1,-1,1,-1,1,-1
KR_6757726005,420,3,47,4,7,3,0,3,2,2,4,-1,1,0,4,0,4,-1,1,0,0,4,102,-1,-7,8,25,0,0,0,-1,0,1,0,-1
KR_6753722036,420,-2,-52,-4,-5,-1,2,1,0,2,2,0,1,1,-3,4,1,-1,3,2,1,-8,-11,1,-7,6,0,0,1,1,1,1,1,6,-1
KR_6748080645,420,-4,-130,9,-13,-1,6,5,-1,1,0,-5,8,3,-2,3,1,-4,5,1,-1,-9,2,-1,-2,3,2,0,-2,1,1,-1,-1,4,-1
KR_6765545820,420,-2,-12,25,-6,-1,2,1,-1,7,6,1,1,2,-5,7,2,0,0,0,0,-12,5,1,-3,2,-2,0,-2,-1,-1,-1,1,6,-1
KR_6638019799,420,-8,-83,-48,-18,-5,6,1,-3,3,0,-1,3,2,-9,10,1,0,0,0,0,-15,6,2,-4,2,0,0,-1,-1,1,-1,-1,5,-1
KR_6716139539,420,-2,19,-30,-8,1,2,3,-3,3,0,-5,5,0,-2,3,1,1,0,1,0,-12,-127,-2,-2,4,5,0,-1,1,-1,-1,1,6,-1
KR_6767559432,420,-1,11,-31,1,3,1,4,4,0,4,-1,3,2,-5,5,0,0,0,0,0,-2,-18,1,-4,3,-2,0,-1,-1,-1,-1,1,5,-1
KR_6678623586,420,-3,-28,-6,-8,-1,2,1,-6,8,2,-1,3,2,0,3,3,0,0,0,0,-7,10,-2,-4,6,-3,0,-1,0,-1,-1,-1,0,-1
KR_6763378887,440,3,24,8,1,0,0,0,2,1,3,-2,2,0,1,4,5,0,0,0,0,-3,33,-2,-2,4,4,0,0,-1,1,1,-1,6,-1
KR_6751158302,420,-4,-25,-52,1,1,0,1,3,1,4,2,1,3,-5,6,1,0,1,1,0,2,0,-1,-3,4,-2,0,0,-1,-1,0,1,4,-1
KR_6762199338,420,-2,1,-50,-3,6,1,7,-6,7,1,-1,3,2,-2,2,0,0,0,0,0,-7,4,2,-6,4,5,0,1,-1,1,1,1,2,-1
KR_6765772893,440,2,30,-22,5,-2,3,1,4,1,5,0,3,3,2,3,5,1,0,1,0,10,7,0,-4,4,2,0,1,0,-1,-1,-1,0,-1
KR_6659147763,440,-3,17,-16,-3,-2,3,1,-1,1,0,-4,4,0,2,1,3,2,0,2,0,2,-108,0,-4,4,2,0,0,-1,-1,-1,-1,4,-1
KR_6756856442,420,-3,-18,0,-7,0,1,1,1,2,3,-2,3,1,0,0,0,-6,7,1,1,-8,2,-2,-4,6,-1,0,0,-1,-1,0,1,1,-1
KR_6705658013,420,-2,-40,4,-9,-6,7,1,0,3,3,-3,3,0,0,0,0,0,1,1,0,-4,-3,0,-7,7,-3,0,-1,1,-1,-1,-1,3,-1
KR_6489101055,420,-2,-30,-20,5,-3,3,0,5,0,5,3,0,3,-1,2,1,1,0,1,0,10,-10,4,-6,2,-2,0,0,-1,1,0,1,4,-1
KR_6765306782,420,-2,-26,20,-5,-3,4,1,-4,4,0,0,4,4,6,1,7,-4,4,0,2,-4,-145,-3,-4,7,2,0,0,-1,-1,-1,-1,3,-1
KR_6766868444,420,-2,30,-24,-12,-6,6,0,-3,4,1,-5,5,0,2,3,5,0,0,0,0,-9,-6,-3,-2,5,-2,0,-2,0,-1,-1,-1,0,-1
KR_6656985249,440,0,-14,-10,7,-2,4,2,2,0,2,3,1,4,1,1,2,3,1,4,0,5,-120,-3,-3,6,1,0,1,-1,1,1,1,3,-1
KR_6760972882,440,2,-4,1,3,0,2,2,0,1,1,-1,2,1,1,0,1,3,1,4,0,2,12,-1,-4,5,4,0,0,1,1,1,1,6,-1
KR_6611213231,420,-4,-69,3,-6,0,2,2,-2,3,1,1,1,2,-3,4,1,-2,2,0,0,-7,1,1,-3,2,-1,0,-2,1,-1,-1,1,1,-1
KR_6765319504,420,-7,-67,12,-12,-8,9,1,-5,5,0,1,0,1,0,2,2,0,1,1,0,2,-15,-6,-3,9,2,0,-3,-1,-1,-1,-1,1,-1
KR_6763639354,440,-5,-62,-8,-12,-3,3,0,-4,4,0,-3,4,1,0,2,2,-2,2,0,0,-11,9,-1,-2,3,-2,0,-3,1,-1,-1,-1,3,-1
KR_6679873403,420,1,42,3,-2,1,1,2,-4,7,3,3,1,4,-2,3,1,0,0,0,0,-7,-22,-3,-6,9,2,0,1,-1,-1,1,-1,3,-1
KR_6673147686,420,-1,-34,-4,-6,-3,4,1,-1,8,7,2,2,4,-4,6,2,0,1,1,0,-5,-5,-4,-1,5,-4,0,-1,-1,-1,-1,1,2,-1
KR_6677249564,420,-3,-14,4,-4,-1,2,1,-2,6,4,-1,2,1,0,1,1,0,0,0,0,0,16,-3,-3,6,2,0,-1,1,0,-1,-1,1,-1
KR_6739802161,420,-1,-7,0,-2,-1,1,0,-1,4,3,-3,3,0,3,1,4,0,0,0,0,-1,16,0,-3,3,2,0,-1,-1,-1,-1,-1,2,-1
KR_6767144673,420,-1,11,16,-10,2,1,3,-3,3,0,-5,7,2,-4,4,0,0,0,0,0,-14,-16,2,-7,5,0,0,0,1,-1,0,-1,2,-1
KR_6758833148,420,-4,-62,-25,-4,-2,3,1,-2,4,2,-1,2,1,2,0,2,-1,1,0,0,3,26,-4,-2,6,2,0,-1,0,-1,-1,1,0,-1
KR_6718970870,420,-2,-51,6,-8,-7,8,1,-2,4,2,2,0,2,-2,5,3,1,0,1,1,-12,-1,-2,-4,6,0,0,-1,-1,-1,-1,1,4,-1
KR_6626997344,420,-1,-7,-9,-3,-4,4,0,1,1,2,2,2,4,-2,2,0,0,0,0,0,0,13,-2,-1,3,-6,0,-1,1,-1,-1,-1,1,-1
KR_6766000290,420,-3,-42,8,-3,-1,2,1,-4,4,0,-4,4,0,7,0,7,-1,3,2,1,4,23,2,-4,2,-4,0,1,0,0,1,1,0,-1
KR_6753009253,440,-2,-70,16,-4,-2,2,0,0,3,3,-7,7,0,1,5,6,4,1,5,-1,-8,-1,-2,-4,6,-3,0,-1,1,0,-1,-1,4,-1
KR_6742682619,420,1,70,-17,8,0,1,1,1,2,3,5,0,5,0,3,3,2,1,3,0,5,-1,3,-4,1,-1,0,1,1,-1,1,1,1,-1
KR_6760956175,420,-1,-15,16,-7,-4,4,0,-4,8,4,6,1,7,0,4,4,-5,5,0,-1,-12,3,0,-3,3,-2,0,-3,1,-1,-1,-1,5,-1
KR_6732586528,420,-1,-33,-12,0,-1,2,1,-2,4,2,0,4,4,3,0,3,0,0,0,0,4,3,2,-4,2,-1,0,0,-1,-1,-1,1,6,-1
KR_6765087021,420,-5,-113,-8,-8,-4,4,0,-1,3,2,-2,3,1,-3,3,0,2,0,2,0,-9,13,-2,-2,4,-6,0,-2,-1,-1,-1,-1,2,-1
KR_6767429528,420,-5,36,-24,-15,-7,8,1,-6,6,0,-3,5,2,1,1,2,0,1,1,0,-11,-1,-4,-1,5,9,0,0,-1,-1,-1,-1,5,-1
KR_6708172379,440,0,12,4,0,0,2,2,-3,6,3,5,0,5,-4,6,2,2,1,3,0,0,7,2,-5,3,-4,0,0,1,1,0,1,1,-1
KR_6724145001,440,0,47,-4,-3,1,1,2,-5,5,0,3,0,3,-2,5,3,0,0,0,0,-10,257,-5,-3,8,1,0,1,-1,1,1,-1,6,-1
KR_6481113218,420,-2,-14,4,-7,0,2,2,-7,7,0,5,0,5,-2,5,3,-3,3,0,0,-15,0,0,-6,6,-1,0,0,-1,1,0,-1,5,-1
KR_6711080303,420,-5,-61,-18,-13,-4,4,0,-2,3,1,-1,1,0,-4,4,0,-2,2,0,0,-10,-10,-4,-2,6,0,0,-3,1,-1,-1,-1,5,-1
KR_6759203403,420,-7,-65,-11,-20,-5,8,3,-3,3,0,-5,7,2,-3,3,0,-4,4,0,0,-12,-13,1,-4,3,-1,0,-2,0,-1,-1,-1,0,-1
KR_6760759756,440,-1,-6,-12,-1,0,2,2,3,0,3,-5,5,0,2,0,2,-1,1,0,0,-2,-4,-5,-1,6,1,0,0,1,1,0,-1,2,-1
KR_6755347446,420,0,-25,0,-2,-5,5,0,2,0,2,-3,5,2,4,0,4,0,0,0,-1,17,-2,0,-4,4,0,0,0,0,0,0,-1,0,-1
KR_6760192477,420,-1,27,13,0,3,0,3,-1,5,4,-4,4,0,2,0,2,0,0,0,0,3,-2,-3,-3,6,3,0,-1,0,1,-1,1,0,-1
KR_6722568654,420,-1,-55,15,4,2,1,3,-5,6,1,-1,3,2,4,2,6,4,1,5,2,16,7,1,-5,4,-4,0,-1,1,-1,-1,1,6,-1
KR_6765431890,420,3,-41,-8,5,1,1,2,0,1,1,-2,5,3,4,4,8,2,0,2,-1,17,-26,2,-5,3,-1,0,0,1,0,1,-1,3,-1
KR_6753480798,420,-6,-41,-43,-1,-1,2,1,-3,5,2,7,0,7,-2,3,1,-2,2,0,0,-5,235,-5,0,5,-4,0,-2,1,-1,-1,-1,2,-1
KR_6619708179,420,-2,-18,-3,-6,-5,5,0,3,2,5,-2,2,0,0,4,4,-2,7,5,0,-7,-6,-1,-5,6,0,0,-2,1,-1,-1,1,3,-1
KR_6748844609,420,1,-50,-23,1,0,2,2,0,1,1,5,0,5,-3,4,1,-1,2,1,0,-1,-45,-2,-2,4,32,0,-2,1,1,-1,-1,1,-1
KR_6762531059,420,-3,-72,-8,-8,-3,3,0,-1,1,0,0,1,1,-4,5,1,0,1,1,1,-4,5,-3,-1,4,0,0,-2,0,-1,-1,1,0,-1
KR_6754978125,420,-2,-36,-45,1,0,3,3,1,1,2,1,1,2,-2,5,3,1,0,1,0,1,7,3,-7,4,0,0,0,-1,-1,0,1,4,-1
KR_6720349174,420,2,24,-12,8,2,0,2,-2,5,3,0,1,1,4,2,6,4,0,4,0,10,-117,0,-5,5,-3,0,0,1,-1,1,-1,2,-1
KR_6185933128,440,-5,18,-28,-11,0,1,1,-5,7,2,-7,7,0,0,1,1,1,0,1,0,-10,-2,5,-9,4,-2,0,0,0,-1,0,1,0,-1
KR_6765630251,420,-3,-26,20,-6,-6,6,0,1,0,1,1,3,4,-2,3,1,0,2,2,0,-1,2,-5,0,5,-1,0,-1,1,-1,-1,1,2,-1
KR_6637240477,420,-5,-90,-16,-8,-2,4,2,1,3,4,-2,3,1,-4,7,3,-1,3,2,0,-4,-8,1,-4,3,-1,0,-2,-1,1,-1,1,4,-1
KR_6758696811,420,0,-7,16,-3,-2,3,1,-1,2,1,0,1,1,-2,4,2,2,1,3,0,3,-24,0,-2,2,2,0,0,1,1,0,-1,3,-1
KR_6605580063,420,-1,-16,-6,-6,0,0,0,-2,2,0,-2,4,2,-2,5,3,0,3,3,0,-4,54,0,-7,7,0,0,0,0,1,0,-1,0,-1
KR_6678713255,420,-2,-15,-20,4,-2,3,1,-1,3,2,6,0,6,4,0,4,-3,4,1,0,8,5,4,-5,1,-2,0,1,1,-1,-1,-1,4,-1
KR_6745728862,440,-5,-61,4,-12,-1,3,2,-2,2,0,-1,5,4,-5,6,1,-3,3,0,-1,-13,-1,-1,-3,4,2,0,-3,-1,-1,-1,-1,3,-1
KR_6746984728,420,1,-13,-7,2,1,2,3,0,2,2,-1,3,2,1,0,1,1,0,1,0,4,-9,2,-6,4,4,0,0,-1,-1,0,1,5,-1
KR_6752506009,420,0,-12,-2,-8,-1,2,1,-4,5,1,-1,2,1,-1,7,6,-1,1,0,0,-13,474,-8,-2,10,0,0,1,1,-1,1,1,4,-1
KR_6760689209,420,-2,-11,-12,-11,-1,1,0,-4,4,0,-9,10,1,3,0,3,0,0,0,0,-6,5,-1,-2,3,-5,0,1,-1,-1,-1,-1,6,-1
KR_6767007336,420,2,12,48,2,4,0,4,1,2,3,-1,3,2,-1,3,2,-1,1,0,0,1,-16,-2,-5,7,5,0,1,-1,1,1,-1,4,-1
KR_6764095689,440,1,-12,8,1,2,2,4,0,0,0,-1,2,1,0,1,1,0,1,1,1,0,10,-1,-4,5,0,0,0,1,-1,0,1,6,-1
KR_6447890235,420,-4,28,-6,-8,0,3,3,1,2,3,-6,6,0,0,3,3,-3,5,2,-2,-12,71,-5,-4,9,1,0,0,-1,-1,-1,-1,3,-1
KR_6726177980,420,-4,-62,-20,-9,-3,4,1,1,1,2,-6,6,0,-3,7,4,2,1,3,0,0,-107,0,-4,4,-3,0,-2,-1,-1,-1,-1,3,-1
KR_6625811223,420,-2,-61,3,-5,-2,3,1,-3,3,0,0,2,2,-3,5,2,3,0,3,0,-10,0,-2,-2,4,0,0,1,-1,1,1,-1,6,-1
KR_6757460554,420,1,-66,-13,2,-1,1,0,7,2,9,-1,2,1,-3,8,5,0,0,0,0,3,10,3,-3,0,1,0,0,-1,0,-1,-1,5,-1
KR_6751063293,420,1,27,4,-1,-1,2,1,-2,5,3,4,1,5,-4,6,2,2,1,3,0,1,6,4,-7,3,1,0,1,-1,1,1,-1,1,-1
KR_6748632130,420,1,28,-16,1,2,1,3,-2,2,0,2,4,6,-1,5,4,0,1,1,1,-2,-2,0,-3,3,-1,0,1,-1,1,1,1,5,-1
KR_6704835704,420,-9,-96,-36,-7,-3,3,0,-1,5,4,-1,4,3,-2,4,2,0,1,1,0,1,-7,2,-6,4,1,0,-2,-1,-1,-1,1,2,-1
KR_6731896996,440,-2,-42,-19,-5,-2,3,1,0,1,1,2,3,5,-6,6,0,1,1,2,0,-11,-2,3,-8,5,-2,0,-2,1,-1,-1,-1,3,-1
KR_6762248963,420,-2,-37,-10,-2,0,1,1,-1,1,0,-1,1,0,5,0,5,-5,6,1,0,0,42,4,-6,2,-18,0,0,-1,-1,0,-1,6,-1
KR_6627173312,420,-1,26,-20,-8,-2,3,1,-4,6,2,2,1,3,-3,4,1,-1,1,0,0,-12,228,-8,0,8,4,0,0,1,1,-1,-1,3,-1
KR_6766023929,440,-2,-127,-24,-6,0,3,3,4,0,4,-2,2,0,-5,7,2,-3,3,0,0,-4,2,-1,-3,4,-3,0,-2,-1,-1,-1,-1,3,-1
KR_6751920489,420,0,22,0,-4,0,3,3,-7,7,0,2,3,5,0,2,2,1,4,5,-2,-11,-3,-2,-1,3,-1,0,0,-1,0,-1,-1,4,-1
KR_6748446165,440,-5,-70,-40,-11,-2,2,0,-2,4,2,-1,3,2,0,2,2,-6,6,0,0,-10,15,1,-3,2,-1,0,-1,-1,-1,-1,-1,3,-1
KR_6767393707,420,-4,-52,-16,-14,-3,5,2,-5,7,2,-4,5,1,1,4,5,-3,3,0,-1,-14,-5,6,-8,2,2,0,-2,-1,-1,-1,-1,4,-1
KR_6723102794,420,-3,-75,-24,0,-1,3,2,0,1,1,0,2,2,2,1,3,-1,1,0,0,3,1,-3,-2,5,-4,0,-2,-1,-1,-1,1,5,-1
KR_6733520929,420,-4,-52,13,-4,-3,5,2,-1,2,1,0,2,2,3,0,3,-3,3,0,0,-7,-28,-3,-4,7,3,0,-2,1,-1,-1,1,2,-1
KR_6733717486,420,-5,-74,-12,-10,-1,2,1,-5,5,0,-4,4,0,-1,3,2,1,4,5,0,-20,-27,-4,-4,8,1,0,-1,1,-1,-1,-1,5,-1
KR_6730670184,420,3,71,16,4,-1,3,2,0,1,1,6,0,6,0,1,1,-1,1,0,0,1,3,3,-6,3,0,0,0,-1,-1,0,1,5,-1
KR_6673997851,420,-5,-14,-13,-9,0,1,1,-6,7,1,-1,1,0,-1,4,3,-1,2,1,0,-8,-13,1,-4,3,2,0,-2,-1,-1,-1,-1,2,-1
KR_6726168833,420,-3,-99,-56,-10,-2,4,2,-2,3,1,-2,3,1,-5,6,1,1,1,2,0,0,10,-2,-4,6,-5,0,0,0,0,0,-1,0,-1
KR_6729607659,420,2,-65,36,-3,0,2,2,2,2,4,-3,5,2,-1,2,1,-1,1,0,1,4,8,3,-6,3,1,0,1,-1,1,1,1,5,-1
KR_6554076579,420,-1,22,15,0,-1,5,4,1,1,2,-4,5,1,1,3,4,3,1,4,0,2,-89,3,-9,6,-1,0,0,-1,1,0,1,6,-1
KR_6753145723,420,-1,-60,0,-4,0,2,2,-3,5,2,2,1,3,-3,4,1,0,1,1,0,-5,35,-1,-4,5,-18,0,-1,1,-1,-1,1,5,-1
KR_6747273626,420,-4,-117,-17,-4,-2,3,1,-3,4,1,2,1,3,-1,3,2,0,0,0,0,4,-21,0,-5,5,-2,0,0,1,-1,-1,1,1,-1
KR_6733036407,420,-2,-16,-5,10,-1,2,1,5,2,7,-3,4,1,8,0,8,1,2,3,1,18,-43,3,-4,1,9,0,-1,1,1,-1,1,5,-1
KR_6755323178,420,-1,-17,2,-6,1,0,1,-7,8,1,2,0,2,-3,4,1,1,1,2,0,-7,2,-4,-1,5,4,0,0,-1,-1,0,1,4,-1
KR_6679495488,420,-3,1,11,-6,0,2,2,-3,5,2,-2,5,3,0,2,2,-1,1,0,0,2,-18,1,-5,4,-7,0,1,0,0,1,-1,0,-1
KR_6749421989,440,1,36,6,5,5,1,6,-6,6,0,1,4,5,5,0,5,0,2,2,-1,2,-12,-4,-2,6,-1,0,-1,0,1,-1,1,0,-1
KR_6642325683,420,-1,-31,-1,-3,-5,6,1,2,2,4,3,0,3,-1,2,1,-2,3,1,0,-6,-128,0,-5,5,4,0,-1,0,-1,-1,-1,0,-1
KR_6766636886,440,0,-27,32,-2,1,1,2,0,0,0,0,2,2,0,3,3,-3,3,0,0,-3,101,2,-3,1,-3,0,0,1,-1,0,-1,1,-1
KR_6749874501,420,1,-18,24,1,-1,3,2,3,3,6,2,2,4,-3,6,3,0,0,0,0,-2,18,-6,-1,7,-7,0,-1,1,-1,-1,1,3,-1
KR_6766673471,420,-2,-75,-37,-2,-3,4,1,0,1,1,-1,1,0,5,0,5,-3,3,0,0,10,2,3,-7,4,-2,0,-3,-1,-1,-1,1,4,-1
KR_6749494687,440,-3,-15,-28,-2,-1,3,2,2,1,3,4,0,4,-6,6,0,-1,1,0,-1,3,-13,-2,-3,5,4,0,-1,1,-1,-1,-1,6,-1
KR_6710947127,440,-3,-36,3,-5,0,1,1,2,2,4,-2,3,1,-4,5,1,-1,2,1,-1,-7,-14,2,-7,5,-1,0,0,1,-1,0,1,6,-1
KR_6762977544,420,0,-40,8,-6,-5,6,1,1,1,2,1,5,6,-2,3,1,-1,1,0,0,-6,7,1,-7,6,-4,0,1,0,-1,1,-1,0,-1
KR_6762839827,420,0,-7,-24,1,2,0,2,-3,4,1,3,2,5,-2,4,2,1,1,2,0,-4,2,-2,0,2,1,0,-1,1,1,-1,1,6,-1
KR_6741188422,420,-1,-69,0,-6,0,1,1,-1,2,1,-3,5,2,-1,4,3,-1,3,2,0,-9,10,4,-6,2,-5,0,0,-1,-1,0,-1,3,-1
KR_6766140259,420,-2,-87,-24,-5,2,0,2,2,1,3,0,2,2,-8,8,0,-1,2,1,1,-6,-5,1,-6,5,0,0,-2,-1,0,-1,1,3,-1
KR_6764319608,420,0,-28,-33,3,1,0,1,0,2,2,1,3,4,4,3,7,-3,3,0,0,0,74,-1,-6,7,2,0,2,-1,1,1,1,1,-1
KR_6765566098,420,-1,-4,9,-2,2,2,4,0,2,2,-2,3,1,1,1,2,-3,5,2,0,2,1,0,-4,4,3,0,0,-1,1,1,-1,2,-1
KR_6732951546,440,-4,-87,8,-8,-3,4,1,0,0,0,-2,3,1,-6,7,1,3,0,3,0,-7,-5,-3,0,3,2,0,-1,0,1,-1,-1,0,-1
KR_6694473533,420,-3,13,-19,-8,-1,3,2,-3,4,1,-1,2,1,0,3,3,-3,3,0,0,-6,-58,-4,-2,6,3,0,0,-1,-1,-1,1,2,-1
KR_6761154379,420,1,-51,-1,1,1,0,1,3,2,5,-1,4,3,-1,3,2,-1,2,1,0,4,8,9,-10,1,0,0,-1,-1,-1,-1,-1,6,-1
KR_6482457627,420,-8,-73,-57,-12,-6,7,1,-3,5,2,1,3,4,-3,3,0,-1,3,2,0,-4,17,-2,-3,5,-1,0,-3,-1,-1,-1,-1,6,-1
KR_6766576289,420,-5,-111,-4,0,0,2,2,-1,2,1,0,1,1,-1,2,1,2,1,3,0,-3,2,1,-3,2,-3,0,-2,1,-1,-1,-1,3,-1
KR_6751175808,420,0,3,-29,1,3,0,3,-3,3,0,3,0,3,-1,3,2,-1,3,2,0,-3,4,3,-7,4,0,0,-2,-1,-1,-1,1,2,-1
KR_6755324136,420,-2,-39,-40,-2,-2,3,1,-2,2,0,5,1,6,-1,5,4,-2,2,0,2,3,105,0,-3,3,-2,0,-1,-1,-1,1,1,2,-1
KR_6762746444,440,-1,9,8,2,-3,6,3,3,2,5,3,0,3,-1,3,2,0,1,1,0,2,35,2,-5,3,-4,0,1,1,-1,1,1,1,-1
KR_6763444970,440,0,74,-20,4,1,1,2,3,2,5,3,0,3,-2,2,0,-1,3,2,1,2,14,2,-4,2,0,0,0,0,1,1,1,0,-1
KR_6751862583,420,-2,-4,-19,-9,-2,2,0,2,2,4,0,2,2,-5,6,1,-4,4,0,0,-4,2,0,-5,5,-2,0,0,1,-1,0,-1,1,-1
KR_6724697687,420,-3,-109,-16,-6,-6,6,0,-1,3,2,-1,2,1,2,1,3,0,0,0,0,-4,14,1,-3,2,-1,0,-1,-1,1,-1,1,2,-1
KR_6764173036,420,-1,-16,12,-5,0,2,2,3,3,6,-6,7,1,0,3,3,-2,3,1,0,-1,-11,2,-4,2,-1,0,-1,-1,1,-1,-1,1,-1
KR_6753192526,420,-6,-93,-40,-3,-7,8,1,0,0,0,3,3,6,1,4,5,0,3,3,1,3,-7,-1,-5,6,3,0,-2,1,1,-1,1,4,-1
KR_6753572617,420,2,-49,26,-1,-3,5,2,-1,3,2,3,1,4,1,0,1,-1,1,0,0,3,-13,-1,-4,5,0,0,-2,-1,-1,-1,-1,4,-1
KR_6748395457,420,-3,-86,15,-11,-4,4,0,-1,2,1,-4,4,0,-1,4,3,-1,1,0,0,-8,0,-3,-2,5,-4,0,-3,-1,0,-1,-1,3,-1
KR_6723287005,420,-3,-61,-30,-6,-2,3,1,0,5,5,-1,5,4,-2,2,0,-1,2,1,0,-6,-6,-5,-3,8,-4,0,-1,-1,-1,-1,1,1,-1
KR_6763234509,440,-1,39,-29,1,4,2,6,-3,3,0,1,2,3,3,0,3,-4,4,0,0,7,15,4,-7,3,-3,0,0,0,1,0,-1,0,-1
KR_6593228713,420,-8,-77,-1,-19,-8,8,0,-5,7,2,2,1,3,-6,6,0,-2,2,0,0,-18,-3,-4,-2,6,-8,0,-2,-1,1,-1,-1,3,-1
KR_6672368713,420,0,-20,-16,2,4,0,4,0,2,2,-4,6,2,0,3,3,2,0,2,0,5,5,2,-5,3,-1,0,0,-1,0,0,1,4,-1
KR_6551543227,420,-3,-46,-21,-9,-2,3,1,-4,4,0,0,4,4,-3,3,0,0,0,0,0,-4,6,0,-5,5,3,0,0,-1,1,0,-1,6,-1
KR_6706698540,420,-2,-53,-8,-7,1,1,2,-4,6,2,-2,4,2,-2,4,2,0,1,1,0,-9,-30,-2,-6,8,-4,0,0,-1,-1,-1,-1,1,-1
KR_6705766324,420,-2,-49,8,-5,-2,3,1,-1,2,1,-6,6,0,2,3,5,2,0,2,0,-3,2,2,-5,3,-2,0,0,1,1,-1,1,5,-1
KR_6763610210,420,-4,-29,-16,-6,-2,2,0,-6,6,0,-5,5,0,7,3,10,0,1,1,0,-8,6,2,-3,1,-4,0,-1,1,-1,-1,-1,2,-1
KR_6761839110,440,-3,-21,-14,-14,-5,5,0,-2,5,3,-7,9,2,-2,3,1,2,2,4,0,-5,175,9,-9,0,-4,0,-2,1,-1,-1,-1,4,-1
KR_6642984576,420,2,-3,-8,8,1,2,3,-4,7,3,8,1,9,3,1,4,0,1,1,1,2,-5,-2,-2,4,1,0,0,1,1,0,1,1,-1
KR_6762431505,420,1,55,-20,-2,2,2,4,1,2,3,1,2,3,-4,6,2,-2,3,1,0,-3,-14,-1,-3,4,-2,0,0,-1,0,1,-1,2,-1
KR_6746554902,440,-2,-17,-32,-6,-1,3,2,-2,3,1,-4,5,1,0,3,3,1,1,2,0,0,-9,-3,-1,4,0,0,-1,0,-1,-1,-1,0,-1
KR_6670370607,420,-1,-35,-37,1,9,1,10,-4,6,2,2,2,4,-4,6,2,-2,4,2,-3,3,17,6,-8,2,-9,0,0,-1,-1,0,-1,1,-1
KR_6753228336,420,-3,-35,9,-2,-5,6,1,-2,4,2,2,1,3,1,0,1,2,0,2,0,1,-2,-4,-1,5,0,0,-3,-1,1,-1,-1,3,-1
KR_6752272510,420,-1,-20,-1,-2,-2,3,1,-1,5,4,1,1,2,0,3,3,0,1,1,0,1,1,6,-9,3,-2,0,0,1,-1,1,-1,1,-1
KR_6754970269,440,0,35,-20,-8,-4,5,1,-2,6,4,-2,3,1,1,2,3,-1,1,0,0,-11,4,1,-4,3,-1,0,0,0,0,0,-1,0,-1
KR_6663887807,420,-1,-30,-24,-5,1,2,3,0,0,0,2,2,4,-5,5,0,-3,3,0,0,-12,-18,-3,-2,5,2,0,0,1,1,1,1,4,-1
KR_6673186121,420,2,18,11,12,4,1,5,6,0,6,0,3,3,1,3,4,1,1,2,0,11,46,0,-4,4,-1,0,2,1,1,1,1,1,-1
KR_6761229021,440,-1,-63,4,-6,2,0,2,-2,3,1,1,2,3,1,0,1,-8,8,0,0,-10,-7,0,-5,5,0,0,0,-1,1,-1,-1,5,-1
KR_6761924025,440,-2,-79,-3,1,-2,4,2,3,0,3,-3,4,1,3,3,6,0,2,2,0,9,-8,-2,-5,7,-2,0,-2,1,-1,-1,1,5,-1
KR_6763427677,440,0,-19,32,-5,-1,3,2,5,0,5,-3,5,2,-5,5,0,-1,1,0,0,-6,153,0,-4,4,10,0,-2,0,-1,-1,-1,0,-1
KR_6704827013,420,0,13,-16,5,5,1,6,-4,5,1,0,0,0,2,2,4,2,0,2,1,10,15,4,-7,3,-1,0,4,1,1,1,1,6,-1
KR_6761766443,440,-2,-36,-35,-2,-4,4,0,2,1,3,3,0,3,-1,3,2,-2,2,0,0,0,-113,-4,-2,6,-1,0,-3,-1,-1,-1,-1,4,-1
KR_6758076626,440,-1,32,-12,-6,-1,1,0,-7,7,0,3,3,6,1,2,3,-2,2,0,1,-18,-34,-1,-7,8,-1,0,0,-1,1,0,-1,5,-1
KR_6631565834,420,-4,-18,0,-8,1,1,2,-2,7,5,0,1,1,-5,5,0,-2,4,2,0,-1,-15,-1,-4,5,-3,0,-1,1,-1,-1,-1,6,-1
KR_6745905102,420,2,39,-28,3,-1,1,0,4,4,8,2,0,2,-2,2,0,0,0,0,0,7,18,1,-4,3,-3,0,1,-1,1,1,1,6,-1
KR_6665871089,420,-1,12,-13,-7,1,1,2,-1,4,3,-6,7,1,-1,1,0,0,2,2,0,-5,21,3,-6,3,-7,0,0,-1,1,0,1,3,-1
KR_6607003307,420,-1,-1,-6,-12,0,3,3,-1,4,3,-10,12,2,-4,4,0,3,1,4,-2,-7,6,-2,-1,3,0,0,-2,-1,1,-1,-1,4,-1
KR_6708910974,440,-2,-30,6,-12,-3,4,1,-1,2,1,-4,8,4,-3,3,0,-1,2,1,0,-16,245,1,-8,7,2,0,0,-1,-1,0,-1,1,-1
KR_6763489399,420,-6,-16,-41,-23,-4,5,1,0,1,1,-2,4,2,-15,15,0,-2,3,1,-2,-20,-13,-2,-1,3,-13,0,-2,-1,-1,-1,-1,2,-1
KR_6750337392,420,-1,-91,2,-10,-1,2,1,-6,7,1,-4,6,2,5,1,6,-4,5,1,0,-1,-161,2,-5,3,-3,0,-3,-1,-1,-1,-1,2,-1
KR_6764299560,420,-3,-57,15,-12,3,2,5,-5,6,1,-4,7,3,-6,6,0,0,0,0,0,-16,24,2,-6,4,-2,0,-1,-1,-1,-1,1,1,-1
KR_6766123558,420,-5,-35,-24,-12,-1,1,0,-4,6,2,-1,5,4,-2,3,1,-4,4,0,0,-12,-187,-7,0,7,2,0,-3,1,-1,-1,-1,1,-1
KR_6526366595,420,0,-36,-38,0,4,0,4,3,2,5,-2,4,2,-3,6,3,-2,5,3,-1,7,-1,0,-2,2,-2,0,-1,-1,-1,-1,-1,1,-1
KR_6725725255,420,-4,-51,10,0,-5,5,0,-1,4,3,-2,3,1,7,2,9,1,2,3,0,10,56,1,-5,4,0,0,-1,1,-1,-1,1,6,-1
KR_6676464848,420,-1,-1,14,-9,2,0,2,-5,5,0,-5,6,1,-1,3,2,0,1,1,0,-11,-17,-6,-2,8,1,0,-1,0,-1,-1,1,0,-1
KR_6735195664,420,-1,21,20,-3,-3,3,0,3,1,4,-5,6,1,0,2,2,2,0,2,0,-1,-3,0,-2,2,4,0,0,1,0,0,-1,3,-1
KR_6679105962,420,-9,-72,-32,-14,-4,5,1,-4,4,0,0,2,2,-3,5,2,-3,3,0,0,-3,7,0,-1,1,0,0,-3,-1,-1,-1,-1,2,-1
KR_6749324125,420,-3,-123,4,-11,-6,7,1,-3,4,1,0,4,4,-1,3,2,-1,2,1,2,-6,-4,-2,-2,4,-2,0,-4,-1,-1,-1,1,5,-1
KR_6761770366,420,5,33,27,10,3,0,3,5,0,5,1,6,7,-1,4,3,2,0,2,-1,9,-3,0,-3,3,5,0,0,0,1,1,-1,0,-1
KR_6621067812,420,-1,-40,-4,3,5,0,5,-3,5,2,5,1,6,-1,2,1,-3,5,2,0,-9,-7,-2,-5,7,2,0,-1,1,1,-1,-1,3,-1
KR_6742290818,440,-2,12,-6,-7,-5,5,0,0,2,2,-2,3,1,1,0,1,-1,2,1,0,-10,4,0,-5,5,-5,0,-1,-1,-1,-1,1,2,-1
KR_6538545930,420,-4,28,-9,-4,0,2,2,0,3,3,0,2,2,-4,4,0,0,0,0,0,-2,280,2,-5,3,-2,0,1,-1,1,1,1,5,-1
KR_6767155719,420,-1,13,-8,-6,-2,2,0,-1,2,1,1,1,2,-5,5,0,1,0,1,0,-6,-10,1,-5,4,-1,0,0,-1,1,0,-1,3,-1
KR_6698766246,420,-4,-78,23,-8,-5,5,0,-2,5,3,-1,4,3,2,3,5,-2,2,0,0,1,2,0,-4,4,-2,0,-1,-1,1,-1,-1,2,-1
KR_6739073800,420,-2,3,-39,-10,-1,2,1,-7,11,4,-1,1,0,0,2,2,-1,1,0,-2,-11,422,-5,-2,7,-20,0,1,-1,-1,-1,-1,6,-1
KR_6683865109,420,0,-14,5,3,1,2,3,0,2,2,1,1,2,2,2,4,-1,3,2,0,3,25,2,-7,5,-1,0,0,1,1,0,1,2,-1
KR_6731494282,420,0,10,27,1,1,1,2,1,1,2,-5,6,1,4,1,5,0,3,3,0,5,186,-2,-1,3,5,0,-2,-1,-1,-1,1,3,-1
KR_6705304488,420,-4,-18,-32,-5,-4,4,0,-1,2,1,-3,4,1,3,4,7,0,1,1,0,-5,5,1,-6,5,6,0,1,1,-1,1,-1,6,-1
KR_6757132582,420,0,0,-27,-3,-4,5,1,4,5,9,-2,3,1,-1,2,1,0,3,3,0,1,7,6,-8,2,0,0,0,-1,-1,0,1,3,-1
KR_6740562631,440,1,-81,4,5,0,1,1,-1,2,1,3,2,5,-1,1,0,4,0,4,0,6,-5,0,-5,5,2,0,-1,1,-1,-1,-1,2,-1
KR_6767222531,420,-1,10,-43,0,0,1,1,4,0,4,-4,4,0,0,2,2,0,1,1,0,-2,-36,-1,-3,4,18,0,0,-1,-1,-1,1,4,-1
KR_6655598921,420,-6,-113,-38,-6,-5,5,0,-1,4,3,-1,1,0,5,0,5,-4,4,0,0,-2,-322,0,-2,2,-1,0,-1,-1,-1,-1,-1,3,-1
KR_6569447763,440,1,17,12,-1,1,1,2,3,2,5,-4,5,1,-1,1,0,0,1,1,0,0,-9,-3,-4,7,3,0,-1,1,-1,-1,-1,5,-1
KR_6646137271,420,-1,-16,-1,0,-1,1,0,-1,2,1,5,2,7,-2,6,4,-1,1,0,0,1,2,3,-6,3,0,0,0,1,-1,-1,1,2,-1
KR_6764482122,420,2,-20,40,2,1,3,4,2,0,2,0,4,4,0,1,1,-1,1,0,0,-4,124,0,-2,2,-2,0,0,1,0,0,-1,1,-1
KR_6744456149,420,-2,-91,0,-5,0,1,1,-2,4,2,-2,4,2,0,0,0,-1,4,3,0,-8,-3,-1,-4,5,-1,0,-1,0,-1,-1,-1,0,-1
KR_6759422327,420,1,56,-4,-3,-4,4,0,-2,5,3,-4,5,1,3,0,3,4,0,4,0,3,-69,-2,-4,6,5,0,-1,-1,-1,-1,-1,6,-1
KR_6680895491,420,-6,-95,10,-19,-5,5,0,-5,5,0,-4,5,1,-4,5,1,-1,1,0,-1,-19,2,2,-5,3,-2,0,-3,1,-1,-1,-1,6,-1
KR_6762426500,420,-3,4,-19,-11,-1,3,2,-2,2,0,1,0,1,-4,6,2,-5,5,0,0,-11,-28,5,-8,3,-1,0,-1,-1,-1,-1,1,4,-1
KR_6745323032,420,-5,-48,-4,-6,-3,4,1,-1,1,0,1,3,4,-2,2,0,-1,1,0,-1,-11,19,-1,-3,4,22,0,0,1,-1,0,-1,4,-1
KR_6665774702,420,0,20,8,3,2,0,2,2,2,4,-1,4,3,1,4,5,-1,3,2,0,4,1,1,-4,3,-1,0,0,0,1,0,1,0,-1
KR_6327141805,440,-7,-7,-8,-18,-6,8,2,-2,2,0,0,3,3,-5,5,0,-5,5,0,0,-11,34,-1,-4,5,-4,0,-1,-1,-1,-1,-1,2,-1
KR_6759860422,420,-2,-63,-26,-7,1,0,1,-4,5,1,0,1,1,-5,6,1,1,3,4,-1,-2,210,1,-6,5,-4,0,-1,-1,-1,-1,-1,6,-1
KR_6702715460,420,-3,-52,32,-5,1,2,3,-3,3,0,-5,5,0,-1,3,2,3,1,4,0,1,-7,3,-6,3,0,0,0,-1,1,0,1,2,-1
KR_6746605996,420,-3,-29,29,-4,-3,5,2,-3,5,2,0,1,1,3,2,5,-1,2,1,0,0,-1,2,-7,5,1,0,-1,1,1,-1,1,6,-1
KR_6608196457,420,-1,11,-12,-4,-4,4,0,-2,3,1,2,0,2,0,3,3,0,2,2,0,-3,-50,0,-5,5,13,0,0,-1,1,0,-1,6,-1
KR_6746605429,440,-4,-34,-28,1,1,0,1,-1,2,1,-4,5,1,4,2,6,1,1,2,-1,-2,-3,-1,-2,3,-3,0,-1,-1,-1,-1,-1,2,-1
KR_6742079368,420,2,17,20,6,0,0,0,3,0,3,-2,3,1,4,0,4,1,2,3,0,9,4,4,-7,3,-3,0,0,1,1,1,1,3,-1
KR_6554062682,420,-3,-90,21,-4,-3,5,2,-1,3,2,-3,3,0,2,1,3,1,2,3,0,-2,3,-3,-2,5,-5,0,-1,-1,1,-1,-1,6,-1
KR_6702816920,420,0,-76,-5,-6,-2,4,2,2,6,8,-2,3,1,-3,5,2,-1,3,2,0,-8,-6,-2,-3,5,2,0,0,-1,-1,-1,-1,5,-1
KR_6756554131,420,-6,-75,-8,-12,-2,3,1,-10,11,1,-3,6,3,4,0,4,-1,3,2,-1,-5,-12,-3,-1,4,0,0,-2,-1,-1,-1,-1,5,-1
KR_6661442151,420,-4,17,-36,-7,3,1,4,-2,5,3,-3,5,2,-3,5,2,-2,2,0,0,-11,-7,0,-4,4,3,0,-1,-1,-1,-1,1,3,-1
KR_6762661583,420,-2,-28,-4,-4,3,2,5,-1,3,2,1,3,4,-7,8,1,0,0,0,0,-10,-3,1,-5,4,0,0,0,0,1,1,1,0,-1
KR_6751267112,420,-5,-67,-36,-11,-1,2,1,-7,9,2,1,1,2,-5,10,5,1,1,2,0,-11,-12,-1,-3,4,2,0,-1,-1,0,-1,-1,3,-1
KR_6694386685,420,-3,-52,-4,-8,-2,3,1,-2,6,4,-3,3,0,0,2,2,-1,3,2,1,-9,-9,-3,0,3,-3,0,-2,-1,-1,-1,1,3,-1
KR_6755988417,420,2,47,-1,2,-1,2,1,0,3,3,1,3,4,2,1,3,0,0,0,1,4,-45,5,-9,4,33,0,-1,1,-1,-1,1,1,-1
KR_6686086493,420,-2,-60,12,-10,-1,2,1,-4,5,1,-1,2,1,-2,2,0,-2,2,0,0,-13,18,-5,-5,10,-5,0,0,-1,-1,-1,-1,2,-1
KR_6760539692,420,-3,27,-12,-6,-3,4,1,-4,5,1,-1,2,1,-1,2,1,3,1,4,0,-2,-28,-6,-1,7,1,0,1,1,-1,1,-1,1,-1
KR_6731623496,420,-3,-75,-10,-3,-1,1,0,1,2,3,-3,4,1,-2,4,2,2,2,4,0,4,2,2,-6,4,-4,0,-1,1,-1,-1,-1,6,-1
KR_6727716766,440,-3,0,-22,-2,-1,4,3,-4,8,4,2,1,3,-1,5,4,2,1,3,1,2,-23,-2,-3,5,0,0,0,-1,1,0,1,6,-1
KR_6319117983,420,-6,-29,-32,-7,2,0,2,-6,8,2,-5,6,1,4,0,4,-2,2,0,0,-4,4,2,-6,4,-4,0,-2,-1,-1,-1,-1,5,-1
KR_6639938321,420,-2,-76,-1,-2,0,2,2,-2,4,2,1,0,1,0,2,2,-1,1,0,0,-7,3,4,-9,5,-1,0,-1,1,1,-1,-1,5,-1
KR_6644093642,420,-3,28,-4,-8,1,1,2,-3,5,2,-2,3,1,-3,3,0,-1,1,0,0,-8,50,-4,-2,6,-27,0,0,-1,-1,-1,-1,5,-1
KR_6755442189,420,-2,-98,-18,-5,1,1,2,-1,3,2,-3,4,1,-1,2,1,-1,2,1,-1,-6,2,3,-5,2,-1,0,-2,-1,-1,-1,-1,2,-1
KR_6767563898,420,-2,-48,20,-4,-3,3,0,0,1,1,-7,7,0,4,1,5,2,0,2,0,-5,-11,0,-2,2,2,0,0,0,-1,1,-1,0,-1
KR_6722205181,420,-2,-35,14,-2,-1,2,1,-2,7,5,3,1,4,-2,2,0,0,1,1,0,-2,4,-2,-5,7,3,0,0,1,-1,0,-1,5,-1
KR_6739905117,420,-2,4,-51,-6,-2,3,1,-1,7,6,1,2,3,-1,2,1,-3,3,0,-1,-5,-67,2,-3,1,-3,0,-2,-1,-1,-1,-1,4,-1
KR_6703018670,420,3,9,5,4,1,2,3,4,1,5,0,3,3,0,3,3,-1,1,0,0,0,-1,3,-6,3,5,0,-1,-1,-1,-1,-1,2,-1
KR_6695624299,420,0,-52,43,-5,-2,2,0,1,2,3,0,4,4,-3,3,0,-1,1,0,1,-4,7,0,-4,4,2,0,-2,1,-1,-1,1,3,-1
KR_6615292635,420,-1,-1,33,-7,-5,5,0,0,2,2,-1,3,2,1,2,3,-2,3,1,0,1,-297,4,-7,3,-4,0,0,1,-1,0,-1,4,-1
KR_6467156492,420,-5,-40,-8,-11,-2,5,3,-2,4,2,-4,5,1,-3,5,2,0,2,2,-1,0,-3,4,-10,6,-1,0,0,1,1,1,-1,6,-1
KR_6765385565,420,-4,-75,8,-12,-4,4,0,-1,4,3,-4,8,4,-2,4,2,-1,2,1,0,3,3,-3,-2,5,-12,0,0,0,-1,-1,-1,0,-1
KR_6736527671,420,-5,-102,-20,-10,1,0,1,-2,2,0,-7,9,2,-2,3,1,0,1,1,0,-5,-7,1,-4,3,-1,0,-1,-1,0,-1,-1,3,-1
KR_6606093213,420,0,-13,-10,0,2,0,2,1,3,4,-2,2,0,-2,3,1,1,4,5,0,-5,-3,2,-7,5,0,0,-1,1,-1,-1,-1,1,-1
KR_6765976604,420,1,27,0,-1,5,0,5,-3,4,1,3,0,3,-5,7,2,-1,2,1,0,-10,8,-3,-3,6,-1,0,0,-1,1,-1,-1,1,-1
KR_6761962007,420,-4,-59,-12,-15,-2,2,0,-2,4,2,-6,9,3,-5,7,2,0,2,2,-1,-15,-2,-4,-2,6,4,0,-1,-1,-1,-1,-1,4,-1
KR_6375290629,420,-2,47,-32,6,-1,2,1,-4,5,1,2,1,3,6,0,6,3,0,3,2,11,0,0,0,0,0,0,0,1,1,0,1,2,-1
KR_6715484323,420,-1,0,-16,-7,-8,9,1,-1,1,0,2,2,4,-1,3,2,1,1,2,0,-5,-103,-2,-2,4,1,0,-1,-1,1,-1,-1,5,-1
KR_6704455870,420,-1,-79,34,1,2,0,2,2,1,3,2,1,3,-5,5,0,0,0,0,0,5,0,-2,-3,5,-2,0,0,1,1,-1,-1,2,-1
KR_6761152301,420,-1,-23,-3,-6,-1,5,4,-1,1,0,-1,4,3,-4,5,1,1,1,2,-1,-5,0,-2,-4,6,1,0,0,1,-1,1,-1,3,-1
KR_6716512609,420,-5,-83,-22,-11,-6,8,2,0,6,6,3,1,4,-6,8,2,-2,3,1,-2,-10,15,1,-3,2,-1,0,-3,-1,-1,-1,-1,6,-1
KR_6761906930,440,3,41,56,1,1,1,2,-6,10,4,1,2,3,3,2,5,2,1,3,0,-2,2,0,-3,3,-1,0,0,1,1,1,-1,6,-1
KR_6761592391,420,-2,-40,-5,-13,-5,6,1,2,1,3,-4,6,2,-8,8,0,2,1,3,0,-8,88,-4,-4,8,-3,0,-1,-1,1,-1,-1,1,-1
KR_6755076854,420,-1,14,-8,0,-1,1,0,1,1,2,1,1,2,-1,5,4,0,0,0,0,2,8,4,-8,4,2,0,-2,-1,-1,-1,-1,4,-1
KR_6682095339,440,-2,-16,-24,3,0,2,2,3,1,4,2,2,4,0,2,2,-2,2,0,0,-1,-13,-1,-4,5,1,0,1,1,1,1,-1,1,-1
KR_6604058296,420,0,13,-6,-2,0,1,1,0,1,1,-3,6,3,1,2,3,0,2,2,0,4,-6,6,-8,2,-3,0,0,1,-1,-1,-1,6,-1
KR_6675893164,420,-1,-64,-8,1,0,1,1,4,1,5,-9,9,0,4,1,5,2,0,2,0,12,218,0,-2,2,0,0,1,1,1,1,-1,3,-1
KR_6750142818,420,-2,50,-32,-2,1,1,2,-2,5,3,-1,4,3,0,7,7,0,1,1,0,1,0,-5,-2,7,1,0,0,1,1,1,1,6,-1
KR_6767081174,440,1,-88,8,5,-5,5,0,4,2,6,3,0,3,5,0,5,-2,2,0,0,10,6,1,-7,6,0,0,0,1,-1,-1,-1,6,-1
KR_6766198313,420,4,21,20,9,2,1,3,2,0,2,5,2,7,-4,6,2,4,0,4,0,-1,-65,-2,-2,4,0,0,0,-1,1,1,-1,6,-1
KR_6680626468,420,2,18,-8,8,-1,2,1,1,1,2,4,1,5,2,2,4,2,0,2,0,3,3,6,-9,3,-6,0,0,-1,1,0,-1,1,-1
KR_6759606454,420,-3,-27,8,-2,-2,2,0,-3,4,1,5,0,5,-2,3,1,0,1,1,0,2,-15,4,-7,3,2,0,-2,-1,-1,-1,1,2,-1
KR_6762680666,420,-4,-1,-29,-9,-2,2,0,-3,3,0,-4,8,4,-1,4,3,1,0,1,0,-10,2,2,-6,4,2,0,0,-1,0,1,-1,6,-1
KR_6764566890,420,-3,-53,-26,-9,-12,12,0,5,2,7,3,0,3,-5,6,1,0,0,0,0,0,6,-1,0,1,3,0,-4,-1,-1,-1,-1,2,-1
KR_6750912111,420,-1,12,1,-1,2,2,4,-3,3,0,2,2,4,0,2,2,-2,2,0,1,-2,23,-3,-3,6,2,0,0,-1,-1,-1,1,3,-1
KR_6753269058,420,-2,-50,-24,2,3,1,4,3,2,5,-5,5,0,2,1,3,-1,1,0,0,8,8,1,-6,5,0,0,0,0,1,0,1,0,-1
KR_6762742901,420,2,-32,12,5,3,2,5,1,1,2,2,0,2,0,1,1,-1,1,0,0,-3,-1,3,-8,5,-5,0,0,1,1,1,-1,6,-1
KR_6635537401,420,-3,-12,-13,-5,2,0,2,-5,7,2,-1,1,0,0,2,2,-1,1,0,-1,-9,-22,-1,-4,5,-2,0,0,-1,1,-1,-1,1,-1
KR_6658716100,420,2,-4,3,0,2,0,2,2,2,4,1,3,4,-5,5,0,0,0,0,0,-4,-22,-3,-3,6,2,0,0,-1,0,0,-1,1,-1
KR_6752389429,420,-4,-49,6,-5,4,0,4,-9,11,2,3,1,4,-2,2,0,-1,1,0,0,-7,8,-4,-1,5,0,0,-1,1,-1,-1,-1,5,-1
KR_6742027623,420,-1,4,-29,2,0,1,1,-4,6,2,5,2,7,1,2,3,0,0,0,0,3,9,-2,-5,7,2,0,0,-1,1,1,1,3,-1
KR_6761724198,420,-2,-47,2,-6,0,1,1,-2,4,2,1,2,3,-4,4,0,-1,2,1,0,-7,-3,1,-4,3,-1,0,0,0,0,0,1,0,-1
KR_6752613648,440,2,17,-13,2,4,0,4,1,3,4,0,2,2,-4,4,0,1,1,2,0,-4,-334,3,-5,2,-2,0,0,1,-1,-1,1,1,-1
KR_6765659166,420,-1,-8,12,-4,-4,5,1,-4,4,0,1,2,3,2,3,5,1,2,3,0,-6,-46,1,-7,6,26,0,0,1,1,1,1,5,-1
KR_6752187609,420,2,-27,5,-1,1,1,2,-3,4,1,2,1,3,-2,2,0,1,0,1,0,-1,19,-2,-4,6,6,0,0,1,1,1,1,6,-1
KR_6543771938,420,2,32,26,4,0,2,2,2,1,3,-3,3,0,5,1,6,0,2,2,0,5,4,1,-4,3,1,0,0,-1,-1,-1,1,1,-1
KR_6748484843,440,3,35,8,9,0,1,1,6,3,9,2,0,2,-4,7,3,5,2,7,-1,6,-30,3,-3,0,1,0,-1,1,1,1,-1,5,-1
KR_6747607672,420,-7,-81,-16,-21,-2,2,0,-6,6,0,-6,6,0,-4,6,2,-3,5,2,0,-27,0,2,-3,1,-3,0,-2,-1,-1,-1,-1,3,-1
KR_6709281574,440,-4,1,-9,-8,0,1,1,0,3,3,-4,5,1,-6,7,1,2,0,2,0,-8,-130,1,-5,4,-4,0,-2,1,-1,-1,1,2,-1
KR_6753025254,420,0,63,12,-1,0,1,1,-4,6,2,2,2,4,1,0,1,0,0,0,-1,-6,2,2,-6,4,4,0,2,-1,1,1,-1,1,-1
KR_6562090990,420,2,-22,21,9,2,1,3,2,1,3,-2,2,0,1,1,2,6,2,8,1,10,-35,-5,-3,8,3,0,0,-1,-1,0,1,5,-1
KR_6730198136,440,-7,-68,-16,-13,-5,5,0,0,2,2,-2,5,3,-6,6,0,0,5,5,0,-21,-7,-7,-3,10,-2,0,-1,-1,-1,-1,-1,6,-1
KR_6705336334,440,-2,-96,-5,-3,-3,3,0,0,4,4,3,1,4,1,4,5,-4,4,0,1,-2,-7,-2,-5,7,3,0,0,1,0,-1,1,5,-1
KR_6764991915,420,0,37,-5,-5,-3,5,2,1,4,5,0,2,2,0,2,2,-3,3,0,1,6,98,-2,-3,5,2,0,1,-1,-1,1,1,5,-1
KR_6731612110,420,3,-38,-5,4,-1,5,4,0,2,2,7,1,8,-1,1,0,-1,1,0,0,1,4,1,-7,6,-2,0,-1,-1,1,1,1,6,-1
KR_6729670605,420,-2,33,20,-2,-6,6,0,0,0,0,2,1,3,3,0,3,-1,1,0,0,0,13,2,-2,0,-1,0,0,1,-1,-1,-1,4,-1
KR_6720724641,420,-2,-64,32,-6,-6,8,2,8,0,8,-6,8,2,-3,4,1,1,0,1,-1,-5,-6,4,-7,3,-3,0,-2,1,-1,-1,-1,1,-1
KR_6728807630,420,-1,-44,-9,-6,1,2,3,-4,6,2,-1,2,1,0,2,2,-2,3,1,-1,-6,136,0,-5,5,-4,0,0,0,-1,-1,-1,0,-1
KR_6753172342,420,-1,-26,-4,-7,0,3,3,-3,5,2,-5,6,1,1,1,2,0,0,0,0,-8,9,4,-5,1,-3,0,-1,-1,1,-1,-1,2,-1
KR_6767332934,420,3,-27,23,7,-5,6,1,5,0,5,3,2,5,3,1,4,1,0,1,0,11,-2,-2,-4,6,1,0,-1,1,0,-1,1,5,-1
KR_6713757242,420,-2,67,5,-6,0,3,3,-3,3,0,2,2,4,-1,2,1,-4,5,1,0,-5,6,-3,-5,8,-1,0,1,-1,-1,1,1,1,-1
KR_6761565075,420,-1,-45,3,2,1,1,2,-1,4,3,2,1,3,1,4,5,-1,2,1,0,0,-103,2,-6,4,2,0,-1,1,1,-1,-1,6,-1
KR_6758030500,420,-2,-49,-24,-4,-2,2,0,0,1,1,-1,3,2,0,1,1,-1,1,0,0,-1,-3,-3,-1,4,0,0,-1,-1,-1,-1,-1,3,-1
KR_6757553371,420,2,26,-1,-3,-1,3,2,-1,2,1,3,1,4,-4,4,0,0,0,0,-1,-9,-2,2,-5,3,5,0,0,-1,0,0,-1,6,-1
KR_6760585232,420,-3,-60,4,-7,3,0,3,-3,4,1,-4,4,0,-1,3,2,-2,2,0,0,-9,-2,-1,-5,6,2,0,0,1,-1,0,1,2,-1
KR_6762803474,440,-3,-98,4,-7,0,1,1,-1,1,0,1,3,4,-6,6,0,-1,4,3,-1,-7,-32,-6,-1,7,2,0,-1,-1,1,-1,-1,3,-1
KR_6709611756,420,-2,38,-7,-7,-3,3,0,-3,3,0,0,2,2,-1,4,3,0,1,1,0,-6,-24,-3,-1,4,-1,0,-1,-1,-1,-1,1,3,-1
KR_6752606004,420,4,113,33,4,4,0,4,-4,7,3,1,2,3,2,2,4,1,0,1,0,-3,-1,7,-8,1,-2,0,0,1,-1,1,1,6,-1
KR_6764714521,440,-6,-68,16,-4,-5,5,0,2,2,4,2,3,5,-6,10,4,3,3,6,0,3,13,7,-8,1,-2,0,-2,-1,1,-1,-1,4,-1
KR_6735660434,420,-4,-67,-40,-3,0,1,1,-1,3,2,0,4,4,-3,6,3,1,0,1,0,1,-7,1,-3,2,1,0,-1,1,-1,-1,-1,3,-1
KR_6725692384,420,-4,-110,8,-4,-3,4,1,-2,4,2,2,1,3,0,1,1,-1,2,1,0,2,-16,-1,-4,5,3,0,0,1,-1,-1,-1,1,-1
KR_6764921032,420,3,21,36,3,1,2,3,4,0,4,2,2,4,-5,5,0,1,0,1,0,-1,-47,-3,-3,6,20,0,-1,0,-1,1,1,0,-1
KR_6643909565,420,0,-45,-36,-2,-2,3,1,3,1,4,0,3,3,-4,5,1,1,1,2,0,0,-22,5,-7,2,0,0,-1,1,1,-1,-1,2,-1
KR_6764342580,420,0,13,-14,3,0,2,2,-4,5,1,4,1,5,3,3,6,0,0,0,0,-1,1,-2,-4,6,9,0,-1,0,-1,-1,-1,0,-1
KR_6767208656,420,1,-8,-8,-5,-3,5,2,3,0,3,-2,3,1,-2,3,1,-1,1,0,0,-3,-12,-1,-6,7,0,0,-1,-1,-1,-1,1,3,-1
KR_6738358926,420,-2,-19,-28,-3,3,0,3,0,3,3,-3,3,0,-5,5,0,2,0,2,0,-4,-17,-2,-5,7,4,0,-1,-1,1,-1,1,1,-1
KR_6730136279,440,2,-39,45,-1,1,3,4,4,3,7,-3,3,0,-4,5,1,1,0,1,0,-1,-4,-1,-5,6,-3,0,-1,-1,-1,-1,1,3,-1
KR_6707063884,440,-3,-7,-20,-10,0,3,3,-2,3,1,-3,3,0,-2,3,1,-3,3,0,-1,-8,1,0,-6,6,-4,0,-1,1,-1,-1,-1,3,-1
KR_6749610006,440,0,-15,8,-2,1,0,1,-3,5,2,2,2,4,0,0,0,-2,4,2,0,-6,8,-11,-3,14,4,0,0,-1,-1,0,1,2,-1
KR_6340496452,420,-4,-30,-20,-9,1,1,2,-2,2,0,-2,3,1,-6,6,0,0,1,1,0,-9,-8,-2,-3,5,-2,0,-2,-1,1,-1,-1,2,-1
KR_6749540549,420,-7,-88,-2,-9,-3,4,1,1,1,2,-4,4,0,-2,3,1,-1,2,1,0,-6,-7,-5,0,5,-2,0,-3,0,-1,-1,-1,0,-1
KR_6748468316,420,-1,-31,4,2,-5,6,1,2,1,3,0,1,1,3,1,4,2,0,2,0,1,-45,-4,-1,5,25,0,-1,-1,-1,-1,1,2,-1
KR_6730343920,440,2,37,24,1,-4,4,0,4,1,5,-1,3,2,2,2,4,0,0,0,2,-4,45,0,-3,3,-16,0,1,-1,1,1,1,2,-1
KR_6756308556,440,-2,-13,9,-5,-3,3,0,3,2,5,0,2,2,-5,5,0,0,0,0,0,-8,-9,1,-4,3,0,0,-1,1,-1,-1,-1,2,-1
KR_6722982071,420,3,59,5,-4,1,2,3,-1,2,1,2,2,4,-5,5,0,-1,1,0,0,-7,30,-4,-6,10,-1,0,0,-1,1,0,1,6,-1
KR_6765454462,420,2,12,-11,7,2,1,3,1,2,3,-1,6,5,5,0,5,0,1,1,0,11,34,-2,-4,6,3,0,0,-1,-1,0,1,3,-1
KR_6764953597,420,-5,-67,-40,-7,-3,5,2,-4,5,1,-4,6,2,2,3,5,2,1,3,0,-3,-9,3,-3,0,-1,0,-2,0,1,-1,-1,0,-1
KR_6673001815,420,-3,-22,-2,-8,0,1,1,-2,3,1,1,4,5,-3,5,2,-4,5,1,1,-6,-17,2,-5,3,-1,0,0,-1,0,-1,1,4,-1
KR_6737611578,420,-3,-73,-36,-5,5,2,7,-2,7,5,-3,5,2,-5,5,0,0,0,0,-1,-2,-15,-1,-3,4,2,0,-2,-1,0,-1,-1,6,-1
KR_6618808041,420,1,-26,-20,-1,-2,2,0,1,2,3,3,3,6,1,3,4,-4,4,0,0,-8,-3,1,-3,2,2,0,0,-1,0,0,-1,2,-1
KR_6765565641,440,0,0,-24,1,-2,3,1,2,3,5,0,2,2,-2,4,2,3,0,3,0,2,339,-7,-1,8,4,0,1,-1,-1,1,1,4,-1
KR_6763368397,420,-1,-62,4,0,0,2,2,-7,11,4,5,2,7,0,2,2,2,0,2,0,11,13,-3,-2,5,3,0,-3,1,-1,-1,-1,6,-1
KR_6760960019,420,-1,9,-13,0,-1,4,3,-3,4,1,-3,3,0,6,1,7,1,1,2,0,4,-28,1,-3,2,0,0,-1,-1,1,-1,1,3,-1
KR_6632197502,420,-6,-71,-28,-16,-6,7,1,-2,4,2,-3,5,2,-3,3,0,-2,2,0,0,-11,13,-4,-1,5,-2,0,-1,-1,-1,-1,1,5,-1
KR_6614796374,420,0,-58,24,-14,-1,1,0,-5,9,4,-1,3,2,-8,10,2,1,1,2,-3,-14,-1,-4,-2,6,1,0,0,-1,-1,-1,-1,1,-1
KR_6694837861,420,-2,13,-13,-5,-4,5,1,0,5,5,0,1,1,0,2,2,-1,1,0,0,-6,4,3,-6,3,-8,0,-1,-1,-1,-1,1,3,-1
KR_6738227461,420,2,-66,12,1,0,2,2,1,0,1,2,1,3,-3,4,1,1,0,1,0,1,128,0,-4,4,1,0,0,-1,1,0,-1,1,-1
KR_6751314188,420,1,27,9,1,0,2,2,0,3,3,7,2,9,-5,7,2,-1,2,1,0,-7,-7,2,-4,2,1,0,0,0,1,0,-1,0,-1
KR_6759712846,440,-3,-80,-34,-5,-4,5,1,5,4,9,-1,4,3,-5,8,3,0,0,0,-2,-11,-3,-8,-3,11,0,0,-1,1,-1,-1,-1,2,-1
KR_6675797577,420,-4,-55,-37,-6,0,1,1,0,4,4,-3,4,1,-2,3,1,-1,1,0,0,-6,2,2,-4,2,-2,0,0,-1,-1,0,-1,2,-1
KR_6728644320,420,-3,25,-13,-5,-4,4,0,-1,2,1,-2,5,3,1,2,3,1,0,1,0,-9,-43,-1,-5,6,-1,0,0,1,1,0,1,4,-1
KR_6706397256,420,0,-74,1,8,0,4,4,8,1,9,-1,1,0,1,2,3,0,1,1,0,9,-1,-6,-1,7,7,0,0,-1,1,0,1,2,-1
KR_6708412144,420,-5,-88,-8,-9,-3,3,0,-8,9,1,-1,4,3,5,2,7,-2,4,2,1,-7,3,-3,-4,7,2,0,-1,0,-1,-1,1,0,-1
KR_6620983802,420,-4,-19,9,-13,3,3,6,-1,3,2,-12,12,0,-4,6,2,1,3,4,-2,-14,10,2,-4,2,-10,0,-3,0,-1,-1,-1,0,-1
KR_6757755085,420,-2,-25,0,-2,0,3,3,3,0,3,1,3,4,-5,6,1,-1,1,0,0,3,-2,0,-4,4,-1,0,0,-1,-1,1,1,3,-1
KR_6695517874,420,-2,-69,20,-6,-1,1,0,1,2,3,-2,5,3,2,0,2,-6,10,4,0,-4,6,1,-3,2,-2,0,-2,0,0,-1,-1,0,-1
KR_6761349091,420,0,-24,0,0,3,1,4,0,6,6,-3,3,0,0,1,1,0,1,1,0,3,-5,3,-6,3,-3,0,-1,0,1,-1,-1,0,-1
KR_6571269975,440,-4,-53,-4,-2,0,1,1,2,1,3,0,2,2,0,4,4,-4,6,2,0,3,-4,-1,-5,6,-3,0,-2,1,-1,-1,1,4,-1
KR_6742939264,420,-1,14,-17,-5,-2,2,0,-5,6,1,5,1,6,-2,4,2,-1,2,1,1,-7,11,-4,-3,7,4,0,0,0,1,-1,1,0,-1
KR_6751958964,420,-3,-47,4,-7,-2,6,4,-3,6,3,-2,3,1,-1,2,1,1,1,2,1,-5,-5,-2,-2,4,0,0,0,-1,-1,-1,1,4,-1
KR_6735855865,440,-2,-107,-24,-3,-2,3,1,-1,2,1,0,0,0,0,1,1,0,2,2,0,-2,71,1,-7,6,-4,0,0,1,-1,-1,1,1,-1
KR_6647444995,420,3,67,-7,3,-1,4,3,4,3,7,-1,2,1,0,0,0,1,0,1,0,-1,12,-1,-6,7,-2,0,1,1,1,1,1,1,-1
KR_6759599523,420,-2,-41,-12,-4,0,0,0,-6,8,2,-3,4,1,4,0,4,1,0,1,0,2,-4,-3,-2,5,-6,0,0,1,0,0,-1,6,-1
KR_6701593761,420,2,-12,12,1,-3,3,0,0,2,2,-4,7,3,11,2,13,-3,6,3,0,9,6,2,-6,4,1,0,0,1,-1,1,1,3,-1
KR_6748676010,420,4,70,-27,5,6,0,6,1,2,3,2,1,3,-3,4,1,-1,1,0,1,3,-11,5,-6,1,-5,0,0,1,-1,0,1,4,-1
KR_6758300256,420,1,26,4,-2,-4,6,2,-1,2,1,-2,3,1,5,0,5,0,0,0,1,2,-4,2,-6,4,4,0,0,1,1,-1,1,4,-1
KR_6720546800,420,-8,-83,3,-13,-2,3,1,-3,3,0,-2,3,1,-7,7,0,1,0,1,0,-12,-15,-5,-2,7,-1,0,-1,-1,1,-1,-1,1,-1
KR_6758772987,440,-8,-41,-8,-11,-4,9,5,-1,3,2,-5,6,1,1,4,5,-2,4,2,2,-2,-5,0,-2,2,0,0,-1,0,0,-1,1,0,-1
KR_6766580986,420,-2,22,-9,-2,0,3,3,-4,4,0,-1,1,0,1,4,5,2,1,3,0,5,-6,1,-3,2,-1,0,1,1,-1,1,1,4,-1
KR_6740545879,440,-1,-4,-8,-7,5,1,6,-2,3,1,-2,3,1,-6,8,2,-2,2,0,0,-2,1,3,-6,3,-2,0,0,-1,1,-1,-1,3,-1
KR_6751286341,420,-3,2,0,-7,-4,5,1,6,1,7,-4,5,1,-3,4,1,-2,3,1,2,-2,-118,-1,-2,3,0,0,-2,-1,0,-1,1,6,-1
KR_6764741879,420,2,-15,0,-1,2,0,2,0,3,3,-5,7,2,1,0,1,1,0,1,0,-3,-6,-6,-1,7,-3,0,1,1,-1,1,-1,3,-1
KR_6625002552,420,0,25,8,-1,-3,4,1,1,1,2,4,0,4,-3,4,1,0,0,0,0,-1,-7,-7,-1,8,6,0,0,1,1,0,-1,6,-1
KR_6665571785,420,0,-3,-19,1,5,1,6,3,0,3,-2,6,4,-4,4,0,-1,1,0,0,-10,2,-3,-3,6,1,0,0,-1,1,0,-1,5,-1
KR_6739462702,420,-4,-43,-36,-9,-2,2,0,0,4,4,-6,8,2,3,3,6,-4,6,2,-1,1,3,0,-4,4,3,0,-1,1,-1,-1,-1,6,-1
KR_6762272882,420,-4,-67,4,-6,1,1,2,0,4,4,-1,4,3,-1,3,2,-5,5,0,0,-9,-7,-1,-5,6,-6,0,0,-1,0,0,-1,1,-1
KR_6615336546,420,-3,-8,3,-5,-3,4,1,0,1,1,3,1,4,-4,5,1,-1,2,1,0,-1,-108,2,-5,3,1,0,-1,1,1,1,1,1,-1
KR_6756863271,420,1,21,20,0,3,1,4,-5,9,4,1,2,3,0,1,1,1,1,2,0,0,-6,-1,-5,6,2,0,0,1,-1,-1,-1,6,-1
KR_6739577068,420,-4,-68,-32,-5,-3,3,0,-4,4,0,-1,7,6,2,3,5,1,0,1,-1,0,-56,0,-5,5,21,0,-1,-1,-1,-1,-1,6,-1
KR_6555338488,420,0,-85,-7,-3,-8,9,1,1,4,5,5,0,5,0,2,2,-1,2,1,0,7,-71,2,-7,5,2,0,-1,1,-1,-1,-1,2,-1
KR_6723078360,420,-5,-9,4,-13,0,1,1,-5,5,0,-2,4,2,-5,5,0,-1,1,0,0,-22,6,-2,-3,5,-1,0,0,-1,-1,-1,-1,4,-1
KR_6653071943,420,2,-15,12,4,0,3,3,0,5,5,4,1,5,3,1,4,-3,4,1,-1,6,3,-8,-3,11,0,0,0,-1,-1,1,-1,5,-1
KR_6705515807,420,-2,-40,-1,-6,1,2,3,-2,5,3,1,1,2,-3,4,1,-3,3,0,-1,-6,-5,-3,-5,8,1,0,-1,-1,-1,-1,-1,1,-1
KR_6743440665,420,-4,-69,4,-6,-1,4,3,-3,3,0,0,5,5,-1,2,1,-1,1,0,-1,-8,-3,-1,-2,3,-4,0,-3,-1,1,-1,-1,3,-1
KR_6756378758,420,1,16,36,0,3,0,3,2,1,3,2,1,3,-3,4,1,-4,4,0,0,-9,2,-1,-2,3,0,0,-1,0,1,-1,-1,0,-1
KR_6765922440,420,2,41,12,1,2,2,4,0,3,3,-2,4,2,-2,6,4,3,1,4,0,-1,-10,-5,-5,10,4,0,0,-1,-1,-1,1,2,-1
KR_6764956914,420,-4,-27,-12,-13,5,2,7,-3,5,2,-7,7,0,-7,7,0,-1,2,1,-1,-15,-280,1,-5,4,14,0,-1,1,1,-1,-1,4,-1
KR_6763123051,420,0,9,23,0,2,0,2,1,3,4,2,2,4,-5,10,5,0,0,0,0,-12,3,-2,-5,7,5,0,0,1,-1,1,-1,4,-1
KR_6766771982,420,1,-4,16,-1,5,1,6,0,1,1,4,2,6,-6,9,3,-4,4,0,0,-5,-50,1,-3,2,1,0,1,-1,-1,1,1,4,-1
KR_6637821574,420,2,-16,18,-3,3,2,5,-1,5,4,0,0,0,-5,6,1,0,0,0,0,-9,-3,-2,-4,6,-4,0,-1,-1,-1,-1,1,6,-1
KR_6758341010,420,1,54,15,-8,1,0,1,-3,5,2,-7,10,3,3,2,5,-2,2,0,0,-15,-7,-11,-2,13,4,0,0,1,-1,0,-1,2,-1
KR_6638451914,420,-2,-40,-44,2,-1,2,1,0,5,5,2,0,2,-3,4,1,4,0,4,0,1,-467,-2,-3,5,-1,0,0,-1,1,-1,1,4,-1
KR_6759392156,420,0,29,-8,3,3,2,5,0,3,3,5,2,7,-2,3,1,-3,4,1,0,-3,-2,2,-5,3,2,0,-2,-1,-1,-1,-1,1,-1
KR_6758021238,440,-1,26,-7,-1,-3,4,1,3,0,3,2,3,5,-2,5,3,-1,2,1,0,0,5,6,-6,0,-1,0,-2,1,-1,-1,-1,3,-1
KR_6339894384,420,-3,-25,-15,-2,3,0,3,2,4,6,-3,4,1,-4,4,0,0,0,0,0,-1,-7,2,-4,2,-4,0,-1,-1,1,-1,1,1,-1
KR_6758792734,420,0,48,-22,3,2,1,3,-1,2,1,0,3,3,2,2,4,0,1,1,2,7,-33,3,-4,1,1,0,1,1,1,1,1,6,-1
KR_6761383379,420,1,37,-12,-2,-1,3,2,0,0,0,2,5,7,-5,5,0,2,0,2,0,-3,-26,3,-5,2,6,0,1,-1,-1,1,-1,4,-1
KR_6762995859,420,0,21,17,-2,0,4,4,1,0,1,4,0,4,-3,3,0,-4,4,0,0,-7,-3,-1,-2,3,0,0,0,-1,1,1,1,6,-1
KR_6740609474,440,-4,25,12,-11,0,1,1,-1,2,1,-6,7,1,-4,6,2,0,1,1,0,-15,-2,-2,-2,4,1,0,-2,0,0,-1,-1,0,-1
KR_6756843907,420,2,24,15,-4,3,1,4,-3,4,1,-1,3,2,-3,5,2,0,1,1,0,-8,15,-1,-4,5,-4,0,0,-1,1,0,-1,3,-1
KR_6764637754,420,-2,16,-21,-8,0,2,2,-4,4,0,-7,7,0,1,3,4,2,0,2,0,-5,-14,-1,-5,6,-1,0,0,1,0,0,-1,3,-1
KR_6720411033,440,-2,-46,-48,2,-2,4,2,3,3,6,1,0,1,-1,3,2,1,0,1,0,7,-2,4,-8,4,-3,0,0,-1,-1,0,1,4,-1
KR_6762251926,420,-2,42,14,-9,0,5,5,-3,3,0,-3,4,1,-3,3,0,0,0,0,0,-12,4,0,-4,4,-2,0,-2,-1,-1,-1,1,1,-1
KR_6730006035,420,0,-51,-18,4,-2,3,1,2,4,6,-1,4,3,3,0,3,2,0,2,0,14,-13,5,-7,2,-2,0,-1,1,0,-1,1,6,-1
KR_6732993516,420,2,-23,-8,1,-2,2,0,-1,4,3,1,0,1,2,4,6,1,1,2,0,4,10,-3,-3,6,2,0,0,-1,-1,1,1,1,-1
KR_6750548243,420,0,-31,-5,6,-3,3,0,3,5,8,4,0,4,2,1,3,0,0,0,0,9,60,-2,-2,4,4,0,0,1,1,0,-1,5,-1
KR_6764959087,420,-1,-34,-12,0,-2,4,2,-1,2,1,1,3,4,6,1,7,-4,5,1,1,1,3,0,-4,4,-2,0,0,-1,1,-1,1,2,-1
KR_6763944420,420,-2,-22,24,-7,-3,3,0,1,3,4,-1,3,2,-5,7,2,1,2,3,0,-9,7,4,-8,4,-1,0,0,1,1,0,-1,3,-1
KR_6764587158,440,-2,-35,4,-5,-2,4,2,1,0,1,1,0,1,-6,6,0,1,1,2,0,-12,6,-3,-4,7,1,0,-1,-1,1,-1,-1,1,-1
KR_6679577336,420,-3,-38,9,-1,-2,2,0,-3,6,3,-1,3,2,7,0,7,-2,5,3,0,8,1,0,-4,4,2,0,-1,0,-1,-1,1,0,-1
KR_6683132600,440,-2,-8,-35,-1,-3,4,1,-1,4,3,4,2,6,0,0,0,-1,1,0,0,-2,-14,-1,-1,2,3,0,0,-1,0,0,1,1,-1
KR_6688023554,420,0,-54,36,3,-2,5,3,2,1,3,1,3,4,1,0,1,1,0,1,0,2,-2,-1,-4,5,4,0,1,1,1,1,-1,6,-1
KR_6764490251,420,-3,23,-4,-5,0,1,1,-1,2,1,2,2,4,-5,5,0,-1,1,0,0,-7,-10,2,-4,2,-1,0,-1,-1,-1,-1,-1,5,-1
KR_6719114878,420,-3,-54,-48,-7,-4,5,1,1,1,2,-1,6,5,0,1,1,-3,3,0,0,-3,29,0,-3,3,0,0,-2,1,-1,-1,1,4,-1
KR_6765629479,420,1,-22,0,4,2,1,3,0,2,2,0,4,4,-1,5,4,3,0,3,0,6,28,-2,-3,5,0,0,0,1,-1,0,-1,5,-1
KR_6723214213,440,-1,53,-15,-7,-1,2,1,-3,5,2,-3,7,4,-1,1,0,1,0,1,0,-17,-22,-1,-3,4,-1,0,-1,-1,-1,-1,-1,2,-1
KR_6759012977,440,-1,-14,-28,-9,0,2,2,-8,9,1,2,3,5,0,4,4,-3,3,0,-1,-18,-25,2,-5,3,2,0,0,0,0,1,-1,0,-1
KR_6635118226,420,-2,-27,1,-5,-3,3,0,-3,5,2,-1,3,2,2,1,3,0,1,1,0,-7,-8,-1,-3,4,0,0,0,-1,-1,-1,-1,1,-1
KR_6750978926,440,-3,-31,-28,-11,-2,2,0,2,2,4,-4,5,1,-5,8,3,-2,2,0,-2,-11,3,-1,-2,3,0,0,-1,-1,1,-1,-1,2,-1
KR_6693025384,420,2,28,38,11,3,0,3,5,1,6,2,3,5,4,1,5,-3,5,2,4,13,-1,1,-4,3,1,0,1,1,-1,1,1,1,-1
KR_6723424232,420,-2,-25,-1,-7,6,0,6,-2,4,2,-2,3,1,-10,10,0,1,0,1,0,-7,-151,-3,-4,7,-3,0,-1,-1,1,-1,-1,5,-1
KR_6758156691,440,2,47,42,1,-1,3,2,-4,4,0,3,1,4,3,2,5,0,6,6,0,-9,-1,4,-8,4,0,0,1,1,0,1,-1,5,-1
KR_6728204899,440,0,-8,7,-5,2,1,3,-1,2,1,-1,1,0,-3,3,0,-2,2,0,0,-10,8,1,-6,5,-10,0,-1,-1,1,1,-1,3,-1
KR_6723003413,420,-3,-19,-24,-7,-2,5,3,-1,2,1,-5,6,1,2,0,2,-1,1,0,-1,-10,7,-3,-4,7,-1,0,0,-1,-1,0,-1,6,-1
KR_6750501558,420,-5,-28,-21,-12,-2,2,0,-2,2,0,-1,1,0,-4,5,1,-3,3,0,0,-6,2,-1,-2,3,1,0,-1,-1,0,-1,-1,6,-1
KR_6679922960,420,-2,-46,-27,6,0,1,1,-1,6,5,6,1,7,-1,5,4,2,0,2,1,0,3,5,-7,2,-1,0,0,1,1,-1,1,1,-1
KR_6656210673,420,-5,-23,5,-7,-3,3,0,-2,2,0,0,2,2,0,2,2,-2,2,0,0,-7,7,6,-9,3,-6,0,0,-1,1,0,1,1,-1
KR_6734013157,420,-5,-67,4,-9,-3,5,2,-2,4,2,1,2,3,-4,5,1,-1,1,0,0,-10,-5,-3,-2,5,-6,0,-1,-1,-1,-1,-1,1,-1
KR_6762539835,420,-2,-39,7,2,0,0,0,0,4,4,1,0,1,-1,1,0,2,0,2,-1,-4,-10,-2,-2,4,4,0,-1,-1,1,-1,-1,2,-1
KR_6746420724,420,-1,-21,16,-6,0,3,3,0,3,3,-6,8,2,1,0,1,-1,1,0,0,-2,8,-2,-2,4,-3,0,0,-1,1,0,-1,1,-1
KR_6764891885,440,-3,-63,-9,-6,-8,9,1,4,1,5,2,4,6,-3,6,3,-1,2,1,0,-5,3,3,-6,3,-2,0,1,-1,1,1,-1,3,-1
KR_6651573776,420,-2,-24,0,-1,0,1,1,1,2,3,-4,6,2,0,1,1,2,0,2,0,-4,-1,-3,-1,4,-3,0,0,0,1,0,1,0,-1
KR_6762676538,420,-1,45,3,1,1,2,3,-1,3,2,4,1,5,-1,4,3,-2,3,1,0,-3,-1,2,-6,4,5,0,0,0,1,0,1,0,-1
KR_6739894560,420,-4,-126,-30,-4,-2,3,1,1,2,3,-3,3,0,3,0,3,-3,3,0,-1,-1,-5,2,-3,1,1,0,-1,0,1,-1,-1,0,-1
KR_6691205711,420,-2,35,-24,-9,0,2,2,-2,4,2,2,3,5,-8,8,0,-1,1,0,0,-12,-12,-3,-4,7,4,0,-1,-1,-1,-1,-1,2,-1
KR_6713711847,420,-2,27,-47,1,-4,5,1,-4,4,0,-2,6,4,2,0,2,9,1,10,0,5,-20,0,-3,3,0,0,-1,1,-1,-1,-1,3,-1
KR_6732536519,440,-1,1,16,-2,-1,3,2,-1,3,2,-1,3,2,1,2,3,0,0,0,0,3,-5,0,-5,5,0,0,0,0,0,0,-1,0,-1
KR_6766928936,420,-1,27,-32,6,3,1,4,0,2,2,-2,7,5,5,0,5,0,0,0,0,7,40,-1,-3,4,-3,0,0,-1,-1,-1,1,4,-1
KR_6762865870,420,-1,-9,-3,-2,1,2,3,4,1,5,-2,2,0,-4,5,1,-1,1,0,0,0,236,0,-2,2,1,0,-1,1,1,-1,1,3,-1
KR_6704360350,420,3,45,8,6,3,3,6,0,1,1,3,2,5,0,1,1,0,0,0,0,7,-14,-4,-3,7,3,0,2,1,1,1,1,3,-1
KR_6765321351,440,-1,2,-8,-5,-1,1,0,0,1,1,-3,4,1,1,0,1,-2,2,0,0,-3,-12,-1,-6,7,-2,0,0,1,0,0,1,6,-1
KR_6649177287,420,-6,-121,0,-14,-2,3,1,-6,6,0,1,2,3,-8,8,0,1,0,1,0,-15,1,-5,-3,8,1,0,-1,-1,-1,-1,-1,2,-1
KR_6643286942,420,-4,-39,-32,-7,-2,3,1,0,1,1,-3,3,0,1,2,3,-3,3,0,0,-6,1,-1,-5,6,1,0,-2,1,-1,-1,-1,5,-1
KR_6694047262,420,0,73,-32,-4,2,2,4,-5,6,1,-3,4,1,4,1,5,-2,2,0,0,-5,9,4,-10,6,2,0,3,1,-1,1,-1,3,-1
KR_6686125568,420,-1,-25,-3,-7,-6,8,2,0,1,1,5,1,6,-6,7,1,0,2,2,0,-7,13,-4,-3,7,3,0,-1,-1,-1,-1,-1,3,-1
KR_6632935299,420,-4,-61,-22,-5,-5,6,1,-1,4,3,-1,2,1,2,1,3,0,2,2,0,1,2,4,-7,3,-5,0,-3,-1,-1,-1,1,2,-1
KR_6661359216,420,-3,-29,-8,-3,-1,3,2,-6,7,1,1,1,2,4,4,8,-1,2,1,0,-1,-3,-6,-1,7,-2,0,0,-1,-1,-1,1,5,-1
KR_6767085668,420,0,118,28,-4,1,0,1,-5,7,2,-1,2,1,2,1,3,-1,1,0,0,-4,38,0,-4,4,-46,0,1,0,0,1,1,0,-1
KR_6653239217,420,-4,-28,-8,-6,-5,5,0,-2,3,1,2,1,3,0,0,0,-1,1,0,0,0,18,-1,-4,5,-1,0,1,-1,-1,1,-1,5,-1
KR_6761874219,440,4,-21,16,10,-2,3,1,2,2,4,-2,4,2,11,0,11,1,0,1,0,11,19,1,-6,5,1,0,0,-1,1,1,1,3,-1
KR_6716150318,420,-3,-9,-16,-5,-1,3,2,-1,3,2,-3,4,1,2,3,5,-2,2,0,-1,3,5,3,-4,1,1,0,-1,-1,0,-1,-1,6,-1
KR_6762947704,420,-4,-107,-41,-12,0,0,0,-2,4,2,-1,2,1,-6,7,1,-3,3,0,0,-15,-1,-2,-1,3,-4,0,-2,-1,0,-1,-1,3,-1
KR_6726495462,440,1,52,8,1,2,0,2,2,1,3,0,2,2,-2,2,0,-1,2,1,0,0,2,-1,-1,2,-1,0,1,-1,1,1,-1,3,-1
KR_6732994218,440,0,-59,19,1,-1,2,1,-1,3,2,-1,2,1,4,1,5,0,2,2,0,2,-4,0,-2,2,-3,0,-1,-1,1,-1,-1,1,-1
KR_6733801450,440,0,30,16,1,-1,2,1,3,0,3,-1,3,2,0,4,4,0,2,2,0,3,-2,-2,-1,3,2,0,0,1,-1,0,-1,6,-1
KR_6747589125,420,-4,-11,-20,-4,-1,1,0,-2,2,0,-4,4,0,3,1,4,0,0,0,0,-5,15,1,-9,8,-7,0,0,-1,1,0,1,6,-1
KR_6751138275,420,4,51,9,6,-1,3,2,1,1,2,1,3,4,3,3,6,2,1,3,0,3,27,4,-7,3,3,0,0,1,0,-1,-1,6,-1
KR_6733432238,420,-1,-54,0,-5,-1,2,1,0,2,2,-1,5,4,-2,5,3,-1,1,0,-1,-7,0,0,-3,3,-4,0,-1,1,0,-1,-1,6,-1
KR_6637179862,420,-2,-20,-15,-3,0,0,0,0,1,1,0,0,0,-3,3,0,0,0,0,0,-3,-4,3,-9,6,-1,0,-1,-1,-1,-1,1,4,-1
KR_6762345141,420,-1,-78,29,-11,-2,3,1,-5,5,0,-1,4,3,-1,2,1,-2,2,0,0,-10,25,-1,-1,2,0,0,-1,-1,-1,1,-1,3,-1
KR_6725896608,440,-3,-75,-11,-2,1,0,1,2,2,4,-7,8,1,-2,2,0,4,3,7,1,3,17,9,-12,3,-1,0,0,1,-1,-1,1,1,-1
KR_6760075461,440,1,-55,20,-2,-2,3,1,1,4,5,1,2,3,-2,2,0,0,1,1,-3,-5,-12,-5,-2,7,2,0,-1,-1,-1,-1,-1,2,-1
KR_6620217343,420,-3,-70,20,-7,-2,2,0,3,2,5,1,1,2,-6,6,0,-3,3,0,0,-8,1,-1,-1,2,-2,0,-1,1,0,-1,-1,1,-1
KR_6762788867,420,1,26,-8,3,-1,1,0,-1,2,1,1,3,4,6,1,7,-2,2,0,1,7,1,-1,-5,6,-1,0,1,-1,1,1,1,3,-1
KR_6756472616,420,-2,-43,-28,-7,-5,5,0,1,2,3,0,2,2,-2,2,0,-1,2,1,0,-8,7,-3,-4,7,1,0,-1,1,-1,-1,1,2,-1
KR_6748541423,440,0,28,-27,0,2,1,3,4,2,6,0,3,3,-4,5,1,-2,2,0,0,-3,-38,-3,-1,4,6,0,-3,-1,-1,-1,-1,3,-1
KR_6748364736,420,-1,28,-12,4,1,1,2,-2,5,3,3,0,3,2,1,3,0,1,1,0,2,-104,-4,-1,5,3,0,-2,-1,-1,-1,1,4,-1
KR_6671815096,420,-4,-101,-13,-2,-1,1,0,2,1,3,-3,3,0,0,0,0,0,0,0,1,5,-116,-1,-6,7,4,0,0,1,-1,-1,1,4,-1
KR_6763184933,420,1,35,4,-1,-2,2,0,-1,4,3,-2,5,3,3,0,3,1,0,1,0,-3,-9,-4,-4,8,6,0,1,1,1,1,1,5,-1
KR_6756478629,420,-5,-88,-30,-16,-2,3,1,-3,3,0,-8,8,0,-2,3,1,-1,1,0,0,-6,1,-2,-3,5,-4,0,-2,-1,-1,-1,-1,4,-1
KR_6764680316,420,-8,-81,-76,-15,-4,7,3,-4,5,1,-4,4,0,0,3,3,-3,4,1,0,-11,-11,-1,-4,5,-1,0,-2,0,-1,-1,-1,0,-1
KR_6575954143,420,-3,-8,-12,-8,-4,5,1,-6,7,1,2,2,4,0,5,5,0,1,1,1,-12,20,1,-4,3,0,0,-1,-1,1,-1,1,1,-1
KR_6752553107,420,-2,8,-8,-1,0,1,1,2,4,6,-2,2,0,-1,3,2,0,5,5,0,-7,-121,-3,-4,7,0,0,-2,-1,-1,-1,-1,5,-1
KR_6765530670,420,-2,-73,-24,-4,1,1,2,-3,4,1,-4,5,1,0,1,1,2,0,2,0,-1,12,-3,0,3,-3,0,-1,0,-1,-1,1,0,-1
KR_6664937430,420,0,96,-7,-4,-1,2,1,0,3,3,1,5,6,-4,4,0,0,1,1,0,-6,-15,-7,-1,8,2,0,0,-1,1,1,1,3,-1
KR_6594986431,420,-3,16,-10,-14,2,0,2,-2,5,3,0,2,2,-5,5,0,-9,9,0,0,-14,-33,2,-6,4,-2,0,0,-1,0,-1,1,6,-1
KR_6742426033,420,-2,-2,-28,-10,-4,4,0,-2,5,3,-3,3,0,-2,6,4,1,3,4,-1,-14,-16,4,-7,3,-3,0,0,1,-1,-1,-1,1,-1
KR_6730525057,440,-3,-39,-4,-5,0,2,2,-3,5,2,-1,3,2,-1,4,3,0,0,0,0,-1,-65,-5,-1,6,11,0,-1,1,-1,-1,-1,6,-1
KR_6760050287,420,2,67,25,7,-1,1,0,6,2,8,1,1,2,0,2,2,1,0,1,1,4,-1,-1,-2,3,1,0,1,0,0,1,1,0,-1
KR_6757040323,420,-1,30,-16,1,1,0,1,1,1,2,-1,3,2,-1,2,1,1,0,1,1,1,10,0,-6,6,-1,0,0,-1,-1,-1,1,1,-1
KR_6766986550,420,0,-17,9,0,2,1,3,-3,5,2,2,3,5,0,1,1,-1,1,0,0,-13,-13,3,-6,3,-2,0,0,1,-1,0,1,6,-1
KR_6750569807,420,-4,-66,-34,-12,-4,5,1,-1,3,2,0,3,3,-8,9,1,1,0,1,0,-1,1,-4,-1,5,-1,0,-2,-1,-1,-1,-1,6,-1
KR_6635399190,420,-4,-54,-4,-8,0,1,1,-5,5,0,-3,4,1,0,0,0,0,0,0,0,-5,12,-1,-5,6,-1,0,-1,-1,-1,-1,-1,3,-1
KR_6715648429,420,1,39,11,0,-1,2,1,1,1,2,-2,3,1,2,3,5,0,1,1,0,-3,156,-6,-2,8,1,0,0,-1,1,0,1,3,-1
KR_6761403037,440,-2,48,16,-4,2,1,3,0,2,2,1,0,1,-8,8,0,1,2,3,0,-11,23,-1,-4,5,-3,0,-2,0,1,-1,1,0,-1
KR_6674222679,420,-1,30,-14,0,1,0,1,4,0,4,-7,8,1,1,1,2,1,1,2,0,6,18,4,-5,1,-3,0,-1,-1,-1,-1,1,3,-1
KR_6766871677,420,-1,-59,-24,-6,-2,2,0,-2,4,2,-2,6,4,0,2,2,0,1,1,0,-4,-16,1,-4,3,2,0,0,-1,-1,0,-1,5,-1
KR_6754866821,420,-3,-51,0,-6,-3,5,2,-2,2,0,0,1,1,-1,2,1,0,0,0,0,-5,0,0,-5,5,-1,0,0,-1,1,0,-1,3,-1
KR_6765381792,420,0,-62,-35,-1,-3,3,0,-3,3,0,-2,3,1,3,1,4,4,0,4,0,6,48,3,-6,3,-5,0,0,0,-1,-1,-1,0,-1
KR_6749458516,420,0,0,-25,-4,-6,6,0,-2,4,2,1,2,3,2,3,5,1,1,2,0,-4,5,1,-6,5,-3,0,0,0,-1,0,-1,0,-1
KR_6760640388,420,-3,-87,-4,-9,-3,3,0,-2,3,1,1,0,1,-5,6,1,0,0,0,0,-16,274,-1,-3,4,-2,0,0,-1,1,0,-1,6,-1
KR_6764233055,420,-1,61,-16,-7,1,0,1,0,2,2,-1,6,5,-5,9,4,-2,2,0,0,-4,147,5,-7,2,-2,0,1,-1,-1,1,-1,1,-1
KR_6759522574,440,-3,-36,-48,-8,2,1,3,-1,3,2,-5,6,1,-4,7,3,0,3,3,-1,-6,18,-2,-2,4,-2,0,-1,-1,-1,-1,-1,3,-1
KR_6760253185,420,-2,-33,-4,0,0,1,1,1,3,4,-3,3,0,2,0,2,0,1,1,0,4,-2,-2,-2,4,4,0,-1,-1,0,-1,-1,2,-1
KR_6750717423,420,1,-8,-33,8,-7,9,2,-2,3,1,4,2,6,9,2,11,4,0,4,0,11,-13,1,-3,2,1,0,1,1,-1,1,1,3,-1
KR_6723055538,420,-6,-71,-16,-4,-2,2,0,2,4,6,-2,3,1,0,2,2,-2,3,1,0,-4,-41,0,-5,5,-1,0,-3,-1,1,-1,-1,1,-1
KR_6752776296,420,2,5,0,3,3,1,4,1,1,2,-6,7,1,2,0,2,3,1,4,1,4,-10,-5,-2,7,1,0,0,-1,-1,0,1,5,-1
KR_6673976493,420,-9,-90,-16,-8,-5,6,1,-1,3,2,-4,4,0,2,1,3,0,1,1,0,-7,0,-2,-5,7,-6,0,-2,-1,-1,-1,-1,2,-1
KR_6763641725,420,-2,-27,-56,-1,2,4,6,-1,1,0,2,2,4,-3,4,1,-1,1,0,0,-4,14,0,-5,5,-2,0,0,-1,-1,0,1,2,-1
KR_6759191739,420,-1,-81,-11,-7,-1,3,2,-8,13,5,-3,4,1,3,1,4,2,0,2,0,-6,-7,-8,-2,10,3,0,0,-1,1,1,-1,3,-1
KR_6767017740,440,0,-28,6,-1,-3,5,2,-3,3,0,4,3,7,2,1,3,-1,2,1,0,4,-5,3,-9,6,-1,0,-2,1,-1,-1,1,2,-1
KR_6733244133,440,-2,-68,9,-15,-3,3,0,-5,6,1,1,0,1,-2,4,2,-6,6,0,0,-12,5,3,-6,3,-6,0,0,1,-1,-1,-1,5,-1
KR_6740181621,440,-5,-79,-36,-14,0,0,0,0,1,1,-9,9,0,-2,5,3,-3,4,1,0,-10,-10,4,-5,1,0,0,-2,-1,1,-1,-1,3,-1
KR_6728952878,420,-4,-47,-4,-7,-3,3,0,-4,5,1,-4,6,2,3,0,3,1,1,2,1,-1,2,-1,-2,3,0,0,-3,0,-1,-1,1,0,-1
KR_6759680741,420,1,24,20,-1,-5,8,3,0,3,3,2,2,4,4,4,8,-2,3,1,0,11,-180,-2,-2,4,1,0,0,1,-1,1,1,1,-1
KR_6673381418,420,-5,-81,0,-8,-1,3,2,0,1,1,-3,3,0,-1,2,1,-3,3,0,0,-8,-7,-1,-4,5,-1,0,0,-1,1,-1,-1,4,-1
KR_6757579260,420,-1,-94,-10,2,-1,1,0,2,2,4,-1,2,1,1,2,3,1,0,1,-1,2,5,-5,-3,8,4,0,-1,0,-1,-1,-1,0,-1
KR_6620779681,420,-1,-12,-26,-6,-3,3,0,-4,4,0,1,1,2,0,1,1,0,1,1,0,0,-10,-3,-2,5,2,0,-1,-1,-1,-1,-1,1,-1
KR_6622631077,420,-2,-35,-12,-7,-3,6,3,-3,6,3,-4,4,0,3,2,5,0,0,0,0,-4,5,5,-9,4,0,0,0,1,1,0,1,2,-1
KR_6485512265,420,-4,-90,-40,-7,-1,2,1,0,1,1,-3,4,1,2,2,4,-5,5,0,0,-1,-13,1,-6,5,0,0,-3,-1,-1,-1,-1,2,-1
KR_6728750058,420,1,23,8,3,0,1,1,3,2,5,1,2,3,-1,1,0,0,0,0,-1,8,2,4,-7,3,0,0,1,1,-1,-1,-1,2,-1
KR_6727256524,420,-3,3,8,4,3,1,4,2,4,6,-1,3,2,-1,3,2,1,0,1,0,4,19,-2,-2,4,-3,0,0,-1,1,1,-1,1,-1
KR_6670615775,420,0,44,12,-1,0,2,2,1,5,6,-1,3,2,0,2,2,-1,1,0,0,-2,3,1,-4,3,-3,0,0,1,1,0,1,4,-1
KR_6745494849,420,-1,18,-24,-4,4,2,6,-4,4,0,0,2,2,-2,2,0,-2,2,0,1,-3,-9,-3,-2,5,3,0,2,0,1,1,1,0,-1
KR_6737160214,420,1,-41,3,0,-1,1,0,0,2,2,-1,4,3,2,2,4,0,1,1,1,7,8,6,-7,1,-2,0,0,-1,1,0,1,4,-1
KR_6699408155,420,2,-81,1,2,0,3,3,3,5,8,-2,2,0,1,3,4,0,0,0,0,5,-10,-4,-2,6,0,0,1,-1,1,1,-1,3,-1
KR_6733983779,440,-4,9,-23,-7,-1,2,1,-1,1,0,-3,5,2,-2,5,3,0,2,2,0,-9,-45,-1,-2,3,35,0,-1,1,-1,-1,-1,3,-1
KR_6745452219,420,-7,-82,4,-8,-11,12,1,7,1,8,-1,2,1,-2,7,5,-1,1,0,0,4,10,0,-2,2,-1,0,-4,-1,-1,-1,-1,5,-1
KR_6766764239,420,-2,18,7,-10,0,2,2,-2,4,2,-6,6,0,2,4,6,-4,4,0,0,-12,104,0,-2,2,-2,0,0,1,-1,-1,-1,2,-1
KR_6640369128,420,-4,-49,-24,-4,1,2,3,-2,2,0,-1,1,0,-2,7,5,0,1,1,0,2,6,-3,-2,5,-2,0,-1,-1,-1,-1,1,3,-1
KR_6689650896,440,4,57,9,8,0,3,3,2,2,4,8,1,9,-2,3,1,0,2,2,0,2,1,0,-5,5,-3,0,0,-1,1,-1,1,1,-1
KR_6749234443,420,-4,-64,-31,-6,0,1,1,-5,7,2,0,1,1,0,2,2,-1,3,2,0,-2,31,-2,-5,7,-8,0,-1,-1,-1,-1,-1,4,-1
KR_6724571152,420,-1,-108,26,-6,-3,5,2,6,0,6,-2,6,4,-3,3,0,-4,4,0,-1,-10,-17,0,-3,3,0,0,0,1,-1,-1,-1,3,-1
KR_6750772752,420,4,23,0,4,8,0,8,-5,7,2,0,4,4,0,4,4,1,0,1,0,1,3,0,-3,3,0,0,0,1,1,0,1,1,-1
KR_6746725712,420,-3,-56,24,-6,2,3,5,-2,3,1,-2,3,1,-2,2,0,-2,3,1,0,-2,1,2,-5,3,-2,0,-2,1,0,-1,1,2,-1
KR_6666337232,420,-4,9,-10,-10,-2,2,0,2,3,5,0,1,1,-5,5,0,-5,5,0,0,-7,-10,-4,-4,8,3,0,0,1,1,-1,-1,4,-1
KR_6715442532,440,2,54,-9,2,1,2,3,4,0,4,0,2,2,2,4,6,-5,6,1,1,10,385,-2,-1,3,3,0,0,-1,0,0,1,6,-1
KR_6743059249,420,-4,-26,-8,-11,-4,4,0,-2,3,1,-6,6,0,1,2,3,0,2,2,0,-10,215,2,-7,5,-2,0,-2,-1,-1,-1,-1,5,-1
KR_6763151233,420,-1,-19,21,-6,-1,4,3,0,3,3,-1,1,0,-2,2,0,-2,2,0,0,-13,-126,-5,-3,8,1,0,0,-1,-1,-1,-1,1,-1
KR_6723779782,440,-1,-2,4,-9,0,1,1,1,1,2,-4,5,1,-5,5,0,-1,3,2,0,-11,-38,-1,-4,5,14,0,0,-1,0,-1,-1,3,-1
KR_6732401274,420,-2,-16,-5,-5,0,2,2,0,6,6,0,1,1,-2,2,0,-3,4,1,0,2,-2,3,-5,2,-2,0,0,1,-1,0,1,5,-1
KR_6635590547,440,-3,-26,-39,-12,-4,5,1,-2,4,2,1,0,1,-1,1,0,-6,7,1,0,-6,62,-4,-1,5,-27,0,-2,-1,-1,-1,-1,4,-1
KR_6766642480,420,2,-2,26,5,0,3,3,1,3,4,4,1,5,0,2,2,0,0,0,0,9,27,0,-4,4,-19,0,1,-1,1,1,-1,3,-1
KR_6549491250,420,1,57,-12,0,9,0,9,0,2,2,-2,3,1,-2,4,2,-5,5,0,0,-7,-4,1,-6,5,-1,0,1,-1,1,1,-1,3,-1
KR_6736327076,420,2,-36,-25,7,-1,3,2,0,2,2,-4,5,1,5,1,6,7,0,7,1,14,6,2,-6,4,-5,0,0,-1,0,-1,1,6,-1
KR_6764270891,420,1,0,33,-2,3,0,3,0,3,3,3,2,5,-3,3,0,-5,5,0,1,0,8,1,-5,4,0,0,-1,1,1,-1,1,1,-1
KR_6749062006,420,0,30,3,2,-1,5,4,-1,3,2,0,1,1,-1,2,1,5,0,5,0,0,20,-4,-4,8,7,0,1,-1,1,1,-1,4,-1
KR_6753492681,420,-3,-47,-19,-10,0,3,3,-1,2,1,-1,5,4,-6,9,3,-2,4,2,-1,-14,-24,2,-6,4,0,0,-1,-1,-1,-1,-1,2,-1
KR_6766146688,440,0,-21,-3,-8,-2,4,2,-3,5,2,-6,10,4,3,1,4,0,0,0,0,-14,-23,-2,-4,6,21,0,-1,-1,-1,-1,-1,1,-1
KR_6525910327,420,-5,-64,-24,-8,-1,1,0,-2,5,3,-1,2,1,-4,5,1,0,0,0,0,-6,0,2,-8,6,-3,0,-1,-1,-1,-1,-1,5,-1
KR_6749831488,420,2,72,-24,4,-2,4,2,0,1,1,-2,5,3,6,0,6,2,0,2,0,4,40,2,-5,3,-21,0,2,-1,-1,-1,1,5,-1
KR_6717979581,420,-2,2,-8,-2,-2,4,2,4,2,6,-2,4,2,-4,5,1,2,0,2,0,-10,-13,0,-6,6,-7,0,0,0,0,1,-1,0,-1
KR_6759995841,440,2,2,-4,3,1,0,1,4,2,6,0,1,1,-3,7,4,1,2,3,2,13,12,4,-9,5,1,0,0,-1,-1,0,1,4,-1
KR_6677599206,420,2,-102,-3,2,-2,3,1,-5,7,2,4,0,4,2,3,5,3,0,3,2,7,3,-3,-4,7,-1,0,-1,1,1,-1,1,4,-1
KR_6723010396,420,3,2,12,1,2,1,3,2,1,3,-1,3,2,-3,5,2,1,0,1,0,-3,128,2,-7,5,-13,0,2,0,-1,1,-1,0,-1
KR_6766685035,420,2,-7,-12,7,-3,4,1,0,2,2,0,2,2,11,2,13,-1,1,0,1,17,-15,-4,0,4,2,0,1,-1,-1,-1,1,4,-1
KR_6728327748,420,-3,1,-32,-3,1,1,2,2,1,3,-1,3,2,-3,3,0,-2,2,0,0,-7,-121,-5,-3,8,-5,0,0,-1,1,0,1,1,-1
KR_6759891245,420,-6,-61,-31,-8,-4,4,0,-1,1,0,1,2,3,-3,4,1,-1,1,0,-1,-5,-14,-4,0,4,3,0,-1,-1,-1,-1,-1,2,-1
KR_6755276513,420,0,-34,26,1,-2,2,0,4,1,5,-2,3,1,2,1,3,-1,1,0,0,1,-9,-1,-3,4,3,0,0,1,0,0,1,1,-1
KR_6750772883,420,-1,-38,-17,0,-1,4,3,0,4,4,1,4,5,0,1,1,0,0,0,0,1,-17,1,-2,1,0,0,-1,-1,-1,-1,1,3,-1
KR_6761340370,420,1,-51,-28,-5,6,0,6,-5,6,1,-4,5,1,-2,4,2,0,1,1,0,-9,4,1,-2,1,-3,0,-1,1,-1,-1,1,4,-1
KR_6751358649,420,-5,-65,-20,-15,-2,4,2,-1,2,1,-7,9,2,-7,8,1,2,0,2,0,-11,-37,-4,-5,9,0,0,-1,1,-1,-1,1,1,-1
KR_6635166363,420,2,-4,8,2,1,0,1,0,3,3,-3,4,1,2,1,3,2,0,2,0,-4,8,1,-4,3,1,0,1,1,-1,1,1,5,-1
KR_6707597828,420,-2,-6,8,-9,0,0,0,-3,3,0,0,0,0,-8,8,0,2,0,2,0,-12,-6,-4,-2,6,3,0,0,1,-1,1,-1,5,-1
KR_6613089522,420,-1,-39,-28,1,0,3,3,-4,4,0,3,1,4,0,0,0,2,0,2,0,1,11,3,-6,3,-1,0,1,-1,-1,1,-1,4,-1
KR_6725925849,420,-6,-111,-10,-17,-9,9,0,2,1,3,-3,5,2,-5,6,1,-2,2,0,-1,-19,-3,-6,-2,8,3,0,-2,1,-1,-1,-1,1,-1
KR_6761615452,440,-1,37,-24,-4,-3,3,0,0,5,5,1,1,2,-1,1,0,-1,1,0,0,-5,-5,-2,-4,6,6,0,-1,1,-1,-1,-1,5,-1
KR_6748960698,420,-2,-24,-8,-5,-1,1,0,-1,2,1,1,1,2,0,3,3,-4,4,0,0,-9,-2,-2,-4,6,1,0,1,1,1,1,1,5,-1
KR_6748094783,420,-1,-14,-15,1,-1,4,3,1,2,3,0,2,2,1,0,1,0,0,0,0,6,0,1,-7,6,1,0,0,1,-1,0,1,2,-1
KR_6702624219,420,-5,-67,-23,-10,-4,4,0,-3,4,1,0,3,3,-2,5,3,-1,2,1,0,-16,-8,-6,-3,9,-1,0,-2,0,-1,-1,-1,0,-1
KR_6192687191,420,-3,-46,-15,-14,-1,2,1,0,2,2,-7,10,3,-6,7,1,0,0,0,0,-3,-7,0,-3,3,-3,0,-1,0,-1,-1,-1,0,-1
KR_6762744409,420,1,-3,-38,4,-3,4,1,3,1,4,3,0,3,0,1,1,1,0,1,0,0,53,3,-4,1,6,0,1,1,-1,1,1,1,-1
KR_6760686466,440,-7,-65,-40,-9,0,2,2,-3,4,1,-6,8,2,2,2,4,-2,2,0,0,-4,8,-2,-1,3,-5,0,-1,-1,1,-1,-1,3,-1
KR_6447957992,420,-1,47,12,-6,-1,3,2,-1,3,2,1,0,1,-5,5,0,0,4,4,0,-9,-2,0,-5,5,-3,0,0,1,1,0,-1,4,-1
KR_6606904894,420,-5,-35,15,-13,-9,9,0,1,2,3,-1,5,4,-4,7,3,0,1,1,0,-5,1,-2,-3,5,-4,0,-1,1,-1,-1,-1,5,-1
KR_6763294154,440,-5,-75,-8,-11,-1,2,1,-1,5,4,-4,5,1,-4,8,4,-1,1,0,0,-14,9,2,-3,1,-1,0,-3,-1,-1,-1,-1,1,-1
KR_6664673500,420,-2,-39,-5,-4,-2,3,1,-2,2,0,-1,4,3,3,3,6,-2,2,0,1,-5,-8,-1,-5,6,1,0,-1,-1,-1,-1,1,1,-1
KR_6695099487,420,1,16,5,3,-3,3,0,3,1,4,-2,4,2,2,2,4,3,1,4,0,11,12,1,-5,4,5,0,0,1,-1,1,1,6,-1
KR_6748737299,420,-1,29,8,-2,-2,3,1,1,1,2,-1,3,2,-2,3,1,2,2,4,0,-2,-6,-3,-1,4,0,0,0,1,-1,-1,-1,3,-1
KR_6764135477,420,-5,-72,-12,-13,0,0,0,-1,3,2,-4,5,1,-2,4,2,-6,6,0,0,-11,-15,-2,-2,4,0,0,0,-1,1,0,-1,4,-1
KR_6762396162,420,-1,0,4,-2,1,2,3,-3,6,3,0,5,5,0,0,0,0,1,1,0,0,0,-2,-2,4,3,0,1,1,1,1,1,1,-1
KR_6715479965,420,-2,-54,11,-8,-3,5,2,1,0,1,0,4,4,-5,7,2,-1,3,2,0,-5,33,-1,-3,4,1,0,1,0,-1,-1,-1,0,-1
KR_6733557245,420,-3,-83,-19,-4,0,2,2,0,4,4,-5,5,0,2,0,2,-1,2,1,0,0,-5,1,-3,2,-1,0,-1,-1,1,-1,-1,3,-1
KR_6710394907,420,-4,-1,-8,-7,2,2,4,-4,5,1,-6,6,0,0,1,1,1,0,1,0,-17,-7,-1,-2,3,-4,0,-2,-1,-1,-1,1,6,-1
KR_6758075064,420,-4,-97,-6,-9,-3,4,1,-5,7,2,2,3,5,-1,3,2,-2,2,0,0,-14,12,-1,-4,5,-3,0,-1,-1,-1,-1,1,5,-1
KR_6744036229,420,0,-32,14,-7,1,1,2,1,1,2,-2,3,1,-6,8,2,-1,1,0,0,-10,-39,0,-4,4,16,0,-1,-1,1,-1,-1,4,-1
KR_6762584800,440,-3,39,7,-4,0,3,3,3,0,3,0,2,2,-1,3,2,-6,6,0,0,-3,-25,1,-5,4,3,0,0,-1,-1,0,-1,2,-1
KR_6575034124,420,-4,-50,-16,-9,-4,4,0,-2,5,3,-2,4,2,-3,4,1,2,1,3,0,-4,8,5,-10,5,-5,0,0,-1,1,0,-1,6,-1
KR_6706459173,420,-4,-33,-8,-9,-4,5,1,0,2,2,1,1,2,-5,7,2,-1,1,0,0,-6,-3,-3,-3,6,-2,0,-2,1,-1,-1,-1,3,-1
KR_6467421620,440,-2,-66,-5,-5,-5,6,1,-1,4,3,0,2,2,2,2,4,-1,2,1,0,0,-30,-3,-2,5,0,0,-1,0,-1,-1,-1,0,-1
KR_6758846971,420,-5,-59,5,-10,-1,3,2,1,3,4,-11,12,1,1,2,3,0,0,0,0,-3,-2,4,-8,4,5,0,-1,0,0,-1,1,0,-1
KR_6748170087,420,-2,-34,-4,-2,0,1,1,-3,7,4,0,2,2,3,3,6,-2,3,1,0,-1,-18,-1,-4,5,6,0,0,0,1,0,-1,0,-1
KR_6759384358,440,0,14,0,-4,2,2,4,0,3,3,-8,8,0,2,5,7,0,2,2,1,-9,-2,-1,-1,2,2,0,0,-1,1,1,1,2,-1
KR_6734121039,420,2,47,28,7,2,1,3,1,3,4,1,1,2,1,0,1,2,0,2,2,9,9,2,-6,4,-2,0,2,1,1,1,1,3,-1
KR_6724170955,420,-6,-159,-38,-6,2,2,4,5,3,8,-2,3,1,-10,10,0,-1,1,0,0,-3,1,7,-10,3,1,0,-2,1,-1,-1,1,2,-1
KR_6767665964,420,-3,44,-8,-10,1,1,2,-7,8,1,-5,7,2,-1,1,0,2,1,3,0,-9,-10,-6,-2,8,0,0,0,-1,-1,0,-1,6,-1
KR_6745001955,420,2,15,-4,2,-2,3,1,2,3,5,-2,3,1,-1,2,1,5,0,5,0,5,21,-4,-5,9,-18,0,0,-1,1,0,-1,1,-1
KR_6526889737,420,-2,-2,-45,0,3,1,4,1,2,3,-2,3,1,-1,1,0,-1,1,0,0,4,259,1,-4,3,-4,0,-1,1,-1,-1,-1,2,-1
KR_6765037177,420,-2,-100,16,1,-2,2,0,3,4,7,0,2,2,1,1,2,-1,1,0,0,7,-55,7,-7,0,0,0,-2,-1,-1,-1,1,6,-1
KR_6764474678,420,-4,-26,12,-5,-1,1,0,1,1,2,-4,5,1,0,3,3,-1,1,0,0,-9,-32,-2,-4,6,-6,0,-1,-1,1,1,1,2,-1
KR_6765485479,420,0,-62,8,-3,-2,2,0,1,2,3,-1,1,0,0,1,1,-1,1,0,0,-1,18,3,-3,0,-7,0,0,-1,1,1,-1,3,-1
KR_6636730797,420,-2,36,-27,-2,1,1,2,-1,4,3,3,0,3,-2,2,0,-3,3,0,0,-5,1,-4,-3,7,-3,0,0,1,-1,0,1,1,-1
KR_6762348598,440,-2,-11,0,-3,-4,4,0,-2,3,1,3,1,4,-1,3,2,1,0,1,0,-5,1,-1,-3,4,2,0,1,-1,0,1,-1,5,-1
KR_6764038202,420,-5,-39,18,-13,-4,4,0,0,2,2,-3,3,0,-3,4,1,-3,3,0,0,-12,3,-6,-1,7,2,0,0,-1,1,-1,-1,5,-1
KR_6715954909,420,-1,7,4,-7,-2,3,1,1,2,3,0,2,2,-2,5,3,-4,5,1,0,-2,1,2,-5,3,1,0,0,-1,-1,0,-1,2,-1
KR_6747050793,420,-1,51,16,-4,2,0,2,-4,5,1,-3,6,3,1,1,2,0,3,3,0,-7,2,0,-5,5,3,0,-1,1,1,-1,-1,6,-1
KR_6506980651,420,-2,-3,20,-4,0,2,2,1,2,3,3,0,3,-7,10,3,-1,3,2,1,-5,-17,-8,-4,12,1,0,0,-1,1,1,1,1,-1
KR_6753747467,420,-6,44,-10,-7,-3,3,0,-2,4,2,-3,3,0,3,3,6,-2,3,1,-1,-9,-25,2,-5,3,2,0,-1,1,-1,-1,1,4,-1
KR_6759657090,420,-2,-47,-12,-8,1,0,1,-1,4,3,-3,3,0,-3,3,0,-2,2,0,0,-4,10,1,-6,5,2,0,-1,1,1,-1,-1,6,-1
KR_6740770194,420,5,-5,39,10,1,1,2,4,2,6,2,3,5,4,3,7,-1,1,0,0,3,7,-1,-3,4,0,0,1,1,-1,1,1,5,-1
KR_6764628923,420,0,-36,6,-2,1,0,1,-1,1,0,-2,2,0,0,1,1,0,0,0,0,-2,6,0,-2,2,-2,0,0,0,-1,0,-1,0,-1
KR_6638840078,420,-3,-36,10,-8,2,1,3,-2,4,2,1,2,3,-7,8,1,-2,2,0,0,-14,1,3,-6,3,-1,0,1,-1,1,1,-1,4,-1
KR_6710046195,420,-1,-14,0,1,-2,3,1,4,2,6,0,2,2,0,4,4,-1,1,0,0,1,-20,0,-5,5,-2,0,-1,1,1,-1,-1,5,-1
KR_6723856229,420,-3,0,0,-5,-2,2,0,-8,11,3,-1,3,2,6,1,7,0,1,1,0,-10,15,-5,-3,8,-1,0,0,1,-1,-1,1,4,-1
KR_6767844401,420,-7,-136,-3,-15,-6,6,0,-2,2,0,0,1,1,-3,4,1,-4,4,0,0,-9,-21,1,-5,4,-1,0,-4,0,-1,-1,-1,0,-1
KR_6764607919,440,2,44,-13,4,8,0,8,-4,6,2,2,0,2,0,1,1,-2,5,3,0,4,-5,-2,-1,3,0,0,-2,-1,-1,-1,1,6,-1
KR_6746095145,420,3,44,0,9,2,1,3,-1,1,0,5,0,5,2,5,7,1,2,3,0,3,9,7,-7,0,0,0,2,1,-1,1,1,2,-1
KR_6767518878,420,-3,-56,-3,-10,0,0,0,0,0,0,-1,6,5,-6,9,3,-3,3,0,0,-7,-2,-1,-3,4,2,0,-1,-1,0,-1,-1,4,-1
KR_6754223655,420,-4,-1,-5,-11,-2,2,0,-2,3,1,-2,2,0,-4,4,0,-1,4,3,-1,-14,2,-5,-1,6,-4,0,0,-1,1,1,-1,5,-1
KR_6604074553,420,-4,-63,8,-10,-7,7,0,-2,2,0,1,0,1,-2,3,1,0,0,0,0,-3,3,-1,-5,6,0,0,-1,-1,-1,-1,-1,5,-1
KR_6759326133,440,1,-14,11,-4,-4,6,2,0,5,5,0,1,1,-1,1,0,1,2,3,0,-7,-3,2,-6,4,-5,0,-1,-1,1,-1,-1,3,-1
KR_6745374882,420,-2,-29,-24,-6,-3,4,1,-5,5,0,0,2,2,2,2,4,0,1,1,0,-8,-9,-1,-4,5,1,0,-1,-1,-1,-1,-1,4,-1
KR_6709440714,420,0,-42,-16,2,-6,6,0,-2,3,1,4,2,6,5,1,6,1,1,2,0,5,139,-3,-3,6,2,0,-1,1,-1,-1,1,2,-1
KR_6741435119,420,3,-43,-21,9,-2,3,1,2,3,5,-3,4,1,1,0,1,11,0,11,0,15,10,1,-5,4,1,0,2,1,-1,-1,-1,1,-1
KR_6657058999,440,1,-63,-4,5,2,1,3,5,0,5,-3,6,3,1,1,2,0,1,1,0,11,4,0,-4,4,-2,0,-1,1,0,-1,-1,5,-1
KR_6753183941,420,-2,-74,0,2,0,1,1,2,4,6,0,2,2,-3,5,2,3,0,3,0,5,2,2,-8,6,-3,0,-1,-1,-1,-1,1,6,-1
KR_6715478732,420,-4,-47,-12,-8,0,0,0,-5,5,0,-4,5,1,0,7,7,1,0,1,0,-10,-4,0,-3,3,-2,0,-2,-1,-1,-1,-1,2,-1
KR_6594808617,420,-1,-44,-12,-4,-5,6,1,2,2,4,1,2,3,-1,5,4,-1,1,0,-2,-11,118,2,-6,4,-1,0,-2,-1,-1,-1,1,5,-1
KR_6441115397,420,-1,-6,-3,-3,-3,3,0,-3,3,0,-1,3,2,4,3,7,0,1,1,0,-1,48,0,-6,6,-10,0,0,-1,-1,0,-1,6,-1
KR_6616584548,420,0,22,8,2,1,0,1,-1,2,1,3,1,4,1,3,4,-2,2,0,1,8,18,3,-7,4,-3,0,0,1,-1,0,1,3,-1
KR_6705980918,420,-3,-38,-10,-13,2,1,3,1,2,3,-2,4,2,-14,15,1,0,1,1,-1,-12,-23,-2,-2,4,2,0,-2,-1,0,-1,-1,5,-1
KR_6760390620,440,-2,-13,-34,-3,-4,4,0,3,1,4,-2,3,1,-1,4,3,1,1,2,0,3,2,-2,-3,5,1,0,0,1,0,0,-1,6,-1
KR_6707187520,420,-5,-75,-48,-8,-2,4,2,-2,5,3,0,3,3,0,3,3,-4,5,1,-1,-5,32,-1,-5,6,-1,0,0,-1,0,0,-1,1,-1
KR_6764469162,420,2,0,24,-1,1,3,4,-1,3,2,0,2,2,1,4,5,-2,2,0,0,1,7,5,-8,3,-2,0,2,1,1,1,1,2,-1
KR_6748102714,420,-3,-67,-28,-9,-5,6,1,-2,2,0,0,2,2,-4,6,2,2,0,2,0,-9,-5,-1,-5,6,-4,0,-2,-1,0,-1,-1,6,-1
KR_6731468288,420,-3,-39,24,-4,3,0,3,-3,4,1,-1,2,1,-2,5,3,-1,2,1,0,-13,41,-5,-2,7,-15,0,-1,-1,1,-1,1,3,-1
KR_6731695411,420,-1,-56,-5,1,-1,2,1,2,3,5,3,2,5,-5,5,0,2,0,2,-1,-6,125,-1,-4,5,2,0,0,-1,1,0,-1,1,-1
KR_6624740585,420,-5,-68,-2,-10,-3,3,0,0,1,1,-2,3,1,-3,3,0,-2,2,0,-1,-9,-8,-1,-1,2,1,0,-3,-1,-1,-1,-1,5,-1
KR_6528796652,420,-3,-58,-31,-11,5,0,5,-1,5,4,-3,5,2,-11,11,0,-1,1,0,-4,-20,9,3,-7,4,3,0,-2,-1,-1,-1,-1,4,-1
KR_6732146057,440,-1,9,-7,-4,-3,3,0,-1,1,0,2,1,3,-1,1,0,-1,2,1,-1,-6,-2,-2,-3,5,2,0,0,-1,0,0,-1,2,-1
KR_6715605535,420,-1,-44,22,-8,-6,7,1,6,0,6,-7,7,0,-1,2,1,0,2,2,0,3,14,0,-1,1,-1,0,-1,1,-1,-1,-1,6,-1
KR_6745248799,420,-4,-64,-40,-4,-5,6,1,0,1,1,-4,5,1,4,1,5,1,2,3,0,2,-39,0,-6,6,28,0,-2,-1,-1,-1,-1,1,-1
KR_6636348804,420,-1,39,-23,6,3,2,5,-1,3,2,0,2,2,4,2,6,0,2,2,0,2,-1,-1,-2,3,0,0,1,-1,1,1,1,3,-1
KR_6761453954,420,-1,7,-5,-10,-1,2,1,-3,7,4,0,4,4,-4,9,5,-2,2,0,0,-17,366,4,-5,1,-4,0,0,1,1,-1,-1,1,-1
KR_6758224129,420,-5,-91,9,-10,1,1,2,-4,6,2,1,1,2,-7,8,1,-1,3,2,0,-12,2,1,-6,5,-2,0,-2,1,1,-1,1,6,-1
KR_6759383045,420,-2,-42,-1,-3,-3,4,1,5,2,7,0,4,4,-3,4,1,-2,3,1,0,3,-2,1,-2,1,2,0,-1,-1,1,-1,1,4,-1
KR_6753581604,420,-3,-38,-27,-8,-4,5,1,-3,5,2,1,2,3,-1,2,1,-1,1,0,0,-5,-15,-5,-1,6,-1,0,0,-1,1,-1,-1,6,-1
KR_6762178871,420,-4,-57,-2,-9,-4,4,0,-6,6,0,0,0,0,-1,3,2,2,0,2,0,-4,38,-3,-5,8,-37,0,-1,-1,-1,-1,-1,6,-1
KR_6724240773,420,-3,-122,-20,-6,3,2,5,0,2,2,-3,6,3,-5,6,1,-1,2,1,0,-6,-4,-1,-4,5,0,0,-2,0,-1,-1,1,0,-1
KR_6743488139,420,-4,-36,4,-12,0,1,1,-4,6,2,1,1,2,-9,12,3,0,1,1,0,-10,2,2,-2,0,-2,0,-1,1,-1,-1,-1,2,-1
KR_6755022876,420,3,-81,28,4,0,0,0,-1,7,6,7,1,8,-2,6,4,0,0,0,0,3,76,-4,-2,6,14,0,2,-1,1,1,1,4,-1
KR_6659346761,420,3,21,-10,-1,2,0,2,-1,1,0,-2,4,2,0,2,2,0,1,1,0,-1,-1,-3,-8,11,2,0,0,-1,1,0,-1,6,-1
KR_6749937625,420,-1,19,24,-5,0,0,0,-3,7,4,2,0,2,-3,4,1,-1,2,1,0,-7,29,0,-2,2,4,0,-1,-1,-1,-1,-1,3,-1
KR_6767264727,420,0,20,9,-7,0,2,2,-2,4,2,-4,4,0,0,2,2,-1,2,1,-1,-2,0,1,-6,5,0,0,0,1,-1,0,-1,3,-1
KR_6733876417,420,-1,-21,-8,2,2,0,2,3,1,4,3,3,6,-6,7,1,0,1,1,0,-9,-15,-1,-3,4,2,0,-1,1,-1,-1,1,3,-1
KR_6706344853,420,-2,-59,40,-2,-2,2,0,-1,5,4,-1,2,1,2,1,3,0,0,0,0,-3,10,0,-5,5,4,0,-1,1,-1,-1,-1,4,-1
KR_6661190372,420,-2,-41,9,-6,0,2,2,-3,5,2,1,1,2,-4,4,0,0,4,4,0,-10,-419,-2,-1,3,-2,0,0,-1,-1,0,-1,5,-1
KR_6748430354,420,-4,-19,-25,-4,1,1,2,-4,4,0,-2,2,0,1,1,2,0,0,0,0,-4,-8,-4,-1,5,2,0,0,-1,1,0,-1,1,-1
KR_6759633186,440,-3,-98,7,-6,0,0,0,-4,5,1,-2,3,1,0,1,1,0,1,1,0,1,0,-3,-3,6,0,0,-1,0,-1,-1,-1,0,-1
KR_6705109690,420,-3,-9,-24,-5,-2,3,1,-5,5,0,1,2,3,0,4,4,1,0,1,-1,-6,5,1,-4,3,2,0,-1,-1,1,-1,-1,3,-1
KR_6622324376,420,-2,-74,-23,-1,0,2,2,-4,5,1,1,5,6,0,2,2,2,0,2,1,0,-4,1,-3,2,-3,0,-1,-1,-1,-1,1,5,-1
KR_6750428770,420,0,24,31,-1,-1,2,1,-2,5,3,-1,2,1,3,2,5,0,0,0,0,-1,-233,-2,-2,4,-2,0,0,0,1,0,-1,0,-1
KR_6743221159,420,-3,-6,-9,-10,2,2,4,-6,7,1,0,1,1,-6,6,0,0,0,0,-2,-23,-10,-4,-1,5,6,0,0,0,1,-1,-1,0,-1
KR_6762973592,420,-1,-66,0,-5,0,2,2,-1,3,2,0,2,2,-6,6,0,2,1,3,0,-4,-18,0,-3,3,-1,0,-1,-1,-1,-1,1,2,-1
KR_6765604744,420,0,-77,8,-2,-2,3,1,-3,6,3,4,0,4,-1,3,2,0,0,0,0,5,0,5,-9,4,-2,0,0,1,0,-1,-1,6,-1
KR_6764654138,420,-4,-11,-34,-12,0,4,4,-3,4,1,-6,7,1,0,1,1,-3,4,1,-1,-11,-5,3,-4,1,-4,0,-1,0,1,-1,-1,0,-1
KR_6684194577,420,-2,-59,5,-1,-6,7,1,2,0,2,2,3,5,2,1,3,-1,1,0,0,3,-1,-2,-3,5,0,0,-1,1,-1,-1,-1,6,-1
KR_6676681195,420,-1,-30,-32,1,-1,1,0,-1,7,6,3,0,3,1,3,4,-1,2,1,0,4,8,3,-5,2,1,0,1,1,1,1,-1,6,-1
KR_6759277031,420,-1,-4,21,-9,-3,4,1,-4,5,1,-7,7,0,5,0,5,0,1,1,0,-1,-11,-2,-2,4,4,0,0,-1,1,-1,-1,4,-1
KR_6700159835,440,-3,-10,-20,-2,-2,3,1,-3,6,3,1,2,3,-2,3,1,4,0,4,0,-9,20,3,-5,2,-6,0,0,0,0,-1,1,0,-1
KR_6606238214,420,-1,-14,-4,0,-1,4,3,-3,3,0,1,3,4,2,1,3,1,0,1,0,1,-6,1,-5,4,2,0,0,-1,-1,0,-1,1,-1
KR_6758893192,420,-6,-94,-56,-12,1,0,1,-7,7,0,1,0,1,-7,10,3,0,1,1,0,-11,2,-1,-4,5,-2,0,-1,1,-1,-1,-1,5,-1
KR_6767098451,420,-2,-112,15,-3,-3,4,1,-2,5,3,2,1,3,0,0,0,0,2,2,0,-4,4,3,-5,2,1,0,-2,-1,1,-1,-1,4,-1
KR_6715813090,420,1,70,-1,0,-3,4,1,0,2,2,3,2,5,0,2,2,0,1,1,0,-2,0,2,-4,2,-1,0,0,1,-1,0,1,4,-1
KR_6716798126,440,0,-47,54,-3,-2,3,1,2,1,3,1,1,2,-4,5,1,0,0,0,2,-4,1,-1,-4,5,-2,0,-1,-1,1,-1,1,1,-1
KR_6767541560,420,-7,-131,-27,-11,1,1,2,-3,4,1,2,1,3,-9,9,0,-2,2,0,1,-19,-6,-1,-3,4,-2,0,-3,-1,0,-1,1,6,-1
KR_6760556776,420,-2,-14,4,-7,-4,4,0,-4,6,2,-5,7,2,3,4,7,3,2,5,0,-9,2,-3,-3,6,2,0,0,-1,-1,-1,1,4,-1
KR_6756257180,440,-2,1,4,4,-2,2,0,-1,7,6,3,3,6,1,3,4,3,0,3,0,14,7,-5,-4,9,-23,0,0,0,-1,0,-1,0,-1
KR_6762064444,420,-2,-75,-29,-1,-4,4,0,-2,3,1,-1,2,1,5,1,6,1,1,2,0,5,3,-1,-2,3,2,0,1,1,0,-1,1,4,-1
KR_6625275696,420,-4,17,0,-7,2,1,3,-1,2,1,-8,8,0,0,1,1,0,0,0,0,-7,-13,5,-9,4,-3,0,0,0,0,0,1,0,-1
KR_6744874591,420,-2,11,-21,-9,-4,4,0,-2,5,3,1,1,2,-4,6,2,0,1,1,1,-8,-187,-1,-3,4,4,0,-3,-1,-1,-1,1,4,-1
KR_6655972175,420,-3,-26,-9,-4,3,2,5,-4,5,1,-3,6,3,1,3,4,-1,3,2,0,-3,-3,4,-6,2,1,0,-2,-1,1,-1,-1,4,-1
KR_6766034303,420,-1,10,-20,-4,-3,3,0,0,2,2,2,1,3,-3,6,3,0,0,0,-2,-11,-10,1,-3,2,5,0,1,1,-1,1,-1,3,-1
KR_6661237190,420,-2,-57,11,-5,2,2,4,-1,2,1,-3,7,4,-2,4,2,-1,2,1,1,-8,298,-2,-3,5,-4,0,0,-1,-1,-1,1,3,-1
KR_6697700739,420,-1,88,-4,-3,-3,4,1,-3,4,1,2,3,5,0,1,1,1,0,1,0,-14,-208,2,-5,3,2,0,0,-1,1,0,-1,1,-1
KR_6678517720,420,-4,-50,-20,-12,-2,2,0,-2,2,0,-1,2,1,-7,7,0,0,0,0,0,-14,2,0,-4,4,-1,0,0,-1,0,-1,1,1,-1
KR_6761268659,420,-4,-2,-7,-4,0,3,3,-2,5,3,-1,3,2,2,5,7,-3,4,1,0,-5,-7,-1,-4,5,-3,0,2,-1,1,1,1,6,-1
KR_6748489101,440,-1,17,0,0,0,1,1,1,4,5,-3,6,3,2,5,7,0,4,4,0,-2,-12,1,-1,0,2,0,0,1,-1,0,-1,4,-1
KR_6612931857,420,-4,-75,-16,-8,0,2,2,-3,3,0,-5,6,1,-1,1,0,1,0,1,-1,-7,-9,-2,-6,8,1,0,-1,1,-1,-1,-1,1,-1
KR_6767331592,420,3,82,-4,10,0,2,2,7,1,8,-2,2,0,5,3,8,0,3,3,-1,13,-9,5,-7,2,3,0,2,-1,-1,1,-1,6,-1
KR_6762475148,420,-5,7,0,-8,-6,7,1,-1,4,3,-2,4,2,3,1,4,-2,4,2,0,-13,-6,-2,-3,5,3,0,-1,-1,-1,-1,-1,6,-1
KR_6748937948,420,-1,15,16,-6,-2,2,0,1,1,2,0,0,0,-5,7,2,0,2,2,0,-6,-24,0,-5,5,4,0,0,-1,1,0,1,4,-1
KR_6726747479,440,-2,-3,-12,-3,-3,3,0,-3,7,4,-1,3,2,0,1,1,4,0,4,0,2,56,-1,-3,4,3,0,0,1,-1,0,-1,6,-1
KR_6759452666,420,-2,-22,-4,-6,5,0,5,-5,6,1,1,6,7,-3,4,1,-4,4,0,0,-12,-16,-3,-2,5,-1,0,-1,-1,1,-1,-1,6,-1
KR_6606126447,440,1,42,-6,-1,1,1,2,-3,5,2,-3,4,1,1,1,2,3,2,5,-1,-5,7,0,-5,5,-2,0,0,-1,-1,0,-1,4,-1
KR_6720575403,420,-3,8,14,-6,-1,2,1,-2,5,3,0,2,2,-4,4,0,1,0,1,0,-6,273,-2,-5,7,-3,0,0,1,-1,0,1,4,-1
KR_6712464568,420,-1,-15,-24,-3,2,0,2,-1,4,3,1,1,2,-1,3,2,-4,4,0,0,-2,-151,0,-3,3,0,0,-2,-1,-1,-1,-1,4,-1
KR_6723177088,420,1,-15,29,-3,-4,4,0,4,1,5,-1,2,1,-1,3,2,-1,1,0,0,9,-6,-1,-4,5,-2,0,-1,-1,1,-1,1,4,-1
KR_6753765281,420,1,-17,15,2,-1,3,2,-5,6,1,0,3,3,7,0,7,1,2,3,0,2,-1,0,-3,3,1,0,0,-1,1,0,1,6,-1
KR_6727725550,420,-3,-31,-24,-2,4,0,4,1,2,3,-6,6,0,0,2,2,-1,1,0,0,1,-4,2,-7,5,-1,0,0,-1,1,1,-1,3,-1
KR_6133085437,420,-2,-54,-20,-5,3,2,5,-6,6,0,1,4,5,-2,2,0,-1,1,0,-2,-4,62,5,-5,0,-4,0,-1,-1,1,-1,-1,5,-1
KR_6760824274,420,0,-14,-4,-9,0,3,3,-2,4,2,0,2,2,-5,8,3,-2,2,0,0,-5,-9,-8,-2,10,4,0,0,1,0,0,-1,6,-1
KR_6763053839,420,-1,-45,-24,-5,-5,6,1,1,2,3,3,4,7,-2,2,0,-2,4,2,-1,-7,-21,2,-6,4,-2,0,-1,-1,0,-1,-1,5,-1
KR_6740029094,420,0,-38,2,2,-2,3,1,6,1,7,3,1,4,-2,2,0,-3,4,1,0,2,11,0,-7,7,0,0,0,-1,1,0,1,5,-1
KR_6525437147,420,-1,-54,8,-9,-2,4,2,-1,5,4,0,1,1,-7,9,2,1,0,1,0,-9,-15,-4,-2,6,2,0,-1,-1,1,-1,1,5,-1
KR_6760483327,420,-1,-21,-46,-6,-1,1,0,2,2,4,-3,4,1,-2,5,3,-2,3,1,0,-4,-9,1,-2,1,-3,0,-2,-1,0,-1,-1,2,-1
KR_6764993158,420,0,-12,-30,-7,2,2,4,-3,6,3,-3,3,0,-1,3,2,-2,2,0,0,-7,-120,-2,-3,5,-3,0,0,0,0,-1,-1,0,-1
KR_6619621005,420,-2,-6,-1,-7,-2,2,0,-1,3,2,-3,4,1,0,1,1,-1,1,0,0,-10,108,1,-7,6,-5,0,0,1,1,1,1,4,-1
KR_6673163138,420,-3,-45,27,2,-2,2,0,-2,6,4,2,2,4,3,1,4,1,0,1,2,14,2,-1,-2,3,2,0,-1,1,-1,-1,1,2,-1
KR_6764969337,420,1,-3,7,2,0,1,1,0,1,1,0,0,0,6,0,6,-4,5,1,-1,0,-13,-8,-3,11,2,0,0,0,-1,0,-1,0,-1
KR_6760954537,420,1,64,12,-7,0,0,0,-4,5,1,-4,4,0,2,3,5,-1,2,1,0,-8,-10,-2,0,2,-1,0,0,1,-1,0,1,3,-1
KR_6752390539,420,-2,50,-15,-9,1,0,1,-3,4,1,-2,4,2,-2,4,2,-3,3,0,0,-12,-13,4,-8,4,-1,0,-1,-1,-1,-1,-1,2,-1
KR_6757649131,420,1,-61,5,5,0,1,1,4,0,4,-1,3,2,0,1,1,2,0,2,0,6,-19,-1,-5,6,21,0,0,0,-1,0,-1,0,-1
KR_6751285691,420,5,35,16,9,-2,2,0,1,1,2,6,1,7,-1,5,4,5,0,5,0,7,0,-3,-2,5,3,0,1,1,-1,1,-1,2,-1
KR_6618769449,420,1,-38,8,5,-2,3,1,6,2,8,4,1,5,-4,7,3,1,0,1,0,9,2,4,-7,3,-1,0,0,-1,1,0,1,5,-1
KR_6762388038,440,-1,0,0,-2,-5,6,1,-1,3,2,2,1,3,-1,2,1,3,0,3,0,8,-38,1,-5,4,11,0,-2,1,-1,-1,-1,5,-1
KR_6694271663,420,0,46,-24,3,1,1,2,-2,3,1,3,1,4,-1,4,3,2,1,3,1,5,-473,2,-7,5,-4,0,0,1,-1,0,1,6,-1
KR_6765539236,420,-2,-68,-4,-9,1,2,3,-4,5,1,-3,5,2,-2,3,1,-1,2,1,-1,-12,-34,-3,-2,5,-1,0,0,1,0,0,-1,4,-1
KR_6622382090,420,-3,-41,-20,-8,-1,1,0,-2,3,1,1,5,6,-3,5,2,-3,3,0,0,-10,100,0,-1,1,-1,0,-2,-1,1,-1,-1,2,-1
KR_6617184963,420,-5,-90,-36,-10,-2,3,1,-2,2,0,-2,5,3,-2,4,2,-2,2,0,0,-9,-6,1,-7,6,-5,0,-3,-1,-1,-1,1,2,-1
KR_6660113540,420,-3,-10,-16,-9,-3,4,1,-5,6,1,2,0,2,-4,6,2,1,0,1,0,-13,15,-3,-5,8,2,0,-1,-1,1,-1,1,5,-1
KR_6743125932,420,-3,-47,-12,-7,-2,2,0,-1,2,1,-1,2,1,-3,4,1,0,1,1,0,-8,-19,-2,-1,3,-4,0,-2,-1,-1,-1,-1,3,-1
KR_6742559590,440,-1,-43,-4,-2,0,2,2,-1,6,5,2,0,2,-5,5,0,2,0,2,0,-5,2,-1,-2,3,-3,0,0,-1,0,0,-1,6,-1
KR_6746402383,420,0,13,-12,-3,-1,2,1,-6,8,2,0,1,1,1,4,5,3,0,3,0,-8,-6,-1,-3,4,0,0,0,-1,1,0,-1,2,-1
KR_6710968665,440,0,15,24,-1,0,2,2,-3,6,3,1,1,2,-4,6,2,5,2,7,0,6,-1,2,-3,1,2,0,1,1,1,1,1,6,-1
KR_6185071704,420,-4,0,-52,-8,-1,3,2,-2,3,1,-6,6,0,1,1,2,0,0,0,-1,-1,0,-1,-4,5,1,0,2,-1,1,1,-1,3,-1
KR_6760240529,420,0,-50,3,-12,-2,3,1,1,1,2,-1,2,1,-8,8,0,-2,3,1,-1,-13,-20,-1,-5,6,0,0,-2,-1,-1,-1,-1,4,-1
KR_6742457430,420,-3,9,9,-5,-2,3,1,-4,5,1,4,0,4,-2,2,0,-1,3,2,0,-10,-39,-3,-2,5,6,0,1,-1,1,1,1,2,-1
KR_6172270193,420,0,14,12,1,1,4,5,2,2,4,-3,4,1,0,5,5,1,0,1,0,4,-1,-3,-3,6,0,0,-1,1,-1,-1,-1,2,-1
KR_6751203997,420,-6,-42,-21,-9,3,0,3,0,3,3,-7,7,0,-4,4,0,-1,1,0,-2,-12,-3,-2,-3,5,0,0,-2,-1,1,-1,-1,1,-1
KR_6706381928,420,2,-26,16,7,-1,2,1,1,2,3,2,3,5,4,0,4,1,0,1,0,6,120,2,-4,2,2,0,0,1,1,0,-1,6,-1
KR_6106937968,420,-5,-111,-19,-10,4,1,5,-2,3,1,-6,8,2,-3,4,1,-3,4,1,0,-10,-45,-1,-3,4,18,0,-1,-1,-1,-1,-1,3,-1
KR_6757081847,420,-5,-73,-20,-5,-6,8,2,-2,2,0,3,4,7,1,3,4,-1,2,1,0,-1,-122,-5,-1,6,3,0,-1,-1,-1,-1,1,6,-1
KR_6767114101,420,-8,-8,-21,-16,-1,3,2,-3,4,1,-6,7,1,-5,7,2,-1,2,1,0,-17,98,-3,-1,4,-1,0,-1,-1,-1,-1,1,6,-1
KR_6644583131,420,-2,-27,24,-2,-1,2,1,0,2,2,0,4,4,1,2,3,-2,2,0,0,3,32,1,-5,4,-5,0,0,-1,-1,0,-1,2,-1
KR_6715336547,420,-3,-55,-32,-1,2,1,3,-1,2,1,-2,2,0,-1,1,0,1,0,1,0,1,-344,4,-4,0,-2,0,-2,1,-1,-1,1,3,-1
KR_6673908679,420,2,4,28,6,5,0,5,0,2,2,2,6,8,-1,4,3,0,2,2,0,-3,0,3,-6,3,0,0,0,1,-1,0,1,1,-1
KR_6740302206,420,-1,3,-12,0,-1,1,0,-1,1,0,4,0,4,2,3,5,-4,5,1,0,-1,-129,-3,-2,5,-6,0,-1,0,-1,-1,1,0,-1
KR_6762488002,420,-7,-77,10,-18,-6,7,1,-1,3,2,0,1,1,-8,10,2,-3,3,0,-1,-13,-7,1,-5,4,-1,0,-4,1,-1,-1,-1,1,-1
KR_6713788956,440,-1,-2,0,-8,-4,5,1,-2,2,0,-2,3,1,0,1,1,0,0,0,0,-2,-32,1,-4,3,14,0,-1,-1,1,-1,-1,4,-1
KR_6632885498,420,1,15,-8,3,0,1,1,2,0,2,-1,8,7,1,2,3,1,1,2,-2,6,-149,0,-4,4,0,0,-1,-1,1,-1,-1,2,-1
KR_6764465144,420,1,-51,8,0,0,1,1,-4,4,0,3,0,3,-1,4,3,2,0,2,0,-6,-3,0,-7,7,-4,0,0,-1,1,0,-1,5,-1
KR_6759468880,420,-2,-11,8,-7,-3,3,0,-3,4,1,2,0,2,-4,6,2,1,1,2,0,1,13,3,-7,4,0,0,-1,-1,-1,-1,-1,2,-1
KR_6766073918,420,2,-45,8,2,6,1,7,2,3,5,-1,4,3,-7,10,3,2,0,2,-1,-7,260,3,-8,5,0,0,0,-1,1,0,-1,1,-1
KR_6762454601,420,-1,-18,-4,-4,-5,5,0,1,1,2,-1,1,0,6,0,6,-5,5,0,1,5,-4,2,-6,4,1,0,-2,-1,-1,-1,1,4,-1
KR_6636298299,440,-7,-81,15,-15,-7,8,1,-2,2,0,0,2,2,-5,8,3,-1,1,0,0,-12,-3,-1,-5,6,-1,0,-4,1,-1,-1,-1,4,-1
KR_5883719500,420,-1,-19,40,-8,0,5,5,0,1,1,-5,7,2,-3,3,0,0,1,1,0,-7,1,-3,-4,7,1,0,-1,1,1,-1,-1,5,-1
KR_6761014986,420,0,-9,-8,0,-5,5,0,1,1,2,2,1,3,2,3,5,0,1,1,0,4,62,0,-4,4,3,0,-1,1,-1,-1,1,3,-1
KR_6717728382,420,-6,-109,-5,-13,-5,6,1,-1,5,4,-3,5,2,-1,2,1,-3,5,2,-1,-3,11,-3,-5,8,-2,0,-1,0,-1,-1,-1,0,-1
KR_6762538038,420,0,-46,0,0,0,0,0,1,2,3,1,2,3,1,1,2,-3,3,0,0,2,1,-1,-2,3,-4,0,-1,1,1,-1,1,5,-1
KR_6589707307,420,-3,-17,-32,-16,0,1,1,-1,1,0,-4,7,3,-10,10,0,-1,1,0,0,-21,-2,-1,-4,5,0,0,1,-1,-1,-1,-1,6,-1
KR_6652161927,420,-1,-64,-12,5,-2,4,2,1,1,2,1,0,1,4,1,5,1,2,3,0,9,-34,-1,-5,6,17,0,-1,-1,-1,-1,-1,4,-1
KR_6575050990,420,-9,-139,-44,-15,-2,4,2,-8,10,2,-4,5,1,-4,6,2,3,1,4,0,-15,-1,-2,-4,6,1,0,-2,-1,-1,-1,-1,3,-1
KR_6745432619,420,-1,-18,-16,-6,0,2,2,1,3,4,-3,4,1,-2,3,1,-2,4,2,0,-9,-17,-1,-1,2,-2,0,0,-1,0,0,1,4,-1
KR_6705704180,420,0,-9,-8,1,-6,7,1,5,0,5,-4,7,3,4,3,7,2,0,2,0,9,23,3,-5,2,-2,0,0,1,-1,0,1,5,-1
KR_6750878779,420,0,-14,-1,-2,1,1,2,1,1,2,1,6,7,-2,3,1,-3,3,0,0,-11,1,2,-6,4,-1,0,0,-1,1,1,-1,2,-1
KR_6764728011,420,-2,-7,3,1,4,3,7,-1,2,1,-3,4,1,2,1,3,-1,2,1,1,-1,-182,1,-5,4,-3,0,1,1,1,1,1,4,-1
KR_6708485373,420,0,-6,24,8,5,0,5,1,2,3,3,0,3,-2,3,1,1,1,2,1,12,9,3,-6,3,-7,0,-1,1,1,-1,1,1,-1
KR_6674680307,420,-1,-4,-20,-1,4,0,4,-2,3,1,-3,5,2,-1,4,3,1,0,1,0,1,-1,3,-9,6,1,0,0,0,-1,0,-1,0,-1
KR_6741337444,420,-1,-53,-4,-5,-1,2,1,-2,4,2,-4,5,1,3,3,6,-1,1,0,0,2,17,-1,-3,4,1,0,0,-1,-1,0,-1,1,-1
KR_6742987392,420,-1,-65,-28,5,1,0,1,2,4,6,4,1,5,-3,8,5,1,0,1,1,9,11,1,-6,5,-2,0,-2,1,-1,-1,1,3,-1
KR_6689717006,420,3,42,-8,7,4,0,4,2,0,2,1,3,4,-3,4,1,3,1,4,0,4,184,2,-6,4,-1,0,0,-1,0,1,-1,2,-1
KR_6764943672,420,-1,22,-4,-4,1,2,3,0,2,2,1,3,4,-4,4,0,-2,3,1,0,-5,-1,-2,-4,6,0,0,0,-1,1,0,1,5,-1
KR_6765513505,420,-3,-26,12,-5,4,0,4,0,1,1,-4,6,2,-3,4,1,-2,3,1,0,-7,1,1,-6,5,-3,0,-1,-1,1,1,1,4,-1
KR_6631026623,420,-4,-28,-40,-8,-2,2,0,0,2,2,-2,5,3,0,0,0,-4,6,2,0,-9,-3,5,-8,3,-4,0,-1,1,-1,-1,1,1,-1
KR_6642363349,420,0,-21,16,0,-4,5,1,5,2,7,4,0,4,-5,8,3,0,1,1,1,3,1,-4,-3,7,1,0,0,-1,-1,0,1,4,-1
KR_6659121114,420,1,-10,-16,-2,1,0,1,1,1,2,-4,4,0,5,2,7,-5,5,0,0,6,5,-4,-3,7,-1,0,0,-1,-1,0,-1,2,-1
KR_6751941938,420,-2,30,28,-2,2,2,4,-1,2,1,-6,6,0,2,1,3,1,0,1,1,-3,3,1,-4,3,-2,0,1,1,1,1,-1,2,-1
KR_6761106620,420,0,14,12,-8,-5,6,1,-4,5,1,1,1,2,3,3,6,-3,4,1,1,-3,-8,-3,-3,6,4,0,-1,1,-1,-1,1,6,-1
KR_6655903639,420,-4,-80,-24,-3,3,1,4,-3,6,3,-2,4,2,-2,2,0,1,1,2,0,-6,-180,4,-12,8,-1,0,-2,-1,-1,-1,-1,1,-1
KR_6730953479,440,-2,-54,-3,-7,-3,3,0,1,4,5,0,1,1,-3,4,1,-2,2,0,0,-2,10,1,-3,2,1,0,-1,-1,-1,-1,-1,1,-1
KR_6748113659,420,1,-1,32,0,-2,4,2,1,3,4,2,0,2,-2,3,1,1,1,2,0,7,-1,0,-3,3,4,0,-1,-1,1,-1,-1,5,-1
KR_6532450277,420,0,-21,-8,3,0,2,2,-1,2,1,-1,4,3,3,2,5,2,0,2,0,9,-5,2,-5,3,-6,0,2,1,-1,1,1,1,-1
KR_6742416090,420,1,-20,-4,0,2,1,3,1,1,2,1,3,4,-2,4,2,-2,2,0,0,-7,-124,-3,-2,5,2,0,0,-1,1,1,1,6,-1
KR_6763373614,420,-1,9,21,3,-3,3,0,1,2,3,2,1,3,3,4,7,0,2,2,0,5,7,5,-8,3,-7,0,-1,-1,-1,-1,1,5,-1
KR_6741552541,420,0,-16,-8,-5,-3,3,0,5,1,6,-4,6,2,-3,3,0,0,0,0,0,1,4,-4,-5,9,-5,0,0,-1,-1,0,1,2,-1
KR_6684913313,420,-4,21,-16,-10,-3,4,1,-1,3,2,-1,1,0,-2,3,1,-3,5,2,0,-9,3,3,-8,5,-6,0,0,0,-1,1,1,0,-1
KR_6723138797,420,0,2,-8,5,5,0,5,4,4,8,0,2,2,-4,8,4,0,1,1,2,-2,4,0,-4,4,-1,0,-1,-1,1,1,1,6,-1
KR_6762547927,440,-3,2,-18,-7,1,0,1,-4,7,3,-1,2,1,0,0,0,-3,6,3,-1,-16,-3,8,-11,3,3,0,-1,-1,-1,-1,-1,6,-1
KR_6761782212,420,-5,-94,2,-4,0,1,1,0,2,2,0,0,0,-4,6,2,0,1,1,0,-2,118,-7,-1,8,0,0,-1,1,-1,-1,1,4,-1
KR_6764284940,420,-4,-75,-4,-12,0,1,1,-7,7,0,5,2,7,-11,11,0,1,0,1,-1,-10,42,1,-3,2,-1,0,-2,-1,1,-1,-1,4,-1
KR_6767566785,420,-2,-88,-20,-7,1,4,5,-3,4,1,-3,3,0,1,1,2,-3,4,1,0,-9,10,-7,-2,9,2,0,-2,-1,-1,-1,1,4,-1
KR_6748672785,420,1,12,28,-1,-3,3,0,3,2,5,3,2,5,-4,6,2,0,1,1,0,1,-1,-3,-1,4,1,0,0,1,1,0,-1,3,-1
KR_6692737928,440,1,-15,24,2,0,2,2,-5,6,1,3,4,7,0,4,4,4,1,5,0,5,-1,-3,-2,5,1,0,1,0,-1,1,-1,0,-1
KR_6608041686,420,-6,-94,-4,-14,-2,3,1,5,2,7,-11,11,0,-3,6,3,-3,3,0,0,-4,-1,-1,-4,5,-5,0,-3,-1,-1,-1,1,3,-1
KR_6724910245,440,-3,-97,-8,-6,-1,1,0,-4,4,0,0,3,3,-1,1,0,0,0,0,0,0,0,1,-5,4,1,0,-2,0,-1,-1,-1,0,-1
KR_6754800891,420,-3,-7,-28,-5,0,1,1,-3,4,1,-1,3,2,-2,4,2,1,0,1,0,-5,71,-3,-2,5,1,0,1,-1,-1,1,1,2,-1
KR_6763543798,420,-5,-77,-3,-12,-2,3,1,-2,4,2,-6,8,2,0,5,5,-2,3,1,1,-6,-3,1,-4,3,-1,0,-4,-1,-1,-1,1,3,-1
KR_6724219195,440,-3,-38,-10,-4,-4,6,2,-8,8,0,-2,2,0,9,3,12,1,1,2,0,7,3,4,-7,3,-1,0,0,0,-1,-1,1,0,-1
KR_6693942766,420,-3,29,23,-1,-2,3,1,-6,9,3,0,2,2,9,2,11,-2,3,1,0,1,-2,0,-4,4,0,0,0,1,-1,0,1,5,-1
KR_6673716209,420,-4,-19,-8,-9,-4,7,3,1,4,5,-3,3,0,-3,3,0,0,2,2,0,-9,4,3,-8,5,-5,0,-1,-1,0,-1,-1,3,-1
KR_6751049100,440,-1,-29,16,-5,-1,1,0,2,2,4,-3,3,0,-2,2,0,-1,1,0,0,-4,91,-3,-1,4,2,0,0,-1,-1,0,-1,1,-1
KR_6428848048,420,1,39,5,-9,-1,3,2,0,2,2,-5,7,2,-1,3,2,-2,3,1,0,-9,14,-6,-3,9,-1,0,-1,-1,-1,-1,-1,4,-1
KR_6741258570,420,0,1,-3,0,-1,3,2,-1,3,2,-2,6,4,3,3,6,1,0,1,0,7,7,5,-7,2,-3,0,1,-1,1,1,1,6,-1
KR_6747050817,420,-3,21,14,3,-2,3,1,4,1,5,1,3,4,0,2,2,0,1,1,1,-1,-6,-1,-4,5,1,0,0,-1,1,0,1,4,-1
KR_6759848461,420,-4,-18,8,-17,0,1,1,-7,8,1,-4,4,0,-2,6,4,-4,4,0,-2,-22,28,1,-2,1,-16,0,0,1,1,-1,-1,4,-1
KR_6763649049,420,-4,-53,-2,-5,3,2,5,3,2,5,-5,7,2,-5,5,0,-1,1,0,1,0,-6,-5,-5,10,1,0,1,-1,1,1,1,1,-1
KR_6717920018,420,-4,-7,-13,-7,-1,1,0,1,5,6,0,0,0,-5,6,1,-2,2,0,0,-8,4,1,-7,6,-1,0,-1,1,-1,-1,1,5,-1
KR_6736490305,420,-2,-43,-20,-7,-1,1,0,-5,5,0,-3,4,1,1,1,2,1,0,1,0,-7,-4,-4,-4,8,0,0,1,1,-1,1,1,6,-1
KR_6745107862,420,2,49,-8,3,2,1,3,4,0,4,-5,5,0,3,3,6,-1,1,0,1,1,112,0,-4,4,2,0,0,-1,-1,0,1,1,-1
KR_6338768705,420,3,59,30,-1,1,1,2,-1,1,0,-2,2,0,1,1,2,0,0,0,0,-2,3,-3,-3,6,-1,0,0,-1,-1,0,-1,2,-1
KR_6745454765,420,-4,-14,-16,-1,-2,4,2,-1,5,4,2,2,4,-1,1,0,1,0,1,0,-2,1,-3,-3,6,-2,0,-1,-1,1,-1,-1,4,-1
KR_6745083843,420,-2,-68,0,-3,-1,4,3,0,2,2,-1,3,2,-2,4,2,1,2,3,0,2,2,1,-5,4,0,0,-1,1,-1,-1,-1,6,-1
KR_6764756097,420,-3,-7,0,3,4,2,6,-2,3,1,-1,1,0,2,0,2,0,0,0,1,4,-2,7,-9,2,3,0,0,-1,1,0,1,5,-1
KR_6743331590,440,-2,22,-16,-1,0,3,3,-2,2,0,2,2,4,-1,2,1,0,0,0,0,-6,24,1,-6,5,-3,0,0,-1,1,0,-1,4,-1
KR_6607724448,420,-2,-58,2,-13,1,1,2,-7,7,0,-1,2,1,-7,7,0,1,0,1,0,-14,-7,3,-9,6,1,0,-1,1,1,-1,-1,5,-1
KR_6643755332,420,-3,3,4,-8,1,1,2,0,2,2,-2,4,2,-5,5,0,-2,3,1,0,-8,-4,-2,-2,4,-7,0,-1,-1,-1,-1,-1,1,-1
KR_6647419432,420,6,120,20,6,4,0,4,-1,5,4,-2,2,0,1,4,5,4,1,5,0,-5,-4,-1,-4,5,-1,0,0,-1,1,1,1,4,-1
KR_6752162877,440,-3,-21,8,-6,-4,5,1,0,1,1,-2,5,3,0,2,2,0,0,0,0,-5,3,1,-5,4,-4,0,0,-1,-1,0,1,6,-1
KR_6532273457,420,-5,4,-33,-16,-1,2,1,1,2,3,-1,1,0,-13,13,0,-2,3,1,0,-11,-183,3,-8,5,-2,0,-2,-1,-1,-1,-1,1,-1
KR_6694518822,420,-2,-1,-2,-9,0,2,2,-6,6,0,-5,6,1,1,1,2,1,0,1,0,-12,0,-2,-5,7,-3,0,-1,-1,-1,-1,-1,1,-1
KR_6753179311,420,-1,-68,-16,-3,2,1,3,0,1,1,-1,3,2,-5,8,3,1,1,2,-1,0,-60,0,-7,7,0,0,0,0,-1,-1,-1,0,-1
KR_6731871982,420,-4,-29,-43,-6,2,0,2,0,1,1,-4,4,0,-4,6,2,0,1,1,0,-4,34,-1,-4,5,-29,0,-1,1,-1,-1,-1,5,-1
KR_6626328290,420,0,25,4,-4,0,0,0,-2,5,3,0,0,0,1,3,4,-3,4,1,0,-8,35,-2,-3,5,-19,0,0,1,0,0,1,2,-1
KR_6658617198,420,-3,-90,-24,-6,0,1,1,-3,4,1,-5,6,1,-1,2,1,3,0,3,0,-6,-1,-2,-2,4,-3,0,0,1,-1,0,-1,3,-1
KR_6747490003,420,0,62,4,-1,0,2,2,1,1,2,-2,3,1,-1,2,1,1,1,2,0,-8,3,3,-5,2,0,0,0,-1,-1,1,1,5,-1
KR_6742264417,420,-1,21,-12,-3,-1,1,0,-2,3,1,-1,3,2,2,4,6,-1,2,1,0,4,8,-5,0,5,1,0,0,-1,-1,0,1,5,-1
KR_6762546943,420,-3,-8,-15,-5,-3,4,1,-5,7,2,1,1,2,0,4,4,2,0,2,0,-1,-1,1,-4,3,5,0,0,-1,-1,0,1,2,-1
KR_6718304553,420,-2,35,-15,1,4,1,5,-1,3,2,-1,2,1,0,0,0,-1,1,0,0,-3,4,-3,-5,8,-1,0,0,0,1,0,1,0,-1
KR_6760516371,440,-5,-49,-25,-13,-4,4,0,-2,3,1,-1,2,1,-5,7,2,-1,1,0,0,-12,1,-5,-1,6,-1,0,0,1,1,0,-1,2,-1
KR_6733573911,420,-1,18,-20,-2,3,1,4,2,2,4,-6,6,0,0,1,1,-1,1,0,0,-3,9,1,-5,4,-9,0,-1,-1,1,-1,1,5,-1
KR_6616503980,420,-5,4,-4,-10,1,0,1,-3,5,2,-4,5,1,-3,5,2,-1,3,2,0,-15,-9,-1,-6,7,-3,0,0,1,1,0,-1,2,-1
KR_6753789194,420,-4,-8,-40,-10,-3,4,1,-8,9,1,1,0,1,-1,2,1,1,0,1,-1,-6,-5,-3,-2,5,3,0,-1,-1,-1,-1,-1,2,-1
KR_6760760083,420,-2,23,-16,2,3,0,3,1,3,4,-3,3,0,2,1,3,-1,1,0,0,-1,9,3,-7,4,1,0,1,1,-1,1,1,6,-1
KR_6761387173,420,-3,-10,-8,-7,0,1,1,-1,2,1,-1,2,1,-4,6,2,-1,2,1,-1,-4,90,2,-5,3,0,0,1,-1,1,1,-1,4,-1
KR_6661413197,420,-3,24,0,-5,-4,6,2,-2,3,1,4,0,4,-4,6,2,1,2,3,-1,0,12,0,-5,5,-2,0,-2,-1,-1,-1,-1,1,-1
KR_6763559873,440,2,-26,48,5,-4,5,1,2,0,2,7,0,7,-3,5,2,3,1,4,0,11,-5,-6,-3,9,-1,0,-1,-1,-1,-1,-1,6,-1
KR_6751156865,420,-4,-16,-4,-9,-2,3,1,-5,5,0,-3,3,0,-2,3,1,3,0,3,0,-7,-1,-2,-3,5,-2,0,-1,1,1,-1,-1,3,-1
KR_6726069595,420,-4,-81,3,-11,-3,3,0,-1,2,1,-2,3,1,-6,6,0,1,0,1,0,-8,-3,-5,-1,6,-2,0,-2,-1,-1,-1,-1,2,-1
KR_6726330713,420,-2,-36,-24,-1,-2,4,2,0,1,1,-1,1,0,1,2,3,1,0,1,0,6,16,0,-4,4,6,0,0,-1,-1,-1,-1,5,-1
KR_6620677665,420,-1,-14,22,-3,-3,6,3,2,1,3,0,2,2,-1,3,2,-1,1,0,0,-5,7,3,-6,3,-4,0,-1,1,-1,-1,-1,2,-1
KR_6764004050,420,-2,-1,-16,-7,-2,2,0,-3,4,1,-2,4,2,0,2,2,0,1,1,-2,-11,-19,0,-4,4,0,0,0,0,0,0,-1,0,-1
KR_6677208671,420,-2,-75,5,-7,-5,8,3,0,2,2,-5,6,1,0,3,3,3,0,3,0,-1,14,-1,-3,4,-3,0,-4,0,-1,-1,-1,0,-1
KR_6705442479,420,1,-24,24,-3,-3,3,0,6,2,8,-1,2,1,-4,8,4,-1,1,0,0,-2,5,5,-7,2,-7,0,0,0,1,-1,-1,0,-1
KR_6753527538,420,-1,-93,24,2,0,3,3,-1,2,1,0,3,3,3,4,7,0,1,1,0,7,13,1,-3,2,1,0,-1,1,-1,-1,-1,1,-1
KR_6606359170,420,-1,35,51,-2,-1,1,0,3,2,5,3,0,3,-6,6,0,-1,1,0,0,-1,19,1,-5,4,5,0,-1,-1,-1,-1,-1,6,-1
KR_6759667454,420,-1,15,8,-6,0,1,1,-1,3,2,-3,5,2,-2,4,2,0,0,0,0,-6,4,1,-5,4,4,0,-1,1,-1,-1,-1,1,-1
KR_6610035031,420,0,2,0,-4,-4,4,0,3,0,3,0,1,1,-4,5,1,1,0,1,0,1,1,2,-7,5,3,0,0,-1,1,0,1,6,-1
KR_6706818271,420,0,-11,15,-5,1,0,1,2,3,5,-2,2,0,-2,3,1,-4,5,1,0,-4,-6,-6,-1,7,0,0,0,-1,1,0,-1,3,-1
KR_6484756990,420,1,-6,12,6,-2,5,3,-1,6,5,3,0,3,4,0,4,2,0,2,1,8,-4,7,-9,2,-2,0,0,0,-1,-1,1,0,-1
KR_6766864269,420,-1,-14,-26,-2,-1,2,1,-4,6,2,-5,6,1,7,0,7,1,1,2,0,-1,-23,0,-3,3,3,0,1,-1,-1,1,-1,6,-1
KR_6626272513,420,0,21,-24,-1,-1,1,0,-3,6,3,5,1,6,-3,4,1,1,1,2,0,-2,-1,-2,-3,5,-1,0,0,-1,-1,0,-1,1,-1
KR_6689423874,420,-6,-80,-16,-11,-3,3,0,1,1,2,-7,7,0,-3,3,0,1,0,1,0,-4,0,-2,-3,5,1,0,0,-1,-1,-1,-1,2,-1
KR_6655822171,440,-1,-11,-20,1,1,0,1,2,1,3,0,3,3,-1,3,2,-1,1,0,0,-5,2,0,-3,3,-1,0,1,-1,1,1,-1,6,-1
KR_6631261667,420,0,52,5,-3,4,1,5,-1,1,0,-4,6,2,-1,2,1,-1,2,1,0,-4,-8,3,-6,3,-3,0,0,-1,1,1,-1,4,-1
KR_6767162188,420,-1,-23,19,4,6,1,7,0,2,2,-7,8,1,4,1,5,1,1,2,0,6,-31,7,-9,2,9,0,1,1,1,1,1,3,-1
KR_6716368455,440,4,9,17,1,-1,2,1,-1,7,6,-1,2,1,1,1,2,3,1,4,1,5,8,2,-4,2,-1,0,1,0,1,1,1,0,-1
KR_6745827110,440,-3,-37,17,-9,-3,5,2,-2,2,0,-6,6,0,-4,4,0,6,0,6,0,-16,-8,-4,0,4,1,0,-2,-1,1,-1,-1,5,-1
KR_6709062829,420,0,28,12,0,1,3,4,-2,3,1,3,0,3,-2,3,1,0,0,0,0,-9,4,3,-6,3,-2,0,0,-1,1,1,1,3,-1
KR_6744937027,420,-1,-47,4,-4,2,1,3,0,2,2,-3,6,3,-2,4,2,-1,2,1,0,-5,-2,-3,-2,5,-3,0,-1,-1,-1,-1,-1,2,-1
KR_6727146000,420,-1,-5,-12,-6,0,1,1,-3,6,3,-2,3,1,-1,3,2,0,1,1,0,-10,3,-5,-8,13,-4,0,1,-1,-1,-1,-1,6,-1
KR_6757500010,440,-5,-58,-35,-11,0,1,1,-11,12,1,-1,1,0,4,2,6,-3,5,2,0,-4,-19,-5,-4,9,0,0,-1,1,-1,-1,-1,6,-1
KR_6762270717,420,-2,0,-8,-1,2,1,3,3,1,4,-2,3,1,-3,3,0,-1,1,0,0,-7,1,1,-7,6,0,0,-1,-1,1,-1,1,4,-1
KR_6693713360,420,-3,-38,-12,-7,-3,5,2,-2,3,1,-3,5,2,1,0,1,0,1,1,0,-6,62,-1,-5,6,1,0,-1,1,-1,-1,1,4,-1
KR_6759540936,420,0,-31,-26,0,3,2,5,0,2,2,3,0,3,-6,7,1,0,0,0,0,5,2,-1,-5,6,0,0,-1,0,-1,-1,-1,0,-1
KR_6762892860,420,2,31,16,7,-1,3,2,6,0,6,0,2,2,2,0,2,0,0,0,1,13,-3,0,-3,3,1,0,0,1,1,0,1,1,-1
KR_6635436483,440,-3,-5,25,-8,-3,3,0,0,2,2,0,1,1,-3,6,3,-2,2,0,0,-10,-8,2,-7,5,2,0,0,1,-1,0,-1,2,-1
KR_6756558023,420,-1,-28,-3,0,5,1,6,-3,5,2,3,1,4,-1,5,4,-4,5,1,1,0,-127,-3,-4,7,-1,0,-1,1,1,1,1,6,-1
KR_6767314329,420,0,34,24,-5,-2,3,1,0,2,2,-2,2,0,-2,3,1,1,0,1,0,-3,1,-4,-3,7,-3,0,0,1,0,0,1,6,-1
KR_6393783882,440,-1,24,16,-3,-1,1,0,2,2,4,-2,2,0,-4,5,1,2,1,3,0,-4,-176,2,-5,3,0,0,-2,1,-1,-1,1,2,-1
KR_6708842830,440,3,0,-10,5,-1,2,1,3,1,4,4,2,6,-2,6,4,1,3,4,0,7,2,-2,-4,6,2,0,-1,-1,-1,-1,1,4,-1
KR_6754840094,420,-2,35,4,-5,-6,6,0,0,1,1,-4,4,0,5,1,6,0,2,2,0,2,26,-2,-3,5,-11,0,-1,-1,-1,-1,1,5,-1
KR_6767219549,440,2,35,24,4,1,0,1,3,0,3,-3,3,0,2,1,3,1,0,1,0,1,5,5,-8,3,0,0,0,1,1,1,1,6,-1
KR_6732972211,420,-1,70,-12,-6,2,0,2,-2,4,2,-2,4,2,-3,4,1,-1,1,0,-2,-14,-9,-4,-3,7,4,0,0,1,1,0,-1,5,-1
KR_6754307555,440,-1,-17,4,-8,2,0,2,-3,5,2,0,2,2,-3,4,1,-4,5,1,-1,-11,-3,3,-6,3,-4,0,-1,-1,1,-1,-1,2,-1
KR_6724379109,420,-6,-107,-16,-17,-4,4,0,-1,2,1,-7,8,1,-5,7,2,0,0,0,0,-15,107,-3,-1,4,-5,0,-1,-1,-1,-1,-1,4,-1
KR_6762450938,420,-2,-71,11,-2,1,0,1,0,3,3,3,2,5,-5,7,2,-1,1,0,0,-5,1,1,-4,3,-3,0,-1,-1,1,-1,1,4,-1
KR_6738943181,420,0,0,-6,1,-3,3,0,1,3,4,5,0,5,-2,2,0,0,0,0,0,3,-12,-1,-3,4,-1,0,0,-1,-1,0,-1,6,-1
KR_6630044416,420,-3,-38,-4,-7,-3,3,0,-6,8,2,2,1,3,-2,6,4,2,1,3,0,-5,21,0,-6,6,-1,0,-2,-1,1,-1,-1,4,-1
KR_6550129689,420,-1,-7,36,-5,0,0,0,-3,6,3,-3,3,0,1,1,2,0,2,2,0,-13,-2,6,-6,0,-2,0,2,1,1,1,1,5,-1
KR_6606583526,420,-2,1,-3,2,-4,4,0,-1,2,1,1,2,3,1,2,3,5,0,5,0,3,0,1,-2,1,2,0,1,0,0,1,1,0,-1
KR_6635088790,420,-3,-99,-8,-4,2,0,2,0,1,1,-2,2,0,-4,7,3,0,2,2,0,-14,-1,-1,-3,4,3,0,0,1,1,-1,1,3,-1
KR_6735985446,420,-4,0,-36,-12,2,2,4,-5,8,3,-3,6,3,-3,4,1,-3,3,0,-2,-16,43,3,-6,3,-18,0,-1,-1,-1,1,-1,3,-1
KR_6642096449,420,-6,-47,-38,-13,1,2,3,-5,7,2,3,2,5,-7,9,2,-5,5,0,0,-8,-10,1,-6,5,1,0,-1,-1,-1,-1,-1,1,-1
KR_6742266163,440,-6,-83,-20,-12,0,1,1,-5,6,1,-3,3,0,-3,4,1,-1,2,1,0,-17,38,1,-7,6,-25,0,-1,0,-1,-1,-1,0,-1
KR_6765346888,420,-1,59,0,-2,-1,3,2,-3,6,3,0,4,4,2,2,4,0,2,2,0,-4,7,2,-6,4,2,0,1,1,-1,1,-1,1,-1
KR_6756843773,420,-1,-45,1,4,-2,3,1,-5,6,1,6,0,6,3,0,3,2,0,2,0,4,4,0,-4,4,-3,0,0,1,1,1,1,2,-1
KR_6747358079,420,-2,-43,0,-2,-3,6,3,1,1,2,4,1,5,-2,5,3,-2,2,0,0,2,-14,2,-3,1,-1,0,-1,1,1,-1,-1,5,-1
KR_6634123032,420,3,26,-16,10,-4,4,0,-1,1,0,3,3,6,11,0,11,1,1,2,0,10,-1,-3,-3,6,2,0,-1,1,-1,-1,1,2,-1
KR_6745321143,420,-2,40,-23,-5,-2,6,4,0,2,2,-4,7,3,-3,6,3,4,0,4,0,2,5,0,-4,4,3,0,1,-1,0,1,1,6,-1
KR_6767048007,420,-3,-32,-2,-6,2,3,5,-1,4,3,-5,6,1,0,4,4,-2,3,1,0,-3,-89,1,-6,5,-1,0,0,-1,0,-1,1,3,-1
KR_6733079375,420,2,51,1,3,8,0,8,0,3,3,0,0,0,0,1,1,-5,5,0,-1,-7,238,0,-4,4,1,0,0,1,1,1,-1,5,-1
KR_6758095050,420,-4,-82,-20,0,-2,2,0,3,1,4,-2,5,3,1,1,2,0,2,2,0,8,-4,-2,-2,4,3,0,-3,-1,-1,-1,1,5,-1
KR_6729574706,420,-4,-47,-4,-9,-6,6,0,-1,1,0,-4,6,2,1,2,3,1,0,1,-1,-5,-2,-1,-1,2,1,0,1,-1,-1,1,-1,2,-1
KR_6629022879,420,0,-38,2,-3,0,1,1,0,2,2,-1,1,0,-1,2,1,-1,1,0,0,0,1,6,-11,5,-3,0,0,-1,1,0,-1,1,-1
KR_6752589753,420,-4,1,-27,-8,-4,4,0,2,1,3,4,1,5,-7,8,1,-3,4,1,0,-6,-19,3,-6,3,30,0,0,-1,1,1,1,6,-1
KR_6766375109,420,1,50,0,1,0,2,2,1,1,2,1,3,4,-1,2,1,0,0,0,-1,3,-5,0,-5,5,3,0,0,1,-1,0,-1,2,-1
KR_6759242053,420,-8,-91,-4,-13,-5,5,0,-4,5,1,-4,4,0,0,1,1,0,0,0,0,-5,-129,7,-12,5,-2,0,-3,-1,-1,-1,-1,1,-1
KR_6764144258,420,0,-54,-13,-1,-3,4,1,6,0,6,-3,3,0,-1,2,1,0,1,1,0,9,101,0,-4,4,-3,0,-2,-1,-1,-1,-1,1,-1
KR_6762985410,420,-1,-18,-20,0,1,3,4,1,1,2,-1,2,1,-2,3,1,1,0,1,0,-2,41,0,-5,5,-6,0,0,0,0,0,1,0,-1
KR_6615973446,420,-8,-140,-16,-22,-3,5,2,-4,5,1,-5,5,0,-11,11,0,1,0,1,0,-15,-4,2,-3,1,-2,0,-2,1,1,-1,-1,6,-1
KR_6606742315,420,2,0,0,3,-3,3,0,-1,5,4,1,3,4,6,0,6,0,1,1,0,3,6,1,-3,2,1,0,0,1,0,1,1,5,-1
KR_6750905719,420,-1,50,9,-4,-5,6,1,1,2,3,-3,4,1,3,0,3,0,0,0,0,-5,-36,-1,-6,7,1,0,0,1,-1,-1,1,5,-1
KR_6752290775,420,1,12,-28,-1,-1,2,1,-1,4,3,2,1,3,-1,3,2,0,0,0,0,0,6,4,-5,1,-1,0,1,-1,1,1,-1,2,-1
KR_6756801753,420,-4,-30,0,-9,-3,3,0,-1,4,3,2,0,2,-3,4,1,-4,4,0,-1,-12,-14,3,-8,5,-2,0,-1,0,0,-1,1,0,-1
KR_6755775445,420,2,39,19,0,-2,3,1,-1,3,2,-1,5,4,0,1,1,4,0,4,0,-3,5,5,-5,0,-3,0,0,1,1,1,1,1,-1
KR_6685128324,440,-7,-103,-11,-13,-3,3,0,-6,6,0,0,5,5,-2,3,1,-2,2,0,0,-8,-4,4,-7,3,-6,0,-3,0,-1,-1,-1,0,-1
KR_6766951580,420,-4,-44,-24,-12,-5,5,0,-4,5,1,-5,5,0,0,1,1,2,0,2,0,-14,-4,-3,-1,4,-4,0,0,1,-1,-1,-1,4,-1
KR_6753123399,420,-2,-66,-4,-2,-6,6,0,6,0,6,-3,6,3,0,1,1,1,3,4,0,-2,-4,1,-5,4,-3,0,0,1,-1,-1,-1,3,-1
KR_6732971263,440,1,12,11,6,0,0,0,0,2,2,-2,2,0,6,0,6,2,1,3,0,7,1,3,-4,1,-2,0,0,1,1,0,1,4,-1
KR_6708388097,420,-1,-39,-4,-8,-6,6,0,1,0,1,-1,1,0,-2,3,1,0,0,0,0,-4,-1,1,-3,2,-1,0,0,-1,1,-1,-1,5,-1
KR_6755578150,420,-1,-18,10,3,0,1,1,6,2,8,-1,3,2,0,4,4,-2,5,3,0,1,15,-6,-1,7,-2,0,0,0,1,0,1,0,-1
KR_6628271341,420,-1,-29,16,-1,-1,3,2,-1,2,1,2,1,3,-1,8,7,0,0,0,2,-1,-17,-2,-4,6,-2,0,1,-1,1,1,1,5,-1
KR_6752732682,440,-2,-89,6,3,-2,2,0,8,2,10,0,1,1,-1,3,2,-2,3,1,-1,2,-286,7,-8,1,2,0,-1,-1,0,-1,-1,4,-1
KR_6755355666,420,3,-50,0,11,1,3,4,1,2,3,0,1,1,5,0,5,4,1,5,-1,11,2,3,-4,1,0,0,0,1,1,0,-1,5,-1
KR_6097064870,420,-2,-73,0,-3,1,2,3,-3,5,2,-2,3,1,-1,1,0,2,0,2,0,-2,10,6,-9,3,-9,0,0,-1,1,0,-1,2,-1
KR_6760689059,420,-1,-30,8,-1,0,3,3,5,2,7,-1,1,0,-5,5,0,0,1,1,1,-4,-12,-4,-3,7,4,0,-1,-1,1,1,1,1,-1
KR_6750788361,420,-2,-88,18,-6,-2,3,1,2,1,3,1,2,3,-1,4,3,-6,6,0,0,-9,15,4,-6,2,1,0,0,-1,-1,0,1,3,-1
KR_6765050141,420,-5,13,-10,-11,-2,4,2,-2,6,4,-1,1,0,-3,4,1,-3,3,0,0,-11,3,-2,-5,7,-4,0,-1,-1,-1,-1,1,5,-1
KR_6765622520,420,-2,8,-26,-2,-3,4,1,-4,5,1,-2,2,0,4,2,6,3,1,4,-1,2,-9,-1,-5,6,3,0,0,1,0,0,-1,5,-1
KR_6762363530,420,-3,-52,-36,-2,-3,6,3,0,3,3,1,2,3,-1,3,2,1,1,2,-3,-4,7,2,-7,5,2,0,0,0,0,-1,-1,0,-1
KR_6760956379,420,3,35,-12,4,4,0,4,1,0,1,0,1,1,-2,3,1,1,0,1,0,3,24,-4,-3,7,-20,0,1,-1,1,1,1,5,-1
KR_6761853090,440,0,-16,2,-2,-1,1,0,3,1,4,-7,8,1,0,4,4,3,0,3,0,8,11,3,-6,3,-1,0,0,-1,1,-1,1,1,-1
KR_6749376671,420,1,-18,-1,0,1,0,1,1,2,3,3,0,3,-5,5,0,0,3,3,0,-2,0,2,-4,2,0,0,0,-1,-1,0,-1,1,-1
KR_6733605318,420,-3,45,0,-4,0,2,2,1,2,3,-3,4,1,0,5,5,-2,3,1,0,-2,48,2,-4,2,-25,0,0,-1,1,1,1,3,-1
KR_6646272703,420,2,-21,32,5,4,0,4,0,5,5,0,0,0,0,2,2,1,1,2,0,0,-3,0,-4,4,2,0,0,1,1,1,1,4,-1
KR_6765811372,420,1,49,20,-2,1,0,1,-3,3,0,0,2,2,0,2,2,0,1,1,0,2,8,-2,-2,4,-3,0,1,-1,0,1,-1,2,-1
KR_6755004858,420,-5,-125,-30,-7,-1,2,1,-1,1,0,0,0,0,-1,7,6,-4,4,0,-1,-5,0,-1,-3,4,2,0,-3,0,-1,-1,-1,0,-1
KR_6525558220,420,0,-29,36,-9,-2,3,1,-1,4,3,-4,4,0,-3,4,1,1,0,1,0,-12,-4,-2,-4,6,6,0,-2,1,-1,-1,-1,2,-1
KR_6753276566,420,-5,-39,-16,-11,-4,4,0,-4,6,2,1,2,3,-3,8,5,-1,2,1,1,-11,5,4,-11,7,-1,0,-1,1,-1,-1,1,5,-1
KR_6646202962,420,1,-25,20,1,5,0,5,-3,5,2,-5,6,1,6,1,7,-2,3,1,0,-4,1,2,-7,5,-2,0,0,0,0,0,1,0,-1
KR_6764789794,420,1,-67,24,3,1,0,1,1,3,4,0,1,1,1,2,3,0,1,1,-1,5,4,-5,-2,7,-1,0,-1,1,-1,-1,-1,6,-1
KR_6761625261,420,2,-50,-9,2,-1,1,0,-1,6,5,2,1,3,-3,5,2,5,1,6,-1,2,33,-1,-5,6,-3,0,1,-1,1,1,-1,6,-1
KR_6649615412,440,-7,-94,5,-12,-3,5,2,3,1,4,4,0,4,-15,16,1,-1,1,0,-2,-11,6,4,-6,2,-4,0,-3,-1,1,-1,-1,1,-1
KR_6673976075,420,0,1,-12,-7,3,2,5,-2,6,4,-5,5,0,-2,3,1,-1,1,0,0,-16,-42,-4,-2,6,14,0,1,-1,1,1,1,6,-1
KR_6747438714,420,1,0,4,1,3,0,3,-1,3,2,1,1,2,-4,4,0,2,0,2,0,-5,0,1,-4,3,0,0,0,-1,1,0,1,4,-1
KR_6650178829,420,1,-9,0,3,1,0,1,4,1,5,1,1,2,-2,3,1,-1,2,1,0,3,173,-2,-3,5,2,0,-1,-1,-1,-1,-1,2,-1
KR_6646579410,420,-4,-78,-18,-7,-2,2,0,0,5,5,-6,7,1,0,1,1,1,0,1,0,-6,1,3,-7,4,-5,0,-1,-1,-1,-1,-1,2,-1
KR_6765984010,420,3,23,10,7,1,1,2,2,0,2,0,3,3,2,1,3,2,1,3,0,6,-32,-1,-3,4,1,0,3,1,1,1,1,2,-1
KR_6569545973,440,-2,-56,9,-3,-2,3,1,-5,7,2,4,1,5,0,2,2,0,0,0,0,-6,0,2,-7,5,-1,0,-2,1,1,-1,1,2,-1
KR_6757617469,420,-2,-74,-8,-8,-5,5,0,-5,8,3,-1,2,1,3,2,5,0,0,0,0,-4,113,3,-5,2,-3,0,-1,-1,-1,-1,-1,6,-1
KR_6765499814,420,-4,-77,40,-9,-3,4,1,0,2,2,-3,5,2,-3,3,0,0,1,1,1,-9,-10,-5,-2,7,-1,0,-2,-1,1,-1,1,4,-1
KR_6722918086,420,-1,-43,19,-3,-1,2,1,5,2,7,1,2,3,-6,7,1,-2,3,1,-1,-8,15,-5,-3,8,1,0,-1,0,-1,-1,-1,0,-1
KR_6715107235,420,0,-31,34,1,1,1,2,3,0,3,1,1,2,-2,4,2,-2,2,0,0,1,-8,1,-3,2,-3,0,0,0,0,-1,1,0,-1
KR_6714922992,420,-3,-45,-4,-3,-3,4,1,1,1,2,-1,3,2,0,1,1,0,0,0,0,-1,-1,2,-5,3,-4,0,-1,1,-1,-1,1,6,-1
KR_6602957756,420,-2,-36,-4,-1,0,1,1,2,4,6,1,0,1,-7,9,2,3,1,4,0,-2,-7,-1,-6,7,4,0,0,-1,1,0,-1,5,-1
KR_6763418039,420,-2,-6,16,0,-1,2,1,-1,2,1,1,0,1,1,3,4,0,0,0,0,1,-31,2,-6,4,-5,0,0,1,1,0,-1,4,-1
KR_6732915196,420,-3,-37,-36,-4,3,0,3,-1,2,1,-4,5,1,0,0,0,-2,2,0,0,-4,-9,-1,-2,3,1,0,0,0,0,0,-1,0,-1
KR_6741288379,420,0,-32,8,-3,-1,1,0,4,3,7,-3,5,2,-3,4,1,0,3,3,0,-2,29,4,-10,6,-23,0,-1,0,0,-1,-1,0,-1
KR_6604040094,420,-7,-110,0,-6,0,4,4,3,2,5,-7,7,0,-1,7,6,-1,2,1,-1,0,5,1,-6,5,-5,0,0,-1,1,-1,1,5,-1
KR_6734048025,440,-3,20,2,0,1,1,2,-4,5,1,-2,3,1,4,2,6,1,1,2,1,-6,-209,-3,-4,7,-1,0,0,-1,-1,0,1,6,-1
KR_6670262276,420,2,45,1,0,1,0,1,-2,3,1,0,1,1,1,1,2,0,1,1,0,-4,-116,0,-6,6,2,0,0,-1,1,0,1,1,-1
KR_6750340751,440,4,43,14,9,6,1,7,1,4,5,3,0,3,-1,3,2,0,1,1,0,7,-5,-1,-1,2,3,0,1,-1,1,1,1,3,-1
KR_6681637477,420,-4,-29,-14,-9,-1,1,0,-1,3,2,0,2,2,-6,9,3,-1,3,2,0,-16,-7,-3,-2,5,2,0,0,-1,0,-1,-1,4,-1
KR_6626196028,420,0,-25,12,-4,-5,6,1,-1,3,2,2,2,4,1,4,5,-1,2,1,0,-3,487,13,-14,1,-17,0,0,1,-1,-1,1,6,-1
KR_6761609840,440,-3,-55,-21,-1,5,0,5,-1,1,0,0,0,0,-5,7,2,0,1,1,0,-7,-4,-2,-1,3,0,0,-1,1,1,-1,-1,2,-1
KR_6759589748,440,2,-55,48,0,6,1,7,0,2,2,0,3,3,-6,7,1,0,1,1,-1,-1,28,-4,-1,5,3,0,-1,-1,0,-1,-1,4,-1
KR_6653332683,420,-1,-7,-16,-6,-1,1,0,-2,3,1,-1,3,2,-1,2,1,-1,1,0,0,-2,-6,-1,-4,5,2,0,0,-1,1,0,-1,6,-1
KR_6702471880,420,6,77,9,12,9,0,9,-1,5,4,2,0,2,-6,8,2,8,0,8,2,9,394,3,-6,3,5,0,2,1,1,1,1,6,-1
KR_6736436602,420,-2,7,0,-4,0,2,2,1,1,2,-4,5,1,0,4,4,-1,2,1,0,-9,-1,1,-4,3,5,0,0,-1,-1,0,-1,3,-1
KR_6698297092,420,-1,-64,22,-3,-10,10,0,3,2,5,3,3,6,0,1,1,1,1,2,0,3,-22,-1,-4,5,1,0,-2,-1,-1,-1,-1,4,-1
KR_6766115726,420,1,-12,1,4,5,0,5,-6,7,1,-4,7,3,7,1,8,2,0,2,0,-2,-101,5,-6,1,0,0,-1,0,1,1,1,0,-1
KR_6607947554,420,-4,-118,22,-7,-3,3,0,1,3,4,-3,4,1,-1,7,6,-1,1,0,0,-7,7,-3,-2,5,0,0,-1,1,-1,-1,1,1,-1
KR_6739949308,420,-3,-96,-16,-7,-1,4,3,-3,4,1,0,1,1,-4,4,0,1,2,3,-1,-4,101,-3,-3,6,2,0,-1,0,-1,-1,-1,0,-1
KR_6763613860,420,-1,0,3,-2,1,3,4,4,2,6,-7,7,0,3,2,5,-3,3,0,0,-1,-3,-1,-5,6,1,0,0,-1,-1,0,-1,4,-1
KR_6762856228,420,-1,2,-15,-4,0,2,2,0,1,1,-4,6,2,1,7,8,-1,3,2,0,2,2,3,-5,2,-5,0,1,-1,1,1,1,3,-1
KR_6763300397,440,0,39,-20,-5,-1,3,2,1,1,2,-1,3,2,-2,5,3,-2,2,0,0,-6,188,-2,-4,6,3,0,0,-1,-1,-1,-1,5,-1
KR_6685966157,420,-1,-66,-20,-6,2,1,3,-3,5,2,1,2,3,-2,3,1,-4,6,2,0,-9,61,-1,-3,4,-2,0,0,-1,0,-1,-1,5,-1
KR_6766112085,420,-6,-67,-7,-18,-1,2,1,-6,6,0,0,2,2,-7,7,0,-4,4,0,0,-17,-12,-3,-2,5,-2,0,-1,1,-1,-1,-1,6,-1
KR_6707519379,420,0,-4,5,5,2,0,2,2,1,3,3,2,5,-2,2,0,0,0,0,0,3,7,-2,-6,8,-1,0,1,-1,1,1,-1,6,-1
KR_6731483155,420,-5,21,-44,-5,0,2,2,5,1,6,-7,7,0,-4,4,0,1,0,1,0,0,30,-4,-4,8,0,0,1,1,-1,1,-1,4,-1
KR_6758128446,420,-3,-11,5,0,-1,2,1,-1,2,1,0,2,2,1,0,1,1,0,1,0,-5,-6,2,-4,2,1,0,1,-1,1,1,1,1,-1
KR_6752362382,420,3,-18,36,1,-3,5,2,-1,2,1,-1,2,1,3,3,6,3,1,4,-1,-2,5,0,-4,4,-7,0,0,1,1,0,-1,6,-1
KR_6551690760,420,-3,-81,1,-5,-3,5,2,-5,10,5,1,1,2,1,0,1,1,1,2,-1,-3,-7,-8,-6,14,6,0,-1,-1,0,-1,-1,3,-1
KR_6755133297,420,-6,-25,-20,-12,3,0,3,-2,4,2,-2,2,0,-9,10,1,-2,2,0,0,-13,-6,-2,-7,9,-4,0,-2,-1,-1,-1,1,1,-1
KR_6749100911,420,-2,-54,4,-1,-3,4,1,1,1,2,0,3,3,0,1,1,1,0,1,0,-4,-2,-4,-2,6,2,0,-1,-1,-1,-1,1,4,-1
KR_6760456249,440,-1,5,52,-8,3,1,4,0,0,0,-2,3,1,-4,4,0,-5,7,2,0,-7,-6,-2,-1,3,3,0,0,1,0,0,-1,4,-1
KR_6633018112,420,-1,-42,-33,-7,-3,4,1,-4,5,1,0,3,3,0,4,4,0,2,2,-1,-8,-7,-4,-2,6,1,0,-1,-1,0,-1,-1,6,-1
KR_6765429469,420,-3,-70,19,-16,1,2,3,-1,2,1,-4,7,3,-5,8,3,-7,7,0,-1,-12,17,2,-6,4,-1,0,-2,-1,-1,-1,-1,1,-1
KR_6767425434,420,0,-49,5,-5,-1,1,0,-1,3,2,-6,7,1,3,1,4,0,0,0,0,-2,1,-5,-1,6,-1,0,-1,1,-1,-1,-1,1,-1
KR_6759073359,420,1,85,-41,0,2,0,2,-1,3,2,1,3,4,0,1,1,-2,4,2,-1,-2,38,-3,-1,4,-3,0,0,-1,-1,1,-1,5,-1
KR_6538710732,420,1,52,12,4,4,0,4,-3,3,0,2,4,6,0,4,4,1,0,1,0,-1,2,-1,-3,4,-3,0,0,1,-1,0,-1,2,-1
KR_6748362165,420,-2,-3,-16,-7,-1,2,1,-2,2,0,0,1,1,-4,7,3,0,0,0,0,-5,3,-2,-2,4,2,0,0,-1,1,0,-1,3,-1
KR_6758942093,420,-3,-30,-4,0,-1,1,0,1,3,4,0,2,2,-1,2,1,1,1,2,0,-3,7,1,-5,4,-4,0,0,-1,1,0,-1,3,-1
KR_6765645555,420,1,-22,-16,2,2,0,2,1,0,1,-3,7,4,2,2,4,0,0,0,0,15,4,-4,-3,7,1,0,0,-1,-1,-1,-1,5,-1
KR_6618711695,440,-1,47,20,-9,1,4,5,-1,1,0,-4,6,2,-2,2,0,-3,5,2,-2,-18,-2,-4,-4,8,1,0,3,1,1,1,-1,1,-1
KR_6724454581,420,-4,-79,-12,-7,2,0,2,-4,5,1,-2,3,1,-3,5,2,0,0,0,0,-10,-20,-1,-3,4,-4,0,-1,-1,0,-1,-1,1,-1
KR_6723354728,420,-1,10,29,-5,-1,1,0,0,3,3,1,1,2,-4,5,1,-1,1,0,-1,-8,-10,-2,-3,5,0,0,-1,0,0,-1,-1,0,-1
KR_6719564839,420,0,11,10,-3,-1,1,0,0,4,4,-2,2,0,2,3,5,-2,3,1,-1,-4,-2,4,-7,3,-1,0,-1,-1,1,-1,-1,5,-1
KR_6627272785,420,2,-36,0,9,4,1,5,4,3,7,1,1,2,0,1,1,0,1,1,0,9,4,3,-6,3,-2,0,-1,1,-1,-1,1,3,-1
KR_6610733314,420,-2,-5,-16,-3,-1,3,2,0,2,2,-3,5,2,1,3,4,0,2,2,0,-3,1,-1,-6,7,-2,0,0,1,-1,0,-1,6,-1
KR_6733082089,420,0,2,-21,4,1,0,1,1,4,5,-2,4,2,2,0,2,2,0,2,0,11,4,1,-3,2,-2,0,1,-1,-1,1,-1,1,-1
KR_6727105643,420,-9,-37,-60,-24,-7,7,0,-9,10,1,-9,9,0,1,3,4,0,2,2,-1,-14,-16,-3,-5,8,0,0,-3,-1,-1,-1,-1,4,-1
KR_6767180028,420,-3,1,-30,-11,-2,3,1,-4,4,0,-5,5,0,0,1,1,0,0,0,0,-11,-197,-1,-3,4,3,0,-1,-1,-1,-1,-1,6,-1
KR_6750762103,440,3,135,-12,10,2,1,3,1,0,1,8,1,9,-1,3,2,0,0,0,0,4,8,2,-4,2,0,0,3,-1,1,1,1,2,-1
KR_6615622225,420,2,-39,-12,4,2,1,3,4,3,7,3,0,3,-4,4,0,-1,1,0,0,2,2,3,-5,2,-3,0,-1,-1,1,-1,1,6,-1
KR_6744879645,420,2,32,58,1,2,3,5,-1,2,1,0,2,2,1,3,4,-1,2,1,1,-4,401,0,-6,6,2,0,1,1,1,1,1,5,-1
KR_6725646674,420,-6,-39,-5,-14,-1,3,2,-6,8,2,-3,3,0,-2,2,0,-2,2,0,0,-11,-16,-2,0,2,0,0,-1,-1,1,-1,-1,6,-1
KR_6749991860,420,1,28,-5,3,2,0,2,-2,4,2,1,1,2,-1,2,1,3,1,4,0,3,15,-3,0,3,3,0,1,1,1,1,1,3,-1
KR_6737722656,420,-2,-14,-8,0,-2,5,3,0,3,3,4,0,4,-1,1,0,-1,2,1,0,1,-5,-2,-2,4,0,0,-1,-1,-1,-1,1,1,-1
KR_6750992656,420,0,-3,4,-2,0,1,1,-1,5,4,-2,3,1,1,1,2,0,0,0,0,-3,19,2,-6,4,0,0,0,0,-1,1,-1,0,-1
KR_6658617924,440,1,79,-8,4,1,1,2,1,5,6,-1,2,1,2,0,2,1,0,1,1,7,13,2,-4,2,-4,0,0,-1,-1,0,1,5,-1
KR_6727117989,420,-2,-18,-4,-7,-3,4,1,-3,6,3,2,1,3,-3,4,1,0,0,0,0,-6,-13,-1,-2,3,-2,0,0,1,1,1,-1,6,-1
KR_6766135785,420,-3,0,-18,-3,-2,2,0,-3,5,2,2,3,5,0,3,3,0,0,0,2,-12,-19,0,-4,4,-1,0,-2,-1,-1,-1,1,5,-1
KR_6737551975,440,1,-8,-28,-3,0,3,3,-3,7,4,3,2,5,-1,6,5,-2,3,1,0,2,-46,-6,-1,7,13,0,-1,-1,-1,-1,1,6,-1
KR_6705538972,420,2,66,4,-1,-2,4,2,-1,1,0,-1,1,0,1,4,5,2,1,3,0,-2,-5,2,-3,1,-4,0,1,1,1,1,-1,1,-1
KR_5871429513,420,-2,-45,14,-8,1,1,2,-7,10,3,-5,8,3,-2,3,1,5,3,8,1,-3,5,-4,-4,8,-1,0,-1,-1,-1,-1,1,3,-1
KR_6737677130,440,0,24,1,3,0,2,2,4,2,6,1,0,1,-3,11,8,1,0,1,0,3,54,4,-5,1,-23,0,-1,1,-1,-1,-1,3,-1
KR_6652025898,420,-5,-4,-17,-11,-5,7,2,-1,3,2,0,0,0,-1,1,0,-4,4,0,0,-4,-2,-3,-4,7,-2,0,-2,-1,1,-1,-1,5,-1
KR_6760736001,420,-2,16,-16,-7,-4,4,0,1,1,2,-2,3,1,-2,4,2,0,1,1,0,-2,6,2,-5,3,-2,0,0,-1,1,0,-1,6,-1
KR_6629346673,420,-2,-46,-4,-3,-4,5,1,0,1,1,-2,4,2,2,0,2,1,0,1,0,5,-4,-3,-3,6,1,0,-1,-1,-1,-1,-1,4,-1
KR_6558468097,420,-2,-31,13,-8,-3,4,1,1,1,2,-2,2,0,-3,3,0,-1,1,0,0,-5,5,-2,-4,6,2,0,-1,-1,-1,-1,-1,4,-1
KR_6737164459,420,3,9,-12,9,2,2,4,-1,5,4,0,3,3,6,0,6,2,0,2,0,5,16,-3,-1,4,2,0,0,-1,1,0,1,3,-1
KR_6742135403,420,1,-11,-32,-4,-3,3,0,1,0,1,5,1,6,-8,8,0,1,0,1,0,-5,-3,-2,-4,6,-2,0,1,1,1,1,-1,3,-1
KR_6732250969,420,-4,28,-53,-3,-6,6,0,2,2,4,2,0,2,0,3,3,-1,1,0,0,2,5,1,-5,4,-2,0,-1,1,-1,-1,-1,2,-1
KR_6728539978,420,-4,-49,-53,-7,-7,7,0,-5,7,2,0,2,2,6,4,10,-1,1,0,-1,-8,11,0,-2,2,0,0,0,1,-1,-1,-1,2,-1
KR_6762276453,420,0,-12,1,2,-4,4,0,3,0,3,2,0,2,0,1,1,1,0,1,0,8,-15,-2,-2,4,3,0,-1,-1,-1,-1,-1,1,-1
KR_6766787501,420,-7,-81,-23,-14,-4,4,0,-5,5,0,-7,8,1,1,3,4,1,1,2,0,-4,-18,0,-3,3,1,0,-3,-1,1,-1,-1,4,-1
KR_6649005774,420,0,4,-5,-2,-2,5,3,-2,8,6,1,2,3,0,4,4,1,1,2,0,-8,0,3,-6,3,0,0,-1,-1,-1,-1,1,2,-1
KR_6441614886,420,2,20,28,3,2,0,2,-5,5,0,4,4,8,1,4,5,1,0,1,0,0,-191,-6,-2,8,-1,0,-1,-1,-1,-1,-1,3,-1
KR_6748824241,420,-1,-86,12,-3,-3,4,1,-1,2,1,-1,3,2,3,2,5,-1,3,2,-1,2,147,3,-3,0,-1,0,1,1,1,1,-1,1,-1
KR_6185916523,440,0,-40,1,0,3,2,5,-1,1,0,-2,2,0,-1,1,0,1,0,1,0,1,2,-1,-6,7,-6,0,-1,-1,-1,-1,-1,2,-1
KR_6765984809,420,-3,-95,-6,-3,0,1,1,0,2,2,-1,2,1,1,0,1,-3,3,0,0,-1,-4,0,-7,7,4,0,0,1,-1,0,-1,6,-1
KR_6762671385,420,-4,-43,8,-14,-4,5,1,-2,2,0,3,2,5,-7,13,6,-4,5,1,3,-3,-1,-4,-2,6,-3,0,-1,-1,-1,-1,-1,2,-1
KR_6488060771,420,0,23,8,-1,-4,5,1,3,1,4,-1,4,3,2,0,2,-1,1,0,-1,-3,2,2,-6,4,6,0,0,-1,1,0,-1,4,-1
KR_6749323069,420,1,-13,-4,4,1,0,1,-1,5,4,1,1,2,1,6,7,2,0,2,0,-3,1,-2,-2,4,0,0,-1,-1,1,-1,-1,4,-1
KR_6764626850,420,1,-54,30,-3,-2,5,3,3,2,5,0,1,1,-5,5,0,1,1,2,0,-8,-259,7,-7,0,-12,0,-1,1,-1,-1,-1,6,-1
KR_6740793482,420,-2,24,-17,-3,2,1,3,-1,5,4,1,2,3,-6,7,1,1,0,1,0,-5,-12,-3,-3,6,3,0,0,-1,-1,-1,1,6,-1
KR_6647478536,420,0,-22,-8,-3,4,2,6,0,1,1,-3,4,1,-4,4,0,0,1,1,0,-5,-3,-5,-2,7,-3,0,0,-1,-1,0,1,2,-1
KR_6623159395,420,-1,-42,5,-1,-3,4,1,0,3,3,2,0,2,-4,6,2,4,0,4,1,6,2,-2,-3,5,1,0,-1,-1,-1,-1,1,6,-1
KR_6706931267,420,-4,-47,-20,-11,-2,3,1,-2,4,2,-3,3,0,-4,5,1,0,2,2,0,-4,-214,3,-5,2,-2,0,-1,-1,-1,-1,-1,1,-1
KR_6757040805,420,-1,-27,-8,3,-3,4,1,4,0,4,1,2,3,1,3,4,0,1,1,0,2,8,2,-4,2,-2,0,-1,0,0,-1,1,0,-1
KR_6649257435,420,-4,-72,-20,-4,3,2,5,-2,4,2,-2,2,0,-1,2,1,-2,3,1,0,-7,-45,1,-5,4,17,0,0,-1,1,0,1,5,-1
KR_6754944784,420,-2,18,-1,-12,-1,2,1,-3,5,2,-1,2,1,-6,6,0,-1,1,0,0,-21,-13,-3,-2,5,5,0,-2,-1,-1,-1,1,5,-1
KR_6741117815,420,-5,-118,-28,-8,-1,3,2,-3,3,0,-2,3,1,-2,2,0,0,0,0,0,-8,29,-1,-3,4,0,0,-2,-1,-1,-1,-1,3,-1
KR_6719779455,420,1,95,36,1,3,0,3,-2,3,1,5,1,6,-5,5,0,0,1,1,0,-1,-5,-4,-3,7,3,0,0,-1,-1,1,-1,4,-1
KR_6752490298,420,1,28,11,-1,2,1,3,-10,11,1,2,1,3,6,1,7,-1,1,0,0,-3,-11,0,-5,5,5,0,0,-1,-1,-1,1,6,-1
KR_6751283327,420,-6,-54,-20,-14,2,1,3,-5,5,0,-5,5,0,-5,6,1,-1,1,0,0,-15,-6,-4,-2,6,1,0,-1,-1,-1,-1,-1,1,-1
KR_6654954023,420,-2,14,4,-1,-2,5,3,-4,4,0,-1,3,2,4,1,5,2,2,4,0,-8,2,3,-10,7,-4,0,0,1,1,0,1,2,-1
KR_6698653848,420,-2,-42,-15,-2,-2,4,2,1,1,2,-1,5,4,1,1,2,-1,2,1,0,3,-102,0,-3,3,-2,0,0,1,1,0,-1,5,-1
KR_6766188184,420,-1,-21,-24,0,-8,8,0,4,1,5,-2,4,2,6,1,7,0,1,1,3,11,12,-1,-4,5,-2,0,-1,1,-1,-1,1,1,-1
KR_6669504186,420,-2,-1,-33,-3,-1,4,3,-4,5,1,0,2,2,1,4,5,1,3,4,0,-4,-11,-2,-3,5,24,0,-2,0,-1,-1,1,0,-1
KR_6736229008,420,-3,-76,-16,-5,-6,7,1,1,1,2,-1,3,2,0,2,2,1,0,1,0,-3,-9,3,-9,6,5,0,-1,-1,-1,-1,1,3,-1
KR_6744592210,420,-2,-42,-16,3,3,0,3,2,4,6,1,0,1,-2,4,2,-1,2,1,0,-1,7,3,-9,6,4,0,-1,-1,1,-1,1,1,-1
KR_6592450660,420,0,0,21,-5,-1,2,1,-2,2,0,-2,4,2,1,1,2,-1,1,0,0,-9,-1,-3,-5,8,2,0,0,-1,-1,-1,1,3,-1
KR_6759159256,420,-1,-29,-8,-3,2,0,2,-6,7,1,-3,5,2,1,0,1,3,0,3,0,1,-41,-4,-2,6,24,0,0,-1,-1,0,-1,1,-1
KR_6764145237,420,2,10,-25,-4,0,2,2,-6,6,0,-2,4,2,2,3,5,2,0,2,0,-2,-6,1,-4,3,0,0,0,1,-1,-1,-1,6,-1
KR_6688391098,420,-1,-66,-4,1,-2,2,0,2,0,2,-4,6,2,3,1,4,2,1,3,0,4,2,-2,-4,6,-6,0,-3,1,-1,-1,-1,1,-1
KR_6758506184,420,-2,-34,4,-5,1,2,3,1,1,2,4,2,6,-7,8,1,-4,5,1,1,-4,-5,0,-8,8,0,0,0,0,1,-1,1,0,-1
KR_6750886761,420,-3,-17,-24,-4,-4,6,2,1,1,2,-4,4,0,3,2,5,0,1,1,0,-4,14,-1,-2,3,4,0,0,1,-1,1,1,6,-1
KR_6758166343,420,2,26,19,0,6,0,6,-1,3,2,1,1,2,-7,8,1,1,0,1,0,-2,6,2,-5,3,-2,0,1,1,1,1,-1,3,-1
KR_6760322985,420,-1,-13,28,-1,-5,5,0,-1,2,1,-1,2,1,4,1,5,2,0,2,1,5,-5,1,-5,4,6,0,1,1,1,1,1,3,-1
KR_6761134049,420,-2,-15,4,-1,-1,1,0,2,1,3,-3,4,1,0,2,2,1,0,1,0,-3,5,-3,-4,7,-6,0,0,1,-1,-1,-1,6,-1
KR_6748472842,420,3,36,20,3,2,2,4,1,3,4,3,0,3,-4,5,1,1,0,1,0,0,5,-1,-4,5,0,0,-1,1,-1,-1,1,6,-1
KR_6635545268,440,-3,-65,-4,-4,-1,1,0,-4,6,2,2,3,5,-1,2,1,0,0,0,0,-10,-186,0,-3,3,32,0,0,-1,-1,0,1,5,-1
KR_6764831770,420,0,38,-14,1,5,0,5,-2,3,1,-1,3,2,0,1,1,-1,2,1,0,0,-2,-2,-3,5,1,0,1,-1,1,1,-1,4,-1
KR_6508246148,440,5,79,20,7,2,1,3,3,4,7,3,0,3,0,1,1,-1,3,2,0,8,5,1,-1,0,2,0,0,0,1,1,1,0,-1
KR_6704421144,420,0,-48,-20,1,0,0,0,-2,3,1,2,5,7,1,6,7,0,2,2,1,1,-9,4,-4,0,0,0,0,-1,0,0,1,5,-1
KR_6766412416,420,-1,-28,4,-1,-2,3,1,-1,2,1,-1,2,1,3,0,3,0,1,1,0,2,81,5,-9,4,-3,0,0,1,1,0,-1,3,-1
KR_6671873214,420,1,20,12,1,0,1,1,0,1,1,-1,3,2,-1,4,3,3,0,3,0,5,-1,-1,-5,6,4,0,-2,1,1,-1,-1,4,-1
KR_6685810834,420,-1,-3,-9,-5,0,0,0,-1,5,4,2,1,3,-5,5,0,-1,1,0,-1,-8,10,-1,-8,9,-4,0,0,-1,1,1,-1,1,-1
KR_6675883938,420,-1,24,-30,-10,0,3,3,1,2,3,-3,5,2,-8,8,0,0,0,0,0,-6,-100,4,-7,3,-4,0,1,1,-1,1,-1,2,-1
KR_6766044771,420,-5,-72,-12,-12,-1,3,2,-3,3,0,-5,7,2,-5,5,0,2,0,2,-1,-13,35,-2,-4,6,-8,0,-1,-1,1,-1,-1,5,-1
KR_6751223061,440,2,48,8,3,0,0,0,3,0,3,0,2,2,0,1,1,0,0,0,0,3,6,2,-7,5,8,0,0,1,1,0,1,5,-1
KR_6765906503,420,0,-40,-4,2,2,2,4,-1,3,2,3,1,4,-2,4,2,0,3,3,0,2,-21,1,-5,4,2,0,-2,0,-1,-1,-1,0,-1
KR_6688178717,440,1,18,4,0,5,4,9,0,0,0,-5,7,2,2,2,4,-2,2,0,0,1,-104,0,-5,5,1,0,-1,1,-1,-1,-1,5,-1
KR_6444222035,420,-4,-40,-37,-12,0,1,1,-3,3,0,-7,8,1,-1,2,1,-1,1,0,0,-13,-23,-2,-2,4,0,0,-3,-1,-1,-1,-1,6,-1
KR_6756595902,420,-6,-23,-32,-6,1,2,3,-2,5,3,-4,4,0,2,3,5,-3,3,0,0,1,-2,2,-4,2,2,0,-1,0,-1,-1,1,0,-1
KR_6762736234,420,-5,-105,-20,-9,-2,4,2,-2,4,2,1,2,3,-3,5,2,-3,4,1,-1,-12,-4,-8,-1,9,-1,0,-1,-1,1,-1,-1,4,-1
KR_6767217476,420,0,46,28,1,1,2,3,1,2,3,0,0,0,1,1,2,-2,2,0,0,0,416,-1,-4,5,1,0,0,1,0,0,1,1,-1
KR_6694356608,420,-3,-51,4,-6,4,0,4,-1,3,2,0,2,2,-5,5,0,-4,4,0,-1,-4,3,0,-1,1,-5,0,0,-1,1,-1,-1,2,-1
KR_6606798995,420,0,-47,28,-9,-4,4,0,4,2,6,1,0,1,-7,8,1,-3,5,2,0,-8,6,-1,-4,5,0,0,-1,1,0,-1,-1,3,-1
KR_6548571140,420,0,-33,-5,5,3,3,6,2,2,4,-3,3,0,3,0,3,0,1,1,0,8,0,-1,-7,8,-2,0,0,-1,-1,0,-1,1,-1
KR_6733300631,440,-2,-81,3,-3,-1,2,1,5,4,9,-7,7,0,1,1,2,-1,1,0,0,-5,-6,-5,0,5,3,0,0,0,-1,0,-1,0,-1
KR_6748542143,440,-8,-156,-23,-21,-5,5,0,0,3,3,-7,7,0,-3,7,4,-6,7,1,-2,-21,-3,-3,-1,4,-2,0,-1,-1,-1,-1,-1,1,-1
KR_6695735050,420,0,-8,-16,1,2,1,3,0,1,1,1,3,4,-2,4,2,0,0,0,0,-3,11,1,-5,4,4,0,0,1,-1,-1,1,6,-1
KR_6690970496,420,-4,-41,-20,-10,-4,4,0,-3,5,2,-4,4,0,-1,4,3,2,0,2,0,-1,2,-4,-4,8,-3,0,-1,-1,-1,-1,1,3,-1
KR_6610367062,420,2,5,-4,2,-1,1,0,1,3,4,7,0,7,-2,4,2,-3,4,1,0,0,-178,3,-5,2,-1,0,0,0,1,1,-1,0,-1
KR_6749216716,420,-2,-74,-13,-3,-8,9,1,0,1,1,6,0,6,-1,2,1,0,0,0,0,5,-30,-2,-4,6,-3,0,-1,-1,-1,-1,-1,4,-1
KR_6743312903,420,2,56,-11,-1,2,2,4,2,0,2,-1,4,3,-1,2,1,-3,3,0,0,-4,-27,-4,0,4,4,0,0,-1,1,0,1,3,-1
KR_6653277231,420,0,39,1,0,-1,2,1,-1,2,1,0,5,5,2,3,5,0,1,1,0,5,-164,-1,-4,5,-2,0,0,1,-1,-1,1,2,-1
KR_6751194225,420,0,22,-9,-2,-6,6,0,4,2,6,0,2,2,1,2,3,-1,1,0,0,2,-11,1,-5,4,-4,0,0,0,0,0,1,0,-1
KR_6744919252,420,-1,-85,12,-10,-5,7,2,0,3,3,-1,2,1,-5,7,2,1,1,2,0,-3,-3,-6,-2,8,-2,0,-1,-1,-1,-1,-1,6,-1
KR_6726166061,420,1,-13,-20,4,-1,1,0,-1,3,2,2,5,7,4,3,7,0,0,0,0,3,16,1,-4,3,-2,0,-1,-1,-1,-1,-1,5,-1
KR_6691212208,420,-2,-6,-24,1,2,1,3,2,3,5,-3,5,2,0,3,3,0,1,1,0,2,2,2,-6,4,0,0,0,1,-1,-1,-1,3,-1
KR_6767227916,420,-2,-66,-13,-4,0,2,2,-1,3,2,-3,3,0,1,1,2,-1,2,1,-1,-11,-4,0,-5,5,1,0,-1,-1,1,-1,-1,5,-1
KR_6765228554,440,-3,34,-16,2,6,1,7,0,2,2,1,0,1,-5,6,1,0,0,0,0,-1,3,-5,-2,7,0,0,1,-1,1,1,1,5,-1
KR_6751705245,420,-2,-37,8,-8,-3,4,1,-2,3,1,-2,2,0,0,1,1,-1,1,0,0,-2,-61,-5,-1,6,24,0,-1,-1,-1,-1,-1,1,-1
KR_6728744201,420,0,-29,-8,7,3,1,4,4,3,7,0,2,2,1,1,2,-1,2,1,0,3,-3,0,-9,9,2,0,0,-1,-1,-1,1,5,-1
KR_6766592012,420,1,54,8,1,-1,2,1,4,0,4,0,2,2,-2,5,3,0,2,2,1,0,-2,-4,-4,8,-7,0,0,-1,-1,0,1,1,-1
KR_6761109151,440,3,4,-7,2,1,5,6,-1,2,1,5,3,8,-3,4,1,0,0,0,0,2,4,0,-4,4,-2,0,0,-1,1,1,-1,6,-1
KR_6692827600,420,-5,-106,-16,-10,-1,4,3,-3,3,0,-2,4,2,-5,9,4,1,3,4,0,-7,1,2,-4,2,-2,0,-2,0,-1,-1,1,0,-1
KR_6384820442,420,-2,-2,-6,-8,1,0,1,-1,3,2,-3,4,1,-7,10,3,2,0,2,0,-5,-96,-1,-6,7,4,0,0,-1,-1,0,1,1,-1
KR_6764788643,420,-4,-54,-33,-10,-1,1,0,-4,4,0,2,0,2,-5,5,0,-2,2,0,0,-9,3,-2,-3,5,-3,0,1,-1,1,1,-1,1,-1
KR_6760106968,420,-7,-80,-4,-13,-1,1,0,-1,3,2,-1,1,0,-9,11,2,-1,2,1,0,-11,23,-2,-2,4,-3,0,-1,1,-1,-1,-1,5,-1
KR_6756722762,420,-1,-59,12,-1,-5,6,1,3,2,5,-4,6,2,1,1,2,4,0,4,-1,5,-16,-5,-1,6,5,0,-1,-1,-1,-1,-1,4,-1
KR_6767527931,420,1,15,-8,-2,-2,3,1,-4,5,1,7,0,7,-3,8,5,0,1,1,0,4,-4,-3,-2,5,1,0,-1,-1,1,-1,-1,3,-1
KR_6723146259,420,-1,-5,-3,-5,-1,3,2,3,0,3,-3,4,1,-3,4,1,-1,1,0,-1,-5,17,-6,-2,8,-3,0,0,-1,-1,1,-1,2,-1
KR_6732340562,420,-1,-40,47,-1,2,1,3,4,1,5,0,0,0,-2,4,2,-5,5,0,0,-6,7,1,-3,2,-4,0,0,1,-1,-1,-1,4,-1
KR_6761398210,420,-2,-18,-30,-1,5,1,6,-5,6,1,-1,3,2,0,0,0,0,0,0,0,-6,-3,-2,-2,4,0,0,0,-1,1,1,1,2,-1
KR_6761325689,420,-2,-114,25,-1,-1,4,3,-1,2,1,-1,3,2,1,2,3,1,2,3,-1,-8,-1,6,-10,4,-10,0,1,-1,-1,1,-1,3,-1
KR_6723553168,420,-2,38,-5,-7,-5,5,0,0,0,0,0,2,2,-2,8,6,0,0,0,0,-6,-4,1,-6,5,1,0,-2,1,-1,-1,-1,5,-1
KR_6606557198,420,1,-2,-16,-2,0,3,3,-2,5,3,-4,4,0,2,1,3,2,1,3,0,-2,219,-3,-4,7,-1,0,0,1,1,0,-1,1,-1
KR_6748471776,420,1,-7,4,5,3,2,5,1,1,2,2,2,4,-1,3,2,0,1,1,-1,3,1,-1,-3,4,1,0,0,-1,1,1,-1,2,-1
KR_6691909628,440,-1,0,-8,-2,-1,1,0,2,1,3,1,3,4,-3,4,1,-1,1,0,0,-5,8,1,-4,3,0,0,1,-1,1,1,-1,1,-1
KR_6759658150,420,-5,-91,-16,-15,-6,6,0,-2,3,1,-1,3,2,-3,4,1,-3,4,1,-1,-20,-11,-8,0,8,0,0,-3,-1,0,-1,1,2,-1
KR_6762282921,440,4,-48,46,2,-1,2,1,2,0,2,5,1,6,-5,5,0,1,1,2,-1,2,38,-2,-3,5,-3,0,0,0,0,0,-1,0,-1
KR_6756907560,420,1,3,-16,6,6,2,8,0,2,2,-4,5,1,3,1,4,1,1,2,0,1,-1,-6,-2,8,-6,0,1,-1,1,1,-1,4,-1
KR_6735555038,440,-1,33,16,-11,-2,2,0,-1,2,1,1,3,4,-5,5,0,-4,4,0,0,-16,11,-4,0,4,0,0,0,1,-1,-1,-1,5,-1
KR_6762159231,420,6,76,28,14,2,0,2,3,0,3,-1,1,0,8,0,8,2,0,2,0,10,9,2,-5,3,5,0,1,-1,-1,1,1,4,-1
KR_6761491952,440,0,1,4,-1,0,2,2,7,0,7,-9,9,0,2,3,5,-1,2,1,0,1,15,3,-6,3,1,0,-1,1,1,-1,-1,6,-1
KR_6653193549,420,-2,-39,0,-3,1,1,2,0,1,1,2,1,3,-5,5,0,-1,1,0,0,-8,166,0,-4,4,-4,0,0,1,0,1,-1,6,-1
KR_6688573821,420,0,-4,17,1,0,4,4,2,1,3,0,1,1,-1,5,4,0,0,0,0,-6,-14,0,-5,5,-1,0,0,1,0,0,1,1,-1
KR_6732989789,420,6,5,26,14,3,2,5,2,3,5,5,1,6,3,2,5,1,0,1,0,12,15,0,-4,4,-11,0,-1,1,1,-1,1,4,-1
KR_6748290539,420,0,-16,-16,-4,2,2,4,2,0,2,-2,2,0,-3,4,1,-3,3,0,0,-2,43,-3,-1,4,-25,0,-1,-1,-1,-1,1,3,-1
KR_6529250073,420,-1,-15,-7,-6,4,3,7,-3,4,1,-2,5,3,-5,7,2,0,1,1,0,-10,-4,-2,-5,7,-3,0,-2,-1,-1,-1,-1,3,-1
KR_6653724159,420,-5,-100,-10,-10,-4,4,0,1,2,3,2,2,4,-7,9,2,-2,2,0,0,-5,-4,-1,-1,2,-5,0,-1,-1,1,-1,1,4,-1
KR_6648423472,420,0,-46,-20,6,-3,3,0,5,1,6,-2,5,3,6,2,8,0,1,1,0,18,53,-2,-4,6,-2,0,-1,1,-1,-1,1,5,-1
KR_6761252357,440,-1,-14,-28,1,-2,2,0,-1,5,4,3,0,3,0,1,1,1,0,1,0,-1,0,1,-5,4,1,0,0,1,-1,0,1,2,-1
KR_6760451069,440,5,-17,8,2,3,0,3,-1,2,1,1,0,1,-2,2,0,1,1,2,0,-1,-2,4,-7,3,2,0,0,-1,1,0,-1,2,-1
KR_6739525043,420,-1,15,-28,-4,1,1,2,-2,4,2,0,1,1,-3,5,2,0,1,1,0,-8,3,1,-6,5,-1,0,0,-1,1,1,1,6,-1
KR_6765837417,420,-4,-11,20,-10,-1,2,1,-6,8,2,1,3,4,-1,2,1,-3,3,0,0,-7,4,3,-7,4,-3,0,-2,-1,1,-1,1,4,-1
KR_6763316319,440,-2,12,19,-6,-1,1,0,-1,1,0,-4,5,1,-3,4,1,3,4,7,0,1,15,-4,-3,7,-1,0,0,0,0,0,-1,0,-1
KR_6761212583,420,-5,-68,-27,-16,0,1,1,-5,6,1,0,5,5,-11,11,0,0,1,1,0,-24,-42,-2,-4,6,25,0,-2,1,1,-1,1,4,-1
KR_6728203072,420,4,-3,48,1,-2,2,0,0,3,3,2,4,6,3,2,5,-2,3,1,0,-1,11,1,-4,3,0,0,-1,0,0,-1,1,0,-1
KR_6682982268,420,-3,-64,-1,-7,-2,2,0,0,2,2,-9,9,0,3,1,4,1,0,1,-1,-3,1,0,-6,6,1,0,0,1,-1,0,-1,6,-1
KR_6747785616,420,0,-10,13,-1,-6,7,1,0,1,1,1,3,4,5,1,6,-1,1,0,0,4,2,-1,-4,5,3,0,0,1,-1,-1,-1,2,-1
KR_6760744063,440,1,-5,8,5,9,1,10,-2,2,0,-1,3,2,-5,8,3,4,1,5,0,2,5,0,-4,4,0,0,1,-1,1,1,-1,4,-1
KR_6745224182,420,-1,-39,21,6,2,1,3,-2,4,2,2,1,3,-2,2,0,6,0,6,1,9,-42,-6,-4,10,19,0,-1,1,-1,-1,1,3,-1
KR_6743722391,420,-4,24,-44,-7,0,1,1,-5,5,0,-2,2,0,-1,1,0,1,1,2,0,-5,-3,0,-5,5,-1,0,1,0,-1,1,1,0,-1
KR_6624419794,420,-2,-118,-20,-2,1,2,3,1,0,1,-1,2,1,-1,3,2,-2,2,0,0,-2,-11,-5,-2,7,1,0,-2,-1,-1,-1,1,6,-1
KR_6762486630,420,-1,-33,4,1,1,0,1,1,2,3,1,2,3,1,3,4,-3,5,2,0,5,79,0,-4,4,-5,0,0,1,-1,0,-1,3,-1
KR_6663811536,420,-1,-22,-4,-6,-3,3,0,-2,6,4,-1,2,1,0,5,5,0,3,3,0,-5,1,3,-6,3,-1,0,0,1,-1,-1,-1,5,-1
KR_6722382400,420,-4,-36,-23,-9,2,0,2,-4,8,4,-8,8,0,1,2,3,0,3,3,0,-3,169,-1,-3,4,-2,0,0,1,1,-1,1,5,-1
KR_6750677593,420,-3,-38,-20,-5,-1,5,4,2,1,3,-1,3,2,-4,6,2,-1,3,2,0,-2,-14,-2,-5,7,0,0,-1,-1,1,-1,1,6,-1
KR_6752950276,420,-1,21,-28,-4,-2,3,1,0,1,1,0,0,0,-1,1,0,-1,1,0,0,-4,52,3,-5,2,-15,0,0,1,1,0,-1,1,-1
KR_6581608390,420,-4,-107,-4,-3,-2,6,4,1,1,2,0,4,4,0,2,2,-2,2,0,1,-1,3,3,-4,1,-4,0,-2,1,1,-1,1,3,-1
KR_6654205044,420,-1,-38,-6,0,-1,3,2,1,1,2,1,2,3,0,1,1,-1,1,0,0,1,3,-2,-5,7,-2,0,0,-1,1,0,-1,6,-1
KR_6738123287,420,0,13,-28,-3,0,2,2,0,4,4,-3,4,1,-1,4,3,1,2,3,0,3,-2,4,-6,2,0,0,0,0,-1,-1,-1,0,-1
KR_6756579114,420,-5,-62,-36,-1,2,2,4,-1,2,1,1,2,3,-3,4,1,0,0,0,0,4,3,4,-5,1,-3,0,1,-1,1,1,-1,2,-1
KR_6751356305,420,-4,-38,-20,-6,-4,5,1,2,4,6,4,3,7,-5,7,2,-3,4,1,0,-13,46,-4,-1,5,-11,0,0,-1,0,-1,-1,3,-1
KR_6683048046,420,-3,-37,5,-12,-3,3,0,-4,4,0,-2,5,3,1,5,6,-4,6,2,-1,-19,3,0,-7,7,-3,0,0,0,-1,0,-1,0,-1
KR_6615680254,420,-7,-42,-28,-13,-2,3,1,-5,5,0,-3,4,1,1,3,4,-4,6,2,-2,-8,3,1,-4,3,-2,0,-3,1,-1,-1,-1,6,-1
KR_6762599786,420,-4,-58,4,-3,1,1,2,0,3,3,-1,3,2,-2,2,0,-1,1,0,0,-5,-3,-3,-1,4,-2,0,1,-1,1,-1,-1,6,-1
KR_6759730873,440,-1,68,1,-9,2,0,2,-11,11,0,1,1,2,1,1,2,-2,2,0,0,-15,-3,-3,-3,6,4,0,-3,-1,-1,-1,1,1,-1
KR_6766952233,440,-1,-48,-24,-1,0,5,5,-6,6,0,0,4,4,4,0,4,1,0,1,-1,-4,1,-2,-2,4,-1,0,0,0,0,0,-1,0,-1
KR_6636435902,420,2,-11,16,4,1,1,2,2,2,4,7,1,8,-8,8,0,2,0,2,-1,4,-13,4,-7,3,4,0,-1,-1,1,-1,-1,1,-1
KR_6753321409,420,3,1,16,2,-5,5,0,1,2,3,4,2,6,2,2,4,0,0,0,0,6,51,1,-4,3,-14,0,0,1,1,1,-1,5,-1
KR_6720528296,420,0,63,-28,0,-1,2,1,-2,2,0,2,4,6,2,5,7,-1,1,0,0,-6,-6,-3,-3,6,2,0,0,1,-1,0,-1,3,-1
KR_6742281164,420,0,-37,24,-3,-3,3,0,0,3,3,-1,4,3,1,4,5,0,1,1,1,-4,12,2,-7,5,-1,0,1,1,-1,1,1,3,-1
KR_6740098053,420,0,-11,11,-2,-2,3,1,-2,2,0,1,2,3,-1,3,2,2,1,3,-4,-10,-217,-1,-4,5,1,0,0,-1,1,1,-1,5,-1
KR_6554542391,420,-1,-13,-13,7,4,0,4,5,1,6,-4,6,2,2,3,5,0,1,1,0,20,-6,-4,-4,8,2,0,0,-1,1,1,1,6,-1
KR_6648818792,420,2,44,12,-5,-2,3,1,4,2,6,-2,4,2,-5,7,2,0,0,0,0,-9,-2,-2,-2,4,-3,0,1,-1,1,1,-1,2,-1
KR_6765125122,420,-2,-76,-20,1,-5,7,2,-2,4,2,2,3,5,4,1,5,2,2,4,0,14,-105,0,-5,5,-3,0,-1,-1,-1,-1,1,3,-1
KR_6763399689,420,0,38,-5,-3,0,3,3,-5,6,1,4,0,4,3,1,4,-5,5,0,-1,-5,-15,0,-3,3,1,0,-1,-1,1,-1,-1,2,-1
KR_6749950047,420,-1,-30,7,6,-1,1,0,-1,3,2,-1,2,1,6,4,10,3,0,3,0,12,-4,0,-4,4,3,0,1,-1,-1,1,1,6,-1
KR_6719380921,420,-1,-102,-17,-2,-2,3,1,1,0,1,-2,2,0,0,2,2,1,1,2,0,2,35,-2,-4,6,-19,0,-1,1,-1,-1,-1,4,-1
KR_6727550122,440,-1,-18,-16,1,1,1,2,-1,4,3,2,2,4,-2,5,3,1,3,4,-2,-3,289,5,-8,3,-1,0,-1,-1,-1,-1,-1,3,-1
KR_6650264563,420,-3,65,-3,-5,-5,6,1,-1,3,2,-1,3,2,-5,6,1,7,0,7,0,-8,-11,-3,-5,8,10,0,0,1,1,0,1,1,-1
KR_6761675645,420,-4,-35,20,-19,-4,4,0,-8,8,0,-2,2,0,-1,2,1,-4,4,0,-1,-21,21,-4,-1,5,-2,0,-1,-1,1,-1,-1,5,-1
KR_6718230060,420,-3,50,16,-10,-2,2,0,0,2,2,-2,4,2,-2,3,1,-4,4,0,0,-5,12,-3,-5,8,1,0,0,1,-1,0,-1,4,-1
KR_6766603145,440,1,-110,4,-3,0,1,1,-4,5,1,0,2,2,1,3,4,0,0,0,0,-2,-4,3,-6,3,0,0,-1,-1,1,-1,1,5,-1
KR_6658389169,420,-1,-11,4,-5,-1,2,1,1,2,3,-1,2,1,-2,2,0,-2,3,1,0,-10,-10,-3,-2,5,6,0,0,-1,1,0,-1,5,-1
KR_6743142480,420,-2,-20,-1,-2,0,2,2,0,4,4,-4,5,1,2,3,5,0,3,3,0,-1,-1,-4,0,4,2,0,-1,-1,1,-1,-1,2,-1
KR_6744822874,420,-1,-8,-18,0,4,1,5,2,1,3,-6,9,3,-1,2,1,1,0,1,0,-1,56,-2,-3,5,20,0,0,1,-1,1,-1,6,-1
KR_6749096001,420,0,36,-15,-10,-4,6,2,-5,5,0,1,2,3,-2,3,1,0,0,0,0,-7,40,-2,-2,4,-2,0,1,-1,1,1,-1,6,-1
KR_6602255871,420,-2,-61,16,-6,-3,3,0,2,2,4,-1,5,4,-2,7,5,-2,6,4,0,-8,7,-2,-6,8,0,0,-1,1,1,-1,1,2,-1
KR_6342697906,420,0,-27,-32,4,1,0,1,-4,5,1,4,0,4,2,3,5,1,1,2,0,6,-5,-1,-6,7,-2,0,0,-1,-1,0,-1,2,-1
KR_6767157717,420,-4,-67,-16,-1,0,1,1,-4,5,1,1,0,1,2,0,2,0,0,0,0,-3,-8,1,-8,7,-1,0,-1,-1,0,-1,1,3,-1
KR_6747093673,420,-3,-84,14,2,-1,4,3,3,1,4,1,0,1,-2,3,1,1,1,2,0,12,154,2,-5,3,-2,0,0,1,-1,1,-1,6,-1
KR_6738830472,440,-3,-54,-29,-3,-2,2,0,-1,2,1,-1,3,2,0,0,0,1,0,1,0,-1,-6,0,-5,5,5,0,-1,-1,-1,-1,-1,4,-1
KR_6754980723,420,1,21,-1,-3,3,3,6,-5,6,1,-1,1,0,0,3,3,0,0,0,0,-4,1,0,-6,6,1,0,0,-1,-1,0,-1,4,-1
KR_6758098967,440,-5,-70,-28,-7,0,3,3,-2,2,0,-3,4,1,1,0,1,-3,3,0,-1,-7,-12,3,-6,3,-6,0,-1,0,0,-1,-1,0,-1
KR_6525865388,420,4,31,36,9,0,2,2,1,1,2,1,1,2,3,3,6,4,0,4,0,14,131,3,-7,4,0,0,1,1,-1,1,-1,2,-1
KR_6767201490,420,-2,20,20,-1,1,1,2,0,2,2,-6,7,1,4,3,7,0,0,0,0,-2,-73,2,-6,4,4,0,0,1,-1,1,1,3,-1
KR_6575167777,420,3,35,6,9,2,0,2,9,2,11,-2,3,1,1,0,1,-1,1,0,0,10,5,2,-6,4,-8,0,2,1,0,1,-1,3,-1
KR_6708133768,420,-6,-91,-28,-15,-3,3,0,-6,9,3,1,3,4,-6,6,0,-1,1,0,0,-14,-166,-4,-3,7,-2,0,-2,-1,-1,-1,1,6,-1
KR_6752448149,420,-5,-155,20,-6,-2,2,0,-2,4,2,5,1,6,-7,7,0,0,0,0,0,-3,-36,0,-8,8,21,0,-3,1,-1,-1,1,2,-1
KR_6707887989,420,1,16,12,0,0,1,1,0,2,2,1,0,1,3,3,6,-4,5,1,0,1,0,-5,-1,6,3,0,2,0,1,1,-1,0,-1
KR_6727462572,420,2,15,-28,6,1,1,2,-2,6,4,3,0,3,2,0,2,2,1,3,0,8,-11,-3,-4,7,3,0,0,-1,1,0,1,4,-1
KR_6762483781,420,2,-46,-7,2,-1,1,0,-1,2,1,0,0,0,4,2,6,0,1,1,0,2,-2,1,-4,3,2,0,0,0,-1,0,1,0,-1
KR_6762406611,420,-1,-60,12,-5,-3,4,1,-3,5,2,3,0,3,-3,4,1,1,0,1,1,-6,-5,1,-4,3,-2,0,0,-1,0,0,1,5,-1
KR_6756782387,420,-3,-42,6,-15,-2,3,1,-3,4,1,-5,5,0,-5,5,0,0,1,1,0,-23,40,2,-5,3,-16,0,0,-1,1,1,-1,3,-1
KR_6534625526,420,-2,-7,1,-5,0,0,0,1,1,2,-1,1,0,-8,9,1,3,0,3,0,-8,-6,-1,-7,8,-7,0,0,-1,-1,0,-1,4,-1
KR_6767937914,420,-5,-122,-26,-9,-8,8,0,1,1,2,2,0,2,-4,5,1,0,2,2,0,7,-10,-1,-2,3,-1,0,-2,0,1,-1,-1,0,-1
KR_6665715269,420,2,-8,27,-2,-1,2,1,-4,8,4,2,1,3,0,5,5,1,0,1,1,-9,-19,1,-7,6,-2,0,0,1,-1,1,1,1,-1
KR_6750942444,420,0,23,-6,1,-1,1,0,-5,5,0,4,3,7,1,0,1,2,0,2,0,0,13,-1,-3,4,-3,0,1,-1,-1,1,-1,2,-1
KR_6759389094,420,-2,-44,2,-6,-7,7,0,3,0,3,-6,7,1,2,1,3,2,1,3,0,0,-2,-3,-3,6,2,0,0,-1,0,0,-1,4,-1
KR_6755417405,420,-2,-44,20,-4,-2,2,0,0,1,1,-2,4,2,0,0,0,0,1,1,0,0,-14,-6,-1,7,4,0,-1,-1,1,-1,1,1,-1
KR_6621087897,420,-2,9,-32,-6,0,2,2,-1,2,1,-2,5,3,-3,4,1,0,0,0,0,-4,165,2,-3,1,-2,0,-1,1,1,-1,1,6,-1
KR_6743596135,420,1,45,-8,2,-4,6,2,0,3,3,3,1,4,1,3,4,2,0,2,0,-3,-122,-1,-4,5,0,0,0,1,-1,-1,-1,2,-1
KR_6757073315,420,-2,-106,24,-10,-1,1,0,2,2,4,-7,7,0,-2,3,1,-2,4,2,-1,-9,10,0,-2,2,0,0,-1,-1,-1,-1,-1,3,-1
KR_6751316395,440,-4,-32,-8,-12,-3,3,0,-6,8,2,-2,2,0,-4,4,0,3,0,3,0,-9,-2,-2,-1,3,2,0,0,-1,1,0,1,4,-1
KR_6745458900,420,0,-32,-20,2,-3,3,0,-2,3,1,8,5,13,-2,5,3,1,2,3,1,8,-3,2,-7,5,-1,0,-2,0,-1,-1,1,0,-1
KR_6757743515,420,-3,-40,-17,-11,-8,8,0,-4,6,2,-2,4,2,2,2,4,1,0,1,-1,-12,10,8,-11,3,0,0,-3,-1,1,1,-1,5,-1
KR_6676225304,420,0,10,-24,12,-3,3,0,2,2,4,-1,2,1,14,2,16,0,1,1,4,25,11,8,-9,1,-8,0,1,1,-1,1,1,4,-1
KR_6741612048,420,-5,20,-40,-5,-1,3,2,-2,4,2,-1,1,0,0,2,2,-1,2,1,0,-2,-10,2,-7,5,0,0,0,-1,-1,0,-1,1,-1
KR_6742757255,420,0,24,-4,-2,-1,3,2,1,2,3,-1,3,2,-1,6,5,0,2,2,0,-10,-14,0,-4,4,-2,0,0,1,1,1,1,3,-1
KR_6653836123,420,-3,-37,-10,-4,-6,7,1,-5,5,0,5,2,7,2,0,2,0,1,1,0,-3,-167,3,-5,2,-3,0,0,1,-1,-1,1,5,-1
KR_6661390513,420,0,-10,20,-8,1,3,4,-3,4,1,0,1,1,-5,5,0,-1,1,0,-1,-8,2,-3,-3,6,2,0,0,-1,1,1,-1,6,-1
KR_6745404826,420,-3,4,8,-2,1,0,1,-1,4,3,-2,3,1,0,1,1,0,2,2,0,-5,-16,3,-8,5,0,0,0,0,0,0,1,0,-1
KR_6634701396,420,-3,-58,8,-5,-1,2,1,2,2,4,-3,7,4,-5,5,0,2,1,3,0,3,-1,-3,-4,7,5,0,-1,-1,1,-1,-1,3,-1
KR_6630458036,420,6,65,31,7,1,1,2,-2,6,4,4,2,6,1,2,3,3,1,4,0,3,-19,3,-5,2,3,0,0,1,-1,-1,-1,1,-1
KR_6626215047,420,-2,-56,13,-5,-2,4,2,1,0,1,0,2,2,-3,5,2,-1,1,0,0,1,5,-5,-2,7,-2,0,-1,-1,1,-1,1,4,-1
KR_6740292237,420,-3,2,-8,2,2,2,4,1,3,4,3,3,6,-2,7,5,-2,2,0,3,14,-21,-3,-4,7,0,0,-1,1,1,-1,1,6,-1
KR_6739173751,420,-5,-65,2,-13,-4,5,1,0,3,3,-1,4,3,-1,1,0,-7,8,1,-1,-6,10,5,-7,2,-8,0,-3,-1,-1,-1,-1,5,-1
KR_6751212331,420,2,-4,-16,-3,-2,4,2,1,0,1,-1,2,1,-2,3,1,1,1,2,0,-4,-11,-3,-3,6,1,0,-1,-1,-1,-1,-1,6,-1
KR_6766569184,420,-3,-32,-28,-8,3,0,3,-2,4,2,-8,9,1,-1,3,2,0,0,0,0,-7,1,3,-4,1,-1,0,-1,0,-1,-1,1,0,-1
KR_6665419988,420,-4,-64,-55,-4,-6,6,0,1,2,3,4,2,6,-3,4,1,0,0,0,0,6,-19,-5,-3,8,-2,0,0,-1,-1,-1,-1,3,-1
KR_6709647971,420,-3,-20,-16,-8,-2,3,1,-2,2,0,-1,2,1,2,2,4,-5,5,0,-2,-12,5,-1,-1,2,-3,0,-1,-1,-1,1,-1,1,-1
KR_6767831321,420,-2,-32,-32,-1,3,1,4,1,1,2,-1,3,2,-5,6,1,1,0,1,0,-3,14,0,-2,2,3,0,1,-1,1,1,-1,2,-1
KR_5873141691,420,3,53,-4,9,-3,5,2,5,0,5,3,1,4,3,1,4,1,1,2,0,9,3,8,-9,1,0,0,1,1,1,-1,1,2,-1
KR_6646679151,420,-4,-72,-44,-8,-2,3,1,-3,4,1,0,1,1,-4,5,1,1,0,1,0,-10,5,-2,-3,5,-3,0,0,-1,0,0,-1,6,-1
KR_6749969405,420,-4,52,-4,-2,0,0,0,-5,5,0,4,0,4,-2,2,0,1,0,1,0,-5,20,-3,-2,5,0,0,1,-1,1,1,1,1,-1
KR_6725482793,440,1,1,4,-4,3,0,3,-2,2,0,-3,7,4,2,3,5,-4,4,0,0,-8,-18,-4,-4,8,-4,0,1,1,-1,1,1,5,-1
KR_6607983235,420,-4,-84,-39,-10,1,3,4,-6,8,2,0,1,1,-3,3,0,-2,6,4,1,-3,1,-4,-3,7,-5,0,-2,-1,0,-1,1,1,-1
KR_6762694451,420,-3,33,-24,-9,0,2,2,-3,6,3,-1,1,0,-2,2,0,-3,3,0,0,-9,-8,1,-4,3,-1,0,-1,-1,-1,-1,-1,1,-1
KR_6693663773,420,-3,-44,4,-8,-4,4,0,-3,5,2,2,2,4,-2,4,2,-1,1,0,0,-10,-25,-1,-1,2,-2,0,-1,-1,-1,-1,-1,2,-1
KR_6683884283,420,-3,-35,-47,-8,-2,2,0,-1,6,5,-2,3,1,-3,4,1,0,2,2,0,-5,-1,-2,-1,3,-5,0,-3,1,-1,-1,-1,6,-1
KR_6767943739,420,1,57,-22,-3,-1,3,2,0,7,7,-6,7,1,2,2,4,2,0,2,0,-1,-3,4,-7,3,1,0,1,-1,-1,1,-1,2,-1
KR_6745747844,420,-3,-54,-20,-1,-2,2,0,-4,5,1,0,1,1,2,3,5,3,0,3,0,2,-11,-2,-3,5,1,0,-2,1,-1,-1,1,3,-1
KR_6715424079,420,1,10,4,0,4,1,5,-4,8,4,0,0,0,-3,7,4,3,0,3,0,-1,2,-2,-4,6,4,0,1,0,1,1,1,0,-1
KR_6757682741,420,-2,-23,12,-4,-3,3,0,-3,5,2,1,2,3,-1,2,1,2,2,4,0,-3,1,0,-2,2,-2,0,-2,1,1,-1,-1,6,-1
KR_6761931141,420,-1,-30,4,2,3,1,4,0,1,1,2,4,6,-4,8,4,1,0,1,0,3,-7,-2,-1,3,-2,0,-1,1,-1,-1,1,2,-1
KR_6619033287,440,-4,-65,-28,-6,-7,7,0,4,1,5,-1,1,0,-1,2,1,-1,1,0,0,-2,6,1,-4,3,-1,0,-2,1,-1,-1,-1,4,-1
KR_6763415560,420,2,1,32,-3,2,0,2,-1,3,2,0,2,2,-2,2,0,-2,3,1,0,-9,-5,1,-4,3,-1,0,1,-1,1,1,-1,6,-1
KR_6649623265,420,0,17,12,-5,3,0,3,1,2,3,-4,5,1,-3,4,1,-2,3,1,0,-10,44,1,-1,0,-16,0,-1,-1,0,-1,-1,5,-1
KR_6693094276,420,1,-12,11,-1,0,2,2,-3,4,1,1,2,3,2,3,5,-1,2,1,0,-3,22,3,-6,3,-4,0,0,-1,1,0,-1,5,-1
KR_6713402769,420,-2,-15,-40,0,-8,9,1,-1,5,4,4,1,5,4,3,7,1,0,1,4,16,1,4,-5,1,1,0,0,-1,-1,1,1,4,-1
KR_6736292430,420,2,4,0,3,-1,1,0,0,2,2,1,0,1,0,2,2,3,1,4,0,9,3,0,-7,7,-3,0,1,-1,1,1,1,3,-1
KR_6554172392,420,-3,-25,33,-10,0,1,1,-10,12,2,-3,3,0,2,1,3,1,1,2,1,-7,5,-1,-4,5,-2,0,2,1,1,1,1,3,-1
KR_6689274052,420,-2,-42,-2,-7,-8,8,0,6,0,6,-2,2,0,-2,2,0,-1,1,0,0,3,1,1,-6,5,5,0,1,-1,1,1,-1,2,-1
KR_6658271276,420,-1,-54,11,-8,-1,1,0,-4,6,2,1,1,2,-2,5,3,-2,4,2,0,-10,12,-3,-2,5,-2,0,0,1,-1,0,-1,2,-1
KR_6050769158,420,-3,-68,-11,-10,-5,5,0,-4,7,3,-2,2,0,1,1,2,0,3,3,0,-12,28,-1,-6,7,-13,0,-1,-1,-1,-1,-1,4,-1
KR_6757949024,420,-5,-31,15,-10,-5,5,0,-2,3,1,-3,4,1,-1,6,5,1,2,3,0,-3,-5,-1,-5,6,-3,0,1,-1,-1,1,1,1,-1
KR_6762714734,420,-4,-32,-27,-10,2,2,4,-7,7,0,1,2,3,-3,5,2,-3,3,0,0,-12,-1,-1,-4,5,-2,0,-1,-1,1,-1,1,5,-1
KR_6755356046,420,1,0,-6,3,-3,3,0,2,2,4,2,5,7,1,3,4,1,0,1,0,4,-276,0,-3,3,2,0,-2,-1,-1,-1,1,4,-1
KR_6738472096,440,0,12,-16,3,-2,3,1,4,0,4,0,1,1,1,3,4,0,1,1,0,6,4,1,-5,4,3,0,-1,0,-1,-1,1,0,-1
KR_6728160055,420,-2,-40,-19,-7,0,3,3,-1,3,2,-1,4,3,-5,6,1,0,1,1,0,-8,0,-2,-5,7,-1,0,-1,-1,0,-1,-1,3,-1
KR_6751180316,420,-1,-95,13,-3,1,1,2,-1,2,1,-3,3,0,4,2,6,-4,5,1,4,-2,-4,0,-4,4,-4,0,0,-1,0,0,1,1,-1
KR_6747254545,420,1,4,-20,1,2,1,3,1,1,2,1,1,2,-3,3,0,0,0,0,0,-3,2,2,-5,3,-2,0,0,0,1,0,1,0,-1
KR_6752510265,420,-1,21,3,-3,0,0,0,-2,4,2,-2,3,1,1,4,5,0,1,1,0,2,-49,3,-8,5,26,0,0,1,0,-1,-1,1,-1
KR_6764876069,440,3,64,2,6,0,1,1,2,2,4,1,3,4,4,1,5,-1,2,1,0,7,10,2,-5,3,2,0,1,-1,1,-1,1,2,-1
KR_6581853130,420,-2,8,-23,-5,-2,3,1,-3,5,2,2,1,3,-1,2,1,-1,1,0,-1,-5,8,-2,-4,6,4,0,-1,-1,1,-1,-1,4,-1
KR_6763233200,420,-1,-20,7,-6,1,0,1,-7,7,0,3,6,9,-1,1,0,-2,2,0,0,-14,7,-2,-5,7,3,0,0,-1,0,0,1,4,-1
KR_6734316386,420,-4,-69,-18,-14,-3,3,0,-3,8,5,-4,5,1,-6,6,0,2,2,4,0,-10,-23,-5,-4,9,3,0,-3,-1,-1,-1,-1,1,-1
KR_6641502324,420,-4,-101,2,-12,3,1,4,-5,7,2,-1,2,1,-8,8,0,-1,1,0,-1,-16,-12,-4,-4,8,-1,0,-1,-1,1,-1,-1,3,-1
KR_6761680181,440,-3,-57,4,-4,0,2,2,1,1,2,-4,5,1,-1,1,0,0,2,2,0,-5,-12,-2,-2,4,0,0,0,0,0,-1,-1,0,-1
KR_6762284909,420,0,-21,-1,-3,-1,3,2,1,3,4,-2,6,4,0,2,2,-1,1,0,0,-11,-11,-2,-3,5,-3,0,0,1,1,0,-1,2,-1
KR_6763348829,420,-4,-38,-27,-6,-3,5,2,-4,8,4,-1,1,0,2,1,3,0,0,0,0,7,1,-1,-2,3,-1,0,-2,1,-1,-1,-1,1,-1
KR_6660265448,420,-2,-29,-27,-5,-2,3,1,1,2,3,0,0,0,-1,2,1,-3,3,0,0,-3,-2,3,-8,5,1,0,-1,-1,-1,-1,1,3,-1
KR_6747104990,420,-1,-43,0,0,1,1,2,-4,5,1,4,1,5,-1,2,1,0,0,0,0,-1,-8,0,-4,4,6,0,-1,-1,1,-1,1,2,-1
KR_6604375973,420,-3,-19,0,-3,1,0,1,-1,4,3,-1,1,0,2,2,4,-4,5,1,0,-4,-17,5,-9,4,-3,0,-1,1,1,-1,-1,5,-1
KR_6706719224,420,0,-7,4,7,1,2,3,-2,5,3,3,3,6,4,3,7,1,0,1,1,16,-19,-1,-3,4,2,0,0,1,1,1,1,2,-1
KR_6722227172,420,-3,-31,-13,-9,1,1,2,-3,4,1,-2,5,3,-2,3,1,-3,3,0,0,-8,-1,5,-9,4,-3,0,-2,-1,-1,-1,1,2,-1
KR_6739548190,420,-5,-74,12,-18,-8,8,0,-5,7,2,0,3,3,-5,5,0,0,0,0,0,-12,2,0,-3,3,-3,0,-2,1,-1,-1,-1,3,-1
KR_6624622781,420,-1,-28,32,1,1,1,2,3,4,7,-3,6,3,0,5,5,0,1,1,2,0,6,-6,-1,7,0,0,2,-1,0,1,1,1,-1
KR_6765939518,420,-6,-124,5,-12,-10,11,1,-5,7,2,1,4,5,0,2,2,2,1,3,0,-4,-23,1,-2,1,0,0,-2,-1,-1,-1,1,2,-1
KR_6767882674,420,-1,9,8,-9,3,1,4,0,2,2,-1,3,2,-7,9,2,-4,5,1,-2,-10,-2,-3,-4,7,-1,0,0,-1,-1,-1,-1,6,-1
KR_6756768223,420,-2,12,-23,-5,1,1,2,-8,8,0,-1,1,0,2,2,4,1,1,2,0,-5,0,4,-6,2,-26,0,0,-1,1,1,-1,5,-1
KR_6630620002,420,-5,-81,-13,-3,-3,3,0,1,3,4,-4,4,0,4,2,6,-1,1,0,0,2,-5,2,-5,3,-2,0,-2,0,-1,-1,-1,0,-1
KR_6722068868,420,-5,27,-16,-7,-12,13,1,0,3,3,1,2,3,6,1,7,-2,3,1,-1,1,3,0,-5,5,2,0,0,1,1,1,-1,6,-1
KR_6748865211,420,1,9,-25,-2,-1,2,1,2,1,3,-4,6,2,1,0,1,0,0,0,0,4,-1,0,-3,3,-2,0,0,-1,-1,0,-1,3,-1
KR_6722738104,420,-4,-10,-30,-10,-1,4,3,-8,8,0,-3,5,2,3,3,6,-1,3,2,0,-2,10,6,-8,2,-8,0,1,1,-1,-1,-1,3,-1
KR_6733658340,420,-6,-139,-32,-11,-1,2,1,-2,5,3,-5,6,1,-4,4,0,1,0,1,0,-9,-5,1,-5,4,-1,0,-3,-1,-1,-1,-1,1,-1
KR_6728445921,420,-5,-51,-4,-7,1,0,1,-8,10,2,0,2,2,1,0,1,-1,2,1,0,-14,-10,3,-8,5,0,0,-1,-1,-1,-1,-1,5,-1
KR_6595401519,420,2,13,-10,3,4,0,4,-4,7,3,1,3,4,0,5,5,2,0,2,0,-1,-4,-3,-4,7,2,0,1,0,-1,1,1,0,-1
KR_6764791091,420,-3,11,12,-14,-3,4,1,-5,5,0,-5,8,3,-1,3,2,0,2,2,-1,-18,10,-2,0,2,-2,0,0,-1,-1,-1,-1,6,-1
KR_6705228115,420,-3,6,-4,-9,-2,3,1,-2,4,2,-3,6,3,0,0,0,-2,3,1,0,-8,2,-1,-4,5,-4,0,0,-1,1,0,1,2,-1
KR_6767502135,420,-5,-49,-35,-6,0,2,2,-1,2,1,4,1,5,-7,7,0,-2,3,1,0,-9,-16,-2,-1,3,-3,0,-1,1,-1,-1,-1,1,-1
KR_6722020008,420,1,25,-12,-1,3,2,5,-2,3,1,1,4,5,-2,4,2,-1,4,3,-3,-17,2,-4,-4,8,3,0,0,1,-1,0,-1,1,-1
KR_6711526844,420,1,31,-47,6,1,2,3,2,3,5,2,2,4,1,2,3,0,0,0,0,8,34,-5,-2,7,-23,0,-2,-1,-1,-1,-1,2,-1
KR_6569637614,420,-3,-10,-8,0,-1,1,0,-4,5,1,3,1,4,4,5,9,-2,3,1,1,1,8,1,-4,3,0,0,1,1,-1,1,1,6,-1
KR_6722559912,420,0,2,8,3,1,2,3,0,4,4,1,1,2,1,0,1,0,0,0,2,4,14,3,-7,4,-1,0,1,-1,1,-1,1,1,-1
KR_6760898144,420,-3,-5,-30,-6,-1,1,0,-1,2,1,-3,4,1,1,5,6,-2,2,0,0,-4,-6,-3,-3,6,-5,0,0,1,-1,1,-1,3,-1
KR_6680470598,420,0,12,-3,1,5,0,5,-2,4,2,-1,2,1,1,0,1,-2,2,0,0,-6,-12,-2,0,2,3,0,0,-1,-1,0,-1,6,-1
KR_6428623687,420,2,28,5,4,0,3,3,4,3,7,-4,6,2,2,1,3,2,2,4,0,5,3,-2,-2,4,0,0,0,0,1,0,1,0,-1
KR_6761252167,420,0,-5,3,-4,0,1,1,-6,7,1,0,1,1,3,3,6,-1,2,1,0,-8,2,2,-5,3,1,0,-1,1,-1,-1,1,6,-1
KR_6751769245,420,1,13,-36,-5,0,1,1,-1,1,0,-1,3,2,-1,4,3,-2,2,0,0,-8,-97,1,-6,5,2,0,-1,-1,1,-1,-1,6,-1
KR_6739148842,420,-7,-94,-38,-9,-3,3,0,-2,3,1,-3,6,3,0,1,1,-1,3,2,0,-4,0,-1,-2,3,-3,0,-1,-1,1,-1,1,3,-1
KR_6758735524,420,2,-27,3,3,-1,2,1,-1,2,1,3,3,6,1,2,3,1,0,1,1,5,-23,-5,0,5,21,0,1,-1,1,1,1,5,-1
KR_6763347896,440,-2,0,-24,-6,1,3,4,-3,3,0,-5,5,0,2,1,3,-1,1,0,0,-8,-1,4,-5,1,-3,0,0,-1,-1,-1,-1,2,-1
KR_6697479536,420,-5,-48,11,-5,-5,6,1,2,2,4,0,3,3,-1,3,2,-1,4,3,-1,-1,-102,-5,-3,8,-2,0,0,1,0,0,-1,3,-1
KR_6676648680,420,-2,28,-51,-12,4,0,4,-8,9,1,-3,4,1,-3,3,0,-2,2,0,-3,-19,1,-2,-2,4,-2,0,0,-1,0,0,-1,3,-1
KR_6738437849,420,-3,-56,0,-10,-4,5,1,-6,6,0,2,2,4,-1,3,2,-1,3,2,0,-8,-231,-6,-1,7,-4,0,0,1,-1,-1,-1,2,-1
KR_6763057373,420,-1,14,-17,-8,0,2,2,-2,4,2,0,2,2,-6,6,0,0,1,1,0,-5,-8,-1,-2,3,2,0,0,1,-1,-1,-1,2,-1
KR_6686012405,420,-1,-3,-27,1,3,2,5,-2,5,3,1,2,3,-2,2,0,1,0,1,0,-1,18,-3,-5,8,1,0,1,-1,0,1,1,2,-1
KR_6664559625,420,1,52,8,1,-5,6,1,1,2,3,2,2,4,0,4,4,3,0,3,0,-2,-19,1,-6,5,6,0,2,1,1,1,1,1,-1
KR_6761980698,420,-3,19,1,-2,4,0,4,0,3,3,-8,10,2,1,0,1,1,0,1,1,1,4,0,-7,7,1,0,1,1,0,1,1,6,-1
KR_6757961978,420,-4,-38,-13,4,-2,2,0,1,3,4,1,2,3,6,1,7,-2,3,1,0,6,-3,1,-5,4,1,0,0,-1,0,0,1,4,-1
KR_6607661916,420,-2,-59,2,-2,-1,2,1,1,3,4,-1,3,2,-1,3,2,0,0,0,0,-2,7,-3,-2,5,1,0,0,1,1,-1,1,4,-1
KR_6759024491,420,-1,-80,39,2,-8,9,1,1,2,3,1,1,2,6,1,7,2,1,3,0,11,-59,0,-5,5,12,0,-1,1,0,-1,-1,3,-1
KR_6687189955,420,0,-10,2,-1,2,1,3,1,3,4,-1,2,1,-2,3,1,-1,2,1,0,2,91,2,-4,2,0,0,1,-1,1,1,-1,5,-1
KR_6751176532,420,2,-3,0,-1,0,3,3,-5,6,1,-1,5,4,6,2,8,-1,3,2,0,3,-35,0,-3,3,4,0,-1,-1,-1,-1,-1,6,-1
KR_6741960041,440,-2,-100,6,-1,1,0,1,-2,2,0,-1,3,2,2,1,3,-1,1,0,0,-4,-63,1,-3,2,29,0,-1,1,-1,-1,1,6,-1
KR_6671691925,440,-1,-28,28,-10,-4,5,1,0,2,2,3,2,5,-7,7,0,-2,2,0,0,-16,-115,-4,-2,6,-3,0,-1,0,-1,-1,1,0,-1
KR_6754809435,420,-1,-73,9,-3,-3,5,2,-3,6,3,2,0,2,1,4,5,0,0,0,0,2,-10,-2,-2,4,2,0,-1,-1,-1,-1,-1,3,-1
KR_6759332877,420,-1,47,24,-6,1,1,2,-3,5,2,-7,10,3,3,2,5,0,3,3,0,-10,3,3,-6,3,1,0,0,0,-1,1,1,0,-1
KR_6752475720,420,-1,16,-4,-2,0,0,0,-5,5,0,4,0,4,0,2,2,-1,1,0,0,-1,25,3,-6,3,3,0,0,1,1,0,-1,6,-1
KR_6741964575,420,-5,-23,-27,-6,0,0,0,-5,6,1,-1,3,2,0,5,5,0,2,2,0,0,161,4,-8,4,-2,0,-2,-1,-1,-1,-1,1,-1
KR_6671246468,420,-5,-24,-32,-7,-1,1,0,-2,2,0,-8,8,0,3,1,4,1,1,2,0,-1,2,-1,-6,7,-2,0,-2,-1,-1,-1,-1,2,-1
KR_6757421362,420,-2,-22,3,-4,3,1,4,-3,3,0,-3,4,1,-1,2,1,0,0,0,0,-6,-4,-3,-2,5,1,0,-1,-1,1,-1,1,2,-1
KR_6494975761,420,-2,-38,-16,-4,3,1,4,0,3,3,-1,2,1,-6,6,0,0,1,1,0,-10,34,5,-6,1,-6,0,0,-1,-1,-1,-1,5,-1
KR_6757125985,420,-1,-16,-8,2,-1,1,0,0,1,1,-3,4,1,2,4,6,4,0,4,0,3,-4,-4,-2,6,5,0,-1,-1,-1,-1,1,3,-1
KR_6448051628,420,-1,14,-21,1,6,2,8,1,2,3,-4,7,3,-1,1,0,-1,1,0,0,3,6,0,-6,6,3,0,1,-1,1,1,-1,1,-1
KR_6760851930,420,-3,16,13,-10,0,1,1,-7,7,0,1,3,4,-2,6,4,-2,2,0,1,-24,-7,0,-2,2,0,0,0,-1,0,0,1,3,-1
KR_6731560232,420,-1,40,-20,-4,1,2,3,-1,3,2,0,1,1,0,1,1,-4,4,0,0,-6,-1,-1,-4,5,0,0,1,-1,1,1,-1,2,-1
KR_6617133926,420,-1,-44,-7,-3,-2,4,2,-1,3,2,-3,5,2,2,3,5,1,1,2,0,6,-195,6,-8,2,-1,0,0,1,1,-1,1,1,-1
KR_6393781090,440,-4,-150,3,-11,-9,9,0,-4,6,2,-1,1,0,0,0,0,3,2,5,0,-14,-2,-1,-7,8,-3,0,0,0,1,-1,-1,0,-1
KR_6638358931,420,3,73,13,0,0,2,2,-2,2,0,-2,2,0,6,2,8,-2,3,1,1,-3,5,0,-4,4,2,0,0,1,1,1,1,3,-1
KR_6723024845,420,0,-60,-4,-4,1,0,1,0,2,2,-4,6,2,-2,3,1,1,1,2,0,1,41,-1,-3,4,-3,0,0,-1,-1,0,-1,2,-1
KR_6736392293,420,-6,-108,-21,-11,-3,4,1,-1,5,4,-1,1,0,-8,8,0,2,1,3,0,-13,-56,-2,-2,4,14,0,-3,-1,-1,-1,-1,4,-1
KR_6719839700,420,-2,-2,-20,-3,1,1,2,-1,2,1,-3,3,0,-1,2,1,1,0,1,0,-4,44,-1,-4,5,-38,0,0,-1,-1,-1,1,2,-1
KR_6763111844,420,1,-11,-4,8,-1,1,0,0,3,3,1,1,2,6,0,6,2,0,2,0,12,0,-2,-3,5,-2,0,-1,1,-1,-1,1,3,-1
KR_6759694408,440,2,31,-6,4,2,2,4,2,0,2,0,4,4,-1,7,6,1,0,1,0,6,4,1,-3,2,2,0,0,1,0,1,1,2,-1
KR_6722874966,420,-6,-103,-36,-22,-1,2,1,-4,5,1,-12,12,0,-3,4,1,-2,2,0,0,-20,-142,-4,-1,5,-6,0,-1,-1,-1,-1,-1,4,-1
KR_6761856420,420,1,-5,15,-1,-1,2,1,-1,2,1,2,2,4,0,1,1,-1,1,0,0,0,5,1,-4,3,-2,0,0,0,-1,0,-1,0,-1
KR_6740095791,440,-1,-48,-9,-7,-2,3,1,0,1,1,-4,4,0,-3,3,0,2,1,3,0,-7,-3,5,-8,3,-1,0,-1,1,-1,-1,-1,4,-1
KR_6695002983,420,-5,-132,0,-10,-4,4,0,0,4,4,-3,3,0,-2,2,0,-1,1,0,-1,0,-4,-2,-1,3,-2,0,-1,-1,-1,-1,-1,5,-1
KR_6743501846,420,-3,-62,-17,-1,0,2,2,-3,3,0,3,0,3,5,1,6,-6,6,0,-1,-5,1,3,-5,2,-2,0,-1,1,-1,-1,-1,6,-1
KR_6612036382,420,-5,-148,-18,-20,-7,7,0,2,2,4,-10,11,1,-2,6,4,-3,3,0,-2,-12,-7,-3,-3,6,4,0,-3,-1,1,-1,-1,2,-1
KR_6766696955,420,-2,8,-21,-7,-3,3,0,-3,6,3,-1,1,0,0,3,3,0,0,0,-1,-12,-18,3,-5,2,-1,0,0,-1,1,1,-1,1,-1
KR_6730967581,440,-4,-63,-31,-4,0,2,2,2,1,3,-2,2,0,-5,6,1,1,1,2,0,0,-11,-1,-1,2,-2,0,-1,-1,-1,-1,-1,5,-1
KR_6755640804,420,-4,-37,1,-12,1,1,2,1,2,3,-5,5,0,-7,7,0,-2,2,0,0,-13,23,1,-6,5,-4,0,-2,-1,-1,-1,-1,4,-1
KR_6759749767,420,-1,13,-24,-2,2,1,3,-5,7,2,1,1,2,0,1,1,0,0,0,0,-6,-9,-1,-3,4,3,0,-1,-1,1,-1,1,3,-1
KR_6764687027,420,-2,-34,-6,-1,-2,4,2,4,2,6,-3,6,3,0,3,3,0,1,1,-2,-7,204,0,-7,7,-3,0,0,-1,1,1,-1,3,-1
KR_6748449174,420,2,36,16,1,2,0,2,1,0,1,-8,9,1,3,1,4,3,0,3,0,-1,117,1,-5,4,24,0,1,-1,-1,1,-1,5,-1
KR_6762603057,420,-1,-1,-4,-4,-1,1,0,-5,7,2,2,0,2,2,2,4,-2,3,1,0,2,2,-2,-2,4,0,0,0,1,-1,-1,1,4,-1
KR_6761710050,420,-4,-133,-1,-3,-2,3,1,-1,6,5,3,0,3,-3,7,4,0,1,1,0,0,-59,1,-4,3,21,0,-2,0,-1,-1,1,0,-1
KR_6733727998,420,-2,16,20,-7,1,1,2,-4,4,0,-2,3,1,-4,6,2,2,0,2,-1,-14,-2,1,-5,4,0,0,-1,-1,-1,-1,-1,2,-1
KR_6608393563,420,2,36,36,-1,2,1,3,0,3,3,5,2,7,-5,6,1,-3,4,1,0,3,-280,-4,-1,5,0,0,0,-1,1,-1,1,4,-1
KR_6721188293,420,1,-7,16,1,0,1,1,1,3,4,-1,3,2,-1,4,3,2,0,2,0,-10,-7,2,-7,5,1,0,0,1,1,1,-1,6,-1
KR_6621009167,420,-3,-63,-34,-4,-4,5,1,-3,4,1,0,4,4,-1,4,3,4,0,4,0,4,9,5,-8,3,-1,0,-2,1,1,-1,1,6,-1
KR_6754793599,440,3,76,-4,1,0,3,3,3,0,3,1,0,1,-3,3,0,0,0,0,0,0,-3,4,-5,1,2,0,1,1,1,1,-1,5,-1
KR_6664432048,420,-2,-34,-26,-2,-1,2,1,2,1,3,-3,3,0,3,0,3,-3,3,0,-1,-2,7,1,-4,3,0,0,2,1,1,1,-1,3,-1
KR_6764696230,420,1,-1,28,-3,-1,2,1,1,1,2,0,3,3,-3,5,2,0,2,2,-1,-7,0,-3,-2,5,2,0,0,-1,-1,0,-1,6,-1
KR_6392060090,420,-2,-5,-20,-4,1,1,2,-4,5,1,-1,3,2,-1,4,3,1,0,1,-1,-8,-14,-6,-6,12,5,0,0,-1,1,0,-1,3,-1
KR_6765925346,420,-4,-115,-4,-1,-2,2,0,-1,2,1,0,1,1,3,2,5,-1,1,0,0,2,8,2,-3,1,-3,0,-1,-1,-1,-1,1,1,-1
KR_6751813377,420,-3,-2,-12,-4,-1,2,1,2,2,4,0,2,2,-5,7,2,0,0,0,1,0,-7,-3,-2,5,1,0,-1,-1,-1,-1,1,5,-1
KR_6767302761,420,-1,24,-8,-9,-2,4,2,0,2,2,-6,6,0,-1,3,2,0,2,2,0,-3,14,-2,-4,6,-6,0,-2,-1,-1,-1,-1,4,-1
KR_6658555758,420,1,16,-24,0,-2,3,1,-1,2,1,3,2,5,1,1,2,-1,3,2,0,1,10,3,-6,3,-5,0,0,-1,-1,-1,1,4,-1
KR_6760669471,420,-2,6,-14,-8,3,1,4,-4,7,3,0,3,3,-6,7,1,-1,1,0,-1,-22,-5,0,-2,2,-1,0,-1,-1,-1,-1,-1,6,-1
KR_6726165796,440,-3,36,-16,-9,-4,5,1,-4,4,0,-1,5,4,-1,4,3,1,0,1,0,-8,-16,5,-6,1,-1,0,-1,1,-1,-1,-1,1,-1
KR_6728666121,420,-3,-31,-8,-3,-1,3,2,-4,5,1,3,1,4,-1,4,3,0,0,0,-1,-2,-26,-8,-1,9,0,0,-2,1,-1,-1,-1,6,-1
KR_6728544326,420,-1,-56,7,4,-2,5,3,10,0,10,-4,4,0,0,3,3,0,0,0,0,4,16,2,-7,5,-2,0,-1,0,1,-1,-1,0,-1
KR_6698720547,420,-3,-42,17,-10,0,0,0,-4,4,0,1,2,3,-6,7,1,-1,2,1,0,-12,-60,-7,-1,8,-3,0,-1,-1,1,-1,1,5,-1
KR_6763909785,420,-5,-119,-20,2,1,0,1,0,4,4,5,1,6,-4,4,0,0,0,0,0,-1,-14,-5,-1,6,-2,0,-1,1,1,-1,-1,2,-1
KR_6634704874,420,-2,14,-19,-5,1,0,1,-1,5,4,0,2,2,0,3,3,-5,5,0,0,-8,-10,7,-12,5,-3,0,-1,-1,-1,-1,-1,4,-1
KR_6742481409,440,-1,20,-8,-2,-2,5,3,-6,6,0,3,1,4,3,2,5,0,0,0,0,-4,34,0,-6,6,-11,0,1,0,-1,1,1,0,-1
KR_6758703094,420,-2,-24,8,-7,-4,5,1,0,3,3,-2,3,1,-1,3,2,0,1,1,0,-6,12,-1,-4,5,-1,0,0,-1,-1,1,-1,3,-1
KR_6683995750,420,-1,15,-32,-4,-2,3,1,0,2,2,1,3,4,-2,6,4,-1,1,0,0,-5,0,4,-5,1,-3,0,0,-1,1,0,-1,2,-1
KR_6692944054,420,-4,-43,31,-9,-4,6,2,-2,3,1,1,2,3,-5,6,1,1,2,3,-1,-8,-25,-2,-2,4,8,0,-2,0,-1,-1,-1,0,-1
KR_6683875881,420,-2,-9,4,-4,1,1,2,-3,5,2,2,2,4,4,6,10,-8,8,0,1,-2,-5,-1,-3,4,1,0,-1,-1,0,-1,1,6,-1
KR_6757742104,420,0,95,-4,-3,1,4,5,-4,6,2,-7,7,0,6,1,7,1,1,2,0,-2,-2,2,-5,3,-2,0,1,1,-1,1,-1,3,-1
KR_6660984963,420,-2,-80,7,4,-1,1,0,3,1,4,2,4,6,-3,5,2,3,1,4,2,11,-4,-4,-1,5,2,0,-1,-1,1,1,1,1,-1
KR_6744531227,420,0,-78,-28,-7,-1,3,2,-6,9,3,1,3,4,0,2,2,-1,2,1,0,-6,-20,-1,-2,3,-3,0,0,1,0,0,-1,3,-1
KR_6635358946,440,-1,61,-12,-7,-1,2,1,-4,4,0,0,1,1,1,4,5,-3,5,2,0,-16,-16,1,-7,6,-1,0,0,-1,-1,0,-1,3,-1
KR_6731890263,420,-3,-18,-21,-6,-1,3,2,0,4,4,-3,3,0,-4,6,2,2,0,2,1,-2,-2,-4,-3,7,-2,0,0,-1,-1,1,1,4,-1
KR_6762664805,420,0,-42,8,-5,0,1,1,-3,4,1,-1,5,4,-1,1,0,0,2,2,-1,-4,3,-2,-3,5,-3,0,0,-1,0,0,-1,1,-1
KR_6731364915,440,-1,-16,-3,-6,2,0,2,1,1,2,-5,7,2,-3,3,0,-1,3,2,0,-1,-15,-2,-1,3,-1,0,0,-1,-1,0,-1,4,-1
KR_6653907343,420,-5,-56,-12,-9,-5,5,0,0,1,1,1,4,5,-3,4,1,-2,3,1,0,-4,-1,1,-8,7,-3,0,-2,-1,-1,-1,-1,5,-1
KR_6735503536,420,0,29,48,-5,2,2,4,-1,2,1,0,3,3,-5,5,0,-1,2,1,-1,-16,2,-6,-4,10,1,0,1,-1,1,-1,-1,3,-1
KR_6749467782,420,0,-63,23,-3,0,2,2,-2,2,0,-6,8,2,5,1,6,0,0,0,0,-5,8,-2,-5,7,1,0,-3,-1,0,-1,-1,6,-1
KR_6765595538,420,-2,-71,-11,-3,3,0,3,-4,6,2,-3,4,1,2,1,3,-1,2,1,0,2,-1,3,-6,3,-3,0,-1,1,-1,-1,-1,4,-1
KR_6762717324,420,-6,-46,-14,-19,-3,3,0,-3,4,1,-7,9,2,-5,6,1,-1,2,1,-4,-19,-12,-1,-2,3,-1,0,-3,-1,-1,-1,-1,6,-1
KR_6698392941,420,-3,-49,-28,3,2,0,2,2,1,3,-1,3,2,0,2,2,0,1,1,0,3,9,-1,-5,6,-2,0,-1,-1,1,-1,-1,3,-1
KR_6714059671,420,-3,-16,-24,-4,-5,5,0,-3,4,1,2,3,5,2,4,6,0,1,1,2,5,8,4,-9,5,-4,0,0,1,0,0,1,1,-1
KR_6705119649,440,-2,-66,36,-2,-1,2,1,-3,4,1,3,2,5,0,2,2,-1,1,0,-1,-2,6,0,-7,7,-5,0,0,1,-1,0,-1,5,-1
KR_6654243035,420,3,52,0,4,1,0,1,3,4,7,0,3,3,-1,3,2,1,0,1,0,6,-6,-3,-4,7,5,0,0,-1,1,0,-1,2,-1
KR_6740582658,440,1,20,-2,2,0,0,0,1,1,2,-2,4,2,2,0,2,1,1,2,0,8,-6,2,-2,0,-3,0,0,1,-1,0,-1,4,-1
KR_6760889825,420,2,14,17,8,6,1,7,3,2,5,0,1,1,0,4,4,-1,1,0,2,10,-44,7,-8,1,-2,0,1,-1,1,1,1,1,-1
KR_6723154349,420,-4,-49,4,-6,2,1,3,-1,5,4,-1,2,1,-4,4,0,-2,2,0,1,-5,25,-3,-2,5,0,0,-1,-1,-1,-1,1,4,-1
KR_6762588749,440,-4,-64,12,-5,0,0,0,-3,6,3,-4,5,1,0,1,1,2,4,6,-1,-13,-13,1,-3,2,-3,0,0,-1,1,-1,-1,3,-1
KR_6724123684,420,1,-1,-16,1,-1,2,1,-2,3,1,-2,5,3,1,1,2,5,3,8,0,-3,-4,2,-7,5,9,0,0,0,1,0,1,0,-1
KR_6748887260,420,2,48,10,0,0,2,2,-3,3,0,5,1,6,0,3,3,-2,4,2,0,-1,0,-1,-4,5,4,0,0,1,1,0,-1,4,-1
KR_6724305705,440,-2,-46,-10,-3,1,1,2,3,2,5,0,4,4,-3,4,1,-4,4,0,0,-6,136,6,-9,3,-2,0,0,0,1,-1,1,0,-1
KR_6766666903,420,-2,21,24,-5,-6,6,0,0,7,7,-2,3,1,2,1,3,1,0,1,1,8,-8,-1,-8,9,4,0,-1,-1,-1,-1,1,3,-1
KR_6767522290,420,-3,63,4,-13,-2,8,6,1,0,1,-3,3,0,-2,4,2,-7,7,0,0,-17,-34,0,-3,3,0,0,0,1,-1,1,-1,5,-1
KR_6612460988,420,0,-1,-15,6,3,1,4,2,1,3,1,0,1,-1,2,1,1,0,1,0,6,12,-1,-7,8,1,0,0,1,1,0,1,2,-1
KR_6764488756,420,-3,-2,-16,-5,0,2,2,-3,7,4,-1,3,2,-1,3,2,0,1,1,0,-10,-8,-3,-3,6,2,0,-1,1,-1,-1,1,1,-1
KR_6681539488,420,2,32,-1,8,-2,3,1,0,3,3,6,0,6,1,0,1,3,0,3,1,13,-12,-4,-5,9,4,0,-1,1,-1,-1,1,3,-1
KR_6764585751,420,-4,-91,1,-11,-1,1,0,-7,7,0,-1,6,5,-1,5,4,-1,1,0,-1,-22,17,5,-9,4,-6,0,-3,1,-1,-1,-1,3,-1
KR_6766651445,440,-8,-86,-29,-25,-6,7,1,-1,2,1,1,2,3,-18,19,1,-1,1,0,0,-22,-10,-3,-2,5,3,0,-2,-1,-1,-1,-1,4,-1
KR_6747231624,420,-2,-25,-11,-4,-4,4,0,2,3,5,0,3,3,-3,4,1,1,0,1,0,-10,340,-1,-3,4,-3,0,-1,1,-1,-1,-1,5,-1
KR_6548897712,420,-1,-35,-44,-1,-2,2,0,-2,2,0,3,3,6,0,4,4,0,0,0,0,5,11,4,-6,2,0,0,0,0,0,0,1,0,-1
KR_6766979763,420,-2,-96,-11,-12,-1,1,0,-3,4,1,-1,1,0,-5,7,2,-2,2,0,0,-13,-139,-1,-3,4,-9,0,-3,-1,-1,-1,-1,4,-1
KR_6766936627,440,-1,-98,8,-4,0,1,1,3,1,4,-4,5,1,-3,4,1,0,1,1,0,-6,-5,1,-2,1,4,0,0,-1,-1,0,-1,1,-1
KR_6751090828,440,-2,-52,4,4,0,1,1,-3,5,2,0,2,2,1,0,1,6,0,6,2,6,-2,-3,-1,4,4,0,-2,1,-1,-1,1,1,-1
KR_6467109610,420,-6,-38,-16,-11,-2,3,1,-1,7,6,-1,4,3,-3,7,4,-4,5,1,-2,-14,15,-1,-6,7,-6,0,-1,-1,-1,-1,-1,3,-1
KR_6750068668,440,-3,-17,-32,2,2,4,6,2,1,3,-2,4,2,1,2,3,-1,4,3,1,6,-3,2,-2,0,0,0,-1,-1,0,-1,1,4,-1
KR_6723199127,420,2,65,8,-5,3,1,4,-1,1,0,-3,4,1,-4,6,2,0,0,0,0,-10,-28,5,-9,4,20,0,-1,-1,-1,-1,1,1,-1
KR_6760662137,420,4,36,0,11,2,1,3,-1,2,1,3,2,5,5,0,5,2,1,3,0,3,8,4,-8,4,1,0,1,1,1,1,1,5,-1
KR_6701738964,420,-3,-33,-8,0,1,1,2,5,2,7,-2,2,0,-4,5,1,0,2,2,0,10,5,0,-3,3,2,0,0,0,-1,1,-1,0,-1
KR_6764802964,420,0,-27,16,-3,-1,1,0,2,3,5,0,1,1,-3,8,5,-1,1,0,0,-3,-7,2,-4,2,1,0,-2,1,-1,-1,1,5,-1
KR_6750586694,420,1,46,16,-1,2,2,4,-2,2,0,-1,1,0,1,4,5,-1,4,3,0,-11,-179,1,-6,5,4,0,-1,-1,-1,-1,-1,4,-1
KR_6641555654,420,-1,-22,-24,-4,2,3,5,-3,4,1,-4,4,0,-1,4,3,2,0,2,0,-3,-264,2,-5,3,-4,0,1,-1,-1,1,1,6,-1
KR_6750375571,420,2,16,27,8,1,1,2,3,1,4,8,3,11,-3,4,1,-1,2,1,0,-2,-4,3,-4,1,-1,0,1,1,1,1,1,3,-1
KR_6757506926,420,-3,-86,-12,-10,-2,4,2,2,0,2,-9,10,1,-2,4,2,1,2,3,0,0,-1,0,-4,4,-7,0,0,-1,-1,-1,-1,4,-1
KR_6750676013,420,-3,-65,-7,-8,-6,6,0,1,2,3,-4,6,2,4,0,4,-3,4,1,-1,-10,6,5,-7,2,-5,0,-1,1,-1,-1,-1,1,-1
KR_6671047050,420,0,-2,20,2,-1,1,0,1,3,4,3,1,4,-1,2,1,0,1,1,0,1,115,-1,-4,5,4,0,1,-1,1,1,1,4,-1
KR_6657878896,420,-2,13,6,0,-2,3,1,0,1,1,4,1,5,-3,3,0,1,0,1,0,-1,-6,-1,-2,3,2,0,-1,1,0,-1,-1,4,-1
KR_6716586104,420,-4,-73,-16,-7,-1,2,1,3,3,6,-4,4,0,-5,5,0,0,0,0,0,-11,1,-3,-2,5,-1,0,0,-1,-1,0,-1,4,-1
KR_6606508510,420,2,4,-3,1,1,2,3,-1,2,1,1,0,1,-2,4,2,2,1,3,0,-3,1,2,-7,5,-5,0,-1,1,-1,-1,-1,3,-1
KR_6732845275,440,-3,-56,-11,2,-2,3,1,-1,5,4,2,1,3,1,2,3,2,1,3,0,5,3,3,-9,6,1,0,0,-1,1,-1,-1,4,-1
KR_6715588886,420,-5,27,-40,-7,-1,3,2,-4,5,1,-4,5,1,-2,6,4,4,0,4,0,5,149,-2,-4,6,-4,0,-1,-1,1,-1,-1,1,-1
KR_6328368095,420,-6,-101,12,-8,0,2,2,4,1,5,-5,6,1,-6,6,0,-1,2,1,0,-3,-8,2,-5,3,1,0,-2,-1,1,-1,-1,3,-1
KR_6667735962,420,-4,-68,4,-4,0,2,2,-8,11,3,0,2,2,3,2,5,1,2,3,0,2,6,-2,-2,4,-2,0,-1,1,-1,-1,1,5,-1
KR_6674891844,420,1,16,-24,0,5,2,7,-2,5,3,-4,5,1,-1,4,3,2,1,3,1,6,-5,-6,-1,7,-4,0,0,-1,-1,1,1,6,-1
KR_6767112724,420,0,0,-3,-2,-2,2,0,-2,3,1,4,1,5,-1,2,1,-1,2,1,0,-2,-2,-5,-4,9,4,0,0,-1,-1,0,-1,2,-1
KR_6752407656,420,0,33,-22,-7,-3,4,1,-4,6,2,0,2,2,0,3,3,0,1,1,-2,-11,6,2,-10,8,-3,0,-1,1,1,1,-1,5,-1
KR_6733321675,420,0,-11,-22,-1,4,6,10,2,1,3,-3,3,0,-3,7,4,-1,1,0,1,5,-9,-1,-2,3,3,0,-1,1,-1,-1,1,3,-1
KR_6731749972,420,-2,-68,24,-10,-2,2,0,2,0,2,-1,2,1,-3,7,4,-6,6,0,0,-11,-3,-7,0,7,1,0,-1,-1,1,1,-1,4,-1
KR_6707885389,420,-3,-74,-40,-7,2,1,3,0,2,2,-10,10,0,-1,2,1,2,2,4,0,-12,-17,-4,-1,5,1,0,-4,1,-1,-1,1,1,-1
KR_6620895789,420,1,-30,0,7,0,2,2,0,2,2,3,1,4,2,2,4,2,2,4,0,12,0,-3,-3,6,0,0,0,1,1,0,-1,1,-1
KR_6663624462,420,-5,-80,1,-13,-3,5,2,-8,8,0,0,3,3,0,3,3,-2,2,0,0,-19,-11,-4,-4,8,3,0,1,-1,-1,1,-1,1,-1
KR_6709373720,420,-2,22,3,-3,-3,5,2,-2,3,1,6,2,8,-3,5,2,-1,1,0,2,-5,-8,-3,-2,5,1,0,-1,-1,-1,-1,-1,4,-1
KR_6704254717,420,4,18,-12,7,3,2,5,0,2,2,0,1,1,0,0,0,4,0,4,-1,3,0,0,-4,4,5,0,1,0,0,1,-1,0,-1
KR_6647524816,420,-3,0,0,-7,-3,3,0,-2,2,0,-4,4,0,1,2,3,1,0,1,0,-3,-6,-8,-2,10,-1,0,0,-1,-1,-1,1,6,-1
KR_6755184424,420,1,-16,46,6,0,1,1,4,0,4,0,2,2,0,6,6,2,1,3,0,3,-10,-5,-2,7,4,0,0,1,1,1,1,3,-1
KR_6688237258,420,-4,-23,11,-1,-3,3,0,3,4,7,2,3,5,-2,3,1,-1,1,0,0,2,36,-1,-4,5,-9,0,1,-1,1,1,-1,3,-1
KR_6764748582,420,-3,-34,4,-4,-3,3,0,-1,2,1,2,0,2,-1,2,1,-1,1,0,0,-5,-7,-3,-2,5,4,0,-2,-1,-1,-1,-1,3,-1
KR_6764643008,420,-2,-13,6,0,-1,2,1,-1,2,1,3,2,5,1,1,2,-2,4,2,0,0,24,0,-5,5,-31,0,0,-1,-1,-1,1,1,-1
KR_6767252233,420,-5,-90,-12,-15,-1,3,2,-2,6,4,-4,5,1,-5,6,1,-3,5,2,0,-11,8,2,-5,3,-3,0,-1,-1,0,-1,1,3,-1
KR_6651696420,420,2,-33,12,3,0,3,3,0,1,1,1,1,2,1,4,5,1,2,3,-2,6,53,0,-4,4,-14,0,-1,-1,1,-1,-1,3,-1
KR_6764637556,420,-3,-99,-18,-6,0,0,0,0,2,2,-6,6,0,0,1,1,0,2,2,0,-3,-1,-5,-4,9,-5,0,-1,-1,1,-1,-1,1,-1
KR_6141687557,420,-2,-16,-12,-8,-4,5,1,1,5,6,-3,4,1,-2,2,0,0,2,2,-1,3,9,-12,-1,13,5,0,-2,1,-1,-1,-1,3,-1
KR_6767314448,420,0,-37,8,-2,1,0,1,1,2,3,2,1,3,-6,6,0,0,1,1,0,-2,-133,-1,-4,5,-4,0,-1,-1,0,-1,-1,5,-1
KR_6610374621,420,-3,13,-14,-10,0,1,1,-2,5,3,-5,6,1,-1,2,1,-2,2,0,-2,-16,-2,0,-2,2,4,0,1,-1,0,-1,-1,2,-1
KR_6615592532,440,2,41,1,4,2,2,4,-1,1,0,-1,3,2,1,3,4,3,0,3,0,1,-3,1,-3,2,3,0,0,1,1,1,-1,5,-1
KR_6758439381,420,3,53,-4,-6,2,2,4,2,5,7,-9,12,3,-1,4,3,0,1,1,0,-17,45,0,-4,4,-24,0,0,-1,-1,-1,-1,1,-1
KR_6560072732,440,-6,-93,-12,-9,0,5,5,0,5,5,-3,5,2,-4,4,0,-2,4,2,0,0,-118,-2,-1,3,-1,0,-3,0,1,-1,-1,0,-1
KR_6751359846,440,-3,-11,-16,-12,1,3,4,-1,3,2,-3,4,1,-8,8,0,-1,1,0,0,-10,30,1,-4,3,-26,0,-1,-1,1,-1,1,5,-1
KR_6651387783,420,-1,19,3,-5,3,2,5,-3,3,0,-3,4,1,-2,6,4,0,2,2,0,-10,-17,1,-5,4,-5,0,0,-1,-1,0,1,1,-1
KR_6623458643,420,-2,30,-8,-8,-1,3,2,-1,2,1,0,2,2,-4,7,3,-2,2,0,0,-12,-7,1,-6,5,-1,0,-1,-1,1,-1,1,2,-1
KR_6673567868,420,1,-6,12,-5,2,2,4,3,1,4,1,4,5,-7,7,0,-4,4,0,-2,-16,-17,-5,-1,6,1,0,-2,1,1,-1,-1,5,-1
KR_6762369769,420,-1,10,-4,-5,-4,5,1,-2,2,0,3,1,4,-2,3,1,0,3,3,0,-6,4,0,-3,3,3,0,-1,1,0,-1,-1,3,-1
KR_6764626728,420,-2,1,-29,-2,1,2,3,4,1,5,-2,5,3,-3,4,1,-2,2,0,0,0,3,2,-4,2,-2,0,-2,-1,-1,-1,1,6,-1
KR_6764863263,440,-4,-50,16,-10,-2,4,2,-2,5,3,-7,9,2,1,3,4,0,0,0,0,-4,1,-4,-2,6,-2,0,-1,0,-1,-1,1,0,-1
KR_6732759112,420,0,38,12,-5,1,1,2,-2,5,3,-2,2,0,-2,4,2,0,1,1,0,-14,0,1,-8,7,-2,0,-1,1,-1,-1,1,1,-1
KR_6741726291,420,1,-35,4,-3,-1,2,1,0,2,2,-2,3,1,-1,2,1,1,1,2,-1,-4,1,-1,-1,2,1,0,0,1,-1,1,-1,1,-1
KR_6757630942,420,-1,-17,0,-3,-2,2,0,-1,2,1,-1,3,2,2,2,4,-1,1,0,1,-4,-6,-1,-3,4,1,0,0,1,-1,-1,1,2,-1
KR_6764553230,420,3,96,8,3,7,0,7,-3,3,0,0,1,1,-3,3,0,2,0,2,0,0,14,-3,-6,9,1,0,3,-1,1,1,1,3,-1
KR_6725718412,440,-3,7,-20,0,-3,5,2,-1,2,1,1,1,2,0,4,4,3,0,3,0,8,1,-5,-5,10,0,0,-1,-1,-1,-1,1,1,-1
KR_6765011095,420,1,-4,21,0,1,1,2,-2,3,1,0,1,1,1,0,1,0,1,1,0,-7,-87,-3,-4,7,-4,0,1,1,-1,1,-1,2,-1
KR_6763670199,420,0,-31,25,2,-2,3,1,5,3,8,1,2,3,-1,1,0,-1,2,1,0,2,-4,2,-6,4,3,0,0,-1,0,0,1,4,-1
KR_6760698272,420,2,22,-3,3,5,0,5,4,0,4,-1,2,1,-1,3,2,-4,4,0,0,0,-7,1,-3,2,1,0,0,-1,0,0,-1,6,-1
KR_6685732415,420,-3,4,-8,-10,2,2,4,0,2,2,-6,7,1,-7,9,2,1,1,2,-1,-7,9,0,-5,5,-1,0,-1,1,-1,-1,-1,4,-1
KR_6731963588,420,-1,43,4,3,0,2,2,-2,4,2,0,3,3,5,0,5,0,1,1,2,16,5,-1,-2,3,1,0,0,0,0,1,1,0,-1
KR_6718207752,440,4,48,19,12,2,1,3,-5,9,4,1,3,4,12,1,13,2,0,2,1,9,-16,-2,-5,7,4,0,0,-1,1,1,1,5,-1
KR_6761436692,420,-3,-8,-19,-8,1,2,3,-2,2,0,-4,7,3,-1,3,2,-2,3,1,0,-10,-1,-2,-4,6,-1,0,-2,-1,0,-1,-1,5,-1
KR_6718160294,420,0,34,8,-1,1,0,1,2,2,4,-1,3,2,-3,5,2,0,1,1,0,-2,10,2,-6,4,-9,0,0,-1,-1,0,1,2,-1
KR_6757997157,420,2,30,18,5,-1,3,2,2,1,3,1,6,7,3,1,4,0,1,1,0,1,13,0,-4,4,-1,0,0,1,-1,-1,-1,2,-1
KR_6453860831,420,-3,-26,-2,-7,0,2,2,-5,6,1,3,0,3,-1,1,0,-4,6,2,0,-5,16,5,-9,4,-4,0,-2,-1,0,-1,1,5,-1
KR_6707409914,420,-5,-15,-35,-11,1,3,4,1,2,3,-3,3,0,-9,9,0,-1,2,1,0,-12,31,-3,-4,7,0,0,0,-1,-1,0,1,6,-1
KR_6759123473,420,0,43,12,0,3,0,3,2,2,4,-2,4,2,-2,3,1,-1,2,1,0,-5,11,8,-8,0,0,0,0,-1,1,0,1,6,-1
KR_6570781940,420,0,12,8,-5,-1,2,1,-6,8,2,3,1,4,2,4,6,-3,3,0,0,-12,-5,-3,-1,4,0,0,0,-1,1,1,-1,6,-1
KR_6744969570,420,2,36,-40,3,0,0,0,0,4,4,4,0,4,1,2,3,-2,2,0,0,0,-15,1,-4,3,4,0,1,1,-1,1,-1,5,-1
KR_6677844757,420,-4,-37,-20,-11,-7,8,1,1,1,2,-3,3,0,-1,3,2,-1,1,0,0,-6,-40,-3,-5,8,0,0,-1,-1,-1,-1,-1,2,-1
KR_6653155237,420,-3,-37,-8,-2,1,1,2,-2,4,2,-1,1,0,2,1,3,-2,2,0,0,0,-7,-3,-4,7,4,0,0,-1,1,0,-1,4,-1
KR_6683919966,420,-4,-42,-20,-10,-4,6,2,1,0,1,-1,3,2,-6,7,1,0,1,1,-1,-7,-19,-2,-4,6,-4,0,-1,-1,-1,-1,-1,1,-1
KR_6683061436,420,-5,-134,-21,-8,-3,4,1,0,2,2,-1,2,1,-1,5,4,-3,4,1,-1,-3,4,2,-4,2,-4,0,-2,1,-1,-1,-1,2,-1
KR_6726800127,440,-5,-61,-52,-7,1,0,1,0,0,0,-2,4,2,-4,4,0,-2,3,1,-1,-3,-4,-2,-4,6,-2,0,0,1,-1,-1,-1,5,-1
KR_6747689360,420,-1,60,20,-8,0,5,5,-1,3,2,-5,8,3,-2,3,1,0,0,0,0,-4,4,7,-8,1,-5,0,0,1,-1,-1,1,3,-1
KR_6720662591,420,-4,-90,-46,-13,0,1,1,-3,3,0,-3,5,2,-7,8,1,0,1,1,0,-10,-18,-7,-2,9,0,0,-4,-1,-1,-1,-1,5,-1
KR_6766512165,420,-4,-16,-17,-6,0,3,3,0,2,2,-3,3,0,-1,4,3,-2,2,0,0,-7,-1,-1,-4,5,-1,0,-1,1,-1,-1,-1,1,-1
KR_6755395330,420,-4,-50,9,-11,-8,8,0,0,2,2,0,2,2,0,3,3,-3,4,1,0,-7,-5,3,-6,3,0,0,-1,1,1,-1,1,5,-1
KR_6630708675,420,-5,-13,-11,-9,-1,4,3,-2,8,6,-3,4,1,-2,3,1,-1,2,1,-2,-1,-9,-3,-2,5,-4,0,-1,1,-1,-1,-1,3,-1
KR_6705119257,420,-1,-31,-1,-10,1,5,6,-2,4,2,-1,3,2,-8,8,0,0,1,1,1,-8,-3,-3,0,3,1,0,-1,0,-1,-1,1,0,-1
KR_6751892272,420,-1,-37,-8,-15,-4,4,0,-4,4,0,-4,7,3,-2,8,6,-1,1,0,0,-14,7,-3,-7,10,-1,0,-1,1,-1,-1,-1,1,-1
KR_6759462930,420,3,40,20,7,3,0,3,-1,2,1,4,0,4,0,2,2,1,1,2,0,2,24,1,-2,1,0,0,1,1,-1,1,1,5,-1
KR_6705028707,420,-1,18,-15,-1,1,2,3,-1,2,1,1,3,4,-2,3,1,0,3,3,0,-6,4,4,-6,2,-1,0,0,-1,-1,0,1,2,-1
KR_6767663343,420,-4,-30,-29,-5,0,2,2,-1,4,3,1,4,5,-1,3,2,-4,8,4,0,-4,3,3,-4,1,-4,0,0,-1,1,0,1,6,-1
KR_6763884562,420,2,57,48,-4,0,0,0,0,2,2,-1,2,1,-1,2,1,-2,2,0,0,-3,8,1,-6,5,-7,0,0,-1,-1,1,-1,5,-1
KR_6759221665,420,-2,-42,-17,-2,-2,2,0,3,0,3,2,2,4,-2,2,0,-3,3,0,-1,-1,33,3,-4,1,-10,0,-1,0,-1,-1,-1,0,-1
KR_6746551133,420,-4,11,-12,-10,-3,3,0,-3,3,0,2,1,3,-5,5,0,-1,2,1,0,-12,4,-1,-2,3,-3,0,0,1,1,0,1,6,-1
KR_6745865822,440,-4,-32,15,-9,-2,3,1,-3,4,1,-5,5,0,1,0,1,0,1,1,0,-9,8,1,-2,1,-5,0,0,-1,-1,-1,-1,4,-1
KR_6747379883,420,-3,-10,5,-7,-4,6,2,-2,4,2,1,3,4,-2,4,2,0,0,0,0,-12,2,0,-4,4,-7,0,-1,-1,1,-1,-1,1,-1
KR_6724825033,420,-5,-33,-9,-10,-2,3,1,-4,6,2,-3,6,3,-2,4,2,1,1,2,-1,-10,-71,0,-2,2,0,0,0,-1,-1,0,-1,1,-1
KR_6736909249,420,-3,-79,12,-14,-2,3,1,-2,4,2,-7,10,3,-2,4,2,-1,3,2,-2,-16,-14,-3,-3,6,2,0,-1,-1,-1,-1,-1,1,-1
KR_6673236342,420,-1,28,12,-1,-3,4,1,-4,5,1,5,2,7,0,3,3,1,0,1,2,1,-4,1,-3,2,1,0,1,1,0,1,1,2,-1
KR_6759553213,420,-1,-49,37,-4,1,0,1,1,2,3,-3,7,4,-1,3,2,-2,2,0,0,-8,10,0,-3,3,0,0,-2,1,-1,-1,-1,1,-1
KR_6757061555,420,-4,-80,-3,-5,0,1,1,-2,5,3,0,1,1,-3,8,5,0,1,1,0,-3,-8,2,-6,4,-2,0,-1,-1,0,-1,1,6,-1
KR_6657943160,420,-1,44,-20,-1,3,0,3,-1,2,1,-2,3,1,-1,3,2,0,1,1,0,0,-4,-3,-6,9,0,0,0,-1,1,0,-1,2,-1
KR_6694585718,420,2,55,-5,5,-3,4,1,3,1,4,2,0,2,2,1,3,1,0,1,1,8,-97,3,-5,2,0,0,0,1,-1,1,1,2,-1
KR_6601187132,420,-5,-29,-20,-21,-5,6,1,-3,3,0,-5,7,2,-7,8,1,-1,1,0,0,-14,10,4,-8,4,-6,0,-1,-1,-1,-1,-1,2,-1
KR_6753916833,420,0,-30,-4,-3,0,5,5,2,1,3,-4,5,1,-1,3,2,0,1,1,-1,-1,5,2,-5,3,0,0,0,-1,1,-1,-1,2,-1
KR_6767971997,420,-2,-14,-13,-5,-2,4,2,2,2,4,-3,4,1,-1,4,3,-1,1,0,-1,-10,-10,-4,-2,6,-1,0,-2,-1,-1,-1,-1,4,-1
KR_6625215660,440,0,14,6,-5,-4,4,0,-1,1,0,0,1,1,-1,3,2,1,1,2,0,-6,-117,0,-4,4,-3,0,-2,0,-1,-1,-1,0,-1
KR_6760602828,440,-5,-55,-30,-11,-3,4,1,-1,1,0,-4,5,1,-3,3,0,0,1,1,0,-9,-119,5,-7,2,-4,0,-4,-1,-1,-1,-1,3,-1
KR_6741588762,420,-4,-57,5,-4,2,0,2,0,1,1,2,2,4,-5,6,1,-3,4,1,0,-8,-10,0,-4,4,-1,0,-3,-1,-1,-1,-1,4,-1
KR_6761482788,420,0,-28,3,1,-2,2,0,1,1,2,-3,3,0,-1,1,0,6,0,6,-1,8,-51,-4,-5,9,32,0,-1,-1,-1,-1,-1,4,-1
KR_6649417891,420,0,58,7,-3,-1,3,2,-7,9,2,2,2,4,1,1,2,2,0,2,-1,-9,-36,-1,-3,4,14,0,-1,-1,-1,-1,-1,6,-1
KR_6723329380,420,-4,-33,6,-7,2,2,4,-5,5,0,-1,4,3,-5,7,2,2,2,4,0,-9,30,1,-3,2,-4,0,1,-1,1,1,1,3,-1
KR_6744992813,420,-6,-50,4,-15,-3,3,0,-3,5,2,-4,7,3,-3,5,2,-2,3,1,0,-9,5,-1,-4,5,-5,0,0,1,1,0,1,6,-1
KR_6765482254,420,-1,-92,-16,-8,0,1,1,-1,3,2,1,0,1,-6,7,1,-2,2,0,-1,-12,-1,-1,-3,4,-6,0,-2,-1,-1,-1,-1,1,-1
KR_6707822467,420,0,10,-3,5,-2,3,1,0,3,3,2,2,4,5,0,5,0,1,1,1,7,27,0,-4,4,-1,0,1,-1,1,1,1,4,-1
KR_6690692934,420,2,64,16,2,3,0,3,-1,3,2,1,3,4,2,4,6,-3,4,1,0,-7,-153,1,-4,3,1,0,1,-1,-1,1,1,2,-1
KR_6740050538,420,-2,17,-20,-7,0,1,1,-1,2,1,0,2,2,-3,4,1,-3,4,1,0,-12,-10,-4,-1,5,1,0,0,0,0,1,-1,0,-1
KR_6752557431,420,0,51,-21,-1,-4,4,0,-2,6,4,-2,5,3,6,1,7,1,1,2,0,-4,3,-1,-3,4,3,0,0,-1,-1,-1,-1,1,-1
KR_6762436845,440,3,-18,16,4,-3,4,1,4,2,6,-4,4,0,5,1,6,2,1,3,-2,7,18,-1,-4,5,2,0,2,1,1,1,-1,4,-1
KR_6762414061,420,3,100,15,6,-4,6,2,4,2,6,5,0,5,-1,1,0,2,0,2,0,3,12,3,-5,2,1,0,3,1,1,1,1,1,-1
KR_6706532452,420,-3,-56,-26,-11,-3,3,0,0,1,1,0,2,2,-7,8,1,-1,1,0,-2,-10,-25,2,-4,2,-6,0,-4,1,1,-1,-1,6,-1
KR_6706953712,420,0,-46,12,-4,-3,4,1,1,3,4,2,2,4,-3,3,0,-1,1,0,0,6,13,-2,-3,5,-1,0,-1,-1,-1,-1,1,5,-1
KR_6757751243,420,1,-5,21,1,-1,2,1,4,2,6,0,0,0,0,2,2,-2,2,0,0,2,4,-3,-1,4,-2,0,1,-1,1,1,-1,5,-1
KR_6767883568,420,0,1,28,1,1,3,4,-1,1,0,4,3,7,-4,4,0,1,0,1,0,-1,-39,-1,-6,7,16,0,1,-1,1,1,1,2,-1
KR_6677574562,420,-2,-17,-32,-10,-3,4,1,-5,5,0,1,1,2,-2,4,2,-1,3,2,0,-12,253,-3,-2,5,2,0,1,-1,0,1,-1,3,-1
KR_6766170367,420,-5,-84,-26,-9,1,3,4,-1,1,0,0,2,2,-9,10,1,0,1,1,0,-11,97,-3,-4,7,-1,0,0,-1,-1,1,-1,3,-1
KR_6750390307,420,-2,18,5,-16,-2,4,2,4,0,4,-6,9,3,-8,8,0,-4,4,0,-1,-17,42,-1,-6,7,-21,0,-2,-1,1,-1,-1,5,-1
KR_6745423429,420,-2,-17,33,-1,-1,2,1,2,2,4,0,3,3,-3,4,1,1,0,1,0,-3,21,3,-4,1,-7,0,0,1,1,0,1,4,-1
KR_6760050952,420,-1,-15,-17,1,0,5,5,-2,3,1,-3,4,1,4,3,7,2,1,3,-4,0,11,1,-7,6,0,0,-1,0,-1,-1,-1,0,-1
KR_6746023235,440,-6,-39,-41,-8,-1,2,1,-1,1,0,-6,7,1,2,1,3,-2,7,5,0,-2,2,1,-5,4,-2,0,-2,-1,-1,-1,1,2,-1
KR_6765705001,420,0,12,-8,0,1,1,2,-2,3,1,0,1,1,1,3,4,0,0,0,0,1,-16,4,-7,3,-1,0,-1,1,-1,-1,-1,4,-1
KR_6626757281,420,-2,-2,-36,2,4,0,4,1,4,5,-2,3,1,1,3,4,-2,4,2,0,0,-2,-1,-6,7,-1,0,0,-1,1,1,-1,4,-1
KR_6684723552,420,-3,57,0,-5,-1,2,1,2,1,3,-1,4,3,-3,3,0,-2,2,0,0,-9,-448,3,-6,3,1,0,0,-1,1,0,1,3,-1
KR_6743425395,440,0,50,14,-4,0,3,3,-2,3,1,-3,3,0,1,4,5,0,1,1,0,-9,-24,-1,-4,5,6,0,0,1,-1,-1,-1,4,-1
KR_6767141501,420,-3,12,0,-9,1,1,2,-3,3,0,-9,11,2,4,1,5,-2,2,0,0,-12,22,3,-7,4,-6,0,0,1,-1,0,-1,4,-1
KR_6755856460,420,3,-21,28,12,3,0,3,0,3,3,1,5,6,5,3,8,3,1,4,0,12,18,8,-10,2,-1,0,0,1,1,1,1,5,-1
KR_6753224793,440,1,-6,11,3,-2,2,0,1,0,1,5,0,5,3,2,5,-4,4,0,0,4,-18,2,-5,3,-1,0,0,-1,1,1,1,5,-1
KR_6755158265,420,3,-22,27,3,-3,4,1,6,0,6,-1,2,1,1,3,4,0,1,1,-1,6,42,3,-9,6,-4,0,0,0,-1,1,-1,0,-1
KR_6747262667,440,2,29,12,-1,0,0,0,2,1,3,0,2,2,-3,5,2,0,1,1,0,1,-6,-5,-3,8,-3,0,0,-1,-1,0,-1,1,-1
KR_6735797642,440,-1,-7,16,-12,1,2,3,0,4,4,-1,2,1,-12,13,1,0,0,0,0,-13,31,-3,-1,4,1,0,-1,0,-1,-1,1,0,-1
KR_6759656018,420,-6,-88,-48,-9,0,0,0,-1,3,2,-1,2,1,-6,9,3,-1,1,0,0,-6,90,-1,-1,2,26,0,-2,-1,-1,-1,-1,1,-1
KR_6748920388,420,3,12,-4,14,2,0,2,1,2,3,4,0,4,5,2,7,2,0,2,0,17,-10,3,-3,0,0,0,2,0,1,1,1,0,-1
KR_6592966496,420,-3,-51,-32,-3,0,2,2,-5,5,0,-2,2,0,4,0,4,0,1,1,0,1,15,7,-7,0,-3,0,-1,1,1,-1,-1,1,-1
KR_6602828729,420,0,47,8,0,-2,3,1,-2,4,2,4,0,4,1,1,2,-1,1,0,0,1,-10,2,-7,5,-5,0,0,1,0,0,1,6,-1
KR_6707357917,420,-3,-17,-31,-2,-2,2,0,-1,2,1,2,1,3,-1,3,2,0,0,0,-1,-3,-28,0,-3,3,14,0,-1,-1,-1,-1,-1,4,-1
KR_6543837963,420,-1,-17,-28,-3,-2,4,2,3,4,7,-2,3,1,-1,2,1,-1,2,1,0,-8,0,-1,-3,4,0,0,1,-1,-1,1,-1,2,-1
KR_6720278319,420,1,51,-36,4,-1,2,1,3,0,3,-3,3,0,3,0,3,2,3,5,0,4,8,2,-4,2,0,0,0,-1,-1,-1,-1,1,-1
KR_6765141224,420,0,-39,37,-7,-2,4,2,1,2,3,0,2,2,-5,5,0,-1,1,0,0,-6,4,-2,-2,4,-2,0,-1,-1,-1,-1,-1,2,-1
KR_6765146952,420,0,12,4,5,6,1,7,-2,2,0,-1,3,2,0,3,3,2,2,4,1,3,-12,-5,-1,6,4,0,0,-1,1,1,1,5,-1
KR_6674798925,420,3,41,-20,3,3,0,3,0,2,2,1,2,3,3,1,4,-4,5,1,0,-1,-26,4,-7,3,0,0,0,-1,-1,-1,1,4,-1
KR_6733149651,420,-2,-28,8,-8,-1,2,1,-2,4,2,-3,4,1,-1,1,0,-1,1,0,0,-5,0,-1,-7,8,-2,0,0,1,-1,-1,1,6,-1
KR_6745186548,420,1,-19,24,2,-4,5,1,-1,3,2,4,0,4,-2,5,3,5,0,5,0,-1,-1,-5,0,5,3,0,-1,-1,1,-1,-1,2,-1
KR_6766128470,420,-3,-8,-15,-2,-2,5,3,1,1,2,6,0,6,-6,8,2,-1,1,0,0,7,21,4,-5,1,-2,0,1,1,1,1,-1,6,-1
KR_6763398092,420,-2,-67,14,-5,-2,4,2,0,3,3,1,0,1,-1,1,0,-3,5,2,0,0,-3,-4,0,4,1,0,0,-1,0,0,-1,3,-1
KR_6627885304,420,0,45,-39,-3,-2,4,2,-3,7,4,2,1,3,-2,2,0,2,1,3,0,-9,9,3,-6,3,1,0,0,-1,-1,0,-1,5,-1
KR_6636839022,420,1,-19,20,-7,-2,2,0,-3,4,1,2,3,5,-3,5,2,-1,1,0,2,-6,-7,1,-5,4,1,0,0,1,-1,-1,-1,1,-1
KR_6702469840,420,-2,21,8,-7,-2,3,1,-4,6,2,-2,3,1,1,1,2,0,0,0,-1,-6,-3,-2,-4,6,-7,0,-1,1,-1,-1,-1,5,-1
KR_6707910829,420,-3,17,-21,-7,1,1,2,-7,8,1,-2,3,1,2,1,3,-1,2,1,1,-5,-9,-1,-7,8,-1,0,-1,-1,-1,-1,1,5,-1
KR_6724281742,440,-3,-111,0,-3,-1,2,1,3,3,6,0,0,0,-2,6,4,-3,3,0,0,-7,0,-3,-4,7,-1,0,-1,-1,1,-1,1,1,-1
KR_6653204861,420,1,30,22,-4,-1,3,2,4,1,5,-5,5,0,-1,2,1,-1,1,0,0,-5,-8,-5,-1,6,0,0,0,-1,0,-1,-1,6,-1
KR_6764219538,440,1,10,28,1,-2,4,2,0,1,1,0,1,1,3,3,6,0,1,1,1,5,-2,-2,0,2,1,0,1,1,-1,1,1,5,-1
KR_6768023625,420,1,-49,3,5,3,1,4,0,3,3,0,2,2,0,2,2,2,0,2,0,4,13,-1,-3,4,2,0,-1,1,-1,-1,1,6,-1
KR_6664635228,420,-4,-48,-16,-13,-2,4,2,-1,2,1,-3,6,3,-8,12,4,1,0,1,-1,-6,1,-3,-4,7,2,0,-2,-1,-1,-1,-1,2,-1
KR_6745815283,420,1,3,16,3,0,0,0,-2,2,0,3,0,3,0,4,4,2,0,2,1,1,7,-4,-2,6,0,0,-1,1,-1,-1,1,1,-1
KR_6735045304,420,-4,-45,-28,-11,-4,5,1,-5,5,0,-2,4,2,-1,2,1,1,0,1,0,-1,-142,-6,-1,7,20,0,-1,-1,-1,-1,-1,4,-1
KR_6762081334,420,-1,12,-8,3,6,1,7,-3,5,2,-1,3,2,1,1,2,0,0,0,-2,3,-4,-1,-5,6,0,0,0,-1,-1,0,-1,5,-1
KR_6747774212,420,0,30,0,-3,2,1,3,0,2,2,-5,5,0,0,3,3,0,0,0,-1,-2,0,-6,-1,7,2,0,1,-1,1,1,-1,5,-1
KR_6753125666,420,-6,40,-39,-13,-4,5,1,-4,6,2,-3,4,1,-1,3,2,-1,1,0,-1,-10,-4,-1,-5,6,-5,0,0,-1,0,0,-1,2,-1
KR_6754792230,420,-2,-34,1,0,4,1,5,-3,7,4,-2,4,2,-2,3,1,3,0,3,0,-4,-4,-3,-7,10,-1,0,1,-1,1,1,-1,5,-1
KR_6756197544,440,-2,-41,3,-3,-1,4,3,6,0,6,-3,4,1,1,1,2,-6,8,2,-1,-5,2,5,-8,3,-5,0,-2,-1,1,-1,-1,3,-1
KR_6665578880,420,-1,-23,4,0,0,2,2,2,1,3,-5,6,1,3,0,3,0,2,2,0,0,2,1,-6,5,1,0,0,-1,1,0,-1,5,-1
KR_6752445928,420,-2,-71,36,-5,0,1,1,-3,4,1,2,2,4,-4,5,1,0,1,1,-1,-11,89,0,-7,7,0,0,0,1,1,0,-1,4,-1
KR_6724741677,420,-4,-48,-9,-9,-3,3,0,-6,6,0,2,1,3,-2,3,1,0,1,1,0,-9,4,-7,-3,10,-2,0,-2,-1,-1,-1,1,2,-1
KR_6616686523,420,-6,-91,-36,-10,-3,3,0,-4,7,3,0,1,1,-3,4,1,0,1,1,0,-5,9,1,-6,5,-7,0,-1,-1,-1,-1,-1,5,-1
KR_6661303056,420,2,-16,-8,3,0,3,3,-6,6,0,6,3,9,-1,2,1,4,0,4,0,2,36,-2,-4,6,-1,0,0,1,-1,-1,-1,3,-1
KR_6733389492,420,-2,-82,44,-12,-4,5,1,-9,11,2,1,2,3,0,1,1,0,1,1,0,-9,7,4,-6,2,-3,0,0,1,1,0,-1,5,-1
KR_6719644927,420,2,49,34,-1,4,0,4,1,4,5,5,2,7,-9,10,1,-2,2,0,1,-15,-2,-5,-3,8,4,0,0,-1,-1,-1,1,2,-1
KR_6743306070,420,-1,-24,9,2,-2,2,0,1,3,4,-1,2,1,4,1,5,0,2,2,0,5,-15,-1,-4,5,-1,0,0,1,-1,-1,1,2,-1
KR_6652623358,420,-4,-147,-21,-4,-6,6,0,-1,5,4,-1,4,3,2,1,3,2,1,3,0,3,-10,-2,-2,4,2,0,-2,-1,-1,-1,-1,6,-1
KR_6760843232,440,-4,5,-15,-10,2,1,3,-8,8,0,-5,5,0,0,1,1,1,0,1,0,-20,1,0,-1,1,0,0,-1,1,1,1,1,5,-1
KR_6716260099,440,-3,-19,-48,-7,-3,3,0,2,0,2,-4,5,1,2,1,3,-4,5,1,-1,3,-4,3,-4,1,3,0,-1,0,-1,-1,-1,0,-1
KR_6750678680,420,1,-73,6,-8,-6,6,0,3,2,5,2,3,5,-6,6,0,-1,1,0,0,-3,-1,-3,-5,8,-3,0,0,0,-1,-1,1,0,-1
KR_6725419532,420,0,-10,0,-3,4,0,4,-2,4,2,-2,4,2,-2,2,0,-1,1,0,0,-4,21,3,-5,2,-2,0,0,0,1,0,-1,0,-1
KR_6696021954,420,-1,-42,3,-3,-2,5,3,-1,2,1,4,2,6,-3,4,1,-1,2,1,0,-7,0,1,-8,7,1,0,-2,-1,-1,-1,-1,2,-1
KR_6767231589,420,-1,-10,-47,3,0,2,2,2,1,3,4,3,7,-4,4,0,1,2,3,0,3,-5,0,-6,6,-1,0,0,-1,1,-1,-1,2,-1
KR_6763622119,420,-3,-33,20,-2,0,2,2,0,3,3,0,2,2,0,0,0,-2,2,0,0,-4,-3,0,-3,3,-1,0,0,0,-1,-1,1,0,-1
KR_6732938437,420,1,36,7,12,-3,5,2,4,2,6,1,2,3,10,2,12,0,0,0,0,14,1,0,-2,2,1,0,1,-1,0,1,1,1,-1
KR_6767806190,420,-1,-16,6,3,1,3,4,-2,2,0,4,0,4,2,3,5,-2,2,0,0,4,-3,3,-6,3,-1,0,-1,1,-1,-1,1,4,-1
KR_6749174019,420,-2,27,-3,2,2,0,2,-1,5,4,2,1,3,-1,4,3,0,1,1,3,12,-8,-2,-5,7,2,0,0,1,1,0,1,2,-1
KR_6766088426,420,-6,-107,-5,-15,-6,8,2,-5,6,1,0,1,1,0,1,1,-4,4,0,0,-13,2,-2,-1,3,-3,0,-1,-1,1,-1,1,3,-1
KR_6747363266,420,-4,-68,-31,-4,-2,3,1,0,3,3,-2,3,1,0,1,1,0,2,2,0,4,-18,-4,-2,6,-1,0,-1,-1,0,-1,-1,6,-1
KR_6707330500,420,-4,-43,-38,-8,-2,2,0,-3,3,0,1,2,3,0,7,7,-4,4,0,0,-8,4,3,-5,2,-4,0,-2,1,-1,1,-1,2,-1
KR_6742948728,420,0,35,-12,-5,-1,1,0,-2,4,2,-2,3,1,3,2,5,-3,3,0,0,-2,-117,2,-7,5,-2,0,-1,-1,0,-1,-1,6,-1
KR_6766677186,420,1,-1,-12,-3,2,2,4,-1,6,5,0,4,4,-4,4,0,0,0,0,0,0,-9,4,-9,5,-3,0,0,1,1,0,1,5,-1
KR_6577538034,420,1,18,12,-3,0,2,2,2,4,6,-3,4,1,2,2,4,-4,4,0,0,-2,-15,1,-4,3,4,0,0,1,-1,-1,-1,1,-1
KR_6626892874,420,0,27,3,4,2,0,2,-1,2,1,1,0,1,1,2,3,1,1,2,0,0,5,0,-7,7,-2,0,-1,-1,-1,-1,1,4,-1
KR_6766900238,420,-2,-66,-8,-3,-2,3,1,4,3,7,-6,6,0,1,0,1,0,1,1,0,-3,4,6,-10,4,-8,0,-1,-1,0,-1,-1,1,-1
KR_6767229721,420,-4,15,-8,-15,1,2,3,-8,9,1,-3,5,2,-3,6,3,-2,3,1,-1,-13,3,-2,-1,3,-2,0,-1,1,-1,-1,-1,6,-1
KR_6719017105,420,4,76,52,0,1,1,2,0,3,3,-1,1,0,2,2,4,-2,4,2,0,0,-35,-9,-4,13,5,0,1,1,-1,1,1,3,-1
KR_6743408822,420,0,10,-8,1,0,2,2,1,2,3,0,2,2,-1,4,3,1,0,1,0,1,1,-2,-1,3,-3,0,-2,-1,-1,-1,1,5,-1
KR_6709628094,420,-2,-1,20,-1,0,0,0,0,2,2,-4,4,0,-2,4,2,5,0,5,2,-5,119,-3,-1,4,2,0,0,-1,1,0,1,1,-1
KR_6608064416,420,-3,-70,-14,-7,-3,4,1,-1,4,3,-2,2,0,-2,4,2,1,0,1,-1,-2,43,1,-6,5,-10,0,-1,-1,-1,-1,-1,4,-1
KR_6735026587,420,-1,17,10,-6,-1,2,1,1,4,5,1,3,4,-1,4,3,-6,7,1,0,-2,-4,-7,-4,11,9,0,0,-1,-1,0,1,5,-1
KR_5883735827,420,-1,-28,16,-1,8,1,9,2,2,4,-9,10,1,-1,5,4,-1,2,1,0,-6,12,2,-6,4,-7,0,-2,-1,1,-1,1,2,-1
KR_6765303036,420,-5,-117,8,-11,-9,11,2,-1,2,1,0,0,0,-3,4,1,2,0,2,0,-6,-6,-1,-2,3,1,0,-3,1,-1,-1,-1,1,-1
KR_6756488594,420,-2,10,0,-2,7,0,7,-1,2,1,-1,2,1,-6,8,2,-1,4,3,0,-2,35,-3,-2,5,0,0,-1,-1,1,-1,-1,5,-1
KR_6733354524,420,1,78,-10,1,1,1,2,-4,6,2,4,1,5,1,0,1,-1,3,2,0,-4,16,2,-5,3,3,0,0,-1,1,0,1,3,-1
KR_6684730423,420,0,-17,20,1,7,0,7,-1,5,4,-3,4,1,-3,5,2,1,0,1,0,-2,12,-4,-4,8,-3,0,0,-1,-1,0,1,3,-1
KR_6732073330,420,-3,-40,-36,-7,-4,4,0,3,1,4,0,0,0,-2,2,0,-4,4,0,0,-6,-19,-5,-2,7,0,0,0,-1,0,-1,-1,1,-1
KR_6764394558,420,-2,-39,-28,-10,-3,3,0,2,3,5,-2,3,1,-6,9,3,-1,3,2,0,-11,6,-4,-2,6,-2,0,0,0,-1,0,-1,0,-1
KR_6763098541,420,-4,-74,-17,-7,0,0,0,-1,3,2,1,1,2,-3,4,1,-4,4,0,0,-10,-54,-3,-3,6,13,0,-2,0,-1,-1,1,0,-1
KR_6747578183,420,0,22,15,2,0,1,1,0,0,0,0,1,1,1,2,3,1,0,1,0,3,-1,2,-5,3,6,0,0,1,0,0,1,3,-1
KR_6740672319,420,0,-14,-8,-3,-2,3,1,-4,6,2,0,1,1,4,0,4,-1,1,0,-1,-9,218,0,-3,3,-3,0,0,1,0,0,-1,1,-1
KR_6733879408,420,-3,-10,31,-6,0,1,1,2,2,4,0,2,2,-6,6,0,-2,3,1,0,-9,10,-3,-5,8,-3,0,-2,-1,-1,-1,1,3,-1
KR_6727667346,420,-1,-5,-29,1,2,1,3,1,5,6,-3,5,2,0,4,4,1,0,1,-1,4,10,2,-3,1,-5,0,1,-1,1,1,-1,4,-1
KR_6744729299,440,-2,-73,-15,-10,2,0,2,-4,5,1,-3,7,4,-5,8,3,0,1,1,0,-11,414,-1,-3,4,1,0,0,-1,-1,0,-1,1,-1
KR_6660534628,420,0,-1,-24,8,-1,4,3,4,3,7,-1,2,1,2,2,4,4,3,7,0,12,4,9,-10,1,-2,0,0,1,1,1,1,1,-1
KR_6689219348,420,-1,-81,11,-2,-3,6,3,1,1,2,1,1,2,-2,5,3,1,1,2,0,1,-2,-1,-4,5,-3,0,-2,-1,1,-1,-1,5,-1
KR_6731236257,420,-4,-59,4,-13,-6,6,0,2,3,5,-1,1,0,-8,8,0,0,0,0,-1,-11,8,0,-4,4,-4,0,-1,-1,-1,-1,-1,3,-1
KR_6749239402,420,-1,10,25,-3,-2,3,1,-2,3,1,-1,3,2,2,0,2,0,0,0,0,-6,-119,-4,-2,6,3,0,1,-1,-1,1,-1,5,-1
KR_6759010520,420,-1,31,-16,1,-1,2,1,5,0,5,0,4,4,0,3,3,-3,3,0,0,2,-2,2,-4,2,2,0,1,0,-1,1,1,0,-1
KR_6717370891,420,2,39,-3,-2,2,4,6,1,3,4,-2,2,0,-2,2,0,-1,2,1,1,-2,-1,-1,-4,5,-1,0,0,-1,-1,-1,1,3,-1
KR_6754510335,420,-4,-41,-8,-6,1,1,2,-1,4,3,-4,6,2,-5,6,1,3,0,3,0,3,2,2,-7,5,-5,0,-3,-1,-1,-1,-1,3,-1
KR_6765978606,420,-2,24,-44,0,3,0,3,2,1,3,-7,8,1,3,0,3,-1,2,1,0,2,5,1,-4,3,-2,0,0,-1,-1,0,1,6,-1
KR_6716441082,440,-1,-2,19,-4,-2,5,3,0,3,3,-4,4,0,1,0,1,1,1,2,0,-2,-1,-3,-5,8,2,0,0,1,-1,1,-1,6,-1
KR_6749400601,440,-1,-18,-8,-3,1,2,3,1,3,4,-5,6,1,-3,5,2,3,0,3,0,-7,3,-1,0,1,0,0,1,1,1,1,-1,1,-1
KR_6703264109,420,-2,-96,-1,-11,-4,5,1,-3,5,2,-4,4,0,0,1,1,0,0,0,0,-4,-2,1,-4,3,1,0,-3,-1,-1,-1,-1,3,-1
KR_6615786625,420,-3,0,-19,-6,-3,5,2,-7,8,1,0,4,4,5,0,5,-1,2,1,0,0,-298,5,-6,1,1,0,-2,-1,-1,-1,-1,6,-1
KR_6732877090,420,-4,-118,-16,-7,-2,2,0,0,0,0,0,4,4,-4,6,2,-1,1,0,0,-8,-6,-2,-5,7,-2,0,0,0,-1,0,-1,0,-1
KR_6445399287,420,2,41,12,2,0,1,1,-1,2,1,-2,4,2,-1,3,2,6,0,6,0,3,-3,5,-9,4,0,0,0,1,1,0,-1,4,-1
KR_6765255242,420,2,-23,-4,11,1,2,3,5,1,6,7,2,9,-2,4,2,0,1,1,0,12,-18,2,-6,4,6,0,0,0,1,0,1,0,-1
KR_6761925519,420,2,99,-20,10,4,1,5,-5,5,0,8,0,8,0,2,2,3,0,3,1,1,-6,0,-6,6,3,0,0,1,-1,0,1,4,-1
KR_6653808658,420,-2,-20,8,0,3,1,4,-3,5,2,2,0,2,0,0,0,-2,2,0,0,-6,11,5,-13,8,0,0,0,-1,1,0,1,1,-1
KR_6733674415,420,-4,-45,8,-7,-4,5,1,0,1,1,0,1,1,-3,3,0,0,0,0,0,-5,-12,-2,-1,3,1,0,-2,-1,1,-1,-1,6,-1
KR_6739885846,440,0,-54,6,-7,0,3,3,5,2,7,-3,4,1,-8,8,0,-1,1,0,0,-4,-3,3,-4,1,-2,0,0,0,0,0,1,0,-1
KR_6719661699,420,-6,-23,-24,-17,-1,2,1,-2,3,1,-7,8,1,-7,7,0,0,0,0,0,-18,-53,-6,-1,7,6,0,0,1,-1,-1,1,1,-1
KR_6763527866,440,-1,19,-19,-4,-2,2,0,4,1,5,-4,5,1,-2,8,6,0,0,0,1,-5,-154,5,-10,5,16,0,0,-1,1,1,1,4,-1
KR_6750901457,420,-3,11,-16,-9,-8,9,1,1,2,3,-3,4,1,1,2,3,0,0,0,0,5,4,0,-2,2,-3,0,0,-1,0,0,-1,5,-1
KR_6723592228,420,-4,13,-32,-1,-4,5,1,1,3,4,2,2,4,0,2,2,0,0,0,0,5,-29,3,-6,3,-5,0,-1,-1,-1,-1,-1,5,-1
KR_6724389703,440,-3,-33,4,-3,-3,3,0,4,1,5,0,0,0,-2,5,3,-2,4,2,0,-7,-1,1,-4,3,-3,0,0,-1,-1,-1,1,6,-1
KR_6607562486,420,-5,-70,-25,-10,-1,1,0,-2,3,1,-2,3,1,-3,5,2,-2,3,1,0,-15,-8,-4,-3,7,1,0,-1,-1,-1,-1,-1,4,-1
KR_6761761923,420,1,42,24,7,-2,3,1,-1,5,4,1,1,2,9,1,10,0,0,0,0,5,-3,0,-3,3,-3,0,0,1,-1,1,1,4,-1
KR_6705464379,420,1,20,-7,0,0,1,1,-5,7,2,1,1,2,2,1,3,2,1,3,0,-7,-5,4,-10,6,5,0,0,-1,1,1,-1,4,-1
KR_6692534762,420,1,-26,-4,1,-1,2,1,1,4,5,-1,1,0,3,0,3,-1,2,1,0,4,1,0,-6,6,2,0,-1,1,-1,-1,-1,3,-1
KR_6764561290,420,0,-91,0,2,-3,5,2,1,3,4,-5,6,1,6,2,8,3,0,3,1,11,6,0,-5,5,-1,0,-1,1,0,1,1,1,-1
KR_6607799916,420,-1,4,-12,-5,0,0,0,1,2,3,-8,8,0,4,2,6,-2,2,0,0,-11,-159,4,-6,2,-2,0,-1,-1,1,-1,1,5,-1
KR_6695909852,420,-3,-61,-31,-11,-2,3,1,-7,9,2,1,2,3,-3,5,2,0,1,1,-3,-21,-6,1,-9,8,2,0,0,-1,1,-1,-1,1,-1
KR_6760353328,420,-1,41,2,2,-2,2,0,-1,1,0,-1,2,1,5,1,6,1,1,2,0,6,-3,1,-4,3,-3,0,-1,1,1,1,1,6,-1
KR_6726489298,440,-6,-70,-12,-7,-2,3,1,2,1,3,5,0,5,-6,7,1,-6,8,2,0,0,-2,2,-5,3,-5,0,-1,0,1,-1,1,0,-1
KR_6672707070,420,-3,6,-20,-5,-1,5,4,0,1,1,-4,4,0,-1,1,0,1,0,1,0,0,-12,-3,-4,7,-2,0,0,-1,-1,0,1,6,-1
KR_6729330177,420,-2,-30,-20,-15,-2,2,0,1,1,2,-13,15,2,1,1,2,-2,2,0,0,-7,-1,-2,-5,7,-2,0,-3,-1,-1,-1,-1,5,-1
KR_6484189178,440,-4,-101,-13,-2,-1,3,2,3,1,4,-1,4,3,-1,2,1,-2,3,1,0,4,-6,2,-9,7,-2,0,-1,-1,-1,-1,-1,6,-1
KR_6766566929,420,1,68,4,7,1,0,1,-1,2,1,7,0,7,0,4,4,0,1,1,0,-2,-76,-2,-5,7,-15,0,0,-1,1,1,1,2,-1
KR_6635202284,420,-3,-71,6,-1,-1,2,1,0,4,4,4,0,4,-4,4,0,0,0,0,0,-1,100,-4,-3,7,-1,0,0,-1,-1,-1,1,6,-1
KR_6413063761,420,3,66,9,10,4,1,5,3,1,4,5,1,6,-2,3,1,0,0,0,0,1,6,1,-5,4,-3,0,1,1,1,1,1,6,-1
KR_6758127528,420,0,-7,-2,0,0,1,1,2,1,3,-1,4,3,-2,3,1,1,1,2,0,-4,48,-5,-3,8,10,0,0,1,-1,0,1,3,-1
KR_6725979100,420,0,58,-4,-6,2,0,2,-4,4,0,-3,6,3,1,1,2,-2,4,2,-2,-10,0,3,-6,3,0,0,0,-1,-1,-1,-1,1,-1
KR_6596440700,420,-4,-25,12,-5,-1,3,2,-1,1,0,-1,2,1,-2,3,1,0,1,1,0,-1,20,-2,-3,5,0,0,-1,-1,1,-1,-1,4,-1
KR_6758419026,440,-3,-108,-1,-6,-3,5,2,2,1,3,-1,2,1,-3,3,0,-1,1,0,0,0,-11,-7,-1,8,2,0,-2,-1,1,-1,-1,6,-1
KR_6654508572,420,-4,-13,-21,-10,1,1,2,-3,4,1,-2,5,3,-3,3,0,-3,3,0,0,-12,0,2,-5,3,0,0,-1,-1,-1,-1,-1,2,-1
KR_6767871613,420,-1,50,-8,-5,-1,3,2,-4,6,2,3,1,4,-1,2,1,-2,2,0,0,-7,2,5,-8,3,-3,0,0,-1,1,0,1,2,-1
KR_6664903010,420,-1,-3,-34,-5,0,1,1,0,2,2,-1,3,2,-3,5,2,-1,2,1,0,-4,-17,0,-6,6,4,0,0,-1,-1,0,-1,5,-1
KR_6641324129,420,-1,-10,14,-8,-3,4,1,-1,4,3,-3,4,1,4,8,12,-5,6,1,0,-5,51,1,-6,5,-9,0,0,0,-1,-1,-1,0,-1
KR_6739293600,440,-5,33,24,-4,0,3,3,-4,5,1,-2,4,2,2,1,3,0,2,2,-1,-14,1,8,-9,1,-2,0,-1,-1,1,-1,-1,6,-1
KR_6754629494,420,-1,-41,-1,-6,2,1,3,-3,3,0,-1,1,0,-4,4,0,0,0,0,-1,-10,-7,-4,-3,7,-3,0,0,1,-1,0,-1,6,-1
KR_6722655636,420,-5,-69,6,-7,-2,3,1,1,3,4,-3,3,0,-4,5,1,1,1,2,0,-11,-109,1,-6,5,-1,0,-1,-1,-1,-1,1,1,-1
KR_6739960239,440,-6,-87,14,-19,-9,10,1,-4,4,0,-5,5,0,-1,2,1,0,0,0,0,-10,-54,0,-3,3,18,0,-2,-1,1,-1,-1,2,-1
KR_6095848432,420,0,-83,-10,2,0,5,5,-4,5,1,2,3,5,2,4,6,2,0,2,2,5,4,-1,-5,6,-6,0,-1,-1,1,-1,-1,5,-1
KR_6741315339,420,-1,25,-5,-4,4,0,4,0,4,4,1,0,1,-6,7,1,-3,4,1,-1,-14,320,-3,-2,5,-1,0,1,-1,1,1,1,1,-1
KR_6733203989,420,1,62,-21,4,4,0,4,-3,5,2,-2,4,2,4,0,4,1,2,3,-1,1,-1,1,-5,4,1,0,2,1,1,1,-1,1,-1
KR_6756212878,420,-2,-17,-44,-1,1,0,1,0,3,3,-7,7,0,3,2,5,2,0,2,0,-5,6,3,-7,4,5,0,0,1,0,0,-1,1,-1
KR_6739975677,420,-2,-38,1,2,-2,5,3,2,1,3,0,5,5,3,2,5,-1,1,0,0,3,-284,1,-7,6,-14,0,-1,1,-1,-1,1,6,-1
KR_6177114556,420,-4,-23,-8,-11,1,1,2,-1,3,2,-6,7,1,-4,4,0,-1,1,0,0,-5,-16,0,-4,4,-1,0,0,1,-1,-1,-1,5,-1
KR_6733416433,420,1,25,0,1,2,1,3,-6,7,1,2,2,4,1,2,3,2,1,3,0,1,-22,0,-6,6,-1,0,1,-1,-1,1,-1,2,-1
KR_6762831716,420,-7,-97,-41,-7,-1,1,0,-3,4,1,-2,2,0,-2,4,2,1,0,1,0,-5,241,2,-5,3,-1,0,0,-1,0,-1,-1,5,-1
KR_6720611251,420,-7,-159,-15,-11,-4,4,0,-7,9,2,0,2,2,-1,3,2,1,0,1,0,-13,-14,-1,-4,5,0,0,-3,1,-1,-1,1,2,-1
KR_6766802753,420,-1,-6,4,-1,0,2,2,3,0,3,2,0,2,-5,5,0,-1,3,2,1,-2,-67,-2,-2,4,24,0,-1,1,-1,-1,1,4,-1
KR_6728588889,420,-3,-77,20,-6,-3,3,0,-3,4,1,-4,6,2,1,2,3,3,0,3,-1,2,-12,-1,-3,4,-6,0,-2,-1,-1,-1,-1,4,-1
KR_6715447140,420,-6,-108,-46,-14,-1,2,1,-1,3,2,-7,8,1,-2,6,4,-3,4,1,-1,-16,-6,-2,-2,4,-1,-1,-5,0,-1,-1,-1,0,-1
KR_6760201327,420,-2,-42,-10,-8,3,1,4,-6,7,1,-5,6,1,-1,2,1,1,2,3,0,-10,-10,-5,-1,6,1,0,-1,-1,-1,-1,-1,2,-1
KR_6343582480,420,-4,-43,-16,-8,-1,4,3,1,1,2,-6,10,4,-1,1,0,-1,1,0,0,-8,0,1,-5,4,2,0,0,-1,0,0,1,2,-1
KR_6767884638,420,1,86,7,1,0,0,0,-2,2,0,1,1,2,1,1,2,1,0,1,0,1,-5,-2,-2,4,-2,0,-1,1,-1,-1,-1,6,-1
KR_6759718078,420,1,41,-3,9,-2,3,1,-2,4,2,4,0,4,8,1,9,1,0,1,1,5,6,6,-9,3,2,0,0,1,-1,-1,1,3,-1
KR_6764339554,440,-2,-21,-11,-17,-1,5,4,-2,2,0,-5,6,1,-7,9,2,-2,2,0,-1,-22,13,1,-5,4,-4,0,-1,-1,1,-1,-1,2,-1
KR_6723295074,420,-1,-12,-21,4,0,2,2,3,3,6,-2,3,1,2,0,2,1,0,1,0,6,4,0,-3,3,4,0,2,-1,1,1,1,2,-1
KR_6724015419,420,3,68,8,8,3,1,4,-3,7,4,0,2,2,5,1,6,3,2,5,0,11,-3,-3,0,3,3,0,1,1,1,1,-1,5,-1
KR_6649320019,420,1,-14,-26,-3,3,0,3,-2,3,1,-7,8,1,2,1,3,1,0,1,0,-5,3,-2,-3,5,-1,0,1,1,-1,1,1,1,-1
KR_6677950794,420,0,-54,0,4,-1,3,2,1,4,5,2,1,3,1,3,4,1,0,1,0,7,45,8,-8,0,18,0,-1,-1,-1,-1,-1,4,-1
KR_6745134958,420,1,41,12,-3,5,1,6,2,2,4,-1,2,1,-9,12,3,0,1,1,0,2,-269,7,-8,1,-2,0,0,-1,-1,-1,1,4,-1
KR_6659049723,440,5,41,-12,11,5,1,6,5,3,8,-2,2,0,5,0,5,-2,2,0,1,11,35,3,-8,5,-17,0,0,-1,-1,0,1,2,-1
KR_6727368933,420,-1,-32,26,-5,-4,4,0,3,0,3,-1,2,1,-3,4,1,0,0,0,0,-3,43,0,-5,5,-19,0,0,1,-1,1,1,6,-1
KR_6762565038,420,-2,28,-12,-2,-2,2,0,-3,4,1,-1,3,2,3,4,7,1,1,2,0,-2,-2,-4,-2,6,1,0,-1,-1,-1,-1,-1,4,-1
KR_6731563891,440,-1,-26,4,-1,1,0,1,0,0,0,0,1,1,-2,3,1,0,1,1,0,-2,0,-3,-4,7,-2,0,0,-1,1,0,-1,2,-1
KR_6761886084,420,-1,60,2,7,0,1,1,-2,2,0,0,5,5,7,1,8,2,2,4,0,11,18,5,-5,0,1,0,-1,0,1,-1,-1,0,-1
KR_6635067116,420,3,12,12,5,4,1,5,-1,3,2,0,2,2,1,0,1,1,0,1,0,6,15,1,-4,3,-2,0,-1,1,-1,-1,-1,4,-1
KR_6750265031,420,-1,17,-20,-1,3,1,4,1,2,3,-2,3,1,-4,5,1,1,0,1,1,-2,-113,0,-7,7,2,0,0,1,1,0,1,1,-1
KR_6674061137,420,-2,-32,17,-5,-3,3,0,-2,4,2,1,2,3,-2,4,2,1,0,1,0,-4,23,4,-8,4,1,0,-1,1,-1,-1,-1,6,-1
KR_6759042107,420,0,-45,-4,-2,1,0,1,-1,1,0,-1,2,1,-2,2,0,1,0,1,0,0,5,3,-6,3,-4,0,-1,-1,-1,-1,-1,3,-1
KR_6716817377,440,0,18,-21,1,4,1,5,0,4,4,-1,2,1,0,5,5,-2,3,1,1,-4,5,-4,0,4,4,0,0,1,-1,-1,1,3,-1
KR_6590048579,420,0,-11,-15,-8,0,1,1,0,0,0,-10,11,1,3,1,4,-1,4,3,-4,-7,-7,-1,-5,6,-2,0,-3,-1,-1,-1,-1,5,-1
KR_6759243517,420,0,-69,1,0,0,2,2,-1,4,3,2,3,5,1,3,4,-2,2,0,0,3,-10,-3,-2,5,3,0,-1,1,-1,-1,-1,2,-1
KR_6659707837,420,1,42,23,-2,3,0,3,-2,2,0,-1,1,0,-3,3,0,1,2,3,0,-2,-15,0,-3,3,-1,0,-1,-1,1,-1,1,6,-1
KR_6677659355,420,-2,15,-4,2,5,2,7,3,1,4,-7,8,1,2,1,3,-1,2,1,0,4,41,-3,-1,4,-12,0,0,0,1,1,1,0,-1
KR_6766643491,440,-5,-75,-56,-12,-1,2,1,-3,4,1,-2,5,3,-5,5,0,-1,1,0,0,-17,1,2,-6,4,-7,0,0,1,-1,0,-1,1,-1
KR_6679791783,420,-2,26,0,1,-1,1,0,-2,2,0,0,2,2,6,1,7,-2,3,1,0,3,28,1,-7,6,0,0,1,1,1,1,1,4,-1
KR_6627716334,420,-4,-79,-19,-6,2,0,2,-5,6,1,-1,5,4,1,0,1,-3,6,3,0,-3,9,5,-7,2,-9,0,-1,0,-1,-1,1,0,-1
KR_6384789195,420,-7,-101,-16,-16,-8,8,0,-8,9,1,2,0,2,-1,2,1,-1,3,2,0,-13,-7,2,-5,3,-12,0,-4,-1,-1,-1,-1,4,-1
KR_6185825558,440,-2,-20,-13,-3,-4,5,1,-3,3,0,-1,1,0,1,2,3,4,2,6,0,-3,-117,2,-9,7,-7,0,-1,0,-1,-1,-1,0,-1
KR_6763756960,420,-3,-104,-31,1,-2,3,1,-2,4,2,0,1,1,2,0,2,3,0,3,0,4,38,0,-4,4,-21,0,0,-1,0,0,1,6,-1
KR_6756947076,420,-1,5,4,3,0,0,0,6,1,7,1,1,2,-6,8,2,2,0,2,0,-4,-9,-3,-2,5,0,0,1,-1,1,1,1,3,-1
KR_6760219365,420,-1,-44,18,-1,0,0,0,3,2,5,-5,7,2,-1,7,6,2,1,3,0,7,-8,-2,-2,4,0,0,-1,-1,1,-1,-1,1,-1
KR_6612600079,420,2,11,12,-3,2,1,3,2,1,3,-4,5,1,-3,3,0,0,1,1,0,-6,111,2,-6,4,1,0,1,-1,1,1,-1,2,-1
KR_6761763388,440,0,24,8,-6,3,0,3,0,0,0,-6,7,1,-2,2,0,-1,2,1,0,-8,-7,-1,-4,5,-2,0,-1,-1,-1,-1,-1,5,-1
KR_6760918347,420,3,15,-17,10,1,1,2,2,3,5,2,1,3,4,4,8,1,1,2,0,11,1,-2,-4,6,1,0,-2,-1,-1,1,1,2,-1
KR_6734165461,440,-2,-154,-8,-5,-7,7,0,3,1,4,2,1,3,-6,6,0,3,0,3,0,5,-2,-2,-3,5,-4,0,-1,-1,-1,-1,-1,6,-1
KR_6673120830,420,-6,-44,-39,-14,-1,1,0,-8,8,0,-5,6,1,0,2,2,0,4,4,-1,-11,9,-2,-3,5,-5,0,-1,0,-1,-1,-1,0,-1
KR_6661792213,420,-2,-13,11,-5,-2,2,0,-3,9,6,-3,6,3,3,1,4,0,0,0,0,-6,12,4,-5,1,-3,0,1,-1,1,1,1,5,-1
KR_6703934158,420,-5,-45,-52,0,-2,3,1,1,3,4,0,0,0,1,1,2,0,1,1,1,8,-7,0,-6,6,4,0,-1,-1,-1,-1,1,2,-1
KR_6633245491,420,1,-1,26,8,-4,5,1,2,2,4,3,0,3,0,1,1,7,1,8,3,11,-4,-2,-5,7,2,0,0,-1,1,-1,1,3,-1
KR_6728395346,440,-3,46,-24,-5,0,4,4,4,0,4,-1,4,3,-4,6,2,-4,4,0,0,3,0,-3,-5,8,2,0,-1,-1,-1,-1,1,1,-1
KR_6762736125,420,-1,-40,-8,0,-2,2,0,-1,3,2,3,0,3,0,1,1,0,0,0,0,3,13,0,-3,3,3,0,-1,-1,-1,-1,1,2,-1
KR_6661463349,420,-2,28,8,-5,-2,4,2,3,3,6,-4,4,0,-3,5,2,1,0,1,0,-8,5,2,-7,5,-8,0,-1,1,-1,-1,-1,5,-1
KR_6185760445,440,1,23,-6,2,1,0,1,2,1,3,-2,3,1,1,0,1,0,0,0,0,2,-3,0,-3,3,-3,0,1,-1,1,1,1,3,-1
KR_6636173377,420,1,-31,-28,-1,1,0,1,-3,7,4,2,0,2,0,2,2,-1,1,0,0,-1,17,5,-7,2,-2,0,-1,1,-1,-1,1,3,-1
KR_6759163018,440,-4,-106,-16,-12,0,1,1,1,3,4,-3,4,1,-7,7,0,-3,3,0,0,-6,5,5,-7,2,0,0,-1,-1,0,-1,-1,5,-1
KR_6731804852,420,-3,-1,-16,-5,0,1,1,-5,5,0,-1,4,3,0,3,3,1,2,3,1,-11,-2,-3,-3,6,-3,0,0,-1,-1,0,1,1,-1
KR_6629598371,420,-1,-74,-23,-1,-4,4,0,6,1,7,-1,1,0,-2,5,3,0,0,0,0,1,-18,4,-7,3,-7,0,0,-1,-1,-1,-1,1,-1
KR_6744758186,440,1,3,9,5,4,2,6,2,4,6,-7,7,0,5,1,6,1,1,2,1,0,9,5,-7,2,-6,0,-1,-1,0,-1,1,4,-1
KR_6752137391,440,-3,-83,-24,-4,-3,3,0,-1,2,1,-3,5,2,3,5,8,0,1,1,0,4,-3,1,-3,2,2,0,-1,1,-1,-1,1,4,-1
KR_6544081814,420,-3,-69,-16,-4,-3,3,0,-1,3,2,-2,3,1,0,4,4,2,0,2,-1,-7,13,-5,-2,7,1,0,-2,-1,-1,-1,-1,1,-1
KR_6724346248,420,-1,-49,-9,-1,4,0,4,2,4,6,-3,3,0,-4,4,0,0,0,0,0,-5,-3,0,-2,2,-3,0,1,-1,1,1,-1,6,-1
KR_6716924045,420,-2,-73,-21,-9,1,3,4,-4,4,0,-3,5,2,-2,2,0,-1,1,0,0,-6,-15,-2,-3,5,-3,0,-2,0,1,-1,-1,0,-1
KR_6764451265,420,0,-12,-15,0,-4,6,2,-4,4,0,-1,4,3,5,1,6,4,1,5,-1,9,6,-3,-1,4,2,0,-1,0,-1,-1,-1,0,-1
KR_6752879538,420,-2,-24,-5,-5,-3,6,3,4,1,5,-5,6,1,0,1,1,-1,1,0,-1,7,2,-1,-4,5,-3,0,-1,1,-1,-1,-1,3,-1
KR_6748888172,440,-1,3,-4,-4,2,3,5,0,1,1,-2,3,1,-3,3,0,-1,1,0,0,-4,96,1,-6,5,-4,0,0,-1,1,0,1,2,-1
KR_6745374788,420,-1,-24,4,-2,3,1,4,-2,4,2,-4,5,1,2,5,7,-1,3,2,2,2,-2,-1,0,1,-2,0,-1,-1,1,-1,1,6,-1
KR_6561308010,420,-5,-49,8,-9,-1,3,2,-4,4,0,-5,7,2,0,3,3,1,1,2,1,-13,-26,-3,-4,7,-1,0,-1,1,1,-1,1,5,-1
KR_6762530079,420,-2,-40,0,-5,2,1,3,-1,1,0,-4,5,1,-2,2,0,0,0,0,-1,-8,-4,-1,-4,5,-2,0,0,-1,1,0,-1,3,-1
KR_6755405791,420,-5,-54,-24,-8,-6,6,0,1,3,4,-2,3,1,-2,4,2,1,0,1,0,2,-258,5,-6,1,1,0,0,-1,-1,0,-1,4,-1
KR_6761579432,440,-4,-95,15,-2,5,0,5,1,1,2,-1,3,2,-3,4,1,-4,4,0,0,2,5,1,-5,4,2,0,-1,-1,1,-1,1,4,-1
KR_6606003566,420,-8,-120,14,-15,-4,4,0,-1,6,5,-5,6,1,-3,4,1,-2,2,0,0,-14,-58,-1,-3,4,-1,0,-2,1,-1,-1,-1,1,-1
KR_6713114774,420,1,17,6,-3,-2,5,3,3,0,3,-1,2,1,-2,3,1,-1,2,1,0,4,6,5,-8,3,-4,0,-1,1,-1,-1,-1,4,-1
KR_6664448979,420,-2,-18,-12,-7,-3,4,1,-1,3,2,1,0,1,-4,4,0,0,3,3,0,-5,0,1,-8,7,-6,0,0,-1,1,-1,-1,4,-1
KR_6688271423,420,-2,-18,-20,-3,5,4,9,1,0,1,-4,4,0,-3,4,1,-2,4,2,-1,-4,-6,-5,0,5,-2,0,-1,1,-1,-1,-1,3,-1
KR_6761911600,420,1,2,37,0,1,1,2,4,0,4,-2,2,0,0,3,3,-3,4,1,0,4,5,6,-7,1,-5,0,-1,-1,1,-1,1,6,-1
KR_6764491734,440,-1,-10,0,-2,0,2,2,-2,2,0,-1,3,2,-1,1,0,2,0,2,0,-1,-19,-2,0,2,0,0,0,0,1,0,-1,0,-1
KR_6731311659,440,-1,9,16,-4,3,0,3,-3,4,1,1,3,4,-4,4,0,-1,2,1,-1,-8,-1,1,-3,2,2,0,-1,1,-1,-1,-1,6,-1
KR_6721819781,420,-5,-96,-36,-14,-4,4,0,-4,4,0,-4,4,0,-4,6,2,2,0,2,0,-11,-14,-6,-5,11,2,0,-2,1,-1,-1,-1,3,-1
KR_6753198475,420,-2,52,-59,-5,2,1,3,-2,2,0,-2,3,1,-4,6,2,1,2,3,0,-2,-5,0,-4,4,0,0,-1,-1,-1,-1,-1,6,-1
KR_6754700855,420,-6,-15,-16,-10,-3,3,0,-1,4,3,-5,5,0,-1,4,3,0,1,1,0,-4,25,3,-3,0,-10,0,-1,-1,-1,-1,1,1,-1
KR_6689417728,420,-4,-23,-24,-14,0,2,2,-2,2,0,-5,6,1,-5,6,1,-2,2,0,0,-17,-1,0,-4,4,2,0,-1,1,-1,-1,-1,4,-1
KR_6627273582,420,3,-16,10,8,-3,3,0,2,2,4,1,2,3,4,0,4,4,2,6,0,8,20,1,-4,3,2,0,2,1,1,1,1,6,-1
KR_6736463223,420,1,-21,-16,7,3,1,4,0,1,1,2,4,6,0,2,2,2,0,2,1,12,-35,4,-9,5,12,0,-2,1,-1,-1,1,5,-1
KR_6766972614,420,-2,-6,-16,-3,1,0,1,0,2,2,-3,4,1,-2,3,1,1,1,2,0,-6,115,-6,-1,7,-6,0,0,-1,1,0,-1,5,-1
KR_6742447743,440,-1,-16,-8,-2,0,1,1,-3,4,1,-1,1,0,0,2,2,2,0,2,-1,-9,3,0,-5,5,1,0,0,-1,1,0,-1,4,-1
KR_6721082075,440,0,-3,-28,3,2,2,4,3,3,6,-2,5,3,0,3,3,0,0,0,-1,7,0,0,-6,6,2,0,1,-1,-1,1,-1,1,-1
KR_6763643145,420,-2,-95,-1,0,2,0,2,3,1,4,-5,10,5,0,4,4,0,3,3,0,3,44,1,-3,2,-2,0,0,1,1,0,1,3,-1
KR_6680606488,420,2,-4,-4,5,1,1,2,5,4,9,2,0,2,-5,8,3,2,1,3,1,7,29,1,-5,4,-2,0,0,-1,1,0,-1,2,-1
KR_6701569847,420,-6,-53,-29,-11,0,1,1,-1,2,1,-2,3,1,-6,6,0,-2,4,2,-1,-9,-38,-2,-2,4,0,0,0,-1,-1,0,-1,2,-1
KR_6719131920,440,1,20,8,-3,3,0,3,-5,5,0,4,2,6,0,0,0,-5,6,1,0,-11,3,0,-5,5,0,0,-1,1,-1,-1,1,4,-1
KR_6732294155,420,4,-56,16,5,-5,6,1,-3,3,0,3,0,3,5,0,5,5,0,5,0,4,-10,-1,-5,6,1,0,-1,1,-1,-1,-1,4,-1
KR_6581290518,420,-1,18,40,0,1,2,3,0,1,1,6,2,8,-6,6,0,-1,2,1,1,-12,-2,2,-5,3,2,0,0,1,1,1,1,1,-1
KR_6732860519,420,-1,-20,2,-4,-4,6,2,-2,3,1,-3,5,2,3,0,3,2,2,4,0,2,6,6,-8,2,1,0,0,-1,-1,-1,-1,2,-1
KR_6738687538,420,3,-14,44,5,5,0,5,2,2,4,4,3,7,-6,9,3,0,1,1,0,8,-74,-4,-2,6,27,0,0,1,-1,0,-1,5,-1
KR_6755827352,420,-5,-80,-24,-2,1,0,1,0,3,3,-6,12,6,4,0,4,-1,1,0,0,4,12,0,-4,4,0,0,-1,-1,0,-1,1,3,-1
KR_6759078409,420,-8,-164,-45,-9,1,1,2,0,2,2,-4,4,0,-7,9,2,1,2,3,-2,-7,-9,-3,-2,5,0,0,-3,-1,-1,-1,-1,1,-1
KR_6757446882,440,3,53,16,2,1,0,1,-1,4,3,1,0,1,-1,3,2,2,1,3,-1,-6,-21,-2,-3,5,3,0,0,1,1,0,-1,5,-1
KR_6766934828,440,-2,44,2,-8,0,2,2,-2,4,2,-5,6,1,-2,3,1,1,1,2,0,-10,-21,-4,-5,9,3,0,0,1,-1,1,-1,5,-1
KR_6525169804,420,2,42,16,5,1,1,2,1,5,6,-2,3,1,3,2,5,2,0,2,1,11,-10,-3,-2,5,-2,0,2,-1,1,1,1,5,-1
KR_6733915020,440,-1,-37,20,-2,-4,4,0,-1,1,0,2,2,4,-1,1,0,2,0,2,0,-6,-5,0,-5,5,-2,0,1,1,-1,1,1,1,-1
KR_6746431747,420,2,28,21,6,1,2,3,-2,6,4,4,2,6,7,4,11,-4,5,1,0,11,0,2,-6,4,4,0,0,0,0,0,1,0,-1
KR_6685974840,420,0,-25,-12,5,0,2,2,2,0,2,2,0,2,2,1,3,-1,1,0,-1,3,-7,-2,-2,4,3,0,0,-1,1,0,-1,3,-1
KR_6745505371,420,-3,-7,-6,-7,0,1,1,-1,3,2,0,0,0,-4,5,1,-2,3,1,-1,-9,-7,-4,-3,7,0,0,0,-1,-1,0,-1,5,-1
KR_6682123516,440,-1,55,0,10,-5,7,2,3,1,4,7,0,7,6,0,6,-1,1,0,0,6,-2,2,-3,1,1,0,1,-1,1,1,1,2,-1
KR_6748076196,420,5,83,8,6,0,3,3,1,0,1,-1,2,1,3,0,3,3,0,3,0,6,1,-2,-1,3,-1,0,1,1,0,1,1,2,-1
KR_6704756120,420,0,-22,12,1,0,1,1,1,2,3,-1,4,3,2,4,6,-1,2,1,0,-1,-15,-1,-2,3,-1,0,0,-1,0,0,-1,2,-1
KR_6761573168,420,-4,-28,0,-13,-5,5,0,-4,8,4,-1,2,1,-4,5,1,1,0,1,1,-10,-7,1,-7,6,0,0,1,1,0,1,1,4,-1
KR_6759718454,440,1,76,10,0,-1,4,3,1,2,3,-5,8,3,4,1,5,1,3,4,0,-6,0,-4,-1,5,-2,0,0,-1,1,0,1,2,-1
KR_6705431145,440,3,44,-21,5,2,2,4,-1,5,4,-2,5,3,5,0,5,1,0,1,-2,-6,-6,-5,-5,10,4,0,2,-1,1,1,-1,3,-1
KR_6761105781,420,0,1,6,3,3,0,3,4,1,5,-3,4,1,0,2,2,-1,1,0,0,-2,3,0,-4,4,1,0,0,1,0,0,1,4,-1
KR_6658472906,420,-4,-37,-21,-5,-2,2,0,-1,3,2,-5,5,0,5,1,6,-2,3,1,1,4,-4,-1,-5,6,-2,0,-2,1,-1,-1,1,2,-1
KR_6741351179,420,1,-34,20,3,1,0,1,2,0,2,-1,2,1,1,2,3,0,1,1,0,6,4,8,-9,1,2,0,0,0,0,0,-1,0,-1
KR_6765196340,420,1,34,-16,3,2,1,3,1,3,4,0,4,4,-1,3,2,1,1,2,0,3,-5,3,-5,2,1,0,-1,-1,0,1,1,2,-1
KR_6763377443,440,-2,14,-17,-4,1,1,2,4,4,8,-4,4,0,-6,9,3,1,1,2,1,0,-16,7,-11,4,3,0,0,-1,-1,0,1,3,-1
KR_6694153464,420,-6,-111,10,-5,-2,2,0,-2,4,2,1,1,2,-3,3,0,1,0,1,0,-5,14,1,-5,4,-2,0,-1,-1,0,-1,-1,6,-1
KR_6716330041,420,1,37,19,-7,-2,2,0,2,1,3,0,1,1,-6,7,1,-1,2,1,0,-6,1,2,-5,3,2,0,0,1,-1,1,-1,4,-1
KR_6745232014,420,-1,-6,-27,0,-3,3,0,1,4,5,-1,2,1,4,6,10,-1,1,0,0,5,-3,0,-8,8,-1,0,0,1,1,-1,-1,2,-1
KR_6759812353,440,-3,-48,4,-3,-3,4,1,0,2,2,3,2,5,-3,5,2,0,2,2,0,-4,-10,-1,-1,2,-1,0,-1,-1,0,-1,1,2,-1
KR_6679846594,420,-2,-80,8,1,-4,4,0,5,2,7,-1,2,1,0,1,1,1,0,1,0,4,-5,-5,-1,6,0,0,-2,1,-1,-1,1,1,-1
KR_6732943928,420,-2,-55,-43,1,0,1,1,-3,4,1,2,1,3,2,1,3,0,1,1,0,7,-43,-2,-2,4,13,0,-1,-1,-1,-1,-1,3,-1
KR_6716950190,420,1,43,-14,6,1,1,2,-3,8,5,2,2,4,2,1,3,4,0,4,0,4,12,5,-7,2,0,0,0,0,1,1,1,0,-1
KR_6766857995,420,-1,23,-20,-4,-4,7,3,-2,5,3,-2,2,0,2,1,3,2,1,3,0,-6,180,0,-4,4,16,0,-1,1,-1,-1,1,5,-1
KR_6761520472,440,3,54,34,10,2,1,3,-3,3,0,5,1,6,3,4,7,3,0,3,1,15,9,1,-3,2,-3,0,1,1,1,1,1,4,-1
KR_6762619689,420,-4,-30,-13,-16,-2,3,1,-4,4,0,-2,4,2,-6,6,0,-2,3,1,0,-11,9,2,-7,5,-7,0,-2,-1,1,-1,-1,4,-1
KR_6766652412,420,4,-14,64,4,-1,1,0,2,1,3,7,0,7,-4,4,0,0,0,0,0,-1,14,-1,-3,4,-3,0,1,-1,1,1,1,2,-1
KR_6757868075,420,-1,10,9,-4,-1,3,2,-2,4,2,-2,5,3,0,2,2,1,0,1,0,-9,-14,-3,-1,4,4,0,0,1,1,1,1,2,-1
KR_6757318430,420,-2,-7,-12,-2,0,0,0,5,2,7,-2,5,3,-4,5,1,-1,1,0,0,-8,-3,4,-9,5,-2,0,-1,-1,0,-1,-1,5,-1
KR_6706325786,420,-3,18,-4,-7,0,1,1,-2,7,5,0,2,2,-2,4,2,-3,3,0,0,-12,34,-3,-3,6,-19,0,0,-1,1,1,-1,4,-1
KR_6763557415,440,2,-84,20,6,-2,4,2,3,1,4,0,1,1,1,1,2,4,1,5,0,9,2,3,-8,5,-1,0,0,-1,0,0,-1,2,-1
KR_6505784395,420,-1,-43,12,-1,-2,2,0,-2,5,3,3,0,3,0,2,2,0,0,0,0,0,10,0,-2,2,-1,0,0,-1,0,-1,-1,2,-1
KR_6722064704,420,-3,-1,-8,-11,3,0,3,-2,3,1,-1,4,3,-7,8,1,-4,4,0,0,-14,-16,-2,0,2,-2,0,0,-1,1,-1,-1,1,-1
KR_6707107625,420,-1,-49,8,-1,5,1,6,-1,4,3,-4,5,1,-2,2,0,1,0,1,0,-3,-4,-1,-3,4,4,0,0,0,1,0,-1,0,-1
KR_6754821494,420,-3,-26,-20,-4,-1,2,1,0,4,4,-1,3,2,-1,2,1,-1,2,1,0,-1,-3,-4,0,4,4,0,-1,-1,-1,-1,-1,4,-1
KR_6765097571,420,0,-56,12,0,-6,7,1,0,2,2,-2,2,0,3,1,4,5,0,5,0,11,-1,-2,-4,6,0,0,0,-1,-1,-1,1,2,-1
KR_6744929787,420,-2,-26,-12,-5,1,0,1,-1,3,2,1,0,1,-4,4,0,-2,2,0,0,-7,8,6,-7,1,-8,0,-1,-1,0,-1,-1,4,-1
KR_6693138173,420,-4,-84,-4,-5,-3,4,1,-4,5,1,2,0,2,0,3,3,0,0,0,0,-6,-5,-7,-1,8,2,0,0,-1,1,-1,1,3,-1
KR_6594908458,420,-2,-88,0,-6,-9,10,1,4,0,4,-1,3,2,-3,3,0,3,0,3,0,-3,-24,0,-5,5,22,0,-2,-1,-1,-1,-1,5,-1
KR_6744126989,420,3,36,0,5,4,1,5,-3,5,2,0,4,4,6,0,6,-2,2,0,0,3,1,1,-6,5,2,0,1,1,-1,1,1,5,-1
KR_6506945611,420,-2,14,-32,3,-1,4,3,0,1,1,3,1,4,2,1,3,-1,1,0,0,8,-36,-1,-5,6,19,0,0,0,-1,-1,-1,0,-1
KR_6735485819,420,-2,-60,-15,-6,0,0,0,1,1,2,-2,6,4,-3,4,1,-2,2,0,0,-4,-11,-5,-2,7,2,0,-1,-1,-1,-1,-1,3,-1
KR_6679539868,420,-1,-89,-10,-4,-2,2,0,-2,4,2,1,3,4,-2,4,2,1,1,2,-4,-8,0,-1,-2,3,-1,0,-1,1,-1,-1,-1,4,-1
KR_6598124488,420,-1,44,0,-4,4,1,5,-5,6,1,1,1,2,-1,6,5,-3,3,0,0,-4,1,3,-6,3,2,0,1,-1,1,1,1,4,-1
KR_6624589465,440,-1,-24,12,-4,1,1,2,1,3,4,-3,6,3,0,2,2,-3,5,2,0,-6,-2,4,-5,1,-1,0,1,-1,-1,-1,-1,3,-1
KR_6754475803,420,2,-54,11,1,-2,3,1,0,3,3,-1,2,1,4,0,4,0,0,0,0,1,13,2,-5,3,-4,0,0,1,-1,0,1,2,-1
KR_6660981297,440,-1,-30,4,-6,0,0,0,-3,3,0,-1,2,1,-4,5,1,2,1,3,0,-3,0,-3,-2,5,-1,0,0,-1,0,0,-1,6,-1
KR_6758906823,420,-4,-79,-12,4,1,1,2,0,3,3,-1,4,3,6,2,8,-2,4,2,-1,4,-3,-2,-2,4,1,0,0,-1,-1,-1,-1,4,-1
KR_6766607945,440,0,-25,-12,2,0,0,0,-1,2,1,4,0,4,-1,3,2,0,2,2,0,-1,-1,4,-5,1,-1,0,-1,-1,1,-1,1,4,-1
KR_6444042306,420,-2,-59,-16,-6,-1,1,0,1,2,3,0,1,1,-6,7,1,0,1,1,-3,-10,-20,1,-5,4,0,0,0,-1,-1,0,-1,6,-1
KR_6763444556,420,2,-19,12,9,3,0,3,1,1,2,-1,2,1,7,2,9,-1,1,0,0,6,-10,-1,-3,4,0,0,0,-1,0,0,1,1,-1
KR_6766719458,420,0,19,0,-3,-2,4,2,0,3,3,1,0,1,-2,4,2,0,0,0,0,-5,-7,0,-2,2,1,0,1,-1,-1,1,-1,6,-1
KR_6762321455,420,-2,-19,8,-3,2,0,2,0,3,3,-4,6,2,0,4,4,-1,2,1,0,-2,-2,1,-4,3,-1,0,1,-1,1,1,-1,2,-1
KR_6762932556,420,-2,-21,-12,-6,-3,5,2,-7,8,1,5,1,6,-4,4,0,3,0,3,0,-4,0,-2,-3,5,0,0,0,0,-1,-1,-1,0,-1
KR_6750350717,420,-2,-7,-4,-5,2,0,2,-2,3,1,0,1,1,-3,3,0,-2,2,0,0,-6,-2,0,-3,3,-3,0,-1,-1,1,-1,-1,1,-1
KR_6751437497,420,-2,-7,-20,-3,-2,4,2,-2,5,3,-4,5,1,4,3,7,1,0,1,0,-3,3,-1,-3,4,-1,0,0,1,1,1,-1,4,-1
KR_6719779021,420,-4,-8,-3,-8,-2,2,0,-2,6,4,-2,3,1,-2,6,4,0,0,0,2,-2,-11,0,-4,4,-1,0,-1,-1,1,-1,-1,3,-1
KR_6763320252,420,-3,-85,-11,-9,-3,3,0,-1,1,0,-1,1,0,-4,4,0,0,2,2,0,-10,-22,1,-4,3,1,0,-1,1,-1,-1,-1,2,-1
KR_6739262049,420,1,-27,-8,1,4,0,4,1,1,2,-3,3,0,-1,1,0,0,1,1,0,-2,-46,0,-4,4,34,0,0,-1,1,0,-1,3,-1
KR_6745260583,420,1,8,-8,-4,4,2,6,0,1,1,-3,4,1,-3,4,1,-2,2,0,-2,-6,6,3,-5,2,-4,0,0,-1,1,0,-1,4,-1
KR_6752264749,420,-1,-14,2,1,2,2,4,5,0,5,-1,4,3,-2,2,0,-3,5,2,-1,-1,47,7,-13,6,-6,0,0,-1,1,0,-1,3,-1
KR_6763627228,440,-2,-32,4,-4,-1,3,2,4,2,6,1,3,4,-3,7,4,-5,5,0,-1,-11,3,0,-6,6,-1,0,0,-1,1,0,-1,6,-1
KR_6752716498,420,0,-11,9,1,0,3,3,1,0,1,2,0,2,-1,1,0,-1,1,0,0,-1,28,3,-4,1,-13,0,0,1,1,0,1,4,-1
KR_6755457534,420,1,-38,31,-3,-3,3,0,-2,7,5,2,1,3,-4,5,1,4,1,5,0,-9,-16,2,-6,4,-4,0,1,1,1,1,1,4,-1
KR_6634984862,420,0,29,-21,1,2,0,2,-6,9,3,1,2,3,4,0,4,0,0,0,0,-2,-31,-2,-5,7,6,0,-1,1,-1,-1,1,3,-1
KR_6709748284,420,-2,-98,-16,-1,-3,4,1,5,1,6,2,3,5,-4,6,2,-1,1,0,-1,1,-5,-1,-2,3,-4,0,0,-1,1,-1,-1,3,-1
KR_6748728890,420,0,-8,-13,4,1,2,3,1,3,4,6,3,9,-2,5,3,-2,3,1,0,3,1,2,-5,3,1,0,1,0,1,1,1,0,-1
KR_6481181036,420,1,25,4,3,3,2,5,2,3,5,1,1,2,-3,4,1,0,0,0,2,11,1,4,-5,1,-2,0,-1,0,-1,-1,1,0,-1
KR_6768000428,420,-4,-48,15,-4,-2,4,2,-1,3,2,-1,3,2,1,3,4,-1,2,1,0,-2,-46,-2,-5,7,23,0,0,1,-1,0,1,1,-1
KR_6673520053,420,0,7,-7,1,-2,2,0,0,5,5,0,0,0,2,0,2,1,2,3,0,3,4,-1,-3,4,-5,0,0,1,-1,0,1,2,-1
KR_6658590157,420,-4,-56,-24,-9,-1,3,2,0,1,1,-3,3,0,-2,4,2,-3,3,0,0,-8,73,4,-5,1,-3,0,-1,-1,1,-1,-1,4,-1
KR_6708741779,440,0,-7,-20,1,3,1,4,-2,4,2,1,0,1,1,0,1,-2,2,0,0,1,-185,4,-6,2,3,0,0,0,1,0,-1,0,-1
KR_6767509803,420,1,-40,-5,-2,0,2,2,-3,3,0,3,1,4,-2,3,1,0,0,0,0,-5,-2,-2,-6,8,-4,0,0,1,0,0,1,2,-1
KR_6652640322,420,-6,-72,-21,-12,-2,4,2,-6,6,0,-6,6,0,3,2,5,-1,1,0,0,-2,-7,-2,-2,4,2,0,-2,-1,-1,-1,-1,2,-1
KR_6759668186,420,3,0,12,10,4,1,5,5,3,8,6,1,7,-4,4,0,-1,2,1,0,2,2,1,-3,2,-1,0,0,1,1,-1,-1,2,-1
KR_6526495090,420,-2,-79,-30,-3,0,2,2,-6,6,0,0,5,5,0,2,2,3,3,6,0,8,2,1,-3,2,-1,0,0,-1,-1,-1,-1,2,-1
KR_6764634543,440,-4,-77,-16,-12,1,0,1,-4,4,0,-6,8,2,-3,4,1,0,1,1,-1,-7,405,-2,-1,3,-1,0,-1,0,-1,-1,-1,0,-1
KR_6463194534,420,-1,-25,-5,-10,4,0,4,-2,3,1,-8,10,2,0,0,0,-4,4,0,0,-10,13,2,-6,4,-4,0,-1,-1,1,1,-1,3,-1
KR_6766034119,420,-1,16,4,-5,-2,3,1,-2,2,0,-4,5,1,0,5,5,3,0,3,0,-5,-100,0,-4,4,-5,0,1,-1,-1,1,-1,2,-1
KR_6767907905,420,-4,-82,-9,-2,-4,4,0,0,4,4,0,2,2,2,1,3,0,1,1,-1,8,8,4,-7,3,-4,0,0,1,-1,1,-1,4,-1
KR_6713528481,420,-2,-67,-13,-2,-3,3,0,-4,4,0,2,0,2,0,3,3,3,4,7,0,-4,22,-3,-6,9,-13,0,0,1,0,0,1,6,-1
KR_6758218997,440,-2,8,4,-5,-2,2,0,-2,3,1,-4,5,1,1,1,2,2,0,2,0,-4,3,1,-7,6,-6,0,0,-1,-1,0,-1,3,-1
KR_6761426959,440,-6,-63,3,-16,-1,1,0,-1,3,2,-1,1,0,-7,8,1,-6,7,1,0,-13,1,6,-7,1,-2,0,-1,-1,-1,-1,-1,5,-1
KR_6672539387,420,-4,-24,-4,-17,-5,6,1,-10,10,0,-2,4,2,1,1,2,-1,1,0,0,-16,-4,1,-5,4,4,0,0,1,-1,0,-1,3,-1
KR_6742181310,420,-2,66,-51,-4,2,2,4,1,0,1,2,3,5,-6,6,0,-3,6,3,-1,-4,42,4,-5,1,-4,0,0,-1,0,-1,-1,5,-1
KR_6741627262,420,1,16,-3,-1,0,1,1,1,2,3,-1,2,1,-1,2,1,0,0,0,0,3,-9,-3,-4,7,2,0,0,1,-1,0,1,6,-1
KR_6653283194,420,-4,-73,-19,-5,-1,1,0,-1,1,0,-7,10,3,3,4,7,1,0,1,0,5,-1,-3,-2,5,-3,0,-2,1,-1,-1,1,1,-1
KR_6763736059,420,3,30,12,5,-1,1,0,2,1,3,2,2,4,2,0,2,0,0,0,0,4,-118,4,-6,2,-1,0,0,0,1,-1,1,0,-1
KR_6590017331,420,1,-23,-12,2,-3,3,0,2,1,3,-2,4,2,4,2,6,1,0,1,1,6,247,2,-7,5,-1,0,-1,0,1,-1,1,0,-1
KR_6761545825,420,0,-21,24,-9,-5,5,0,2,2,4,-3,7,4,-3,4,1,0,2,2,0,-6,-4,-4,-2,6,3,0,0,1,0,-1,-1,4,-1
KR_6697960047,440,-3,4,-12,-7,-1,2,1,0,1,1,-2,4,2,-1,1,0,-3,6,3,0,-6,27,0,-5,5,-12,0,0,-1,1,0,1,1,-1
KR_6631436182,420,-2,-45,7,-5,-5,7,2,0,1,1,-1,3,2,1,3,4,0,1,1,0,-10,41,-5,-2,7,-21,0,2,1,-1,1,-1,5,-1
KR_6693098384,420,0,33,-22,-2,-3,4,1,1,4,5,-1,3,2,0,0,0,1,0,1,0,4,-4,-4,-1,5,-1,0,-1,-1,-1,-1,-1,4,-1
KR_6759574211,420,1,41,-41,4,1,0,1,1,3,4,-1,3,2,2,1,3,1,1,2,0,-2,2,-1,-5,6,-3,0,1,-1,-1,1,1,4,-1
KR_6737599348,440,1,15,-6,1,-4,6,2,0,3,3,3,3,6,4,2,6,-2,2,0,0,-9,7,-2,-4,6,-4,0,-1,-1,1,-1,1,1,-1
KR_6728538207,440,0,-30,-24,-4,3,1,4,3,0,3,-4,5,1,-4,4,0,-2,2,0,0,-8,-9,-4,-3,7,-4,0,0,-1,0,-1,-1,3,-1
KR_6555407351,420,-6,-57,-50,-5,-2,2,0,3,2,5,-2,4,2,-1,2,1,-3,3,0,-1,-3,11,-1,-3,4,1,0,-1,-1,-1,-1,-1,5,-1
KR_6762447511,420,-5,-30,-23,-11,-6,6,0,-1,2,1,-3,3,0,-1,7,6,0,0,0,0,-7,-34,4,-6,2,19,0,-2,1,-1,-1,1,5,-1
KR_6760988761,420,-2,80,9,-4,-1,4,3,-1,2,1,1,3,4,-4,6,2,1,4,5,-1,-12,-10,0,-4,4,4,0,-1,-1,-1,-1,-1,5,-1
KR_6759471127,440,-1,-29,19,-14,-1,5,4,-4,4,0,0,2,2,-6,6,0,-3,6,3,-1,-11,2,-3,0,3,1,0,-2,-1,-1,-1,-1,3,-1
KR_6679750571,420,-5,-45,5,-4,1,1,2,-2,4,2,-4,7,3,-3,6,3,4,1,5,-2,-10,-39,-1,-2,3,-1,0,-2,-1,-1,-1,-1,5,-1
KR_6709861326,420,-5,-93,0,-13,-9,11,2,1,1,2,-2,6,4,-3,4,1,0,1,1,-2,-9,16,-2,-3,5,-2,0,-3,1,-1,-1,-1,4,-1
KR_6747212508,420,-5,-56,-20,-8,-3,3,0,2,0,2,0,1,1,-4,4,0,-3,4,1,0,-8,11,0,-6,6,-2,0,0,-1,-1,0,-1,1,-1
KR_6737629465,440,-4,-57,-34,1,0,2,2,3,1,4,-1,3,2,-1,3,2,0,1,1,0,10,-1,4,-5,1,1,0,0,1,0,0,1,5,-1
KR_6652903740,420,2,3,8,8,-2,3,1,6,1,7,-2,4,2,4,1,5,2,1,3,0,15,9,0,-2,2,2,0,-1,-1,-1,1,-1,1,-1
KR_6712499471,420,-4,11,16,-4,0,0,0,-3,6,3,-4,5,1,3,1,4,0,0,0,0,-6,21,0,-5,5,-1,0,0,-1,-1,-1,1,6,-1
KR_6758242476,420,-2,29,7,-13,-3,5,2,-3,4,1,0,3,3,-6,7,1,-1,1,0,0,-16,3,-5,-1,6,-4,0,1,-1,1,1,-1,3,-1
KR_6754719657,420,-3,-87,-44,-4,-6,7,1,-7,7,0,3,0,3,4,0,4,2,0,2,0,4,-44,0,-3,3,6,0,-3,-1,-1,-1,-1,2,-1
KR_6765235416,420,2,31,4,-4,4,1,5,-4,5,1,-2,2,0,-2,3,1,0,2,2,0,-3,12,4,-5,1,-2,0,2,1,1,1,-1,5,-1
KR_6751322182,420,-2,-91,6,-5,0,0,0,2,0,2,-2,4,2,-4,5,1,-1,2,1,0,-5,29,-3,-3,6,-3,0,0,0,-1,0,1,0,-1
KR_6714058094,420,-3,7,-31,-9,-1,3,2,-4,4,0,-3,4,1,-1,4,3,0,0,0,0,-8,2,-1,-1,2,-3,0,-1,-1,0,-1,-1,5,-1
KR_6758937654,420,3,53,54,-3,3,0,3,0,2,2,-3,4,1,-4,4,0,1,0,1,0,-2,26,3,-5,2,-2,0,0,-1,-1,1,-1,3,-1
KR_6657912854,420,-4,-14,-27,-17,-1,1,0,-10,11,1,-4,4,0,-3,5,2,1,0,1,1,-22,-2,-4,-2,6,3,0,-1,-1,-1,-1,1,5,-1
KR_6747331112,420,-4,-6,-6,-6,0,2,2,-9,9,0,6,0,6,-1,2,1,-2,2,0,0,-10,18,2,-5,3,-2,0,-1,-1,-1,-1,1,1,-1
KR_6741780353,420,2,5,11,0,0,3,3,0,2,2,-1,2,1,0,3,3,1,0,1,-2,-3,-3,-1,-3,4,-6,0,0,-1,-1,0,-1,3,-1
KR_6763501885,440,2,8,-11,3,6,0,6,-1,3,2,-1,2,1,-3,5,2,2,0,2,2,5,3,1,-6,5,0,0,1,1,1,1,1,5,-1
KR_6593199531,420,-6,-78,-16,-12,-1,1,0,-2,3,1,-2,3,1,-2,5,3,-5,5,0,0,-18,9,-3,-2,5,-3,0,-1,-1,-1,-1,-1,4,-1
KR_6747325217,420,-4,-42,-17,-9,1,1,2,-3,4,1,0,2,2,-7,9,2,0,0,0,0,-10,7,-2,-3,5,-5,0,0,-1,-1,-1,-1,3,-1
KR_6757564519,440,-7,-56,-10,-8,-3,4,1,-7,8,1,0,2,2,1,3,4,1,3,4,1,-7,-8,-3,-1,4,-1,0,-3,0,-1,-1,1,0,-1
KR_6505626588,420,-4,-59,16,-6,1,2,3,1,1,2,0,4,4,-5,6,1,-3,3,0,0,-7,2,-2,-4,6,-6,0,-1,1,-1,-1,1,5,-1
KR_6722074085,420,-1,-39,18,-4,-1,3,2,-3,6,3,-1,4,3,2,3,5,-1,1,0,0,-12,-3,1,-6,5,-1,0,0,1,1,0,1,3,-1
KR_6764750480,420,-1,-56,28,0,-4,4,0,5,2,7,-1,1,0,0,4,4,0,3,3,0,8,13,1,-3,2,-16,0,-1,1,-1,-1,-1,2,-1
KR_6758182312,420,-1,-43,0,-5,-6,7,1,-2,3,1,-1,3,2,4,1,5,0,0,0,0,2,5,3,-6,3,-3,0,-1,-1,1,-1,-1,3,-1
KR_6755444820,420,-2,-37,-30,-2,-2,5,3,0,1,1,3,4,7,1,1,2,-4,6,2,0,4,4,6,-9,3,6,0,-2,-1,1,-1,1,4,-1
KR_6653350357,420,1,-28,28,-5,1,0,1,-2,5,3,0,1,1,-3,4,1,-1,1,0,0,-13,97,1,-5,4,1,0,-1,1,0,-1,-1,1,-1
KR_6482467685,420,-4,-77,-4,-5,-1,2,1,1,2,3,-5,7,2,0,1,1,0,1,1,0,-4,-6,2,-3,1,-1,0,-1,-1,0,-1,1,5,-1
KR_6748522406,420,-4,-103,-40,-2,3,2,5,1,0,1,1,0,1,-6,7,1,-1,3,2,0,-6,-5,0,-3,3,-3,0,-3,1,-1,-1,-1,2,-1
KR_6672920087,420,-4,-18,-30,-11,-7,9,2,-1,5,4,-3,6,3,0,1,1,0,1,1,-1,0,16,5,-9,4,-1,0,-2,1,-1,-1,-1,5,-1
KR_6759938132,420,-3,-37,-44,-7,-2,4,2,2,1,3,-3,4,1,-2,3,1,-2,6,4,0,1,-341,3,-6,3,-2,0,0,-1,-1,-1,-1,3,-1
KR_6744859924,420,-1,4,28,1,-2,3,1,-5,6,1,2,2,4,4,2,6,2,2,4,0,-1,-22,1,-6,5,-1,0,0,1,1,0,1,1,-1
KR_6705682694,420,0,10,-16,4,-1,2,1,4,2,6,-2,3,1,-1,4,3,4,0,4,0,8,-6,-3,-2,5,7,0,0,1,1,0,-1,2,-1
KR_6704421759,420,-2,4,0,-9,1,1,2,-4,6,2,-5,7,2,-1,3,2,0,2,2,-1,-17,-1,1,-6,5,-1,0,0,0,-1,0,-1,0,-1
KR_6765391859,420,1,15,0,8,6,1,7,0,2,2,0,6,6,3,3,6,-1,2,1,1,3,-1,7,-8,1,-4,0,1,0,1,1,1,0,-1
KR_6753608294,420,-2,-2,-31,-4,1,0,1,0,1,1,-3,4,1,0,3,3,-2,3,1,1,2,-186,-3,-2,5,-4,0,0,-1,-1,0,1,3,-1
KR_6660908305,420,2,87,2,1,7,0,7,-3,4,1,0,3,3,1,3,4,-4,4,0,1,-10,-13,0,-8,8,-4,0,1,1,1,1,1,1,-1
KR_6723088117,420,-2,-76,19,-9,-6,6,0,2,2,4,-2,3,1,-3,3,0,0,0,0,0,-3,-8,-2,-2,4,3,0,-1,-1,-1,-1,-1,3,-1
KR_6764751951,420,-1,-3,2,-2,-1,2,1,-2,2,0,-3,5,2,3,2,5,1,0,1,0,5,-4,-1,-6,7,1,0,0,1,1,-1,1,4,-1
KR_6672961107,420,-4,-112,0,-6,-1,1,0,0,2,2,-1,2,1,-4,6,2,0,1,1,0,-4,-21,1,-4,3,1,0,-1,1,-1,-1,-1,1,-1
KR_6658842722,420,1,-39,15,0,-1,3,2,1,3,4,2,2,4,-1,3,2,-1,1,0,0,-3,-136,3,-7,4,-3,0,-1,1,-1,-1,1,4,-1
KR_6739524661,420,-1,-9,-14,4,3,2,5,-1,3,2,3,0,3,0,2,2,-1,1,0,0,-2,-55,5,-8,3,8,0,-1,-1,1,-1,1,5,-1
KR_6694334398,420,0,-10,17,-3,0,0,0,-1,4,3,-1,5,4,0,3,3,-1,1,0,1,-8,-4,-2,-4,6,3,0,0,-1,1,1,1,4,-1
KR_6741476341,420,5,48,2,0,5,0,5,-5,8,3,3,1,4,-3,5,2,0,1,1,0,-8,4,-3,-4,7,4,0,1,1,0,1,1,2,-1
KR_6694030131,420,-5,-69,-12,-6,0,2,2,-1,4,3,0,3,3,-3,3,0,-2,2,0,0,-3,-6,-3,-2,5,0,0,-2,1,0,-1,-1,4,-1
KR_6679020970,420,-4,-46,8,-8,-2,5,3,-2,2,0,0,2,2,-5,6,1,1,0,1,-1,-8,-45,-4,-3,7,6,0,-2,-1,-1,-1,-1,1,-1
KR_6765048861,420,-1,-63,19,-4,1,0,1,4,0,4,-3,5,2,-5,6,1,-1,2,1,0,0,14,-2,0,2,-2,0,0,-1,-1,0,-1,2,-1
KR_6672908666,420,-1,-57,23,2,-1,3,2,1,2,3,4,1,5,-4,6,2,2,0,2,0,-3,33,-3,-2,5,-2,0,0,1,1,-1,1,3,-1
KR_6715340649,420,0,10,-8,-5,1,3,4,-4,6,2,1,1,2,1,5,6,-4,4,0,3,-7,-2,-1,-4,5,-1,0,-1,1,0,-1,1,3,-1
KR_6755402417,420,-3,22,12,-8,0,0,0,-1,2,1,-6,6,0,1,0,1,-2,2,0,0,-6,-126,-3,-2,5,0,0,0,-1,-1,0,-1,1,-1
KR_6767785182,420,-3,-51,-25,-10,-4,4,0,-3,4,1,-2,3,1,-1,3,2,0,3,3,0,-4,123,-4,0,4,1,0,-1,-1,-1,1,1,6,-1
KR_6755515085,420,-6,-73,-8,-10,-2,3,1,-1,3,2,2,2,4,-9,10,1,0,1,1,0,-9,6,-2,-4,6,-3,0,-2,1,1,-1,-1,5,-1
KR_6693383224,420,-1,53,1,0,1,0,1,1,1,2,1,1,2,-3,6,3,0,2,2,0,-2,3,0,-5,5,-2,0,1,1,1,1,1,6,-1
KR_6706249811,420,0,20,-15,-1,-1,1,0,0,2,2,-3,7,4,-1,3,2,4,0,4,0,3,19,2,-4,2,-5,0,0,-1,-1,-1,1,2,-1
KR_6724647733,420,-2,-56,12,-2,3,4,7,-5,7,2,-3,4,1,1,3,4,2,1,3,0,0,102,-2,-2,4,2,0,-3,-1,-1,-1,-1,1,-1
KR_6755425945,420,-6,-21,-32,-1,1,1,2,-2,4,2,-1,2,1,0,3,3,1,2,3,0,6,-14,-2,-4,6,5,0,0,-1,0,0,1,4,-1
KR_6726465835,440,-5,-81,-28,-7,-1,2,1,-2,5,3,-2,5,3,-1,4,3,-1,2,1,0,-6,-18,3,-6,3,0,0,-2,-1,1,-1,-1,6,-1
KR_6620874050,420,-5,-95,19,-18,-6,6,0,-2,3,1,-3,4,1,-3,3,0,-4,4,0,-3,-20,-1,-3,-4,7,-1,0,-1,-1,-1,-1,-1,4,-1
KR_6724566554,440,-5,-46,9,-13,-2,2,0,-5,8,3,-2,3,1,-4,4,0,0,0,0,0,-9,-1,2,-4,2,-2,0,-1,0,-1,-1,-1,0,-1
KR_6760269895,420,-1,40,12,-1,-1,1,0,0,4,4,-5,5,0,1,1,2,4,1,5,1,2,9,0,-4,4,-3,0,0,0,-1,0,1,0,-1
KR_6760048096,420,-5,-44,-32,-8,4,1,5,1,1,2,1,1,2,-8,9,1,-6,6,0,-1,-9,-3,-2,-4,6,2,0,-3,-1,-1,-1,-1,3,-1
KR_6761814691,440,-3,-74,-19,-8,-1,1,0,2,0,2,-4,5,1,-1,3,2,-4,4,0,0,-11,-1,-1,-3,4,-5,0,0,-1,-1,0,-1,6,-1
KR_6766485717,420,-2,76,9,0,3,0,3,-3,5,2,0,2,2,-1,3,2,1,0,1,0,-6,45,1,-4,3,-19,0,1,-1,-1,1,-1,4,-1
KR_6747478614,420,-6,-64,-28,-16,-3,3,0,-6,6,0,3,2,5,-10,11,1,0,2,2,-1,-20,-2,-1,-4,5,-5,0,-3,-1,-1,-1,-1,5,-1
KR_6693514966,420,2,-66,32,4,1,3,4,0,4,4,0,1,1,0,2,2,3,4,7,0,4,1,-1,-2,3,0,0,0,1,1,0,1,6,-1
KR_6720625551,420,-1,-52,12,-3,-4,4,0,5,4,9,2,2,4,-4,6,2,-2,3,1,-1,-4,23,-2,-3,5,-1,0,-1,-1,1,-1,-1,5,-1
KR_6731822793,420,-4,-47,-4,-10,-7,7,0,-1,2,1,0,3,3,-4,4,0,2,2,4,0,-12,5,-1,-2,3,-1,0,-2,-1,-1,-1,-1,5,-1
KR_6672755275,420,2,12,-16,9,1,1,2,-3,4,1,7,1,8,1,4,5,3,0,3,1,5,-5,0,-7,7,5,0,1,1,1,1,1,3,-1
KR_6730604278,440,2,34,16,0,4,0,4,1,3,4,-1,3,2,-1,1,0,-3,3,0,0,-6,24,-3,-3,6,-8,0,-1,-1,-1,1,-1,3,-1
KR_6728530747,420,-1,-10,6,-5,2,1,3,-4,6,2,2,0,2,-4,5,1,-1,1,0,-2,-8,-10,-4,-5,9,-1,0,0,-1,1,0,-1,3,-1
KR_6738159579,420,0,11,-15,2,0,2,2,-2,5,3,6,0,6,0,0,0,-2,2,0,0,1,3,2,-8,6,1,0,0,-1,1,0,-1,2,-1
KR_6725582918,420,-1,-67,-32,-1,-4,5,1,-1,3,2,1,3,4,4,1,5,-1,1,0,-1,-1,1,1,-5,4,-4,0,1,1,1,1,-1,6,-1
KR_6758727852,420,6,138,11,3,1,3,4,3,1,4,0,1,1,0,2,2,-1,2,1,0,0,-4,0,-3,3,2,0,2,0,1,1,-1,0,-1
KR_6643934492,440,-3,-25,-28,-5,-1,2,1,0,2,2,-2,5,3,-3,5,2,1,0,1,0,-9,3,1,-5,4,4,0,0,-1,1,-1,-1,3,-1
KR_6471496801,420,-4,7,28,-11,1,1,2,-10,11,1,2,3,5,-3,4,1,-1,2,1,-1,-17,1,-2,-3,5,-5,0,-1,-1,-1,-1,-1,6,-1
KR_6632323006,420,-6,33,-78,-4,1,0,1,-1,2,1,4,1,5,-3,5,2,-5,5,0,0,-4,-10,0,-1,1,-1,0,-1,-1,-1,-1,-1,5,-1
KR_6704871852,420,0,19,-27,0,1,1,2,-1,3,2,3,1,4,-2,2,0,-1,1,0,0,-5,-3,2,-4,2,2,0,0,-1,-1,0,-1,4,-1
KR_6765613016,420,-1,-43,4,-2,-3,3,0,0,2,2,0,0,0,1,2,3,0,1,1,0,1,15,2,-5,3,-3,0,-1,1,1,-1,1,4,-1
KR_6740482942,440,0,30,19,-1,2,4,6,2,1,3,-3,4,1,-1,2,1,-1,1,0,0,-2,10,1,-4,3,-7,0,0,0,-1,0,1,0,-1
KR_6716616063,420,-4,-2,-24,-6,2,1,3,0,1,1,1,1,2,-6,8,2,-3,4,1,0,-12,-15,-3,-3,6,2,0,-1,-1,0,-1,-1,4,-1
KR_6740819933,420,-5,-48,-76,-8,-6,6,0,-1,2,1,-2,4,2,2,3,5,-1,2,1,0,-6,5,1,-3,2,-1,0,-1,-1,-1,-1,1,6,-1
KR_6708806593,420,3,84,-5,10,0,0,0,-4,5,1,6,0,6,6,0,6,2,0,2,0,2,-116,3,-7,4,3,0,2,1,-1,1,1,4,-1
KR_6702920854,420,-1,-2,-20,3,0,2,2,2,0,2,1,1,2,-2,3,1,2,0,2,0,3,-37,-5,-2,7,14,0,0,1,-1,0,1,6,-1
KR_6762591611,440,-2,-2,4,-2,-2,3,1,-2,4,2,2,1,3,0,3,3,0,0,0,1,-7,-5,0,-3,3,2,0,1,1,1,1,1,2,-1
KR_6692497188,420,0,36,-7,-1,1,0,1,1,0,1,-2,2,0,0,2,2,-1,2,1,0,-3,13,7,-12,5,-3,0,0,1,-1,0,-1,6,-1
KR_6750763193,420,0,14,0,0,2,1,3,2,1,3,-2,4,2,-2,4,2,0,0,0,-1,-5,-31,-3,-4,7,11,0,-1,-1,1,-1,-1,5,-1
KR_6735327219,420,-2,-38,-28,2,-1,2,1,2,2,4,3,1,4,-2,4,2,0,1,1,0,7,0,3,-5,2,0,0,-1,-1,1,-1,1,2,-1
KR_6733521325,420,-5,-4,15,-8,0,0,0,-1,1,0,-5,8,3,-2,2,0,0,0,0,0,-8,-10,-2,-2,4,4,0,0,-1,1,0,-1,2,-1
KR_6608149020,420,-1,33,-8,-5,0,0,0,2,2,4,-4,5,1,3,3,6,-6,7,1,0,-4,-9,4,-6,2,-4,0,0,1,-1,0,-1,5,-1
KR_6752589885,440,-3,-35,-36,-7,-2,2,0,-1,2,1,0,3,3,-4,5,1,0,1,1,0,-6,0,-2,0,2,-2,0,0,-1,1,0,1,6,-1
KR_6750368554,420,1,-2,9,1,1,4,5,1,0,1,-1,6,5,0,1,1,0,0,0,0,5,-5,-1,-3,4,5,0,-2,1,-1,-1,-1,1,-1
KR_6646406542,420,0,3,-41,-1,1,3,4,-2,4,2,0,0,0,1,2,3,-1,1,0,0,1,10,3,-5,2,-1,0,0,-1,-1,1,1,5,-1
KR_6749130857,420,-1,37,-1,-10,1,0,1,-6,6,0,-1,3,2,-2,2,0,-2,2,0,0,-19,-4,2,-5,3,-2,0,1,-1,0,1,1,2,-1
KR_6766092873,420,-5,-36,-32,-3,-1,1,0,-5,8,3,7,2,9,1,1,2,-5,5,0,0,-1,1,2,-4,2,-5,0,1,-1,1,1,-1,5,-1
KR_6692786992,440,-7,-32,-66,-8,-3,5,2,-1,3,2,2,3,5,0,4,4,-6,7,1,0,-8,80,2,-6,4,-3,0,-5,-1,-1,-1,-1,4,-1
KR_6763338504,420,-2,-48,4,-2,-2,3,1,3,0,3,-2,2,0,0,0,0,-1,1,0,0,-2,-15,3,-6,3,1,0,-1,-1,1,-1,1,4,-1
KR_6761375584,420,-1,-29,-8,-9,1,0,1,-2,2,0,-1,5,4,-4,4,0,-3,3,0,0,-9,7,-4,-1,5,2,0,0,-1,-1,0,-1,2,-1
KR_6762208069,420,-5,-1,-49,-21,-10,11,1,-3,5,2,-2,2,0,-5,6,1,-1,1,0,0,-10,15,2,-4,2,-3,0,-1,-1,-1,-1,-1,3,-1
KR_6626380881,420,-1,-53,-24,-10,-2,6,4,-3,4,1,-6,6,0,3,1,4,-2,4,2,-1,-8,5,0,-2,2,2,0,0,-1,-1,1,-1,1,-1
KR_6767379488,420,0,26,19,1,-2,2,0,-2,2,0,0,2,2,3,2,5,2,0,2,0,0,-258,-2,-3,5,-13,0,0,-1,-1,0,-1,6,-1
KR_6761922134,420,-5,-64,-19,-8,-2,3,1,-3,5,2,-1,1,0,-2,2,0,0,1,1,-1,-9,-11,-5,0,5,2,0,-2,-1,-1,-1,-1,6,-1
KR_6705230022,440,4,47,-3,2,-3,3,0,1,1,2,0,3,3,0,4,4,4,3,7,0,0,-12,-5,-5,10,0,0,2,-1,-1,1,1,2,-1
KR_6642178004,420,0,12,-12,-2,-4,5,1,1,3,4,1,1,2,0,3,3,0,0,0,-1,-4,-6,-2,-2,4,-4,0,0,-1,-1,-1,-1,4,-1
KR_6731791575,420,0,4,-12,-1,-4,5,1,2,1,3,2,3,5,-2,4,2,1,3,4,0,1,-10,-5,-3,8,-2,0,0,1,-1,-1,-1,3,-1
KR_6727317349,420,-3,17,-4,-4,4,0,4,-3,5,2,-2,2,0,1,3,4,-4,5,1,0,-8,2,4,-7,3,-3,0,0,1,1,0,1,2,-1
KR_6750800416,420,-2,25,-35,-1,-1,3,2,2,2,4,-2,3,1,-1,2,1,1,0,1,1,-3,8,0,-5,5,-1,0,0,-1,0,0,1,1,-1
KR_6570730128,420,-5,-92,-22,-13,-2,2,0,-2,4,2,-3,4,1,-3,6,3,-3,4,1,0,-4,101,-2,-5,7,-2,0,-2,-1,-1,-1,-1,6,-1
KR_6716331847,440,0,47,-32,0,-1,3,2,-2,3,1,1,1,2,2,3,5,0,0,0,0,4,-25,-1,-4,5,0,0,0,-1,-1,-1,-1,6,-1
KR_6649316260,420,1,-25,8,-4,0,1,1,0,1,1,-2,3,1,-3,3,0,1,1,2,1,-8,-5,-3,-3,6,1,0,0,1,0,0,1,6,-1
KR_6764520134,440,1,4,8,-2,-2,3,1,0,2,2,1,0,1,1,1,2,-2,3,1,0,1,-3,-2,-1,3,-1,0,-1,1,-1,-1,-1,5,-1
KR_6755845209,420,-1,-118,5,0,-5,5,0,0,5,5,-1,5,4,4,2,6,2,0,2,0,16,-13,4,-6,2,1,0,-3,-1,-1,-1,-1,2,-1
KR_6575358049,420,-4,-52,33,-9,0,1,1,-2,3,1,-2,2,0,-2,5,3,-3,3,0,0,-4,-5,-2,-1,3,0,0,0,-1,0,-1,1,4,-1
KR_6742797456,420,-4,-66,12,-11,-5,6,1,0,3,3,-2,2,0,-3,3,0,-1,2,1,0,-8,10,6,-6,0,-4,0,-1,-1,1,-1,1,6,-1
KR_6768035840,420,-4,-35,-31,-2,0,3,3,-3,6,3,0,2,2,0,3,3,1,1,2,0,-2,1,2,-7,5,-4,0,0,-1,-1,1,-1,3,-1
KR_6767165249,440,-1,-38,-8,-17,-2,3,1,-4,8,4,-3,3,0,-7,9,2,-1,5,4,-2,-26,15,-5,-5,10,3,0,-1,-1,1,-1,-1,4,-1
KR_6710166885,420,1,60,-16,1,4,0,4,2,2,4,-4,7,3,-1,2,1,0,1,1,0,-3,17,-2,-3,5,-4,0,1,0,1,1,1,0,-1
KR_6752923846,420,2,76,-4,5,2,0,2,-1,1,0,2,2,4,1,1,2,1,1,2,0,-1,3,0,-5,5,-4,0,-1,-1,1,-1,1,5,-1
KR_6741276508,440,-1,28,4,1,1,0,1,-2,5,3,0,4,4,0,3,3,2,1,3,0,-4,16,5,-5,0,-3,0,-1,-1,1,-1,1,6,-1
KR_6765948117,420,-3,0,-8,-7,-1,2,1,0,5,5,-3,3,0,-3,7,4,0,1,1,0,-7,-2,2,-4,2,0,0,0,1,0,0,1,3,-1
KR_6757977568,420,1,62,5,-5,1,1,2,-7,9,2,2,4,6,0,2,2,-1,1,0,0,-10,4,5,-10,5,3,0,1,-1,1,1,1,3,-1
KR_6745494470,420,-1,-26,3,-12,2,2,4,-5,7,2,-6,7,1,-2,3,1,-1,1,0,-1,-22,3,1,-2,1,-1,0,-1,-1,-1,-1,-1,5,-1
KR_6725943972,440,0,37,-37,-5,0,0,0,0,1,1,-5,6,1,0,3,3,0,0,0,0,-2,212,0,-4,4,4,0,-2,1,-1,-1,-1,4,-1
KR_6736248691,420,1,7,-9,3,-3,4,1,1,2,3,-2,2,0,7,2,9,0,0,0,0,9,1,-4,-4,8,-2,0,0,-1,-1,1,-1,2,-1
KR_6726310626,440,-6,-72,13,-15,-3,4,1,-2,2,0,-2,3,1,-3,4,1,-5,5,0,0,-18,1,-8,-5,13,6,0,-2,1,-1,-1,-1,1,-1
KR_6746044862,420,-4,-26,-9,-6,1,2,3,-1,2,1,-5,5,0,0,1,1,-1,2,1,0,-3,-3,-2,-4,6,-1,0,-2,-1,-1,-1,-1,2,-1
KR_6733477287,420,-1,-45,-28,4,2,1,3,6,2,8,-6,8,2,1,4,5,1,2,3,0,7,-23,-1,0,1,-1,0,0,1,-1,-1,1,2,-1
KR_6760345597,440,-2,-37,-19,-1,-4,4,0,0,2,2,0,4,4,4,3,7,-1,3,2,0,3,2,-3,-3,6,-7,0,0,-1,0,0,1,2,-1
KR_6664902849,420,-1,16,-30,1,4,0,4,-5,5,0,1,2,3,-2,4,2,3,1,4,1,-2,-1,0,-1,1,0,0,0,-1,1,1,1,4,-1
KR_6703928278,420,-6,-58,-9,-15,1,1,2,1,2,3,-4,5,1,2,1,3,-15,18,3,0,-16,9,-4,0,4,-1,0,-2,-1,0,-1,1,2,-1
KR_6723531468,420,-2,-39,-13,-1,-1,4,3,-3,3,0,4,1,5,-1,1,0,0,1,1,0,-3,-3,-5,-1,6,2,0,-2,-1,-1,-1,1,6,-1
KR_6651437699,420,-1,-20,8,-7,0,0,0,0,1,1,-3,3,0,0,3,3,-4,4,0,0,-7,-22,1,-4,3,-2,0,-1,0,-1,-1,-1,0,-1
KR_6708355821,420,2,51,12,1,2,1,3,1,3,4,0,3,3,-1,2,1,-1,2,1,1,-11,2,-2,-7,9,2,0,0,-1,1,0,1,6,-1
KR_6710991421,420,0,28,7,-6,-3,3,0,0,0,0,0,5,5,-4,4,0,1,1,2,1,-8,-6,-7,-1,8,2,0,0,-1,-1,-1,1,1,-1
KR_6764350957,440,-6,-88,20,-10,1,2,3,-4,5,1,-5,8,3,-2,2,0,0,1,1,0,-10,-1,-3,-3,6,1,0,0,-1,1,-1,-1,3,-1
KR_6635290519,420,3,77,-5,4,3,0,3,-3,6,3,1,4,5,-1,3,2,4,0,4,1,12,15,-4,-3,7,8,0,2,1,-1,1,1,2,-1
KR_6767487627,420,3,36,-32,5,-1,3,2,-1,1,0,2,1,3,2,1,3,3,0,3,0,1,5,5,-5,0,-1,0,1,-1,1,1,1,3,-1
KR_6764924731,420,0,-1,-14,0,-1,1,0,2,1,3,-1,5,4,0,1,1,0,1,1,0,2,-21,-4,-3,7,1,0,0,-1,1,0,-1,2,-1
KR_6621579441,420,-2,-18,-25,-3,-2,3,1,0,2,2,0,3,3,-2,3,1,1,1,2,0,-2,128,-1,-4,5,0,0,1,-1,-1,1,-1,1,-1
KR_6615538543,420,-3,36,-26,-7,-4,4,0,-2,3,1,0,1,1,2,0,2,-3,4,1,0,-3,-1,-2,-4,6,0,0,0,0,-1,0,-1,0,-1
KR_6736931317,440,-6,-66,14,-19,-16,16,0,-5,5,0,-1,1,0,8,1,9,-5,6,1,0,-10,1,2,-4,2,-4,0,-3,0,-1,-1,1,0,-1
KR_6639536581,420,-3,-35,-23,-12,0,0,0,-8,8,0,0,2,2,-2,2,0,-2,2,0,0,-11,123,-4,-1,5,-6,0,-1,-1,-1,-1,-1,5,-1
KR_6739689450,420,-2,28,-16,-9,-1,1,0,-2,4,2,-5,9,4,-1,3,2,0,0,0,0,0,-4,-4,0,4,0,0,0,-1,-1,1,1,1,-1
KR_6738513092,420,1,35,42,-2,-4,4,0,1,0,1,-1,3,2,1,3,4,1,0,1,-1,-2,-14,-2,-3,5,1,0,-1,1,1,1,-1,1,-1
KR_6751401692,440,-1,-47,-4,-7,-1,6,5,-1,3,2,-1,2,1,-2,7,5,-2,2,0,-3,-5,-4,2,-7,5,1,0,-1,-1,1,-1,1,6,-1
KR_6615593533,420,2,20,20,-2,1,1,2,1,5,6,-2,3,1,-2,4,2,0,0,0,0,-10,-10,-2,-4,6,5,0,0,-1,1,0,1,5,-1
KR_6760313964,420,-6,-96,-9,-17,-3,4,1,-8,9,1,1,1,2,-4,4,0,-3,3,0,0,-21,8,-1,-5,6,-3,0,-2,-1,-1,-1,-1,2,-1
KR_6656309169,420,0,-45,20,1,1,0,1,5,2,7,-1,3,2,-4,6,2,0,0,0,0,-5,4,-1,-5,6,-1,0,0,-1,1,0,-1,2,-1
KR_6748948883,420,2,-7,-8,6,-2,2,0,1,2,3,6,0,6,3,0,3,-2,2,0,1,3,-42,-2,-1,3,26,0,0,1,-1,-1,1,6,-1
KR_6726534164,420,-2,-37,-20,4,-3,5,2,1,1,2,3,3,6,3,1,4,0,1,1,0,10,55,3,-7,4,-4,0,-2,1,-1,-1,-1,1,-1
KR_6659385951,420,2,-10,20,4,0,2,2,4,1,5,2,1,3,0,1,1,-2,3,1,0,3,-17,-1,-4,5,1,0,1,1,-1,1,1,2,-1
KR_6683785741,420,0,-63,-16,7,-2,3,1,1,3,4,3,1,4,3,1,4,2,0,2,0,11,-15,2,-7,5,2,0,-2,1,-1,-1,1,2,-1
KR_6688088645,420,-4,-78,-44,-13,-1,2,1,-1,1,0,-9,9,0,-2,4,2,0,2,2,0,-3,-21,0,-3,3,-3,0,-1,-1,0,-1,-1,5,-1
KR_6749541527,440,-3,-79,5,-6,-1,3,2,-7,7,0,2,1,3,2,1,3,-2,2,0,0,-6,23,-5,-2,7,1,0,0,-1,1,0,-1,2,-1
KR_6749807707,420,-4,-94,-27,-5,0,1,1,0,3,3,0,2,2,-1,5,4,-4,6,2,0,-4,-4,-6,-3,9,-1,0,0,-1,0,-1,1,3,-1
KR_6767970083,420,1,-5,-10,1,1,1,2,5,1,6,-4,4,0,0,2,2,-1,1,0,0,6,-17,1,-7,6,-5,0,0,1,-1,-1,-1,2,-1
KR_6733009299,420,3,-41,0,11,-1,2,1,4,1,5,5,2,7,2,0,2,1,0,1,0,10,13,0,-4,4,4,0,-2,1,-1,-1,1,2,-1
KR_6713387597,420,-4,-2,-37,-15,1,1,2,-9,9,0,0,4,4,-7,12,5,0,3,3,-3,-23,0,-2,-2,4,-1,0,-2,-1,-1,-1,-1,1,-1
KR_6656856994,440,-4,-52,-16,-4,0,1,1,-4,6,2,-3,3,0,0,1,1,3,0,3,-1,-6,15,0,-3,3,1,0,0,-1,0,-1,-1,2,-1
KR_5883747205,420,-2,-7,23,-11,-13,13,0,0,0,0,-1,2,1,1,1,2,2,0,2,0,-1,-13,0,-6,6,-1,0,0,1,-1,-1,-1,4,-1
KR_6677421346,420,-7,-107,-34,-17,-12,12,0,-2,2,0,-2,3,1,2,1,3,-3,3,0,0,-8,1,-1,-4,5,-3,0,-4,-1,-1,-1,-1,4,-1
KR_6684311945,420,-6,-29,-8,-5,-5,5,0,1,5,6,-4,4,0,2,1,3,1,0,1,0,-7,-2,-1,0,1,0,0,-2,-1,1,-1,-1,6,-1
KR_6764204749,420,1,-3,11,-2,3,1,4,3,0,3,-1,3,2,-6,8,2,-1,2,1,0,-6,-53,-3,-3,6,-3,0,0,-1,1,0,1,6,-1
KR_6762202713,420,-3,-49,-19,-2,-2,3,1,-9,10,1,7,1,8,5,1,6,-3,3,0,0,-2,12,-1,-3,4,-2,0,-1,-1,-1,-1,-1,2,-1
KR_6684152835,420,-3,-63,-4,-6,0,2,2,-5,5,0,-4,5,1,2,1,3,1,2,3,0,-7,-4,-2,-6,8,3,0,0,-1,1,-1,1,1,-1
KR_6721155841,440,-4,-93,-28,-7,-3,3,0,0,2,2,0,0,0,-6,9,3,2,0,2,0,-5,9,1,-5,4,-4,0,0,-1,0,0,1,6,-1
KR_6761389505,420,1,6,-17,5,3,0,3,-1,2,1,0,0,0,-1,1,0,4,0,4,0,3,-8,-3,-3,6,3,0,0,0,0,0,1,0,-1
KR_6716868523,420,-5,-125,0,-7,-1,3,2,0,4,4,1,1,2,-6,6,0,-1,2,1,2,0,-7,-4,-3,7,4,0,-2,1,-1,-1,1,6,-1
KR_6732962379,420,-5,-82,-19,-7,-3,5,2,-2,5,3,-6,8,2,2,1,3,2,1,3,-1,1,-8,-3,-2,5,4,0,-2,-1,-1,-1,-1,4,-1
KR_6734067600,440,-4,-13,-20,-1,1,0,1,1,0,1,1,1,2,-5,6,1,1,0,1,0,-4,-25,1,-4,3,3,0,0,-1,0,0,1,5,-1
KR_6767077252,420,-2,-10,0,-7,0,1,1,-6,7,1,-2,4,2,0,2,2,1,0,1,0,-12,-1,-3,-1,4,-1,0,0,-1,0,0,-1,3,-1
KR_6766528922,420,-2,-62,-4,-7,1,4,5,0,1,1,-1,4,3,-7,8,1,0,1,1,1,-6,7,1,-6,5,1,0,-1,-1,-1,-1,1,2,-1
KR_6765163240,420,4,50,16,4,5,1,6,0,5,5,1,2,3,0,4,4,-2,4,2,0,9,-117,1,-7,6,3,0,-1,1,1,-1,-1,6,-1
KR_6763213045,420,-4,-66,14,-11,-5,5,0,-2,6,4,2,1,3,-4,6,2,-2,3,1,0,-9,3,-3,-1,4,-4,0,0,0,1,0,1,0,-1
KR_6640525266,420,2,5,0,1,-1,2,1,3,0,3,-1,1,0,0,0,0,0,0,0,0,2,39,2,-5,3,-14,0,0,1,-1,0,1,3,-1
KR_6743528772,420,0,28,4,-1,0,2,2,0,0,0,-5,6,1,5,0,5,-1,1,0,1,5,4,-2,-3,5,4,0,0,1,1,1,1,5,-1
KR_6755381944,440,-4,-73,-12,-6,0,2,2,-4,4,0,3,3,6,1,5,6,-6,6,0,-2,-12,-6,1,-3,2,0,0,0,-1,-1,0,-1,6,-1
KR_6681126634,420,0,-3,34,5,4,0,4,5,2,7,-1,2,1,2,2,4,-5,6,1,2,7,-30,1,-6,5,-5,0,-1,-1,1,1,1,4,-1
KR_6675951073,420,-1,-49,16,-7,-1,1,0,-1,2,1,-3,6,3,0,6,6,-2,2,0,1,-5,27,0,-7,7,-9,0,0,1,1,-1,1,6,-1
KR_6757832072,420,1,-2,-13,5,3,0,3,-1,4,3,1,2,3,2,0,2,0,0,0,0,6,-1,3,-6,3,-6,0,0,-1,1,0,-1,1,-1
KR_6760814711,440,-3,-22,4,-14,0,1,1,-8,8,0,-3,5,2,-1,3,2,-2,2,0,-1,-16,4,-3,-5,8,-2,0,0,0,0,0,-1,0,-1
KR_6760506186,420,-3,-1,-4,-8,0,1,1,-1,2,1,-3,3,0,-2,5,3,-2,2,0,-1,-10,318,-2,-3,5,0,0,0,-1,0,0,-1,5,-1
KR_6766537430,420,-1,-60,12,-1,-1,3,2,0,2,2,-2,3,1,1,0,1,1,1,2,0,3,-7,1,-6,5,6,0,0,-1,1,0,1,6,-1
KR_6737776810,420,-3,-61,11,-13,-2,2,0,-1,2,1,-6,8,2,-3,3,0,-1,2,1,0,-6,-2,-4,-4,8,0,0,-1,-1,1,-1,-1,2,-1
KR_6752380576,420,-8,-139,-8,-19,-5,5,0,1,0,1,-9,9,0,-5,7,2,-1,2,1,0,-13,-7,-2,-5,7,2,0,-4,1,-1,-1,-1,5,-1
KR_6747014134,420,0,25,-32,12,3,1,4,3,0,3,3,3,6,4,0,4,-1,1,0,0,10,-2,2,-3,1,0,0,0,-1,1,0,1,1,-1
KR_6636207138,420,-1,-42,12,6,-2,3,1,9,4,13,-1,3,2,-2,5,3,2,1,3,-1,-2,-104,-4,-5,9,3,0,1,1,-1,1,-1,4,-1
KR_6734948102,420,1,-17,-28,3,3,0,3,0,3,3,-2,3,1,1,0,1,1,1,2,0,6,16,1,-3,2,-1,0,0,-1,-1,0,1,3,-1
KR_6593782717,420,-1,-7,27,-2,-2,2,0,-3,4,1,0,1,1,1,2,3,2,1,3,0,1,12,3,-4,1,-2,0,0,-1,1,1,-1,6,-1
KR_6765851496,420,-1,-48,7,-1,-1,3,2,-1,4,3,2,0,2,-2,2,0,1,2,3,0,4,-12,1,-3,2,-3,0,0,-1,1,-1,-1,3,-1
KR_6759321120,420,0,13,16,2,-5,5,0,-2,4,2,3,3,6,6,0,6,0,0,0,0,9,8,-2,-3,5,2,0,-1,1,1,-1,1,3,-1
KR_6738037183,420,3,44,12,1,6,0,6,-1,3,2,-5,7,2,0,1,1,1,1,2,0,-3,-7,-2,-4,6,0,0,1,-1,-1,1,1,2,-1
KR_6767355676,440,0,-41,7,1,-2,2,0,1,0,1,1,1,2,1,2,3,0,0,0,0,-2,-3,2,-7,5,4,0,0,-1,-1,-1,1,1,-1
KR_6761290969,420,-1,11,-4,2,4,0,4,-4,5,1,-1,1,0,1,2,3,2,0,2,1,-8,-68,1,-6,5,-6,0,1,-1,-1,1,1,3,-1
KR_6648124808,420,-3,-78,-16,3,-5,6,1,0,1,1,5,1,6,4,0,4,-1,2,1,0,1,5,1,-3,2,-3,0,-1,1,-1,-1,-1,4,-1
KR_6338199532,420,-5,-47,-16,-10,0,2,2,-2,3,1,-5,6,1,-3,4,1,0,2,2,0,-5,3,-1,-2,3,1,0,-2,-1,-1,-1,-1,2,-1
KR_6767692997,420,-4,-10,-20,-9,3,2,5,-1,2,1,0,1,1,-11,11,0,0,0,0,0,-14,-2,0,-2,2,-1,0,1,-1,1,1,-1,3,-1
KR_6759232259,420,-2,-3,-56,-8,2,0,2,1,2,3,-3,7,4,-1,2,1,-7,7,0,-1,-7,-15,-2,-1,3,4,0,0,-1,1,-1,-1,4,-1
KR_6759847417,440,1,-14,-5,-3,-1,3,2,0,1,1,-2,3,1,-1,1,0,1,0,1,0,-2,1,2,-5,3,-1,0,0,0,0,0,-1,0,-1
KR_6764250656,420,1,26,-16,4,-1,3,2,0,5,5,2,0,2,1,3,4,2,0,2,0,3,4,3,-4,1,-1,0,-1,1,-1,-1,-1,2,-1
KR_6746158375,420,-5,-26,13,-5,-3,4,1,0,1,1,0,0,0,-2,3,1,0,0,0,0,-4,-14,-6,-3,9,1,0,0,-1,-1,0,-1,4,-1
KR_6615186064,420,2,52,-31,-1,4,1,5,-3,6,3,-2,2,0,0,1,1,0,0,0,2,-3,-20,-6,-2,8,0,0,1,-1,-1,1,1,2,-1
KR_6751287036,420,0,-77,-12,-6,0,1,1,-7,8,1,2,1,3,-2,4,2,1,1,2,0,-2,0,-2,-2,4,3,0,-1,1,1,-1,-1,5,-1
KR_6671248818,420,-6,-75,-53,-12,-5,5,0,-7,8,1,-1,2,1,-1,2,1,2,1,3,-1,-6,6,-3,-2,5,0,0,-1,-1,-1,-1,-1,1,-1
KR_6739939746,420,-3,-88,-41,-9,2,0,2,-3,6,3,0,2,2,-5,5,0,-3,4,1,0,-14,-8,0,-3,3,-1,0,-3,-1,-1,-1,-1,6,-1
KR_6761332529,440,-4,-67,-1,-10,-1,2,1,2,2,4,-3,4,1,-6,6,0,-2,3,1,0,-9,-3,0,-1,1,-3,0,-2,-1,-1,-1,1,4,-1
KR_6757747881,420,-4,-122,-4,-17,-5,7,2,-1,2,1,2,2,4,-8,11,3,-5,5,0,1,-2,5,7,-10,3,2,0,-4,1,-1,-1,1,5,-1
KR_6709572255,420,-2,-112,-4,1,4,2,6,3,1,4,-5,8,3,-1,2,1,0,0,0,0,5,-2,-5,-2,7,0,0,-2,-1,1,-1,1,4,-1
KR_6761147633,420,-1,-5,22,0,2,1,3,2,2,4,-1,2,1,-4,4,0,1,0,1,0,-1,4,-1,-5,6,-2,0,-1,1,1,-1,1,6,-1
KR_6760364823,440,-1,-62,-32,-3,-1,1,0,-1,3,2,0,2,2,-1,2,1,0,3,3,0,0,5,1,-2,1,2,0,-1,1,-1,-1,-1,3,-1
KR_6663913566,420,-4,-41,-28,-6,-3,3,0,2,1,3,-2,2,0,-4,7,3,1,0,1,0,4,-7,0,-6,6,-1,0,-1,-1,-1,-1,1,3,-1
KR_6687125850,420,-3,-48,20,-9,0,1,1,-1,1,0,-5,6,1,-1,3,2,-2,3,1,0,-17,62,-2,-4,6,-3,0,0,-1,1,0,-1,6,-1
KR_6758612674,420,-3,-33,-1,-10,-3,4,1,2,0,2,-4,4,0,-8,9,1,3,0,3,-1,-6,-7,0,-2,2,1,0,-1,-1,1,-1,-1,3,-1
KR_6767450150,420,-1,-66,-3,-4,0,4,4,-1,1,0,0,3,3,1,2,3,-4,4,0,0,-3,-185,0,-6,6,4,0,-1,1,-1,-1,1,5,-1
KR_6682015247,420,3,58,1,6,3,1,4,-2,6,4,4,2,6,0,2,2,1,1,2,0,2,0,-1,-7,8,0,0,0,1,-1,1,-1,4,-1
KR_6631356587,420,0,-33,-36,0,1,0,1,-1,3,2,1,2,3,-2,7,5,1,2,3,0,-5,-4,1,-6,5,-2,0,-1,-1,0,-1,-1,1,-1
KR_6749847589,420,3,37,-12,8,-2,5,3,3,4,7,3,1,4,1,2,3,3,0,3,0,10,-20,-1,-4,5,0,0,1,1,1,1,1,3,-1
KR_6652339812,420,-3,-40,-4,-8,-3,3,0,2,1,3,-4,6,2,-4,4,0,1,0,1,-2,-8,176,-2,-3,5,0,0,-1,-1,1,-1,-1,1,-1
KR_6693375308,420,-4,-27,-12,-11,-4,4,0,1,3,4,-4,5,1,-5,6,1,1,2,3,0,-18,59,-2,-5,7,-8,0,0,-1,1,-1,-1,1,-1
KR_6759158788,420,-3,-10,9,-10,0,3,3,-8,9,1,-2,2,0,-1,1,0,1,0,1,-1,-6,-3,-3,-3,6,-4,0,-3,1,-1,-1,-1,2,-1
KR_6679671250,420,-1,-71,20,1,-3,3,0,2,1,3,1,1,2,0,3,3,1,4,5,0,1,15,2,-4,2,2,0,0,1,-1,1,-1,2,-1
KR_6748227953,420,-1,-57,-44,2,-2,2,0,4,1,5,-3,3,0,3,4,7,0,1,1,0,-2,-12,-7,-3,10,4,0,0,-1,0,0,-1,1,-1
KR_6726038918,420,-1,-12,-24,-6,1,1,2,-1,2,1,-6,6,0,0,4,4,0,1,1,0,-4,-11,-6,-3,9,4,0,-1,-1,-1,-1,-1,4,-1
KR_6569125820,420,-7,-72,-16,-16,-1,1,0,-5,6,1,-5,6,1,-4,8,4,-1,4,3,0,-13,123,2,-5,3,-4,0,-3,-1,-1,-1,1,5,-1
KR_6709897612,420,-7,-65,-6,-8,-4,6,2,-4,7,3,1,3,4,0,2,2,-1,2,1,2,-1,181,3,-7,4,1,0,-1,1,1,-1,1,1,-1
KR_6760273026,420,1,-2,35,2,1,0,1,3,2,5,-1,3,2,-1,6,5,0,3,3,0,1,-2,0,-8,8,-6,0,0,-1,1,-1,1,1,-1
KR_6664576207,420,-1,-16,-12,-8,-3,3,0,-2,3,1,2,1,3,-4,5,1,-1,2,1,0,-15,-1,-2,-5,7,-4,0,-1,-1,-1,-1,1,1,-1
KR_6542995869,420,-3,-5,0,-1,2,2,4,-2,4,2,-1,7,6,0,1,1,0,3,3,0,-2,-2,-2,-6,8,7,0,2,-1,1,1,1,6,-1
KR_6661277458,420,0,-52,-8,-1,-3,3,0,-1,3,2,2,4,6,-1,4,3,2,2,4,2,-2,-3,0,-3,3,-3,0,0,-1,1,0,1,6,-1
KR_6763633999,420,3,37,4,5,2,1,3,2,2,4,1,2,3,-1,1,0,1,0,1,0,4,-6,4,-8,4,2,0,-2,1,-1,-1,1,2,-1
KR_6757594550,440,0,20,-21,-1,2,2,4,1,1,2,2,1,3,-4,4,0,-2,2,0,0,-4,-43,0,-4,4,19,0,1,0,0,1,1,0,-1
KR_6748563573,420,-2,65,-36,-1,6,0,6,0,2,2,-2,3,1,-4,5,1,-1,1,0,1,-10,-41,-2,-1,3,0,0,0,1,1,0,1,6,-1
KR_6665525633,440,5,26,16,5,5,0,5,4,1,5,1,0,1,-4,4,0,-1,2,1,0,4,7,5,-9,4,-1,0,0,1,1,0,1,5,-1
KR_6694052243,420,-2,10,-32,-4,1,2,3,-2,3,1,-1,2,1,-1,3,2,-1,2,1,0,-6,-1,-1,-3,4,3,0,1,1,0,1,-1,3,-1
KR_6751100797,440,-6,-69,-29,-11,-1,1,0,-3,3,0,-5,7,2,0,1,1,-2,3,1,0,-3,-5,-3,-1,4,-5,0,0,-1,-1,0,-1,2,-1
KR_6711025838,420,-2,-62,-23,1,2,4,6,-1,5,4,0,2,2,0,3,3,0,1,1,0,2,52,-1,-3,4,18,0,-1,1,-1,-1,-1,3,-1
KR_6751240720,420,-3,-1,7,-9,-3,4,1,-2,5,3,-3,3,0,-1,4,3,0,1,1,0,-23,-13,-1,-4,5,2,0,-2,-1,1,-1,-1,3,-1
KR_6758188205,420,-1,1,-12,-4,2,1,3,-4,4,0,1,3,4,-1,2,1,-2,2,0,-2,-9,-47,0,-4,4,17,0,1,-1,-1,1,-1,6,-1
KR_6739551462,420,2,24,2,5,2,0,2,4,3,7,1,1,2,-3,8,5,1,0,1,-1,5,-14,5,-7,2,2,0,1,-1,1,1,-1,6,-1
KR_6761073417,420,-2,-28,4,-8,-2,3,1,-2,3,1,1,2,3,-5,8,3,0,1,1,0,-2,2,-2,-5,7,4,0,-2,1,-1,-1,-1,6,-1
KR_6760462491,420,1,-33,15,-3,-2,4,2,-2,3,1,1,0,1,1,1,2,-1,1,0,-1,-2,2,3,-7,4,1,0,0,-1,-1,-1,-1,2,-1
KR_6765673775,420,0,-23,16,-6,-1,2,1,0,3,3,-2,3,1,-3,4,1,0,0,0,0,-10,-14,-1,-2,3,0,0,0,1,-1,0,-1,4,-1
KR_6749127341,420,-1,-2,12,-4,0,2,2,0,4,4,2,0,2,-5,5,0,-1,1,0,0,-6,11,-2,-2,4,-2,0,-1,-1,-1,-1,-1,3,-1
KR_6722218323,420,-2,-68,-11,-2,0,1,1,-2,4,2,2,2,4,1,1,2,-3,3,0,0,1,-5,1,-5,4,-1,0,0,0,-1,-1,1,0,-1
KR_6767916120,420,-2,-16,-16,3,-2,2,0,4,0,4,-1,2,1,2,2,4,0,1,1,0,6,1,0,-5,5,-6,0,-1,1,-1,-1,1,6,-1
KR_6760660265,420,-3,-47,-16,-10,-1,3,2,-4,5,1,0,5,5,-4,5,1,-1,2,1,0,-15,7,2,-3,1,-2,0,0,-1,1,0,1,2,-1
KR_6694956299,420,3,43,36,-4,3,0,3,-2,5,3,2,2,4,-6,7,1,-1,2,1,0,-10,-7,0,-4,4,2,0,2,0,1,1,-1,0,-1
KR_6748996688,420,0,-22,20,-3,1,3,4,-1,6,5,-5,6,1,1,4,5,1,0,1,-3,1,-19,-1,-2,3,0,0,1,1,-1,1,-1,3,-1
KR_6606046870,440,0,-11,-6,-1,1,5,6,0,2,2,2,0,2,-3,5,2,-1,1,0,0,-1,-28,-2,-2,4,0,0,-1,-1,-1,-1,1,1,-1
KR_6733550979,420,-4,-151,-6,-4,-1,1,0,3,1,4,-2,4,2,-2,4,2,-2,2,0,0,-6,-20,-2,-2,4,-1,0,-2,-1,-1,-1,-1,2,-1
KR_6735711638,420,-1,-65,0,0,0,1,1,2,3,5,-3,3,0,1,0,1,0,1,1,0,3,-244,-6,-2,8,1,0,0,1,1,0,-1,1,-1
KR_6741383576,420,0,-65,3,1,0,2,2,1,4,5,1,4,5,-1,4,3,0,1,1,0,1,148,-1,-2,3,-4,0,0,1,1,-1,-1,5,-1
KR_6676283292,420,1,4,29,-2,-1,2,1,0,4,4,0,2,2,1,5,6,-2,2,0,0,-9,-42,-3,-4,7,17,0,0,0,0,-1,1,0,-1
KR_6730433942,440,-2,2,-35,0,1,1,2,-4,5,1,5,3,8,-3,3,0,1,0,1,0,7,8,5,-10,5,-3,0,0,-1,1,1,1,2,-1
KR_6686803420,440,1,-16,4,0,-1,2,1,-2,6,4,0,1,1,-2,3,1,5,1,6,0,3,7,3,-7,4,0,0,1,0,0,1,-1,0,-1
KR_6759299569,420,-1,-34,-7,-4,-2,2,0,-2,3,1,-3,7,4,0,3,3,3,0,3,0,-2,-104,2,-5,3,-6,0,0,-1,-1,-1,-1,4,-1
KR_6768018304,420,-1,-38,-4,-5,-1,2,1,-2,3,1,0,2,2,-1,3,2,-1,3,2,0,-12,13,-1,-2,3,-1,0,0,-1,0,1,1,6,-1
KR_6688497573,420,-1,-34,4,-6,-1,1,0,-4,6,2,-1,4,3,1,0,1,-1,1,0,-1,-4,-3,5,-9,4,-2,0,0,-1,-1,0,-1,4,-1
KR_6765547611,420,-3,-43,-12,-11,-1,1,0,-1,1,0,0,4,4,-8,8,0,-1,2,1,-1,-14,-21,-1,-4,5,-1,0,-1,0,0,-1,-1,0,-1
KR_6766995273,420,6,26,28,12,4,1,5,3,3,6,4,1,5,0,4,4,1,1,2,0,8,9,4,-8,4,-4,0,2,-1,1,1,1,3,-1
KR_6615553315,420,-1,-43,17,2,-1,4,3,6,3,9,-4,4,0,1,2,3,0,1,1,0,4,-1,0,-3,3,2,0,0,1,-1,-1,1,2,-1
KR_6763156750,440,-3,-34,-36,-11,-2,2,0,2,4,6,0,2,2,-4,4,0,-7,8,1,0,-10,-70,-2,-5,7,-1,0,-2,-1,0,-1,-1,3,-1
KR_6709261993,440,4,80,-3,4,-4,6,2,5,1,6,-1,10,9,0,1,1,4,4,8,0,-3,-5,-1,-3,4,-2,0,1,-1,0,1,1,6,-1
KR_6756707291,420,1,18,0,0,2,0,2,3,2,5,1,0,1,-4,7,3,-2,2,0,0,-1,-6,0,-5,5,2,0,1,1,1,-1,-1,6,-1
KR_6765777649,420,2,-48,0,10,-2,2,0,6,2,8,4,2,6,2,2,4,0,1,1,0,13,2,-1,-3,4,3,0,0,1,-1,0,1,5,-1
KR_6741545414,420,2,-13,4,-1,1,0,1,1,1,2,-1,2,1,-1,2,1,-1,1,0,0,0,133,0,-6,6,-5,0,2,1,1,1,-1,5,-1
KR_6641044242,420,0,-50,4,4,2,0,2,3,1,4,2,0,2,-1,5,4,-2,3,1,0,0,13,-2,-3,5,5,0,0,-1,1,0,-1,3,-1
KR_6761522625,440,-1,-73,19,-1,4,0,4,1,1,2,-2,3,1,-1,2,1,-3,4,1,0,1,-10,-2,-4,6,0,0,-1,-1,-1,-1,1,2,-1
KR_6752112139,420,-1,82,-32,-5,-2,2,0,1,1,2,-3,4,1,2,3,5,-3,3,0,0,-12,-2,1,-6,5,-1,0,1,1,-1,1,-1,1,-1
KR_6702662686,420,0,-15,-27,-7,2,1,3,-1,3,2,-7,9,2,0,4,4,-1,5,4,0,-5,-7,-1,-4,5,0,0,-1,0,-1,-1,-1,0,-1
KR_6767340977,420,-3,1,-12,-4,2,4,6,-2,2,0,-3,6,3,-3,6,3,2,2,4,0,-5,226,-4,-3,7,2,0,0,-1,1,0,-1,1,-1
KR_6662164314,440,-1,-66,33,-3,-5,5,0,-3,5,2,5,3,8,0,3,3,0,3,3,1,-2,21,1,-2,1,0,0,-1,-1,-1,-1,1,2,-1
KR_6762791504,440,1,-49,5,2,0,1,1,1,3,4,1,1,2,0,1,1,0,1,1,0,0,-24,1,-5,4,0,0,-1,1,1,-1,1,3,-1
KR_6743245582,420,-3,-91,-12,-11,-2,3,1,-4,5,1,3,1,4,-9,11,2,1,2,3,0,-12,-93,-3,-1,4,0,0,-2,-1,1,-1,-1,1,-1
KR_6760734578,440,-3,-30,-30,-6,-3,4,1,2,2,4,0,4,4,-2,3,1,-3,3,0,0,0,-6,-1,-1,2,-1,0,-2,1,-1,-1,-1,4,-1
KR_6765110814,420,-1,42,-28,1,2,1,3,0,2,2,-4,4,0,2,4,6,1,1,2,-1,1,0,-3,-1,4,5,0,3,-1,1,1,-1,1,-1
KR_6676316663,420,-3,-38,0,-7,0,6,6,-1,1,0,3,1,4,-5,5,0,-4,4,0,1,-9,-13,-2,-4,6,-8,0,-2,-1,-1,1,1,6,-1
KR_6567334830,440,0,2,0,3,1,1,2,-2,3,1,5,1,6,2,2,4,-3,3,0,0,0,3,5,-9,4,-6,0,0,-1,-1,1,1,6,-1
KR_6766069025,420,-3,-24,28,-8,-5,6,1,2,0,2,1,2,3,-4,6,2,-2,2,0,-1,-5,104,-3,0,3,4,0,-1,-1,-1,-1,-1,4,-1
KR_6736440619,420,-2,11,-24,-4,-1,2,1,-1,1,0,0,3,3,0,3,3,-2,2,0,0,0,-8,0,-6,6,5,0,1,1,-1,-1,-1,5,-1
KR_6736249399,420,1,-31,0,-5,-2,3,1,-4,4,0,-4,5,1,5,3,8,0,1,1,0,5,-23,1,-4,3,0,0,0,1,-1,-1,1,4,-1
KR_6758175772,420,-2,-2,-20,-5,-1,3,2,1,3,4,-4,6,2,-4,4,0,3,0,3,-1,-10,100,0,-5,5,1,0,-1,-1,-1,-1,-1,4,-1
KR_6759618228,420,-3,-34,0,-1,0,2,2,-6,8,2,-4,6,2,7,0,7,2,1,3,-3,-9,-4,0,-5,5,3,0,0,1,1,-1,-1,4,-1
KR_6706461213,420,-4,-52,-1,-14,-8,9,1,2,2,4,1,0,1,-7,8,1,-2,2,0,-2,-10,-14,-6,-2,8,-1,0,0,-1,1,-1,-1,3,-1
KR_6662348997,420,-3,-39,21,-6,-6,6,0,-2,2,0,0,3,3,2,0,2,0,0,0,-1,-4,1,-2,-2,4,0,0,0,1,-1,-1,-1,5,-1
KR_6731200237,420,-2,-59,0,-4,-2,2,0,1,0,1,-4,7,3,1,2,3,0,0,0,0,4,19,-2,-2,4,-3,0,0,-1,0,0,-1,4,-1
KR_6637879052,420,-7,-7,-28,-6,-8,8,0,0,2,2,-4,5,1,3,1,4,3,0,3,0,0,-5,-3,-2,5,2,0,-1,-1,-1,-1,-1,3,-1
KR_6760953301,420,4,69,-11,-1,6,2,8,-3,3,0,-3,5,2,-2,5,3,1,0,1,0,-5,4,-3,-6,9,3,0,1,-1,1,1,-1,5,-1
KR_6732344014,440,0,19,-4,5,2,2,4,4,1,5,0,0,0,-3,5,2,2,0,2,0,7,2,-5,0,5,-2,0,-1,-1,-1,-1,1,6,-1
KR_6644070202,440,-2,3,-26,-5,-6,6,0,0,3,3,1,1,2,-1,1,0,1,1,2,0,-9,-100,3,-5,2,-3,0,0,-1,-1,-1,-1,1,-1
KR_6660828678,420,-2,-2,-16,-3,5,1,6,-2,2,0,-2,3,1,-6,6,0,2,1,3,0,-4,5,-1,-2,3,-3,0,-2,-1,-1,-1,1,3,-1
KR_6651061352,420,-1,-15,4,-5,0,0,0,-3,5,2,2,1,3,-4,6,2,0,1,1,0,-10,1,-1,-6,7,-2,0,0,-1,-1,0,-1,3,-1
KR_6761106133,420,-3,-28,-24,-1,0,0,0,-1,3,2,0,3,3,0,4,4,0,0,0,0,0,26,-4,-2,6,2,0,0,-1,1,0,1,1,-1
KR_6649514585,440,0,46,3,-4,-5,5,0,-1,7,6,2,0,2,-1,2,1,1,0,1,0,-2,2,1,-4,3,1,0,-1,0,-1,-1,1,0,-1
KR_6726096755,420,0,-17,-6,-2,-3,5,2,3,2,5,3,5,8,-6,8,2,1,0,1,0,7,5,-1,-5,6,-2,0,-1,-1,-1,-1,-1,5,-1
KR_6767105218,420,-4,-30,-20,-6,2,1,3,-1,3,2,-2,2,0,-5,6,1,0,2,2,0,-8,4,-1,-5,6,-6,0,0,-1,-1,0,-1,1,-1
KR_6651665069,420,-2,-11,-17,0,-3,4,1,4,1,5,-6,6,0,5,1,6,0,0,0,0,3,-168,3,-8,5,-27,0,0,-1,-1,-1,1,4,-1
KR_6761162495,440,-2,-35,-18,-7,-3,3,0,-1,3,2,-3,4,1,1,3,4,-1,1,0,-2,-5,-5,2,-6,4,2,0,-1,-1,-1,-1,-1,5,-1
KR_6716847011,440,0,-2,11,-2,-2,3,1,0,4,4,0,1,1,0,3,3,0,0,0,0,-10,0,-1,-3,4,-1,0,0,1,1,-1,1,6,-1
KR_6751962866,440,0,-19,-13,-2,-2,3,1,6,0,6,-5,5,0,-1,3,2,0,2,2,1,9,6,-3,0,3,2,0,0,-1,-1,0,1,3,-1
KR_6761673419,440,-1,-53,-19,-9,4,1,5,0,1,1,-4,6,2,1,3,4,-10,10,0,0,-4,15,6,-10,4,-9,0,0,1,0,0,-1,4,-1
KR_6714986965,420,-1,21,-20,4,-2,5,3,1,6,7,7,0,7,-2,3,1,0,1,1,0,11,7,2,-3,1,-2,0,-3,-1,-1,-1,1,1,-1
KR_6737532665,440,-1,38,0,-2,5,0,5,-5,5,0,0,1,1,0,4,4,-2,2,0,0,-2,1,2,-4,2,-1,0,-1,-1,-1,-1,-1,4,-1
KR_6746475735,420,-4,-14,-16,-12,1,0,1,-2,3,1,-1,5,4,-4,6,2,-6,6,0,-1,-8,1,5,-10,5,0,0,0,-1,-1,-1,-1,2,-1
KR_6647371748,420,-2,-62,-10,0,1,1,2,2,1,3,0,4,4,-5,8,3,2,1,3,0,6,10,0,-6,6,-4,0,-1,-1,-1,-1,-1,2,-1
KR_6725779420,440,-2,2,0,-5,4,0,4,-3,4,1,-3,3,0,-1,2,1,-2,5,3,0,-14,-37,2,-5,3,18,0,1,1,1,1,-1,5,-1
KR_6534668385,420,-3,-24,-26,-6,-3,6,3,-3,4,1,2,2,4,0,4,4,-2,2,0,0,-3,-10,-1,-5,6,-1,0,-1,-1,-1,-1,-1,3,-1
KR_6646335975,420,1,-13,-23,-1,-6,6,0,5,0,5,0,3,3,-2,2,0,2,0,2,0,6,2,3,-6,3,-1,0,0,-1,-1,-1,-1,3,-1
KR_6710893876,440,0,29,15,0,2,0,2,3,2,5,-2,2,0,-2,2,0,-1,3,2,0,-6,273,0,-7,7,23,0,0,0,1,0,-1,0,-1
KR_6755364460,420,-1,-36,9,-1,0,1,1,0,2,2,0,2,2,2,1,3,-3,3,0,0,-2,3,2,-6,4,5,0,0,1,-1,1,-1,1,-1
KR_6765322255,420,-2,-100,-12,-4,-5,8,3,3,3,6,2,2,4,-5,7,2,1,0,1,0,-4,19,-2,-4,6,2,0,-3,-1,1,-1,-1,4,-1
KR_6767237321,420,-3,-9,-13,-7,0,1,1,1,2,3,3,0,3,-7,10,3,-4,4,0,3,-4,19,0,-1,1,1,0,-1,-1,1,-1,1,5,-1
KR_6767144794,420,-4,-66,-7,-10,0,2,2,0,2,2,1,3,4,-9,9,0,-2,2,0,1,-14,-2,-3,-6,9,-2,0,0,-1,-1,-1,1,3,-1
KR_6758755868,420,-3,-49,-12,-4,-1,1,0,0,3,3,-3,5,2,-4,5,1,4,1,5,0,0,100,0,-4,4,-6,0,-2,1,-1,-1,-1,4,-1
KR_6626149796,420,1,69,-3,-1,-1,1,0,0,1,1,-1,3,2,1,1,2,0,1,1,0,-8,9,-3,-4,7,0,0,0,1,-1,0,-1,1,-1
KR_6686662025,420,-2,66,-19,0,2,0,2,-3,6,3,-4,5,1,0,4,4,5,0,5,1,2,-4,-2,-2,4,4,0,0,-1,-1,1,1,3,-1
KR_6764353118,420,0,11,3,-8,-4,4,0,0,2,2,-3,5,2,0,3,3,-1,1,0,0,-7,34,4,-7,3,-2,0,1,-1,1,1,-1,5,-1
KR_6744567000,420,-6,-46,-47,-14,-2,3,1,-4,4,0,-1,4,3,-5,8,3,-2,2,0,0,-13,10,-3,-3,6,-4,0,-1,-1,-1,-1,-1,1,-1
KR_6606085272,420,-5,14,-26,-16,1,1,2,-5,6,1,-8,9,1,-3,3,0,-1,1,0,0,-21,-5,1,-5,4,-1,0,0,-1,1,0,1,5,-1
KR_6729530322,420,5,26,20,13,1,1,2,-3,5,2,5,3,8,4,2,6,6,2,8,1,6,-107,2,-4,2,4,0,1,0,1,1,1,0,-1
KR_6722483617,420,2,67,11,-2,1,0,1,1,2,3,9,0,9,-12,13,1,-1,1,0,-2,-16,-5,1,-7,6,2,0,0,-1,1,1,-1,3,-1
KR_6755216097,420,0,43,0,4,2,0,2,1,0,1,-2,9,7,2,2,4,1,2,3,0,-5,-8,1,-6,5,-2,0,2,-1,1,1,-1,1,-1
KR_6758781688,420,3,68,8,0,-3,3,0,3,0,3,1,2,3,-1,3,2,0,1,1,0,-3,-3,-3,-5,8,10,0,1,-1,1,1,1,3,-1
KR_6760805962,420,-4,-117,-44,-15,-2,3,1,0,4,4,5,2,7,-14,14,0,-4,4,0,0,-15,29,-2,-4,6,-3,0,-2,0,-1,-1,-1,0,-1
KR_6710878654,420,0,1,-20,1,-7,7,0,0,1,1,2,1,3,5,1,6,1,0,1,1,4,-2,-3,-3,6,-3,0,-1,-1,-1,-1,1,4,-1
KR_6755062299,420,2,20,34,4,0,1,1,-1,1,0,-1,3,2,4,2,6,2,0,2,3,7,-4,-3,-3,6,1,0,0,1,-1,0,1,6,-1
KR_6764949634,420,-1,38,-30,-6,2,0,2,-2,4,2,1,2,3,-1,5,4,-6,7,1,0,0,-35,1,-4,3,19,0,0,-1,0,0,1,4,-1
KR_6754158063,420,0,53,-25,1,2,2,4,-2,2,0,0,2,2,2,3,5,-1,1,0,0,1,-5,1,-5,4,-3,0,1,1,1,1,-1,6,-1
KR_6744585550,420,3,113,7,9,-1,3,2,2,0,2,-1,3,2,7,2,9,2,0,2,1,7,-12,5,-7,2,4,0,1,1,1,1,1,6,-1
KR_6657793474,420,2,0,20,0,-2,3,1,-1,4,3,3,4,7,-1,4,3,1,1,2,-1,1,21,1,-2,1,-3,0,1,1,-1,-1,-1,2,-1
KR_6695857824,420,0,27,-23,0,-1,2,1,-1,5,4,-3,5,2,3,1,4,2,0,2,-1,-6,8,1,-6,5,2,0,-1,-1,-1,-1,-1,3,-1
KR_6762789873,420,1,-58,1,6,1,0,1,7,1,8,-3,4,1,3,0,3,-2,2,0,0,13,29,-6,-3,9,-26,0,0,-1,-1,-1,1,1,-1
KR_6731096734,420,-6,-121,0,-8,1,1,2,-4,5,1,1,0,1,-5,7,2,-1,2,1,-1,-12,-19,2,-7,5,-1,0,-1,-1,1,-1,-1,6,-1
KR_6734470717,420,-2,-3,4,4,2,1,3,-1,2,1,1,3,4,6,1,7,-4,5,1,0,4,-18,-7,-1,8,4,0,-1,-1,-1,-1,1,3,-1
KR_6727609575,440,-1,3,15,-5,-2,4,2,-3,4,1,1,3,4,1,2,3,-2,4,2,0,-6,-7,-4,0,4,0,0,-1,1,-1,-1,1,6,-1
KR_6610484225,420,-2,-51,0,-3,-1,4,3,1,0,1,2,3,5,-4,5,1,-1,1,0,0,-4,-260,5,-7,2,-1,0,-1,-1,-1,-1,1,6,-1
KR_6765492231,420,-1,26,-4,6,-1,4,3,1,2,3,5,1,6,3,0,3,-2,3,1,3,9,7,4,-6,2,-8,0,-1,1,-1,-1,1,1,-1
KR_6696776155,420,-4,-14,-28,-13,-1,2,1,-5,7,2,-1,2,1,-5,7,2,-1,2,1,0,-16,-5,-4,-2,6,2,0,0,1,-1,0,-1,5,-1
KR_6525085985,420,1,6,12,6,1,1,2,4,2,6,2,0,2,0,3,3,-1,1,0,-1,-1,-15,-2,-7,9,9,0,0,1,-1,0,-1,1,-1
KR_6638036981,420,2,-33,-10,0,-2,2,0,2,3,5,3,1,4,0,3,3,-3,3,0,-1,-5,126,1,-5,4,-3,0,0,-1,-1,0,-1,6,-1
KR_6529187434,420,-2,-37,8,3,1,0,1,2,4,6,2,0,2,-1,5,4,-1,2,1,0,2,-10,-4,-3,7,1,0,0,-1,1,-1,1,5,-1
KR_6767428828,420,-4,-61,-20,-11,2,2,4,-5,5,0,-5,8,3,-3,4,1,0,1,1,0,-16,2,1,-7,6,-3,0,-2,1,1,-1,-1,1,-1
KR_6601295103,420,2,37,17,-1,2,1,3,-2,8,6,-4,6,2,2,2,4,1,0,1,0,1,0,0,-3,3,2,0,2,1,1,1,-1,6,-1
KR_6632062858,420,1,-16,31,-2,1,1,2,1,3,4,2,2,4,-5,5,0,-1,2,1,0,-4,-18,0,-2,2,1,0,0,0,0,-1,-1,0,-1
KR_6752041748,420,-1,30,-13,-8,-1,3,2,-3,3,0,-6,7,1,2,5,7,0,1,1,0,-6,6,-2,-2,4,-2,0,1,-1,0,1,-1,5,-1
KR_6619776644,420,2,10,-1,9,-6,7,1,7,0,7,6,0,6,0,5,5,2,2,4,0,11,0,1,-6,5,2,0,0,-1,-1,-1,1,4,-1
KR_6749283807,420,0,57,28,-8,3,2,5,1,1,2,-5,5,0,-5,7,2,-2,2,0,-1,-12,2,0,-4,4,-6,0,1,-1,1,1,-1,2,-1
KR_6765739473,420,-2,-19,6,-6,0,1,1,1,2,3,-1,4,3,-3,4,1,-3,3,0,0,-10,-109,-3,-3,6,2,0,-1,0,-1,-1,-1,0,-1
KR_6620705463,420,-1,1,24,-5,-2,2,0,0,1,1,-1,1,0,-1,2,1,-1,1,0,0,-7,-109,-3,-3,6,-1,0,-2,1,-1,-1,1,3,-1
KR_6752336092,420,-3,-15,-20,-5,2,3,5,1,1,2,-2,4,2,-5,8,3,-1,2,1,0,-5,-5,-2,-4,6,0,0,-1,-1,1,-1,-1,5,-1
KR_6767251096,420,0,-38,-12,1,2,1,3,-1,3,2,3,0,3,-3,5,2,0,0,0,0,-1,13,3,-9,6,4,0,-1,-1,1,-1,-1,2,-1
KR_6765462732,440,-2,-49,8,-1,-1,2,1,-1,3,2,1,1,2,0,3,3,0,2,2,0,4,-5,-1,-2,3,2,0,-2,-1,-1,-1,-1,3,-1
KR_6765572415,420,-4,-28,-8,-2,-2,4,2,-1,3,2,-5,5,0,6,0,6,0,1,1,0,3,-1,0,-5,5,-2,0,1,1,1,1,-1,1,-1
KR_6711661181,420,-1,6,-15,-1,7,0,7,-5,8,3,-1,2,1,2,3,5,-4,4,0,1,-4,-37,1,-5,4,0,0,0,0,1,1,1,0,-1
KR_6731573339,420,-4,-26,3,-5,2,1,3,-1,2,1,-3,6,3,-2,5,3,-1,1,0,0,-6,37,-2,-3,5,-35,0,-1,-1,-1,-1,-1,1,-1
KR_6739575876,420,-1,20,16,-5,-4,4,0,-2,3,1,1,1,2,-1,6,5,1,2,3,0,-9,-99,2,-6,4,-6,0,0,-1,-1,0,-1,1,-1
KR_6753093438,420,-2,-33,0,-8,-2,3,1,-3,5,2,0,2,2,-5,5,0,2,0,2,0,-8,-2,-1,-5,6,-2,0,-1,1,-1,-1,-1,5,-1
KR_6735154907,420,-1,22,9,-5,0,2,2,-8,11,3,-4,5,1,5,0,5,2,1,3,0,0,25,5,-8,3,-3,0,-3,-1,-1,-1,-1,5,-1
KR_6756248520,440,-3,-35,0,-6,-2,3,1,-3,7,4,1,4,5,-3,3,0,1,0,1,0,-6,51,0,-5,5,-24,0,-1,1,-1,-1,-1,3,-1
KR_6759623383,420,-5,-153,-1,-7,-3,5,2,0,1,1,-2,4,2,-2,3,1,0,0,0,0,-5,-11,-5,-2,7,-2,0,-2,-1,0,-1,-1,6,-1
KR_6722156802,420,0,-53,-24,6,-3,5,2,6,1,7,6,0,6,-1,2,1,-2,2,0,0,8,25,6,-8,2,6,0,-1,-1,1,-1,1,1,-1
KR_6661564735,420,-2,-40,-17,-4,1,2,3,-2,3,1,-3,3,0,1,3,4,-1,3,2,0,-5,-6,-8,-3,11,4,0,-1,-1,1,-1,-1,5,-1
KR_6657266025,440,-2,-54,-24,2,5,0,5,1,2,3,3,4,7,-7,7,0,0,2,2,1,2,38,2,-5,3,0,0,-1,-1,-1,-1,1,1,-1
KR_6767394980,420,-3,-79,-36,-9,-3,3,0,1,5,6,-1,2,1,-3,6,3,-3,3,0,0,-6,-10,-2,-2,4,-1,0,-1,1,-1,-1,-1,5,-1
KR_6653175641,420,-4,-84,-16,-10,0,1,1,-2,3,1,-6,7,1,-1,4,3,-1,1,0,0,0,21,-1,-2,3,0,0,-1,-1,-1,-1,-1,4,-1
KR_6754892546,420,-1,-60,-24,4,0,0,0,-1,2,1,3,1,4,0,1,1,2,0,2,0,2,-2,0,-3,3,-1,0,-1,-1,-1,-1,-1,5,-1
KR_6706978804,420,-3,12,24,0,-1,3,2,1,1,2,-4,4,0,3,1,4,1,0,1,0,4,-8,-4,-1,5,5,0,0,1,1,1,1,6,-1
KR_6765478048,420,-1,-4,24,2,-2,3,1,-4,5,1,1,2,3,4,0,4,3,0,3,0,2,-8,-9,-4,13,0,0,0,-1,-1,0,-1,1,-1
KR_6615216739,420,-2,-7,4,-3,-1,2,1,-2,3,1,0,1,1,-2,4,2,2,1,3,0,-1,117,-1,-2,3,19,0,0,-1,-1,0,1,4,-1
KR_6765813406,420,-4,-37,-13,-6,-1,1,0,-4,4,0,3,3,6,-3,5,2,-1,4,3,0,-3,2,1,-6,5,0,0,0,-1,-1,-1,-1,6,-1
KR_6742247754,420,-5,-90,-41,-10,-3,3,0,3,3,6,-2,2,0,-6,6,0,-2,3,1,0,-4,-9,-2,-4,6,4,0,-3,-1,1,-1,-1,1,-1
KR_6632799644,420,-4,-62,-29,-12,-3,4,1,-4,6,2,-3,4,1,-3,5,2,1,0,1,0,-5,-159,-3,-1,4,15,0,0,-1,-1,-1,-1,6,-1
KR_6750963733,420,-3,-25,-5,-5,-5,8,3,-3,4,1,3,0,3,-1,1,0,1,0,1,0,-7,-5,-4,-3,7,2,0,0,1,-1,-1,1,4,-1
KR_6525243341,420,-2,41,30,4,0,2,2,1,1,2,4,2,6,-7,9,2,6,0,6,0,3,3,0,-2,2,-2,0,1,1,0,-1,1,3,-1
KR_6721903166,420,-1,-15,14,1,-4,4,0,1,2,3,-5,5,0,8,2,10,1,0,1,-1,-1,4,2,-3,1,-5,0,1,1,1,-1,-1,4,-1
KR_6766149108,420,-7,-60,-33,-17,-1,3,2,1,3,4,-10,10,0,-7,7,0,0,1,1,0,-13,37,-4,-3,7,-20,0,-1,1,-1,-1,-1,1,-1
KR_6444105955,420,-1,-63,-36,-1,1,0,1,-2,4,2,0,1,1,0,5,5,0,0,0,-1,-1,117,0,-4,4,0,0,0,0,-1,0,1,0,-1
KR_6760065861,420,0,-41,-12,1,3,2,5,2,0,2,1,1,2,0,0,0,-5,5,0,0,6,16,-2,-2,4,0,0,0,1,-1,0,-1,2,-1
KR_6737967793,420,3,-12,38,8,-2,2,0,0,2,2,9,0,9,0,3,3,1,0,1,0,-2,3,2,-3,1,3,0,2,1,1,1,1,2,-1
KR_6767422678,420,4,48,-4,7,-1,2,1,-1,1,0,2,2,4,6,2,8,1,0,1,1,8,-9,-1,-2,3,-5,0,0,1,-1,1,1,3,-1
KR_6761057575,440,-8,-146,-24,-9,-9,10,1,-2,6,4,0,0,0,1,2,3,1,0,1,0,-4,2,-3,-1,4,-1,0,-4,-1,-1,-1,1,2,-1
KR_6744692935,420,3,43,-22,9,3,1,4,1,1,2,2,1,3,4,0,4,-1,3,2,0,8,-1,1,-4,3,-3,0,0,0,1,1,1,0,-1
KR_6684949426,420,-6,-92,-4,-14,-2,2,0,-2,4,2,-7,7,0,-2,6,4,-1,2,1,0,-6,340,-1,0,1,0,0,-2,1,0,-1,-1,3,-1
KR_6723318015,420,-7,-112,-19,-13,-1,2,1,-4,4,0,-4,4,0,-2,4,2,-2,2,0,-2,-7,-2,2,-4,2,-1,0,-2,-1,-1,-1,-1,2,-1
KR_6719871786,420,-1,-86,4,2,0,3,3,-1,2,1,-1,2,1,-2,6,4,6,2,8,1,7,4,4,-7,3,2,0,-1,-1,1,-1,1,5,-1
KR_6760419452,420,2,2,22,-1,-5,7,2,-1,1,0,1,1,2,2,5,7,2,0,2,0,0,-4,-1,-2,3,1,0,-1,-1,1,-1,-1,3,-1
KR_6682848879,420,-1,20,2,0,-2,3,1,1,2,3,1,1,2,3,1,4,-3,3,0,0,5,0,0,-2,2,3,0,-2,1,-1,-1,-1,6,-1
KR_6689650251,420,-5,-55,-4,-13,-2,3,1,1,0,1,-2,3,1,-10,10,0,0,0,0,0,-12,155,-3,-3,6,0,0,-3,-1,-1,-1,-1,3,-1
KR_6665509641,420,-1,-43,14,-5,-3,4,1,1,1,2,-4,6,2,1,1,2,0,1,1,-1,-6,-1,-3,-4,7,2,0,-1,0,-1,-1,-1,0,-1
KR_6767958074,420,0,-49,-4,-2,-2,3,1,-1,3,2,4,0,4,-2,4,2,-1,2,1,0,1,1,2,-4,2,4,0,0,-1,1,1,1,2,-1
KR_6752797306,420,-1,-56,-4,-3,-1,1,0,1,1,2,-2,2,0,2,1,3,-3,4,1,0,-2,-5,-2,-3,5,-3,0,0,1,-1,-1,-1,4,-1
KR_6746746384,420,1,11,8,2,-5,8,3,6,4,10,1,0,1,-1,5,4,1,1,2,0,-4,-14,2,-3,1,-5,0,0,1,-1,0,-1,6,-1
KR_6754900634,420,-4,-42,-9,-3,1,3,4,3,4,7,-3,5,2,-4,9,5,0,1,1,0,5,-7,5,-8,3,0,0,-1,-1,-1,-1,1,6,-1
KR_6606383638,420,-3,-62,-4,-6,0,2,2,-2,2,0,-3,6,3,0,1,1,-1,1,0,0,-5,-88,-2,0,2,3,0,0,-1,-1,-1,1,4,-1
KR_6730618077,420,-6,-90,-43,-10,-3,5,2,2,1,3,-12,12,0,3,4,7,0,1,1,0,4,5,-2,-4,6,-4,0,-2,-1,-1,-1,-1,5,-1
KR_6767209316,420,-6,-75,0,-13,-4,4,0,-2,5,3,0,4,4,-8,9,1,1,1,2,0,-7,-6,-1,-3,4,-1,0,-1,-1,0,-1,-1,2,-1
KR_6764905649,440,-5,-42,-36,-8,-4,4,0,3,2,5,2,1,3,-8,10,2,-1,1,0,2,-2,-5,1,-2,1,3,0,-1,-1,-1,-1,1,6,-1
KR_6619873573,420,1,-45,9,3,-2,3,1,3,1,4,1,1,2,3,3,6,-2,3,1,0,0,1,0,-3,3,-4,0,1,1,0,-1,-1,6,-1
KR_6708607049,420,-1,-27,44,1,0,2,2,1,5,6,2,2,4,-1,2,1,-1,1,0,1,7,72,2,-6,4,-5,0,1,1,1,1,1,1,-1
KR_6752360690,420,0,-7,0,-3,-2,4,2,0,2,2,0,3,3,0,4,4,-1,2,1,0,-5,-395,-2,-3,5,-3,0,1,-1,1,1,-1,1,-1
KR_6626848302,420,-1,-20,7,-3,0,3,3,-6,7,1,-1,3,2,4,1,5,0,0,0,0,-2,-1,3,-9,6,2,0,-1,1,-1,-1,1,5,-1
KR_6745043346,420,-4,-77,-33,-14,-1,4,3,-2,2,0,6,1,7,-13,13,0,-4,4,0,0,-26,20,-3,-3,6,-1,0,-1,-1,1,-1,1,1,-1
KR_6745286491,420,-6,-56,-16,-5,-4,5,1,-4,6,2,-1,3,2,1,2,3,3,0,3,0,-3,-3,-1,-8,9,0,0,0,-1,-1,-1,1,5,-1
KR_6728159437,420,-5,-45,4,-8,-2,3,1,1,0,1,-1,3,2,-4,5,1,-2,2,0,0,-7,-3,0,-3,3,-5,0,0,-1,1,1,-1,1,-1
KR_6740092592,420,0,-13,9,-5,-3,3,0,-2,6,4,-2,4,2,-1,2,1,3,1,4,0,3,-40,-3,-1,4,29,0,-1,1,-1,-1,-1,6,-1
KR_6765353563,420,-2,8,17,-5,2,1,3,-5,8,3,-3,5,2,0,4,4,1,1,2,1,-6,24,-1,-2,3,3,0,-2,-1,1,-1,-1,2,-1
KR_6678620380,420,1,-43,-8,1,1,1,2,2,4,6,0,2,2,0,3,3,-2,2,0,2,4,-102,2,-4,2,-10,0,-2,-1,-1,-1,1,5,-1
KR_6737085980,420,-5,-57,-18,-7,-5,6,1,-1,2,1,1,1,2,-3,4,1,1,0,1,0,-6,-9,-1,-2,3,1,0,-2,1,-1,-1,-1,2,-1
KR_6752528438,420,-5,13,-62,-11,-3,4,1,-3,3,0,-9,9,0,2,3,5,2,0,2,0,1,-3,0,-4,4,0,0,-2,-1,0,-1,1,5,-1
KR_6761945165,440,-2,-60,16,-8,-5,6,1,-4,6,2,1,2,3,-2,2,0,2,1,3,-3,-20,5,-1,-1,2,0,0,-2,0,-1,-1,-1,0,-1
KR_6761034894,420,-2,-4,4,-2,0,1,1,1,2,3,-1,4,3,-3,4,1,1,1,2,0,4,6,3,-4,1,-4,0,0,-1,-1,0,-1,6,-1
KR_6753611602,420,-5,-123,-10,-8,-9,9,0,-1,1,0,-3,3,0,3,0,3,2,0,2,0,1,-9,-4,-3,7,-2,0,-2,-1,-1,-1,-1,5,-1
KR_6748132022,420,-3,-68,-20,-2,1,1,2,-4,6,2,-2,3,1,3,1,4,0,3,3,0,4,-200,2,-5,3,-7,0,-1,-1,-1,-1,1,5,-1
KR_6763588467,420,-3,-68,28,0,-5,5,0,-2,2,0,2,2,4,2,2,4,3,0,3,0,1,-46,-1,-3,4,18,0,1,1,1,-1,1,2,-1
KR_6760859098,440,2,-70,20,-4,-3,3,0,5,2,7,-6,6,0,1,1,2,-1,2,1,0,-5,-2,-6,-1,7,3,0,1,1,1,1,-1,5,-1
KR_6767926802,420,-1,-55,12,-4,-1,3,2,0,0,0,-4,4,0,3,1,4,-2,3,1,0,-1,0,0,-3,3,-2,0,-1,-1,1,-1,1,5,-1
KR_6767128851,420,-2,-79,-4,-1,0,2,2,2,0,2,-2,3,1,-1,1,0,0,0,0,0,-3,-37,0,-5,5,16,0,-2,-1,-1,-1,-1,3,-1
KR_6737715500,440,4,-13,12,5,4,1,5,2,1,3,-3,3,0,1,2,3,1,1,2,0,6,-1,-2,-4,6,4,0,-1,1,-1,-1,1,3,-1
KR_6765893807,420,0,-20,16,1,0,2,2,-1,5,4,1,2,3,-1,6,5,2,0,2,0,-9,-9,3,-6,3,-11,0,1,1,1,1,1,4,-1
KR_6742908668,420,-1,12,-13,-2,-2,3,1,3,2,5,2,2,4,-4,4,0,-1,1,0,-1,-1,2,-3,-2,5,1,0,-1,-1,-1,-1,-1,3,-1
KR_6725841679,440,-4,-24,-32,-5,-3,5,2,5,1,6,-2,5,3,0,1,1,-5,6,1,0,-13,10,5,-8,3,11,0,-1,-1,-1,-1,1,2,-1
KR_6765128725,420,0,-17,5,-9,-3,4,1,-3,3,0,-2,5,3,-1,6,5,0,0,0,0,-9,-1,2,-2,0,1,0,-1,-1,1,-1,-1,5,-1
KR_6767367416,420,-3,-94,-20,-6,-2,4,2,2,0,2,-1,1,0,-6,8,2,1,1,2,0,-5,0,-2,-4,6,-2,0,-2,-1,-1,-1,1,1,-1
KR_6755519619,420,-4,-35,-25,-7,-2,2,0,4,2,6,1,3,4,-8,10,2,-2,2,0,0,-6,8,3,-8,5,-2,0,0,-1,1,0,1,3,-1
KR_6695185454,420,0,-28,0,-2,-2,5,3,1,2,3,4,1,5,-5,10,5,0,0,0,0,2,-7,-3,-4,7,-5,0,-1,1,-1,-1,-1,1,-1
KR_6748435038,420,-1,56,-20,-4,3,1,4,-3,3,0,0,1,1,-1,6,5,-3,3,0,-1,-9,9,8,-9,1,-5,0,0,1,-1,0,-1,6,-1
KR_6647218968,440,-2,-34,-36,-6,2,4,6,-3,3,0,-2,2,0,-2,3,1,-1,1,0,0,0,-12,-1,-5,6,4,0,-1,-1,-1,-1,-1,2,-1
KR_6716535441,420,-5,-60,-24,-9,-2,3,1,-1,1,0,-4,5,1,-2,3,1,0,0,0,0,-5,-7,-4,-5,9,2,0,0,-1,1,-1,-1,1,-1
KR_6759975865,420,0,63,-5,0,1,2,3,0,1,1,0,0,0,1,2,3,-2,4,2,0,-5,41,1,-4,3,-19,0,1,1,0,1,1,4,-1
KR_6741660606,420,-2,-105,-11,-4,0,1,1,3,1,4,-1,3,2,-6,6,0,0,2,2,0,-6,15,1,-4,3,3,0,-1,1,-1,-1,1,3,-1
KR_6662451869,440,-3,-26,-12,-4,-1,2,1,1,5,6,-6,6,0,1,1,2,1,1,2,-1,-2,13,1,-3,2,-2,0,0,1,-1,1,-1,6,-1
KR_6616223606,420,-4,-46,-37,-7,4,0,4,0,1,1,-5,6,1,-2,4,2,-4,5,1,0,-2,7,0,-4,4,-3,0,1,-1,0,1,1,3,-1
KR_6752507109,420,1,29,15,5,3,5,8,1,1,2,4,0,4,-2,3,1,-1,1,0,1,1,6,5,-8,3,1,0,-1,1,-1,-1,1,4,-1
KR_6744683571,420,0,-25,-22,1,-1,1,0,0,3,3,0,3,3,1,0,1,1,2,3,0,7,10,3,-4,1,-1,0,-1,1,0,-1,-1,3,-1
KR_6713444265,420,-2,34,17,-7,0,1,1,-4,5,1,-3,3,0,2,5,7,-2,2,0,0,-9,6,-3,-1,4,1,0,0,1,-1,-1,-1,5,-1
KR_6752311282,420,-2,-47,8,-3,0,0,0,0,3,3,0,6,6,0,2,2,-3,6,3,-1,-4,42,-3,-4,7,0,0,-1,-1,1,-1,-1,4,-1
KR_6767692094,420,-1,-83,43,-3,-4,4,0,5,1,6,-2,5,3,-2,3,1,0,1,1,0,-7,-17,1,-6,5,-3,0,0,-1,1,-1,-1,1,-1
KR_6762446097,440,-5,-43,-28,-10,-4,6,2,-3,4,1,0,2,2,-2,2,0,-1,1,0,0,-11,-1,-3,-1,4,-1,0,-1,-1,1,-1,1,2,-1
KR_6685879701,420,-3,22,-11,-6,-5,5,0,-5,8,3,-2,3,1,6,1,7,0,2,2,0,-4,3,5,-8,3,-3,0,-1,1,-1,-1,1,5,-1
KR_6716250719,420,-5,-91,-13,-13,-9,9,0,-2,3,1,-2,2,0,0,5,5,0,1,1,-2,-16,-12,-8,0,8,1,0,-1,-1,-1,-1,-1,5,-1
KR_6707461212,420,-1,-35,8,-8,-1,4,3,-1,5,4,-4,5,1,0,2,2,-2,3,1,-1,-12,217,-4,-5,9,6,0,1,-1,1,1,-1,3,-1
KR_6705348780,420,-2,-55,5,-9,-1,2,1,-4,6,2,-1,6,5,0,3,3,-3,5,2,-3,-10,-32,-1,-3,4,2,0,-1,-1,-1,-1,-1,4,-1
KR_6661355561,420,0,22,-12,-5,4,1,5,-5,7,2,-2,5,3,-1,2,1,-1,1,0,0,-10,-5,3,-5,2,3,0,0,-1,1,1,-1,1,-1
KR_6673772506,420,-2,-34,11,-4,-3,5,2,-1,2,1,2,1,3,-1,2,1,-1,4,3,0,0,-17,-1,-3,4,2,0,1,-1,-1,1,1,1,-1
KR_6760475731,420,0,35,13,-2,-7,10,3,-1,5,4,-4,5,1,11,0,11,-1,1,0,0,3,3,2,-6,4,-1,0,1,-1,-1,1,1,2,-1
KR_6754142261,420,0,7,-17,-2,-4,4,0,-1,3,2,2,1,3,0,3,3,1,0,1,0,-2,20,1,-5,4,1,0,0,1,-1,-1,1,1,-1
KR_6766575883,420,-2,-36,10,-7,-2,2,0,-2,5,3,-5,5,0,0,1,1,2,0,2,0,-9,-12,1,-4,3,3,0,-1,0,-1,-1,-1,0,-1
KR_6752538904,420,-2,13,1,-9,-4,4,0,-1,3,2,-1,3,2,-2,4,2,-1,3,2,0,-13,6,-1,-4,5,-4,0,-1,1,-1,-1,1,1,-1
KR_6754705403,420,-1,-3,-21,-2,-1,3,2,3,0,3,-2,2,0,-1,1,0,-1,2,1,0,1,8,2,-7,5,-2,0,0,1,-1,-1,-1,5,-1
KR_6548983195,420,2,39,33,3,1,2,3,0,5,5,2,1,3,0,1,1,0,0,0,0,9,4,-2,-4,6,1,0,0,-1,-1,1,1,4,-1
KR_6620822494,420,-2,-53,-4,-6,0,2,2,-2,3,1,1,1,2,-5,6,1,0,1,1,0,-7,121,5,-7,2,-8,0,0,-1,1,0,1,3,-1
KR_6695551737,420,-7,-179,-10,-18,-8,8,0,0,1,1,-4,6,2,-4,7,3,-2,2,0,0,-12,-6,-4,-1,5,0,0,-4,-1,-1,-1,1,5,-1
KR_6689359359,420,-3,30,-24,-11,-6,6,0,0,2,2,-6,6,0,0,0,0,1,1,2,0,-2,179,-4,-5,9,5,0,2,-1,1,1,-1,2,-1
KR_6713745704,420,-8,-40,5,-22,-2,2,0,-5,6,1,-11,11,0,-4,4,0,0,1,1,0,-15,-26,-2,0,2,2,0,-2,1,-1,-1,-1,3,-1
KR_5944308018,420,-5,-78,-20,-3,0,0,0,2,3,5,-5,7,2,-2,4,2,2,0,2,0,1,-5,-1,-6,7,-3,0,-1,0,0,-1,-1,0,-1
KR_6676232489,420,-2,-40,0,-5,-1,3,2,0,3,3,-3,6,3,-2,4,2,1,0,1,0,-10,-6,-2,-2,4,-1,0,-2,1,-1,-1,1,6,-1
KR_6706565471,440,-9,-112,-42,-9,-2,3,1,-2,6,4,2,4,6,-3,4,1,-4,4,0,1,-6,54,-2,0,2,0,0,-3,-1,-1,-1,1,5,-1
KR_6767307049,440,2,-70,19,3,-3,3,0,5,2,7,2,2,4,-1,2,1,0,1,1,0,1,-5,1,-3,2,5,0,-1,1,-1,-1,-1,5,-1
KR_6602883829,420,0,-28,-33,0,-5,5,0,4,3,7,2,3,5,0,3,3,-1,2,1,0,0,-7,-4,-2,6,4,0,0,1,1,0,-1,1,-1
KR_6767224404,420,1,-3,-9,4,0,0,0,3,2,5,2,2,4,-1,3,2,0,0,0,0,8,1,0,-5,5,0,0,-1,1,-1,-1,-1,3,-1
KR_6714406074,420,-2,-52,4,-7,-4,6,2,-2,3,1,-2,2,0,1,4,5,0,0,0,-1,-13,14,-1,-4,5,-2,0,-1,-1,0,-1,-1,4,-1
KR_6760014963,420,-7,-28,-28,-15,-3,4,1,-1,2,1,-2,3,1,-5,9,4,-4,4,0,0,-10,-3,-3,-3,6,-1,0,-3,-1,-1,-1,1,3,-1
KR_6765358718,440,1,151,-19,2,-2,6,4,1,0,1,-3,4,1,4,0,4,2,0,2,0,1,12,-1,-3,4,3,0,1,-1,1,1,-1,6,-1
KR_6628141920,420,3,-8,-44,2,1,0,1,1,2,3,-1,4,3,0,4,4,1,0,1,0,3,7,9,-12,3,-2,0,1,-1,1,1,-1,6,-1
KR_6570890256,420,1,10,-19,-7,-2,3,1,0,3,3,-4,5,1,0,2,2,-1,1,0,0,-14,207,-1,-5,6,2,0,0,-1,-1,-1,-1,6,-1
KR_6728190637,440,2,-11,24,-5,-3,3,0,2,0,2,-4,6,2,1,0,1,-1,3,2,0,-5,-120,-3,-2,5,-4,0,0,1,0,0,-1,1,-1
KR_6749380787,420,1,-44,12,-2,2,0,2,-1,4,3,-5,5,0,-2,3,1,4,0,4,-1,0,1,0,-6,6,1,0,0,1,1,0,-1,1,-1
KR_6575125559,420,-2,-18,-12,-14,-1,5,4,-1,3,2,-7,9,2,-4,4,0,-1,2,1,-1,-14,-229,-1,-3,4,3,0,-2,-1,-1,-1,-1,2,-1
KR_6765871503,420,0,6,16,-1,0,1,1,1,2,3,1,1,2,-3,12,9,0,1,1,1,11,-17,-4,-4,8,-1,0,-1,1,-1,-1,1,5,-1
KR_6761687020,420,-4,-10,-1,-11,-2,2,0,-4,5,1,4,1,5,-8,9,1,-1,1,0,0,-17,-16,-7,-3,10,4,0,-1,-1,-1,-1,-1,1,-1
KR_6761057181,420,2,64,28,-9,2,1,3,-2,3,1,3,1,4,-13,13,0,1,0,1,0,-16,-3,-5,-1,6,-2,0,-1,-1,1,-1,-1,2,-1
KR_6206640556,420,-2,9,25,-6,2,1,3,-4,6,2,-2,3,1,-2,3,1,0,0,0,0,-13,106,-3,-2,5,-3,0,2,-1,1,1,-1,5,-1
KR_6642427026,420,1,19,26,4,0,4,4,-1,2,1,1,1,2,3,0,3,1,1,2,0,0,-37,-1,-5,6,-1,0,2,-1,1,1,1,1,-1
KR_6592313343,420,-4,-39,-6,-4,-1,1,0,-3,6,3,-2,4,2,1,0,1,1,0,1,0,-3,194,-6,-3,9,-5,0,-2,1,-1,-1,-1,5,-1
KR_6753846545,420,-4,-40,-4,-10,-5,5,0,-3,3,0,-1,2,1,-1,2,1,0,1,1,0,-8,122,4,-7,3,-3,0,0,-1,-1,-1,-1,4,-1
KR_6763074289,440,-2,33,0,-4,-3,3,0,-2,3,1,-1,1,0,0,3,3,2,0,2,0,1,18,-1,-4,5,4,0,0,-1,-1,0,-1,6,-1
KR_6762438289,420,-2,-78,-4,-11,4,1,5,-8,8,0,-2,5,3,-4,4,0,-1,3,2,0,-6,-1,-4,0,4,1,0,-2,0,-1,-1,-1,0,-1
KR_6749545024,440,-5,-91,4,-5,-2,3,1,0,2,2,-6,9,3,5,1,6,-2,2,0,2,-4,5,3,-7,4,1,0,-1,-1,0,-1,1,6,-1
KR_6763612718,420,3,62,8,-4,2,2,4,-1,1,0,-5,6,1,-1,2,1,1,0,1,0,-11,-1,-2,-2,4,0,0,2,-1,-1,1,-1,4,-1
KR_6763051874,420,0,-42,-4,-2,1,0,1,-5,5,0,5,0,5,-3,3,0,0,1,1,0,-8,-140,3,-5,2,-4,0,-1,1,0,-1,-1,4,-1
KR_6651321084,420,-1,-13,24,-4,1,0,1,0,3,3,-2,6,4,-3,5,2,0,4,4,0,0,2,-1,-3,4,-1,0,-3,1,-1,-1,-1,5,-1
KR_6481528618,420,-1,0,-3,-1,3,1,4,-6,8,2,0,1,1,2,1,3,0,1,1,0,-5,0,4,-6,2,2,0,2,-1,1,1,-1,2,-1
KR_6744694120,420,-4,-34,-14,-9,-3,3,0,-1,3,2,-2,2,0,1,1,2,-4,6,2,0,-2,5,2,-6,4,-2,0,0,0,-1,-1,-1,0,-1
KR_6582557524,420,2,14,20,3,-3,5,2,3,4,7,1,2,3,0,2,2,2,0,2,0,8,-8,1,-4,3,2,0,1,1,1,-1,-1,2,-1
KR_6763286568,420,-5,-92,-3,-5,-1,1,0,-2,4,2,2,0,2,-2,5,3,-2,2,0,0,-6,30,3,-5,2,-2,0,-2,-1,1,-1,-1,3,-1
KR_6554192845,420,-2,-32,45,-13,-3,3,0,-1,3,2,-4,9,5,-3,3,0,-2,3,1,-1,-8,-2,-1,-1,2,0,0,-1,-1,0,-1,-1,5,-1
KR_6745062113,420,-4,-58,-13,-8,-1,3,2,-5,6,1,-2,2,0,2,2,4,-2,2,0,0,-8,-7,-1,-5,6,-4,0,-1,-1,-1,-1,1,6,-1
KR_6762646638,420,2,5,7,5,5,0,5,-1,3,2,-3,4,1,4,0,4,0,0,0,0,2,12,0,-5,5,-1,0,2,0,1,1,1,0,-1
KR_6638523959,420,2,-10,-11,6,3,1,4,2,1,3,-1,1,0,2,3,5,0,2,2,0,5,-3,-2,-5,7,2,0,1,-1,1,1,-1,3,-1
KR_6686024107,420,1,53,29,2,-3,4,1,1,2,3,1,2,3,2,0,2,1,1,2,0,4,6,0,-4,4,-3,0,0,1,1,1,1,2,-1
KR_6728261798,420,-1,-91,-4,-1,0,0,0,3,2,5,-1,4,3,-2,5,3,-1,1,0,0,6,-4,1,-5,4,0,0,0,-1,-1,-1,-1,6,-1
KR_6764418117,420,1,25,-14,1,-5,5,0,-1,1,0,6,2,8,-2,4,2,3,0,3,0,2,6,2,-4,2,-3,0,2,-1,1,1,1,6,-1
KR_6767330907,420,0,-1,34,-2,-1,2,1,1,0,1,-3,5,2,0,2,2,1,0,1,0,2,19,2,-5,3,-35,0,-2,0,-1,-1,1,0,-1
KR_6722681963,420,-3,-35,3,-3,4,2,6,1,4,5,-4,5,1,-4,5,1,0,2,2,0,-3,2,-2,-2,4,-3,0,0,-1,0,1,-1,6,-1
KR_6685520530,420,-1,7,-39,-5,0,3,3,-2,3,1,-3,4,1,-1,2,1,1,2,3,0,-7,-22,3,-6,3,3,0,0,1,-1,-1,-1,6,-1
KR_6567321331,440,0,27,12,-3,-2,2,0,3,1,4,-1,2,1,-2,4,2,-1,3,2,0,-5,0,-5,-1,6,3,0,2,-1,0,1,1,3,-1
KR_6560205555,440,-1,-4,0,2,1,0,1,2,3,5,0,4,4,0,4,4,-1,2,1,0,2,12,-1,-2,3,3,0,0,-1,1,1,1,1,-1
KR_6750981606,420,-2,-86,-44,2,1,1,2,2,0,2,2,0,2,-1,3,2,-2,2,0,0,0,52,-1,-3,4,-26,0,-2,-1,-1,-1,-1,1,-1
KR_6646167379,420,-1,-16,-4,-2,0,2,2,2,1,3,0,4,4,-4,6,2,0,1,1,0,-5,-1,-4,-4,8,-3,0,1,1,-1,1,-1,2,-1
KR_6709817229,420,-5,-78,3,-7,-3,3,0,1,6,7,0,2,2,-6,7,1,1,0,1,0,-1,-5,1,-5,4,-1,0,0,-1,-1,-1,1,6,-1
KR_6579788126,440,-1,-16,-6,0,3,1,4,-2,4,2,0,0,0,2,3,5,-3,3,0,0,-1,6,-3,-4,7,-5,0,-1,-1,0,-1,1,1,-1
KR_6757064737,420,1,-18,-32,-8,0,2,2,-2,4,2,-2,2,0,-5,7,2,1,4,5,-1,-12,2,-3,-1,4,0,0,0,-1,0,0,-1,3,-1
KR_6758093424,420,-2,-27,-32,-5,-1,3,2,-4,6,2,1,2,3,-1,4,3,0,3,3,1,4,15,0,-4,4,4,0,0,0,-1,0,1,0,-1
KR_6762492625,420,-1,23,-16,-2,-1,1,0,1,0,1,0,2,2,0,2,2,-2,3,1,0,-2,5,-4,-4,8,2,0,0,1,-1,0,-1,2,-1
KR_6730424308,420,1,32,20,-3,-4,5,1,0,2,2,2,0,2,-1,3,2,0,0,0,0,-1,8,5,-9,4,-1,0,0,1,-1,1,-1,6,-1
KR_6592639761,420,-1,-42,25,-3,-5,5,0,-2,3,1,-1,3,2,4,0,4,1,0,1,0,1,-7,-9,-4,13,1,0,1,0,-1,1,1,0,-1
KR_6765495783,420,-1,-28,-16,3,-2,4,2,-3,5,2,5,1,6,0,1,1,3,1,4,0,6,19,2,-5,3,6,0,1,-1,-1,1,-1,6,-1
KR_6767199489,420,2,-9,13,1,1,0,1,0,2,2,0,0,0,0,0,0,0,0,0,0,0,-4,3,-5,2,-3,0,0,1,1,0,1,4,-1
KR_6760272181,420,-4,-55,-28,-2,-1,2,1,-4,5,1,-1,2,1,1,4,5,3,0,3,0,-1,-15,0,-4,4,4,0,-1,1,1,-1,1,6,-1
KR_6762474730,420,-2,-13,-24,-11,2,0,2,-8,9,1,-4,5,1,2,0,2,-3,4,1,0,-7,17,1,-7,6,-3,0,-1,-1,-1,-1,1,6,-1
KR_6725657071,440,2,44,16,3,-1,1,0,2,2,4,1,2,3,-2,3,1,3,1,4,0,3,-2,-6,-2,8,3,0,2,-1,1,1,-1,5,-1
KR_6707348368,420,2,43,0,3,-1,1,0,4,1,5,1,1,2,0,6,6,-1,4,3,0,3,22,0,-3,3,-2,0,0,1,-1,-1,1,1,-1
KR_6570896363,420,-4,6,-28,-13,-2,2,0,-2,4,2,-2,2,0,-4,5,1,-3,3,0,0,-7,-27,-2,-6,8,0,0,0,-1,0,0,-1,6,-1
KR_6732473388,420,-1,-30,1,-4,-2,2,0,2,3,5,-1,1,0,0,3,3,-3,3,0,0,-3,-28,2,-8,6,2,0,1,-1,1,1,1,4,-1
KR_6677304385,420,2,-9,37,1,-1,1,0,3,2,5,1,3,4,-1,2,1,-1,1,0,0,-1,-2,0,-5,5,0,0,1,1,-1,1,1,5,-1
KR_6747734982,420,-4,-77,-4,-2,-2,2,0,-2,3,1,-5,6,1,4,4,8,3,0,3,1,12,27,-1,-5,6,-3,0,0,1,1,-1,1,6,-1
KR_6761314805,420,-1,-62,4,0,-2,5,3,2,1,3,-1,3,2,2,2,4,-1,1,0,0,4,4,-2,-3,5,-5,0,0,0,-1,-1,-1,0,-1
KR_6747849946,420,0,-51,4,2,0,1,1,4,0,4,-1,3,2,0,2,2,-1,1,0,0,2,-118,1,-3,2,-1,0,-1,-1,-1,-1,-1,1,-1
KR_6724269318,420,0,5,-1,-3,-2,2,0,0,2,2,0,3,3,-2,7,5,1,1,2,0,-8,27,0,-5,5,1,0,-2,1,-1,-1,1,2,-1
KR_6764403434,440,-7,-12,0,-14,-6,7,1,-4,5,1,-1,1,0,1,1,2,-4,4,0,0,-13,2,0,-6,6,-3,0,-1,-1,1,-1,-1,3,-1
KR_6762930940,420,-2,-43,-10,-9,-4,4,0,0,1,1,1,1,2,-6,8,2,0,1,1,-1,-4,13,2,-5,3,0,0,0,-1,-1,0,-1,2,-1
KR_6763628337,420,1,28,0,3,-3,3,0,2,2,4,1,3,4,1,3,4,2,0,2,0,11,-32,4,-6,2,4,0,0,-1,1,0,1,3,-1
KR_6610576001,420,-4,-41,0,-12,-2,4,2,-1,1,0,-1,1,0,-7,8,1,-1,1,0,0,-16,11,0,-6,6,-3,0,-1,1,-1,-1,-1,1,-1
KR_6748358647,420,0,-98,20,6,0,2,2,9,2,11,-6,6,0,-2,6,4,5,0,5,1,8,3,9,-10,1,-1,0,-1,1,1,-1,1,3,-1
KR_6746953256,420,2,70,45,7,3,2,5,-4,5,1,3,0,3,-2,7,5,7,1,8,2,7,-1,-4,-2,6,-2,0,0,0,0,1,1,0,-1
KR_6729527153,420,-5,-84,-12,-18,-1,1,0,-7,8,1,-7,8,1,-3,4,1,0,0,0,-1,-17,3,1,-5,4,-1,0,0,1,-1,-1,-1,2,-1
KR_6705013587,420,-3,-26,-24,-4,-1,4,3,0,3,3,-1,1,0,-2,3,1,0,1,1,0,-9,203,0,-2,2,-8,0,0,-1,-1,-1,-1,3,-1
KR_6630959707,420,-3,29,-6,-8,-3,4,1,-4,7,3,-2,3,1,1,4,5,0,2,2,1,-16,2,-1,-4,5,-3,0,0,-1,-1,0,1,5,-1
KR_6716158594,420,2,-13,-4,-4,-2,2,0,-1,2,1,2,4,6,-1,3,2,-2,4,2,1,-9,-1,-3,-3,6,5,0,-1,1,1,-1,1,5,-1
KR_6635484367,420,-2,-29,7,-2,-1,1,0,-5,7,2,4,1,5,-3,3,0,3,0,3,0,-2,-29,3,-4,1,0,0,1,-1,-1,1,1,3,-1
KR_6694965369,420,-2,23,-14,-1,-5,5,0,2,3,5,4,2,6,-1,1,0,-1,1,0,0,3,-13,0,-2,2,2,0,-2,-1,-1,-1,-1,1,-1
KR_6752945322,420,-2,-68,11,-2,-3,3,0,1,0,1,1,1,2,1,0,1,-2,2,0,0,-2,3,2,-7,5,-4,0,-1,-1,1,-1,-1,4,-1
KR_6765788518,440,0,0,-24,0,2,3,5,-4,4,0,-1,1,0,-3,4,1,6,1,7,0,-6,11,4,-5,1,-2,0,-1,0,-1,-1,1,0,-1
KR_6762915682,420,0,31,-11,-3,-1,2,1,1,1,2,3,0,3,-4,5,1,-2,2,0,0,-6,-5,-3,-3,6,1,0,0,-1,-1,-1,-1,6,-1
KR_6685849018,420,1,-18,-3,3,-2,2,0,0,3,3,0,1,1,3,0,3,2,0,2,0,3,-14,0,-5,5,2,0,0,-1,-1,-1,1,3,-1
KR_6761496995,420,2,58,-4,-1,-1,2,1,-2,4,2,0,1,1,2,1,3,0,1,1,0,-2,-16,3,-4,1,5,0,1,1,-1,1,-1,4,-1
KR_6713830049,440,-2,-40,-12,-6,0,2,2,-1,3,2,1,2,3,-2,3,1,-4,5,1,0,-13,4,4,-6,2,-2,0,-1,0,-1,-1,-1,0,-1
KR_6730077646,420,0,-7,-16,2,-1,1,0,1,1,2,3,1,4,-2,4,2,1,0,1,0,1,-6,0,-5,5,-2,0,0,-1,1,0,1,4,-1
KR_6489684044,420,-2,-30,16,-4,-1,2,1,-1,6,5,-2,4,2,0,0,0,0,1,1,0,-5,-317,-2,-4,6,-1,0,0,-1,-1,-1,-1,6,-1
KR_6744079907,420,-2,-14,-11,-1,-6,6,0,6,1,7,-3,4,1,1,1,2,1,0,1,0,1,-2,-2,-3,5,-5,0,-1,-1,-1,-1,-1,2,-1
KR_6740525843,440,3,-6,-20,-1,-2,2,0,0,2,2,-3,4,1,2,1,3,2,0,2,1,2,-18,-1,-3,4,-1,0,-1,1,-1,-1,1,2,-1
KR_6660189202,420,-1,-7,-19,-3,0,1,1,-3,5,2,2,0,2,-1,2,1,-1,1,0,0,-7,-44,-2,-4,6,0,0,0,0,1,0,-1,0,-1
KR_6737864027,440,-6,-51,-16,-6,-1,3,2,-2,2,0,1,2,3,-2,4,2,-2,3,1,0,-2,0,-1,-3,4,-2,0,-1,-1,1,-1,-1,2,-1
KR_6744243608,420,-4,-14,-12,-10,-5,5,0,-7,9,2,-6,7,1,5,0,5,3,0,3,0,-6,11,-6,-3,9,2,0,0,0,0,0,-1,0,-1
KR_6533689227,420,2,112,9,5,6,0,6,-4,4,0,2,4,6,1,1,2,0,1,1,0,-5,15,2,-7,5,-2,0,0,0,-1,1,-1,0,-1
KR_6751045837,420,-1,-7,28,-9,-2,2,0,-3,5,2,1,1,2,-8,8,0,3,1,4,-2,-19,-27,0,-7,7,-2,0,-1,1,1,-1,-1,5,-1
KR_6707343286,420,-2,-63,-2,2,-2,3,1,2,1,3,3,2,5,3,1,4,-4,4,0,1,1,38,1,-5,4,1,0,0,1,0,0,1,6,-1
KR_6677328068,420,1,-55,1,-2,3,0,3,-5,6,1,0,2,2,2,4,6,-2,4,2,-1,-8,6,-2,-7,9,-3,0,0,0,1,0,-1,0,-1
KR_6760619736,420,-2,-50,7,-9,1,2,3,-7,7,0,2,1,3,-4,5,1,-1,2,1,0,-4,-11,-9,-3,12,8,0,0,-1,-1,0,-1,1,-1
KR_6766858514,420,-4,-3,-20,-3,0,1,1,1,2,3,0,4,4,0,1,1,-4,4,0,-2,-8,157,6,-7,1,0,0,-3,1,-1,-1,-1,2,-1
KR_6765838464,440,-2,38,-6,-10,-5,5,0,0,3,3,-3,5,2,-1,4,3,-1,2,1,0,-8,68,-3,-3,6,-2,0,0,-1,0,0,-1,5,-1
KR_6726287405,420,-4,-90,-28,-10,-1,3,2,0,1,1,0,2,2,-3,7,4,-6,6,0,0,-5,-176,1,-5,4,12,0,-2,-1,-1,-1,-1,3,-1
KR_6644914969,420,0,22,-28,-4,5,1,6,4,2,6,-8,9,1,0,4,4,-5,5,0,0,2,-3,1,-2,1,-2,0,1,-1,-1,1,1,1,-1
KR_6758231461,420,-3,-85,-24,-6,-2,4,2,-1,5,4,-2,3,1,-1,3,2,0,0,0,0,-4,-4,0,-4,4,-4,0,0,1,-1,-1,-1,3,-1
KR_6717286567,420,1,22,4,-2,1,2,3,1,4,5,-2,2,0,-3,3,0,1,0,1,0,-2,3,-1,-4,5,-4,0,0,-1,1,0,-1,4,-1
KR_6348231954,420,-8,-116,-42,-13,-5,5,0,-7,7,0,0,1,1,0,2,2,-1,2,1,-2,-10,-18,-3,-3,6,3,0,-2,-1,-1,-1,-1,1,-1
KR_6652129413,440,-2,-31,-13,-7,-2,2,0,-2,4,2,-6,7,1,2,2,4,1,2,3,0,-2,-3,-3,0,3,1,0,-1,0,-1,-1,-1,0,-1
KR_6758186490,440,3,8,6,6,1,2,3,-2,4,2,4,0,4,2,1,3,1,2,3,0,5,-2,3,-5,2,5,0,1,0,0,1,-1,0,-1
KR_6715789767,420,-1,49,-56,-5,1,4,5,2,2,4,-7,7,0,2,2,4,-3,3,0,0,-6,32,-1,-3,4,1,0,0,-1,-1,1,-1,4,-1
KR_6759615108,440,3,-2,11,10,2,2,4,7,0,7,-4,4,0,5,1,6,0,0,0,0,10,-39,-1,-3,4,20,0,0,1,1,1,1,4,-1
KR_6751291081,420,-3,89,-12,-9,1,1,2,-4,5,1,2,1,3,-3,3,0,-5,5,0,0,-12,25,2,-6,4,-3,0,-1,0,-1,-1,-1,0,-1
KR_6763068004,420,-3,-71,-28,-2,-1,3,2,-2,3,1,-1,2,1,-1,2,1,3,1,4,0,2,-16,-3,-1,4,3,0,-1,-1,-1,-1,-1,2,-1
KR_6617543973,420,-1,-25,-29,-3,-2,3,1,-1,8,7,-3,5,2,0,5,5,3,0,3,0,1,5,2,-6,4,-3,0,0,-1,1,0,1,1,-1
KR_6764896871,420,0,25,-4,-6,-3,4,1,-1,1,0,-1,1,0,-2,4,2,1,0,1,0,-3,55,3,-5,2,2,0,0,-1,-1,0,-1,4,-1
KR_6737572301,420,0,39,3,-2,-5,6,1,1,3,4,5,1,6,-2,3,1,-1,1,0,0,-6,-9,-5,-1,6,4,0,-1,1,-1,-1,-1,6,-1
KR_6758466199,420,-5,-37,-12,-12,4,1,5,-1,2,1,-8,8,0,-8,10,2,1,0,1,0,-11,-2,3,-6,3,-4,0,-2,-1,-1,-1,-1,6,-1
KR_6763649833,420,-1,-4,11,-4,2,1,3,-2,3,1,0,4,4,-3,3,0,-1,2,1,-1,-6,-14,-1,-7,8,-1,0,0,1,0,0,-1,1,-1
KR_6758090216,420,-3,7,-23,-10,-3,4,1,-3,5,2,-4,4,0,0,3,3,0,0,0,0,-5,-3,3,-9,6,-3,0,0,1,0,-1,-1,2,-1
KR_6725852836,420,-3,26,-12,-8,-5,7,2,-1,2,1,2,5,7,-3,4,1,-1,2,1,2,-9,17,0,-3,3,-1,0,0,-1,1,-1,1,2,-1
KR_6664964009,420,-1,-142,27,-9,4,1,5,-2,3,1,-6,8,2,-4,5,1,-1,2,1,0,-3,-22,0,-5,5,-4,0,-3,-1,-1,-1,-1,1,-1
KR_6671189765,420,0,-28,-17,-1,-1,3,2,-3,4,1,-1,1,0,3,3,6,1,0,1,0,1,11,4,-8,4,-2,0,1,0,0,1,1,0,-1
KR_6743816662,420,2,-23,-2,8,0,1,1,3,1,4,3,0,3,2,3,5,0,1,1,0,2,-5,-5,-2,7,7,0,0,0,0,0,-1,0,-1
KR_6712305210,420,-4,-80,11,-7,-1,5,4,0,2,2,-6,9,3,0,1,1,0,1,1,0,-6,34,2,-5,3,1,0,-2,1,1,-1,-1,5,-1
KR_6766026174,420,0,-37,0,3,3,0,3,4,0,4,-2,3,1,2,4,6,-4,5,1,0,4,0,0,-4,4,5,0,1,1,1,1,1,1,-1
KR_6743706536,420,1,54,3,3,2,0,2,-2,4,2,0,1,1,4,1,5,-1,1,0,2,5,-4,1,-3,2,-3,0,0,-1,1,0,1,6,-1
KR_6627070554,420,-6,-62,-6,-9,-2,3,1,-2,5,3,0,1,1,-3,4,1,-2,2,0,0,-10,1,2,-5,3,-6,0,0,1,1,0,-1,5,-1
KR_6714368906,420,-4,-59,-12,-6,6,0,6,-6,10,4,1,1,2,-7,7,0,0,1,1,-1,-17,-4,-6,-2,8,0,0,-2,-1,1,-1,-1,4,-1
KR_6703849184,420,-3,-87,-24,-6,0,1,1,1,2,3,-7,8,1,-1,3,2,1,3,4,1,-4,0,-2,0,2,1,0,0,-1,1,-1,1,1,-1
KR_6740411878,420,0,-5,-5,0,2,0,2,-3,5,2,2,0,2,1,3,4,-2,4,2,0,-6,-21,0,-4,4,3,0,0,1,-1,-1,-1,4,-1
KR_6616905350,420,-2,50,-16,-3,2,3,5,-1,3,2,1,2,3,-6,7,1,1,1,2,1,-14,281,2,-4,2,-1,0,0,-1,1,1,1,1,-1
KR_6754552302,420,-1,-52,4,-3,-2,4,2,-2,4,2,2,1,3,-1,2,1,0,1,1,0,1,2,0,-6,6,-1,0,-1,1,-1,-1,-1,2,-1
KR_6764265288,440,-5,-148,-25,-5,-2,3,1,1,5,6,-4,4,0,-2,2,0,2,0,2,0,-5,-22,-3,-4,7,0,0,-2,-1,1,-1,-1,3,-1
KR_6737805257,440,2,45,-16,2,1,2,3,-3,5,2,1,1,2,4,0,4,-1,2,1,1,7,-12,-4,-3,7,7,0,1,-1,1,1,1,5,-1
KR_6759827210,420,-5,-42,-15,-12,-3,5,2,0,3,3,-5,5,0,-2,2,0,-2,3,1,0,-7,-13,-6,-2,8,1,0,-2,-1,-1,-1,-1,4,-1
KR_6050764663,420,-2,41,4,-5,-4,4,0,-2,3,1,-3,3,0,3,2,5,1,1,2,0,0,-18,2,-8,6,2,0,-1,-1,-1,-1,1,2,-1
KR_6766040442,420,1,31,-5,-2,-2,2,0,-2,4,2,3,1,4,0,5,5,-1,3,2,0,-4,116,5,-8,3,4,0,0,-1,1,0,-1,2,-1
KR_6717776205,420,1,0,-8,-3,2,2,4,-3,6,3,2,0,2,-1,2,1,-3,3,0,0,-4,1,0,-4,4,1,0,1,1,1,-1,-1,5,-1
KR_6754903958,420,1,24,23,0,2,0,2,-2,3,1,3,2,5,-4,4,0,1,0,1,0,-4,18,-2,-4,6,2,0,0,-1,1,1,1,5,-1
KR_6753543340,420,0,-4,15,-11,0,2,2,-11,11,0,0,0,0,1,3,4,-1,1,0,0,-16,-9,-3,-5,8,-2,0,0,-1,-1,1,-1,4,-1
KR_6731320309,440,-5,-38,-24,-7,-3,5,2,-2,3,1,-5,5,0,1,0,1,2,0,2,0,1,-2,-1,-6,7,-3,0,0,-1,1,1,-1,1,-1
KR_6612298934,420,1,32,1,3,3,1,4,2,2,4,1,1,2,-5,7,2,2,0,2,0,-1,-4,2,-5,3,3,0,1,-1,1,1,-1,3,-1
KR_6751086693,420,-1,-24,-16,1,-3,5,2,1,2,3,-1,3,2,2,1,3,2,1,3,0,5,10,3,-7,4,-1,0,-2,-1,1,-1,-1,1,-1
KR_6664238565,420,-7,-110,-50,-8,-1,3,2,-6,8,2,0,1,1,0,0,0,-1,1,0,0,-4,-290,-2,-2,4,1,0,-2,-1,-1,-1,-1,3,-1
KR_6747592488,420,-6,-98,11,-16,-5,5,0,0,1,1,4,2,6,-10,10,0,-5,6,1,0,-5,2,0,-3,3,0,0,-2,0,-1,-1,-1,0,-1
KR_6629547396,420,-7,-119,-28,-7,-5,5,0,-1,2,1,-4,4,0,2,0,2,1,0,1,0,3,-6,2,-4,2,1,0,0,1,-1,0,-1,2,-1
KR_6701682457,420,0,-14,-18,0,2,1,3,-4,6,2,-1,2,1,2,0,2,1,0,1,0,5,-9,-5,-1,6,-2,0,0,-1,-1,-1,1,3,-1
KR_6759604967,420,0,21,2,-4,-5,5,0,0,3,3,-3,3,0,5,2,7,-1,1,0,0,-4,-5,-2,-1,3,3,0,-1,0,-1,-1,1,0,-1
KR_6744848034,420,-2,29,-18,-5,-5,6,1,0,0,0,0,3,3,0,3,3,0,1,1,0,-9,14,3,-6,3,-2,0,0,-1,-1,0,1,3,-1
KR_6635008070,420,-1,36,-8,-1,2,0,2,6,0,6,4,0,4,-13,13,0,0,0,0,0,-4,9,2,-5,3,-1,0,-1,1,-1,-1,-1,4,-1
KR_6760968876,420,-1,-9,-8,-5,-4,5,1,-4,5,1,2,0,2,0,2,2,1,0,1,0,3,28,5,-7,2,2,0,0,1,-1,0,-1,3,-1
KR_6581712534,420,-3,-55,-1,-2,-3,4,1,1,1,2,3,1,4,-4,6,2,1,0,1,0,-1,6,0,-3,3,-2,0,-2,-1,1,-1,-1,6,-1
KR_6764021955,420,-3,-28,2,-11,0,1,1,-6,8,2,0,2,2,0,3,3,-5,5,0,0,-10,100,-2,-6,8,1,0,-1,-1,1,-1,-1,5,-1
KR_6621791955,420,0,7,-29,5,2,1,3,-1,4,3,1,3,4,2,0,2,1,0,1,0,4,-9,2,-6,4,1,0,1,0,-1,1,1,0,-1
KR_6684229534,420,-3,-26,20,-16,-4,4,0,-3,3,0,-5,6,1,-6,7,1,2,0,2,-2,-16,4,-1,-2,3,1,0,-1,-1,-1,-1,-1,2,-1
KR_6731656047,420,-1,-31,12,-2,-6,6,0,0,1,1,1,3,4,-1,3,2,4,0,4,0,2,142,-6,-2,8,5,0,0,1,-1,-1,-1,6,-1
KR_6725801808,420,1,51,-17,-2,1,3,4,-1,2,1,-2,3,1,0,1,1,0,1,1,0,-3,-4,0,-7,7,-1,0,-1,-1,-1,-1,-1,4,-1
KR_6766469023,420,0,100,-3,1,1,2,3,-5,6,1,-3,5,2,8,0,8,0,0,0,0,0,2,2,-4,2,-2,0,2,1,-1,1,1,2,-1
KR_6749873402,420,-2,-14,-5,-3,-3,5,2,-1,2,1,1,5,6,-2,4,2,2,1,3,-1,0,-1,-6,0,6,1,0,-1,-1,-1,-1,-1,4,-1
KR_6676712842,420,-3,9,-12,-9,0,0,0,-1,3,2,-4,4,0,0,2,2,-4,4,0,0,-5,103,1,-5,4,-2,0,-2,-1,-1,-1,-1,6,-1
KR_6722323520,420,-1,2,-7,-8,1,2,3,0,1,1,3,0,3,0,1,1,-12,12,0,-1,-8,59,2,-5,3,-24,0,2,-1,1,1,-1,5,-1
KR_6746514520,420,-1,-74,-7,-2,1,0,1,-3,6,3,1,1,2,-2,2,0,1,2,3,-1,0,-16,-2,-6,8,1,0,1,0,0,1,-1,0,-1
KR_6709241136,420,0,-21,-4,2,0,2,2,-4,6,2,2,3,5,3,0,3,1,4,5,0,-2,-18,-4,-4,8,6,0,1,-1,1,1,1,4,-1
KR_6718042717,440,-2,-75,-20,8,1,1,2,5,0,5,-4,5,1,0,0,0,6,0,6,0,4,-361,-3,-3,6,0,0,0,-1,1,0,1,1,-1
KR_6766771541,420,3,24,-7,8,-4,4,0,4,4,8,-3,4,1,7,1,8,4,0,4,0,12,-36,1,-4,3,15,0,2,1,-1,1,-1,3,-1
KR_6755519080,420,-6,-61,-22,-15,2,1,3,-7,7,0,-5,5,0,-3,5,2,-2,2,0,0,-17,24,3,-6,3,-1,0,-3,-1,1,-1,-1,5,-1
KR_6748904631,420,-1,-28,4,-4,0,0,0,-2,4,2,-5,5,0,2,3,5,1,0,1,-1,2,-3,-2,-3,5,2,0,-1,-1,1,-1,-1,6,-1
KR_6758031509,420,-1,25,12,0,-5,5,0,4,4,8,2,0,2,-1,2,1,0,1,1,0,4,11,0,-4,4,0,0,0,0,-1,1,1,0,-1
KR_6736034087,420,-3,6,-16,-2,-3,3,0,-3,4,1,3,1,4,1,2,3,0,0,0,0,-4,-7,3,-9,6,2,0,0,-1,0,0,-1,6,-1
KR_6748057672,420,-3,-90,-16,-4,1,3,4,1,5,6,-4,4,0,-2,3,1,0,1,1,0,0,11,0,-6,6,-3,0,0,1,-1,0,1,3,-1
KR_6706908330,420,2,3,16,0,-5,5,0,3,4,7,2,1,3,-1,2,1,1,1,2,0,-3,11,2,-6,4,-3,0,0,-1,-1,-1,1,4,-1
KR_6679590309,420,-6,-108,0,-6,0,1,1,2,1,3,-3,4,1,-4,4,0,-1,1,0,0,-7,-3,-2,-5,7,2,0,-2,-1,-1,-1,1,5,-1
KR_6764253292,420,-2,-16,5,-9,-2,4,2,0,2,2,2,1,3,-5,5,0,-4,4,0,0,-6,-48,-2,-4,6,17,0,-1,1,1,-1,1,5,-1
KR_6747202302,420,4,104,13,6,3,1,4,-3,3,0,4,1,5,2,1,3,0,2,2,0,-5,-3,0,-2,2,0,0,3,1,1,1,1,4,-1
KR_6630290201,420,4,76,8,1,-1,3,2,4,0,4,-4,8,4,3,1,4,-1,2,1,0,5,0,0,-6,6,4,0,3,-1,1,1,1,4,-1
KR_6753157650,420,-2,-105,-11,-3,-5,6,1,-1,5,4,0,2,2,0,3,3,3,0,3,-1,-1,6,6,-8,2,-2,0,-1,1,0,-1,-1,3,-1
KR_6342676396,420,-2,-49,-32,0,1,0,1,1,2,3,-1,2,1,2,1,3,-3,3,0,0,5,48,1,-9,8,4,0,-1,1,0,-1,1,6,-1
KR_6745462693,440,-2,-51,-8,-1,-7,8,1,1,2,3,4,1,5,0,1,1,1,1,2,0,0,-27,2,-2,0,9,0,0,0,0,1,1,0,-1
KR_6677259543,420,-5,-68,-23,-14,-5,6,1,-3,3,0,-1,1,0,-3,3,0,-2,2,0,0,-11,-15,-4,-3,7,-2,0,-2,-1,-1,-1,-1,2,-1
KR_6651868967,420,0,-36,19,3,0,1,1,3,2,5,3,0,3,-1,5,4,-2,2,0,0,-1,-14,1,-5,4,1,0,0,1,-1,-1,1,3,-1
KR_6721251967,420,-7,-56,-40,-17,-12,13,1,-2,2,0,-1,2,1,-2,3,1,0,0,0,0,-11,-10,-1,-2,3,-2,0,-2,-1,-1,-1,1,1,-1
KR_6680310467,420,0,31,-40,8,2,1,3,1,2,3,-3,5,2,2,2,4,6,1,7,0,9,95,0,-3,3,7,0,1,1,-1,1,1,6,-1
KR_6750862129,440,4,60,30,9,1,0,1,0,2,2,1,4,5,3,0,3,4,2,6,2,6,1,0,-2,2,1,0,1,1,-1,1,1,6,-1
KR_6733027673,420,-5,-80,0,-9,1,2,3,-2,4,2,-4,4,0,-3,4,1,-1,1,0,0,-10,-126,0,-3,3,0,0,-2,1,1,-1,-1,1,-1
KR_6758096951,420,-2,-55,42,-2,1,1,2,0,3,3,6,0,6,-8,10,2,-1,3,2,-2,-7,-10,-3,-6,9,3,0,-2,-1,1,-1,-1,1,-1
KR_6764558968,420,0,16,-27,-3,6,1,7,-1,3,2,-2,2,0,-5,5,0,-1,2,1,0,-4,210,-2,0,2,1,0,1,-1,-1,1,1,6,-1
KR_6710965125,420,-4,-167,-13,-9,-4,4,0,-1,3,2,-6,7,1,1,2,3,1,0,1,0,2,-22,2,-5,3,-1,0,-2,0,0,-1,-1,0,-1
KR_6708069013,420,-4,-81,-34,-4,-1,3,2,0,3,3,1,4,5,0,1,1,-4,5,1,0,6,-15,-5,-4,9,1,0,-1,-1,-1,-1,-1,4,-1
KR_6703205116,420,-8,-140,-33,-17,-8,8,0,-3,5,2,-4,4,0,-1,1,0,-1,2,1,0,-8,-5,0,-3,3,-2,0,-3,-1,-1,-1,-1,4,-1
KR_6766823077,420,-4,-22,-15,-10,-1,1,0,-3,5,2,1,3,4,-1,3,2,-6,8,2,0,-8,-45,1,-7,6,1,0,1,-1,-1,1,1,4,-1
KR_6767624053,420,-3,-10,3,-3,1,1,2,-3,4,1,0,3,3,2,2,4,-3,3,0,0,-5,-57,-2,-3,5,0,0,0,0,1,1,1,0,-1
KR_6747310071,420,0,-2,0,-9,-4,6,2,-6,8,2,0,0,0,0,4,4,1,1,2,-3,-10,-4,-1,-3,4,-2,0,0,1,-1,-1,-1,2,-1
KR_6620065844,420,-5,-27,-35,-15,-3,5,2,-4,8,4,-5,5,0,-3,5,2,0,1,1,1,-15,7,-1,-7,8,-5,0,-1,1,-1,-1,1,2,-1
KR_6730909502,440,-4,-113,-12,-5,0,2,2,0,1,1,-3,4,1,0,2,2,-2,5,3,-1,-4,-5,-1,-4,5,-4,0,-2,1,-1,-1,-1,2,-1
KR_6765149008,420,0,49,8,-2,0,3,3,0,3,3,-1,4,3,-1,2,1,0,1,1,0,0,-4,9,-12,3,5,0,1,-1,-1,1,-1,2,-1
KR_6644970831,420,-1,-47,-16,-4,1,1,2,-4,6,2,-5,5,0,2,3,5,2,0,2,0,-4,-6,-3,-5,8,2,0,1,-1,1,1,-1,1,-1
KR_6733611288,420,-6,-75,-1,-14,-2,4,2,-6,8,2,-2,4,2,-4,4,0,0,1,1,-1,-14,-8,-5,-4,9,4,0,-3,-1,-1,-1,-1,3,-1
KR_6696671885,420,0,74,24,-1,1,1,2,-1,4,3,-2,4,2,1,3,4,0,4,4,0,-5,-14,1,-8,7,3,0,0,1,-1,0,1,1,-1
KR_6631811051,420,0,22,12,4,1,1,2,-4,7,3,5,0,5,1,2,3,1,1,2,2,2,-1,2,-4,2,-1,0,1,1,-1,-1,1,2,-1
KR_6660886191,440,-2,17,-8,3,4,2,6,-2,4,2,-1,2,1,-1,3,2,3,1,4,0,1,-5,3,-5,2,2,0,0,-1,1,0,-1,6,-1
KR_6697102939,420,1,-4,-36,0,-3,3,0,1,0,1,2,2,4,2,1,3,-2,2,0,0,2,3,5,-8,3,0,0,0,1,0,0,-1,1,-1
KR_6713108664,420,2,15,17,2,-1,1,0,1,5,6,-1,2,1,3,1,4,0,1,1,0,1,-42,1,-4,3,26,0,1,-1,1,1,-1,1,-1
KR_6751333519,420,-1,27,4,-1,-1,2,1,1,2,3,2,2,4,-2,4,2,-1,3,2,1,2,-9,-6,-3,9,4,0,1,-1,1,1,1,4,-1
KR_6747431968,420,0,-32,-1,-7,-1,3,2,-5,5,0,1,0,1,1,3,4,-3,3,0,1,-10,2,-3,-6,9,2,0,0,-1,0,0,1,5,-1
KR_6679478484,420,-7,-113,-20,-18,-4,5,1,-4,4,0,-2,2,0,-8,8,0,0,0,0,0,-19,209,1,-6,5,-4,0,-2,-1,-1,-1,-1,4,-1
KR_6765706085,420,-2,-85,-10,-5,-3,4,1,0,6,6,-2,5,3,4,2,6,-4,6,2,-3,8,2,5,-10,5,6,0,-1,1,-1,-1,-1,2,-1
KR_6697075021,420,3,11,22,2,0,2,2,5,1,6,-2,4,2,-3,3,0,2,0,2,0,4,-6,0,-5,5,0,0,-2,1,1,-1,-1,3,-1
KR_6701899440,420,3,-20,24,-2,-4,4,0,0,8,8,-1,2,1,3,1,4,0,0,0,0,8,195,-3,-1,4,3,0,0,-1,-1,-1,1,3,-1
KR_6742922628,420,-3,16,7,-5,2,1,3,-4,6,2,0,2,2,-2,3,1,-1,1,0,0,-9,-4,-2,-1,3,-5,0,0,-1,-1,-1,-1,5,-1
KR_6755309513,420,1,32,-18,2,1,3,4,3,3,6,-3,3,0,1,4,5,0,0,0,0,4,-102,1,-7,6,4,0,0,-1,-1,0,1,3,-1
KR_6581772283,420,-3,-41,-3,-1,5,0,5,-3,4,1,-4,5,1,0,2,2,1,1,2,0,0,-2,0,-6,6,3,0,2,1,1,1,-1,1,-1
KR_6751221052,440,-4,1,25,-7,3,0,3,-2,2,0,0,3,3,-7,7,0,-1,2,1,0,-7,-5,-4,-1,5,1,0,0,1,0,0,-1,1,-1
KR_6677139249,420,2,38,-23,-4,-1,1,0,-2,4,2,0,1,1,-1,8,7,0,0,0,0,2,-30,-3,-3,6,1,0,0,-1,-1,0,-1,6,-1
KR_6676847819,420,-3,-48,-8,-5,-2,3,1,2,4,6,-2,3,1,-5,5,0,2,1,3,0,-5,0,8,-12,4,-3,0,-1,-1,-1,-1,1,4,-1
KR_6715608548,420,-3,-4,-9,-5,2,4,6,-6,7,1,5,1,6,-5,9,4,-1,2,1,2,9,-4,3,-5,2,3,0,-1,1,-1,-1,-1,3,-1
KR_6745036767,420,-1,-6,0,-5,-1,4,3,1,0,1,-5,5,0,0,1,1,0,1,1,0,-4,-2,0,-6,6,0,0,0,1,-1,0,-1,2,-1
KR_6746095671,420,-1,-11,44,-11,-4,4,0,0,3,3,1,1,2,-5,6,1,-3,3,0,0,-15,-12,-8,-1,9,1,0,-1,1,-1,-1,-1,5,-1
KR_6595303548,420,-3,-91,-47,-10,-1,3,2,-4,8,4,-1,1,0,-1,2,1,-3,5,2,0,-7,8,4,-5,1,0,0,-2,1,-1,-1,1,4,-1
KR_6716042736,420,-4,-1,-33,-4,2,2,4,-1,2,1,-4,5,1,-1,2,1,0,0,0,0,-1,5,-1,-5,6,-3,0,0,0,1,0,1,0,-1
KR_6708964106,440,-3,-18,-26,-3,2,2,4,1,0,1,1,2,3,-6,6,0,-1,5,4,1,8,32,-1,-5,6,-7,0,0,-1,-1,0,1,6,-1
KR_6755684966,420,4,43,5,6,1,1,2,6,0,6,3,0,3,-3,5,2,-1,2,1,0,3,7,4,-5,1,-3,0,0,1,-1,0,-1,5,-1
KR_6690965663,420,-3,-56,18,-7,0,4,4,2,4,6,-3,3,0,-6,6,0,0,0,0,0,-2,-17,5,-7,2,-5,0,-1,-1,1,-1,1,1,-1
KR_6762566800,420,-5,-82,-47,-5,-5,5,0,0,0,0,-1,4,3,0,4,4,1,1,2,0,-1,-25,2,-5,3,21,0,-1,-1,1,-1,1,2,-1
KR_6762987489,440,5,47,19,10,4,3,7,2,2,4,4,2,6,1,2,3,-1,2,1,1,11,-284,0,-1,1,0,0,1,1,0,1,1,5,-1
KR_6761887522,420,0,-70,-19,3,-1,2,1,3,2,5,3,2,5,-3,3,0,1,1,2,-1,3,-19,-4,-2,6,5,0,0,-1,0,-1,-1,2,-1
KR_6743510484,440,-4,-88,-24,-6,1,0,1,2,1,3,-1,2,1,-7,7,0,-1,1,0,1,-10,-14,-1,-4,5,0,0,0,-1,1,0,1,6,-1
KR_6608186076,420,1,63,24,-5,-1,2,1,1,2,3,-2,3,1,-4,5,1,1,2,3,0,-9,26,4,-6,2,0,0,0,-1,1,1,-1,5,-1
KR_6655713997,420,-2,-59,37,1,-2,3,1,-1,2,1,-3,3,0,2,3,5,5,1,6,1,7,2,-3,-3,6,-3,0,0,1,-1,0,1,6,-1
KR_6758678095,440,-6,-89,0,-19,-9,10,1,1,1,2,-3,3,0,-3,6,3,-5,5,0,0,-19,0,0,-2,2,0,0,-3,0,0,-1,-1,0,-1
KR_6760880030,420,-2,13,10,-8,-3,3,0,-1,2,1,0,2,2,-3,3,0,-1,2,1,0,-14,0,-2,-2,4,1,0,-2,-1,0,-1,1,5,-1
KR_6735743025,440,1,-50,48,0,-1,2,1,1,3,4,-1,3,2,0,5,5,1,0,1,-1,-4,-5,-1,-1,2,2,0,1,1,-1,1,-1,2,-1
KR_6651093822,420,2,-39,14,2,1,2,3,-4,5,1,0,2,2,3,3,6,2,0,2,0,5,-11,-4,-2,6,1,0,1,1,-1,1,1,1,-1
KR_6748328228,420,-2,-61,-20,-6,-7,7,0,0,3,3,2,2,4,-1,1,0,0,0,0,-1,1,-104,4,-6,2,-2,0,-2,-1,-1,-1,-1,5,-1
KR_6759523870,420,-2,7,-1,-11,-4,5,1,-4,6,2,2,1,3,-1,3,2,-4,6,2,0,-9,-7,1,-5,4,-1,0,-1,-1,1,-1,-1,3,-1
KR_6759887026,440,0,-37,0,-2,2,1,3,0,3,3,1,4,5,-6,7,1,1,3,4,0,3,-8,0,0,0,1,0,-1,-1,1,-1,-1,2,-1
KR_6754931185,420,-4,-42,9,-5,-1,3,2,0,5,5,1,0,1,-4,4,0,-1,5,4,0,0,-5,-4,-1,5,0,0,0,-1,-1,0,-1,5,-1
KR_6610162636,420,-4,43,-15,-6,3,0,3,-5,6,1,-4,4,0,0,2,2,0,0,0,0,-12,-7,2,-11,9,-2,0,1,1,1,1,1,1,-1
KR_6763909573,420,-6,-6,-20,-15,-2,3,1,-16,16,0,1,2,3,1,1,2,1,0,1,0,-18,-10,-2,-3,5,0,0,-2,0,-1,-1,1,0,-1
KR_6729379160,420,-5,-11,-25,-10,-2,3,1,-4,7,3,2,0,2,-2,5,3,-4,4,0,-1,-7,-4,3,-7,4,-3,0,-1,-1,-1,-1,-1,6,-1
KR_6708643464,420,-2,5,-8,-11,-1,2,1,-5,5,0,0,2,2,-4,4,0,-1,1,0,0,-17,34,-6,-4,10,-24,0,-1,-1,-1,-1,-1,4,-1
KR_6762094773,420,0,11,2,9,4,1,5,1,2,3,3,2,5,2,1,3,-1,2,1,0,10,6,2,-5,3,4,0,-1,1,-1,-1,1,2,-1
KR_6719475818,420,0,22,-24,-7,2,2,4,-1,1,0,-3,3,0,-5,6,1,0,2,2,0,-10,2,-4,-4,8,-12,0,0,-1,1,0,-1,4,-1
KR_6728754788,420,-2,-45,-16,-6,2,1,3,-2,6,4,-3,5,2,-2,6,4,-1,1,0,-1,-7,-2,-2,-3,5,-3,0,-2,0,1,-1,-1,0,-1
KR_6751006843,440,0,-18,-8,-2,2,2,4,-1,3,2,1,3,4,-4,5,1,0,4,4,0,-2,-7,-1,-2,3,-2,0,-1,-1,-1,-1,-1,6,-1
KR_6761017853,420,0,22,-32,0,1,2,3,1,2,3,5,2,7,-6,7,1,-1,3,2,0,2,-97,-1,-3,4,2,0,0,-1,-1,-1,-1,4,-1
KR_6760805980,440,-2,-30,8,6,-1,1,0,1,3,4,2,1,3,4,1,5,0,1,1,0,9,6,2,-8,6,-2,0,0,1,0,0,-1,5,-1
KR_6658566241,420,-4,-31,13,-9,-4,4,0,0,4,4,-2,2,0,0,2,2,-3,3,0,0,-9,-24,2,-4,2,6,0,-1,1,-1,-1,-1,6,-1
KR_6762912776,420,-3,-63,22,-6,0,2,2,-3,4,1,1,0,1,-5,6,1,1,0,1,0,-4,12,2,-3,1,-2,0,0,-1,1,0,-1,1,-1
KR_6702933436,420,0,-4,-11,-2,-1,3,2,-3,7,4,2,3,5,-1,4,3,1,1,2,0,-1,0,-1,-3,4,0,0,-1,1,-1,-1,-1,6,-1
KR_6549387737,420,-3,-34,-18,-9,-1,3,2,-3,7,4,-4,5,1,-1,2,1,0,0,0,0,-15,-18,-7,-1,8,2,0,0,-1,0,0,-1,6,-1
KR_6751190198,420,-1,-5,-16,1,-5,5,0,1,1,2,-1,2,1,4,4,8,2,0,2,0,7,1,1,-7,6,-3,0,-2,-1,-1,-1,1,6,-1
KR_6672211510,420,-2,-38,0,-7,3,0,3,0,4,4,-5,6,1,-2,4,2,-3,3,0,0,0,4,-5,-3,8,-2,0,-1,1,-1,-1,-1,3,-1
KR_6724664579,420,-3,-6,41,-14,-1,5,4,-3,4,1,-3,3,0,-6,8,2,-1,2,1,0,-23,3,-2,-5,7,-7,0,0,1,0,1,1,6,-1
KR_6762442818,420,3,65,-18,5,3,1,4,-3,4,1,3,0,3,1,2,3,1,1,2,0,1,152,1,-4,3,-28,0,0,-1,-1,0,1,1,-1
KR_6673431042,420,-5,-31,-14,-19,0,1,1,2,1,3,-9,10,1,-7,7,0,-5,5,0,-2,-16,260,-5,-2,7,0,0,-3,-1,-1,-1,-1,5,-1
KR_6695331691,420,-10,-132,-55,-4,7,0,7,-2,2,0,-5,5,0,-1,9,8,-3,4,1,-3,-18,1,-1,-5,6,-6,0,-2,-1,1,-1,-1,4,-1
KR_6743649049,420,-2,27,-13,2,-1,2,1,2,6,8,-2,4,2,5,4,9,-2,2,0,0,-5,-15,-5,-5,10,6,0,-1,1,-1,-1,-1,6,-1
KR_6742885866,420,-9,-160,-38,-15,-3,3,0,-5,7,2,-7,7,0,1,0,1,-1,1,0,0,-13,-4,5,-6,1,-3,0,-5,-1,-1,-1,-1,5,-1
KR_6709601214,420,-4,-101,-30,-11,-6,7,1,-1,2,1,2,2,4,-6,7,1,0,1,1,0,-3,16,2,-5,3,-1,0,-4,-1,-1,-1,-1,3,-1
KR_6657356572,440,-4,23,-54,-5,-2,2,0,2,1,3,-4,4,0,1,1,2,-2,2,0,0,-9,-47,-1,-2,3,3,0,0,-1,-1,-1,-1,3,-1
KR_6741499163,420,-2,-38,-20,-2,-3,3,0,0,1,1,-2,2,0,3,2,5,0,0,0,0,1,-96,-5,-1,6,-16,0,-1,1,-1,-1,1,2,-1
KR_6636654915,420,-3,55,-29,-7,-8,10,2,1,1,2,-3,4,1,2,0,2,1,1,2,0,-11,8,-3,-2,5,2,0,1,-1,-1,-1,-1,2,-1
KR_6765676001,420,-6,-67,-24,-8,-1,3,2,5,5,10,-3,4,1,2,2,4,-11,12,1,-2,-6,0,0,-1,1,-2,0,-2,1,-1,-1,-1,5,-1
KR_6730415936,420,-3,-43,4,-12,-3,5,2,-3,3,0,-2,2,0,-7,9,2,3,2,5,0,-17,-23,1,-4,3,10,0,-1,1,-1,-1,-1,1,-1
KR_6718460769,420,1,41,8,3,1,0,1,0,4,4,1,1,2,1,0,1,0,1,1,1,-1,-22,1,-5,4,0,0,1,1,1,1,1,4,-1
KR_6755340735,440,-1,48,-12,-1,4,0,4,-1,2,1,-1,1,0,-2,5,3,-1,1,0,-1,-7,-9,-2,-5,7,7,0,1,-1,-1,-1,-1,1,-1
KR_6728565549,420,-2,12,-2,5,-4,4,0,-5,7,2,3,1,4,10,0,10,1,1,2,0,5,-26,5,-9,4,0,0,0,1,-1,-1,1,5,-1
KR_6734431282,420,-1,-84,26,-7,-3,5,2,-1,4,3,-1,2,1,-5,8,3,3,1,4,-1,-8,4,0,-3,3,1,0,-1,1,-1,-1,-1,2,-1
KR_6735063500,420,0,55,12,0,1,1,2,3,3,6,-4,4,0,1,0,1,-1,2,1,0,3,42,-1,-4,5,-19,0,2,1,-1,1,-1,5,-1
KR_6755848167,420,-2,-47,-8,-6,1,1,2,1,4,5,-4,6,2,-4,6,2,0,0,0,0,-8,0,-3,-3,6,0,0,-2,-1,-1,-1,-1,6,-1
KR_6628107497,420,0,-17,3,2,-6,8,2,5,0,5,1,1,2,2,2,4,0,1,1,0,6,-10,-2,-2,4,-1,0,-1,1,-1,-1,1,6,-1
KR_6749410644,420,-4,24,-30,-6,-4,4,0,-2,5,3,-5,5,0,6,2,8,-1,1,0,0,-5,6,3,-5,2,-2,0,1,-1,0,1,1,1,-1
KR_6762165588,420,-5,-43,9,-9,-4,6,2,-2,2,0,-3,5,2,0,1,1,0,1,1,0,-6,-13,-5,-2,7,2,0,-1,-1,-1,1,1,4,-1
KR_6673622129,420,2,64,-4,4,2,0,2,-2,6,4,-1,3,2,4,0,4,1,1,2,0,-3,7,-2,-2,4,-1,0,1,0,1,1,-1,0,-1
KR_6445322941,420,2,20,-23,1,3,0,3,-4,5,1,0,2,2,4,1,5,-2,3,1,0,0,72,4,-9,5,0,0,0,-1,1,0,-1,1,-1
KR_6733016423,420,-1,16,-28,-4,0,2,2,2,3,5,-6,8,2,0,1,1,0,1,1,0,7,206,0,-3,3,-5,0,-1,-1,1,1,-1,6,-1
KR_6615524791,420,-2,47,-8,-1,-3,4,1,0,1,1,-1,1,0,3,2,5,0,0,0,0,-4,-22,3,-5,2,-3,0,-1,1,-1,-1,1,6,-1
KR_6342631915,420,2,73,10,1,6,0,6,0,4,4,2,1,3,-5,8,3,-2,3,1,0,-3,2,2,-8,6,-2,0,0,-1,-1,-1,-1,1,-1
KR_6641386045,420,0,-4,-16,2,1,1,2,-1,4,3,2,0,2,-3,6,3,3,1,4,0,9,9,-3,-3,6,-1,0,-1,-1,0,-1,1,1,-1
KR_6748145408,420,-1,-6,8,-3,-3,4,1,0,3,3,1,1,2,-1,3,2,0,2,2,0,0,12,6,-8,2,-5,0,0,-1,-1,1,1,5,-1
KR_6742973303,420,1,8,32,0,1,2,3,-3,4,1,0,4,4,1,2,3,1,0,1,0,1,-69,-1,-1,2,-2,0,0,1,-1,0,-1,1,-1
KR_6693961541,420,-4,-29,-28,-8,-6,6,0,2,0,2,3,1,4,-6,7,1,-1,1,0,0,-8,-9,1,-7,6,1,0,-1,-1,-1,-1,-1,3,-1
KR_6525039344,420,1,-65,-44,3,-1,2,1,-2,6,4,5,1,6,1,2,3,0,1,1,0,8,0,0,-4,4,2,0,-1,-1,-1,-1,-1,5,-1
KR_6761736006,420,-3,-9,-30,1,1,0,1,-4,4,0,-2,2,0,7,0,7,-1,1,0,0,2,-401,2,-5,3,1,0,-1,-1,-1,-1,1,2,-1
KR_6757183741,420,-2,8,-11,0,1,1,2,1,2,3,-3,4,1,2,1,3,-1,1,0,0,-2,17,0,-2,2,-1,0,0,-1,-1,0,1,6,-1
KR_6762495183,420,-1,-5,-10,-5,1,1,2,-3,6,3,-2,4,2,-1,2,1,0,0,0,0,-6,11,2,-4,2,-3,0,-1,1,-1,-1,-1,2,-1
KR_6752655004,420,-1,-27,-8,-5,-2,4,2,-2,3,1,0,1,1,-1,3,2,0,0,0,0,-4,275,-8,-1,9,5,0,-2,-1,-1,-1,1,1,-1
KR_6763901752,420,1,-31,15,-4,0,2,2,-3,7,4,-3,4,1,2,1,3,0,0,0,-1,-7,-1,-5,-1,6,1,0,0,-1,-1,0,-1,1,-1
KR_6328271003,420,-1,-6,-29,-3,-4,5,1,-1,3,2,5,1,6,-3,5,2,0,0,0,0,-7,14,-1,-4,5,-6,0,-2,0,-1,-1,-1,0,-1
KR_6764420367,420,-4,-47,-20,-7,1,0,1,-5,8,3,-1,5,4,-3,5,2,1,1,2,0,-8,-21,2,-5,3,-5,0,1,0,1,1,1,0,-1
KR_6751976912,420,0,32,-15,-4,4,0,4,2,3,5,-2,4,2,-8,8,0,0,0,0,-1,-8,5,2,-6,4,-2,0,-1,-1,-1,-1,-1,2,-1
KR_6755303310,440,-4,-22,-16,-10,-8,8,0,-1,1,0,1,1,2,-1,3,2,-1,2,1,0,-5,2,0,-7,7,-1,0,0,-1,-1,-1,1,6,-1
KR_6764044799,420,3,-15,5,4,3,1,4,1,2,3,1,1,2,-4,4,0,3,2,5,0,-1,3,5,-9,4,2,0,1,1,-1,1,1,2,-1
KR_6664955156,420,-4,-27,-5,-14,-7,8,1,-5,6,1,0,3,3,-2,4,2,0,1,1,0,-16,-2,-1,-5,6,-2,0,-1,1,-1,-1,-1,1,-1
KR_6629097660,420,2,34,17,-1,3,1,4,-1,2,1,0,3,3,-3,3,0,0,0,0,0,-5,7,4,-5,1,0,0,-1,-1,1,-1,1,4,-1
KR_6747512892,420,3,6,24,6,8,0,8,-3,4,1,1,1,2,1,2,3,-1,2,1,0,1,8,0,-6,6,-1,0,0,1,1,1,1,1,-1
KR_6703757072,420,-2,-29,-28,-1,4,1,5,1,1,2,5,0,5,-8,8,0,-3,5,2,0,-12,-45,1,-2,1,15,0,-1,-1,1,-1,1,3,-1
KR_6759297131,420,1,62,-8,0,-2,2,0,-1,4,3,3,0,3,1,0,1,-1,1,0,0,1,-13,4,-6,2,0,0,0,1,-1,0,-1,1,-1
KR_6721874832,440,-3,-97,-12,-5,-3,8,5,-2,2,0,1,3,4,-3,4,1,2,6,8,0,-10,-11,0,-2,2,3,0,-2,1,1,-1,-1,1,-1
KR_6727206236,420,-2,-12,-16,-5,-1,2,1,-5,8,3,1,0,1,1,1,2,-1,1,0,0,0,2,-2,-4,6,-1,0,0,-1,-1,0,1,1,-1
KR_6765115727,420,-1,-56,1,-7,-1,2,1,-5,5,0,1,1,2,0,3,3,-2,2,0,0,-3,147,5,-8,3,-3,0,-3,-1,-1,-1,-1,1,-1
KR_6710903104,420,-4,-83,-28,-6,-1,2,1,-1,1,0,-2,5,3,-2,8,6,0,1,1,-1,-5,-11,-1,-6,7,-2,0,-1,-1,1,-1,-1,4,-1
KR_6754422070,440,-2,-61,5,-6,-1,1,0,-5,8,3,1,3,4,-1,2,1,0,0,0,0,-9,0,1,-6,5,-7,0,-1,0,-1,-1,-1,0,-1
KR_6648154158,420,3,0,52,9,-1,2,1,4,1,5,2,3,5,3,1,4,1,1,2,0,10,81,3,-8,5,16,0,1,-1,1,1,-1,2,-1
KR_6767856841,420,2,29,24,-1,0,1,1,-1,3,2,1,5,6,1,3,4,-2,2,0,1,-2,5,-3,-1,4,-1,0,0,0,-1,0,1,0,-1
KR_6087732826,420,-1,14,-25,-3,2,1,3,-9,9,0,0,1,1,4,3,7,0,1,1,0,-6,-5,-4,-2,6,-1,0,1,-1,1,1,-1,2,-1
KR_6639876046,420,-5,-29,-27,-10,-1,2,1,-2,6,4,-5,7,2,-2,3,1,0,2,2,-1,-4,-3,1,-5,4,-1,0,-3,1,-1,-1,-1,6,-1
KR_6756755221,420,-2,-68,-27,-10,-2,4,2,-1,2,1,0,4,4,-3,3,0,-4,4,0,-1,-8,7,-1,-5,6,2,0,-1,0,0,-1,-1,0,-1
KR_6662667765,440,-1,-48,16,1,-1,4,3,-3,4,1,-4,7,3,8,1,9,1,1,2,0,8,0,-4,-3,7,2,0,0,-1,-1,-1,1,6,-1
KR_6644197336,420,0,35,-15,-4,1,0,1,-3,5,2,2,0,2,-4,7,3,0,0,0,0,-9,-104,-10,-3,13,2,0,-1,-1,-1,-1,-1,6,-1
KR_6713991487,420,-2,-31,17,-7,-4,4,0,0,2,2,0,3,3,-2,3,1,-1,1,0,0,-9,-2,-5,0,5,3,0,-1,-1,-1,-1,-1,6,-1
KR_6725803601,420,-1,-46,-12,2,-1,4,3,-4,5,1,-1,3,2,9,1,10,-1,2,1,1,4,-6,1,-5,4,4,0,-3,1,-1,-1,1,3,-1
KR_6759909206,440,1,-11,4,-6,4,1,5,2,1,3,-2,7,5,-5,6,1,-5,6,1,-2,-15,4,0,-3,3,0,0,-1,-1,-1,-1,-1,5,-1
KR_6761905089,420,-4,-35,-18,-10,0,3,3,-3,3,0,-6,6,0,0,2,2,-1,3,2,0,-12,9,0,-6,6,-4,0,0,0,-1,0,-1,0,-1
KR_6723881838,420,-2,3,-20,-2,-2,2,0,0,3,3,1,2,3,-4,4,0,3,0,3,1,-3,10,-3,-4,7,1,0,0,-1,1,0,1,4,-1
KR_6678219110,440,-4,-6,-33,-7,4,0,4,-5,5,0,-6,7,1,-1,3,2,1,1,2,0,-8,-36,-5,-1,6,-4,0,-2,-1,-1,-1,-1,5,-1
KR_6715664232,420,2,-32,5,5,1,0,1,-1,3,2,6,4,10,-1,3,2,0,0,0,2,8,13,0,-6,6,-2,0,0,1,1,-1,1,6,-1
KR_6755555840,420,-2,21,-17,-4,-4,4,0,-6,6,0,2,1,3,4,1,5,0,2,2,0,-3,-4,-2,-4,6,8,0,-2,-1,1,-1,1,4,-1
KR_6747840777,420,1,-53,2,3,-5,6,1,2,1,3,-1,3,2,6,0,6,1,0,1,0,8,-6,2,-5,3,0,0,-1,1,-1,-1,-1,6,-1
KR_6750710679,420,3,1,16,6,0,2,2,5,0,5,1,2,3,1,3,4,-1,2,1,0,5,1,-3,-2,5,-1,0,-1,1,1,-1,1,2,-1
KR_6758709680,440,-3,-66,-39,0,-2,2,0,0,0,0,1,2,3,1,4,5,0,1,1,-1,0,-30,1,-3,2,1,0,-1,-1,-1,-1,-1,1,-1
KR_6708108661,420,-1,-110,19,-4,-2,4,2,-3,4,1,-3,3,0,2,4,6,2,1,3,0,0,-7,0,-5,5,-3,0,-1,0,-1,-1,-1,0,-1
KR_6672744882,420,-2,-14,-4,-5,-2,2,0,0,1,1,0,2,2,-4,6,2,1,0,1,0,-6,2,-1,-2,3,1,0,-1,-1,0,-1,-1,6,-1
KR_6621518841,420,-3,-129,23,-4,-1,2,1,4,0,4,-4,4,0,-2,2,0,-1,2,1,0,-4,-6,-3,-3,6,-3,0,-1,1,1,-1,1,6,-1
KR_6665306823,420,-4,-41,-24,-7,-5,5,0,2,1,3,-3,4,1,4,0,4,-5,7,2,0,-4,-28,1,-4,3,-1,0,0,-1,1,0,-1,4,-1
KR_6764752653,440,-5,-43,12,-8,-2,2,0,-5,5,0,-1,2,1,-4,4,0,4,0,4,0,-9,1,-5,-1,6,-2,0,0,0,0,0,-1,0,-1
KR_6748399573,420,2,-1,25,0,5,1,6,-2,6,4,-3,5,2,-2,7,5,2,2,4,0,1,14,-3,-3,6,4,0,1,0,1,1,-1,0,-1
KR_5871426124,420,3,-3,-19,5,4,0,4,3,2,5,-1,3,2,0,2,2,-1,1,0,0,3,-11,7,-14,7,3,0,-1,1,-1,-1,1,1,-1
KR_6653272879,420,-2,14,-16,-4,-2,3,1,1,1,2,-3,4,1,-1,2,1,1,2,3,1,-4,4,0,-3,3,2,0,-1,-1,-1,-1,1,4,-1
KR_6715377562,420,0,45,-24,1,0,0,0,-1,3,2,6,1,7,-1,3,2,-3,4,1,0,-6,3,2,-4,2,-5,0,-1,1,-1,-1,-1,6,-1
KR_6583142020,440,-2,-37,-24,-6,-8,8,0,-2,8,6,2,1,3,3,1,4,-1,3,2,0,-5,1,4,-5,1,-2,0,-1,-1,-1,-1,1,5,-1
KR_6686678039,420,-4,-56,-73,-4,1,0,1,-7,9,2,1,2,3,-2,5,3,3,0,3,0,-4,17,0,-4,4,-1,0,0,1,-1,-1,1,3,-1
KR_6659013265,420,1,25,12,-1,-2,3,1,0,2,2,2,2,4,-1,1,0,0,0,0,1,1,-1,-2,-4,6,2,0,0,1,1,1,1,5,-1
KR_6627188131,420,-1,-65,-24,2,-1,1,0,2,1,3,0,2,2,-1,2,1,2,0,2,0,0,3,-1,-1,2,0,0,-1,1,1,-1,-1,6,-1
KR_6608954795,420,0,-36,50,0,1,0,1,-2,4,2,5,0,5,-1,2,1,-3,3,0,0,-6,-120,-8,0,8,5,0,0,-1,1,0,-1,1,-1
KR_6745072921,420,3,-26,12,-3,-7,8,1,0,1,1,5,0,5,-2,3,1,1,0,1,0,5,33,-2,-2,4,1,0,0,-1,-1,-1,-1,3,-1
KR_6172267283,420,-5,-13,-4,-13,-3,3,0,-4,8,4,-3,6,3,-1,2,1,-2,3,1,0,-12,176,-4,-6,10,-5,0,-1,-1,0,-1,-1,2,-1
KR_6663738148,420,-4,-62,11,-8,-5,6,1,-1,2,1,1,4,5,-3,3,0,0,0,0,-1,-9,-15,-4,-2,6,-1,0,-1,-1,-1,-1,-1,2,-1
KR_6751947293,420,-5,-94,-20,-7,-4,5,1,4,1,5,-7,7,0,-1,2,1,1,0,1,-1,-1,-4,1,-3,2,-1,0,-1,-1,-1,-1,-1,6,-1
KR_6647873686,420,2,10,17,1,4,0,4,0,2,2,0,0,0,-4,7,3,1,0,1,0,-7,-20,-1,-7,8,-5,0,0,-1,1,0,1,3,-1
KR_6755484609,420,-1,-17,0,-6,-4,4,0,0,1,1,-5,5,0,3,2,5,0,2,2,0,-9,4,-4,-2,6,-2,0,0,1,-1,0,1,1,-1
KR_6759302190,420,-1,3,25,-3,0,2,2,-4,5,1,0,2,2,0,1,1,1,1,2,0,-10,124,7,-8,1,-4,0,1,-1,1,1,1,2,-1
KR_6759267120,420,4,-8,20,9,3,0,3,3,5,8,3,4,7,-1,3,2,1,2,3,0,2,6,5,-8,3,-2,0,1,1,1,1,1,2,-1
KR_6762695027,420,2,-25,-16,5,-1,1,0,5,2,7,-3,3,0,0,1,1,4,0,4,0,15,111,-2,-4,6,2,0,0,1,1,1,-1,3,-1
KR_6762373502,420,0,-25,23,-6,-4,4,0,3,2,5,-4,7,3,-3,3,0,2,0,2,-1,-6,41,0,-2,2,-21,0,0,-1,1,0,-1,6,-1
KR_6766976965,420,-4,-100,-10,-11,-2,4,2,2,1,3,-4,5,1,-8,8,0,1,1,2,0,-4,0,0,-2,2,0,0,-3,-1,1,-1,-1,5,-1
KR_6703105829,420,3,-16,-4,1,2,3,5,0,4,4,0,2,2,-3,3,0,2,1,3,0,-3,0,-1,-4,5,2,0,0,-1,1,1,-1,6,-1
KR_6631345539,420,-4,-59,-32,-1,-10,11,1,0,6,6,2,0,2,5,0,5,2,1,3,0,21,-181,-1,-5,6,-3,0,0,1,-1,0,-1,1,-1
KR_6606223816,440,-1,-94,-11,3,1,0,1,3,3,6,-1,3,2,-1,5,4,1,0,1,0,7,28,1,-4,3,-1,0,-2,-1,-1,-1,-1,2,-1
KR_6758002508,440,-1,-16,-8,-3,2,2,4,-4,5,1,-1,2,1,1,2,3,-1,3,2,-1,-13,-155,1,-4,3,2,0,1,0,1,-1,-1,0,-1
KR_6608403069,420,-2,-42,-20,-4,6,0,6,-1,1,0,-9,9,0,0,1,1,0,0,0,0,-2,-196,-2,-6,8,6,0,-1,-1,1,1,1,5,-1
KR_6751803943,420,1,-25,32,-1,1,1,2,-3,3,0,2,2,4,-1,2,1,0,1,1,0,-3,-7,-5,-1,6,4,0,-1,0,1,-1,-1,0,-1
KR_6728846945,420,-3,-89,-32,-3,-1,3,2,-4,7,3,4,1,5,-5,6,1,3,1,4,-2,-13,-1,-3,-1,4,-1,0,0,-1,0,0,-1,5,-1
KR_6760718809,420,-1,-9,-29,2,-4,4,0,-2,6,4,7,1,8,0,2,2,1,3,4,1,2,49,-2,-5,7,-25,0,0,1,-1,-1,1,2,-1
KR_6525807543,420,-3,-52,-7,-2,-2,4,2,0,4,4,-4,5,1,1,2,3,3,1,4,0,-2,-6,-2,-5,7,2,0,-1,1,1,1,1,1,-1
KR_6705814153,420,-1,-39,29,-9,-1,3,2,-5,7,2,-2,4,2,-1,4,3,0,0,0,0,-13,-61,-4,0,4,22,0,-2,1,1,-1,1,3,-1
KR_6626797184,420,0,-48,-20,-2,0,0,0,-1,3,2,-1,2,1,1,2,3,-1,1,0,0,-2,11,-13,-1,14,-1,0,-1,-1,-1,-1,1,5,-1
KR_6764185297,420,2,-26,16,0,7,1,8,-1,1,0,-3,3,0,-2,8,6,-1,3,2,-1,-13,18,-4,-4,8,-2,0,0,1,1,1,-1,2,-1
KR_6768038496,420,-2,-17,4,-1,-2,3,1,-2,3,1,5,0,5,-1,4,3,-1,1,0,0,-2,-130,7,-9,2,-3,0,0,1,-1,-1,1,5,-1
KR_6761191364,420,0,-43,0,-1,-2,3,1,-1,3,2,2,0,2,0,0,0,0,0,0,0,0,-1,1,-4,3,-1,0,0,-1,0,0,1,5,-1
KR_6767566362,420,-3,-28,-34,-8,-2,2,0,-7,8,1,-3,3,0,5,0,5,-1,4,3,-1,-4,-13,4,-8,4,2,0,-2,1,-1,-1,-1,6,-1
KR_6338687522,420,0,-30,24,-7,2,1,3,-3,6,3,-3,5,2,-3,6,3,0,0,0,0,-11,175,-1,-3,4,-5,0,-1,1,0,-1,-1,2,-1
KR_6737490183,420,1,-48,1,-3,0,2,2,-1,1,0,-4,9,5,3,1,4,-1,1,0,0,4,-1,-1,-3,4,3,0,0,1,-1,-1,-1,4,-1
KR_6663829152,420,-3,-48,-16,-7,-5,5,0,-9,9,0,2,1,3,4,2,6,1,0,1,-1,-7,-7,0,-1,1,-2,0,-1,0,-1,-1,-1,0,-1
KR_6763597735,420,-2,-5,-3,-6,-1,2,1,-5,6,1,2,2,4,1,1,2,-3,7,4,0,-4,4,4,-9,5,-8,0,-1,-1,-1,-1,-1,3,-1
KR_6744401007,420,-3,-120,-4,-7,-5,5,0,0,4,4,-1,2,1,1,4,5,-2,3,1,0,-7,74,-4,-3,7,20,0,0,0,-1,-1,-1,0,-1
KR_6682798851,420,-1,20,-16,2,4,0,4,-2,4,2,0,4,4,-1,2,1,1,0,1,0,8,-12,-1,-5,6,4,0,0,0,1,0,-1,0,-1
KR_6683156463,420,-2,-2,38,-8,1,3,4,-1,3,2,-5,6,1,0,1,1,-3,3,0,0,-7,13,0,-5,5,1,0,0,1,1,0,-1,5,-1
KR_6646583516,420,-1,2,31,-3,0,1,1,-1,2,1,1,2,3,-3,5,2,0,1,1,0,-10,39,1,-8,7,-16,0,0,1,1,1,-1,5,-1
KR_6724484974,440,-5,-36,-51,-6,3,1,4,-3,9,6,-2,5,3,-5,5,0,1,0,1,-1,-5,-17,2,-6,4,-3,0,0,-1,1,-1,-1,1,-1
KR_6750654559,420,2,68,9,-3,1,1,2,-1,2,1,2,0,2,-3,4,1,-2,2,0,0,-8,2,1,-4,3,-7,0,1,0,1,1,-1,0,-1
KR_6748108457,420,-4,-43,16,-5,-3,3,0,-4,5,1,3,2,5,0,1,1,-1,2,1,0,-6,25,4,-7,3,-5,0,-1,-1,-1,-1,-1,2,-1
KR_6631088016,420,-4,-74,0,-5,0,1,1,-5,6,1,5,0,5,-1,4,3,-4,4,0,0,7,-204,1,-6,5,-2,0,-2,1,-1,-1,1,1,-1
KR_6751783774,420,0,-55,-6,-1,-1,2,1,1,1,2,0,3,3,-2,3,1,1,1,2,0,4,-30,1,-8,7,29,0,0,-1,1,0,1,6,-1
KR_6765672567,420,2,63,2,6,-1,1,0,-1,2,1,1,4,5,5,2,7,2,0,2,0,10,-223,-4,-3,7,1,0,-1,1,-1,-1,1,3,-1
KR_6766376472,420,-3,-10,-8,-3,-2,3,1,-2,7,5,1,2,3,1,1,2,-1,1,0,0,-2,2,1,-4,3,-1,0,-1,1,-1,-1,1,5,-1
KR_6525673754,420,2,65,11,3,1,1,2,0,3,3,0,1,1,2,4,6,0,2,2,0,4,1,2,-6,4,0,0,0,-1,1,0,-1,3,-1
KR_6727123440,420,-3,26,-44,-7,0,2,2,2,1,3,-6,6,0,-2,3,1,-1,3,2,0,-4,2,-2,-3,5,0,0,-1,0,-1,-1,-1,0,-1
KR_6696777768,420,-1,-62,-9,3,-6,6,0,-2,5,3,2,2,4,6,1,7,3,1,4,1,3,-16,0,-5,5,1,0,-1,1,-1,-1,-1,5,-1
KR_6632983077,420,1,1,-3,0,1,2,3,-3,5,2,1,1,2,0,1,1,1,1,2,0,2,135,6,-8,2,1,0,0,0,-1,-1,-1,0,-1
KR_6435069172,420,-3,-28,-16,-6,-4,6,2,1,0,1,-4,4,0,1,0,1,0,0,0,-1,-8,-110,4,-8,4,-3,0,-1,-1,-1,-1,-1,2,-1
KR_6767472081,420,-4,-43,-25,-6,1,2,3,-4,5,1,2,1,3,-3,4,1,-2,2,0,0,-9,3,3,-7,4,-5,0,-1,1,-1,-1,1,5,-1
KR_6746769882,420,-1,14,4,-3,2,2,4,-1,3,2,-4,5,1,-3,3,0,3,0,3,2,5,5,-4,-2,6,-3,0,1,1,-1,1,1,5,-1
KR_6732939104,420,-1,60,-4,-6,1,0,1,0,3,3,0,0,0,-6,7,1,-1,2,1,-1,-16,2,4,-6,2,0,0,0,-1,1,1,-1,1,-1
KR_6742539717,440,-2,-56,-36,-5,-5,5,0,-1,5,4,-1,3,2,0,2,2,2,1,3,-2,-4,164,-2,-2,4,0,0,0,-1,1,0,1,6,-1
KR_6172133382,420,-2,-39,-11,-6,0,0,0,-2,4,2,0,1,1,-3,5,2,-1,1,0,0,-9,-14,-2,-5,7,2,0,0,-1,-1,0,-1,4,-1
KR_6623220455,420,0,-36,-16,0,-1,1,0,-2,2,0,-2,4,2,5,2,7,0,0,0,0,6,-2,-2,-2,4,-2,0,-1,1,-1,-1,-1,3,-1
KR_6627216711,420,-2,2,-44,-4,2,2,4,-3,3,0,2,3,5,-3,4,1,-2,2,0,0,-6,-6,2,-9,7,-1,0,-1,-1,-1,-1,-1,5,-1
KR_6754973143,420,0,25,12,4,3,1,4,5,0,5,-2,2,0,-1,4,3,-1,1,0,3,12,12,-3,-4,7,-1,0,1,1,0,1,1,4,-1
KR_6749162266,420,-2,-51,-5,-3,-2,2,0,1,0,1,-1,2,1,-2,2,0,1,0,1,0,-1,11,8,-10,2,-2,0,-1,1,-1,-1,1,5,-1
KR_6606337294,420,-2,-102,1,-2,-2,3,1,1,3,4,-4,7,3,3,2,5,0,0,0,-1,-3,5,0,-6,6,0,0,-1,1,0,-1,1,6,-1
KR_6731700356,420,-1,-27,-6,-3,-2,3,1,-4,4,0,-2,4,2,6,2,8,-1,2,1,0,3,6,4,-6,2,-3,0,-1,-1,-1,-1,1,5,-1
KR_6762559061,440,-6,-74,-13,-17,-3,4,1,1,2,3,-8,8,0,-1,2,1,-6,7,1,-1,-21,4,-3,-2,5,2,0,-1,0,0,-1,-1,0,-1
KR_6762437491,420,-4,-42,16,-11,-5,7,2,-3,4,1,-8,11,3,4,1,5,1,1,2,0,-7,-411,-1,0,1,0,0,-1,-1,-1,-1,-1,1,-1
KR_6741255378,420,-6,-28,-25,-13,0,1,1,-7,12,5,-5,6,1,-2,3,1,1,1,2,0,-14,-56,-1,-4,5,2,0,-1,-1,-1,-1,-1,4,-1
KR_6759692756,420,-2,-23,-24,-1,1,2,3,2,1,3,-4,4,0,-1,3,2,1,0,1,0,1,115,0,-2,2,0,0,0,-1,-1,0,1,3,-1
KR_6750892093,420,-4,-95,21,-13,-5,5,0,-2,3,1,-2,2,0,-5,6,1,1,0,1,0,-13,-1,0,-5,5,-1,0,-3,0,1,-1,-1,0,-1
KR_6747099302,420,-3,-11,-1,-3,0,1,1,3,0,3,-1,2,1,-4,4,0,-1,1,0,0,-7,-1,-3,-2,5,2,0,-1,-1,-1,-1,1,6,-1
KR_6658915707,420,-1,8,-17,0,-1,2,1,3,4,7,-3,5,2,0,2,2,1,1,2,0,6,2,1,-8,7,-3,0,-1,1,-1,-1,1,5,-1
KR_6612333658,420,-4,-78,-16,-3,3,1,4,-1,2,1,0,2,2,-5,6,1,0,0,0,-1,-5,-278,-5,-4,9,-1,0,1,-1,-1,1,-1,2,-1
KR_6761795264,420,-7,-41,-28,-16,-2,2,0,-8,10,2,-1,3,2,-2,4,2,-3,3,0,0,-9,-35,-4,0,4,8,0,-1,-1,-1,-1,-1,6,-1
KR_6613027896,420,1,26,-5,9,-2,4,2,6,3,9,0,0,0,5,0,5,0,1,1,3,14,-2,5,-7,2,3,0,0,-1,0,1,1,5,-1
KR_6767909546,420,3,-58,-14,9,-1,1,0,5,0,5,3,0,3,0,0,0,2,1,3,0,12,-35,3,-4,1,35,0,-1,-1,1,-1,1,1,-1
KR_6762653336,420,0,-38,-3,-1,-2,2,0,-2,3,1,1,1,2,3,1,4,-1,2,1,0,3,14,1,-4,3,-2,0,-1,-1,0,-1,-1,3,-1
KR_6761838346,420,3,-15,24,2,-1,2,1,0,1,1,0,4,4,3,2,5,0,0,0,0,7,2,0,-5,5,0,0,-1,-1,-1,-1,-1,2,-1
KR_6606530858,420,-2,-12,-2,-7,0,3,3,1,4,5,-2,3,1,-5,7,2,-1,1,0,0,-7,2,0,-1,1,-2,0,1,-1,-1,1,-1,4,-1
KR_6607749683,420,0,-66,-35,5,-1,1,0,1,4,5,3,0,3,2,2,4,0,0,0,-1,8,-6,0,-3,3,0,0,0,1,0,-1,-1,3,-1
KR_6766051928,420,1,-90,4,2,0,3,3,-1,2,1,0,1,1,3,0,3,0,2,2,0,3,1,2,-6,4,-1,0,0,1,-1,-1,-1,5,-1
KR_6614011699,440,-3,-57,-53,-5,-4,5,1,1,2,3,-6,7,1,3,1,4,1,0,1,0,2,6,1,-7,6,2,0,0,1,-1,0,-1,2,-1
KR_6635400686,420,1,49,6,4,-2,3,1,0,2,2,5,0,5,-1,2,1,2,2,4,0,6,8,0,-5,5,4,0,-1,1,1,-1,-1,6,-1
KR_6649699735,420,-5,-84,2,-11,-4,4,0,0,1,1,-1,1,0,-2,4,2,-4,4,0,0,-6,-39,-2,-6,8,28,0,0,-1,-1,0,-1,3,-1
KR_6738442931,420,-5,-56,-9,-8,-2,3,1,-1,4,3,1,2,3,-6,6,0,0,1,1,-1,-16,-4,0,-8,8,-1,0,-2,-1,1,-1,-1,1,-1
KR_6733613477,420,-3,-58,-3,-10,0,1,1,0,4,4,1,3,4,-10,10,0,-1,1,0,1,-10,-55,-1,-5,6,-1,0,-2,0,-1,-1,-1,0,-1
KR_6348215692,420,-7,-58,-8,-13,1,1,2,-6,9,3,-1,3,2,-9,13,4,2,0,2,1,-5,-48,-2,-4,6,23,0,-3,-1,-1,-1,1,4,-1
KR_6634983337,420,-4,-29,-9,-13,-1,2,1,-5,6,1,-4,4,0,-1,3,2,-2,2,0,0,-8,13,-6,0,6,1,0,-1,1,-1,-1,-1,5,-1
KR_6742135448,420,-3,31,8,-6,-2,2,0,-5,7,2,-1,2,1,2,2,4,0,0,0,0,-11,2,4,-6,2,-3,0,0,1,-1,-1,-1,3,-1
KR_6610518574,420,0,11,-16,5,3,3,6,3,0,3,-2,3,1,0,1,1,1,1,2,0,3,-3,2,-5,3,0,0,1,-1,1,1,-1,4,-1
KR_6737910048,420,-1,24,23,-3,-4,6,2,0,2,2,-7,9,2,8,2,10,0,1,1,0,-4,-9,-2,-4,6,3,0,-1,-1,-1,-1,-1,2,-1
KR_6755698222,420,-1,-61,-28,3,4,0,4,1,0,1,-1,2,1,-1,4,3,0,0,0,1,5,42,-4,-2,6,-2,0,0,1,1,0,1,5,-1
KR_6760282404,420,-1,-24,-8,-2,5,0,5,1,1,2,-3,3,0,-6,7,1,1,1,2,0,1,4,0,-2,2,1,0,0,-1,1,0,-1,4,-1
KR_6747776955,420,2,26,31,-3,-2,5,3,1,1,2,-3,6,3,-1,4,3,2,1,3,0,4,0,2,-7,5,1,0,0,1,-1,0,1,3,-1
KR_6728979031,420,0,-41,15,-6,0,1,1,2,1,3,-5,6,1,-5,5,0,2,2,4,0,0,7,-1,-4,5,-7,0,-1,-1,-1,-1,-1,1,-1
KR_6607040987,420,0,57,-12,-9,1,1,2,-2,3,1,-2,4,2,-6,8,2,0,1,1,0,-20,-12,0,-5,5,5,0,0,1,1,1,-1,3,-1
KR_6675958476,420,-3,-100,4,-10,-1,2,1,1,4,5,-8,8,0,-4,7,3,2,2,4,0,3,4,3,-6,3,-8,0,-1,1,-1,-1,-1,1,-1
KR_6375743459,420,-2,-15,16,-9,-3,4,1,-6,7,1,-2,3,1,2,2,4,0,1,1,0,-8,0,0,0,0,0,0,-2,1,-1,-1,-1,6,-1
KR_6763581630,420,0,-40,0,-5,1,0,1,0,4,4,-6,8,2,0,2,2,0,1,1,2,-2,25,2,-6,4,-6,0,-1,-1,-1,-1,1,1,-1
KR_6766744182,420,-2,-54,-12,-4,0,0,0,-1,4,3,-3,4,1,1,4,5,-1,2,1,0,-7,-2,-1,-5,6,1,0,0,-1,1,0,-1,1,-1
KR_6726366135,420,-5,-85,4,-14,-2,3,1,-3,6,3,-6,7,1,-2,3,1,-1,4,3,-1,-19,-1,0,-6,6,-1,0,-3,1,-1,-1,-1,5,-1
KR_6747326786,420,-3,1,-28,2,2,1,3,4,0,4,-3,3,0,-1,3,2,0,1,1,0,-1,-117,-2,-6,8,1,0,1,-1,1,1,1,1,-1
KR_6737891069,440,-7,-65,-8,-20,-7,7,0,-7,7,0,-1,1,0,-5,9,4,0,0,0,0,-17,-19,-2,-2,4,0,0,-2,-1,0,-1,-1,4,-1
KR_6754143403,420,1,30,-24,-2,0,2,2,-2,4,2,1,3,4,-3,5,2,2,0,2,-1,-6,1,0,-3,3,-1,0,0,-1,0,1,-1,1,-1
KR_6685934457,420,-2,-68,5,-14,-1,4,3,-5,8,3,-5,5,0,-2,5,3,-1,2,1,0,-12,-1,0,-8,8,-1,0,-1,1,-1,-1,-1,3,-1
KR_6765538087,420,-2,6,-6,1,-1,2,1,0,2,2,3,0,3,0,1,1,-1,1,0,0,5,-34,2,-6,4,27,0,-1,-1,1,-1,1,2,-1
KR_6711350128,420,-3,17,-36,-9,-1,3,2,-1,2,1,-3,9,6,-6,7,1,2,0,2,-2,-12,5,2,-5,3,1,0,0,-1,0,0,-1,4,-1
KR_6748924525,420,-5,-52,-32,-3,1,2,3,0,4,4,-4,4,0,-1,1,0,1,1,2,0,-5,-8,-2,-3,5,-3,0,-1,-1,1,-1,1,4,-1
KR_6696901942,420,1,60,-16,6,0,3,3,-1,3,2,5,0,5,2,2,4,0,0,0,0,-2,1,-3,-5,8,2,0,0,1,1,0,-1,5,-1
KR_6749489462,440,-1,4,-16,-7,-5,6,1,-1,1,0,-2,2,0,3,1,4,-2,2,0,0,-9,7,3,-4,1,-3,0,0,-1,-1,0,1,3,-1
KR_6757180255,420,-1,52,12,-7,-1,4,3,-4,7,3,-1,1,0,-1,4,3,0,0,0,0,-7,1,-4,-3,7,-2,0,1,1,-1,1,-1,2,-1
KR_6764468211,440,-2,-66,-12,-6,0,2,2,-1,2,1,1,1,2,-3,3,0,-3,4,1,0,-9,3,2,-5,3,3,0,-2,1,-1,-1,-1,6,-1
KR_6581648630,420,-1,-16,0,2,1,1,2,-3,5,2,-1,3,2,4,1,5,1,1,2,0,3,0,2,-5,3,-2,0,0,1,-1,1,1,1,-1
KR_6096377129,420,-3,29,-3,-8,0,4,4,-3,7,4,-4,8,4,-1,3,2,0,1,1,1,-11,1,-2,-3,5,-1,0,0,-1,-1,1,1,1,-1
