matchId,queueId,Diff_LV,Diff_CS,Diff_jglCS,Diff-K,Diff-K-top,K-WIN-top,K-LOSE-top,Diff-K-jug,K-WIN-jug,K-LOSE-jug,Diff-K-mid,K-WIN-mid,K-LOSE-mid,Diff-K-ad,K-WIN-ad,K-LOSE-ad,Diff-K-sup,K-WIN-sup,K-LOSE-sup,invadeKill,Diff-A,Diff_WARDplaced,Diff-ControlWARDplaced,LOSE_controlWARDPlaced,WIN_controlWARDPlaced,Diff_WARDkill,Diff_Inhibitor,Diff_TOWERkill,Diff_FirstDRAGON,Diff_FirstHERALD,Diff_Firsttower,Diff_FirstBLOOD,dragonType,result
KR_6613088742,420,-6,-46,-51,-16,-7,7,0,-2,6,4,-1,2,1,-3,5,2,-3,4,1,-2,-9,2,4,-7,3,-3,0,-1,-1,1,-1,-1,4,-1
KR_6639963111,420,1,-31,24,1,0,1,1,2,4,6,-1,3,2,2,1,3,-2,2,0,-1,9,-455,-3,-1,4,24,0,0,-1,1,0,-1,5,-1
KR_6750531722,440,-1,12,-16,-6,-3,4,1,2,1,3,1,3,4,-4,9,5,-2,4,2,0,9,-37,3,-5,2,19,0,-1,0,-1,-1,-1,0,-1
KR_6741358994,420,-4,-48,-61,-6,-5,5,0,-2,3,1,-1,3,2,0,5,5,2,0,2,-2,-3,-6,5,-8,3,-4,0,-1,-1,0,-1,-1,5,-1
KR_6765093170,420,-8,-108,-31,-16,-3,4,1,0,1,1,-2,5,3,-6,7,1,-5,6,1,-2,-14,-6,-1,-4,5,-3,0,-3,-1,1,-1,-1,5,-1
KR_6741736532,420,-2,-5,7,-8,-3,3,0,3,2,5,-4,4,0,-2,2,0,-2,2,0,0,-12,0,-7,-2,9,-4,0,1,-1,1,1,1,2,-1
KR_6655326410,420,0,21,-4,1,2,2,4,-2,3,1,1,0,1,-1,4,3,1,0,1,1,-1,-444,-4,-3,7,-4,0,0,1,-1,1,1,2,-1
KR_6756502897,420,-2,-34,4,-3,0,1,1,1,4,5,-5,8,3,0,3,3,1,0,1,0,-6,20,-2,-3,5,-1,0,-2,-1,1,-1,-1,6,-1
KR_6719888246,420,-4,-88,12,-10,-2,2,0,-3,5,2,-1,2,1,-5,9,4,1,0,1,0,-1,20,-1,-4,5,-17,0,-1,-1,-1,-1,1,5,-1
KR_6745336076,440,1,39,24,-4,-1,2,1,0,2,2,-1,1,0,3,0,3,-5,6,1,-1,-8,-8,-3,-1,4,2,0,0,-1,-1,0,-1,1,-1
KR_6645470392,420,-3,-11,-6,-10,-3,4,1,3,3,6,-8,9,1,-3,5,2,1,1,2,0,-10,65,0,-4,4,1,0,-1,-1,-1,-1,-1,5,-1
KR_6752004590,420,-1,4,8,-6,1,2,3,-2,4,2,2,2,4,-2,3,1,-5,5,0,0,-14,10,-5,-3,8,-2,0,0,-1,-1,-1,1,4,-1
KR_6753231525,440,-3,-12,0,2,2,1,3,5,2,7,-2,2,0,-2,5,3,-1,4,3,0,-1,-9,0,-2,2,-3,0,1,-1,1,1,1,2,-1
KR_6756111663,420,-1,-88,-62,-5,-1,2,1,-2,5,3,3,3,6,-4,4,0,-1,1,0,-1,-3,104,1,-2,1,1,0,-4,1,-1,-1,-1,6,-1
KR_6768198259,440,-4,-76,-36,-3,0,1,1,-1,2,1,-1,5,4,-2,3,1,1,0,1,0,-4,-16,1,-5,4,3,0,-1,-1,-1,-1,-1,5,-1
KR_6763696476,420,-1,-19,-17,-7,-2,2,0,-3,4,1,0,6,6,0,2,2,-2,3,1,0,2,10,0,-5,5,-4,0,0,-1,1,0,-1,2,-1
KR_6639133050,420,-6,-88,-35,-8,-3,5,2,0,3,3,-2,7,5,-3,3,0,0,0,0,0,-3,-4,-2,-1,3,0,0,-2,-1,-1,-1,1,6,-1
KR_6725003116,420,-9,-73,-43,-18,1,0,1,-7,8,1,-6,7,1,-4,7,3,-2,2,0,0,-14,45,3,-6,3,0,0,-3,-1,-1,-1,1,1,-1
KR_6728822645,420,1,35,-3,0,0,0,0,2,4,6,-3,5,2,-3,5,2,4,0,4,0,-8,10,7,-9,2,-1,0,1,1,1,1,1,3,-1
KR_6724204275,420,-1,20,-24,-2,2,0,2,1,1,2,-1,3,2,0,2,2,-4,5,1,0,5,69,2,-6,4,4,0,1,-1,1,1,1,4,-1
KR_6413056349,420,-4,-108,7,-8,-4,4,0,0,4,4,-5,5,0,1,1,2,0,1,1,0,1,-189,3,-5,2,-7,0,-1,-1,-1,-1,-1,6,-1
KR_6727609986,420,1,-22,0,0,1,0,1,4,0,4,-4,4,0,0,6,6,-1,1,0,0,3,-35,2,-3,1,0,0,-1,-1,-1,-1,-1,3,-1
KR_6743563052,420,-6,-69,-10,-12,-3,4,1,-5,5,0,-1,2,1,-1,1,0,-2,3,1,0,-5,53,-5,-3,8,3,0,0,-1,-1,-1,-1,5,-1
KR_6660052138,440,-4,-158,-1,-12,-6,7,1,-7,7,0,1,2,3,1,1,2,-1,3,2,-1,-9,-14,-1,-2,3,-5,0,-2,-1,-1,-1,-1,1,-1
KR_6764781399,420,-2,20,8,-8,-2,3,1,1,1,2,-1,1,0,-5,5,0,-1,3,2,0,-10,-22,2,-5,3,-3,0,0,-1,1,-1,-1,1,-1
KR_6652827448,420,-3,-55,-28,0,2,0,2,2,1,3,2,1,3,-5,5,0,-1,2,1,0,-2,1,2,-4,2,-1,0,-1,-1,-1,-1,-1,4,-1
KR_6745933340,420,0,-81,16,1,-2,3,1,-3,4,1,4,2,6,2,2,4,0,1,1,0,3,-80,0,-6,6,-1,0,0,-1,-1,0,1,2,-1
KR_6742622816,420,-2,-50,12,-5,-1,1,0,-8,11,3,7,1,8,-3,5,2,0,2,2,-1,-18,108,4,-6,2,-1,0,-2,1,-1,-1,-1,6,-1
KR_6640059041,420,1,17,24,-1,3,2,5,1,1,2,-1,3,2,-4,5,1,0,1,1,0,1,296,3,-8,5,1,0,0,-1,1,0,1,3,-1
KR_6739317362,420,0,8,28,-2,0,1,1,0,1,1,2,2,4,-5,6,1,1,0,1,0,1,36,-3,-1,4,-22,0,0,-1,0,1,-1,3,-1
KR_6738249691,420,-1,9,12,-2,1,1,2,-2,3,1,-3,6,3,2,1,3,0,1,1,0,0,-12,-3,-3,6,2,0,0,-1,1,0,-1,3,-1
KR_6619470700,420,0,1,17,5,2,0,2,2,0,2,5,0,5,-2,5,3,-2,2,0,-1,6,-41,-1,-4,5,12,0,0,0,1,0,-1,0,-1
KR_6764913136,440,0,-54,-24,2,-4,4,0,0,3,3,1,3,4,2,1,3,3,1,4,0,4,12,-3,-1,4,1,0,0,1,-1,-1,-1,3,-1
KR_6755031649,420,0,29,-4,3,4,2,6,-1,3,2,-2,4,2,0,2,2,2,0,2,0,-5,12,-4,0,4,3,0,1,1,-1,-1,-1,2,-1
KR_6738633805,440,-5,-62,5,-13,-2,4,2,-2,2,0,-3,4,1,-5,6,1,-1,2,1,0,-5,7,-4,0,4,-1,0,-2,-1,-1,-1,-1,3,-1
KR_6723745883,420,-3,-34,-4,-3,8,0,8,-1,3,2,-1,1,0,-11,11,0,2,0,2,-1,-11,5,2,-5,3,-7,0,0,-1,1,0,1,6,-1
KR_6749065916,420,-1,-66,0,-5,-1,3,2,-3,5,2,0,4,4,-2,5,3,1,0,1,-1,3,-1,1,-3,2,1,0,0,-1,0,0,-1,3,-1
KR_6682693054,420,-1,10,25,-7,-3,3,0,-2,3,1,-2,2,0,-1,2,1,1,0,1,0,-13,-11,3,-3,0,-1,0,-1,1,-1,-1,1,4,-1
KR_6743628119,420,-4,-55,-3,-9,0,0,0,-5,6,1,3,2,5,-3,3,0,-4,4,0,0,-10,-19,-2,-3,5,2,0,-2,-1,0,-1,1,4,-1
KR_6564331329,420,1,-33,-6,10,3,1,4,-5,5,0,6,1,7,2,5,7,4,0,4,0,6,0,-4,-2,6,1,0,-2,1,1,-1,1,1,-1
KR_6749585581,420,-4,-42,-41,-9,1,0,1,-6,8,2,0,3,3,-4,5,1,0,2,2,0,-10,3,0,-4,4,-1,0,0,-1,-1,-1,-1,5,-1
KR_6650413955,420,2,31,12,9,7,0,7,0,2,2,1,0,1,1,2,3,0,2,2,0,3,9,2,-6,4,-2,0,1,-1,1,1,-1,2,-1
KR_6644591534,420,4,75,-16,3,5,1,6,2,1,3,0,4,4,-1,4,3,-3,4,1,-1,-4,10,-5,0,5,1,0,1,-1,-1,1,-1,1,-1
KR_6724065701,420,-1,-51,8,-4,-3,3,0,2,2,4,-1,4,3,-2,4,2,0,2,2,0,6,1,3,-5,2,-4,0,-1,-1,-1,-1,-1,1,-1
KR_6722332087,440,1,-59,28,1,0,2,2,0,4,4,-4,4,0,4,2,6,1,2,3,0,-6,-12,-3,-2,5,0,0,0,1,1,1,-1,5,-1
KR_6761134627,420,-1,-36,33,-6,1,1,2,-3,5,2,0,1,1,-7,8,1,3,0,3,0,-8,1,-5,-4,9,-1,0,0,-1,-1,0,-1,5,-1
KR_6760751957,420,-1,5,-2,-5,-5,6,1,0,0,0,1,2,3,0,1,1,-1,3,2,0,0,-29,1,-3,2,0,0,0,1,0,0,-1,4,-1
KR_6710646219,420,-6,-198,-15,-9,-7,8,1,-1,2,1,1,1,2,0,3,3,-2,2,0,0,-2,34,-5,0,5,1,0,-4,-1,-1,-1,-1,4,-1
KR_6670691131,420,-1,-20,0,-4,-1,3,2,-1,3,2,4,1,5,-4,6,2,-2,4,2,0,-4,93,-2,-4,6,2,0,-1,-1,-1,-1,1,6,-1
KR_6764924111,420,0,-2,4,4,4,0,4,1,2,3,0,1,1,-1,4,3,0,2,2,0,-3,1,3,-8,5,0,0,-1,-1,-1,-1,-1,6,-1
KR_6744089226,440,-7,-67,-48,-21,-5,6,1,-5,5,0,2,1,3,-10,13,3,-3,3,0,0,-23,-7,-1,-2,3,0,0,-4,-1,-1,-1,-1,6,-1
KR_6673910775,420,-4,-76,-16,-7,-4,5,1,-4,6,2,2,1,3,1,2,3,-2,2,0,-1,-11,-2,-4,-1,5,1,0,-1,-1,-1,-1,-1,2,-1
KR_6671221029,420,-4,25,-13,-8,1,2,3,0,0,0,-2,4,2,-4,4,0,-3,3,0,0,-6,-45,-6,-2,8,3,0,-1,-1,0,-1,-1,3,-1
KR_6616547329,420,-1,-3,-12,-5,2,1,3,0,6,6,-2,5,3,-5,5,0,0,3,3,0,4,-285,-2,-1,3,0,0,-1,-1,1,-1,-1,5,-1
KR_6701841251,420,-4,-80,-22,-11,-2,3,1,-4,5,1,-1,1,0,-2,4,2,-2,2,0,0,-17,15,-6,-1,7,-1,0,-3,-1,0,-1,-1,4,-1
KR_6569913128,420,0,-20,-8,0,-2,4,2,4,2,6,-1,4,3,1,0,1,-2,3,1,0,6,-14,-1,-3,4,5,0,0,-1,1,1,-1,3,-1
KR_6732919744,420,-1,23,-8,-2,-6,7,1,2,1,3,5,2,7,1,4,5,-4,4,0,0,0,-14,1,-3,2,-3,0,1,1,1,-1,1,6,-1
KR_6758098180,420,1,-4,32,-3,-2,3,1,2,0,2,0,3,3,1,3,4,-4,4,0,-1,-1,14,2,-4,2,-7,0,0,-1,1,-1,-1,5,-1
KR_6764699080,440,-1,-43,36,-1,-2,2,0,1,1,2,2,1,3,0,5,5,-2,3,1,-1,-2,-2,0,-4,4,-2,0,0,-1,1,0,-1,5,-1
KR_6692608945,420,-2,-80,7,-7,-3,4,1,1,3,4,-5,7,2,-1,4,3,1,2,3,0,2,-3,5,-7,2,0,0,-1,-1,-1,-1,-1,5,-1
KR_6759597005,420,-3,-1,0,-6,-2,3,1,3,4,7,-1,4,3,-5,6,1,-1,1,0,0,-12,-19,1,-5,4,0,0,-1,1,-1,-1,-1,3,-1
KR_6754153627,420,0,35,19,-4,-2,3,1,2,1,3,-2,3,1,-3,4,1,1,2,3,0,1,-3,-3,-1,4,-1,0,0,-1,-1,-1,1,4,-1
KR_6744494900,420,-3,-19,-36,-6,1,1,2,-2,2,0,-4,5,1,-1,8,7,0,1,1,0,-4,-1,-2,-2,4,-1,0,1,-1,1,1,-1,6,-1
KR_6764693596,420,-1,-62,-5,0,-1,4,3,-1,5,4,1,1,2,-1,2,1,2,1,3,0,3,-7,-4,-4,8,0,0,0,1,0,0,1,3,-1
KR_6758189824,440,-2,-25,-23,-6,-4,6,2,-2,3,1,-2,5,3,2,0,2,0,0,0,0,-14,-50,2,-5,3,28,0,-2,1,-1,-1,-1,4,-1
KR_6759067706,420,-2,-6,-13,-8,-3,4,1,-2,3,1,-2,3,1,-2,4,2,1,1,2,-1,-3,51,-3,0,3,-21,0,0,-1,1,-1,-1,5,-1
KR_6661402611,420,-1,14,-4,4,0,2,2,-2,2,0,3,1,4,3,1,4,0,0,0,0,6,-29,10,-11,1,10,0,0,0,-1,0,-1,0,-1
KR_6740920680,420,-3,24,-42,-12,-5,6,1,-3,6,3,-6,6,0,2,1,3,0,0,0,0,-13,-114,-4,-1,5,0,0,0,-1,1,-1,-1,6,-1
KR_6740100559,420,-2,20,-1,-6,0,1,1,0,3,3,-3,5,2,-4,5,1,1,1,2,-1,-7,-9,0,-3,3,0,0,-2,-1,-1,-1,-1,5,-1
KR_6763650900,440,1,53,12,-1,-2,4,2,1,2,3,-3,3,0,1,2,3,2,1,3,0,-2,0,1,-8,7,1,0,0,-1,1,1,-1,1,-1
KR_6740547993,420,-1,-64,-44,-3,2,2,4,-2,4,2,-1,7,6,-2,5,3,0,0,0,0,-2,2,0,-5,5,0,0,0,-1,-1,0,-1,6,-1
KR_6629182043,420,-1,17,-28,2,6,0,6,0,4,4,3,1,4,-7,8,1,0,0,0,0,-6,5,0,-3,3,-1,0,0,-1,0,1,1,1,-1
KR_6762075301,420,-1,-3,4,-7,-1,3,2,-1,3,2,-1,1,0,-4,4,0,0,0,0,1,-2,-13,-2,-1,3,1,0,0,-1,-1,0,1,6,-1
KR_6624319070,440,1,-4,29,7,3,2,5,3,2,5,-5,10,5,3,1,4,3,0,3,0,13,8,1,-6,5,0,0,-1,1,-1,-1,-1,2,-1
KR_6724772304,420,-3,23,-8,-10,-3,4,1,-5,7,2,-2,5,3,0,2,2,0,2,2,0,-13,-78,0,-4,4,3,0,-1,-1,-1,1,-1,2,-1
KR_6723548743,420,4,41,17,12,0,2,2,7,1,8,1,1,2,3,2,5,1,0,1,0,11,-4,-2,-5,7,1,0,1,1,1,1,1,6,-1
KR_6761385040,420,0,-83,64,-6,0,2,2,-2,4,2,5,1,6,-9,9,0,0,0,0,0,-12,-1,1,-3,2,-1,0,0,-1,-1,-1,-1,2,-1
KR_6767080745,420,-7,-102,-33,-9,-2,3,1,-6,6,0,-3,3,0,0,2,2,2,0,2,0,-3,-9,-1,-1,2,0,0,-1,1,-1,-1,1,4,-1
KR_6679269096,420,-3,-50,-12,-5,0,2,2,-2,5,3,0,2,2,-3,3,0,0,0,0,1,-4,5,1,-4,3,-4,0,0,-1,0,0,1,4,-1
KR_6766984661,420,3,26,7,3,-3,5,2,4,1,5,4,2,6,-4,5,1,2,0,2,1,2,1,1,-3,2,2,0,1,1,-1,1,1,6,-1
KR_6707634692,420,1,-3,27,-3,2,2,4,0,2,2,-1,2,1,-4,6,2,0,1,1,0,-6,47,-1,-4,5,-21,0,1,1,1,1,-1,3,-1
KR_6767430225,420,-3,6,-28,-4,1,1,2,-4,4,0,3,5,8,-6,8,2,2,2,4,0,-11,8,3,-5,2,-1,0,1,-1,-1,-1,-1,2,-1
KR_6760585376,420,-4,-29,-4,-10,1,2,3,-4,4,0,-4,4,0,-2,2,0,-1,2,1,-1,-9,9,-3,-1,4,2,0,-1,-1,1,-1,-1,3,-1
KR_6740566253,420,1,20,4,3,1,0,1,3,3,6,3,1,4,-1,2,1,-3,3,0,0,0,6,-1,-4,5,3,0,0,1,1,0,-1,4,-1
KR_6762126849,420,1,24,-8,0,1,2,3,-3,4,1,-3,4,1,6,0,6,-1,2,1,-1,-5,34,-2,-6,8,-16,0,0,1,-1,0,-1,4,-1
KR_6750741367,440,-1,-41,-8,-5,0,2,2,0,1,1,-1,2,1,-3,6,3,-1,2,1,0,-11,-23,4,-6,2,-5,0,-1,-1,-1,-1,-1,5,-1
KR_6762745456,420,-2,-1,-19,-7,-1,2,1,2,4,6,-3,3,0,-5,5,0,0,0,0,0,-10,-3,-4,-3,7,4,0,0,-1,1,0,-1,4,-1
KR_6738355063,440,0,29,7,-1,2,1,3,1,2,3,-1,1,0,-3,4,1,0,2,2,0,-1,-140,-2,-3,5,16,0,0,0,-1,0,-1,0,-1
KR_6722747575,440,-2,1,-38,-5,1,1,2,2,0,2,-3,4,1,-5,5,0,0,1,1,0,-7,-22,-5,-2,7,5,0,0,-1,0,1,-1,1,-1
KR_6727171133,440,-7,-66,-17,-16,0,1,1,-6,6,0,-7,8,1,-1,3,2,-2,5,3,0,-30,-2,4,-5,1,-3,0,-1,-1,1,-1,1,2,-1
KR_6755281917,440,-6,-59,20,-20,-4,4,0,-3,4,1,1,4,5,-13,16,3,-1,2,1,3,-4,-16,2,-7,5,-4,0,-1,0,0,-1,1,0,-1
KR_6703691113,420,0,72,4,-6,0,2,2,-5,6,1,3,6,9,-6,11,5,2,1,3,-1,-1,24,3,-5,2,-2,0,-1,-1,0,-1,1,3,-1
KR_6764113123,420,0,-50,-12,2,5,1,6,0,1,1,-1,5,4,-1,2,1,-1,2,1,0,1,-1,0,0,0,0,0,0,1,0,-1,-1,1,-1
KR_6752837404,440,-11,-169,9,3,-3,3,0,-2,8,6,1,1,2,7,2,9,0,0,0,1,8,3,2,-4,2,-3,0,-4,-1,-1,-1,1,3,-1
KR_6534940204,440,-4,-58,-48,-3,-2,6,4,0,1,1,-3,3,0,0,2,2,2,3,5,0,7,-21,5,-6,1,-3,0,-2,-1,-1,-1,-1,2,-1
KR_6756935407,420,-3,-75,-16,2,3,2,5,4,2,6,-2,2,0,-5,7,2,2,2,4,0,7,14,-1,-7,8,2,0,1,0,-1,1,1,0,-1
KR_6619650084,420,-1,-24,-3,-1,-2,2,0,-1,3,2,-2,4,2,1,0,1,3,1,4,0,5,-19,4,-8,4,-5,0,0,0,-1,0,1,0,-1
KR_6654109770,420,-1,18,-18,-1,3,1,4,0,2,2,-2,6,4,-1,1,0,-1,1,0,0,1,-122,-2,-2,4,3,0,0,-1,-1,-1,1,4,-1
KR_6759100657,420,1,35,-12,-1,1,2,3,-2,5,3,-2,4,2,0,2,2,2,1,3,0,-11,14,6,-9,3,-1,0,1,-1,0,1,1,5,-1
KR_6684443821,420,-2,-19,-48,1,1,0,1,-6,7,1,-1,5,4,5,0,5,2,2,4,0,6,3,2,-5,3,0,0,0,-1,1,-1,-1,3,-1
KR_6655016830,420,0,-65,12,-7,-3,4,1,3,1,4,1,1,2,-7,8,1,-1,2,1,1,-4,2,1,-4,3,1,0,0,-1,-1,-1,1,4,-1
KR_6687437540,420,-2,10,8,-1,-1,1,0,2,1,3,-1,3,2,-4,6,2,3,0,3,0,3,5,0,-3,3,0,0,0,-1,-1,0,-1,5,-1
KR_6619999180,420,0,32,-32,1,2,0,2,3,2,5,-2,5,3,-1,2,1,-1,3,2,1,1,-107,-3,-5,8,-1,0,1,-1,-1,1,1,6,-1
KR_6562039849,420,-4,-57,-2,-2,3,1,4,-7,8,1,2,1,3,-2,4,2,2,1,3,0,0,25,3,-9,6,-3,0,-1,-1,-1,-1,1,4,-1
KR_6640904764,420,-4,-70,-24,-10,-1,1,0,-5,8,3,0,2,2,-4,7,3,0,3,3,-1,-11,-3,-2,-3,5,-1,0,0,-1,1,0,-1,1,-1
KR_6727110328,420,-1,36,-12,-2,-2,2,0,2,2,4,4,0,4,-2,3,1,-4,4,0,0,-2,23,0,-2,2,-4,0,0,1,-1,0,1,1,-1
KR_6653669946,440,1,-41,4,-3,-2,3,1,-2,4,2,2,1,3,-3,3,0,2,1,3,0,2,-1,-2,-1,3,1,0,1,1,1,-1,-1,1,-1
KR_6743843370,420,-3,-76,15,-8,-2,3,1,1,4,5,-3,5,2,-3,6,3,-1,2,1,0,-5,-14,0,-4,4,3,0,-2,-1,1,-1,1,5,-1
KR_6739635986,420,0,1,8,-2,1,0,1,-2,7,5,1,1,2,-3,3,0,1,0,1,0,-9,3,-3,-3,6,1,0,1,-1,-1,1,1,3,-1
KR_6706736032,420,-4,-13,-27,-12,-2,2,0,-2,3,1,-1,1,0,-6,7,1,-1,2,1,0,-8,5,2,-4,2,-1,0,-1,1,-1,-1,-1,2,-1
KR_6758473685,420,-8,-22,-19,-11,1,3,4,-2,3,1,-9,10,1,-2,3,1,1,0,1,2,-2,-5,-2,-5,7,-3,0,-4,-1,-1,-1,-1,5,-1
KR_6765428487,420,2,-39,12,2,-3,4,1,8,2,10,-2,5,3,-1,3,2,0,3,3,-1,4,-2,0,-2,2,-2,0,0,1,-1,-1,-1,6,-1
KR_6724273248,420,0,-31,-23,6,-3,4,1,0,5,5,-2,4,2,4,1,5,7,1,8,3,18,21,4,-7,3,-3,0,1,1,1,1,1,2,-1
KR_6644824892,420,-7,-17,-28,-19,-3,4,1,-4,7,3,-5,5,0,-5,5,0,-2,3,1,0,-15,-6,-6,-3,9,-3,0,-3,-1,0,-1,-1,6,-1
KR_6702991192,420,2,-14,27,-2,-3,4,1,2,2,4,-3,4,1,2,1,3,0,1,1,0,0,0,-3,-2,5,3,0,0,1,-1,0,-1,3,-1
KR_6682395479,440,0,-68,4,1,1,1,2,-3,5,2,8,1,9,-5,7,2,0,0,0,0,-1,-4,1,-5,4,1,0,-1,1,-1,-1,1,6,-1
KR_6755377826,420,0,-14,33,1,-2,3,1,-2,4,2,-1,2,1,2,1,3,4,1,5,0,2,-3,2,-3,1,0,0,0,-1,0,0,1,4,-1
KR_6705465676,440,0,-61,9,3,-2,2,0,1,1,2,3,1,4,1,2,3,0,0,0,0,7,2,-1,-2,3,2,0,-1,1,-1,-1,-1,4,-1
KR_6762220145,420,-7,-22,4,-17,3,1,4,0,2,2,-6,7,1,-13,13,0,-1,1,0,1,-18,-10,-6,-1,7,1,0,-1,-1,1,-1,1,4,-1
KR_6624716072,420,-5,20,-8,-13,-2,3,1,-1,3,2,-3,4,1,-4,5,1,-3,5,2,0,-12,2,2,-4,2,-2,0,-1,1,-1,-1,-1,4,-1
KR_6755690693,440,-5,-91,8,-12,-7,7,0,-5,5,0,0,3,3,1,5,6,-1,1,0,0,-7,-4,-1,-4,5,-5,0,-4,-1,-1,-1,1,4,-1
KR_6725228654,420,-4,-92,-44,-12,0,3,3,-4,5,1,-1,1,0,-6,6,0,-1,1,0,-1,-12,-8,2,-4,2,1,0,-3,-1,-1,-1,-1,5,-1
KR_6711500795,440,-2,-21,5,-7,2,0,2,-2,2,0,1,1,2,-3,3,0,-5,7,2,0,-5,3,4,-6,2,-3,0,1,1,-1,1,1,4,-1
KR_6724726067,420,-3,-2,-12,-4,-2,4,2,3,2,5,-1,1,0,-4,5,1,0,0,0,0,-7,116,-3,-3,6,4,0,0,1,1,0,-1,1,-1
KR_6759982014,420,-3,42,-16,-6,5,1,6,-2,3,1,-5,6,1,-3,9,6,-1,2,1,-1,-16,-11,0,-6,6,4,0,0,-1,1,1,-1,3,-1
KR_6508765259,420,-2,-31,-4,-7,3,0,3,1,1,2,-4,4,0,-4,6,2,-3,3,0,0,-8,-28,2,-7,5,22,0,0,-1,1,0,-1,4,-1
KR_6734511437,420,-6,-96,-24,-10,-3,4,1,-4,4,0,-2,2,0,-1,2,1,0,2,2,0,-9,-108,-4,-1,5,-1,0,-3,-1,-1,-1,-1,5,-1
KR_6733166746,420,-6,-68,-12,-13,-4,6,2,1,1,2,-6,6,0,-3,3,0,-1,1,0,0,-8,-3,0,-3,3,0,0,-2,-1,-1,-1,1,2,-1
KR_6731282918,420,-2,-2,15,-1,-3,3,0,0,2,2,7,0,7,-2,5,3,-3,4,1,0,-4,-24,-6,-3,9,4,0,0,1,-1,-1,-1,6,-1
KR_6754127401,440,1,55,-4,-6,0,1,1,2,2,4,-1,3,2,-4,5,1,-3,3,0,0,-8,6,1,-6,5,-1,0,-1,1,-1,-1,-1,1,-1
KR_6649940425,420,2,0,-4,1,1,0,1,2,5,7,1,1,2,-2,3,1,-1,2,1,-1,-5,-312,0,-3,3,-1,0,0,-1,-1,0,-1,3,-1
KR_6751155908,420,1,18,12,4,0,1,1,2,3,5,-1,4,3,2,0,2,1,0,1,0,10,-7,-1,-2,3,2,0,1,1,1,1,1,2,-1
KR_6768369647,420,1,-20,8,-3,-2,3,1,-3,5,2,1,1,2,-1,4,3,2,1,3,-1,6,5,4,-5,1,-2,0,0,-1,-1,0,-1,1,-1
KR_6715430380,420,1,8,1,-2,2,2,4,0,3,3,0,5,5,-3,4,1,-1,1,0,-1,-9,-16,-3,0,3,-3,0,0,-1,-1,-1,-1,3,-1
KR_6693403130,420,1,7,8,2,-1,2,1,5,1,6,1,2,3,-2,4,2,-1,2,1,0,9,56,3,-5,2,-37,0,0,1,1,0,-1,1,-1
KR_6762271027,440,-2,4,-5,-10,-3,3,0,-2,2,0,-2,3,1,-2,4,2,-1,1,0,0,-8,-14,1,-4,3,-2,0,0,-1,-1,0,-1,3,-1
KR_6631252070,420,-2,-50,-4,-5,-2,3,1,1,2,3,-1,4,3,0,4,4,-3,3,0,0,-5,-6,-4,-4,8,-1,0,0,1,1,0,-1,2,-1
KR_6765790703,440,-3,-37,39,-5,-2,3,1,3,0,3,-2,5,3,-1,1,0,-3,3,0,0,3,1,3,-6,3,0,0,-1,1,-1,-1,-1,5,-1
KR_6743626303,420,0,-29,4,-1,2,1,3,2,1,3,-1,2,1,-3,3,0,-1,2,1,0,-1,8,2,-3,1,3,0,-1,1,1,-1,1,5,-1
KR_6737839283,420,1,24,32,4,0,1,1,8,1,9,1,3,4,-3,4,1,-2,3,1,0,4,-7,-3,-1,4,0,0,0,-1,1,1,-1,1,-1
KR_6737769212,440,-7,-64,-8,-18,2,2,4,-1,2,1,-12,12,0,-5,5,0,-2,2,0,1,-21,6,1,-3,2,-2,0,-1,0,-1,-1,1,0,-1
KR_6765504598,420,0,-32,-3,0,-2,3,1,1,1,2,0,4,4,1,0,1,0,2,2,0,3,135,3,-6,3,-2,0,-1,-1,-1,-1,1,6,-1
KR_6715262485,420,2,70,22,2,1,3,4,1,1,2,2,0,2,2,3,5,-4,6,2,0,0,38,-2,-6,8,-32,0,0,-1,1,0,-1,2,-1
KR_6741351764,420,-4,-26,-39,-13,0,2,2,-4,5,1,-2,2,0,-6,6,0,-1,1,0,0,-13,2,1,-6,5,-3,0,-2,-1,-1,-1,-1,5,-1
KR_6762923882,420,1,4,-20,-5,2,0,2,-1,4,3,1,2,3,-6,6,0,-1,1,0,0,-11,6,2,-5,3,0,0,-1,-1,-1,-1,-1,4,-1
KR_6732460278,420,-6,-32,-19,-16,0,0,0,-1,4,3,-5,7,2,-7,8,1,-3,4,1,0,-13,27,-4,-3,7,1,0,-2,0,-1,-1,-1,0,-1
KR_6765332164,420,1,26,-12,11,8,1,9,5,2,7,-3,4,1,2,1,3,-1,3,2,0,7,0,3,-7,4,0,0,2,1,1,1,1,1,-1
KR_6662602588,420,-1,12,-24,3,-1,1,0,6,2,8,-1,3,2,1,0,1,-2,2,0,0,6,-3,-2,-3,5,1,0,0,-1,-1,1,-1,1,-1
KR_6765331563,420,0,23,9,-2,-2,3,1,5,2,7,-5,6,1,1,1,2,-1,3,2,0,-5,40,1,-4,3,-22,0,0,-1,-1,0,1,2,-1
KR_6737297867,420,-2,71,4,2,1,3,4,-2,4,2,8,1,9,-2,8,6,-3,3,0,0,1,71,0,-7,7,2,0,1,1,-1,1,-1,4,-1
KR_6761082485,440,0,-18,-4,-4,0,2,2,4,3,7,-2,2,0,-4,5,1,-2,4,2,1,-5,36,4,-5,1,3,0,0,1,1,-1,1,1,-1
KR_6764969803,420,-2,-20,8,-1,1,2,3,2,3,5,-2,2,0,-2,2,0,0,2,2,0,-3,13,0,-2,2,5,0,0,-1,1,0,1,1,-1
KR_6648069122,420,-2,-56,-40,-8,1,0,1,-8,8,0,3,1,4,-2,3,1,-2,4,2,0,-17,-2,-2,-6,8,-2,0,-1,-1,0,-1,-1,5,-1
KR_6725738555,420,-3,-56,8,-8,-2,5,3,-3,4,1,1,0,1,-4,4,0,0,0,0,0,-8,-10,-8,-1,9,-2,0,-2,-1,-1,-1,-1,4,-1
KR_6652402863,420,-1,23,-20,-5,-2,3,1,4,1,5,-2,5,3,-1,4,3,-4,4,0,-1,4,-14,-1,-6,7,1,0,1,1,1,1,-1,5,-1
KR_6727861389,420,1,-34,-28,2,4,1,5,-4,4,0,-2,3,1,3,0,3,1,0,1,0,-2,-38,-2,-3,5,24,0,-1,-1,0,-1,1,5,-1
KR_6767655210,420,-4,-46,-43,-4,-1,2,1,0,3,3,-8,9,1,4,1,5,1,0,1,0,3,-6,-1,-3,4,2,0,0,1,-1,-1,1,1,-1
KR_6567834625,420,-1,-42,9,6,1,1,2,0,4,4,3,0,3,2,0,2,0,0,0,0,8,-8,0,-8,8,1,0,0,1,0,-1,-1,4,-1
KR_6764726615,420,-1,-55,17,-7,-6,7,1,4,1,5,-3,4,1,-1,2,1,-1,1,0,0,-6,-39,-3,-6,9,22,0,-2,-1,-1,-1,-1,2,-1
KR_6759334608,420,-3,15,16,-9,-5,5,0,1,0,1,-1,3,2,-6,8,2,2,2,4,0,-9,-2,-3,-3,6,2,0,0,1,1,0,-1,4,-1
KR_6765974880,440,-3,26,4,-4,-2,3,1,-3,5,2,-1,2,1,1,3,4,1,0,1,0,-1,0,2,-4,2,-6,0,0,1,-1,-1,-1,3,-1
KR_6739149983,420,-3,-3,-40,1,0,1,1,-5,5,0,2,0,2,3,5,8,1,0,1,-1,-1,-3,1,-5,4,-6,0,0,1,1,0,-1,4,-1
KR_6762051774,420,0,-22,-16,2,-1,3,2,2,1,3,-1,3,2,1,1,2,1,2,3,0,3,0,1,-3,2,-3,0,0,-1,-1,0,1,2,-1
KR_6732378167,420,-2,-102,3,-3,-2,3,1,-1,1,0,-1,2,1,0,0,0,1,0,1,0,4,-51,-3,-2,5,24,0,-1,0,-1,-1,1,0,-1
KR_6482507587,420,-2,-22,4,-2,-2,3,1,-2,5,3,-1,3,2,4,2,6,-1,2,1,0,8,-2,0,-4,4,0,0,-3,-1,-1,-1,1,6,-1
KR_6742209146,420,-4,-58,-4,-13,-1,2,1,3,0,3,-1,1,0,-14,14,0,0,0,0,0,-9,-6,-1,-5,6,4,0,-1,1,1,-1,-1,1,-1
KR_6763674903,420,-5,-60,20,-13,-2,5,3,-4,8,4,-5,5,0,0,1,1,-2,3,1,0,-9,-17,-5,-1,6,3,0,-2,-1,-1,-1,-1,2,-1
KR_6687303205,420,-2,-67,-29,1,2,1,3,1,0,1,-1,3,2,1,2,3,-2,2,0,0,4,-42,0,-4,4,31,0,-1,-1,0,-1,-1,2,-1
KR_6750726887,420,-5,-74,-5,-7,-2,2,0,3,2,5,-3,4,1,-3,5,2,-2,4,2,2,2,6,-4,-2,6,-2,0,-1,-1,-1,-1,1,4,-1
KR_6767228691,440,-1,-96,12,1,3,3,6,-4,6,2,-1,3,2,3,1,4,0,0,0,-1,3,47,1,-5,4,2,0,-1,1,0,-1,-1,3,-1
KR_6765014539,420,-1,-38,8,-5,-3,5,2,0,2,2,-1,2,1,-2,2,0,1,0,1,0,-2,48,5,-6,1,-28,0,-1,1,1,-1,-1,5,-1
KR_6767473975,420,-1,30,-16,-3,2,0,2,-4,7,3,-1,6,5,3,3,6,-3,4,1,0,-3,-6,-5,-3,8,1,0,-1,-1,1,-1,1,5,-1
KR_6761436450,440,0,13,-12,0,1,0,1,0,4,4,-2,2,0,0,2,2,1,1,2,0,-2,-2,1,-8,7,0,0,-1,1,1,-1,1,6,-1
KR_6642142309,420,0,-47,12,0,-1,1,0,-1,4,3,-2,2,0,4,0,4,0,0,0,0,-2,8,4,-5,1,-3,0,0,-1,1,0,1,5,-1
KR_6602490319,420,-3,-1,-8,-9,-1,1,0,-4,5,1,-3,6,3,-3,4,1,2,0,2,0,-10,-2,-5,-2,7,-2,0,0,-1,1,0,1,6,-1
KR_6624590805,420,-5,-63,-4,-11,-8,9,1,-1,4,3,2,0,2,-4,10,6,0,1,1,-1,-12,-2,-1,-2,3,-1,0,-2,-1,-1,-1,-1,1,-1
KR_6713290578,420,1,-31,15,2,0,3,3,-2,4,2,4,1,5,2,3,5,-2,2,0,-1,3,-7,-2,-2,4,2,0,0,-1,-1,-1,-1,2,-1
KR_6759087798,440,2,-27,-4,1,-1,2,1,1,0,1,2,3,5,0,3,3,-1,1,0,0,1,-21,-4,0,4,-5,0,-1,-1,-1,-1,1,2,-1
KR_6685013516,420,-3,-97,8,-12,-2,2,0,0,2,2,-4,5,1,-1,3,2,-5,8,3,-1,-14,-4,-4,0,4,-3,0,-1,1,-1,-1,-1,3,-1
KR_6750870184,420,-2,-54,-24,-6,1,1,2,-3,4,1,-6,8,2,0,5,5,2,0,2,0,0,71,-2,-1,3,4,0,0,-1,-1,-1,-1,2,-1
KR_6763398719,440,-10,-143,-60,-26,-7,8,1,-7,9,2,-2,3,1,-7,8,1,-3,3,0,-3,-36,2,1,-3,2,-4,0,-2,-1,-1,-1,-1,3,-1
KR_6763895973,420,-3,-10,19,-8,2,2,4,-7,7,0,-1,4,3,-1,3,2,-1,1,0,0,-11,3,2,-5,3,-1,0,-2,-1,1,-1,-1,5,-1
KR_6694201995,420,0,-47,2,0,-4,4,0,3,0,3,3,1,4,0,1,1,-2,3,1,-1,5,5,6,-9,3,-1,0,0,1,0,0,-1,1,-1
KR_6762707277,420,-2,-25,-24,-1,-2,3,1,0,4,4,-1,2,1,0,2,2,2,1,3,-3,-7,4,-1,-3,4,-1,0,-2,1,-1,-1,-1,4,-1
KR_6753994126,420,-3,-34,-21,-2,3,1,4,-4,7,3,-2,7,5,4,3,7,-3,3,0,1,-4,5,6,-8,2,-1,0,-2,1,-1,-1,1,1,-1
KR_6619422151,420,3,50,-12,4,7,1,8,0,3,3,-4,5,1,1,0,1,0,1,1,-2,-1,12,2,-4,2,-4,0,1,1,-1,1,-1,6,-1
KR_6745100980,420,-4,24,-39,0,2,2,4,-1,3,2,-1,3,2,-1,4,3,1,0,1,1,0,-12,3,-5,2,-1,0,0,-1,-1,0,1,3,-1
KR_6753011712,440,3,-37,42,12,0,1,1,4,1,5,5,2,7,2,4,6,1,2,3,-1,10,3,0,-2,2,-2,0,2,1,1,1,-1,3,-1
KR_6761532814,420,0,-14,-4,2,-2,2,0,2,0,2,3,0,3,-1,1,0,0,0,0,0,3,-120,-3,-5,8,4,0,-1,1,1,-1,1,5,-1
KR_6761055620,420,0,-69,9,-1,-1,1,0,3,5,8,2,3,5,-5,6,1,0,1,1,-3,-6,-32,1,-7,6,18,0,-1,1,1,-1,-1,6,-1
KR_6617859337,420,-5,-50,-53,-8,-1,2,1,0,3,3,2,1,3,-7,7,0,-2,2,0,0,-2,-2,-5,-2,7,3,0,-1,-1,-1,-1,1,6,-1
KR_6748029574,420,-2,-68,-28,-6,-8,8,0,-2,5,3,-1,4,3,6,1,7,-1,1,0,-1,3,-141,-1,-5,6,2,0,-1,-1,-1,-1,-1,3,-1
KR_6751989928,420,0,-67,16,-1,2,2,4,2,2,4,0,3,3,-3,6,3,-2,2,0,-1,-4,9,5,-8,3,-4,0,1,-1,1,1,-1,3,-1
KR_6739780114,420,-3,-78,-24,-5,-2,3,1,-2,5,3,2,2,4,1,1,2,-4,4,0,0,-5,7,-1,-5,6,3,0,-2,1,-1,1,-1,5,-1
KR_6758705894,420,-1,0,12,-4,-2,3,1,-4,6,2,-1,2,1,2,0,2,1,0,1,0,-13,5,0,-5,5,0,0,1,-1,-1,1,1,2,-1
KR_6647488979,420,-5,-50,-44,-12,4,1,5,-1,2,1,-3,4,1,-10,11,1,-2,2,0,0,-13,-9,-2,-6,8,-3,0,-2,-1,-1,1,-1,3,-1
KR_6766043901,420,-4,-69,-47,-10,-2,3,1,-2,2,0,0,0,0,-6,6,0,0,0,0,0,-11,12,-5,-3,8,-6,0,-1,-1,0,-1,-1,1,-1
KR_6663914130,420,0,-38,-4,3,-1,2,1,4,2,6,2,1,3,-4,4,0,2,0,2,0,0,31,-3,-2,5,-28,0,-1,-1,1,-1,1,4,-1
KR_6548202319,420,0,-33,56,-3,2,0,2,4,0,4,-6,6,0,-3,5,2,0,0,0,1,-1,0,0,-7,7,-5,0,-2,0,0,-1,1,0,-1
KR_6759462930,420,3,40,20,7,3,0,3,-1,2,1,4,0,4,0,2,2,1,1,2,0,2,24,1,-2,1,0,0,1,1,-1,1,1,5,-1
KR_6761007677,420,-3,-51,-17,-2,0,2,2,-2,3,1,1,3,4,0,2,2,-1,2,1,0,2,-142,-2,-2,4,-3,0,-1,-1,-1,-1,1,1,-1
KR_6684585644,420,-3,-39,34,-9,-5,6,1,-1,1,0,0,1,1,1,2,3,-4,4,0,0,-8,-15,1,-2,1,2,0,-2,1,-1,-1,-1,1,-1
KR_6733272036,420,0,24,-3,0,1,0,1,1,2,3,-3,3,0,-1,1,0,2,0,2,0,-5,-38,-1,-4,5,0,0,1,-1,-1,-1,-1,6,-1
KR_6751939884,420,-3,-28,-14,-4,-1,1,0,-1,3,2,0,2,2,-1,2,1,-1,1,0,0,-3,33,2,-5,3,-3,0,0,1,-1,0,-1,5,-1
KR_6654462966,420,0,15,3,0,-1,1,0,-3,5,2,4,1,5,0,3,3,0,1,1,2,8,5,1,-5,4,-8,0,0,0,-1,0,1,0,-1
KR_6730809953,420,-3,-34,0,1,0,3,3,1,5,6,3,1,4,-1,4,3,-2,2,0,0,1,-4,-9,0,9,3,0,0,-1,0,0,1,4,-1
KR_6710346022,420,-4,-75,-29,-5,-3,4,1,-2,3,1,0,1,1,1,1,2,-1,1,0,0,-7,-8,2,-4,2,-2,0,-4,-1,-1,-1,-1,3,-1
KR_6648593662,420,-2,-72,-4,-4,0,1,1,0,3,3,2,0,2,-5,8,3,-1,2,1,0,-7,-10,-2,-4,6,-1,0,-1,1,1,1,-1,4,-1
KR_6642252336,420,-3,-100,-40,3,1,0,1,0,1,1,-2,3,1,4,0,4,0,0,0,0,8,4,4,-7,3,-3,0,0,-1,-1,0,1,5,-1
KR_6692211468,420,-5,-42,-15,-11,-5,6,1,1,4,5,-1,2,1,-5,6,1,-1,4,3,-1,-15,-6,-2,-5,7,-3,0,-1,1,1,-1,-1,5,-1
KR_6765643602,440,-6,-1,-28,-12,-1,2,1,-2,3,1,4,3,7,-10,10,0,-3,5,2,0,-14,-7,0,-1,1,-1,-1,-3,-1,-1,-1,-1,2,-1
KR_6764593744,420,2,-41,10,-4,2,1,3,-2,3,1,-2,2,0,-2,3,1,0,1,1,0,-5,-5,0,-3,3,-2,0,0,0,1,0,-1,0,-1
KR_6642663012,420,-5,-49,-27,-12,-1,2,1,-5,7,2,-4,7,3,-2,4,2,0,0,0,0,-18,3,-1,-3,4,1,0,-2,-1,-1,-1,-1,1,-1
KR_6768248888,440,-3,31,9,-11,-4,5,1,-3,4,1,-3,4,1,1,1,2,-2,2,0,0,-7,13,-1,-3,4,1,0,0,-1,-1,0,1,4,-1
KR_6707573269,420,2,-6,7,4,3,1,4,-4,5,1,3,0,3,1,2,3,1,0,1,-1,2,-7,1,-5,4,1,0,0,1,1,1,-1,5,-1
KR_6679299501,420,-4,-63,-12,-5,-4,5,1,-1,3,2,-4,6,2,4,2,6,0,0,0,0,-8,-11,-5,-6,11,-2,0,0,1,0,-1,1,2,-1
KR_6709297192,420,-4,-42,0,-7,1,0,1,-3,6,3,-3,4,1,-2,5,3,0,1,1,0,-7,8,3,-5,2,1,0,-1,1,1,-1,-1,3,-1
KR_6744828822,420,-1,-8,-29,-13,-4,5,1,-2,4,2,-2,5,3,-5,6,1,0,0,0,0,-10,-306,-2,-4,6,1,0,-1,-1,-1,-1,-1,2,-1
KR_6725032294,440,-7,-112,-60,-19,-5,5,0,-5,5,0,-8,10,2,-3,5,2,2,0,2,0,-4,-6,-1,-3,4,3,0,-2,-1,-1,-1,-1,4,-1
KR_6763775308,420,0,24,7,2,2,1,3,-3,7,4,4,2,6,-1,2,1,0,0,0,0,-5,-9,-5,-1,6,2,0,1,-1,-1,1,1,4,-1
KR_6665914994,420,0,-43,8,-3,2,1,3,-2,2,0,-4,6,2,1,4,5,0,1,1,0,-4,37,1,-6,5,0,0,-1,-1,1,1,-1,2,-1
KR_6667638464,420,-3,-13,-18,-6,2,0,2,-7,8,1,2,3,5,0,0,0,-3,3,0,0,-7,-7,-5,-3,8,2,0,-1,1,-1,-1,1,3,-1
KR_6759915508,420,-4,-43,-18,-8,0,1,1,-3,4,1,-2,2,0,-2,2,0,-1,1,0,0,-9,-82,3,-4,1,-2,0,0,1,0,-1,1,3,-1
KR_6467695622,420,-2,-51,1,-2,1,3,4,-1,2,1,3,1,4,-4,4,0,-1,1,0,-1,-9,46,3,-5,2,-12,0,0,-1,1,1,-1,4,-1
KR_6662044711,420,-4,-69,-40,-3,-2,2,0,1,4,5,1,0,1,-3,4,1,0,0,0,0,-1,8,4,-6,2,-5,0,0,1,-1,1,-1,5,-1
KR_6713973756,420,2,48,9,-2,7,0,7,1,2,3,-15,15,0,5,2,7,0,2,2,-3,-1,-3,4,-9,5,2,0,2,1,-1,1,1,2,-1
KR_6761576225,420,-1,-18,-2,1,-2,3,1,4,2,6,3,1,4,-4,6,2,0,1,1,0,2,258,0,-3,3,-1,0,0,1,1,0,1,6,-1
KR_6761442697,420,-7,-166,2,-9,-4,4,0,0,2,2,1,3,4,-8,8,0,2,1,3,0,-8,-44,1,-4,3,14,0,-1,1,1,-1,1,5,-1
KR_6760062549,420,2,-27,-19,4,2,1,3,2,0,2,3,0,3,-3,3,0,0,0,0,0,0,-5,0,-4,4,0,0,-2,-1,-1,-1,1,4,-1
KR_6622659144,420,-5,-56,-11,-14,-4,4,0,-1,5,4,-1,1,0,-6,7,1,-2,2,0,-3,-17,-1,0,-1,1,-3,0,-3,-1,-1,-1,-1,4,-1
KR_6763002423,420,1,6,24,-4,1,3,4,-2,3,1,2,0,2,-5,7,2,0,0,0,1,-6,2,5,-8,3,-8,0,1,-1,1,1,1,3,-1
KR_6760501133,420,2,30,-16,2,1,2,3,-2,2,0,-3,3,0,5,1,6,1,0,1,-1,3,51,3,-5,2,-24,0,1,-1,1,1,-1,3,-1
KR_6760776191,420,2,17,-20,5,0,2,2,-1,1,0,5,0,5,2,3,5,-1,2,1,0,4,-27,3,-4,1,5,0,0,1,1,1,-1,5,-1
KR_6624662254,420,-7,-75,-11,-16,-1,5,4,-1,1,0,-1,3,2,-15,15,0,2,1,3,0,-6,-2,-2,-2,4,0,0,-2,-1,-1,-1,-1,1,-1
KR_6755953462,420,-3,5,-33,-8,-1,2,1,2,0,2,-2,4,2,-6,8,2,-1,2,1,0,-7,-5,-1,-7,8,0,0,-2,-1,-1,-1,-1,3,-1
KR_6762839516,420,-3,-4,-48,-2,-1,2,1,-1,5,4,-2,3,1,-2,2,0,4,0,4,0,1,28,-1,-5,6,-23,0,1,-1,1,1,1,5,-1
KR_6615731185,420,1,39,-9,-3,-3,3,0,1,2,3,0,3,3,0,0,0,-1,1,0,0,-2,-32,-3,-2,5,15,0,1,0,-1,1,-1,0,-1
KR_6731905722,420,0,37,-16,-2,-3,4,1,-1,3,2,0,6,6,2,4,6,0,1,1,0,-8,13,1,-10,9,-6,0,-1,1,-1,-1,-1,4,-1
KR_6755238331,420,-5,-89,-20,-10,-1,1,0,-7,7,0,1,4,5,-4,5,1,1,2,3,0,-1,157,-5,-3,8,-1,0,-1,-1,0,-1,-1,4,-1
KR_6687934077,420,-6,-66,-3,-11,1,1,2,-4,6,2,-2,2,0,-7,8,1,1,1,2,0,-13,-52,-6,-4,10,-2,0,-2,-1,1,-1,-1,3,-1
KR_6762575254,420,-5,-55,-8,-13,2,1,3,-2,6,4,-4,7,3,-4,4,0,-5,7,2,-1,-16,-2,-5,0,5,0,0,-2,-1,-1,-1,-1,2,-1
KR_6755915778,420,0,10,32,1,-2,3,1,0,3,3,0,1,1,2,3,5,1,1,2,1,3,127,4,-8,4,0,0,-1,1,-1,-1,1,4,-1
KR_6767205194,440,-3,4,-17,-11,-4,6,2,-7,7,0,3,2,5,-4,5,1,1,1,2,0,-3,7,1,-2,1,-3,0,-2,0,0,-1,-1,0,-1
KR_6732773248,420,-1,-22,8,-4,-2,2,0,-2,2,0,-2,4,2,2,2,4,0,0,0,-1,-5,76,1,-6,5,-38,0,0,-1,1,1,-1,4,-1
KR_6630471503,420,-6,-25,-32,-10,-2,4,2,-4,7,3,5,1,6,-8,8,0,-1,1,0,-2,-11,23,-5,-1,6,0,0,-2,-1,-1,-1,-1,4,-1
KR_6646299036,420,-3,24,-2,-1,-1,2,1,-3,5,2,-2,5,3,5,2,7,0,1,1,0,-4,0,1,-3,2,0,0,0,1,-1,1,-1,5,-1
KR_6767064632,420,-2,53,12,-6,0,3,3,1,0,1,-5,8,3,-1,5,4,-1,2,1,1,-14,2,-1,-2,3,1,0,1,-1,-1,-1,1,3,-1
KR_6693704842,420,-4,-91,-8,-12,-5,5,0,3,0,3,-3,3,0,-6,8,2,-1,1,0,-1,-10,109,-1,-3,4,-5,0,-2,-1,-1,-1,-1,3,-1
KR_6682284392,420,0,-8,36,1,-3,4,1,4,4,8,0,2,2,-2,4,2,2,0,2,0,9,-2,2,-5,3,-1,0,0,1,1,-1,-1,6,-1
KR_6655190463,420,0,27,-1,-1,-5,5,0,2,2,4,2,0,2,-2,4,2,2,2,4,0,-10,-329,-2,-4,6,-5,0,-1,-1,-1,-1,-1,3,-1
KR_6607647068,420,-4,-47,-51,-7,1,2,3,-1,3,2,-5,8,3,2,4,6,-4,5,1,2,-4,8,6,-9,3,-3,0,-1,-1,-1,1,1,6,-1
KR_6760336134,420,-1,-36,12,-12,-2,2,0,-1,4,3,-7,9,2,-1,4,3,-1,1,0,0,-4,21,-5,-2,7,3,0,-1,0,-1,-1,-1,0,-1
KR_6719820852,420,-7,-170,-20,-3,-3,3,0,1,1,2,0,0,0,-1,1,0,0,0,0,0,-2,-9,-1,-2,3,-3,0,-2,-1,1,-1,-1,6,-1
KR_6706841456,420,-1,69,-8,-4,-5,5,0,1,2,3,-1,3,2,3,2,5,-2,3,1,0,-4,-12,-1,-3,4,8,0,0,-1,-1,0,1,2,-1
KR_6725655484,420,-2,-5,12,-3,2,0,2,-5,7,2,0,3,3,2,2,4,-2,2,0,-1,-9,1,-3,-4,7,1,0,0,1,1,0,-1,3,-1
KR_6768374313,420,2,35,14,-2,1,4,5,0,1,1,-3,4,1,1,1,2,-1,2,1,1,-3,7,4,-5,1,-5,0,0,-1,1,1,-1,6,-1
KR_6643226735,420,3,-48,2,6,0,1,1,0,1,1,3,0,3,3,0,3,0,0,0,0,4,16,1,-5,4,0,0,0,1,-1,-1,-1,5,-1
KR_6684480354,420,-3,-27,-51,-8,1,3,4,-2,2,0,-4,4,0,-5,5,0,2,2,4,0,-4,-14,2,-4,2,-2,0,0,-1,1,1,-1,4,-1
KR_6712278065,440,-2,16,-12,-8,1,0,1,-3,4,1,-2,3,1,-5,5,0,1,0,1,0,-13,11,2,-4,2,1,0,0,1,1,0,-1,4,-1
KR_6752476477,440,-1,-31,-9,-3,1,1,2,1,3,4,-1,1,0,-1,3,2,-3,3,0,0,-1,6,0,-6,6,-4,0,0,-1,-1,0,1,2,-1
KR_6758739084,420,-5,-68,-9,-10,-4,5,1,0,3,3,-3,3,0,-4,5,1,1,2,3,0,-7,7,1,-3,2,-2,0,0,-1,-1,0,1,5,-1
KR_6645122879,420,0,29,16,-6,-2,2,0,-2,3,1,-1,4,3,-1,4,3,0,0,0,0,-9,-2,-1,-5,6,0,0,0,0,-1,-1,-1,0,-1
KR_6607470833,420,0,40,-6,-3,5,1,6,-4,4,0,-2,3,1,-1,1,0,-1,1,0,0,-5,-4,-3,-3,6,-1,0,-2,-1,-1,-1,-1,3,-1
KR_6561299873,420,-2,-43,7,-4,-1,2,1,2,1,3,0,2,2,-7,7,0,2,0,2,-1,-5,12,-3,-3,6,-1,0,-1,-1,1,-1,-1,4,-1
KR_6655631945,420,-1,-55,20,-1,-2,2,0,-1,1,0,0,2,2,1,2,3,1,2,3,0,-2,0,-4,-5,9,-3,0,0,1,-1,-1,-1,5,-1
KR_6738188184,420,-2,-60,-4,-5,1,2,3,3,2,5,-1,1,0,-8,8,0,0,0,0,-1,-4,-13,-3,-4,7,-5,0,0,1,-1,-1,-1,1,-1
KR_6763056228,420,1,5,-12,-4,-6,7,1,2,1,3,2,1,3,-1,2,1,-1,1,0,1,3,5,2,-5,3,1,0,0,0,0,-1,1,0,-1
KR_6765380553,420,1,-71,4,-2,3,0,3,-1,4,3,0,1,1,-4,7,3,0,0,0,0,-6,-5,-4,-3,7,4,0,-1,-1,1,-1,1,5,-1
KR_6747322185,440,0,29,-16,0,0,0,0,-4,4,0,2,2,4,2,0,2,0,0,0,-1,5,-6,-4,-1,5,2,0,0,-1,1,-1,-1,1,-1
KR_6729493659,440,-2,-86,-4,-4,0,3,3,1,1,2,-3,3,0,0,0,0,-2,8,6,-1,-1,6,2,-5,3,-2,0,0,1,1,-1,1,1,-1
KR_6594721806,420,0,-57,-14,0,0,3,3,3,0,3,-4,5,1,1,3,4,0,1,1,0,0,-13,0,-5,5,-2,0,0,1,-1,0,-1,1,-1
KR_6724980513,420,0,8,-10,-8,0,1,1,-6,6,0,3,1,4,-6,6,0,1,3,4,-2,-14,4,0,-5,5,-1,0,0,-1,-1,-1,-1,2,-1
KR_6762729701,420,-2,-73,-4,-9,1,2,3,1,1,2,-6,6,0,-5,5,0,0,1,1,0,-10,11,3,-5,2,-4,0,-1,0,-1,-1,-1,0,-1
KR_6716389190,420,4,67,4,7,1,4,5,1,4,5,1,2,3,2,0,2,2,0,2,0,4,-4,2,-4,2,4,0,0,1,-1,1,-1,4,-1
KR_6619412974,440,3,32,-7,8,-1,2,1,1,3,4,1,3,4,8,1,9,-1,1,0,0,16,2,1,-4,3,2,0,1,1,1,1,-1,2,-1
KR_6616495077,440,-3,-17,-16,-10,3,1,4,-4,5,1,-3,3,0,-6,6,0,0,0,0,0,-12,-1,1,-7,6,-1,0,0,-1,-1,1,-1,3,-1
KR_6752130480,420,0,-60,-9,-3,2,2,4,0,4,4,2,3,5,-4,5,1,-3,3,0,0,-11,41,4,-7,3,-23,0,0,1,-1,0,-1,5,-1
KR_6743409349,420,-2,-61,0,-2,0,1,1,1,2,3,1,4,5,-2,3,1,-2,2,0,0,3,-310,-3,-1,4,3,0,-1,-1,1,-1,-1,6,-1
KR_6601308550,420,-5,-32,-32,-13,-1,2,1,-4,5,1,0,3,3,-4,7,3,-4,6,2,0,-9,-5,-1,-1,2,-1,0,-1,-1,-1,-1,-1,3,-1
KR_6619736864,420,-2,17,0,-9,1,0,1,-1,4,3,1,1,2,-7,7,0,-3,3,0,0,-13,-1,0,-3,3,0,0,0,-1,1,-1,-1,5,-1
KR_6762448616,440,-2,-23,-16,-1,-2,4,2,-1,4,3,2,2,4,0,4,4,0,1,1,0,0,4,-5,-1,6,-3,0,-1,1,1,-1,1,5,-1
KR_6651733159,420,0,-35,3,-3,-3,3,0,1,3,4,1,2,3,-1,3,2,-1,3,2,0,0,221,-3,-2,5,-2,0,1,-1,1,1,-1,5,-1
KR_6764829619,420,-6,-37,4,-18,-8,9,1,-4,4,0,2,0,2,-8,8,0,0,1,1,-1,-20,2,1,-2,1,-2,0,-2,-1,-1,-1,-1,5,-1
KR_6714623701,420,-4,-18,-20,-8,0,1,1,-4,6,2,-3,4,1,-3,4,1,2,0,2,0,0,5,-4,-4,8,-3,0,0,-1,1,0,1,2,-1
KR_6688254354,420,-2,-6,-15,-4,0,1,1,0,5,5,-3,3,0,0,1,1,-1,4,3,0,-2,-15,5,-7,2,0,0,0,-1,1,0,-1,1,-1
KR_6522237919,420,-2,-36,-27,-4,-1,4,3,0,3,3,-1,3,2,1,2,3,-3,3,0,0,-10,-3,-3,-2,5,-4,0,-1,-1,-1,-1,1,1,-1
KR_6649951560,420,-2,-25,-20,-2,-4,7,3,3,1,4,0,2,2,0,3,3,-1,1,0,0,0,-3,0,-5,5,4,0,0,1,1,1,1,5,-1
KR_6757920439,420,-1,-6,10,-6,0,0,0,1,3,4,1,1,2,-4,5,1,-4,4,0,0,-8,-12,-2,-4,6,2,0,0,-1,1,0,-1,1,-1
KR_6759638659,420,-4,-73,-48,3,0,1,1,3,2,5,-4,6,2,1,3,4,3,0,3,0,21,28,5,-6,1,-5,0,1,1,-1,-1,-1,2,-1
KR_6732120985,420,-7,-88,3,-25,-1,3,2,-8,9,1,-8,9,1,-6,6,0,-2,2,0,-2,-29,-23,-3,-4,7,0,-1,-5,-1,-1,-1,-1,2,-1
KR_6760058043,440,-5,-17,4,-8,0,1,1,-1,1,0,-2,3,1,-3,3,0,-2,2,0,0,-12,-7,0,-5,5,-6,0,0,-1,1,-1,-1,4,-1
KR_6747765330,420,-4,-64,-2,-10,0,2,2,-4,6,2,-8,11,3,0,1,1,2,1,3,1,-2,-6,0,-2,2,-1,0,-1,-1,-1,-1,1,5,-1
KR_6762614710,420,0,33,24,4,1,4,5,1,2,3,6,1,7,-2,4,2,-2,3,1,-1,2,32,8,-8,0,-4,0,0,1,1,0,-1,6,-1
KR_6765883526,420,1,15,-26,-1,-2,3,1,0,1,1,1,0,1,-1,4,3,1,0,1,0,-2,-6,-2,-4,6,0,0,0,0,-1,0,-1,0,-1
KR_6624541802,420,-1,-3,17,-5,1,1,2,-5,6,1,2,1,3,-1,2,1,-2,3,1,-1,-3,-3,2,-5,3,0,0,-2,-1,-1,-1,-1,3,-1
KR_6767215408,440,0,-56,-20,2,0,0,0,-2,2,0,2,3,5,2,0,2,0,0,0,0,4,4,0,-3,3,3,0,-1,0,-1,-1,1,0,-1
KR_6671325407,420,-3,-98,-4,-1,-3,4,1,2,1,3,-1,2,1,-2,4,2,3,2,5,0,-1,2,2,-5,3,-3,0,0,1,1,-1,-1,3,-1
KR_6767147081,420,-5,-76,-11,-11,-4,5,1,3,0,3,-3,4,1,-7,9,2,0,0,0,0,-1,-2,2,-5,3,1,0,-1,1,-1,-1,-1,1,-1
KR_6763731863,420,0,-81,12,1,4,0,4,5,1,6,-4,5,1,-4,6,2,0,0,0,-1,8,-2,2,-5,3,3,0,0,1,1,0,-1,5,-1
KR_6573225668,420,-4,-30,-5,-7,0,1,1,-5,6,1,2,1,3,-1,4,3,-3,3,0,0,-6,241,1,-4,3,-2,0,-1,1,-1,-1,1,5,-1
KR_6682741869,420,-1,-58,-20,-2,1,0,1,-3,4,1,0,2,2,-1,2,1,1,0,1,-1,4,-6,2,-3,1,-1,0,2,-1,-1,1,-1,2,-1
KR_6734918627,420,-3,-33,-36,-10,1,2,3,4,1,5,-7,8,1,-6,7,1,-2,2,0,-1,-7,6,2,-5,3,-3,0,-2,-1,1,-1,-1,2,-1
KR_6691763905,420,2,36,-15,6,1,0,1,1,1,2,3,0,3,1,2,3,0,0,0,0,4,6,2,-4,2,3,0,0,-1,0,0,1,4,-1
KR_6636266398,420,0,-63,21,0,-7,8,1,4,0,4,3,2,5,-7,7,0,7,0,7,-1,5,2,-3,-2,5,0,0,0,0,0,0,-1,0,-1
KR_6759858014,440,-3,6,-9,-5,-6,7,1,1,3,4,-2,3,1,-2,2,0,4,0,4,0,-12,9,6,-9,3,-5,0,-1,-1,-1,-1,1,1,-1
KR_6750724998,420,-2,-35,-12,-5,-1,2,1,0,1,1,-1,5,4,-7,7,0,4,0,4,-1,-5,0,2,-7,5,2,0,1,1,1,1,-1,1,-1
KR_6761607261,420,-2,-89,-24,-8,-4,6,2,-4,7,3,1,0,1,-1,2,1,0,0,0,0,-6,-4,1,-6,5,1,0,-1,-1,1,-1,-1,1,-1
KR_6765278233,420,-1,-93,-14,0,0,0,0,-3,3,0,4,1,5,1,0,1,-2,2,0,0,-7,23,0,-4,4,6,0,-1,1,0,-1,1,5,-1
KR_6670941907,420,-4,-16,-36,-9,-5,5,0,-4,5,1,0,4,4,-1,3,2,1,1,2,1,0,-3,1,-5,4,-10,0,-1,-1,-1,-1,1,2,-1
KR_6733314099,420,-2,-39,12,-3,-1,2,1,3,1,4,-6,6,0,1,4,5,0,4,4,1,2,-32,4,-6,2,-3,0,0,0,0,0,1,0,-1
KR_6751781272,420,3,5,-2,10,0,0,0,5,1,6,4,0,4,0,1,1,1,0,1,0,2,-5,-1,-1,2,4,0,1,-1,1,1,1,4,-1
KR_6749547587,420,2,-52,20,9,0,1,1,2,1,3,-1,2,1,7,0,7,1,1,2,1,11,-29,-1,-3,4,2,0,-1,1,-1,-1,1,2,-1
KR_6762783669,420,0,-17,4,4,5,0,5,-2,6,4,2,2,4,1,3,4,-2,2,0,2,6,1,3,-4,1,-1,0,-1,-1,1,-1,1,6,-1
KR_6674164685,420,1,71,-8,5,4,2,6,-2,5,3,6,3,9,-2,4,2,-1,1,0,2,2,213,0,-5,5,3,0,2,-1,1,1,1,5,-1
KR_6758860299,420,-1,11,19,-2,-2,2,0,-3,6,3,4,4,8,1,3,4,-2,2,0,0,-7,25,-4,-3,7,-1,0,1,1,-1,-1,-1,3,-1
KR_6766909298,420,-4,-139,-48,-8,1,1,2,-1,3,2,-3,4,1,-3,3,0,-2,2,0,0,-8,-27,2,-3,1,-1,0,-3,-1,-1,-1,-1,5,-1
KR_6724056410,420,-2,30,-52,-3,-3,4,1,-6,6,0,0,2,2,2,2,4,4,0,4,0,8,1,-2,-1,3,4,0,-1,-1,-1,-1,1,5,-1
KR_6763255173,420,3,59,-4,8,4,0,4,5,2,7,0,1,1,-3,4,1,2,0,2,0,8,-3,-1,-1,2,1,0,2,1,1,1,1,5,-1
KR_6600430716,420,0,60,-16,8,0,1,1,5,1,6,0,0,0,1,1,2,2,1,3,1,13,1,-1,-5,6,-3,0,-1,1,-1,-1,1,4,-1
KR_6717105496,420,-6,-103,-27,-13,0,4,4,-4,5,1,-4,5,1,-5,7,2,0,0,0,-1,-10,45,1,-3,2,2,0,-2,1,-1,-1,-1,2,-1
KR_6724637607,420,1,27,21,3,2,3,5,-2,6,4,0,3,3,2,4,6,1,0,1,0,7,-1,-4,0,4,3,0,1,1,-1,1,1,2,-1
KR_6680175410,420,-1,-16,8,-4,-4,5,1,3,0,3,1,4,5,-2,4,2,-2,4,2,0,2,-1,6,-10,4,-3,0,0,1,-1,0,1,1,-1
KR_6678164930,420,-5,-121,-40,-10,-1,1,0,-6,7,1,-1,3,2,0,2,2,-2,3,1,-2,1,7,-5,-2,7,0,0,-1,1,-1,-1,-1,2,-1
KR_6759716094,420,-6,-81,-14,-3,-7,7,0,6,0,6,2,0,2,-4,5,1,0,1,1,0,-4,-7,-6,-3,9,0,-1,-4,1,-1,-1,1,2,-1
KR_6760372260,420,3,-3,-16,3,5,1,6,-1,4,3,2,4,6,-4,5,1,1,1,2,0,2,2,1,-4,3,-3,0,-1,-1,-1,-1,1,2,-1
KR_6750532478,420,-6,-130,-16,-8,-3,4,1,1,1,2,-2,3,1,-2,7,5,-2,4,2,0,-4,11,4,-8,4,-3,0,-1,-1,1,-1,-1,4,-1
KR_6762364853,420,-2,-60,-22,-2,2,1,3,1,3,4,3,1,4,-4,4,0,-4,4,0,0,-1,-44,1,-5,4,18,0,1,-1,1,1,-1,5,-1
KR_6743408244,420,-1,-50,15,-7,-3,3,0,4,3,7,-1,2,1,-5,6,1,-2,3,1,0,-4,0,-1,-2,3,1,0,-1,-1,-1,-1,-1,4,-1
KR_6760503111,420,1,44,24,-4,1,2,3,1,0,1,1,3,4,-6,6,0,-1,1,0,0,-14,141,2,-4,2,6,0,1,1,-1,1,1,4,-1
KR_6747804895,420,-4,-1,-5,0,-1,4,3,1,3,4,-2,2,0,2,2,4,0,0,0,1,5,149,-2,-2,4,4,0,-1,-1,1,-1,1,2,-1
KR_6756328940,420,0,-25,-12,-1,0,2,2,-1,1,0,-1,3,2,0,3,3,1,1,2,0,1,4,-3,-5,8,2,0,1,1,1,1,1,2,-1
KR_6759562631,420,-1,-5,12,-6,1,0,1,-6,7,1,2,0,2,-3,3,0,0,1,1,0,-11,-2,-6,-2,8,1,0,-1,-1,-1,-1,-1,3,-1
KR_6768479936,420,-2,-70,-41,0,-2,3,1,-1,2,1,1,0,1,-1,3,2,3,0,3,0,5,6,-6,-1,7,-1,0,-1,-1,-1,-1,1,5,-1
KR_6715401412,420,-2,-28,20,-4,0,0,0,2,0,2,-4,5,1,-2,3,1,0,2,2,-1,-2,-120,6,-7,1,-3,0,0,1,1,-1,-1,6,-1
KR_6648125871,420,-4,-110,-16,-11,-3,5,2,-2,5,3,0,1,1,-3,5,2,-3,4,1,0,-9,-26,-1,-5,6,0,0,-2,-1,-1,-1,-1,3,-1
KR_6711327385,420,-1,24,16,-6,2,0,2,1,1,2,0,5,5,-6,7,1,-3,3,0,0,-11,-70,3,-7,4,4,0,1,1,1,1,-1,5,-1
KR_6750556705,440,-5,-75,-28,-9,-1,3,2,-1,1,0,-7,7,0,-1,4,3,1,0,1,-1,-1,-3,-4,-3,7,-3,0,-2,1,0,-1,-1,2,-1
KR_6734866230,420,-4,-56,22,-10,-5,6,1,-3,4,1,-1,2,1,0,1,1,-1,4,3,-1,-8,-10,-3,-6,9,2,0,-1,1,1,-1,-1,3,-1
KR_6465825660,420,-3,-27,-23,-8,-5,5,0,-2,4,2,-2,4,2,3,0,3,-2,3,1,0,1,-4,-3,-1,4,3,0,-1,-1,-1,-1,-1,4,-1
KR_6762400222,420,-7,-82,-26,-18,-2,3,1,-5,5,0,-3,4,1,-3,4,1,-5,5,0,0,-10,-12,1,-4,3,4,0,0,-1,0,-1,-1,5,-1
KR_6754338418,420,-3,-34,-7,-20,-1,2,1,-1,2,1,0,0,0,-12,16,4,-6,8,2,-1,-15,-2,0,-1,1,-1,0,-1,-1,-1,-1,-1,1,-1
KR_6680806312,420,-2,23,-15,-3,-2,2,0,2,2,4,-3,4,1,0,3,3,0,1,1,0,-8,1,5,-6,1,0,0,0,1,0,0,-1,3,-1
KR_6482324656,420,-2,-21,-32,1,-1,3,2,-1,3,2,1,1,2,2,1,3,0,0,0,0,1,-5,2,-6,4,-1,0,1,1,-1,1,1,4,-1
KR_6641593651,420,-2,7,-30,4,-1,2,1,1,1,2,-2,2,0,4,0,4,2,0,2,0,9,-3,3,-4,1,2,0,-1,1,-1,-1,1,5,-1
KR_6627753713,420,-1,-66,4,-5,0,1,1,-1,2,1,-3,4,1,-1,2,1,0,0,0,0,-2,-4,1,-3,2,0,0,0,1,1,-1,-1,3,-1
KR_6759252170,420,3,-10,32,0,-4,4,0,0,0,0,1,1,2,5,1,6,-2,3,1,-1,-3,-9,-1,-3,4,4,0,-1,1,-1,-1,-1,3,-1
KR_6629115549,420,0,41,-16,-3,-2,2,0,-1,2,1,-1,2,1,3,5,8,-2,2,0,0,7,10,3,-4,1,-2,0,0,-1,1,0,1,1,-1
KR_6642443599,420,-1,-3,16,-1,-1,4,3,0,4,4,1,0,1,-1,2,1,0,0,0,-1,-2,6,-4,-3,7,3,0,0,1,-1,0,-1,4,-1
KR_6760418615,420,1,-35,17,5,-2,3,1,7,0,7,0,3,3,1,1,2,-1,1,0,0,11,1,1,-5,4,0,0,0,1,-1,0,-1,4,-1
KR_6732599270,440,-3,-40,-8,-5,-1,1,0,1,1,2,-3,3,0,0,1,1,-2,3,1,1,-9,-13,-5,0,5,0,0,0,1,0,0,1,6,-1
KR_6641178532,420,-3,-89,24,-1,-3,4,1,4,0,4,-2,4,2,0,4,4,0,1,1,0,-1,-16,-3,-2,5,2,0,-2,1,-1,-1,-1,2,-1
KR_6765072825,420,-5,-107,-4,-9,-1,2,1,-3,4,1,-4,4,0,-2,2,0,1,0,1,0,-8,-130,-2,-1,3,-3,0,-1,-1,-1,-1,-1,1,-1
KR_6762537825,440,-4,-20,-32,-8,-4,5,1,2,2,4,-7,7,0,1,2,3,0,2,2,0,-5,204,-2,-1,3,-2,0,-1,-1,-1,-1,-1,4,-1
KR_6756886971,420,1,-38,-43,0,-2,2,0,-1,4,3,4,1,5,-1,2,1,0,0,0,0,5,-101,-2,-3,5,4,0,2,1,-1,1,1,3,-1
KR_6627933555,420,-1,-76,52,-5,0,1,1,-2,2,0,-2,5,3,0,0,0,-1,4,3,0,-2,-3,0,-3,3,0,0,-1,-1,1,-1,-1,4,-1
KR_6717612227,420,-3,-71,-39,-8,-3,4,1,0,4,4,0,2,2,-1,4,3,-4,5,1,0,-3,-21,-3,-4,7,2,0,-1,-1,-1,-1,-1,4,-1
KR_6723745500,420,-1,-19,-16,1,-1,1,0,2,4,6,0,1,1,-2,2,0,2,1,3,0,2,-32,0,-6,6,3,0,-2,1,-1,-1,1,4,-1
KR_6765719109,420,-5,-43,-48,-11,-2,4,2,-4,5,1,-4,6,2,-1,2,1,0,0,0,0,-13,5,-2,-2,4,-2,0,-2,-1,-1,-1,-1,2,-1
KR_6731605490,420,-2,-53,-17,-4,-4,4,0,-1,2,1,-4,6,2,4,0,4,1,0,1,0,0,-19,1,-4,3,1,0,-1,1,-1,-1,-1,2,-1
KR_6710785111,420,1,68,3,4,4,1,5,0,3,3,1,1,2,0,4,4,-1,2,1,0,-2,-22,-5,-4,9,2,0,0,1,-1,1,1,6,-1
KR_6660302495,440,-1,-23,12,-5,2,0,2,-4,7,3,-2,3,1,-1,6,5,0,1,1,0,-4,44,0,-2,2,-27,0,0,0,0,0,1,0,-1
KR_6607419841,420,-7,-113,-6,-11,-1,2,1,-9,11,2,3,2,5,-4,5,1,0,0,0,0,-11,240,3,-6,3,-4,0,0,-1,-1,-1,-1,3,-1
KR_6199590044,420,-4,-51,-12,-2,-4,5,1,3,1,4,-1,6,5,-1,3,2,1,0,1,0,6,188,4,-6,2,3,0,0,0,-1,-1,-1,0,-1
KR_6725854489,420,-4,31,-1,-7,-2,2,0,-2,4,2,1,0,1,3,2,5,-7,7,0,0,-16,-126,6,-7,1,-7,0,-1,-1,1,-1,1,3,-1
KR_6619546701,420,0,50,5,0,0,0,0,0,3,3,0,2,2,0,0,0,0,0,0,0,0,-129,0,-3,3,2,0,-1,0,-1,-1,-1,0,-1
KR_6755606571,420,-3,-23,52,-13,-2,3,1,0,3,3,-2,5,3,-4,4,0,-5,5,0,-1,-8,2,2,-4,2,-3,0,-1,0,-1,-1,-1,0,-1
KR_6766756350,420,0,52,-5,-1,-1,2,1,1,0,1,2,2,4,-3,3,0,0,1,1,0,4,14,2,-3,1,-6,0,-1,1,-1,-1,-1,1,-1
KR_6764108005,420,2,2,-12,2,3,0,3,3,0,3,-5,5,0,-1,4,3,2,0,2,0,0,-1,1,-4,3,0,0,1,-1,1,1,1,6,-1
KR_6674002389,420,0,-56,-26,-2,1,1,2,-6,6,0,0,1,1,2,0,2,1,0,1,0,-5,-2,-3,-2,5,2,0,-1,1,-1,-1,-1,3,-1
KR_6746341372,420,-3,-48,-4,-10,-3,3,0,1,2,3,-3,5,2,-6,8,2,1,1,2,0,-9,-3,-2,-1,3,3,0,-1,1,-1,-1,-1,3,-1
KR_6768180253,420,-3,-34,12,-10,-5,5,0,4,0,4,-5,5,0,-2,2,0,-2,2,0,0,-7,15,-2,-4,6,5,0,0,-1,-1,0,-1,5,-1
KR_6743611153,420,0,25,-12,-2,0,0,0,1,0,1,-1,3,2,-1,2,1,-1,1,0,0,-4,24,-2,-2,4,-6,0,0,1,-1,-1,-1,5,-1
KR_6757476570,420,-1,-19,-8,-6,0,2,2,-1,4,3,-6,7,1,0,3,3,1,0,1,0,-7,10,2,-4,2,-4,0,1,0,-1,-1,-1,0,-1
KR_6758991225,420,-2,-13,4,-3,0,4,4,0,0,0,-1,5,4,1,1,2,-3,4,1,0,-6,2,3,-4,1,-4,0,0,-1,0,0,-1,3,-1
KR_6767384440,420,-5,-42,-68,-17,-8,9,1,-6,6,0,-4,4,0,2,2,4,-1,4,3,-3,-19,261,-2,-2,4,2,0,-2,-1,-1,-1,-1,4,-1
KR_6760681122,440,-2,15,18,-4,2,1,3,2,2,4,-2,3,1,-7,8,1,1,0,1,0,-11,-20,-3,-2,5,-3,0,1,-1,1,1,-1,3,-1
KR_6636682535,420,0,10,4,-1,1,3,4,-2,4,2,0,3,3,0,4,4,0,1,1,-1,-6,88,-4,-6,10,-1,0,0,-1,1,1,-1,5,-1
KR_6764901566,420,3,26,-23,7,2,2,4,1,1,2,2,2,4,2,4,6,0,1,1,0,6,-14,-4,-2,6,0,0,0,0,1,-1,-1,0,-1
KR_6198131875,420,-3,-40,-5,3,3,1,4,2,5,7,-3,4,1,-1,2,1,2,4,6,1,4,0,-3,-2,5,-4,0,0,-1,1,-1,1,4,-1
KR_6695458291,420,-2,-47,36,-5,-2,2,0,-5,8,3,3,0,3,1,1,2,-2,2,0,0,-2,0,2,-3,1,0,0,0,-1,1,0,-1,1,-1
KR_6685418528,420,-3,-7,-11,-5,2,1,3,-4,6,2,3,0,3,-3,3,0,-3,4,1,0,-4,-6,4,-7,3,1,0,0,-1,-1,-1,-1,4,-1
KR_6685618436,420,-6,-44,-11,-5,-2,5,3,-1,4,3,-5,5,0,4,2,6,-1,1,0,0,2,294,-6,-4,10,4,0,0,-1,1,0,-1,2,-1
KR_6717609823,420,-3,-60,3,-2,-3,4,1,3,4,7,-1,3,2,-3,4,1,2,0,2,-1,0,1,-1,-3,4,-2,0,0,-1,1,-1,-1,1,-1
KR_6682675397,420,0,13,8,-1,3,0,3,-4,4,0,3,4,7,-3,3,0,0,0,0,0,-10,18,-5,-3,8,0,0,0,-1,0,0,-1,1,-1
KR_6197877288,440,-2,-3,3,-6,2,1,3,-1,3,2,0,2,2,-8,9,1,1,1,2,-1,-8,-229,4,-8,4,2,0,-2,-1,-1,-1,-1,3,-1
KR_6766124368,420,1,-26,-17,2,0,3,3,-1,5,4,1,5,6,3,2,5,-1,1,0,1,6,-29,1,-5,4,6,0,-1,1,0,-1,1,1,-1
KR_6762103381,420,1,2,28,-3,2,0,2,2,1,3,-1,1,0,-5,6,1,-1,1,0,0,0,11,0,-3,3,-2,0,-1,-1,1,-1,-1,1,-1
KR_6693873889,420,-4,-23,-36,-15,-3,4,1,-3,4,1,-1,2,1,-5,6,1,-3,3,0,0,-17,-2,-2,-5,7,-1,0,-2,-1,-1,-1,-1,6,-1
KR_6713229295,420,-3,20,-16,-5,-1,2,1,-3,3,0,-3,4,1,4,2,6,-2,4,2,0,-2,5,2,-4,2,0,0,-1,1,-1,-1,1,3,-1
KR_6754342170,420,1,37,8,5,2,3,5,-3,6,3,0,2,2,3,2,5,3,2,5,0,5,13,6,-6,0,-4,0,1,1,1,1,1,4,-1
KR_6765817032,420,-3,17,39,-4,2,2,4,3,1,4,-2,3,1,-3,8,5,-4,4,0,-2,-7,-30,2,-4,2,1,0,-1,0,1,1,-1,0,-1
KR_6638479484,420,2,8,0,0,3,0,3,-9,9,0,1,4,5,2,0,2,3,0,3,0,4,-14,-3,-4,7,-2,0,-1,-1,-1,-1,-1,4,-1
KR_6764829976,420,-1,-59,31,-13,-4,5,1,0,1,1,-4,4,0,-3,6,3,-2,2,0,-2,-13,3,-2,-4,6,-4,0,0,0,0,0,-1,0,-1
KR_6652481917,420,1,-40,12,-2,-3,3,0,0,2,2,-4,6,2,2,2,4,3,1,4,1,0,-3,-1,-5,6,1,0,-1,-1,1,-1,1,3,-1
KR_6765528237,420,2,15,10,-2,5,0,5,1,3,4,-3,3,0,-4,5,1,-1,1,0,0,-8,112,0,-2,2,5,0,0,1,-1,0,-1,5,-1
KR_6593910412,420,0,-114,0,4,4,1,5,1,1,2,-2,3,1,2,3,5,-1,1,0,0,-1,11,6,-10,4,-5,0,-1,1,1,-1,1,6,-1
KR_6692031444,420,2,24,12,4,3,1,4,2,1,3,-2,3,1,-1,3,2,2,2,4,0,0,30,0,-8,8,-20,0,1,-1,0,1,1,4,-1
KR_6723303805,420,-1,-10,20,2,0,0,0,3,2,5,1,0,1,-3,7,4,1,2,3,1,1,-1,0,-2,2,4,0,0,-1,1,-1,1,6,-1
KR_6746727805,420,1,47,35,3,3,1,4,0,2,2,1,2,3,0,0,0,-1,1,0,-1,2,239,-1,-2,3,32,0,0,1,1,0,-1,6,-1
KR_6751712380,420,-1,-16,1,4,-1,2,1,3,2,5,-1,4,3,2,1,3,1,0,1,1,5,8,0,-4,4,3,0,-1,1,-1,-1,1,1,-1
KR_6764479914,420,-1,-57,-27,-3,-1,2,1,-3,4,1,1,3,4,0,0,0,0,0,0,-1,1,-20,1,-6,5,-1,0,-1,-1,-1,-1,-1,3,-1
KR_6480249611,420,0,-6,-32,-7,-4,5,1,-4,5,1,1,2,3,-1,2,1,1,0,1,0,-4,5,-1,-1,2,4,0,0,1,-1,0,1,3,-1
KR_6762660191,420,-4,-8,-43,-5,0,3,3,-8,8,0,2,1,3,-1,3,2,2,0,2,0,1,22,-3,-5,8,2,0,-1,0,-1,-1,-1,0,-1
KR_6756091554,420,-2,-64,-24,-2,1,0,1,1,1,2,-1,4,3,-3,3,0,0,1,1,0,-3,7,3,-5,2,-5,0,0,-1,1,1,-1,3,-1
KR_6646967135,420,7,7,8,13,1,0,1,1,1,2,6,0,6,4,1,5,1,0,1,0,9,8,-2,-3,5,2,0,1,1,-1,1,1,2,-1
KR_6708573415,420,-2,32,-20,-4,-1,2,1,-4,5,1,-6,9,3,8,2,10,-1,1,0,0,0,5,0,-3,3,2,0,-1,-1,-1,-1,1,3,-1
KR_6756328605,420,0,-6,4,-2,1,1,2,-1,3,2,-4,6,2,0,2,2,2,0,2,0,-2,-52,-5,0,5,23,0,-1,1,1,-1,-1,4,-1
KR_6765922117,440,-6,-108,-3,-13,-3,3,0,-8,9,1,2,1,3,2,1,3,-6,6,0,0,-15,-3,0,-4,4,0,0,-1,-1,-1,-1,-1,3,-1
KR_6588888647,420,-1,-59,-20,-5,1,2,3,2,1,3,-1,2,1,-4,4,0,-3,4,1,0,-5,-5,-5,-1,6,-4,0,-1,-1,1,-1,-1,2,-1
KR_6736397149,420,-4,-113,-24,-8,-4,4,0,-3,5,2,-3,7,4,2,1,3,0,0,0,0,-11,1,0,-3,3,-1,0,-2,-1,-1,-1,-1,5,-1
KR_6614369156,420,-1,28,-28,-1,1,1,2,1,5,6,-2,4,2,0,1,1,-1,2,1,0,2,1,-1,-6,7,0,0,-1,-1,-1,-1,1,4,-1
KR_6508638874,420,-7,-80,-56,-16,-7,7,0,0,1,1,-2,2,0,-5,6,1,-2,3,1,0,-8,6,-4,-1,5,4,0,-2,-1,-1,-1,-1,6,-1
KR_6733374827,420,-3,5,8,-16,-5,6,1,-8,9,1,-2,4,2,1,2,3,-2,3,1,0,-13,-23,-3,-2,5,-4,0,-1,1,-1,-1,-1,6,-1
KR_6762400855,420,-3,-54,12,-11,-3,4,1,-6,6,0,-2,4,2,-1,3,2,1,2,3,0,-11,107,-2,-1,3,1,0,0,-1,0,0,-1,3,-1
KR_6719498663,420,5,68,32,0,1,0,1,0,2,2,2,1,3,-1,2,1,-2,4,2,0,-1,3,-1,-6,7,7,0,0,1,1,0,-1,6,-1
KR_6768355223,420,-2,-54,6,-1,3,1,4,1,3,4,-4,5,1,-2,3,1,1,1,2,0,2,-387,-1,0,1,1,0,-2,-1,1,-1,1,5,-1
KR_6765374075,420,3,97,29,4,3,2,5,-2,4,2,1,0,1,3,4,7,-1,1,0,0,-4,-105,-1,-4,5,1,0,1,0,0,1,-1,0,-1
KR_6591021375,420,1,31,-12,2,0,3,3,1,2,3,2,1,3,0,3,3,-1,1,0,-1,-2,-8,7,-10,3,-4,0,0,1,1,1,-1,1,-1
KR_6767989059,420,0,20,-12,-1,4,1,5,2,2,4,-6,6,0,1,2,3,-2,2,0,0,0,6,1,-6,5,-4,0,0,-1,-1,1,-1,6,-1
KR_6627678320,420,-1,47,-28,-7,-4,6,2,1,2,3,1,2,3,-1,3,2,-4,5,1,0,-4,-11,-4,-4,8,-1,0,-1,-1,-1,-1,-1,4,-1
KR_6764829612,420,-4,-145,-29,-13,-5,6,1,-3,4,1,-3,7,4,0,2,2,-2,2,0,0,-5,44,4,-8,4,-11,0,-3,-1,1,-1,-1,3,-1
KR_6602519327,420,1,1,-36,-3,2,0,2,0,4,4,-7,8,1,-1,1,0,3,0,3,0,-4,-5,0,-3,3,0,0,0,-1,-1,-1,1,1,-1
KR_6760395057,420,-2,23,-12,2,0,2,2,1,2,3,3,0,3,-1,2,1,-1,1,0,0,3,-17,1,-5,4,-4,0,0,1,1,0,1,4,-1
KR_6752574512,420,-3,-12,-24,-3,-1,2,1,1,2,3,-2,3,1,-1,1,0,0,0,0,0,-5,4,1,-3,2,2,0,0,1,-1,-1,1,1,-1
KR_6756657858,420,0,7,35,-1,-4,5,1,2,1,3,-1,1,0,2,1,3,0,1,1,-1,-4,-5,1,-3,2,-2,0,0,-1,1,0,-1,3,-1
KR_6629486791,420,-5,-62,-4,-11,1,2,3,-10,12,2,0,1,1,-2,4,2,0,1,1,0,-12,271,-3,-3,6,1,0,-1,1,-1,-1,-1,4,-1
KR_6712963321,420,0,-36,5,1,2,0,2,1,0,1,-4,5,1,2,2,4,0,2,2,1,-1,-45,-1,-2,3,18,0,0,-1,1,0,1,4,-1
KR_6746621906,420,-1,38,-4,-2,-4,4,0,0,2,2,1,0,1,0,2,2,1,0,1,0,3,34,0,-5,5,-14,0,0,1,-1,0,1,5,-1
KR_6754500857,420,-6,-17,-49,-8,1,3,4,-8,9,1,-6,7,1,2,0,2,3,0,3,0,-4,3,0,-4,4,4,0,0,-1,-1,-1,-1,6,-1
KR_6762379170,420,-2,-52,-27,-9,-6,6,0,0,2,2,-2,6,4,-2,7,5,1,3,4,-1,2,2,2,-6,4,-1,0,-1,-1,-1,-1,-1,3,-1
KR_6646709745,440,-14,-164,-28,-20,-4,4,0,-4,5,1,-6,9,3,-7,7,0,1,0,1,0,-22,-2,1,-2,1,-2,0,-2,-1,0,-1,-1,6,-1
KR_6597448314,420,-3,-17,-32,-2,0,1,1,-2,5,3,-2,2,0,4,0,4,-2,2,0,0,1,0,-2,-4,6,1,0,0,1,1,0,-1,4,-1
KR_6747614125,420,3,64,0,7,3,0,3,2,3,5,-3,5,2,5,0,5,0,0,0,0,5,2,1,-4,3,-3,0,0,0,0,0,-1,0,-1
KR_6762757107,420,-3,-1,-31,1,-1,2,1,3,1,4,-2,3,1,0,1,1,1,0,1,1,4,-168,-2,-1,3,23,0,-2,1,-1,-1,1,2,-1
KR_6754561371,440,-3,-93,12,-6,-1,2,1,-9,10,1,-3,3,0,7,2,9,0,1,1,0,-10,7,2,-5,3,-2,0,-1,1,1,-1,1,4,-1
KR_6758472071,420,-8,-75,-56,-13,1,1,2,-4,5,1,-8,8,0,0,2,2,-2,3,1,0,-5,-8,-2,-5,7,1,0,-1,-1,1,-1,1,4,-1
KR_6696319064,440,1,-14,15,7,1,2,3,0,2,2,3,1,4,1,2,3,2,0,2,0,7,-53,1,-6,5,27,0,0,-1,-1,0,-1,5,-1
KR_6719184200,420,-6,-58,-30,-15,-4,6,2,-6,8,2,-3,3,0,-4,4,0,2,1,3,0,-9,-5,-7,-2,9,3,0,-1,-1,1,-1,-1,4,-1
KR_6635067463,420,-6,-8,-37,-6,-1,3,2,-5,8,3,1,1,2,-1,2,1,0,2,2,-1,-13,-5,-5,-2,7,5,0,-2,1,-1,-1,-1,2,-1
KR_6514949786,420,4,29,-16,5,5,0,5,-4,8,4,2,1,3,0,0,0,2,1,3,0,1,-13,-3,-3,6,5,0,2,1,1,1,-1,6,-1
KR_6741386814,420,-3,5,-6,-9,-4,5,1,0,5,5,-3,4,1,-4,5,1,2,0,2,0,-11,5,2,-5,3,-2,0,-2,-1,-1,-1,1,2,-1
KR_6732903409,420,-3,-35,-18,-4,3,0,3,-3,6,3,0,1,1,-5,5,0,1,1,2,0,-4,-11,-1,-3,4,1,0,-1,-1,1,-1,1,5,-1
KR_6637959383,420,1,14,12,-1,3,2,5,-4,6,2,3,0,3,-1,2,1,-2,2,0,0,-9,0,-4,-3,7,0,0,1,-1,1,1,1,6,-1
KR_6759344519,420,-4,-66,-6,-7,1,2,3,-2,4,2,1,3,4,-4,5,1,-3,3,0,0,-8,59,-4,-2,6,-1,0,0,-1,-1,-1,1,3,-1
KR_6747382801,420,0,17,17,1,-1,1,0,-4,4,0,-2,3,1,5,2,7,3,0,3,0,2,1,-1,-1,2,0,0,0,0,-1,-1,-1,0,-1
KR_6767421430,420,-3,-43,-23,-18,1,1,2,-5,6,1,-9,9,0,-5,6,1,0,2,2,0,-15,4,1,-5,4,-1,0,-1,-1,1,1,-1,6,-1
KR_6736728728,420,1,56,4,1,-2,4,2,-1,2,1,0,2,2,3,1,4,1,0,1,0,1,10,-1,-2,3,2,0,2,1,-1,1,1,3,-1
KR_6632374653,420,-5,-91,-12,-8,1,2,3,-4,7,3,1,0,1,-5,6,1,-1,1,0,0,-10,-222,3,-7,4,1,0,0,-1,1,-1,-1,5,-1
KR_6750817930,440,-1,-72,-20,4,-2,4,2,2,1,3,0,2,2,5,2,7,-1,2,1,0,10,4,2,-6,4,-3,0,-1,-1,-1,-1,1,4,-1
KR_6759577665,420,-1,-9,7,-5,5,1,6,-3,4,1,-6,6,0,-1,3,2,0,1,1,0,-13,-4,-1,-2,3,-3,0,-1,-1,1,-1,1,5,-1
KR_6765623206,440,-3,16,-11,-5,-3,3,0,-3,3,0,2,0,2,1,1,2,-2,2,0,0,-1,10,1,-4,3,-2,0,0,-1,1,0,-1,4,-1
KR_6760507500,420,-3,-23,4,-6,0,4,4,2,0,2,1,2,3,-7,7,0,-2,2,0,1,-10,-18,0,-5,5,1,0,-2,1,1,-1,1,3,-1
KR_6765908329,420,-1,-29,-32,-7,-3,3,0,-3,6,3,-2,2,0,2,3,5,-1,1,0,-2,-13,38,1,-6,5,-44,0,0,-1,-1,0,-1,2,-1
KR_6595109571,420,2,98,8,-7,1,1,2,2,3,5,-4,5,1,-6,7,1,0,1,1,0,-7,93,-2,-8,10,-2,0,-1,-1,-1,-1,-1,5,-1
KR_6747216248,420,-4,-47,-12,-7,0,2,2,-4,7,3,3,0,3,-2,5,3,-4,8,4,0,-8,-4,-3,-1,4,-6,0,-1,1,-1,-1,1,6,-1
KR_6727147911,420,-1,-110,-6,-6,0,1,1,-3,5,2,-5,7,2,1,1,2,1,0,1,0,-6,13,-2,-2,4,-3,0,0,-1,1,0,-1,3,-1
KR_6762488666,440,-3,-38,-22,-9,-3,7,4,0,3,3,1,5,6,-6,8,2,-1,2,1,-1,-3,-16,-3,-2,5,2,0,-1,-1,-1,-1,-1,3,-1
KR_6734765042,420,0,-15,-4,-8,3,2,5,0,0,0,1,2,3,-11,11,0,-1,3,2,-1,-7,1,-1,-4,5,-2,0,-1,-1,-1,-1,-1,5,-1
KR_6483780415,420,2,16,-17,1,2,0,2,-1,3,2,-2,4,2,0,1,1,2,2,4,0,-6,-2,2,-8,6,-4,0,0,-1,-1,1,1,6,-1
KR_6646082793,420,-1,3,10,0,0,1,1,-3,5,2,1,1,2,3,2,5,-1,3,2,0,5,-10,-2,-3,5,-1,0,0,1,-1,0,1,2,-1
KR_6764461857,420,0,-6,14,-3,0,1,1,1,0,1,-2,4,2,-2,4,2,0,0,0,0,-5,22,-5,-1,6,-1,0,0,-1,-1,-1,-1,5,-1
KR_6757713564,420,2,40,-16,-1,2,1,3,0,2,2,0,2,2,-4,6,2,1,2,3,0,1,-4,-2,-2,4,-2,0,0,-1,1,0,-1,4,-1
KR_6629353151,420,-4,-44,-24,-12,0,2,2,-7,7,0,-2,3,1,-4,5,1,1,0,1,0,-14,394,-4,-1,5,-2,0,-1,-1,0,-1,-1,5,-1
KR_6760267589,420,0,44,-4,-2,-1,2,1,2,0,2,-3,3,0,1,1,2,-1,1,0,0,-7,3,-4,-3,7,0,0,0,-1,0,0,-1,4,-1
KR_6495791013,420,0,58,2,6,5,0,5,2,2,4,-4,5,1,2,4,6,1,1,2,-2,-2,-8,-3,-5,8,4,0,0,-1,-1,0,-1,2,-1
KR_6739345373,440,-5,-11,-24,-4,-1,2,1,0,3,3,-8,10,2,0,4,4,5,1,6,0,2,-105,3,-3,0,-2,0,-1,-1,1,-1,1,4,-1
KR_6766121744,420,-2,-38,12,-3,4,1,5,3,1,4,-3,5,2,-7,8,1,0,2,2,0,-11,-9,-8,-4,12,-1,0,-1,-1,1,-1,-1,1,-1
KR_6663453505,420,1,-29,15,-5,3,2,5,2,4,6,-5,6,1,-4,4,0,-1,3,2,0,-8,5,-1,-3,4,2,0,1,-1,0,-1,-1,4,-1
KR_6765812952,440,-1,-7,4,1,3,1,4,3,4,7,-6,8,2,3,1,4,-2,2,0,0,1,46,0,-2,2,-1,0,1,0,1,1,1,0,-1
KR_6702343301,420,-2,-76,7,0,2,2,4,0,2,2,6,3,9,-5,7,2,-3,3,0,0,1,-34,-1,-4,5,21,0,-2,-1,1,-1,-1,1,-1
KR_6730923879,420,-5,-39,-15,-6,-1,4,3,1,2,3,-3,5,2,-4,4,0,1,1,2,0,-4,-6,-3,-2,5,1,0,-2,-1,1,-1,1,1,-1
KR_6759968035,420,-4,-22,-24,-10,-4,5,1,-4,4,0,-1,1,0,1,2,3,-2,2,0,0,-11,-5,0,-4,4,1,0,-1,-1,-1,-1,-1,6,-1
KR_6760728220,440,-3,-73,-12,-7,-1,1,0,-3,6,3,-1,2,1,0,3,3,-2,2,0,0,-5,-3,0,-2,2,-1,0,0,-1,0,0,1,2,-1
KR_6727385107,420,3,13,4,2,1,2,3,2,3,5,3,1,4,0,2,2,-4,5,1,1,-1,-6,-2,-3,5,-1,0,2,-1,1,1,1,3,-1
KR_6637879761,420,-2,-10,-4,-8,-2,3,1,1,4,5,-2,6,4,-5,6,1,0,2,2,0,-8,8,4,-6,2,-1,0,0,1,-1,0,1,1,-1
KR_6725002947,420,-1,-8,-13,-7,0,3,3,-4,6,2,-3,4,1,2,2,4,-2,2,0,-1,-7,6,-4,-3,7,0,0,-1,0,-1,-1,-1,0,-1
KR_6761948489,420,-4,-11,-13,-9,0,1,1,-2,3,1,-3,5,2,-3,3,0,-1,1,0,0,-8,162,-5,-1,6,-1,0,-1,-1,-1,-1,-1,3,-1
KR_6743622766,420,-2,-33,2,-1,-5,5,0,-1,3,2,3,1,4,1,2,3,1,1,2,0,0,109,0,-6,6,2,0,0,1,-1,-1,-1,6,-1
KR_6682575453,440,-3,-110,-5,-9,-6,6,0,-1,3,2,-3,5,2,0,4,4,1,6,7,-1,1,-4,-9,0,9,2,0,-2,-1,-1,-1,-1,1,-1
KR_6723675723,420,-1,-3,8,6,0,1,1,2,1,3,2,1,3,0,2,2,2,0,2,0,6,-6,-3,-2,5,0,0,1,-1,1,1,1,4,-1
KR_6661502664,420,0,-18,-12,-6,-1,1,0,-3,5,2,1,1,2,-3,3,0,0,3,3,0,-5,401,-2,-4,6,-16,0,0,-1,-1,0,1,6,-1
KR_6628644375,420,-1,-32,21,-1,-1,3,2,3,1,4,1,2,3,-3,5,2,-1,1,0,0,-6,-9,1,-5,4,-3,0,-2,1,-1,-1,-1,4,-1
KR_6706226770,440,-1,9,-13,-8,0,4,4,-5,5,0,1,2,3,-5,6,1,1,1,2,0,-5,4,1,-4,3,-1,0,0,1,-1,-1,-1,2,-1
KR_6446367932,420,-4,-59,-1,-9,-2,4,2,3,1,4,-7,7,0,-4,5,1,1,0,1,-1,-12,36,-3,-1,4,-13,0,-1,1,1,-1,-1,3,-1
KR_6740138490,440,2,19,20,1,4,0,4,-1,2,1,1,2,3,-1,2,1,-2,2,0,0,3,5,-2,-2,4,3,0,1,-1,1,-1,-1,4,-1
KR_6717507985,420,-4,-38,-28,-6,0,4,4,4,0,4,-5,5,0,-4,5,1,-1,1,0,-1,-5,154,4,-5,1,1,0,-2,0,1,-1,-1,0,-1
KR_6736690813,420,-1,-2,-12,-4,0,2,2,1,1,2,-1,3,2,-3,4,1,-1,1,0,0,-2,-48,-3,-7,10,26,0,-1,-1,-1,-1,-1,2,-1
KR_6741519583,420,0,-18,24,-4,2,1,3,0,2,2,1,0,1,-1,3,2,-6,6,0,-1,-6,-4,4,-4,0,1,0,0,0,1,-1,-1,0,-1
KR_6754121717,440,-9,-97,24,-22,-10,11,1,-2,4,2,1,4,5,-11,15,4,0,1,1,1,-25,21,-5,-6,11,-2,0,-2,-1,0,-1,-1,1,-1
KR_6646527835,420,-2,25,-5,-4,0,2,2,-4,5,1,1,2,3,-3,6,3,2,1,3,0,-2,0,0,-6,6,0,0,0,-1,1,0,1,6,-1
KR_6706562553,420,-3,-10,-16,0,-4,5,1,1,0,1,-3,5,2,6,1,7,0,0,0,-1,3,56,0,-3,3,2,0,0,1,1,0,-1,1,-1
KR_6649064268,420,-8,-132,-34,-17,-11,11,0,-4,7,3,-1,1,0,0,2,2,-1,1,0,1,-7,8,1,-2,1,0,-1,-5,-1,-1,-1,1,6,-1
KR_6752228561,420,-2,-34,7,6,-2,6,4,0,2,2,6,1,7,1,2,3,1,1,2,1,11,40,-6,-2,8,-11,0,-1,-1,-1,-1,-1,5,-1
KR_6762504459,420,0,-51,14,4,-3,3,0,-1,3,2,2,1,3,5,1,6,1,1,2,0,13,-34,-1,-3,4,16,0,-1,1,-1,-1,1,4,-1
KR_6722353466,420,-3,-26,-16,-8,-1,1,0,0,1,1,-4,5,1,-4,5,1,1,1,2,-1,-12,-6,-2,-2,4,2,0,-1,-1,-1,-1,-1,5,-1
KR_6730489261,440,-3,-62,1,-9,0,2,2,-3,4,1,-8,8,0,2,3,5,0,0,0,0,-9,-7,0,-6,6,2,0,-1,-1,-1,-1,-1,6,-1
KR_6760480341,420,-4,-88,3,-9,-7,8,1,-2,3,1,1,1,2,-3,4,1,2,0,2,1,-6,-3,-1,-4,5,0,0,-2,1,-1,-1,1,4,-1
KR_6734132410,440,1,30,-5,1,-1,4,3,2,0,2,-1,2,1,5,0,5,-4,6,2,1,12,0,1,-4,3,0,0,0,1,-1,1,1,1,-1
KR_6727808748,420,-5,-140,-36,-1,-3,3,0,-1,4,3,-1,4,3,4,1,5,0,3,3,0,7,3,2,-6,4,-2,0,0,-1,1,-1,-1,3,-1
KR_6760183849,420,0,18,24,-3,2,0,2,-3,5,2,-4,4,0,0,1,1,2,0,2,0,-12,-85,2,-5,3,-2,0,0,-1,1,0,1,2,-1
KR_6734149945,420,-8,-79,-35,-17,-1,3,2,-9,10,1,-5,7,2,-1,6,5,-1,1,0,0,-11,7,-6,-4,10,-8,0,-1,0,1,-1,1,0,-1
KR_6757852713,440,-1,-2,24,-7,-2,5,3,-4,8,4,-2,3,1,2,4,6,-1,1,0,-1,-13,-1,0,-5,5,3,0,1,-1,-1,1,-1,3,-1
KR_6628564419,420,0,4,-3,0,2,1,3,5,2,7,1,1,2,-4,4,0,-4,4,0,0,1,7,-1,-4,5,1,0,0,-1,0,1,-1,4,-1
KR_6750003195,420,1,33,0,3,5,0,5,4,1,5,-3,6,3,-2,2,0,-1,1,0,0,2,3,0,-5,5,-1,0,-1,-1,-1,-1,-1,4,-1
KR_6703532684,420,-5,-39,4,-10,0,1,1,-2,3,1,-2,3,1,-6,7,1,0,1,1,-1,-13,-8,-1,-4,5,-1,0,-1,1,-1,-1,-1,5,-1
KR_6766880192,420,3,29,-14,5,-1,2,1,-2,2,0,3,1,4,2,0,2,3,0,3,0,8,40,0,-5,5,-15,0,1,1,-1,-1,-1,6,-1
KR_6749991552,420,-3,-39,-28,-5,-2,4,2,-1,1,0,0,4,4,-2,4,2,0,0,0,0,0,208,0,-3,3,-1,0,0,-1,1,0,1,3,-1
KR_6763203022,420,-2,-30,10,-8,2,0,2,-5,5,0,0,4,4,-5,5,0,0,0,0,0,-10,-3,0,-6,6,-1,0,-1,1,1,-1,-1,4,-1
KR_6766860877,420,-2,42,19,-11,1,0,1,-2,3,1,-7,7,0,-3,5,2,0,0,0,-1,-15,-28,-1,-4,5,5,0,0,1,-1,-1,-1,1,-1
KR_6755840975,420,-5,-68,20,-11,-1,3,2,0,1,1,-3,7,4,-4,5,1,-3,3,0,0,-16,-2,0,-4,4,-4,0,0,-1,1,0,1,4,-1
KR_6758987453,420,-5,-38,-20,-6,-2,2,0,1,1,2,-2,6,4,-6,9,3,3,0,3,0,-7,8,-4,-4,8,0,0,-2,-1,-1,-1,1,2,-1
KR_6725124758,420,-2,-45,-18,-5,-2,3,1,1,1,2,2,1,3,-5,5,0,-1,1,0,0,-5,-6,1,-3,2,-1,0,-1,0,1,-1,1,0,-1
KR_6610090530,420,-5,-60,-44,-5,-2,2,0,3,3,6,0,4,4,-5,7,2,-1,1,0,0,3,-94,-1,-4,5,-1,0,-1,-1,0,-1,-1,5,-1
KR_6547729496,420,0,-88,20,-1,0,0,0,3,1,4,1,0,1,-5,5,0,0,1,1,-1,-2,-42,3,-7,4,22,0,0,-1,1,-1,-1,3,-1
KR_6704687555,420,-1,14,-23,2,-4,4,0,0,2,2,3,0,3,3,0,3,0,0,0,1,4,8,1,-6,5,2,0,0,1,-1,-1,1,4,-1
KR_6767440989,420,-3,-99,-15,0,-1,3,2,-1,2,1,4,1,5,-4,6,2,2,0,2,0,-1,8,1,-4,3,-2,0,0,0,1,0,1,0,-1
KR_6766495007,420,-7,-69,-28,-20,-6,6,0,0,4,4,-3,3,0,-6,9,3,-5,5,0,0,-18,11,6,-8,2,0,0,-2,-1,1,-1,-1,6,-1
KR_6767526473,420,-1,-48,-10,-7,-1,3,2,0,1,1,-9,12,3,2,2,4,1,0,1,-2,-9,11,8,-11,3,-20,0,0,-1,-1,1,-1,3,-1
KR_6757604814,420,-1,51,-9,-5,-5,5,0,-1,5,4,-1,2,1,0,2,2,2,0,2,0,2,4,3,-5,2,2,0,-1,1,-1,-1,-1,6,-1
KR_6646023588,420,-6,-106,0,-13,-1,1,0,-4,5,1,-5,7,2,-2,2,0,-1,1,0,0,-12,8,-1,-3,4,-1,0,-2,-1,1,-1,-1,1,-1
KR_6742070913,420,0,10,12,1,2,1,3,0,1,1,0,2,2,-1,4,3,0,3,3,0,-1,12,-1,-5,6,1,0,0,1,-1,0,1,2,-1
KR_6754791090,420,-1,-81,9,-7,-2,4,2,3,3,6,-3,3,0,-3,4,1,-2,2,0,0,0,-10,-4,0,4,-1,0,-1,-1,1,-1,1,1,-1
KR_6764799253,420,-2,24,-11,1,-3,3,0,4,1,5,3,3,6,0,2,2,-3,3,0,0,2,4,2,-7,5,-6,0,0,-1,0,0,-1,2,-1
KR_6720782310,440,-1,57,-5,1,2,1,3,-2,5,3,0,1,1,3,1,4,-2,2,0,0,7,8,3,-5,2,0,0,0,1,-1,-1,1,4,-1
KR_6738360959,420,-4,-95,5,-6,-1,3,2,1,0,1,-1,3,2,-4,4,0,-1,2,1,0,-4,12,2,-4,2,-4,0,-1,-1,-1,-1,-1,3,-1
KR_6608735625,420,1,-27,-1,-6,3,1,4,-7,8,1,-3,5,2,1,3,4,0,2,2,0,-7,-21,-3,-7,10,6,0,0,1,-1,-1,-1,3,-1
KR_6752717813,440,-4,-91,-26,-7,-5,7,2,-1,4,3,0,4,4,0,4,4,-1,1,0,0,-1,5,0,-3,3,5,0,-1,-1,-1,-1,-1,5,-1
KR_6759430356,420,0,-47,12,5,2,1,3,0,4,4,-1,2,1,7,0,7,-3,4,1,0,9,63,3,-4,1,1,0,0,-1,1,0,-1,3,-1
KR_6762969536,440,-3,16,-16,-5,-1,2,1,1,1,2,-4,5,1,1,2,3,-2,2,0,0,-11,-37,0,-5,5,-6,0,0,-1,0,-1,-1,1,-1
KR_6723155231,440,3,81,12,-1,6,1,7,1,1,2,2,3,5,-6,10,4,-4,4,0,0,-3,-7,-4,-1,5,1,0,0,-1,-1,0,-1,2,-1
KR_6718227019,420,-1,15,20,-3,-2,2,0,2,1,3,0,2,2,-2,2,0,-1,1,0,0,2,-17,0,-4,4,0,0,0,1,-1,-1,-1,5,-1
KR_6751869682,420,-1,20,0,-6,-1,2,1,-2,3,1,-6,7,1,3,2,5,0,3,3,0,2,-362,-1,-7,8,-2,0,-1,-1,-1,-1,-1,1,-1
KR_6762749486,420,1,-40,20,-1,0,0,0,1,1,2,-6,6,0,3,3,6,1,0,1,-2,-6,16,-2,-3,5,-3,0,0,-1,1,1,-1,2,-1
KR_6760501653,420,-4,-54,-20,-6,1,0,1,-6,9,3,-5,7,2,3,1,4,1,1,2,-2,-9,-15,-4,-5,9,-1,0,0,-1,0,0,-1,1,-1
KR_6713762438,440,-3,-36,-25,-14,0,0,0,-2,2,0,0,2,2,-12,12,0,0,1,1,0,-16,-30,-1,-3,4,29,0,-1,-1,-1,-1,-1,4,-1
KR_6573247994,420,-2,-29,15,-8,-4,4,0,-2,3,1,4,1,5,-8,10,2,2,1,3,0,-7,148,0,-6,6,-3,0,-2,-1,-1,1,-1,2,-1
KR_6761886236,420,-1,-56,8,5,3,0,3,-4,5,1,0,6,6,4,2,6,2,0,2,1,14,-3,-2,-4,6,6,0,0,0,-1,0,1,0,-1
KR_6731349990,420,-1,-38,-17,-5,1,3,4,-1,4,3,1,2,3,-3,5,2,-3,3,0,0,-11,1,-3,-2,5,-1,0,1,-1,1,1,-1,5,-1
KR_6758912158,420,-1,-5,9,-3,-1,1,0,-2,4,2,1,2,3,-1,2,1,0,0,0,0,3,5,0,-2,2,-1,0,0,1,-1,-1,-1,3,-1
KR_6728150684,420,-4,-66,20,-5,6,0,6,-5,6,1,2,2,4,-9,10,1,1,0,1,0,-16,-222,0,-5,5,-1,0,0,-1,1,1,-1,4,-1
KR_6758676534,440,-3,-19,1,-6,1,3,4,3,3,6,-5,7,2,-2,4,2,-3,3,0,0,-2,-9,0,-6,6,1,0,0,1,-1,-1,1,6,-1
KR_6736801448,440,-7,-113,-36,-16,-6,6,0,-5,5,0,0,1,1,-2,4,2,-3,5,2,-1,-8,-1,-1,-4,5,-3,0,-2,-1,-1,-1,-1,1,-1
KR_6748688179,420,-3,-55,4,1,1,0,1,-1,2,1,0,5,5,5,3,8,-4,4,0,-1,-1,2,-2,0,2,0,0,-1,1,-1,-1,-1,5,-1
KR_6557707723,420,1,14,-16,4,2,3,5,-1,4,3,0,1,1,3,1,4,0,1,1,0,6,1,1,-5,4,-3,0,2,1,1,1,-1,5,-1
KR_6646473124,420,0,-5,8,-4,-5,5,0,-1,1,0,-3,4,1,4,2,6,1,1,2,0,-5,1,-3,-3,6,2,0,0,-1,-1,-1,-1,2,-1
KR_6577799508,420,4,131,22,11,10,0,10,0,4,4,0,2,2,2,0,2,-1,1,0,0,-1,4,-4,-2,6,1,0,2,-1,1,1,1,3,-1
KR_6659162473,440,2,-8,-8,4,-2,4,2,0,2,2,9,1,10,-4,5,1,1,0,1,0,1,-58,3,-3,0,18,0,0,1,1,0,-1,3,-1
KR_6649480060,420,-3,-4,1,-8,-2,3,1,1,2,3,-3,3,0,-1,2,1,-3,3,0,0,-9,-3,3,-6,3,-1,0,-1,-1,1,-1,-1,1,-1
KR_6759904449,440,-2,-41,-43,-2,-1,2,1,1,0,1,0,2,2,1,2,3,-3,4,1,0,-5,-2,-2,-1,3,2,0,-1,1,-1,-1,1,1,-1
KR_6703315514,440,0,23,-44,-1,1,0,1,0,1,1,-5,5,0,4,0,4,-1,5,4,0,4,2,1,-2,1,1,0,0,-1,0,0,1,4,-1
KR_6767262339,420,-3,-45,0,0,0,1,1,0,1,1,1,1,2,-1,2,1,0,1,1,0,-1,2,3,-5,2,-3,0,0,-1,1,0,1,4,-1
KR_6758165965,420,-3,-26,-4,-11,-2,5,3,3,0,3,-12,13,1,1,2,3,-1,2,1,1,4,2,1,-4,3,-4,0,-1,0,-1,-1,1,0,-1
KR_6767387200,420,-3,-22,8,-8,-3,3,0,1,1,2,-2,4,2,-2,4,2,-2,2,0,-1,-12,-8,-3,-2,5,-1,0,-1,1,-1,-1,-1,4,-1
KR_6714639814,420,-4,-38,-16,-11,-4,5,1,-4,4,0,-1,4,3,-2,4,2,0,0,0,0,-8,26,-2,-3,5,3,0,0,-1,1,-1,-1,6,-1
KR_6762398579,420,-3,9,20,-9,0,0,0,0,1,1,-5,5,0,-2,6,4,-2,2,0,0,-4,0,3,-5,2,-1,0,0,-1,1,-1,-1,1,-1
KR_6681455897,420,-5,-35,-40,-14,-1,3,2,-4,6,2,-5,5,0,-4,4,0,0,1,1,0,-7,13,5,-8,3,-6,0,-1,-1,-1,-1,-1,2,-1
KR_6758241388,420,0,15,26,-7,-3,3,0,-1,3,2,-3,6,3,0,1,1,0,2,2,0,-8,-20,-7,-3,10,4,0,-1,-1,-1,-1,-1,4,-1
KR_6746739453,420,-2,45,-8,-8,-4,5,1,0,2,2,-4,4,0,-2,3,1,2,2,4,0,-2,36,-3,-2,5,1,0,-1,-1,-1,-1,-1,2,-1
KR_6702830859,420,-4,-112,-8,-5,2,2,4,-5,6,1,-1,5,4,-1,4,3,0,1,1,-1,-7,-240,3,-7,4,-3,0,-1,-1,-1,-1,-1,6,-1
KR_6768011512,420,-1,13,-12,-1,-5,5,0,3,1,4,-1,2,1,6,1,7,-4,4,0,0,6,-2,-3,-4,7,2,0,0,1,-1,-1,-1,4,-1
KR_6757240605,420,-4,-106,-32,-9,-1,1,0,-4,5,1,0,3,3,-2,2,0,-2,2,0,0,-10,-3,3,-4,1,-3,0,-1,-1,0,-1,1,3,-1
KR_6658347609,420,0,-37,12,2,0,1,1,-4,7,3,0,2,2,5,0,5,1,1,2,0,9,-30,5,-6,1,-1,0,0,-1,1,-1,-1,6,-1
KR_6650191275,420,-4,-93,-32,-3,-2,3,1,-1,3,2,0,4,4,-2,2,0,2,1,3,1,-4,-57,0,-3,3,27,0,-1,-1,1,-1,1,2,-1
KR_6594431243,420,-4,25,-22,-9,-1,2,1,-6,8,2,-2,4,2,0,4,4,0,0,0,0,-17,-42,0,-8,8,-2,0,-2,-1,-1,-1,1,5,-1
KR_6619613698,420,-4,-8,-32,-5,-1,3,2,-1,2,1,1,1,2,1,1,2,-5,6,1,0,-6,0,0,-4,4,-7,0,0,1,1,1,1,5,-1
KR_6768066672,420,-3,-84,8,-11,-2,2,0,-5,7,2,-1,2,1,-2,3,1,-1,1,0,0,-8,118,3,-4,1,-2,0,-2,1,-1,-1,-1,2,-1
KR_6738283973,440,0,4,-14,-2,0,2,2,-5,5,0,3,1,4,-3,4,1,3,0,3,-1,-5,1,0,-4,4,-4,0,-1,-1,-1,-1,-1,1,-1
KR_6745286491,420,-6,-56,-16,-5,-4,5,1,-4,6,2,-1,3,2,1,2,3,3,0,3,0,-3,-3,-1,-8,9,0,0,0,-1,-1,-1,1,5,-1
KR_6743527996,420,-3,-4,-28,-2,1,0,1,0,2,2,0,2,2,-3,7,4,0,1,1,0,-2,-22,-2,0,2,2,0,0,-1,-1,-1,1,6,-1
KR_6762305289,420,1,13,4,2,2,0,2,4,4,8,1,0,1,-4,5,1,-1,2,1,0,5,2,2,-3,1,1,0,0,0,-1,0,1,0,-1
KR_6765576579,420,4,39,16,9,3,0,3,0,2,2,5,0,5,1,3,4,0,0,0,0,12,-33,4,-5,1,16,0,1,-1,1,1,1,3,-1
KR_6755284959,420,-4,-118,-20,-9,-5,5,0,-1,2,1,2,0,2,-3,3,0,-2,2,0,0,-4,-5,1,-2,1,0,0,-4,-1,-1,-1,-1,1,-1
KR_6685016656,420,1,-19,-20,-6,-4,4,0,-4,5,1,3,1,4,-1,4,3,0,1,1,0,-1,-4,-6,-2,8,2,0,-1,-1,-1,-1,-1,1,-1
KR_6671328568,420,3,-2,-31,3,3,2,5,1,3,4,-2,4,2,2,1,3,-1,1,0,-1,-7,1,3,-4,1,-1,0,0,1,-1,1,-1,3,-1
KR_6648530374,420,-2,42,11,-13,-4,5,1,0,4,4,-3,5,2,-3,7,4,-3,3,0,-2,-22,-16,1,-5,4,3,0,0,-1,1,-1,1,3,-1
KR_6615660664,420,-1,19,-26,-3,-1,1,0,-3,5,2,-2,3,1,2,0,2,1,0,1,0,-1,-32,0,-4,4,0,0,1,0,0,1,-1,0,-1
KR_6463228554,420,-2,-1,-43,-8,-3,5,2,-5,5,0,-5,8,3,4,1,5,1,0,1,0,-8,2,-5,-1,6,-4,0,0,-1,-1,-1,-1,3,-1
KR_6449224178,420,-3,-43,-4,0,3,0,3,-2,6,4,-3,3,0,1,2,3,1,1,2,0,-3,5,-5,-2,7,-3,0,-2,-1,-1,-1,-1,1,-1
KR_6558814607,420,-1,-41,40,3,3,3,6,0,2,2,-3,4,1,2,1,3,1,0,1,0,0,10,3,-5,2,-1,0,1,-1,1,1,1,6,-1
KR_6715400137,420,-2,-97,-15,-1,-1,2,1,-2,3,1,2,2,4,-1,1,0,1,0,1,0,-2,5,-1,-3,4,-2,0,0,-1,1,0,1,1,-1
KR_6754949494,420,-4,-57,-35,-13,-2,2,0,-1,3,2,-10,10,0,2,0,2,-2,2,0,0,-11,10,4,-6,2,-3,0,-1,-1,-1,-1,1,5,-1
KR_6662546082,420,-4,-83,1,-8,0,0,0,-2,3,1,-4,6,2,-3,5,2,1,1,2,0,-9,6,-3,-3,6,-2,0,-3,-1,-1,-1,-1,6,-1
KR_6762714337,440,2,22,8,5,1,1,2,1,2,3,-1,1,0,3,2,5,1,2,3,0,8,-4,1,-3,2,0,0,1,-1,1,1,1,3,-1
KR_6754660546,420,-9,-169,-38,-22,1,2,3,-2,3,1,-9,10,1,-11,11,0,-1,1,0,1,-22,3,2,-6,4,-1,-1,-4,-1,-1,-1,1,1,-1
KR_6706625856,420,-2,69,-46,-8,-4,4,0,-6,7,1,-1,3,2,4,1,5,-1,3,2,0,-2,4,1,-3,2,2,0,0,-1,-1,-1,-1,4,-1
KR_6717153118,420,-5,-30,0,-5,-1,2,1,-2,3,1,0,2,2,-2,3,1,0,1,1,0,-6,3,-2,-3,5,1,0,0,-1,0,0,-1,6,-1
KR_6757920120,420,-4,-82,-6,-2,-2,3,1,-1,1,0,3,1,4,-1,1,0,-1,1,0,0,-3,-9,-4,0,4,0,0,-2,-1,1,-1,1,2,-1
KR_6764075546,420,-7,-118,-12,-14,-1,1,0,-1,2,1,-2,4,2,-1,3,2,-9,9,0,0,-15,-48,-3,-3,6,23,0,-1,1,-1,-1,-1,2,-1
KR_6750561820,420,-2,-93,-24,-4,-1,1,0,2,1,3,1,2,3,-3,3,0,-3,3,0,0,0,-4,2,-5,3,-5,0,0,-1,-1,-1,-1,5,-1
KR_6758188650,420,-3,-19,-24,-1,1,1,2,1,2,3,-1,1,0,-1,4,3,-1,2,1,0,-2,-138,-2,-5,7,5,0,-1,1,-1,-1,1,4,-1
KR_6763220514,420,-4,-85,-18,-7,0,1,1,-1,3,2,-2,3,1,-3,6,3,-1,1,0,0,-2,-48,-5,-1,6,20,0,-4,1,-1,-1,-1,5,-1
KR_6721288500,420,-2,81,-78,-1,0,2,2,-3,4,1,0,2,2,1,2,3,1,0,1,0,2,-303,5,-5,0,-1,0,2,-1,-1,1,1,2,-1
KR_6766949153,420,-3,38,-1,-9,0,3,3,-2,7,5,-5,5,0,-1,4,3,-1,1,0,0,-12,-5,-2,-7,9,3,0,-1,0,-1,-1,-1,0,-1
KR_6645047612,420,-1,10,16,-8,-1,2,1,-4,4,0,2,2,4,-4,7,3,-1,1,0,-2,-20,7,-2,-3,5,0,0,0,-1,1,1,-1,3,-1
KR_6757379605,440,-4,-55,-17,-15,-12,13,1,-2,4,2,-2,2,0,4,1,5,-3,4,1,0,-4,-2,-3,-2,5,-1,0,1,-1,0,-1,-1,4,-1
KR_6727452698,420,-2,-83,0,-6,-2,2,0,1,1,2,-5,7,2,0,2,2,0,0,0,0,-5,1,0,-4,4,-3,0,-1,-1,-1,-1,-1,1,-1
KR_6767249650,420,1,-57,-19,3,-2,4,2,-1,5,4,1,1,2,-1,3,2,6,0,6,0,11,-14,-6,-3,9,2,0,-2,1,-1,-1,1,4,-1
KR_6752215414,420,-3,28,-4,-3,2,2,4,0,4,4,1,1,2,-1,2,1,-5,6,1,0,-3,4,1,-7,6,2,0,0,1,1,1,1,4,-1
KR_6716328733,420,1,36,4,-7,-1,1,0,-5,6,1,-3,7,4,0,1,1,2,0,2,0,7,23,2,-5,3,-16,0,-1,-1,-1,-1,-1,6,-1
KR_6198183108,420,-1,-23,-21,-3,-4,4,0,3,0,3,0,1,1,-2,2,0,0,0,0,0,3,-4,1,-5,4,3,0,-1,-1,-1,-1,-1,3,-1
KR_6740381424,420,2,32,19,8,-1,3,2,3,1,4,5,0,5,1,3,4,0,2,2,0,0,4,8,-9,1,-7,0,1,-1,1,1,1,6,-1
KR_6638511175,420,-4,-15,-20,-4,0,0,0,-2,4,2,-4,4,0,2,0,2,0,0,0,0,0,-6,2,-5,3,-1,0,0,1,-1,-1,1,2,-1
KR_6656640680,420,1,72,2,0,0,1,1,0,2,2,-3,3,0,2,0,2,1,0,1,0,-2,11,3,-6,3,1,0,0,0,1,0,-1,0,-1
KR_6759872361,420,-1,7,-7,-1,-1,1,0,0,2,2,0,3,3,1,0,1,-1,2,1,0,9,-112,4,-7,3,1,0,0,1,-1,0,-1,4,-1
KR_6706377955,420,-1,29,-26,-3,0,1,1,-1,3,2,-1,3,2,1,2,3,-2,5,3,-1,-3,1,0,-3,3,-2,0,1,-1,-1,1,-1,5,-1
KR_6761280238,420,2,-14,37,1,-3,4,1,0,6,6,0,6,6,1,2,3,3,0,3,0,13,-295,2,-4,2,0,0,0,1,-1,0,1,5,-1
KR_6214574990,420,2,7,0,0,-6,6,0,1,0,1,0,2,2,4,1,5,1,1,2,0,3,3,-1,-4,5,-1,0,1,-1,-1,1,1,1,-1
KR_6739982268,420,-6,-61,-37,-14,-8,8,0,-1,3,2,-3,3,0,-3,4,1,1,1,2,0,-3,6,-1,-4,5,-1,0,-4,-1,-1,-1,-1,3,-1
KR_6683853292,420,-5,-89,-40,-11,-3,3,0,-4,4,0,-1,3,2,-2,3,1,-1,2,1,0,-4,-12,2,-5,3,-2,0,0,1,0,-1,-1,6,-1
KR_6712207054,440,0,-34,-4,-4,2,1,3,-6,8,2,4,1,5,-4,10,6,0,2,2,-1,-5,50,1,-6,5,-17,0,-1,-1,-1,-1,-1,6,-1
KR_6763960597,420,1,-46,8,5,3,0,3,2,1,3,2,1,3,2,1,3,-4,4,0,0,6,1,-2,-2,4,-1,0,0,-1,1,0,1,6,-1
KR_6702942677,440,-6,-170,8,-10,-3,7,4,-3,4,1,2,4,6,-6,6,0,0,0,0,0,-6,-5,-5,-2,7,-1,0,-2,-1,-1,-1,-1,2,-1
KR_6714885287,420,0,-48,5,1,-2,5,3,2,0,2,0,2,2,-1,1,0,2,0,2,0,4,211,-6,-1,7,3,0,-2,0,-1,-1,-1,0,-1
KR_6738909380,420,-4,4,-40,-4,-1,2,1,-3,5,2,-1,2,1,0,3,3,1,2,3,-1,-3,29,2,-6,4,-5,0,0,0,0,-1,-1,0,-1
KR_6768409772,420,0,-21,15,-5,0,3,3,2,1,3,-1,3,2,-11,11,0,5,1,6,-1,-7,-3,0,-2,2,-5,0,-1,-1,-1,-1,-1,2,-1
KR_6699780205,420,-6,-123,-60,-13,-3,4,1,-2,3,1,-8,10,2,1,0,1,-1,1,0,0,-12,5,-1,-4,5,-3,0,0,-1,0,-1,-1,3,-1
KR_6767798296,420,-5,-54,0,-13,-1,2,1,-4,5,1,-2,3,1,-6,8,2,0,1,1,0,-9,-1,2,-4,2,-4,0,-2,-1,1,-1,-1,1,-1
KR_6724036076,420,1,28,-4,-3,4,0,4,2,0,2,-3,5,2,-5,7,2,-1,2,1,-1,-13,28,2,-3,1,-2,0,0,-1,1,-1,-1,5,-1
KR_6766554375,440,-2,12,-24,-4,7,0,7,-7,7,0,-4,4,0,0,3,3,0,0,0,0,-3,0,0,-2,2,1,0,-1,-1,0,-1,-1,4,-1
KR_6759483575,420,1,25,2,3,4,1,5,-4,5,1,1,2,3,1,4,5,1,0,1,3,-1,12,-1,-4,5,-6,0,1,1,-1,1,-1,1,-1
KR_6567558640,420,0,-41,10,-7,-2,2,0,-1,1,0,-2,3,1,1,2,3,-3,4,1,-1,-7,3,-1,-3,4,3,0,0,1,1,-1,-1,1,-1
KR_6761316795,440,-7,-92,-4,-9,-3,3,0,-2,2,0,-1,1,0,-2,3,1,-1,2,1,0,-8,0,-2,-4,6,3,0,-3,-1,-1,-1,1,1,-1
KR_6767019487,440,0,14,-16,3,-1,1,0,1,2,3,3,0,3,0,1,1,0,0,0,0,4,-6,2,-4,2,-4,0,1,-1,0,1,1,1,-1
KR_6767542106,420,-2,-13,-16,-9,-2,2,0,-3,3,0,0,2,2,-1,4,3,-3,3,0,0,-12,-140,2,-6,4,0,0,-1,1,-1,-1,-1,4,-1
KR_6752904516,420,2,49,48,4,-1,1,0,-3,6,3,-1,1,0,5,1,6,4,0,4,0,5,-102,-2,-5,7,3,0,1,1,-1,1,1,6,-1
KR_6621418050,420,1,-28,4,1,3,0,3,-2,6,4,0,2,2,-1,5,4,1,3,4,0,4,14,2,-5,3,-7,0,0,-1,-1,0,1,3,-1
KR_6753392678,420,-5,-64,43,-8,-3,4,1,-3,3,0,0,1,1,-1,3,2,-1,1,0,0,-8,18,4,-8,4,-2,0,-1,-1,1,-1,-1,6,-1
KR_6763904370,440,-6,-88,-20,-13,0,1,1,-3,3,0,-6,6,0,0,2,2,-4,4,0,0,-11,-11,-4,0,4,2,0,-4,0,-1,-1,-1,0,-1
KR_6704513376,420,-2,-69,36,-4,-3,3,0,-4,6,2,-3,6,3,4,0,4,2,0,2,0,0,-4,4,-6,2,-1,0,1,1,1,1,1,6,-1
KR_6757426133,420,-3,-45,-24,0,-2,2,0,2,1,3,3,1,4,-3,8,5,0,1,1,0,-3,93,2,-3,1,2,0,-1,1,-1,-1,-1,2,-1
KR_6669325534,420,-3,-55,-15,-15,-3,3,0,-6,7,1,-5,7,2,-1,3,2,0,1,1,0,-6,17,1,-3,2,-1,0,0,-1,-1,0,-1,2,-1
KR_6626543832,420,-3,-80,0,1,-4,4,0,-1,4,3,0,2,2,9,1,10,-3,3,0,-1,2,-12,-5,-2,7,2,0,-1,-1,-1,-1,-1,4,-1
KR_6740129262,440,-3,19,-16,-1,-1,1,0,-2,4,2,-1,1,0,3,1,4,0,1,1,2,-9,-57,6,-7,1,-2,0,0,-1,0,0,1,6,-1
KR_6757938103,420,-3,-59,12,-10,-4,4,0,-7,9,2,0,2,2,-2,4,2,3,1,4,0,-5,-13,-4,-3,7,8,0,-1,-1,-1,-1,-1,6,-1
KR_6750478494,420,-4,-29,-4,-7,-1,1,0,-1,3,2,-7,8,1,0,3,3,2,2,4,1,-1,-4,1,-7,6,-5,0,-1,-1,1,-1,1,2,-1
KR_6700599562,420,-5,-91,-21,-7,-2,2,0,-2,4,2,0,1,1,-2,3,1,-1,1,0,0,-8,2,0,-4,4,-3,0,-2,-1,-1,-1,-1,6,-1
KR_6704743557,440,-9,-76,-53,-19,-3,6,3,-3,4,1,-6,9,3,-4,6,2,-3,4,1,0,-17,-1,-3,-3,6,-1,0,-4,-1,-1,-1,-1,3,-1
KR_6580063307,420,-3,-49,-24,-2,-1,1,0,0,3,3,-1,2,1,0,3,3,0,1,1,0,0,44,-1,-6,7,-22,0,-2,-1,-1,-1,-1,5,-1
KR_6756797391,420,-5,-98,-45,-7,-3,3,0,0,2,2,-1,3,2,-2,3,1,-1,1,0,0,-11,5,0,-3,3,-2,0,-1,-1,-1,-1,1,3,-1
KR_6475891076,420,3,-9,20,-2,3,0,3,-3,5,2,0,0,0,-2,5,3,0,0,0,-1,-8,9,3,-11,8,-2,0,0,-1,0,0,-1,3,-1
KR_6766059861,420,-2,-69,-12,-1,1,4,5,1,2,3,-2,2,0,0,2,2,-1,2,1,0,6,0,0,-5,5,3,0,-1,-1,1,-1,1,6,-1
KR_6749743210,420,-1,-17,2,4,4,1,5,-1,2,1,2,1,3,-1,5,4,0,2,2,3,4,-19,-4,-2,6,2,0,0,0,-1,0,1,0,-1
KR_6760808614,420,1,-38,24,0,0,1,1,1,1,2,-2,4,2,0,2,2,1,1,2,0,0,3,2,-6,4,3,0,0,-1,1,-1,-1,1,-1
KR_6757773321,420,3,-9,20,3,1,1,2,-1,1,0,3,1,4,1,1,2,-1,1,0,0,-2,38,3,-6,3,-17,0,0,1,-1,0,-1,6,-1
KR_6656495890,420,1,33,8,6,8,0,8,1,2,3,-1,5,4,0,5,5,-2,2,0,0,-6,-22,2,-6,4,2,0,1,1,1,1,1,2,-1
KR_6558901390,420,-3,25,-37,0,0,1,1,3,3,6,-5,6,1,0,1,1,2,0,2,0,-3,-5,-5,-1,6,2,0,0,-1,1,0,1,4,-1
KR_6755458255,420,-1,-45,20,-5,-1,3,2,1,1,2,-3,3,0,-2,5,3,0,1,1,0,0,5,2,-5,3,-1,0,0,1,-1,0,-1,3,-1
KR_6757640952,420,-2,1,-16,-11,1,3,4,-2,5,3,-5,7,2,-4,4,0,-1,2,1,2,-7,-8,-4,0,4,4,0,-1,1,-1,-1,1,3,-1
KR_6622737586,420,-4,-22,-40,-3,0,2,2,-3,4,1,-2,2,0,0,5,5,2,0,2,1,-5,-18,-7,-3,10,2,0,0,-1,-1,0,1,3,-1
KR_6732870861,420,-3,-70,-30,-12,1,0,1,-5,6,1,-2,4,2,-2,3,1,-4,4,0,0,-11,-31,1,-7,6,-1,0,1,1,-1,1,-1,5,-1
KR_6685772961,420,1,-64,46,5,2,0,2,2,0,2,4,0,4,-1,3,2,-2,2,0,2,4,-9,-3,-2,5,0,0,0,1,-1,0,1,6,-1
KR_6762073536,420,-6,-34,-33,-5,-4,4,0,-3,3,0,1,0,1,3,1,4,-2,2,0,0,-2,-7,-8,-3,11,4,0,-1,-1,-1,1,1,2,-1
KR_6759882996,420,-1,16,8,-6,-1,2,1,-2,3,1,3,1,4,-5,8,3,-1,1,0,0,-12,43,1,-6,5,-17,0,1,-1,0,1,-1,1,-1
KR_6760548915,420,2,24,20,9,3,2,5,2,2,4,0,1,1,1,0,1,3,1,4,1,3,23,1,-6,5,0,0,0,0,1,0,1,0,-1
KR_6732413207,420,0,-36,40,-4,3,0,3,1,2,3,-4,5,1,-4,5,1,0,1,1,0,-8,120,3,-8,5,0,0,1,1,1,1,-1,6,-1
KR_6610219515,420,-2,-40,-12,-8,0,1,1,7,1,8,-7,7,0,-10,12,2,2,1,3,0,-6,90,-4,-2,6,0,0,-1,-1,1,-1,-1,3,-1
KR_6699758156,420,3,-62,-47,3,-2,3,1,0,4,4,3,0,3,4,1,5,-2,2,0,0,6,-87,5,-6,1,-4,0,-3,1,-1,-1,1,3,-1
KR_6748925067,420,-2,49,-64,-5,1,0,1,-3,3,0,-4,6,2,1,1,2,0,1,1,0,-7,-2,-2,-6,8,1,0,0,-1,0,0,-1,3,-1
KR_6671246665,420,-1,-38,-20,-6,1,4,5,-3,5,2,-3,6,3,-2,4,2,1,1,2,-1,-4,4,2,-6,4,-3,0,0,-1,1,1,-1,3,-1
KR_6750774619,420,1,44,-4,-4,3,0,3,-3,4,1,0,2,2,-5,7,2,1,2,3,0,-15,-1,1,-5,4,-5,0,1,-1,1,1,-1,4,-1
KR_6738239094,420,-1,34,23,-7,-1,3,2,-1,1,0,2,0,2,-2,4,2,-5,6,1,0,-5,28,-1,-5,6,-6,0,1,-1,1,1,-1,2,-1
KR_6743468221,420,0,-76,24,7,1,1,2,2,3,5,7,1,8,-5,7,2,2,0,2,0,-4,8,1,-6,5,-4,0,-1,-1,1,-1,1,1,-1
KR_6764963632,420,-5,27,-24,-9,-5,6,1,-4,6,2,1,0,1,1,3,4,-2,2,0,0,-12,-6,-5,-2,7,2,0,0,-1,-1,-1,1,3,-1
KR_6762113828,420,0,6,-28,-2,-2,5,3,1,4,5,0,0,0,-1,3,2,0,1,1,0,0,-130,0,-4,4,1,0,0,1,-1,-1,-1,6,-1
KR_6707093263,420,-3,-61,9,-4,-1,2,1,1,1,2,1,2,3,-4,4,0,-1,2,1,0,-8,-11,-3,-4,7,0,0,-3,-1,-1,-1,-1,1,-1
KR_6763092951,420,1,-17,37,-4,1,2,3,-3,3,0,-1,3,2,-3,5,2,2,1,3,0,-12,3,-3,-6,9,-4,0,0,0,1,-1,-1,0,-1
KR_6759194134,420,-4,-29,-16,-14,-3,3,0,-3,6,3,-5,7,2,0,2,2,-3,3,0,0,-8,4,0,-4,4,2,0,-1,-1,-1,-1,-1,4,-1
KR_6739001569,420,-6,-118,-16,-18,-4,4,0,-4,4,0,-3,4,1,-8,9,1,1,0,1,0,-11,-7,-4,-3,7,-3,0,-1,-1,-1,-1,-1,4,-1
KR_6752973170,420,-4,-85,-27,-11,2,0,2,-2,3,1,-6,6,0,-5,7,2,0,1,1,0,-16,-18,-5,-1,6,2,0,-2,-1,-1,-1,-1,2,-1
KR_6641158843,420,-4,-81,-4,-9,0,2,2,-5,5,0,-5,5,0,1,3,4,0,0,0,0,-4,-6,-1,-3,4,-6,0,-2,-1,1,-1,-1,3,-1
KR_6745178266,420,-3,-74,-28,-2,-3,3,0,-2,3,1,3,2,5,1,1,2,-1,3,2,0,3,7,1,-6,5,-5,0,-1,-1,-1,-1,-1,1,-1
KR_6763200728,420,-1,-14,-36,3,4,0,4,0,1,1,-1,3,2,-1,2,1,1,0,1,0,0,-53,-3,-2,5,27,0,-1,-1,1,-1,1,4,-1
KR_6691709198,440,1,-8,2,11,3,1,4,0,3,3,-1,5,4,9,2,11,0,1,1,2,14,-2,-1,-2,3,2,0,0,1,-1,1,1,6,-1
KR_6767749188,420,-1,7,3,-8,2,1,3,-3,5,2,-4,6,2,-1,4,3,-2,2,0,1,-10,102,-1,-2,3,3,0,1,-1,1,1,1,6,-1
KR_6741937739,420,-6,-38,6,-11,3,2,5,-8,8,0,-5,5,0,-4,5,1,3,5,8,-3,-16,-11,0,-3,3,-2,0,0,1,-1,1,-1,3,-1
KR_6691674074,440,2,29,20,-2,-2,4,2,-2,4,2,5,3,8,-5,8,3,2,0,2,0,0,2,-2,-3,5,-2,0,1,1,-1,-1,-1,2,-1
KR_6752073913,440,-3,-112,20,-9,-2,2,0,4,2,6,-2,3,1,-6,7,1,-3,3,0,0,-7,-5,-1,-4,5,-4,0,0,-1,1,0,1,4,-1
KR_6759658150,420,-5,-91,-16,-15,-6,6,0,-2,3,1,-1,3,2,-3,4,1,-3,4,1,-1,-20,-11,-8,0,8,0,0,-3,-1,0,-1,1,2,-1
KR_6753947535,420,-5,-9,-28,-8,-4,4,0,-3,4,1,3,1,4,-4,5,1,0,4,4,0,-6,1,1,-5,4,-2,0,-1,0,-1,-1,-1,0,-1
KR_6727194352,440,-5,-19,-9,-9,-2,2,0,0,2,2,-1,1,0,-4,6,2,-2,2,0,0,-6,-8,-4,-4,8,-3,0,0,-1,-1,0,-1,4,-1
KR_6742561613,440,-3,4,-42,-11,0,0,0,1,4,5,-6,7,1,-3,8,5,-3,5,2,1,-9,-9,-3,-3,6,-1,0,0,-1,-1,-1,1,2,-1
KR_6758810896,420,-1,-12,-9,-2,4,0,4,-3,4,1,-4,4,0,4,2,6,-3,3,0,0,-4,-14,-5,-1,6,0,0,-1,-1,1,-1,1,4,-1
KR_6550165533,420,-3,-76,8,-14,1,1,2,3,1,4,-2,2,0,-15,17,2,-1,1,0,-1,-14,42,-3,-4,7,-25,0,1,1,1,-1,-1,1,-1
KR_6763199497,420,1,54,10,2,-1,2,1,2,1,3,-2,3,1,3,2,5,0,1,1,1,-2,-8,2,-6,4,0,0,-1,0,-1,-1,1,0,-1
KR_6494604549,420,-2,-42,16,-7,-2,2,0,-1,4,3,-1,1,0,-4,4,0,1,1,2,0,-4,105,-1,-1,2,-1,0,-1,-1,1,-1,-1,1,-1
KR_6764299383,420,-4,-99,-24,-5,0,2,2,-4,5,1,0,2,2,1,2,3,-2,2,0,-2,-5,-44,-4,-3,7,14,0,-2,-1,-1,-1,-1,1,-1
KR_6759803545,420,-5,-27,-12,-8,-3,5,2,0,3,3,-5,5,0,0,2,2,0,0,0,-1,-9,-6,-1,-3,4,1,0,-1,-1,-1,-1,-1,6,-1
KR_6750932884,420,3,28,24,5,-1,2,1,2,1,3,-3,4,1,5,0,5,2,1,3,0,9,21,-1,-4,5,0,0,1,0,1,1,1,0,-1
KR_6762674336,440,-4,-37,-13,-15,-3,3,0,-4,6,2,-5,5,0,-3,3,0,0,0,0,0,-13,-86,-5,-2,7,8,0,-2,-1,-1,-1,-1,2,-1
KR_6721607127,420,-1,-30,16,-2,-2,3,1,1,2,3,2,3,5,-2,4,2,-1,1,0,0,-4,-24,5,-7,2,0,0,0,-1,1,0,-1,4,-1
KR_6737330355,420,-3,-75,-9,-13,-6,7,1,-8,8,0,3,1,4,0,0,0,-2,2,0,0,-10,-2,-1,-3,4,-2,0,-1,-1,-1,-1,-1,3,-1
KR_6464751446,420,-1,-49,-16,2,1,1,2,-1,2,1,2,1,3,2,3,5,-2,3,1,0,-3,-59,4,-7,3,1,0,1,-1,1,1,1,3,-1
KR_6765300059,420,-3,-63,13,-10,-3,4,1,2,4,6,-1,3,2,-1,4,3,-7,9,2,-1,-8,10,2,-2,0,-1,0,0,0,0,-1,-1,0,-1
KR_6758140091,420,-4,-89,5,-1,0,2,2,6,0,6,2,0,2,-7,8,1,-2,2,0,0,-5,4,5,-10,5,-2,0,0,1,1,-1,1,5,-1
KR_6761982156,420,-1,19,-40,-5,0,1,1,-7,7,0,-1,5,4,5,1,6,-2,3,1,0,-6,-39,1,-2,1,23,0,0,-1,-1,0,-1,5,-1
KR_6744568519,420,-5,-5,-60,-10,1,3,4,-4,5,1,-3,4,1,-2,2,0,-2,2,0,0,-14,-62,-3,-2,5,-4,0,-1,-1,-1,-1,-1,3,-1
KR_6738681437,420,-3,-77,5,-5,-5,5,0,4,3,7,1,2,3,-1,4,3,-4,4,0,0,1,-15,3,-5,2,-2,0,-1,1,1,-1,-1,1,-1
KR_6725984325,420,1,12,43,5,0,1,1,1,2,3,5,1,6,-3,5,2,2,1,3,0,2,-1,-2,-2,4,-2,0,0,-1,1,-1,1,5,-1
KR_6698219355,420,-6,-89,-39,-13,4,1,5,-4,5,1,-5,7,2,-4,5,1,-4,5,1,-1,-14,-12,2,-5,3,0,0,-1,0,-1,-1,1,0,-1
KR_6764298931,420,-3,-59,-27,-7,0,0,0,-2,2,0,-7,9,2,2,1,3,0,0,0,0,-3,-1,-1,-4,5,-3,0,-1,-1,-1,-1,-1,4,-1
KR_6738985501,420,-4,-43,-20,-10,0,2,2,-1,1,0,-1,2,1,-3,5,2,-5,6,1,0,-10,6,0,-2,2,-5,0,0,-1,0,1,-1,4,-1
KR_6759929091,420,3,34,-16,0,2,2,4,1,2,3,0,1,1,-5,5,0,2,0,2,0,-2,-5,-5,-3,8,-1,0,0,1,-1,1,-1,6,-1
KR_6760624553,420,-1,-46,-8,-3,0,1,1,-2,4,2,2,4,6,-3,6,3,0,0,0,-1,-10,-313,-4,-1,5,2,0,-1,1,-1,-1,-1,6,-1
KR_6666796524,420,-1,-16,-8,0,-8,10,2,0,3,3,1,1,2,5,0,5,2,0,2,-2,7,-317,-3,-4,7,1,0,-1,0,-1,-1,-1,0,-1
KR_6210698297,420,-7,6,-10,-14,-8,8,0,-2,3,1,0,0,0,0,2,2,-4,5,1,0,-6,-187,-5,-3,8,2,0,-3,1,-1,-1,-1,1,-1
KR_5830496092,420,2,9,7,4,2,0,2,2,3,5,0,0,0,-1,2,1,1,0,1,0,3,10,3,-8,5,-4,0,0,-1,1,0,-1,5,-1
KR_6724137366,420,-2,-35,-8,-10,-1,2,1,4,2,6,-3,3,0,-6,6,0,-4,4,0,0,-14,11,0,-4,4,1,0,-3,-1,-1,-1,1,5,-1
KR_6763131983,420,-5,-91,45,-17,-4,5,1,1,1,2,-2,4,2,-4,4,0,-8,8,0,0,-10,-10,-4,-2,6,-4,0,-2,-1,-1,-1,-1,2,-1
KR_6733084463,420,1,29,29,-4,-5,6,1,-2,3,1,-3,6,3,2,1,3,4,1,5,0,-10,126,2,-6,4,-2,0,1,1,1,1,1,3,-1
KR_6752892373,420,1,-29,4,3,0,3,3,1,2,3,-1,2,1,-2,4,2,5,0,5,0,4,36,4,-5,1,-7,0,2,-1,1,1,1,4,-1
KR_6767580886,420,-2,-45,-12,-8,2,1,3,-1,1,0,-1,3,2,-6,8,2,-2,2,0,-1,-6,31,5,-7,2,3,0,0,-1,0,-1,-1,1,-1
KR_6682811478,440,-6,14,-3,-17,0,3,3,-7,8,1,-5,5,0,-3,4,1,-2,2,0,-1,-24,133,-2,-3,5,0,0,0,-1,-1,-1,-1,3,-1
KR_6757442203,420,1,9,12,7,2,2,4,4,1,5,4,0,4,-3,7,4,0,2,2,0,-4,12,1,-3,2,0,0,0,-1,-1,0,1,5,-1
KR_6743470913,420,2,5,22,3,0,0,0,0,2,2,0,4,4,2,4,6,1,1,2,0,-4,34,0,-5,5,-4,0,2,-1,0,1,1,3,-1
KR_6767510470,440,-2,-31,-2,-7,-2,3,1,0,1,1,-6,7,1,-2,4,2,3,0,3,-2,-7,-5,-3,-5,8,4,0,0,-1,0,-1,1,4,-1
KR_6718394268,420,0,-24,1,1,0,0,0,2,0,2,3,0,3,-4,4,0,0,0,0,0,-5,0,0,-2,2,0,0,0,1,1,0,1,5,-1
KR_6717206932,420,-4,35,-28,-10,-7,7,0,-5,6,1,4,2,6,-1,1,0,-1,1,0,-1,-17,2,0,-4,4,-2,0,-1,-1,-1,-1,-1,1,-1
KR_6548254607,420,-3,18,-14,-13,3,0,3,2,1,3,-11,12,1,-5,5,0,-2,2,0,0,-5,-10,-5,0,5,1,0,-1,-1,1,1,-1,6,-1
KR_6768321050,420,0,-8,-11,0,-2,2,0,-1,2,1,5,2,7,-1,3,2,-1,1,0,0,-3,1,-1,-5,6,0,0,-1,1,-1,-1,1,5,-1
KR_6715491412,420,-4,-43,-17,-6,-6,7,1,-2,2,0,0,3,3,-1,5,4,3,0,3,0,-5,4,4,-8,4,-3,0,0,1,1,-1,1,2,-1
KR_6755402377,420,0,45,-36,1,4,0,4,-5,5,0,1,3,4,1,1,2,0,0,0,0,-5,-3,-1,-2,3,3,0,0,-1,0,-1,-1,2,-1
KR_6749353898,420,-1,-5,8,-4,-1,2,1,-1,6,5,1,0,1,-3,5,2,0,1,1,0,-14,-3,-4,-5,9,3,0,0,-1,1,0,1,1,-1
KR_6756950574,420,3,22,12,7,10,0,10,-1,4,3,1,2,3,-1,2,1,-2,3,1,-1,-1,-5,-2,-1,3,-1,0,0,-1,1,1,-1,3,-1
KR_6713563366,420,0,-26,-18,1,0,2,2,0,6,6,-3,5,2,3,2,5,1,2,3,0,-5,-4,-2,-3,5,0,0,1,1,1,1,-1,1,-1
KR_6748904631,420,-1,-28,4,-4,0,0,0,-2,4,2,-5,5,0,2,3,5,1,0,1,-1,2,-3,-2,-3,5,2,0,-1,-1,1,-1,-1,6,-1
KR_6738350095,420,-1,26,-24,3,3,1,4,-2,3,1,2,1,3,0,1,1,0,1,1,0,2,-114,4,-7,3,0,0,0,1,1,0,1,2,-1
KR_6745598917,420,-9,-52,-32,-14,-6,7,1,-3,3,0,-2,2,0,0,2,2,-3,4,1,0,-8,-19,2,-6,4,2,0,-3,0,-1,-1,-1,0,-1
KR_6716512151,440,-3,-66,-22,-7,0,1,1,-6,7,1,0,3,3,-2,5,3,1,2,3,0,-10,-7,-7,0,7,-3,0,0,-1,-1,0,-1,4,-1
KR_6527041728,420,-6,-59,-34,-19,-7,8,1,-3,4,1,2,2,4,-9,9,0,-2,3,1,0,-16,-9,0,-2,2,0,0,-1,-1,-1,-1,-1,6,-1
KR_6753691739,420,0,22,15,4,4,0,4,0,4,4,2,2,4,-2,4,2,0,0,0,0,-3,-3,0,-4,4,7,0,0,1,0,0,-1,1,-1
KR_6664198750,420,-1,38,-20,-7,-2,2,0,-1,2,1,-1,2,1,-1,3,2,-2,3,1,0,-6,-4,0,-5,5,2,0,0,-1,1,0,-1,3,-1
KR_6730348858,420,-2,-58,-34,-10,-3,5,2,-5,5,0,-2,5,3,2,1,3,-2,2,0,0,-6,12,0,-3,3,0,0,0,-1,-1,-1,-1,4,-1
KR_6764455706,420,-4,4,-4,-6,-2,3,1,3,2,5,-1,1,0,-4,4,0,-2,2,0,0,-13,8,0,-4,4,-1,0,-1,-1,0,-1,-1,5,-1
KR_6713406617,420,0,32,40,-4,-5,5,0,-2,2,0,5,1,6,-2,4,2,0,1,1,-2,-14,-4,0,-4,4,2,0,0,1,-1,-1,-1,4,-1
KR_6465346321,420,-4,-17,-51,-4,-1,1,0,0,1,1,2,2,4,-5,5,0,0,0,0,0,-3,-12,-6,-3,9,2,0,0,-1,1,1,1,6,-1
KR_6731926291,420,-1,-34,-23,-6,-2,3,1,5,0,5,-8,9,1,-2,5,3,1,0,1,0,-9,-17,4,-9,5,-4,0,-1,-1,-1,-1,-1,1,-1
KR_6765475076,420,1,66,12,-1,-1,1,0,-3,5,2,-1,2,1,0,4,4,4,1,5,0,-6,2,-1,-5,6,0,0,0,1,-1,0,-1,1,-1
KR_6713558058,420,-2,-27,-24,3,3,1,4,-2,2,0,3,4,7,-4,5,1,3,1,4,0,0,-17,0,-6,6,9,0,1,-1,1,-1,1,3,-1
KR_6767542271,420,0,-11,35,6,5,1,6,0,2,2,4,1,5,-2,2,0,-1,1,0,0,1,12,2,-2,0,-5,0,0,1,1,1,1,1,-1
KR_6767865845,420,-3,-86,-41,4,1,0,1,3,2,5,0,0,0,0,2,2,0,1,1,0,3,118,1,-6,5,-8,0,1,1,-1,1,1,4,-1
KR_6754528857,420,-3,-101,-32,-9,-5,6,1,-3,4,1,2,2,4,-3,3,0,0,0,0,0,-8,0,-3,-2,5,1,0,-1,0,-1,-1,-1,0,-1
KR_6763025644,420,-2,-7,-3,-6,1,1,2,-1,1,0,-3,9,6,-4,8,4,1,1,2,0,-7,-2,-2,-1,3,-1,0,-1,-1,-1,-1,-1,1,-1
KR_6744247906,420,-4,-51,-16,-7,-6,6,0,1,1,2,-5,5,0,3,1,4,0,0,0,1,0,35,-2,-5,7,-13,0,-2,-1,-1,-1,1,6,-1
KR_6619694689,420,-2,-13,-14,-15,0,1,1,1,4,5,-9,10,1,-1,2,1,-6,8,2,-1,-9,-23,-6,-2,8,4,0,-2,-1,-1,-1,-1,2,-1
KR_6761809520,440,-2,-14,-4,-13,3,0,3,-9,9,0,-3,4,1,-2,2,0,-2,3,1,0,-17,2,2,-4,2,0,0,2,-1,-1,1,-1,6,-1
KR_6603176969,420,-4,-76,4,-9,-2,3,1,-5,7,2,-1,2,1,2,3,5,-3,4,1,0,-10,10,1,-5,4,-4,0,0,-1,1,1,1,2,-1
KR_6765578959,420,-3,27,-22,-3,-5,7,2,3,2,5,-1,6,5,0,3,3,0,0,0,2,3,8,-3,-1,4,0,0,1,0,-1,-1,1,0,-1
KR_6757958174,420,-1,-67,22,2,0,1,1,5,1,6,-1,6,5,0,1,1,-2,3,1,0,8,15,2,-7,5,-4,0,-2,-1,-1,-1,-1,5,-1
KR_6601347724,420,2,-9,-24,8,2,2,4,-1,3,2,2,1,3,0,4,4,5,3,8,-1,6,-9,-5,-2,7,6,0,0,1,1,0,-1,1,-1
KR_6759306976,440,-2,-47,-8,-6,0,0,0,-2,3,1,0,1,1,-1,1,0,-3,5,2,0,-11,1,1,-6,5,5,0,0,1,1,1,-1,2,-1
KR_6732981299,420,-5,0,-22,-7,0,1,1,-3,4,1,-3,4,1,-2,4,2,1,1,2,0,-4,1,3,-6,3,-3,0,-2,-1,0,-1,-1,2,-1
KR_6691877769,420,0,21,-36,3,0,3,3,-3,6,3,-3,4,1,7,0,7,2,1,3,0,4,112,-2,-2,4,2,0,0,0,1,1,1,0,-1
KR_6764685861,440,-1,9,-17,0,2,1,3,-1,2,1,1,2,3,-3,3,0,1,0,1,0,-2,193,-2,-4,6,3,0,0,-1,1,1,1,1,-1
KR_6767692944,420,-8,-96,-19,-21,0,4,4,-14,15,1,-3,5,2,-5,8,3,1,2,3,-6,-12,-127,4,-5,1,-3,0,-1,-1,1,-1,-1,5,-1
KR_6758323043,420,2,-15,-17,11,-1,3,2,1,0,1,3,4,7,4,2,6,4,0,4,0,18,1,3,-5,2,3,0,0,1,1,-1,1,6,-1
KR_6755402094,420,1,99,-3,-1,-1,2,1,1,1,2,-4,6,2,1,2,3,2,1,3,0,-7,36,0,-5,5,0,0,1,-1,1,-1,1,2,-1
KR_6765463191,420,-2,-61,-3,0,-1,2,1,1,2,3,5,2,7,-5,8,3,0,1,1,0,3,-13,-2,-3,5,0,0,-1,1,-1,-1,1,4,-1
KR_6741268838,420,-6,-33,-4,-9,-3,4,1,1,1,2,-3,4,1,1,1,2,-5,5,0,0,-8,-30,-1,-3,4,-1,0,-1,1,-1,-1,-1,5,-1
KR_6579542481,420,-6,-34,-16,-16,-2,2,0,-4,4,0,-6,6,0,-1,2,1,-3,4,1,0,-16,-1,2,-5,3,-5,0,-2,-1,-1,-1,-1,5,-1
KR_6681147012,440,0,138,0,-10,-1,1,0,-3,3,0,2,1,3,-9,10,1,1,2,3,-1,-21,-73,-3,-3,6,0,0,0,-1,-1,1,1,2,-1
KR_6766004283,420,-5,-44,-20,-9,2,0,2,1,2,3,-7,7,0,-3,4,1,-2,4,2,0,-11,-11,-2,-5,7,2,0,1,-1,1,-1,-1,6,-1
KR_6749172542,440,0,-22,8,-5,-5,6,1,0,0,0,-1,4,3,1,2,3,0,1,1,-1,-7,9,1,-4,3,-3,0,0,-1,1,0,-1,5,-1
KR_6721495945,420,-2,-16,-11,-12,-4,5,1,0,1,1,-7,9,2,-1,2,1,0,3,3,0,-13,-166,1,-3,2,-3,0,-2,1,-1,-1,-1,2,-1
KR_6688296757,420,2,33,4,-2,-1,2,1,0,4,4,1,0,1,-2,4,2,0,2,2,0,0,-97,-3,-5,8,-26,0,-1,1,1,-1,-1,5,-1
KR_6356007488,420,-1,37,-8,1,1,2,3,-3,6,3,0,2,2,0,5,5,3,1,4,0,7,0,0,0,0,-3,0,2,-1,1,1,-1,3,-1
KR_6759498324,420,6,43,16,16,1,3,4,-2,5,3,3,1,4,13,1,14,1,1,2,0,12,-20,1,-3,2,1,0,3,-1,1,1,1,4,-1
KR_6621434932,420,0,-3,-41,-3,-1,1,0,0,1,1,-2,3,1,0,3,3,0,0,0,0,-2,-3,-2,-3,5,1,0,0,-1,-1,0,1,5,-1
KR_6722344888,440,-3,-11,-5,2,3,2,5,-4,8,4,0,2,2,1,2,3,2,1,3,3,0,-8,0,-3,3,-3,0,0,1,1,0,1,2,-1
KR_6687236389,420,-2,-37,-24,4,2,2,4,5,1,6,0,3,3,-3,6,3,0,1,1,0,0,-44,3,-8,5,14,0,1,-1,1,-1,1,3,-1
KR_6602333376,420,-2,-79,-24,-4,-6,7,1,-1,3,2,-2,4,2,3,1,4,2,0,2,0,3,-230,1,-4,3,-3,0,-2,1,-1,-1,1,3,-1
KR_6762734931,420,-5,13,-31,-14,-1,2,1,-1,3,2,-2,4,2,-10,10,0,0,3,3,0,-12,-7,1,-4,3,3,0,-1,1,1,-1,-1,1,-1
KR_6739001250,420,-3,-113,-25,-5,-2,3,1,0,2,2,2,1,3,-3,3,0,-2,2,0,0,-6,4,1,-2,1,0,0,-1,-1,-1,-1,-1,5,-1
KR_6747962000,440,0,-34,16,-3,0,2,2,-2,5,3,5,0,5,-6,7,1,0,0,0,0,-8,-116,9,-13,4,-6,0,0,1,1,-1,-1,3,-1
KR_6731500921,420,1,-99,35,-3,-5,6,1,0,1,1,2,1,3,-3,7,4,3,0,3,0,-1,-8,-2,-2,4,3,0,-1,1,0,-1,1,3,-1
KR_6767246614,420,-4,-10,-44,-10,-4,4,0,-1,2,1,-3,3,0,0,2,2,-2,3,1,0,-7,384,-4,0,4,2,0,-1,-1,-1,-1,-1,1,-1
KR_6768355000,440,-6,5,5,-14,-2,4,2,-2,4,2,-3,3,0,-5,6,1,-2,3,1,0,-18,-3,0,-3,3,2,0,-2,-1,-1,-1,1,4,-1
KR_6723329542,420,-3,-91,-8,-2,1,2,3,0,2,2,0,3,3,-2,3,1,-1,3,2,0,-3,15,-2,-1,3,0,0,0,1,1,0,-1,2,-1
KR_6755604917,420,-3,-2,-6,-9,-2,4,2,-2,3,1,-1,4,3,-4,7,3,0,1,1,0,-18,5,3,-4,1,0,0,0,-1,0,1,-1,6,-1
KR_6768391847,420,0,-6,26,-5,1,0,1,2,1,3,-2,4,2,-4,6,2,-2,4,2,0,-6,19,-2,-2,4,-2,0,1,0,1,1,1,0,-1
KR_6579675940,420,0,-48,2,-1,0,4,4,4,2,6,0,1,1,-5,7,2,0,2,2,1,-3,3,4,-6,2,-3,0,-2,-1,-1,-1,1,6,-1
KR_6765290445,420,-1,-35,3,2,-5,5,0,3,1,4,-1,8,7,4,2,6,1,2,3,0,12,-19,0,-3,3,3,0,-1,-1,1,-1,1,2,-1
KR_6764237207,420,-2,-61,10,5,4,0,4,-3,3,0,-1,2,1,2,5,7,3,1,4,0,8,0,-1,-2,3,1,0,-1,0,1,-1,-1,0,-1
KR_6559560486,420,1,-16,16,-4,1,2,3,-1,11,10,-2,4,2,-1,3,2,-1,2,1,0,-5,31,-12,-6,18,-12,0,0,-1,-1,1,-1,1,-1
KR_6705104537,420,-1,9,-37,-4,0,2,2,-1,5,4,-3,3,0,0,1,1,0,1,1,0,-2,4,0,-3,3,0,0,0,-1,1,0,1,3,-1
KR_6764606102,420,-2,-32,-3,-12,-7,8,1,-4,7,3,1,4,5,-1,1,0,-1,1,0,0,-13,-2,-4,-2,6,-6,0,-1,-1,0,-1,-1,1,-1
KR_6766596948,420,-2,9,-40,6,2,0,2,4,4,8,4,0,4,-3,5,2,-1,1,0,0,8,-1,2,-4,2,2,0,1,-1,1,1,1,6,-1
KR_6768528609,420,-1,-53,-21,-13,5,1,6,0,2,2,-6,8,2,-11,12,1,-1,1,0,-1,-4,-25,-5,-5,10,0,0,-1,-1,0,-1,-1,5,-1
KR_6723678448,420,-2,-51,29,-3,-4,4,0,1,2,3,-1,1,0,0,3,3,1,2,3,0,4,20,-6,-3,9,-1,0,1,1,1,1,-1,6,-1
KR_6734058078,420,0,40,-1,3,0,0,0,5,2,7,-3,4,1,1,1,2,0,1,1,0,5,-15,1,-8,7,3,0,0,1,1,1,1,5,-1
KR_6763666140,420,-2,-20,22,-9,0,3,3,-3,6,3,-1,2,1,-1,1,0,-4,5,1,1,-12,-3,0,-4,4,0,0,0,1,0,-1,1,4,-1
KR_6666000667,420,-4,-69,-36,-7,-5,5,0,0,5,5,-2,4,2,-2,3,1,2,3,5,0,-4,6,1,-5,4,1,0,-1,-1,1,-1,-1,2,-1
KR_6767445860,420,1,-78,20,-1,1,2,3,2,3,5,3,2,5,-6,8,2,-1,2,1,0,-3,118,1,-5,4,-3,0,0,0,0,0,1,0,-1
KR_6747885108,420,-2,-10,-4,-7,-3,3,0,-5,7,2,0,2,2,2,2,4,-1,3,2,-1,-5,1,0,-1,1,-4,0,-4,1,-1,-1,-1,4,-1
KR_6689783130,420,-1,-3,-12,-1,0,1,1,-5,8,3,5,1,6,0,3,3,-1,1,0,0,-8,20,2,-5,3,-1,0,0,1,0,-1,-1,4,-1
KR_6734273176,420,-4,-90,-18,-13,-6,6,0,1,2,3,-6,7,1,-3,3,0,1,0,1,0,-6,-4,-4,0,4,0,0,-3,-1,-1,-1,-1,5,-1
KR_6651119721,420,1,-66,25,1,2,0,2,1,4,5,-3,4,1,1,0,1,0,0,0,0,0,11,0,-4,4,-1,0,0,1,1,-1,1,4,-1
KR_6482385790,420,2,-9,-31,0,3,0,3,0,4,4,-3,3,0,0,3,3,0,1,1,-3,-1,-392,3,-6,3,5,0,-2,-1,1,-1,-1,3,-1
KR_6724953653,440,-3,-90,-17,1,1,4,5,0,1,1,7,1,8,-4,5,1,-3,4,1,0,1,1,-1,-3,4,1,0,0,1,1,1,1,2,-1
KR_6731732758,420,-2,-13,-4,-8,0,1,1,0,2,2,-4,5,1,-2,3,1,-2,2,0,0,-4,-23,-2,-3,5,2,0,-1,-1,-1,-1,1,4,-1
KR_6762395094,440,-2,8,2,-2,6,0,6,0,3,3,-6,7,1,-5,7,2,3,0,3,0,-6,-5,-3,-3,6,0,0,0,1,1,1,1,1,-1
KR_6756478570,420,1,-36,5,-1,1,1,2,-1,4,3,4,0,4,-4,5,1,-1,1,0,0,-2,-16,0,-4,4,0,0,0,-1,-1,0,1,4,-1
KR_6387369738,420,-2,22,-20,-6,0,0,0,-4,5,1,1,2,3,0,2,2,-3,4,1,0,-9,-14,-4,-1,5,3,0,0,-1,-1,-1,-1,1,-1
KR_6573189411,420,-1,-20,-11,-2,3,3,6,3,1,4,-4,4,0,-4,4,0,0,2,2,0,0,217,3,-7,4,-5,0,0,0,-1,0,-1,0,-1
KR_6723167828,420,-5,-77,8,-14,-2,2,0,-15,16,1,4,1,5,-1,4,3,0,0,0,1,-23,-14,-5,-2,7,-2,0,-2,-1,-1,-1,1,4,-1
KR_6758114890,420,-4,-46,-28,-6,-1,4,3,0,1,1,-5,5,0,-1,5,4,1,1,2,-1,-9,-2,-4,-1,5,0,0,-2,-1,-1,-1,-1,1,-1
KR_6729897990,420,1,30,-16,0,1,2,3,1,0,1,-1,2,1,1,0,1,-2,4,2,0,-2,-3,2,-7,5,3,0,1,1,1,1,1,4,-1
KR_6733551287,420,-1,-31,0,-1,9,0,9,-3,4,1,-2,4,2,-4,6,2,-1,1,0,1,-2,7,1,-4,3,3,0,2,-1,-1,1,-1,3,-1
KR_6722065925,420,1,38,-3,9,2,3,5,3,1,4,-1,3,2,2,3,5,3,1,4,0,0,228,1,-4,3,-1,0,0,-1,1,1,1,3,-1
KR_6755716123,420,-3,-88,14,-12,1,2,3,0,1,1,-4,6,2,-2,3,1,-7,7,0,-2,-20,-9,-2,-4,6,-5,0,-2,-1,-1,-1,-1,5,-1
KR_6595023657,420,-3,-14,-32,-2,0,1,1,-2,3,1,-1,2,1,1,0,1,0,0,0,0,-2,-13,2,-5,3,1,0,-1,-1,-1,-1,1,4,-1
KR_6767814458,420,-7,-123,-43,-18,-2,4,2,-4,6,2,-9,10,1,0,3,3,-3,3,0,-1,-17,-3,2,-6,4,-10,0,-1,-1,-1,-1,-1,4,-1
KR_6634069678,420,-4,-52,6,-7,3,0,3,-2,4,2,-8,10,2,0,3,3,0,1,1,0,-8,-27,8,-12,4,1,0,1,-1,1,1,-1,6,-1
KR_6767547632,420,-2,-76,3,-1,4,0,4,-3,3,0,-1,3,2,1,0,1,-2,2,0,-1,0,-27,-1,-2,3,0,0,0,1,-1,0,-1,4,-1
KR_6755307479,420,4,22,-8,4,5,0,5,-3,3,0,4,1,5,-2,4,2,0,1,1,0,-3,-1,0,-3,3,3,0,3,1,-1,1,1,4,-1
KR_6765667524,420,3,88,15,9,4,0,4,2,2,4,-1,4,3,1,2,3,3,1,4,0,11,-1,-1,-4,5,5,0,1,1,1,1,1,3,-1
KR_6713531291,420,1,-30,6,4,2,2,4,-3,3,0,3,0,3,-3,4,1,5,0,5,0,4,-4,-1,-3,4,-1,0,0,1,1,0,1,4,-1
KR_6638732110,420,2,-21,8,-1,1,0,1,2,0,2,-1,4,3,-2,7,5,-1,2,1,0,-1,-3,-2,-2,4,1,0,1,-1,1,1,-1,1,-1
KR_6748043668,420,1,9,-8,4,0,2,2,6,0,6,-4,5,1,2,2,4,0,1,1,0,10,207,1,-6,5,-3,0,0,1,-1,-1,-1,2,-1
KR_6763799412,420,-3,25,-58,3,2,0,2,-2,3,1,3,1,4,-2,4,2,2,2,4,0,-1,2,1,-4,3,-4,0,0,-1,1,0,-1,5,-1
KR_6758892138,420,-1,-30,-3,-3,1,1,2,-5,7,2,1,3,4,0,2,2,0,1,1,0,-7,174,-4,-3,7,32,0,-2,-1,-1,-1,1,3,-1
KR_6764334807,420,1,-57,-23,2,-2,4,2,6,0,6,-1,2,1,-1,2,1,0,2,2,0,9,1,-1,-4,5,1,0,-2,0,-1,-1,-1,0,-1
KR_6751332663,440,-3,-62,6,-6,0,1,1,-1,1,0,-4,5,1,-1,2,1,0,2,2,0,-9,5,-6,-4,10,4,0,0,-1,-1,0,-1,6,-1
KR_6759323433,420,-1,-8,-7,6,-3,3,0,3,1,4,0,3,3,4,1,5,2,0,2,0,7,-9,-5,-2,7,5,0,-1,1,-1,-1,1,6,-1
KR_6768078369,420,-5,-35,-12,-15,-2,3,1,-2,3,1,-10,11,1,-2,5,3,1,3,4,0,-4,1,0,-1,1,1,0,0,0,1,0,1,0,-1
KR_6752601818,420,0,-37,-40,5,2,1,3,-2,4,2,1,2,3,2,1,3,2,0,2,0,3,33,3,-5,2,-2,0,0,-1,-1,0,1,2,-1
KR_6609354430,420,-1,5,-5,-8,1,1,2,1,4,5,-2,3,1,-7,8,1,-1,1,0,0,-14,-3,-2,-3,5,-1,0,1,-1,1,1,-1,3,-1
KR_6741217934,420,-3,-42,-26,1,-2,2,0,1,1,2,3,0,3,0,0,0,-1,1,0,0,3,-3,-4,-1,5,3,0,0,-1,-1,1,-1,3,-1
KR_6763978374,420,0,12,-24,-3,0,3,3,-1,4,3,-1,4,3,0,3,3,-1,1,0,-1,-5,31,5,-9,4,4,0,0,1,-1,0,1,1,-1
KR_6719202966,420,-5,-37,-34,-2,-2,3,1,-4,8,4,-1,3,2,6,1,7,-1,2,1,0,5,5,5,-6,1,1,0,1,-1,1,1,1,1,-1
KR_6719222891,440,0,2,-1,0,2,1,3,-8,9,1,7,1,8,1,4,5,-2,2,0,0,-4,33,-4,-1,5,-17,0,0,1,-1,0,-1,2,-1
KR_6761656987,420,4,101,-16,3,3,2,5,4,0,4,-1,1,0,-4,5,1,1,1,2,0,3,-7,0,-3,3,-1,0,1,1,-1,1,-1,2,-1
KR_6676108549,420,-2,9,4,3,1,1,2,0,1,1,2,1,3,0,4,4,0,1,1,0,6,28,0,-2,2,-1,0,0,-1,1,0,1,2,-1
KR_6642553872,420,3,35,-20,-5,-1,4,3,-2,5,3,0,2,2,-1,4,3,-1,1,0,0,-2,114,-3,-3,6,-2,0,-1,1,-1,-1,1,1,-1
KR_6743602227,420,-5,1,18,-12,-1,3,2,-2,5,3,-8,8,0,0,0,0,-1,2,1,0,-16,6,3,-4,1,-8,0,0,1,-1,0,-1,4,-1
KR_6701889380,420,0,-36,8,2,-1,1,0,1,0,1,6,2,8,-4,5,1,0,0,0,0,-6,11,5,-6,1,-5,0,-2,-1,-1,-1,1,5,-1
KR_6733140495,420,-6,-27,-27,-16,-1,3,2,-5,5,0,-4,6,2,-5,7,2,-1,2,1,1,-21,0,-1,-4,5,-5,0,0,-1,0,-1,1,3,-1
KR_6727311378,420,-2,18,-58,0,3,0,3,-1,1,0,-4,4,0,1,6,7,1,2,3,-1,-8,-10,1,-6,5,-2,0,-1,-1,0,-1,-1,1,-1
KR_6685991513,420,-8,-80,-25,-25,-4,4,0,-4,5,1,-3,5,2,-15,15,0,1,0,1,-1,-28,2,-4,-1,5,-1,0,-3,0,-1,-1,-1,0,-1
KR_6761353838,420,-3,-65,-17,-5,1,0,1,-1,5,4,-2,2,0,-3,5,2,0,1,1,0,0,7,5,-8,3,1,0,0,1,1,0,-1,6,-1
KR_6768507551,420,-3,-16,-24,-5,-6,6,0,0,2,2,0,1,1,2,3,5,-1,1,0,-1,-1,5,-1,-5,6,4,0,0,0,-1,-1,-1,0,-1
KR_6705138676,420,-5,-68,0,-10,-6,6,0,-3,5,2,-1,1,0,2,3,5,-2,2,0,-1,-5,-1,-2,-6,8,3,0,-1,1,-1,-1,-1,1,-1
KR_6735111712,420,1,-52,3,3,1,1,2,-1,1,0,1,1,2,3,1,4,-1,1,0,-1,3,-18,0,-3,3,2,0,-1,0,-1,-1,-1,0,-1
KR_6741537307,420,1,-7,4,-7,-4,5,1,4,3,7,-7,9,2,2,2,4,-2,3,1,-3,-16,19,2,-3,1,1,0,-1,-1,-1,-1,-1,3,-1
KR_6742084664,440,-3,9,15,-12,1,1,2,-4,4,0,-4,5,1,-3,5,2,-2,2,0,0,-21,-6,-1,-4,5,-2,0,-1,0,1,-1,1,0,-1
KR_6743352841,420,-4,-61,-12,-12,2,0,2,-4,7,3,-7,7,0,0,3,3,-3,3,0,0,-15,-3,2,-3,1,1,0,-2,-1,1,-1,1,2,-1
KR_6749359987,420,-2,28,-36,-7,1,3,4,-1,4,3,-4,4,0,-1,3,2,-2,3,1,-1,-2,-6,-2,-4,6,3,0,0,-1,0,0,-1,4,-1
KR_6763675709,420,-1,-18,11,-9,-2,3,1,0,2,2,-4,4,0,-1,2,1,-2,2,0,0,-8,8,2,-4,2,-3,0,0,0,-1,-1,-1,0,-1
KR_6711377069,440,-2,-59,9,-4,1,0,1,-1,1,0,0,4,4,-3,3,0,-1,1,0,0,-3,-66,2,-7,5,5,0,-1,-1,1,-1,1,1,-1
KR_6732493652,440,4,51,6,7,11,0,11,-3,5,2,0,0,0,0,4,4,-1,2,1,0,-1,18,1,-2,1,-1,0,2,1,1,1,1,1,-1
KR_6765646868,420,-4,-100,4,-5,-7,7,0,1,1,2,-1,3,2,-1,3,2,3,1,4,0,2,-1,-1,-3,4,1,0,-1,-1,-1,-1,-1,6,-1
KR_6752324418,420,-2,28,-6,-8,-1,2,1,-6,7,1,0,3,3,-1,1,0,0,0,0,0,-5,4,3,-6,3,-2,0,0,-1,1,0,-1,3,-1
KR_6767526023,420,-4,-47,-37,-7,0,1,1,-5,8,3,-1,3,2,-2,4,2,1,2,3,0,-5,-8,0,-2,2,-1,0,-3,-1,-1,-1,-1,3,-1
KR_6752010306,420,-4,-55,-12,-3,0,1,1,3,2,5,-1,2,1,-3,4,1,-2,4,2,1,4,10,-3,-5,8,-13,0,1,-1,-1,1,1,4,-1
KR_6684058370,420,0,19,14,-8,2,2,4,-7,9,2,2,1,3,1,1,2,-6,6,0,0,-8,6,-1,-3,4,-2,0,0,-1,-1,0,-1,5,-1
KR_6756553317,420,2,-36,-24,6,2,2,4,-2,2,0,0,4,4,6,1,7,0,0,0,0,6,-5,-3,-3,6,1,0,0,1,-1,-1,1,4,-1
KR_6767838471,420,-3,5,14,-3,-3,3,0,1,3,4,-2,6,4,1,1,2,0,2,2,0,11,5,0,-5,5,0,0,0,-1,1,1,-1,1,-1
KR_6609852499,420,-2,-20,-20,-1,0,2,2,2,1,3,5,1,6,-5,7,2,-3,3,0,0,-7,-7,2,-8,6,4,0,0,-1,1,-1,1,3,-1
KR_6715894048,420,0,-62,-5,-2,-5,6,1,4,0,4,3,0,3,-1,3,2,-3,3,0,0,1,-3,-1,-3,4,-1,0,-2,-1,-1,-1,1,2,-1
KR_6764097766,420,-3,-99,-4,-1,0,2,2,2,1,3,-3,4,1,-2,4,2,2,0,2,0,1,0,0,-4,4,-2,0,-1,-1,-1,-1,-1,2,-1
KR_6760866101,420,2,35,-10,2,-1,3,2,-1,3,2,2,3,5,-1,2,1,3,1,4,0,-2,6,-2,-4,6,1,0,2,1,-1,1,1,6,-1
KR_6732645846,420,-2,-37,-24,-7,2,0,2,-6,7,1,0,2,2,-3,5,2,0,1,1,0,-4,66,-4,-4,8,-31,0,-1,-1,1,1,-1,3,-1
KR_6756956161,420,-5,-58,12,-14,-4,6,2,1,2,3,-2,3,1,-8,8,0,-1,1,0,0,-9,-15,1,-6,5,-5,0,-2,-1,1,-1,-1,4,-1
KR_6710177909,420,-1,-42,-28,-4,-6,8,2,-1,4,3,-1,2,1,5,0,5,-1,1,0,-1,-1,-6,-3,-2,5,2,0,-1,-1,-1,-1,-1,3,-1
KR_6765857605,440,-4,-56,3,-7,-3,4,1,2,3,5,-5,5,0,1,2,3,-2,2,0,0,-5,-8,1,-6,5,-3,0,-3,0,-1,-1,1,0,-1
KR_6725626747,440,-5,-9,-16,-13,-2,3,1,-3,5,2,-4,6,2,0,3,3,-4,6,2,0,-10,-6,-1,-2,3,2,0,-1,-1,1,-1,-1,3,-1
KR_6756564654,420,-2,18,12,-3,0,1,1,-5,7,2,0,3,3,3,1,4,-1,1,0,-1,-3,-1,-1,-5,6,1,0,1,0,0,1,-1,0,-1
KR_6638408390,420,5,60,-4,2,-3,3,0,1,1,2,2,0,2,3,0,3,-1,1,0,0,5,5,-1,-4,5,2,0,1,-1,-1,1,-1,1,-1
KR_6743778498,420,1,49,-23,0,6,1,7,-3,4,1,2,2,4,-5,6,1,0,1,1,0,-4,4,2,-3,1,-3,1,2,-1,1,1,1,2,-1
KR_6751731328,420,0,-47,12,-1,2,0,2,0,1,1,5,1,6,-5,5,0,-3,5,2,0,-5,1,-1,-5,6,4,0,-1,0,1,-1,1,0,-1
KR_6761585911,420,-1,22,16,5,-1,2,1,5,2,7,0,3,3,3,0,3,-2,2,0,0,5,-429,3,-5,2,4,0,0,1,1,0,1,1,-1
KR_6662752160,420,-5,-58,12,-12,-2,3,1,0,4,4,-2,2,0,-7,8,1,-1,3,2,0,-14,-25,-8,0,8,1,0,-3,-1,-1,-1,1,6,-1
KR_6752251362,420,-1,-7,-4,0,3,1,4,0,1,1,-1,2,1,0,1,1,-2,2,0,0,-3,-111,-1,-3,4,0,0,1,-1,1,1,1,4,-1
KR_6582633614,420,-3,-35,0,-3,5,0,5,-3,4,1,-2,2,0,-4,4,0,1,0,1,0,-12,-21,-4,-3,7,2,0,1,-1,1,1,1,4,-1
KR_6762488442,420,-2,-28,0,-5,-1,3,2,2,1,3,0,1,1,-5,6,1,-1,1,0,-1,-6,-10,-4,-4,8,6,0,0,-1,-1,-1,-1,3,-1
KR_6641800023,420,0,-50,21,-2,0,1,1,0,5,5,-3,5,2,-2,3,1,3,2,5,0,0,7,2,-7,5,-2,0,0,1,1,0,1,3,-1
KR_6761272651,440,-2,-32,-12,-5,-1,3,2,2,1,3,-2,7,5,-4,4,0,0,0,0,0,-1,-5,1,-3,2,-1,0,-1,-1,-1,-1,1,1,-1
KR_6679310585,420,1,2,-12,-2,0,2,2,3,2,5,-2,3,1,-2,3,1,-1,2,1,0,2,2,-5,-2,7,0,0,0,-1,0,1,-1,3,-1
KR_6762646690,440,-1,-44,-7,-8,1,1,2,0,2,2,3,3,6,-10,11,1,-2,2,0,0,-4,12,3,-7,4,-2,0,-2,1,1,-1,1,6,-1
KR_6703207243,420,1,3,-16,4,4,0,4,-2,4,2,-5,10,5,6,2,8,1,0,1,0,0,-9,-3,-4,7,-3,0,1,-1,1,1,-1,1,-1
KR_6687138812,420,-4,-6,-77,-6,-1,2,1,-7,9,2,1,3,4,-2,3,1,3,1,4,-5,-12,-16,-5,0,5,5,0,0,-1,-1,0,-1,3,-1
KR_6715754601,420,-3,-16,-8,-17,-7,8,1,-2,3,1,-5,6,1,-5,5,0,2,0,2,0,-11,24,-5,-3,8,0,0,-1,-1,-1,-1,-1,4,-1
KR_6760940814,420,-2,-23,-2,4,-1,4,3,2,1,3,0,2,2,3,0,3,0,1,1,1,8,0,3,-6,3,1,0,-1,1,-1,-1,1,6,-1
KR_6591935097,420,-1,-21,5,1,-2,3,1,5,2,7,-2,5,3,0,0,0,0,0,0,0,-4,-8,-4,-2,6,5,0,0,1,-1,-1,1,3,-1
KR_6755542111,420,-3,-39,16,-6,0,2,2,1,5,6,-6,8,2,-1,4,3,0,1,1,2,9,1,2,-7,5,-2,0,-1,-1,0,-1,1,1,-1
KR_6760497504,420,-1,-52,0,1,-1,5,4,2,0,2,1,1,2,0,2,2,-1,1,0,0,3,-6,-1,-1,2,-1,0,0,1,1,-1,-1,6,-1
KR_6755615152,420,-4,-130,-8,-6,-1,3,2,-5,6,1,-1,4,3,-1,2,1,2,0,2,-2,-6,-3,-5,-5,10,-3,0,-1,-1,0,-1,-1,1,-1
KR_6712304587,440,-6,-119,-12,-15,-8,8,0,0,4,4,-5,5,0,-3,5,2,1,0,1,-1,-9,-29,-3,-1,4,0,0,-3,-1,-1,-1,-1,2,-1
KR_6608845600,420,2,15,24,4,-1,2,1,2,1,3,-1,4,3,3,2,5,1,1,2,0,6,8,-3,-2,5,0,0,0,-1,-1,0,-1,3,-1
KR_6739258615,420,0,66,-23,-2,2,1,3,6,2,8,-7,7,0,-4,5,1,1,2,3,0,-18,-2,3,-5,2,-1,0,0,-1,-1,1,-1,5,-1
KR_6759404374,420,-4,-17,-15,-7,1,4,5,-2,3,1,0,2,2,-4,5,1,-2,7,5,0,-12,-20,-6,0,6,1,0,-1,-1,-1,-1,1,4,-1
KR_6742563328,420,-4,4,-20,-7,2,0,2,0,3,3,-4,4,0,-5,5,0,0,0,0,0,-9,48,-3,-1,4,-17,0,0,-1,1,0,-1,6,-1
KR_6610131108,440,-2,15,-5,-6,3,1,4,-4,5,1,-3,5,2,-2,3,1,0,0,0,0,-14,3,1,-7,6,-3,0,-1,1,0,-1,-1,1,-1
KR_6738670348,420,-2,-24,-44,1,1,2,3,3,1,4,-1,5,4,-1,3,2,-1,1,0,0,8,-5,-2,-2,4,3,0,-1,1,-1,-1,-1,2,-1
KR_6727275439,420,0,-3,-12,-4,-1,1,0,-1,2,1,0,3,3,-3,3,0,1,1,2,0,-5,-8,-3,-2,5,2,0,0,-1,-1,0,-1,5,-1
KR_6724060004,420,-2,-29,-36,-1,0,3,3,0,1,1,-2,4,2,-2,3,1,3,0,3,0,-8,-1,0,-7,7,-5,0,-1,-1,-1,-1,1,6,-1
KR_6702309479,420,-3,18,-28,-11,-2,4,2,-3,4,1,-2,4,2,0,2,2,-4,4,0,0,-6,-2,1,-3,2,1,0,0,0,-1,-1,-1,0,-1
KR_6703490426,420,-3,8,-43,-7,-4,5,1,-1,2,1,-3,8,5,2,1,3,-1,2,1,-1,-2,5,1,-5,4,1,0,0,-1,-1,-1,1,2,-1
KR_6746780328,420,0,-24,-7,-3,2,2,4,-2,2,0,-3,4,1,0,2,2,0,2,2,-1,0,-2,-4,-4,8,3,0,-1,0,-1,-1,-1,0,-1
KR_6734316446,420,-5,-6,-44,-7,1,0,1,-2,4,2,-5,5,0,-4,4,0,3,0,3,0,-5,97,-3,-2,5,4,0,0,-1,-1,-1,1,5,-1
KR_6766813677,420,-1,12,-23,4,-1,2,1,0,2,2,10,0,10,-5,5,0,0,0,0,-1,-6,10,3,-5,2,-2,0,0,0,0,0,-1,0,-1
KR_6764786791,420,1,-3,5,3,0,2,2,2,0,2,1,4,5,1,2,3,-1,1,0,0,6,33,-1,-6,7,0,0,0,0,-1,0,1,0,-1
KR_6751662186,420,2,27,-16,6,-1,1,0,1,2,3,-1,4,3,2,2,4,5,0,5,0,6,1,-1,-1,2,2,0,0,1,0,0,1,1,-1
KR_6668638674,420,-3,-9,-29,-6,1,0,1,2,2,4,-4,4,0,-3,6,3,-2,4,2,0,-1,-32,-4,-2,6,1,0,-3,1,1,-1,-1,5,-1
KR_6746844980,420,-2,18,-12,-7,-2,3,1,-3,5,2,0,4,4,-2,3,1,0,1,1,0,-9,-3,-4,-1,5,5,0,0,-1,0,0,-1,3,-1
KR_6757933692,420,-1,-7,23,-3,1,1,2,3,1,4,-4,6,2,-3,4,1,0,2,2,0,-6,5,1,-7,6,2,0,1,-1,1,1,-1,2,-1
KR_6678249762,420,-4,-51,1,-10,-6,6,0,-4,5,1,3,1,4,0,2,2,-3,3,0,0,-11,-46,-1,-4,5,17,0,-2,-1,-1,-1,-1,5,-1
KR_6631181116,420,-3,8,0,-9,-2,3,1,-3,3,0,-5,5,0,0,2,2,1,1,2,0,-4,-7,0,-3,3,-5,0,-1,-1,0,-1,1,5,-1
KR_6672569530,440,-3,-21,-15,-5,2,1,3,-1,6,5,-9,9,0,1,4,5,2,1,3,0,3,45,-2,-1,3,-12,0,-1,1,1,-1,-1,3,-1
KR_6659434230,420,-1,7,-16,-2,-4,4,0,2,5,7,6,0,6,-8,11,3,2,0,2,0,1,-29,-6,-4,10,8,0,-1,0,-1,-1,-1,0,-1
KR_6747198283,420,-2,-34,-23,-11,1,2,3,-2,4,2,-1,1,0,-6,9,3,-3,5,2,0,-17,-298,-2,-4,6,0,0,-3,-1,-1,-1,-1,2,-1
KR_6760546865,420,1,8,-8,-4,-3,3,0,-2,3,1,-2,3,1,2,0,2,1,0,1,0,0,16,3,-4,1,1,0,1,0,-1,1,-1,0,-1
KR_6752206142,420,2,55,8,4,4,2,6,0,4,4,3,3,6,-2,5,3,-1,1,0,-2,-4,-1,0,-7,7,1,0,0,0,1,1,-1,0,-1
KR_6681197669,420,0,22,5,-5,2,0,2,-5,6,1,-1,2,1,3,4,7,-4,6,2,0,-8,-8,-2,-5,7,-1,0,0,-1,1,1,1,2,-1
KR_6643299917,420,2,73,-27,-2,1,2,3,-3,8,5,2,3,5,-1,3,2,-1,2,1,1,-10,-38,0,0,0,2,0,0,-1,-1,-1,1,4,-1
KR_6762546164,420,-1,-136,-17,0,-4,5,1,-3,3,0,10,0,10,-1,2,1,-2,2,0,-2,-1,16,-2,-3,5,2,0,-2,0,-1,-1,-1,0,-1
KR_6703347689,420,-3,61,12,-6,-4,4,0,-1,2,1,-3,4,1,-1,2,1,3,1,4,1,-1,2,1,-5,4,0,0,1,1,-1,-1,1,5,-1
KR_6766821920,420,-1,-19,-28,-6,0,0,0,2,1,3,0,0,0,-7,7,0,-1,1,0,0,-6,1,3,-6,3,-1,0,-1,-1,1,-1,-1,1,-1
KR_6745617251,420,1,24,-10,6,5,2,7,5,1,6,-4,8,4,-1,1,0,1,0,1,-1,8,0,-3,0,3,0,0,0,0,1,1,-1,0,-1
KR_6705234014,440,-1,46,21,-5,3,1,4,0,2,2,-4,6,2,-3,4,1,-1,1,0,1,-8,11,1,-4,3,-4,0,-1,0,-1,-1,1,0,-1
KR_6741965811,440,0,-1,-32,-1,-1,4,3,0,0,0,-1,3,2,2,0,2,-1,2,1,0,-5,-4,-2,0,2,2,0,0,-1,-1,0,-1,3,-1
KR_6717328340,420,-3,-58,0,-9,-4,4,0,-3,5,2,0,2,2,-2,3,1,0,0,0,-1,-15,-6,0,-2,2,-2,0,0,-1,1,1,-1,4,-1
KR_6757717595,420,-1,-34,-36,-7,0,1,1,-1,4,3,0,3,3,-3,4,1,-3,3,0,0,-5,-6,1,-5,4,-2,0,-1,0,-1,-1,-1,0,-1
KR_6741944535,420,-3,-48,24,-9,-2,4,2,-3,8,5,-1,2,1,-2,3,1,-1,1,0,0,-7,-197,4,-5,1,-1,0,0,1,1,0,-1,1,-1
KR_6726812111,420,-1,-2,-24,5,2,2,4,3,1,4,-2,3,1,1,2,3,1,0,1,1,4,343,1,-2,1,-1,0,1,1,1,1,1,2,-1
KR_6751895900,420,1,52,-19,5,4,2,6,-2,4,2,-1,2,1,3,0,3,1,1,2,0,3,11,3,-7,4,-1,0,-1,0,0,-1,1,0,-1
KR_6724094893,420,-4,-78,-7,-12,-2,2,0,0,3,3,-6,9,3,-5,5,0,1,1,2,0,-7,-26,-1,-5,6,-1,0,-1,1,1,-1,-1,5,-1
KR_6764941028,420,-1,41,-6,0,-1,2,1,5,3,8,-1,3,2,-3,4,1,0,2,2,0,-2,9,2,-8,6,-3,0,0,1,1,1,1,4,-1
KR_6762043743,420,0,-26,-7,3,1,1,2,-3,4,1,0,3,3,0,3,3,5,0,5,0,-1,-27,-8,-3,11,4,0,0,1,-1,0,1,3,-1
KR_6742672966,420,1,1,12,-4,1,1,2,6,2,8,-3,5,2,-2,4,2,-6,7,1,0,-7,-15,-2,-3,5,0,0,-1,1,-1,-1,-1,1,-1
KR_6754306516,420,1,41,12,3,-4,4,0,0,2,2,3,0,3,5,0,5,-1,1,0,0,1,2,3,-8,5,3,0,0,1,-1,0,1,3,-1
KR_6695758352,440,1,-27,-16,12,4,1,5,0,6,6,2,1,3,5,0,5,1,3,4,1,20,19,5,-10,5,-2,0,1,1,1,1,-1,1,-1
KR_6745708400,420,-3,76,-24,-5,4,0,4,-4,4,0,2,3,5,-6,6,0,-1,2,1,0,-7,1,0,-2,2,-1,0,-1,1,-1,-1,-1,3,-1
KR_6645227295,420,-8,-148,-48,-7,-3,5,2,2,2,4,-5,6,1,-2,6,4,1,1,2,0,4,186,-2,-2,4,-2,0,-1,-1,-1,-1,-1,5,-1
KR_6597216624,420,0,-54,19,-11,1,1,2,-7,7,0,-1,4,3,-2,3,1,-2,2,0,-1,-10,31,-5,-3,8,-9,0,-2,-1,-1,-1,-1,5,-1
KR_6754802418,420,-1,-23,-17,-2,0,1,1,-2,4,2,1,2,3,-3,6,3,2,2,4,-1,-3,193,0,-3,3,-4,0,0,1,0,0,1,5,-1
KR_6705466260,420,-2,-32,4,-5,1,2,3,-3,3,0,0,1,1,-2,4,2,-1,3,2,-1,-14,2,-2,-2,4,-4,0,-2,-1,1,-1,-1,4,-1
KR_6499439512,420,-3,28,-20,-3,3,0,3,-7,8,1,-2,4,2,3,2,5,0,1,1,0,5,-35,2,-5,3,14,0,0,0,0,0,-1,0,-1
KR_6761559524,420,-3,4,-21,-5,-3,5,2,-2,4,2,1,0,1,1,2,3,-2,4,2,1,-5,-26,1,-7,6,7,0,-1,0,-1,-1,1,0,-1
KR_6488156066,420,-6,-85,28,-15,-7,7,0,-1,2,1,-1,4,3,-4,5,1,-2,3,1,0,-17,93,0,-4,4,1,0,-2,-1,-1,-1,-1,6,-1
KR_6732713839,440,-1,-66,14,0,4,1,5,-1,2,1,1,2,3,-6,6,0,2,0,2,0,1,4,3,-6,3,1,0,0,1,-1,0,-1,5,-1
KR_6764043247,420,-4,-139,-12,-8,-4,4,0,0,1,1,1,0,1,-2,5,3,-3,4,1,0,-5,24,-2,-3,5,-1,0,-2,-1,-1,-1,-1,5,-1
KR_6744537749,420,1,70,29,2,-1,2,1,-2,4,2,0,3,3,4,1,5,1,0,1,0,-4,-28,0,-4,4,2,0,0,-1,-1,1,1,1,-1
KR_6762262227,420,0,-40,31,3,-1,2,1,0,4,4,-3,4,1,3,2,5,4,0,4,0,9,21,2,-7,5,-6,0,0,1,-1,-1,-1,6,-1
KR_6762785271,420,-2,-12,29,-6,-5,5,0,-3,5,2,3,0,3,-2,3,1,1,1,2,0,-5,0,-3,-3,6,0,0,0,-1,-1,0,-1,6,-1
KR_6731818663,420,0,-24,-5,1,-1,3,2,0,4,4,0,2,2,1,5,6,1,2,3,2,11,19,0,-3,3,0,0,0,-1,-1,0,1,4,-1
KR_6656693818,420,-4,-9,-25,-1,0,0,0,-3,6,3,7,0,7,-5,8,3,0,2,2,-1,5,32,-2,-3,5,-2,0,0,1,-1,0,-1,5,-1
KR_6763918701,440,-3,-73,-27,-8,-3,4,1,1,3,4,-1,5,4,-4,7,3,-1,2,1,0,-8,-49,2,-4,2,17,0,-3,-1,0,-1,-1,1,-1
KR_6665151657,420,0,5,12,-1,0,1,1,3,1,4,-4,5,1,-1,4,3,1,1,2,0,1,-4,-4,-2,6,0,0,0,-1,0,0,1,2,-1
KR_6738922752,420,-7,-90,-44,-11,-1,4,3,-2,6,4,-4,4,0,-4,5,1,0,2,2,0,-8,0,1,-4,3,-3,0,-2,-1,0,-1,-1,1,-1
KR_6729804859,420,-4,-65,-6,-5,1,3,4,-1,1,0,-1,3,2,1,0,1,-5,5,0,0,-11,-5,2,-7,5,-4,0,-1,-1,-1,-1,-1,2,-1
KR_6682614147,440,2,32,16,4,0,3,3,1,2,3,3,0,3,-1,5,4,1,1,2,1,5,7,-4,-2,6,-2,0,1,1,-1,1,1,3,-1
KR_6758487295,420,-1,20,-1,-5,1,2,3,-2,2,0,-2,2,0,-3,3,0,1,2,3,0,-11,50,3,-7,4,-18,0,1,-1,1,1,-1,1,-1
KR_6621454603,420,-1,-3,-16,-4,0,0,0,-1,5,4,4,0,4,-5,6,1,-2,2,0,-1,-6,-2,-1,-4,5,-4,0,-3,-1,-1,-1,-1,3,-1
KR_6754568223,420,-1,26,-11,-5,-1,2,1,-4,6,2,0,2,2,-1,2,1,1,3,4,0,-9,104,-5,-3,8,5,0,-1,-1,1,-1,-1,6,-1
KR_6741288280,420,2,44,4,5,3,2,5,2,1,3,4,1,5,-2,4,2,-2,2,0,1,-6,-72,-1,-6,7,-2,0,1,-1,1,1,1,6,-1
KR_6687241825,420,-4,-76,-23,-13,3,0,3,-4,4,0,-1,2,1,-11,11,0,0,3,3,-4,-24,-16,-2,-4,6,-3,0,-3,0,-1,-1,-1,0,-1
KR_6757127258,420,-3,-48,-3,-1,-3,4,1,2,1,3,-6,6,0,3,3,6,3,1,4,1,-1,6,-1,-5,6,1,0,-1,1,1,-1,1,3,-1
KR_6723050342,420,-5,-70,-27,-8,-2,3,1,-4,6,2,1,1,2,-3,5,2,0,0,0,-1,-9,-25,-1,-1,2,0,0,-1,-1,-1,-1,-1,4,-1
KR_6767060267,420,-2,-31,1,-7,0,2,2,2,4,6,-2,2,0,-2,3,1,-5,5,0,-1,-8,-9,-1,-3,4,0,0,-1,1,-1,-1,-1,1,-1
KR_6616469946,420,-1,-65,24,-5,-3,3,0,5,0,5,-7,7,0,2,3,5,-2,5,3,0,1,455,-1,0,1,-15,0,-1,1,-1,-1,1,6,-1
KR_6725877635,420,-3,-107,-20,-3,-7,8,1,-2,5,3,0,1,1,1,1,2,5,0,5,0,12,-14,-4,-1,5,2,0,-2,-1,-1,-1,-1,6,-1
KR_6685090943,420,-2,-37,16,-8,-3,5,2,-2,2,0,0,2,2,-1,4,3,-2,2,0,0,-8,-5,-1,-4,5,-2,0,-1,-1,-1,-1,1,4,-1
KR_6747999144,440,-2,5,-16,-5,-1,1,0,-6,6,0,2,1,3,0,2,2,0,0,0,-1,-8,0,-6,-3,9,1,0,0,-1,-1,0,-1,3,-1
KR_6753967712,420,-4,-31,-20,-2,1,1,2,0,1,1,-2,4,2,-1,4,3,0,1,1,0,5,-5,-1,-6,7,2,0,1,0,1,1,1,0,-1
KR_6713232419,420,-5,-75,-4,-11,-5,6,1,-2,4,2,1,2,3,-4,4,0,-1,1,0,-1,-14,-9,1,-4,3,4,0,-3,-1,1,-1,-1,6,-1
KR_6484910381,420,1,-38,37,1,-1,2,1,2,3,5,0,1,1,0,0,0,0,0,0,0,3,8,1,-5,4,-7,0,0,1,1,-1,1,4,-1
KR_6230984020,420,-4,-93,0,-5,0,1,1,-4,4,0,-2,6,4,0,3,3,1,0,1,0,1,-24,-1,-4,5,28,0,-1,-1,1,-1,-1,4,-1
KR_6762684509,420,-5,-18,-26,-7,1,4,5,-3,3,0,-7,7,0,5,1,6,-3,4,1,0,-1,111,-1,-2,3,4,0,-1,0,-1,-1,1,0,-1
KR_6765253680,420,0,49,-32,1,4,1,5,-7,9,2,2,1,3,1,1,2,1,3,4,0,7,6,0,-3,3,-1,0,0,-1,1,0,1,4,-1
KR_6461013044,420,-2,-27,-4,3,1,2,3,2,1,3,1,4,5,-2,4,2,1,2,3,0,2,-2,0,-4,4,-1,0,0,1,-1,0,-1,3,-1
KR_6674450098,440,-4,-39,-20,-14,-3,3,0,-3,3,0,-4,4,0,0,5,5,-4,4,0,0,-15,7,-1,-4,5,-5,0,0,-1,-1,-1,-1,3,-1
KR_6761166481,420,-2,-55,-12,-8,-2,2,0,-5,5,0,-2,4,2,0,1,1,1,0,1,0,-6,2,0,-3,3,1,0,0,-1,-1,-1,-1,4,-1
KR_6667590008,420,-7,-51,9,-8,-1,1,0,-2,2,0,-1,4,3,-3,3,0,-1,1,0,0,-9,-77,-1,-4,5,-6,0,-1,-1,-1,-1,-1,5,-1
KR_6671734992,420,-1,-44,-8,-13,-2,2,0,-1,2,1,1,3,4,-9,9,0,-2,2,0,0,-15,-3,-1,-3,4,-1,0,-2,-1,-1,-1,-1,2,-1
KR_6762618670,420,-2,-82,20,-3,-1,4,3,1,1,2,4,1,5,-6,7,1,-1,2,1,0,-5,-1,-4,-3,7,2,0,-1,1,0,-1,-1,1,-1
KR_6746811770,420,-1,0,-8,-1,0,2,2,-1,2,1,2,1,3,-5,7,2,3,2,5,0,5,-4,1,-1,0,1,0,-1,-1,1,-1,-1,4,-1
KR_6727635439,440,-1,-7,4,-5,0,2,2,-1,2,1,-6,6,0,-2,4,2,4,0,4,0,0,14,2,-7,5,-7,0,0,1,0,-1,-1,5,-1
KR_6763180284,440,-1,-22,-24,-4,1,0,1,-3,6,3,0,1,1,0,1,1,-2,5,3,-1,-1,3,-2,-5,7,-1,0,0,1,-1,0,-1,5,-1
KR_6720254124,420,1,-37,12,-1,2,0,2,-3,3,0,1,2,3,-3,7,4,2,3,5,0,-6,4,3,-8,5,0,0,-1,0,-1,-1,-1,0,-1
KR_6683891167,420,-7,-108,-76,-5,0,4,4,2,1,3,-3,3,0,-4,6,2,0,1,1,-1,-1,-7,-3,-5,8,2,0,-1,-1,1,-1,-1,5,-1
KR_6637658174,420,3,53,37,5,6,2,8,1,4,5,-4,5,1,2,0,2,0,2,2,0,0,-3,-3,-1,4,1,0,3,1,1,1,1,3,-1
KR_6683163762,420,-2,-23,-12,-1,-3,3,0,2,2,4,-5,8,3,5,0,5,0,0,0,0,8,3,-2,-1,3,2,0,0,1,-1,1,1,6,-1
KR_6755599285,420,1,15,12,1,-5,5,0,0,5,5,3,0,3,0,3,3,3,0,3,0,8,8,5,-6,1,-4,0,1,-1,1,1,1,6,-1
KR_6517154034,420,1,-4,20,4,-4,4,0,8,1,9,4,0,4,-2,3,1,-2,2,0,0,3,-1,-1,-5,6,-1,0,-1,1,-1,-1,1,4,-1
KR_6719193613,440,-5,-42,-45,-5,0,4,4,-3,4,1,-5,6,1,3,1,4,0,0,0,0,-6,6,-3,-3,6,-1,0,-1,-1,-1,-1,-1,1,-1
KR_6765634815,420,-1,25,-41,4,-1,3,2,-1,2,1,-5,5,0,11,1,12,0,0,0,0,8,-9,-8,-2,10,-1,0,0,-1,0,-1,1,5,-1
KR_6749873606,420,-7,-67,0,-16,0,3,3,-2,2,0,-4,4,0,-9,9,0,-1,2,1,0,-20,-48,-3,-2,5,19,0,-3,-1,-1,-1,1,5,-1
KR_6748696695,420,-2,-6,-28,-12,2,1,3,-6,6,0,0,1,1,-3,3,0,-5,5,0,-2,-19,-16,-3,-2,5,4,0,-1,-1,-1,-1,-1,4,-1
KR_6762874160,420,-5,-36,-11,-8,-1,2,1,0,2,2,-2,5,3,-4,6,2,-1,2,1,0,-1,5,0,-4,4,-3,0,0,1,-1,0,-1,5,-1
KR_6766502546,420,-2,-45,21,-4,-1,2,1,2,1,3,-1,2,1,-4,4,0,0,0,0,0,-6,-248,2,-9,7,-3,0,-1,-1,1,-1,-1,5,-1
KR_6745927688,420,3,4,5,-1,0,0,0,-3,3,0,1,3,4,-2,3,1,3,0,3,0,-3,2,3,-6,3,-1,0,0,0,-1,0,-1,0,-1
KR_6743695175,420,1,41,-20,-3,1,3,4,2,2,4,-2,3,1,-2,3,1,-2,3,1,-1,-9,-5,-1,-4,5,-3,0,0,-1,0,0,-1,6,-1
KR_6766139817,420,-4,-19,-26,-8,0,4,4,4,0,4,-1,2,1,-13,13,0,2,0,2,0,-7,5,2,-4,2,0,0,0,0,-1,-1,-1,0,-1
KR_6759088233,420,-4,-27,8,-10,-7,7,0,1,1,2,-1,1,0,-1,3,2,-2,3,1,0,-1,-5,-1,-1,2,0,0,-1,-1,-1,-1,-1,5,-1
KR_6740302120,420,1,11,24,-1,-1,2,1,-1,5,4,-2,3,1,2,1,3,1,2,3,0,9,105,2,-4,2,2,0,0,-1,1,0,-1,3,-1
KR_6764981528,420,-3,-24,15,-6,3,4,7,3,0,3,-5,5,0,-5,6,1,-2,2,0,0,-7,8,5,-7,2,-6,0,-1,1,1,-1,1,5,-1
KR_6740238623,420,0,1,21,1,-2,3,1,-1,1,0,-3,6,3,7,2,9,0,0,0,0,5,-6,1,-7,6,-2,0,-2,0,-1,-1,-1,0,-1
KR_6733231329,420,-1,33,-44,-2,3,2,5,-4,5,1,2,3,5,-1,1,0,-2,3,1,-1,-7,8,1,-5,4,-3,0,-1,-1,1,-1,-1,1,-1
KR_6760729713,420,0,-16,7,-4,-2,2,0,4,2,6,-5,5,0,-2,6,4,1,4,5,0,4,13,2,-5,3,-3,0,0,-1,-1,-1,-1,4,-1
KR_6764867032,420,4,-41,0,10,0,1,1,5,1,6,2,4,6,3,2,5,0,1,1,0,24,1,2,-4,2,-2,0,-1,1,-1,-1,1,4,-1
KR_6764580647,420,0,-6,8,1,-3,4,1,3,1,4,0,1,1,0,3,3,1,0,1,0,4,5,2,-5,3,-3,0,0,0,-1,-1,-1,0,-1
KR_6647788474,420,-5,-6,-8,-8,-2,2,0,1,2,3,-4,5,1,-3,4,1,0,0,0,0,-6,2,-6,-2,8,-1,0,0,-1,1,0,1,3,-1
KR_6688967898,420,0,28,-29,6,1,1,2,0,3,3,4,1,5,2,1,3,-1,1,0,0,2,2,-3,-3,6,-1,0,0,-1,1,0,1,1,-1
KR_6739856104,440,-5,-104,-36,-12,-5,6,1,-5,5,0,-2,4,2,0,2,2,0,0,0,0,-5,3,1,-4,3,2,0,-1,-1,-1,-1,-1,3,-1
KR_6709401685,420,-1,85,1,-1,-1,3,2,-3,4,1,4,2,6,-2,2,0,1,2,3,0,-7,-12,-3,-3,6,4,0,1,-1,-1,-1,1,4,-1
KR_6726267618,420,-3,-15,-3,-12,-5,5,0,-4,6,2,2,0,2,-3,9,6,-2,4,2,0,-10,0,1,-4,3,6,0,-2,-1,-1,-1,-1,5,-1
KR_6766893940,420,-3,-44,8,-5,0,1,1,0,2,2,-2,2,0,0,1,1,-3,3,0,0,-2,-116,1,-4,3,-3,0,-1,1,1,-1,1,3,-1
KR_6743245620,420,-2,-30,-12,-4,-1,1,0,-3,4,1,-3,4,1,3,0,3,0,2,2,1,0,-135,-2,-3,5,-1,0,-1,-1,-1,-1,1,4,-1
KR_6694440544,420,-3,-30,-12,-6,0,0,0,2,2,4,-4,4,0,-4,7,3,0,0,0,0,-4,-6,-4,-4,8,0,0,-1,-1,-1,-1,-1,3,-1
KR_6742917954,420,-3,-81,-5,-4,0,0,0,-1,4,3,-1,1,0,-1,2,1,-1,1,0,0,0,-12,-1,-4,5,1,0,-1,1,-1,-1,1,3,-1
KR_6722134556,420,-3,-20,-26,-7,0,3,3,-3,4,1,-6,7,1,1,2,3,1,2,3,1,-6,3,-1,-4,5,-3,0,0,-1,-1,0,1,2,-1
KR_6702582233,420,0,50,12,0,0,1,1,3,1,4,1,1,2,-5,6,1,1,1,2,0,-6,-3,1,-4,3,-2,0,1,1,1,1,1,6,-1
KR_6634010546,420,-5,46,-21,-9,2,0,2,-6,8,2,-3,3,0,-1,3,2,-1,1,0,0,-12,1,1,-8,7,0,0,0,-1,-1,0,-1,2,-1
KR_6760791023,420,-3,-88,-20,-1,-1,2,1,5,1,6,1,1,2,-3,5,2,-3,6,3,1,1,-4,1,-6,5,-6,0,-1,1,1,-1,1,3,-1
KR_6746693979,420,2,26,-5,4,1,1,2,-1,3,2,3,0,3,4,2,6,-3,4,1,0,0,2,2,-5,3,-2,0,1,1,1,1,1,3,-1
KR_6763233724,440,-1,-41,-8,-2,-3,6,3,2,3,5,2,0,2,-1,3,2,-2,2,0,0,7,98,0,-3,3,-3,0,-1,1,-1,-1,1,5,-1
KR_6761472192,420,-1,0,-4,2,1,0,1,1,1,2,-1,2,1,2,2,4,-1,1,0,0,0,70,2,-5,3,5,0,0,-1,0,0,1,5,-1
KR_6765590306,420,-3,-14,-4,-7,-1,3,2,-1,3,2,0,2,2,-3,5,2,-2,3,1,0,1,0,5,-6,1,-2,0,0,0,1,0,-1,0,-1
KR_6761058679,420,1,9,0,7,-1,2,1,-3,4,1,3,5,8,6,0,6,2,0,2,0,6,3,5,-9,4,2,0,3,1,1,1,1,5,-1
KR_6636429920,420,-2,67,-56,-5,2,2,4,1,1,2,-2,3,1,-2,3,1,-4,4,0,0,-4,2,-2,-5,7,-2,0,-1,1,-1,-1,1,5,-1
KR_6729380834,420,0,-82,-8,-6,-9,9,0,0,4,4,1,4,5,0,6,6,2,1,3,-1,-6,41,-1,-4,5,-28,0,0,-1,-1,-1,-1,2,-1
KR_6692175859,420,1,-17,40,1,-1,3,2,-2,5,3,2,1,3,2,1,3,0,0,0,0,-4,-38,6,-7,1,6,0,0,1,-1,0,-1,3,-1
KR_6650334599,420,-2,-69,-16,-6,-5,6,1,-1,1,0,3,1,4,-2,4,2,-1,2,1,0,-1,-29,1,-5,4,-5,0,-2,-1,-1,-1,-1,3,-1
KR_6761777213,420,1,-18,18,-1,-3,3,0,-2,2,0,0,1,1,3,1,4,1,1,2,0,-2,23,2,-6,4,-6,0,0,0,1,-1,-1,0,-1
KR_6746577999,420,0,23,-38,8,-1,1,0,-1,3,2,0,0,0,7,2,9,3,0,3,0,13,-1,0,-8,8,1,0,1,-1,1,1,1,1,-1
KR_6761663726,420,-2,7,-4,-7,0,2,2,-1,2,1,-4,6,2,2,3,5,-4,4,0,-1,-6,-2,-3,-2,5,-1,0,0,0,-1,-1,1,0,-1
KR_6755069870,420,-2,-58,-8,-5,-10,11,1,0,1,1,2,3,5,-1,3,2,4,0,4,0,9,0,-1,-1,2,1,0,-1,-1,-1,-1,1,6,-1
KR_6745960299,420,-4,-96,-15,-9,-6,6,0,-5,7,2,0,1,1,0,2,2,2,0,2,0,-1,-2,0,-4,4,-2,0,0,0,0,-1,-1,0,-1
KR_6728364751,420,-2,-33,-20,-4,-2,5,3,1,5,6,-1,2,1,-1,3,2,-1,3,2,0,-9,402,0,-4,4,-3,0,-1,1,-1,-1,1,3,-1
KR_6767186334,420,-3,-4,-15,-8,4,0,4,-1,4,3,-3,7,4,-7,7,0,-1,1,0,-2,-14,-5,-5,-5,10,0,0,-1,-1,-1,-1,-1,3,-1
KR_6761788578,420,0,-19,19,-3,1,0,1,0,1,1,7,0,7,-11,12,1,0,2,2,0,-8,-3,-4,-3,7,2,0,1,1,1,-1,1,3,-1
KR_6735034126,420,-4,-46,0,-5,1,2,3,0,2,2,-1,3,2,-4,6,2,-1,2,1,0,-5,27,0,-6,6,1,0,0,-1,-1,-1,-1,4,-1
KR_6755674673,420,-1,-52,8,-12,0,3,3,-9,9,0,-2,5,3,-1,8,7,0,2,2,1,-14,-24,-1,-2,3,1,0,-3,-1,1,-1,-1,2,-1
KR_6766991937,420,-5,1,-4,-12,-4,4,0,2,0,2,-1,3,2,-1,5,4,-8,9,1,0,-14,-1,0,-4,4,-2,0,-2,-1,1,-1,1,2,-1
KR_6598224293,440,-2,-52,-20,-2,1,2,3,-1,1,0,1,2,3,-2,2,0,-1,1,0,0,-5,0,5,-6,1,-4,0,0,-1,1,-1,-1,3,-1
KR_6761311577,440,1,-42,70,-1,0,2,2,-2,6,4,1,2,3,-2,3,1,2,1,3,0,-7,0,1,-5,4,-2,0,-1,-1,1,-1,-1,4,-1
KR_6735243857,440,2,-12,-12,3,3,1,4,0,1,1,-3,4,1,4,4,8,-1,2,1,0,6,-6,3,-6,3,6,0,0,-1,-1,-1,1,5,-1
KR_6768403927,420,1,8,4,4,6,2,8,1,2,3,1,1,2,-4,4,0,0,0,0,-1,-1,4,0,-1,1,1,0,-1,-1,1,-1,-1,4,-1
KR_6725394878,420,-6,-56,-47,-18,-10,10,0,-1,2,1,-1,2,1,-1,5,4,-5,5,0,-1,-11,-11,-2,-2,4,4,0,-1,-1,-1,-1,-1,5,-1
KR_6728664666,420,-3,40,13,-4,-3,3,0,-3,3,0,3,2,5,0,2,2,-1,2,1,0,-5,-2,1,-5,4,-4,0,0,1,0,0,-1,4,-1
KR_6650672616,420,0,-31,-9,-4,-2,3,1,2,1,3,-5,5,0,2,0,2,-1,3,2,0,-2,4,1,-4,3,-3,0,0,-1,1,0,-1,1,-1
KR_6741706089,420,-3,-6,-5,-8,-1,1,0,0,2,2,-1,5,4,-3,3,0,-3,3,0,0,-13,-12,-4,-2,6,0,0,-1,-1,1,-1,-1,3,-1
KR_6596682086,420,1,-28,19,4,0,0,0,4,1,5,0,2,2,1,0,1,-1,1,0,0,0,44,0,-6,6,-28,0,0,1,1,0,1,3,-1
KR_6757880482,420,-2,-61,10,-4,-2,4,2,0,4,4,0,3,3,0,0,0,-2,3,1,-1,-3,26,1,-4,3,-1,0,-1,-1,-1,-1,-1,2,-1
KR_6723212397,420,-7,-92,-22,-16,-2,3,1,-9,9,0,2,2,4,-7,9,2,0,1,1,0,-7,-10,-3,-3,6,-2,0,-2,-1,-1,-1,-1,2,-1
KR_6714553054,420,-2,28,-35,-6,3,2,5,-5,8,3,4,1,5,-6,8,2,-2,2,0,0,-5,7,0,-3,3,0,0,-1,1,-1,-1,-1,2,-1
KR_6765464982,420,-1,-30,-16,2,1,1,2,1,3,4,-5,5,0,2,2,4,3,0,3,0,12,-7,-2,-1,3,-1,0,0,-1,1,0,1,4,-1
KR_6756780353,420,-2,-102,-13,0,-3,4,1,2,2,4,3,1,4,-1,3,2,-1,1,0,0,3,4,0,-5,5,-4,0,0,-1,-1,-1,-1,3,-1
KR_6635149770,420,2,-9,8,-2,2,2,4,0,3,3,-2,4,2,0,3,3,-2,2,0,0,4,-7,-4,-4,8,0,0,0,-1,1,1,-1,1,-1
KR_6726527465,420,-7,-110,-27,-14,-6,7,1,0,0,0,-6,7,1,-1,3,2,-1,1,0,1,-6,-13,-1,-2,3,1,0,-2,-1,-1,-1,1,4,-1
KR_6744982799,420,4,41,0,6,1,0,1,1,5,6,1,3,4,1,1,2,2,1,3,0,3,-5,0,-3,3,1,0,1,1,1,1,1,6,-1
KR_6760716285,420,-10,-191,7,-15,-3,4,1,0,1,1,-4,5,1,-8,8,0,0,2,2,0,-9,-58,-3,0,3,-1,0,-4,-1,-1,-1,-1,3,-1
KR_6767542550,420,0,-78,-4,-4,-2,3,1,-1,4,3,2,2,4,-4,8,4,1,0,1,0,-1,-226,0,-5,5,0,0,-2,1,-1,-1,-1,1,-1
KR_6727737385,420,-1,-72,3,3,4,0,4,1,2,3,-1,2,1,1,3,4,-2,2,0,0,3,21,3,-9,6,-2,0,1,-1,1,1,1,4,-1
KR_6759831600,420,-2,-49,-4,0,4,0,4,-1,4,3,2,2,4,-5,6,1,0,0,0,0,-7,16,-2,-3,5,2,0,1,-1,1,1,-1,1,-1
KR_6745902476,420,-2,23,8,-6,-1,1,0,-1,4,3,2,1,3,-4,5,1,-2,2,0,0,-10,-3,1,-5,4,1,0,0,0,0,0,-1,0,-1
KR_6748612179,420,2,6,24,0,1,0,1,0,3,3,-1,1,0,1,5,6,-1,2,1,0,5,-38,1,-4,3,17,0,-1,0,-1,-1,-1,0,-1
KR_6761659583,440,-3,-37,20,-5,0,0,0,-6,8,2,0,4,4,1,3,4,0,1,1,0,-13,1,-2,-1,3,-4,0,0,-1,0,-1,1,4,-1
KR_6720306536,420,-2,-17,32,-6,1,2,3,0,2,2,0,2,2,-6,9,3,-1,3,2,0,-16,2,-2,-4,6,0,0,-1,-1,-1,-1,1,4,-1
KR_6723598354,420,-2,-34,-37,-6,-2,2,0,0,1,1,-4,4,0,-2,2,0,2,0,2,0,-1,181,-1,-2,3,-3,0,-1,-1,1,-1,-1,2,-1
KR_6615536381,420,0,-16,24,0,-5,6,1,5,0,5,-2,4,2,3,0,3,-1,2,1,-2,4,4,2,-6,4,3,0,0,1,-1,0,-1,1,-1
KR_6728851279,420,-3,-28,-4,4,-6,7,1,5,2,7,5,0,5,2,3,5,-2,2,0,0,16,0,2,-6,4,2,0,0,1,-1,-1,1,6,-1
KR_6671221273,420,-3,2,-14,-3,3,1,4,-1,4,3,-1,2,1,-1,4,3,-3,5,2,0,8,13,-1,-3,4,-1,0,0,0,-1,-1,-1,0,-1
KR_6731823089,420,3,41,26,9,-1,5,4,0,2,2,1,0,1,8,0,8,1,0,1,1,11,29,4,-6,2,1,0,2,1,1,1,1,1,-1
KR_6750053298,420,-5,-66,-15,-4,2,0,2,-2,3,1,-3,4,1,-1,3,2,0,1,1,0,1,-8,-3,-1,4,1,0,-1,-1,1,-1,-1,1,-1
KR_6755348045,420,2,20,16,2,-6,7,1,4,2,6,-1,1,0,4,1,5,1,2,3,-1,1,-6,-2,-2,4,4,0,-2,-1,-1,-1,-1,2,-1
KR_6744002488,420,0,-56,6,1,-2,3,1,-1,2,1,1,2,3,2,0,2,1,3,4,0,5,-428,1,-5,4,-6,0,0,-1,-1,-1,-1,4,-1
KR_6682251822,420,-4,-33,-9,-4,1,2,3,-2,3,1,-3,3,0,-1,2,1,1,0,1,-1,-2,10,2,-5,3,-1,0,0,1,1,0,-1,1,-1
KR_6729571139,420,2,40,-4,8,-2,3,1,2,0,2,6,1,7,1,1,2,1,0,1,1,4,3,9,-12,3,-1,0,0,1,1,0,1,6,-1
KR_6698977274,420,-7,-44,-39,0,0,2,2,2,4,6,-8,10,2,4,2,6,2,0,2,3,6,1,-2,-6,8,-6,0,-3,1,-1,-1,1,4,-1
KR_6757509591,420,2,-52,14,1,1,0,1,-3,8,5,0,1,1,3,5,8,0,1,1,0,-2,-293,-3,-1,4,-1,0,-1,-1,-1,-1,1,1,-1
KR_6756144108,420,-1,3,1,-9,3,1,4,-4,5,1,-6,7,1,-3,5,2,1,0,1,0,-13,2,-1,0,1,-4,0,1,1,-1,1,1,4,-1
KR_6730770083,420,-2,-8,12,-5,3,0,3,-1,2,1,-2,2,0,-3,5,2,-2,2,0,0,-12,0,-1,-4,5,-3,0,-1,-1,1,-1,-1,6,-1
KR_6555701785,420,3,58,28,5,-2,2,0,-1,1,0,7,2,9,-2,3,1,3,1,4,0,3,9,3,-7,4,-1,0,1,0,1,1,1,0,-1
KR_6655555352,420,0,2,16,-7,-3,4,1,-1,3,2,0,4,4,-3,4,1,0,1,1,-1,-16,36,-3,-3,6,-18,0,0,1,0,1,-1,4,-1
KR_6748723905,420,-6,-80,-28,-12,-1,1,0,-2,3,1,-1,1,0,-8,10,2,0,0,0,0,-11,2,-1,-7,8,-4,0,-1,-1,-1,-1,-1,3,-1
KR_6742021350,440,-1,-65,11,-4,0,1,1,-2,2,0,0,3,3,-2,2,0,0,0,0,0,-10,-3,-3,-3,6,0,0,0,-1,1,0,-1,4,-1
KR_6719150774,440,-2,-36,-16,-1,2,0,2,2,0,2,4,2,6,-7,9,2,-2,2,0,0,-4,320,-3,-3,6,4,0,-1,0,0,-1,1,0,-1
KR_6664585888,440,-2,-26,40,-6,2,0,2,-1,4,3,0,0,0,-2,4,2,-5,7,2,0,-10,4,3,-8,5,-2,0,-1,1,1,-1,-1,6,-1
KR_6525283862,420,-4,7,-4,-12,-3,4,1,-4,5,1,-2,5,3,-3,4,1,0,0,0,0,-7,13,-3,-1,4,-2,0,0,-1,-1,-1,-1,3,-1
KR_6670598947,420,3,4,-28,6,5,0,5,-4,6,2,5,1,6,-1,4,3,1,1,2,-1,5,-16,1,-3,2,4,0,0,-1,-1,-1,-1,3,-1
KR_6645003422,420,-5,-50,-39,-14,-2,2,0,-7,9,2,-3,7,4,-1,1,0,-1,2,1,-1,-18,-14,-4,-3,7,7,0,-2,-1,-1,-1,-1,2,-1
KR_6758490618,420,-2,5,-5,-2,3,1,4,3,2,5,-2,3,1,-2,3,1,-4,5,1,0,-9,2,1,-5,4,-5,0,-1,-1,1,-1,-1,3,-1
KR_6631701661,420,-2,11,-6,-3,1,2,3,3,2,5,-3,6,3,-7,7,0,3,0,3,0,-2,-1,4,-8,4,3,0,-1,-1,-1,-1,1,5,-1
KR_6767094983,420,2,-25,44,2,-1,1,0,0,3,3,3,2,5,-2,6,4,2,0,2,0,2,46,0,-4,4,-20,0,1,1,-1,1,1,5,-1
KR_6738553268,420,2,32,10,8,-2,4,2,-2,4,2,4,0,4,7,1,8,1,2,3,0,10,-14,1,-3,2,4,0,1,1,0,1,1,6,-1
KR_6733150504,420,-6,-81,-16,-12,-4,4,0,-1,3,2,-6,6,0,0,0,0,-1,1,0,0,-4,22,-3,-2,5,-3,0,0,-1,-1,-1,-1,6,-1
KR_6755563411,420,-5,-63,-25,-11,-2,2,0,-5,8,3,-3,4,1,-1,1,0,0,0,0,0,-5,3,1,-4,3,-3,0,-2,-1,-1,-1,-1,5,-1
KR_6729494648,440,-5,-26,11,-10,-2,3,1,0,2,2,-2,3,1,-4,4,0,-2,2,0,0,-16,5,1,-7,6,0,0,-1,-1,1,-1,1,1,-1
KR_6753574937,420,-4,-71,4,-10,-1,3,2,-3,5,2,2,3,5,-2,3,1,-6,6,0,0,-12,5,-3,-1,4,-1,0,-1,0,-1,-1,-1,0,-1
KR_6761142544,440,-1,-81,-17,4,0,0,0,-1,3,2,2,1,3,4,1,5,-1,2,1,0,12,1,1,-5,4,1,0,0,1,-1,0,-1,5,-1
KR_6767408412,420,-2,-54,13,-5,1,1,2,-4,10,6,-2,3,1,0,1,1,0,1,1,0,-11,-11,-3,-6,9,-4,0,0,-1,1,0,1,3,-1
KR_6757054385,440,-9,-98,-23,-23,-8,8,0,-3,4,1,-1,2,1,-4,6,2,-7,8,1,-2,-18,28,-3,-4,7,2,0,-2,-1,1,-1,-1,5,-1
KR_6691821828,420,-1,-39,15,-5,-5,5,0,0,3,3,-1,3,2,0,1,1,1,0,1,0,-6,-5,-2,-2,4,2,0,-1,-1,1,-1,1,1,-1
KR_6762486452,440,-3,-68,-29,-2,2,0,2,-4,5,1,1,1,2,-1,1,0,0,4,4,-1,6,-5,1,-2,1,5,0,0,0,-1,-1,-1,0,-1
KR_6085595238,420,1,16,-17,-7,4,1,5,3,1,4,-1,1,0,-12,12,0,-1,1,0,0,-5,17,1,-5,4,-1,0,0,1,-1,0,-1,4,-1
KR_6711433650,440,2,-29,-6,-4,0,1,1,-4,6,2,-2,4,2,1,1,2,1,2,3,0,-8,56,2,-5,3,25,0,0,-1,1,-1,-1,5,-1
KR_6682417959,440,-2,-7,-40,-1,-7,7,0,0,4,4,4,1,5,0,2,2,2,0,2,1,5,-8,-3,-1,4,0,0,-1,-1,0,-1,1,1,-1
KR_6711197288,420,3,25,-70,3,-2,3,1,1,2,3,3,0,3,1,0,1,0,2,2,0,4,71,0,-2,2,1,0,0,1,-1,1,-1,4,-1
KR_6761268496,420,2,26,4,3,3,1,4,2,1,3,-3,4,1,0,0,0,1,0,1,0,-1,-15,-2,-2,4,1,0,0,1,-1,0,-1,3,-1
KR_6737629634,420,-3,-66,-55,-6,-3,5,2,0,0,0,3,3,6,-5,8,3,-1,1,0,-1,-3,34,-3,-4,7,-2,0,-2,-1,-1,-1,-1,1,-1
KR_6755971012,420,-5,-139,0,-14,-6,7,1,-4,4,0,-1,2,1,1,1,2,-4,5,1,0,-7,-90,-1,-5,6,-5,0,0,-1,-1,-1,-1,4,-1
KR_6704763514,420,2,1,-15,-1,-2,3,1,-3,4,1,-1,2,1,2,3,5,3,0,3,0,3,-32,-3,-5,8,2,0,0,1,-1,0,-1,4,-1
KR_6643750087,420,-5,-96,0,-9,-5,5,0,1,2,3,-2,3,1,-4,5,1,1,0,1,0,-3,1,3,-8,5,-4,0,-1,-1,-1,-1,-1,1,-1
KR_6716567249,440,-4,-101,-32,-8,-6,6,0,0,2,2,-1,3,2,1,2,3,-2,2,0,0,0,2,-2,-1,3,-1,0,-2,1,0,-1,1,5,-1
KR_6718264563,420,0,2,-12,-3,2,1,3,0,1,1,0,2,2,-2,2,0,-3,3,0,0,-13,10,-2,-3,5,-4,0,1,-1,1,1,-1,4,-1
KR_6766599182,420,2,38,-10,1,-2,4,2,-2,3,1,11,1,12,-6,8,2,0,2,2,-1,4,3,3,-6,3,2,0,0,0,-1,-1,-1,0,-1
KR_6724137607,420,-5,-72,-32,-2,0,1,1,-1,5,4,-1,3,2,0,1,1,0,1,1,0,0,-4,4,-10,6,-4,0,0,-1,-1,-1,1,2,-1
KR_6754251055,420,0,-73,0,0,-2,2,0,-1,3,2,0,2,2,0,3,3,3,0,3,0,6,-8,-2,-1,3,0,0,1,-1,-1,-1,1,2,-1
KR_6740033208,420,-3,-41,-40,-11,-9,9,0,1,4,5,0,2,2,0,1,1,-3,4,1,-1,0,-1,-1,-1,2,1,0,0,-1,-1,-1,-1,4,-1
KR_6740600927,420,-8,-65,-24,-20,-9,9,0,-8,8,0,-1,3,2,0,1,1,-2,3,1,-2,-23,0,0,-6,6,-1,0,-3,1,-1,-1,-1,1,-1
KR_6700905899,420,3,-22,7,4,-2,3,1,5,2,7,1,2,3,1,0,1,-1,1,0,0,-2,-5,-1,-5,6,7,0,-2,-1,-1,-1,1,2,-1
KR_6713783813,420,-3,-8,0,-6,-1,1,0,-2,2,0,-2,4,2,-1,1,0,0,0,0,0,-6,5,1,-7,6,14,0,0,-1,1,0,1,1,-1
KR_6764686251,420,-1,-68,12,1,-1,2,1,1,3,4,1,1,2,-3,5,2,3,0,3,-1,-2,-14,-4,-2,6,2,0,-1,1,0,-1,-1,5,-1
KR_6636080203,420,-2,-60,-8,2,0,1,1,1,0,1,5,1,6,-3,4,1,-1,2,1,0,14,5,1,-2,1,-2,0,-2,-1,-1,-1,-1,5,-1
KR_6749965327,420,-2,-53,-1,-1,-1,1,0,5,2,7,0,1,1,-5,6,1,0,2,2,0,3,-24,-1,-4,5,0,0,-1,1,-1,-1,-1,4,-1
KR_6638270148,440,-2,-74,-18,-3,-4,5,1,-5,8,3,3,3,6,5,3,8,-2,2,0,0,1,-3,2,-5,3,3,0,0,-1,1,0,-1,3,-1
KR_6669344999,420,0,45,-18,-3,-1,2,1,-2,4,2,-2,2,0,-1,4,3,3,2,5,0,-1,108,-1,-4,5,3,0,-1,-1,1,-1,-1,1,-1
KR_6757142219,420,5,90,-24,7,0,1,1,1,1,2,4,1,5,0,3,3,2,0,2,0,6,90,3,-6,3,-1,0,2,0,1,1,1,0,-1
KR_6704442622,420,-5,-76,16,-21,-2,2,0,-2,5,3,-4,5,1,-10,11,1,-3,3,0,0,-21,-15,-1,-4,5,-1,0,-1,0,0,-1,-1,0,-1
KR_6760205379,420,0,-3,-24,-4,-3,3,0,1,1,2,0,3,3,-2,3,1,0,4,4,0,0,-116,1,-2,1,0,0,-1,-1,-1,-1,-1,4,-1
KR_6735032715,420,-1,11,0,4,0,2,2,-1,2,1,1,2,3,5,0,5,-1,1,0,0,5,-8,-4,-2,6,4,0,0,1,0,0,1,6,-1
KR_6725046775,440,1,-3,0,1,-1,3,2,2,1,3,1,1,2,-1,4,3,0,0,0,0,-4,-4,-1,-4,5,4,0,1,-1,1,1,1,4,-1
KR_6724886584,420,-2,-15,9,-1,1,0,1,1,2,3,-1,3,2,-2,2,0,0,1,1,0,2,-2,-3,-2,5,-3,0,0,1,0,0,1,3,-1
KR_6738114371,420,-5,-65,4,-5,-2,2,0,5,1,6,-2,3,1,1,2,3,-7,8,1,0,-4,-21,1,-6,5,7,0,-1,1,-1,-1,-1,2,-1
KR_6752389830,420,-3,-4,0,-4,-1,4,3,0,3,3,-5,6,1,1,2,3,1,0,1,0,-7,12,4,-4,0,-1,0,-1,1,-1,-1,-1,6,-1
KR_6671807443,420,1,10,6,-4,-3,3,0,0,2,2,-1,4,3,0,2,2,0,4,4,-1,-2,2,-1,-3,4,5,0,-1,-1,-1,-1,-1,1,-1
KR_6756609592,420,4,36,27,2,1,1,2,1,3,4,0,1,1,0,2,2,0,1,1,0,-1,135,-3,-5,8,-1,0,0,1,1,0,-1,5,-1
KR_6734394529,440,-4,-83,-20,-8,-1,3,2,0,1,1,0,2,2,-7,7,0,0,1,1,0,-10,-10,-5,-2,7,-1,0,0,-1,-1,0,1,1,-1
KR_6759017563,420,3,69,24,-1,1,2,3,-1,4,3,-1,3,2,-1,7,6,1,0,1,-1,-4,0,3,-6,3,1,0,1,1,1,1,-1,2,-1
KR_6767522604,420,-1,14,-4,-8,3,0,3,0,2,2,-5,6,1,-5,6,1,-1,1,0,-1,-7,-3,-1,-6,7,-6,0,-1,1,-1,-1,-1,4,-1
KR_6721152957,420,-2,-68,-4,-5,-1,2,1,-3,7,4,0,2,2,-2,5,3,1,0,1,0,1,0,0,-4,4,0,0,-1,-1,0,1,1,2,-1
KR_6713406414,420,-11,-128,-72,-11,-3,5,2,-5,5,0,-3,6,3,-1,4,3,1,1,2,0,-9,-15,-2,-1,3,-1,0,-4,-1,-1,-1,-1,1,-1
KR_6761254466,420,-3,-19,0,-7,-2,3,1,-1,3,2,-4,6,2,0,5,5,0,0,0,0,-1,1,-1,-1,2,-2,0,0,-1,-1,0,-1,4,-1
KR_6759975940,420,-5,-53,-8,-2,-1,3,2,3,3,6,0,1,1,-4,4,0,0,0,0,0,0,-9,-5,-3,8,0,0,-2,-1,-1,-1,-1,4,-1
KR_6763282874,420,2,0,13,-2,1,1,2,-3,5,2,3,0,3,-3,5,2,0,1,1,0,2,0,-1,-4,5,-4,0,0,0,-1,0,-1,0,-1
KR_6729670780,420,-4,-98,24,-14,-3,7,4,1,1,2,-5,5,0,-11,13,2,4,1,5,0,-6,-7,-5,-1,6,0,0,-1,1,-1,-1,-1,5,-1
KR_6754355997,420,-5,20,-16,-14,-4,5,1,1,1,2,2,1,3,-10,10,0,-3,3,0,-1,-13,118,-1,-3,4,-2,0,0,-1,1,-1,-1,5,-1
KR_6610055707,440,-4,-48,-24,-6,0,3,3,1,0,1,-3,4,1,1,1,2,-5,6,1,0,1,2,6,-8,2,-2,0,-1,-1,0,-1,-1,1,-1
KR_6725466828,420,0,-32,-12,-1,-2,4,2,0,3,3,0,3,3,0,2,2,1,0,1,0,3,2,0,-3,3,-4,0,0,-1,1,1,-1,4,-1
KR_6720617020,440,-3,-21,-44,-1,-2,4,2,-3,4,1,6,4,10,-3,5,2,1,1,2,0,10,-5,0,-7,7,6,0,-3,-1,-1,-1,1,5,-1
KR_6767851532,440,-2,-34,8,-9,3,1,4,0,2,2,-3,3,0,-5,7,2,-4,4,0,-1,-15,-3,-2,-3,5,-1,0,0,-1,-1,-1,-1,5,-1
KR_6720812841,440,-6,-94,16,-12,4,0,4,2,1,3,-11,12,1,-4,4,0,-3,4,1,1,-8,-7,-2,-2,4,2,0,-3,-1,-1,-1,1,1,-1
KR_6755364265,440,-1,-89,24,0,0,4,4,4,1,5,-1,3,2,-4,6,2,1,1,2,0,3,6,-6,-2,8,-1,0,-3,1,-1,-1,1,6,-1
KR_6759662731,420,4,73,2,13,7,0,7,0,3,3,10,2,12,-6,8,2,2,2,4,3,13,5,9,-9,0,-1,0,0,0,1,1,1,0,-1
KR_6728017190,420,-4,-103,5,-3,-1,1,0,-3,4,1,-1,3,2,1,2,3,1,0,1,0,-2,0,0,-4,4,-5,0,0,-1,1,-1,1,5,-1
KR_6514813460,420,-3,37,8,-9,2,0,2,-4,6,2,-4,4,0,0,0,0,-3,3,0,0,-9,-6,-2,-3,5,-1,0,0,1,-1,0,-1,6,-1
KR_6690365597,420,-2,-26,12,-2,-2,3,1,-1,4,3,1,2,3,0,5,5,0,0,0,0,6,-1,-1,-3,4,2,0,-1,-1,0,-1,1,6,-1
KR_6666040501,420,-2,-62,-16,-5,2,0,2,-6,6,0,3,1,4,-3,4,1,-1,1,0,0,-6,-5,2,-6,4,-1,0,-1,0,-1,-1,-1,0,-1
KR_6746323923,440,-2,-65,-69,8,1,1,2,-1,1,0,0,3,3,7,1,8,1,2,3,0,10,107,2,-2,0,-1,0,-1,-1,0,-1,-1,5,-1
KR_6762175608,420,2,-46,12,3,-3,3,0,1,4,5,-1,3,2,1,1,2,5,0,5,0,7,-7,-1,-5,6,3,0,1,-1,1,1,-1,1,-1
KR_6684781517,420,-3,-38,6,-9,-5,5,0,0,3,3,1,0,1,-4,4,0,-1,2,1,-2,-5,1,2,-6,4,-1,0,-1,-1,-1,-1,-1,1,-1
KR_6674097813,420,-5,-119,-14,-13,-7,7,0,-1,2,1,-2,2,0,-3,3,0,0,0,0,0,-15,-4,-1,-2,3,0,0,-3,-1,-1,-1,-1,5,-1
KR_6758155958,440,-1,41,-24,-5,1,1,2,-7,7,0,-2,4,2,2,1,3,1,0,1,1,-4,7,-3,0,3,2,0,0,1,-1,0,1,3,-1
KR_6731756293,420,2,-21,20,5,0,2,2,4,0,4,6,3,9,-8,8,0,3,0,3,-1,5,-11,-5,-4,9,2,0,0,1,1,-1,-1,1,-1
KR_6740791989,420,-1,-171,36,-6,0,0,0,0,2,2,-3,3,0,-2,3,1,-1,3,2,0,0,-15,-5,0,5,1,0,-2,1,1,-1,-1,3,-1
KR_6759052463,420,1,-56,-25,2,-1,3,2,-1,2,1,3,2,5,2,1,3,-1,1,0,-1,-4,-7,-5,-3,8,-7,0,-1,-1,1,-1,-1,5,-1
KR_6768043065,420,-4,-85,-23,-7,-4,5,1,-7,7,0,3,0,3,1,1,2,0,0,0,-1,-6,2,-5,-5,10,0,0,-1,1,-1,-1,-1,2,-1
KR_6765306232,420,-3,-110,-44,-6,-1,3,2,0,2,2,-2,3,1,-4,5,1,1,1,2,-1,-3,15,2,-7,5,4,0,-3,1,-1,-1,-1,4,-1
KR_6681358999,420,-3,-25,-9,-10,-3,4,1,-4,7,3,1,2,3,-2,5,3,-2,2,0,-3,-16,1,0,-3,3,3,0,-2,-1,-1,-1,-1,1,-1
KR_6758165513,420,-6,-77,-16,-6,-5,5,0,-3,4,1,2,4,6,-1,6,5,1,0,1,0,0,-124,0,-3,3,1,0,-3,-1,-1,-1,-1,6,-1
KR_6687294778,420,2,51,8,8,-2,2,0,3,2,5,1,1,2,3,1,4,3,1,4,1,14,40,6,-8,2,-21,0,-1,1,1,-1,1,3,-1
KR_6735008769,420,-3,-68,-29,-13,-6,8,2,-5,6,1,-3,4,1,2,4,6,-1,1,0,0,-5,-4,4,-5,1,-2,0,-2,-1,-1,-1,-1,4,-1
KR_6766773697,420,-1,13,48,-10,1,1,2,-9,9,0,-5,6,1,0,0,0,3,1,4,-1,-6,5,-3,-2,5,0,0,-2,1,-1,-1,-1,3,-1
KR_6759344683,440,-1,4,-16,0,-1,2,1,1,5,6,-3,4,1,2,0,2,1,0,1,0,-1,21,0,-4,4,-1,0,0,-1,-1,-1,1,6,-1
KR_6764006292,420,-4,-67,-4,-8,2,3,5,-3,3,0,-3,3,0,-4,4,0,0,0,0,0,-3,-237,-2,-4,6,-2,0,-2,-1,1,-1,-1,1,-1
KR_6729278363,420,-4,7,-24,-12,-4,4,0,-9,10,1,-1,4,3,3,0,3,-1,2,1,0,-2,-3,-6,-1,7,1,0,-2,-1,1,-1,-1,6,-1
KR_6757388873,420,3,9,-4,12,1,1,2,0,4,4,4,0,4,6,0,6,1,0,1,0,12,11,-2,-2,4,-1,0,0,1,-1,1,-1,3,-1
KR_6649622342,420,3,38,17,8,3,2,5,-1,5,4,5,2,7,1,3,4,0,0,0,0,-1,-3,-2,-4,6,-1,0,1,-1,-1,-1,1,3,-1
KR_6751661088,420,0,70,-16,-2,-3,4,1,-1,4,3,2,2,4,1,1,2,-1,2,1,0,-2,12,0,-4,4,0,0,0,1,-1,0,-1,5,-1
KR_6671912343,420,2,17,-37,-5,-2,5,3,1,1,2,6,3,9,-8,9,1,-2,4,2,-1,-10,7,0,-3,3,2,0,0,-1,1,1,-1,5,-1
KR_6760819086,420,1,-7,-16,2,2,2,4,2,1,3,1,2,3,-4,4,0,1,0,1,0,5,-2,0,-4,4,16,0,1,-1,1,1,1,2,-1
KR_6762388372,420,-1,56,-22,-8,-6,7,1,0,0,0,3,1,4,2,2,4,-7,10,3,-1,-9,-195,0,-2,2,0,0,-1,-1,-1,-1,-1,6,-1
KR_6762817239,420,3,28,-7,-2,-1,4,3,-2,5,3,-2,3,1,0,1,1,3,0,3,0,-2,-406,-2,-1,3,-2,0,-1,-1,-1,-1,-1,3,-1
KR_6721526419,420,0,20,-8,0,3,0,3,2,2,4,-3,6,3,-3,3,0,1,6,7,0,0,-25,1,-5,4,-1,0,0,-1,-1,-1,-1,6,-1
KR_6699547513,420,4,30,-12,3,2,3,5,0,1,1,2,4,6,1,2,3,-2,2,0,1,5,45,3,-7,4,1,0,1,0,-1,1,-1,0,-1
KR_6767835836,420,-1,1,14,-5,3,1,4,-2,4,2,1,3,4,-2,2,0,-5,8,3,0,-6,15,0,-3,3,-3,0,-1,-1,1,1,-1,3,-1
KR_6722920146,420,-4,-39,-8,-7,-3,4,1,-3,5,2,-2,3,1,0,1,1,1,1,2,0,-5,2,0,-4,4,-2,0,-1,1,-1,-1,-1,6,-1
KR_6628313620,420,2,43,-4,0,5,1,6,-7,8,1,0,0,0,3,0,3,-1,3,2,0,-2,8,2,-5,3,-2,0,1,-1,1,1,1,3,-1
KR_6757749165,440,-3,-59,12,-4,-4,5,1,5,1,6,-3,3,0,-2,3,1,0,1,1,0,0,-5,2,-5,3,-2,0,0,1,1,0,-1,5,-1
KR_6624597538,420,-1,60,-7,4,-2,3,1,1,3,4,3,1,4,0,2,2,2,0,2,0,6,31,3,-7,4,-3,0,0,-1,-1,0,-1,6,-1
KR_6717552293,420,-1,-9,29,-1,-1,3,2,0,2,2,1,2,3,-2,3,1,1,0,1,0,-2,-7,-4,-4,8,2,0,0,-1,1,-1,1,2,-1
KR_6764505403,420,1,31,-40,-4,0,3,3,-1,3,2,4,2,6,-2,4,2,-5,5,0,-1,-14,-17,-4,-4,8,-4,0,0,-1,0,-1,-1,2,-1
KR_6634961833,420,2,-12,-4,7,1,3,4,0,3,3,0,1,1,5,1,6,1,1,2,0,12,8,-1,-1,2,-2,0,0,1,-1,1,-1,3,-1
KR_6766731555,440,-3,-13,-4,-7,-3,3,0,0,3,3,1,3,4,-5,5,0,0,0,0,0,0,10,1,-3,2,-1,0,0,0,-1,-1,-1,0,-1
KR_6714370504,420,1,62,-23,4,1,1,2,2,0,2,0,1,1,1,1,2,0,1,1,0,8,-1,-5,-2,7,1,0,0,1,-1,0,1,5,-1
KR_6764268754,420,0,-11,46,-7,-4,4,0,0,2,2,-2,7,5,3,4,7,-4,5,1,-1,-2,-5,0,-2,2,-1,0,-1,-1,1,-1,-1,6,-1
KR_6652328398,420,-1,55,-31,-3,2,1,3,0,3,3,-5,5,0,0,6,6,0,1,1,0,5,10,-4,-3,7,-2,0,-1,1,-1,-1,-1,2,-1
KR_6765249938,420,-2,-65,15,-2,1,0,1,-1,4,3,1,0,1,-3,6,3,0,1,1,0,-12,11,8,-8,0,-1,0,0,1,1,0,-1,5,-1
KR_6728899927,420,-1,-44,-3,-5,2,1,3,-2,2,0,2,6,8,-4,5,1,-3,3,0,0,-9,-11,0,-5,5,-1,0,-2,-1,1,-1,-1,3,-1
KR_6709568763,420,-9,-113,-24,-20,-4,5,1,-5,5,0,-4,6,2,-5,5,0,-2,2,0,0,-13,0,-2,-4,6,0,0,-5,-1,-1,-1,-1,1,-1
KR_6593822896,420,-3,-80,-8,-6,-2,3,1,-2,2,0,1,1,2,-2,5,3,-1,2,1,0,-3,34,0,-9,9,-3,0,-4,1,-1,-1,-1,5,-1
KR_6764508297,420,-5,-43,-12,-12,-6,6,0,0,3,3,0,3,3,-4,4,0,-2,2,0,0,-14,-4,-1,-4,5,0,0,-1,0,-1,-1,-1,0,-1
KR_6685680226,420,-2,11,12,-8,-1,4,3,-1,6,5,-2,2,0,-2,4,2,-2,4,2,1,-13,-6,-1,-5,6,-3,0,1,-1,1,1,1,3,-1
KR_6723708406,420,-2,23,6,-11,-5,6,1,-1,2,1,-3,5,2,0,1,1,-2,2,0,-1,-14,4,5,-6,1,-3,0,0,1,-1,0,-1,5,-1
KR_6703959275,420,0,-50,13,-1,4,5,9,-1,1,0,0,1,1,-5,6,1,1,0,1,0,-7,1,-2,-4,6,2,0,1,1,-1,-1,1,1,-1
KR_6702790021,420,0,7,8,-11,3,0,3,-4,5,1,-7,8,1,-2,2,0,-1,2,1,0,-11,3,6,-9,3,-4,0,-2,-1,1,-1,-1,5,-1
KR_6751441513,440,2,11,-13,-6,0,2,2,-6,8,2,-3,3,0,4,2,6,-1,2,1,0,-3,4,-2,-3,5,-1,0,0,-1,-1,-1,1,1,-1
KR_6760888716,420,-3,-25,-18,-14,-1,2,1,-7,8,1,-4,5,1,0,2,2,-2,2,0,-1,-10,105,-4,-1,5,0,0,-2,1,-1,-1,-1,1,-1
KR_6656602170,420,-2,-33,-12,-5,-1,4,3,-1,2,1,-4,4,0,1,1,2,0,0,0,0,-5,-265,0,-3,3,3,0,-1,-1,-1,-1,-1,6,-1
KR_6689042462,440,1,-68,-3,-3,-3,4,1,-7,8,1,1,2,3,2,3,5,4,1,5,-1,5,-4,-1,-4,5,1,0,1,-1,-1,-1,-1,2,-1
KR_6715603230,420,-10,-152,23,-13,-2,2,0,-3,3,0,-5,6,1,-3,3,0,0,1,1,0,-17,202,-6,-3,9,-4,0,-3,-1,1,-1,-1,6,-1
KR_6758217255,420,-2,-83,10,-5,-1,1,0,-2,4,2,-3,5,2,2,2,4,-1,1,0,0,1,-23,6,-7,1,29,0,0,-1,1,-1,-1,4,-1
KR_6765727440,420,-3,21,4,-2,-3,3,0,1,2,3,-2,3,1,1,3,4,1,1,2,0,3,-13,-4,-4,8,3,0,0,1,-1,0,-1,3,-1
KR_6765670268,420,-3,23,-5,-6,2,2,4,-1,4,3,-4,5,1,-2,8,6,-1,1,0,0,-8,-2,-3,-4,7,4,0,1,0,-1,1,1,0,-1
KR_6569986841,420,4,75,-4,10,3,0,3,3,0,3,2,2,4,0,3,3,2,0,2,0,9,12,7,-9,2,-3,0,1,1,1,1,1,3,-1
KR_6571218167,420,-4,-4,-39,-6,0,2,2,-2,4,2,0,1,1,-6,7,1,2,0,2,-3,-15,5,-5,-2,7,4,0,0,-1,-1,-1,-1,4,-1
KR_6726098574,420,0,-13,12,-1,1,1,2,-2,3,1,0,3,3,-1,2,1,1,0,1,0,-2,-33,-1,-3,4,4,0,0,1,0,0,-1,6,-1
KR_6714116228,420,2,54,14,1,-4,4,0,0,2,2,-1,1,0,7,0,7,-1,1,0,0,9,-118,-4,-2,6,4,0,-1,1,-1,-1,1,1,-1
KR_6762429797,420,3,51,-5,6,0,2,2,1,1,2,6,1,7,-2,6,4,1,0,1,-1,10,3,-1,-5,6,-1,0,2,1,-1,1,-1,5,-1
KR_6721732156,440,-2,-1,-15,1,4,1,5,0,2,2,-1,3,2,-2,5,3,0,2,2,0,2,3,2,-5,3,-5,0,0,1,-1,0,1,4,-1
KR_6750675759,420,-1,-3,20,-2,3,0,3,-2,4,2,-4,4,0,2,0,2,-1,1,0,0,-6,-21,-3,-1,4,1,0,-1,0,-1,-1,-1,0,-1
KR_6767259007,420,0,-21,-20,2,1,0,1,5,1,6,2,2,4,-6,7,1,0,1,1,1,7,-2,1,-5,4,1,0,0,1,0,0,1,1,-1
KR_6642727101,420,4,78,18,-1,3,1,4,1,2,3,2,3,5,-5,9,4,-2,2,0,0,-5,53,1,-4,3,-20,0,-1,1,0,1,-1,2,-1
KR_6768056475,420,-6,-29,-24,-8,-3,3,0,-1,2,1,0,0,0,-5,6,1,1,0,1,0,-8,-24,-3,-4,7,2,0,-2,-1,1,-1,-1,3,-1
KR_6761386395,420,-2,-3,-8,-7,3,0,3,1,1,2,-3,4,1,-5,5,0,-3,3,0,0,-11,-6,-2,-2,4,-2,0,-1,-1,1,-1,-1,5,-1
KR_6715995912,420,-2,-48,26,-9,-1,2,1,2,0,2,0,2,2,-9,10,1,-1,2,1,-1,-4,0,2,-5,3,0,0,-1,-1,-1,-1,-1,1,-1
KR_6705196269,440,0,35,-18,-8,0,1,1,-6,8,2,2,0,2,-3,6,3,-1,4,3,0,-7,-72,2,-4,2,19,0,-2,1,0,-1,-1,2,-1
KR_6763276828,420,-3,-76,-56,-8,-1,3,2,-3,3,0,-4,5,1,0,4,4,0,3,3,0,-6,-200,3,-7,4,-2,0,-1,0,0,-1,-1,0,-1
KR_6756906951,420,-2,-77,6,-14,2,2,4,-2,4,2,-7,8,1,-4,5,1,-3,3,0,0,-10,-18,3,-7,4,-1,0,-1,-1,-1,-1,-1,3,-1
KR_6768372346,420,-3,-58,-32,-4,-7,7,0,0,2,2,-1,3,2,3,2,5,1,0,1,0,5,5,1,-4,3,-5,0,-1,-1,-1,-1,-1,6,-1
KR_6723203986,420,1,37,-3,7,0,1,1,0,3,3,3,0,3,4,1,5,0,1,1,0,15,7,4,-6,2,-5,0,1,1,1,1,1,5,-1
KR_6768372346,420,-3,-58,-32,-4,-7,7,0,0,2,2,-1,3,2,3,2,5,1,0,1,0,5,5,1,-4,3,-5,0,-1,-1,-1,-1,-1,6,-1
KR_6647901758,420,4,7,14,5,1,1,2,-1,2,1,-1,3,2,5,1,6,1,0,1,-1,5,16,-1,-4,5,-3,0,0,0,0,1,-1,0,-1
KR_6762766998,420,-2,11,-28,-3,-1,2,1,-3,4,1,2,1,3,-3,5,2,2,0,2,-1,-5,5,2,-6,4,-1,0,-1,-1,0,-1,-1,4,-1
KR_6725547726,420,2,-17,4,2,4,1,5,-1,3,2,6,0,6,-7,7,0,0,0,0,0,-7,-23,-2,-2,4,-4,0,1,-1,1,1,1,6,-1
KR_6724388448,420,-2,-55,-12,-5,0,2,2,-4,5,1,-4,6,2,4,0,4,-1,1,0,0,7,2,3,-7,4,-2,0,-1,1,-1,-1,-1,2,-1
KR_6766227883,420,-3,-24,-7,-5,-1,3,2,0,1,1,-6,8,2,1,2,3,1,1,2,0,0,6,2,-8,6,-5,0,0,1,-1,-1,1,3,-1
KR_6759604440,440,2,10,0,0,-2,5,3,0,1,1,1,1,2,-2,4,2,3,3,6,-1,-5,-47,1,-6,5,16,0,1,-1,1,1,-1,6,-1
KR_6728748303,420,3,-11,40,-4,0,1,1,1,2,3,5,1,6,-9,9,0,-1,2,1,0,-12,-4,-2,-4,6,2,0,1,-1,1,1,-1,2,-1
KR_6750097231,420,0,-52,-15,3,2,0,2,1,5,6,-2,6,4,4,3,7,-2,3,1,1,6,9,2,-5,3,-1,0,0,1,-1,-1,1,4,-1
KR_6706773065,420,-2,-34,-12,-2,-4,5,1,2,0,2,1,2,3,0,3,3,-1,2,1,-1,5,-75,-3,-5,8,-20,0,-2,-1,-1,-1,-1,5,-1
KR_6604619564,420,-1,-89,-12,-4,3,0,3,-4,5,1,-2,4,2,0,4,4,-1,3,2,1,-2,-20,2,-8,6,-1,0,-1,-1,-1,-1,1,6,-1
KR_6755816194,420,-3,-70,-17,-12,0,1,1,-8,9,1,4,3,7,-8,9,1,0,1,1,0,-17,-10,0,-6,6,-5,0,0,-1,-1,0,1,1,-1
KR_6765253772,420,-3,-4,5,0,0,2,2,0,0,0,-3,3,0,2,2,4,1,0,1,0,1,4,4,-6,2,-4,0,-1,1,-1,-1,1,3,-1
KR_6752019089,420,-2,46,-20,-5,-5,5,0,-1,4,3,-3,5,2,2,1,3,2,0,2,0,1,-114,1,-4,3,-6,0,0,-1,1,0,-1,4,-1
KR_6766643283,440,-2,3,-4,-4,-3,3,0,-1,1,0,3,1,4,-5,8,3,2,2,4,0,-6,212,0,-2,2,-3,0,0,-1,-1,0,1,1,-1
KR_6754360906,420,-5,-71,-23,-3,-1,2,1,0,1,1,-4,8,4,2,1,3,0,0,0,-1,-3,20,3,-5,2,1,0,1,-1,1,1,-1,3,-1
KR_6764222509,420,-1,-93,39,-3,0,2,2,-4,7,3,1,1,2,2,1,3,-2,4,2,-2,-4,4,-2,-1,3,-1,0,-1,0,0,-1,-1,0,-1
KR_6558957675,420,-2,-15,12,-3,1,4,5,0,0,0,-6,9,3,1,0,1,1,0,1,0,-5,-11,-3,-1,4,2,0,-2,1,0,-1,-1,6,-1
KR_6720519866,440,-2,-36,-16,-5,-8,8,0,-5,7,2,1,3,4,1,3,4,6,1,7,1,-1,-28,0,-3,3,2,0,0,1,-1,-1,1,3,-1
KR_6767667632,440,-4,-113,-4,-8,-3,4,1,-1,3,2,0,1,1,-4,6,2,0,0,0,0,-7,-3,0,-3,3,0,0,0,-1,0,0,-1,1,-1
KR_6704994826,420,-4,9,-32,-2,0,1,1,0,2,2,-2,4,2,0,2,2,0,0,0,0,-5,-91,4,-7,3,-2,0,0,-1,1,0,1,5,-1
KR_6761157406,440,-5,-60,-28,-18,-2,4,2,0,1,1,-6,9,3,-8,8,0,-2,2,0,-1,-24,-5,-5,-2,7,1,0,-1,1,-1,-1,-1,3,-1
KR_6760231598,420,-5,-28,-64,-6,-3,5,2,-8,8,0,-5,5,0,4,1,5,6,0,6,0,1,12,0,-2,2,-1,0,-2,-1,-1,-1,1,4,-1
KR_6515118969,420,-4,-13,-4,-7,2,1,3,-5,8,3,-2,3,1,-3,5,2,1,1,2,3,-3,-19,-8,-2,10,5,0,-1,-1,-1,-1,1,4,-1
KR_6657712878,420,-2,-18,12,1,-1,1,0,-2,7,5,-1,3,2,2,2,4,3,0,3,-1,2,-22,-4,0,4,1,0,-1,0,-1,-1,-1,0,-1
KR_6760219845,420,0,8,-15,-3,2,0,2,-2,4,2,0,2,2,-2,4,2,-1,2,1,0,-4,-12,-2,-1,3,-5,0,-1,-1,-1,-1,1,3,-1
KR_6724086328,420,-3,-41,-20,-8,-1,1,0,0,2,2,-6,8,2,0,4,4,-1,1,0,0,1,373,-1,-4,5,0,0,-1,1,-1,-1,-1,3,-1
KR_6681238728,420,-2,-25,-20,-2,1,1,2,-5,5,0,5,1,6,-4,8,4,1,0,1,1,9,1,1,-4,3,-1,0,-1,-1,-1,-1,1,1,-1
KR_6684677289,420,-1,-30,24,-6,2,0,2,-2,2,0,1,4,5,-5,5,0,-2,2,0,0,-9,-18,0,-8,8,1,0,1,1,1,-1,-1,1,-1
KR_6765183265,420,0,56,4,0,1,3,4,4,0,4,0,1,1,-5,7,2,0,0,0,-1,-4,14,6,-8,2,-5,0,2,1,1,1,-1,4,-1
KR_6712107662,440,0,-21,12,-3,0,1,1,3,2,5,-4,4,0,-2,3,1,0,2,2,0,-10,-8,-1,-5,6,1,0,-1,1,-1,-1,1,6,-1
KR_6744214692,420,-3,-87,-12,-8,-1,2,1,0,1,1,-4,5,1,-1,2,1,-2,3,1,0,-6,-21,-5,-2,7,5,0,-1,-1,-1,-1,-1,5,-1
KR_6736690786,420,3,-34,4,1,2,1,3,2,1,3,1,4,5,-5,7,2,1,0,1,0,-2,-6,-6,-3,9,4,0,0,-1,1,1,-1,6,-1
KR_6763352633,420,-2,-31,-32,-2,1,3,4,-4,6,2,0,2,2,-1,2,1,2,1,3,0,2,1,-2,-3,5,-1,0,0,-1,1,0,-1,2,-1
KR_6675671645,420,-6,-103,0,-11,-3,5,2,-1,3,2,0,2,2,-7,7,0,0,0,0,0,-11,37,-1,-4,5,-16,0,-2,-1,-1,-1,1,5,-1
KR_6739581661,420,0,23,25,-7,-3,5,2,-2,3,1,-4,4,0,1,7,8,1,0,1,-3,-10,1,-1,-6,7,2,0,0,1,-1,1,-1,5,-1
KR_6681230307,420,-5,-43,-28,-8,4,1,5,-6,11,5,-1,2,1,-4,6,2,-1,2,1,0,-12,-2,0,-5,5,-4,0,0,-1,1,1,1,2,-1
KR_6764662682,420,0,-24,8,-1,0,1,1,4,4,8,-5,6,1,0,3,3,0,0,0,0,-1,7,3,-5,2,-3,0,-1,-1,-1,-1,-1,6,-1
KR_6695305048,420,3,-15,-24,4,3,1,4,-5,5,0,1,2,3,4,3,7,1,0,1,0,6,0,2,-5,3,6,0,1,-1,1,1,1,3,-1
KR_6760293772,420,-3,10,-14,-8,-1,2,1,-2,2,0,-1,1,0,-3,3,0,-1,1,0,0,-12,6,0,-3,3,-4,0,0,-1,1,0,-1,3,-1
KR_6734564444,440,-3,-4,-56,-4,-2,2,0,-3,3,0,0,3,3,0,1,1,1,0,1,1,3,13,4,-5,1,-3,0,-1,-1,-1,-1,1,2,-1
KR_6703197167,420,-4,-94,-19,5,0,2,2,-1,1,0,3,1,4,2,4,6,1,0,1,0,17,-2,-4,-1,5,-2,0,-2,-1,-1,-1,1,2,-1
KR_6766040554,440,-3,-59,-34,-11,-4,4,0,-1,4,3,-2,2,0,-6,6,0,2,1,3,0,-15,29,1,-4,3,-17,0,-1,-1,1,-1,-1,4,-1
KR_6729686674,420,2,17,-12,2,3,0,3,-2,5,3,1,3,4,1,5,6,-1,1,0,0,-2,9,4,-9,5,-4,0,1,-1,1,1,1,1,-1
KR_6591887314,420,-2,-81,-29,-4,-1,1,0,1,3,4,-8,10,2,4,2,6,0,0,0,0,9,-114,-1,-4,5,-6,0,0,-1,-1,0,1,5,-1
KR_6719352518,420,2,24,42,5,3,0,3,10,1,11,-2,2,0,-6,8,2,0,1,1,0,-1,102,-5,-2,7,1,0,1,1,1,1,1,3,-1
KR_6735587610,420,2,0,14,4,-2,3,1,0,0,0,6,1,7,2,2,4,-2,2,0,0,0,-14,0,-6,6,1,0,0,1,1,0,-1,2,-1
KR_6760334246,420,-3,-13,10,-13,2,1,3,-2,3,1,-2,3,1,-10,11,1,-1,1,0,-1,-9,33,-2,-2,4,2,0,-1,-1,-1,-1,-1,6,-1
KR_6615579961,420,-3,-26,-20,-6,3,0,3,1,2,3,3,0,3,-13,14,1,0,0,0,0,-17,1,3,-7,4,-1,0,0,-1,1,-1,1,2,-1
KR_6744323589,420,-2,-82,-15,0,-2,4,2,1,3,4,-3,4,1,2,1,3,2,2,4,0,2,55,-4,-4,8,25,0,-1,-1,1,-1,1,5,-1
KR_6762281554,420,-5,-88,-25,-2,-1,4,3,-5,7,2,0,2,2,2,2,4,2,0,2,0,4,-8,-4,-1,5,1,0,-3,-1,-1,-1,1,6,-1
KR_6547672295,420,1,14,20,-2,0,1,1,-5,6,1,-2,3,1,3,0,3,2,0,2,0,-9,-45,-8,0,8,25,0,0,1,1,-1,1,2,-1
KR_6682375386,440,-3,-39,-20,-1,-1,4,3,-3,5,2,0,1,1,3,3,6,0,0,0,0,5,-247,4,-4,0,0,0,0,-1,1,0,-1,2,-1
KR_6741292012,420,-4,-73,48,-14,-11,12,1,2,2,4,-3,6,3,0,4,4,-2,2,0,1,-3,-2,0,-3,3,1,0,-3,-1,1,-1,1,5,-1
KR_6758342803,440,-1,-29,-15,7,2,1,3,-2,3,1,0,1,1,8,0,8,-1,3,2,0,8,-6,-2,-4,6,3,0,0,-1,1,1,1,2,-1
KR_6617653450,420,-4,-43,-4,-3,-1,2,1,6,0,6,-3,7,4,-5,7,2,0,1,1,0,2,10,-5,-1,6,-6,0,-4,-1,-1,-1,-1,1,-1
KR_6747474329,420,0,26,-12,-2,1,0,1,0,2,2,-2,3,1,1,0,1,-2,4,2,0,2,4,-3,-2,5,0,0,0,1,-1,0,-1,5,-1
KR_6726784006,420,1,13,16,3,4,0,4,-2,2,0,0,1,1,0,1,1,1,0,1,0,3,42,-3,-3,6,0,0,0,1,-1,-1,-1,2,-1
KR_6761628991,420,2,22,-4,5,-1,3,2,0,5,5,2,1,3,3,2,5,1,0,1,0,7,-3,-7,-4,11,0,0,0,-1,1,-1,-1,3,-1
KR_6761157395,420,0,-10,4,3,-1,1,0,2,2,4,-3,5,2,4,0,4,1,0,1,0,6,242,3,-5,2,1,0,0,1,-1,-1,1,4,-1
KR_6766031373,420,-3,-22,-25,-10,-1,1,0,-1,2,1,-2,4,2,-5,7,2,-1,2,1,0,-9,245,0,-2,2,0,0,-1,-1,0,-1,-1,5,-1
KR_6743171527,420,-3,36,15,-10,-1,1,0,0,4,4,-7,7,0,-3,3,0,1,1,2,0,-8,68,0,-5,5,-4,0,-1,-1,1,1,-1,1,-1
KR_6738326413,420,1,-8,-4,5,6,1,7,-3,5,2,3,2,5,-3,4,1,2,0,2,0,3,-8,-1,-3,4,0,0,0,-1,1,1,1,3,-1
KR_6653302283,420,-2,-25,-7,-5,-1,1,0,-2,3,1,0,2,2,-3,4,1,1,0,1,0,-5,4,0,-4,4,-1,0,0,-1,-1,0,-1,5,-1
KR_6754974946,420,-1,-45,17,0,1,0,1,4,1,5,-4,6,2,-1,8,7,0,1,1,0,2,-6,-1,-5,6,3,0,0,1,-1,-1,1,3,-1
KR_6727785730,420,-1,-51,-1,3,-1,3,2,1,2,3,-2,2,0,6,2,8,-1,1,0,-1,-1,2,-4,-3,7,4,0,0,0,-1,0,-1,0,-1
KR_6758131339,420,1,64,-4,6,3,0,3,1,1,2,5,4,9,-3,7,4,0,0,0,2,4,-8,-5,-7,12,2,0,1,1,-1,1,1,6,-1
KR_6704874123,440,-4,-40,-18,1,0,4,4,-1,2,1,2,1,3,3,5,8,-3,3,0,1,3,2,-2,-1,3,0,0,0,0,1,-1,1,0,-1
KR_6761202892,420,-1,30,-12,-5,-10,10,0,2,1,3,1,3,4,1,1,2,1,1,2,0,1,5,1,-5,4,0,0,1,-1,-1,1,1,6,-1
KR_6749955198,420,-4,-68,-15,-12,5,1,6,-2,5,3,-12,12,0,-2,2,0,-1,1,0,0,-4,-2,-1,-4,5,-1,0,-3,0,-1,-1,-1,0,-1
KR_6738582020,440,-4,-4,-28,-12,-4,7,3,-2,4,2,-1,2,1,-7,8,1,2,1,3,-1,-21,-13,-4,-2,6,4,0,-1,-1,0,-1,-1,2,-1
KR_6761400555,420,-1,-35,-3,-3,2,0,2,1,2,3,-4,7,3,0,2,2,-2,2,0,0,4,22,4,-8,4,-5,0,-3,0,-1,-1,1,0,-1
KR_6720097065,420,0,21,-1,4,-1,4,3,0,4,4,3,1,4,2,1,3,0,1,1,0,1,27,0,-4,4,-2,0,1,1,0,-1,1,4,-1
KR_6751867893,420,-2,-51,4,-6,-10,12,2,1,0,1,6,0,6,-1,3,2,-2,2,0,0,-4,-9,-1,-3,4,6,0,0,1,-1,-1,-1,3,-1
KR_6723215893,420,-7,-116,-30,-15,0,0,0,-7,8,1,-6,7,1,-1,3,2,-1,1,0,0,-17,-9,-2,-4,6,-2,0,-2,-1,-1,-1,-1,6,-1
KR_6740005618,420,-1,-18,16,-2,-1,4,3,-3,3,0,-1,4,3,2,2,4,1,1,2,0,-4,7,-1,-1,2,-1,0,-1,1,-1,-1,-1,2,-1
KR_6759788872,420,1,16,12,0,-3,4,1,-2,6,4,2,2,4,1,1,2,2,1,3,0,-1,-3,-2,-5,7,3,0,1,0,1,1,-1,0,-1
KR_6756733161,420,0,-8,1,-3,0,2,2,0,1,1,1,1,2,3,0,3,-7,11,4,-1,-4,-5,-2,-6,8,0,0,-2,-1,-1,1,-1,2,-1
KR_6728114245,440,-5,-87,-52,-3,-1,1,0,3,0,3,-4,5,1,-2,3,1,1,3,4,0,0,-38,-1,-4,5,1,0,-2,-1,-1,-1,-1,6,-1
KR_6760031106,440,-1,-27,-8,-3,2,1,3,0,3,3,2,1,3,-2,4,2,-5,5,0,0,-1,12,1,-3,2,-5,0,-1,-1,-1,-1,1,3,-1
KR_6754728120,420,-2,-13,19,3,1,0,1,4,1,5,-1,1,0,-1,3,2,0,0,0,0,5,6,1,-8,7,-4,0,0,1,1,0,1,4,-1
KR_6704111295,420,-2,-38,-12,-5,-5,5,0,2,1,3,1,2,3,-2,2,0,-1,1,0,0,-6,5,0,-9,9,-6,0,-1,1,-1,-1,-1,5,-1
KR_6632022106,420,-5,-13,0,-8,2,1,3,-4,5,1,-2,6,4,-4,8,4,0,0,0,0,-17,-6,0,-5,5,-4,0,-2,-1,-1,-1,-1,2,-1
KR_6764124867,420,-1,47,-24,-6,3,0,3,-1,3,2,-3,4,1,-4,6,2,-1,3,2,0,-6,-20,-3,-1,4,0,0,1,1,1,1,-1,3,-1
KR_6715440548,420,-1,-65,-33,3,0,2,2,2,4,6,3,3,6,-2,3,1,0,0,0,0,-1,3,3,-5,2,0,0,-1,1,-1,-1,1,6,-1
KR_6740238340,420,0,28,24,-5,3,2,5,1,2,3,-5,5,0,-4,4,0,0,2,2,0,-12,-2,0,-3,3,1,0,1,0,1,1,1,0,-1
KR_6750769631,420,-3,-46,-23,-7,-1,2,1,-1,3,2,1,2,3,-1,2,1,-5,5,0,-2,-21,-150,-1,-3,4,1,0,-3,-1,-1,-1,-1,1,-1
KR_6767551809,420,-1,-2,-12,2,1,3,4,3,3,6,-4,4,0,2,3,5,0,1,1,0,-2,-2,0,-5,5,-4,0,0,0,1,1,1,0,-1
KR_6754332444,420,-2,22,4,-3,-5,5,0,1,1,2,0,4,4,4,2,6,-3,6,3,0,-7,-69,-3,-4,7,1,0,-1,-1,-1,1,1,6,-1
KR_6766961887,420,-2,-16,-9,-5,2,0,2,-1,4,3,-1,2,1,-3,5,2,-2,2,0,0,-5,-18,10,-13,3,-2,0,-1,1,-1,-1,-1,6,-1
KR_6575691424,420,-1,-75,-13,-1,-2,4,2,0,5,5,3,4,7,-4,7,3,2,0,2,1,9,-3,7,-9,2,-2,0,-2,0,-1,-1,1,0,-1
KR_6715626803,440,0,-62,-24,5,0,2,2,-2,4,2,3,3,6,4,5,9,0,0,0,0,7,-5,0,-6,6,-3,0,0,-1,1,-1,1,6,-1
KR_6732153028,420,2,-10,25,2,-1,3,2,3,2,5,-2,2,0,1,3,4,1,0,1,1,4,-6,-5,-3,8,1,0,0,1,-1,-1,1,2,-1
KR_6752957212,420,0,85,-20,-8,-1,2,1,-1,4,3,-3,3,0,-4,6,2,1,1,2,0,-1,6,8,-10,2,2,0,0,-1,-1,0,-1,6,-1
KR_6762671812,440,-5,-116,-4,-6,-4,6,2,1,0,1,0,0,0,-2,4,2,-1,1,0,0,-1,0,-1,-2,3,1,0,-1,-1,-1,-1,-1,3,-1
KR_6724668961,420,-6,-100,-7,-15,-5,7,2,3,3,6,-6,6,0,-5,5,0,-2,2,0,0,-4,-15,-3,0,3,0,0,-2,-1,-1,-1,-1,4,-1
KR_6699387593,420,-3,-16,15,-7,1,1,2,-1,2,1,-9,9,0,2,1,3,0,2,2,0,-6,-4,-3,-1,4,0,0,0,-1,0,0,-1,5,-1
KR_6761515463,420,-6,-118,-16,-18,-5,5,0,-6,6,0,-7,8,1,0,1,1,0,0,0,0,-13,-37,-4,-1,5,0,0,-2,-1,-1,-1,-1,3,-1
KR_6649541525,420,1,32,36,-4,1,0,1,0,4,4,0,1,1,-3,3,0,-2,2,0,0,-4,-3,-4,-3,7,2,0,-1,-1,-1,-1,-1,4,-1
KR_6755646382,420,2,24,-1,1,-1,1,0,1,2,3,4,2,6,-2,3,1,-1,2,1,-1,-3,-32,8,-12,4,35,0,-1,0,-1,-1,-1,0,-1
KR_6761479393,440,-3,-81,0,-1,-3,3,0,-1,2,1,7,2,9,-3,4,1,-1,1,0,0,0,12,-2,-4,6,-1,0,-2,0,-1,-1,1,0,-1
KR_6748903682,420,-2,-29,-12,-2,-3,3,0,-2,4,2,-1,1,0,2,3,5,2,0,2,0,2,-5,4,-6,2,-3,0,0,0,-1,-1,1,0,-1
KR_6740359484,420,4,11,-21,10,6,0,6,-3,5,2,-1,2,1,4,0,4,4,0,4,1,5,11,0,-4,4,3,0,0,1,1,-1,1,1,-1
KR_6766452458,420,-2,-7,-6,-7,1,2,3,-2,3,1,-3,3,0,-4,8,4,1,2,3,-1,-14,14,-1,-2,3,-4,0,-1,1,-1,-1,-1,4,-1
KR_6615646093,420,1,-43,8,-2,0,0,0,-1,3,2,-1,3,2,-2,2,0,2,0,2,0,-7,0,-2,-3,5,-4,0,0,-1,1,0,-1,3,-1
KR_6756315728,420,0,-71,-1,0,-6,8,2,1,2,3,5,1,6,-2,4,2,2,1,3,1,0,-1,-4,-2,6,-3,0,-1,1,-1,-1,1,6,-1
KR_6723268197,420,3,12,20,-1,-1,2,1,3,1,4,-3,4,1,-2,6,4,2,1,3,-1,0,-31,3,-4,1,6,0,1,-1,-1,1,-1,5,-1
KR_6757571132,420,-3,-63,-12,-6,0,1,1,2,1,3,1,3,4,-10,10,0,1,0,1,0,-9,-19,-3,-3,6,-1,0,-2,-1,-1,-1,-1,5,-1
KR_6759375855,420,1,48,-8,5,4,0,4,-6,6,0,3,2,5,2,1,3,2,0,2,2,9,-6,-1,-3,4,4,0,1,-1,1,1,1,6,-1
KR_6681689075,420,0,8,24,-3,2,1,3,-4,5,1,5,0,5,-6,8,2,0,1,1,0,-12,-5,0,-4,4,2,0,0,1,1,1,1,5,-1
KR_6763363212,420,3,31,4,8,1,1,2,1,0,1,2,1,3,3,1,4,1,0,1,1,10,-6,0,-4,4,0,0,0,1,-1,0,1,3,-1
KR_6687919167,420,-1,-87,-4,-1,2,2,4,-1,3,2,0,2,2,0,1,1,-2,3,1,0,3,41,2,-6,4,-2,0,-1,1,-1,-1,1,1,-1
KR_6764547028,420,-1,-63,-37,0,-4,4,0,5,0,5,0,4,4,0,1,1,-1,2,1,0,7,214,4,-5,1,1,0,-1,0,1,-1,1,0,-1
KR_6726351440,440,-2,-12,-16,-5,-3,4,1,4,0,4,-5,7,2,-2,6,4,1,1,2,0,-9,164,-2,-1,3,3,0,-1,-1,1,-1,1,6,-1
KR_6693915850,420,2,55,-14,-3,4,0,4,-4,4,0,1,2,3,-3,3,0,-1,1,0,0,-9,7,1,-4,3,2,0,0,1,1,-1,-1,1,-1
KR_6383928504,420,4,15,-12,8,-1,3,2,0,1,1,4,3,7,4,0,4,1,0,1,0,7,15,1,-2,1,-5,0,0,1,0,1,1,4,-1
KR_6758726080,440,0,0,7,1,0,7,7,1,1,2,0,7,7,-1,1,0,1,0,1,0,9,-8,2,-6,4,-3,0,1,0,1,1,1,0,-1
KR_6765464125,420,-4,-48,-3,-2,-1,2,1,-1,2,1,-3,3,0,2,4,6,1,0,1,0,-5,-9,-3,-5,8,-2,0,0,1,1,0,1,4,-1
KR_6760034384,420,-2,-61,-16,-2,-8,8,0,3,0,3,-2,3,1,2,3,5,3,2,5,0,8,3,-2,-4,6,1,0,-2,1,0,-1,-1,3,-1
KR_6669323657,420,-4,-23,13,-5,0,2,2,-3,4,1,-4,5,1,2,0,2,0,0,0,-1,-6,-329,-1,-3,4,4,0,-1,-1,-1,-1,-1,3,-1
KR_6706514551,420,-2,-21,-42,-2,-2,2,0,-3,4,1,-1,2,1,3,1,4,1,2,3,0,3,6,-2,-1,3,2,0,1,0,-1,1,-1,0,-1
KR_6738574425,420,-1,-1,-20,-7,1,1,2,-7,8,1,-2,4,2,0,2,2,1,0,1,-2,-11,-115,1,-5,4,2,0,-1,1,1,-1,-1,4,-1
KR_6733912021,420,-2,-73,18,-6,-5,5,0,-4,4,0,9,0,9,-5,6,1,-1,1,0,1,-4,1,-5,-4,9,4,0,-3,-1,-1,-1,1,5,-1
KR_6763708440,420,-5,-73,-4,-13,0,1,1,-1,2,1,-1,4,3,-6,6,0,-5,5,0,0,-15,9,0,-4,4,-2,0,0,1,1,-1,1,5,-1
KR_6757489200,420,-3,-83,-21,-6,-4,5,1,4,2,6,-2,3,1,-6,8,2,2,1,3,0,-2,37,4,-6,2,-1,0,-2,-1,-1,-1,-1,1,-1
KR_6760740404,420,-3,-61,24,-6,-2,4,2,-1,6,5,0,5,5,-3,4,1,0,0,0,-1,-2,21,-5,-1,6,-1,0,0,0,1,-1,-1,0,-1
KR_6764341275,420,-1,35,0,-7,0,2,2,1,1,2,0,0,0,-9,9,0,1,1,2,0,-7,7,0,-3,3,2,0,2,-1,1,1,1,2,-1
KR_6444354959,420,-7,14,-54,-16,-1,3,2,-6,6,0,-1,2,1,-2,4,2,-6,7,1,0,-14,-15,0,-6,6,0,0,-4,0,-1,-1,-1,0,-1
KR_6729188885,440,-6,-131,-20,-16,-4,5,1,-7,8,1,-3,4,1,-3,4,1,1,1,2,0,-17,-299,5,-8,3,-6,0,-4,-1,0,-1,-1,5,-1
KR_6709640349,420,-7,-143,-29,-16,-2,2,0,0,0,0,-8,10,2,-6,8,2,0,1,1,0,-10,93,0,-3,3,0,-1,-6,-1,-1,-1,1,4,-1
KR_6747276848,440,-5,13,-43,-10,0,0,0,-3,7,4,0,3,3,0,2,2,-7,7,0,0,-10,-95,-2,-2,4,-23,0,-2,-1,-1,-1,-1,2,-1
KR_6722393649,420,-2,25,-4,-1,-2,3,1,0,3,3,0,1,1,0,3,3,1,0,1,0,3,-82,6,-9,3,-3,0,-2,1,-1,-1,1,4,-1
KR_6757963546,420,1,-55,31,-1,0,2,2,2,3,5,-1,2,1,-3,4,1,1,1,2,0,-6,-30,-5,-3,8,2,0,0,1,0,0,1,5,-1
KR_6762309356,420,-3,-38,-41,4,-4,4,0,2,1,3,0,2,2,6,6,12,0,1,1,-1,6,-1,5,-9,4,-2,0,0,1,0,0,-1,1,-1
KR_6765109742,420,-5,-29,-28,-10,2,2,4,-5,6,1,-6,7,1,-1,4,3,0,0,0,-1,-11,1,0,-3,3,0,0,-1,-1,1,-1,-1,2,-1
KR_6738366530,440,-1,-62,-8,0,0,0,0,2,0,2,-3,4,1,0,4,4,1,0,1,0,3,7,2,-5,3,2,0,1,1,-1,1,1,4,-1
KR_6641968354,420,-4,-48,-19,-3,0,1,1,0,1,1,-1,2,1,1,1,2,-3,3,0,1,-4,-30,-2,-4,6,-3,0,-1,-1,-1,-1,1,4,-1
KR_6762248688,420,-3,-49,-7,-10,-3,4,1,-4,7,3,1,0,1,-3,3,0,-1,1,0,0,-5,0,0,-3,3,1,0,-2,-1,-1,-1,-1,6,-1
KR_6710631362,420,-1,-61,-9,3,-3,3,0,3,2,5,3,0,3,0,1,1,0,2,2,0,2,-26,-3,-5,8,1,0,0,1,-1,-1,-1,3,-1
KR_6627098589,420,2,32,4,1,-4,4,0,1,1,2,7,0,7,-4,4,0,1,0,1,0,1,-4,0,-3,3,2,0,-1,1,1,-1,-1,2,-1
KR_6767786292,420,5,-24,29,11,1,1,2,3,2,5,1,5,6,5,1,6,1,0,1,0,12,0,-4,-5,9,1,0,1,-1,-1,-1,1,5,-1
KR_6757403021,420,-3,-5,-18,-5,1,1,2,-4,4,0,1,0,1,1,2,3,-4,4,0,1,-8,14,7,-10,3,-3,0,-1,1,-1,-1,1,5,-1
KR_6750152807,420,4,-30,20,7,0,1,1,1,0,1,1,1,2,2,2,4,3,2,5,0,6,14,3,-5,2,-2,0,0,-1,1,1,1,6,-1
KR_6703291359,420,2,-4,0,7,1,1,2,0,3,3,3,2,5,1,1,2,2,2,4,0,10,-2,-1,-4,5,3,0,2,1,-1,1,1,1,-1
KR_6732912224,420,-2,14,-31,1,2,1,3,-3,3,0,2,1,3,0,2,2,0,0,0,0,8,2,3,-7,4,4,0,-1,1,-1,-1,1,1,-1
KR_6746530367,420,-2,-38,-5,-8,-4,5,1,0,4,4,-2,4,2,-3,7,4,1,0,1,0,-9,-17,-3,-4,7,0,0,0,-1,0,0,1,5,-1
KR_6522497189,420,-7,-63,-24,-24,-1,4,3,-4,8,4,-8,8,0,-10,11,1,-1,1,0,-4,-39,-3,3,-11,8,-1,0,-5,-1,-1,-1,-1,1,-1
KR_6756739384,420,-2,-4,-13,-6,-2,3,1,-2,3,1,-2,8,6,0,2,2,0,1,1,-2,-2,-3,-5,-1,6,-2,0,-1,0,0,1,-1,0,-1
KR_6712846828,420,0,16,46,4,1,2,3,3,3,6,0,3,3,-1,2,1,1,0,1,0,0,0,1,-4,3,1,0,2,1,1,1,1,4,-1
KR_6723625206,420,-3,-7,12,-8,1,1,2,-5,7,2,-2,4,2,-1,5,4,-1,1,0,0,-14,45,3,-5,2,-24,0,-1,-1,1,-1,1,5,-1
KR_6760861986,420,-1,-6,-24,-5,-4,4,0,1,4,5,-1,2,1,1,1,2,-2,2,0,-1,-3,13,0,-4,4,1,0,1,-1,1,1,-1,3,-1
KR_6738952586,420,3,-52,2,2,0,3,3,-3,5,2,1,1,2,4,1,5,0,0,0,0,1,-165,-6,-1,7,-1,0,-1,1,-1,-1,-1,6,-1
KR_6765133913,420,-2,-21,20,-8,2,1,3,-5,5,0,-1,2,1,-3,3,0,-1,2,1,0,-9,16,-2,-2,4,-3,0,-1,-1,1,-1,1,4,-1
KR_6728097116,420,-1,36,-4,0,-2,4,2,0,3,3,-1,2,1,4,1,5,-1,1,0,0,-5,7,3,-4,1,0,0,2,1,1,1,1,3,-1
KR_6767015003,420,-5,-52,-12,-10,2,1,3,-1,3,2,-8,8,0,-3,4,1,0,1,1,-1,-6,2,1,-6,5,-2,0,-1,-1,1,-1,-1,2,-1
KR_6762360935,420,0,-22,0,-2,0,1,1,1,1,2,-4,5,1,3,5,8,-2,2,0,1,-11,-4,0,-4,4,-3,0,0,-1,-1,0,1,5,-1
KR_6760312674,420,-1,-78,-8,-4,-2,2,0,4,0,4,1,2,3,-11,14,3,4,0,4,0,3,-143,-1,-1,2,6,0,0,0,1,-1,-1,0,-1
KR_6691008597,420,-3,-26,-12,-5,1,4,5,-1,2,1,0,1,1,-1,3,2,-4,4,0,0,-2,0,1,-5,4,1,0,0,-1,1,-1,-1,2,-1
KR_6734617332,420,0,9,11,-3,0,2,2,-2,3,1,-2,4,2,0,2,2,1,1,2,0,-2,-8,-6,-2,8,2,0,0,1,-1,0,-1,3,-1
KR_6663655019,420,-2,-77,-8,2,0,2,2,-1,2,1,1,3,4,0,2,2,2,0,2,1,-2,3,0,-5,5,3,0,0,0,1,1,1,0,-1
KR_6751758765,420,1,20,20,-3,-2,3,1,0,4,4,3,2,5,-4,8,4,0,3,3,-1,-3,-7,-4,-3,7,0,0,0,-1,-1,-1,-1,3,-1
KR_6750218706,420,-1,-118,39,-3,1,3,4,-4,5,1,-2,3,1,-1,1,0,3,0,3,0,-1,-6,-7,0,7,2,0,-2,1,0,-1,-1,2,-1
KR_6687885317,420,-7,-29,-27,-8,-6,6,0,-6,8,2,2,3,5,2,3,5,0,1,1,1,-3,1,-2,-3,5,1,0,0,1,-1,-1,1,5,-1
KR_6715359607,420,-5,-109,-24,-12,-3,5,2,-1,3,2,-1,2,1,-5,9,4,-2,2,0,0,-6,-22,-2,-1,3,-1,0,-2,-1,1,-1,-1,2,-1
KR_6754833336,420,3,64,0,1,7,0,7,-1,5,4,-1,2,1,1,4,5,-5,6,1,-3,-6,56,5,-7,2,-1,0,2,1,1,1,-1,5,-1
KR_6721349595,420,-1,-7,2,-4,-4,4,0,-2,4,2,4,2,6,-3,7,4,1,0,1,0,-2,-1,-5,-1,6,6,0,0,1,-1,-1,1,5,-1
KR_6750014313,420,-1,-42,-13,-1,-2,3,1,2,2,4,1,0,1,-3,9,6,1,2,3,-1,2,1,6,-8,2,-1,0,-1,1,0,-1,-1,2,-1
KR_6758643653,420,-4,-8,-44,-11,0,0,0,-4,4,0,-1,2,1,-5,6,1,-1,1,0,-1,-18,4,-1,-2,3,-6,0,-1,-1,1,-1,-1,6,-1
KR_6646641511,440,0,-29,32,-5,0,1,1,0,5,5,2,2,4,-3,6,3,-4,5,1,-2,-8,-1,-5,-5,10,4,0,1,-1,-1,1,1,4,-1
KR_6754306644,420,-2,-44,-21,0,2,2,4,-1,5,4,0,1,1,-2,5,3,1,1,2,0,-6,95,1,-6,5,2,0,0,-1,1,-1,-1,5,-1
KR_6641152540,420,0,-58,16,2,0,2,2,0,3,3,-2,3,1,4,1,5,0,3,3,0,3,-13,-5,-2,7,2,0,1,1,0,-1,1,2,-1
KR_6730903818,420,-5,-29,22,-14,-5,8,3,2,0,2,-11,11,0,-2,5,3,2,0,2,0,-9,-8,-3,-2,5,-6,0,-3,-1,-1,-1,-1,6,-1
KR_6759891884,420,-3,-26,-9,-4,3,0,3,0,4,4,-3,4,1,-5,8,3,1,0,1,-1,2,1,-3,-1,4,3,0,0,0,1,-1,-1,0,-1
KR_6764618596,440,-2,-7,-39,-6,4,2,6,-6,6,0,-2,2,0,-1,2,1,-1,1,0,0,-12,-1,1,-6,5,-1,0,0,-1,-1,-1,-1,2,-1
KR_6742407017,440,1,70,-8,3,0,4,4,1,2,3,-1,4,3,0,1,1,3,0,3,1,0,11,5,-8,3,0,0,0,1,1,1,1,2,-1
KR_6733385221,420,-7,-121,-38,-5,1,2,3,0,2,2,-4,4,0,-2,2,0,0,1,1,0,-2,-6,-4,-3,7,-1,0,-2,-1,-1,-1,1,6,-1
KR_6750725138,420,-2,-52,-28,-1,3,0,3,1,1,2,-2,7,5,-5,7,2,2,0,2,0,-8,21,10,-10,0,2,0,-1,-1,1,-1,-1,2,-1
KR_6699477297,420,-1,-93,32,-7,-2,2,0,-2,2,0,0,1,1,0,3,3,-3,3,0,-1,-5,-9,0,-3,3,-5,0,0,0,-1,0,-1,0,-1
KR_6714371399,420,-1,45,-9,-1,-1,1,0,1,1,2,0,2,2,0,2,2,-1,1,0,0,-1,-117,-1,-8,9,5,0,0,-1,1,1,1,2,-1
KR_6724568717,420,-2,-3,-48,-4,-2,3,1,0,1,1,-2,3,1,-1,4,3,1,1,2,0,4,-86,0,-2,2,1,0,0,-1,-1,-1,-1,5,-1
KR_6641207190,420,-1,-8,12,-3,-3,6,3,3,1,4,0,1,1,0,2,2,-3,3,0,1,-4,6,5,-6,1,-2,0,1,-1,1,1,1,1,-1
KR_6661379922,420,-6,-100,-8,-8,-2,3,1,0,1,1,-2,3,1,-3,5,2,-1,1,0,0,-8,-38,2,-5,3,17,0,-2,-1,-1,-1,1,4,-1
KR_6759422327,420,1,56,-4,-3,-4,4,0,-2,5,3,-4,5,1,3,0,3,4,0,4,0,3,-69,-2,-4,6,5,0,-1,-1,-1,-1,-1,6,-1
KR_6726451062,420,-2,95,8,-7,4,3,7,-3,4,1,-5,6,1,-3,5,2,0,1,1,1,-15,-9,0,-4,4,2,0,0,-1,0,1,1,4,-1
KR_6467636586,420,-4,-113,32,-2,-3,4,1,0,1,1,1,0,1,1,1,2,-1,1,0,1,-3,-13,-2,-8,10,0,0,-2,1,-1,-1,1,3,-1
KR_6721386777,420,0,-11,-12,-2,-3,4,1,0,2,2,4,0,4,-3,5,2,0,0,0,1,-10,-12,-2,-3,5,0,0,0,1,-1,-1,1,4,-1
KR_6762470782,420,1,-52,-20,0,0,3,3,-1,3,2,0,2,2,1,0,1,0,0,0,0,0,5,0,-5,5,3,0,1,-1,-1,-1,1,2,-1
KR_6731936238,420,-2,-38,-28,-5,0,2,2,0,1,1,-4,5,1,-1,2,1,0,0,0,-1,-3,2,-3,-1,4,0,0,-2,-1,-1,-1,-1,3,-1
KR_6719864609,420,1,-61,26,9,0,4,4,3,1,4,5,4,9,1,1,2,0,1,1,-1,6,21,2,-7,5,3,0,0,-1,-1,0,1,1,-1
KR_6598097042,420,1,33,27,-3,-3,3,0,7,4,11,-2,2,0,-4,6,2,-1,1,0,-1,-8,-19,-4,-3,7,5,0,1,-1,1,1,-1,1,-1
KR_6768248499,420,-5,-120,3,-17,-5,5,0,-2,5,3,-3,4,1,-7,10,3,0,1,1,-1,-20,-8,-3,0,3,5,0,-1,1,-1,-1,-1,3,-1
KR_6722545922,440,-2,-64,-16,-10,-5,6,1,0,3,3,-1,3,2,-6,8,2,2,2,4,-2,-13,-7,-4,-4,8,-4,0,-2,-1,-1,-1,-1,6,-1
KR_6469546507,420,-5,-70,-4,-9,-1,3,2,-3,5,2,-5,5,0,-1,5,4,1,2,3,0,-9,144,-1,-6,7,-2,0,1,-1,-1,1,-1,3,-1
KR_6727248786,420,-7,-54,-45,-13,5,0,5,-5,6,1,-3,6,3,-8,8,0,-2,3,1,-1,-19,1,4,-7,3,0,0,-1,-1,1,1,-1,5,-1
KR_6730856833,420,1,-43,26,-1,3,0,3,-1,4,3,2,1,3,-2,4,2,-3,3,0,0,-5,3,-1,-3,4,-3,0,1,1,1,1,1,5,-1
KR_6760229128,420,-8,-85,-12,-18,-10,11,1,-1,1,0,-2,3,1,-5,6,1,0,0,0,0,-8,-115,-2,-2,4,-3,0,-5,-1,1,-1,1,3,-1
KR_6746133942,420,-3,-22,0,-3,-5,5,0,-1,1,0,-2,3,1,6,0,6,-1,2,1,0,0,44,4,-5,1,-3,0,0,-1,1,1,1,4,-1
KR_6647181833,440,-3,-85,-8,-9,-2,3,1,-3,3,0,-5,7,2,2,4,6,-1,1,0,0,-4,2,-3,-2,5,2,0,-3,0,-1,-1,1,0,-1
KR_6728628235,420,-2,-12,-11,-3,0,0,0,0,2,2,-2,4,2,-1,2,1,0,3,3,0,-8,-2,-3,-1,4,-4,0,-1,-1,-1,-1,-1,6,-1
KR_6635699970,420,-2,-28,7,-5,-3,3,0,4,4,8,-2,2,0,-2,4,2,-2,3,1,1,2,9,7,-9,2,-10,0,-3,1,-1,-1,1,5,-1
KR_6765906503,420,0,-40,-4,2,2,2,4,-1,3,2,3,1,4,-2,4,2,0,3,3,0,2,-21,1,-5,4,2,0,-2,0,-1,-1,-1,0,-1
KR_6757658288,420,-5,0,-8,-10,-3,4,1,-1,3,2,-4,4,0,-1,3,2,-1,2,1,0,-5,4,1,-4,3,-2,0,-1,-1,-1,-1,1,6,-1
KR_6740318174,420,0,-11,4,3,-3,3,0,0,1,1,2,0,2,4,0,4,0,1,1,0,3,-4,-1,-3,4,-2,0,1,-1,1,1,1,1,-1
KR_6763443938,420,3,60,46,6,0,1,1,2,2,4,3,1,4,-1,1,0,2,1,3,2,8,9,-3,-2,5,-1,0,0,-1,1,0,1,1,-1
KR_6759197450,420,-7,-94,-16,-16,-8,8,0,-1,1,0,-1,1,0,-6,6,0,0,1,1,0,-11,2,0,-3,3,-1,0,-2,-1,-1,-1,-1,4,-1
KR_6711374008,420,-3,2,-10,-16,-8,9,1,2,2,4,-7,8,1,-4,5,1,1,0,1,0,-5,1,0,-4,4,-1,0,-1,-1,0,-1,1,4,-1
KR_6624934501,420,1,-13,24,6,-1,1,0,2,1,3,7,1,8,-1,5,4,-1,2,1,0,5,-16,3,-4,1,17,0,1,1,1,1,-1,6,-1
KR_6695543425,420,-3,-8,-52,-7,0,1,1,-5,5,0,0,5,5,-2,3,1,0,1,1,0,-5,-37,-1,-4,5,9,0,-2,1,-1,-1,-1,5,-1
KR_6759130885,420,0,3,12,-3,0,1,1,-2,2,0,-3,4,1,2,3,5,0,1,1,0,-5,-155,1,-3,2,0,0,0,1,-1,0,1,6,-1
KR_6731653788,420,-3,-14,-27,-4,-3,3,0,0,2,2,3,1,4,-3,3,0,-1,1,0,0,-2,-27,4,-6,2,-1,0,0,1,1,0,1,6,-1
KR_6721300834,420,-4,-67,-28,-6,-3,3,0,-2,4,2,-1,2,1,-1,3,2,1,0,1,0,-2,-54,0,-5,5,-16,0,-1,-1,0,-1,-1,1,-1
KR_6746810312,420,-3,-23,-32,-1,-1,2,1,-3,3,0,2,2,4,1,5,6,0,0,0,0,-1,-7,-3,-1,4,0,0,-1,-1,-1,-1,1,4,-1
KR_6607581962,440,-2,5,-24,-6,3,1,4,-5,6,1,-3,5,2,1,2,3,-2,2,0,0,-13,-6,-2,-5,7,1,0,-1,-1,-1,-1,-1,4,-1
KR_6627166543,420,-1,-5,-4,-4,1,0,1,-1,3,2,0,1,1,-4,4,0,0,1,1,0,-6,7,1,-4,3,-6,0,-1,-1,1,-1,-1,2,-1
KR_6726883543,420,-3,-52,-16,-10,-4,5,1,4,0,4,-3,5,2,-6,7,1,-1,3,2,0,-7,231,2,-4,2,-5,0,0,-1,-1,-1,-1,6,-1
KR_6755627632,440,-1,-5,-24,0,-1,2,1,0,1,1,1,1,2,-1,2,1,1,0,1,0,4,2,1,-4,3,-2,0,-3,1,-1,-1,1,3,-1
KR_6756751482,420,-1,-12,-11,-8,-10,11,1,0,2,2,4,3,7,-1,2,1,-1,1,0,0,6,0,-1,-2,3,1,0,0,1,-1,-1,-1,1,-1
KR_6648837636,420,-2,-46,8,-8,0,1,1,0,0,0,-5,5,0,-4,5,1,1,1,2,0,-5,45,-1,-3,4,4,0,1,-1,0,1,-1,4,-1
KR_6730481741,420,-2,56,16,-4,-3,3,0,0,1,1,8,0,8,-5,6,1,-4,5,1,0,-9,-18,2,-5,3,1,0,0,-1,1,0,1,2,-1
KR_6765323640,420,-1,-45,-36,-4,-3,5,2,-3,4,1,0,3,3,-1,3,2,3,1,4,0,0,4,-3,-2,5,0,0,-1,-1,1,1,-1,2,-1
KR_6765562813,420,3,79,8,2,2,0,2,0,0,0,2,1,3,-2,2,0,0,0,0,0,-3,-72,0,-7,7,6,0,-1,1,-1,-1,-1,1,-1
KR_6732537881,440,-5,-129,-8,-17,-1,1,0,0,2,2,-3,4,1,-1,3,2,-12,12,0,0,-12,-6,-4,0,4,4,0,-3,-1,0,-1,-1,1,-1
KR_6763745538,420,1,-30,-4,6,-5,5,0,5,2,7,8,0,8,-2,2,0,0,1,1,-1,8,-14,-5,-2,7,5,0,0,1,1,-1,-1,6,-1
KR_6734526501,440,-2,-66,-19,-15,0,2,2,1,0,1,-5,7,2,-9,9,0,-2,3,1,0,-10,5,-1,-2,3,-2,0,-1,-1,-1,-1,-1,1,-1
KR_6766946715,440,-3,-68,-19,-8,-1,2,1,-1,1,0,1,1,2,-3,3,0,-4,4,0,0,-6,-107,-2,-4,6,0,0,-3,0,-1,-1,-1,0,-1
KR_6662495488,420,0,38,-4,-2,-1,2,1,-3,5,2,0,2,2,2,0,2,0,0,0,0,-3,1,0,-6,6,-4,0,0,1,-1,0,1,2,-1
KR_6508579872,420,-5,-31,-28,-3,0,1,1,-1,3,2,-4,4,0,-1,2,1,3,1,4,0,2,-77,1,-2,1,1,0,0,-1,-1,-1,-1,2,-1
KR_6760419101,420,0,62,28,-2,2,1,3,0,2,2,-5,5,0,4,1,5,-3,3,0,0,-2,1,-1,-2,3,2,0,0,1,1,0,1,1,-1
KR_6764936931,420,-3,-57,-16,1,-1,1,0,1,5,6,3,0,3,-2,3,1,0,0,0,0,3,-10,-5,-3,8,3,0,0,0,-1,-1,1,0,-1
KR_6742115695,440,0,-21,22,-3,-4,6,2,1,0,1,2,2,4,-1,4,3,-1,1,0,0,-9,-307,-2,-3,5,1,0,0,-1,-1,0,-1,6,-1
KR_6765839077,420,-1,-85,-16,3,0,0,0,-2,5,3,-1,4,3,6,0,6,0,1,1,1,7,-27,2,-4,2,22,0,0,1,1,0,1,5,-1
KR_6758768311,420,-2,-64,2,-5,3,0,3,-2,4,2,-1,2,1,-6,6,0,1,0,1,1,-9,-19,-4,-2,6,3,0,-1,-1,-1,-1,1,6,-1
KR_6751946828,420,-4,-28,-40,-2,5,1,6,-3,4,1,-1,3,2,1,4,5,-4,5,1,0,-8,-4,-1,-4,5,2,0,-1,1,-1,-1,1,6,-1
KR_6760985675,420,-1,-92,-5,-6,-4,4,0,1,1,2,1,1,2,-3,5,2,-1,2,1,0,-2,-9,-4,-2,6,-2,0,-2,-1,-1,-1,-1,4,-1
KR_6691617611,440,0,-102,24,-3,-4,4,0,1,3,4,0,2,2,-1,7,6,1,0,1,0,0,-8,-4,-3,7,1,0,0,-1,1,0,-1,5,-1
KR_6715816275,420,-6,-136,-23,-5,-5,5,0,1,0,1,1,1,2,-1,3,2,-1,1,0,0,-4,-16,4,-9,5,-3,0,-3,-1,-1,-1,-1,4,-1
KR_6762313231,420,-3,-51,-23,-12,-1,2,1,-3,3,0,0,9,9,-2,3,1,-6,6,0,0,-7,5,0,-4,4,-4,0,-2,-1,-1,-1,1,6,-1
KR_6711032498,420,-3,-63,-28,-1,-1,4,3,1,2,3,-1,5,4,-1,3,2,1,1,2,0,5,-1,-3,-3,6,0,0,-1,-1,-1,-1,-1,5,-1
KR_6759469548,420,1,-54,-19,-9,-4,4,0,2,2,4,-2,5,3,-3,7,4,-2,2,0,-1,1,10,0,-4,4,-2,0,-1,-1,-1,-1,-1,5,-1
KR_6751266617,420,-2,31,-25,-1,-1,2,1,-1,4,3,-3,4,1,2,1,3,2,1,3,2,1,15,3,-5,2,-1,0,1,1,-1,1,1,4,-1
KR_6610733129,440,4,67,31,4,2,3,5,1,2,3,2,2,4,-1,2,1,0,1,1,1,5,0,4,-6,2,0,0,1,1,1,1,1,1,-1
KR_6762223992,420,-2,-50,-23,-2,6,1,7,-6,6,0,0,1,1,-1,2,1,-1,1,0,0,-5,-25,-1,-4,5,13,0,1,-1,-1,1,-1,1,-1
KR_6766876116,420,1,33,-16,-2,-2,2,0,3,0,3,-1,2,1,-2,2,0,0,0,0,0,1,-4,-2,-2,4,5,0,0,-1,-1,-1,-1,6,-1
KR_6719650510,440,-6,-22,0,-11,-1,1,0,-1,4,3,-4,4,0,-5,5,0,0,0,0,0,-18,-37,3,-9,6,5,0,-1,-1,1,-1,-1,2,-1
KR_6745494764,420,-2,19,-3,0,-5,5,0,0,1,1,-2,3,1,2,4,6,5,2,7,0,1,11,1,-3,2,3,0,-1,1,-1,-1,-1,1,-1
KR_6756705059,420,-3,-27,-13,-11,-2,3,1,-4,4,0,-3,3,0,-2,2,0,0,2,2,0,-12,-5,0,-5,5,-2,0,-1,-1,1,-1,-1,4,-1
KR_6732734813,420,1,28,-16,5,0,2,2,-4,6,2,2,1,3,2,4,6,5,0,5,0,3,0,-3,0,3,1,0,0,-1,-1,0,-1,5,-1
KR_6741086803,420,-4,-1,-19,-3,3,1,4,-2,2,0,0,0,0,-5,5,0,1,1,2,0,-8,-4,-2,-4,6,-5,0,-1,-1,1,-1,-1,5,-1
KR_6713593159,420,-1,-23,-25,0,-1,2,1,1,1,2,-6,6,0,4,1,5,2,0,2,0,11,-30,4,-7,3,6,0,-2,1,-1,-1,1,2,-1
KR_6760619286,440,-1,-70,-4,-1,-3,3,0,0,2,2,-3,5,2,2,3,5,3,0,3,0,8,0,-3,0,3,0,0,0,1,-1,0,-1,2,-1
KR_6720421573,420,-1,-9,-6,-5,-1,2,1,1,1,2,-4,4,0,-1,1,0,0,1,1,0,-6,-2,0,-2,2,1,0,0,-1,-1,0,-1,5,-1
KR_6703509856,420,-4,-100,-12,-11,0,3,3,0,1,1,1,3,4,-11,12,1,-1,3,2,1,-8,6,-2,0,2,-1,0,-5,-1,-1,-1,1,5,-1
KR_6662176349,420,-3,-43,-12,-4,-1,1,0,2,1,3,-4,5,1,-2,6,4,1,1,2,0,-9,-1,2,-6,4,1,0,0,1,-1,0,1,4,-1
KR_6766607831,440,-1,-32,-16,-6,0,1,1,4,0,4,-3,3,0,-3,7,4,-4,5,1,0,-5,-10,-2,-1,3,2,0,-2,1,-1,-1,-1,3,-1
KR_6764034104,420,-4,-9,-19,-4,-2,2,0,1,2,3,-4,4,0,1,1,2,0,0,0,0,-2,-4,1,-3,2,0,0,0,1,-1,1,-1,2,-1
KR_6750712298,420,-1,-69,8,1,1,3,4,-2,3,1,3,1,4,1,2,3,-2,2,0,0,-2,23,0,-3,3,-4,0,0,0,1,0,1,0,-1
KR_6723264223,420,-2,-15,4,-5,0,4,4,-1,2,1,-1,4,3,-1,2,1,-2,2,0,1,-3,-5,5,-7,2,-3,0,-1,0,-1,-1,1,0,-1
KR_6721428517,420,-4,-50,4,-7,-3,5,2,-1,5,4,2,1,3,-3,3,0,-2,2,0,0,-7,11,0,-3,3,-12,0,-2,0,1,-1,-1,0,-1
KR_6767169900,440,-1,19,0,2,6,0,6,-2,2,0,-1,1,0,0,2,2,-1,1,0,0,-3,2,0,-5,5,0,0,1,-1,-1,1,-1,3,-1
KR_6622767723,420,1,4,-8,2,2,1,3,-2,6,4,0,2,2,0,3,3,2,0,2,0,-2,-3,-4,-1,5,6,0,0,-1,1,0,-1,6,-1
KR_6759378301,440,-1,-7,3,-2,-1,1,0,4,0,4,-3,6,3,-2,2,0,0,1,1,0,1,27,-5,-3,8,-21,0,0,1,1,-1,-1,2,-1
KR_6763988677,420,-2,38,-14,1,2,0,2,-2,4,2,-5,7,2,3,1,4,3,0,3,0,6,2,1,-4,3,-2,0,0,-1,1,0,1,2,-1
KR_6729502624,420,-1,-9,-52,-4,-1,4,3,-3,4,1,2,1,3,-2,4,2,0,0,0,0,-1,10,1,-7,6,-2,0,0,-1,-1,-1,-1,6,-1
KR_6662306627,420,-3,-21,-20,-11,-5,6,1,-2,4,2,-1,1,0,-1,3,2,-2,2,0,0,-7,-170,0,-3,3,1,0,0,-1,-1,0,-1,6,-1
KR_6570141702,420,0,37,-20,-7,-1,1,0,-2,2,0,-8,8,0,2,4,6,2,0,2,-1,-6,-10,-3,-4,7,2,0,0,-1,-1,-1,-1,1,-1
KR_6598181475,440,-4,-37,-13,-12,1,0,1,1,2,3,-2,4,2,-7,7,0,-5,5,0,0,-11,-30,5,-7,2,16,0,-2,1,-1,-1,-1,1,-1
KR_6746095061,420,0,-34,-24,0,1,2,3,-1,1,0,-3,5,2,3,2,5,0,2,2,0,4,3,-1,-4,5,-1,0,-1,-1,-1,-1,1,3,-1
KR_6747503948,440,-4,46,-34,-3,-1,2,1,0,3,3,1,1,2,0,2,2,-3,5,2,0,-1,-1,5,-5,0,0,0,-2,-1,0,-1,1,5,-1
KR_6752047363,420,0,-74,-8,4,-2,2,0,2,3,5,1,2,3,-2,4,2,5,2,7,0,-3,-42,4,-6,2,23,0,0,1,-1,0,-1,6,-1
KR_6762755572,420,2,-39,12,2,-2,2,0,1,1,2,4,0,4,-1,5,4,0,0,0,0,4,-19,3,-6,3,7,0,-1,1,0,-1,1,5,-1
KR_6715695527,440,-4,-26,28,-10,-10,11,1,-2,8,6,0,1,1,4,1,5,-2,2,0,0,-11,-3,-5,-3,8,0,0,0,1,-1,1,-1,5,-1
KR_6738331475,440,-2,27,-28,-16,-10,11,1,5,2,7,-6,8,2,2,1,3,-7,7,0,1,-14,-19,-3,0,3,0,0,0,-1,1,-1,1,3,-1
KR_6740433662,420,-7,-139,-17,-14,-3,4,1,-1,3,2,-7,7,0,-2,3,1,-1,1,0,-1,-2,5,-8,-1,9,3,0,-2,-1,1,-1,-1,5,-1
KR_6750989284,420,-2,-4,3,1,-1,1,0,0,1,1,-2,3,1,4,2,6,0,0,0,0,-1,19,0,-1,1,-18,0,0,0,-1,0,-1,0,-1
KR_6743048899,420,1,40,-11,3,1,0,1,-1,2,1,-3,3,0,6,0,6,0,1,1,0,1,18,-2,-3,5,-1,0,2,-1,1,1,1,6,-1
KR_6466407744,420,0,-5,32,-2,-2,3,1,0,4,4,1,2,3,-3,5,2,2,0,2,0,7,-62,1,-5,4,-20,0,0,-1,1,1,-1,5,-1
KR_6752426193,440,-5,-65,-56,-10,2,0,2,-1,3,2,-6,7,1,-2,5,3,-3,3,0,0,-8,51,0,-3,3,-16,0,-1,-1,-1,-1,1,1,-1
KR_6760241609,420,0,-42,4,2,0,2,2,-1,3,2,2,2,4,2,4,6,-1,3,2,0,8,-3,4,-6,2,2,0,-2,1,-1,-1,-1,5,-1
KR_6703295656,440,-4,-20,-18,-14,2,2,4,-6,8,2,-6,7,1,-5,7,2,1,1,2,0,-12,-8,-4,-1,5,0,0,0,0,0,-1,-1,0,-1
KR_6760433534,420,2,1,-6,7,2,1,3,-1,5,4,3,1,4,5,1,6,-2,3,1,0,4,6,-1,-2,3,-1,0,1,0,0,1,-1,0,-1
KR_6759728263,420,-1,48,22,-4,1,1,2,2,2,4,0,2,2,-4,5,1,-3,3,0,1,-5,-129,-3,-2,5,0,0,0,0,1,0,1,0,-1
KR_6699138426,420,-2,-46,-31,-1,-3,4,1,3,2,5,-1,4,3,-1,3,2,1,1,2,-1,-3,188,0,-3,3,-1,0,-1,-1,1,-1,-1,2,-1
KR_6700939146,420,-6,-14,-40,-11,-4,4,0,-6,6,0,-4,4,0,3,0,3,0,1,1,0,-3,-7,-1,-2,3,2,0,-1,-1,-1,-1,1,2,-1
KR_6753032794,440,-3,-43,-4,-11,-1,3,2,-1,3,2,-2,3,1,-5,7,2,-2,2,0,0,-6,8,4,-6,2,-1,0,-2,1,-1,-1,1,1,-1
KR_6756082712,420,0,-30,-32,4,1,1,2,2,3,5,1,0,1,-4,9,5,4,0,4,0,3,-6,-1,-1,2,-1,0,-1,-1,0,-1,1,3,-1
KR_6737451474,420,-1,-11,12,-2,2,2,4,3,0,3,-3,7,4,7,0,7,-11,11,0,1,2,-4,5,-5,0,-1,0,-2,1,-1,-1,1,1,-1
KR_6756988343,420,0,54,10,-1,1,0,1,-2,4,2,1,1,2,-1,4,3,0,1,1,0,-3,13,4,-6,2,-2,0,-2,-1,-1,-1,-1,4,-1
KR_6747553043,420,-4,-52,40,-12,-1,1,0,-2,2,0,-1,1,0,-4,5,1,-4,4,0,0,-13,-27,1,-5,4,-3,0,-2,1,1,-1,-1,4,-1
KR_6595142472,420,0,37,15,-13,1,2,3,-6,8,2,-3,5,2,-8,10,2,3,1,4,0,-10,-5,-6,-2,8,3,0,-1,-1,-1,-1,1,3,-1
KR_6752604531,420,-4,-80,-7,1,1,1,2,0,3,3,0,1,1,-1,5,4,1,1,2,1,2,-344,0,-4,4,29,0,0,-1,0,0,1,3,-1
KR_6721661649,440,-3,-15,5,-4,-1,5,4,-3,8,5,-1,4,3,2,4,6,-1,4,3,3,3,-10,-2,-4,6,-3,0,1,1,1,1,1,4,-1
KR_6678492012,420,-2,1,-18,-1,-7,8,1,3,2,5,3,1,4,-1,3,2,1,3,4,0,5,45,-1,-4,5,-25,0,-1,-1,-1,-1,-1,2,-1
KR_6736842779,440,0,-63,-3,3,-4,7,3,2,2,4,2,0,2,2,1,3,1,3,4,-1,2,-1,2,-5,3,-2,0,0,1,1,0,-1,1,-1
KR_6662813050,420,-5,-97,-14,-8,-4,4,0,-5,6,1,1,0,1,1,0,1,-1,1,0,0,-9,153,0,-6,6,-5,0,-2,-1,0,-1,-1,6,-1
KR_6722994279,420,2,-93,0,4,1,1,2,0,1,1,-1,1,0,3,0,3,1,1,2,0,9,37,-2,-4,6,3,0,-1,0,-1,-1,-1,0,-1
KR_6722376890,420,-1,-23,-24,-6,0,2,2,-4,4,0,1,3,4,1,3,4,-4,4,0,0,-11,-7,-6,-3,9,-3,0,0,-1,1,0,-1,4,-1
KR_6724096576,420,1,-17,-12,5,-3,5,2,1,1,2,5,2,7,1,3,4,1,2,3,0,9,-16,1,-3,2,1,0,1,-1,1,1,1,5,-1
KR_6767337944,420,-4,15,12,-5,2,0,2,1,2,3,3,0,3,-8,8,0,-3,4,1,0,-9,6,4,-8,4,-2,0,0,-1,1,0,-1,6,-1
KR_6744455604,420,-7,-140,-16,-13,-8,8,0,-4,6,2,1,0,1,-2,3,1,0,0,0,0,-3,25,1,-4,3,-2,0,-2,0,0,-1,-1,0,-1
KR_6746807166,420,-4,-54,-24,-5,-6,7,1,-2,5,3,-4,5,1,2,1,3,5,2,7,0,-1,-6,0,-1,1,1,0,-1,-1,-1,-1,-1,2,-1
KR_6768093586,420,-2,-26,32,-10,-8,8,0,-3,3,0,-4,5,1,3,1,4,2,0,2,0,-5,-268,0,-4,4,-1,0,-1,-1,-1,-1,-1,3,-1
KR_6765318600,420,-1,1,-2,-3,4,0,4,-2,5,3,-4,7,3,-4,5,1,3,0,3,0,0,-2,-4,-2,6,3,0,0,-1,0,1,-1,5,-1
KR_6754480543,440,-7,-72,-36,-11,-7,7,0,4,0,4,-4,4,0,-6,7,1,2,0,2,-3,-5,-8,-1,-4,5,-2,0,-2,-1,-1,-1,-1,1,-1
KR_6756819486,420,-2,-85,44,-5,-5,6,1,-2,2,0,2,3,5,0,2,2,0,1,1,0,-7,113,2,-5,3,-4,0,-2,1,-1,-1,-1,6,-1
KR_6763942793,420,-2,-37,-1,-10,0,3,3,-3,5,2,2,1,3,-8,8,0,-1,1,0,0,-6,4,-1,-3,4,-3,0,-1,-1,-1,-1,-1,4,-1
KR_6690365855,420,-2,14,-36,-7,3,3,6,0,4,4,-4,4,0,-3,4,1,-3,4,1,-1,-3,-23,-3,-3,6,1,0,-1,0,-1,-1,-1,0,-1
KR_6747919194,420,1,25,0,2,1,2,3,-1,1,0,1,0,1,3,1,4,-2,2,0,0,1,-11,-5,-2,7,7,0,0,-1,1,0,-1,1,-1
KR_6723137149,420,-1,-21,0,-8,0,0,0,-1,6,5,-6,6,0,1,1,2,-2,4,2,0,-5,-2,0,-3,3,1,0,-1,0,-1,-1,1,0,-1
KR_6754879393,420,2,-34,24,2,0,2,2,3,1,4,-2,3,1,3,1,4,-2,2,0,-1,1,-9,0,-3,3,1,0,-1,1,-1,-1,-1,1,-1
KR_6763345348,420,-2,-1,-4,-7,-4,7,3,-2,2,0,-3,4,1,1,4,5,1,0,1,0,-2,20,2,-7,5,0,0,-3,-1,-1,-1,-1,3,-1
KR_6747501023,440,-3,-33,-28,-11,-2,2,0,-7,8,1,-4,4,0,5,0,5,-3,7,4,0,-8,10,3,-7,4,-1,0,0,-1,0,0,-1,4,-1
KR_6751807208,420,3,54,15,10,10,1,11,1,1,2,2,0,2,-1,1,0,-2,3,1,0,-4,4,4,-5,1,1,0,1,1,-1,1,1,6,-1
KR_6699287563,420,-5,-55,-32,-14,-3,4,1,-8,8,0,-4,6,2,1,2,3,0,0,0,0,-11,7,-1,-3,4,-2,0,0,-1,-1,-1,1,2,-1
KR_6738664222,420,-5,-87,-44,-14,-5,6,1,-1,4,3,-7,8,1,-3,5,2,2,0,2,0,-5,-37,1,-2,1,-2,0,-1,0,1,-1,-1,0,-1
KR_6739617945,420,-5,-1,-124,-13,1,1,2,-9,10,1,-2,4,2,-6,7,1,3,2,5,0,-12,-6,-6,-1,7,4,0,-2,-1,-1,-1,1,2,-1
KR_6615719692,420,0,-9,-36,-2,2,1,3,-1,2,1,-2,5,3,-1,3,2,0,0,0,-1,-6,131,-3,-1,4,-4,0,-1,-1,-1,-1,-1,4,-1
KR_6752675425,420,-3,-3,-32,-5,-1,2,1,-4,8,4,-2,7,5,1,2,3,1,3,4,0,-6,-39,3,-8,5,16,0,-1,1,-1,-1,-1,3,-1
KR_6732060533,420,0,2,-24,-9,0,1,1,-2,2,0,1,2,3,-5,7,2,-3,4,1,-1,-9,-14,-1,-3,4,1,0,-1,1,1,-1,-1,5,-1
KR_6759162603,420,-6,-18,-10,-26,-4,8,4,-6,7,1,-5,6,1,-7,7,0,-4,4,0,0,-16,-14,-7,0,7,1,0,-1,-1,-1,-1,-1,1,-1
KR_6730787210,420,-3,-66,-28,-3,-2,2,0,-1,4,3,-3,4,1,2,0,2,1,0,1,0,5,9,0,-5,5,1,0,-1,-1,1,-1,-1,5,-1
KR_6751290867,420,-3,-95,-35,-7,-2,5,3,-2,4,2,1,5,6,-5,6,1,1,1,2,0,6,0,-2,-1,3,-4,0,-2,-1,0,-1,-1,3,-1
KR_6695592081,420,-9,-136,-30,-23,-7,7,0,0,2,2,-9,10,1,-6,7,1,-1,1,0,-1,-14,-224,0,-4,4,-1,0,-1,-1,-1,-1,-1,1,-1
KR_6768451253,420,-4,-28,-16,-1,-1,3,2,1,2,3,6,0,6,-6,7,1,-1,1,0,0,4,-4,-2,-1,3,-3,0,-2,-1,0,-1,1,1,-1
KR_6767413728,420,-1,12,33,-5,5,0,5,3,1,4,-3,3,0,-1,3,2,-9,11,2,0,-15,-42,0,-5,5,22,0,0,1,1,1,-1,1,-1
KR_6761248508,420,-2,-32,-18,0,0,1,1,0,2,2,-2,3,1,2,4,6,0,0,0,1,5,2,2,-6,4,-2,0,0,-1,1,0,1,5,-1
KR_6766369569,420,0,24,-6,6,-2,4,2,3,0,3,-1,2,1,5,0,5,1,1,2,0,14,-5,2,-4,2,1,0,1,-1,1,1,1,3,-1
KR_6756398835,440,-4,-89,-11,-11,-3,5,2,-2,4,2,-4,6,2,-6,8,2,4,2,6,-1,-2,-2,-2,-4,6,-5,0,-2,1,-1,-1,1,3,-1
KR_6764075456,420,-1,-12,-2,-3,-1,2,1,0,1,1,1,2,3,-2,2,0,-1,1,0,0,-5,-1,-3,-4,7,1,0,0,0,-1,0,1,0,-1
KR_6594818571,420,-4,-124,-23,-6,-3,3,0,-2,5,3,-1,2,1,-1,1,0,1,0,1,-1,-4,4,2,-5,3,0,0,-1,1,1,-1,1,2,-1
KR_6742577180,420,-5,4,3,-13,1,3,4,-3,3,0,-2,4,2,-8,9,1,-1,2,1,0,-14,-4,-7,-1,8,0,0,-1,1,0,-1,-1,6,-1
KR_6617758743,420,-3,-41,-24,-6,1,0,1,-2,5,3,-3,4,1,-2,3,1,0,2,2,0,-3,7,-3,-3,6,-3,0,-2,-1,-1,-1,-1,4,-1
KR_6764447411,420,-5,-42,-8,-13,-1,3,2,-3,3,0,-4,4,0,-2,8,6,-3,4,1,-1,-13,-9,-3,-2,5,0,0,-2,-1,1,-1,-1,4,-1
KR_6755975300,420,1,34,39,-2,2,2,4,-1,1,0,-5,5,0,1,1,2,1,0,1,0,-5,-5,0,-4,4,3,0,-1,1,0,-1,1,6,-1
KR_6728634207,440,-3,55,-5,-5,-2,3,1,-6,10,4,1,2,3,0,4,4,2,1,3,-1,0,5,5,-5,0,-1,0,1,0,0,1,-1,0,-1
KR_6485547019,420,-1,51,32,6,-4,4,0,-5,6,1,2,1,3,10,1,11,3,3,6,2,10,1,1,-5,4,1,0,0,-1,-1,1,1,5,-1
KR_6746702401,420,-4,-114,-23,-7,-9,9,0,0,1,1,-1,2,1,5,2,7,-2,2,0,0,-5,15,2,-5,3,-1,0,-2,-1,-1,-1,-1,2,-1
KR_6752448093,420,-3,-33,-6,-6,0,2,2,-2,3,1,1,0,1,-4,4,0,-1,1,0,0,-5,-12,-1,-6,7,-2,0,0,-1,1,0,-1,3,-1
KR_6760496642,420,2,48,-11,3,4,1,5,-2,3,1,0,2,2,1,2,3,0,1,1,0,0,1,1,-3,2,-2,0,1,1,1,1,1,4,-1
KR_6641186470,420,0,-55,42,-3,-1,2,1,-2,4,2,2,4,6,0,1,1,-2,3,1,0,3,1,0,-4,4,-5,0,1,-1,1,1,-1,2,-1
KR_6757569946,420,2,-17,4,3,2,1,3,1,1,2,-2,6,4,5,2,7,-3,3,0,-1,6,-20,-1,-4,5,4,0,1,1,1,1,-1,3,-1
KR_6719750083,420,-1,14,7,-3,7,0,7,-3,3,0,3,0,3,-8,8,0,-2,3,1,0,-11,-2,1,-3,2,-3,0,-1,-1,-1,-1,-1,3,-1
KR_6760338879,420,2,55,31,-4,3,1,4,-1,1,0,-3,3,0,-1,3,2,-2,2,0,-1,-10,40,-5,-3,8,-12,0,0,0,-1,1,-1,0,-1
KR_6647880491,420,-5,12,-24,-13,-1,2,1,-3,4,1,-5,6,1,-4,6,2,0,2,2,0,-10,7,3,-6,3,0,0,-2,-1,-1,-1,1,5,-1
KR_6704681774,440,-4,11,0,-14,-3,3,0,-3,4,1,-8,8,0,0,1,1,0,2,2,-1,-19,6,-1,-3,4,-2,0,0,1,1,0,-1,1,-1
KR_6749124902,420,-1,-1,-12,-1,-5,5,0,2,1,3,0,5,5,2,1,3,0,1,1,-1,-3,75,-2,-2,4,4,0,0,-1,-1,1,-1,2,-1
KR_6760505682,420,-3,-26,-4,-10,-3,3,0,1,0,1,-1,3,2,-4,5,1,-3,4,1,-1,-13,-8,1,-2,1,0,0,-1,-1,0,-1,-1,3,-1
KR_6746792063,420,-3,27,10,-15,-1,2,1,0,2,2,-5,5,0,-7,9,2,-2,4,2,0,-2,17,0,-5,5,-3,0,-1,-1,-1,-1,-1,3,-1
KR_6750707173,420,0,-3,-24,-2,-1,2,1,1,2,3,-3,4,1,2,1,3,-1,1,0,0,0,-2,2,-6,4,-5,0,-1,-1,1,-1,-1,1,-1
KR_6766638044,420,1,38,-12,-3,5,0,5,-2,3,1,-6,6,0,-1,2,1,1,1,2,0,-3,0,-1,-5,6,-1,0,-1,-1,0,-1,-1,5,-1
KR_6765716388,420,-5,0,-44,-4,-1,3,2,-6,8,2,-2,3,1,5,1,6,0,0,0,1,-5,-12,0,-4,4,0,0,-1,1,0,1,1,5,-1
KR_6734708645,420,-2,-17,-44,1,1,1,2,-2,2,0,1,2,3,0,2,2,1,0,1,0,0,-3,3,-7,4,2,0,0,-1,1,1,-1,4,-1
KR_6768458209,420,0,-10,-8,-3,1,2,3,-1,5,4,0,1,1,-5,6,1,2,3,5,0,-8,0,1,-4,3,-5,0,-1,-1,1,-1,1,2,-1
KR_6755024730,420,-3,-29,-23,-6,0,2,2,3,2,5,-5,6,1,-2,3,1,-2,2,0,0,-6,241,4,-6,2,-3,0,0,0,-1,-1,-1,0,-1
KR_6752290372,420,-1,-8,-4,-7,-1,5,4,1,5,6,-4,4,0,-5,6,1,2,1,3,-1,-9,-9,-4,-4,8,3,0,0,-1,1,-1,-1,5,-1
KR_6623903916,420,-4,-145,-40,-4,1,0,1,-1,3,2,0,2,2,0,1,1,-4,4,0,0,-3,-3,-4,-2,6,0,0,-2,-1,-1,-1,-1,3,-1
KR_6726574927,420,-2,-82,1,-6,-3,4,1,0,3,3,-5,9,4,-3,3,0,5,0,5,0,6,2,3,-8,5,-4,0,0,-1,0,-1,-1,1,-1
KR_6682739459,420,-4,-27,-56,-8,3,2,5,-5,7,2,-7,10,3,2,3,5,-1,1,0,0,-2,-11,-1,-3,4,-1,0,-1,-1,1,-1,-1,1,-1
KR_6724657625,440,3,25,-24,2,1,1,2,2,2,4,-4,5,1,1,4,5,2,0,2,2,-4,-3,-3,-1,4,0,0,1,-1,0,1,1,6,-1
KR_6764658777,420,-2,-16,-4,-6,-5,5,0,-5,6,1,0,2,2,4,4,8,0,0,0,0,-2,-3,1,-4,3,0,0,-1,-1,-1,-1,-1,6,-1
KR_6684674130,420,-1,-81,4,-4,-5,7,2,1,1,2,3,0,3,-4,4,0,1,0,1,-1,2,-2,-2,-4,6,-5,0,-1,1,0,-1,-1,2,-1
KR_6761953470,420,-2,-112,4,2,-1,2,1,0,2,2,0,0,0,0,4,4,3,1,4,1,3,-39,-2,-5,7,21,0,-2,-1,1,-1,1,4,-1
KR_6756667168,420,-2,-50,19,-6,-2,3,1,2,0,2,-1,3,2,-3,3,0,-2,3,1,0,-5,-8,-2,-1,3,-4,0,-1,-1,-1,-1,-1,5,-1
KR_6726657617,420,-4,-29,-7,-3,-5,5,0,2,1,3,-3,4,1,2,1,3,1,0,1,0,2,6,0,-4,4,-1,0,-1,1,-1,-1,-1,5,-1
KR_6706111076,420,-4,-98,-7,-6,-3,5,2,-1,5,4,0,2,2,1,1,2,-3,3,0,0,1,-19,5,-6,1,-9,0,-3,-1,-1,-1,-1,3,-1
KR_6762493813,420,-3,-81,-19,4,1,1,2,1,1,2,-4,6,2,4,1,5,2,3,5,0,3,-8,-5,-3,8,-1,0,0,-1,-1,-1,1,3,-1
KR_6761319906,420,-4,-44,-1,-6,1,1,2,-5,7,2,0,0,0,-3,6,3,1,1,2,2,-4,-7,-9,-1,10,3,0,-1,1,-1,-1,1,4,-1
KR_6765275088,420,-1,-38,-44,2,-1,2,1,2,2,4,-5,6,1,5,1,6,1,2,3,0,10,-18,2,-6,4,0,0,-1,-1,-1,-1,1,4,-1
KR_6691874072,420,-7,-108,-20,-18,-8,8,0,-4,6,2,1,1,2,-6,6,0,-1,1,0,0,-17,13,-4,-6,10,2,0,-1,0,1,-1,1,0,-1
KR_6671425572,420,1,19,-4,-1,0,2,2,4,1,5,-2,5,3,-3,4,1,0,1,1,0,0,-184,-2,-3,5,2,0,0,-1,-1,-1,1,2,-1
KR_6763925271,420,-7,-44,4,-3,-2,3,1,-1,4,3,-1,4,3,0,2,2,1,0,1,-1,1,-1,-1,-5,6,-2,0,0,-1,1,0,-1,2,-1
KR_6752139746,440,-3,-50,7,-13,1,1,2,-7,7,0,3,1,4,-9,10,1,-1,2,1,0,-16,-7,-5,-3,8,0,0,-2,-1,0,-1,-1,6,-1
KR_6762627330,420,1,-57,4,5,0,1,1,4,0,4,0,3,3,2,0,2,-1,2,1,0,12,-1,0,-4,4,-3,0,-2,1,-1,-1,-1,6,-1
KR_6764752668,440,0,11,23,-4,3,1,4,5,0,5,-2,4,2,-8,11,3,-2,3,1,0,-1,9,-6,-4,10,6,0,0,-1,1,1,-1,2,-1
KR_6762969123,420,-5,-11,-8,-12,-6,8,2,0,3,3,-1,3,2,-1,6,5,-4,5,1,1,-2,-21,5,-6,1,1,0,-2,-1,0,-1,1,5,-1
KR_6569677923,440,-3,-32,-31,-5,2,0,2,-3,7,4,-2,5,3,0,2,2,-2,2,0,0,-1,-10,-4,-3,7,-1,0,-1,-1,1,-1,1,4,-1
KR_6583951739,420,1,0,-17,1,-2,3,1,0,3,3,-1,3,2,2,1,3,2,1,3,0,4,1,-3,-2,5,1,0,-1,-1,1,-1,1,4,-1
KR_6751173114,420,-1,-34,-8,0,-1,1,0,0,1,1,1,3,4,-1,3,2,1,0,1,-1,-4,-131,1,-5,4,3,0,0,0,0,0,-1,0,-1
KR_6665110516,420,2,28,-1,0,0,3,3,-3,3,0,0,5,5,3,2,5,0,2,2,-1,-11,6,1,-5,4,1,0,1,-1,1,1,-1,3,-1
KR_6762420150,420,0,24,-28,2,4,0,4,0,3,3,-2,3,1,0,2,2,0,1,1,0,2,-14,1,-9,8,-2,0,0,-1,-1,-1,-1,1,-1
KR_6720343893,420,-3,-17,-40,-7,-5,5,0,-5,5,0,1,1,2,-1,2,1,3,0,3,0,-3,6,-3,-5,8,3,0,0,-1,-1,0,-1,4,-1
KR_6765539109,420,-2,-7,24,-3,-4,4,0,1,3,4,0,1,1,0,5,5,0,0,0,-1,3,-44,-2,-4,6,9,0,0,1,1,-1,-1,2,-1
KR_6703536729,420,-8,-134,-76,-12,-1,2,1,0,1,1,-6,7,1,-6,7,1,1,0,1,0,-10,-17,-6,-2,8,0,0,-3,-1,-1,-1,-1,1,-1
KR_6738150494,440,-2,11,2,0,-1,2,1,-2,4,2,2,2,4,1,2,3,0,0,0,0,-1,-3,-4,-2,6,3,0,1,1,-1,1,-1,2,-1
KR_6749969952,420,3,58,13,6,7,0,7,5,1,6,-2,2,0,-5,9,4,1,1,2,0,-5,7,6,-9,3,-6,0,1,-1,-1,1,-1,3,-1
KR_6758378791,440,0,-13,-22,-4,-1,2,1,-2,2,0,5,0,5,-8,9,1,2,1,3,0,-4,4,-4,-3,7,-6,0,0,-1,1,-1,-1,2,-1
KR_6609917619,420,0,10,-8,0,-1,1,0,-2,5,3,1,0,1,1,3,4,1,1,2,0,2,-1,-4,-1,5,4,0,0,-1,0,0,-1,5,-1
KR_6758738081,420,-4,-102,-52,-4,0,2,2,-2,5,3,1,0,1,-2,4,2,-1,3,2,0,3,0,1,-5,4,4,0,-1,1,-1,-1,-1,3,-1
KR_6673936050,420,-1,40,0,-1,-4,6,2,2,2,4,0,1,1,0,2,2,1,0,1,-1,2,-5,-2,-2,4,5,0,0,-1,-1,0,-1,4,-1
KR_6766864298,420,1,-27,22,-4,2,3,5,2,0,2,0,2,2,-4,5,1,-4,4,0,0,-5,0,-3,-1,4,0,0,-1,-1,1,-1,-1,4,-1
KR_6758448076,420,-6,-49,-16,-10,-4,6,2,-2,3,1,0,2,2,-5,7,2,1,0,1,0,-5,1,4,-4,0,-1,0,-1,-1,1,-1,-1,3,-1
KR_6762054189,420,-1,-13,-20,-1,1,2,3,-1,1,0,0,0,0,1,3,4,-2,2,0,0,-4,168,4,-6,2,-7,0,-1,1,-1,-1,1,4,-1
KR_6624676264,420,0,-29,-28,2,-1,1,0,2,4,6,-2,4,2,1,6,7,2,0,2,1,8,-21,-1,-2,3,4,0,0,-1,0,0,1,5,-1
KR_6760547819,420,0,-11,20,2,3,1,4,1,3,4,0,1,1,-2,3,1,0,2,2,0,-4,247,0,-5,5,-1,0,0,-1,0,1,1,3,-1
KR_6724109203,420,2,28,10,-3,-1,3,2,-1,4,3,-1,2,1,-4,6,2,4,1,5,0,-5,-13,-6,-2,8,4,0,2,1,1,1,1,5,-1
KR_6623204518,420,-2,-22,-24,-3,-1,1,0,3,2,5,-2,4,2,-1,6,5,-2,2,0,0,-5,-12,-5,-1,6,-2,0,1,-1,1,1,-1,4,-1
KR_6730863773,420,-8,-77,-36,-20,0,0,0,-4,5,1,-4,5,1,-8,8,0,-4,4,0,0,-14,-2,-4,-2,6,-5,0,-1,-1,0,-1,-1,5,-1
KR_6573242327,420,0,-40,8,1,-2,2,0,3,2,5,-2,3,1,0,3,3,2,1,3,0,6,-6,-1,-4,5,-6,0,-1,-1,-1,-1,-1,3,-1
KR_6647324181,420,0,63,-20,0,-1,2,1,1,2,3,-5,5,0,2,0,2,3,2,5,0,7,19,-2,-1,3,-4,0,-1,1,-1,-1,-1,1,-1
KR_6758605696,420,-2,-64,-12,-4,0,1,1,-2,5,3,-1,3,2,0,2,2,-1,1,0,0,-5,-6,-1,-3,4,0,0,-1,-1,-1,-1,-1,4,-1
KR_6765743434,420,-5,5,-23,-14,0,1,1,-4,5,1,-3,3,0,-1,3,2,-6,6,0,-1,-11,-5,-3,-5,8,2,0,-2,-1,-1,-1,-1,1,-1
KR_6722041325,420,3,36,4,6,1,0,1,0,3,3,3,1,4,2,3,5,0,1,1,1,3,3,1,-6,5,-1,0,1,0,1,1,1,0,-1
KR_6713487099,420,3,41,-5,4,-2,2,0,2,4,6,0,2,2,1,0,1,3,0,3,0,3,4,0,-7,7,5,0,1,-1,-1,1,1,5,-1
KR_6724026675,420,-2,19,-4,-1,0,2,2,0,5,5,-3,5,2,1,2,3,1,2,3,0,-9,-22,-4,-2,6,-2,0,0,-1,1,0,1,6,-1
KR_6762761283,420,-3,-38,10,-9,2,3,5,-3,6,3,-4,5,1,-1,3,2,-3,3,0,0,-12,138,0,-3,3,-2,0,-1,-1,1,-1,1,4,-1
KR_6596676373,420,-5,-62,12,-6,2,0,2,0,2,2,2,3,5,-6,6,0,-4,4,0,0,-6,-36,6,-6,0,15,0,-2,-1,1,-1,1,3,-1
KR_6754371680,420,0,-71,-16,-5,0,3,3,1,0,1,-2,3,1,-4,6,2,0,2,2,0,-2,-3,-1,-4,5,2,0,-3,1,1,-1,-1,6,-1
KR_6754834702,420,-3,-60,-44,-8,-2,5,3,-3,4,1,-1,5,4,-1,2,1,-1,1,0,0,-6,1,-1,-1,2,0,0,-2,-1,1,-1,-1,2,-1
KR_6671363576,420,-3,-9,16,-10,-8,8,0,2,0,2,-2,4,2,-3,4,1,1,2,3,0,-8,21,-1,-2,3,1,0,-1,-1,-1,-1,-1,5,-1
KR_6733601817,420,0,-26,-40,-3,1,1,2,5,5,10,-1,1,0,-6,7,1,-2,2,0,0,-1,1,-5,-5,10,0,0,-3,-1,-1,-1,1,3,-1
KR_6736989399,420,0,-12,-8,-7,-2,4,2,3,1,4,-7,9,2,3,3,6,-4,5,1,-1,-7,2,6,-8,2,3,0,-1,1,-1,-1,-1,3,-1
KR_6758120217,440,1,-69,-6,7,1,0,1,-1,2,1,-2,2,0,4,1,5,5,0,5,0,7,-41,2,-5,3,16,0,-2,1,-1,-1,1,5,-1
KR_6761569640,440,0,14,11,0,-1,2,1,2,3,5,2,1,3,0,0,0,-3,5,2,0,-7,-56,3,-8,5,36,0,0,-1,-1,1,1,3,-1
KR_6700518767,420,0,30,-23,-3,2,2,4,-5,5,0,1,2,3,-2,5,3,1,1,2,1,-3,1,5,-8,3,0,0,2,1,1,1,1,4,-1
KR_6750578217,420,-1,10,4,-7,1,1,2,-3,4,1,-3,5,2,-1,5,4,-1,3,2,0,-1,-6,1,-5,4,-2,0,0,-1,-1,0,-1,1,-1
KR_6401596128,420,-4,-60,-48,-7,2,0,2,-6,8,2,-2,2,0,0,7,7,-1,4,3,0,-7,-5,1,-6,5,-6,0,-1,-1,-1,-1,1,4,-1
KR_6767682756,440,-3,-37,-4,1,3,3,6,0,2,2,0,0,0,0,2,2,-2,2,0,0,0,-83,5,-6,1,-1,0,-1,1,-1,-1,-1,2,-1
KR_6752072504,420,-2,-21,4,-6,0,0,0,-5,7,2,0,1,1,-2,4,2,1,1,2,0,-3,4,3,-8,5,-3,0,0,-1,-1,0,-1,6,-1
KR_6727263787,420,-3,-97,-20,-7,-1,1,0,-3,4,1,-1,3,2,-2,2,0,0,0,0,0,-4,1,0,-2,2,-2,0,-2,-1,1,-1,-1,2,-1
KR_6763812502,440,3,16,6,4,-2,4,2,-1,5,4,3,2,5,5,0,5,-1,2,1,0,6,-4,2,-5,3,-4,0,1,1,-1,1,1,4,-1
KR_6594829977,420,-5,-83,7,-14,-2,2,0,-6,7,1,0,1,1,-6,8,2,0,1,1,0,-21,19,-4,-6,10,-23,0,-2,-1,-1,-1,-1,2,-1
KR_6731420948,420,-4,-93,-16,-11,-8,8,0,-2,3,1,1,0,1,-2,3,1,0,2,2,0,-6,-2,2,-5,3,-2,0,-1,1,0,-1,-1,6,-1
KR_6751061211,420,-1,69,2,3,3,1,4,-5,8,3,5,2,7,1,2,3,-1,2,1,0,9,-1,2,-4,2,0,0,2,1,-1,1,1,6,-1
KR_6636143479,420,-1,-12,-12,1,4,0,4,1,3,4,1,0,1,-2,3,1,-3,7,4,0,2,14,0,-3,3,0,0,-1,-1,-1,-1,-1,5,-1
KR_6761701950,420,0,8,28,-2,2,1,3,2,3,5,-7,8,1,0,1,1,1,1,2,0,2,-31,1,-6,5,7,0,-1,-1,-1,-1,-1,2,-1
KR_6768470692,420,-5,-137,-17,-13,-6,7,1,1,0,1,-2,4,2,-3,5,2,-3,5,2,0,-7,244,-5,-3,8,-2,0,-1,-1,1,-1,-1,4,-1
KR_6761233732,420,3,61,17,5,0,4,4,-1,3,2,4,2,6,5,2,7,-3,4,1,1,5,6,0,-3,3,-3,0,-1,-1,-1,-1,1,2,-1
KR_6760316284,420,-9,-95,-14,-17,0,3,3,-1,1,0,-6,8,2,-6,11,5,-4,5,1,1,-10,-22,2,-4,2,4,0,-3,-1,-1,-1,1,4,-1
KR_6739252018,420,-3,-35,-51,-6,2,2,4,-1,3,2,-6,7,1,-1,4,3,0,3,3,0,-4,-2,1,-3,2,-3,0,-1,-1,0,-1,-1,2,-1
KR_6755108771,420,-5,-93,0,-5,0,2,2,3,3,6,-1,4,3,-2,2,0,-5,6,1,0,-3,-1,11,-11,0,-3,0,0,0,1,0,-1,0,-1
KR_6741123081,420,0,9,-4,0,1,3,4,0,5,5,-4,4,0,2,3,5,1,1,2,0,0,-5,0,-2,2,1,0,0,1,0,0,1,2,-1
KR_6755663280,440,2,22,-3,-1,8,2,10,-1,3,2,-4,6,2,-2,2,0,-2,5,3,0,0,3,5,-7,2,5,0,0,0,-1,0,-1,0,-1
KR_6760562844,420,-2,-63,5,-9,3,1,4,3,2,5,-9,10,1,-3,5,2,-3,3,0,0,-5,-7,-11,-1,12,0,0,-2,-1,1,-1,-1,5,-1
KR_6625182295,420,0,-20,11,2,3,0,3,0,3,3,-2,5,3,1,1,2,0,1,1,0,0,-221,-1,-4,5,4,0,0,-1,1,0,-1,6,-1
KR_6482568841,420,1,6,-8,-2,0,1,1,1,2,3,-2,4,2,1,1,2,-2,2,0,0,-2,-46,2,-8,6,-1,0,-1,1,0,-1,1,4,-1
KR_6767808700,420,-3,-55,-5,-10,-2,4,2,-7,7,0,-2,3,1,0,3,3,1,0,1,-1,-9,0,2,-4,2,-2,0,0,-1,-1,0,-1,6,-1
KR_6723574606,420,1,-42,10,-9,-7,8,1,3,2,5,0,1,1,-3,4,1,-2,2,0,-2,-20,7,2,-6,4,4,0,-2,1,-1,-1,-1,3,-1
KR_6768460908,420,-3,17,-8,-8,-1,2,1,-6,6,0,0,2,2,-1,5,4,0,0,0,0,-8,9,2,-6,4,-3,0,0,-1,-1,0,-1,6,-1
KR_6739887935,420,-4,-110,-33,-6,-1,2,1,4,2,6,0,1,1,-10,12,2,1,0,1,0,6,-4,-8,0,8,2,0,-2,-1,-1,-1,-1,4,-1
KR_6751059823,440,2,14,6,0,0,0,0,0,2,2,1,0,1,3,1,4,-4,4,0,0,1,-2,1,-10,9,0,0,0,-1,1,1,1,2,-1
KR_6763298560,420,1,2,-8,0,-2,4,2,0,0,0,2,4,6,0,2,2,0,0,0,0,3,96,1,-6,5,0,0,0,-1,0,0,-1,6,-1
KR_6740094191,440,-3,-83,-44,-4,0,2,2,-1,2,1,-6,8,2,6,2,8,-3,3,0,-1,0,-12,-4,-4,8,-1,0,0,1,1,0,-1,3,-1
KR_6689657920,420,-3,-102,-23,-6,-1,3,2,-2,3,1,1,0,1,-3,4,1,-1,1,0,0,-6,0,-1,-3,4,-1,0,-1,1,1,-1,-1,5,-1
KR_6493316029,420,-4,-63,-16,-8,-1,1,0,-5,7,2,0,3,3,0,2,2,-2,2,0,0,-3,-1,1,-3,2,-1,0,1,1,-1,-1,-1,6,-1
KR_6751476412,440,0,34,-26,-7,4,1,5,-7,9,2,-2,6,4,-2,5,3,0,2,2,2,-3,16,-2,-4,6,0,0,0,-1,1,1,1,5,-1
KR_6764751717,440,-2,15,-16,0,-4,4,0,1,2,3,3,2,5,1,3,4,-1,2,1,0,3,15,2,-6,4,-10,0,0,0,-1,0,1,0,-1
KR_6711292168,420,-3,-58,-3,-7,-2,2,0,-1,1,0,0,2,2,-2,5,3,-2,2,0,0,-6,8,3,-5,2,-3,0,-3,-1,-1,-1,-1,2,-1
KR_6728880715,420,-2,-33,-64,-5,1,0,1,-3,4,1,0,2,2,-2,6,4,-1,4,3,0,-3,-2,-2,-3,5,-4,0,-1,-1,-1,-1,-1,6,-1
KR_6693644940,420,-1,31,4,-12,-3,4,1,-5,6,1,-4,5,1,1,1,2,-1,1,0,0,-11,-2,0,-5,5,-2,0,0,-1,1,0,-1,5,-1
KR_6764451330,420,-3,-79,-8,-9,-1,1,0,-9,9,0,1,2,3,1,2,3,-1,2,1,0,-5,2,1,-4,3,0,0,-1,-1,-1,-1,-1,6,-1
KR_6766805290,420,5,65,32,5,5,1,6,3,2,5,-1,3,2,-1,3,2,-1,2,1,0,10,8,4,-8,4,-1,0,0,1,1,1,-1,1,-1
KR_6767978816,420,0,64,0,3,-1,2,1,1,1,2,3,1,4,0,1,1,0,1,1,0,2,-17,-6,-2,8,5,0,2,0,1,1,1,0,-1
KR_6678133321,420,2,22,18,5,0,1,1,2,2,4,5,1,6,-3,4,1,1,0,1,0,-5,3,2,-4,2,2,0,0,1,-1,0,1,6,-1
KR_6756241235,420,-7,-2,-24,-21,2,1,3,1,1,2,-9,9,0,-9,9,0,-6,6,0,-1,-17,5,-1,-3,4,1,0,-3,-1,1,-1,-1,6,-1
KR_6764132931,420,0,-53,12,-1,1,2,3,-2,7,5,3,2,5,-3,4,1,0,0,0,-1,-13,394,1,-4,3,-4,0,1,1,1,1,-1,6,-1
KR_6631773940,420,2,-34,20,1,1,1,2,-2,3,1,3,1,4,-1,2,1,0,0,0,0,3,286,4,-6,2,16,0,0,-1,-1,-1,1,2,-1
KR_6706352108,420,-3,-52,-4,-4,1,1,2,-3,3,0,0,3,3,-1,3,2,-1,2,1,0,-6,12,-4,-2,6,-4,0,0,-1,0,0,-1,5,-1
KR_6768208756,420,-2,-41,12,-5,0,1,1,-3,5,2,-5,6,1,2,1,3,1,1,2,0,-5,14,0,-3,3,-1,0,0,-1,1,-1,-1,6,-1
KR_6758191310,440,-1,35,-4,-6,-1,3,2,-1,3,2,1,5,6,-1,1,0,-4,6,2,1,-12,2,1,-3,2,2,0,1,-1,1,1,1,2,-1
KR_6747391640,420,-1,-19,12,-3,-4,5,1,0,0,0,0,2,2,-1,4,3,2,1,3,0,-5,36,0,-4,4,-15,0,0,1,1,1,1,3,-1
KR_6573195848,420,-7,-93,-58,-21,-11,11,0,3,3,6,-5,6,1,-7,9,2,-1,6,5,-3,-17,-20,-4,0,4,-5,0,-1,-1,-1,-1,-1,6,-1
KR_6668562069,420,-4,-77,4,-6,-4,5,1,-1,5,4,-1,2,1,-1,5,4,1,2,3,-1,0,-2,-4,-6,10,-1,0,0,1,1,-1,-1,5,-1
KR_6721775494,440,-1,-10,-1,0,-2,6,4,0,4,4,0,2,2,-1,1,0,3,0,3,0,1,-1,-1,-3,4,-2,0,-2,-1,-1,-1,-1,3,-1
KR_6743972889,420,-5,-82,-7,-12,-3,4,1,-4,5,1,0,6,6,-3,3,0,-2,2,0,0,-12,-10,-1,-3,4,1,0,-3,-1,0,-1,-1,6,-1
KR_6766093754,420,-4,-73,2,-9,-7,7,0,2,3,5,-5,5,0,1,1,2,0,0,0,0,-7,4,-2,-3,5,-4,0,-2,-1,-1,-1,-1,5,-1
KR_6764367424,420,-4,-42,-16,-8,-2,2,0,-2,2,0,-1,2,1,-3,6,3,0,0,0,0,-12,17,1,-5,4,2,0,0,-1,-1,1,1,6,-1
KR_6758940007,440,2,16,8,6,2,4,6,-3,5,2,8,0,8,1,4,5,-2,3,1,0,-2,47,0,-3,3,-29,0,1,1,-1,1,-1,2,-1
KR_6767406509,420,-2,-56,-5,-1,-2,4,2,-1,2,1,-1,1,0,2,2,4,1,1,2,0,4,147,1,-4,3,2,0,1,1,-1,1,-1,4,-1
KR_6761205895,440,-2,3,-16,-2,-2,4,2,1,3,4,-1,2,1,0,0,0,0,1,1,0,-3,-1,1,-6,5,-3,0,0,1,-1,0,-1,4,-1
KR_6733864090,420,-3,21,-46,-9,0,3,3,-3,6,3,-5,5,0,1,1,2,-2,4,2,0,-11,-4,1,-6,5,5,0,0,-1,0,-1,-1,5,-1
KR_6719262058,420,-5,-105,-20,-7,-1,2,1,-1,4,3,-3,4,1,-2,3,1,0,1,1,0,-4,-28,4,-7,3,-2,0,-2,-1,-1,-1,-1,5,-1
KR_6744305798,420,1,53,-27,3,-1,2,1,1,2,3,1,1,2,0,2,2,2,1,3,0,8,4,-2,-3,5,3,0,0,0,-1,0,-1,0,-1
KR_6727627235,420,1,-9,-20,8,3,2,5,3,0,3,-1,1,0,-1,1,0,4,1,5,0,11,-10,2,-4,2,4,0,1,-1,1,1,1,5,-1
KR_6757727320,420,-3,-12,7,-2,0,3,3,0,2,2,-3,4,1,2,0,2,-1,1,0,0,7,-3,1,-5,4,-4,0,-1,1,1,-1,-1,6,-1
KR_6706820596,420,2,-24,4,0,1,3,4,0,1,1,-1,3,2,1,3,4,-1,2,1,0,-3,-25,1,-4,3,5,0,1,-1,1,1,-1,1,-1
KR_6767978087,420,0,26,8,-4,0,2,2,-2,5,3,-4,4,0,4,1,5,-2,5,3,0,2,-1,-2,-4,6,-2,0,1,-1,-1,1,-1,2,-1
KR_6751938042,420,-2,-54,15,-4,-5,5,0,1,3,4,6,1,7,-4,5,1,-2,3,1,0,0,247,-5,-1,6,-1,0,-1,1,1,-1,-1,3,-1
KR_6764827868,440,1,3,3,7,1,1,2,3,0,3,2,0,2,0,2,2,1,2,3,0,8,61,0,-5,5,-2,0,1,1,-1,1,1,1,-1
KR_6766656805,420,-1,9,-28,-5,2,1,3,-2,3,1,1,0,1,-4,5,1,-2,3,1,0,-8,-11,-3,-4,7,4,0,-1,-1,1,-1,-1,6,-1
KR_6724935163,420,1,-2,-26,5,0,3,3,-1,4,3,6,0,6,1,2,3,-1,2,1,1,5,-13,4,-6,2,-2,0,0,1,0,-1,1,4,-1
KR_6763721717,420,3,9,4,6,7,0,7,-1,2,1,4,2,6,-1,3,2,-3,3,0,0,-8,10,3,-5,2,0,0,1,1,-1,1,1,1,-1
KR_6735908454,440,-5,-136,0,-14,-3,4,1,-7,8,1,-1,3,2,-2,6,4,-1,1,0,-1,-14,5,2,-6,4,3,0,-3,-1,-1,-1,-1,2,-1
KR_6744959480,420,-6,-35,-24,-12,-9,9,0,-3,7,4,-1,4,3,2,0,2,-1,3,2,0,-6,-2,-3,-2,5,0,0,-2,1,-1,-1,1,1,-1
KR_6626387985,420,0,15,-23,0,2,1,3,-6,7,1,6,3,9,0,4,4,-2,4,2,1,-1,5,3,-3,0,0,0,1,1,0,1,-1,5,-1
KR_6764015289,420,-4,4,-6,-8,-1,2,1,-1,3,2,1,1,2,-2,5,3,-5,5,0,-2,-10,30,0,-2,2,-3,0,-1,-1,1,-1,-1,2,-1
KR_6752328717,420,0,-31,-12,3,6,0,6,1,2,3,-2,4,2,-2,2,0,0,3,3,0,6,-24,4,-5,1,0,0,-2,1,-1,-1,-1,1,-1
KR_6757956570,420,-3,-28,-16,-4,0,1,1,-5,6,1,2,1,3,0,4,4,-1,1,0,0,-5,3,-4,-3,7,-5,0,-1,-1,0,-1,1,2,-1
KR_6745474839,420,0,-23,-12,1,2,1,3,2,0,2,4,3,7,-4,5,1,-3,3,0,0,-6,6,0,-3,3,-1,0,0,-1,1,1,1,6,-1
KR_6767615970,420,-2,-89,20,-12,2,1,3,-7,7,0,-4,5,1,-4,4,0,1,1,2,0,-9,-49,-5,-3,8,17,0,-2,-1,1,-1,-1,5,-1
KR_6751653754,420,-5,-21,-60,-10,-1,2,1,-2,2,0,-3,4,1,-3,4,1,-1,2,1,0,-9,1,2,-4,2,-5,0,-1,-1,-1,-1,-1,2,-1
KR_6679521102,420,1,8,16,1,2,0,2,-4,4,0,-3,3,0,1,0,1,5,1,6,1,9,83,4,-7,3,3,0,0,-1,-1,1,1,3,-1
KR_6760645060,420,-2,-8,-24,1,2,0,2,0,4,4,3,1,4,-1,4,3,-3,3,0,0,3,2,3,-6,3,-1,0,1,0,1,1,-1,0,-1
KR_6755059829,420,0,-8,4,0,-3,4,1,0,0,0,-1,1,0,3,0,3,1,1,2,0,7,-5,-5,-3,8,-1,0,-1,0,-1,-1,-1,0,-1
KR_6760251287,420,-1,28,41,-5,-1,3,2,-5,5,0,2,1,3,1,1,2,-2,2,0,-1,-10,-9,-6,-2,8,0,0,-2,1,-1,-1,-1,3,-1
KR_6731469374,420,-2,-2,-12,-12,-3,4,1,2,1,3,-3,3,0,-2,4,2,-6,6,0,0,-13,1,-3,-6,9,-2,0,-1,1,-1,-1,1,6,-1
KR_6726003436,440,4,51,18,2,1,1,2,2,2,4,-3,4,1,-1,3,2,3,0,3,0,-2,-116,-1,-4,5,0,0,0,-1,-1,-1,-1,5,-1
KR_6762213429,420,1,61,4,-2,1,2,3,-3,4,1,5,2,7,-2,3,1,-3,4,1,0,-11,23,2,-4,2,0,0,3,-1,1,1,-1,4,-1
KR_6758792169,440,-4,-26,15,-12,1,4,5,-1,5,4,-5,7,2,-4,6,2,-3,3,0,0,-12,-30,-1,-2,3,-1,0,1,1,1,1,-1,6,-1
KR_6766791452,420,-4,-8,8,-9,-1,1,0,-1,3,2,-4,8,4,-6,6,0,3,1,4,0,-13,-8,-3,-3,6,2,0,0,-1,1,0,1,2,-1
KR_6768410465,420,1,47,20,0,4,1,5,6,1,7,-7,7,0,-2,5,3,-1,1,0,-2,-10,13,1,-6,5,2,0,0,1,-1,1,-1,6,-1
KR_6727652401,420,0,-53,0,-3,0,1,1,-2,7,5,-1,3,2,-1,2,1,1,1,2,-1,-7,19,1,-6,5,6,0,0,-1,1,0,-1,6,-1
KR_6508691331,420,0,-25,13,-3,0,0,0,-5,7,2,2,0,2,0,1,1,0,1,1,-1,-13,-38,-1,-3,4,2,0,0,-1,-1,0,-1,3,-1
KR_6654592757,420,-5,8,-20,-7,-3,4,1,1,2,3,-6,6,0,2,2,4,-1,1,0,0,-2,-117,2,-6,4,-1,0,-1,-1,-1,-1,-1,3,-1
KR_6749289909,420,1,-19,8,2,-1,4,3,1,6,7,0,0,0,1,2,3,1,2,3,0,5,234,0,-3,3,2,0,1,-1,1,1,1,6,-1
KR_6765724732,440,-2,-7,9,-6,0,2,2,-6,6,0,-1,2,1,1,5,6,0,1,1,0,-6,-204,-4,-3,7,-2,0,0,-1,-1,0,1,3,-1
KR_6757072971,420,0,-40,5,-3,-4,4,0,-1,2,1,-2,4,2,1,6,7,3,0,3,-1,-4,-31,-9,0,9,1,0,0,0,-1,1,-1,0,-1
KR_6611865045,440,-2,-56,0,-6,-4,5,1,0,5,5,-3,4,1,2,0,2,-1,1,0,0,1,-14,-5,-3,8,-1,0,-1,-1,-1,-1,-1,5,-1
KR_6688488334,420,-3,-48,24,-8,-3,3,0,2,1,3,-2,2,0,-5,5,0,0,1,1,0,-6,6,0,-7,7,-8,0,-1,1,-1,-1,-1,6,-1
KR_6748675017,420,-2,-59,-11,-6,-3,4,1,-1,1,0,-3,6,3,0,4,4,1,0,1,-1,0,0,1,-5,4,-1,0,0,0,1,0,-1,0,-1
KR_6759032184,440,-3,-30,-16,-5,1,0,1,-2,2,0,-6,6,0,0,6,6,2,0,2,0,0,-37,-6,-1,7,-1,0,-1,-1,0,-1,1,6,-1
KR_6767383855,420,0,-28,-20,0,4,1,5,-3,5,2,-5,5,0,5,0,5,-1,1,0,0,1,67,-1,-3,4,-1,0,0,-1,-1,0,1,1,-1
KR_6768301677,420,-3,-43,-16,-5,0,1,1,1,1,2,-1,2,1,-6,7,1,1,0,1,0,-4,-38,-1,-4,5,26,0,0,1,-1,0,1,1,-1
KR_6761045210,420,-3,-16,-9,-11,-1,3,2,0,2,2,-1,2,1,-7,9,2,-2,3,1,0,-9,-159,-2,-4,6,20,0,0,0,0,-1,-1,0,-1
KR_6692409267,420,3,26,17,10,5,0,5,-1,2,1,4,0,4,3,1,4,-1,1,0,0,12,-3,-2,-2,4,-2,0,1,0,-1,1,1,0,-1
KR_6759097537,420,-4,-67,-34,-7,0,2,2,1,2,3,-4,6,2,-5,6,1,1,4,5,-1,3,-1,3,-7,4,-2,0,0,-1,-1,-1,-1,6,-1
KR_6745809451,420,-5,-70,-18,-5,1,1,2,4,0,4,-3,6,3,-5,6,1,-2,4,2,0,-6,-12,-5,-1,6,-1,0,-2,-1,0,-1,1,3,-1
KR_6765691758,420,-1,-10,-23,-4,-1,2,1,-2,4,2,-1,4,3,-1,3,2,1,1,2,0,-2,22,3,-6,3,2,0,-1,0,0,-1,-1,0,-1
KR_6701240415,420,-5,-105,4,-18,-3,5,2,-5,6,1,-6,7,1,-5,7,2,1,1,2,-1,-12,-5,-2,-3,5,-2,0,-4,-1,-1,-1,-1,3,-1
KR_6755313129,420,-3,-106,-8,-9,1,1,2,-1,3,2,-9,10,1,-7,7,0,7,1,8,0,-10,-4,-2,-6,8,-7,0,-1,-1,1,-1,-1,3,-1
KR_6639889456,420,-2,-51,0,-8,-1,2,1,-2,4,2,-2,2,0,-1,1,0,-2,2,0,0,-4,-32,-1,-4,5,-4,0,-2,1,-1,-1,-1,3,-1
KR_6638973222,420,-4,-32,3,-14,-3,5,2,1,1,2,0,4,4,-9,10,1,-3,3,0,0,-16,-10,-5,-2,7,0,0,-2,1,-1,-1,-1,1,-1
KR_6610629161,440,-1,-66,-16,2,-1,1,0,5,2,7,1,4,5,-3,3,0,0,0,0,0,2,-5,-2,-2,4,-2,0,0,-1,-1,-1,1,5,-1
KR_6749089848,420,1,-43,12,14,2,1,3,0,2,2,4,3,7,7,2,9,1,1,2,1,24,-17,1,-8,7,-1,0,2,1,1,-1,1,1,-1
KR_6768377701,420,2,63,8,7,0,1,1,1,4,5,1,4,5,2,2,4,3,1,4,0,7,-15,1,-5,4,5,0,1,0,1,1,1,0,-1
KR_6753750472,420,-3,-77,-4,0,-1,2,1,-1,1,0,2,0,2,0,1,1,0,0,0,-1,4,-7,3,-5,2,-4,0,0,-1,-1,0,-1,1,-1
KR_6709063784,420,0,23,-20,0,-4,6,2,0,4,4,2,2,4,3,2,5,-1,1,0,0,3,43,0,-5,5,-13,0,-2,1,-1,-1,-1,2,-1
KR_6709539777,420,1,52,-3,-1,0,2,2,-6,7,1,2,1,3,2,2,4,1,0,1,0,-1,5,0,-7,7,0,0,0,1,-1,0,-1,5,-1
KR_6645293529,420,-7,-91,4,-16,-6,6,0,-3,5,2,0,2,2,-5,7,2,-2,2,0,0,-14,0,1,-7,6,0,0,-1,0,0,-1,-1,0,-1
KR_6768456415,420,0,28,-35,-4,7,0,7,-3,3,0,0,0,0,-7,7,0,-1,2,1,1,-14,-9,2,-7,5,-5,0,-2,-1,-1,-1,1,5,-1
KR_6693647477,420,-1,-48,-17,2,-2,2,0,2,2,4,3,3,6,-1,4,3,0,0,0,-1,12,-2,1,-2,1,0,0,-1,1,0,-1,-1,1,-1
KR_6662387756,420,-3,-33,-20,-6,0,1,1,-2,2,0,0,1,1,-2,2,0,-2,3,1,0,-7,-102,2,-5,3,-1,0,-1,0,0,-1,-1,0,-1
KR_6739819106,420,1,-59,29,6,-1,4,3,8,0,8,1,0,1,-4,4,0,2,0,2,0,8,-9,-4,-5,9,1,0,-1,1,1,-1,1,1,-1
KR_6683092466,420,-1,52,-4,-10,0,2,2,-1,3,2,-10,11,1,2,2,4,-1,1,0,0,-11,-3,2,-4,2,-1,0,-1,-1,0,-1,-1,2,-1
KR_6606709236,420,-3,-45,-6,-8,1,2,3,-1,3,2,-8,9,1,2,3,5,-2,2,0,1,0,214,-1,-3,4,-1,0,-1,-1,0,-1,1,6,-1
KR_6758445310,420,1,-29,-1,3,-2,5,3,4,0,4,1,4,5,-1,3,2,1,1,2,0,4,8,5,-7,2,0,0,-1,-1,1,-1,1,4,-1
KR_6765690515,420,-3,-45,6,-13,3,1,4,-5,6,1,-1,3,2,-8,9,1,-2,3,1,0,-8,-3,2,-5,3,-3,0,-1,-1,1,-1,-1,2,-1
KR_6753351032,420,-4,-43,-24,-8,1,0,1,-4,4,0,-2,3,1,-2,3,1,-1,1,0,0,-11,-16,-1,-5,6,4,0,-3,1,-1,-1,-1,2,-1
KR_6704452750,420,-5,-109,19,-3,-2,2,0,1,3,4,-1,1,0,-4,4,0,3,0,3,0,-11,35,2,-6,4,0,0,-1,-1,1,-1,-1,6,-1
KR_6210652980,420,-1,-69,4,-5,-1,3,2,0,2,2,0,0,0,-6,6,0,2,0,2,-1,-7,66,-3,-4,7,-30,0,-1,-1,0,-1,-1,3,-1
KR_6764178716,420,1,-45,49,2,-3,3,0,2,3,5,5,0,5,2,2,4,-4,5,1,1,4,8,-2,-4,6,5,0,-1,1,-1,-1,1,3,-1
KR_6765558789,420,3,65,2,-2,-2,3,1,0,3,3,0,3,3,3,1,4,-3,3,0,0,-1,-2,4,-5,1,-2,0,1,1,0,1,1,2,-1
KR_6706197158,420,-3,-75,-12,-5,-2,4,2,1,1,2,-2,3,1,-1,5,4,-1,1,0,0,-1,-7,-2,-4,6,2,0,1,-1,1,1,-1,5,-1
KR_6762204767,420,-1,13,-11,2,2,1,3,-3,5,2,1,0,1,1,2,3,1,0,1,0,5,47,4,-8,4,-23,0,1,-1,1,1,1,6,-1
KR_6739335176,420,-5,-67,-19,-13,0,2,2,-6,8,2,-4,4,0,-2,6,4,-1,2,1,0,-14,63,-1,-7,8,-12,0,-1,-1,-1,-1,-1,5,-1
KR_6444431648,420,-2,74,0,-4,0,1,1,-3,3,0,-1,2,1,0,2,2,0,1,1,0,-6,110,3,-6,3,-2,0,0,0,0,0,-1,0,-1
KR_6760924573,420,-1,35,-8,2,3,1,4,-1,1,0,5,1,6,-1,2,1,-4,5,1,0,2,-5,-1,-6,7,2,0,0,-1,1,0,1,4,-1
KR_6644655113,420,-4,-26,0,-4,1,2,3,-1,8,7,3,0,3,-4,7,3,-3,3,0,0,-9,-3,-2,-5,7,0,0,0,-1,-1,0,1,2,-1
KR_6738545472,420,-3,-61,16,-9,2,0,2,-2,3,1,-1,2,1,-6,9,3,-2,2,0,0,-9,23,-2,-2,4,-4,0,-2,-1,-1,-1,-1,6,-1
KR_6766525069,420,-1,43,22,-8,1,3,4,-6,6,0,-6,8,2,0,3,3,3,0,3,-1,-15,-11,2,-6,4,-3,0,0,-1,-1,-1,-1,3,-1
KR_6754119850,420,-1,-68,5,-2,6,0,6,2,0,2,-6,6,0,0,2,2,-4,4,0,0,2,2,3,-4,1,-4,0,-1,0,-1,-1,-1,0,-1
KR_6743693649,420,1,-95,-3,-8,0,1,1,2,2,4,-1,2,1,-8,10,2,-1,2,1,0,-6,-2,-4,0,4,-2,0,-1,-1,1,-1,-1,2,-1
KR_6766900815,420,-2,-14,-28,0,-1,2,1,-3,3,0,-2,6,4,2,1,3,4,0,4,2,3,-18,7,-11,4,18,0,0,-1,-1,-1,1,6,-1
KR_6717922451,420,1,-49,15,3,1,0,1,4,0,4,-2,2,0,0,1,1,0,0,0,0,8,-13,-2,-2,4,0,0,-1,-1,-1,-1,1,5,-1
KR_6711055469,420,-4,-65,-11,-5,-1,2,1,-5,6,1,1,1,2,0,1,1,0,0,0,0,-6,-1,0,-5,5,-2,0,-2,-1,-1,-1,-1,3,-1
KR_6762689451,420,1,-30,-4,0,1,5,6,-1,1,0,1,5,6,0,4,4,-1,1,0,-1,-5,-260,3,-4,1,0,0,2,-1,0,1,-1,4,-1
KR_6647600144,420,-1,6,17,0,-1,2,1,3,0,3,-5,5,0,3,0,3,0,0,0,0,5,-45,-4,-2,6,1,0,1,-1,-1,1,-1,6,-1
KR_6689156444,420,0,-53,19,0,-3,4,1,3,1,4,3,1,4,-5,6,1,2,0,2,1,0,-6,-2,-3,5,5,0,0,-1,0,0,1,3,-1
KR_6747626080,420,0,10,-5,2,-1,3,2,-3,6,3,4,3,7,3,2,5,-1,2,1,0,4,32,0,-3,3,-19,0,0,-1,1,0,1,2,-1
KR_6596402156,420,-1,21,-41,-4,2,1,3,-3,6,3,-5,6,1,3,3,6,-1,3,2,0,4,6,-1,-5,6,5,0,1,1,0,1,-1,1,-1
KR_6768337887,440,-3,-11,-9,-4,1,0,1,-1,2,1,-1,2,1,-3,4,1,0,0,0,0,-10,-6,2,-6,4,-5,0,0,1,-1,0,1,3,-1
KR_6768094739,440,2,22,-16,8,2,2,4,-1,6,5,-2,2,0,5,1,6,4,0,4,0,6,-27,0,-1,1,4,0,0,-1,1,1,1,3,-1
KR_6754303666,420,-1,-5,28,1,-2,4,2,2,2,4,4,1,5,-1,4,3,-2,2,0,2,3,-1,3,-4,1,4,0,0,0,-1,0,1,0,-1
KR_6761333699,420,-2,40,-40,-5,2,0,2,-4,6,2,-3,4,1,-2,5,3,2,1,3,-1,-5,6,-6,-2,8,1,0,-1,1,-1,-1,-1,3,-1
KR_6765164405,420,-3,-117,-6,-4,-3,5,2,0,3,3,-3,3,0,0,3,3,2,1,3,0,3,25,3,-7,4,-3,0,-2,-1,-1,-1,1,3,-1
KR_6754069918,420,-5,-19,-4,-9,-5,6,1,1,2,3,2,0,2,-6,7,1,-1,2,1,0,-8,-131,-1,-3,4,-5,0,-2,0,1,-1,1,0,-1
KR_6711602089,440,3,93,-12,4,2,2,4,1,3,4,1,1,2,3,1,4,-3,6,3,-1,-1,-42,0,-5,5,1,0,1,-1,1,1,-1,4,-1
KR_6688990941,420,-1,-43,-12,-4,3,0,3,1,3,4,-2,5,3,-4,6,2,-2,4,2,0,-5,-13,-3,-4,7,-1,0,0,1,1,-1,-1,6,-1
KR_6768306647,440,-1,-20,28,-10,3,1,4,-7,9,2,-2,2,0,-3,4,1,-1,3,2,0,-12,122,-2,-3,5,3,0,-2,-1,1,1,-1,2,-1
KR_6758843428,420,-1,-18,20,-2,-2,5,3,5,0,5,-2,2,0,-2,3,1,-1,1,0,0,-1,15,3,-4,1,-2,0,-1,1,-1,-1,-1,4,-1
KR_6755309212,440,-5,-113,-38,-9,-1,3,2,-3,3,0,0,3,3,-2,3,1,-3,4,1,0,-14,-158,4,-7,3,-3,0,-4,-1,-1,-1,-1,5,-1
KR_6679278871,420,-3,-15,-40,-1,-2,2,0,-4,5,1,0,3,3,3,0,3,2,0,2,0,-4,-6,-4,-2,6,2,0,0,-1,1,1,-1,1,-1
KR_6602313539,420,-3,-28,-61,-9,3,1,4,1,4,5,0,4,4,-15,16,1,2,2,4,1,7,-10,-2,-1,3,4,0,-2,0,-1,-1,1,0,-1
KR_6749056390,420,1,-17,1,0,-5,7,2,0,2,2,0,1,1,3,0,3,2,2,4,1,6,-2,-3,-2,5,3,0,0,1,-1,1,1,6,-1
KR_6707270385,420,-4,-40,-8,-15,-3,4,1,1,2,3,0,2,2,-6,6,0,-7,7,0,0,-15,-3,-1,-4,5,-2,0,-3,-1,0,-1,-1,6,-1
KR_6761687371,420,-1,-26,20,3,-1,3,2,4,1,5,0,3,3,-1,2,1,1,1,2,0,7,-1,6,-9,3,-4,0,0,1,1,1,1,4,-1
KR_6673496214,420,1,37,14,2,-1,1,0,3,0,3,3,2,5,0,4,4,-3,4,1,0,0,-4,2,-5,3,0,0,0,1,1,0,1,2,-1
KR_6734921148,420,0,11,17,-5,0,3,3,2,2,4,-2,5,3,-4,5,1,-1,4,3,0,-11,3,-4,-4,8,-3,0,0,1,1,-1,-1,4,-1
KR_6757569417,420,0,-47,-25,-5,-3,3,0,0,2,2,1,3,4,-1,4,3,-2,2,0,0,-7,-3,-2,-5,7,-4,0,0,-1,-1,0,-1,1,-1
KR_6764532584,420,-1,59,-16,-7,-3,3,0,1,3,4,-4,6,2,-2,3,1,1,1,2,0,-6,-2,0,-4,4,0,0,-1,1,1,-1,1,5,-1
KR_6710115647,420,0,-33,5,3,0,2,2,1,0,1,5,4,9,-2,4,2,-1,3,2,-4,6,-6,2,-9,7,4,0,0,-1,1,1,1,6,-1
KR_6630902362,420,1,-19,4,-7,1,1,2,4,0,4,-1,2,1,-12,12,0,1,2,3,0,-12,-178,0,-3,3,-3,0,0,-1,1,-1,-1,6,-1
KR_6559709011,420,-3,-45,2,-9,2,2,4,-1,4,3,-3,3,0,-4,4,0,-3,4,1,0,-6,62,8,-12,4,-34,0,-2,-1,-1,-1,1,4,-1
KR_6768327665,420,-3,-30,12,-10,-3,3,0,2,1,3,-8,9,1,-1,2,1,0,1,1,0,-11,-9,-3,-1,4,0,0,-2,1,-1,-1,-1,2,-1
KR_6752716498,420,0,-11,9,1,0,3,3,1,0,1,2,0,2,-1,1,0,-1,1,0,0,-1,28,3,-4,1,-13,0,0,1,1,0,1,4,-1
KR_6717866886,420,-2,25,-40,-5,-1,1,0,-1,2,1,0,1,1,-2,5,3,-1,3,2,0,2,-14,-2,-2,4,-2,0,0,0,-1,0,-1,0,-1
KR_6759183164,420,-3,9,-37,-5,2,1,3,0,1,1,-7,9,2,1,3,4,-1,1,0,-2,-6,-129,-3,-2,5,1,0,0,-1,-1,-1,-1,6,-1
KR_6754906634,420,1,-11,8,-3,1,3,4,-3,5,2,-1,1,0,0,0,0,0,1,1,0,-4,-223,-1,-3,4,-18,0,1,-1,-1,1,1,4,-1
KR_6707879764,440,-2,-93,-8,0,-2,3,1,2,3,5,-1,4,3,0,4,4,1,0,1,2,-1,-6,3,-8,5,1,0,0,-1,1,-1,1,3,-1
KR_6729742419,420,-7,-47,-67,-8,3,1,4,-1,2,1,-3,3,0,-1,2,1,-6,6,0,0,-6,-16,0,-2,2,-3,0,-2,1,1,-1,-1,4,-1
KR_6580007482,420,-1,38,-20,-6,-1,1,0,-3,3,0,0,2,2,-3,4,1,1,0,1,-1,-8,7,4,-6,2,-21,0,0,1,-1,0,-1,5,-1
KR_6764066358,420,2,34,36,3,2,0,2,-2,4,2,3,1,4,0,2,2,0,0,0,0,1,87,-3,-4,7,1,0,0,0,-1,0,1,0,-1
KR_6719331432,420,-7,-74,-29,-14,-1,3,2,-4,4,0,-3,5,2,-4,5,1,-2,2,0,-1,-7,-2,1,-6,5,0,0,-1,-1,-1,-1,-1,3,-1
KR_6749608113,420,-1,-52,-5,-1,-1,2,1,-2,2,0,3,2,5,-4,4,0,3,0,3,0,2,-9,-5,-2,7,0,0,0,1,1,-1,-1,2,-1
KR_6751794634,420,-5,-127,-3,-24,-7,7,0,-1,2,1,-12,13,1,-2,3,1,-2,5,3,-1,-27,-49,-4,-2,6,16,0,-1,-1,-1,-1,-1,3,-1
KR_6617691351,420,-1,-56,0,0,-9,9,0,1,2,3,3,0,3,2,3,5,3,0,3,0,6,-101,-3,-3,6,1,0,-1,1,-1,-1,-1,4,-1
KR_6726820189,420,-1,-25,0,-2,0,1,1,-1,2,1,-1,2,1,0,3,3,0,1,1,0,-1,15,-3,-3,6,4,0,0,-1,1,0,-1,3,-1
KR_6762810717,420,3,32,16,1,0,0,0,1,1,2,-2,6,4,1,4,5,1,2,3,0,6,17,5,-9,4,-3,0,0,-1,-1,0,-1,6,-1
KR_6758867796,440,-2,-77,17,-5,-1,2,1,2,1,3,3,3,6,-9,9,0,0,1,1,-1,-3,4,1,-5,4,0,0,-1,1,0,-1,-1,4,-1
KR_6763239752,420,-1,6,-29,-3,0,3,3,2,0,2,-3,3,0,1,4,5,-3,3,0,0,-3,4,1,-4,3,-1,0,-2,1,1,-1,-1,5,-1
KR_6661523671,420,0,54,4,-5,0,2,2,3,0,3,-5,8,3,-3,5,2,0,0,0,0,-6,0,-1,-5,6,-2,0,0,-1,0,0,-1,1,-1
KR_6661976446,420,0,-37,-6,-3,0,2,2,-2,5,3,-3,6,3,-1,1,0,3,1,4,0,1,-5,-1,-5,6,-2,0,1,-1,1,1,-1,5,-1
KR_6742597112,420,0,-36,8,2,-1,2,1,6,1,7,-3,5,2,0,2,2,0,2,2,0,7,40,2,-7,5,-7,0,-1,1,-1,-1,-1,4,-1
KR_6752671672,420,-2,-44,3,-9,-5,7,2,1,4,5,-2,2,0,-6,7,1,3,0,3,0,-6,2,3,-7,4,-2,0,-1,0,1,-1,-1,0,-1
KR_6652886027,420,-2,25,-38,-3,3,3,6,-3,4,1,-1,1,0,-2,2,0,0,2,2,0,3,-6,0,-5,5,-1,0,0,1,-1,0,1,1,-1
KR_6733724411,420,1,28,20,-1,0,1,1,0,4,4,-3,3,0,4,0,4,-2,5,3,0,1,-248,0,-6,6,1,0,0,-1,1,1,-1,5,-1
KR_6745679789,420,-3,-31,16,-18,-2,4,2,-2,4,2,-3,7,4,-10,13,3,-1,1,0,-2,-29,-6,-3,0,3,2,0,-1,-1,0,-1,-1,3,-1
KR_6768125955,420,-1,43,-7,3,1,0,1,0,2,2,1,1,2,1,1,2,0,2,2,0,0,8,5,-10,5,-1,0,0,1,-1,1,1,1,-1
KR_6763133781,420,2,-24,16,1,-1,1,0,5,1,6,-2,2,0,-1,1,0,0,1,1,0,5,-40,0,-4,4,22,0,0,1,-1,-1,-1,5,-1
KR_6756156403,420,-1,-23,-9,-2,4,0,4,-1,2,1,-2,5,3,-5,6,1,2,1,3,0,-13,23,-1,-4,5,-3,0,-1,-1,-1,-1,-1,5,-1
KR_6584035160,420,-5,2,-37,-10,-1,2,1,-6,10,4,-2,3,1,-1,5,4,0,0,0,1,-11,-50,-6,-2,8,31,0,-2,-1,-1,-1,1,4,-1
KR_6767250290,420,4,70,8,1,-1,3,2,2,4,6,-2,2,0,1,3,4,1,1,2,0,1,-34,1,-5,4,2,0,0,-1,-1,0,-1,1,-1
KR_6647548214,420,-2,-5,-17,-12,-1,2,1,-4,6,2,-7,8,1,0,2,2,0,2,2,-1,-14,-5,0,-1,1,-2,0,-2,-1,-1,-1,-1,3,-1
KR_6745504020,420,-1,-67,4,1,1,1,2,-4,6,2,4,1,5,0,1,1,0,2,2,0,1,1,0,-4,4,-3,0,-1,-1,-1,-1,1,3,-1
KR_6765673852,440,-1,-119,-16,6,2,0,2,2,1,3,-1,2,1,2,5,7,1,2,3,0,4,0,6,-7,1,-3,0,0,-1,1,-1,1,5,-1
KR_6487134550,420,-1,28,21,-5,3,0,3,2,3,5,-5,5,0,-1,1,0,-4,5,1,0,-5,-7,3,-5,2,-8,0,0,1,0,0,1,3,-1
KR_6693526556,420,0,-27,8,-7,-2,3,1,1,3,4,-3,3,0,-2,2,0,-1,1,0,0,-5,78,-1,-4,5,-1,0,-1,-1,-1,-1,-1,2,-1
KR_6700529902,420,-3,-30,-43,-2,1,2,3,1,1,2,-2,2,0,-2,3,1,0,4,4,0,1,10,1,-4,3,2,0,-1,-1,1,-1,-1,2,-1
KR_6732660687,420,-2,-14,-13,-4,0,1,1,1,1,2,-2,5,3,0,4,4,-3,3,0,-1,-5,-3,5,-6,1,-1,0,0,1,-1,0,-1,6,-1
KR_6680315780,420,-7,-82,-6,-14,-2,3,1,-2,4,2,-5,5,0,-5,9,4,0,1,1,-1,-18,-10,5,-6,1,-1,0,-1,-1,1,-1,-1,3,-1
KR_6718088858,420,-5,13,-36,-13,0,1,1,-3,4,1,0,3,3,-9,10,1,-1,1,0,-1,-18,-185,0,-4,4,1,0,0,1,1,-1,-1,6,-1
KR_6703424730,420,0,5,19,2,-1,2,1,-2,3,1,4,1,5,-1,4,3,2,1,3,-1,-1,264,2,-7,5,-1,0,0,-1,1,0,-1,5,-1
KR_6764954937,420,6,61,34,13,9,0,9,-2,4,2,0,0,0,5,1,6,1,1,2,0,6,1,-1,-2,3,1,0,1,1,1,1,-1,3,-1
KR_6721930596,440,-3,-61,-20,-16,-3,3,0,-4,5,1,-7,9,2,-1,3,2,-1,1,0,0,-11,-49,0,-5,5,-3,0,-2,-1,-1,-1,-1,1,-1
KR_6763959838,420,-1,8,-43,-9,-1,2,1,0,1,1,-5,5,0,0,2,2,-3,4,1,0,0,-2,-2,-4,6,1,0,0,-1,0,0,-1,3,-1
KR_6767508899,420,-1,-21,-28,-4,-1,4,3,-2,5,3,1,5,6,1,3,4,-3,4,1,0,-5,32,3,-5,2,-3,0,-1,-1,0,-1,1,4,-1
KR_6724174284,420,1,18,23,1,-3,4,1,1,3,4,2,1,3,1,1,2,0,0,0,0,-4,1,-3,-2,5,4,0,0,-1,1,1,-1,6,-1
KR_6755437747,420,-2,-105,-8,-3,0,0,0,2,0,2,-4,6,2,1,4,5,-2,2,0,-3,-2,3,1,-5,4,-7,0,-2,-1,1,-1,-1,3,-1
KR_6762881689,420,1,21,0,7,-3,4,1,2,3,5,1,1,2,6,0,6,1,0,1,3,6,2,3,-4,1,1,0,0,-1,-1,-1,-1,1,-1
KR_6707049905,420,-6,-52,-33,-3,1,1,2,0,1,1,-6,6,0,4,1,5,-2,2,0,0,3,170,0,-3,3,4,0,-2,1,-1,-1,1,6,-1
KR_6743947228,440,-1,-33,0,5,-1,3,2,0,1,1,3,2,5,0,0,0,3,1,4,0,5,-5,1,-5,4,0,0,-1,1,1,-1,1,3,-1
KR_6627083909,420,0,10,4,5,1,1,2,0,2,2,5,0,5,-1,4,3,0,1,1,0,6,49,5,-5,0,-26,0,0,-1,-1,0,1,4,-1
KR_6493791349,420,-5,-41,-8,-19,-1,1,0,-2,2,0,-5,5,0,-4,7,3,-7,7,0,0,-19,185,3,-7,4,24,0,-1,-1,1,-1,1,6,-1
KR_6712228060,440,-7,-103,-4,-17,-3,4,1,-4,5,1,-3,3,0,-7,7,0,0,1,1,0,-10,1,-4,-1,5,0,0,-1,0,1,-1,-1,0,-1
KR_6767140146,420,-3,4,0,-11,-1,1,0,-3,3,0,1,3,4,-5,6,1,-3,4,1,0,-18,3,0,-3,3,-3,0,-1,-1,-1,-1,1,3,-1
KR_6750688132,420,-11,-88,-52,-25,-5,5,0,-4,4,0,-9,11,2,-4,4,0,-3,3,0,-1,-14,-129,-5,-3,8,-3,0,-4,-1,-1,-1,-1,2,-1
KR_6745232014,420,-1,-6,-27,0,-3,3,0,1,4,5,-1,2,1,4,6,10,-1,1,0,0,5,-3,0,-8,8,-1,0,0,1,1,-1,-1,2,-1
KR_6762567699,420,-1,6,-8,-4,3,1,4,-4,6,2,3,0,3,-4,7,3,-2,2,0,0,-9,-9,3,-5,2,-1,0,0,-1,-1,-1,1,5,-1
KR_6664652836,440,-3,-102,-13,-7,0,2,2,-1,3,2,3,1,4,-7,7,0,-2,2,0,-1,-7,-5,-3,-1,4,-1,0,-2,0,1,-1,-1,0,-1
KR_6661688237,420,-4,-53,-30,-14,0,3,3,-1,3,2,-5,7,2,-6,7,1,-2,3,1,-2,-5,30,-4,-1,5,-17,0,-2,-1,-1,-1,-1,1,-1
KR_6639011662,420,-4,-76,-4,-8,-3,3,0,-6,8,2,1,2,3,0,1,1,0,0,0,0,-5,-13,-2,-4,6,-1,0,-1,-1,-1,-1,-1,2,-1
KR_6757861018,420,-6,-27,-62,-6,1,4,5,-2,3,1,-4,4,0,0,2,2,-1,1,0,0,-5,-12,0,-2,2,1,0,-2,-1,1,-1,-1,2,-1
KR_6714568282,420,-2,10,7,-10,2,1,3,-2,3,1,-2,3,1,-8,11,3,0,2,2,0,-18,-4,-6,-1,7,0,0,-2,-1,-1,-1,-1,6,-1
KR_6759753976,420,-4,-72,8,-15,3,0,3,-6,6,0,2,4,6,-10,12,2,-4,4,0,-2,-21,-42,-7,-3,10,14,0,-2,0,-1,-1,-1,0,-1
KR_6759497310,420,-2,-31,8,-5,-3,4,1,-1,2,1,2,2,4,-4,6,2,1,1,2,0,-2,35,-4,-5,9,-17,0,0,-1,-1,-1,1,1,-1
KR_6713867293,420,-5,-82,-46,-15,-1,3,2,-5,6,1,-1,6,5,-6,9,3,-2,3,1,0,-10,7,6,-8,2,0,0,-1,-1,1,-1,-1,1,-1
KR_6764777230,420,-2,-63,-12,-15,-4,5,1,-2,2,0,-3,3,0,-5,5,0,-1,1,0,-1,-23,-13,0,-4,4,-1,0,0,-1,-1,-1,-1,4,-1
KR_6767189975,420,-1,-67,0,-1,1,2,3,-4,4,0,0,3,3,2,1,3,0,1,1,0,-2,-50,-5,-3,8,28,0,-1,-1,-1,-1,-1,5,-1
KR_6628326264,420,-3,12,-18,-7,0,1,1,-2,4,2,-1,2,1,-3,3,0,-1,1,0,0,-11,3,-1,-3,4,2,0,0,0,-1,0,-1,0,-1
KR_6727493123,420,-8,-76,-13,-16,-3,3,0,0,5,5,-2,2,0,-5,6,1,-6,7,1,-2,-21,-6,-1,-8,9,1,0,-2,-1,1,-1,-1,2,-1
KR_6759928802,420,-4,-60,-4,-13,-2,4,2,-1,6,5,-4,5,1,-5,6,1,-1,1,0,0,-10,3,2,-5,3,0,0,-1,-1,-1,-1,-1,6,-1
KR_6688854517,420,1,-88,23,-1,0,3,3,-3,4,1,-2,2,0,-2,2,0,6,1,7,0,6,0,-1,-6,7,0,0,-2,-1,1,-1,1,6,-1
KR_6493608164,420,2,49,12,-1,6,0,6,0,1,1,-1,1,0,1,2,3,-7,7,0,0,-3,3,0,-4,4,-5,0,1,-1,1,1,1,3,-1
KR_6732761516,440,-4,-75,-8,-4,-3,3,0,-4,4,0,8,1,9,-5,6,1,0,0,0,0,-6,-8,1,-4,3,2,0,-1,1,1,-1,1,3,-1
KR_6561967700,420,-1,0,11,-3,1,1,2,3,4,7,1,1,2,-2,2,0,-6,7,1,0,-3,-22,2,-5,3,-3,0,0,-1,1,0,-1,1,-1
KR_6723613973,420,-4,13,16,-8,-2,3,1,-8,9,1,1,2,3,-2,5,3,3,2,5,0,-10,-6,-3,0,3,3,0,1,-1,-1,1,1,1,-1
KR_6738832935,420,-4,-26,-5,-4,-2,3,1,-2,2,0,-4,7,3,3,1,4,1,0,1,0,-1,7,-3,-2,5,1,0,0,-1,-1,-1,1,1,-1
KR_6756171462,420,0,-20,-36,2,-3,3,0,3,0,3,8,2,10,-7,7,0,1,1,2,0,1,-4,6,-7,1,1,0,-1,-1,-1,1,-1,6,-1
KR_6650488910,420,-1,-12,13,-5,-3,4,1,-2,5,3,-1,2,1,-1,1,0,2,0,2,0,-1,-2,0,-2,2,0,0,-1,-1,-1,-1,1,1,-1
KR_6740021323,420,-2,-108,1,-5,-2,2,0,1,6,7,1,2,3,-2,2,0,-3,3,0,0,-5,-9,-4,0,4,2,0,-2,-1,1,-1,-1,4,-1
KR_6756816044,420,-1,-98,27,-7,-1,3,2,0,4,4,1,1,2,-7,7,0,0,2,2,-1,-11,-4,-1,-3,4,-2,0,-1,-1,1,-1,-1,2,-1
KR_6701535827,440,-7,-145,-39,-25,-2,3,1,-10,10,0,1,5,6,-10,12,2,-4,5,1,0,-21,-28,-1,-2,3,0,-1,-5,-1,0,-1,-1,4,-1
KR_6616532784,420,-2,26,4,-8,-2,4,2,-1,3,2,1,1,2,-6,6,0,0,1,1,0,-10,-2,2,-6,4,0,0,2,1,1,1,-1,3,-1
KR_6702379661,420,0,8,48,-4,-2,2,0,1,1,2,1,0,1,-1,5,4,-3,5,2,0,-12,54,1,-7,6,-31,0,0,0,-1,1,-1,0,-1
KR_6762750920,420,-4,-114,-17,-8,0,1,1,3,2,5,-1,2,1,-8,9,1,-2,2,0,0,-9,-11,-2,-3,5,0,0,-2,-1,1,-1,1,4,-1
KR_6746200099,420,-5,-61,-34,-14,0,0,0,-2,3,1,-9,9,0,-2,2,0,-1,1,0,0,-9,23,-6,-2,8,-23,0,-2,-1,-1,-1,-1,5,-1
KR_6768351002,420,-1,-51,-20,-1,-1,3,2,1,1,2,3,1,4,-1,4,3,-3,3,0,0,2,-5,2,-4,2,-3,0,0,-1,1,0,1,2,-1
KR_6720717260,440,4,11,32,6,-2,4,2,7,0,7,2,0,2,-2,5,3,1,3,4,-2,7,12,3,-6,3,0,0,0,1,1,0,-1,3,-1
KR_6761816612,440,2,9,11,6,7,3,10,1,2,3,-2,4,2,1,4,5,-1,1,0,-1,6,-3,6,-11,5,-4,0,1,1,1,1,1,3,-1
KR_6647681484,420,0,-44,-21,4,6,0,6,-2,3,1,4,1,5,-2,3,1,-2,3,1,0,-2,6,4,-9,5,-1,0,1,-1,1,-1,-1,5,-1
KR_6606634131,420,-9,-78,-30,-12,2,1,3,-3,4,1,-3,5,2,-7,7,0,-1,2,1,0,-15,247,2,-3,1,2,0,-1,1,0,1,1,5,-1
KR_6758676453,420,-3,-33,12,-9,-4,5,1,-4,7,3,-1,2,1,-2,3,1,2,1,3,0,3,116,-5,-1,6,-20,0,0,-1,-1,-1,-1,4,-1
KR_6763918859,420,0,-11,-4,2,2,1,3,4,4,8,-1,1,0,-1,3,2,-2,3,1,0,-2,-115,0,-2,2,1,0,1,-1,-1,1,1,6,-1
KR_6705333129,440,-2,25,14,-11,2,2,4,-1,3,2,1,3,4,-9,9,0,-4,4,0,-2,-14,7,-3,-3,6,-1,0,-1,-1,-1,-1,-1,6,-1
KR_6734739112,420,-1,-33,-3,-2,-2,3,1,4,1,5,3,0,3,-5,5,0,-2,3,1,0,-2,-2,1,-5,4,3,0,-1,1,1,-1,-1,1,-1
KR_6356040803,420,-4,-107,16,-4,4,2,6,1,2,3,-2,2,0,-8,9,1,1,0,1,0,-9,0,0,0,0,5,0,1,-1,1,1,-1,5,-1
KR_6652703449,420,-7,-125,-101,-1,0,0,0,0,0,0,2,0,2,-2,4,2,-1,1,0,0,-2,-11,-3,0,3,4,-1,-6,1,-1,-1,-1,2,-1
KR_6765904202,420,-1,12,-4,-5,-1,1,0,0,1,1,-2,5,3,-2,3,1,0,0,0,0,-4,11,5,-7,2,-6,0,0,-1,-1,-1,-1,4,-1
KR_6711349219,420,3,-13,-4,4,-1,2,1,-1,6,5,4,2,6,1,0,1,1,1,2,0,3,-13,-5,-2,7,1,0,0,1,-1,0,1,6,-1
KR_6694730517,420,-5,-24,-16,-10,-4,4,0,-4,7,3,0,3,3,-2,3,1,0,0,0,0,-9,22,-2,-1,3,2,0,-2,-1,-1,-1,-1,5,-1
KR_6702881607,420,-2,4,3,0,-3,5,2,-5,7,2,4,1,5,4,0,4,0,1,1,2,6,1,1,-5,4,-4,0,0,-1,0,0,1,2,-1
KR_6689104730,420,2,25,40,2,5,1,6,-3,5,2,0,1,1,1,2,3,-1,2,1,-2,-6,-112,2,-5,3,3,0,1,-1,1,1,-1,3,-1
KR_6756091364,440,-5,-70,-42,-12,-5,5,0,-5,5,0,0,0,0,-3,4,1,1,0,1,0,-5,-35,-1,-2,3,-4,0,-1,0,1,-1,1,0,-1
KR_6756599571,440,-4,-110,-44,4,-1,1,0,0,4,4,5,2,7,2,4,6,-2,2,0,0,2,3,-2,-1,3,1,0,-1,1,-1,-1,-1,4,-1
KR_6765657961,420,0,16,1,4,-2,3,1,-1,1,0,4,1,5,-3,4,1,6,1,7,0,1,1,1,-3,2,1,0,0,1,-1,-1,-1,3,-1
KR_6765827905,440,-1,49,16,-4,1,1,2,-6,7,1,1,2,3,0,0,0,0,0,0,0,-14,-3,-4,-2,6,-4,0,0,-1,-1,0,-1,3,-1
KR_6762427057,420,-2,-18,3,-6,-5,6,1,2,2,4,-3,3,0,-4,7,3,4,1,5,0,-9,-2,-3,-3,6,-1,0,0,0,-1,-1,1,0,-1
KR_6753371618,420,-4,-64,-9,-12,-6,7,1,-6,6,0,0,3,3,-1,3,2,1,1,2,0,-14,-6,-1,-3,4,1,0,0,-1,1,0,-1,6,-1
KR_6736672098,420,-2,5,-22,2,-4,6,2,0,4,4,0,3,3,4,1,5,2,0,2,0,2,9,-2,-1,3,2,0,-1,-1,-1,1,1,4,-1
KR_6743669748,420,1,6,12,-3,-3,4,1,-5,7,2,1,2,3,0,1,1,4,0,4,0,-6,6,-5,-1,6,-3,0,0,1,-1,0,-1,5,-1
KR_6731711714,420,-5,-88,10,-1,-6,7,1,2,0,2,1,1,2,0,2,2,2,0,2,0,7,0,0,-4,4,0,0,-1,1,1,-1,-1,6,-1
KR_6710571136,420,0,-8,8,3,-3,3,0,9,0,9,-3,4,1,0,2,2,0,0,0,0,3,238,-2,-2,4,-4,0,1,-1,1,1,-1,5,-1
KR_6680016039,420,-1,43,41,-6,1,1,2,-3,6,3,-1,2,1,-1,2,1,-2,2,0,0,-9,-6,-1,-4,5,1,0,1,-1,0,1,1,4,-1
KR_6602978434,420,-1,-40,5,-3,3,2,5,-2,4,2,-1,2,1,-1,6,5,-2,3,1,0,-5,-7,0,-5,5,6,0,0,-1,1,0,-1,4,-1
KR_6674977530,420,-1,11,-8,3,1,2,3,5,0,5,-2,2,0,-1,3,2,0,2,2,0,8,27,-2,-5,7,-1,0,-1,0,-1,-1,-1,0,-1
KR_6763136133,420,-1,-43,-4,-5,-4,5,1,-1,4,3,0,4,4,-2,6,4,2,1,3,-1,5,230,-3,-2,5,0,0,-1,-1,-1,-1,-1,6,-1
KR_6764408582,420,2,0,22,5,2,0,2,0,2,2,3,1,4,0,0,0,0,0,0,0,-1,239,-7,-2,9,3,0,1,1,1,1,1,6,-1
KR_6764167175,420,-7,-30,-16,-11,-8,9,1,0,4,4,-1,2,1,-1,3,2,-1,2,1,-1,2,72,6,-8,2,-1,0,-2,1,-1,-1,-1,2,-1
KR_6647601349,420,5,36,-4,12,-1,4,3,5,0,5,4,3,7,2,1,3,2,1,3,0,14,-1,0,-2,2,-1,0,0,1,-1,-1,-1,4,-1
KR_6725142648,420,-2,-41,-16,2,-2,3,1,0,1,1,-3,6,3,4,0,4,3,3,6,0,4,-24,-4,-3,7,-2,0,0,-1,-1,-1,-1,1,-1
KR_6767355177,420,-1,60,-6,-8,2,0,2,-2,4,2,3,2,5,-6,7,1,-5,5,0,0,-19,-30,0,0,0,16,0,-4,-1,-1,-1,-1,2,-1
KR_6764193873,420,2,31,40,-5,-2,2,0,-4,6,2,3,2,5,-4,6,2,2,0,2,0,-8,-97,1,-3,2,0,0,1,0,1,1,-1,0,-1
KR_6644679987,420,-5,-70,-14,-13,-8,8,0,0,1,1,-1,6,5,-3,5,2,-1,2,1,0,0,-2,0,-5,5,-4,0,-3,0,-1,-1,-1,0,-1
KR_6651072825,420,2,-5,20,2,0,1,1,-1,4,3,5,2,7,-2,3,1,0,0,0,0,-6,-1,4,-7,3,-2,0,-1,-1,-1,-1,-1,4,-1
KR_6538158781,420,-4,-48,-4,-6,-3,6,3,-1,3,2,-2,5,3,1,2,3,-1,1,0,0,-3,-45,-3,-2,5,7,0,-1,-1,-1,-1,1,3,-1
KR_6662128907,420,-3,-53,-66,-3,-2,4,2,-3,5,2,-1,1,0,2,2,4,1,0,1,0,2,-4,-3,-1,4,4,0,-1,-1,-1,-1,-1,1,-1
KR_6758075942,440,-5,-78,16,-12,-3,4,1,3,1,4,-2,4,2,-8,11,3,-2,3,1,0,-9,4,0,-3,3,-3,0,-1,-1,-1,-1,-1,2,-1
KR_6764062825,420,-2,-8,-13,-3,-1,1,0,-1,2,1,-2,2,0,1,2,3,0,1,1,0,-3,300,-1,-4,5,-1,0,1,1,-1,-1,-1,3,-1
KR_6738691655,440,1,-75,24,4,-3,5,2,2,1,3,6,0,6,-3,4,1,2,0,2,0,-3,-4,-1,-3,4,1,0,0,-1,-1,-1,1,6,-1
KR_6730673493,420,-3,-73,-15,-7,-2,3,1,-3,4,1,1,2,3,-3,3,0,0,0,0,0,-7,5,-1,-4,5,-5,0,0,-1,1,1,-1,4,-1
KR_6631057756,420,0,-23,-36,5,2,0,2,2,1,3,1,3,4,0,0,0,0,0,0,0,8,-6,-1,-5,6,3,0,1,-1,0,1,1,1,-1
KR_6726203585,420,3,29,12,6,-1,1,0,4,1,5,-3,4,1,6,2,8,0,1,1,1,10,60,6,-7,1,-2,0,0,1,-1,-1,1,6,-1
KR_6722415335,420,0,0,-18,2,-4,6,2,7,1,8,0,0,0,-1,4,3,0,2,2,0,4,5,3,-5,2,-4,0,1,-1,1,1,1,2,-1
KR_6759805520,420,2,39,28,2,3,1,4,-5,7,2,0,1,1,5,5,10,-1,1,0,0,-3,-14,0,-5,5,-3,0,0,-1,1,1,1,3,-1
KR_6709270707,420,-4,-17,-31,0,2,2,4,2,1,3,-3,4,1,-3,4,1,2,1,3,2,11,-16,1,-3,2,0,0,0,-1,1,1,1,6,-1
KR_6739797496,420,-4,-18,-28,-8,-1,1,0,0,1,1,2,0,2,-6,6,0,-3,3,0,0,-7,15,-4,-3,7,-4,0,-1,-1,1,-1,-1,4,-1
KR_6699749691,420,-2,-85,4,-4,3,3,6,0,1,1,-5,5,0,-1,4,3,-1,1,0,-1,-12,1,-3,-1,4,-1,0,-2,-1,-1,-1,-1,6,-1
KR_6766886449,420,-4,-86,-12,-11,-1,2,1,-6,8,2,0,3,3,-2,5,3,-2,3,1,1,-15,10,3,-7,4,-7,0,0,-1,0,0,1,6,-1
KR_6643141253,420,0,1,-14,0,-6,6,0,0,1,1,0,1,1,6,2,8,0,1,1,-1,1,9,-6,0,6,-2,0,-1,-1,-1,-1,-1,3,-1
KR_6764870030,420,-2,-38,-8,-4,2,3,5,-2,2,0,-1,4,3,-3,5,2,0,0,0,0,-1,-4,-1,-2,3,4,0,-1,-1,0,-1,1,5,-1
KR_6482602210,420,3,12,5,3,1,0,1,2,3,5,4,2,6,-2,3,1,-2,3,1,0,2,50,3,-6,3,-1,0,0,0,1,1,1,0,-1
KR_6705766381,420,2,35,-19,-2,0,4,4,0,4,4,-3,4,1,4,4,8,-3,5,2,1,1,24,0,-3,3,-2,0,0,-1,-1,-1,1,6,-1
KR_6734368071,440,1,47,18,3,-4,4,0,1,0,1,-3,4,1,10,2,12,-1,1,0,0,12,-15,0,-5,5,5,0,0,1,1,1,1,6,-1
KR_6672635756,440,-5,-116,-5,-1,1,2,3,2,4,6,-6,7,1,1,2,3,1,0,1,0,-6,-1,-1,-1,2,-2,0,-1,1,0,-1,1,4,-1
KR_6757456602,420,2,26,12,1,1,2,3,4,2,6,2,2,4,-4,5,1,-2,3,1,-1,-3,-1,4,-6,2,-2,0,0,-1,0,-1,-1,6,-1
KR_6760417196,420,-1,-35,8,1,-1,3,2,1,0,1,-2,3,1,2,0,2,1,0,1,0,10,3,-3,-3,6,1,0,0,1,0,0,1,2,-1
KR_6673773170,420,-3,49,-46,-1,0,1,1,-3,3,0,-2,3,1,4,0,4,0,1,1,0,-2,-20,-3,-4,7,2,0,0,-1,0,0,-1,1,-1
KR_6752749995,420,0,-36,-4,-1,-3,3,0,1,3,4,3,0,3,-1,5,4,-1,3,2,0,3,-14,3,-4,1,-5,0,1,-1,0,1,-1,2,-1
KR_6762751389,420,1,-14,25,-1,-3,4,1,-4,7,3,9,0,9,1,1,2,-4,4,0,-1,-6,35,6,-9,3,-10,0,1,0,-1,1,-1,0,-1
KR_6751805926,420,-1,20,12,-2,2,0,2,0,1,1,1,2,3,-3,3,0,-2,2,0,0,-6,-6,2,-7,5,-3,0,0,1,1,1,1,2,-1
KR_6720746730,440,-2,18,-3,-12,-4,6,2,0,1,1,-4,4,0,-1,1,0,-3,4,1,-2,-22,4,-3,-1,4,-1,0,-1,-1,-1,-1,-1,1,-1
KR_6767217210,440,-6,9,-39,-3,-3,4,1,1,2,3,0,4,4,-3,4,1,2,0,2,0,-9,-95,3,-8,5,4,0,-2,-1,-1,-1,1,3,-1
KR_6765286623,420,3,-60,10,-1,1,2,3,0,3,3,4,0,4,-4,4,0,-2,2,0,0,-4,5,6,-7,1,-1,0,0,1,-1,-1,1,6,-1
KR_6750969449,440,0,-5,-56,-1,-4,5,1,-1,2,1,3,1,4,0,5,5,1,0,1,-1,-2,-6,-4,-4,8,6,0,-1,-1,-1,-1,1,6,-1
KR_6760645587,420,-3,-20,12,-3,0,2,2,-5,5,0,3,0,3,-1,2,1,0,0,0,1,-3,21,-3,-2,5,4,0,-1,-1,1,-1,1,4,-1
KR_6735945431,420,-1,26,-28,3,1,0,1,1,1,2,3,1,4,-6,7,1,4,0,4,0,2,-16,1,-4,3,6,0,0,-1,1,0,-1,6,-1
KR_6618089365,420,1,1,-16,1,-3,4,1,1,4,5,1,1,2,1,2,3,1,2,3,0,6,-409,3,-6,3,-2,0,0,1,-1,-1,-1,4,-1
KR_6744336414,420,-1,-78,-6,-8,-3,3,0,-2,4,2,2,0,2,-6,6,0,1,0,1,0,-11,0,1,-4,3,1,0,-2,-1,1,-1,-1,3,-1
KR_6712783348,420,-1,-7,-5,-1,3,1,4,0,4,4,3,1,4,-3,3,0,-4,7,3,1,1,11,3,-8,5,-3,0,-2,1,-1,-1,1,3,-1
KR_6747549899,440,1,-22,36,3,-3,3,0,2,2,4,0,2,2,5,1,6,-1,1,0,0,3,11,-2,-2,4,2,0,0,-1,-1,0,-1,1,-1
KR_6584554347,420,1,-46,-13,5,1,2,3,0,2,2,2,0,2,1,2,3,1,0,1,0,2,-5,-3,-4,7,5,0,-1,-1,-1,-1,-1,1,-1
KR_6521173481,420,-1,-34,-19,3,3,0,3,3,2,5,1,2,3,-4,5,1,0,2,2,0,0,19,-3,-6,9,-1,0,0,-1,1,-1,-1,4,-1
KR_6744911492,420,5,35,8,11,0,1,1,3,2,5,5,1,6,1,3,4,2,1,3,1,6,-9,-3,-6,9,4,0,0,1,-1,0,1,4,-1
KR_6741022726,420,-2,-49,-20,1,-2,2,0,7,1,8,-2,3,1,-4,5,1,2,1,3,0,8,-23,-2,-1,3,0,0,-2,0,-1,-1,-1,0,-1
KR_6757685324,420,0,-61,-21,-5,-8,9,1,-3,5,2,6,0,6,-2,4,2,2,1,3,0,3,2,1,-4,3,-1,0,-3,1,-1,-1,-1,2,-1
KR_6628590550,420,-6,-22,-57,-9,-2,3,1,-3,3,0,-5,5,0,-2,3,1,3,1,4,0,-3,110,1,-2,1,0,0,-2,-1,-1,-1,-1,3,-1
KR_6656829146,420,-1,0,32,-1,2,0,2,-4,8,4,-2,3,1,3,1,4,0,3,3,0,0,-118,-3,-2,5,1,0,0,1,-1,0,-1,4,-1
KR_6635277378,420,0,-23,-4,-6,0,1,1,-6,8,2,3,1,4,-1,2,1,-2,3,1,0,-9,-7,5,-6,1,-4,0,-2,-1,-1,-1,1,3,-1
KR_6756351564,420,-3,-32,18,-7,-5,5,0,0,2,2,0,4,4,-4,5,1,2,1,3,-1,-6,-4,0,-3,3,1,0,0,1,0,0,-1,1,-1
KR_6639528361,420,-4,-34,-36,-5,-3,4,1,0,2,2,-1,7,6,-1,2,1,0,1,1,0,0,-1,-4,-4,8,-3,0,-1,1,-1,-1,1,2,-1
KR_6748614711,420,0,-12,25,6,8,0,8,1,2,3,0,3,3,-4,6,2,1,3,4,0,1,-66,2,-7,5,-5,0,1,1,0,1,-1,3,-1
KR_6458883125,420,3,-49,16,4,0,1,1,8,0,8,0,2,2,-2,2,0,-2,2,0,0,5,-23,-3,-3,6,1,0,-1,1,1,-1,1,4,-1
KR_6759704519,420,0,-80,-1,1,-1,2,1,4,0,4,-3,3,0,0,2,2,1,3,4,0,2,54,0,-1,1,-1,0,0,0,0,0,-1,0,-1
KR_6759091585,420,2,19,-28,2,0,5,5,1,2,3,-3,4,1,6,2,8,-2,3,1,2,7,-5,5,-9,4,-3,0,1,-1,-1,1,1,4,-1
KR_6446427320,420,0,-18,-17,2,1,1,2,-2,3,1,0,2,2,2,0,2,1,0,1,0,7,49,4,-8,4,0,0,-1,-1,1,-1,1,3,-1
KR_6765768036,420,-3,-22,-31,2,0,1,1,-1,2,1,-2,3,1,3,3,6,2,0,2,0,13,1,1,-7,6,-1,0,0,-1,0,0,1,3,-1
KR_6681784018,420,-2,-20,-20,0,-2,3,1,-1,6,5,2,1,3,0,2,2,1,1,2,0,-2,22,-1,-4,5,-3,0,0,1,-1,-1,1,2,-1
KR_6759761817,440,0,-74,-5,-3,1,1,2,1,4,5,1,0,1,-4,5,1,-2,4,2,0,2,-2,1,-6,5,4,0,-1,-1,-1,-1,-1,1,-1
KR_6747899474,420,-1,-7,-8,-6,-3,4,1,0,4,4,-3,3,0,0,1,1,0,1,1,0,-1,27,3,-6,3,0,0,0,1,1,0,1,1,-1
KR_6758761324,420,-1,6,11,-4,0,3,3,1,3,4,-2,6,4,0,2,2,-3,3,0,0,1,-9,-3,0,3,-1,0,0,0,0,0,-1,0,-1
KR_6617444965,420,-4,28,-36,-9,-1,1,0,-1,2,1,-2,4,2,-4,5,1,-1,3,2,0,-6,7,0,-2,2,0,0,-1,-1,-1,-1,1,4,-1
KR_6744829412,420,1,69,-32,2,2,1,3,-1,5,4,0,0,0,0,4,4,1,1,2,0,2,-25,-1,-1,2,0,0,1,1,1,1,-1,4,-1
KR_6762095884,420,0,23,-8,1,-3,5,2,1,1,2,2,0,2,2,2,4,-1,2,1,0,2,13,3,-5,2,-3,0,-1,1,-1,-1,-1,2,-1
KR_6752830651,440,-2,-14,20,-15,-5,5,0,-1,4,3,-4,5,1,-9,9,0,4,0,4,-2,-18,0,1,-2,1,-1,0,-1,-1,-1,-1,-1,2,-1
KR_6547584473,420,-1,-41,-4,-7,2,0,2,-3,4,1,-2,5,3,-5,6,1,1,1,2,0,-11,48,-2,-4,6,-24,0,-2,1,-1,-1,-1,6,-1
KR_6768368278,420,-1,-53,12,5,2,2,4,4,2,6,1,1,2,-1,3,2,-1,2,1,0,6,17,1,-5,4,-2,0,0,1,-1,0,-1,2,-1
KR_6758782397,420,1,90,11,-6,-2,3,1,-3,3,0,-8,10,2,3,2,5,4,0,4,0,2,11,1,-5,4,-2,0,1,1,-1,-1,-1,2,-1
KR_6570067937,420,-1,15,6,-4,-1,1,0,1,1,2,0,2,2,-3,4,1,-1,1,0,0,-2,35,3,-8,5,-6,0,-1,1,-1,-1,-1,1,-1
KR_6742297065,420,5,109,40,4,5,3,8,0,1,1,-6,6,0,4,0,4,1,1,2,0,3,2,1,-2,1,4,0,1,1,1,1,1,4,-1
KR_6766950613,420,-3,-49,-8,-10,-1,3,2,-3,7,4,-3,3,0,-1,3,2,-2,3,1,-1,-17,-273,1,-3,2,4,0,-1,-1,-1,-1,-1,5,-1
KR_6763007481,420,-3,-81,-6,-7,1,1,2,-2,6,4,-2,4,2,-3,4,1,-1,2,1,-1,-10,-111,-3,-1,4,-5,0,-1,-1,-1,-1,-1,2,-1
KR_6765180138,420,0,-49,24,-3,0,2,2,-3,4,1,0,3,3,0,1,1,0,1,1,0,-3,8,1,-6,5,-3,0,1,0,1,1,-1,0,-1
KR_6766082481,420,-2,-20,-9,-1,0,2,2,7,1,8,-5,6,1,0,2,2,-3,3,0,0,1,82,2,-3,1,-2,0,-1,0,0,-1,-1,0,-1
KR_6747288539,420,-8,-78,-19,-18,-6,8,2,1,2,3,-2,3,1,-8,8,0,-3,3,0,-5,-20,-3,-3,0,3,-1,0,-2,-1,-1,-1,-1,1,-1
KR_6763177594,440,-1,-31,-2,-3,-4,4,0,-1,3,2,0,6,6,2,0,2,0,1,1,0,0,4,1,-5,4,-5,0,-3,-1,-1,-1,1,3,-1
KR_6756866876,420,-1,10,4,-5,2,1,3,-1,2,1,-4,6,2,-2,2,0,0,2,2,0,-10,-14,-4,-3,7,1,0,-1,1,-1,-1,1,3,-1
KR_6768275896,420,-3,-24,-20,-1,2,0,2,1,2,3,-4,4,0,1,1,2,-1,1,0,0,-4,7,5,-7,2,0,0,0,-1,-1,0,-1,3,-1
KR_6645514646,420,1,2,-30,-1,-4,4,0,-1,5,4,1,1,2,5,1,6,-2,3,1,0,-1,121,1,-6,5,1,0,0,0,0,0,-1,0,-1
KR_6764053621,420,-2,-57,16,-4,-1,3,2,6,1,7,-1,1,0,-5,5,0,-3,3,0,0,-1,-4,-3,-1,4,-1,0,-2,1,1,-1,1,1,-1
KR_6765928872,420,0,-17,4,-5,-2,3,1,-6,6,0,-1,3,2,4,1,5,0,4,4,0,-3,25,2,-4,2,3,0,1,0,1,1,1,0,-1
KR_6752357857,440,-4,-59,-19,-4,-2,3,1,2,1,3,1,0,1,-2,3,1,-3,4,1,0,-3,8,2,-7,5,-4,0,-2,1,1,-1,-1,1,-1
KR_6723018499,440,-1,-121,-12,-7,-2,5,3,4,5,9,-5,5,0,-2,3,1,-2,2,0,0,-14,20,3,-4,1,-2,0,-1,-1,0,-1,-1,4,-1
KR_6736880935,440,-4,-45,-20,-5,4,1,5,-2,3,1,4,0,4,-10,10,0,-1,1,0,-1,-10,4,2,-5,3,1,0,-2,-1,-1,-1,-1,4,-1
KR_6760559711,440,1,43,8,-1,-6,6,0,5,0,5,0,1,1,0,1,1,0,0,0,0,6,-18,-5,-3,8,1,0,1,0,1,1,-1,0,-1
KR_6744945774,420,-3,-16,-8,-5,-5,5,0,-3,3,0,0,0,0,4,2,6,-1,1,0,0,0,-4,-3,-3,6,4,0,0,-1,1,-1,-1,2,-1
KR_6671318521,420,1,30,12,0,1,0,1,-3,3,0,-2,2,0,3,6,9,1,2,3,1,-7,181,0,-4,4,2,0,1,1,-1,1,1,2,-1
KR_6729760257,420,-1,-10,-37,1,0,2,2,3,1,4,-2,4,2,0,1,1,0,1,1,0,6,-30,0,-5,5,3,0,-1,1,-1,-1,1,5,-1
KR_6762264140,420,0,-4,-8,3,-2,4,2,6,1,7,0,2,2,0,0,0,-1,1,0,-1,2,-14,4,-7,3,-1,0,0,1,-1,-1,-1,3,-1
KR_6746761169,420,-2,21,-12,3,1,2,3,-3,5,2,3,1,4,3,2,5,-1,1,0,0,2,-1,-4,-5,9,4,0,0,1,-1,1,1,2,-1
KR_6669316655,420,1,-52,37,7,5,1,6,1,2,3,-1,1,0,3,4,7,-1,2,1,0,-1,18,1,-6,5,-1,0,-2,1,-1,-1,-1,4,-1
KR_6752595259,420,-2,7,18,-3,-3,3,0,-1,1,0,0,2,2,1,3,4,0,0,0,0,-2,9,3,-4,1,0,0,0,1,-1,-1,1,3,-1
KR_6756282095,420,0,49,4,1,-1,3,2,2,0,2,0,2,2,3,0,3,-3,3,0,0,8,-2,3,-9,6,-1,0,0,1,-1,0,1,4,-1
KR_6750488279,440,-1,-42,-41,5,0,1,1,0,1,1,-1,3,2,8,1,9,-2,2,0,0,15,5,0,-6,6,0,0,0,1,1,0,-1,6,-1
KR_6688522457,420,-2,-43,12,-9,-2,4,2,-3,4,1,2,3,5,-1,6,5,-5,6,1,0,-8,8,3,-6,3,-2,0,0,1,0,0,-1,3,-1
KR_6638209122,440,4,24,23,8,2,1,3,3,1,4,2,1,3,0,1,1,1,2,3,0,10,-37,1,-3,2,23,0,0,1,1,0,1,1,-1
KR_6717398842,440,-2,-20,-14,-3,-1,3,2,-2,2,0,-1,1,0,-1,2,1,2,0,2,0,-6,0,-1,-2,3,2,0,-1,-1,1,-1,1,1,-1
KR_6682357507,440,-4,-68,-9,-2,4,3,7,2,4,6,-4,4,0,-2,3,1,-2,3,1,0,5,-18,2,-6,4,0,0,-1,1,-1,-1,1,2,-1
KR_6747433169,440,-2,6,0,-2,1,0,1,-2,6,4,-1,4,3,0,2,2,0,1,1,0,-8,-4,0,-4,4,1,0,-1,-1,0,-1,1,4,-1
KR_6627550353,420,-3,-32,32,-10,-7,7,0,-2,3,1,1,2,3,-1,5,4,-1,4,3,0,-11,-4,-4,-4,8,-3,0,0,-1,1,-1,1,5,-1
KR_6723690364,420,0,10,-27,-1,5,2,7,-2,2,0,-1,3,2,-1,3,2,-2,3,1,0,0,6,5,-8,3,-4,0,1,-1,-1,1,-1,4,-1
KR_6724022480,420,-1,-37,-8,5,4,1,5,1,1,2,0,1,1,1,2,3,-1,1,0,0,1,-6,1,-4,3,0,0,-1,1,-1,-1,1,4,-1
KR_6742414301,420,-2,22,-11,-8,-4,4,0,-2,5,3,-1,3,2,-1,3,2,0,2,2,0,-5,9,3,-7,4,-4,0,0,0,1,-1,-1,0,-1
KR_6724870100,440,0,12,4,2,0,1,1,-2,3,1,-4,6,2,7,1,8,1,0,1,0,5,-46,0,-3,3,-1,0,1,-1,-1,1,1,5,-1
KR_6762224253,420,-2,-82,-24,-3,3,2,5,-1,2,1,-6,10,4,3,1,4,-2,3,1,0,3,-6,-2,-1,3,2,0,-2,1,1,-1,-1,4,-1
KR_6663845908,420,-3,-19,16,-4,3,1,4,1,4,5,-4,4,0,-4,6,2,0,1,1,-2,-6,1,-2,-4,6,0,0,-1,1,1,-1,-1,1,-1
KR_6757680126,420,0,-68,10,9,0,1,1,6,0,6,0,4,4,3,1,4,0,1,1,2,3,-41,1,-6,5,15,0,-2,-1,-1,-1,1,4,-1
KR_6764685088,420,-4,-20,8,-7,-2,3,1,1,1,2,0,1,1,-6,6,0,0,0,0,0,-6,-7,1,-3,2,0,0,-1,-1,0,-1,-1,5,-1
KR_6763282002,420,-2,-74,11,-3,-5,6,1,0,1,1,1,1,2,-3,3,0,4,0,4,0,1,-41,0,-5,5,17,0,-1,-1,1,-1,1,4,-1
KR_6671322449,420,0,21,-20,-9,-2,5,3,-1,5,4,-5,7,2,1,1,2,-2,3,1,-2,-9,-237,4,-5,1,-5,0,1,-1,1,1,-1,5,-1
KR_6700637588,420,-7,-58,19,-20,-4,4,0,-1,3,2,-10,10,0,-3,6,3,-2,3,1,0,-20,15,3,-5,2,-2,0,-2,-1,-1,-1,-1,3,-1
KR_6757241771,420,-2,-41,8,-6,-1,2,1,-2,2,0,4,0,4,-5,5,0,-2,2,0,0,-10,-10,-4,-3,7,2,0,0,-1,-1,0,-1,4,-1
KR_6760081676,420,2,17,-24,2,-3,3,0,2,1,3,3,0,3,1,1,2,-1,1,0,0,1,-150,-2,-2,4,1,0,-3,-1,-1,-1,1,5,-1
KR_6727220304,420,4,69,24,13,0,2,2,1,5,6,1,3,4,2,2,4,9,0,9,2,16,-15,0,-3,3,2,0,0,1,-1,1,1,6,-1
KR_6346008802,420,-7,15,-29,-13,1,1,2,-1,1,0,-8,10,2,-4,6,2,-1,1,0,0,-18,-91,3,-7,4,-1,0,-1,-1,-1,-1,-1,6,-1
KR_6765469619,420,2,129,21,-6,-2,2,0,-1,1,0,-1,4,3,-2,3,1,0,0,0,0,-12,4,3,-6,3,-5,0,2,0,1,1,1,0,-1
KR_6723241370,420,-1,-35,-4,-3,0,1,1,-1,4,3,2,2,4,-3,4,1,-1,1,0,0,-4,2,-1,-4,5,-1,0,1,-1,1,1,-1,2,-1
KR_6767318467,420,1,-12,-28,4,2,1,3,2,2,4,1,1,2,-1,2,1,0,0,0,0,5,-226,4,-7,3,12,0,1,-1,1,1,1,3,-1
KR_6691788113,420,-1,-15,-45,-1,-2,4,2,1,1,2,-2,2,0,1,2,3,1,0,1,0,2,-2,-1,-4,5,-1,0,-1,-1,-1,-1,-1,2,-1
KR_6763868867,420,3,24,17,2,-4,5,1,2,0,2,2,2,4,0,2,2,2,0,2,0,7,-10,-1,-3,4,5,0,0,0,0,0,-1,0,-1
KR_6758019468,420,-1,-81,-32,-7,-2,3,1,1,2,3,-3,5,2,-2,2,0,-1,1,0,-1,-8,-4,-1,-2,3,-3,0,0,0,0,0,-1,0,-1
KR_6704923293,420,-3,-30,19,-7,-2,3,1,3,1,4,-2,3,1,-4,4,0,-2,2,0,0,-12,10,2,-8,6,0,0,1,-1,1,1,1,6,-1
KR_6742264519,420,-1,28,3,-1,3,0,3,-2,4,2,-1,6,5,1,5,6,-2,4,2,2,-4,-16,-5,-3,8,3,0,1,1,-1,1,1,6,-1
KR_6688827042,420,-1,-77,11,-8,-2,2,0,-1,1,0,-4,9,5,1,4,5,-2,4,2,-1,-9,26,-1,-4,5,-1,0,0,-1,1,-1,-1,2,-1
KR_6716154159,420,0,-46,-8,-1,-3,5,2,1,1,2,7,0,7,-5,5,0,-1,3,2,0,-4,1,6,-6,0,-4,0,-1,0,-1,-1,-1,0,-1
KR_6672099378,420,-8,-67,-107,-16,1,0,1,-8,10,2,-5,7,2,-1,2,1,-3,4,1,0,-9,-10,0,0,0,1,0,-4,-1,-1,-1,-1,5,-1
KR_6755558209,420,-3,-60,-24,-13,-4,4,0,1,1,2,-5,7,2,-6,10,4,1,0,1,0,-10,-22,-1,-5,6,-7,0,-2,-1,1,-1,-1,6,-1
KR_6756893946,420,-4,-102,-25,-4,0,0,0,-3,3,0,0,1,1,-3,4,1,2,1,3,0,-3,-6,-4,-6,10,5,0,0,1,-1,-1,1,2,-1
KR_6666751128,420,0,17,-28,6,-1,4,3,-2,3,1,-1,3,2,11,2,13,-1,1,0,0,13,-195,-3,-3,6,4,0,0,-1,-1,1,1,4,-1
KR_6722780494,420,0,-17,-1,0,-2,3,1,-2,4,2,2,2,4,2,0,2,0,0,0,0,-1,18,3,-8,5,-7,0,0,-1,1,0,-1,3,-1
KR_6756554154,420,-2,-57,-19,-8,-8,9,1,2,4,6,2,0,2,-1,2,1,-3,5,2,0,-2,-4,1,-4,3,1,0,-1,-1,0,-1,-1,5,-1
KR_6761616405,420,-6,-28,-18,-7,-1,3,2,-2,4,2,-2,5,3,-1,3,2,-1,1,0,0,-6,1,-2,-3,5,-1,0,-1,-1,1,-1,1,4,-1
KR_6742135720,440,0,3,-19,-2,1,1,2,-1,1,0,-2,4,2,-1,2,1,1,1,2,1,4,1,2,-5,3,-2,0,0,0,0,0,1,0,-1
KR_6662691429,420,-4,-78,5,-8,1,0,1,0,2,2,-3,5,2,-4,5,1,-2,2,0,0,-12,18,-1,-5,6,1,0,0,1,1,-1,1,5,-1
KR_6683019636,440,-1,-16,-1,1,-3,4,1,-1,4,3,0,1,1,6,0,6,-1,1,0,0,1,1,2,-3,1,-2,0,-1,0,0,-1,-1,0,-1
KR_6741130124,420,-1,84,-25,0,1,3,4,0,2,2,-2,4,2,1,2,3,0,1,1,0,-5,229,1,-3,2,1,0,2,-1,1,1,1,4,-1
KR_6710878822,420,-2,-88,-12,-6,0,3,3,0,2,2,0,1,1,-4,6,2,-2,2,0,-1,-10,-1,0,-3,3,-1,0,-1,-1,-1,-1,-1,6,-1
KR_6758963489,420,-2,-22,-30,1,-2,3,1,-1,3,2,1,3,4,0,1,1,3,1,4,0,8,18,3,-4,1,7,0,0,1,-1,-1,1,6,-1
KR_6289262150,440,2,47,23,3,-1,2,1,0,4,4,1,4,5,0,3,3,3,1,4,1,5,28,-1,-2,3,-2,0,-1,1,-1,-1,1,6,-1
KR_6643775422,420,-3,-29,-7,-3,7,0,7,-5,5,0,1,0,1,-4,5,1,-2,5,3,1,-5,10,1,-3,2,-5,0,0,1,0,-1,1,4,-1
KR_6730419697,440,-1,-51,20,-13,-3,7,4,-3,3,0,0,2,2,-4,4,0,-3,3,0,-1,-17,0,0,-2,2,3,0,-1,-1,1,-1,-1,6,-1
KR_6741656423,420,-1,-25,12,-6,1,1,2,-2,4,2,-1,1,0,-3,4,1,-1,1,0,0,-7,47,-2,-4,6,-22,0,-1,1,-1,-1,1,2,-1
KR_6707154956,420,-1,-67,20,-5,-3,5,2,1,0,1,-2,3,1,-1,1,0,0,2,2,-1,-7,-17,-3,-4,7,1,0,-1,-1,1,-1,-1,1,-1
KR_6713881484,420,1,16,0,0,1,1,2,-1,3,2,-3,5,2,2,0,2,1,0,1,0,2,-1,-5,-3,8,6,0,0,-1,-1,0,-1,6,-1
KR_6401507195,440,-3,-107,-34,-2,2,3,5,-1,3,2,-2,5,3,-1,5,4,0,1,1,0,8,0,1,-4,3,-7,0,-1,-1,-1,-1,-1,1,-1
KR_6767685450,440,0,1,4,-2,5,0,5,-1,8,7,1,0,1,-5,8,3,-2,4,2,-2,-15,-24,0,-4,4,2,0,0,1,-1,-1,-1,5,-1
KR_6674512327,440,-3,-52,-1,-5,2,0,2,0,0,0,-4,7,3,-2,3,1,-1,2,1,0,-7,9,2,-7,5,-6,0,-1,-1,1,-1,-1,3,-1
KR_6494616858,420,-6,-74,-20,-11,1,2,3,-7,8,1,-3,5,2,-5,5,0,3,1,4,0,-8,21,-2,-4,6,-4,0,-1,-1,-1,-1,1,3,-1
KR_6764335767,420,3,55,-5,7,1,0,1,1,3,4,4,0,4,0,5,5,1,1,2,0,4,22,2,-5,3,-5,0,1,-1,1,1,1,5,-1
KR_6760327066,420,-3,-6,-20,-7,1,1,2,1,0,1,-1,4,3,-2,2,0,-6,7,1,0,-5,-10,0,-4,4,-2,0,0,-1,-1,0,-1,1,-1
KR_6635663810,420,-1,-48,16,1,1,1,2,2,2,4,-1,1,0,1,1,2,-2,5,3,2,6,8,1,-8,7,-2,0,0,-1,-1,0,1,5,-1
KR_6746638326,420,5,53,-11,16,10,0,10,0,2,2,-1,6,5,7,0,7,0,1,1,0,21,10,8,-9,1,0,0,1,1,1,1,1,6,-1
KR_6762222442,420,-1,-79,8,-3,-1,2,1,-3,3,0,-2,3,1,1,1,2,2,0,2,0,6,11,1,-5,4,-4,0,1,1,-1,1,1,1,-1
KR_6733167795,440,-3,-38,0,0,4,2,6,0,1,1,-2,3,1,-4,5,1,2,2,4,0,-2,15,0,-1,1,-1,0,-3,-1,-1,-1,1,6,-1
KR_6607867681,420,-1,-11,12,-2,2,2,4,2,1,3,-2,2,0,0,0,0,-4,4,0,0,-1,-11,-8,-1,9,2,0,-1,-1,-1,-1,1,5,-1
KR_6761678465,420,1,44,-18,0,1,1,2,-2,5,3,-3,4,1,6,0,6,-2,2,0,0,-5,31,-4,-3,7,-11,0,1,-1,-1,1,-1,5,-1
KR_6767275389,440,-2,-84,9,-6,-1,2,1,-1,1,0,2,4,6,-3,4,1,-3,3,0,0,-15,-7,-5,0,5,-3,0,-1,1,-1,-1,-1,5,-1
KR_6698702184,440,-7,-37,-28,-14,-8,9,1,-1,2,1,-1,3,2,-3,4,1,-1,3,2,1,-16,237,-2,-5,7,-2,0,-3,0,-1,-1,1,0,-1
KR_6764101637,420,1,12,-17,2,2,2,4,-3,5,2,0,3,3,3,2,5,0,1,1,-2,-6,-31,-1,-5,6,5,0,0,1,-1,1,-1,3,-1
KR_6657796837,420,2,-27,-12,0,1,3,4,1,2,3,-1,1,0,0,0,0,-1,1,0,0,0,-1,-1,-3,4,1,0,0,-1,-1,1,-1,4,-1
KR_6592137239,420,-1,-30,-30,1,0,1,1,2,1,3,0,2,2,-2,5,3,1,1,2,0,2,0,-3,-1,4,-2,0,0,-1,1,1,-1,2,-1
KR_6663437639,420,-2,61,12,-4,3,0,3,-6,14,8,1,0,1,-1,2,1,-1,2,1,0,-7,-3,-3,-2,5,-2,0,-2,1,-1,-1,1,1,-1
KR_6723636141,420,0,26,-18,2,-1,2,1,1,4,5,2,3,5,1,5,6,-1,2,1,2,10,-7,5,-6,1,-5,0,0,-1,1,0,1,3,-1
KR_6711592594,420,1,65,45,-4,0,0,0,4,1,5,-2,4,2,-6,6,0,0,1,1,0,-4,-1,3,-7,4,0,0,1,0,-1,1,1,0,-1
KR_6676871026,420,-1,-15,8,-4,-5,7,2,0,2,2,0,3,3,3,1,4,-2,2,0,0,-2,-1,2,-4,2,1,0,-2,-1,-1,-1,1,4,-1
KR_6741677737,420,0,-28,-28,-9,-7,8,1,1,1,2,2,3,5,-5,7,2,0,3,3,-1,-6,10,4,-8,4,-7,0,-1,-1,-1,-1,-1,3,-1
KR_6751745330,420,2,16,-8,4,3,1,4,-2,2,0,1,2,3,-1,4,3,3,1,4,0,0,-9,0,-4,4,0,0,1,0,1,1,1,0,-1
KR_6735623076,440,-5,-39,-29,-12,-4,5,1,-6,9,3,-5,7,2,3,3,6,0,0,0,-1,-15,-4,1,-5,4,-1,0,-1,-1,-1,-1,-1,1,-1
KR_6745987005,420,-1,29,-4,0,1,0,1,1,5,6,-4,5,1,1,2,3,1,1,2,0,-3,2,-4,-4,8,1,0,0,0,1,0,1,0,-1
KR_6734606898,440,-2,-95,0,-5,7,0,7,-3,3,0,1,1,2,-7,7,0,-3,6,3,-1,-5,-24,-3,0,3,3,0,-1,1,-1,-1,-1,3,-1
KR_6662143070,420,-3,-38,-20,-2,-3,4,1,2,3,5,0,1,1,0,3,3,-1,3,2,0,1,-2,0,-4,4,-5,0,-1,1,-1,-1,1,2,-1
KR_6710620211,420,-6,-76,-24,-11,0,2,2,-3,6,3,-8,9,1,0,2,2,0,1,1,1,-4,0,2,-4,2,-1,0,-1,1,-1,-1,1,4,-1
KR_6627110620,420,-2,-1,16,-2,-1,2,1,-2,3,1,0,1,1,4,3,7,-3,4,1,0,-5,240,-5,-2,7,0,0,0,1,-1,0,1,5,-1
KR_6693201905,420,3,24,24,-3,-2,3,1,2,2,4,-1,4,3,-5,5,0,3,3,6,0,-10,518,-1,-1,2,-3,0,1,1,1,1,-1,6,-1
KR_6715088239,420,0,-18,-17,1,2,3,5,-2,5,3,-2,4,2,2,0,2,1,0,1,0,6,11,-1,0,1,0,0,0,-1,-1,0,-1,4,-1
KR_6761203346,420,-3,-44,16,-5,-4,4,0,0,3,3,2,2,4,-4,6,2,1,0,1,0,-7,37,0,-4,4,-4,0,1,-1,1,1,1,6,-1
KR_6764996511,420,-1,0,4,1,-1,3,2,-1,2,1,-2,3,1,3,2,5,2,1,3,0,-3,2,-1,-3,4,2,0,0,1,-1,0,1,4,-1
KR_6759877182,420,2,-9,0,-1,-1,2,1,3,1,4,-3,3,0,-2,4,2,2,0,2,0,-1,-22,-6,-3,9,3,0,0,-1,0,0,-1,2,-1
KR_6646091550,420,2,19,-16,-2,0,0,0,1,1,2,-1,2,1,-1,1,0,-1,1,0,0,-2,-8,-3,-5,8,-1,0,0,1,1,0,-1,5,-1
KR_6694005767,420,-1,12,32,-1,0,1,1,-4,4,0,-2,4,2,1,4,5,4,0,4,0,1,-5,-2,-3,5,5,0,0,1,1,0,1,2,-1
KR_6724851872,420,-6,-53,-28,-8,0,2,2,-1,3,2,-8,8,0,3,0,3,-2,5,3,0,-1,5,-1,-3,4,-5,0,-2,-1,-1,-1,1,1,-1
KR_6712578303,420,2,59,-14,1,2,1,3,-3,4,1,3,1,4,2,1,3,-3,4,1,0,0,-2,0,-5,5,1,0,0,-1,1,1,1,3,-1
KR_6754403976,420,-4,-55,-24,-3,3,0,3,0,1,1,-7,9,2,-2,5,3,3,0,3,1,-2,1,-4,-3,7,0,0,1,-1,-1,1,1,6,-1
KR_6563151768,440,-2,-17,25,-12,-4,6,2,-1,8,7,0,4,4,-3,3,0,-4,4,0,0,-15,1,1,-3,2,0,0,1,1,1,1,-1,3,-1
KR_6624096481,420,1,89,-40,2,4,0,4,-3,3,0,-4,5,1,5,0,5,0,1,1,0,5,4,1,-5,4,1,0,0,0,-1,0,1,0,-1
KR_6713786665,440,-5,-109,7,-9,-4,4,0,-1,4,3,-3,5,2,0,2,2,-1,1,0,-1,-10,-1,-3,-4,7,-4,0,-3,-1,-1,-1,-1,2,-1
KR_6622836229,420,-2,-2,-16,-5,2,1,3,-2,4,2,-5,6,1,4,3,7,-4,4,0,1,-4,4,2,-5,3,2,0,0,-1,1,0,1,2,-1
KR_6755694733,420,3,96,11,5,0,2,2,1,2,3,-4,5,1,8,2,10,0,1,1,-1,-1,13,-4,-1,5,1,0,1,1,1,1,-1,3,-1
KR_6747319235,420,-4,-57,-20,-14,-1,4,3,-3,4,1,-10,10,0,0,4,4,0,2,2,-1,-9,0,2,-6,4,-2,0,-2,-1,-1,-1,-1,2,-1
KR_6724014210,420,5,94,24,3,5,0,5,2,2,4,-2,5,3,-1,4,3,-1,1,0,0,-5,8,-2,-2,4,2,0,0,-1,0,1,1,6,-1
KR_6687170796,420,0,-44,0,0,-6,6,0,1,1,2,5,1,6,2,2,4,-2,2,0,0,11,15,-1,-4,5,1,0,-2,-1,1,-1,-1,6,-1
KR_6766105275,420,2,6,16,2,2,1,3,-4,7,3,3,2,5,2,3,5,-1,2,1,1,3,1,6,-9,3,-2,0,0,-1,0,0,1,3,-1
KR_6757796100,420,-1,-40,-10,-9,1,3,4,1,0,1,-5,7,2,-6,6,0,0,1,1,-1,1,-18,0,-4,4,-5,0,-1,-1,1,-1,-1,2,-1
KR_6767212886,420,-4,-38,-12,-13,-1,1,0,-3,4,1,-7,8,1,-2,3,1,0,0,0,0,-6,-10,3,-7,4,2,0,-1,-1,-1,-1,-1,5,-1
KR_6612405935,420,2,-61,52,1,2,2,4,0,1,1,-3,5,2,2,1,3,0,1,1,0,8,182,-1,-3,4,-2,0,-1,-1,-1,-1,-1,6,-1
KR_6688465099,420,2,8,33,0,-5,6,1,0,1,1,2,1,3,1,2,3,2,0,2,0,3,11,-1,-3,4,-1,0,-1,1,-1,-1,-1,5,-1
KR_6715800108,420,-2,-44,6,-10,-1,1,0,-1,3,2,-3,4,1,-4,7,3,-1,3,2,0,-9,-203,1,-8,7,-6,0,-3,1,-1,-1,-1,1,-1
KR_6540991635,420,-5,-100,-11,-5,5,1,6,-2,2,0,1,0,1,-5,5,0,-4,4,0,0,-7,-22,0,-4,4,-1,0,-2,-1,1,-1,1,5,-1
KR_6684145261,420,-4,16,-12,-9,-1,3,2,-4,5,1,-2,4,2,-2,4,2,0,0,0,0,-13,-24,-2,-3,5,5,0,0,1,-1,0,1,6,-1
KR_6750609838,420,-1,-15,-24,-4,-1,2,1,0,4,4,-3,5,2,2,2,4,-2,4,2,0,-1,2,0,-4,4,-2,0,0,0,0,-1,-1,0,-1
KR_6737384928,420,-2,-69,-4,-9,-6,6,0,-3,5,2,-1,4,3,2,0,2,-1,2,1,0,-4,1,-5,-2,7,2,0,0,-1,1,-1,-1,1,-1
KR_6679290007,420,3,97,-28,9,0,1,1,-5,5,0,9,4,13,3,1,4,2,0,2,0,8,-237,-7,-5,12,6,0,1,-1,-1,-1,1,2,-1
KR_6752527281,420,-2,35,-11,0,3,0,3,-2,5,3,-2,2,0,0,2,2,1,0,1,0,-2,-22,-1,-4,5,-1,0,-1,1,-1,-1,1,3,-1
KR_6765885175,440,-3,-56,-40,-5,-2,3,1,2,4,6,-4,4,0,-2,4,2,1,0,1,-1,-2,-3,-5,-3,8,-1,0,-2,0,-1,-1,-1,0,-1
KR_6687202860,420,-4,-77,-12,-9,-4,5,1,0,2,2,-3,3,0,-1,1,0,-1,1,0,0,-7,5,4,-5,1,3,0,0,-1,1,-1,1,2,-1
KR_6758879457,420,-8,-109,-29,-10,-1,3,2,-2,8,6,-5,7,2,-2,3,1,0,0,0,-1,-14,-34,-5,0,5,2,0,-2,-1,1,-1,-1,3,-1
KR_6732162977,420,-2,16,-19,-9,-1,5,4,-6,6,0,-2,2,0,-2,5,3,2,0,2,0,-4,-5,-1,-4,5,0,0,-1,-1,-1,-1,-1,3,-1
KR_6384380143,420,-7,-72,4,-5,1,0,1,1,3,4,-7,7,0,-1,4,3,1,1,2,0,1,13,4,-7,3,-4,0,0,-1,-1,-1,1,4,-1
KR_6766540715,420,-2,-84,8,-9,2,0,2,1,1,2,-7,9,2,-3,4,1,-2,4,2,-3,-12,2,-3,-2,5,-4,0,0,-1,-1,-1,1,2,-1
KR_6734258853,420,1,-36,27,-2,-1,3,2,-1,1,0,1,2,3,-2,2,0,1,2,3,0,-6,6,2,-9,7,0,0,0,-1,1,1,-1,1,-1
KR_6449072092,420,-1,-42,-9,-3,-1,1,0,-2,3,1,1,1,2,-1,4,3,0,1,1,0,-3,115,2,-4,2,7,0,0,0,1,0,-1,0,-1
KR_6745721437,420,0,-18,0,1,-1,3,2,-1,4,3,3,0,3,0,0,0,0,0,0,0,0,159,-2,-3,5,-1,0,0,-1,1,0,-1,3,-1
KR_6717416675,420,-3,17,5,-6,-2,5,3,-2,4,2,4,2,6,-2,3,1,-4,5,1,0,-9,6,7,-7,0,-1,0,0,0,0,-1,-1,0,-1
KR_6749382498,420,-5,-83,-28,-13,-10,13,3,-2,4,2,-1,2,1,-1,5,4,1,1,2,0,-4,-162,-6,-1,7,0,0,-2,0,-1,-1,-1,0,-1
KR_6745850080,420,0,30,-5,-6,-1,4,3,-4,6,2,1,4,5,-1,1,0,-1,2,1,0,-3,12,-5,-2,7,0,0,-1,1,-1,-1,1,1,-1
KR_6756412164,420,0,79,-8,0,0,1,1,-1,7,6,1,0,1,0,3,3,0,1,1,0,-3,19,4,-7,3,-5,0,0,-1,-1,0,-1,4,-1
KR_6685074187,420,-5,-81,-7,-14,-9,9,0,-4,5,1,1,3,4,-2,2,0,0,1,1,0,-4,10,-1,-3,4,-2,0,-3,-1,-1,-1,-1,1,-1
KR_6760532905,420,3,40,-6,3,1,1,2,0,2,2,1,4,5,-3,3,0,4,1,5,0,3,8,2,-5,3,-3,0,0,1,-1,1,1,1,-1
KR_6759618444,440,-1,-70,17,-1,-1,2,1,0,0,0,2,0,2,-2,5,3,0,0,0,0,0,-8,-6,-1,7,0,0,-1,1,-1,-1,-1,2,-1
KR_6737810128,420,-4,-78,0,-7,-2,2,0,1,1,2,-9,10,1,1,1,2,2,1,3,0,-1,239,-4,-2,6,2,0,-2,1,-1,-1,-1,6,-1
KR_6618345218,420,0,-26,-6,7,-1,4,3,2,2,4,7,0,7,-1,3,2,0,1,1,0,17,-1,6,-6,0,0,0,0,-1,1,1,1,5,-1
KR_6760592726,420,-6,-7,-9,-11,3,1,4,0,1,1,-8,8,0,-3,5,2,-3,3,0,0,-8,4,-3,-3,6,-3,0,0,-1,-1,1,-1,1,-1
KR_6729657134,420,1,-4,-16,4,1,0,1,-3,5,2,1,3,4,5,1,6,0,1,1,-1,-4,-4,-5,-4,9,-1,0,-1,1,-1,-1,-1,2,-1
KR_6767361929,420,5,28,16,15,-3,5,2,11,1,12,4,1,5,2,1,3,1,4,5,0,20,-6,2,-7,5,1,0,0,-1,-1,-1,1,4,-1
KR_6567904230,420,3,10,18,6,0,2,2,0,3,3,1,1,2,4,1,5,1,0,1,0,6,1,0,-6,6,4,0,0,1,-1,-1,1,5,-1
KR_6703634177,420,-5,-67,-16,-13,-3,5,2,-9,9,0,2,2,4,0,3,3,-3,4,1,0,-25,-9,3,-5,2,1,0,-4,1,-1,-1,-1,2,-1
KR_6747866844,440,-5,-4,0,-19,-3,3,0,-8,8,0,-3,5,2,-4,5,1,-1,1,0,0,-19,-12,-4,0,4,-2,0,0,-1,0,-1,-1,3,-1
KR_6720193428,420,-3,-12,-13,-7,-8,8,0,0,3,3,-2,4,2,2,0,2,1,0,1,0,-8,-4,2,-5,3,-5,0,-2,-1,-1,-1,1,3,-1
KR_6663420787,420,-1,-77,-4,4,0,0,0,0,5,5,1,3,4,2,2,4,1,1,2,0,1,-15,4,-6,2,-2,0,0,-1,-1,0,1,5,-1
KR_6754462112,420,-4,-122,-18,2,-2,3,1,-1,7,6,4,2,6,0,3,3,1,0,1,0,0,-9,-2,-3,5,1,0,-2,-1,-1,-1,1,1,-1
KR_6627294252,420,-3,-35,-6,1,3,0,3,1,1,2,-2,4,2,-3,8,5,2,1,3,0,1,168,1,-9,8,-3,0,1,-1,-1,1,1,2,-1
KR_6740084280,420,-2,-42,23,-8,3,1,4,-5,6,1,-3,3,0,-4,6,2,1,0,1,0,-15,-6,-3,-3,6,0,0,-2,-1,-1,-1,-1,6,-1
KR_6676150874,440,-1,53,-12,3,0,1,1,-3,4,1,5,1,6,0,3,3,1,0,1,0,5,5,-8,-2,10,-2,0,-1,1,1,-1,-1,5,-1
KR_6764500709,420,1,33,4,2,3,0,3,0,1,1,4,0,4,-6,7,1,1,0,1,0,-3,-40,3,-7,4,-2,0,1,-1,1,-1,-1,6,-1
KR_6705535367,420,-1,7,-44,-2,2,1,3,-2,4,2,4,0,4,-2,3,1,-4,4,0,0,-5,-24,3,-7,4,15,0,-1,-1,-1,-1,1,5,-1
KR_6662273270,440,-6,-101,-3,-10,0,1,1,4,0,4,-8,9,1,-6,6,0,0,1,1,0,0,3,0,-2,2,-2,0,-2,1,1,-1,1,6,-1
KR_6709352046,420,-5,-38,-11,-15,-1,1,0,-3,5,2,-6,8,2,-7,8,1,2,1,3,0,-12,-10,-5,-3,8,-2,0,0,1,1,1,1,2,-1
KR_6658630952,420,2,32,8,2,4,0,4,-5,6,1,2,0,2,2,0,2,-1,1,0,0,-4,-229,2,-5,3,0,0,2,-1,0,1,-1,2,-1
KR_6621459840,420,-4,-113,-3,-11,-9,9,0,-5,9,4,2,3,5,1,1,2,0,2,2,0,-10,105,6,-12,6,-6,0,-2,1,-1,-1,1,1,-1
KR_6763088290,420,-1,-37,18,-4,0,1,1,-6,9,3,-1,1,0,1,4,5,2,0,2,0,-11,4,-2,-5,7,-2,0,-1,1,-1,-1,1,1,-1
KR_6308934198,440,-2,8,-44,0,-1,3,2,-4,5,1,0,1,1,5,1,6,0,1,1,0,7,2,-5,-1,6,4,0,0,-1,-1,-1,-1,6,-1
KR_6756855880,420,0,-11,34,-1,1,0,1,1,2,3,-1,3,2,-1,2,1,-1,2,1,0,-2,-38,2,-5,3,24,0,-1,-1,1,-1,-1,5,-1
KR_6745045019,440,-5,-60,-28,-4,1,0,1,-2,7,5,0,1,1,-1,1,0,-2,3,1,0,-2,-65,3,-9,6,2,0,-1,1,-1,-1,1,5,-1
KR_6743031545,420,-3,-14,-44,-4,1,2,3,0,1,1,0,3,3,-5,6,1,0,1,1,0,-4,253,1,-7,6,1,0,1,-1,1,1,-1,4,-1
KR_6762040025,420,0,-56,20,5,1,1,2,1,1,2,4,1,5,-4,5,1,3,2,5,0,2,5,1,-5,4,2,0,0,-1,0,0,-1,4,-1
KR_6720322163,420,-1,-67,-10,1,-3,4,1,1,0,1,1,2,3,2,0,2,0,1,1,0,1,-7,1,-6,5,-9,0,0,1,-1,-1,1,4,-1
KR_6734856376,420,3,-52,45,6,2,2,4,2,2,4,-1,3,2,3,0,3,0,2,2,0,4,-95,0,-4,4,-4,0,0,-1,1,0,1,6,-1
KR_6692280704,420,-10,-109,-25,-15,-3,3,0,0,1,1,-3,6,3,-10,11,1,1,1,2,1,-21,-3,-3,-4,7,-5,0,-3,-1,-1,-1,1,6,-1
KR_6700988225,420,-3,7,-8,-4,-2,3,1,-1,2,1,-5,6,1,3,2,5,1,1,2,1,-2,1,1,-7,6,-2,0,0,1,1,-1,1,3,-1
KR_6750665239,420,-1,-82,-4,-3,-1,3,2,2,2,4,1,1,2,-5,7,2,0,0,0,0,-1,19,2,-3,1,2,0,0,1,1,1,-1,6,-1
KR_6703407646,420,2,13,-21,-1,6,1,7,-8,12,4,1,1,2,0,2,2,0,4,4,0,-1,-1,0,-6,6,3,0,0,-1,0,0,-1,3,-1
KR_6729715893,440,-3,51,-15,-3,0,2,2,4,1,5,0,1,1,-1,4,3,-6,6,0,0,-4,3,-1,-3,4,-5,0,1,-1,1,1,1,3,-1
KR_6749297141,420,-6,-116,-9,-10,-2,3,1,-1,3,2,-5,7,2,-3,6,3,1,0,1,-2,-11,5,-1,-4,5,-1,0,-1,-1,-1,-1,-1,1,-1
KR_6755031470,420,0,-110,32,0,3,1,4,0,2,2,0,3,3,-5,5,0,2,0,2,0,-3,-3,-3,-1,4,-5,0,0,-1,1,-1,-1,1,-1
KR_6742502914,420,-3,27,-36,-2,0,0,0,-2,3,1,-2,3,1,3,3,6,-1,3,2,0,2,-4,0,-2,2,-2,0,0,-1,-1,0,-1,4,-1
KR_6380902054,420,2,2,12,6,-2,2,0,7,0,7,2,1,3,-3,5,2,2,0,2,0,6,-32,1,-6,5,16,0,0,1,-1,-1,1,3,-1
KR_6766725280,420,-6,-55,16,-5,-2,4,2,0,1,1,-5,5,0,3,2,5,-1,4,3,0,-3,-7,0,-5,5,-2,0,-2,-1,-1,-1,-1,2,-1
KR_6767088499,420,-2,5,-14,0,-1,1,0,2,0,2,-4,5,1,0,2,2,3,0,3,0,3,-1,-1,-6,7,1,0,-1,1,-1,-1,1,1,-1
KR_6737209951,440,-4,-36,-4,-10,-8,9,1,2,0,2,-3,3,0,-1,4,3,0,0,0,0,-10,0,-2,-4,6,0,0,-2,-1,-1,-1,-1,2,-1
KR_6703710116,420,-7,-88,-109,-1,2,1,3,-1,2,1,-6,7,1,4,5,9,0,0,0,0,7,-1,-3,-4,7,4,0,-2,0,-1,-1,1,0,-1
KR_6764393739,420,-3,-48,-16,-8,0,3,3,-4,4,0,-3,3,0,-1,1,0,0,0,0,0,-6,-12,-1,-2,3,-2,0,0,-1,1,-1,-1,3,-1
KR_6737555496,420,1,98,16,-6,0,0,0,-4,5,1,1,3,4,-1,3,2,-2,2,0,0,-16,-200,0,-6,6,4,0,1,0,1,1,-1,0,-1
KR_6748120399,420,-5,-81,8,-5,-4,6,2,0,2,2,1,1,2,-2,4,2,0,0,0,2,4,-322,-4,-6,10,-1,0,0,-1,0,-1,1,5,-1
KR_6640686660,420,-2,9,-4,1,0,1,1,4,1,5,-2,3,1,-3,4,1,2,0,2,1,7,8,1,-5,4,1,0,0,-1,-1,0,1,6,-1
KR_6722442545,440,-2,37,-21,-8,-1,2,1,-4,4,0,-4,5,1,3,0,3,-2,2,0,0,-11,-25,-2,-1,3,5,0,-1,1,-1,-1,-1,6,-1
KR_6755740475,420,-2,-17,-19,-10,0,1,1,0,2,2,-2,4,2,-4,6,2,-4,5,1,1,1,-1,3,-7,4,-3,0,-1,0,0,-1,1,0,-1
KR_6762142943,420,-1,-24,4,-2,-2,4,2,0,4,4,-2,2,0,4,2,6,-2,4,2,0,-1,-10,1,-5,4,0,0,-1,-1,1,-1,-1,2,-1
KR_6520224922,420,1,55,-23,3,2,2,4,-3,6,3,-1,1,0,3,0,3,2,1,3,0,11,-20,2,-6,4,2,0,1,-1,1,1,-1,3,-1
KR_6633211516,440,-7,-131,-5,-12,-6,6,0,0,0,0,-3,4,1,-3,3,0,0,0,0,0,-10,-17,-3,-3,6,-5,0,-2,-1,-1,-1,-1,5,-1
KR_6760385423,420,-6,-126,15,-24,-4,6,2,-3,3,0,-12,12,0,-6,6,0,1,4,5,0,-10,0,-2,-1,3,-2,0,-1,-1,-1,-1,-1,4,-1
KR_6657695717,420,-5,-38,-21,-7,-1,1,0,2,4,6,-3,3,0,-3,4,1,-2,4,2,0,-6,-6,-3,-5,8,0,0,0,1,-1,-1,-1,2,-1
KR_6765479902,420,-3,-3,-29,-4,-4,6,2,0,3,3,0,1,1,2,4,6,-2,2,0,0,2,45,1,-3,2,-27,0,-1,-1,-1,-1,-1,4,-1
KR_6631690978,420,-4,1,-38,-8,-4,4,0,-3,3,0,-1,3,2,1,3,4,-1,1,0,0,-5,4,1,-4,3,2,0,-2,-1,-1,-1,1,1,-1
KR_6740101363,420,-3,3,-7,-8,-4,4,0,-4,5,1,3,0,3,1,1,2,-4,5,1,1,-5,27,1,-4,3,0,0,-1,1,-1,-1,1,1,-1
KR_6597116901,420,0,-13,-12,1,-3,4,1,0,1,1,0,0,0,4,0,4,0,0,0,0,2,-1,1,-6,5,2,0,0,1,-1,0,-1,2,-1
KR_6734893609,420,-2,4,8,-2,-1,4,3,0,1,1,-7,9,2,8,0,8,-2,4,2,-1,-7,-46,2,-9,7,0,0,1,-1,0,1,-1,3,-1
KR_6751766067,420,-2,-52,-20,-7,0,0,0,-6,7,1,1,2,3,0,3,3,-2,3,1,0,-6,-9,-1,-1,2,-2,0,-1,-1,-1,-1,-1,4,-1
KR_6514228980,420,-8,-118,-34,-26,-2,4,2,-9,10,1,-5,13,8,-6,7,1,-4,4,0,-1,-22,-152,-8,0,8,0,0,-4,0,-1,-1,-1,0,-1
KR_6765663560,420,5,-7,-10,6,4,1,5,-2,3,1,2,2,4,-2,7,5,4,1,5,0,-1,17,-1,-2,3,2,0,1,-1,1,1,-1,5,-1
KR_6740877842,420,-2,-11,-48,-1,1,1,2,2,1,3,-4,5,1,0,5,5,0,0,0,0,1,6,-2,-3,5,-5,0,0,-1,-1,0,-1,4,-1
KR_6729410974,420,-6,-92,-16,-15,2,0,2,-1,3,2,-3,3,0,-14,15,1,1,0,1,0,-10,9,2,-4,2,-5,0,-5,-1,-1,-1,-1,4,-1
KR_6666058315,420,-2,-130,-9,-4,-1,3,2,-2,3,1,1,0,1,0,1,1,-2,2,0,0,-5,11,4,-8,4,-4,0,-2,1,-1,-1,-1,2,-1
KR_6638374106,420,-2,51,-48,-4,-3,3,0,-1,2,1,-1,5,4,-1,3,2,2,0,2,-2,-4,-8,-5,-1,6,3,0,0,0,-1,0,-1,0,-1
KR_6765938282,420,2,7,-17,4,1,1,2,2,2,4,7,0,7,-4,7,3,-2,2,0,0,10,3,3,-6,3,0,0,1,1,1,1,-1,2,-1
KR_6764986743,420,-2,20,-16,1,1,2,3,2,1,3,-4,5,1,2,0,2,0,3,3,0,0,-8,-3,-4,7,4,0,-1,1,-1,-1,1,4,-1
KR_6767929965,420,-1,-97,-28,-1,-1,1,0,-4,6,2,1,1,2,2,3,5,1,0,1,-2,-5,-48,-7,-1,8,0,0,-1,-1,-1,-1,-1,3,-1
KR_6713869246,440,0,37,12,1,3,1,4,-4,6,2,4,2,6,0,0,0,-2,2,0,0,-3,-9,7,-9,2,1,0,-1,1,-1,-1,-1,5,-1
KR_6609644895,420,-1,30,-12,-5,0,0,0,-6,8,2,3,1,4,-1,3,2,-1,3,2,0,-8,-1,-4,-3,7,1,0,-1,1,-1,-1,-1,2,-1
KR_6712329314,420,1,-50,3,0,4,3,7,-2,2,0,-2,8,6,0,2,2,0,0,0,0,-2,-4,2,-6,4,-3,0,-1,1,-1,1,-1,6,-1
KR_6628485118,420,0,-43,-24,-2,-2,5,3,0,4,4,-2,4,2,0,3,3,2,0,2,0,9,1,1,-4,3,0,0,-1,-1,0,-1,-1,5,-1
KR_6759236253,420,0,-34,-8,5,-2,2,0,0,1,1,5,1,6,0,2,2,2,1,3,0,9,202,4,-7,3,-1,0,0,-1,1,0,1,2,-1
KR_6739399646,420,-2,-53,3,-12,-6,6,0,-6,10,4,0,2,2,-2,2,0,2,0,2,0,-14,-159,0,-2,2,-21,0,-1,0,0,-1,-1,0,-1
KR_6721979446,440,-1,-31,-28,-1,-1,3,2,-3,4,1,1,0,1,1,1,2,1,0,1,0,4,0,3,-8,5,-3,0,1,1,-1,-1,1,3,-1
KR_6767380968,420,-4,-40,0,-19,-5,5,0,-2,3,1,1,3,4,-11,11,0,-2,2,0,0,-16,5,3,-4,1,4,0,-1,1,-1,-1,1,4,-1
KR_6738546588,420,-5,1,-38,-9,-3,4,1,0,2,2,-2,3,1,-5,8,3,1,1,2,0,-10,4,1,-5,4,-7,0,-1,1,-1,1,1,1,-1
KR_6765517183,420,-4,-37,-24,-11,-3,4,1,-2,3,1,0,1,1,-5,5,0,-1,4,3,-2,-17,-8,-4,-2,6,2,0,-2,-1,-1,-1,-1,2,-1
KR_6751048889,440,4,56,-12,0,-1,1,0,2,3,5,1,2,3,0,2,2,-2,4,2,-1,-4,0,-2,-5,7,-2,0,1,-1,0,1,-1,5,-1
KR_6706669473,420,-2,-28,1,-2,1,1,2,-4,4,0,5,1,6,-1,3,2,-3,3,0,1,-3,44,-4,-2,6,-14,0,0,-1,1,1,1,2,-1
KR_6755210424,420,-1,-7,-12,-1,0,0,0,-2,2,0,2,0,2,0,2,2,-1,1,0,0,-3,2,0,-4,4,0,0,0,-1,-1,0,-1,1,-1
KR_6744741980,420,-2,-89,4,1,2,0,2,-6,7,1,7,1,8,-2,4,2,0,0,0,0,-2,3,-3,-2,5,2,0,1,1,1,1,-1,5,-1
KR_6675654808,420,-1,8,-20,0,2,0,2,-4,6,2,-1,4,3,3,3,6,0,0,0,0,-3,0,1,-6,5,1,0,1,-1,1,1,1,1,-1
KR_6727530882,420,-4,24,-39,-7,-1,2,1,-2,4,2,-4,5,1,-1,7,6,1,2,3,1,0,-7,-2,-6,8,1,0,-1,-1,-1,-1,1,6,-1
KR_6718565781,440,-1,-29,4,2,-4,4,0,2,0,2,1,0,1,-1,2,1,4,3,7,0,6,21,0,-3,3,-5,0,-1,1,1,-1,1,6,-1
KR_6755473277,420,-4,11,-31,-8,-1,2,1,-9,10,1,-6,6,0,6,1,7,2,1,3,0,-6,450,3,-3,0,-2,0,-1,-1,0,-1,1,2,-1
KR_6755669260,420,1,25,28,-1,2,0,2,1,2,3,-2,5,3,1,4,5,-3,3,0,2,2,-126,-1,-5,6,11,0,0,-1,1,0,1,4,-1
KR_6711260178,420,-5,-44,-29,-8,-1,3,2,-1,4,3,-5,6,1,-1,2,1,0,1,1,0,2,-9,2,-2,0,2,0,-2,-1,-1,-1,-1,4,-1
KR_6703576704,420,-1,57,1,-2,-2,3,1,-1,2,1,0,5,5,-1,1,0,2,0,2,0,2,115,-1,-4,5,-1,0,0,-1,-1,1,-1,6,-1
KR_6717225926,420,0,-21,21,-2,-2,4,2,0,1,1,1,0,1,0,0,0,-1,1,0,0,-1,3,-1,-5,6,-4,0,0,1,-1,0,1,5,-1
KR_6724367378,440,-4,-45,10,-14,0,1,1,-1,3,2,-8,9,1,-5,6,1,0,1,1,0,-8,-62,-4,-1,5,3,0,-2,-1,-1,-1,-1,4,-1
KR_6565347449,420,3,29,-4,-1,1,1,2,4,0,4,0,1,1,-6,8,2,0,0,0,0,-5,-2,-3,-6,9,-2,0,-1,-1,-1,-1,1,6,-1
KR_6713927033,420,-1,-42,9,-6,-5,5,0,2,1,3,0,0,0,-2,3,1,-1,1,0,-2,-8,293,0,-5,5,-4,0,-1,-1,-1,-1,-1,6,-1
KR_6754869165,420,-3,-40,-38,-14,2,1,3,-3,5,2,-2,3,1,-10,12,2,-1,2,1,0,-12,3,2,-5,3,-2,0,-2,-1,0,-1,-1,1,-1
KR_6561798637,420,-2,-50,-3,3,-1,3,2,7,2,9,-1,2,1,-1,5,4,-1,4,3,-1,1,0,-1,-5,6,-2,0,0,-1,0,0,-1,6,-1
KR_6744955241,420,0,13,8,-3,0,1,1,-6,8,2,-1,3,2,1,1,2,3,3,6,0,-3,-7,-1,-2,3,1,0,0,1,1,1,-1,6,-1
KR_6665104321,420,0,7,8,3,-1,4,3,0,3,3,2,1,3,3,0,3,-1,5,4,0,-1,-5,5,-7,2,-2,0,1,-1,1,1,1,5,-1
KR_6746595060,420,0,-113,20,-1,2,0,2,-1,6,5,-3,3,0,1,2,3,0,2,2,-1,-4,13,1,-4,3,0,0,0,-1,-1,0,-1,5,-1
KR_6767227317,420,-4,2,-24,-9,-4,4,0,-3,5,2,3,1,4,-1,3,2,-4,4,0,0,-1,7,-2,-2,4,-1,0,-1,-1,0,-1,1,3,-1
KR_6625038237,420,-4,-71,-20,-8,-6,6,0,-3,6,3,0,2,2,0,0,0,1,1,2,1,-2,7,-3,-2,5,0,0,-1,1,1,-1,1,5,-1
KR_6464857027,420,0,-6,-1,-1,2,0,2,1,1,2,0,3,3,-3,3,0,-1,1,0,0,-1,-121,-7,-1,8,9,0,1,-1,-1,1,-1,4,-1
KR_6626540301,420,0,21,-36,0,4,0,4,-3,3,0,0,4,4,-2,4,2,1,0,1,0,1,34,0,-3,3,4,0,1,1,-1,1,-1,5,-1
KR_6703482764,420,0,-34,8,-9,-2,3,1,-4,6,2,-1,4,3,-3,5,2,1,1,2,0,-16,-7,-2,-1,3,2,0,0,1,0,-1,-1,2,-1
KR_6749937625,420,-1,19,24,-5,0,0,0,-3,7,4,2,0,2,-3,4,1,-1,2,1,0,-7,29,0,-2,2,4,0,-1,-1,-1,-1,-1,3,-1
KR_6750533124,420,0,-7,0,2,-1,4,3,0,2,2,1,1,2,1,1,2,1,0,1,0,1,-5,5,-6,1,-3,0,0,1,1,-1,-1,6,-1
KR_6695612557,420,1,20,64,-3,2,0,2,-1,2,1,1,4,5,-3,3,0,-2,2,0,0,-10,-20,-3,-3,6,-3,0,1,1,1,1,1,5,-1
KR_6624176312,420,0,-32,-9,-2,1,2,3,-8,8,0,1,3,4,3,2,5,1,0,1,1,-3,3,1,-4,3,-3,0,-1,-1,1,-1,1,5,-1
KR_6678094960,420,0,-2,-2,4,-1,2,1,4,3,7,2,0,2,1,4,5,-2,3,1,0,2,12,2,-5,3,4,0,1,-1,1,1,-1,6,-1
KR_6754339084,420,-7,-78,-31,-14,-4,6,2,-3,3,0,-4,4,0,0,4,4,-3,3,0,-2,-12,-8,1,-3,2,-4,-1,-6,-1,-1,-1,-1,3,-1
KR_6742177073,440,2,29,-4,-4,2,1,3,5,2,7,-1,3,2,-9,10,1,-1,2,1,0,-9,6,7,-8,1,-2,0,1,-1,1,1,-1,5,-1
KR_6736764226,420,-2,-2,3,-2,-4,4,0,-1,3,2,2,2,4,1,0,1,0,0,0,0,3,35,1,-3,2,-11,0,1,1,1,1,-1,4,-1
KR_6761863389,420,-2,7,8,0,4,1,5,1,4,5,-6,6,0,1,2,3,0,1,1,0,-1,7,1,-8,7,-4,0,0,-1,0,1,1,1,-1
KR_6723099107,420,-5,-61,-36,-11,2,0,2,0,4,4,-7,7,0,-5,5,0,-1,1,0,0,-22,-21,-3,-3,6,2,0,-2,-1,-1,-1,-1,4,-1
KR_6755500450,440,-3,-96,-26,-4,-4,5,1,-2,3,1,1,0,1,0,2,2,1,2,3,1,0,-2,1,-6,5,-2,0,0,1,-1,-1,1,4,-1
KR_6732145690,420,0,17,-4,-2,0,3,3,2,1,3,-4,4,0,0,4,4,0,0,0,0,-6,-1,-2,-4,6,-4,0,0,-1,1,1,-1,5,-1
KR_6735871406,420,-7,-139,-36,-21,-4,4,0,-4,5,1,-3,4,1,-10,12,2,0,1,1,-1,-16,-3,-2,-2,4,0,0,-1,-1,0,-1,-1,4,-1
KR_6765768763,440,0,-65,24,-1,5,2,7,4,2,6,-1,1,0,-8,10,2,-1,2,1,0,-9,-9,-6,-4,10,0,0,-1,-1,1,-1,1,5,-1
KR_6768247479,420,3,-1,21,17,1,1,2,5,4,9,5,2,7,6,2,8,0,1,1,1,24,6,3,-4,1,0,0,-1,1,0,-1,1,3,-1
KR_6755183908,420,1,-39,4,4,1,0,1,2,3,5,0,1,1,-1,2,1,2,0,2,0,6,9,0,-4,4,0,0,1,0,-1,1,-1,0,-1
KR_6705238649,420,3,33,-5,10,1,4,5,-1,1,0,5,0,5,5,1,6,0,0,0,-1,9,8,3,-4,1,0,0,1,1,1,1,-1,5,-1
KR_6637909617,420,5,52,5,1,-3,3,0,-1,7,6,0,2,2,6,0,6,-1,1,0,0,11,7,0,-5,5,-1,0,0,-1,1,1,1,4,-1
KR_6592984585,420,-1,-59,14,0,-7,8,1,1,2,3,5,2,7,2,1,3,-1,2,1,-1,-2,19,3,-8,5,1,0,0,-1,-1,-1,-1,3,-1
KR_6752005742,440,-1,-31,12,-1,3,1,4,-4,4,0,-4,6,2,1,5,6,3,0,3,0,-2,-9,-1,-3,4,0,0,-2,0,1,-1,-1,0,-1
KR_6724281537,440,-2,-5,12,-7,-2,5,3,-2,3,1,-4,4,0,0,3,3,1,1,2,0,-3,-6,-5,0,5,-1,0,-1,1,-1,-1,-1,6,-1
KR_6695620417,420,-2,-59,-13,-9,0,2,2,0,3,3,-3,4,1,0,3,3,-6,6,0,0,-1,-14,2,-4,2,2,0,-1,-1,-1,-1,-1,4,-1
KR_6713028244,420,0,29,7,-5,0,1,1,-4,5,1,0,3,3,-1,1,0,0,0,0,0,-4,-63,-6,-3,9,2,0,0,-1,-1,0,-1,5,-1
KR_6741723702,420,-2,19,15,-8,1,3,4,-3,4,1,-3,3,0,-3,4,1,0,0,0,0,-10,-25,7,-7,0,0,0,0,1,-1,0,-1,2,-1
KR_6763260949,420,-1,35,4,-3,-4,5,1,1,2,3,0,2,2,0,1,1,0,0,0,0,0,2,1,-2,1,2,0,-1,1,-1,-1,-1,2,-1
KR_6684972029,420,-7,-82,-29,-18,-3,3,0,-6,6,0,-1,4,3,-3,10,7,-5,5,0,-1,-14,-13,-2,-2,4,4,0,-2,-1,-1,-1,-1,5,-1
KR_6726101993,420,-3,-88,4,-1,-3,3,0,-1,3,2,1,1,2,3,2,5,-1,3,2,0,1,2,3,-7,4,2,0,0,-1,0,0,1,1,-1
KR_6733925540,420,-5,8,-3,-6,-2,3,1,1,2,3,-3,4,1,3,5,8,-5,5,0,0,-2,-18,1,-4,3,-1,0,-1,-1,-1,-1,1,3,-1
KR_6654621222,420,-3,-34,-17,-2,2,0,2,-1,2,1,0,1,1,0,3,3,-3,3,0,0,-10,-23,4,-6,2,-7,0,-1,-1,1,-1,-1,1,-1
KR_6696886487,420,-2,-60,23,-4,-3,3,0,3,0,3,-1,2,1,-1,2,1,-2,2,0,0,2,21,0,-3,3,-14,0,0,-1,1,1,-1,5,-1
KR_6755447064,420,2,-42,4,-5,3,0,3,-2,4,2,-5,5,0,0,1,1,-1,1,0,0,-4,-122,1,-4,3,2,0,-1,-1,-1,-1,-1,2,-1
KR_6733606243,420,-2,-49,-16,2,-1,1,0,0,3,3,-2,3,1,4,0,4,1,0,1,0,7,-7,3,-7,4,2,0,0,-1,-1,0,1,1,-1
KR_6767336088,420,-3,-47,12,-7,-3,4,1,0,1,1,-2,3,1,-3,4,1,1,0,1,0,-4,39,0,-4,4,-3,0,-1,-1,-1,-1,-1,4,-1
KR_6689481612,420,0,0,18,3,6,1,7,-2,3,1,1,1,2,-3,4,1,1,0,1,0,2,5,-1,-7,8,1,0,0,1,-1,0,1,3,-1
KR_6742241512,440,-2,-44,-16,2,4,3,7,-2,2,0,-3,5,2,3,3,6,0,1,1,0,3,10,-2,-2,4,-7,0,-3,-1,-1,-1,1,2,-1
KR_6677806916,420,3,76,-16,3,-1,1,0,2,2,4,-1,2,1,2,3,5,1,1,2,-1,1,-4,-3,-5,8,0,0,0,1,1,1,-1,3,-1
KR_6750406979,440,-5,-59,8,-14,-3,6,3,-3,3,0,-2,2,0,-3,5,2,-3,3,0,0,-12,-13,-3,-4,7,-9,0,-1,-1,1,-1,-1,1,-1
KR_6756789461,420,2,24,12,10,1,1,2,2,0,2,5,1,6,0,2,2,2,2,4,3,13,6,7,-8,1,-4,0,1,1,1,1,1,4,-1
KR_6764573681,420,0,-125,9,-7,0,1,1,0,2,2,-1,3,2,-1,1,0,-5,5,0,0,-6,1,3,-5,2,-1,0,-1,0,0,-1,-1,0,-1
KR_6759309132,420,2,38,-28,-2,2,2,4,-7,8,1,1,2,3,1,2,3,1,0,1,-2,-5,-4,-4,-1,5,-4,0,0,-1,-1,-1,-1,2,-1
KR_6757403608,420,0,8,-48,-3,-3,3,0,0,3,3,0,5,5,2,2,4,-2,2,0,0,1,169,-1,-3,4,0,0,1,1,-1,1,-1,2,-1
KR_6699332238,420,0,22,-16,-5,-2,2,0,4,3,7,-4,5,1,-2,3,1,-1,2,1,0,-11,-9,-4,-2,6,2,0,0,-1,-1,0,-1,4,-1
KR_6758745917,440,-1,31,8,-9,-4,4,0,2,1,3,2,1,3,-8,11,3,-1,2,1,0,-5,-50,1,-4,3,23,0,-1,-1,-1,-1,-1,6,-1
KR_6762442579,420,0,-6,7,0,1,3,4,1,2,3,3,2,5,-4,7,3,-1,1,0,1,-6,-3,-1,-4,5,-3,0,0,-1,1,1,1,6,-1
KR_6761977491,420,-1,21,-13,-3,-5,5,0,3,1,4,-5,7,2,3,3,6,1,1,2,0,6,114,4,-6,2,-2,0,-2,1,-1,-1,-1,1,-1
KR_6683007119,420,1,31,4,4,-1,1,0,0,2,2,0,2,2,5,0,5,0,2,2,0,0,-6,1,-3,2,-3,0,2,1,1,1,1,1,-1
KR_6684004748,420,0,91,-28,-3,3,1,4,-6,7,1,-3,5,2,2,2,4,1,0,1,0,-4,10,7,-10,3,-1,0,1,0,-1,1,1,0,-1
KR_6559630121,420,-2,-22,-12,-1,1,0,1,2,1,3,-6,6,0,2,1,3,0,1,1,0,6,2,2,-5,3,1,0,0,-1,1,0,-1,1,-1
KR_6764622318,440,0,30,-20,1,3,2,5,-1,2,1,1,0,1,4,2,6,-6,8,2,0,1,11,2,-8,6,-8,0,1,1,-1,1,-1,1,-1
KR_6757603491,420,-1,-71,-26,3,-2,4,2,2,1,3,0,2,2,1,2,3,2,0,2,0,5,-54,-3,-4,7,35,0,-2,-1,1,-1,1,6,-1
KR_6744865297,420,-1,10,-29,1,-2,3,1,0,1,1,0,1,1,2,3,5,1,1,2,1,3,-199,2,-8,6,-1,0,0,-1,1,-1,1,6,-1
KR_6712882377,420,-3,-38,-12,0,-1,3,2,1,0,1,0,4,4,-1,2,1,1,0,1,0,4,-178,0,-3,3,3,0,-1,1,-1,-1,-1,1,-1
KR_6733494656,420,-2,-61,-36,-4,2,0,2,-1,4,3,-4,5,1,0,1,1,-1,1,0,0,4,-31,-8,0,8,1,0,-3,-1,-1,-1,-1,1,-1
KR_6717730678,420,1,-5,-14,3,-1,2,1,-2,7,5,-1,3,2,6,0,6,1,0,1,0,-1,-6,-2,-6,8,10,0,0,1,1,0,1,5,-1
KR_6728586000,420,-2,-51,16,-5,0,2,2,1,1,2,-3,4,1,1,0,1,-4,4,0,-1,-7,30,2,-5,3,-2,0,-1,-1,-1,-1,-1,5,-1
KR_6745758258,420,-1,1,-16,-11,0,2,2,-2,4,2,1,2,3,-5,5,0,-5,6,1,0,-19,-8,4,-8,4,-4,0,-2,-1,1,-1,-1,6,-1
KR_6767146771,440,0,76,-1,-1,5,0,5,-3,4,1,-4,6,2,4,1,5,-3,5,2,1,4,12,0,-4,4,-1,0,1,-1,1,1,1,3,-1
KR_6670239075,420,2,-44,0,9,3,1,4,0,3,3,4,1,5,-1,4,3,3,0,3,0,10,7,3,-7,4,0,0,1,1,1,1,1,6,-1
KR_6761128836,420,-1,-92,-16,-2,-1,3,2,0,1,1,1,1,2,2,3,5,-4,4,0,0,-4,-5,-1,0,1,-1,0,-3,-1,1,-1,1,4,-1
KR_6717327086,420,-2,-57,30,-2,1,4,5,1,2,3,-2,3,1,-2,2,0,0,1,1,0,-9,7,-1,-4,5,-5,0,-1,1,-1,-1,1,2,-1
KR_6607571416,420,1,-9,20,-1,-5,5,0,4,0,4,-1,5,4,0,5,5,1,0,1,0,-1,6,-2,-7,9,-5,0,0,1,1,1,-1,3,-1
KR_6761268011,420,0,37,14,2,3,1,4,-3,4,1,-6,8,2,4,3,7,4,1,5,1,3,17,-4,-1,5,1,0,1,0,1,1,1,0,-1
KR_6670967447,420,-3,-52,4,-13,-1,4,3,-4,7,3,-2,3,1,-6,6,0,0,0,0,0,-14,-27,-4,-2,6,-2,0,-1,0,-1,-1,-1,0,-1
KR_6727395937,420,0,-14,8,3,-1,2,1,-2,3,1,-1,2,1,4,1,5,3,3,6,1,9,29,-4,-1,5,-19,0,1,-1,1,-1,1,6,-1
KR_6626454637,420,3,25,-16,5,0,1,1,-1,3,2,1,1,2,4,4,8,1,0,1,0,2,3,0,-3,3,-2,0,2,1,1,-1,1,3,-1
KR_6754018175,420,-4,-104,8,-13,-2,2,0,-4,4,0,-5,5,0,-2,3,1,0,0,0,0,-9,16,3,-5,2,1,0,-1,0,-1,-1,-1,0,-1
KR_6625586199,420,-4,-64,-16,-8,3,0,3,-6,6,0,-6,6,0,5,2,7,-4,4,0,-2,-4,7,4,-7,3,-1,0,-1,-1,-1,-1,-1,2,-1
KR_6759785094,420,-1,13,-9,2,1,1,2,-2,4,2,1,1,2,7,0,7,-5,5,0,0,0,-3,5,-9,4,2,0,0,0,-1,0,-1,0,-1
KR_6745123438,420,-1,25,-3,0,3,0,3,-3,4,1,-1,2,1,1,1,2,0,1,1,1,-9,2,-8,-1,9,5,0,0,-1,0,0,1,4,-1
KR_6655396771,420,3,4,-11,11,-4,4,0,-1,4,3,6,1,7,7,0,7,3,0,3,1,16,-196,1,-5,4,-4,0,0,1,-1,-1,1,5,-1
KR_6756496505,440,0,59,13,-5,5,2,7,-4,5,1,2,2,4,-8,10,2,0,2,2,2,-7,-15,-3,-2,5,4,0,0,-1,1,1,1,2,-1
KR_6733439353,420,-2,-44,-5,-8,-3,4,1,0,3,3,-2,3,1,0,1,1,-3,4,1,0,-7,-10,-4,-1,5,0,0,-2,1,-1,-1,-1,2,-1
KR_6756045567,420,2,0,-21,5,-1,2,1,0,2,2,5,1,6,-1,2,1,2,0,2,0,8,-19,-2,-4,6,0,0,0,-1,0,1,-1,4,-1
KR_6739302615,420,-3,-10,-12,-11,-6,7,1,-1,4,3,-5,6,1,1,2,3,0,1,1,1,-5,7,2,-5,3,-7,0,-1,-1,-1,-1,1,6,-1
KR_6753055192,420,-2,-48,-34,-4,-2,4,2,2,1,3,-1,1,0,-3,3,0,0,0,0,0,-5,-11,0,-3,3,0,0,-1,-1,-1,-1,-1,6,-1
KR_6762236749,420,0,-56,35,-1,0,3,3,3,0,3,1,0,1,-6,9,3,1,0,1,0,0,7,-1,-3,4,-2,0,0,-1,0,-1,1,3,-1
KR_6679799240,420,-4,-47,-3,-7,-1,1,0,1,1,2,-2,3,1,-5,5,0,0,1,1,0,-5,31,3,-6,3,1,0,0,0,1,0,-1,0,-1
KR_6765631221,420,-2,-46,16,-4,0,1,1,-3,4,1,0,2,2,-2,3,1,1,2,3,0,-2,5,1,-3,2,0,0,1,-1,1,1,1,5,-1
KR_6762986674,420,-1,40,-29,-3,3,0,3,1,3,4,-1,2,1,-2,5,3,-4,5,1,1,-6,0,-3,-4,7,-5,0,-1,1,-1,-1,1,6,-1
KR_6764636073,420,-1,-7,-28,-3,-5,7,2,6,0,6,0,2,2,0,3,3,-4,5,1,0,-5,4,0,-4,4,-6,0,0,1,-1,-1,-1,3,-1
KR_6767324689,420,-4,-66,-11,1,-2,2,0,-1,2,1,7,0,7,-1,2,1,-2,3,1,0,-6,4,3,-6,3,0,0,1,-1,1,1,1,4,-1
KR_6767731297,420,-1,63,0,-8,-1,1,0,-2,3,1,-2,4,2,-4,5,1,1,0,1,0,-13,3,2,-6,4,-2,0,1,1,-1,1,1,3,-1
KR_6761680899,440,0,18,40,-4,0,2,2,0,1,1,-4,5,1,0,3,3,0,2,2,0,-6,3,-3,-4,7,-3,0,1,-1,1,1,-1,2,-1
KR_6766387916,420,0,28,-12,2,5,0,5,0,2,2,-3,4,1,0,3,3,0,1,1,0,-5,-9,1,-6,5,1,0,0,1,-1,1,-1,4,-1
KR_6751179774,420,-7,-79,-55,-6,-1,2,1,-5,6,1,-1,2,1,1,1,2,0,1,1,0,-3,-460,0,-3,3,23,0,0,-1,-1,-1,1,6,-1
KR_6767895649,420,-2,-76,-19,-8,-5,6,1,-3,4,1,0,2,2,1,0,1,-1,1,0,2,-10,0,-1,-3,4,2,0,-1,-1,-1,-1,1,2,-1
KR_6682888618,420,-2,-19,-8,1,-2,2,0,3,2,5,4,3,7,-4,6,2,0,2,2,0,-2,4,-4,-2,6,6,0,0,1,-1,-1,1,2,-1
KR_6698317061,420,-3,-82,-5,-10,-5,6,1,2,5,7,-3,6,3,-4,5,1,0,0,0,0,-5,11,-2,-3,5,-13,0,-2,1,-1,-1,-1,3,-1
KR_6572972680,420,-3,-69,-1,-10,-2,5,3,-3,4,1,1,3,4,-6,6,0,0,1,1,0,-7,2,-3,-2,5,-1,0,2,-1,1,1,-1,6,-1
KR_6703375992,420,-4,14,20,-8,-1,2,1,-4,5,1,0,2,2,-4,7,3,1,1,2,0,-5,-1,0,-4,4,1,0,-1,1,-1,-1,1,3,-1
KR_6759332877,420,-1,47,24,-6,1,1,2,-3,5,2,-7,10,3,3,2,5,0,3,3,0,-10,3,3,-6,3,1,0,0,0,-1,1,1,0,-1
KR_6710885867,420,-1,0,9,-7,-2,3,1,-7,8,1,1,1,2,3,2,5,-2,5,3,0,-6,-1,-2,-2,4,3,0,-1,1,-1,-1,-1,4,-1
KR_6738625419,420,0,6,-2,5,1,0,1,-2,3,1,0,2,2,4,0,4,2,0,2,0,7,153,-3,-2,5,-1,0,1,-1,1,1,1,5,-1
KR_6733568320,420,-8,-79,-21,-27,-7,10,3,-3,3,0,-5,6,1,-13,13,0,1,0,1,-1,-25,-2,-3,-2,5,-1,0,-1,-1,-1,-1,-1,1,-1
KR_6736706085,420,3,-7,31,2,-4,5,1,4,1,5,0,1,1,2,2,4,0,0,0,0,8,74,3,-7,4,-23,0,1,-1,-1,1,-1,1,-1
KR_6720610249,420,3,45,-5,0,0,1,1,-1,2,1,1,1,2,0,5,5,0,0,0,0,2,2,-2,-1,3,-1,0,0,0,0,0,1,0,-1
KR_6717830254,420,-2,-3,-1,-4,-4,4,0,6,2,8,-3,5,2,-4,7,3,1,1,2,0,4,-9,-7,-3,10,0,0,-1,-1,-1,-1,1,4,-1
KR_6767322287,420,-5,-35,-28,-10,-2,3,1,-3,3,0,3,0,3,-6,6,0,-2,2,0,-1,-14,12,-1,-5,6,-3,0,-1,1,-1,-1,-1,2,-1
KR_6468657736,420,-4,-108,-5,-17,-1,1,0,-1,4,3,-6,7,1,-7,7,0,-2,2,0,-1,-15,6,-2,-2,4,-4,0,-3,-1,-1,-1,-1,1,-1
KR_6621039069,420,-4,-63,13,-2,-4,4,0,-1,1,0,7,0,7,-2,3,1,-2,2,0,0,-2,-120,0,-2,2,-4,0,0,-1,1,-1,1,4,-1
KR_6768343821,420,-2,-6,-11,-2,1,1,2,-1,6,5,-1,3,2,-1,1,0,0,1,1,-1,-5,-74,-1,-2,3,-23,0,0,1,1,1,-1,3,-1
KR_6733338779,420,-1,15,4,-1,-2,4,2,1,2,3,2,2,4,-2,2,0,0,0,0,0,-5,36,-3,-4,7,-24,0,0,1,-1,0,1,6,-1
KR_6765405255,420,-1,-61,0,-1,-2,2,0,2,1,3,-7,9,2,2,0,2,4,0,4,0,-2,17,1,-5,4,0,0,0,1,-1,1,-1,2,-1
KR_6767263080,420,1,-67,0,6,1,2,3,2,1,3,0,0,0,3,1,4,0,0,0,0,7,0,2,-4,2,-2,0,0,-1,-1,0,-1,6,-1
KR_6684898830,420,0,-61,-11,0,-1,2,1,1,2,3,4,1,5,-5,10,5,1,2,3,-1,8,-16,0,-7,7,6,0,-1,-1,-1,-1,1,5,-1
KR_6725063357,420,-5,-29,16,-16,-4,5,1,6,2,8,-9,10,1,-8,8,0,-1,2,1,0,-20,8,6,-8,2,-4,0,-1,0,1,-1,-1,0,-1
KR_6700347590,420,3,65,1,4,5,0,5,-1,3,2,1,5,6,1,4,5,-2,2,0,0,-1,2,-2,-9,11,2,0,2,-1,1,1,-1,3,-1
KR_6758075526,420,-2,-41,29,1,0,0,0,0,1,1,0,1,1,2,2,4,-1,1,0,-1,0,7,1,-6,5,1,0,0,0,1,0,-1,0,-1
KR_6748642216,420,-1,13,28,-8,0,1,1,-5,5,0,0,3,3,-2,3,1,-1,3,2,0,-8,0,4,-4,0,0,0,-1,-1,1,-1,-1,4,-1
KR_6636217009,420,-3,-34,-40,-6,0,0,0,2,4,6,0,1,1,-6,6,0,-2,3,1,0,-7,-17,-2,-2,4,0,0,-1,-1,-1,-1,1,2,-1
KR_6642438503,420,-2,-17,-8,-4,-5,6,1,5,4,9,-1,3,2,-1,1,0,-2,2,0,0,-2,36,-2,-6,8,-13,0,-1,1,-1,-1,1,3,-1
KR_6625441084,420,0,-103,16,4,0,2,2,4,0,4,3,4,7,-6,6,0,3,2,5,0,8,3,0,-2,2,-1,0,0,1,1,-1,1,4,-1
KR_6710588733,420,-4,4,-32,-10,-2,3,1,-3,4,1,-1,2,1,-5,7,2,1,0,1,0,-16,-54,-5,-2,7,28,0,-2,-1,1,-1,-1,4,-1
KR_6720867947,440,1,53,26,5,-3,5,2,2,2,4,3,4,7,1,1,2,2,1,3,0,5,3,-2,-4,6,-1,0,1,1,-1,1,1,4,-1
KR_6674336336,440,-2,-36,4,-6,-7,11,4,6,0,6,-3,3,0,0,2,2,-2,5,3,-1,-10,3,0,-2,2,1,0,-2,1,0,-1,-1,2,-1
KR_6199619083,420,1,27,8,-3,4,2,6,-3,3,0,0,1,1,-5,5,0,1,0,1,0,-6,-2,1,-5,4,-1,0,2,-1,1,1,1,5,-1
KR_6764499483,420,1,-20,15,-1,-2,4,2,-1,2,1,1,2,3,-1,8,7,2,0,2,-1,-3,-20,2,-5,3,22,0,0,-1,1,0,-1,2,-1
KR_6706240586,420,-3,-30,-3,-2,-1,4,3,-2,5,3,5,2,7,-4,4,0,0,1,1,0,-10,6,-3,-4,7,1,0,-1,-1,1,-1,-1,6,-1
KR_6736522404,420,-2,-24,-16,4,-2,4,2,2,2,4,-2,4,2,4,3,7,2,0,2,1,16,-14,2,-5,3,2,0,0,-1,-1,-1,1,4,-1
KR_6740040497,420,0,-29,-4,2,-2,2,0,5,0,5,3,1,4,-8,9,1,4,0,4,0,2,5,4,-6,2,-3,0,-1,0,1,-1,1,0,-1
KR_6723354561,420,-5,-67,-43,1,-3,3,0,1,1,2,0,1,1,4,2,6,-1,1,0,0,1,106,-4,-2,6,1,0,0,-1,-1,-1,1,6,-1
KR_6767815371,420,-4,-41,-27,-13,-1,3,2,-6,7,1,-5,5,0,-2,4,2,1,1,2,0,-13,-15,-2,-3,5,0,0,-3,1,-1,-1,1,4,-1
KR_6729230187,440,-1,-66,0,2,-1,2,1,2,2,4,3,1,4,-1,3,2,-1,1,0,-1,-2,-11,2,-5,3,0,0,0,1,1,0,-1,3,-1
KR_6631407942,420,-3,21,-32,-2,0,1,1,-2,3,1,1,2,3,-1,5,4,0,1,1,0,1,-8,-1,-4,5,4,0,0,-1,-1,0,-1,6,-1
KR_6674298578,420,0,11,4,7,7,1,8,4,1,5,-5,5,0,3,1,4,-2,2,0,0,6,-11,-3,-4,7,-2,0,0,1,1,0,1,1,-1
KR_6684665543,420,1,22,43,-1,3,0,3,-8,11,3,1,1,2,3,1,4,0,1,1,0,-8,140,1,-6,5,-2,0,0,-1,-1,0,1,3,-1
KR_6621097882,420,-3,-45,0,-7,-2,4,2,2,4,6,-5,5,0,-3,6,3,1,1,2,1,-2,106,-1,-7,8,1,0,2,1,1,1,1,5,-1
KR_6742104617,420,0,-5,8,2,-4,6,2,4,1,5,-1,3,2,4,1,5,-1,4,3,2,13,-19,-3,-2,5,-2,0,0,0,1,0,1,0,-1
KR_6738688482,440,-2,-19,0,-8,2,2,4,-2,2,0,-2,2,0,-5,7,2,-1,2,1,0,-13,4,2,-6,4,-8,0,0,-1,-1,-1,-1,1,-1
KR_6759931952,440,-2,14,4,-4,-6,7,1,0,0,0,1,1,2,1,1,2,0,1,1,0,-3,7,-3,-3,6,2,0,0,0,0,0,1,0,-1
KR_6763245639,440,-6,-64,2,-22,-10,10,0,0,1,1,1,0,1,-12,12,0,-1,1,0,0,-16,-15,-1,-3,4,-3,0,-2,-1,-1,-1,-1,5,-1
KR_6713928550,420,-1,10,-17,1,2,0,2,1,1,2,0,3,3,-4,7,3,2,0,2,0,-6,-7,-1,-4,5,-4,0,0,-1,1,0,1,5,-1
KR_6758073075,420,-3,-33,-11,-4,-1,2,1,0,2,2,3,1,4,-5,5,0,-1,2,1,1,-2,-2,2,-4,2,-2,0,-1,-1,0,-1,1,4,-1
KR_6764677736,440,2,39,16,-2,1,0,1,4,2,6,-1,5,4,-4,5,1,-2,2,0,0,-9,360,1,-4,3,-6,0,1,1,1,1,-1,5,-1
KR_6622641497,420,-2,15,-7,-1,-3,3,0,1,3,4,4,2,6,-3,5,2,0,0,0,0,1,25,5,-6,1,-2,0,-1,1,-1,-1,1,2,-1
KR_6672686680,440,1,41,-16,4,-5,5,0,-6,8,2,5,0,5,3,1,4,7,2,9,1,12,14,6,-7,1,-6,0,0,1,-1,0,1,2,-1
KR_6749063792,420,-1,50,-30,-5,-5,5,0,-4,7,3,-4,7,3,4,0,4,4,1,5,-1,-7,-7,-1,-3,4,5,0,0,0,-1,0,-1,0,-1
KR_6645798625,420,-2,-48,0,-3,5,0,5,4,2,6,-5,6,1,-3,5,2,-4,4,0,0,-2,-42,4,-7,3,22,0,-1,-1,1,-1,1,1,-1
KR_6746273620,420,-1,-84,-24,4,-5,6,1,6,1,7,0,1,1,0,2,2,3,0,3,0,3,320,-2,-4,6,-2,0,-1,1,-1,-1,1,2,-1
KR_6725619883,420,-3,21,-8,-11,0,0,0,-9,10,1,2,1,3,-2,7,5,-2,2,0,0,-13,2,-1,-4,5,0,0,-1,1,0,-1,-1,6,-1
KR_6719788543,420,-3,-35,-16,-1,-3,3,0,1,1,2,2,2,4,-1,1,0,0,1,1,0,-1,-1,3,-7,4,-3,0,-2,0,-1,-1,1,0,-1
KR_6725985616,440,0,8,-6,-3,-3,3,0,1,3,4,3,1,4,-5,6,1,1,1,2,0,-3,0,1,-6,5,0,0,-1,-1,0,-1,-1,3,-1
KR_6682860581,420,-2,-87,31,-9,-4,4,0,1,0,1,2,0,2,-8,9,1,0,1,1,-1,-7,14,1,-6,5,-8,0,0,-1,1,-1,-1,3,-1
KR_6644361367,420,0,-5,0,2,0,3,3,-1,4,3,1,3,4,2,7,9,0,0,0,-1,4,-37,3,-7,4,11,0,0,1,0,1,-1,1,-1
KR_6744129727,420,-1,-30,-21,-3,3,0,3,-6,10,4,-2,2,0,3,4,7,-1,1,0,0,-4,123,0,-4,4,0,0,0,-1,-1,0,1,1,-1
KR_6693045223,420,1,32,12,0,1,3,4,-1,5,4,3,3,6,-2,5,3,-1,1,0,0,-8,1,-2,-4,6,3,0,1,-1,1,1,1,6,-1
KR_6767357676,420,-1,-36,15,-3,-2,3,1,0,1,1,-2,4,2,3,1,4,-2,2,0,0,0,0,1,-4,3,4,0,0,1,-1,-1,-1,4,-1
KR_6480290674,420,-7,-17,-24,-15,-3,4,1,-2,3,1,-6,8,2,-4,7,3,0,1,1,0,-15,7,-2,-1,3,-1,0,-1,-1,1,-1,1,1,-1
KR_6716266751,420,-6,-112,-50,-12,-3,4,1,-4,4,0,-4,5,1,3,1,4,-4,5,1,0,-5,-6,-3,-3,6,5,0,-1,-1,1,-1,1,1,-1
KR_6756390210,420,-1,19,-8,2,8,0,8,-6,9,3,4,1,5,-4,5,1,0,1,1,0,6,0,5,-8,3,-2,0,1,-1,1,1,1,4,-1
KR_6767965956,420,0,22,5,3,0,1,1,0,1,1,3,2,5,0,2,2,0,1,1,0,2,315,-1,-3,4,-1,0,1,0,1,1,-1,0,-1
KR_6729593976,440,5,38,31,11,5,0,5,0,3,3,9,0,9,-1,1,0,-2,2,0,0,-4,2,-1,-2,3,5,0,1,0,0,1,1,0,-1
KR_6603110189,420,5,139,23,9,5,1,6,3,5,8,0,3,3,3,2,5,-2,4,2,1,-7,-240,-2,-5,7,2,0,1,-1,1,1,1,2,-1
KR_6731462965,420,-2,-14,-28,-3,0,2,2,1,1,2,-4,4,0,-1,3,2,1,0,1,0,-2,-7,2,-5,3,-5,0,1,1,-1,-1,-1,2,-1
KR_6754737802,420,0,15,-30,0,-2,3,1,3,2,5,1,2,3,-2,5,3,0,0,0,0,1,46,3,-8,5,-30,0,2,1,1,1,1,5,-1
KR_6767482616,420,-6,-89,3,-17,-8,8,0,-8,10,2,-2,4,2,-5,5,0,6,1,7,0,-2,0,-1,-2,3,-1,0,-2,1,1,-1,1,2,-1
KR_6728940115,420,1,-18,-8,7,-1,3,2,4,2,6,6,1,7,0,2,2,-2,2,0,1,11,-15,-5,-4,9,3,0,-2,0,-1,-1,1,0,-1
KR_6698696533,420,-2,-44,0,-5,3,1,4,-2,3,1,-5,5,0,3,2,5,-4,5,1,-2,-15,-2,3,-5,2,-1,0,0,-1,1,1,-1,2,-1
KR_6705298839,420,-4,-21,-33,-9,-3,4,1,-1,2,1,1,2,3,0,1,1,-6,6,0,0,-11,14,-4,-2,6,-15,0,-1,-1,-1,-1,-1,5,-1
KR_6757993065,420,1,7,38,3,3,1,4,3,0,3,-2,2,0,1,0,1,-2,2,0,0,0,1,0,-5,5,2,0,0,0,1,0,1,0,-1
KR_6739039250,420,-4,-67,-7,-14,-2,3,1,0,1,1,-7,8,1,-5,7,2,0,1,1,0,-15,-6,-3,-1,4,0,0,-1,-1,-1,-1,-1,6,-1
KR_6482561192,420,-2,6,9,-5,1,1,2,2,3,5,-4,6,2,-1,3,2,-3,3,0,0,-13,54,6,-9,3,0,0,-2,-1,1,-1,1,2,-1
KR_6751456031,420,-1,-3,1,-3,-1,2,1,-2,4,2,-5,6,1,1,2,3,4,0,4,0,-5,25,-4,-5,9,-1,0,1,-1,1,1,-1,1,-1
KR_6650632297,420,-2,-30,-24,-3,-4,5,1,0,5,5,0,3,3,1,1,2,0,1,1,1,1,-220,0,-4,4,1,0,0,1,-1,-1,1,4,-1
KR_6731468826,420,3,-53,27,-2,-4,4,0,1,0,1,-3,3,0,2,1,3,2,0,2,-1,-1,19,-2,-2,4,2,0,0,-1,-1,0,-1,6,-1
KR_6730287890,420,-7,-138,-11,-18,-3,3,0,-1,5,4,-6,8,2,-9,10,1,1,2,3,-2,-17,-30,-6,0,6,-6,0,-3,-1,1,-1,-1,1,-1
KR_6736677406,440,-1,-21,11,6,4,0,4,-1,2,1,2,2,4,3,0,3,-2,3,1,0,12,8,3,-8,5,-2,0,-1,1,-1,-1,1,1,-1
KR_6673747368,420,-3,-103,16,-4,-8,10,2,7,0,7,1,3,4,-4,6,2,0,2,2,2,2,-5,-1,-3,4,-2,0,-2,-1,1,-1,1,6,-1
KR_6662446255,420,2,60,20,4,0,4,4,2,0,2,5,0,5,-3,8,5,0,0,0,0,-9,2,-5,-2,7,4,0,0,-1,1,1,-1,2,-1
KR_6727584364,420,-5,-37,-1,-9,-1,2,1,-2,6,4,1,1,2,-2,2,0,-5,5,0,1,-3,-14,0,-4,4,1,0,-3,-1,-1,-1,1,1,-1
KR_6647474136,420,-5,2,4,-8,-1,4,3,0,2,2,-3,4,1,-4,5,1,0,1,1,0,-13,-17,-1,-3,4,-1,0,-1,-1,-1,-1,-1,5,-1
KR_6731827788,420,3,68,20,0,0,2,2,5,0,5,-7,8,1,1,5,6,1,1,2,0,5,5,0,-4,4,2,0,3,-1,1,1,-1,1,-1
KR_6703099380,440,-9,-38,-12,-21,-5,5,0,-4,4,0,-5,6,1,-5,6,1,-2,2,0,0,-15,-2,2,-4,2,-4,0,-1,-1,-1,-1,-1,2,-1
KR_6616390111,440,-4,-92,-8,-1,-3,3,0,1,0,1,0,1,1,-5,9,4,6,3,9,0,1,-5,-4,-5,9,5,0,-1,1,-1,-1,1,4,-1
KR_6520441860,420,-3,-50,-14,-12,-3,3,0,-7,10,3,0,0,0,-1,1,0,-1,1,0,0,-13,13,0,-3,3,0,0,-2,0,-1,-1,-1,0,-1
KR_6642345842,420,-4,-38,-16,-13,0,2,2,-1,2,1,-6,6,0,-5,7,2,-1,1,0,0,-14,14,0,-5,5,-3,0,-2,-1,-1,-1,-1,5,-1
KR_6767053326,420,1,23,11,-2,1,0,1,2,0,2,-3,4,1,-3,3,0,1,0,1,0,-4,-57,-1,-2,3,-3,0,0,-1,1,0,-1,5,-1
KR_6675783248,420,-2,-110,-4,-1,1,2,3,-5,6,1,4,4,8,-2,2,0,1,0,1,0,-2,-350,-2,-8,10,9,0,-4,-1,-1,-1,1,3,-1
KR_6767257402,420,5,26,-16,15,3,3,6,2,1,3,0,6,6,8,0,8,2,1,3,0,18,14,-2,-3,5,2,0,0,1,-1,1,1,6,-1
KR_6465234301,420,-2,-7,-24,-8,2,0,2,-4,6,2,-3,4,1,-3,5,2,0,1,1,1,-10,0,-3,-2,5,-2,0,-2,-1,-1,-1,1,3,-1
KR_6763908623,420,-5,-12,-4,-9,3,0,3,-3,3,0,-1,1,0,-4,5,1,-4,5,1,0,-12,-4,-3,-1,4,1,0,1,1,1,1,-1,6,-1
KR_6652901938,420,-1,-14,9,-6,2,2,4,-3,4,1,-3,6,3,0,2,2,-2,2,0,3,-13,-15,-1,-3,4,7,0,0,-1,0,0,1,1,-1
KR_6750282507,420,-6,-50,-52,-13,-1,1,0,-2,3,1,0,1,1,-6,6,0,-4,4,0,-2,-13,-6,-4,-3,7,-3,0,-1,-1,-1,-1,-1,3,-1
KR_6698861497,420,-6,-77,21,-16,-1,2,1,-6,8,2,-7,8,1,-1,2,1,-1,1,0,-1,-20,1,-3,-3,6,-5,0,-2,1,1,-1,-1,1,-1
KR_6729647494,420,-3,-48,-21,-5,-3,3,0,3,1,4,-7,7,0,1,2,3,1,0,1,0,0,-11,-4,-2,6,8,0,0,1,1,1,1,4,-1
KR_6766235536,420,-1,47,12,-3,0,1,1,-5,7,2,0,0,0,1,6,7,1,0,1,0,6,-19,2,-7,5,2,0,-1,1,-1,-1,-1,1,-1
KR_6709115631,420,1,23,4,3,0,0,0,-4,8,4,4,2,6,0,2,2,3,0,3,1,5,3,-3,-5,8,1,0,1,-1,1,1,1,3,-1
KR_6730880669,420,-3,-12,-12,-9,-4,4,0,-5,6,1,0,2,2,0,0,0,0,1,1,0,-8,-87,-6,-3,9,-9,0,1,-1,1,1,-1,5,-1
KR_6764552614,420,-6,-103,-31,-15,0,0,0,0,0,0,-7,7,0,-5,5,0,-3,3,0,0,-8,-7,-2,-2,4,3,0,-2,-1,-1,-1,-1,4,-1
KR_6758489928,420,-2,-70,4,-6,-2,3,1,1,0,1,-4,5,1,0,2,2,-1,1,0,0,-1,-32,4,-6,2,26,0,-1,0,-1,-1,-1,0,-1
KR_6466355176,420,-1,12,-7,-10,-2,2,0,-1,6,5,1,3,4,-7,8,1,-1,2,1,-1,-14,10,-2,-2,4,3,0,0,0,0,0,-1,0,-1
KR_6621354662,420,-7,-36,-6,-19,-2,2,0,-7,8,1,-4,6,2,-5,5,0,-1,3,2,0,-16,1,-3,-4,7,-3,0,-1,-1,1,-1,-1,5,-1
KR_6762222976,420,1,-19,13,2,-1,1,0,2,0,2,-3,7,4,6,1,7,-2,2,0,0,13,3,-1,0,1,-2,0,-3,1,-1,-1,-1,2,-1
KR_6742968255,420,3,35,21,3,3,3,6,5,2,7,-4,4,0,-1,4,3,0,1,1,0,1,-2,4,-9,5,-3,0,0,0,1,0,-1,0,-1
KR_6748583138,420,-2,-80,28,-7,-1,2,1,-6,6,0,-4,7,3,4,1,5,0,3,3,-1,-7,-16,-4,-2,6,-3,0,0,1,-1,-1,-1,5,-1
KR_6663505188,420,-1,-42,-8,1,-5,8,3,-2,3,1,4,0,4,3,1,4,1,0,1,0,10,-1,-4,-2,6,3,0,0,1,-1,1,-1,6,-1
KR_6633158915,440,-8,-94,-11,-23,-3,4,1,-11,13,2,-3,5,2,0,2,2,-6,8,2,-2,-24,-24,-4,-4,8,1,0,-3,1,-1,-1,-1,1,-1
KR_6648547574,420,-2,-48,16,-4,-5,5,0,-2,3,1,0,2,2,1,4,5,2,0,2,0,0,-4,-3,-1,4,1,0,0,-1,0,1,-1,3,-1
KR_6582633874,420,0,31,-31,6,0,3,3,0,2,2,-1,3,2,6,1,7,1,2,3,1,14,6,0,-4,4,-2,0,0,0,1,0,1,0,-1
KR_6723183892,420,-1,-13,20,6,3,1,4,0,1,1,1,0,1,3,1,4,-1,1,0,0,4,-5,-1,-5,6,2,0,0,1,1,0,1,3,-1
KR_6632816120,420,2,-56,20,2,1,0,1,-2,2,0,0,2,2,1,1,2,2,1,3,0,1,1,-5,-2,7,4,0,0,1,-1,-1,-1,2,-1
KR_6723245944,420,-2,-6,-4,-1,0,0,0,0,5,5,4,0,4,-1,3,2,-4,4,0,0,-8,-37,2,-5,3,-25,0,0,-1,-1,0,1,6,-1
KR_6730310305,420,-4,-92,17,-3,-1,1,0,-1,5,4,4,0,4,-6,6,0,1,1,2,0,-7,-5,-1,-3,4,-3,0,0,1,1,-1,1,4,-1
KR_6659900566,420,-8,-62,-99,-13,-2,3,1,-4,4,0,-2,3,1,-5,5,0,0,1,1,-1,-11,-7,1,-6,5,0,0,-2,-1,-1,-1,-1,4,-1
KR_6752594348,420,1,-23,20,-1,-1,2,1,1,2,3,0,1,1,-2,2,0,1,0,1,0,-3,2,2,-6,4,-2,0,1,-1,1,1,1,6,-1
KR_6752994919,420,-2,28,25,3,-2,2,0,-2,4,2,-1,4,3,7,0,7,1,0,1,0,-1,-13,-5,-3,8,9,0,-1,-1,1,1,1,5,-1
KR_6737839409,420,-2,-59,27,-2,-3,4,1,-1,5,4,0,3,3,2,1,3,0,0,0,0,1,-1,-2,-4,6,0,0,-1,1,-1,-1,1,6,-1
KR_6733485708,420,-1,-12,-15,2,-1,2,1,-2,4,2,2,0,2,3,2,5,0,2,2,0,-1,-40,1,-5,4,10,0,-1,1,-1,-1,1,5,-1
KR_6758245753,440,3,46,12,2,1,3,4,3,0,3,4,2,6,-5,5,0,-1,3,2,0,-3,-57,0,-4,4,19,0,2,-1,1,1,-1,3,-1
KR_6660130810,420,0,-96,12,-4,-3,3,0,-4,7,3,-1,3,2,3,1,4,1,2,3,0,-3,4,4,-8,4,0,0,1,1,-1,1,1,1,-1
KR_6767963491,420,1,9,-4,-3,2,1,3,-3,5,2,-2,2,0,0,2,2,0,0,0,0,-5,-81,3,-6,3,-8,0,-1,-1,1,-1,1,6,-1
KR_6747905132,440,1,69,-8,1,0,0,0,-1,2,1,0,4,4,1,2,3,1,1,2,-2,-3,-1,-3,-3,6,2,0,0,-1,1,0,-1,2,-1
KR_6687706818,420,0,20,-3,-7,0,3,3,-1,2,1,-3,5,2,-2,2,0,-1,1,0,0,-9,-7,-4,-3,7,0,0,-1,1,-1,-1,-1,5,-1
KR_6735693358,420,1,-35,32,-1,3,1,4,-1,4,3,0,5,5,-3,4,1,0,3,3,-1,-14,310,4,-6,2,3,0,0,1,1,0,-1,5,-1
KR_6759764978,420,0,-61,11,-3,1,2,3,2,2,4,0,5,5,-6,6,0,0,1,1,0,-1,0,1,-4,3,0,0,0,-1,1,0,-1,2,-1
KR_6725336053,420,-2,16,-4,-14,-1,2,1,-6,6,0,2,3,5,-3,3,0,-6,6,0,0,-14,-2,-2,-3,5,-2,0,-1,-1,1,-1,-1,3,-1
KR_6762476997,420,-1,-60,36,-9,-2,5,3,1,3,4,-3,3,0,-5,6,1,0,0,0,0,-17,-7,2,-6,4,-2,0,-2,1,-1,-1,-1,1,-1
KR_6731295394,420,-1,36,-6,-3,-3,6,3,0,5,5,-2,4,2,2,1,3,0,0,0,0,-8,29,6,-7,1,0,0,-2,1,1,-1,-1,5,-1
KR_6728176403,420,1,-17,-7,4,1,1,2,-8,9,1,6,0,6,4,1,5,1,0,1,1,5,-6,1,-3,2,-1,0,1,-1,1,1,1,4,-1
KR_6761367476,420,-2,-27,-20,4,0,2,2,0,1,1,-3,5,2,6,1,7,1,0,1,0,6,11,5,-7,2,-5,0,0,-1,-1,0,1,4,-1
KR_6719146853,440,-1,-20,-17,0,-4,4,0,0,4,4,2,2,4,2,1,3,0,2,2,0,-2,10,2,-5,3,1,0,-1,1,1,-1,1,4,-1
KR_6760348805,420,-3,-20,20,-6,-3,3,0,-1,4,3,1,2,3,-4,4,0,1,1,2,0,-6,-39,2,-5,3,14,0,-2,0,1,-1,1,0,-1
KR_6741715634,420,0,0,-4,1,-6,6,0,3,3,6,4,1,5,0,2,2,0,1,1,1,4,31,-2,-5,7,-12,0,0,1,1,-1,1,6,-1
KR_6758205860,420,-1,-61,-9,-9,0,0,0,-1,2,1,-3,4,1,-3,6,3,-2,3,1,-1,-5,-5,-2,-6,8,-2,0,0,0,1,0,-1,0,-1
KR_6742403535,420,-3,-23,24,-1,-2,3,1,1,2,3,5,2,7,-5,5,0,0,1,1,-1,-4,3,0,-3,3,-2,0,-2,1,1,-1,-1,4,-1
KR_6659453215,420,-4,-39,4,-10,-5,7,2,-1,5,4,-3,5,2,0,2,2,-1,1,0,0,-14,-13,-2,-2,4,0,0,0,-1,-1,-1,1,1,-1
KR_6758675478,420,-7,-49,-28,-10,-3,3,0,3,5,8,1,2,3,-7,7,0,-4,5,1,0,-8,-10,-1,-1,2,0,0,-3,-1,-1,-1,-1,5,-1
KR_6698740914,440,0,0,-3,-8,1,4,5,-1,2,1,-1,5,4,-6,8,2,-1,4,3,0,-10,29,-2,-3,5,-15,0,-1,0,-1,-1,1,0,-1
KR_6722844276,420,-4,-48,-32,-6,2,3,5,-4,5,1,-1,1,0,-2,5,3,-1,1,0,-1,-9,-3,0,-5,5,-2,0,1,-1,1,1,-1,6,-1
KR_6676954776,420,1,-29,26,8,-1,2,1,-2,2,0,7,0,7,3,2,5,1,0,1,1,9,1,3,-5,2,4,0,1,-1,0,1,1,3,-1
KR_6724627061,420,-8,-54,-36,-18,-5,7,2,-3,5,2,-11,11,0,-1,2,1,2,2,4,0,-8,32,-2,-1,3,-11,0,-3,-1,-1,-1,-1,2,-1
KR_6698661556,420,0,-25,33,-9,2,2,4,-2,4,2,-8,9,1,1,0,1,-2,2,0,-2,-15,3,2,-4,2,-1,0,-1,-1,-1,-1,-1,1,-1
KR_6669839037,420,-3,-78,28,-7,0,1,1,-1,3,2,-5,7,2,-1,2,1,0,0,0,2,1,7,3,-6,3,0,0,0,1,1,-1,1,2,-1
KR_6766532264,440,-5,-87,-16,-3,4,0,4,-1,1,0,-2,3,1,0,2,2,-4,4,0,0,-5,0,3,-5,2,-3,0,-1,-1,0,-1,1,1,-1
KR_6573244492,420,-2,-21,-19,-8,5,1,6,-3,3,0,-1,3,2,-5,6,1,-4,4,0,1,-11,-18,-3,-6,9,3,0,0,-1,1,-1,1,1,-1
KR_6733666900,420,-3,-95,-16,-8,1,3,4,-1,1,0,-4,4,0,-5,7,2,1,0,1,1,-4,1,-3,-2,5,0,0,0,-1,1,1,-1,1,-1
KR_6762450329,440,-5,-78,-39,-8,-1,3,2,-5,7,2,-3,6,3,1,0,1,0,2,2,0,-16,1,-2,-3,5,0,0,-1,0,-1,-1,-1,0,-1
KR_6687329918,420,-3,-11,-17,-4,-4,4,0,-2,4,2,2,1,3,-1,7,6,1,1,2,1,2,-2,-3,-2,5,1,0,-2,-1,-1,-1,-1,6,-1
KR_6764963339,420,-1,-31,4,-1,2,0,2,-3,5,2,0,0,0,1,1,2,-1,2,1,0,-1,-49,-1,-7,8,33,0,0,0,0,0,1,0,-1
KR_6759461969,420,-1,-60,5,2,-7,8,1,3,0,3,5,2,7,0,3,3,1,2,3,0,14,-38,1,-5,4,18,0,-2,1,-1,-1,-1,6,-1
KR_6745081392,420,-7,-38,7,-8,-3,4,1,-3,5,2,0,6,6,-5,7,2,3,1,4,-1,-5,-19,-1,0,1,-3,-1,-1,-1,-1,-1,-1,2,-1
KR_6700219413,420,-2,-39,-8,-5,-1,1,0,0,2,2,0,2,2,-3,5,2,-1,1,0,0,-4,67,-2,-6,8,14,0,1,-1,1,1,-1,5,-1
KR_6661485809,420,-4,-72,8,-6,-3,4,1,0,4,4,1,1,2,-2,3,1,-2,2,0,0,-4,1,-2,-4,6,-3,0,-1,-1,0,-1,1,4,-1
KR_6607654148,440,-1,11,-28,1,-2,2,0,0,3,3,3,1,4,1,4,5,-1,1,0,0,-1,3,0,-5,5,-4,0,2,0,1,1,-1,0,-1
KR_6623987788,420,2,-70,22,1,1,2,3,2,0,2,1,1,2,-4,4,0,1,1,2,0,9,114,1,-6,5,-2,0,-1,-1,0,-1,-1,5,-1
KR_6746536615,420,-5,-36,-13,-3,0,3,3,3,2,5,-2,5,3,-3,3,0,-1,1,0,1,0,3,-1,-2,3,0,0,-1,-1,-1,-1,1,1,-1
KR_6495689892,420,-1,-31,4,-7,1,1,2,0,0,0,0,1,1,-2,2,0,-6,6,0,0,-6,43,5,-6,1,-24,0,-1,-1,-1,-1,1,6,-1
KR_6648206022,420,1,96,-27,1,2,2,4,0,2,2,-1,4,3,1,2,3,-1,2,1,0,0,-4,-4,-3,7,1,0,-1,-1,1,-1,1,3,-1
KR_6629570898,420,0,8,1,4,8,1,9,-4,5,1,2,1,3,-2,3,1,0,0,0,0,-3,2,6,-8,2,-4,0,0,-1,-1,1,-1,5,-1
KR_6666162267,420,-4,-54,-28,-3,-3,3,0,-2,4,2,-2,2,0,3,0,3,1,0,1,-1,0,25,-3,-3,6,0,0,0,1,-1,-1,-1,2,-1
KR_6759968096,420,-2,-14,-12,-2,2,2,4,-2,4,2,-4,4,0,7,2,9,-5,6,1,0,-3,-7,-3,-4,7,0,0,0,-1,-1,-1,-1,3,-1
KR_6724901834,420,-4,-58,-27,-11,-5,5,0,-1,5,4,5,4,9,-10,10,0,0,0,0,0,-13,12,2,-8,6,-6,0,-1,1,-1,-1,1,1,-1
KR_6766132247,420,-1,-26,-32,1,0,1,1,-2,4,2,-2,3,1,6,1,7,-1,2,1,1,-1,4,1,-7,6,1,0,1,-1,-1,1,1,4,-1
KR_6741668166,420,-1,-44,3,-4,-1,2,1,-1,6,5,2,0,2,-3,3,0,-1,1,0,0,-8,-6,-4,-3,7,3,0,-1,-1,-1,-1,-1,2,-1
KR_6708462246,420,-2,1,-12,-6,-2,3,1,-8,9,1,1,4,5,4,1,5,-1,2,1,0,-10,-13,-6,-5,11,7,0,0,-1,-1,0,-1,1,-1
KR_6702560965,420,0,-34,0,-2,-1,2,1,-5,8,3,3,1,4,1,0,1,0,1,1,0,-4,-36,-2,-3,5,30,0,0,1,0,0,1,3,-1
KR_6733668539,420,3,112,24,5,0,1,1,3,0,3,-1,4,3,3,2,5,0,1,1,0,-1,11,0,-3,3,0,0,0,0,1,1,1,0,-1
KR_6750181676,420,-4,-112,6,-8,-2,2,0,0,2,2,1,1,2,-8,10,2,1,2,3,0,-3,6,1,-7,6,-3,0,-1,0,-1,-1,-1,0,-1
KR_6703665080,420,-3,-20,-48,2,0,1,1,-1,2,1,3,0,3,0,3,3,0,0,0,1,2,10,2,-8,6,1,0,1,1,1,1,1,1,-1
KR_6767299464,420,-2,-66,24,-13,0,3,3,-2,3,1,-4,4,0,-4,5,1,-3,3,0,-2,-11,341,-2,-3,5,3,0,-3,-1,1,-1,-1,4,-1
KR_6737980091,420,-1,-55,25,-3,2,3,5,-1,3,2,0,5,5,-4,5,1,0,1,1,0,-11,-4,-3,-3,6,0,0,-1,1,0,-1,1,4,-1
KR_6760463818,420,-6,-77,-12,-11,-5,5,0,-3,4,1,-1,1,0,-3,5,2,1,0,1,0,-7,45,-1,-6,7,-22,0,-1,-1,-1,-1,-1,3,-1
KR_6714395660,420,0,3,15,3,-2,3,1,-2,5,3,3,2,5,2,0,2,2,1,3,1,2,4,3,-3,0,-1,0,1,1,-1,-1,1,1,-1
KR_6759439101,420,-4,-63,-41,-8,-3,3,0,-6,8,2,2,2,4,-5,7,2,4,3,7,-1,-7,22,-1,-7,8,-10,0,-2,-1,-1,-1,-1,1,-1
KR_6647440902,420,-3,-65,42,-7,-1,3,2,0,1,1,-3,4,1,-4,6,2,1,0,1,0,-9,-6,-7,-1,8,-1,0,-2,0,1,-1,-1,0,-1
KR_6762540478,420,-1,-83,-12,-3,1,2,3,-2,4,2,-2,3,1,-1,4,3,1,0,1,0,-3,-6,1,-5,4,0,0,0,-1,0,0,1,5,-1
KR_6705399329,420,-3,19,-20,-12,-1,1,0,-7,9,2,-3,3,0,2,0,2,-3,5,2,-2,-21,-17,-2,-4,6,-2,0,-1,-1,-1,-1,-1,6,-1
KR_6683967281,420,-7,-63,-38,-17,0,1,1,-8,11,3,-2,2,0,-5,5,0,-2,3,1,0,-23,31,-1,-5,6,-23,0,-2,0,1,-1,1,0,-1
KR_6761921645,420,-1,-8,-40,-10,-5,8,3,1,1,2,1,1,2,-3,4,1,-4,4,0,0,-13,-24,-6,-1,7,3,0,0,-1,-1,0,-1,1,-1
KR_6636066604,420,1,58,0,3,1,0,1,-4,7,3,0,1,1,3,1,4,3,0,3,0,4,40,0,-5,5,-8,0,0,-1,-1,0,1,2,-1
KR_6678060532,420,-4,9,-32,-15,-3,3,0,0,0,0,-3,3,0,-8,8,0,-1,1,0,-1,-12,-6,-5,-1,6,0,0,-1,-1,-1,-1,-1,2,-1
KR_6738061782,420,-6,31,-85,-8,2,0,2,-2,2,0,-3,7,4,-4,4,0,-1,2,1,0,-9,4,5,-6,1,-4,0,-1,-1,-1,-1,1,4,-1
KR_6647436856,420,-1,-3,12,-4,1,1,2,3,2,5,-6,8,2,-2,2,0,0,1,1,0,-1,-1,-3,-1,4,-1,0,-1,-1,-1,-1,-1,6,-1
KR_6766581193,420,3,30,-20,8,-1,3,2,2,1,3,3,1,4,3,1,4,1,0,1,0,10,-2,-2,-5,7,-1,0,0,0,1,0,1,0,-1
KR_6724950858,420,-2,-14,-43,0,-2,2,0,-1,4,3,-1,3,2,1,2,3,3,0,3,0,3,19,3,-5,2,-3,0,0,-1,-1,0,-1,5,-1
KR_6749244550,420,-3,-16,-32,-13,-1,3,2,-2,3,1,-7,7,0,-1,5,4,-2,2,0,-2,-14,-6,1,-5,4,6,0,-1,0,-1,-1,-1,0,-1
KR_6733334256,420,-3,-68,-16,-8,-3,4,1,0,4,4,1,1,2,-3,4,1,-3,5,2,0,-5,-11,-1,-3,4,3,0,0,-1,-1,-1,-1,4,-1
KR_6766387414,420,0,-45,-12,5,1,1,2,4,2,6,1,1,2,1,2,3,-2,4,2,0,-2,275,2,-5,3,4,0,0,1,1,0,1,2,-1
KR_6722766285,420,1,52,-3,7,4,0,4,3,1,4,1,1,2,-2,3,1,1,1,2,0,1,201,-5,-2,7,2,0,0,-1,1,1,1,5,-1
KR_6766618804,420,-1,-6,3,-5,-3,3,0,0,1,1,-2,3,1,-2,3,1,2,0,2,0,-10,-633,-3,-1,4,-2,0,0,-1,1,-1,1,1,-1
KR_6729475988,440,-1,-9,20,-1,-1,2,1,6,3,9,-3,4,1,-4,5,1,1,1,2,0,2,-295,-4,0,4,2,0,0,1,-1,-1,-1,4,-1
KR_6761451323,440,-2,29,-20,-6,-3,5,2,5,0,5,0,0,0,-1,4,3,-7,7,0,0,0,-3,0,-3,3,-2,0,0,-1,-1,1,1,2,-1
KR_6765370662,420,3,25,8,5,2,0,2,7,1,8,-3,4,1,-1,3,2,0,1,1,0,2,6,5,-5,0,1,0,0,-1,-1,1,1,4,-1
KR_6745206778,440,-1,-101,0,2,-2,4,2,6,2,8,-4,5,1,2,2,4,0,3,3,0,4,45,1,-6,5,-21,0,0,1,-1,0,-1,3,-1
KR_6764261931,420,-5,-44,-20,-9,2,1,3,-3,4,1,0,1,1,-8,8,0,0,0,0,0,-9,-22,-2,-5,7,0,0,-1,-1,-1,-1,-1,2,-1
KR_6464784428,420,-1,89,-16,0,-1,3,2,-5,7,2,5,0,5,1,4,5,0,1,1,0,5,-24,2,-4,2,0,0,-1,1,-1,-1,1,5,-1
KR_6695010408,420,-3,-28,8,-7,2,1,3,1,1,2,1,1,2,-6,6,0,-5,5,0,0,-10,-33,0,-3,3,25,0,0,-1,0,-1,1,4,-1
KR_6767055317,420,0,-16,0,5,0,3,3,0,1,1,2,1,3,2,2,4,1,0,1,0,3,0,-4,-3,7,-2,0,0,1,-1,0,1,4,-1
KR_6715638756,420,0,9,8,-4,-2,3,1,-5,6,1,2,1,3,0,2,2,1,1,2,0,-5,14,-1,-5,6,2,0,-1,-1,1,-1,1,3,-1
KR_6710137199,420,-7,-105,-50,-20,0,2,2,-7,7,0,-5,5,0,-7,7,0,-1,1,0,0,-13,-145,-6,-1,7,3,0,-1,-1,-1,-1,-1,1,-1
KR_6686829819,420,-3,-14,-18,-2,0,4,4,-3,6,3,4,0,4,-1,3,2,-2,3,1,0,-1,1,1,-3,2,2,0,1,-1,1,1,-1,5,-1
KR_6719304381,420,-1,-80,22,-2,-4,4,0,3,3,6,1,2,3,-1,1,0,-1,1,0,-3,1,-6,-2,-3,5,4,0,-1,1,1,-1,-1,6,-1
KR_6764728352,420,4,66,9,8,0,2,2,2,0,2,0,3,3,3,0,3,3,0,3,0,4,19,-1,-2,3,1,0,1,1,1,1,-1,6,-1
KR_6633257997,440,-1,-25,38,-4,0,2,2,-4,4,0,2,3,5,-5,6,1,3,0,3,0,-1,-14,1,-9,8,-6,0,-2,1,-1,-1,-1,4,-1
KR_6638893867,420,-5,-49,-9,-9,-5,5,0,2,0,2,0,1,1,-6,7,1,0,0,0,0,-4,5,4,-9,5,-4,0,-1,1,1,-1,1,1,-1
KR_6754858379,420,-10,-139,-19,-26,-8,8,0,-8,8,0,-4,4,0,-5,5,0,-1,3,2,-2,-21,-8,1,-3,2,-2,-1,-5,-1,-1,-1,-1,6,-1
KR_6763549173,420,-3,-10,-16,0,-3,3,0,0,1,1,2,2,4,1,3,4,0,1,1,0,4,-11,3,-4,1,3,0,0,1,1,-1,-1,3,-1
KR_6463426335,420,-1,-14,-27,-7,1,1,2,1,1,2,-4,4,0,-6,7,1,1,1,2,-1,-11,-16,0,-4,4,0,0,0,0,1,0,-1,0,-1
KR_6744562366,420,1,-6,4,0,4,0,4,-1,2,1,1,0,1,-4,5,1,0,1,1,1,-1,-1,-1,-5,6,0,0,-1,1,0,1,1,3,-1
KR_6522779074,420,-1,-14,-28,0,0,2,2,-1,3,2,0,6,6,1,0,1,0,2,2,-1,0,-7,4,-7,3,2,0,-2,0,-1,-1,-1,0,-1
KR_6746481919,420,4,48,6,4,-1,4,3,5,0,5,-2,5,3,-1,2,1,3,0,3,0,6,-4,0,-5,5,2,0,2,-1,-1,1,-1,1,-1
KR_6764343724,420,0,-63,32,1,1,1,2,2,1,3,-4,4,0,0,6,6,2,1,3,-1,-11,9,1,-3,2,-4,0,1,-1,1,1,-1,6,-1
KR_6733951855,420,0,-25,-20,6,6,1,7,1,0,1,-1,2,1,-1,1,0,1,1,2,0,5,1,3,-3,0,-2,0,-1,1,-1,-1,-1,2,-1
KR_6674214414,420,-1,29,-16,-2,-3,3,0,-1,3,2,-5,6,1,4,0,4,3,0,3,-1,5,24,-3,-3,6,-2,0,0,-1,-1,0,-1,5,-1
KR_6754828995,420,1,-45,0,-1,1,1,2,-1,2,1,-7,8,1,3,1,4,3,0,3,0,7,4,4,-5,1,-3,0,-1,0,1,1,1,0,-1
KR_6706390616,420,-5,-22,-16,-10,-3,3,0,-2,4,2,-2,2,0,-2,2,0,-1,1,0,0,-5,5,0,-2,2,-1,0,0,-1,-1,0,-1,4,-1
KR_6657004082,420,-1,-33,4,-7,4,1,5,1,1,2,-1,3,2,-11,11,0,0,1,1,0,-13,-2,0,-5,5,1,0,0,1,1,1,-1,6,-1
KR_6762836966,440,-1,-96,-4,-1,4,2,6,1,0,1,-5,6,1,-4,6,2,3,0,3,0,3,-273,0,-4,4,3,0,-1,1,-1,-1,1,6,-1
KR_6756529915,440,-1,-33,27,-4,0,4,4,-4,7,3,-1,2,1,0,3,3,1,2,3,0,-6,-16,-4,-3,7,1,0,0,1,-1,1,1,1,-1
KR_6764309994,420,4,35,8,10,0,1,1,-4,5,1,7,1,8,1,1,2,6,0,6,0,6,-8,4,-6,2,2,0,1,1,1,1,1,5,-1
KR_6721424129,420,-1,2,24,0,-4,6,2,3,2,5,-3,4,1,3,0,3,1,0,1,0,2,-22,1,-6,5,-2,0,-1,1,-1,-1,1,3,-1
KR_6741556386,420,2,0,-19,6,2,2,4,2,1,3,-1,2,1,1,1,2,2,0,2,0,6,-6,-6,-1,7,2,0,0,1,-1,0,-1,1,-1
KR_6619741039,420,-7,-116,-21,-9,0,3,3,0,1,1,-3,3,0,-3,3,0,-3,3,0,0,-4,-325,1,-3,2,-1,0,0,-1,-1,-1,-1,5,-1
KR_6616622687,420,-2,-25,3,-2,3,0,3,0,6,6,1,0,1,-5,6,1,-1,1,0,1,2,5,0,-5,5,-1,0,-1,1,1,-1,1,5,-1
KR_6754683902,420,-1,33,15,-6,0,5,5,-3,5,2,-4,4,0,1,1,2,0,1,1,0,-3,-4,-2,-2,4,-1,0,0,-1,-1,-1,1,1,-1
KR_6692704780,440,-5,-48,0,-7,-5,6,1,-1,2,1,0,2,2,2,1,3,-3,3,0,0,2,-8,6,-6,0,1,0,-2,1,-1,-1,-1,6,-1
KR_6757600480,420,-2,-56,-12,-10,1,2,3,-2,2,0,-3,5,2,-4,7,3,-2,2,0,1,-11,-23,-2,-1,3,2,0,-2,-1,1,-1,1,4,-1
KR_6482242833,420,-6,-70,-33,-16,-2,3,1,-3,4,1,-3,4,1,-8,8,0,0,1,1,-1,-16,169,-3,-6,9,8,0,-3,-1,-1,-1,-1,3,-1
KR_6751904456,420,2,19,16,3,1,0,1,1,2,3,-2,2,0,4,1,5,-1,1,0,0,3,1,2,-6,4,-1,0,0,-1,1,0,-1,5,-1
KR_6727134536,440,0,-36,-18,-2,2,0,2,5,0,5,-5,6,1,-3,5,2,-1,1,0,0,-3,24,-2,-2,4,-5,0,0,-1,1,1,1,1,-1
KR_6731702846,420,-4,-127,10,-6,-3,3,0,0,1,1,-3,6,3,0,1,1,0,0,0,-1,-5,16,-1,-2,3,-2,0,-2,-1,1,-1,-1,6,-1
KR_6682114958,420,2,62,12,2,0,3,3,1,2,3,1,1,2,-1,3,2,1,0,1,1,0,-3,3,-6,3,2,0,-1,1,-1,-1,1,2,-1
KR_6669281448,420,0,-69,24,2,-2,4,2,4,2,6,-2,4,2,1,2,3,1,0,1,1,9,190,1,-3,2,0,0,0,-1,0,0,1,6,-1
KR_6650744186,420,0,41,1,5,4,1,5,4,2,6,-4,5,1,3,1,4,-2,2,0,0,-1,-3,2,-6,4,0,0,1,-1,1,1,1,2,-1
KR_6758698353,420,3,4,10,-1,-1,3,2,6,0,6,0,1,1,-6,8,2,0,1,1,1,0,6,-3,-3,6,-3,0,0,-1,1,-1,1,2,-1
KR_6734515319,420,-9,-72,-25,-19,-4,5,1,-3,4,1,0,1,1,-13,14,1,1,0,1,2,-18,-4,-5,-1,6,0,0,-1,-1,-1,-1,1,1,-1
KR_6621634437,420,-1,77,-24,3,1,3,4,0,4,4,-5,6,1,4,1,5,3,0,3,0,3,4,1,-1,0,1,0,1,1,1,1,1,2,-1
KR_6572156448,420,-7,-110,-28,-15,-8,8,0,-1,3,2,-3,5,2,-5,7,2,2,1,3,-2,-8,-7,1,-7,6,-1,0,-2,-1,1,-1,-1,6,-1
KR_6750110429,420,-2,-75,-44,2,-5,5,0,-2,7,5,4,2,6,4,2,6,1,0,1,2,11,6,-1,-5,6,-4,0,-2,-1,-1,-1,1,2,-1
KR_6761547690,440,-2,4,-12,-2,2,0,2,-2,3,1,4,0,4,-2,6,4,-4,5,1,-1,-3,11,0,-4,4,2,0,-2,1,0,-1,-1,3,-1
KR_6763781046,420,0,40,3,2,4,0,4,-2,3,1,-4,6,2,2,2,4,2,1,3,0,-5,3,3,-5,2,-3,0,1,-1,1,1,-1,5,-1
KR_6755848729,420,-3,-91,-8,-6,0,3,3,0,2,2,-2,4,2,-6,7,1,2,0,2,-1,-8,-1,-6,-2,8,-2,0,0,1,-1,-1,-1,3,-1
KR_6662230489,420,3,12,-9,1,0,1,1,-1,3,2,-1,4,3,2,1,3,1,0,1,0,4,-8,-2,-5,7,4,0,0,1,-1,0,-1,2,-1
KR_6643889967,420,-1,23,-28,1,1,1,2,-2,3,1,1,1,2,1,1,2,0,2,2,0,0,3,3,-7,4,-2,0,0,-1,-1,0,-1,6,-1
KR_6760784893,420,2,-3,8,4,-1,3,2,0,1,1,3,1,4,0,2,2,2,1,3,0,10,-124,1,-6,5,2,0,1,1,1,1,-1,4,-1
KR_6740771702,420,0,56,32,-3,0,3,3,-5,6,1,4,1,5,0,2,2,-2,2,0,0,-3,-1,-1,-3,4,1,0,-1,1,-1,-1,-1,2,-1
KR_6728708593,420,-3,21,-2,0,3,1,4,-4,5,1,-1,3,2,-1,3,2,3,0,3,1,-6,41,4,-8,4,-15,0,0,1,-1,1,1,3,-1
KR_6760056832,420,-1,-32,2,-1,1,1,2,0,5,5,-2,2,0,-4,6,2,4,2,6,0,1,-5,2,-5,3,-5,0,-1,-1,-1,-1,-1,3,-1
KR_6742339174,420,-5,-73,-16,-8,-1,2,1,0,5,5,-3,3,0,-5,5,0,1,0,1,2,-1,11,2,-4,2,-5,0,0,1,-1,0,1,1,-1
KR_6759776354,420,1,-20,-51,1,3,0,3,-3,4,1,-1,3,2,0,3,3,2,0,2,-1,-2,17,2,-5,3,-1,0,2,-1,0,1,-1,3,-1
KR_6672661099,420,-4,-77,-55,-7,1,3,4,0,0,0,-2,5,3,-6,6,0,0,0,0,0,-2,2,0,-3,3,-5,0,-4,-1,-1,-1,1,4,-1
KR_6682872067,420,0,44,-5,-4,1,2,3,-1,2,1,-3,6,3,0,1,1,-1,1,0,0,-10,2,-1,-5,6,2,0,0,1,1,1,-1,6,-1
KR_6720546213,440,0,-12,22,2,-3,3,0,4,1,5,-1,2,1,-1,3,2,3,1,4,1,7,2,-2,-1,3,3,0,0,1,-1,1,1,6,-1
KR_6681773204,420,2,-27,32,3,-2,3,1,6,3,9,1,1,2,-1,3,2,-1,2,1,0,7,2,0,-5,5,-3,0,-1,1,-1,-1,-1,3,-1
KR_6766065048,420,-1,-34,20,-3,0,2,2,1,2,3,-4,5,1,0,0,0,0,0,0,0,1,2,5,-8,3,-6,0,0,-1,-1,0,1,4,-1
KR_6767186093,440,-5,-102,-24,-17,-5,6,1,-3,3,0,-6,7,1,-3,8,5,0,2,2,-1,-15,0,3,-5,2,-1,0,-3,-1,-1,-1,-1,2,-1
KR_6766624419,420,3,29,-8,1,3,0,3,-1,2,1,-2,6,4,2,1,3,-1,2,1,0,3,6,0,-2,2,-2,0,1,-1,0,1,1,5,-1
KR_6761241180,420,2,11,-12,10,0,2,2,0,3,3,4,2,6,3,0,3,3,0,3,1,11,-120,-4,-3,7,4,0,0,1,1,1,1,4,-1
KR_6704856775,420,-2,-22,-8,-4,-2,3,1,-4,5,1,0,3,3,1,4,5,1,0,1,-2,-5,-10,-3,-2,5,-4,0,0,0,1,0,-1,0,-1
KR_6635651839,420,0,17,-8,-1,-2,3,1,-1,2,1,-2,4,2,1,3,4,3,0,3,0,2,-7,-4,-1,5,5,0,0,-1,-1,0,1,5,-1
KR_6767909375,420,-1,31,-8,-7,0,1,1,-2,3,1,-1,2,1,-4,6,2,0,1,1,-1,-7,6,1,-7,6,-10,0,0,-1,1,0,-1,1,-1
KR_6724853041,420,0,-59,16,-2,-1,3,2,3,0,3,-1,1,0,-2,5,3,-1,2,1,0,3,4,0,-6,6,0,0,1,-1,1,1,1,5,-1
KR_6717936739,420,-8,-159,-28,1,-4,4,0,1,0,1,2,2,4,0,2,2,2,0,2,-1,2,-5,-2,-3,5,1,0,-2,-1,-1,-1,-1,1,-1
KR_6730881796,420,2,11,0,4,1,1,2,-1,2,1,0,1,1,2,2,4,2,0,2,0,0,-22,-3,-3,6,5,0,0,0,1,0,1,0,-1
KR_6758063274,420,-5,-68,-18,-18,-4,5,1,0,0,0,-4,5,1,-6,7,1,-4,4,0,1,-17,-88,-1,-6,7,27,0,-1,0,-1,-1,1,0,-1
KR_6603913755,420,0,-5,12,3,-1,2,1,-2,6,4,2,0,2,3,2,5,1,0,1,0,3,-147,-1,-1,2,-3,0,-2,1,-1,-1,1,4,-1
KR_6748700243,420,-3,-50,-8,-8,-2,4,2,1,3,4,-6,7,1,-5,8,3,4,3,7,-1,-6,1,-1,-4,5,-3,0,-1,1,-1,-1,1,2,-1
KR_6671281311,420,-4,-127,0,-14,-5,5,0,-3,3,0,-2,3,1,-5,6,1,1,3,4,1,-11,14,-1,-3,4,-5,0,-2,1,1,-1,1,1,-1
KR_6765228749,420,-3,-74,-25,-1,1,0,1,-2,2,0,3,0,3,-1,6,5,-2,7,5,0,-1,-2,-4,0,4,0,0,-1,1,-1,-1,-1,1,-1
KR_6712851019,420,-4,-24,-5,-9,-2,3,1,-4,7,3,0,4,4,-4,5,1,1,0,1,0,-7,2,-4,-2,6,3,0,-4,-1,-1,-1,1,5,-1
KR_6677020493,420,-1,40,-30,2,2,1,3,1,6,7,0,1,1,2,3,5,-3,3,0,0,1,-4,-2,-2,4,7,0,0,1,1,0,1,4,-1
KR_6718194485,440,1,-18,11,-2,5,1,6,-7,9,2,-4,7,3,-2,5,3,6,1,7,-1,-2,-2,1,-4,3,1,0,-1,1,-1,-1,-1,4,-1
KR_6759552218,420,0,-30,-4,2,-2,3,1,4,2,6,1,1,2,-1,2,1,0,2,2,0,1,4,1,-5,4,4,0,0,1,-1,0,-1,4,-1
KR_6729688407,440,-4,-63,-8,-5,-5,6,1,-1,1,0,3,0,3,-3,4,1,1,1,2,0,-5,-152,-4,-4,8,-11,0,-2,-1,-1,-1,-1,4,-1
KR_6679294945,420,-1,-78,1,-1,-1,2,1,-2,2,0,0,1,1,2,0,2,0,0,0,0,-1,4,-1,-5,6,-5,0,-1,-1,-1,-1,-1,6,-1
KR_6747444797,440,-2,-47,-24,1,-4,4,0,2,1,3,4,0,4,-1,3,2,0,2,2,0,3,-7,-2,-7,9,3,0,-1,1,-1,-1,-1,4,-1
KR_6759662365,420,0,2,16,2,-2,3,1,1,1,2,-6,7,1,9,3,12,0,1,1,0,18,-13,-1,-4,5,6,0,1,-1,0,1,-1,3,-1
KR_6765129207,420,2,23,-12,-1,1,3,4,-3,4,1,2,2,4,-1,4,3,0,0,0,0,-3,-3,1,-6,5,-5,0,0,1,-1,0,-1,4,-1
KR_6670804089,420,-3,-31,0,-8,-2,6,4,1,3,4,-2,2,0,-5,6,1,0,1,1,0,-9,-4,-2,-3,5,1,0,0,1,0,0,1,6,-1
KR_6634869148,420,1,22,0,1,0,3,3,-2,3,1,2,2,4,0,5,5,1,1,2,-2,-9,13,2,-7,5,-1,0,0,1,-1,0,1,4,-1
KR_6756258563,420,-7,-114,-12,-14,-4,4,0,-4,5,1,-3,4,1,-2,3,1,-1,2,1,-1,-10,-1,2,-4,2,2,0,-1,-1,-1,-1,-1,2,-1
KR_6767122889,420,-1,7,-20,-5,-6,6,0,-4,4,0,3,0,3,0,4,4,2,0,2,0,-1,-10,1,-4,3,1,0,3,-1,1,1,-1,6,-1
KR_6731761480,420,-3,-80,-8,-6,-3,4,1,-1,2,1,1,0,1,-3,5,2,0,1,1,0,-6,43,-5,-2,7,2,0,-1,-1,-1,-1,1,6,-1
KR_6634156962,420,1,17,16,-2,-1,1,0,-1,2,1,3,1,4,-1,2,1,-2,3,1,0,3,-2,5,-10,5,2,0,0,0,1,-1,1,0,-1
KR_6722423536,420,2,45,3,10,2,1,3,-2,3,1,7,2,9,3,2,5,0,2,2,1,9,-4,-4,-2,6,2,0,1,0,-1,1,1,0,-1
KR_6761889857,420,-4,63,-4,-4,1,1,2,-5,9,4,0,4,4,3,4,7,-3,3,0,-1,-7,8,0,-4,4,5,0,0,1,1,1,1,1,-1
KR_6704631606,420,0,-38,5,-4,0,0,0,-2,3,1,-1,4,3,-1,2,1,0,1,1,0,-3,231,-2,-1,3,-4,0,-1,-1,-1,-1,-1,1,-1
KR_6752062053,420,0,-57,-7,-3,2,1,3,1,2,3,-4,4,0,-2,2,0,0,1,1,0,-5,4,-2,-2,4,-1,0,-1,1,-1,-1,-1,2,-1
KR_6755300049,420,-4,-29,-20,-4,-4,6,2,2,2,4,-1,2,1,-1,3,2,0,0,0,-1,-2,9,2,-4,2,-1,0,-1,1,1,-1,-1,4,-1
KR_6700613544,420,-1,79,12,-7,0,0,0,-1,5,4,0,1,1,-2,7,5,-4,4,0,0,-10,-4,0,-4,4,1,0,-1,1,1,-1,-1,1,-1
KR_6727394432,420,1,2,-5,8,-1,1,0,2,1,3,-1,5,4,5,0,5,3,0,3,-1,9,11,-4,-5,9,4,0,0,1,-1,-1,-1,2,-1
KR_6765697119,420,-3,-81,22,-6,1,1,2,-3,4,1,-3,3,0,1,2,3,-2,2,0,0,-6,4,1,-3,2,-1,0,0,-1,-1,-1,1,2,-1
KR_6699726261,420,3,25,-12,6,2,0,2,0,4,4,-1,3,2,6,3,9,-1,1,0,1,15,-15,0,-4,4,-1,0,0,1,1,0,1,4,-1
KR_6649473818,420,-3,-107,-7,-2,-3,4,1,-1,4,3,0,2,2,2,5,7,0,2,2,3,-7,-6,-5,0,5,0,0,-1,1,-1,-1,1,5,-1
KR_6738520314,440,-2,23,-1,-7,0,0,0,-4,7,3,-1,1,0,-3,3,0,1,3,4,1,-1,2,-4,0,4,-1,0,0,-1,1,0,1,3,-1
KR_6714704574,420,-4,-18,8,-2,-1,2,1,0,3,3,-1,3,2,1,0,1,-1,1,0,0,-11,2,-2,-4,6,-1,0,1,1,1,1,-1,4,-1
KR_6750815355,420,3,-13,15,6,5,1,6,0,3,3,-1,2,1,1,2,3,1,0,1,0,5,4,4,-8,4,-6,0,1,1,0,1,-1,3,-1
KR_6679255096,420,4,44,-8,7,-2,2,0,-2,3,1,1,2,3,9,0,9,1,1,2,1,10,-3,1,-8,7,2,0,1,1,1,1,1,1,-1
KR_6765105961,420,-1,-67,31,-4,-5,5,0,3,0,3,0,4,4,-3,5,2,1,0,1,0,-7,11,-1,-2,3,10,0,-2,-1,-1,-1,-1,5,-1
KR_6753992053,420,2,39,55,8,-1,1,0,2,1,3,0,2,2,7,1,8,0,0,0,0,8,16,0,-4,4,6,0,0,1,-1,-1,1,2,-1
KR_6749910237,420,0,-5,3,-2,-3,4,1,-3,5,2,-2,3,1,6,0,6,0,0,0,0,1,-19,-1,-1,2,-1,0,1,-1,1,1,-1,6,-1
KR_6727311959,420,-1,-10,5,0,-2,3,1,-4,5,1,-4,5,1,3,3,6,7,0,7,1,2,2,-1,-4,5,-1,0,1,-1,0,1,1,2,-1
KR_6759860422,420,-2,-63,-26,-7,1,0,1,-4,5,1,0,1,1,-5,6,1,1,3,4,-1,-2,210,1,-6,5,-4,0,-1,-1,-1,-1,-1,6,-1
KR_6747788542,420,2,-14,24,2,2,1,3,0,2,2,2,3,5,-2,5,3,0,0,0,0,-5,32,-2,-3,5,-1,0,0,1,1,0,1,4,-1
KR_6766752000,420,-1,25,-8,-5,0,5,5,-2,5,3,0,0,0,-2,2,0,-1,1,0,0,-5,2,0,-2,2,-1,0,1,1,1,1,1,3,-1
KR_6756956889,420,-3,-36,-28,-4,-1,3,2,-2,4,2,-1,2,1,0,3,3,0,0,0,0,-2,-4,1,-5,4,-1,0,-1,-1,-1,-1,1,3,-1
KR_6682271580,420,-3,-51,-11,-11,-3,3,0,2,2,4,-4,4,0,-4,5,1,-2,2,0,0,-7,-263,-3,-3,6,3,0,0,-1,-1,0,-1,3,-1
KR_6743448694,420,-4,-19,-24,-2,-1,2,1,-1,4,3,0,1,1,0,3,3,0,1,1,-1,1,-4,-4,-5,9,1,0,0,1,-1,0,-1,3,-1
KR_6760319948,420,-2,-20,-5,-3,-6,6,0,-1,1,0,1,1,2,3,1,4,0,1,1,0,2,3,0,-5,5,-1,0,0,-1,1,-1,-1,5,-1
KR_6762771795,420,-3,-24,-13,-3,0,1,1,-3,3,0,-2,3,1,4,6,10,-2,3,1,0,-1,5,2,-8,6,-3,0,0,1,0,-1,1,6,-1
KR_6601875027,420,-7,-11,-54,-13,-5,6,1,-1,5,4,-4,5,1,-1,1,0,-2,3,1,-1,-7,-1,1,-6,5,-6,0,-2,-1,-1,-1,-1,5,-1
KR_6751203077,420,-1,24,3,-1,2,1,3,-6,6,0,-1,4,3,2,1,3,2,0,2,0,1,-38,1,-2,1,14,0,1,-1,0,1,-1,3,-1
KR_6714317790,420,-4,29,16,-15,-8,8,0,-1,1,0,-7,7,0,2,0,2,-1,1,0,0,-6,27,-4,-1,5,-27,0,-1,0,-1,-1,-1,0,-1
KR_6712738645,420,-1,-22,16,-2,4,1,5,0,1,1,0,1,1,-3,4,1,-3,3,0,0,-8,384,-5,-2,7,-2,0,1,1,1,1,1,6,-1
KR_6645332110,420,-8,-89,-55,-21,-8,10,2,0,3,3,-3,4,1,-7,7,0,-3,4,1,-2,-17,-3,-3,-6,9,-2,0,-4,-1,-1,-1,1,3,-1
KR_6746113866,420,-3,-59,-43,-12,-1,5,4,-6,6,0,-4,5,1,-2,2,0,1,3,4,1,-9,2,-4,0,4,-4,0,-2,-1,-1,-1,1,1,-1
KR_6721994228,440,-2,-46,-24,-3,-2,2,0,0,4,4,2,1,3,-3,5,2,0,2,2,0,0,-2,1,-3,2,-3,0,-1,-1,-1,-1,1,2,-1
KR_6672538445,420,2,-37,16,11,1,0,1,4,2,6,3,0,3,2,0,2,1,0,1,1,21,15,3,-6,3,-6,0,0,1,-1,0,1,6,-1
KR_6750640335,420,-3,-83,-2,-10,0,4,4,-1,1,0,-7,8,1,-2,2,0,0,0,0,0,-3,-221,-2,-1,3,-3,0,-2,-1,-1,-1,-1,2,-1
KR_6630935521,420,-3,-75,-12,-7,-4,4,0,-2,5,3,2,0,2,0,1,1,-3,3,0,0,-5,2,3,-5,2,-1,0,-2,1,-1,-1,-1,1,-1
KR_6761452166,420,-2,2,0,-6,1,2,3,-6,6,0,3,2,5,-5,6,1,1,2,3,0,-6,21,-8,-3,11,3,0,-1,1,1,-1,-1,4,-1
KR_6760359711,420,0,8,3,-4,1,1,2,-4,6,2,-1,1,0,-1,1,0,1,1,2,0,-7,321,6,-8,2,-3,0,0,0,1,0,1,0,-1
